contig	position	variantID	refAllele	altAllele	refCount	altCount	totalCount	lowMAPQDepth	lowBaseQDepth	rawDepth	otherBases	improperPairs
1	6698	.	G	A	15	17	32	0	3	35	0	0
1	6746	.	T	C	26	6	32	0	33	65	0	0
1	10093	.	C	T	40	31	71	0	4	75	0	0
1	14083	.	G	A	0	7	7	0	12	19	0	0
1	15050	.	G	A	1	7	8	0	5	13	0	0
1	15772	.	G	A	0	6	6	0	6	12	0	0
1	15828	.	G	A	0	10	10	0	7	17	0	0
1	16072	.	C	T	4	8	12	0	3	15	0	0
1	32450	.	T	C	11	14	25	1	1	27	0	0
1	33036	.	C	T	10	6	16	0	1	17	0	0
1	38106	.	C	T	5	13	18	0	1	19	0	0
1	38814	.	G	A	2	18	20	0	14	34	0	0
1	39620	.	C	A	3	4	7	0	5	12	0	0
1	39621	.	G	C	8	4	12	0	0	12	0	0
1	40409	.	T	C	5	3	8	0	0	8	0	0
1	41287	.	C	T	2	6	8	0	5	13	0	0
1	42590	.	G	A	5	2	7	0	1	8	0	0
1	42662	.	G	A	5	5	10	0	1	11	0	0
1	42698	.	G	A	6	6	12	0	0	12	0	0
1	45214	.	G	T	1	2	3	0	0	3	0	0
1	61090	.	A	G	3	10	13	0	0	13	0	0
1	62771	.	G	A	9	6	15	0	1	16	0	0
1	62838	.	C	T	7	9	16	0	1	17	0	0
1	140959	.	A	T	1	2	3	0	0	3	0	0
1	153527	.	A	G	9	9	18	0	0	18	0	0
1	154104	.	G	C	8	8	16	0	0	16	0	0
1	154113	.	G	A	8	8	16	0	1	17	0	0
1	154140	.	C	A	0	9	9	0	5	14	0	0
1	157915	.	T	A	5	7	12	0	0	12	0	0
1	160229	.	G	A	8	4	12	0	1	13	0	0
1	176642	.	C	T	15	17	32	0	2	34	0	0
1	176774	.	C	T	15	18	33	1	0	34	0	0
1	181717	.	T	C	19	8	27	0	0	27	0	0
1	181754	.	C	T	11	21	32	0	0	32	0	0
1	181763	.	A	G	12	19	31	0	0	31	0	0
1	186389	.	C	T	5	5	10	0	0	10	0	0
1	186864	.	G	A	4	3	7	0	1	8	0	0
1	191914	.	C	G	8	4	12	0	0	12	0	0
1	208262	.	G	A	5	3	8	0	0	8	0	0
1	208265	.	G	A	5	3	8	0	0	8	0	0
1	208408	.	T	A	7	24	31	0	2	33	0	0
1	208570	.	T	C	6	10	16	0	3	19	0	0
1	208600	.	T	C	9	4	13	0	1	14	0	0
1	208613	.	T	C	6	0	6	0	7	13	0	0
1	209162	.	T	C	15	11	26	0	0	26	0	0
1	212162	.	G	A	15	11	26	0	0	26	0	0
1	213203	.	G	C	24	0	24	0	14	38	0	0
1	218551	.	C	T	5	6	11	1	1	13	0	0
1	218775	.	G	A	2	5	7	0	0	7	0	0
1	219437	.	C	T	4	3	7	0	0	7	0	0
1	221781	.	C	G	4	8	12	0	1	13	0	0
1	222797	.	C	T	3	4	7	0	0	7	0	0
1	225044	.	G	A	0	5	5	0	11	16	0	0
1	225083	.	C	T	4	9	13	0	1	14	0	0
1	442456	.	T	C	5	4	9	2	0	11	0	0
1	443155	.	G	T	3	3	6	0	0	6	0	0
1	474321	.	A	G	4	2	6	0	0	6	0	0
1	474398	.	C	A	0	3	3	0	9	12	0	0
1	474465	.	C	T	16	6	22	0	0	22	0	0
1	474473	.	A	G	18	6	24	0	0	24	0	0
1	476034	.	G	A	8	3	11	0	1	12	0	0
1	477001	.	C	T	0	5	5	0	11	16	0	0
1	477013	.	G	T	10	5	15	0	0	15	0	0
1	477046	.	G	A	10	5	15	0	0	15	0	0
1	477070	.	C	T	2	3	5	0	9	14	0	0
1	477951	.	C	T	3	4	7	0	1	8	0	0
1	479986	.	A	G	4	7	11	0	0	11	0	0
1	483820	.	T	A	3	6	9	0	0	9	0	0
1	483821	.	C	T	3	6	9	0	0	9	0	0
1	484094	.	G	A	3	5	8	0	0	8	0	0
1	484141	.	T	C	3	0	3	1	2	6	0	0
1	484418	.	G	A	5	5	10	0	0	10	0	0
1	484434	.	C	T	6	4	10	0	0	10	0	0
1	486475	.	G	C	6	3	9	0	0	9	0	0
1	486637	.	A	G	3	3	6	0	0	6	0	0
1	486650	.	A	T	3	3	6	0	1	7	0	0
1	486775	.	T	C	2	4	6	0	0	6	0	0
1	492231	.	C	A	1	7	8	0	0	8	0	0
1	494246	.	A	T	4	7	11	0	0	11	0	0
1	496303	.	A	G	8	6	14	0	1	15	0	0
1	496305	.	A	C	8	6	14	0	0	14	0	0
1	496760	.	A	G	2	0	2	0	7	9	0	0
1	497054	.	G	A	6	5	11	0	2	13	0	0
1	501303	.	G	A	2	11	13	0	8	21	0	0
1	501381	.	T	A	5	5	10	0	1	11	0	0
1	502079	.	C	A	8	12	20	0	1	21	0	0
1	503900	.	C	T	4	13	17	0	1	18	0	0
1	504073	.	A	G	10	0	10	0	11	21	0	0
1	504637	.	A	T	4	5	9	0	0	9	0	0
1	504663	.	C	G	4	8	12	0	1	13	0	0
1	504696	.	A	G	8	0	8	0	9	17	0	0
1	504912	.	C	A	7	3	10	0	1	11	0	0
1	505013	.	A	G	3	6	9	0	1	10	0	0
1	505178	.	G	A	6	6	12	0	1	13	0	0
1	505260	.	A	G	4	1	5	0	7	12	0	0
1	505298	.	C	T	8	6	14	1	1	16	0	0
1	505464	.	T	C	1	7	8	0	0	8	0	0
1	509222	.	T	G	3	2	5	0	1	6	0	0
1	509387	.	A	G	5	8	13	0	0	13	0	0
1	511525	.	G	A	6	3	9	0	0	9	0	0
1	511544	.	C	T	3	6	9	0	1	10	0	0
1	511957	.	G	A	9	5	14	0	0	14	0	0
1	511968	.	A	T	5	7	12	0	0	12	0	0
1	512127	.	C	T	6	5	11	0	0	11	0	0
1	512183	.	G	C	4	2	6	0	1	7	0	0
1	513613	.	A	G	1	5	6	0	0	6	0	0
1	513615	.	T	A	1	5	6	0	0	6	0	0
1	514114	.	G	A	0	7	7	0	4	11	0	0
1	514202	.	C	T	6	6	12	0	0	12	0	0
1	515549	.	G	A	3	6	9	0	0	9	0	0
1	515575	.	G	C	3	4	7	0	2	9	0	0
1	517515	.	C	T	19	5	24	0	0	24	0	0
1	517697	.	T	C	2	2	4	0	0	4	0	0
1	517699	.	A	G	2	0	2	0	2	4	0	0
1	524806	.	G	A	10	6	16	0	3	19	0	0
1	524828	.	C	T	13	7	20	0	0	20	0	0
1	528522	.	G	A	2	8	10	0	15	25	0	0
1	528552	.	A	C	14	10	24	0	2	26	0	0
1	530497	.	T	A	10	2	12	1	0	13	0	0
1	546198	.	C	T	3	4	7	0	0	7	0	0
1	552692	.	A	G	1	3	4	0	0	4	0	0
1	586161	.	G	A	1	9	10	0	9	19	0	0
1	586165	.	C	T	7	10	17	0	0	17	0	0
1	586765	.	C	T	7	3	10	0	1	11	0	0
1	587200	.	G	T	9	5	14	0	2	16	0	0
1	589044	.	A	T	19	11	30	0	4	34	0	0
1	589056	.	C	T	25	11	36	0	0	36	0	0
1	589115	.	G	A	1	15	16	0	8	24	0	0
1	594664	.	C	G	3	5	8	0	0	8	0	0
1	601882	.	G	A	8	2	10	0	1	11	0	0
1	601954	.	C	T	3	5	8	0	0	8	0	0
1	603292	.	A	G	5	8	13	0	0	13	0	0
1	606128	.	A	C	10	13	23	0	0	23	0	0
1	610451	.	C	G	1	4	5	0	0	5	0	0
1	610606	.	C	T	1	7	8	0	0	8	0	0
1	610722	.	T	C	7	16	23	0	1	24	0	0
1	611267	.	T	C	36	24	60	0	2	62	0	0
1	614568	.	C	G	1	15	16	0	14	30	0	0
1	617950	.	C	T	4	27	31	0	21	52	0	0
1	618190	.	A	C	28	1	29	0	27	56	0	0
1	618210	.	G	A	32	22	54	0	4	58	0	0
1	618277	.	A	G	20	34	54	0	0	54	0	0
1	618434	.	C	T	30	26	56	0	4	61	1	0
1	618776	.	C	A	13	14	27	0	0	27	0	0
1	618826	.	C	T	28	11	39	0	1	40	0	0
1	618918	.	A	T	18	35	53	11	0	64	0	0
1	618932	.	A	G	19	34	53	11	3	67	0	0
1	619679	.	T	A	15	15	30	0	1	31	0	0
1	619703	.	C	T	1	12	13	1	20	34	0	0
1	619764	.	C	T	29	9	38	0	1	39	0	0
1	620244	.	A	T	36	26	62	0	5	67	0	0
1	620314	.	G	A	31	31	62	0	1	63	0	0
1	620516	.	A	T	16	44	60	0	2	63	1	0
1	620517	.	T	G	19	45	64	0	0	64	0	0
1	621027	.	C	T	2	22	24	0	29	53	0	0
1	621063	.	T	A	23	24	47	0	1	48	0	0
1	621069	.	G	A	24	22	46	0	1	48	1	0
1	621102	.	A	T	22	21	43	0	1	44	0	0
1	621141	.	T	A	15	24	39	0	1	40	0	0
1	621283	.	C	T	3	24	27	0	27	54	0	0
1	621336	.	G	A	28	30	58	1	7	66	0	0
1	621389	.	C	T	32	30	62	1	6	69	0	0
1	621440	.	C	T	21	43	64	0	2	66	0	0
1	626601	.	G	A	38	22	60	0	1	61	0	0
1	629610	.	G	A	21	34	55	0	2	57	0	0
1	629619	.	A	G	20	39	59	0	0	59	0	0
1	634882	.	T	C	36	25	61	1	1	63	0	0
1	634933	.	T	C	40	11	51	2	2	57	2	0
1	638431	.	C	T	5	28	33	0	34	67	0	0
1	5273659	.	G	A	4	7	11	0	1	12	0	0
1	5273712	.	A	T	5	3	8	0	0	8	0	0
1	5273808	.	A	G	5	5	10	0	0	10	0	0
1	5273826	.	G	A	7	3	10	0	0	10	0	0
1	5273889	.	C	A	7	4	11	0	1	12	0	0
1	5275892	.	G	A	7	7	14	0	1	15	0	0
1	5276189	.	G	A	5	5	10	0	0	10	0	0
1	5276257	.	T	C	6	9	15	0	0	15	0	0
1	5276343	.	G	A	7	8	15	0	0	15	0	0
1	5276982	.	A	G	4	0	4	0	6	10	0	0
1	5354765	.	C	A	17	16	33	0	1	34	0	0
1	5354768	.	A	G	18	15	33	0	1	34	0	0
1	5354929	.	T	C	19	25	44	0	2	46	0	0
1	5355024	.	G	T	18	24	42	0	0	42	0	0
1	5355334	.	G	A	37	25	62	0	6	68	0	0
1	5355435	.	C	T	6	13	19	3	41	63	0	0
1	5355514	.	G	A	34	32	66	1	1	68	0	0
1	5355707	.	T	A	29	30	59	3	1	63	0	0
1	5355804	.	C	T	2	29	31	0	34	65	0	0
1	5356001	.	C	A	22	21	43	0	1	44	0	0
1	5356002	.	A	C	21	1	22	0	21	43	0	0
1	5356075	.	A	T	26	20	46	0	2	48	0	0
1	5356087	.	C	T	27	18	45	0	3	48	0	0
1	5356455	.	T	G	12	15	27	0	1	28	0	0
1	5356497	.	C	A	15	18	33	0	1	34	0	0
1	5356499	.	G	T	14	19	33	0	0	33	0	0
1	5356667	.	A	T	20	16	36	0	0	36	0	0
1	5356681	.	T	C	22	2	24	0	16	40	0	0
1	5357053	.	T	C	14	12	26	0	1	27	0	0
1	5357083	.	T	C	5	3	8	16	0	24	0	0
1	5357405	.	T	C	6	29	35	1	1	37	0	0
1	5357528	.	C	G	17	17	34	0	4	38	0	0
1	5357541	.	T	C	15	21	36	0	7	43	0	0
1	5357630	.	T	C	25	9	34	0	0	34	0	0
1	5357742	.	C	A	22	20	42	0	0	42	0	0
1	5357772	.	C	G	24	16	40	0	2	42	0	0
1	5357845	.	C	A	28	22	50	0	1	51	0	0
1	5357967	.	T	G	23	13	36	0	0	36	0	0
1	5357978	.	T	G	25	7	32	0	1	33	0	0
1	5358265	.	C	T	3	20	23	0	23	46	0	0
1	5358448	.	A	G	17	14	31	0	0	31	0	0
1	5358480	.	G	T	14	12	26	0	0	26	0	0
1	5358528	.	T	C	3	10	13	0	0	13	0	0
1	5358531	.	A	C	3	9	12	0	0	12	0	0
1	5358792	.	C	A	23	15	38	0	2	40	0	0
1	5365350	.	G	A	25	18	43	0	2	45	0	0
1	5365368	.	C	T	26	19	45	0	0	45	0	0
1	5375285	.	C	T	21	28	49	0	1	50	0	0
1	5378957	.	T	G	25	22	47	0	0	47	0	0
1	5402605	.	T	A	22	14	36	0	0	36	0	0
1	5414300	.	T	C	13	13	26	0	0	26	0	0
1	5414327	.	C	T	17	19	36	0	1	37	0	0
1	5415859	.	T	C	19	18	37	0	0	37	0	0
1	5415970	.	C	G	15	13	28	0	0	28	0	0
1	5418692	.	C	T	16	19	35	0	0	35	0	0
1	5418971	.	A	T	13	14	27	0	0	28	1	0
1	5419043	.	G	T	8	3	11	0	1	12	0	0
1	5422518	.	G	T	3	5	8	0	0	8	0	0
1	5425428	.	G	C	6	6	12	0	1	13	0	0
1	5433554	.	C	T	8	9	17	0	0	17	0	0
1	5433709	.	C	T	9	11	20	0	1	21	0	0
1	5433712	.	T	C	10	11	21	1	1	23	0	0
1	5498516	.	G	C	0	2	2	0	3	5	0	0
1	5503778	.	T	G	1	4	5	0	0	5	0	0
1	5503809	.	T	C	4	4	8	0	0	8	0	0
1	5503828	.	T	C	3	3	6	0	0	6	0	0
1	5503882	.	G	A	1	2	3	0	0	3	0	0
1	5503898	.	C	A	1	2	3	0	0	3	0	0
1	5504308	.	G	T	1	2	3	1	0	4	0	0
1	5507440	.	C	T	2	8	10	0	0	10	0	0
1	5507533	.	G	A	2	4	6	0	1	7	0	0
1	5509116	.	T	G	5	3	8	0	0	8	0	0
1	5511672	.	T	C	2	3	5	0	0	5	0	0
1	5511982	.	T	C	2	2	4	0	0	4	0	0
1	5586908	.	G	C	1	2	3	0	0	3	0	0
1	5606790	.	C	A	17	17	34	0	0	34	0	0
1	5607137	.	G	T	12	9	21	0	0	21	0	0
1	5607181	.	A	G	13	7	20	0	1	21	0	0
1	5607597	.	G	A	5	6	11	0	1	12	0	0
1	5607668	.	T	C	15	10	25	0	0	25	0	0
1	5607914	.	G	T	4	10	14	0	1	15	0	0
1	5607929	.	C	A	12	3	15	0	0	15	0	0
1	5607970	.	T	C	8	6	14	0	0	14	0	0
1	5608215	.	G	T	9	9	18	0	0	18	0	0
1	5631812	.	A	G	5	6	11	0	2	13	0	0
1	5631815	.	G	C	4	1	5	0	9	14	0	0
1	5632031	.	A	G	3	5	8	0	0	8	0	0
1	5638713	.	G	A	3	3	6	0	0	6	0	0
1	5641049	.	G	A	6	7	13	0	0	13	0	0
1	5671710	.	A	G	9	4	13	0	0	13	0	0
1	5671728	.	G	T	5	6	11	0	4	15	0	0
1	5675514	.	A	G	6	5	11	0	1	12	0	0
1	5681042	.	C	T	0	7	7	0	8	15	0	0
1	5681072	.	G	A	8	3	11	0	0	11	0	0
1	5745572	.	G	A	4	3	7	0	1	8	0	0
1	5745674	.	A	T	1	2	3	0	0	3	0	0
1	5745902	.	C	G	6	4	10	0	0	10	0	0
1	6137622	.	G	A	1	6	7	1	1	9	0	0
1	6137629	.	G	A	0	7	7	1	1	9	0	0
1	6137829	.	A	G	4	7	11	0	0	11	0	0
1	6137880	.	G	T	0	5	5	0	3	8	0	0
1	6138027	.	A	T	4	3	7	0	1	8	0	0
1	6144223	.	A	G	7	7	14	0	0	14	0	0
1	6146514	.	C	T	4	5	9	0	0	9	0	0
1	6146553	.	C	T	5	5	10	0	0	10	0	0
1	6146698	.	G	T	2	4	6	0	2	8	0	0
1	6149942	.	T	C	2	10	12	0	1	13	0	0
1	6153251	.	T	C	2	5	7	0	0	7	0	0
1	6153397	.	A	G	2	0	2	0	6	8	0	0
1	6153451	.	G	A	4	8	12	1	0	13	0	0
1	6158360	.	G	T	0	5	5	0	9	14	0	0
1	6158557	.	T	G	2	8	10	0	0	10	0	0
1	6165150	.	A	G	12	12	24	0	0	24	0	0
1	6165213	.	C	T	16	4	20	0	0	20	0	0
1	6165318	.	A	C	17	8	25	0	1	26	0	0
1	6167421	.	A	G	9	0	9	0	6	15	0	0
1	6168264	.	G	A	7	13	20	0	2	22	0	0
1	6168346	.	T	A	22	10	32	0	1	33	0	0
1	6168411	.	G	C	21	11	32	0	1	33	0	0
1	6168417	.	G	T	4	13	17	0	19	36	0	0
1	6168568	.	C	G	14	6	20	0	0	20	0	0
1	6168858	.	A	G	12	0	12	0	15	27	0	0
1	6168875	.	G	A	12	14	26	0	2	28	0	0
1	6168925	.	T	C	13	8	21	0	1	22	0	0
1	6169155	.	C	T	8	6	14	0	0	14	0	0
1	6169208	.	C	T	12	12	24	0	0	24	0	0
1	6169232	.	T	C	7	12	19	0	2	21	0	0
1	6169279	.	G	A	7	11	18	0	1	19	0	0
1	6169317	.	C	T	9	7	16	0	0	16	0	0
1	6169378	.	C	T	10	5	15	0	1	16	0	0
1	6169387	.	G	C	15	8	23	0	0	23	0	0
1	6169462	.	T	C	20	7	27	0	0	27	0	0
1	6169494	.	A	G	14	0	14	0	9	23	0	0
1	6169688	.	A	T	3	2	5	0	1	6	0	0
1	6169691	.	C	T	2	3	5	0	0	5	0	0
1	6169765	.	C	T	1	2	3	0	0	3	0	0
1	6173631	.	T	C	11	4	15	0	0	15	0	0
1	6175280	.	G	A	1	7	8	0	6	14	0	0
1	6185218	.	A	G	6	6	12	0	1	13	0	0
1	6185236	.	T	G	2	5	7	0	0	7	0	0
1	6185259	.	T	G	10	7	17	0	0	17	0	0
1	6185280	.	T	A	12	8	20	0	0	20	0	0
1	6185320	.	T	A	12	4	16	0	3	19	0	0
1	6185326	.	A	C	16	4	20	0	0	20	0	0
1	6185411	.	C	T	2	2	4	0	1	5	0	0
1	6185461	.	C	T	2	4	6	0	0	6	0	0
1	6190003	.	A	G	10	5	15	0	1	16	0	0
1	6190127	.	A	G	5	11	16	0	1	17	0	0
1	6199003	.	T	C	18	9	27	0	0	27	0	0
1	6201976	.	C	T	12	8	20	0	0	20	0	0
1	6206978	.	C	T	8	5	13	0	0	13	0	0
1	6207041	.	A	G	9	11	20	0	1	21	0	0
1	6209632	.	G	A	2	9	11	0	10	21	0	0
1	6209662	.	T	G	11	12	23	0	2	25	0	0
1	6209743	.	A	T	12	10	22	0	0	22	0	0
1	6209746	.	G	A	2	9	11	0	9	20	0	0
1	6210190	.	T	G	11	0	11	0	9	20	0	0
1	6210243	.	T	C	14	14	28	0	3	31	0	0
1	6210471	.	T	C	12	9	21	0	0	21	0	0
1	6225563	.	G	A	0	3	3	0	5	8	0	0
1	6225909	.	A	C	5	3	8	0	0	8	0	0
1	6225945	.	G	A	1	5	6	0	0	6	0	0
1	6226084	.	A	G	2	3	5	0	1	6	0	0
1	6231293	.	T	C	3	2	5	0	0	5	0	0
1	6231305	.	G	A	3	2	5	0	0	5	0	0
1	6238639	.	C	T	2	2	4	0	1	5	0	0
1	6240444	.	T	G	8	3	11	0	0	11	0	0
1	6240474	.	A	C	3	5	8	0	1	9	0	0
1	6241379	.	G	T	2	4	6	0	5	11	0	0
1	6243549	.	A	G	6	0	6	0	4	10	0	0
1	6243975	.	T	G	9	5	14	0	0	14	0	0
1	6244279	.	A	T	2	2	4	0	0	4	0	0
1	6244281	.	G	C	2	2	4	0	0	4	0	0
1	6252839	.	T	C	1	5	6	0	0	6	0	0
1	6254769	.	A	G	3	7	10	0	0	10	0	0
1	6262842	.	G	A	0	2	2	0	5	7	0	0
1	6262918	.	C	T	4	4	8	0	0	8	0	0
1	6269116	.	T	C	5	5	10	0	1	11	0	0
1	6271664	.	A	G	7	5	12	0	0	12	0	0
1	6271712	.	T	C	9	6	15	0	1	16	0	0
1	6357164	.	A	C	6	7	13	0	0	13	0	0
1	6357840	.	A	G	8	8	16	0	0	16	0	0
1	6364196	.	T	C	9	6	15	0	0	15	0	0
1	6365673	.	A	G	4	4	8	0	1	9	0	0
1	6365793	.	A	C	8	4	12	0	0	12	0	0
1	6366000	.	T	A	5	5	10	0	0	10	0	0
1	6366024	.	A	C	3	4	7	0	1	8	0	0
1	6366061	.	C	T	3	2	5	0	0	5	0	0
1	6403712	.	A	T	9	4	13	0	0	13	0	0
1	6404145	.	G	C	7	8	15	0	0	15	0	0
1	6404205	.	A	T	13	4	17	0	0	17	0	0
1	6404250	.	G	A	7	7	14	0	0	14	0	0
1	6404659	.	G	A	8	5	13	0	0	13	0	0
1	6429608	.	A	G	9	7	16	0	0	16	0	0
1	6429646	.	A	G	9	6	15	0	1	16	0	0
1	6494126	.	A	G	7	4	11	0	0	11	0	0
1	6494215	.	T	G	6	6	12	0	0	12	0	0
1	6494227	.	C	T	0	6	6	0	5	11	0	0
1	6494338	.	C	T	6	3	9	0	0	9	0	0
1	6646688	.	T	G	6	0	6	0	9	15	0	0
1	6648724	.	T	C	3	12	15	0	2	17	0	0
1	6662858	.	A	T	13	12	25	0	1	26	0	0
1	6663617	.	T	C	3	3	6	0	0	6	0	0
1	6663623	.	C	A	3	3	6	0	0	6	0	0
1	6663920	.	T	G	9	4	13	0	2	15	0	0
1	6663925	.	G	T	9	3	12	0	2	14	0	0
1	6667440	.	T	A	2	3	5	0	0	5	0	0
1	6667477	.	A	C	3	2	5	0	0	5	0	0
1	6883866	.	C	G	3	4	7	0	0	7	0	0
1	6884604	.	G	A	0	4	4	0	1	5	0	0
1	6884625	.	C	A	2	3	5	0	0	5	0	0
1	6887959	.	T	C	1	0	1	0	2	3	0	0
1	6887969	.	G	T	2	2	4	0	0	4	0	0
1	6909761	.	T	C	3	4	7	0	1	8	0	0
1	6918865	.	G	A	3	3	6	0	0	6	0	0
1	6924361	.	A	G	6	6	12	0	0	12	0	0
1	6924578	.	C	T	4	4	8	0	0	8	0	0
1	6924761	.	G	A	0	4	4	0	4	8	0	0
1	6924858	.	G	C	4	3	7	0	0	7	0	0
1	6925300	.	A	C	1	1	2	0	0	2	0	0
1	6925307	.	G	T	1	2	3	0	0	3	0	0
1	7438277	.	T	C	1	3	4	0	0	4	0	0
1	7438289	.	T	C	1	2	3	0	1	4	0	0
1	7447427	.	C	A	1	2	3	0	0	3	0	0
1	7447436	.	T	C	2	2	4	0	0	4	0	0
1	7518644	.	C	T	26	25	51	0	0	51	0	0
1	7522455	.	T	C	13	20	33	0	2	35	0	0
1	7523258	.	A	C	26	20	46	0	0	46	0	0
1	7523264	.	C	T	25	21	46	0	2	48	0	0
1	7526839	.	G	A	15	15	30	0	2	32	0	0
1	7528289	.	G	C	1	26	27	0	27	54	0	0
1	7529752	.	G	A	38	22	60	0	0	60	0	0
1	7530123	.	C	T	22	28	50	0	6	56	0	0
1	7538822	.	C	T	24	27	51	0	1	52	0	0
1	7539053	.	G	C	15	15	30	0	0	30	0	0
1	7554068	.	T	C	1	4	5	0	1	6	0	0
1	7559902	.	G	A	2	14	16	1	42	59	0	0
1	7634834	.	T	C	3	0	3	0	2	5	0	0
1	7662571	.	T	C	17	26	43	0	0	43	0	0
1	7662628	.	G	A	19	20	39	0	0	39	0	0
1	7662723	.	T	A	16	18	34	0	1	36	1	0
1	7662728	.	G	A	15	18	33	0	2	35	0	0
1	7662880	.	A	T	21	27	48	0	1	49	0	0
1	7670535	.	C	T	35	20	55	0	4	59	0	0
1	7672794	.	T	C	34	25	59	0	4	63	0	0
1	7672809	.	C	T	34	26	60	0	0	60	0	0
1	7673070	.	C	T	23	20	43	0	6	49	0	0
1	7673129	.	C	A	21	29	50	0	1	51	0	0
1	7673198	.	A	G	18	16	34	0	0	34	0	0
1	7682949	.	G	A	8	4	12	0	0	12	0	0
1	7864780	.	A	G	4	3	7	0	0	7	0	0
1	7875057	.	G	A	2	5	7	0	0	7	0	0
1	7894186	.	C	T	1	2	3	0	1	4	0	0
1	8022495	.	C	T	17	8	25	0	0	25	0	0
1	8022532	.	A	G	18	8	26	0	0	26	0	0
1	8022606	.	T	C	13	7	20	0	0	20	0	0
1	8022682	.	C	T	3	17	20	0	11	31	0	0
1	8023433	.	C	T	19	15	34	0	1	35	0	0
1	8023587	.	A	G	17	17	34	0	3	37	0	0
1	8023730	.	C	T	20	13	33	0	3	36	0	0
1	8024087	.	G	A	21	16	37	1	0	38	0	0
1	8025863	.	C	T	20	16	36	0	1	37	0	0
1	8026146	.	C	T	17	21	38	0	1	39	0	0
1	8026148	.	T	G	17	21	38	0	1	39	0	0
1	8026293	.	G	T	17	13	30	0	1	31	0	0
1	8026345	.	C	T	15	22	37	0	3	40	0	0
1	8026415	.	C	T	2	13	15	0	20	35	0	0
1	8026521	.	C	A	2	17	19	0	30	49	0	0
1	8026565	.	C	T	21	16	37	0	1	38	0	0
1	8026924	.	T	A	15	16	31	0	3	34	0	0
1	8028177	.	T	A	13	15	28	0	1	29	0	0
1	8028652	.	G	A	27	19	46	0	0	46	0	0
1	8028688	.	C	A	21	24	45	0	1	46	0	0
1	8028727	.	G	A	15	24	39	0	2	41	0	0
1	8028811	.	C	T	2	20	22	0	21	43	0	0
1	8032800	.	T	C	13	8	21	0	0	21	0	0
1	8032947	.	G	A	24	16	40	0	2	42	0	0
1	8032986	.	A	G	20	16	36	0	0	36	0	0
1	8049495	.	C	T	2	12	14	0	9	23	0	0
1	8051513	.	G	A	16	9	25	0	0	25	0	0
1	8055927	.	T	C	16	0	16	0	10	26	0	0
1	8055954	.	A	G	15	9	24	0	0	24	0	0
1	8058005	.	A	G	11	12	23	0	3	26	0	0
1	8129147	.	A	T	2	4	6	0	0	6	0	0
1	8129153	.	T	C	2	0	2	0	3	5	0	0
1	8131090	.	T	C	1	2	3	0	0	3	0	0
1	8159982	.	C	T	4	2	6	0	0	6	0	0
1	8165443	.	A	C	4	3	7	0	1	8	0	0
1	8165609	.	C	T	7	6	13	0	0	13	0	0
1	8165643	.	T	C	5	4	9	0	0	9	0	0
1	8165667	.	T	C	2	4	6	0	0	6	0	0
1	8165741	.	T	C	4	3	7	0	0	7	0	0
1	8166788	.	A	T	15	11	26	0	1	27	0	0
1	8166992	.	A	G	7	7	14	0	0	14	0	0
1	8167118	.	C	A	3	3	6	0	0	6	0	0
1	8167319	.	A	G	3	3	6	0	0	6	0	0
1	8167368	.	G	A	11	6	17	0	0	17	0	0
1	8167508	.	A	G	11	12	23	0	0	23	0	0
1	8167526	.	C	T	11	12	23	0	0	23	0	0
1	8167570	.	C	G	8	12	20	0	0	20	0	0
1	8167668	.	G	A	9	12	21	0	0	21	0	0
1	8169262	.	C	T	11	14	25	0	0	25	0	0
1	8169268	.	C	T	11	9	20	0	6	26	0	0
1	8169361	.	G	A	4	12	16	0	0	16	0	0
1	8185072	.	G	A	13	12	25	0	1	26	0	0
1	8185103	.	G	A	10	13	23	0	1	24	0	0
1	8189518	.	G	T	10	10	20	0	0	20	0	0
1	8192188	.	C	G	4	6	10	0	0	10	0	0
1	8192192	.	A	G	4	6	10	0	1	11	0	0
1	8192344	.	A	C	11	14	25	0	0	25	0	0
1	8192382	.	T	A	7	5	12	0	1	13	0	0
1	8383213	.	T	G	1	2	3	0	0	3	0	0
1	8383303	.	A	G	1	2	3	0	0	3	0	0
1	8401475	.	T	C	1	6	7	0	0	7	0	0
1	8403409	.	C	T	4	3	7	0	0	7	0	0
1	8403438	.	A	C	5	2	7	0	0	7	0	0
1	8416565	.	T	A	28	31	59	0	0	59	0	0
1	8416629	.	T	G	23	21	44	0	1	45	0	0
1	8416820	.	C	T	5	5	10	0	0	10	0	0
1	8417896	.	T	C	19	20	39	0	1	42	2	0
1	8417943	.	A	G	10	12	22	0	1	23	0	0
1	8418118	.	C	G	5	8	13	1	4	18	0	0
1	8418126	.	A	C	8	0	8	1	9	18	0	0
1	8422521	.	A	G	33	22	55	0	1	56	0	0
1	8424738	.	C	T	2	27	29	0	20	50	1	0
1	8424804	.	C	T	29	15	44	0	1	45	0	0
1	8424813	.	A	G	28	19	47	0	0	47	0	0
1	8508755	.	G	A	0	4	4	0	10	14	0	0
1	8508809	.	G	T	12	11	23	0	1	24	0	0
1	8508950	.	T	C	8	6	14	0	1	15	0	0
1	8511602	.	C	T	18	10	28	1	2	31	0	0
1	8511778	.	G	T	0	14	14	0	12	26	0	0
1	8516407	.	G	A	1	15	16	0	15	31	0	0
1	8516443	.	C	G	14	11	25	0	3	28	0	0
1	8516552	.	A	G	7	12	19	0	1	20	0	0
1	8524300	.	A	C	1	2	3	0	0	3	0	0
1	8524315	.	G	A	2	2	4	0	0	4	0	0
1	8527205	.	G	T	4	3	7	0	0	7	0	0
1	8529745	.	G	A	1	6	7	0	3	10	0	0
1	8529888	.	G	A	1	3	4	0	4	8	0	0
1	8530336	.	G	A	0	3	3	0	1	4	0	0
1	8530544	.	T	A	3	2	5	0	0	5	0	0
1	8530548	.	T	G	3	2	5	0	0	5	0	0
1	8530943	.	G	A	1	2	3	0	2	5	0	0
1	8531311	.	C	T	3	4	7	0	0	7	0	0
1	8531417	.	G	A	6	4	10	0	0	10	0	0
1	8531494	.	A	G	3	5	8	0	1	9	0	0
1	8531653	.	T	C	2	2	4	0	0	4	0	0
1	8543337	.	T	A	4	3	7	0	0	7	0	0
1	8543380	.	G	A	3	6	9	0	1	10	0	0
1	8543390	.	C	T	3	6	9	0	2	11	0	0
1	8543707	.	A	G	4	4	8	0	0	8	0	0
1	8544457	.	C	T	5	3	8	0	0	8	0	0
1	8544483	.	G	A	3	3	6	0	0	6	0	0
1	8547315	.	G	C	2	0	2	0	5	7	0	0
1	8548647	.	T	A	6	2	8	0	0	8	0	0
1	8550143	.	T	C	1	0	1	0	3	4	0	0
1	8550146	.	T	C	1	3	4	0	0	4	0	0
1	8555582	.	C	G	9	4	13	0	0	13	0	0
1	8560072	.	A	G	3	2	5	0	0	5	0	0
1	8560237	.	C	T	7	2	9	0	0	9	0	0
1	8560266	.	C	T	5	4	9	0	0	9	0	0
1	8560289	.	C	T	5	3	8	0	0	8	0	0
1	8563728	.	C	T	9	6	15	0	0	15	0	0
1	8563755	.	A	G	7	3	10	0	0	10	0	0
1	8563792	.	G	A	4	4	8	0	0	8	0	0
1	8564058	.	C	T	4	3	7	0	0	7	0	0
1	8566237	.	G	A	6	6	12	0	0	12	0	0
1	8566485	.	T	C	2	6	8	0	1	9	0	0
1	8566545	.	T	C	3	4	7	0	0	7	0	0
1	8601971	.	A	T	11	6	17	0	3	21	1	0
1	8601990	.	A	T	16	12	28	0	0	28	0	0
1	8604175	.	C	T	11	5	16	0	0	16	0	0
1	8606561	.	C	T	8	13	21	0	0	21	0	0
1	8606611	.	T	C	4	13	17	0	0	17	0	0
1	8606644	.	G	A	16	6	22	0	1	23	0	0
1	8607487	.	C	T	9	14	23	0	0	23	0	0
1	8607547	.	C	T	12	6	18	0	0	18	0	0
1	8607556	.	T	C	11	5	16	0	3	19	0	0
1	8608008	.	T	C	11	7	18	0	1	19	0	0
1	8608180	.	G	A	2	16	18	0	5	23	0	0
1	8610451	.	G	A	0	18	18	0	11	29	0	0
1	8638537	.	T	G	5	4	9	0	1	10	0	0
1	8639877	.	G	A	2	3	5	0	0	5	0	0
1	8642800	.	C	T	7	6	13	0	0	13	0	0
1	8642824	.	A	T	5	4	9	0	0	9	0	0
1	8642938	.	A	G	4	5	9	0	0	9	0	0
1	8642953	.	C	T	5	5	10	0	1	11	0	0
1	8643784	.	G	T	3	4	7	0	1	8	0	0
1	8643805	.	A	G	5	2	7	0	0	7	0	0
1	8646265	.	C	T	2	2	4	0	0	4	0	0
1	8646915	.	G	A	1	2	3	0	0	3	0	0
1	8649726	.	A	G	49	48	97	2	0	99	0	0
1	8649865	.	C	T	44	32	76	1	1	78	0	0
1	8649988	.	A	G	36	38	74	0	8	82	0	0
1	8649994	.	A	T	34	43	77	0	2	79	0	0
1	8650317	.	G	A	30	42	72	0	3	75	0	0
1	8650371	.	C	T	33	39	72	0	1	73	0	0
1	8650544	.	G	A	4	10	14	0	0	14	0	0
1	8650830	.	T	G	9	4	13	0	0	13	0	0
1	8651036	.	G	A	35	35	70	0	6	76	0	0
1	8651060	.	T	C	44	30	74	0	1	76	1	0
1	8651576	.	G	A	41	33	74	2	2	78	0	0
1	8652655	.	C	T	0	3	3	0	2	5	0	0
1	8662553	.	G	A	22	26	48	0	3	51	0	0
1	8663048	.	G	A	5	27	32	0	18	50	0	0
1	8663195	.	T	G	27	26	53	0	0	53	0	0
1	8663295	.	T	C	21	36	57	0	2	59	0	0
1	8667377	.	G	A	30	18	48	0	0	48	0	0
1	8667606	.	C	T	22	32	54	0	2	56	0	0
1	8668166	.	T	C	21	32	53	0	1	54	0	0
1	8668238	.	G	T	30	25	55	0	2	57	0	0
1	8668886	.	T	C	1	3	4	0	0	4	0	0
1	8668930	.	A	T	2	3	5	0	0	5	0	0
1	8669543	.	A	G	9	3	12	0	3	15	0	0
1	8669669	.	A	G	23	10	33	0	1	34	0	0
1	8669673	.	A	G	26	8	34	0	1	35	0	0
1	8669717	.	T	G	18	20	38	0	0	38	0	0
1	8669718	.	T	C	17	20	37	0	0	37	0	0
1	8669753	.	T	A	22	18	40	0	0	40	0	0
1	8669847	.	G	T	20	20	40	0	1	41	0	0
1	8670031	.	T	C	23	40	63	0	6	69	0	0
1	8670032	.	G	T	7	21	28	0	40	69	1	0
1	8670402	.	G	A	17	14	31	0	1	32	0	0
1	8694404	.	G	A	16	13	29	0	2	31	0	0
1	8698765	.	T	C	27	19	46	0	0	46	0	0
1	8701548	.	A	G	23	2	25	0	24	49	0	0
1	8702325	.	G	T	16	20	36	0	1	37	0	0
1	8702400	.	T	C	24	24	48	0	1	49	0	0
1	8764123	.	C	T	7	7	14	0	0	14	0	0
1	8764812	.	G	A	21	8	29	0	0	29	0	0
1	8765028	.	G	A	17	17	34	0	0	34	0	0
1	8765491	.	T	A	22	12	34	0	0	34	0	0
1	8765493	.	G	T	16	10	26	0	2	28	0	0
1	8766453	.	C	T	18	14	32	0	0	32	0	0
1	8766471	.	C	T	1	14	15	0	14	29	0	0
1	8766501	.	C	T	14	18	32	0	0	32	0	0
1	8766693	.	G	A	18	10	28	0	1	29	0	0
1	8766903	.	G	C	19	12	31	0	1	33	1	0
1	8770773	.	G	A	10	14	24	0	0	24	0	0
1	8771020	.	T	G	11	7	18	0	0	18	0	0
1	8773257	.	G	A	10	9	19	0	0	19	0	0
1	8773269	.	T	C	12	9	21	0	0	21	0	0
1	8773320	.	G	A	13	11	24	0	1	25	0	0
1	8776506	.	G	A	9	5	14	0	1	15	0	0
1	8777796	.	C	A	9	11	20	0	0	20	0	0
1	8917623	.	C	T	9	11	20	0	0	20	0	0
1	9044526	.	C	T	25	11	36	0	1	37	0	0
1	9044745	.	C	T	14	13	27	0	4	31	0	0
1	9051092	.	T	C	17	20	37	0	0	37	0	0
1	9064781	.	T	G	1	6	7	0	1	8	0	0
1	9064885	.	C	A	2	4	6	0	1	7	0	0
1	9074335	.	C	T	17	8	25	0	1	26	0	0
1	9118497	.	T	A	25	19	44	0	1	45	0	0
1	9123289	.	C	G	18	18	36	3	0	39	0	0
1	9153685	.	G	A	1	2	3	0	0	3	0	0
1	9155225	.	T	G	2	0	2	0	2	4	0	0
1	9161236	.	A	T	1	2	3	0	0	3	0	0
1	9169938	.	T	C	1	5	6	0	0	6	0	0
1	9225454	.	C	T	1	3	4	0	1	5	0	0
1	9261903	.	A	C	12	1	13	0	16	29	0	0
1	9261930	.	G	A	10	13	23	0	0	23	0	0
1	9262173	.	G	A	17	7	24	0	1	25	0	0
1	9262221	.	A	G	14	8	22	1	0	23	0	0
1	9265578	.	T	C	13	9	22	0	1	23	0	0
1	9270885	.	G	A	14	8	22	0	0	22	0	0
1	9270933	.	C	T	6	11	17	0	2	19	0	0
1	9273011	.	C	T	12	11	23	0	0	23	0	0
1	9273037	.	A	G	12	11	23	0	1	24	0	0
1	9273173	.	G	A	11	12	23	0	2	25	0	0
1	9273347	.	A	G	10	8	18	0	1	19	0	0
1	9278150	.	G	A	10	11	21	0	0	21	0	0
1	9290319	.	A	G	9	6	15	0	0	15	0	0
1	9290432	.	T	A	8	7	15	0	1	16	0	0
1	9290500	.	G	T	2	8	10	0	0	10	0	0
1	9292975	.	A	T	5	11	16	0	0	16	0	0
1	9293002	.	T	C	7	13	20	0	0	20	0	0
1	9293495	.	A	G	11	14	25	0	3	28	0	0
1	9499764	.	C	T	9	10	19	0	1	20	0	0
1	9500312	.	A	T	4	11	15	0	0	15	0	0
1	9500332	.	T	C	4	4	8	0	0	10	2	0
1	9500757	.	A	T	6	5	11	0	0	11	0	0
1	9500765	.	T	C	6	3	9	0	0	9	0	0
1	9500835	.	A	G	4	7	11	0	0	11	0	0
1	9500867	.	T	C	9	3	12	0	1	13	0	0
1	9500947	.	G	T	4	9	13	0	1	14	0	0
1	9500965	.	T	C	7	4	11	0	0	11	0	0
1	9500984	.	A	T	3	4	7	0	0	7	0	0
1	9501011	.	T	C	4	2	6	0	0	6	0	0
1	9501031	.	C	T	3	5	8	0	0	8	0	0
1	9501229	.	C	T	13	11	24	0	0	24	0	0
1	9501231	.	G	A	12	12	24	0	1	25	0	0
1	9501365	.	T	C	16	0	16	0	8	24	0	0
1	9501394	.	T	A	7	13	20	0	0	20	0	0
1	9508752	.	T	A	6	13	19	0	2	21	0	0
1	9510571	.	A	G	10	4	14	0	1	15	0	0
1	9510574	.	G	A	9	5	14	0	2	16	0	0
1	9512342	.	C	T	9	5	14	0	1	15	0	0
1	9516905	.	A	C	8	9	17	0	0	17	0	0
1	9517048	.	A	G	11	11	22	0	0	22	0	0
1	9517102	.	G	A	8	7	15	0	1	16	0	0
1	9519935	.	G	A	6	6	12	0	0	12	0	0
1	9520435	.	G	A	2	3	5	0	0	5	0	0
1	9523283	.	C	T	1	11	12	0	6	18	0	0
1	9527076	.	T	A	9	9	18	0	0	18	0	0
1	9557242	.	G	T	0	4	4	0	2	6	0	0
1	9557456	.	T	C	3	3	6	0	0	6	0	0
1	9618201	.	C	T	6	3	9	0	0	9	0	0
1	9618241	.	A	G	7	5	12	0	0	12	0	0
1	9708660	.	T	A	5	2	7	0	0	7	0	0
1	9708694	.	T	C	4	3	7	0	0	7	0	0
1	9708707	.	T	C	5	3	8	0	0	8	0	0
1	9708818	.	G	T	2	2	4	0	1	5	0	0
1	9708918	.	C	T	5	3	8	0	0	8	0	0
1	9709280	.	G	A	5	2	7	0	0	7	0	0
1	9709340	.	C	T	7	5	12	0	0	12	0	0
1	9709500	.	G	A	6	3	9	0	0	9	0	0
1	9710759	.	C	T	7	3	10	0	0	10	0	0
1	9710853	.	T	C	5	6	11	0	0	11	0	0
1	9711158	.	G	A	4	5	9	0	1	10	0	0
1	9711161	.	G	A	4	5	9	0	1	10	0	0
1	9711405	.	T	A	3	3	6	0	0	6	0	0
1	9711593	.	A	C	6	5	11	0	0	11	0	0
1	9711740	.	G	C	5	4	9	0	0	9	0	0
1	9711956	.	A	G	7	6	13	0	0	13	0	0
1	9712111	.	G	A	2	5	7	0	9	16	0	0
1	9712253	.	T	A	4	4	8	0	0	8	0	0
1	9712291	.	T	C	2	2	4	0	2	6	0	0
1	9741123	.	G	A	6	3	9	0	0	9	0	0
1	9793219	.	C	T	4	6	10	0	0	10	0	0
1	9793220	.	T	C	4	6	10	0	0	10	0	0
1	9808324	.	A	G	2	3	5	0	0	5	0	0
1	9808345	.	T	A	4	5	9	0	0	9	0	0
1	9808365	.	C	T	4	4	8	0	0	8	0	0
1	9808691	.	A	T	3	4	7	0	0	7	0	0
1	9865364	.	G	T	2	2	4	0	0	4	0	0
1	9866670	.	G	A	1	3	4	0	0	4	0	0
1	9873485	.	G	A	3	2	5	0	0	5	0	0
1	9873509	.	G	A	3	2	5	0	0	5	0	0
1	9873607	.	A	T	6	4	10	0	10	20	0	0
1	9873616	.	T	C	7	0	7	0	18	25	0	0
1	9873787	.	G	A	9	8	17	0	0	17	0	0
1	9877426	.	C	T	1	3	4	0	1	5	0	0
1	9877576	.	C	T	0	3	3	0	2	5	0	0
1	9880387	.	A	G	1	4	5	0	1	6	0	0
1	9883339	.	T	C	1	2	3	0	0	3	0	0
1	9885305	.	G	T	1	3	4	0	0	4	0	0
1	9914200	.	A	G	2	0	2	0	2	4	0	0
1	9919948	.	A	G	1	2	3	0	0	3	0	0
1	9920359	.	G	A	4	5	9	0	1	10	0	0
1	9920631	.	G	A	3	6	9	0	1	10	0	0
1	10646917	.	T	C	1	2	3	2	0	5	0	0
1	10669212	.	C	T	6	2	8	0	0	8	0	0
1	10675585	.	A	T	2	2	4	0	0	4	0	0
1	10680513	.	A	G	2	2	4	1	0	5	0	0
1	10680518	.	C	T	1	2	3	1	0	5	1	0
1	10683868	.	A	T	21	11	32	3	2	37	0	0
1	10683955	.	A	G	29	16	45	0	0	45	0	0
1	10683974	.	A	C	23	22	45	0	3	48	0	0
1	10684037	.	A	G	24	2	26	0	20	46	0	0
1	10684105	.	G	A	3	22	25	0	18	43	0	0
1	10688731	.	T	G	14	0	14	0	15	29	0	0
1	10692078	.	T	C	23	13	36	1	3	40	0	0
1	10692090	.	G	A	22	18	40	0	2	42	0	0
1	10736181	.	G	A	34	24	58	0	3	61	0	0
1	10738177	.	A	G	26	13	39	0	0	39	0	0
1	10738509	.	T	C	38	25	63	0	3	66	0	0
1	10738535	.	G	A	46	24	70	0	0	70	0	0
1	10738568	.	A	G	42	1	43	0	25	68	0	0
1	10738863	.	C	A	30	37	67	0	4	71	0	0
1	10841254	.	T	C	9	11	20	0	1	21	0	0
1	10841275	.	T	C	9	15	24	0	2	26	0	0
1	10841356	.	G	A	6	7	13	1	0	14	0	0
1	10885173	.	A	C	11	3	14	0	0	14	0	0
1	10885266	.	T	A	11	5	16	0	0	16	0	0
1	10897373	.	A	G	5	4	9	0	0	9	0	0
1	10901325	.	G	A	6	3	9	0	1	10	0	0
1	10912132	.	C	T	1	3	4	0	3	7	0	0
1	10918642	.	T	A	1	3	4	0	0	4	0	0
1	10944902	.	T	C	1	4	5	0	0	5	0	0
1	10950594	.	C	T	0	2	2	0	5	7	0	0
1	10950747	.	C	A	4	3	7	0	0	7	0	0
1	10950751	.	G	A	3	3	6	0	0	6	0	0
1	10952835	.	G	T	1	3	4	0	0	4	0	0
1	11001371	.	A	G	1	1	2	0	1	3	0	0
1	11001407	.	C	T	0	2	2	0	1	3	0	0
1	11117383	.	C	T	1	4	5	0	0	5	0	0
1	11124918	.	C	T	1	3	4	0	1	5	0	0
1	11125074	.	T	A	2	3	5	0	1	6	0	0
1	11125149	.	C	T	0	5	5	0	6	11	0	0
1	11125177	.	C	T	4	7	11	0	0	11	0	0
1	11125195	.	C	T	5	6	11	0	0	11	0	0
1	11125237	.	G	A	2	7	9	0	0	9	0	0
1	11125249	.	A	C	2	8	10	0	0	11	1	0
1	11127938	.	G	A	9	6	15	0	1	16	0	0
1	11128515	.	C	A	1	11	12	0	4	16	0	0
1	11130713	.	G	A	5	3	8	0	1	9	0	0
1	11132905	.	C	T	1	2	3	0	3	6	0	0
1	11136648	.	G	A	2	5	7	0	0	7	0	0
1	11141082	.	C	T	3	5	8	0	0	8	0	0
1	11144295	.	T	C	4	4	8	0	0	8	0	0
1	11150984	.	G	A	2	7	9	0	0	9	0	0
1	11157060	.	T	C	3	5	8	0	0	8	0	0
1	11194724	.	C	T	0	4	4	0	3	7	0	0
1	11207307	.	A	G	3	4	7	0	0	7	0	0
1	11216633	.	A	G	2	4	6	0	0	6	0	0
1	11217430	.	G	A	3	3	6	0	0	6	0	0
1	11230467	.	T	C	1	0	1	0	3	4	0	0
1	11267625	.	G	A	1	2	3	0	0	3	0	0
1	11275073	.	A	G	6	3	9	0	0	9	0	0
1	11275171	.	T	C	2	0	2	0	2	4	0	0
1	11280839	.	C	A	2	6	8	0	0	8	0	0
1	11364423	.	G	A	1	2	3	0	0	3	0	0
1	11364435	.	T	A	2	3	5	0	0	5	0	0
1	11366308	.	G	A	2	3	5	0	0	5	0	0
1	11670963	.	T	C	5	2	7	0	0	7	0	0
1	11671042	.	T	C	6	3	9	0	0	9	0	0
1	11671059	.	A	G	6	5	11	0	0	11	0	0
1	11671355	.	C	A	10	8	18	0	0	18	0	0
1	11671527	.	G	A	4	4	8	0	0	8	0	0
1	11671580	.	C	T	11	5	16	0	0	16	0	0
1	11695068	.	C	A	5	0	5	0	0	5	0	0
1	11783388	.	T	C	15	18	33	0	2	35	0	0
1	11783410	.	T	C	20	13	33	0	1	34	0	0
1	11783504	.	T	C	28	13	41	0	2	43	0	0
1	11783650	.	T	C	28	22	50	0	2	52	0	0
1	11784609	.	T	C	31	13	44	0	2	46	0	0
1	11784679	.	T	C	17	34	51	0	1	52	0	0
1	15138708	.	A	C	11	13	24	0	0	26	2	0
1	15139336	.	T	C	10	8	18	0	0	18	0	0
1	15139576	.	G	A	6	4	10	0	1	11	0	0
1	15140407	.	C	T	11	11	22	0	2	24	0	0
1	15142631	.	T	C	20	8	28	0	3	31	0	0
1	15200277	.	T	C	26	19	45	0	1	47	1	0
1	15200440	.	A	G	21	2	23	0	15	38	0	0
1	15200517	.	A	T	19	21	40	0	0	41	1	0
1	15200595	.	A	G	10	22	32	0	1	33	0	0
1	15200730	.	G	C	3	18	21	0	13	34	0	0
1	15200777	.	T	C	18	11	29	0	7	36	0	0
1	15201264	.	A	C	17	17	34	0	0	35	1	0
1	15201491	.	A	G	21	21	42	0	0	42	0	0
1	15201603	.	C	T	11	15	26	0	1	27	0	0
1	15201732	.	T	G	16	9	25	0	1	26	0	0
1	15201889	.	G	T	0	15	15	0	12	27	0	0
1	15201931	.	A	T	10	16	26	0	1	27	0	0
1	15202287	.	G	A	23	16	39	0	1	40	0	0
1	15202716	.	G	T	10	21	31	0	0	31	0	0
1	15203038	.	T	C	20	20	40	0	1	41	0	0
1	15203056	.	T	C	13	20	33	0	2	35	0	0
1	15230428	.	C	G	5	4	9	0	0	9	0	0
1	15240166	.	C	T	9	5	14	0	0	14	0	0
1	15242916	.	C	T	7	13	20	0	0	20	0	0
1	15253338	.	T	A	7	4	11	1	0	12	0	0
1	15253732	.	T	G	12	4	16	0	0	16	0	0
1	15254249	.	A	G	13	0	13	0	5	18	0	0
1	15254351	.	T	G	11	9	20	0	1	21	0	0
1	15254468	.	T	C	5	2	7	0	6	13	0	0
1	15254866	.	G	A	1	10	11	0	9	20	0	0
1	15254973	.	A	T	6	11	17	0	0	17	0	0
1	15255308	.	C	T	5	5	10	0	0	10	0	0
1	15255411	.	T	C	10	7	17	0	0	17	0	0
1	15255424	.	A	G	6	0	6	0	7	13	0	0
1	15255468	.	G	A	5	5	10	0	2	12	0	0
1	15255597	.	A	T	10	4	14	0	0	15	1	0
1	15255799	.	G	A	2	3	5	0	0	5	0	0
1	15255877	.	A	C	3	3	6	0	0	6	0	0
1	15259036	.	G	A	5	9	14	0	0	14	0	0
1	15259178	.	C	A	7	2	9	0	1	10	0	0
1	15269519	.	C	A	4	6	10	0	1	11	0	0
1	15277911	.	C	G	5	2	7	0	0	7	0	0
1	15284984	.	T	C	4	5	9	0	1	10	0	0
1	15293547	.	G	T	13	5	18	0	0	18	0	0
1	15294701	.	C	T	2	10	12	0	9	21	0	0
1	15297504	.	C	T	1	6	7	0	3	10	0	0
1	15306233	.	G	A	6	6	12	0	0	12	0	0
1	15306320	.	T	C	5	5	10	0	3	13	0	0
1	15311846	.	A	G	3	8	11	0	1	12	0	0
1	15312410	.	C	T	8	8	16	0	0	16	0	0
1	15312702	.	A	T	9	4	13	0	0	15	2	0
1	15312766	.	C	G	5	5	10	0	0	10	0	0
1	15312813	.	A	G	4	6	10	0	0	10	0	0
1	15312984	.	T	C	3	2	5	0	1	6	0	0
1	15313079	.	T	C	3	2	5	0	0	5	0	0
1	15313083	.	A	G	3	2	5	0	0	5	0	0
1	15313205	.	C	T	0	3	3	0	4	7	0	0
1	15313229	.	T	G	4	3	7	0	1	8	0	0
1	15313245	.	A	C	6	4	10	0	1	11	0	0
1	15313302	.	G	A	6	5	11	0	0	11	0	0
1	15491623	.	T	A	1	2	3	0	0	3	0	0
1	15712307	.	G	A	6	2	8	0	0	8	0	0
1	15712356	.	G	T	4	2	6	0	0	6	0	0
1	15764411	.	C	A	0	3	3	0	6	9	0	0
1	16127926	.	C	T	20	17	37	0	1	38	0	0
1	16127962	.	G	A	21	21	42	0	0	42	0	0
1	16152840	.	G	A	3	21	24	0	20	44	0	0
1	16153607	.	G	A	19	23	42	0	0	42	0	0
1	16548908	.	C	T	1	5	6	0	0	6	0	0
1	16559907	.	T	C	4	5	9	0	1	10	0	0
1	16565049	.	C	A	4	4	8	0	0	8	0	0
1	16574059	.	G	T	0	11	11	0	16	27	0	0
1	16574149	.	C	T	2	4	6	0	0	6	0	0
1	16574154	.	T	C	2	4	6	0	0	6	0	0
1	16574214	.	G	T	5	3	8	0	0	8	0	0
1	16574417	.	G	A	11	8	19	0	1	20	0	0
1	16609231	.	C	T	10	14	24	0	1	25	0	0
1	16614590	.	T	C	19	14	33	0	1	34	0	0
1	16616881	.	A	T	23	21	44	0	1	45	0	0
1	16617296	.	T	C	7	8	15	0	0	15	0	0
1	16633611	.	T	A	10	9	19	0	0	19	0	0
1	16633629	.	C	T	13	8	21	0	0	21	0	0
1	16633665	.	T	C	11	12	23	0	1	24	0	0
1	16634129	.	C	T	4	9	13	0	2	15	0	0
1	16634654	.	A	G	7	9	16	0	1	17	0	0
1	16635013	.	C	T	13	4	17	0	1	18	0	0
1	16635039	.	G	A	1	10	11	0	9	20	0	0
1	16635341	.	T	C	7	9	16	0	0	16	0	0
1	16635596	.	C	T	10	5	15	0	0	15	0	0
1	16637853	.	G	A	7	14	21	0	0	21	0	0
1	16637955	.	T	C	17	14	31	0	1	32	0	0
1	16638189	.	G	A	17	11	28	0	0	28	0	0
1	16638464	.	T	C	9	9	18	0	0	18	0	0
1	16638575	.	C	T	10	4	14	0	1	15	0	0
1	16639396	.	A	G	14	9	23	0	1	24	0	0
1	16639501	.	T	C	15	20	35	0	0	35	0	0
1	16639732	.	C	T	11	11	22	0	0	22	0	0
1	16640081	.	G	T	11	18	29	0	1	30	0	0
1	16640138	.	A	G	11	0	11	0	15	26	0	0
1	16640277	.	T	C	12	7	19	0	0	19	0	0
1	16642684	.	T	C	15	10	25	0	2	27	0	0
1	16642770	.	G	A	9	9	18	0	2	20	0	0
1	16646269	.	A	G	16	10	26	0	1	27	0	0
1	16646372	.	G	A	8	16	24	0	1	25	0	0
1	16646405	.	C	T	6	13	19	0	0	19	0	0
1	16646499	.	C	T	8	9	17	0	0	17	0	0
1	16646833	.	C	G	8	0	8	0	18	26	0	0
1	16646848	.	T	A	15	6	21	0	1	22	0	0
1	16647928	.	G	T	15	9	24	0	3	27	0	0
1	16649950	.	C	A	14	11	25	0	1	26	0	0
1	16650067	.	T	A	17	10	27	0	0	27	0	0
1	16650350	.	T	A	12	11	23	0	0	23	0	0
1	16650433	.	G	A	8	13	21	0	1	22	0	0
1	16650463	.	C	T	14	9	23	0	0	23	0	0
1	16653552	.	A	T	7	7	14	0	0	14	0	0
1	16653655	.	C	T	12	5	17	0	0	17	0	0
1	16653923	.	T	C	15	12	27	0	0	27	0	0
1	16653991	.	G	C	9	5	14	0	0	14	0	0
1	16654572	.	A	G	8	4	12	0	2	14	0	0
1	16654657	.	T	G	5	7	12	0	0	12	0	0
1	16654898	.	A	G	12	3	15	0	0	15	0	0
1	16654910	.	G	A	12	3	15	0	0	15	0	0
1	16655077	.	C	T	6	8	14	0	1	15	0	0
1	16655134	.	G	A	9	9	18	0	1	19	0	0
1	16656828	.	C	T	7	4	11	0	0	11	0	0
1	16657862	.	T	C	7	0	7	0	5	12	0	0
1	16675197	.	G	A	2	2	4	0	0	4	0	0
1	16675380	.	A	T	4	9	13	0	1	14	0	0
1	16675407	.	T	C	5	0	5	0	4	9	0	0
1	16675564	.	T	A	5	10	15	0	1	16	0	0
1	16675615	.	T	C	6	0	6	0	14	20	0	0
1	16679950	.	G	T	7	11	18	0	2	20	0	0
1	16679956	.	A	T	6	12	18	0	0	18	0	0
1	16688911	.	G	T	10	5	15	0	2	17	0	0
1	16688943	.	T	C	1	2	3	0	0	3	0	0
1	16688950	.	C	A	1	2	3	0	0	3	0	0
1	17446171	.	C	T	8	2	10	0	0	10	0	0
1	17481349	.	A	T	4	5	9	0	0	9	0	0
1	17481676	.	T	C	5	2	7	0	0	7	0	0
1	17482356	.	C	T	7	2	9	0	0	9	0	0
1	17482898	.	T	A	8	4	12	0	0	12	0	0
1	17482970	.	C	T	7	3	10	0	0	10	0	0
1	17483809	.	C	A	7	3	10	0	0	10	0	0
1	17484209	.	T	C	7	6	13	0	0	13	0	0
1	17484383	.	A	C	5	9	14	0	1	15	0	0
1	17484724	.	A	G	15	7	22	0	0	22	0	0
1	17487029	.	T	C	6	5	11	0	1	12	0	0
1	17487170	.	A	G	9	1	10	0	10	20	0	0
1	17491536	.	C	T	7	3	10	0	2	12	0	0
1	17496233	.	C	A	10	8	18	0	1	19	0	0
1	17496245	.	T	C	9	13	22	0	1	23	0	0
1	17496394	.	C	T	13	10	23	0	1	24	0	0
1	17496506	.	A	G	15	10	25	0	1	26	0	0
1	17497479	.	C	T	11	8	19	0	0	19	0	0
1	17500257	.	T	C	10	8	18	0	1	19	0	0
1	17500275	.	A	G	10	0	10	0	12	22	0	0
1	17505138	.	T	C	17	13	30	0	1	31	0	0
1	17505676	.	A	G	11	14	25	0	1	26	0	0
1	17505759	.	T	C	9	10	19	0	0	19	0	0
1	17509715	.	C	T	9	12	21	0	1	22	0	0
1	17509754	.	T	C	10	16	26	0	1	27	0	0
1	17510038	.	T	C	9	14	23	0	1	24	0	0
1	17513463	.	C	T	12	29	41	0	2	43	0	0
1	17513496	.	T	C	21	23	44	0	0	44	0	0
1	17513562	.	A	G	14	2	16	0	18	34	0	0
1	17513574	.	T	A	12	23	35	0	2	37	0	0
1	17515145	.	G	C	10	12	22	0	0	22	0	0
1	17522001	.	C	A	21	16	37	0	6	43	0	0
1	17522031	.	T	C	23	19	42	0	1	44	1	0
1	17522098	.	T	A	16	26	42	0	2	44	0	0
1	17522107	.	T	C	18	27	45	0	0	45	0	0
1	17522249	.	G	T	18	15	33	0	5	38	0	0
1	17522313	.	C	T	13	12	25	0	1	26	0	0
1	17522647	.	C	T	17	13	30	0	1	31	0	0
1	17522755	.	C	T	15	13	28	2	2	32	0	0
1	17522868	.	A	G	24	0	24	0	21	45	0	0
1	17522923	.	C	T	17	22	39	0	4	43	0	0
1	17523030	.	A	G	13	0	13	0	11	24	0	0
1	17523054	.	T	C	11	13	24	0	1	25	0	0
1	17523080	.	T	C	13	12	25	0	0	25	0	0
1	17523119	.	T	A	17	17	34	0	0	34	0	0
1	17523170	.	A	G	12	16	28	0	0	28	0	0
1	17523350	.	T	C	11	15	26	0	1	27	0	0
1	17523562	.	T	C	5	3	8	1	0	9	0	0
1	17523592	.	G	C	9	6	15	1	0	16	0	0
1	17523603	.	A	G	13	7	20	1	0	22	1	0
1	17523891	.	G	A	18	21	39	0	1	40	0	0
1	17523934	.	A	G	23	0	23	0	11	34	0	0
1	17524150	.	A	T	16	12	28	0	0	28	0	0
1	17524401	.	T	A	6	2	8	0	0	8	0	0
1	17524508	.	G	C	6	8	14	0	3	17	0	0
1	17524562	.	T	C	14	18	32	0	0	32	0	0
1	17531731	.	C	A	6	7	13	0	0	13	0	0
1	17531762	.	T	A	5	8	13	0	0	13	0	0
1	17534533	.	T	A	7	6	13	0	1	14	0	0
1	17534599	.	G	A	4	4	8	0	0	8	0	0
1	17534734	.	C	T	8	4	12	0	0	12	0	0
1	17534764	.	T	C	7	6	13	0	0	13	0	0
1	17534870	.	G	A	1	10	11	0	9	20	0	0
1	17534892	.	A	T	10	10	20	0	0	20	0	0
1	17534952	.	T	G	7	6	13	0	0	13	0	0
1	17534962	.	G	A	11	7	18	0	0	18	0	0
1	17535015	.	G	A	7	9	16	0	0	16	0	0
1	17535021	.	G	A	6	9	15	0	1	16	0	0
1	17535150	.	G	T	4	4	8	0	0	8	0	0
1	17535214	.	C	T	7	8	15	0	2	17	0	0
1	17535245	.	T	C	9	8	17	0	1	18	0	0
1	17535281	.	A	G	5	7	12	0	0	12	0	0
1	17535334	.	G	A	0	4	4	0	4	8	0	0
1	17535349	.	C	T	4	5	9	0	0	9	0	0
1	17535442	.	G	A	9	13	22	0	0	22	0	0
1	17535461	.	T	G	13	11	24	0	0	24	0	0
1	17535493	.	G	A	1	8	9	1	13	23	0	0
1	17535844	.	A	G	9	2	11	0	0	11	0	0
1	17537709	.	A	G	10	8	18	0	0	18	0	0
1	17537731	.	T	C	9	9	18	0	0	18	0	0
1	17538198	.	T	C	10	5	15	0	0	15	0	0
1	17538751	.	T	C	15	0	15	0	9	24	0	0
1	17538823	.	A	G	8	6	14	0	1	15	0	0
1	17538852	.	A	G	7	11	18	0	1	19	0	0
1	17539011	.	T	G	7	9	16	0	3	19	0	0
1	17539212	.	G	A	7	4	11	0	0	11	0	0
1	17542951	.	A	G	8	9	17	0	0	17	0	0
1	17546586	.	A	T	11	9	20	0	0	20	0	0
1	17546655	.	A	C	15	10	25	0	0	25	0	0
1	17546827	.	C	T	7	11	18	0	1	19	0	0
1	17554050	.	A	G	8	7	15	0	1	16	0	0
1	17555209	.	T	C	8	9	17	0	0	17	0	0
1	17555218	.	C	T	8	10	18	0	0	18	0	0
1	17565679	.	C	T	5	7	12	0	2	14	0	0
1	17565727	.	G	A	6	7	13	0	1	14	0	0
1	17565736	.	A	G	7	8	15	0	0	15	0	0
1	17565893	.	G	A	7	11	18	0	1	19	0	0
1	17681203	.	G	A	2	5	7	0	0	7	0	0
1	17681429	.	T	C	0	3	3	0	0	3	0	0
1	17681508	.	T	C	4	2	6	0	0	6	0	0
1	17683203	.	A	T	9	13	22	0	0	22	0	0
1	17688762	.	A	G	4	7	11	0	2	13	0	0
1	17688868	.	A	C	5	10	15	0	0	15	0	0
1	17689083	.	C	G	1	9	10	0	9	19	0	0
1	17689173	.	T	C	9	16	25	0	0	25	0	0
1	17689182	.	T	C	8	0	8	0	17	25	0	0
1	17693082	.	G	C	6	7	13	0	0	13	0	0
1	17693156	.	A	T	10	4	14	0	0	14	0	0
1	17693218	.	C	T	5	5	10	0	0	10	0	0
1	17698646	.	A	T	4	3	7	0	0	7	0	0
1	17698724	.	T	C	4	5	9	0	0	9	0	0
1	17699529	.	T	A	4	2	6	0	0	6	0	0
1	17699534	.	A	G	2	2	4	0	2	6	0	0
1	17699650	.	A	G	6	8	14	0	0	14	0	0
1	17701890	.	T	G	12	9	21	0	3	24	0	0
1	17702512	.	T	A	11	10	21	0	0	21	0	0
1	17704125	.	C	T	6	10	16	0	0	16	0	0
1	17704155	.	A	G	8	8	16	0	0	16	0	0
1	17708635	.	G	A	10	9	19	0	0	19	0	0
1	17710831	.	T	C	5	4	9	0	0	9	0	0
1	17711097	.	G	T	6	5	11	0	1	12	0	0
1	17711346	.	G	A	10	7	17	1	0	18	0	0
1	17711596	.	T	A	9	10	19	1	1	21	0	0
1	17711623	.	C	T	8	9	17	0	0	17	0	0
1	17747757	.	G	T	5	5	10	0	1	11	0	0
1	17747841	.	G	C	3	3	6	0	0	6	0	0
1	17747849	.	T	A	3	3	6	0	0	6	0	0
1	17761911	.	A	G	4	2	6	0	0	6	0	0
1	17762065	.	G	A	1	4	5	0	0	5	0	0
1	17762133	.	T	C	1	4	5	0	0	5	0	0
1	17762486	.	C	A	3	2	5	0	1	6	0	0
1	17762517	.	G	A	4	4	8	0	0	8	0	0
1	17784124	.	G	A	2	3	5	0	0	5	0	0
1	17786115	.	A	G	6	5	11	0	0	11	0	0
1	17789451	.	G	A	5	2	7	0	0	7	0	0
1	17789612	.	G	C	4	2	6	0	0	6	0	0
1	17858513	.	A	T	1	4	5	0	0	5	0	0
1	18252294	.	G	A	1	1	2	0	0	2	0	0
1	18252393	.	C	T	2	2	4	0	0	4	0	0
1	18252659	.	A	G	3	2	5	0	1	6	0	0
1	18252696	.	C	T	0	3	3	0	4	7	0	0
1	18336490	.	T	G	2	2	4	0	0	4	0	0
1	18363913	.	C	T	0	4	4	0	3	7	0	0
1	18373281	.	G	T	4	3	7	0	0	7	0	0
1	18373398	.	G	T	2	5	7	0	1	8	0	0
1	18375662	.	T	A	4	4	8	0	0	8	0	0
1	18377615	.	A	G	5	5	10	0	0	10	0	0
1	18377690	.	G	C	5	0	5	0	10	15	0	0
1	18399380	.	A	G	2	2	4	0	0	4	0	0
1	18404068	.	C	T	0	3	3	0	4	7	0	0
1	18421185	.	T	C	4	0	4	0	5	9	0	0
1	18445692	.	G	T	7	2	9	2	0	11	0	0
1	18445766	.	G	T	3	3	6	0	0	6	0	0
1	18445792	.	G	T	3	4	7	0	0	7	0	0
1	18446152	.	G	A	10	6	16	0	0	16	0	0
1	18581402	.	G	A	0	4	4	0	1	5	0	0
1	18586614	.	C	T	0	2	2	0	3	5	0	0
1	18594886	.	C	T	3	3	6	0	0	6	0	0
1	19863785	.	C	A	10	3	13	0	0	13	0	0
1	19863949	.	C	T	4	3	7	0	0	7	0	0
1	19866140	.	C	T	2	5	7	0	0	7	0	0
1	19866672	.	C	T	4	5	9	0	0	9	0	0
1	19872148	.	C	T	4	4	8	0	0	8	0	0
1	19872269	.	C	T	1	6	7	0	1	8	0	0
1	19872320	.	G	A	0	6	6	0	1	7	0	0
1	19874549	.	A	G	2	8	10	0	0	10	0	0
1	19874550	.	G	A	2	8	10	0	0	10	0	0
1	19879890	.	A	T	4	4	8	0	0	8	0	0
1	19882538	.	C	A	4	6	10	0	0	10	0	0
1	19885849	.	A	C	5	5	10	0	0	10	0	0
1	19886323	.	G	A	1	6	7	0	1	8	0	0
1	19886336	.	G	A	1	3	4	0	5	9	0	0
1	19936191	.	A	G	14	1	15	0	12	27	0	0
1	19936211	.	A	C	14	11	25	0	0	25	0	0
1	19936625	.	T	C	4	4	8	0	1	9	0	0
1	19936673	.	A	G	6	2	8	0	1	9	0	0
1	19936790	.	T	G	11	8	19	0	2	21	0	0
1	19950478	.	A	T	14	21	35	0	0	35	0	0
1	19950737	.	C	A	18	14	32	0	2	34	0	0
1	19955706	.	C	T	13	9	22	0	1	23	0	0
1	19966416	.	C	T	11	12	23	0	0	23	0	0
1	19978049	.	A	G	8	1	9	1	10	20	0	0
1	19978118	.	T	C	20	16	36	0	0	36	0	0
1	19978445	.	A	C	11	12	23	0	2	25	0	0
1	19984448	.	C	T	15	12	27	0	3	30	0	0
1	19989354	.	C	T	9	9	18	0	0	18	0	0
1	19989404	.	G	A	14	7	21	0	2	23	0	0
1	20063843	.	C	A	1	6	7	0	4	11	0	0
1	20068075	.	A	C	1	5	6	0	0	6	0	0
1	20068092	.	T	A	1	5	6	0	0	6	0	0
1	20069667	.	T	G	8	0	8	0	6	14	0	0
1	20084537	.	A	G	7	12	19	0	0	19	0	0
1	20092616	.	T	A	7	11	18	0	2	20	0	0
1	20094234	.	G	A	11	14	25	1	0	26	0	0
1	20094327	.	G	T	9	7	16	0	0	16	0	0
1	20095274	.	A	G	12	9	21	0	0	21	0	0
1	20112454	.	C	T	4	4	8	9	1	18	0	0
1	20117596	.	T	C	5	6	11	0	0	11	0	0
1	20129652	.	T	C	9	5	14	0	0	14	0	0
1	20138983	.	C	G	10	5	15	0	1	16	0	0
1	20138993	.	C	T	10	6	16	0	0	16	0	0
1	20141572	.	G	A	0	8	8	1	14	23	0	0
1	20141661	.	A	C	11	10	21	0	0	21	0	0
1	20147248	.	T	A	10	6	16	1	1	18	0	0
1	20160882	.	T	A	10	17	27	0	0	27	0	0
1	20166536	.	C	A	14	16	30	0	0	30	0	0
1	20194118	.	C	T	9	4	13	0	1	14	0	0
1	20212284	.	C	T	11	16	27	0	0	27	0	0
1	20224309	.	G	T	5	5	10	0	0	10	0	0
1	20270252	.	G	A	2	3	5	0	0	5	0	0
1	20270779	.	G	T	15	12	27	0	1	28	0	0
1	20272915	.	T	A	7	3	10	0	1	11	0	0
1	20273071	.	T	C	5	7	12	0	1	13	0	0
1	20273088	.	G	A	6	7	13	0	2	15	0	0
1	20273198	.	C	A	0	5	5	1	7	13	0	0
1	20556916	.	G	T	10	7	17	0	0	17	0	0
1	20557447	.	G	A	17	18	35	0	2	37	0	0
1	20557467	.	G	A	23	16	39	0	2	41	0	0
1	20557625	.	A	C	9	0	9	0	13	22	0	0
1	20557650	.	C	T	10	9	19	0	0	19	0	0
1	20557662	.	G	T	7	9	16	0	1	17	0	0
1	20557788	.	A	C	1	0	1	0	3	4	0	0
1	20557960	.	A	T	5	2	7	0	1	8	0	0
1	20558311	.	G	C	6	4	10	0	0	10	0	0
1	20558523	.	G	A	7	4	11	1	0	12	0	0
1	20558594	.	C	A	2	4	6	0	8	14	0	0
1	20558691	.	A	C	3	3	6	0	0	6	0	0
1	20558902	.	A	G	5	10	15	1	0	16	0	0
1	20559010	.	A	G	5	6	11	0	0	11	0	0
1	20559321	.	T	C	7	0	7	0	6	13	0	0
1	20559427	.	C	T	8	8	16	0	0	16	0	0
1	20559442	.	C	T	10	8	18	0	1	19	0	0
1	20559538	.	G	A	8	11	19	0	0	19	0	0
1	20559830	.	G	A	7	12	19	0	0	19	0	0
1	20564770	.	T	G	7	6	13	0	2	15	0	0
1	20581281	.	C	T	6	2	8	0	1	9	0	0
1	20581311	.	C	T	1	4	5	0	9	14	0	0
1	20581617	.	C	T	7	3	10	0	0	10	0	0
1	20581764	.	G	A	3	3	6	0	0	6	0	0
1	20635419	.	C	T	32	48	80	0	2	82	0	0
1	20694955	.	A	G	26	23	49	0	2	51	0	0
1	20698009	.	C	T	28	27	55	0	0	55	0	0
1	20705237	.	C	T	25	25	50	0	0	50	0	0
1	20733161	.	T	C	1	3	4	0	0	4	0	0
1	20733310	.	T	A	1	2	3	0	0	3	0	0
1	20866958	.	A	G	20	26	46	0	2	48	0	0
1	20867057	.	A	T	33	31	64	0	2	66	0	0
1	20867321	.	C	T	3	21	24	0	23	47	0	0
1	20867345	.	C	T	24	22	46	0	1	47	0	0
1	20867359	.	C	T	27	13	40	0	6	46	0	0
1	20867478	.	T	C	22	36	58	0	5	63	0	0
1	20867611	.	T	C	28	39	67	0	2	69	0	0
1	20867623	.	T	C	31	39	70	0	4	74	0	0
1	20867650	.	G	A	30	37	67	0	3	70	0	0
1	20867887	.	T	C	26	40	66	0	3	69	0	0
1	20867901	.	C	G	6	20	26	0	45	71	0	0
1	20867933	.	T	C	44	2	46	1	28	75	0	0
1	20868301	.	A	G	28	34	62	1	4	67	0	0
1	20868338	.	G	T	37	35	72	1	2	75	0	0
1	20868467	.	C	T	39	24	63	0	1	64	0	0
1	20868525	.	G	C	39	28	67	2	3	72	0	0
1	20868762	.	C	A	27	17	44	8	0	52	0	0
1	20868765	.	C	G	2	14	16	8	27	51	0	0
1	20868997	.	C	T	5	12	17	0	42	59	0	0
1	20870219	.	T	G	19	23	42	0	3	45	0	0
1	20870601	.	A	G	33	25	58	4	1	63	0	0
1	20870774	.	G	A	20	42	62	0	5	68	1	0
1	20870808	.	C	T	2	36	38	0	29	67	0	0
1	20870846	.	C	T	26	33	59	1	4	64	0	0
1	20870876	.	C	T	40	24	64	1	0	65	0	0
1	20871210	.	G	A	38	29	67	1	3	71	0	0
1	20878946	.	C	T	34	34	68	0	2	70	0	0
1	20878994	.	G	A	45	34	79	0	0	79	0	0
1	20886924	.	G	A	40	28	68	0	2	70	0	0
1	20886936	.	G	A	39	30	69	0	1	70	0	0
1	20910967	.	A	G	41	29	70	0	8	78	0	0
1	20911156	.	T	G	41	30	71	0	8	79	0	0
1	20916898	.	G	A	4	8	12	0	0	12	0	0
1	20917091	.	G	C	7	5	12	0	0	12	0	0
1	20917114	.	T	A	8	9	17	0	0	17	0	0
1	20925532	.	G	A	6	4	10	0	0	10	0	0
1	20925544	.	G	T	8	4	12	0	1	13	0	0
1	20941806	.	T	A	9	10	19	0	1	20	0	0
1	20946897	.	A	G	10	9	19	0	1	20	0	0
1	20956239	.	G	A	6	5	11	0	0	11	0	0
1	20959028	.	T	C	4	5	9	0	0	9	0	0
1	20966059	.	T	C	8	8	16	1	1	18	0	0
1	20966109	.	A	T	9	7	16	0	0	16	0	0
1	20970109	.	G	T	8	8	16	0	1	17	0	0
1	21138623	.	T	C	2	4	6	0	0	6	0	0
1	21139108	.	A	G	10	4	14	0	2	16	0	0
1	21139355	.	G	A	3	5	8	0	1	9	0	0
1	21139367	.	G	A	3	6	9	0	0	9	0	0
1	21139456	.	G	C	5	2	7	0	0	7	0	0
1	21141701	.	A	G	9	5	14	0	1	15	0	0
1	21141869	.	T	G	10	7	17	0	1	18	0	0
1	21141894	.	C	T	0	5	5	0	8	13	0	0
1	21141999	.	G	A	6	4	10	0	1	11	0	0
1	21142029	.	A	G	8	5	13	0	0	13	0	0
1	21148609	.	A	T	4	3	7	0	1	8	0	0
1	21151784	.	A	G	4	5	9	0	0	9	0	0
1	21160853	.	G	A	5	7	12	0	0	12	0	0
1	21161102	.	T	A	3	5	8	0	0	8	0	0
1	21309423	.	G	A	4	3	7	0	0	7	0	0
1	21312085	.	G	A	12	8	20	0	1	21	0	0
1	21312112	.	C	T	8	12	20	0	2	22	0	0
1	21312145	.	A	G	14	6	20	0	0	20	0	0
1	21314009	.	A	T	3	3	6	0	0	6	0	0
1	21333205	.	C	G	2	25	27	0	21	48	0	0
1	21341577	.	T	C	14	30	44	4	1	49	0	0
1	21346051	.	C	T	17	30	47	0	3	50	0	0
1	21352529	.	A	G	20	18	38	0	1	39	0	0
1	21368014	.	C	A	29	21	50	0	0	50	0	0
1	21368074	.	C	A	28	20	48	0	1	49	0	0
1	21409358	.	G	T	23	18	41	0	3	44	0	0
1	21423093	.	A	T	4	3	7	0	1	8	0	0
1	21423756	.	A	G	9	16	25	0	1	26	0	0
1	21439453	.	G	A	11	10	21	0	2	23	0	0
1	21447843	.	C	T	13	8	21	0	1	22	0	0
1	21473134	.	G	A	10	4	14	0	0	14	0	0
1	21473155	.	G	A	10	5	15	0	0	15	0	0
1	21473248	.	T	C	10	0	10	0	10	20	0	0
1	21500209	.	T	A	5	6	11	0	0	11	0	0
1	21505611	.	A	G	6	2	8	0	0	8	0	0
1	21505670	.	G	A	5	3	8	0	0	8	0	0
1	21505702	.	G	T	5	6	11	0	0	11	0	0
1	21513826	.	G	A	4	6	10	0	0	10	0	0
1	21515880	.	G	A	7	2	9	0	0	9	0	0
1	21515903	.	G	T	4	7	11	0	0	11	0	0
1	21518503	.	G	A	6	5	11	0	0	11	0	0
1	21518799	.	C	T	4	6	10	0	0	10	0	0
1	21522253	.	G	A	2	3	5	0	0	5	0	0
1	21525823	.	C	T	0	5	5	0	4	9	0	0
1	21526876	.	G	A	5	2	7	0	0	7	0	0
1	21529367	.	G	A	6	6	12	0	0	12	0	0
1	21536486	.	G	A	3	2	5	0	0	5	0	0
1	21610651	.	A	G	3	4	7	0	0	7	0	0
1	21610678	.	G	T	6	5	11	0	0	11	0	0
1	21611043	.	T	C	5	7	12	0	0	12	0	0
1	21611109	.	A	T	4	3	7	0	0	7	0	0
1	21611128	.	T	C	3	0	3	0	5	8	0	0
1	21611786	.	G	C	4	2	6	0	0	6	0	0
1	21612127	.	C	T	4	4	8	0	0	8	0	0
1	21612268	.	A	C	3	3	6	0	1	7	0	0
1	21612400	.	G	A	5	10	15	0	0	15	0	0
1	21612418	.	G	C	4	11	15	0	0	15	0	0
1	21648917	.	T	A	1	5	6	0	0	6	0	0
1	21901503	.	C	A	1	2	3	0	0	3	0	0
1	21941031	.	C	A	7	7	14	0	0	14	0	0
1	21944731	.	C	T	7	2	9	0	1	10	0	0
1	21947233	.	A	T	2	6	8	0	0	8	0	0
1	21949907	.	A	C	6	9	15	0	1	16	0	0
1	21949910	.	G	A	5	9	14	0	0	14	0	0
1	21949996	.	C	T	10	8	18	0	0	18	0	0
1	21950179	.	C	T	8	5	13	0	1	14	0	0
1	21950621	.	G	A	2	11	13	0	9	22	0	0
1	21950650	.	T	C	12	13	25	0	1	26	0	0
1	21950824	.	C	A	8	6	14	0	0	14	0	0
1	21950841	.	G	A	4	5	9	0	7	16	0	0
1	21950896	.	G	A	1	3	4	0	9	13	0	0
1	21951119	.	G	A	2	8	10	0	3	13	0	0
1	21951309	.	T	G	8	6	14	0	1	15	0	0
1	21951411	.	G	A	9	5	14	0	0	14	0	0
1	21951431	.	T	C	3	9	12	0	0	12	0	0
1	21954946	.	G	A	1	9	10	0	12	22	0	0
1	21954974	.	C	T	8	6	14	0	1	15	0	0
1	21957122	.	T	G	14	3	17	0	1	18	0	0
1	21957124	.	T	C	14	3	17	0	0	17	0	0
1	21961364	.	G	T	1	9	10	0	3	13	0	0
1	21961430	.	T	C	8	8	16	0	0	16	0	0
1	22236891	.	A	T	6	3	9	0	0	9	0	0
1	22236990	.	G	A	4	7	11	0	0	11	0	0
1	22389122	.	C	T	8	8	16	0	0	16	0	0
1	22389246	.	C	T	1	6	7	0	6	13	0	0
1	22389264	.	T	A	9	9	18	0	1	19	0	0
1	22389395	.	T	C	19	14	33	0	0	33	0	0
1	22401851	.	A	G	7	8	15	0	4	19	0	0
1	22411760	.	A	G	10	12	22	0	0	22	0	0
1	22482490	.	C	T	4	6	10	0	0	10	0	0
1	22482494	.	A	T	10	3	13	0	0	13	0	0
1	22482560	.	G	T	6	7	13	6	1	20	0	0
1	22482575	.	A	G	9	5	14	6	0	20	0	0
1	22482893	.	A	C	1	4	5	0	0	5	0	0
1	22483076	.	T	C	1	5	6	0	1	7	0	0
1	22483594	.	C	A	2	3	5	1	0	6	0	0
1	22483747	.	C	T	4	1	5	1	1	7	0	0
1	22483750	.	T	C	4	0	4	1	4	9	0	0
1	22483821	.	C	G	6	6	12	0	0	12	0	0
1	22483835	.	C	A	5	6	11	0	0	11	0	0
1	22483955	.	A	G	6	3	9	0	0	9	0	0
1	22484015	.	A	T	5	2	7	0	0	7	0	0
1	22484152	.	A	T	4	3	7	0	0	7	0	0
1	22484156	.	T	G	3	3	6	0	0	6	0	0
1	22484199	.	T	C	2	4	6	0	0	6	0	0
1	22484544	.	C	A	8	7	15	0	0	15	0	0
1	22490234	.	C	A	8	9	17	0	1	18	0	0
1	22490402	.	C	T	3	10	13	0	0	13	0	0
1	22490444	.	G	T	1	5	6	0	0	6	0	0
1	22490565	.	C	T	0	7	7	0	7	14	0	0
1	22490660	.	G	A	9	6	15	0	0	15	0	0
1	22490795	.	C	T	0	5	5	0	8	13	0	0
1	22490897	.	G	A	2	8	10	0	0	10	0	0
1	22511863	.	C	T	2	2	4	0	1	5	0	0
1	22511922	.	G	A	4	9	13	0	0	13	0	0
1	22543834	.	A	C	2	3	5	0	0	5	0	0
1	22545292	.	A	T	1	2	3	0	0	3	0	0
1	22546604	.	G	A	1	2	3	0	0	3	0	0
1	22555667	.	A	G	1	2	3	0	0	3	0	0
1	22647772	.	T	C	3	5	8	0	1	9	0	0
1	22647844	.	C	A	17	10	27	0	0	27	0	0
1	22647852	.	T	A	17	10	27	1	0	28	0	0
1	23283065	.	G	C	10	7	17	0	0	17	0	0
1	23283287	.	A	T	3	2	5	0	0	5	0	0
1	23283295	.	G	A	3	2	5	0	0	5	0	0
1	23283769	.	C	T	3	2	5	0	0	5	0	0
1	23297750	.	A	G	2	7	9	0	0	9	0	0
1	23297789	.	T	C	6	0	6	0	4	10	0	0
1	23298384	.	C	A	1	4	5	0	0	5	0	0
1	23298494	.	T	C	4	9	13	0	0	13	0	0
1	23301687	.	A	T	4	7	11	0	0	11	0	0
1	23301873	.	G	T	7	7	14	0	0	14	0	0
1	23311756	.	T	A	5	5	10	0	1	11	0	0
1	23311959	.	A	G	6	0	6	0	9	15	0	0
1	23312029	.	G	A	13	10	23	0	3	26	0	0
1	23321770	.	G	T	15	13	28	0	1	29	0	0
1	23322076	.	T	C	7	13	20	0	0	20	0	0
1	23322442	.	C	T	21	16	37	0	1	38	0	0
1	23322473	.	T	C	21	15	36	0	1	37	0	0
1	23322501	.	C	T	17	16	33	0	1	34	0	0
1	23322602	.	T	A	10	15	25	0	1	26	0	0
1	23322659	.	T	A	20	15	35	0	1	36	0	0
1	23322937	.	G	A	1	5	6	0	8	14	0	0
1	23323129	.	A	T	1	2	3	0	0	3	0	0
1	23323611	.	T	C	9	0	9	2	2	13	0	0
1	23330118	.	A	G	15	16	31	0	3	34	0	0
1	23332456	.	T	C	10	3	13	0	1	14	0	0
1	23332462	.	C	T	10	4	14	0	0	14	0	0
1	23337716	.	A	G	5	10	15	0	1	16	0	0
1	23343024	.	A	G	2	4	6	0	1	7	0	0
1	23343866	.	A	G	3	5	8	0	0	8	0	0
1	23369545	.	G	A	9	6	15	0	0	15	0	0
1	23373384	.	G	C	0	3	3	0	2	5	0	0
1	23374143	.	C	T	4	3	7	0	0	7	0	0
1	23377366	.	C	A	2	3	5	0	0	5	0	0
1	23377676	.	C	T	3	3	6	0	0	6	0	0
1	23377740	.	A	G	2	2	4	0	0	4	0	0
1	23393120	.	A	T	4	2	6	0	1	7	0	0
1	23506660	.	C	A	9	9	18	0	0	18	0	0
1	23506674	.	C	T	7	8	15	0	0	15	0	0
1	23506711	.	A	T	5	5	10	1	3	14	0	0
1	23506865	.	C	A	18	18	36	0	1	37	0	0
1	23515748	.	T	G	10	18	28	0	2	30	0	0
1	23521634	.	G	T	18	22	40	0	1	41	0	0
1	23522528	.	C	T	10	9	19	0	2	21	0	0
1	23569007	.	A	G	2	2	4	0	0	4	0	0
1	23572969	.	A	T	2	2	4	0	0	4	0	0
1	23573760	.	C	T	5	3	8	4	0	12	0	0
1	23573814	.	A	C	4	12	16	1	0	17	0	0
1	23573823	.	A	T	5	12	17	0	0	17	0	0
1	23573921	.	G	A	7	4	11	0	0	11	0	0
1	23574003	.	C	A	5	4	9	0	0	9	0	0
1	23578157	.	C	T	7	7	14	0	0	14	0	0
1	23578159	.	T	G	7	6	13	0	0	13	0	0
1	23578196	.	A	T	9	3	12	0	0	12	0	0
1	23578478	.	C	T	5	3	8	0	0	8	0	0
1	23578490	.	G	A	4	2	6	0	0	6	0	0
1	23578651	.	C	T	2	4	6	0	0	6	0	0
1	23578839	.	A	C	3	2	5	0	0	5	0	0
1	23579438	.	T	C	10	4	14	0	0	14	0	0
1	23579714	.	C	T	0	7	7	0	2	9	0	0
1	23580087	.	C	T	5	4	9	0	0	9	0	0
1	23580644	.	C	T	4	3	7	0	0	7	0	0
1	23580700	.	G	A	4	2	6	0	0	6	0	0
1	23581097	.	T	A	6	2	8	0	0	8	0	0
1	23581960	.	T	G	3	5	8	0	0	8	0	0
1	23582052	.	A	G	1	2	3	0	1	4	0	0
1	23585190	.	C	A	4	2	6	0	0	6	0	0
1	23585338	.	G	A	4	4	8	0	0	8	0	0
1	23585411	.	C	T	1	2	3	0	0	3	0	0
1	23585802	.	C	A	0	11	11	0	3	14	0	0
1	23586133	.	A	G	7	10	17	0	0	17	0	0
1	23586780	.	C	T	1	3	4	0	3	7	0	0
1	23865000	.	C	T	3	3	6	0	0	6	0	0
1	23889642	.	T	A	3	8	11	0	0	11	0	0
1	23889648	.	A	G	7	3	10	0	1	11	0	0
1	23898014	.	G	A	5	5	10	0	0	10	0	0
1	23902973	.	G	A	4	3	7	0	0	7	0	0
1	23909090	.	A	G	7	13	20	0	2	22	0	0
1	23909289	.	A	T	4	3	7	0	2	9	0	0
1	23909522	.	A	C	2	5	7	0	0	7	0	0
1	23921071	.	A	T	13	8	21	0	0	21	0	0
1	23921166	.	C	A	4	10	14	0	0	14	0	0
1	23921171	.	G	A	3	11	14	0	0	14	0	0
1	23921284	.	T	C	6	3	9	0	0	9	0	0
1	23921427	.	T	C	9	1	10	0	4	14	0	0
1	23921564	.	T	A	5	4	9	0	1	10	0	0
1	23943609	.	A	T	6	4	10	0	0	10	0	0
1	23975453	.	A	G	4	6	10	0	1	11	0	0
1	24045920	.	G	T	4	5	9	0	0	9	0	0
1	24045977	.	T	G	7	3	10	0	4	14	0	0
1	24050482	.	C	T	0	4	4	0	3	7	0	0
1	24076445	.	T	C	6	9	15	0	0	15	0	0
1	24076890	.	A	G	13	12	25	0	1	26	0	0
1	24077274	.	A	G	11	1	12	0	11	23	0	0
1	24077517	.	C	T	18	18	36	0	3	39	0	0
1	24077791	.	G	A	4	12	16	2	16	34	0	0
1	24081190	.	G	C	2	4	6	0	1	7	0	0
1	24163638	.	G	A	3	8	11	0	1	12	0	0
1	24197364	.	G	A	5	3	8	0	0	8	0	0
1	24197375	.	C	T	2	5	7	0	4	11	0	0
1	24213106	.	G	A	2	3	5	0	0	5	0	0
1	24213229	.	T	G	5	3	8	0	0	8	0	0
1	24213284	.	C	T	1	3	4	0	0	4	0	0
1	24214514	.	T	A	6	3	9	0	0	9	0	0
1	24227870	.	G	T	1	3	4	0	1	5	0	0
1	24227872	.	C	T	0	4	4	0	1	5	0	0
1	24227911	.	C	A	3	8	11	0	0	11	0	0
1	24228248	.	C	T	1	4	5	0	1	6	0	0
1	24228273	.	T	A	6	2	8	0	0	8	0	0
1	24245909	.	A	G	2	4	6	0	1	7	0	0
1	24256422	.	T	A	2	3	5	0	1	6	0	0
1	24256432	.	A	T	1	4	5	0	0	5	0	0
1	24356734	.	T	C	36	24	60	0	3	63	0	0
1	24357931	.	C	T	37	31	68	0	3	71	0	0
1	24511975	.	T	C	0	1	1	0	1	2	0	0
1	24511997	.	A	C	1	2	3	0	0	3	0	0
1	24513528	.	C	T	1	3	4	0	0	4	0	0
1	24520818	.	G	A	3	4	7	0	0	7	0	0
1	24521032	.	C	T	3	5	8	0	2	10	0	0
1	24523410	.	C	T	0	5	5	0	5	10	0	0
1	24552293	.	A	G	1	3	4	0	0	4	0	0
1	24554843	.	G	A	1	4	5	0	1	6	0	0
1	24557201	.	A	G	4	3	7	0	0	7	0	0
1	24557213	.	C	T	2	3	5	0	0	5	0	0
1	24557605	.	A	G	3	7	10	0	1	11	0	0
1	24557865	.	A	G	9	7	16	0	3	19	0	0
1	24558187	.	C	T	3	2	5	0	0	5	0	0
1	24558336	.	C	G	2	3	5	0	0	5	0	0
1	24558410	.	T	A	1	3	4	0	0	4	0	0
1	24902778	.	T	C	19	0	19	0	7	26	0	0
1	25024060	.	T	C	2	0	2	0	6	8	0	0
1	25024435	.	G	A	4	5	9	0	1	10	0	0
1	25216208	.	C	T	1	3	4	0	0	4	0	0
1	25272691	.	G	C	1	7	8	0	1	9	0	0
1	25296797	.	C	T	12	12	24	0	1	25	0	0
1	25296831	.	C	T	8	12	20	0	1	21	0	0
1	25305290	.	A	T	10	11	21	0	2	23	0	0
1	25305446	.	T	G	12	1	13	0	13	26	0	0
1	25310899	.	C	A	11	8	19	0	0	19	0	0
1	25310912	.	T	A	8	8	16	0	1	17	0	0
1	25313056	.	C	T	14	6	20	0	0	20	0	0
1	25313261	.	T	C	19	14	33	0	0	33	0	0
1	25313300	.	G	A	1	7	8	0	23	31	0	0
1	25313482	.	T	A	20	18	38	0	0	38	0	0
1	25322572	.	T	A	9	3	12	0	0	12	0	0
1	25322633	.	A	T	4	2	6	0	0	6	0	0
1	25322704	.	T	A	1	2	3	0	0	3	0	0
1	25327834	.	A	T	4	3	7	0	1	8	0	0
1	25331494	.	C	T	9	4	13	0	0	13	0	0
1	25336466	.	A	G	4	4	8	0	0	8	0	0
1	25336507	.	C	A	4	5	9	0	1	10	0	0
1	25340311	.	G	A	8	4	12	0	0	12	0	0
1	25340353	.	C	T	0	5	5	0	5	10	0	0
1	25399528	.	A	C	4	3	7	0	0	7	0	0
1	25399556	.	G	A	5	3	8	0	1	9	0	0
1	25399617	.	T	A	2	4	6	0	0	6	0	0
1	25399621	.	A	T	2	4	6	0	0	6	0	0
1	25400017	.	A	G	6	3	9	0	0	9	0	0
1	25400032	.	C	T	1	3	4	0	5	9	0	0
1	25401181	.	G	A	2	4	6	0	0	6	0	0
1	25401635	.	G	A	3	6	9	0	0	9	0	0
1	25401638	.	T	A	6	3	9	0	0	9	0	0
1	25401756	.	A	G	3	7	10	0	0	10	0	0
1	25401819	.	A	G	8	8	16	0	0	16	0	0
1	25401984	.	T	C	3	11	14	0	0	14	0	0
1	25402044	.	T	A	4	3	7	0	0	7	0	0
1	25402229	.	T	C	5	6	11	0	0	11	0	0
1	25402260	.	A	G	7	7	14	0	0	14	0	0
1	25402560	.	C	T	4	3	7	0	0	7	0	0
1	25402647	.	T	G	2	2	4	0	0	4	0	0
1	25402695	.	C	T	2	2	4	0	0	4	0	0
1	25402957	.	G	C	1	2	3	0	0	3	0	0
1	25403140	.	A	G	3	4	7	0	0	7	0	0
1	25403289	.	T	C	5	2	7	0	0	7	0	0
1	25409010	.	G	A	1	4	5	0	0	5	0	0
1	25419911	.	T	G	3	3	6	0	0	6	0	0
1	25419936	.	A	G	0	5	5	0	1	6	0	0
1	25438705	.	G	A	3	2	5	0	0	5	0	0
1	25491522	.	G	A	3	2	5	0	0	5	0	0
1	25626004	.	T	C	1	1	2	0	1	3	0	0
1	25626209	.	G	A	1	2	3	0	0	3	0	0
1	25654976	.	C	T	12	6	18	0	0	18	0	0
1	25660719	.	C	T	5	4	9	0	0	9	0	0
1	25666368	.	T	C	1	2	3	0	0	3	0	0
1	25798792	.	T	A	8	5	13	0	0	13	0	0
1	25798863	.	G	C	3	7	10	0	1	11	0	0
1	25798983	.	A	C	5	2	7	0	0	7	0	0
1	25803617	.	C	T	11	12	23	0	0	23	0	0
1	25811411	.	T	C	13	9	22	0	0	22	0	0
1	25812658	.	C	T	6	6	12	0	0	12	0	0
1	25863530	.	G	A	13	9	22	0	2	24	0	0
1	25863638	.	A	T	15	6	21	0	1	22	0	0
1	25911654	.	T	A	8	5	13	0	0	13	0	0
1	26012936	.	C	T	4	2	6	0	0	6	0	0
1	26025440	.	C	A	0	3	3	0	2	5	0	0
1	26046950	.	T	A	13	15	28	0	1	29	0	0
1	26094301	.	T	A	2	2	4	0	0	4	0	0
1	26095879	.	T	G	6	5	11	0	1	12	0	0
1	26096488	.	G	C	11	6	17	0	0	17	0	0
1	26106888	.	G	A	5	2	7	0	0	7	0	0
1	26108222	.	G	A	3	2	5	0	0	5	0	0
1	26109479	.	T	C	2	2	4	0	0	4	0	0
1	26127702	.	A	T	16	2	18	0	9	29	2	0
1	26127710	.	G	T	15	1	16	0	12	28	0	0
1	26127856	.	A	T	11	16	27	0	0	27	0	0
1	26251906	.	T	G	1	5	6	0	0	6	0	0
1	26252153	.	A	T	6	3	9	0	0	9	0	0
1	26252215	.	T	C	2	2	4	0	0	4	0	0
1	26252598	.	T	C	1	4	5	0	0	5	0	0
1	26252798	.	G	C	5	0	5	0	14	19	0	0
1	26252877	.	G	A	8	7	15	0	1	16	0	0
1	26252931	.	A	T	7	3	10	0	1	11	0	0
1	26293167	.	C	T	0	5	5	0	2	7	0	0
1	26293231	.	T	A	2	8	10	0	1	11	0	0
1	26374612	.	A	T	3	4	7	0	1	8	0	0
1	26374638	.	A	G	3	0	3	0	8	11	0	0
1	26375497	.	G	T	12	9	21	0	0	21	0	0
1	26375733	.	G	A	3	10	13	0	8	21	0	0
1	26377682	.	C	T	7	3	10	0	0	10	0	0
1	26377694	.	C	T	9	3	12	0	0	12	0	0
1	26382852	.	C	T	19	17	36	0	1	37	0	0
1	26382853	.	C	T	20	17	37	0	1	38	0	0
1	26383281	.	G	T	0	8	8	0	7	15	0	0
1	26383553	.	T	G	12	4	16	0	1	17	0	0
1	26384317	.	C	A	2	2	4	0	0	4	0	0
1	26384721	.	A	G	8	5	13	0	0	13	0	0
1	26384779	.	C	A	4	3	7	0	0	7	0	0
1	26385222	.	C	G	6	9	15	0	0	15	0	0
1	26385939	.	A	G	7	11	18	0	2	20	0	0
1	26391698	.	A	G	3	2	5	0	0	5	0	0
1	26391720	.	A	G	3	3	6	0	0	6	0	0
1	26394436	.	A	C	6	0	6	0	6	12	0	0
1	26438749	.	G	T	4	2	6	0	0	6	0	0
1	26438894	.	C	T	1	7	8	0	9	17	0	0
1	26438909	.	A	G	10	7	17	0	0	17	0	0
1	26439131	.	T	C	7	0	7	0	10	17	0	0
1	26439176	.	T	C	7	5	12	0	0	12	0	0
1	26453698	.	C	G	15	16	31	0	0	31	0	0
1	26454080	.	T	A	13	6	19	0	0	19	0	0
1	26456433	.	G	A	6	7	13	0	1	14	0	0
1	26463208	.	C	G	17	12	29	0	1	30	0	0
1	26463263	.	G	A	1	9	10	0	15	25	0	0
1	26463488	.	T	G	2	0	2	0	5	7	0	0
1	26463552	.	A	G	7	0	7	0	10	17	0	0
1	26463692	.	C	T	11	9	20	0	0	20	0	0
1	26463878	.	C	A	6	6	12	0	0	12	0	0
1	26464003	.	C	T	11	12	23	0	0	23	0	0
1	26464175	.	G	A	3	5	8	0	1	9	0	0
1	26464446	.	G	A	7	10	17	0	0	17	0	0
1	26465047	.	A	C	11	12	23	0	2	25	0	0
1	26465218	.	G	T	2	9	11	0	8	19	0	0
1	26467125	.	T	A	4	4	8	0	0	8	0	0
1	26467953	.	A	C	13	4	17	0	1	18	0	0
1	26473634	.	G	A	8	11	19	0	0	19	0	0
1	26476305	.	C	T	4	6	10	0	1	11	0	0
1	26476553	.	T	A	15	4	19	0	1	20	0	0
1	26480970	.	G	C	0	7	7	0	10	17	0	0
1	26489854	.	G	A	12	7	19	0	1	20	0	0
1	26498400	.	C	T	15	8	23	0	1	24	0	0
1	26498657	.	G	A	0	14	14	0	8	22	0	0
1	26507270	.	A	C	13	6	19	0	2	21	0	0
1	26507356	.	G	A	12	9	21	0	2	23	0	0
1	26507582	.	G	A	15	7	22	0	0	22	0	0
1	26649095	.	A	T	1	3	4	0	1	5	0	0
1	26654154	.	A	T	1	2	3	0	0	3	0	0
1	26660660	.	C	T	1	13	14	0	11	25	0	0
1	26661084	.	G	A	18	23	41	0	1	42	0	0
1	26661516	.	G	A	20	16	36	0	0	36	0	0
1	26662867	.	T	A	1	5	6	0	0	6	0	0
1	26663278	.	C	T	2	3	5	0	0	5	0	0
1	26671025	.	T	C	4	2	6	0	0	6	0	0
1	26673433	.	C	T	4	3	7	0	1	8	0	0
1	26675979	.	T	A	1	2	3	0	0	3	0	0
1	26676347	.	A	G	1	3	4	0	0	4	0	0
1	26740966	.	T	C	26	25	51	0	2	53	0	0
1	26741410	.	C	T	34	22	56	0	1	57	0	0
1	26827238	.	A	G	4	2	6	0	0	6	0	0
1	26827464	.	G	A	2	3	5	0	0	5	0	0
1	26881663	.	C	A	1	2	3	0	0	3	0	0
1	26881664	.	C	T	0	2	2	0	1	3	0	0
1	27207986	.	A	G	8	0	8	0	7	15	0	0
1	27208553	.	T	A	3	3	6	0	1	7	0	0
1	27209628	.	A	C	8	12	20	0	0	20	0	0
1	27209904	.	T	G	7	6	13	0	0	13	0	0
1	27210057	.	T	C	3	4	7	0	1	8	0	0
1	27210578	.	G	A	6	9	15	0	1	16	0	0
1	27210929	.	C	T	13	15	28	0	1	29	0	0
1	27809162	.	T	C	11	9	20	0	0	20	0	0
1	27809198	.	T	A	9	10	19	0	1	20	0	0
1	27809381	.	C	T	10	6	16	0	0	16	0	0
1	27842373	.	G	A	2	19	21	0	13	34	0	0
1	27860743	.	T	A	5	3	8	0	1	9	0	0
1	27868306	.	T	C	3	2	5	0	0	5	0	0
1	27893097	.	T	C	8	11	19	0	0	19	0	0
1	27893139	.	C	A	9	7	16	0	0	16	0	0
1	27893237	.	C	A	1	3	4	0	0	4	0	0
1	27893550	.	T	A	2	6	8	0	1	9	0	0
1	27993191	.	A	G	13	1	14	0	8	22	0	0
1	27995605	.	C	T	12	9	21	0	2	23	0	0
1	28018806	.	C	T	8	8	16	0	1	17	0	0
1	28035590	.	T	C	4	7	11	0	0	11	0	0
1	28035719	.	G	A	1	2	3	0	1	4	0	0
1	28035786	.	C	T	4	2	6	0	1	7	0	0
1	28046218	.	T	C	12	14	26	0	1	27	0	0
1	28046224	.	A	G	10	1	11	0	17	28	0	0
1	28046717	.	T	A	4	2	6	0	1	7	0	0
1	28081318	.	C	T	6	9	15	0	0	15	0	0
1	28089545	.	G	A	12	6	18	0	0	18	0	0
1	28194893	.	C	T	4	2	6	0	0	6	0	0
1	28391882	.	C	G	15	9	24	0	1	25	0	0
1	28391914	.	C	T	0	9	9	0	7	16	0	0
1	28422549	.	G	T	8	12	20	0	2	22	0	0
1	28422569	.	C	T	15	9	24	0	0	24	0	0
1	28428603	.	A	G	10	7	17	0	1	18	0	0
1	28724010	.	G	T	7	2	9	0	1	10	0	0
1	28808541	.	T	C	10	7	17	0	0	17	0	0
1	28835669	.	T	C	8	5	13	0	0	13	0	0
1	28847677	.	C	T	0	18	18	0	4	22	0	0
1	28860619	.	G	A	13	8	21	0	1	22	0	0
1	28860730	.	A	T	9	11	20	0	2	22	0	0
1	28874819	.	C	T	3	4	7	0	0	7	0	0
1	28899224	.	C	A	0	3	3	0	1	4	0	0
1	28899350	.	G	A	2	4	6	0	0	6	0	0
1	28899530	.	T	C	3	2	5	0	0	5	0	0
1	28900661	.	A	G	2	3	5	0	0	5	0	0
1	28929621	.	C	T	3	3	6	0	1	7	0	0
1	28961846	.	C	T	42	19	61	0	4	65	0	0
1	28962501	.	C	T	3	24	27	0	35	62	0	0
1	28962545	.	A	G	32	14	46	0	3	49	0	0
1	28962556	.	A	C	34	10	44	0	0	44	0	0
1	28962598	.	C	T	27	17	44	0	1	45	0	0
1	28962966	.	G	A	40	26	66	0	0	66	0	0
1	28986486	.	C	T	19	20	39	0	1	40	0	0
1	28986532	.	G	A	22	19	41	0	0	41	0	0
1	29045226	.	G	A	27	21	48	0	2	50	0	0
1	29061155	.	G	A	3	2	5	0	0	5	0	0
1	29141285	.	C	T	1	2	3	0	1	4	0	0
1	29162589	.	A	G	8	5	13	0	0	13	0	0
1	29163737	.	C	T	1	2	3	0	1	4	0	0
1	29183991	.	C	T	1	2	3	0	0	3	0	0
1	29183997	.	A	T	1	2	3	0	0	3	0	0
1	29184042	.	A	C	2	3	5	0	0	5	0	0
1	29184190	.	A	G	2	5	7	0	0	7	0	0
1	29184298	.	C	T	1	5	6	0	0	6	0	0
1	29201933	.	G	C	7	9	16	0	1	17	0	0
1	29202110	.	T	C	6	7	13	0	0	13	0	0
1	29202368	.	G	A	2	8	10	0	0	10	0	0
1	29202379	.	A	G	2	0	2	0	10	12	0	0
1	29211635	.	T	C	16	3	19	0	0	19	0	0
1	29211636	.	T	C	11	7	18	0	1	19	0	0
1	29212341	.	G	A	10	10	20	0	0	20	0	0
1	29213227	.	G	A	2	10	12	0	11	23	0	0
1	29213902	.	C	T	6	6	12	0	0	12	0	0
1	29227642	.	T	A	9	5	14	0	0	14	0	0
1	29228390	.	A	T	4	5	9	0	0	9	0	0
1	29268588	.	A	G	2	0	2	0	2	4	0	0
1	29268626	.	C	T	1	3	4	0	0	4	0	0
1	29281974	.	C	G	3	5	8	0	0	8	0	0
1	29282145	.	C	T	3	10	13	0	1	14	0	0
1	29282175	.	A	C	6	6	12	0	1	13	0	0
1	29282836	.	C	T	7	7	14	0	0	14	0	0
1	29390799	.	T	C	6	2	8	0	0	8	0	0
1	29618331	.	A	G	2	2	4	0	0	4	0	0
1	29618413	.	G	T	1	3	4	0	0	4	0	0
1	29687175	.	A	C	1	2	3	0	0	3	0	0
1	29718827	.	A	C	4	5	9	0	0	9	0	0
1	29731965	.	T	G	6	6	12	0	0	12	0	0
1	29737972	.	A	C	6	9	15	0	1	16	0	0
1	29738496	.	T	C	7	10	17	0	0	17	0	0
1	29739670	.	T	A	7	12	19	0	2	21	0	0
1	29740160	.	C	G	0	0	0	0	9	9	0	0
1	29740954	.	G	C	7	8	15	0	0	15	0	0
1	29741054	.	C	T	14	20	34	1	1	36	0	0
1	29741193	.	T	A	12	9	21	0	3	24	0	0
1	29741407	.	A	C	13	9	22	0	4	26	0	0
1	29741447	.	C	T	14	6	20	0	1	21	0	0
1	29741952	.	C	T	14	11	25	0	0	25	0	0
1	29741967	.	A	G	10	12	22	0	5	27	0	0
1	29742036	.	C	T	12	12	24	0	1	25	0	0
1	29742368	.	T	C	9	4	13	1	1	15	0	0
1	29742487	.	T	C	2	4	6	0	0	6	0	0
1	29742791	.	A	T	10	11	21	0	1	22	0	0
1	29742796	.	A	G	11	0	11	0	13	24	0	0
1	29743087	.	G	A	10	9	19	0	0	19	0	0
1	29743165	.	A	G	10	9	19	0	0	19	0	0
1	29743178	.	T	C	10	8	18	0	1	19	0	0
1	29743281	.	T	C	10	8	18	0	1	19	0	0
1	29743423	.	T	G	11	15	26	0	0	26	0	0
1	29743505	.	A	G	3	5	8	0	0	8	0	0
1	29752319	.	T	C	8	9	17	0	0	17	0	0
1	29752421	.	A	G	5	7	12	0	0	12	0	0
1	29754673	.	A	G	7	3	10	0	2	12	0	0
1	29758042	.	G	A	7	8	15	0	1	16	0	0
1	29770360	.	T	A	10	8	18	0	1	19	0	0
1	29770748	.	A	C	5	4	9	0	0	9	0	0
1	29772751	.	G	T	21	8	29	0	0	29	0	0
1	29775664	.	C	A	6	13	19	0	2	21	0	0
1	29779300	.	G	C	10	11	21	0	0	21	0	0
1	29779402	.	G	A	0	14	14	0	6	20	0	0
1	29781462	.	G	A	12	12	24	0	2	26	0	0
1	29786407	.	G	C	1	10	11	0	16	27	0	0
1	29787262	.	T	C	12	13	25	0	0	25	0	0
1	29790030	.	A	T	13	6	19	0	3	22	0	0
1	29795692	.	G	A	6	9	15	0	1	16	0	0
1	29797191	.	T	C	10	17	27	0	0	27	0	0
1	29797387	.	A	C	10	9	19	0	2	21	0	0
1	29797674	.	G	A	5	3	8	0	0	8	0	0
1	29798203	.	A	G	16	12	28	0	0	28	0	0
1	29804658	.	A	T	11	13	24	0	0	24	0	0
1	29804682	.	A	G	12	8	20	0	1	21	0	0
1	29813246	.	C	A	16	16	32	0	4	36	0	0
1	29813276	.	C	T	17	23	40	0	0	40	0	0
1	29817451	.	C	A	16	16	32	0	3	35	0	0
1	29820831	.	C	T	20	19	39	0	0	39	0	0
1	29823603	.	T	C	19	13	32	0	0	32	0	0
1	29823604	.	G	A	18	13	31	0	1	32	0	0
1	29823701	.	A	G	20	18	38	0	3	41	0	0
1	29858127	.	G	T	7	3	10	0	1	11	0	0
1	29858258	.	A	T	3	4	7	0	0	7	0	0
1	29858300	.	A	T	5	3	8	0	0	8	0	0
1	29862116	.	C	T	5	5	10	0	0	10	0	0
1	29862155	.	A	C	8	5	13	0	0	13	0	0
1	31072098	.	T	C	8	3	11	0	0	11	0	0
1	32385420	.	T	A	3	2	5	0	0	5	0	0
1	34233301	.	A	G	6	0	6	0	8	14	0	0
1	36020092	.	A	T	7	10	17	0	0	17	0	0
1	36740431	.	A	G	2	3	5	0	0	5	0	0
1	37195941	.	T	A	6	5	11	0	1	12	0	0
1	37195950	.	G	A	7	5	12	0	1	13	0	0
1	37196220	.	T	A	10	10	20	0	0	20	0	0
1	37196228	.	A	G	9	9	18	0	0	19	1	0
1	37212301	.	T	A	11	10	21	0	0	21	0	0
1	37212331	.	C	T	9	8	17	0	0	17	0	0
1	37284382	.	C	T	8	9	17	0	0	17	0	0
1	37287291	.	A	T	13	10	23	0	2	25	0	0
1	37287294	.	G	A	14	13	27	0	0	27	0	0
1	37291884	.	A	C	9	8	17	0	0	17	0	0
1	37304354	.	C	A	12	13	25	0	2	27	0	0
1	37304439	.	C	T	16	15	31	0	0	31	0	0
1	37304494	.	T	A	19	11	30	0	1	31	0	0
1	37304510	.	T	G	18	10	28	0	0	28	0	0
1	37304536	.	G	A	10	9	19	0	0	19	0	0
1	37304870	.	T	A	5	1	6	0	0	6	0	0
1	37304929	.	G	A	8	6	14	0	7	21	0	0
1	37305148	.	C	T	4	5	9	0	0	9	0	0
1	37306726	.	G	T	3	12	15	0	13	28	0	0
1	37306913	.	T	A	11	15	26	0	1	27	0	0
1	37306942	.	A	C	14	12	26	0	1	27	0	0
1	37339689	.	T	C	3	5	8	0	1	9	0	0
1	37344832	.	T	C	7	11	18	0	0	18	0	0
1	37353355	.	C	T	9	10	19	0	2	21	0	0
1	37355591	.	G	A	7	4	11	0	0	11	0	0
1	37355606	.	C	T	5	5	10	0	1	11	0	0
1	37359071	.	C	T	12	8	20	0	0	20	0	0
1	37359221	.	G	C	7	4	11	0	0	11	0	0
1	37359352	.	A	G	7	8	15	0	0	15	0	0
1	37361554	.	A	G	5	7	12	0	0	12	0	0
1	37361759	.	C	T	13	6	19	0	0	19	0	0
1	37361879	.	T	A	6	3	9	0	0	9	0	0
1	37361919	.	T	C	6	3	9	0	0	9	0	0
1	37361960	.	C	T	1	2	3	0	0	3	0	0
1	37399494	.	G	A	0	2	2	0	2	4	0	0
1	37399683	.	C	T	1	2	3	0	0	3	0	0
1	37399696	.	G	A	0	2	2	0	1	3	0	0
1	37752326	.	T	C	5	2	7	0	0	7	0	0
1	37752392	.	A	G	6	0	6	0	11	17	0	0
1	37752478	.	G	C	10	7	17	0	1	18	0	0
1	37753024	.	G	A	13	9	22	0	1	23	0	0
1	38125431	.	C	A	17	9	26	0	0	26	0	0
1	38125684	.	T	C	16	11	27	0	2	29	0	0
1	38131058	.	C	T	15	8	23	0	0	23	0	0
1	38131073	.	T	C	8	12	20	0	0	20	0	0
1	38131094	.	G	A	9	7	16	0	0	16	0	0
1	38131288	.	G	A	20	9	29	0	0	29	0	0
1	38131360	.	G	A	18	29	47	0	2	49	0	0
1	38131486	.	G	A	12	17	29	0	2	31	0	0
1	38131812	.	T	C	1	4	5	0	0	5	0	0
1	38132245	.	A	C	2	3	5	0	0	5	0	0
1	38132254	.	A	C	2	2	4	0	0	4	0	0
1	38142998	.	G	T	7	11	18	0	0	18	0	0
1	38146192	.	G	T	4	7	11	0	2	13	0	0
1	38150605	.	A	C	6	11	17	0	1	18	0	0
1	38163017	.	C	T	20	13	33	0	1	34	0	0
1	38163132	.	G	A	16	17	33	0	1	34	0	0
1	38166009	.	G	C	12	9	21	0	3	24	0	0
1	38166268	.	A	C	22	12	34	0	0	34	0	0
1	38166429	.	T	C	17	19	36	0	0	36	0	0
1	38166431	.	T	G	17	19	36	0	0	36	0	0
1	38166520	.	A	G	12	15	27	0	0	27	0	0
1	38169771	.	T	A	8	3	11	1	0	12	0	0
1	38169972	.	T	G	21	15	36	0	1	37	0	0
1	38170553	.	G	A	18	14	32	0	2	34	0	0
1	38346162	.	C	T	0	5	5	0	6	11	0	0
1	38346475	.	C	T	1	3	4	0	0	4	0	0
1	38346578	.	G	T	4	5	9	0	1	10	0	0
1	38346649	.	C	T	1	5	6	0	2	8	0	0
1	38346739	.	G	A	7	7	14	0	0	14	0	0
1	38354049	.	G	A	4	9	13	0	0	13	0	0
1	38416477	.	G	A	3	4	7	0	1	8	0	0
1	38416536	.	A	G	3	5	8	1	0	9	0	0
1	38417229	.	G	A	7	3	10	0	0	10	0	0
1	38417268	.	A	T	5	11	16	0	0	16	0	0
1	38417332	.	A	G	3	10	13	0	0	13	0	0
1	38417370	.	G	A	9	5	14	0	0	14	0	0
1	38417531	.	G	T	6	9	15	0	0	15	0	0
1	38417571	.	G	T	3	10	13	0	1	14	0	0
1	38417588	.	T	G	7	5	12	0	2	14	0	0
1	38417625	.	A	T	8	4	12	0	0	12	0	0
1	38417680	.	T	A	4	5	9	0	0	10	1	0
1	38418087	.	C	T	4	4	8	0	0	8	0	0
1	38418294	.	G	T	10	3	13	0	0	13	0	0
1	38466714	.	G	A	2	6	8	0	2	10	0	0
1	38649340	.	A	G	42	24	66	0	0	66	0	0
1	38649947	.	G	A	26	42	68	0	5	73	0	0
1	38650132	.	G	T	41	26	67	0	0	67	0	0
1	38650298	.	G	A	30	30	60	0	1	61	0	0
1	38650382	.	G	C	29	31	60	0	2	62	0	0
1	38650467	.	A	G	28	37	65	1	6	72	0	0
1	38650510	.	G	C	29	36	65	1	4	70	0	0
1	38650516	.	T	C	34	36	70	1	3	74	0	0
1	38650545	.	T	C	38	37	75	0	5	80	0	0
1	38651063	.	G	T	41	31	72	0	2	74	0	0
1	38651065	.	T	A	40	31	71	0	3	74	0	0
1	38651361	.	C	T	20	20	40	0	2	42	0	0
1	38651370	.	G	A	19	24	43	0	3	46	0	0
1	38651469	.	C	A	21	33	54	0	1	55	0	0
1	38651822	.	G	A	15	10	25	0	1	26	0	0
1	38655522	.	C	T	3	26	29	3	39	71	0	0
1	38657689	.	G	A	33	31	64	0	4	68	0	0
1	38660240	.	T	C	32	2	34	0	39	73	0	0
1	38660252	.	A	G	30	36	66	0	3	69	0	0
1	38660369	.	G	A	39	31	70	0	2	72	0	0
1	38709351	.	A	C	27	0	27	0	15	43	1	0
1	38709381	.	G	C	23	13	36	4	0	40	0	0
1	38709480	.	G	A	18	10	28	0	0	28	0	0
1	38709535	.	T	A	17	12	29	0	0	29	0	0
1	38784551	.	A	T	11	10	21	0	1	22	0	0
1	38787039	.	C	T	8	7	15	0	0	15	0	0
1	38791569	.	C	T	8	17	25	0	0	25	0	0
1	38793983	.	G	A	9	5	14	0	0	14	0	0
1	38797663	.	A	C	15	13	28	0	1	29	0	0
1	38799513	.	G	A	16	13	29	0	0	29	0	0
1	38799585	.	A	G	18	11	29	0	0	29	0	0
1	38799588	.	T	A	14	16	30	0	0	30	0	0
1	38802537	.	G	A	11	11	22	0	1	23	0	0
1	38802703	.	A	G	7	16	23	0	2	25	0	0
1	38802718	.	G	A	18	12	30	0	1	31	0	0
1	38802747	.	A	G	13	1	14	0	11	25	0	0
1	38802855	.	C	A	14	8	22	0	0	22	0	0
1	38803092	.	C	T	4	2	6	2	0	8	0	0
1	38803205	.	A	T	12	9	21	0	1	22	0	0
1	38803404	.	A	G	13	14	27	0	0	27	0	0
1	38805128	.	G	T	8	4	12	0	3	15	0	0
1	38805135	.	C	T	11	4	15	0	0	15	0	0
1	38805439	.	G	A	10	9	19	0	0	19	0	0
1	38805450	.	A	G	8	9	17	0	1	18	0	0
1	38805506	.	G	A	15	10	25	0	0	25	0	0
1	38807255	.	G	C	8	8	16	0	0	16	0	0
1	38808259	.	C	A	8	8	16	0	1	17	0	0
1	38808379	.	C	T	1	8	9	0	8	17	0	0
1	38808723	.	T	A	8	10	18	0	0	18	0	0
1	38810061	.	T	G	9	8	17	0	0	17	0	0
1	38820219	.	G	A	1	11	12	0	11	23	0	0
1	38822092	.	A	T	5	4	9	0	0	9	0	0
1	38851225	.	C	T	2	2	4	1	0	5	0	0
1	39388092	.	C	T	8	3	11	0	0	11	0	0
1	39388103	.	G	A	0	4	4	0	9	13	0	0
1	39388332	.	A	C	2	2	4	0	0	4	0	0
1	39388363	.	C	T	4	2	6	0	0	6	0	0
1	39482532	.	C	T	4	3	7	0	0	7	0	0
1	39639723	.	C	T	8	8	16	0	0	16	0	0
1	39680758	.	G	A	1	5	6	0	8	14	0	0
1	39680794	.	C	A	8	6	14	0	1	15	0	0
1	39700498	.	T	C	4	7	11	0	1	12	0	0
1	39732544	.	C	T	9	10	19	0	1	20	0	0
1	39735491	.	T	C	14	13	27	0	0	27	0	0
1	39770416	.	C	T	11	12	23	0	0	23	0	0
1	39771429	.	T	A	13	13	26	0	0	26	0	0
1	39772010	.	T	C	14	16	30	0	1	31	0	0
1	39772042	.	A	G	12	7	19	0	3	22	0	0
1	39772135	.	C	A	16	13	29	0	0	29	0	0
1	39772225	.	C	T	17	19	36	0	2	38	0	0
1	39774096	.	C	T	16	14	30	0	1	31	0	0
1	39774225	.	C	T	12	12	24	0	3	27	0	0
1	39774363	.	G	A	13	15	28	0	1	29	0	0
1	39774618	.	A	G	20	12	32	0	1	33	0	0
1	39774690	.	A	G	17	10	27	0	1	28	0	0
1	39774727	.	C	A	14	11	25	0	2	27	0	0
1	39774891	.	C	T	21	18	39	0	3	42	0	0
1	39774915	.	G	A	23	20	43	0	1	44	0	0
1	39775089	.	C	T	13	14	27	0	1	28	0	0
1	39775131	.	C	T	19	12	31	0	2	33	0	0
1	39775227	.	C	T	18	12	30	0	1	31	0	0
1	39776356	.	A	C	21	19	40	0	2	42	0	0
1	39777089	.	G	A	13	16	29	0	3	32	0	0
1	39777836	.	G	A	1	17	18	0	11	29	0	0
1	39777975	.	A	T	13	16	29	0	1	30	0	0
1	39778047	.	A	G	14	0	14	0	15	29	0	0
1	39778075	.	T	G	10	17	27	0	0	27	0	0
1	39778332	.	G	C	26	21	47	0	0	47	0	0
1	39778661	.	G	A	13	8	21	0	0	21	0	0
1	39778663	.	G	A	14	7	21	0	1	22	0	0
1	39778949	.	G	C	20	15	35	0	1	36	0	0
1	39779225	.	G	C	10	11	21	0	0	21	0	0
1	39779468	.	A	T	4	3	7	0	0	7	0	0
1	39869860	.	T	A	4	3	7	0	0	7	0	0
1	39869917	.	T	A	3	3	6	0	0	6	0	0
1	39869974	.	G	A	2	3	5	0	1	6	0	0
1	39870008	.	T	C	2	2	4	0	0	4	0	0
1	39879560	.	T	C	3	4	7	0	0	7	0	0
1	39880815	.	T	G	1	0	1	0	4	5	0	0
1	39880877	.	A	G	1	2	3	0	2	5	0	0
1	39881107	.	A	G	1	2	3	0	0	3	0	0
1	39881116	.	A	G	0	0	0	0	3	3	0	0
1	39882764	.	A	T	2	3	5	0	0	5	0	0
1	39882899	.	A	G	3	5	8	0	1	9	0	0
1	39891915	.	G	A	1	2	3	0	0	3	0	0
1	39899477	.	G	C	18	26	44	0	1	45	0	0
1	39899494	.	A	G	26	15	41	0	3	44	0	0
1	39899663	.	G	A	25	20	45	0	2	47	0	0
1	39900056	.	G	A	21	29	50	0	1	51	0	0
1	39900129	.	G	A	27	21	48	0	1	49	0	0
1	39900137	.	G	T	27	20	47	0	1	48	0	0
1	39900360	.	G	A	11	15	26	0	0	26	0	0
1	39900432	.	C	T	1	16	17	0	13	30	0	0
1	39900750	.	C	T	2	16	18	0	11	29	0	0
1	39901269	.	G	A	5	10	15	0	1	16	0	0
1	39901378	.	T	A	12	12	24	0	0	24	0	0
1	39901500	.	T	C	12	8	20	0	0	20	0	0
1	39901501	.	G	A	12	7	19	0	1	20	0	0
1	39901729	.	T	C	21	0	21	0	16	37	0	0
1	39907291	.	A	C	7	7	14	0	0	14	0	0
1	39907492	.	T	C	21	0	21	0	16	37	0	0
1	39907611	.	C	T	0	12	12	0	6	18	0	0
1	39908047	.	G	A	21	13	34	0	0	34	0	0
1	39908680	.	C	T	18	8	26	0	4	30	0	0
1	39908854	.	A	G	12	18	30	0	1	31	0	0
1	39908881	.	C	T	13	17	30	0	2	32	0	0
1	39908926	.	A	G	10	12	22	0	0	22	0	0
1	39909003	.	A	T	20	9	29	0	0	29	0	0
1	39909247	.	A	T	18	23	41	0	0	41	0	0
1	39909274	.	A	T	20	17	37	0	3	40	0	0
1	39981794	.	A	G	9	4	13	0	1	14	0	0
1	39982971	.	G	A	1	2	3	0	0	3	0	0
1	39995100	.	C	T	8	14	22	0	2	24	0	0
1	39998875	.	G	A	15	12	27	0	3	30	0	0
1	40001853	.	A	T	16	10	26	0	2	28	0	0
1	40001873	.	C	A	14	8	22	0	1	23	0	0
1	40002113	.	G	A	15	10	25	0	0	25	0	0
1	40002148	.	C	G	16	12	28	0	0	28	0	0
1	40008905	.	T	C	22	16	38	0	1	39	0	0
1	40008906	.	G	A	23	16	39	0	1	40	0	0
1	40009227	.	T	A	14	14	28	0	0	28	0	0
1	40009258	.	C	T	15	9	24	0	4	28	0	0
1	40009291	.	A	G	15	9	24	0	0	24	0	0
1	40009382	.	G	A	17	11	28	0	0	28	0	0
1	40009526	.	T	C	4	4	8	0	0	8	0	0
1	40009625	.	T	C	11	6	17	0	0	17	0	0
1	40009671	.	C	A	13	6	19	0	2	21	0	0
1	40009697	.	C	T	12	4	16	0	0	16	0	0
1	40015189	.	A	G	9	2	11	0	2	13	0	0
1	40015219	.	C	T	16	8	24	0	2	26	0	0
1	40015265	.	C	T	1	6	7	0	24	31	0	0
1	40015553	.	A	G	12	5	17	0	0	17	0	0
1	40015697	.	A	G	9	10	19	0	1	20	0	0
1	40023692	.	T	C	9	7	16	0	0	16	0	0
1	40027564	.	C	A	5	3	8	0	0	8	0	0
1	40028208	.	C	A	7	3	10	0	0	10	0	0
1	40028424	.	C	T	9	10	19	0	1	20	0	0
1	40028508	.	C	T	13	7	20	0	0	20	0	0
1	40028568	.	G	T	10	5	15	0	1	16	0	0
1	40028613	.	G	A	9	6	15	0	0	15	0	0
1	40028637	.	C	T	5	7	12	0	0	13	1	0
1	40028680	.	G	A	4	5	9	0	1	10	0	0
1	40041528	.	C	T	10	10	20	0	0	20	0	0
1	40044175	.	G	C	6	4	10	0	0	10	0	0
1	40044562	.	G	A	10	4	14	0	0	14	0	0
1	40044578	.	C	T	6	13	19	0	0	19	0	0
1	40046859	.	G	A	6	5	11	0	0	11	0	0
1	40047070	.	T	A	10	12	22	0	0	22	0	0
1	40051918	.	T	C	10	8	18	1	0	19	0	0
1	40051923	.	G	C	11	6	17	1	2	20	0	0
1	40051988	.	G	C	2	17	19	0	8	27	0	0
1	40052033	.	A	G	20	7	27	0	1	28	0	0
1	40052066	.	G	C	8	13	21	0	0	21	0	0
1	40052083	.	G	A	8	15	23	1	2	26	0	0
1	40052481	.	A	C	9	5	14	0	0	14	0	0
1	40052638	.	T	A	1	2	3	0	0	3	0	0
1	40052965	.	T	A	1	2	3	0	1	4	0	0
1	40057483	.	C	T	4	5	9	0	0	9	0	0
1	40057604	.	A	G	3	5	8	0	1	9	0	0
1	40057805	.	C	T	11	11	22	0	1	23	0	0
1	40060836	.	T	A	4	4	8	0	0	8	0	0
1	40060860	.	T	C	3	2	5	0	0	5	0	0
1	40060968	.	A	C	7	11	18	0	0	18	0	0
1	40060992	.	C	T	0	12	12	0	7	19	0	0
1	40061061	.	C	T	2	6	8	0	5	13	0	0
1	40061169	.	G	A	12	4	16	0	2	18	0	0
1	40061285	.	C	T	9	7	16	0	1	17	0	0
1	40062593	.	T	G	10	7	17	0	0	17	0	0
1	40066299	.	G	A	7	7	14	0	0	14	0	0
1	40107874	.	T	G	10	9	19	0	0	19	0	0
1	40107961	.	C	T	7	6	13	0	0	13	0	0
1	40111679	.	C	G	14	23	37	0	2	39	0	0
1	40111702	.	T	G	16	23	39	0	3	42	0	0
1	40111737	.	A	C	17	19	36	0	0	36	0	0
1	40111738	.	G	A	18	17	35	0	2	37	0	0
1	40111776	.	C	T	11	16	27	0	3	30	0	0
1	40111918	.	C	T	16	12	28	0	2	30	0	0
1	40112206	.	T	C	7	4	11	0	3	14	0	0
1	40112347	.	C	T	5	7	12	0	1	13	0	0
1	40112410	.	C	T	7	5	12	0	0	12	0	0
1	40112713	.	A	G	3	0	3	0	3	6	0	0
1	40112760	.	T	A	6	10	16	0	0	16	0	0
1	40112822	.	A	T	16	8	24	0	0	24	0	0
1	40112837	.	C	T	8	14	22	0	0	22	0	0
1	40112869	.	C	T	18	10	28	0	1	29	0	0
1	40112879	.	A	G	15	9	24	0	3	27	0	0
1	40112938	.	G	C	5	10	15	1	0	16	0	0
1	40113374	.	T	A	2	4	6	0	0	6	0	0
1	40113486	.	A	G	1	3	4	0	0	4	0	0
1	40114070	.	G	A	3	2	5	0	0	5	0	0
1	40114155	.	T	A	1	2	3	0	0	3	0	0
1	40115018	.	A	T	3	3	6	0	0	6	0	0
1	40116747	.	G	A	12	9	21	0	0	21	0	0
1	40116823	.	C	T	1	2	3	0	4	7	0	0
1	40116889	.	G	A	1	2	3	0	0	3	0	0
1	40116915	.	T	G	5	3	8	0	0	8	0	0
1	40116946	.	C	T	1	2	3	0	7	10	0	0
1	40117345	.	G	A	16	9	25	0	3	28	0	0
1	40117792	.	C	T	5	10	15	0	0	15	0	0
1	40123964	.	C	T	4	10	14	0	11	25	0	0
1	40126279	.	T	C	6	15	21	0	1	22	0	0
1	40126281	.	T	G	8	12	20	0	3	23	0	0
1	40132692	.	G	C	2	8	10	0	0	10	0	0
1	40210865	.	G	T	16	16	32	1	1	34	0	0
1	40211048	.	C	T	0	10	10	0	9	19	0	0
1	40211065	.	T	C	7	11	18	0	0	18	0	0
1	40211217	.	A	C	11	6	17	0	0	17	0	0
1	40211465	.	T	C	17	0	17	0	15	32	0	0
1	40211645	.	C	G	1	10	11	0	16	27	0	0
1	40212065	.	C	T	15	16	31	0	0	31	0	0
1	40212084	.	C	A	4	15	19	0	10	29	0	0
1	40212305	.	C	T	15	19	34	0	2	36	0	0
1	40221359	.	A	G	10	13	23	0	0	23	0	0
1	40221458	.	A	T	6	12	18	0	0	18	0	0
1	40226289	.	G	A	10	9	19	0	2	21	0	0
1	40226292	.	G	C	9	9	18	0	2	20	0	0
1	40227029	.	T	G	10	12	22	0	0	22	0	0
1	40242922	.	C	A	2	3	5	0	0	5	0	0
1	40248173	.	C	T	5	5	10	0	0	10	0	0
1	40248383	.	C	T	9	6	15	0	0	15	0	0
1	40252219	.	T	A	15	13	28	0	2	30	0	0
1	40257577	.	A	G	16	12	28	0	0	28	0	0
1	40257631	.	C	T	9	4	13	0	0	13	0	0
1	40257751	.	C	T	5	8	13	0	1	14	0	0
1	40257834	.	T	G	9	0	9	0	11	20	0	0
1	40258340	.	G	T	2	2	4	0	0	4	0	0
1	40263675	.	C	A	2	6	8	0	1	9	0	0
1	40266618	.	C	T	28	32	60	0	1	61	0	0
1	40269724	.	C	G	1	2	3	0	0	3	0	0
1	40269754	.	A	C	1	2	3	0	0	3	0	0
1	40269998	.	T	G	1	2	3	0	0	3	0	0
1	40270054	.	C	T	38	20	58	0	6	64	0	0
1	40270094	.	G	A	3	26	29	0	28	57	0	0
1	40270095	.	G	A	30	25	55	0	4	59	0	0
1	40336234	.	C	G	3	8	11	0	0	11	0	0
1	40336396	.	A	C	4	0	4	0	2	6	0	0
1	40336789	.	G	A	5	4	9	0	0	9	0	0
1	40337314	.	C	T	10	9	19	0	1	20	0	0
1	40337464	.	C	A	0	14	14	0	9	23	0	0
1	40340571	.	C	T	7	5	12	0	1	13	0	0
1	40340598	.	C	T	10	7	17	0	0	17	0	0
1	40410608	.	C	T	1	4	5	0	4	9	0	0
1	40410839	.	A	T	11	11	22	0	0	22	0	0
1	40410908	.	C	T	18	6	24	0	2	26	0	0
1	40411091	.	T	A	6	12	18	0	0	18	0	0
1	40411928	.	T	C	6	5	11	1	0	12	0	0
1	40567094	.	G	A	11	18	29	0	1	30	0	0
1	40568601	.	G	A	7	11	18	0	2	20	0	0
1	40568707	.	A	G	9	1	10	0	13	23	0	0
1	40568883	.	G	A	2	21	23	0	10	33	0	0
1	40568990	.	A	G	20	14	34	0	1	35	0	0
1	40569153	.	C	T	12	10	22	0	0	22	0	0
1	40569168	.	C	T	12	6	18	0	0	18	0	0
1	40569231	.	G	A	12	9	21	0	1	22	0	0
1	40569295	.	A	T	14	8	22	0	2	24	0	0
1	40569386	.	T	A	11	10	21	8	1	30	0	0
1	40569466	.	A	T	17	14	31	0	1	32	0	0
1	40569538	.	G	A	16	9	25	0	1	26	0	0
1	40569548	.	T	C	14	10	24	0	0	24	0	0
1	40573703	.	G	T	18	20	38	0	1	39	0	0
1	40590967	.	T	G	28	17	45	0	1	46	0	0
1	40591262	.	T	C	16	24	40	0	2	42	0	0
1	40591272	.	T	C	16	25	41	0	1	42	0	0
1	40594373	.	C	T	15	18	33	0	1	34	0	0
1	40594415	.	C	T	2	17	19	0	10	29	0	0
1	40594517	.	T	C	26	1	27	1	15	43	0	0
1	40594526	.	G	A	29	17	46	1	1	48	0	0
1	40597332	.	A	C	19	0	19	0	24	43	0	0
1	40600992	.	A	T	16	15	31	0	0	31	0	0
1	40601547	.	G	A	17	9	26	0	0	26	0	0
1	40601595	.	G	C	11	0	11	0	11	22	0	0
1	40618861	.	C	T	10	9	19	0	0	19	0	0
1	40627291	.	G	A	12	6	18	0	2	20	0	0
1	40638246	.	A	T	6	7	13	0	1	14	0	0
1	40794437	.	T	C	4	2	6	0	1	7	0	0
1	40795213	.	C	A	4	4	8	0	0	8	0	0
1	40795231	.	A	T	5	3	8	0	0	8	0	0
1	40796779	.	G	T	4	2	6	0	0	6	0	0
1	40796791	.	G	A	3	4	7	0	1	8	0	0
1	40796977	.	C	T	5	2	7	0	0	7	0	0
1	40796985	.	A	T	6	2	8	0	0	8	0	0
1	40799045	.	G	A	1	2	3	0	0	3	0	0
1	40799343	.	C	A	1	2	3	0	0	3	0	0
1	40992716	.	T	A	11	3	14	0	1	15	0	0
1	40992823	.	A	G	3	5	8	0	1	9	0	0
1	40992878	.	C	G	7	6	13	0	1	14	0	0
1	40993349	.	C	T	3	12	15	0	7	22	0	0
1	40993714	.	G	A	9	4	13	0	0	13	0	0
1	40994068	.	T	A	4	3	7	0	1	8	0	0
1	41131608	.	C	T	19	16	35	1	0	36	0	0
1	41133944	.	G	A	9	9	18	0	2	20	0	0
1	41136245	.	T	C	13	12	25	0	0	25	0	0
1	41138638	.	A	G	12	11	23	0	1	24	0	0
1	41138641	.	C	T	12	14	26	0	0	26	0	0
1	41140465	.	T	C	11	17	28	0	0	28	0	0
1	41140640	.	C	T	16	14	30	1	1	32	0	0
1	41215289	.	T	A	9	15	24	0	0	24	0	0
1	41215312	.	T	G	11	15	26	0	1	27	0	0
1	41215547	.	G	A	11	11	22	0	2	24	0	0
1	41215746	.	T	A	19	10	29	0	0	29	0	0
1	41215868	.	T	G	12	4	16	0	0	16	0	0
1	41215869	.	G	T	5	9	14	0	1	15	0	0
1	41215998	.	T	C	8	4	12	0	0	12	0	0
1	41222341	.	T	C	9	4	13	0	1	14	0	0
1	41230927	.	C	T	9	10	19	0	1	20	0	0
1	41294719	.	A	G	9	11	20	0	0	20	0	0
1	41294760	.	T	C	7	14	21	0	2	23	0	0
1	41294790	.	G	T	5	16	21	0	0	21	0	0
1	41297453	.	C	T	1	10	11	0	10	21	0	0
1	41297495	.	G	A	14	13	27	0	2	29	0	0
1	41297561	.	C	T	7	10	17	0	0	17	0	0
1	41297564	.	A	T	11	5	16	0	1	17	0	0
1	41300133	.	C	T	10	9	19	0	1	20	0	0
1	41309208	.	C	G	8	6	14	0	2	16	0	0
1	41310074	.	A	G	9	7	16	0	0	16	0	0
1	41312210	.	G	A	8	8	16	0	0	16	0	0
1	41318203	.	T	G	5	7	12	2	0	14	0	0
1	41320781	.	A	G	5	14	19	0	1	20	0	0
1	41324327	.	C	T	1	7	8	0	10	18	0	0
1	41324444	.	C	T	1	7	8	0	2	10	0	0
1	41327484	.	A	T	6	5	11	0	1	12	0	0
1	41330394	.	G	A	8	5	13	0	1	14	0	0
1	41330594	.	G	C	7	7	14	0	0	14	0	0
1	41331692	.	G	A	7	11	18	0	0	18	0	0
1	41332989	.	T	C	3	0	3	0	4	7	0	0
1	41333034	.	G	A	3	3	6	0	0	6	0	0
1	41333321	.	A	G	4	6	10	0	2	12	0	0
1	41335135	.	G	A	10	3	13	0	0	13	0	0
1	41335147	.	T	A	9	3	12	0	0	12	0	0
1	41335270	.	G	A	2	10	12	0	0	12	0	0
1	41337314	.	G	A	7	8	15	0	0	15	0	0
1	41339963	.	C	T	1	11	12	0	3	15	0	0
1	41340128	.	C	G	6	10	16	0	0	16	0	0
1	41340133	.	T	G	4	10	14	0	1	15	0	0
1	41342427	.	C	A	2	4	6	0	0	6	0	0
1	41352634	.	G	C	1	7	8	0	0	8	0	0
1	41360074	.	A	G	6	2	8	0	0	8	0	0
1	41364819	.	G	A	2	1	3	0	0	3	0	0
1	41374028	.	G	T	2	5	7	0	0	7	0	0
1	41470524	.	T	C	26	19	45	0	0	45	0	0
1	41471529	.	T	C	26	21	47	0	0	47	0	0
1	41487459	.	C	A	7	6	13	0	0	13	0	0
1	41487474	.	C	T	5	6	11	0	0	11	0	0
1	41487811	.	C	T	3	12	15	0	0	15	0	0
1	41487960	.	A	T	8	5	13	0	0	13	0	0
1	41487973	.	T	C	6	6	12	0	0	12	0	0
1	41488030	.	T	C	4	2	6	0	0	6	0	0
1	41488643	.	A	C	8	3	11	0	1	12	0	0
1	41489068	.	C	T	2	3	5	0	0	5	0	0
1	41489274	.	G	C	2	2	4	0	1	5	0	0
1	41489343	.	G	A	1	2	3	0	0	3	0	0
1	41492032	.	A	G	1	0	1	0	3	4	0	0
1	41492367	.	A	T	1	4	5	0	0	5	0	0
1	41498219	.	A	G	9	6	15	0	0	15	0	0
1	41512895	.	C	T	7	5	12	0	0	12	0	0
1	41513332	.	G	A	5	2	7	0	0	7	0	0
1	41513497	.	G	A	11	5	16	0	1	17	0	0
1	41530370	.	C	T	5	5	10	0	0	10	0	0
1	41596291	.	C	T	3	3	6	0	0	6	0	0
1	41600339	.	T	C	6	4	10	0	0	10	0	0
1	41604931	.	C	G	8	0	8	0	7	15	0	0
1	41604934	.	C	G	8	0	8	0	8	16	0	0
1	41604985	.	G	A	0	10	10	0	4	14	0	0
1	41605011	.	T	C	4	6	10	0	1	11	0	0
1	41605065	.	C	A	6	5	11	0	0	11	0	0
1	41605149	.	T	C	6	2	8	0	1	9	0	0
1	41605203	.	C	T	6	5	11	0	0	11	0	0
1	41609961	.	C	A	2	2	4	0	0	4	0	0
1	41615874	.	C	T	6	7	13	0	2	15	0	0
1	41615904	.	T	C	10	9	19	0	1	20	0	0
1	41615949	.	T	C	9	8	17	0	0	17	0	0
1	41616081	.	T	G	4	5	9	0	1	10	0	0
1	41616186	.	A	C	5	4	9	0	1	10	0	0
1	41616867	.	T	A	1	2	3	0	0	3	0	0
1	41690506	.	C	T	16	8	24	0	0	24	0	0
1	41730609	.	C	T	16	21	37	0	1	38	0	0
1	41730669	.	G	A	13	17	30	0	2	32	0	0
1	41744103	.	C	T	17	8	25	0	0	25	0	0
1	41755157	.	C	T	13	18	31	0	0	31	0	0
1	41755158	.	A	T	13	18	31	0	0	31	0	0
1	41755195	.	C	T	24	11	35	1	0	36	0	0
1	41770847	.	T	A	10	9	19	0	1	20	0	0
1	41770872	.	T	C	13	7	20	0	1	21	0	0
1	41770959	.	T	C	13	12	25	0	0	25	0	0
1	41817556	.	G	A	4	4	8	0	0	8	0	0
1	41817574	.	T	C	4	3	7	0	0	7	0	0
1	41817678	.	C	T	9	3	12	0	0	12	0	0
1	41849293	.	A	G	14	5	19	0	0	19	0	0
1	41849310	.	A	G	11	8	19	0	3	22	0	0
1	41865471	.	C	T	21	19	40	0	2	42	0	0
1	41950085	.	T	A	1	2	3	0	0	3	0	0
1	42375005	.	C	A	11	15	26	0	0	26	0	0
1	42375071	.	C	T	14	14	28	0	3	31	0	0
1	42386349	.	T	C	11	7	18	0	1	19	0	0
1	42386364	.	C	A	8	10	18	0	0	18	0	0
1	42386430	.	T	C	10	6	16	0	1	17	0	0
1	42386436	.	T	C	11	5	16	0	1	17	0	0
1	42388351	.	T	C	9	10	19	0	0	19	0	0
1	42391172	.	T	C	12	10	22	0	1	23	0	0
1	42391194	.	T	C	14	10	24	0	0	24	0	0
1	42391214	.	G	A	10	12	22	0	2	24	0	0
1	42776652	.	T	C	22	16	38	0	1	39	0	0
1	42776787	.	C	T	2	15	17	0	17	34	0	0
1	42776806	.	A	T	19	17	36	0	1	37	0	0
1	42776853	.	T	C	23	20	43	0	1	44	0	0
1	42776906	.	A	G	22	19	41	0	0	41	0	0
1	42777116	.	G	A	15	20	35	0	0	36	1	0
1	42777146	.	C	G	1	15	16	0	18	34	0	0
1	42777383	.	A	G	21	21	42	0	2	45	1	0
1	42777593	.	T	G	13	14	27	0	0	27	0	0
1	42777674	.	G	A	16	12	28	0	2	30	0	0
1	42882955	.	C	T	13	14	27	0	5	32	0	0
1	43023630	.	G	A	16	10	26	0	2	28	0	0
1	43034947	.	C	T	18	18	36	0	4	40	0	0
1	43035178	.	T	C	12	15	27	0	2	29	0	0
1	43035546	.	T	A	7	2	9	0	0	9	0	0
1	43659248	.	C	T	3	31	34	0	25	59	0	0
1	43670083	.	A	G	25	22	47	0	2	49	0	0
1	43670378	.	C	T	0	24	24	0	11	35	0	0
1	43682472	.	C	A	18	29	47	0	0	47	0	0
1	43684513	.	A	G	15	15	30	2	1	33	0	0
1	43688164	.	G	A	2	3	5	0	0	5	0	0
1	43688242	.	C	T	1	6	7	0	0	7	0	0
1	43691412	.	C	A	3	3	6	0	1	7	0	0
1	43691598	.	T	C	2	2	4	0	0	4	0	0
1	43720168	.	A	G	3	4	7	0	0	7	0	0
1	43974433	.	A	T	3	3	6	0	0	6	0	0
1	43976515	.	C	T	1	2	3	0	0	3	0	0
1	43976539	.	A	C	1	2	3	0	0	3	0	0
1	43989063	.	G	A	5	2	7	0	1	8	0	0
1	43989064	.	C	A	7	2	9	0	0	9	0	0
1	43989132	.	T	A	7	2	9	0	0	9	0	0
1	43989134	.	C	A	7	2	9	0	0	9	0	0
1	43994103	.	A	G	6	3	9	0	0	9	0	0
1	43994129	.	A	G	3	4	7	0	0	7	0	0
1	43994191	.	T	C	4	2	6	0	0	6	0	0
1	43994213	.	C	T	2	3	5	0	0	5	0	0
1	43994447	.	A	C	8	6	14	0	0	14	0	0
1	43994567	.	G	A	5	7	12	0	0	12	0	0
1	43994790	.	T	G	12	4	16	0	0	16	0	0
1	43994840	.	T	A	8	6	14	0	0	14	0	0
1	43994948	.	C	A	5	6	11	0	1	12	0	0
1	43997679	.	C	T	2	5	7	0	0	7	0	0
1	43998272	.	C	T	5	4	9	0	0	9	0	0
1	43998275	.	G	A	3	5	8	0	0	8	0	0
1	43998526	.	C	T	8	4	12	0	0	12	0	0
1	44000786	.	C	T	8	4	12	0	0	12	0	0
1	44000868	.	T	C	11	1	12	0	4	16	0	0
1	44000898	.	C	T	7	4	11	0	0	11	0	0
1	44000927	.	A	T	2	2	4	0	0	5	1	0
1	44021757	.	T	C	4	0	4	0	7	11	0	0
1	44021800	.	G	T	5	6	11	0	0	11	0	0
1	44021837	.	A	C	6	0	6	0	8	14	0	0
1	44022017	.	C	G	6	6	12	1	0	13	0	0
1	44029176	.	C	T	5	4	9	0	0	9	0	0
1	44032066	.	G	A	2	3	5	0	0	5	0	0
1	44032299	.	C	T	3	1	4	0	0	4	0	0
1	44032460	.	G	T	1	2	3	0	0	3	0	0
1	44034439	.	G	T	3	8	11	0	0	11	0	0
1	44036924	.	T	C	1	3	4	0	0	4	0	0
1	44040513	.	A	T	3	4	7	0	0	7	0	0
1	44040854	.	T	C	2	3	5	0	0	5	0	0
1	44041079	.	G	A	6	7	13	0	0	13	0	0
1	44041350	.	G	A	5	5	10	0	0	10	0	0
1	44048179	.	C	T	0	4	4	0	5	10	1	0
1	44048263	.	C	T	6	7	13	0	0	13	0	0
1	44048446	.	C	A	3	2	5	0	2	7	0	0
1	44048482	.	A	T	1	5	6	0	0	6	0	0
1	44048592	.	T	G	3	2	5	0	0	5	0	0
1	44137729	.	T	A	1	2	3	0	0	3	0	0
1	44173395	.	A	C	1	4	5	0	0	5	0	0
1	44205523	.	C	A	10	5	15	0	1	16	0	0
1	44205679	.	G	A	1	4	5	0	9	14	0	0
1	44216738	.	A	C	8	9	17	0	2	19	0	0
1	44227346	.	C	T	8	7	15	0	0	15	0	0
1	44227764	.	G	T	10	9	19	1	1	21	0	0
1	44228020	.	T	A	6	6	12	0	0	12	0	0
1	44228033	.	G	A	0	5	5	0	7	12	0	0
1	44228081	.	A	G	5	4	9	0	0	9	0	0
1	44228243	.	T	G	13	5	18	0	1	19	0	0
1	44228705	.	C	T	1	3	4	0	3	7	0	0
1	44390558	.	A	G	21	16	37	0	0	37	0	0
1	44393977	.	T	C	16	22	38	0	2	40	0	0
1	44394276	.	A	T	6	4	10	0	0	10	0	0
1	44394329	.	T	G	2	2	4	0	0	4	0	0
1	44394390	.	G	A	2	2	4	0	0	4	0	0
1	44418010	.	A	C	2	2	4	0	0	4	0	0
1	44491134	.	A	T	11	22	33	0	1	34	0	0
1	44492030	.	C	A	27	21	48	0	0	48	0	0
1	44492413	.	C	T	25	21	46	0	4	50	0	0
1	44492476	.	C	T	32	24	56	0	1	57	0	0
1	44492626	.	A	C	28	30	58	0	4	62	0	0
1	44492791	.	C	T	29	28	57	0	1	58	0	0
1	44492842	.	G	T	30	31	61	0	0	61	0	0
1	44492875	.	A	T	27	26	53	0	2	55	0	0
1	44492908	.	G	A	4	31	35	0	28	63	0	0
1	44493085	.	C	T	35	22	57	0	7	64	0	0
1	44493498	.	A	T	31	24	55	0	2	57	0	0
1	44493575	.	C	A	20	24	44	0	1	45	0	0
1	44493952	.	G	A	3	24	27	0	25	52	0	0
1	44493971	.	G	A	28	24	52	0	3	55	0	0
1	44494090	.	G	A	5	34	39	0	31	70	0	0
1	44494153	.	C	T	33	31	64	0	3	67	0	0
1	44494371	.	G	T	3	22	25	0	18	43	0	0
1	44494506	.	G	T	30	10	40	0	1	41	0	0
1	44495258	.	C	T	28	20	48	0	4	52	0	0
1	44548800	.	T	C	7	9	16	0	0	16	0	0
1	44559553	.	A	C	7	0	7	0	16	23	0	0
1	44559559	.	T	G	9	0	9	0	11	20	0	0
1	44564983	.	C	T	10	12	22	0	1	23	0	0
1	44565022	.	T	C	5	10	15	0	3	18	0	0
1	44565025	.	C	T	10	6	16	0	0	16	0	0
1	44565084	.	C	T	11	9	20	0	0	20	0	0
1	44565138	.	T	C	9	12	21	0	1	22	0	0
1	44565188	.	C	A	7	8	15	0	3	18	0	0
1	44565288	.	A	T	11	9	20	0	0	20	0	0
1	44566084	.	C	T	7	10	17	0	2	19	0	0
1	44566133	.	C	A	16	7	23	0	0	23	0	0
1	44566193	.	G	T	1	13	14	0	15	29	0	0
1	44569458	.	G	A	13	11	24	0	0	24	0	0
1	44569717	.	C	T	3	13	16	0	20	36	0	0
1	44569907	.	A	C	6	4	10	0	1	11	0	0
1	44570740	.	C	T	15	10	25	0	4	29	0	0
1	44571352	.	T	C	9	7	16	0	0	16	0	0
1	44571370	.	C	T	2	6	8	0	5	13	0	0
1	44571420	.	G	T	8	8	16	0	0	16	0	0
1	44571480	.	G	T	13	9	22	0	1	23	0	0
1	44571672	.	C	T	1	11	12	1	12	25	0	0
1	44581710	.	C	T	3	11	14	0	14	28	0	0
1	44582513	.	C	T	15	14	29	0	0	29	0	0
1	44582576	.	G	A	1	16	17	0	17	34	0	0
1	44582657	.	G	A	7	9	16	0	0	16	0	0
1	44591232	.	C	A	9	5	14	0	1	15	0	0
1	44651929	.	G	C	4	0	4	0	15	19	0	0
1	44652498	.	A	G	30	17	47	0	1	48	0	0
1	44652511	.	A	C	28	19	47	0	1	48	0	0
1	44652599	.	T	C	23	1	24	0	21	45	0	0
1	44652916	.	T	A	22	26	48	1	2	51	0	0
1	44653014	.	C	T	26	22	48	0	3	51	0	0
1	44653076	.	A	T	23	25	48	0	0	48	0	0
1	44653135	.	T	A	17	19	36	0	1	37	0	0
1	44653150	.	T	A	18	17	35	0	0	35	0	0
1	44653171	.	A	G	22	15	37	0	0	37	0	0
1	44658849	.	T	C	25	3	28	0	25	53	0	0
1	44664964	.	T	A	18	16	34	0	4	38	0	0
1	44669970	.	G	T	19	16	35	0	2	37	0	0
1	44672271	.	G	A	14	22	36	0	1	37	0	0
1	44672571	.	G	A	24	8	32	0	3	35	0	0
1	44678037	.	A	G	13	21	34	0	0	34	0	0
1	44683393	.	G	A	18	20	38	0	1	39	0	0
1	44696138	.	G	A	16	11	27	0	0	27	0	0
1	44703761	.	G	T	13	22	35	0	2	37	0	0
1	44729413	.	C	T	17	18	35	0	0	35	0	0
1	44729449	.	G	C	19	18	37	0	0	37	0	0
1	44729479	.	C	G	16	11	27	0	0	27	0	0
1	44737473	.	G	A	1	12	13	0	10	23	0	0
1	44737653	.	A	T	4	7	11	0	0	11	0	0
1	44737750	.	T	A	10	5	15	0	0	15	0	0
1	44800662	.	C	T	1	2	3	0	1	4	0	0
1	44800676	.	C	T	3	2	5	0	0	5	0	0
1	44816363	.	A	G	19	1	20	0	18	38	0	0
1	44816380	.	G	A	19	19	38	0	3	41	0	0
1	44818992	.	A	G	25	1	26	0	15	41	0	0
1	44846997	.	G	A	5	13	18	0	3	21	0	0
1	44849126	.	C	T	4	5	9	0	0	9	0	0
1	44852503	.	T	C	13	9	22	0	0	22	0	0
1	44852737	.	G	C	8	7	15	0	0	15	0	0
1	44852817	.	G	A	7	7	14	0	0	14	0	0
1	44855409	.	T	C	8	4	12	0	0	12	0	0
1	44861744	.	C	T	22	6	28	0	0	28	0	0
1	44861954	.	A	T	16	9	25	0	2	27	0	0
1	44862092	.	C	G	22	11	33	0	5	38	0	0
1	44862707	.	C	T	18	10	28	1	1	30	0	0
1	44862725	.	G	A	20	11	31	1	0	32	0	0
1	44869068	.	G	A	24	13	37	2	1	40	0	0
1	44869115	.	C	T	21	12	33	2	0	35	0	0
1	44869173	.	A	T	12	8	20	0	2	22	0	0
1	44869174	.	C	T	14	7	21	0	2	23	0	0
1	44869216	.	G	A	13	5	18	0	0	18	0	0
1	44869621	.	G	A	14	6	20	0	1	21	0	0
1	44869638	.	A	G	6	8	14	0	0	14	0	0
1	44869666	.	C	A	14	8	22	0	0	22	0	0
1	44869810	.	T	C	7	6	13	0	0	13	0	0
1	44872586	.	A	G	5	5	10	0	0	10	0	0
1	44872735	.	C	T	3	3	6	0	0	6	0	0
1	44893456	.	T	C	2	6	8	0	0	8	0	0
1	44893526	.	C	T	0	5	5	0	2	7	0	0
1	44893894	.	G	T	6	4	10	0	0	10	0	0
1	44893921	.	T	A	5	4	9	0	1	10	0	0
1	44897218	.	G	C	6	0	6	0	7	13	0	0
1	44897259	.	C	A	8	6	14	0	1	15	0	0
1	44900938	.	G	T	3	6	9	0	0	9	0	0
1	44914322	.	C	T	1	2	3	0	0	3	0	0
1	44914355	.	T	A	2	2	4	0	0	4	0	0
1	44916631	.	C	A	4	4	8	0	0	8	0	0
1	44919737	.	C	T	3	2	5	0	0	5	0	0
1	44919749	.	G	A	3	3	6	0	0	6	0	0
1	44922512	.	G	A	6	3	9	0	0	9	0	0
1	44922550	.	T	G	2	5	7	0	0	7	0	0
1	44922712	.	G	T	1	5	6	0	0	6	0	0
1	44923063	.	A	T	1	4	5	0	2	7	0	0
1	44923148	.	C	T	5	2	7	0	1	8	0	0
1	44923565	.	C	T	3	2	5	0	1	6	0	0
1	44923661	.	T	C	4	3	7	0	0	7	0	0
1	44923723	.	C	T	5	5	10	0	0	10	0	0
1	44923830	.	T	C	3	3	6	0	0	6	0	0
1	44924122	.	A	G	2	3	5	0	0	5	0	0
1	44925602	.	A	G	1	2	3	0	0	3	0	0
1	44925945	.	C	T	1	6	7	0	0	7	0	0
1	44925977	.	G	A	2	6	8	0	1	9	0	0
1	44940755	.	C	A	2	3	5	0	1	6	0	0
1	44946030	.	C	T	2	4	6	0	0	6	0	0
1	44946039	.	T	G	3	2	5	0	0	5	0	0
1	44950079	.	G	T	4	2	6	0	0	6	0	0
1	44950178	.	T	G	4	5	9	0	0	9	0	0
1	44959343	.	C	G	14	7	21	0	1	22	0	0
1	44959347	.	C	A	16	9	25	0	0	25	0	0
1	44959408	.	C	A	16	9	25	0	2	27	0	0
1	44959538	.	C	T	11	8	19	2	0	21	0	0
1	44959580	.	T	C	7	4	11	3	0	14	0	0
1	44960204	.	T	A	4	4	8	0	1	9	0	0
1	44960252	.	A	G	2	11	13	0	0	13	0	0
1	44960898	.	G	A	9	7	16	0	0	16	0	0
1	44961055	.	A	C	11	6	17	0	0	17	0	0
1	44961245	.	C	A	7	7	14	0	0	14	0	0
1	44961347	.	T	A	4	6	10	0	0	11	1	0
1	44961387	.	G	A	0	5	5	0	8	13	0	0
1	44961406	.	A	G	7	0	7	0	8	15	0	0
1	44961612	.	A	T	6	13	19	0	0	19	0	0
1	44961698	.	A	G	3	0	3	0	10	13	0	0
1	44962036	.	T	A	14	11	25	0	0	25	0	0
1	45003075	.	G	T	12	15	27	0	2	29	0	0
1	45008646	.	T	C	6	10	16	0	1	17	0	0
1	45011637	.	A	G	14	11	25	0	0	25	0	0
1	45013571	.	G	A	16	8	24	0	1	25	0	0
1	45013775	.	T	C	7	2	9	0	1	10	0	0
1	45013894	.	G	A	6	8	14	0	0	14	0	0
1	45013904	.	G	A	6	9	15	0	0	15	0	0
1	45014176	.	G	A	7	13	20	0	1	21	0	0
1	45014263	.	A	G	9	12	21	0	0	21	0	0
1	45014361	.	C	A	7	3	10	0	0	10	0	0
1	45014373	.	C	A	7	3	10	0	0	10	0	0
1	45014976	.	C	G	10	11	21	0	1	22	0	0
1	45015095	.	A	T	11	8	19	0	0	19	0	0
1	45015271	.	A	G	3	5	8	0	0	8	0	0
1	45015310	.	T	C	3	4	7	0	0	7	0	0
1	45015586	.	G	A	8	7	15	0	0	15	0	0
1	45015687	.	T	C	8	9	17	0	0	17	0	0
1	45015693	.	C	T	7	10	17	0	0	17	0	0
1	45015809	.	A	G	3	3	6	0	1	7	0	0
1	45015827	.	G	C	2	2	4	0	0	4	0	0
1	45016070	.	C	T	7	6	13	0	1	14	0	0
1	45016216	.	G	A	3	4	7	0	1	8	0	0
1	45016221	.	G	T	5	3	8	0	0	8	0	0
1	45016502	.	T	A	11	10	21	0	2	23	0	0
1	45019745	.	C	T	29	26	55	1	3	59	0	0
1	45022069	.	C	T	3	28	31	0	18	49	0	0
1	45022114	.	G	A	20	21	41	2	1	44	0	0
1	45022156	.	C	T	20	21	41	2	0	43	0	0
1	45038781	.	G	A	18	9	27	0	1	28	0	0
1	45038894	.	G	A	15	8	23	0	3	26	0	0
1	45038963	.	A	C	17	17	34	0	0	34	0	0
1	45038966	.	T	C	18	16	34	0	0	34	0	0
1	45039608	.	T	C	15	13	28	0	5	33	0	0
1	45041107	.	T	C	13	12	25	0	2	27	0	0
1	45041116	.	A	C	15	13	28	0	0	28	0	0
1	45041152	.	C	T	3	7	10	0	13	23	0	0
1	45041257	.	G	A	24	23	47	0	1	48	0	0
1	45044236	.	A	G	24	39	63	0	3	66	0	0
1	45045401	.	A	G	33	26	59	0	4	63	0	0
1	45085242	.	T	C	19	22	41	0	2	43	0	0
1	45085261	.	C	G	16	1	17	0	21	38	0	0
1	45086369	.	T	C	24	24	48	0	1	49	0	0
1	45086405	.	G	A	29	19	48	0	3	51	0	0
1	45087729	.	G	A	25	26	51	0	2	53	0	0
1	45087810	.	A	T	14	26	40	0	2	42	0	0
1	45093732	.	A	C	23	20	43	0	2	45	0	0
1	45093762	.	A	G	27	19	46	0	4	50	0	0
1	45093769	.	A	T	29	20	49	0	2	51	0	0
1	45094157	.	C	T	27	18	45	0	2	47	0	0
1	45094226	.	T	G	17	20	37	0	2	39	0	0
1	45094235	.	G	A	19	20	39	0	1	40	0	0
1	45094264	.	C	G	21	25	46	0	1	47	0	0
1	45094317	.	A	T	14	25	39	0	3	42	0	0
1	45094322	.	A	C	30	10	40	0	1	41	0	0
1	45094831	.	T	A	1	3	4	0	0	4	0	0
1	45095019	.	T	C	5	2	7	2	0	9	0	0
1	45095150	.	C	A	3	10	13	0	1	14	0	0
1	45095157	.	G	A	0	9	9	0	2	11	0	0
1	45206076	.	G	A	13	8	21	0	0	21	0	0
1	45208096	.	G	A	13	16	29	0	3	32	0	0
1	45208396	.	C	T	0	14	14	0	11	25	0	0
1	45208771	.	C	A	15	11	26	0	0	26	0	0
1	45211431	.	G	A	20	15	35	0	0	35	0	0
1	45211599	.	C	T	7	11	18	0	2	20	0	0
1	45211602	.	G	A	12	6	18	0	0	18	0	0
1	45213290	.	G	A	13	19	32	0	1	33	0	0
1	45217781	.	A	T	6	3	9	0	0	9	0	0
1	45240507	.	G	A	3	3	6	0	0	6	0	0
1	45240516	.	A	C	3	4	7	0	0	7	0	0
1	45243416	.	C	A	4	4	8	0	1	9	0	0
1	45243551	.	C	T	5	2	7	0	0	7	0	0
1	45246614	.	T	C	2	4	6	0	0	6	0	0
1	45260765	.	G	C	10	4	14	0	0	14	0	0
1	45261266	.	C	G	5	9	14	0	0	14	0	0
1	45261353	.	C	T	7	5	12	0	1	13	0	0
1	45261383	.	G	A	1	6	7	0	5	12	0	0
1	45262384	.	A	T	5	4	9	0	0	9	0	0
1	45282591	.	T	C	1	3	4	0	0	4	0	0
1	45282594	.	A	G	1	0	1	0	4	5	0	0
1	45330064	.	G	A	13	14	27	0	2	29	0	0
1	45330165	.	A	C	28	16	44	0	1	45	0	0
1	45330174	.	C	T	26	16	42	0	0	42	0	0
1	45330207	.	C	T	12	21	33	0	1	34	0	0
1	45330386	.	T	G	17	2	19	0	16	35	0	0
1	45332801	.	T	G	6	2	8	0	0	8	0	0
1	45335160	.	G	A	11	10	21	0	0	21	0	0
1	45335187	.	G	A	11	12	23	0	2	25	0	0
1	45337115	.	G	A	12	14	26	0	0	26	0	0
1	45340851	.	G	A	3	10	13	0	1	14	0	0
1	45351969	.	A	G	4	4	8	0	0	8	0	0
1	45352030	.	C	T	4	3	7	0	0	7	0	0
1	45355709	.	C	T	7	4	11	0	0	11	0	0
1	45366096	.	G	A	0	6	6	0	8	14	0	0
1	45366137	.	A	T	4	4	8	0	0	8	0	0
1	45366271	.	G	C	2	2	4	0	0	4	0	0
1	45366288	.	A	T	1	3	4	0	0	4	0	0
1	45366338	.	C	T	3	3	6	0	1	7	0	0
1	45366386	.	C	A	2	2	4	0	1	5	0	0
1	45373247	.	A	G	19	13	32	0	3	35	0	0
1	45373517	.	C	A	18	19	37	0	0	37	0	0
1	45373665	.	G	A	14	17	31	0	2	33	0	0
1	45373666	.	T	C	15	17	32	0	0	32	0	0
1	45373795	.	A	G	20	22	42	0	0	42	0	0
1	45374657	.	T	A	10	19	29	0	0	29	0	0
1	45375065	.	G	A	7	11	18	0	1	19	0	0
1	45375271	.	C	T	7	9	16	3	0	22	3	0
1	45375573	.	A	T	11	13	24	0	0	24	0	0
1	45375666	.	G	A	14	7	21	0	0	21	0	0
1	45375790	.	C	A	7	6	13	0	1	14	0	0
1	45376352	.	T	C	14	23	37	0	1	38	0	0
1	45376413	.	G	A	20	19	39	0	1	40	0	0
1	45378546	.	G	A	13	13	26	0	1	27	0	0
1	45383598	.	C	T	14	11	25	0	0	25	0	0
1	45383646	.	G	A	8	16	24	0	0	24	0	0
1	45393491	.	C	T	0	13	13	0	5	18	0	0
1	45526241	.	G	A	8	8	16	0	0	16	0	0
1	45526247	.	C	G	1	7	8	0	9	17	0	0
1	45526337	.	C	A	2	11	13	0	10	23	0	0
1	45526418	.	T	G	10	12	22	0	0	22	0	0
1	45526439	.	G	A	15	12	27	0	0	27	0	0
1	45570225	.	T	A	9	18	27	1	2	30	0	0
1	45570384	.	T	A	15	14	29	0	1	30	0	0
1	45570876	.	G	A	20	25	45	0	3	48	0	0
1	45570909	.	C	A	3	22	25	0	32	57	0	0
1	45573418	.	A	G	18	16	34	0	1	35	0	0
1	45574320	.	C	T	1	16	17	0	18	35	0	0
1	45574347	.	T	C	12	0	12	0	18	30	0	0
1	45574478	.	T	A	23	11	34	0	0	34	0	0
1	45574560	.	T	C	22	9	31	0	2	33	0	0
1	45575610	.	G	T	23	16	39	0	1	41	1	0
1	45575613	.	T	C	21	15	36	0	5	41	0	0
1	45575910	.	G	T	21	4	25	0	1	26	0	0
1	45575911	.	C	T	21	4	25	0	0	25	0	0
1	45576094	.	T	C	19	8	27	0	2	29	0	0
1	45576107	.	A	G	21	9	30	0	0	30	0	0
1	45577570	.	A	G	20	15	35	0	1	36	0	0
1	45577899	.	A	G	22	12	34	0	1	35	0	0
1	45616925	.	G	A	20	19	39	0	2	41	0	0
1	45617163	.	G	A	18	24	42	0	0	42	0	0
1	45617226	.	C	A	21	16	37	0	2	39	0	0
1	45617239	.	A	G	21	18	39	0	1	40	0	0
1	45617300	.	G	A	13	8	21	0	2	23	0	0
1	45617436	.	C	T	20	24	44	0	0	45	1	0
1	45617457	.	C	G	23	25	48	0	1	49	0	0
1	45617478	.	T	A	21	18	39	0	8	47	0	0
1	45617577	.	T	A	21	23	44	0	1	45	0	0
1	45617657	.	A	T	20	21	41	0	0	41	0	0
1	45617743	.	C	T	19	25	44	0	3	47	0	0
1	45619758	.	T	C	26	22	48	0	2	50	0	0
1	45631275	.	T	C	21	0	21	0	19	40	0	0
1	45631469	.	G	A	20	17	37	0	1	38	0	0
1	45661876	.	T	A	3	2	5	0	1	6	0	0
1	45663869	.	C	T	3	7	10	0	0	10	0	0
1	45663883	.	T	G	2	6	8	0	0	8	0	0
1	45664224	.	C	T	14	18	32	0	1	33	0	0
1	45664260	.	G	A	21	14	35	0	1	36	0	0
1	45668754	.	C	T	9	6	15	0	0	15	0	0
1	45671775	.	C	T	3	3	6	0	1	7	0	0
1	45689715	.	G	A	5	3	8	0	0	8	0	0
1	45694005	.	T	C	5	2	7	0	1	8	0	0
1	45696262	.	G	A	0	3	3	0	5	8	0	0
1	45697339	.	G	T	4	4	8	0	0	8	0	0
1	45697555	.	C	T	3	2	5	0	0	5	0	0
1	45697558	.	T	C	3	3	6	0	0	6	0	0
1	45697762	.	G	A	3	4	7	0	0	7	0	0
1	45697813	.	C	T	4	3	7	0	1	8	0	0
1	45697838	.	T	A	3	3	6	0	0	6	0	0
1	45699494	.	A	G	1	2	3	0	0	3	0	0
1	45699597	.	G	C	1	2	3	0	0	3	0	0
1	45699993	.	C	T	3	4	7	0	0	7	0	0
1	45700116	.	T	C	2	3	5	0	0	5	0	0
1	45700379	.	A	G	5	4	9	0	0	9	0	0
1	45700396	.	G	A	3	4	7	0	0	7	0	0
1	45700509	.	G	A	0	2	2	0	2	4	0	0
1	45700511	.	G	A	2	1	3	0	1	4	0	0
1	45707268	.	T	C	2	8	10	0	0	10	0	0
1	45727918	.	A	G	9	0	9	0	6	15	0	0
1	45727928	.	A	G	9	0	9	0	5	14	0	0
1	45730896	.	A	T	13	11	24	0	0	24	0	0
1	45730905	.	T	C	13	12	25	0	0	25	0	0
1	45735695	.	T	C	5	9	14	0	0	14	0	0
1	45735704	.	A	G	7	5	12	0	0	12	0	0
1	45735817	.	G	A	9	14	23	2	0	25	0	0
1	45735990	.	G	A	1	8	9	0	7	16	0	0
1	45736045	.	T	A	5	11	16	0	0	16	0	0
1	45736171	.	A	G	8	0	8	0	8	16	0	0
1	45736412	.	A	C	3	7	10	0	1	11	0	0
1	45736517	.	A	C	2	3	5	0	0	5	0	0
1	45736528	.	G	A	3	2	5	0	0	5	0	0
1	45736686	.	C	A	7	9	16	0	0	16	0	0
1	45737067	.	T	G	7	10	17	0	0	17	0	0
1	45737202	.	G	A	10	10	20	0	0	20	0	0
1	45737271	.	G	A	6	5	11	0	0	11	0	0
1	45737442	.	C	T	15	13	28	0	1	29	0	0
1	45737590	.	C	A	8	6	14	0	1	15	0	0
1	45741134	.	C	A	2	7	9	0	0	9	0	0
1	45741220	.	A	G	5	0	5	0	6	11	0	0
1	45741361	.	G	A	2	2	4	0	0	4	0	0
1	45742348	.	A	G	3	3	6	0	0	6	0	0
1	45742382	.	C	T	2	4	6	0	0	6	0	0
1	45742481	.	A	T	3	9	12	0	0	12	0	0
1	45742555	.	T	C	3	3	6	0	0	6	0	0
1	45742596	.	A	G	2	0	2	0	5	7	0	0
1	45742599	.	C	A	2	5	7	0	0	7	0	0
1	45742640	.	T	C	2	3	5	0	0	5	0	0
1	45742715	.	T	G	4	3	7	0	0	7	0	0
1	45743935	.	A	G	0	4	4	0	0	4	0	0
1	45743999	.	T	C	5	3	8	0	0	8	0	0
1	45744017	.	A	G	2	5	7	0	0	7	0	0
1	45744091	.	C	T	5	4	9	0	1	10	0	0
1	45744212	.	A	T	4	6	10	0	0	10	0	0
1	45755050	.	G	A	0	2	2	0	1	3	0	0
1	45815037	.	C	T	3	3	6	0	0	6	0	0
1	45821033	.	G	A	0	2	2	0	2	4	0	0
1	45821042	.	G	A	2	2	4	0	0	4	0	0
1	45822935	.	A	G	1	2	3	0	0	3	0	0
1	45831446	.	G	A	3	3	6	0	3	9	0	0
1	45833011	.	T	A	6	2	8	0	0	8	0	0
1	45833127	.	T	C	4	4	8	0	1	9	0	0
1	45833155	.	A	C	2	3	5	0	1	6	0	0
1	45833165	.	A	T	6	3	9	0	0	9	0	0
1	45833715	.	G	C	1	2	3	1	0	4	0	0
1	45833734	.	A	T	1	2	3	0	0	3	0	0
1	45833900	.	G	A	1	3	4	0	0	4	0	0
1	45834001	.	C	T	2	3	5	0	0	5	0	0
1	45834022	.	G	A	0	3	3	0	4	7	0	0
1	45834146	.	C	G	2	2	4	0	1	5	0	0
1	45834156	.	A	T	5	2	7	0	0	7	0	0
1	45834404	.	A	G	4	5	9	0	0	9	0	0
1	45835246	.	A	T	3	2	5	0	0	5	0	0
1	45835298	.	C	T	2	3	5	0	0	5	0	0
1	45835389	.	G	A	4	6	10	0	0	10	0	0
1	45835455	.	A	T	5	4	9	0	0	9	0	0
1	45835486	.	G	A	3	5	8	0	1	9	0	0
1	45835615	.	G	A	3	2	5	0	0	5	0	0
1	45835815	.	G	A	9	3	12	0	0	12	0	0
1	45835870	.	T	G	3	4	7	0	0	7	0	0
1	45840013	.	T	C	9	4	13	0	1	14	0	0
1	45848680	.	G	T	0	4	4	0	3	7	0	0
1	45848713	.	G	A	0	1	1	0	2	3	0	0
1	45851881	.	G	A	0	4	4	0	1	5	0	0
1	45852113	.	T	C	4	2	6	0	0	6	0	0
1	45867414	.	G	T	11	7	18	0	1	19	0	0
1	45867759	.	C	T	23	11	34	0	1	35	0	0
1	45867830	.	A	G	15	15	30	0	3	33	0	0
1	45867834	.	C	T	19	15	34	0	0	34	0	0
1	45868007	.	C	T	1	23	24	0	19	43	0	0
1	45869326	.	C	T	20	14	34	0	1	35	0	0
1	45869447	.	C	A	14	21	35	0	2	37	0	0
1	45869588	.	A	C	16	12	28	0	0	28	0	0
1	45869923	.	T	C	6	5	11	0	2	13	0	0
1	45870044	.	G	A	10	11	21	0	0	21	0	0
1	45870046	.	G	T	11	7	18	0	3	21	0	0
1	45870223	.	A	G	6	9	15	0	4	19	0	0
1	45870253	.	A	G	13	7	20	0	1	21	0	0
1	45870644	.	A	G	15	8	23	0	1	24	0	0
1	45871331	.	T	C	11	10	21	0	0	21	0	0
1	45879827	.	G	A	6	7	13	0	0	13	0	0
1	45889009	.	T	C	6	6	12	0	0	12	0	0
1	45892097	.	G	A	8	15	23	0	0	23	0	0
1	45892469	.	C	G	9	4	13	0	0	13	0	0
1	45892556	.	G	A	10	6	16	0	0	16	0	0
1	45892706	.	A	G	4	5	9	0	0	9	0	0
1	45894103	.	C	T	0	7	7	0	4	11	0	0
1	45894827	.	G	T	6	3	9	0	2	11	0	0
1	45897615	.	G	A	7	9	16	0	0	16	0	0
1	45897970	.	G	A	5	6	11	0	0	11	0	0
1	45897988	.	C	T	1	4	5	0	9	14	0	0
1	45898011	.	G	A	10	6	16	0	0	16	0	0
1	45901798	.	A	G	3	7	10	0	0	10	0	0
1	45901870	.	A	G	11	6	17	0	0	17	0	0
1	45902230	.	A	G	11	9	20	0	1	21	0	0
1	45902233	.	G	T	12	9	21	0	1	22	0	0
1	45902614	.	C	T	6	3	9	0	0	9	0	0
1	45905957	.	G	T	5	7	12	0	0	12	0	0
1	45906186	.	A	G	1	6	7	0	0	7	0	0
1	45906437	.	T	C	1	0	1	0	6	7	0	0
1	45923586	.	G	A	5	3	8	0	0	8	0	0
1	45923628	.	C	T	3	2	5	0	0	5	0	0
1	45923630	.	C	A	3	2	5	0	0	5	0	0
1	45923905	.	A	G	2	0	2	0	2	4	0	0
1	45935510	.	G	A	9	12	21	0	1	22	0	0
1	45935642	.	T	C	8	4	12	0	0	12	0	0
1	45935753	.	A	G	10	11	21	0	2	23	0	0
1	45935849	.	G	A	9	9	18	0	0	18	0	0
1	45937624	.	T	C	2	5	7	0	0	7	0	0
1	45937639	.	A	G	3	6	9	0	0	9	0	0
1	45937693	.	A	G	10	0	10	0	6	16	0	0
1	45939811	.	A	G	5	0	5	0	5	10	0	0
1	45941557	.	G	A	15	9	24	0	0	24	0	0
1	45944033	.	C	T	7	3	10	0	1	11	0	0
1	45944239	.	A	G	6	4	10	0	1	11	0	0
1	45944475	.	G	A	8	9	17	0	1	18	0	0
1	45946667	.	C	T	8	5	13	0	0	13	0	0
1	45946739	.	C	T	4	6	10	0	1	11	0	0
1	45947875	.	G	T	7	10	17	0	0	17	0	0
1	45948157	.	G	A	13	5	18	0	0	18	0	0
1	45952797	.	C	T	7	4	11	0	0	11	0	0
1	45952994	.	T	C	5	5	10	0	1	11	0	0
1	45953009	.	C	T	6	7	13	0	0	13	0	0
1	45953066	.	G	A	6	13	19	0	0	19	0	0
1	45953087	.	C	T	7	11	18	0	0	18	0	0
1	45955771	.	A	C	4	10	14	0	1	15	0	0
1	45956046	.	G	A	12	7	19	0	0	19	0	0
1	45956166	.	G	T	9	7	16	1	0	17	0	0
1	45956231	.	A	G	10	12	22	0	1	23	0	0
1	46020602	.	A	G	1	6	7	0	0	7	0	0
1	46449464	.	C	T	0	2	2	0	2	4	0	0
1	46831357	.	G	A	7	5	12	0	1	13	0	0
1	47120514	.	A	T	10	4	14	0	0	14	0	0
1	47120622	.	G	C	2	15	17	4	1	22	0	0
1	47120627	.	C	T	2	17	19	4	1	24	0	0
1	47170732	.	A	G	6	2	8	0	0	8	0	0
1	47500084	.	G	A	1	3	4	0	0	4	0	0
1	47511153	.	A	G	5	2	7	0	1	8	0	0
1	47683909	.	T	C	1	6	7	0	0	7	0	0
1	47969835	.	G	A	1	2	3	0	1	4	0	0
1	48379832	.	T	A	4	2	6	0	0	6	0	0
1	48390707	.	T	A	6	3	9	0	0	9	0	0
1	48390712	.	T	A	5	3	8	0	0	8	0	0
1	48406434	.	C	G	2	0	2	0	3	5	0	0
1	48452518	.	C	T	3	2	5	0	0	5	0	0
1	48452524	.	G	A	1	2	3	0	2	5	0	0
1	48452633	.	G	A	0	5	5	0	3	8	0	0
1	48470316	.	G	A	4	2	6	0	0	6	0	0
1	48486543	.	A	G	2	2	4	1	0	5	0	0
1	48486803	.	C	T	3	2	5	0	0	5	0	0
1	48487228	.	T	C	2	3	5	1	0	6	0	0
1	48487555	.	C	T	3	2	5	0	0	5	0	0
1	48487556	.	T	G	3	2	5	0	0	5	0	0
1	48487729	.	T	A	5	5	10	0	0	10	0	0
1	48488243	.	T	G	4	4	8	0	0	8	0	0
1	48488362	.	T	A	4	3	7	0	0	7	0	0
1	48488377	.	G	A	1	4	5	0	3	8	0	0
1	48488398	.	C	T	3	5	8	0	0	8	0	0
1	48488436	.	C	T	2	4	6	0	0	6	0	0
1	48488496	.	C	T	3	2	5	0	1	6	0	0
1	48488898	.	A	T	2	5	7	0	0	7	0	0
1	48489474	.	A	G	3	6	9	0	0	9	0	0
1	48581796	.	T	C	1	0	1	0	4	5	0	0
1	48581919	.	C	T	6	6	12	0	1	13	0	0
1	48582091	.	T	C	4	3	7	0	0	7	0	0
1	48583000	.	T	C	5	6	11	1	0	12	0	0
1	48583098	.	C	G	1	3	4	0	0	4	0	0
1	48583521	.	A	C	9	6	15	0	0	15	0	0
1	48583528	.	C	T	9	6	15	0	0	15	0	0
1	48583844	.	G	C	5	9	14	0	1	15	0	0
1	48587725	.	T	A	8	10	18	0	1	19	0	0
1	48600877	.	T	C	4	0	4	0	5	9	0	0
1	48607301	.	T	C	3	4	7	0	0	7	0	0
1	48607361	.	A	G	6	7	13	0	0	13	0	0
1	48614986	.	T	C	3	5	8	0	1	9	0	0
1	48921983	.	G	A	3	6	9	0	0	9	0	0
1	48922123	.	C	T	1	2	3	0	2	5	0	0
1	49289663	.	G	A	3	27	30	0	30	61	1	0
1	49289729	.	C	G	35	6	41	0	32	73	0	0
1	49293733	.	C	T	29	27	56	1	1	58	0	0
1	49293891	.	G	A	23	19	42	0	1	43	0	0
1	49294003	.	G	A	21	21	42	2	1	45	0	0
1	49294032	.	A	T	9	19	28	3	1	32	0	0
1	49294654	.	G	A	14	14	28	0	0	28	0	0
1	49294727	.	G	C	15	13	28	0	1	29	0	0
1	49294765	.	T	C	18	22	40	0	0	40	0	0
1	49420026	.	T	C	6	5	11	0	1	12	0	0
1	49420044	.	G	A	8	5	13	0	0	13	0	0
1	49420637	.	G	A	7	5	12	0	0	12	0	0
1	49420658	.	A	G	6	7	13	0	0	13	0	0
1	49423200	.	G	A	13	5	18	1	0	19	0	0
1	49424516	.	G	A	1	4	5	0	9	14	0	0
1	49424543	.	T	A	6	10	16	0	0	16	0	0
1	49425668	.	C	T	6	8	14	0	0	14	0	0
1	49425737	.	C	T	1	7	8	0	0	8	0	0
1	49427972	.	G	C	0	7	7	0	9	16	0	0
1	49429878	.	G	A	0	14	14	0	8	22	0	0
1	49429917	.	C	A	7	8	15	0	1	16	0	0
1	49429944	.	T	A	9	7	16	0	0	16	0	0
1	49435086	.	A	G	5	6	11	0	0	11	0	0
1	49437991	.	C	T	1	2	3	0	0	3	0	0
1	49438011	.	G	T	2	2	4	0	0	4	0	0
1	49438038	.	T	C	2	2	4	0	0	4	0	0
1	49442683	.	C	G	3	3	6	0	1	7	0	0
1	49442960	.	C	G	1	3	4	0	0	4	0	0
1	49447611	.	A	G	2	3	5	0	0	5	0	0
1	49453465	.	C	G	5	3	8	0	0	8	0	0
1	49457751	.	G	A	3	5	8	0	1	9	0	0
1	49461033	.	C	A	6	2	8	0	0	8	0	0
1	49461225	.	A	G	3	6	9	0	1	10	0	0
1	49464920	.	A	T	3	5	8	0	0	8	0	0
1	49466190	.	G	A	4	3	7	0	2	9	0	0
1	49473716	.	G	T	9	7	16	0	0	16	0	0
1	49473970	.	G	C	6	14	20	0	0	20	0	0
1	49474079	.	G	A	1	3	4	0	11	15	0	0
1	49474993	.	T	C	10	3	13	0	0	13	0	0
1	49474995	.	C	T	7	3	10	0	2	12	0	0
1	49475714	.	C	T	6	6	12	0	3	15	0	0
1	49475769	.	A	C	9	7	16	0	1	17	0	0
1	49480825	.	T	G	4	7	11	0	0	11	0	0
1	49481546	.	T	A	12	15	27	0	3	30	0	0
1	49481567	.	T	G	14	15	29	0	0	29	0	0
1	49481649	.	T	C	10	9	19	0	1	20	0	0
1	49481787	.	A	G	14	13	27	0	3	30	0	0
1	49481866	.	T	G	19	19	38	0	2	40	0	0
1	49481886	.	A	T	19	18	37	0	1	38	0	0
1	49482742	.	C	T	10	11	21	0	1	22	0	0
1	49482755	.	C	T	13	15	28	0	0	28	0	0
1	49482984	.	T	A	7	11	18	0	0	18	0	0
1	49483217	.	C	G	5	2	7	0	0	7	0	0
1	49483242	.	T	C	9	4	13	0	0	13	0	0
1	49483270	.	C	T	10	6	16	0	2	18	0	0
1	49483300	.	A	G	12	11	23	0	1	24	0	0
1	49483555	.	T	C	12	6	18	1	2	21	0	0
1	49483563	.	T	C	12	5	17	1	1	19	0	0
1	49483679	.	G	A	14	15	29	0	1	30	0	0
1	49483721	.	T	G	9	11	20	0	0	20	0	0
1	49483901	.	T	A	16	21	37	0	2	39	0	0
1	49484002	.	A	T	27	20	47	0	2	49	0	0
1	49484096	.	G	T	15	24	39	0	4	43	0	0
1	49484146	.	G	A	16	20	36	0	2	38	0	0
1	49492396	.	G	A	12	15	27	0	1	28	0	0
1	49497590	.	T	G	5	11	16	0	3	19	0	0
1	49606724	.	A	G	6	2	8	0	0	8	0	0
1	49606801	.	A	G	3	4	7	0	1	8	0	0
1	49607102	.	A	T	6	4	10	0	0	10	0	0
1	49607156	.	T	G	7	3	10	0	0	10	0	0
1	49607223	.	T	A	4	3	7	0	0	7	0	0
1	49607251	.	T	C	5	3	8	0	0	8	0	0
1	49607370	.	G	A	3	3	6	0	2	8	0	0
1	49607490	.	A	C	1	4	5	0	0	5	0	0
1	49607650	.	T	C	1	4	5	0	0	5	0	0
1	49607675	.	T	G	1	2	3	0	0	3	0	0
1	49607706	.	C	T	1	5	6	0	0	6	0	0
1	49607746	.	C	G	2	3	5	0	1	6	0	0
1	49608014	.	T	C	4	3	7	0	1	8	0	0
1	49608027	.	T	C	3	0	3	0	3	6	0	0
1	49609011	.	C	T	6	5	11	0	0	11	0	0
1	49609024	.	C	T	1	6	7	0	5	12	0	0
1	49609048	.	A	G	4	3	7	0	1	8	0	0
1	49609065	.	A	G	3	3	6	0	0	6	0	0
1	49609113	.	G	C	2	0	2	0	5	7	0	0
1	49609191	.	G	A	4	5	9	0	0	9	0	0
1	49609247	.	G	A	9	3	12	0	0	12	0	0
1	49613880	.	C	T	6	3	9	0	0	9	0	0
1	49622992	.	T	C	8	7	15	0	1	16	0	0
1	49625706	.	A	G	1	8	9	0	0	9	0	0
1	49626456	.	C	T	4	5	9	0	0	9	0	0
1	49626514	.	A	G	3	6	9	0	0	9	0	0
1	49627769	.	C	A	2	2	4	0	0	4	0	0
1	49633402	.	T	G	2	3	5	0	0	5	0	0
1	49633426	.	C	A	1	4	5	0	0	5	0	0
1	49648546	.	G	A	4	3	7	0	0	7	0	0
1	49648979	.	G	T	3	3	6	0	0	6	0	0
1	49648996	.	A	T	4	4	8	0	0	8	0	0
1	49649030	.	C	T	0	5	5	0	6	11	0	0
1	49649047	.	T	C	4	6	10	0	0	10	0	0
1	49693244	.	T	C	1	2	3	0	0	3	0	0
1	49694765	.	T	A	4	4	8	0	0	8	0	0
1	49694773	.	T	C	4	3	7	0	1	8	0	0
1	49696076	.	G	A	6	7	13	0	0	13	0	0
1	49814674	.	T	C	20	12	32	0	0	32	0	0
1	49902787	.	C	T	7	4	11	0	0	11	0	0
1	49912665	.	C	T	7	9	16	0	1	17	0	0
1	49912827	.	A	G	3	9	12	0	0	12	0	0
1	49912841	.	C	A	0	9	9	0	3	12	0	0
1	49912866	.	C	T	0	9	9	0	3	12	0	0
1	49913062	.	A	G	9	16	25	0	2	27	0	0
1	49913071	.	G	A	10	17	27	0	3	30	0	0
1	49913101	.	T	G	8	21	29	0	1	30	0	0
1	49915208	.	G	A	5	15	20	0	2	22	0	0
1	49915231	.	C	T	4	13	17	0	2	19	0	0
1	49918779	.	T	C	4	8	12	0	1	13	0	0
1	49929579	.	G	A	3	6	9	0	0	9	0	0
1	49929693	.	T	C	4	4	8	0	0	8	0	0
1	49929726	.	A	G	4	3	7	0	0	7	0	0
1	49929784	.	C	T	6	2	8	0	0	8	0	0
1	49930146	.	G	A	4	2	6	0	1	7	0	0
1	49931697	.	A	C	4	3	7	0	0	7	0	0
1	49931763	.	T	A	5	4	9	0	2	11	0	0
1	49931814	.	C	A	0	3	3	0	7	10	0	0
1	49931874	.	T	C	5	3	8	0	0	8	0	0
1	49960756	.	T	C	4	2	6	0	0	6	0	0
1	49980609	.	T	C	2	4	6	0	0	6	0	0
1	49980622	.	T	C	1	3	4	0	0	4	0	0
1	49980651	.	G	A	1	2	3	0	0	3	0	0
1	50035697	.	C	T	2	4	6	0	0	6	0	0
1	50051814	.	C	A	1	4	5	0	0	5	0	0
1	50111654	.	C	T	5	7	12	0	0	12	0	0
1	50171219	.	T	C	8	11	19	0	0	19	0	0
1	50172815	.	A	G	14	18	32	0	0	32	0	0
1	50178829	.	C	A	16	12	28	0	3	31	0	0
1	50178988	.	A	G	6	0	6	0	10	16	0	0
1	50183822	.	C	A	5	3	8	0	1	9	0	0
1	50185244	.	G	A	1	11	12	0	6	18	0	0
1	50187688	.	A	G	8	10	18	0	0	18	0	0
1	50187836	.	T	G	4	5	9	0	0	10	1	0
1	50187866	.	A	G	4	0	4	0	5	9	0	0
1	50198619	.	C	A	3	2	5	0	0	5	0	0
1	50198792	.	T	C	6	6	12	0	0	12	0	0
1	50198815	.	C	T	1	7	8	0	7	15	0	0
1	50199365	.	A	T	8	4	12	0	2	14	0	0
1	50199368	.	G	A	11	3	14	0	0	14	0	0
1	50245894	.	G	C	10	10	20	0	0	20	0	0
1	50257749	.	T	C	3	0	3	0	5	8	0	0
1	50261274	.	A	G	3	5	8	0	1	9	0	0
1	50265198	.	T	C	7	0	7	0	7	14	0	0
1	50266593	.	G	A	6	5	11	0	0	11	0	0
1	50266704	.	C	G	3	4	7	0	0	7	0	0
1	50270280	.	A	G	4	3	7	0	0	7	0	0
1	50273133	.	G	A	5	4	9	0	1	10	0	0
1	50284907	.	A	G	3	7	10	0	1	11	0	0
1	50293876	.	A	G	10	6	16	0	0	16	0	0
1	50301833	.	A	G	15	9	24	0	1	25	0	0
1	50303989	.	G	A	1	11	12	0	18	30	0	0
1	50319584	.	A	G	3	5	8	0	1	9	0	0
1	50393160	.	C	G	4	2	6	0	0	6	0	0
1	50393232	.	G	T	5	4	9	0	0	9	0	0
1	50487649	.	G	T	8	12	20	0	1	21	0	0
1	50487837	.	C	A	5	9	14	0	1	15	0	0
1	50487844	.	G	A	3	9	12	0	0	12	0	0
1	50487895	.	T	C	8	1	9	0	4	13	0	0
1	50487938	.	A	C	10	5	15	0	1	16	0	0
1	50488002	.	A	G	6	6	12	0	0	12	0	0
1	50496598	.	A	G	6	8	14	0	0	14	0	0
1	50502852	.	C	T	0	10	10	0	3	13	0	0
1	50519961	.	T	C	3	5	8	1	1	10	0	0
1	50520003	.	A	G	5	8	13	0	0	13	0	0
1	50521790	.	T	C	7	3	10	0	0	10	0	0
1	50521871	.	G	T	5	9	14	0	0	14	0	0
1	50551383	.	G	A	1	2	3	0	3	6	0	0
1	50554362	.	A	C	2	2	4	0	0	4	0	0
1	50554597	.	C	T	2	4	6	0	0	6	0	0
1	50594217	.	T	C	14	18	32	0	2	34	0	0
1	50594318	.	T	G	10	11	21	0	0	21	0	0
1	50594346	.	A	G	7	10	17	0	1	18	0	0
1	50594647	.	G	A	9	6	15	2	0	17	0	0
1	50594670	.	A	T	11	10	21	1	0	22	0	0
1	50594986	.	T	C	14	0	14	0	13	27	0	0
1	50595288	.	T	C	13	18	31	0	0	31	0	0
1	50595289	.	G	A	12	18	30	0	0	30	0	0
1	50595476	.	G	A	16	10	26	0	0	26	0	0
1	50595608	.	G	C	4	10	14	0	0	14	0	0
1	50595748	.	T	C	18	12	30	0	0	30	0	0
1	50595805	.	G	A	15	11	26	0	1	27	0	0
1	50595809	.	T	A	13	13	26	0	1	27	0	0
1	50596694	.	A	G	21	16	37	0	0	37	0	0
1	50598848	.	G	A	16	23	39	0	1	40	0	0
1	50598872	.	A	G	19	18	37	0	5	42	0	0
1	50602955	.	G	A	3	2	5	0	0	5	0	0
1	50608232	.	T	C	10	25	35	0	0	35	0	0
1	50608373	.	G	A	20	14	34	0	0	34	0	0
1	50608691	.	A	T	11	11	22	1	1	24	0	0
1	50608692	.	T	C	12	11	23	1	0	24	0	0
1	50611013	.	G	A	3	4	7	0	0	7	0	0
1	50642380	.	G	A	1	3	4	0	6	10	0	0
1	50646922	.	G	A	1	9	10	0	2	12	0	0
1	50652102	.	G	A	4	4	8	0	0	8	0	0
1	50656594	.	T	C	5	12	17	0	1	18	0	0
1	50657063	.	T	G	7	7	14	0	0	14	0	0
1	50657093	.	T	C	8	9	17	0	0	17	0	0
1	50657117	.	C	A	10	6	16	0	0	16	0	0
1	50660378	.	A	T	10	6	16	0	0	16	0	0
1	50666985	.	T	A	6	6	12	0	0	12	0	0
1	50668798	.	G	A	0	2	2	0	2	4	0	0
1	50668883	.	C	T	8	4	12	0	1	13	0	0
1	50668915	.	C	T	8	5	13	0	2	15	0	0
1	50670799	.	T	C	5	5	10	0	0	10	0	0
1	50673749	.	G	A	0	7	7	0	7	14	0	0
1	50688646	.	A	G	8	0	8	0	8	16	0	0
1	50688682	.	A	T	10	4	14	0	0	14	0	0
1	50702736	.	C	T	4	15	19	0	0	19	0	0
1	50703007	.	A	G	9	7	16	0	0	16	0	0
1	50847905	.	T	C	2	5	7	0	0	7	0	0
1	50848106	.	A	G	9	12	21	0	0	21	0	0
1	50848115	.	A	G	9	13	22	0	1	23	0	0
1	50848206	.	A	C	15	9	24	0	1	25	0	0
1	50848504	.	C	T	12	14	26	0	5	31	0	0
1	50848532	.	G	A	9	17	26	0	8	34	0	0
1	50848555	.	A	G	14	11	25	0	2	27	0	0
1	50848595	.	T	C	14	14	28	0	1	29	0	0
1	50848609	.	A	C	13	11	24	0	3	27	0	0
1	50848647	.	C	T	0	20	20	0	17	37	0	0
1	50848659	.	A	G	14	15	29	0	2	31	0	0
1	50848815	.	A	G	11	17	28	0	7	35	0	0
1	50848911	.	A	G	10	13	23	0	0	23	0	0
1	50848961	.	C	T	15	17	32	0	0	32	0	0
1	50849055	.	T	C	22	1	23	0	19	42	0	0
1	50849125	.	T	C	20	15	35	0	1	36	0	0
1	50849157	.	C	T	3	15	18	0	22	40	0	0
1	50849199	.	T	C	15	2	17	0	14	31	0	0
1	50849282	.	A	G	11	9	20	0	0	20	0	0
1	50849331	.	G	A	9	14	23	0	2	25	0	0
1	50849456	.	G	A	16	6	22	0	3	25	0	0
1	50849670	.	A	C	9	0	9	0	5	14	0	0
1	50849697	.	T	C	12	0	12	0	5	17	0	0
1	50849705	.	C	G	12	4	16	0	1	17	0	0
1	50850041	.	T	A	20	11	31	0	1	32	0	0
1	50850170	.	C	T	14	12	26	0	0	26	0	0
1	50858891	.	A	T	4	6	10	0	0	10	0	0
1	50969207	.	G	A	0	25	25	0	22	47	0	0
1	50977089	.	C	T	16	15	31	0	0	31	0	0
1	50977569	.	A	C	3	2	5	0	0	5	0	0
1	50977607	.	G	A	1	3	4	0	0	4	0	0
1	50977640	.	G	T	1	2	3	0	0	3	0	0
1	50977707	.	G	A	4	58	62	1	62	125	0	0
1	50977899	.	A	G	1	0	1	0	2	3	0	0
1	50979925	.	T	C	27	34	61	4	6	71	0	0
1	50985169	.	C	T	30	40	70	0	0	70	0	0
1	50986092	.	T	C	33	35	68	0	8	76	0	0
1	50986110	.	A	G	37	38	75	0	3	78	0	0
1	50986197	.	C	T	27	37	64	0	5	69	0	0
1	50987507	.	A	C	42	39	81	0	3	84	0	0
1	50990593	.	A	G	27	4	31	0	29	60	0	0
1	50990698	.	A	T	28	25	53	1	2	56	0	0
1	50990815	.	G	A	29	23	52	0	0	52	0	0
1	51013210	.	C	T	3	2	5	0	0	5	0	0
1	51021731	.	G	A	4	3	7	0	1	8	0	0
1	51024947	.	T	C	3	8	11	0	0	11	0	0
1	51024992	.	A	G	4	9	13	0	0	13	0	0
1	51029529	.	A	G	4	4	8	0	0	8	0	0
1	51031234	.	G	A	8	4	12	0	0	12	0	0
1	51031291	.	T	C	3	0	3	0	3	6	0	0
1	51031476	.	A	G	4	4	8	0	0	8	0	0
1	51038546	.	T	G	5	3	8	0	1	9	0	0
1	51038570	.	A	G	6	4	10	0	1	11	0	0
1	51038819	.	A	G	7	4	11	0	0	11	0	0
1	51041255	.	T	G	17	1	18	0	17	35	0	0
1	51041363	.	G	A	2	15	17	0	16	33	0	0
1	51042228	.	G	A	0	8	8	0	8	16	0	0
1	51052276	.	C	T	11	5	16	0	1	17	0	0
1	51052279	.	T	C	11	6	17	0	1	18	0	0
1	51053333	.	G	C	10	4	14	0	0	14	0	0
1	51055896	.	G	C	7	5	12	0	0	12	0	0
1	51056766	.	C	A	1	5	6	0	9	15	0	0
1	51058146	.	A	C	10	0	10	0	6	16	0	0
1	51073118	.	T	C	1	2	3	0	0	3	0	0
1	51230198	.	T	C	9	4	13	0	1	14	0	0
1	51362693	.	C	T	7	4	11	0	0	11	0	0
1	51368758	.	T	G	6	3	9	0	1	10	0	0
1	51371165	.	T	C	5	7	12	0	0	12	0	0
1	51371166	.	A	C	5	7	12	0	0	12	0	0
1	51372625	.	C	T	6	6	12	0	1	13	0	0
1	51372688	.	C	T	6	5	11	0	0	11	0	0
1	51372742	.	C	T	6	2	8	0	0	8	0	0
1	51372951	.	C	T	4	5	9	0	0	9	0	0
1	51373730	.	A	C	10	8	18	0	0	18	0	0
1	51373808	.	C	T	8	9	17	0	0	17	0	0
1	51373904	.	A	G	11	6	17	0	0	17	0	0
1	51373952	.	A	C	11	9	20	0	0	20	0	0
1	51374009	.	T	C	4	3	7	0	0	7	0	0
1	51375006	.	C	G	12	7	19	0	0	19	0	0
1	51375301	.	A	G	5	6	11	0	2	13	0	0
1	51377708	.	C	A	13	9	22	0	1	23	0	0
1	51377757	.	C	T	9	6	15	0	1	16	0	0
1	51377781	.	A	C	5	7	12	0	2	14	0	0
1	51377798	.	G	A	2	3	5	0	5	10	0	0
1	51386764	.	C	G	11	6	17	0	0	17	0	0
1	51395384	.	A	G	13	4	17	0	1	18	0	0
1	51397646	.	C	T	5	8	13	0	0	13	0	0
1	51397677	.	G	A	6	10	16	0	0	16	0	0
1	51397713	.	C	A	6	8	14	0	0	14	0	0
1	51397730	.	T	C	8	11	19	0	0	19	0	0
1	51398373	.	T	C	6	13	19	0	1	20	0	0
1	51400205	.	T	C	4	11	15	0	0	15	0	0
1	51403088	.	C	T	7	7	14	0	2	16	0	0
1	51403599	.	T	A	17	6	23	0	0	23	0	0
1	51403756	.	T	A	9	3	12	0	3	15	0	0
1	51403785	.	C	T	7	6	13	0	0	13	0	0
1	51404230	.	A	G	6	2	8	0	0	8	0	0
1	51404733	.	A	G	1	3	4	0	0	4	0	0
1	51405087	.	C	T	8	5	13	0	0	13	0	0
1	51405119	.	C	A	8	4	12	0	0	12	0	0
1	51405323	.	C	A	2	4	6	0	1	7	0	0
1	51405498	.	A	G	3	0	3	0	2	5	0	0
1	51405499	.	G	A	3	2	5	0	0	5	0	0
1	51405986	.	G	T	7	5	12	0	0	12	0	0
1	51406191	.	G	A	0	5	5	0	4	9	0	0
1	51406341	.	T	A	10	6	16	0	0	16	0	0
1	51406346	.	G	A	9	5	14	0	0	14	0	0
1	51406425	.	A	C	3	2	5	0	0	5	0	0
1	51413315	.	T	C	18	22	40	1	0	41	0	0
1	51417125	.	C	G	9	1	10	0	15	25	0	0
1	51425221	.	G	T	3	7	10	0	12	22	0	0
1	51425476	.	T	A	5	2	7	0	0	7	0	0
1	51427779	.	T	C	10	15	25	0	0	25	0	0
1	51427837	.	A	C	10	17	27	0	1	28	0	0
1	51444718	.	G	A	10	5	15	0	0	15	0	0
1	51445120	.	A	T	9	14	23	0	1	24	0	0
1	51445140	.	T	G	7	12	19	0	0	19	0	0
1	51445217	.	A	T	8	3	11	0	0	11	0	0
1	51445325	.	T	C	7	6	13	0	1	14	0	0
1	51445513	.	T	C	12	0	12	0	7	19	0	0
1	51445673	.	T	G	10	11	21	0	0	21	0	0
1	51445697	.	T	C	14	0	14	0	13	27	0	0
1	51445732	.	A	G	18	10	28	0	1	29	0	0
1	51445777	.	T	A	14	13	27	0	0	27	0	0
1	51446004	.	G	A	8	5	13	0	0	13	0	0
1	51446195	.	T	C	5	0	5	0	5	10	0	0
1	51446287	.	C	T	4	4	8	0	0	8	0	0
1	51446366	.	T	C	5	3	8	0	1	9	0	0
1	51446462	.	C	T	5	2	7	0	0	7	0	0
1	51446511	.	G	A	6	4	10	0	0	10	0	0
1	51446597	.	A	T	6	6	12	0	0	12	0	0
1	51447506	.	T	C	5	3	8	0	1	9	0	0
1	51447543	.	T	G	5	6	11	0	0	11	0	0
1	51447573	.	C	T	6	6	12	0	0	12	0	0
1	51447680	.	T	A	5	3	8	0	0	8	0	0
1	51447728	.	C	T	3	2	5	0	0	5	0	0
1	51447807	.	A	G	3	2	5	0	0	5	0	0
1	51447914	.	G	T	5	2	7	0	0	7	0	0
1	51447919	.	T	C	5	0	5	0	2	7	0	0
1	51448105	.	A	G	1	3	4	0	0	4	0	0
1	51448249	.	C	A	7	9	16	0	0	16	0	0
1	51448367	.	A	G	5	4	9	0	0	9	0	0
1	51448517	.	C	T	12	7	19	0	0	19	0	0
1	51448696	.	C	A	4	3	7	0	0	7	0	0
1	51448781	.	A	G	4	6	10	0	0	10	0	0
1	51448807	.	C	T	1	4	5	0	0	5	0	0
1	51448829	.	T	G	2	3	5	0	0	5	0	0
1	51449298	.	T	C	7	5	12	0	1	13	0	0
1	51449639	.	G	A	4	2	6	0	3	9	0	0
1	51449673	.	G	C	5	7	12	0	0	12	0	0
1	51449895	.	T	C	6	7	13	0	1	14	0	0
1	51450752	.	G	A	8	5	13	0	1	14	0	0
1	51557903	.	C	T	0	21	21	0	16	37	0	0
1	51558008	.	T	C	18	17	35	0	2	37	0	0
1	51558036	.	G	A	18	15	33	0	1	34	0	0
1	51558133	.	G	T	19	10	29	0	1	30	0	0
1	51558150	.	A	T	17	9	26	0	0	26	0	0
1	51558604	.	C	T	19	25	44	0	1	45	0	0
1	51558897	.	T	A	22	26	48	0	0	49	1	0
1	51559060	.	C	G	30	18	48	0	4	52	0	0
1	51559269	.	G	C	25	18	43	0	1	44	0	0
1	51559815	.	C	T	30	19	49	0	0	49	0	0
1	51562800	.	A	G	22	28	50	1	1	52	0	0
1	51562803	.	T	C	24	26	50	1	1	52	0	0
1	51567367	.	A	G	23	26	49	0	1	50	0	0
1	51591352	.	A	G	28	23	51	0	4	55	0	0
1	51591427	.	G	A	6	3	9	0	0	9	0	0
1	51594058	.	A	T	14	8	22	0	1	23	0	0
1	51594447	.	A	G	12	24	36	0	4	40	0	0
1	51594485	.	A	C	14	17	31	0	3	34	0	0
1	51594690	.	C	G	2	17	19	0	21	40	0	0
1	51594701	.	C	T	6	20	26	0	20	46	0	0
1	51606302	.	C	G	26	20	46	0	3	50	1	0
1	51608856	.	C	A	8	4	12	1	0	13	0	0
1	51608887	.	T	C	6	0	6	1	7	14	0	0
1	51609002	.	A	T	21	16	37	0	1	38	0	0
1	51615436	.	G	T	3	4	7	0	0	7	0	0
1	51673110	.	C	A	0	3	3	0	1	4	0	0
1	51673121	.	T	C	1	2	3	0	1	4	0	0
1	51673162	.	G	T	1	3	4	0	0	4	0	0
1	51673721	.	A	G	2	2	4	0	0	4	0	0
1	51673895	.	C	T	2	3	5	0	0	5	0	0
1	51673913	.	T	C	3	0	3	0	2	5	0	0
1	51702374	.	C	T	0	3	3	0	3	6	0	0
1	51703863	.	T	C	9	0	9	0	8	17	0	0
1	51709481	.	G	A	7	9	16	0	0	16	0	0
1	51710007	.	C	T	8	9	17	0	1	18	0	0
1	51719037	.	A	C	10	0	10	0	6	16	0	0
1	51723440	.	T	C	22	21	43	0	1	44	0	0
1	51723461	.	A	T	21	24	45	0	1	46	0	0
1	51729506	.	C	T	25	19	44	0	0	44	0	0
1	51729572	.	A	G	20	1	21	0	18	39	0	0
1	51729645	.	A	C	18	10	28	0	1	29	0	0
1	51729687	.	C	T	25	8	33	0	3	36	0	0
1	51729697	.	C	A	26	11	37	0	2	39	0	0
1	51729735	.	C	A	20	10	30	0	2	32	0	0
1	51729750	.	C	A	17	11	28	0	2	30	0	0
1	51729798	.	A	C	7	11	18	0	0	18	0	0
1	51734087	.	T	C	17	16	33	0	4	37	0	0
1	51734449	.	C	T	0	20	20	0	20	40	0	0
1	51876733	.	G	T	3	2	5	0	0	5	0	0
1	51960615	.	T	C	6	4	10	0	0	10	0	0
1	51961020	.	T	C	8	7	15	0	1	16	0	0
1	52054116	.	A	G	5	6	11	0	0	11	0	0
1	52073807	.	C	G	20	16	36	0	1	37	0	0
1	52111494	.	C	T	16	13	29	0	6	35	0	0
1	52113251	.	G	A	9	9	18	0	2	20	0	0
1	52115814	.	G	A	14	14	28	0	1	29	0	0
1	52115862	.	C	T	0	11	11	0	10	21	0	0
1	52117112	.	C	G	9	11	20	0	1	21	0	0
1	52121404	.	C	T	24	11	35	0	1	36	0	0
1	52121405	.	T	G	23	11	34	0	2	36	0	0
1	52121450	.	C	T	2	20	22	0	14	36	0	0
1	52124240	.	C	T	3	9	12	0	12	24	0	0
1	52128305	.	T	G	8	11	19	1	0	20	0	0
1	52130225	.	A	T	14	19	33	0	0	33	0	0
1	52130431	.	G	A	14	18	32	0	3	35	0	0
1	52135185	.	T	C	21	13	34	0	0	34	0	0
1	52135384	.	T	C	12	3	15	0	0	15	0	0
1	52135513	.	G	A	4	13	17	1	1	19	0	0
1	52135840	.	C	A	14	8	22	0	0	22	0	0
1	52135862	.	A	G	5	16	21	0	0	21	0	0
1	52135928	.	G	C	8	13	21	0	1	22	0	0
1	52136027	.	T	C	13	12	25	0	1	26	0	0
1	52136117	.	A	C	15	14	29	0	0	29	0	0
1	52136190	.	G	A	13	8	21	0	0	21	0	0
1	52136294	.	T	C	4	5	9	0	0	9	0	0
1	52136323	.	G	A	10	8	18	0	0	18	0	0
1	52136379	.	T	A	11	12	23	0	1	24	0	0
1	52136641	.	A	G	8	10	18	0	4	22	0	0
1	52136759	.	A	T	16	19	35	0	0	35	0	0
1	52136868	.	A	G	4	18	22	0	0	22	0	0
1	52136894	.	T	C	6	18	24	0	0	24	0	0
1	52136974	.	T	A	6	12	18	0	0	18	0	0
1	52139909	.	T	A	22	15	37	0	0	37	0	0
1	52149554	.	A	T	28	20	48	0	1	49	0	0
1	52149619	.	A	C	26	15	41	0	1	42	0	0
1	52149794	.	A	G	16	20	36	0	1	37	0	0
1	52149977	.	T	A	12	14	26	0	1	27	0	0
1	52150152	.	G	A	18	17	35	0	0	35	0	0
1	52150182	.	G	T	1	19	20	0	23	43	0	0
1	52150231	.	C	T	20	19	39	0	2	41	0	0
1	52150400	.	A	G	12	5	17	0	2	19	0	0
1	52150900	.	G	T	12	4	16	0	0	16	0	0
1	52150974	.	A	G	10	5	15	0	0	15	0	0
1	52151170	.	A	G	11	4	15	0	0	15	0	0
1	52151387	.	A	G	1	2	3	0	0	3	0	0
1	52152300	.	A	T	13	12	25	0	1	26	0	0
1	52152488	.	A	G	13	15	28	0	1	29	0	0
1	52152617	.	C	T	22	22	44	0	2	46	0	0
1	52178926	.	G	A	8	6	14	0	2	16	0	0
1	52179039	.	G	T	12	9	21	0	1	22	0	0
1	52179066	.	C	T	0	9	9	0	7	16	0	0
1	52198224	.	T	C	3	5	8	0	1	9	0	0
1	52198239	.	G	A	7	3	10	0	1	11	0	0
1	52201186	.	T	C	2	3	5	0	1	6	0	0
1	52201193	.	T	A	3	3	6	0	1	7	0	0
1	52452116	.	C	G	0	2	2	0	1	3	0	0
1	52452197	.	G	A	7	6	13	0	0	13	0	0
1	52452275	.	G	T	8	4	12	0	1	13	0	0
1	52455885	.	C	G	9	12	21	0	0	21	0	0
1	52455908	.	G	A	12	10	22	0	0	22	0	0
1	52455960	.	C	T	10	10	20	0	2	22	0	0
1	52456002	.	G	A	9	16	25	0	1	26	0	0
1	52460737	.	C	T	8	11	19	0	0	19	0	0
1	52460739	.	T	C	6	11	17	0	0	17	0	0
1	52460906	.	T	C	6	6	12	1	1	14	0	0
1	52460944	.	G	T	6	7	13	1	0	14	0	0
1	52461114	.	A	G	5	5	10	0	0	10	0	0
1	52461183	.	C	T	4	6	10	0	0	10	0	0
1	52461195	.	G	A	11	3	14	0	0	14	0	0
1	52462147	.	A	G	3	4	7	0	1	8	0	0
1	52462154	.	G	T	3	4	7	0	1	8	0	0
1	52475840	.	A	G	3	0	3	0	7	10	0	0
1	52475955	.	C	T	3	6	9	0	0	9	0	0
1	52478381	.	C	T	5	2	7	0	1	8	0	0
1	52478413	.	G	A	0	3	3	0	1	4	0	0
1	52478513	.	C	T	4	2	6	0	0	6	0	0
1	52478538	.	G	A	2	3	5	0	3	8	0	0
1	52482650	.	T	C	4	6	10	0	1	11	0	0
1	52486008	.	G	A	0	5	5	0	2	7	0	0
1	52489974	.	G	A	1	6	7	0	7	14	0	0
1	52495004	.	T	A	4	2	6	1	0	7	0	0
1	52495045	.	C	T	0	3	3	0	4	7	0	0
1	52495082	.	C	G	2	2	4	0	1	6	1	0
1	52499807	.	A	G	3	4	7	0	1	8	0	0
1	52505134	.	T	C	5	3	8	0	0	8	0	0
1	52505216	.	G	A	3	2	5	0	1	6	0	0
1	52560612	.	G	A	2	7	9	0	1	10	0	0
1	52574874	.	T	C	10	8	18	0	0	18	0	0
1	52574973	.	G	A	7	2	9	0	1	10	0	0
1	52577657	.	G	A	0	5	5	0	4	9	0	0
1	52577703	.	C	A	4	5	9	0	1	10	0	0
1	52592126	.	A	G	5	7	12	0	0	12	0	0
1	52592129	.	C	T	6	7	13	0	0	13	0	0
1	52595043	.	C	A	4	10	14	0	0	14	0	0
1	52599102	.	A	G	5	0	5	0	7	12	0	0
1	52599557	.	C	T	6	6	12	0	1	13	0	0
1	52606865	.	C	T	10	10	20	0	0	20	0	0
1	52607826	.	T	C	9	7	16	0	1	17	0	0
1	52609347	.	C	T	10	6	16	0	0	16	0	0
1	52609392	.	C	T	9	4	13	0	0	13	0	0
1	52609654	.	T	G	4	1	5	0	5	10	0	0
1	52610788	.	G	A	9	11	20	0	2	22	0	0
1	52611963	.	A	G	7	11	18	0	2	20	0	0
1	52612987	.	T	C	11	8	19	0	1	20	0	0
1	52613051	.	T	A	12	9	21	0	2	23	0	0
1	52613216	.	G	T	9	8	17	0	0	17	0	0
1	52614377	.	C	T	9	14	23	0	1	24	0	0
1	52614926	.	T	A	10	8	18	0	0	18	0	0
1	52615824	.	C	T	13	11	24	0	0	24	0	0
1	52616711	.	A	G	13	8	21	0	2	23	0	0
1	52618405	.	C	T	12	14	26	0	1	27	0	0
1	52625747	.	C	G	12	2	14	0	12	26	0	0
1	52626360	.	T	A	14	10	24	0	0	24	0	0
1	52626826	.	T	A	10	6	16	0	0	16	0	0
1	52627572	.	G	A	1	16	17	0	24	41	0	0
1	52627609	.	A	T	23	22	45	0	0	45	0	0
1	52627678	.	A	T	21	18	39	0	1	40	0	0
1	52627679	.	C	T	20	18	38	0	1	39	0	0
1	52628253	.	G	T	8	10	18	0	1	19	0	0
1	52628305	.	T	C	3	7	10	0	0	10	0	0
1	52652155	.	C	A	4	3	7	0	0	7	0	0
1	52653703	.	C	T	0	2	2	0	1	3	0	0
1	52656201	.	C	A	0	4	4	0	2	6	0	0
1	52656219	.	T	C	2	3	5	0	0	5	0	0
1	52657799	.	T	G	3	5	8	0	1	9	0	0
1	52659459	.	T	C	2	2	4	0	0	4	0	0
1	52663429	.	C	T	4	4	8	0	0	8	0	0
1	52676495	.	G	A	8	5	13	0	1	14	0	0
1	52679345	.	A	G	6	5	11	0	0	11	0	0
1	52681185	.	G	A	3	8	11	0	0	11	0	0
1	52681296	.	C	A	6	4	10	0	0	10	0	0
1	52682847	.	C	T	10	8	18	0	0	18	0	0
1	52682850	.	T	C	9	9	18	0	1	19	0	0
1	52682910	.	C	T	11	9	20	0	1	21	0	0
1	52685099	.	G	A	1	5	6	0	11	17	0	0
1	52688151	.	C	T	15	5	20	0	2	22	0	0
1	52698944	.	G	T	12	16	28	0	0	28	0	0
1	52698955	.	C	T	13	13	26	0	2	28	0	0
1	52764914	.	C	T	15	7	22	0	0	22	0	0
1	52773239	.	G	A	17	8	25	0	0	25	0	0
1	52773311	.	A	G	10	10	20	0	1	21	0	0
1	52775619	.	A	C	15	11	26	0	1	27	0	0
1	52779785	.	G	A	11	18	29	0	2	31	0	0
1	52782161	.	G	A	19	17	36	0	0	36	0	0
1	52782220	.	G	T	16	16	32	0	0	32	0	0
1	52784549	.	A	T	10	8	18	0	0	18	0	0
1	52784624	.	T	A	10	6	16	0	1	17	0	0
1	52792476	.	C	A	13	9	22	0	0	22	0	0
1	53865870	.	C	A	3	2	5	0	0	5	0	0
1	53865898	.	A	T	3	2	5	0	0	5	0	0
1	53866041	.	T	C	2	3	5	0	0	5	0	0
1	53866075	.	C	T	3	8	11	0	0	11	0	0
1	53866120	.	A	T	9	10	19	0	0	19	0	0
1	53866128	.	T	C	10	8	18	0	0	18	0	0
1	53866319	.	C	T	1	10	11	0	5	16	0	0
1	53868941	.	A	G	6	8	14	0	2	16	0	0
1	53871326	.	T	A	7	5	12	0	1	13	0	0
1	53871416	.	C	A	6	5	11	0	2	13	0	0
1	53872031	.	C	A	8	10	18	0	2	20	0	0
1	53872061	.	C	T	5	6	11	0	0	11	0	0
1	53872067	.	T	C	6	0	6	0	6	12	0	0
1	53873112	.	T	C	8	0	8	0	4	12	0	0
1	53873173	.	C	T	1	6	7	0	7	14	0	0
1	53873177	.	T	C	8	0	8	0	6	14	0	0
1	53879314	.	T	A	5	3	8	0	1	9	0	0
1	53879353	.	C	T	0	6	6	0	5	11	0	0
1	53879397	.	C	T	5	7	12	0	0	12	0	0
1	53879731	.	T	C	2	1	3	1	5	9	0	0
1	53879767	.	G	A	2	5	7	1	1	9	0	0
1	53880610	.	T	C	3	2	5	0	0	5	0	0
1	53911983	.	G	A	1	2	3	0	0	3	0	0
1	53912019	.	G	A	1	3	4	0	0	4	0	0
1	53912148	.	A	G	2	5	7	0	0	7	0	0
1	53912607	.	T	C	4	0	4	0	6	10	0	0
1	53912670	.	A	G	4	9	13	0	2	15	0	0
1	53912691	.	A	G	4	7	11	0	0	11	0	0
1	53916931	.	T	A	5	6	11	0	0	11	0	0
1	53919219	.	C	G	6	4	10	0	0	10	0	0
1	53919228	.	G	T	6	5	11	0	0	11	0	0
1	53919345	.	T	C	1	2	3	0	0	3	0	0
1	53921783	.	T	C	2	2	4	0	1	5	0	0
1	53923793	.	A	G	5	0	5	0	4	9	0	0
1	53926940	.	G	T	7	2	9	0	0	9	0	0
1	53930468	.	T	C	6	7	13	0	0	13	0	0
1	53932271	.	A	G	11	4	15	0	0	15	0	0
1	53934495	.	C	A	4	6	10	0	1	11	0	0
1	53935236	.	G	A	6	5	11	0	0	11	0	0
1	53935248	.	G	T	0	6	6	0	6	12	0	0
1	53935287	.	A	G	11	0	11	0	7	18	0	0
1	53935314	.	T	C	10	8	18	0	1	19	0	0
1	53935335	.	C	T	6	9	15	0	1	16	0	0
1	53937423	.	C	T	9	6	15	0	1	16	0	0
1	53939430	.	A	G	4	5	9	0	0	9	0	0
1	53939604	.	C	T	9	5	14	0	0	14	0	0
1	53953276	.	G	T	1	2	3	0	0	3	0	0
1	53954314	.	G	A	1	6	7	0	15	22	0	0
1	53954361	.	C	A	22	14	36	0	1	37	0	0
1	53954385	.	A	C	19	15	34	0	1	35	0	0
1	53955055	.	G	A	11	8	19	0	5	24	0	0
1	53958136	.	G	A	1	8	9	0	22	31	0	0
1	53958263	.	C	T	16	10	26	0	1	27	0	0
1	53962227	.	A	T	12	16	28	0	1	29	0	0
1	53962264	.	T	C	13	18	31	0	0	31	0	0
1	53962490	.	T	G	15	7	22	0	0	22	0	0
1	53962606	.	T	A	4	4	8	0	0	8	0	0
1	53962860	.	G	A	1	5	6	1	11	18	0	0
1	53962863	.	C	T	13	5	18	1	0	19	0	0
1	53962900	.	T	A	13	5	18	1	1	20	0	0
1	53963108	.	C	A	14	8	22	0	0	23	1	0
1	53963159	.	C	T	15	9	24	0	0	24	0	0
1	53963782	.	A	G	5	7	12	0	1	13	0	0
1	53980283	.	A	G	1	2	3	0	0	3	0	0
1	53980293	.	A	G	1	1	2	0	1	3	0	0
1	53983108	.	T	C	1	2	3	0	0	3	0	0
1	53987578	.	T	G	1	3	4	0	0	4	0	0
1	53987605	.	G	A	1	3	4	0	0	4	0	0
1	54025576	.	A	G	2	1	3	0	5	8	0	0
1	54048786	.	G	A	2	6	8	0	0	8	0	0
1	54062754	.	G	A	19	13	32	1	2	35	0	0
1	54062858	.	A	G	20	7	27	0	3	30	0	0
1	54069513	.	G	T	7	4	11	0	0	11	0	0
1	54069515	.	C	A	7	4	11	0	0	11	0	0
1	54075326	.	A	G	6	3	9	0	0	9	0	0
1	54080067	.	A	T	7	4	11	0	0	11	0	0
1	54080098	.	T	C	4	6	10	0	0	10	0	0
1	54080189	.	T	G	3	0	3	0	5	8	0	0
1	54080253	.	G	C	3	4	7	0	2	9	0	0
1	54080261	.	C	T	4	5	9	0	0	9	0	0
1	54088976	.	A	G	1	2	3	0	1	4	0	0
1	54089032	.	C	T	2	5	7	0	0	7	0	0
1	54095147	.	G	A	1	2	3	0	0	3	0	0
1	54107246	.	C	A	3	4	7	0	0	7	0	0
1	54137238	.	A	G	8	8	16	0	1	17	0	0
1	54140472	.	A	T	6	9	15	0	0	15	0	0
1	54142097	.	T	C	10	9	19	0	0	19	0	0
1	54142130	.	G	T	0	13	13	0	6	19	0	0
1	54144024	.	T	G	8	11	19	0	0	19	0	0
1	54146383	.	C	T	9	9	18	0	1	19	0	0
1	54146416	.	T	C	14	11	25	0	1	26	0	0
1	54154371	.	T	C	4	0	4	0	5	9	0	0
1	54154383	.	T	G	6	5	11	0	0	11	0	0
1	54158479	.	A	G	5	5	10	0	1	11	0	0
1	54167162	.	G	A	3	5	8	0	0	8	0	0
1	54167196	.	G	A	1	4	5	0	0	5	0	0
1	54167496	.	A	C	4	2	6	0	0	6	0	0
1	54167551	.	T	C	2	0	2	0	5	7	0	0
1	54167596	.	G	T	4	5	9	0	0	9	0	0
1	54178755	.	G	C	5	9	14	0	0	14	0	0
1	54182416	.	T	A	2	4	6	0	1	7	0	0
1	54182419	.	A	G	2	4	6	0	0	6	0	0
1	54184468	.	C	T	3	7	10	0	0	10	0	0
1	54190522	.	C	A	2	1	3	0	3	6	0	0
1	54190585	.	T	A	3	3	6	0	0	6	0	0
1	54190661	.	A	G	1	4	5	0	0	5	0	0
1	54190672	.	T	G	3	4	7	0	0	7	0	0
1	54191511	.	T	G	5	6	11	0	0	11	0	0
1	54194875	.	G	A	0	4	4	0	5	9	0	0
1	54194890	.	T	A	6	4	10	0	0	10	0	0
1	54195029	.	T	C	9	6	15	0	0	15	0	0
1	54197431	.	G	A	1	3	4	0	0	4	0	0
1	54197443	.	G	A	2	1	3	0	2	5	0	0
1	54199009	.	G	A	6	8	14	0	0	14	0	0
1	54202319	.	A	G	3	6	9	0	0	9	0	0
1	54202331	.	C	T	5	6	11	0	0	11	0	0
1	54206955	.	T	C	4	7	11	0	0	11	0	0
1	54209203	.	T	C	4	3	7	0	1	8	0	0
1	54210220	.	A	G	6	3	9	0	1	10	0	0
1	54219462	.	A	G	4	0	4	0	4	8	0	0
1	54221930	.	T	C	2	5	7	5	0	12	0	0
1	54221936	.	T	C	3	4	7	5	0	12	0	0
1	54244041	.	T	C	3	5	8	0	1	9	0	0
1	54244432	.	T	C	5	9	14	0	0	14	0	0
1	54245914	.	G	A	4	7	11	0	0	11	0	0
1	54248366	.	A	C	9	13	22	0	2	24	0	0
1	54253768	.	G	A	1	13	14	0	14	28	0	0
1	54255651	.	C	T	9	10	19	0	0	19	0	0
1	54262843	.	G	A	7	9	16	0	1	17	0	0
1	54674027	.	A	T	3	2	5	0	0	5	0	0
1	54674388	.	A	G	13	10	23	0	0	23	0	0
1	54674430	.	A	G	15	0	15	0	14	29	0	0
1	54677238	.	A	G	5	0	5	0	8	13	0	0
1	54683743	.	C	T	10	10	20	0	0	20	0	0
1	54685529	.	G	A	10	5	15	0	0	15	0	0
1	54685559	.	C	G	11	5	16	0	0	16	0	0
1	54685590	.	A	G	9	3	12	0	1	13	0	0
1	54685610	.	T	C	7	4	11	0	0	11	0	0
1	54687580	.	C	T	4	7	11	0	0	11	0	0
1	54687649	.	G	T	2	9	11	0	0	11	0	0
1	54687715	.	C	A	5	7	12	0	0	12	0	0
1	54687756	.	A	C	3	8	11	0	0	11	0	0
1	54687766	.	A	C	3	10	13	0	0	13	0	0
1	54687798	.	A	C	5	7	12	0	1	13	0	0
1	54687928	.	G	T	7	2	9	0	0	9	0	0
1	54687981	.	A	G	2	6	8	1	0	9	0	0
1	54689329	.	T	C	5	6	11	0	1	12	0	0
1	54693953	.	C	A	2	6	8	0	0	8	0	0
1	54701201	.	C	G	1	7	8	0	12	20	0	0
1	54701231	.	G	A	10	7	17	0	3	20	0	0
1	54703469	.	C	T	2	9	11	0	15	26	0	0
1	54707977	.	G	A	36	29	65	0	1	66	0	0
1	54708098	.	G	T	34	29	63	0	3	66	0	0
1	54708191	.	C	A	28	31	59	0	2	61	0	0
1	54708253	.	G	A	26	33	59	0	9	68	0	0
1	54708281	.	A	T	33	35	68	0	3	71	0	0
1	54708301	.	A	C	36	31	67	0	1	68	0	0
1	54708317	.	C	T	37	29	66	0	0	66	0	0
1	54708359	.	C	T	32	29	61	5	0	66	0	0
1	54708549	.	T	C	11	10	21	1	0	22	0	0
1	54708555	.	T	C	21	3	24	1	0	25	0	0
1	54709110	.	T	A	13	9	22	0	1	23	0	0
1	54709112	.	A	G	13	9	22	0	1	23	0	0
1	54709334	.	G	A	32	29	61	0	2	63	0	0
1	54726221	.	A	G	1	2	3	0	0	3	0	0
1	54728572	.	T	C	2	0	2	0	3	5	0	0
1	54731875	.	T	A	0	2	2	0	0	2	0	0
1	54731890	.	A	C	1	2	3	0	0	3	0	0
1	54737506	.	C	A	7	4	11	0	0	12	1	0
1	54747720	.	T	C	4	8	12	0	1	13	0	0
1	54747729	.	A	G	3	0	3	0	9	12	0	0
1	54747786	.	A	C	2	5	7	0	0	7	0	0
1	54747993	.	T	G	3	5	8	0	0	8	0	0
1	54748062	.	T	G	8	0	8	0	4	12	0	0
1	54750104	.	A	G	5	0	5	0	9	14	0	0
1	54750254	.	A	G	4	0	4	0	6	10	0	0
1	54750500	.	G	A	2	6	8	0	4	12	0	0
1	54753095	.	T	G	9	0	9	0	5	14	0	0
1	54753101	.	T	C	9	4	13	0	1	14	0	0
1	54753167	.	A	G	12	6	18	0	1	19	0	0
1	54753173	.	G	C	0	7	7	0	12	19	0	0
1	54754356	.	C	T	8	5	13	0	0	13	0	0
1	54754482	.	T	G	12	7	19	0	0	19	0	0
1	54754503	.	G	A	7	6	13	0	0	13	0	0
1	54754550	.	C	A	8	5	13	0	0	13	0	0
1	54754565	.	C	T	7	5	12	0	0	12	0	0
1	54754623	.	A	T	5	8	13	0	0	13	0	0
1	54754626	.	T	A	7	6	13	0	1	14	0	0
1	54754744	.	C	T	7	7	14	0	1	15	0	0
1	54754754	.	T	C	9	8	17	0	0	17	0	0
1	54758624	.	A	T	2	12	14	0	1	15	0	0
1	54758725	.	C	T	2	17	19	0	17	36	0	0
1	54758810	.	C	T	17	11	28	0	1	29	0	0
1	54758975	.	T	C	19	15	34	0	2	36	0	0
1	54759065	.	G	A	23	18	41	2	0	43	0	0
1	54762947	.	G	A	21	20	41	0	1	42	0	0
1	54762997	.	G	T	16	15	31	0	3	34	0	0
1	54763022	.	G	C	13	21	34	0	0	34	0	0
1	54763070	.	C	G	1	18	19	0	6	25	0	0
1	54763106	.	A	G	6	6	12	0	0	12	0	0
1	54763133	.	T	C	5	6	11	0	2	13	0	0
1	54763182	.	A	G	16	12	28	0	0	28	0	0
1	54763187	.	G	A	16	14	30	0	0	30	0	0
1	54763298	.	G	A	17	18	35	0	2	37	0	0
1	54765216	.	A	C	18	1	19	0	21	40	0	0
1	54765218	.	C	T	1	19	20	0	20	40	0	0
1	54774007	.	A	G	1	4	5	1	0	6	0	0
1	54777359	.	C	A	4	3	7	3	1	11	0	0
1	54893126	.	C	G	10	5	15	0	0	15	0	0
1	54893140	.	G	A	2	3	5	0	10	15	0	0
1	54893265	.	G	C	10	3	13	0	0	13	0	0
1	54895011	.	G	A	0	3	3	0	3	6	0	0
1	54897256	.	C	A	6	1	7	0	1	9	1	0
1	54897288	.	C	T	8	5	13	0	0	13	0	0
1	54898178	.	G	A	1	8	9	0	8	17	0	0
1	54898489	.	A	T	6	4	10	0	0	10	0	0
1	54906069	.	T	C	8	8	16	0	1	17	0	0
1	54906162	.	G	A	2	7	9	0	10	19	0	0
1	54906192	.	T	C	9	8	17	0	0	17	0	0
1	54906476	.	G	C	0	8	8	0	5	13	0	0
1	54906619	.	T	A	10	8	18	0	0	18	0	0
1	54907021	.	G	A	8	5	13	0	0	13	0	0
1	54907502	.	A	G	5	5	10	0	0	10	0	0
1	54907549	.	T	C	9	10	19	0	0	19	0	0
1	54907585	.	G	C	16	9	25	0	2	27	0	0
1	54907600	.	A	T	14	11	25	0	0	25	0	0
1	54907622	.	T	C	12	9	21	0	2	23	0	0
1	54909104	.	C	G	1	0	1	0	4	5	0	0
1	54927198	.	T	C	16	17	33	0	2	35	0	0
1	54929168	.	G	A	14	17	31	1	2	35	1	0
1	54929256	.	T	C	10	7	17	0	1	18	0	0
1	54929281	.	G	A	1	12	13	0	13	26	0	0
1	54929293	.	C	T	13	14	27	0	0	27	0	0
1	54929373	.	C	G	7	6	13	0	0	13	0	0
1	54929994	.	T	C	10	8	18	0	0	18	0	0
1	54930316	.	G	A	2	2	4	0	0	4	0	0
1	54930428	.	T	A	5	7	12	0	1	13	0	0
1	54930486	.	G	A	7	8	15	1	0	16	0	0
1	54930598	.	A	G	14	9	23	0	2	25	0	0
1	54930626	.	A	C	14	9	23	0	1	24	0	0
1	54930693	.	T	C	7	7	14	0	0	14	0	0
1	54930711	.	G	A	5	7	12	0	1	13	0	0
1	54930776	.	A	G	12	6	18	0	0	18	0	0
1	54930868	.	C	A	11	3	14	0	0	14	0	0
1	54931111	.	T	C	4	8	12	0	1	13	0	0
1	54931122	.	G	A	0	9	9	0	4	13	0	0
1	54931211	.	A	T	7	13	20	0	2	22	0	0
1	54931230	.	T	A	10	11	21	0	1	22	0	0
1	54931791	.	G	C	0	13	13	0	9	22	0	0
1	54936235	.	G	T	12	15	27	0	1	28	0	0
1	54936471	.	T	C	11	0	11	0	17	28	0	0
1	54938274	.	T	C	10	12	22	1	0	23	0	0
1	54939536	.	A	T	6	15	21	0	0	21	0	0
1	54941036	.	G	A	5	16	21	0	1	22	0	0
1	54943139	.	G	A	7	8	15	0	0	15	0	0
1	54943160	.	A	G	6	8	14	0	0	14	0	0
1	54943178	.	G	A	4	8	12	0	0	12	0	0
1	54945039	.	A	G	3	5	8	0	0	8	0	0
1	54945108	.	T	C	3	0	3	0	5	8	0	0
1	54945175	.	T	G	3	7	10	0	0	10	0	0
1	54945195	.	A	C	3	7	10	0	0	10	0	0
1	54946977	.	A	C	4	0	4	0	5	9	0	0
1	54950534	.	T	C	19	7	26	0	0	26	0	0
1	54950572	.	G	A	16	7	23	0	0	23	0	0
1	54950661	.	G	A	12	14	26	0	0	26	0	0
1	54950745	.	G	T	8	12	20	0	1	21	0	0
1	54950801	.	A	G	12	7	19	0	0	19	0	0
1	54955207	.	G	A	14	7	21	0	0	21	0	0
1	54955234	.	A	G	19	11	30	0	1	31	0	0
1	54960328	.	A	G	4	8	12	0	0	12	0	0
1	54960368	.	T	G	10	12	22	0	0	22	0	0
1	54960416	.	A	C	17	12	29	0	3	32	0	0
1	54960563	.	T	A	17	21	38	1	2	41	0	0
1	54960620	.	G	C	7	5	12	0	0	12	0	0
1	54960639	.	C	T	0	7	7	0	7	14	0	0
1	54960881	.	A	G	18	14	32	0	5	37	0	0
1	54962466	.	A	G	21	22	43	0	1	44	0	0
1	54963314	.	A	G	19	19	38	0	0	38	0	0
1	54964724	.	A	G	21	16	37	0	1	38	0	0
1	54968253	.	A	T	7	7	14	0	0	14	0	0
1	54974437	.	C	A	6	10	16	0	0	16	0	0
1	54974438	.	A	G	6	10	16	0	0	16	0	0
1	54974477	.	G	A	11	3	14	0	0	14	0	0
1	54974500	.	T	A	10	6	16	0	0	17	1	0
1	54974538	.	A	G	5	9	14	0	1	15	0	0
1	54974660	.	T	C	9	6	15	0	0	15	0	0
1	54974774	.	G	A	5	8	13	0	0	13	0	0
1	54974810	.	G	T	6	8	14	1	0	15	0	0
1	54975136	.	A	T	7	7	14	1	0	15	0	0
1	54975431	.	C	T	14	4	18	0	0	18	0	0
1	54975519	.	C	T	16	6	22	0	0	22	0	0
1	54975636	.	C	T	6	7	13	0	0	13	0	0
1	54975658	.	A	G	5	6	11	0	0	11	0	0
1	54975762	.	A	T	8	3	11	0	1	12	0	0
1	54975884	.	A	G	7	13	20	0	1	21	0	0
1	54975911	.	G	A	7	10	17	0	0	17	0	0
1	54976026	.	T	A	8	10	18	0	1	19	0	0
1	54976035	.	T	A	9	12	21	0	0	21	0	0
1	54976104	.	G	A	4	4	8	0	0	8	0	0
1	54976178	.	T	C	6	0	6	0	9	15	0	0
1	54976185	.	T	C	11	4	15	0	0	15	0	0
1	54976249	.	T	A	10	9	19	0	0	19	0	0
1	54976256	.	C	T	11	10	21	0	1	22	0	0
1	54976497	.	T	C	11	6	17	0	0	17	0	0
1	54976731	.	C	T	4	4	8	0	0	8	0	0
1	54976732	.	A	G	4	4	8	0	0	8	0	0
1	54976798	.	C	A	1	3	4	0	0	4	0	0
1	54976827	.	T	C	4	2	6	0	0	6	0	0
1	54976835	.	C	T	5	2	7	0	0	7	0	0
1	54976980	.	C	G	5	3	8	0	0	8	0	0
1	54976988	.	A	C	6	2	8	0	0	8	0	0
1	54977572	.	G	A	4	9	13	0	0	13	0	0
1	54977618	.	G	A	11	7	18	0	0	18	0	0
1	54977697	.	G	A	10	3	13	0	0	13	0	0
1	54977719	.	T	A	11	4	15	0	0	15	0	0
1	54977767	.	A	T	5	5	10	0	0	10	0	0
1	54977781	.	A	G	4	5	9	0	0	9	0	0
1	54978022	.	T	G	11	8	19	0	0	19	0	0
1	54978023	.	C	T	1	8	9	0	10	19	0	0
1	54978478	.	T	C	4	5	9	0	0	9	0	0
1	54981628	.	G	A	3	7	10	0	0	10	0	0
1	54981706	.	C	T	9	8	17	0	0	17	0	0
1	54984172	.	A	G	13	7	20	0	1	21	0	0
1	54984206	.	T	C	9	0	9	0	6	15	0	0
1	54984587	.	C	T	11	12	23	0	1	24	0	0
1	54985320	.	C	T	10	12	22	0	1	23	0	0
1	54986910	.	T	C	15	1	16	0	7	23	0	0
1	54987539	.	A	G	9	10	19	0	0	19	0	0
1	54988190	.	T	G	5	8	13	0	0	13	0	0
1	54988259	.	G	A	7	11	18	0	1	19	0	0
1	54997275	.	T	C	12	0	12	0	10	22	0	0
1	54997327	.	T	C	9	5	14	0	0	14	0	0
1	55008322	.	A	G	15	8	23	0	1	24	0	0
1	55008382	.	C	T	16	9	25	0	2	27	0	0
1	55008405	.	G	A	15	10	25	0	1	26	0	0
1	55008594	.	A	T	9	7	16	0	2	18	0	0
1	55008772	.	T	C	13	15	28	0	2	30	0	0
1	55009513	.	C	A	2	5	7	0	0	7	0	0
1	55009618	.	A	G	5	3	8	0	1	9	0	0
1	55011101	.	T	A	2	2	4	0	0	4	0	0
1	55011117	.	T	C	2	2	4	0	0	4	0	0
1	55011353	.	G	C	1	5	6	0	0	6	0	0
1	55011514	.	C	T	8	4	12	0	0	12	0	0
1	55011539	.	A	T	8	3	11	0	0	11	0	0
1	55011550	.	G	A	9	5	14	0	2	16	0	0
1	55011692	.	C	T	1	6	7	0	7	14	0	0
1	55013350	.	G	A	7	7	14	0	1	15	0	0
1	55013968	.	G	C	6	8	14	0	0	14	0	0
1	55018538	.	G	A	3	5	8	0	0	8	0	0
1	55021862	.	A	T	1	4	5	0	0	5	0	0
1	55021886	.	G	A	4	3	7	0	0	7	0	0
1	55021952	.	G	A	4	3	7	0	0	7	0	0
1	55022075	.	T	C	6	0	6	0	5	11	0	0
1	55022162	.	T	A	4	3	7	0	1	8	0	0
1	55033734	.	A	G	2	7	9	0	0	9	0	0
1	55037690	.	C	T	0	9	9	0	3	12	0	0
1	55038186	.	G	A	5	4	9	0	0	9	0	0
1	55038249	.	A	G	2	4	6	0	0	6	0	0
1	55046541	.	A	G	1	3	4	0	0	4	0	0
1	55046560	.	A	C	1	2	3	0	0	3	0	0
1	55046591	.	G	A	1	3	4	0	0	4	0	0
1	55047682	.	A	C	1	2	3	0	0	3	0	0
1	55047792	.	A	G	1	2	3	0	0	3	0	0
1	55048601	.	A	C	2	2	4	0	0	4	0	0
1	55049129	.	C	T	1	2	3	0	0	3	0	0
1	55049162	.	C	T	0	2	2	0	1	3	0	0
1	55049456	.	T	C	4	0	4	0	5	9	0	0
1	55057587	.	A	C	1	0	1	0	2	3	0	0
1	55058671	.	T	C	1	3	4	0	0	4	0	0
1	55080832	.	A	G	2	3	5	0	2	7	0	0
1	55080840	.	A	G	4	0	4	0	3	7	0	0
1	55080893	.	G	C	5	3	8	0	0	8	0	0
1	55080905	.	A	G	4	3	7	0	0	7	0	0
1	55084464	.	G	A	5	3	8	0	0	8	0	0
1	55084673	.	A	G	2	4	6	0	0	6	0	0
1	55085782	.	A	G	2	0	2	0	5	7	0	0
1	55085830	.	A	T	3	5	8	0	0	8	0	0
1	55087742	.	T	C	3	3	6	0	0	6	0	0
1	55087823	.	G	C	4	5	9	0	0	9	0	0
1	55087881	.	C	T	1	4	5	0	0	5	0	0
1	55088074	.	G	T	2	4	6	0	1	7	0	0
1	55088075	.	A	G	2	4	6	0	1	7	0	0
1	55089078	.	T	A	2	4	6	0	0	6	0	0
1	55089316	.	G	A	0	4	4	0	4	8	0	0
1	55089328	.	G	A	6	5	11	0	0	11	0	0
1	55089396	.	C	T	5	9	14	0	0	14	0	0
1	55089449	.	G	A	1	4	5	0	0	5	0	0
1	55099139	.	T	C	6	9	15	0	1	16	0	0
1	55099214	.	A	C	14	9	23	0	0	23	0	0
1	55099472	.	T	C	12	14	26	0	0	26	0	0
1	55099772	.	C	T	8	6	14	0	1	15	0	0
1	55099880	.	C	G	6	9	15	0	0	15	0	0
1	55099952	.	C	T	13	13	26	0	0	26	0	0
1	55100018	.	T	C	13	9	22	0	0	22	0	0
1	55100378	.	G	A	4	16	20	0	10	30	0	0
1	55100422	.	T	A	15	12	27	0	2	29	0	0
1	55100456	.	T	C	18	13	31	0	0	31	0	0
1	55101322	.	G	T	18	15	33	0	0	33	0	0
1	55101358	.	C	T	17	15	32	0	0	32	0	0
1	55101439	.	C	A	15	15	30	0	1	31	0	0
1	55101445	.	C	G	17	15	32	0	1	33	0	0
1	55103160	.	A	G	19	8	27	0	1	28	0	0
1	55105727	.	T	C	9	10	19	1	0	20	0	0
1	55108059	.	A	T	12	7	19	1	0	20	0	0
1	55108065	.	T	C	11	7	18	1	3	22	0	0
1	55109717	.	A	T	10	7	17	0	0	17	0	0
1	55113410	.	G	A	1	3	4	0	0	4	0	0
1	55113465	.	A	G	3	4	7	0	0	7	0	0
1	55116281	.	A	T	1	2	3	0	0	3	0	0
1	55126626	.	A	C	10	1	11	0	8	19	0	0
1	55129864	.	A	C	9	1	10	0	9	19	0	0
1	55144350	.	A	G	1	2	3	0	0	3	0	0
1	55161252	.	T	C	2	0	2	0	5	7	0	0
1	55161257	.	A	T	2	5	7	0	1	8	0	0
1	55161431	.	A	G	2	2	4	0	1	5	0	0
1	55161440	.	A	G	3	2	5	0	0	5	0	0
1	55161467	.	C	G	8	3	11	0	0	11	0	0
1	55166270	.	T	C	2	2	4	0	1	5	0	0
1	55166477	.	G	A	4	5	9	0	1	10	0	0
1	55169244	.	G	C	4	4	8	0	0	8	0	0
1	55169349	.	G	C	7	4	11	0	1	12	0	0
1	55169658	.	T	A	18	14	32	0	0	32	0	0
1	55169662	.	A	G	18	12	30	0	0	30	0	0
1	55169699	.	T	A	22	2	24	0	1	25	0	0
1	55169713	.	A	T	16	5	21	0	0	21	0	0
1	55169756	.	A	G	16	16	32	0	2	34	0	0
1	55169961	.	T	C	15	0	15	0	10	25	0	0
1	55169980	.	A	G	15	8	23	0	0	23	0	0
1	55169999	.	C	T	11	10	21	0	2	23	0	0
1	55170056	.	G	T	8	8	16	1	0	17	0	0
1	55170264	.	C	T	15	4	19	4	0	23	0	0
1	55171249	.	G	A	15	14	29	0	1	30	0	0
1	55176698	.	A	G	12	11	23	0	0	23	0	0
1	55178808	.	A	G	10	5	15	0	0	15	0	0
1	55179434	.	C	T	9	9	18	0	2	20	0	0
1	55179470	.	C	T	10	6	16	0	0	16	0	0
1	55180229	.	A	G	6	5	11	0	1	12	0	0
1	55180278	.	G	C	9	0	9	0	6	15	0	0
1	55182626	.	G	T	4	8	12	0	0	12	0	0
1	55182656	.	T	C	4	6	10	0	1	11	0	0
1	55182685	.	T	C	7	4	11	0	0	11	0	0
1	55182720	.	T	C	5	8	13	0	1	14	0	0
1	55182743	.	C	T	7	8	15	0	0	15	0	0
1	55182811	.	A	G	5	5	10	0	2	12	0	0
1	55182876	.	A	T	10	8	18	0	1	19	0	0
1	55183074	.	G	A	5	9	14	0	1	15	0	0
1	55191201	.	G	T	12	8	20	0	0	20	0	0
1	55191219	.	T	A	11	7	18	0	1	19	0	0
1	55191256	.	A	T	9	6	15	0	0	15	0	0
1	55191467	.	C	T	2	18	20	0	18	38	0	0
1	55191471	.	T	C	20	0	20	0	18	38	0	0
1	55191675	.	A	G	21	5	26	0	1	27	0	0
1	55195309	.	T	C	16	0	16	0	13	29	0	0
1	55195384	.	G	T	17	14	31	0	1	32	0	0
1	55195414	.	G	A	16	9	25	0	0	25	0	0
1	55195952	.	T	G	11	10	21	0	0	21	0	0
1	55196024	.	G	T	17	7	24	0	2	26	0	0
1	55197805	.	T	C	9	13	22	0	1	23	0	0
1	55223213	.	C	T	5	6	11	0	0	11	0	0
1	55223241	.	G	C	7	11	18	0	0	18	0	0
1	55226071	.	G	A	4	11	15	0	0	15	0	0
1	55226931	.	T	C	7	5	12	0	0	12	0	0
1	55228575	.	C	T	3	2	5	0	0	5	0	0
1	55228601	.	C	T	1	4	5	0	2	7	0	0
1	55229456	.	A	G	1	5	6	0	0	6	0	0
1	55229767	.	T	C	7	5	12	0	0	12	0	0
1	55230401	.	A	T	1	4	5	0	0	5	0	0
1	55233436	.	C	T	6	8	14	0	0	14	0	0
1	55233824	.	G	A	6	7	13	0	0	13	0	0
1	55233833	.	C	T	6	8	14	0	0	14	0	0
1	55234020	.	A	G	7	3	10	0	1	11	0	0
1	55234161	.	A	G	5	2	7	0	0	7	0	0
1	55234200	.	G	C	5	3	8	0	0	8	0	0
1	55234212	.	T	G	5	4	9	0	0	9	0	0
1	55235276	.	A	G	1	5	6	0	0	6	0	0
1	55264187	.	G	C	4	6	10	0	0	10	0	0
1	55264191	.	A	C	4	6	10	0	0	10	0	0
1	55264225	.	C	T	5	3	8	0	0	8	0	0
1	55264366	.	C	T	2	3	5	0	0	5	0	0
1	55264575	.	T	A	15	15	30	0	2	32	0	0
1	55746553	.	C	T	1	2	3	0	0	3	0	0
1	55748604	.	A	C	1	2	3	0	0	3	0	0
1	55762664	.	C	A	11	17	28	1	1	30	0	0
1	55772026	.	C	T	20	27	47	0	4	51	0	0
1	55776813	.	G	A	8	15	23	0	20	43	0	0
1	55776858	.	G	A	6	22	28	0	13	41	0	0
1	55776909	.	A	C	15	11	26	0	1	37	10	0
1	55776962	.	T	A	23	20	43	0	2	46	1	0
1	55777008	.	A	T	16	22	38	0	3	41	0	0
1	55783978	.	T	C	32	26	58	1	0	59	0	0
1	55785527	.	C	A	4	24	28	0	35	63	0	0
1	55785577	.	A	G	37	31	68	0	4	72	0	0
1	55785596	.	T	C	23	24	47	0	3	50	0	0
1	55785654	.	C	T	11	20	31	0	2	33	0	0
1	55785697	.	C	T	8	5	13	0	0	13	0	0
1	55787276	.	G	A	3	3	6	0	0	6	0	0
1	55787300	.	C	T	0	3	3	0	4	7	0	0
1	55787507	.	A	G	4	2	6	0	0	6	0	0
1	55789456	.	C	T	4	3	7	0	0	7	0	0
1	55789549	.	C	A	6	5	11	0	0	11	0	0
1	55810630	.	C	T	0	2	2	0	3	5	0	0
1	55817728	.	C	T	8	6	14	0	0	14	0	0
1	55817753	.	G	A	9	3	12	0	0	12	0	0
1	55824892	.	C	G	3	2	5	0	1	6	0	0
1	55833139	.	G	C	4	3	7	0	1	8	0	0
1	55833276	.	C	T	5	2	7	0	1	8	0	0
1	55833281	.	C	T	5	2	7	0	0	7	0	0
1	55843902	.	C	T	20	13	33	0	1	34	0	0
1	55843968	.	G	A	17	21	38	0	0	38	0	0
1	55844044	.	T	A	15	14	29	0	2	31	0	0
1	55844143	.	T	G	19	19	38	0	2	40	0	0
1	55851968	.	T	C	15	1	16	0	16	32	0	0
1	55853320	.	G	A	15	17	32	0	0	32	0	0
1	55872892	.	C	G	16	19	35	0	2	37	0	0
1	55873073	.	C	T	12	18	30	0	1	31	0	0
1	55878342	.	T	A	5	7	12	0	0	12	0	0
1	55878431	.	T	A	8	6	14	0	0	15	1	0
1	55878457	.	C	T	9	9	18	0	0	18	0	0
1	55878496	.	T	C	12	0	12	0	11	23	0	0
1	55878558	.	G	A	7	6	13	0	0	13	0	0
1	55885938	.	A	T	7	5	12	0	1	13	0	0
1	55888442	.	A	G	7	7	14	0	0	14	0	0
1	55888632	.	T	C	7	0	7	0	5	12	0	0
1	55888654	.	C	T	6	3	9	0	0	9	0	0
1	55888690	.	A	G	7	3	10	0	0	10	0	0
1	55888693	.	T	A	6	4	10	0	1	11	0	0
1	55888810	.	A	C	3	4	7	0	1	8	0	0
1	55888816	.	G	A	3	4	7	0	1	8	0	0
1	55888852	.	A	C	2	7	9	0	0	9	0	0
1	55888857	.	A	C	2	0	2	0	6	8	0	0
1	55888892	.	A	G	4	9	13	0	2	15	0	0
1	56217457	.	G	A	10	9	19	0	1	20	0	0
1	56217510	.	A	G	23	23	46	0	5	51	0	0
1	56217925	.	G	A	36	26	62	0	8	70	0	0
1	56218189	.	C	T	6	43	49	0	29	78	0	0
1	56218258	.	A	C	27	49	76	0	1	77	0	0
1	56220668	.	A	G	35	34	69	0	3	72	0	0
1	56223902	.	T	G	4	3	7	0	0	7	0	0
1	56422751	.	G	A	2	3	5	0	1	6	0	0
1	56422781	.	T	A	3	4	7	0	0	7	0	0
1	56422962	.	A	T	5	10	15	0	0	15	0	0
1	56422967	.	T	C	5	10	15	0	0	15	0	0
1	56423002	.	T	G	6	8	14	0	0	14	0	0
1	56423293	.	C	T	7	3	10	0	0	10	0	0
1	56423426	.	T	C	2	2	4	0	0	4	0	0
1	56423427	.	T	C	1	0	1	0	3	4	0	0
1	56423554	.	T	C	3	2	5	0	0	5	0	0
1	56423607	.	T	C	2	4	6	0	0	6	0	0
1	56423641	.	T	A	4	2	6	0	3	9	0	0
1	56425228	.	G	C	2	0	2	0	8	10	0	0
1	56425243	.	A	G	6	6	12	0	0	12	0	0
1	56425843	.	T	C	8	0	8	0	7	15	0	0
1	56425864	.	C	T	9	4	13	0	0	13	0	0
1	56428320	.	G	A	8	14	22	0	2	24	0	0
1	57278215	.	G	C	11	6	17	0	0	17	0	0
1	57278405	.	A	T	2	4	6	0	1	7	0	0
1	57278452	.	C	T	4	2	6	0	0	6	0	0
1	57278610	.	T	G	9	3	12	0	1	13	0	0
1	57278669	.	A	G	6	7	13	0	1	14	0	0
1	57278690	.	G	A	6	10	16	0	0	16	0	0
1	57278753	.	T	C	9	10	19	0	0	19	0	0
1	57278783	.	T	C	4	8	12	0	2	14	0	0
1	57278915	.	G	A	9	13	22	0	0	22	0	0
1	57278979	.	G	A	7	8	15	0	0	15	0	0
1	57279073	.	T	C	6	2	8	0	8	16	0	0
1	57280108	.	G	A	6	8	14	0	1	15	0	0
1	57280184	.	G	T	6	10	16	0	1	17	0	0
1	57280292	.	T	C	6	4	10	0	0	10	0	0
1	57280454	.	A	T	5	5	10	0	1	12	1	0
1	57280502	.	T	C	13	4	17	0	1	18	0	0
1	57306744	.	G	T	5	2	7	0	0	7	0	0
1	57332495	.	A	T	1	8	9	0	0	9	0	0
1	57332657	.	G	A	0	5	5	0	4	9	0	0
1	57332699	.	G	A	0	2	2	0	6	8	0	0
1	57332744	.	C	T	4	4	8	0	0	8	0	0
1	57333094	.	G	A	0	2	2	0	4	6	0	0
1	57337050	.	A	G	6	8	14	0	1	15	0	0
1	57337107	.	T	C	3	4	7	0	0	7	0	0
1	57337110	.	C	T	2	3	5	0	1	6	0	0
1	57338226	.	G	A	2	4	6	0	5	11	0	0
1	57340049	.	T	C	10	6	16	0	0	16	0	0
1	57340108	.	C	T	4	6	10	0	0	10	0	0
1	57340164	.	T	A	3	6	9	0	1	10	0	0
1	57927618	.	T	C	1	4	5	0	0	5	0	0
1	57990792	.	T	A	1	2	3	0	0	3	0	0
1	58013308	.	C	A	11	3	14	0	1	15	0	0
1	58013309	.	A	G	10	3	13	0	2	15	0	0
1	58013360	.	G	A	10	3	13	0	0	13	0	0
1	58013368	.	A	T	9	3	12	0	0	12	0	0
1	58013423	.	C	T	0	6	6	0	6	12	0	0
1	58013474	.	T	C	4	0	4	1	4	9	0	0
1	58013486	.	C	T	4	2	6	1	0	7	0	0
1	58014013	.	A	G	8	7	15	0	1	16	0	0
1	58014867	.	T	C	12	5	17	0	0	17	0	0
1	58014933	.	T	C	5	0	5	0	5	10	0	0
1	58015053	.	A	G	4	4	8	0	0	8	0	0
1	58015448	.	G	T	12	5	17	0	2	19	0	0
1	58015511	.	A	G	11	3	14	0	0	14	0	0
1	58015532	.	T	G	10	6	16	0	0	16	0	0
1	58015556	.	T	C	6	0	6	0	6	12	0	0
1	58015580	.	T	C	5	0	5	0	5	10	0	0
1	58018622	.	G	A	4	3	7	0	1	8	0	0
1	58018679	.	T	G	2	4	6	0	0	6	0	0
1	58018790	.	C	T	4	7	11	0	0	11	0	0
1	58018850	.	C	A	1	4	5	0	4	9	0	0
1	58019805	.	A	G	2	2	4	0	1	5	0	0
1	58019888	.	A	T	2	8	10	0	0	11	1	0
1	58020767	.	T	C	5	0	5	0	4	9	0	0
1	58020797	.	A	G	2	4	6	0	0	6	0	0
1	58020829	.	A	G	1	2	3	0	1	4	0	0
1	58020842	.	A	G	1	2	3	0	0	3	0	0
1	58036348	.	A	C	7	4	11	0	0	11	0	0
1	58036351	.	A	G	6	3	9	0	2	11	0	0
1	58036450	.	G	A	6	7	13	0	1	14	0	0
1	58036467	.	G	T	5	6	11	0	1	12	0	0
1	58039905	.	C	A	1	2	3	0	1	4	0	0
1	58545734	.	C	G	7	4	11	0	1	12	0	0
1	58547354	.	C	A	4	3	7	0	0	7	0	0
1	58547783	.	T	C	4	6	10	0	1	11	0	0
1	58548428	.	T	C	9	7	16	0	0	16	0	0
1	58548491	.	T	C	5	10	15	0	2	17	0	0
1	58559454	.	C	T	0	4	4	0	2	6	0	0
1	58559484	.	T	C	2	0	2	0	3	5	0	0
1	58559598	.	A	G	3	2	5	0	0	5	0	0
1	58570810	.	C	T	0	2	2	0	1	3	0	0
1	58593586	.	C	A	1	2	3	0	0	3	0	0
1	58593833	.	C	A	8	6	14	0	0	14	0	0
1	58593835	.	T	C	8	5	13	0	1	14	0	0
1	58593912	.	C	T	5	6	11	0	0	11	0	0
1	58594066	.	T	C	1	1	2	0	3	5	0	0
1	58594611	.	T	G	10	3	13	0	0	13	0	0
1	58594689	.	A	G	5	2	7	0	0	7	0	0
1	58594693	.	C	G	5	2	7	0	0	7	0	0
1	58595018	.	C	T	9	13	22	0	0	22	0	0
1	58595198	.	A	G	8	7	15	0	0	15	0	0
1	58595386	.	G	A	10	6	16	0	0	16	0	0
1	58595455	.	G	A	5	8	13	0	0	13	0	0
1	58595545	.	T	C	6	7	13	0	0	13	0	0
1	58598802	.	T	C	10	0	10	0	8	18	0	0
1	58598830	.	A	T	9	4	13	0	0	13	0	0
1	58601615	.	G	A	7	9	16	0	0	16	0	0
1	58601620	.	T	C	6	9	15	0	0	15	0	0
1	58602143	.	C	T	1	2	3	0	0	3	0	0
1	58603243	.	G	A	1	2	3	1	2	6	0	0
1	58605222	.	G	A	1	3	4	1	1	6	0	0
1	58605840	.	A	G	5	2	7	1	0	8	0	0
1	58606321	.	T	C	2	2	4	0	0	4	0	0
1	58606326	.	T	A	2	2	4	0	0	4	0	0
1	58612519	.	T	C	4	6	10	0	0	10	0	0
1	58612762	.	A	G	3	3	6	0	1	7	0	0
1	58612899	.	G	A	0	2	2	2	4	8	0	0
1	58613027	.	A	G	5	2	7	0	0	7	0	0
1	58613091	.	A	C	2	3	5	0	0	5	0	0
1	58615380	.	G	T	4	5	9	5	0	14	0	0
1	58617987	.	T	C	2	4	6	0	0	6	0	0
1	58618035	.	C	T	3	9	12	0	0	12	0	0
1	58618755	.	A	T	2	4	6	0	0	6	0	0
1	58618769	.	G	A	3	3	6	0	0	6	0	0
1	58618792	.	T	G	3	2	5	0	0	5	0	0
1	58631261	.	C	T	2	2	4	0	0	4	0	0
1	58631374	.	A	G	6	3	9	1	0	10	0	0
1	58631609	.	C	T	1	4	5	0	0	5	0	0
1	58631695	.	A	T	3	6	9	0	0	9	0	0
1	58631713	.	A	G	2	0	2	0	3	5	0	0
1	58677839	.	T	C	7	11	18	0	1	19	0	0
1	58677856	.	C	T	5	12	17	0	0	17	0	0
1	58677993	.	A	G	3	6	9	1	2	12	0	0
1	58678017	.	T	C	5	4	9	1	0	10	0	0
1	58678077	.	T	A	7	8	15	1	0	16	0	0
1	58680432	.	T	A	4	18	22	0	0	22	0	0
1	58680499	.	C	A	6	15	21	0	3	24	0	0
1	58680708	.	T	C	12	15	27	0	1	28	0	0
1	58680718	.	C	G	12	14	26	0	2	28	0	0
1	58680792	.	T	C	14	9	23	0	0	23	0	0
1	58680913	.	T	C	13	9	22	0	0	24	2	0
1	58681068	.	C	T	10	13	23	0	1	24	0	0
1	58681419	.	A	T	6	14	20	0	1	24	3	0
1	58681491	.	T	C	9	7	16	0	0	16	0	0
1	58762985	.	T	G	17	16	33	0	1	34	0	0
1	58763444	.	T	C	5	0	5	0	10	15	0	0
1	58766341	.	G	A	10	9	19	0	0	19	0	0
1	58846938	.	A	G	3	8	11	0	0	11	0	0
1	58850500	.	T	G	3	3	6	0	0	6	0	0
1	58850525	.	T	A	4	4	8	0	0	8	0	0
1	58850562	.	C	T	3	6	9	0	0	9	0	0
1	58977339	.	T	C	2	2	4	0	0	4	0	0
1	58982147	.	G	A	0	10	10	1	8	19	0	0
1	58982195	.	C	G	8	6	14	1	0	15	0	0
1	58984239	.	G	T	5	5	10	0	0	10	0	0
1	58984368	.	G	A	0	6	6	0	8	14	0	0
1	58984478	.	T	C	4	6	10	0	0	10	0	0
1	58984640	.	C	T	6	9	15	0	0	15	0	0
1	58985530	.	G	A	4	8	12	0	1	13	0	0
1	58985579	.	T	G	10	11	21	0	0	21	0	0
1	58985730	.	C	A	2	2	4	0	0	4	0	0
1	58992846	.	C	T	2	2	4	0	0	4	0	0
1	58993039	.	T	G	4	5	9	0	0	9	0	0
1	58993894	.	T	C	1	3	4	0	0	4	0	0
1	59009732	.	A	G	22	2	24	0	23	47	0	0
1	59018886	.	C	T	2	8	10	0	5	15	0	0
1	59019006	.	C	G	2	5	7	0	0	7	0	0
1	59019084	.	T	A	4	8	12	0	1	13	0	0
1	59019093	.	A	G	7	9	16	0	0	16	0	0
1	59062665	.	T	C	23	26	49	0	4	53	0	0
1	59065047	.	G	A	1	3	4	1	0	5	0	0
1	59065049	.	C	T	1	3	4	1	0	5	0	0
1	59065889	.	G	A	4	9	13	0	16	29	0	0
1	59141415	.	C	A	1	4	5	1	0	6	0	0
1	59141550	.	T	C	2	4	6	0	0	6	0	0
1	59141556	.	G	C	2	4	6	0	0	6	0	0
1	59142891	.	A	G	6	1	7	0	6	13	0	0
1	59143004	.	T	C	7	4	11	0	1	12	0	0
1	59143499	.	T	A	4	3	7	0	0	7	0	0
1	59143503	.	A	G	3	3	6	0	2	8	0	0
1	59146013	.	C	T	1	5	6	0	0	6	0	0
1	59146790	.	A	G	4	10	14	0	1	15	0	0
1	59148260	.	T	C	2	5	7	0	0	7	0	0
1	59148341	.	T	C	6	9	15	0	0	15	0	0
1	59149117	.	C	T	8	21	29	0	0	29	0	0
1	59149968	.	T	C	15	15	30	0	1	31	0	0
1	59150450	.	A	G	11	10	21	0	0	21	0	0
1	59150482	.	G	T	9	9	18	0	0	18	0	0
1	59150518	.	T	C	12	9	21	0	0	21	0	0
1	59150559	.	T	G	8	14	22	0	3	25	0	0
1	59150583	.	T	A	6	13	19	0	2	21	0	0
1	59150683	.	T	C	9	12	21	0	1	22	0	0
1	59150737	.	T	C	11	4	15	0	0	15	0	0
1	59150762	.	G	T	14	10	24	0	1	25	0	0
1	59150781	.	T	C	13	12	25	0	1	26	0	0
1	59154592	.	T	C	4	12	16	0	1	17	0	0
1	59156827	.	T	G	4	10	14	0	0	14	0	0
1	59157536	.	T	C	7	14	21	0	1	22	0	0
1	59157856	.	T	A	7	13	20	0	2	22	0	0
1	59157888	.	T	C	9	15	24	0	0	24	0	0
1	59157977	.	A	C	17	13	30	0	1	31	0	0
1	59158035	.	C	A	9	17	26	0	2	28	0	0
1	59158062	.	A	T	12	17	29	0	1	30	0	0
1	59158070	.	G	A	14	14	28	0	4	32	0	0
1	59172876	.	A	G	17	11	28	0	0	28	0	0
1	59172900	.	A	G	19	13	32	0	0	32	0	0
1	59172969	.	G	A	19	21	40	0	0	40	0	0
1	59173358	.	G	T	14	19	33	0	1	34	0	0
1	59173563	.	C	T	21	13	34	0	1	35	0	0
1	59173701	.	G	T	18	15	33	0	2	35	0	0
1	59173758	.	A	G	10	16	26	0	0	26	0	0
1	59173866	.	T	G	19	11	30	0	9	39	0	0
1	59173896	.	T	C	19	1	20	0	19	39	0	0
1	59174387	.	A	G	16	11	27	0	0	27	0	0
1	59174408	.	G	A	10	11	21	0	1	22	0	0
1	59174492	.	T	G	14	9	23	0	1	24	0	0
1	59174525	.	A	C	13	10	23	0	0	23	0	0
1	59174576	.	C	T	7	11	18	0	0	18	0	0
1	59174645	.	G	A	13	14	27	0	3	30	0	0
1	59174797	.	A	C	13	16	29	0	1	31	1	0
1	59174962	.	T	C	17	21	38	0	0	38	0	0
1	59175511	.	T	C	13	18	31	0	1	32	0	0
1	59175572	.	A	G	14	11	25	0	0	25	0	0
1	59175626	.	G	A	8	14	22	0	2	24	0	0
1	59175635	.	G	A	7	16	23	0	2	25	0	0
1	59175740	.	G	T	16	8	24	0	2	26	0	0
1	59175983	.	T	C	15	8	23	0	0	23	0	0
1	59175989	.	A	G	14	7	21	0	1	22	0	0
1	59176636	.	C	T	13	10	23	0	1	24	0	0
1	59176887	.	G	T	16	8	24	0	0	24	0	0
1	59176935	.	A	C	13	0	13	0	10	23	0	0
1	59218477	.	C	G	1	4	5	2	6	13	0	0
1	59218594	.	A	G	10	9	19	0	1	20	0	0
1	59226049	.	T	C	21	30	51	0	7	58	0	0
1	59226052	.	A	G	26	32	58	0	1	59	0	0
1	59228311	.	G	A	41	16	57	1	5	63	0	0
1	59228322	.	C	T	44	21	65	1	1	67	0	0
1	59228569	.	A	C	23	0	23	0	22	45	0	0
1	59229211	.	G	A	12	7	19	0	0	19	0	0
1	59232206	.	A	G	15	26	41	0	1	42	0	0
1	59232358	.	T	G	2	4	6	0	0	6	0	0
1	59232509	.	G	A	19	25	44	1	3	48	0	0
1	59235016	.	T	G	15	23	38	0	5	43	0	0
1	59238037	.	T	C	3	5	8	0	0	8	0	0
1	59238038	.	A	C	3	5	8	0	0	8	0	0
1	59244312	.	A	G	8	5	13	0	0	13	0	0
1	59244635	.	A	T	8	14	22	0	0	22	0	0
1	59244916	.	T	A	30	10	40	2	3	45	0	0
1	59244928	.	C	T	25	19	44	2	4	50	0	0
1	59245142	.	C	G	26	30	56	0	2	58	0	0
1	59245658	.	G	A	14	12	26	0	0	26	0	0
1	59245873	.	T	C	15	11	26	0	2	28	0	0
1	59245900	.	C	T	15	13	28	0	1	29	0	0
1	59246189	.	T	C	10	1	11	0	13	24	0	0
1	59246363	.	A	T	4	5	9	0	0	9	0	0
1	59247893	.	T	G	15	10	25	0	0	26	1	0
1	59247944	.	C	T	13	13	26	0	2	28	0	0
1	59248138	.	T	A	13	6	19	0	4	23	0	0
1	59251658	.	C	G	21	11	32	0	2	34	0	0
1	59251839	.	T	C	17	0	17	0	15	32	0	0
1	59293937	.	T	C	1	2	3	0	0	3	0	0
1	59293966	.	A	G	2	4	6	0	0	6	0	0
1	59297464	.	T	G	2	4	6	0	0	6	0	0
1	59298069	.	T	C	1	3	4	0	0	4	0	0
1	59298261	.	T	G	8	6	14	0	0	14	0	0
1	59302210	.	G	A	0	5	5	0	6	11	0	0
1	59302276	.	C	T	6	8	14	0	0	14	0	0
1	59302372	.	T	G	5	10	15	0	1	16	0	0
1	59302813	.	C	A	2	4	6	0	0	6	0	0
1	59303024	.	C	A	1	4	5	0	0	5	0	0
1	59303220	.	T	G	3	3	6	0	0	6	0	0
1	59305047	.	C	T	1	1	2	0	15	17	0	0
1	59305059	.	A	C	3	0	3	0	10	13	0	0
1	59305116	.	T	C	4	0	4	0	9	13	0	0
1	59305200	.	T	C	2	6	8	0	1	9	0	0
1	59305895	.	C	T	5	4	9	0	0	9	0	0
1	59312211	.	C	A	3	3	6	0	0	6	0	0
1	59314966	.	A	G	9	11	20	0	1	21	0	0
1	59318886	.	A	G	4	0	4	0	8	12	0	0
1	59320111	.	C	T	8	14	22	0	2	24	0	0
1	59321447	.	A	G	12	0	12	0	13	25	0	0
1	59324067	.	T	C	15	22	37	0	2	39	0	0
1	59328110	.	T	G	3	0	3	0	2	5	0	0
1	59328287	.	C	T	7	8	15	0	0	15	0	0
1	59330135	.	T	C	5	7	12	0	0	12	0	0
1	59409266	.	G	A	2	5	7	0	0	7	0	0
1	59415710	.	A	G	1	5	6	0	0	6	0	0
1	59422141	.	T	G	1	7	8	0	0	8	0	0
1	59542739	.	A	T	2	4	6	1	0	7	0	0
1	59562375	.	A	G	1	6	7	0	0	7	0	0
10	95052	.	T	C	5	2	7	0	0	7	0	0
10	590087	.	A	G	2	4	6	0	0	6	0	0
10	591341	.	A	G	1	3	4	0	0	4	0	0
10	591476	.	A	G	7	0	7	0	8	15	0	0
10	1052692	.	A	G	7	0	7	0	4	11	0	0
10	1056227	.	A	G	6	3	9	0	0	9	0	0
10	1056409	.	A	G	6	5	11	0	0	11	0	0
10	1056460	.	T	C	5	3	8	0	0	9	1	0
10	1076251	.	T	C	8	7	15	0	0	15	0	0
10	1082985	.	T	G	4	8	12	0	0	12	0	0
10	1083030	.	T	A	1	3	4	0	0	4	0	0
10	1084628	.	A	G	2	8	10	0	0	10	0	0
10	1105953	.	C	T	6	13	19	0	0	19	0	0
10	1107460	.	C	T	15	14	29	0	0	29	0	0
10	1113781	.	C	T	1	1	2	0	1	3	0	0
10	1133195	.	G	A	2	2	4	0	0	4	0	0
10	1226809	.	T	C	1	3	4	0	0	4	0	0
10	1275715	.	G	T	4	4	8	0	0	8	0	0
10	1436596	.	C	G	2	15	17	0	12	29	0	0
10	1450286	.	G	A	6	8	14	0	1	15	0	0
10	1515816	.	C	T	7	7	14	0	0	14	0	0
10	1519606	.	T	G	4	5	9	1	1	11	0	0
10	1541411	.	G	A	2	15	17	0	0	17	0	0
10	1549013	.	C	A	1	13	14	0	3	17	0	0
10	1549088	.	C	T	0	14	14	0	5	19	0	0
10	1549179	.	A	G	13	4	17	0	2	19	0	0
10	1549189	.	A	G	19	4	23	0	1	24	0	0
10	1549335	.	G	A	12	2	14	0	1	15	0	0
10	1549337	.	A	G	12	3	15	0	1	16	0	0
10	1549494	.	G	A	4	12	16	0	3	19	0	0
10	1549532	.	A	G	2	7	9	0	0	9	0	0
10	1549533	.	G	A	7	2	9	0	0	9	0	0
10	1552767	.	G	A	1	3	4	0	0	4	0	0
10	1597332	.	A	G	6	2	8	0	0	8	0	0
10	1597396	.	G	A	8	12	20	0	0	20	0	0
10	1599468	.	C	T	5	3	8	0	1	9	0	0
10	1603967	.	T	C	4	7	11	0	0	11	0	0
10	1609683	.	T	C	4	3	7	0	0	7	0	0
10	1617480	.	C	A	3	4	7	0	3	10	0	0
10	1626597	.	A	G	1	2	3	0	0	3	0	0
10	1648044	.	T	C	12	14	26	0	1	27	0	0
10	1649691	.	T	C	12	8	20	1	1	22	0	0
10	1652260	.	G	C	2	8	10	0	8	18	0	0
10	1656257	.	C	T	7	9	16	0	1	17	0	0
10	1658184	.	T	C	16	9	25	0	0	25	0	0
10	1663101	.	T	C	11	17	28	0	2	30	0	0
10	1665572	.	A	G	23	0	23	0	9	32	0	0
10	1666500	.	A	G	17	0	17	1	14	32	0	0
10	1666525	.	G	A	1	13	14	1	13	28	0	0
10	1668159	.	C	T	15	20	35	0	1	36	0	0
10	1671442	.	A	T	15	8	23	0	2	25	0	0
10	1674291	.	C	T	18	19	37	0	1	38	0	0
10	1681712	.	A	T	7	10	17	0	0	17	0	0
10	1684563	.	T	G	9	9	18	0	0	18	0	0
10	1687078	.	C	T	4	2	6	0	0	6	0	0
10	1687094	.	C	T	4	3	7	0	1	8	0	0
10	1687547	.	C	T	28	24	52	0	0	52	0	0
10	1694456	.	T	A	9	19	28	0	3	31	0	0
10	1708197	.	T	A	21	16	37	0	3	40	0	0
10	1708230	.	T	C	26	12	38	0	3	41	0	0
10	1708239	.	A	T	15	25	40	0	0	40	0	0
10	1708412	.	A	T	28	31	59	0	2	61	0	0
10	1709165	.	T	A	32	26	58	0	1	59	0	0
10	1709331	.	T	G	26	27	53	0	2	55	0	0
10	1709731	.	G	A	30	37	67	0	1	68	0	0
10	1709783	.	G	A	20	33	53	0	4	57	0	0
10	1709836	.	T	G	29	18	47	1	4	52	0	0
10	1709855	.	C	T	27	20	47	1	1	49	0	0
10	1709871	.	G	A	26	18	44	1	1	46	0	0
10	1710078	.	T	G	42	12	54	2	3	59	0	0
10	1710079	.	T	A	44	13	57	2	1	60	0	0
10	1710270	.	A	G	24	25	49	0	2	51	0	0
10	1710358	.	C	T	25	15	40	0	2	42	0	0
10	1711061	.	T	C	16	2	18	0	21	39	0	0
10	1711136	.	T	C	30	27	57	0	1	58	0	0
10	1711188	.	T	A	19	27	46	0	4	50	0	0
10	1711211	.	C	T	20	20	40	0	0	40	0	0
10	1711711	.	G	A	23	22	45	0	0	46	1	0
10	1711780	.	C	T	3	15	18	1	19	38	0	0
10	1712091	.	G	A	11	8	19	6	3	28	0	0
10	1712100	.	T	A	12	11	23	4	1	28	0	0
10	1712306	.	G	A	14	23	37	0	1	38	0	0
10	1712316	.	C	T	9	23	32	0	3	35	0	0
10	1712457	.	C	A	26	10	36	5	0	41	0	0
10	1712658	.	G	A	23	18	41	0	0	41	0	0
10	1712757	.	A	G	14	31	45	0	1	46	0	0
10	1712899	.	A	T	31	23	54	0	2	56	0	0
10	1712964	.	T	G	56	2	58	0	0	58	0	0
10	1713418	.	T	C	24	22	46	0	7	53	0	0
10	1718294	.	C	A	26	25	51	0	0	51	0	0
10	1745541	.	A	T	4	2	6	0	1	7	0	0
10	1745738	.	T	A	11	4	15	0	0	16	1	0
10	1752113	.	T	A	6	6	12	0	1	13	0	0
10	1752122	.	C	A	7	6	13	0	0	13	0	0
10	1776112	.	G	A	5	3	8	0	0	8	0	0
10	1782968	.	C	G	1	4	5	0	0	5	0	0
10	1798869	.	T	G	3	2	5	0	0	5	0	0
10	1866818	.	G	A	6	9	15	0	0	15	0	0
10	1869266	.	G	A	17	13	30	0	0	30	0	0
10	1869313	.	G	T	14	14	28	0	0	28	0	0
10	1869328	.	C	T	13	10	23	0	1	24	0	0
10	1871634	.	G	T	3	13	16	0	9	25	0	0
10	1880470	.	A	G	16	16	32	0	1	33	0	0
10	1880734	.	C	T	8	12	20	0	1	21	0	0
10	1885891	.	A	C	11	14	25	0	1	26	0	0
10	1886113	.	G	A	1	14	15	0	6	21	0	0
10	1886119	.	T	G	16	8	24	0	0	24	0	0
10	1886182	.	C	T	11	15	26	0	1	27	0	0
10	1886265	.	C	G	17	15	32	0	0	32	0	0
10	1886587	.	T	C	12	14	26	0	2	28	0	0
10	1886590	.	T	A	15	14	29	0	1	30	0	0
10	1886764	.	T	C	21	12	33	0	0	33	0	0
10	1887238	.	C	T	24	6	30	0	0	30	0	0
10	1887364	.	C	T	12	17	29	0	2	31	0	0
10	1887496	.	A	G	20	2	22	0	15	37	0	0
10	1887811	.	A	G	21	13	34	0	0	34	0	0
10	1888135	.	G	C	15	17	32	0	1	33	0	0
10	1888222	.	C	T	11	19	30	0	2	32	0	0
10	1888225	.	G	A	15	18	33	0	0	33	0	0
10	1888303	.	C	T	18	12	30	0	3	33	0	0
10	1888414	.	T	C	19	15	34	0	3	37	0	0
10	1888438	.	C	T	18	21	39	0	1	40	0	0
10	1888487	.	T	C	19	20	39	0	1	40	0	0
10	1888515	.	C	T	21	18	39	1	1	41	0	0
10	1888824	.	C	T	21	17	38	0	1	39	0	0
10	1888893	.	C	T	22	16	38	0	0	38	0	0
10	1889171	.	G	T	24	23	47	0	2	49	0	0
10	1889179	.	A	G	22	1	23	0	21	44	0	0
10	1889255	.	C	T	18	18	36	0	0	36	0	0
10	1889296	.	C	T	21	16	37	0	0	37	0	0
10	1889882	.	A	C	24	22	46	0	3	49	0	0
10	1890313	.	A	G	34	14	48	0	0	48	0	0
10	1890949	.	T	C	28	9	37	0	2	39	0	0
10	1890961	.	G	A	23	13	36	0	3	39	0	0
10	1891018	.	G	A	2	24	26	0	17	43	0	0
10	1891660	.	G	C	20	19	39	0	0	39	0	0
10	1891724	.	G	C	27	25	52	0	1	53	0	0
10	1892516	.	G	A	19	10	29	0	2	31	0	0
10	2234379	.	C	T	11	8	19	0	1	20	0	0
10	2255014	.	T	C	9	6	15	0	2	17	0	0
10	2261897	.	A	T	6	8	14	0	2	16	0	0
10	2261921	.	G	C	8	7	15	0	0	15	0	0
10	2283925	.	C	T	12	11	23	0	0	23	0	0
10	2283976	.	T	C	6	10	16	0	2	18	0	0
10	2286689	.	G	A	6	8	14	0	0	14	0	0
10	2292380	.	G	T	8	9	17	1	1	19	0	0
10	2294325	.	G	A	22	6	28	0	1	29	0	0
10	2328740	.	C	A	10	9	19	0	1	20	0	0
10	2339274	.	C	T	12	8	20	1	0	21	0	0
10	2354973	.	C	A	8	9	17	0	0	17	0	0
10	2367762	.	C	T	12	15	27	0	0	27	0	0
10	2393715	.	G	A	18	16	34	0	3	37	0	0
10	2393763	.	G	C	20	15	35	0	0	35	0	0
10	2504174	.	G	T	13	23	36	0	1	37	0	0
10	2504210	.	C	T	3	24	27	0	18	45	0	0
10	2506081	.	G	A	28	20	48	0	2	50	0	0
10	2508347	.	T	C	21	0	21	0	17	38	0	0
10	2510397	.	C	G	3	14	17	0	27	44	0	0
10	2515351	.	T	G	11	13	24	0	1	25	0	0
10	2515447	.	T	C	16	0	16	0	21	37	0	0
10	2526413	.	A	G	18	22	40	0	1	41	0	0
10	2575204	.	A	G	17	1	18	0	15	33	0	0
10	2575369	.	T	C	19	15	34	0	0	34	0	0
10	2582315	.	A	G	1	2	3	0	0	3	0	0
10	2582318	.	T	G	1	0	1	0	2	3	0	0
10	2661542	.	C	G	3	2	5	0	1	6	0	0
10	2666387	.	A	G	3	0	3	0	7	10	0	0
10	2681622	.	C	T	7	5	12	0	0	12	0	0
10	2681771	.	G	A	9	16	25	0	2	27	0	0
10	2681800	.	C	T	1	16	17	0	8	25	0	0
10	2685179	.	T	C	3	2	5	0	1	6	0	0
10	2685228	.	A	G	1	0	1	0	2	3	0	0
10	2697449	.	C	T	0	6	6	1	3	10	0	0
10	2700572	.	G	A	6	4	10	0	0	10	0	0
10	2704653	.	C	T	6	13	19	0	0	19	0	0
10	2704752	.	G	T	8	9	17	0	0	17	0	0
10	2759276	.	G	A	15	7	22	0	1	23	0	0
10	2759329	.	T	G	13	11	24	0	1	25	0	0
10	2759381	.	G	C	12	15	27	0	1	28	0	0
10	2759391	.	A	T	12	13	25	0	3	28	0	0
10	2772036	.	G	A	12	8	20	1	2	23	0	0
10	2772057	.	G	A	12	11	23	1	2	26	0	0
10	2778444	.	G	A	15	17	32	0	2	34	0	0
10	2782761	.	G	A	11	13	24	0	0	24	0	0
10	2784391	.	A	G	12	14	26	0	1	27	0	0
10	2788649	.	A	T	13	7	20	0	0	20	0	0
10	2850533	.	A	G	7	4	11	0	0	11	0	0
10	2850546	.	A	G	7	2	9	0	0	9	0	0
10	2850675	.	A	G	3	0	3	0	6	9	0	0
10	2888166	.	C	A	11	6	17	1	0	18	0	0
10	2891905	.	G	A	6	12	18	0	0	18	0	0
10	2894148	.	G	C	12	6	18	0	0	18	0	0
10	2894193	.	T	G	8	0	8	0	10	18	0	0
10	2894545	.	C	T	10	7	17	0	1	18	0	0
10	2897110	.	A	C	8	9	17	0	0	17	0	0
10	2897720	.	T	A	9	9	18	0	0	18	0	0
10	2897817	.	T	G	9	1	10	0	3	13	0	0
10	2897897	.	A	G	2	6	8	0	2	10	0	0
10	2897911	.	G	T	3	5	8	0	1	9	0	0
10	2898087	.	T	C	3	4	7	0	0	7	0	0
10	2898269	.	C	T	2	5	7	0	1	8	0	0
10	2898346	.	T	A	3	4	7	0	0	7	0	0
10	2898390	.	A	T	1	2	3	0	0	3	0	0
10	2899238	.	A	G	1	2	3	0	0	3	0	0
10	2899345	.	A	G	2	2	4	0	1	5	0	0
10	2899399	.	C	T	2	2	4	0	0	4	0	0
10	2899425	.	G	C	0	2	2	0	1	3	0	0
10	2899565	.	G	A	0	3	3	0	2	5	0	0
10	2899631	.	A	T	2	2	4	0	0	4	0	0
10	2899632	.	C	A	2	2	4	0	0	4	0	0
10	2902681	.	A	C	2	2	4	0	0	4	0	0
10	2904624	.	C	T	2	2	4	0	0	4	0	0
10	2904638	.	G	C	2	2	4	0	0	4	0	0
10	2904794	.	C	T	4	4	8	0	0	8	0	0
10	2906893	.	T	C	4	3	7	0	1	8	0	0
10	2907353	.	A	G	4	2	6	0	0	6	0	0
10	2907362	.	T	C	4	3	7	0	0	7	0	0
10	2907413	.	A	G	5	5	10	0	0	10	0	0
10	2907422	.	T	C	5	6	11	0	1	12	0	0
10	2907461	.	A	G	5	5	10	0	1	11	0	0
10	2909135	.	G	A	4	3	7	0	0	7	0	0
10	2910591	.	G	T	4	3	7	0	0	7	0	0
10	2915399	.	G	A	8	4	12	0	0	12	0	0
10	2915412	.	A	G	10	4	14	0	0	14	0	0
10	2915462	.	G	A	1	4	5	0	8	13	0	0
10	2915495	.	C	T	5	7	12	0	1	13	0	0
10	2920032	.	C	T	6	4	10	0	1	11	0	0
10	2921280	.	T	A	7	4	11	0	1	12	0	0
10	2981073	.	C	T	4	4	8	0	0	8	0	0
10	2983307	.	G	A	3	2	5	0	0	5	0	0
10	2983715	.	C	T	2	3	5	0	0	5	0	0
10	2983736	.	A	G	3	3	6	0	1	7	0	0
10	2983864	.	C	A	2	2	4	0	0	4	0	0
10	2983997	.	C	T	1	2	3	0	1	4	0	0
10	2984171	.	A	T	2	3	5	0	0	5	0	0
10	2984311	.	C	T	5	3	8	0	0	8	0	0
10	2984819	.	G	C	0	4	4	0	6	10	0	0
10	2984902	.	T	C	8	3	11	0	0	11	0	0
10	2984924	.	G	T	7	4	11	0	0	11	0	0
10	2984945	.	G	A	0	2	2	0	6	8	0	0
10	2985032	.	G	T	0	3	3	0	4	7	0	0
10	2987020	.	A	G	3	0	3	0	3	6	0	0
10	3007051	.	A	C	8	7	15	0	0	15	0	0
10	3016263	.	T	C	6	7	13	0	0	13	0	0
10	3024637	.	C	G	10	9	19	0	0	19	0	0
10	3024706	.	C	T	9	15	24	0	1	25	0	0
10	3026264	.	A	C	9	10	19	0	0	19	0	0
10	3026376	.	A	G	7	8	15	0	1	16	0	0
10	3026521	.	A	C	1	4	5	0	1	6	0	0
10	3031670	.	T	C	5	0	5	0	8	13	0	0
10	3031760	.	A	G	5	7	12	0	0	12	0	0
10	3032072	.	C	T	5	4	9	0	2	11	0	0
10	3032353	.	T	A	3	7	10	0	0	10	0	0
10	3032481	.	G	T	3	3	6	0	0	6	0	0
10	3032500	.	G	A	6	3	9	0	0	9	0	0
10	3033231	.	G	A	6	2	8	0	1	9	0	0
10	3033247	.	A	G	6	3	9	0	0	9	0	0
10	3078844	.	C	G	3	5	8	0	0	8	0	0
10	3085411	.	G	T	4	2	6	0	0	6	0	0
10	3308482	.	G	A	1	9	10	0	14	24	0	0
10	3311737	.	T	G	8	10	18	0	0	18	0	0
10	3311800	.	A	G	9	0	9	0	9	18	0	0
10	3311845	.	G	A	7	8	15	0	0	15	0	0
10	3314596	.	T	C	22	11	33	0	1	34	0	0
10	3317976	.	G	A	1	12	13	0	9	22	0	0
10	3318005	.	G	C	1	11	12	0	8	20	0	0
10	3318060	.	G	A	8	8	16	0	1	17	0	0
10	3318201	.	A	G	2	13	15	0	2	17	0	0
10	3318211	.	C	T	3	11	14	0	0	14	0	0
10	3318358	.	G	T	2	4	6	0	0	6	0	0
10	3318837	.	G	C	3	3	6	0	0	6	0	0
10	3319873	.	A	G	11	0	11	0	10	21	0	0
10	3319890	.	G	T	0	7	7	0	14	21	0	0
10	3319938	.	C	T	11	12	23	0	2	25	0	0
10	3320007	.	C	G	12	13	25	0	1	26	0	0
10	3320015	.	T	C	14	14	28	0	1	29	0	0
10	3320151	.	A	G	14	21	35	0	2	37	0	0
10	3320194	.	G	A	12	12	24	0	2	26	0	0
10	3320229	.	G	A	15	10	25	0	1	26	0	0
10	3320287	.	T	G	14	11	25	0	4	29	0	0
10	3320465	.	C	G	12	15	27	0	2	29	0	0
10	3320495	.	A	T	9	22	31	0	2	33	0	0
10	3320506	.	C	T	21	9	30	0	0	30	0	0
10	3320705	.	G	A	11	7	18	0	1	19	0	0
10	3320776	.	C	T	16	13	29	0	0	29	0	0
10	3320850	.	C	T	26	8	34	0	1	35	0	0
10	3321005	.	A	G	17	8	25	0	0	25	0	0
10	3321262	.	A	G	13	23	36	0	2	38	0	0
10	3321273	.	A	G	15	18	33	0	3	36	0	0
10	3321416	.	T	G	15	9	24	0	1	25	0	0
10	3336838	.	C	T	3	3	6	0	0	6	0	0
10	3336846	.	T	A	4	6	10	0	0	10	0	0
10	3341412	.	C	T	8	7	15	0	1	16	0	0
10	3353607	.	C	T	9	7	16	0	0	16	0	0
10	3353622	.	A	G	6	6	12	0	0	12	0	0
10	3354048	.	A	G	9	10	19	0	0	19	0	0
10	3358897	.	A	T	15	11	26	0	0	26	0	0
10	3364772	.	A	T	6	6	12	0	2	14	0	0
10	3365063	.	C	T	0	8	8	2	13	23	0	0
10	3365312	.	T	C	8	5	13	0	0	13	0	0
10	3365726	.	A	C	27	0	27	2	0	30	1	0
10	3365834	.	A	T	7	4	11	0	1	12	0	0
10	3366095	.	C	T	3	10	13	0	17	30	0	0
10	3366199	.	C	T	0	11	11	0	12	23	0	0
10	3370680	.	G	A	3	11	14	0	0	14	0	0
10	3371866	.	G	A	9	8	17	0	1	18	0	0
10	3377087	.	G	A	3	3	6	0	1	7	0	0
10	3379107	.	T	C	3	0	3	0	4	7	0	0
10	3381744	.	A	G	6	7	13	0	0	13	0	0
10	3385835	.	T	C	2	6	8	0	1	9	0	0
10	3388200	.	T	G	9	12	21	0	0	21	0	0
10	3400126	.	A	T	7	2	9	0	0	9	0	0
10	3400216	.	C	T	4	5	9	0	0	9	0	0
10	3400225	.	T	C	3	5	8	0	0	8	0	0
10	3403764	.	C	T	0	2	2	0	3	5	0	0
10	3406168	.	A	G	2	2	4	0	0	4	0	0
10	3408009	.	G	A	1	4	5	0	0	5	0	0
10	3416152	.	T	C	4	3	7	0	0	7	0	0
10	3420097	.	A	T	18	17	35	0	0	35	0	0
10	3426363	.	G	A	13	28	41	0	2	43	0	0
10	3428230	.	G	C	8	6	14	0	2	16	0	0
10	3430894	.	C	G	3	6	9	0	0	9	0	0
10	3434883	.	C	T	7	3	10	0	1	11	0	0
10	3435321	.	T	A	9	5	14	0	1	15	0	0
10	3436370	.	C	T	11	6	17	0	0	17	0	0
10	3438991	.	T	C	1	4	5	0	0	5	0	0
10	3439018	.	A	G	2	7	9	0	0	9	0	0
10	3441973	.	T	C	10	4	14	0	0	14	0	0
10	3442030	.	T	C	2	7	9	0	0	9	0	0
10	3445818	.	C	T	6	9	15	0	0	15	0	0
10	3450861	.	A	G	13	6	19	0	0	19	0	0
10	3451091	.	G	A	5	5	10	0	0	10	0	0
10	3451429	.	G	A	0	9	9	0	14	23	0	0
10	3451672	.	A	G	2	7	9	0	0	9	0	0
10	3451848	.	G	A	0	3	3	0	8	11	0	0
10	3451864	.	C	T	3	6	9	0	0	9	0	0
10	3452073	.	A	G	2	14	16	0	0	16	0	0
10	3452183	.	G	A	8	4	12	0	0	12	0	0
10	3452185	.	T	A	8	4	12	0	0	12	0	0
10	3532257	.	T	C	1	2	3	0	0	3	0	0
10	3884831	.	G	A	0	4	4	0	2	6	0	0
10	3884936	.	G	A	3	3	6	0	1	7	0	0
10	3884957	.	G	A	4	4	8	0	0	8	0	0
10	3885050	.	C	T	1	2	3	0	1	4	0	0
10	3885069	.	T	C	0	3	3	0	0	3	0	0
10	3942996	.	T	A	10	5	15	0	0	15	0	0
10	3943026	.	A	G	6	0	6	0	10	16	0	0
10	3969027	.	G	T	0	9	9	0	7	16	0	0
10	3969491	.	G	T	4	5	9	0	1	10	0	0
10	3969887	.	C	T	5	6	11	0	0	11	0	0
10	3979744	.	G	T	7	7	14	0	0	14	0	0
10	3979870	.	G	A	9	6	15	0	0	15	0	0
10	3979876	.	C	A	8	5	13	0	0	13	0	0
10	3987505	.	T	C	3	7	10	0	0	10	0	0
10	4010300	.	A	G	4	8	12	0	0	12	0	0
10	4010345	.	G	T	0	7	7	0	11	18	0	0
10	4016017	.	G	A	2	13	15	0	0	15	0	0
10	4024798	.	G	A	12	4	16	0	0	16	0	0
10	4026443	.	T	G	5	0	5	0	5	10	0	0
10	4029455	.	C	T	8	7	15	0	0	15	0	0
10	4029634	.	A	G	6	4	10	0	1	11	0	0
10	4030211	.	A	T	4	3	7	0	1	8	0	0
10	4032623	.	C	T	10	4	14	0	0	14	0	0
10	4037287	.	G	A	10	4	14	0	2	16	0	0
10	4038772	.	G	A	7	14	21	0	3	24	0	0
10	4038898	.	A	G	12	9	21	0	1	22	0	0
10	4039123	.	C	T	20	10	30	0	2	32	0	0
10	4039129	.	C	T	19	11	30	0	2	32	0	0
10	4060322	.	T	C	4	8	12	0	0	12	0	0
10	4060394	.	G	A	3	2	5	0	0	5	0	0
10	4067500	.	T	G	3	3	6	0	0	6	0	0
10	4073792	.	C	T	6	3	9	0	0	9	0	0
10	4240887	.	T	C	16	22	38	0	2	40	0	0
10	4240899	.	C	T	18	22	40	0	0	40	0	0
10	4279623	.	C	A	2	2	4	0	0	4	0	0
10	4279695	.	T	C	2	2	4	0	1	5	0	0
10	4279800	.	A	G	6	5	11	0	0	11	0	0
10	4289764	.	G	A	2	4	6	0	0	6	0	0
10	4290174	.	T	A	2	4	6	0	0	6	0	0
10	4290771	.	A	G	2	2	4	0	0	4	0	0
10	4314971	.	G	T	0	2	2	0	1	3	0	0
10	4501609	.	C	T	9	6	15	0	0	15	0	0
10	4501733	.	G	A	8	11	19	0	1	20	0	0
10	4501817	.	A	G	9	8	17	0	0	17	0	0
10	4503291	.	G	T	13	9	22	0	0	22	0	0
10	4503736	.	C	T	10	10	20	0	1	21	0	0
10	4503901	.	C	G	18	9	27	0	1	28	0	0
10	4505886	.	T	A	13	16	29	0	1	31	1	0
10	4505887	.	T	A	13	17	30	0	1	31	0	0
10	4508492	.	T	A	21	10	31	0	1	32	0	0
10	4508518	.	G	T	4	13	17	0	15	32	0	0
10	4808105	.	A	G	3	3	6	0	0	6	0	0
10	4808241	.	A	C	0	4	4	0	1	5	0	0
10	4808266	.	G	A	1	4	5	0	0	5	0	0
10	4808498	.	T	C	4	2	6	0	0	6	0	0
10	4888387	.	C	A	6	4	10	0	0	10	0	0
10	4888457	.	A	G	10	8	18	0	0	18	0	0
10	4888582	.	A	G	7	0	7	0	8	15	0	0
10	4888666	.	A	G	3	0	3	0	7	10	0	0
10	4888808	.	C	T	5	6	11	0	0	11	0	0
10	4888832	.	G	A	0	6	6	0	6	12	0	0
10	4888988	.	T	C	5	2	7	0	0	7	0	0
10	4889119	.	A	T	2	7	9	0	1	10	0	0
10	4889159	.	C	A	3	6	9	0	0	9	0	0
10	4889228	.	C	T	4	5	9	0	0	9	0	0
10	4889248	.	T	C	5	5	10	0	0	10	0	0
10	4889302	.	C	A	5	11	16	0	1	17	0	0
10	4889704	.	A	G	9	9	18	0	1	19	0	0
10	4889923	.	A	G	8	0	8	0	8	16	0	0
10	4890027	.	C	T	8	9	17	0	0	17	0	0
10	4890082	.	G	C	4	10	14	0	0	14	0	0
10	4896742	.	G	A	10	5	15	0	0	15	0	0
10	4896766	.	G	A	12	5	17	0	0	17	0	0
10	4940895	.	A	G	7	6	13	0	0	13	0	0
10	4941113	.	A	G	6	5	11	0	0	11	0	0
10	4941342	.	G	C	7	9	16	0	2	18	0	0
10	4941421	.	T	G	11	6	17	0	0	17	0	0
10	4950824	.	G	T	14	7	21	0	0	21	0	0
10	4956906	.	C	T	11	7	18	0	1	19	0	0
10	4956966	.	G	A	10	7	17	0	1	18	0	0
10	4968900	.	G	C	8	18	26	0	0	26	0	0
10	4969014	.	T	A	7	9	16	0	0	16	0	0
10	4969036	.	T	G	3	1	4	0	9	13	0	0
10	4969069	.	C	A	6	9	15	0	0	15	0	0
10	5000719	.	C	T	1	11	12	2	12	26	0	0
10	5000753	.	C	T	2	7	9	0	15	24	0	0
10	5004215	.	C	T	6	3	9	0	0	9	0	0
10	5010287	.	G	A	20	25	45	0	0	45	0	0
10	5010344	.	T	G	21	30	51	0	0	51	0	0
10	5010407	.	G	A	19	24	43	0	1	44	0	0
10	5016797	.	G	A	30	23	53	0	3	56	0	0
10	5016917	.	C	G	28	26	54	0	2	56	0	0
10	5016922	.	A	G	30	27	57	0	0	57	0	0
10	5020320	.	G	A	28	29	57	0	8	65	0	0
10	5020326	.	T	C	35	30	65	0	2	67	0	0
10	5024410	.	C	T	28	25	53	0	4	57	0	0
10	5025848	.	C	A	14	15	29	0	1	30	0	0
10	5026058	.	C	T	15	9	24	0	0	24	0	0
10	5028877	.	A	G	13	14	27	0	0	27	0	0
10	5031869	.	T	C	10	14	24	0	0	24	0	0
10	5036521	.	G	A	2	8	10	0	9	19	0	0
10	5036522	.	A	G	11	8	19	0	0	19	0	0
10	5036729	.	C	T	12	7	19	0	0	19	0	0
10	5037119	.	T	A	7	4	11	0	0	11	0	0
10	5037147	.	C	T	5	4	9	0	0	9	0	0
10	5037354	.	C	A	10	3	13	0	0	13	0	0
10	5037372	.	A	T	13	7	20	0	0	20	0	0
10	5042113	.	C	T	7	6	13	0	0	13	0	0
10	5042217	.	A	G	10	4	14	0	0	14	0	0
10	5042239	.	G	A	5	3	8	0	1	9	0	0
10	5042469	.	G	A	8	6	14	0	0	14	0	0
10	5047452	.	A	G	12	5	17	1	0	18	0	0
10	5053518	.	C	G	5	3	8	0	2	10	0	0
10	5053556	.	T	C	6	4	10	0	0	10	0	0
10	5058715	.	C	T	0	6	6	0	8	14	0	0
10	5092764	.	T	C	7	5	12	4	1	17	0	0
10	5092772	.	A	G	5	3	8	5	1	14	0	0
10	5093157	.	T	C	5	10	15	0	2	17	0	0
10	5093222	.	A	G	11	6	17	0	1	18	0	0
10	5093240	.	C	A	9	5	14	0	0	14	0	0
10	5093274	.	A	G	2	5	7	0	0	7	0	0
10	5094649	.	C	A	3	9	12	0	1	13	0	0
10	5094778	.	G	T	7	6	13	0	0	13	0	0
10	5097478	.	G	A	6	12	18	0	0	18	0	0
10	5097520	.	A	G	5	4	9	0	0	9	0	0
10	5110656	.	T	C	7	4	11	0	1	12	0	0
10	5110761	.	A	G	11	4	15	0	0	15	0	0
10	5110777	.	G	A	9	7	16	0	0	16	0	0
10	5113791	.	G	T	6	3	9	0	0	9	0	0
10	5119729	.	C	T	0	3	3	0	5	8	0	0
10	5124214	.	A	T	3	5	8	0	0	8	0	0
10	5124374	.	C	T	5	2	7	0	0	7	0	0
10	5124609	.	G	T	3	5	8	0	0	8	0	0
10	5124612	.	A	G	3	5	8	0	0	8	0	0
10	5126927	.	T	G	6	4	10	0	0	10	0	0
10	5146688	.	G	A	3	11	14	0	1	15	0	0
10	5147059	.	A	G	5	2	7	0	1	8	0	0
10	5203569	.	G	A	15	7	22	0	4	26	0	0
10	5216204	.	T	C	6	11	17	0	1	18	0	0
10	5216249	.	A	G	9	14	23	0	3	26	0	0
10	5220608	.	C	T	13	12	25	0	1	26	0	0
10	5220835	.	G	A	1	11	12	0	8	20	0	0
10	5220940	.	T	A	15	10	25	0	1	26	0	0
10	5220992	.	C	T	10	15	25	0	0	25	0	0
10	5220997	.	C	A	16	9	25	0	1	26	0	0
10	5221039	.	G	A	14	10	24	0	1	25	0	0
10	5221199	.	T	A	8	2	10	0	0	10	0	0
10	5221238	.	C	A	6	16	22	0	0	22	0	0
10	5221292	.	C	A	15	9	24	0	1	25	0	0
10	5221297	.	T	G	15	8	23	0	0	23	0	0
10	5221336	.	G	C	10	9	19	0	1	20	0	0
10	5237199	.	C	A	4	3	7	0	0	7	0	0
10	5237213	.	C	T	5	2	7	0	0	7	0	0
10	5239838	.	G	A	1	3	4	0	2	6	0	0
10	5245143	.	G	A	0	5	5	0	4	9	0	0
10	5245194	.	C	G	5	0	5	0	6	11	0	0
10	5248247	.	T	C	6	6	12	0	1	13	0	0
10	5257980	.	C	T	3	5	8	0	0	8	0	0
10	5258914	.	T	A	8	8	16	0	1	17	0	0
10	5264280	.	A	G	9	8	17	0	1	18	0	0
10	5264310	.	G	A	7	6	13	0	0	13	0	0
10	5264458	.	G	A	8	5	13	0	0	13	0	0
10	5264534	.	C	A	4	6	10	0	1	11	0	0
10	5417480	.	A	G	9	5	14	0	0	14	0	0
10	5417669	.	T	A	8	4	12	0	0	12	0	0
10	5417841	.	A	C	4	4	8	0	0	8	0	0
10	5418509	.	A	G	8	6	14	1	0	15	0	0
10	5418569	.	C	T	7	6	13	0	0	13	0	0
10	5429905	.	G	A	1	8	9	0	7	16	0	0
10	5432576	.	T	C	4	6	10	0	1	11	0	0
10	5461988	.	C	A	7	4	11	0	1	13	1	0
10	5461994	.	T	A	7	3	10	0	0	10	0	0
10	5475206	.	G	C	4	3	7	0	2	9	0	0
10	5475214	.	T	G	6	4	10	0	1	11	0	0
10	5475406	.	A	T	1	2	3	0	0	3	0	0
10	5475526	.	T	C	4	3	7	0	0	7	0	0
10	5534179	.	T	A	3	2	5	0	0	5	0	0
10	5534483	.	T	C	6	3	9	0	1	10	0	0
10	5534487	.	C	T	0	2	2	0	7	9	0	0
10	5534527	.	G	T	8	5	13	0	1	14	0	0
10	5534539	.	G	A	7	6	13	0	0	13	0	0
10	5534611	.	C	T	5	7	12	0	1	13	0	0
10	5534612	.	A	G	5	7	12	0	0	12	0	0
10	5534646	.	A	G	7	7	14	0	1	15	0	0
10	5534878	.	C	T	10	8	18	0	0	18	0	0
10	5534946	.	A	G	11	10	21	0	0	21	0	0
10	5534950	.	A	T	11	10	21	0	1	22	0	0
10	5535047	.	A	T	9	3	12	0	2	14	0	0
10	5535048	.	C	G	11	3	14	0	0	15	1	0
10	5535359	.	A	T	5	7	12	0	0	12	0	0
10	5535368	.	T	A	5	6	11	0	0	11	0	0
10	5535436	.	C	T	12	5	17	0	0	17	0	0
10	5535445	.	T	C	11	6	17	0	0	17	0	0
10	5535483	.	A	T	12	10	22	0	1	23	0	0
10	5535540	.	T	G	11	9	20	0	3	23	0	0
10	5535561	.	T	A	11	8	19	0	1	20	0	0
10	5536240	.	T	C	2	5	7	0	0	7	0	0
10	5536256	.	G	A	3	5	8	0	0	8	0	0
10	5536534	.	T	A	1	4	5	0	0	5	0	0
10	5538302	.	T	G	9	5	14	0	1	15	0	0
10	5542152	.	T	C	7	6	13	0	0	13	0	0
10	5545438	.	C	T	8	11	19	0	1	20	0	0
10	5545465	.	T	C	9	8	17	0	0	17	0	0
10	5568128	.	G	T	7	7	14	0	0	14	0	0
10	5568155	.	T	G	6	9	15	0	0	15	0	0
10	5568212	.	G	A	8	9	17	0	0	17	0	0
10	5568319	.	A	C	9	7	16	0	1	17	0	0
10	5568329	.	A	G	10	8	18	0	0	18	0	0
10	5667605	.	C	T	4	2	6	0	0	6	0	0
10	5667906	.	C	A	2	2	4	0	1	5	0	0
10	5668103	.	C	T	4	3	7	0	1	8	0	0
10	5668135	.	G	A	6	4	10	0	2	12	0	0
10	5668218	.	G	C	8	10	18	0	1	19	0	0
10	5683869	.	A	G	1	3	4	0	0	4	0	0
10	5724020	.	T	C	16	16	32	0	1	33	0	0
10	5724095	.	T	C	25	23	48	0	2	50	0	0
10	5737757	.	G	A	39	12	51	0	2	53	0	0
10	5744934	.	C	T	40	11	51	0	3	54	0	0
10	5745015	.	C	A	30	20	50	0	0	50	0	0
10	5745290	.	T	C	23	22	45	5	2	52	0	0
10	5745299	.	C	T	19	22	41	5	3	50	1	0
10	5760455	.	T	C	26	13	39	0	2	41	0	0
10	5760461	.	A	G	29	12	41	0	0	41	0	0
10	5766958	.	A	G	33	25	58	0	1	59	0	0
10	5769541	.	G	T	28	26	54	0	3	57	0	0
10	5772568	.	A	G	23	29	52	0	5	57	0	0
10	5782337	.	C	T	37	34	71	0	3	74	0	0
10	5788755	.	A	C	4	4	8	0	0	8	0	0
10	5788806	.	G	A	1	7	8	0	0	8	0	0
10	5788877	.	G	A	7	5	12	0	0	12	0	0
10	5789059	.	A	G	8	3	11	0	0	11	0	0
10	5789069	.	G	A	8	1	9	0	1	10	0	0
10	5789155	.	G	T	4	4	8	0	2	10	0	0
10	5789241	.	T	C	10	3	13	0	0	13	0	0
10	5789245	.	T	C	10	2	12	0	0	12	0	0
10	5789806	.	C	T	8	5	13	0	0	13	0	0
10	5789905	.	T	A	4	6	10	3	1	14	0	0
10	5789920	.	T	C	2	5	7	1	2	10	0	0
10	5790001	.	C	A	4	3	7	0	0	7	0	0
10	5790080	.	A	G	4	13	17	0	4	21	0	0
10	5790097	.	G	A	5	14	19	1	0	20	0	0
10	5790210	.	C	T	11	6	17	0	3	20	0	0
10	5790278	.	G	T	7	10	17	3	0	20	0	0
10	5790397	.	A	T	2	4	6	2	1	9	0	0
10	5790412	.	C	T	3	2	5	2	1	8	0	0
10	5790570	.	A	C	10	7	17	0	0	17	0	0
10	5790640	.	T	G	9	6	15	0	0	15	0	0
10	5790866	.	A	C	4	6	10	0	0	10	0	0
10	5790913	.	A	C	8	6	14	0	0	14	0	0
10	5790922	.	C	A	7	5	12	0	2	14	0	0
10	5790956	.	C	G	1	7	8	0	5	13	0	0
10	5791030	.	A	G	9	13	22	0	1	23	0	0
10	5791044	.	C	T	1	14	15	0	12	27	0	0
10	5791184	.	G	A	10	8	18	0	2	20	0	0
10	5791224	.	C	G	7	12	19	0	1	20	0	0
10	5791238	.	A	G	7	10	17	0	2	19	0	0
10	5791377	.	A	T	7	10	17	0	4	21	0	0
10	5791387	.	G	A	8	15	23	0	1	24	0	0
10	5791417	.	C	T	1	10	11	0	11	22	0	0
10	5791743	.	A	T	5	2	7	0	0	7	0	0
10	5792512	.	A	T	8	10	18	0	1	19	0	0
10	5792533	.	A	T	4	8	12	0	2	14	0	0
10	5792573	.	G	A	5	7	12	0	0	12	0	0
10	5792584	.	A	G	5	6	11	0	1	12	0	0
10	5792615	.	A	G	5	3	8	0	0	8	0	0
10	5792667	.	G	A	7	9	16	0	1	17	0	0
10	5792722	.	T	C	10	0	10	0	9	19	0	0
10	5792757	.	A	G	8	5	13	0	1	14	0	0
10	5792845	.	T	C	4	4	8	0	0	8	0	0
10	5792864	.	C	T	5	2	7	0	0	7	0	0
10	5793197	.	G	A	2	4	6	0	0	6	0	0
10	5793210	.	A	G	3	1	4	0	0	4	0	0
10	5793863	.	A	G	4	4	8	0	1	9	0	0
10	5794423	.	C	G	4	8	12	0	0	12	0	0
10	5796929	.	C	T	0	3	3	0	11	14	0	0
10	5804114	.	C	A	3	6	9	0	0	9	0	0
10	5810738	.	C	G	4	6	10	0	0	10	0	0
10	5810739	.	T	G	4	6	10	0	0	10	0	0
10	5810895	.	A	G	2	9	11	0	1	12	0	0
10	5810940	.	A	G	2	5	7	0	0	7	0	0
10	5813696	.	A	G	6	3	9	0	0	9	0	0
10	5828645	.	A	G	10	3	13	0	0	13	0	0
10	5828660	.	A	G	10	4	14	0	0	14	0	0
10	5828704	.	C	A	1	9	10	0	5	15	0	0
10	5828840	.	A	G	4	3	7	0	0	7	0	0
10	5828945	.	A	G	6	7	13	0	0	13	0	0
10	5834171	.	C	T	7	6	13	0	1	14	0	0
10	5834242	.	G	A	4	5	9	0	2	11	0	0
10	5844718	.	G	A	8	8	16	0	0	16	0	0
10	5844763	.	A	G	7	5	12	0	1	13	0	0
10	5847731	.	A	T	2	6	8	0	0	8	0	0
10	5847821	.	G	T	7	3	10	0	1	11	0	0
10	5991093	.	T	C	1	2	3	0	1	4	0	0
10	5991924	.	C	A	2	2	4	0	0	4	0	0
10	6004615	.	C	A	3	6	9	0	1	10	0	0
10	6016242	.	G	A	5	4	9	0	0	9	0	0
10	6016545	.	G	T	6	4	10	0	1	11	0	0
10	6023750	.	A	G	4	4	8	0	0	8	0	0
10	6023946	.	T	C	5	5	10	0	0	10	0	0
10	6023958	.	G	A	8	6	14	0	0	14	0	0
10	6024159	.	A	T	3	7	10	0	0	10	0	0
10	6024248	.	G	C	6	4	10	0	0	10	0	0
10	6032880	.	A	G	6	0	6	0	6	12	0	0
10	6032886	.	G	A	4	6	10	0	1	11	0	0
10	6033452	.	T	C	1	5	6	0	0	6	0	0
10	6033469	.	A	C	1	6	7	0	1	8	0	0
10	6033612	.	G	A	2	9	11	0	6	17	0	0
10	6033627	.	A	T	5	10	15	0	0	15	0	0
10	6255082	.	C	T	5	6	11	0	0	11	0	0
10	6263593	.	G	A	3	6	9	0	0	9	0	0
10	6265475	.	A	G	4	4	8	0	0	8	0	0
10	6267255	.	C	T	2	2	4	0	0	4	0	0
10	6275517	.	G	A	5	6	11	0	0	11	0	0
10	6275577	.	C	T	5	3	8	0	0	8	0	0
10	6278202	.	A	G	8	4	12	0	0	12	0	0
10	6280939	.	G	A	0	5	5	0	7	12	0	0
10	6280948	.	G	A	2	6	8	0	3	11	0	0
10	6281946	.	A	G	8	0	8	0	5	13	0	0
10	6301828	.	C	T	11	9	20	0	1	21	0	0
10	6301930	.	C	T	7	9	16	0	1	17	0	0
10	6312954	.	A	T	7	5	12	0	0	12	0	0
10	6313643	.	C	T	4	7	11	0	0	11	0	0
10	6348571	.	C	A	12	6	18	2	2	22	0	0
10	6372501	.	C	T	9	14	23	0	0	23	0	0
10	6372915	.	G	A	8	12	20	0	0	20	0	0
10	6372964	.	T	C	10	10	20	0	0	20	0	0
10	6373003	.	T	C	5	6	11	0	1	12	0	0
10	6373079	.	C	G	7	4	11	0	0	11	0	0
10	6373332	.	A	T	4	5	9	0	0	9	0	0
10	6373336	.	C	G	4	5	9	0	1	10	0	0
10	6373378	.	A	C	4	6	10	0	0	10	0	0
10	6373472	.	T	A	6	4	10	0	0	10	0	0
10	6373522	.	A	T	2	8	10	0	0	13	3	0
10	6373524	.	A	G	5	8	13	0	0	13	0	0
10	6373614	.	A	G	4	4	8	0	0	8	0	0
10	6373622	.	A	G	5	5	10	0	0	10	0	0
10	6373708	.	A	G	15	0	15	0	5	20	0	0
10	6373758	.	A	C	9	11	20	0	1	21	0	0
10	6374017	.	A	G	14	10	24	0	1	25	0	0
10	6374041	.	A	T	18	6	24	0	1	25	0	0
10	6374068	.	G	T	17	6	23	0	2	25	0	0
10	6374235	.	T	C	13	16	29	0	0	29	0	0
10	6374279	.	G	A	0	15	15	0	16	31	0	0
10	6374352	.	C	T	11	16	27	0	1	28	0	0
10	6374486	.	A	G	8	7	15	0	0	15	0	0
10	6374501	.	A	G	6	8	14	0	1	15	0	0
10	6374573	.	A	T	4	12	16	0	1	18	1	0
10	6374597	.	A	G	12	10	22	0	0	22	0	0
10	6374615	.	T	C	12	12	24	0	2	26	0	0
10	6400925	.	A	T	2	2	4	0	0	4	0	0
10	6401577	.	A	C	3	3	6	0	0	6	0	0
10	6402213	.	T	A	4	3	7	0	3	10	0	0
10	6402593	.	G	A	3	2	5	1	5	11	0	0
10	6402658	.	G	A	0	4	4	1	4	9	0	0
10	6402660	.	C	G	3	0	3	1	5	9	0	0
10	6402742	.	C	G	2	4	6	0	0	6	0	0
10	6402993	.	A	G	1	3	4	0	0	4	0	0
10	6403019	.	A	T	1	2	3	0	0	3	0	0
10	6404358	.	T	A	3	3	6	0	0	6	0	0
10	6404377	.	A	C	3	3	6	0	0	6	0	0
10	6404764	.	G	C	4	5	9	0	0	9	0	0
10	6404899	.	G	T	1	5	6	0	0	6	0	0
10	6404900	.	G	T	1	5	6	0	0	6	0	0
10	6405275	.	A	T	5	2	7	0	0	7	0	0
10	6405321	.	A	G	3	5	8	0	1	9	0	0
10	6405897	.	T	A	2	3	5	0	0	5	0	0
10	6406093	.	A	G	2	0	2	0	3	5	0	0
10	6406635	.	C	T	2	3	5	0	0	5	0	0
10	6406677	.	A	G	5	4	9	0	0	9	0	0
10	6407449	.	C	T	6	5	11	0	0	11	0	0
10	6407475	.	G	A	0	4	4	0	7	11	0	0
10	6407559	.	A	T	5	6	11	0	0	11	0	0
10	6407605	.	C	A	5	4	9	0	0	9	0	0
10	6407764	.	C	A	2	7	9	1	1	11	0	0
10	6407833	.	T	C	5	5	10	3	0	13	0	0
10	6407871	.	A	G	4	4	8	3	0	11	0	0
10	6407904	.	C	T	4	2	6	0	0	6	0	0
10	6408955	.	T	G	10	0	10	0	5	15	0	0
10	6408986	.	A	G	11	4	15	0	1	16	0	0
10	6409095	.	G	A	1	7	8	0	7	15	0	0
10	6409120	.	G	A	7	4	11	0	0	11	0	0
10	6409379	.	A	G	6	5	11	0	0	11	0	0
10	6409448	.	C	T	2	6	8	0	0	8	0	0
10	6409455	.	T	A	6	2	8	0	0	8	0	0
10	6409506	.	A	G	6	8	14	0	0	14	0	0
10	6409583	.	C	T	5	3	8	0	1	9	0	0
10	6473199	.	A	G	1	7	8	0	0	8	0	0
10	6473544	.	T	C	16	14	30	0	0	30	0	0
10	6473685	.	T	C	8	8	16	0	2	18	0	0
10	6473704	.	C	G	12	10	22	0	0	22	0	0
10	6473851	.	A	G	15	8	23	0	0	23	0	0
10	6473862	.	C	T	1	9	10	0	13	23	0	0
10	6473908	.	A	G	14	7	21	0	1	22	0	0
10	6473996	.	T	C	8	18	26	0	0	26	0	0
10	6474057	.	T	A	10	9	19	0	3	22	0	0
10	6479444	.	T	C	10	0	10	0	18	28	0	0
10	6479471	.	C	T	1	13	14	0	11	25	0	0
10	6510756	.	T	C	19	29	48	0	2	51	1	0
10	6510786	.	T	G	30	25	55	0	0	55	0	0
10	6510825	.	T	C	31	28	59	0	1	60	0	0
10	6517593	.	T	A	27	29	56	0	0	56	0	0
10	6517663	.	A	G	20	3	23	0	23	46	0	0
10	6517726	.	C	T	18	19	37	0	1	38	0	0
10	6517959	.	A	G	25	11	36	0	2	38	0	0
10	6521596	.	T	C	2	2	4	0	0	4	0	0
10	6522267	.	A	T	3	8	11	0	0	11	0	0
10	6531002	.	A	G	8	8	16	0	0	16	0	0
10	6531297	.	T	C	7	5	12	0	1	13	0	0
10	6533850	.	T	A	6	8	14	0	0	14	0	0
10	6546851	.	A	G	6	6	12	0	1	13	0	0
10	6546929	.	C	A	0	5	5	0	4	9	0	0
10	6549360	.	C	T	2	2	4	0	0	4	0	0
10	6566670	.	C	T	0	3	3	0	4	7	0	0
10	6578070	.	A	G	7	2	9	0	0	9	0	0
10	6578252	.	T	C	2	3	5	0	0	5	0	0
10	6587088	.	T	A	3	2	5	0	1	6	0	0
10	6781239	.	G	A	9	6	15	0	0	15	0	0
10	6781278	.	T	A	5	8	13	0	0	13	0	0
10	6781286	.	G	T	5	8	13	0	0	13	0	0
10	6781362	.	G	A	14	12	26	0	0	26	0	0
10	6781372	.	T	A	16	14	30	0	2	32	0	0
10	6781450	.	T	C	14	13	27	0	1	28	0	0
10	6781506	.	A	T	10	13	23	0	0	23	0	0
10	6781664	.	A	T	9	10	19	0	2	21	0	0
10	6781742	.	G	T	8	10	18	0	0	18	0	0
10	6781786	.	A	T	5	4	9	0	0	9	0	0
10	6781867	.	C	A	8	13	21	0	0	21	0	0
10	6781903	.	T	G	8	12	20	0	0	20	0	0
10	6781918	.	A	T	9	8	17	0	0	17	0	0
10	6782020	.	G	C	6	13	19	0	0	19	0	0
10	6782036	.	T	C	6	0	6	0	10	16	0	0
10	6782220	.	A	G	4	5	9	2	0	11	0	0
10	6782454	.	C	G	12	15	27	0	1	28	0	0
10	6782489	.	T	G	10	18	28	0	1	29	0	0
10	6782624	.	A	G	19	21	40	0	0	40	0	0
10	6782636	.	T	A	15	21	36	0	5	41	0	0
10	6782664	.	A	G	22	20	42	0	1	43	0	0
10	6786326	.	C	T	2	22	24	0	18	42	0	0
10	6786564	.	A	G	14	20	34	0	2	36	0	0
10	6804756	.	T	C	10	0	10	0	10	20	0	0
10	6824761	.	A	C	10	15	25	0	0	25	0	0
10	6824845	.	A	T	12	15	27	0	1	28	0	0
10	6824877	.	T	G	15	12	27	0	1	28	0	0
10	6831298	.	C	T	1	4	5	0	8	13	0	0
10	6831446	.	T	C	3	5	8	0	0	8	0	0
10	6834065	.	A	T	6	10	16	0	0	16	0	0
10	6834341	.	G	A	19	9	28	0	0	28	0	0
10	6834380	.	C	A	2	6	8	1	12	21	0	0
10	6846904	.	A	G	7	5	12	0	1	13	0	0
10	6851184	.	C	A	8	8	16	0	0	16	0	0
10	6853641	.	A	G	10	15	25	0	1	26	0	0
10	6925193	.	G	T	1	2	3	0	0	3	0	0
10	6933802	.	G	A	5	2	7	0	0	7	0	0
10	6936471	.	G	A	1	4	5	0	4	9	0	0
10	6944079	.	T	G	3	0	3	0	2	5	0	0
10	6944334	.	C	A	3	2	5	0	0	5	0	0
10	7210001	.	G	A	3	35	38	0	26	64	0	0
10	7221810	.	A	G	19	22	41	0	2	43	0	0
10	7222213	.	T	C	22	24	46	0	1	47	0	0
10	7224964	.	A	G	18	31	49	0	0	49	0	0
10	7231728	.	T	C	25	20	45	0	2	47	0	0
10	7231821	.	T	A	25	23	48	0	3	51	0	0
10	7231964	.	G	C	28	18	46	0	0	46	0	0
10	7232043	.	T	A	22	16	38	0	1	39	0	0
10	7232058	.	G	T	2	15	17	0	21	38	0	0
10	7232104	.	A	T	22	13	35	0	1	36	0	0
10	7232309	.	C	T	13	10	23	0	1	24	0	0
10	7232416	.	T	C	25	16	41	0	0	41	0	0
10	7232420	.	T	C	25	16	41	0	0	41	0	0
10	7233038	.	T	C	23	17	40	0	0	40	0	0
10	7233218	.	A	G	30	21	51	0	4	55	0	0
10	7233440	.	A	T	38	26	64	0	1	65	0	0
10	7233457	.	C	G	36	23	59	0	3	62	0	0
10	7233518	.	T	C	28	20	48	0	3	51	0	0
10	7233854	.	A	T	14	14	28	0	4	32	0	0
10	7233939	.	C	T	8	4	12	0	0	12	0	0
10	7284182	.	T	A	4	8	12	0	0	12	0	0
10	7284403	.	C	T	6	5	11	0	0	11	0	0
10	7284520	.	A	G	3	9	12	0	0	12	0	0
10	7284556	.	T	A	4	8	12	1	0	13	0	0
10	7284629	.	T	C	5	12	17	0	0	17	0	0
10	7311979	.	G	A	4	4	8	0	0	8	0	0
10	7311997	.	T	G	6	4	10	0	0	10	0	0
10	7312057	.	A	G	9	7	16	1	0	17	0	0
10	7347192	.	C	A	0	4	4	0	6	10	0	0
10	7483649	.	G	C	3	0	3	0	6	9	0	0
10	7483671	.	A	G	7	4	11	0	0	11	0	0
10	7483708	.	T	A	7	2	9	0	0	9	0	0
10	7483713	.	G	A	8	2	10	0	0	10	0	0
10	7493909	.	C	T	1	2	3	0	0	3	0	0
10	7498961	.	A	T	1	2	3	0	0	3	0	0
10	7508077	.	T	C	4	5	9	0	1	10	0	0
10	7533759	.	C	T	2	3	5	0	0	5	0	0
10	7551431	.	T	A	1	3	4	0	1	5	0	0
10	7551444	.	G	T	2	3	5	0	0	5	0	0
10	7564294	.	C	T	10	8	18	0	3	21	0	0
10	7593246	.	A	T	12	15	27	2	2	31	0	0
10	7593349	.	C	A	21	17	38	0	2	40	0	0
10	7617113	.	A	T	26	32	58	0	2	60	0	0
10	7617126	.	T	C	26	30	56	0	1	57	0	0
10	7617242	.	G	A	23	34	57	0	2	59	0	0
10	7617327	.	A	C	19	21	40	0	17	57	0	0
10	7617350	.	A	T	19	37	56	0	10	66	0	0
10	7617636	.	A	G	11	2	13	0	22	35	0	0
10	7629422	.	C	T	1	3	4	0	0	4	0	0
10	7629453	.	T	C	3	2	5	0	0	5	0	0
10	7635245	.	C	T	4	3	7	0	0	7	0	0
10	7640501	.	C	T	18	23	41	0	1	42	0	0
10	7640676	.	G	A	18	17	35	0	0	35	0	0
10	7653663	.	C	T	0	3	3	0	2	5	0	0
10	7653750	.	T	C	4	0	4	0	3	7	0	0
10	7658603	.	C	T	2	2	4	0	0	4	0	0
10	7671368	.	T	C	6	8	14	0	1	15	0	0
10	7671425	.	G	A	6	6	12	0	0	12	0	0
10	7672832	.	A	C	12	7	19	0	0	19	0	0
10	7672853	.	G	A	9	6	15	0	0	15	0	0
10	7673819	.	C	G	3	7	10	0	0	10	0	0
10	7673849	.	A	G	2	4	6	0	0	6	0	0
10	7673887	.	C	G	1	2	3	0	0	3	0	0
10	7673896	.	T	C	1	2	3	0	0	3	0	0
10	7674079	.	T	G	4	5	9	0	1	10	0	0
10	7674136	.	C	T	2	3	5	0	1	6	0	0
10	7674393	.	C	T	1	2	3	0	1	4	0	0
10	7674429	.	C	T	2	2	4	0	0	4	0	0
10	7674506	.	A	G	8	7	15	0	0	15	0	0
10	7678121	.	T	C	8	14	22	0	3	25	0	0
10	7678154	.	C	T	1	9	10	0	9	19	0	0
10	7678525	.	C	T	2	8	10	0	14	24	0	0
10	7696900	.	G	A	5	6	11	1	1	13	0	0
10	7700564	.	T	G	9	7	16	0	0	16	0	0
10	7700615	.	A	G	13	7	20	0	1	21	0	0
10	7700676	.	G	A	14	10	24	0	0	24	0	0
10	7701852	.	A	C	12	1	13	0	13	26	0	0
10	7704413	.	A	G	5	4	9	0	0	9	0	0
10	7704436	.	G	A	1	5	6	0	6	12	0	0
10	7704484	.	C	A	6	4	10	0	0	11	1	0
10	7704490	.	G	A	7	4	11	0	0	11	0	0
10	7704548	.	C	T	5	9	14	0	0	14	0	0
10	7705560	.	G	A	0	4	4	0	2	6	0	0
10	7709761	.	T	C	12	8	20	0	0	20	0	0
10	7709975	.	A	G	3	12	15	0	0	15	0	0
10	7709978	.	T	C	3	11	14	0	0	14	0	0
10	7712180	.	T	A	10	6	16	0	0	16	0	0
10	7712206	.	G	A	9	5	14	0	0	14	0	0
10	7712228	.	C	T	5	7	12	0	0	12	0	0
10	7713924	.	A	G	10	0	10	0	10	20	0	0
10	7721459	.	A	G	8	10	18	0	0	18	0	0
10	7721746	.	G	A	8	9	17	0	3	20	0	0
10	7722595	.	A	G	5	7	12	0	3	15	0	0
10	7722936	.	C	T	2	3	5	0	1	6	0	0
10	7723004	.	T	C	2	5	7	1	0	8	0	0
10	7723061	.	C	A	6	7	13	0	0	13	0	0
10	7723157	.	A	G	5	17	22	0	0	22	0	0
10	7723218	.	T	C	6	13	19	0	2	21	0	0
10	7723275	.	C	A	4	18	22	0	1	24	1	0
10	7723337	.	C	G	4	4	8	0	0	8	0	0
10	7727393	.	T	C	6	4	10	0	0	10	0	0
10	7727505	.	T	A	2	4	6	0	0	6	0	0
10	7727571	.	G	C	6	2	8	0	0	8	0	0
10	7727598	.	A	T	6	5	11	0	0	11	0	0
10	7727704	.	T	A	6	3	9	0	0	9	0	0
10	7734316	.	T	G	3	3	6	0	0	6	0	0
10	7734401	.	G	A	6	9	15	0	1	16	0	0
10	7734465	.	C	T	12	6	18	0	0	18	0	0
10	7770200	.	A	G	2	3	5	0	0	5	0	0
10	7770201	.	G	A	2	3	5	0	0	5	0	0
10	7770425	.	T	C	1	1	2	0	4	6	0	0
10	7770467	.	C	T	0	6	6	0	1	7	0	0
10	7771039	.	G	A	1	3	4	0	0	4	0	0
10	7771634	.	T	A	2	2	4	0	0	4	0	0
10	7771735	.	A	C	1	3	4	0	0	4	0	0
10	7771769	.	C	T	4	4	8	0	0	8	0	0
10	7771778	.	G	A	4	4	8	0	0	8	0	0
10	7772272	.	C	T	6	6	12	0	1	13	0	0
10	7810461	.	A	T	22	21	43	0	3	46	0	0
10	7810565	.	G	A	22	21	43	0	0	43	0	0
10	7811062	.	T	A	8	7	15	0	3	18	0	0
10	7811075	.	T	C	8	6	14	0	0	14	0	0
10	7811935	.	A	G	23	15	38	0	1	39	0	0
10	7815118	.	G	A	20	20	40	0	1	41	0	0
10	7815187	.	G	A	22	21	43	0	1	44	0	0
10	7843465	.	A	G	8	4	12	0	0	12	0	0
10	7847200	.	C	T	3	5	8	0	1	9	0	0
10	7850682	.	T	G	7	3	10	0	0	10	0	0
10	7850804	.	C	A	4	2	6	0	0	6	0	0
10	7901065	.	T	G	3	2	5	0	0	5	0	0
10	7901066	.	G	T	3	2	5	0	0	5	0	0
10	7901226	.	G	A	3	3	6	0	0	6	0	0
10	7901261	.	G	C	2	3	5	0	0	5	0	0
10	7901276	.	A	T	3	2	5	0	0	5	0	0
10	7901673	.	T	C	3	1	4	0	0	4	0	0
10	7901700	.	A	G	1	2	3	0	0	3	0	0
10	7901754	.	T	A	3	4	7	0	0	7	0	0
10	7902300	.	C	T	4	5	9	0	0	9	0	0
10	7909269	.	C	A	5	8	13	0	0	13	0	0
10	7909665	.	T	A	4	6	10	0	0	10	0	0
10	7916836	.	A	C	6	11	17	0	1	18	0	0
10	7916930	.	C	A	7	8	15	0	0	15	0	0
10	7917036	.	A	T	7	15	22	0	0	22	0	0
10	7917114	.	T	C	10	15	25	0	0	25	0	0
10	7917411	.	C	A	0	10	10	0	13	23	0	0
10	7917483	.	C	A	7	8	15	0	0	15	0	0
10	7917551	.	A	G	14	13	27	0	1	28	0	0
10	7917592	.	T	C	21	11	32	0	1	33	0	0
10	7917686	.	T	C	18	17	35	0	0	35	0	0
10	7917690	.	A	T	17	17	34	0	2	36	0	0
10	7920910	.	T	G	18	22	40	0	1	41	0	0
10	7920913	.	C	T	19	20	39	0	1	40	0	0
10	7922210	.	G	T	14	15	29	0	0	29	0	0
10	7922294	.	C	A	12	14	26	0	1	27	0	0
10	7926899	.	A	G	18	14	32	0	4	36	0	0
10	7929647	.	T	C	13	0	13	0	7	20	0	0
10	7936283	.	T	G	15	22	37	0	1	38	0	0
10	7938629	.	C	T	13	16	29	0	4	33	0	0
10	7938659	.	A	G	18	15	33	0	0	33	0	0
10	7938683	.	T	C	17	14	31	0	1	32	0	0
10	7959655	.	T	A	11	14	25	0	0	25	0	0
10	7968160	.	G	T	3	3	6	0	1	7	0	0
10	7968274	.	G	T	5	12	17	0	0	17	0	0
10	7984677	.	A	T	27	12	39	0	4	43	0	0
10	7986217	.	T	C	17	17	34	0	2	36	0	0
10	7986307	.	C	T	3	19	22	0	23	45	0	0
10	7986432	.	C	T	1	16	17	0	26	43	0	0
10	7989162	.	T	G	5	3	8	0	0	8	0	0
10	7989237	.	G	A	6	6	12	0	0	12	0	0
10	7989287	.	G	A	10	8	18	0	1	19	0	0
10	7989348	.	C	T	9	7	16	0	0	16	0	0
10	7989576	.	C	T	6	14	20	0	1	21	0	0
10	7992197	.	T	C	16	15	31	0	0	31	0	0
10	7996021	.	G	A	6	6	12	0	1	13	0	0
10	8001365	.	A	G	5	7	12	0	0	12	0	0
10	8005785	.	T	A	11	8	19	0	1	20	0	0
10	8005845	.	C	A	1	8	9	0	6	15	0	0
10	8009996	.	A	C	7	5	12	0	1	13	0	0
10	8010064	.	A	G	7	3	10	0	0	10	0	0
10	8032838	.	G	A	6	8	14	0	0	14	0	0
10	8032910	.	C	T	0	5	5	0	6	11	0	0
10	8033224	.	T	A	3	2	5	0	0	5	0	0
10	8033259	.	C	T	5	4	9	0	0	9	0	0
10	8033425	.	T	C	4	3	7	0	0	7	0	0
10	8034855	.	C	T	1	2	3	0	0	3	0	0
10	8035262	.	C	T	0	2	2	0	6	8	0	0
10	8035384	.	G	A	2	2	4	0	1	5	0	0
10	8035510	.	C	T	1	3	4	0	3	7	0	0
10	8035604	.	C	T	0	3	3	0	4	7	0	0
10	8036259	.	T	C	2	4	6	0	0	6	0	0
10	8036813	.	C	T	1	2	3	0	1	4	0	0
10	8036839	.	G	A	3	4	7	0	0	7	0	0
10	8037351	.	C	T	2	6	8	0	0	8	0	0
10	8037395	.	A	T	1	3	4	0	0	4	0	0
10	8037425	.	A	G	1	3	4	0	0	4	0	0
10	8037619	.	C	T	4	2	6	0	0	6	0	0
10	8037620	.	C	G	5	2	7	0	0	7	0	0
10	8037820	.	A	T	6	4	10	0	0	10	0	0
10	8037866	.	T	G	4	6	10	0	0	10	0	0
10	8040536	.	T	C	4	8	12	0	0	12	0	0
10	8041806	.	T	C	1	3	4	0	0	4	0	0
10	8041874	.	C	T	3	4	7	0	0	7	0	0
10	8097929	.	C	G	21	13	34	0	0	34	0	0
10	8154892	.	C	T	4	5	9	0	0	9	0	0
10	8160813	.	T	G	6	5	11	0	1	12	0	0
10	8160888	.	G	A	7	3	10	0	1	11	0	0
10	8160891	.	T	C	9	0	9	0	5	14	0	0
10	8161027	.	A	G	4	6	10	0	0	10	0	0
10	8163440	.	G	A	7	10	17	0	1	18	0	0
10	8170083	.	C	A	3	3	6	0	0	6	0	0
10	8170468	.	C	A	0	3	3	0	2	5	0	0
10	8175056	.	G	T	2	6	8	0	1	9	0	0
10	8175123	.	T	C	2	2	4	0	1	5	0	0
10	8175164	.	C	A	6	6	12	0	0	12	0	0
10	8190734	.	C	T	3	6	9	0	0	9	0	0
10	8190849	.	A	T	3	2	5	0	0	5	0	0
10	8195186	.	T	C	4	2	6	0	0	6	0	0
10	8196965	.	C	A	4	4	8	0	0	8	0	0
10	8208610	.	G	A	5	5	10	1	2	13	0	0
10	8213224	.	C	T	3	4	7	0	1	8	0	0
10	8213229	.	G	A	3	4	7	0	1	8	0	0
10	8213765	.	T	C	3	5	8	0	0	8	0	0
10	8217056	.	T	C	2	4	6	0	0	6	0	0
10	8235946	.	A	G	3	0	3	0	5	8	0	0
10	8236775	.	T	C	10	4	14	0	0	14	0	0
10	8239318	.	T	C	10	8	18	0	0	18	0	0
10	8263045	.	G	A	7	14	21	0	1	22	0	0
10	8263081	.	T	C	8	8	16	0	3	19	0	0
10	8263919	.	C	T	8	4	12	0	0	12	0	0
10	8265940	.	A	G	3	2	5	0	0	5	0	0
10	8266383	.	A	G	16	12	28	0	1	29	0	0
10	8269377	.	G	A	19	9	28	0	0	28	0	0
10	8278160	.	T	C	6	12	18	0	1	19	0	0
10	8278214	.	A	G	9	10	19	0	1	20	0	0
10	8288983	.	A	G	5	5	10	0	0	10	0	0
10	8295026	.	C	T	1	10	11	0	7	18	0	0
10	8295196	.	T	G	7	14	21	0	0	21	0	0
10	8295295	.	C	A	1	12	13	0	12	25	0	0
10	8306677	.	G	C	2	2	4	0	0	4	0	0
10	8335315	.	T	C	2	4	6	0	0	6	0	0
10	8335402	.	A	G	2	2	4	0	1	5	0	0
10	8357833	.	G	A	1	3	4	0	0	4	0	0
10	8358229	.	A	T	2	2	4	0	0	4	0	0
10	8358277	.	A	T	2	2	4	0	0	4	0	0
10	8358339	.	A	G	1	2	3	0	1	4	0	0
10	8418671	.	A	G	7	3	10	0	0	10	0	0
10	8426531	.	T	C	4	0	4	0	2	6	0	0
10	8427796	.	T	G	5	4	9	0	0	9	0	0
10	8434492	.	T	C	2	0	2	0	5	7	0	0
10	8434530	.	T	A	2	4	6	0	0	6	0	0
10	8434677	.	A	T	2	6	8	0	0	8	0	0
10	8437947	.	T	C	9	6	15	0	0	15	0	0
10	8450742	.	G	T	0	2	2	0	4	6	0	0
10	8468942	.	A	C	11	4	15	0	0	15	0	0
10	8571191	.	A	C	2	2	4	0	0	4	0	0
10	8575951	.	T	C	4	2	6	0	0	6	0	0
10	8629373	.	T	C	12	5	17	0	1	18	0	0
10	8629496	.	T	C	9	6	15	0	1	16	0	0
10	8629847	.	A	G	8	0	8	0	13	21	0	0
10	8630402	.	G	T	1	11	12	0	14	26	0	0
10	8630428	.	A	G	16	8	24	0	0	24	0	0
10	8630452	.	G	T	17	9	26	0	0	26	0	0
10	8630527	.	G	A	11	11	22	0	0	22	0	0
10	8630618	.	C	T	5	10	15	0	0	15	0	0
10	8630631	.	T	C	4	11	15	0	0	15	0	0
10	8630702	.	T	C	8	9	17	0	1	18	0	0
10	8630914	.	A	G	1	3	4	0	0	4	0	0
10	8631135	.	A	G	7	5	12	0	0	12	0	0
10	8631152	.	A	T	8	6	14	0	0	14	0	0
10	8660722	.	C	T	15	12	27	0	1	28	0	0
10	8670139	.	G	A	10	14	24	0	0	24	0	0
10	8819572	.	C	A	2	4	6	0	0	6	0	0
10	8825313	.	A	G	2	2	4	0	0	4	0	0
10	8825349	.	G	A	1	2	3	0	1	4	0	0
10	8828537	.	G	A	4	4	8	0	0	8	0	0
10	8828580	.	G	A	0	3	3	0	4	7	0	0
10	8829791	.	T	C	2	4	6	0	0	6	0	0
10	8829937	.	C	T	3	4	7	0	0	7	0	0
10	8832344	.	A	G	2	3	5	0	0	5	0	0
10	8835272	.	A	T	5	5	10	0	0	10	0	0
10	8838030	.	C	A	1	4	5	0	0	5	0	0
10	8838092	.	C	A	2	2	4	0	0	4	0	0
10	8840343	.	A	G	2	2	4	0	1	5	0	0
10	8950055	.	G	A	10	3	13	0	0	13	0	0
10	8950108	.	A	G	6	4	10	0	1	11	0	0
10	8952601	.	A	G	2	2	4	0	0	4	0	0
10	8955356	.	C	A	5	2	7	0	0	7	0	0
10	8970757	.	T	C	4	2	6	0	0	6	0	0
10	8976417	.	G	A	2	2	4	0	0	4	0	0
10	9006634	.	T	C	10	15	25	0	0	25	0	0
10	9089524	.	A	C	4	1	5	0	8	13	0	0
10	9089569	.	T	A	11	11	22	0	1	23	0	0
10	9089602	.	T	C	9	0	9	0	12	21	0	0
10	9164807	.	T	C	10	9	19	0	1	20	0	0
10	9165056	.	T	C	6	6	12	0	0	12	0	0
10	9168991	.	C	T	8	6	14	0	0	14	0	0
10	9173473	.	A	G	7	9	16	0	0	16	0	0
10	9173485	.	G	T	1	8	9	0	5	14	0	0
10	9177363	.	T	C	13	10	23	0	1	24	0	0
10	9181508	.	T	A	9	10	19	0	3	22	0	0
10	9184326	.	T	A	5	5	10	0	0	10	0	0
10	9184533	.	C	T	8	13	21	0	1	22	0	0
10	9209311	.	A	T	1	4	5	0	0	5	0	0
10	9234236	.	T	C	1	2	3	0	0	3	0	0
10	9234390	.	T	G	1	0	1	0	2	3	0	0
10	9234742	.	G	A	0	3	3	0	1	4	0	0
10	9255670	.	G	A	1	6	7	0	1	8	0	0
10	9269228	.	G	A	2	13	15	0	0	15	0	0
10	9305277	.	G	A	7	2	9	0	0	9	0	0
10	9305433	.	A	G	6	9	15	0	0	15	0	0
10	9305534	.	A	C	11	3	14	0	1	15	0	0
10	9305543	.	C	T	9	5	14	0	0	14	0	0
10	9308057	.	C	T	8	3	11	0	0	11	0	0
10	9308092	.	G	A	3	10	13	0	3	16	0	0
10	9308133	.	G	A	6	8	14	0	0	14	0	0
10	9346253	.	T	A	5	3	8	0	0	8	0	0
10	9347928	.	C	G	5	1	6	0	6	12	0	0
10	9361037	.	C	T	7	7	14	0	0	14	0	0
10	9361891	.	G	A	7	7	14	0	0	14	0	0
10	9361924	.	G	C	4	2	6	0	0	6	0	0
10	9369466	.	A	G	5	2	7	0	0	7	0	0
10	9370274	.	G	A	6	6	12	0	1	13	0	0
10	9370755	.	A	G	5	2	7	0	0	7	0	0
10	9388921	.	A	G	2	2	4	0	1	5	0	0
10	9390726	.	C	T	6	5	11	0	0	11	0	0
10	9395012	.	C	T	2	7	9	0	0	9	0	0
10	9419821	.	G	A	9	11	20	0	2	22	0	0
10	9419901	.	T	A	12	6	18	0	0	18	0	0
10	9419902	.	A	G	12	6	18	0	0	18	0	0
10	9595693	.	C	T	8	5	13	0	0	13	0	0
10	9595832	.	C	T	7	3	10	0	0	10	0	0
10	9601813	.	T	C	4	2	6	0	2	8	0	0
10	9610268	.	T	C	1	4	5	0	0	5	0	0
10	9612572	.	T	A	11	5	16	0	0	16	0	0
10	9618055	.	G	A	1	5	6	0	7	13	0	0
10	9618295	.	G	A	5	4	9	0	0	9	0	0
10	9626934	.	A	T	4	4	8	0	0	8	0	0
10	9626988	.	C	T	7	3	10	0	1	11	0	0
10	9627603	.	T	C	3	7	10	0	0	10	0	0
10	9628988	.	A	G	12	7	19	0	0	19	0	0
10	9632265	.	G	A	0	11	11	0	9	20	0	0
10	9632336	.	A	G	11	0	11	0	14	25	0	0
10	9638888	.	A	G	12	6	18	0	0	18	0	0
10	9639172	.	T	C	9	10	19	0	0	19	0	0
10	9642674	.	T	A	9	8	17	0	1	18	0	0
10	9642832	.	T	G	4	0	4	0	7	11	0	0
10	9644669	.	T	C	2	3	5	4	0	9	0	0
10	9697243	.	C	A	11	8	19	0	0	19	0	0
10	9697270	.	A	T	8	9	17	0	0	17	0	0
10	9701905	.	C	T	15	11	26	0	3	29	0	0
10	9714771	.	T	C	14	14	28	0	0	28	0	0
10	9714801	.	C	T	9	10	19	0	0	19	0	0
10	9714819	.	A	G	5	11	16	0	0	16	0	0
10	9729611	.	G	A	1	16	17	0	16	33	0	0
10	9771749	.	G	T	1	9	10	0	6	16	0	0
10	9776699	.	C	T	16	13	29	0	1	30	0	0
10	9781455	.	G	A	23	11	34	0	1	35	0	0
10	9781509	.	G	A	14	22	36	0	2	38	0	0
10	9784087	.	C	T	20	18	38	0	2	40	0	0
10	9784238	.	G	A	4	21	25	0	26	51	0	0
10	9789262	.	C	T	27	20	47	0	0	47	0	0
10	9800719	.	G	T	21	22	43	0	0	43	0	0
10	9802771	.	T	C	19	17	36	0	2	38	0	0
10	9802804	.	C	T	20	9	29	0	0	29	0	0
10	9806731	.	A	G	10	2	12	0	21	33	0	0
10	9807014	.	T	G	16	15	31	1	2	34	0	0
10	9807203	.	G	A	22	13	35	0	0	35	0	0
10	9836923	.	A	G	1	2	3	0	0	3	0	0
10	9837027	.	T	C	4	3	7	0	0	7	0	0
10	9837191	.	A	G	6	7	13	0	1	14	0	0
10	9846240	.	A	G	13	11	24	0	2	26	0	0
10	9846261	.	G	A	11	9	20	0	0	20	0	0
10	9846285	.	T	G	7	7	14	0	2	16	0	0
10	9846602	.	C	G	0	8	8	0	13	21	0	0
10	9856390	.	T	C	6	0	6	0	11	17	0	0
10	9861038	.	A	T	9	8	17	0	1	18	0	0
10	9861103	.	G	T	5	9	14	0	2	16	0	0
10	9895348	.	G	A	8	13	21	0	2	23	0	0
10	9899215	.	G	T	10	12	22	0	1	23	0	0
10	9899302	.	G	A	9	12	21	0	0	21	0	0
10	9899308	.	G	A	13	7	20	0	0	20	0	0
10	9961471	.	A	T	19	12	31	0	2	33	0	0
10	10254913	.	G	A	1	11	12	0	5	17	0	0
10	10261887	.	G	C	9	14	23	0	0	23	0	0
10	10261893	.	C	A	9	15	24	0	1	25	0	0
10	10262013	.	T	C	5	7	12	0	2	14	0	0
10	10262157	.	A	G	7	7	14	0	2	16	0	0
10	10269930	.	T	C	10	11	21	0	0	21	0	0
10	10317392	.	A	T	7	8	15	0	1	16	0	0
10	10325451	.	T	C	12	5	17	0	2	19	0	0
10	10380074	.	G	A	2	2	4	0	0	4	0	0
10	10494897	.	A	G	1	2	3	0	0	3	0	0
10	10535877	.	C	T	2	4	6	0	0	6	0	0
10	10535884	.	C	A	2	3	5	0	0	5	0	0
10	10561156	.	T	A	2	3	5	0	0	5	0	0
10	10561353	.	A	G	1	0	1	0	2	3	0	0
10	10567262	.	A	G	6	2	8	0	0	8	0	0
10	10636263	.	A	G	11	7	18	0	1	19	0	0
10	10636283	.	T	C	10	9	19	0	0	19	0	0
10	10636330	.	A	G	6	8	14	0	1	15	0	0
10	10636558	.	A	T	8	7	15	1	0	16	0	0
10	10636799	.	C	A	6	3	9	0	0	9	0	0
10	10636896	.	G	A	1	8	9	0	9	18	0	0
10	10636946	.	A	G	11	12	23	0	1	24	0	0
10	10880349	.	T	C	1	2	3	0	0	3	0	0
10	11267530	.	C	A	8	5	13	0	0	13	0	0
10	11276479	.	C	T	5	8	13	0	0	13	0	0
10	11279555	.	G	A	13	6	19	0	0	19	0	0
10	11280118	.	C	T	13	7	20	0	1	21	0	0
10	11280146	.	C	T	11	10	21	0	0	21	0	0
10	11280834	.	A	C	1	2	3	0	0	3	0	0
10	11280839	.	G	C	1	2	3	0	0	3	0	0
10	11280878	.	A	G	2	3	5	0	0	5	0	0
10	11280942	.	A	G	1	0	1	0	3	4	0	0
10	11280999	.	A	G	3	1	4	0	0	4	0	0
10	11281005	.	T	C	2	2	4	0	0	4	0	0
10	11281148	.	G	A	3	4	7	0	0	7	0	0
10	11281492	.	G	A	4	2	6	0	0	6	0	0
10	11282020	.	C	T	3	2	5	0	0	5	0	0
10	11282055	.	A	G	2	3	5	0	0	5	0	0
10	11282072	.	G	A	2	3	5	0	0	5	0	0
10	11282194	.	A	G	5	4	9	0	0	9	0	0
10	11282933	.	T	A	5	20	25	0	0	25	0	0
10	11286830	.	C	T	8	9	17	0	0	17	0	0
10	11298651	.	G	A	3	4	7	0	0	7	0	0
10	11298652	.	A	C	3	4	7	0	0	7	0	0
10	11298852	.	G	A	7	6	13	0	0	13	0	0
10	11298864	.	A	G	9	3	12	0	0	12	0	0
10	11298955	.	T	C	4	5	9	0	0	9	0	0
10	11298975	.	C	T	4	6	10	0	0	10	0	0
10	11299042	.	G	A	4	4	8	0	0	8	0	0
10	11309859	.	C	G	6	0	6	0	6	12	0	0
10	11310041	.	G	A	6	6	12	0	0	12	0	0
10	11310500	.	G	A	4	6	10	0	0	10	0	0
10	11310501	.	C	A	3	6	9	0	0	9	0	0
10	11310618	.	A	C	6	3	9	0	0	9	0	0
10	11310648	.	G	A	4	4	8	0	0	8	0	0
10	11310682	.	G	A	3	2	5	0	0	5	0	0
10	11322985	.	T	C	9	10	19	0	1	20	0	0
10	11323032	.	G	A	13	7	20	0	0	20	0	0
10	11323092	.	G	A	9	5	14	0	1	15	0	0
10	11327364	.	A	G	1	4	5	0	0	5	0	0
10	11327429	.	G	A	5	2	7	0	0	7	0	0
10	11327466	.	G	A	7	3	10	0	0	10	0	0
10	11327484	.	C	T	1	3	4	0	6	10	0	0
10	11328246	.	G	C	10	8	18	0	1	19	0	0
10	11328263	.	G	A	11	6	17	0	0	17	0	0
10	11331922	.	C	T	1	5	6	0	8	14	0	0
10	11332206	.	A	G	11	5	16	0	0	16	0	0
10	11334397	.	T	C	5	0	5	0	8	13	0	0
10	11334415	.	C	A	1	6	7	0	7	14	0	0
10	11334547	.	A	G	6	4	10	0	0	10	0	0
10	11339235	.	G	A	11	12	23	0	0	23	0	0
10	11339319	.	C	T	1	7	8	0	9	17	0	0
10	11343169	.	C	T	14	4	18	0	0	18	0	0
10	11347909	.	A	G	10	7	17	0	1	18	0	0
10	11347929	.	T	G	9	9	18	0	0	18	0	0
10	11359991	.	A	G	11	1	12	0	14	26	0	0
10	11362275	.	C	T	20	23	43	0	0	43	0	0
10	11368116	.	G	T	12	6	18	0	0	18	0	0
10	11398168	.	T	G	5	0	5	0	8	13	0	0
10	11399574	.	C	T	9	3	12	0	0	12	0	0
10	11403954	.	T	C	3	5	8	0	0	8	0	0
10	11769166	.	G	A	2	3	5	0	0	5	0	0
10	11790947	.	T	C	12	12	24	0	2	26	0	0
10	11805601	.	T	C	7	7	14	0	2	16	0	0
10	11809444	.	A	G	13	11	24	0	1	25	0	0
10	12517256	.	G	C	0	2	2	0	2	4	0	0
10	12517338	.	C	T	4	4	8	0	0	8	0	0
10	12556417	.	T	A	3	9	12	0	0	12	0	0
10	12609148	.	T	C	6	5	11	0	0	11	0	0
10	12616243	.	G	C	2	4	6	0	0	6	0	0
10	12616330	.	T	G	1	2	3	0	0	3	0	0
10	12616396	.	A	G	4	4	8	0	0	8	0	0
10	12656045	.	C	T	6	7	13	0	0	13	0	0
10	12656075	.	T	C	9	6	15	0	0	15	0	0
10	12729309	.	C	T	5	4	9	0	0	9	0	0
10	12729361	.	C	T	4	5	9	0	0	9	0	0
10	12730352	.	T	C	7	6	13	0	0	13	0	0
10	12730433	.	C	T	6	5	11	0	1	12	0	0
10	13000879	.	A	G	2	3	5	0	0	5	0	0
10	13037752	.	A	G	1	0	1	0	3	4	0	0
10	13038022	.	T	C	3	5	8	0	0	8	0	0
10	13038025	.	A	C	2	5	7	0	1	8	0	0
10	13063752	.	A	G	4	0	4	0	1	5	0	0
10	13063775	.	C	T	5	3	8	0	0	8	0	0
10	13283660	.	C	A	7	4	11	0	0	11	0	0
10	13283720	.	C	T	6	6	12	0	0	12	0	0
10	13286472	.	T	C	6	8	14	0	1	15	0	0
10	13286778	.	G	A	0	3	3	0	3	6	0	0
10	13286803	.	A	T	5	3	8	0	0	8	0	0
10	13287031	.	A	C	3	2	5	0	0	5	0	0
10	13460494	.	A	C	7	10	17	0	2	19	0	0
10	13460671	.	G	A	18	9	27	0	0	27	0	0
10	13460691	.	T	C	18	9	27	0	2	29	0	0
10	13460745	.	C	A	2	17	19	0	9	28	0	0
10	13460765	.	C	T	11	15	26	0	2	28	0	0
10	13460814	.	A	T	19	8	27	0	0	27	0	0
10	13461080	.	T	C	21	0	21	1	16	39	1	0
10	13476010	.	A	G	24	24	48	0	1	49	0	0
10	13529250	.	C	G	13	18	31	0	1	32	0	0
10	13529270	.	T	C	14	18	32	0	0	32	0	0
10	13536790	.	T	C	7	0	7	0	15	22	0	0
10	14263906	.	T	G	1	2	3	0	0	3	0	0
10	14326834	.	C	T	1	4	5	0	0	5	0	0
10	14478899	.	A	G	3	2	5	0	0	5	0	0
10	14478929	.	A	G	2	4	6	0	0	6	0	0
10	14484443	.	T	C	3	0	3	0	2	5	0	0
10	14488213	.	T	C	2	3	5	0	0	5	0	0
10	14488276	.	T	A	3	2	5	0	0	5	0	0
10	14491139	.	C	T	16	12	28	0	0	28	0	0
10	14532271	.	T	C	9	6	15	0	1	16	0	0
10	14532398	.	T	C	8	0	8	0	8	16	0	0
10	14533352	.	A	G	5	2	7	0	0	7	0	0
10	14536393	.	G	A	4	8	12	0	0	12	0	0
10	14545572	.	A	G	16	15	31	0	0	31	0	0
10	14545602	.	T	C	3	0	3	0	4	7	0	0
10	14556592	.	A	G	2	2	4	0	0	4	0	0
10	14556691	.	A	G	1	3	4	0	0	4	0	0
10	14556697	.	G	A	0	3	3	0	1	4	0	0
10	14871245	.	T	A	6	9	15	0	3	18	0	0
10	14871758	.	C	G	16	9	25	0	1	26	0	0
10	14871768	.	A	G	17	14	31	0	0	31	0	0
10	14871801	.	A	C	14	15	29	0	1	30	0	0
10	14873175	.	T	G	20	11	31	0	2	33	0	0
10	14873220	.	A	G	24	12	36	0	1	37	0	0
10	14878863	.	C	G	19	6	25	0	0	25	0	0
10	14878890	.	T	C	18	0	18	0	8	26	0	0
10	14879027	.	G	A	15	9	24	0	3	27	0	0
10	14885337	.	A	G	22	8	30	0	1	31	0	0
10	14885957	.	C	A	0	11	11	0	16	27	0	0
10	14892211	.	C	T	6	11	17	0	21	38	0	0
10	14920909	.	G	A	12	10	22	0	1	23	0	0
10	14920912	.	T	C	12	1	13	0	9	22	0	0
10	14921053	.	G	C	13	1	14	0	14	28	0	0
10	14921086	.	A	C	22	0	22	0	14	36	0	0
10	15065716	.	C	T	2	3	5	0	0	5	0	0
10	15065904	.	A	C	1	2	3	0	1	4	0	0
10	15277481	.	T	C	27	14	41	0	0	41	0	0
10	15285696	.	C	T	24	19	43	0	0	43	0	0
10	15285852	.	T	G	24	0	24	0	13	37	0	0
10	15287463	.	T	C	14	14	28	0	0	28	0	0
10	15287883	.	C	A	14	15	29	0	1	30	0	0
10	15287933	.	C	T	14	16	30	0	0	30	0	0
10	15291157	.	G	A	2	21	23	0	23	46	0	0
10	15295913	.	T	C	25	12	37	0	0	37	0	0
10	15296219	.	G	A	2	22	24	0	14	38	0	0
10	15298458	.	G	C	11	19	30	0	1	31	0	0
10	15298518	.	G	A	20	26	46	0	1	47	0	0
10	15303975	.	A	T	26	25	51	0	1	52	0	0
10	15304167	.	A	G	11	14	25	0	0	25	0	0
10	15304331	.	C	A	17	11	28	0	2	30	0	0
10	15304782	.	A	G	21	8	29	0	0	29	0	0
10	15338917	.	T	G	3	9	12	0	0	12	0	0
10	15372708	.	G	T	12	16	28	0	2	30	0	0
10	15372726	.	G	A	12	19	31	0	1	32	0	0
10	15372889	.	G	A	19	11	30	0	4	34	0	0
10	15381782	.	C	G	8	4	12	0	0	12	0	0
10	15381784	.	A	C	8	4	12	0	0	12	0	0
10	15382352	.	A	G	7	15	22	0	4	26	0	0
10	15382546	.	A	G	10	12	22	0	1	23	0	0
10	15382669	.	G	A	14	16	30	0	1	31	0	0
10	15382681	.	A	T	17	13	30	0	0	30	0	0
10	15400027	.	G	A	28	23	51	0	0	51	0	0
10	15400692	.	T	G	22	18	40	0	2	42	0	0
10	15405509	.	T	G	4	2	6	0	0	6	0	0
10	15434330	.	T	C	3	3	6	0	0	6	0	0
10	15438451	.	G	A	2	3	5	0	1	6	0	0
10	15447471	.	T	C	2	3	5	0	0	5	0	0
10	15511974	.	C	T	6	7	13	0	0	13	0	0
10	15533107	.	T	C	6	2	8	0	0	8	0	0
10	15551496	.	G	A	5	5	10	0	0	10	0	0
10	15551580	.	C	T	1	5	6	0	0	6	0	0
10	15553178	.	A	G	3	4	7	0	0	7	0	0
10	15569027	.	G	A	1	10	11	0	10	21	0	0
10	15575364	.	C	T	9	10	19	0	0	19	0	0
10	15575627	.	T	C	5	5	10	0	0	10	0	0
10	15575633	.	C	T	5	3	8	0	1	9	0	0
10	15580988	.	T	G	10	0	10	0	5	15	0	0
10	15581078	.	G	A	3	5	8	0	0	8	0	0
10	15582371	.	C	G	8	5	13	0	0	13	0	0
10	15582744	.	A	C	12	11	23	0	0	23	0	0
10	15582746	.	A	T	10	11	21	0	0	21	0	0
10	15582799	.	C	T	7	17	24	0	0	24	0	0
10	15582906	.	C	T	14	10	24	0	0	24	0	0
10	15583060	.	C	T	7	6	13	0	3	16	0	0
10	15583105	.	C	T	8	5	13	0	1	14	0	0
10	15583153	.	G	C	6	6	12	0	0	12	0	0
10	15596503	.	A	C	7	7	14	0	0	14	0	0
10	15596752	.	C	T	10	7	17	0	0	17	0	0
10	15596767	.	C	G	12	5	17	0	1	18	0	0
10	15596958	.	G	C	7	7	14	0	0	14	0	0
10	15596995	.	C	T	10	6	16	0	0	16	0	0
10	15597103	.	T	A	10	13	23	0	0	23	0	0
10	15597822	.	G	A	3	7	10	0	1	11	0	0
10	15597834	.	A	T	4	8	12	0	0	12	0	0
10	15598303	.	A	T	6	4	10	0	0	10	0	0
10	15598358	.	T	G	8	7	15	0	0	15	0	0
10	15598412	.	T	C	5	6	11	0	0	11	0	0
10	15598458	.	A	G	2	0	2	0	6	8	0	0
10	15598598	.	T	G	8	9	17	0	0	17	0	0
10	15598681	.	G	A	0	12	12	0	5	17	0	0
10	15598921	.	T	A	11	5	16	0	3	19	0	0
10	15603092	.	C	T	6	2	8	0	1	9	0	0
10	15603099	.	G	A	1	2	3	0	10	13	0	0
10	15608373	.	T	C	10	20	30	0	4	34	0	0
10	15608756	.	T	C	29	18	47	0	0	47	0	0
10	15612238	.	C	T	21	18	39	0	0	39	0	0
10	15612602	.	G	A	21	9	30	0	0	30	0	0
10	15612641	.	A	T	18	4	22	0	5	27	0	0
10	15612675	.	T	A	28	14	42	0	3	45	0	0
10	15612705	.	C	T	25	15	40	0	6	46	0	0
10	15612758	.	G	A	28	9	37	0	2	39	0	0
10	15612859	.	G	T	1	21	22	0	9	31	0	0
10	15613076	.	G	A	0	11	11	0	8	19	0	0
10	15613174	.	A	C	4	8	12	0	0	12	0	0
10	15618411	.	A	G	6	3	9	0	0	9	0	0
10	15618606	.	A	G	4	7	11	0	0	11	0	0
10	15621499	.	A	G	6	4	10	0	0	10	0	0
10	15621529	.	C	T	0	4	4	0	4	8	0	0
10	15623124	.	T	C	5	10	15	0	0	15	0	0
10	15629349	.	C	T	3	3	6	0	0	6	0	0
10	15631408	.	C	T	0	8	8	0	7	15	0	0
10	15631480	.	C	T	0	2	2	0	1	3	0	0
10	15637405	.	C	T	4	4	8	0	0	8	0	0
10	15637494	.	T	C	1	3	4	0	0	4	0	0
10	15637696	.	T	C	6	5	11	0	0	11	0	0
10	15637753	.	T	G	4	4	8	0	0	8	0	0
10	15637860	.	G	A	2	6	8	0	0	8	0	0
10	15644841	.	A	C	3	4	7	0	0	7	0	0
10	15649116	.	T	G	1	2	3	0	0	3	0	0
10	15783637	.	A	G	7	1	8	0	25	33	0	0
10	15783721	.	A	G	10	10	20	0	4	24	0	0
10	15783777	.	G	A	15	13	28	0	1	29	0	0
10	15783934	.	T	C	14	13	27	0	0	27	0	0
10	15784613	.	G	A	0	14	14	0	10	24	0	0
10	15788562	.	A	T	16	15	31	0	1	32	0	0
10	15795197	.	A	G	18	1	19	0	14	33	0	0
10	15809215	.	C	T	15	11	26	0	2	28	0	0
10	15812950	.	A	G	16	2	18	0	17	35	0	0
10	15816029	.	T	A	2	2	4	0	0	4	0	0
10	15816852	.	C	G	0	4	4	0	2	6	0	0
10	15816879	.	G	A	4	5	9	0	0	9	0	0
10	15824645	.	A	G	4	3	7	0	0	7	0	0
10	15824648	.	A	G	4	3	7	0	0	7	0	0
10	15826604	.	T	G	2	3	5	0	0	5	0	0
10	15826905	.	G	A	2	4	6	0	0	6	0	0
10	15827288	.	A	G	2	2	4	0	0	4	0	0
10	15829290	.	C	A	1	4	5	0	0	5	0	0
10	15830921	.	G	A	2	3	5	0	0	5	0	0
10	15831166	.	A	T	1	2	3	0	0	3	0	0
10	15838597	.	G	A	4	5	9	0	0	9	0	0
10	15839025	.	G	A	4	3	7	0	1	8	0	0
10	15839104	.	A	T	3	1	4	0	3	7	0	0
10	15860619	.	G	T	3	2	5	0	0	5	0	0
10	15881732	.	G	T	6	2	8	0	0	8	0	0
10	15881819	.	T	G	10	6	16	0	0	16	0	0
10	15884833	.	G	A	15	10	25	0	0	25	0	0
10	15884872	.	T	C	11	0	11	0	12	23	0	0
10	15885056	.	C	G	7	7	14	0	0	14	0	0
10	15893297	.	A	T	6	8	14	0	0	14	0	0
10	15893347	.	G	A	7	12	19	0	0	19	0	0
10	15893372	.	G	T	9	10	19	0	1	20	0	0
10	15919753	.	T	A	8	5	13	0	2	15	0	0
10	15937655	.	G	C	2	5	7	0	0	7	0	0
10	15937799	.	C	T	1	2	3	0	0	3	0	0
10	15960967	.	T	A	6	3	9	0	1	10	0	0
10	15967713	.	T	A	19	9	28	0	0	28	0	0
10	15967715	.	G	A	19	9	28	0	0	28	0	0
10	15975308	.	G	A	1	17	18	0	14	32	0	0
10	15980805	.	A	T	18	16	34	0	2	36	0	0
10	15984366	.	C	T	20	5	25	0	2	27	0	0
10	15992664	.	G	A	8	14	22	0	1	23	0	0
10	15992712	.	T	A	15	14	29	0	1	30	0	0
10	15992731	.	A	T	12	14	26	0	2	28	0	0
10	15992968	.	A	C	19	15	34	0	2	36	0	0
10	15997600	.	A	G	15	0	15	0	10	25	0	0
10	15997729	.	C	T	13	15	28	0	0	28	0	0
10	15997804	.	G	A	2	9	11	0	12	23	0	0
10	16015332	.	G	A	14	18	32	0	0	32	0	0
10	16015509	.	C	A	1	14	15	0	11	26	0	0
10	16017676	.	A	T	8	21	29	0	1	30	0	0
10	16019482	.	G	A	10	19	29	0	1	30	0	0
10	16019881	.	A	G	8	7	15	0	2	17	0	0
10	16019902	.	C	T	7	8	15	0	0	15	0	0
10	16031378	.	T	C	13	7	20	0	2	22	0	0
10	16031555	.	C	T	6	7	13	0	0	13	0	0
10	16031648	.	C	G	9	9	18	0	0	18	0	0
10	16031690	.	A	G	9	9	18	0	1	19	0	0
10	16034782	.	A	G	7	5	12	0	1	13	0	0
10	16034796	.	C	T	8	4	12	0	0	12	0	0
10	16034887	.	G	A	4	3	7	0	0	7	0	0
10	16034901	.	A	C	6	3	9	0	0	9	0	0
10	16035084	.	G	A	7	4	11	0	0	11	0	0
10	16036615	.	T	C	11	13	24	0	0	24	0	0
10	16036728	.	T	A	4	7	11	0	0	11	0	0
10	16036818	.	C	T	10	4	14	0	0	14	0	0
10	16036929	.	G	A	7	5	12	0	0	12	0	0
10	16043700	.	A	G	14	0	14	0	7	21	0	0
10	16049522	.	T	C	10	7	17	0	1	18	0	0
10	16052536	.	T	C	11	7	18	0	2	20	0	0
10	16055878	.	C	T	8	8	16	0	0	16	0	0
10	16055906	.	C	T	5	9	14	0	2	16	0	0
10	16056137	.	T	A	7	2	9	0	0	9	0	0
10	16056145	.	A	G	8	2	10	0	0	10	0	0
10	16056181	.	T	A	9	4	13	0	0	13	0	0
10	16056511	.	T	C	8	9	17	0	0	17	0	0
10	16061731	.	T	C	5	0	5	1	3	9	0	0
10	16065144	.	C	A	1	4	5	0	0	5	0	0
10	16141451	.	C	T	2	2	4	0	0	4	0	0
10	16173297	.	A	G	8	6	14	0	1	15	0	0
10	16176685	.	G	A	7	6	13	0	0	13	0	0
10	16176720	.	C	T	8	12	20	0	0	20	0	0
10	16176906	.	G	A	9	8	17	0	1	18	0	0
10	16176915	.	G	A	9	10	19	0	0	19	0	0
10	16181904	.	T	C	5	5	10	0	1	11	0	0
10	16185500	.	T	C	13	6	19	0	0	19	0	0
10	16185611	.	A	G	13	0	13	0	9	22	0	0
10	16185685	.	A	G	7	5	12	0	0	12	0	0
10	16185915	.	T	G	7	4	11	0	0	11	0	0
10	16185927	.	C	G	5	5	10	0	0	10	0	0
10	16185984	.	T	G	4	2	6	0	0	6	0	0
10	16186158	.	T	C	8	4	12	0	0	12	0	0
10	16186405	.	T	A	5	7	12	0	0	12	0	0
10	16192385	.	G	A	10	5	15	0	2	17	0	0
10	16225603	.	A	T	14	0	14	0	1	15	0	0
10	16225872	.	C	T	4	6	10	0	0	10	0	0
10	16226250	.	A	C	11	10	21	0	2	23	0	0
10	16263919	.	G	A	2	5	7	0	1	8	0	0
10	16264257	.	A	T	3	6	9	0	0	9	0	0
10	16264293	.	T	G	1	0	1	0	8	9	0	0
10	16273333	.	C	T	7	3	10	0	0	10	0	0
10	16273683	.	C	T	4	5	9	0	0	9	0	0
10	16287073	.	C	T	9	7	16	0	0	16	0	0
10	16303060	.	A	T	15	10	25	0	0	25	0	0
10	16307128	.	A	G	3	2	5	0	3	8	0	0
10	16307651	.	T	A	9	22	31	0	0	31	0	0
10	16307679	.	T	A	11	14	25	0	0	26	1	0
10	16307952	.	A	G	10	7	17	0	0	17	0	0
10	16307979	.	A	T	11	7	18	0	1	19	0	0
10	16308206	.	T	C	7	3	10	0	1	11	0	0
10	16308272	.	A	G	8	4	12	0	0	12	0	0
10	16308643	.	G	A	1	9	10	0	11	21	0	0
10	16308648	.	G	T	2	8	10	0	10	20	0	0
10	16308923	.	G	A	0	9	9	0	19	28	0	0
10	16309001	.	T	A	15	10	25	1	1	27	0	0
10	16309017	.	G	A	16	8	24	1	2	27	0	0
10	16309167	.	T	C	17	11	28	0	1	29	0	0
10	16309364	.	A	G	5	6	11	0	0	11	0	0
10	16309434	.	T	C	1	3	4	0	0	4	0	0
10	16309498	.	C	T	8	9	17	0	4	21	0	0
10	16475952	.	C	T	4	2	6	0	0	6	0	0
10	16476267	.	A	T	2	2	4	0	2	6	0	0
10	16476742	.	A	T	1	5	6	0	0	6	0	0
10	16477049	.	T	C	4	0	4	0	6	10	0	0
10	16477202	.	A	G	3	4	7	0	0	7	0	0
10	16477230	.	T	C	3	3	6	0	0	6	0	0
10	16477575	.	T	C	4	2	6	0	0	6	0	0
10	16477629	.	T	C	1	3	4	0	0	4	0	0
10	16503816	.	T	A	2	3	5	0	0	5	0	0
10	16563035	.	A	C	9	6	15	0	0	16	1	0
10	16746334	.	A	G	3	6	9	0	0	9	0	0
10	16746706	.	C	A	5	6	11	0	0	11	0	0
10	16746790	.	C	T	7	8	15	0	0	15	0	0
10	16747280	.	T	C	3	2	5	0	0	5	0	0
10	16747281	.	A	C	3	2	5	0	0	5	0	0
10	16747465	.	A	C	1	6	7	0	0	7	0	0
10	16867505	.	G	T	5	2	7	0	0	7	0	0
10	17132501	.	C	T	34	25	59	0	3	62	0	0
10	17166889	.	C	T	2	9	11	0	19	30	0	0
10	17166955	.	A	G	18	24	42	0	0	42	0	0
10	17166982	.	A	G	19	23	42	0	2	44	0	0
10	17167637	.	A	G	37	32	69	0	4	73	0	0
10	17167733	.	T	C	33	33	66	0	1	67	0	0
10	17167757	.	G	A	31	32	63	0	3	66	0	0
10	17168039	.	C	T	28	31	59	0	1	60	0	0
10	17168096	.	A	G	24	38	62	0	4	66	0	0
10	17169948	.	C	G	37	21	58	0	2	60	0	0
10	17174687	.	C	T	7	1	8	0	2	10	0	0
10	17179400	.	G	A	4	5	9	0	0	9	0	0
10	17179557	.	C	T	8	3	11	0	0	11	0	0
10	17183147	.	T	A	6	2	8	0	1	9	0	0
10	17205669	.	G	A	8	6	14	0	1	15	0	0
10	17211858	.	C	A	2	2	4	0	0	4	0	0
10	17213961	.	T	C	4	2	6	0	0	6	0	0
10	17213985	.	G	A	2	3	5	0	0	5	0	0
10	17282810	.	C	G	14	6	20	0	2	22	0	0
10	17282903	.	G	A	10	9	19	0	3	22	0	0
10	17283170	.	A	G	14	13	27	0	3	30	0	0
10	17283386	.	A	G	15	13	28	0	0	28	0	0
10	17283720	.	T	A	10	15	25	0	0	25	0	0
10	17283905	.	A	G	8	16	24	0	1	25	0	0
10	17283955	.	G	A	9	18	27	0	1	28	0	0
10	17372187	.	G	A	1	9	10	0	7	17	0	0
10	17552889	.	A	T	2	6	8	0	0	8	0	0
10	17552976	.	T	C	4	5	9	0	0	9	0	0
10	17552994	.	T	C	5	8	13	0	0	13	0	0
10	17553184	.	T	C	3	2	5	0	0	5	0	0
10	17553271	.	G	A	14	4	18	0	1	19	0	0
10	17560030	.	G	A	7	6	13	0	1	14	0	0
10	17560390	.	T	C	2	1	3	0	1	4	0	0
10	17562978	.	G	C	2	5	7	0	2	9	0	0
10	17563180	.	A	G	4	2	6	0	0	6	0	0
10	17563279	.	C	T	7	3	10	0	0	10	0	0
10	17568878	.	C	T	5	3	8	0	1	9	0	0
10	17572866	.	C	A	0	4	4	0	4	8	0	0
10	17577348	.	T	C	2	6	8	0	0	8	0	0
10	17579465	.	C	T	0	3	3	0	7	10	0	0
10	17579715	.	A	C	9	3	12	0	1	13	0	0
10	17579948	.	T	A	3	8	11	0	0	11	0	0
10	17583426	.	T	C	7	0	7	0	6	13	0	0
10	17587553	.	G	A	6	2	8	0	0	8	0	0
10	17587628	.	A	T	3	4	7	0	0	7	0	0
10	17587742	.	G	A	5	10	15	0	1	16	0	0
10	17587789	.	G	A	4	6	10	0	1	11	0	0
10	17587795	.	T	C	8	0	8	0	5	13	0	0
10	17638857	.	A	G	4	0	4	0	4	8	0	0
10	17638977	.	T	C	2	2	4	0	0	4	0	0
10	17681174	.	A	T	15	8	23	0	2	25	0	0
10	17681183	.	T	A	18	9	27	0	1	28	0	0
10	17681252	.	G	A	13	11	24	0	1	25	0	0
10	17684736	.	C	T	11	7	18	0	0	18	0	0
10	17684739	.	C	T	13	8	21	0	0	21	0	0
10	17686174	.	T	C	14	8	22	0	1	23	0	0
10	17686216	.	T	C	18	12	30	0	1	31	0	0
10	17690998	.	C	T	7	4	11	0	1	12	0	0
10	17691127	.	T	G	3	6	9	0	1	10	0	0
10	17700237	.	T	C	3	0	3	0	10	13	0	0
10	17700365	.	A	T	7	6	13	0	0	13	0	0
10	17700458	.	T	C	7	7	14	0	0	14	0	0
10	17700484	.	A	T	6	6	12	0	1	13	0	0
10	17700753	.	C	A	7	4	11	0	0	11	0	0
10	17700775	.	G	A	3	3	6	0	0	6	0	0
10	17701002	.	C	G	8	16	24	0	0	24	0	0
10	17701003	.	C	A	0	15	15	0	7	23	1	0
10	17701222	.	C	T	1	9	10	0	14	24	0	0
10	17851033	.	T	G	12	9	21	0	0	21	0	0
10	17876862	.	A	G	17	0	17	1	23	41	0	0
10	17890850	.	G	A	21	22	43	1	0	44	0	0
10	17911220	.	C	T	14	14	28	0	1	29	0	0
10	17913424	.	A	C	14	13	27	0	1	28	0	0
10	17922444	.	A	G	18	24	42	1	4	47	0	0
10	17922540	.	A	T	16	21	37	0	2	39	0	0
10	17922582	.	C	T	14	16	30	0	3	33	0	0
10	17922651	.	G	C	19	14	33	0	1	34	0	0
10	17922718	.	C	T	18	14	32	0	1	33	0	0
10	17922807	.	A	G	24	0	24	0	12	36	0	0
10	17922894	.	T	G	17	14	31	0	1	32	0	0
10	17922955	.	A	T	13	8	21	0	2	23	0	0
10	17922973	.	T	C	9	7	16	0	4	20	0	0
10	17923490	.	A	T	10	12	22	1	0	23	0	0
10	17923867	.	A	C	7	8	15	0	0	15	0	0
10	17923912	.	T	A	5	9	14	0	1	15	0	0
10	17924398	.	A	C	6	8	14	1	0	15	0	0
10	17924420	.	T	C	4	9	13	0	1	14	0	0
10	17924740	.	T	G	16	19	35	0	0	35	0	0
10	17924779	.	G	A	11	18	29	0	1	30	0	0
10	17924836	.	T	A	12	11	23	0	1	24	0	0
10	17925146	.	T	C	15	13	28	0	1	29	0	0
10	17925301	.	T	A	4	9	13	0	1	14	0	0
10	17925302	.	G	T	4	8	12	0	2	14	0	0
10	17925951	.	T	A	2	2	4	0	0	4	0	0
10	17940352	.	G	A	32	23	55	0	2	57	0	0
10	17940356	.	A	G	30	25	55	0	0	55	0	0
10	17943696	.	G	A	27	33	60	0	1	61	0	0
10	17943714	.	T	C	30	32	62	0	2	64	0	0
10	17944017	.	C	T	25	24	49	0	2	51	0	0
10	17945447	.	A	G	19	22	41	0	4	45	0	0
10	17945522	.	C	T	20	16	36	3	0	39	0	0
10	17945581	.	G	T	24	25	49	0	2	51	0	0
10	17945629	.	T	C	28	27	55	0	4	59	0	0
10	17945725	.	A	G	25	23	48	0	0	48	0	0
10	17945738	.	T	A	25	20	45	0	0	45	0	0
10	17945779	.	T	A	22	12	34	0	1	35	0	0
10	17946030	.	A	T	4	2	6	0	0	6	0	0
10	18292010	.	C	A	0	1	1	0	2	3	0	0
10	18462778	.	T	G	1	2	3	0	0	3	0	0
10	18462789	.	T	A	2	2	4	0	0	4	0	0
10	18463614	.	C	G	1	2	3	0	0	3	0	0
10	18467793	.	A	C	3	2	5	0	0	5	0	0
10	18467846	.	A	C	5	3	8	0	0	8	0	0
10	18467873	.	T	C	3	4	7	0	0	7	0	0
10	18877465	.	A	T	1	2	3	0	0	3	0	0
10	18887816	.	C	T	12	11	23	0	1	24	0	0
10	18896228	.	A	C	12	14	26	0	2	28	0	0
10	18906598	.	C	G	9	0	9	0	14	24	1	0
10	18911166	.	A	G	8	8	16	0	0	16	0	0
10	18924407	.	C	G	16	18	34	1	0	35	0	0
10	18927910	.	C	T	9	11	20	0	1	21	0	0
10	18930403	.	T	C	12	24	36	0	0	36	0	0
10	18934119	.	A	T	6	10	16	0	0	16	0	0
10	18934291	.	T	C	8	11	19	0	0	19	0	0
10	18934393	.	T	G	7	0	7	0	8	15	0	0
10	18934409	.	T	A	9	8	17	0	0	17	0	0
10	18934590	.	A	C	8	19	27	0	0	27	0	0
10	18934683	.	T	C	13	9	22	0	0	22	0	0
10	18934963	.	G	A	2	13	15	0	5	20	0	0
10	18935271	.	C	T	12	17	29	0	0	29	0	0
10	18935874	.	T	A	3	3	6	0	0	6	0	0
10	18973124	.	A	G	14	1	15	0	10	25	0	0
10	18983512	.	C	A	26	19	45	0	0	46	1	0
10	18989018	.	C	G	20	14	34	0	1	35	0	0
10	18989047	.	T	C	24	16	40	0	2	42	0	0
10	19005965	.	A	C	1	2	3	0	0	3	0	0
10	19005983	.	A	G	1	2	3	0	0	3	0	0
10	19006076	.	G	A	1	2	3	0	0	3	0	0
10	19020475	.	A	G	4	11	15	0	0	15	0	0
10	19021102	.	C	G	5	8	13	0	0	13	0	0
10	19021192	.	A	G	5	4	9	0	0	9	0	0
10	19021456	.	A	G	1	2	3	0	0	3	0	0
10	19090373	.	G	T	0	2	2	0	1	3	0	0
10	19090870	.	C	T	3	2	5	0	0	5	0	0
10	19090885	.	G	A	4	2	6	0	0	6	0	0
10	19310775	.	C	G	8	6	14	0	0	14	0	0
10	19338576	.	G	A	1	10	11	0	2	13	0	0
10	19338735	.	G	C	4	4	8	0	0	8	0	0
10	19338827	.	C	T	6	4	10	0	1	11	0	0
10	19338839	.	T	C	6	4	10	0	0	10	0	0
10	19338938	.	T	G	5	5	10	0	0	10	0	0
10	19339280	.	C	G	4	6	10	0	0	10	0	0
10	19339364	.	G	A	0	4	4	0	5	9	0	0
10	19339367	.	T	C	5	4	9	0	1	10	0	0
10	19339538	.	G	C	0	13	13	0	14	27	0	0
10	19339647	.	C	T	6	11	17	0	4	21	0	0
10	19339859	.	C	G	8	13	21	0	0	21	0	0
10	19428498	.	C	T	1	3	4	0	1	5	0	0
10	19428509	.	T	C	1	3	4	0	0	4	0	0
10	19428743	.	T	A	1	4	5	0	0	5	0	0
10	19428789	.	C	T	3	4	7	0	0	7	0	0
10	19428791	.	G	T	3	4	7	0	0	7	0	0
10	19428830	.	A	C	2	2	4	0	0	4	0	0
10	19428835	.	C	A	0	2	2	0	1	3	0	0
10	19429713	.	T	C	5	2	7	0	1	8	0	0
10	19429718	.	A	G	6	2	8	0	0	8	0	0
10	19429874	.	C	A	1	0	1	0	2	3	0	0
10	19554673	.	A	T	25	19	44	0	1	45	0	0
10	19558489	.	C	A	27	28	55	0	2	57	0	0
10	19558558	.	T	A	26	27	53	0	1	54	0	0
10	19559235	.	A	G	23	28	51	0	2	53	0	0
10	19562006	.	T	G	31	24	55	0	1	56	0	0
10	19562015	.	A	T	36	25	61	0	0	61	0	0
10	19562945	.	C	T	30	33	63	0	1	64	0	0
10	19565704	.	A	T	21	24	45	2	2	49	0	0
10	19565771	.	T	C	18	26	44	0	1	45	0	0
10	19565782	.	A	C	18	28	46	0	0	46	0	0
10	19566400	.	T	A	11	17	28	0	1	29	0	0
10	19566445	.	T	C	5	8	13	0	0	13	0	0
10	19801737	.	C	A	8	11	19	0	0	19	0	0
10	19801759	.	A	C	10	7	17	0	0	17	0	0
10	19801779	.	C	T	10	5	15	0	0	15	0	0
10	19801808	.	A	G	9	5	14	0	0	14	0	0
10	20082011	.	T	G	6	4	10	0	1	11	0	0
10	20083200	.	C	T	8	7	15	0	0	15	0	0
10	20085200	.	A	C	8	8	16	0	0	16	0	0
10	20087260	.	A	G	4	6	10	0	0	10	0	0
10	20087263	.	C	T	3	6	9	0	0	9	0	0
10	20087388	.	T	C	6	5	11	0	0	11	0	0
10	20093368	.	C	T	12	6	18	0	0	18	0	0
10	20093914	.	C	T	10	12	22	0	0	22	0	0
10	20093959	.	A	G	7	18	25	0	2	27	0	0
10	20099649	.	C	T	3	2	5	0	1	6	0	0
10	20103429	.	A	T	8	5	13	0	0	13	0	0
10	20103448	.	A	G	7	3	10	0	0	10	0	0
10	20103601	.	G	T	5	5	10	0	1	11	0	0
10	20103639	.	A	G	4	5	9	0	0	9	0	0
10	20103662	.	C	T	5	3	8	0	0	8	0	0
10	20103731	.	C	T	3	9	12	0	0	12	0	0
10	20105347	.	A	G	15	13	28	0	0	28	0	0
10	20108575	.	T	A	14	24	38	0	1	39	0	0
10	20113892	.	T	C	1	2	3	0	0	3	0	0
10	20113939	.	A	G	3	2	5	0	0	5	0	0
10	20113962	.	T	C	2	2	4	0	0	4	0	0
10	20132444	.	G	T	1	2	3	0	0	3	0	0
10	20136107	.	T	C	21	14	35	0	1	36	0	0
10	20137862	.	A	G	5	19	24	0	2	26	0	0
10	20140896	.	T	A	2	1	3	0	0	3	0	0
10	20140951	.	T	C	3	2	5	0	0	5	0	0
10	20143850	.	T	A	3	5	8	0	1	9	0	0
10	20147452	.	A	G	5	0	5	0	10	15	0	0
10	20159474	.	G	A	4	2	6	0	1	7	0	0
10	20159531	.	G	A	3	2	5	0	0	5	0	0
10	20218342	.	C	G	13	17	30	0	0	30	0	0
10	20221281	.	C	T	12	11	23	0	1	24	0	0
10	20270867	.	T	C	6	2	8	0	0	8	0	0
10	20307552	.	T	C	3	0	3	0	2	5	0	0
10	20307554	.	A	T	3	1	4	0	1	5	0	0
10	20339024	.	C	T	6	6	12	0	1	13	0	0
10	20351930	.	T	C	4	3	7	0	1	8	0	0
10	20351978	.	A	G	4	3	7	0	1	8	0	0
10	20356700	.	C	T	4	5	9	0	0	9	0	0
10	20356812	.	G	A	2	4	6	0	0	6	0	0
10	20356822	.	G	T	2	3	5	0	2	7	0	0
10	20368883	.	C	T	17	13	30	0	4	34	0	0
10	20371675	.	A	T	22	8	30	0	0	30	0	0
10	20371715	.	T	C	18	7	25	0	0	25	0	0
10	20371723	.	A	C	16	8	24	0	0	24	0	0
10	20371827	.	C	T	18	7	25	0	0	25	0	0
10	20395629	.	T	C	4	6	10	0	0	10	0	0
10	20401613	.	C	A	5	4	9	0	0	9	0	0
10	20401813	.	A	G	6	3	9	0	1	10	0	0
10	20462884	.	G	A	18	15	33	0	1	34	0	0
10	20463890	.	G	A	23	18	41	0	1	42	0	0
10	20464238	.	A	G	21	19	40	0	0	40	0	0
10	20464245	.	A	G	19	18	37	0	2	39	0	0
10	20468868	.	T	C	13	0	13	0	14	27	0	0
10	20468952	.	G	A	20	11	31	0	1	32	0	0
10	20472600	.	G	T	10	10	20	0	3	23	0	0
10	20473517	.	G	T	17	16	33	0	0	33	0	0
10	20481740	.	T	C	16	17	33	0	1	34	0	0
10	20505261	.	G	A	2	6	8	0	0	8	0	0
10	20506482	.	T	A	3	6	9	0	0	9	0	0
10	20515512	.	A	G	9	5	14	0	0	14	0	0
10	20517889	.	A	G	3	3	6	0	0	6	0	0
10	20519543	.	T	C	12	6	18	0	0	18	0	0
10	20519549	.	T	C	12	0	12	0	6	18	0	0
10	20522212	.	C	T	5	2	7	0	0	7	0	0
10	20522217	.	G	T	4	2	6	0	0	6	0	0
10	20527571	.	C	T	2	4	6	0	0	6	0	0
10	20527639	.	G	A	10	5	15	0	0	15	0	0
10	20527653	.	C	T	9	7	16	0	0	16	0	0
10	20529384	.	G	A	9	7	16	0	2	18	0	0
10	20529389	.	G	T	9	8	17	0	0	17	0	0
10	20529450	.	T	C	10	0	10	0	6	16	0	0
10	20532762	.	C	T	1	4	5	0	3	8	0	0
10	20533079	.	A	C	10	6	16	0	0	16	0	0
10	20543294	.	T	C	9	1	10	0	4	14	0	0
10	20543336	.	G	A	15	8	23	0	0	23	0	0
10	20546548	.	C	T	12	12	24	0	1	25	0	0
10	20563086	.	T	C	18	7	25	0	1	26	0	0
10	20565260	.	C	T	1	8	9	0	16	25	0	0
10	20583799	.	C	T	7	10	17	0	0	17	0	0
10	20586463	.	A	T	4	10	14	0	0	14	0	0
10	20596178	.	C	G	10	17	27	0	0	27	0	0
10	20598267	.	A	G	17	6	23	1	0	24	0	0
10	20598345	.	C	G	11	7	18	17	2	37	0	0
10	20604555	.	T	C	14	19	33	0	0	33	0	0
10	20605150	.	C	T	11	17	28	0	1	29	0	0
10	20605592	.	C	T	2	3	5	0	0	5	0	0
10	20636027	.	C	T	17	15	32	0	1	33	0	0
10	20636072	.	A	C	21	18	39	0	4	43	0	0
10	20636082	.	C	T	18	17	35	0	2	37	0	0
10	20636168	.	A	T	15	17	32	0	1	33	0	0
10	20636177	.	G	T	15	16	31	0	1	32	0	0
10	20636211	.	G	A	11	17	28	0	2	30	0	0
10	20636262	.	T	A	12	17	29	0	1	30	0	0
10	20636273	.	T	C	15	0	15	0	16	31	0	0
10	20636346	.	T	C	8	10	18	4	1	23	0	0
10	20636479	.	T	C	6	4	10	1	1	12	0	0
10	20637069	.	C	T	20	22	42	0	2	44	0	0
10	20654817	.	A	T	1	2	3	0	1	4	0	0
10	20660387	.	G	A	3	5	8	0	2	10	0	0
10	20661288	.	A	G	6	9	15	0	1	16	0	0
10	20696449	.	A	G	2	7	9	0	1	10	0	0
10	20920664	.	A	G	14	13	27	0	0	27	0	0
10	20971685	.	A	G	15	13	28	0	0	28	0	0
10	21043461	.	G	A	23	8	31	0	3	34	0	0
10	21043902	.	G	A	12	16	28	0	0	28	0	0
10	21043934	.	A	G	12	14	26	0	0	26	0	0
10	21043944	.	A	G	12	12	24	0	0	24	0	0
10	21044037	.	G	A	7	18	25	0	1	26	0	0
10	21044094	.	T	A	5	21	26	0	0	26	0	0
10	21044136	.	G	A	11	15	26	0	0	26	0	0
10	21044193	.	A	G	7	14	21	0	1	22	0	0
10	21044235	.	A	C	8	11	19	0	0	19	0	0
10	21044316	.	A	G	7	9	16	0	0	16	0	0
10	21044645	.	G	A	5	8	13	0	0	13	0	0
10	21044964	.	T	A	9	10	19	0	3	22	0	0
10	21045126	.	T	C	9	1	10	0	13	23	0	0
10	21053520	.	G	C	7	5	12	0	0	12	0	0
10	21053932	.	A	C	9	6	15	0	0	15	0	0
10	21053945	.	C	T	9	6	15	0	0	15	0	0
10	21053967	.	T	C	9	8	17	0	0	17	0	0
10	21436810	.	T	C	10	8	18	0	1	19	0	0
10	21437255	.	A	G	13	0	13	0	9	22	0	0
10	21440173	.	T	C	14	12	26	0	0	26	0	0
10	21440486	.	T	A	19	17	36	0	1	37	0	0
10	21440786	.	A	G	16	16	32	0	4	36	0	0
10	21441305	.	C	T	14	12	26	0	2	28	0	0
10	21442229	.	T	C	17	19	36	0	0	36	0	0
10	21442994	.	T	A	18	26	44	0	2	46	0	0
10	21443476	.	T	C	20	17	37	0	0	37	0	0
10	21451996	.	C	T	11	18	29	0	2	31	0	0
10	21452340	.	T	C	13	14	27	0	0	27	0	0
10	21456498	.	T	C	12	9	21	0	1	22	0	0
10	21459403	.	G	A	0	18	18	0	13	31	0	0
10	21459439	.	G	A	16	19	35	0	1	36	0	0
10	21462585	.	A	G	14	20	34	0	2	36	0	0
10	21469977	.	G	A	4	10	14	0	17	31	0	0
10	21469997	.	A	C	19	17	36	0	0	36	0	0
10	21473787	.	A	G	1	2	3	0	0	3	0	0
10	21523014	.	C	T	16	11	27	0	0	27	0	0
10	21523578	.	C	A	7	6	13	0	0	13	0	0
10	21523624	.	A	C	7	8	15	0	0	15	0	0
10	21523639	.	C	T	9	9	18	0	0	18	0	0
10	21523720	.	T	C	7	9	16	0	3	19	0	0
10	21523827	.	A	G	8	9	17	0	1	18	0	0
10	21524016	.	G	A	0	7	7	0	8	15	0	0
10	21524121	.	A	T	10	4	14	0	2	16	0	0
10	21524244	.	C	A	14	4	18	0	1	19	0	0
10	21524319	.	G	T	12	9	21	0	0	21	0	0
10	21524337	.	C	T	11	10	21	0	0	21	0	0
10	21524472	.	C	T	4	10	14	0	1	15	0	0
10	21524682	.	G	A	13	12	25	0	0	25	0	0
10	21524805	.	T	C	12	13	25	0	2	27	0	0
10	21524811	.	A	C	9	13	22	0	0	22	0	0
10	21564251	.	C	A	2	6	8	0	1	9	0	0
10	21579284	.	A	C	6	2	8	3	1	12	0	0
10	21588009	.	G	T	1	3	4	0	0	4	0	0
10	21588036	.	C	T	2	3	5	0	0	5	0	0
10	21588067	.	T	C	4	4	8	0	0	8	0	0
10	21588090	.	C	T	3	3	6	0	1	7	0	0
10	21588226	.	G	A	0	2	2	0	1	3	0	0
10	21588332	.	C	T	1	2	3	0	0	3	0	0
10	21589174	.	G	C	4	3	7	0	0	7	0	0
10	21622317	.	G	A	37	30	67	9	3	79	0	0
10	21645994	.	G	A	33	32	65	1	2	68	0	0
10	21646033	.	C	T	30	39	69	1	0	70	0	0
10	21646216	.	T	C	31	9	40	0	1	41	0	0
10	21646225	.	G	A	30	14	44	0	0	44	0	0
10	21646400	.	C	G	29	29	58	0	0	58	0	0
10	21646844	.	A	G	36	22	58	0	0	58	0	0
10	21646848	.	A	G	33	22	55	0	1	56	0	0
10	21646908	.	C	A	28	29	57	0	1	58	0	0
10	21647008	.	A	C	20	23	43	0	2	45	0	0
10	21647200	.	C	T	25	32	57	0	3	60	0	0
10	21647241	.	T	G	30	29	59	0	1	60	0	0
10	21647291	.	G	A	2	26	28	0	27	55	0	0
10	21647539	.	T	C	39	26	65	1	4	70	0	0
10	21647582	.	C	A	39	27	66	0	2	68	0	0
10	21647614	.	A	C	29	28	57	0	9	66	0	0
10	21647898	.	C	T	31	20	51	0	4	55	0	0
10	21652038	.	G	A	0	1	1	0	2	3	0	0
10	21652585	.	A	T	1	4	5	1	0	6	0	0
10	21657070	.	T	C	3	2	5	0	0	5	0	0
10	21658567	.	G	A	7	4	11	0	0	11	0	0
10	21660641	.	A	C	1	2	3	0	0	3	0	0
10	21660652	.	A	T	1	2	3	0	0	3	0	0
10	21662662	.	T	C	1	2	3	2	0	5	0	0
10	21669235	.	G	A	2	3	5	0	0	5	0	0
10	21674958	.	C	T	2	2	4	0	0	4	0	0
10	21674967	.	A	G	1	0	1	0	2	3	0	0
10	21677547	.	C	T	5	5	10	0	0	10	0	0
10	21677573	.	T	C	7	3	10	0	0	10	0	0
10	21677924	.	C	T	1	2	3	0	0	3	0	0
10	21701671	.	A	G	4	2	6	0	0	6	0	0
10	21719436	.	T	G	1	4	5	0	0	5	0	0
10	21720833	.	A	G	1	6	7	0	1	8	0	0
10	21720867	.	G	A	0	7	7	1	2	10	0	0
10	21722930	.	G	C	2	4	6	1	1	8	0	0
10	21723083	.	G	A	1	6	7	0	0	7	0	0
10	21723489	.	A	C	3	4	7	0	0	7	0	0
10	21723569	.	T	G	5	0	5	0	5	10	0	0
10	21723639	.	A	G	2	2	4	0	3	7	0	0
10	21723660	.	C	A	5	5	10	0	0	10	0	0
10	21723742	.	G	A	5	6	11	0	0	11	0	0
10	21723810	.	A	G	4	0	4	0	3	7	0	0
10	21724194	.	T	A	4	2	6	0	1	7	0	0
10	21724901	.	T	C	9	3	12	0	0	12	0	0
10	21729150	.	G	A	2	2	4	9	0	13	0	0
10	21731754	.	T	C	1	4	5	2	0	7	0	0
10	21732669	.	T	A	1	4	5	1	1	7	0	0
10	21732988	.	C	T	9	3	12	2	0	14	0	0
10	21737987	.	G	A	1	6	7	0	4	11	0	0
10	21738005	.	C	A	5	7	12	0	0	12	0	0
10	21738068	.	C	T	1	5	6	1	0	7	0	0
10	21739919	.	T	A	2	2	4	4	0	8	0	0
10	21777141	.	T	G	6	4	10	0	0	10	0	0
10	21777177	.	A	C	4	2	6	0	1	7	0	0
10	21777889	.	A	C	8	2	10	0	1	11	0	0
10	21777903	.	A	C	8	5	13	0	0	13	0	0
10	21777956	.	A	G	6	3	9	0	0	9	0	0
10	21778089	.	C	A	9	3	12	0	0	12	0	0
10	21778098	.	C	G	11	3	14	0	0	14	0	0
10	21778125	.	G	A	7	3	10	0	2	12	0	0
10	21778494	.	A	T	1	2	3	0	0	3	0	0
10	21778495	.	G	C	1	2	3	0	0	3	0	0
10	21778614	.	A	C	4	4	8	0	1	9	0	0
10	21778980	.	C	T	5	8	13	6	0	19	0	0
10	21779067	.	C	T	8	2	10	0	0	10	0	0
10	21779073	.	T	A	10	3	13	0	0	13	0	0
10	21779129	.	T	G	11	4	15	0	0	15	0	0
10	21780310	.	G	A	1	7	8	1	9	18	0	0
10	21780571	.	A	G	22	6	28	0	0	28	0	0
10	21780579	.	C	T	22	6	28	0	0	28	0	0
10	21780612	.	A	G	6	18	24	0	0	27	3	0
10	21780615	.	A	C	7	23	30	0	0	30	0	0
10	21780741	.	A	G	9	3	12	0	18	30	0	0
10	21780747	.	G	T	1	22	23	0	7	30	0	0
10	21781313	.	C	T	12	18	30	9	1	40	0	0
10	21783252	.	C	T	12	3	15	0	0	15	0	0
10	21783523	.	A	G	17	6	23	1	0	24	0	0
10	21783525	.	A	G	17	9	26	14	0	40	0	0
10	21783560	.	C	A	17	16	33	8	1	42	0	0
10	21783664	.	T	C	13	3	16	0	1	17	0	0
10	21783667	.	G	A	0	3	3	0	16	19	0	0
10	21783727	.	C	A	14	5	19	0	1	20	0	0
10	21783733	.	T	C	15	5	20	0	1	21	0	0
10	21784756	.	C	T	11	10	21	8	0	29	0	0
10	21784759	.	T	C	11	8	19	8	0	28	1	0
10	21785734	.	C	T	24	7	31	7	0	38	0	0
10	21790076	.	A	C	13	13	26	0	1	27	0	0
10	21790295	.	A	T	6	7	13	0	0	13	0	0
10	21790323	.	G	A	3	7	10	0	0	10	0	0
10	21790648	.	T	C	10	13	23	0	1	24	0	0
10	21790769	.	A	G	13	1	14	0	11	26	1	0
10	21790775	.	A	C	12	15	27	0	1	28	0	0
10	21790934	.	T	C	11	14	25	0	0	25	0	0
10	21791090	.	G	A	14	11	25	0	1	26	0	0
10	21791690	.	G	A	0	5	5	22	5	32	0	0
10	21791699	.	T	C	3	5	8	24	0	32	0	0
10	21791927	.	A	T	5	7	12	11	2	25	0	0
10	21792024	.	A	C	18	10	28	6	2	36	0	0
10	21794285	.	G	A	5	6	11	0	0	11	0	0
10	21797266	.	C	T	6	8	14	0	1	15	0	0
10	21797665	.	C	T	7	6	13	0	1	14	0	0
10	21797704	.	A	G	8	7	15	0	0	15	0	0
10	21797769	.	T	G	10	6	16	0	0	16	0	0
10	21797914	.	G	A	5	6	11	0	0	11	0	0
10	21798029	.	T	C	4	2	6	0	1	7	0	0
10	21798102	.	A	G	1	2	3	0	0	3	0	0
10	21798215	.	C	A	8	10	18	2	1	21	0	0
10	21798333	.	C	T	5	6	11	1	0	12	0	0
10	21798348	.	A	T	7	6	13	1	0	14	0	0
10	21798372	.	G	A	7	7	14	0	0	14	0	0
10	21798828	.	C	A	8	3	11	1	1	13	0	0
10	21798975	.	C	T	4	6	10	12	0	22	0	0
10	21798987	.	T	A	1	6	7	21	0	28	0	0
10	21799293	.	A	G	2	2	4	15	0	19	0	0
10	21799343	.	T	A	10	5	15	3	0	18	0	0
10	21799374	.	T	A	12	4	16	1	1	18	0	0
10	21801256	.	C	G	7	9	16	2	0	18	0	0
10	21801267	.	C	T	9	12	21	1	0	22	0	0
10	21801339	.	T	G	17	0	17	0	9	26	0	0
10	21801352	.	T	C	19	10	29	0	1	30	0	0
10	21801573	.	C	T	13	7	20	0	0	20	0	0
10	21801590	.	A	C	8	6	14	0	0	14	0	0
10	21801611	.	G	T	4	8	12	0	1	13	0	0
10	21801718	.	G	A	2	12	14	0	14	28	0	0
10	21802057	.	A	G	9	7	16	1	2	19	0	0
10	21802086	.	A	G	10	6	16	1	2	19	0	0
10	21802291	.	C	T	13	15	28	0	2	30	0	0
10	21802326	.	C	A	16	13	29	0	0	29	0	0
10	21802355	.	C	A	17	14	31	0	0	31	0	0
10	21802380	.	G	A	2	15	17	0	13	30	0	0
10	21802530	.	A	T	4	4	8	0	0	8	0	0
10	21802539	.	C	T	8	6	14	0	0	14	0	0
10	21802566	.	T	C	12	5	17	0	1	18	0	0
10	21802661	.	C	T	19	8	27	0	2	29	0	0
10	21802962	.	G	A	11	6	17	17	5	39	0	0
10	21804785	.	G	T	1	4	5	0	6	11	0	0
10	21804786	.	G	T	7	3	10	0	1	11	0	0
10	21805019	.	A	T	2	3	5	0	0	5	0	0
10	21805020	.	A	C	2	3	5	0	0	5	0	0
10	21805085	.	A	C	4	3	7	0	0	7	0	0
10	21805090	.	G	A	5	3	8	0	0	8	0	0
10	21805251	.	T	G	6	5	11	0	0	11	0	0
10	21805447	.	G	A	5	9	14	0	0	14	0	0
10	21805762	.	C	T	6	9	15	0	1	16	0	0
10	21805870	.	A	G	8	0	8	0	4	12	0	0
10	21805942	.	G	T	2	4	6	0	6	12	0	0
10	21806060	.	G	A	7	9	16	0	0	16	0	0
10	21806984	.	T	A	9	4	13	10	0	23	0	0
10	21809227	.	T	C	2	2	4	0	0	4	0	0
10	21809253	.	C	A	1	4	5	0	0	5	0	0
10	21809314	.	A	G	1	2	3	0	0	3	0	0
10	21809695	.	T	G	4	0	4	0	3	7	0	0
10	21818522	.	C	T	59	28	87	0	5	92	0	0
10	21818595	.	T	G	34	40	74	0	1	75	0	0
10	21818762	.	A	C	30	27	57	0	3	60	0	0
10	21818978	.	G	T	31	37	68	0	2	70	0	0
10	21819577	.	C	T	28	40	68	0	7	75	0	0
10	21819772	.	T	C	27	38	65	0	3	68	0	0
10	21819966	.	A	T	8	3	11	0	0	11	0	0
10	21872639	.	A	G	1	4	5	0	0	5	0	0
10	21944787	.	T	C	1	2	3	3	0	6	0	0
10	21944836	.	T	C	3	2	5	0	0	5	0	0
10	21944847	.	A	G	4	2	6	0	0	6	0	0
10	22003847	.	T	C	23	23	46	0	1	47	0	0
10	22003874	.	A	G	16	26	42	0	3	45	0	0
10	22030827	.	G	A	18	21	39	0	3	42	0	0
10	22030881	.	A	T	19	19	38	0	2	40	0	0
10	22030887	.	T	G	20	24	44	0	1	45	0	0
10	22030985	.	T	C	17	25	42	0	0	42	0	0
10	22030986	.	C	T	18	24	42	0	1	43	0	0
10	22031034	.	C	T	17	28	45	0	0	45	0	0
10	22031493	.	G	A	27	23	50	0	1	51	0	0
10	22031572	.	A	G	33	19	52	0	0	52	0	0
10	22031635	.	A	G	17	24	41	0	1	42	0	0
10	22031666	.	A	G	12	25	37	0	0	37	0	0
10	22031755	.	T	C	16	10	26	0	1	27	0	0
10	22031759	.	T	C	16	11	27	0	1	28	0	0
10	22031805	.	G	C	5	13	18	0	0	18	0	0
10	22031806	.	G	A	5	14	19	0	0	19	0	0
10	22036033	.	A	G	5	0	5	0	4	9	0	0
10	22036169	.	A	G	10	8	18	0	1	19	0	0
10	22041529	.	G	A	6	9	15	0	0	15	0	0
10	22041546	.	C	T	7	8	15	0	2	17	0	0
10	22044921	.	T	G	8	2	10	0	2	12	0	0
10	22051436	.	A	G	3	3	6	0	0	6	0	0
10	22051548	.	C	T	0	2	2	0	1	3	0	0
10	22051933	.	A	G	1	2	3	0	0	3	0	0
10	22052133	.	T	C	2	2	4	0	0	4	0	0
10	22056547	.	T	C	1	3	4	0	0	4	0	0
10	22134695	.	G	A	1	2	3	0	1	4	0	0
10	22162187	.	T	C	15	0	15	0	10	25	0	0
10	22162576	.	A	G	10	9	19	0	1	20	0	0
10	22162673	.	T	G	5	6	11	0	1	12	0	0
10	22163144	.	A	T	9	6	15	0	1	16	0	0
10	22163165	.	A	G	3	6	9	0	2	11	0	0
10	22163235	.	C	T	0	8	8	0	9	17	0	0
10	22163244	.	C	G	9	6	15	0	0	15	0	0
10	22163660	.	C	T	7	6	13	0	1	14	0	0
10	22163801	.	A	T	9	9	18	0	0	18	0	0
10	22163867	.	T	C	7	6	13	0	1	14	0	0
10	22163928	.	C	A	3	9	12	0	0	12	0	0
10	22164144	.	A	T	5	5	10	0	0	10	0	0
10	22164276	.	T	C	1	3	4	0	1	5	0	0
10	22164421	.	T	A	8	4	12	0	1	13	0	0
10	22164518	.	T	A	6	8	14	0	0	14	0	0
10	22164621	.	T	G	7	5	12	0	0	12	0	0
10	22164622	.	G	A	7	5	12	0	0	12	0	0
10	22164672	.	G	A	8	3	11	0	0	11	0	0
10	22164686	.	A	T	8	4	12	0	0	12	0	0
10	22165383	.	C	G	1	8	9	0	0	9	0	0
10	22165607	.	T	G	5	2	7	0	0	7	0	0
10	22165644	.	T	C	5	4	9	0	0	9	0	0
10	22165709	.	G	A	5	6	11	0	0	11	0	0
10	22165719	.	C	A	0	4	4	0	4	8	0	0
10	22165768	.	T	A	8	4	12	0	0	12	0	0
10	22165879	.	T	A	7	4	11	0	0	11	0	0
10	22165880	.	T	C	6	4	10	0	1	11	0	0
10	22165953	.	C	T	6	4	10	0	1	11	0	0
10	22166010	.	T	A	7	8	15	0	2	17	0	0
10	22166128	.	C	T	5	5	10	0	1	11	0	0
10	22166182	.	A	C	7	0	7	0	4	11	0	0
10	22166184	.	G	A	7	4	11	0	0	11	0	0
10	22166504	.	C	T	5	8	13	0	3	16	0	0
10	22205038	.	G	A	10	4	14	0	0	14	0	0
10	22248334	.	C	T	0	4	4	0	6	10	0	0
10	22249237	.	G	A	8	4	12	0	0	12	0	0
10	22381847	.	A	G	12	10	22	0	1	23	0	0
10	22381897	.	C	G	8	11	19	0	1	20	0	0
10	22381984	.	A	T	6	6	12	0	1	13	0	0
10	22475736	.	G	A	9	10	19	0	1	20	0	0
10	22475799	.	G	A	1	16	17	0	16	33	0	0
10	22476535	.	C	T	15	14	29	0	1	30	0	0
10	22477229	.	A	G	20	15	35	0	1	36	0	0
10	22477580	.	C	T	13	9	22	0	0	22	0	0
10	22477610	.	A	G	10	0	10	0	10	20	0	0
10	22477661	.	C	T	9	12	21	0	1	22	0	0
10	22510508	.	A	G	9	4	13	0	0	13	0	0
10	22510550	.	C	A	7	6	13	0	5	18	0	0
10	22516643	.	C	G	10	12	22	0	2	24	0	0
10	22516758	.	T	C	5	9	14	0	0	14	0	0
10	22516903	.	A	G	3	7	10	0	0	10	0	0
10	22516957	.	T	C	2	7	9	0	2	11	0	0
10	22518293	.	C	T	15	10	25	0	4	29	0	0
10	22518294	.	C	T	18	10	28	0	1	29	0	0
10	22519465	.	A	G	8	19	27	0	0	27	0	0
10	22519668	.	A	T	8	15	23	0	1	24	0	0
10	22519737	.	C	T	11	10	21	0	3	24	0	0
10	22519749	.	G	C	13	8	21	0	0	21	0	0
10	22519931	.	C	T	5	10	15	0	0	15	0	0
10	22530058	.	A	C	6	7	13	0	0	13	0	0
10	22530728	.	T	G	5	3	8	0	0	8	0	0
10	22531906	.	A	C	18	15	33	0	0	33	0	0
10	22531946	.	T	G	12	14	26	0	2	28	0	0
10	22532139	.	C	T	12	12	24	0	0	24	0	0
10	22532211	.	G	A	10	6	16	0	1	17	0	0
10	22532547	.	T	A	15	12	27	0	0	27	0	0
10	22532817	.	C	G	14	15	29	0	1	30	0	0
10	22811149	.	C	A	6	4	10	0	0	10	0	0
10	23139410	.	A	G	1	0	1	0	2	3	0	0
10	23139411	.	A	G	1	2	3	0	0	3	0	0
10	24326236	.	C	T	16	19	35	0	2	37	0	0
10	24334810	.	G	A	26	21	47	0	0	47	0	0
10	24335002	.	C	T	20	23	43	0	2	45	0	0
10	24335402	.	C	T	20	14	34	0	0	34	0	0
10	24373137	.	C	T	2	3	5	1	0	6	0	0
10	24373429	.	T	A	1	4	5	0	1	6	0	0
10	24373647	.	C	T	4	2	6	0	0	6	0	0
10	24373657	.	A	C	4	5	9	0	0	9	0	0
10	24373963	.	C	T	2	3	5	0	0	5	0	0
10	24422052	.	C	T	12	13	25	0	1	26	0	0
10	24422205	.	G	A	14	10	24	0	5	29	0	0
10	24422236	.	C	T	14	16	30	0	1	31	0	0
10	24422311	.	G	A	12	9	21	0	0	21	0	0
10	24424363	.	G	C	2	11	13	0	9	22	0	0
10	24425653	.	A	G	11	10	21	0	1	22	0	0
10	24426038	.	A	T	11	11	22	0	2	24	0	0
10	24429357	.	T	C	9	9	18	0	0	18	0	0
10	24431762	.	C	T	13	6	19	0	0	19	0	0
10	24435656	.	G	T	7	11	18	0	2	20	0	0
10	24435662	.	A	G	10	1	11	0	13	24	0	0
10	24442466	.	C	T	5	9	14	0	1	15	0	0
10	24442490	.	A	G	3	0	3	0	6	9	0	0
10	24563892	.	T	G	11	12	23	0	1	24	0	0
10	24564904	.	G	A	0	12	12	0	10	22	0	0
10	24564935	.	C	A	13	12	25	0	0	25	0	0
10	24565366	.	A	T	23	10	33	0	0	33	0	0
10	24565424	.	G	A	24	11	35	0	0	35	0	0
10	24565435	.	G	T	3	10	13	0	22	35	0	0
10	24565587	.	C	A	13	8	21	0	1	22	0	0
10	24566124	.	T	C	8	5	13	0	2	15	0	0
10	24573740	.	G	A	1	8	9	0	10	19	0	0
10	24600128	.	A	G	12	14	26	0	4	30	0	0
10	24605406	.	A	C	19	9	28	0	1	29	0	0
10	24609362	.	C	A	9	8	17	0	1	18	0	0
10	24614505	.	A	T	9	14	23	0	0	23	0	0
10	24614636	.	A	G	12	0	12	0	13	25	0	0
10	24621354	.	A	G	21	15	36	0	1	37	0	0
10	24621543	.	G	A	15	9	24	0	1	25	0	0
10	24621687	.	G	A	6	7	13	0	1	14	0	0
10	24621730	.	A	T	3	4	7	0	0	7	0	0
10	24621757	.	T	A	4	6	10	0	0	10	0	0
10	24649813	.	T	G	6	3	9	0	1	10	0	0
10	24650192	.	A	G	6	4	10	0	1	11	0	0
10	24650769	.	T	C	2	0	2	0	5	7	0	0
10	24650889	.	T	A	6	7	13	0	1	15	1	0
10	24654501	.	C	T	0	9	9	0	17	26	0	0
10	24654607	.	A	T	7	15	22	0	0	22	0	0
10	24654765	.	C	T	10	11	21	0	0	21	0	0
10	24654906	.	T	C	8	0	8	0	8	16	0	0
10	24655146	.	A	T	21	10	31	0	3	34	0	0
10	24655984	.	C	T	8	4	12	0	1	13	0	0
10	24656449	.	T	A	14	17	31	1	0	32	0	0
10	24658800	.	T	C	3	0	3	0	3	6	0	0
10	24659100	.	A	G	1	2	3	0	0	3	0	0
10	24659361	.	A	T	6	2	8	0	0	8	0	0
10	24659492	.	T	A	4	2	6	0	1	7	0	0
10	24659507	.	C	T	5	2	7	0	0	7	0	0
10	24659661	.	A	C	7	5	12	0	0	12	0	0
10	24659717	.	G	C	2	4	6	0	2	8	0	0
10	24659732	.	A	G	6	4	10	0	0	10	0	0
10	24660215	.	T	G	6	11	17	0	2	19	0	0
10	24660629	.	T	A	8	3	11	0	0	11	0	0
10	24666069	.	A	C	4	10	14	0	0	14	0	0
10	24677091	.	T	G	7	0	7	0	4	11	0	0
10	24677227	.	G	A	3	4	7	0	0	7	0	0
10	24677253	.	T	A	3	2	5	0	0	5	0	0
10	24683309	.	C	A	3	2	5	0	0	5	0	0
10	24683335	.	C	T	4	2	6	0	0	6	0	0
10	24683458	.	T	C	1	2	3	0	0	3	0	0
10	24683460	.	A	C	1	2	3	0	0	3	0	0
10	24683800	.	T	C	1	2	3	0	0	3	0	0
10	24683815	.	T	C	1	3	4	0	0	4	0	0
10	24684010	.	T	C	2	3	5	0	1	6	0	0
10	24685378	.	A	G	2	2	4	0	0	4	0	0
10	24685576	.	G	C	2	3	5	0	0	5	0	0
10	24685624	.	T	A	2	4	6	0	0	6	0	0
10	24686158	.	G	A	3	3	6	0	1	7	0	0
10	24686241	.	A	G	1	2	3	0	0	3	0	0
10	24710938	.	T	G	2	3	5	0	0	5	0	0
10	24710981	.	T	G	4	6	10	0	0	10	0	0
10	24721468	.	G	C	9	1	10	0	4	14	0	0
10	24721585	.	G	A	3	2	5	0	0	5	0	0
10	24724151	.	T	G	1	2	3	0	0	3	0	0
10	24725357	.	G	A	2	3	5	0	0	5	0	0
10	24725358	.	A	C	2	2	4	0	1	5	0	0
10	24725724	.	G	A	1	2	3	0	0	3	0	0
10	24726211	.	T	A	4	2	6	0	1	7	0	0
10	24726264	.	G	A	4	3	7	0	0	7	0	0
10	24726302	.	A	G	4	6	10	0	1	11	0	0
10	24726413	.	C	T	0	5	5	0	2	7	0	0
10	24726599	.	G	A	1	1	2	0	0	2	0	0
10	24726606	.	A	T	1	2	3	0	0	3	0	0
10	24726659	.	T	C	0	2	2	0	2	4	0	0
10	24726809	.	A	G	4	8	12	0	0	12	0	0
10	24727127	.	A	G	3	3	6	0	0	6	0	0
10	24762377	.	G	A	1	2	3	0	0	3	0	0
10	24762462	.	T	C	4	0	4	0	7	11	0	0
10	24762510	.	A	G	5	7	12	0	0	12	0	0
10	24762723	.	A	G	10	5	15	0	0	15	0	0
10	24765589	.	A	C	3	4	7	0	1	8	0	0
10	24765893	.	A	G	7	6	13	0	0	13	0	0
10	25109156	.	T	G	1	3	4	0	1	5	0	0
10	25109225	.	A	C	4	7	11	0	0	11	0	0
10	25109492	.	C	T	3	2	5	0	1	6	0	0
10	25153410	.	T	C	2	1	3	0	0	3	0	0
10	25153416	.	G	A	3	2	5	0	0	5	0	0
10	25153929	.	A	T	2	4	6	0	0	6	0	0
10	25153942	.	A	G	2	3	5	0	0	5	0	0
10	25158411	.	T	C	2	0	2	0	2	4	0	0
10	25202867	.	A	C	1	2	3	0	0	3	0	0
10	25205354	.	A	C	8	9	17	0	2	19	0	0
10	25212215	.	C	G	14	1	15	0	17	32	0	0
10	25219757	.	A	G	4	2	6	0	0	6	0	0
10	25219804	.	A	C	17	14	31	0	1	32	0	0
10	25219805	.	A	G	17	0	17	0	15	32	0	0
10	25222392	.	G	T	19	10	29	0	0	29	0	0
10	25222426	.	T	C	17	7	24	0	1	25	0	0
10	25232341	.	G	A	0	6	6	0	7	13	0	0
10	25250373	.	C	T	7	7	14	0	1	15	0	0
10	25250493	.	T	A	8	7	15	0	1	16	0	0
10	25252426	.	G	A	16	6	22	0	1	23	0	0
10	25252474	.	C	T	18	13	31	0	0	31	0	0
10	25252591	.	A	G	11	17	28	0	0	28	0	0
10	25252899	.	T	C	11	8	19	0	0	19	0	0
10	25261968	.	A	C	19	15	34	0	0	34	0	0
10	25262150	.	T	A	12	19	31	0	1	32	0	0
10	25262336	.	C	T	16	17	33	0	2	36	1	0
10	25267829	.	A	T	12	31	43	0	8	51	0	0
10	25267952	.	T	C	26	13	39	0	3	42	0	0
10	25268389	.	T	C	23	6	29	0	1	30	0	0
10	25268827	.	C	T	4	3	7	0	0	7	0	0
10	25269148	.	G	A	7	3	10	0	0	10	0	0
10	25269170	.	C	A	9	3	12	0	0	12	0	0
10	25269245	.	C	T	15	18	33	2	2	37	0	0
10	25269413	.	A	G	19	20	39	0	2	41	0	0
10	25269470	.	A	G	16	27	43	0	2	45	0	0
10	25269747	.	T	A	23	20	43	0	1	44	0	0
10	25270044	.	C	A	22	19	41	1	3	45	0	0
10	25270096	.	T	C	33	14	47	1	1	50	1	0
10	25270618	.	C	G	27	11	38	0	1	39	0	0
10	25270643	.	A	G	31	8	39	0	1	40	0	0
10	25270942	.	G	C	17	13	30	0	1	31	0	0
10	25270958	.	C	T	17	13	30	0	0	30	0	0
10	25271051	.	T	A	10	13	23	0	1	24	0	0
10	25271338	.	T	C	8	14	22	0	3	26	1	0
10	25312889	.	T	A	4	6	10	0	0	10	0	0
10	25313204	.	G	A	5	5	10	0	1	11	0	0
10	25317306	.	A	G	3	7	10	0	0	10	0	0
10	25321269	.	T	C	6	0	6	0	8	14	0	0
10	25325361	.	A	G	7	6	13	0	0	13	0	0
10	25329811	.	C	A	2	25	27	0	29	57	1	0
10	25333961	.	C	T	1	19	20	0	24	44	0	0
10	25334178	.	T	C	25	14	39	0	0	39	0	0
10	25342889	.	A	G	24	15	39	0	1	40	0	0
10	25373950	.	C	T	1	2	3	0	0	3	0	0
10	25374652	.	G	A	1	3	4	0	0	4	0	0
10	25381265	.	C	G	5	3	8	0	1	9	0	0
10	25381304	.	G	A	2	2	4	0	1	5	0	0
10	25381349	.	G	C	2	2	4	0	0	4	0	0
10	25381721	.	T	C	2	2	4	0	0	4	0	0
10	25381742	.	G	T	0	2	2	0	1	3	0	0
10	25383998	.	C	A	1	3	4	0	0	4	0	0
10	25384182	.	A	G	1	2	3	0	0	3	0	0
10	25384185	.	G	T	1	2	3	0	0	3	0	0
10	25403111	.	T	A	1	2	3	0	0	3	0	0
10	25403153	.	C	T	0	4	4	0	1	5	0	0
10	25403280	.	C	G	0	6	6	0	2	8	0	0
10	25410276	.	T	C	3	1	4	0	7	11	0	0
10	25410288	.	A	G	4	8	12	0	0	12	0	0
10	25435194	.	A	G	6	3	9	0	0	9	0	0
10	25435335	.	G	C	1	0	1	0	9	10	0	0
10	25436518	.	C	A	3	5	8	0	0	8	0	0
10	25462325	.	A	T	2	3	5	0	1	6	0	0
10	25573333	.	G	A	11	9	20	0	0	20	0	0
10	25573393	.	T	C	7	0	7	0	6	13	0	0
10	25573410	.	T	C	4	8	12	0	0	12	0	0
10	25573436	.	C	G	5	8	13	0	1	14	0	0
10	25574092	.	T	C	8	0	8	0	5	13	0	0
10	25574127	.	T	A	2	6	8	0	0	9	1	0
10	25574159	.	T	C	3	9	12	0	0	12	0	0
10	25574171	.	A	G	2	8	10	0	0	10	0	0
10	25581999	.	G	A	10	7	17	0	1	18	0	0
10	25582029	.	A	G	9	10	19	0	0	19	0	0
10	25582101	.	G	A	7	13	20	0	0	20	0	0
10	25582689	.	G	A	4	5	9	0	1	10	0	0
10	25582854	.	G	A	7	2	9	0	2	11	0	0
10	25582920	.	T	C	7	5	12	0	0	12	0	0
10	25585179	.	A	G	9	7	16	0	0	16	0	0
10	25601711	.	A	G	6	2	8	0	0	8	0	0
10	25601799	.	T	C	3	8	11	0	0	11	0	0
10	25601838	.	G	A	5	6	11	0	1	12	0	0
10	25612580	.	C	T	0	4	4	0	3	7	0	0
10	25612581	.	G	C	3	4	7	0	0	7	0	0
10	25615597	.	A	G	3	5	8	0	0	8	0	0
10	25620904	.	G	A	3	4	7	0	1	8	0	0
10	25657262	.	T	G	5	3	8	0	0	8	0	0
10	25694637	.	G	A	26	22	48	0	1	49	0	0
10	25694844	.	G	A	29	24	53	0	0	53	0	0
10	25694848	.	C	T	29	24	53	0	0	53	0	0
10	25701659	.	G	C	9	15	24	0	2	26	0	0
10	25704345	.	C	T	11	5	16	0	1	17	0	0
10	25706228	.	G	A	13	5	18	0	0	18	0	0
10	25709379	.	A	G	4	2	6	0	0	6	0	0
10	25709721	.	A	C	4	9	13	0	0	13	0	0
10	25709764	.	T	A	8	6	14	0	0	14	0	0
10	25712724	.	C	T	0	8	8	0	7	15	0	0
10	25712820	.	G	A	6	3	9	0	1	10	0	0
10	25762652	.	C	T	0	3	3	0	1	4	0	0
10	25831924	.	A	G	1	8	9	0	1	10	0	0
10	25834684	.	A	G	4	3	7	0	0	7	0	0
10	25837574	.	T	G	4	7	11	0	0	11	0	0
10	25840894	.	A	G	2	3	5	0	0	5	0	0
10	25841020	.	G	A	1	4	5	0	1	6	0	0
10	25859735	.	T	A	3	4	7	0	0	7	0	0
10	26225398	.	T	C	8	0	8	0	9	17	0	0
10	26225479	.	T	C	4	0	4	0	6	10	0	0
10	26269728	.	G	A	5	4	9	0	0	9	0	0
10	26269842	.	T	C	3	7	10	0	0	10	0	0
10	26270064	.	C	A	3	4	7	0	1	8	0	0
10	26270847	.	T	C	11	0	11	0	7	18	0	0
10	26271018	.	G	C	12	0	12	0	8	20	0	0
10	26271357	.	C	A	4	3	7	0	0	7	0	0
10	26271522	.	T	C	8	10	18	0	0	18	0	0
10	26271672	.	G	C	7	3	10	0	0	10	0	0
10	26271852	.	C	T	4	3	7	0	0	7	0	0
10	26271855	.	T	C	4	3	7	0	0	7	0	0
10	26272062	.	G	T	4	4	8	0	0	8	0	0
10	26272338	.	C	G	1	3	4	0	3	7	0	0
10	26272756	.	T	C	5	0	5	0	4	9	0	0
10	26272941	.	A	T	1	5	6	0	0	6	0	0
10	26274479	.	A	G	5	2	7	0	0	7	0	0
10	26275967	.	A	G	4	2	6	0	0	6	0	0
10	26276019	.	C	T	0	3	3	0	2	5	0	0
10	26279001	.	G	A	3	5	8	0	1	9	0	0
10	26279519	.	T	C	3	4	7	0	0	7	0	0
10	26282195	.	C	A	0	5	5	0	1	6	0	0
10	26282196	.	G	A	1	5	6	0	0	6	0	0
10	26285271	.	G	T	1	5	6	0	0	6	0	0
10	26285280	.	C	T	1	3	4	0	1	5	0	0
10	26296608	.	T	C	3	3	6	0	0	6	0	0
10	26297430	.	G	A	4	4	8	0	0	8	0	0
10	26299819	.	T	G	1	2	3	0	0	3	0	0
10	26299849	.	T	C	1	0	1	0	2	3	0	0
10	26305388	.	G	C	3	2	5	0	0	5	0	0
10	26408795	.	A	G	1	2	3	0	0	3	0	0
10	26409356	.	G	A	2	3	5	0	0	5	0	0
10	26409362	.	C	T	2	2	4	0	1	5	0	0
10	26409971	.	C	T	1	2	3	0	0	3	0	0
10	26409989	.	A	T	1	2	3	0	0	3	0	0
10	26508150	.	A	C	3	3	6	0	1	7	0	0
10	26508775	.	A	C	3	0	3	0	3	6	0	0
10	26512779	.	G	A	1	2	3	0	0	3	0	0
10	26517207	.	A	T	11	8	19	0	0	19	0	0
10	26517214	.	C	T	13	7	20	0	0	20	0	0
10	26517569	.	G	A	0	10	10	0	13	23	0	0
10	26522813	.	G	A	1	7	8	0	9	17	0	0
10	26540432	.	A	G	9	10	19	0	0	19	0	0
10	26541145	.	G	A	14	16	30	0	5	35	0	0
10	26551191	.	T	A	14	18	32	0	1	33	0	0
10	26551492	.	A	G	14	24	38	0	9	47	0	0
10	26558704	.	C	T	26	30	56	1	4	61	0	0
10	26560166	.	T	C	27	25	52	0	0	52	0	0
10	26560366	.	G	A	3	14	17	1	33	51	0	0
10	26560392	.	C	A	32	16	48	1	2	51	0	0
10	26565704	.	T	C	25	33	58	0	2	60	0	0
10	26565760	.	G	A	2	34	36	0	20	56	0	0
10	26566054	.	G	C	7	23	30	0	19	49	0	0
10	26566267	.	T	C	19	22	41	0	6	47	0	0
10	26566354	.	A	T	18	21	39	0	1	40	0	0
10	26566369	.	A	T	20	14	34	0	1	35	0	0
10	26566715	.	T	A	12	11	23	0	0	23	0	0
10	26566749	.	G	A	18	8	26	0	0	26	0	0
10	26566785	.	T	A	22	9	31	0	1	32	0	0
10	26566787	.	A	T	23	9	32	0	1	33	0	0
10	26566855	.	A	G	23	1	24	0	8	32	0	0
10	26566970	.	T	G	15	1	16	0	15	31	0	0
10	26567127	.	G	A	4	22	26	0	15	41	0	0
10	26567238	.	A	G	24	28	52	0	1	53	0	0
10	26567337	.	C	T	15	29	44	0	3	47	0	0
10	26567376	.	C	G	12	27	39	0	3	42	0	0
10	26567500	.	C	T	13	24	37	0	2	39	0	0
10	26567656	.	G	C	20	16	36	0	2	38	0	0
10	26567810	.	C	T	13	23	36	0	1	37	0	0
10	26567889	.	T	A	16	5	21	0	0	21	0	0
10	26567958	.	T	A	17	13	30	0	0	30	0	0
10	26568154	.	A	T	9	15	24	0	0	24	0	0
10	26568166	.	C	T	8	13	21	0	1	22	0	0
10	26568201	.	A	G	6	5	11	0	0	11	0	0
10	26568239	.	C	T	10	6	16	0	0	16	0	0
10	26568429	.	A	C	19	22	41	0	1	42	0	0
10	26568498	.	T	C	21	22	43	0	0	43	0	0
10	26568523	.	G	T	20	20	40	0	0	40	0	0
10	26568726	.	A	G	24	26	50	0	0	50	0	0
10	26569098	.	A	G	13	0	13	0	22	35	0	0
10	26569099	.	A	C	14	21	35	0	0	35	0	0
10	26569248	.	C	A	12	6	18	0	5	23	0	0
10	26574004	.	T	C	12	6	18	0	2	20	0	0
10	26583978	.	C	G	18	10	28	0	2	30	0	0
10	26596020	.	T	A	23	22	45	0	1	46	0	0
10	26596075	.	C	T	22	20	42	0	1	43	0	0
10	26596080	.	T	C	20	18	38	0	1	39	0	0
10	26652886	.	T	C	1	2	3	0	0	3	0	0
10	26656135	.	A	C	11	8	19	0	1	20	0	0
10	26656240	.	C	T	14	6	20	0	2	22	0	0
10	26656500	.	G	A	13	9	22	0	0	22	0	0
10	26656527	.	A	G	13	9	22	0	2	24	0	0
10	26659245	.	C	T	16	14	30	0	0	30	0	0
10	26661469	.	T	C	12	14	26	0	0	26	0	0
10	26662046	.	G	A	11	19	30	0	0	30	0	0
10	26666823	.	C	T	12	12	24	1	4	29	0	0
10	26666839	.	T	C	11	15	26	1	3	30	0	0
10	26692581	.	C	T	2	3	5	0	0	5	0	0
10	26717156	.	T	A	12	18	30	0	1	32	1	0
10	26717246	.	G	A	13	11	24	0	1	25	0	0
10	26717740	.	A	G	21	11	32	0	1	33	0	0
10	26717963	.	G	A	16	10	26	1	0	27	0	0
10	26729687	.	T	C	14	7	21	0	0	21	0	0
10	26744012	.	A	G	9	7	16	0	1	17	0	0
10	26753415	.	C	G	2	2	4	0	0	4	0	0
10	26762841	.	C	A	5	5	10	0	1	11	0	0
10	26765526	.	T	C	9	10	19	0	0	19	0	0
10	26766154	.	C	T	8	6	14	0	0	14	0	0
10	26766550	.	G	C	2	2	4	0	0	4	0	0
10	26774709	.	T	G	12	11	23	0	0	23	0	0
10	26774943	.	G	A	5	9	14	0	0	14	0	0
10	26777572	.	A	G	7	7	14	0	0	14	0	0
10	26777774	.	T	C	10	5	15	0	0	15	0	0
10	26780983	.	T	C	5	11	16	0	0	16	0	0
10	26781140	.	T	C	2	5	7	0	1	8	0	0
10	26781419	.	T	C	7	0	7	0	10	17	0	0
10	26783968	.	C	T	10	7	17	0	1	18	0	0
10	26785456	.	G	T	4	8	12	0	0	12	0	0
10	26785477	.	A	G	2	5	7	0	0	7	0	0
10	26788593	.	C	A	6	6	12	0	0	12	0	0
10	26790603	.	G	A	9	6	15	0	1	16	0	0
10	26790668	.	T	C	6	6	12	0	0	12	0	0
10	26791027	.	G	A	3	9	12	0	1	13	0	0
10	26831923	.	G	A	5	2	7	0	0	7	0	0
10	26831965	.	G	T	6	4	10	1	0	11	0	0
10	26835004	.	G	A	12	14	26	0	1	27	0	0
10	26835024	.	T	C	8	15	23	0	0	23	0	0
10	26835066	.	A	C	6	12	18	0	0	18	0	0
10	26835081	.	T	A	10	4	14	0	0	14	0	0
10	26835172	.	T	C	1	7	8	3	0	11	0	0
10	26835299	.	G	A	7	9	16	0	3	19	0	0
10	26835595	.	G	A	4	10	14	0	4	18	0	0
10	26836990	.	G	A	8	19	27	0	1	28	0	0
10	26898897	.	G	A	0	2	2	0	2	4	0	0
10	26899289	.	G	A	1	2	3	0	0	3	0	0
10	26899304	.	C	G	2	2	4	0	0	4	0	0
10	26922450	.	T	C	1	3	4	0	1	5	0	0
10	26924042	.	A	G	3	2	5	0	0	5	0	0
10	26929291	.	A	T	20	30	50	0	0	50	0	0
10	26929459	.	C	T	25	10	35	0	0	36	1	0
10	26930061	.	C	A	22	16	38	0	0	38	0	0
10	26932632	.	C	T	13	15	28	0	1	29	0	0
10	26958321	.	T	G	6	1	7	0	6	14	1	0
10	26958457	.	A	G	8	5	13	0	0	13	0	0
10	26958470	.	G	C	5	7	12	0	0	12	0	0
10	26958779	.	A	G	4	4	8	0	0	8	0	0
10	26958928	.	A	G	4	0	4	0	3	7	0	0
10	26958972	.	C	A	3	4	7	0	0	7	0	0
10	26959523	.	T	G	3	2	5	0	1	6	0	0
10	26959528	.	T	C	4	2	6	0	0	6	0	0
10	26959744	.	G	A	7	4	11	0	0	11	0	0
10	26959811	.	A	G	4	9	13	0	0	13	0	0
10	26959894	.	C	A	7	2	9	0	0	9	0	0
10	26960015	.	C	T	4	4	8	0	0	8	0	0
10	26960212	.	A	T	3	5	8	0	0	8	0	0
10	26960281	.	A	G	6	6	12	0	0	12	0	0
10	26960333	.	T	A	2	2	4	0	0	4	0	0
10	26960358	.	G	A	2	2	4	0	0	4	0	0
10	26962406	.	T	C	5	6	11	0	0	11	0	0
10	26963839	.	T	A	4	5	9	0	1	10	0	0
10	26965668	.	C	G	9	4	13	0	0	13	0	0
10	26966316	.	A	G	10	6	16	0	0	16	0	0
10	26971782	.	C	T	7	9	16	0	0	16	0	0
10	26972064	.	T	C	7	9	16	0	2	18	0	0
10	26972152	.	T	C	14	8	22	0	1	23	0	0
10	26972321	.	T	A	1	3	4	0	0	4	0	0
10	26972349	.	T	C	4	4	8	0	0	8	0	0
10	26972364	.	T	C	4	5	9	0	0	9	0	0
10	26972409	.	G	A	6	3	9	0	0	9	0	0
10	26972877	.	C	G	4	5	9	0	0	9	0	0
10	26973454	.	T	G	4	0	4	0	5	9	0	0
10	26974414	.	T	C	2	5	7	0	0	7	0	0
10	26976990	.	G	A	2	8	10	0	0	10	0	0
10	26982572	.	C	G	4	3	7	0	0	7	0	0
10	26983539	.	G	A	5	2	7	0	0	7	0	0
10	26983612	.	G	T	3	3	6	0	0	6	0	0
10	26983619	.	T	A	2	3	5	0	0	5	0	0
10	26983671	.	C	A	1	3	4	0	1	5	0	0
10	26987399	.	T	C	8	2	10	0	13	23	0	0
10	26989818	.	A	T	13	15	28	0	2	30	0	0
10	26989843	.	A	T	8	15	23	0	0	23	0	0
10	26990173	.	C	T	11	5	16	0	2	18	0	0
10	26991487	.	T	C	10	19	29	0	0	29	0	0
10	26991514	.	C	T	8	15	23	0	1	24	0	0
10	26991556	.	C	T	6	8	14	0	3	17	0	0
10	26991785	.	C	G	3	2	5	0	1	6	0	0
10	26991875	.	A	T	6	3	9	0	1	10	0	0
10	26991876	.	C	G	7	3	10	0	0	10	0	0
10	26997147	.	C	A	14	8	22	1	2	25	0	0
10	26997218	.	G	A	10	9	19	0	1	20	0	0
10	26997222	.	A	T	9	9	18	0	2	20	0	0
10	26999165	.	T	C	9	1	10	0	16	26	0	0
10	27006367	.	A	G	16	17	33	0	2	35	0	0
10	27006386	.	G	A	17	18	35	0	0	35	0	0
10	27006413	.	A	C	18	14	32	0	0	32	0	0
10	27006447	.	T	C	18	12	30	0	0	30	0	0
10	27006490	.	A	G	19	10	29	0	1	30	0	0
10	27006721	.	T	C	22	27	49	0	3	52	0	0
10	28473577	.	C	G	0	3	3	0	11	14	0	0
10	28477749	.	G	A	2	5	7	0	1	8	0	0
10	28483319	.	C	T	5	3	8	0	0	8	0	0
10	28483542	.	A	G	6	4	10	0	0	10	0	0
10	28483561	.	G	A	6	4	10	0	0	10	0	0
10	28483631	.	C	T	0	6	6	0	1	7	0	0
10	28483703	.	T	C	1	0	1	0	2	3	0	0
10	28483869	.	T	C	8	4	12	0	0	12	0	0
10	28519381	.	A	G	3	3	6	0	0	6	0	0
10	28519447	.	T	G	1	1	2	0	1	3	0	0
10	28587609	.	G	C	1	5	6	0	0	6	0	0
10	28587703	.	C	T	2	5	7	0	0	7	0	0
10	28679049	.	G	A	0	5	5	0	6	11	0	0
10	28690862	.	T	G	1	0	1	0	5	6	0	0
10	28691024	.	C	T	3	6	9	0	0	9	0	0
10	28696000	.	A	G	7	0	7	0	9	16	0	0
10	28696336	.	C	A	7	6	13	0	0	13	0	0
10	28724220	.	G	A	6	13	19	0	0	19	0	0
10	28727265	.	C	T	6	6	12	0	0	12	0	0
10	28727461	.	C	T	7	14	21	0	0	21	0	0
10	28729808	.	G	C	4	3	7	0	0	7	0	0
10	28730216	.	C	T	6	8	14	0	0	14	0	0
10	28730249	.	C	T	9	5	14	0	0	14	0	0
10	28730345	.	T	A	7	6	13	0	1	14	0	0
10	28730446	.	A	C	3	8	11	0	0	11	0	0
10	28730880	.	T	A	10	8	18	0	0	18	0	0
10	28730913	.	G	A	13	13	26	0	2	28	0	0
10	28731001	.	C	T	8	14	22	0	2	24	0	0
10	28731072	.	C	T	8	9	17	0	0	17	0	0
10	28731155	.	A	T	8	5	13	1	1	15	0	0
10	28731289	.	T	C	12	6	18	0	1	19	0	0
10	28731333	.	C	T	5	7	12	0	0	12	0	0
10	28731372	.	G	A	1	6	7	0	8	15	0	0
10	28732003	.	C	A	17	17	34	0	2	36	0	0
10	28732104	.	T	C	13	11	24	0	0	24	0	0
10	28732601	.	C	T	3	19	22	0	10	32	0	0
10	28732785	.	T	C	19	11	30	0	3	33	0	0
10	28733067	.	G	T	15	22	37	0	2	39	0	0
10	28743800	.	T	A	15	14	29	0	1	30	0	0
10	28745833	.	G	A	11	14	25	0	3	28	0	0
10	28748741	.	C	T	2	11	13	0	11	24	0	0
10	28749053	.	A	G	8	10	18	0	1	19	0	0
10	28761022	.	C	T	11	8	19	0	2	21	0	0
10	28761049	.	C	T	13	12	25	0	0	25	0	0
10	28761094	.	G	A	14	15	29	0	0	29	0	0
10	28761100	.	G	A	16	12	28	0	1	29	0	0
10	28835635	.	C	G	12	5	17	0	1	18	0	0
10	28835655	.	G	A	10	8	18	0	0	18	0	0
10	28835701	.	A	T	11	8	19	0	2	21	0	0
10	29166445	.	A	G	8	10	18	0	1	19	0	0
10	29185800	.	C	G	17	0	17	0	20	37	0	0
10	29185863	.	T	A	25	13	38	0	1	39	0	0
10	29187908	.	C	T	25	6	31	1	0	32	0	0
10	29201671	.	C	T	8	11	19	1	2	22	0	0
10	29205655	.	A	T	13	13	26	0	3	29	0	0
10	29205679	.	G	T	1	17	18	0	12	30	0	0
10	29223795	.	T	C	4	3	7	0	0	7	0	0
10	29224331	.	G	T	2	2	4	0	0	4	0	0
10	29224364	.	C	T	2	6	8	2	4	14	0	0
10	29224484	.	G	A	12	17	29	0	1	30	0	0
10	29224598	.	A	T	19	8	27	0	0	27	0	0
10	29224651	.	C	A	14	9	23	1	1	25	0	0
10	29225032	.	A	G	10	3	13	0	6	19	0	0
10	29266376	.	C	T	28	22	50	0	1	51	0	0
10	29268521	.	T	A	4	4	8	0	0	8	0	0
10	29268551	.	T	A	1	4	5	0	0	5	0	0
10	29270092	.	A	C	2	7	9	0	0	9	0	0
10	29270225	.	C	T	5	6	11	0	0	11	0	0
10	29270291	.	T	C	5	9	14	0	1	15	0	0
10	29271915	.	C	T	5	16	21	0	1	22	0	0
10	29271980	.	A	C	11	0	11	0	11	22	0	0
10	29272693	.	C	T	11	7	18	0	1	19	0	0
10	29561191	.	A	G	7	10	17	0	1	18	0	0
10	29575542	.	C	T	11	6	17	0	0	17	0	0
10	29578478	.	C	T	18	9	27	0	1	28	0	0
10	29578738	.	C	T	9	16	25	0	1	26	0	0
10	29578756	.	G	T	17	14	31	0	1	32	0	0
10	29678313	.	G	A	10	16	26	0	1	27	0	0
10	29701347	.	C	T	11	14	25	0	2	27	0	0
10	29701405	.	G	A	3	11	14	0	17	31	0	0
10	29702103	.	G	A	10	14	24	0	0	24	0	0
10	29708080	.	C	T	17	10	27	0	1	28	0	0
10	29708095	.	T	A	15	9	24	0	1	25	0	0
10	29708154	.	A	G	17	0	17	0	13	30	0	0
10	29736255	.	G	C	1	1	2	0	1	3	0	0
10	29736736	.	T	C	11	0	11	0	17	28	0	0
10	29736895	.	T	A	8	5	13	0	0	13	0	0
10	29738555	.	C	T	6	9	15	0	0	15	0	0
10	29742656	.	C	T	11	11	22	0	1	23	0	0
10	29742795	.	T	C	13	17	30	0	0	30	0	0
10	29751638	.	G	T	17	12	29	0	1	30	0	0
10	29754464	.	G	T	12	11	23	0	0	23	0	0
10	29759186	.	A	G	12	18	30	0	1	31	0	0
10	29761405	.	C	T	13	11	24	0	1	25	0	0
10	29763146	.	A	G	13	6	19	0	0	19	0	0
10	29766766	.	C	T	10	5	15	0	0	15	0	0
10	29766795	.	T	C	4	9	13	0	0	13	0	0
10	29767566	.	C	A	6	7	13	0	0	13	0	0
10	29768405	.	G	T	12	9	21	0	0	21	0	0
10	29770277	.	C	T	3	9	12	0	0	12	0	0
10	29770329	.	G	T	5	3	8	0	0	8	0	0
10	29770388	.	G	C	5	1	6	0	1	7	0	0
10	29772167	.	A	G	7	6	13	0	0	13	0	0
10	29778375	.	A	G	7	0	7	0	7	14	0	0
10	29778396	.	C	T	8	8	16	0	0	16	0	0
10	29781448	.	T	C	6	6	12	0	0	12	0	0
10	29785682	.	C	A	10	12	22	0	3	25	0	0
10	29794161	.	C	A	1	2	3	0	0	3	0	0
10	29798724	.	A	G	1	2	3	0	0	3	0	0
10	29820495	.	G	A	6	3	9	0	0	9	0	0
10	29823484	.	G	A	11	5	16	0	1	17	0	0
10	29828696	.	T	G	6	6	12	0	0	12	0	0
10	29831556	.	G	A	5	4	9	0	0	9	0	0
10	29851177	.	C	T	38	22	60	0	2	62	0	0
10	29853684	.	A	G	9	4	13	3	13	29	0	0
10	29892283	.	C	T	0	2	2	0	6	8	0	0
10	29892382	.	C	T	7	6	13	0	0	13	0	0
10	29892478	.	C	T	4	2	6	0	0	6	0	0
10	29963638	.	G	A	3	5	8	0	0	8	0	0
10	30540800	.	C	T	6	6	12	0	0	12	0	0
10	30576004	.	T	C	9	15	24	0	0	24	0	0
10	30618121	.	C	T	6	3	9	0	0	9	0	0
10	30623408	.	G	A	10	11	21	0	0	21	0	0
10	30627092	.	A	T	10	14	24	0	2	26	0	0
10	30691384	.	C	T	8	5	13	0	0	13	0	0
10	30785055	.	T	G	8	8	16	0	0	16	0	0
10	30785463	.	G	A	7	7	14	0	0	14	0	0
10	31020810	.	A	G	4	4	8	0	0	8	0	0
10	31021450	.	C	T	2	8	10	0	1	11	0	0
10	31021553	.	G	A	10	13	23	0	1	24	0	0
10	31021611	.	C	T	9	11	20	0	2	22	0	0
10	31021676	.	G	A	12	19	31	0	2	33	0	0
10	31021811	.	C	T	0	11	11	0	15	26	0	0
10	31023824	.	C	T	14	14	28	0	0	28	0	0
10	31031543	.	C	T	0	11	11	0	10	21	0	0
10	31032043	.	T	C	15	4	19	0	1	20	0	0
10	31034999	.	C	T	0	18	18	0	10	28	0	0
10	31035030	.	G	A	14	8	22	0	0	22	0	0
10	31035129	.	C	T	10	11	21	0	1	22	0	0
10	31040834	.	G	A	4	5	9	0	1	10	0	0
10	31223377	.	A	T	2	3	5	0	0	5	0	0
10	31263329	.	G	A	1	3	4	0	0	4	0	0
10	31267625	.	A	G	2	0	2	0	3	5	0	0
10	31270495	.	G	T	0	2	2	0	2	4	0	0
10	31275451	.	C	G	4	0	4	0	6	10	0	0
10	31276808	.	T	C	8	4	12	0	0	12	0	0
10	31280293	.	G	A	2	3	5	0	0	5	0	0
10	31280410	.	C	T	3	5	8	0	0	8	0	0
10	31280554	.	A	T	0	6	6	0	0	6	0	0
10	31280980	.	A	T	4	2	6	0	0	6	0	0
10	31306727	.	C	T	4	12	16	0	12	28	0	0
10	31306956	.	C	G	0	18	18	1	15	34	0	0
10	31315631	.	C	T	0	14	14	0	12	26	0	0
10	31317976	.	T	C	16	11	27	0	5	32	0	0
10	31317978	.	A	G	17	14	31	0	1	32	0	0
10	31325248	.	C	A	14	13	27	0	0	27	0	0
10	31326235	.	T	C	12	0	12	0	7	19	0	0
10	31328373	.	A	T	10	12	22	0	1	23	0	0
10	31328531	.	C	T	8	8	16	0	2	18	0	0
10	31328609	.	G	A	9	14	23	0	0	23	0	0
10	31328612	.	A	C	14	9	23	0	0	23	0	0
10	31337822	.	G	A	6	13	19	0	1	20	0	0
10	31354096	.	A	G	2	7	9	0	0	9	0	0
10	31562787	.	T	C	1	2	3	0	0	3	0	0
10	31624750	.	G	A	5	2	7	0	0	7	0	0
10	31628325	.	A	C	8	3	11	0	0	11	0	0
10	31628397	.	C	T	5	3	8	0	0	8	0	0
10	31628406	.	C	T	5	4	9	0	0	9	0	0
10	31632313	.	G	C	2	7	9	0	0	9	0	0
10	31632691	.	G	A	8	3	11	0	0	11	0	0
10	31632758	.	A	T	11	5	16	0	0	16	0	0
10	31632829	.	A	G	5	5	10	0	0	10	0	0
10	31632838	.	C	T	4	4	8	0	0	8	0	0
10	31632945	.	C	T	6	4	10	0	0	10	0	0
10	31633273	.	T	C	1	2	3	0	0	3	0	0
10	31633424	.	A	G	3	1	4	0	0	4	0	0
10	31633438	.	T	A	3	2	5	0	0	5	0	0
10	31633640	.	G	A	3	5	8	0	3	11	0	0
10	31646096	.	G	A	1	4	5	0	0	5	0	0
10	31725404	.	C	T	6	4	10	0	0	10	0	0
10	31725473	.	G	A	0	3	3	0	3	6	0	0
10	31725697	.	C	T	2	3	5	0	0	5	0	0
10	31725736	.	T	C	3	4	7	0	0	7	0	0
10	31726055	.	A	C	2	2	4	0	0	4	0	0
10	31726068	.	G	A	3	2	5	0	0	5	0	0
10	31738616	.	A	G	4	5	9	0	1	10	0	0
10	31739346	.	G	T	29	35	64	0	1	65	0	0
10	31757307	.	C	T	26	22	48	0	1	49	0	0
10	31772112	.	A	G	28	25	53	1	0	54	0	0
10	31800313	.	A	G	12	10	22	0	0	22	0	0
10	31803651	.	G	A	11	13	24	1	0	25	0	0
10	31805648	.	C	T	9	9	18	0	0	18	0	0
10	31805736	.	G	A	9	4	13	0	1	14	0	0
10	31951383	.	G	A	4	4	8	0	0	8	0	0
10	31951431	.	G	A	5	6	11	0	0	11	0	0
10	31951489	.	G	T	4	3	7	0	0	7	0	0
10	31953565	.	A	G	5	4	9	0	0	9	0	0
10	31953627	.	T	C	3	2	5	0	0	5	0	0
10	31953744	.	C	A	2	5	7	0	0	7	0	0
10	32036978	.	G	A	2	3	5	0	1	6	0	0
10	32037208	.	T	A	1	3	4	0	0	4	0	0
10	32037355	.	C	T	1	2	3	1	0	4	0	0
10	32037373	.	T	C	1	3	4	1	0	5	0	0
10	32058854	.	C	T	2	3	5	0	0	5	0	0
10	32062333	.	G	A	2	2	4	0	0	4	0	0
10	32063266	.	T	A	3	2	5	0	0	5	0	0
10	32063275	.	A	G	3	0	3	0	2	5	0	0
10	32063401	.	C	T	2	3	5	0	0	5	0	0
10	32063752	.	G	A	4	4	8	0	1	9	0	0
10	32063809	.	A	G	2	7	9	0	0	9	0	0
10	32071029	.	G	A	3	3	6	0	0	6	0	0
10	32071949	.	A	G	2	2	4	0	0	4	0	0
10	32106162	.	G	A	1	2	3	0	0	3	0	0
10	32106223	.	G	A	1	2	3	0	3	6	0	0
10	32122662	.	C	T	2	2	4	0	1	5	0	0
10	32561338	.	G	A	5	9	14	0	0	14	0	0
10	32561392	.	A	T	9	17	26	0	1	27	0	0
10	32561398	.	G	A	2	17	19	0	10	29	0	0
10	32561427	.	A	C	22	12	34	0	0	34	0	0
10	32561437	.	T	A	21	12	33	0	2	35	0	0
10	32561615	.	C	G	11	8	19	0	1	20	0	0
10	32562267	.	C	T	19	10	29	0	1	30	0	0
10	32577621	.	G	A	15	12	27	0	0	27	0	0
10	32581221	.	G	A	17	11	28	0	0	28	0	0
10	32600809	.	A	G	5	0	5	0	5	10	0	0
10	32600810	.	T	C	5	5	10	0	0	10	0	0
10	32600927	.	C	T	23	15	38	0	1	39	0	0
10	32648649	.	C	T	3	6	9	0	0	9	0	0
10	32648799	.	C	T	3	7	10	0	0	10	0	0
10	32657586	.	A	G	6	2	8	0	0	8	0	0
10	32657591	.	C	A	3	7	10	0	0	10	0	0
10	32657893	.	G	A	11	14	25	0	2	27	0	0
10	32657980	.	A	G	21	15	36	0	0	36	0	0
10	32660658	.	A	C	3	2	5	0	0	5	0	0
10	32780271	.	A	C	22	13	35	0	2	37	0	0
10	32783974	.	A	C	14	13	27	0	1	28	0	0
10	32787910	.	C	T	13	13	26	0	1	27	0	0
10	32788457	.	A	T	10	15	25	0	1	26	0	0
10	32788504	.	A	T	11	10	21	0	2	23	0	0
10	32788633	.	T	C	25	17	42	0	1	43	0	0
10	32788663	.	T	C	25	17	42	0	1	43	0	0
10	32809986	.	G	C	17	13	30	0	0	30	0	0
10	32810279	.	T	A	8	10	18	0	4	22	0	0
10	32810340	.	A	T	15	7	22	0	0	22	0	0
10	32810579	.	T	C	7	0	7	0	7	14	0	0
10	32810593	.	A	T	7	3	10	0	0	10	0	0
10	32811010	.	C	T	0	4	4	0	5	9	0	0
10	32811102	.	T	A	13	4	17	0	1	18	0	0
10	32817924	.	C	A	1	12	13	0	11	24	0	0
10	32820412	.	A	G	8	11	19	0	2	21	0	0
10	32820426	.	T	A	12	12	24	0	1	25	0	0
10	32820451	.	G	T	12	16	28	0	0	28	0	0
10	32820577	.	T	C	12	1	13	0	17	30	0	0
10	32823131	.	C	T	11	15	26	0	0	26	0	0
10	32823146	.	G	A	15	13	28	0	0	28	0	0
10	32831269	.	G	A	14	18	32	0	0	32	0	0
10	32831671	.	T	C	14	0	14	0	7	21	0	0
10	32831683	.	C	G	8	11	19	0	0	19	0	0
10	32840835	.	C	T	1	18	19	0	11	30	0	0
10	32843827	.	C	G	7	9	16	0	0	16	0	0
10	32851687	.	C	G	9	11	20	0	0	21	1	0
10	32856993	.	C	A	1	2	3	0	0	3	0	0
10	32856999	.	T	A	2	2	4	0	0	4	0	0
10	32857034	.	C	G	6	2	8	0	0	8	0	0
10	32857557	.	T	C	12	7	19	0	1	20	0	0
10	32857738	.	A	G	6	9	15	0	0	15	0	0
10	32857746	.	A	T	10	7	17	0	0	17	0	0
10	32857898	.	C	T	8	11	19	0	1	20	0	0
10	32857948	.	T	G	9	10	19	0	1	20	0	0
10	32858020	.	C	T	7	12	19	0	1	20	0	0
10	32858023	.	C	T	12	4	16	0	2	18	0	0
10	32858107	.	A	G	16	12	28	2	0	30	0	0
10	32858132	.	T	C	17	0	17	0	16	33	0	0
10	32858158	.	C	G	13	21	34	1	1	36	0	0
10	32858215	.	T	A	19	13	32	0	0	32	0	0
10	32858361	.	T	C	16	19	35	0	0	35	0	0
10	32858425	.	G	C	15	14	29	0	2	31	0	0
10	32858607	.	C	T	16	9	25	0	0	25	0	0
10	32858612	.	T	A	9	14	23	0	1	24	0	0
10	32858642	.	G	C	9	14	23	0	0	23	0	0
10	32861106	.	G	A	12	13	25	0	3	28	0	0
10	32861118	.	T	G	9	19	28	0	2	30	0	0
10	32874849	.	G	A	18	17	35	0	2	37	0	0
10	32881787	.	C	T	1	11	12	0	12	24	0	0
10	32881823	.	G	A	8	14	22	0	1	23	0	0
10	32881884	.	C	T	12	13	25	0	0	25	0	0
10	32881904	.	A	G	11	12	23	0	1	24	0	0
10	32882022	.	A	G	6	3	9	0	0	9	0	0
10	32882056	.	G	A	7	6	13	0	0	13	0	0
10	32882080	.	A	T	5	11	16	0	0	16	0	0
10	32882156	.	T	G	14	12	26	0	2	28	0	0
10	32882495	.	T	C	3	9	12	0	0	12	0	0
10	32882515	.	C	T	5	11	16	0	0	16	0	0
10	32882575	.	C	A	5	2	7	0	0	7	0	0
10	32882683	.	G	T	5	19	24	0	2	26	0	0
10	32882686	.	A	T	7	17	24	0	2	26	0	0
10	32882732	.	C	A	5	17	22	0	1	23	0	0
10	32882977	.	C	A	4	18	22	0	7	29	0	0
10	32890201	.	C	T	1	16	17	0	17	34	0	0
10	32899276	.	T	A	8	3	11	0	0	11	0	0
10	32899986	.	T	G	10	9	19	0	2	21	0	0
10	32899988	.	T	C	9	0	9	0	12	21	0	0
10	32900021	.	T	C	13	9	22	0	0	22	0	0
10	32900469	.	T	G	11	8	19	0	1	20	0	0
10	32900642	.	A	T	4	11	15	0	0	15	0	0
10	32901915	.	A	T	8	3	11	0	0	11	0	0
10	32902159	.	T	C	4	0	4	0	5	9	0	0
10	32902481	.	G	C	4	2	6	0	0	6	0	0
10	32903589	.	C	T	0	11	11	0	9	20	0	0
10	32907193	.	G	T	7	6	13	0	0	13	0	0
10	32912847	.	T	G	8	6	14	0	1	15	0	0
10	32912883	.	C	G	6	6	12	0	0	12	0	0
10	32920415	.	A	G	7	4	11	0	0	11	0	0
10	32920529	.	C	A	0	7	7	0	2	9	0	0
10	32920649	.	A	G	11	4	15	0	1	16	0	0
10	32939399	.	C	T	1	7	8	0	7	15	0	0
10	32939426	.	G	A	9	5	14	0	0	14	0	0
10	32939516	.	C	T	4	7	11	0	0	11	0	0
10	32944113	.	A	T	4	3	7	0	1	8	0	0
10	32950508	.	C	T	0	6	6	0	5	11	0	0
10	32963501	.	C	T	0	6	6	0	9	15	0	0
10	32963546	.	A	G	8	3	11	0	1	12	0	0
10	32963555	.	T	C	7	3	10	0	0	10	0	0
10	32963722	.	C	A	6	2	8	0	0	8	0	0
10	32963924	.	G	A	9	6	15	0	3	18	0	0
10	32963960	.	C	G	8	8	16	0	1	17	0	0
10	32964089	.	C	T	0	10	10	0	6	16	0	0
10	33009985	.	T	A	5	6	11	0	0	11	0	0
10	33254930	.	G	A	5	6	11	0	2	13	0	0
10	33255113	.	G	A	5	10	15	0	1	16	0	0
10	33260487	.	G	T	1	6	7	0	1	8	0	0
10	33260681	.	G	T	6	4	10	0	0	10	0	0
10	33260682	.	G	A	4	5	9	0	0	9	0	0
10	33314237	.	T	A	4	6	10	0	0	10	0	0
10	33325241	.	T	C	4	2	6	0	0	6	0	0
10	33340591	.	C	T	2	5	7	0	0	7	0	0
10	33340827	.	T	C	2	2	4	0	2	6	0	0
10	33340828	.	G	T	1	5	6	0	0	6	0	0
10	33342292	.	T	C	3	5	8	0	0	8	0	0
10	33342539	.	C	T	0	3	3	0	1	4	0	0
10	33369973	.	C	A	9	14	23	0	0	23	0	0
10	33373568	.	C	G	0	19	19	0	10	29	0	0
10	33375478	.	C	T	14	9	23	0	2	25	0	0
10	33385363	.	G	A	29	24	53	0	10	63	0	0
10	33389469	.	A	G	30	0	30	0	20	50	0	0
10	33391844	.	G	A	37	18	55	0	1	56	0	0
10	33391930	.	G	A	18	18	36	0	5	41	0	0
10	33392071	.	T	C	19	12	31	0	0	31	0	0
10	33392103	.	G	A	17	12	29	0	1	30	0	0
10	33392199	.	A	G	14	11	25	0	3	28	0	0
10	33392263	.	A	G	16	11	27	1	1	29	0	0
10	33392264	.	C	T	11	16	27	1	0	28	0	0
10	33392370	.	T	C	15	15	30	0	0	30	0	0
10	33574138	.	A	C	1	2	3	0	0	3	0	0
10	33574157	.	A	G	2	2	4	0	0	4	0	0
10	33574332	.	A	T	6	3	9	0	1	10	0	0
10	33576509	.	T	C	8	6	14	0	1	15	0	0
10	33576518	.	T	C	8	5	13	0	1	14	0	0
10	33576551	.	T	C	4	6	10	0	0	10	0	0
10	33578719	.	A	T	1	3	4	0	0	4	0	0
10	33578816	.	T	A	5	7	12	0	0	12	0	0
10	33578981	.	T	G	2	3	5	0	1	6	0	0
10	33580756	.	T	C	0	1	1	0	3	4	0	0
10	33580759	.	G	A	2	3	5	0	0	5	0	0
10	33588095	.	G	T	1	2	3	0	0	3	0	0
10	33588100	.	C	T	1	2	3	0	0	3	0	0
10	33588965	.	C	G	0	2	2	0	1	3	0	0
10	33614545	.	G	A	6	4	10	0	1	11	0	0
10	33618584	.	G	A	1	6	7	0	0	7	0	0
10	33618665	.	A	G	1	5	6	0	0	6	0	0
10	33626390	.	G	T	0	3	3	0	4	7	0	0
10	33626400	.	C	T	4	3	7	0	0	7	0	0
10	33626437	.	A	C	2	3	5	0	0	5	0	0
10	33626475	.	A	G	3	3	6	0	1	7	0	0
10	33646957	.	G	A	4	4	8	0	0	8	0	0
10	33659230	.	C	T	7	2	9	0	0	9	0	0
10	33687994	.	C	T	4	2	6	0	0	6	0	0
10	33861127	.	C	T	4	4	8	0	0	8	0	0
10	33861325	.	C	T	4	2	6	0	0	6	0	0
10	33866987	.	T	A	14	4	18	0	0	18	0	0
10	33867032	.	G	A	11	3	14	0	0	14	0	0
10	33867365	.	C	T	3	5	8	0	1	9	0	0
10	33867394	.	G	A	3	4	7	0	0	7	0	0
10	33880079	.	C	T	1	2	3	0	0	3	0	0
10	33902326	.	C	A	7	6	13	0	4	17	0	0
10	33908183	.	C	A	14	15	29	0	1	30	0	0
10	33908291	.	C	T	18	13	31	0	0	31	0	0
10	33909979	.	G	A	19	16	35	0	2	37	0	0
10	33917015	.	G	A	5	3	8	0	0	8	0	0
10	33921928	.	A	G	9	8	17	0	1	18	0	0
10	33921934	.	T	C	12	9	21	0	0	21	0	0
10	33924255	.	G	A	1	10	11	0	14	25	0	0
10	33928201	.	G	A	1	8	9	0	8	17	0	0
10	33930351	.	T	C	10	17	27	0	0	27	0	0
10	33930780	.	T	G	12	6	18	0	0	18	0	0
10	33932844	.	G	A	14	8	22	0	1	23	0	0
10	33932859	.	C	T	12	7	19	0	2	21	0	0
10	33942126	.	C	T	6	7	13	0	0	13	0	0
10	33942210	.	C	T	13	7	20	1	0	21	0	0
10	33948176	.	C	T	9	11	20	0	0	20	0	0
10	33956690	.	G	A	0	16	16	0	11	27	0	0
10	33957780	.	C	T	10	18	28	0	3	31	0	0
10	33958750	.	T	C	14	18	32	0	2	34	0	0
10	33958813	.	T	C	12	13	25	0	1	26	0	0
10	33960943	.	C	T	16	18	34	0	1	35	0	0
10	33961048	.	G	A	1	18	19	0	15	34	0	0
10	33961093	.	A	T	12	16	28	1	0	29	0	0
10	33982165	.	G	A	17	26	43	0	0	43	0	0
10	33983870	.	A	G	25	18	43	0	3	46	0	0
10	33989820	.	G	A	16	17	33	1	0	34	0	0
10	33994424	.	A	G	23	23	46	0	0	46	0	0
10	33994445	.	A	G	15	22	37	0	1	38	0	0
10	33994475	.	C	T	10	27	37	0	1	38	0	0
10	34011378	.	T	C	2	2	4	0	0	4	0	0
10	34018166	.	C	T	1	2	3	0	0	3	0	0
10	34378110	.	T	G	8	0	8	0	5	13	0	0
10	34383783	.	A	T	12	6	18	0	0	18	0	0
10	34383843	.	G	A	7	6	13	0	0	13	0	0
10	34383858	.	A	G	7	5	12	0	0	12	0	0
10	34388882	.	T	G	8	13	21	0	0	21	0	0
10	34388888	.	G	A	8	13	21	0	0	21	0	0
10	34394653	.	G	A	5	9	14	0	0	14	0	0
10	34396026	.	G	A	12	6	18	0	0	18	0	0
10	34402980	.	T	A	3	2	5	0	0	5	0	0
10	34403615	.	A	G	3	11	14	0	0	14	0	0
10	34403668	.	A	T	8	14	22	0	0	22	0	0
10	34403965	.	A	T	7	6	13	0	0	13	0	0
10	34403980	.	A	G	7	0	7	0	7	14	0	0
10	34404015	.	G	A	6	3	9	0	1	10	0	0
10	34404028	.	T	G	7	6	13	0	0	13	0	0
10	34404154	.	T	C	1	3	4	0	0	4	0	0
10	34404593	.	T	C	3	3	6	0	1	7	0	0
10	34426308	.	C	T	1	5	6	0	0	6	0	0
10	34426656	.	C	T	5	5	10	0	0	10	0	0
10	34572353	.	T	C	4	9	13	0	0	13	0	0
10	34580604	.	G	A	4	4	8	0	0	8	0	0
10	34580622	.	C	T	5	7	12	0	0	12	0	0
10	34588818	.	G	T	3	9	12	0	4	16	0	0
10	34588872	.	C	T	8	10	18	0	0	18	0	0
10	34588881	.	C	T	9	7	16	0	0	16	0	0
10	34606549	.	T	C	9	16	25	0	3	28	0	0
10	34657676	.	C	T	17	10	27	0	1	28	0	0
10	34661857	.	A	G	10	7	17	0	0	17	0	0
10	34662184	.	C	T	4	17	21	0	1	22	0	0
10	34662223	.	C	A	7	21	28	0	1	29	0	0
10	34662334	.	T	C	10	13	23	0	1	24	0	0
10	34662349	.	C	T	16	9	25	0	2	27	0	0
10	34662437	.	C	T	6	12	18	0	1	19	0	0
10	34662481	.	A	T	7	9	16	0	1	17	0	0
10	34664906	.	G	A	14	10	24	0	2	26	0	0
10	34665053	.	G	A	1	15	16	0	8	24	0	0
10	34673597	.	C	T	17	16	33	0	0	33	0	0
10	34676338	.	C	T	9	7	16	0	0	16	0	0
10	34677614	.	C	A	11	8	19	0	0	19	0	0
10	34699238	.	C	T	13	11	24	0	0	24	0	0
10	34703742	.	G	A	9	9	18	0	1	19	0	0
10	34709708	.	G	C	15	14	29	0	0	29	0	0
10	34709940	.	C	T	11	13	24	0	1	25	0	0
10	34714789	.	C	T	23	10	33	0	0	33	0	0
10	34724906	.	C	T	14	17	31	0	1	32	0	0
10	34729552	.	G	A	21	16	37	0	1	38	0	0
10	34729693	.	C	T	15	21	36	0	1	37	0	0
10	34733566	.	A	G	23	23	46	0	1	47	0	0
10	34733661	.	C	T	20	14	34	0	11	45	0	0
10	34733883	.	A	T	24	14	38	0	1	39	0	0
10	34734714	.	A	T	28	22	50	0	5	55	0	0
10	34734743	.	T	G	18	19	37	0	1	38	0	0
10	34734785	.	G	T	16	5	21	1	1	23	0	0
10	34737919	.	T	C	16	20	36	0	2	38	0	0
10	34738213	.	C	T	5	22	27	0	30	57	0	0
10	34754660	.	C	T	20	16	36	0	0	36	0	0
10	34768418	.	G	A	0	2	2	0	1	3	0	0
10	34813299	.	T	C	14	12	26	0	1	27	0	0
10	34867466	.	C	T	11	13	24	0	2	26	0	0
10	34870579	.	C	T	15	9	24	0	2	26	0	0
10	34958584	.	C	G	3	2	5	0	0	5	0	0
10	34961309	.	A	G	20	7	27	0	0	27	0	0
10	34961311	.	T	C	20	7	27	0	0	27	0	0
10	34961480	.	C	A	5	6	11	0	1	12	0	0
10	34961520	.	T	C	8	5	13	0	1	14	0	0
10	34961669	.	A	G	9	7	16	0	0	16	0	0
10	34962074	.	G	T	3	2	5	0	0	5	0	0
10	34962116	.	G	A	4	5	9	0	0	9	0	0
10	34962155	.	G	A	2	3	5	0	0	5	0	0
10	34969984	.	A	G	2	5	7	0	1	8	0	0
10	34976884	.	G	C	4	2	6	0	0	6	0	0
10	34976925	.	G	A	1	4	5	0	0	5	0	0
10	34976926	.	G	T	1	4	5	0	0	5	0	0
10	34983561	.	A	G	1	2	3	0	0	3	0	0
10	34989149	.	T	C	11	0	11	0	15	26	0	0
10	34992565	.	A	G	12	13	25	0	2	27	0	0
10	34998281	.	G	C	6	13	19	0	0	19	0	0
10	35008963	.	C	T	6	9	15	0	0	15	0	0
10	35011337	.	A	G	10	8	18	0	0	18	0	0
10	35023235	.	C	T	6	4	10	0	1	11	0	0
10	35025832	.	G	C	3	4	7	0	1	8	0	0
10	35029172	.	G	A	5	2	7	0	1	8	0	0
10	35032792	.	A	G	4	4	8	0	0	8	0	0
10	35051681	.	C	G	3	4	7	0	0	7	0	0
10	35063944	.	C	T	6	4	10	0	0	10	0	0
10	35064268	.	T	G	5	6	11	0	0	11	0	0
10	35108561	.	A	G	4	2	6	0	0	6	0	0
10	35108590	.	G	T	6	2	8	0	0	8	0	0
10	35153051	.	G	T	7	5	12	0	0	12	0	0
10	35156268	.	C	T	4	3	7	0	0	7	0	0
10	35156315	.	G	A	7	3	10	0	0	10	0	0
10	35156431	.	C	T	7	6	13	0	0	13	0	0
10	35156473	.	C	T	4	5	9	0	0	9	0	0
10	35156485	.	A	C	3	3	6	0	0	6	0	0
10	35160454	.	T	G	2	0	2	0	4	6	0	0
10	35163358	.	T	A	7	4	11	0	2	13	0	0
10	35163406	.	G	A	6	3	9	0	0	9	0	0
10	35163492	.	T	C	3	2	5	0	0	5	0	0
10	35169884	.	T	C	6	5	11	0	0	11	0	0
10	35170265	.	A	G	6	3	9	0	0	9	0	0
10	35177270	.	A	T	5	5	10	0	3	13	0	0
10	35177324	.	A	G	4	5	9	0	0	9	0	0
10	35177357	.	G	A	5	7	12	0	0	12	0	0
10	35177375	.	G	C	6	0	6	0	7	13	0	0
10	35177537	.	G	A	5	6	11	0	0	11	0	0
10	35178440	.	A	T	9	10	19	0	0	19	0	0
10	35178518	.	A	T	11	7	18	0	3	21	0	0
10	35180253	.	G	C	5	10	15	0	0	15	0	0
10	35180273	.	C	T	5	8	13	0	0	13	0	0
10	35180627	.	C	T	1	7	8	0	19	27	0	0
10	35182580	.	A	T	4	7	11	0	0	11	0	0
10	35182654	.	G	T	3	2	5	0	0	5	0	0
10	35220292	.	A	G	7	5	12	0	0	12	0	0
10	35236801	.	T	G	5	4	9	1	0	10	0	0
10	35236909	.	C	T	0	4	4	0	5	9	0	0
10	35241646	.	A	T	6	9	15	0	0	15	0	0
10	35242113	.	C	G	6	9	15	0	0	15	0	0
10	35245939	.	T	A	6	8	14	0	0	14	0	0
10	35245951	.	C	T	7	7	14	0	0	14	0	0
10	35247905	.	G	A	7	4	11	0	1	12	0	0
10	35247980	.	G	C	5	0	5	0	7	12	0	0
10	35248280	.	T	C	4	0	4	0	3	7	0	0
10	35248433	.	G	A	9	7	16	0	1	17	0	0
10	35254613	.	A	G	1	4	5	0	0	5	0	0
10	35265206	.	T	A	1	8	9	0	0	9	0	0
10	35265234	.	C	T	3	2	5	0	0	5	0	0
10	35274747	.	G	A	4	2	6	0	1	7	0	0
10	35281335	.	C	T	5	5	10	0	0	10	0	0
10	35292112	.	G	A	1	6	7	0	3	10	0	0
10	35298732	.	A	G	7	8	15	0	1	16	0	0
10	35304002	.	G	A	10	6	16	0	1	17	0	0
10	35304014	.	C	T	11	5	16	0	1	17	0	0
10	35307579	.	C	T	14	8	22	0	0	22	0	0
10	35311926	.	C	G	9	15	24	0	1	25	0	0
10	35312253	.	C	T	7	7	14	0	0	14	0	0
10	35312682	.	C	G	4	5	9	0	0	9	0	0
10	35538349	.	A	C	19	10	29	0	0	29	0	0
10	35538350	.	C	A	18	11	29	0	0	29	0	0
10	35592817	.	A	G	3	5	8	0	0	8	0	0
10	35592830	.	G	A	4	6	10	0	1	11	0	0
10	35595653	.	C	T	14	7	21	0	0	21	0	0
10	35595669	.	T	A	9	16	25	0	0	25	0	0
10	35600397	.	T	C	6	4	10	0	0	10	0	0
10	35600529	.	G	T	6	7	13	0	0	13	0	0
10	35602535	.	G	T	4	9	13	0	0	13	0	0
10	35602756	.	T	C	3	7	10	0	0	10	0	0
10	35603179	.	G	T	2	4	6	0	0	6	0	0
10	35603212	.	A	G	3	6	9	0	0	9	0	0
10	35603233	.	A	G	4	6	10	0	0	10	0	0
10	35606506	.	C	A	4	7	11	0	0	11	0	0
10	35607283	.	T	A	6	2	8	0	1	9	0	0
10	35609468	.	T	C	5	4	9	0	0	9	0	0
10	35610899	.	T	C	1	2	3	0	0	3	0	0
10	35610961	.	T	G	3	3	6	0	0	6	0	0
10	35611227	.	G	T	5	7	12	0	1	13	0	0
10	35611367	.	G	A	5	3	8	0	0	8	0	0
10	35611436	.	C	T	7	4	11	0	1	12	0	0
10	35611789	.	T	A	3	4	7	0	0	7	0	0
10	35611800	.	C	A	5	3	8	0	0	8	0	0
10	35611843	.	C	A	3	5	8	0	0	8	0	0
10	35664575	.	C	A	1	3	4	0	0	4	0	0
10	35953425	.	A	C	9	3	12	0	0	12	0	0
10	35959133	.	C	A	10	6	16	0	0	16	0	0
10	35959163	.	T	C	13	5	18	0	0	18	0	0
10	35959223	.	T	C	8	9	17	0	1	18	0	0
10	35959400	.	T	C	12	6	18	0	1	19	0	0
10	36029893	.	T	C	35	34	69	0	3	72	0	0
10	36040404	.	T	C	6	5	11	0	0	11	0	0
10	36049738	.	G	A	6	6	12	0	0	12	0	0
10	36054226	.	C	T	10	5	15	0	0	15	0	0
10	36063020	.	G	A	1	3	4	1	0	5	0	0
10	36092696	.	C	T	3	2	5	0	0	5	0	0
10	36095390	.	G	A	2	2	4	0	0	4	0	0
10	36095809	.	G	A	0	4	4	0	2	6	0	0
10	36096022	.	T	A	1	2	3	0	0	3	0	0
10	36097946	.	C	T	3	2	5	0	0	5	0	0
10	36098253	.	A	C	1	5	6	0	0	6	0	0
10	36155719	.	T	G	1	0	1	0	2	3	0	0
10	36155767	.	C	A	3	3	6	0	0	6	0	0
10	36159159	.	A	T	5	5	10	0	0	10	0	0
10	36159166	.	G	A	5	5	10	0	0	10	0	0
10	36159432	.	G	C	3	4	7	0	0	7	0	0
10	36159502	.	G	A	2	2	4	0	1	5	0	0
10	36159761	.	C	T	1	2	3	0	0	3	0	0
10	36160027	.	C	T	1	2	3	0	0	3	0	0
10	36160041	.	G	A	1	2	3	0	0	3	0	0
10	36363557	.	A	G	10	12	22	0	2	24	0	0
10	36363611	.	C	T	18	16	34	0	0	34	0	0
10	36363818	.	G	T	16	14	30	0	0	30	0	0
10	36363937	.	G	A	19	24	43	0	0	43	0	0
10	36363971	.	C	T	3	17	20	0	18	38	0	0
10	36364172	.	A	G	26	9	35	0	0	35	0	0
10	36405921	.	C	T	15	28	43	0	1	44	0	0
10	36406039	.	G	T	12	22	34	0	0	34	0	0
10	36406106	.	T	A	13	8	21	1	1	23	0	0
10	36406210	.	G	A	21	14	35	0	0	35	0	0
10	36443018	.	T	C	10	18	28	0	0	28	0	0
10	36443541	.	T	C	14	20	34	0	0	34	0	0
10	36443676	.	G	A	0	16	16	0	8	24	0	0
10	36443714	.	G	A	5	19	24	0	2	26	0	0
10	36443818	.	T	G	14	0	14	0	7	21	0	0
10	36446799	.	A	T	11	10	21	0	1	22	0	0
10	36451615	.	T	C	20	22	42	0	3	45	0	0
10	36451661	.	G	A	20	29	49	0	2	51	0	0
10	36454567	.	C	A	13	19	32	0	0	32	0	0
10	36454649	.	A	G	25	1	26	0	19	45	0	0
10	36454650	.	C	A	26	14	40	0	5	45	0	0
10	36454902	.	G	T	18	21	39	0	3	42	0	0
10	36455146	.	C	T	11	19	30	0	2	32	0	0
10	36455215	.	T	C	13	12	25	0	1	26	0	0
10	36455229	.	C	G	13	13	26	0	1	27	0	0
10	36455344	.	A	G	17	17	34	0	1	35	0	0
10	36455847	.	G	A	1	6	7	0	6	13	0	0
10	36476481	.	C	T	1	16	17	0	16	33	0	0
10	36476529	.	C	T	16	10	26	0	0	26	0	0
10	36476639	.	C	T	3	18	21	0	9	30	0	0
10	36476717	.	A	G	16	15	31	0	2	33	0	0
10	36476834	.	G	A	18	18	36	0	0	36	0	0
10	36476852	.	A	G	18	17	35	0	2	37	0	0
10	36476922	.	C	T	11	16	27	0	0	27	0	0
10	36481915	.	A	C	16	14	30	0	0	30	0	0
10	36482588	.	G	A	13	12	25	0	4	29	0	0
10	36487530	.	G	A	9	8	17	0	0	17	0	0
10	36489882	.	A	G	11	3	14	0	0	14	0	0
10	36489893	.	A	G	10	4	14	0	0	14	0	0
10	36492091	.	C	T	8	3	11	0	1	12	0	0
10	36494336	.	G	A	4	5	9	0	1	10	0	0
10	36494590	.	C	G	8	10	18	0	0	19	1	0
10	36495580	.	T	G	13	5	18	0	0	18	0	0
10	36496544	.	A	G	10	11	21	0	0	21	0	0
10	36496595	.	G	A	12	3	15	0	2	17	0	0
10	36498246	.	G	A	6	7	13	0	0	13	0	0
10	36498379	.	C	T	1	5	6	0	6	12	0	0
10	36498397	.	G	A	6	6	12	0	0	12	0	0
10	36500581	.	C	T	14	10	24	0	2	26	0	0
10	36500674	.	G	A	9	11	20	0	0	20	0	0
10	36504163	.	C	T	0	5	5	0	3	8	0	0
10	36506103	.	G	A	6	7	13	0	0	13	0	0
10	36506290	.	C	T	1	4	5	0	5	10	0	0
10	36518643	.	C	T	5	5	10	0	0	10	0	0
10	36519788	.	T	C	6	3	9	0	3	12	0	0
10	36520024	.	C	A	1	7	8	0	0	8	0	0
10	36520711	.	G	A	9	7	16	2	0	18	0	0
10	36520945	.	A	G	10	10	20	0	0	20	0	0
10	36521605	.	C	T	5	5	10	0	0	10	0	0
10	36522302	.	G	A	3	2	5	0	1	6	0	0
10	36522602	.	A	C	9	0	9	0	3	12	0	0
10	36522713	.	A	C	2	0	2	0	5	7	0	0
10	36523826	.	G	A	10	7	17	0	1	18	0	0
10	36528549	.	A	G	6	12	18	0	2	20	0	0
10	36558839	.	A	G	8	11	19	0	2	21	0	0
10	36558895	.	G	A	18	15	33	0	1	34	0	0
10	36570469	.	A	G	21	13	34	0	2	36	0	0
10	36572622	.	G	A	19	21	40	0	1	41	0	0
10	36572640	.	C	A	3	18	21	0	20	41	0	0
10	36572814	.	A	T	13	13	26	0	0	26	0	0
10	36575980	.	G	A	14	13	27	0	2	29	0	0
10	36575992	.	C	T	15	14	29	0	1	30	0	0
10	36584462	.	T	C	16	14	30	0	0	30	0	0
10	36613095	.	T	C	14	11	25	0	0	25	0	0
10	36613145	.	G	T	11	11	22	0	2	24	0	0
10	36613164	.	C	T	1	8	9	0	8	17	0	0
10	36613276	.	C	T	13	13	26	0	0	26	0	0
10	36615367	.	G	A	11	14	25	0	0	25	0	0
10	36615907	.	C	A	12	12	24	0	2	26	0	0
10	36618435	.	C	T	0	4	4	0	12	17	1	0
10	36618787	.	C	T	15	11	26	0	0	26	0	0
10	36625258	.	C	A	4	7	11	0	10	22	1	0
10	36625534	.	G	A	6	15	21	0	0	21	0	0
10	36625602	.	C	G	8	9	17	0	1	18	0	0
10	36625761	.	T	A	10	12	22	0	2	24	0	0
10	36626201	.	C	T	7	8	15	0	0	15	0	0
10	36627009	.	G	C	9	8	17	0	0	17	0	0
10	36627314	.	C	T	15	3	18	0	0	18	0	0
10	36627390	.	A	G	6	8	14	0	2	16	0	0
10	36627414	.	C	A	9	6	15	0	0	15	0	0
10	36627517	.	C	T	8	8	16	1	0	17	0	0
10	36627657	.	A	C	4	8	12	0	0	12	0	0
10	36627820	.	C	T	5	10	15	0	2	17	0	0
10	36628009	.	C	A	7	6	13	0	0	13	0	0
10	36628012	.	G	A	6	6	12	0	0	12	0	0
10	36628569	.	C	T	0	2	2	0	1	3	0	0
10	36628626	.	G	A	7	5	12	0	0	12	0	0
10	36628804	.	G	T	7	5	12	0	0	12	0	0
10	36688455	.	C	T	6	10	16	0	2	18	0	0
10	36689850	.	G	T	9	12	21	0	2	23	0	0
10	36689893	.	A	G	9	9	18	0	0	18	0	0
10	36691372	.	C	A	2	11	13	0	8	21	0	0
10	36695781	.	G	C	16	12	28	0	0	28	0	0
10	36695785	.	C	T	16	12	28	0	0	28	0	0
10	36704842	.	A	G	22	10	32	4	1	37	0	0
10	36706217	.	T	A	19	13	32	0	2	34	0	0
10	36708401	.	A	G	12	0	12	0	29	41	0	0
10	36708453	.	C	T	13	23	36	0	1	37	0	0
10	36710559	.	A	C	16	11	27	0	3	30	0	0
10	36710599	.	C	T	15	15	30	0	1	31	0	0
10	36710871	.	G	A	0	19	19	0	24	43	0	0
10	36710893	.	G	T	1	17	18	0	22	41	1	0
10	36711260	.	T	A	4	5	9	0	0	9	0	0
10	36711329	.	T	A	6	8	14	0	2	16	0	0
10	36711613	.	C	T	11	4	15	0	2	17	0	0
10	36752664	.	G	T	0	3	3	0	2	5	0	0
10	36768031	.	G	A	1	1	2	0	1	3	0	0
10	36773249	.	T	A	2	4	6	0	0	6	0	0
10	36774379	.	T	A	1	2	3	0	1	4	0	0
10	36778293	.	C	T	3	6	9	0	0	9	0	0
10	36778302	.	C	A	3	6	9	0	0	9	0	0
10	36796131	.	T	A	3	2	5	0	0	5	0	0
10	36800465	.	G	A	9	11	20	0	0	20	0	0
10	36800518	.	C	T	9	13	22	0	0	22	0	0
10	36800600	.	G	A	6	12	18	0	0	18	0	0
10	36800642	.	A	G	6	12	18	0	0	18	0	0
10	36807986	.	G	A	6	13	19	0	2	21	0	0
10	36808032	.	G	A	5	10	15	0	2	17	0	0
10	36808096	.	A	G	3	5	8	0	0	8	0	0
10	36808189	.	T	A	4	3	7	0	0	7	0	0
10	36811815	.	A	G	10	8	18	0	0	18	0	0
10	36812214	.	A	C	7	10	17	0	0	17	0	0
10	36814912	.	G	A	4	12	16	0	0	16	0	0
10	36815330	.	T	C	10	0	10	0	6	16	0	0
10	36817197	.	A	C	13	8	21	0	0	21	0	0
10	36817355	.	C	T	2	5	7	0	9	16	0	0
10	36817530	.	C	T	13	5	18	0	0	18	0	0
10	36817940	.	T	C	7	10	17	0	0	17	0	0
10	36817979	.	T	G	17	6	23	0	1	24	0	0
10	36819664	.	G	T	11	13	24	0	0	24	0	0
10	36819671	.	C	T	12	11	23	0	1	24	0	0
10	36820601	.	C	T	3	10	13	0	11	24	0	0
10	36820611	.	A	G	13	10	23	0	0	23	0	0
10	36820664	.	C	T	13	15	28	0	0	28	0	0
10	36820688	.	C	G	2	15	17	0	9	26	0	0
10	36820736	.	G	A	10	10	20	0	1	21	0	0
10	36820769	.	T	A	11	10	21	0	1	22	0	0
10	36820892	.	G	A	15	6	21	0	1	22	0	0
10	36825650	.	C	T	0	2	2	0	6	8	0	0
10	36825818	.	T	C	2	3	5	0	0	5	0	0
10	36825880	.	G	A	6	4	10	0	0	10	0	0
10	36828227	.	T	C	10	10	20	0	1	21	0	0
10	36828265	.	G	A	11	9	20	0	1	21	0	0
10	36828295	.	G	T	6	7	13	0	1	14	0	0
10	36828469	.	T	C	6	0	6	0	5	11	0	0
10	36828475	.	C	T	7	5	12	0	0	12	0	0
10	36835641	.	A	T	6	5	11	0	0	11	0	0
10	36835740	.	G	A	8	7	15	0	0	15	0	0
10	36838768	.	C	T	5	7	12	0	1	13	0	0
10	36841230	.	G	T	5	7	12	0	1	13	0	0
10	36848872	.	G	A	2	9	11	0	1	12	0	0
10	36848938	.	A	G	10	5	15	0	1	16	0	0
10	36850674	.	C	T	2	8	10	0	9	19	0	0
10	36850752	.	A	G	4	10	14	0	1	15	0	0
10	36852643	.	G	A	3	3	6	0	0	6	0	0
10	36867407	.	T	C	5	6	11	0	0	11	0	0
10	36876162	.	A	C	6	0	6	0	4	10	0	0
10	36878340	.	G	T	4	2	6	0	0	6	0	0
10	36878362	.	C	A	3	4	7	0	0	7	0	0
10	36878568	.	C	T	7	10	17	0	0	17	0	0
10	36878638	.	T	C	8	0	8	0	7	15	0	0
10	36927345	.	A	T	2	3	5	0	1	6	0	0
10	36927349	.	C	T	0	4	4	0	3	7	0	0
10	36950935	.	A	T	6	2	8	0	0	8	0	0
10	36951044	.	A	T	4	4	8	0	0	8	0	0
10	36951076	.	G	C	1	3	4	0	2	6	0	0
10	36951223	.	A	C	6	10	16	0	0	16	0	0
10	36951378	.	A	G	6	6	12	0	0	12	0	0
10	36951582	.	C	G	11	8	19	0	0	19	0	0
10	36951660	.	T	A	10	10	20	1	1	22	0	0
10	36963456	.	G	A	7	9	16	0	0	16	0	0
10	36967206	.	T	C	22	8	30	0	2	32	0	0
10	36969510	.	T	C	10	9	19	0	1	20	0	0
10	36969519	.	A	G	7	8	15	0	3	18	0	0
10	36974901	.	G	A	3	10	13	0	1	14	0	0
10	36976271	.	C	T	2	8	10	0	6	16	0	0
10	36976318	.	G	A	7	13	20	0	0	20	0	0
10	36987831	.	T	G	11	4	15	0	0	15	0	0
10	36999951	.	A	G	7	6	13	0	1	14	0	0
10	37011570	.	G	T	4	4	8	0	0	8	0	0
10	37014392	.	C	T	5	3	8	0	2	10	0	0
10	37016252	.	T	G	2	7	9	0	0	9	0	0
10	37016308	.	G	A	4	4	8	0	0	8	0	0
10	37022463	.	G	A	4	6	10	0	1	11	0	0
10	37024367	.	T	C	3	0	3	0	3	6	0	0
10	37028670	.	A	G	7	5	12	0	0	12	0	0
10	37070656	.	A	T	2	4	6	1	0	7	0	0
10	37126295	.	C	T	8	6	14	0	0	14	0	0
10	37126307	.	C	T	6	6	12	0	0	12	0	0
10	37137549	.	G	A	3	10	13	0	19	32	0	0
10	37145178	.	G	A	8	16	24	0	1	25	0	0
10	37152081	.	G	A	18	22	40	0	2	42	0	0
10	37152105	.	A	G	25	0	25	0	18	43	0	0
10	37163252	.	C	A	13	12	25	0	0	25	0	0
10	37167151	.	G	C	9	6	15	0	1	16	0	0
10	37227524	.	C	T	9	10	19	0	2	21	0	0
10	37234093	.	A	G	5	0	5	0	8	13	0	0
10	37236672	.	T	G	7	0	7	0	8	15	0	0
10	37236857	.	A	G	9	0	9	0	13	22	0	0
10	37239229	.	G	A	7	5	12	0	2	14	0	0
10	37252054	.	G	A	1	7	8	0	15	23	0	0
10	37253986	.	A	G	12	6	18	0	2	21	1	0
10	37277246	.	G	A	0	3	3	0	1	4	0	0
10	37280907	.	A	G	1	2	3	0	0	3	0	0
10	37288972	.	A	C	2	4	6	0	0	6	0	0
10	37288988	.	C	T	3	3	6	0	0	6	0	0
10	37290957	.	G	A	3	2	5	0	0	5	0	0
10	37296515	.	G	A	0	7	7	0	3	10	0	0
10	37296561	.	G	A	1	2	3	0	4	7	0	0
10	37298354	.	G	C	4	4	8	0	0	8	0	0
10	37334291	.	G	T	3	2	5	0	0	5	0	0
10	37360287	.	T	C	1	2	3	0	0	3	0	0
10	37360308	.	G	A	3	3	6	0	0	6	0	0
10	37360344	.	G	A	1	3	4	0	2	6	0	0
10	37361681	.	G	A	0	2	2	0	8	10	0	0
10	37364389	.	T	C	3	2	5	0	0	5	0	0
10	37367481	.	C	T	4	4	8	0	0	8	0	0
10	37373858	.	C	T	2	3	5	0	1	6	0	0
10	37373873	.	G	A	2	3	5	0	3	8	0	0
10	37378252	.	A	T	5	4	9	0	1	10	0	0
10	37384943	.	G	A	1	2	3	0	4	7	0	0
10	37385317	.	T	C	3	3	6	0	0	6	0	0
10	37389654	.	G	A	0	7	7	0	2	9	0	0
10	37394535	.	C	T	6	6	12	0	1	13	0	0
10	37764473	.	C	T	9	15	24	0	1	25	0	0
10	37779765	.	A	C	14	13	27	0	0	27	0	0
10	37779778	.	T	A	14	10	24	0	3	27	0	0
10	37783114	.	A	G	10	12	22	0	0	22	0	0
10	37783179	.	A	G	17	0	17	0	10	27	0	0
10	37783323	.	A	G	9	9	18	0	0	18	0	0
10	37783575	.	C	A	3	5	8	0	0	8	0	0
10	37783669	.	C	A	5	2	7	1	0	8	0	0
10	37992839	.	A	T	8	6	14	0	0	14	0	0
10	37997567	.	C	G	4	7	11	0	0	11	0	0
10	38000084	.	G	T	0	9	9	0	2	11	0	0
10	38003011	.	A	G	11	9	20	0	1	21	0	0
10	38006849	.	G	C	1	2	3	0	1	4	0	0
10	38006855	.	G	A	0	2	2	0	2	4	0	0
10	38040372	.	A	G	8	12	20	0	0	20	0	0
10	38040378	.	A	G	12	7	19	0	1	20	0	0
10	38074570	.	G	T	6	5	11	1	0	12	0	0
10	38170737	.	G	A	6	10	16	0	0	16	0	0
10	38171149	.	G	C	5	0	5	0	6	11	0	0
10	38171207	.	C	A	3	12	15	0	2	17	0	0
10	38171356	.	A	T	6	14	20	0	0	20	0	0
10	38171490	.	T	A	15	8	23	0	0	23	0	0
10	38173383	.	C	A	3	11	14	0	15	29	0	0
10	38177999	.	C	T	2	13	15	0	12	27	0	0
10	38178357	.	G	A	11	14	25	0	0	25	0	0
10	38180732	.	A	T	6	7	13	0	0	13	0	0
10	38189023	.	T	C	1	0	1	0	3	4	0	0
10	38199097	.	G	A	7	3	10	0	0	10	0	0
10	38199169	.	T	C	6	12	18	0	0	18	0	0
10	38201513	.	G	A	3	6	9	0	0	9	0	0
10	38205149	.	T	C	8	0	8	0	9	17	0	0
10	38211810	.	C	G	3	12	15	0	0	15	0	0
10	38218990	.	C	T	1	5	6	0	1	7	0	0
10	38231165	.	C	T	2	8	10	0	9	19	0	0
10	38235957	.	G	C	5	5	10	0	0	10	0	0
10	38243543	.	G	A	4	6	10	0	0	10	0	0
10	38257295	.	G	A	4	2	6	0	1	7	0	0
10	38257509	.	C	G	0	3	3	0	8	11	0	0
10	38257558	.	C	T	3	5	8	0	2	10	0	0
10	38257870	.	T	C	14	17	31	0	1	32	0	0
10	38258729	.	C	G	15	14	29	0	0	29	0	0
10	38259033	.	C	T	7	12	19	0	0	19	0	0
10	38259034	.	A	G	7	12	19	0	0	19	0	0
10	38259204	.	G	A	13	8	21	0	0	21	0	0
10	38259217	.	A	G	10	6	16	0	1	17	0	0
10	38259268	.	G	C	3	9	12	2	0	14	0	0
10	38259339	.	A	T	11	6	17	0	0	17	0	0
10	38259449	.	A	C	17	0	17	0	7	24	0	0
10	38259451	.	A	G	17	7	24	0	0	24	0	0
10	38259900	.	T	C	14	0	14	0	16	30	0	0
10	38260002	.	G	A	12	8	20	0	1	21	0	0
10	38260210	.	T	A	16	15	31	0	1	32	0	0
10	38260626	.	A	T	10	13	23	0	0	23	0	0
10	38261085	.	T	G	5	9	14	0	0	14	0	0
10	38261109	.	T	C	3	8	11	0	0	11	0	0
10	38261453	.	G	A	10	4	14	0	1	15	0	0
10	38261485	.	C	T	11	7	18	0	0	18	0	0
10	38261495	.	T	G	9	7	16	0	0	16	0	0
10	38261638	.	G	A	5	4	9	0	1	10	0	0
10	38261696	.	C	T	7	4	11	0	2	13	0	0
10	38665994	.	C	T	17	20	37	0	3	40	0	0
10	38666063	.	T	C	21	19	40	0	0	40	0	0
10	38686126	.	T	C	24	18	42	0	4	46	0	0
10	38695152	.	A	C	26	14	40	0	2	42	0	0
10	38695510	.	A	G	22	7	29	0	0	29	0	0
10	38695656	.	A	G	13	14	27	0	1	28	0	0
10	38712403	.	A	G	2	0	2	0	4	6	0	0
10	38712431	.	C	T	2	5	7	0	0	7	0	0
10	38712508	.	C	T	3	3	6	0	0	6	0	0
10	38723539	.	T	C	2	3	5	0	0	5	0	0
10	38724101	.	C	T	2	3	5	0	0	5	0	0
10	38726441	.	C	T	2	2	4	0	0	4	0	0
10	38775780	.	C	G	12	10	22	0	0	22	0	0
10	38885821	.	T	C	8	7	15	0	1	16	0	0
10	38891454	.	C	A	9	8	17	0	1	18	0	0
10	38922043	.	G	A	1	10	11	0	17	28	0	0
10	38924557	.	C	T	15	8	23	0	0	23	0	0
10	38924560	.	T	C	13	9	22	0	1	23	0	0
10	38934391	.	A	G	5	13	18	0	2	20	0	0
10	38940232	.	A	G	6	10	16	0	0	16	0	0
10	38943265	.	C	G	15	7	22	0	1	23	0	0
10	38950115	.	T	C	12	3	15	0	1	16	0	0
10	38950430	.	G	A	2	6	8	0	15	23	0	0
10	38950484	.	A	G	13	16	29	0	4	33	0	0
10	38950538	.	T	C	15	18	33	0	2	35	0	0
10	38954126	.	C	T	13	16	29	0	3	32	0	0
10	38954141	.	T	C	17	15	32	0	2	34	0	0
10	38954798	.	T	C	13	14	27	0	1	28	0	0
10	38954801	.	C	T	13	18	31	0	0	31	0	0
10	38957061	.	T	C	19	14	33	0	1	34	0	0
10	38957127	.	G	A	1	16	17	0	19	36	0	0
10	38957193	.	C	T	17	12	29	0	1	30	0	0
10	38957748	.	A	C	10	16	26	0	0	26	0	0
10	38957754	.	A	C	6	19	25	0	1	26	0	0
10	38969552	.	A	C	33	18	51	0	2	53	0	0
10	38969598	.	A	C	22	29	51	0	2	53	0	0
10	38969629	.	C	T	23	30	53	0	0	53	0	0
10	38969685	.	A	G	22	23	45	0	0	45	0	0
10	38969778	.	C	T	23	23	46	1	1	48	0	0
10	39011484	.	C	T	19	15	34	0	2	36	0	0
10	39086981	.	G	A	27	23	50	0	1	51	0	0
10	39087242	.	C	T	7	4	11	1	4	16	0	0
10	39087391	.	A	G	26	0	26	0	37	63	0	0
10	39087625	.	T	A	27	31	58	0	1	59	0	0
10	39087659	.	T	A	28	21	49	0	3	52	0	0
10	39091684	.	C	A	3	5	8	0	0	8	0	0
10	39091792	.	A	G	4	0	4	0	11	15	0	0
10	39098798	.	C	T	3	7	10	0	0	10	0	0
10	39102672	.	G	C	4	8	12	0	0	12	0	0
10	39102776	.	T	C	7	6	13	0	1	14	0	0
10	39110452	.	G	C	4	3	7	0	0	7	0	0
10	39115595	.	G	T	3	8	11	0	0	11	0	0
10	39115596	.	T	C	3	8	11	0	0	11	0	0
10	39120132	.	T	C	10	11	21	0	0	21	0	0
10	39130460	.	C	T	35	32	67	0	5	72	0	0
10	39140465	.	A	G	6	7	13	0	1	14	0	0
10	39140741	.	T	C	11	11	22	0	0	22	0	0
10	39152038	.	A	G	4	4	8	0	0	8	0	0
10	39153470	.	G	A	5	2	7	0	0	7	0	0
10	39153494	.	A	G	4	4	8	0	0	8	0	0
10	39153599	.	T	A	6	5	11	0	0	11	0	0
10	39170798	.	A	C	3	5	8	0	2	10	0	0
10	39175139	.	T	C	4	5	9	0	1	10	0	0
10	39175418	.	T	C	4	2	6	0	1	7	0	0
10	39175452	.	C	T	3	3	6	0	0	6	0	0
10	39175475	.	G	A	0	4	4	0	4	8	0	0
10	39177816	.	T	C	3	3	6	0	0	6	0	0
10	39179439	.	G	A	4	2	6	0	0	6	0	0
10	39179525	.	G	A	6	4	10	0	0	10	0	0
10	39179565	.	C	T	5	6	11	0	0	11	0	0
10	39179607	.	C	T	3	3	6	0	0	6	0	0
10	39179608	.	C	T	3	3	6	0	0	6	0	0
10	39179925	.	T	A	3	2	5	0	0	6	1	0
10	39180884	.	A	G	4	0	4	0	2	6	0	0
10	39180902	.	A	G	3	2	5	0	1	6	0	0
10	39182173	.	A	G	10	7	17	0	1	18	0	0
10	39182310	.	C	A	7	5	12	0	1	13	0	0
10	39182342	.	A	T	6	5	11	0	1	12	0	0
10	39182401	.	C	A	11	7	18	0	0	18	0	0
10	39182497	.	C	T	4	6	10	0	0	10	0	0
10	39182602	.	G	A	0	3	3	0	4	7	0	0
10	39199639	.	G	A	1	3	4	0	5	9	0	0
10	39205021	.	C	T	9	5	14	0	2	16	0	0
10	39205256	.	C	G	7	11	18	0	0	18	0	0
10	39206945	.	A	G	5	7	12	0	0	12	0	0
10	39207104	.	C	A	4	2	6	0	0	6	0	0
10	39207114	.	C	A	3	2	5	0	1	6	0	0
10	39207388	.	A	G	4	2	6	0	2	8	0	0
10	39207397	.	T	A	4	4	8	0	0	8	0	0
10	39207708	.	A	T	3	4	7	0	1	8	0	0
10	39207720	.	A	G	3	3	6	0	1	7	0	0
10	39207749	.	C	T	1	3	4	0	0	4	0	0
10	39212932	.	G	A	3	5	8	0	0	8	0	0
10	39216625	.	C	T	14	8	22	0	0	22	0	0
10	39219390	.	T	C	10	14	24	0	1	25	0	0
10	39219540	.	T	A	21	13	34	0	0	34	0	0
10	39222134	.	A	C	19	15	34	0	0	34	0	0
10	39222182	.	A	G	17	13	30	0	1	31	0	0
10	39225504	.	A	C	17	10	27	0	0	27	0	0
10	39225555	.	T	C	15	11	26	0	1	27	0	0
10	39231387	.	G	A	30	12	42	0	2	44	0	0
10	39249061	.	G	T	1	2	3	0	0	3	0	0
10	39251381	.	C	T	1	2	3	0	0	3	0	0
10	39265717	.	C	T	2	3	5	0	0	5	0	0
10	39265766	.	G	A	3	2	5	0	0	5	0	0
10	39266350	.	G	T	0	5	5	0	2	7	0	0
10	39270672	.	G	A	1	2	3	0	0	3	0	0
10	39270674	.	A	G	1	2	3	0	0	3	0	0
10	39277087	.	C	G	2	4	6	0	0	6	0	0
10	39284092	.	T	G	5	0	5	0	4	9	0	0
10	39284104	.	C	G	5	0	5	0	5	10	0	0
10	39285246	.	A	G	3	6	9	0	0	9	0	0
10	39285288	.	T	C	4	6	10	0	0	10	0	0
10	39286967	.	C	T	3	7	10	0	0	10	0	0
10	39287100	.	C	T	5	2	7	0	1	8	0	0
10	39289006	.	A	G	3	0	3	0	7	10	0	0
10	39289036	.	A	C	2	7	9	0	0	9	0	0
10	39292583	.	A	C	1	6	7	0	0	7	0	0
10	39292988	.	A	G	2	3	5	0	0	5	0	0
10	39293118	.	G	T	4	2	6	1	1	8	0	0
10	39293157	.	C	T	5	2	7	1	0	8	0	0
10	39293240	.	C	T	2	4	6	0	0	6	0	0
10	39293241	.	T	G	2	4	6	0	0	6	0	0
10	39293705	.	A	G	3	5	8	0	0	8	0	0
10	39293707	.	A	T	4	3	7	0	1	8	0	0
10	39293746	.	G	A	2	3	5	0	0	5	0	0
10	39293751	.	A	G	2	3	5	0	0	5	0	0
10	39476639	.	A	G	5	3	8	0	1	9	0	0
10	39904774	.	G	A	2	9	11	0	2	13	0	0
10	39904780	.	C	T	3	9	12	0	0	12	0	0
10	39904851	.	A	T	4	6	10	0	0	10	0	0
10	39904915	.	A	G	10	8	18	0	0	18	0	0
10	39904966	.	T	C	6	3	9	0	0	9	0	0
10	39905085	.	A	T	4	2	6	0	0	6	0	0
10	39905089	.	T	G	3	2	5	0	0	5	0	0
10	39953483	.	T	A	2	2	4	0	0	4	0	0
10	39953689	.	T	C	8	5	13	0	2	15	0	0
10	40086018	.	A	G	4	3	7	0	1	8	0	0
10	40086024	.	T	C	4	3	7	0	0	7	0	0
10	40086093	.	A	G	3	2	5	0	0	5	0	0
10	40086099	.	G	A	3	3	6	0	0	6	0	0
10	40089829	.	C	A	2	2	4	0	0	4	0	0
10	40089838	.	C	T	2	3	5	0	0	5	0	0
10	40089941	.	T	C	9	6	15	0	0	15	0	0
10	40097252	.	C	A	8	5	13	0	0	13	0	0
10	40109378	.	C	T	7	5	12	0	0	12	0	0
10	40109439	.	G	A	0	7	7	0	10	17	0	0
10	40110115	.	A	C	4	4	8	0	0	8	0	0
10	40110397	.	A	G	4	4	8	0	0	8	0	0
10	40110599	.	G	A	0	4	4	1	2	7	0	0
10	40110616	.	G	T	5	5	10	1	0	11	0	0
10	40110666	.	T	A	6	6	12	0	0	12	0	0
10	40110768	.	A	G	5	2	7	0	0	7	0	0
10	40110853	.	A	T	4	3	7	0	0	7	0	0
10	40110869	.	A	T	4	3	7	0	0	7	0	0
10	40110907	.	A	G	3	2	5	0	0	5	0	0
10	40111412	.	G	A	2	1	3	0	1	4	0	0
10	40111549	.	T	C	4	12	16	0	1	17	0	0
10	40111610	.	C	T	5	6	11	0	2	13	0	0
10	40111666	.	G	C	9	7	16	0	1	17	0	0
10	40111706	.	A	G	8	7	15	0	0	15	0	0
10	40111732	.	C	T	4	7	11	0	1	12	0	0
10	40111904	.	G	T	2	4	6	0	0	6	0	0
10	40111952	.	C	T	5	4	9	0	0	9	0	0
10	40111964	.	C	A	8	4	12	0	0	12	0	0
10	40112096	.	C	A	6	4	10	0	0	10	0	0
10	40112121	.	A	G	5	4	9	0	0	9	0	0
10	40112157	.	G	A	5	5	10	0	0	10	0	0
10	40112159	.	T	A	4	5	9	0	1	10	0	0
10	40112347	.	A	T	7	9	16	0	1	17	0	0
10	40112638	.	C	T	2	9	11	0	0	11	0	0
10	40112834	.	G	A	13	3	16	0	0	16	0	0
10	40113082	.	T	C	4	3	7	0	0	7	0	0
10	40113113	.	C	G	2	2	4	0	2	6	0	0
10	40113161	.	C	A	5	6	11	0	0	11	0	0
10	40113197	.	G	A	0	11	11	0	4	15	0	0
10	40113408	.	A	G	7	6	13	0	0	13	0	0
10	40113446	.	T	C	5	3	8	0	1	9	0	0
10	40113508	.	A	T	3	2	5	0	0	5	0	0
10	40113592	.	G	A	3	2	5	0	0	5	0	0
10	40113713	.	A	G	1	2	3	0	0	3	0	0
10	40167788	.	A	G	3	0	3	0	2	5	0	0
10	40167908	.	C	T	4	3	7	0	0	7	0	0
10	40204788	.	A	G	4	2	6	0	0	6	0	0
10	40204845	.	G	A	0	4	4	0	3	7	0	0
10	40236068	.	A	G	10	0	10	1	11	22	0	0
10	40262052	.	T	C	7	9	16	0	0	16	0	0
10	40262338	.	T	C	6	7	13	0	0	13	0	0
10	40262347	.	A	G	6	0	6	0	8	14	0	0
10	40266160	.	A	G	6	7	13	0	0	13	0	0
10	40266259	.	A	C	6	8	14	0	0	14	0	0
10	40274411	.	G	A	5	9	14	0	0	14	0	0
10	40274541	.	G	A	0	8	8	0	15	23	0	0
10	40274626	.	C	T	9	6	15	0	0	15	0	0
10	40275055	.	G	C	0	8	8	0	4	12	0	0
10	40275070	.	T	G	4	6	10	0	0	10	0	0
10	40275158	.	G	A	0	4	4	0	7	11	0	0
10	40290969	.	G	A	4	2	6	0	0	6	0	0
10	40296645	.	T	C	4	2	6	0	0	6	0	0
10	40296841	.	G	A	0	6	6	0	3	9	0	0
10	40296896	.	C	T	4	2	6	0	0	6	0	0
10	40303924	.	G	C	7	4	11	0	0	11	0	0
10	40303980	.	A	G	5	4	9	0	0	9	0	0
10	40307553	.	T	C	6	3	9	0	1	10	0	0
10	40307622	.	C	T	1	7	8	0	1	9	0	0
10	40311286	.	G	T	0	10	10	0	14	24	0	0
10	40314175	.	A	C	6	10	16	0	0	16	0	0
10	40314177	.	A	C	6	9	15	0	1	16	0	0
10	40315211	.	A	G	2	2	4	0	1	5	0	0
10	40317095	.	G	T	10	5	15	0	1	16	0	0
10	40317190	.	T	G	6	4	10	0	0	10	0	0
10	40317192	.	G	T	6	4	10	0	0	10	0	0
10	40317285	.	A	T	8	9	17	0	0	17	0	0
10	40317323	.	A	G	2	0	2	0	4	6	0	0
10	40317341	.	A	G	1	3	4	0	0	4	0	0
10	40822252	.	C	T	3	8	11	0	11	22	0	0
10	40825192	.	T	C	17	13	30	0	3	33	0	0
10	40826436	.	A	G	9	8	17	0	1	18	0	0
10	40826494	.	A	G	10	4	14	0	0	14	0	0
10	40826516	.	A	G	13	5	18	0	0	18	0	0
10	40826589	.	C	T	22	13	35	0	0	35	0	0
10	40826590	.	A	G	21	13	34	0	0	34	0	0
10	40859336	.	T	A	1	3	4	0	0	4	0	0
10	40859338	.	A	G	1	2	3	0	1	4	0	0
10	40859503	.	G	A	3	3	6	0	0	6	0	0
10	40859512	.	C	T	3	2	5	0	0	5	0	0
10	40859722	.	A	G	8	4	12	0	0	12	0	0
10	40859885	.	A	G	3	5	8	0	0	8	0	0
10	40859968	.	T	C	10	5	15	0	0	15	0	0
10	40860070	.	G	C	3	0	3	0	7	10	0	0
10	40861563	.	C	A	2	3	5	0	0	5	0	0
10	40861650	.	G	A	7	4	11	0	0	11	0	0
10	40861701	.	G	T	7	4	11	0	0	11	0	0
10	40866244	.	T	C	3	0	3	0	6	9	0	0
10	40872771	.	G	A	6	6	12	0	0	12	0	0
10	40872816	.	A	G	5	3	8	0	0	8	0	0
10	40877124	.	A	G	3	2	5	0	0	5	0	0
10	41089380	.	A	G	10	15	25	0	1	26	0	0
10	41099458	.	A	G	4	11	15	0	0	15	0	0
10	41104088	.	G	C	4	0	4	0	3	7	0	0
10	41106892	.	A	C	8	7	15	0	1	16	0	0
10	41106982	.	G	A	14	7	21	0	1	22	0	0
10	41107066	.	A	T	14	10	24	0	3	27	0	0
10	41108246	.	G	T	12	5	17	0	2	19	0	0
10	41111804	.	C	A	10	6	16	0	0	16	0	0
10	41111851	.	C	T	1	9	10	0	10	20	0	0
10	41111877	.	G	A	12	11	23	0	1	24	0	0
10	41111975	.	T	C	16	18	34	0	1	35	0	0
10	41111993	.	C	T	3	11	14	0	21	35	0	0
10	41112076	.	T	C	11	2	13	0	11	24	0	0
10	41115360	.	C	A	10	9	19	0	2	21	0	0
10	41121590	.	C	A	7	14	21	0	0	21	0	0
10	41129375	.	T	C	11	7	18	0	2	20	0	0
10	41136356	.	G	A	9	10	19	0	1	20	0	0
10	41136365	.	G	A	8	12	20	0	0	20	0	0
10	41143525	.	G	A	4	4	8	0	0	8	0	0
10	41156370	.	A	T	3	3	6	0	0	6	0	0
10	41156857	.	G	T	3	6	9	0	0	9	0	0
10	41185133	.	A	T	1	2	3	0	0	3	0	0
10	41192623	.	C	A	8	3	11	0	0	11	0	0
10	41362430	.	A	G	2	2	4	0	1	5	0	0
10	41362763	.	C	G	12	17	29	1	1	32	1	0
10	41362839	.	A	G	15	13	28	1	0	29	0	0
10	41368569	.	G	A	11	11	22	0	1	23	0	0
10	41368626	.	C	T	1	8	9	0	13	22	0	0
10	41373231	.	G	A	10	10	20	0	0	20	0	0
10	41376895	.	G	A	9	5	14	1	0	15	0	0
10	41379918	.	G	C	9	6	15	0	0	15	0	0
10	41379992	.	G	A	9	8	17	0	2	19	0	0
10	41380079	.	G	C	15	1	16	0	12	28	0	0
10	41397380	.	G	T	4	9	13	0	1	14	0	0
10	41397404	.	G	A	4	6	10	0	1	11	0	0
10	41397443	.	G	A	8	9	17	0	1	18	0	0
10	41397533	.	A	G	8	6	14	0	1	15	0	0
10	41397712	.	A	G	6	4	10	0	0	10	0	0
10	41399919	.	G	A	10	3	13	0	0	13	0	0
10	41399968	.	G	T	6	17	23	0	1	24	0	0
10	41409570	.	G	T	3	3	6	0	1	7	0	0
10	41409578	.	T	A	4	3	7	0	0	7	0	0
10	41409781	.	C	T	3	7	10	0	0	10	0	0
10	41419075	.	C	T	7	9	16	0	0	16	0	0
10	41605886	.	C	T	3	3	6	0	0	6	0	0
10	41606172	.	G	C	1	2	3	0	0	3	0	0
10	41607052	.	G	A	3	4	7	0	1	8	0	0
10	41607357	.	C	T	12	5	17	0	0	17	0	0
10	41607396	.	C	T	13	3	16	1	0	17	0	0
10	41607492	.	A	G	3	0	3	0	2	5	0	0
10	41607787	.	A	C	5	5	10	0	0	10	0	0
10	41607939	.	C	A	8	6	14	0	0	14	0	0
10	41607966	.	T	C	4	10	14	0	0	14	0	0
10	41608254	.	A	C	5	2	7	0	0	7	0	0
10	41608379	.	G	C	6	5	11	0	0	11	0	0
10	41608479	.	G	A	6	7	13	0	0	13	0	0
10	41608513	.	A	G	7	1	8	0	7	15	0	0
10	41608561	.	A	T	3	4	7	1	0	8	0	0
10	41608615	.	C	T	8	5	13	1	0	14	0	0
10	41608871	.	G	T	5	3	8	0	0	8	0	0
10	41608935	.	G	A	0	6	6	0	8	14	0	0
10	41690816	.	C	T	1	2	3	0	0	3	0	0
10	41690840	.	T	C	4	2	6	0	0	6	0	0
10	41735272	.	C	T	2	2	4	0	1	5	0	0
10	41765973	.	C	T	5	8	13	0	1	14	0	0
10	41766022	.	A	G	10	1	11	0	4	15	0	0
10	41801475	.	C	T	4	8	12	0	0	12	0	0
10	41801664	.	G	A	1	3	4	0	0	4	0	0
10	41816988	.	C	T	5	8	13	0	0	13	0	0
10	41816991	.	G	A	5	7	12	0	0	12	0	0
10	41817054	.	T	C	9	4	13	0	0	13	0	0
10	41817094	.	C	A	5	9	14	0	1	15	0	0
10	41830403	.	G	A	26	14	40	0	0	40	0	0
10	41830435	.	C	T	19	17	36	0	1	37	0	0
10	41832092	.	C	A	6	12	18	0	1	19	0	0
10	41834276	.	G	T	13	15	28	0	1	29	0	0
10	41834300	.	C	T	18	9	27	0	0	27	0	0
10	41835199	.	C	T	6	11	17	0	1	18	0	0
10	41837039	.	T	C	4	14	18	0	0	18	0	0
10	41837425	.	G	C	15	9	24	0	1	25	0	0
10	41837486	.	T	C	15	11	26	0	0	26	0	0
10	41837528	.	A	G	12	7	19	0	1	20	0	0
10	41841178	.	G	T	9	15	24	0	0	24	0	0
10	41841209	.	C	G	8	15	23	0	1	24	0	0
10	41841214	.	G	C	7	13	20	0	0	20	0	0
10	41843743	.	C	A	1	7	8	0	9	17	0	0
10	41879500	.	A	G	3	3	6	0	0	6	0	0
10	41879506	.	G	A	3	4	7	0	0	7	0	0
10	41891658	.	C	G	1	4	5	0	3	8	0	0
10	41894738	.	T	A	4	2	6	0	0	6	0	0
10	41894792	.	T	C	1	4	5	0	0	5	0	0
10	41902778	.	A	C	7	0	7	0	6	13	0	0
10	41902817	.	A	G	5	4	9	0	2	11	0	0
10	41926939	.	C	G	4	2	6	0	0	6	0	0
10	41954644	.	T	A	4	4	8	0	0	8	0	0
10	41959280	.	A	G	4	3	7	0	1	8	0	0
10	41959325	.	C	A	1	4	5	0	0	5	0	0
10	41959448	.	A	G	1	2	3	0	0	3	0	0
10	41959597	.	T	C	4	2	6	0	0	6	0	0
10	41959919	.	T	C	2	2	4	0	0	4	0	0
10	41983494	.	T	C	5	0	5	0	7	12	0	0
10	41983674	.	C	T	2	4	6	0	0	6	0	0
10	41983798	.	A	C	3	2	5	0	0	5	0	0
10	41983800	.	T	G	3	2	5	0	0	5	0	0
10	41985364	.	G	A	1	2	3	0	0	3	0	0
10	41985911	.	G	A	3	3	6	0	0	6	0	0
10	41988086	.	C	G	3	0	3	0	2	5	0	0
10	41992924	.	G	T	4	4	8	0	0	8	0	0
10	42006943	.	A	G	7	3	10	0	0	10	0	0
10	42011054	.	T	C	3	5	8	0	0	8	0	0
10	42011060	.	G	T	4	7	11	0	0	11	0	0
10	42011245	.	C	T	5	6	11	0	0	11	0	0
10	42011293	.	G	A	4	7	11	0	2	13	0	0
10	42017620	.	C	T	4	3	7	0	0	7	0	0
10	42020205	.	T	A	2	10	12	0	0	12	0	0
10	42020285	.	G	A	6	3	9	0	0	9	0	0
10	42020422	.	C	T	4	5	9	0	1	10	0	0
10	42020451	.	C	T	10	4	14	0	0	14	0	0
10	42020592	.	G	T	5	7	12	0	1	13	0	0
10	42020684	.	A	G	3	0	3	0	13	16	0	0
10	42021321	.	G	A	4	3	7	0	0	7	0	0
10	42021384	.	T	C	1	4	5	0	1	6	0	0
10	42021485	.	A	T	4	9	13	0	0	13	0	0
10	42021515	.	T	A	6	3	9	0	0	12	3	0
10	42021543	.	T	C	8	4	12	0	1	13	0	0
10	42022014	.	C	G	4	10	14	0	0	14	0	0
10	42036689	.	G	T	2	5	7	0	1	8	0	0
10	42044480	.	G	A	10	8	18	0	0	18	0	0
10	42044497	.	A	G	10	10	20	0	0	20	0	0
10	42044745	.	T	G	12	7	19	0	0	19	0	0
10	42044746	.	C	T	13	7	20	0	0	20	0	0
10	42044809	.	T	A	19	6	25	0	2	27	0	0
10	42045075	.	T	G	21	5	26	0	1	27	0	0
10	42045254	.	C	T	2	6	8	0	5	13	0	0
10	42045300	.	G	C	10	5	15	0	0	15	0	0
10	42047442	.	T	A	2	2	4	0	0	4	0	0
10	42050758	.	C	T	6	3	9	0	0	9	0	0
10	42089484	.	C	A	1	2	3	0	0	3	0	0
10	42089729	.	C	A	1	3	4	0	0	4	0	0
10	42089731	.	G	A	1	3	4	0	0	4	0	0
10	42089945	.	T	C	2	0	2	0	2	4	0	0
10	42089964	.	T	C	2	2	4	0	0	4	0	0
10	42090214	.	A	G	7	11	18	0	2	20	0	0
10	42090222	.	A	G	12	11	23	0	1	24	0	0
10	42090315	.	T	C	14	12	26	0	1	27	0	0
10	42093928	.	A	G	12	12	24	0	2	26	0	0
10	42101122	.	A	G	5	10	15	0	0	15	0	0
10	42104361	.	T	G	7	6	13	0	1	14	0	0
10	42107853	.	C	T	5	5	10	0	0	10	0	0
10	42107884	.	C	T	1	6	7	0	3	10	0	0
10	42108029	.	G	A	7	7	14	0	0	14	0	0
10	42108077	.	T	A	7	4	11	0	0	11	0	0
10	42111601	.	G	A	3	8	11	0	0	11	0	0
10	42111955	.	G	A	2	2	4	0	0	4	0	0
10	42112062	.	T	A	5	5	10	0	0	10	0	0
10	42112075	.	T	C	5	0	5	0	7	12	0	0
10	42119816	.	A	G	6	3	9	0	0	9	0	0
10	42123309	.	C	G	4	8	12	0	0	12	0	0
10	42123334	.	T	C	3	0	3	0	11	14	0	0
10	42123388	.	A	G	6	13	19	0	1	20	0	0
10	42125549	.	C	T	10	4	14	0	1	15	0	0
10	42125702	.	C	T	6	7	13	0	0	13	0	0
10	42128886	.	A	G	12	10	22	1	0	23	0	0
10	42128898	.	C	T	9	8	17	1	1	19	0	0
10	42131297	.	A	T	12	5	17	0	1	18	0	0
10	42134574	.	A	G	3	6	9	0	0	9	0	0
10	42134629	.	C	T	2	3	5	0	0	5	0	0
10	42134662	.	T	A	1	3	4	0	0	4	0	0
10	42135035	.	C	T	2	5	7	0	0	7	0	0
10	42135131	.	A	G	3	4	7	0	0	7	0	0
10	42135449	.	T	C	4	3	7	0	0	7	0	0
10	42135472	.	A	G	5	2	7	0	0	7	0	0
10	42135501	.	T	C	2	4	6	0	0	6	0	0
10	42136716	.	T	C	3	0	3	0	3	6	0	0
10	42137108	.	A	G	8	2	10	1	1	12	0	0
10	42137140	.	C	T	0	3	3	0	5	8	0	0
10	42137452	.	G	A	3	5	8	0	0	8	0	0
10	42137503	.	T	C	2	2	4	0	0	4	0	0
10	42137847	.	G	T	1	2	3	0	0	3	0	0
10	42137895	.	A	G	3	2	5	0	0	5	0	0
10	42137985	.	G	C	1	1	2	0	1	3	0	0
10	42138380	.	T	C	9	0	9	0	7	16	0	0
10	42140199	.	G	A	3	2	5	0	0	5	0	0
10	42140224	.	A	T	6	4	10	0	0	10	0	0
10	42143434	.	T	A	1	3	4	0	0	4	0	0
10	42462644	.	A	G	3	0	3	0	2	5	0	0
10	42636352	.	T	C	2	2	4	0	1	5	0	0
10	42636382	.	C	T	1	2	3	0	0	3	0	0
10	42636448	.	C	T	3	2	5	0	0	5	0	0
10	42650372	.	A	G	1	0	1	0	2	3	0	0
10	42652463	.	C	T	3	6	9	0	0	9	0	0
10	42659358	.	C	T	2	3	5	0	0	5	0	0
10	42661358	.	A	G	2	3	5	0	0	5	0	0
10	42691349	.	T	C	11	7	18	0	1	19	0	0
10	42694573	.	A	G	9	0	9	0	10	19	0	0
10	42701006	.	C	T	12	6	18	0	0	18	0	0
10	42701027	.	C	G	10	9	19	0	0	19	0	0
10	42701051	.	T	C	11	12	23	0	0	23	0	0
10	42701315	.	T	A	16	6	22	0	1	23	0	0
10	42701317	.	A	G	15	3	18	0	5	23	0	0
10	42704608	.	T	G	14	8	22	0	1	23	0	0
10	42704622	.	A	T	10	9	19	0	2	21	0	0
10	42704643	.	A	T	8	9	17	0	0	17	0	0
10	42704929	.	C	T	15	7	22	0	1	23	0	0
10	42704988	.	T	C	9	12	21	0	1	22	0	0
10	42708084	.	A	G	10	6	16	1	1	18	0	0
10	42708132	.	C	T	10	4	14	1	1	16	0	0
10	42709610	.	T	C	12	6	18	0	3	21	0	0
10	42709634	.	T	C	11	10	21	0	3	24	0	0
10	42715853	.	C	T	32	10	42	0	2	44	0	0
10	42716271	.	T	C	13	6	19	0	0	19	0	0
10	42716278	.	T	G	13	0	13	0	7	20	0	0
10	42738094	.	A	G	5	8	13	0	0	13	0	0
10	42738095	.	C	T	4	8	12	0	0	12	0	0
10	42738132	.	T	A	7	12	19	0	0	19	0	0
10	42738343	.	A	G	4	6	10	1	0	11	0	0
10	42738400	.	A	G	6	5	11	0	0	11	0	0
10	42739527	.	A	G	6	3	9	0	4	13	0	0
10	42739589	.	G	A	15	8	23	0	0	23	0	0
10	42739593	.	T	C	14	10	24	0	1	26	1	0
10	42739938	.	C	T	8	4	12	2	1	15	0	0
10	42740111	.	G	A	1	5	6	0	14	20	0	0
10	42740302	.	T	A	13	14	27	0	2	29	0	0
10	42741347	.	T	G	17	12	29	0	8	37	0	0
10	42741469	.	T	A	29	18	47	0	1	48	0	0
10	42741528	.	G	T	29	16	45	0	2	47	0	0
10	42741662	.	G	A	28	17	45	0	3	48	0	0
10	42741918	.	C	T	21	16	37	0	1	38	0	0
10	42742058	.	T	C	4	0	4	0	6	10	0	0
10	42742101	.	T	A	5	3	8	0	0	8	0	0
10	42742412	.	G	T	15	6	21	2	1	24	0	0
10	42742415	.	T	G	14	8	22	2	2	26	0	0
10	42742472	.	C	G	13	8	21	0	0	21	0	0
10	42742544	.	T	C	3	14	17	0	0	17	0	0
10	42742560	.	T	C	16	8	24	0	0	24	0	0
10	42742594	.	A	G	11	15	26	0	1	27	0	0
10	42742604	.	G	T	14	18	32	0	0	32	0	0
10	42742798	.	G	T	19	9	28	4	0	32	0	0
10	42742835	.	C	T	22	5	27	0	1	28	0	0
10	42742851	.	G	A	16	6	22	0	0	22	0	0
10	42742981	.	T	A	3	4	7	1	0	8	0	0
10	42742998	.	C	A	4	3	7	1	0	8	0	0
10	42743337	.	C	T	6	2	8	1	0	9	0	0
10	42743608	.	A	C	3	5	8	7	0	15	0	0
10	42743624	.	T	G	4	4	8	7	0	15	0	0
10	42743666	.	G	T	6	7	13	25	3	41	0	0
10	42744078	.	C	T	12	6	18	0	0	18	0	0
10	42744085	.	A	T	12	7	19	0	0	19	0	0
10	42744124	.	A	T	10	7	17	6	0	23	0	0
10	42744219	.	A	C	6	2	8	0	0	8	0	0
10	42744705	.	A	T	11	11	22	0	0	22	0	0
10	42744831	.	T	G	11	6	17	3	0	20	0	0
10	42744912	.	C	A	15	7	22	0	1	23	0	0
10	42744923	.	T	C	15	5	20	0	0	20	0	0
10	42745147	.	A	G	13	10	23	0	2	25	0	0
10	42748084	.	A	T	15	21	36	0	0	36	0	0
10	42748096	.	A	G	13	17	30	0	0	30	0	0
10	42748120	.	A	G	10	19	29	0	0	29	0	0
10	42759781	.	T	A	15	9	24	0	1	25	0	0
10	42762535	.	T	C	10	9	19	0	1	20	0	0
10	42767123	.	G	A	18	18	36	0	1	37	0	0
10	42767252	.	C	T	4	17	21	0	21	42	0	0
10	42775877	.	A	C	8	0	8	0	10	18	0	0
10	42775891	.	C	A	10	7	17	0	0	17	0	0
10	42874159	.	T	G	2	2	4	0	0	4	0	0
10	42875870	.	T	C	1	3	4	0	1	5	0	0
10	42875884	.	G	A	1	2	3	0	0	3	0	0
10	42876861	.	A	C	1	0	1	0	6	7	0	0
10	42876967	.	T	C	2	2	4	0	0	4	0	0
10	42880688	.	C	T	4	3	7	0	0	7	0	0
10	42880694	.	T	A	3	3	6	0	0	6	0	0
10	42881300	.	C	A	3	2	5	0	1	6	0	0
10	42899020	.	C	T	8	3	11	0	1	12	0	0
10	42900909	.	G	T	0	3	3	0	2	5	0	0
10	42902618	.	T	C	5	4	9	0	0	9	0	0
10	42902666	.	G	A	4	3	7	0	0	7	0	0
10	42903875	.	T	C	1	2	3	0	0	3	0	0
10	42930776	.	T	C	5	0	5	0	13	19	1	0
10	42930781	.	T	C	11	0	11	0	7	18	0	0
10	42930814	.	T	C	15	9	24	0	0	24	0	0
10	42930828	.	T	C	8	15	23	0	0	23	0	0
10	42931278	.	T	C	10	4	14	0	0	14	0	0
10	42949713	.	A	G	5	5	10	0	1	11	0	0
10	42992877	.	T	C	9	10	19	0	1	20	0	0
10	43044188	.	G	T	2	4	6	0	0	6	0	0
10	43044206	.	T	C	1	3	4	0	0	4	0	0
10	43057697	.	C	T	5	4	9	0	0	9	0	0
10	43072939	.	A	G	2	3	5	0	1	6	0	0
10	43072943	.	T	C	2	4	6	0	0	6	0	0
10	43073049	.	C	T	4	3	7	0	0	7	0	0
10	43073103	.	A	G	2	3	5	0	0	5	0	0
10	43149237	.	A	G	6	0	6	0	6	12	0	0
10	43157426	.	C	A	5	3	8	0	1	9	0	0
10	43194823	.	C	T	3	2	5	0	0	5	0	0
10	43225563	.	G	A	1	3	4	0	3	7	0	0
10	43230976	.	T	C	1	2	3	0	0	3	0	0
10	43231317	.	C	A	1	3	4	0	0	4	0	0
10	43231591	.	T	A	1	2	3	0	1	4	0	0
10	43231887	.	C	T	1	4	5	0	0	5	0	0
10	43231919	.	G	A	2	2	4	0	0	4	0	0
10	43231972	.	G	A	1	2	3	0	1	4	0	0
10	43232272	.	C	T	8	3	11	0	0	11	0	0
10	43232340	.	C	T	1	2	3	0	0	3	0	0
10	43232668	.	A	C	3	3	6	0	0	6	0	0
10	43290759	.	C	T	3	2	5	0	2	7	0	0
10	43355979	.	A	G	15	8	23	0	0	23	0	0
10	43365046	.	A	G	11	17	28	0	0	28	0	0
10	43372035	.	A	G	9	7	16	0	0	16	0	0
10	43372466	.	C	T	9	9	18	0	0	18	0	0
10	43375407	.	T	A	8	14	22	0	2	24	0	0
10	43395095	.	T	C	8	0	8	0	9	17	0	0
10	43413801	.	T	C	0	2	2	0	1	3	0	0
10	43413806	.	T	A	1	2	3	0	0	3	0	0
10	43434323	.	G	C	2	3	5	0	0	5	0	0
10	43450100	.	C	T	2	1	3	0	0	3	0	0
10	43450110	.	A	G	2	2	4	0	0	4	0	0
10	43450144	.	C	T	4	3	7	0	0	7	0	0
10	43450145	.	T	C	4	3	7	0	0	7	0	0
10	43450357	.	A	C	1	2	3	0	0	3	0	0
10	43499966	.	C	T	1	2	3	0	0	3	0	0
10	43499974	.	T	C	3	2	5	0	0	5	0	0
10	43545250	.	T	G	4	8	12	0	0	12	0	0
10	43545269	.	C	T	4	3	7	0	1	8	0	0
10	43545446	.	T	A	6	9	15	0	0	16	1	0
10	43545475	.	A	C	5	11	16	0	1	17	0	0
10	43545681	.	C	T	7	6	13	0	0	13	0	0
10	43547194	.	T	A	4	5	9	0	0	9	0	0
10	43547684	.	T	A	4	6	10	0	0	10	0	0
10	43547724	.	G	A	3	4	7	0	0	7	0	0
10	43548297	.	G	A	3	5	8	0	0	8	0	0
10	43548301	.	A	G	3	5	8	0	0	8	0	0
10	43548488	.	A	T	3	8	11	0	0	11	0	0
10	43548508	.	A	G	4	6	10	0	0	10	0	0
10	43548543	.	T	C	7	0	7	0	2	9	0	0
10	43549060	.	G	A	5	10	15	0	1	16	0	0
10	43549062	.	G	T	5	11	16	0	0	16	0	0
10	43549435	.	T	A	4	4	8	0	0	8	0	0
10	43550123	.	G	A	2	2	4	0	0	4	0	0
10	43550156	.	G	C	2	5	7	0	0	7	0	0
10	43554507	.	A	G	4	2	6	0	1	7	0	0
10	43558079	.	G	T	3	6	9	0	1	10	0	0
10	43568222	.	G	A	6	3	9	0	0	9	0	0
10	43709042	.	A	T	3	3	6	0	0	6	0	0
10	43709084	.	T	C	4	4	8	0	0	8	0	0
10	43709085	.	G	C	4	4	8	0	0	8	0	0
10	43709204	.	A	G	11	9	20	0	0	20	0	0
10	43711059	.	T	A	22	13	35	0	0	35	0	0
10	43715981	.	G	A	28	8	36	0	3	39	0	0
10	43721415	.	C	T	19	15	34	0	0	34	0	0
10	43761719	.	T	A	6	3	9	0	1	10	0	0
10	43761755	.	A	G	8	8	16	0	0	16	0	0
10	43761996	.	G	A	5	3	8	0	1	9	0	0
10	43762021	.	C	T	8	5	13	0	0	13	0	0
10	43762142	.	C	T	2	3	5	0	2	7	0	0
10	43762519	.	A	G	2	7	9	0	0	9	0	0
10	43762654	.	A	G	14	8	22	0	1	23	0	0
10	43762717	.	A	G	5	5	10	0	1	11	0	0
10	43762755	.	A	C	8	4	12	0	0	12	0	0
10	43765291	.	G	C	6	9	15	0	0	15	0	0
10	43766589	.	T	C	9	0	9	0	7	16	0	0
10	43766688	.	T	G	7	8	15	0	0	15	0	0
10	43766733	.	G	A	8	6	14	0	0	14	0	0
10	43766817	.	A	C	6	0	6	0	6	12	0	0
10	43771142	.	C	T	4	8	12	0	0	12	0	0
10	43771238	.	G	A	1	3	4	0	0	4	0	0
10	43771302	.	G	A	1	3	4	0	0	4	0	0
10	43806993	.	A	C	4	4	8	0	0	8	0	0
10	43807019	.	G	C	3	3	6	0	0	6	0	0
10	43863742	.	A	C	4	3	7	0	0	7	0	0
10	43863779	.	A	C	4	2	6	0	0	6	0	0
10	43865750	.	G	A	2	2	4	0	0	4	0	0
10	43865933	.	T	C	1	2	3	0	0	3	0	0
10	43888751	.	G	A	1	2	3	0	0	3	0	0
10	43893287	.	G	T	4	4	8	0	0	8	0	0
10	43958439	.	A	C	14	13	27	0	1	28	0	0
10	43999640	.	G	T	7	6	13	0	2	15	0	0
10	44002836	.	G	A	8	10	18	0	0	18	0	0
10	44011744	.	A	G	4	6	10	1	0	11	0	0
10	44057263	.	T	A	10	13	23	0	1	24	0	0
10	44134118	.	A	G	14	0	14	0	14	28	0	0
10	44146313	.	C	T	17	9	26	0	0	26	0	0
10	44155428	.	C	T	22	10	32	0	1	33	0	0
10	44155446	.	G	C	2	9	11	0	23	34	0	0
10	44170593	.	G	T	15	13	28	0	0	28	0	0
10	44176257	.	C	T	18	9	27	0	1	28	0	0
10	44180299	.	C	T	14	22	36	0	2	38	0	0
10	44189322	.	G	A	22	19	41	0	1	42	0	0
10	44297245	.	G	T	11	4	15	0	0	15	0	0
10	44314569	.	C	T	8	10	18	0	1	19	0	0
10	44314579	.	A	G	12	8	20	0	0	20	0	0
10	44320823	.	G	C	14	6	20	0	1	21	0	0
10	44337487	.	C	G	4	3	7	0	0	7	0	0
10	44337652	.	G	T	5	7	12	0	0	12	0	0
10	44337710	.	G	A	3	6	9	0	0	9	0	0
10	44337718	.	T	C	0	0	0	0	8	8	0	0
10	44340944	.	C	T	9	7	16	0	1	17	0	0
10	44345005	.	C	T	1	8	9	0	11	20	0	0
10	44346449	.	T	C	6	0	6	0	3	9	0	0
10	44353914	.	G	A	11	4	15	0	0	15	0	0
10	44354053	.	G	C	6	5	11	0	0	11	0	0
10	44354736	.	A	C	8	3	11	0	0	11	0	0
10	44363242	.	G	T	9	8	17	0	1	18	0	0
10	44364604	.	A	T	13	10	23	0	1	25	1	0
10	44364610	.	C	T	14	10	24	0	1	25	0	0
10	44371710	.	G	T	3	6	9	0	14	23	0	0
10	44375738	.	T	G	5	1	6	0	5	11	0	0
10	44375785	.	G	A	1	7	8	0	3	11	0	0
10	44377942	.	G	C	13	5	18	0	0	18	0	0
10	44409402	.	C	G	8	6	14	0	0	14	0	0
10	44410082	.	C	T	9	7	16	0	0	16	0	0
10	44410088	.	G	A	6	9	15	0	1	16	0	0
10	44410241	.	G	A	6	5	11	0	1	12	0	0
10	44410975	.	T	C	3	5	8	0	0	8	0	0
10	44437145	.	T	C	21	14	35	0	2	37	0	0
10	44465477	.	C	T	2	3	5	0	3	8	0	0
10	44466844	.	G	A	3	3	6	0	0	6	0	0
10	44503882	.	G	A	12	9	21	0	1	22	0	0
10	44506313	.	C	T	1	9	10	0	11	21	0	0
10	44513232	.	T	C	4	3	7	0	1	8	0	0
10	44513270	.	T	C	6	0	6	0	4	10	0	0
10	44513307	.	T	C	7	3	10	0	2	12	0	0
10	44513402	.	T	C	7	0	7	0	6	13	0	0
10	44513421	.	C	T	1	9	10	0	6	16	0	0
10	44515911	.	G	C	4	4	8	0	1	9	0	0
10	44515927	.	T	C	4	5	9	0	0	9	0	0
10	44516001	.	C	T	1	3	4	0	5	9	0	0
10	44516270	.	G	T	3	7	10	0	0	10	0	0
10	44516535	.	A	T	4	3	7	0	1	8	0	0
10	44516559	.	T	C	3	0	3	0	6	9	0	0
10	44516907	.	G	T	2	4	6	0	0	6	0	0
10	44516908	.	T	C	1	0	1	0	5	6	0	0
10	44516955	.	C	T	3	3	6	0	0	6	0	0
10	44517092	.	G	A	6	4	10	0	0	10	0	0
10	44517170	.	C	T	0	5	5	0	3	8	0	0
10	44581983	.	C	G	9	20	29	0	1	30	0	0
10	44640688	.	A	C	16	10	26	0	0	26	0	0
10	44640700	.	C	T	18	9	27	0	0	27	0	0
10	44640725	.	C	A	9	13	22	0	0	22	0	0
10	44640742	.	G	A	1	11	12	0	11	23	0	0
10	44640832	.	G	A	11	17	28	0	0	28	0	0
10	44640873	.	G	A	7	10	17	0	1	18	0	0
10	44640910	.	A	C	11	10	21	0	0	21	0	0
10	44641025	.	G	A	10	10	20	0	2	22	0	0
10	44641815	.	C	A	11	8	19	0	1	20	0	0
10	44648115	.	G	T	0	5	5	0	9	14	0	0
10	44648627	.	C	T	6	10	16	0	2	18	0	0
10	44650913	.	G	A	3	13	16	0	14	30	0	0
10	44652561	.	G	A	1	19	20	0	14	34	0	0
10	44656821	.	C	G	13	24	37	0	0	37	0	0
10	44656863	.	C	T	16	17	33	0	0	33	0	0
10	44656926	.	C	T	25	12	37	0	0	37	0	0
10	44659668	.	A	G	14	15	29	0	2	31	0	0
10	44663082	.	A	G	20	18	38	1	1	40	0	0
10	44665345	.	G	T	1	9	10	0	17	27	0	0
10	44665536	.	A	T	17	14	31	0	0	31	0	0
10	44665620	.	C	T	12	13	25	0	0	25	0	0
10	44667125	.	T	C	14	19	33	0	0	33	0	0
10	44669263	.	G	A	11	11	22	0	0	22	0	0
10	44669402	.	G	A	5	6	11	0	3	14	0	0
10	44669497	.	A	G	7	12	19	0	3	22	0	0
10	44671799	.	G	A	2	15	17	0	15	32	0	0
10	44671818	.	A	C	13	14	27	0	0	28	1	0
10	44672036	.	T	A	28	12	40	0	1	41	0	0
10	44672228	.	G	A	7	8	15	0	0	15	0	0
10	44692308	.	A	T	15	12	27	0	0	27	0	0
10	44692314	.	C	A	17	14	31	0	0	31	0	0
10	44693445	.	G	A	11	8	19	49	1	69	0	0
10	44693523	.	T	G	40	6	46	2	33	81	0	0
10	44693556	.	C	T	15	23	38	9	3	50	0	0
10	44693769	.	C	T	42	25	67	28	19	114	0	0
10	44693799	.	T	C	36	12	48	59	0	107	0	0
10	44693868	.	G	A	35	7	42	14	0	56	0	0
10	44694354	.	G	A	46	19	65	16	4	85	0	0
10	44733825	.	C	T	2	2	4	0	1	5	0	0
10	44736522	.	G	A	3	4	7	0	0	7	0	0
10	44738221	.	G	A	2	3	5	0	1	6	0	0
10	44738290	.	C	T	5	7	12	0	0	12	0	0
10	44745648	.	T	G	3	6	9	0	0	9	0	0
10	44900001	.	T	C	3	2	5	0	0	5	0	0
10	44900901	.	T	G	1	2	3	0	0	3	0	0
10	44905224	.	A	G	14	16	30	0	0	30	0	0
10	44914623	.	A	G	13	0	13	0	7	20	0	0
10	44914761	.	T	A	5	9	14	0	0	14	0	0
10	44940952	.	G	T	0	3	3	0	2	5	0	0
10	44941051	.	C	T	5	2	7	0	0	7	0	0
10	44941408	.	G	A	3	2	5	0	0	5	0	0
10	44941825	.	G	C	0	3	3	0	1	4	0	0
10	44979593	.	A	T	7	6	13	0	0	13	0	0
10	44979712	.	A	G	4	3	7	0	0	7	0	0
10	44979767	.	A	G	8	6	14	0	0	14	0	0
10	44979792	.	T	C	5	7	12	0	1	13	0	0
10	44980379	.	T	C	4	6	10	0	0	10	0	0
10	44980391	.	C	T	7	6	13	0	0	13	0	0
10	44980913	.	C	T	6	11	17	0	3	20	0	0
10	44989378	.	C	T	29	24	53	1	2	56	0	0
10	44989384	.	T	C	30	25	55	1	2	58	0	0
10	44990917	.	C	T	26	25	51	0	4	55	0	0
10	45055879	.	G	A	9	11	20	0	1	21	0	0
10	45055948	.	G	A	15	12	27	0	0	27	0	0
10	45059822	.	C	T	10	12	22	0	1	23	0	0
10	45064957	.	C	T	14	19	33	0	0	33	0	0
10	45069978	.	A	C	11	6	17	0	0	17	0	0
10	45085679	.	C	T	15	10	25	0	0	25	0	0
10	45089826	.	A	G	11	0	11	0	8	19	0	0
10	45099498	.	T	C	15	9	24	0	2	26	0	0
10	45099522	.	T	C	16	13	29	0	2	31	0	0
10	45101543	.	G	A	2	11	13	0	5	18	0	0
10	45103519	.	C	T	12	8	20	0	2	22	0	0
10	45105244	.	T	C	21	5	26	0	0	26	0	0
10	45160904	.	C	A	3	3	6	0	0	6	0	0
10	45160907	.	C	T	3	3	6	0	0	6	0	0
10	45170325	.	C	A	1	3	4	0	1	5	0	0
10	45175496	.	G	A	6	3	9	0	0	9	0	0
10	45179688	.	A	C	2	5	7	0	0	7	0	0
10	45180294	.	C	T	4	8	12	0	0	12	0	0
10	45180335	.	C	T	7	4	11	0	0	11	0	0
10	45187450	.	T	C	4	4	8	0	0	8	0	0
10	45189611	.	C	G	2	3	5	0	0	5	0	0
10	45190629	.	C	T	3	5	8	0	0	8	0	0
10	45203109	.	T	C	7	11	18	0	0	18	0	0
10	45203154	.	A	G	4	8	12	0	1	13	0	0
10	45203271	.	T	A	8	9	17	0	1	18	0	0
10	45203646	.	A	G	5	5	10	0	1	11	0	0
10	45203793	.	G	A	1	3	4	0	4	8	0	0
10	45203856	.	G	A	8	3	11	1	1	13	0	0
10	45203882	.	A	G	10	3	13	0	1	14	0	0
10	45203951	.	G	A	0	3	3	0	8	11	0	0
10	45203952	.	C	T	7	4	11	0	0	11	0	0
10	45204151	.	A	G	2	2	4	0	0	4	0	0
10	45204185	.	T	C	2	4	6	0	0	6	0	0
10	45204218	.	A	G	4	0	4	0	3	7	0	0
10	45204527	.	A	G	2	3	5	0	0	5	0	0
10	45204568	.	G	T	5	2	7	0	0	7	0	0
10	45204611	.	A	G	4	3	7	0	0	7	0	0
10	45204621	.	T	C	3	5	8	0	2	10	0	0
10	45204739	.	A	T	2	4	6	0	0	6	0	0
10	45204769	.	T	A	1	3	4	0	1	5	0	0
10	45205166	.	A	C	5	14	19	1	1	21	0	0
10	45205175	.	A	G	3	1	4	1	12	17	0	0
10	45205226	.	A	G	8	1	9	0	10	19	0	0
10	45205237	.	C	G	8	0	8	0	11	19	0	0
10	45205284	.	A	C	10	9	19	0	0	19	0	0
10	45205295	.	A	G	8	0	8	0	10	18	0	0
10	45205400	.	C	A	4	4	8	0	0	8	0	0
10	45205757	.	C	A	5	3	8	0	0	8	0	0
10	45205758	.	A	G	5	3	8	0	0	8	0	0
10	45206289	.	G	C	10	0	10	0	7	17	0	0
10	45206326	.	G	T	6	3	9	0	2	11	0	0
10	45206450	.	T	C	4	0	4	0	11	15	0	0
10	45206478	.	G	T	14	2	16	0	0	16	0	0
10	45208153	.	A	G	5	5	10	0	0	10	0	0
10	45208667	.	C	T	0	8	8	0	3	11	0	0
10	45208875	.	G	A	6	5	11	0	1	12	0	0
10	45208899	.	C	A	9	4	13	0	2	15	0	0
10	45213798	.	C	T	0	8	8	0	3	11	0	0
10	45215720	.	C	T	0	3	3	1	6	10	0	0
10	45222613	.	T	C	2	0	2	0	2	4	0	0
10	45229624	.	C	A	1	4	5	0	0	5	0	0
10	45229710	.	C	T	4	3	7	1	0	8	0	0
10	45248527	.	A	C	10	7	17	0	1	19	1	0
10	45248548	.	T	A	8	8	16	0	0	16	0	0
10	45248638	.	G	A	8	4	12	0	1	13	0	0
10	45313560	.	C	T	6	18	24	0	0	24	0	0
10	45313623	.	G	A	1	9	10	0	8	18	0	0
10	45313671	.	C	T	8	10	18	0	0	18	0	0
10	45322668	.	A	G	10	0	10	0	17	27	0	0
10	45325302	.	G	A	3	9	12	0	11	23	0	0
10	45334629	.	A	C	3	1	4	0	12	16	0	0
10	45334688	.	C	T	6	9	15	0	2	17	0	0
10	45336565	.	T	C	10	13	23	0	1	24	0	0
10	45340105	.	G	T	0	9	9	0	6	15	0	0
10	45340654	.	A	G	2	4	6	2	0	8	0	0
10	45340835	.	G	C	5	7	12	0	1	13	0	0
10	45340930	.	G	T	8	12	20	0	0	20	0	0
10	45341210	.	T	A	2	6	8	0	0	8	0	0
10	45341403	.	A	G	3	7	10	0	0	10	0	0
10	45341410	.	A	G	4	0	4	0	7	11	0	0
10	45341452	.	T	G	6	7	13	0	0	13	0	0
10	45341537	.	A	C	9	15	24	0	0	24	0	0
10	45341546	.	A	C	7	16	23	0	0	23	0	0
10	45341572	.	G	C	0	14	14	0	7	21	0	0
10	45341596	.	C	T	7	8	15	0	0	15	0	0
10	45341762	.	A	T	4	10	14	0	1	15	0	0
10	45349924	.	G	A	39	46	85	0	3	88	0	0
10	45351037	.	C	T	38	41	79	0	4	83	0	0
10	45352231	.	C	T	18	18	36	0	2	38	0	0
10	45375714	.	G	T	16	6	22	0	0	22	0	0
10	45375732	.	C	T	20	7	27	0	0	27	0	0
11	355625	.	G	A	1	2	3	0	0	3	0	0
11	355630	.	G	A	1	2	3	0	0	3	0	0
11	356174	.	C	T	4	6	10	0	1	11	0	0
11	359403	.	A	G	11	0	11	0	9	20	0	0
11	360059	.	A	G	1	0	1	0	2	3	0	0
11	360104	.	A	C	4	2	6	0	0	6	0	0
11	410965	.	C	T	3	4	7	0	0	7	0	0
11	411119	.	C	T	3	4	7	0	1	8	0	0
11	411207	.	A	T	6	10	16	0	0	16	0	0
11	411260	.	C	T	1	5	6	0	7	13	0	0
11	411424	.	T	C	10	4	14	0	0	14	0	0
11	411437	.	T	G	9	3	12	0	0	12	0	0
11	413033	.	A	C	9	6	15	0	0	16	1	0
11	413080	.	A	G	5	7	12	0	0	12	0	0
11	413129	.	C	T	2	10	12	0	0	12	0	0
11	413180	.	T	G	7	5	12	0	0	12	0	0
11	413184	.	A	G	8	5	13	0	0	13	0	0
11	421405	.	G	A	7	3	10	0	0	10	0	0
11	421491	.	T	G	9	8	17	0	0	17	0	0
11	421513	.	G	T	6	9	15	0	0	15	0	0
11	421765	.	C	G	0	3	3	0	2	5	0	0
11	421774	.	G	A	2	3	5	0	0	5	0	0
11	421820	.	A	G	5	2	7	0	0	7	0	0
11	421860	.	G	T	3	2	5	0	1	6	0	0
11	422327	.	T	C	4	0	4	0	2	6	0	0
11	422412	.	C	T	3	2	5	0	0	5	0	0
11	424191	.	A	G	4	2	6	0	0	6	0	0
11	424560	.	G	A	2	2	4	0	0	4	0	0
11	445266	.	C	T	4	2	6	0	0	6	0	0
11	445572	.	A	G	4	1	5	0	0	5	0	0
11	445582	.	C	T	1	2	3	0	0	3	0	0
11	445905	.	G	T	1	2	3	0	0	3	0	0
11	445925	.	T	C	1	2	3	0	0	3	0	0
11	446010	.	T	G	1	2	3	0	0	3	0	0
11	446274	.	A	G	1	4	5	0	0	5	0	0
11	446323	.	G	A	3	4	7	0	0	7	0	0
11	447294	.	G	C	2	3	5	0	0	5	0	0
11	447386	.	C	T	1	6	7	0	0	7	0	0
11	448043	.	T	A	1	3	4	0	0	4	0	0
11	448882	.	A	C	1	3	4	0	0	4	0	0
11	448906	.	C	T	2	2	4	0	0	4	0	0
11	448956	.	G	C	0	3	3	0	2	5	0	0
11	448975	.	A	G	1	2	3	0	1	4	0	0
11	449008	.	T	A	1	3	4	0	0	4	0	0
11	449161	.	C	A	1	3	4	0	0	4	0	0
11	449398	.	T	A	1	2	3	0	0	3	0	0
11	449409	.	A	T	1	2	3	0	0	3	0	0
11	449684	.	G	A	2	5	7	0	0	7	0	0
11	449752	.	A	G	2	1	3	0	7	10	0	0
11	457707	.	C	T	1	14	15	0	11	26	0	0
11	458062	.	G	A	17	19	36	0	1	37	0	0
11	458083	.	A	G	19	20	39	0	1	40	0	0
11	460665	.	C	T	0	14	14	0	14	28	0	0
11	460752	.	G	A	11	20	31	0	0	31	0	0
11	474556	.	C	T	1	4	5	0	0	5	0	0
11	474578	.	A	G	3	4	7	0	0	7	0	0
11	474619	.	A	T	4	4	8	0	0	8	0	0
11	474622	.	G	T	4	5	9	0	0	9	0	0
11	474662	.	C	G	7	4	11	0	0	11	0	0
11	474676	.	A	T	6	3	9	0	1	10	0	0
11	474917	.	C	A	3	4	7	0	1	8	0	0
11	474949	.	A	T	6	3	9	0	0	9	0	0
11	475112	.	T	C	1	3	4	0	0	4	0	0
11	475314	.	C	T	5	4	9	0	0	9	0	0
11	475359	.	A	G	2	4	6	0	0	6	0	0
11	475376	.	T	A	2	3	5	0	1	6	0	0
11	475399	.	G	A	2	4	6	0	0	6	0	0
11	475524	.	G	A	5	2	7	0	0	7	0	0
11	475534	.	C	T	6	0	6	0	2	8	0	0
11	475603	.	G	C	4	4	8	0	0	8	0	0
11	475911	.	G	T	1	7	8	0	0	8	0	0
11	476145	.	G	T	2	5	7	0	1	8	0	0
11	480611	.	G	A	8	7	15	0	0	15	0	0
11	481943	.	A	T	10	7	17	0	1	18	0	0
11	482574	.	T	G	5	4	9	0	0	9	0	0
11	492659	.	C	T	5	33	38	0	19	57	0	0
11	494399	.	T	C	31	33	64	1	0	65	0	0
11	494405	.	A	G	29	31	60	1	4	65	0	0
11	495003	.	T	C	36	35	71	0	2	73	0	0
11	517546	.	G	A	5	2	7	0	0	7	0	0
11	527956	.	C	T	4	9	13	0	2	15	0	0
11	532542	.	G	A	7	4	11	0	0	11	0	0
11	537386	.	G	A	0	3	3	0	1	4	0	0
11	537443	.	C	T	5	6	11	0	1	12	0	0
11	539425	.	T	C	11	14	25	0	1	26	0	0
11	539470	.	G	A	2	10	12	0	6	18	0	0
11	539586	.	C	T	14	6	20	0	2	22	0	0
11	539899	.	T	C	3	2	5	0	2	7	0	0
11	540010	.	C	T	4	3	7	0	1	8	0	0
11	540046	.	G	T	2	5	7	0	0	7	0	0
11	566562	.	G	A	9	6	15	21	0	36	0	0
11	570876	.	A	G	7	8	15	0	0	15	0	0
11	570881	.	T	C	6	0	6	0	9	15	0	0
11	570942	.	C	T	7	5	12	0	2	14	0	0
11	570979	.	C	T	10	11	21	0	0	21	0	0
11	575845	.	G	A	2	3	5	0	0	5	0	0
11	575870	.	C	T	4	3	7	0	0	7	0	0
11	588053	.	C	A	1	3	4	0	0	4	0	0
11	589785	.	C	T	7	9	16	0	0	16	0	0
11	675382	.	G	C	25	26	51	0	1	52	0	0
11	675477	.	G	A	21	25	46	0	2	48	0	0
11	676888	.	G	A	24	18	42	0	2	44	0	0
11	676899	.	A	T	22	19	41	0	2	43	0	0
11	677089	.	A	T	20	16	36	0	2	38	0	0
11	687501	.	G	A	31	21	52	1	2	55	0	0
11	691863	.	C	T	1	19	20	0	22	42	0	0
11	714954	.	G	A	1	4	5	0	4	9	0	0
11	718423	.	G	T	6	3	9	0	0	9	0	0
11	719800	.	G	T	19	23	42	0	4	46	0	0
11	1529838	.	A	G	12	7	19	0	1	20	0	0
11	1529852	.	A	G	15	7	22	0	0	22	0	0
11	1530234	.	A	G	30	5	35	0	0	35	0	0
11	2254438	.	C	T	1	9	10	1	1	12	0	0
11	2255025	.	T	G	6	4	10	0	1	11	0	0
11	2255027	.	T	G	6	5	11	0	1	12	0	0
11	2462475	.	A	G	1	3	4	0	0	4	0	0
11	2681397	.	A	G	7	3	10	0	0	10	0	0
11	2681401	.	A	G	5	0	5	0	5	10	0	0
11	2681464	.	A	G	5	2	7	0	0	7	0	0
11	2681482	.	A	G	3	3	6	0	0	6	0	0
11	2681894	.	A	G	4	3	7	0	0	7	0	0
11	2682384	.	A	G	9	2	11	0	1	12	0	0
11	2690080	.	A	G	3	3	6	0	1	7	0	0
11	2690131	.	A	G	3	2	5	0	0	5	0	0
11	2705657	.	A	G	9	5	14	0	0	14	0	0
11	2758674	.	T	A	1	2	3	0	0	3	0	0
11	2759392	.	C	T	2	2	4	1	0	5	0	0
11	2759425	.	A	G	7	3	10	3	1	14	0	0
11	2759461	.	T	C	7	15	22	2	1	25	0	0
11	2759475	.	G	T	9	16	25	2	2	29	0	0
11	2759498	.	G	A	10	28	38	2	0	40	0	0
11	2828174	.	A	G	16	19	35	0	1	36	0	0
11	3122886	.	A	T	4	5	9	0	0	9	0	0
11	3170359	.	A	G	3	0	3	0	4	7	0	0
11	3175310	.	C	T	2	2	4	0	0	4	0	0
11	3189863	.	C	T	9	5	14	0	0	14	0	0
11	3211974	.	G	C	6	3	9	0	0	9	0	0
11	3212009	.	T	C	2	3	5	0	0	5	0	0
11	3217970	.	C	T	3	2	5	0	0	5	0	0
11	3222083	.	A	G	8	4	12	0	0	12	0	0
11	3222192	.	T	C	4	7	11	0	2	13	0	0
11	3227343	.	G	A	7	5	12	0	0	12	0	0
11	3230284	.	G	A	6	4	10	0	0	10	0	0
11	3233455	.	T	G	3	2	5	0	0	5	0	0
11	3235516	.	G	A	6	3	9	0	0	9	0	0
11	3235543	.	C	T	6	4	10	0	1	11	0	0
11	3235558	.	G	A	0	4	4	0	6	10	0	0
11	3237023	.	T	C	8	7	15	0	2	17	0	0
11	3238720	.	T	C	9	8	17	0	1	18	0	0
11	3243316	.	T	C	6	7	13	0	0	13	0	0
11	3246120	.	A	G	6	7	13	0	0	13	0	0
11	3249158	.	A	G	4	0	4	0	10	14	0	0
11	3249253	.	C	T	4	6	10	0	1	11	0	0
11	3249268	.	T	C	3	8	11	0	1	12	0	0
11	3249334	.	T	C	6	8	14	0	0	14	0	0
11	3249346	.	C	T	5	9	14	0	1	15	0	0
11	3249370	.	A	G	5	0	5	0	6	11	0	0
11	3312137	.	T	C	15	12	27	2	0	29	0	0
11	3317226	.	T	C	11	16	27	0	1	28	0	0
11	3317229	.	G	T	11	19	30	0	0	30	0	0
11	3323411	.	A	G	5	7	12	0	0	12	0	0
11	3323414	.	G	A	5	4	9	0	1	10	0	0
11	3337038	.	A	G	35	30	65	0	5	70	0	0
11	3337253	.	A	G	36	30	66	0	1	67	0	0
11	3337256	.	T	C	38	0	38	0	31	69	0	0
11	3337698	.	T	A	28	20	48	0	2	50	0	0
11	3337718	.	G	C	28	21	49	0	0	49	0	0
11	3338060	.	C	G	27	20	47	0	2	49	0	0
11	3338144	.	T	C	36	25	61	0	3	64	0	0
11	3338236	.	T	C	35	1	36	0	24	60	0	0
11	3338288	.	T	A	36	24	60	1	1	62	0	0
11	3338299	.	T	G	34	23	57	1	2	60	0	0
11	3338431	.	C	T	3	29	32	0	31	63	0	0
11	3338491	.	G	A	29	27	56	0	2	58	0	0
11	3338514	.	C	A	32	30	62	0	3	65	0	0
11	3338624	.	G	A	34	22	56	0	4	60	0	0
11	3338638	.	A	G	39	25	64	0	1	65	0	0
11	3338708	.	A	G	35	28	63	0	0	63	0	0
11	3338813	.	T	C	45	1	46	0	19	65	0	0
11	3338933	.	A	G	25	29	54	0	2	56	0	0
11	3339107	.	C	T	3	28	31	0	26	57	0	0
11	3339425	.	G	A	34	38	72	0	1	73	0	0
11	3340306	.	G	A	35	17	52	1	1	54	0	0
11	3341350	.	C	G	3	21	24	0	38	62	0	0
11	3345676	.	A	G	3	2	5	0	0	5	0	0
11	3345716	.	T	C	7	3	10	0	0	10	0	0
11	3345900	.	G	A	3	3	6	0	0	6	0	0
11	3345952	.	T	C	2	5	7	0	1	8	0	0
11	3345991	.	G	C	2	3	5	0	0	5	0	0
11	3345993	.	T	A	2	3	5	0	0	5	0	0
11	3346066	.	C	A	6	4	10	0	0	10	0	0
11	3346076	.	G	C	7	5	12	0	0	12	0	0
11	3346128	.	T	G	3	6	9	0	0	9	0	0
11	3346797	.	T	C	2	0	2	0	2	4	0	0
11	3346847	.	G	A	7	3	10	0	0	10	0	0
11	3347108	.	A	G	4	3	7	0	0	7	0	0
11	3347717	.	T	C	4	0	4	0	2	6	0	0
11	3347727	.	T	C	3	0	3	0	2	5	0	0
11	3348004	.	T	G	2	2	4	0	0	4	0	0
11	3348185	.	A	G	1	3	4	0	0	4	0	0
11	3367924	.	G	C	13	12	25	0	1	26	0	0
11	3369891	.	A	G	7	7	14	0	1	15	0	0
11	3371938	.	T	G	1	2	3	0	0	3	0	0
11	3373418	.	A	G	11	14	25	0	0	25	0	0
11	3377127	.	T	C	6	0	6	0	6	12	0	0
11	3379999	.	G	T	5	14	19	0	1	20	0	0
11	3380012	.	C	G	5	15	20	0	0	20	0	0
11	3380135	.	A	G	5	7	12	0	0	12	0	0
11	3381243	.	T	A	4	13	17	0	0	17	0	0
11	3381261	.	C	A	3	13	16	0	0	16	0	0
11	3381290	.	A	G	2	8	10	0	0	10	0	0
11	3395069	.	G	A	19	13	32	0	2	34	0	0
11	3395070	.	A	T	19	13	32	0	2	34	0	0
11	3395303	.	G	A	14	17	31	0	1	32	0	0
11	3395324	.	C	T	13	22	35	0	0	35	0	0
11	3395501	.	A	G	18	18	36	0	0	36	0	0
11	3395693	.	A	T	17	15	32	0	1	33	0	0
11	3395699	.	G	A	17	15	32	0	1	33	0	0
11	3398738	.	A	C	9	1	10	0	21	31	0	0
11	3401899	.	C	A	15	8	23	0	0	23	0	0
11	3422086	.	T	C	10	4	14	0	0	14	0	0
11	3425136	.	G	A	7	6	13	0	1	14	0	0
11	3425175	.	G	A	12	12	24	0	0	24	0	0
11	3494930	.	T	A	7	15	22	0	1	23	0	0
11	3499160	.	A	G	1	0	1	0	2	3	0	0
11	3499197	.	G	A	1	3	4	0	0	4	0	0
11	3499204	.	G	T	1	4	5	0	0	5	0	0
11	3520631	.	A	G	5	4	9	0	0	9	0	0
11	3520670	.	T	C	2	3	5	0	0	5	0	0
11	3520694	.	C	A	0	2	2	0	2	4	0	0
11	3520753	.	A	T	2	2	4	0	0	4	0	0
11	3523493	.	G	A	10	7	17	0	1	18	0	0
11	3523976	.	A	C	7	1	8	0	12	20	0	0
11	3524111	.	G	A	9	14	23	0	0	23	0	0
11	3524196	.	A	G	13	15	28	0	0	28	0	0
11	3524236	.	C	T	15	11	26	0	0	26	0	0
11	3524541	.	A	T	13	10	23	0	0	23	0	0
11	3524591	.	G	A	9	7	16	0	0	16	0	0
11	3524715	.	A	C	9	3	12	1	0	13	0	0
11	3526443	.	T	C	9	11	20	0	0	20	0	0
11	3526458	.	A	G	9	7	16	0	1	17	0	0
11	3526605	.	C	G	22	12	34	0	1	35	0	0
11	3528320	.	A	T	19	13	32	0	1	33	0	0
11	3530443	.	G	T	7	12	19	0	1	20	0	0
11	3530991	.	T	C	13	0	13	0	13	26	0	0
11	3532836	.	A	G	6	7	13	0	0	13	0	0
11	3535397	.	A	G	4	12	16	0	0	16	0	0
11	3551074	.	T	C	21	28	49	0	0	49	0	0
11	3551309	.	A	G	28	27	55	0	2	57	0	0
11	3551944	.	G	A	29	28	57	0	0	57	0	0
11	3551986	.	C	T	2	17	19	0	21	40	0	0
11	3593490	.	A	C	3	10	13	0	0	13	0	0
11	3593693	.	T	C	2	9	11	5	0	16	0	0
11	3593708	.	T	C	8	8	16	5	0	21	0	0
11	3593748	.	A	G	8	9	17	0	3	20	0	0
11	3593794	.	T	C	10	3	13	0	2	15	0	0
11	3594062	.	T	C	8	10	18	0	1	19	0	0
11	3594070	.	T	C	8	11	19	0	1	20	0	0
11	3594147	.	A	T	8	7	15	0	0	15	0	0
11	3594277	.	T	G	11	9	20	0	3	23	0	0
11	3594321	.	T	C	11	1	12	0	10	22	0	0
11	3594327	.	T	A	12	11	23	0	0	23	0	0
11	3594366	.	A	G	7	13	20	0	2	22	0	0
11	3594452	.	T	G	4	2	6	0	8	15	1	0
11	3594541	.	A	T	10	6	16	0	2	19	1	0
11	3594573	.	A	T	6	6	12	0	0	12	0	0
11	3594618	.	G	A	4	7	11	0	0	11	0	0
11	3594649	.	T	G	3	12	15	0	0	15	0	0
11	3595140	.	A	C	5	0	5	0	4	9	0	0
11	3595308	.	G	A	5	8	13	0	0	13	0	0
11	3595579	.	A	G	11	11	22	0	0	22	0	0
11	3600246	.	C	A	7	7	14	0	0	14	0	0
11	3602382	.	T	C	10	10	20	0	1	21	0	0
11	3603392	.	A	G	5	7	12	0	0	12	0	0
11	3603434	.	T	C	3	6	9	0	0	9	0	0
11	3606914	.	T	C	9	0	9	0	5	14	0	0
11	3609448	.	A	T	6	4	10	0	0	10	0	0
11	3609535	.	A	C	3	3	6	0	0	6	0	0
11	3634125	.	T	A	2	3	5	0	2	7	0	0
11	3634128	.	T	C	4	2	6	0	1	7	0	0
11	3635817	.	G	C	1	3	4	0	0	4	0	0
11	3848656	.	C	T	10	11	21	0	0	21	0	0
11	3858081	.	T	G	11	7	18	0	1	19	0	0
11	3858318	.	A	G	15	16	31	0	1	32	0	0
11	3860104	.	C	G	3	10	13	0	1	14	0	0
11	3860149	.	G	T	8	11	19	0	0	19	0	0
11	3860524	.	C	G	5	6	11	0	0	11	0	0
11	3893429	.	A	C	11	29	40	0	1	41	0	0
11	3893564	.	A	G	18	14	32	0	3	35	0	0
11	3893635	.	C	T	20	16	36	0	1	37	0	0
11	3893636	.	T	G	20	17	37	0	0	37	0	0
11	3893928	.	G	C	21	17	38	0	0	38	0	0
11	3893933	.	G	C	19	16	35	0	0	36	1	0
11	3894023	.	T	C	18	28	46	0	0	46	0	0
11	3898787	.	C	T	1	19	20	0	22	42	0	0
11	3899066	.	C	A	1	13	14	0	25	39	0	0
11	3901375	.	C	A	1	20	21	0	15	37	1	0
11	3901414	.	C	T	20	14	34	0	1	35	0	0
11	3901733	.	C	G	2	21	23	0	14	37	0	0
11	3904517	.	C	G	2	20	22	0	20	42	0	0
11	3904674	.	T	G	17	19	36	0	1	37	0	0
11	3905928	.	A	G	17	19	36	0	0	36	0	0
11	3910103	.	T	C	10	5	15	0	2	17	0	0
11	3910304	.	G	A	31	19	50	0	1	51	0	0
11	3910310	.	C	T	30	18	48	0	1	49	0	0
11	3913213	.	C	T	20	15	35	1	0	36	0	0
11	3917723	.	A	G	17	20	37	0	0	37	0	0
11	3922983	.	G	A	10	14	24	0	2	26	0	0
11	3925822	.	T	C	11	0	11	0	11	22	0	0
11	3925906	.	A	G	14	15	29	0	0	29	0	0
11	3925939	.	T	C	19	17	36	0	2	38	0	0
11	3927859	.	G	A	13	9	22	0	1	23	0	0
11	3928044	.	A	T	9	4	13	0	3	16	0	0
11	3928168	.	T	C	10	7	17	0	0	17	0	0
11	3934043	.	A	G	4	13	17	0	0	17	0	0
11	3934190	.	A	G	10	11	21	0	1	22	0	0
11	3934319	.	T	G	10	11	21	0	0	21	0	0
11	3936111	.	A	G	11	17	28	0	0	28	0	0
11	3936378	.	T	A	15	8	23	0	0	23	0	0
11	3941634	.	A	G	7	5	12	0	0	12	0	0
11	3941649	.	G	T	9	5	14	1	0	15	0	0
11	3941697	.	A	T	6	6	12	1	0	13	0	0
11	3951531	.	T	A	12	7	19	0	1	20	0	0
11	3954572	.	T	C	9	0	9	0	8	17	0	0
11	3959435	.	T	C	12	4	16	0	5	21	0	0
11	3962979	.	A	C	9	3	12	0	0	12	0	0
11	3963388	.	C	T	4	6	10	0	0	10	0	0
11	3963581	.	C	T	5	4	9	0	0	9	0	0
11	3963608	.	G	T	5	5	10	0	0	10	0	0
11	3963639	.	T	A	8	8	16	0	0	16	0	0
11	3964193	.	T	A	6	5	11	0	1	12	0	0
11	3965870	.	C	T	7	5	12	0	2	14	0	0
11	3965984	.	T	A	8	7	15	0	0	15	0	0
11	3967445	.	A	G	5	4	9	0	0	9	0	0
11	3968877	.	G	A	10	5	15	0	1	16	0	0
11	3968915	.	T	G	10	6	16	0	0	16	0	0
11	3968934	.	G	C	9	6	15	0	2	17	0	0
11	3971752	.	T	C	2	3	5	0	0	5	0	0
11	3971884	.	T	G	2	5	7	0	0	7	0	0
11	3971897	.	A	G	1	3	4	0	1	5	0	0
11	3971943	.	T	A	2	2	4	1	0	5	0	0
11	3972170	.	C	A	2	3	5	0	0	5	0	0
11	3972263	.	T	C	1	3	4	0	0	4	0	0
11	3972540	.	A	C	3	2	5	0	0	5	0	0
11	3972541	.	G	A	3	2	5	0	1	6	0	0
11	3975229	.	T	G	3	3	6	0	0	6	0	0
11	3989472	.	A	G	26	0	26	0	19	45	0	0
11	3993452	.	G	A	1	5	6	0	5	11	0	0
11	3994137	.	T	G	1	2	3	0	0	3	0	0
11	3994901	.	C	A	5	3	8	0	0	8	0	0
11	3995468	.	T	C	1	4	5	0	1	6	0	0
11	3995515	.	A	G	2	12	14	0	0	14	0	0
11	4003827	.	T	G	4	3	7	0	0	7	0	0
11	4006924	.	C	T	0	5	5	0	6	11	0	0
11	4006956	.	C	T	4	2	6	0	0	6	0	0
11	4010744	.	C	G	4	5	9	0	0	9	0	0
11	4010752	.	T	G	4	3	7	0	0	7	0	0
11	4010895	.	C	T	6	4	10	0	1	11	0	0
11	4011001	.	T	C	3	0	3	0	7	10	0	0
11	4026308	.	C	T	8	10	18	0	0	18	0	0
11	4053390	.	G	A	1	10	11	0	17	28	0	0
11	4113807	.	C	T	6	8	14	0	1	15	0	0
11	4131300	.	A	T	9	11	20	0	0	20	0	0
11	4131313	.	C	T	6	13	19	0	0	19	0	0
11	4131933	.	T	A	15	8	23	0	0	23	0	0
11	4131958	.	A	T	9	3	12	0	1	13	0	0
11	4132159	.	C	A	18	16	34	0	1	35	0	0
11	4132229	.	A	G	14	14	28	0	1	29	0	0
11	4132295	.	C	T	28	22	50	0	1	51	0	0
11	4132296	.	A	C	28	23	51	0	0	51	0	0
11	4132378	.	G	C	11	8	19	1	1	21	0	0
11	4132440	.	A	G	13	8	21	0	0	21	0	0
11	4209004	.	T	C	2	7	9	0	0	9	0	0
11	4219556	.	A	C	3	2	5	0	0	5	0	0
11	4954023	.	A	C	1	2	3	0	0	3	0	0
11	5598266	.	G	A	2	4	6	0	0	6	0	0
11	5598325	.	G	A	4	4	8	0	0	8	0	0
11	5600594	.	A	G	2	2	4	0	0	4	0	0
11	5600597	.	C	A	2	1	3	0	0	3	0	0
11	5613915	.	C	T	1	2	3	0	0	3	0	0
11	5616894	.	T	G	3	2	5	0	0	5	0	0
11	5622008	.	C	A	1	2	3	0	0	3	0	0
11	5622146	.	T	C	2	2	4	0	0	4	0	0
11	5624635	.	T	C	2	3	5	0	0	5	0	0
11	5624942	.	A	T	2	4	6	0	0	6	0	0
11	5635318	.	A	C	3	3	6	0	1	7	0	0
11	5640605	.	A	T	5	3	8	0	0	8	0	0
11	5646331	.	C	T	5	3	8	0	0	8	0	0
11	5648343	.	A	C	2	4	6	0	0	6	0	0
11	5648358	.	G	A	0	4	4	0	2	6	0	0
11	5648643	.	C	T	5	4	9	0	0	9	0	0
11	5658587	.	T	A	9	8	17	0	0	17	0	0
11	5658751	.	A	G	3	4	7	0	0	7	0	0
11	5658889	.	A	G	2	2	4	0	0	4	0	0
11	5658941	.	A	G	3	4	7	0	0	7	0	0
11	5659054	.	C	G	4	3	7	0	0	7	0	0
11	5659097	.	G	A	4	6	10	0	0	10	0	0
11	5659177	.	T	A	2	2	4	0	0	4	0	0
11	5659300	.	C	A	2	4	6	0	0	6	0	0
11	5666471	.	A	G	8	8	16	0	0	16	0	0
11	5669671	.	T	C	12	8	20	0	1	21	0	0
11	5669722	.	G	A	0	4	4	0	13	17	0	0
11	5669907	.	G	A	1	12	13	0	7	20	0	0
11	5669917	.	A	T	8	12	20	0	0	20	0	0
11	5669950	.	T	C	9	10	19	0	0	19	0	0
11	5674134	.	G	A	7	8	15	0	0	15	0	0
11	5674150	.	A	G	7	7	14	0	1	15	0	0
11	5674731	.	T	G	8	0	8	0	15	23	0	0
11	5817345	.	T	C	10	12	22	0	2	24	0	0
11	5817397	.	A	T	11	11	22	0	2	24	0	0
11	5817472	.	C	A	17	4	21	0	5	26	0	0
11	5821096	.	C	G	15	12	27	0	0	27	0	0
11	5825477	.	T	C	5	12	17	0	2	19	0	0
11	5836012	.	G	A	7	7	14	0	0	14	0	0
11	5836049	.	A	C	10	5	15	0	0	15	0	0
11	5843388	.	T	C	27	28	55	0	3	58	0	0
11	5844303	.	T	A	26	33	59	0	2	61	0	0
11	5844333	.	T	C	30	24	54	0	1	55	0	0
11	5844525	.	G	A	27	30	57	0	2	59	0	0
11	5844579	.	G	A	3	25	28	0	28	56	0	0
11	5847511	.	G	A	34	23	57	0	4	61	0	0
11	5852424	.	G	T	6	19	25	2	25	52	0	0
11	5865356	.	A	C	1	0	1	0	4	5	0	0
11	5865491	.	C	T	2	4	6	0	0	6	0	0
11	5923335	.	C	A	14	19	33	0	0	33	0	0
11	5923515	.	G	A	0	5	5	0	4	9	0	0
11	5934455	.	G	A	1	3	4	0	0	4	0	0
11	5936354	.	G	A	1	2	3	0	0	3	0	0
11	5945410	.	A	T	1	1	2	0	0	2	0	0
11	5945836	.	A	T	6	7	13	0	0	13	0	0
11	5945840	.	G	A	6	7	13	0	1	14	0	0
11	5945919	.	T	A	6	10	16	0	0	16	0	0
11	5946023	.	T	A	13	15	28	0	0	28	0	0
11	5946564	.	T	C	20	11	31	0	0	31	0	0
11	5946854	.	G	C	18	12	30	0	6	36	0	0
11	5947191	.	T	G	13	16	29	0	1	30	0	0
11	5953436	.	G	T	16	12	28	0	0	28	0	0
11	5953521	.	T	C	8	0	8	0	12	20	0	0
11	5953547	.	C	T	0	9	9	0	14	23	0	0
11	5965186	.	C	G	3	3	6	0	0	6	0	0
11	5965189	.	C	G	0	2	2	0	4	6	0	0
11	5965302	.	T	C	1	3	4	0	1	5	0	0
11	5966209	.	G	A	1	6	7	0	0	7	0	0
11	5966215	.	G	A	2	5	7	0	0	7	0	0
11	5966265	.	C	A	0	4	4	0	3	7	0	0
11	5966340	.	C	T	2	5	7	0	0	7	0	0
11	5967285	.	T	G	2	5	7	0	0	7	0	0
11	5991089	.	G	A	3	4	7	0	1	8	0	0
11	6034351	.	C	A	2	5	7	0	0	7	0	0
11	6051362	.	C	G	2	3	5	0	0	5	0	0
11	6051431	.	G	A	6	4	10	0	2	13	1	0
11	6051632	.	G	A	6	7	13	0	1	14	0	0
11	6051648	.	C	T	0	7	7	0	8	15	0	0
11	6051679	.	C	T	7	12	19	0	0	19	0	0
11	6051880	.	A	C	8	1	9	0	5	14	0	0
11	6057335	.	G	A	6	7	13	1	0	14	0	0
11	6062107	.	T	A	6	6	12	0	1	13	0	0
11	6064265	.	C	T	4	5	9	0	1	10	0	0
11	6072462	.	C	T	2	3	5	0	0	5	0	0
11	6072463	.	G	A	0	3	3	0	2	5	0	0
11	6074259	.	A	C	3	2	5	0	0	5	0	0
11	6074265	.	C	T	4	2	6	0	0	6	0	0
11	6080584	.	G	C	1	2	3	0	0	3	0	0
11	6115760	.	A	C	3	2	5	0	0	5	0	0
11	6124566	.	A	G	1	0	1	0	2	3	0	0
11	6124807	.	C	T	1	3	4	0	0	4	0	0
11	6132828	.	G	A	1	4	5	0	1	6	0	0
11	6133477	.	T	A	2	2	4	0	0	4	0	0
11	6139323	.	A	G	3	3	6	0	0	6	0	0
11	6144776	.	T	C	5	5	10	0	0	10	0	0
11	6144800	.	G	A	5	4	9	0	0	9	0	0
11	6159704	.	A	G	3	2	5	0	0	5	0	0
11	6159741	.	A	T	1	3	4	0	0	4	0	0
11	6159782	.	T	C	1	3	4	0	0	4	0	0
11	6163516	.	T	C	2	3	5	0	2	7	0	0
11	6163570	.	C	T	4	6	10	0	0	10	0	0
11	6167971	.	C	T	2	4	6	0	1	7	0	0
11	6167981	.	C	T	2	4	6	0	0	6	0	0
11	6168007	.	C	T	1	3	4	0	0	4	0	0
11	6168047	.	C	T	3	3	6	0	0	6	0	0
11	6168071	.	T	C	2	5	7	0	0	7	0	0
11	6170596	.	C	A	5	5	10	0	0	10	0	0
11	6170662	.	T	C	4	8	12	0	0	12	0	0
11	6172327	.	G	A	5	9	14	0	0	14	0	0
11	6172366	.	T	G	3	10	13	0	0	13	0	0
11	6183030	.	T	C	13	16	29	0	1	30	0	0
11	6187412	.	C	G	1	9	10	0	14	24	0	0
11	6197495	.	C	T	0	10	10	0	2	12	0	0
11	6198215	.	T	A	2	5	7	0	0	7	0	0
11	6289556	.	T	C	1	2	3	0	0	3	0	0
11	6290039	.	C	T	1	2	3	0	0	3	0	0
11	6290147	.	C	T	4	2	6	0	0	6	0	0
11	6300374	.	T	C	6	5	11	0	1	12	0	0
11	6303371	.	T	A	7	2	9	0	1	10	0	0
11	6307055	.	A	G	1	0	1	0	7	8	0	0
11	6307059	.	A	T	1	5	6	0	1	7	0	0
11	6309916	.	T	A	5	3	8	0	0	8	0	0
11	6309918	.	G	A	5	3	8	0	0	8	0	0
11	6310732	.	G	A	1	3	4	0	1	5	0	0
11	6428893	.	G	T	16	10	26	0	1	27	0	0
11	6443561	.	A	G	5	0	5	0	7	12	0	0
11	6443580	.	A	G	2	8	10	0	0	10	0	0
11	6443604	.	A	G	4	4	8	0	2	10	0	0
11	6446730	.	G	A	1	2	3	0	0	3	0	0
11	6456177	.	C	T	10	6	16	0	1	17	0	0
11	6456447	.	C	T	1	5	6	0	0	6	0	0
11	6456677	.	T	C	26	22	48	0	3	51	0	0
11	6456829	.	C	T	28	20	48	0	2	50	0	0
11	6456889	.	C	T	1	2	3	0	0	3	0	0
11	6456891	.	T	A	1	2	3	0	0	3	0	0
11	6457442	.	G	A	13	9	22	0	7	29	0	0
11	6457473	.	C	A	10	9	19	0	1	20	0	0
11	6457500	.	A	T	14	6	20	0	0	20	0	0
11	6457518	.	T	C	10	7	17	0	0	17	0	0
11	6457594	.	C	A	3	4	7	0	2	9	0	0
11	6457619	.	T	C	5	3	8	0	1	9	0	0
11	6460765	.	A	T	1	3	4	0	0	4	0	0
11	6944235	.	A	G	13	3	16	0	2	18	0	0
11	6977626	.	T	C	3	2	5	0	0	5	0	0
11	6977811	.	A	G	3	2	5	0	0	5	0	0
11	6985237	.	A	G	4	4	8	0	1	9	0	0
11	6986967	.	C	T	1	3	4	0	0	4	0	0
11	6987168	.	A	G	2	3	5	0	0	5	0	0
11	7981956	.	T	C	16	4	20	0	0	20	0	0
11	9948208	.	T	C	5	2	7	0	1	8	0	0
11	10670439	.	T	C	29	21	50	1	5	56	0	0
11	12720049	.	T	A	15	21	36	0	3	39	0	0
11	12727225	.	A	G	23	20	43	0	2	45	0	0
11	12727446	.	C	T	21	24	45	0	2	47	0	0
11	12727685	.	T	C	14	18	32	0	1	33	0	0
11	12727708	.	C	A	13	15	28	0	0	28	0	0
11	12727829	.	T	A	10	4	14	1	0	15	0	0
11	12727990	.	T	A	5	17	22	0	1	23	0	0
11	12727999	.	C	T	6	12	18	0	2	20	0	0
11	12728195	.	T	G	10	12	22	0	0	22	0	0
11	12728249	.	C	T	7	6	13	0	1	14	0	0
11	12732521	.	T	C	3	0	3	0	5	8	0	0
11	12732569	.	C	T	4	4	8	0	0	8	0	0
11	12732573	.	T	G	1	5	6	0	0	6	0	0
11	12732696	.	T	A	1	3	4	0	0	4	0	0
11	12732699	.	A	T	1	3	4	0	0	4	0	0
11	12733104	.	G	A	3	4	7	0	0	7	0	0
11	12733235	.	T	C	1	0	1	0	5	6	0	0
11	12733264	.	T	C	1	3	4	0	0	4	0	0
11	12733362	.	A	G	1	2	3	0	0	3	0	0
11	12733815	.	C	T	5	2	7	0	0	7	0	0
11	12733892	.	T	G	1	4	5	0	0	5	0	0
11	12734007	.	C	T	5	2	7	0	0	7	0	0
11	12734223	.	G	A	4	4	8	0	0	8	0	0
11	12743172	.	T	C	3	3	6	0	0	6	0	0
11	12743801	.	T	G	2	4	6	0	0	6	0	0
11	12743983	.	C	T	2	4	6	0	0	6	0	0
11	12744740	.	T	C	5	14	19	0	1	20	0	0
11	12751500	.	G	A	11	12	23	0	0	23	0	0
11	12751831	.	T	C	9	9	18	0	3	21	0	0
11	12752161	.	A	T	3	2	5	0	1	6	0	0
11	12767964	.	A	G	10	0	10	0	6	16	0	0
11	12767982	.	T	C	7	5	12	0	1	13	0	0
11	12768214	.	G	A	1	18	19	0	8	27	0	0
11	12768221	.	C	T	10	14	24	0	1	25	0	0
11	12768351	.	A	G	10	8	18	0	2	20	0	0
11	12768394	.	A	C	6	4	10	0	2	12	0	0
11	12783139	.	T	A	11	6	17	0	0	17	0	0
11	12792707	.	C	T	2	3	5	0	0	5	0	0
11	12792803	.	C	T	4	5	9	0	0	9	0	0
11	12795711	.	T	C	2	5	7	0	2	9	0	0
11	12800822	.	G	A	5	4	9	0	0	9	0	0
11	12800823	.	C	G	5	4	9	0	0	9	0	0
11	12800927	.	A	C	4	3	7	0	1	8	0	0
11	12839413	.	T	C	3	4	7	0	0	7	0	0
11	12845688	.	A	G	2	0	2	0	4	6	0	0
11	12860525	.	T	C	8	12	20	0	1	21	0	0
11	12860552	.	G	A	0	12	12	0	10	22	0	0
11	12860924	.	A	G	3	2	5	0	0	5	0	0
11	12860931	.	C	G	3	2	5	0	0	5	0	0
11	12861196	.	A	G	7	6	13	0	0	13	0	0
11	12864070	.	C	T	8	10	18	0	1	19	0	0
11	12864361	.	A	G	5	0	5	0	9	14	0	0
11	12869192	.	G	T	1	6	7	0	9	16	0	0
11	12869309	.	T	C	4	10	14	0	0	14	0	0
11	12869409	.	C	A	3	6	9	0	0	9	0	0
11	12869414	.	C	T	3	5	8	0	1	9	0	0
11	13033241	.	C	T	1	2	3	0	0	3	0	0
11	13055470	.	G	A	26	24	50	0	3	53	0	0
11	13055694	.	C	A	10	10	20	0	2	22	0	0
11	13062000	.	T	C	7	3	10	0	1	11	0	0
11	13071920	.	A	G	13	7	20	0	1	21	0	0
11	13079183	.	C	A	12	7	19	0	0	19	0	0
11	13088062	.	G	T	2	11	13	0	5	18	0	0
11	13094199	.	C	T	9	8	17	0	0	17	0	0
11	13094203	.	C	T	7	8	15	0	1	16	0	0
11	13094368	.	T	A	9	13	22	0	1	23	0	0
11	13094473	.	A	T	16	21	37	0	1	38	0	0
11	13094581	.	C	T	3	26	29	0	17	46	0	0
11	13094668	.	C	A	18	18	36	0	3	39	0	0
11	13094678	.	T	C	12	16	28	0	7	35	0	0
11	13094778	.	T	C	23	19	42	0	0	42	0	0
11	13095049	.	G	A	21	18	39	0	3	42	0	0
11	13176674	.	C	A	2	3	5	0	0	5	0	0
11	13181238	.	T	C	6	6	12	0	0	12	0	0
11	13181415	.	G	A	6	3	9	0	0	9	0	0
11	13182850	.	C	T	3	3	6	0	0	6	0	0
11	13185928	.	C	T	4	4	8	0	1	9	0	0
11	13185931	.	G	T	4	4	8	0	0	9	1	0
11	13188425	.	G	C	4	6	10	0	2	12	0	0
11	13188527	.	A	G	4	0	4	0	4	8	0	0
11	13189062	.	A	G	2	1	3	0	2	5	0	0
11	13189461	.	A	G	4	2	6	0	0	6	0	0
11	13189469	.	A	G	6	4	10	0	1	11	0	0
11	13189592	.	G	A	1	4	5	0	0	5	0	0
11	13208755	.	T	A	49	26	75	0	1	76	0	0
11	13209037	.	T	G	35	36	71	0	3	74	0	0
11	13209391	.	C	T	55	28	83	0	0	83	0	0
11	13210604	.	G	A	39	33	72	0	2	74	0	0
11	13210650	.	A	C	30	38	68	0	5	73	0	0
11	13210897	.	A	T	42	34	76	0	1	77	0	0
11	13212234	.	T	C	45	34	79	0	3	82	0	0
11	13212306	.	C	T	34	32	66	0	4	70	0	0
11	13212333	.	T	C	29	34	63	0	2	65	0	0
11	13212357	.	T	C	24	43	67	0	1	68	0	0
11	13212567	.	T	C	31	37	68	0	4	72	0	0
11	13212908	.	T	A	24	26	50	0	2	52	0	0
11	13280565	.	T	C	21	2	23	0	5	28	0	0
11	13281122	.	T	C	14	12	26	0	0	26	0	0
11	13281158	.	A	T	8	7	15	0	1	16	0	0
11	13281238	.	A	G	7	5	12	0	0	12	0	0
11	13281243	.	C	A	7	4	11	0	0	11	0	0
11	13281331	.	A	T	14	6	20	0	1	21	0	0
11	13281594	.	T	C	21	11	32	0	0	32	0	0
11	13281734	.	G	A	14	11	25	0	2	27	0	0
11	13281794	.	G	T	11	7	18	0	2	20	0	0
11	13281864	.	C	T	3	2	5	0	0	5	0	0
11	13282201	.	G	T	10	8	18	0	0	18	0	0
11	13282439	.	C	A	2	2	4	0	0	4	0	0
11	13282443	.	G	A	2	2	4	0	0	4	0	0
11	13283335	.	A	G	13	14	27	0	2	29	0	0
11	13283368	.	C	A	6	11	17	0	3	20	0	0
11	13283403	.	T	G	6	15	21	0	0	21	0	0
11	13283447	.	G	A	16	9	25	0	1	26	0	0
11	13283476	.	C	T	20	5	25	0	0	25	0	0
11	13283569	.	G	A	11	6	17	0	0	17	0	0
11	13283634	.	C	T	7	5	12	0	0	12	0	0
11	13283713	.	G	A	13	11	24	0	0	24	0	0
11	13292084	.	A	G	8	8	16	0	3	19	0	0
11	13292105	.	C	T	0	7	7	0	12	19	0	0
11	13292462	.	C	T	16	22	38	0	2	40	0	0
11	13292576	.	C	T	1	20	21	0	13	34	0	0
11	13305874	.	T	C	7	5	12	0	0	12	0	0
11	13306186	.	C	T	8	13	21	0	0	21	0	0
11	13313163	.	G	A	6	10	16	0	0	16	0	0
11	13313208	.	C	T	4	12	16	0	1	17	0	0
11	13313363	.	G	A	8	6	14	0	0	14	0	0
11	13313524	.	G	A	7	4	11	0	1	12	0	0
11	13341110	.	A	G	2	3	5	0	0	5	0	0
11	13341112	.	T	A	2	3	5	0	0	5	0	0
11	13341342	.	G	A	3	4	7	0	0	7	0	0
11	13341346	.	A	C	3	3	6	0	0	6	0	0
11	13424244	.	G	A	5	2	7	0	0	7	0	0
11	13424515	.	A	G	2	2	4	0	0	4	0	0
11	13424543	.	G	A	1	3	4	0	0	4	0	0
11	13445981	.	T	C	3	5	8	0	0	8	0	0
11	13480221	.	G	A	4	4	8	0	0	8	0	0
11	13480257	.	A	T	3	5	8	0	0	8	0	0
11	13485098	.	G	A	3	5	8	0	0	8	0	0
11	13485140	.	A	G	6	0	6	0	5	11	0	0
11	13494666	.	T	A	6	5	11	0	0	11	0	0
11	13503124	.	T	G	2	0	2	0	7	9	0	0
11	13503351	.	A	G	4	4	8	0	0	8	0	0
11	13503765	.	G	T	4	3	7	0	0	7	0	0
11	13504343	.	A	C	4	3	7	0	0	7	0	0
11	13504403	.	C	T	4	2	6	0	1	7	0	0
11	13505186	.	C	A	7	4	11	0	0	11	0	0
11	13505401	.	A	G	1	0	1	0	2	3	0	0
11	13528735	.	G	A	0	3	3	0	1	4	0	0
11	13529810	.	T	C	3	5	8	0	1	9	0	0
11	13532024	.	G	T	5	5	10	0	0	10	0	0
11	13532034	.	G	A	0	4	4	0	6	10	0	0
11	13532070	.	T	G	5	0	5	0	3	8	0	0
11	13532071	.	T	C	5	3	8	0	0	8	0	0
11	13532567	.	T	C	8	7	15	0	0	15	0	0
11	13532763	.	C	T	5	5	10	0	0	10	0	0
11	13532922	.	C	T	3	6	9	0	0	9	0	0
11	13533094	.	T	G	3	7	10	0	0	10	0	0
11	13533124	.	G	A	3	12	15	0	1	16	0	0
11	13533214	.	A	G	4	0	4	0	6	10	0	0
11	13533388	.	T	A	2	9	11	0	0	11	0	0
11	13533429	.	G	T	3	11	14	0	0	14	0	0
11	13636198	.	C	T	4	4	8	0	0	8	0	0
11	13636239	.	T	C	1	2	3	0	0	3	0	0
11	13639185	.	C	G	5	2	7	0	0	7	0	0
11	13697910	.	T	C	6	3	9	0	0	9	0	0
11	13789149	.	T	A	3	3	6	0	0	6	0	0
11	13789162	.	C	T	4	3	7	0	0	7	0	0
11	14017627	.	C	A	1	2	3	0	0	3	0	0
11	14062357	.	C	T	3	2	5	0	0	5	0	0
11	14062368	.	C	T	1	3	4	0	0	4	0	0
11	14062453	.	C	G	5	4	9	0	0	9	0	0
11	14062662	.	A	G	6	3	9	0	0	9	0	0
11	14062667	.	A	G	6	3	9	0	0	9	0	0
11	14073049	.	T	A	2	4	6	0	0	6	0	0
11	14073444	.	C	T	9	8	17	0	1	18	0	0
11	14073503	.	G	A	6	10	16	0	0	16	0	0
11	14073560	.	T	A	6	11	17	0	0	17	0	0
11	14073730	.	G	T	5	12	17	0	3	20	0	0
11	14073857	.	C	A	9	7	16	0	0	16	0	0
11	14073858	.	A	T	8	7	15	0	0	15	0	0
11	14074125	.	T	C	7	7	14	0	0	14	0	0
11	14074245	.	T	C	8	5	13	0	0	13	0	0
11	14074584	.	T	G	6	3	9	0	0	9	0	0
11	14074628	.	T	A	3	4	7	0	0	7	0	0
11	14074649	.	A	G	2	3	5	0	0	5	0	0
11	14074951	.	C	T	4	5	9	0	0	9	0	0
11	14074952	.	A	T	4	5	9	0	0	9	0	0
11	14075147	.	G	A	4	7	11	0	0	11	0	0
11	14075302	.	A	G	7	10	17	0	2	19	0	0
11	14101295	.	C	A	0	5	5	0	7	12	0	0
11	14101497	.	A	T	15	4	19	0	1	20	0	0
11	14101521	.	A	T	12	4	16	0	0	16	0	0
11	14101597	.	G	A	6	4	10	0	0	10	0	0
11	14101859	.	A	C	2	0	2	0	7	9	0	0
11	14104681	.	T	A	1	3	4	0	0	4	0	0
11	14104721	.	T	C	1	3	4	0	0	4	0	0
11	14112469	.	T	C	4	3	7	0	0	7	0	0
11	14119489	.	C	T	2	5	7	0	0	7	0	0
11	14119690	.	C	G	2	3	5	0	1	6	0	0
11	14132176	.	C	G	7	1	8	0	2	10	0	0
11	14137563	.	C	T	5	5	10	1	1	12	0	0
11	14137901	.	C	A	4	4	8	0	0	8	0	0
11	14137988	.	C	T	11	10	21	0	0	21	0	0
11	14138006	.	T	G	9	8	17	0	0	17	0	0
11	14143452	.	C	A	8	4	12	0	1	13	0	0
11	14143499	.	G	A	1	2	3	0	3	6	0	0
11	14199913	.	G	C	0	19	19	0	12	31	0	0
11	14266826	.	G	T	1	6	7	0	14	21	0	0
11	14267075	.	T	C	11	15	26	0	2	28	0	0
11	14267076	.	G	A	12	16	28	0	0	28	0	0
11	14267239	.	C	G	6	6	12	0	1	13	0	0
11	14290616	.	C	A	2	2	4	0	0	4	0	0
11	14318207	.	T	A	2	6	8	0	0	8	0	0
11	14332997	.	A	G	1	0	1	0	2	3	0	0
11	14333489	.	T	C	2	2	4	0	0	4	0	0
11	14338397	.	C	G	6	2	8	0	1	9	0	0
11	14338454	.	C	G	7	4	11	0	0	11	0	0
11	14338460	.	G	A	3	7	10	0	0	10	0	0
11	14340971	.	T	A	1	2	3	0	0	3	0	0
11	14341498	.	T	A	2	4	6	0	0	6	0	0
11	14341510	.	A	C	2	4	6	0	0	6	0	0
11	14341610	.	C	A	4	3	7	0	0	7	0	0
11	14341669	.	C	A	5	2	7	0	1	8	0	0
11	14342379	.	A	C	2	2	4	0	0	4	0	0
11	14343567	.	A	C	7	5	12	0	0	12	0	0
11	14343612	.	T	G	2	4	6	0	0	6	0	0
11	14344976	.	G	T	3	8	11	0	1	12	0	0
11	14344989	.	G	A	1	8	9	0	1	10	0	0
11	14345062	.	T	A	3	2	5	0	0	5	0	0
11	14345064	.	C	T	3	2	5	0	0	5	0	0
11	14345156	.	C	A	2	3	5	0	0	5	0	0
11	14345215	.	A	G	2	1	3	0	1	4	0	0
11	14345221	.	T	G	1	2	3	0	1	4	0	0
11	14345562	.	T	G	1	4	5	0	0	5	0	0
11	14345638	.	C	T	2	2	4	0	0	4	0	0
11	14345753	.	A	G	5	7	12	0	1	13	0	0
11	14345830	.	T	C	3	5	8	0	0	8	0	0
11	14345884	.	T	G	1	5	6	0	1	7	0	0
11	14345922	.	T	G	1	2	3	0	0	3	0	0
11	14639030	.	T	C	8	7	15	0	1	16	0	0
11	14639392	.	A	C	3	3	6	0	0	6	0	0
11	14640002	.	G	T	0	1	1	0	8	9	0	0
11	14676541	.	A	G	5	0	5	0	4	9	0	0
11	14749156	.	G	A	11	7	18	0	2	20	0	0
11	14751068	.	T	C	5	8	13	0	0	13	0	0
11	14955592	.	A	G	9	7	16	0	0	16	0	0
11	14956525	.	A	G	8	1	9	0	3	12	0	0
11	15250544	.	T	C	14	15	29	0	2	31	0	0
11	15281992	.	G	A	4	9	13	0	1	14	0	0
11	15586792	.	T	G	2	2	4	0	0	4	0	0
11	15833846	.	T	C	4	3	7	0	0	7	0	0
11	15834110	.	T	G	3	5	8	0	0	8	0	0
11	15834265	.	T	C	4	3	7	0	1	8	0	0
11	15834436	.	T	A	4	3	7	0	0	7	0	0
11	15850735	.	C	T	4	7	11	0	0	11	0	0
11	15874809	.	C	A	0	6	6	0	2	8	0	0
11	15874820	.	A	G	2	8	10	0	0	10	0	0
11	15874882	.	C	T	2	4	6	0	2	8	0	0
11	15875008	.	G	A	2	4	6	0	0	6	0	0
11	15878458	.	T	C	6	9	15	0	0	15	0	0
11	15887006	.	A	G	1	4	5	0	1	6	0	0
11	15888117	.	G	C	0	4	4	0	8	12	0	0
11	15894885	.	G	A	2	5	7	0	9	16	0	0
11	15910604	.	G	C	1	3	4	0	0	4	0	0
11	15972599	.	T	C	2	8	10	0	1	11	0	0
11	15972646	.	C	A	4	5	9	0	4	13	0	0
11	15975556	.	C	T	7	5	12	0	0	12	0	0
11	16005711	.	C	T	7	14	21	0	0	21	0	0
11	16005862	.	G	A	6	5	11	0	0	11	0	0
11	16005883	.	G	T	5	3	8	0	0	8	0	0
11	16006016	.	C	T	2	6	8	0	0	8	0	0
11	16006030	.	C	T	2	7	9	0	0	9	0	0
11	16006149	.	C	T	4	6	10	1	1	12	0	0
11	16006154	.	T	A	5	7	12	1	0	13	0	0
11	16006655	.	C	T	1	6	7	0	0	7	0	0
11	16006740	.	G	C	2	2	4	0	0	4	0	0
11	16007461	.	A	G	4	2	6	2	0	8	0	0
11	16010468	.	A	G	4	0	4	0	6	10	0	0
11	16010502	.	A	G	2	0	2	0	6	8	0	0
11	16010656	.	T	C	16	9	25	0	0	25	0	0
11	16010788	.	C	A	10	11	21	0	0	21	0	0
11	16010799	.	G	C	10	10	20	0	0	20	0	0
11	16010978	.	G	A	8	6	14	1	1	16	0	0
11	16010986	.	A	T	7	7	14	1	0	15	0	0
11	16011116	.	C	T	3	3	6	0	0	6	0	0
11	16011185	.	C	A	2	5	7	0	0	7	0	0
11	16011622	.	T	C	10	4	14	1	0	15	0	0
11	16011632	.	T	G	9	0	9	1	4	14	0	0
11	16011705	.	T	C	10	8	18	0	6	24	0	0
11	16011745	.	C	G	17	10	27	0	0	27	0	0
11	16011770	.	T	C	20	23	43	0	1	44	0	0
11	16011807	.	T	C	15	26	41	0	2	43	0	0
11	16011895	.	A	C	21	5	26	0	2	28	0	0
11	16012021	.	G	A	10	9	19	0	0	19	0	0
11	16012117	.	G	T	0	12	12	0	8	21	1	0
11	16012140	.	G	A	0	14	14	0	10	24	0	0
11	16012152	.	A	G	10	0	10	0	16	26	0	0
11	16012191	.	C	T	12	14	26	0	1	27	0	0
11	16012201	.	C	T	8	12	20	0	3	23	0	0
11	16012251	.	T	A	10	11	21	0	1	22	0	0
11	16012256	.	C	T	8	12	20	0	0	20	0	0
11	16012316	.	T	G	7	7	14	0	0	14	0	0
11	16012364	.	G	T	3	7	10	0	9	19	0	0
11	16012414	.	T	C	7	3	10	0	0	10	0	0
11	16012654	.	A	G	8	0	8	0	3	11	0	0
11	16012785	.	T	G	12	7	19	0	0	19	0	0
11	16012786	.	A	G	12	7	19	0	0	19	0	0
11	16012829	.	G	T	12	11	23	0	1	24	0	0
11	16013018	.	T	C	8	6	14	0	0	14	0	0
11	16013036	.	T	A	4	3	7	0	0	7	0	0
11	16099700	.	G	A	5	5	10	0	1	11	0	0
11	16104175	.	T	C	12	7	19	0	0	19	0	0
11	16115692	.	C	T	14	5	19	0	1	20	0	0
11	16143781	.	T	C	17	13	30	0	0	30	0	0
11	16143829	.	T	C	14	20	34	0	0	34	0	0
11	16152718	.	A	T	2	8	10	0	0	10	0	0
11	16153290	.	C	T	16	10	26	0	1	27	0	0
11	16158555	.	G	A	17	15	32	0	1	33	0	0
11	16159056	.	A	G	9	12	21	0	2	23	0	0
11	16159316	.	C	T	10	15	25	0	0	25	0	0
11	16159875	.	T	C	13	4	17	0	1	18	0	0
11	16159903	.	C	T	11	8	19	0	0	19	0	0
11	16160137	.	A	G	13	0	13	0	17	30	0	0
11	16165293	.	T	C	11	9	20	0	0	20	0	0
11	16165298	.	G	A	1	8	9	0	10	19	0	0
11	16165474	.	C	T	16	4	20	0	1	21	0	0
11	16165605	.	T	A	8	8	16	0	0	16	0	0
11	16165665	.	A	G	8	15	23	0	1	24	0	0
11	16165710	.	T	A	9	8	17	0	1	18	0	0
11	16165756	.	G	A	15	6	21	0	1	22	0	0
11	16166137	.	C	G	1	3	4	0	0	4	0	0
11	16169352	.	T	C	2	3	5	0	0	5	0	0
11	16169412	.	G	T	1	3	4	0	0	4	0	0
11	16180033	.	G	A	38	22	60	0	1	61	0	0
11	16184739	.	A	G	26	21	47	0	1	48	0	0
11	16184865	.	A	T	19	27	46	1	1	48	0	0
11	16237915	.	C	G	2	4	6	0	0	6	0	0
11	16238173	.	C	T	7	3	10	0	0	10	0	0
11	16341426	.	A	G	1	2	3	0	0	3	0	0
11	16585694	.	A	G	1	5	6	0	0	6	0	0
11	16585724	.	C	A	2	3	5	0	0	5	0	0
11	16586331	.	A	G	4	2	6	0	0	6	0	0
11	16586747	.	A	G	5	4	9	0	0	9	0	0
11	16587486	.	G	T	1	2	3	0	1	4	0	0
11	16587715	.	A	G	6	7	13	0	2	15	0	0
11	16738613	.	T	C	4	2	6	0	0	6	0	0
11	16738655	.	C	T	4	3	7	0	0	7	0	0
11	16739039	.	C	T	1	9	10	0	4	14	0	0
11	16849887	.	T	G	3	2	5	0	0	5	0	0
11	16849896	.	G	A	2	1	3	0	1	4	0	0
11	17511788	.	T	C	5	14	19	0	0	19	0	0
11	17511902	.	C	A	5	11	16	0	0	16	0	0
11	17511964	.	C	G	6	0	6	0	8	14	0	0
11	17512139	.	T	C	13	13	26	0	0	26	0	0
11	17512289	.	T	C	12	15	27	0	2	29	0	0
11	17512831	.	T	A	3	3	6	0	1	7	0	0
11	17513328	.	A	G	4	0	4	0	6	10	0	0
11	17513371	.	G	T	5	2	7	0	0	7	0	0
11	17513405	.	C	T	6	3	9	0	0	9	0	0
11	17513424	.	T	A	6	2	8	0	0	8	0	0
11	17513440	.	A	G	5	2	7	0	1	8	0	0
11	17513526	.	G	A	1	5	6	0	5	11	0	0
11	17513554	.	T	A	5	6	11	0	1	12	0	0
11	17597424	.	G	A	1	2	3	0	1	4	0	0
11	17713672	.	T	C	5	5	10	0	0	10	0	0
11	17726651	.	A	T	2	2	4	0	1	5	0	0
11	17757767	.	T	C	10	8	18	0	0	18	0	0
11	17757859	.	T	C	4	8	12	0	0	12	0	0
11	17758113	.	T	A	3	2	5	0	0	5	0	0
11	17763137	.	A	G	12	15	27	0	0	27	0	0
11	17763160	.	T	C	11	14	25	0	3	28	0	0
11	17763173	.	C	A	10	14	24	0	1	25	0	0
11	17763393	.	C	T	9	15	24	0	1	25	0	0
11	17765170	.	C	T	11	6	17	0	0	17	0	0
11	17765618	.	T	C	4	0	4	0	8	12	0	0
11	17769238	.	C	T	14	11	25	0	0	25	0	0
11	17769801	.	A	T	10	7	17	0	0	17	0	0
11	17770594	.	C	T	5	13	18	0	1	19	0	0
11	17770627	.	T	C	6	11	17	0	0	17	0	0
11	17771185	.	T	C	7	8	15	0	0	15	0	0
11	17771248	.	T	C	8	8	16	0	0	16	0	0
11	17771478	.	C	T	7	5	12	0	0	12	0	0
11	17774893	.	G	A	6	5	11	0	0	11	0	0
11	17774917	.	T	C	4	4	8	0	3	11	0	0
11	17774970	.	G	T	5	6	11	0	0	11	0	0
11	17778492	.	T	A	7	4	11	0	0	11	0	0
11	17778528	.	T	C	9	0	9	0	7	16	0	0
11	17778597	.	A	G	3	4	7	0	0	7	0	0
11	17778618	.	T	G	4	6	10	0	0	10	0	0
11	17778690	.	G	T	5	5	10	0	0	11	1	0
11	17778819	.	G	A	3	9	12	0	0	12	0	0
11	17778846	.	G	A	3	11	14	0	1	15	0	0
11	17778978	.	A	T	2	5	7	0	0	7	0	0
11	17779023	.	T	C	4	5	9	0	0	9	0	0
11	17779028	.	T	G	4	5	9	0	1	10	0	0
11	17779159	.	A	G	5	6	11	0	0	11	0	0
11	17779197	.	A	T	3	4	7	0	1	8	0	0
11	17779254	.	T	C	8	0	8	0	4	12	0	0
11	17779279	.	C	A	10	5	15	0	0	15	0	0
11	17779599	.	A	T	3	5	8	0	0	8	0	0
11	17779630	.	G	A	3	7	10	0	0	10	0	0
11	17779656	.	C	T	1	6	7	0	2	9	0	0
11	17782529	.	A	C	12	0	12	0	8	20	0	0
11	17782683	.	G	A	6	3	9	0	1	10	0	0
11	17782699	.	G	C	4	6	10	0	1	11	0	0
11	17782738	.	A	G	2	3	5	0	0	5	0	0
11	17782845	.	C	T	8	10	18	0	0	18	0	0
11	17782849	.	A	G	9	10	19	0	0	19	0	0
11	17785402	.	T	G	15	9	24	0	2	26	0	0
11	17785412	.	C	A	16	8	24	0	0	24	0	0
11	17785591	.	A	G	15	9	24	0	2	26	0	0
11	17789069	.	G	T	15	15	30	0	2	32	0	0
11	17789210	.	T	C	19	7	26	0	3	29	0	0
11	17789550	.	A	G	20	14	34	0	0	35	1	0
11	17792991	.	C	T	1	14	15	0	7	22	0	0
11	17793676	.	G	A	6	18	24	0	0	24	0	0
11	17796869	.	C	T	1	10	11	0	9	20	0	0
11	17797072	.	T	C	11	1	12	0	6	18	0	0
11	17797280	.	G	A	15	8	23	0	0	23	0	0
11	17984308	.	T	C	7	3	10	0	0	10	0	0
11	17984405	.	G	A	1	4	5	0	5	10	0	0
11	17984426	.	G	C	2	3	5	0	6	11	0	0
11	17987289	.	C	A	4	4	8	0	0	8	0	0
11	18223383	.	C	T	9	6	15	0	0	15	0	0
11	18238076	.	C	T	8	12	20	0	1	21	0	0
11	18244388	.	T	C	12	6	18	0	3	21	0	0
11	18271303	.	G	A	3	6	9	0	0	9	0	0
11	18277370	.	C	T	1	7	8	0	7	15	0	0
11	18277388	.	G	A	6	7	13	0	0	13	0	0
11	18283013	.	G	A	4	7	11	0	0	11	0	0
11	18283268	.	T	C	4	6	10	0	0	10	0	0
11	18283440	.	A	G	4	6	10	0	0	11	1	0
11	18283525	.	T	C	4	0	4	0	8	12	0	0
11	18287280	.	A	G	6	9	15	0	0	15	0	0
11	18287283	.	A	T	6	10	16	0	0	16	0	0
11	18287693	.	A	G	6	8	14	0	1	15	0	0
11	18287779	.	G	A	6	4	10	0	1	11	0	0
11	18287895	.	T	G	13	8	21	0	0	21	0	0
11	18287940	.	A	T	17	10	27	0	0	27	0	0
11	18288018	.	T	C	11	7	18	0	0	18	0	0
11	18288212	.	T	C	7	5	12	0	0	12	0	0
11	18289425	.	T	G	11	5	16	0	1	17	0	0
11	18290095	.	G	A	9	7	16	0	1	17	0	0
11	18291865	.	A	G	11	16	27	0	0	27	0	0
11	18291961	.	C	T	3	4	7	0	9	16	0	0
11	18292595	.	C	T	1	10	11	0	13	24	0	0
11	18292633	.	A	G	13	10	23	0	1	24	0	0
11	18292699	.	T	A	6	17	23	0	0	23	0	0
11	18293166	.	A	G	8	9	17	0	0	17	0	0
11	18294857	.	A	G	6	9	15	0	0	15	0	0
11	18295057	.	T	C	7	8	15	0	0	15	0	0
11	18297113	.	A	G	5	2	7	0	1	8	0	0
11	18299674	.	A	G	4	6	10	0	0	10	0	0
11	18304271	.	T	A	10	6	16	0	1	17	0	0
11	18305756	.	G	A	7	3	10	0	1	11	0	0
11	18305804	.	C	G	8	9	17	0	0	17	0	0
11	18309570	.	T	C	3	7	10	0	0	10	0	0
11	18315937	.	G	A	7	6	13	0	0	13	0	0
11	18315955	.	C	T	9	5	14	0	0	14	0	0
11	18345719	.	T	G	2	4	6	0	0	6	0	0
11	18346440	.	A	C	1	1	2	0	2	4	0	0
11	18346470	.	T	A	2	2	4	0	0	4	0	0
11	18346827	.	C	T	0	4	4	0	3	7	0	0
11	18347895	.	T	A	2	3	5	0	2	7	0	0
11	18396932	.	G	A	2	2	4	0	0	4	0	0
11	18397505	.	C	T	2	3	5	0	0	5	0	0
11	18398514	.	T	C	3	4	7	0	1	8	0	0
11	18398555	.	T	G	5	4	9	0	1	10	0	0
11	18398578	.	T	G	3	6	9	0	0	9	0	0
11	18398751	.	T	C	1	5	6	0	0	6	0	0
11	18398944	.	T	C	3	0	3	0	3	6	0	0
11	18399303	.	A	G	3	2	5	0	0	5	0	0
11	18399346	.	T	A	3	2	5	0	0	5	0	0
11	18404193	.	T	A	1	2	3	0	0	3	0	0
11	18404199	.	A	G	1	2	3	0	0	3	0	0
11	18535666	.	C	T	19	12	31	1	3	35	0	0
11	18535761	.	G	C	19	14	33	0	1	34	0	0
11	18536769	.	G	A	19	11	30	0	0	30	0	0
11	18536830	.	G	A	16	11	27	0	0	27	0	0
11	18536866	.	G	A	7	12	19	0	0	19	0	0
11	18537180	.	A	G	8	8	16	0	1	17	0	0
11	18537244	.	G	A	12	9	21	0	4	25	0	0
11	18537447	.	T	C	9	9	18	0	0	18	0	0
11	18537561	.	T	A	9	8	17	0	3	20	0	0
11	18537636	.	T	A	9	10	19	0	0	19	0	0
11	18538219	.	A	T	13	15	28	0	3	31	0	0
11	18538259	.	G	T	18	11	29	0	2	31	0	0
11	18538336	.	A	C	16	0	16	0	16	32	0	0
11	18538362	.	T	C	16	0	16	0	16	32	0	0
11	18542168	.	T	C	7	9	16	0	3	19	0	0
11	18542585	.	A	G	9	7	16	0	0	16	0	0
11	18543520	.	T	A	8	5	13	0	2	15	0	0
11	18543543	.	T	A	10	6	16	0	1	17	0	0
11	18543828	.	T	C	6	7	13	0	3	16	0	0
11	18543870	.	A	G	8	5	13	0	1	14	0	0
11	18546276	.	T	A	2	2	4	0	0	4	0	0
11	18546378	.	T	A	3	9	12	0	0	12	0	0
11	18547125	.	A	G	18	18	36	0	1	37	0	0
11	18551011	.	C	A	0	13	13	0	8	21	0	0
11	18551077	.	G	A	10	4	14	0	0	14	0	0
11	18551089	.	G	A	7	6	13	0	0	13	0	0
11	18551605	.	C	T	1	15	16	0	12	28	0	0
11	18552231	.	A	T	6	4	10	0	1	11	0	0
11	18568971	.	G	A	14	12	26	0	0	26	0	0
11	18572364	.	T	C	15	0	15	0	8	23	0	0
11	18572574	.	G	A	12	12	24	0	3	27	0	0
11	18572586	.	C	T	12	15	27	0	1	28	0	0
11	18572640	.	T	G	11	8	19	0	0	19	0	0
11	18572648	.	G	A	10	7	17	0	2	19	0	0
11	18572751	.	G	A	13	14	27	0	1	28	0	0
11	18575095	.	C	A	11	10	21	0	1	22	0	0
11	18575161	.	C	G	11	3	14	0	1	15	0	0
11	18575173	.	G	T	14	3	17	0	1	18	0	0
11	18575258	.	T	G	9	15	24	0	0	24	0	0
11	18575326	.	G	T	13	9	22	0	1	23	0	0
11	18577787	.	A	G	13	11	24	0	1	25	0	0
11	18579921	.	C	T	1	4	5	0	15	20	0	0
11	18580059	.	C	T	0	10	10	0	7	17	0	0
11	18580170	.	T	C	5	0	5	0	5	10	0	0
11	18580191	.	T	A	5	6	11	0	2	13	0	0
11	18580293	.	T	C	7	0	7	0	8	15	0	0
11	18586264	.	T	C	12	0	12	0	8	20	0	0
11	18586445	.	T	C	6	4	10	0	0	10	0	0
11	18587719	.	T	G	2	4	6	0	0	6	0	0
11	18587720	.	A	G	2	4	6	0	0	6	0	0
11	18592065	.	A	G	13	4	17	0	1	18	0	0
11	18665791	.	A	T	7	4	11	1	0	12	0	0
11	18677979	.	A	G	3	5	8	0	1	9	0	0
11	18678027	.	G	A	2	5	7	0	5	12	0	0
11	18678103	.	G	A	6	2	8	0	0	8	0	0
11	18678321	.	T	C	2	5	7	0	0	7	0	0
11	18678344	.	T	G	1	9	10	0	0	10	0	0
11	18680982	.	G	C	2	2	4	0	0	4	0	0
11	18681078	.	C	G	3	6	9	0	0	9	0	0
11	18681103	.	G	A	0	6	6	0	3	9	0	0
11	18681382	.	A	G	4	0	4	0	6	10	0	0
11	18681547	.	A	G	4	0	4	0	5	9	0	0
11	18681607	.	G	A	4	6	10	0	1	11	0	0
11	18682694	.	A	G	8	8	16	0	0	16	0	0
11	18682826	.	T	C	3	6	9	0	0	9	0	0
11	18697720	.	A	G	14	7	21	0	2	23	0	0
11	18697817	.	T	G	11	7	18	0	2	20	0	0
11	18697822	.	A	G	11	1	12	0	9	21	0	0
11	18698138	.	A	G	6	0	6	0	7	13	0	0
11	18698184	.	G	A	2	3	5	0	4	9	0	0
11	18698221	.	A	C	5	2	7	0	1	8	0	0
11	18698526	.	G	A	6	5	11	0	0	11	0	0
11	18698767	.	A	T	4	2	6	0	0	6	0	0
11	18699104	.	T	C	5	10	15	0	1	16	0	0
11	18704378	.	G	C	8	1	9	0	5	14	0	0
11	18704500	.	G	A	19	12	31	0	1	32	0	0
11	18704620	.	C	T	1	15	16	0	21	37	0	0
11	18705108	.	A	G	19	18	37	0	0	37	0	0
11	18784949	.	A	T	8	8	16	0	0	16	0	0
11	18785130	.	A	G	9	14	23	0	2	25	0	0
11	18785250	.	C	T	2	20	22	0	10	32	0	0
11	18785294	.	T	G	10	16	26	0	0	26	0	0
11	18785296	.	C	T	10	16	26	0	0	26	0	0
11	18785346	.	A	T	15	13	28	0	1	29	0	0
11	18785410	.	G	A	9	18	27	0	1	28	0	0
11	18785421	.	A	G	9	12	21	0	1	22	0	0
11	18785570	.	T	A	12	8	20	0	0	20	0	0
11	18785600	.	A	T	10	5	15	0	1	16	0	0
11	18785623	.	A	T	5	6	11	0	1	12	0	0
11	18785749	.	C	G	2	5	7	0	1	8	0	0
11	18785921	.	G	A	15	16	31	0	0	31	0	0
11	18785975	.	T	C	9	18	27	0	2	29	0	0
11	18785997	.	T	A	7	22	29	0	0	29	0	0
11	18786085	.	A	T	4	9	13	0	0	13	0	0
11	18786250	.	A	C	18	24	42	0	0	42	0	0
11	18786329	.	C	A	1	19	20	0	15	35	0	0
11	18794157	.	C	A	0	8	8	0	13	21	0	0
11	18799800	.	C	T	8	6	14	0	0	14	0	0
11	18799873	.	G	A	14	12	26	0	0	26	0	0
11	18802570	.	T	C	4	2	6	0	0	6	0	0
11	18802815	.	G	C	1	2	3	0	2	5	0	0
11	18802865	.	C	G	3	3	6	0	0	6	0	0
11	18802879	.	A	G	3	2	5	0	0	5	0	0
11	18803621	.	A	G	4	2	6	0	0	6	0	0
11	18806030	.	A	G	3	3	6	0	0	6	0	0
11	18809354	.	G	A	3	6	9	0	0	9	0	0
11	18810393	.	A	G	2	3	5	0	0	5	0	0
11	18814506	.	T	G	5	3	8	0	0	8	0	0
11	18815957	.	C	T	4	6	10	0	0	10	0	0
11	18819056	.	A	G	5	2	7	0	0	7	0	0
11	19041518	.	G	A	10	11	21	0	1	22	0	0
11	19041647	.	T	G	13	5	18	0	1	19	0	0
11	19042020	.	T	C	13	9	22	0	0	22	0	0
11	19042026	.	A	G	12	8	20	0	1	21	0	0
11	19068394	.	C	T	26	19	45	0	1	46	0	0
11	19072608	.	T	A	24	16	40	0	2	42	0	0
11	19072746	.	A	T	26	18	44	0	1	45	0	0
11	19084820	.	C	T	8	8	16	0	1	17	0	0
11	19085099	.	G	A	12	6	18	0	0	18	0	0
11	19089286	.	A	G	31	28	59	0	1	60	0	0
11	19089362	.	A	G	31	23	54	0	4	58	0	0
11	19089368	.	C	T	32	23	55	0	1	56	0	0
11	19089608	.	G	A	5	30	35	0	26	61	0	0
11	19089839	.	G	A	1	22	23	0	18	41	0	0
11	19090203	.	G	A	0	15	15	0	14	29	0	0
11	19217341	.	T	A	1	2	3	0	0	3	0	0
11	19217349	.	A	G	1	2	3	0	0	3	0	0
11	19370862	.	G	C	2	6	8	0	0	8	0	0
11	19434043	.	G	C	12	7	19	0	0	19	0	0
11	19434095	.	A	C	5	12	17	0	1	18	0	0
11	19434132	.	T	C	5	11	16	0	1	17	0	0
11	19434239	.	T	C	13	8	21	0	2	23	0	0
11	19434279	.	T	C	12	7	19	0	0	19	0	0
11	19434290	.	T	C	10	8	18	0	1	19	0	0
11	19456886	.	C	T	5	7	12	0	1	13	0	0
11	19462920	.	C	T	18	7	25	0	1	26	0	0
11	19462971	.	A	G	9	1	10	0	10	20	0	0
11	19464759	.	C	G	13	8	21	0	1	22	0	0
11	19464813	.	A	G	5	11	16	0	0	16	0	0
11	19464957	.	C	G	8	0	8	0	10	18	0	0
11	19465029	.	T	C	10	12	22	0	2	24	0	0
11	19465080	.	T	C	15	12	27	0	0	27	0	0
11	19465428	.	C	T	22	11	33	0	2	35	0	0
11	19467792	.	G	A	2	16	18	0	23	41	0	0
11	19467838	.	C	T	20	13	33	0	1	34	0	0
11	19468104	.	C	T	26	21	47	0	0	47	0	0
11	19468123	.	T	C	24	23	47	0	1	48	0	0
11	19468301	.	A	G	12	1	13	0	13	26	0	0
11	19468547	.	C	A	15	13	28	0	0	28	0	0
11	19468697	.	G	T	13	5	18	0	1	19	0	0
11	19468718	.	A	G	13	6	19	0	0	19	0	0
11	19502433	.	C	T	21	22	43	0	0	43	0	0
11	19502479	.	T	C	17	15	32	0	2	34	0	0
11	19503920	.	T	A	13	15	28	0	2	30	0	0
11	19506155	.	A	G	19	21	40	0	0	40	0	0
11	19506260	.	C	T	10	17	27	0	0	27	0	0
11	19509643	.	T	C	20	13	33	0	2	35	0	0
11	19511392	.	G	A	12	20	32	1	0	33	0	0
11	19511922	.	A	C	3	2	5	0	0	5	0	0
11	19511983	.	G	A	2	5	7	0	0	7	0	0
11	19512285	.	T	C	4	7	11	0	0	11	0	0
11	19512430	.	C	T	1	3	4	1	5	10	0	0
11	19513031	.	C	T	3	2	5	0	0	5	0	0
11	19513033	.	T	A	4	2	6	0	0	6	0	0
11	19513249	.	A	G	1	6	7	0	0	7	0	0
11	19513358	.	T	C	4	3	7	0	0	7	0	0
11	19513364	.	T	C	3	0	3	0	3	6	0	0
11	19513395	.	A	G	3	2	5	0	0	5	0	0
11	19513639	.	C	T	4	4	8	0	0	8	0	0
11	19513722	.	C	A	0	3	3	0	3	6	0	0
11	19513725	.	A	G	3	3	6	0	0	6	0	0
11	19514982	.	A	G	1	2	3	0	0	3	0	0
11	19515190	.	G	T	4	3	7	0	1	8	0	0
11	19515275	.	C	T	3	3	6	0	0	6	0	0
11	19515286	.	A	G	3	5	8	0	1	9	0	0
11	19516201	.	A	C	1	2	3	0	0	3	0	0
11	19604223	.	A	C	12	15	27	0	0	27	0	0
11	19606676	.	T	C	5	8	13	0	0	13	0	0
11	19607131	.	T	C	13	13	26	0	0	26	0	0
11	19624828	.	G	A	6	4	10	0	1	11	0	0
11	19625168	.	G	A	18	5	23	0	0	24	1	0
11	19625416	.	T	C	34	8	42	0	0	42	0	0
11	19626236	.	G	A	7	2	9	0	0	9	0	0
11	19644104	.	T	C	4	0	4	0	4	8	0	0
11	19694025	.	A	G	3	2	5	0	0	5	0	0
11	19729842	.	A	T	2	6	8	0	1	10	1	0
11	19733160	.	A	G	4	4	8	0	0	8	0	0
11	19733388	.	A	G	5	5	10	0	1	11	0	0
11	19780751	.	T	C	1	4	5	0	1	6	0	0
11	19950899	.	C	T	6	4	10	0	0	10	0	0
11	19951119	.	G	A	5	2	7	0	0	7	0	0
11	19986251	.	A	G	7	0	7	0	3	10	0	0
11	19999131	.	T	C	5	5	10	0	1	11	0	0
11	20017802	.	A	G	2	15	17	0	1	18	0	0
11	20057537	.	G	C	1	3	4	0	0	4	0	0
11	20058882	.	C	A	2	4	6	0	0	6	0	0
11	20092194	.	C	T	1	2	3	0	0	3	0	0
11	20371248	.	A	G	8	0	8	0	12	20	0	0
11	20657517	.	A	C	10	6	16	1	1	18	0	0
11	20657574	.	G	C	10	10	20	0	0	20	0	0
11	20657661	.	T	C	16	9	25	0	0	25	0	0
11	20979901	.	A	C	6	3	9	0	0	9	0	0
11	21158792	.	G	A	3	5	8	0	1	9	0	0
11	21158858	.	G	A	4	5	9	0	0	9	0	0
11	21173971	.	T	C	6	7	13	0	0	13	0	0
11	21217518	.	T	C	5	5	10	0	0	10	0	0
11	21217542	.	T	C	8	7	15	0	0	15	0	0
11	21217834	.	T	C	7	4	11	0	1	12	0	0
11	21217986	.	A	G	2	2	4	0	0	4	0	0
11	21217994	.	G	A	1	3	4	0	0	4	0	0
11	21260009	.	T	C	4	9	13	0	0	13	0	0
11	21260018	.	A	T	5	7	12	0	0	12	0	0
11	21260213	.	G	A	4	2	6	0	0	6	0	0
11	21260546	.	G	A	2	6	8	0	1	9	0	0
11	21260676	.	C	T	7	3	10	0	0	10	0	0
11	21260750	.	C	T	7	3	10	0	0	10	0	0
11	21260985	.	A	T	2	3	5	0	0	5	0	0
11	21261546	.	A	G	4	5	9	0	0	9	0	0
11	21261558	.	T	C	3	4	7	0	0	7	0	0
11	21261688	.	C	A	2	3	5	0	2	7	0	0
11	21262085	.	T	C	1	3	4	0	0	4	0	0
11	21266802	.	T	C	5	5	10	0	0	10	0	0
11	21266841	.	T	A	4	2	6	0	0	6	0	0
11	21278950	.	T	A	16	9	25	0	1	27	1	0
11	21279194	.	G	T	14	13	27	0	2	29	0	0
11	21280202	.	A	T	10	12	22	0	0	22	0	0
11	21280504	.	A	C	10	9	19	0	0	19	0	0
11	21280555	.	A	T	9	3	12	0	0	12	0	0
11	21280689	.	T	A	5	8	13	0	1	14	0	0
11	21280801	.	T	A	6	15	21	0	0	21	0	0
11	21280974	.	G	A	7	11	18	0	2	20	0	0
11	21281087	.	C	T	9	15	24	1	1	26	0	0
11	21281110	.	G	A	12	24	36	0	0	36	0	0
11	21281219	.	G	A	20	13	33	0	0	33	0	0
11	21281269	.	T	C	13	7	20	0	2	22	0	0
11	21281273	.	A	G	15	10	25	0	0	25	0	0
11	21281516	.	G	A	11	10	21	0	6	27	0	0
11	21281774	.	T	C	11	7	18	0	1	19	0	0
11	21281821	.	A	T	5	7	12	0	1	13	0	0
11	21281876	.	T	C	3	4	7	0	0	7	0	0
11	21281888	.	G	A	4	6	10	0	0	10	0	0
11	21281916	.	A	G	7	7	14	0	0	14	0	0
11	21281951	.	A	G	8	7	15	0	0	15	0	0
11	21282068	.	G	A	7	12	19	0	0	19	0	0
11	21282072	.	G	A	7	11	18	0	1	19	0	0
11	21282208	.	T	C	4	2	6	0	0	6	0	0
11	21282302	.	A	C	7	1	8	0	3	11	0	0
11	21282414	.	G	A	17	8	25	0	0	25	0	0
11	21282424	.	C	G	17	9	26	0	0	26	0	0
11	21282500	.	C	A	13	14	27	0	1	28	0	0
11	21282571	.	G	A	5	11	16	0	2	18	0	0
11	21282673	.	G	T	9	12	21	0	3	24	0	0
11	21282747	.	T	C	6	10	16	0	1	17	0	0
11	21282809	.	A	T	11	6	17	0	0	17	0	0
11	21282957	.	T	C	6	2	8	0	13	21	0	0
11	21283211	.	G	A	16	9	25	0	0	25	0	0
11	21284382	.	G	A	10	11	21	0	0	21	0	0
11	21284588	.	A	G	13	11	24	1	0	25	0	0
11	21284701	.	A	C	11	1	12	0	23	35	0	0
11	21284733	.	C	T	13	18	31	0	1	32	0	0
11	21284844	.	C	T	12	9	21	0	2	23	0	0
11	21304242	.	T	A	1	3	4	0	0	4	0	0
11	21304260	.	G	A	2	3	5	0	0	5	0	0
11	21323564	.	A	G	11	12	23	0	2	25	0	0
11	21352744	.	G	C	12	6	18	0	0	18	0	0
11	21352773	.	A	T	11	10	21	0	1	22	0	0
11	21363229	.	T	C	5	3	8	0	0	8	0	0
11	21363298	.	T	C	1	0	1	0	4	5	0	0
11	21363310	.	G	A	1	3	4	0	0	4	0	0
11	21363411	.	T	C	3	0	3	0	2	5	0	0
11	21363479	.	A	G	6	5	11	0	0	11	0	0
11	21363480	.	A	C	6	0	6	0	5	11	0	0
11	21363693	.	A	T	5	4	9	0	0	9	0	0
11	21407500	.	G	A	3	11	14	0	0	14	0	0
11	21407692	.	C	G	10	9	19	0	1	20	0	0
11	21407782	.	G	T	10	12	22	0	0	22	0	0
11	21409415	.	A	T	14	18	32	0	0	32	0	0
11	21409417	.	T	C	11	18	29	0	1	30	0	0
11	21427219	.	T	C	12	16	28	0	0	28	0	0
11	21434465	.	G	A	4	8	12	0	1	13	0	0
11	21443950	.	A	G	5	5	10	0	0	10	0	0
11	21457932	.	A	G	1	10	11	0	0	11	0	0
11	21583065	.	T	C	5	6	11	0	0	11	0	0
11	21583210	.	T	C	1	0	1	0	3	4	0	0
11	21593849	.	A	T	6	5	11	0	0	11	0	0
11	21593869	.	G	C	9	7	16	0	0	16	0	0
11	21594510	.	C	T	2	2	4	0	0	4	0	0
11	21594552	.	G	A	3	2	5	0	0	5	0	0
11	21595189	.	G	A	4	2	6	0	1	7	0	0
11	21595191	.	G	A	0	2	2	0	5	7	0	0
11	21595307	.	G	A	1	2	3	0	1	4	0	0
11	21595351	.	G	A	1	2	3	0	3	6	0	0
11	21595615	.	G	A	8	6	14	0	1	15	0	0
11	21596133	.	A	C	3	6	9	0	0	9	0	0
11	21596134	.	G	A	4	6	10	0	0	10	0	0
11	21596459	.	T	C	5	4	9	0	0	9	0	0
11	21596492	.	A	G	6	0	6	0	4	10	0	0
11	21596713	.	C	G	2	4	6	0	0	6	0	0
11	21596994	.	T	G	7	4	11	0	0	11	0	0
11	21597055	.	T	G	7	9	16	0	0	16	0	0
11	21597166	.	A	G	7	0	7	0	4	11	0	0
11	21597256	.	A	C	4	5	9	0	1	10	0	0
11	21597337	.	A	G	3	4	7	0	0	7	0	0
11	21597584	.	T	C	3	4	7	0	0	7	0	0
11	21597659	.	T	C	3	8	11	0	0	11	0	0
11	21597676	.	C	A	3	6	9	0	0	9	0	0
11	21597702	.	A	G	3	4	7	0	0	7	0	0
11	21597754	.	T	G	2	2	4	0	0	4	0	0
11	21597988	.	C	T	4	8	12	0	1	13	0	0
11	21598002	.	T	C	3	5	8	0	0	8	0	0
11	21598036	.	T	C	1	2	3	0	0	3	0	0
11	21598121	.	G	A	0	3	3	0	6	9	0	0
11	21910569	.	T	C	9	3	12	0	0	12	0	0
11	21962831	.	A	G	17	9	26	0	0	26	0	0
11	22091956	.	C	A	10	13	23	0	2	26	1	0
11	22092158	.	G	A	12	22	34	0	2	36	0	0
11	22092244	.	A	T	12	13	25	0	0	25	0	0
11	22092689	.	T	A	9	8	17	0	2	19	0	0
11	22093634	.	G	A	17	17	34	0	3	37	0	0
11	22093848	.	A	C	12	12	24	0	1	25	0	0
11	22094072	.	T	C	6	14	20	0	2	22	0	0
11	22288794	.	T	C	1	0	1	0	2	3	0	0
11	22292523	.	C	A	1	3	4	0	0	4	0	0
11	22363756	.	A	T	8	8	16	0	1	17	0	0
11	22363768	.	A	T	8	9	17	0	0	17	0	0
11	22363994	.	T	G	12	7	19	0	0	19	0	0
11	22364128	.	A	T	5	7	12	0	1	13	0	0
11	22364140	.	T	A	3	9	12	0	1	13	0	0
11	22364228	.	G	A	4	13	17	0	1	18	0	0
11	22364359	.	A	G	5	6	11	0	0	11	0	0
11	22364416	.	A	G	6	4	10	0	0	10	0	0
11	22364502	.	C	A	0	13	13	0	14	27	0	0
11	22364558	.	T	C	11	10	21	0	0	21	0	0
11	22366841	.	T	C	16	13	29	0	0	29	0	0
11	22367200	.	A	T	9	15	24	0	0	24	0	0
11	22367251	.	A	G	12	17	29	0	1	30	0	0
11	22369932	.	G	A	6	6	12	0	0	12	0	0
11	22369981	.	A	G	12	12	24	0	0	24	0	0
11	22369991	.	C	A	13	15	28	0	0	28	0	0
11	22371944	.	T	G	10	6	16	0	1	17	0	0
11	22371990	.	T	G	9	6	15	0	1	16	0	0
11	22374890	.	G	A	2	4	6	0	2	8	0	0
11	22375072	.	T	C	9	3	12	0	0	12	0	0
11	22490731	.	A	G	9	0	9	1	6	16	0	0
11	22495182	.	T	C	17	5	22	0	1	23	0	0
11	22505058	.	T	C	12	5	17	0	1	18	0	0
11	22560289	.	T	C	22	8	30	0	0	30	0	0
11	22582243	.	G	C	8	6	14	0	1	15	0	0
11	22582573	.	C	A	6	9	15	0	0	15	0	0
11	22582607	.	T	C	9	5	14	0	1	15	0	0
11	22582706	.	T	C	13	5	18	0	0	18	0	0
11	22582830	.	T	C	16	7	23	0	0	23	0	0
11	22582878	.	A	G	11	4	15	0	0	15	0	0
11	22582923	.	C	T	9	3	12	0	0	12	0	0
11	22583023	.	A	T	9	6	15	0	0	15	0	0
11	22583139	.	G	T	12	5	17	1	0	18	0	0
11	22583346	.	G	T	3	2	5	0	1	6	0	0
11	22583547	.	G	T	13	7	20	0	0	20	0	0
11	22583759	.	T	C	6	5	11	0	0	11	0	0
11	22583807	.	T	C	14	5	19	0	0	19	0	0
11	22583974	.	T	C	10	8	18	0	1	19	0	0
11	22583984	.	T	C	13	8	21	0	0	21	0	0
11	22584173	.	G	A	11	5	16	0	1	17	0	0
11	22584229	.	T	C	8	3	11	0	1	12	0	0
11	22623334	.	T	A	7	3	10	0	1	11	0	0
11	22623502	.	T	G	2	4	6	0	0	6	0	0
11	22624550	.	A	G	8	5	13	0	0	13	0	0
11	22624777	.	C	A	4	4	8	0	1	9	0	0
11	22624778	.	C	A	5	4	9	0	0	9	0	0
11	22629148	.	C	A	6	4	10	0	1	11	0	0
11	22629325	.	A	C	1	4	5	0	1	6	0	0
11	22629891	.	A	T	1	3	4	0	0	4	0	0
11	22630020	.	A	T	1	2	3	0	0	3	0	0
11	22630190	.	T	A	3	3	6	0	0	6	0	0
11	22630252	.	G	T	1	3	4	0	0	4	0	0
11	22630264	.	T	G	1	2	3	0	0	3	0	0
11	22891305	.	C	G	16	15	31	2	0	33	0	0
11	22891574	.	G	A	25	7	32	0	1	33	0	0
11	22891575	.	T	C	22	0	22	0	10	32	0	0
11	22891624	.	C	T	20	6	26	0	1	27	0	0
11	22891683	.	G	A	20	14	34	0	2	36	0	0
11	22891692	.	C	T	1	18	19	0	19	38	0	0
11	22892028	.	C	T	11	17	28	0	1	29	0	0
11	22892205	.	A	G	17	26	43	0	1	44	0	0
11	22892345	.	C	A	2	11	13	0	10	23	0	0
11	22892395	.	G	A	13	15	28	1	0	29	0	0
11	22892432	.	C	T	19	8	27	1	0	28	0	0
11	22892534	.	G	A	13	12	25	0	2	27	0	0
11	22892573	.	G	A	17	13	30	0	0	30	0	0
11	22892859	.	A	T	18	18	36	0	2	39	1	0
11	22906133	.	T	G	18	17	35	0	2	37	0	0
11	22906383	.	T	C	14	14	28	1	2	31	0	0
11	22911841	.	C	G	13	17	30	0	2	32	0	0
11	22920796	.	T	A	6	10	16	0	2	18	0	0
11	22921124	.	G	T	34	25	59	0	1	60	0	0
11	22921168	.	C	T	33	27	60	0	2	62	0	0
11	22921326	.	G	A	27	16	43	0	0	43	0	0
11	22921568	.	G	C	27	30	57	0	3	60	0	0
11	22921800	.	T	G	25	29	54	0	1	55	0	0
11	22921865	.	T	C	23	3	26	0	29	55	0	0
11	22921953	.	C	T	26	15	41	0	1	42	0	0
11	22922075	.	A	G	24	24	48	0	0	48	0	0
11	22922114	.	A	T	25	22	47	0	2	49	0	0
11	22922115	.	A	T	24	21	45	0	4	49	0	0
11	22922251	.	C	T	27	23	50	0	4	54	0	0
11	22922266	.	A	G	21	29	50	0	4	54	0	0
11	22922290	.	A	G	23	25	48	0	3	51	0	0
11	22922309	.	T	A	26	27	53	0	0	53	0	0
11	22922333	.	A	T	23	22	45	0	3	48	0	0
11	22922355	.	A	T	28	14	42	0	5	47	0	0
11	22922405	.	G	A	29	21	50	0	2	52	0	0
11	22922668	.	T	C	28	26	54	0	2	56	0	0
11	22922762	.	T	A	30	20	50	0	1	51	0	0
11	22922841	.	C	A	34	15	49	2	0	52	1	0
11	22922909	.	A	T	26	18	44	0	1	45	0	0
11	22923397	.	A	T	29	17	46	0	1	47	0	0
11	22923429	.	T	A	27	7	34	0	2	48	12	0
11	22923441	.	T	G	43	6	49	0	2	52	1	0
11	22923613	.	T	C	30	4	34	0	22	56	0	0
11	22924449	.	C	T	19	12	31	0	0	31	0	0
11	22924650	.	A	C	11	13	24	0	0	24	0	0
11	22924746	.	C	T	1	17	18	0	8	26	0	0
11	22925048	.	G	A	16	8	24	0	1	25	0	0
11	22925266	.	G	A	22	16	38	0	1	39	0	0
11	22925370	.	A	G	36	19	55	0	2	57	0	0
11	22926213	.	A	C	18	0	18	0	20	38	0	0
11	22950984	.	C	T	32	23	55	0	2	57	0	0
11	22964006	.	G	T	28	28	56	0	1	57	0	0
11	22969056	.	T	C	19	0	19	0	28	47	0	0
11	22969098	.	C	G	22	17	39	0	1	40	0	0
11	22983958	.	A	T	14	12	26	0	1	27	0	0
11	22983965	.	C	G	1	10	11	2	13	26	0	0
11	22984008	.	G	A	18	15	33	2	1	36	0	0
11	22995813	.	A	G	14	19	33	0	3	36	0	0
11	23312451	.	T	A	6	4	10	0	0	10	0	0
11	23312477	.	T	C	5	2	7	0	0	7	0	0
11	23313911	.	G	A	4	2	6	0	0	6	0	0
11	23313928	.	T	C	4	4	8	0	0	8	0	0
11	23343154	.	A	G	2	10	12	0	1	13	0	0
11	23343231	.	G	A	11	7	18	0	0	18	0	0
11	23343594	.	T	A	12	11	23	0	1	24	0	0
11	23343775	.	A	G	4	7	11	0	0	11	0	0
11	23344143	.	C	A	17	17	34	0	0	34	0	0
11	23344421	.	G	C	11	11	22	0	1	23	0	0
11	23344790	.	T	A	11	11	22	0	1	23	0	0
11	23352194	.	C	T	15	12	27	0	0	27	0	0
11	23353706	.	C	T	10	7	17	0	0	17	0	0
11	23365237	.	A	T	3	7	10	0	0	10	0	0
11	23374787	.	C	G	4	7	11	0	0	11	0	0
11	23377379	.	A	G	9	13	22	0	1	23	0	0
11	23377418	.	A	C	8	0	8	0	10	18	0	0
11	23377538	.	G	T	6	2	8	0	1	9	0	0
11	23479872	.	T	C	1	9	10	0	0	10	0	0
11	23479882	.	T	G	2	9	11	0	0	11	0	0
11	23595538	.	G	T	9	4	13	0	1	14	0	0
11	23595627	.	C	T	3	6	9	0	2	11	0	0
11	23595766	.	C	A	7	7	14	0	0	14	0	0
11	23596240	.	A	G	7	11	18	0	0	18	0	0
11	23596264	.	G	T	5	14	19	0	1	20	0	0
11	23596333	.	T	C	12	12	24	0	1	25	0	0
11	23596725	.	T	C	7	8	15	0	0	15	0	0
11	23596732	.	A	T	7	10	17	0	0	17	0	0
11	23597047	.	G	A	3	5	8	0	0	8	0	0
11	23597310	.	A	G	11	6	17	0	0	17	0	0
11	23597589	.	C	T	2	8	10	0	6	16	0	0
11	23604921	.	T	C	5	6	11	0	0	11	0	0
11	23604954	.	A	G	4	5	9	0	1	10	0	0
11	23659051	.	G	A	3	4	7	0	0	7	0	0
11	23659108	.	G	C	5	2	7	0	0	7	0	0
11	23686379	.	C	T	1	5	6	0	5	11	0	0
11	23686426	.	G	A	4	7	11	0	0	11	0	0
11	23825482	.	A	C	5	5	10	0	0	10	0	0
11	23825607	.	C	T	6	12	18	0	0	18	0	0
11	23825610	.	T	C	5	10	15	0	1	16	0	0
11	23826524	.	C	T	6	7	13	0	0	13	0	0
11	23828197	.	G	C	11	5	16	0	0	16	0	0
11	23828245	.	A	G	17	6	23	0	0	23	0	0
11	23834585	.	T	G	4	10	14	0	0	14	0	0
11	23834884	.	A	G	10	7	17	0	1	18	0	0
11	23838200	.	G	A	1	6	7	0	6	13	0	0
11	23839022	.	C	T	10	7	17	0	0	17	0	0
11	23842789	.	A	G	5	10	15	0	0	15	0	0
11	23843015	.	C	T	6	8	14	0	2	16	0	0
11	23843072	.	T	A	10	10	20	0	0	20	0	0
11	23843117	.	A	T	12	9	21	0	0	21	0	0
11	23843180	.	G	A	11	7	18	0	2	20	0	0
11	23843362	.	A	G	10	6	16	0	2	18	0	0
11	23845323	.	C	T	20	17	37	0	2	39	0	0
11	23845329	.	C	A	14	22	36	0	1	37	0	0
11	23856440	.	A	G	5	13	18	0	1	19	0	0
11	23879654	.	C	A	13	23	36	0	2	39	1	0
11	23879825	.	A	T	13	17	30	0	0	30	0	0
11	23879938	.	C	T	16	19	35	0	1	36	0	0
11	23880084	.	T	C	16	12	28	1	1	30	0	0
11	23880476	.	T	G	9	12	21	0	3	24	0	0
11	23880486	.	G	T	12	9	21	0	0	21	0	0
11	23880607	.	C	T	12	19	31	0	1	32	0	0
11	23880631	.	G	T	14	18	32	0	1	33	0	0
11	23881038	.	C	A	7	8	15	0	0	15	0	0
11	23881070	.	C	T	8	8	16	0	0	16	0	0
11	23881101	.	G	A	11	4	15	0	0	15	0	0
11	23881131	.	G	C	13	6	19	0	0	19	0	0
11	23881152	.	G	A	1	8	9	0	10	19	0	0
11	23881238	.	A	T	6	10	16	0	0	16	0	0
11	23881247	.	A	T	5	10	15	0	0	15	0	0
11	23881683	.	A	T	6	2	8	0	0	8	0	0
11	23881719	.	T	A	7	4	11	0	1	12	0	0
11	23881866	.	A	G	4	16	20	0	0	20	0	0
11	23882438	.	A	G	8	4	12	0	3	15	0	0
11	23882525	.	T	C	11	13	24	0	0	24	0	0
11	23882572	.	A	T	18	15	33	0	1	34	0	0
11	23882646	.	A	T	18	15	33	0	2	36	1	0
11	23882655	.	C	T	20	15	35	0	2	37	0	0
11	23882747	.	C	T	25	13	38	0	3	41	0	0
11	23882748	.	C	T	24	14	38	0	2	40	0	0
11	23882836	.	A	G	10	7	17	0	5	22	0	0
11	23883235	.	A	T	5	2	7	0	1	8	0	0
11	23883302	.	G	A	7	7	14	0	0	14	0	0
11	23883699	.	A	T	12	8	20	0	0	20	0	0
11	23884416	.	G	A	34	13	47	0	0	47	0	0
11	23884419	.	T	A	13	35	48	0	0	48	0	0
11	23884742	.	G	A	13	4	17	0	1	18	0	0
11	23933059	.	C	T	11	7	18	0	1	19	0	0
11	23957433	.	T	C	0	7	7	2	0	11	2	0
11	23957496	.	A	G	9	0	9	0	6	15	0	0
11	23970126	.	G	A	9	11	20	0	0	20	0	0
11	23976169	.	C	T	13	8	21	0	1	22	0	0
11	24035841	.	G	T	1	9	10	0	6	16	0	0
11	24036035	.	C	T	8	10	18	0	0	18	0	0
11	24038115	.	A	G	10	10	20	0	2	22	0	0
11	24038795	.	T	G	16	14	30	0	0	30	0	0
11	24039086	.	A	G	21	19	40	0	0	40	0	0
11	24039241	.	A	G	21	0	21	0	21	42	0	0
11	24039246	.	T	G	22	20	42	0	1	43	0	0
11	24039728	.	G	A	15	18	33	0	1	34	0	0
11	24039732	.	C	T	17	15	32	0	5	37	0	0
11	24039773	.	A	C	19	18	37	0	0	38	1	0
11	24039791	.	A	C	21	16	37	0	1	38	0	0
11	24039912	.	T	C	18	9	27	0	2	29	0	0
11	24039949	.	C	A	13	17	30	0	1	31	0	0
11	24043500	.	C	T	11	7	18	0	0	18	0	0
11	24044318	.	G	T	7	8	15	0	2	17	0	0
11	24044351	.	C	T	10	8	18	0	0	18	0	0
11	24044413	.	T	A	10	8	18	0	1	19	0	0
11	24046235	.	C	T	11	9	20	0	0	20	0	0
11	24050607	.	G	A	14	7	21	0	0	21	0	0
11	24054359	.	G	T	3	5	8	0	0	8	0	0
11	24054807	.	C	A	3	2	5	0	0	5	0	0
11	24054894	.	A	G	3	2	5	0	0	5	0	0
11	24055432	.	A	G	5	3	8	0	1	9	0	0
11	24055699	.	A	T	15	7	22	0	0	22	0	0
11	24055884	.	A	G	10	0	10	0	9	19	0	0
11	24056205	.	C	T	16	13	29	0	1	30	0	0
11	24056377	.	G	C	19	13	32	0	3	35	0	0
11	24058749	.	G	A	4	10	14	0	0	14	0	0
11	24058963	.	G	A	4	4	8	1	0	9	0	0
11	24059268	.	G	A	2	6	8	0	0	8	0	0
11	24059476	.	A	T	2	5	7	0	0	7	0	0
11	24059630	.	C	A	8	3	11	0	0	11	0	0
11	24059873	.	A	T	7	6	13	0	0	13	0	0
11	24059933	.	G	A	5	7	12	0	0	12	0	0
11	24059963	.	G	A	5	7	12	0	0	12	0	0
11	24060014	.	C	G	5	2	7	0	0	7	0	0
11	24188088	.	G	T	6	12	18	0	1	19	0	0
11	24188221	.	C	T	0	7	7	0	10	17	0	0
11	24188227	.	G	T	7	10	17	0	0	17	0	0
11	24188385	.	T	A	6	5	11	0	1	12	0	0
11	24188436	.	T	A	6	7	13	0	1	14	0	0
11	24188437	.	G	T	5	9	14	0	0	14	0	0
11	24188884	.	C	T	0	8	8	0	7	15	0	0
11	24189765	.	G	A	8	5	13	0	0	13	0	0
11	24189786	.	C	T	1	7	8	0	8	16	0	0
11	24189811	.	G	C	6	6	12	0	0	12	0	0
11	24190606	.	C	T	9	10	19	0	0	19	0	0
11	24190821	.	G	A	5	3	8	0	0	8	0	0
11	24190989	.	A	T	4	7	11	0	0	11	0	0
11	24191019	.	G	A	5	4	9	0	0	9	0	0
11	24340745	.	T	A	8	9	17	0	1	18	0	0
11	24340931	.	G	A	12	5	17	0	0	17	0	0
11	24343537	.	T	C	27	20	47	0	0	47	0	0
11	24344983	.	T	G	14	16	30	0	0	30	0	0
11	24348553	.	C	G	12	10	22	0	1	23	0	0
11	24349265	.	A	C	11	13	24	0	1	25	0	0
11	24360891	.	C	G	7	7	14	0	0	14	0	0
11	24360924	.	A	G	5	12	17	0	1	18	0	0
11	24361207	.	T	G	7	13	20	0	0	20	0	0
11	24369586	.	A	G	8	10	18	0	0	18	0	0
11	24369652	.	G	A	3	3	6	0	0	6	0	0
11	24379360	.	C	T	4	4	8	0	0	8	0	0
11	24379384	.	G	A	3	4	7	0	0	7	0	0
11	24382547	.	C	T	0	7	7	0	4	11	0	0
11	24465598	.	A	C	2	6	8	0	0	8	0	0
11	24471518	.	C	T	2	9	11	0	7	18	0	0
11	24472065	.	A	G	3	7	10	0	1	11	0	0
11	24472145	.	T	A	5	8	13	0	0	13	0	0
11	24472176	.	A	G	5	5	10	0	0	10	0	0
11	24474181	.	G	A	4	4	8	0	0	8	0	0
11	24474384	.	G	A	6	5	11	0	0	11	0	0
11	24474483	.	A	C	8	8	16	0	0	16	0	0
11	24476587	.	C	T	5	8	13	0	1	14	0	0
11	24480781	.	C	T	6	5	11	0	0	11	0	0
11	24481382	.	G	A	7	4	11	0	0	11	0	0
11	24643337	.	T	G	3	6	9	0	0	9	0	0
11	24645757	.	T	C	5	4	9	0	0	9	0	0
11	24658335	.	T	C	5	7	12	0	1	13	0	0
11	24658606	.	G	A	3	12	15	0	7	22	0	0
11	24658696	.	C	T	12	7	19	0	0	19	0	0
11	24662830	.	T	A	2	6	8	0	0	8	0	0
11	24662898	.	C	A	6	5	11	0	0	11	0	0
11	24663768	.	G	A	1	3	4	0	2	6	0	0
11	24744060	.	C	T	2	3	5	0	0	5	0	0
11	24747583	.	G	A	2	3	5	0	0	5	0	0
11	24747586	.	T	C	0	3	3	0	1	4	0	0
11	24782271	.	G	A	0	3	3	0	9	12	0	0
11	24782948	.	C	T	1	2	3	0	0	3	0	0
11	24786415	.	G	A	1	6	7	0	5	12	0	0
11	24786466	.	T	A	17	12	29	0	0	29	0	0
11	24789357	.	C	G	18	6	24	0	0	24	0	0
11	24792102	.	T	A	16	18	34	0	1	35	0	0
11	24792201	.	G	A	14	13	27	0	5	32	0	0
11	24796820	.	T	G	21	0	21	0	15	37	1	0
11	24799378	.	G	A	10	10	20	0	0	20	0	0
11	24799408	.	G	A	0	7	7	0	4	11	0	0
11	24799433	.	T	G	3	5	8	0	3	11	0	0
11	24804565	.	A	T	19	15	34	0	1	35	0	0
11	24805106	.	A	C	6	16	22	0	2	24	0	0
11	24807966	.	A	G	13	14	27	0	0	27	0	0
11	24809738	.	C	T	21	23	44	0	4	48	0	0
11	24810510	.	C	A	21	17	38	0	1	39	0	0
11	24813651	.	G	A	9	14	23	0	0	23	0	0
11	24813810	.	A	G	11	15	26	0	2	28	0	0
11	24814014	.	A	G	19	8	27	0	1	28	0	0
11	24814110	.	G	T	14	18	32	0	2	34	0	0
11	24816326	.	A	T	2	3	5	0	1	6	0	0
11	24816471	.	C	T	5	2	7	0	0	7	0	0
11	24816472	.	C	T	5	2	7	0	0	7	0	0
11	24816648	.	G	A	5	4	9	0	0	9	0	0
11	24817054	.	T	A	8	6	14	0	0	14	0	0
11	24817352	.	G	T	6	2	8	0	0	8	0	0
11	24819667	.	C	T	18	11	29	0	2	31	0	0
11	24823323	.	G	A	2	18	20	0	10	30	0	0
11	24825549	.	C	T	15	11	26	0	0	26	0	0
11	24825583	.	G	A	4	8	12	0	3	15	0	0
11	24825598	.	C	T	12	7	19	0	1	20	0	0
11	24831674	.	T	C	10	7	17	0	0	17	0	0
11	24835762	.	A	C	16	18	34	0	0	34	0	0
11	24835764	.	A	G	16	18	34	0	0	34	0	0
11	24836409	.	C	T	18	13	31	0	0	31	0	0
11	24843031	.	C	A	13	14	27	0	4	31	0	0
11	24843058	.	G	A	0	12	12	0	9	21	0	0
11	24843079	.	A	G	6	0	6	0	10	16	0	0
11	24843154	.	G	A	2	6	8	0	8	16	0	0
11	24843219	.	C	T	13	10	23	0	0	23	0	0
11	24848221	.	T	A	19	15	34	0	1	35	0	0
11	24848409	.	G	T	22	12	34	0	1	35	0	0
11	24850428	.	A	G	16	17	33	0	3	36	0	0
11	24851182	.	A	T	2	5	7	0	0	7	0	0
11	24851804	.	T	C	9	10	19	0	0	20	1	0
11	24856391	.	C	T	5	4	9	0	0	9	0	0
11	24862554	.	C	T	13	5	18	0	1	19	0	0
11	24862737	.	C	T	9	4	13	0	0	13	0	0
11	24865281	.	A	G	6	7	13	0	1	14	0	0
11	24865602	.	T	A	2	5	7	0	0	7	0	0
11	24865626	.	C	T	4	5	9	0	0	9	0	0
11	24869046	.	G	A	10	6	16	0	1	17	0	0
11	24874841	.	A	G	7	4	11	0	0	11	0	0
11	24874960	.	C	A	7	0	7	1	7	17	2	0
11	24875331	.	T	C	8	6	14	0	0	14	0	0
11	24878011	.	C	T	8	13	21	0	0	21	0	0
11	24880785	.	T	C	13	17	30	0	1	31	0	0
11	24884840	.	G	C	18	13	31	0	2	33	0	0
11	24884967	.	C	T	20	13	33	0	1	34	0	0
11	24885282	.	T	C	11	9	20	0	0	20	0	0
11	24885332	.	C	T	9	8	17	0	0	17	0	0
11	24885357	.	A	T	7	7	14	0	1	15	0	0
11	24885598	.	C	T	5	3	8	1	1	10	0	0
11	24885734	.	T	C	2	9	11	0	0	11	0	0
11	24885738	.	A	G	2	8	10	0	0	10	0	0
11	24885810	.	A	C	7	6	13	0	0	13	0	0
11	24885901	.	A	T	12	5	17	0	0	17	0	0
11	24885928	.	C	T	15	9	24	0	0	24	0	0
11	24885937	.	C	T	18	8	26	0	1	27	0	0
11	24886152	.	C	A	11	29	40	3	2	45	0	0
11	24886420	.	T	A	5	9	14	0	1	15	0	0
11	24886438	.	T	G	2	8	10	0	0	10	0	0
11	24886499	.	T	A	5	6	11	0	0	11	0	0
11	24886602	.	G	T	1	5	6	0	11	17	0	0
11	24886672	.	T	C	6	16	22	0	1	23	0	0
11	24886686	.	G	T	20	5	25	0	1	26	0	0
11	24886739	.	G	T	17	14	31	0	0	31	0	0
11	24886754	.	G	A	15	14	29	0	1	30	0	0
11	24887321	.	T	C	26	18	44	0	1	45	0	0
11	24887636	.	A	G	8	30	38	0	0	38	0	0
11	24887648	.	A	G	15	3	18	0	16	34	0	0
11	24887703	.	C	T	4	13	17	0	2	19	0	0
11	24888272	.	C	T	7	11	18	0	0	18	0	0
11	24888379	.	C	A	16	14	30	0	2	32	0	0
11	24888560	.	A	T	2	4	6	0	1	7	0	0
11	24901897	.	C	T	30	22	52	0	1	53	0	0
11	24902157	.	A	T	22	24	46	0	2	48	0	0
11	24903143	.	G	T	21	25	46	0	1	47	0	0
11	24905477	.	C	T	29	26	55	0	1	56	0	0
11	24905526	.	G	T	29	13	42	0	0	42	0	0
11	24905541	.	C	T	27	13	40	0	1	41	0	0
11	24905574	.	G	A	30	16	46	0	1	47	0	0
11	24905576	.	C	A	31	16	47	0	0	47	0	0
11	24905632	.	T	G	14	25	39	0	1	40	0	0
11	24905692	.	G	A	2	11	13	0	34	47	0	0
11	24905742	.	C	T	30	10	40	0	0	40	0	0
11	24905748	.	A	G	27	10	37	0	3	40	0	0
11	24906177	.	G	T	11	10	21	0	1	22	0	0
11	24906178	.	G	A	11	10	21	0	1	22	0	0
11	24966841	.	G	A	0	9	9	0	5	14	0	0
11	24966928	.	A	G	5	0	5	0	5	10	0	0
11	24969654	.	A	G	13	0	13	0	6	19	0	0
11	24972396	.	G	A	2	6	8	0	8	16	0	0
11	24975714	.	C	T	9	4	13	0	0	13	0	0
11	24975855	.	C	T	8	6	14	0	0	14	0	0
11	24975911	.	A	C	2	10	12	0	0	12	0	0
11	24975936	.	C	T	4	6	10	0	0	10	0	0
11	24980631	.	C	A	12	10	22	0	1	23	0	0
11	24980684	.	C	T	12	8	20	0	1	21	0	0
11	24980714	.	A	C	8	13	21	0	0	21	0	0
11	24981190	.	A	T	12	6	18	0	1	19	0	0
11	24987085	.	T	C	8	9	17	0	1	18	0	0
11	24987226	.	C	T	15	11	26	0	0	26	0	0
11	24992298	.	A	G	15	7	22	0	0	22	0	0
11	24992445	.	T	A	7	9	16	0	1	17	0	0
11	24992899	.	C	A	9	5	14	0	0	14	0	0
11	24992928	.	G	A	6	5	11	0	1	12	0	0
11	24994833	.	A	C	13	11	24	0	1	25	0	0
11	25010619	.	A	C	15	12	27	0	4	31	0	0
11	25010873	.	A	G	12	0	12	0	15	27	0	0
11	25025783	.	T	G	19	19	38	0	1	39	0	0
11	25026004	.	C	G	16	7	23	0	1	24	0	0
11	25026437	.	A	G	14	16	30	0	4	34	0	0
11	25026450	.	A	T	10	18	28	0	2	30	0	0
11	25031086	.	T	A	14	15	29	0	1	30	0	0
11	25031272	.	A	C	10	33	43	0	0	43	0	0
11	25031362	.	C	T	17	12	29	0	3	32	0	0
11	25031497	.	A	T	16	11	27	0	1	28	0	0
11	25031527	.	G	A	12	17	29	0	0	29	0	0
11	25035439	.	C	T	15	15	30	0	0	30	0	0
11	25036942	.	C	T	16	10	26	0	2	28	0	0
11	25037017	.	C	T	15	15	30	0	2	32	0	0
11	25038572	.	T	C	17	12	29	0	0	29	0	0
11	25038625	.	G	C	21	7	28	0	1	29	0	0
11	25038652	.	G	A	0	6	6	0	19	25	0	0
11	25040808	.	A	T	8	11	19	0	0	19	0	0
11	25041204	.	C	T	10	7	17	0	2	19	0	0
11	25041607	.	G	C	1	21	22	0	15	38	1	0
11	25044150	.	G	T	0	2	2	0	5	7	0	0
11	25046896	.	T	C	3	5	8	0	0	8	0	0
11	25053236	.	C	T	3	3	6	0	0	6	0	0
11	25053820	.	G	A	3	2	5	0	0	5	0	0
11	25054092	.	G	A	3	5	8	0	0	8	0	0
11	25054095	.	G	A	3	6	9	0	0	9	0	0
11	25058993	.	A	C	1	3	4	0	0	4	0	0
11	25059067	.	G	A	6	2	8	0	0	8	0	0
11	25059156	.	T	A	5	5	10	0	0	10	0	0
11	25061104	.	G	A	3	4	7	0	0	7	0	0
11	25062382	.	T	A	1	2	3	0	0	3	0	0
11	25062395	.	A	C	1	2	3	0	0	3	0	0
11	25062455	.	G	T	2	2	4	0	1	5	0	0
11	25062499	.	T	C	2	3	5	0	0	5	0	0
11	25062532	.	C	T	1	5	6	0	0	6	0	0
11	25062867	.	C	G	2	2	4	0	0	4	0	0
11	25062879	.	C	T	1	2	3	0	0	3	0	0
11	25063054	.	A	C	3	4	7	0	0	7	0	0
11	25063080	.	G	A	3	5	8	0	0	8	0	0
11	25063103	.	G	A	1	4	5	0	0	5	0	0
11	25063120	.	T	G	1	3	4	0	0	4	0	0
11	25064623	.	C	G	28	23	51	0	1	52	0	0
11	25101665	.	C	T	25	24	49	0	0	49	0	0
11	25127839	.	G	A	39	36	75	0	0	75	0	0
11	25129232	.	C	G	38	5	43	0	32	75	0	0
11	25132510	.	T	C	37	37	74	0	3	77	0	0
11	25138485	.	A	C	35	29	64	0	4	68	0	0
11	25138656	.	T	C	34	30	64	0	10	74	0	0
11	25138673	.	T	A	35	37	72	0	1	73	0	0
11	25138845	.	C	T	27	42	69	0	2	71	0	0
11	25139000	.	G	C	17	17	34	0	1	35	0	0
11	25139053	.	G	A	6	2	8	0	1	9	0	0
11	25163387	.	C	A	5	7	12	0	0	12	0	0
11	25163414	.	G	A	7	3	10	0	0	10	0	0
11	25166824	.	G	A	5	4	9	0	0	9	0	0
11	25167856	.	T	C	7	7	14	0	0	14	0	0
11	25167980	.	G	A	10	4	14	0	0	14	0	0
11	25169680	.	G	A	6	8	14	0	0	14	0	0
11	25169704	.	T	C	8	7	15	0	0	15	0	0
11	25169749	.	G	A	1	6	7	0	7	14	0	0
11	25173328	.	T	C	2	5	7	0	0	7	0	0
11	25173348	.	G	A	4	3	7	0	0	7	0	0
11	25178862	.	C	T	7	9	16	0	1	17	0	0
11	25178865	.	T	A	7	9	16	0	1	17	0	0
11	25179014	.	C	T	9	8	17	0	0	17	0	0
11	25179057	.	A	C	9	4	13	0	0	13	0	0
11	25179069	.	A	G	3	6	9	0	0	9	0	0
11	25179099	.	C	T	9	7	16	0	0	16	0	0
11	25179383	.	C	T	3	2	5	0	0	5	0	0
11	25179430	.	T	A	2	5	7	0	0	7	0	0
11	25179641	.	C	T	14	5	19	0	0	19	0	0
11	25179659	.	A	T	11	8	19	0	0	19	0	0
11	25180225	.	C	T	5	5	10	0	0	10	0	0
11	25180243	.	A	G	2	5	7	0	0	7	0	0
11	25260187	.	C	T	13	17	30	0	0	30	0	0
11	25261660	.	T	A	10	15	25	0	1	26	0	0
11	25265777	.	G	A	1	14	15	0	5	21	1	0
11	25265950	.	T	C	9	10	19	0	0	19	0	0
11	25302183	.	C	T	20	16	36	0	2	38	0	0
11	25303803	.	C	T	8	17	25	0	0	25	0	0
11	25303887	.	T	C	13	15	28	1	0	30	1	0
11	25306433	.	T	C	11	15	26	0	1	27	0	0
11	25307345	.	T	C	14	19	33	1	0	35	1	0
11	25310329	.	G	C	12	7	19	0	0	19	0	0
11	25310777	.	T	G	20	11	31	0	0	31	0	0
11	25310859	.	A	T	18	12	30	0	0	30	0	0
11	25313916	.	C	T	0	3	3	1	4	8	0	0
11	25314910	.	C	T	3	7	10	0	0	10	0	0
11	25317875	.	G	A	9	7	16	0	1	17	0	0
11	25318295	.	G	A	6	7	13	0	0	13	0	0
11	25335685	.	G	A	0	2	2	0	2	4	0	0
11	25403825	.	A	G	3	4	7	0	0	7	0	0
11	25403830	.	A	T	3	2	5	0	0	5	0	0
11	25405613	.	T	C	4	4	8	0	0	8	0	0
11	25405655	.	T	C	7	4	11	0	1	12	0	0
11	25405772	.	C	T	7	4	11	0	2	13	0	0
11	25405901	.	C	T	3	3	6	0	1	7	0	0
11	25405910	.	C	T	6	5	11	0	0	11	0	0
11	25406186	.	T	C	10	3	13	0	0	13	0	0
11	25406343	.	A	G	16	10	26	0	0	26	0	0
11	25406366	.	T	G	15	0	15	0	11	27	1	0
11	25406381	.	C	T	15	12	27	0	0	27	0	0
11	25406534	.	C	T	12	7	19	0	0	19	0	0
11	25407014	.	G	A	6	10	16	0	0	16	0	0
11	25407626	.	T	C	10	6	16	0	1	17	0	0
11	25407987	.	A	T	7	11	18	0	0	18	0	0
11	25408139	.	C	T	17	20	37	0	0	37	0	0
11	25408283	.	C	G	7	11	18	0	2	20	0	0
11	25408352	.	T	C	6	5	11	0	0	11	0	0
11	25436961	.	T	A	10	11	21	0	0	21	0	0
11	25437080	.	C	T	11	11	22	0	2	24	0	0
11	25437299	.	C	T	19	14	33	0	0	33	0	0
11	25437417	.	C	T	11	11	22	0	3	25	0	0
11	25437684	.	G	A	9	7	16	0	0	16	0	0
11	25437866	.	T	G	10	5	15	0	0	15	0	0
11	25437901	.	G	A	14	8	22	0	0	22	0	0
11	25439860	.	G	T	21	9	30	0	1	31	0	0
11	25440511	.	G	A	14	9	23	0	1	24	0	0
11	25440649	.	G	C	11	0	11	0	6	17	0	0
11	25441979	.	T	A	8	11	19	0	1	20	0	0
11	25442057	.	A	C	13	0	13	0	12	25	0	0
11	25442096	.	C	T	13	10	23	0	2	25	0	0
11	25442147	.	G	T	14	12	26	0	0	26	0	0
11	25442313	.	A	G	12	9	21	0	0	21	0	0
11	25442424	.	A	G	9	10	19	0	0	19	0	0
11	25442457	.	G	T	6	9	15	0	1	16	0	0
11	25447276	.	A	G	7	5	12	0	1	13	0	0
11	25447279	.	T	C	6	0	6	0	9	15	0	0
11	25449437	.	T	A	8	13	21	0	0	21	0	0
11	25449899	.	C	T	1	5	6	0	7	13	0	0
11	25450113	.	G	A	7	6	13	0	0	13	0	0
11	25450155	.	T	C	7	7	14	0	0	14	0	0
11	25453188	.	C	A	5	7	12	0	0	12	0	0
11	25453201	.	C	T	6	9	15	0	1	16	0	0
11	25453344	.	G	T	8	6	14	0	1	15	0	0
11	25453650	.	C	G	5	10	15	0	0	15	0	0
11	25453652	.	G	A	10	5	15	0	0	15	0	0
11	25456514	.	C	T	0	6	6	0	8	14	0	0
11	25459346	.	C	A	1	4	5	0	5	10	0	0
11	25510648	.	A	G	5	3	8	0	1	9	0	0
11	25512869	.	A	T	3	2	5	0	0	5	0	0
11	25517490	.	A	T	4	4	8	0	0	8	0	0
11	25517506	.	T	G	4	3	7	0	0	7	0	0
11	25539857	.	T	G	2	4	6	0	0	6	0	0
11	25539891	.	C	T	2	3	5	0	0	5	0	0
11	25540580	.	G	C	3	6	9	0	0	9	0	0
11	25540583	.	G	A	0	4	4	0	5	9	0	0
11	25542320	.	A	T	5	7	12	0	0	12	0	0
11	25542906	.	A	G	8	9	17	0	1	18	0	0
11	25548007	.	G	A	4	7	11	0	1	12	0	0
11	25548043	.	G	T	0	9	9	0	9	18	0	0
11	25560159	.	A	T	3	7	10	0	1	11	0	0
11	25565778	.	A	T	5	3	8	0	0	8	0	0
11	25565823	.	A	G	3	0	3	0	3	6	0	0
11	25565876	.	T	A	3	3	6	0	0	6	0	0
11	25565892	.	T	C	3	2	5	0	0	5	0	0
11	25570711	.	A	C	3	6	9	0	1	10	0	0
11	25573888	.	T	A	10	8	18	0	1	19	0	0
11	25573921	.	T	A	9	3	12	0	1	13	0	0
11	25575139	.	A	G	14	14	28	0	0	28	0	0
11	25575365	.	C	T	7	6	13	0	1	14	0	0
11	25575725	.	A	T	13	5	18	0	0	18	0	0
11	25575872	.	A	G	8	1	9	0	9	18	0	0
11	25583983	.	C	T	5	3	8	0	1	9	0	0
11	25616095	.	G	A	5	2	7	0	0	7	0	0
11	25617944	.	A	G	8	7	15	0	2	17	0	0
11	25618127	.	T	C	1	8	9	0	0	9	0	0
11	25618218	.	C	T	9	3	12	0	1	13	0	0
11	25618353	.	T	A	3	6	9	0	0	9	0	0
11	25618408	.	C	T	2	2	4	0	0	4	0	0
11	25620145	.	T	G	3	0	3	0	3	6	0	0
11	25629968	.	C	T	2	2	4	0	0	4	0	0
11	25630136	.	T	G	2	5	7	0	0	7	0	0
11	25630660	.	C	T	8	5	13	0	0	13	0	0
11	25631050	.	T	G	5	0	5	0	3	8	0	0
11	25631434	.	A	T	1	3	4	0	0	4	0	0
11	25631435	.	A	T	1	3	4	0	0	4	0	0
11	25655387	.	A	G	1	3	4	0	0	4	0	0
11	25655408	.	C	A	2	3	5	0	0	5	0	0
11	25663961	.	C	T	1	3	4	0	0	4	0	0
11	25668264	.	G	A	2	5	7	0	0	7	0	0
11	25668431	.	G	A	0	2	2	0	3	5	0	0
11	25678671	.	C	T	4	2	6	0	0	6	0	0
11	25678793	.	C	T	2	4	6	0	0	6	0	0
11	25678962	.	A	T	5	2	7	0	0	7	0	0
11	25678971	.	T	A	4	2	6	0	0	6	0	0
11	25679010	.	A	T	3	4	7	0	0	7	0	0
11	25681439	.	T	C	12	10	22	0	0	22	0	0
11	25681594	.	C	T	8	7	15	0	2	17	0	0
11	25681602	.	C	A	11	6	17	0	1	18	0	0
11	25681659	.	G	A	1	5	6	0	14	20	0	0
11	25681677	.	G	A	1	6	7	0	12	19	0	0
11	25681809	.	C	G	14	6	20	0	1	21	0	0
11	25681855	.	A	T	11	7	18	0	2	20	0	0
11	25681863	.	C	T	11	6	17	0	0	17	0	0
11	25684396	.	C	T	10	9	19	0	0	19	0	0
11	25686079	.	T	A	19	15	34	0	1	35	0	0
11	25689209	.	T	C	16	12	28	0	0	28	0	0
11	25689233	.	G	C	7	14	21	0	1	22	0	0
11	25689551	.	T	C	11	5	16	0	0	16	0	0
11	25689561	.	T	A	3	8	11	0	1	12	0	0
11	25693862	.	T	A	4	8	12	0	0	12	0	0
11	25695436	.	G	A	8	4	12	0	0	12	0	0
11	25695509	.	G	A	0	4	4	0	5	9	0	0
11	25695577	.	C	T	3	10	13	0	1	14	0	0
11	25695625	.	A	G	3	3	6	0	0	6	0	0
11	25695643	.	T	C	2	3	5	0	1	6	0	0
11	25695724	.	C	A	5	2	7	0	2	9	0	0
11	25695733	.	C	T	4	6	10	0	0	10	0	0
11	25695817	.	G	C	5	4	9	0	0	9	0	0
11	25698776	.	G	C	7	4	11	0	0	11	0	0
11	25698866	.	T	C	5	2	7	0	1	8	0	0
11	25698869	.	G	C	2	2	4	0	4	8	0	0
11	25698917	.	C	T	3	3	6	0	1	7	0	0
11	25698951	.	C	T	5	7	12	0	0	12	0	0
11	25699406	.	G	A	3	7	10	0	8	18	0	0
11	25699505	.	C	A	12	6	18	0	0	18	0	0
11	25702397	.	C	T	9	6	15	0	2	17	0	0
11	25705225	.	C	T	7	10	17	0	0	17	0	0
11	25713028	.	A	G	6	3	9	0	1	10	0	0
11	25713124	.	T	A	8	4	12	0	0	12	0	0
11	25713361	.	T	A	9	6	15	0	1	16	0	0
11	25713362	.	T	A	9	6	15	0	1	16	0	0
11	25713526	.	A	G	6	9	15	0	1	16	0	0
11	25713683	.	G	A	12	10	22	0	0	22	0	0
11	25713913	.	T	C	2	12	14	0	0	14	0	0
11	25714148	.	G	A	13	5	18	0	0	18	0	0
11	25714425	.	G	T	10	10	20	0	1	21	0	0
11	25714441	.	C	A	6	11	17	0	1	18	0	0
11	25718194	.	C	T	6	14	20	0	1	21	0	0
11	25718438	.	T	G	14	11	25	0	1	26	0	0
11	25721865	.	C	T	11	13	24	0	0	24	0	0
11	25729190	.	G	T	5	8	13	0	1	14	0	0
11	25730281	.	G	A	7	8	15	0	1	16	0	0
11	25730282	.	A	T	7	9	16	0	0	16	0	0
11	25743158	.	C	T	3	2	5	0	0	5	0	0
11	25743414	.	G	A	5	2	7	0	0	7	0	0
11	25749826	.	A	C	8	10	18	0	0	18	0	0
11	25749873	.	T	A	16	11	27	1	0	28	0	0
11	25750003	.	G	A	2	2	4	0	0	4	0	0
11	25750008	.	A	G	2	2	4	0	0	4	0	0
11	25783118	.	C	T	3	5	8	0	6	14	0	0
11	25783432	.	G	A	9	9	18	0	0	18	0	0
11	25783704	.	C	T	15	14	29	0	3	32	0	0
11	25789211	.	C	G	4	6	10	0	0	10	0	0
11	25791044	.	C	A	0	2	2	0	7	9	0	0
11	25791065	.	A	T	6	4	10	0	0	10	0	0
11	25893627	.	C	T	14	15	29	0	1	30	0	0
11	25893943	.	A	G	17	16	33	0	2	35	0	0
11	25894003	.	T	C	20	20	40	0	0	40	0	0
11	25944661	.	A	C	15	16	31	0	2	34	1	0
11	26180292	.	C	T	1	21	22	0	16	38	0	0
11	26180385	.	C	T	0	5	5	0	1	6	0	0
11	26180460	.	G	A	13	11	24	0	7	31	0	0
11	26190763	.	C	T	11	7	18	0	0	18	0	0
11	26191478	.	T	A	12	14	26	0	0	26	0	0
11	26191901	.	A	T	12	6	18	0	0	18	0	0
11	26193071	.	G	A	7	6	13	0	0	13	0	0
11	26193377	.	C	T	0	10	10	0	10	21	1	0
11	26193721	.	T	G	4	8	12	0	0	12	0	0
11	26194061	.	T	G	12	12	24	0	0	24	0	0
11	26194237	.	G	T	7	9	16	0	1	17	0	0
11	26194289	.	C	A	10	3	13	0	1	14	0	0
11	26195042	.	A	T	5	2	7	0	0	7	0	0
11	26195300	.	T	C	9	6	15	0	1	16	0	0
11	26229093	.	G	A	12	16	28	0	0	28	0	0
11	26229587	.	T	C	6	2	8	0	3	11	0	0
11	26229801	.	G	A	11	11	22	0	0	22	0	0
11	26229809	.	T	C	12	13	25	0	1	26	0	0
11	26229900	.	C	T	0	9	9	0	14	23	0	0
11	26230425	.	G	C	15	9	24	0	1	25	0	0
11	26230644	.	G	A	4	4	8	0	0	8	0	0
11	26230972	.	A	G	10	8	18	0	1	19	0	0
11	26231552	.	A	T	1	2	3	0	0	3	0	0
11	26231804	.	T	C	13	12	25	0	1	26	0	0
11	26231890	.	G	A	13	6	19	0	1	20	0	0
11	26231971	.	T	C	9	5	14	0	2	16	0	0
11	26232038	.	A	T	6	5	11	0	2	13	0	0
11	26232311	.	C	T	6	4	10	0	0	10	0	0
11	26232658	.	C	G	0	5	5	0	4	9	0	0
11	26232768	.	C	T	3	3	6	0	3	9	0	0
11	26233509	.	C	T	0	4	4	0	7	11	0	0
11	26233522	.	A	T	11	4	15	0	1	16	0	0
11	26311763	.	C	T	2	12	14	0	6	20	0	0
11	26367058	.	T	G	2	7	9	0	0	9	0	0
11	26367201	.	C	T	2	6	8	0	1	9	0	0
11	26369132	.	G	A	7	5	12	0	0	12	0	0
11	26369416	.	A	G	1	2	3	0	0	3	0	0
11	26371212	.	G	T	10	6	16	0	0	16	0	0
11	26371216	.	C	T	9	5	14	0	0	14	0	0
11	26372296	.	C	T	0	12	12	0	8	20	0	0
11	26373641	.	G	A	6	5	11	0	0	11	0	0
11	26373647	.	C	T	2	4	6	0	3	9	0	0
11	26373798	.	T	C	4	0	4	0	5	9	0	0
11	26373912	.	C	T	1	2	3	0	0	3	0	0
11	26373933	.	G	A	2	3	5	0	0	5	0	0
11	26374063	.	G	A	3	4	7	0	0	7	0	0
11	26374108	.	A	G	4	4	8	0	0	8	0	0
11	26380197	.	C	A	5	7	12	0	0	12	0	0
11	26380977	.	G	A	9	6	15	0	1	16	0	0
11	26381100	.	C	T	10	4	14	0	0	14	0	0
11	26381145	.	C	T	5	5	10	0	1	11	0	0
11	26381313	.	T	A	5	3	8	0	0	8	0	0
11	26381908	.	G	A	7	6	13	0	0	13	0	0
11	26382551	.	A	G	5	0	5	0	5	10	0	0
11	26382756	.	T	C	13	12	25	0	0	25	0	0
11	26383068	.	C	T	4	3	7	0	1	8	0	0
11	26383120	.	T	C	3	4	7	0	0	7	0	0
11	26397833	.	A	G	12	0	12	0	24	36	0	0
11	26398012	.	T	C	9	5	14	0	1	15	0	0
11	26398081	.	A	T	13	9	22	0	0	22	0	0
11	26400503	.	G	A	12	14	26	0	0	26	0	0
11	26400796	.	C	T	6	5	11	0	0	11	0	0
11	26400841	.	T	C	10	5	15	0	0	15	0	0
11	26400916	.	C	T	13	8	21	0	1	22	0	0
11	26401248	.	G	T	10	4	14	0	0	14	0	0
11	26401407	.	C	T	8	10	18	0	0	18	0	0
11	26401413	.	C	T	7	8	15	0	1	16	0	0
11	26505727	.	T	C	3	5	8	0	0	8	0	0
11	26532452	.	G	T	0	3	3	0	2	5	0	0
11	26537464	.	G	A	0	5	5	0	5	10	0	0
11	26540451	.	A	G	1	2	3	0	0	3	0	0
11	26540484	.	C	T	4	2	6	0	0	6	0	0
11	26540496	.	T	C	5	2	7	0	0	7	0	0
11	26545709	.	G	A	4	9	13	0	0	13	0	0
11	26545746	.	A	G	6	4	10	0	2	12	0	0
11	26545779	.	A	G	5	3	8	0	0	8	0	0
11	26550317	.	G	A	7	5	12	0	1	13	0	0
11	26561119	.	G	A	2	9	11	0	0	11	0	0
11	26561560	.	A	T	1	1	2	0	1	3	0	0
11	26562132	.	C	A	7	5	12	0	0	12	0	0
11	26562253	.	G	A	3	6	9	0	0	9	0	0
11	26562292	.	T	A	2	5	7	0	0	7	0	0
11	26562306	.	C	G	2	4	6	0	0	6	0	0
11	26562327	.	G	T	0	4	4	0	1	5	0	0
11	26610919	.	C	A	22	33	55	0	3	58	0	0
11	26614389	.	T	C	33	42	75	1	0	76	0	0
11	26614487	.	G	T	23	34	57	0	1	58	0	0
11	26614552	.	G	C	1	30	31	0	30	61	0	0
11	26614615	.	T	A	29	26	55	0	1	56	0	0
11	26614649	.	A	G	30	0	30	0	27	57	0	0
11	26615112	.	T	G	26	10	36	0	1	37	0	0
11	26615294	.	G	A	20	20	40	0	0	40	0	0
11	26683250	.	C	T	8	3	11	0	1	12	0	0
11	26683692	.	A	T	4	4	8	0	0	8	0	0
11	26686150	.	T	C	2	3	5	0	0	5	0	0
11	26686179	.	C	T	0	2	2	0	4	6	0	0
11	26686251	.	A	G	4	6	10	0	0	10	0	0
11	26695838	.	G	A	16	4	20	0	0	20	0	0
11	26695904	.	C	T	7	1	8	0	2	10	0	0
11	26698136	.	G	T	5	4	9	0	0	9	0	0
11	26699328	.	A	T	3	2	5	0	0	5	0	0
11	26704347	.	C	A	1	14	15	0	17	32	0	0
11	26705196	.	C	T	12	15	27	0	0	27	0	0
11	26705239	.	C	A	16	11	27	0	0	27	0	0
11	26705738	.	G	T	13	14	27	0	0	27	0	0
11	26705995	.	C	A	13	9	22	2	1	25	0	0
11	26706015	.	G	A	13	9	22	2	2	26	0	0
11	26706572	.	C	T	1	13	14	0	11	25	0	0
11	26706862	.	A	C	10	16	26	0	1	27	0	0
11	26707325	.	T	C	10	1	11	0	38	49	0	0
11	26707634	.	A	G	21	20	41	0	7	48	0	0
11	26707679	.	G	A	24	19	43	0	0	43	0	0
11	26707733	.	A	G	17	26	43	0	1	44	0	0
11	26715590	.	C	T	12	13	25	0	2	27	0	0
11	26722188	.	G	A	10	6	16	0	0	16	0	0
11	26722247	.	A	G	11	10	21	0	0	21	0	0
11	26739994	.	T	G	11	11	22	0	0	22	0	0
11	26740393	.	T	C	9	13	22	0	1	23	0	0
11	26740697	.	T	A	9	6	15	0	1	16	0	0
11	26740784	.	A	G	14	8	22	0	2	24	0	0
11	26961994	.	A	G	4	4	8	1	1	10	0	0
11	27136614	.	C	T	9	7	16	0	0	16	0	0
11	27143555	.	C	T	6	7	13	0	0	13	0	0
11	27143590	.	A	G	6	0	6	0	7	13	0	0
11	27195745	.	A	T	11	7	18	0	0	18	0	0
11	27197211	.	A	G	6	0	6	0	9	15	0	0
11	27486825	.	C	T	4	3	7	0	0	7	0	0
11	27487296	.	T	C	6	2	8	0	0	8	0	0
11	27487368	.	T	A	4	4	8	0	0	8	0	0
11	27487411	.	A	G	6	9	15	0	0	15	0	0
11	27487557	.	G	T	6	4	10	0	1	11	0	0
11	27487689	.	T	C	8	5	13	0	0	13	0	0
11	27487904	.	T	A	2	3	5	0	0	5	0	0
11	27488158	.	C	T	8	4	12	0	0	12	0	0
11	27488300	.	A	G	5	7	12	0	0	12	0	0
11	27488312	.	C	T	6	8	14	0	0	14	0	0
11	27488369	.	G	C	10	8	18	0	0	18	0	0
11	27488669	.	G	A	5	6	11	0	0	11	0	0
11	27495632	.	C	T	2	2	4	0	0	4	0	0
11	27500831	.	G	T	1	7	8	0	0	8	0	0
11	27516630	.	T	G	5	6	11	0	0	11	0	0
11	27516662	.	G	A	7	3	10	0	0	10	0	0
11	27516891	.	C	T	0	3	3	0	3	6	0	0
11	27517115	.	G	A	3	7	10	0	0	10	0	0
11	27517122	.	T	G	3	8	11	0	0	11	0	0
11	27517168	.	T	C	6	4	10	0	1	11	0	0
11	27517238	.	C	T	1	9	10	0	4	14	0	0
11	27517296	.	T	C	7	8	15	0	0	15	0	0
11	27517728	.	C	T	7	6	13	0	0	13	0	0
11	27517734	.	G	C	7	0	7	0	5	12	0	0
11	27517776	.	G	T	4	3	7	0	0	7	0	0
11	27526278	.	A	G	8	2	10	0	1	11	0	0
11	27644826	.	A	G	11	8	19	0	1	20	0	0
11	27644922	.	G	A	7	8	15	0	1	16	0	0
11	27645742	.	T	A	5	6	11	0	0	11	0	0
11	27645871	.	G	A	3	3	6	0	0	6	0	0
11	27646063	.	T	A	3	7	10	0	0	10	0	0
11	27646172	.	T	C	6	5	11	2	0	13	0	0
11	27646210	.	G	C	10	9	19	1	0	20	0	0
11	27646298	.	A	G	12	13	25	0	0	25	0	0
11	27649527	.	G	A	24	26	50	1	0	51	0	0
11	27655732	.	A	G	14	17	31	0	1	32	0	0
11	27655774	.	C	T	1	20	21	0	15	36	0	0
11	27661241	.	C	T	2	13	15	0	12	27	0	0
11	27668314	.	A	G	14	11	25	0	1	26	0	0
11	27669744	.	G	C	8	11	19	0	0	19	0	0
11	27671163	.	C	T	10	9	19	0	1	20	0	0
11	27671251	.	G	A	12	9	21	0	2	24	1	0
11	27673289	.	C	T	14	8	22	0	4	26	0	0
11	27677815	.	C	T	2	9	11	0	15	26	0	0
11	27677939	.	T	G	10	10	20	1	0	21	0	0
11	27677948	.	G	A	10	12	22	1	0	23	0	0
11	27705165	.	G	A	2	11	13	0	0	13	0	0
11	27705215	.	T	A	4	10	14	0	0	14	0	0
11	27705219	.	G	T	6	9	15	0	0	15	0	0
11	27705308	.	G	A	15	10	25	0	1	26	0	0
11	27705960	.	G	A	12	8	20	0	1	21	0	0
11	27706308	.	G	A	7	5	12	0	1	13	0	0
11	27706434	.	T	A	6	4	10	0	0	10	0	0
11	27706441	.	T	C	7	0	7	0	5	12	0	0
11	27706741	.	T	A	8	6	14	0	1	15	0	0
11	27706742	.	A	C	7	6	13	0	2	15	0	0
11	27708665	.	A	C	10	11	21	0	0	21	0	0
11	27710381	.	G	T	5	5	10	0	0	10	0	0
11	27713556	.	G	T	12	7	19	1	0	20	0	0
11	27719203	.	A	G	12	7	19	0	0	19	0	0
11	27719350	.	G	T	13	10	23	0	0	23	0	0
11	27719956	.	G	T	10	5	15	0	0	15	0	0
11	27725145	.	T	G	4	11	15	0	2	17	0	0
11	27727592	.	G	A	12	9	21	0	0	21	0	0
11	27727631	.	A	G	7	9	16	0	0	16	0	0
11	27738118	.	A	G	13	10	23	0	1	24	0	0
11	27738331	.	A	G	2	7	9	0	1	10	0	0
11	27738569	.	G	C	9	4	13	0	2	15	0	0
11	27743683	.	G	A	2	2	4	0	1	5	0	0
11	27745839	.	A	T	1	2	3	0	0	3	0	0
11	27750751	.	A	G	1	2	3	0	0	3	0	0
11	27750766	.	A	G	2	2	4	0	0	4	0	0
11	27817706	.	T	A	1	1	2	0	1	3	0	0
11	27817767	.	G	A	3	5	8	1	0	9	0	0
11	27818236	.	A	C	12	9	21	0	1	22	0	0
11	27818239	.	T	C	13	8	21	0	1	22	0	0
11	27818343	.	G	C	8	10	18	0	0	18	0	0
11	27818393	.	C	G	4	2	6	0	1	7	0	0
11	27820431	.	T	G	7	11	18	0	1	19	0	0
11	27820992	.	C	T	0	6	6	0	6	12	0	0
11	27827057	.	A	T	1	4	5	0	0	5	0	0
11	27828919	.	A	T	6	5	11	0	2	13	0	0
11	27829402	.	A	G	6	4	10	0	1	11	0	0
11	27829702	.	T	C	18	14	32	0	0	32	0	0
11	27829772	.	G	A	14	10	24	0	1	25	0	0
11	27829928	.	G	A	15	14	29	0	1	30	0	0
11	27835073	.	T	C	7	11	18	0	0	18	0	0
11	27835372	.	C	A	7	11	18	0	0	18	0	0
11	27836045	.	T	C	14	10	24	0	0	24	0	0
11	27840160	.	A	G	14	12	26	0	1	27	0	0
11	27845701	.	A	G	9	10	19	0	1	20	0	0
11	27857373	.	C	T	9	8	17	0	3	20	0	0
11	27867140	.	T	G	5	8	13	0	0	13	0	0
11	27874042	.	T	C	13	1	14	0	7	21	0	0
11	27896518	.	C	T	1	14	15	0	15	30	0	0
11	27989380	.	G	A	0	4	4	0	5	9	0	0
11	27994100	.	C	T	4	2	6	0	0	6	0	0
11	27994962	.	T	C	3	4	7	0	0	7	0	0
11	28005245	.	C	T	3	5	8	0	0	9	1	0
11	28005535	.	C	T	9	6	15	0	1	16	0	0
11	28107926	.	T	C	1	1	2	0	1	3	0	0
11	28107951	.	T	A	2	1	3	0	1	4	0	0
11	28109480	.	A	T	1	4	5	0	0	5	0	0
11	28109913	.	A	G	1	3	4	0	0	4	0	0
11	28110081	.	C	A	3	1	4	0	1	5	0	0
11	28110132	.	T	G	3	0	3	0	2	5	0	0
11	28110135	.	C	A	3	2	5	0	0	5	0	0
11	28110207	.	T	G	1	2	3	0	0	3	0	0
11	28110275	.	A	G	3	2	5	0	0	5	0	0
11	28110276	.	A	G	3	2	5	0	0	5	0	0
11	28110342	.	A	G	3	2	5	0	0	5	0	0
11	28122476	.	A	G	0	4	4	0	1	5	0	0
11	28123028	.	T	G	3	3	6	0	0	6	0	0
11	28123088	.	T	G	2	0	2	0	3	5	0	0
11	28123139	.	T	G	3	3	6	0	0	6	0	0
11	28123141	.	C	T	4	3	7	0	0	7	0	0
11	28123186	.	T	C	4	3	7	0	0	7	0	0
11	28123298	.	T	C	2	2	4	0	0	4	0	0
11	28123448	.	C	G	3	5	8	1	0	9	0	0
11	28124010	.	C	G	2	3	5	0	0	5	0	0
11	28124132	.	C	A	1	1	2	0	1	3	0	0
11	28124161	.	G	C	1	3	4	0	0	4	0	0
11	28124217	.	G	A	0	2	2	0	5	7	0	0
11	28124598	.	G	C	2	2	4	0	0	4	0	0
11	28310675	.	T	C	3	7	10	0	1	11	0	0
11	28310756	.	T	C	2	7	9	0	0	9	0	0
11	28310987	.	C	T	4	2	6	0	1	7	0	0
11	28311194	.	A	G	6	0	6	0	3	9	0	0
11	28362294	.	A	C	10	3	13	0	1	14	0	0
11	28366617	.	T	A	4	3	7	0	1	8	0	0
11	28394468	.	A	G	7	4	11	0	0	11	0	0
11	28396869	.	A	T	1	2	3	0	0	3	0	0
11	28400163	.	C	T	6	7	13	0	0	13	0	0
11	28404161	.	G	A	8	8	16	0	0	16	0	0
11	28409862	.	T	C	5	7	12	0	2	14	0	0
11	28409976	.	G	A	1	4	5	0	6	11	0	0
11	28410154	.	C	T	8	5	13	0	0	13	0	0
11	28410157	.	T	C	8	4	12	0	1	13	0	0
11	28412858	.	C	T	7	5	12	0	0	12	0	0
11	28412868	.	A	C	5	4	9	0	0	9	0	0
11	28419255	.	A	G	4	1	5	0	5	10	0	0
11	28419753	.	C	T	10	9	19	0	0	19	0	0
11	28419948	.	C	T	8	7	15	0	0	15	0	0
11	28420051	.	A	G	5	0	5	0	5	10	0	0
11	28420264	.	T	G	6	1	7	0	8	15	0	0
11	28420600	.	G	A	1	5	6	0	3	9	0	0
11	28420602	.	T	C	3	4	7	0	2	9	0	0
11	28420880	.	T	C	2	6	8	0	0	8	0	0
11	28421115	.	T	G	9	7	16	0	0	16	0	0
11	28421234	.	A	G	7	0	7	0	6	13	0	0
11	28422071	.	G	A	4	2	6	0	0	6	0	0
11	28422273	.	C	T	7	6	13	0	3	16	0	0
11	28422542	.	A	G	6	9	15	0	0	15	0	0
11	28422892	.	C	A	8	2	10	0	0	10	0	0
11	28423137	.	A	G	3	0	3	0	10	13	0	0
11	28423147	.	T	A	5	10	15	0	0	15	0	0
11	28423325	.	C	T	10	6	16	0	0	16	0	0
11	28423457	.	T	C	11	4	15	0	1	16	0	0
11	28423497	.	G	T	12	6	18	0	1	19	0	0
11	28423628	.	A	T	14	7	21	0	0	21	0	0
11	28477137	.	C	T	8	6	14	0	1	15	0	0
11	28477338	.	T	C	10	14	24	0	1	25	0	0
11	28477697	.	T	C	5	6	11	0	1	12	0	0
11	28477720	.	T	A	2	6	8	0	0	8	0	0
11	28478026	.	T	C	3	11	14	0	0	14	0	0
11	28513792	.	A	G	3	11	14	0	1	15	0	0
11	28513960	.	T	C	6	11	17	0	0	17	0	0
11	28514053	.	G	A	7	8	15	0	1	16	0	0
11	28514089	.	T	C	7	6	13	0	2	15	0	0
11	28514307	.	T	G	5	11	16	0	0	16	0	0
11	28514747	.	A	T	6	3	9	0	1	10	0	0
11	28614120	.	C	T	0	4	4	0	3	7	0	0
11	28643141	.	G	A	23	22	45	0	1	46	0	0
11	28643281	.	A	T	24	21	45	0	3	48	0	0
11	28643890	.	G	C	20	13	33	0	1	34	0	0
11	28644087	.	A	C	22	20	42	0	3	45	0	0
11	28644110	.	T	C	19	1	20	0	22	42	0	0
11	28661028	.	A	G	16	31	47	0	1	48	0	0
11	28789260	.	C	T	21	18	39	0	2	41	0	0
11	28808965	.	G	A	15	14	29	0	1	30	0	0
11	29331532	.	A	G	2	3	5	0	0	5	0	0
11	29331609	.	T	C	4	6	10	0	1	11	0	0
11	29331695	.	A	G	8	7	15	0	0	15	0	0
11	29331854	.	T	C	5	5	10	0	0	10	0	0
11	29332113	.	T	G	6	4	10	0	0	10	0	0
11	29332357	.	A	G	4	5	9	0	1	10	0	0
11	29332454	.	C	A	5	5	10	0	0	10	0	0
11	29332591	.	G	A	7	4	11	0	1	12	0	0
11	29332652	.	A	T	5	5	10	0	0	10	0	0
11	29332662	.	T	G	4	5	9	0	0	9	0	0
11	29332761	.	C	A	6	2	8	0	0	8	0	0
11	29333807	.	A	G	2	2	4	0	0	4	0	0
11	29333878	.	T	C	4	3	7	0	0	7	0	0
11	29334137	.	A	T	0	3	3	0	1	4	0	0
11	29335597	.	T	G	1	2	3	0	0	3	0	0
11	29335648	.	G	A	4	5	9	0	0	9	0	0
11	29575390	.	G	A	13	14	27	0	4	31	0	0
11	29575429	.	G	T	18	16	34	0	3	37	0	0
11	29575527	.	C	T	20	20	40	0	2	42	0	0
11	29575897	.	C	T	18	16	34	0	0	34	0	0
11	29576344	.	T	A	5	6	11	0	1	12	0	0
11	29576958	.	T	C	3	2	5	0	0	5	0	0
11	29577107	.	G	A	8	12	20	0	2	22	0	0
11	29577163	.	C	T	17	12	29	0	2	31	0	0
11	29577431	.	T	C	6	6	12	0	0	12	0	0
11	29577481	.	T	A	3	6	9	0	0	9	0	0
11	29577566	.	C	T	8	19	27	0	0	27	0	0
11	29577598	.	T	C	7	1	8	0	19	27	0	0
11	29577970	.	T	C	8	7	15	0	0	15	0	0
11	29577979	.	T	A	7	7	14	0	2	16	0	0
11	29578070	.	C	T	1	11	12	0	17	29	0	0
11	29578133	.	T	C	15	0	15	0	13	28	0	0
11	29578139	.	A	G	15	14	29	0	0	29	0	0
11	29578265	.	G	A	18	9	27	0	1	28	0	0
11	29581774	.	T	C	11	0	11	1	14	26	0	0
11	29581828	.	A	G	16	8	24	1	0	25	0	0
11	29587885	.	A	G	22	10	32	0	1	33	0	0
11	29587927	.	T	C	17	11	28	0	1	29	0	0
11	29588525	.	G	A	22	11	33	0	0	33	0	0
11	29589199	.	T	C	20	13	33	0	2	35	0	0
11	29589370	.	C	T	19	11	30	0	2	32	0	0
11	29589512	.	T	G	14	20	34	0	0	34	0	0
11	29589578	.	T	C	10	0	10	0	14	24	0	0
11	29589602	.	T	A	13	13	26	0	0	26	0	0
11	29593372	.	T	C	13	9	22	0	0	22	0	0
11	29596227	.	A	G	7	13	20	0	1	21	0	0
11	29601936	.	T	C	19	9	28	0	0	28	0	0
11	29602407	.	T	A	10	9	19	1	1	21	0	0
11	29607633	.	A	G	9	5	14	0	2	16	0	0
11	29609844	.	G	A	9	7	16	0	0	17	1	0
11	29614074	.	T	C	8	0	8	0	8	16	0	0
11	29614086	.	T	C	8	12	20	0	0	20	0	0
11	29617672	.	G	A	12	7	19	0	0	19	0	0
11	29623647	.	T	C	10	11	21	0	2	23	0	0
11	29624186	.	T	C	11	0	11	0	12	23	0	0
11	29626180	.	G	A	10	8	18	0	1	19	0	0
11	29637556	.	T	C	7	10	17	0	1	18	0	0
11	29685445	.	T	C	2	10	12	0	0	12	0	0
11	29757258	.	T	C	8	4	12	0	0	12	0	0
11	29757636	.	A	C	18	8	26	0	0	26	0	0
11	29760548	.	C	T	0	18	18	0	10	28	0	0
11	29762946	.	G	A	9	18	27	0	3	30	0	0
11	29764554	.	A	G	13	16	29	0	0	29	0	0
11	29771521	.	A	G	7	5	12	0	0	12	0	0
11	29771602	.	A	G	2	4	6	0	0	6	0	0
11	29771632	.	A	G	2	4	6	0	1	7	0	0
11	29776479	.	A	G	3	3	6	0	0	6	0	0
11	29781081	.	G	T	1	4	5	0	3	8	0	0
11	29781082	.	T	C	4	4	8	0	0	8	0	0
11	29781528	.	T	C	8	3	11	0	0	11	0	0
11	29784212	.	A	G	1	3	4	0	0	4	0	0
11	29784239	.	C	T	3	2	5	0	0	5	0	0
11	29784287	.	C	T	4	3	7	0	0	7	0	0
11	29784951	.	A	C	5	5	10	0	0	10	0	0
11	29785019	.	C	T	5	4	9	0	0	9	0	0
11	29785034	.	G	A	3	4	7	0	0	7	0	0
11	29785388	.	C	T	1	4	5	1	0	6	0	0
11	29785434	.	A	G	1	3	4	0	0	4	0	0
11	29785586	.	T	A	5	4	9	0	0	9	0	0
11	29785694	.	T	G	6	7	13	0	0	13	0	0
11	29785731	.	A	G	5	3	8	0	2	10	0	0
11	29785844	.	C	G	7	8	15	0	0	15	0	0
11	29785942	.	C	G	7	3	10	0	1	11	0	0
11	29786398	.	G	A	5	7	12	0	0	12	0	0
11	29786401	.	T	C	6	7	13	0	0	13	0	0
11	29786459	.	C	T	7	5	12	0	0	12	0	0
11	29788042	.	G	A	9	9	18	0	1	19	0	0
11	29789405	.	A	C	9	6	15	0	0	15	0	0
11	29789776	.	T	A	4	4	8	0	0	8	0	0
11	29790631	.	A	G	4	0	4	0	5	9	0	0
11	29791911	.	C	A	20	24	44	0	0	44	0	0
11	29793694	.	A	C	11	10	21	0	0	21	0	0
11	29793726	.	C	A	10	12	22	0	0	22	0	0
11	29794009	.	A	G	16	18	34	0	2	36	0	0
11	29795555	.	G	T	1	3	4	0	0	4	0	0
11	29795584	.	A	G	1	4	5	0	0	5	0	0
11	29795601	.	C	T	2	4	6	0	1	7	0	0
11	29796270	.	A	C	7	0	7	0	5	12	0	0
11	29796650	.	T	G	1	3	4	0	0	4	0	0
11	29803049	.	C	G	1	4	5	0	0	5	0	0
11	29815351	.	A	G	5	8	13	0	0	13	0	0
11	29816109	.	G	A	1	2	3	0	0	3	0	0
11	29816126	.	T	G	1	3	4	0	0	4	0	0
11	29818196	.	T	A	4	1	5	0	1	6	0	0
11	29818213	.	T	C	3	2	5	0	0	5	0	0
11	29818464	.	T	A	5	2	7	0	0	7	0	0
11	29818491	.	C	A	3	3	6	0	0	6	0	0
11	29863872	.	A	T	5	3	8	0	0	8	0	0
11	29876865	.	C	T	9	4	13	0	1	14	0	0
11	29876974	.	C	A	7	5	12	0	0	12	0	0
11	29877077	.	A	G	5	4	9	0	0	9	0	0
11	29917966	.	G	T	3	2	5	0	0	5	0	0
11	29918069	.	T	C	3	4	7	0	2	9	0	0
11	29918070	.	T	C	2	7	9	0	0	9	0	0
11	29918168	.	T	C	3	8	11	0	0	11	0	0
11	29918294	.	G	T	4	6	10	0	0	10	0	0
11	29918306	.	A	G	3	8	11	0	0	11	0	0
11	29936156	.	G	A	4	3	7	0	0	7	0	0
11	29936168	.	T	C	5	2	7	0	0	7	0	0
11	29936453	.	T	C	5	0	5	0	4	9	0	0
11	29936461	.	A	G	4	5	9	0	1	10	0	0
11	30001081	.	A	C	6	7	13	0	0	13	0	0
11	30082218	.	A	G	7	0	7	0	3	10	0	0
11	30082769	.	G	A	5	9	14	0	0	14	0	0
11	30083525	.	A	G	6	4	10	0	0	10	0	0
11	30083603	.	C	A	4	6	10	0	3	13	0	0
11	30083795	.	C	T	8	10	18	0	0	18	0	0
11	30084212	.	C	T	4	5	9	0	1	10	0	0
11	30086845	.	A	C	6	7	13	0	2	15	0	0
11	30087007	.	C	T	6	11	17	0	0	17	0	0
11	30087147	.	T	G	3	1	4	0	8	12	0	0
11	30087271	.	A	G	4	4	8	0	2	10	0	0
11	30087274	.	T	C	4	3	7	0	2	9	0	0
11	30087312	.	A	T	5	5	10	0	0	10	0	0
11	30087429	.	G	A	11	7	18	0	0	18	0	0
11	30087756	.	A	T	8	5	13	0	0	13	0	0
11	30087885	.	C	T	6	8	14	0	0	14	0	0
11	30088392	.	A	T	12	7	19	0	0	19	0	0
11	30088427	.	G	A	9	3	12	0	0	12	0	0
11	30088560	.	G	T	9	11	20	0	0	20	0	0
11	30089649	.	A	G	12	9	21	0	0	21	0	0
11	30089671	.	G	A	10	4	14	0	1	15	0	0
11	30106790	.	A	C	6	2	8	0	0	8	0	0
11	30107224	.	G	T	5	2	7	0	1	8	0	0
11	30107299	.	T	G	5	7	12	0	0	12	0	0
11	30107366	.	A	G	3	4	7	0	0	7	0	0
11	30107405	.	T	C	6	10	16	0	0	16	0	0
11	30107417	.	C	T	7	9	16	0	0	16	0	0
11	30113047	.	C	T	0	2	2	0	7	9	0	0
11	30118871	.	T	C	8	0	8	0	7	15	0	0
11	30118970	.	A	G	8	8	16	0	2	18	0	0
11	30122741	.	G	A	2	7	9	0	0	9	0	0
11	30123439	.	G	A	9	4	13	0	0	13	0	0
11	30147877	.	G	A	8	4	12	0	0	12	0	0
11	30148024	.	G	A	6	2	8	0	0	8	0	0
11	30149880	.	A	G	7	4	11	0	0	11	0	0
11	30153891	.	C	T	0	3	3	0	2	5	0	0
11	30201723	.	A	G	6	6	12	0	1	13	0	0
11	30205713	.	C	T	12	8	20	0	0	20	0	0
11	30222912	.	T	C	14	16	30	0	0	30	0	0
11	30222963	.	G	A	3	15	18	0	20	38	0	0
11	30231104	.	C	T	27	20	47	2	1	50	0	0
11	30231269	.	A	G	23	20	43	0	3	46	0	0
11	30231416	.	T	A	19	17	36	0	3	39	0	0
11	30258167	.	T	G	4	4	8	0	0	8	0	0
11	30264067	.	C	T	6	2	8	0	0	8	0	0
11	30367071	.	C	A	4	2	6	0	0	6	0	0
11	30367192	.	T	A	1	2	3	0	1	4	0	0
11	30640954	.	A	G	1	3	4	0	0	4	0	0
11	30642164	.	A	G	5	4	9	0	0	9	0	0
11	30946960	.	A	G	9	3	12	0	0	12	0	0
11	31024887	.	A	G	10	5	15	0	1	16	0	0
11	31380501	.	A	G	6	2	8	0	0	8	0	0
11	31558251	.	G	A	0	10	10	0	11	21	0	0
11	31558634	.	C	A	15	13	28	0	0	28	0	0
11	31558782	.	C	T	8	5	13	0	2	15	0	0
11	31602828	.	G	T	15	7	22	0	0	22	0	0
11	31603346	.	G	A	1	6	7	0	7	14	0	0
11	31620889	.	C	A	1	1	2	0	1	3	0	0
11	31621018	.	T	C	1	2	3	0	0	3	0	0
11	31621074	.	G	A	0	2	2	0	2	4	0	0
11	31647283	.	A	C	8	12	20	0	1	21	0	0
11	31649781	.	G	A	0	22	22	0	13	35	0	0
11	31653670	.	T	G	9	1	10	0	12	22	0	0
11	31653700	.	T	C	9	9	18	0	1	19	0	0
11	31664070	.	T	C	13	17	30	0	1	31	0	0
11	31664108	.	T	C	12	12	24	0	1	25	0	0
11	31667490	.	C	A	11	10	21	0	0	21	0	0
11	31667592	.	C	T	17	24	41	0	2	43	0	0
11	31667658	.	C	T	14	24	38	0	1	39	0	0
11	31667946	.	G	A	11	17	28	0	0	28	0	0
11	31668186	.	A	G	4	7	11	0	1	18	6	0
11	31668191	.	A	T	3	8	11	0	0	17	6	0
11	31668330	.	C	A	10	13	23	0	1	24	0	0
11	31668394	.	T	G	7	12	19	0	0	19	0	0
11	31668540	.	T	A	4	4	8	0	0	8	0	0
11	31668824	.	T	A	10	8	18	2	1	21	0	0
11	31668849	.	A	T	5	6	11	4	0	15	0	0
11	31668893	.	T	C	2	4	6	2	0	8	0	0
11	31668964	.	G	C	3	4	7	0	1	8	0	0
11	31670216	.	A	T	6	16	22	0	1	23	0	0
11	31670534	.	T	C	2	8	10	0	0	10	0	0
11	31670605	.	T	A	3	4	7	0	0	7	0	0
11	31670610	.	A	T	3	5	8	0	0	8	0	0
11	31670789	.	C	T	11	7	18	0	1	19	0	0
11	31670808	.	C	A	15	7	22	0	0	22	0	0
11	31670830	.	T	C	13	7	20	0	1	21	0	0
11	31670868	.	T	C	13	4	17	0	1	18	0	0
11	31670881	.	T	A	12	4	16	0	0	16	0	0
11	31670920	.	G	A	1	4	5	0	13	18	0	0
11	31670935	.	G	A	14	4	18	0	0	18	0	0
11	31670959	.	G	T	10	2	12	0	0	12	0	0
11	31671165	.	G	C	4	5	9	0	0	9	0	0
11	31671189	.	A	G	4	5	9	0	0	9	0	0
11	31671326	.	G	T	0	9	9	0	5	14	0	0
11	31671328	.	T	G	5	9	14	0	0	14	0	0
11	32576695	.	C	T	10	9	19	0	4	23	0	0
11	32577076	.	T	A	6	5	11	0	1	12	0	0
11	32577258	.	C	T	2	14	16	0	11	27	0	0
11	32577404	.	A	G	26	18	44	0	2	46	0	0
11	32577439	.	G	A	21	16	37	0	3	40	0	0
11	32577800	.	G	A	22	15	37	0	1	38	0	0
11	32577830	.	G	A	26	17	43	0	0	43	0	0
11	32578082	.	C	T	22	16	38	0	1	39	0	0
11	32578172	.	G	A	23	18	41	0	0	41	0	0
11	32720124	.	C	T	27	18	45	0	1	46	0	0
11	32720427	.	A	T	24	9	33	0	1	34	0	0
11	32720505	.	C	T	9	16	25	0	3	28	0	0
11	32720730	.	C	G	9	15	24	0	0	24	0	0
11	32720856	.	A	G	18	9	27	0	0	27	0	0
11	32721057	.	T	A	11	11	22	0	3	25	0	0
11	32721144	.	A	G	16	18	34	0	0	34	0	0
11	32721168	.	A	G	17	15	32	0	0	32	0	0
11	32721333	.	A	G	12	18	30	0	1	31	0	0
11	32721492	.	A	C	9	0	9	0	16	25	0	0
11	32721498	.	T	G	8	16	24	0	1	25	0	0
11	32721765	.	A	G	7	9	16	0	1	17	0	0
11	32721843	.	G	A	13	13	26	0	0	27	1	0
11	32722547	.	A	G	13	8	21	0	0	21	0	0
11	32723520	.	G	A	9	10	19	0	1	20	0	0
11	32723691	.	C	T	10	13	23	0	1	24	0	0
11	33426583	.	C	T	4	2	6	0	1	7	0	0
11	33426645	.	G	T	0	3	3	0	5	8	0	0
11	33426728	.	A	G	2	0	2	0	4	6	0	0
11	33509405	.	G	A	6	3	9	0	0	9	0	0
11	33509414	.	T	G	6	2	8	0	0	8	0	0
11	33514693	.	T	G	5	2	7	0	0	7	0	0
11	33517742	.	T	C	3	3	6	0	0	6	0	0
11	33530170	.	T	C	3	6	9	0	0	9	0	0
11	33530220	.	A	G	2	8	10	0	3	14	1	0
11	33532289	.	A	G	6	4	10	0	0	10	0	0
11	33537289	.	G	T	1	3	4	0	1	5	0	0
11	33537327	.	A	G	1	3	4	0	0	4	0	0
11	33537435	.	C	T	3	4	7	0	1	8	0	0
11	33539693	.	T	C	3	5	8	0	0	8	0	0
11	33545056	.	A	T	2	5	7	0	0	7	0	0
11	33551200	.	T	C	13	10	23	0	2	25	0	0
11	33553873	.	T	C	12	8	20	0	1	21	0	0
11	33554087	.	G	A	6	10	16	0	1	17	0	0
11	33554116	.	G	A	5	13	18	0	0	18	0	0
11	33554535	.	T	C	4	9	13	0	0	13	0	0
11	33599038	.	T	C	2	8	10	0	0	10	0	0
11	33599148	.	T	C	8	14	22	0	0	22	0	0
11	33599187	.	T	C	11	0	11	0	13	24	0	0
11	33599223	.	A	G	17	8	25	0	0	25	0	0
11	33599240	.	A	T	16	8	24	0	0	24	0	0
11	33599464	.	C	T	0	7	7	0	8	15	0	0
11	33599900	.	C	T	0	4	4	0	6	10	0	0
11	33599938	.	T	C	4	1	5	0	0	5	0	0
11	33599947	.	C	G	5	2	7	0	0	7	0	0
11	33600015	.	G	A	7	4	11	0	0	11	0	0
11	33600174	.	G	A	19	8	27	0	1	28	0	0
11	33600215	.	A	G	28	11	39	0	0	39	0	0
11	33600551	.	C	A	3	2	5	0	0	5	0	0
11	33600572	.	T	A	3	4	7	0	0	7	0	0
11	33600646	.	T	C	6	0	6	0	4	10	0	0
11	33600862	.	G	A	4	2	6	0	0	6	0	0
11	33600918	.	C	A	2	3	5	0	1	6	0	0
11	33605227	.	A	G	5	6	11	0	1	12	0	0
11	33607096	.	A	G	5	5	10	0	0	10	0	0
11	33699032	.	C	G	0	2	2	0	1	3	0	0
11	33751572	.	A	G	1	2	3	0	1	4	0	0
11	33760460	.	A	G	3	2	5	0	0	5	0	0
11	33763007	.	C	T	3	5	8	0	1	9	0	0
11	33764754	.	T	C	1	4	5	0	0	5	0	0
11	33767093	.	A	G	2	0	2	0	3	5	0	0
11	33772552	.	C	T	2	8	10	0	1	11	0	0
11	33827023	.	G	A	4	11	15	0	0	15	0	0
11	33829443	.	A	G	4	8	12	0	0	12	0	0
11	33829515	.	A	G	6	12	18	0	0	18	0	0
11	33832679	.	C	T	5	16	21	0	0	21	0	0
11	33834700	.	A	G	10	11	21	0	1	22	0	0
11	33835385	.	C	A	8	8	16	0	1	17	0	0
11	33835542	.	T	C	13	8	21	0	0	21	0	0
11	33839169	.	C	T	8	20	28	0	4	32	0	0
11	33841788	.	C	T	17	14	31	0	0	31	0	0
11	33841984	.	C	T	10	11	21	0	0	21	0	0
11	33842542	.	C	T	6	6	12	0	0	12	0	0
11	33846497	.	T	C	12	4	16	0	0	16	0	0
11	33846519	.	T	C	8	7	15	0	1	16	0	0
11	33846566	.	T	C	4	5	9	0	1	10	0	0
11	33846729	.	T	C	3	0	3	0	3	6	0	0
11	33847080	.	T	G	3	8	11	0	1	12	0	0
11	33847123	.	C	T	8	4	12	0	0	12	0	0
11	33847293	.	G	A	7	7	14	0	0	14	0	0
11	33855666	.	G	A	6	5	11	0	0	11	0	0
11	33857576	.	A	C	1	6	7	0	0	7	0	0
11	33857580	.	G	A	0	6	6	0	0	6	0	0
11	33857833	.	T	C	11	13	24	0	0	24	0	0
11	33870464	.	A	T	3	3	6	0	0	6	0	0
11	33870573	.	C	T	4	3	7	0	0	7	0	0
11	33870576	.	C	T	4	3	7	0	0	7	0	0
11	33871043	.	T	G	1	2	3	0	0	3	0	0
11	33871343	.	G	T	6	4	10	0	0	11	1	0
11	33871358	.	G	T	10	3	13	0	0	13	0	0
11	33871378	.	G	T	13	7	20	0	0	20	0	0
11	33871466	.	A	G	20	8	28	0	0	28	0	0
11	33871575	.	A	G	24	16	40	0	2	42	0	0
11	33871897	.	C	T	21	8	29	0	1	30	0	0
11	33871931	.	G	C	21	5	26	0	1	27	0	0
11	33871932	.	C	A	22	6	28	0	0	28	0	0
11	33872029	.	C	T	1	5	6	0	12	18	0	0
11	33872038	.	G	C	6	0	6	1	14	21	0	0
11	33872289	.	T	C	11	0	11	0	10	21	0	0
11	33872411	.	A	C	7	9	16	0	1	17	0	0
11	33872442	.	A	G	9	6	15	0	1	16	0	0
11	33872564	.	G	T	13	8	21	1	1	23	0	0
11	33872661	.	A	G	5	4	9	0	1	10	0	0
11	33872684	.	C	T	8	6	14	0	0	14	0	0
11	33872699	.	A	G	7	4	11	0	1	12	0	0
11	33872759	.	A	G	7	3	10	0	2	12	0	0
11	33872763	.	A	C	7	4	11	0	0	11	0	0
11	33872829	.	C	T	1	10	11	0	10	21	0	0
11	33873578	.	A	C	19	11	30	0	0	30	0	0
11	33880086	.	A	G	15	7	22	0	1	23	0	0
11	33880089	.	C	T	2	8	10	0	13	23	0	0
11	33887086	.	C	T	0	6	6	0	4	10	0	0
11	33888884	.	G	A	13	6	19	0	0	19	0	0
11	33891817	.	A	G	10	5	15	0	0	15	0	0
11	33900231	.	G	C	7	3	10	0	0	10	0	0
11	33900436	.	G	C	7	6	13	0	0	13	0	0
11	33902072	.	T	C	5	2	7	0	0	7	0	0
11	33902247	.	T	A	6	2	8	0	0	8	0	0
11	33902283	.	C	A	6	6	12	0	0	12	0	0
11	33912573	.	T	C	8	6	14	0	0	14	0	0
11	33912597	.	C	A	10	7	17	0	1	18	0	0
11	33912645	.	T	G	11	5	16	0	0	16	0	0
11	33997884	.	T	A	2	3	5	0	0	5	0	0
11	33998436	.	A	T	2	1	3	0	2	5	0	0
11	33998475	.	G	C	2	2	4	0	0	4	0	0
11	33998890	.	T	A	1	2	3	0	0	3	0	0
11	34158307	.	T	A	2	2	4	0	0	4	0	0
11	34158346	.	T	C	1	2	3	0	0	3	0	0
11	34220083	.	G	A	0	3	3	0	3	6	0	0
11	34220129	.	C	T	2	7	9	0	0	9	0	0
11	34220436	.	T	C	8	0	8	0	5	13	0	0
11	34228108	.	G	A	3	3	6	0	0	6	0	0
11	34230594	.	G	T	7	2	9	0	0	9	0	0
11	34231302	.	G	A	9	5	14	0	0	14	0	0
11	34235427	.	C	A	13	13	26	0	0	26	0	0
11	34235498	.	C	G	5	7	12	0	0	12	0	0
11	34235528	.	T	C	6	9	15	0	0	15	0	0
11	34235825	.	A	T	14	13	27	0	0	27	0	0
11	34235858	.	A	C	13	10	23	0	0	23	0	0
11	34235918	.	A	G	13	2	15	0	12	27	0	0
11	34236092	.	G	T	11	11	22	0	1	23	0	0
11	34237150	.	C	T	3	7	10	0	0	10	0	0
11	34237632	.	G	T	1	1	2	0	1	3	0	0
11	34911188	.	A	G	4	3	7	0	0	7	0	0
11	34911191	.	A	G	5	2	7	0	0	7	0	0
11	34911229	.	G	A	6	16	22	1	0	23	0	0
11	35438612	.	A	C	9	8	17	0	3	20	0	0
11	36046521	.	T	A	1	3	4	0	0	4	0	0
11	36046523	.	A	C	1	3	4	0	0	4	0	0
11	36146021	.	C	T	1	4	5	0	0	5	0	0
11	36158316	.	A	C	0	2	2	0	1	3	0	0
11	36158379	.	A	C	8	11	19	0	0	19	0	0
11	36158839	.	G	T	6	5	11	0	2	13	0	0
11	36180612	.	C	T	10	11	21	0	0	21	0	0
11	36180666	.	C	T	8	3	11	0	0	11	0	0
11	36180774	.	A	G	9	7	16	0	0	16	0	0
11	36180775	.	T	C	9	6	15	0	1	16	0	0
11	36180831	.	G	T	2	8	10	0	14	24	0	0
11	36180876	.	C	A	17	10	27	0	1	28	0	0
11	36205992	.	C	T	7	10	17	0	0	17	0	0
11	36206090	.	C	T	6	11	17	0	0	17	0	0
11	36208199	.	G	A	15	7	22	0	1	23	0	0
11	36208328	.	G	A	1	10	11	0	12	23	0	0
11	36214517	.	C	T	23	18	41	0	2	43	0	0
11	36214815	.	G	A	1	15	16	0	16	32	0	0
11	36214859	.	C	T	13	14	27	0	1	28	0	0
11	36214955	.	A	T	17	6	23	0	1	24	0	0
11	36215346	.	G	A	15	10	25	0	0	25	0	0
11	36215399	.	A	G	11	11	22	0	0	22	0	0
11	36218548	.	G	C	2	4	6	0	0	6	0	0
11	36224767	.	G	A	3	4	7	0	0	7	0	0
11	36224780	.	T	C	3	0	3	0	3	6	0	0
11	36224833	.	C	T	2	3	5	0	0	5	0	0
11	36228124	.	G	A	1	5	6	0	1	7	0	0
11	36230101	.	G	A	3	3	6	0	0	6	0	0
11	36236950	.	G	A	1	5	6	0	6	12	0	0
11	36237094	.	C	T	1	5	6	0	1	7	0	0
11	36237148	.	C	G	4	2	6	0	0	6	0	0
11	36237421	.	T	C	6	2	8	0	0	8	0	0
11	36237601	.	A	C	1	2	3	0	0	3	0	0
11	36269682	.	G	A	7	10	17	0	2	19	0	0
11	36269768	.	A	G	14	11	25	0	1	26	0	0
11	36269788	.	A	G	17	12	29	0	4	33	0	0
11	36281939	.	T	G	6	7	13	0	1	14	0	0
11	36281943	.	G	A	4	9	13	0	2	15	0	0
11	36282417	.	G	T	6	6	12	0	0	12	0	0
11	36282450	.	G	T	4	4	8	0	2	10	0	0
11	36283728	.	A	G	7	11	18	0	0	18	0	0
11	36291207	.	G	A	3	6	9	0	0	9	0	0
11	36291208	.	T	C	2	6	8	0	0	8	0	0
11	36340801	.	C	T	5	2	7	0	1	8	0	0
11	36340961	.	A	G	5	6	11	0	0	11	0	0
11	36340991	.	T	C	4	3	7	0	0	7	0	0
11	36343167	.	G	C	17	10	27	0	1	28	0	0
11	36343339	.	A	T	19	11	30	0	1	31	0	0
11	36346578	.	A	T	8	13	21	0	1	22	0	0
11	36369242	.	C	G	4	3	7	0	0	7	0	0
11	36372590	.	A	G	1	3	4	0	0	5	1	0
11	36372690	.	G	A	4	4	8	0	1	9	0	0
11	36372937	.	A	G	2	5	7	0	0	7	0	0
11	36372961	.	G	A	2	5	7	0	0	7	0	0
11	36373059	.	C	T	1	3	4	0	0	4	0	0
11	36373148	.	A	T	4	2	6	0	0	6	0	0
11	36373355	.	C	T	3	2	5	1	0	8	2	0
11	36373430	.	G	A	1	6	7	0	0	7	0	0
11	36373459	.	A	T	1	7	8	0	0	8	0	0
11	36373504	.	C	G	1	0	1	0	2	3	0	0
11	36373738	.	T	C	7	6	13	0	0	13	0	0
11	36373746	.	T	C	8	5	13	1	0	14	0	0
11	36374559	.	G	A	1	3	4	0	0	4	0	0
11	36374944	.	T	G	3	8	11	0	0	11	0	0
11	36374958	.	T	C	3	6	9	0	1	10	0	0
11	36374993	.	G	T	4	5	9	0	1	10	0	0
11	36375028	.	A	G	2	0	2	0	7	9	0	0
11	36375120	.	T	G	4	5	9	0	0	9	0	0
11	36375293	.	G	A	9	3	12	1	1	14	0	0
11	36375367	.	T	C	4	5	9	0	0	9	0	0
11	36375671	.	C	T	3	11	14	0	0	14	0	0
11	36375708	.	A	G	4	13	17	0	0	17	0	0
11	36375774	.	A	T	6	7	13	0	0	13	0	0
11	36375852	.	T	G	6	4	10	0	0	10	0	0
11	36388483	.	T	C	3	3	6	0	0	6	0	0
11	36388511	.	A	C	4	2	6	0	0	6	0	0
11	36393111	.	A	G	4	0	4	0	5	9	0	0
11	36393150	.	T	A	3	4	7	0	1	8	0	0
11	36395136	.	A	T	4	3	7	0	1	8	0	0
11	36395728	.	T	C	7	3	10	1	0	11	0	0
11	36398192	.	G	A	0	5	5	0	3	8	0	0
11	36398318	.	A	G	4	4	8	0	2	10	0	0
11	36398531	.	A	G	5	0	5	0	9	14	0	0
11	36398558	.	T	A	3	7	10	0	0	10	0	0
11	36398624	.	C	T	6	4	10	0	0	10	0	0
11	36422295	.	G	T	2	2	4	0	0	4	0	0
11	36434733	.	C	G	1	3	4	0	0	4	0	0
11	36452372	.	G	A	1	3	4	0	0	4	0	0
11	36452453	.	C	A	2	2	4	0	0	4	0	0
11	36452534	.	C	A	4	2	6	0	0	6	0	0
11	36452688	.	A	G	12	3	15	0	0	15	0	0
11	36456011	.	C	T	1	4	5	0	1	6	0	0
11	36456101	.	T	A	5	9	14	0	0	14	0	0
11	36456125	.	A	C	4	0	4	0	11	15	0	0
11	36460829	.	G	A	12	11	23	0	1	24	0	0
11	36460988	.	A	G	7	8	15	0	0	15	0	0
11	36463965	.	T	C	8	6	14	0	0	14	0	0
11	36464541	.	T	A	5	5	10	0	0	10	0	0
11	36464565	.	G	C	5	4	9	0	0	9	0	0
11	36467942	.	G	A	8	4	12	0	0	12	0	0
11	36467948	.	C	T	4	10	14	0	0	14	0	0
11	36468047	.	G	A	5	9	14	0	1	15	0	0
11	36470493	.	C	T	1	3	4	0	9	13	0	0
11	36470651	.	G	A	5	7	12	0	0	12	0	0
11	36473924	.	G	A	3	4	7	0	1	8	0	0
11	36477626	.	G	A	3	8	11	0	0	11	0	0
11	36477777	.	C	T	7	3	10	0	2	12	0	0
11	36477803	.	C	T	7	9	16	0	0	16	0	0
11	36482269	.	A	G	2	4	6	0	1	7	0	0
11	36482311	.	C	T	8	5	13	0	1	14	0	0
11	36484836	.	G	A	8	3	11	0	0	11	0	0
11	36485042	.	A	G	4	0	4	0	4	8	0	0
11	36489169	.	G	C	7	4	11	0	1	12	0	0
11	36489205	.	T	C	4	10	14	0	0	14	0	0
11	36489706	.	T	C	1	5	6	0	0	6	0	0
11	36689425	.	T	C	5	3	8	0	0	8	0	0
11	36689486	.	A	G	4	5	9	0	0	9	0	0
11	36695094	.	A	G	2	2	4	0	0	4	0	0
11	36712859	.	C	A	4	2	6	0	0	6	0	0
11	36712878	.	G	T	5	1	6	0	1	7	0	0
11	36742718	.	C	T	0	2	2	0	2	4	0	0
11	36765485	.	A	C	2	0	2	0	4	6	0	0
11	36788112	.	G	A	1	3	4	0	0	4	0	0
11	36793697	.	G	T	7	8	15	0	1	16	0	0
11	36793859	.	G	A	7	7	14	0	0	14	0	0
11	36795564	.	G	T	13	14	27	0	0	27	0	0
11	36797149	.	C	T	1	12	13	0	4	17	0	0
11	36801796	.	G	A	10	6	16	0	0	16	0	0
11	36806296	.	A	G	13	8	21	0	0	21	0	0
11	36816163	.	T	C	16	6	22	0	0	23	1	0
11	36816171	.	T	C	11	11	22	0	0	22	0	0
11	36818820	.	A	T	11	6	17	0	0	17	0	0
11	36819529	.	C	T	6	6	12	0	0	12	0	0
11	36819859	.	A	T	5	8	13	0	1	14	0	0
11	36819904	.	G	A	8	4	12	0	0	12	0	0
11	36822599	.	G	A	4	4	8	0	0	8	0	0
11	36995485	.	A	G	4	5	9	0	0	9	0	0
11	36995494	.	A	G	4	6	10	0	0	10	0	0
11	37001740	.	C	T	4	4	8	0	0	8	0	0
11	37002607	.	C	T	10	8	18	0	0	18	0	0
11	37002616	.	G	A	11	6	17	0	2	19	0	0
11	37004670	.	C	T	7	10	17	0	2	19	0	0
11	37015968	.	T	C	11	6	17	0	0	17	0	0
11	37020723	.	C	T	5	11	16	0	0	16	0	0
11	37031950	.	C	T	9	6	15	0	0	15	0	0
11	37032055	.	G	A	20	11	31	0	1	32	0	0
11	37032420	.	G	A	1	3	4	0	0	4	0	0
11	37032546	.	C	T	4	5	9	0	0	9	0	0
11	37032626	.	T	C	8	6	14	0	0	14	0	0
11	37032739	.	C	T	6	5	11	0	0	11	0	0
11	37032740	.	A	T	6	5	11	0	0	11	0	0
11	37032854	.	C	A	4	5	9	0	0	9	0	0
11	37033333	.	A	C	13	8	21	0	0	21	0	0
11	37033348	.	C	A	12	6	18	0	0	18	0	0
11	37033373	.	C	T	9	4	13	0	0	13	0	0
11	37033676	.	C	T	5	5	10	0	0	10	0	0
11	37033813	.	C	G	12	5	17	0	0	17	0	0
11	37033846	.	G	C	11	7	18	0	1	19	0	0
11	37033855	.	T	A	11	7	18	0	2	20	0	0
11	37035240	.	T	A	3	7	10	0	3	13	0	0
11	37035454	.	A	G	13	0	13	0	19	32	0	0
11	37049469	.	A	T	7	6	13	1	0	14	0	0
11	37049545	.	G	A	5	3	8	0	0	8	0	0
11	37070236	.	C	T	1	3	4	0	1	5	0	0
11	37074779	.	G	A	2	6	8	1	0	9	0	0
11	37080550	.	C	T	5	11	16	0	0	16	0	0
11	37080614	.	T	C	4	3	7	0	1	8	0	0
11	37080971	.	G	T	6	7	13	0	0	13	0	0
11	37081040	.	T	G	7	0	7	0	6	13	0	0
11	37081058	.	T	C	6	2	8	0	1	9	0	0
11	37081112	.	A	G	5	5	10	0	0	10	0	0
11	37081142	.	A	G	3	0	3	0	4	7	0	0
11	37084157	.	T	C	5	9	14	0	1	15	0	0
11	37096571	.	T	A	2	2	4	0	0	4	0	0
11	37101045	.	G	A	2	2	4	0	0	4	0	0
11	37101236	.	T	C	1	3	4	0	0	4	0	0
11	37101270	.	A	C	1	3	4	0	0	4	0	0
11	37101408	.	G	A	3	1	4	0	0	4	0	0
11	37101426	.	G	A	3	2	5	0	0	5	0	0
11	37109432	.	C	T	4	3	7	0	0	7	0	0
11	37120881	.	T	C	2	4	6	0	0	6	0	0
11	37137676	.	G	T	3	6	9	0	0	9	0	0
11	37137762	.	A	T	6	4	10	0	1	11	0	0
11	37137768	.	A	G	6	5	11	0	0	11	0	0
11	37137829	.	A	T	8	4	12	0	1	13	0	0
11	37144633	.	C	A	11	12	23	0	0	23	0	0
11	37144704	.	C	T	10	7	17	0	1	18	0	0
11	37144864	.	C	T	3	5	8	0	0	8	0	0
11	37152069	.	G	A	3	7	10	0	0	10	0	0
11	37152126	.	C	A	4	2	6	0	2	8	0	0
11	37152410	.	T	G	9	0	9	0	5	14	0	0
11	37153439	.	A	T	5	12	17	0	0	17	0	0
11	37153681	.	C	T	5	9	14	0	0	14	0	0
11	37153687	.	T	C	6	8	14	0	0	14	0	0
11	37155247	.	A	T	13	6	19	0	3	22	0	0
11	37155353	.	A	G	9	0	9	0	12	21	0	0
11	37155394	.	A	G	9	12	21	0	1	22	0	0
11	37155400	.	T	A	15	11	26	0	1	27	0	0
11	37158818	.	T	C	20	17	37	0	3	40	0	0
11	37159490	.	C	T	11	12	23	0	0	23	0	0
11	37159902	.	G	A	13	4	17	0	0	17	0	0
11	37159994	.	T	A	12	0	12	0	0	12	0	0
11	37161822	.	G	A	1	7	8	0	11	19	0	0
11	37162310	.	A	G	7	11	18	0	0	18	0	0
11	37162529	.	G	A	14	12	26	0	0	26	0	0
11	37163874	.	A	G	8	7	15	0	0	15	0	0
11	37164191	.	G	C	9	12	21	0	1	22	0	0
11	37164510	.	T	C	6	16	22	0	3	25	0	0
11	37167289	.	A	G	7	13	20	0	0	20	0	0
11	37167402	.	A	G	14	0	14	0	7	21	0	0
11	37167669	.	C	T	19	12	31	0	0	31	0	0
11	37167991	.	T	C	11	5	16	0	2	18	0	0
11	37168147	.	T	C	10	9	19	0	0	19	0	0
11	37168162	.	T	A	10	8	18	0	1	19	0	0
11	37169108	.	A	G	13	17	30	0	2	32	0	0
11	37169144	.	G	A	10	21	31	0	1	32	0	0
11	37169269	.	G	A	19	13	32	0	2	34	0	0
11	37169931	.	T	C	1	2	3	0	0	3	0	0
11	37170045	.	G	C	4	3	7	0	0	7	0	0
11	37170409	.	A	G	26	1	27	0	15	42	0	0
11	37274727	.	A	T	2	3	5	0	0	5	0	0
11	37274768	.	C	A	1	2	3	0	0	3	0	0
11	37274829	.	G	A	1	2	3	0	0	3	0	0
11	37274839	.	G	A	2	2	4	0	0	4	0	0
11	37297811	.	A	T	18	22	40	0	0	41	1	0
11	37297951	.	T	C	19	16	35	0	0	35	0	0
11	37298028	.	T	A	9	15	24	0	3	27	0	0
11	37298718	.	G	A	9	11	20	0	0	20	0	0
11	37298796	.	G	A	17	8	25	0	0	25	0	0
11	37313177	.	C	T	8	7	15	0	12	27	0	0
11	37322273	.	G	T	4	3	7	0	0	7	0	0
11	37337444	.	G	A	6	6	12	0	0	12	0	0
11	37337450	.	C	G	1	6	7	0	6	13	0	0
11	37359387	.	C	T	0	3	3	0	2	5	0	0
11	37373093	.	G	A	5	6	11	0	0	11	0	0
11	37373105	.	C	T	4	5	9	0	1	10	0	0
11	37411007	.	C	G	6	5	11	0	0	11	0	0
11	37411070	.	G	A	5	3	8	0	1	9	0	0
11	37411522	.	G	T	2	6	8	0	0	8	0	0
11	37431722	.	C	T	1	3	4	0	0	4	0	0
11	37431953	.	C	T	31	19	50	0	1	51	0	0
11	37434255	.	T	G	17	13	30	1	1	32	0	0
11	37434259	.	T	G	18	13	31	1	1	33	0	0
11	37434618	.	C	T	27	19	46	0	0	46	0	0
11	37441257	.	T	G	25	26	51	0	1	52	0	0
11	37442557	.	G	A	16	18	34	0	1	35	0	0
11	37442772	.	G	T	13	16	29	0	0	29	0	0
11	37445084	.	G	A	20	23	43	0	1	44	0	0
11	37445680	.	C	T	18	11	29	0	3	32	0	0
11	37445825	.	G	A	14	15	29	0	1	30	0	0
11	37446107	.	G	A	9	8	17	0	0	17	0	0
11	37446173	.	T	A	9	13	22	0	3	25	0	0
11	37446224	.	G	C	14	0	14	0	13	27	0	0
11	37446700	.	C	T	17	16	33	0	1	34	0	0
11	37446736	.	C	G	15	20	35	0	0	35	0	0
11	37447634	.	C	T	1	5	6	0	14	20	0	0
11	37447754	.	C	T	2	13	15	0	12	27	0	0
11	37447925	.	T	G	11	14	25	0	0	25	0	0
11	37448264	.	G	A	16	15	31	0	3	34	0	0
11	37448396	.	T	C	10	19	29	0	1	30	0	0
11	37449089	.	C	T	2	16	18	0	5	23	0	0
11	37449098	.	G	T	17	5	22	0	1	23	0	0
11	37449415	.	T	A	10	7	17	0	3	20	0	0
11	37449599	.	C	T	11	19	30	0	0	30	0	0
11	37451040	.	C	T	0	9	9	0	6	15	0	0
11	37548471	.	C	T	7	6	13	0	3	16	0	0
11	37613577	.	G	A	26	24	50	0	1	51	0	0
11	37628230	.	C	T	35	33	68	0	2	70	0	0
11	37628595	.	T	C	21	15	36	0	1	37	0	0
11	37628816	.	T	C	23	14	37	0	1	38	0	0
11	37628831	.	C	T	29	12	41	0	1	42	0	0
11	37628863	.	T	A	29	11	40	0	1	41	0	0
11	37629046	.	G	A	20	20	40	0	4	44	0	0
11	37709031	.	A	C	10	4	14	0	0	14	0	0
11	37709033	.	A	G	9	4	13	0	1	14	0	0
11	37709133	.	G	A	3	8	11	0	0	11	0	0
11	37709303	.	C	A	10	14	24	0	0	24	0	0
11	37709334	.	T	C	7	9	16	0	4	20	0	0
11	37709450	.	T	C	12	0	12	0	6	18	0	0
11	37709475	.	C	A	12	4	16	0	1	17	0	0
11	37709542	.	T	C	5	5	10	0	0	10	0	0
11	37709545	.	G	A	5	5	10	0	0	10	0	0
11	37709677	.	A	G	9	4	13	0	0	13	0	0
11	37709940	.	T	A	4	3	7	0	0	7	0	0
11	37709943	.	C	A	2	3	5	0	1	6	0	0
11	37709998	.	A	C	1	2	3	0	0	3	0	0
11	37710026	.	T	A	1	2	3	0	0	3	0	0
11	37710164	.	G	A	4	4	8	1	0	9	0	0
11	37710172	.	C	T	1	4	5	1	4	10	0	0
11	37710272	.	G	A	4	4	8	0	2	10	0	0
11	37710328	.	T	A	4	3	7	0	0	7	0	0
11	37710333	.	T	C	4	3	7	0	0	7	0	0
11	37710630	.	C	T	2	4	6	0	0	6	0	0
11	37710631	.	T	A	2	4	6	0	0	6	0	0
11	37710680	.	A	G	8	3	11	0	0	11	0	0
11	37710709	.	T	C	8	0	8	0	6	14	0	0
11	37710960	.	A	G	8	7	15	0	0	15	0	0
11	37710962	.	A	G	10	7	17	0	0	17	0	0
11	37711005	.	G	A	4	5	9	0	1	10	0	0
11	37711498	.	G	A	5	7	12	0	0	12	0	0
11	37711507	.	A	G	4	6	10	0	0	10	0	0
11	37711540	.	T	C	5	5	10	0	0	10	0	0
11	37717543	.	C	T	0	10	10	0	4	14	0	0
11	37720622	.	C	A	19	16	35	0	2	37	0	0
11	37720658	.	G	A	24	22	46	0	0	46	0	0
11	37720671	.	A	G	20	17	37	0	0	37	0	0
11	37722445	.	G	A	24	11	35	0	3	38	0	0
11	37725854	.	C	T	14	10	24	0	2	26	0	0
11	37813639	.	G	A	2	2	4	0	0	4	0	0
11	37813659	.	A	G	3	0	3	0	2	5	0	0
11	37816436	.	A	G	7	2	9	0	1	10	0	0
11	37819039	.	G	T	4	5	9	0	0	9	0	0
11	37828480	.	G	A	1	2	3	0	1	4	0	0
11	37829168	.	A	C	2	5	7	0	0	7	0	0
11	37829325	.	C	T	2	4	6	0	0	6	0	0
11	37829642	.	T	C	5	4	9	0	0	9	0	0
11	37829740	.	C	T	2	3	5	0	0	5	0	0
11	37830219	.	C	G	1	3	4	0	0	4	0	0
11	37830353	.	A	G	1	3	4	0	0	4	0	0
11	37830531	.	G	A	0	2	2	0	2	4	0	0
11	37831082	.	T	G	2	2	4	0	0	4	0	0
11	37831111	.	A	C	2	4	6	0	0	6	0	0
11	37848872	.	C	T	6	4	10	0	0	10	0	0
11	37848961	.	G	A	7	3	10	0	1	11	0	0
11	37854049	.	A	G	6	2	8	0	0	8	0	0
11	37854394	.	T	G	1	5	6	0	0	6	0	0
11	37859678	.	C	A	0	1	1	0	3	4	0	0
11	37859693	.	C	A	2	2	4	0	1	5	0	0
11	37868492	.	G	A	3	3	6	0	0	6	0	0
11	37949533	.	G	A	1	2	3	0	0	3	0	0
11	38807987	.	C	T	11	11	22	0	0	22	0	0
11	38844445	.	G	C	17	24	41	0	0	41	0	0
11	38844481	.	T	C	20	14	34	0	1	35	0	0
11	38846017	.	G	A	1	7	8	0	12	20	0	0
11	38846152	.	G	A	4	4	8	0	0	8	0	0
11	38846316	.	T	A	19	10	29	0	0	29	0	0
11	38846361	.	G	A	17	8	25	0	0	25	0	0
11	38850244	.	G	A	0	10	10	0	9	19	0	0
11	38865710	.	A	G	13	24	37	0	1	38	0	0
11	38875221	.	A	G	18	15	33	0	1	34	0	0
11	38875283	.	A	T	20	19	39	0	1	40	0	0
11	38875352	.	G	A	21	19	40	0	1	41	0	0
11	38875397	.	T	G	24	15	39	0	1	40	0	0
11	38875484	.	A	C	15	12	27	0	0	27	0	0
11	38875660	.	T	C	16	15	31	0	1	32	0	0
11	38875867	.	T	C	6	9	15	0	1	16	0	0
11	39014283	.	A	G	1	2	3	0	0	3	0	0
11	39014284	.	A	C	1	2	3	0	0	3	0	0
11	39044412	.	T	C	13	10	23	0	1	24	0	0
11	39044541	.	G	C	15	14	29	0	1	30	0	0
11	39076002	.	T	A	6	3	9	0	0	9	0	0
11	39081018	.	C	T	1	3	4	0	0	4	0	0
11	39109555	.	C	T	7	6	13	0	1	14	0	0
11	39109968	.	C	T	12	7	19	0	0	19	0	0
11	39110046	.	C	T	7	4	11	0	0	11	0	0
11	39112035	.	A	G	7	8	15	0	0	15	0	0
11	39112168	.	A	G	3	5	8	0	0	8	0	0
11	39113067	.	G	T	2	4	6	0	0	6	0	0
11	39113143	.	A	G	7	4	11	0	0	11	0	0
11	39113410	.	C	T	0	4	4	0	2	6	0	0
11	39113423	.	C	G	2	5	7	0	1	8	0	0
11	39113449	.	G	T	2	2	4	0	3	7	0	0
11	39113986	.	C	T	1	2	3	0	0	3	0	0
11	39114164	.	C	G	5	5	10	0	0	10	0	0
11	39114195	.	C	A	5	2	7	0	1	8	0	0
11	39114421	.	G	A	1	2	3	0	0	3	0	0
11	39114853	.	G	T	2	2	4	0	0	4	0	0
11	39114922	.	G	A	1	3	4	0	1	5	0	0
11	39115034	.	G	A	2	3	5	0	1	6	0	0
11	39118639	.	G	A	1	5	6	0	0	6	0	0
11	39135160	.	T	A	35	20	55	0	1	56	0	0
11	39135834	.	C	G	29	24	53	0	1	54	0	0
11	39141536	.	A	C	21	24	45	0	0	45	0	0
11	39141732	.	T	G	7	12	19	0	1	20	0	0
11	39922713	.	A	C	19	16	35	0	1	36	0	0
11	39922714	.	A	C	17	18	35	0	1	36	0	0
11	39953921	.	C	T	12	4	16	0	4	20	0	0
11	40020386	.	A	G	2	3	5	0	2	7	0	0
11	40644440	.	G	T	3	6	9	0	1	10	0	0
11	40644458	.	A	G	4	4	8	0	0	8	0	0
11	40647099	.	T	C	4	0	4	0	6	10	0	0
11	40647123	.	A	C	3	4	7	0	1	8	0	0
11	40649417	.	G	A	3	3	6	0	0	6	0	0
11	40655819	.	T	C	12	16	28	0	5	33	0	0
11	40658079	.	A	C	15	19	34	0	0	34	0	0
11	40658091	.	A	T	14	13	27	0	2	29	0	0
11	40658154	.	C	G	19	1	20	0	13	33	0	0
11	40658232	.	C	T	14	11	25	0	2	27	0	0
11	40658352	.	G	A	1	5	6	0	9	15	0	0
11	40658455	.	T	C	8	9	17	0	1	18	0	0
11	40661378	.	T	C	10	12	22	0	0	22	0	0
11	40665545	.	T	C	12	21	33	1	1	35	0	0
11	40665602	.	G	T	1	22	23	1	18	42	0	0
11	40673797	.	C	T	11	13	24	0	0	24	0	0
11	40673877	.	A	G	10	15	25	0	0	25	0	0
11	40677891	.	A	T	25	21	46	0	1	48	1	0
11	40677967	.	T	C	32	16	48	0	1	49	0	0
11	40678385	.	T	G	34	33	67	0	3	70	0	0
11	40678445	.	A	C	27	1	28	1	35	64	0	0
11	40680890	.	A	G	37	26	63	0	1	64	0	0
11	40714749	.	C	T	0	2	2	0	1	3	0	0
11	40723176	.	C	T	1	2	3	0	0	3	0	0
11	40831754	.	A	G	11	0	11	0	6	17	0	0
11	40840238	.	T	C	12	8	20	0	0	20	0	0
11	40840407	.	T	C	11	7	18	0	0	18	0	0
11	40843208	.	T	C	10	13	23	0	3	26	0	0
11	40843814	.	T	C	10	13	23	0	0	23	0	0
11	40844085	.	T	G	8	3	11	0	0	11	0	0
11	40844094	.	C	T	5	4	9	0	1	10	0	0
11	40844162	.	T	C	6	5	11	0	0	11	0	0
11	40844195	.	A	T	7	4	11	0	2	14	1	0
11	40845117	.	T	C	2	9	11	0	5	16	0	0
11	40845515	.	T	C	4	3	7	0	0	7	0	0
11	41066190	.	T	G	15	0	15	0	20	35	0	0
11	41066765	.	T	G	10	8	18	0	0	18	0	0
11	41066871	.	C	T	12	14	26	0	0	26	0	0
11	41066888	.	C	T	11	14	25	0	1	26	0	0
11	41066950	.	A	G	13	14	27	0	2	29	0	0
11	41067275	.	G	A	5	11	16	0	1	17	0	0
11	41067430	.	A	T	2	8	10	0	1	11	0	0
11	41067442	.	C	T	2	9	11	0	0	11	0	0
11	41067488	.	A	C	2	10	12	0	0	12	0	0
11	41067502	.	G	A	1	8	9	0	1	10	0	0
11	41078522	.	C	A	6	3	9	0	0	9	0	0
11	41078578	.	A	T	11	5	16	0	0	16	0	0
11	41078762	.	A	T	14	17	31	0	0	31	0	0
11	41084325	.	T	G	24	12	36	0	1	37	0	0
11	41089631	.	G	T	10	4	14	0	0	14	0	0
11	41089641	.	T	C	12	5	17	0	0	17	0	0
11	41090478	.	A	C	5	8	13	0	0	13	0	0
11	41090479	.	A	C	5	8	13	0	0	13	0	0
11	41101666	.	A	G	10	10	20	0	1	21	0	0
11	41101760	.	A	T	5	6	11	0	0	11	0	0
11	41101800	.	T	A	6	4	10	0	0	10	0	0
11	41101866	.	C	T	4	8	12	0	2	14	0	0
11	41101910	.	G	A	5	9	14	0	1	15	0	0
11	41101918	.	C	T	4	12	16	0	0	16	0	0
11	41101948	.	A	G	5	1	6	0	9	15	0	0
11	41102013	.	A	G	8	0	8	0	6	14	0	0
11	41102026	.	T	C	8	3	11	0	1	12	0	0
11	41102205	.	A	G	9	6	15	0	1	16	0	0
11	41104549	.	A	G	10	5	15	0	0	15	0	0
11	41104934	.	G	A	8	9	17	0	0	17	0	0
11	41104954	.	C	T	10	12	22	0	0	22	0	0
11	41105030	.	G	A	1	7	8	0	7	15	0	0
11	41105144	.	T	G	4	0	4	0	10	14	0	0
11	41105210	.	G	A	0	2	2	0	4	6	0	0
11	41111301	.	A	G	9	12	21	0	0	21	0	0
11	41111334	.	T	C	8	11	19	0	1	20	0	0
11	41111370	.	C	T	5	8	13	0	0	13	0	0
11	41111422	.	A	G	4	8	12	0	1	13	0	0
11	41111431	.	A	C	4	8	12	0	0	12	0	0
11	41111561	.	T	A	3	2	5	0	0	5	0	0
11	41111603	.	T	A	4	2	6	0	0	6	0	0
11	41114055	.	C	T	1	3	4	0	3	7	0	0
11	41114090	.	G	T	2	3	5	0	0	5	0	0
11	41114186	.	A	C	4	6	10	0	0	10	0	0
11	41119769	.	A	G	7	6	13	0	0	13	0	0
11	41122665	.	T	C	4	1	5	0	12	17	0	0
11	41125040	.	A	G	2	7	9	0	0	9	0	0
11	41132195	.	A	G	11	14	25	0	0	25	0	0
11	41216395	.	A	G	4	10	14	0	0	14	0	0
11	41216413	.	C	A	4	11	15	0	1	16	0	0
11	41216455	.	T	C	3	0	3	0	11	14	0	0
11	41216505	.	G	C	2	13	15	0	0	15	0	0
11	41220596	.	G	A	11	11	22	0	0	22	0	0
11	41220613	.	C	T	2	11	13	0	12	25	0	0
11	41220683	.	T	A	10	10	20	0	0	20	0	0
11	41222940	.	A	G	17	11	28	0	0	28	0	0
11	41243315	.	A	T	3	4	7	1	0	8	0	0
11	41244604	.	T	G	7	8	15	0	0	15	0	0
11	41244709	.	G	A	1	10	11	0	10	21	0	0
11	41306035	.	G	A	0	7	7	0	6	13	0	0
11	41307691	.	T	C	16	17	33	0	1	34	0	0
11	41307733	.	A	G	11	12	23	0	5	28	0	0
11	41307844	.	T	C	9	16	25	0	1	26	0	0
11	41308307	.	A	T	1	2	3	0	0	3	0	0
11	41363778	.	G	A	0	11	11	0	8	19	0	0
11	41372906	.	G	T	1	9	10	0	5	15	0	0
11	41459981	.	G	C	3	29	32	0	23	55	0	0
11	41461417	.	C	G	28	25	53	0	0	53	0	0
11	41463534	.	C	G	20	26	46	1	2	49	0	0
11	41468791	.	C	T	18	26	44	1	1	46	0	0
11	41473980	.	G	T	9	7	16	0	0	16	0	0
11	41474041	.	T	A	6	6	12	0	1	13	0	0
11	41474042	.	G	T	6	6	12	0	1	13	0	0
11	41660756	.	G	A	0	10	10	0	3	13	0	0
11	41669291	.	C	T	4	6	10	0	1	11	0	0
11	41686121	.	A	G	5	0	5	0	7	12	0	0
11	41838873	.	G	A	5	7	12	0	3	15	0	0
11	41838878	.	G	C	5	9	14	0	1	15	0	0
11	41838930	.	T	A	6	5	11	0	0	11	0	0
11	41838933	.	C	A	5	5	10	0	0	10	0	0
11	41838991	.	T	G	5	0	5	0	11	16	0	0
11	41838999	.	G	T	5	8	13	0	0	13	0	0
11	41840493	.	T	C	5	9	14	0	1	15	0	0
11	41840601	.	A	T	7	7	14	0	1	15	0	0
11	41842313	.	C	T	11	6	17	0	0	18	1	0
11	41844192	.	C	A	10	9	19	0	0	19	0	0
11	41846057	.	G	C	1	2	3	0	0	3	0	0
11	41846699	.	C	T	10	3	13	0	0	13	0	0
11	41850058	.	A	G	7	5	12	0	1	13	0	0
11	42128561	.	G	A	4	2	6	0	0	6	0	0
11	42131413	.	T	C	6	0	6	0	6	12	0	0
11	42175030	.	T	C	1	0	1	0	2	3	0	0
11	42603999	.	A	G	4	3	7	0	0	7	0	0
11	42605462	.	T	C	4	3	7	0	1	8	0	0
11	42605646	.	T	C	6	6	12	0	1	13	0	0
11	42605688	.	G	C	5	5	10	0	1	11	0	0
11	42606923	.	C	T	6	7	13	0	0	13	0	0
11	42608394	.	T	C	6	4	10	0	3	13	0	0
11	42610466	.	C	T	8	10	18	0	0	18	0	0
11	42618675	.	A	G	13	0	13	0	8	21	0	0
11	42618720	.	A	G	10	7	17	0	0	17	0	0
11	42618726	.	C	T	9	7	16	0	2	18	0	0
11	42715280	.	A	G	1	0	1	0	3	4	0	0
11	42715577	.	A	G	2	2	4	0	0	4	0	0
11	42715614	.	C	T	2	3	5	0	0	5	0	0
11	42730657	.	A	G	20	17	37	0	0	37	0	0
11	42730895	.	C	T	19	13	32	0	1	33	0	0
11	42730974	.	T	G	25	0	25	0	9	34	0	0
11	42730982	.	T	C	23	8	31	0	1	32	0	0
11	42731172	.	G	T	21	17	38	0	0	38	0	0
11	42732358	.	T	C	21	12	33	0	1	34	0	0
11	42766053	.	A	G	9	4	13	0	0	13	0	0
11	42768175	.	G	C	5	5	10	0	0	10	0	0
11	42783922	.	G	A	2	6	8	0	10	18	0	0
11	42783955	.	G	C	7	4	11	0	0	11	0	0
11	42793640	.	T	A	4	4	8	0	0	8	0	0
11	42801508	.	T	A	8	10	18	0	0	18	0	0
11	42809031	.	C	G	5	11	16	0	0	16	0	0
11	42809115	.	T	C	5	9	14	0	0	14	0	0
11	42809233	.	A	G	8	3	11	0	1	12	0	0
11	42809438	.	G	C	7	5	12	5	0	17	0	0
11	42809558	.	A	G	5	6	11	0	1	12	0	0
11	42809578	.	A	T	4	6	10	0	0	10	0	0
11	42809717	.	G	A	1	5	6	0	5	11	0	0
11	42811938	.	G	A	0	6	6	0	4	10	0	0
11	42815261	.	G	A	6	5	11	0	0	11	0	0
11	42816352	.	C	G	3	13	16	0	1	17	0	0
11	42816496	.	A	G	9	6	15	0	0	15	0	0
11	42816617	.	G	T	6	3	9	0	0	9	0	0
11	42816719	.	T	C	3	2	5	0	0	5	0	0
11	42816720	.	T	C	2	2	4	0	1	5	0	0
11	42816765	.	C	A	2	3	5	0	0	5	0	0
11	42816803	.	T	A	4	4	8	0	0	8	0	0
11	42816815	.	T	C	6	5	11	0	0	11	0	0
11	42816841	.	G	T	7	3	10	0	0	10	0	0
11	42816859	.	C	T	7	3	10	0	0	10	0	0
11	42817257	.	T	A	2	6	8	0	1	9	0	0
11	42817359	.	A	T	3	4	7	0	0	8	1	0
11	42817598	.	A	G	2	2	4	0	8	12	0	0
11	42817604	.	G	T	2	8	10	0	1	11	0	0
11	42912164	.	C	T	0	3	3	0	1	4	0	0
11	42912784	.	A	G	8	4	12	0	0	12	0	0
11	42912791	.	G	A	8	4	12	0	0	12	0	0
11	42912837	.	T	A	3	4	7	0	0	7	0	0
11	42916055	.	T	C	1	2	3	0	0	3	0	0
11	42916130	.	T	C	1	3	4	0	0	4	0	0
11	42916373	.	G	A	5	3	8	0	1	9	0	0
11	42916577	.	A	T	2	2	4	0	0	4	0	0
11	42916595	.	G	A	1	4	5	0	0	5	0	0
11	42917357	.	G	T	3	3	6	0	0	6	0	0
11	42917366	.	G	A	2	3	5	0	0	5	0	0
11	42933696	.	A	G	5	6	11	0	1	12	0	0
11	42933703	.	T	C	6	4	10	0	2	12	0	0
11	42933780	.	G	A	8	6	14	0	0	14	0	0
11	42939803	.	T	C	9	6	15	0	0	15	0	0
11	42940748	.	C	T	5	5	10	0	0	10	0	0
11	42942921	.	C	T	1	8	9	0	3	12	0	0
11	42942930	.	G	A	5	7	12	0	0	12	0	0
11	43159295	.	T	C	22	0	22	0	35	57	0	0
11	43164302	.	G	T	27	21	48	0	1	49	0	0
11	43167677	.	A	T	38	25	63	0	2	65	0	0
11	43170792	.	A	C	32	0	32	0	22	54	0	0
11	43170804	.	G	A	29	23	52	0	2	54	0	0
11	43170924	.	A	G	29	24	53	0	2	55	0	0
11	43171230	.	T	A	19	18	37	0	1	38	0	0
11	43171281	.	A	G	20	22	42	0	2	44	0	0
11	43179006	.	G	C	21	26	47	0	0	47	0	0
11	43179639	.	G	A	24	21	45	0	0	45	0	0
11	43179651	.	A	G	21	20	41	0	0	41	0	0
11	43187495	.	T	C	26	20	46	0	3	49	0	0
11	43189275	.	T	G	24	25	49	0	2	51	0	0
11	43190846	.	G	A	21	18	39	0	1	40	0	0
11	43470332	.	T	C	12	8	20	0	0	20	0	0
11	43470337	.	T	C	16	7	23	0	1	24	0	0
11	43470525	.	T	C	4	2	6	0	0	6	0	0
11	43691890	.	C	G	2	3	5	0	0	5	0	0
11	43712332	.	C	T	2	2	4	0	0	4	0	0
11	43712665	.	G	A	1	2	3	0	0	3	0	0
11	44021999	.	T	G	5	6	11	0	1	12	0	0
11	44022321	.	G	A	3	5	8	0	0	8	0	0
11	44023935	.	C	T	4	4	8	0	0	8	0	0
11	44025903	.	T	A	4	7	11	0	0	11	0	0
11	44030913	.	G	T	2	4	6	0	3	9	0	0
11	44102035	.	C	T	3	2	5	0	0	5	0	0
11	44102040	.	C	T	3	2	5	0	0	5	0	0
11	44104132	.	T	C	5	0	5	0	4	9	0	0
11	44144749	.	A	C	13	12	25	2	0	27	0	0
11	44144820	.	A	G	19	12	31	0	0	31	0	0
11	44144958	.	T	G	27	24	51	0	1	52	0	0
11	44145001	.	T	A	33	25	58	0	2	61	1	0
11	44149701	.	T	C	19	0	19	0	21	40	0	0
11	44152750	.	A	G	26	25	51	0	0	51	0	0
11	44152795	.	T	C	25	29	54	0	1	55	0	0
11	44155422	.	G	A	16	13	29	10	2	41	0	0
11	44155479	.	T	C	12	1	13	1	24	38	0	0
11	44155485	.	T	C	18	1	19	0	20	39	0	0
11	44155583	.	T	C	19	20	39	0	2	41	0	0
11	44155640	.	C	A	15	21	36	0	0	36	0	0
11	44155703	.	C	A	13	25	38	0	1	39	0	0
11	44155706	.	C	T	1	11	12	0	27	39	0	0
11	44155766	.	G	T	21	17	38	0	1	39	0	0
11	44157872	.	C	T	16	20	36	1	1	38	0	0
11	44161525	.	A	G	20	16	36	0	3	39	0	0
11	44163064	.	G	T	21	23	44	0	2	46	0	0
11	44185469	.	C	T	1	2	3	0	0	3	0	0
11	44188312	.	G	A	1	3	4	0	0	4	0	0
11	44188320	.	T	A	1	3	4	0	0	4	0	0
11	44188374	.	G	A	1	2	3	0	0	3	0	0
11	44328905	.	A	G	10	27	37	0	4	41	0	0
11	44328956	.	T	C	24	15	39	0	1	40	0	0
11	44329050	.	A	G	15	15	30	0	3	33	0	0
11	44334935	.	T	A	20	20	40	0	0	40	0	0
11	44337494	.	T	A	1	2	3	0	0	3	0	0
11	44337497	.	A	G	1	2	3	0	0	3	0	0
11	44401057	.	C	A	9	10	19	0	1	20	0	0
11	44401275	.	G	A	8	11	19	0	1	20	0	0
11	44401437	.	G	A	12	11	23	0	0	23	0	0
11	44403378	.	C	G	8	8	16	0	0	16	0	0
11	44442425	.	C	T	10	13	23	0	0	23	0	0
11	44444661	.	C	G	7	6	13	0	0	13	0	0
11	44445314	.	A	G	6	2	8	0	0	8	0	0
11	44445316	.	T	G	6	2	8	0	0	8	0	0
11	44445500	.	G	A	9	5	14	0	1	15	0	0
11	44445554	.	A	G	9	9	18	0	0	18	0	0
11	44445561	.	C	T	11	8	19	0	0	19	0	0
11	44445733	.	A	G	14	0	14	0	8	22	0	0
11	44445736	.	C	T	13	8	21	0	0	21	0	0
11	44445778	.	C	T	11	10	21	0	1	22	0	0
11	44452790	.	T	C	11	0	11	0	9	20	0	0
11	44452797	.	C	T	0	8	8	0	12	20	0	0
11	44452849	.	G	A	15	8	23	0	0	23	0	0
11	44466598	.	T	C	1	2	3	20	0	23	0	0
11	44466931	.	T	C	8	5	13	0	0	13	0	0
11	44468838	.	G	A	7	10	17	0	0	17	0	0
11	44468842	.	T	C	4	12	16	0	1	17	0	0
11	44481079	.	A	C	7	0	7	0	7	14	0	0
11	44483622	.	G	T	5	5	10	0	1	11	0	0
11	44483647	.	G	T	2	3	5	0	1	6	0	0
11	44484460	.	A	G	2	3	5	0	0	5	0	0
11	44484497	.	T	C	3	3	6	0	1	7	0	0
11	44484548	.	A	G	2	2	4	0	0	4	0	0
11	44485675	.	T	G	7	5	12	0	0	12	0	0
11	44502515	.	T	G	3	7	10	0	0	10	0	0
11	44502554	.	C	T	4	5	9	0	0	9	0	0
11	44502592	.	G	A	6	5	11	0	1	12	0	0
11	44502630	.	T	A	6	6	12	0	0	12	0	0
11	44502660	.	C	T	6	6	12	0	0	12	0	0
11	44502770	.	G	A	1	2	3	0	5	8	0	0
11	44502778	.	G	C	4	0	4	0	3	8	1	0
11	44522002	.	C	G	7	9	16	0	0	16	0	0
11	44522119	.	C	T	7	9	16	0	0	16	0	0
11	44522158	.	G	T	3	6	9	0	0	9	0	0
11	44523229	.	C	T	2	3	5	1	0	6	0	0
11	44523348	.	A	G	7	3	10	0	0	10	0	0
11	44523385	.	C	A	5	7	12	0	0	12	0	0
11	44523420	.	C	A	8	5	13	0	0	13	0	0
11	44524164	.	A	G	1	0	1	0	5	6	0	0
11	44524391	.	G	A	7	5	12	0	0	12	0	0
11	44524423	.	T	G	11	8	19	0	1	20	0	0
11	44524448	.	G	A	1	9	10	0	8	18	0	0
11	44524583	.	T	C	5	2	7	0	1	8	0	0
11	44524631	.	T	C	5	5	10	0	0	10	0	0
11	44524673	.	T	C	3	7	10	0	0	10	0	0
11	44524834	.	G	T	0	5	5	0	6	11	0	0
11	44527025	.	T	C	4	3	7	0	0	7	0	0
11	44527053	.	G	A	7	3	10	0	0	10	0	0
11	44527087	.	G	T	8	10	18	0	0	18	0	0
11	44527115	.	T	A	9	16	25	0	2	27	0	0
11	44527134	.	G	C	11	17	28	0	2	30	0	0
11	44527183	.	T	C	19	1	20	0	7	27	0	0
11	44527367	.	G	A	23	15	38	0	0	38	0	0
11	44527744	.	G	A	14	8	22	0	1	23	0	0
11	44527909	.	A	C	31	8	39	7	0	46	0	0
11	44527911	.	G	A	28	7	35	7	4	46	0	0
11	44528307	.	C	T	17	12	29	0	3	32	0	0
11	44528311	.	C	T	3	13	16	0	17	34	1	0
11	44528351	.	A	C	15	16	31	0	0	31	0	0
11	44528405	.	G	A	18	12	30	1	1	32	0	0
11	44528481	.	A	G	20	18	38	0	0	38	0	0
11	44528539	.	A	G	18	12	30	0	0	30	0	0
11	44528694	.	A	G	9	13	22	0	0	22	0	0
11	44528877	.	A	T	12	31	43	0	0	43	0	0
11	44528927	.	G	T	23	10	33	0	1	34	0	0
11	44529149	.	G	A	5	5	10	0	0	10	0	0
11	44529193	.	T	C	3	10	13	0	0	13	0	0
11	44529195	.	T	A	10	3	13	0	0	13	0	0
11	44529719	.	G	A	19	24	43	0	3	46	0	0
11	44530262	.	T	C	11	1	12	0	20	32	0	0
11	44533253	.	T	C	12	1	13	0	21	34	0	0
11	44542958	.	T	A	12	10	22	0	1	23	0	0
11	44606861	.	C	T	8	11	19	0	0	19	0	0
11	44606883	.	G	C	8	8	16	0	0	16	0	0
11	44607291	.	T	A	11	10	21	0	2	23	0	0
11	44607303	.	A	T	10	10	20	0	2	22	0	0
11	44612357	.	A	G	5	10	15	1	1	17	0	0
11	44614918	.	G	A	9	5	14	1	0	15	0	0
11	44614945	.	C	G	0	7	7	1	6	14	0	0
11	44614960	.	C	T	5	3	8	1	0	9	0	0
11	44617110	.	T	G	5	7	12	0	0	12	0	0
11	44622565	.	G	A	5	5	10	0	0	10	0	0
11	44622594	.	C	T	2	3	5	0	0	5	0	0
11	44628707	.	G	A	0	4	4	0	8	12	0	0
11	44632351	.	A	G	7	5	12	0	0	12	0	0
11	44634802	.	A	C	7	3	10	0	1	11	0	0
11	44634828	.	C	A	9	6	15	0	0	15	0	0
11	44634888	.	A	G	3	1	4	0	0	4	0	0
11	44637569	.	T	A	5	5	10	0	0	10	0	0
11	44637704	.	C	T	3	13	16	0	13	29	0	0
11	44637714	.	T	C	19	0	19	0	13	32	0	0
11	44637802	.	G	A	18	10	28	0	2	30	0	0
11	44637950	.	A	G	26	27	53	1	0	54	0	0
11	44637953	.	G	T	28	24	52	1	2	55	0	0
11	44638006	.	G	A	37	23	60	1	2	63	0	0
11	44643882	.	C	T	27	19	46	0	2	48	0	0
11	44723130	.	C	G	20	17	37	0	0	37	0	0
11	44723353	.	G	A	2	24	26	0	24	50	0	0
11	44723500	.	C	T	22	20	42	0	2	44	0	0
11	44723746	.	A	G	23	20	43	0	4	47	0	0
11	44725376	.	C	T	16	23	39	0	1	40	0	0
11	44726119	.	C	T	17	15	32	1	4	37	0	0
11	44805464	.	G	C	0	17	17	0	3	20	0	0
11	44805701	.	G	A	14	8	22	0	0	22	0	0
11	44834268	.	G	A	2	12	14	0	7	21	0	0
11	44836755	.	A	G	15	0	15	0	16	31	0	0
11	44843706	.	A	G	7	0	7	0	9	16	0	0
11	44848783	.	A	G	15	0	15	0	14	29	0	0
11	44848876	.	A	T	10	11	21	0	2	23	0	0
11	44852627	.	C	G	7	4	11	2	0	13	0	0
11	44852756	.	A	T	8	7	15	0	0	15	0	0
11	44852988	.	T	A	7	3	10	0	0	10	0	0
11	44853044	.	A	G	4	8	12	0	0	12	0	0
11	44853073	.	A	T	5	8	13	0	3	16	0	0
11	44853115	.	A	T	6	3	9	0	0	9	0	0
11	44853156	.	T	A	6	4	10	0	0	10	0	0
11	44853172	.	C	A	1	8	9	0	0	9	0	0
11	44853282	.	T	C	6	2	8	0	0	8	0	0
11	44853325	.	T	C	3	5	8	0	1	9	0	0
11	44853670	.	C	T	7	4	11	0	0	11	0	0
11	44854200	.	C	A	3	4	7	0	0	7	0	0
11	44854209	.	C	A	2	3	5	0	0	5	0	0
11	44854560	.	A	T	10	6	16	0	2	18	0	0
11	44854631	.	C	T	10	6	16	0	1	17	0	0
11	44854636	.	G	T	10	6	16	0	0	16	0	0
11	44854692	.	A	C	1	10	11	0	1	12	0	0
11	44854735	.	A	G	3	0	3	0	4	7	0	0
11	44854759	.	C	T	5	2	7	0	0	7	0	0
11	44854847	.	A	G	7	18	25	0	0	25	0	0
11	44854850	.	T	C	6	19	25	0	1	26	0	0
11	44854996	.	T	C	22	8	30	0	0	30	0	0
11	44855027	.	G	A	0	12	12	0	20	32	0	0
11	44855182	.	G	A	2	5	7	1	2	10	0	0
11	44862036	.	C	T	1	2	3	0	0	3	0	0
11	44880288	.	A	G	12	9	21	0	2	23	0	0
11	44880291	.	T	A	11	11	22	0	0	22	0	0
11	44880332	.	G	A	11	14	25	0	0	25	0	0
11	44880345	.	C	G	16	9	25	0	1	26	0	0
11	44887200	.	G	A	17	20	37	0	1	38	0	0
11	44887224	.	T	C	27	1	28	0	16	44	0	0
11	44887612	.	G	T	33	20	53	0	0	53	0	0
11	44891507	.	G	A	17	19	36	0	1	37	0	0
11	44892859	.	T	A	22	27	49	0	0	49	0	0
11	44892883	.	G	A	23	17	40	0	4	44	0	0
11	44892943	.	G	A	24	13	37	0	0	37	0	0
11	44892979	.	T	A	16	13	29	0	0	29	0	0
11	44894409	.	T	C	10	0	10	2	14	26	0	0
11	44897584	.	C	T	16	16	32	0	2	34	0	0
11	44897647	.	A	C	21	6	27	0	1	28	0	0
11	44901315	.	C	T	3	6	9	0	10	19	0	0
11	44901373	.	C	A	33	35	68	0	1	69	0	0
11	44906468	.	A	G	2	2	4	0	0	4	0	0
11	44910758	.	T	G	14	17	31	0	0	31	0	0
11	44912485	.	C	A	3	7	10	0	9	19	0	0
11	44912992	.	C	T	1	14	15	0	16	31	0	0
11	44913176	.	C	A	1	19	20	0	15	35	0	0
11	44914943	.	G	C	19	8	27	0	0	27	0	0
11	44922524	.	T	G	12	4	16	0	0	16	0	0
11	44927159	.	C	A	12	7	19	0	1	20	0	0
11	44927833	.	G	T	8	14	22	0	0	22	0	0
11	44935861	.	G	C	10	7	17	0	1	18	0	0
11	44945621	.	T	G	2	2	4	0	1	5	0	0
11	44945623	.	T	G	3	1	4	0	1	5	0	0
11	44954090	.	G	A	15	12	27	0	1	28	0	0
11	44960620	.	G	A	8	6	14	0	0	14	0	0
11	44964284	.	C	T	1	8	9	0	9	18	0	0
11	45097134	.	G	A	1	3	4	2	3	9	0	0
11	45097183	.	G	C	5	9	14	0	0	14	0	0
11	45097195	.	T	C	5	7	12	0	0	12	0	0
11	45097734	.	C	A	2	2	4	0	0	4	0	0
11	45098189	.	G	A	3	4	7	1	0	8	0	0
11	45098197	.	A	T	3	3	6	1	0	7	0	0
11	45100285	.	C	T	1	3	4	2	0	6	0	0
11	45112699	.	C	A	4	3	7	0	0	7	0	0
11	45117117	.	A	G	5	0	5	0	4	9	0	0
11	45120566	.	C	T	4	5	9	0	0	9	0	0
11	45120665	.	C	T	4	3	7	0	0	7	0	0
11	45120700	.	G	A	0	3	3	0	5	8	0	0
11	45122701	.	C	T	4	2	6	0	0	6	0	0
11	45124499	.	C	G	4	2	6	0	0	6	0	0
11	45127352	.	C	G	9	7	16	0	0	16	0	0
11	45139714	.	G	A	3	2	5	0	0	5	0	0
11	45139844	.	A	G	3	4	7	0	0	7	0	0
11	45139866	.	C	A	2	2	4	0	1	5	0	0
11	45140210	.	G	C	8	6	14	0	0	14	0	0
11	45141271	.	G	A	9	16	25	0	0	25	0	0
11	45147865	.	G	C	6	7	13	0	0	13	0	0
11	45147873	.	A	G	3	4	7	0	0	7	0	0
11	45152845	.	G	A	1	2	3	0	0	3	0	0
11	45161381	.	A	T	4	6	10	0	0	10	0	0
11	45161818	.	G	A	8	2	10	0	2	12	0	0
11	45161878	.	T	C	11	5	16	0	0	16	0	0
11	45162015	.	G	A	3	9	12	1	0	13	0	0
11	45162416	.	T	C	21	0	21	0	20	41	0	0
11	45167709	.	G	A	7	11	18	0	0	18	0	0
11	45171160	.	C	T	4	8	12	0	0	12	0	0
11	45171162	.	T	C	4	8	12	0	0	12	0	0
11	45174851	.	T	C	1	2	3	0	4	7	0	0
11	45174879	.	T	C	1	6	7	0	0	7	0	0
11	45223968	.	G	A	0	7	7	0	4	11	0	0
11	45224763	.	C	A	4	4	8	0	0	8	0	0
11	45233971	.	G	A	0	2	2	0	2	4	0	0
11	45234045	.	G	C	3	4	7	0	0	7	0	0
11	45234948	.	C	T	3	2	5	0	0	5	0	0
11	45237529	.	T	G	3	2	5	0	0	5	0	0
11	45242360	.	T	C	4	10	14	0	1	15	0	0
11	45243089	.	A	C	3	10	13	0	1	14	0	0
11	45243092	.	A	C	4	10	14	0	0	14	0	0
11	45245811	.	G	A	5	4	9	0	0	9	0	0
11	45245913	.	A	G	3	5	8	0	0	8	0	0
11	45245925	.	A	T	2	2	4	0	1	5	0	0
11	45262155	.	T	C	11	6	17	0	1	18	0	0
11	45262186	.	G	A	1	11	12	0	11	23	0	0
11	45262379	.	G	T	10	8	18	1	2	21	0	0
11	45265828	.	C	T	7	11	18	0	0	18	0	0
11	45265859	.	G	C	8	7	15	0	1	16	0	0
11	45290463	.	A	G	11	13	24	0	1	25	0	0
11	45290869	.	C	T	12	5	17	0	0	17	0	0
11	45290989	.	A	C	11	8	19	0	0	19	0	0
11	45291944	.	G	A	14	6	20	0	1	21	0	0
11	45292918	.	G	A	1	16	17	0	11	28	0	0
11	45299717	.	A	C	3	6	9	0	0	9	0	0
11	45299734	.	A	G	3	1	4	0	5	9	0	0
11	45299764	.	C	G	4	0	4	0	4	8	0	0
11	45326754	.	A	G	5	2	7	0	0	7	0	0
11	45327813	.	C	T	4	5	9	0	0	9	0	0
11	45327922	.	C	G	5	3	8	0	0	8	0	0
11	45327983	.	G	A	1	11	12	0	5	17	0	0
11	45328001	.	C	T	4	15	19	0	1	20	0	0
11	45328046	.	C	T	4	7	11	0	1	12	0	0
11	45328145	.	G	A	3	7	10	0	0	10	0	0
11	45328238	.	C	G	1	2	3	0	0	3	0	0
11	45328494	.	T	C	2	5	7	0	2	9	0	0
11	45342334	.	A	G	5	0	5	0	4	9	0	0
11	45342589	.	C	A	1	6	7	0	0	7	0	0
11	45342592	.	G	A	1	7	8	0	0	8	0	0
11	45342625	.	C	T	3	5	8	0	0	8	0	0
11	45342664	.	T	C	3	4	7	0	0	7	0	0
11	45342697	.	T	G	3	3	6	0	0	6	0	0
11	45342924	.	T	C	1	2	3	0	0	3	0	0
11	45343033	.	A	G	2	2	4	0	0	4	0	0
11	45343176	.	G	C	4	4	8	0	1	9	0	0
11	45343389	.	G	A	3	2	5	0	1	6	0	0
11	45344080	.	C	T	3	4	7	0	0	7	0	0
11	45344129	.	G	A	5	3	8	0	0	8	0	0
11	45351639	.	G	A	6	8	14	0	2	16	0	0
11	45355011	.	C	T	2	9	11	0	11	22	0	0
11	45355022	.	C	G	11	8	19	0	1	20	0	0
11	45355155	.	C	T	6	8	14	0	0	14	0	0
11	45355606	.	G	C	9	9	18	0	1	19	0	0
11	45356041	.	T	A	5	3	8	0	3	11	0	0
11	45356042	.	G	A	3	5	8	0	3	11	0	0
11	45356114	.	G	A	11	8	19	0	5	24	0	0
11	45356355	.	C	T	2	5	7	1	5	13	0	0
11	45356660	.	C	T	5	14	19	1	11	31	0	0
11	45359173	.	G	A	10	17	27	0	2	29	0	0
11	45359923	.	A	G	9	7	16	0	0	16	0	0
11	45359980	.	G	A	10	8	18	0	0	18	0	0
11	45362324	.	T	C	10	15	25	0	1	26	0	0
11	45363073	.	G	A	17	6	23	0	0	23	0	0
11	45371380	.	C	G	6	7	13	0	1	14	0	0
11	45371438	.	A	C	4	0	4	0	5	9	0	0
11	45371444	.	G	A	3	6	9	0	0	9	0	0
11	45371474	.	C	A	5	8	13	0	0	13	0	0
11	45371868	.	A	G	10	6	16	0	2	18	0	0
11	45372043	.	C	T	0	7	7	0	4	11	0	0
11	45372123	.	C	T	1	4	5	0	7	12	0	0
11	45385720	.	T	C	1	0	1	0	4	5	0	0
11	45388197	.	G	A	5	1	6	0	1	7	0	0
11	45389466	.	T	C	1	4	5	0	0	5	0	0
11	45389505	.	T	A	1	2	3	0	1	4	0	0
11	45389891	.	G	A	9	7	16	0	2	18	0	0
11	45389932	.	A	T	8	6	14	0	0	14	0	0
11	45389961	.	A	T	7	9	16	0	1	17	0	0
11	45389981	.	G	A	10	7	17	0	1	18	0	0
11	45390003	.	C	G	10	8	18	0	1	19	0	0
11	45391400	.	C	T	25	27	52	0	0	52	0	0
11	45391430	.	G	T	14	13	27	0	1	28	0	0
11	45391683	.	G	A	1	12	13	0	20	33	0	0
11	45391727	.	T	C	14	13	27	0	0	27	0	0
11	45391788	.	C	T	5	14	19	0	3	22	0	0
11	45392634	.	C	A	18	9	27	0	3	30	0	0
11	45393468	.	G	T	47	41	88	0	2	90	0	0
11	45393520	.	A	C	11	6	17	0	44	61	0	0
11	45393522	.	A	C	13	3	16	0	46	62	0	0
11	45395572	.	G	A	3	25	28	0	23	51	0	0
11	45399925	.	C	T	9	14	23	0	8	31	0	0
11	45399985	.	G	T	3	14	17	0	19	36	0	0
11	45403525	.	G	A	12	12	24	0	0	24	0	0
11	45412505	.	C	T	0	15	15	0	16	31	0	0
11	45425460	.	C	G	1	2	3	0	0	3	0	0
11	45430139	.	C	T	5	3	8	0	1	9	0	0
11	45432233	.	C	A	2	3	5	0	0	5	0	0
11	45439899	.	G	A	4	6	10	0	1	11	0	0
11	45452445	.	A	G	10	4	14	0	0	14	0	0
11	45452786	.	G	A	1	5	6	0	9	15	0	0
11	45454748	.	C	A	10	6	16	0	0	16	0	0
11	45456290	.	G	A	5	4	9	0	1	10	0	0
11	45460271	.	G	A	0	6	6	0	10	16	0	0
11	45463352	.	T	C	12	12	24	0	0	25	1	0
11	45463781	.	T	A	31	4	35	0	3	38	0	0
11	45463786	.	G	C	30	3	33	0	5	38	0	0
11	45463835	.	G	T	17	12	29	0	1	30	0	0
11	45463979	.	T	A	7	6	13	0	0	14	1	0
11	45464817	.	T	G	8	8	16	0	0	16	0	0
11	45464835	.	G	A	10	8	18	0	0	18	0	0
11	45464880	.	C	T	9	12	21	0	2	23	0	0
11	45465080	.	T	A	15	6	21	0	0	21	0	0
11	45468959	.	G	A	2	3	5	0	0	5	0	0
11	45469739	.	G	A	2	4	6	0	0	6	0	0
11	45469780	.	A	G	4	2	6	0	0	6	0	0
11	45470277	.	C	T	3	11	14	0	7	21	0	0
12	989890	.	T	C	9	2	11	0	0	11	0	0
12	1387913	.	A	G	3	2	5	0	1	6	0	0
12	1524539	.	C	T	2	2	4	0	1	5	0	0
12	2850025	.	A	G	11	4	15	0	0	15	0	0
12	2850547	.	T	C	6	0	6	0	3	9	0	0
12	3077296	.	C	G	2	1	3	0	0	3	0	0
12	3270526	.	A	T	4	2	6	0	0	6	0	0
12	3271368	.	A	G	5	2	7	0	0	7	0	0
12	3271383	.	A	G	6	5	11	0	1	12	0	0
12	3271553	.	G	A	5	6	11	0	0	11	0	0
12	3271646	.	T	A	4	2	6	1	0	7	0	0
12	3272464	.	G	A	16	5	21	1	1	23	0	0
12	3272693	.	A	G	2	2	4	1	0	5	0	0
12	3571986	.	C	T	16	9	25	0	2	27	0	0
12	3574348	.	G	A	17	11	28	0	0	28	0	0
12	3574489	.	G	A	4	5	9	0	0	9	0	0
12	3714149	.	G	T	3	6	9	0	2	11	0	0
12	3714183	.	G	A	7	5	12	0	0	12	0	0
12	3714213	.	T	A	7	6	13	0	0	13	0	0
12	3714315	.	C	T	8	8	16	0	0	16	0	0
12	3714330	.	A	T	11	10	21	0	2	23	0	0
12	3714425	.	C	A	9	5	14	0	0	14	0	0
12	3714578	.	T	C	3	0	3	0	8	11	0	0
12	3714602	.	T	C	5	7	12	0	0	12	0	0
12	3715016	.	A	G	8	6	14	0	0	14	0	0
12	3715046	.	T	C	7	4	11	0	1	12	0	0
12	3715196	.	C	T	2	2	4	1	11	16	0	0
12	3715292	.	T	G	4	10	14	0	1	15	0	0
12	3715327	.	C	A	5	8	13	0	0	13	0	0
12	3715329	.	C	G	4	8	12	0	0	12	0	0
12	3715365	.	T	C	3	6	9	0	0	9	0	0
12	3715474	.	T	C	3	4	7	0	0	7	0	0
12	3715544	.	T	C	3	7	10	0	1	11	0	0
12	3715585	.	T	C	4	5	9	0	3	12	0	0
12	3715588	.	C	A	6	7	13	0	0	13	0	0
12	3715638	.	T	C	2	6	8	0	0	8	0	0
12	3715904	.	G	A	11	6	17	0	0	17	0	0
12	3716621	.	G	C	13	17	30	0	1	31	0	0
12	3723786	.	C	G	13	10	23	0	1	24	0	0
12	3723963	.	G	A	2	12	14	0	7	21	0	0
12	3726646	.	T	A	9	8	17	0	3	20	0	0
12	3740717	.	C	A	13	17	30	1	2	33	0	0
12	3740724	.	T	A	15	17	32	1	1	34	0	0
12	3740784	.	C	T	19	21	40	0	0	40	0	0
12	3740803	.	G	A	17	18	35	0	1	36	0	0
12	3740961	.	C	A	3	14	17	0	13	30	0	0
12	3749502	.	A	G	13	8	21	0	0	21	0	0
12	3749505	.	C	T	2	7	9	0	13	22	0	0
12	3753166	.	C	T	1	10	11	0	15	26	0	0
12	3756297	.	G	T	13	11	24	0	2	26	0	0
12	3770991	.	G	A	2	7	9	0	0	9	0	0
12	3778422	.	A	G	3	4	7	0	0	7	0	0
12	3778580	.	C	G	1	0	1	0	1	2	0	0
12	3789435	.	C	A	0	7	7	0	9	16	0	0
12	3789463	.	T	C	14	4	18	0	0	18	0	0
12	3789489	.	T	A	6	13	19	0	0	19	0	0
12	3789772	.	T	G	17	10	27	0	2	29	0	0
12	3806732	.	C	T	7	10	17	0	0	17	0	0
12	3806825	.	T	G	7	8	15	0	0	15	0	0
12	3807876	.	G	A	7	6	13	0	1	14	0	0
12	3808038	.	T	C	8	5	13	0	0	13	0	0
12	3808704	.	A	G	9	10	19	0	0	19	0	0
12	3808728	.	C	T	6	10	16	0	0	16	0	0
12	3808832	.	G	A	12	4	16	0	0	16	0	0
12	3840324	.	C	T	7	8	15	0	0	15	0	0
12	3840515	.	C	A	1	7	8	0	7	15	0	0
12	3840637	.	A	C	4	7	11	0	0	11	0	0
12	3840659	.	T	A	1	3	4	0	0	4	0	0
12	3848176	.	A	G	6	5	11	0	1	12	0	0
12	3860696	.	C	T	4	3	7	0	0	7	0	0
12	3861279	.	A	G	2	0	2	0	2	4	0	0
12	3875667	.	A	G	5	9	14	0	1	15	0	0
12	3875727	.	T	C	2	5	7	0	0	7	0	0
12	3875892	.	A	G	7	0	7	0	5	12	0	0
12	3918676	.	T	C	1	2	3	0	0	3	0	0
12	3920279	.	T	C	4	2	6	0	0	6	0	0
12	3920309	.	G	A	2	3	5	0	0	5	0	0
12	3921427	.	G	T	6	4	10	0	0	10	0	0
12	3921444	.	A	T	5	5	10	0	0	10	0	0
12	3921537	.	T	A	2	6	8	0	0	8	0	0
12	3921813	.	G	A	9	3	12	0	0	12	0	0
12	3921894	.	T	C	6	5	11	0	1	12	0	0
12	3922047	.	A	G	3	5	8	0	0	8	0	0
12	3922068	.	A	T	1	6	7	0	0	7	0	0
12	3922536	.	A	G	4	8	12	0	2	14	0	0
12	3922549	.	G	A	0	8	8	0	7	15	0	0
12	3922764	.	A	G	3	4	7	0	0	7	0	0
12	3944488	.	C	G	1	31	32	0	24	56	0	0
12	3944543	.	A	G	26	32	58	0	2	60	0	0
12	3946833	.	G	A	25	37	62	0	1	63	0	0
12	3947276	.	A	G	22	22	44	0	2	46	0	0
12	3947484	.	A	G	16	27	43	0	3	46	0	0
12	3947902	.	G	A	22	25	47	0	1	48	0	0
12	3947929	.	A	G	19	25	44	0	3	47	0	0
12	3948593	.	C	T	18	29	47	0	2	50	1	0
12	3948701	.	G	A	28	25	53	0	2	55	0	0
12	3949194	.	A	G	19	33	52	0	1	53	0	0
12	3953155	.	T	A	22	18	40	0	2	42	0	0
12	3953946	.	A	G	21	15	36	0	3	39	0	0
12	3954003	.	T	G	7	13	20	0	1	21	0	0
12	3956864	.	A	G	25	16	41	0	1	42	0	0
12	3957973	.	A	G	22	20	42	0	1	43	0	0
12	3964631	.	G	A	15	12	27	1	1	29	0	0
12	3964770	.	A	G	9	12	21	0	0	21	0	0
12	3965002	.	G	T	9	13	22	1	4	27	0	0
12	3965168	.	T	C	16	15	31	0	0	31	0	0
12	3967756	.	A	G	16	18	34	0	0	34	0	0
12	3971655	.	A	G	4	9	13	0	0	13	0	0
12	3974755	.	C	T	0	11	11	0	14	25	0	0
12	3986338	.	T	C	2	2	4	0	0	4	0	0
12	3998821	.	A	C	2	2	4	0	0	4	0	0
12	3998925	.	T	A	4	4	8	0	0	8	0	0
12	3998943	.	T	C	3	2	5	0	0	5	0	0
12	3998961	.	A	T	5	5	10	0	0	10	0	0
12	3999002	.	A	G	1	5	6	0	0	6	0	0
12	4002615	.	A	T	4	3	7	0	0	7	0	0
12	4002709	.	A	G	4	11	15	0	0	15	0	0
12	4004344	.	C	T	5	9	14	0	0	14	0	0
12	4004448	.	C	T	0	8	8	0	5	13	0	0
12	4009150	.	G	A	3	6	9	0	1	10	0	0
12	4009165	.	A	G	5	6	11	0	0	11	0	0
12	4009202	.	G	A	8	7	15	0	1	16	0	0
12	4009337	.	G	A	4	7	11	0	0	11	0	0
12	4009462	.	A	T	5	6	11	0	0	11	0	0
12	4014416	.	G	A	4	7	11	0	0	11	0	0
12	4016206	.	C	T	2	4	6	0	0	6	0	0
12	4020028	.	A	G	1	2	3	0	0	3	0	0
12	4020063	.	A	T	2	3	5	0	0	5	0	0
12	4020073	.	C	A	2	2	4	0	1	5	0	0
12	4022390	.	C	T	3	2	5	0	0	5	0	0
12	4022397	.	C	T	4	4	8	0	0	8	0	0
12	4022458	.	A	G	3	7	10	0	0	10	0	0
12	4024104	.	T	C	4	8	12	0	0	12	0	0
12	4140743	.	T	G	1	0	1	0	2	3	0	0
12	4144290	.	A	T	2	2	4	0	0	4	0	0
12	4144811	.	A	G	1	3	4	0	0	4	0	0
12	4217418	.	T	C	2	2	4	0	0	4	0	0
12	4220453	.	A	G	5	4	9	0	0	9	0	0
12	4220656	.	T	C	3	4	7	0	0	7	0	0
12	4225361	.	A	T	5	5	10	0	0	10	0	0
12	4226080	.	C	T	3	2	5	0	0	5	0	0
12	4226089	.	G	A	4	1	5	0	1	6	0	0
12	4226155	.	A	G	8	0	8	0	4	12	0	0
12	4226492	.	G	C	0	2	2	0	1	3	0	0
12	4227248	.	A	C	5	4	9	0	0	9	0	0
12	4227365	.	G	A	9	3	12	0	0	12	0	0
12	4227374	.	A	G	9	3	12	0	1	13	0	0
12	4231990	.	A	G	5	5	10	0	0	10	0	0
12	4232001	.	C	T	6	4	10	0	0	10	0	0
12	4232313	.	A	G	3	0	3	0	7	10	0	0
12	4232320	.	C	T	4	6	10	0	0	10	0	0
12	4232425	.	G	A	11	8	19	0	0	19	0	0
12	4232434	.	C	A	11	9	20	0	0	20	0	0
12	4234489	.	G	C	6	6	12	0	1	13	0	0
12	4238720	.	T	C	2	2	4	0	0	4	0	0
12	4601769	.	A	G	25	21	46	0	2	48	0	0
12	4602047	.	T	A	16	10	26	1	4	31	0	0
12	4602245	.	G	A	18	17	35	0	4	39	0	0
12	4602399	.	A	T	18	18	36	0	0	36	0	0
12	4602436	.	A	T	21	10	31	0	1	32	0	0
12	4606669	.	C	T	20	21	41	0	1	42	0	0
12	4609143	.	C	T	22	18	40	0	0	40	0	0
12	4609343	.	C	G	1	15	16	0	18	34	0	0
12	4609364	.	A	G	16	15	31	0	1	32	0	0
12	4609391	.	T	C	19	14	33	0	1	34	0	0
12	4609409	.	C	T	18	13	31	0	0	31	0	0
12	4611092	.	C	T	1	15	16	0	19	35	0	0
12	4611128	.	C	T	20	18	38	0	2	40	0	0
12	4611521	.	T	C	11	1	12	0	27	39	0	0
12	4615281	.	T	C	14	0	14	0	15	29	0	0
12	4616967	.	C	G	13	11	24	0	2	26	0	0
12	4616974	.	G	A	12	11	23	0	2	25	0	0
12	4617024	.	G	T	9	14	23	0	1	24	0	0
12	4617065	.	G	A	13	17	30	0	0	30	0	0
12	4617070	.	T	C	12	17	29	0	1	30	0	0
12	4617102	.	G	C	14	0	14	0	14	28	0	0
12	4617243	.	G	A	28	16	44	1	0	45	0	0
12	4617274	.	G	A	24	16	40	0	0	40	0	0
12	4617286	.	T	C	27	0	27	0	15	42	0	0
12	4619179	.	A	G	14	13	27	0	2	29	0	0
12	4619230	.	G	T	21	14	35	0	1	36	0	0
12	4619553	.	C	T	10	13	23	0	1	24	0	0
12	4621060	.	C	T	7	4	11	0	1	12	0	0
12	4621108	.	A	T	10	7	17	0	1	18	0	0
12	4621480	.	G	A	11	11	22	0	2	24	0	0
12	4621618	.	A	G	19	13	32	0	0	32	0	0
12	4621782	.	A	G	10	12	22	0	4	26	0	0
12	4621909	.	G	T	18	11	29	0	4	33	0	0
12	4622224	.	T	C	9	1	10	0	13	23	0	0
12	4622344	.	G	A	13	8	21	0	1	22	0	0
12	4622884	.	G	A	19	8	27	0	0	27	0	0
12	4631531	.	A	G	7	4	11	0	1	12	0	0
12	4631996	.	C	A	3	8	11	0	0	11	0	0
12	4632019	.	T	A	0	7	7	0	1	8	0	0
12	4644028	.	A	C	4	6	10	0	0	10	0	0
12	4645291	.	G	T	7	9	16	0	1	17	0	0
12	4648491	.	C	T	7	3	10	0	1	11	0	0
12	4648530	.	G	A	9	8	17	0	0	17	0	0
12	4653986	.	C	T	1	6	7	0	8	15	0	0
12	4654421	.	A	G	3	2	5	0	0	5	0	0
12	4654427	.	C	G	0	1	1	0	4	5	0	0
12	4661329	.	A	G	4	3	7	0	0	7	0	0
12	4686524	.	G	A	10	8	18	0	1	19	0	0
12	4690311	.	A	G	10	14	24	0	1	25	0	0
12	4690425	.	G	A	1	4	5	0	10	15	0	0
12	4690572	.	T	C	5	8	13	0	0	13	0	0
12	4690668	.	G	C	1	6	7	0	0	7	0	0
12	4690785	.	T	C	5	5	10	0	0	10	0	0
12	4691043	.	G	A	0	6	6	0	7	13	0	0
12	4691146	.	A	G	7	5	12	0	0	12	0	0
12	4712234	.	T	C	5	12	17	0	0	17	0	0
12	4713010	.	C	A	14	15	29	0	0	29	0	0
12	4715953	.	A	G	15	1	16	1	8	25	0	0
12	4715968	.	G	A	13	9	22	1	2	25	0	0
12	4716061	.	A	C	7	12	19	0	6	25	0	0
12	4716064	.	T	G	10	2	12	0	13	25	0	0
12	4716361	.	A	G	8	13	21	0	0	21	0	0
12	4716375	.	T	C	9	13	22	0	0	22	0	0
12	4720264	.	T	C	7	13	20	0	1	21	0	0
12	4721721	.	C	G	16	16	32	0	2	34	0	0
12	4721727	.	A	G	17	0	17	0	17	34	0	0
12	4724397	.	A	T	12	11	23	0	0	23	0	0
12	4724455	.	A	G	18	0	18	0	7	25	0	0
12	4724464	.	T	C	17	10	27	0	0	27	0	0
12	4724553	.	G	A	8	7	15	0	1	16	0	0
12	4724634	.	G	A	0	9	9	0	8	17	0	0
12	4724710	.	G	A	6	3	9	0	0	9	0	0
12	4724787	.	T	G	7	9	16	0	0	16	0	0
12	4724983	.	G	A	11	13	24	0	1	25	0	0
12	4725170	.	A	T	15	7	22	0	0	22	0	0
12	4725371	.	A	G	10	10	20	0	0	20	0	0
12	4733968	.	C	T	13	13	26	0	3	29	0	0
12	4734008	.	G	T	20	20	40	0	0	40	0	0
12	4734068	.	G	T	22	24	46	0	0	46	0	0
12	4734306	.	A	T	22	23	45	0	0	45	0	0
12	4734312	.	A	G	19	22	41	0	1	42	0	0
12	4734418	.	T	G	24	24	48	0	3	51	0	0
12	4734476	.	T	C	25	1	26	0	23	49	0	0
12	4734925	.	C	T	27	35	62	0	3	65	0	0
12	4734967	.	G	A	25	28	53	0	5	58	0	0
12	4734979	.	C	T	1	27	28	0	31	60	1	0
12	4751860	.	C	T	16	16	32	0	1	33	0	0
12	4752981	.	G	A	13	25	38	0	2	40	0	0
12	4753014	.	A	G	12	30	42	0	4	47	1	0
12	4753020	.	A	G	13	31	44	0	3	47	0	0
12	4753095	.	C	T	27	30	57	0	0	57	0	0
12	4753104	.	C	T	4	30	34	0	25	59	0	0
12	4754639	.	G	T	16	24	40	0	1	41	0	0
12	4920541	.	A	G	3	0	3	0	4	7	0	0
12	4935758	.	G	C	2	7	9	0	0	9	0	0
12	4935876	.	G	A	1	3	4	0	0	4	0	0
12	4944911	.	G	A	0	2	2	0	4	6	0	0
12	4944952	.	T	C	4	2	6	0	0	6	0	0
12	4945209	.	T	C	2	5	7	0	0	7	0	0
12	4950356	.	C	T	2	3	5	0	0	5	0	0
12	4957095	.	A	G	3	7	10	0	0	10	0	0
12	4961162	.	C	T	1	3	4	0	0	4	0	0
12	4961256	.	A	G	3	4	7	0	0	7	0	0
12	4961930	.	A	G	1	3	4	0	0	4	0	0
12	4961955	.	A	C	1	4	5	0	0	5	0	0
12	5021084	.	G	A	1	6	7	0	3	10	0	0
12	5021110	.	G	A	1	2	3	0	0	3	0	0
12	5021183	.	A	G	3	0	3	0	10	13	0	0
12	5038141	.	C	T	4	6	10	0	0	10	0	0
12	5038363	.	A	C	2	4	6	0	0	6	0	0
12	5044104	.	A	G	9	0	9	0	8	17	0	0
12	5044106	.	G	A	9	7	16	0	1	17	0	0
12	5044338	.	A	T	7	5	12	0	1	13	0	0
12	5044462	.	A	T	2	2	4	0	0	4	0	0
12	5044545	.	A	G	4	0	4	0	2	6	0	0
12	5044606	.	C	T	6	3	9	0	0	9	0	0
12	5044737	.	A	G	5	0	5	0	5	10	0	0
12	5054754	.	A	G	1	0	1	0	2	3	0	0
12	5059785	.	T	C	2	4	6	0	0	6	0	0
12	5059829	.	A	G	1	0	1	0	6	7	0	0
12	5059868	.	C	G	1	7	8	0	0	8	0	0
12	5064179	.	G	A	0	2	2	0	5	7	0	0
12	5070229	.	A	C	1	3	4	0	0	4	0	0
12	5070290	.	G	A	3	5	8	0	0	8	0	0
12	5070383	.	A	C	2	2	4	0	0	4	0	0
12	5071104	.	T	A	1	4	5	0	0	5	0	0
12	5084514	.	C	T	18	12	30	0	1	31	0	0
12	5090591	.	T	C	18	14	32	0	3	35	0	0
12	5091368	.	A	T	14	12	26	0	0	26	0	0
12	5116192	.	A	G	24	23	47	0	0	47	0	0
12	5119802	.	T	C	12	13	25	0	2	27	0	0
12	5180489	.	G	A	3	11	14	0	0	14	0	0
12	5180626	.	G	A	3	9	12	0	1	13	0	0
12	5180662	.	T	A	4	5	9	0	0	9	0	0
12	5182460	.	T	C	4	6	10	0	1	11	0	0
12	5182718	.	G	A	6	6	12	0	0	12	0	0
12	5185627	.	G	A	9	6	15	0	1	16	0	0
12	5189940	.	C	T	2	6	8	0	0	8	0	0
12	5190063	.	A	G	4	6	10	0	0	10	0	0
12	5222251	.	T	C	2	2	4	0	0	4	0	0
12	5352785	.	T	A	2	3	5	0	0	5	0	0
12	5352855	.	G	A	0	2	2	0	1	3	0	0
12	5358435	.	G	A	3	3	6	0	0	6	0	0
12	5366486	.	A	G	1	0	1	0	2	3	0	0
12	5375249	.	T	C	2	3	5	0	0	5	0	0
12	5375252	.	C	T	2	2	4	0	1	5	0	0
12	5382286	.	G	A	1	3	4	0	2	6	0	0
12	5383896	.	C	T	3	2	5	0	0	5	0	0
12	5386789	.	T	A	3	2	5	0	0	5	0	0
12	5388700	.	C	T	5	4	9	0	0	9	0	0
12	5389889	.	G	A	6	3	9	0	1	10	0	0
12	5389940	.	T	C	5	5	10	0	0	10	0	0
12	5398514	.	T	G	2	4	6	0	0	6	0	0
12	5399803	.	G	A	4	5	9	0	0	9	0	0
12	5399832	.	G	C	4	6	10	0	1	11	0	0
12	5402235	.	G	T	4	3	7	0	2	9	0	0
12	5404160	.	T	C	7	0	7	0	5	12	0	0
12	5404181	.	G	C	6	0	6	0	2	8	0	0
12	5404403	.	C	T	0	2	2	0	4	6	0	0
12	5407930	.	A	T	1	5	6	0	0	6	0	0
12	5412179	.	C	T	2	8	10	0	0	10	0	0
12	5412216	.	A	G	2	4	6	0	0	6	0	0
12	5412235	.	C	G	3	4	7	0	0	7	0	0
12	5414913	.	T	C	2	0	2	0	4	6	0	0
12	5424239	.	G	A	5	5	10	0	0	10	0	0
12	5424264	.	A	G	5	7	12	0	1	13	0	0
12	5424499	.	G	T	7	5	12	0	0	12	0	0
12	5424785	.	A	T	5	6	11	0	0	11	0	0
12	5427456	.	T	A	9	8	17	0	2	19	0	0
12	5427491	.	T	G	9	4	13	0	0	13	0	0
12	5434072	.	G	A	7	12	19	0	0	19	0	0
12	5434794	.	G	T	5	4	9	0	0	9	0	0
12	5451783	.	A	G	7	5	12	0	0	12	0	0
12	5451926	.	G	A	5	6	11	0	0	11	0	0
12	5452249	.	C	T	3	3	6	0	0	6	0	0
12	5452625	.	A	G	5	8	13	0	0	13	0	0
12	5455688	.	T	C	2	0	2	0	4	6	0	0
12	5459629	.	A	G	2	2	4	0	0	4	0	0
12	5576096	.	C	T	5	2	7	0	1	8	0	0
12	5576126	.	A	G	3	0	3	0	7	10	0	0
12	5576136	.	C	T	4	3	7	0	1	8	0	0
12	5581617	.	G	C	2	2	4	0	0	4	0	0
12	5597010	.	G	A	2	2	4	0	0	4	0	0
12	5618145	.	A	T	2	0	2	0	1	3	0	0
12	5618151	.	G	A	2	2	4	0	0	4	0	0
12	5998760	.	C	T	1	12	13	0	0	13	0	0
12	7610969	.	T	C	8	5	13	0	0	13	0	0
12	7611188	.	T	C	10	5	15	0	0	15	0	0
12	7611205	.	T	C	8	3	11	0	1	12	0	0
12	7611286	.	T	C	1	4	5	0	1	6	0	0
12	7611390	.	T	C	3	3	6	0	0	6	0	0
12	7612106	.	T	C	3	7	10	0	0	10	0	0
12	7612441	.	T	C	3	3	6	0	0	6	0	0
12	9039896	.	C	T	12	3	15	0	0	15	0	0
12	10125573	.	A	G	4	9	13	0	0	13	0	0
12	11124934	.	C	G	2	0	2	0	7	9	0	0
12	11124937	.	A	C	3	1	4	0	6	10	0	0
12	11389082	.	T	C	10	4	14	0	0	14	0	0
12	11390365	.	T	C	4	4	8	0	0	8	0	0
12	13473280	.	A	G	6	4	10	1	0	11	0	0
12	13473302	.	A	G	5	0	5	1	2	8	0	0
12	13474461	.	A	G	16	7	23	0	0	23	0	0
12	13741105	.	T	G	2	1	3	0	3	6	0	0
12	14166722	.	T	A	8	3	11	0	0	11	0	0
12	15309971	.	A	G	3	0	3	0	2	5	0	0
12	17118249	.	A	G	15	2	17	0	0	17	0	0
12	18717307	.	A	T	6	2	8	0	0	8	0	0
12	18913503	.	A	G	9	3	12	0	0	12	0	0
12	18913906	.	A	G	8	3	11	0	0	11	0	0
12	18913938	.	A	G	5	5	10	0	1	11	0	0
12	19189677	.	T	C	7	2	9	0	1	10	0	0
12	19318412	.	G	T	2	2	4	0	0	4	0	0
12	19430150	.	A	G	6	7	13	0	1	14	0	0
12	19430154	.	A	G	8	6	14	0	0	14	0	0
12	20639413	.	T	A	3	2	5	0	0	5	0	0
12	20639777	.	G	T	2	2	4	0	0	4	0	0
12	20653080	.	A	T	6	5	11	0	1	12	0	0
12	20653081	.	A	T	7	3	10	0	3	13	0	0
12	22529182	.	T	C	8	7	15	0	3	18	0	0
12	22529456	.	T	G	21	19	40	1	3	44	0	0
12	22529457	.	A	C	21	21	42	1	2	45	0	0
12	22531505	.	A	T	26	13	39	0	1	40	0	0
12	22532595	.	G	A	24	24	48	0	2	50	0	0
12	22533054	.	G	A	25	18	43	0	0	43	0	0
12	22533806	.	C	T	1	24	25	0	18	43	0	0
12	22533884	.	A	T	15	17	32	0	2	34	0	0
12	22533908	.	G	A	19	12	31	0	0	31	0	0
12	22534383	.	A	G	22	15	37	0	2	39	0	0
12	22534794	.	C	T	20	14	34	0	3	37	0	0
12	22535121	.	C	G	16	15	31	0	1	32	0	0
12	22535186	.	C	T	10	30	40	0	3	43	0	0
12	22535197	.	A	G	12	31	43	0	2	45	0	0
12	22535498	.	T	C	14	12	26	0	1	27	0	0
12	22535546	.	A	T	18	15	33	0	3	36	0	0
12	22535567	.	T	C	15	16	31	0	2	33	0	0
12	22535631	.	T	G	19	14	33	0	1	34	0	0
12	22535640	.	G	A	18	15	33	0	0	33	0	0
12	22536188	.	C	T	1	10	11	0	16	27	0	0
12	22536609	.	T	G	14	28	42	1	2	46	1	0
12	22536621	.	G	C	15	24	39	1	2	42	0	0
12	22537244	.	T	C	17	12	29	0	1	30	0	0
12	22537485	.	G	A	10	11	21	0	0	21	0	0
12	22560249	.	A	G	11	8	19	0	1	20	0	0
12	22561889	.	A	C	5	4	9	0	0	9	0	0
12	22561961	.	G	A	6	2	8	0	0	8	0	0
12	22561981	.	A	G	2	1	3	0	0	3	0	0
12	22562509	.	T	C	4	6	10	0	1	11	0	0
12	22562554	.	C	T	3	1	4	0	1	5	0	0
12	22562581	.	T	C	4	4	8	0	0	8	0	0
12	22563882	.	T	C	9	9	18	0	1	19	0	0
12	22563891	.	G	T	9	8	17	0	1	18	0	0
12	22565015	.	T	C	3	2	5	0	1	6	0	0
12	22565764	.	A	G	6	3	9	0	0	9	0	0
12	22566413	.	A	G	6	5	11	0	0	11	0	0
12	22566434	.	A	T	5	5	10	0	0	10	0	0
12	22569785	.	C	T	15	6	21	0	1	22	0	0
12	22570379	.	A	T	23	16	39	0	3	42	0	0
12	22570499	.	T	C	17	17	34	0	1	35	0	0
12	22570814	.	T	C	18	17	35	0	3	38	0	0
12	22571592	.	A	T	12	5	17	0	0	17	0	0
12	22571628	.	G	A	12	7	19	0	0	19	0	0
12	22572199	.	C	G	14	13	27	0	3	30	0	0
12	22572287	.	A	C	16	13	29	0	1	30	0	0
12	22572528	.	T	G	17	7	24	0	0	24	0	0
12	22572738	.	C	T	9	15	24	0	0	24	0	0
12	22572814	.	A	G	8	0	8	0	8	16	0	0
12	22573080	.	T	A	19	8	27	0	0	27	0	0
12	22573239	.	A	C	4	2	6	0	0	6	0	0
12	22628731	.	G	T	0	4	4	0	7	11	0	0
12	22628775	.	A	C	3	4	7	0	1	8	0	0
12	22628897	.	G	A	1	3	4	0	0	4	0	0
12	22628902	.	A	T	1	3	4	0	0	4	0	0
12	22628983	.	G	A	6	2	8	0	0	8	0	0
12	22630471	.	G	A	6	7	13	0	0	13	0	0
12	22634817	.	C	T	1	3	4	0	0	4	0	0
12	22640923	.	T	C	5	8	13	0	0	13	0	0
12	22643556	.	C	G	7	10	17	1	0	18	0	0
12	22644050	.	A	T	3	4	7	0	0	7	0	0
12	22644060	.	T	C	4	2	6	0	0	6	0	0
12	22644202	.	T	G	3	7	10	0	0	10	0	0
12	22644209	.	T	C	3	8	11	0	0	11	0	0
12	22644281	.	T	C	2	3	5	0	0	5	0	0
12	22644576	.	A	G	4	1	5	0	6	11	0	0
12	22644634	.	T	C	3	9	12	0	0	12	0	0
12	22644687	.	T	G	7	7	14	0	1	15	0	0
12	22644800	.	G	A	3	4	7	0	0	7	0	0
12	22644852	.	C	T	3	2	5	0	1	6	0	0
12	22645174	.	G	A	2	3	5	0	0	5	0	0
12	22648402	.	T	C	2	2	4	0	0	4	0	0
12	22648423	.	A	T	3	3	6	0	0	6	0	0
12	22668172	.	C	T	1	2	3	0	0	3	0	0
12	22680247	.	T	C	15	7	22	0	0	22	0	0
12	22680255	.	T	C	15	6	21	0	0	21	0	0
12	22680285	.	C	G	6	9	15	0	3	18	0	0
12	22680337	.	C	T	4	6	10	0	1	11	0	0
12	22768372	.	G	A	10	8	18	0	0	18	0	0
12	22774261	.	C	T	5	11	16	0	0	16	0	0
12	22774439	.	A	G	5	6	11	0	1	12	0	0
12	22780905	.	G	A	10	8	18	0	0	18	0	0
12	22784031	.	A	T	6	8	14	0	1	15	0	0
12	22785874	.	G	A	0	6	6	0	5	11	0	0
12	22788151	.	A	C	11	10	21	0	0	21	0	0
12	22814990	.	T	C	10	15	25	0	2	27	0	0
12	22814994	.	A	G	14	13	27	0	1	28	0	0
12	22815203	.	G	A	12	9	21	0	2	23	0	0
12	22815365	.	C	T	15	11	26	0	2	28	0	0
12	22815659	.	A	G	11	4	15	0	1	16	0	0
12	22815724	.	G	T	11	8	19	0	1	20	0	0
12	22815767	.	A	T	12	6	18	0	1	19	0	0
12	22885982	.	T	C	1	2	3	0	0	3	0	0
12	22905430	.	T	C	1	2	3	0	0	3	0	0
12	22911941	.	C	T	1	2	3	0	0	3	0	0
12	22915224	.	T	C	4	3	7	0	0	7	0	0
12	22915257	.	A	G	2	0	2	0	5	7	0	0
12	22915831	.	A	G	2	0	2	0	4	6	0	0
12	22915857	.	A	T	1	4	5	0	0	5	0	0
12	22915880	.	C	A	1	2	3	0	0	3	0	0
12	22916155	.	T	C	3	2	5	0	0	5	0	0
12	22916277	.	T	A	2	3	5	0	0	5	0	0
12	22916281	.	A	C	2	3	5	0	0	5	0	0
12	22921525	.	T	A	9	6	15	0	0	15	0	0
12	22927981	.	T	C	17	19	36	0	0	36	0	0
12	22932087	.	C	T	11	13	24	0	1	25	0	0
12	22932090	.	G	C	11	11	22	0	1	23	0	0
12	22932148	.	G	A	9	5	14	0	0	14	0	0
12	22932160	.	A	C	10	5	15	0	0	15	0	0
12	22932737	.	A	G	15	0	15	0	5	20	0	0
12	22932852	.	G	T	3	9	12	0	17	29	0	0
12	22932875	.	G	T	16	9	25	0	0	25	0	0
12	22962211	.	A	T	4	5	9	0	0	9	0	0
12	22962555	.	C	A	3	5	8	0	0	8	0	0
12	22962764	.	T	C	5	9	14	0	0	14	0	0
12	22962781	.	G	A	7	11	18	0	0	18	0	0
12	22962911	.	C	A	5	4	9	0	0	9	0	0
12	22963197	.	G	A	4	2	6	0	0	6	0	0
12	22963242	.	G	A	2	2	4	0	0	4	0	0
12	22963667	.	C	G	8	4	12	0	0	12	0	0
12	22991383	.	C	T	2	5	7	0	1	8	0	0
12	23008283	.	T	G	3	2	5	0	0	5	0	0
12	23008540	.	C	A	2	6	8	0	2	10	0	0
12	23009215	.	G	A	5	7	12	0	0	12	0	0
12	23009275	.	C	T	2	7	9	0	0	9	0	0
12	23389675	.	G	A	18	7	25	0	1	26	0	0
12	23400392	.	C	T	23	19	42	0	2	44	0	0
12	23400469	.	C	T	21	15	36	0	1	37	0	0
12	23403091	.	T	C	20	15	35	0	0	35	0	0
12	23403149	.	T	C	24	16	40	0	1	41	0	0
12	23406439	.	A	G	19	19	38	0	3	41	0	0
12	23411287	.	C	T	17	15	32	0	0	32	0	0
12	23415280	.	C	T	15	21	36	0	0	36	0	0
12	23415370	.	C	T	19	17	36	0	1	37	0	0
12	23415662	.	G	A	6	24	30	0	2	32	0	0
12	23415715	.	T	C	16	14	30	0	5	35	0	0
12	23415897	.	A	T	15	2	17	0	1	18	0	0
12	23424190	.	C	T	3	5	8	0	0	8	0	0
12	23429685	.	C	T	4	2	6	0	0	6	0	0
12	23429917	.	A	G	2	1	3	0	4	7	0	0
12	23430003	.	C	A	2	3	5	0	1	6	0	0
12	23665047	.	C	G	2	0	2	0	3	5	0	0
12	23665167	.	C	T	3	2	5	0	0	5	0	0
12	23674331	.	T	A	1	3	4	0	0	4	0	0
12	23674468	.	C	T	1	4	5	0	0	5	0	0
12	23784201	.	C	G	3	6	9	1	0	11	1	0
12	23787358	.	T	G	5	2	7	0	0	7	0	0
12	23787826	.	G	T	4	3	7	0	0	7	0	0
12	23787904	.	A	T	2	6	8	0	0	8	0	0
12	23787989	.	T	A	4	3	7	0	4	11	0	0
12	23788528	.	G	A	6	5	11	0	0	11	0	0
12	23788649	.	C	A	6	10	16	0	1	17	0	0
12	23788682	.	G	A	7	9	16	0	2	18	0	0
12	23789838	.	A	C	3	6	9	0	0	9	0	0
12	23790148	.	A	T	9	4	13	0	0	13	0	0
12	23793990	.	A	T	6	6	12	0	0	12	0	0
12	23794148	.	A	T	3	3	6	0	0	6	0	0
12	23794848	.	A	T	2	4	6	0	0	6	0	0
12	23867113	.	G	T	1	2	3	0	0	3	0	0
12	23885887	.	T	C	1	2	3	0	0	3	0	0
12	23885908	.	C	T	3	3	6	0	0	6	0	0
12	23885932	.	G	A	0	3	3	0	4	7	0	0
12	23912037	.	A	G	3	3	6	0	0	6	0	0
12	23913566	.	T	C	5	2	7	0	0	7	0	0
12	23913587	.	G	A	5	3	8	0	0	8	0	0
12	23916491	.	A	G	1	3	4	0	0	4	0	0
12	23916502	.	T	C	1	5	6	0	0	6	0	0
12	23917156	.	T	G	2	0	2	0	3	5	0	0
12	23917160	.	T	G	2	2	4	0	0	4	0	0
12	23917279	.	T	C	3	3	6	0	1	7	0	0
12	23917460	.	G	C	5	6	11	0	0	11	0	0
12	23920090	.	G	A	5	3	8	0	0	8	0	0
12	23923434	.	G	A	6	6	12	0	1	13	0	0
12	23932067	.	T	G	5	12	17	0	1	18	0	0
12	23995727	.	A	G	2	3	5	0	0	5	0	0
12	24005973	.	C	T	2	6	8	0	0	8	0	0
12	24010977	.	T	G	3	5	8	0	0	8	0	0
12	24018336	.	A	G	3	3	6	0	0	6	0	0
12	24022843	.	T	C	4	8	12	0	0	12	0	0
12	24027041	.	G	A	7	4	11	0	0	11	0	0
12	24030458	.	G	A	5	6	11	0	0	11	0	0
12	24030846	.	A	G	7	6	13	0	0	13	0	0
12	24034771	.	C	T	5	4	9	0	0	9	0	0
12	24036870	.	T	C	8	7	15	0	0	15	0	0
12	24038339	.	A	C	8	3	11	0	2	13	0	0
12	24038517	.	A	G	4	4	8	0	0	8	0	0
12	24038542	.	T	C	7	7	14	0	1	15	0	0
12	24041253	.	G	T	7	9	16	0	0	16	0	0
12	24041254	.	T	A	7	9	16	0	0	16	0	0
12	24041322	.	T	A	5	6	11	0	0	11	0	0
12	24041545	.	T	C	3	2	5	0	0	5	0	0
12	24043730	.	A	G	9	5	14	0	0	14	0	0
12	24051755	.	T	A	6	5	11	0	1	12	0	0
12	24052133	.	A	G	2	0	2	0	2	4	0	0
12	24052256	.	G	C	8	3	11	0	0	11	0	0
12	24052288	.	T	C	3	3	6	0	1	7	0	0
12	24052303	.	T	A	3	4	7	0	0	7	0	0
12	24052684	.	G	A	9	8	17	0	1	18	0	0
12	24056716	.	G	T	4	2	6	0	0	6	0	0
12	24056738	.	G	A	3	4	7	0	0	7	0	0
12	24056755	.	T	A	3	3	6	0	0	6	0	0
12	24057167	.	C	G	2	4	6	0	0	6	0	0
12	24057198	.	G	T	2	2	4	0	0	4	0	0
12	24057368	.	G	A	4	8	12	0	0	13	1	0
12	24060008	.	A	G	5	5	10	0	0	10	0	0
12	24061107	.	G	T	4	4	8	0	0	8	0	0
12	24061145	.	A	G	6	2	8	0	0	8	0	0
12	24061231	.	G	C	4	4	8	0	0	8	0	0
12	24061312	.	G	T	2	4	6	0	3	9	0	0
12	24067592	.	T	A	3	4	7	0	0	7	0	0
12	24067610	.	C	T	2	8	10	0	0	10	0	0
12	24072946	.	A	G	2	5	7	0	0	7	0	0
12	24342531	.	G	A	11	13	24	0	0	24	0	0
12	24345339	.	T	C	5	10	15	0	2	17	0	0
12	24447515	.	G	A	3	14	17	0	9	26	0	0
12	24465541	.	C	T	21	23	44	1	0	45	0	0
12	24465607	.	C	T	21	19	40	0	0	40	0	0
12	24465712	.	T	C	18	25	43	0	1	44	0	0
12	24465875	.	A	C	17	14	31	0	2	33	0	0
12	24484083	.	A	C	20	21	41	1	0	42	0	0
12	24484084	.	C	T	20	21	41	1	0	42	0	0
12	24561971	.	G	A	5	9	14	0	0	14	0	0
12	24562338	.	C	T	5	6	11	0	0	11	0	0
12	24562365	.	A	G	5	1	6	0	4	10	0	0
12	24562410	.	A	G	5	5	10	0	1	11	0	0
12	24562909	.	C	T	13	4	17	0	0	17	0	0
12	24607140	.	G	A	2	27	29	0	36	65	0	0
12	24607215	.	G	A	38	26	64	0	4	68	0	0
12	24636997	.	T	G	19	24	43	0	1	44	0	0
12	24797413	.	C	T	14	9	23	0	2	25	0	0
12	24797999	.	G	C	10	5	15	0	0	15	0	0
12	24798235	.	A	G	16	6	22	0	0	22	0	0
12	24798237	.	T	G	16	6	22	0	0	22	0	0
12	24811369	.	G	A	10	6	16	0	0	16	0	0
12	24811441	.	C	A	6	4	10	0	0	10	0	0
12	24811468	.	G	A	6	5	11	0	0	11	0	0
12	24811489	.	A	G	9	5	14	0	0	14	0	0
12	24811558	.	T	C	3	0	3	0	8	11	0	0
12	24841940	.	C	A	5	8	13	0	1	14	0	0
12	24841945	.	A	G	9	6	15	0	3	18	0	0
12	24842119	.	A	G	11	15	26	0	0	26	0	0
12	24842121	.	G	A	12	15	27	0	0	27	0	0
12	24842597	.	C	T	0	5	5	0	2	7	0	0
12	24843424	.	T	C	19	0	19	0	15	34	0	0
12	24843451	.	C	T	14	15	29	0	1	30	0	0
12	24847330	.	T	G	16	14	30	0	0	30	0	0
12	24848399	.	G	A	4	12	16	0	0	16	0	0
12	24848651	.	C	T	4	7	11	0	0	11	0	0
12	24848678	.	A	G	4	8	12	0	0	12	0	0
12	24848687	.	A	G	4	8	12	0	0	12	0	0
12	24848765	.	T	C	9	7	16	0	0	16	0	0
12	24851165	.	T	C	17	11	28	0	0	28	0	0
12	24851264	.	G	A	11	10	21	0	2	23	0	0
12	24851297	.	G	A	10	14	24	0	0	24	0	0
12	24854643	.	T	G	3	2	5	0	1	6	0	0
12	24857814	.	T	C	10	7	17	0	0	17	0	0
12	24904842	.	T	C	13	6	19	0	0	19	0	0
12	24906618	.	T	C	3	7	10	0	0	10	0	0
12	24910206	.	A	G	4	4	8	0	1	9	0	0
12	24910222	.	C	G	5	5	10	0	0	10	0	0
12	24910546	.	T	A	3	8	11	0	0	11	0	0
12	24913535	.	G	C	1	6	7	0	0	7	0	0
12	24913609	.	C	A	2	6	8	0	0	8	0	0
12	24918034	.	C	T	3	3	6	0	0	6	0	0
12	24918747	.	C	A	2	4	6	0	1	7	0	0
12	24920788	.	A	G	2	7	9	0	0	9	0	0
12	24922646	.	A	T	2	5	7	0	0	7	0	0
12	24953532	.	C	G	15	7	22	0	0	22	0	0
12	24957267	.	A	G	42	34	76	0	3	79	0	0
12	24957416	.	T	C	49	37	86	0	9	95	0	0
12	24957806	.	A	G	33	45	78	0	5	83	0	0
12	25043221	.	A	G	5	9	14	0	1	15	0	0
12	25043324	.	C	T	0	4	4	0	9	13	0	0
12	25043594	.	C	T	10	5	15	0	1	16	0	0
12	25044516	.	A	G	10	8	18	0	0	18	0	0
12	25044540	.	C	T	7	5	12	0	2	14	0	0
12	25044786	.	T	G	8	11	19	0	1	20	0	0
12	25045074	.	T	C	6	9	15	0	2	17	0	0
12	25045174	.	C	T	9	15	24	0	1	25	0	0
12	25045315	.	C	T	1	7	8	0	11	19	0	0
12	25065680	.	A	G	7	8	15	0	0	15	0	0
12	25094107	.	T	G	10	10	20	0	2	22	0	0
12	25094201	.	T	C	9	7	16	0	0	16	0	0
12	25094359	.	T	C	2	14	16	0	0	16	0	0
12	25094401	.	C	T	5	6	11	0	2	13	0	0
12	25094484	.	T	C	11	4	15	0	0	15	0	0
12	25149179	.	C	G	11	7	18	0	1	19	0	0
12	25149203	.	G	A	8	8	16	0	0	16	0	0
12	25205542	.	A	T	5	2	7	0	0	7	0	0
12	25209754	.	G	C	1	2	3	0	0	3	0	0
12	25216701	.	G	A	3	2	5	0	0	5	0	0
12	25230976	.	A	G	10	8	18	0	1	19	0	0
12	25251716	.	G	A	6	7	13	0	1	14	0	0
12	25254891	.	T	C	13	9	22	0	2	24	0	0
12	25271404	.	T	G	13	13	26	0	2	28	0	0
12	25271409	.	C	A	16	14	30	0	0	30	0	0
12	25271598	.	C	T	7	19	26	0	0	26	0	0
12	25284375	.	G	A	21	17	38	0	0	38	0	0
12	25284414	.	T	C	19	16	35	0	0	35	0	0
12	25284423	.	G	A	18	14	32	0	1	33	0	0
12	25377318	.	A	C	4	0	4	0	8	12	0	0
12	25377345	.	A	T	3	5	8	0	0	8	0	0
12	25377354	.	A	C	3	4	7	0	0	7	0	0
12	25377690	.	T	A	3	4	7	0	0	7	0	0
12	25377797	.	A	T	5	6	11	1	0	12	0	0
12	25377817	.	C	G	6	2	8	1	1	10	0	0
12	25378351	.	G	A	15	12	27	0	0	27	0	0
12	25378354	.	C	T	1	8	9	0	15	25	1	0
12	25378420	.	A	G	12	8	20	0	3	24	1	0
12	25378475	.	G	A	10	11	21	0	0	21	0	0
12	25378506	.	C	A	2	12	14	0	13	27	0	0
12	25378555	.	T	C	16	7	23	0	0	23	0	0
12	25378848	.	G	T	9	5	14	0	1	15	0	0
12	25378882	.	G	T	6	5	11	0	1	12	0	0
12	25467742	.	C	T	15	15	30	0	0	30	0	0
12	25467823	.	T	C	11	12	23	0	1	24	0	0
12	25467887	.	T	C	8	8	16	0	1	17	0	0
12	25468312	.	C	T	20	21	41	0	2	43	0	0
12	25472281	.	C	T	25	22	47	0	0	47	0	0
12	25472290	.	A	G	23	3	26	0	21	47	0	0
12	25483514	.	T	C	4	4	8	0	1	9	0	0
12	25484586	.	G	A	19	16	35	0	3	38	0	0
12	25484676	.	T	G	18	21	39	0	0	39	0	0
12	25485203	.	C	T	9	11	20	0	2	22	0	0
12	25600834	.	A	G	5	9	14	0	3	17	0	0
12	25602616	.	T	A	11	13	24	0	0	24	0	0
12	25602820	.	T	A	5	6	11	0	2	13	0	0
12	25602828	.	T	A	8	4	12	0	0	12	0	0
12	25703490	.	A	G	18	0	18	0	23	41	0	0
12	25705600	.	G	A	13	13	26	0	0	26	0	0
12	25713629	.	G	C	17	14	31	0	2	33	0	0
12	25714409	.	T	C	14	15	29	0	0	29	0	0
12	25714480	.	T	G	19	16	35	0	0	35	0	0
12	25754150	.	C	T	4	14	18	1	0	19	0	0
12	25754225	.	C	T	15	17	32	0	1	33	0	0
12	25768096	.	C	T	35	14	49	0	1	50	0	0
12	25768326	.	T	A	22	28	50	0	6	56	0	0
12	25768580	.	G	A	5	20	25	0	17	42	0	0
12	25768660	.	A	T	1	6	7	0	0	7	0	0
12	25768830	.	T	C	4	14	18	0	0	18	0	0
12	25769012	.	G	A	19	20	39	0	2	41	0	0
12	25769177	.	A	T	10	14	24	0	4	28	0	0
12	25769752	.	G	A	20	27	47	0	2	49	0	0
12	25769889	.	G	A	6	8	14	0	1	15	0	0
12	25826208	.	G	A	2	3	5	0	0	5	0	0
12	25828470	.	C	T	3	4	7	0	0	7	0	0
12	25828756	.	G	A	1	2	3	0	0	3	0	0
12	25828763	.	G	A	0	2	2	0	1	3	0	0
12	25828816	.	A	T	1	2	3	0	0	3	0	0
12	25829046	.	T	C	1	1	2	0	1	3	0	0
12	25829105	.	T	C	2	5	7	1	0	8	0	0
12	25829168	.	A	G	2	2	4	1	1	6	0	0
12	25845511	.	T	C	13	3	16	0	0	16	0	0
12	25845512	.	G	A	13	3	16	0	0	16	0	0
12	25846021	.	T	C	19	19	38	0	1	39	0	0
12	25856178	.	T	A	18	14	32	0	3	35	0	0
12	25861006	.	T	C	20	15	35	0	1	36	0	0
12	25866543	.	G	A	19	19	38	0	1	39	0	0
12	25872834	.	C	A	17	11	28	0	0	28	0	0
12	25872933	.	C	T	21	13	34	0	2	36	0	0
12	25872938	.	C	A	18	16	34	0	4	39	1	0
12	25873241	.	C	T	11	13	24	0	2	26	0	0
12	25873289	.	C	T	13	15	28	0	2	30	0	0
12	25881185	.	G	C	1	20	21	0	12	33	0	0
12	25881254	.	A	C	21	16	37	0	1	38	0	0
12	25881778	.	T	C	14	19	33	0	4	37	0	0
12	25950895	.	G	C	1	0	1	0	2	3	0	0
12	25951057	.	A	G	3	7	10	0	0	10	0	0
12	25951101	.	C	T	3	6	9	0	1	10	0	0
12	25951761	.	C	T	1	3	4	0	5	9	0	0
12	25951781	.	C	A	4	3	7	0	1	8	0	0
12	25952026	.	A	G	3	5	8	0	1	9	0	0
12	25952027	.	C	G	4	5	9	0	0	9	0	0
12	25953817	.	T	C	3	4	7	0	1	8	0	0
12	25954447	.	A	G	3	4	7	0	0	7	0	0
12	25958962	.	C	T	3	3	6	0	0	6	0	0
12	25982664	.	A	T	2	8	10	0	0	10	0	0
12	26203891	.	C	T	1	15	16	0	10	26	0	0
12	26203900	.	A	T	10	17	27	0	0	27	0	0
12	26226655	.	C	G	1	7	8	0	10	18	0	0
12	26227042	.	C	T	10	7	17	0	1	18	0	0
12	26235368	.	T	C	6	9	15	0	2	17	0	0
12	26249908	.	G	A	6	5	11	0	0	11	0	0
12	26318397	.	C	T	0	7	7	0	9	16	0	0
12	26318515	.	A	G	15	11	26	0	1	27	0	0
12	26318625	.	G	A	9	9	18	0	1	19	0	0
12	26318702	.	A	G	15	7	22	0	0	22	0	0
12	26410014	.	C	T	1	3	4	0	0	4	0	0
12	26412467	.	T	G	1	3	4	0	0	4	0	0
12	26412498	.	A	G	1	5	6	0	0	6	0	0
12	26412554	.	T	G	2	9	11	0	0	11	0	0
12	26412787	.	T	C	1	3	4	0	0	4	0	0
12	26476093	.	C	G	12	19	31	0	1	32	0	0
12	26476319	.	A	G	13	19	32	0	0	32	0	0
12	26476424	.	A	G	10	11	21	0	0	21	0	0
12	26486421	.	C	G	19	26	45	0	1	46	0	0
12	26486446	.	A	C	21	27	48	0	3	51	0	0
12	26486580	.	T	C	13	12	25	0	1	26	0	0
12	26486753	.	T	C	9	14	23	0	2	25	0	0
12	26486934	.	T	A	8	9	17	0	0	17	0	0
12	26487002	.	A	T	13	12	25	0	0	25	0	0
12	26487044	.	G	A	8	9	17	0	0	17	0	0
12	26487292	.	T	G	3	2	5	0	0	5	0	0
12	26491761	.	C	A	1	4	5	0	0	5	0	0
12	26493806	.	C	T	4	3	7	0	3	10	0	0
12	26493836	.	G	A	1	6	7	0	9	16	0	0
12	26493870	.	G	T	7	9	16	0	0	16	0	0
12	26545262	.	C	G	1	2	3	0	2	5	0	0
12	26545416	.	G	T	1	2	3	0	0	3	0	0
12	26546851	.	G	T	0	4	4	0	0	4	0	0
12	26546855	.	C	T	1	3	4	0	0	4	0	0
12	26546965	.	A	G	3	2	5	0	0	5	0	0
12	26546966	.	A	G	3	2	5	0	0	5	0	0
12	26547261	.	A	C	4	0	4	0	7	11	0	0
12	26547276	.	A	C	3	8	11	0	0	11	0	0
12	26547397	.	C	T	7	3	10	0	1	11	0	0
12	26547688	.	A	T	3	4	7	0	2	9	0	0
12	26549729	.	G	A	3	3	6	0	0	6	0	0
12	26566780	.	G	A	1	4	5	1	0	6	0	0
12	26582535	.	A	T	1	2	3	0	0	3	0	0
12	26586957	.	C	T	3	5	8	0	0	8	0	0
12	26587216	.	G	A	1	4	5	0	2	7	0	0
12	26594165	.	C	T	0	6	6	0	11	17	0	0
12	26594216	.	G	A	15	12	27	0	2	29	0	0
12	26597512	.	C	T	1	7	8	0	10	18	0	0
12	26608882	.	C	T	1	5	6	0	6	12	0	0
12	26611673	.	A	T	3	2	5	0	0	5	0	0
12	26612038	.	A	G	8	9	17	0	0	17	0	0
12	26612188	.	T	C	9	0	9	0	8	17	0	0
12	26612225	.	C	G	7	8	15	0	1	16	0	0
12	26612390	.	G	C	7	9	16	0	2	18	0	0
12	26617621	.	C	A	3	6	9	0	0	9	0	0
12	26617882	.	G	A	6	4	10	0	0	10	0	0
12	26620426	.	A	G	2	6	8	0	0	8	0	0
12	26620612	.	T	G	1	3	4	0	0	4	0	0
12	26638166	.	G	A	6	7	13	0	0	13	0	0
12	26638274	.	G	A	13	4	17	0	1	18	0	0
12	26638640	.	C	T	10	4	14	0	0	14	0	0
12	26693547	.	G	A	10	8	18	0	0	18	0	0
12	26704300	.	C	T	8	9	17	0	2	19	0	0
12	26708821	.	G	A	1	10	11	0	11	22	0	0
12	26724285	.	A	T	10	4	14	0	0	14	0	0
12	26724327	.	C	A	8	5	13	0	0	13	0	0
12	26724413	.	G	T	11	4	15	0	0	15	0	0
12	26724762	.	A	G	10	0	10	0	8	18	0	0
12	26724975	.	A	G	17	0	17	0	8	25	0	0
12	26724984	.	A	T	18	7	25	0	0	25	0	0
12	26725079	.	C	A	19	5	24	0	0	24	0	0
12	26725402	.	A	G	8	9	17	0	1	18	0	0
12	26750431	.	G	A	5	6	11	0	1	12	0	0
12	26750619	.	A	G	13	16	29	0	0	29	0	0
12	26750924	.	A	C	2	3	5	0	0	5	0	0
12	26751414	.	G	A	14	15	29	0	4	33	0	0
12	26751489	.	A	G	16	10	26	0	1	27	0	0
12	26752074	.	A	C	3	2	5	0	1	6	0	0
12	26752391	.	T	C	7	0	7	0	8	15	0	0
12	26752400	.	C	T	8	10	18	0	0	18	0	0
12	26752528	.	C	T	10	8	18	0	0	18	0	0
12	26752730	.	C	T	1	11	12	0	14	26	0	0
12	26752778	.	G	C	13	6	19	0	1	20	0	0
12	26752871	.	G	A	9	11	20	0	0	20	0	0
12	26752946	.	G	A	8	7	15	0	2	17	0	0
12	26758251	.	A	G	10	10	20	0	0	20	0	0
12	26758521	.	A	G	5	12	17	0	0	17	0	0
12	26758710	.	A	C	4	5	9	0	0	9	0	0
12	26758722	.	T	C	3	6	9	0	0	9	0	0
12	26758793	.	G	T	10	3	13	0	0	13	0	0
12	26761017	.	G	A	7	5	12	0	0	12	0	0
12	26764315	.	C	T	0	7	7	0	7	14	0	0
12	26764416	.	C	T	1	9	10	0	3	13	0	0
12	26774720	.	A	G	6	8	14	0	3	17	0	0
12	26961184	.	C	T	2	6	8	0	0	8	0	0
12	27023301	.	C	T	9	8	17	0	0	17	0	0
12	27023677	.	C	T	11	8	19	0	2	21	0	0
12	27024941	.	A	G	12	9	21	0	0	21	0	0
12	27025481	.	C	T	13	11	24	0	1	25	0	0
12	27026528	.	A	C	2	7	9	0	0	9	0	0
12	27029347	.	T	C	18	1	19	0	16	35	0	0
12	27029648	.	C	T	12	18	30	0	2	32	0	0
12	27030917	.	T	C	18	1	19	0	13	32	0	0
12	27036471	.	A	G	5	5	10	0	0	10	0	0
12	27036570	.	A	C	5	5	10	0	0	10	0	0
12	27037804	.	C	T	4	7	11	0	0	11	0	0
12	27037813	.	C	T	5	7	12	0	0	12	0	0
12	27050766	.	A	G	7	8	15	0	3	18	0	0
12	27059070	.	A	G	14	13	27	0	3	30	0	0
12	27059581	.	T	C	15	8	23	0	1	24	0	0
12	27059901	.	A	T	27	15	42	0	0	42	0	0
12	27059910	.	A	T	25	15	40	0	0	40	0	0
12	27060018	.	C	T	15	11	26	0	2	28	0	0
12	27060087	.	C	A	4	12	16	0	1	17	0	0
12	27060572	.	G	A	9	9	18	0	0	18	0	0
12	27061951	.	A	T	1	3	4	0	1	5	0	0
12	27064684	.	T	G	3	5	8	0	0	8	0	0
12	27065002	.	A	G	6	8	14	0	0	14	0	0
12	27065056	.	C	A	7	6	13	0	2	15	0	0
12	27065470	.	A	C	3	7	10	0	0	10	0	0
12	27065471	.	C	A	2	7	9	0	0	9	0	0
12	27065942	.	T	C	3	5	8	0	1	9	0	0
12	27066169	.	C	G	3	2	5	0	1	6	0	0
12	27068492	.	G	A	7	13	20	0	3	23	0	0
12	27068513	.	C	A	5	15	20	0	1	21	0	0
12	27072033	.	T	C	10	5	15	0	0	15	0	0
12	27073084	.	A	G	7	12	19	0	1	20	0	0
12	27073135	.	T	C	5	7	12	0	1	13	0	0
12	27078324	.	A	T	7	12	19	0	1	20	0	0
12	27086658	.	C	T	13	11	24	0	0	24	0	0
12	27086943	.	T	C	7	9	16	0	0	16	0	0
12	27086958	.	C	T	9	8	17	0	1	18	0	0
12	27087261	.	A	G	8	4	12	0	0	12	0	0
12	27087342	.	C	A	10	8	18	0	0	18	0	0
12	27087375	.	T	C	8	8	16	0	1	17	0	0
12	27087570	.	A	T	13	11	24	0	2	26	0	0
12	27087635	.	T	C	14	7	21	0	0	21	0	0
12	27087844	.	G	A	9	14	23	0	1	24	0	0
12	27088199	.	T	C	13	6	19	0	0	19	0	0
12	27088286	.	G	T	6	13	19	0	1	20	0	0
12	27088304	.	T	C	8	12	20	0	0	20	0	0
12	27088357	.	C	T	8	18	26	0	1	27	0	0
12	27088383	.	A	C	9	16	25	0	0	25	0	0
12	27088646	.	T	A	11	20	31	0	1	32	0	0
12	27088758	.	A	C	9	2	11	0	0	11	0	0
12	27088767	.	G	A	9	3	12	0	1	13	0	0
12	27088821	.	A	G	10	0	10	0	11	21	0	0
12	27088836	.	T	C	7	10	17	0	1	18	0	0
12	27089531	.	G	C	13	6	19	0	3	22	0	0
12	27089857	.	T	C	23	11	34	0	0	34	0	0
12	27090630	.	A	C	12	14	26	0	1	27	0	0
12	27090663	.	G	A	0	17	17	0	12	29	0	0
12	27090696	.	A	T	15	15	30	0	2	32	0	0
12	27090756	.	A	G	10	18	28	0	0	28	0	0
12	27090824	.	T	G	17	13	30	0	2	32	0	0
12	27090856	.	A	T	11	9	20	0	2	22	0	0
12	27090864	.	G	C	10	11	21	0	1	22	0	0
12	27090918	.	G	A	9	8	17	0	1	18	0	0
12	27091163	.	C	A	3	10	13	0	2	15	0	0
12	27091305	.	T	C	8	17	25	0	1	26	0	0
12	27119727	.	G	A	1	3	4	0	0	4	0	0
12	27127436	.	T	A	1	2	3	0	2	5	0	0
12	27128299	.	T	A	7	2	9	0	0	9	0	0
12	27128305	.	A	G	7	2	9	0	0	9	0	0
12	27130237	.	G	A	2	11	13	0	12	25	0	0
12	27131224	.	T	C	5	3	8	0	0	8	0	0
12	27142089	.	T	A	4	3	7	0	0	7	0	0
12	27207050	.	T	G	5	10	15	0	4	19	0	0
12	27207053	.	C	T	9	10	19	0	0	19	0	0
12	27207130	.	G	A	6	7	13	0	1	14	0	0
12	27207466	.	T	C	23	11	34	0	2	36	0	0
12	27218781	.	C	T	12	9	21	0	0	21	0	0
12	27219143	.	C	T	13	10	23	0	0	23	0	0
12	27219450	.	T	C	4	6	10	0	1	11	0	0
12	27219761	.	T	A	11	15	26	0	0	26	0	0
12	27219818	.	G	A	0	15	15	0	8	23	0	0
12	27220582	.	T	C	15	15	30	0	0	30	0	0
12	27221491	.	G	A	16	16	32	0	1	33	0	0
12	27221505	.	A	T	14	18	32	0	1	33	0	0
12	27224057	.	G	A	10	13	23	0	2	25	0	0
12	27224090	.	C	G	10	1	11	0	15	26	0	0
12	27224727	.	T	C	7	11	18	0	0	18	0	0
12	27229078	.	A	G	20	7	27	0	0	27	0	0
12	27229216	.	T	A	13	13	26	0	2	28	0	0
12	27229438	.	T	G	9	7	16	0	0	16	0	0
12	27229647	.	C	A	8	7	15	0	0	15	0	0
12	27241657	.	A	G	2	6	8	0	0	8	0	0
12	27242416	.	G	A	3	6	9	0	0	9	0	0
12	27243208	.	A	G	10	9	19	0	0	19	0	0
12	27243236	.	T	C	14	10	24	0	1	25	0	0
12	27303000	.	A	G	8	4	12	0	0	12	0	0
12	27303211	.	C	T	11	4	15	0	1	16	0	0
12	27303288	.	C	T	9	7	16	0	2	18	0	0
12	27303295	.	A	C	9	9	18	0	2	20	0	0
12	27303328	.	T	C	12	7	19	0	0	19	0	0
12	27303486	.	A	T	14	19	33	0	1	34	0	0
12	27303496	.	T	C	13	19	32	0	2	34	0	0
12	27303521	.	C	T	13	15	28	0	1	29	0	0
12	27304064	.	C	T	7	5	12	0	0	12	0	0
12	27304316	.	A	T	14	6	20	0	0	20	0	0
12	27304596	.	T	A	10	12	22	0	1	23	0	0
12	27304650	.	A	G	11	0	11	0	14	25	0	0
12	27304704	.	A	C	13	17	30	0	0	30	0	0
12	27305054	.	G	A	19	12	31	0	1	32	0	0
12	27305495	.	C	A	10	15	25	0	0	25	0	0
12	27305503	.	A	G	10	15	25	0	0	25	0	0
12	27557809	.	C	T	2	6	8	0	0	8	0	0
12	27558619	.	G	C	7	6	13	0	0	13	0	0
12	27558705	.	G	T	2	3	5	0	1	6	0	0
12	27559653	.	T	C	5	6	11	0	0	11	0	0
12	27563459	.	C	T	5	7	12	0	0	12	0	0
12	27568288	.	T	A	5	3	8	0	1	9	0	0
12	27570675	.	A	G	9	10	19	0	0	19	0	0
12	27570725	.	T	A	12	10	22	0	0	22	0	0
12	27570759	.	T	G	11	7	18	0	1	19	0	0
12	27570838	.	C	G	7	7	14	0	1	15	0	0
12	27570869	.	A	T	2	7	9	0	1	10	0	0
12	27570964	.	G	A	2	4	6	0	0	6	0	0
12	27570998	.	T	A	3	4	7	0	0	7	0	0
12	27571015	.	A	G	4	5	9	0	0	9	0	0
12	27571076	.	C	A	6	4	10	0	1	11	0	0
12	27571142	.	A	C	9	5	14	0	0	14	0	0
12	27571151	.	A	T	8	5	13	0	0	13	0	0
12	27571213	.	T	C	7	0	7	0	4	11	0	0
12	27571224	.	C	T	8	4	12	0	0	12	0	0
12	27571625	.	G	A	9	9	18	0	0	18	0	0
12	27573030	.	G	A	15	7	22	0	0	22	0	0
12	27573072	.	G	A	14	8	22	0	0	22	0	0
12	27575444	.	T	C	9	7	16	0	0	16	0	0
12	27575776	.	T	G	6	4	10	0	1	11	0	0
12	27580100	.	A	C	7	6	13	0	0	13	0	0
12	27580166	.	T	C	5	9	14	0	3	17	0	0
12	27584590	.	A	T	6	6	12	0	0	12	0	0
12	27584827	.	C	T	1	5	6	0	9	15	0	0
12	27586719	.	G	A	4	5	9	0	0	9	0	0
12	27591232	.	G	A	7	8	15	0	0	15	0	0
12	27593678	.	T	C	6	10	16	0	1	17	0	0
12	27593868	.	A	C	9	4	13	0	0	13	0	0
12	27593892	.	C	T	8	7	15	0	1	16	0	0
12	27593922	.	T	G	6	8	14	0	1	15	0	0
12	27595297	.	T	A	5	9	14	0	1	15	0	0
12	27602080	.	A	T	10	8	18	0	0	18	0	0
12	27615642	.	A	G	10	1	11	0	7	18	0	0
12	27622254	.	C	T	8	9	17	0	0	17	0	0
12	27622321	.	G	A	5	4	9	0	0	9	0	0
12	27622336	.	C	A	4	3	7	0	0	7	0	0
12	27627528	.	G	C	8	9	17	1	0	18	0	0
12	27665035	.	T	C	10	16	26	0	0	26	0	0
12	27665289	.	G	C	8	15	23	0	0	23	0	0
12	27665502	.	T	A	5	2	7	0	0	7	0	0
12	27704351	.	C	T	4	6	10	0	1	11	0	0
12	27889992	.	T	C	5	4	9	0	0	9	0	0
12	27902711	.	A	C	7	4	11	0	0	11	0	0
12	27902871	.	A	G	4	1	5	0	5	10	0	0
12	27906193	.	A	C	4	9	13	0	0	13	0	0
12	27925629	.	C	T	4	7	11	0	0	11	0	0
12	27926619	.	C	T	1	2	3	0	0	3	0	0
12	27926674	.	T	C	3	5	8	0	0	8	0	0
12	27943009	.	T	C	8	7	15	0	1	16	0	0
12	27999503	.	C	T	9	6	15	0	0	15	0	0
12	28003340	.	C	T	8	6	14	0	1	15	0	0
12	28003358	.	C	T	8	6	14	0	1	15	0	0
12	28033169	.	C	T	11	8	19	0	0	19	0	0
12	28049096	.	G	A	13	7	20	0	1	21	0	0
12	28072821	.	C	G	24	8	32	0	1	33	0	0
12	28120585	.	C	T	1	4	5	0	0	5	0	0
12	28120615	.	A	G	2	0	2	0	3	5	0	0
12	28298889	.	C	A	4	2	6	0	0	6	0	0
12	28299293	.	T	C	1	3	4	0	0	4	0	0
12	28348521	.	G	A	2	3	5	0	0	5	0	0
12	28350566	.	A	G	10	10	20	0	0	20	0	0
12	28351160	.	G	C	6	3	9	0	0	9	0	0
12	28354243	.	C	T	11	10	21	0	0	21	0	0
12	28355486	.	G	A	13	7	20	0	0	20	0	0
12	28359161	.	G	A	15	8	23	0	0	23	0	0
12	28367757	.	T	A	29	18	47	0	1	48	0	0
12	28369391	.	G	A	4	16	20	0	27	47	0	0
12	28369412	.	G	T	30	14	44	0	7	51	0	0
12	28369540	.	C	A	25	25	50	0	4	54	0	0
12	28369615	.	G	C	2	19	21	0	31	52	0	0
12	28369909	.	G	T	4	28	32	0	21	53	0	0
12	28369981	.	C	T	22	27	49	0	1	50	0	0
12	28370062	.	G	C	4	20	24	0	26	50	0	0
12	28370335	.	A	C	25	27	52	0	4	56	0	0
12	28370474	.	T	G	10	2	12	0	32	44	0	0
12	28377909	.	T	A	2	3	5	0	1	6	0	0
12	28377976	.	G	A	2	2	4	1	0	5	0	0
12	28377990	.	G	A	3	2	5	1	1	7	0	0
12	28378045	.	A	T	6	3	9	0	0	9	0	0
12	28378139	.	G	A	3	6	9	0	2	11	0	0
12	28378237	.	A	C	1	5	6	0	0	6	0	0
12	28378394	.	C	A	1	2	3	0	5	8	0	0
12	28378418	.	G	A	5	2	7	0	0	7	0	0
12	28378645	.	C	T	3	2	5	0	0	5	0	0
12	28378788	.	C	T	3	3	6	0	0	6	0	0
12	28379215	.	C	T	7	3	10	0	1	11	0	0
12	28379218	.	C	T	6	4	10	0	0	10	0	0
12	28379646	.	T	C	7	4	11	0	0	11	0	0
12	28379647	.	G	A	7	4	11	0	0	11	0	0
12	28379860	.	C	T	3	3	6	0	0	6	0	0
12	28380082	.	G	T	4	2	6	0	0	6	0	0
12	28380086	.	G	A	4	2	6	0	0	6	0	0
12	28380175	.	A	C	2	2	4	0	0	4	0	0
12	28380215	.	C	T	0	2	2	0	2	4	0	0
12	28449032	.	G	T	4	5	9	0	0	9	0	0
12	28457292	.	C	T	2	4	6	0	0	6	0	0
12	28459436	.	G	T	1	3	4	0	0	4	0	0
12	28476588	.	G	A	2	4	6	0	1	7	0	0
12	28477963	.	G	A	4	3	7	0	0	7	0	0
12	28496613	.	A	C	2	3	5	0	0	5	0	0
12	28497879	.	T	C	1	4	5	0	0	5	0	0
12	28497933	.	A	G	2	5	7	0	0	7	0	0
12	28511104	.	G	T	1	2	3	0	0	3	0	0
12	28537214	.	A	T	1	3	4	0	0	4	0	0
12	28559939	.	T	C	8	4	12	0	0	12	0	0
12	28560354	.	T	A	3	2	5	0	0	5	0	0
12	28560370	.	G	T	2	2	4	0	0	4	0	0
12	28560494	.	T	C	6	5	11	0	1	12	0	0
12	28560734	.	T	C	7	5	12	0	0	12	0	0
12	28560990	.	T	C	10	6	16	0	0	16	0	0
12	28561253	.	G	A	2	5	7	0	0	7	0	0
12	28561420	.	C	T	8	3	11	0	0	11	0	0
12	28561778	.	A	T	4	9	13	0	1	14	0	0
12	28561875	.	A	C	1	0	1	0	2	3	0	0
12	28568138	.	T	A	4	5	9	0	0	9	0	0
12	28568350	.	G	A	6	5	11	0	0	11	0	0
12	28570908	.	G	A	6	6	12	0	0	12	0	0
12	28668713	.	A	T	23	19	42	0	0	42	0	0
12	28676131	.	C	T	11	19	30	0	0	30	0	0
12	28676307	.	C	T	11	10	21	1	0	22	0	0
12	28676551	.	A	G	15	0	15	0	11	26	0	0
12	28676844	.	A	T	17	9	26	0	0	26	0	0
12	28677202	.	C	T	18	9	27	0	1	28	0	0
12	28677314	.	A	G	12	15	27	0	0	27	0	0
12	28677413	.	T	C	17	6	23	0	0	23	0	0
12	28677576	.	A	T	14	8	22	0	0	22	0	0
12	28797777	.	T	C	4	7	11	0	1	12	0	0
12	28799604	.	G	C	4	6	10	0	0	10	0	0
12	28800029	.	A	G	6	4	10	0	0	10	0	0
12	28801271	.	A	G	14	0	14	0	11	25	0	0
12	28802016	.	T	C	14	14	28	0	2	30	0	0
12	28806022	.	G	A	1	7	8	0	5	13	0	0
12	28806062	.	C	T	7	7	14	0	2	16	0	0
12	28806180	.	C	T	13	4	17	0	2	19	0	0
12	28806285	.	G	A	8	3	11	0	0	11	0	0
12	28806396	.	C	A	6	2	8	0	2	10	0	0
12	28806459	.	A	T	9	14	23	0	0	23	0	0
12	28806494	.	G	A	12	13	25	0	0	25	0	0
12	28806530	.	G	C	13	10	23	0	0	23	0	0
12	28806584	.	T	G	15	3	18	0	1	19	0	0
12	28806586	.	A	T	15	4	19	0	0	19	0	0
12	28806857	.	T	A	1	11	12	0	0	12	0	0
12	28806861	.	T	G	1	12	13	0	0	13	0	0
12	28826191	.	T	C	5	2	7	0	1	8	0	0
12	28827295	.	A	G	2	3	5	0	1	6	0	0
12	28827553	.	T	A	3	3	6	0	0	6	0	0
12	28827899	.	A	G	6	0	6	0	6	12	0	0
12	28828016	.	A	C	2	8	10	0	2	12	0	0
12	28828207	.	A	T	4	4	8	0	0	8	0	0
12	28828234	.	T	C	4	3	7	0	0	7	0	0
12	28828358	.	G	A	5	4	9	0	0	9	0	0
12	28830363	.	A	G	8	9	17	1	1	20	1	0
12	28835101	.	A	G	1	2	3	0	0	3	0	0
12	28844171	.	T	C	7	13	20	0	2	22	0	0
12	28847439	.	A	C	6	5	11	0	0	11	0	0
12	28856200	.	T	C	11	7	18	0	1	19	0	0
12	28856227	.	T	C	11	7	18	0	1	19	0	0
12	28863046	.	A	T	12	9	21	0	1	22	0	0
12	28863086	.	T	A	13	10	23	0	1	24	0	0
12	28863101	.	T	C	11	9	20	0	0	20	0	0
12	28863582	.	A	G	14	15	29	0	0	29	0	0
12	28863711	.	T	C	4	13	17	0	0	17	0	0
12	28863783	.	A	C	9	14	23	0	0	23	0	0
12	28863811	.	T	C	10	11	21	0	0	21	0	0
12	28864217	.	T	C	6	7	13	0	1	14	0	0
12	28864575	.	T	G	14	0	14	0	9	23	0	0
12	28864719	.	G	C	9	15	24	0	2	26	0	0
12	28864778	.	C	G	16	12	28	0	1	29	0	0
12	28864792	.	A	C	18	12	30	0	2	32	0	0
12	28864847	.	T	C	18	15	33	0	2	35	0	0
12	28865106	.	G	T	15	13	28	0	0	28	0	0
12	28865298	.	T	A	21	20	41	0	0	41	0	0
12	28865668	.	T	G	12	12	24	0	0	24	0	0
12	28865679	.	G	A	14	14	28	0	0	28	0	0
12	28865805	.	A	C	13	9	22	0	0	22	0	0
12	28870626	.	T	C	10	14	24	0	0	24	0	0
12	28870797	.	T	C	12	0	12	0	27	39	0	0
12	28870801	.	T	A	20	14	34	0	6	40	0	0
12	28870912	.	C	A	26	15	41	0	0	41	0	0
12	28871068	.	G	T	18	11	29	0	0	29	0	0
12	28871433	.	C	A	3	20	23	0	19	42	0	0
12	28878343	.	C	T	22	17	39	0	2	41	0	0
12	28889025	.	A	G	6	0	6	0	6	12	0	0
12	28889149	.	A	G	4	2	6	0	0	6	0	0
12	28899989	.	C	A	5	4	9	0	0	9	0	0
12	28912644	.	T	C	7	5	12	0	0	12	0	0
12	28912659	.	C	T	6	4	10	0	0	10	0	0
12	28916846	.	A	T	8	7	15	0	0	15	0	0
12	28918699	.	G	A	11	12	23	0	0	23	0	0
12	28924363	.	G	A	18	6	24	0	0	24	0	0
12	28927051	.	G	A	6	6	12	0	1	13	0	0
12	28930455	.	T	C	14	7	21	0	0	21	0	0
12	28932389	.	C	T	4	3	7	0	1	8	0	0
12	28932428	.	C	T	7	7	14	0	0	14	0	0
12	28932571	.	G	A	8	6	14	0	0	14	0	0
12	28932581	.	T	A	9	6	15	0	0	15	0	0
12	28945099	.	A	C	2	3	5	0	0	5	0	0
12	28945112	.	A	C	2	2	4	0	0	4	0	0
12	28945337	.	A	G	2	0	2	0	2	4	0	0
12	28948117	.	T	C	3	2	5	0	2	7	0	0
12	28949067	.	A	G	11	5	16	0	0	16	0	0
12	28949112	.	C	A	8	5	13	0	1	14	0	0
12	28950009	.	T	C	3	0	3	0	9	12	0	0
12	28950678	.	G	T	8	5	13	0	0	13	0	0
12	28951019	.	C	T	1	4	5	0	6	11	0	0
12	28952139	.	T	C	6	10	16	0	2	18	0	0
12	28952784	.	A	G	3	4	7	0	1	8	0	0
12	28955614	.	T	C	5	0	5	0	9	14	0	0
12	28956533	.	A	G	2	0	2	0	4	6	0	0
12	28956566	.	T	C	6	3	9	0	1	10	0	0
12	28956615	.	A	G	9	6	15	0	0	15	0	0
12	28958548	.	A	G	4	0	4	0	5	9	0	0
12	28959298	.	C	T	2	2	4	0	1	5	0	0
12	28959943	.	G	T	3	2	5	0	0	5	0	0
12	28960284	.	T	C	5	4	9	0	0	9	0	0
12	28960321	.	G	A	4	2	6	0	2	8	0	0
12	28960357	.	G	A	1	3	4	0	4	8	0	0
12	29054940	.	A	G	2	4	6	0	1	7	0	0
12	29054941	.	A	G	3	4	7	0	0	7	0	0
12	29055068	.	A	T	2	5	7	0	0	7	0	0
12	29063312	.	C	T	12	9	21	0	2	23	0	0
12	29063346	.	G	A	14	16	30	0	1	31	0	0
12	29084032	.	T	C	15	12	27	0	1	28	0	0
12	29102585	.	T	C	13	17	30	0	1	31	0	0
12	29103004	.	T	C	3	9	12	0	1	13	0	0
12	29103041	.	T	A	6	9	15	0	1	16	0	0
12	29173678	.	C	G	7	5	12	0	0	12	0	0
12	29173712	.	T	C	6	6	12	0	0	12	0	0
12	29207101	.	T	C	5	4	9	0	0	9	0	0
12	29207473	.	G	A	0	9	9	0	5	14	0	0
12	29207533	.	T	C	6	7	13	0	0	13	0	0
12	29207590	.	G	A	0	10	10	0	4	14	0	0
12	29207683	.	G	T	13	14	27	0	0	27	0	0
12	29208099	.	T	G	10	5	15	0	1	16	0	0
12	29209834	.	G	A	5	5	10	0	3	13	0	0
12	29209840	.	A	T	6	7	13	0	0	13	0	0
12	29210371	.	C	A	9	9	18	0	1	19	0	0
12	29210435	.	C	G	14	4	18	0	0	18	0	0
12	29210600	.	C	T	8	4	12	0	0	12	0	0
12	29210719	.	T	A	7	9	16	0	0	16	0	0
12	29211082	.	G	A	6	3	9	0	1	10	0	0
12	29211195	.	T	A	12	13	25	0	0	25	0	0
12	29211232	.	G	A	1	15	16	0	13	29	0	0
12	29211289	.	T	A	11	15	26	0	2	28	0	0
12	29211292	.	A	G	8	13	21	0	6	27	0	0
12	29223921	.	G	A	4	3	7	0	0	7	0	0
12	29223969	.	A	T	1	2	3	0	0	3	0	0
12	29224250	.	T	G	2	2	4	0	1	5	0	0
12	29224310	.	A	G	5	3	8	0	1	9	0	0
12	29224326	.	T	G	5	2	7	0	0	7	0	0
12	29224521	.	A	T	1	4	5	0	0	5	0	0
12	29224609	.	A	C	2	4	6	0	0	6	0	0
12	29224655	.	T	C	2	4	6	0	0	6	0	0
12	29224687	.	C	T	3	2	5	0	0	5	0	0
12	29226152	.	T	C	6	3	9	0	0	9	0	0
12	29226573	.	A	T	4	3	7	0	0	7	0	0
12	29226690	.	A	G	2	3	5	0	0	5	0	0
12	29226752	.	T	A	2	3	5	0	0	5	0	0
12	29226876	.	C	A	0	3	3	0	1	4	0	0
12	29227014	.	T	G	2	5	7	0	1	8	0	0
12	29227044	.	G	A	2	5	7	0	0	7	0	0
12	29229047	.	G	C	1	4	5	0	0	5	0	0
12	29229080	.	C	T	0	3	3	0	2	5	0	0
12	29229299	.	A	G	2	3	5	0	0	5	0	0
12	29233284	.	C	T	3	4	7	0	0	7	0	0
12	29240142	.	T	A	3	2	5	0	0	5	0	0
12	29244139	.	T	C	2	6	8	0	0	8	0	0
12	29251251	.	T	C	5	3	8	0	0	8	0	0
12	29251385	.	A	G	3	4	7	1	0	8	0	0
12	29251408	.	T	C	6	7	13	0	0	13	0	0
12	29251446	.	T	C	4	2	6	0	2	8	0	0
12	29251520	.	A	G	4	6	10	0	0	10	0	0
12	29260865	.	A	G	3	5	8	0	0	8	0	0
12	29262564	.	A	G	4	0	4	0	5	9	0	0
12	29266917	.	T	C	5	7	12	0	0	12	0	0
12	29269576	.	C	A	3	2	5	0	0	5	0	0
12	29269689	.	G	A	3	4	7	0	0	7	0	0
12	29269695	.	A	G	3	0	3	0	3	6	0	0
12	29269770	.	G	T	1	2	3	0	3	6	0	0
12	29269774	.	T	G	3	2	5	0	0	5	0	0
12	29351320	.	A	G	18	18	36	0	3	39	0	0
12	29351810	.	A	G	15	13	28	0	1	29	0	0
12	29358277	.	T	C	13	13	26	2	3	31	0	0
12	29358370	.	G	C	10	0	10	0	11	21	0	0
12	29358384	.	A	G	10	13	23	0	0	23	0	0
12	29358418	.	A	G	6	18	24	0	0	24	0	0
12	29624017	.	G	A	12	15	27	0	0	27	0	0
12	29624272	.	C	A	10	5	15	0	1	16	0	0
12	29624611	.	T	C	6	0	6	0	6	12	0	0
12	29764201	.	C	T	3	4	7	0	1	8	0	0
12	29764222	.	G	T	1	4	5	0	3	8	0	0
12	29801179	.	T	C	6	5	11	0	1	12	0	0
12	29801600	.	T	A	8	4	12	0	0	12	0	0
12	29806358	.	C	G	8	0	8	0	8	16	0	0
12	29811009	.	A	G	10	0	10	0	4	14	0	0
12	29843460	.	A	G	13	12	25	0	1	26	0	0
12	29844434	.	T	C	5	10	15	0	0	15	0	0
12	29873273	.	C	G	13	17	30	0	0	30	0	0
12	29921114	.	T	G	10	10	20	0	0	20	0	0
12	29947132	.	A	G	11	10	21	0	0	21	0	0
12	29947147	.	C	A	11	12	23	0	0	23	0	0
12	29957074	.	C	T	24	9	33	0	2	35	0	0
12	29957164	.	C	T	18	12	30	0	0	30	0	0
12	29965655	.	G	A	6	7	13	0	0	13	0	0
12	29965724	.	G	A	9	10	19	0	0	19	0	0
12	29965928	.	C	T	7	13	20	0	1	22	1	0
12	29965967	.	G	A	11	5	16	0	1	17	0	0
12	29966039	.	T	C	9	9	18	0	1	19	0	0
12	29966048	.	T	C	9	1	10	0	11	21	0	0
12	29968087	.	T	C	13	0	13	0	14	27	0	0
12	29973800	.	G	A	9	7	16	0	1	17	0	0
12	29976936	.	G	A	11	12	23	0	0	23	0	0
12	29976978	.	T	C	5	8	13	0	1	14	0	0
12	30031290	.	C	A	7	4	11	0	0	11	0	0
12	30031293	.	T	C	4	6	10	0	0	10	0	0
12	30031336	.	T	C	4	5	9	0	0	9	0	0
12	30031338	.	G	A	4	5	9	0	0	9	0	0
12	30031531	.	T	A	5	2	7	0	0	7	0	0
12	30031677	.	T	C	9	6	15	0	2	17	0	0
12	30031680	.	T	C	9	6	15	0	2	17	0	0
12	30129351	.	C	T	5	3	8	0	1	9	0	0
12	30153772	.	T	C	4	9	13	0	0	13	0	0
12	30156449	.	T	C	7	10	17	0	0	17	0	0
12	30192526	.	A	T	10	8	18	0	1	19	0	0
12	30200741	.	C	T	13	16	29	0	0	29	0	0
12	30207912	.	G	A	8	9	17	0	1	18	0	0
12	30208905	.	T	C	6	6	12	0	0	12	0	0
12	30211165	.	T	A	10	3	13	0	1	14	0	0
12	30216034	.	C	A	5	5	10	0	1	11	0	0
12	30216090	.	G	T	3	6	9	0	1	10	0	0
12	30216248	.	C	T	8	10	18	0	0	18	0	0
12	30216436	.	T	C	10	10	20	0	0	20	0	0
12	30216490	.	T	C	6	8	14	0	1	15	0	0
12	30216693	.	C	T	2	7	9	0	0	9	0	0
12	30216697	.	G	A	1	8	9	0	2	11	0	0
12	30217569	.	A	G	7	4	11	0	3	14	0	0
12	30217589	.	A	T	7	4	11	0	0	11	0	0
12	30217705	.	G	A	2	8	10	0	4	14	0	0
12	30217747	.	C	T	6	4	10	0	1	11	0	0
12	30217782	.	T	G	6	8	14	0	0	14	0	0
12	30217783	.	C	A	8	4	12	0	2	14	0	0
12	30217966	.	G	A	4	7	11	0	0	11	0	0
12	30217986	.	C	T	8	6	14	0	0	14	0	0
12	30218069	.	A	T	1	4	5	0	0	5	0	0
12	30218086	.	G	T	3	3	6	0	0	6	0	0
12	30218135	.	C	A	5	7	12	0	0	12	0	0
12	30218150	.	G	A	9	6	15	0	0	15	0	0
12	30218173	.	C	T	7	10	17	0	1	18	0	0
12	30219306	.	A	T	11	16	27	0	2	29	0	0
12	30219739	.	G	A	2	6	8	0	2	10	0	0
12	30219804	.	C	T	12	13	25	1	0	26	0	0
12	30292275	.	G	A	0	11	11	0	2	13	0	0
12	30292463	.	A	G	1	0	1	0	3	4	0	0
12	30299073	.	C	T	2	5	7	0	0	7	0	0
12	30302941	.	A	T	5	10	15	0	0	15	0	0
12	30303081	.	C	A	6	8	14	0	0	14	0	0
12	30305983	.	T	C	4	7	11	0	0	11	0	0
12	30307010	.	C	T	3	8	11	0	0	11	0	0
12	30307913	.	G	T	5	14	19	0	2	21	0	0
12	30372463	.	G	A	0	5	5	0	4	9	0	0
12	30372763	.	G	A	8	3	11	0	0	11	0	0
12	30382341	.	C	T	3	10	13	0	1	14	0	0
12	30382705	.	G	A	3	5	8	0	3	11	0	0
12	30383960	.	G	A	0	9	9	0	9	18	0	0
12	30385562	.	C	T	13	5	18	0	1	19	0	0
12	30391136	.	G	A	7	6	13	0	2	15	0	0
12	30418108	.	T	C	9	11	20	0	1	21	0	0
12	30418513	.	C	G	7	7	14	0	1	15	0	0
12	30419123	.	A	T	7	4	11	0	3	14	0	0
12	30419134	.	C	A	4	10	14	0	0	14	0	0
12	30419260	.	T	G	12	10	22	0	2	24	0	0
12	30419646	.	T	C	8	7	15	0	1	16	0	0
12	30419655	.	T	C	7	8	15	0	0	15	0	0
12	30419695	.	T	C	2	9	11	0	1	12	0	0
12	30442406	.	C	A	8	6	14	0	1	15	0	0
12	30442783	.	G	A	10	9	19	0	1	20	0	0
12	30443462	.	T	C	9	6	15	0	0	15	0	0
12	30459037	.	C	T	2	2	4	0	0	4	0	0
12	30459136	.	A	G	3	2	5	0	0	5	0	0
12	30459404	.	G	A	3	2	5	0	0	5	0	0
12	30459422	.	A	C	1	3	4	0	0	4	0	0
12	30459474	.	G	T	5	2	7	0	0	7	0	0
12	30459503	.	T	A	2	6	8	0	2	10	0	0
12	30459532	.	A	T	6	2	8	0	1	9	0	0
12	30459538	.	A	G	6	2	8	0	1	9	0	0
12	30461218	.	G	A	5	2	7	0	0	7	0	0
12	30461485	.	T	A	4	5	9	0	0	9	0	0
12	30467573	.	G	A	6	2	8	0	0	8	0	0
12	30467666	.	G	T	4	3	7	0	0	7	0	0
12	30504077	.	A	C	2	3	5	0	0	5	0	0
12	30504403	.	C	T	2	4	6	0	0	6	0	0
12	30504745	.	T	C	1	2	3	0	0	3	0	0
12	30508533	.	C	A	1	2	3	0	0	3	0	0
12	30706173	.	T	A	7	6	13	0	0	13	0	0
12	30706176	.	T	C	7	8	15	0	0	15	0	0
12	30712099	.	T	A	5	5	10	0	0	10	0	0
12	30741328	.	T	G	2	3	5	0	0	5	0	0
12	30750832	.	G	A	1	2	3	0	1	4	0	0
12	30788993	.	G	A	6	3	9	0	1	10	0	0
12	30793107	.	C	T	7	8	15	0	0	15	0	0
12	30796306	.	C	T	13	4	17	0	0	17	0	0
12	30796322	.	C	A	4	14	18	0	0	18	0	0
12	30796345	.	C	T	5	10	15	0	0	15	0	0
12	30796967	.	T	A	4	4	8	0	0	8	0	0
12	30798079	.	G	A	10	3	13	0	1	14	0	0
12	30798085	.	A	T	5	7	12	0	1	13	0	0
12	30800128	.	G	A	8	3	11	0	1	12	0	0
12	30803166	.	G	A	1	9	10	0	10	20	0	0
12	30803196	.	T	C	10	12	22	0	0	22	0	0
12	30803629	.	A	G	8	6	14	0	3	17	0	0
12	30805335	.	T	C	3	5	8	0	1	9	0	0
12	30805359	.	T	C	2	7	9	0	1	10	0	0
12	30805455	.	C	T	4	5	9	0	1	10	0	0
12	30806928	.	G	T	1	8	9	0	6	15	0	0
12	30807038	.	A	G	11	10	21	0	0	21	0	0
12	30807245	.	A	G	1	5	6	0	0	6	0	0
12	30807330	.	T	A	2	2	4	0	0	4	0	0
12	30807458	.	C	T	14	8	22	0	1	23	0	0
12	30807494	.	G	A	9	10	19	0	0	19	0	0
12	30807504	.	A	C	9	7	16	0	1	17	0	0
12	30807540	.	C	T	12	5	17	0	0	17	0	0
12	30807591	.	C	T	14	8	22	0	0	22	0	0
12	30807597	.	A	G	9	2	11	0	13	24	0	0
12	30807947	.	A	G	1	2	3	0	1	4	0	0
12	30808051	.	A	G	1	8	9	0	0	9	0	0
12	30808094	.	C	T	8	8	16	0	1	17	0	0
12	30808150	.	T	A	14	4	18	0	2	20	0	0
12	30808342	.	A	T	1	4	5	0	1	6	0	0
12	30808531	.	G	C	8	4	12	0	0	12	0	0
12	30808716	.	C	T	2	8	10	0	0	10	0	0
12	30808766	.	C	T	6	2	8	0	0	8	0	0
12	30808812	.	A	G	3	1	4	0	4	8	0	0
12	30979815	.	A	C	7	5	12	0	3	15	0	0
12	30980566	.	G	A	25	23	48	0	2	50	0	0
12	30981795	.	G	A	20	23	43	0	1	44	0	0
12	30986452	.	G	A	26	28	54	1	3	58	0	0
12	31102981	.	A	G	11	13	24	0	1	25	0	0
12	31435977	.	T	A	13	6	19	1	2	22	0	0
12	31438056	.	G	T	6	8	14	0	1	15	0	0
12	31479251	.	T	A	2	2	4	0	0	4	0	0
12	31516068	.	T	C	6	3	9	0	0	9	0	0
12	31516364	.	A	G	3	2	5	0	0	5	0	0
12	31520603	.	T	C	4	3	7	0	0	7	0	0
12	31520814	.	T	A	2	3	5	0	0	5	0	0
12	31520850	.	C	T	3	3	6	0	0	6	0	0
12	31528169	.	G	C	0	5	5	0	6	11	0	0
12	31528714	.	G	A	9	3	12	0	0	12	0	0
12	31531950	.	T	G	6	5	11	0	0	11	0	0
12	31532342	.	A	C	4	6	10	0	0	10	0	0
12	31532577	.	T	C	6	4	10	0	0	10	0	0
12	31532638	.	A	C	7	3	10	0	0	10	0	0
12	31532715	.	T	C	2	4	6	0	1	7	0	0
12	31629611	.	C	T	5	4	9	0	0	9	0	0
12	31630829	.	G	A	1	8	9	1	6	16	0	0
12	31631082	.	T	C	6	3	9	0	0	9	0	0
12	31631116	.	A	T	3	3	6	0	1	7	0	0
12	31631124	.	A	T	4	3	7	0	0	7	0	0
12	31631190	.	G	T	2	2	4	0	0	4	0	0
12	31664770	.	T	A	2	8	10	0	0	10	0	0
12	31664846	.	A	T	4	3	7	0	0	7	0	0
12	31665247	.	A	G	1	2	3	0	0	3	0	0
12	31665351	.	C	T	2	3	5	0	0	5	0	0
12	31689567	.	T	A	3	2	5	0	1	6	0	0
12	31704077	.	A	C	8	7	15	0	0	15	0	0
12	31704458	.	G	A	0	5	5	0	3	8	0	0
12	31704485	.	A	G	3	0	3	0	8	11	0	0
12	31704548	.	T	C	5	5	10	0	0	10	0	0
12	31704641	.	A	G	10	0	10	0	3	13	0	0
12	31704647	.	G	T	0	1	1	0	13	14	0	0
12	31708020	.	C	T	4	2	6	0	1	7	0	0
12	31708025	.	G	A	4	2	6	0	0	6	0	0
12	31708082	.	G	A	3	2	5	0	0	5	0	0
12	31708125	.	C	A	4	4	8	0	0	8	0	0
12	31720799	.	C	T	21	17	38	0	1	39	0	0
12	31721486	.	G	A	10	4	14	0	0	14	0	0
12	31722593	.	G	T	14	12	26	0	3	29	0	0
12	31722811	.	G	T	9	17	26	0	0	26	0	0
12	31722875	.	A	C	23	0	23	0	20	43	0	0
12	31724245	.	A	C	30	33	63	0	0	63	0	0
12	31724252	.	C	T	27	34	61	0	1	62	0	0
12	31724386	.	T	C	1	0	1	0	2	3	0	0
12	31729236	.	G	A	14	11	25	0	1	26	0	0
12	31729441	.	A	C	8	10	18	0	2	20	0	0
12	31729455	.	G	T	12	9	21	0	0	21	0	0
12	31738763	.	C	G	8	10	18	0	1	19	0	0
12	31740733	.	T	C	9	12	21	0	1	22	0	0
12	31740822	.	C	T	13	10	23	0	1	24	0	0
12	31741463	.	C	T	17	8	25	0	0	25	0	0
12	31743995	.	C	T	11	10	21	0	1	22	0	0
12	31753752	.	C	T	13	9	22	0	1	23	0	0
12	31753755	.	C	T	13	9	22	0	1	23	0	0
12	31764523	.	T	C	16	13	29	0	2	31	0	0
12	31764526	.	C	A	15	13	28	0	4	32	0	0
12	31765407	.	G	A	17	10	27	0	1	28	0	0
12	31765485	.	G	A	13	8	21	0	0	22	1	0
12	31765517	.	T	C	15	4	19	0	0	19	0	0
12	31765540	.	T	G	12	6	18	0	1	19	0	0
12	31783185	.	G	A	6	2	8	0	0	8	0	0
12	31785314	.	C	T	6	2	8	0	0	8	0	0
12	31785545	.	G	A	7	2	9	0	0	9	0	0
12	31787752	.	T	C	1	2	3	0	0	3	0	0
12	31787760	.	A	G	1	1	2	0	0	2	0	0
12	31789799	.	C	T	14	9	23	0	0	23	0	0
12	31794655	.	G	A	12	12	24	0	1	25	0	0
12	31911406	.	A	G	4	4	8	0	0	8	0	0
12	31919122	.	C	T	2	2	4	0	0	4	0	0
12	31919143	.	T	G	1	2	3	0	0	3	0	0
12	32039443	.	C	T	2	6	8	0	12	20	0	0
12	32039527	.	A	G	11	7	18	0	0	18	0	0
12	32039546	.	G	A	14	8	22	0	1	23	0	0
12	32039635	.	A	C	18	11	29	0	2	31	0	0
12	32039678	.	C	T	17	22	39	0	3	42	0	0
12	32039937	.	G	A	18	19	37	0	0	37	0	0
12	32039958	.	T	C	20	2	22	0	17	39	0	0
12	32040093	.	G	A	25	14	39	0	3	42	0	0
12	32045155	.	G	A	18	22	40	0	2	42	0	0
12	32045212	.	T	C	25	1	26	0	14	40	0	0
12	32051434	.	C	A	18	17	35	2	3	40	0	0
12	32051488	.	G	A	18	15	33	2	0	35	0	0
12	32066061	.	C	A	14	9	23	0	0	23	0	0
12	32068470	.	C	A	2	4	6	0	0	6	0	0
12	32068487	.	A	G	2	5	7	0	0	7	0	0
12	32068700	.	A	T	3	4	7	0	0	7	0	0
12	33336119	.	A	C	3	2	5	0	20	25	0	0
12	33371666	.	C	A	6	1	7	0	0	8	1	0
12	33966790	.	T	G	21	30	51	0	0	51	0	0
12	33966886	.	A	G	12	22	34	0	0	34	0	0
12	33966905	.	C	T	12	16	28	0	2	30	0	0
12	33967283	.	C	T	14	17	31	0	1	32	0	0
12	33968073	.	T	A	22	12	34	0	1	35	0	0
12	33971333	.	G	T	15	16	31	0	1	32	0	0
12	33972748	.	G	A	16	14	30	0	0	30	0	0
12	33978184	.	G	A	0	2	2	0	1	3	0	0
12	33984160	.	A	T	2	2	4	0	0	4	0	0
12	33988140	.	T	G	1	4	5	0	0	5	0	0
12	33988266	.	C	T	2	3	5	0	0	5	0	0
12	33988374	.	T	C	3	3	6	0	0	6	0	0
12	33988764	.	G	A	0	2	2	0	3	5	0	0
12	33991521	.	G	A	20	18	38	0	1	39	0	0
12	33991622	.	T	C	17	17	34	0	2	36	0	0
12	33991781	.	T	C	32	23	55	0	1	56	0	0
12	33991867	.	A	T	26	18	44	0	1	45	0	0
12	33991882	.	T	A	22	27	49	0	2	51	0	0
12	33991987	.	A	C	26	23	49	0	3	52	0	0
12	33992208	.	A	C	10	13	23	0	7	30	0	0
12	33992813	.	C	A	17	27	44	0	3	47	0	0
12	33993008	.	T	A	25	13	38	4	1	43	0	0
12	33993152	.	A	T	17	24	41	0	2	43	0	0
12	33993320	.	C	T	5	19	24	0	20	44	0	0
12	33997324	.	G	A	20	24	44	0	1	45	0	0
12	34119508	.	A	G	1	0	1	0	4	5	0	0
12	34119531	.	T	C	1	4	5	0	0	5	0	0
12	34127785	.	C	T	3	5	8	0	0	8	0	0
12	34180040	.	C	A	12	9	21	0	0	21	0	0
12	34180771	.	C	T	5	4	9	3	0	12	0	0
12	34187407	.	A	G	8	0	8	0	11	19	0	0
12	34192041	.	G	A	0	10	10	0	8	18	0	0
12	34192551	.	C	T	10	6	16	0	0	16	0	0
12	34192679	.	T	C	3	5	8	0	0	8	0	0
12	34192762	.	C	T	2	11	13	1	1	15	0	0
12	34192869	.	C	T	2	3	5	0	0	5	0	0
12	34192870	.	G	A	0	3	3	0	2	5	0	0
12	34209402	.	T	A	5	10	15	0	0	15	0	0
12	34209468	.	G	C	3	0	3	0	4	8	1	0
12	34219445	.	A	T	3	5	8	0	0	8	0	0
12	34219469	.	T	C	4	4	8	0	1	9	0	0
12	34219622	.	G	A	8	3	11	0	0	11	0	0
12	34219670	.	C	T	0	5	5	0	8	13	0	0
12	34378856	.	G	T	3	1	4	0	0	4	0	0
12	34378860	.	G	A	3	2	5	0	0	5	0	0
12	34435143	.	T	A	2	2	4	0	0	4	0	0
12	34563459	.	G	T	4	1	5	0	1	10	4	0
12	34563469	.	T	C	6	4	10	0	0	10	0	0
12	34564123	.	A	G	10	6	16	0	1	17	0	0
12	34564343	.	C	T	3	4	7	0	0	7	0	0
12	34564786	.	G	A	11	6	17	0	1	18	0	0
12	34564904	.	A	T	5	7	12	0	0	12	0	0
12	34565200	.	A	C	2	6	8	0	0	8	0	0
12	34565223	.	T	C	1	6	7	0	1	8	0	0
12	34565354	.	C	G	6	2	8	0	0	8	0	0
12	34565441	.	A	G	2	6	8	0	1	9	0	0
12	34565504	.	A	G	4	10	14	0	0	14	0	0
12	34565787	.	T	A	6	2	8	0	0	9	1	0
12	34566022	.	C	T	7	4	11	0	0	11	0	0
12	34566766	.	C	T	8	4	12	0	0	12	0	0
12	34568320	.	A	C	3	8	11	0	0	11	0	0
12	34568321	.	C	A	3	8	11	0	0	11	0	0
12	34568383	.	T	C	8	4	12	0	0	12	0	0
12	34574380	.	T	C	1	2	3	0	0	3	0	0
12	34574413	.	G	A	4	3	7	0	0	7	0	0
12	34574416	.	T	A	3	4	7	0	0	7	0	0
12	34577306	.	C	T	1	5	6	0	0	6	0	0
12	34580590	.	C	T	3	2	5	0	1	6	0	0
12	34581049	.	C	T	3	2	5	0	1	6	0	0
12	34581051	.	C	T	2	3	5	0	1	6	0	0
12	34595553	.	T	A	2	4	6	0	1	7	0	0
12	34606647	.	T	G	2	6	8	0	1	9	0	0
12	34617041	.	C	T	4	2	6	0	1	7	0	0
12	34638681	.	T	C	3	0	3	0	2	5	0	0
12	34768629	.	C	T	1	2	3	0	1	4	0	0
12	34810833	.	A	G	4	6	10	0	0	10	0	0
12	34819719	.	T	G	2	4	6	0	0	6	0	0
12	34819743	.	C	T	2	4	6	0	0	6	0	0
12	34820013	.	G	A	2	3	5	0	1	6	0	0
12	34820128	.	G	A	7	3	10	1	0	11	0	0
12	34820574	.	C	A	5	3	8	0	0	8	0	0
12	34821557	.	T	C	2	3	5	0	0	5	0	0
12	34830863	.	T	C	2	4	6	0	0	6	0	0
12	34834887	.	G	T	2	2	4	0	0	4	0	0
12	34834943	.	A	G	1	2	3	0	0	3	0	0
12	34837395	.	G	A	0	3	3	0	4	7	0	0
12	34837507	.	A	G	1	0	1	0	2	3	0	0
12	34840201	.	C	T	6	2	8	0	0	8	0	0
12	34841852	.	C	T	7	3	10	0	0	10	0	0
12	34841886	.	A	T	4	6	10	0	2	12	0	0
12	34841897	.	C	G	6	2	8	0	3	11	0	0
12	34841996	.	A	G	7	0	7	0	3	10	0	0
12	34842239	.	G	A	3	3	6	0	0	6	0	0
12	34845413	.	T	A	1	3	4	0	0	4	0	0
12	34845669	.	T	G	2	8	10	0	1	11	0	0
12	34845828	.	A	T	10	4	14	0	0	14	0	0
12	34845869	.	T	C	2	4	6	0	0	6	0	0
12	34845923	.	C	A	4	2	6	0	1	7	0	0
12	34847077	.	T	G	3	3	6	0	1	7	0	0
12	34847234	.	A	T	3	4	7	0	0	7	0	0
12	34847949	.	G	A	7	12	19	0	0	19	0	0
12	34847978	.	T	C	11	7	18	0	0	18	0	0
12	34851117	.	G	A	10	13	23	0	0	23	0	0
12	34876712	.	A	G	4	7	11	0	1	12	0	0
12	34877048	.	T	A	7	6	13	0	0	13	0	0
12	34883556	.	A	C	9	4	13	0	0	13	0	0
12	34883557	.	G	A	9	4	13	0	0	13	0	0
12	34883640	.	G	A	8	4	12	0	0	12	0	0
12	34884018	.	T	C	9	4	13	0	3	16	0	0
12	34884062	.	T	A	5	3	8	0	0	8	0	0
12	34884446	.	C	T	1	4	5	0	1	6	0	0
12	34891681	.	C	T	7	13	20	0	0	20	0	0
12	34891911	.	A	T	10	7	17	0	1	18	0	0
12	34892024	.	A	G	9	3	12	0	2	14	0	0
12	34892089	.	C	T	6	8	14	0	0	14	0	0
12	34892590	.	T	A	5	13	18	0	0	18	0	0
12	34953641	.	G	T	0	13	13	0	11	24	0	0
12	34981205	.	G	A	1	13	14	1	15	30	0	0
12	35012004	.	C	T	17	14	31	0	2	33	0	0
12	35012127	.	T	C	24	14	38	1	4	43	0	0
12	35014147	.	C	A	7	7	14	0	1	15	0	0
12	35018127	.	C	T	20	21	41	0	0	41	0	0
12	35018320	.	T	G	6	3	9	0	7	16	0	0
12	35018519	.	G	T	5	2	7	0	0	7	0	0
12	35021590	.	G	T	3	7	10	0	0	10	0	0
12	35021593	.	G	A	2	7	9	0	1	10	0	0
12	35051265	.	C	T	14	11	25	0	0	25	0	0
12	35082428	.	C	T	2	2	4	0	0	4	0	0
12	35085748	.	A	G	3	3	6	0	0	6	0	0
12	35085787	.	T	C	3	0	3	0	2	5	0	0
12	35099532	.	G	T	3	4	7	0	0	7	0	0
12	35099775	.	C	A	0	5	5	0	4	9	0	0
12	35103300	.	C	T	5	4	9	0	0	9	0	0
12	35103606	.	T	C	6	0	6	0	11	17	0	0
12	35119833	.	C	A	15	11	26	0	2	28	0	0
12	35120000	.	C	T	9	13	22	0	0	22	0	0
12	35146537	.	G	A	1	7	8	0	13	21	0	0
12	35158344	.	C	T	10	16	26	0	1	27	0	0
12	35167333	.	A	G	22	9	31	0	3	34	0	0
12	35178914	.	G	A	18	13	31	0	0	31	0	0
12	35189264	.	G	T	11	17	28	0	2	30	0	0
12	35189295	.	C	T	9	18	27	0	3	30	0	0
12	35189471	.	T	A	16	16	32	0	1	33	0	0
12	35191841	.	T	A	20	16	36	0	1	37	0	0
12	35191856	.	C	T	17	19	36	0	0	36	0	0
12	35270489	.	C	T	8	5	13	0	1	14	0	0
12	35270529	.	C	T	2	7	9	0	0	9	0	0
12	35316791	.	C	A	6	2	8	0	0	8	0	0
12	35317147	.	G	A	7	5	12	0	0	12	0	0
12	35317222	.	A	G	1	3	4	0	0	4	0	0
12	35317294	.	A	G	5	0	5	0	7	12	0	0
12	35317520	.	C	A	8	9	17	0	0	17	0	0
12	35317609	.	C	T	8	3	11	0	0	11	0	0
12	35317654	.	C	T	7	3	10	0	0	10	0	0
12	35325618	.	C	A	5	3	8	0	1	9	0	0
12	35325811	.	C	T	7	5	12	0	0	12	0	0
12	35328139	.	C	T	5	9	14	0	1	15	0	0
12	35330107	.	C	T	4	8	12	1	0	13	0	0
12	35332283	.	T	A	7	11	18	0	1	19	0	0
12	35334652	.	C	G	8	7	15	0	1	16	0	0
12	35339212	.	A	G	7	4	11	0	0	11	0	0
12	35339263	.	A	T	9	4	13	0	0	13	0	0
12	35339395	.	C	T	5	5	10	0	0	10	0	0
12	35346498	.	G	A	28	21	49	0	3	52	0	0
12	35346597	.	A	T	20	34	54	0	1	55	0	0
12	35346842	.	T	C	18	16	34	0	3	37	0	0
12	35346873	.	C	T	26	23	49	0	1	50	0	0
12	35347002	.	A	T	22	24	46	0	1	47	0	0
12	35347078	.	G	A	34	21	55	0	1	56	0	0
12	35347084	.	C	T	2	31	33	0	22	55	0	0
12	35347318	.	C	T	27	23	50	0	2	52	0	0
12	35347485	.	T	G	21	25	46	0	2	48	0	0
12	35347795	.	C	T	1	13	14	0	10	24	0	0
12	35347951	.	A	G	28	27	55	0	0	55	0	0
12	35350686	.	G	A	28	14	42	0	2	44	0	0
12	35351392	.	G	T	17	18	35	2	1	38	0	0
12	35381729	.	T	C	10	3	13	0	29	42	0	0
12	35386919	.	A	G	20	22	42	0	1	43	0	0
12	35543736	.	T	G	3	12	15	0	1	16	0	0
12	35543971	.	T	G	12	12	24	0	0	24	0	0
12	35544320	.	T	G	7	8	15	0	0	15	0	0
12	35544460	.	A	G	8	10	18	0	0	18	0	0
12	35544596	.	C	A	6	2	8	0	0	8	0	0
12	35544968	.	A	G	16	15	31	0	1	32	0	0
12	35551120	.	G	A	3	9	12	0	0	12	0	0
12	35556821	.	G	C	6	4	10	0	1	11	0	0
12	35559393	.	G	A	3	4	7	0	0	7	0	0
12	35559614	.	T	G	3	16	19	0	0	19	0	0
12	35568231	.	G	A	11	10	21	0	0	21	0	0
12	35568249	.	C	T	1	8	9	0	16	25	0	0
12	35568270	.	T	A	13	8	21	0	1	22	0	0
12	35568303	.	C	G	16	12	28	0	1	29	0	0
12	35568691	.	A	G	11	14	25	0	0	25	0	0
12	35568787	.	G	A	10	9	19	0	0	19	0	0
12	35568793	.	A	G	9	8	17	0	0	17	0	0
12	35574179	.	T	C	6	0	6	0	10	16	0	0
12	35574180	.	C	G	7	9	16	0	0	16	0	0
12	35593188	.	C	T	17	20	37	0	3	40	0	0
12	35593469	.	T	A	14	5	19	0	0	19	0	0
12	35593729	.	A	G	8	0	8	0	9	17	0	0
12	35594069	.	T	A	16	22	38	0	0	38	0	0
12	35594154	.	C	T	18	13	31	0	1	32	0	0
12	35594169	.	C	T	16	13	29	0	1	30	0	0
12	35594436	.	C	T	19	14	33	0	0	34	1	0
12	35594474	.	A	G	22	13	35	0	1	36	0	0
12	35594495	.	G	A	4	10	14	0	17	31	0	0
12	35594512	.	T	C	17	14	31	0	0	31	0	0
12	35594541	.	C	A	20	15	35	0	1	36	0	0
12	35594605	.	C	T	18	13	31	0	0	31	0	0
12	35594623	.	T	A	18	13	31	0	1	32	0	0
12	35674952	.	G	A	20	13	33	0	1	34	0	0
12	35689209	.	C	T	19	15	34	0	0	34	0	0
12	35689210	.	A	G	18	15	33	0	2	35	0	0
12	35704426	.	G	T	30	21	51	0	5	56	0	0
12	35704435	.	G	T	30	29	59	0	0	59	0	0
12	35704735	.	A	G	19	16	35	0	0	35	0	0
12	35704852	.	G	A	23	18	41	0	0	41	0	0
12	35704921	.	A	C	15	22	37	0	1	38	0	0
12	35704996	.	T	G	19	22	41	0	1	42	0	0
12	35705131	.	C	T	17	16	33	0	7	40	0	0
12	35705140	.	A	C	16	1	17	0	24	41	0	0
12	35705224	.	A	G	23	16	39	0	3	42	0	0
12	35705252	.	T	G	26	20	46	0	1	47	0	0
12	35705323	.	G	A	10	23	33	0	1	34	0	0
12	35705367	.	C	T	1	20	21	0	14	35	0	0
12	35705565	.	C	T	1	15	16	0	11	27	0	0
12	35705606	.	A	T	8	10	18	0	1	19	0	0
12	35705661	.	T	C	15	17	32	0	2	34	0	0
12	35705926	.	C	T	25	18	43	0	2	45	0	0
12	35706091	.	C	T	14	22	36	0	3	39	0	0
12	35706124	.	A	G	20	17	37	0	2	39	0	0
12	35706253	.	A	T	14	16	30	0	0	30	0	0
12	35706304	.	A	G	16	15	31	0	1	32	0	0
12	35706524	.	G	A	22	17	39	0	1	40	0	0
12	35706568	.	C	T	23	18	41	0	0	41	0	0
12	35706859	.	C	T	1	20	21	0	11	32	0	0
12	35706970	.	G	T	12	19	31	0	1	32	0	0
12	35707155	.	C	T	16	16	32	0	1	33	0	0
12	35707171	.	T	C	14	19	33	0	0	33	0	0
12	35707225	.	G	A	14	16	30	0	1	31	0	0
12	35707537	.	A	G	14	11	25	0	0	25	0	0
12	35707636	.	G	A	12	9	21	0	0	21	0	0
12	35707660	.	A	C	9	7	16	0	0	17	1	0
12	35707747	.	A	G	14	11	25	0	1	26	0	0
12	35707963	.	T	C	19	0	19	0	13	32	0	0
12	35707987	.	G	A	16	12	28	0	3	31	0	0
12	35708139	.	T	G	13	17	30	0	0	30	0	0
12	35708235	.	A	G	17	19	36	0	2	38	0	0
12	35708272	.	C	T	14	17	31	0	6	37	0	0
12	35708950	.	G	A	16	8	24	0	1	25	0	0
12	35709007	.	G	A	19	19	38	0	0	38	0	0
12	35709028	.	A	G	13	18	31	0	1	32	0	0
12	35710837	.	T	C	15	16	31	0	1	32	0	0
12	35715339	.	A	G	9	8	17	0	0	17	0	0
12	35716116	.	T	G	9	5	14	0	0	14	0	0
12	35740605	.	G	T	10	12	22	0	2	24	0	0
12	35837354	.	C	T	0	4	4	0	8	12	0	0
12	35837425	.	T	A	2	3	5	0	0	5	0	0
12	35837468	.	C	A	2	4	6	0	0	6	0	0
12	35837499	.	G	C	6	6	12	0	1	13	0	0
12	35837503	.	T	G	6	6	12	0	0	12	0	0
12	35837751	.	G	A	7	3	10	0	0	10	0	0
12	35837828	.	T	A	6	2	8	0	0	8	0	0
12	35837842	.	G	A	7	2	9	0	0	9	0	0
12	35838202	.	C	T	1	3	4	0	0	4	0	0
12	35838537	.	G	C	2	3	5	0	0	5	0	0
12	35838542	.	A	C	2	2	4	0	0	4	0	0
12	35838672	.	C	A	0	5	5	0	6	11	0	0
12	35838683	.	A	G	5	4	9	0	0	9	0	0
12	35839063	.	A	T	6	7	13	0	0	13	0	0
12	35839090	.	C	T	1	5	6	0	3	9	0	0
12	35839159	.	C	T	4	7	11	0	0	11	0	0
12	35839165	.	C	G	5	7	12	0	1	13	0	0
12	35839261	.	C	A	7	8	15	0	0	15	0	0
12	35839680	.	G	A	6	5	11	0	2	13	0	0
12	35839879	.	C	A	0	11	11	0	12	23	0	0
12	35839919	.	C	G	1	3	4	0	8	12	0	0
12	35839942	.	C	T	6	2	8	0	1	9	0	0
12	35840003	.	T	C	4	0	4	0	6	10	0	0
12	35840008	.	C	A	4	7	11	0	0	11	0	0
12	35840483	.	G	A	5	2	7	0	0	7	0	0
12	35840543	.	A	C	5	8	13	0	0	13	0	0
12	35840717	.	A	G	5	9	14	0	0	14	0	0
12	35840800	.	T	G	3	6	9	0	0	9	0	0
12	35841438	.	G	A	2	8	10	0	1	11	0	0
12	35841457	.	G	A	7	10	17	0	0	17	0	0
12	35841718	.	C	A	5	4	9	0	0	9	0	0
12	35847493	.	A	T	12	7	19	0	0	19	0	0
12	35847535	.	T	C	7	7	14	0	0	14	0	0
12	35847538	.	C	T	7	6	13	0	0	13	0	0
12	35853678	.	A	G	10	9	19	0	0	19	0	0
12	35853693	.	T	C	9	9	18	0	2	20	0	0
12	35853732	.	C	A	12	9	21	0	0	21	0	0
12	35864581	.	T	A	5	4	9	0	0	9	0	0
12	35867935	.	G	A	5	2	7	0	0	7	0	0
12	35868203	.	A	G	3	2	5	0	0	5	0	0
12	35870659	.	C	G	2	4	6	0	0	6	0	0
12	35872597	.	C	T	6	5	11	0	0	11	0	0
12	35873158	.	C	T	4	5	9	0	0	9	0	0
12	35875707	.	A	G	5	3	8	0	0	8	0	0
12	35875766	.	A	G	5	6	11	0	0	11	0	0
12	35883704	.	T	C	3	0	3	0	2	5	0	0
12	35963575	.	T	C	11	7	18	0	0	18	0	0
12	35967239	.	T	C	7	10	17	0	2	19	0	0
12	35976771	.	C	A	11	5	16	0	0	16	0	0
12	35980917	.	T	G	5	6	11	0	0	11	0	0
12	35981206	.	T	C	5	0	5	0	12	17	0	0
12	35981260	.	T	A	7	13	20	0	0	20	0	0
12	35981303	.	T	G	4	7	11	0	1	12	0	0
12	35981304	.	G	C	4	8	12	0	0	12	0	0
12	35981478	.	A	G	7	5	12	0	0	12	0	0
12	35981627	.	C	T	5	9	14	0	1	15	0	0
12	35981713	.	C	T	1	4	5	0	2	7	0	0
12	35981795	.	T	A	5	6	11	0	0	11	0	0
12	35981832	.	A	G	2	9	11	0	1	12	0	0
12	35988544	.	A	G	4	13	17	0	2	19	0	0
12	35988553	.	G	A	3	13	16	0	0	16	0	0
12	36105341	.	A	G	2	3	5	0	0	5	0	0
12	36105410	.	G	T	1	2	3	0	0	3	0	0
12	36135764	.	C	T	8	9	17	0	2	19	0	0
12	36158056	.	A	C	16	19	35	0	2	38	1	0
12	36158098	.	G	C	17	17	34	0	0	34	0	0
12	36158099	.	T	C	16	17	33	0	1	34	0	0
12	36158225	.	T	C	15	14	29	0	0	29	0	0
12	36158349	.	G	A	3	17	20	0	17	38	1	0
12	36158538	.	C	T	3	7	10	0	1	11	0	0
12	36159597	.	C	G	7	5	12	1	0	13	0	0
12	36413894	.	G	T	4	7	11	0	2	13	0	0
12	36413937	.	A	T	14	6	20	0	1	21	0	0
12	36416669	.	T	C	5	5	10	0	0	10	0	0
12	36416675	.	T	C	5	7	12	0	0	12	0	0
12	36416714	.	G	A	7	5	12	0	1	13	0	0
12	36416732	.	G	C	10	3	13	0	1	14	0	0
12	36420420	.	G	A	3	4	7	0	0	7	0	0
12	36422537	.	A	G	5	2	7	0	0	7	0	0
12	36424613	.	G	A	4	7	11	0	1	12	0	0
12	36424618	.	G	A	7	3	10	0	1	11	0	0
12	36426775	.	C	T	1	2	3	0	0	3	0	0
12	36462038	.	G	A	3	7	10	0	0	10	0	0
12	36468999	.	G	T	6	4	10	0	0	10	0	0
12	36469011	.	T	A	5	3	8	0	0	8	0	0
12	36471122	.	A	T	1	2	3	0	1	4	0	0
12	36471149	.	A	C	3	2	5	0	0	5	0	0
12	36671236	.	C	T	0	3	3	0	1	4	0	0
12	36739440	.	C	T	3	5	8	0	0	8	0	0
12	36739638	.	A	G	2	6	8	0	0	8	0	0
12	36739668	.	C	T	2	2	4	0	0	4	0	0
12	36739676	.	A	G	1	1	2	0	0	2	0	0
12	36739744	.	A	G	1	3	4	0	0	4	0	0
12	36739745	.	T	A	1	2	3	0	1	4	0	0
12	36740059	.	C	A	1	2	3	0	0	3	0	0
12	36891583	.	C	T	11	5	16	0	0	16	0	0
12	36895025	.	A	G	10	7	17	0	1	18	0	0
12	36895057	.	T	C	5	9	14	0	0	14	0	0
12	36895067	.	G	A	4	11	15	0	0	15	0	0
12	36952648	.	T	G	4	0	4	1	7	12	0	0
12	36960197	.	T	C	5	3	8	0	0	8	0	0
12	36960200	.	A	T	5	3	8	0	0	8	0	0
12	37001843	.	C	T	5	3	8	0	0	8	0	0
12	37002957	.	G	A	1	2	3	0	2	5	0	0
12	37003372	.	T	G	1	1	2	0	2	4	0	0
12	37003374	.	A	G	2	3	5	0	0	5	0	0
12	37003460	.	T	C	2	4	6	0	0	6	0	0
12	37003613	.	A	G	2	2	4	0	0	4	0	0
12	37004057	.	T	C	6	5	11	0	0	11	0	0
12	37004290	.	A	C	2	2	4	0	0	4	0	0
12	37005350	.	T	C	1	3	4	0	0	4	0	0
12	37005586	.	A	G	3	0	3	0	3	6	0	0
12	37275601	.	C	T	3	2	5	0	0	5	0	0
12	37275799	.	T	G	2	3	5	0	0	5	0	0
12	37275800	.	T	G	2	3	5	0	0	5	0	0
12	37407249	.	G	T	1	3	4	0	0	4	0	0
12	37407392	.	T	A	7	10	17	0	1	18	0	0
12	37407477	.	T	C	5	6	11	0	0	11	0	0
12	37407524	.	C	A	7	3	10	0	0	10	0	0
12	37407632	.	T	A	6	5	11	0	0	11	0	0
12	37407813	.	C	T	5	5	10	0	2	12	0	0
12	37408206	.	A	G	5	3	8	0	0	8	0	0
12	37408442	.	G	C	8	4	12	0	0	12	0	0
12	37409037	.	C	T	1	6	7	0	0	7	0	0
12	37409269	.	C	T	7	5	12	0	0	12	0	0
12	37409315	.	C	T	0	8	8	0	4	12	0	0
12	37409436	.	C	A	1	4	5	0	2	7	0	0
12	37409481	.	G	A	2	8	10	0	0	10	0	0
12	37409611	.	A	G	7	7	14	0	1	15	0	0
12	37409802	.	C	T	6	7	13	0	0	13	0	0
12	37409836	.	T	G	7	9	16	0	1	17	0	0
12	37410018	.	T	C	4	0	4	0	11	15	0	0
12	37410034	.	C	T	5	9	14	0	0	14	0	0
12	37410111	.	T	C	8	5	13	0	0	13	0	0
12	37410469	.	T	G	6	7	13	0	0	13	0	0
12	37410519	.	C	T	6	5	11	0	0	11	0	0
12	37410546	.	T	C	3	0	3	0	4	7	0	0
12	37410648	.	C	T	5	7	12	0	0	12	0	0
12	37410693	.	C	G	2	8	10	0	0	10	0	0
12	37410816	.	A	G	5	9	14	0	0	14	0	0
12	37410966	.	T	C	4	5	9	0	0	9	0	0
12	37411041	.	T	C	2	0	2	0	8	10	0	0
12	37449270	.	C	A	4	2	6	0	1	7	0	0
12	37449271	.	T	A	4	1	5	0	2	7	0	0
12	37463606	.	T	C	9	1	10	0	12	22	0	0
12	37490224	.	G	T	6	5	11	0	2	13	0	0
12	37497149	.	G	A	7	8	15	0	0	15	0	0
12	37503881	.	G	A	5	10	15	0	0	15	0	0
12	37515112	.	T	C	3	0	3	0	6	9	0	0
12	37530784	.	G	A	5	4	9	0	1	10	0	0
12	37530848	.	A	G	4	7	11	0	0	11	0	0
12	37530969	.	T	C	4	6	10	0	0	10	0	0
12	37531008	.	G	A	2	4	6	0	0	6	0	0
12	37531014	.	A	G	2	4	6	0	0	6	0	0
12	37531071	.	G	T	5	2	7	0	1	8	0	0
12	37538183	.	T	G	4	7	11	0	0	11	0	0
12	37545850	.	G	A	9	4	13	0	1	14	0	0
12	37552108	.	A	T	5	5	10	0	0	10	0	0
12	37575944	.	A	C	3	2	5	0	0	5	0	0
12	37575967	.	C	A	0	2	2	0	4	6	0	0
12	37576013	.	T	C	2	0	2	0	2	5	1	0
12	38556562	.	G	T	3	4	7	0	0	7	0	0
12	38561258	.	C	A	9	11	20	0	4	24	0	0
12	38563150	.	C	A	3	3	6	0	0	6	0	0
12	38563158	.	C	T	1	4	5	0	0	5	0	0
12	38563219	.	T	A	2	3	5	0	0	5	0	0
12	38563233	.	G	A	2	2	4	0	0	4	0	0
12	38563347	.	C	G	4	6	10	0	0	10	0	0
12	38605005	.	C	T	1	3	4	0	0	4	0	0
12	38651219	.	G	A	0	5	5	0	1	6	0	0
12	38651329	.	C	T	1	2	3	0	0	3	0	0
12	38655310	.	C	A	1	6	7	0	1	8	0	0
12	38676664	.	C	T	4	3	7	0	0	7	0	0
12	38677076	.	C	T	6	2	8	0	0	8	0	0
12	38680669	.	G	T	1	9	10	0	3	13	0	0
12	38687907	.	T	A	4	3	7	0	0	7	0	0
12	38787630	.	G	A	5	3	8	0	2	10	0	0
12	38796212	.	A	G	2	0	2	0	3	5	0	0
12	38799627	.	C	T	8	4	12	0	0	12	0	0
12	38799678	.	C	G	6	5	11	0	1	12	0	0
12	38799732	.	G	A	7	7	14	0	0	14	0	0
12	38799759	.	C	T	5	4	9	0	0	9	0	0
12	38799822	.	A	C	9	6	15	0	0	15	0	0
12	38802875	.	T	C	5	5	10	0	1	11	0	0
12	38803012	.	T	C	11	5	16	0	1	17	0	0
12	38803148	.	T	A	5	3	8	0	1	9	0	0
12	38803238	.	C	T	6	4	10	2	0	12	0	0
12	38803411	.	A	G	5	0	5	0	6	11	0	0
12	38803586	.	T	C	1	8	9	0	0	9	0	0
12	38803633	.	C	T	3	6	9	0	0	9	0	0
12	38803649	.	G	C	3	4	7	0	0	7	0	0
12	38803683	.	T	C	2	3	5	0	1	6	0	0
12	38804305	.	A	G	6	3	9	0	0	9	0	0
12	38804314	.	C	T	4	7	11	0	0	11	0	0
12	38804350	.	G	A	6	8	14	0	0	14	0	0
12	38804538	.	A	C	9	4	13	0	0	13	0	0
12	38809283	.	C	T	2	2	4	0	0	4	0	0
12	38819679	.	C	T	3	2	5	0	0	5	0	0
12	38819727	.	C	T	4	5	9	0	0	9	0	0
12	38834491	.	T	G	2	4	6	0	1	7	0	0
12	38836784	.	T	G	3	0	3	0	7	10	0	0
12	38842158	.	G	A	1	8	9	0	0	9	0	0
12	38842188	.	C	T	3	7	10	0	0	10	0	0
12	38843587	.	A	G	6	4	10	0	0	10	0	0
12	38847925	.	C	T	5	4	9	0	0	9	0	0
12	38849546	.	C	A	3	2	5	0	0	5	0	0
12	38850285	.	T	A	6	3	9	0	0	9	0	0
12	38850889	.	C	T	7	4	11	0	0	11	0	0
12	38854919	.	G	T	0	7	7	0	4	11	0	0
12	38855015	.	A	T	3	5	8	0	0	8	0	0
12	38855049	.	G	A	0	6	6	0	4	10	0	0
12	38855344	.	G	A	1	6	7	0	9	16	0	0
12	38855596	.	T	G	9	0	9	0	7	16	0	0
12	38855601	.	G	A	5	8	13	0	2	15	0	0
12	38855859	.	T	A	5	3	8	0	0	8	0	0
12	38855861	.	C	T	3	5	8	0	0	8	0	0
12	38855971	.	A	C	1	4	5	0	0	5	0	0
12	38855981	.	T	C	1	3	4	0	0	4	0	0
12	38900941	.	G	C	3	2	5	0	0	5	0	0
12	38900950	.	T	A	3	2	5	0	1	6	0	0
12	38913125	.	T	C	1	2	3	0	0	3	0	0
12	38913146	.	G	C	1	2	3	0	0	3	0	0
12	39744954	.	G	C	2	7	9	0	12	21	0	0
12	40206716	.	G	A	0	5	5	0	6	11	0	0
12	40348899	.	G	T	0	3	3	0	6	9	0	0
12	40497143	.	T	C	3	2	5	0	0	5	0	0
12	40518043	.	T	C	12	11	23	0	2	25	0	0
12	40518088	.	C	T	9	6	15	0	2	17	0	0
12	40518094	.	T	C	8	7	15	0	0	15	0	0
12	40905599	.	G	A	1	6	7	1	9	17	0	0
12	40945499	.	G	A	2	2	4	0	1	5	0	0
12	40945980	.	C	T	10	13	23	0	0	23	0	0
12	41000900	.	G	A	0	6	6	0	11	17	0	0
12	41000969	.	A	G	3	0	3	1	6	10	0	0
12	41000993	.	A	C	1	9	10	1	0	11	0	0
12	41028550	.	A	G	9	8	17	0	0	17	0	0
12	41028626	.	G	A	1	13	14	0	11	25	0	0
12	41037024	.	A	C	6	15	21	0	0	21	0	0
12	41071775	.	T	C	10	13	23	0	0	23	0	0
12	41071841	.	T	C	14	9	23	0	2	25	0	0
12	41113007	.	T	C	17	6	23	0	0	23	0	0
12	41113040	.	G	A	13	10	23	0	1	24	0	0
12	41113049	.	C	A	10	13	23	0	0	23	0	0
12	41113313	.	A	T	11	14	25	0	1	26	0	0
12	41437046	.	G	A	11	5	16	0	0	16	0	0
12	41449931	.	C	T	11	15	26	1	0	27	0	0
12	41455861	.	T	C	2	4	6	0	2	8	0	0
12	41458264	.	G	A	8	5	13	1	0	14	0	0
12	41461321	.	A	T	12	4	16	0	0	16	0	0
12	41530062	.	C	T	16	10	26	0	1	27	0	0
12	41530095	.	T	C	17	14	31	0	2	33	0	0
12	41530191	.	C	T	16	16	32	0	1	33	0	0
12	41535844	.	C	T	18	8	26	0	1	27	0	0
12	41535886	.	A	C	11	21	32	0	0	32	0	0
12	41535898	.	C	T	14	18	32	0	1	33	0	0
12	41535937	.	T	A	15	20	35	0	0	35	0	0
12	41539161	.	C	T	22	25	47	0	1	48	0	0
12	41541259	.	C	T	20	10	30	0	2	32	0	0
12	41547505	.	A	G	15	13	28	0	2	30	0	0
12	41549214	.	G	A	2	16	18	0	24	42	0	0
12	41549404	.	C	G	21	18	39	0	0	39	0	0
12	41549413	.	G	T	21	20	41	0	2	43	0	0
12	41549476	.	T	C	15	31	46	0	4	50	0	0
12	41581092	.	A	G	8	7	15	0	0	15	0	0
12	41581257	.	A	T	11	11	22	1	3	26	0	0
12	41593093	.	T	A	15	16	31	0	2	33	0	0
12	41606683	.	T	C	9	0	9	0	16	25	0	0
12	41606686	.	G	T	9	15	24	0	0	24	0	0
12	41612061	.	A	G	8	11	19	0	0	19	0	0
12	41631703	.	A	T	1	8	9	0	0	9	0	0
12	41632117	.	A	G	12	23	35	0	0	35	0	0
12	41633644	.	C	A	1	23	24	0	12	36	0	0
12	41636655	.	C	T	21	7	28	0	0	28	0	0
12	41636658	.	G	T	20	8	28	0	2	30	0	0
12	41643177	.	T	A	10	12	22	0	2	24	0	0
12	41643178	.	C	T	10	14	24	0	0	24	0	0
12	41643214	.	C	T	10	18	28	0	1	29	0	0
12	41643217	.	G	A	9	18	27	0	3	30	0	0
12	41647273	.	T	C	18	9	27	0	1	28	0	0
12	41647312	.	C	T	15	5	20	0	1	21	0	0
12	41653151	.	G	A	14	6	20	0	0	20	0	0
12	41656554	.	G	A	17	15	32	0	0	32	0	0
12	41661349	.	C	T	1	6	7	0	1	8	0	0
12	41684634	.	G	A	9	14	23	0	1	24	0	0
12	41698056	.	G	A	29	22	51	0	2	53	0	0
12	41702044	.	A	C	20	27	47	0	3	50	0	0
12	41723148	.	T	A	11	3	14	0	0	14	0	0
12	41723310	.	C	T	1	10	11	0	14	25	0	0
12	41723457	.	G	A	10	12	22	0	0	22	0	0
12	41723608	.	T	A	17	15	32	0	0	32	0	0
12	41723747	.	C	T	14	14	28	0	2	30	0	0
12	41731908	.	G	A	9	14	23	0	2	25	0	0
12	41732013	.	C	T	3	10	13	0	10	23	0	0
12	41735790	.	T	C	7	10	17	0	2	19	0	0
12	41739297	.	G	T	15	13	28	0	1	29	0	0
12	41739345	.	C	G	1	18	19	0	15	34	0	0
12	41759621	.	A	C	12	0	12	0	16	28	0	0
12	41759669	.	C	T	1	8	9	0	14	23	0	0
12	41991699	.	T	A	1	4	5	0	0	5	0	0
12	41991744	.	T	G	4	13	17	0	0	17	0	0
12	41991796	.	A	C	9	6	15	1	0	16	0	0
12	41991797	.	C	T	9	6	15	1	0	16	0	0
12	41992005	.	A	C	8	6	14	1	2	17	0	0
12	41992094	.	G	A	5	5	10	0	0	10	0	0
12	41992971	.	A	T	4	8	12	0	0	12	0	0
12	42007693	.	A	G	12	0	12	0	5	17	0	0
12	42153216	.	A	G	6	11	17	0	0	17	0	0
12	42182963	.	G	A	7	9	16	0	2	18	0	0
12	42186478	.	A	G	15	6	21	0	1	22	0	0
12	42195697	.	A	T	11	6	17	0	0	17	0	0
12	42196136	.	T	A	1	2	3	0	0	3	0	0
12	42196924	.	A	G	4	5	9	0	1	10	0	0
12	42196933	.	T	G	2	6	8	0	2	10	0	0
12	42197558	.	G	T	2	4	6	0	0	6	0	0
12	42197711	.	A	G	3	2	5	0	0	5	0	0
12	42197717	.	G	A	0	2	2	0	2	4	0	0
12	42197759	.	G	A	3	3	6	0	0	6	0	0
12	42366107	.	A	G	1	2	3	0	0	3	0	0
12	42366395	.	T	C	1	2	3	0	0	3	0	0
12	42366402	.	C	T	1	2	3	0	0	3	0	0
12	42369685	.	C	T	0	9	9	0	10	19	0	0
12	42369848	.	G	A	13	6	19	0	1	20	0	0
12	42369912	.	A	G	9	11	20	0	0	20	0	0
12	42384900	.	G	T	13	6	19	0	0	19	0	0
12	42384924	.	T	C	4	0	4	0	2	6	0	0
12	42396909	.	T	C	2	0	2	0	3	5	0	0
12	42404830	.	A	T	2	1	3	0	1	4	0	0
12	42405963	.	T	G	1	2	3	0	0	3	0	0
12	42406178	.	C	T	4	4	8	0	1	9	0	0
12	42576815	.	C	T	28	11	39	0	2	41	0	0
12	42577187	.	C	T	22	20	42	0	3	45	0	0
12	42578117	.	A	T	11	5	16	0	0	16	0	0
12	42578505	.	A	T	18	20	38	0	1	39	0	0
12	42578698	.	A	G	10	0	10	0	10	20	0	0
12	42578958	.	A	G	4	8	12	0	3	18	3	0
12	42578996	.	T	A	11	11	22	1	3	26	0	0
12	43376709	.	C	T	0	13	13	0	7	20	0	0
12	43376960	.	A	T	3	8	11	0	0	11	0	0
12	43377049	.	G	T	6	7	13	0	0	13	0	0
12	43377281	.	G	C	5	11	16	0	2	18	0	0
12	43377505	.	A	T	10	6	16	0	0	16	0	0
12	43377558	.	T	C	3	4	7	0	0	7	0	0
12	43384898	.	G	T	6	8	14	0	2	16	0	0
12	43384921	.	G	A	6	10	16	0	0	16	0	0
12	43391390	.	T	C	6	0	6	0	6	12	0	0
12	43395597	.	G	A	11	13	24	0	0	24	0	0
12	43395955	.	A	G	8	11	19	0	2	21	0	0
12	43415173	.	T	A	8	8	16	0	2	18	0	0
12	43426072	.	A	G	4	11	15	0	2	17	0	0
12	44368836	.	C	G	2	4	6	0	0	6	0	0
12	44372784	.	C	T	6	6	12	0	0	12	0	0
12	44378608	.	T	G	6	5	11	0	0	11	0	0
12	44394996	.	G	C	1	0	1	0	3	4	0	0
12	44416254	.	A	G	1	4	5	0	0	5	0	0
12	44416269	.	A	G	2	3	5	0	0	5	0	0
12	44611138	.	A	G	3	0	3	0	2	5	0	0
12	44611465	.	G	A	0	2	2	0	2	4	0	0
12	44611570	.	C	A	5	3	8	0	0	8	0	0
12	44611651	.	G	A	2	4	6	0	0	6	0	0
12	44611693	.	C	T	2	4	6	0	0	6	0	0
12	44611963	.	G	A	1	2	3	0	2	5	0	0
12	44635123	.	C	A	3	7	10	0	0	10	0	0
12	47044800	.	A	T	5	5	10	0	0	10	0	0
12	47282104	.	G	A	1	8	9	0	13	22	0	0
12	47283506	.	C	T	11	15	26	0	0	26	0	0
12	47283514	.	A	G	11	15	26	0	1	27	0	0
12	47283544	.	G	C	8	14	22	0	1	23	0	0
12	47291529	.	G	C	2	10	12	0	19	31	0	0
12	47291703	.	G	A	24	7	31	0	3	34	0	0
12	47295523	.	C	T	9	8	17	0	0	17	0	0
12	47295939	.	C	T	17	22	39	0	2	41	0	0
12	47302828	.	C	T	14	17	31	0	1	32	0	0
12	47302831	.	G	A	17	15	32	0	0	32	0	0
12	47331864	.	C	T	16	20	36	0	1	37	0	0
12	47332185	.	A	G	15	13	28	0	4	32	0	0
12	47332326	.	C	A	20	18	38	0	0	38	0	0
12	47332389	.	G	A	20	18	38	0	0	38	0	0
12	47332575	.	A	G	14	19	33	0	0	33	0	0
12	47332635	.	G	A	19	22	41	0	1	42	0	0
12	47332827	.	C	T	22	21	43	0	2	45	0	0
12	47335257	.	C	T	13	16	29	0	2	31	0	0
12	47335472	.	C	T	16	15	31	1	0	32	0	0
12	47344423	.	T	C	25	17	42	0	1	43	0	0
12	47347875	.	C	T	9	8	17	3	1	21	0	0
12	47355358	.	T	G	26	25	51	0	1	52	0	0
12	47448986	.	C	T	15	19	34	0	1	35	0	0
12	47449121	.	G	A	4	7	11	0	6	17	0	0
12	47449481	.	C	T	12	12	24	0	0	24	0	0
12	47449784	.	A	G	11	0	11	0	10	21	0	0
12	47449886	.	T	C	11	7	18	0	2	20	0	0
12	47449997	.	G	A	22	16	38	0	1	39	0	0
12	47461255	.	G	A	13	8	21	1	1	23	0	0
12	47469850	.	G	C	15	11	26	0	0	26	0	0
12	47480299	.	A	C	14	11	25	1	0	26	0	0
12	47480404	.	G	A	15	9	24	0	3	28	1	0
12	47480434	.	A	G	10	0	10	0	11	21	0	0
12	47480469	.	A	T	9	11	20	0	2	22	0	0
12	47480536	.	A	C	8	18	26	0	0	26	0	0
12	47480565	.	T	A	13	15	28	0	1	29	0	0
12	47480728	.	A	G	15	0	15	0	30	45	0	0
12	47480731	.	T	A	23	13	36	0	9	46	1	0
12	47481112	.	T	G	16	17	33	0	4	37	0	0
12	47481229	.	G	C	1	8	9	1	15	25	0	0
12	47481611	.	G	A	13	12	25	0	0	25	0	0
12	47505208	.	G	A	14	8	22	0	0	22	0	0
12	47510101	.	T	C	11	12	23	0	1	24	0	0
12	47523795	.	A	C	16	17	33	0	1	34	0	0
12	47540933	.	T	C	21	21	42	0	1	43	0	0
12	47540934	.	C	T	20	20	40	0	2	42	0	0
12	47540999	.	A	C	15	19	34	0	2	36	0	0
12	47541265	.	G	A	1	3	4	0	0	4	0	0
12	47544222	.	T	C	4	0	4	0	8	12	0	0
12	47544354	.	C	A	0	2	2	0	3	5	0	0
12	47544543	.	A	G	3	3	6	0	0	6	0	0
12	47580442	.	G	A	11	7	18	0	1	19	0	0
12	47589212	.	C	T	1	6	7	0	6	13	0	0
12	47593373	.	G	A	13	11	24	0	1	25	0	0
12	47638692	.	A	T	5	2	7	29	0	36	0	0
12	47862041	.	C	T	8	3	11	0	1	12	0	0
12	47862047	.	T	C	4	6	10	0	0	10	0	0
12	47919665	.	C	T	4	6	10	0	0	10	0	0
12	47967867	.	C	T	0	2	2	0	5	7	0	0
12	47967868	.	G	A	5	2	7	0	0	7	0	0
12	47967906	.	C	A	3	2	5	0	1	6	0	0
12	47968031	.	G	A	3	2	5	0	0	5	0	0
12	48094399	.	A	T	4	4	8	0	1	9	0	0
12	48118470	.	A	C	1	4	5	0	0	5	0	0
12	48118598	.	A	T	3	3	6	0	0	6	0	0
12	48118981	.	G	A	1	4	5	0	1	6	0	0
12	48119048	.	G	A	3	2	5	0	0	5	0	0
12	48119153	.	T	G	6	3	9	0	0	9	0	0
12	48119855	.	C	T	1	3	4	0	1	5	0	0
12	48119934	.	C	T	1	3	4	0	0	4	0	0
12	48121193	.	T	C	2	2	4	0	0	4	0	0
12	48121455	.	A	T	1	4	5	0	0	5	0	0
12	48122106	.	C	G	1	2	3	0	2	5	0	0
12	48133239	.	G	A	8	3	11	0	1	12	0	0
12	48137949	.	G	A	7	5	12	0	0	12	0	0
12	48139236	.	G	A	8	5	13	0	0	13	0	0
12	48143336	.	G	A	8	6	14	0	0	14	0	0
12	48146371	.	C	T	3	3	6	0	0	6	0	0
12	48146395	.	G	T	3	4	7	0	0	7	0	0
12	48146841	.	C	T	1	8	9	0	7	16	0	0
12	48146880	.	C	T	0	8	8	0	7	15	0	0
12	48157055	.	C	T	0	5	5	0	3	8	0	0
12	48157135	.	G	A	6	4	10	0	0	10	0	0
12	48161625	.	C	T	5	3	8	0	0	8	0	0
12	48162177	.	C	A	5	7	12	0	0	12	0	0
12	48162291	.	T	A	6	3	9	0	0	9	0	0
12	48168094	.	G	A	9	7	16	0	0	16	0	0
12	48198910	.	G	T	2	6	8	0	0	8	0	0
12	48205068	.	G	A	1	2	3	0	1	4	0	0
12	48211292	.	T	C	2	3	5	0	0	5	0	0
12	48220624	.	C	G	3	10	13	0	0	13	0	0
12	48228265	.	A	C	10	7	17	0	0	17	0	0
12	48231039	.	G	A	1	4	5	0	10	15	0	0
12	48231108	.	G	T	6	6	12	0	0	12	0	0
12	48239927	.	C	T	4	7	11	0	0	11	0	0
12	48319235	.	A	T	11	5	16	0	1	17	0	0
12	48327550	.	T	G	7	7	14	0	1	15	0	0
12	48340578	.	G	A	14	7	21	0	4	25	0	0
12	48341936	.	G	A	2	11	13	0	8	21	0	0
12	48346807	.	C	T	2	5	7	0	0	7	0	0
12	48349836	.	C	T	3	9	12	0	14	26	0	0
12	48367360	.	C	T	4	7	11	0	16	27	0	0
12	48367442	.	T	G	11	11	22	0	2	24	0	0
12	48401980	.	G	T	4	3	7	0	0	7	0	0
12	48404465	.	C	A	2	3	5	0	1	6	0	0
12	48419281	.	G	C	2	6	8	0	0	8	0	0
12	48419568	.	T	G	4	2	6	0	0	6	0	0
12	48419645	.	A	C	2	4	6	1	0	7	0	0
12	48419867	.	C	T	0	8	8	0	8	16	0	0
12	48420640	.	A	G	8	10	18	0	0	18	0	0
12	48432078	.	C	T	1	9	10	0	10	20	0	0
12	48432716	.	G	T	13	8	21	0	4	25	0	0
12	48436863	.	T	C	7	0	7	0	9	16	0	0
12	48440328	.	A	G	3	4	7	0	0	7	0	0
12	48440345	.	A	G	4	2	6	0	2	8	0	0
12	48445239	.	G	C	3	0	3	0	3	6	0	0
12	48445240	.	A	G	3	3	6	0	0	6	0	0
12	48451923	.	A	G	4	3	7	0	0	7	0	0
12	48457823	.	G	A	4	5	9	0	0	9	0	0
12	48465570	.	G	A	3	6	9	0	0	9	0	0
12	48469825	.	C	T	15	10	25	1	0	26	0	0
12	48476965	.	A	T	20	26	46	0	1	47	0	0
12	48476995	.	T	C	6	0	6	0	16	22	0	0
12	48480740	.	G	A	11	8	19	0	0	19	0	0
12	48511751	.	C	T	5	3	8	0	1	9	0	0
12	48522722	.	C	T	5	3	8	0	0	8	0	0
12	48522778	.	C	T	2	5	7	0	0	7	0	0
12	48522793	.	T	C	4	6	10	0	1	11	0	0
12	48525046	.	G	A	4	12	16	0	1	17	0	0
12	48528736	.	G	A	12	11	23	0	0	23	0	0
12	48529757	.	C	T	10	15	25	0	1	26	0	0
12	48532581	.	A	G	5	13	18	0	5	23	0	0
12	48611667	.	C	T	1	2	3	0	0	3	0	0
12	48612390	.	G	A	0	2	2	0	1	3	0	0
12	48612405	.	G	A	1	1	2	0	1	3	0	0
12	48623030	.	C	A	3	6	9	0	0	9	0	0
12	48680110	.	C	G	7	7	14	0	3	17	0	0
12	48680163	.	A	T	6	5	11	0	1	12	0	0
12	48682002	.	A	G	6	8	14	0	0	14	0	0
12	48682317	.	A	G	8	2	10	0	0	10	0	0
12	48682530	.	G	C	2	7	9	0	0	9	0	0
12	48792426	.	G	A	1	4	5	0	1	6	0	0
12	48796831	.	C	T	3	8	11	0	1	12	0	0
12	48796993	.	T	C	3	16	19	0	0	19	0	0
12	48799261	.	C	T	6	14	20	0	0	20	0	0
12	48800725	.	G	A	1	8	9	0	0	9	0	0
12	48803126	.	G	C	9	9	18	0	1	19	0	0
12	48804074	.	G	C	14	11	25	0	1	26	0	0
12	48810338	.	C	T	11	18	29	0	3	32	0	0
12	48810557	.	G	T	2	9	11	0	18	29	0	0
12	48810558	.	C	T	18	9	27	0	0	27	0	0
12	48810865	.	C	T	7	3	10	0	0	10	0	0
12	48811035	.	T	C	7	7	14	0	0	14	0	0
12	48816218	.	A	G	18	0	18	0	9	27	0	0
12	48826364	.	C	T	26	15	41	1	1	43	0	0
12	48828194	.	G	T	12	5	17	0	0	17	0	0
12	48828350	.	C	T	8	4	12	0	0	12	0	0
12	48828356	.	C	G	6	9	15	0	0	15	0	0
12	48828431	.	G	A	3	9	12	0	15	27	0	0
12	48828461	.	C	T	12	10	22	0	0	22	0	0
12	48828467	.	G	A	2	9	11	0	12	23	0	0
12	48829379	.	T	C	14	10	24	0	1	25	0	0
12	48829397	.	T	C	11	9	20	0	2	22	0	0
12	48833090	.	T	C	19	14	33	0	0	33	0	0
12	48833165	.	C	T	15	6	21	0	1	22	0	0
12	48836348	.	A	G	10	8	18	0	0	18	0	0
12	48836482	.	G	A	11	14	25	0	3	28	0	0
12	48851450	.	G	A	1	3	4	0	0	4	0	0
12	48851480	.	C	A	2	3	5	0	0	5	0	0
12	48852885	.	G	T	1	2	3	0	0	3	0	0
12	48862730	.	T	C	1	2	3	0	0	3	0	0
12	48864119	.	T	C	3	3	6	1	1	8	0	0
12	48864536	.	A	G	1	0	1	0	2	3	0	0
12	48866840	.	G	A	0	3	3	0	1	4	0	0
12	48867236	.	G	A	0	3	3	0	4	7	0	0
12	48871942	.	G	C	6	4	10	0	0	10	0	0
12	48881833	.	C	T	4	2	6	1	0	7	0	0
12	48899089	.	C	T	7	4	11	0	0	11	0	0
12	48909987	.	G	A	2	5	7	0	0	7	0	0
12	48943420	.	C	T	0	5	5	0	2	7	0	0
12	48959630	.	G	A	3	4	7	0	1	8	0	0
12	48974534	.	A	G	1	5	6	0	1	7	0	0
12	48974901	.	T	C	1	5	6	0	0	6	0	0
12	48975613	.	G	A	0	3	3	0	2	5	0	0
12	48979219	.	T	C	9	0	9	0	8	17	0	0
12	48979234	.	T	C	7	0	7	0	8	15	0	0
12	48979256	.	G	T	4	3	7	0	3	10	0	0
12	48979362	.	A	C	5	1	6	0	9	15	0	0
12	48979609	.	C	T	0	5	5	0	8	13	0	0
12	48979648	.	C	T	4	6	10	0	1	11	0	0
12	48982536	.	T	C	9	0	9	0	6	15	0	0
12	48982539	.	C	T	1	6	7	0	8	15	0	0
12	48983799	.	C	T	0	5	5	0	4	9	0	0
12	48984334	.	T	C	3	0	3	0	6	9	0	0
12	49004058	.	C	T	2	20	22	0	17	39	0	0
12	49004071	.	C	T	2	18	20	0	18	38	0	0
12	49005119	.	G	T	23	19	42	3	4	49	0	0
12	49005150	.	T	C	24	20	44	2	1	47	0	0
12	49010732	.	C	T	3	4	7	0	0	7	0	0
12	49034603	.	C	T	11	6	17	0	0	17	0	0
12	49035182	.	G	A	1	17	18	0	4	22	0	0
12	49035269	.	C	T	7	7	14	0	0	14	0	0
12	49037523	.	G	C	1	7	8	0	4	12	0	0
12	49037568	.	G	A	0	8	8	0	5	13	0	0
12	49114550	.	G	T	3	11	14	0	19	33	0	0
12	49125593	.	G	A	0	2	2	0	3	5	0	0
12	49125725	.	C	A	1	3	4	0	0	4	0	0
12	49125898	.	C	T	2	3	5	0	0	5	0	0
12	49125949	.	A	G	2	5	7	0	0	7	0	0
12	49148399	.	A	G	16	17	33	0	1	34	0	0
12	49149457	.	C	T	1	13	14	0	11	25	0	0
12	49158090	.	T	C	7	0	7	0	7	14	0	0
12	49158104	.	T	C	7	3	10	0	1	11	0	0
12	49158990	.	G	A	20	17	37	1	0	38	0	0
12	49159802	.	A	G	12	15	27	17	1	45	0	0
12	49160120	.	G	A	12	18	30	9	2	41	0	0
12	49161825	.	A	G	2	4	6	29	0	35	0	0
12	49161860	.	T	C	14	15	29	13	4	46	0	0
12	49166926	.	C	T	8	8	16	0	1	17	0	0
13	83970	.	C	T	0	3	3	0	3	6	0	0
13	86362	.	G	A	2	4	6	0	0	6	0	0
13	86382	.	G	A	3	3	6	0	0	6	0	0
13	111572	.	G	A	0	6	6	0	1	7	0	0
13	111804	.	C	T	6	4	10	0	1	11	0	0
13	112666	.	C	G	5	5	10	0	2	12	0	0
13	113203	.	C	G	4	3	7	3	3	13	0	0
13	216427	.	T	A	5	4	9	1	4	14	0	0
13	343567	.	G	T	4	5	9	0	0	9	0	0
13	343581	.	C	G	0	4	4	0	3	7	0	0
13	530294	.	G	T	1	10	11	0	1	12	0	0
13	541529	.	T	C	6	2	8	0	0	8	0	0
13	663882	.	A	G	8	0	8	0	2	10	0	0
13	663896	.	A	G	5	4	9	0	1	10	0	0
13	751094	.	C	T	1	7	8	0	0	8	0	0
13	808361	.	A	G	8	4	12	0	0	12	0	0
13	809779	.	A	G	10	6	16	0	3	19	0	0
13	1415598	.	A	C	5	0	5	0	18	23	0	0
13	2416927	.	G	T	1	2	3	6	0	9	0	0
13	2416933	.	A	T	1	2	3	6	0	9	0	0
13	2417235	.	C	T	3	3	6	2	0	8	0	0
13	2427331	.	T	C	4	5	9	0	0	9	0	0
13	2427439	.	T	C	7	4	11	0	2	13	0	0
13	2981378	.	T	A	7	16	23	0	0	23	0	0
13	3109195	.	G	C	3	2	5	0	0	5	0	0
13	3109224	.	T	C	1	3	4	0	0	4	0	0
13	3127930	.	G	A	10	5	15	0	0	15	0	0
13	3128038	.	T	C	4	0	4	0	9	13	0	0
13	3154956	.	G	C	3	4	7	0	0	7	0	0
13	3155005	.	C	T	6	4	10	0	1	11	0	0
13	3155196	.	T	A	5	5	10	0	0	10	0	0
13	3264323	.	C	A	4	6	10	0	1	11	0	0
13	3264406	.	C	T	3	3	6	0	0	6	0	0
13	3269340	.	G	A	15	10	25	0	2	27	0	0
13	3270123	.	A	G	12	6	18	0	1	19	0	0
13	3272706	.	C	A	3	6	9	0	7	16	0	0
13	3272735	.	G	C	6	7	13	0	0	14	1	0
13	3275094	.	T	C	6	0	6	0	9	15	0	0
13	3277401	.	G	A	5	3	8	0	0	8	0	0
13	3277423	.	G	C	4	6	10	0	0	10	0	0
13	3279525	.	A	G	9	3	12	1	0	13	0	0
13	3279588	.	C	T	1	5	6	1	5	12	0	0
13	3282127	.	T	C	9	9	18	0	2	20	0	0
13	3283761	.	A	G	4	6	10	0	0	10	0	0
13	3287268	.	C	A	8	8	16	0	0	16	0	0
13	3299514	.	C	G	6	3	9	0	0	9	0	0
13	3313102	.	G	A	3	3	6	0	1	7	0	0
13	3321982	.	A	G	6	2	8	0	0	8	0	0
13	3357683	.	C	T	0	6	6	0	4	10	0	0
13	3369252	.	T	C	3	4	7	0	0	7	0	0
13	3370583	.	T	C	1	2	3	0	0	3	0	0
13	3370596	.	T	C	1	0	1	0	2	3	0	0
13	3874427	.	A	G	6	6	12	0	0	12	0	0
13	3874618	.	T	C	5	6	11	0	2	13	0	0
13	3874815	.	T	C	5	0	5	0	5	10	0	0
13	3874831	.	T	C	6	6	12	0	1	13	0	0
13	3874903	.	C	A	1	8	9	0	5	14	0	0
13	3874909	.	G	A	5	7	12	0	0	12	0	0
13	3874983	.	A	G	3	2	5	0	0	5	0	0
13	3875113	.	C	G	4	3	7	0	0	7	0	0
13	3881152	.	T	G	1	8	9	0	0	9	0	0
13	3881204	.	T	C	13	9	22	0	1	23	0	0
13	3881208	.	G	T	10	9	19	0	1	20	0	0
13	3881269	.	C	G	5	7	12	0	1	13	0	0
13	3885350	.	A	C	1	4	5	0	0	5	0	0
13	3885359	.	G	T	2	5	7	0	1	8	0	0
13	3915908	.	A	G	5	6	11	0	1	12	0	0
13	3916150	.	A	G	11	23	34	0	0	34	0	0
13	3916377	.	G	A	16	9	25	0	0	25	0	0
13	3919020	.	T	C	17	1	18	0	17	35	0	0
13	3919057	.	A	C	13	20	33	0	1	34	0	0
13	3919136	.	A	T	10	14	24	0	0	24	0	0
13	3919167	.	A	G	13	18	31	0	1	32	0	0
13	3919555	.	T	C	18	14	32	0	4	36	0	0
13	3919632	.	A	G	21	17	38	0	0	38	0	0
13	3919672	.	T	G	20	13	33	0	2	35	0	0
13	3919686	.	G	A	18	16	34	0	0	34	0	0
13	3920759	.	C	T	2	7	9	0	14	23	0	0
13	3922791	.	T	C	11	11	22	0	2	24	0	0
13	3927916	.	T	C	7	11	18	0	1	19	0	0
13	3927931	.	T	C	5	12	17	0	0	17	0	0
13	3936482	.	C	G	16	13	29	0	0	29	0	0
13	3938574	.	C	A	13	10	23	0	0	23	0	0
13	3938619	.	C	A	18	10	28	0	2	30	0	0
13	3942055	.	G	A	0	11	11	0	19	30	0	0
13	3949847	.	G	A	12	13	25	0	1	26	0	0
13	3949978	.	T	G	10	1	11	0	10	21	0	0
13	3950007	.	G	A	13	10	23	0	1	25	1	0
13	3950074	.	A	T	12	11	23	0	0	23	0	0
13	3950181	.	T	C	26	14	40	0	0	40	0	0
13	3950497	.	G	T	6	9	15	0	1	16	0	0
13	3950669	.	T	A	7	3	10	0	2	12	0	0
13	3954611	.	C	T	12	9	21	0	1	22	0	0
13	3958895	.	C	T	9	6	15	0	2	17	0	0
13	3962569	.	C	T	6	4	10	0	0	10	0	0
13	3962845	.	C	T	5	4	9	0	3	12	0	0
13	3965966	.	G	A	15	10	25	0	2	27	0	0
13	3980164	.	C	T	3	2	5	0	0	5	0	0
13	3981808	.	T	C	3	1	4	0	0	4	0	0
13	3981832	.	T	A	6	2	8	0	0	8	0	0
13	3981880	.	G	C	2	3	5	0	1	6	0	0
13	3982036	.	T	G	1	3	4	0	0	4	0	0
13	3982190	.	G	A	4	8	12	0	1	13	0	0
13	3982711	.	C	T	5	3	8	0	1	9	0	0
13	3983112	.	G	C	6	2	8	0	1	9	0	0
13	4000625	.	A	G	4	3	7	0	0	7	0	0
13	4018624	.	A	T	2	1	3	0	0	3	0	0
13	4018630	.	C	T	1	2	3	0	1	4	0	0
13	4084284	.	G	A	4	6	10	0	0	10	0	0
13	4213240	.	G	A	6	6	12	0	2	14	0	0
13	4213291	.	A	C	4	8	12	0	1	13	0	0
13	4213300	.	C	T	8	3	11	0	0	11	0	0
13	4213804	.	G	A	9	10	19	0	1	20	0	0
13	4226664	.	C	A	22	17	39	0	2	41	0	0
13	4231438	.	T	A	15	8	23	0	1	24	0	0
13	4231590	.	A	G	2	2	4	0	0	4	0	0
13	4231819	.	G	A	12	10	22	1	2	25	0	0
13	4231869	.	A	G	8	16	24	0	2	26	0	0
13	4231899	.	A	G	6	8	14	0	1	15	0	0
13	4231917	.	A	G	8	5	13	0	1	14	0	0
13	4231954	.	T	A	7	5	12	0	0	12	0	0
13	4232051	.	G	A	6	6	12	0	0	12	0	0
13	4232054	.	A	T	5	6	11	0	1	12	0	0
13	4232171	.	C	T	15	13	28	0	3	31	0	0
13	4232280	.	T	C	28	21	49	0	1	50	0	0
13	4232284	.	T	C	25	23	48	0	2	50	0	0
13	4232324	.	T	G	14	21	35	0	1	36	0	0
13	4232358	.	A	T	20	11	31	1	0	32	0	0
13	4232400	.	A	T	22	9	31	2	2	35	0	0
13	4232718	.	G	A	7	7	14	0	2	16	0	0
13	4233030	.	C	T	1	17	18	0	16	34	0	0
13	4233033	.	G	A	16	15	31	0	1	32	0	0
13	4233167	.	T	A	13	12	25	3	0	28	0	0
13	4233361	.	G	T	13	11	24	0	0	24	0	0
13	4233365	.	G	A	12	12	24	0	0	24	0	0
13	4233625	.	T	A	11	13	24	0	1	25	0	0
13	4233779	.	G	A	18	6	24	0	3	27	0	0
13	4233889	.	G	A	15	11	26	0	0	26	0	0
13	4233911	.	G	C	12	15	27	0	1	28	0	0
13	4233952	.	T	G	11	18	29	0	3	32	0	0
13	4234337	.	G	A	16	11	27	0	0	27	0	0
13	4234349	.	G	T	13	18	31	0	0	31	0	0
13	4234655	.	G	A	30	16	46	0	1	47	0	0
13	4251236	.	G	A	8	5	13	0	1	14	0	0
13	4256617	.	A	G	19	9	28	0	1	29	0	0
13	4307752	.	A	G	11	8	19	0	0	19	0	0
13	4307782	.	C	T	13	12	25	0	2	27	0	0
13	4307934	.	T	C	15	13	28	0	1	29	0	0
13	4308269	.	G	A	13	12	25	0	2	27	0	0
13	4308841	.	T	G	17	10	27	0	0	27	0	0
13	4309166	.	T	G	8	11	19	0	0	19	0	0
13	4310247	.	G	A	14	14	28	0	1	29	0	0
13	4310440	.	G	C	28	0	28	0	21	49	0	0
13	4310511	.	C	T	1	18	19	0	22	41	0	0
13	4310565	.	G	A	16	22	38	0	1	39	0	0
13	4310568	.	A	T	24	15	39	0	1	40	0	0
13	4310610	.	C	T	18	18	36	0	3	39	0	0
13	4311081	.	T	C	12	11	23	0	0	23	0	0
13	4311578	.	T	C	14	1	15	0	19	34	0	0
13	4311699	.	G	T	15	18	33	0	2	35	0	0
13	4311912	.	C	T	15	8	23	0	1	24	0	0
13	4317628	.	C	T	0	5	5	0	6	11	0	0
13	4317721	.	T	C	11	7	18	0	1	19	0	0
13	4320905	.	T	C	8	11	19	0	2	21	0	0
13	4321153	.	T	C	10	7	17	0	0	17	0	0
13	4321382	.	C	T	4	8	12	0	0	12	0	0
13	4321507	.	A	C	15	0	15	0	9	24	0	0
13	4321741	.	T	G	7	7	14	0	0	14	0	0
13	4325167	.	G	C	3	0	3	0	4	7	0	0
13	4330240	.	G	A	7	5	12	0	0	12	0	0
13	4330282	.	A	T	6	2	8	0	1	9	0	0
13	4332807	.	G	A	1	3	4	0	3	7	0	0
13	4339139	.	A	C	2	4	6	0	0	6	0	0
13	4339382	.	C	T	8	6	14	0	0	14	0	0
13	4343183	.	C	T	0	9	9	0	3	12	0	0
13	4343216	.	A	T	9	5	14	0	0	14	0	0
13	4343221	.	T	A	8	5	13	0	0	13	0	0
13	4343490	.	G	A	12	6	18	0	0	18	0	0
13	4343931	.	G	A	7	2	9	1	0	10	0	0
13	4344159	.	C	G	4	5	9	0	0	9	0	0
13	4344800	.	T	C	7	6	13	0	5	18	0	0
13	4347531	.	T	C	3	4	7	0	0	7	0	0
13	4347627	.	C	A	2	3	5	0	0	5	0	0
13	4350442	.	A	G	4	5	9	0	0	9	0	0
13	4350523	.	G	T	6	3	9	0	0	9	0	0
13	4352724	.	C	T	3	3	6	0	0	6	0	0
13	4354424	.	G	T	1	6	7	0	0	7	0	0
13	4354596	.	T	A	3	2	5	0	0	5	0	0
13	4354644	.	T	C	2	6	8	0	0	8	0	0
13	4360724	.	C	T	0	6	6	0	4	10	0	0
13	4360778	.	G	A	4	3	7	0	0	7	0	0
13	4361838	.	A	C	7	3	10	0	0	10	0	0
13	4361847	.	A	G	3	6	9	0	0	9	0	0
13	4366152	.	A	G	6	3	9	0	0	9	0	0
13	4366180	.	C	A	3	4	7	0	0	7	0	0
13	4366431	.	T	A	2	7	9	0	0	9	0	0
13	4366741	.	G	T	3	3	6	0	0	6	0	0
13	4366777	.	A	C	2	0	2	0	3	5	0	0
13	4366807	.	A	G	1	2	3	0	0	3	0	0
13	4366911	.	C	T	2	4	6	0	0	6	0	0
13	4368536	.	T	C	8	6	14	0	0	14	0	0
13	4398802	.	A	G	10	0	10	0	13	23	0	0
13	4399510	.	T	C	2	3	5	0	0	5	0	0
13	4400323	.	A	G	2	0	2	0	5	7	0	0
13	4400339	.	G	A	5	2	7	0	0	7	0	0
13	4400409	.	G	C	7	7	14	0	0	14	0	0
13	4400462	.	A	C	3	2	5	1	1	7	0	0
13	4400464	.	C	G	2	3	5	1	0	6	0	0
13	4400550	.	T	G	2	2	4	0	0	4	0	0
13	4400698	.	A	T	2	2	4	0	0	4	0	0
13	4400704	.	T	A	2	2	4	0	0	4	0	0
13	4406816	.	T	C	14	9	23	2	3	28	0	0
13	4406937	.	T	A	6	4	10	0	0	10	0	0
13	4600689	.	A	G	4	3	7	0	2	9	0	0
13	4602243	.	G	A	2	2	4	0	0	4	0	0
13	4611061	.	C	T	3	12	15	0	0	15	0	0
13	4613672	.	T	C	8	5	13	0	0	13	0	0
13	4615130	.	G	T	6	4	10	0	1	11	0	0
13	4615169	.	T	C	6	5	11	0	1	12	0	0
13	4657721	.	G	C	7	5	12	0	0	12	0	0
13	4663375	.	G	A	4	11	15	0	1	16	0	0
13	4663402	.	C	T	7	10	17	0	1	18	0	0
13	4663444	.	A	G	12	7	19	0	0	19	0	0
13	4664226	.	A	G	1	2	3	0	0	3	0	0
13	4712874	.	G	A	8	14	22	0	2	24	0	0
13	4713193	.	C	G	6	5	11	0	1	12	0	0
13	4713254	.	G	A	5	5	10	0	0	10	0	0
13	4713373	.	T	A	7	6	13	0	0	13	0	0
13	4713702	.	A	T	4	6	10	0	1	11	0	0
13	4714017	.	C	A	5	6	11	0	0	11	0	0
13	4723985	.	C	T	3	2	5	0	0	5	0	0
13	4872121	.	C	T	20	6	26	0	0	26	0	0
13	4899623	.	A	G	15	17	32	0	0	32	0	0
13	4945774	.	T	A	14	11	25	0	2	27	0	0
13	4956118	.	G	A	26	14	40	0	3	43	0	0
13	4968819	.	T	A	17	9	26	0	0	26	0	0
13	4968849	.	A	G	10	14	24	0	1	25	0	0
13	4968931	.	T	A	11	10	21	2	1	24	0	0
13	4969139	.	A	G	15	0	15	1	7	23	0	0
13	4969319	.	A	G	2	28	30	0	0	30	0	0
13	4969320	.	A	G	17	13	30	0	0	30	0	0
13	4973556	.	T	A	5	4	9	0	0	9	0	0
13	4973701	.	T	A	6	5	11	2	1	14	0	0
13	4973856	.	C	T	1	8	9	0	7	16	0	0
13	4978620	.	G	A	16	9	25	0	1	26	0	0
13	4978785	.	C	T	1	12	13	0	15	28	0	0
13	4978821	.	T	C	16	0	16	0	16	32	0	0
13	4978885	.	T	C	13	11	24	0	1	25	0	0
13	4978887	.	C	A	13	12	25	0	0	25	0	0
13	4979150	.	C	T	5	9	14	0	1	15	0	0
13	4979163	.	A	T	5	8	13	0	1	14	0	0
13	4979339	.	C	T	9	6	15	1	0	16	0	0
13	4979420	.	T	C	8	11	19	0	1	20	0	0
13	4979550	.	A	G	9	12	21	0	1	22	0	0
13	4979607	.	G	T	13	8	21	0	4	25	0	0
13	4979799	.	T	C	6	0	6	0	7	13	0	0
13	4982061	.	T	G	3	2	5	0	3	8	0	0
13	4982091	.	C	T	0	5	5	0	6	11	0	0
13	4983110	.	A	T	7	4	11	0	0	11	0	0
13	4983113	.	C	A	1	4	5	0	7	12	0	0
13	4984355	.	A	G	5	4	9	0	0	9	0	0
13	4984377	.	T	G	3	4	7	0	0	7	0	0
13	4984402	.	A	T	3	3	6	0	1	7	0	0
13	4986110	.	G	A	7	7	14	0	0	14	0	0
13	4987659	.	C	A	0	6	6	0	6	12	0	0
13	4992360	.	A	C	4	4	8	0	0	8	0	0
13	4992374	.	C	G	2	4	6	0	0	6	0	0
13	4995574	.	T	C	17	21	38	0	1	39	0	0
13	4995638	.	G	T	0	11	11	0	14	25	0	0
13	4995788	.	C	T	17	11	28	0	1	29	0	0
13	5016758	.	G	C	27	24	51	0	2	53	0	0
13	5017657	.	A	G	32	28	60	0	1	61	0	0
13	5017699	.	G	A	31	27	58	0	5	63	0	0
13	5025842	.	G	T	4	18	22	0	25	47	0	0
13	5025938	.	A	G	27	0	27	0	26	53	0	0
13	5026062	.	A	G	31	25	56	0	3	59	0	0
13	5028407	.	G	A	27	30	57	0	4	61	0	0
13	5028414	.	T	C	27	25	52	0	8	60	0	0
13	5028471	.	T	G	28	31	59	0	1	60	0	0
13	5028538	.	T	G	29	27	56	0	3	59	0	0
13	5028751	.	T	C	26	26	52	0	3	55	0	0
13	5028802	.	T	C	20	24	44	0	1	45	0	0
13	5031689	.	T	A	2	3	5	0	0	5	0	0
13	5038238	.	C	G	4	3	7	0	0	7	0	0
13	5040437	.	G	A	1	2	3	0	0	3	0	0
13	5040445	.	T	C	1	1	2	0	0	2	0	0
13	5040500	.	A	G	1	2	3	0	0	3	0	0
13	5043828	.	T	G	3	2	5	0	0	5	0	0
13	5048344	.	G	T	2	5	7	0	0	7	0	0
13	5246065	.	T	C	3	2	5	0	0	5	0	0
13	5491234	.	G	A	16	27	43	0	2	45	0	0
13	5531709	.	A	G	16	22	38	2	2	42	0	0
13	5568993	.	G	A	16	6	22	0	1	23	0	0
13	5569344	.	C	T	11	10	21	0	0	21	0	0
13	5871084	.	C	A	5	3	8	0	0	8	0	0
13	5871321	.	G	A	5	3	8	0	1	9	0	0
13	5871340	.	G	C	8	4	12	0	0	12	0	0
13	5871445	.	G	A	7	8	15	0	0	15	0	0
13	5871757	.	C	G	4	5	9	0	0	9	0	0
13	5871834	.	C	T	1	6	7	0	7	14	0	0
13	5871928	.	G	A	6	4	10	0	0	10	0	0
13	5871967	.	A	G	9	3	12	1	1	14	0	0
13	5872300	.	G	A	8	3	11	0	1	12	0	0
13	5872717	.	A	G	9	12	21	0	0	21	0	0
13	5897408	.	G	A	6	5	11	0	0	11	0	0
13	5936945	.	T	G	7	9	16	0	1	17	0	0
13	5959654	.	T	C	8	9	17	0	3	20	0	0
13	5978430	.	C	G	3	2	5	0	0	5	0	0
13	5978865	.	T	C	11	13	24	0	0	24	0	0
13	6077117	.	G	A	1	2	3	0	0	3	0	0
13	6092108	.	C	G	5	2	7	0	0	7	0	0
13	6119843	.	A	G	2	3	5	0	0	5	0	0
13	6125154	.	T	C	2	2	4	0	2	6	0	0
13	6125207	.	A	T	7	3	10	0	1	11	0	0
13	6125217	.	G	A	0	5	5	0	5	10	0	0
13	6189925	.	T	G	10	0	10	0	11	21	0	0
13	6191523	.	C	A	6	12	18	0	0	19	1	0
13	6192433	.	C	A	6	10	16	0	1	17	0	0
13	6194867	.	T	A	7	9	16	0	0	16	0	0
13	6195043	.	T	G	13	0	13	0	12	25	0	0
13	6195055	.	A	T	13	8	21	0	2	23	0	0
13	6199336	.	G	A	2	10	12	0	11	23	0	0
13	6199375	.	T	C	10	9	19	0	1	20	0	0
13	6204583	.	G	A	16	9	25	0	0	25	0	0
13	6204957	.	T	C	5	6	11	0	0	11	0	0
13	6205311	.	G	A	4	3	7	0	0	7	0	0
13	6226012	.	G	C	9	6	15	0	1	16	0	0
13	6233482	.	A	C	8	4	12	0	3	15	0	0
13	6236772	.	G	A	9	7	16	0	0	16	0	0
13	6236796	.	C	T	8	10	18	0	1	19	0	0
13	6236901	.	G	A	15	14	29	0	0	29	0	0
13	6238204	.	G	A	11	8	19	0	1	20	0	0
13	6238466	.	T	C	10	12	22	0	0	22	0	0
13	6238658	.	G	T	1	14	15	0	8	23	0	0
13	6238762	.	A	G	8	12	20	0	0	20	0	0
13	6238883	.	A	G	9	5	14	0	0	14	0	0
13	6238972	.	G	A	12	12	24	0	0	24	0	0
13	6239031	.	C	T	4	6	10	0	2	12	0	0
13	6239091	.	A	T	4	5	9	0	0	9	0	0
13	6259409	.	T	G	3	4	7	0	0	7	0	0
13	6259600	.	T	A	3	2	5	0	1	6	0	0
13	6271263	.	C	T	3	4	7	0	0	7	0	0
13	6271347	.	A	G	4	3	7	0	0	7	0	0
13	6279404	.	G	T	1	2	3	0	0	3	0	0
13	6279412	.	C	A	2	2	4	0	1	5	0	0
13	6279479	.	C	T	3	2	5	0	0	5	0	0
13	6279570	.	C	T	0	3	3	0	2	5	0	0
13	7061687	.	G	A	1	2	3	0	0	3	0	0
13	7109218	.	A	G	2	3	5	0	0	5	0	0
13	7114439	.	T	C	2	2	4	0	0	4	0	0
13	7129881	.	C	T	5	3	8	0	1	9	0	0
13	7130882	.	G	A	0	5	5	0	4	9	0	0
13	7136285	.	G	C	3	3	6	0	0	6	0	0
13	7148075	.	G	A	1	3	4	0	0	4	0	0
13	7156984	.	A	G	2	0	2	0	3	5	0	0
13	7156987	.	A	G	2	0	2	0	3	5	0	0
13	7168777	.	T	C	1	3	4	0	0	4	0	0
13	7170250	.	C	T	2	1	3	0	1	4	0	0
13	7243048	.	G	A	0	7	7	0	2	9	0	0
13	7243397	.	T	C	10	7	17	0	0	17	0	0
13	7243431	.	A	G	8	9	17	0	0	17	0	0
13	7243484	.	C	T	5	8	13	0	1	14	0	0
13	7255659	.	T	C	10	10	20	0	0	20	0	0
13	7255664	.	G	A	9	11	20	0	0	20	0	0
13	7305412	.	T	C	6	10	16	0	1	17	0	0
13	7305556	.	C	T	5	7	12	0	1	13	0	0
13	7305568	.	T	A	4	8	12	0	0	12	0	0
13	7305601	.	G	A	1	4	5	0	5	10	0	0
13	7305625	.	T	A	5	4	9	0	1	10	0	0
13	7305637	.	T	A	6	5	11	0	0	11	0	0
13	7305715	.	A	G	6	6	12	0	0	12	0	0
13	7305861	.	T	C	6	2	8	0	0	8	0	0
13	7306606	.	A	T	10	6	16	0	0	16	0	0
13	7306731	.	T	C	8	6	14	0	0	14	0	0
13	7306738	.	C	T	9	6	15	0	0	15	0	0
13	7306994	.	T	A	6	7	13	0	0	13	0	0
13	7307382	.	A	C	4	4	8	0	0	8	0	0
13	7307512	.	T	C	8	3	11	0	0	11	0	0
13	7307601	.	C	T	3	4	7	0	1	8	0	0
13	7307869	.	A	G	3	4	7	0	0	7	0	0
13	7308279	.	T	C	8	6	14	0	0	14	0	0
13	7308285	.	T	C	8	3	11	0	0	11	0	0
13	7308855	.	C	T	7	2	9	0	0	9	0	0
13	7308947	.	A	T	2	6	8	0	0	8	0	0
13	7309141	.	T	C	4	4	8	0	0	8	0	0
13	7309392	.	C	T	5	9	14	0	0	14	0	0
13	7309507	.	A	T	4	8	12	0	1	13	0	0
13	7309710	.	A	G	6	3	9	0	1	10	0	0
13	7309721	.	T	C	5	3	8	0	0	8	0	0
13	7310386	.	C	A	6	5	11	0	0	11	0	0
13	7310428	.	G	A	4	4	8	0	0	8	0	0
13	7310986	.	C	T	3	6	9	0	0	9	0	0
13	7311089	.	C	T	4	7	11	0	0	11	0	0
13	7311154	.	T	G	5	0	5	0	8	13	0	0
13	7311218	.	A	G	3	8	11	0	0	11	0	0
13	7311324	.	T	G	5	4	9	0	0	9	0	0
13	7311420	.	C	A	9	8	17	0	0	17	0	0
13	7311476	.	C	T	5	6	11	0	0	11	0	0
13	7311849	.	C	T	6	10	16	0	1	17	0	0
13	7311986	.	A	C	6	13	19	0	1	20	0	0
13	7312015	.	T	A	10	16	26	0	0	26	0	0
13	7312170	.	C	T	9	15	24	0	1	25	0	0
13	7312201	.	T	A	7	14	21	0	1	22	0	0
13	7312225	.	G	C	8	10	18	0	3	21	0	0
13	7312527	.	G	A	1	13	14	0	13	27	0	0
13	7312585	.	T	C	9	13	22	0	0	22	0	0
13	7312675	.	C	T	14	6	20	0	0	20	0	0
13	7312713	.	T	A	11	3	14	0	0	14	0	0
13	7312991	.	T	C	11	11	22	0	0	22	0	0
13	7313020	.	G	A	1	12	13	0	8	21	0	0
13	7313066	.	T	G	6	7	13	0	0	13	0	0
13	7313185	.	T	C	11	10	21	0	1	22	0	0
13	7313304	.	A	G	9	11	20	0	1	21	0	0
13	7313324	.	T	A	10	13	23	0	0	23	0	0
13	7313436	.	T	C	8	6	14	0	0	14	0	0
13	7313546	.	A	G	8	9	17	0	0	17	0	0
13	7313613	.	C	T	6	8	14	0	0	14	0	0
13	7313641	.	C	A	10	8	18	0	0	18	0	0
13	7313703	.	C	T	13	15	28	0	3	31	0	0
13	7313827	.	C	T	14	11	25	0	0	25	0	0
13	7314049	.	T	C	12	10	22	0	1	23	0	0
13	7314222	.	A	T	18	7	25	0	0	25	0	0
13	7314300	.	T	C	16	9	25	0	0	25	0	0
13	7314567	.	C	A	9	16	25	1	0	26	0	0
13	7314568	.	T	G	9	16	25	1	0	26	0	0
13	7314736	.	A	C	13	15	28	0	1	29	0	0
13	7315123	.	C	T	23	16	39	0	1	40	0	0
13	7315174	.	C	A	20	16	36	0	0	36	0	0
13	7315197	.	A	G	17	0	17	0	20	37	0	0
13	7315234	.	A	G	15	24	39	0	1	40	0	0
13	7315597	.	A	G	14	0	14	0	9	23	0	0
13	7316042	.	C	A	20	9	29	0	1	30	0	0
13	7316157	.	G	T	9	17	26	0	0	26	0	0
13	7316207	.	C	T	6	7	13	0	0	13	0	0
13	7316463	.	G	A	9	6	15	0	0	15	0	0
13	7316484	.	A	T	8	8	16	0	0	16	0	0
13	7316532	.	C	A	7	7	14	0	2	16	0	0
13	7316537	.	A	C	9	8	17	0	0	17	0	0
13	7316784	.	G	A	11	7	18	0	0	18	0	0
13	7316830	.	C	G	8	3	11	0	0	11	0	0
13	7322524	.	C	T	17	10	27	0	0	27	0	0
13	7340207	.	A	T	4	2	6	0	0	7	1	0
13	7340264	.	C	G	10	6	16	0	0	16	0	0
13	7340289	.	A	C	11	4	15	0	2	17	0	0
13	7346655	.	C	A	18	6	24	1	0	25	0	0
13	7346683	.	A	G	13	10	23	1	1	25	0	0
13	7346798	.	A	G	18	12	30	0	2	32	0	0
13	7346928	.	A	C	18	7	25	0	0	25	0	0
13	7346942	.	T	C	12	6	18	0	1	19	0	0
13	7347026	.	A	G	13	8	21	0	1	22	0	0
13	7347060	.	G	T	10	5	15	0	0	15	0	0
13	7347061	.	A	T	9	5	14	0	0	15	1	0
13	7651815	.	A	G	2	2	4	0	0	4	0	0
13	7651854	.	G	A	1	2	3	0	2	5	0	0
13	7687756	.	G	A	6	9	15	0	0	15	0	0
13	7687786	.	T	C	7	8	15	0	0	15	0	0
13	7689546	.	C	A	6	10	16	0	1	17	0	0
13	7690025	.	G	A	8	5	13	0	0	13	0	0
13	7690033	.	T	A	10	5	15	0	0	15	0	0
13	7690060	.	G	A	9	3	12	0	0	12	0	0
13	7690124	.	G	A	6	5	11	0	0	11	0	0
13	7693225	.	T	A	5	1	6	0	5	11	0	0
13	7693615	.	A	C	3	3	6	0	0	6	0	0
13	7698480	.	C	T	3	6	9	0	0	9	0	0
13	7698537	.	T	C	4	7	11	0	1	12	0	0
13	7703468	.	T	C	5	5	10	0	0	10	0	0
13	7703470	.	A	T	5	5	10	0	0	10	0	0
13	7718784	.	C	T	2	5	7	0	0	7	0	0
13	7718996	.	A	G	3	5	8	0	0	8	0	0
13	7721296	.	T	C	4	4	8	0	0	8	0	0
13	7721329	.	C	T	2	5	7	0	0	7	0	0
13	7721511	.	C	T	1	4	5	0	0	5	0	0
13	7725965	.	C	T	9	5	14	0	0	14	0	0
13	7728958	.	C	T	7	5	12	0	0	12	0	0
13	7737020	.	G	A	1	9	10	0	2	12	0	0
13	7737101	.	G	A	0	7	7	0	8	15	0	0
13	7744319	.	A	G	7	7	14	0	1	15	0	0
13	7744443	.	G	A	13	12	25	0	2	27	0	0
13	7745463	.	C	G	12	7	19	0	2	21	0	0
13	7745544	.	C	T	16	6	22	0	0	22	0	0
13	7745705	.	G	A	4	7	11	0	1	12	0	0
13	7745814	.	C	A	4	5	9	0	1	10	0	0
13	7745866	.	A	G	3	0	3	0	6	9	0	0
13	7745962	.	A	G	2	4	6	0	0	6	0	0
13	7745979	.	T	C	1	4	5	0	0	5	0	0
13	7747299	.	A	G	3	5	8	0	0	8	0	0
13	7747338	.	A	G	9	0	9	0	4	13	0	0
13	7747513	.	C	G	6	6	12	0	0	12	0	0
13	7747738	.	T	C	6	16	22	0	1	23	0	0
13	7747760	.	T	C	10	12	22	0	2	24	0	0
13	7748021	.	G	T	8	9	17	0	1	18	0	0
13	7748424	.	T	C	12	11	23	0	1	24	0	0
13	7748497	.	T	G	6	3	9	0	0	9	0	0
13	7748533	.	T	G	6	7	13	0	1	14	0	0
13	7748794	.	G	A	0	16	16	0	8	24	0	0
13	7748882	.	A	T	10	16	26	0	1	27	0	0
13	7748995	.	T	A	3	11	14	0	0	14	0	0
13	7749000	.	G	C	3	10	13	0	0	13	0	0
13	7755764	.	A	C	29	0	29	0	18	47	0	0
13	7755875	.	T	C	31	1	32	0	21	53	0	0
13	7759403	.	T	C	28	28	56	0	1	57	0	0
13	7763810	.	A	G	21	15	36	0	1	37	0	0
13	7766936	.	C	T	2	17	19	0	23	42	0	0
13	7767013	.	C	T	4	4	8	0	1	9	0	0
13	8142558	.	A	G	3	3	6	0	0	6	0	0
13	8270551	.	C	T	4	4	8	0	0	8	0	0
13	8270554	.	T	C	3	4	7	0	1	8	0	0
13	8270586	.	G	T	3	2	5	0	0	5	0	0
13	8281433	.	C	T	1	4	5	0	0	5	0	0
13	8281655	.	A	C	7	4	11	0	0	11	0	0
13	8281717	.	C	G	2	2	4	0	0	4	0	0
13	8281828	.	G	A	2	5	7	0	0	7	0	0
13	8281876	.	G	T	4	5	9	0	0	9	0	0
13	8281882	.	T	G	4	4	8	0	0	8	0	0
13	8285256	.	T	A	8	12	20	0	0	20	0	0
13	8285430	.	G	A	8	5	13	0	0	13	0	0
13	8290860	.	A	C	4	2	6	0	0	6	0	0
13	8294201	.	C	T	1	3	4	0	4	8	0	0
13	8296502	.	G	A	6	6	12	0	0	12	0	0
13	8320575	.	G	A	3	2	5	0	1	6	0	0
13	8320743	.	A	G	6	2	8	0	0	8	0	0
13	8320890	.	A	G	2	3	5	0	0	5	0	0
13	8326274	.	T	C	6	7	13	0	1	14	0	0
13	8330296	.	G	C	1	3	4	0	0	4	0	0
13	8330568	.	G	A	3	4	7	0	0	7	0	0
13	8345298	.	A	G	5	3	8	0	0	8	0	0
13	8348161	.	G	A	3	6	9	0	0	9	0	0
13	8348241	.	A	T	4	3	7	0	0	7	0	0
13	8352188	.	A	C	4	0	4	0	5	9	0	0
13	8375857	.	T	C	9	0	9	0	4	13	0	0
13	8375932	.	A	T	11	11	22	0	1	23	0	0
13	8375935	.	C	A	11	13	24	0	1	25	0	0
13	8375981	.	A	G	19	21	40	0	1	41	0	0
13	8376064	.	A	G	15	13	28	0	1	29	0	0
13	8376077	.	C	G	14	13	27	0	2	29	0	0
13	8376184	.	C	T	9	11	20	0	1	21	0	0
13	8376187	.	G	A	10	12	22	0	0	22	0	0
13	8376301	.	A	T	8	9	17	0	0	17	0	0
13	8376317	.	T	A	8	11	19	0	1	20	0	0
13	8376355	.	C	T	10	12	22	0	0	22	0	0
13	8376613	.	T	G	7	11	18	0	0	18	0	0
13	8376675	.	C	A	1	5	6	0	9	15	0	0
13	8376731	.	C	T	9	2	11	0	3	14	0	0
13	8376765	.	C	A	13	5	18	0	1	19	0	0
13	8376845	.	A	G	7	4	11	0	1	12	0	0
13	8376882	.	C	T	2	5	7	0	5	12	0	0
13	8376896	.	T	C	7	5	12	0	0	12	0	0
13	8377327	.	A	G	3	3	6	0	1	7	0	0
13	8377334	.	A	G	4	4	8	0	0	8	0	0
13	8377606	.	A	G	3	3	6	0	0	6	0	0
13	8378018	.	A	C	4	3	7	0	0	7	0	0
13	8378280	.	C	T	0	6	6	0	2	9	1	0
13	8378391	.	G	C	5	1	6	0	0	6	0	0
13	8378400	.	T	C	5	2	7	0	0	7	0	0
13	8378511	.	A	T	7	4	11	0	2	13	0	0
13	8378559	.	C	A	8	4	12	0	0	12	0	0
13	8378588	.	C	A	0	2	2	0	11	13	0	0
13	8378738	.	T	C	6	3	9	0	1	10	0	0
13	8378779	.	T	C	2	0	2	0	4	6	0	0
13	8379079	.	A	C	3	0	3	0	6	9	0	0
13	8379096	.	T	G	3	5	8	0	0	8	0	0
13	8379119	.	C	T	2	4	6	0	0	6	0	0
13	8379171	.	A	T	8	4	12	0	1	13	0	0
13	8379447	.	A	G	3	3	6	1	0	7	0	0
13	8379510	.	A	G	5	2	7	0	0	7	0	0
13	8379528	.	T	C	2	0	2	0	3	5	0	0
13	8380605	.	A	G	5	2	7	0	0	7	0	0
13	8381285	.	C	T	3	2	5	0	1	6	0	0
13	8381341	.	A	G	1	6	7	0	0	7	0	0
13	8388201	.	T	G	0	3	3	0	1	4	0	0
13	8388215	.	T	C	1	3	4	0	0	4	0	0
13	8446055	.	C	T	1	2	3	0	1	4	0	0
13	8453560	.	C	A	1	2	3	0	0	3	0	0
13	8453571	.	T	A	1	3	4	0	0	4	0	0
13	8453690	.	C	T	2	6	8	0	0	8	0	0
13	8600097	.	A	G	3	2	5	0	0	5	0	0
13	8605132	.	T	A	7	3	10	0	0	10	0	0
13	8605145	.	T	A	8	3	11	0	0	11	0	0
13	8605186	.	T	A	9	3	12	0	0	12	0	0
13	8621601	.	A	C	2	7	9	0	0	9	0	0
13	8621808	.	C	G	6	3	9	0	1	10	0	0
13	8621955	.	T	C	5	7	12	0	0	12	0	0
13	8622003	.	A	C	2	2	4	0	1	5	0	0
13	8622084	.	A	G	9	6	15	0	0	15	0	0
13	8622801	.	T	C	3	3	6	0	0	6	0	0
13	8623517	.	A	C	6	6	12	0	1	13	0	0
13	8624658	.	T	C	6	6	12	0	1	13	0	0
13	8624659	.	G	T	7	6	13	0	0	13	0	0
13	8625050	.	A	G	2	0	2	0	5	7	0	0
13	8625102	.	T	C	4	5	9	0	0	9	0	0
13	8625106	.	T	A	4	4	8	0	0	8	0	0
13	8626252	.	C	G	3	4	7	1	0	8	0	0
13	8626645	.	T	A	4	6	10	0	0	10	0	0
13	8626699	.	C	T	6	15	21	0	0	21	0	0
13	8626841	.	C	T	5	6	11	0	0	11	0	0
13	8626957	.	C	T	2	3	5	0	0	5	0	0
13	8627056	.	T	C	4	9	13	0	0	13	0	0
13	8627178	.	T	A	9	8	17	0	0	17	0	0
13	8627179	.	A	T	8	8	16	0	0	17	1	0
13	8627222	.	C	T	10	4	14	0	0	14	0	0
13	8627445	.	A	G	7	3	10	0	2	12	0	0
13	8627634	.	T	A	9	3	12	0	0	12	0	0
13	8627748	.	T	C	4	4	8	0	0	8	0	0
13	8627819	.	T	C	3	6	9	0	0	9	0	0
13	8627947	.	C	T	1	2	3	0	0	3	0	0
13	8683804	.	C	T	6	2	8	0	0	8	0	0
13	8684134	.	A	G	1	7	8	0	0	8	0	0
13	8684175	.	C	T	2	2	4	0	1	5	0	0
13	8684460	.	A	G	7	5	12	0	0	12	0	0
13	8684464	.	G	A	7	5	12	0	0	12	0	0
13	8684499	.	C	T	10	4	14	0	0	14	0	0
13	8684513	.	T	C	10	6	16	0	2	18	0	0
13	8684608	.	G	A	1	7	8	0	2	10	0	0
13	8684705	.	A	G	4	10	14	0	2	16	0	0
13	8685051	.	C	T	0	6	6	0	5	11	0	0
13	8685176	.	C	T	5	4	9	0	1	10	0	0
13	8685217	.	A	T	3	5	8	0	0	8	0	0
13	8685228	.	G	C	3	5	8	0	0	8	0	0
13	8685278	.	C	A	5	4	9	0	0	9	0	0
13	8685417	.	G	A	4	6	10	0	0	10	0	0
13	8685496	.	A	T	5	5	10	0	2	12	0	0
13	8685542	.	G	A	8	8	16	0	1	17	0	0
13	8692306	.	C	T	13	5	18	0	0	18	0	0
13	8692395	.	A	G	11	11	22	0	0	22	0	0
13	8692776	.	T	G	15	12	27	0	1	28	0	0
13	8777701	.	G	A	14	12	26	0	4	30	0	0
13	8777724	.	T	C	9	16	25	0	1	26	0	0
13	8778490	.	G	A	37	38	75	0	1	76	0	0
13	8778501	.	G	T	37	33	70	0	5	75	0	0
13	8778548	.	G	A	44	25	69	0	3	72	0	0
13	8781087	.	G	T	1	4	5	0	0	5	0	0
13	8781128	.	T	A	3	2	5	0	0	5	0	0
13	8781159	.	G	C	3	0	3	0	3	6	0	0
13	8781222	.	T	C	4	7	11	0	0	11	0	0
13	8781266	.	A	G	1	4	5	0	0	5	0	0
13	8781577	.	A	G	39	32	71	0	2	73	0	0
13	8781786	.	C	T	37	28	65	0	2	67	0	0
13	8781789	.	A	C	37	29	66	0	0	66	0	0
13	8782036	.	T	C	1	1	2	0	1	3	0	0
13	8785294	.	C	G	17	24	41	0	0	41	0	0
13	8785327	.	T	C	10	5	15	0	0	15	0	0
13	8843022	.	G	C	1	2	3	0	0	3	0	0
13	8894831	.	T	A	2	2	4	0	0	4	0	0
13	8894847	.	G	T	0	2	2	0	1	3	0	0
13	8898541	.	C	A	3	2	5	0	0	5	0	0
13	8937231	.	T	G	1	0	1	0	2	3	0	0
13	8937412	.	A	G	2	6	8	0	0	8	0	0
13	8937472	.	T	G	4	4	8	0	0	8	0	0
13	8945365	.	C	T	2	4	6	0	0	6	0	0
13	8945642	.	C	G	2	3	5	0	1	6	0	0
13	8945646	.	T	G	2	4	6	0	0	6	0	0
13	8946981	.	T	C	4	3	7	0	0	7	0	0
13	8947095	.	C	T	3	2	5	0	0	5	0	0
13	8950783	.	C	G	5	2	7	0	1	8	0	0
13	8950795	.	C	A	2	5	7	0	0	7	0	0
13	8951259	.	T	G	1	4	5	0	0	5	0	0
13	9300177	.	A	G	7	9	16	0	1	17	0	0
13	9300224	.	C	T	0	8	8	0	5	13	0	0
13	9300239	.	G	T	3	4	7	0	0	7	0	0
13	9307202	.	C	T	0	8	8	0	10	18	0	0
13	9307646	.	T	C	13	12	25	0	0	25	0	0
13	9311011	.	G	T	16	6	22	0	0	22	0	0
13	9314040	.	T	A	37	33	70	0	1	71	0	0
13	9314104	.	C	T	2	32	34	0	27	61	0	0
13	9314322	.	G	A	31	30	61	0	2	63	0	0
13	9314340	.	C	T	32	30	62	0	5	67	0	0
13	9314532	.	T	C	32	5	37	0	35	72	0	0
13	9314657	.	C	T	37	30	67	0	4	71	0	0
13	9314680	.	G	A	43	28	71	0	1	72	0	0
13	9314800	.	T	C	45	34	79	0	1	80	0	0
13	9314935	.	G	A	36	41	77	0	1	78	0	0
13	9315004	.	C	T	35	35	70	0	2	72	0	0
13	9315019	.	T	C	29	42	71	0	2	73	0	0
13	9315178	.	T	C	61	18	79	0	0	79	0	0
13	9315192	.	T	C	39	39	78	0	1	79	0	0
13	9315321	.	G	T	47	41	88	0	4	92	0	0
13	9317915	.	T	C	34	51	85	0	4	89	0	0
13	9318491	.	G	C	38	46	84	0	5	89	0	0
13	9318638	.	G	C	23	3	26	0	47	73	0	0
13	9318644	.	T	C	22	50	72	0	1	73	0	0
13	9318682	.	T	C	29	0	29	0	49	78	0	0
13	9318699	.	A	T	42	30	72	0	2	74	0	0
13	9340093	.	C	T	1	5	6	0	3	9	0	0
13	9340199	.	T	C	9	3	12	0	1	14	1	0
13	9340527	.	C	T	7	6	13	0	0	13	0	0
13	9340609	.	C	A	0	11	11	0	10	21	0	0
13	9340671	.	G	A	8	8	16	0	0	16	0	0
13	9343329	.	T	C	11	10	21	0	1	22	0	0
13	9344878	.	A	T	13	7	20	0	0	20	0	0
13	9345182	.	A	C	9	13	22	0	1	23	0	0
13	9351194	.	T	C	15	13	28	0	1	29	0	0
13	9358449	.	C	T	8	10	18	0	2	20	0	0
13	9361825	.	T	C	6	11	17	0	1	18	0	0
13	9362035	.	T	A	4	6	10	0	0	10	0	0
13	9367117	.	G	T	6	8	14	0	0	14	0	0
13	9367537	.	A	G	8	6	14	0	3	17	0	0
13	9367562	.	T	A	13	10	23	0	1	24	0	0
13	9367600	.	G	T	10	8	18	0	0	18	0	0
13	9370743	.	A	C	2	5	7	0	0	7	0	0
13	9373300	.	G	C	1	3	4	0	0	4	0	0
13	9373809	.	C	G	1	4	5	0	0	5	0	0
13	9374113	.	C	T	1	4	5	0	0	5	0	0
13	9374140	.	G	A	1	4	5	0	0	5	0	0
13	9374283	.	G	A	0	2	2	0	2	4	0	0
13	9374533	.	A	G	2	2	4	0	0	4	0	0
13	9374827	.	C	G	2	2	4	0	0	4	0	0
13	9655947	.	C	A	4	3	7	0	0	7	0	0
13	9655952	.	C	G	4	2	6	0	0	6	0	0
13	9725467	.	T	C	2	2	4	0	2	6	0	0
13	9755552	.	C	T	2	2	4	0	0	4	0	0
13	9755583	.	G	A	1	2	3	0	0	3	0	0
13	9759182	.	C	T	3	2	5	0	0	5	0	0
13	9759974	.	A	G	2	3	5	0	0	5	0	0
13	9760013	.	A	G	5	0	5	0	2	7	0	0
13	9760021	.	A	G	4	3	7	0	0	7	0	0
13	9760102	.	A	G	2	2	4	0	0	4	0	0
13	9760378	.	A	G	1	2	3	0	0	3	0	0
13	9760513	.	A	G	1	0	1	0	3	4	0	0
13	9828568	.	A	T	4	3	7	0	0	7	0	0
13	9828572	.	G	A	1	4	5	0	3	8	0	0
13	9828933	.	G	T	3	8	11	0	0	11	0	0
13	9829007	.	A	G	3	2	5	0	0	5	0	0
13	9829013	.	C	T	2	2	4	0	1	5	0	0
13	9829274	.	C	A	5	3	8	0	0	8	0	0
13	9829289	.	T	C	5	4	9	0	0	9	0	0
13	9829406	.	A	C	1	2	3	0	0	3	0	0
13	9829408	.	G	A	1	2	3	0	0	3	0	0
13	9829855	.	C	T	4	4	8	0	1	9	0	0
13	9829987	.	T	C	7	5	12	0	0	12	0	0
13	9829990	.	T	C	8	5	13	0	0	13	0	0
13	9830089	.	T	C	1	6	7	0	0	7	0	0
13	9830371	.	T	C	1	2	3	0	0	3	0	0
13	9830399	.	C	T	0	2	2	0	1	3	0	0
13	9830518	.	A	T	2	6	8	0	0	8	0	0
13	9830521	.	A	C	2	5	7	0	0	7	0	0
13	9830554	.	A	G	3	4	7	0	0	7	0	0
13	9830686	.	A	T	1	3	4	0	0	4	0	0
13	9831056	.	G	C	1	6	7	0	0	7	0	0
13	9831116	.	A	G	5	5	10	0	0	10	0	0
13	9836485	.	A	T	5	6	11	0	0	11	0	0
13	9839813	.	G	A	3	11	14	0	1	15	0	0
13	9840152	.	G	A	12	7	19	0	0	19	0	0
13	9841702	.	T	A	19	9	28	0	1	29	0	0
13	9844527	.	A	G	16	2	18	0	13	31	0	0
13	9844746	.	T	C	18	28	46	0	1	47	0	0
13	9855508	.	G	T	9	9	18	0	0	18	0	0
13	9855874	.	G	A	14	14	28	0	0	28	0	0
13	9856143	.	G	A	11	8	19	0	0	19	0	0
13	9856192	.	A	G	11	14	25	0	0	25	0	0
13	9856493	.	A	T	18	16	34	0	2	36	0	0
13	9856816	.	G	A	14	12	26	0	2	28	0	0
13	9866857	.	G	A	9	10	19	1	0	20	0	0
13	9901540	.	C	G	1	2	3	0	0	3	0	0
13	9903744	.	G	T	1	5	6	0	0	6	0	0
13	9924978	.	C	T	3	3	6	0	0	6	0	0
13	9924993	.	G	C	3	3	6	0	0	6	0	0
13	9925017	.	T	G	3	2	5	0	0	5	0	0
13	10004081	.	T	A	1	2	3	0	0	3	0	0
13	10004092	.	A	G	1	2	3	0	0	3	0	0
13	10895731	.	T	G	9	12	21	0	1	22	0	0
13	10906719	.	G	A	15	13	28	0	1	29	0	0
13	10906817	.	T	C	21	8	29	0	0	29	0	0
13	10910423	.	G	T	2	10	12	0	23	35	0	0
13	10922497	.	T	G	1	3	4	0	0	4	0	0
13	10922568	.	T	C	4	1	5	0	0	5	0	0
13	10922578	.	C	T	4	3	7	0	1	8	0	0
13	10922613	.	A	T	6	4	10	0	0	10	0	0
13	10922660	.	G	A	4	2	6	0	1	7	0	0
13	10975980	.	G	A	1	2	3	0	0	3	0	0
13	10976428	.	T	C	2	4	6	0	0	6	0	0
13	10976431	.	A	G	2	3	5	0	1	6	0	0
13	10978512	.	A	T	2	5	7	0	0	7	0	0
13	10978526	.	C	T	2	4	6	0	0	6	0	0
13	10978589	.	A	T	2	2	4	0	0	4	0	0
13	10982404	.	C	T	16	13	29	0	0	29	0	0
13	10982444	.	G	A	17	14	31	0	0	31	0	0
13	10982472	.	T	G	12	15	27	0	2	29	0	0
13	10982739	.	A	T	13	4	17	0	0	17	0	0
13	10982741	.	A	C	13	4	17	0	0	17	0	0
13	10982966	.	A	T	9	14	23	0	0	23	0	0
13	10983139	.	C	T	3	6	9	0	0	9	0	0
13	10983231	.	G	A	8	4	12	0	0	12	0	0
13	10983421	.	C	A	13	6	19	0	0	19	0	0
13	10983482	.	T	A	10	8	18	0	0	18	0	0
13	10983788	.	T	C	17	10	27	0	1	28	0	0
13	10983821	.	G	T	15	6	21	0	2	23	0	0
13	10984205	.	G	A	17	25	42	0	2	44	0	0
13	10990959	.	G	A	9	6	15	0	0	15	0	0
13	10990973	.	T	C	10	0	10	0	7	17	0	0
13	10994107	.	A	G	15	12	27	0	0	27	0	0
13	10997566	.	A	G	14	9	23	0	2	25	0	0
13	11001998	.	A	G	9	15	24	0	1	25	0	0
13	11002013	.	A	C	9	0	9	0	15	24	0	0
13	11002052	.	A	G	17	6	23	0	0	23	0	0
13	11002234	.	C	T	4	12	16	0	6	22	0	0
13	11002247	.	G	A	10	11	21	0	0	21	0	0
13	11002541	.	A	G	13	7	20	0	3	23	0	0
13	11002697	.	A	G	8	13	21	0	1	22	0	0
13	11002778	.	T	C	12	9	21	0	1	22	0	0
13	11002922	.	C	T	8	13	21	0	0	21	0	0
13	11002970	.	T	C	8	10	18	0	1	19	0	0
13	11003297	.	C	T	1	10	11	0	4	15	0	0
13	11007087	.	G	A	4	7	11	0	0	11	0	0
13	11012312	.	G	T	4	6	10	1	0	11	0	0
13	11012349	.	C	T	10	4	14	0	0	14	0	0
13	11012469	.	T	C	6	8	14	0	1	15	0	0
13	11020257	.	C	T	2	4	6	0	0	6	0	0
13	11029585	.	G	T	8	5	13	0	0	13	0	0
13	11035307	.	G	A	7	4	11	0	0	11	0	0
13	11035313	.	C	T	0	4	4	0	5	9	0	0
13	11035406	.	A	G	4	4	8	0	1	9	0	0
13	11035409	.	G	A	4	4	8	0	2	10	0	0
13	11073409	.	T	G	3	3	6	0	0	6	0	0
13	11077508	.	C	A	3	3	6	0	0	6	0	0
13	11083167	.	A	G	5	4	9	0	1	10	0	0
13	11086319	.	C	G	3	0	3	0	4	7	0	0
13	11119837	.	A	G	7	4	11	0	1	12	0	0
13	11166435	.	G	A	4	5	9	0	1	10	0	0
13	11166467	.	A	G	2	3	5	0	0	5	0	0
13	11166613	.	C	G	1	1	2	0	0	2	0	0
13	11175605	.	G	A	5	2	7	0	1	8	0	0
13	11176295	.	T	C	2	5	7	0	0	7	0	0
13	11184784	.	G	A	7	9	16	0	2	18	0	0
13	11233520	.	G	C	8	15	23	0	0	23	0	0
13	11441080	.	T	A	14	18	32	0	3	35	0	0
13	11442090	.	A	T	17	22	39	0	1	40	0	0
13	11443457	.	T	A	21	26	47	0	0	47	0	0
13	11443881	.	C	T	25	16	41	0	1	42	0	0
13	11444022	.	A	T	12	19	31	0	1	32	0	0
13	11444263	.	G	A	3	25	28	0	19	47	0	0
13	11444295	.	C	T	26	24	50	0	2	52	0	0
13	11444801	.	T	A	19	10	29	0	4	33	0	0
13	11489965	.	T	C	12	10	22	0	0	22	0	0
13	11489999	.	C	A	14	15	29	0	0	29	0	0
13	11490035	.	A	G	19	15	34	0	0	34	0	0
13	11490065	.	G	A	18	9	27	0	2	29	0	0
13	11490084	.	G	A	23	6	29	0	1	30	0	0
13	11490214	.	A	C	2	3	5	0	0	5	0	0
13	11490300	.	G	T	2	2	4	0	3	7	0	0
13	11490626	.	G	A	13	6	19	1	1	21	0	0
13	11500299	.	T	C	8	0	8	0	18	26	0	0
13	11503682	.	G	A	8	7	15	0	0	15	0	0
13	11536901	.	T	A	8	11	19	0	0	19	0	0
13	11550734	.	G	T	1	8	9	0	7	16	0	0
13	11550741	.	T	C	5	8	13	0	0	13	0	0
13	11675148	.	G	A	6	4	10	0	1	11	0	0
13	11675185	.	A	G	5	3	8	0	1	9	0	0
13	11675270	.	G	A	4	2	6	0	1	7	0	0
13	11675343	.	C	G	6	3	9	0	0	9	0	0
13	11675378	.	T	C	5	4	9	0	0	9	0	0
13	11675584	.	C	T	6	5	11	0	0	11	0	0
13	11675855	.	T	G	4	3	7	0	1	8	0	0
13	11675912	.	A	T	2	3	5	0	0	5	0	0
13	11675951	.	G	A	6	2	8	0	1	9	0	0
13	11676330	.	A	G	1	4	5	0	0	5	0	0
13	11676337	.	G	A	1	3	4	0	0	4	0	0
13	11676403	.	C	T	3	6	9	0	0	9	0	0
13	11676472	.	A	G	6	2	8	0	1	9	0	0
13	11676516	.	G	A	3	3	6	0	0	6	0	0
13	11676535	.	G	A	2	3	5	0	0	5	0	0
13	11676614	.	A	G	1	4	5	0	0	5	0	0
13	11676639	.	G	A	1	4	5	0	0	5	0	0
13	11676694	.	G	A	6	5	11	0	0	11	0	0
13	11676787	.	A	C	3	0	3	1	2	6	0	0
13	11677524	.	G	A	2	3	5	0	0	5	0	0
13	11677606	.	A	G	3	2	5	0	0	5	0	0
13	11678444	.	T	C	4	0	4	0	6	10	0	0
13	11679322	.	C	G	3	4	7	0	0	7	0	0
13	11679360	.	T	A	3	2	5	0	0	5	0	0
13	11679375	.	A	T	4	2	6	0	0	6	0	0
13	11696126	.	G	T	1	2	3	0	0	3	0	0
13	11718640	.	C	T	2	2	4	0	0	4	0	0
13	11718832	.	A	G	1	2	3	0	1	4	0	0
13	11718839	.	G	C	1	4	5	0	0	5	0	0
13	11719120	.	T	A	1	3	4	0	0	4	0	0
13	11719917	.	A	C	2	2	4	0	0	4	0	0
13	11746459	.	C	A	16	16	32	0	2	34	0	0
13	11751402	.	G	A	15	14	29	0	1	30	0	0
13	11767651	.	T	C	5	4	9	0	0	9	0	0
13	11767768	.	A	G	3	6	9	0	1	10	0	0
13	11775095	.	G	A	6	5	11	0	0	11	0	0
13	11781751	.	C	T	2	4	6	0	7	13	0	0
13	11781769	.	A	G	5	3	8	0	0	8	0	0
13	11791391	.	A	G	4	5	9	0	0	9	0	0
13	11791499	.	A	G	3	5	8	0	0	8	0	0
13	11829109	.	C	A	3	4	7	0	1	8	0	0
13	11829112	.	T	A	3	5	8	0	0	8	0	0
13	11829158	.	T	A	6	4	10	0	1	11	0	0
13	11836187	.	C	T	6	9	15	0	0	15	0	0
13	11852302	.	C	T	9	4	13	0	0	13	0	0
13	11860525	.	T	C	2	2	4	0	1	5	0	0
13	11868812	.	A	G	5	5	10	0	0	10	0	0
13	11869049	.	G	T	11	5	16	0	0	16	0	0
13	11869127	.	C	T	10	4	14	0	1	15	0	0
13	11869143	.	T	C	7	5	12	0	2	14	0	0
13	11869219	.	G	T	5	5	10	0	0	10	0	0
13	11869220	.	G	T	4	5	9	0	0	9	0	0
13	11869357	.	G	T	4	5	9	0	0	9	0	0
13	11869539	.	T	C	5	5	10	0	0	10	0	0
13	11876698	.	T	G	4	6	10	0	2	12	0	0
13	11876841	.	G	A	6	5	11	0	0	11	0	0
13	11876850	.	G	A	6	5	11	0	0	11	0	0
13	11911904	.	A	G	8	8	16	0	1	17	0	0
13	11921543	.	T	C	6	7	13	0	0	13	0	0
13	11923834	.	G	C	10	10	20	0	1	21	0	0
13	11926692	.	C	G	7	13	20	0	0	20	0	0
13	11927341	.	C	G	11	6	17	0	0	17	0	0
13	11927347	.	T	A	10	5	15	0	0	15	0	0
13	11927491	.	T	C	6	11	17	0	0	17	0	0
13	11927603	.	A	G	2	3	5	0	0	5	0	0
13	11927735	.	T	C	5	6	11	0	0	11	0	0
13	11927829	.	A	T	7	5	12	1	2	15	0	0
13	11927830	.	T	G	8	5	13	1	1	15	0	0
13	11966316	.	A	G	4	3	7	0	0	7	0	0
13	11967334	.	T	A	1	2	3	0	0	12	9	0
13	11977394	.	A	T	6	4	10	0	0	10	0	0
13	11984768	.	A	C	8	13	21	0	0	21	0	0
13	11984857	.	T	A	4	3	7	0	0	7	0	0
13	11989357	.	T	C	21	15	36	0	2	38	0	0
13	11989468	.	A	C	22	11	33	1	3	37	0	0
13	11989554	.	A	G	20	18	38	0	1	39	0	0
13	11989629	.	C	T	32	14	46	0	0	46	0	0
13	11989633	.	T	C	30	14	44	0	1	45	0	0
13	11989698	.	C	T	19	15	34	0	2	36	0	0
13	11990118	.	G	A	20	15	35	0	0	35	0	0
13	11990175	.	T	C	14	1	15	0	13	28	0	0
13	11990294	.	A	G	24	15	39	0	1	40	0	0
13	11990329	.	T	G	22	14	36	0	2	38	0	0
13	11990389	.	G	T	19	10	29	0	2	31	0	0
13	11993451	.	A	T	22	14	36	0	1	37	0	0
13	12000699	.	T	C	14	8	22	0	1	23	0	0
13	12000700	.	G	C	14	8	22	0	0	22	0	0
13	12000906	.	T	A	12	18	30	0	1	31	0	0
13	12001110	.	T	C	11	7	18	0	0	18	0	0
13	12001254	.	A	G	15	14	29	0	0	29	0	0
13	12003230	.	A	G	10	9	19	0	0	19	0	0
13	12003905	.	T	C	9	0	9	0	9	18	0	0
13	12005588	.	C	T	1	4	5	0	12	17	0	0
13	12005859	.	T	A	11	8	19	0	0	19	0	0
13	12016719	.	A	T	1	2	3	0	0	3	0	0
13	12016722	.	T	C	1	0	1	0	2	3	0	0
13	12045797	.	A	T	5	7	12	0	1	13	0	0
13	12087528	.	G	A	4	18	22	0	24	46	0	0
13	12088223	.	C	G	18	19	37	0	0	37	0	0
13	12088255	.	A	G	15	17	32	0	0	32	0	0
13	12088327	.	A	G	12	9	21	0	0	21	0	0
13	12088406	.	T	C	12	13	25	0	0	25	0	0
13	12141929	.	A	G	3	3	6	0	0	6	0	0
13	12142001	.	G	A	6	2	8	0	0	8	0	0
13	12142007	.	T	C	5	2	7	0	1	8	0	0
13	12142204	.	G	A	5	7	12	0	3	15	0	0
13	12150892	.	C	T	7	8	15	0	0	16	1	0
13	12183498	.	G	A	1	4	5	0	2	7	0	0
13	12183918	.	C	A	4	2	6	0	0	6	0	0
13	12201923	.	C	G	6	2	8	0	0	8	0	0
13	12202096	.	A	T	4	4	8	0	1	9	0	0
13	12207170	.	A	T	7	8	15	0	1	16	0	0
13	12207583	.	G	T	4	4	8	0	1	9	0	0
13	12207591	.	A	T	5	4	9	0	1	10	0	0
13	12207656	.	C	T	7	6	13	0	0	13	0	0
13	12300502	.	G	A	4	2	6	0	0	6	0	0
13	12329553	.	C	T	3	5	8	0	0	8	0	0
13	12370737	.	T	A	6	2	8	0	0	8	0	0
13	12370839	.	A	G	8	3	11	0	0	11	0	0
13	12370952	.	T	A	3	3	6	0	0	6	0	0
13	12371078	.	C	T	5	2	7	0	0	7	0	0
13	12371184	.	T	C	2	6	8	0	0	8	0	0
13	12371290	.	G	T	4	4	8	0	0	8	0	0
13	12372247	.	T	C	4	10	14	0	1	15	0	0
13	12372552	.	C	A	10	5	15	0	0	15	0	0
13	12372596	.	C	G	10	6	16	0	1	17	0	0
13	12372609	.	C	G	12	5	17	0	0	17	0	0
13	12372777	.	A	G	6	8	14	0	0	14	0	0
13	12373033	.	A	G	8	0	8	0	5	13	0	0
13	12373059	.	T	C	5	4	9	0	0	9	0	0
13	12373153	.	T	C	9	3	12	0	0	12	0	0
13	12373262	.	C	T	4	4	8	0	1	9	0	0
13	12373274	.	A	T	6	5	11	0	0	11	0	0
13	12373430	.	T	A	9	7	16	1	1	18	0	0
13	12373460	.	A	G	8	9	17	0	0	17	0	0
13	12373514	.	A	G	3	5	8	0	0	8	0	0
13	12373572	.	C	T	4	5	9	0	2	11	0	0
13	12373679	.	T	C	4	5	9	0	0	9	0	0
13	12374414	.	A	G	6	9	15	0	0	15	0	0
13	12374585	.	T	G	4	4	8	0	2	10	0	0
13	12374710	.	A	G	4	0	4	0	9	13	0	0
13	12374771	.	A	G	4	8	12	0	2	14	0	0
13	12374775	.	T	G	6	7	13	0	1	14	0	0
13	12374901	.	C	A	6	3	9	0	0	9	0	0
13	12374910	.	G	A	1	3	4	0	6	10	0	0
13	12374954	.	A	C	3	5	8	0	0	8	0	0
13	12375198	.	A	G	10	5	15	0	1	16	0	0
13	12375348	.	C	A	5	5	10	0	0	10	0	0
13	12375389	.	A	G	8	6	14	0	0	14	0	0
13	12378105	.	G	A	1	2	3	0	0	3	0	0
13	12378142	.	G	T	2	4	6	0	0	6	0	0
13	12378315	.	T	A	5	5	10	0	0	10	0	0
13	12378356	.	T	G	7	7	14	0	0	14	0	0
13	12378407	.	T	C	5	7	12	0	1	13	0	0
13	12385182	.	A	G	4	7	11	0	0	11	0	0
13	12385538	.	G	T	9	13	22	0	3	25	0	0
13	12387658	.	G	A	13	13	26	0	0	26	0	0
13	12390161	.	G	A	0	2	2	0	1	3	0	0
13	12390178	.	G	C	0	5	5	0	1	6	0	0
13	12395987	.	T	C	2	6	8	0	1	9	0	0
13	12414235	.	G	T	1	7	8	0	0	8	0	0
13	12414722	.	T	A	5	4	9	0	0	9	0	0
13	12419598	.	A	G	2	4	6	0	0	6	0	0
13	12419652	.	A	T	3	3	6	0	0	6	0	0
13	12419673	.	G	A	2	2	4	0	0	4	0	0
13	12423756	.	T	C	3	7	10	0	1	11	0	0
13	12426645	.	C	G	5	5	10	0	0	10	0	0
13	12428776	.	A	C	3	4	7	1	0	8	0	0
13	12441437	.	A	G	6	2	8	0	0	8	0	0
13	12443951	.	C	T	5	5	10	0	0	10	0	0
13	12444014	.	T	C	3	2	5	0	0	5	0	0
13	12444218	.	A	T	4	3	7	0	0	7	0	0
13	12447952	.	T	C	4	8	12	0	0	12	0	0
13	12447961	.	A	C	4	7	11	0	0	11	0	0
13	12450980	.	G	T	6	3	9	0	1	10	0	0
13	12451397	.	T	C	2	2	4	0	0	4	0	0
13	12479382	.	C	A	4	4	8	0	0	8	0	0
13	12479490	.	G	A	12	10	22	0	1	23	0	0
13	12482650	.	A	C	15	15	30	0	0	30	0	0
13	12485035	.	G	A	12	19	31	0	1	32	0	0
13	12489232	.	G	A	5	2	7	1	1	9	0	0
13	12489360	.	A	G	2	6	8	0	0	8	0	0
13	12489553	.	T	A	4	2	6	0	0	6	0	0
13	12494069	.	C	T	6	6	12	0	0	12	0	0
13	12494400	.	T	C	4	0	4	0	4	8	0	0
13	12494485	.	A	T	3	5	8	0	1	9	0	0
13	12624860	.	C	T	18	7	25	0	0	25	0	0
13	12628901	.	C	T	17	12	29	0	0	29	0	0
13	12632260	.	A	G	8	0	8	0	14	22	0	0
13	12632946	.	T	A	14	6	20	0	0	20	0	0
13	12632967	.	T	C	11	3	14	0	0	14	0	0
13	12633014	.	C	G	9	4	13	0	0	13	0	0
13	12635858	.	T	A	3	6	9	0	0	10	1	0
13	12635862	.	C	A	5	5	10	0	0	10	0	0
13	12635974	.	T	C	5	2	7	1	0	8	0	0
13	12646651	.	T	C	3	2	5	0	0	5	0	0
13	12646682	.	A	T	1	2	3	0	0	3	0	0
13	12665126	.	A	G	7	11	18	1	0	19	0	0
13	12665152	.	T	C	11	4	15	0	0	15	0	0
13	12665183	.	T	C	6	0	6	0	6	12	0	0
13	12665189	.	T	C	5	0	5	0	7	12	0	0
13	12665328	.	C	A	3	6	9	0	0	9	0	0
13	12665546	.	T	C	10	6	16	0	0	16	0	0
13	12665587	.	C	T	0	7	7	0	10	17	0	0
13	12665678	.	T	A	4	4	8	0	2	10	0	0
13	12665704	.	T	C	2	2	4	0	1	5	0	0
13	12665945	.	A	C	2	4	6	0	0	6	0	0
13	12665963	.	A	G	1	4	5	0	0	5	0	0
13	12666038	.	G	A	4	6	10	0	0	10	0	0
13	12666182	.	C	T	0	9	9	0	3	12	0	0
13	12666362	.	A	G	8	5	13	0	0	13	0	0
13	12681150	.	T	C	3	2	5	0	1	6	0	0
13	12681188	.	C	A	4	3	7	0	0	7	0	0
13	12681777	.	G	C	1	3	4	0	0	4	0	0
13	12739359	.	A	T	9	4	13	1	1	15	0	0
13	12739555	.	A	G	6	4	10	0	3	13	0	0
13	12739630	.	C	G	7	0	7	0	7	14	0	0
13	12739939	.	C	T	12	8	20	0	0	20	0	0
13	12740092	.	G	T	0	10	10	0	11	21	0	0
13	12740129	.	C	T	8	13	21	0	0	21	0	0
13	12740236	.	A	G	14	10	24	0	0	24	0	0
13	12740263	.	T	G	15	0	15	0	9	24	0	0
13	12740674	.	G	A	16	8	24	0	0	24	0	0
13	12762486	.	T	G	5	6	11	0	1	12	0	0
13	12765738	.	T	G	15	10	25	0	2	27	0	0
13	12769323	.	T	C	9	9	18	0	1	19	0	0
13	12778247	.	T	G	6	4	10	0	0	10	0	0
13	12778653	.	A	C	6	3	9	0	0	9	0	0
13	12778731	.	G	T	10	3	13	0	1	14	0	0
13	12778733	.	C	A	11	3	14	0	0	14	0	0
13	12778862	.	T	A	2	3	5	0	1	6	0	0
13	12847745	.	A	G	2	2	4	0	0	4	0	0
13	12993890	.	C	T	0	2	2	0	2	4	0	0
13	12993928	.	C	T	2	2	4	0	0	4	0	0
13	12994738	.	A	T	13	7	20	0	2	22	0	0
13	12994743	.	G	T	10	11	21	0	2	23	0	0
13	12997845	.	C	T	8	8	16	0	0	16	0	0
13	13001540	.	G	T	6	4	10	0	0	10	0	0
13	13004739	.	G	A	5	6	11	0	0	11	0	0
13	13004748	.	G	A	3	7	10	0	0	10	0	0
13	13006639	.	C	T	3	3	6	0	1	7	0	0
13	13006642	.	A	T	3	4	7	0	0	7	0	0
13	13008496	.	G	A	4	3	7	0	0	7	0	0
13	13008910	.	C	T	7	5	12	0	0	12	0	0
13	13008939	.	C	T	6	5	11	0	0	11	0	0
13	13018741	.	G	A	1	6	7	0	0	7	0	0
13	13019085	.	G	T	5	2	7	0	1	8	0	0
13	13019148	.	C	T	1	5	6	0	0	6	0	0
13	13019277	.	C	G	9	6	15	0	0	15	0	0
13	13027068	.	A	C	1	2	3	0	0	3	0	0
13	13027299	.	A	T	2	2	4	0	0	4	0	0
13	13069251	.	C	T	3	7	10	0	2	12	0	0
13	13091046	.	C	A	8	13	21	0	1	22	0	0
13	13091079	.	T	C	9	12	21	0	0	21	0	0
13	13094191	.	A	G	16	10	26	0	1	27	0	0
13	13213863	.	G	A	1	4	5	0	0	5	0	0
13	13214412	.	G	A	9	11	20	0	3	23	0	0
13	13214571	.	T	A	11	7	18	0	0	18	0	0
13	13214648	.	C	T	1	3	4	0	0	4	0	0
13	13214883	.	A	T	5	4	9	0	0	9	0	0
13	13215010	.	A	G	4	2	6	0	0	6	0	0
13	13215332	.	C	G	3	5	8	0	0	8	0	0
13	13215474	.	C	T	3	4	7	0	0	7	0	0
13	13215640	.	T	G	1	4	5	0	0	5	0	0
13	13215643	.	G	A	1	3	4	0	0	4	0	0
13	13215984	.	T	C	7	7	14	0	1	15	0	0
13	13216071	.	A	T	11	4	15	0	2	17	0	0
13	13216156	.	G	A	4	3	7	0	0	7	0	0
13	13216381	.	T	A	5	2	7	0	0	7	0	0
13	13216495	.	A	C	2	4	6	0	0	6	0	0
13	13216515	.	T	G	3	2	5	0	0	5	0	0
13	13216593	.	C	T	2	6	8	0	0	8	0	0
13	13217045	.	C	A	5	5	10	0	0	10	0	0
13	13217345	.	G	A	6	4	10	0	0	10	0	0
13	13217406	.	T	C	6	3	9	0	0	9	0	0
13	13217648	.	G	A	3	2	5	0	0	5	0	0
13	13217649	.	A	T	3	2	5	0	0	5	0	0
13	13218334	.	G	T	2	3	5	0	0	5	0	0
13	13218594	.	C	T	3	3	6	0	0	6	0	0
13	13221451	.	G	A	6	2	8	0	1	9	0	0
13	13221482	.	C	T	2	3	5	0	0	5	0	0
13	13228465	.	G	A	3	5	8	0	0	8	0	0
13	13228489	.	T	C	2	0	2	0	3	5	0	0
13	13245530	.	T	A	2	2	4	0	0	4	0	0
13	13294771	.	T	A	4	2	6	0	1	7	0	0
13	13681906	.	A	C	2	3	5	0	0	5	0	0
13	13693781	.	A	T	4	19	23	0	0	23	0	0
13	13697957	.	G	A	0	16	16	0	11	27	0	0
13	13698240	.	G	T	14	7	21	0	0	21	0	0
13	13703298	.	T	C	22	9	31	0	1	32	0	0
13	13704011	.	T	G	5	26	31	0	1	32	0	0
13	13708562	.	C	T	20	4	24	0	1	25	0	0
13	13708567	.	T	C	21	4	25	0	1	26	0	0
13	13710824	.	G	C	24	12	36	0	1	37	0	0
13	13712633	.	T	C	28	10	38	0	1	39	0	0
13	13713106	.	C	G	7	24	31	0	1	32	0	0
13	13725119	.	A	G	21	1	22	0	6	28	0	0
13	13733417	.	G	T	36	24	60	0	1	61	0	0
13	13970036	.	G	A	5	2	7	0	1	8	0	0
13	13984582	.	G	A	3	4	7	0	0	7	0	0
13	13988395	.	A	C	3	3	6	0	0	6	0	0
13	13988460	.	A	T	6	2	8	0	0	8	0	0
13	13997097	.	C	T	6	3	9	0	0	9	0	0
13	13997101	.	C	T	3	6	9	0	0	9	0	0
13	13997299	.	C	T	3	7	10	0	0	10	0	0
13	13997383	.	T	G	11	0	11	0	5	16	0	0
13	13997446	.	G	T	0	5	5	0	2	7	0	0
13	13997829	.	G	A	4	3	7	0	0	7	0	0
13	13999037	.	A	T	1	7	8	0	0	8	0	0
13	14002936	.	A	T	7	5	12	0	0	12	0	0
13	14002979	.	G	T	2	4	6	0	0	6	0	0
13	14003099	.	A	G	5	4	9	0	0	9	0	0
13	14004141	.	C	T	6	5	11	0	0	11	0	0
13	14004209	.	C	T	7	2	9	0	0	9	0	0
13	14023838	.	G	A	1	6	7	0	5	12	0	0
13	14070774	.	A	T	4	8	12	0	0	12	0	0
13	14070868	.	C	T	12	3	15	0	1	16	0	0
13	14070931	.	T	C	10	11	21	0	0	21	0	0
13	14070961	.	C	T	8	8	16	0	0	16	0	0
13	14070982	.	A	G	5	5	10	0	0	10	0	0
13	14078691	.	G	A	1	10	11	0	16	27	0	0
13	14078752	.	T	C	9	4	13	0	1	14	0	0
13	14081204	.	A	T	7	3	10	0	0	10	0	0
13	14088909	.	G	T	11	8	19	0	1	20	0	0
13	14092489	.	C	T	9	11	20	0	1	21	0	0
13	14092573	.	G	A	9	12	21	0	0	21	0	0
13	14094405	.	C	T	8	9	17	0	0	17	0	0
13	14094441	.	G	A	8	9	17	0	1	18	0	0
13	14098156	.	T	C	3	7	10	0	2	12	0	0
13	14102253	.	C	T	9	15	24	0	0	24	0	0
13	14103916	.	C	T	7	10	17	0	0	17	0	0
13	14116632	.	C	T	7	11	18	0	1	19	0	0
13	14116869	.	T	C	10	14	24	0	0	24	0	0
13	14137061	.	C	T	14	6	20	0	1	21	0	0
13	14181846	.	A	T	10	3	13	0	1	14	0	0
13	14181912	.	A	C	11	5	16	0	2	18	0	0
13	14181952	.	T	C	8	10	18	0	1	19	0	0
13	14190780	.	C	T	1	17	18	0	13	31	0	0
13	14191033	.	T	C	14	9	23	0	1	24	0	0
13	14191045	.	G	C	12	9	21	0	0	21	0	0
13	14191724	.	G	A	20	6	26	0	1	27	0	0
13	14192110	.	T	C	9	13	22	0	0	22	0	0
13	14192131	.	G	A	5	14	19	0	2	21	0	0
13	14192178	.	A	T	11	12	23	0	1	24	0	0
13	14192376	.	A	G	8	7	15	0	0	15	0	0
13	14192511	.	A	T	10	8	18	0	0	18	0	0
13	14194241	.	C	G	0	8	8	0	8	16	0	0
13	14194256	.	A	G	11	11	22	0	0	22	0	0
13	14194640	.	C	T	10	8	18	0	0	18	0	0
13	14194660	.	G	A	11	11	22	1	0	23	0	0
13	14194836	.	C	T	2	11	13	0	14	27	0	0
13	14194968	.	T	A	16	8	24	0	0	24	0	0
13	14195100	.	A	G	9	17	26	0	0	26	0	0
13	14199220	.	A	T	22	18	40	0	1	41	0	0
13	14220900	.	G	A	17	10	27	0	0	27	0	0
13	14241819	.	C	T	7	13	20	0	0	20	0	0
13	14251160	.	G	A	10	5	15	0	2	17	0	0
13	14251280	.	C	T	0	7	7	0	14	21	0	0
13	14251313	.	C	A	11	13	24	0	0	24	0	0
13	14487429	.	T	A	7	11	18	0	0	18	0	0
13	14487445	.	T	C	10	0	10	0	7	17	0	0
13	14902500	.	C	A	6	11	17	0	1	18	0	0
13	14902507	.	T	C	7	9	16	0	0	16	0	0
13	14902546	.	C	T	6	6	12	0	0	12	0	0
13	14902702	.	G	A	7	10	17	0	0	17	0	0
13	14906587	.	G	C	9	7	16	0	0	16	0	0
13	14906614	.	G	A	8	9	17	0	1	18	0	0
13	14906754	.	A	G	8	5	13	0	3	16	0	0
13	14908903	.	T	C	7	4	11	0	0	11	0	0
13	14915669	.	G	A	2	3	5	0	0	5	0	0
13	14919111	.	C	T	1	6	7	0	0	7	0	0
13	15113142	.	G	A	6	2	8	0	0	8	0	0
13	15141803	.	A	T	8	4	12	0	1	13	0	0
13	15191053	.	T	C	1	3	4	0	0	4	0	0
13	15194509	.	A	G	2	5	7	0	0	7	0	0
13	15194555	.	C	T	4	5	9	0	0	9	0	0
13	15194711	.	T	C	3	2	5	0	0	5	0	0
13	15210469	.	C	A	2	3	5	0	0	5	0	0
13	15210557	.	C	T	5	3	8	0	1	9	0	0
13	15212395	.	G	T	5	2	7	0	1	8	0	0
13	15215789	.	A	T	22	19	41	0	2	43	0	0
13	15580864	.	T	A	19	20	39	0	1	40	0	0
13	15580879	.	T	G	16	0	16	0	21	37	0	0
13	15580948	.	G	T	20	11	31	0	2	33	0	0
13	15647444	.	A	G	18	12	30	0	0	30	0	0
13	15657987	.	A	G	27	30	57	0	2	59	0	0
13	15668124	.	A	T	9	6	15	1	0	16	0	0
13	15696717	.	T	G	3	5	8	0	0	8	0	0
13	15762306	.	T	C	3	0	3	0	4	7	0	0
13	15762320	.	A	C	4	2	6	0	0	6	0	0
13	15762515	.	T	C	4	8	12	1	0	13	0	0
13	15763061	.	G	T	5	6	11	0	0	11	0	0
13	15763233	.	T	C	6	0	6	0	3	9	0	0
13	15763273	.	T	C	4	3	7	0	0	7	0	0
13	15763733	.	T	C	5	10	15	0	0	15	0	0
13	15778124	.	T	C	5	0	5	0	3	8	0	0
13	15778128	.	C	T	5	3	8	0	0	8	0	0
13	15800977	.	T	G	2	3	5	0	0	5	0	0
13	15801705	.	T	A	12	12	24	0	0	24	0	0
13	15801726	.	T	C	12	8	20	0	0	20	0	0
13	15814429	.	A	G	9	15	24	2	0	26	0	0
13	15814724	.	T	A	5	4	9	0	0	9	0	0
13	15816637	.	G	A	22	14	36	0	3	39	0	0
13	15848817	.	A	G	20	22	42	0	1	43	0	0
13	15848895	.	C	T	28	14	42	2	3	47	0	0
13	15849541	.	T	C	25	22	47	1	1	49	0	0
13	15869322	.	A	G	27	15	42	0	1	43	0	0
13	15872256	.	A	G	26	23	49	0	2	51	0	0
13	15880940	.	T	G	22	30	52	0	3	56	1	0
13	15882860	.	A	C	27	26	53	1	2	56	0	0
13	15897090	.	C	T	5	5	10	0	0	10	0	0
13	15897108	.	A	G	4	5	9	0	2	11	0	0
13	15897141	.	A	G	5	6	11	0	0	11	0	0
13	15928805	.	T	C	6	4	10	0	0	10	0	0
13	15929121	.	C	A	0	2	2	0	3	5	0	0
13	15929308	.	C	A	6	12	18	0	0	18	0	0
13	15943539	.	T	C	1	2	3	0	0	3	0	0
13	15958862	.	C	T	0	3	3	0	1	4	0	0
13	15958874	.	G	A	1	3	4	0	0	4	0	0
13	15958963	.	G	A	3	3	6	0	0	6	0	0
13	16186182	.	G	A	5	7	12	0	0	12	0	0
13	16186209	.	T	C	4	0	4	0	6	10	0	0
13	16191517	.	A	T	12	5	17	0	0	17	0	0
13	16191580	.	A	G	7	6	13	0	0	13	0	0
13	16191635	.	A	T	7	6	13	0	0	13	0	0
13	16268470	.	A	G	2	2	4	0	0	4	0	0
13	16268675	.	T	C	2	2	4	0	0	4	0	0
13	16300653	.	G	A	2	4	6	0	0	6	0	0
13	16300670	.	T	C	5	4	9	0	0	9	0	0
13	16311465	.	A	G	3	7	10	0	0	10	0	0
13	16313525	.	G	C	11	4	15	0	0	15	0	0
13	16413254	.	A	G	4	0	4	0	12	16	0	0
13	16413293	.	C	T	11	12	23	0	0	23	0	0
13	16413366	.	T	C	11	7	18	0	2	20	0	0
13	16420480	.	T	A	6	5	11	0	0	11	0	0
13	16420799	.	A	G	5	9	14	0	1	15	0	0
13	16425241	.	C	T	7	7	14	0	1	15	0	0
13	16425350	.	T	C	7	7	14	0	0	14	0	0
13	16428604	.	T	C	4	6	10	0	1	11	0	0
13	16436353	.	C	T	7	8	15	0	1	16	0	0
13	16436524	.	A	G	5	7	12	0	4	16	0	0
13	16436596	.	A	G	2	0	2	0	8	11	1	0
13	16436786	.	T	C	7	4	11	0	1	12	0	0
13	16448511	.	G	A	0	5	5	0	9	14	0	0
13	16474382	.	A	G	6	0	6	0	4	10	0	0
13	16479914	.	T	A	9	7	16	0	0	16	0	0
13	16496254	.	T	C	9	7	16	0	0	16	0	0
13	16496377	.	G	A	1	4	5	0	1	6	0	0
13	16496770	.	T	A	16	8	24	0	2	26	0	0
13	16522322	.	A	T	10	14	24	0	0	24	0	0
13	16522533	.	C	G	7	5	12	0	1	13	0	0
13	16522880	.	C	T	13	9	22	0	2	24	0	0
13	16809610	.	T	C	10	11	21	0	0	21	0	0
13	16852953	.	G	A	11	15	26	0	2	28	0	0
13	16855387	.	C	A	14	11	25	0	1	27	1	0
13	16856045	.	T	A	19	12	31	0	1	32	0	0
13	16871830	.	A	C	18	7	25	0	1	26	0	0
13	16876825	.	C	T	15	18	33	0	1	34	0	0
13	16878895	.	A	C	17	26	43	0	8	51	0	0
13	16886040	.	C	T	18	19	37	0	0	37	0	0
13	16886068	.	C	T	14	18	32	0	1	33	0	0
13	17470079	.	C	T	9	14	23	0	0	23	0	0
13	17470112	.	A	G	10	1	11	0	12	23	0	0
13	17470430	.	T	C	13	7	20	0	0	20	0	0
13	17702802	.	C	T	10	8	18	0	0	18	0	0
13	17703097	.	A	G	3	0	3	0	7	10	0	0
13	17703164	.	A	T	7	7	14	0	0	14	0	0
13	17703308	.	G	A	15	9	24	0	1	25	0	0
13	17705633	.	C	T	6	11	17	0	0	17	0	0
13	17705669	.	C	T	10	10	20	0	1	21	0	0
13	17705681	.	C	T	13	12	25	0	2	27	0	0
13	17714530	.	C	A	24	20	44	0	1	45	0	0
13	17714905	.	T	C	22	21	43	0	1	44	0	0
13	17714942	.	A	G	28	19	47	0	4	51	0	0
13	17717608	.	G	A	29	24	53	1	2	56	0	0
13	17752932	.	A	T	4	4	8	0	0	8	0	0
13	17753144	.	A	C	5	0	5	0	8	14	1	0
13	17753668	.	A	C	11	11	22	0	1	23	0	0
13	17753732	.	A	T	13	15	28	0	0	28	0	0
13	17753821	.	A	T	7	8	15	0	1	16	0	0
13	17754071	.	T	A	5	3	8	0	0	10	2	0
13	17754275	.	G	T	10	6	16	0	0	16	0	0
13	17754466	.	C	T	5	2	7	0	0	7	0	0
13	17754510	.	T	C	4	7	11	1	0	13	1	0
13	17754518	.	T	G	8	3	11	1	1	13	0	0
13	17754720	.	A	T	1	5	6	0	0	6	0	0
13	17754889	.	C	G	4	2	6	0	1	7	0	0
13	17754897	.	C	T	0	7	7	0	3	10	0	0
13	17755221	.	C	T	4	4	8	0	0	8	0	0
13	17755579	.	A	G	6	10	16	0	0	16	0	0
13	17755743	.	G	C	4	0	4	0	5	9	0	0
13	17755758	.	C	T	1	7	8	0	2	10	0	0
13	17755830	.	C	A	12	3	15	0	0	15	0	0
13	17755898	.	G	A	10	12	22	0	0	22	0	0
13	17756043	.	G	A	6	7	13	0	0	13	0	0
13	17756112	.	G	A	6	5	11	0	1	12	0	0
13	17756131	.	A	T	8	5	13	0	1	14	0	0
13	17756186	.	C	A	7	7	14	0	1	15	0	0
13	17756235	.	G	A	9	6	15	0	1	16	0	0
13	17756322	.	G	A	9	11	20	0	1	21	0	0
13	17822777	.	A	T	5	8	13	0	0	13	0	0
13	17943071	.	C	T	4	5	9	0	1	10	0	0
13	18011130	.	T	G	3	4	7	0	1	8	0	0
13	18011158	.	G	T	5	4	9	0	1	10	0	0
13	18019724	.	T	C	3	2	5	0	0	5	0	0
13	18019786	.	C	T	1	4	5	0	1	6	0	0
13	18024418	.	C	T	6	7	13	0	0	13	0	0
13	18024419	.	A	G	6	7	13	0	0	13	0	0
13	18033053	.	A	G	4	2	6	0	0	6	0	0
13	18033073	.	T	G	3	2	5	0	0	5	0	0
13	18038643	.	G	A	3	5	8	0	1	9	0	0
13	18046210	.	G	A	2	5	7	0	0	7	0	0
13	18069031	.	A	G	4	3	7	0	0	7	0	0
13	18073433	.	A	G	9	11	20	0	0	20	0	0
13	18073524	.	G	T	8	10	18	0	0	18	0	0
13	18073582	.	G	T	7	4	11	0	1	12	0	0
13	18073706	.	G	A	7	11	18	0	0	18	0	0
13	18076710	.	T	G	12	10	22	0	2	24	0	0
13	18076788	.	G	C	16	10	26	0	1	27	0	0
13	18076818	.	G	A	11	14	25	0	1	26	0	0
13	18076996	.	C	T	16	15	31	0	1	32	0	0
13	18077056	.	G	T	12	18	30	0	1	31	0	0
13	18077116	.	G	A	14	19	33	0	3	36	0	0
13	18077191	.	C	G	17	14	31	0	2	33	0	0
13	18080348	.	G	A	12	10	22	0	0	22	0	0
13	18080411	.	G	T	8	14	22	0	2	24	0	0
13	18083391	.	C	T	1	9	10	0	12	22	0	0
13	18083415	.	G	A	7	11	18	0	1	19	0	0
13	18087946	.	G	A	10	8	18	0	1	19	0	0
13	18088276	.	T	G	11	11	22	0	1	23	0	0
13	18092062	.	G	T	8	4	12	0	1	13	0	0
13	18092084	.	A	G	6	8	14	0	1	15	0	0
13	18092108	.	T	C	8	8	16	0	1	17	0	0
13	18092266	.	C	T	8	7	15	0	0	15	0	0
13	18092279	.	A	G	6	6	12	0	1	13	0	0
13	18092417	.	A	G	7	11	18	0	0	18	0	0
13	18099947	.	T	C	10	0	10	0	11	21	0	0
13	18104890	.	C	T	9	6	15	0	0	15	0	0
13	18104929	.	A	T	7	4	11	0	1	12	0	0
13	18105175	.	G	A	10	7	17	0	0	17	0	0
13	18105382	.	A	G	15	8	23	0	0	23	0	0
13	18107562	.	C	T	10	5	15	0	1	16	0	0
13	18107622	.	A	G	7	7	14	0	1	15	0	0
13	18109855	.	A	T	1	7	8	0	0	8	0	0
13	18110003	.	T	C	11	0	11	0	12	23	0	0
13	18119488	.	T	C	4	4	8	0	1	9	0	0
13	18119489	.	C	T	4	4	8	0	1	9	0	0
13	18122193	.	C	T	4	7	11	0	4	15	0	0
13	18122263	.	C	G	1	8	9	0	5	14	0	0
13	18179391	.	G	C	5	0	5	0	8	13	0	0
13	18179521	.	A	G	1	5	6	0	0	6	0	0
13	18179535	.	G	T	1	5	6	0	0	6	0	0
13	18179757	.	T	C	13	15	28	0	0	28	0	0
13	18179859	.	C	A	11	21	32	0	0	32	0	0
13	18185457	.	A	C	7	0	7	0	8	15	0	0
13	18185463	.	C	A	5	7	12	0	1	13	0	0
13	18195926	.	G	A	5	5	10	0	1	11	0	0
13	18274914	.	A	C	2	2	4	0	0	4	0	0
13	18275320	.	G	A	4	2	6	0	0	6	0	0
13	18275935	.	T	C	3	2	5	0	1	6	0	0
13	18276043	.	T	A	5	4	9	0	0	9	0	0
13	18276195	.	A	G	3	3	6	0	1	7	0	0
13	18295212	.	C	T	3	5	8	0	0	8	0	0
13	18295423	.	G	A	0	4	4	0	6	10	0	0
13	18295680	.	T	C	1	4	5	0	2	7	0	0
13	18295718	.	A	G	1	5	6	0	0	6	0	0
13	18295760	.	A	G	4	0	4	0	4	8	0	0
13	18314113	.	T	G	16	0	16	0	13	29	0	0
13	18321156	.	T	C	10	10	20	0	1	21	0	0
13	18323464	.	A	G	7	12	19	0	0	19	0	0
13	18323595	.	G	A	1	8	9	0	19	28	0	0
13	18323653	.	A	G	17	0	17	0	8	25	0	0
13	18323787	.	T	A	20	8	28	0	2	30	0	0
13	18358890	.	G	C	19	17	36	0	1	37	0	0
13	18359112	.	G	C	19	16	35	0	0	35	0	0
13	18359304	.	A	T	10	6	16	0	2	18	0	0
13	18359374	.	C	T	8	16	24	0	1	25	0	0
13	18359507	.	A	T	12	9	21	0	0	21	0	0
13	18371186	.	A	C	6	11	17	0	0	17	0	0
13	18375465	.	C	A	5	5	10	0	2	12	0	0
13	18375512	.	T	A	10	7	17	0	3	20	0	0
13	18382132	.	A	C	5	5	10	0	0	10	0	0
13	18382192	.	T	C	8	8	16	0	1	17	0	0
13	18385497	.	C	T	7	7	14	0	0	14	0	0
13	18385512	.	C	T	9	6	15	0	0	15	0	0
13	18385797	.	T	A	3	4	7	0	3	10	0	0
13	18394755	.	T	A	15	8	23	0	1	24	0	0
13	18397138	.	C	G	10	5	15	0	1	16	0	0
13	18397449	.	T	C	4	3	7	0	0	7	0	0
13	18397452	.	T	C	4	2	6	0	1	7	0	0
13	18409776	.	T	A	5	5	10	0	0	10	0	0
13	18410799	.	G	C	0	6	6	0	1	7	0	0
13	18418337	.	C	A	9	8	17	0	1	18	0	0
13	18418528	.	G	A	13	5	18	0	2	20	0	0
13	18428103	.	A	G	17	14	31	0	0	31	0	0
13	18431278	.	T	A	7	11	18	0	0	18	0	0
13	18431301	.	C	T	7	10	17	0	0	17	0	0
13	18431430	.	C	T	12	5	17	0	0	17	0	0
13	18434354	.	T	C	6	3	9	0	0	9	0	0
13	18434519	.	C	A	7	7	14	0	1	15	0	0
13	18434520	.	G	C	0	7	7	0	8	15	0	0
13	18434818	.	C	G	7	10	17	0	2	19	0	0
13	18434902	.	C	T	4	10	14	0	1	15	0	0
13	18434957	.	G	A	5	4	9	0	0	9	0	0
13	18434962	.	A	G	5	2	7	0	0	7	0	0
13	18471608	.	A	G	3	4	7	0	0	7	0	0
13	18471615	.	G	T	3	4	7	0	0	7	0	0
13	18471666	.	G	C	2	3	5	0	0	5	0	0
13	18472012	.	T	C	1	2	3	0	0	3	0	0
13	18499773	.	A	T	2	3	5	0	0	5	0	0
13	18507735	.	A	G	17	10	27	0	0	27	0	0
13	18509592	.	G	A	1	18	19	0	13	32	0	0
13	18509925	.	T	C	15	9	24	0	0	24	0	0
13	18509940	.	C	T	18	9	27	0	0	27	0	0
13	18510319	.	C	A	12	18	30	0	2	32	0	0
13	18510324	.	A	G	12	18	30	0	1	31	0	0
13	18510540	.	G	A	5	10	15	0	14	29	0	0
13	18511023	.	C	T	11	14	25	0	0	25	0	0
13	18511140	.	A	G	15	1	16	0	14	30	0	0
13	18511637	.	A	C	8	9	17	0	1	18	0	0
13	18511763	.	T	A	13	14	27	0	0	27	0	0
13	18511996	.	A	T	8	17	25	0	1	26	0	0
13	18512030	.	A	T	15	14	29	0	0	29	0	0
13	18512082	.	C	G	13	14	27	0	0	27	0	0
13	18624124	.	G	C	0	2	2	0	2	4	0	0
13	18659382	.	C	T	6	4	10	0	0	10	0	0
13	18663103	.	G	A	2	5	7	0	0	7	0	0
13	18663947	.	G	A	25	21	46	0	2	48	0	0
13	18677437	.	T	C	17	5	22	0	0	22	0	0
13	18677467	.	G	A	12	7	19	0	0	19	0	0
13	18677726	.	T	C	15	9	24	0	0	24	0	0
13	18677749	.	C	A	17	7	24	0	0	24	0	0
13	18677925	.	A	T	8	10	18	0	0	18	0	0
13	18680027	.	G	A	11	12	23	0	1	24	0	0
13	18685598	.	A	G	10	18	28	0	1	29	0	0
13	18685673	.	G	A	11	10	21	0	1	22	0	0
13	18801820	.	T	C	4	6	10	0	2	12	0	0
13	19304688	.	A	G	23	20	43	0	1	44	0	0
13	19316930	.	G	C	10	9	19	0	0	19	0	0
13	19317016	.	T	A	4	12	16	0	0	16	0	0
13	19317018	.	C	G	4	11	15	0	1	16	0	0
13	19317051	.	T	G	7	4	11	0	2	13	0	0
13	19627150	.	A	G	6	9	15	0	0	15	0	0
13	19627266	.	A	C	7	7	14	0	0	14	0	0
13	19629266	.	C	G	8	7	15	0	0	15	0	0
13	19639198	.	A	G	3	8	11	0	0	11	0	0
13	19639205	.	G	A	5	7	12	0	0	12	0	0
13	19639238	.	T	C	6	8	14	0	0	14	0	0
13	19639256	.	T	C	7	0	7	0	8	15	0	0
13	19642065	.	A	G	1	2	3	0	0	3	0	0
13	19642093	.	T	C	2	0	2	0	3	5	0	0
13	19642108	.	T	G	4	3	7	0	0	7	0	0
13	19799192	.	A	G	18	6	24	0	1	25	0	0
13	19799467	.	G	A	12	9	21	0	0	21	0	0
13	19799522	.	C	T	12	8	20	0	1	21	0	0
13	19799535	.	T	A	14	7	21	0	1	22	0	0
13	19799623	.	T	C	13	10	23	0	0	23	0	0
13	19799646	.	C	A	3	9	12	0	11	23	0	0
13	19799705	.	A	G	12	9	21	0	1	22	0	0
13	19799799	.	C	T	1	4	5	0	1	6	0	0
13	19884705	.	G	A	2	4	6	0	0	6	0	0
13	19884720	.	C	T	2	3	5	0	0	5	0	0
13	19964336	.	C	A	1	4	5	0	0	5	0	0
13	19964401	.	G	C	1	2	3	0	0	3	0	0
13	20007815	.	G	A	3	3	6	0	1	7	0	0
13	20007841	.	C	T	3	2	5	0	0	5	0	0
13	20328046	.	G	T	1	3	4	0	0	4	0	0
13	20401263	.	C	A	2	19	21	0	22	43	0	0
13	20425396	.	C	T	1	18	19	0	13	32	0	0
13	20518620	.	C	T	1	19	20	0	11	31	0	0
13	20518711	.	C	T	7	10	17	0	0	17	0	0
13	21638735	.	G	A	2	3	5	0	0	5	0	0
13	21638916	.	G	A	7	4	11	0	0	11	0	0
13	21638955	.	C	A	5	3	8	0	0	8	0	0
13	21677621	.	T	C	2	3	5	0	1	6	0	0
13	21680844	.	A	T	4	2	6	0	0	6	0	0
13	21683057	.	A	C	4	5	9	0	0	9	0	0
13	21683077	.	T	C	3	5	8	0	0	8	0	0
13	21683488	.	A	T	19	19	38	0	0	38	0	0
13	21683511	.	T	G	18	15	33	0	0	33	0	0
13	21683546	.	C	T	13	17	30	0	0	30	0	0
13	21689373	.	G	A	4	3	7	0	0	7	0	0
13	21689438	.	A	C	10	6	16	0	1	17	0	0
13	21689439	.	C	T	10	6	16	0	1	17	0	0
13	21689530	.	A	T	5	7	12	0	0	12	0	0
13	21689839	.	C	T	4	5	9	0	1	10	0	0
13	21689854	.	C	T	8	5	13	0	2	15	0	0
13	21689982	.	G	A	6	5	11	0	0	11	0	0
13	21690096	.	C	G	3	7	10	0	2	12	0	0
13	21690229	.	A	C	6	3	9	0	0	9	0	0
13	21690374	.	G	A	11	10	21	3	0	24	0	0
13	21690530	.	C	T	1	7	8	0	8	16	0	0
13	21690724	.	A	T	1	11	12	0	0	12	0	0
13	21690877	.	A	C	5	0	5	1	8	14	0	0
13	21690907	.	G	A	8	4	12	1	0	13	0	0
13	21691324	.	G	A	4	4	8	1	0	9	0	0
13	21691794	.	G	A	6	4	10	0	0	10	0	0
13	21692328	.	C	A	8	7	15	0	0	15	0	0
13	21692338	.	C	T	10	8	18	0	0	18	0	0
13	21692859	.	C	T	7	6	13	0	0	13	0	0
13	21693187	.	A	G	7	10	17	0	1	18	0	0
13	21693208	.	A	C	9	0	9	0	8	17	0	0
13	21693285	.	A	T	11	12	23	0	0	23	0	0
13	21693342	.	C	T	11	14	25	0	0	25	0	0
13	21693361	.	C	T	11	14	25	0	1	26	0	0
13	21693410	.	G	C	13	8	21	0	1	22	0	0
13	21693514	.	A	T	16	7	23	0	0	23	0	0
13	21695438	.	G	T	11	8	19	3	1	23	0	0
13	21712507	.	G	A	14	20	34	0	1	35	0	0
13	21712526	.	G	A	11	15	26	0	4	30	0	0
13	21712755	.	G	C	10	11	21	0	0	21	0	0
13	21716581	.	T	C	5	11	16	0	0	16	0	0
13	21722470	.	G	A	11	16	27	0	0	27	0	0
13	21725502	.	G	T	12	5	17	0	1	18	0	0
13	21725526	.	T	C	12	6	18	0	2	20	0	0
13	21727799	.	G	A	2	13	15	0	1	16	0	0
13	21735278	.	C	T	6	9	15	0	1	16	0	0
13	21738992	.	T	G	10	6	16	0	0	16	0	0
13	21739036	.	A	T	13	8	21	0	0	21	0	0
13	21770891	.	T	C	11	13	24	0	1	25	0	0
13	21775469	.	C	T	17	8	25	0	0	25	0	0
13	21775697	.	C	T	7	7	14	0	0	14	0	0
13	21776039	.	C	T	4	5	9	0	0	9	0	0
13	21776046	.	G	C	4	4	8	0	0	8	0	0
13	21776081	.	C	T	2	4	6	1	0	7	0	0
13	21776279	.	A	G	3	2	5	0	0	5	0	0
13	21804467	.	G	A	0	4	4	0	1	5	0	0
13	21818627	.	C	A	5	3	8	0	0	8	0	0
13	21818652	.	C	A	2	3	5	0	1	6	0	0
13	21819997	.	G	A	3	2	5	0	0	5	0	0
13	21821393	.	A	C	2	2	4	0	0	4	0	0
13	21826168	.	C	A	6	5	11	0	1	12	0	0
13	21826203	.	G	T	8	6	14	0	0	14	0	0
13	21826470	.	G	A	2	4	6	0	8	14	0	0
13	21851617	.	C	T	2	6	8	0	0	8	0	0
13	21852008	.	G	A	0	6	6	0	6	12	0	0
13	21853237	.	A	G	4	13	17	0	1	18	0	0
13	21853240	.	C	T	5	14	19	0	0	19	0	0
13	21855829	.	G	A	9	5	14	0	1	15	0	0
13	21855868	.	C	T	11	7	18	0	0	18	0	0
13	21856741	.	G	A	10	8	18	0	0	18	0	0
13	21856849	.	G	A	1	6	7	0	11	18	0	0
13	21860027	.	T	A	9	2	11	0	2	13	0	0
13	21860111	.	G	A	4	7	11	0	0	11	0	0
13	21861775	.	A	C	6	3	9	0	1	10	0	0
13	21861777	.	G	A	4	4	8	0	1	9	0	0
13	21862288	.	T	A	5	17	22	0	0	22	0	0
13	21864182	.	T	A	13	9	22	0	2	24	0	0
13	21866357	.	A	C	13	6	19	0	0	19	0	0
13	21869927	.	C	T	9	7	16	0	2	18	0	0
13	21870467	.	G	C	0	21	21	0	14	35	0	0
13	21870575	.	A	G	23	3	26	0	18	44	0	0
13	21870608	.	A	T	22	18	40	0	0	41	1	0
13	21874107	.	C	T	11	12	23	0	0	23	0	0
13	21874149	.	G	T	0	17	17	0	11	28	0	0
13	21874649	.	C	T	20	12	32	0	2	34	0	0
13	21884298	.	C	T	15	20	35	0	1	36	0	0
13	21884328	.	G	A	11	13	24	0	5	29	0	0
13	21884407	.	T	C	8	9	17	0	0	17	0	0
13	21884408	.	C	T	8	9	17	0	0	17	0	0
13	21884979	.	T	C	7	11	18	0	0	18	0	0
13	21884980	.	C	T	6	10	16	0	2	18	0	0
13	21885143	.	C	A	17	17	34	0	0	34	0	0
13	21885198	.	T	A	20	16	36	0	1	37	0	0
13	21919855	.	A	G	2	0	2	0	9	11	0	0
13	22064678	.	G	A	6	6	12	0	0	12	0	0
13	22064775	.	G	A	2	4	6	0	1	7	0	0
13	22065406	.	G	A	3	6	9	0	0	9	0	0
13	22065631	.	A	G	5	7	12	0	0	12	0	0
13	22065661	.	G	A	2	9	11	0	0	11	0	0
13	22066024	.	C	T	7	6	13	0	2	15	0	0
13	22066042	.	T	C	8	6	14	0	2	16	0	0
13	22066066	.	C	T	11	8	19	0	0	19	0	0
13	22066078	.	T	G	11	8	19	0	0	19	0	0
13	22076892	.	C	T	9	12	21	0	0	21	0	0
13	22087098	.	C	T	6	13	19	0	1	20	0	0
13	22087508	.	C	T	8	13	21	0	1	22	0	0
13	22088061	.	T	G	5	0	5	0	8	13	0	0
13	22094800	.	T	C	12	13	25	0	0	25	0	0
13	22094871	.	T	G	10	14	24	0	0	24	0	0
13	22095589	.	G	A	2	7	9	0	0	9	0	0
13	22095594	.	T	A	3	4	7	0	1	8	0	0
13	22119935	.	T	C	21	18	39	1	1	41	0	0
13	22198502	.	G	A	16	12	28	0	0	28	0	0
13	22207003	.	C	T	21	14	35	0	2	37	0	0
13	22238125	.	C	A	22	19	41	0	1	42	0	0
13	22238209	.	T	C	12	17	29	0	1	30	0	0
13	22238233	.	G	A	19	13	32	0	0	32	0	0
13	22240672	.	T	A	21	23	44	0	3	47	0	0
13	22241103	.	T	A	23	16	39	0	2	41	0	0
13	22241123	.	G	T	2	16	18	0	26	44	0	0
13	22241374	.	A	C	17	22	39	0	2	41	0	0
13	22241482	.	G	C	19	15	34	0	1	35	0	0
13	22241648	.	T	G	20	17	37	0	4	42	1	0
13	22241730	.	G	C	31	20	51	0	2	53	0	0
13	22241731	.	A	T	33	20	53	0	0	53	0	0
13	22242197	.	G	C	22	19	41	0	2	43	0	0
13	22242299	.	C	G	26	11	37	0	0	37	0	0
13	22242394	.	C	G	21	21	42	0	2	44	0	0
13	22242837	.	T	G	26	17	43	0	0	43	0	0
13	22243211	.	A	C	8	8	16	0	3	19	0	0
13	22281119	.	C	T	7	9	16	0	0	16	0	0
13	22303944	.	T	G	3	4	7	0	0	7	0	0
13	22317066	.	T	C	8	8	16	0	2	18	0	0
13	22317136	.	A	T	4	5	9	0	1	10	0	0
13	22317347	.	A	G	7	8	15	0	0	15	0	0
13	22328575	.	C	T	10	7	17	0	0	17	0	0
13	22340444	.	C	T	6	6	12	0	2	14	0	0
13	22340456	.	G	A	8	7	15	0	0	15	0	0
13	22347443	.	C	A	8	6	14	0	1	15	0	0
13	22351817	.	G	A	15	5	20	0	0	20	0	0
13	22351910	.	A	G	9	6	15	0	1	16	0	0
13	22354938	.	G	A	8	6	14	0	1	15	0	0
13	22355025	.	C	A	8	10	18	0	1	19	0	0
13	22357850	.	A	G	9	0	9	0	7	16	0	0
13	22358021	.	A	G	8	10	18	0	1	19	0	0
13	22361332	.	G	A	13	14	27	0	0	27	0	0
13	22361718	.	A	C	5	13	18	0	0	18	0	0
13	22364908	.	T	C	16	16	32	0	0	32	0	0
13	22365016	.	C	T	22	22	44	0	1	45	0	0
13	22365404	.	C	T	10	13	23	0	1	24	0	0
13	22365461	.	A	G	20	10	30	0	2	32	0	0
13	22367600	.	C	A	16	15	31	0	4	35	0	0
13	22369262	.	C	T	12	6	18	0	0	18	0	0
13	22369295	.	T	C	12	13	25	0	0	25	0	0
13	22369349	.	C	T	13	15	28	0	1	29	0	0
13	22369399	.	A	C	11	8	19	0	2	21	0	0
13	22369445	.	C	T	12	9	21	0	0	21	0	0
13	22371981	.	G	A	1	16	17	0	20	37	0	0
13	22372015	.	C	G	27	23	50	0	0	50	0	0
13	22372075	.	T	C	20	21	41	0	6	47	0	0
13	22372105	.	G	A	4	19	23	0	23	46	0	0
13	22372126	.	C	T	19	22	41	0	0	41	0	0
13	22372205	.	A	G	20	19	39	0	1	40	0	0
13	22458271	.	G	A	0	2	2	0	1	3	0	0
13	22551629	.	A	G	2	2	4	0	0	4	0	0
13	22555909	.	G	A	5	3	8	0	0	8	0	0
13	22592991	.	G	T	4	2	6	0	0	6	0	0
13	22615696	.	C	G	3	0	3	0	2	5	0	0
13	22617941	.	G	A	2	2	4	0	0	4	0	0
13	22618256	.	T	A	1	2	3	1	0	4	0	0
13	22618353	.	A	T	2	2	4	1	0	5	0	0
13	22618393	.	T	A	1	3	4	0	1	5	0	0
13	22620095	.	G	A	3	3	6	0	0	6	0	0
13	22659195	.	C	G	21	0	21	0	23	44	0	0
13	22659196	.	A	G	20	22	42	0	2	44	0	0
13	22659231	.	G	A	3	29	32	0	21	53	0	0
13	22659291	.	A	G	28	23	51	0	0	51	0	0
13	22659363	.	G	A	17	23	40	2	0	42	0	0
13	22667102	.	G	A	22	23	45	0	1	46	0	0
13	22667111	.	T	C	24	22	46	0	1	47	0	0
13	22669319	.	T	C	15	25	40	0	1	41	0	0
13	22679837	.	G	A	3	2	5	0	1	6	0	0
13	22683416	.	A	T	2	3	5	0	0	5	0	0
13	22688510	.	G	A	2	3	5	0	0	5	0	0
13	22704711	.	G	T	3	2	5	0	0	5	0	0
13	22705172	.	G	C	1	2	3	0	0	3	0	0
13	22725613	.	C	T	2	4	6	0	0	6	0	0
13	22727561	.	G	T	4	2	6	0	0	6	0	0
13	22728705	.	G	T	3	4	7	0	0	7	0	0
13	22735063	.	T	C	9	4	13	0	0	13	0	0
13	22735139	.	A	G	12	5	17	0	1	18	0	0
13	22742791	.	G	A	8	14	22	0	0	22	0	0
13	22744359	.	A	G	8	11	19	0	1	20	0	0
13	22866026	.	A	G	2	2	4	0	0	4	0	0
13	22867888	.	G	A	0	5	5	0	17	22	0	0
13	22867953	.	G	T	10	4	14	0	0	14	0	0
13	22868017	.	G	A	8	3	11	0	1	12	0	0
13	22868447	.	G	A	1	5	6	0	8	14	0	0
13	22868456	.	T	C	9	6	15	0	0	15	0	0
13	22871900	.	C	A	1	4	5	0	1	6	0	0
13	22871989	.	A	G	2	3	5	0	0	5	0	0
13	22872519	.	T	A	4	2	6	0	0	6	0	0
13	22872538	.	C	T	4	2	6	0	0	6	0	0
13	22876576	.	T	C	5	0	5	0	7	12	0	0
13	22876623	.	G	A	8	6	14	0	0	14	0	0
13	22876678	.	A	T	8	4	12	0	0	12	0	0
13	22877076	.	C	T	15	8	23	0	1	24	0	0
13	22877130	.	G	T	14	8	22	0	1	23	0	0
13	22878754	.	G	A	21	15	36	0	1	37	0	0
13	22879149	.	A	T	15	6	21	0	0	21	0	0
13	22890835	.	A	C	21	1	22	0	26	48	0	0
13	22898042	.	A	G	20	17	37	0	1	38	0	0
13	22900733	.	G	A	21	20	41	0	0	41	0	0
13	22900742	.	A	T	22	17	39	0	0	39	0	0
13	22902882	.	A	C	14	7	21	0	3	24	0	0
13	22902987	.	G	A	21	8	29	0	1	30	0	0
13	22948789	.	G	A	2	2	4	0	0	4	0	0
13	22970205	.	A	C	1	2	3	0	0	3	0	0
13	22973314	.	A	G	31	24	55	0	0	55	0	0
13	22973348	.	A	G	25	23	48	0	2	50	0	0
13	22973531	.	T	C	16	0	16	0	28	44	0	0
13	22973895	.	A	G	20	25	45	0	4	49	0	0
13	22974033	.	A	G	15	31	46	0	1	47	0	0
13	22974108	.	C	T	13	30	43	0	2	45	0	0
13	22976067	.	C	A	23	17	40	0	1	41	0	0
13	22976070	.	G	A	22	17	39	0	0	39	0	0
13	22976383	.	T	C	24	0	24	0	15	39	0	0
13	22977283	.	G	A	25	22	47	0	1	48	0	0
13	22977319	.	A	G	22	21	43	0	1	44	0	0
13	22977343	.	A	G	18	24	42	0	1	43	0	0
13	22978059	.	T	C	25	1	26	0	19	45	0	0
13	22978062	.	G	A	25	18	43	0	4	47	0	0
13	22983106	.	A	G	13	12	25	0	0	25	0	0
13	22983109	.	A	G	14	12	26	0	1	27	0	0
13	23002697	.	G	A	10	14	24	0	0	24	0	0
13	23007677	.	A	G	19	9	28	0	2	30	0	0
13	23007811	.	T	C	1	4	5	0	0	5	0	0
13	23017637	.	G	A	2	2	4	0	1	5	0	0
13	23042321	.	A	G	6	5	11	0	0	11	0	0
13	23042387	.	C	G	8	6	14	0	0	14	0	0
13	23042745	.	G	A	8	5	13	0	0	13	0	0
13	23042929	.	G	T	11	8	19	0	0	19	0	0
13	23043112	.	T	C	2	4	6	0	0	6	0	0
13	23043117	.	A	G	3	4	7	0	0	7	0	0
13	23045229	.	G	A	3	3	6	0	1	7	0	0
13	23058975	.	G	A	7	4	11	0	5	16	0	0
13	23064735	.	T	C	2	7	9	0	0	9	0	0
13	23070787	.	C	T	1	6	7	0	0	7	0	0
13	23070895	.	T	C	3	11	14	0	1	15	0	0
13	23070994	.	A	G	2	4	6	0	0	6	0	0
13	23084177	.	C	G	16	18	34	1	0	35	0	0
13	23084841	.	G	C	17	13	30	0	1	31	0	0
13	23090190	.	A	C	17	20	37	0	0	37	0	0
13	23094356	.	T	C	18	0	18	0	19	37	0	0
13	23094895	.	G	T	13	22	35	0	1	36	0	0
13	23107890	.	A	G	1	0	1	0	2	3	0	0
13	23166970	.	G	C	0	5	5	0	2	7	0	0
13	23166988	.	T	A	2	5	7	0	0	7	0	0
13	23169809	.	C	T	1	4	5	0	0	5	0	0
13	23170025	.	C	G	5	4	9	0	0	9	0	0
13	23196207	.	C	T	8	6	14	0	0	14	0	0
13	23201307	.	T	A	7	6	13	0	1	14	0	0
13	23204849	.	A	C	9	5	14	0	1	15	0	0
13	23211195	.	A	T	12	8	20	0	0	20	0	0
13	23212821	.	A	G	6	10	16	0	1	17	0	0
13	23222899	.	A	T	8	5	13	0	1	14	0	0
13	23223122	.	A	G	5	4	9	0	0	9	0	0
13	23223422	.	G	A	9	5	14	0	0	14	0	0
13	23223428	.	C	T	8	4	12	0	0	12	0	0
13	23223469	.	T	A	8	5	13	0	1	14	0	0
13	23223486	.	C	T	9	4	13	0	0	13	0	0
13	23224087	.	G	A	9	4	13	0	0	13	0	0
13	23224113	.	A	T	7	4	11	0	1	12	0	0
13	23224360	.	A	G	10	4	14	0	0	14	0	0
13	23224363	.	T	G	10	3	13	0	0	13	0	0
13	23224427	.	C	T	13	10	23	0	0	23	0	0
13	23224470	.	G	A	9	10	19	0	2	21	0	0
13	23224605	.	G	T	14	6	20	0	1	21	0	0
13	23224727	.	C	T	8	12	20	0	0	20	0	0
13	23224735	.	A	G	7	13	20	0	0	20	0	0
13	23224821	.	T	A	12	9	21	0	0	21	0	0
13	23224860	.	T	A	13	9	22	0	1	23	0	0
13	23225541	.	T	C	12	11	23	0	0	23	0	0
13	23225776	.	T	A	11	12	23	0	1	24	0	0
13	23226114	.	G	A	2	11	13	0	12	25	0	0
13	23226213	.	A	C	10	4	14	0	0	14	0	0
13	23234605	.	A	G	2	3	5	0	0	5	0	0
13	23234621	.	C	A	2	3	5	0	0	5	0	0
13	23241260	.	A	G	2	5	7	0	0	7	0	0
13	23314904	.	T	G	12	6	18	1	2	21	0	0
13	23382393	.	G	A	8	23	31	0	1	32	0	0
13	23382572	.	T	C	14	17	31	0	2	33	0	0
13	23387252	.	T	C	9	9	18	0	0	18	0	0
13	23387337	.	C	T	4	2	6	0	2	8	0	0
13	23387891	.	T	A	4	1	5	0	0	5	0	0
13	23499434	.	G	T	4	3	7	0	0	7	0	0
13	23669773	.	C	T	14	7	21	0	1	22	0	0
13	23669870	.	T	G	12	9	21	0	0	21	0	0
13	23669916	.	C	A	12	7	19	0	0	19	0	0
13	23675183	.	C	T	17	10	27	0	0	27	0	0
13	23675510	.	T	C	9	6	15	0	0	15	0	0
13	23675892	.	G	C	1	9	10	0	13	23	0	0
13	23676856	.	G	A	2	11	13	0	7	20	0	0
13	23676913	.	C	A	14	9	23	0	2	25	0	0
13	23678001	.	G	A	1	11	12	0	6	18	0	0
13	23679546	.	G	A	1	7	8	0	10	18	0	0
13	23679888	.	G	A	10	10	20	0	1	21	0	0
13	23685075	.	G	A	5	8	13	0	0	13	0	0
13	23685301	.	G	A	9	7	16	0	1	17	0	0
13	23692515	.	C	T	21	12	33	0	0	33	0	0
13	23692572	.	C	T	18	16	34	0	0	34	0	0
13	23703048	.	G	C	12	11	23	0	0	23	0	0
13	23703053	.	T	C	9	12	21	0	2	23	0	0
13	23709532	.	C	T	15	12	27	0	1	28	0	0
13	23709562	.	T	C	16	16	32	0	3	35	0	0
13	23709592	.	A	G	23	18	41	0	1	42	0	0
13	23711937	.	G	A	18	23	41	0	2	43	0	0
13	23728490	.	T	A	13	6	19	0	0	19	0	0
13	23730801	.	G	A	8	12	20	0	1	21	0	0
13	23731944	.	C	A	4	7	11	0	1	12	0	0
13	23733239	.	A	C	1	2	3	0	0	3	0	0
13	23733294	.	A	C	3	2	5	0	0	5	0	0
13	23843742	.	C	T	4	6	10	0	0	10	0	0
13	23876610	.	A	G	6	0	6	0	7	13	0	0
13	23876697	.	T	C	9	7	16	0	0	16	0	0
13	23876784	.	C	T	6	5	11	0	0	11	0	0
13	23876865	.	C	T	4	6	10	0	0	10	0	0
13	23882377	.	A	G	6	5	11	0	1	12	0	0
13	23882615	.	T	C	9	8	17	0	0	17	0	0
13	23882629	.	T	C	6	8	14	0	1	15	0	0
13	23882686	.	C	T	4	7	11	0	1	12	0	0
13	23882842	.	A	T	1	8	9	0	0	9	0	0
13	23882946	.	A	G	4	4	8	0	0	8	0	0
13	23898045	.	T	G	22	14	36	0	0	36	0	0
13	23901334	.	C	T	16	6	22	0	2	24	0	0
13	23901349	.	T	C	16	8	24	0	3	27	0	0
13	23901502	.	A	G	7	10	17	0	0	17	0	0
13	23901555	.	A	G	10	0	10	0	8	18	0	0
13	23901570	.	T	C	10	7	17	0	0	17	0	0
13	23920791	.	A	G	14	12	26	0	0	26	0	0
13	23931192	.	T	C	8	0	8	0	11	19	0	0
13	23932450	.	G	A	5	5	10	0	0	10	0	0
13	23940708	.	T	C	6	1	7	0	5	12	0	0
13	23940754	.	C	A	6	8	14	0	1	15	0	0
13	23943040	.	T	G	5	14	19	0	0	19	0	0
13	23990189	.	C	A	1	6	7	0	0	7	0	0
13	23996192	.	G	A	1	4	5	0	0	5	0	0
13	23999129	.	G	A	5	9	14	0	0	14	0	0
13	24000394	.	G	A	1	5	6	0	0	6	0	0
13	24002850	.	T	C	2	7	9	0	0	9	0	0
13	24010663	.	A	G	2	2	4	0	0	4	0	0
13	24014332	.	A	G	3	5	8	0	1	9	0	0
13	24014341	.	G	A	4	2	6	0	2	8	0	0
13	24014578	.	T	C	9	5	14	0	0	14	0	0
13	24023036	.	G	T	11	7	18	0	0	18	0	0
13	24033958	.	G	T	0	2	2	0	6	8	0	0
13	24034092	.	T	G	9	7	16	0	1	17	0	0
13	24034158	.	A	G	9	8	17	0	0	17	0	0
13	24034206	.	A	G	8	10	18	0	0	18	0	0
13	24034215	.	G	A	7	7	14	0	2	16	0	0
13	24045342	.	C	T	2	9	11	0	0	11	0	0
13	24046953	.	G	A	2	7	9	0	7	16	0	0
13	24056221	.	C	T	8	13	21	0	0	21	0	0
13	24068790	.	C	T	1	12	13	0	8	21	0	0
13	24069624	.	C	A	9	9	18	0	1	19	0	0
13	24069902	.	A	T	14	9	23	0	1	24	0	0
13	24070242	.	C	T	0	7	7	0	9	16	0	0
13	24070730	.	C	T	10	11	21	0	1	22	0	0
13	24096437	.	G	T	11	6	17	0	0	17	0	0
13	24234815	.	C	A	3	3	6	0	0	6	0	0
13	24241436	.	A	G	4	2	6	0	0	6	0	0
13	24250380	.	C	T	0	3	3	0	1	4	0	0
13	24250666	.	G	T	1	2	3	0	0	3	0	0
13	24251672	.	G	A	3	2	5	0	1	6	0	0
13	24262773	.	T	A	1	3	4	0	0	4	0	0
13	24262792	.	C	A	1	2	3	0	0	3	0	0
13	24263204	.	C	A	1	2	3	0	0	3	0	0
13	24263453	.	G	A	2	6	8	0	0	8	0	0
13	24266756	.	G	C	4	4	8	0	0	8	0	0
13	24266814	.	A	G	5	0	5	0	6	11	0	0
13	24268443	.	C	T	1	2	3	0	0	3	0	0
13	24269693	.	T	G	5	3	8	0	1	9	0	0
13	24269697	.	C	T	5	4	9	0	0	9	0	0
13	24271061	.	C	A	2	4	6	0	0	6	0	0
13	24276354	.	A	G	2	4	6	0	0	6	0	0
13	24276366	.	C	T	3	4	7	0	0	7	0	0
13	24276497	.	A	G	3	0	3	0	5	8	0	0
13	24287895	.	C	T	5	8	13	0	1	14	0	0
13	24290132	.	A	T	12	8	20	0	0	20	0	0
13	24290140	.	A	G	11	8	19	0	0	19	0	0
13	24290169	.	T	G	10	0	10	0	9	19	0	0
13	24292374	.	A	G	5	2	7	0	1	8	0	0
13	24292398	.	G	A	4	3	7	0	0	7	0	0
13	24292675	.	A	G	7	7	14	0	1	15	0	0
13	24292727	.	G	A	9	12	21	0	1	22	0	0
13	24292796	.	T	A	9	13	22	0	0	22	0	0
13	24292800	.	A	T	8	12	20	0	1	21	0	0
13	24292947	.	A	T	7	3	10	0	0	10	0	0
13	24293381	.	A	T	21	19	40	0	0	40	0	0
13	24293465	.	C	T	5	17	22	0	14	36	0	0
13	24293516	.	G	A	21	19	40	0	2	43	1	0
13	24293518	.	C	A	24	19	43	0	2	45	0	0
13	24293615	.	G	A	16	16	32	1	12	45	0	0
13	24293698	.	C	T	27	14	41	0	2	43	0	0
13	24293748	.	C	G	4	19	23	0	2	25	0	0
13	24293793	.	A	G	26	6	32	0	0	32	0	0
13	24294046	.	A	G	11	20	31	0	0	31	0	0
13	24295921	.	C	A	2	6	8	0	0	8	0	0
13	24295999	.	T	C	3	7	10	0	0	10	0	0
13	24296071	.	G	A	13	6	19	0	0	19	0	0
13	24296094	.	A	C	10	4	14	0	0	14	0	0
13	24296198	.	A	T	9	4	13	0	0	13	0	0
13	24296250	.	A	G	3	6	9	0	2	11	0	0
13	24303840	.	G	A	7	11	18	0	1	19	0	0
13	24305975	.	T	G	15	15	30	0	0	30	0	0
13	24311510	.	G	A	14	9	23	0	0	23	0	0
13	24371898	.	C	T	1	3	4	0	0	4	0	0
13	24371933	.	A	C	2	0	2	0	3	5	0	0
13	24372197	.	C	T	7	8	15	0	0	15	0	0
13	24372392	.	A	G	4	2	6	0	0	6	0	0
13	24372506	.	G	T	1	3	4	0	0	4	0	0
13	24372685	.	T	C	4	3	7	0	0	7	0	0
13	24372943	.	C	T	2	3	5	0	0	5	0	0
13	24378978	.	A	T	7	3	10	0	0	10	0	0
13	24381350	.	A	G	3	2	5	0	0	5	0	0
13	24382137	.	G	A	1	3	4	0	4	8	0	0
13	24382152	.	T	C	6	2	8	0	0	8	0	0
13	24382539	.	T	C	6	5	11	0	1	12	0	0
13	24395373	.	G	A	8	4	12	0	0	12	0	0
13	24401087	.	C	G	2	3	5	0	0	5	0	0
13	24401663	.	C	A	1	3	4	0	1	5	0	0
13	24402560	.	T	C	12	11	23	0	0	23	0	0
13	24411029	.	A	G	20	20	40	0	2	42	0	0
13	24423602	.	C	T	0	4	4	0	1	5	0	0
13	24423652	.	G	T	4	3	7	0	1	8	0	0
13	24423821	.	C	T	2	4	6	0	0	6	0	0
13	24423930	.	T	C	5	4	9	0	1	10	0	0
13	24424014	.	C	T	6	7	13	0	0	13	0	0
13	24424051	.	G	A	3	6	9	0	1	10	0	0
13	24424260	.	A	T	4	3	7	0	0	7	0	0
13	24424899	.	T	G	4	4	8	0	0	8	0	0
13	24425005	.	C	A	2	2	4	0	0	4	0	0
13	24425019	.	G	A	1	2	3	0	0	3	0	0
13	24425812	.	C	T	0	3	3	0	0	3	0	0
13	24425833	.	C	T	1	3	4	0	0	4	0	0
13	24431365	.	T	G	1	5	6	0	0	6	0	0
13	24432096	.	C	T	12	12	24	0	1	25	0	0
13	24432162	.	G	C	13	7	20	0	1	21	0	0
13	24432350	.	C	T	1	13	14	0	15	29	0	0
13	24436011	.	C	G	12	13	25	0	0	25	0	0
13	24436054	.	G	A	14	13	27	0	0	27	0	0
13	24437225	.	G	A	9	14	23	0	1	24	0	0
13	24447235	.	T	G	8	3	11	0	1	12	0	0
13	24447364	.	G	C	4	12	16	0	1	17	0	0
13	24519762	.	T	C	5	3	8	0	0	8	0	0
13	24519798	.	G	A	1	3	4	0	0	4	0	0
13	24519911	.	G	A	3	6	9	0	0	9	0	0
13	24519921	.	G	T	0	5	5	0	2	7	0	0
13	24521927	.	G	A	4	4	8	0	0	8	0	0
13	24522025	.	A	G	3	2	5	0	0	5	0	0
13	24522140	.	T	C	2	2	4	0	0	4	0	0
13	24522344	.	A	G	3	3	6	0	0	6	0	0
13	24522356	.	T	C	3	3	6	0	0	6	0	0
13	24523469	.	G	A	0	4	4	0	8	12	0	0
13	24524072	.	T	C	2	2	4	0	0	4	0	0
13	24524206	.	G	A	2	4	6	0	0	6	0	0
13	24524305	.	T	G	2	2	4	0	0	4	0	0
13	24552508	.	C	T	6	5	11	0	0	11	0	0
13	24580372	.	G	A	27	16	43	1	3	47	0	0
13	24580411	.	G	A	20	19	39	1	3	43	0	0
13	24580705	.	C	T	11	26	37	0	2	39	0	0
13	24580756	.	G	C	2	15	17	0	20	37	0	0
13	24580869	.	T	C	17	10	27	0	1	28	0	0
13	24580941	.	T	C	13	13	26	0	1	27	0	0
13	24581274	.	G	A	13	24	37	0	1	38	0	0
13	24581316	.	C	A	23	19	42	0	0	42	0	0
13	24581334	.	G	C	18	23	41	0	1	42	0	0
13	24581358	.	T	C	17	16	33	0	0	33	0	0
13	24581748	.	A	C	22	7	29	0	2	31	0	0
13	24581798	.	T	A	5	9	14	0	1	16	1	0
13	24581840	.	T	G	12	7	19	0	1	20	0	0
13	24581854	.	C	T	17	8	25	0	1	26	0	0
13	24582047	.	A	G	6	5	11	0	1	12	0	0
13	24582110	.	C	T	8	9	17	0	1	18	0	0
13	24582122	.	T	C	7	7	14	0	2	16	0	0
13	24584435	.	C	A	1	4	5	0	0	5	0	0
13	24585402	.	T	A	1	6	7	0	0	7	0	0
13	24585753	.	G	T	1	6	7	0	0	7	0	0
13	24662313	.	G	C	1	3	4	0	0	4	0	0
13	24663625	.	C	A	2	2	4	0	0	4	0	0
13	24664317	.	T	G	3	2	5	0	0	5	0	0
13	24665759	.	T	G	9	3	12	0	0	12	0	0
13	24665869	.	C	T	3	9	12	1	0	13	0	0
13	24702033	.	C	A	2	10	12	0	8	20	0	0
13	24702112	.	T	C	8	4	12	0	1	13	0	0
13	24702114	.	T	C	6	7	13	0	0	13	0	0
13	24702198	.	T	C	4	3	7	0	0	7	0	0
13	24702415	.	T	C	8	6	14	0	0	14	0	0
13	24702478	.	T	G	8	8	16	0	1	17	0	0
13	24702602	.	T	A	9	8	17	0	0	17	0	0
13	24702652	.	A	T	6	8	14	0	0	14	0	0
13	24702724	.	C	T	9	9	18	0	1	19	0	0
13	24702883	.	A	T	11	5	16	0	0	16	0	0
13	24703276	.	C	T	3	2	5	0	0	5	0	0
13	24703354	.	C	A	2	4	6	0	0	6	0	0
13	24703362	.	C	A	2	3	5	0	0	5	0	0
13	24703411	.	A	T	2	0	2	0	2	4	0	0
13	24703473	.	G	T	1	3	4	0	0	4	0	0
13	24703512	.	G	A	5	4	9	0	0	9	0	0
13	24704032	.	A	G	6	4	10	0	1	11	0	0
13	24704102	.	C	A	9	6	15	0	0	15	0	0
13	24716363	.	T	C	8	6	14	0	0	14	0	0
13	24716375	.	A	T	6	7	13	0	1	14	0	0
13	24716415	.	T	C	9	5	14	0	2	16	0	0
13	24721567	.	C	G	1	2	3	0	0	3	0	0
13	24730827	.	G	A	1	2	3	0	0	3	0	0
13	24741258	.	G	A	0	2	2	0	4	6	0	0
13	24745047	.	T	C	2	2	4	0	0	4	0	0
13	24745049	.	G	T	2	2	4	0	0	4	0	0
13	24745169	.	A	G	1	3	4	0	0	4	0	0
13	24745188	.	A	C	1	2	3	0	0	3	0	0
13	24781536	.	G	A	12	12	24	0	0	24	0	0
13	24781580	.	T	C	11	11	22	0	3	25	0	0
13	24781605	.	T	C	15	12	27	0	0	27	0	0
13	24781640	.	G	A	13	19	32	0	0	32	0	0
13	24781713	.	A	G	13	9	22	0	0	22	0	0
13	24781885	.	G	A	9	5	14	0	1	15	0	0
13	24786900	.	T	A	16	19	35	0	1	36	0	0
13	24791020	.	A	G	3	11	14	0	0	14	0	0
13	24791077	.	G	T	3	4	7	0	0	7	0	0
13	24804104	.	C	T	5	10	15	0	1	16	0	0
13	24804224	.	G	C	10	8	18	0	0	18	0	0
13	24804478	.	C	T	14	8	22	1	1	24	0	0
13	24804484	.	A	G	18	9	27	1	0	28	0	0
13	24804765	.	C	T	12	5	17	0	1	18	0	0
13	24804804	.	A	G	9	4	13	0	0	13	0	0
13	24805068	.	A	C	9	6	15	0	0	15	0	0
13	24805148	.	A	C	10	5	15	0	0	15	0	0
13	24805687	.	G	A	4	11	15	0	3	18	0	0
13	24806423	.	T	C	7	0	7	0	11	18	0	0
13	24810459	.	G	A	5	4	9	0	0	9	0	0
13	24834446	.	C	T	11	11	22	0	1	23	0	0
13	24837627	.	A	G	14	16	30	0	1	31	0	0
13	24837876	.	T	C	4	8	12	0	0	12	0	0
13	24871866	.	A	G	13	14	27	0	1	28	0	0
13	24872667	.	A	G	14	13	27	0	2	29	0	0
13	24872733	.	G	A	11	9	20	0	1	21	0	0
13	24873141	.	C	A	2	7	9	0	14	23	0	0
13	24873186	.	A	T	8	6	14	0	0	14	0	0
13	24873480	.	A	G	13	12	25	0	1	26	0	0
13	24873579	.	C	T	13	8	21	0	0	21	0	0
13	24874897	.	G	A	11	13	24	0	1	25	0	0
13	24875948	.	A	C	12	10	22	1	0	23	0	0
13	24878633	.	A	T	2	5	7	0	0	7	0	0
13	24878687	.	T	C	5	9	14	0	0	14	0	0
13	24881635	.	T	C	7	6	13	0	1	14	0	0
13	24885195	.	G	A	6	7	13	0	0	13	0	0
13	24905897	.	G	A	5	5	10	0	0	10	0	0
13	24906196	.	A	T	9	5	14	0	0	14	0	0
13	24918814	.	T	A	9	11	20	0	1	21	0	0
13	24918820	.	T	C	8	14	22	0	0	22	0	0
13	24986203	.	G	A	9	16	25	0	1	26	0	0
13	24986238	.	G	T	11	15	26	0	0	26	0	0
13	24986272	.	T	C	8	0	8	0	13	21	0	0
13	25204643	.	C	T	2	3	5	0	0	5	0	0
13	25207064	.	G	C	3	3	6	0	0	6	0	0
13	25207068	.	C	T	3	4	7	0	0	7	0	0
13	25208276	.	A	G	1	3	4	0	0	4	0	0
13	25208545	.	T	A	4	2	6	0	0	6	0	0
13	25212429	.	T	C	2	6	8	0	0	8	0	0
13	25214739	.	G	A	3	2	5	0	1	6	0	0
13	25222407	.	C	T	5	3	8	0	0	8	0	0
13	25227166	.	C	T	0	5	5	0	4	9	0	0
13	25229672	.	C	T	0	2	2	0	5	7	0	0
13	25284140	.	C	A	1	2	3	0	0	3	0	0
13	25284251	.	G	T	2	2	4	0	0	4	0	0
13	25365034	.	G	A	7	9	16	0	1	17	0	0
13	25366380	.	T	G	8	7	15	0	0	15	0	0
13	25369449	.	C	T	9	4	13	0	2	15	0	0
13	25371436	.	A	G	12	11	23	0	0	23	0	0
13	25371475	.	C	A	11	11	22	0	0	22	0	0
13	25371918	.	A	G	12	13	25	0	0	25	0	0
13	25378924	.	T	G	15	6	21	1	0	22	0	0
13	25379263	.	A	T	15	15	30	0	2	32	0	0
13	25379304	.	A	G	17	2	19	0	11	30	0	0
13	25379352	.	A	C	12	15	27	0	1	28	0	0
13	25384281	.	T	C	17	9	26	0	2	28	0	0
13	25386904	.	C	T	8	7	15	0	2	17	0	0
13	25388389	.	G	A	8	8	16	0	1	17	0	0
13	25388764	.	T	G	3	0	3	0	4	7	0	0
13	25429048	.	T	A	9	7	16	0	1	17	0	0
13	25429145	.	G	A	3	11	14	0	0	14	0	0
13	25429158	.	G	A	11	3	14	0	1	15	0	0
13	25435866	.	G	C	0	2	2	0	1	3	0	0
13	25436360	.	A	T	10	10	20	0	0	20	0	0
13	25444357	.	C	T	3	7	10	0	0	10	0	0
13	25450254	.	C	T	1	2	3	0	0	3	0	0
13	25450460	.	A	C	1	5	6	0	0	6	0	0
13	25472084	.	C	T	3	4	7	0	0	7	0	0
13	25472336	.	G	A	24	21	45	0	2	47	0	0
13	25472735	.	G	A	14	13	27	0	0	27	0	0
13	25472859	.	G	A	21	14	35	0	1	36	0	0
13	25473084	.	T	A	20	31	51	0	1	52	0	0
13	25473325	.	G	A	34	12	46	0	0	46	0	0
13	25474019	.	G	T	20	20	40	0	1	41	0	0
13	25475904	.	A	G	22	17	39	0	1	40	0	0
13	25477304	.	A	G	7	10	17	0	0	17	0	0
13	25478897	.	G	A	4	4	8	0	0	8	0	0
13	25495556	.	C	T	12	7	19	0	1	20	0	0
13	25495781	.	G	A	16	10	26	0	0	26	0	0
13	25497320	.	A	G	12	0	12	0	14	26	0	0
13	25497575	.	T	C	11	8	19	0	0	19	0	0
13	25497581	.	C	T	11	8	19	0	1	20	0	0
13	25497700	.	G	C	9	11	20	0	0	20	0	0
13	25497769	.	T	A	14	8	22	0	1	23	0	0
13	25516204	.	T	C	4	10	14	0	0	14	0	0
13	25519063	.	G	A	0	10	10	0	14	24	0	0
13	25521858	.	T	C	2	12	14	1	0	15	0	0
13	25523629	.	T	C	16	13	29	0	0	29	0	0
13	25523677	.	G	A	2	17	19	0	11	30	0	0
13	25523680	.	T	A	19	9	28	0	1	29	0	0
13	25525989	.	G	A	9	8	17	0	1	18	0	0
13	25531776	.	T	C	10	14	24	0	0	24	0	0
13	25532352	.	C	T	12	18	30	0	0	30	0	0
13	25532574	.	C	A	12	12	24	0	1	25	0	0
13	25532857	.	A	G	7	10	17	0	1	18	0	0
13	25533233	.	G	A	16	17	33	0	2	35	0	0
13	25533258	.	T	A	16	18	34	0	2	36	0	0
13	25533452	.	A	T	11	10	21	0	0	21	0	0
13	25533657	.	C	G	14	0	14	0	8	22	0	0
13	25533767	.	G	T	12	16	28	0	0	28	0	0
13	25533846	.	G	A	12	10	22	0	0	22	0	0
13	25533897	.	C	T	3	7	10	0	0	10	0	0
13	25534172	.	T	A	10	7	17	0	2	19	0	0
13	25534368	.	A	G	26	0	26	0	17	43	0	0
13	25534551	.	G	A	6	2	8	0	0	8	0	0
13	25534897	.	G	A	0	2	2	0	1	3	0	0
13	25534939	.	G	T	1	2	3	0	0	3	0	0
13	25535405	.	G	A	1	5	6	0	2	8	0	0
13	25549516	.	A	G	10	0	10	0	7	17	0	0
13	25551722	.	A	G	10	0	10	0	16	26	0	0
13	25551781	.	C	A	8	11	19	0	1	20	0	0
13	25552219	.	T	C	9	14	23	0	2	25	0	0
13	25559610	.	G	A	5	5	10	0	0	10	0	0
13	25560411	.	C	A	5	9	14	0	1	15	0	0
13	25560458	.	A	T	5	9	14	0	0	14	0	0
13	25560471	.	G	A	2	7	9	0	5	14	0	0
13	25563221	.	C	A	7	7	14	0	1	15	0	0
13	25565379	.	T	C	8	13	21	0	0	21	0	0
13	25565985	.	G	A	6	4	10	0	0	10	0	0
13	25565988	.	A	C	6	4	10	0	0	10	0	0
13	25569940	.	A	C	7	7	14	0	0	14	0	0
13	25570044	.	C	T	0	2	2	0	5	7	0	0
13	25570104	.	C	T	11	4	15	0	0	15	0	0
13	25570164	.	A	C	4	0	4	0	3	7	0	0
13	25570341	.	T	C	6	1	7	0	8	15	0	0
13	25570410	.	A	G	12	8	20	0	0	20	0	0
13	25570477	.	G	A	11	8	19	0	0	19	0	0
13	25570532	.	A	C	6	0	6	0	11	18	1	0
13	25570618	.	A	T	4	4	8	0	0	8	0	0
13	25570709	.	T	C	9	0	9	0	7	16	0	0
13	25570715	.	C	T	9	6	15	0	1	17	1	0
13	25570821	.	T	C	9	5	14	0	1	15	0	0
13	25570854	.	A	T	9	10	19	0	2	21	0	0
13	25571038	.	T	C	8	3	11	0	1	12	0	0
13	25571274	.	C	T	9	9	18	0	1	19	0	0
13	25573146	.	T	C	4	0	4	0	8	12	0	0
13	25575396	.	C	T	13	6	19	0	2	21	0	0
13	25575411	.	A	C	10	6	16	0	2	18	0	0
13	25580764	.	C	A	6	9	15	0	0	15	0	0
13	25585250	.	C	A	1	1	2	0	3	5	0	0
13	25585757	.	G	A	4	2	6	0	0	6	0	0
13	25589241	.	G	A	7	7	14	0	0	14	0	0
13	25590736	.	A	G	3	3	6	0	0	6	0	0
13	25592630	.	A	G	1	3	4	0	0	4	0	0
13	25593832	.	T	C	1	2	3	0	0	3	0	0
13	25726201	.	C	T	2	5	7	0	1	8	0	0
13	25726308	.	A	C	4	4	8	0	0	8	0	0
13	25728453	.	A	C	5	4	9	0	1	10	0	0
13	25728606	.	A	T	4	5	9	0	0	9	0	0
13	25729076	.	C	T	1	6	7	0	0	7	0	0
13	25737993	.	G	A	5	4	9	0	0	9	0	0
13	25738083	.	G	A	5	2	7	0	0	7	0	0
13	25740472	.	G	A	5	4	9	0	0	9	0	0
13	25740516	.	G	A	2	3	5	0	0	5	0	0
13	25750830	.	G	A	3	2	5	0	0	5	0	0
13	25750868	.	A	T	2	3	5	0	0	5	0	0
13	25795635	.	T	C	5	3	8	0	0	8	0	0
13	25796084	.	G	A	1	3	4	0	1	5	0	0
13	25824718	.	C	T	12	11	23	0	0	23	0	0
13	25825016	.	G	A	16	15	31	0	0	31	0	0
13	25825445	.	A	T	12	10	22	0	2	24	0	0
13	25826426	.	G	C	3	2	5	0	0	5	0	0
13	25827421	.	G	A	21	14	35	0	0	35	0	0
13	25842020	.	T	C	5	0	5	0	9	14	0	0
13	25923392	.	A	G	18	16	34	0	8	42	0	0
13	25923450	.	A	T	10	16	26	0	1	27	0	0
13	25924388	.	C	T	10	16	26	0	1	27	0	0
13	25924523	.	C	T	11	13	24	0	1	25	0	0
13	26692974	.	T	C	1	1	2	0	2	4	0	0
13	26780130	.	C	T	1	3	4	0	0	4	0	0
13	26780191	.	C	T	3	4	7	0	1	8	0	0
13	26782924	.	C	G	2	2	4	0	0	4	0	0
13	26783017	.	A	T	6	2	8	0	0	8	0	0
13	27000394	.	C	T	1	6	7	0	11	18	0	0
13	27036660	.	T	C	4	12	16	0	0	16	0	0
13	27036766	.	G	A	15	5	20	0	0	20	0	0
13	27036847	.	C	T	7	11	18	0	0	18	0	0
13	27036898	.	T	C	12	10	22	0	1	23	0	0
13	27037942	.	A	G	9	15	24	0	2	26	0	0
13	27038163	.	G	A	10	4	14	0	1	15	0	0
13	27189898	.	C	T	15	10	25	0	0	25	0	0
13	27190435	.	C	T	7	22	29	0	0	29	0	0
13	27201525	.	A	G	10	0	10	0	14	24	0	0
13	27201606	.	T	C	7	7	14	0	0	14	0	0
13	27201624	.	A	T	12	6	18	0	0	18	0	0
13	27204440	.	T	A	27	14	41	0	3	44	0	0
13	27207707	.	G	T	15	5	20	0	1	21	0	0
13	27209754	.	T	C	12	15	27	0	0	27	0	0
13	27277165	.	T	G	4	0	4	0	2	6	0	0
13	27277351	.	A	G	3	0	3	0	2	5	0	0
13	27278161	.	C	G	2	0	2	0	2	4	0	0
13	27290750	.	G	C	2	3	5	0	0	5	0	0
13	27293812	.	C	T	1	3	4	0	0	4	0	0
13	27293813	.	A	G	1	3	4	0	0	4	0	0
13	27294304	.	G	A	2	2	4	0	0	4	0	0
13	27294417	.	A	T	4	3	7	0	0	7	0	0
13	27294656	.	G	A	6	3	9	0	1	10	0	0
13	27294663	.	C	T	7	4	11	0	0	11	0	0
13	27295459	.	T	C	3	2	5	0	0	5	0	0
13	27295488	.	C	T	3	2	5	0	0	5	0	0
13	27295682	.	G	A	3	2	5	0	0	5	0	0
13	27296278	.	A	G	4	3	7	0	0	7	0	0
13	27296291	.	T	C	5	3	8	0	0	8	0	0
13	27296396	.	G	A	4	4	8	0	1	9	0	0
13	27296415	.	T	A	0	7	7	0	1	8	0	0
13	27296433	.	A	G	3	6	9	0	0	9	0	0
13	27296576	.	C	T	2	4	6	0	1	7	0	0
13	27296616	.	T	C	5	2	7	0	0	7	0	0
13	27296768	.	A	T	1	2	3	0	0	3	0	0
13	27303822	.	T	C	4	3	7	0	0	7	0	0
13	27309080	.	C	T	5	8	13	0	0	13	0	0
13	27309143	.	C	T	7	13	20	0	0	20	0	0
13	27309209	.	C	T	6	8	14	0	1	15	0	0
13	27312888	.	G	A	4	4	8	0	0	8	0	0
13	27313025	.	T	A	6	3	9	0	0	9	0	0
13	27313236	.	A	G	12	3	15	0	1	16	0	0
13	27313258	.	G	T	2	14	16	0	0	16	0	0
13	27316688	.	T	A	6	5	11	0	0	11	0	0
13	27316862	.	T	G	7	7	14	0	3	17	0	0
13	27317499	.	C	T	30	24	54	0	5	59	0	0
13	27320574	.	T	C	26	35	61	0	1	62	0	0
13	27320583	.	C	T	27	35	62	0	3	65	0	0
13	27320628	.	T	A	29	28	57	0	6	63	0	0
13	27320771	.	C	T	29	34	63	0	1	64	0	0
13	27320849	.	T	C	34	28	62	0	2	64	0	0
13	27321211	.	C	T	34	33	67	0	9	76	0	0
13	27321271	.	G	A	4	27	31	0	28	59	0	0
13	27323970	.	G	A	5	27	32	1	33	66	0	0
13	27323976	.	G	A	5	36	41	1	26	68	0	0
13	27324341	.	A	T	36	26	62	0	3	65	0	0
13	27324346	.	T	C	38	29	67	0	1	68	0	0
13	27379718	.	T	C	2	4	6	0	0	6	0	0
13	27379798	.	G	A	2	2	4	0	0	4	0	0
13	27632915	.	C	T	2	10	12	0	16	28	0	0
13	27633628	.	G	A	21	14	35	0	1	36	0	0
13	27633833	.	A	G	18	14	32	0	1	33	0	0
13	27633906	.	A	G	13	21	34	0	1	35	0	0
13	27634634	.	A	G	22	9	31	0	2	33	0	0
13	27634670	.	G	T	29	13	42	0	0	42	0	0
13	27634678	.	G	T	26	16	42	0	0	43	1	0
13	27634726	.	T	C	16	1	17	0	27	44	0	0
13	27634789	.	A	G	18	17	35	1	0	36	0	0
13	27634903	.	A	G	22	25	47	0	1	48	0	0
13	27650537	.	G	A	17	14	31	0	5	36	0	0
13	27653458	.	C	A	0	20	20	0	19	39	0	0
13	27668056	.	G	T	16	23	39	1	2	42	0	0
13	27674408	.	C	T	22	15	37	0	1	38	0	0
13	27675462	.	T	C	12	0	12	0	13	25	0	0
13	27677945	.	C	T	1	14	15	0	15	30	0	0
13	27685233	.	G	A	16	10	26	0	2	28	0	0
13	27685329	.	C	T	2	18	20	0	8	28	0	0
13	27685363	.	G	A	14	11	25	0	0	25	0	0
13	27685446	.	C	T	13	12	25	0	0	25	0	0
13	27685552	.	G	A	18	17	35	0	3	38	0	0
13	27685583	.	C	T	2	14	16	0	20	36	0	0
13	27686252	.	G	A	20	12	32	0	0	32	0	0
13	27686259	.	C	T	19	14	33	1	0	34	0	0
13	27770575	.	T	C	18	7	25	0	1	26	0	0
13	27776846	.	A	G	12	8	20	0	0	20	0	0
13	27782086	.	C	A	6	5	11	0	1	12	0	0
13	27782192	.	A	T	8	3	11	0	0	11	0	0
13	27782193	.	G	A	7	3	10	0	0	10	0	0
13	27901949	.	C	T	2	2	4	0	0	4	0	0
13	27914491	.	A	G	3	7	10	0	0	10	0	0
13	27951758	.	T	A	12	7	19	0	0	19	0	0
13	27951989	.	A	C	14	9	23	0	0	23	0	0
13	27952207	.	G	A	17	19	36	0	0	36	0	0
13	27952330	.	G	T	18	18	36	0	0	36	0	0
13	27963912	.	T	C	17	14	31	0	0	31	0	0
13	28009108	.	C	T	15	16	31	0	2	33	0	0
13	28009159	.	G	A	15	14	29	1	1	31	0	0
13	28009178	.	A	C	18	14	32	1	1	34	0	0
13	28009246	.	A	T	22	11	33	0	0	33	0	0
13	28009302	.	G	A	1	23	24	0	15	39	0	0
13	28009567	.	G	A	14	9	23	0	1	24	0	0
13	28010214	.	C	A	5	21	26	0	26	52	0	0
13	28010572	.	C	A	24	16	40	0	3	43	0	0
13	28062552	.	T	G	20	18	38	1	1	40	0	0
13	28176651	.	T	C	18	12	30	0	6	36	0	0
13	28306325	.	A	G	2	3	5	0	1	6	0	0
13	28498793	.	G	A	0	7	7	0	3	10	0	0
13	28498812	.	G	A	1	6	7	0	0	7	0	0
13	28501360	.	C	T	4	4	8	0	0	8	0	0
13	28513036	.	T	C	5	4	9	0	0	9	0	0
13	28513240	.	G	A	1	3	4	0	1	5	0	0
13	28561116	.	T	C	2	4	6	0	0	6	0	0
13	28561184	.	T	C	7	2	9	0	0	9	0	0
13	28561190	.	A	T	7	2	9	0	0	9	0	0
13	28588938	.	T	A	3	2	5	0	0	5	0	0
13	28596162	.	C	A	8	6	14	0	2	16	0	0
13	28596166	.	T	C	5	7	12	0	3	15	0	0
13	28596739	.	A	G	1	0	1	0	3	4	0	0
13	28615556	.	C	T	5	6	11	0	0	11	0	0
13	28615622	.	T	C	3	3	6	0	0	6	0	0
13	28618147	.	A	G	1	6	7	0	0	7	0	0
13	28618290	.	C	G	2	0	2	0	3	5	0	0
13	28619373	.	T	G	3	5	8	0	0	8	0	0
13	28619558	.	T	C	3	5	8	1	0	9	0	0
13	28632432	.	A	G	1	4	5	0	0	5	0	0
13	28632492	.	G	A	1	4	5	0	0	5	0	0
13	28642876	.	C	T	5	3	8	0	0	8	0	0
13	28650349	.	A	T	14	14	28	0	1	29	0	0
13	28650416	.	G	C	14	11	25	0	1	26	0	0
13	28650683	.	A	G	10	17	27	0	0	27	0	0
13	28651365	.	A	G	25	23	48	0	2	50	0	0
13	28665065	.	C	T	8	11	19	0	1	20	0	0
13	28676034	.	G	A	8	7	15	0	0	15	0	0
13	28676083	.	A	C	11	5	16	0	0	16	0	0
13	28676472	.	C	G	9	0	9	0	7	16	0	0
13	28678176	.	C	G	11	7	18	0	0	18	0	0
13	28680681	.	G	A	3	2	5	0	0	5	0	0
13	28680879	.	T	C	4	3	7	0	0	7	0	0
13	28690442	.	T	C	5	4	9	0	0	9	0	0
13	28690457	.	C	T	6	5	11	0	0	11	0	0
13	28692778	.	C	T	4	14	18	0	0	18	0	0
13	28694447	.	G	A	7	5	12	0	0	12	0	0
13	28701246	.	G	A	2	11	13	0	6	19	0	0
13	28732278	.	G	A	4	3	7	0	0	7	0	0
13	28732292	.	T	A	3	3	6	0	0	6	0	0
13	28741042	.	A	T	20	17	37	0	2	39	0	0
13	28744159	.	G	A	2	11	13	0	0	13	0	0
13	28744690	.	C	T	25	6	31	0	0	31	0	0
13	28744831	.	C	T	6	9	15	0	0	15	0	0
13	28745188	.	G	A	13	13	26	0	1	28	1	0
13	28745825	.	G	A	5	7	12	0	0	12	0	0
13	28745963	.	C	T	7	10	17	0	0	17	0	0
13	28746070	.	G	A	3	2	5	0	1	6	0	0
13	28746083	.	T	C	2	2	4	0	1	5	0	0
13	28786555	.	G	A	1	5	6	0	0	6	0	0
13	28786583	.	A	G	1	6	7	0	0	7	0	0
13	28791923	.	G	A	2	2	4	0	0	4	0	0
13	28841987	.	C	T	14	9	23	0	2	25	0	0
13	28841990	.	G	T	13	9	22	0	2	24	0	0
13	28866485	.	A	G	36	16	52	0	2	54	0	0
13	28866518	.	C	A	28	22	50	0	8	58	0	0
13	28866553	.	A	G	26	29	55	0	1	56	0	0
13	28866590	.	A	G	25	24	49	0	1	50	0	0
13	28866615	.	C	T	22	28	50	0	2	52	0	0
13	28866722	.	T	C	17	27	44	0	2	46	0	0
13	28866857	.	G	T	2	25	27	0	16	43	0	0
13	28867071	.	G	T	23	21	44	0	2	46	0	0
13	28867382	.	A	T	33	23	56	0	2	58	0	0
13	28870698	.	A	T	28	33	61	1	6	68	0	0
13	28901463	.	T	A	28	26	54	0	0	54	0	0
13	28901714	.	T	A	28	28	56	0	2	58	0	0
13	28901871	.	A	T	13	15	28	3	2	33	0	0
13	28901957	.	A	G	16	15	31	0	0	31	0	0
13	28901996	.	T	C	13	14	27	0	1	28	0	0
13	28902058	.	C	T	15	15	30	0	0	30	0	0
13	29128201	.	C	A	1	2	3	0	0	3	0	0
13	29216742	.	G	C	1	2	3	0	0	3	0	0
13	29226205	.	G	A	1	2	3	0	1	4	0	0
13	29226207	.	G	A	1	3	4	0	0	4	0	0
13	29226842	.	T	C	3	3	6	0	0	6	0	0
13	29292193	.	C	T	4	6	10	0	0	10	0	0
13	29295742	.	G	A	2	3	5	0	1	6	0	0
13	29295759	.	A	C	2	3	5	0	1	6	0	0
13	29300574	.	A	G	6	0	6	0	4	10	0	0
13	29341522	.	C	T	10	5	15	0	0	15	0	0
13	29346927	.	G	A	0	7	7	0	4	11	0	0
13	29347252	.	T	C	4	6	10	0	0	10	0	0
13	29357115	.	T	A	2	4	6	0	0	6	0	0
13	29374153	.	G	A	0	8	8	0	9	17	0	0
13	29374165	.	G	A	9	9	18	0	0	18	0	0
13	29374514	.	C	T	9	13	22	0	0	23	1	0
13	29381011	.	C	T	10	11	21	0	1	22	0	0
13	29381047	.	A	C	13	7	20	0	0	20	0	0
13	29385786	.	A	G	17	18	35	0	1	36	0	0
13	29385831	.	G	A	16	12	28	0	1	29	0	0
13	29385894	.	G	A	12	17	29	0	1	30	0	0
13	29392238	.	C	T	13	8	21	0	1	22	0	0
13	29392261	.	G	A	7	11	18	0	0	18	0	0
13	29402613	.	T	G	12	12	24	0	2	26	0	0
13	29402669	.	C	T	11	10	21	0	2	23	0	0
13	29403953	.	A	C	10	15	25	0	1	26	0	0
13	29403957	.	C	T	14	11	25	0	0	25	0	0
13	29404145	.	T	C	8	10	18	0	0	18	0	0
13	29404218	.	T	A	8	11	19	0	1	20	0	0
13	29404323	.	G	T	18	12	30	0	0	30	0	0
13	29404399	.	A	T	9	12	21	0	1	22	0	0
13	29404400	.	C	T	9	13	22	0	1	23	0	0
13	29404576	.	A	G	14	10	24	0	1	25	0	0
13	29404633	.	C	T	16	16	32	0	0	32	0	0
13	29404660	.	T	G	16	0	16	0	14	30	0	0
13	29404754	.	T	A	2	2	4	0	0	4	0	0
13	29404809	.	G	A	0	2	2	0	4	6	0	0
13	29407196	.	C	T	10	6	16	0	0	16	0	0
13	29407397	.	C	A	2	4	6	0	4	10	0	0
13	29407896	.	A	G	5	3	8	0	0	8	0	0
13	29408052	.	G	T	2	2	4	0	0	4	0	0
13	29408192	.	T	A	8	6	14	0	1	15	0	0
13	29408650	.	A	G	11	10	21	0	0	21	0	0
13	29408677	.	T	A	9	16	25	0	1	26	0	0
13	29408989	.	G	A	9	8	17	0	0	17	0	0
13	29409206	.	T	G	7	9	16	0	0	16	0	0
13	29409210	.	T	A	7	9	16	0	1	17	0	0
13	29409530	.	G	A	15	8	23	0	1	24	0	0
13	29409558	.	G	A	11	9	20	0	0	20	0	0
13	29411895	.	T	G	6	13	19	1	1	22	1	0
13	29412379	.	G	T	19	5	24	0	1	25	0	0
13	29414441	.	G	C	14	9	23	0	0	23	0	0
13	29414482	.	A	T	13	8	21	0	2	23	0	0
13	29414509	.	G	A	14	10	24	0	0	24	0	0
13	29415184	.	A	T	10	17	27	0	0	27	0	0
13	29415202	.	G	A	10	16	26	0	0	26	0	0
13	29416798	.	A	T	15	14	29	0	0	29	0	0
13	29417792	.	T	C	11	8	19	0	0	19	0	0
13	29417814	.	G	A	7	8	15	0	2	17	0	0
13	29419583	.	G	A	4	5	9	0	2	11	0	0
13	29421211	.	G	T	6	9	15	0	1	16	0	0
13	29421296	.	C	T	15	9	24	0	0	24	0	0
13	29422391	.	A	C	2	5	7	0	0	7	0	0
13	29422459	.	C	T	6	7	13	0	0	13	0	0
13	29422511	.	T	A	8	5	13	0	0	13	0	0
13	29422808	.	G	A	7	9	16	0	1	17	0	0
13	29771323	.	T	C	4	4	8	0	0	8	0	0
13	29779532	.	G	A	2	2	4	0	0	4	0	0
13	29804075	.	T	C	2	3	5	1	0	6	0	0
13	29804178	.	T	A	6	6	12	0	0	12	0	0
13	29804207	.	C	A	3	7	10	0	0	10	0	0
13	29804362	.	T	C	2	6	8	0	0	8	0	0
13	29925560	.	A	T	6	7	13	0	1	14	0	0
13	29926242	.	C	T	1	10	11	0	0	11	0	0
13	29928675	.	A	G	7	8	15	0	1	16	0	0
13	29935371	.	A	G	3	8	11	0	2	13	0	0
13	29935983	.	C	G	1	2	3	0	0	3	0	0
13	29952902	.	C	T	5	2	7	0	1	8	0	0
13	29952914	.	G	A	4	2	6	0	1	7	0	0
13	29953265	.	T	G	9	7	16	0	0	16	0	0
13	29953267	.	C	A	9	7	16	0	0	16	0	0
13	29953383	.	G	T	5	7	12	0	0	12	0	0
13	29953522	.	T	C	9	2	11	0	13	24	0	0
13	29958513	.	T	A	12	15	27	0	2	29	0	0
13	29958551	.	G	A	15	14	29	0	0	29	0	0
13	29958725	.	A	G	11	16	27	0	1	28	0	0
13	29965856	.	G	A	10	3	13	0	0	13	0	0
13	29979966	.	T	C	7	7	14	0	1	15	0	0
13	30008147	.	G	A	1	4	5	0	1	6	0	0
13	30008596	.	A	T	22	32	54	0	2	56	0	0
13	30008631	.	T	C	25	20	45	0	7	52	0	0
13	30008737	.	T	C	18	17	35	0	1	36	0	0
13	30009021	.	T	A	12	2	14	0	0	14	0	0
13	30009128	.	G	C	5	3	8	0	0	8	0	0
13	30009818	.	A	C	26	24	50	0	3	53	0	0
13	30009968	.	T	C	36	16	52	3	1	56	0	0
13	30010059	.	C	A	26	20	46	0	2	48	0	0
13	30010137	.	T	C	35	14	49	2	1	52	0	0
13	30021321	.	T	A	26	26	52	0	4	56	0	0
13	30027133	.	T	G	29	10	39	0	2	41	0	0
13	30027372	.	G	A	7	11	18	0	0	18	0	0
13	30027378	.	G	A	7	10	17	0	0	17	0	0
13	30027523	.	T	A	31	14	45	0	0	45	0	0
13	30027659	.	C	T	5	9	14	0	0	14	0	0
13	30033796	.	C	T	1	2	3	0	0	3	0	0
13	30039013	.	C	T	10	5	15	0	0	15	0	0
13	30041662	.	G	A	7	15	22	0	0	22	0	0
13	30043395	.	T	G	6	0	6	0	6	12	0	0
13	30043579	.	A	G	7	7	14	0	1	15	0	0
13	30044214	.	A	T	1	3	4	0	0	4	0	0
13	30083348	.	A	C	28	24	52	0	1	53	0	0
13	30106137	.	C	G	14	0	14	0	23	37	0	0
13	30112396	.	C	T	28	28	56	0	3	59	0	0
13	30112414	.	T	A	28	27	55	0	1	56	0	0
13	30115125	.	A	G	31	28	59	0	3	62	0	0
13	30115217	.	C	T	23	30	53	0	1	54	0	0
13	30125106	.	G	A	36	14	50	0	7	57	0	0
13	30125107	.	T	C	36	20	56	0	1	57	0	0
13	30128388	.	A	T	35	25	60	0	3	63	0	0
13	30131722	.	G	T	24	30	54	0	2	56	0	0
13	30131804	.	G	A	26	22	48	0	0	48	0	0
13	30132190	.	T	C	39	23	62	0	1	63	0	0
13	30138763	.	T	A	4	5	9	0	0	9	0	0
13	30145217	.	A	G	9	4	13	0	0	13	0	0
13	30145414	.	C	A	4	2	6	0	0	6	0	0
13	30145514	.	T	A	5	3	8	0	0	8	0	0
13	30145616	.	T	A	4	3	7	0	0	7	0	0
13	30146199	.	C	A	9	3	12	0	0	12	0	0
13	30146447	.	T	A	7	4	11	0	0	11	0	0
13	30152310	.	A	C	5	6	11	0	1	12	0	0
13	30152502	.	G	C	16	17	33	0	1	34	0	0
13	30155934	.	C	T	16	13	29	1	0	30	0	0
13	30155973	.	T	A	15	8	23	1	2	26	0	0
13	30156176	.	T	C	14	19	33	0	0	33	0	0
13	30156347	.	A	T	12	17	29	0	0	29	0	0
13	30158975	.	A	G	14	16	30	0	1	31	0	0
13	30159823	.	C	T	13	11	24	0	1	25	0	0
13	30161553	.	T	A	18	13	31	0	1	32	0	0
13	30166340	.	C	A	15	23	38	0	1	39	0	0
13	30167097	.	C	A	1	2	3	0	0	3	0	0
13	30167430	.	T	G	14	14	28	0	1	29	0	0
13	30167432	.	A	G	15	14	29	0	0	29	0	0
13	30167711	.	G	A	23	22	45	0	4	49	0	0
13	30167716	.	T	C	22	26	48	0	2	50	0	0
13	30167807	.	G	A	2	23	25	0	14	39	0	0
13	30168662	.	T	A	19	18	37	0	2	39	0	0
13	30181124	.	T	G	2	4	6	0	0	6	0	0
13	30181125	.	T	G	2	4	6	0	0	6	0	0
13	30186853	.	G	A	4	4	8	0	0	8	0	0
13	30186857	.	A	G	3	0	3	0	5	8	0	0
13	30186997	.	C	T	1	6	7	0	0	7	0	0
13	30190019	.	A	T	1	3	4	0	0	4	0	0
13	30190031	.	C	T	1	3	4	0	0	4	0	0
13	30199107	.	T	G	6	2	8	0	0	8	0	0
13	30229090	.	A	G	37	3	40	0	21	61	0	0
13	30233273	.	T	A	1	4	5	0	1	6	0	0
13	30233353	.	A	G	3	3	6	0	0	6	0	0
13	30234351	.	A	C	19	12	31	1	2	34	0	0
13	30474859	.	A	T	12	11	23	0	1	24	0	0
13	30498325	.	A	G	7	0	7	0	5	12	0	0
13	30509281	.	A	G	9	0	9	1	6	17	1	0
13	30551479	.	T	C	13	9	22	0	0	22	0	0
13	30552253	.	A	G	9	0	9	0	8	17	0	0
13	30552504	.	T	A	11	12	23	0	2	25	0	0
13	30552605	.	C	G	8	11	19	0	0	19	0	0
13	30552915	.	T	C	7	9	16	0	1	17	0	0
13	30553002	.	C	T	11	8	19	0	1	20	0	0
13	30553404	.	T	C	12	8	20	0	1	21	0	0
13	30553682	.	C	T	12	9	21	0	0	21	0	0
13	30555751	.	G	A	19	13	32	0	2	34	0	0
13	30556278	.	C	T	11	11	22	0	1	23	0	0
13	30558555	.	C	A	11	10	21	0	2	23	0	0
13	30558896	.	T	C	9	11	20	0	1	21	0	0
13	30559044	.	A	G	11	8	19	0	2	21	0	0
13	30561686	.	G	T	3	14	17	0	16	33	0	0
13	30562079	.	T	G	8	7	15	0	0	15	0	0
13	30562673	.	T	C	20	14	34	0	3	37	0	0
13	30568158	.	T	C	4	11	15	0	1	16	0	0
13	30568176	.	A	G	7	1	8	0	10	18	0	0
13	30568316	.	T	A	11	8	19	0	0	19	0	0
13	30568875	.	A	G	13	13	26	0	0	26	0	0
13	30569650	.	A	C	3	8	11	0	1	12	0	0
13	30569687	.	A	G	6	10	16	0	1	17	0	0
13	30572333	.	A	C	3	3	6	0	0	6	0	0
13	30572778	.	C	T	6	4	10	0	0	10	0	0
13	30575206	.	G	A	3	5	8	1	1	10	0	0
13	30575325	.	A	G	6	6	12	0	0	12	0	0
13	30575637	.	T	A	1	6	7	0	0	7	0	0
13	30579552	.	A	G	3	5	8	0	0	8	0	0
13	30579565	.	A	G	2	5	7	0	0	7	0	0
13	30579792	.	T	C	2	0	2	0	5	7	0	0
13	30580409	.	A	C	3	2	5	0	0	5	0	0
13	30580465	.	T	G	1	2	3	0	0	3	0	0
13	30580935	.	T	C	8	0	8	0	8	16	0	0
13	30580966	.	T	G	10	7	17	0	2	19	0	0
13	30581329	.	C	T	2	8	10	0	6	16	0	0
13	30581334	.	A	T	4	8	12	0	1	13	0	0
13	30581686	.	A	T	6	3	9	0	0	9	0	0
13	30581755	.	C	T	4	3	7	0	0	7	0	0
13	30582174	.	C	T	0	2	2	0	1	3	0	0
13	30582347	.	T	C	6	0	6	0	4	10	0	0
13	30582393	.	A	G	5	2	7	0	1	8	0	0
13	30582397	.	A	G	6	2	8	0	0	8	0	0
13	30582577	.	G	A	4	3	7	0	1	8	0	0
13	30582746	.	C	T	0	4	4	0	3	7	0	0
13	30582781	.	G	A	3	5	8	0	0	8	0	0
13	30582931	.	T	C	2	3	5	0	0	5	0	0
13	30582962	.	A	G	1	2	3	0	0	3	0	0
13	30583036	.	C	G	1	3	4	0	1	5	0	0
13	30583056	.	A	G	1	3	4	0	0	4	0	0
13	30583099	.	C	G	0	3	3	0	1	4	0	0
13	30583140	.	G	C	4	3	7	0	0	7	0	0
13	30583293	.	T	G	1	3	4	0	0	4	0	0
13	30583477	.	G	A	5	2	7	0	0	7	0	0
13	30583514	.	T	C	3	4	7	0	1	8	0	0
13	30583573	.	A	G	3	5	8	0	0	8	0	0
13	30583664	.	T	A	5	3	8	0	0	8	0	0
13	30584007	.	G	A	3	5	8	0	0	8	0	0
13	30584052	.	A	T	4	2	6	0	0	6	0	0
13	30584073	.	C	T	3	2	5	0	0	5	0	0
13	30584332	.	G	A	5	4	9	0	0	9	0	0
13	30817617	.	G	T	8	9	17	0	1	18	0	0
13	30817633	.	G	A	5	8	13	0	0	13	0	0
13	30817786	.	A	G	2	3	5	0	0	5	0	0
13	30817872	.	A	G	7	0	7	0	8	15	0	0
13	30817951	.	C	T	7	7	14	0	0	14	0	0
13	30817983	.	T	C	10	6	16	0	0	16	0	0
13	30818107	.	C	G	11	9	20	0	1	21	0	0
13	30818246	.	C	T	15	17	32	0	0	32	0	0
13	30818319	.	A	T	9	6	15	0	0	15	0	0
13	30818849	.	A	G	10	11	21	1	1	23	0	0
13	30818876	.	C	T	8	13	21	0	2	23	0	0
13	30818986	.	T	A	11	11	22	0	0	22	0	0
13	30819133	.	G	C	12	26	38	0	0	38	0	0
13	30819334	.	T	C	13	13	26	1	1	28	0	0
13	30819444	.	A	T	8	8	16	0	0	16	0	0
13	30819445	.	T	G	9	8	17	0	0	17	0	0
13	30819645	.	T	C	3	4	7	0	0	7	0	0
13	30878624	.	A	T	4	3	7	0	1	8	0	0
13	30878744	.	T	C	1	5	6	0	0	6	0	0
13	30879062	.	G	A	3	5	8	0	0	8	0	0
13	30888494	.	T	C	1	4	5	0	0	5	0	0
13	30892629	.	C	T	5	4	9	0	0	9	0	0
13	30903345	.	A	G	4	6	10	0	0	10	0	0
13	30903921	.	T	A	2	5	7	0	1	8	0	0
13	30905716	.	T	C	6	4	10	0	0	10	0	0
13	30905827	.	G	A	1	4	5	0	5	10	0	0
13	30906016	.	A	G	5	5	10	0	0	10	0	0
13	30906190	.	A	T	1	8	9	1	0	10	0	0
13	30908977	.	T	C	8	6	14	0	0	14	0	0
13	30909624	.	T	A	1	4	5	0	0	5	0	0
13	30917642	.	A	T	2	2	4	0	0	4	0	0
13	30917890	.	C	A	1	1	2	0	1	3	0	0
13	30991541	.	T	C	2	2	4	0	0	4	0	0
13	31925701	.	A	G	1	5	6	0	0	6	0	0
13	31933666	.	A	G	5	10	15	0	0	15	0	0
13	31933684	.	G	A	5	9	14	0	1	15	0	0
13	31935288	.	C	T	2	1	3	0	1	4	0	0
13	31936053	.	C	G	3	3	6	0	0	6	0	0
13	31936074	.	A	T	4	3	7	0	0	7	0	0
13	31936488	.	T	A	2	3	5	0	0	5	0	0
13	31936700	.	G	T	5	9	14	0	1	15	0	0
13	31936707	.	T	A	4	10	14	0	0	14	0	0
13	31936907	.	T	C	6	0	6	0	3	9	0	0
13	32150021	.	T	C	6	2	8	0	0	8	0	0
13	32150038	.	G	A	1	2	3	0	2	5	0	0
13	32446184	.	T	A	1	2	3	0	0	3	0	0
13	32452658	.	C	T	4	3	7	0	0	7	0	0
13	32452949	.	T	G	7	3	10	0	0	10	0	0
13	32453362	.	T	G	3	4	7	0	1	8	0	0
13	32454381	.	A	T	11	9	20	0	1	21	0	0
13	32454546	.	A	G	9	0	9	0	4	13	0	0
13	32454565	.	T	A	8	6	14	0	0	14	0	0
13	32454617	.	G	A	1	8	9	0	6	15	0	0
13	32455754	.	C	T	7	10	17	0	1	18	0	0
13	32455943	.	A	G	6	3	9	0	1	10	0	0
13	32456312	.	C	G	7	9	16	0	0	16	0	0
13	32575964	.	T	G	2	2	4	0	0	4	0	0
13	32576853	.	T	C	1	3	4	0	0	4	0	0
13	32577273	.	A	C	1	2	3	0	0	3	0	0
13	32577369	.	G	C	1	0	1	0	2	3	0	0
13	32580572	.	A	C	6	3	9	0	0	9	0	0
13	32580616	.	G	A	7	4	11	0	0	11	0	0
13	32580618	.	C	G	7	4	11	0	0	11	0	0
13	32583864	.	C	T	9	7	16	0	0	16	0	0
13	32583930	.	A	G	10	13	23	0	0	23	0	0
13	32593009	.	T	C	6	1	7	0	4	11	0	0
13	32630241	.	C	G	1	4	5	0	0	5	0	0
13	32638670	.	T	C	9	5	14	0	0	14	0	0
13	32638718	.	A	G	10	5	15	0	0	15	0	0
13	32638737	.	T	C	13	7	20	0	0	20	0	0
13	32638991	.	T	C	14	7	21	0	1	22	0	0
13	32640975	.	C	A	7	5	12	0	0	12	0	0
13	32641480	.	T	C	1	2	3	0	0	3	0	0
13	32641979	.	C	T	2	2	4	0	1	5	0	0
13	32642012	.	A	C	4	4	8	0	0	8	0	0
13	32642015	.	T	A	4	4	8	0	0	8	0	0
13	32642047	.	G	C	4	3	7	0	0	7	0	0
13	32642050	.	G	C	5	3	8	0	1	9	0	0
13	32642284	.	C	A	9	2	11	0	1	12	0	0
13	32642293	.	A	G	4	2	6	0	4	10	0	0
13	32642488	.	A	G	13	4	17	0	0	17	0	0
13	32642964	.	C	T	2	2	4	0	0	4	0	0
13	32643326	.	G	A	3	3	6	0	1	7	0	0
13	32643366	.	G	A	3	3	6	0	0	6	0	0
13	32643414	.	A	T	3	4	7	0	0	7	0	0
13	32644863	.	T	C	1	5	6	0	0	6	0	0
13	32645082	.	T	G	4	3	7	0	0	7	0	0
13	32665008	.	A	C	4	4	8	0	0	8	0	0
13	32665035	.	G	A	2	4	6	0	0	6	0	0
13	32679934	.	A	G	2	3	5	0	0	5	0	0
13	32726091	.	T	C	2	0	2	1	3	6	0	0
13	32726095	.	G	T	2	3	5	1	0	6	0	0
13	32726152	.	G	C	3	7	10	0	0	10	0	0
13	32754291	.	T	C	2	7	9	0	0	9	0	0
13	32794025	.	T	G	2	0	2	0	5	7	0	0
13	32794139	.	C	A	1	5	6	0	0	6	0	0
13	32794214	.	G	A	7	8	15	0	0	15	0	0
13	32794413	.	T	C	5	12	17	0	2	19	0	0
13	32794925	.	T	C	3	5	8	0	1	9	0	0
13	32794999	.	C	T	14	5	19	0	0	19	0	0
13	32795072	.	A	G	8	0	8	0	3	11	0	0
13	32795108	.	T	C	3	7	10	0	0	10	0	0
13	32795615	.	G	A	6	3	9	0	0	9	0	0
13	32795882	.	A	C	5	4	9	0	0	9	0	0
13	32807497	.	T	G	3	0	3	0	3	6	0	0
13	32812332	.	A	G	1	5	6	0	2	8	0	0
13	32812624	.	T	C	7	4	11	0	0	11	0	0
13	32812788	.	A	C	5	2	7	0	0	7	0	0
13	32812885	.	A	G	3	0	3	0	4	7	0	0
13	32815668	.	G	A	7	5	12	0	0	12	0	0
13	32815884	.	T	C	6	9	15	0	0	15	0	0
13	32815981	.	A	T	4	15	19	0	1	20	0	0
13	32816055	.	G	C	13	13	26	0	0	26	0	0
13	32816128	.	T	G	16	16	32	0	1	33	0	0
13	32816338	.	C	G	12	10	22	0	1	23	0	0
13	32825086	.	C	T	9	9	18	0	0	18	0	0
13	32825137	.	G	A	11	10	21	0	1	22	0	0
13	32825503	.	A	G	14	12	26	0	0	26	0	0
13	32826966	.	T	C	7	13	20	0	2	22	0	0
13	32826978	.	A	G	6	13	19	0	0	19	0	0
13	32827410	.	T	C	6	11	17	0	0	17	0	0
13	32827434	.	C	T	4	9	13	0	3	16	0	0
13	32827754	.	A	G	5	7	12	0	1	13	0	0
13	32830255	.	G	T	9	4	13	0	2	15	0	0
13	32831770	.	C	T	9	8	17	0	0	17	0	0
13	32831965	.	T	C	6	11	17	0	0	17	0	0
13	32831971	.	T	C	7	13	20	0	0	20	0	0
13	32832055	.	A	G	11	13	24	0	1	25	0	0
13	32832058	.	T	A	8	13	21	0	2	23	0	0
13	32834925	.	T	C	8	4	12	0	2	14	0	0
13	32838217	.	T	C	5	7	12	0	0	12	0	0
13	32838254	.	C	T	4	12	16	0	0	16	0	0
13	32838276	.	T	A	5	13	18	0	0	18	0	0
13	32838399	.	T	C	10	0	10	0	12	22	0	0
13	32838417	.	T	C	11	1	12	0	9	21	0	0
13	32838507	.	T	C	14	8	22	0	1	23	0	0
13	32841314	.	A	G	8	5	13	0	1	14	0	0
13	32841377	.	C	T	7	6	13	0	0	13	0	0
13	32841598	.	A	G	8	4	12	0	0	12	0	0
13	32899241	.	G	C	3	5	8	0	0	8	0	0
13	32902243	.	C	T	0	2	2	0	2	4	0	0
13	32902290	.	T	C	2	0	2	0	2	4	0	0
13	32902537	.	T	G	2	3	5	0	0	5	0	0
13	32902545	.	G	A	2	2	4	0	0	4	0	0
13	33028797	.	A	G	20	16	36	0	1	37	0	0
13	33029624	.	G	T	1	14	15	0	17	32	0	0
13	33031915	.	A	G	19	20	39	0	0	39	0	0
13	33033354	.	A	G	28	22	50	0	2	52	0	0
13	33048095	.	T	C	7	0	7	0	7	14	0	0
13	33054706	.	G	A	7	3	10	0	0	10	0	0
13	33059182	.	C	T	14	19	33	0	1	34	0	0
13	33059257	.	T	C	16	14	30	0	0	30	0	0
13	33059260	.	A	G	17	14	31	0	1	32	0	0
13	33062352	.	G	C	7	19	26	0	0	26	0	0
13	33065614	.	A	C	11	7	18	0	1	19	0	0
13	33065670	.	G	A	15	11	26	0	0	26	0	0
13	33066691	.	C	A	0	7	7	0	4	11	0	0
13	33066778	.	T	C	1	3	4	0	1	5	0	0
13	33066782	.	G	T	2	3	5	0	0	5	0	0
13	33066882	.	A	C	3	5	8	0	0	8	0	0
13	33066893	.	A	T	3	5	8	0	0	8	0	0
13	33066923	.	G	A	1	3	4	0	0	4	0	0
13	33067157	.	T	G	1	2	3	0	0	3	0	0
13	33067624	.	C	T	1	4	5	0	0	5	0	0
13	33078859	.	T	C	1	0	1	0	6	7	0	0
13	33083161	.	T	C	3	4	7	0	1	8	0	0
13	33089068	.	A	G	3	4	7	0	0	7	0	0
13	33089224	.	G	A	2	2	4	0	0	4	0	0
13	33122594	.	G	A	4	3	7	0	0	7	0	0
13	33122941	.	C	T	5	11	16	0	3	19	0	0
13	33122949	.	G	C	7	9	16	0	1	17	0	0
13	33187760	.	G	A	1	5	6	0	0	6	0	0
13	33256262	.	T	C	1	2	3	0	2	5	0	0
13	33263860	.	A	T	19	2	21	2	3	26	0	0
13	33310619	.	C	T	1	4	5	0	0	5	0	0
13	33816176	.	T	A	13	3	16	0	1	17	0	0
13	34746422	.	T	C	1	3	4	0	0	4	0	0
13	35510952	.	T	C	6	2	8	0	1	9	0	0
13	35945265	.	T	C	4	2	6	0	0	6	0	0
13	36153098	.	G	A	1	3	4	0	0	4	0	0
13	36680611	.	G	A	1	11	12	0	8	20	0	0
13	36683911	.	C	T	8	9	17	0	0	17	0	0
13	36691543	.	T	C	10	9	19	0	0	19	0	0
13	36705895	.	G	A	2	3	5	0	1	6	0	0
13	36717012	.	A	G	4	4	8	0	0	8	0	0
13	36725167	.	G	A	4	2	6	0	0	6	0	0
13	36737056	.	C	T	3	4	7	0	0	7	0	0
13	36741086	.	A	G	2	2	4	0	0	4	0	0
13	36761234	.	A	G	3	2	5	0	0	5	0	0
13	36764791	.	C	T	20	22	42	0	3	45	0	0
13	36764838	.	C	G	15	22	37	0	1	38	0	0
13	36771815	.	G	A	15	16	31	0	1	32	0	0
13	36781068	.	G	C	1	17	18	0	16	34	0	0
13	36781407	.	A	G	22	1	23	0	23	46	0	0
13	36783998	.	G	A	4	23	27	0	23	50	0	0
13	36784262	.	G	A	0	15	15	0	8	23	0	0
13	36784347	.	G	A	0	3	3	0	10	13	0	0
13	36784350	.	G	A	10	3	13	0	0	13	0	0
13	36787343	.	C	T	2	2	4	0	0	4	0	0
13	36787783	.	G	A	2	2	4	0	1	5	0	0
13	36792193	.	G	C	3	3	6	0	0	6	0	0
13	36795509	.	T	C	5	0	5	0	6	11	0	0
13	36798022	.	C	A	1	2	3	0	0	3	0	0
13	36800799	.	C	T	2	2	4	0	0	4	0	0
13	36802345	.	A	G	1	2	3	0	1	4	0	0
13	36802371	.	T	C	1	3	4	0	0	4	0	0
13	36821952	.	C	A	0	2	2	0	1	3	0	0
13	36868564	.	G	A	11	15	26	0	1	27	0	0
13	36868635	.	T	G	15	16	31	0	2	33	0	0
13	36868938	.	C	A	26	16	42	1	0	43	0	0
13	36869639	.	C	T	5	23	28	0	26	54	0	0
13	36872777	.	A	G	26	23	49	0	2	51	0	0
13	36872814	.	A	C	21	1	22	0	26	48	0	0
13	36879965	.	T	C	20	0	20	0	17	37	0	0
13	36879983	.	G	A	19	19	38	0	0	38	0	0
13	36880028	.	A	C	11	0	11	0	22	33	0	0
13	36887746	.	C	A	1	16	17	0	18	35	0	0
13	36887779	.	G	A	20	15	35	0	2	37	0	0
13	36898229	.	G	A	26	21	47	0	2	49	0	0
13	36910378	.	G	A	17	26	43	0	0	43	0	0
13	36910387	.	C	T	17	23	40	0	3	43	0	0
13	36910591	.	A	G	13	20	33	0	5	38	0	0
13	36910729	.	G	C	19	25	44	0	0	44	0	0
13	36911037	.	T	C	26	0	26	0	27	53	0	0
13	36923217	.	A	C	5	5	10	0	1	11	0	0
13	36923228	.	G	C	6	4	10	0	0	10	0	0
13	36926967	.	G	A	7	6	13	0	0	13	0	0
13	36932023	.	C	T	10	9	19	0	0	19	0	0
13	36932289	.	G	A	8	5	13	0	2	15	0	0
13	36932356	.	A	G	7	7	14	0	0	14	0	0
13	36932970	.	T	G	6	4	10	0	1	11	0	0
13	36933206	.	C	T	2	2	4	0	0	4	0	0
13	36958184	.	T	A	1	2	3	0	0	3	0	0
13	36990431	.	G	A	3	6	9	0	0	9	0	0
13	36994954	.	T	G	7	6	13	0	0	13	0	0
13	36995363	.	C	G	4	5	9	0	0	9	0	0
13	36995757	.	T	G	4	3	7	0	0	7	0	0
13	36995832	.	G	A	4	1	5	0	1	6	0	0
13	36995873	.	G	T	5	2	7	0	0	7	0	0
13	36995874	.	A	G	4	2	6	0	1	7	0	0
13	36996530	.	A	G	4	2	6	0	0	6	0	0
13	36996681	.	C	T	3	5	8	0	0	8	0	0
13	36997459	.	G	A	0	4	4	0	4	8	0	0
13	37041045	.	A	C	3	5	8	0	0	8	0	0
13	37055813	.	A	G	1	0	1	0	2	3	0	0
13	37055867	.	A	G	2	2	4	0	0	4	0	0
13	37065596	.	C	A	5	4	9	0	0	9	0	0
13	37067506	.	A	G	6	2	8	1	0	9	0	0
13	37071638	.	A	G	1	2	3	0	0	3	0	0
13	37071768	.	G	A	1	3	4	0	1	5	0	0
13	37071841	.	A	G	2	2	4	0	1	5	0	0
13	37075501	.	T	A	6	6	12	0	0	12	0	0
13	37075528	.	T	A	6	3	9	0	0	9	0	0
13	37075547	.	T	A	6	4	10	0	0	10	0	0
13	37075986	.	C	G	6	2	8	0	0	8	0	0
13	37076093	.	A	T	11	10	21	0	0	21	0	0
13	37076152	.	A	G	8	4	12	0	1	13	0	0
13	37076269	.	T	C	18	4	22	0	0	22	0	0
13	37076373	.	T	G	7	11	18	1	0	19	0	0
13	37076382	.	C	T	1	9	10	0	5	15	0	0
13	37076415	.	T	C	7	5	12	0	0	12	0	0
13	37076710	.	C	T	4	3	7	0	1	8	0	0
13	37076934	.	C	T	5	4	9	0	1	10	0	0
13	37076960	.	A	C	2	9	11	0	0	11	0	0
13	37077127	.	T	C	1	5	6	0	0	6	0	0
13	37077629	.	T	C	2	3	5	0	0	5	0	0
13	37077829	.	C	A	1	7	8	0	4	12	0	0
13	37077844	.	G	A	5	5	10	0	0	10	0	0
13	37077903	.	A	G	15	4	19	0	0	19	0	0
13	37077961	.	C	T	1	7	8	0	14	22	0	0
13	37078181	.	C	T	2	9	11	1	12	24	0	0
13	37090658	.	A	G	6	3	9	0	0	9	0	0
13	37090700	.	A	C	3	6	9	0	0	9	0	0
13	37093324	.	G	A	4	5	9	0	0	9	0	0
13	37093387	.	C	T	1	2	3	0	6	9	0	0
13	37093548	.	G	A	4	3	7	0	0	7	0	0
13	37103094	.	A	G	2	9	11	0	1	12	0	0
13	37103148	.	C	G	0	9	9	0	3	12	0	0
13	37103178	.	G	T	4	7	11	0	0	11	0	0
13	37105516	.	C	T	5	5	10	0	1	11	0	0
13	37105799	.	A	T	7	10	17	0	0	17	0	0
13	37108099	.	T	C	8	9	17	0	1	18	0	0
13	37303034	.	C	T	1	2	3	0	0	3	0	0
13	37303235	.	A	G	2	6	8	0	0	8	0	0
13	37303316	.	C	T	0	4	4	0	7	11	0	0
13	37303535	.	T	C	5	2	7	0	0	7	0	0
13	37421509	.	C	T	0	13	13	0	4	17	0	0
13	37421604	.	A	C	6	15	21	0	2	23	0	0
13	37422417	.	C	T	0	20	20	0	12	32	0	0
13	37425730	.	G	A	10	7	17	0	1	18	0	0
13	37426052	.	A	G	2	6	8	0	0	8	0	0
13	37429222	.	C	T	4	8	12	0	1	13	0	0
13	37429469	.	G	A	4	6	10	0	0	10	0	0
13	37432564	.	A	G	9	10	19	0	1	20	0	0
13	37432570	.	A	G	9	10	19	0	0	19	0	0
13	37469396	.	T	C	1	2	3	0	0	3	0	0
13	37469488	.	G	C	1	2	3	0	0	3	0	0
13	37470539	.	T	G	3	2	5	0	0	5	0	0
13	37470965	.	C	T	1	4	5	0	0	5	0	0
13	37470967	.	C	A	0	4	4	0	1	5	0	0
13	37472515	.	C	G	3	5	8	0	0	8	0	0
13	37472557	.	T	C	2	5	7	0	0	7	0	0
13	37492128	.	T	C	2	2	4	0	0	4	0	0
13	37492436	.	T	G	1	2	3	0	0	3	0	0
13	37528544	.	T	C	4	9	13	0	0	13	0	0
13	37528612	.	T	A	5	5	10	0	1	11	0	0
13	37528624	.	T	C	4	0	4	0	6	10	0	0
13	37528793	.	T	G	5	11	16	0	1	17	0	0
13	37532764	.	G	T	3	3	6	0	0	6	0	0
13	37545464	.	T	C	12	0	12	0	5	17	0	0
13	37545480	.	T	C	9	0	9	0	6	15	0	0
13	37594485	.	T	C	3	3	6	0	0	6	0	0
13	37596665	.	T	A	3	3	6	0	0	6	0	0
13	37596674	.	C	T	1	2	3	0	2	5	0	0
13	37600375	.	A	T	2	4	6	0	0	6	0	0
13	37600499	.	A	T	3	3	6	0	0	6	0	0
13	37653721	.	A	T	9	4	13	0	0	13	0	0
13	37653780	.	T	C	9	6	15	1	1	17	0	0
13	37653947	.	C	T	1	2	3	0	0	3	0	0
13	37654067	.	T	A	1	3	4	0	1	5	0	0
13	37658727	.	A	G	3	2	5	0	1	6	0	0
13	37658843	.	G	C	5	3	8	0	0	8	0	0
13	37659192	.	G	A	0	4	4	0	1	5	0	0
13	37659208	.	T	C	3	5	8	0	0	8	0	0
13	37659250	.	A	G	5	6	11	0	0	11	0	0
13	37659252	.	A	T	5	6	11	0	0	11	0	0
13	37659437	.	G	A	5	4	9	0	0	9	0	0
13	37659453	.	A	C	8	4	12	0	0	12	0	0
13	37659570	.	C	T	5	3	8	0	1	9	0	0
13	37661698	.	A	G	4	9	13	0	0	13	0	0
13	37666322	.	C	T	1	7	8	0	0	8	0	0
13	37671948	.	T	C	11	8	19	0	2	21	0	0
13	37671949	.	T	C	12	7	19	0	2	21	0	0
13	37672082	.	T	G	9	15	24	0	0	24	0	0
13	37672087	.	A	C	8	15	23	0	2	25	0	0
13	37672129	.	G	A	2	11	13	0	12	25	0	0
13	37672133	.	G	A	14	10	24	0	0	24	0	0
13	37672716	.	C	T	15	13	28	0	0	28	0	0
13	37672777	.	A	G	13	11	24	0	1	25	0	0
13	37673230	.	A	T	1	3	4	0	0	4	0	0
13	38304688	.	G	A	10	13	23	0	1	24	0	0
13	38304739	.	C	A	16	13	29	0	0	29	0	0
13	38304791	.	C	A	15	8	23	0	3	26	0	0
13	38304824	.	A	G	12	10	22	0	0	22	0	0
13	39114793	.	A	G	0	3	3	0	1	4	0	0
13	39285378	.	G	A	1	2	3	0	0	3	0	0
13	39346412	.	G	A	2	2	4	0	0	4	0	0
13	39349323	.	A	G	3	2	5	0	0	5	0	0
13	39349619	.	T	C	3	2	5	0	0	5	0	0
13	39360613	.	C	T	0	3	3	0	1	4	0	0
13	39532105	.	T	C	1	2	3	0	2	5	0	0
13	39657068	.	A	G	11	5	16	0	0	16	0	0
13	39657140	.	C	T	0	7	7	0	7	14	0	0
13	39657156	.	T	G	7	6	13	0	0	13	0	0
13	39657285	.	T	C	3	4	7	0	0	7	0	0
13	39657625	.	A	C	6	5	11	0	0	11	0	0
13	39657652	.	A	G	4	6	10	0	0	10	0	0
13	39830658	.	C	G	3	2	5	0	0	5	0	0
13	39830811	.	A	G	1	3	4	0	0	4	0	0
13	40352476	.	A	G	9	12	21	0	0	21	0	0
13	40352830	.	A	G	14	7	21	1	2	24	0	0
13	40352842	.	A	G	5	14	19	0	1	20	0	0
13	40749004	.	T	C	9	2	11	0	1	12	0	0
13	41289189	.	T	C	3	7	10	0	1	11	0	0
13	41911474	.	T	C	12	10	22	0	0	22	0	0
13	42400473	.	C	T	12	14	26	0	3	29	0	0
13	42407519	.	C	T	5	10	15	0	2	17	0	0
13	42407526	.	A	G	8	8	16	0	0	16	0	0
13	42407618	.	A	C	9	7	16	0	4	20	0	0
13	42414459	.	A	G	5	3	8	1	0	9	0	0
13	42443532	.	T	C	5	4	9	0	0	9	0	0
13	42467430	.	T	C	6	12	18	0	0	18	0	0
13	42469651	.	C	T	10	4	14	0	0	14	0	0
13	42471895	.	T	C	4	4	8	0	0	8	0	0
13	42481256	.	A	G	13	8	21	0	2	23	0	0
13	42481575	.	T	C	9	21	30	1	3	34	0	0
13	42485110	.	G	A	13	7	20	0	1	21	0	0
13	42487319	.	T	C	10	13	23	1	1	25	0	0
13	42490775	.	C	T	6	7	13	0	0	13	0	0
13	42500513	.	A	T	4	4	8	0	0	8	0	0
13	42502659	.	T	A	4	3	7	0	0	7	0	0
13	42502713	.	T	C	5	5	10	0	0	10	0	0
13	42507075	.	C	T	6	5	11	0	0	11	0	0
13	42513589	.	T	G	9	8	17	0	1	18	0	0
13	42513607	.	G	A	8	8	16	0	0	16	0	0
13	42516915	.	C	G	0	7	7	0	5	12	0	0
13	42521407	.	T	C	4	0	4	0	5	9	0	0
13	42523951	.	A	G	11	6	17	0	1	18	0	0
13	42523969	.	G	C	11	4	15	0	0	15	0	0
13	42524065	.	C	G	1	5	6	0	2	8	0	0
13	42524107	.	C	T	4	3	7	0	0	7	0	0
13	42536843	.	T	C	4	4	8	0	0	8	0	0
13	42602533	.	A	T	3	3	6	0	0	6	0	0
13	42604301	.	A	C	4	2	6	0	0	7	1	0
13	42604325	.	C	T	2	4	6	0	0	6	0	0
13	42611019	.	T	C	4	2	6	0	0	6	0	0
13	42611052	.	C	T	6	2	8	0	0	8	0	0
13	42615073	.	T	G	4	5	9	0	0	9	0	0
13	42616301	.	A	C	6	4	10	0	0	10	0	0
13	42616527	.	C	A	3	5	8	0	2	10	0	0
13	42626622	.	C	T	1	8	9	0	5	14	0	0
13	42628463	.	T	C	5	5	10	0	0	10	0	0
13	42672885	.	T	G	7	5	12	0	0	12	0	0
13	42676262	.	T	A	13	15	28	0	2	30	0	0
13	42678806	.	C	T	16	11	27	0	0	27	0	0
13	42681219	.	A	G	1	4	5	0	0	5	0	0
13	42681759	.	G	T	8	10	18	0	0	18	0	0
13	42682255	.	T	A	13	11	24	0	0	24	0	0
13	42682282	.	T	C	12	9	21	0	0	21	0	0
13	42691626	.	A	G	18	10	28	0	0	28	0	0
13	42691644	.	G	A	16	11	27	0	0	27	0	0
13	42693028	.	C	T	2	5	7	0	4	11	0	0
13	42693030	.	G	A	5	5	10	0	0	10	0	0
13	42720879	.	G	A	2	2	4	0	1	5	0	0
13	42720896	.	G	A	2	5	7	0	0	7	0	0
13	43223722	.	T	G	25	15	40	0	2	42	0	0
13	43223961	.	G	A	17	14	31	0	0	31	0	0
13	43226429	.	C	T	6	22	28	0	22	50	0	0
13	43229923	.	G	A	16	23	39	0	0	39	0	0
13	43232179	.	A	G	8	13	21	0	0	21	0	0
13	43232266	.	G	A	18	14	32	0	1	33	0	0
13	43237120	.	A	G	12	11	23	0	0	23	0	0
13	43237153	.	G	A	11	3	14	0	0	14	0	0
13	43238513	.	C	A	16	20	36	0	1	37	0	0
13	43277409	.	T	C	2	3	5	0	1	6	0	0
13	43300346	.	C	T	2	6	8	0	0	8	0	0
13	43300391	.	T	C	5	4	9	0	0	9	0	0
13	43507468	.	T	C	4	0	4	0	2	6	0	0
13	43507470	.	A	G	4	2	6	0	1	7	0	0
13	43507520	.	A	G	4	6	10	0	0	10	0	0
13	43507541	.	A	G	7	11	18	0	0	18	0	0
13	43507747	.	A	G	4	6	10	0	0	10	0	0
13	43507797	.	A	C	7	4	11	0	0	11	0	0
13	43507889	.	G	A	5	14	19	0	1	20	0	0
13	43508674	.	A	T	10	18	28	0	0	28	0	0
13	43508696	.	A	G	6	14	20	0	0	20	0	0
13	43508868	.	G	A	19	11	30	0	1	31	0	0
13	43508986	.	A	G	15	7	22	0	0	22	0	0
13	43508987	.	T	A	13	7	20	0	1	21	0	0
13	43509318	.	G	A	16	14	30	0	0	30	0	0
13	43509386	.	G	A	18	14	32	0	0	32	0	0
13	43509443	.	A	T	12	17	29	0	0	29	0	0
13	43509537	.	A	G	12	9	21	0	2	23	0	0
13	43509600	.	T	A	15	15	30	0	0	30	0	0
13	43512320	.	C	T	1	11	12	0	7	19	0	0
13	43512546	.	G	A	3	5	8	0	1	9	0	0
13	43512915	.	T	C	5	2	7	0	0	7	0	0
13	43515153	.	G	A	12	5	17	0	0	17	0	0
13	43515168	.	T	A	11	6	17	0	1	18	0	0
13	43599926	.	T	C	4	8	12	0	0	12	0	0
13	43633291	.	G	A	4	7	11	0	0	11	0	0
13	43637067	.	T	C	5	5	10	0	0	10	0	0
13	43637079	.	A	G	7	5	12	0	0	12	0	0
13	43637205	.	A	T	5	7	12	0	0	12	0	0
13	43647035	.	T	C	12	16	28	0	0	28	0	0
13	43650583	.	G	A	1	2	3	0	0	3	0	0
13	43650592	.	G	C	2	2	4	0	0	4	0	0
13	43650627	.	A	T	9	10	19	0	1	20	0	0
13	43658881	.	G	A	18	8	26	0	2	28	0	0
13	43659018	.	C	T	15	11	26	0	1	27	0	0
13	43659107	.	G	A	0	5	5	0	18	23	0	0
13	43659357	.	G	T	8	9	17	0	1	18	0	0
13	44308161	.	T	C	3	0	3	1	4	8	0	0
13	44355466	.	C	A	6	3	9	0	0	9	0	0
13	44362302	.	T	C	3	0	3	0	2	5	0	0
13	44498566	.	T	C	6	2	8	0	0	8	0	0
13	44498613	.	T	A	4	2	6	0	0	6	0	0
13	44498640	.	G	A	2	2	4	0	0	4	0	0
13	44629339	.	G	A	1	5	6	0	0	6	0	0
13	44702469	.	T	C	7	2	9	0	13	22	0	0
13	44715290	.	G	A	24	13	37	0	1	38	0	0
13	44738328	.	G	A	17	18	35	0	0	35	0	0
13	44767765	.	T	C	13	9	22	0	0	22	0	0
13	44772073	.	A	G	6	16	22	0	1	23	0	0
13	44775714	.	G	A	5	7	12	0	1	13	0	0
13	44775895	.	C	T	0	4	4	1	10	15	0	0
13	44779071	.	A	G	5	11	16	0	0	16	0	0
13	44779083	.	A	G	9	10	19	0	0	19	0	0
13	44779107	.	C	T	9	6	15	0	0	15	0	0
13	44782267	.	T	C	6	10	16	0	2	18	0	0
13	44788217	.	C	T	8	3	11	0	2	13	0	0
13	44788358	.	G	A	5	2	7	0	1	8	0	0
13	44788361	.	T	A	6	2	8	0	1	9	0	0
13	44788815	.	C	T	14	11	25	0	0	25	0	0
13	44788827	.	A	C	12	10	22	0	0	22	0	0
13	44808582	.	A	C	18	0	18	0	7	25	0	0
13	44842770	.	G	A	2	2	4	2	0	6	0	0
13	44842810	.	G	T	1	6	7	1	0	8	0	0
13	44860837	.	T	A	7	6	13	0	0	13	0	0
13	44869386	.	G	T	5	9	14	0	0	14	0	0
13	44888309	.	A	C	10	8	18	0	2	20	0	0
13	45010064	.	A	G	11	13	24	0	0	24	0	0
13	45012835	.	A	T	24	28	52	0	3	55	0	0
13	45015355	.	A	T	27	22	49	0	0	49	0	0
13	45015655	.	T	G	17	25	42	0	2	44	0	0
13	45015776	.	T	C	35	30	65	0	2	67	0	0
13	45016119	.	G	A	38	28	66	0	0	66	0	0
13	45035991	.	A	G	17	8	25	0	0	25	0	0
13	45039294	.	G	A	9	9	18	0	2	20	0	0
13	45039330	.	T	A	8	11	19	0	1	20	0	0
13	45049177	.	A	G	8	10	18	0	1	19	0	0
13	45432170	.	A	G	24	7	31	0	0	31	0	0
13	45434952	.	T	G	17	19	36	0	0	36	0	0
13	45436554	.	A	G	22	14	36	0	2	38	0	0
13	45436561	.	G	T	24	15	39	0	0	39	0	0
13	45468567	.	A	T	11	30	41	2	2	46	1	0
13	45468827	.	G	C	37	2	39	0	32	71	0	0
13	45470601	.	A	G	32	28	60	3	1	64	0	0
13	45470815	.	A	T	29	26	55	0	0	55	0	0
13	45470926	.	G	C	18	23	41	0	0	41	0	0
13	45470983	.	A	G	13	11	24	0	3	27	0	0
13	45471048	.	A	G	8	10	18	0	1	19	0	0
13	45471052	.	A	G	8	11	19	0	2	21	0	0
13	45471086	.	T	A	9	6	15	0	2	17	0	0
13	45471243	.	G	A	22	27	49	0	1	50	0	0
13	45471367	.	A	T	28	20	48	0	1	49	0	0
13	45471475	.	C	A	19	19	38	0	0	38	0	0
13	45471669	.	C	T	28	29	57	0	1	58	0	0
13	45471888	.	C	T	1	17	18	0	26	44	0	0
13	45472124	.	T	G	13	10	23	0	1	24	0	0
13	45472215	.	G	C	27	26	53	0	0	53	0	0
13	45472653	.	G	A	34	30	64	0	3	67	0	0
13	45472924	.	G	A	37	46	83	0	5	88	0	0
13	45472954	.	G	A	43	45	88	0	1	89	0	0
13	45476285	.	C	T	7	8	15	0	2	17	0	0
13	45476360	.	A	C	17	12	29	0	0	29	0	0
13	45476711	.	C	T	21	18	39	0	0	39	0	0
13	45476731	.	A	T	22	17	39	0	1	40	0	0
13	45481475	.	G	A	16	11	27	0	0	27	0	0
13	45481792	.	A	G	2	6	8	0	0	8	0	0
13	45494912	.	G	C	19	15	34	0	3	37	0	0
13	45495227	.	C	A	19	19	38	0	2	40	0	0
13	45495442	.	G	T	5	4	9	0	0	9	0	0
13	45495488	.	T	A	1	1	2	0	1	3	0	0
13	45524500	.	T	C	10	15	25	0	0	25	0	0
13	45553072	.	G	A	9	11	20	0	0	20	0	0
13	45553168	.	G	A	15	7	22	1	0	23	0	0
13	45565508	.	C	T	12	18	30	0	1	31	0	0
13	45565637	.	G	A	12	9	21	0	4	25	0	0
13	45565646	.	G	A	0	14	14	0	14	28	0	0
13	45570300	.	A	C	15	8	23	0	0	23	0	0
13	45794475	.	C	T	6	9	15	0	0	15	0	0
13	45991772	.	T	C	24	24	48	0	4	52	0	0
13	45991801	.	C	T	20	23	43	0	5	48	0	0
13	45999530	.	G	A	3	21	24	0	17	41	0	0
13	45999723	.	C	T	19	16	35	0	4	39	0	0
13	46179340	.	C	T	28	34	62	0	3	65	0	0
13	46179387	.	C	T	37	27	64	0	5	70	1	0
13	46179392	.	G	A	40	24	64	0	4	68	0	0
13	46179806	.	T	A	31	24	55	0	4	59	0	0
13	46179814	.	A	G	29	24	53	0	3	56	0	0
13	46298734	.	G	A	4	2	6	0	0	6	0	0
13	46299677	.	G	T	5	3	8	0	0	8	0	0
13	46299812	.	C	T	0	8	8	0	4	12	0	0
13	46299827	.	A	G	4	9	13	0	0	13	0	0
13	46299873	.	T	A	3	5	8	0	0	8	0	0
13	46299875	.	T	G	3	5	8	0	0	8	0	0
13	46299934	.	G	A	3	4	7	0	0	7	0	0
13	46300224	.	T	A	2	3	5	0	0	5	0	0
13	46300247	.	A	T	3	2	5	0	0	5	0	0
13	46300259	.	T	G	2	2	4	0	1	5	0	0
13	46300421	.	C	T	7	3	10	0	1	11	0	0
13	46300450	.	C	T	5	4	9	0	1	10	0	0
13	46300694	.	T	A	7	3	10	0	0	10	0	0
13	46300737	.	G	A	11	5	16	0	1	17	0	0
13	46321988	.	C	T	1	5	6	0	1	7	0	0
13	46343432	.	T	C	6	0	6	0	6	12	0	0
13	46343471	.	G	A	5	2	7	0	0	7	0	0
13	46343486	.	G	A	3	4	7	0	0	7	0	0
13	46343525	.	G	A	5	4	9	0	0	9	0	0
13	46346306	.	G	A	6	4	10	0	1	11	0	0
13	46384311	.	A	G	4	3	7	0	0	7	0	0
13	46520818	.	G	A	1	2	3	0	0	3	0	0
13	46520845	.	T	C	1	3	4	0	0	4	0	0
13	46520924	.	T	C	9	4	13	0	0	13	0	0
13	46521542	.	C	T	0	7	7	0	2	9	0	0
13	46521633	.	G	A	10	7	17	0	1	18	0	0
13	46521664	.	C	A	12	9	21	0	2	23	0	0
13	46521762	.	T	A	8	6	14	0	1	15	0	0
13	46674878	.	G	A	5	5	10	0	0	10	0	0
13	46686936	.	T	C	4	4	8	1	1	10	0	0
13	46687008	.	C	G	7	8	15	0	0	15	0	0
13	46687037	.	G	T	6	7	13	0	0	13	0	0
13	46687086	.	G	A	3	3	6	0	0	6	0	0
13	46718745	.	A	G	2	3	5	0	0	5	0	0
13	46718871	.	A	C	8	6	14	0	0	14	0	0
13	46718930	.	T	C	7	8	15	0	0	15	0	0
13	46771366	.	A	C	8	7	15	0	1	16	0	0
13	46793193	.	G	A	0	9	9	0	5	14	0	0
13	46795515	.	G	A	3	14	17	1	13	31	0	0
13	46804112	.	G	A	5	2	7	0	0	7	0	0
13	46804202	.	G	A	4	2	6	0	0	6	0	0
13	46812107	.	C	T	4	2	6	0	0	6	0	0
13	46831698	.	C	T	0	4	4	0	2	6	0	0
13	46831831	.	A	T	2	2	4	0	0	4	0	0
13	46832084	.	A	G	1	3	4	0	0	4	0	0
13	46832315	.	T	C	9	0	9	0	3	12	0	0
13	46832449	.	A	T	5	5	10	0	1	11	0	0
13	46832471	.	A	C	2	6	8	0	1	9	0	0
13	46833050	.	C	G	4	3	7	0	0	7	0	0
13	46833064	.	C	T	3	3	6	0	0	6	0	0
13	46834504	.	G	A	7	6	13	0	1	14	0	0
13	46834550	.	G	A	8	7	15	0	0	15	0	0
13	46834815	.	C	T	3	4	7	0	1	8	0	0
13	46834860	.	T	A	6	4	10	0	0	10	0	0
13	46835270	.	C	G	2	2	4	0	0	4	0	0
13	46835304	.	C	T	4	6	10	0	0	10	0	0
13	46835344	.	C	T	7	4	11	0	1	12	0	0
13	46844205	.	G	A	7	6	13	0	1	14	0	0
13	46857629	.	A	T	10	6	16	0	1	17	0	0
13	46860158	.	T	C	3	0	3	0	5	8	0	0
13	46864873	.	C	A	0	3	3	0	6	9	0	0
13	46929067	.	G	T	0	2	2	0	1	3	0	0
13	46930109	.	T	G	3	4	7	0	0	7	0	0
13	46935014	.	T	G	1	3	4	0	0	4	0	0
13	46935089	.	C	T	2	3	5	0	0	5	0	0
13	46988299	.	C	T	15	15	30	0	1	31	0	0
13	46988390	.	T	C	11	0	11	0	18	29	0	0
13	46988457	.	C	A	1	16	17	0	16	33	0	0
13	46988561	.	A	G	17	20	37	0	1	38	0	0
13	46988588	.	A	G	24	22	46	0	0	46	0	0
13	46988638	.	T	G	15	22	37	0	1	38	0	0
13	46989607	.	C	T	2	18	20	0	22	42	0	0
13	47042439	.	G	A	0	4	4	0	1	5	0	0
13	47045212	.	G	T	3	2	5	0	1	6	0	0
13	47099834	.	A	G	3	3	6	0	0	6	0	0
13	47100347	.	C	T	1	8	9	0	0	9	0	0
13	47120091	.	T	C	3	2	5	0	0	5	0	0
13	47127266	.	T	C	3	6	9	0	0	9	0	0
13	47130927	.	A	G	3	0	3	1	3	7	0	0
13	47135882	.	C	T	5	3	8	0	0	8	0	0
13	47135885	.	G	A	0	2	2	0	6	8	0	0
13	47146860	.	C	T	4	4	8	0	0	8	0	0
13	47163748	.	A	G	8	0	8	1	6	15	0	0
13	47449795	.	A	G	3	6	9	0	0	9	0	0
13	47507208	.	A	G	2	2	4	0	0	4	0	0
13	47540240	.	A	G	2	2	4	0	0	4	0	0
13	47556049	.	G	C	3	3	6	0	0	6	0	0
13	47556374	.	T	C	2	2	4	0	0	4	0	0
13	47683807	.	T	C	3	3	6	0	0	6	0	0
13	47684293	.	T	C	1	4	5	0	1	6	0	0
13	47686970	.	C	T	4	3	7	0	0	7	0	0
13	47687088	.	G	A	2	3	5	0	0	5	0	0
13	47689478	.	A	C	3	2	5	0	0	5	0	0
13	47689506	.	C	T	2	3	5	0	0	5	0	0
13	47689564	.	A	G	1	5	6	0	0	6	0	0
13	47690160	.	C	T	3	2	5	0	0	5	0	0
13	47690180	.	C	T	2	4	6	0	1	7	0	0
13	47690269	.	A	T	1	3	4	0	0	4	0	0
13	47690383	.	C	G	1	2	3	0	0	3	0	0
13	47690600	.	T	G	1	2	3	0	0	3	0	0
13	47714035	.	T	C	5	7	12	0	0	12	0	0
13	47714064	.	T	C	2	4	6	0	1	7	0	0
13	47723765	.	C	T	5	3	8	0	0	8	0	0
13	47723778	.	A	G	5	0	5	0	5	10	0	0
13	47751907	.	T	G	1	3	4	0	0	6	2	0
13	47751943	.	T	C	1	0	1	0	2	3	0	0
13	47751953	.	C	T	1	2	3	0	0	3	0	0
13	47827308	.	C	T	2	5	7	0	2	9	0	0
13	47831531	.	T	C	1	5	6	0	0	6	0	0
13	47831552	.	G	A	2	7	9	0	0	9	0	0
13	47834276	.	C	A	2	5	7	1	1	9	0	0
13	47835638	.	G	T	2	5	7	0	0	7	0	0
13	47838024	.	G	A	1	9	10	0	0	10	0	0
13	47838052	.	G	A	2	7	9	0	4	13	0	0
13	47838650	.	G	C	2	7	9	0	0	9	0	0
13	47839071	.	C	T	5	9	14	0	1	15	0	0
13	47839119	.	A	T	3	14	17	0	0	17	0	0
13	48381134	.	A	G	3	1	4	0	2	6	0	0
13	48533161	.	A	G	1	1	2	0	5	7	0	0
13	48533227	.	T	C	4	1	5	0	1	6	0	0
13	48549008	.	C	T	3	7	10	0	0	10	0	0
13	48748722	.	A	G	1	3	4	0	0	4	0	0
13	48751921	.	A	G	6	4	10	0	0	10	0	0
13	48755122	.	T	C	7	10	17	0	0	17	0	0
13	48758259	.	T	C	1	2	3	0	0	3	0	0
13	48758775	.	T	C	2	0	2	0	2	4	0	0
13	48759272	.	T	C	2	2	4	0	0	4	0	0
13	48760457	.	G	T	2	2	4	0	0	4	0	0
13	48760628	.	C	T	0	2	2	0	1	3	0	0
13	48760634	.	G	T	1	2	3	0	0	3	0	0
13	48766270	.	C	T	8	3	11	0	0	11	0	0
13	49057097	.	A	C	2	0	2	0	2	4	0	0
13	49125243	.	C	T	0	2	2	0	2	4	0	0
13	49153938	.	G	A	4	2	6	0	2	8	0	0
13	49153953	.	A	G	5	4	9	0	0	9	0	0
13	49154048	.	G	A	12	11	23	0	1	24	0	0
13	49154249	.	C	T	9	2	11	0	0	11	0	0
13	49154257	.	G	A	7	3	10	0	1	11	0	0
13	49154631	.	T	C	15	0	15	0	20	35	0	0
13	49158734	.	G	A	12	5	17	0	0	17	0	0
13	49167185	.	T	G	13	7	20	0	0	20	0	0
13	49167195	.	C	T	12	6	18	0	0	18	0	0
13	49169071	.	A	T	15	5	20	0	2	22	0	0
13	49169121	.	G	C	11	8	19	0	1	20	0	0
13	49169455	.	C	A	2	2	4	0	5	9	0	0
13	49176036	.	T	C	2	3	5	0	0	5	0	0
13	49176294	.	C	T	2	4	6	0	0	6	0	0
13	49443721	.	C	T	28	20	48	0	1	49	0	0
13	49443868	.	T	C	32	2	34	0	26	60	0	0
13	49444090	.	C	T	28	22	50	0	2	52	0	0
13	49444177	.	C	A	1	23	24	0	20	44	0	0
13	49444224	.	G	A	27	12	39	0	2	41	0	0
13	49444446	.	C	A	19	13	32	0	2	35	1	0
13	49543334	.	C	T	2	2	4	0	0	4	0	0
13	49544509	.	C	T	0	2	2	0	2	4	0	0
13	49544560	.	T	A	1	4	5	0	0	5	0	0
13	49544577	.	A	G	1	1	2	0	0	2	0	0
13	49544700	.	T	C	1	3	4	0	0	4	0	0
13	49544833	.	C	T	14	21	35	0	1	36	0	0
13	49544873	.	T	A	16	24	40	0	2	42	0	0
13	49544973	.	G	T	12	16	28	0	0	28	0	0
13	49545039	.	A	G	23	22	45	0	1	46	0	0
13	49583976	.	A	G	24	16	40	0	0	40	0	0
13	49585341	.	T	A	29	17	46	2	2	50	0	0
13	49585344	.	A	T	27	18	45	2	1	48	0	0
13	49585384	.	T	G	9	9	18	1	0	19	0	0
13	49597297	.	C	T	0	9	9	0	7	16	0	0
13	49599521	.	G	A	6	9	15	0	0	15	0	0
13	49605897	.	T	C	0	0	0	0	4	4	0	0
13	49605904	.	A	G	1	3	4	0	0	4	0	0
13	49608888	.	T	C	6	4	10	0	0	10	0	0
13	49609056	.	T	C	5	0	5	0	4	9	0	0
13	49609268	.	C	T	2	4	6	0	3	9	0	0
13	49612336	.	C	T	2	3	5	0	1	6	0	0
13	49633362	.	G	T	3	5	8	0	1	9	0	0
13	49636115	.	G	T	5	5	10	0	0	10	0	0
13	49636240	.	C	T	1	4	5	0	0	5	0	0
13	49638771	.	A	G	2	6	8	0	0	8	0	0
13	49638789	.	A	G	2	5	7	0	1	8	0	0
13	49642805	.	G	T	8	8	16	0	0	16	0	0
13	49660026	.	A	G	2	4	6	0	0	6	0	0
13	49707868	.	A	T	4	3	7	0	0	7	0	0
13	49727448	.	A	G	6	6	12	0	1	13	0	0
13	49727463	.	T	G	8	3	11	0	1	12	0	0
13	49727548	.	A	G	4	2	6	0	1	7	0	0
13	49727550	.	A	G	4	2	6	0	1	7	0	0
13	49765806	.	C	T	1	5	6	0	0	6	0	0
13	49765815	.	G	T	0	3	3	0	2	5	0	0
13	49766268	.	G	A	1	9	10	0	6	16	0	0
13	49767539	.	A	G	11	10	21	0	0	21	0	0
13	49767570	.	G	A	11	11	22	0	1	23	0	0
13	49767736	.	T	G	11	7	18	0	0	18	0	0
13	49767806	.	T	A	5	5	10	0	0	10	0	0
13	49767807	.	G	T	5	5	10	0	0	10	0	0
13	49767953	.	T	A	6	8	14	0	1	15	0	0
13	49768095	.	A	G	13	8	21	0	2	23	0	0
13	49768207	.	C	T	3	5	8	0	1	9	0	0
13	49768401	.	C	T	14	10	24	0	0	24	0	0
13	49768402	.	A	C	13	9	22	0	2	24	0	0
13	49768592	.	A	T	9	4	13	0	1	14	0	0
13	49769060	.	C	T	9	7	16	0	0	16	0	0
13	49769141	.	G	C	5	5	10	1	0	11	0	0
13	49769274	.	G	A	0	2	2	0	2	4	0	0
13	49774860	.	A	C	1	0	1	0	2	3	0	0
13	49774893	.	G	T	1	5	6	0	0	6	0	0
13	49775018	.	T	G	8	4	12	0	0	12	0	0
13	49785412	.	C	T	5	13	18	0	0	18	0	0
13	49785417	.	T	C	4	14	18	0	0	18	0	0
13	49785455	.	C	G	6	11	17	0	2	19	0	0
13	49785456	.	A	G	6	13	19	0	0	19	0	0
13	49786114	.	A	G	8	11	19	0	0	19	0	0
13	49788102	.	A	T	13	6	19	0	1	21	1	0
13	49802010	.	C	A	5	5	10	0	0	10	0	0
13	49802025	.	T	G	6	7	13	0	0	13	0	0
13	49818982	.	A	G	11	10	21	0	1	22	0	0
13	49819001	.	C	A	1	11	12	0	9	21	0	0
13	49819019	.	A	G	11	14	25	0	0	25	0	0
13	49898458	.	G	T	2	6	8	0	0	8	0	0
13	49904236	.	T	C	7	8	15	0	0	15	0	0
13	49907480	.	A	G	4	19	23	0	0	23	0	0
13	49907549	.	C	T	3	7	10	0	0	10	0	0
13	49915484	.	C	A	7	3	10	0	0	10	0	0
13	49915580	.	A	G	5	9	14	0	0	14	0	0
13	49917748	.	T	C	4	6	10	0	0	10	0	0
13	49922870	.	G	T	7	2	9	0	1	10	0	0
13	49922904	.	A	G	4	2	6	0	0	6	0	0
13	49922970	.	C	T	0	3	3	0	5	8	0	0
13	49923176	.	T	C	7	4	11	0	0	11	0	0
13	49923570	.	G	T	9	3	12	0	0	12	0	0
13	49923678	.	C	A	4	11	15	0	0	15	0	0
13	49931689	.	C	T	6	3	9	0	1	10	0	0
13	50169004	.	C	T	12	4	16	2	3	21	0	0
13	50670846	.	A	T	8	8	16	0	1	17	0	0
13	50670911	.	G	C	12	8	20	1	1	22	0	0
13	50672297	.	T	C	3	0	3	0	11	14	0	0
13	50712066	.	G	T	3	7	10	0	0	10	0	0
13	50712093	.	T	C	3	4	7	0	0	7	0	0
13	50714876	.	T	G	3	3	6	0	1	7	0	0
13	50714961	.	C	T	1	3	4	0	0	4	0	0
13	50715121	.	A	G	3	5	8	0	0	8	0	0
13	50715123	.	T	A	3	5	8	0	0	8	0	0
13	50715205	.	A	G	4	7	11	0	0	11	0	0
13	50715615	.	T	C	2	0	2	3	6	11	0	0
13	50730444	.	C	T	0	4	4	0	2	6	0	0
13	50731324	.	C	T	4	3	7	0	0	7	0	0
13	51140665	.	A	G	27	10	37	0	0	37	0	0
13	51140782	.	A	G	14	22	36	0	3	39	0	0
13	51145614	.	T	G	25	19	44	0	0	44	0	0
13	51147152	.	G	A	24	13	37	0	1	38	0	0
13	51147164	.	A	G	23	11	34	0	2	36	0	0
13	51147736	.	G	A	18	9	27	0	2	29	0	0
13	51147778	.	A	G	17	11	28	0	1	29	0	0
13	51162561	.	A	G	18	11	29	0	1	30	0	0
13	51162579	.	T	G	16	9	25	0	4	29	0	0
13	51169874	.	C	G	16	8	24	1	2	27	0	0
13	51503093	.	T	A	4	4	8	0	0	8	0	0
13	51503141	.	G	A	2	4	6	0	0	6	0	0
13	51503524	.	G	A	3	6	9	0	1	10	0	0
13	51520086	.	C	T	2	3	5	0	0	5	0	0
13	51520197	.	G	A	3	3	6	0	0	6	0	0
13	51526839	.	G	A	3	4	7	0	1	8	0	0
13	51580096	.	G	T	0	15	15	0	7	22	0	0
13	51580105	.	T	C	7	14	21	0	0	21	0	0
13	51582507	.	T	G	3	4	7	0	0	7	0	0
13	51583019	.	C	A	8	9	17	0	0	17	0	0
13	51583043	.	T	C	7	8	15	0	1	16	0	0
13	51583130	.	A	G	4	2	6	0	13	19	0	0
13	51719661	.	G	C	13	11	24	0	0	24	0	0
13	51719767	.	A	C	9	16	25	0	0	25	0	0
13	51719850	.	G	A	2	7	9	0	8	17	0	0
13	51720057	.	T	C	10	6	16	0	0	16	0	0
13	51720126	.	C	A	11	9	20	0	0	20	0	0
13	51720291	.	A	G	11	0	11	0	8	19	0	0
13	51720993	.	G	C	1	7	8	0	17	25	0	0
13	51721143	.	T	C	14	9	23	0	0	23	0	0
13	51728520	.	G	A	7	4	11	0	2	13	0	0
13	51728597	.	A	G	9	0	9	0	6	15	0	0
13	51728782	.	C	G	6	12	18	0	0	18	0	0
13	51728902	.	A	C	14	9	23	0	0	23	0	0
13	51728937	.	A	G	16	8	24	0	0	24	0	0
13	51853950	.	A	T	3	2	5	0	0	5	0	0
13	51854014	.	T	C	7	2	9	0	0	9	0	0
13	51872081	.	C	T	2	3	5	0	1	6	0	0
13	51881119	.	G	A	1	2	3	0	2	5	0	0
13	51881185	.	T	C	1	4	5	0	0	5	0	0
13	51893777	.	A	T	4	8	12	0	1	13	0	0
13	51893807	.	C	T	6	10	16	0	0	16	0	0
13	51894204	.	C	T	16	14	30	3	1	34	0	0
13	51894215	.	A	G	17	15	32	3	1	36	0	0
13	51894264	.	C	T	3	20	23	0	22	45	0	0
13	51898991	.	C	G	19	12	31	0	2	33	0	0
13	51899138	.	C	T	2	20	22	0	17	39	0	0
13	51899707	.	C	T	25	17	42	0	1	43	0	0
13	51903040	.	A	G	10	7	17	20	0	37	0	0
13	51921994	.	G	A	5	4	9	0	0	9	0	0
13	51922014	.	C	T	1	3	4	0	3	7	0	0
13	51950882	.	G	A	1	5	6	0	0	6	0	0
13	51956414	.	T	C	5	7	12	0	1	13	0	0
13	51956418	.	G	A	8	7	15	0	0	15	0	0
13	51961780	.	T	C	10	9	19	0	0	19	0	0
13	51962017	.	G	T	6	6	12	0	1	13	0	0
13	51962211	.	C	T	9	7	16	0	1	17	0	0
13	51962407	.	C	T	4	5	9	0	3	12	0	0
13	51962413	.	C	T	3	3	6	0	4	10	0	0
13	51962754	.	G	A	1	9	10	0	10	21	1	0
13	51962802	.	G	A	10	9	19	0	3	22	0	0
13	51962836	.	A	G	3	2	5	0	2	9	2	0
13	51962892	.	C	A	8	14	22	0	0	22	0	0
13	51962961	.	C	G	11	6	17	0	2	19	0	0
13	51963030	.	A	G	3	0	3	1	2	6	0	0
13	51963383	.	C	T	5	4	9	0	2	11	0	0
13	51967259	.	G	A	1	4	5	0	0	5	0	0
13	51969156	.	G	A	4	3	7	0	0	7	0	0
13	51969313	.	C	T	1	5	6	0	1	7	0	0
13	51972910	.	C	T	0	5	5	0	1	6	0	0
13	52013066	.	A	G	1	0	1	0	2	3	0	0
13	52013739	.	T	C	4	3	7	0	0	7	0	0
13	52013766	.	C	T	4	2	6	0	0	6	0	0
13	52014050	.	C	T	5	3	8	1	0	9	0	0
13	52014156	.	A	C	6	2	8	0	0	8	0	0
14	543346	.	C	A	5	5	10	0	0	10	0	0
14	543585	.	G	A	3	3	6	0	0	6	0	0
14	547023	.	T	C	1	0	1	0	3	4	0	0
14	547170	.	A	G	3	2	5	0	0	5	0	0
14	547374	.	G	C	3	3	6	0	1	7	0	0
14	548928	.	C	T	2	3	5	0	0	5	0	0
14	557740	.	C	T	4	4	8	0	0	8	0	0
14	557761	.	A	G	3	4	7	0	2	9	0	0
14	565193	.	T	G	6	4	10	0	0	10	0	0
14	565350	.	G	C	6	5	11	3	1	15	0	0
14	565354	.	T	A	4	5	9	3	0	12	0	0
14	606255	.	A	G	9	10	19	0	2	21	0	0
14	616648	.	G	A	11	5	16	0	0	16	0	0
14	620200	.	C	A	5	6	11	0	0	11	0	0
14	684179	.	G	A	18	17	35	0	0	35	0	0
14	699496	.	A	C	1	2	3	0	0	3	0	0
14	712170	.	T	G	1	2	3	0	1	4	0	0
14	712194	.	G	A	2	5	7	0	1	8	0	0
14	712205	.	G	C	0	6	6	0	2	8	0	0
14	715123	.	G	C	7	4	11	0	0	11	0	0
14	715126	.	T	C	7	4	11	0	0	11	0	0
14	715201	.	C	T	9	6	15	0	0	15	0	0
14	715207	.	A	G	10	0	10	0	6	16	0	0
14	717845	.	G	A	1	5	6	0	6	12	0	0
14	717927	.	G	A	5	4	9	0	0	9	0	0
14	718194	.	A	C	4	5	9	0	0	9	0	0
14	719447	.	A	G	8	8	16	0	0	16	0	0
14	719926	.	A	G	5	10	15	0	1	16	0	0
14	723539	.	T	C	8	11	19	0	0	19	0	0
14	723542	.	T	C	7	10	17	0	2	19	0	0
14	790989	.	C	T	4	4	8	0	0	8	0	0
14	791067	.	C	G	10	1	11	0	3	14	0	0
14	791636	.	T	C	4	4	8	0	0	8	0	0
14	791696	.	T	A	2	2	4	0	0	4	0	0
14	791707	.	T	A	3	1	4	0	0	4	0	0
14	791913	.	A	T	4	3	7	0	0	7	0	0
14	791989	.	G	T	2	4	6	0	0	6	0	0
14	792133	.	C	A	3	3	6	0	0	6	0	0
14	792142	.	T	C	2	1	3	0	1	4	0	0
14	792173	.	C	A	3	4	7	0	0	7	0	0
14	792536	.	A	C	4	3	7	0	0	7	0	0
14	863175	.	A	T	4	2	6	0	1	7	0	0
14	863418	.	T	A	1	2	3	0	0	3	0	0
14	863515	.	T	C	2	0	2	0	3	5	0	0
14	863767	.	A	G	11	4	15	0	0	15	0	0
14	863807	.	A	T	10	9	19	0	4	23	0	0
14	863868	.	G	T	11	14	25	0	0	25	0	0
14	863949	.	T	C	9	12	21	0	1	22	0	0
14	868838	.	G	A	12	17	29	0	0	29	0	0
14	868855	.	A	G	10	16	26	0	0	26	0	0
14	912754	.	C	T	1	2	3	0	0	3	0	0
14	912775	.	G	A	1	2	3	0	0	3	0	0
14	914602	.	G	C	3	2	5	0	0	5	0	0
14	937399	.	A	T	3	1	4	0	1	5	0	0
14	937768	.	G	A	1	2	3	0	0	3	0	0
14	937849	.	A	C	2	6	8	0	0	8	0	0
14	938290	.	C	A	2	2	4	0	0	4	0	0
14	938292	.	A	G	2	2	4	0	0	4	0	0
14	938503	.	T	C	1	3	4	1	0	5	0	0
14	938531	.	A	C	2	2	4	1	0	5	0	0
14	939505	.	A	G	1	2	3	0	0	3	0	0
14	940499	.	T	C	1	2	3	0	0	3	0	0
14	942337	.	T	C	2	2	4	0	0	4	0	0
14	942378	.	G	A	2	4	6	0	1	7	0	0
14	944384	.	G	A	1	2	3	0	0	3	0	0
14	944393	.	C	G	0	2	2	0	1	3	0	0
14	947412	.	T	C	2	3	5	0	0	5	0	0
14	947870	.	A	T	1	2	3	0	0	3	0	0
14	949842	.	C	T	1	1	2	0	1	3	0	0
14	974448	.	A	G	1	3	4	0	0	4	0	0
14	974835	.	G	A	1	2	3	0	0	3	0	0
14	974899	.	G	C	2	2	4	0	0	4	0	0
14	975000	.	G	A	1	3	4	0	0	4	0	0
14	989848	.	G	T	2	3	5	0	0	5	0	0
14	994353	.	G	T	1	2	3	1	1	5	0	0
14	994413	.	C	T	5	5	10	0	1	11	0	0
14	994437	.	T	C	6	3	9	0	0	9	0	0
14	997012	.	C	A	3	4	7	0	1	8	0	0
14	997273	.	T	A	4	5	9	0	0	9	0	0
14	997603	.	T	C	2	3	5	0	0	5	0	0
14	997651	.	A	C	2	4	6	0	1	7	0	0
14	997705	.	C	A	2	2	4	0	0	4	0	0
14	997765	.	T	C	3	4	7	0	0	7	0	0
14	997783	.	A	G	3	3	6	0	1	7	0	0
14	997853	.	C	T	2	4	6	0	0	6	0	0
14	1040682	.	G	C	0	2	2	0	2	4	0	0
14	1119141	.	C	T	4	2	6	0	1	7	0	0
14	1119225	.	C	T	10	5	15	0	0	15	0	0
14	1119423	.	A	G	5	4	9	0	3	12	0	0
14	1119432	.	T	C	3	3	6	0	5	11	0	0
14	1119899	.	A	C	1	2	3	0	0	3	0	0
14	1119993	.	T	C	7	7	14	0	1	15	0	0
14	1120017	.	T	C	6	11	17	0	0	17	0	0
14	1120072	.	C	A	4	6	10	0	0	10	0	0
14	1120154	.	T	C	8	4	12	0	0	12	0	0
14	1120178	.	C	T	3	5	8	0	0	8	0	0
14	1120196	.	T	G	4	0	4	0	5	9	0	0
14	1120236	.	C	T	8	3	11	0	0	11	0	0
14	1120598	.	T	C	3	3	6	0	0	6	0	0
14	1121029	.	A	G	4	3	7	0	0	7	0	0
14	1121068	.	C	T	5	5	10	0	0	10	0	0
14	1121297	.	T	G	1	2	3	0	0	3	0	0
14	1121303	.	G	C	1	1	2	0	0	2	0	0
14	1124602	.	C	G	6	8	14	0	0	14	0	0
14	1127693	.	G	A	5	9	14	0	1	15	0	0
14	1128800	.	C	G	6	8	14	0	1	15	0	0
14	1128836	.	A	C	6	6	12	0	0	12	0	0
14	1138611	.	C	A	9	12	21	0	1	22	0	0
14	1138626	.	G	A	2	9	11	0	11	22	0	0
14	1139509	.	C	T	11	11	22	0	0	22	0	0
14	1142796	.	G	A	2	6	8	0	11	19	0	0
14	1145203	.	C	A	7	11	18	0	0	18	0	0
14	1146630	.	G	A	7	6	13	0	0	13	0	0
14	1150594	.	A	G	13	11	24	0	2	26	0	0
14	1152544	.	C	A	18	10	28	0	0	28	0	0
14	1153665	.	T	C	9	8	17	0	1	18	0	0
14	1153830	.	T	A	14	7	21	0	0	21	0	0
14	1159869	.	A	G	10	0	10	0	15	25	0	0
14	1160333	.	C	T	13	7	20	0	0	20	0	0
14	1160427	.	T	G	15	8	23	0	0	23	0	0
14	1171023	.	T	C	12	13	25	0	0	25	0	0
14	1171052	.	T	A	16	11	27	0	1	28	0	0
14	1171081	.	T	A	13	7	20	0	1	21	0	0
14	1192448	.	G	A	5	6	11	0	0	11	0	0
14	1192681	.	C	T	5	8	13	0	0	13	0	0
14	1194090	.	C	T	0	12	12	0	6	18	0	0
14	1194133	.	G	A	7	10	17	0	0	17	0	0
14	1194154	.	C	T	0	9	9	0	7	16	0	0
14	1196568	.	C	G	6	6	12	0	0	12	0	0
14	1196658	.	T	G	3	5	8	0	1	9	0	0
14	1200460	.	T	G	3	7	10	0	0	10	0	0
14	1200545	.	G	T	10	9	19	0	1	20	0	0
14	1200615	.	A	G	4	3	7	0	0	7	0	0
14	1200676	.	C	T	0	5	5	0	3	8	0	0
14	1200842	.	A	C	5	4	9	0	1	10	0	0
14	1203713	.	A	G	18	15	33	0	6	39	0	0
14	1203770	.	G	T	22	23	45	0	0	45	0	0
14	1204197	.	A	T	21	17	38	0	2	40	0	0
14	1204299	.	G	A	13	17	30	0	0	30	0	0
14	1225227	.	C	T	1	5	6	0	10	16	0	0
14	1719577	.	A	G	4	2	6	0	0	6	0	0
14	1889644	.	T	C	17	6	23	13	1	37	0	0
14	1947457	.	G	A	5	3	8	1	0	9	0	0
14	1948853	.	T	A	3	2	5	0	0	5	0	0
14	1948855	.	A	G	3	2	5	0	0	5	0	0
14	1952803	.	C	T	1	2	3	12	0	15	0	0
14	1956470	.	C	T	8	3	11	0	0	11	0	0
14	2003514	.	A	G	3	3	6	0	0	6	0	0
14	2031634	.	G	A	1	3	4	0	0	4	0	0
14	2201907	.	T	C	1	2	3	1	1	5	0	0
14	2203058	.	G	T	3	4	7	0	0	7	0	0
14	2203092	.	T	C	1	7	8	0	0	8	0	0
14	2205747	.	A	G	1	6	7	0	0	7	0	0
14	2206257	.	G	A	2	4	6	3	0	9	0	0
14	2206272	.	G	A	3	4	7	3	1	11	0	0
14	2206317	.	T	C	3	4	7	2	0	9	0	0
14	2212373	.	A	G	1	2	3	0	0	3	0	0
14	2220101	.	C	T	1	6	7	0	0	7	0	0
14	2262893	.	A	G	1	3	4	2	0	6	0	0
14	2316992	.	G	A	1	2	3	0	0	3	0	0
14	2351565	.	A	T	11	12	23	4	2	29	0	0
14	2351566	.	G	T	12	13	25	4	0	29	0	0
14	2351848	.	A	G	9	4	13	0	0	13	0	0
14	2352280	.	T	G	10	5	15	2	0	17	0	0
14	2360116	.	T	A	9	17	26	2	2	30	0	0
14	3187115	.	G	A	1	7	8	0	0	8	0	0
14	3451164	.	C	A	11	6	17	0	0	17	0	0
14	3451169	.	T	C	10	3	13	0	2	15	0	0
14	3576057	.	T	C	17	2	19	5	2	33	7	0
14	3576058	.	A	T	13	14	27	5	3	35	0	0
14	4047853	.	T	G	3	5	8	0	0	8	0	0
14	4183038	.	A	G	3	2	5	0	0	5	0	0
14	4183711	.	A	G	3	0	3	0	2	5	0	0
14	4183724	.	A	G	3	2	5	0	0	5	0	0
14	4183908	.	A	G	7	3	10	0	1	11	0	0
14	4290889	.	A	G	5	2	7	0	0	7	0	0
14	4290895	.	A	G	6	2	8	0	0	8	0	0
14	4813124	.	A	G	5	2	7	0	1	8	0	0
14	4813280	.	A	G	1	0	1	0	2	3	0	0
14	6000428	.	A	G	6	2	8	0	0	8	0	0
14	6003665	.	A	G	3	4	7	0	0	7	0	0
14	6332501	.	T	C	6	2	8	0	0	8	0	0
14	6332869	.	A	C	11	3	14	0	0	14	0	0
14	6332872	.	T	C	8	4	12	0	2	14	0	0
14	6333022	.	T	C	7	4	11	2	2	15	0	0
14	6336174	.	C	T	1	5	6	0	1	7	0	0
14	6341993	.	C	T	6	4	10	0	0	10	0	0
14	6342201	.	T	C	5	5	10	0	0	10	0	0
14	6342357	.	T	A	2	2	4	0	1	5	0	0
14	6546928	.	C	T	1	7	8	0	0	8	0	0
14	6624558	.	A	G	20	1	21	0	6	27	0	0
14	6624569	.	A	G	20	4	24	0	1	25	0	0
14	6624621	.	A	G	11	19	30	1	3	34	0	0
14	6625521	.	G	C	22	32	54	1	4	59	0	0
14	6625794	.	A	G	7	14	21	0	2	23	0	0
14	6625805	.	A	G	24	8	32	0	3	35	0	0
14	7171828	.	T	C	13	3	16	0	0	16	0	0
14	7172126	.	A	T	1	4	5	1	0	6	0	0
14	7916052	.	A	G	5	4	9	0	0	9	0	0
14	7916066	.	A	G	2	3	5	0	1	6	0	0
14	8264834	.	G	A	7	2	9	0	0	9	0	0
14	8495668	.	A	T	2	6	8	0	0	8	0	0
14	8496257	.	A	G	2	3	5	1	0	6	0	0
14	8569554	.	A	G	5	3	8	0	0	8	0	0
14	8569681	.	A	G	4	3	7	0	0	7	0	0
14	9077530	.	T	A	3	2	5	0	0	5	0	0
14	9593209	.	T	A	1	2	3	0	0	3	0	0
14	9595330	.	T	C	8	11	19	0	2	22	1	0
14	9595373	.	T	C	16	7	23	0	1	24	0	0
14	9595450	.	T	C	2	9	11	0	1	12	0	0
14	9595520	.	T	C	11	4	15	0	2	17	0	0
14	9595524	.	T	C	2	14	16	0	0	16	0	0
14	10338670	.	G	A	2	2	4	0	1	5	0	0
14	10752154	.	T	C	1	1	2	0	1	3	0	0
14	11266531	.	A	T	1	9	10	0	1	11	0	0
14	11388897	.	G	T	2	3	5	0	0	5	0	0
14	12605900	.	T	C	19	6	25	0	0	25	0	0
14	14594942	.	A	G	4	3	7	0	0	7	0	0
14	14594966	.	A	G	5	0	5	0	3	8	0	0
14	14741934	.	G	A	18	4	22	0	5	27	0	0
14	15663175	.	T	C	3	3	6	0	0	6	0	0
14	15972242	.	T	C	1	2	3	0	1	4	0	0
14	15972277	.	T	C	2	0	2	0	2	4	0	0
14	15972303	.	G	A	3	3	6	0	0	6	0	0
14	15972419	.	A	G	2	5	7	0	1	8	0	0
14	15972435	.	C	A	5	8	13	0	0	13	0	0
14	15972549	.	T	C	3	2	5	0	2	7	0	0
14	15972596	.	T	C	2	0	2	0	4	6	0	0
14	15972660	.	C	G	6	3	9	0	0	9	0	0
14	15972666	.	G	A	4	2	6	0	1	7	0	0
14	15973819	.	A	T	3	3	6	0	0	6	0	0
14	15973844	.	G	A	6	2	8	0	0	8	0	0
14	15973919	.	A	G	6	4	10	0	0	10	0	0
14	15974065	.	C	A	1	5	6	0	0	6	0	0
14	15974069	.	A	T	1	5	6	0	0	6	0	0
14	15974188	.	T	A	3	3	6	0	0	7	1	0
14	15974370	.	T	C	6	7	13	0	0	13	0	0
14	15974448	.	A	G	2	2	4	0	0	4	0	0
14	15974508	.	A	G	1	2	3	0	0	3	0	0
14	15974580	.	A	G	4	3	7	0	0	7	0	0
14	15974613	.	G	A	2	3	5	0	0	5	0	0
14	15983585	.	T	C	4	3	7	0	0	7	0	0
14	15983590	.	T	C	4	3	7	0	0	7	0	0
14	16042530	.	C	A	2	5	7	0	1	8	0	0
14	16044274	.	A	C	3	5	8	0	0	8	0	0
14	16044638	.	G	A	1	5	6	0	5	11	0	0
14	16069264	.	A	C	5	5	10	0	1	11	0	0
14	16069354	.	C	T	2	5	7	0	1	8	0	0
14	16069404	.	G	A	2	4	6	0	0	6	0	0
14	16069405	.	A	G	2	4	6	0	0	6	0	0
14	16084339	.	C	T	10	14	24	0	1	25	0	0
14	16090764	.	T	C	11	11	22	0	0	22	0	0
14	16090800	.	T	A	8	10	18	0	0	18	0	0
14	16090828	.	A	T	7	10	17	0	0	17	0	0
14	16090897	.	C	T	11	8	19	0	0	19	0	0
14	16090939	.	A	C	8	12	20	0	0	20	0	0
14	16091563	.	C	T	3	11	14	0	1	15	0	0
14	16091586	.	T	A	5	9	14	0	0	14	0	0
14	16093983	.	G	A	24	18	42	0	0	42	0	0
14	16095683	.	A	G	19	10	29	0	1	30	0	0
14	16097204	.	T	A	14	9	23	0	0	23	0	0
14	16115278	.	G	A	14	14	28	0	0	28	0	0
14	16115353	.	A	G	15	14	29	0	0	29	0	0
14	16122866	.	T	C	17	12	29	0	1	30	0	0
14	16122962	.	G	A	21	19	40	0	1	41	0	0
14	16123055	.	G	C	2	27	29	0	16	45	0	0
14	16127308	.	C	T	5	4	9	0	1	10	0	0
14	16130167	.	C	G	17	16	33	0	0	33	0	0
14	16132423	.	T	G	8	11	19	0	0	19	0	0
14	16145112	.	T	A	5	4	9	0	0	9	0	0
14	16178079	.	A	G	3	2	5	0	0	5	0	0
14	16208059	.	T	G	3	5	8	0	0	8	0	0
14	16288166	.	A	C	7	17	24	0	0	24	0	0
14	16288236	.	T	G	9	8	17	0	2	19	0	0
14	16296383	.	A	G	10	1	11	0	10	21	0	0
14	16384110	.	T	C	2	2	4	0	0	4	0	0
14	16402450	.	G	A	1	2	3	0	0	3	0	0
14	16402489	.	T	C	1	0	1	0	3	4	0	0
14	16432788	.	C	T	5	2	7	0	0	7	0	0
14	16433098	.	A	T	18	17	35	0	1	36	0	0
14	16433473	.	C	A	0	21	21	0	21	42	0	0
14	16433496	.	A	G	22	19	41	0	2	43	0	0
14	16433623	.	T	G	9	3	12	2	0	14	0	0
14	16433943	.	C	T	1	17	18	0	15	33	0	0
14	16434131	.	G	C	21	18	39	0	2	41	0	0
14	16434179	.	T	C	26	13	39	2	2	43	0	0
14	16434474	.	T	C	12	0	12	0	9	21	0	0
14	16434791	.	A	G	18	24	42	0	0	42	0	0
14	16434981	.	T	C	23	1	24	0	36	60	0	0
14	16434990	.	T	A	28	18	46	0	16	62	0	0
14	16448208	.	A	T	23	20	43	0	0	43	0	0
14	16456712	.	C	T	15	21	36	0	2	38	0	0
14	16484069	.	C	T	7	3	10	0	0	10	0	0
14	16484429	.	C	T	4	5	9	0	1	10	0	0
14	16484558	.	A	T	6	4	10	0	0	10	0	0
14	16484633	.	G	T	5	6	11	0	0	11	0	0
14	16484713	.	A	G	4	7	11	0	1	12	0	0
14	16485222	.	C	T	2	5	7	0	7	14	0	0
14	16606655	.	C	T	2	6	8	0	6	14	0	0
14	16618118	.	G	A	6	10	16	0	1	17	0	0
14	16754120	.	C	A	9	3	12	0	1	13	0	0
14	16754192	.	A	C	4	9	13	0	0	13	0	0
14	16754243	.	G	A	2	11	13	0	1	14	0	0
14	16766053	.	C	T	4	7	11	0	0	11	0	0
14	16769067	.	A	G	18	17	35	0	1	36	0	0
14	16769109	.	T	C	12	16	28	0	2	30	0	0
14	16769189	.	C	T	15	11	26	0	2	28	0	0
14	16769246	.	C	T	17	21	38	0	3	41	0	0
14	16769478	.	A	G	25	4	29	0	0	29	0	0
14	16769515	.	G	A	22	13	35	0	2	37	0	0
14	16769550	.	A	G	22	0	22	0	13	35	0	0
14	16770260	.	C	T	12	12	24	0	1	25	0	0
14	16770338	.	T	A	16	15	31	0	1	32	0	0
14	16770646	.	C	A	16	19	35	0	1	36	0	0
14	16770847	.	C	T	18	18	36	0	0	36	0	0
14	16770989	.	A	G	11	0	11	2	10	23	0	0
14	16771194	.	A	T	6	8	14	0	0	14	0	0
14	16771265	.	A	T	11	8	19	0	1	20	0	0
14	16777708	.	T	C	2	3	5	0	1	6	0	0
14	16777743	.	T	G	2	4	6	0	0	6	0	0
14	16778080	.	C	T	0	5	5	0	8	13	0	0
14	16790506	.	T	C	3	3	6	0	0	6	0	0
14	16790722	.	A	T	5	3	8	0	0	8	0	0
14	16796249	.	T	A	2	2	4	0	0	4	0	0
14	16799473	.	T	A	2	3	5	0	0	5	0	0
14	16801669	.	C	T	2	3	5	0	0	5	0	0
14	16810447	.	G	C	2	2	4	0	1	5	0	0
14	16813863	.	G	A	16	9	25	0	2	27	0	0
14	16949354	.	A	G	9	0	9	0	7	16	0	0
14	16949357	.	C	T	10	5	15	0	1	16	0	0
14	16968227	.	T	C	6	6	12	0	1	13	0	0
14	16968260	.	C	T	8	9	17	0	0	17	0	0
14	16996870	.	G	A	2	9	11	0	3	14	0	0
14	16996916	.	G	A	6	9	15	0	0	15	0	0
14	16997008	.	G	A	8	10	18	0	0	18	0	0
14	17003570	.	G	A	0	6	6	0	5	11	0	0
14	17003771	.	C	A	8	7	15	0	0	15	0	0
14	17025080	.	A	G	12	0	12	0	11	23	0	0
14	17025109	.	A	T	14	11	25	0	1	26	0	0
14	17025151	.	T	A	14	11	25	0	0	25	0	0
14	17025200	.	G	A	9	3	12	0	0	12	0	0
14	17025215	.	T	C	7	2	9	0	0	9	0	0
14	17025521	.	C	A	4	9	13	0	0	13	0	0
14	17025524	.	T	A	4	10	14	0	0	14	0	0
14	17025751	.	T	A	8	4	12	0	1	13	0	0
14	17025752	.	T	C	9	3	12	0	1	13	0	0
14	17025807	.	T	C	6	7	13	0	1	14	0	0
14	17025819	.	C	T	8	6	14	0	0	14	0	0
14	17025849	.	A	G	10	10	20	0	0	20	0	0
14	17026100	.	T	A	10	6	16	0	0	16	0	0
14	17026488	.	G	A	8	7	15	0	0	15	0	0
14	17026572	.	T	G	15	9	24	0	0	24	0	0
14	17026724	.	T	C	13	20	33	0	1	34	0	0
14	17026840	.	T	C	1	5	6	0	0	6	0	0
14	17026881	.	G	T	2	4	6	0	0	6	0	0
14	17027207	.	G	A	6	5	11	0	0	11	0	0
14	17088611	.	A	C	4	1	5	0	1	6	0	0
14	17161264	.	G	A	1	2	3	0	1	4	0	0
14	17197240	.	A	C	10	10	20	0	1	21	0	0
14	17199990	.	A	G	20	19	39	0	0	39	0	0
14	17200351	.	A	T	8	9	17	0	0	17	0	0
14	17200407	.	C	A	12	5	17	0	1	18	0	0
14	17200653	.	A	C	15	7	22	0	2	24	0	0
14	17230387	.	C	T	0	3	3	0	3	6	0	0
14	17230601	.	A	G	7	6	13	0	0	13	0	0
14	17233598	.	C	A	19	9	28	0	1	29	0	0
14	17239275	.	C	T	2	8	10	0	8	18	0	0
14	17240587	.	A	G	8	5	13	0	0	13	0	0
14	17266010	.	C	T	2	16	18	0	11	29	0	0
14	17275648	.	G	A	6	4	10	0	0	10	0	0
14	17275708	.	C	G	6	6	12	0	0	12	0	0
14	17278972	.	C	T	6	9	15	0	0	15	0	0
14	17279005	.	T	C	7	6	13	0	1	14	0	0
14	17279197	.	G	A	4	8	12	0	1	13	0	0
14	17279212	.	C	T	6	6	12	0	1	13	0	0
14	17279305	.	T	C	8	6	14	0	1	15	0	0
14	17281761	.	A	G	9	8	17	0	0	17	0	0
14	17282061	.	C	T	5	4	9	0	1	10	0	0
14	17282095	.	C	G	7	3	10	0	1	11	0	0
14	17282100	.	C	T	1	3	4	0	6	10	0	0
14	17282139	.	C	T	10	4	14	0	1	15	0	0
14	17305587	.	G	A	7	11	18	0	0	18	0	0
14	17305604	.	G	A	5	14	19	0	1	20	0	0
14	17329989	.	G	C	6	3	9	0	0	9	0	0
14	17330048	.	G	A	2	1	3	0	1	4	0	0
14	17347521	.	C	T	2	2	4	0	0	4	0	0
14	17347596	.	A	C	1	2	3	0	0	3	0	0
14	17347597	.	C	T	1	2	3	0	0	3	0	0
14	17347911	.	T	C	2	4	6	0	0	6	0	0
14	17349307	.	C	T	6	2	8	0	2	10	0	0
14	17349409	.	C	T	10	3	13	0	0	13	0	0
14	17349420	.	G	A	7	3	10	0	1	11	0	0
14	17349444	.	T	G	8	4	12	0	0	12	0	0
14	17349639	.	T	C	4	3	7	0	0	7	0	0
14	17349789	.	G	A	5	2	7	0	1	8	0	0
14	17443283	.	C	T	2	2	4	0	0	4	0	0
14	17568099	.	A	G	7	7	14	0	0	14	0	0
14	17572743	.	T	C	11	11	22	0	0	22	0	0
14	17575548	.	A	G	7	8	15	0	0	15	0	0
14	17575607	.	G	T	9	5	14	0	0	14	0	0
14	17575868	.	G	A	10	12	22	0	0	22	0	0
14	17575877	.	G	A	13	4	17	0	3	20	0	0
14	17580685	.	G	A	10	9	19	0	1	20	0	0
14	17580922	.	C	A	31	19	50	0	0	50	0	0
14	17581084	.	A	T	24	17	41	0	0	41	0	0
14	17581214	.	A	T	34	22	56	1	0	58	1	0
14	17586693	.	G	A	18	14	32	0	2	34	0	0
14	17588131	.	G	T	15	12	27	0	3	30	0	0
14	17593429	.	T	C	5	6	11	0	0	11	0	0
14	17593444	.	G	T	4	7	11	0	0	11	0	0
14	17593490	.	A	G	4	4	8	0	0	8	0	0
14	17593554	.	A	T	3	3	6	0	0	6	0	0
14	17593720	.	C	T	10	11	21	0	6	27	0	0
14	17593767	.	A	T	14	9	23	0	1	24	0	0
14	17593783	.	T	A	17	12	29	0	0	29	0	0
14	17593823	.	A	T	13	10	23	0	0	23	0	0
14	17593992	.	T	A	8	6	14	0	1	15	0	0
14	17594137	.	G	A	3	5	8	0	0	8	0	0
14	17594185	.	A	G	1	3	4	0	1	5	0	0
14	17594323	.	A	T	1	2	3	0	0	3	0	0
14	17594527	.	A	G	5	8	13	0	0	13	0	0
14	17594734	.	A	T	4	9	13	0	0	13	0	0
14	17595121	.	G	A	6	3	9	0	2	11	0	0
14	17595156	.	A	C	4	0	4	0	5	9	0	0
14	17595460	.	T	A	6	6	12	0	0	12	0	0
14	17595539	.	T	C	10	13	23	0	0	23	0	0
14	17596002	.	T	A	3	2	5	0	0	5	0	0
14	17596070	.	G	T	4	2	6	0	1	7	0	0
14	17596597	.	G	A	7	10	17	0	0	17	0	0
14	18667852	.	T	C	15	15	30	0	2	32	0	0
14	18668731	.	A	G	3	6	9	0	0	9	0	0
14	18669481	.	C	A	23	14	37	0	0	37	0	0
14	18670446	.	C	T	15	16	31	0	0	31	0	0
14	18670582	.	T	A	15	17	32	0	3	35	0	0
14	18670665	.	A	G	12	9	21	0	2	23	0	0
14	18671011	.	A	T	11	15	26	0	0	26	0	0
14	18672491	.	C	T	12	10	22	1	2	25	0	0
14	21198364	.	A	C	4	2	6	0	18	24	0	0
14	21198366	.	A	C	8	0	8	0	18	26	0	0
14	21750970	.	C	T	1	3	4	0	0	4	0	0
14	21761334	.	T	C	4	5	9	0	1	10	0	0
14	21766410	.	C	T	8	3	11	0	2	13	0	0
14	21766428	.	A	G	11	5	16	0	1	17	0	0
14	21768233	.	A	G	4	5	9	0	2	11	0	0
14	21768244	.	G	A	1	5	6	0	7	13	0	0
14	21768418	.	G	A	3	4	7	0	0	7	0	0
14	21770666	.	C	G	8	5	13	0	1	14	0	0
14	21770708	.	A	G	5	0	5	0	6	11	0	0
14	21771915	.	G	A	7	4	11	0	1	12	0	0
14	21772267	.	T	C	14	6	20	0	1	21	0	0
14	21772385	.	T	C	8	8	16	0	0	16	0	0
14	21772412	.	C	T	8	8	16	0	0	16	0	0
14	21772553	.	C	T	14	13	27	0	0	27	0	0
14	21772594	.	A	G	7	5	12	0	4	16	0	0
14	21772663	.	G	C	14	7	21	0	0	21	0	0
14	21779102	.	C	T	14	9	23	0	0	23	0	0
14	21779241	.	G	A	11	11	22	0	1	23	0	0
14	21779300	.	T	G	10	9	19	0	0	19	0	0
14	21779518	.	C	T	6	8	14	0	0	14	0	0
14	21779551	.	A	G	8	5	13	0	0	13	0	0
14	21779582	.	T	C	5	2	7	0	0	7	0	0
14	21779617	.	T	C	4	4	8	0	0	8	0	0
14	21779633	.	T	C	3	4	7	0	0	7	0	0
14	21779668	.	T	G	3	4	7	0	0	7	0	0
14	21779678	.	C	T	4	2	6	0	0	6	0	0
14	21779977	.	G	A	6	7	13	0	0	13	0	0
14	21780155	.	C	G	7	5	12	0	0	12	0	0
14	21780206	.	A	G	11	6	17	0	0	17	0	0
14	21780274	.	A	C	12	5	17	0	1	18	0	0
14	21780321	.	T	C	7	5	12	0	0	12	0	0
14	21783361	.	T	G	4	9	13	0	0	13	0	0
14	21797819	.	T	C	9	4	13	0	1	14	0	0
14	21816373	.	C	T	7	17	24	0	1	25	0	0
14	21816388	.	T	C	7	13	20	0	1	21	0	0
14	21816467	.	G	A	9	9	18	0	0	18	0	0
14	21834912	.	C	T	14	14	28	0	0	28	0	0
14	21840858	.	A	G	6	0	6	0	14	20	0	0
14	21842735	.	A	C	24	19	43	0	1	44	0	0
14	21843297	.	G	C	10	22	32	0	1	33	0	0
14	21844187	.	T	A	18	15	33	0	0	33	0	0
14	21844668	.	A	C	15	16	31	0	0	31	0	0
14	21844679	.	T	A	16	14	30	0	1	31	0	0
14	21845129	.	T	A	20	20	40	0	0	40	0	0
14	21845363	.	A	G	23	1	24	0	10	34	0	0
14	21845822	.	A	C	20	22	42	0	2	44	0	0
14	21924299	.	A	G	1	4	5	0	0	5	0	0
14	21924501	.	T	C	2	0	2	0	6	8	0	0
14	21924547	.	G	A	4	4	8	0	0	8	0	0
14	21925565	.	G	A	2	1	3	0	1	4	0	0
14	21925571	.	A	C	2	0	2	0	2	4	0	0
14	21980871	.	C	A	1	4	5	0	0	5	0	0
14	21987518	.	C	T	2	5	7	0	0	7	0	0
14	21987611	.	G	A	5	4	9	0	0	9	0	0
14	21999213	.	A	G	3	6	9	0	0	9	0	0
14	22000647	.	T	C	4	4	8	0	0	8	0	0
14	22102371	.	A	G	13	12	25	0	0	25	0	0
14	22102381	.	A	G	13	14	27	0	0	27	0	0
14	22104906	.	T	C	8	5	13	0	2	15	0	0
14	22104948	.	G	A	14	11	25	0	0	25	0	0
14	22106056	.	T	A	1	3	4	0	0	4	0	0
14	22106082	.	G	C	3	2	5	0	0	5	0	0
14	22106222	.	C	G	6	3	9	0	0	9	0	0
14	22106230	.	A	T	5	3	8	0	0	8	0	0
14	22108215	.	C	T	14	18	32	0	0	32	0	0
14	22132473	.	T	C	22	20	42	0	2	44	0	0
14	22132536	.	A	T	16	25	41	0	1	42	0	0
14	22139254	.	G	A	28	28	56	0	1	57	0	0
14	22139358	.	G	A	23	32	55	0	0	55	0	0
14	22139398	.	T	A	35	23	58	0	2	60	0	0
14	22139668	.	G	A	4	23	27	0	27	54	0	0
14	22140150	.	G	A	3	6	9	0	0	9	0	0
14	22140158	.	T	C	3	5	8	0	0	8	0	0
14	22140417	.	T	C	9	7	16	0	0	16	0	0
14	22151875	.	G	A	10	8	18	0	0	18	0	0
14	22151879	.	C	T	0	9	9	0	9	18	0	0
14	22151913	.	C	T	15	17	32	0	0	32	0	0
14	22172138	.	C	T	17	27	44	0	0	44	0	0
14	22249344	.	G	A	20	19	39	0	2	41	0	0
14	22254184	.	T	C	20	31	51	1	1	53	0	0
14	22272120	.	A	G	24	1	25	1	22	48	0	0
14	22272340	.	G	A	31	23	54	0	1	55	0	0
14	22272351	.	G	A	29	21	50	0	2	52	0	0
14	22272749	.	A	G	20	0	20	0	20	40	0	0
14	22452886	.	A	C	1	3	4	2	0	6	0	0
14	23187210	.	C	T	5	5	10	0	1	11	0	0
14	23405034	.	G	A	3	5	8	0	1	9	0	0
14	23409848	.	C	T	6	9	15	0	0	15	0	0
14	23411712	.	G	T	0	7	7	0	5	12	0	0
14	23455989	.	G	A	6	6	12	0	1	13	0	0
14	23463681	.	G	A	0	7	7	0	5	12	0	0
14	23463708	.	A	G	4	7	11	0	0	11	0	0
14	23463717	.	A	G	3	0	3	0	5	8	0	0
14	23463760	.	C	A	5	4	9	0	0	9	0	0
14	23594151	.	G	A	2	2	4	0	2	6	0	0
14	23596318	.	C	T	2	4	6	0	0	6	0	0
14	23599933	.	A	G	4	3	7	0	0	7	0	0
14	23599978	.	A	G	3	2	5	0	1	6	0	0
14	23600002	.	T	C	3	3	6	0	1	7	0	0
14	23600047	.	C	T	2	3	5	0	0	5	0	0
14	23609472	.	T	C	1	9	10	0	0	10	0	0
14	23609772	.	C	T	2	5	7	0	0	7	0	0
14	23613274	.	G	T	8	5	13	0	0	13	0	0
14	23615471	.	C	T	10	8	18	0	0	18	0	0
14	23615480	.	G	A	9	10	19	0	1	20	0	0
14	23621903	.	C	T	8	9	17	0	0	17	0	0
14	23622190	.	C	T	4	9	13	0	1	14	0	0
14	23653096	.	T	C	10	3	13	0	0	13	0	0
14	23657531	.	G	A	2	6	8	0	4	12	0	0
14	23663911	.	G	C	10	7	17	0	0	17	0	0
14	23664063	.	T	G	12	10	22	0	0	23	1	0
14	23666002	.	C	T	9	7	16	0	0	16	0	0
14	23666227	.	G	A	2	13	15	0	14	29	0	0
14	23666326	.	C	T	10	14	24	0	1	25	0	0
14	23666491	.	G	A	2	10	12	0	6	18	0	0
14	23673373	.	G	A	0	13	13	0	15	28	0	0
14	23675378	.	G	A	9	4	13	0	0	13	0	0
14	23679273	.	A	C	3	0	3	0	3	6	0	0
14	23679369	.	T	C	4	2	6	0	5	11	0	0
14	23679375	.	T	A	5	7	12	0	0	12	0	0
14	23679411	.	C	A	3	5	8	0	1	9	0	0
14	23679564	.	T	C	2	4	6	0	1	7	0	0
14	23679592	.	T	C	3	3	6	0	0	6	0	0
14	23679671	.	G	A	1	2	3	0	0	3	0	0
14	23679674	.	T	G	1	1	2	0	0	2	0	0
14	23680031	.	C	T	2	3	5	0	3	8	0	0
14	23680344	.	T	C	6	5	11	0	1	12	0	0
14	23680405	.	T	C	4	0	4	0	4	8	0	0
14	23684582	.	G	C	2	3	5	0	0	5	0	0
14	23687872	.	G	C	11	16	27	0	1	28	0	0
14	23689974	.	A	T	12	6	18	0	0	18	0	0
14	23693720	.	G	T	9	10	19	0	0	19	0	0
14	23696893	.	A	T	19	16	35	0	0	35	0	0
14	23700121	.	T	C	28	16	44	0	0	44	0	0
14	23700142	.	G	T	26	13	39	0	3	42	0	0
14	23702323	.	G	A	2	15	17	1	15	33	0	0
14	23702703	.	G	A	19	23	42	0	2	44	0	0
14	23704771	.	G	C	4	20	24	1	27	52	0	0
14	23707976	.	A	G	11	8	19	1	0	20	0	0
14	23717277	.	A	T	29	25	54	0	2	56	0	0
14	23717289	.	A	T	28	26	54	0	3	57	0	0
14	23720196	.	A	T	27	31	58	0	3	61	0	0
14	23722030	.	C	T	31	27	58	0	2	60	0	0
14	23726393	.	C	A	35	23	58	1	3	62	0	0
14	23726413	.	G	A	36	27	63	1	3	67	0	0
14	23726547	.	C	T	23	29	52	0	0	52	0	0
14	23732056	.	C	A	1	8	9	1	0	10	0	0
14	23732117	.	T	C	2	8	10	0	1	11	0	0
14	23732368	.	C	A	2	18	20	0	8	28	0	0
14	23732396	.	A	G	7	22	29	0	3	32	0	0
14	23732444	.	G	T	11	26	37	0	1	39	1	0
14	23732497	.	C	A	10	18	28	0	0	28	0	0
14	23732508	.	C	T	9	16	25	0	0	25	0	0
14	23732547	.	T	A	8	6	14	0	0	14	0	0
14	23732691	.	G	T	3	7	10	0	0	10	0	0
14	23732718	.	A	G	4	9	13	0	1	14	0	0
14	23732745	.	C	G	5	12	17	0	0	17	0	0
14	23732824	.	T	A	5	3	8	0	0	8	0	0
14	23732916	.	C	T	3	5	8	0	0	8	0	0
14	23732924	.	A	T	3	4	7	0	0	7	0	0
14	23733097	.	A	G	10	7	17	0	1	18	0	0
14	23733220	.	G	A	10	16	26	0	0	26	0	0
14	23737655	.	G	A	2	2	4	0	0	4	0	0
14	23737661	.	C	T	0	2	2	0	1	3	0	0
14	23747360	.	T	A	21	14	35	0	0	35	0	0
14	23748654	.	A	G	22	19	41	0	0	41	0	0
14	23752335	.	C	T	19	14	33	0	3	36	0	0
14	23756410	.	G	A	5	9	14	0	0	14	0	0
14	23756637	.	A	G	10	10	20	0	0	20	0	0
14	23756680	.	A	G	9	15	24	0	1	25	0	0
14	23756716	.	T	A	14	20	34	0	1	35	0	0
14	23756752	.	T	G	19	21	40	0	1	41	0	0
14	23756809	.	G	T	17	10	27	0	2	29	0	0
14	23799271	.	G	T	11	11	22	0	0	22	0	0
14	23799293	.	T	C	10	10	20	0	0	20	0	0
14	23799344	.	G	T	10	6	16	0	2	18	0	0
14	23801145	.	C	A	2	10	12	0	16	28	0	0
14	23801159	.	C	A	1	9	10	0	18	28	0	0
14	23801249	.	G	A	7	13	20	0	0	20	0	0
14	23811956	.	T	C	7	8	15	0	0	15	0	0
14	23811978	.	C	T	5	8	13	0	0	13	0	0
14	23812017	.	T	C	1	7	8	0	0	8	0	0
14	23812581	.	C	T	5	6	11	0	0	11	0	0
14	23947547	.	G	A	1	3	4	0	3	7	0	0
14	23947586	.	A	G	2	0	2	0	3	5	0	0
14	23947690	.	A	G	7	3	10	0	0	10	0	0
14	23961006	.	C	G	4	0	4	0	6	10	0	0
14	23967648	.	C	A	3	4	7	0	0	7	0	0
14	23967672	.	A	G	1	1	2	0	0	2	0	0
14	23967772	.	G	A	3	3	6	0	0	6	0	0
14	23968348	.	C	T	3	3	6	0	0	6	0	0
14	23968517	.	G	C	2	3	5	0	0	5	0	0
14	23968564	.	T	A	4	7	11	0	0	11	0	0
14	23968657	.	C	A	6	6	12	0	1	13	0	0
14	23968720	.	G	A	7	9	16	0	1	17	0	0
14	23968925	.	G	A	1	2	3	0	0	3	0	0
14	23969152	.	G	A	3	2	5	0	1	6	0	0
14	23969154	.	T	C	3	2	5	0	1	6	0	0
14	23969443	.	G	C	3	3	6	0	0	6	0	0
14	23972351	.	C	T	20	17	37	0	0	37	0	0
14	23972572	.	G	A	12	17	29	0	4	33	0	0
14	23972587	.	C	T	11	15	26	0	0	26	0	0
14	23982623	.	A	T	24	17	41	0	3	44	0	0
14	23991507	.	C	T	22	18	40	0	3	43	0	0
14	23993952	.	A	G	23	28	51	0	1	52	0	0
14	23998961	.	C	A	18	11	29	0	1	30	0	0
14	23999021	.	C	T	14	22	36	0	1	37	0	0
14	23999112	.	A	G	19	20	39	0	1	40	0	0
14	23999315	.	A	G	17	9	26	0	0	26	0	0
14	23999459	.	A	C	11	13	24	0	1	25	0	0
14	24094689	.	C	T	4	3	7	0	0	7	0	0
14	24094722	.	G	A	2	4	6	0	1	7	0	0
14	24097686	.	A	G	12	6	18	0	0	18	0	0
14	24097734	.	G	A	9	11	20	0	1	21	0	0
14	24098470	.	C	G	3	4	7	0	2	9	0	0
14	24098648	.	G	A	21	6	27	0	0	27	0	0
14	24098694	.	G	T	26	8	34	0	0	34	0	0
14	24099059	.	A	T	12	15	27	0	2	29	0	0
14	24099240	.	C	A	14	9	23	0	0	23	0	0
14	24099309	.	T	A	7	4	11	0	1	12	0	0
14	24109706	.	T	G	17	15	32	0	2	34	0	0
14	24220467	.	A	G	28	0	28	0	15	43	0	0
14	24220959	.	A	T	6	10	16	0	1	17	0	0
14	24221053	.	G	A	15	6	21	0	1	22	0	0
14	24221194	.	T	A	12	12	24	0	1	25	0	0
14	24248398	.	C	A	4	7	11	0	0	11	0	0
14	24268332	.	A	C	9	0	9	0	8	17	0	0
14	24268403	.	G	A	5	3	8	0	0	8	0	0
14	24268676	.	A	T	12	11	23	0	0	23	0	0
14	24268781	.	G	A	13	11	24	0	0	24	0	0
14	24274575	.	C	T	11	5	16	0	1	17	0	0
14	24278144	.	C	G	36	20	56	0	1	57	0	0
14	24278162	.	C	G	38	13	51	0	4	55	0	0
14	24278234	.	A	G	38	12	50	0	0	50	0	0
14	24278831	.	T	C	28	17	45	0	1	46	0	0
14	24279011	.	A	C	20	16	36	0	1	38	1	0
14	24279305	.	A	T	6	11	17	0	0	17	0	0
14	24279326	.	A	C	7	12	19	0	0	19	0	0
14	24279383	.	T	A	18	10	28	0	0	28	0	0
14	24279429	.	T	C	18	13	31	0	0	31	0	0
14	24279459	.	C	G	13	17	30	0	1	31	0	0
14	24279551	.	A	G	20	0	20	0	15	35	0	0
14	24279682	.	T	C	17	17	34	0	0	34	0	0
14	24280452	.	T	C	17	12	29	0	1	30	0	0
14	24280517	.	A	C	14	15	29	0	0	29	0	0
14	24280904	.	T	G	21	13	34	0	1	35	0	0
14	24280975	.	A	G	17	11	28	0	1	29	0	0
14	24281118	.	T	A	21	22	43	0	0	43	0	0
14	24281149	.	A	C	18	29	47	0	2	49	0	0
14	24281292	.	T	C	24	22	46	4	0	50	0	0
14	24283536	.	C	T	35	27	62	4	2	68	0	0
14	24283609	.	G	A	15	17	32	0	1	33	0	0
14	24288525	.	T	A	4	5	9	0	0	9	0	0
14	24301750	.	G	T	12	9	21	0	0	21	0	0
14	24301779	.	T	G	12	6	18	0	1	19	0	0
14	24301946	.	C	A	4	4	8	0	0	8	0	0
14	24302052	.	T	C	6	8	14	0	0	14	0	0
14	24302157	.	G	T	5	7	12	0	0	12	0	0
14	24302236	.	A	C	3	7	10	0	0	10	0	0
14	24302310	.	A	C	5	3	8	0	1	9	0	0
14	24302363	.	T	A	8	3	11	0	0	11	0	0
14	24302428	.	T	C	6	7	13	0	1	14	0	0
14	24302439	.	G	A	5	9	14	0	2	16	0	0
14	24302560	.	G	A	13	8	21	0	0	21	0	0
14	24302766	.	T	G	4	5	9	0	0	9	0	0
14	24302770	.	G	T	0	4	4	0	4	8	0	0
14	24302825	.	T	C	6	5	11	0	1	12	0	0
14	24303104	.	G	C	10	8	18	0	0	18	0	0
14	24303205	.	T	A	8	5	13	0	0	13	0	0
14	24303217	.	G	A	8	3	11	0	0	11	0	0
14	24303465	.	G	T	1	11	12	0	14	26	0	0
14	24303504	.	C	T	19	13	32	0	2	34	0	0
14	24303523	.	G	T	17	12	29	0	2	31	0	0
14	24303660	.	T	C	6	3	9	0	0	9	0	0
14	24303665	.	C	A	5	3	8	0	0	8	0	0
14	24303767	.	C	G	5	6	11	0	0	11	0	0
14	24303873	.	C	A	3	4	7	0	0	7	0	0
14	24304271	.	T	A	5	10	15	0	0	15	0	0
14	24304276	.	G	A	5	12	17	0	0	17	0	0
14	24304309	.	G	A	15	8	23	0	1	24	0	0
14	24304480	.	A	C	11	4	15	0	0	15	0	0
14	24304518	.	T	C	9	6	15	0	0	15	0	0
14	24304591	.	T	A	13	7	20	0	0	20	0	0
14	24304823	.	A	G	3	3	6	0	1	7	0	0
14	24317226	.	G	A	23	23	46	0	6	52	0	0
14	24317266	.	A	T	28	30	58	0	1	59	0	0
14	24317272	.	G	A	25	32	57	0	3	60	0	0
14	24317316	.	C	T	27	35	62	0	2	64	0	0
14	24317508	.	T	C	26	34	60	0	2	62	0	0
14	24317576	.	A	G	27	25	52	0	5	57	0	0
14	24317751	.	C	A	1	21	22	0	19	41	0	0
14	24318041	.	A	T	23	21	44	0	2	46	0	0
14	24318087	.	A	T	27	19	46	0	0	46	0	0
14	24318479	.	A	T	30	25	55	0	1	56	0	0
14	24318685	.	G	A	17	14	31	0	3	34	0	0
14	24318723	.	T	C	17	19	36	0	2	38	0	0
14	24318726	.	T	C	19	2	21	0	19	40	0	0
14	24318868	.	T	C	23	24	47	0	4	51	0	0
14	24325537	.	T	C	25	37	62	0	1	63	0	0
14	24326696	.	G	C	5	2	7	0	0	7	0	0
14	24326937	.	G	A	32	29	61	0	1	62	0	0
14	24327917	.	G	A	26	31	57	0	0	57	0	0
14	24328142	.	T	C	19	31	50	0	1	51	0	0
14	24328303	.	T	C	24	2	26	0	21	47	0	0
14	24332141	.	G	T	2	3	5	0	0	5	0	0
14	24332817	.	A	T	21	26	47	0	0	47	0	0
14	24333761	.	A	G	16	24	40	0	1	41	0	0
14	24369557	.	G	A	20	16	36	0	1	37	0	0
14	24391361	.	A	G	19	20	39	0	1	40	0	0
14	24406609	.	C	G	1	15	16	0	22	38	0	0
14	24409293	.	C	A	1	12	13	0	17	30	0	0
14	24410373	.	G	A	8	15	23	0	3	26	0	0
14	24410384	.	T	C	12	0	12	0	16	28	0	0
14	24410450	.	A	C	14	15	29	0	3	32	0	0
14	24410556	.	T	C	22	9	31	0	0	31	0	0
14	24491911	.	G	A	4	2	6	0	0	6	0	0
14	24492051	.	G	C	3	7	10	0	0	10	0	0
14	24492154	.	C	T	4	8	12	0	0	12	0	0
14	24492225	.	G	A	4	4	8	0	0	8	0	0
14	24492226	.	C	A	1	4	5	0	3	8	0	0
14	24497739	.	T	C	1	2	3	0	0	3	0	0
14	24497868	.	T	C	4	0	4	0	9	13	0	0
14	24509941	.	T	C	7	6	13	0	0	13	0	0
14	24536966	.	A	G	5	3	8	0	1	9	0	0
14	24541797	.	T	C	1	3	4	0	0	4	0	0
14	24840882	.	A	G	3	0	3	0	2	5	0	0
14	24841094	.	T	C	3	5	8	0	0	8	0	0
14	24852639	.	T	C	6	4	10	0	1	11	0	0
14	24853190	.	A	T	3	3	6	0	0	6	0	0
14	24857159	.	T	A	4	4	8	0	0	8	0	0
14	24973441	.	A	T	7	7	14	0	1	15	0	0
14	24985474	.	T	C	10	10	20	0	0	20	0	0
14	24985478	.	C	T	10	10	20	0	0	20	0	0
14	24985582	.	C	A	11	9	20	0	0	20	0	0
14	24990428	.	G	T	11	11	22	0	2	24	0	0
14	24990720	.	G	A	10	3	13	0	0	13	0	0
14	24997535	.	C	T	8	11	19	0	1	20	0	0
14	24997954	.	C	A	6	8	14	0	0	14	0	0
14	24998076	.	A	G	16	0	16	1	9	26	0	0
14	24998093	.	T	C	15	12	27	1	0	28	0	0
14	24998121	.	C	T	16	7	23	1	1	25	0	0
14	24998203	.	C	T	10	11	21	0	2	23	0	0
14	24998359	.	C	A	14	6	20	0	0	20	0	0
14	24998459	.	C	A	11	9	20	0	0	20	0	0
14	24998765	.	A	T	12	9	21	0	2	23	0	0
14	24998930	.	C	G	11	14	25	0	2	27	0	0
14	24999573	.	A	G	18	0	18	0	17	35	0	0
14	25000109	.	A	G	13	14	27	0	0	27	0	0
14	25000492	.	A	T	9	5	14	1	1	16	0	0
14	25000621	.	A	G	11	10	21	0	0	21	0	0
14	25040313	.	G	A	5	3	8	0	1	9	0	0
14	25063607	.	G	T	13	3	16	0	1	17	0	0
14	25063617	.	A	G	12	7	19	0	1	20	0	0
14	25065972	.	T	C	24	1	25	0	14	39	0	0
14	25066722	.	T	A	20	21	41	0	1	42	0	0
14	25066754	.	A	C	17	21	38	0	2	40	0	0
14	25067463	.	G	T	14	19	33	0	0	35	2	0
14	25067905	.	C	T	24	12	36	0	2	38	0	0
14	25071336	.	T	G	24	11	35	0	3	38	0	0
14	25076629	.	A	G	8	9	17	0	0	17	0	0
14	25077642	.	G	A	15	15	30	0	1	31	0	0
14	25078505	.	A	T	11	11	22	0	3	25	0	0
14	25080687	.	C	G	29	8	37	0	2	39	0	0
14	25102028	.	C	G	3	2	5	0	0	5	0	0
14	25102078	.	G	A	3	4	7	2	0	9	0	0
14	25498841	.	A	G	2	1	3	0	0	3	0	0
14	25501086	.	T	A	3	3	6	0	0	6	0	0
14	25906539	.	C	T	1	7	8	0	0	8	0	0
14	25907335	.	A	G	9	6	15	0	0	15	0	0
14	25908628	.	T	A	3	2	5	0	0	5	0	0
14	26105315	.	C	A	4	2	6	0	0	7	1	0
14	26405323	.	G	A	4	2	6	0	1	7	0	0
14	26718313	.	T	C	1	5	6	0	0	6	0	0
14	30454680	.	T	C	3	1	4	0	0	4	0	0
14	30454704	.	T	C	0	10	10	0	0	10	0	0
14	30741997	.	T	A	6	2	8	0	1	9	0	0
14	30960465	.	G	A	1	4	5	0	0	5	0	0
14	31521936	.	A	G	1	2	3	0	0	3	0	0
14	31643781	.	A	G	12	11	23	0	0	23	0	0
14	31643801	.	A	G	8	11	19	0	0	19	0	0
14	31645407	.	G	T	6	3	9	0	0	9	0	0
14	31647217	.	A	G	3	9	12	0	2	14	0	0
14	31647335	.	G	T	2	14	16	0	0	16	0	0
14	31681848	.	T	G	1	1	2	0	9	11	0	0
14	31801219	.	T	C	8	0	8	0	4	12	0	0
14	32524969	.	T	A	1	8	9	0	2	11	0	0
14	32525127	.	G	A	1	5	6	0	0	6	0	0
14	33282483	.	T	C	0	3	3	0	3	6	0	0
14	33344463	.	A	G	1	9	10	0	0	10	0	0
14	33826997	.	T	C	6	6	12	0	0	12	0	0
14	33827224	.	T	C	5	10	15	0	0	15	0	0
14	33827249	.	T	C	2	0	2	0	12	14	0	0
14	33899359	.	C	A	3	2	5	0	0	5	0	0
14	33899360	.	T	A	2	2	4	0	0	4	0	0
14	33899674	.	T	C	15	0	15	0	14	29	0	0
14	33901591	.	T	C	6	5	11	0	0	11	0	0
14	34090422	.	A	G	6	3	9	0	0	9	0	0
14	34125983	.	T	A	3	2	5	0	0	5	0	0
14	34129822	.	A	G	1	6	7	0	0	7	0	0
14	34130357	.	T	C	5	8	13	0	1	14	0	0
14	34488338	.	C	T	3	3	6	0	0	6	0	0
14	34634989	.	A	T	7	2	9	0	1	10	0	0
14	35011559	.	A	G	14	4	18	0	2	20	0	0
14	35804833	.	A	G	36	12	48	1	1	50	0	0
14	35813121	.	T	A	1	19	20	0	3	23	0	0
14	36268424	.	T	C	0	8	8	0	0	8	0	0
14	36268426	.	T	C	14	8	22	0	1	23	0	0
14	36720985	.	A	G	13	3	16	0	2	18	0	0
14	36752050	.	T	C	2	0	2	0	3	5	0	0
14	36752055	.	T	C	3	0	3	0	2	5	0	0
14	38656962	.	T	C	5	5	10	0	1	11	0	0
14	38656976	.	A	C	5	8	13	0	0	13	0	0
14	38659002	.	G	A	2	5	7	0	0	7	0	0
14	38663969	.	A	C	1	4	5	0	0	5	0	0
14	38663972	.	C	T	1	4	5	0	1	6	0	0
14	38668543	.	G	C	0	9	9	0	3	12	0	0
14	38668546	.	T	C	1	10	11	0	0	11	0	0
14	38668782	.	C	A	6	5	11	0	0	11	0	0
14	38668815	.	C	T	8	4	12	0	0	12	0	0
14	38668863	.	T	C	7	5	12	0	0	12	0	0
14	38669487	.	A	G	4	4	8	0	0	8	0	0
14	38669562	.	G	T	0	2	2	0	3	5	0	0
14	38670016	.	C	T	3	10	13	1	1	15	0	0
14	38672310	.	A	G	3	0	3	0	10	13	0	0
14	38672521	.	G	T	4	7	11	0	0	11	0	0
14	38678070	.	C	T	2	6	8	0	1	9	0	0
14	38688730	.	G	A	4	2	6	0	0	6	0	0
14	38688794	.	A	T	6	5	11	0	0	11	0	0
14	38688829	.	G	C	7	8	15	0	0	15	0	0
14	38689174	.	G	A	4	6	10	0	1	11	0	0
14	38689332	.	A	G	6	5	11	0	0	11	0	0
14	38689409	.	A	C	7	7	14	0	0	14	0	0
14	38689428	.	G	C	5	7	12	0	1	13	0	0
14	38763334	.	A	C	22	17	39	0	0	39	0	0
14	38763381	.	G	A	16	15	31	0	1	32	0	0
14	38763394	.	G	A	16	16	32	0	0	32	0	0
14	38783272	.	T	C	19	12	31	1	5	37	0	0
14	38796156	.	C	G	6	4	10	0	0	10	0	0
14	38799419	.	G	A	3	8	11	0	0	11	0	0
14	38802884	.	C	T	6	7	13	0	0	13	0	0
14	38802904	.	A	T	6	7	13	0	0	13	0	0
14	38802960	.	G	A	7	6	13	0	0	13	0	0
14	38802967	.	T	G	8	6	14	0	0	14	0	0
14	38803085	.	G	A	3	13	16	0	2	18	0	0
14	38803088	.	C	T	1	4	5	0	12	17	0	0
14	38806916	.	G	T	8	4	12	0	1	13	0	0
14	38809356	.	G	A	3	5	8	0	0	8	0	0
14	38845762	.	T	C	21	16	37	0	0	37	0	0
14	38846587	.	A	T	41	22	63	0	2	65	0	0
14	38847235	.	A	G	15	16	31	0	0	31	0	0
14	38847497	.	A	G	3	0	3	0	5	8	0	0
14	38849729	.	C	T	28	28	56	0	4	60	0	0
14	38849946	.	A	C	35	24	59	0	3	63	1	0
14	38853381	.	C	G	2	2	4	0	0	4	0	0
14	38853821	.	C	T	2	4	6	0	0	6	0	0
14	38862589	.	A	G	8	4	12	0	0	12	0	0
14	38862598	.	A	G	9	3	12	0	0	12	0	0
14	38865589	.	C	T	5	9	14	0	0	14	0	0
14	38869753	.	G	A	6	2	8	0	1	9	0	0
14	38872410	.	C	T	10	5	15	0	0	15	0	0
14	38872454	.	T	C	8	4	12	0	1	13	0	0
14	38872541	.	A	G	7	3	10	0	0	10	0	0
14	38872579	.	T	C	3	1	4	0	3	7	0	0
14	38875450	.	G	A	2	2	4	0	2	6	0	0
14	38875463	.	A	G	1	2	3	0	2	5	0	0
14	38875488	.	T	C	2	3	5	0	0	5	0	0
14	38875512	.	A	G	1	2	3	0	0	3	0	0
14	38878552	.	T	C	9	8	17	0	0	17	0	0
14	38881363	.	G	A	0	3	3	0	3	6	0	0
14	38882982	.	T	C	3	4	7	0	0	7	0	0
14	38937085	.	T	C	1	0	1	0	3	4	0	0
14	38937099	.	T	C	1	3	4	0	0	4	0	0
14	38937305	.	C	T	7	5	12	0	0	12	0	0
14	38941498	.	A	G	3	5	8	0	1	9	0	0
14	38946708	.	A	G	5	5	10	0	0	10	0	0
14	38946732	.	G	A	3	5	8	0	0	8	0	0
14	39002205	.	A	T	1	4	5	0	0	5	0	0
14	39002555	.	C	T	2	3	5	0	0	5	0	0
14	39002562	.	C	T	2	3	5	0	0	5	0	0
14	39002698	.	C	A	4	3	7	0	1	8	0	0
14	39002739	.	G	C	6	0	6	0	6	12	0	0
14	39002752	.	A	G	9	4	13	0	0	13	0	0
14	39002820	.	A	T	11	4	15	0	1	16	0	0
14	39002883	.	A	G	6	7	13	0	1	14	0	0
14	39003039	.	T	G	3	7	10	0	0	10	0	0
14	39258889	.	T	C	3	4	7	0	1	8	0	0
14	39444266	.	C	T	6	5	11	0	0	11	0	0
14	39458519	.	C	T	5	4	9	0	0	9	0	0
14	39651358	.	G	C	7	3	10	0	0	10	0	0
14	39651511	.	A	G	3	3	6	0	0	6	0	0
14	40303775	.	T	C	12	7	19	0	4	23	0	0
14	40746227	.	C	T	3	2	5	0	0	5	0	0
14	41277518	.	T	C	14	26	40	0	2	42	0	0
14	41278386	.	C	T	24	19	43	0	0	43	0	0
14	41513775	.	T	C	2	2	4	1	0	5	0	0
14	41513776	.	T	A	2	2	4	1	0	5	0	0
14	41920613	.	G	A	1	4	5	1	0	6	0	0
14	41920619	.	C	A	1	3	4	1	0	5	0	0
14	42172396	.	C	T	9	9	18	0	0	18	0	0
14	42172457	.	T	A	13	8	21	0	2	23	0	0
14	42172459	.	G	C	1	9	10	0	13	23	0	0
14	42172951	.	G	A	1	12	13	0	7	20	0	0
14	42173572	.	A	T	2	16	18	0	0	18	0	0
14	42174247	.	G	A	0	18	18	0	13	31	0	0
14	42174385	.	C	T	13	12	25	0	1	26	0	0
14	42174724	.	C	T	15	13	28	0	0	28	0	0
14	42178626	.	C	T	17	13	30	0	3	33	0	0
14	42179574	.	G	T	1	6	7	0	0	7	0	0
14	42179697	.	G	A	1	6	7	0	0	7	0	0
14	42978742	.	T	C	2	1	3	0	2	5	0	0
14	42978789	.	G	A	5	9	14	0	0	14	0	0
14	42978975	.	A	G	19	12	31	0	0	31	0	0
14	42978980	.	A	C	16	15	31	0	1	32	0	0
14	42979090	.	T	A	15	6	21	0	0	21	0	0
14	42979233	.	G	C	14	12	26	1	3	30	0	0
14	42979513	.	C	T	22	15	37	0	1	38	0	0
14	42997943	.	G	A	22	21	43	0	1	44	0	0
14	42998114	.	G	A	12	14	26	0	2	28	0	0
14	42998740	.	A	G	25	21	46	0	0	46	0	0
14	42998900	.	G	A	22	8	30	0	4	34	0	0
14	42999314	.	C	T	14	7	21	0	1	22	0	0
14	42999662	.	T	C	19	18	37	0	2	39	0	0
14	43000743	.	T	A	15	5	20	0	1	21	0	0
14	43000785	.	A	T	17	13	30	0	0	30	0	0
14	43577704	.	G	A	2	6	8	0	1	9	0	0
14	43577916	.	G	A	3	12	15	0	0	15	0	0
14	43579983	.	A	G	12	11	23	0	1	24	0	0
14	43580004	.	A	G	12	11	23	0	0	23	0	0
14	43591152	.	G	T	9	5	14	0	1	15	0	0
14	43591188	.	G	A	9	8	17	0	1	18	0	0
14	43596699	.	G	A	14	11	25	0	0	25	0	0
14	43596774	.	C	A	13	15	28	1	0	29	0	0
14	43598196	.	C	T	3	4	7	0	7	14	0	0
14	43605462	.	C	T	9	4	13	0	1	14	0	0
14	43605498	.	T	C	11	1	12	0	5	17	0	0
14	43612822	.	T	C	6	3	9	0	2	11	0	0
14	43615151	.	G	A	4	4	8	0	2	10	0	0
14	43615244	.	C	G	4	7	11	0	0	11	0	0
14	43616522	.	G	A	1	3	4	0	0	4	0	0
14	44013794	.	C	A	11	9	20	0	1	21	0	0
14	44208093	.	G	A	0	13	13	0	6	19	0	0
14	44208146	.	C	T	7	4	11	0	1	12	0	0
14	44589624	.	C	T	7	18	25	0	0	25	0	0
14	44589711	.	T	A	19	11	30	0	0	30	0	0
14	44589834	.	A	G	12	7	19	0	0	19	0	0
14	44589972	.	T	A	12	10	22	0	0	22	0	0
14	44589978	.	G	A	13	11	24	0	0	24	0	0
14	44590297	.	G	C	9	17	26	0	0	26	0	0
14	44590301	.	A	G	10	1	11	0	18	29	0	0
14	44590644	.	C	T	14	17	31	0	3	34	0	0
14	44590838	.	T	A	12	13	25	0	0	25	0	0
14	44590935	.	G	A	2	11	13	0	10	23	0	0
14	44590992	.	A	G	11	6	17	0	1	18	0	0
14	45034654	.	G	A	1	4	5	0	0	5	0	0
14	45200401	.	A	G	3	3	6	0	0	6	0	0
14	45202214	.	C	G	3	2	5	0	0	5	0	0
14	45203288	.	A	G	1	3	4	0	0	4	0	0
14	45213966	.	T	C	4	5	9	0	1	10	0	0
14	45214090	.	C	A	1	5	6	0	0	6	0	0
14	45214236	.	T	C	4	4	8	0	0	8	0	0
14	45226154	.	G	A	4	2	6	0	0	6	0	0
14	45230886	.	C	T	2	2	4	0	0	4	0	0
14	45259749	.	T	C	3	1	4	0	1	5	0	0
14	45259768	.	C	T	2	2	4	0	0	4	0	0
14	45259961	.	A	G	12	9	21	0	1	22	0	0
14	45260118	.	C	T	8	9	17	0	1	18	0	0
14	45260381	.	G	T	8	5	13	0	0	13	0	0
14	45271464	.	G	A	12	7	19	0	1	20	0	0
14	45271622	.	T	C	11	14	25	0	0	25	0	0
14	45276551	.	T	C	8	17	25	0	1	26	0	0
14	45276603	.	G	A	0	11	11	0	9	20	0	0
14	45276629	.	C	G	7	14	21	0	0	21	0	0
14	45276671	.	C	T	8	13	21	0	0	21	0	0
14	45276826	.	T	C	9	7	16	0	2	18	0	0
14	45293316	.	T	G	9	7	16	0	0	16	0	0
14	45293345	.	C	G	9	0	9	0	9	18	0	0
14	45293390	.	G	A	13	9	22	0	1	23	0	0
14	45293511	.	G	A	0	10	10	0	11	21	0	0
14	45293625	.	A	G	6	7	13	0	0	13	0	0
14	45293640	.	T	A	7	9	16	0	0	16	0	0
14	45293722	.	G	A	3	6	9	0	1	10	0	0
14	45293898	.	C	T	2	5	7	0	0	7	0	0
14	45293956	.	G	A	6	8	14	0	0	14	0	0
14	45293965	.	G	A	6	9	15	0	2	17	0	0
14	45293995	.	G	A	19	8	27	0	1	28	0	0
14	45295314	.	T	C	4	7	11	0	0	11	0	0
14	45295374	.	A	G	8	0	8	0	3	11	0	0
14	45312096	.	C	T	3	2	5	0	1	6	0	0
14	45341645	.	T	C	12	9	21	0	0	21	0	0
14	45435597	.	T	C	1	3	4	0	2	6	0	0
14	45435598	.	T	C	3	3	6	0	0	6	0	0
14	45435891	.	T	C	7	9	16	0	0	16	0	0
14	45435978	.	T	C	2	0	2	0	6	8	0	0
14	45435982	.	T	C	2	4	6	0	1	7	0	0
14	45514913	.	T	C	4	2	6	0	0	6	0	0
14	45530665	.	T	C	9	8	17	0	2	19	0	0
14	45534043	.	T	G	10	12	22	0	0	22	0	0
14	45534178	.	A	G	12	7	19	0	0	19	0	0
14	45534256	.	A	G	13	6	19	0	1	20	0	0
14	45534262	.	C	T	0	6	6	0	11	17	0	0
14	45542357	.	T	A	11	8	19	0	1	20	0	0
14	45545172	.	A	G	6	3	9	0	0	9	0	0
14	45548614	.	G	A	10	6	16	0	0	16	0	0
14	45549643	.	A	T	9	10	19	0	0	19	0	0
14	45552410	.	A	G	1	4	5	0	0	5	0	0
14	45552452	.	G	A	1	2	3	0	0	3	0	0
14	45554284	.	A	C	1	3	4	0	0	4	0	0
14	45554287	.	G	A	1	2	3	0	0	3	0	0
14	45554558	.	G	T	2	2	4	0	0	4	0	0
14	45555063	.	G	A	2	3	5	0	0	5	0	0
14	45555686	.	G	C	1	2	3	0	0	3	0	0
14	45555772	.	G	A	2	2	4	0	0	4	0	0
14	45565914	.	G	T	4	7	11	0	1	12	0	0
14	45565915	.	A	T	3	8	11	0	1	12	0	0
14	45568736	.	G	T	13	14	27	0	0	27	0	0
14	45570967	.	G	A	14	12	26	0	1	27	0	0
14	45571124	.	A	T	6	8	14	0	2	16	0	0
14	45571501	.	G	A	8	8	16	0	1	17	0	0
14	45571593	.	C	T	12	10	22	1	0	23	0	0
14	45571679	.	T	C	4	5	9	0	0	9	0	0
14	45575139	.	G	A	6	5	11	0	0	11	0	0
14	45575203	.	C	A	7	4	11	1	0	12	0	0
14	45575214	.	T	C	11	0	11	1	4	16	0	0
14	45575336	.	A	G	16	6	22	0	2	24	0	0
14	45575495	.	T	C	17	12	29	0	1	30	0	0
14	45581382	.	T	C	19	20	39	0	3	42	0	0
14	45582312	.	C	A	1	13	14	0	19	33	0	0
14	45582314	.	T	A	20	12	32	0	2	34	0	0
14	45584078	.	T	C	12	1	13	0	9	22	0	0
14	45584312	.	T	C	11	8	19	0	0	19	0	0
14	45586237	.	G	A	13	10	23	0	0	23	0	0
14	45590653	.	T	A	7	10	17	0	1	18	0	0
14	45592634	.	T	C	11	12	23	0	0	23	0	0
14	45594741	.	C	T	11	5	16	0	0	16	0	0
14	45594753	.	T	C	10	5	15	0	0	15	0	0
14	45594792	.	G	C	4	1	5	0	6	11	0	0
14	45603874	.	C	T	6	7	13	0	0	13	0	0
14	45603951	.	T	C	9	0	9	0	5	14	0	0
14	45603976	.	G	A	11	6	17	0	0	17	0	0
14	45608886	.	A	G	11	13	24	0	0	24	0	0
14	45614526	.	C	G	8	0	8	0	6	14	0	0
14	45631345	.	C	T	3	12	15	0	6	21	0	0
14	45631716	.	C	T	16	15	31	0	0	31	0	0
14	45631768	.	G	T	28	18	46	0	3	49	0	0
14	45632834	.	A	C	29	37	66	0	2	68	0	0
14	45632967	.	T	C	25	2	27	0	21	48	0	0
14	45634860	.	A	T	39	40	79	0	2	81	0	0
14	45634960	.	C	T	11	32	43	1	23	67	0	0
14	45635333	.	C	T	16	40	56	0	37	93	0	0
14	45635767	.	T	C	61	41	102	0	3	105	0	0
14	45636078	.	A	G	29	3	32	1	4	37	0	0
14	45636701	.	G	A	45	14	59	0	2	61	0	0
14	45636719	.	A	T	59	1	60	0	3	63	0	0
14	45636800	.	A	G	42	15	57	3	13	73	0	0
14	45636844	.	A	T	37	28	65	2	3	70	0	0
14	45637058	.	C	G	21	18	39	1	4	44	0	0
14	45637103	.	A	C	23	3	26	1	17	44	0	0
14	45637200	.	C	T	40	29	69	0	4	73	0	0
14	45637201	.	T	A	38	32	70	0	2	72	0	0
14	45637382	.	A	G	23	30	53	0	0	53	0	0
14	45637545	.	T	G	22	23	45	0	3	48	0	0
14	45637702	.	C	T	41	28	69	0	2	71	0	0
14	45637804	.	G	T	23	32	55	17	9	81	0	0
14	45638280	.	G	C	22	35	57	0	2	59	0	0
14	45638509	.	C	T	19	29	48	0	2	50	0	0
14	45638562	.	T	G	29	22	51	0	0	51	0	0
14	45638563	.	T	A	27	20	47	0	4	51	0	0
14	45789603	.	T	C	2	0	2	0	2	4	0	0
14	45911045	.	T	A	3	2	5	0	1	6	0	0
14	45925763	.	A	G	4	4	8	0	0	8	0	0
14	45925764	.	A	G	4	4	8	0	0	8	0	0
14	45925917	.	G	C	1	5	6	0	1	7	0	0
14	45925992	.	A	C	5	6	11	0	1	12	0	0
14	45926229	.	G	A	2	3	5	0	5	10	0	0
14	45926238	.	C	T	5	3	8	0	0	8	0	0
14	45926364	.	C	T	2	2	4	0	0	4	0	0
14	45926559	.	T	C	3	3	6	0	0	6	0	0
14	45926910	.	C	T	4	5	9	0	0	9	0	0
14	45927130	.	T	G	8	0	8	0	5	13	0	0
14	45927282	.	A	T	4	4	8	0	0	8	0	0
14	45927364	.	G	A	2	2	4	0	1	5	0	0
14	45927624	.	T	A	8	3	11	0	0	11	0	0
14	45928059	.	T	A	5	4	9	0	1	10	0	0
14	45928224	.	A	T	1	3	4	0	0	4	0	0
14	45928241	.	G	A	1	2	3	0	1	4	0	0
14	45928398	.	T	C	5	2	7	0	0	7	0	0
14	45928432	.	T	C	4	4	8	0	0	8	0	0
14	45928790	.	G	A	1	3	4	0	1	5	0	0
14	45928803	.	A	C	2	3	5	0	0	5	0	0
14	45928853	.	T	G	3	4	7	0	0	7	0	0
14	45929100	.	A	T	2	4	6	0	1	7	0	0
14	45929137	.	T	G	4	1	5	0	1	6	0	0
14	45929140	.	T	A	5	2	7	0	0	7	0	0
14	45929211	.	C	T	3	2	5	1	0	6	0	0
14	45929280	.	C	T	5	2	7	0	0	7	0	0
14	45929409	.	C	T	4	2	6	0	1	7	0	0
14	45929837	.	T	A	4	4	8	0	0	8	0	0
14	45929974	.	T	C	5	3	8	0	0	8	0	0
14	45930135	.	T	C	4	6	10	0	1	11	0	0
14	45930196	.	A	C	4	5	9	0	0	9	0	0
14	45930399	.	C	T	4	5	9	1	0	10	0	0
14	45930508	.	A	G	7	1	8	2	0	10	0	0
14	45930515	.	G	A	8	2	10	2	0	12	0	0
14	45930572	.	A	G	4	2	6	1	0	7	0	0
14	45930573	.	T	G	5	2	7	1	0	8	0	0
14	45930617	.	A	G	6	2	8	0	1	9	0	0
14	45930690	.	A	G	9	4	13	0	0	13	0	0
14	45930794	.	G	A	6	8	14	0	0	14	0	0
14	45931079	.	C	G	4	7	11	0	1	12	0	0
14	45931194	.	G	T	9	10	19	0	2	21	0	0
14	45931504	.	C	G	11	14	25	0	1	26	0	0
14	45931637	.	C	T	10	8	18	0	1	19	0	0
14	45931899	.	C	T	8	8	16	0	1	17	0	0
14	45932128	.	T	G	8	2	10	0	0	10	0	0
14	45967618	.	T	C	7	5	12	0	0	12	0	0
14	46007306	.	A	G	18	8	26	0	1	27	0	0
14	46007321	.	G	A	21	9	30	0	1	31	0	0
14	46009611	.	G	A	17	9	26	0	2	28	0	0
14	46009683	.	A	T	12	14	26	0	0	26	0	0
14	46010711	.	C	T	13	13	26	0	2	28	0	0
14	46010909	.	T	C	13	14	27	0	0	27	0	0
14	46012960	.	T	C	8	13	21	0	0	21	0	0
14	46013121	.	A	T	13	9	22	0	0	22	0	0
14	46013402	.	C	T	20	14	34	1	0	35	0	0
14	46015888	.	C	A	20	18	38	0	0	38	0	0
14	46016107	.	A	G	21	19	40	0	1	41	0	0
14	46017969	.	G	A	20	10	30	0	0	30	0	0
14	46018029	.	C	T	23	10	33	0	0	33	0	0
14	46018548	.	A	G	8	23	31	1	0	32	0	0
14	46028329	.	G	T	9	5	14	0	1	15	0	0
14	46028330	.	T	A	10	5	15	0	0	15	0	0
14	46028376	.	G	A	7	3	10	0	0	10	0	0
14	46028548	.	G	C	0	9	9	0	8	17	0	0
14	46037489	.	T	C	5	5	10	0	0	10	0	0
14	46039751	.	T	C	3	6	9	0	1	10	0	0
14	46039904	.	C	G	2	0	2	0	4	6	0	0
14	46040318	.	T	C	5	4	9	0	0	9	0	0
14	46041036	.	G	A	4	3	7	0	0	7	0	0
14	46041763	.	T	G	4	3	7	0	0	7	0	0
14	46041800	.	C	T	3	3	6	0	0	6	0	0
14	46041861	.	A	T	6	10	16	0	2	18	0	0
14	46048396	.	A	G	4	5	9	0	1	10	0	0
14	46048644	.	C	T	0	14	14	0	8	22	0	0
14	46048704	.	C	G	1	15	16	0	8	24	0	0
14	46048875	.	T	C	12	18	30	0	2	32	0	0
14	46052172	.	T	A	7	15	22	0	2	24	0	0
14	46052244	.	G	T	9	9	18	0	0	18	0	0
14	46067317	.	A	T	6	10	16	0	0	16	0	0
14	46074433	.	C	T	5	3	8	0	0	8	0	0
14	46074473	.	T	A	7	3	10	0	1	11	0	0
14	46074489	.	A	G	7	3	10	0	0	10	0	0
14	46074626	.	C	G	3	2	5	0	0	5	0	0
14	46074646	.	G	T	1	2	3	0	0	3	0	0
14	46075085	.	T	C	4	2	6	0	0	6	0	0
14	46075640	.	A	C	3	2	5	0	0	5	0	0
14	46076858	.	T	C	5	3	8	0	0	8	0	0
14	46078074	.	A	G	1	2	3	0	0	3	0	0
14	46078092	.	T	C	1	2	3	0	0	3	0	0
14	46088921	.	A	G	5	5	10	0	0	10	0	0
14	46089176	.	C	T	4	2	6	0	0	6	0	0
14	46089297	.	A	C	2	4	6	0	0	6	0	0
14	46091199	.	G	A	2	3	5	0	1	6	0	0
14	46094922	.	C	T	9	10	19	0	3	22	0	0
14	46095043	.	A	G	30	15	45	0	0	45	0	0
14	46095058	.	A	G	30	13	43	0	2	45	0	0
14	46095108	.	A	G	26	28	54	0	2	56	0	0
14	46104150	.	C	T	23	22	45	0	4	49	0	0
14	46104222	.	C	T	2	23	25	0	20	45	0	0
14	46104935	.	G	A	24	17	41	0	3	44	0	0
14	46114944	.	G	A	12	14	26	0	0	26	0	0
14	46128996	.	A	C	8	6	14	0	0	14	0	0
14	46140812	.	C	A	10	9	19	0	0	19	0	0
14	46146715	.	G	A	9	7	16	0	1	17	0	0
14	46146730	.	G	A	10	8	18	0	0	18	0	0
14	46154358	.	C	A	11	7	18	0	1	19	0	0
14	46154561	.	G	A	0	5	5	0	5	10	0	0
14	46154713	.	A	G	4	10	14	0	2	16	0	0
14	46154723	.	G	A	10	6	16	0	2	18	0	0
14	46154798	.	T	C	5	13	18	0	0	19	1	0
14	46154854	.	G	T	0	11	11	0	6	17	0	0
14	46177600	.	C	A	4	3	7	0	1	8	0	0
14	46177770	.	G	T	3	3	6	0	0	6	0	0
14	46182249	.	G	A	7	3	10	0	0	10	0	0
14	46182556	.	A	G	5	2	7	0	0	7	0	0
14	46182605	.	A	G	2	2	4	0	0	4	0	0
14	46182619	.	A	G	1	3	4	0	0	4	0	0
14	46183099	.	C	T	5	6	11	0	0	11	0	0
14	46183140	.	C	T	6	4	10	0	0	10	0	0
14	46183183	.	T	G	2	5	7	0	0	7	0	0
14	46183348	.	A	G	5	2	7	0	0	7	0	0
14	46183365	.	C	T	4	3	7	0	1	8	0	0
14	46183683	.	A	G	6	9	15	0	1	16	0	0
14	46184037	.	T	C	1	6	7	0	0	7	0	0
14	46184039	.	A	G	1	6	7	0	0	7	0	0
14	46184192	.	A	G	3	0	3	0	3	6	0	0
14	46184223	.	G	A	1	2	3	0	0	3	0	0
14	46184576	.	A	G	5	0	5	0	5	10	0	0
14	46184953	.	G	C	3	2	5	0	0	5	0	0
14	46185313	.	T	C	4	2	6	0	0	6	0	0
14	46185334	.	A	T	2	4	6	0	0	6	0	0
14	46185438	.	A	G	2	4	6	0	0	6	0	0
14	46185448	.	C	T	2	2	4	0	0	4	0	0
14	46186175	.	T	G	4	4	8	0	0	8	0	0
14	46186188	.	T	C	5	3	8	0	0	8	0	0
14	46186425	.	A	G	5	3	8	1	0	9	0	0
14	46186827	.	A	G	11	0	11	0	9	20	0	0
14	46187437	.	A	G	2	1	3	0	3	6	0	0
14	46187458	.	A	G	1	1	2	0	1	3	0	0
14	46187544	.	C	T	4	5	9	0	0	9	0	0
14	46187641	.	C	T	3	10	13	0	0	13	0	0
14	46187644	.	T	G	3	0	3	0	10	13	0	0
14	46187730	.	G	A	7	4	11	0	2	13	0	0
14	46187879	.	C	T	1	3	4	0	0	4	0	0
14	46188561	.	A	C	12	7	19	0	1	20	0	0
14	46188578	.	C	T	6	12	18	0	0	18	0	0
14	46189037	.	C	T	5	4	9	0	0	9	0	0
14	46189130	.	G	A	9	4	13	0	0	13	0	0
14	46189158	.	C	T	7	5	12	0	0	12	0	0
14	46189173	.	G	T	9	5	14	0	0	14	0	0
14	46189251	.	A	G	9	11	20	0	0	20	0	0
14	46189268	.	C	T	9	11	20	0	1	21	0	0
14	46189342	.	T	C	8	4	12	0	1	13	0	0
14	46189531	.	C	T	2	3	5	0	1	6	0	0
14	46200128	.	G	A	7	10	17	0	2	19	0	0
14	46200244	.	A	C	8	7	15	0	1	16	0	0
14	46200396	.	A	G	11	3	14	0	0	14	0	0
14	46200422	.	A	T	9	6	15	0	1	16	0	0
14	46200445	.	C	A	9	10	19	0	0	19	0	0
14	46200636	.	G	T	11	12	23	0	1	24	0	0
14	46200814	.	G	A	20	10	30	0	2	32	0	0
14	46204139	.	A	G	12	12	24	0	0	24	0	0
14	46206097	.	C	G	0	16	16	0	12	28	0	0
14	46208722	.	G	A	13	9	22	0	2	24	0	0
14	46208725	.	T	C	13	11	24	0	1	25	0	0
14	46208818	.	A	T	22	15	37	0	0	37	0	0
14	46211002	.	G	T	3	4	7	0	0	7	0	0
14	46219634	.	A	T	4	5	9	0	0	9	0	0
14	46346878	.	T	A	17	14	31	0	1	32	0	0
14	46352475	.	A	T	6	12	18	0	0	18	0	0
14	46352654	.	A	T	13	12	25	0	1	26	0	0
14	46360374	.	C	T	0	3	3	0	1	4	0	0
14	46376502	.	G	C	2	0	2	0	5	7	0	0
14	46376522	.	C	G	2	2	4	0	0	4	0	0
14	46382488	.	C	T	6	5	11	0	0	11	0	0
14	46385597	.	G	A	3	3	6	0	1	7	0	0
14	46385624	.	G	A	3	3	6	0	0	6	0	0
14	46388160	.	C	T	2	5	7	0	0	7	0	0
14	46392152	.	G	A	4	7	11	0	0	11	0	0
14	46395311	.	A	G	2	2	4	0	0	4	0	0
14	46441791	.	G	A	4	3	7	0	0	7	0	0
14	46441899	.	G	A	3	4	7	0	0	7	0	0
14	46441921	.	T	A	3	2	5	0	0	5	0	0
14	46456501	.	T	G	15	19	34	0	2	36	0	0
14	46456905	.	T	A	17	12	29	0	2	31	0	0
14	46456989	.	C	T	16	21	37	0	1	38	0	0
14	46457009	.	T	G	23	11	34	0	0	34	0	0
14	46457684	.	A	G	7	8	15	0	2	17	0	0
14	46457700	.	A	G	11	5	16	0	0	16	0	0
14	46457809	.	A	G	16	7	23	1	2	26	0	0
14	46458010	.	C	T	8	4	12	0	0	12	0	0
14	46458185	.	T	G	6	3	9	0	0	9	0	0
14	46458209	.	G	C	2	3	5	0	0	5	0	0
14	46458338	.	C	G	6	5	11	0	0	11	0	0
14	46458376	.	T	A	10	16	26	0	0	26	0	0
14	46458790	.	A	G	6	13	19	0	0	19	0	0
14	46458915	.	C	G	6	14	20	0	0	20	0	0
14	46459269	.	G	A	14	5	19	0	0	19	0	0
14	46475543	.	G	A	9	13	22	0	1	23	0	0
14	46495047	.	G	A	14	8	22	0	1	23	0	0
14	46503589	.	A	C	10	0	10	0	7	17	0	0
14	46540360	.	C	T	6	8	14	0	0	14	0	0
14	46616460	.	C	G	2	4	6	0	6	12	0	0
14	46633864	.	A	G	2	2	4	0	0	4	0	0
14	46643203	.	G	A	3	2	5	0	0	5	0	0
14	46648252	.	A	G	5	2	7	0	0	7	0	0
14	46648273	.	C	T	4	4	8	0	0	8	0	0
14	46651453	.	G	A	4	6	10	0	0	10	0	0
14	46668440	.	C	T	3	5	8	0	0	8	0	0
14	46675613	.	C	G	1	6	7	0	0	7	0	0
14	46675630	.	T	G	2	7	9	0	0	9	0	0
14	46678919	.	A	G	3	8	11	0	1	12	0	0
14	46679259	.	A	G	6	5	11	0	0	11	0	0
14	46679263	.	C	T	5	5	10	0	1	11	0	0
14	46679664	.	G	A	5	2	7	6	0	13	0	0
14	46679902	.	A	C	19	5	24	4	0	28	0	0
14	46679912	.	G	A	18	6	24	4	1	29	0	0
14	46679999	.	A	G	17	7	24	0	0	24	0	0
14	46680043	.	T	C	13	5	18	0	0	18	0	0
14	46680183	.	G	T	3	7	10	0	1	11	0	0
14	46680210	.	G	T	10	5	15	0	2	17	0	0
14	46680226	.	C	A	15	7	22	0	0	22	0	0
14	46680702	.	T	C	8	2	10	0	0	10	0	0
14	46680904	.	A	T	4	7	11	0	1	12	0	0
14	46680966	.	T	C	6	9	15	0	1	16	0	0
14	46681005	.	A	C	6	7	13	0	0	13	0	0
14	46681020	.	T	A	6	8	14	0	0	14	0	0
14	46681641	.	A	G	9	8	17	0	0	17	0	0
14	46682783	.	A	C	6	4	10	0	0	10	0	0
14	46682877	.	T	G	7	10	17	0	0	18	1	0
14	46682919	.	T	C	4	6	10	0	3	13	0	0
14	46682926	.	A	G	5	5	10	0	1	11	0	0
14	46683101	.	T	A	9	4	13	0	0	13	0	0
14	46683354	.	A	G	2	7	9	0	0	9	0	0
14	46683419	.	A	G	4	3	7	0	0	7	0	0
14	46683431	.	C	T	5	2	7	0	0	7	0	0
14	46683502	.	A	G	2	4	6	0	0	6	0	0
14	46683660	.	A	C	4	3	7	0	0	7	0	0
14	46683689	.	G	A	5	5	10	0	0	10	0	0
14	46683725	.	A	G	4	5	9	0	0	9	0	0
14	46684102	.	C	T	0	3	3	0	5	8	0	0
14	46684195	.	A	C	7	12	19	0	0	19	0	0
14	46684227	.	T	C	8	10	18	0	0	18	0	0
14	46684233	.	G	T	13	7	20	0	1	21	0	0
14	46684632	.	T	C	9	0	9	0	6	15	0	0
14	46684636	.	T	A	7	6	13	0	1	14	0	0
14	46684800	.	T	G	12	11	23	0	0	23	0	0
14	46789421	.	A	G	7	5	12	0	1	13	0	0
14	46873439	.	C	A	2	3	5	0	0	5	0	0
14	46873543	.	G	A	6	5	11	0	0	11	0	0
14	46873806	.	G	A	5	4	9	0	0	9	0	0
14	46874001	.	G	A	10	9	19	0	1	20	0	0
14	46874095	.	G	A	4	5	9	0	0	9	0	0
14	46874098	.	T	A	3	5	8	0	1	9	0	0
14	46874191	.	G	A	5	3	8	0	0	8	0	0
14	46874276	.	C	A	1	3	4	0	1	5	0	0
14	46874572	.	G	A	3	3	6	0	0	6	0	0
14	46874605	.	T	A	2	5	7	0	0	7	0	0
14	46874740	.	C	T	2	3	5	0	0	5	0	0
14	46874885	.	T	A	2	2	4	0	0	4	0	0
14	46874926	.	A	T	1	2	3	0	0	3	0	0
14	46876924	.	T	C	7	4	11	0	0	11	0	0
14	46876970	.	C	T	5	3	8	0	1	9	0	0
14	46877085	.	T	C	3	5	8	0	0	8	0	0
14	46881719	.	A	G	13	6	19	0	0	19	0	0
14	47142035	.	A	G	17	10	27	1	0	28	0	0
14	47264962	.	T	C	11	0	11	0	16	27	0	0
14	47265031	.	A	G	10	15	25	1	0	26	0	0
14	47882878	.	T	A	7	6	13	0	0	13	0	0
14	48740763	.	T	C	3	5	8	0	0	8	0	0
14	48932470	.	T	A	23	21	44	0	2	46	0	0
14	48932712	.	G	A	15	9	24	0	0	24	0	0
14	48932880	.	A	T	34	7	41	0	0	41	0	0
14	48932970	.	T	A	23	20	43	0	1	44	0	0
14	48933224	.	A	G	32	16	48	0	1	49	0	0
14	48933273	.	C	A	32	13	45	2	1	48	0	0
14	48933361	.	T	A	38	10	48	2	0	50	0	0
14	48933513	.	T	C	16	11	27	0	4	31	0	0
14	48933575	.	A	G	22	7	29	0	2	31	0	0
14	48933592	.	T	C	19	1	20	0	6	26	0	0
14	48933772	.	G	A	6	5	11	1	0	12	0	0
14	48934025	.	G	A	24	18	42	0	1	43	0	0
14	48934052	.	G	A	24	14	38	0	2	40	0	0
14	48934253	.	G	A	20	10	30	0	2	32	0	0
14	48934276	.	G	A	20	7	27	0	0	27	0	0
14	48934299	.	C	A	18	4	22	0	0	22	0	0
14	48934547	.	A	T	21	22	43	0	2	45	0	0
14	48934577	.	G	T	27	18	45	0	3	48	0	0
14	48934630	.	C	G	36	11	47	0	0	47	0	0
14	48934639	.	T	C	38	0	38	0	8	46	0	0
14	48934701	.	T	C	23	24	47	0	4	51	0	0
14	48934719	.	T	G	27	26	53	0	2	55	0	0
14	48934829	.	T	A	22	23	45	0	3	48	0	0
14	48960464	.	C	T	0	6	6	0	2	8	0	0
14	48960842	.	C	T	1	2	3	0	0	3	0	0
14	48960979	.	T	G	3	7	10	0	0	10	0	0
14	48964697	.	T	C	10	17	27	0	1	28	0	0
14	48982481	.	G	A	0	1	1	0	2	3	0	0
14	48995443	.	G	A	1	5	6	0	0	6	0	0
14	48995473	.	C	T	0	2	2	0	1	3	0	0
14	48995551	.	C	G	6	3	9	0	0	9	0	0
14	48995962	.	A	T	3	4	7	0	0	7	0	0
14	48997367	.	G	A	3	4	7	0	0	7	0	0
14	48997620	.	G	C	2	2	4	0	0	4	0	0
14	48997748	.	A	G	1	3	4	0	0	4	0	0
14	48997824	.	A	G	7	5	12	0	1	13	0	0
14	49005367	.	T	A	3	2	5	0	0	5	0	0
14	49009896	.	T	C	4	6	10	0	1	11	0	0
14	49009923	.	A	G	7	0	7	0	4	11	0	0
14	49015183	.	T	C	2	5	7	0	0	7	0	0
14	49021945	.	C	T	6	15	21	0	0	21	0	0
14	49021960	.	C	T	5	13	18	0	0	18	0	0
14	49022002	.	C	T	3	6	9	0	0	9	0	0
14	49022071	.	A	G	8	0	8	0	13	21	0	0
14	49022145	.	A	G	9	0	9	0	10	19	0	0
14	49022290	.	G	T	1	6	7	0	9	16	0	0
14	49022328	.	T	C	4	9	13	0	0	13	0	0
14	49029026	.	A	G	4	0	4	0	8	12	0	0
14	49029269	.	C	G	2	2	4	0	0	4	0	0
14	49029992	.	C	T	3	4	7	0	0	7	0	0
14	49030378	.	A	G	2	2	4	0	0	4	0	0
14	49030450	.	A	G	0	2	2	0	1	3	0	0
14	49031081	.	T	G	4	6	10	0	0	10	0	0
14	49031086	.	G	A	4	8	12	0	0	12	0	0
14	49031149	.	T	C	5	12	17	0	0	17	0	0
14	49031162	.	C	T	5	10	15	0	0	15	0	0
14	49031212	.	A	G	5	3	8	0	0	8	0	0
14	49031255	.	A	G	3	0	3	0	2	5	0	0
14	49031304	.	T	A	2	6	8	0	0	8	0	0
14	49040425	.	A	G	3	3	6	0	0	6	0	0
14	49040563	.	T	A	9	3	12	0	1	13	0	0
14	49040574	.	G	A	7	3	10	0	1	11	0	0
14	49047525	.	T	G	19	15	34	0	2	36	0	0
14	49053391	.	G	A	10	6	16	0	1	17	0	0
14	49053402	.	C	G	9	6	15	0	0	15	0	0
14	49053431	.	T	G	7	5	12	0	0	12	0	0
14	49053523	.	T	C	6	8	14	0	0	14	0	0
14	49057237	.	T	C	10	5	15	0	1	16	0	0
14	49078728	.	T	G	4	6	10	0	0	10	0	0
14	49078734	.	G	T	4	6	10	0	0	10	0	0
14	49078814	.	A	C	3	2	5	0	1	6	0	0
14	49079018	.	G	A	2	3	5	0	0	5	0	0
14	49089947	.	G	A	3	2	5	0	0	5	0	0
14	49089956	.	T	C	4	0	4	0	2	6	0	0
14	49091420	.	G	A	7	5	12	0	0	12	0	0
14	49092514	.	G	A	3	3	6	0	0	6	0	0
14	49092559	.	C	T	3	5	8	0	0	8	0	0
14	49119048	.	G	T	16	16	32	0	4	36	0	0
14	49119062	.	G	A	21	23	44	0	4	48	0	0
14	49119115	.	T	G	34	33	67	0	1	68	0	0
14	49119192	.	T	A	30	25	55	4	1	60	0	0
14	49119321	.	A	C	30	24	54	0	1	55	0	0
14	49119484	.	T	A	28	20	48	0	1	49	0	0
14	49124645	.	G	C	19	19	38	0	1	39	0	0
14	49124711	.	A	C	22	21	43	0	0	43	0	0
14	49126924	.	G	A	20	12	32	0	1	33	0	0
14	49133139	.	A	G	21	8	29	0	1	30	0	0
14	49135328	.	A	T	11	26	37	0	2	39	0	0
14	49136483	.	C	T	20	21	41	0	0	41	0	0
14	49136530	.	T	G	14	0	14	0	19	33	0	0
14	49136551	.	T	G	10	2	12	0	12	25	1	0
14	49136835	.	G	A	14	10	24	0	1	25	0	0
14	49136886	.	C	A	12	12	24	0	1	25	0	0
14	49136909	.	C	T	7	14	21	5	1	27	0	0
14	49152660	.	A	T	3	4	7	0	0	7	0	0
14	49153681	.	T	C	3	2	5	0	0	5	0	0
14	49154087	.	A	T	10	5	15	0	1	16	0	0
14	49172185	.	A	T	8	6	14	0	0	14	0	0
14	49172331	.	C	T	4	7	11	0	0	11	0	0
14	49172472	.	T	G	5	3	8	0	0	8	0	0
14	49172623	.	A	G	3	0	3	0	5	8	0	0
14	49172884	.	C	A	7	2	9	0	1	10	0	0
14	49172926	.	T	G	5	0	5	0	4	9	0	0
14	49172961	.	G	A	0	6	6	0	3	9	0	0
14	49173579	.	C	A	2	5	7	0	0	7	0	0
14	49173601	.	C	T	2	9	11	0	0	11	0	0
14	49174995	.	G	T	2	10	12	0	1	13	0	0
14	49175348	.	T	A	2	1	3	0	1	4	0	0
14	49175579	.	T	C	1	5	6	0	0	6	0	0
14	49175761	.	A	C	3	3	6	0	0	6	0	0
14	49182980	.	T	G	8	5	13	0	1	14	0	0
14	49183104	.	C	G	5	6	11	0	1	12	0	0
14	49188546	.	C	T	6	2	8	0	0	8	0	0
14	49188552	.	G	C	6	4	10	0	0	10	0	0
14	49192533	.	A	G	4	0	4	0	7	11	0	0
14	49195572	.	C	A	6	7	13	0	1	14	0	0
14	49196757	.	A	T	6	9	15	1	0	16	0	0
14	49196784	.	C	T	8	6	14	1	0	15	0	0
14	49199004	.	A	T	8	7	15	0	0	15	0	0
14	49202111	.	C	G	8	8	16	0	0	16	0	0
14	49203983	.	C	T	4	3	7	0	0	7	0	0
14	49204136	.	G	A	1	6	7	0	7	14	0	0
14	49206876	.	G	C	7	2	9	0	1	10	0	0
14	49206879	.	C	T	8	3	11	0	0	11	0	0
14	49206948	.	G	A	8	14	22	0	0	22	0	0
14	49209884	.	G	A	1	9	10	0	10	20	0	0
14	49209983	.	C	T	9	12	21	0	0	21	0	0
14	49210055	.	T	C	6	10	16	0	0	16	0	0
14	49210075	.	C	A	7	9	16	0	0	16	0	0
14	49210231	.	A	G	4	10	14	0	0	14	0	0
14	49210349	.	G	A	5	7	12	0	1	13	0	0
14	49210569	.	G	C	5	4	9	0	0	9	0	0
14	49210686	.	T	G	2	3	5	0	1	6	0	0
14	49210779	.	C	T	2	5	7	0	0	7	0	0
14	49210867	.	G	T	6	5	11	1	0	12	0	0
14	49210955	.	A	G	13	4	17	0	0	17	0	0
14	49211001	.	A	G	6	7	13	0	4	17	0	0
14	49211045	.	T	C	11	6	17	0	2	19	0	0
14	49211204	.	A	G	3	3	6	0	0	6	0	0
14	49211229	.	C	T	4	3	7	0	1	8	0	0
14	49211269	.	A	G	6	4	10	0	2	12	0	0
14	49211280	.	T	A	3	6	9	0	0	9	0	0
14	49212292	.	C	T	7	4	11	1	0	12	0	0
14	49212314	.	G	A	7	2	9	1	0	10	0	0
14	49212350	.	C	T	10	7	17	0	0	17	0	0
14	49212395	.	T	C	6	6	12	0	0	12	0	0
14	49212612	.	T	C	4	4	8	0	0	8	0	0
14	49212674	.	T	C	8	1	9	0	1	10	0	0
14	49212683	.	C	G	7	3	10	0	0	10	0	0
14	49212757	.	A	T	6	3	9	0	1	10	0	0
14	49212838	.	C	T	3	6	9	0	0	9	0	0
14	49212867	.	A	C	3	3	6	0	0	6	0	0
14	49212887	.	A	C	3	3	6	0	0	6	0	0
14	49212985	.	A	T	10	5	15	0	0	15	0	0
14	49212986	.	G	A	10	5	15	0	0	15	0	0
14	49213126	.	A	T	9	10	19	0	0	19	0	0
14	49213250	.	C	T	5	10	15	0	2	18	1	0
14	49213871	.	A	T	7	2	9	0	0	9	0	0
14	49214087	.	G	A	5	6	11	0	0	11	0	0
14	49214158	.	G	A	4	5	9	0	2	11	0	0
14	49214170	.	A	G	6	0	6	0	6	12	0	0
14	49214286	.	T	G	2	2	4	0	0	4	0	0
14	49214323	.	A	T	3	6	9	0	0	9	0	0
14	49214347	.	T	G	3	0	3	0	7	10	0	0
14	49214392	.	G	A	8	3	11	0	0	11	0	0
14	49231813	.	C	T	16	14	30	0	0	30	0	0
14	49231903	.	C	G	14	10	24	0	0	24	0	0
14	49233651	.	G	A	1	8	9	0	8	17	0	0
14	49233937	.	A	G	8	9	17	1	1	19	0	0
14	49236476	.	A	G	17	11	28	0	2	30	0	0
14	49237917	.	A	G	11	12	23	1	1	25	0	0
14	49244377	.	T	C	20	16	36	0	1	37	0	0
14	49244425	.	A	G	18	0	18	0	19	37	0	0
14	49244496	.	C	T	22	17	39	1	3	43	0	0
14	49244740	.	A	T	11	9	20	0	0	20	0	0
14	49245255	.	G	C	12	15	27	0	0	28	1	0
14	49430817	.	A	G	15	10	25	0	0	25	0	0
14	49442729	.	A	T	3	10	13	0	0	13	0	0
14	49444327	.	G	A	7	6	13	0	1	14	0	0
14	49489002	.	A	G	15	31	46	3	5	54	0	0
14	49865367	.	T	A	12	6	18	0	2	20	0	0
14	49865508	.	G	A	14	15	29	0	0	29	0	0
14	49865563	.	C	T	11	9	20	0	1	21	0	0
14	49865711	.	A	G	23	12	35	0	3	38	0	0
14	49865747	.	C	T	2	21	23	0	16	39	0	0
14	49878814	.	T	C	10	1	11	0	13	24	0	0
14	49938797	.	C	A	7	15	22	0	0	22	0	0
14	49939493	.	C	T	1	6	7	0	11	18	0	0
14	49939498	.	A	G	10	7	17	0	0	17	0	0
14	49943137	.	G	A	8	9	17	0	1	18	0	0
14	49943171	.	G	T	12	10	22	0	1	23	0	0
14	49943185	.	T	A	16	14	30	0	2	32	0	0
14	49947765	.	C	T	6	7	13	0	0	13	0	0
14	49947806	.	G	A	4	9	13	0	0	13	0	0
14	49947846	.	G	A	3	6	9	0	1	10	0	0
14	49947868	.	T	C	5	0	5	0	5	10	0	0
14	49948196	.	G	T	8	5	13	0	0	13	0	0
14	49948217	.	A	G	7	3	10	0	0	10	0	0
14	49948589	.	G	A	8	9	17	0	1	18	0	0
14	49952434	.	C	A	0	11	11	0	8	19	0	0
14	49952515	.	A	G	9	8	17	0	0	17	0	0
14	49952554	.	A	G	6	13	19	0	1	20	0	0
14	49952819	.	G	A	11	7	18	0	3	21	0	0
14	49962203	.	C	T	4	10	14	0	0	14	0	0
14	49962227	.	A	G	2	5	7	0	0	7	0	0
14	49962383	.	G	A	7	6	13	0	0	13	0	0
14	49970407	.	A	G	3	9	12	0	0	12	0	0
14	49992217	.	A	C	5	4	9	0	0	9	0	0
14	49996841	.	T	C	1	0	1	0	2	3	0	0
14	49996893	.	C	T	1	2	3	0	0	3	0	0
14	49997004	.	G	A	1	4	5	0	0	5	0	0
14	49997040	.	A	G	1	3	4	0	0	4	0	0
14	49997043	.	T	C	1	3	4	0	0	4	0	0
14	49997115	.	G	A	5	2	7	0	0	7	0	0
14	49997246	.	A	G	2	5	7	0	0	7	0	0
14	49997276	.	G	A	2	6	8	0	0	8	0	0
14	49997867	.	G	A	6	3	9	0	0	9	0	0
14	50027311	.	A	G	1	2	3	0	0	3	0	0
14	50798988	.	C	T	35	50	85	0	6	91	0	0
14	50944705	.	C	A	9	5	14	0	2	16	0	0
14	50950535	.	T	C	9	14	23	0	1	24	0	0
14	50962369	.	T	C	5	12	17	0	0	17	0	0
14	50964260	.	C	T	9	9	18	0	1	19	0	0
14	50968017	.	T	C	3	7	10	0	1	11	0	0
14	50972733	.	G	A	0	6	6	0	8	14	0	0
14	50972921	.	G	A	0	10	10	0	4	14	0	0
14	50972963	.	C	T	4	4	8	0	0	8	0	0
14	50973219	.	A	G	6	9	15	0	0	15	0	0
14	50973374	.	C	A	3	4	7	0	1	8	0	0
14	50973537	.	G	C	3	9	12	0	1	13	0	0
14	50973563	.	T	A	4	10	14	0	1	15	0	0
14	50974433	.	A	G	4	0	4	0	7	11	0	0
14	50974538	.	C	A	8	12	20	0	0	20	0	0
14	50974785	.	C	G	5	11	16	0	0	16	0	0
14	50974827	.	A	G	6	11	17	0	0	17	0	0
14	50975094	.	A	G	5	7	12	0	0	12	0	0
14	50975541	.	A	G	10	3	13	2	2	17	0	0
14	50994361	.	A	G	6	3	9	0	0	9	0	0
14	50994436	.	C	G	8	4	12	0	0	12	0	0
14	50994687	.	G	T	18	18	36	0	0	36	0	0
14	50994695	.	G	C	19	17	36	0	2	38	0	0
14	50999698	.	A	G	8	17	25	0	0	25	0	0
14	51002874	.	G	C	11	0	11	0	16	27	0	0
14	51012349	.	C	T	5	5	10	0	2	12	0	0
14	51014221	.	T	G	9	8	17	0	2	19	0	0
14	51015245	.	C	T	9	16	25	0	0	25	0	0
14	51015264	.	A	G	10	22	32	0	1	33	0	0
14	51015359	.	G	C	12	10	22	0	1	23	0	0
14	51017771	.	G	A	1	14	15	1	8	24	0	0
14	51017841	.	A	G	10	11	21	2	0	23	0	0
14	51017906	.	A	T	8	9	17	0	1	18	0	0
14	51017952	.	G	A	1	7	8	0	6	14	0	0
14	51024089	.	A	G	8	5	13	0	0	13	0	0
14	51026649	.	A	T	7	6	13	0	1	14	0	0
14	51038943	.	A	G	5	8	13	0	0	13	0	0
14	51038976	.	A	G	6	9	15	0	1	16	0	0
14	51038980	.	G	T	7	8	15	0	0	15	0	0
14	51039042	.	A	G	4	3	7	0	0	7	0	0
14	51164415	.	C	T	3	3	6	0	0	6	0	0
14	51829341	.	G	A	41	34	75	0	4	79	0	0
14	51830952	.	G	A	39	32	71	1	3	75	0	0
14	52323580	.	A	C	1	2	3	0	0	3	0	0
14	52323588	.	A	G	1	0	1	0	2	3	0	0
14	52357035	.	A	G	5	3	8	0	1	9	0	0
14	52358915	.	G	A	0	4	4	0	2	6	0	0
14	52358971	.	G	C	4	4	8	0	2	10	0	0
14	52366401	.	G	A	8	4	12	0	1	13	0	0
14	52379740	.	T	A	11	9	20	1	0	21	0	0
14	52379749	.	T	A	8	13	21	1	1	23	0	0
14	52379937	.	G	A	1	4	5	0	2	7	0	0
14	52380266	.	C	T	1	3	4	0	2	6	0	0
14	52381762	.	G	A	11	5	16	8	0	24	0	0
14	52383871	.	G	A	17	10	27	0	1	28	0	0
14	52386667	.	G	A	6	16	22	0	0	22	0	0
14	52388115	.	G	A	13	10	23	0	3	26	0	0
14	52388136	.	G	C	12	14	26	0	0	26	0	0
14	52388357	.	G	A	8	8	16	0	1	17	0	0
14	52388360	.	G	T	10	9	19	0	0	19	0	0
14	52397323	.	G	A	6	5	11	1	2	14	0	0
14	52397752	.	G	A	8	11	19	0	0	19	0	0
14	52399977	.	A	G	3	11	14	0	2	16	0	0
14	52400426	.	G	C	4	5	9	1	0	10	0	0
14	52408354	.	A	C	5	3	8	0	0	8	0	0
14	52408366	.	C	T	2	2	4	0	2	6	0	0
14	52408677	.	C	T	4	3	7	1	0	8	0	0
14	52408678	.	A	G	4	3	7	1	0	8	0	0
14	52408723	.	T	C	5	4	9	0	0	9	0	0
14	52411301	.	G	A	0	7	7	0	10	17	0	0
14	52411315	.	C	G	9	6	15	0	1	16	0	0
14	52413182	.	C	T	9	3	12	0	1	13	0	0
14	52417306	.	A	G	1	0	1	3	4	8	0	0
14	52417537	.	C	T	5	3	8	0	0	8	0	0
14	52417555	.	T	C	3	3	6	0	0	6	0	0
14	52418070	.	T	G	4	4	8	0	0	8	0	0
14	52418307	.	T	G	9	5	14	0	0	14	0	0
14	52418308	.	T	A	7	5	12	0	1	13	0	0
14	52418565	.	T	G	10	1	11	0	4	15	0	0
14	52418772	.	G	T	7	7	14	0	2	16	0	0
14	52418818	.	A	G	7	9	16	0	0	16	0	0
14	52418900	.	A	G	3	3	6	0	0	6	0	0
14	52419007	.	C	G	2	3	5	0	0	5	0	0
14	52419048	.	T	A	4	2	6	0	0	6	0	0
14	52490168	.	C	G	9	7	16	0	0	16	0	0
14	52490198	.	G	A	0	4	4	0	8	12	0	0
14	52494438	.	A	G	5	6	11	0	1	12	0	0
14	52494442	.	T	C	4	7	11	0	2	13	0	0
14	52517782	.	T	A	4	4	8	0	0	8	0	0
14	52517957	.	T	C	11	11	22	0	0	22	0	0
14	52518002	.	A	G	13	14	27	0	0	27	0	0
14	52518030	.	G	A	0	13	13	0	13	26	0	0
14	52518125	.	C	A	2	12	14	0	1	15	0	0
14	52518278	.	G	C	3	9	12	0	4	16	0	0
14	52520528	.	G	T	2	2	4	0	1	5	0	0
14	52520882	.	G	T	2	4	6	0	0	6	0	0
14	52522732	.	G	A	2	3	5	0	0	5	0	0
14	52522820	.	T	C	8	9	17	0	0	17	0	0
14	52522822	.	C	T	8	9	17	0	0	17	0	0
14	52522876	.	C	T	9	10	19	0	1	20	0	0
14	52523087	.	G	A	13	10	23	0	1	24	0	0
14	52523131	.	G	A	6	5	11	0	0	11	0	0
14	52523237	.	G	C	3	5	8	0	0	8	0	0
14	52523290	.	C	T	0	6	6	1	7	14	0	0
14	52523478	.	T	C	19	8	27	0	0	27	0	0
14	52523493	.	T	C	10	10	20	0	2	22	0	0
14	52523520	.	T	A	11	16	27	0	0	27	0	0
14	52523531	.	C	T	1	17	18	0	6	24	0	0
14	52523707	.	A	G	9	7	16	0	1	17	0	0
14	52523798	.	C	T	12	5	17	1	1	19	0	0
14	52524195	.	C	A	12	7	19	0	0	19	0	0
14	52524307	.	G	A	10	6	16	0	0	16	0	0
14	52524364	.	C	T	0	5	5	0	7	12	0	0
14	52524399	.	G	A	7	5	12	1	0	13	0	0
14	52524525	.	A	T	4	2	6	0	0	6	0	0
14	52524603	.	C	T	4	4	8	0	1	9	0	0
14	52524651	.	A	T	14	4	18	0	0	18	0	0
14	52524665	.	T	G	10	4	14	0	0	14	0	0
14	52524687	.	T	A	3	13	16	0	0	16	0	0
14	52524792	.	A	G	7	2	9	0	1	10	0	0
14	52525016	.	C	T	0	12	12	0	11	23	0	0
14	52525326	.	C	T	0	5	5	0	13	18	0	0
14	52525340	.	T	A	13	5	18	0	0	18	0	0
14	52525673	.	G	A	5	10	15	0	0	15	0	0
14	52525812	.	C	T	2	17	19	0	12	31	0	0
14	52528210	.	G	A	12	13	25	0	0	25	0	0
14	52531368	.	G	C	12	1	13	0	19	32	0	0
14	52531384	.	T	C	12	17	29	0	3	32	0	0
14	52533500	.	G	A	19	10	29	0	2	31	0	0
14	52533578	.	T	C	14	12	26	0	1	27	0	0
14	52533584	.	T	C	15	0	15	0	14	29	0	0
14	52538887	.	G	A	13	9	22	0	1	23	0	0
14	52565823	.	C	T	49	20	69	0	8	77	0	0
14	52571230	.	A	G	1	6	7	0	0	7	0	0
14	52575138	.	C	T	7	2	9	1	0	10	0	0
14	52575738	.	C	T	6	5	11	0	3	14	0	0
14	52580522	.	T	C	7	0	7	0	7	14	0	0
14	52580608	.	G	A	1	5	6	0	0	6	0	0
14	52583001	.	C	A	8	4	12	0	1	13	0	0
15	908257	.	T	C	2	3	5	4	0	9	0	0
15	1026038	.	C	T	1	3	4	0	0	4	0	0
15	1026045	.	T	A	1	3	4	0	0	4	0	0
15	1026323	.	A	G	4	2	6	0	0	6	0	0
15	1026440	.	G	C	1	2	3	0	0	3	0	0
15	1026462	.	G	A	1	2	3	0	0	3	0	0
15	1026488	.	T	C	3	2	5	0	0	5	0	0
15	1029379	.	G	C	2	2	4	0	0	4	0	0
15	1029484	.	C	T	3	2	5	0	0	5	0	0
15	1033435	.	A	T	9	5	14	0	0	14	0	0
15	1033479	.	T	G	6	5	11	0	0	11	0	0
15	1033564	.	G	T	2	6	8	0	0	8	0	0
15	1033853	.	A	G	6	3	9	0	0	9	0	0
15	1033955	.	C	T	1	4	5	0	2	7	0	0
15	1033959	.	G	A	0	4	4	0	1	5	0	0
15	1036614	.	C	T	5	4	9	0	0	9	0	0
15	1036677	.	C	T	0	4	4	0	3	7	0	0
15	1036825	.	T	C	5	5	10	0	0	10	0	0
15	1046078	.	G	C	3	3	6	0	0	6	0	0
15	1046102	.	T	A	2	4	6	0	0	6	0	0
15	1148129	.	A	G	5	2	7	0	0	7	0	0
15	1152067	.	T	C	1	6	7	0	1	8	0	0
15	1167171	.	C	T	8	2	10	0	1	11	0	0
15	1167183	.	C	T	10	2	12	0	0	12	0	0
15	1168999	.	A	G	1	3	4	0	0	4	0	0
15	1169624	.	A	G	7	6	13	0	0	13	0	0
15	1173016	.	A	G	4	0	4	0	6	10	0	0
15	1173067	.	C	T	5	3	8	0	1	9	0	0
15	1173542	.	C	T	10	8	18	0	0	18	0	0
15	1176447	.	G	A	1	5	6	0	7	13	0	0
15	1183930	.	G	T	7	5	12	0	1	13	0	0
15	1183984	.	C	T	1	9	10	0	5	15	0	0
15	1186181	.	A	G	8	4	12	0	1	13	0	0
15	1186202	.	C	T	0	4	4	0	10	14	0	0
15	1189664	.	C	T	20	7	27	0	0	27	0	0
15	1191750	.	A	G	16	8	24	0	0	24	0	0
15	1191792	.	G	A	5	8	13	0	10	23	0	0
15	1191822	.	A	G	8	0	8	0	15	23	0	0
15	1194619	.	G	A	2	6	8	0	14	22	0	0
15	1194633	.	A	G	15	7	22	0	0	22	0	0
15	1194670	.	G	A	13	8	21	0	1	22	0	0
15	1194754	.	T	C	6	3	9	0	2	11	0	0
15	1204917	.	T	C	7	6	13	0	0	13	0	0
15	1204941	.	T	C	7	6	13	0	0	13	0	0
15	1209060	.	G	A	0	4	4	0	4	8	0	0
15	1682103	.	T	C	2	6	8	0	0	8	0	0
15	1682187	.	T	C	6	2	8	0	0	8	0	0
15	1725241	.	A	G	6	2	8	0	0	8	0	0
15	1848098	.	T	C	7	7	14	0	1	15	0	0
15	1985843	.	A	G	1	4	5	0	0	5	0	0
15	2414764	.	A	G	7	4	11	0	0	11	0	0
15	2414798	.	A	G	7	3	10	0	0	10	0	0
15	2503901	.	C	T	1	4	5	0	0	5	0	0
15	2729971	.	T	C	10	6	16	0	1	17	0	0
15	2730358	.	T	C	6	21	27	0	0	27	0	0
15	3159919	.	A	G	5	2	7	0	0	7	0	0
15	3160212	.	A	G	4	2	6	0	0	6	0	0
15	3160740	.	A	G	1	3	4	0	0	4	0	0
15	3376685	.	A	C	2	7	9	0	2	11	0	0
15	3377050	.	C	G	2	7	9	0	2	12	1	0
15	3377106	.	C	T	6	5	11	0	0	11	0	0
15	3781357	.	G	A	2	2	4	0	0	4	0	0
15	3781808	.	T	A	1	3	4	0	0	4	0	0
15	3899678	.	A	T	2	2	4	0	0	4	0	0
15	3899930	.	A	G	3	5	8	0	1	9	0	0
15	3899948	.	T	A	6	3	9	0	0	9	0	0
15	3900485	.	G	A	3	4	7	0	1	8	0	0
15	3900593	.	G	A	2	2	4	0	0	4	0	0
15	3915699	.	G	A	0	3	3	0	3	6	0	0
15	3917355	.	A	T	4	1	5	0	2	7	0	0
15	3920836	.	T	A	2	2	4	0	1	5	0	0
15	3921308	.	A	G	3	2	5	0	0	5	0	0
15	3922509	.	T	C	4	3	7	0	0	7	0	0
15	3922638	.	C	T	4	3	7	0	2	9	0	0
15	3922752	.	C	A	6	2	8	0	0	8	0	0
15	3922822	.	C	G	1	6	7	0	0	7	0	0
15	3922835	.	A	C	1	5	6	0	0	6	0	0
15	3923082	.	T	G	2	3	5	0	0	5	0	0
15	3923094	.	T	G	1	3	4	0	0	4	0	0
15	3923135	.	A	G	1	0	1	0	5	6	0	0
15	3923193	.	A	G	2	4	6	0	0	6	0	0
15	3924349	.	C	G	3	2	5	0	0	5	0	0
15	3924695	.	T	A	2	3	5	0	0	6	1	0
15	3925206	.	G	T	1	3	4	0	2	6	0	0
15	3927930	.	G	A	2	3	5	0	1	6	0	0
15	3929762	.	C	G	2	2	4	0	0	4	0	0
15	3932368	.	G	A	1	2	3	0	1	4	0	0
15	3940123	.	A	T	1	3	4	0	0	4	0	0
15	4105009	.	A	G	2	5	7	0	1	8	0	0
15	4105164	.	C	T	0	11	11	0	2	13	0	0
15	4105262	.	A	G	4	2	6	0	1	7	0	0
15	4105328	.	A	G	5	2	7	0	0	7	0	0
15	4105416	.	G	T	3	3	6	0	0	6	0	0
15	4111649	.	T	C	7	4	11	0	0	11	0	0
15	4111821	.	A	G	9	4	13	0	0	13	0	0
15	4112233	.	C	T	1	4	5	0	1	6	0	0
15	4123660	.	T	G	2	5	7	0	1	8	0	0
15	4172366	.	C	G	13	7	20	0	0	20	0	0
15	4172371	.	G	T	11	6	17	0	1	18	0	0
15	4172458	.	C	T	6	12	18	0	2	20	0	0
15	4172470	.	A	G	13	5	18	0	0	18	0	0
15	4174147	.	T	G	9	11	20	0	1	21	0	0
15	4174174	.	C	T	5	9	14	0	0	14	0	0
15	4174191	.	G	T	5	12	17	0	0	17	0	0
15	4177160	.	C	A	13	5	18	0	0	18	0	0
15	4180093	.	C	A	2	8	10	0	10	20	0	0
15	4182667	.	T	C	18	0	18	0	15	33	0	0
15	4182718	.	A	G	21	13	34	0	0	34	0	0
15	4190893	.	T	A	4	5	9	0	0	9	0	0
15	4202300	.	T	C	8	6	14	0	0	14	0	0
15	4202321	.	C	T	7	9	16	0	0	16	0	0
15	4207587	.	G	C	7	11	18	0	1	19	0	0
15	4314014	.	C	A	8	9	17	0	0	17	0	0
15	4353311	.	G	T	33	12	45	0	1	46	0	0
15	4353333	.	T	C	36	3	39	0	13	57	5	0
15	4353965	.	G	A	33	29	62	0	13	76	1	0
15	4354082	.	G	A	31	32	63	0	0	63	0	0
15	4371833	.	T	C	37	25	62	1	1	64	0	0
15	4371863	.	C	T	39	25	64	1	1	66	0	0
15	4376110	.	C	T	1	23	24	0	25	49	0	0
15	4415864	.	G	C	17	6	23	0	0	23	0	0
15	4422222	.	A	G	3	4	7	0	0	7	0	0
15	4422383	.	A	T	1	2	3	0	0	3	0	0
15	4422394	.	G	A	1	2	3	0	0	3	0	0
15	4426474	.	C	T	3	4	7	0	0	7	0	0
15	4445081	.	A	G	0	3	3	0	1	4	0	0
15	4967234	.	C	T	2	0	2	0	1	3	0	0
15	4983605	.	A	G	6	2	8	0	0	8	0	0
15	4983606	.	A	G	5	3	8	0	0	8	0	0
15	6234255	.	G	A	7	9	16	0	1	17	0	0
15	6525689	.	G	A	2	3	5	0	1	6	0	0
15	6529942	.	C	G	1	2	3	0	2	5	0	0
15	6529953	.	T	C	1	2	3	0	0	3	0	0
15	6545184	.	G	T	1	3	4	1	0	5	0	0
15	6574511	.	A	G	2	2	4	0	0	4	0	0
15	6579239	.	T	G	2	2	4	0	0	4	0	0
15	6652600	.	T	C	17	10	27	0	1	28	0	0
15	6653094	.	T	G	13	12	25	0	0	25	0	0
15	6653209	.	G	T	2	15	17	0	9	26	0	0
15	6653282	.	C	G	7	14	21	0	0	21	0	0
15	6654524	.	T	G	7	11	18	0	1	19	0	0
15	6654587	.	C	A	14	14	28	0	2	30	0	0
15	6659159	.	G	A	23	17	40	0	1	41	0	0
15	6661390	.	G	A	24	9	33	0	1	34	0	0
15	6661449	.	T	C	19	15	34	1	2	37	0	0
15	6661499	.	G	A	17	17	34	1	0	35	0	0
15	6727022	.	T	A	4	2	6	0	1	7	0	0
15	6778515	.	T	A	7	2	9	0	0	9	0	0
15	6778825	.	A	G	3	3	6	0	1	7	0	0
15	6778856	.	C	A	1	2	3	0	1	4	0	0
15	6778877	.	A	G	1	4	5	0	1	6	0	0
15	6789675	.	T	C	5	15	20	0	2	22	0	0
15	6799903	.	G	A	8	9	17	0	0	17	0	0
15	6806712	.	G	C	12	20	32	0	1	33	0	0
15	6806836	.	G	A	14	17	31	0	2	33	0	0
15	6806912	.	T	G	8	17	25	0	0	25	0	0
15	6806931	.	T	G	8	12	20	0	1	21	0	0
15	6807014	.	A	T	1	2	3	0	0	3	0	0
15	6807406	.	C	A	4	4	8	0	0	8	0	0
15	6807500	.	C	G	11	12	23	0	2	25	0	0
15	6807514	.	G	A	12	14	26	0	2	28	0	0
15	6807563	.	A	T	18	15	33	0	2	35	0	0
15	6807874	.	C	T	6	8	14	0	0	14	0	0
15	6838126	.	G	A	1	2	3	0	0	3	0	0
15	6838771	.	T	C	8	5	13	0	1	14	0	0
15	6838786	.	T	C	9	5	14	0	1	15	0	0
15	6841506	.	G	T	11	13	24	0	0	24	0	0
15	6845567	.	A	G	5	6	11	0	0	11	0	0
15	6845636	.	T	A	4	8	12	0	1	13	0	0
15	6863102	.	G	A	5	6	11	0	0	11	0	0
15	6863137	.	T	C	8	3	11	0	0	11	0	0
15	6957221	.	C	G	9	8	17	0	0	17	0	0
15	8191892	.	A	G	1	4	5	0	1	6	0	0
15	8382177	.	A	G	2	2	4	0	0	4	0	0
15	8394927	.	T	G	4	5	9	0	0	9	0	0
15	8394942	.	G	A	3	4	7	0	0	7	0	0
15	8394965	.	G	A	0	3	3	0	6	9	0	0
15	8394987	.	C	T	6	3	9	0	0	9	0	0
15	8399281	.	T	A	4	3	7	0	1	8	0	0
15	8399624	.	C	T	1	3	4	0	1	5	0	0
15	8425772	.	G	A	3	2	5	0	1	6	0	0
15	8426123	.	T	G	7	2	9	0	1	10	0	0
15	8426205	.	A	T	3	2	5	0	0	5	0	0
15	8426594	.	T	C	4	0	4	0	3	7	0	0
15	8427062	.	A	G	7	5	12	0	0	12	0	0
15	8437030	.	A	G	5	3	8	0	0	8	0	0
15	8437062	.	T	G	4	2	6	0	1	7	0	0
15	8485026	.	T	C	1	3	4	0	0	4	0	0
15	8485185	.	T	C	4	4	8	0	0	8	0	0
15	8485191	.	T	C	4	4	8	0	0	8	0	0
15	8604835	.	A	C	10	6	16	0	1	17	0	0
15	8605259	.	C	A	10	8	18	0	1	19	0	0
15	8605318	.	G	A	15	10	25	0	1	26	0	0
15	8605452	.	C	A	5	5	10	0	1	11	0	0
15	8605838	.	T	A	10	15	25	0	1	26	0	0
15	8605839	.	A	T	10	16	26	0	0	26	0	0
15	8605972	.	T	A	12	14	26	0	0	26	0	0
15	8606207	.	A	T	4	9	13	0	0	13	0	0
15	8606224	.	G	A	3	10	13	0	2	15	0	0
15	8606256	.	A	C	3	10	13	0	1	14	0	0
15	8606464	.	A	G	13	11	24	0	3	27	0	0
15	8606501	.	G	A	15	13	28	0	2	30	0	0
15	8606507	.	G	A	13	16	29	0	1	30	0	0
15	8606555	.	C	T	11	9	20	0	0	20	0	0
15	8606601	.	A	C	5	13	18	0	0	18	0	0
15	8606619	.	A	G	5	13	18	0	0	18	0	0
15	8606799	.	T	G	9	5	14	0	3	17	0	0
15	8606823	.	G	A	14	5	19	0	0	19	0	0
15	8606872	.	C	A	14	10	24	0	0	24	0	0
15	8606897	.	T	C	15	6	21	0	0	21	0	0
15	8606940	.	T	G	5	10	15	0	3	18	0	0
15	8606943	.	T	G	5	13	18	0	0	18	0	0
15	8607025	.	T	A	9	16	25	0	1	26	0	0
15	8607182	.	T	A	14	15	29	0	0	29	0	0
15	8607365	.	G	T	13	10	23	0	10	33	0	0
15	8607846	.	T	A	10	16	26	0	0	26	0	0
15	8661671	.	C	T	9	7	16	0	0	16	0	0
15	8663798	.	A	G	2	4	6	0	0	6	0	0
15	8665317	.	A	C	2	3	5	0	0	5	0	0
15	8665414	.	G	A	5	4	9	0	0	9	0	0
15	8665459	.	C	T	0	5	5	0	6	11	0	0
15	8665481	.	G	A	7	7	14	0	0	14	0	0
15	8665506	.	A	G	7	6	13	0	0	13	0	0
15	8797850	.	T	C	31	21	52	0	1	53	0	0
15	8799007	.	A	G	29	17	46	0	0	46	0	0
15	8799016	.	A	G	38	9	47	0	2	49	0	0
15	8799141	.	T	A	17	11	28	1	0	29	0	0
15	8799462	.	T	A	27	9	36	3	2	41	0	0
15	8799713	.	G	A	25	22	47	0	5	52	0	0
15	8799730	.	T	G	21	0	21	0	31	52	0	0
15	8799831	.	T	C	13	17	30	0	0	30	0	0
15	8799856	.	G	A	13	12	25	0	0	25	0	0
15	8799872	.	C	A	13	13	26	0	0	26	0	0
15	8799892	.	C	T	13	12	25	0	0	25	0	0
15	8799916	.	T	C	9	8	17	0	2	19	0	0
15	8813936	.	T	C	4	0	4	0	3	7	0	0
15	8813971	.	G	A	4	3	7	0	0	7	0	0
15	8815320	.	A	T	3	3	6	0	0	6	0	0
15	8856283	.	G	T	5	3	8	0	0	8	0	0
15	8856293	.	C	T	9	5	14	0	0	14	0	0
15	8991643	.	A	C	1	2	3	0	0	3	0	0
15	8991713	.	T	C	1	2	3	0	0	3	0	0
15	8991738	.	A	G	1	2	3	0	0	3	0	0
15	8991757	.	G	C	1	3	4	0	0	4	0	0
15	8993566	.	A	T	1	2	3	0	0	3	0	0
15	9011092	.	A	G	3	2	5	0	0	5	0	0
15	9011178	.	C	T	7	6	13	0	0	13	0	0
15	9011230	.	G	A	8	4	12	0	0	12	0	0
15	9020621	.	C	T	3	11	14	0	0	14	0	0
15	9022736	.	C	T	0	3	3	0	5	8	0	0
15	9234102	.	A	C	14	15	29	0	2	31	0	0
15	9234114	.	A	G	17	18	35	0	2	37	0	0
15	9234156	.	A	C	22	17	39	0	5	44	0	0
15	9234634	.	A	T	29	16	45	0	0	45	0	0
15	9234885	.	A	G	29	29	58	0	1	59	0	0
15	9234960	.	C	T	26	32	58	0	0	58	0	0
15	9234972	.	T	C	25	35	60	0	3	63	0	0
15	9235081	.	C	G	33	37	70	0	3	73	0	0
15	9235128	.	A	C	29	34	63	0	0	63	0	0
15	9235254	.	A	G	30	37	67	0	1	68	0	0
15	9235319	.	C	T	34	32	66	0	0	66	0	0
15	9238101	.	G	A	38	31	69	0	3	72	0	0
15	9249293	.	G	A	34	32	66	0	7	73	0	0
15	9249344	.	C	T	36	35	71	0	1	72	0	0
15	9249346	.	A	G	35	34	69	0	3	72	0	0
15	9272219	.	G	T	20	14	34	14	2	50	0	0
15	9312135	.	C	T	2	2	4	0	0	4	0	0
15	9315612	.	C	A	2	4	6	0	0	6	0	0
15	9319051	.	T	C	13	0	13	0	6	19	0	0
15	9367812	.	G	A	8	6	14	0	0	14	0	0
15	9367842	.	T	C	6	8	14	0	0	14	0	0
15	9368757	.	G	A	6	6	12	0	1	13	0	0
15	9368834	.	A	G	7	5	12	1	0	13	0	0
15	9369114	.	T	C	10	13	23	0	0	23	0	0
15	9369344	.	G	T	7	5	12	0	0	12	0	0
15	9369571	.	A	T	9	7	16	0	1	17	0	0
15	9369610	.	A	T	10	6	16	0	0	16	0	0
15	9369651	.	G	C	7	9	16	0	0	17	1	0
15	9369689	.	G	A	7	13	20	0	0	20	0	0
15	9369733	.	C	T	12	6	18	0	1	19	0	0
15	9369737	.	C	G	7	12	19	0	0	19	0	0
15	9369903	.	A	T	8	3	11	0	1	12	0	0
15	9369914	.	T	A	11	5	16	0	0	16	0	0
15	9370096	.	T	C	4	9	13	0	0	13	0	0
15	9370115	.	G	A	10	6	16	0	0	16	0	0
15	9370131	.	C	T	11	6	17	0	2	19	0	0
15	9370477	.	A	G	6	5	11	0	1	12	0	0
15	9370492	.	C	G	8	4	12	0	1	13	0	0
15	9370534	.	T	A	9	4	13	0	0	13	0	0
15	9370553	.	C	T	4	11	15	0	0	15	0	0
15	9370919	.	G	T	9	8	17	0	1	18	0	0
15	9370967	.	T	C	6	0	6	0	9	15	0	0
15	9371303	.	G	A	8	9	17	0	0	17	0	0
15	9371564	.	A	G	10	5	15	0	1	16	0	0
15	9371657	.	T	C	8	3	11	0	1	12	0	0
15	9371678	.	A	G	8	5	13	0	2	15	0	0
15	9372053	.	T	C	10	5	15	0	1	16	0	0
15	9372281	.	C	T	9	3	12	0	5	17	0	0
15	9372356	.	T	A	10	7	17	0	0	17	0	0
15	9372500	.	G	A	6	7	13	0	1	14	0	0
15	9372539	.	G	A	9	8	17	0	0	17	0	0
15	9372730	.	G	A	1	8	9	0	1	10	0	0
15	9372929	.	C	T	4	3	7	0	0	7	0	0
15	9373205	.	G	A	7	3	10	0	0	10	0	0
15	9373698	.	T	C	5	4	9	0	1	10	0	0
15	9373901	.	G	T	2	5	7	0	0	7	0	0
15	9373967	.	A	G	1	4	5	0	0	5	0	0
15	9374174	.	T	C	6	2	8	0	0	8	0	0
15	9374363	.	G	A	4	5	9	0	0	9	0	0
15	9374627	.	A	T	4	8	12	0	0	12	0	0
15	9374860	.	A	T	4	3	7	0	2	9	0	0
15	9374894	.	T	C	3	2	5	0	0	5	0	0
15	9375002	.	G	T	1	2	3	0	0	3	0	0
15	9375542	.	C	T	3	3	6	0	1	7	0	0
15	9375767	.	C	G	2	2	4	0	0	4	0	0
15	9375773	.	A	G	2	2	4	0	0	4	0	0
15	9377192	.	A	G	4	8	12	0	0	12	0	0
15	9378090	.	A	T	4	2	6	0	0	6	0	0
15	9379178	.	A	G	4	4	8	0	0	8	0	0
15	9379394	.	C	T	3	4	7	0	0	7	0	0
15	9379485	.	T	C	3	5	8	0	0	8	0	0
15	9379868	.	A	G	2	4	6	0	0	6	0	0
15	9380048	.	G	T	5	3	8	0	0	8	0	0
15	9380101	.	A	G	3	2	5	0	0	5	0	0
15	9382214	.	T	A	4	3	7	0	0	7	0	0
15	9382293	.	G	T	1	2	3	0	0	3	0	0
15	9389731	.	G	A	1	2	3	0	0	3	0	0
15	9390019	.	A	G	1	3	4	0	0	4	0	0
15	9390112	.	T	G	1	4	5	0	0	5	0	0
15	9394113	.	C	T	0	2	2	0	4	6	0	0
15	9394125	.	C	T	4	3	7	0	0	7	0	0
15	9394152	.	A	G	4	3	7	0	0	7	0	0
15	9421380	.	A	G	1	2	3	0	0	3	0	0
15	9421400	.	T	C	1	2	3	0	0	3	0	0
15	9445444	.	A	T	5	3	8	0	0	8	0	0
15	9461812	.	A	T	2	3	5	0	0	5	0	0
15	9466908	.	A	G	5	3	8	0	0	8	0	0
15	9466938	.	T	C	3	4	7	0	0	7	0	0
15	9608255	.	G	T	2	4	6	0	0	6	0	0
15	9608264	.	A	T	1	4	5	0	0	5	0	0
15	9613343	.	G	T	1	4	5	0	0	5	0	0
15	9617050	.	A	G	1	2	3	0	0	3	0	0
15	9617134	.	T	C	1	0	1	0	5	6	0	0
15	10001851	.	A	G	11	16	27	0	0	27	0	0
15	10002281	.	G	A	9	9	18	0	1	19	0	0
15	10002317	.	G	A	11	7	18	0	0	18	0	0
15	10002478	.	T	C	2	2	4	0	0	4	0	0
15	10002480	.	T	A	2	2	4	0	0	4	0	0
15	10002545	.	C	T	8	5	13	0	0	13	0	0
15	10002591	.	A	G	7	9	16	0	0	16	0	0
15	10003274	.	C	T	12	12	24	0	1	25	0	0
15	10003357	.	G	A	7	7	14	0	0	14	0	0
15	10003379	.	G	A	8	4	12	0	0	12	0	0
15	10003647	.	C	T	0	7	7	0	5	12	0	0
15	10003767	.	C	T	0	3	3	0	5	8	0	0
15	10025010	.	T	C	13	7	20	0	0	20	0	0
15	10025185	.	A	G	5	5	10	0	2	12	0	0
15	10025508	.	A	G	5	5	10	0	0	10	0	0
15	10025601	.	G	C	6	1	7	0	12	19	0	0
15	10025688	.	G	A	1	5	6	0	0	6	0	0
15	10025760	.	T	G	6	7	13	0	0	13	0	0
15	10025949	.	C	T	9	6	15	0	0	15	0	0
15	10027257	.	T	C	2	7	9	0	0	9	0	0
15	10027296	.	A	G	3	7	10	0	0	10	0	0
15	10039775	.	A	G	6	10	16	1	0	17	0	0
15	10065534	.	T	A	14	7	21	0	0	21	0	0
15	10065645	.	A	G	11	7	18	0	0	18	0	0
15	10065663	.	A	G	8	5	13	0	1	14	0	0
15	10065735	.	G	A	2	3	5	0	0	5	0	0
15	10065786	.	T	C	6	0	6	0	5	11	0	0
15	10065843	.	T	G	7	6	13	0	0	13	0	0
15	10065846	.	A	G	6	5	11	0	1	12	0	0
15	10066287	.	A	G	5	4	9	0	0	9	0	0
15	10081882	.	G	A	7	3	10	0	0	10	0	0
15	10081902	.	G	A	7	4	11	0	0	11	0	0
15	10081966	.	G	A	4	10	14	0	0	14	0	0
15	10088507	.	G	A	6	2	8	0	0	8	0	0
15	10088588	.	C	T	3	7	10	0	0	10	0	0
15	10107512	.	C	T	12	4	16	0	0	16	0	0
15	10107545	.	C	G	0	6	6	0	5	11	0	0
15	10114779	.	G	A	10	5	15	0	0	15	0	0
15	10114788	.	A	G	11	3	14	0	0	14	0	0
15	10114854	.	T	C	7	1	8	0	5	13	0	0
15	10114884	.	G	A	10	6	16	0	0	16	0	0
15	10114932	.	C	T	7	8	15	0	0	15	0	0
15	10207324	.	T	G	2	4	6	0	0	6	0	0
15	10215720	.	G	A	4	3	7	0	1	8	0	0
15	10229677	.	C	T	5	2	7	0	0	7	0	0
15	10340978	.	G	C	4	3	7	0	0	7	0	0
15	10341020	.	A	G	2	2	4	0	1	5	0	0
15	10341041	.	G	A	2	3	5	1	0	6	0	0
15	10455411	.	G	A	4	3	7	0	0	7	0	0
15	11668065	.	A	G	4	2	6	0	0	6	0	0
15	11668633	.	C	T	3	7	10	0	0	10	0	0
15	11669761	.	C	T	2	2	4	0	0	4	0	0
15	11670283	.	A	C	4	4	8	0	1	9	0	0
15	11680132	.	C	T	3	3	6	0	0	6	0	0
15	11681447	.	A	G	4	5	9	0	0	9	0	0
15	11690967	.	T	C	3	7	10	0	0	10	0	0
15	11691008	.	T	G	5	0	5	0	5	10	0	0
15	11757580	.	T	A	12	7	19	0	4	23	0	0
15	11874021	.	A	G	4	0	4	0	4	8	0	0
15	11874022	.	A	T	5	3	8	0	0	8	0	0
15	11874077	.	T	C	3	2	5	0	1	6	0	0
15	11874647	.	T	C	3	3	6	0	0	6	0	0
15	13107454	.	T	A	2	2	4	0	0	4	0	0
15	13986586	.	C	T	3	3	6	0	7	13	0	0
15	14631930	.	T	C	4	11	15	0	0	15	0	0
15	14631936	.	T	C	11	0	11	0	6	17	0	0
15	16937375	.	T	C	7	7	14	0	0	14	0	0
15	16937653	.	T	C	3	5	8	0	0	8	0	0
15	16937662	.	T	C	2	2	4	0	7	11	0	0
15	16937740	.	T	C	10	2	12	0	0	12	0	0
15	16937741	.	T	C	10	0	10	0	2	12	0	0
15	17124296	.	A	G	14	4	18	0	1	19	0	0
15	17424271	.	G	A	4	5	9	0	5	14	0	0
15	17424274	.	G	A	5	1	6	0	4	10	0	0
15	17487526	.	A	G	21	7	28	0	0	28	0	0
15	17487544	.	A	G	10	13	23	0	0	23	0	0
15	17487561	.	A	G	18	9	27	0	0	27	0	0
15	17866447	.	C	A	4	3	7	0	0	7	0	0
15	19209468	.	G	A	8	9	17	0	0	17	0	0
15	19250469	.	G	C	9	5	14	0	0	14	0	0
15	19293919	.	G	T	17	15	32	0	2	34	0	0
15	19293920	.	G	T	17	16	33	0	1	34	0	0
15	19301259	.	A	G	9	10	19	0	1	20	0	0
15	19311505	.	G	T	1	4	5	0	15	20	0	0
15	19316319	.	T	G	5	2	7	0	0	7	0	0
15	19316437	.	C	A	8	4	12	0	0	12	0	0
15	19316497	.	A	T	4	8	12	0	0	12	0	0
15	19316573	.	T	C	6	6	12	0	0	12	0	0
15	19317065	.	G	A	0	2	2	0	1	3	0	0
15	19318382	.	G	A	2	4	6	0	0	6	0	0
15	19318445	.	T	G	8	0	8	0	4	12	0	0
15	19318513	.	T	A	4	2	6	0	0	6	0	0
15	19318545	.	G	T	5	3	8	0	0	8	0	0
15	19318927	.	A	C	2	3	5	0	1	6	0	0
15	19318943	.	G	A	0	3	3	0	0	3	0	0
15	19319077	.	T	A	5	2	7	0	0	7	0	0
15	19319128	.	A	C	6	4	10	0	0	10	0	0
15	19319150	.	A	G	7	0	7	0	4	11	0	0
15	19319227	.	C	G	10	7	17	0	0	17	0	0
15	19319250	.	T	C	12	9	21	0	0	21	0	0
15	19319272	.	G	C	11	6	17	0	0	17	0	0
15	19319429	.	G	A	2	3	5	0	0	5	0	0
15	19319666	.	A	G	5	1	6	0	2	8	0	0
15	19319691	.	A	T	3	4	7	0	0	7	0	0
15	19324762	.	T	A	5	6	11	0	1	12	0	0
15	19324910	.	C	A	7	4	11	0	1	12	0	0
15	19327602	.	C	G	3	3	6	0	0	6	0	0
15	19327665	.	G	A	0	9	9	0	5	14	0	0
15	19328334	.	G	A	14	7	21	0	0	21	0	0
15	19329944	.	G	A	8	12	20	0	0	20	0	0
15	19329950	.	C	T	8	14	22	0	0	22	0	0
15	19330144	.	C	T	7	8	15	0	0	15	0	0
15	19330652	.	A	G	4	0	4	0	8	12	0	0
15	19331011	.	C	A	4	3	7	0	0	7	0	0
15	19336799	.	G	A	4	3	7	0	1	8	0	0
15	19337247	.	A	C	9	9	18	0	0	18	0	0
15	19337251	.	C	T	9	9	18	0	0	18	0	0
15	19345530	.	G	T	8	11	19	0	0	19	0	0
15	19345614	.	C	T	10	12	22	0	1	23	0	0
15	19347821	.	C	T	1	6	7	0	0	7	0	0
15	19347878	.	G	T	13	5	18	0	0	18	0	0
15	19348038	.	A	G	7	3	10	0	0	10	0	0
15	19348275	.	C	T	8	4	12	0	1	13	0	0
15	19355138	.	G	A	1	2	3	0	0	3	0	0
15	19472530	.	C	A	1	5	6	0	0	6	0	0
15	19482877	.	A	C	3	4	7	0	0	7	0	0
15	19522085	.	T	C	5	10	15	0	0	15	0	0
15	19544143	.	T	C	7	3	10	0	0	10	0	0
15	19561226	.	A	G	6	0	6	0	8	14	0	0
15	19576879	.	A	G	12	10	22	0	2	24	0	0
15	19577066	.	C	T	11	10	21	0	0	21	0	0
15	19577072	.	C	T	9	10	19	0	0	19	0	0
15	19577242	.	G	A	7	6	13	0	0	13	0	0
15	19577367	.	C	A	11	8	19	0	1	20	0	0
15	19577377	.	T	C	9	7	16	0	1	17	0	0
15	19583841	.	C	T	17	14	31	0	0	31	0	0
15	19584132	.	G	T	13	8	21	0	0	21	0	0
15	19584187	.	T	C	19	8	27	0	0	27	0	0
15	19595508	.	C	T	15	17	32	0	3	35	0	0
15	19595509	.	T	G	19	1	20	0	16	36	0	0
15	19600214	.	C	T	10	10	20	0	0	20	0	0
15	19600390	.	A	T	6	3	9	0	0	9	0	0
15	19600570	.	A	C	8	7	15	0	0	15	0	0
15	19600589	.	C	T	9	6	15	0	0	15	0	0
15	19600606	.	A	G	11	1	12	0	5	17	0	0
15	19661664	.	T	A	9	6	15	0	0	15	0	0
15	19661756	.	T	A	10	6	16	0	2	18	0	0
15	19661820	.	G	T	13	10	23	0	0	23	0	0
15	19668294	.	T	G	6	10	16	0	0	16	0	0
15	19668354	.	A	G	8	10	18	0	0	18	0	0
15	19668375	.	G	A	11	12	23	0	0	23	0	0
15	19668534	.	A	G	10	12	22	0	0	22	0	0
15	19668558	.	G	A	11	13	24	0	0	24	0	0
15	19668585	.	A	G	8	15	23	0	1	24	0	0
15	19668638	.	T	G	8	12	20	0	0	20	0	0
15	19669146	.	T	C	11	0	11	0	9	20	0	0
15	19674676	.	G	A	8	9	17	0	0	17	0	0
15	19726987	.	C	A	2	4	6	0	0	6	0	0
15	19727056	.	A	C	2	3	5	0	0	5	0	0
15	19727184	.	T	C	1	3	4	0	0	4	0	0
15	19728131	.	A	T	4	9	13	0	0	14	1	0
15	19728638	.	A	G	21	22	43	0	2	45	0	0
15	19728853	.	T	A	10	10	20	0	3	23	0	0
15	19728989	.	A	C	16	6	22	0	0	23	1	0
15	19737755	.	C	T	3	17	20	0	17	37	0	0
15	19742655	.	T	C	13	18	31	0	1	32	0	0
15	19745764	.	C	A	2	16	18	0	10	29	1	0
15	19760449	.	T	C	4	10	14	0	1	15	0	0
15	19772261	.	C	A	4	10	14	0	16	31	1	0
15	19867676	.	A	C	2	2	4	0	0	4	0	0
15	19867729	.	T	C	3	8	11	0	0	11	0	0
15	19870165	.	C	T	5	2	7	0	1	8	0	0
15	19870174	.	G	A	6	2	8	0	0	8	0	0
15	19875030	.	G	A	0	2	2	0	7	9	0	0
15	19878798	.	A	G	1	3	4	0	0	4	0	0
15	19891082	.	A	T	9	9	18	0	1	19	0	0
15	19891939	.	T	C	10	12	22	0	2	24	0	0
15	19892083	.	G	A	0	10	10	0	8	18	0	0
15	19894898	.	T	G	5	0	5	0	8	13	0	0
15	19895285	.	A	G	11	5	16	0	1	17	0	0
15	19895304	.	T	A	11	7	18	0	1	19	0	0
15	19895991	.	A	G	9	0	9	0	6	15	0	0
15	19896052	.	A	C	7	10	17	0	3	20	0	0
15	19900319	.	A	T	2	6	8	0	0	8	0	0
15	19907233	.	T	C	4	6	10	0	0	10	0	0
15	19907241	.	A	G	4	6	10	0	0	10	0	0
15	19907543	.	G	T	1	5	6	0	0	6	0	0
15	19908328	.	T	A	4	6	10	0	0	10	0	0
15	19908340	.	T	A	4	5	9	0	0	9	0	0
15	19908777	.	A	T	5	8	13	0	0	13	0	0
15	19925978	.	G	A	7	9	16	0	3	19	0	0
15	19991372	.	G	C	1	2	3	0	0	3	0	0
15	20003130	.	G	A	5	4	9	0	0	9	0	0
15	20004823	.	T	A	3	2	5	0	0	5	0	0
15	20004837	.	C	A	4	2	6	0	0	6	0	0
15	20005301	.	A	G	8	4	12	0	0	12	0	0
15	20005943	.	A	G	4	10	14	0	1	15	0	0
15	20006747	.	T	G	7	6	13	0	2	15	0	0
15	20007033	.	T	A	9	9	18	0	0	18	0	0
15	20008357	.	C	T	7	6	13	0	1	14	0	0
15	20008513	.	C	T	6	10	16	0	1	17	0	0
15	20012049	.	G	T	5	4	9	0	2	11	0	0
15	20012153	.	G	A	4	5	9	0	1	10	0	0
15	20012199	.	G	T	7	4	11	0	1	12	0	0
15	20061367	.	G	A	13	6	19	0	0	19	0	0
15	20065029	.	T	C	10	9	19	0	2	21	0	0
15	20065074	.	G	A	8	6	14	0	0	14	0	0
15	20065125	.	A	G	7	14	21	0	0	21	0	0
15	20069165	.	T	C	11	5	16	0	0	16	0	0
15	20069201	.	G	A	5	6	11	0	1	12	0	0
15	20071596	.	G	A	7	9	16	0	0	16	0	0
15	20071713	.	T	C	6	7	13	0	0	13	0	0
15	20074627	.	A	G	4	4	8	0	1	9	0	0
15	20076928	.	C	T	5	6	11	0	1	12	0	0
15	20081245	.	T	G	8	14	22	0	1	23	0	0
15	20081275	.	T	A	13	8	21	0	0	21	0	0
15	20081731	.	G	A	15	7	22	0	1	23	0	0
15	20081806	.	T	G	11	11	22	0	2	24	0	0
15	20081903	.	G	A	10	7	17	0	0	17	0	0
15	20088588	.	A	G	1	2	3	0	0	3	0	0
15	20097365	.	G	A	6	3	9	0	1	10	0	0
15	20111554	.	G	A	2	2	4	0	0	4	0	0
15	20111624	.	G	A	3	6	9	0	0	9	0	0
15	20117970	.	G	A	5	3	8	0	0	8	0	0
15	20124761	.	G	A	5	5	10	0	0	10	0	0
15	20204850	.	T	G	5	2	7	0	0	7	0	0
15	20204873	.	C	T	1	5	6	0	1	7	0	0
15	20205074	.	A	C	2	3	5	0	0	5	0	0
15	20205146	.	G	T	1	2	3	0	0	3	0	0
15	20350535	.	G	A	2	2	4	0	0	4	0	0
15	20369562	.	G	A	13	14	27	0	0	27	0	0
15	20374712	.	G	A	1	6	7	0	3	10	0	0
15	20376393	.	A	G	16	6	22	0	1	23	0	0
15	20377873	.	A	T	4	13	17	0	0	17	0	0
15	20377946	.	C	T	13	10	23	0	0	23	0	0
15	20378302	.	C	T	12	6	18	0	1	19	0	0
15	20378479	.	T	C	12	12	24	0	0	24	0	0
15	20379860	.	C	T	5	13	18	0	0	18	0	0
15	20380144	.	C	A	8	9	17	0	0	17	0	0
15	20383150	.	C	T	18	14	32	0	0	32	0	0
15	20384539	.	A	G	29	3	32	0	24	56	0	0
15	20394672	.	T	C	18	15	33	1	1	35	0	0
15	20395141	.	G	A	1	13	14	0	9	23	0	0
15	20406270	.	A	C	5	3	8	0	0	8	0	0
15	20406413	.	C	T	1	3	4	0	4	8	0	0
15	20406484	.	G	C	4	7	11	0	0	11	0	0
15	20407026	.	T	A	5	5	10	0	0	10	0	0
15	20407045	.	G	A	2	2	4	0	0	4	0	0
15	20407938	.	G	T	9	12	21	0	0	21	0	0
15	20407951	.	G	T	7	13	20	0	0	20	0	0
15	20411321	.	G	A	8	9	17	0	0	17	0	0
15	20412107	.	G	T	6	6	12	0	0	12	0	0
15	20412171	.	G	C	10	17	27	0	0	27	0	0
15	20463842	.	A	G	3	2	5	0	0	5	0	0
15	20475817	.	A	G	2	5	7	0	1	8	0	0
15	20478820	.	G	A	9	14	23	0	0	23	0	0
15	20479056	.	A	G	4	6	10	0	0	10	0	0
15	20489875	.	G	A	3	6	9	0	1	10	0	0
15	20525533	.	C	T	6	3	9	0	1	10	0	0
15	20535215	.	T	G	2	3	5	0	0	5	0	0
15	20535445	.	T	C	2	3	5	0	0	5	0	0
15	20535475	.	C	T	3	4	7	0	0	7	0	0
15	20540641	.	T	A	3	3	6	0	1	7	0	0
15	20603373	.	T	C	4	6	10	0	0	10	0	0
15	20605179	.	G	A	4	6	10	0	0	10	0	0
15	20605194	.	G	A	4	6	10	0	0	10	0	0
15	20607323	.	C	T	9	4	13	0	0	13	0	0
15	20624759	.	G	T	5	7	12	0	0	12	0	0
15	20628220	.	G	A	12	5	17	0	0	17	0	0
15	20629658	.	T	C	8	7	15	0	0	15	0	0
15	20637832	.	C	T	7	6	13	0	0	13	0	0
15	20652746	.	G	A	5	6	11	0	0	11	0	0
15	20652813	.	A	T	12	16	28	0	1	29	0	0
15	20652955	.	A	G	23	16	39	0	0	39	0	0
15	20653005	.	T	A	17	21	38	0	1	39	0	0
15	20653258	.	T	A	30	13	43	0	0	43	0	0
15	20709184	.	T	A	5	8	13	0	2	15	0	0
15	20709340	.	G	C	22	10	32	0	0	32	0	0
15	20709490	.	A	G	16	17	33	0	2	35	0	0
15	20709925	.	G	A	23	15	38	0	1	39	0	0
15	20731260	.	G	C	25	15	40	0	2	42	0	0
15	20731559	.	G	A	1	2	3	0	0	3	0	0
15	20808163	.	G	A	1	5	6	0	0	6	0	0
15	20832831	.	C	T	7	14	21	0	0	21	0	0
15	20833018	.	A	G	6	11	17	0	3	20	0	0
15	20833302	.	A	G	3	3	6	0	0	6	0	0
15	20833310	.	A	G	2	3	5	0	1	6	0	0
15	20836008	.	A	G	2	3	5	0	0	5	0	0
15	20837927	.	G	A	4	4	8	0	1	9	0	0
15	20843256	.	T	C	10	4	14	0	0	14	0	0
15	20843348	.	C	T	3	11	14	0	0	14	0	0
15	20843441	.	C	T	7	9	16	0	0	16	0	0
15	20843859	.	G	C	1	2	3	0	5	8	0	0
15	20843974	.	A	T	7	6	13	0	0	13	0	0
15	20844016	.	C	T	6	8	14	0	2	16	0	0
15	20844018	.	C	T	8	9	17	0	0	17	0	0
15	20844074	.	A	C	8	5	13	0	0	13	0	0
15	20869195	.	C	T	10	9	19	0	0	19	0	0
15	20872763	.	T	C	6	11	17	0	0	17	0	0
15	20875296	.	C	T	9	15	24	0	0	24	0	0
15	20883185	.	A	T	22	11	33	0	4	37	0	0
15	20886090	.	T	C	10	10	20	0	0	20	0	0
15	20891154	.	T	A	13	10	23	0	2	26	1	0
15	20893920	.	T	A	4	7	11	0	0	11	0	0
15	20894094	.	A	G	10	0	10	0	16	26	0	0
15	20894177	.	C	A	13	20	33	0	1	34	0	0
15	20901053	.	T	C	16	18	34	0	1	35	0	0
15	20901133	.	A	G	17	16	33	0	0	33	0	0
15	20901366	.	T	A	18	24	42	0	2	44	0	0
15	20901540	.	C	T	1	9	10	1	11	22	0	0
15	20901562	.	G	A	17	11	28	0	0	28	0	0
15	20907603	.	A	G	16	7	23	0	0	23	0	0
15	22046568	.	T	C	6	3	9	0	0	9	0	0
15	22046647	.	T	C	10	4	14	0	0	14	0	0
15	22046954	.	T	C	4	0	4	0	8	12	0	0
15	22046965	.	G	C	3	8	11	0	0	11	0	0
15	22047054	.	G	A	1	3	4	0	0	4	0	0
15	22047389	.	T	C	3	5	8	0	0	8	0	0
15	22074090	.	A	G	3	5	8	0	0	8	0	0
15	22074224	.	G	A	11	6	17	0	1	18	0	0
15	22133987	.	A	C	9	2	11	0	6	17	0	0
15	22143027	.	G	A	21	12	33	0	2	35	0	0
15	22147174	.	C	G	14	17	31	0	0	31	0	0
15	22147186	.	G	T	13	13	26	0	1	27	0	0
15	22272412	.	A	C	1	2	3	0	0	3	0	0
15	22272427	.	A	G	1	0	1	0	2	3	0	0
15	22319721	.	C	T	3	8	11	0	0	11	0	0
15	22319797	.	C	T	6	6	12	0	0	12	0	0
15	22319830	.	G	A	4	3	7	0	0	7	0	0
15	22324529	.	A	T	2	12	14	0	0	14	0	0
15	22324538	.	T	A	3	11	14	0	1	15	0	0
15	22324760	.	A	G	15	13	28	0	2	30	0	0
15	22324948	.	T	C	9	10	19	0	0	19	0	0
15	22325007	.	C	T	10	5	15	0	0	15	0	0
15	22325278	.	A	G	9	0	9	0	4	13	0	0
15	22325617	.	G	T	3	12	15	1	0	16	0	0
15	22435473	.	G	A	9	8	17	0	0	17	0	0
15	22435565	.	T	G	12	0	12	0	14	26	0	0
15	22435632	.	C	G	9	6	15	0	1	16	0	0
15	22435655	.	C	T	7	3	10	0	1	11	0	0
15	22441639	.	C	T	4	7	11	0	0	11	0	0
15	22441703	.	C	T	7	9	16	0	1	17	0	0
15	22441744	.	A	G	6	9	15	0	0	15	0	0
15	22441855	.	C	T	4	10	14	0	2	16	0	0
15	22441900	.	T	C	7	7	14	0	1	15	0	0
15	22441972	.	G	A	11	12	23	0	1	24	0	0
15	22442713	.	A	T	12	9	21	0	0	21	0	0
15	22442875	.	G	A	1	10	11	0	7	18	0	0
15	22443048	.	T	G	5	3	8	1	2	11	0	0
15	22443136	.	C	T	11	13	24	0	0	24	0	0
15	22443282	.	C	T	8	12	20	0	1	21	0	0
15	22443289	.	A	T	10	13	23	0	0	23	0	0
15	22443460	.	G	A	3	6	9	0	13	22	0	0
15	22443462	.	A	G	12	0	12	0	9	21	0	0
15	22443520	.	A	G	11	10	21	0	2	23	0	0
15	22443615	.	G	A	9	12	21	0	1	22	0	0
15	22443630	.	G	T	1	13	14	0	14	29	1	0
15	22443798	.	A	G	20	12	32	0	1	33	0	0
15	22443858	.	A	G	18	14	32	0	2	34	0	0
15	22443934	.	G	A	0	23	23	0	15	38	0	0
15	22444062	.	A	G	20	13	33	0	2	35	0	0
15	22444239	.	G	A	2	14	16	0	15	31	0	0
15	22444266	.	A	G	16	15	31	0	0	31	0	0
15	22444310	.	T	A	14	15	29	0	0	29	0	0
15	22444331	.	G	A	13	9	22	0	0	22	0	0
15	22444483	.	T	G	6	2	8	0	5	13	0	0
15	22444486	.	A	T	6	5	11	0	1	12	0	0
15	22444524	.	T	C	4	3	7	0	1	8	0	0
15	22448610	.	G	C	2	2	4	0	1	5	0	0
15	22500750	.	G	A	1	6	7	0	3	10	0	0
15	22502831	.	C	A	4	2	6	0	1	7	0	0
15	22503346	.	A	G	2	0	2	0	2	4	0	0
15	22510996	.	G	A	5	3	8	0	1	9	0	0
15	22516432	.	C	A	5	5	10	0	0	10	0	0
15	22516625	.	G	A	10	8	18	0	0	18	0	0
15	22524099	.	C	A	6	2	8	0	0	8	0	0
15	22526258	.	C	T	4	4	8	0	1	9	0	0
15	22533518	.	G	A	3	9	12	0	1	13	0	0
15	22536756	.	C	T	2	4	6	0	1	7	0	0
15	22536795	.	G	C	0	2	2	0	4	6	0	0
15	22537008	.	T	A	5	4	9	0	0	9	0	0
15	22537096	.	T	C	1	12	13	0	1	14	0	0
15	22722694	.	C	T	7	3	10	0	0	10	0	0
15	22945140	.	G	A	4	2	6	0	0	6	0	0
15	22976939	.	T	C	3	3	6	0	0	6	0	0
15	22976943	.	T	C	3	4	7	0	1	8	0	0
15	22999133	.	T	C	2	2	4	0	0	4	0	0
15	22999151	.	C	T	2	2	4	0	0	4	0	0
15	23006951	.	T	G	1	0	1	0	3	4	0	0
15	23060885	.	T	C	8	2	10	0	0	10	0	0
15	23181511	.	C	A	3	6	9	0	0	9	0	0
15	23187879	.	T	A	5	6	11	0	0	11	0	0
15	23187902	.	T	G	7	1	8	0	5	13	0	0
15	23188188	.	T	G	4	4	8	0	0	8	0	0
15	23188190	.	C	T	3	4	7	0	0	7	0	0
15	23188245	.	T	A	3	5	8	0	0	8	0	0
15	23208223	.	G	C	5	2	7	0	0	7	0	0
15	23208341	.	G	C	2	2	4	0	0	4	0	0
15	23243797	.	T	C	4	2	6	0	0	6	0	0
15	23243860	.	G	A	0	6	6	0	5	11	0	0
15	23244071	.	T	C	5	3	8	0	1	9	0	0
15	23244134	.	A	C	6	4	10	0	1	11	0	0
15	23255643	.	T	C	8	7	15	0	0	15	0	0
15	23256320	.	C	T	10	17	27	0	0	27	0	0
15	23256449	.	T	C	15	7	22	0	1	23	0	0
15	23256674	.	C	T	7	8	15	0	0	15	0	0
15	23256779	.	G	A	1	6	7	0	10	17	0	0
15	23264471	.	G	A	0	7	7	2	10	19	0	0
15	23264547	.	G	A	3	9	12	0	12	24	0	0
15	23264945	.	T	C	15	6	21	0	0	21	0	0
15	23265217	.	C	T	8	5	13	0	0	13	0	0
15	23272060	.	C	T	1	4	5	0	0	5	0	0
15	23273262	.	G	A	5	10	15	0	1	16	0	0
15	23273456	.	C	T	8	3	11	0	0	11	0	0
15	23280990	.	G	A	3	4	7	0	0	7	0	0
15	23281017	.	C	G	2	3	5	0	0	5	0	0
15	23281046	.	T	C	5	3	8	0	0	8	0	0
15	23282503	.	G	A	6	4	10	0	0	10	0	0
15	23282608	.	C	T	6	2	8	0	0	8	0	0
15	23284990	.	A	G	4	4	8	0	0	8	0	0
15	23285213	.	T	A	3	5	8	0	0	8	0	0
15	23286306	.	T	A	1	2	3	0	0	3	0	0
15	23286311	.	A	G	1	2	3	0	0	3	0	0
15	23286550	.	T	A	4	2	6	0	0	6	0	0
15	23342660	.	T	G	3	3	6	0	0	6	0	0
15	23356816	.	C	T	3	3	6	0	0	6	0	0
15	23356824	.	C	A	3	2	5	0	0	5	0	0
15	23357114	.	C	G	2	4	6	0	1	7	0	0
15	23357369	.	C	T	3	5	8	0	0	8	0	0
15	23357402	.	G	A	0	5	5	0	5	10	0	0
15	23357909	.	C	T	4	2	6	0	0	6	0	0
15	23357915	.	G	A	2	4	6	0	0	6	0	0
15	23357957	.	G	C	7	3	10	0	1	11	0	0
15	23358257	.	C	A	4	5	9	0	0	9	0	0
15	23369217	.	T	C	1	3	4	0	0	4	0	0
15	23386976	.	C	T	6	11	17	0	8	25	0	0
15	23387010	.	A	G	11	12	23	0	0	23	0	0
15	23387334	.	G	A	10	8	18	0	1	19	0	0
15	23387567	.	G	A	12	7	19	0	1	20	0	0
15	23387577	.	G	A	8	12	20	0	1	21	0	0
15	23388471	.	G	T	19	10	29	0	1	30	0	0
15	23388609	.	C	T	17	9	26	0	1	27	0	0
15	23389139	.	C	G	9	6	15	0	1	16	0	0
15	23389689	.	A	G	8	7	15	0	0	15	0	0
15	23389809	.	G	A	8	4	12	0	0	12	0	0
15	23391110	.	C	T	4	5	9	0	0	9	0	0
15	23391196	.	G	A	4	4	8	0	0	8	0	0
15	23391411	.	A	G	3	3	6	0	0	6	0	0
15	23391741	.	A	G	7	13	20	0	1	21	0	0
15	23394773	.	G	A	3	8	11	0	0	11	0	0
15	23397588	.	A	G	5	8	13	0	0	13	0	0
15	23397614	.	C	T	1	4	5	0	8	13	0	0
15	23397987	.	C	T	7	7	14	0	0	14	0	0
15	23398053	.	G	A	4	4	8	0	0	8	0	0
15	23400770	.	G	A	12	5	17	1	0	18	0	0
15	23400954	.	G	A	10	9	19	0	1	20	0	0
15	23400961	.	A	G	16	9	25	0	0	25	0	0
15	23402432	.	G	A	6	4	10	0	0	10	0	0
15	23403071	.	G	A	11	7	18	0	0	18	0	0
15	23403097	.	A	G	12	10	22	0	0	22	0	0
15	23403191	.	T	C	12	0	12	0	4	16	0	0
15	23403668	.	T	C	8	2	10	0	2	12	0	0
15	23404421	.	T	C	3	0	3	0	6	9	0	0
15	23404883	.	T	A	9	4	13	0	0	13	0	0
15	23405102	.	T	C	3	4	7	0	0	7	0	0
15	23405503	.	T	C	3	0	3	0	5	8	0	0
15	23419931	.	T	A	5	7	12	0	0	12	0	0
15	23423674	.	C	T	4	8	12	0	0	12	0	0
15	23423724	.	G	A	7	2	9	0	0	9	0	0
15	23426717	.	T	A	11	13	24	0	0	24	0	0
15	23427075	.	G	A	8	9	17	0	0	17	0	0
15	23429593	.	G	A	12	8	20	0	0	20	0	0
15	23429915	.	G	A	12	12	24	0	2	26	0	0
15	23431734	.	C	T	0	4	4	0	21	25	0	0
15	23434037	.	G	A	8	5	13	0	1	14	0	0
15	23434242	.	C	T	5	8	13	0	1	14	0	0
15	23434251	.	G	A	11	5	16	0	0	16	0	0
15	23437095	.	C	T	10	8	18	0	2	20	0	0
15	23437162	.	T	A	3	10	13	0	1	14	0	0
15	23440676	.	T	C	9	6	15	0	2	17	0	0
15	23440721	.	G	A	7	7	14	0	0	14	0	0
15	23440751	.	A	G	6	6	12	0	0	12	0	0
15	23442817	.	G	A	4	4	8	0	0	8	0	0
15	23442841	.	T	A	5	4	9	0	0	9	0	0
15	23442929	.	C	A	6	3	9	0	1	10	0	0
15	23442930	.	T	A	5	3	8	0	2	10	0	0
15	23450851	.	T	C	2	4	6	0	0	6	0	0
15	23468501	.	G	T	3	4	7	0	0	7	0	0
15	23468522	.	A	T	5	3	8	0	0	8	0	0
15	23468965	.	A	T	5	2	7	0	0	7	0	0
15	23474815	.	C	G	7	9	16	0	0	16	0	0
15	23475487	.	A	G	1	3	4	0	0	4	0	0
15	23475901	.	C	T	0	3	3	0	1	4	0	0
15	23475943	.	G	A	3	5	8	0	0	8	0	0
15	23478509	.	G	C	1	2	3	0	0	3	0	0
15	23478680	.	G	A	2	4	6	0	0	6	0	0
15	23480171	.	C	T	2	9	11	0	0	11	0	0
15	23480174	.	C	T	2	8	10	0	1	11	0	0
15	23499544	.	A	G	1	2	3	0	0	3	0	0
15	23499547	.	G	A	1	2	3	0	0	3	0	0
15	23512078	.	A	T	2	9	11	0	1	12	0	0
15	23512219	.	T	C	2	0	2	0	4	6	0	0
15	23512882	.	T	C	1	2	3	0	0	3	0	0
15	23513009	.	G	C	4	4	8	0	0	8	0	0
15	23514762	.	G	A	2	3	5	0	0	5	0	0
15	23520048	.	C	T	5	3	8	0	0	8	0	0
15	23520069	.	G	A	4	5	9	0	0	9	0	0
15	23520725	.	G	A	0	3	3	0	1	4	0	0
15	23524359	.	A	G	1	3	4	0	0	4	0	0
15	23528160	.	A	G	1	2	3	0	0	3	0	0
15	23528183	.	G	A	3	3	6	0	0	6	0	0
15	23529203	.	A	G	2	4	6	0	2	8	0	0
15	23529212	.	T	C	3	4	7	0	0	7	0	0
15	23529251	.	C	A	3	4	7	0	1	8	0	0
15	23531136	.	G	A	0	2	2	0	2	4	0	0
15	23531933	.	G	A	4	2	6	0	0	6	0	0
15	23532119	.	G	A	0	2	2	0	3	5	0	0
15	23532146	.	A	T	2	3	5	0	0	5	0	0
15	23532332	.	C	T	3	2	5	0	0	5	0	0
15	23532336	.	A	T	2	3	5	0	0	5	0	0
15	23540705	.	G	A	5	2	7	0	0	7	0	0
15	23541136	.	A	C	2	2	4	0	0	4	0	0
15	23541529	.	A	T	4	3	7	0	0	7	0	0
15	23541533	.	A	G	4	0	4	0	3	7	0	0
15	23551218	.	G	A	2	5	7	0	7	14	0	0
15	23551272	.	C	T	6	7	13	0	1	14	0	0
15	23551511	.	T	G	4	5	9	0	0	9	0	0
15	23551704	.	G	A	1	12	13	0	6	19	0	0
15	23551769	.	T	G	9	0	9	0	12	21	0	0
15	23551775	.	C	T	7	12	19	0	0	19	0	0
15	23617364	.	G	A	2	8	10	0	10	20	0	0
15	23617612	.	G	T	11	14	25	0	0	25	0	0
15	23619093	.	G	A	2	15	17	0	17	34	0	0
15	23620453	.	T	G	11	22	33	0	0	33	0	0
15	23620511	.	G	A	16	16	32	0	0	32	0	0
15	23620541	.	C	T	18	21	39	0	1	40	0	0
15	23627514	.	G	A	12	13	25	0	6	31	0	0
15	23640374	.	T	A	9	14	23	0	10	33	0	0
15	23640678	.	A	C	5	1	6	0	32	38	0	0
15	23641057	.	C	T	11	10	21	0	0	21	0	0
15	23641102	.	T	G	11	9	20	0	1	21	0	0
15	23641107	.	G	C	11	10	21	0	2	23	0	0
15	23641426	.	G	A	5	10	15	0	0	15	0	0
15	23662647	.	A	G	3	1	4	0	1	5	0	0
15	23670622	.	A	G	1	4	5	0	1	6	0	0
15	23675921	.	A	G	1	0	1	0	2	3	0	0
15	23677256	.	G	T	0	3	3	0	4	7	0	0
15	23677373	.	A	T	2	2	4	0	0	4	0	0
15	23677376	.	G	A	0	2	2	0	2	4	0	0
15	23684232	.	C	T	3	2	5	0	0	5	0	0
15	23686857	.	G	A	7	2	9	0	0	9	0	0
15	23686877	.	G	A	4	4	8	0	0	8	0	0
15	23688673	.	G	A	3	2	5	0	0	5	0	0
15	23689030	.	C	T	3	3	6	0	1	7	0	0
15	23689275	.	G	A	4	2	6	0	0	6	0	0
15	23689643	.	G	A	2	7	9	0	1	10	0	0
15	23694079	.	T	C	1	2	3	0	0	3	0	0
15	23709660	.	G	A	7	3	10	0	1	11	0	0
15	23710339	.	T	C	5	6	11	0	1	12	0	0
15	23710465	.	C	T	8	6	14	0	0	14	0	0
15	23710490	.	G	T	7	6	13	0	0	13	0	0
15	23710515	.	G	A	9	3	12	0	2	14	0	0
15	23710539	.	T	C	7	8	15	0	0	15	0	0
15	23710811	.	A	G	10	4	14	0	2	16	0	0
15	23711953	.	G	A	9	10	19	0	1	20	0	0
15	23712082	.	A	G	16	12	28	0	1	29	0	0
15	23713116	.	C	T	1	5	6	0	7	13	0	0
15	23713158	.	A	G	7	3	10	0	0	11	1	0
15	23713174	.	G	C	6	4	10	0	0	10	0	0
15	23713323	.	A	G	3	4	7	0	0	7	0	0
15	23713335	.	T	G	3	4	7	0	0	7	0	0
15	23713923	.	C	T	5	5	10	0	0	10	0	0
15	23718008	.	G	A	11	9	20	0	0	20	0	0
15	23718403	.	C	T	9	10	19	0	0	19	0	0
15	23722824	.	A	T	10	7	17	0	0	17	0	0
15	23724153	.	G	A	8	5	13	0	1	14	0	0
15	23730816	.	C	A	5	2	7	0	0	7	0	0
15	23733485	.	C	A	8	3	11	0	0	11	0	0
15	23738914	.	C	T	12	6	18	0	0	18	0	0
15	23738915	.	G	C	0	6	6	0	12	18	0	0
15	23739032	.	C	T	5	2	7	0	0	7	0	0
15	23745659	.	G	A	3	2	5	0	2	7	0	0
15	23745952	.	C	T	2	5	7	0	0	7	0	0
15	23746655	.	A	T	4	5	9	0	0	9	0	0
15	23746674	.	G	A	2	2	4	0	0	4	0	0
15	23780791	.	A	T	2	2	4	0	3	7	0	0
15	23781320	.	G	A	4	3	7	0	1	8	0	0
15	23783669	.	C	T	4	5	9	0	0	9	0	0
15	23784896	.	C	T	5	5	10	0	0	10	0	0
15	23788266	.	G	A	6	3	9	0	0	9	0	0
15	23789947	.	T	G	1	3	4	0	0	4	0	0
15	23789982	.	A	T	1	2	3	0	0	3	0	0
15	23793070	.	C	T	8	8	16	0	0	16	0	0
15	23793206	.	C	T	5	8	13	0	0	13	0	0
15	23817403	.	T	A	4	11	15	0	1	16	0	0
15	23817517	.	G	A	12	8	20	0	0	20	0	0
15	23817901	.	C	T	2	11	13	0	9	22	0	0
15	23818313	.	T	A	12	8	20	0	0	20	0	0
15	23818575	.	T	C	6	13	19	0	0	19	0	0
15	23818586	.	T	C	9	4	13	0	1	14	0	0
15	23818765	.	G	A	3	5	8	0	0	8	0	0
15	23819248	.	T	A	9	11	20	0	0	20	0	0
15	23819253	.	C	T	12	8	20	0	0	20	0	0
15	23819423	.	G	A	9	14	23	0	0	23	0	0
15	23823508	.	C	T	12	7	19	0	0	19	0	0
15	23823638	.	G	C	7	8	15	0	0	15	0	0
15	23829245	.	C	T	10	5	15	0	0	15	0	0
15	23830658	.	G	A	6	5	11	0	0	11	0	0
15	23831007	.	C	T	5	7	12	0	0	12	0	0
15	23834426	.	A	G	1	7	8	0	0	8	0	0
15	23841498	.	G	A	6	9	15	0	1	16	0	0
15	23860840	.	G	A	5	3	8	0	0	8	0	0
15	23860849	.	G	A	5	3	8	0	0	8	0	0
15	23892260	.	G	A	5	2	7	0	0	7	0	0
15	23912118	.	C	T	2	3	5	0	0	5	0	0
15	23913867	.	G	T	2	2	4	0	0	4	0	0
15	23917946	.	A	T	1	2	3	0	0	3	0	0
15	23918333	.	G	C	3	8	11	0	0	11	0	0
15	23918365	.	C	T	6	2	8	0	0	8	0	0
15	23922714	.	G	A	19	13	32	0	0	32	0	0
15	23922994	.	G	T	16	13	29	0	0	29	0	0
15	23923261	.	T	G	21	14	35	0	1	36	0	0
15	23925372	.	G	C	18	15	33	0	1	34	0	0
15	23927992	.	G	T	18	17	35	0	2	37	0	0
15	23931187	.	A	G	12	9	21	0	1	22	0	0
15	23931454	.	A	G	17	8	25	0	1	26	0	0
15	23942804	.	T	G	16	9	25	0	1	26	0	0
15	23951730	.	G	C	1	5	6	0	0	6	0	0
15	24016739	.	T	C	5	2	7	0	1	8	0	0
15	24017280	.	G	A	7	5	12	0	0	12	0	0
15	24020116	.	C	T	7	8	15	0	0	15	0	0
15	24026897	.	G	A	4	2	6	0	0	6	0	0
15	24027998	.	T	G	1	0	1	0	6	7	0	0
15	24035939	.	C	A	2	2	4	0	0	4	0	0
15	24035940	.	A	C	2	2	4	0	0	4	0	0
15	24036108	.	T	C	3	3	6	0	0	6	0	0
15	24036159	.	T	C	2	6	8	0	0	8	0	0
15	24052264	.	C	T	6	6	12	0	0	12	0	0
15	24054101	.	C	T	11	8	19	0	0	19	0	0
15	24084737	.	T	A	12	10	22	0	1	23	0	0
15	24084773	.	C	T	10	8	18	0	1	19	0	0
15	24094697	.	T	C	10	10	20	0	0	20	0	0
15	24096474	.	G	A	11	7	18	0	1	19	0	0
15	24096657	.	C	A	12	10	22	0	0	22	0	0
15	24104648	.	C	T	11	8	19	0	1	20	0	0
15	24106821	.	C	T	11	14	25	0	0	25	0	0
15	24119372	.	A	G	5	6	11	0	0	11	0	0
15	24119391	.	C	T	6	4	10	0	1	11	0	0
15	24119571	.	T	C	13	12	25	0	0	25	0	0
15	24120490	.	G	A	0	9	9	2	2	13	0	0
15	24120588	.	C	T	11	5	16	0	0	16	0	0
15	24388860	.	C	T	6	12	18	0	2	20	0	0
15	24389369	.	A	C	9	16	25	0	2	27	0	0
15	24389483	.	G	A	2	14	16	0	14	30	0	0
15	24391755	.	G	A	4	11	15	1	14	30	0	0
15	24439290	.	G	A	12	13	25	0	2	27	0	0
15	24439382	.	T	C	7	10	17	0	2	19	0	0
15	24489776	.	G	A	15	11	26	0	0	26	0	0
15	24500648	.	G	A	9	13	22	0	1	23	0	0
15	24525815	.	A	G	10	0	10	0	9	19	0	0
15	24525890	.	T	C	16	9	25	0	0	25	0	0
15	24530477	.	G	A	1	17	18	0	17	35	0	0
15	24535495	.	C	T	16	18	34	0	0	34	0	0
15	24543991	.	C	T	18	17	35	0	1	36	0	0
15	24544305	.	T	A	5	4	9	0	1	10	0	0
15	24544325	.	G	A	3	6	9	0	0	9	0	0
15	24544653	.	A	T	9	9	18	0	0	18	0	0
15	24544657	.	A	G	8	1	9	0	8	17	0	0
15	24549609	.	T	C	7	10	17	0	0	17	0	0
15	24554786	.	C	A	4	13	17	0	0	17	0	0
15	24557432	.	A	G	6	5	11	0	0	11	0	0
15	24557540	.	G	A	4	7	11	0	1	12	0	0
15	24557810	.	A	C	9	4	13	0	1	14	0	0
15	24561055	.	T	C	8	11	19	0	0	19	0	0
15	24561414	.	G	A	8	11	19	0	0	19	0	0
15	24561501	.	C	T	6	12	18	0	2	20	0	0
15	24562188	.	A	G	1	4	5	0	0	5	0	0
15	24568588	.	T	C	1	3	4	0	0	4	0	0
15	24568849	.	C	T	3	2	5	0	0	5	0	0
15	24583933	.	C	G	4	2	6	0	1	7	0	0
15	24585586	.	T	C	1	0	1	0	3	4	0	0
15	24585596	.	T	A	1	2	3	0	0	3	0	0
15	24586419	.	C	A	1	1	2	0	1	3	0	0
15	24586420	.	A	C	1	2	3	0	0	3	0	0
15	24596763	.	C	T	2	2	4	0	0	4	0	0
15	24661329	.	C	T	1	3	4	0	0	4	0	0
15	24662567	.	G	A	0	2	2	0	1	3	0	0
15	24662587	.	G	A	0	2	2	0	1	3	0	0
15	24670994	.	A	G	2	1	3	0	1	4	0	0
15	24671024	.	T	C	1	2	3	0	1	4	0	0
15	24673723	.	T	A	7	4	11	0	2	13	0	0
15	24673997	.	A	G	7	11	18	0	0	18	0	0
15	24676950	.	A	T	1	3	4	0	0	4	0	0
15	24676983	.	T	A	1	3	4	0	0	4	0	0
15	24678088	.	G	A	6	9	15	0	1	16	0	0
15	24679744	.	T	C	11	14	25	0	0	25	0	0
15	24679944	.	T	C	5	8	13	0	0	13	0	0
15	24683236	.	A	G	8	14	22	0	0	22	0	0
15	24686282	.	C	T	14	13	27	0	0	27	0	0
15	24686450	.	G	A	0	8	8	0	16	24	0	0
15	24689592	.	G	A	2	18	20	0	9	29	0	0
15	24689701	.	G	A	0	11	11	0	13	24	0	0
15	24689948	.	T	C	9	9	18	0	0	18	0	0
15	24691290	.	A	G	5	0	5	0	9	14	0	0
15	24692351	.	A	T	7	7	14	0	0	14	0	0
15	24692359	.	G	A	5	8	13	0	1	14	0	0
15	24692716	.	T	A	9	8	17	0	0	17	0	0
15	24733569	.	G	A	5	8	13	0	0	13	0	0
15	24733689	.	G	A	10	4	14	0	2	16	0	0
15	24733791	.	T	G	18	10	28	0	0	28	0	0
15	24733896	.	G	A	9	9	18	0	3	21	0	0
15	24733932	.	T	C	13	7	20	0	1	21	0	0
15	24735111	.	G	T	14	7	21	0	1	22	0	0
15	24735163	.	C	G	11	7	18	0	0	18	0	0
15	24735219	.	C	T	6	5	11	0	1	12	0	0
15	24735341	.	C	T	6	14	20	0	0	20	0	0
15	24735472	.	T	C	7	3	10	0	0	10	0	0
15	24735677	.	G	T	13	12	25	0	1	26	0	0
15	24735935	.	T	G	1	5	6	0	0	6	0	0
15	24736187	.	G	A	5	2	7	0	0	7	0	0
15	24736244	.	A	T	5	3	8	0	0	8	0	0
15	24736362	.	G	C	2	2	4	0	0	4	0	0
15	24736413	.	A	G	7	3	10	0	2	12	0	0
15	24736430	.	A	G	10	4	14	0	0	14	0	0
15	24736525	.	A	G	6	5	11	0	2	13	0	0
15	24737745	.	A	G	11	23	34	0	0	34	0	0
15	24742930	.	G	A	1	14	15	0	23	38	0	0
15	24743843	.	G	A	11	4	15	0	0	15	0	0
15	24744691	.	G	C	11	14	25	0	0	25	0	0
15	24744724	.	A	T	9	8	17	0	0	17	0	0
15	24749895	.	G	A	3	32	35	0	30	65	0	0
15	24751322	.	C	T	38	32	70	0	1	71	0	0
15	24754323	.	T	G	1	7	8	0	0	8	0	0
15	24754524	.	G	A	21	11	32	0	1	33	0	0
15	24758722	.	C	T	1	4	5	0	0	5	0	0
15	24772364	.	T	G	5	4	9	0	0	9	0	0
15	24772558	.	A	G	2	0	2	0	4	6	0	0
15	24791413	.	C	T	6	2	8	0	0	8	0	0
15	24791431	.	C	T	4	3	7	0	1	8	0	0
15	24791630	.	G	T	0	3	3	0	2	5	0	0
15	24791806	.	G	C	2	3	5	0	0	5	0	0
15	24791911	.	G	C	5	2	7	0	0	7	0	0
15	24791950	.	A	G	4	4	8	0	0	8	0	0
15	24792183	.	G	A	5	5	10	0	0	10	0	0
15	24792418	.	C	T	5	2	7	0	0	7	0	0
15	24792604	.	T	C	2	10	12	0	0	12	0	0
15	24794104	.	C	T	4	8	12	0	1	13	0	0
15	24794441	.	T	A	3	2	5	0	0	5	0	0
15	24798529	.	G	A	9	7	16	0	0	16	0	0
15	24806288	.	G	A	12	6	18	0	0	18	0	0
15	24837105	.	G	A	0	13	13	0	11	24	0	0
15	24837402	.	C	T	3	3	6	0	0	6	0	0
15	24837474	.	A	G	6	5	11	0	0	11	0	0
15	24845205	.	G	A	20	18	38	0	2	40	0	0
15	24845460	.	C	T	1	4	5	0	7	12	0	0
15	24845500	.	G	T	6	14	20	0	0	20	0	0
15	24846070	.	G	A	6	9	15	0	0	15	0	0
15	24846186	.	T	C	18	12	30	0	2	32	0	0
15	24846311	.	T	A	6	10	16	0	1	17	0	0
15	24846594	.	T	C	7	0	7	0	10	17	0	0
15	24846735	.	A	T	19	8	27	0	1	28	0	0
15	24869405	.	T	C	9	0	9	0	14	23	0	0
15	24869684	.	G	A	7	8	15	0	0	15	0	0
15	24946807	.	C	T	1	6	7	0	5	12	0	0
15	24946809	.	C	G	7	6	13	0	0	13	0	0
15	24946864	.	A	G	3	3	6	0	0	6	0	0
15	24946887	.	C	T	2	2	4	0	0	4	0	0
15	24948537	.	C	G	3	4	7	1	0	8	0	0
15	24949055	.	A	G	1	2	3	1	0	4	0	0
15	24950714	.	G	A	1	3	4	0	1	5	0	0
15	24959877	.	G	T	3	2	5	0	0	5	0	0
15	24960463	.	G	A	6	4	10	0	1	11	0	0
15	25096386	.	G	T	3	5	8	0	1	9	0	0
15	25096677	.	T	C	6	6	12	0	0	12	0	0
15	25097100	.	C	T	2	2	4	0	0	4	0	0
15	25097179	.	T	A	3	3	6	0	0	6	0	0
15	25097290	.	C	T	6	4	10	0	0	10	0	0
15	25097582	.	C	T	2	8	10	0	1	11	0	0
15	25099117	.	T	C	5	0	5	0	3	8	0	0
15	25099120	.	A	G	4	3	7	0	0	7	0	0
15	25099174	.	A	G	5	3	8	0	0	8	0	0
15	25099206	.	C	T	2	3	5	0	0	5	0	0
15	25099258	.	G	A	1	2	3	0	0	3	0	0
15	25099305	.	C	G	0	5	5	0	4	9	0	0
15	25101042	.	C	T	4	5	9	0	0	9	0	0
15	25101083	.	A	G	7	6	13	0	0	13	0	0
15	25101085	.	T	G	8	6	14	0	0	14	0	0
15	25101260	.	T	C	7	4	11	0	1	12	0	0
15	25101267	.	A	G	8	4	12	0	1	13	0	0
15	25101302	.	G	A	4	5	9	0	2	11	0	0
15	25101538	.	G	A	9	10	19	0	0	19	0	0
15	25101619	.	A	G	13	13	26	0	0	26	0	0
15	25101740	.	C	A	13	15	28	0	1	29	0	0
15	25101990	.	A	G	15	15	30	0	1	31	0	0
15	25121504	.	T	G	8	3	11	0	0	11	0	0
15	25121522	.	A	G	8	6	14	0	0	14	0	0
15	25127854	.	A	G	6	13	19	0	0	19	0	0
15	25152258	.	A	G	4	8	12	0	0	12	0	0
15	25152294	.	A	C	9	0	9	0	5	14	0	0
15	25153250	.	C	A	11	12	23	0	0	23	0	0
15	25153294	.	G	A	7	9	16	0	0	16	0	0
15	25173015	.	C	T	0	4	4	0	3	7	0	0
15	25173157	.	A	G	8	6	14	0	0	14	0	0
15	25173188	.	A	T	9	3	12	0	2	14	0	0
15	25173494	.	A	C	8	6	14	0	0	14	0	0
15	25173714	.	C	T	2	15	17	0	1	18	0	0
15	25173759	.	T	C	2	6	8	0	2	10	0	0
15	25173877	.	C	T	2	2	4	1	0	5	0	0
15	25173898	.	G	A	3	1	4	1	1	6	0	0
15	25173920	.	G	A	2	2	4	0	1	5	0	0
15	25174048	.	C	A	0	5	5	0	3	8	0	0
15	25174634	.	G	A	4	6	10	0	0	10	0	0
15	25174998	.	T	A	2	2	4	0	1	5	0	0
15	25175354	.	G	C	2	3	5	0	0	5	0	0
15	25175811	.	A	C	5	7	12	0	1	13	0	0
15	25176075	.	C	T	5	10	15	0	1	16	0	0
15	25176191	.	G	C	6	0	6	0	4	10	0	0
15	25176527	.	C	T	1	13	14	0	10	24	0	0
15	25195068	.	T	C	5	0	5	0	5	10	0	0
15	25214272	.	T	C	1	2	3	0	0	3	0	0
15	25214384	.	A	G	5	8	13	0	0	13	0	0
15	25229156	.	A	G	2	5	7	0	0	7	0	0
15	25239148	.	T	C	3	4	7	0	0	7	0	0
15	25243412	.	C	T	1	2	3	0	0	3	0	0
15	25267804	.	G	A	5	2	7	0	0	7	0	0
15	25273187	.	C	T	17	19	36	0	1	37	0	0
15	25274918	.	T	G	23	26	49	0	0	49	0	0
15	25278986	.	A	G	26	17	43	0	0	43	0	0
15	25281387	.	G	A	20	15	35	0	0	35	0	0
15	25283846	.	A	C	14	0	14	0	14	28	0	0
15	25283963	.	A	G	16	17	33	0	2	35	0	0
15	25321973	.	G	A	8	8	16	0	1	17	0	0
15	25321982	.	A	C	8	6	14	0	2	16	0	0
15	25322410	.	C	A	1	8	9	0	8	17	0	0
15	25322607	.	T	G	15	7	22	0	1	23	0	0
15	25322783	.	G	A	6	16	22	0	3	25	0	0
15	25322853	.	C	T	11	17	28	0	0	28	0	0
15	25323064	.	G	C	20	9	29	0	0	29	0	0
15	25333922	.	C	T	2	2	4	0	6	10	0	0
15	25344998	.	G	A	6	6	12	0	0	12	0	0
15	25346772	.	G	A	3	4	7	0	1	8	0	0
15	25346775	.	G	A	4	4	8	0	0	8	0	0
15	25349844	.	C	T	9	9	18	0	1	19	0	0
15	25351846	.	C	T	4	6	10	0	1	11	0	0
15	25351870	.	C	A	3	10	13	0	0	13	0	0
15	25351927	.	G	A	3	6	9	0	1	10	0	0
15	25352011	.	C	T	2	3	5	0	0	5	0	0
15	25352062	.	C	A	3	5	8	0	0	8	0	0
15	25352251	.	C	T	0	5	5	0	3	8	0	0
15	25352260	.	G	C	3	0	3	0	6	9	0	0
15	25353263	.	C	T	0	3	3	0	1	4	0	0
15	25353973	.	T	G	5	6	11	0	0	11	0	0
15	25357191	.	A	G	5	6	11	0	0	11	0	0
15	25357456	.	A	G	2	2	4	0	0	4	0	0
15	25357510	.	G	A	4	3	7	0	0	7	0	0
15	25367067	.	C	T	5	2	7	0	0	7	0	0
15	25367129	.	A	G	3	10	13	0	1	14	0	0
15	25367229	.	G	A	4	4	8	0	0	8	0	0
15	25375950	.	C	A	9	3	12	0	0	12	0	0
15	25376190	.	T	C	6	7	13	0	1	14	0	0
15	25376212	.	T	G	9	8	17	0	1	18	0	0
15	25376506	.	G	A	3	3	6	0	0	6	0	0
15	25376673	.	G	C	9	3	12	0	0	12	0	0
15	25376674	.	C	T	1	3	4	0	8	12	0	0
15	25376842	.	A	G	2	2	4	0	0	4	0	0
15	25377137	.	C	T	1	12	13	0	6	19	0	0
15	25377155	.	C	T	1	15	16	0	5	21	0	0
15	25377218	.	C	A	4	5	9	0	0	9	0	0
15	25388120	.	C	T	5	11	16	0	0	16	0	0
15	25398276	.	T	G	4	2	6	0	0	6	0	0
15	25398406	.	A	C	1	6	7	0	0	7	0	0
15	25398665	.	C	A	3	4	7	0	0	7	0	0
15	25400018	.	A	G	5	4	9	0	1	10	0	0
15	25400120	.	T	C	3	6	9	0	2	11	0	0
15	25434948	.	C	T	0	4	4	0	2	6	0	0
15	25452128	.	A	T	2	4	6	0	0	6	0	0
15	25452131	.	C	T	2	4	6	0	0	6	0	0
15	25485155	.	A	G	3	0	3	0	4	7	0	0
15	25485394	.	A	G	1	3	4	0	0	4	0	0
15	25492912	.	G	A	0	3	3	1	2	6	0	0
15	25498515	.	G	T	0	7	7	0	7	14	0	0
15	25498718	.	C	A	1	5	6	0	0	6	0	0
15	25499171	.	A	G	4	2	6	0	1	7	0	0
15	25504064	.	A	G	1	3	4	0	0	4	0	0
15	25504397	.	A	C	4	0	4	0	3	7	0	0
15	25504399	.	T	A	6	3	9	0	0	9	0	0
15	25504902	.	C	G	1	5	6	0	7	13	0	0
15	25507942	.	A	T	8	8	16	0	1	18	1	0
15	25508539	.	T	G	3	12	15	0	1	16	0	0
15	25508852	.	T	G	11	12	23	0	1	24	0	0
15	25509414	.	C	A	1	8	9	0	8	17	0	0
15	25509498	.	G	A	10	9	19	0	1	20	0	0
15	25509500	.	C	T	1	10	11	0	9	20	0	0
15	25510372	.	G	T	10	6	16	0	1	17	0	0
15	25512525	.	T	C	6	0	6	0	6	12	0	0
15	25515702	.	G	A	8	13	21	0	1	22	0	0
15	25517116	.	C	T	5	6	11	0	0	11	0	0
15	25528359	.	C	A	4	3	7	0	0	7	0	0
15	25530918	.	C	T	4	4	8	0	0	8	0	0
15	25532175	.	C	T	1	7	8	0	0	8	0	0
15	25532219	.	C	T	3	6	9	0	1	10	0	0
15	25533270	.	C	G	4	3	7	0	0	7	0	0
15	25533279	.	A	T	4	5	9	0	0	9	0	0
15	25534200	.	T	C	4	3	7	0	0	7	0	0
15	25534293	.	T	G	5	5	10	0	0	10	0	0
15	25537641	.	C	A	5	4	9	0	0	9	0	0
15	25537860	.	C	A	3	3	6	0	1	7	0	0
15	25538178	.	A	G	5	10	15	0	5	20	0	0
15	25538381	.	T	C	4	6	10	0	0	10	0	0
15	25538793	.	G	A	1	3	4	0	5	9	0	0
15	25588805	.	A	G	19	10	29	0	0	29	0	0
15	25588836	.	A	C	26	12	38	0	2	40	0	0
15	25588840	.	T	C	27	2	29	0	12	41	0	0
15	25589119	.	G	T	11	8	19	0	0	19	0	0
15	25589197	.	T	A	15	21	36	0	3	39	0	0
15	25589280	.	G	T	10	15	25	0	3	28	0	0
15	25589321	.	A	G	8	9	17	0	2	19	0	0
15	25589438	.	C	G	15	11	26	0	1	27	0	0
15	25589582	.	G	C	11	14	25	0	0	25	0	0
15	25589624	.	C	T	7	11	18	0	0	18	0	0
15	25589640	.	T	C	3	10	13	0	2	15	0	0
15	25589708	.	A	G	14	11	25	0	1	26	0	0
15	25589812	.	A	T	11	14	25	0	2	27	0	0
15	25589838	.	A	G	12	11	23	0	1	24	0	0
15	25589979	.	T	A	13	12	25	0	1	26	0	0
15	25589983	.	C	T	13	10	23	0	3	26	0	0
15	25590022	.	A	G	10	11	21	0	0	21	0	0
15	25590129	.	A	G	13	12	25	0	2	27	0	0
15	25590155	.	T	C	10	19	29	0	0	29	0	0
15	25590235	.	A	G	9	6	15	0	1	16	0	0
15	25590240	.	A	G	8	6	14	0	1	15	0	0
15	25590297	.	A	G	7	9	16	0	1	17	0	0
15	25590394	.	T	A	9	13	22	0	0	22	0	0
15	25590474	.	G	A	11	17	28	0	1	29	0	0
15	25590585	.	G	T	5	13	18	0	1	19	0	0
15	25590820	.	A	G	6	9	15	0	0	15	0	0
15	25591541	.	A	T	15	18	33	0	0	33	0	0
15	25591553	.	A	C	14	14	28	0	0	28	0	0
15	25591807	.	C	G	16	14	30	0	1	31	0	0
15	25591820	.	A	T	12	16	28	0	0	28	0	0
15	25591846	.	A	G	9	11	20	0	0	20	0	0
15	25591938	.	C	T	3	2	5	0	0	5	0	0
15	25592064	.	C	T	3	4	7	0	1	8	0	0
15	25592080	.	C	T	0	8	8	0	3	11	0	0
15	25592126	.	C	G	5	7	12	0	0	12	0	0
15	25592223	.	A	G	1	2	3	0	1	4	0	0
15	25592606	.	T	A	7	8	15	0	0	15	0	0
15	25593187	.	T	G	6	7	13	0	0	13	0	0
15	25594091	.	A	G	8	9	17	0	1	18	0	0
15	25594214	.	A	C	5	4	9	0	0	9	0	0
15	25594345	.	C	T	0	8	8	0	8	16	0	0
15	25594511	.	G	C	5	0	5	0	7	12	0	0
15	25594810	.	A	C	2	7	9	0	1	10	0	0
15	25595187	.	T	C	2	12	14	0	0	14	0	0
15	25595350	.	T	A	5	7	12	0	0	12	0	0
15	25595352	.	A	T	5	7	12	0	0	12	0	0
15	25595702	.	T	C	21	6	27	0	0	27	0	0
15	25598873	.	T	A	11	13	24	0	1	25	0	0
15	25598963	.	G	A	14	17	31	0	0	31	0	0
15	25599071	.	C	T	11	13	24	0	3	27	0	0
15	25602628	.	G	A	11	7	18	0	0	18	0	0
15	25602843	.	T	C	6	7	13	0	0	13	0	0
15	25602846	.	G	A	6	7	13	0	0	13	0	0
15	25602915	.	A	G	6	9	15	0	0	15	0	0
15	25603017	.	G	A	9	11	20	0	0	20	0	0
15	25605041	.	A	G	14	10	24	0	0	24	0	0
15	25608056	.	A	G	3	6	9	0	1	10	0	0
15	25608288	.	A	G	5	4	9	0	0	9	0	0
15	25628766	.	T	C	6	4	10	0	0	10	0	0
15	25628860	.	G	C	11	1	12	0	3	15	0	0
15	25628863	.	A	G	11	3	14	0	1	15	0	0
15	25635424	.	C	T	13	5	18	1	1	20	0	0
15	25638600	.	G	A	4	8	12	0	0	12	0	0
15	25640533	.	T	C	9	4	13	0	0	13	0	0
15	25640540	.	A	G	8	0	8	0	3	11	0	0
15	25640891	.	C	T	5	6	11	0	1	12	0	0
15	25640892	.	T	G	4	6	10	0	2	12	0	0
15	25641002	.	C	G	4	6	10	0	0	10	0	0
15	25649944	.	G	A	5	8	13	0	2	15	0	0
15	25649959	.	G	A	7	7	14	0	0	14	0	0
15	25650100	.	T	G	10	8	18	0	0	18	0	0
15	25653349	.	A	G	5	2	7	0	0	7	0	0
15	25656103	.	C	T	10	3	13	0	0	13	0	0
15	25656175	.	A	G	9	6	15	0	0	15	0	0
15	25910696	.	G	A	3	4	7	0	1	8	0	0
15	25961996	.	C	T	5	4	9	0	0	9	0	0
15	25971207	.	C	T	6	2	8	0	2	10	0	0
15	25971213	.	C	T	5	5	10	0	0	10	0	0
15	26399801	.	T	C	6	10	16	0	0	16	0	0
15	26400117	.	C	T	7	8	15	0	1	16	0	0
15	26400297	.	G	C	7	8	15	0	0	15	0	0
15	26400300	.	A	C	5	9	14	0	2	16	0	0
15	26400743	.	T	G	4	8	12	0	0	12	0	0
15	26400766	.	A	G	9	10	19	0	0	19	0	0
15	26400819	.	A	G	18	10	28	0	0	28	0	0
15	26400836	.	G	A	15	12	27	0	2	29	0	0
15	26400876	.	G	A	15	15	30	0	0	30	0	0
15	26400900	.	C	T	14	10	24	0	0	24	0	0
15	26400924	.	A	T	12	7	19	0	0	19	0	0
15	26401101	.	A	G	8	11	19	0	0	19	0	0
15	26401194	.	T	G	6	7	13	0	0	13	0	0
15	26401200	.	C	T	4	10	14	0	0	14	0	0
15	26401259	.	A	C	10	4	14	0	0	14	0	0
15	26401623	.	A	T	12	13	25	0	0	25	0	0
15	26401779	.	A	G	13	13	26	0	0	26	0	0
15	26401880	.	A	T	7	6	13	0	0	13	0	0
15	26401888	.	G	C	6	3	9	0	0	9	0	0
15	26402167	.	G	A	14	8	22	0	0	22	0	0
15	26498400	.	T	G	1	3	4	0	0	4	0	0
15	26498455	.	A	T	6	3	9	0	2	11	0	0
15	26498615	.	C	T	7	16	23	0	2	25	0	0
15	26498621	.	C	A	7	18	25	0	0	25	0	0
15	26498716	.	A	G	8	15	23	0	0	23	0	0
15	26498749	.	A	T	13	20	33	0	1	34	0	0
15	26498820	.	T	G	11	17	28	0	0	28	0	0
15	26505495	.	C	A	18	11	29	0	1	30	0	0
15	26515021	.	C	T	2	5	7	0	17	24	0	0
15	26534203	.	G	A	7	7	14	0	0	14	0	0
15	26538874	.	A	G	4	10	14	0	0	14	0	0
15	26538885	.	G	A	4	11	15	0	0	15	0	0
15	26553093	.	A	T	5	5	10	0	0	10	0	0
15	26553095	.	T	C	4	5	9	0	0	9	0	0
15	26554008	.	G	A	3	5	8	0	0	8	0	0
15	26554014	.	A	T	3	5	8	0	0	8	0	0
15	26554162	.	A	G	3	4	7	0	1	8	0	0
15	26554181	.	T	C	3	4	7	0	0	7	0	0
15	26554490	.	T	A	1	3	4	0	0	4	0	0
15	26554686	.	G	A	8	5	13	0	0	13	0	0
15	26554939	.	T	C	1	2	3	0	6	9	0	0
15	26561058	.	A	C	4	4	8	0	0	8	0	0
15	26561347	.	G	A	9	3	12	0	0	12	0	0
15	26561407	.	C	G	8	4	12	0	0	12	0	0
15	26561468	.	C	T	1	5	6	0	1	7	0	0
15	26561502	.	T	C	1	2	3	0	0	3	0	0
15	26561610	.	A	T	3	2	5	0	1	6	0	0
15	26562842	.	G	A	1	3	4	0	0	4	0	0
15	26563537	.	T	C	1	0	1	0	8	9	0	0
15	26563751	.	A	G	2	4	6	0	0	6	0	0
15	26563775	.	A	C	2	3	5	0	1	6	0	0
15	26563799	.	A	G	4	3	7	0	0	7	0	0
15	26564209	.	G	A	5	4	9	0	0	9	0	0
15	26564267	.	G	A	6	3	9	0	0	9	0	0
15	26565371	.	G	A	1	2	3	0	0	3	0	0
15	26566114	.	G	A	4	7	11	0	0	11	0	0
15	26566700	.	A	G	1	2	3	0	0	3	0	0
15	26566925	.	A	T	1	3	4	0	0	4	0	0
15	26570902	.	G	A	1	3	4	0	0	4	0	0
15	26678917	.	C	A	1	7	8	0	7	15	0	0
15	26678932	.	T	A	8	6	14	0	0	15	1	0
15	26679070	.	T	A	6	4	10	0	0	10	0	0
15	26679908	.	C	T	0	5	5	0	9	14	0	0
15	26680080	.	G	C	4	3	7	0	1	9	1	0
15	26680099	.	T	A	3	5	8	0	0	8	0	0
15	26683504	.	A	G	4	13	17	0	0	17	0	0
15	26683758	.	G	A	17	10	27	0	3	30	0	0
15	26683764	.	G	A	11	17	28	0	0	28	0	0
15	26686828	.	A	T	2	4	6	0	2	43	35	0
15	26699885	.	G	A	7	5	12	0	0	12	0	0
15	26707518	.	G	A	6	8	14	0	1	15	0	0
15	26707569	.	G	T	7	11	18	0	0	18	0	0
15	26710306	.	G	A	11	4	15	0	0	15	0	0
15	26720581	.	C	T	4	13	17	0	12	29	0	0
15	26729480	.	G	A	8	6	14	0	0	14	0	0
15	26751709	.	C	G	3	11	14	0	0	14	0	0
15	26787927	.	C	T	9	7	16	1	0	17	0	0
15	26843956	.	A	G	9	8	17	0	0	17	0	0
15	26844074	.	T	G	5	7	12	0	1	13	0	0
15	26844077	.	A	T	6	7	13	0	1	14	0	0
15	26849890	.	G	A	2	3	5	0	0	5	0	0
15	26873946	.	G	A	7	2	9	0	0	9	0	0
15	26880427	.	G	T	3	5	8	0	0	8	0	0
15	26882942	.	T	G	4	3	7	0	0	7	0	0
15	26883982	.	T	A	3	3	6	0	0	6	0	0
15	26884010	.	G	C	3	0	3	0	3	6	0	0
15	26884380	.	A	G	1	2	3	0	0	3	0	0
15	26885449	.	C	T	7	2	9	0	0	9	0	0
15	26886727	.	C	T	1	2	3	0	0	3	0	0
15	26886902	.	G	A	1	2	3	0	0	3	0	0
15	26904430	.	A	G	7	4	11	0	1	12	0	0
15	26904779	.	G	A	4	3	7	0	0	7	0	0
15	26904838	.	A	G	2	6	8	0	0	8	0	0
15	26904989	.	C	A	2	5	7	0	0	7	0	0
15	26905002	.	C	T	4	4	8	0	0	8	0	0
15	26905088	.	A	G	7	4	11	0	0	11	0	0
15	26905118	.	T	G	4	4	8	0	0	8	0	0
15	26915384	.	T	A	12	8	20	0	1	21	0	0
15	26915531	.	A	G	17	10	27	0	0	27	0	0
15	26915568	.	G	A	17	13	30	0	0	30	0	0
15	26915633	.	C	T	9	15	24	0	0	24	0	0
15	26915651	.	T	C	8	10	18	0	1	19	0	0
15	26919255	.	T	C	8	19	27	0	0	27	0	0
15	26921873	.	T	C	15	11	26	0	0	26	0	0
15	26922139	.	A	G	12	9	21	0	1	22	0	0
15	26922162	.	T	G	10	6	16	0	0	16	0	0
15	26924056	.	T	C	8	12	20	0	2	22	0	0
15	26924080	.	C	G	1	9	10	0	13	23	0	0
15	26926474	.	G	A	5	3	8	0	0	8	0	0
15	26926653	.	A	C	6	5	11	0	0	11	0	0
15	26935032	.	A	T	6	8	14	0	0	14	0	0
15	26935696	.	G	A	8	8	16	0	0	17	1	0
15	26938324	.	A	C	10	7	17	0	0	17	0	0
15	26939031	.	C	A	5	5	10	0	2	12	0	0
15	26939224	.	G	T	9	3	12	0	0	12	0	0
15	26939233	.	A	C	3	7	10	0	0	10	0	0
15	26939279	.	G	A	0	4	4	0	6	10	0	0
15	26939362	.	A	G	2	1	3	0	0	3	0	0
15	26939363	.	T	A	1	1	2	0	0	3	1	0
15	26941892	.	G	A	2	8	10	0	6	16	0	0
15	26942174	.	A	T	6	4	10	0	0	10	0	0
15	26961861	.	G	A	0	5	5	0	4	9	0	0
15	26993973	.	C	A	4	6	10	0	1	11	0	0
15	27071063	.	A	G	5	0	5	0	6	11	0	0
15	27071096	.	C	G	6	6	12	0	0	12	0	0
15	27071099	.	A	G	6	7	13	0	0	13	0	0
15	27071735	.	G	A	6	9	15	0	0	15	0	0
15	27071792	.	T	G	7	8	15	0	1	16	0	0
15	27071849	.	G	A	12	7	19	0	1	20	0	0
15	27087813	.	C	T	5	10	15	0	0	15	0	0
15	27328142	.	T	G	8	0	8	0	8	16	0	0
15	27352608	.	G	A	7	5	12	0	0	12	0	0
15	27353481	.	G	A	3	6	9	0	0	9	0	0
15	27354412	.	T	A	11	20	31	0	1	32	0	0
15	27363787	.	C	T	1	2	3	0	0	3	0	0
15	27371021	.	T	A	1	4	5	0	0	5	0	0
15	27703845	.	A	G	17	11	28	0	4	32	0	0
15	27704220	.	C	A	2	20	22	0	15	37	0	0
15	27710392	.	A	G	11	10	21	0	0	21	0	0
15	27710396	.	C	T	11	10	21	0	0	21	0	0
15	28079177	.	C	T	1	2	3	0	3	6	0	0
15	28079204	.	A	C	4	0	4	0	3	7	0	0
15	28079214	.	A	G	4	2	6	0	0	6	0	0
15	28079249	.	A	T	3	2	5	0	0	5	0	0
15	28079317	.	T	A	2	5	7	0	0	9	2	0
15	28079541	.	C	T	2	2	4	0	0	4	0	0
15	28079848	.	C	T	0	6	6	0	4	10	0	0
15	28082567	.	A	G	4	3	7	0	0	7	0	0
15	28084711	.	C	T	1	3	4	0	0	4	0	0
15	28085382	.	T	C	4	13	17	0	0	17	0	0
15	28085422	.	G	A	5	8	13	0	1	14	0	0
15	28106804	.	A	G	3	9	12	0	0	12	0	0
15	28124642	.	C	T	10	10	20	0	0	20	0	0
15	28124913	.	T	C	7	11	18	0	0	18	0	0
15	28125146	.	A	G	7	0	7	0	9	16	0	0
15	28125186	.	A	G	5	13	18	0	0	18	0	0
15	28175898	.	G	A	1	2	3	0	1	4	0	0
15	28175982	.	T	G	2	2	4	0	0	4	0	0
15	28178147	.	C	T	1	2	3	0	0	3	0	0
15	28178188	.	C	T	2	2	4	0	0	4	0	0
15	28178197	.	C	T	3	1	4	0	1	5	0	0
15	28179788	.	C	G	2	2	4	0	0	4	0	0
15	28179790	.	A	G	2	2	4	0	0	4	0	0
15	28179931	.	T	C	2	2	4	0	0	4	0	0
15	28182704	.	G	A	5	4	9	0	0	9	0	0
15	28182716	.	C	A	4	4	8	0	0	8	0	0
15	28182837	.	A	G	4	3	7	0	1	8	0	0
15	28182924	.	T	C	5	2	7	0	0	7	0	0
15	28182927	.	T	C	5	2	7	0	0	7	0	0
15	28182964	.	G	A	2	2	4	0	0	4	0	0
15	28188849	.	T	A	5	3	8	0	1	9	0	0
15	28189029	.	T	A	5	13	18	0	0	18	0	0
15	28189046	.	T	G	5	12	17	0	1	18	0	0
15	28189409	.	A	C	7	5	12	0	0	12	0	0
15	28189589	.	T	C	8	0	8	0	10	18	0	0
15	28189591	.	T	C	7	10	17	0	0	17	0	0
15	28189945	.	T	G	8	15	23	0	0	23	0	0
15	28192706	.	A	G	8	15	23	0	1	24	0	0
15	28194669	.	T	C	6	13	19	0	0	19	0	0
15	28194708	.	A	G	11	14	25	0	1	26	0	0
15	28195515	.	A	T	5	12	17	0	1	18	0	0
15	28199233	.	G	A	7	10	17	0	2	19	0	0
15	28199431	.	A	G	6	10	16	0	0	16	0	0
15	28199437	.	A	T	4	10	14	0	1	15	0	0
15	28199574	.	T	C	4	8	12	0	0	12	0	0
15	28199707	.	G	A	3	4	7	0	1	8	0	0
15	28199860	.	T	C	4	0	4	0	6	10	0	0
15	28199861	.	T	G	4	6	10	0	0	10	0	0
15	28199905	.	T	G	7	3	10	0	1	11	0	0
15	28230658	.	A	G	5	3	8	0	0	8	0	0
15	28230738	.	G	A	5	2	7	0	1	8	0	0
15	28238143	.	G	A	2	3	5	0	0	5	0	0
15	28242043	.	T	C	6	2	8	0	0	8	0	0
15	28249301	.	G	T	4	6	10	0	0	10	0	0
15	28251094	.	T	A	18	16	34	0	1	35	0	0
15	28252597	.	T	C	11	19	30	0	2	32	0	0
15	28252599	.	A	G	14	19	33	0	0	33	0	0
15	28253171	.	C	A	1	16	17	0	16	33	0	0
15	28253522	.	C	T	12	4	16	0	1	17	0	0
15	28253773	.	C	T	14	14	28	0	0	28	0	0
15	28254184	.	T	C	12	8	20	0	3	23	0	0
15	28254202	.	G	T	16	12	28	0	3	31	0	0
15	28256036	.	A	G	5	13	18	0	0	18	0	0
15	28257277	.	A	G	15	12	27	0	1	28	0	0
15	28259321	.	T	C	6	7	13	0	1	14	0	0
15	28259773	.	C	T	1	4	5	0	10	15	0	0
15	28259971	.	G	A	10	4	14	0	3	17	0	0
15	28260007	.	C	T	9	3	12	0	2	14	0	0
15	28260031	.	A	G	10	4	14	0	0	14	0	0
15	28260234	.	A	G	7	13	20	0	0	20	0	0
15	28260381	.	A	T	8	13	21	0	1	22	0	0
15	28260522	.	T	A	7	11	18	0	0	18	0	0
15	28343332	.	A	G	4	6	10	0	1	11	0	0
15	28343667	.	C	T	9	10	19	0	0	19	0	0
15	28349816	.	C	T	6	3	9	0	0	9	0	0
15	28350079	.	C	G	3	5	8	0	3	11	0	0
15	28350095	.	C	T	5	9	14	0	0	14	0	0
15	28350744	.	C	T	1	2	3	0	0	3	0	0
15	28350745	.	T	A	1	2	3	0	0	3	0	0
15	28350999	.	T	G	7	3	10	0	0	10	0	0
15	28351020	.	A	G	11	5	16	0	0	16	0	0
15	28351089	.	C	G	6	3	9	0	0	9	0	0
15	28351132	.	G	A	1	3	4	0	0	4	0	0
15	28351375	.	A	T	5	2	7	0	0	7	0	0
15	28351381	.	G	C	5	1	6	0	0	6	0	0
15	28351591	.	G	T	4	2	6	0	0	6	0	0
15	28352138	.	T	C	7	6	13	0	0	13	0	0
15	28352168	.	C	A	11	7	18	0	0	18	0	0
15	28352387	.	A	T	1	4	5	0	0	5	0	0
15	28368884	.	G	A	11	5	16	0	1	17	0	0
15	28370974	.	T	C	6	7	13	0	0	13	0	0
15	28392769	.	G	T	3	6	9	0	1	10	0	0
15	28401905	.	A	T	10	9	19	0	1	20	0	0
15	28403365	.	C	T	6	7	13	0	3	16	0	0
15	28410762	.	T	C	1	2	3	0	0	3	0	0
15	28410769	.	C	T	1	2	3	0	0	3	0	0
15	28424382	.	A	G	1	0	1	0	2	3	0	0
15	28424395	.	T	G	1	2	3	0	0	3	0	0
15	28432697	.	C	A	12	17	29	0	1	30	0	0
15	28432739	.	C	T	10	18	28	0	0	28	0	0
15	28432741	.	A	T	8	18	26	0	1	27	0	0
15	28432871	.	T	C	6	12	18	0	0	18	0	0
15	28432993	.	C	T	1	13	14	0	11	25	0	0
15	28433073	.	A	G	15	7	22	0	0	22	0	0
15	28433102	.	C	A	14	8	22	0	0	22	0	0
15	28433126	.	G	T	14	9	23	0	0	23	0	0
15	28433161	.	T	C	7	7	14	0	1	15	0	0
15	28433282	.	G	A	16	15	31	0	2	33	0	0
15	28433947	.	A	G	15	14	29	0	0	29	0	0
15	28437178	.	G	T	7	6	13	0	0	13	0	0
15	28439441	.	G	A	11	11	22	0	1	23	0	0
15	28446791	.	A	T	10	8	18	0	1	19	0	0
15	28452844	.	A	G	6	13	19	0	0	19	0	0
15	28453081	.	C	A	0	14	14	0	11	25	0	0
15	28453102	.	C	T	12	14	26	0	0	26	0	0
15	28463609	.	C	T	0	7	7	0	5	12	0	0
15	28480345	.	A	T	2	3	5	0	0	5	0	0
15	28483230	.	C	T	6	5	11	0	0	11	0	0
15	28483333	.	A	C	7	9	16	1	0	17	0	0
15	28509840	.	G	A	13	9	22	1	0	23	0	0
15	28515428	.	C	A	9	9	18	0	5	23	0	0
15	28520856	.	A	G	11	0	11	0	10	21	0	0
15	28526386	.	A	T	13	10	23	0	4	27	0	0
15	28537810	.	T	A	10	10	20	0	2	22	0	0
15	28537852	.	T	C	8	7	15	0	0	15	0	0
15	28537872	.	G	A	0	7	7	0	11	18	0	0
15	28537906	.	A	C	6	10	16	0	1	17	0	0
15	28537965	.	T	A	5	12	17	0	1	18	0	0
15	28538012	.	G	A	3	13	16	0	5	21	0	0
15	28538097	.	A	G	15	1	16	0	9	25	0	0
15	28538173	.	G	A	10	5	15	0	0	15	0	0
15	28538199	.	T	C	8	11	19	0	0	19	0	0
15	28538239	.	G	T	15	8	23	0	0	23	0	0
15	28538405	.	T	C	8	12	20	0	0	20	0	0
15	28538602	.	A	T	6	6	12	0	0	12	0	0
15	28538605	.	G	A	0	5	5	0	6	11	0	0
15	28538667	.	A	G	8	6	14	0	1	15	0	0
15	28538761	.	A	G	12	14	26	0	0	26	0	0
15	28538765	.	C	T	11	12	23	0	0	23	0	0
15	28538984	.	C	T	4	4	8	0	1	9	0	0
15	28539022	.	C	A	8	7	15	0	0	15	0	0
15	28539112	.	C	T	6	8	14	0	0	14	0	0
15	28539160	.	T	C	10	8	18	0	0	18	0	0
15	28539232	.	C	T	8	9	17	0	0	17	0	0
15	28539310	.	A	G	9	3	12	0	0	12	0	0
15	28539381	.	A	T	5	5	10	0	0	10	0	0
15	28539383	.	A	T	5	5	10	0	0	10	0	0
15	28539523	.	T	C	10	9	19	0	0	19	0	0
15	28539556	.	G	A	10	7	17	0	0	17	0	0
15	28539649	.	T	A	13	4	17	0	1	18	0	0
15	28549003	.	G	A	5	4	9	0	0	9	0	0
15	28549347	.	G	T	8	5	13	0	0	13	0	0
15	28549348	.	T	A	8	5	13	0	0	13	0	0
15	28549392	.	A	C	8	5	13	0	0	13	0	0
15	28549665	.	T	C	1	0	1	0	5	6	0	0
15	28549872	.	A	C	4	2	6	0	0	6	0	0
15	28549965	.	G	C	3	5	8	0	1	9	0	0
15	28550088	.	A	G	4	4	8	0	1	9	0	0
15	28550824	.	C	T	6	2	8	0	0	8	0	0
15	28550841	.	T	G	3	4	7	0	1	8	0	0
15	28551281	.	G	A	3	3	6	0	0	6	0	0
15	28551285	.	G	A	3	3	6	0	0	6	0	0
15	28551333	.	G	C	6	2	8	0	0	8	0	0
15	28551498	.	A	G	8	4	12	0	0	12	0	0
15	28552448	.	G	A	4	2	6	0	1	7	0	0
15	28611934	.	G	A	3	4	7	0	0	7	0	0
15	28615431	.	A	C	2	4	6	0	0	6	0	0
15	28615665	.	A	G	3	3	6	0	0	6	0	0
15	28618112	.	A	G	5	4	9	0	1	10	0	0
15	28634719	.	G	A	9	6	15	0	0	15	0	0
15	28646687	.	G	A	10	7	17	0	3	20	0	0
15	28646696	.	T	C	12	0	12	0	10	22	0	0
15	28646886	.	G	A	5	6	11	0	1	12	0	0
15	28646931	.	C	G	6	8	14	0	0	14	0	0
15	28672508	.	T	G	7	7	14	0	0	14	0	0
15	28677558	.	T	A	12	10	22	0	1	23	0	0
15	28686433	.	A	T	24	19	43	0	4	47	0	0
15	28758907	.	G	C	1	17	18	0	26	44	0	0
15	28758988	.	C	T	23	24	47	0	2	49	0	0
15	28759171	.	T	G	34	0	34	0	23	57	0	0
15	28759246	.	G	C	3	15	18	0	33	51	0	0
15	28759558	.	C	G	24	0	24	0	15	39	0	0
15	28759639	.	G	A	15	15	30	0	1	31	0	0
15	28760090	.	T	C	28	22	50	0	3	53	0	0
15	28760675	.	A	T	27	18	45	0	1	46	0	0
15	28761031	.	T	C	23	13	36	0	0	36	0	0
15	28761173	.	T	C	23	14	37	0	1	38	0	0
15	28761284	.	T	A	23	18	41	0	2	43	0	0
15	28762440	.	C	T	25	20	45	0	2	47	0	0
15	28763124	.	T	C	18	28	46	0	3	49	0	0
15	28763134	.	T	C	18	29	47	0	1	48	0	0
15	28763677	.	C	A	23	24	47	0	1	48	0	0
15	28763770	.	T	C	26	30	56	0	2	58	0	0
15	28763927	.	G	A	1	28	29	0	26	55	0	0
15	28763986	.	G	A	3	29	32	0	26	58	0	0
15	28764206	.	G	T	2	17	19	0	23	42	0	0
15	28764252	.	A	G	30	0	30	0	30	60	0	0
15	28766069	.	A	G	6	8	14	0	0	14	0	0
15	28787262	.	T	A	3	4	7	0	1	8	0	0
15	28802093	.	A	T	1	2	3	0	0	3	0	0
15	28802136	.	A	T	3	3	6	0	0	6	0	0
15	28881717	.	G	A	10	21	31	0	0	31	0	0
15	28882675	.	T	A	10	12	22	0	0	22	0	0
15	28882687	.	A	G	10	12	22	0	1	23	0	0
15	28886531	.	G	C	5	4	9	0	0	9	0	0
15	28886882	.	A	T	7	7	14	0	1	15	0	0
15	28887280	.	G	T	7	11	18	0	0	18	0	0
15	28887667	.	A	G	8	10	18	0	0	18	0	0
15	28972971	.	A	G	3	4	7	0	0	7	0	0
15	28973434	.	C	A	2	2	4	0	0	4	0	0
15	28974081	.	T	G	1	0	1	0	4	5	0	0
15	28974096	.	T	C	1	3	4	0	0	4	0	0
15	29000989	.	C	T	27	19	46	0	7	53	0	0
15	29001556	.	C	T	31	15	46	2	2	50	0	0
15	29001583	.	T	C	31	17	48	2	3	53	0	0
15	29004485	.	A	G	22	25	47	0	4	51	0	0
15	29005346	.	T	A	19	20	39	0	1	40	0	0
15	29005363	.	A	C	17	13	30	0	4	34	0	0
15	29005564	.	T	G	22	10	32	0	3	35	0	0
15	29005600	.	A	C	23	12	35	0	1	36	0	0
15	29005862	.	T	A	31	18	49	0	1	50	0	0
15	29005869	.	A	T	29	19	48	0	2	50	0	0
15	29005935	.	C	T	23	19	42	0	1	43	0	0
15	29005984	.	C	T	21	12	33	0	0	33	0	0
15	29005996	.	C	A	20	16	36	0	2	38	0	0
15	29006097	.	C	T	30	14	44	0	1	45	0	0
15	29006142	.	G	A	3	17	20	0	31	51	0	0
15	29089143	.	T	A	26	21	47	0	1	48	0	0
15	29089279	.	C	A	31	24	55	0	1	56	0	0
15	29089317	.	A	G	29	22	51	0	1	52	0	0
15	29089392	.	A	G	18	18	36	0	1	37	0	0
15	29089524	.	T	C	31	19	50	0	1	51	0	0
15	29089788	.	G	A	29	20	49	0	2	51	0	0
15	29089827	.	G	T	3	25	28	0	26	54	0	0
15	29089870	.	C	T	29	32	61	0	3	64	0	0
15	29090181	.	A	G	23	27	50	0	5	55	0	0
15	29091565	.	G	A	27	22	49	0	2	51	0	0
15	29092871	.	C	T	3	5	8	0	0	8	0	0
15	29093073	.	C	A	5	9	14	0	0	14	0	0
15	29097468	.	T	C	6	15	21	0	2	23	0	0
15	29097640	.	A	G	22	12	34	0	0	34	0	0
15	29100574	.	T	G	15	10	25	0	1	26	0	0
15	29100623	.	G	A	12	11	23	1	1	25	0	0
15	29100934	.	C	G	13	15	28	0	3	31	0	0
15	29104050	.	G	A	13	12	25	0	0	25	0	0
15	29106691	.	T	C	6	9	15	0	1	16	0	0
15	29108812	.	T	C	9	10	19	0	0	19	0	0
15	29108872	.	A	G	10	12	22	0	1	23	0	0
15	29108896	.	A	G	6	14	20	0	1	21	0	0
15	29111682	.	T	C	10	0	10	0	12	22	0	0
15	29111902	.	A	C	5	0	5	0	10	15	0	0
15	29111969	.	C	T	9	7	16	0	0	16	0	0
15	29111970	.	T	C	9	7	16	0	0	16	0	0
15	29112164	.	C	T	4	8	12	0	0	12	0	0
15	29114289	.	C	A	6	7	13	0	0	13	0	0
15	29114337	.	C	G	0	9	9	0	10	19	0	0
15	29114361	.	A	T	11	8	19	0	3	22	0	0
15	29116177	.	T	C	6	8	14	0	0	14	0	0
15	29116264	.	A	G	18	22	40	1	6	47	0	0
15	29116658	.	C	G	19	5	24	0	1	25	0	0
15	29116659	.	A	G	20	5	25	0	0	25	0	0
15	29119813	.	A	C	11	13	24	0	1	25	0	0
15	29119829	.	A	C	14	15	29	0	1	30	0	0
15	29122072	.	T	A	16	22	38	0	2	40	0	0
15	29123085	.	G	T	5	3	8	0	0	8	0	0
15	29136127	.	A	T	4	5	9	0	0	9	0	0
15	29148674	.	T	C	5	5	10	0	0	10	0	0
15	29148675	.	T	G	5	0	5	0	5	10	0	0
15	29149292	.	C	T	8	6	14	0	0	14	0	0
15	29152041	.	G	T	4	6	10	0	0	10	0	0
15	29292180	.	T	C	1	6	7	0	1	8	0	0
15	29294445	.	C	T	6	2	8	0	1	9	0	0
15	29297445	.	C	T	3	6	9	0	1	10	0	0
15	29297752	.	G	A	4	4	8	0	0	8	0	0
15	29311995	.	G	C	1	9	10	0	7	17	0	0
15	29312333	.	T	C	8	6	14	0	0	14	0	0
15	29312748	.	T	C	9	7	16	0	1	17	0	0
15	29312763	.	C	T	11	7	18	0	0	18	0	0
15	29314588	.	G	A	0	4	4	0	8	12	0	0
15	29316909	.	A	G	6	7	13	0	0	13	0	0
15	29326129	.	T	C	1	0	1	0	2	3	0	0
15	29343863	.	A	G	2	4	6	0	0	6	0	0
15	29344053	.	G	A	3	3	6	0	1	7	0	0
15	29344979	.	A	G	3	2	5	0	1	6	0	0
15	29383494	.	T	C	1	2	3	0	0	3	0	0
15	29393763	.	C	T	4	3	7	0	0	7	0	0
15	29454352	.	G	A	13	7	20	0	1	21	0	0
15	29456387	.	A	G	12	12	24	1	1	26	0	0
15	29456410	.	C	T	17	14	31	0	0	31	0	0
15	29459013	.	A	G	14	13	27	0	2	29	0	0
15	29459046	.	G	A	9	13	22	0	0	22	0	0
15	29465874	.	T	C	7	8	15	0	3	18	0	0
15	29467216	.	T	A	20	12	32	0	0	32	0	0
15	29467254	.	A	G	18	1	19	0	11	30	0	0
15	29467339	.	A	G	17	15	32	0	0	32	0	0
15	29469851	.	G	T	12	11	23	0	1	24	0	0
15	29481884	.	A	G	19	6	25	0	0	25	0	0
15	29481921	.	G	A	2	8	10	0	18	28	0	0
15	29482286	.	G	C	18	9	27	0	0	27	0	0
15	29482439	.	A	G	9	8	17	0	0	17	0	0
15	29483095	.	T	G	2	5	7	0	0	7	0	0
15	29483236	.	T	G	9	9	18	0	0	18	0	0
15	29483326	.	G	A	0	3	3	0	3	6	0	0
15	29483434	.	G	C	6	13	19	0	0	19	0	0
15	29483608	.	A	T	11	4	15	0	1	16	0	0
15	29483712	.	T	A	3	3	6	0	1	7	0	0
15	29483851	.	G	T	20	10	30	0	3	33	0	0
15	29549217	.	A	G	5	5	10	0	0	10	0	0
15	29549677	.	T	A	6	6	12	0	0	12	0	0
15	29549804	.	C	T	0	7	7	0	5	12	0	0
15	29555703	.	T	C	3	5	8	0	0	8	0	0
15	29555706	.	A	T	4	4	8	0	1	9	0	0
15	29556667	.	T	C	6	6	12	0	0	12	0	0
15	29709048	.	G	T	4	5	9	0	0	9	0	0
15	29709825	.	T	C	4	3	7	0	1	8	0	0
15	29710065	.	A	G	6	12	18	0	0	18	0	0
15	29710305	.	T	C	5	11	16	0	0	16	0	0
15	29710737	.	G	T	5	2	7	0	1	8	0	0
15	29712127	.	C	A	8	9	17	0	2	19	0	0
15	29712210	.	G	A	0	9	9	0	11	20	0	0
15	29712221	.	C	T	13	9	22	0	0	22	0	0
15	29712405	.	G	A	9	10	19	0	1	20	0	0
15	29712794	.	C	T	1	5	6	0	0	6	0	0
15	29772299	.	T	A	3	2	5	0	0	5	0	0
15	29775134	.	A	G	3	2	5	0	3	8	0	0
15	29889577	.	G	A	3	3	6	0	0	6	0	0
15	29889709	.	C	T	1	2	3	0	7	10	0	0
15	29889884	.	A	G	6	2	8	0	0	8	0	0
15	30127451	.	T	C	7	10	17	0	0	17	0	0
15	30130286	.	G	T	2	6	8	0	0	8	0	0
15	30130530	.	A	C	6	7	13	0	1	14	0	0
15	30130664	.	G	A	3	5	8	0	16	24	0	0
15	30131482	.	G	A	10	6	16	0	3	19	0	0
15	30131585	.	C	T	5	6	11	0	0	11	0	0
15	30131803	.	G	A	6	5	11	0	1	12	0	0
15	30134489	.	G	A	7	5	12	0	1	13	0	0
15	30134679	.	C	G	4	7	11	0	0	11	0	0
15	30134779	.	G	T	7	6	13	0	0	13	0	0
15	30135206	.	G	A	0	14	14	0	6	20	0	0
15	30135572	.	A	G	8	0	8	0	8	16	0	0
15	30135920	.	A	G	4	7	11	0	1	12	0	0
15	30135948	.	G	A	3	7	10	0	1	11	0	0
15	30136472	.	A	G	1	3	4	0	0	4	0	0
15	30136512	.	T	A	1	2	3	0	0	3	0	0
15	30136962	.	A	G	6	0	6	0	15	21	0	0
15	30137561	.	C	T	15	11	26	0	0	26	0	0
15	30157713	.	A	G	11	2	13	0	15	28	0	0
15	30158096	.	G	T	1	9	10	0	13	23	0	0
15	30159050	.	A	T	9	8	17	0	1	18	0	0
15	30252414	.	T	C	11	8	19	0	2	21	0	0
15	30265017	.	C	T	16	12	28	0	2	30	0	0
15	30301196	.	G	A	0	10	10	0	4	14	0	0
15	30301239	.	G	A	0	3	3	0	9	12	0	0
15	30301320	.	T	C	14	11	25	0	0	25	0	0
15	30301447	.	G	A	7	7	14	0	1	15	0	0
15	30301474	.	G	A	5	11	16	0	0	16	0	0
15	30311016	.	C	T	3	6	9	0	0	9	0	0
15	30311062	.	G	T	3	3	6	0	4	10	0	0
15	30311616	.	T	G	1	6	7	0	0	7	0	0
15	30350666	.	A	T	3	2	5	0	0	5	0	0
15	30354513	.	G	T	4	2	6	0	0	6	0	0
15	30354603	.	A	T	2	6	8	0	0	8	0	0
15	30424673	.	C	T	0	12	12	0	8	20	0	0
15	30425936	.	G	A	6	9	15	0	0	15	0	0
15	30838455	.	C	G	4	5	9	0	3	12	0	0
15	30838498	.	G	A	1	5	6	0	1	7	0	0
15	30838777	.	G	A	20	13	33	0	0	33	0	0
15	30838867	.	C	T	9	15	24	0	2	26	0	0
15	30838991	.	C	A	11	5	16	1	6	23	0	0
15	30839168	.	A	T	15	5	20	0	0	20	0	0
15	30852433	.	G	A	16	11	27	0	0	27	0	0
15	30852598	.	T	C	13	9	22	0	0	22	0	0
15	30853039	.	G	T	10	10	20	0	0	20	0	0
15	30853096	.	T	A	7	19	26	0	0	26	0	0
15	30861987	.	C	A	0	4	4	0	1	5	0	0
15	30862251	.	A	T	8	5	13	0	0	13	0	0
15	30862449	.	A	G	8	6	14	0	2	16	0	0
15	30862452	.	G	T	9	6	15	0	1	16	0	0
15	30862712	.	G	A	18	8	26	0	0	26	0	0
15	30862785	.	C	T	8	8	16	0	0	16	0	0
15	30862814	.	A	G	8	9	17	0	0	17	0	0
15	30862848	.	T	C	11	6	17	0	1	18	0	0
15	30862997	.	T	G	7	7	14	0	0	14	0	0
15	30863059	.	T	C	7	0	7	0	4	11	0	0
15	30863117	.	T	C	5	5	10	0	0	10	0	0
15	30863123	.	A	C	5	6	11	0	0	11	0	0
15	30863242	.	T	C	7	4	11	0	0	11	0	0
15	30863354	.	C	T	5	7	12	0	0	12	0	0
15	30863535	.	G	T	21	12	33	0	3	36	0	0
15	30863569	.	G	A	21	13	34	0	4	38	0	0
15	30863799	.	T	C	13	0	13	0	7	20	0	0
15	30863834	.	G	T	11	7	18	0	1	19	0	0
15	30863850	.	T	C	11	5	16	0	0	16	0	0
15	30864072	.	T	G	9	5	14	0	0	14	0	0
15	30864308	.	C	A	8	8	16	0	1	17	0	0
15	30864354	.	T	C	10	0	10	0	6	16	0	0
15	30864424	.	C	A	13	3	16	0	0	16	0	0
15	30864425	.	T	A	12	3	15	0	0	16	1	0
15	30874327	.	A	G	9	12	21	0	2	23	0	0
15	30874387	.	G	A	11	11	22	0	0	22	0	0
15	30883761	.	T	C	8	0	8	0	8	16	0	0
15	30887163	.	G	A	6	6	12	0	1	13	0	0
15	30888274	.	G	A	7	7	14	0	1	15	0	0
15	30889297	.	T	C	9	7	16	0	0	16	0	0
15	30889544	.	T	C	8	4	12	0	0	12	0	0
15	30891570	.	A	G	4	4	8	0	2	10	0	0
15	30891636	.	C	T	4	2	6	0	0	6	0	0
15	30891645	.	G	A	4	3	7	0	0	7	0	0
15	30896882	.	G	A	1	2	3	0	0	3	0	0
15	30900478	.	A	G	4	4	8	0	0	8	0	0
15	30902892	.	C	T	0	2	2	0	3	5	0	0
15	30904802	.	G	A	1	4	5	0	0	5	0	0
15	30906972	.	G	A	5	2	7	0	1	8	0	0
15	30907089	.	C	G	0	7	7	0	5	12	0	0
15	30907811	.	A	G	11	11	22	0	1	23	0	0
15	30907818	.	G	A	0	9	9	0	13	22	0	0
15	30907884	.	C	A	10	13	23	0	2	25	0	0
15	30907888	.	A	G	10	0	10	0	14	24	0	0
15	30909175	.	C	G	26	0	26	0	12	38	0	0
15	30909308	.	G	A	2	19	21	0	20	41	0	0
15	30909572	.	C	A	10	16	26	0	1	27	0	0
15	30909707	.	A	T	8	9	17	0	2	19	0	0
15	30909771	.	T	C	6	17	23	0	0	23	0	0
15	30909798	.	A	G	4	0	4	0	14	18	0	0
15	30909824	.	A	C	7	15	22	0	0	22	0	0
15	30909884	.	C	T	13	8	21	0	1	22	0	0
15	30917695	.	T	G	3	0	3	0	6	9	0	0
15	30917715	.	A	G	7	7	14	0	0	14	0	0
15	30917737	.	C	T	8	5	13	0	1	14	0	0
15	30917750	.	A	T	8	8	16	0	0	16	0	0
15	30919478	.	C	T	3	7	10	0	1	11	0	0
15	30919595	.	T	C	10	8	18	0	0	18	0	0
15	30919676	.	G	T	8	5	13	0	0	13	0	0
15	30919854	.	T	G	7	6	13	0	0	13	0	0
15	30920135	.	A	G	6	7	13	0	0	13	0	0
15	30920242	.	A	C	3	2	5	0	0	5	0	0
15	30920698	.	C	A	10	10	20	0	1	21	0	0
15	30920780	.	T	C	4	4	8	0	0	8	0	0
15	30920795	.	A	G	3	4	7	0	0	8	1	0
15	30939882	.	T	C	3	0	3	0	6	9	0	0
15	30943184	.	A	G	3	3	6	0	0	6	0	0
15	30951852	.	A	G	3	4	7	0	0	7	0	0
15	30953159	.	T	C	3	3	6	0	0	6	0	0
15	30953189	.	C	G	1	4	5	0	0	5	0	0
15	30955191	.	A	G	7	4	11	0	0	11	0	0
15	30955263	.	G	C	3	0	3	0	7	10	0	0
15	30955388	.	G	A	2	3	5	0	0	5	0	0
15	30958409	.	T	C	1	4	5	0	0	5	0	0
15	30965387	.	C	T	0	2	2	0	5	7	0	0
15	30967396	.	A	G	1	4	5	0	0	5	0	0
15	30970232	.	A	G	2	5	7	0	0	7	0	0
15	30970242	.	C	T	2	5	7	0	0	7	0	0
15	30972017	.	G	A	3	4	7	0	0	7	0	0
15	31033022	.	A	C	2	2	4	0	0	4	0	0
15	31033050	.	A	T	1	2	3	0	0	3	0	0
15	31099528	.	A	G	1	2	3	0	0	3	0	0
15	31162074	.	T	A	14	18	32	0	0	32	0	0
15	31162122	.	A	G	11	23	34	0	0	34	0	0
15	31162186	.	G	C	7	25	32	0	0	32	0	0
15	31162795	.	G	A	18	12	30	0	2	32	0	0
15	31162836	.	A	G	16	9	25	0	1	26	0	0
15	31163089	.	G	A	10	19	29	0	3	32	0	0
15	31163148	.	T	A	15	17	32	0	6	38	0	0
15	31163335	.	A	T	11	17	28	0	0	28	0	0
15	31163621	.	T	A	28	18	46	0	1	47	0	0
15	31166755	.	C	A	16	12	28	0	0	28	0	0
15	31166788	.	A	G	14	13	27	0	0	27	0	0
15	31173414	.	G	A	12	10	22	0	1	23	0	0
15	31177053	.	A	G	8	8	16	0	1	17	0	0
15	31177054	.	T	A	10	8	18	0	0	18	0	0
15	31177214	.	T	G	14	8	22	0	0	22	0	0
15	31203002	.	A	G	4	12	16	0	0	16	0	0
15	31205723	.	A	G	2	12	14	0	0	14	0	0
15	31213017	.	T	C	6	0	6	0	12	18	0	0
15	31213046	.	T	G	6	10	16	0	2	18	0	0
15	31213105	.	C	T	0	8	8	0	7	15	0	0
15	31213171	.	A	G	7	6	13	0	0	13	0	0
15	31213208	.	C	T	4	10	14	0	0	14	0	0
15	31244298	.	C	T	1	4	5	0	5	10	0	0
15	31244412	.	C	T	0	7	7	0	11	18	0	0
15	31250430	.	A	T	1	4	5	0	0	5	0	0
15	31513561	.	G	A	23	32	55	0	5	60	0	0
15	31513842	.	A	G	35	30	65	0	5	70	0	0
15	31513848	.	T	C	37	32	69	0	4	73	0	0
15	31513893	.	C	A	2	24	26	0	45	71	0	0
15	31514325	.	A	G	27	35	62	0	3	65	0	0
15	31516046	.	G	A	4	4	8	0	1	9	0	0
15	31564314	.	G	A	3	2	5	0	0	5	0	0
15	31564691	.	A	G	1	4	5	0	0	5	0	0
15	31564864	.	G	T	5	3	8	0	0	8	0	0
15	31564885	.	A	G	7	3	10	0	0	10	0	0
15	31564946	.	T	C	10	4	14	0	0	14	0	0
15	31565440	.	C	T	8	4	12	0	1	13	0	0
15	31574100	.	T	C	2	0	2	0	5	7	0	0
15	31574119	.	A	G	1	4	5	0	0	5	0	0
15	31674120	.	G	T	5	8	13	0	0	13	0	0
15	31694928	.	G	A	2	8	10	0	7	17	0	0
15	31700738	.	C	T	6	7	13	0	0	13	0	0
15	31706200	.	G	C	7	7	14	0	0	14	0	0
15	31712529	.	C	T	5	8	13	0	0	13	0	0
15	31732502	.	A	G	13	5	18	0	0	18	0	0
15	31766761	.	T	C	1	2	3	0	0	3	0	0
15	31824372	.	A	G	3	3	6	0	0	6	0	0
15	31828002	.	A	T	1	3	4	0	0	4	0	0
15	31829488	.	A	G	5	6	11	0	0	11	0	0
15	31838385	.	C	T	4	2	6	0	1	7	0	0
15	31840371	.	G	A	6	4	10	0	0	10	0	0
15	31852098	.	C	A	3	2	5	0	1	6	0	0
15	31855867	.	T	C	4	2	6	0	0	6	0	0
15	31862250	.	T	C	5	10	15	0	1	16	0	0
15	31862320	.	C	T	5	9	14	0	0	14	0	0
15	31864426	.	G	A	3	4	7	0	0	7	0	0
15	31866308	.	C	T	5	3	8	0	0	8	0	0
15	31866649	.	C	T	5	4	9	0	0	9	0	0
15	31877363	.	C	T	8	8	16	0	0	16	0	0
15	31881825	.	G	A	7	7	14	0	1	15	0	0
15	31881873	.	G	A	1	13	14	0	9	23	0	0
15	31881954	.	T	C	12	10	22	0	0	22	0	0
15	31882044	.	A	G	10	5	15	0	0	15	0	0
15	31882167	.	G	A	2	5	7	0	0	7	0	0
15	31882176	.	A	G	3	7	10	0	0	10	0	0
15	31882269	.	G	A	4	7	11	0	0	11	0	0
15	31882272	.	A	G	4	7	11	0	0	11	0	0
15	31882342	.	C	T	7	3	10	0	1	11	0	0
15	31884219	.	A	C	10	7	17	0	0	17	0	0
15	31889005	.	T	G	8	8	16	0	3	19	0	0
15	31889086	.	A	G	6	10	16	0	0	16	0	0
15	31889332	.	C	T	3	5	8	0	1	9	0	0
15	31890902	.	T	G	8	5	13	0	0	13	0	0
15	31893536	.	A	C	13	6	19	0	2	21	0	0
15	31893599	.	C	T	16	9	25	0	1	26	0	0
15	31895248	.	A	G	11	0	11	0	10	21	0	0
15	31905040	.	G	A	13	20	33	0	2	35	0	0
15	31905097	.	A	G	12	16	28	0	3	31	0	0
15	31909454	.	A	C	15	5	20	0	2	22	0	0
15	31918681	.	T	C	1	2	3	0	0	3	0	0
15	32161056	.	G	A	0	2	2	0	1	3	0	0
15	32165799	.	G	C	2	2	4	0	0	4	0	0
15	32184717	.	G	A	0	2	2	0	2	4	0	0
15	32193250	.	C	T	3	2	5	0	0	5	0	0
15	32193624	.	A	C	4	2	6	0	0	6	0	0
15	32193892	.	G	T	0	3	3	0	2	5	0	0
15	32193922	.	A	T	1	2	3	0	0	3	0	0
15	32194286	.	G	A	2	3	5	0	0	5	0	0
15	32194550	.	A	C	3	2	5	0	0	5	0	0
15	32194708	.	A	G	2	2	4	0	0	4	0	0
15	32194945	.	C	A	2	3	5	0	0	5	0	0
15	32195020	.	C	T	4	5	9	0	0	9	0	0
15	32195395	.	T	C	3	5	8	0	0	8	0	0
15	32195521	.	T	C	6	7	13	0	0	13	0	0
15	32195718	.	G	A	4	6	10	0	2	12	0	0
15	32195729	.	A	G	4	4	8	0	1	9	0	0
15	32196363	.	A	T	1	3	4	0	0	4	0	0
15	32196731	.	A	C	1	1	2	0	0	2	0	0
15	32197001	.	G	C	5	2	7	0	0	7	0	0
15	32197453	.	A	G	3	3	6	0	0	6	0	0
15	32197458	.	T	C	4	3	7	0	0	7	0	0
15	32249188	.	G	A	19	16	35	0	2	37	0	0
15	32259056	.	G	A	9	11	20	0	1	21	0	0
15	32261461	.	G	C	0	9	9	2	15	26	0	0
15	32261464	.	T	C	9	15	24	2	0	26	0	0
15	32265889	.	T	C	15	17	32	0	0	32	0	0
15	32266557	.	A	T	10	9	19	0	0	19	0	0
15	32266921	.	G	A	2	12	14	0	12	26	0	0
15	32267078	.	A	G	9	7	16	0	1	17	0	0
15	32267120	.	C	A	3	5	8	0	0	8	0	0
15	32349509	.	A	G	13	3	16	0	1	17	0	0
15	32349742	.	A	G	10	9	19	0	0	19	0	0
15	32350116	.	G	T	6	7	13	0	0	13	0	0
15	32350762	.	A	G	18	8	26	0	0	26	0	0
15	32350820	.	A	G	13	6	19	1	0	20	0	0
15	32351183	.	A	G	8	8	16	0	0	16	0	0
15	32351476	.	A	G	6	7	13	2	0	15	0	0
15	32887799	.	A	G	2	5	7	0	1	8	0	0
15	32887858	.	A	G	12	6	18	0	0	18	0	0
15	33817756	.	T	G	1	9	10	0	0	10	0	0
15	33853701	.	C	T	4	7	11	0	1	12	0	0
15	33864152	.	A	G	2	6	8	0	0	8	0	0
15	33864266	.	G	A	2	6	8	0	0	8	0	0
15	33864585	.	G	A	6	3	9	0	1	10	0	0
15	33891825	.	G	A	27	21	48	0	2	50	0	0
15	33891826	.	G	A	30	21	51	0	0	51	0	0
15	33891869	.	G	T	24	16	40	0	0	40	0	0
15	33896117	.	G	T	24	28	52	0	6	58	0	0
15	33896177	.	T	C	18	37	55	0	2	57	0	0
15	33896213	.	T	C	23	3	26	0	33	59	0	0
15	33896303	.	T	A	29	24	53	0	3	57	1	0
15	33896306	.	A	G	25	27	52	0	2	54	0	0
15	33896832	.	T	C	27	15	42	0	3	45	0	0
15	33899556	.	C	G	23	15	38	0	2	40	0	0
15	33899808	.	T	A	28	18	46	0	4	50	0	0
15	33902388	.	C	G	4	13	17	0	19	36	0	0
15	33910546	.	G	C	23	23	46	2	1	49	0	0
15	33970841	.	A	G	18	0	18	0	20	38	0	0
15	33970854	.	C	T	21	19	40	0	2	42	0	0
15	33970907	.	C	T	28	16	44	0	2	46	0	0
15	33971097	.	G	C	18	28	46	0	0	46	0	0
15	33977716	.	A	T	12	20	32	0	1	33	0	0
15	33977760	.	A	G	10	1	11	0	19	30	0	0
15	33977942	.	A	C	13	9	22	0	0	22	0	0
15	34074558	.	C	T	4	3	7	0	0	7	0	0
15	34174532	.	T	A	16	16	32	0	1	33	0	0
15	34174568	.	T	A	13	15	28	0	0	28	0	0
15	34174635	.	T	C	9	6	15	0	0	15	0	0
15	34174744	.	A	T	2	3	5	0	0	5	0	0
15	34175101	.	T	C	17	14	31	0	0	31	0	0
15	34175359	.	G	A	12	4	16	0	0	16	0	0
15	34175426	.	T	A	6	7	13	0	1	14	0	0
15	34175718	.	G	A	6	3	9	0	0	9	0	0
15	34175917	.	C	T	7	8	15	1	0	16	0	0
15	34175929	.	C	T	10	7	17	1	0	18	0	0
15	34176203	.	A	T	9	11	20	0	1	22	1	0
15	34176214	.	C	T	12	9	21	0	1	22	0	0
15	34176336	.	G	T	3	2	5	0	0	5	0	0
15	34176379	.	A	C	10	8	18	0	0	18	0	0
15	34176841	.	A	T	7	11	18	0	0	18	0	0
15	34176993	.	G	A	12	4	16	0	0	16	0	0
15	34182135	.	G	A	11	9	20	0	1	21	0	0
15	34186690	.	A	T	7	12	19	0	0	19	0	0
15	34189452	.	G	A	14	8	22	0	1	23	0	0
15	34215835	.	A	T	1	3	4	0	0	4	0	0
15	34223260	.	A	G	3	2	5	0	0	5	0	0
15	34239165	.	C	T	2	2	4	0	0	4	0	0
15	34239191	.	C	T	3	4	7	0	0	7	0	0
15	34306614	.	G	A	1	2	3	0	0	3	0	0
15	34319453	.	A	G	2	2	4	0	0	4	0	0
15	34354169	.	G	T	2	0	2	0	1	3	0	0
15	34354179	.	C	T	2	2	4	0	0	4	0	0
15	34367541	.	C	T	0	4	4	0	3	7	0	0
15	34534245	.	C	G	9	5	14	0	0	14	0	0
15	34534265	.	C	T	4	6	10	0	1	11	0	0
15	34558428	.	G	A	3	7	10	0	0	10	0	0
15	34573337	.	C	T	1	2	3	0	0	3	0	0
15	34573343	.	A	G	2	3	5	0	0	5	0	0
15	34573454	.	A	C	4	7	11	0	0	11	0	0
15	34573597	.	A	T	4	5	9	0	0	9	0	0
15	34573664	.	G	T	3	6	9	0	0	9	0	0
15	34573952	.	T	A	0	6	6	0	0	6	0	0
15	34573959	.	A	T	1	6	7	0	0	7	0	0
15	34574116	.	G	A	8	6	14	0	3	17	0	0
15	34577749	.	G	A	8	9	17	0	0	17	0	0
15	34590674	.	A	C	3	4	7	0	0	7	0	0
15	34590772	.	A	G	6	7	13	0	0	13	0	0
15	34618669	.	A	T	10	16	26	0	0	26	0	0
15	34618906	.	C	A	10	10	20	0	1	21	0	0
15	34618948	.	T	G	13	12	25	0	0	25	0	0
15	34618958	.	G	A	15	9	24	0	4	28	0	0
15	34621868	.	G	A	11	12	23	0	2	25	0	0
15	34621875	.	G	A	14	11	25	0	3	28	0	0
15	34627792	.	T	A	17	9	26	0	0	26	0	0
15	34627874	.	T	C	14	12	26	0	3	29	0	0
15	34635321	.	C	A	8	9	17	0	1	18	0	0
15	34635336	.	A	C	10	0	10	0	7	17	0	0
15	34637582	.	C	T	2	12	14	0	13	27	0	0
15	34638847	.	C	T	1	10	11	0	12	23	0	0
15	34641252	.	G	C	4	0	4	0	8	12	0	0
15	34641276	.	G	A	7	10	17	0	0	17	0	0
15	34641300	.	G	A	8	10	18	0	0	18	0	0
15	34641384	.	G	A	19	7	26	0	0	26	0	0
15	34657370	.	C	T	10	4	14	0	0	14	0	0
15	34657919	.	T	A	12	8	20	0	0	20	0	0
15	35076003	.	C	T	8	8	16	1	2	19	0	0
15	35091591	.	A	G	6	3	9	0	1	10	0	0
15	35091659	.	A	G	6	2	8	0	0	8	0	0
15	35115699	.	A	G	1	4	5	5	0	10	0	0
15	35156554	.	T	G	2	2	4	0	0	4	0	0
15	35156573	.	A	T	4	1	5	0	0	5	0	0
15	35157052	.	T	A	6	6	12	0	0	12	0	0
15	35157054	.	G	A	5	5	10	0	1	11	0	0
15	35158661	.	T	G	6	12	18	0	1	19	0	0
15	35163492	.	T	G	10	8	18	0	1	19	0	0
15	35212147	.	C	G	0	7	7	0	7	14	0	0
15	35212177	.	G	A	9	7	16	0	0	16	0	0
15	35212318	.	A	T	7	4	11	0	0	11	0	0
15	35212386	.	T	C	4	9	13	0	0	13	0	0
15	35212418	.	G	C	3	6	9	0	0	9	0	0
15	35214784	.	T	A	7	4	11	0	0	11	0	0
15	35214859	.	A	C	8	0	8	0	8	16	0	0
15	35214901	.	G	A	7	9	16	0	0	16	0	0
15	35217424	.	G	A	8	6	14	0	0	14	0	0
15	35217475	.	T	C	9	6	15	0	1	16	0	0
15	35217487	.	C	A	0	8	8	0	12	20	0	0
15	35224269	.	G	C	13	9	22	0	0	22	0	0
15	35247678	.	A	T	24	18	42	0	2	44	0	0
15	35247687	.	A	G	21	22	43	0	0	43	0	0
15	35247729	.	A	G	16	26	42	0	0	42	0	0
15	35247762	.	T	C	15	18	33	0	2	35	0	0
15	35386062	.	C	T	1	2	3	0	0	3	0	0
15	35709983	.	G	A	0	5	5	0	6	11	0	0
15	35709988	.	C	T	6	5	11	0	1	12	0	0
15	35718398	.	A	C	5	5	10	0	0	10	0	0
15	35737680	.	T	C	7	7	14	0	0	14	0	0
15	35760664	.	C	T	6	12	18	0	1	19	0	0
15	35760925	.	T	C	5	5	10	0	0	10	0	0
15	35760943	.	C	T	6	6	12	0	1	13	0	0
15	35760970	.	G	A	6	8	14	0	1	15	0	0
15	35761024	.	T	C	9	9	18	0	0	18	0	0
15	35761027	.	A	G	7	9	16	0	0	16	0	0
15	35761126	.	G	A	1	12	13	0	14	27	0	0
15	35761225	.	G	A	9	8	17	0	0	17	0	0
15	35761516	.	T	C	6	4	10	0	0	10	0	0
15	35889139	.	G	A	2	2	4	0	0	4	0	0
15	35889474	.	G	A	3	3	6	0	1	7	0	0
15	35889516	.	A	C	3	2	5	0	2	7	0	0
15	35889517	.	C	A	0	2	2	0	5	7	0	0
15	35889810	.	G	A	3	6	9	0	1	10	0	0
15	35889826	.	C	T	7	4	11	0	0	11	0	0
15	35889865	.	A	G	2	6	8	0	0	8	0	0
15	35889970	.	C	T	2	2	4	0	0	4	0	0
15	35889971	.	G	A	2	2	4	0	0	4	0	0
15	35890046	.	G	A	4	3	7	0	0	7	0	0
15	35890372	.	T	A	2	2	4	0	1	5	0	0
15	35891639	.	T	A	4	2	6	0	0	6	0	0
15	35926361	.	C	G	3	2	5	0	0	5	0	0
15	35927066	.	T	G	2	4	6	0	0	6	0	0
15	35927375	.	A	G	1	4	5	0	0	5	0	0
15	37222589	.	T	C	30	37	67	0	3	70	0	0
15	37227033	.	T	G	38	34	72	0	3	75	0	0
15	37227059	.	A	G	36	3	39	0	34	73	0	0
15	37227509	.	A	G	30	0	30	0	29	59	0	0
15	37227714	.	A	G	24	4	28	0	31	59	0	0
15	37227770	.	G	A	33	22	55	0	4	62	3	0
15	37228164	.	A	G	38	28	66	0	1	67	0	0
15	37228236	.	C	T	19	29	48	0	3	51	0	0
15	37228266	.	T	C	25	26	51	0	1	52	0	0
15	37228301	.	T	A	22	32	54	1	2	57	0	0
15	37228338	.	T	A	21	22	43	1	3	47	0	0
15	37228620	.	G	C	42	18	60	0	1	61	0	0
15	37228626	.	G	A	40	17	57	0	1	58	0	0
15	37228665	.	C	G	34	31	65	0	1	66	0	0
15	37228843	.	T	A	49	16	65	1	3	69	0	0
15	37228845	.	T	G	46	15	61	1	5	68	1	0
15	37229199	.	A	G	20	0	20	8	5	33	0	0
15	37229871	.	A	T	35	35	70	0	3	73	0	0
15	37229991	.	C	A	38	27	65	0	1	67	1	0
15	37230038	.	G	A	35	28	63	0	3	66	0	0
15	37230100	.	G	A	33	32	65	0	2	67	0	0
15	37459049	.	T	C	5	0	5	0	3	8	0	0
15	37459979	.	T	C	6	8	14	0	0	14	0	0
15	37459988	.	T	C	5	0	5	0	6	11	0	0
15	37460201	.	T	C	3	0	3	0	2	5	0	0
15	37561838	.	A	G	1	2	3	0	0	3	0	0
15	38859746	.	C	T	8	6	14	0	0	14	0	0
15	38859753	.	A	C	6	4	10	0	0	10	0	0
15	38892060	.	T	C	10	9	19	0	0	19	0	0
15	39128662	.	C	T	14	7	21	0	3	24	0	0
15	39140121	.	C	A	19	13	32	0	0	32	0	0
15	39140568	.	G	A	3	15	18	0	12	30	0	0
15	39141465	.	T	C	13	8	21	0	1	22	0	0
15	39208133	.	C	A	15	14	29	0	2	31	0	0
15	39208150	.	C	T	15	15	30	0	1	31	0	0
15	39208201	.	C	A	15	14	29	0	1	30	0	0
15	39208211	.	C	T	15	15	30	0	0	30	0	0
15	39208258	.	C	T	21	16	37	0	3	40	0	0
15	39228174	.	A	G	17	29	46	0	1	47	0	0
15	39278501	.	G	T	4	10	14	0	0	14	0	0
15	39281923	.	A	G	13	12	25	0	2	27	0	0
15	39282007	.	G	C	11	0	11	0	11	22	0	0
15	39282070	.	A	G	9	7	16	0	1	17	0	0
15	39282091	.	G	A	6	13	19	0	4	23	0	0
15	39294391	.	C	T	12	12	24	0	0	24	0	0
15	39296706	.	A	G	9	11	20	0	2	22	0	0
15	39296730	.	G	A	12	9	21	0	2	23	0	0
15	39297051	.	G	A	18	12	30	0	2	32	0	0
15	39297081	.	A	G	11	16	27	0	4	31	0	0
15	39305598	.	G	A	9	4	13	0	0	13	0	0
15	39312461	.	G	A	3	10	13	0	0	13	0	0
15	39326986	.	C	T	13	9	22	0	0	22	0	0
15	39345641	.	G	A	7	7	14	0	0	14	0	0
15	39354726	.	G	A	3	7	10	0	0	10	0	0
15	39359522	.	A	T	3	5	8	0	0	8	0	0
15	39368871	.	T	G	4	5	9	0	0	9	0	0
15	39368952	.	A	C	4	3	7	0	1	8	0	0
15	39372699	.	G	A	5	3	8	0	0	8	0	0
15	39629864	.	T	A	3	3	6	0	1	7	0	0
15	39967275	.	G	A	46	24	70	0	0	70	0	0
15	39969923	.	T	G	30	34	64	0	8	72	0	0
15	39986125	.	C	A	6	5	11	0	0	11	0	0
15	39987655	.	C	T	13	7	20	0	1	21	0	0
15	39987691	.	T	C	11	8	19	0	0	19	0	0
15	39992053	.	C	T	10	5	15	0	0	15	0	0
15	40000966	.	C	A	10	11	21	0	0	21	0	0
15	40000981	.	A	T	11	10	21	0	0	21	0	0
15	40002242	.	C	T	11	13	24	0	0	24	0	0
15	40002319	.	C	T	9	15	24	0	2	26	0	0
15	40002325	.	C	T	10	13	23	0	1	24	0	0
15	40002534	.	A	T	5	4	9	0	0	9	0	0
15	40004793	.	A	G	6	2	8	1	0	9	0	0
15	40004820	.	G	A	2	4	6	0	0	6	0	0
15	40005111	.	A	G	9	6	15	0	0	15	0	0
15	40005112	.	A	G	5	10	15	0	0	15	0	0
15	40005279	.	C	T	5	3	8	0	0	8	0	0
15	40005297	.	A	C	5	5	10	0	0	10	0	0
15	40005318	.	T	A	9	5	14	0	0	14	0	0
15	40005466	.	C	T	6	10	16	0	2	18	0	0
15	40005545	.	T	C	10	10	20	0	1	21	0	0
15	40006090	.	A	C	6	5	11	0	1	12	0	0
15	40008449	.	C	T	23	24	47	0	1	48	0	0
15	40008498	.	C	T	23	22	45	0	3	48	0	0
15	40008544	.	C	A	23	34	57	0	2	59	0	0
15	40018239	.	G	A	4	28	32	0	34	66	0	0
15	40018290	.	C	T	42	22	64	0	0	64	0	0
15	40027138	.	C	T	43	31	74	0	4	78	0	0
15	40027279	.	T	C	51	28	79	0	3	82	0	0
15	40027364	.	G	T	47	19	66	0	0	66	0	0
15	40027377	.	C	T	34	24	58	0	7	65	0	0
15	40027484	.	T	G	32	1	33	0	25	58	0	0
15	40027540	.	A	C	20	36	56	0	5	61	0	0
15	40027717	.	A	G	29	31	60	0	2	62	0	0
15	40028457	.	T	G	41	30	71	0	4	75	0	0
15	40028568	.	G	A	33	19	52	0	5	57	0	0
15	40028574	.	A	G	28	22	50	0	10	60	0	0
15	40091068	.	C	T	15	8	23	0	0	23	0	0
15	40099812	.	C	T	11	6	17	0	0	17	0	0
15	40099844	.	T	C	12	7	19	0	0	19	0	0
15	40104028	.	T	C	16	9	25	0	2	27	0	0
15	40108886	.	T	C	22	13	35	0	0	35	0	0
15	40108898	.	C	T	20	15	35	0	0	35	0	0
15	40115610	.	A	T	11	12	23	0	3	26	0	0
15	40115676	.	C	T	14	19	33	0	1	34	0	0
15	40122221	.	A	G	19	9	28	0	2	30	0	0
15	40122625	.	G	A	12	14	26	0	2	28	0	0
15	40126698	.	A	G	25	1	26	0	19	45	0	0
15	40128979	.	C	G	26	15	41	0	2	43	0	0
15	40129543	.	G	C	18	14	32	0	0	32	0	0
15	40129594	.	T	G	16	24	40	0	1	41	0	0
15	40129604	.	A	T	12	21	33	0	4	37	0	0
15	40129810	.	A	C	15	14	29	0	0	29	0	0
15	40130181	.	G	A	2	7	9	0	12	21	0	0
15	40130208	.	G	A	5	8	13	0	1	14	0	0
15	40130424	.	T	C	2	2	4	0	1	5	0	0
15	40130425	.	G	A	2	1	3	0	2	5	0	0
15	40130563	.	A	G	11	0	11	0	5	16	0	0
15	40131001	.	G	A	0	6	6	0	5	11	0	0
15	40131060	.	A	G	13	9	22	0	1	23	0	0
15	40131112	.	C	A	16	11	27	0	0	27	0	0
15	40131139	.	T	A	20	10	30	0	3	33	0	0
15	40131157	.	A	G	18	10	28	0	0	28	0	0
15	40131216	.	G	A	11	13	24	0	1	25	0	0
15	40131232	.	C	T	12	7	19	0	1	20	0	0
15	40131276	.	C	G	13	8	21	0	0	21	0	0
15	40131297	.	C	G	14	13	27	0	0	27	0	0
15	40131316	.	C	A	14	12	26	0	3	29	0	0
15	40131363	.	G	T	2	13	15	0	22	37	0	0
15	40131498	.	A	G	14	0	14	0	26	40	0	0
15	40131500	.	A	G	14	25	39	0	1	40	0	0
15	40131547	.	T	C	14	20	34	0	3	37	0	0
15	40131560	.	T	A	12	23	35	0	0	35	0	0
15	40131586	.	C	T	16	28	44	0	0	44	0	0
15	40131619	.	T	C	16	23	39	0	0	39	0	0
15	40131624	.	T	A	16	23	39	0	0	39	0	0
15	40131769	.	T	C	8	11	19	0	0	19	0	0
15	40202354	.	T	G	22	24	46	0	1	47	0	0
15	40202393	.	C	T	17	21	38	0	4	42	0	0
15	40211507	.	T	C	25	23	48	0	7	55	0	0
15	40211591	.	A	C	24	25	49	0	0	49	0	0
15	40211618	.	A	G	29	0	29	0	19	48	0	0
15	40211741	.	C	G	27	13	40	0	0	40	0	0
15	40211954	.	G	T	9	6	15	0	1	16	0	0
15	40217590	.	T	C	1	3	4	0	0	4	0	0
15	40793515	.	G	C	0	5	5	0	2	7	0	0
15	40793800	.	C	T	2	4	6	0	0	6	0	0
15	40794052	.	A	T	2	2	4	0	0	4	0	0
15	40794058	.	T	G	2	2	4	0	0	4	0	0
15	40794089	.	G	A	2	2	4	0	0	4	0	0
15	40794118	.	T	A	2	3	5	0	0	5	0	0
15	40794142	.	C	T	1	4	5	0	0	5	0	0
15	40794183	.	A	C	2	2	4	0	0	4	0	0
15	40794691	.	C	T	3	2	5	0	0	5	0	0
15	40795249	.	T	G	3	3	6	0	0	6	0	0
15	40795639	.	C	T	4	2	6	0	0	6	0	0
15	40796470	.	C	T	1	2	3	0	0	3	0	0
15	40830304	.	C	T	5	4	9	0	1	10	0	0
15	40830376	.	C	T	2	4	6	0	0	6	0	0
15	40864677	.	T	C	1	2	3	0	0	3	0	0
15	40864824	.	C	T	3	2	5	0	0	5	0	0
15	40877098	.	G	A	0	4	4	0	3	7	0	0
15	40893860	.	T	C	2	4	6	0	0	6	0	0
15	40893864	.	G	A	2	4	6	0	0	6	0	0
15	40894244	.	A	G	2	0	2	0	6	8	0	0
15	40894385	.	T	A	4	3	7	0	2	9	0	0
15	40926702	.	C	T	7	3	10	0	0	10	0	0
15	40930419	.	G	A	2	7	9	0	0	9	0	0
15	40933339	.	T	C	4	6	10	0	0	10	0	0
15	40933369	.	G	A	0	4	4	0	3	7	0	0
15	40936283	.	A	G	6	0	6	0	4	10	0	0
15	40938072	.	C	T	11	4	15	0	0	15	0	0
15	40938119	.	G	A	12	10	22	0	0	22	0	0
15	40938305	.	C	T	8	4	12	0	0	12	0	0
15	40938498	.	T	C	7	3	10	0	1	11	0	0
15	40941322	.	G	A	8	6	14	0	0	14	0	0
15	40945651	.	A	G	8	6	14	0	1	15	0	0
15	40945690	.	T	C	8	7	15	0	0	15	0	0
15	40952226	.	A	G	6	4	10	0	0	10	0	0
15	40962073	.	G	T	3	5	8	0	1	9	0	0
15	40962160	.	T	C	5	6	11	0	1	12	0	0
15	40962186	.	C	T	9	5	14	0	0	14	0	0
15	40962280	.	G	C	1	2	3	0	2	5	0	0
15	40988189	.	T	C	16	7	23	0	3	26	0	0
15	40988228	.	C	T	14	9	23	0	2	25	0	0
15	40988565	.	A	G	13	4	17	0	0	17	0	0
15	40988659	.	C	A	5	4	9	0	0	9	0	0
15	40988937	.	A	T	3	2	5	0	0	5	0	0
15	40988947	.	T	C	3	2	5	0	0	5	0	0
15	40988996	.	C	T	2	4	6	0	0	6	0	0
15	40989007	.	G	A	0	4	4	0	2	6	0	0
15	40989053	.	T	G	2	7	9	0	0	9	0	0
15	40989110	.	G	A	1	3	4	0	0	4	0	0
15	40989614	.	C	T	3	2	5	0	0	5	0	0
15	40989690	.	A	G	6	4	10	0	0	10	0	0
15	40989801	.	A	G	7	0	7	0	3	10	0	0
15	41170289	.	A	G	12	16	28	0	0	28	0	0
15	41170710	.	G	A	17	7	24	0	0	24	0	0
15	41170992	.	G	A	13	8	21	0	2	23	0	0
15	41171081	.	T	C	21	0	21	0	12	33	0	0
15	41171135	.	A	G	7	14	21	0	1	22	0	0
15	41171335	.	A	T	20	12	32	0	2	34	0	0
15	41171448	.	A	C	22	13	35	0	1	36	0	0
15	41171471	.	G	T	14	14	28	0	2	30	0	0
15	41171516	.	C	A	3	13	16	1	27	44	0	0
15	41172103	.	G	A	9	8	17	0	1	18	0	0
15	41172303	.	G	T	10	6	16	0	1	17	0	0
15	41172325	.	G	T	10	9	19	0	0	19	0	0
15	41172427	.	T	C	5	8	13	0	1	14	0	0
15	41172649	.	T	A	6	4	10	0	1	11	0	0
15	41172893	.	A	C	12	7	19	0	1	20	0	0
15	41172904	.	G	C	11	8	19	0	1	20	0	0
15	41173093	.	A	T	9	9	18	0	0	18	0	0
15	41173109	.	C	T	12	8	20	0	0	20	0	0
15	41173142	.	G	A	10	5	15	0	0	15	0	0
15	41173261	.	T	G	13	9	22	0	4	26	0	0
15	41173326	.	C	T	18	15	33	0	2	35	0	0
15	41173620	.	G	A	15	13	28	0	0	28	0	0
15	41292134	.	G	A	1	5	6	0	2	8	0	0
15	41769064	.	T	C	5	4	9	0	0	9	0	0
15	41769792	.	T	C	4	10	14	0	1	15	0	0
15	41770222	.	A	G	1	2	3	0	0	3	0	0
15	42767880	.	G	A	1	5	6	0	17	23	0	0
15	42920208	.	G	A	11	4	15	0	0	15	0	0
15	42920218	.	G	A	1	5	6	0	10	16	0	0
15	42920317	.	A	G	4	6	10	0	1	11	0	0
15	42920332	.	G	T	9	3	12	0	0	12	0	0
15	42920365	.	C	T	4	8	12	0	0	12	0	0
15	42933283	.	C	T	4	5	9	1	0	10	0	0
15	42933343	.	G	A	1	3	4	0	5	9	0	0
15	42947514	.	C	T	6	6	12	0	1	13	0	0
15	42947664	.	C	G	5	7	12	0	0	12	0	0
15	42947700	.	C	A	4	3	7	0	0	7	0	0
15	42947799	.	A	G	5	4	9	0	0	9	0	0
15	42952872	.	G	T	9	5	14	0	1	15	0	0
15	42958701	.	C	T	6	10	16	0	0	16	0	0
15	42976197	.	C	G	11	5	16	0	0	17	1	0
15	42981069	.	C	T	5	8	13	0	0	13	0	0
15	42981137	.	C	A	4	7	11	0	1	12	0	0
15	42981223	.	A	G	10	13	23	0	2	25	0	0
15	42981281	.	A	T	12	10	22	0	1	23	0	0
15	42981321	.	G	A	8	6	14	0	0	14	0	0
15	43073941	.	C	T	1	2	3	0	1	4	0	0
15	43604224	.	G	A	3	4	7	0	0	7	0	0
15	43604903	.	C	G	4	6	10	0	0	10	0	0
15	43604928	.	A	G	4	5	9	0	0	9	0	0
15	43604988	.	G	C	3	3	6	0	0	6	0	0
15	43604996	.	A	G	3	4	7	0	0	7	0	0
15	43605398	.	G	T	1	3	4	0	0	4	0	0
15	43605435	.	A	G	4	6	10	0	1	11	0	0
15	43605483	.	C	T	3	7	10	0	6	16	0	0
15	43605503	.	G	C	8	5	13	0	1	14	0	0
15	43605538	.	C	T	0	5	5	0	9	14	0	0
15	43605544	.	G	A	4	5	9	0	2	11	0	0
15	43616981	.	A	G	1	3	4	0	0	4	0	0
15	43617001	.	T	C	1	4	5	0	0	5	0	0
15	43651693	.	G	A	3	4	7	0	0	7	0	0
15	43656352	.	G	A	3	4	7	0	0	7	0	0
15	43656519	.	G	T	1	3	4	0	0	4	0	0
15	43656619	.	C	T	4	4	8	0	0	8	0	0
15	43657018	.	T	A	5	4	9	0	0	9	0	0
15	43662920	.	C	T	3	3	6	0	0	6	0	0
15	43662995	.	G	A	5	2	7	0	0	7	0	0
15	43675801	.	A	G	1	2	3	0	0	3	0	0
15	43917471	.	C	T	1	6	7	0	0	7	0	0
15	43917543	.	G	A	0	7	7	0	2	9	0	0
15	43938527	.	C	T	1	5	6	0	1	7	0	0
15	43969860	.	A	G	2	3	5	0	0	5	0	0
15	43977993	.	A	T	4	1	5	0	2	7	0	0
15	43977995	.	A	T	5	2	7	0	0	7	0	0
15	43978036	.	C	G	4	4	8	0	0	8	0	0
15	43982146	.	T	C	6	5	11	0	0	11	0	0
15	43982517	.	T	C	1	3	4	0	0	4	0	0
15	43983171	.	A	G	3	3	6	0	1	7	0	0
15	43983393	.	C	T	0	3	3	0	2	5	0	0
15	43983402	.	G	A	1	4	5	0	1	6	0	0
15	43983477	.	G	A	3	6	9	0	0	9	0	0
15	43983489	.	G	A	4	5	9	0	0	9	0	0
15	43983525	.	G	A	3	2	5	0	1	6	0	0
15	43983585	.	G	A	7	5	12	0	0	12	0	0
15	43984034	.	T	C	2	2	4	0	0	4	0	0
15	43984470	.	T	C	1	2	3	0	0	3	0	0
15	43988698	.	T	A	4	2	6	0	0	6	0	0
15	44029488	.	A	C	1	2	3	0	0	3	0	0
15	44062437	.	C	T	2	2	4	0	0	4	0	0
15	44072776	.	T	C	11	0	11	3	5	19	0	0
15	44072782	.	G	A	8	10	18	3	2	23	0	0
15	44074653	.	A	G	11	15	26	0	1	27	0	0
15	44075125	.	C	T	1	11	12	0	11	23	0	0
15	44077766	.	A	T	7	15	22	0	1	23	0	0
15	44140324	.	T	G	2	0	2	0	7	9	0	0
15	44140360	.	G	A	10	4	14	0	0	14	0	0
15	44140458	.	G	A	0	2	2	0	5	7	0	0
15	44140666	.	C	T	3	6	9	0	0	9	0	0
15	44140716	.	C	T	3	6	9	0	0	9	0	0
15	44140780	.	A	G	5	2	7	0	0	7	0	0
15	44140991	.	T	C	2	6	8	0	0	8	0	0
15	44141311	.	A	G	3	4	7	0	0	7	0	0
15	44141644	.	A	C	5	2	7	0	1	8	0	0
15	44209147	.	T	G	5	2	7	4	0	11	0	0
15	44255001	.	G	A	4	2	6	0	0	6	0	0
15	44255130	.	A	T	5	2	7	0	0	7	0	0
15	44255212	.	A	C	4	5	9	0	0	9	0	0
15	44255438	.	A	G	2	0	2	0	4	6	0	0
15	44255467	.	C	T	1	4	5	0	0	5	0	0
15	44255473	.	T	C	2	4	6	0	0	6	0	0
15	44255503	.	A	T	2	2	4	0	0	4	0	0
15	44283812	.	A	G	5	6	11	0	1	12	0	0
15	44290546	.	C	T	4	5	9	0	0	9	0	0
15	44295044	.	G	A	5	2	7	0	0	7	0	0
15	44295262	.	A	G	2	0	2	0	5	7	0	0
15	44318502	.	T	C	1	4	5	3	0	8	0	0
15	44323349	.	T	C	3	6	9	0	0	9	0	0
15	44323436	.	G	A	2	3	5	0	4	9	0	0
15	44323442	.	G	A	4	6	10	0	0	10	0	0
15	44336923	.	A	T	2	9	11	0	0	11	0	0
15	44340093	.	C	T	3	2	5	0	0	5	0	0
15	44344283	.	G	A	1	6	7	0	2	9	0	0
15	44370890	.	C	A	7	8	15	0	1	16	0	0
15	44371058	.	T	C	16	19	35	0	0	35	0	0
15	44371076	.	C	T	18	15	33	0	0	33	0	0
15	44371129	.	C	T	10	13	23	0	2	25	0	0
15	44371289	.	C	T	13	14	27	0	0	27	0	0
15	44371484	.	T	C	7	11	18	0	0	18	0	0
15	44385117	.	T	C	10	9	19	0	1	20	0	0
15	44440352	.	G	A	4	3	7	0	0	7	0	0
15	44445243	.	C	T	1	2	3	0	1	4	0	0
15	44465352	.	G	A	2	3	5	0	0	5	0	0
15	44472745	.	A	G	2	3	5	0	0	5	0	0
15	44472757	.	A	G	1	4	5	0	1	6	0	0
15	44472901	.	C	T	2	1	3	0	1	4	0	0
15	44475254	.	A	G	4	3	7	0	0	7	0	0
15	44499653	.	T	A	16	16	32	0	1	34	1	0
15	44530288	.	T	C	10	0	10	0	12	22	0	0
15	44534976	.	G	A	7	7	14	0	2	16	0	0
15	44559576	.	C	G	7	14	21	1	1	23	0	0
15	44559636	.	T	C	6	0	6	0	13	19	0	0
15	44559646	.	T	A	7	6	13	0	0	13	0	0
15	44560414	.	T	G	13	14	27	1	1	29	0	0
15	44565727	.	T	A	13	19	32	0	1	33	0	0
15	44646664	.	G	A	12	6	18	0	0	18	0	0
15	44646676	.	T	C	10	6	16	0	2	18	0	0
15	44647485	.	A	G	8	4	12	0	0	12	0	0
15	44660651	.	C	T	6	6	12	0	0	12	0	0
15	44663021	.	G	A	4	6	10	0	1	11	0	0
15	44676962	.	T	C	6	0	6	0	5	11	0	0
15	44676968	.	G	A	5	7	12	0	0	12	0	0
15	44677292	.	G	T	6	8	14	0	0	14	0	0
15	44677302	.	T	C	3	12	15	0	0	15	0	0
15	44714650	.	A	G	13	6	19	0	4	23	0	0
15	44717704	.	A	G	6	5	11	0	0	11	0	0
15	44721553	.	G	A	3	3	6	0	0	6	0	0
15	44721559	.	G	A	4	3	7	0	0	7	0	0
15	44755886	.	C	T	0	5	5	0	9	14	0	0
15	45088596	.	C	T	0	5	5	0	4	9	0	0
15	45103853	.	C	A	5	3	8	0	0	8	0	0
15	45110056	.	G	A	1	2	3	0	0	4	1	0
15	45118674	.	A	C	1	0	1	0	3	4	0	0
15	45122487	.	T	G	2	3	5	0	0	5	0	0
15	45123267	.	T	C	2	0	2	0	5	7	0	0
15	45123321	.	C	T	0	5	5	0	3	8	0	0
15	45129375	.	C	T	0	5	5	0	7	12	0	0
15	45129761	.	T	C	3	4	7	0	2	9	0	0
15	45135377	.	G	A	1	2	3	0	0	3	0	0
15	45136517	.	A	G	5	3	8	0	0	8	0	0
15	45136538	.	T	C	4	2	6	0	0	6	0	0
15	45136556	.	T	C	3	2	5	0	1	6	0	0
15	45149048	.	T	C	1	0	1	0	3	4	0	0
15	45156496	.	T	G	2	2	4	0	0	4	0	0
15	45162049	.	T	C	4	2	6	0	1	7	0	0
15	45169116	.	T	A	1	2	3	0	0	3	0	0
15	45200818	.	T	A	2	4	6	0	0	6	0	0
15	45200831	.	A	T	2	2	4	0	0	4	0	0
15	45226881	.	G	A	1	3	4	0	0	4	0	0
15	45239288	.	C	A	2	3	5	0	0	5	0	0
15	45239312	.	T	C	1	3	4	0	0	4	0	0
15	45418610	.	G	A	27	21	48	0	1	49	0	0
15	45510169	.	T	A	16	22	38	0	3	41	0	0
15	45527282	.	C	T	7	4	11	0	0	11	0	0
15	45527565	.	G	T	4	2	6	0	0	6	0	0
15	45527830	.	C	T	0	3	3	0	6	9	0	0
15	45528227	.	T	C	5	2	7	0	0	7	0	0
15	45528385	.	C	A	0	3	3	0	7	10	0	0
15	45544630	.	T	C	9	8	17	1	0	18	0	0
15	45544687	.	C	T	8	5	13	1	0	14	0	0
15	45544759	.	C	A	7	6	13	0	0	13	0	0
15	45552439	.	G	C	2	3	5	0	0	5	0	0
15	45555001	.	G	A	0	9	9	0	2	11	0	0
15	45555208	.	A	T	9	8	17	0	0	17	0	0
15	45591739	.	G	C	17	12	29	0	0	29	0	0
15	45591753	.	C	G	19	12	31	0	2	33	0	0
15	45595456	.	A	T	9	11	20	0	1	21	0	0
15	45602730	.	T	C	13	11	24	0	3	27	0	0
15	45602878	.	G	A	17	7	24	0	0	24	0	0
15	45612497	.	G	A	0	16	16	0	10	26	0	0
15	45621750	.	C	T	4	7	11	0	2	13	0	0
15	45628074	.	G	A	13	6	19	0	2	21	0	0
15	45634793	.	G	A	24	13	37	0	4	41	0	0
15	45634864	.	T	G	8	15	23	0	2	25	0	0
15	45634865	.	C	T	10	14	24	0	1	25	0	0
15	45634995	.	T	C	7	5	12	1	3	16	0	0
15	45635375	.	A	G	8	7	15	0	0	15	0	0
15	45635848	.	C	T	14	11	25	0	1	26	0	0
15	45635952	.	T	C	8	4	12	0	0	12	0	0
15	45635999	.	G	A	12	9	21	0	2	23	0	0
15	45636160	.	C	A	1	3	4	0	0	4	0	0
15	45637224	.	A	G	13	9	22	0	0	22	0	0
15	45994139	.	G	T	4	10	14	0	0	14	0	0
15	45994177	.	C	T	4	15	19	0	1	20	0	0
15	46034372	.	T	C	7	7	14	0	1	15	0	0
15	46108618	.	G	A	2	13	15	0	10	25	0	0
15	46108696	.	T	C	11	14	25	0	1	26	0	0
15	46108922	.	A	G	11	0	11	0	7	18	0	0
15	46111047	.	T	A	10	6	16	0	0	16	0	0
15	46111152	.	A	G	10	0	10	0	9	19	0	0
15	46111254	.	A	G	15	10	25	0	0	25	0	0
15	46111410	.	A	G	6	7	13	0	0	13	0	0
15	46116133	.	G	A	14	10	24	0	1	25	0	0
15	46116136	.	T	G	13	0	13	0	10	23	0	0
15	46116352	.	A	G	6	10	16	0	3	19	0	0
15	46598423	.	C	T	3	3	6	0	0	6	0	0
15	46643768	.	T	C	11	15	26	0	1	27	0	0
15	46649525	.	A	G	18	17	35	0	4	39	0	0
15	46652124	.	A	G	8	11	19	0	1	20	0	0
15	46662143	.	C	T	13	11	24	2	3	29	0	0
15	46662353	.	T	C	17	12	29	0	3	32	0	0
15	46666181	.	T	C	11	0	11	0	17	28	0	0
15	46668250	.	T	A	11	17	28	0	1	29	0	0
15	46687210	.	G	A	7	4	11	0	0	11	0	0
15	46687234	.	T	C	8	0	8	0	5	13	0	0
15	46687290	.	A	C	3	6	9	0	0	9	0	0
15	46687341	.	T	G	3	10	13	0	0	13	0	0
15	46687586	.	A	G	4	9	13	0	2	15	0	0
15	46691237	.	A	G	4	3	7	0	0	7	0	0
15	46694399	.	A	C	4	6	10	0	2	12	0	0
15	46699268	.	G	A	8	4	12	0	0	12	0	0
15	46704595	.	T	C	4	9	13	0	0	13	0	0
15	46704623	.	G	A	1	3	4	0	0	4	0	0
15	46718528	.	T	G	2	6	8	0	0	8	0	0
15	46726371	.	T	C	2	4	6	0	1	7	0	0
15	46727382	.	G	A	5	7	12	0	0	12	0	0
15	46727571	.	G	A	5	6	11	0	0	11	0	0
15	47022702	.	T	C	1	2	3	0	0	3	0	0
15	47031476	.	T	C	2	2	4	0	0	4	0	0
15	47063594	.	C	T	1	3	4	0	1	5	0	0
15	47083980	.	G	A	0	3	3	0	6	9	0	0
15	47100599	.	C	T	1	12	13	0	12	25	0	0
15	47107256	.	A	G	9	12	21	0	1	22	0	0
15	47113654	.	T	G	11	11	22	0	2	24	0	0
15	47336295	.	G	A	11	16	27	0	0	27	0	0
15	47338768	.	C	A	1	2	3	0	0	3	0	0
15	47386982	.	T	A	19	17	36	0	1	37	0	0
15	47410231	.	C	A	12	10	22	0	1	23	0	0
15	47418607	.	G	A	0	15	15	0	12	27	0	0
15	47418627	.	G	A	14	15	29	0	0	29	0	0
15	47419090	.	G	A	3	11	14	0	29	43	0	0
15	47419096	.	C	T	30	14	44	0	2	46	0	0
15	47419240	.	C	T	25	20	45	0	2	47	0	0
15	47419394	.	C	T	28	15	43	0	2	45	0	0
15	47419395	.	A	T	27	15	42	0	2	44	0	0
15	47420838	.	T	A	25	26	51	0	0	51	0	0
15	47420920	.	G	C	2	27	29	0	1	30	0	0
15	47421203	.	T	C	17	7	24	0	0	24	0	0
15	47421329	.	A	G	9	10	19	0	1	20	0	0
15	47421669	.	C	T	17	9	26	0	4	30	0	0
15	47421675	.	G	C	10	17	27	0	1	28	0	0
15	47446426	.	G	A	0	3	3	0	2	5	0	0
15	47446429	.	C	T	1	3	4	0	1	5	0	0
15	47446553	.	A	C	2	2	4	0	0	4	0	0
15	47448596	.	G	C	1	3	4	0	0	4	0	0
15	47452895	.	C	A	1	2	3	0	0	3	0	0
15	47453236	.	C	T	1	4	5	0	0	5	0	0
15	47453251	.	A	T	1	5	6	0	0	6	0	0
15	47453288	.	C	G	1	3	4	0	0	4	0	0
15	47453734	.	T	G	3	2	5	0	0	5	0	0
15	47455030	.	A	G	1	2	3	0	0	3	0	0
15	47830783	.	C	T	3	2	5	0	0	5	0	0
15	47831096	.	C	T	10	9	19	0	0	20	1	0
15	47831195	.	G	C	10	7	17	0	0	17	0	0
15	47831249	.	C	T	6	7	13	0	1	14	0	0
15	47831265	.	T	A	3	7	10	0	1	11	0	0
15	47831495	.	C	G	11	10	21	0	0	21	0	0
15	47831511	.	C	T	3	10	13	0	10	23	0	0
15	47831565	.	C	A	16	8	24	0	1	25	0	0
15	47831731	.	T	G	5	5	10	0	0	10	0	0
15	47831765	.	G	A	1	4	5	0	0	5	0	0
15	47832424	.	T	G	3	3	6	0	1	7	0	0
15	47832930	.	C	T	14	6	20	1	2	23	0	0
15	47832931	.	C	T	2	6	8	1	15	24	0	0
15	47833083	.	G	A	5	8	13	0	0	13	0	0
15	47833392	.	G	A	13	7	20	0	0	20	0	0
15	47833395	.	C	T	0	7	7	0	12	19	0	0
15	47833436	.	C	T	1	6	7	0	11	18	0	0
15	47833493	.	C	T	2	2	4	0	6	10	0	0
15	47833662	.	C	T	8	8	16	0	0	16	0	0
15	47833814	.	C	T	3	7	10	0	0	10	0	0
15	47834202	.	T	C	4	1	5	0	16	21	0	0
15	47834327	.	C	G	11	4	15	0	2	17	0	0
15	47834487	.	C	T	0	7	7	0	4	11	0	0
15	47834559	.	G	A	4	7	11	0	1	12	0	0
15	47839080	.	G	A	4	6	10	0	0	10	0	0
15	47845908	.	A	G	14	20	34	0	2	36	0	0
15	47847373	.	G	A	21	21	42	0	0	42	0	0
15	47848495	.	C	T	18	22	40	0	6	46	0	0
15	47851205	.	T	A	29	33	62	0	1	63	0	0
15	47851340	.	C	G	36	17	53	1	1	67	12	0
15	47851342	.	C	G	47	18	65	1	1	68	1	0
15	47851455	.	T	G	37	27	64	0	1	65	0	0
15	47851486	.	G	A	32	32	64	0	0	64	0	0
15	47851522	.	C	T	1	30	31	0	28	59	0	0
15	47851751	.	A	G	30	26	56	0	1	57	0	0
15	47851828	.	G	A	28	16	44	0	2	46	0	0
15	47851978	.	C	T	11	4	15	0	3	18	0	0
15	47851979	.	A	G	11	5	16	0	2	18	0	0
15	47852049	.	G	T	20	5	25	0	3	28	0	0
15	47855085	.	A	G	37	15	52	2	5	59	0	0
15	47856418	.	T	C	56	24	80	1	3	84	0	0
15	47860443	.	C	T	1	19	20	0	20	40	0	0
16	815859	.	C	T	12	11	23	0	0	23	0	0
16	815967	.	G	A	6	14	20	0	1	21	0	0
16	816096	.	A	G	11	6	17	0	2	19	0	0
16	1199273	.	C	T	7	5	12	0	0	12	0	0
16	1199324	.	C	T	3	4	7	0	0	7	0	0
16	1199699	.	C	T	3	8	11	0	0	11	0	0
16	1199740	.	A	G	4	5	9	0	0	9	0	0
16	1199741	.	C	T	4	4	8	0	1	9	0	0
16	1204061	.	G	A	1	8	9	0	3	12	0	0
16	1205135	.	G	A	5	4	9	0	0	9	0	0
16	1207149	.	T	A	3	11	14	0	1	15	0	0
16	1207227	.	G	A	12	10	22	0	0	22	0	0
16	1207948	.	C	G	5	11	16	0	0	16	0	0
16	1209528	.	C	T	8	9	17	0	0	17	0	0
16	1209597	.	A	C	3	3	6	0	0	6	0	0
16	1209985	.	T	G	6	5	11	0	0	11	0	0
16	1210280	.	G	A	6	6	12	0	0	12	0	0
16	1210403	.	C	T	11	9	20	0	2	22	0	0
16	1210880	.	A	C	0	0	0	0	16	16	0	0
16	1210884	.	A	C	1	2	3	0	10	13	0	0
16	1228093	.	A	C	7	9	16	0	2	18	0	0
16	1230470	.	C	T	5	7	12	0	0	12	0	0
16	1234138	.	A	T	10	6	16	0	0	16	0	0
16	1239500	.	T	C	16	14	30	0	4	34	0	0
16	1269560	.	T	C	1	2	3	0	0	3	0	0
16	1334452	.	C	T	9	8	17	0	1	18	0	0
16	1354513	.	A	G	15	12	27	0	3	30	0	0
16	1355316	.	A	T	24	16	40	0	1	41	0	0
16	1355720	.	T	C	16	19	35	0	1	36	0	0
16	1359119	.	T	C	12	18	30	0	0	30	0	0
16	1362345	.	C	T	1	2	3	0	0	3	0	0
16	1397952	.	A	T	2	3	5	0	0	6	1	0
16	1398447	.	G	A	4	3	7	0	0	7	0	0
16	1398492	.	G	T	4	2	6	0	0	6	0	0
16	1398530	.	A	G	6	5	11	0	0	11	0	0
16	1466033	.	C	T	1	3	4	0	0	4	0	0
16	1466528	.	C	G	0	3	3	0	1	4	0	0
16	1466983	.	G	A	2	2	4	1	0	5	0	0
16	1467075	.	G	A	1	2	3	0	1	4	0	0
16	1523892	.	A	G	3	5	8	0	0	8	0	0
16	1523911	.	G	C	5	0	5	0	7	12	0	0
16	1549920	.	A	G	3	7	10	0	0	10	0	0
16	1551146	.	T	G	10	11	21	0	0	21	0	0
16	1569758	.	A	G	3	7	10	0	2	12	0	0
16	1572508	.	C	T	6	3	9	0	0	9	0	0
16	1573203	.	G	A	4	5	9	0	0	9	0	0
16	1573215	.	C	T	5	3	8	1	0	9	0	0
16	1573259	.	T	G	4	2	6	1	1	8	0	0
16	1577676	.	G	A	3	2	5	0	1	6	0	0
16	1580006	.	G	C	2	0	2	0	5	7	0	0
16	1884215	.	C	T	12	7	19	0	0	19	0	0
16	1884218	.	C	T	12	7	19	0	0	19	0	0
16	1906682	.	C	A	11	12	23	0	0	23	0	0
16	1996533	.	A	G	7	3	10	0	0	10	0	0
16	1996569	.	A	C	7	8	15	0	0	15	0	0
16	1996577	.	C	T	7	9	16	0	1	17	0	0
16	2009844	.	T	G	4	11	15	0	0	15	0	0
16	2043021	.	C	T	13	7	20	0	1	21	0	0
16	2043122	.	G	C	2	10	12	0	11	23	0	0
16	2071535	.	G	A	0	11	11	0	11	22	0	0
16	2102037	.	T	C	8	7	15	0	2	17	0	0
16	2102349	.	C	T	6	3	9	0	1	10	0	0
16	2102468	.	A	T	4	6	10	0	1	11	0	0
16	2102495	.	A	G	1	0	1	1	2	4	0	0
16	2102683	.	C	T	4	3	7	0	0	7	0	0
16	2103052	.	C	T	16	4	20	0	0	20	0	0
16	2103058	.	G	T	15	3	18	0	1	19	0	0
16	2103088	.	G	A	1	4	5	0	19	24	0	0
16	2103167	.	C	T	11	4	15	0	0	15	0	0
16	2103209	.	C	T	8	8	16	0	1	17	0	0
16	2103241	.	T	A	8	8	16	0	0	16	0	0
16	2103268	.	A	T	4	9	13	0	2	15	0	0
16	2103307	.	T	C	13	14	27	0	0	27	0	0
16	2103714	.	A	T	2	4	6	0	0	6	0	0
16	2103783	.	A	T	1	6	7	0	0	7	0	0
16	2104181	.	T	A	1	2	3	0	0	3	0	0
16	2104312	.	A	C	11	15	26	0	1	27	0	0
16	2104400	.	T	C	10	6	16	0	0	16	0	0
16	2104597	.	T	C	23	20	43	1	3	47	0	0
16	2104604	.	A	G	22	1	23	1	21	45	0	0
16	2105035	.	A	G	1	6	7	0	0	7	0	0
16	2353020	.	C	A	8	6	14	0	0	14	0	0
16	2353023	.	T	C	7	6	13	0	0	13	0	0
16	2353191	.	C	A	8	3	11	0	0	11	0	0
16	2360324	.	C	T	4	2	6	0	0	6	0	0
16	2365716	.	G	A	5	6	11	0	0	11	0	0
16	2368422	.	T	C	7	0	7	2	6	15	0	0
16	2380596	.	T	G	4	3	7	0	0	7	0	0
16	2380735	.	G	A	3	4	7	0	1	8	0	0
16	2382011	.	G	T	6	8	14	0	0	14	0	0
16	2388237	.	A	C	2	0	2	0	3	5	0	0
16	2388306	.	T	A	3	5	8	0	1	9	0	0
16	2388309	.	A	T	3	5	8	0	0	8	0	0
16	2472263	.	G	A	15	7	22	0	0	22	0	0
16	2472284	.	T	C	12	5	17	0	3	20	0	0
16	2484064	.	C	T	2	11	13	0	19	32	0	0
16	2485904	.	G	A	7	16	23	0	1	24	0	0
16	2494323	.	T	C	14	0	14	0	18	32	0	0
16	2495649	.	G	C	9	12	21	0	1	22	0	0
16	2517184	.	G	T	14	6	20	0	0	20	0	0
16	2519071	.	T	C	16	5	21	0	1	22	0	0
16	2525891	.	A	G	10	6	16	0	1	17	0	0
16	2526035	.	C	T	8	3	11	0	1	12	0	0
16	2528209	.	A	G	11	4	15	0	0	15	0	0
16	2539405	.	G	A	6	7	13	0	2	15	0	0
16	2542782	.	G	C	9	8	17	0	1	19	1	0
16	2557990	.	A	G	7	4	11	0	0	11	0	0
16	2558252	.	G	C	9	8	17	0	0	17	0	0
16	2567316	.	A	G	16	0	16	1	8	25	0	0
16	2568847	.	G	A	1	13	14	0	8	22	0	0
16	2574963	.	C	T	8	5	13	0	0	13	0	0
16	2577717	.	T	A	12	6	18	0	1	19	0	0
16	2580255	.	T	A	14	6	20	0	1	21	0	0
16	2637673	.	T	C	3	1	4	0	3	7	0	0
16	2637703	.	C	A	2	3	5	0	0	5	0	0
16	2647072	.	C	T	2	2	4	0	0	4	0	0
16	2807453	.	A	T	2	2	4	0	0	4	0	0
16	2820437	.	T	C	4	4	8	0	0	8	0	0
16	2822493	.	T	C	2	2	4	0	0	4	0	0
16	2822496	.	G	T	2	2	4	0	0	4	0	0
16	2824645	.	G	C	4	2	6	0	0	6	0	0
16	2825870	.	A	G	4	4	8	0	1	9	0	0
16	2827474	.	C	T	4	4	8	0	2	10	0	0
16	2827483	.	G	A	5	3	8	0	0	8	0	0
16	2829139	.	T	C	4	3	7	0	0	7	0	0
16	2844077	.	T	A	1	2	3	0	0	3	0	0
16	2844103	.	G	A	2	2	4	0	0	4	0	0
16	2912551	.	A	G	3	2	5	0	0	5	0	0
16	2964078	.	T	C	3	4	7	0	1	8	0	0
16	2987434	.	T	A	4	2	6	0	0	6	0	0
16	3068156	.	A	G	3	5	8	0	1	9	0	0
16	3075265	.	G	A	0	2	2	0	2	4	0	0
16	3076191	.	T	G	2	0	2	0	2	4	0	0
16	3089158	.	C	T	3	5	8	0	2	10	0	0
16	3091150	.	C	T	1	7	8	0	0	8	0	0
16	3091178	.	C	T	1	7	8	0	0	8	0	0
16	3091195	.	A	G	1	6	7	0	0	7	0	0
16	3091279	.	A	C	5	6	11	0	1	12	0	0
16	3091288	.	G	A	6	5	11	0	0	11	0	0
16	3095897	.	T	C	1	3	4	0	0	4	0	0
16	3096160	.	C	G	2	4	6	0	0	6	0	0
16	3096166	.	T	C	2	5	7	0	0	7	0	0
16	3096319	.	T	C	5	3	8	0	0	8	0	0
16	3096384	.	C	T	4	5	9	0	0	9	0	0
16	3096420	.	T	C	6	6	12	0	0	12	0	0
16	3096446	.	A	T	4	8	12	0	1	13	0	0
16	3096516	.	G	A	3	6	9	0	0	9	0	0
16	3463895	.	A	G	11	16	27	0	0	27	0	0
16	3470212	.	G	A	10	11	21	0	0	21	0	0
16	3470332	.	A	G	10	6	16	0	0	16	0	0
16	3499306	.	G	A	6	9	15	0	0	15	0	0
16	3499423	.	A	C	10	0	10	0	10	20	0	0
16	3523597	.	T	A	3	6	9	0	0	9	0	0
16	3531599	.	A	G	7	10	17	0	0	17	0	0
16	3548551	.	T	C	4	0	4	0	10	14	0	0
16	3579786	.	T	G	3	6	9	0	0	9	0	0
16	4067809	.	G	T	1	4	5	0	0	5	0	0
16	4070156	.	G	A	0	7	7	0	5	12	0	0
16	4071460	.	T	C	2	3	5	0	0	5	0	0
16	4100650	.	C	G	2	3	5	0	0	5	0	0
16	4105539	.	C	A	6	3	9	0	0	9	0	0
16	4110155	.	C	A	6	4	10	0	0	10	0	0
16	4115198	.	C	T	3	7	10	0	0	10	0	0
16	4115237	.	A	G	5	3	8	0	0	8	0	0
16	4117682	.	G	C	6	5	11	0	0	11	0	0
16	4117843	.	A	G	6	3	9	0	0	9	0	0
16	4118991	.	G	A	5	9	14	0	0	14	0	0
16	4119048	.	C	T	2	4	6	0	1	7	0	0
16	4126464	.	C	T	7	4	11	0	1	12	0	0
16	4126903	.	C	A	8	5	13	0	0	13	0	0
16	4126927	.	C	T	7	7	14	0	0	14	0	0
16	4128322	.	C	T	5	4	9	0	0	9	0	0
16	4129136	.	T	A	8	4	12	0	0	12	0	0
16	4131062	.	T	C	5	4	9	0	1	10	0	0
16	4138416	.	G	A	6	5	11	0	1	12	0	0
16	4138638	.	G	A	6	6	12	0	0	12	0	0
16	4138776	.	C	T	2	4	6	0	0	6	0	0
16	4138824	.	G	A	3	2	5	0	0	5	0	0
16	4158384	.	A	G	1	1	2	0	4	6	0	0
16	4160307	.	G	A	3	7	10	0	0	10	0	0
16	4163503	.	C	T	8	6	14	0	1	15	0	0
16	4163671	.	A	G	2	0	2	0	5	7	0	0
16	4168036	.	T	A	6	6	12	2	2	16	0	0
16	4168086	.	C	T	6	2	8	2	0	10	0	0
16	4168139	.	A	G	8	3	11	0	0	11	0	0
16	4168488	.	A	C	2	3	5	0	0	5	0	0
16	4168816	.	C	A	1	2	3	0	0	3	0	0
16	4185449	.	G	A	0	2	2	0	3	5	0	0
16	4190052	.	A	T	3	2	5	0	0	5	0	0
16	4190091	.	T	A	3	2	5	0	0	5	0	0
16	4190094	.	C	A	3	2	5	0	0	5	0	0
16	4190599	.	G	A	5	3	8	0	0	8	0	0
16	4197130	.	T	A	5	11	16	0	1	17	0	0
16	4200749	.	G	T	9	15	24	1	0	25	0	0
16	4201948	.	C	G	13	6	19	0	0	19	0	0
16	4202038	.	C	T	16	7	23	0	0	23	0	0
16	4202128	.	A	G	11	15	26	0	0	26	0	0
16	4202946	.	A	G	11	8	19	0	1	20	0	0
16	4287757	.	C	G	4	7	11	0	0	11	0	0
16	4287783	.	C	T	2	5	7	0	0	7	0	0
16	4287936	.	C	T	0	3	3	0	5	8	0	0
16	4287961	.	G	A	2	6	8	0	0	8	0	0
16	4288656	.	T	A	4	5	9	0	0	9	0	0
16	4317343	.	A	T	4	3	7	0	0	7	0	0
16	4317365	.	G	A	3	4	7	0	0	7	0	0
16	4513775	.	A	G	6	5	11	0	0	11	0	0
16	4513876	.	A	T	4	7	11	0	0	11	0	0
16	4513901	.	T	C	9	8	17	0	0	17	0	0
16	4513920	.	C	G	10	10	20	0	0	20	0	0
16	4514114	.	T	C	6	0	6	0	6	12	0	0
16	4514467	.	A	T	5	8	13	0	0	13	0	0
16	4514592	.	A	C	9	4	13	0	0	13	0	0
16	4514594	.	T	A	7	4	11	0	0	11	0	0
16	4514633	.	T	C	9	5	14	0	0	14	0	0
16	4514666	.	T	C	6	0	6	0	5	11	0	0
16	4514784	.	T	C	9	4	13	0	0	13	0	0
16	4514795	.	T	C	3	8	11	0	0	12	1	0
16	4514915	.	T	C	2	0	2	0	3	5	0	0
16	4515614	.	G	T	2	3	5	0	0	5	0	0
16	4515770	.	G	C	1	2	3	0	0	3	0	0
16	4516529	.	T	C	1	2	3	0	0	3	0	0
16	4517456	.	C	T	6	5	11	0	2	13	0	0
16	4517477	.	G	A	7	7	14	0	0	14	0	0
16	4517606	.	A	G	15	7	22	0	1	23	0	0
16	4517704	.	C	T	7	7	14	0	2	16	0	0
16	4531629	.	G	A	3	1	4	0	1	5	0	0
16	4531827	.	A	G	7	6	13	0	1	14	0	0
16	4533768	.	T	C	10	6	16	0	3	19	0	0
16	4538422	.	A	G	6	10	16	0	0	16	0	0
16	4540805	.	G	T	7	11	18	0	1	19	0	0
16	4540864	.	G	C	6	7	13	0	3	16	0	0
16	4541022	.	A	C	7	11	18	0	0	18	0	0
16	4541061	.	T	G	4	5	9	0	2	11	0	0
16	4541085	.	T	C	1	7	8	2	1	11	0	0
16	4541146	.	G	A	7	4	11	2	0	13	0	0
16	4541167	.	A	C	8	2	10	1	1	12	0	0
16	4541233	.	T	C	12	4	16	0	0	16	0	0
16	4541250	.	C	T	10	6	16	0	1	17	0	0
16	4541281	.	A	T	6	4	10	0	0	10	0	0
16	4542211	.	A	G	3	2	5	0	0	5	0	0
16	4542252	.	A	G	2	2	4	0	1	5	0	0
16	4542518	.	C	T	1	18	19	0	12	31	0	0
16	4545454	.	T	C	9	12	21	0	0	21	0	0
16	4546606	.	A	C	8	0	8	0	11	19	0	0
16	4546651	.	G	A	6	12	18	0	1	19	0	0
16	4573450	.	G	T	8	9	17	0	0	17	0	0
16	4573458	.	C	T	8	7	15	0	2	17	0	0
16	4573556	.	A	T	3	8	11	0	2	13	0	0
16	4573588	.	A	G	5	10	15	0	0	15	0	0
16	4575940	.	G	A	5	12	17	0	0	17	0	0
16	4583847	.	A	T	6	5	11	0	0	11	0	0
16	4583864	.	A	G	9	6	15	0	0	15	0	0
16	4587184	.	C	T	6	7	13	1	0	14	0	0
16	4587187	.	G	A	6	7	13	1	1	15	0	0
16	4591911	.	T	C	3	0	3	0	2	5	0	0
16	4615993	.	C	A	4	6	10	0	1	11	0	0
16	4616071	.	A	T	7	8	15	1	0	17	1	0
16	4619598	.	A	T	7	10	17	0	1	18	0	0
16	4619614	.	A	G	5	10	15	0	0	15	0	0
16	4628953	.	T	C	6	7	13	0	0	13	0	0
16	4630127	.	G	T	9	4	13	0	0	13	0	0
16	4630143	.	C	T	7	5	12	0	0	12	0	0
16	4695108	.	A	C	1	3	4	0	0	4	0	0
16	4695172	.	G	C	0	8	8	0	12	20	0	0
16	4695323	.	A	C	6	3	9	0	0	9	0	0
16	4695368	.	T	A	4	4	8	0	1	9	0	0
16	4695530	.	A	G	7	5	12	0	0	12	0	0
16	4697566	.	C	G	1	3	4	0	0	4	0	0
16	4697599	.	A	G	4	0	4	0	6	10	0	0
16	4697713	.	A	G	5	0	5	0	4	9	0	0
16	4697821	.	G	A	6	4	10	0	0	10	0	0
16	4697829	.	C	G	6	4	10	0	0	10	0	0
16	4700766	.	T	C	13	7	20	0	0	20	0	0
16	4707381	.	A	T	1	7	8	0	0	8	0	0
16	4707544	.	G	A	2	3	5	0	0	5	0	0
16	4715613	.	T	A	1	2	3	0	0	3	0	0
16	4746675	.	A	C	1	4	5	0	0	5	0	0
16	4755816	.	A	T	3	7	10	0	0	10	0	0
16	4759113	.	G	A	5	6	11	0	1	12	0	0
16	4761133	.	T	C	8	0	8	0	5	13	0	0
16	4769909	.	A	C	3	0	3	0	3	6	0	0
16	4770454	.	A	C	2	3	5	0	0	5	0	0
16	4772790	.	G	A	1	2	3	0	1	4	0	0
16	4782335	.	C	T	3	3	6	0	0	6	0	0
16	4784020	.	T	C	1	2	3	0	0	3	0	0
16	4834602	.	C	T	2	2	4	0	0	4	0	0
16	4834606	.	A	G	2	2	4	0	0	4	0	0
16	4842203	.	T	A	11	10	21	0	0	21	0	0
16	4842308	.	A	G	6	12	18	0	0	18	0	0
16	4858779	.	G	T	1	6	7	0	9	16	0	0
16	4860516	.	A	G	10	7	17	0	2	19	0	0
16	4867445	.	C	T	13	9	22	0	0	22	0	0
16	4867487	.	C	T	17	12	29	0	0	29	0	0
16	4869973	.	G	A	8	7	15	0	0	15	0	0
16	4870180	.	C	T	10	12	22	0	1	23	0	0
16	4872260	.	C	T	14	8	22	0	0	22	0	0
16	4872281	.	G	A	11	11	22	0	0	22	0	0
16	4872320	.	G	A	9	9	18	0	1	19	0	0
16	4872453	.	C	T	7	7	14	0	0	14	0	0
16	4876470	.	C	T	7	5	12	0	0	12	0	0
16	4879768	.	T	C	9	13	22	0	0	22	0	0
16	4882206	.	C	T	13	8	21	0	1	22	0	0
16	4882491	.	C	T	12	7	19	0	0	19	0	0
16	4882492	.	G	A	1	7	8	0	11	19	0	0
16	4885458	.	T	A	16	11	27	0	0	27	0	0
16	4895423	.	T	C	11	14	25	0	3	28	0	0
16	5014391	.	A	G	3	3	6	0	1	7	0	0
16	5014564	.	A	G	7	10	17	0	0	17	0	0
16	5025494	.	G	A	12	12	24	0	1	25	0	0
16	5105221	.	G	A	21	19	40	0	2	42	0	0
16	5145459	.	T	C	8	14	22	0	1	23	0	0
16	5145599	.	C	A	24	12	36	0	3	39	0	0
16	5145622	.	G	A	21	13	34	0	3	37	0	0
16	5149298	.	T	C	21	17	38	0	0	38	0	0
16	5153956	.	T	C	22	22	44	0	2	46	0	0
16	5156563	.	G	A	1	12	13	0	13	26	0	0
16	5159283	.	A	G	13	10	23	0	0	23	0	0
16	5159289	.	C	T	12	10	22	0	1	23	0	0
16	5159328	.	T	C	16	10	26	0	1	27	0	0
16	5163275	.	T	C	12	5	17	0	1	18	0	0
16	5164569	.	C	T	9	5	14	0	1	15	0	0
16	5166015	.	G	A	1	14	15	0	15	30	0	0
16	5166030	.	C	T	15	13	28	0	0	28	0	0
16	5166288	.	G	A	18	11	29	0	1	30	0	0
16	5166332	.	T	A	23	12	35	0	0	35	0	0
16	5166351	.	T	C	24	13	37	0	2	39	0	0
16	5166546	.	G	A	17	10	27	1	0	28	0	0
16	5166645	.	A	C	17	10	27	1	0	28	0	0
16	5166719	.	A	G	7	9	16	0	0	16	0	0
16	5166805	.	A	G	16	0	16	0	10	26	0	0
16	5166889	.	G	T	11	16	27	0	1	28	0	0
16	5166977	.	G	T	14	14	28	0	0	28	0	0
16	5167030	.	G	A	10	8	18	0	1	19	0	0
16	5167249	.	A	C	11	14	25	0	2	27	0	0
16	5167257	.	A	G	13	10	23	0	4	27	0	0
16	5187795	.	G	A	6	11	17	0	0	17	0	0
16	5188029	.	A	C	10	12	22	0	4	26	0	0
16	5190168	.	C	T	7	6	13	1	0	14	0	0
16	5190210	.	C	T	8	6	14	0	0	14	0	0
16	5190590	.	A	G	6	8	14	0	0	14	0	0
16	5193353	.	C	T	4	7	11	0	3	14	0	0
16	5193539	.	G	A	10	9	19	0	1	20	0	0
16	5193605	.	T	G	13	8	21	0	2	23	0	0
16	5193644	.	G	A	15	6	21	0	0	21	0	0
16	5196228	.	G	A	1	2	3	16	0	19	0	0
16	5196377	.	C	T	7	7	14	0	0	14	0	0
16	5196630	.	C	T	9	12	21	0	0	21	0	0
16	5199264	.	A	G	6	3	9	0	0	9	0	0
16	5199381	.	C	T	5	11	16	0	1	17	0	0
16	5199399	.	C	T	2	12	14	0	1	15	0	0
16	5199476	.	C	T	9	11	20	0	0	20	0	0
16	5199503	.	C	T	15	10	25	0	0	25	0	0
16	5205146	.	G	A	2	11	13	0	9	23	1	0
16	5216548	.	G	A	11	16	27	0	0	27	0	0
16	5216707	.	G	C	8	10	18	0	0	18	0	0
16	5221680	.	A	C	6	6	12	0	2	14	0	0
16	5221888	.	T	C	6	10	16	0	0	16	0	0
16	5223355	.	G	A	16	5	21	0	2	23	0	0
16	5223375	.	A	G	14	5	19	0	2	21	0	0
16	5223454	.	C	T	6	12	18	0	0	18	0	0
16	5223470	.	G	A	5	10	15	0	0	15	0	0
16	5223740	.	C	T	11	4	15	0	0	15	0	0
16	5224328	.	A	G	18	11	29	0	1	30	0	0
16	5230627	.	G	A	2	9	11	0	10	22	1	0
16	5230782	.	A	T	10	10	20	0	0	20	0	0
16	5462155	.	G	C	1	3	4	0	0	4	0	0
16	5462174	.	A	C	1	2	3	0	0	3	0	0
16	5463942	.	A	G	1	2	3	0	0	3	0	0
16	5475143	.	G	A	2	2	4	0	1	5	0	0
16	5475185	.	C	T	2	5	7	0	0	7	0	0
16	5475197	.	C	T	2	4	6	0	0	6	0	0
16	5478041	.	A	G	1	2	3	0	0	3	0	0
16	5490855	.	G	A	1	2	3	0	0	3	0	0
16	5490860	.	G	T	0	2	2	0	1	3	0	0
16	5491815	.	C	T	4	4	8	0	0	8	0	0
16	5492091	.	G	A	0	2	2	0	2	4	0	0
16	5493285	.	A	G	1	3	4	0	0	4	0	0
16	5541554	.	C	T	1	4	5	0	0	5	0	0
16	5601579	.	T	C	3	2	5	0	0	5	0	0
16	5601611	.	A	G	3	2	5	0	0	5	0	0
16	5601642	.	G	A	0	2	2	0	1	3	0	0
16	5612617	.	A	T	9	7	16	0	0	16	0	0
16	5612631	.	A	T	9	7	16	0	0	16	0	0
16	5620883	.	C	T	7	7	14	0	0	14	0	0
16	5623099	.	T	C	6	5	11	0	0	11	0	0
16	5624209	.	C	T	10	6	16	0	0	16	0	0
16	5624467	.	C	T	9	8	17	0	0	17	0	0
16	5633881	.	C	T	11	6	17	0	1	18	0	0
16	5636292	.	T	G	3	0	3	0	11	14	0	0
16	5636328	.	T	G	5	0	5	0	10	15	0	0
16	5678085	.	A	C	3	2	5	0	0	5	0	0
16	5678244	.	A	G	3	2	5	0	0	5	0	0
16	5693445	.	G	A	6	7	13	0	0	13	0	0
16	5693532	.	T	C	9	7	16	0	1	17	0	0
16	5697114	.	C	T	4	8	12	0	1	13	0	0
16	5700055	.	G	A	0	10	10	0	8	18	0	0
16	5700058	.	T	C	7	8	15	0	1	16	0	0
16	5700402	.	A	G	11	16	27	1	0	28	0	0
16	5700534	.	C	T	12	6	18	0	1	19	0	0
16	5700689	.	G	A	2	9	11	0	11	22	0	0
16	5702891	.	T	G	5	10	15	0	2	17	0	0
16	5702906	.	T	C	8	11	19	0	0	19	0	0
16	5702948	.	C	T	7	10	17	0	0	17	0	0
16	5705811	.	G	T	0	8	8	0	12	20	0	0
16	5708077	.	C	A	12	11	23	0	0	23	0	0
16	5708175	.	C	T	10	9	19	0	2	21	0	0
16	5708181	.	G	A	10	6	16	0	3	19	0	0
16	5710369	.	C	T	9	7	16	0	2	18	0	0
16	5710483	.	G	A	1	10	11	0	4	15	0	0
16	5710582	.	G	T	3	5	8	0	0	8	0	0
16	5710627	.	G	T	6	3	9	0	0	9	0	0
16	5776245	.	T	C	24	13	37	0	3	40	0	0
16	5778882	.	A	G	26	13	39	0	1	40	0	0
16	5778913	.	T	C	19	14	33	0	1	34	0	0
16	5786977	.	G	A	7	8	15	0	0	15	0	0
16	5786989	.	C	T	0	7	7	0	7	14	0	0
16	5787396	.	A	G	2	2	4	0	4	8	0	0
16	5787399	.	T	A	2	5	7	0	1	8	0	0
16	5787436	.	C	A	5	6	11	0	1	12	0	0
16	5787562	.	G	A	4	4	8	0	0	8	0	0
16	5787670	.	A	G	2	10	12	0	0	12	0	0
16	5787911	.	T	G	2	3	5	0	0	5	0	0
16	5788163	.	T	A	6	6	12	0	0	12	0	0
16	5788451	.	G	A	7	5	12	0	0	12	0	0
16	5788534	.	G	C	2	2	4	0	1	5	0	0
16	5788655	.	T	C	1	7	8	0	1	9	0	0
16	5788716	.	C	T	0	9	9	0	6	15	0	0
16	5789124	.	C	A	4	9	13	0	16	29	0	0
16	5789340	.	G	C	12	1	13	0	11	24	0	0
16	5795721	.	C	T	1	6	7	0	13	20	0	0
16	5800670	.	C	T	1	6	7	0	15	22	0	0
16	5806440	.	G	A	5	7	12	0	0	12	0	0
16	5806578	.	G	T	8	7	15	0	0	15	0	0
16	5808868	.	G	T	9	5	14	0	0	14	0	0
16	5808931	.	G	A	6	9	15	0	0	15	0	0
16	5812610	.	C	T	1	7	8	0	3	11	0	0
16	5812624	.	G	T	6	3	9	0	0	9	0	0
16	5812703	.	G	A	4	5	9	0	1	10	0	0
16	5813088	.	T	C	6	5	11	0	0	11	0	0
16	5819970	.	T	A	9	10	19	0	0	19	0	0
16	5820045	.	C	T	6	5	11	0	0	11	0	0
16	5873756	.	G	A	2	3	5	0	0	5	0	0
16	6182755	.	C	T	26	21	47	0	1	48	0	0
16	6191514	.	A	G	37	27	64	0	4	68	0	0
16	6191526	.	G	C	39	26	65	0	1	66	0	0
16	6191622	.	C	G	26	46	72	1	1	74	0	0
16	6192811	.	A	G	29	33	62	0	4	66	0	0
16	6197593	.	G	A	30	28	58	0	3	61	0	0
16	6205657	.	G	T	25	20	45	0	1	46	0	0
16	6356766	.	A	G	3	3	6	0	0	6	0	0
16	6356823	.	T	A	7	5	12	0	0	12	0	0
16	6356850	.	T	C	7	3	10	0	0	10	0	0
16	6362221	.	A	T	4	3	7	0	0	7	0	0
16	6387037	.	G	A	17	27	44	0	3	47	0	0
16	6387121	.	G	A	31	21	52	0	4	56	0	0
16	6387143	.	A	C	30	2	32	0	23	55	0	0
16	6387157	.	A	C	34	23	57	0	2	59	0	0
16	6395740	.	T	A	2	4	6	0	1	7	0	0
16	6395904	.	A	G	3	2	5	0	0	5	0	0
16	6395906	.	A	G	3	2	5	0	0	5	0	0
16	6648735	.	C	T	2	3	5	0	0	5	0	0
16	6649671	.	T	C	2	2	4	0	0	4	0	0
16	6649730	.	A	T	3	3	6	0	1	7	0	0
16	6650049	.	T	C	2	6	8	0	0	8	0	0
16	6650087	.	C	T	4	2	6	0	0	6	0	0
16	6650097	.	C	T	2	5	7	0	0	7	0	0
16	6650415	.	T	C	2	2	4	0	1	5	0	0
16	6650631	.	C	A	4	4	8	0	0	8	0	0
16	6650889	.	G	T	2	7	9	0	5	14	0	0
16	6650931	.	C	T	3	5	8	0	1	9	0	0
16	6651049	.	T	C	5	3	8	0	0	8	0	0
16	6653508	.	C	A	1	2	3	0	0	4	1	0
16	6653587	.	T	A	2	10	12	0	0	12	0	0
16	6653875	.	G	T	6	4	10	0	0	10	0	0
16	6653883	.	A	G	6	4	10	0	0	10	0	0
16	6654152	.	T	C	4	6	10	0	0	10	0	0
16	6733567	.	G	A	3	2	5	0	0	5	0	0
16	6735029	.	C	G	1	2	3	0	0	3	0	0
16	6735032	.	T	A	1	2	3	0	0	3	0	0
16	6735077	.	A	G	3	2	5	0	0	5	0	0
16	6741716	.	G	T	0	5	5	0	2	7	0	0
16	6745636	.	T	C	4	4	8	0	0	8	0	0
16	6746003	.	C	T	7	2	9	0	0	9	0	0
16	6746038	.	C	A	2	7	9	0	0	9	0	0
16	6747256	.	G	T	6	3	9	0	0	9	0	0
16	6756387	.	G	C	1	2	3	0	0	3	0	0
16	6757321	.	T	C	2	2	4	0	0	4	0	0
16	6757361	.	G	A	0	2	2	0	2	4	0	0
16	6763017	.	A	T	4	4	8	0	0	8	0	0
16	6766761	.	C	T	2	3	5	0	0	5	0	0
16	6770411	.	A	G	7	0	7	0	5	12	0	0
16	6770441	.	A	G	6	4	10	0	0	10	0	0
16	6770455	.	G	A	4	5	9	0	0	9	0	0
16	6771841	.	T	C	4	5	9	0	0	9	0	0
16	6776120	.	G	A	0	5	5	0	7	12	0	0
16	6776126	.	G	A	8	6	14	0	0	14	0	0
16	6776416	.	T	C	2	2	4	0	0	4	0	0
16	6778482	.	A	G	6	4	10	0	0	10	0	0
16	6779823	.	C	T	2	2	4	0	1	5	0	0
16	6784866	.	C	T	8	3	11	0	0	11	0	0
16	6787491	.	G	A	3	5	8	0	7	15	0	0
16	6790964	.	C	T	4	5	9	0	0	9	0	0
16	6790978	.	C	T	3	4	7	0	0	7	0	0
16	6792044	.	C	T	6	7	13	0	0	13	0	0
16	6792059	.	C	G	6	5	11	0	0	11	0	0
16	6796096	.	C	T	0	8	8	0	1	9	0	0
16	6796118	.	C	T	5	6	11	0	0	11	0	0
16	6800043	.	G	A	1	3	4	0	8	12	0	0
16	6800209	.	G	A	2	5	7	0	0	7	0	0
16	6800211	.	A	G	2	0	2	0	5	7	0	0
16	6800330	.	G	C	2	2	4	2	1	7	0	0
16	6800383	.	G	A	2	4	6	0	0	6	0	0
16	6803410	.	C	T	3	1	4	0	0	4	0	0
16	6803429	.	T	C	7	6	13	0	0	13	0	0
16	6803650	.	A	T	25	15	40	7	1	48	0	0
16	6803725	.	T	C	18	21	39	0	2	41	0	0
16	6803887	.	A	G	18	19	37	0	0	37	0	0
16	6820746	.	G	C	8	9	17	0	2	19	0	0
16	6821214	.	G	A	5	7	12	0	0	12	0	0
16	6821248	.	C	T	0	14	14	0	3	17	0	0
16	6821332	.	A	G	9	8	17	0	1	18	0	0
16	6821423	.	A	G	8	13	21	0	2	23	0	0
16	6821465	.	C	T	0	5	5	0	18	23	0	0
16	6821995	.	T	C	22	1	23	0	13	36	0	0
16	6822014	.	G	A	12	21	33	0	0	33	0	0
16	6864716	.	T	C	7	4	11	0	0	11	0	0
16	6864838	.	G	A	1	6	7	0	3	10	0	0
16	6903350	.	T	A	4	3	7	0	2	9	0	0
16	6903599	.	G	A	1	4	5	0	2	7	0	0
16	6903680	.	A	G	5	0	5	0	4	9	0	0
16	6917125	.	G	A	2	4	6	0	0	6	0	0
16	6917140	.	A	G	5	6	11	0	1	12	0	0
16	6920023	.	T	C	2	3	5	0	0	5	0	0
16	6920026	.	G	A	0	3	3	0	2	5	0	0
16	6920250	.	G	A	1	6	7	0	0	7	0	0
16	6923646	.	A	T	6	4	10	0	2	12	0	0
16	6923836	.	A	G	9	7	16	0	0	16	0	0
16	6923879	.	G	A	5	3	8	0	0	8	0	0
16	6926751	.	C	T	2	3	5	0	2	7	0	0
16	6926876	.	C	T	3	8	11	0	1	12	0	0
16	6929670	.	C	A	4	5	9	0	1	10	0	0
16	6929671	.	A	T	4	6	10	0	0	10	0	0
16	6929812	.	C	T	9	4	13	0	0	13	0	0
16	6929832	.	G	A	8	5	13	0	0	13	0	0
16	6929860	.	G	A	5	9	14	0	0	14	0	0
16	6932735	.	A	T	3	6	9	0	0	9	0	0
16	6937191	.	G	A	2	2	4	0	0	4	0	0
16	6938038	.	A	T	2	1	3	1	2	6	0	0
16	6944713	.	G	T	7	5	12	0	0	12	0	0
16	6944720	.	A	G	7	7	14	0	0	14	0	0
16	6944766	.	T	C	16	15	31	0	1	32	0	0
16	6955048	.	G	A	24	21	45	0	2	47	0	0
16	6955368	.	A	G	13	9	22	2	0	24	0	0
16	6981593	.	A	G	1	0	1	0	3	4	0	0
16	7054250	.	T	C	4	4	8	0	0	8	0	0
16	7202466	.	T	A	2	2	4	0	1	5	0	0
16	7202467	.	A	G	3	2	5	0	0	5	0	0
16	7202513	.	A	C	3	0	3	0	0	6	3	0
16	7202757	.	C	T	3	2	5	0	0	5	0	0
16	7202758	.	T	A	3	2	5	0	0	5	0	0
16	7203408	.	G	T	2	3	5	0	0	5	0	0
16	7203424	.	A	G	3	3	6	0	0	6	0	0
16	7208565	.	C	T	0	2	2	0	1	3	0	0
16	7212412	.	T	C	2	0	2	0	2	4	0	0
16	7212428	.	A	G	3	2	5	0	0	5	0	0
16	7212520	.	G	A	4	2	6	0	0	6	0	0
16	7217013	.	A	G	8	12	20	0	1	21	0	0
16	7217052	.	G	T	12	12	24	0	0	24	0	0
16	7220142	.	A	G	14	5	19	0	0	19	0	0
16	7220225	.	C	T	2	11	13	0	6	19	0	0
16	7221846	.	C	T	1	8	9	0	7	16	0	0
16	7226998	.	G	A	8	6	14	0	1	15	0	0
16	7239374	.	A	C	5	12	17	0	1	18	0	0
16	7242677	.	C	T	4	4	8	0	0	8	0	0
16	7242729	.	A	T	11	5	16	0	0	16	0	0
16	7242735	.	T	A	9	5	14	0	0	14	0	0
16	7242790	.	A	G	6	7	13	0	0	13	0	0
16	7242821	.	A	T	12	6	18	0	0	18	0	0
16	7242878	.	A	G	19	13	32	0	1	33	0	0
16	7242961	.	A	G	9	8	17	0	0	17	0	0
16	7250782	.	A	T	9	17	26	0	1	27	0	0
16	7252871	.	T	C	11	27	38	0	2	40	0	0
16	7254778	.	G	A	1	23	24	0	15	39	0	0
16	7259719	.	T	C	11	16	27	0	0	27	0	0
16	7259869	.	T	A	2	10	12	0	0	12	0	0
16	7259900	.	A	G	4	8	12	0	0	12	0	0
16	7259956	.	A	T	7	18	25	0	0	25	0	0
16	7259957	.	G	A	7	18	25	0	0	25	0	0
16	7260156	.	T	C	1	2	3	0	1	4	0	0
16	7260262	.	G	A	2	5	7	0	0	7	0	0
16	7260280	.	T	A	1	4	5	0	0	5	0	0
16	7315229	.	G	C	4	3	7	0	0	7	0	0
16	7315255	.	G	A	3	4	7	0	0	7	0	0
16	7315413	.	T	C	2	0	2	0	3	5	0	0
16	7315654	.	A	T	6	2	8	0	0	8	0	0
16	7315933	.	G	A	5	5	10	0	0	10	0	0
16	7316083	.	G	A	4	5	9	0	1	10	0	0
16	7316409	.	G	A	5	4	9	0	0	9	0	0
16	7376900	.	A	G	7	7	14	0	2	16	0	0
16	7385689	.	C	T	7	7	14	0	0	14	0	0
16	7385705	.	A	G	6	7	13	0	0	13	0	0
16	7385807	.	C	T	7	5	12	0	0	12	0	0
16	7415215	.	G	A	17	9	26	0	0	26	0	0
16	7415254	.	T	A	12	10	22	0	0	22	0	0
16	7415423	.	C	A	14	12	26	0	2	28	0	0
16	7415435	.	G	A	14	13	27	0	1	28	0	0
16	7415542	.	A	T	9	10	19	0	4	23	0	0
16	7415559	.	C	A	7	10	17	0	1	18	0	0
16	7415761	.	G	A	16	4	20	0	0	20	0	0
16	7415793	.	G	A	14	7	21	0	2	23	0	0
16	7416236	.	C	T	10	12	22	0	0	22	0	0
16	7416320	.	C	T	10	9	19	0	0	19	0	0
16	7416352	.	T	A	8	5	13	0	0	14	1	0
16	7626589	.	T	C	21	15	36	0	1	37	0	0
16	7630612	.	T	C	20	16	36	0	0	36	0	0
16	7635527	.	C	T	20	23	43	0	1	44	0	0
16	7635721	.	T	A	21	17	38	0	2	41	1	0
16	7638788	.	T	C	18	13	31	0	0	31	0	0
16	7638815	.	A	T	17	19	36	0	1	37	0	0
16	7638828	.	A	G	15	1	16	0	21	37	0	0
16	7638866	.	A	T	23	14	37	0	0	37	0	0
16	7638979	.	C	T	21	20	41	0	2	43	0	0
16	7638984	.	C	A	21	19	40	0	4	44	0	0
16	7639085	.	A	C	15	29	44	0	1	45	0	0
16	7639100	.	T	A	19	26	45	0	3	48	0	0
16	7639401	.	A	C	31	23	54	0	1	55	0	0
16	7639527	.	C	T	18	19	37	0	1	38	0	0
16	7639534	.	G	C	1	18	19	0	19	38	0	0
16	7639621	.	C	T	13	24	37	0	0	37	0	0
16	7639643	.	A	T	14	23	37	0	1	38	0	0
16	7639684	.	A	G	15	18	33	0	0	33	0	0
16	7639774	.	T	A	17	16	33	0	1	34	0	0
16	7639856	.	T	C	17	26	43	0	0	43	0	0
16	7640116	.	A	G	19	21	40	0	2	42	0	0
16	7640127	.	G	A	2	22	24	0	20	44	0	0
16	7640390	.	C	T	31	8	39	0	1	40	0	0
16	7640410	.	A	G	32	8	40	0	2	42	0	0
16	7640425	.	T	A	25	16	41	0	2	43	0	0
16	7640757	.	T	A	18	11	29	0	0	29	0	0
16	7640999	.	G	A	4	5	9	0	0	9	0	0
16	7656878	.	T	G	1	3	4	0	0	4	0	0
16	7673160	.	A	T	1	2	3	0	0	3	0	0
16	7673175	.	C	G	1	2	3	0	0	3	0	0
16	7705796	.	T	C	2	4	6	0	0	6	0	0
16	7716184	.	C	G	3	5	8	0	0	8	0	0
16	7725555	.	A	T	5	9	14	0	0	14	0	0
16	7728408	.	C	T	4	7	11	0	0	11	0	0
16	7743398	.	C	T	0	5	5	0	4	9	0	0
16	7743598	.	T	A	6	6	12	0	0	12	0	0
16	7743687	.	A	G	1	4	5	0	0	5	0	0
16	7745027	.	C	A	4	4	8	0	0	8	0	0
16	7745053	.	C	G	6	4	10	0	1	11	0	0
16	7745398	.	A	G	1	4	5	0	0	5	0	0
16	7746040	.	G	A	5	1	6	0	1	9	2	0
16	7746152	.	A	T	2	5	7	0	0	7	0	0
16	7746153	.	G	A	2	5	7	0	0	7	0	0
16	7746193	.	G	A	4	5	9	0	0	9	0	0
16	7746693	.	C	T	4	2	6	0	3	9	0	0
16	7746947	.	G	A	3	2	5	0	0	5	0	0
16	7748211	.	G	A	5	3	8	0	1	9	0	0
16	7748346	.	G	A	2	3	5	0	0	5	0	0
16	7748364	.	G	A	2	3	5	0	0	5	0	0
16	7758386	.	C	T	5	3	8	0	2	10	0	0
16	7792786	.	C	T	1	2	3	0	0	3	0	0
16	7803023	.	T	C	6	6	12	0	0	12	0	0
16	7803298	.	T	C	5	3	8	0	0	8	0	0
16	7803340	.	T	C	2	5	7	0	0	7	0	0
16	7803401	.	A	G	4	0	4	0	2	9	3	0
16	7803418	.	G	C	4	6	10	0	1	11	0	0
16	7803560	.	A	G	7	6	13	0	2	15	0	0
16	7803627	.	T	A	4	8	12	0	0	12	0	0
16	7803765	.	C	G	10	6	16	0	0	16	0	0
16	7803782	.	C	A	2	6	8	0	5	13	0	0
16	7803825	.	A	T	3	5	8	0	0	8	0	0
16	7803859	.	A	C	4	3	7	0	0	7	0	0
16	7803905	.	G	C	7	1	8	0	4	12	0	0
16	7803923	.	T	A	11	7	18	0	0	18	0	0
16	7803971	.	T	A	10	5	15	0	1	16	0	0
16	7804269	.	A	T	7	3	10	0	0	10	0	0
16	7804270	.	C	T	8	3	11	0	0	11	0	0
16	7804355	.	C	G	5	6	11	0	0	11	0	0
16	7804391	.	T	C	2	0	2	0	6	8	0	0
16	7804588	.	C	A	8	3	11	0	0	11	0	0
16	7804914	.	C	T	3	2	5	0	0	5	0	0
16	7804927	.	T	C	2	1	3	0	0	3	0	0
16	7804990	.	A	C	2	3	5	0	0	5	0	0
16	7805423	.	C	T	0	7	7	0	3	10	0	0
16	7805524	.	C	A	2	3	5	0	2	7	0	0
16	7821241	.	C	T	4	10	14	0	1	15	0	0
16	7821244	.	G	A	4	12	16	0	0	16	0	0
16	7828792	.	G	T	7	4	11	0	0	11	0	0
16	7985896	.	T	A	6	7	13	0	0	13	0	0
16	7994808	.	T	G	3	1	4	0	1	5	0	0
16	7998969	.	A	G	4	3	7	0	0	7	0	0
16	7999368	.	A	G	2	7	9	0	1	10	0	0
16	7999499	.	C	A	2	5	7	0	0	7	0	0
16	8001064	.	C	A	3	6	9	0	0	9	0	0
16	8040833	.	C	G	8	3	11	0	0	11	0	0
16	8051941	.	T	C	7	0	7	0	13	20	0	0
16	8052033	.	T	C	12	13	25	0	1	26	0	0
16	8052049	.	G	A	14	11	25	1	1	27	0	0
16	8052145	.	C	A	18	15	33	0	0	33	0	0
16	8052537	.	C	T	16	14	30	0	1	31	0	0
16	8052606	.	T	C	14	0	14	0	8	22	0	0
16	8052651	.	T	C	20	7	27	0	1	28	0	0
16	8052673	.	G	C	22	0	22	0	9	31	0	0
16	8052747	.	A	G	15	11	26	0	0	26	0	0
16	8052831	.	T	A	8	10	18	0	1	19	0	0
16	8052866	.	C	A	0	4	4	5	7	16	0	0
16	8052909	.	T	A	5	7	12	6	0	18	0	0
16	8052982	.	T	C	10	9	19	0	2	21	0	0
16	8053206	.	T	G	6	11	17	0	0	17	0	0
16	8053403	.	C	T	16	12	28	0	1	29	0	0
16	8053485	.	C	T	17	10	27	0	1	28	0	0
16	8053716	.	A	G	16	16	32	0	2	34	0	0
16	8053717	.	T	C	16	17	33	0	1	34	0	0
16	8054260	.	T	G	3	8	11	0	0	11	0	0
16	8054290	.	C	T	1	9	10	0	2	12	0	0
16	8054389	.	C	T	0	9	9	0	14	23	0	0
16	8054434	.	T	C	13	2	15	0	13	28	0	0
16	8055037	.	A	G	8	13	21	0	1	22	0	0
16	8059585	.	T	C	8	9	17	0	0	17	0	0
16	8066237	.	A	C	10	14	24	0	1	25	0	0
16	8066318	.	A	G	14	14	28	0	0	28	0	0
16	8119672	.	G	A	14	14	28	0	0	28	0	0
16	8119976	.	A	G	19	10	29	0	1	30	0	0
16	8120033	.	G	A	17	15	32	0	3	35	0	0
16	8120171	.	C	T	13	5	18	0	0	18	0	0
16	8139585	.	G	A	2	8	10	0	0	10	0	0
16	8139786	.	T	C	6	3	9	0	1	10	0	0
16	8160589	.	T	C	3	4	7	0	0	7	0	0
16	8161330	.	C	T	3	8	11	0	0	11	0	0
16	8161555	.	C	T	3	5	8	0	0	8	0	0
16	8161573	.	C	A	4	7	11	0	0	11	0	0
16	8161591	.	G	A	5	5	10	0	0	10	0	0
16	8161708	.	G	A	0	6	6	0	6	12	0	0
16	8161875	.	C	T	4	7	11	0	0	11	0	0
16	8162024	.	G	A	0	2	2	0	3	5	0	0
16	8162356	.	T	G	1	2	3	0	0	3	0	0
16	8298915	.	T	C	1	3	4	0	0	4	0	0
16	8299025	.	T	A	5	4	9	0	0	9	0	0
16	8299037	.	A	T	5	3	8	0	0	8	0	0
16	8299123	.	T	A	9	4	13	0	1	14	0	0
16	8299302	.	G	A	4	2	6	0	1	7	0	0
16	8299308	.	T	A	7	2	9	0	0	9	0	0
16	8299410	.	T	A	3	4	7	0	0	7	0	0
16	8299462	.	G	C	3	2	5	0	0	5	0	0
16	8300218	.	T	A	5	2	7	0	0	7	0	0
16	8300225	.	C	T	1	3	4	0	4	8	0	0
16	8300255	.	G	A	7	4	11	0	0	11	0	0
16	8300269	.	T	C	6	2	8	0	0	8	0	0
16	8300823	.	T	A	4	7	11	0	0	11	0	0
16	8317945	.	A	C	1	0	1	0	2	3	0	0
16	8323386	.	T	C	5	4	9	0	1	10	0	0
16	8339352	.	G	C	3	0	3	0	3	6	0	0
16	8342675	.	C	T	7	9	16	0	0	16	0	0
16	8531299	.	C	T	6	6	12	0	0	12	0	0
16	8531571	.	A	G	2	3	5	0	0	5	0	0
16	8532430	.	G	T	5	2	7	0	0	7	0	0
16	8535966	.	C	T	0	3	3	0	1	4	0	0
16	8539363	.	T	C	1	0	1	0	4	5	0	0
16	8539523	.	C	T	1	4	5	0	0	5	0	0
16	8539885	.	C	A	7	2	9	0	0	9	0	0
16	8540664	.	G	T	2	3	5	0	0	5	0	0
16	8552018	.	C	T	2	2	4	0	0	4	0	0
16	8552048	.	A	T	2	3	5	0	0	5	0	0
16	8564763	.	C	A	0	3	3	0	1	4	0	0
16	8578996	.	G	A	2	2	4	0	0	4	0	0
16	8608649	.	C	T	1	2	3	0	0	3	0	0
16	8608661	.	C	T	0	2	2	0	1	3	0	0
16	8752017	.	T	A	21	17	38	0	0	38	0	0
16	8752091	.	A	G	12	22	34	0	4	38	0	0
16	8752223	.	C	T	11	17	28	0	4	32	0	0
16	8752316	.	G	T	14	15	29	0	0	29	0	0
16	8752334	.	C	T	4	18	22	0	12	34	0	0
16	8759975	.	G	A	18	20	38	0	0	38	0	0
16	8771008	.	A	G	2	2	4	0	3	7	0	0
16	8771091	.	A	G	5	3	8	1	0	9	0	0
16	8771162	.	G	A	2	2	4	0	1	5	0	0
16	8788386	.	T	C	13	12	25	0	1	26	0	0
16	8788446	.	A	G	23	8	31	0	1	32	0	0
16	8788629	.	T	C	14	0	14	0	14	28	0	0
16	8788659	.	G	C	9	15	24	0	0	24	0	0
16	8816122	.	G	A	7	15	22	0	0	22	0	0
16	8818958	.	T	C	12	6	18	0	0	18	0	0
16	8819113	.	T	C	13	6	19	0	0	19	0	0
16	8834219	.	G	T	17	9	26	0	1	27	0	0
16	8844580	.	A	G	14	17	31	1	1	33	0	0
16	8844586	.	C	A	14	15	29	1	1	31	0	0
16	8845738	.	T	G	11	17	28	0	1	29	0	0
16	8847272	.	T	C	14	10	24	1	0	25	0	0
16	8862269	.	G	A	7	10	17	0	0	17	0	0
16	9276020	.	C	T	8	12	20	0	0	20	0	0
16	9281534	.	G	A	3	9	12	0	0	12	0	0
16	9282707	.	C	T	4	5	9	0	0	9	0	0
16	9286997	.	G	A	7	5	12	0	0	12	0	0
16	9297728	.	C	T	6	9	15	0	1	16	0	0
16	9297889	.	C	T	5	6	11	0	0	11	0	0
16	9299700	.	C	T	4	5	9	0	2	11	0	0
16	9306247	.	A	G	8	5	13	0	0	13	0	0
16	9313279	.	G	A	3	2	5	1	0	6	0	0
16	9313294	.	T	C	2	4	6	1	0	7	0	0
16	9348891	.	C	T	3	2	5	0	0	5	0	0
16	9383456	.	T	A	5	2	7	0	0	7	0	0
16	9408625	.	T	A	5	3	8	0	0	8	0	0
16	9408795	.	G	A	0	2	2	0	2	4	0	0
16	9408822	.	G	T	4	4	8	0	0	8	0	0
16	9409013	.	C	A	9	5	14	0	0	14	0	0
16	9409051	.	C	T	6	4	10	0	1	11	0	0
16	9409286	.	T	A	2	2	4	0	0	4	0	0
16	9410978	.	C	G	3	3	6	0	0	6	0	0
16	9411121	.	T	G	3	4	7	0	0	7	0	0
16	9411749	.	G	A	4	3	7	0	0	7	0	0
16	9411872	.	G	C	1	3	4	0	0	4	0	0
16	9411962	.	G	A	4	6	10	0	0	10	0	0
16	9411965	.	G	A	4	5	9	0	0	9	0	0
16	9412024	.	A	T	2	9	11	0	0	11	0	0
16	9412048	.	T	C	6	7	13	0	0	13	0	0
16	9412177	.	A	G	1	0	1	0	3	4	0	0
16	9412302	.	C	T	4	6	10	0	0	10	0	0
16	9412401	.	C	T	4	8	12	0	1	13	0	0
16	9412615	.	T	G	2	3	5	0	0	5	0	0
16	9412878	.	C	T	4	2	6	0	0	6	0	0
16	9415134	.	A	G	2	4	6	0	0	6	0	0
16	9415176	.	A	G	5	2	7	0	0	7	0	0
16	9415387	.	C	T	5	3	8	0	0	8	0	0
16	9415749	.	G	A	6	5	11	0	0	11	0	0
16	9415793	.	C	T	5	2	7	0	1	8	0	0
16	9420003	.	G	A	6	10	16	0	0	16	0	0
16	9433856	.	C	A	1	2	3	0	4	7	0	0
16	9433915	.	C	T	0	2	2	0	2	4	0	0
16	9434086	.	A	C	7	2	9	0	1	10	0	0
16	9437789	.	G	A	8	10	18	0	0	18	0	0
16	9587606	.	T	C	4	3	7	0	0	7	0	0
16	9587696	.	A	G	1	0	1	0	2	3	0	0
16	9593865	.	A	C	4	9	13	0	1	14	0	0
16	9596127	.	C	T	4	7	11	0	0	11	0	0
16	9602643	.	T	C	5	12	17	0	1	18	0	0
16	9602672	.	A	G	8	11	19	0	1	20	0	0
16	9605436	.	A	T	6	12	18	0	2	20	0	0
16	9605619	.	T	C	8	8	16	0	1	17	0	0
16	9605728	.	G	C	3	3	6	0	0	6	0	0
16	9605823	.	A	T	4	4	8	0	0	8	0	0
16	9605850	.	A	G	6	9	15	0	0	15	0	0
16	9605947	.	A	G	15	5	20	0	0	20	0	0
16	9605982	.	C	A	8	9	17	0	0	17	0	0
16	9606011	.	G	T	6	11	17	0	0	17	0	0
16	9606024	.	C	T	4	9	13	0	0	13	0	0
16	9606048	.	G	A	2	5	7	0	0	7	0	0
16	9714080	.	G	A	12	6	18	0	1	19	0	0
16	9716237	.	C	A	2	3	5	0	1	6	0	0
16	9716258	.	T	C	3	2	5	0	0	5	0	0
16	9722035	.	C	T	5	2	7	0	0	7	0	0
16	9722069	.	G	A	4	2	6	0	0	6	0	0
16	9722089	.	G	A	1	3	4	0	0	4	0	0
16	9723551	.	G	A	2	2	4	0	0	4	0	0
16	9723557	.	G	C	2	2	4	0	0	4	0	0
16	9725137	.	A	T	1	2	3	0	0	3	0	0
16	9725196	.	C	G	2	2	4	0	0	4	0	0
16	9745489	.	T	A	8	4	12	0	2	14	0	0
16	9748874	.	C	G	5	8	13	0	1	14	0	0
16	9751612	.	A	G	3	1	4	0	3	7	0	0
16	9752273	.	T	C	10	6	16	0	1	17	0	0
16	9752999	.	A	G	2	8	10	0	1	11	0	0
16	9753005	.	C	G	2	7	9	0	1	10	0	0
16	9753083	.	A	T	8	7	15	0	0	15	0	0
16	9755612	.	C	T	9	6	15	0	0	15	0	0
16	9755647	.	T	C	12	7	19	0	0	19	0	0
16	9758164	.	C	T	6	12	18	0	0	18	0	0
16	9758452	.	A	T	4	4	8	0	0	8	0	0
16	9758561	.	T	C	3	3	6	0	0	6	0	0
16	9758675	.	G	A	1	4	5	0	2	7	0	0
16	9758944	.	G	A	3	6	9	0	11	20	0	0
16	9758956	.	A	G	10	5	15	0	2	17	0	0
16	9759605	.	A	T	7	7	14	0	1	15	0	0
16	9759698	.	A	C	7	8	15	0	1	16	0	0
16	9759820	.	T	A	6	7	13	0	0	13	0	0
16	9759842	.	A	G	4	7	11	0	0	11	0	0
16	9759914	.	A	G	5	8	13	0	1	14	0	0
16	9760006	.	C	T	9	6	15	0	1	16	0	0
16	9760083	.	T	C	6	11	17	0	0	17	0	0
16	9760085	.	C	A	6	11	17	0	0	17	0	0
16	9760248	.	T	C	13	4	17	0	0	17	0	0
16	9760597	.	A	G	1	0	1	0	5	6	0	0
16	9760835	.	A	T	6	4	10	0	0	10	0	0
16	9760894	.	A	T	8	9	17	0	0	17	0	0
16	9761141	.	G	A	1	5	6	0	7	13	0	0
16	9766586	.	A	C	9	11	20	0	1	21	0	0
16	9766774	.	T	C	12	13	25	0	2	27	0	0
16	9769846	.	C	T	11	11	22	0	2	24	0	0
16	9771283	.	C	G	12	15	27	0	0	27	0	0
16	9771284	.	T	C	13	13	26	0	2	28	0	0
16	9774187	.	G	A	14	20	34	0	0	34	0	0
16	9774357	.	G	A	20	22	42	0	0	42	0	0
16	9774381	.	G	A	21	17	38	0	1	39	0	0
16	9777497	.	T	C	13	18	31	0	2	33	0	0
16	9777589	.	A	T	12	10	22	0	0	22	0	0
16	9777716	.	A	G	4	3	7	0	0	7	0	0
16	9781031	.	T	C	18	17	35	0	5	40	0	0
16	9785990	.	G	A	10	23	33	0	3	36	0	0
16	9787891	.	T	G	23	19	42	0	1	43	0	0
16	9788110	.	C	T	6	5	11	0	2	13	0	0
16	9788447	.	T	C	4	8	12	0	0	12	0	0
16	9788486	.	G	A	4	10	14	0	1	15	0	0
16	9788672	.	G	A	8	5	13	0	0	13	0	0
16	9788929	.	T	G	3	6	9	0	0	9	0	0
16	9789007	.	A	T	7	12	19	1	1	21	0	0
16	9789015	.	C	G	14	4	18	1	1	20	0	0
16	9789048	.	G	T	8	4	12	0	0	12	0	0
16	9789063	.	A	C	9	5	14	0	1	15	0	0
16	9789097	.	C	T	9	8	17	0	0	17	0	0
16	9789225	.	A	C	5	7	12	0	2	14	0	0
16	9789371	.	C	G	12	1	13	1	2	16	0	0
16	9789513	.	C	G	17	14	31	0	1	33	1	0
16	9789984	.	T	C	11	11	22	0	2	24	0	0
16	9791087	.	A	C	2	4	6	0	0	6	0	0
16	9791111	.	T	G	1	6	7	0	0	7	0	0
16	9793981	.	A	T	2	8	10	0	0	10	0	0
16	9797128	.	A	C	1	0	1	0	4	5	0	0
16	9801943	.	A	G	5	5	10	0	0	10	0	0
16	9802099	.	G	A	3	2	5	0	0	5	0	0
16	9813388	.	G	A	1	3	4	0	0	4	0	0
16	9827944	.	A	G	1	3	4	0	0	4	0	0
16	9833315	.	T	A	2	2	4	0	0	4	0	0
16	9833494	.	C	A	4	2	6	0	0	6	0	0
16	9833794	.	T	A	15	29	44	0	1	45	0	0
16	9833887	.	T	A	26	11	37	0	2	39	0	0
16	9833974	.	G	A	28	23	51	0	1	52	0	0
16	9834135	.	A	C	23	22	45	0	0	45	0	0
16	9834271	.	C	T	23	14	37	1	0	38	0	0
16	9834491	.	T	A	27	15	42	0	1	43	0	0
16	9834518	.	T	G	20	19	39	0	2	41	0	0
16	9834541	.	G	A	16	17	33	0	1	34	0	0
16	9834595	.	A	T	18	13	31	0	3	34	0	0
16	9834748	.	G	C	15	17	32	0	1	33	0	0
16	9834802	.	C	A	17	16	33	0	1	34	0	0
16	9834850	.	A	G	14	16	30	0	1	31	0	0
16	9834960	.	G	A	24	21	45	0	2	47	0	0
16	9835250	.	C	G	24	22	46	0	5	51	0	0
16	9847149	.	G	A	23	18	41	0	2	43	0	0
16	9847182	.	T	C	18	23	41	0	2	43	0	0
16	9978438	.	G	A	34	26	60	0	1	61	0	0
16	10027167	.	G	C	2	0	2	0	4	6	0	0
16	10038806	.	A	T	3	5	8	0	0	8	0	0
16	10038938	.	T	C	2	4	6	0	0	6	0	0
16	10038956	.	A	G	2	3	5	0	0	5	0	0
16	10048855	.	G	C	2	0	2	0	2	4	0	0
16	10055799	.	A	T	5	2	7	0	0	7	0	0
16	10066164	.	A	G	5	10	15	0	0	15	0	0
16	10071730	.	G	A	9	7	16	0	0	16	0	0
16	10071777	.	C	T	8	9	17	0	1	18	0	0
16	10210504	.	C	T	1	3	4	0	1	5	0	0
16	10213523	.	A	T	1	2	3	0	0	3	0	0
16	10213529	.	A	G	1	2	3	0	0	3	0	0
16	10232334	.	C	T	1	3	4	0	0	4	0	0
16	10232385	.	C	G	1	4	5	0	0	5	0	0
16	10279330	.	C	T	3	4	7	0	0	7	0	0
16	10283438	.	C	A	7	6	13	0	0	13	0	0
16	10284582	.	A	T	4	5	9	0	0	9	0	0
16	10287996	.	G	A	4	7	11	0	0	11	0	0
16	10288022	.	C	A	7	3	10	0	0	10	0	0
16	10288230	.	A	G	9	6	15	0	0	15	0	0
16	10288260	.	C	T	8	9	17	0	1	18	0	0
16	10288754	.	G	A	4	5	9	0	0	9	0	0
16	10288784	.	C	A	4	5	9	0	0	9	0	0
16	10288827	.	T	A	5	5	10	0	0	10	0	0
16	10288882	.	T	A	6	4	10	0	0	10	0	0
16	10288951	.	G	A	6	6	12	0	2	14	0	0
16	10288998	.	G	A	5	4	9	0	0	9	0	0
16	10289049	.	C	A	3	3	6	0	1	7	0	0
16	10300046	.	C	T	4	5	9	0	0	9	0	0
16	10300466	.	G	T	4	3	7	0	1	8	0	0
16	10300493	.	A	G	8	4	12	0	1	13	0	0
16	10323903	.	C	T	17	14	31	0	2	33	0	0
16	10325870	.	C	T	22	19	41	0	4	45	0	0
16	10326092	.	C	T	28	24	52	0	5	57	0	0
16	10326347	.	T	G	19	0	19	0	27	46	0	0
16	10338418	.	T	A	4	5	9	0	0	9	0	0
16	10338593	.	A	G	9	4	13	0	0	13	0	0
16	10339887	.	C	A	4	4	8	0	0	8	0	0
16	10341816	.	A	C	3	3	6	0	0	6	0	0
16	10342169	.	C	T	10	12	22	0	0	22	0	0
16	10345223	.	T	C	8	7	15	0	0	15	0	0
16	10345595	.	A	G	7	13	20	0	0	20	0	0
16	10345720	.	A	G	5	5	10	0	0	10	0	0
16	10346329	.	T	C	4	7	11	0	0	11	0	0
16	10346444	.	T	G	10	6	16	0	0	16	0	0
16	10360911	.	T	C	13	6	19	0	0	19	0	0
16	10360935	.	T	C	10	7	17	0	0	17	0	0
16	10360971	.	C	T	11	7	18	0	2	20	0	0
16	10364706	.	T	C	11	18	29	0	0	29	0	0
16	10366768	.	C	T	18	13	31	0	3	34	0	0
16	10367171	.	G	A	13	12	25	0	5	30	0	0
16	10367475	.	C	A	23	17	40	0	4	44	0	0
16	10367499	.	C	T	22	17	39	0	0	39	0	0
16	10367674	.	C	T	13	21	34	0	0	34	0	0
16	10367894	.	A	C	10	13	23	0	2	25	0	0
16	10367961	.	C	T	8	14	22	0	1	23	0	0
16	10368002	.	T	A	11	16	27	0	0	27	0	0
16	10368086	.	A	T	10	10	20	0	2	22	0	0
16	10368098	.	T	C	11	9	20	0	0	20	0	0
16	10368200	.	C	T	11	11	22	0	0	22	0	0
16	10368219	.	T	G	12	8	20	0	0	20	0	0
16	10368407	.	A	G	8	3	11	0	0	11	0	0
16	10368408	.	C	A	8	3	11	0	0	11	0	0
16	10368452	.	T	A	8	15	23	0	2	25	0	0
16	10368564	.	G	C	13	5	18	0	2	20	0	0
16	10368594	.	C	A	8	13	21	0	0	21	0	0
16	10368713	.	G	T	7	11	18	0	0	18	0	0
16	10368801	.	C	T	12	10	22	0	0	22	0	0
16	10368820	.	C	A	12	9	21	0	1	22	0	0
16	10369068	.	C	T	13	9	22	0	0	22	0	0
16	10369168	.	C	G	18	9	27	0	1	28	0	0
16	10369266	.	G	A	16	19	35	0	3	38	0	0
16	10413724	.	A	C	4	8	12	0	1	13	0	0
16	10413726	.	G	T	8	5	13	0	0	13	0	0
16	10413777	.	T	A	4	4	8	0	1	9	0	0
16	10413957	.	T	C	7	9	16	0	0	16	0	0
16	10417124	.	G	C	8	7	15	1	0	16	0	0
16	10426088	.	A	G	9	4	13	0	0	13	0	0
16	10426522	.	C	A	7	2	9	0	0	9	0	0
16	10426525	.	G	A	2	2	4	0	6	10	0	0
16	10426630	.	A	G	7	4	11	0	0	11	0	0
16	10426762	.	G	A	0	4	4	0	6	10	0	0
16	10427656	.	G	A	0	4	4	0	5	9	0	0
16	10427722	.	A	T	1	4	5	0	0	5	0	0
16	10427730	.	C	T	5	2	7	0	0	7	0	0
16	10427786	.	T	G	2	2	4	0	0	4	0	0
16	10427799	.	T	C	0	4	4	0	0	4	0	0
16	10431931	.	G	A	0	3	3	0	5	8	0	0
16	10431994	.	G	A	3	9	12	0	1	13	0	0
16	10432113	.	G	A	2	3	5	0	1	6	0	0
16	10432114	.	G	T	3	3	6	0	1	7	0	0
16	10438639	.	G	C	5	6	11	0	0	11	0	0
16	10438833	.	G	A	3	4	7	0	0	7	0	0
16	10444018	.	G	A	7	6	13	0	1	14	0	0
16	10447409	.	A	G	5	7	12	0	1	13	0	0
16	10447923	.	C	A	3	2	5	0	0	5	0	0
16	10454950	.	G	A	0	10	10	0	9	19	0	0
16	10458749	.	A	G	4	10	14	0	0	14	0	0
16	10461712	.	A	T	7	5	12	0	0	12	0	0
16	10464571	.	C	T	10	8	18	0	0	18	0	0
16	10475645	.	C	T	12	6	18	0	1	19	0	0
16	10475646	.	A	G	13	6	19	0	0	19	0	0
16	10477836	.	C	T	4	6	10	0	12	22	0	0
16	10481425	.	C	T	16	15	31	0	2	33	0	0
16	10481488	.	C	T	1	12	13	0	15	28	0	0
16	10489410	.	G	A	12	14	26	0	0	26	0	0
16	10502065	.	A	G	16	15	31	0	0	31	0	0
16	10502169	.	G	A	12	14	26	0	1	27	0	0
16	10504444	.	C	A	10	14	24	0	0	24	0	0
16	10506411	.	C	T	15	7	22	0	0	23	1	0
16	10557948	.	C	T	1	3	4	0	0	4	0	0
16	10617055	.	A	G	1	2	3	0	1	4	0	0
16	10617265	.	T	C	10	3	13	0	3	16	0	0
16	10620018	.	G	A	3	9	12	0	7	19	0	0
16	10620100	.	A	T	5	10	15	0	1	16	0	0
16	10620213	.	C	T	8	3	11	0	0	11	0	0
16	10633656	.	C	T	10	10	20	0	0	20	0	0
16	10633690	.	C	A	10	6	16	0	1	18	1	0
16	10634271	.	C	T	9	7	16	1	0	17	0	0
16	10634289	.	T	G	7	12	19	0	1	20	0	0
16	10635179	.	T	A	1	5	6	0	0	6	0	0
16	10635338	.	A	T	12	7	19	0	2	21	0	0
16	10635401	.	T	G	11	20	31	0	0	31	0	0
16	10635532	.	T	C	5	6	11	0	0	11	0	0
16	10635551	.	A	C	8	6	14	0	0	14	0	0
16	10635838	.	T	C	8	4	12	0	0	12	0	0
16	10635927	.	A	G	4	2	6	0	1	7	0	0
16	10635942	.	A	G	3	4	7	0	0	7	0	0
16	10636168	.	C	T	7	6	13	0	0	13	0	0
16	10636173	.	A	G	7	5	12	0	0	12	0	0
16	10636241	.	T	G	3	6	9	0	1	10	0	0
16	10636252	.	A	T	2	5	7	0	1	8	0	0
16	10636418	.	T	C	6	5	11	0	1	12	0	0
16	10636527	.	A	G	9	12	21	1	1	23	0	0
16	10636534	.	A	G	3	17	20	1	2	23	0	0
16	10636698	.	T	A	8	11	19	0	0	19	0	0
16	10636882	.	C	T	5	7	12	0	0	12	0	0
16	10637192	.	G	A	2	12	14	0	8	22	0	0
16	10637259	.	A	G	14	12	26	0	1	27	0	0
16	10637329	.	C	A	12	10	22	0	0	22	0	0
16	10637379	.	T	A	11	11	22	0	2	24	0	0
16	10637943	.	T	A	4	2	6	0	0	6	0	0
16	10724812	.	A	G	6	3	9	0	1	10	0	0
16	10731333	.	C	T	5	5	10	0	0	10	0	0
16	10731388	.	G	C	6	4	10	0	4	14	0	0
16	10731571	.	A	T	6	6	12	0	0	12	0	0
16	10731648	.	T	C	2	6	8	0	2	10	0	0
16	10731717	.	C	G	5	5	10	0	0	10	0	0
16	10731819	.	T	G	3	3	6	0	0	6	0	0
16	10731995	.	G	A	4	2	6	0	0	6	0	0
16	10732051	.	A	G	3	0	3	0	2	5	0	0
16	10732053	.	A	T	3	2	5	0	0	5	0	0
16	10732140	.	G	A	1	4	5	0	0	5	0	0
16	10733662	.	A	G	7	3	10	0	0	10	0	0
16	10733829	.	G	C	1	2	3	0	1	4	0	0
16	10734032	.	A	C	3	2	5	0	0	5	0	0
16	10734190	.	T	C	4	3	7	0	2	9	0	0
16	10776922	.	A	C	26	23	49	0	1	50	0	0
16	10777025	.	G	A	5	6	11	0	0	11	0	0
16	10795647	.	T	C	36	25	61	0	3	64	0	0
16	10798995	.	A	T	24	28	52	0	4	56	0	0
16	10799155	.	T	C	33	23	56	0	5	61	0	0
16	10801127	.	T	C	36	17	53	1	3	57	0	0
16	10801517	.	T	C	34	27	61	0	3	64	0	0
16	10801682	.	C	T	28	15	43	0	2	45	0	0
16	10801772	.	C	T	27	18	45	1	0	46	0	0
16	10804843	.	T	C	31	37	68	0	1	69	0	0
16	10804862	.	A	T	32	37	69	0	1	71	1	0
16	10804878	.	C	T	31	34	65	0	7	72	0	0
16	10807360	.	T	A	27	27	54	0	1	55	0	0
16	10807486	.	C	T	33	31	64	0	1	65	0	0
16	10813138	.	A	C	43	30	73	0	2	75	0	0
16	10813372	.	C	T	35	29	64	0	0	64	0	0
16	10815877	.	T	C	33	36	69	0	5	74	0	0
16	10820157	.	G	A	5	35	40	0	29	69	0	0
16	10820215	.	A	T	30	32	62	0	1	63	0	0
16	10820224	.	T	A	28	36	64	0	0	64	0	0
16	10820803	.	C	T	23	27	50	0	4	54	0	0
16	10820866	.	A	G	8	10	18	0	2	20	0	0
16	10829458	.	T	C	14	1	15	0	11	26	0	0
16	10829569	.	A	T	18	6	24	0	0	24	0	0
16	10829633	.	A	T	10	6	16	0	1	17	0	0
16	10829635	.	A	C	11	5	16	0	1	17	0	0
16	10829968	.	T	G	14	16	30	0	3	33	0	0
16	10830013	.	T	G	9	9	18	0	2	20	0	0
16	10830145	.	T	G	14	11	25	0	1	26	0	0
16	10830147	.	T	A	15	12	27	0	0	27	0	0
16	10830309	.	T	A	8	7	15	0	0	15	0	0
16	10830328	.	T	C	12	7	19	0	0	19	0	0
16	10830625	.	G	C	11	10	21	0	1	22	0	0
16	10832217	.	C	T	5	5	10	0	1	11	0	0
16	10833900	.	C	G	11	4	15	0	0	15	0	0
16	10833987	.	G	A	11	9	20	0	2	22	0	0
16	10841193	.	T	C	11	9	20	0	0	20	0	0
16	10841612	.	T	C	11	10	21	0	0	21	0	0
16	10843402	.	A	G	9	1	10	0	10	20	0	0
16	10843690	.	T	C	16	16	32	0	0	32	0	0
16	10846654	.	A	G	25	9	34	0	0	34	0	0
16	10855924	.	A	G	17	9	26	0	2	28	0	0
16	10856130	.	A	G	10	6	16	0	0	16	0	0
16	10856235	.	C	G	10	14	24	2	4	30	0	0
16	10858554	.	G	A	8	12	20	0	0	20	0	0
16	10858656	.	A	G	23	10	33	0	0	33	0	0
16	10859434	.	C	T	27	15	42	0	0	42	0	0
16	10859435	.	T	C	26	16	42	0	0	42	0	0
16	10859857	.	T	C	27	23	50	0	0	50	0	0
16	10861880	.	G	A	28	16	44	0	0	44	0	0
16	10861899	.	T	C	26	16	42	0	2	44	0	0
16	10861956	.	A	G	23	15	38	0	1	39	0	0
16	10861971	.	T	A	20	13	33	0	1	34	0	0
16	10862331	.	C	G	20	11	31	0	0	31	0	0
16	10862627	.	G	A	3	18	21	0	24	45	0	0
16	10862762	.	C	T	24	15	39	0	1	40	0	0
16	10862773	.	T	C	23	19	42	0	0	42	0	0
16	10918660	.	C	G	4	5	9	0	0	9	0	0
16	10919019	.	G	A	2	8	10	0	0	10	0	0
16	10919104	.	A	G	3	1	4	0	2	6	0	0
16	10919317	.	C	T	0	2	2	0	3	5	0	0
16	10919482	.	C	A	3	3	6	0	2	9	1	0
16	10974586	.	T	C	4	4	8	0	0	8	0	0
16	10979967	.	C	G	2	1	3	0	4	7	0	0
16	10987970	.	A	C	1	4	5	0	1	6	0	0
16	10988366	.	T	C	2	2	4	0	1	5	0	0
16	10988476	.	A	G	4	6	10	0	1	11	0	0
16	10989372	.	T	C	3	2	5	0	0	5	0	0
16	10990319	.	A	G	2	4	6	0	0	6	0	0
16	10990445	.	T	A	9	4	13	0	0	13	0	0
16	10990578	.	A	T	5	3	8	0	1	9	0	0
16	10990633	.	A	G	7	3	10	0	0	10	0	0
16	10990781	.	A	C	3	4	7	0	0	7	0	0
16	10990915	.	T	A	5	7	12	0	0	12	0	0
16	10990940	.	C	A	10	7	17	0	1	18	0	0
16	11029931	.	G	C	7	5	12	0	0	12	0	0
16	11030141	.	C	A	3	3	6	0	0	6	0	0
16	11134774	.	T	G	3	6	9	0	0	9	0	0
16	11134959	.	G	C	4	6	10	0	0	10	0	0
16	11134962	.	T	C	4	6	10	0	0	10	0	0
16	11135511	.	C	T	7	5	12	0	0	12	0	0
16	11135814	.	T	C	7	4	11	0	0	11	0	0
16	11135820	.	G	A	6	4	10	0	1	11	0	0
16	11135904	.	G	A	7	6	13	0	1	14	0	0
16	11137612	.	C	A	7	3	10	0	0	10	0	0
16	11137720	.	G	A	9	6	15	0	1	16	0	0
16	11137738	.	T	C	9	4	13	0	1	14	0	0
16	11137873	.	T	C	7	4	11	0	0	11	0	0
16	11137912	.	A	G	7	0	7	0	7	14	0	0
16	11138021	.	C	T	11	13	24	0	0	24	0	0
16	11138081	.	C	T	8	5	13	0	1	14	0	0
16	11138648	.	A	G	5	5	10	0	1	11	0	0
16	11138963	.	A	G	5	6	11	0	0	11	0	0
16	11139022	.	C	T	4	3	7	0	0	7	0	0
16	11139031	.	A	C	3	2	5	0	0	5	0	0
16	11139076	.	T	A	3	3	6	0	0	6	0	0
16	11140004	.	G	A	8	7	15	0	0	15	0	0
16	11140122	.	G	A	1	5	6	0	9	15	0	0
16	11140151	.	T	C	12	7	19	1	1	21	0	0
16	11140248	.	T	C	9	4	13	0	1	14	0	0
16	11140569	.	A	G	3	6	9	0	2	11	0	0
16	11140643	.	A	C	4	2	6	0	0	6	0	0
16	11140798	.	A	G	9	0	9	0	2	11	0	0
16	11140820	.	G	C	7	4	11	1	0	12	0	0
16	11140894	.	A	G	4	8	12	0	1	13	0	0
16	11140933	.	A	T	4	5	9	0	0	9	0	0
16	11140993	.	A	G	3	4	7	0	0	7	0	0
16	11140994	.	A	G	3	4	7	0	0	7	0	0
16	11141200	.	C	T	9	8	17	0	0	17	0	0
16	11141325	.	A	G	5	4	9	0	0	9	0	0
16	11141338	.	C	T	1	4	5	0	0	5	0	0
16	11141776	.	C	G	10	6	16	0	0	16	0	0
16	11141836	.	G	A	12	10	22	0	0	22	0	0
16	11141908	.	G	A	1	5	6	0	9	15	0	0
16	11142032	.	A	T	9	5	14	0	0	14	0	0
16	11142428	.	A	G	7	8	15	0	1	16	0	0
16	11142451	.	A	C	6	6	12	0	0	12	0	0
16	11151789	.	G	C	0	2	2	0	1	3	0	0
16	11166806	.	C	T	8	5	13	0	2	15	0	0
16	11166851	.	G	A	11	10	21	0	1	22	0	0
16	11166857	.	A	T	13	12	25	0	0	25	0	0
16	11166908	.	G	A	14	7	21	0	0	21	0	0
16	11167260	.	C	T	8	6	14	0	1	15	0	0
16	11167436	.	G	A	8	9	17	0	1	18	0	0
16	11167461	.	G	A	8	12	20	0	0	20	0	0
16	11167512	.	A	G	4	0	4	0	10	14	0	0
16	11167586	.	T	G	5	5	10	0	1	11	0	0
16	11167908	.	T	C	6	6	12	0	1	13	0	0
16	11168205	.	A	G	11	8	19	0	0	19	0	0
16	11168817	.	A	C	7	11	18	0	3	21	0	0
16	11168831	.	T	C	8	14	22	0	0	22	0	0
16	11168922	.	T	A	6	8	14	0	0	14	0	0
16	11169325	.	C	A	15	9	24	0	0	24	0	0
16	11169438	.	C	A	11	10	21	0	0	21	0	0
16	11169447	.	A	G	14	10	24	0	0	24	0	0
16	11169843	.	T	A	13	9	22	0	1	23	0	0
16	11170152	.	C	G	15	7	22	0	2	24	0	0
16	11170202	.	C	T	12	8	20	0	1	21	0	0
16	11170334	.	C	T	11	9	20	0	3	23	0	0
16	11189286	.	A	G	16	0	16	0	16	32	0	0
16	11190369	.	G	A	1	18	19	0	14	33	0	0
16	11193643	.	A	G	16	23	39	0	3	42	0	0
16	11193652	.	A	G	20	0	20	0	19	39	0	0
16	11199190	.	A	G	19	0	19	0	21	40	0	0
16	11199293	.	T	C	26	22	48	0	0	48	0	0
16	11199460	.	G	A	2	11	13	0	29	42	0	0
16	11199533	.	C	T	32	26	58	0	0	58	0	0
16	11206313	.	A	C	28	20	48	0	1	49	0	0
16	11206316	.	C	T	25	22	47	0	2	49	0	0
16	11212111	.	C	A	21	28	49	0	3	52	0	0
16	11212260	.	C	A	18	20	38	0	4	42	0	0
16	11212438	.	A	G	25	0	25	0	21	46	0	0
16	11215022	.	G	T	17	17	34	0	2	36	0	0
16	11215162	.	T	C	20	11	31	0	1	32	0	0
16	11215163	.	T	C	21	9	30	0	2	32	0	0
16	11215504	.	C	T	29	19	48	0	2	50	0	0
16	11221153	.	A	C	21	17	38	0	0	39	1	0
16	11221667	.	A	G	15	19	34	0	0	34	0	0
16	11222031	.	T	A	21	7	28	1	0	29	0	0
16	11222139	.	G	A	19	12	31	0	0	31	0	0
16	11222738	.	G	A	1	15	16	0	16	32	0	0
16	11227526	.	T	G	4	6	10	0	0	10	0	0
16	11227537	.	G	A	4	6	10	0	0	10	0	0
16	11227611	.	G	A	6	6	12	0	0	12	0	0
16	11227865	.	C	T	6	2	8	0	0	8	0	0
16	11228358	.	C	A	0	5	5	0	5	10	0	0
16	11228751	.	G	A	2	6	8	0	0	8	0	0
16	11228826	.	G	A	4	3	7	0	0	7	0	0
16	11228848	.	G	C	3	3	6	0	0	6	0	0
16	11228978	.	G	A	5	2	7	0	0	7	0	0
16	11228979	.	G	A	5	2	7	0	0	7	0	0
16	11229095	.	A	G	5	3	8	0	0	8	0	0
16	11229330	.	T	C	3	4	7	0	0	7	0	0
16	11229499	.	C	T	2	3	5	0	0	5	0	0
16	11229594	.	T	C	1	3	4	0	0	4	0	0
16	11231048	.	C	T	1	2	3	0	0	3	0	0
16	11231420	.	A	G	2	3	5	0	0	5	0	0
16	11231621	.	T	A	3	5	8	0	1	10	1	0
16	11231644	.	C	A	4	8	12	0	0	12	0	0
16	11241078	.	A	G	6	2	8	0	1	9	0	0
16	11266016	.	T	G	21	15	36	0	0	36	0	0
16	11276019	.	A	T	17	21	38	0	0	38	0	0
16	11290903	.	T	A	9	11	20	0	1	21	0	0
16	11290975	.	A	C	17	9	26	0	0	26	0	0
16	11291799	.	T	C	22	17	39	2	3	44	0	0
16	11291803	.	G	A	23	16	39	2	0	41	0	0
16	11303426	.	G	A	0	4	4	0	1	5	0	0
16	11303432	.	A	G	0	4	4	0	1	5	0	0
16	11313379	.	C	T	1	2	3	0	1	4	0	0
16	11313462	.	A	G	3	2	5	0	0	5	0	0
16	11313588	.	T	C	2	3	5	0	0	5	0	0
16	11313612	.	C	T	1	4	5	0	0	5	0	0
16	11314144	.	A	G	2	4	6	0	0	6	0	0
16	11318376	.	G	A	0	4	4	0	7	11	0	0
16	11344446	.	G	A	0	4	4	0	3	7	0	0
16	11344457	.	T	C	4	6	10	0	1	11	0	0
16	11344556	.	C	T	3	3	6	0	0	6	0	0
16	11483951	.	C	T	6	5	11	0	0	11	0	0
16	11486258	.	G	A	1	5	6	0	5	11	0	0
16	11506075	.	C	T	5	2	7	0	0	7	0	0
16	11506128	.	G	A	0	6	6	0	9	15	0	0
16	11530746	.	T	G	10	8	18	0	1	19	0	0
16	11531018	.	A	G	6	12	18	0	0	18	0	0
16	11533864	.	T	C	5	12	17	0	0	17	0	0
16	11555088	.	G	C	3	1	4	0	17	21	0	0
16	11773932	.	T	C	6	1	7	0	11	18	0	0
16	11774345	.	G	A	11	7	18	0	0	18	0	0
16	11774355	.	C	T	0	9	9	0	9	18	0	0
16	11774398	.	T	C	11	8	19	0	0	19	0	0
16	11774456	.	G	A	12	5	17	0	0	17	0	0
16	11774519	.	T	C	11	4	15	0	0	15	0	0
16	11774948	.	T	A	9	9	18	0	3	21	0	0
16	11775084	.	G	T	12	7	19	0	0	22	3	0
16	11775200	.	A	G	6	17	23	0	0	23	0	0
16	11775279	.	T	C	7	15	22	0	1	23	0	0
16	11775485	.	G	A	12	5	17	2	0	19	0	0
16	11775683	.	T	C	15	21	36	0	0	36	0	0
16	11778275	.	C	T	2	11	13	0	9	22	0	0
16	11778542	.	A	G	5	5	10	0	1	11	0	0
16	11962904	.	G	A	1	3	4	0	0	4	0	0
16	11974658	.	G	A	15	17	32	0	2	34	0	0
16	11974703	.	G	A	9	20	29	0	1	30	0	0
16	11978028	.	A	G	18	17	35	0	0	35	0	0
16	11978045	.	G	A	19	20	39	0	2	41	0	0
16	11978094	.	A	C	19	24	43	0	0	43	0	0
16	11979590	.	T	C	8	10	18	0	0	18	0	0
16	11982269	.	G	A	14	16	30	1	0	31	0	0
16	11982323	.	G	A	20	15	35	0	0	35	0	0
16	11982507	.	T	A	17	15	32	0	0	32	0	0
16	11985606	.	C	T	11	17	28	0	2	30	0	0
16	12052487	.	T	C	2	2	4	0	0	4	0	0
16	12059574	.	C	T	1	2	3	0	3	6	0	0
16	12059576	.	C	A	1	2	3	0	3	6	0	0
16	12065410	.	A	G	9	13	22	1	2	25	0	0
16	12073577	.	G	A	7	7	14	0	0	14	0	0
16	12076492	.	A	G	6	14	20	0	0	20	0	0
16	12078916	.	A	G	13	9	22	0	1	23	0	0
16	12078976	.	C	T	13	4	17	0	2	19	0	0
16	12078982	.	C	T	11	7	18	0	1	19	0	0
16	12083632	.	A	G	1	3	4	0	0	4	0	0
16	12092428	.	A	G	11	10	21	0	0	21	0	0
16	12095043	.	G	A	4	5	9	0	1	10	0	0
16	12095103	.	T	C	11	7	18	0	0	18	0	0
16	12097241	.	T	C	11	4	15	0	1	16	0	0
16	12097292	.	G	T	10	8	18	0	1	19	0	0
16	12102947	.	C	A	29	27	56	0	0	56	0	0
16	12103263	.	A	T	36	26	62	0	0	62	0	0
16	12103292	.	A	T	40	22	62	0	0	62	0	0
16	12103344	.	A	G	36	24	60	0	1	61	0	0
16	12103421	.	T	A	26	29	55	0	3	58	0	0
16	12103530	.	G	A	28	29	57	0	2	59	0	0
16	12103873	.	C	T	6	35	41	0	27	68	0	0
16	12103881	.	G	A	31	35	66	0	1	67	0	0
16	12103934	.	C	T	31	30	61	0	5	66	0	0
16	12103941	.	A	G	31	31	62	0	2	64	0	0
16	12104042	.	C	T	23	31	54	0	4	58	0	0
16	12104043	.	A	T	23	33	56	0	2	58	0	0
16	12104083	.	C	T	31	31	62	3	2	67	0	0
16	12104231	.	C	G	27	24	51	1	1	53	0	0
16	12104350	.	T	C	26	28	54	1	4	59	0	0
16	12104384	.	C	T	24	30	54	3	2	59	0	0
16	12104388	.	T	C	24	29	53	3	4	60	0	0
16	12104509	.	G	A	40	22	62	2	1	65	0	0
16	12104601	.	G	A	26	33	59	0	2	61	0	0
16	12104665	.	A	G	29	22	51	5	2	58	0	0
16	12104794	.	C	T	24	16	40	2	3	45	0	0
16	12104813	.	A	T	35	16	51	1	6	58	0	0
16	12104943	.	A	T	45	9	54	0	0	54	0	0
16	12104944	.	T	G	41	9	50	0	4	54	0	0
16	12105032	.	G	A	26	8	34	0	1	35	0	0
16	12105196	.	C	A	27	12	39	0	2	41	0	0
16	12105206	.	A	G	30	18	48	0	1	49	0	0
16	12105265	.	T	A	37	13	50	0	2	52	0	0
16	12105443	.	A	T	8	7	15	1	0	16	0	0
16	12105644	.	A	C	24	37	61	0	0	61	0	0
16	12105645	.	C	T	23	37	60	0	0	60	0	0
16	12105689	.	C	T	3	30	33	0	20	53	0	0
16	12105796	.	C	T	4	43	47	0	21	68	0	0
16	12105854	.	A	G	31	27	58	0	3	61	0	0
16	12108607	.	G	A	33	34	67	0	3	70	0	0
16	12108622	.	A	G	32	37	69	0	3	72	0	0
16	12114975	.	G	A	30	33	63	0	5	68	0	0
16	12118207	.	G	A	33	19	52	0	2	54	0	0
16	12118210	.	C	T	37	19	56	0	1	57	0	0
16	12126930	.	C	G	2	20	22	0	25	47	0	0
16	12135754	.	G	A	21	20	41	0	3	44	0	0
16	12138940	.	A	G	33	22	55	0	1	56	0	0
16	12138964	.	G	T	30	25	55	0	2	57	0	0
16	12138991	.	T	C	24	0	24	0	30	54	0	0
16	12150403	.	A	G	14	24	38	0	1	39	0	0
16	12150415	.	T	C	13	3	16	0	26	42	0	0
16	12150457	.	A	G	15	28	43	0	1	44	0	0
16	12150460	.	C	T	15	29	44	0	2	46	0	0
16	12162370	.	A	C	18	1	19	0	20	39	0	0
16	12173361	.	G	C	26	19	45	0	1	46	0	0
16	12173406	.	A	G	25	17	42	0	2	44	0	0
16	12175281	.	G	A	5	8	13	0	0	13	0	0
16	12175377	.	T	C	2	6	8	0	0	8	0	0
16	12185322	.	C	A	1	2	3	0	0	3	0	0
16	12185382	.	A	G	2	5	7	0	0	7	0	0
16	12243571	.	C	T	31	24	55	0	4	59	0	0
16	12245691	.	G	A	32	33	65	0	0	65	0	0
16	12245760	.	T	C	37	28	65	0	2	67	0	0
16	12245954	.	C	T	31	37	68	0	2	70	0	0
16	12259023	.	T	C	20	21	41	0	2	43	0	0
16	12259072	.	C	T	16	23	39	0	0	39	0	0
16	12263047	.	C	T	3	24	27	0	21	48	0	0
16	12263223	.	A	G	24	23	47	0	1	48	0	0
16	12263358	.	C	T	3	28	31	0	30	61	0	0
16	12263385	.	G	A	22	17	39	0	4	43	0	0
16	12264912	.	A	T	28	22	50	0	0	50	0	0
16	12264999	.	T	C	18	1	19	0	25	44	0	0
16	12265237	.	A	G	20	16	36	0	3	39	0	0
16	12266130	.	C	A	1	10	11	0	15	26	0	0
16	12266137	.	A	T	11	8	19	0	2	21	0	0
16	12267706	.	C	G	5	4	9	1	0	10	0	0
16	12273636	.	G	A	3	23	26	0	31	57	0	0
16	12273653	.	A	G	36	22	58	0	0	58	0	0
16	12276065	.	A	T	19	8	27	0	2	29	0	0
16	12286460	.	A	T	7	10	17	0	1	18	0	0
16	12294273	.	G	A	6	3	9	0	1	10	0	0
16	12340701	.	T	C	3	0	3	0	5	8	0	0
16	12346071	.	G	A	3	2	5	0	1	6	0	0
16	12346516	.	A	C	2	0	2	0	3	5	0	0
16	12347591	.	A	G	3	3	6	0	1	7	0	0
16	12356458	.	G	A	3	3	6	0	1	7	0	0
16	12356494	.	T	C	2	2	4	0	0	4	0	0
16	12367100	.	A	G	2	2	4	0	0	4	0	0
16	12367103	.	G	A	2	2	4	0	0	4	0	0
16	12417822	.	G	A	3	3	6	0	0	6	0	0
16	12477920	.	G	T	1	2	3	0	0	3	0	0
16	12478239	.	C	T	1	1	2	0	1	3	0	0
16	12478240	.	C	T	1	2	3	0	0	3	0	0
16	12478727	.	G	A	5	3	8	0	0	8	0	0
16	12484658	.	A	C	2	2	4	0	0	4	0	0
16	12560246	.	C	T	5	2	7	0	0	7	0	0
16	12632593	.	G	C	4	6	10	0	0	10	0	0
16	12632664	.	T	C	4	11	15	0	1	17	1	0
16	12636347	.	T	C	5	10	15	0	2	17	0	0
16	12636546	.	T	C	13	12	25	0	0	25	0	0
16	12637271	.	G	A	8	4	12	0	1	13	0	0
16	12637284	.	T	C	7	5	12	0	0	12	0	0
16	12637552	.	A	T	5	8	13	0	0	13	0	0
16	12637779	.	C	T	10	8	18	0	0	18	0	0
16	12637822	.	T	C	10	10	20	0	1	21	0	0
16	12637824	.	G	A	1	10	11	0	10	21	0	0
16	12638030	.	A	C	3	3	6	0	1	7	0	0
16	12638062	.	A	G	3	3	6	0	1	7	0	0
16	12639125	.	A	T	10	3	13	0	0	14	1	0
16	12639184	.	C	G	8	7	15	1	0	16	0	0
16	12639285	.	T	A	4	9	13	0	3	16	0	0
16	12639291	.	C	T	6	11	17	0	0	17	0	0
16	12639320	.	C	G	8	5	13	0	1	14	0	0
16	12639488	.	G	A	3	8	11	0	0	11	0	0
16	12670085	.	G	A	2	2	4	0	0	4	0	0
16	12674720	.	A	G	2	4	6	0	0	6	0	0
16	12730380	.	A	G	12	12	24	0	1	25	0	0
16	12730412	.	G	A	22	18	40	0	2	42	0	0
16	12730707	.	A	G	9	7	16	0	2	18	0	0
16	12738324	.	G	A	10	13	23	0	0	23	0	0
16	12743927	.	G	A	0	10	10	0	13	23	0	0
16	12744138	.	A	G	5	2	7	0	0	7	0	0
16	12744164	.	A	G	5	2	7	0	0	7	0	0
16	12744256	.	T	C	1	3	4	0	0	4	0	0
16	12744270	.	T	C	1	2	3	0	0	3	0	0
16	12748058	.	A	G	4	1	5	0	30	35	0	0
16	12748568	.	T	C	14	14	28	0	1	29	0	0
16	12748944	.	A	G	21	8	29	0	3	32	0	0
16	12754621	.	A	G	22	3	25	0	21	46	0	0
16	12754849	.	T	C	21	22	43	0	2	45	0	0
16	12754858	.	G	T	4	15	19	0	20	39	0	0
16	12755011	.	G	A	19	14	33	0	2	35	0	0
16	12756051	.	G	T	16	17	33	0	0	33	0	0
16	12764143	.	T	A	2	2	4	0	0	4	0	0
16	12764221	.	G	A	2	3	5	0	0	5	0	0
16	12772927	.	T	C	1	2	3	0	0	3	0	0
16	12773492	.	G	A	1	2	3	0	1	4	0	0
16	12794028	.	A	G	5	2	7	0	0	7	0	0
16	12794075	.	C	G	5	6	11	0	0	11	0	0
16	12807129	.	C	G	7	5	12	0	0	12	0	0
16	12812496	.	T	C	9	5	14	0	0	14	0	0
16	12816160	.	A	G	13	8	21	0	1	22	0	0
16	12816745	.	A	C	15	10	25	0	1	26	0	0
16	12816975	.	G	A	9	6	15	0	2	17	0	0
16	12821106	.	C	T	22	20	42	0	0	42	0	0
16	12821221	.	G	A	18	24	42	0	1	43	0	0
16	12821370	.	A	T	14	9	23	0	0	23	0	0
16	12821371	.	G	A	14	9	23	0	0	23	0	0
16	12821497	.	T	C	26	13	39	0	0	39	0	0
16	12821620	.	T	C	10	5	15	0	0	15	0	0
16	12882543	.	A	G	15	18	33	0	3	36	0	0
16	12882612	.	C	T	3	20	23	0	16	39	0	0
16	12883126	.	G	A	19	17	36	0	2	38	0	0
16	12883484	.	G	C	11	9	20	0	2	22	0	0
16	12883618	.	C	T	15	14	29	0	1	30	0	0
16	12884054	.	A	T	19	15	34	0	1	35	0	0
16	12884510	.	A	T	14	20	34	0	0	34	0	0
16	12963061	.	T	C	2	1	3	0	2	5	0	0
16	12963109	.	A	G	5	4	9	0	0	9	0	0
16	12963274	.	A	T	10	3	13	0	2	15	0	0
16	12963368	.	G	A	16	8	24	0	0	24	0	0
16	12963384	.	C	T	0	9	9	0	18	27	0	0
16	12963405	.	A	G	19	10	29	0	2	31	0	0
16	12963696	.	T	G	28	15	43	0	3	46	0	0
16	12967855	.	G	A	15	19	34	0	0	34	0	0
16	12981637	.	G	A	16	8	24	0	1	25	0	0
16	12984488	.	C	G	12	14	26	0	1	27	0	0
16	13023601	.	A	G	8	8	16	0	1	17	0	0
16	13033243	.	G	A	4	4	8	0	1	9	0	0
16	13109726	.	T	C	7	3	10	0	1	11	0	0
16	13180298	.	T	C	2	6	8	0	0	8	0	0
16	13194780	.	C	G	2	2	4	0	0	4	0	0
16	13242711	.	G	A	1	2	3	0	0	3	0	0
16	13281423	.	A	C	2	3	5	0	0	5	0	0
16	13307711	.	G	A	4	3	7	0	1	8	0	0
16	13453329	.	T	A	1	2	3	0	0	3	0	0
16	13599957	.	G	A	8	11	19	0	0	19	0	0
16	13600680	.	A	C	12	16	28	0	2	30	0	0
16	13601026	.	T	C	12	13	25	0	1	26	0	0
16	13601254	.	G	C	5	7	12	0	0	12	0	0
16	13601907	.	A	C	6	6	12	0	0	12	0	0
16	13602164	.	T	C	8	12	20	0	1	21	0	0
16	13602454	.	T	A	12	15	27	0	0	27	0	0
16	13602488	.	T	C	10	11	21	0	0	21	0	0
16	13602697	.	A	G	15	13	28	0	0	28	0	0
16	13602800	.	T	A	13	11	24	0	1	25	0	0
16	13602922	.	A	G	7	5	12	0	1	13	0	0
16	13603375	.	C	T	7	12	19	0	0	19	0	0
16	13606896	.	A	T	11	5	16	0	0	16	0	0
16	13606977	.	G	A	14	13	27	0	0	27	0	0
16	13610726	.	T	A	26	21	47	0	7	54	0	0
16	13610882	.	G	A	18	20	38	0	1	39	0	0
16	13610966	.	A	G	22	7	29	0	0	29	0	0
16	13611035	.	G	A	19	11	30	0	1	31	0	0
16	13612999	.	T	A	12	15	27	0	0	27	0	0
16	13613104	.	T	C	11	11	22	0	0	22	0	0
16	13616338	.	G	A	1	2	3	0	0	3	0	0
16	13617023	.	C	T	1	10	11	0	8	19	0	0
16	13617152	.	C	T	7	11	18	0	0	18	0	0
16	13617291	.	G	A	6	9	15	0	0	16	1	0
16	13617329	.	T	G	4	9	13	0	2	15	0	0
16	13618170	.	A	G	13	4	17	1	1	19	0	0
16	13618172	.	C	G	5	13	18	1	0	19	0	0
16	13618374	.	A	T	17	15	32	0	0	32	0	0
16	13618644	.	T	A	17	8	25	0	2	27	0	0
16	13619001	.	A	C	12	11	23	0	0	23	0	0
16	13619436	.	A	G	12	7	19	0	0	19	0	0
16	13619448	.	T	C	11	6	17	0	0	17	0	0
16	13619509	.	G	T	10	9	19	0	1	20	0	0
16	13620333	.	C	T	5	10	15	0	0	15	0	0
16	13621056	.	G	A	6	5	11	0	1	12	0	0
16	13621605	.	A	G	7	11	18	0	4	22	0	0
16	13621752	.	G	A	5	7	12	0	0	12	0	0
16	13622624	.	G	C	4	2	6	0	0	6	0	0
16	13622643	.	A	T	3	3	6	0	0	7	1	0
16	13623641	.	A	C	5	3	8	0	0	8	0	0
16	13636760	.	G	A	34	26	60	0	2	62	0	0
16	13643969	.	C	A	12	28	40	0	1	41	0	0
16	13644509	.	A	T	17	20	37	0	1	38	0	0
16	13644781	.	T	A	12	13	25	0	1	26	0	0
16	13645076	.	A	T	19	11	30	0	1	31	0	0
16	13645242	.	G	C	16	13	29	0	1	30	0	0
16	13645318	.	T	G	16	15	31	0	1	32	0	0
16	13645419	.	T	A	12	12	24	0	0	25	1	0
16	13645610	.	T	C	15	1	16	3	16	35	0	0
16	13673143	.	T	C	4	7	11	0	1	12	0	0
16	13673734	.	A	C	7	4	11	0	0	11	0	0
16	13679037	.	A	G	5	2	7	0	0	7	0	0
16	13680289	.	T	C	2	0	2	0	2	4	0	0
16	13680357	.	T	G	2	3	5	0	0	5	0	0
16	13680487	.	T	G	2	5	7	0	0	7	0	0
16	13680585	.	A	G	6	4	10	0	0	10	0	0
16	13701482	.	C	T	12	8	20	0	0	20	0	0
16	13701599	.	A	G	5	8	13	0	1	14	0	0
16	13706061	.	G	A	9	12	21	0	0	21	0	0
16	13706207	.	G	C	13	10	23	0	0	23	0	0
16	13721408	.	C	T	19	5	24	0	0	24	0	0
16	13721420	.	G	A	6	13	19	0	0	19	0	0
16	13729810	.	C	T	14	14	28	0	1	29	0	0
16	13741584	.	C	T	16	14	30	0	1	31	0	0
16	13743117	.	T	C	14	0	14	1	13	28	0	0
16	13743198	.	G	T	15	14	29	0	4	33	0	0
16	13743327	.	C	T	0	20	20	0	13	33	0	0
16	13743345	.	T	C	10	15	25	0	2	27	0	0
16	13743405	.	G	T	20	11	31	0	1	32	0	0
16	13780375	.	G	A	20	14	34	0	2	36	0	0
16	13780415	.	T	A	17	17	34	0	3	37	0	0
16	13789765	.	G	A	16	17	33	0	1	34	0	0
16	13810372	.	G	A	2	2	4	0	0	4	0	0
16	13810843	.	A	T	1	2	3	0	0	3	0	0
16	13810958	.	G	C	1	2	3	0	0	3	0	0
16	13818640	.	T	A	12	2	14	0	1	15	0	0
16	13818644	.	G	A	12	2	14	0	0	14	0	0
16	13826195	.	C	T	11	11	22	0	1	23	0	0
16	13841360	.	T	A	6	13	19	0	0	19	0	0
16	13845368	.	G	A	3	10	13	0	15	28	0	0
16	13845846	.	A	G	3	7	10	0	1	11	0	0
16	13855142	.	T	C	14	10	24	0	1	25	0	0
16	13855472	.	T	C	9	16	25	0	0	25	0	0
16	13855482	.	T	A	15	9	24	0	0	24	0	0
16	13868186	.	T	C	7	2	9	0	1	10	0	0
16	13870508	.	A	C	8	7	15	0	0	15	0	0
16	13870517	.	A	G	7	8	15	0	0	15	0	0
16	13870685	.	A	C	5	6	11	0	0	11	0	0
16	13870857	.	T	A	2	4	6	0	0	6	0	0
16	13875968	.	G	A	1	2	3	0	0	3	0	0
16	13876564	.	C	T	0	2	2	0	1	3	0	0
16	13876917	.	T	C	2	2	4	0	0	4	0	0
16	13883968	.	C	A	9	7	16	0	0	16	0	0
16	13883980	.	A	C	13	9	22	0	0	22	0	0
16	14010794	.	C	T	4	4	8	0	0	8	0	0
16	14016057	.	T	C	10	4	14	0	0	14	0	0
16	14021817	.	G	T	10	7	17	0	0	17	0	0
16	14021886	.	C	T	14	12	26	0	1	27	0	0
16	14021907	.	T	A	12	15	27	0	1	28	0	0
16	14022035	.	A	C	10	14	24	0	0	24	0	0
16	14022445	.	T	C	9	13	22	0	0	22	0	0
16	14022585	.	C	A	9	10	19	0	0	19	0	0
16	14022697	.	T	A	4	6	10	0	1	11	0	0
16	14029359	.	A	C	17	16	33	0	0	33	0	0
16	14039604	.	T	C	7	11	18	0	3	21	0	0
16	14039616	.	A	C	8	15	23	0	0	23	0	0
16	14051150	.	G	C	19	24	43	0	0	43	0	0
16	14051249	.	T	C	20	27	47	0	0	47	0	0
16	14051329	.	A	T	27	17	44	0	1	45	0	0
16	14051339	.	A	C	31	16	47	0	3	50	0	0
16	14052681	.	A	G	26	24	50	0	1	51	0	0
16	14055071	.	A	T	8	8	16	0	0	16	0	0
16	14094219	.	A	G	2	2	4	0	1	5	0	0
16	14094222	.	C	A	2	1	3	0	1	4	0	0
16	14094364	.	A	C	4	5	9	0	0	9	0	0
16	14094422	.	C	G	12	10	22	0	2	24	0	0
16	14094601	.	G	A	13	15	28	0	0	28	0	0
16	14094604	.	T	A	11	13	24	0	0	24	0	0
16	14094640	.	G	T	14	8	22	0	0	22	0	0
16	14094668	.	T	A	11	10	21	0	0	21	0	0
16	14094801	.	C	T	7	7	14	0	1	15	0	0
16	14094806	.	G	A	9	8	17	0	0	17	0	0
16	14095126	.	T	A	7	4	11	0	0	11	0	0
16	14095176	.	A	T	11	10	21	0	1	22	0	0
16	14095183	.	G	C	12	9	21	0	1	22	0	0
16	14095279	.	C	A	11	12	23	0	1	24	0	0
16	14095397	.	A	C	18	12	30	0	1	31	0	0
16	14095563	.	A	C	14	0	14	0	13	27	0	0
16	14098014	.	C	T	12	11	23	0	0	23	0	0
16	14101832	.	G	A	6	9	15	0	1	16	0	0
16	14101864	.	T	C	14	13	27	0	1	28	0	0
16	14126267	.	C	T	13	11	24	0	1	25	0	0
16	14126294	.	T	C	14	15	29	0	5	34	0	0
16	14133317	.	G	A	8	11	19	0	1	20	0	0
16	14133521	.	G	A	16	19	35	0	0	35	0	0
16	14133547	.	G	T	14	15	29	0	1	30	0	0
16	14133721	.	C	T	9	7	16	2	1	19	0	0
16	14133734	.	A	C	13	7	20	2	1	23	0	0
16	14133874	.	C	T	11	3	14	0	1	15	0	0
16	14133910	.	C	G	10	9	19	0	0	19	0	0
16	14134020	.	C	T	0	7	7	0	10	17	0	0
16	14134116	.	A	T	12	16	28	0	1	29	0	0
16	14154105	.	A	G	13	9	22	0	0	22	0	0
16	14154150	.	T	G	17	11	28	0	1	29	0	0
16	14154240	.	T	A	7	9	16	0	1	17	0	0
16	14154324	.	T	C	15	1	16	0	11	27	0	0
16	14154708	.	G	A	11	12	23	0	0	23	0	0
16	14155364	.	T	C	7	11	18	0	0	18	0	0
16	14155605	.	T	A	10	12	22	0	0	22	0	0
16	14155997	.	A	T	11	5	16	0	1	17	0	0
16	14156157	.	T	C	7	9	16	0	0	16	0	0
16	14156177	.	G	A	9	6	15	0	1	16	0	0
16	14156775	.	C	A	3	6	9	0	10	19	0	0
16	14156865	.	A	G	6	3	9	0	0	9	0	0
16	14157055	.	C	T	7	10	17	0	0	17	0	0
16	14157112	.	C	T	10	7	17	0	0	17	0	0
16	14157316	.	A	G	10	11	21	0	0	21	0	0
16	14157390	.	G	A	11	7	18	0	1	19	0	0
16	14157447	.	T	A	11	11	22	0	0	22	0	0
16	14157448	.	A	T	11	11	22	0	0	22	0	0
16	14158490	.	G	A	4	4	8	0	0	8	0	0
16	14158619	.	G	A	7	9	16	0	2	18	0	0
16	14158655	.	T	C	5	12	17	0	0	17	0	0
16	14158666	.	T	G	6	10	16	0	0	16	0	0
16	14167362	.	A	G	6	5	11	0	0	11	0	0
16	14167383	.	A	G	7	6	13	0	0	13	0	0
16	14167480	.	T	C	6	5	11	0	0	11	0	0
16	14202192	.	A	C	18	7	25	0	0	25	0	0
16	14202197	.	T	A	17	5	22	0	2	24	0	0
16	14206289	.	G	A	7	5	12	0	0	12	0	0
16	14209195	.	G	A	10	9	19	0	1	20	0	0
16	14209348	.	T	C	9	17	26	0	0	26	0	0
16	14210949	.	A	C	12	6	18	0	1	19	0	0
16	14212079	.	G	C	2	7	9	0	14	23	0	0
16	14214534	.	G	A	3	3	6	0	0	6	0	0
16	14214543	.	A	G	3	4	7	0	0	7	0	0
16	14214643	.	A	T	5	3	8	0	3	12	1	0
16	14215565	.	C	G	2	2	4	0	0	4	0	0
16	14216708	.	T	A	3	2	5	0	0	5	0	0
16	14216726	.	A	G	2	4	6	0	0	6	0	0
16	14216766	.	G	A	0	4	4	0	2	6	0	0
16	14216944	.	A	G	1	2	3	0	0	3	0	0
16	14220429	.	T	C	5	5	10	0	0	10	0	0
16	14223252	.	C	T	5	5	10	0	0	10	0	0
16	14224041	.	T	G	2	9	11	0	0	11	0	0
16	14226046	.	G	A	0	5	5	0	10	15	0	0
16	14227913	.	C	T	11	8	19	0	0	19	0	0
16	14228668	.	A	G	3	8	11	0	0	11	0	0
16	14229614	.	A	G	2	8	10	0	0	10	0	0
16	14230373	.	T	C	6	6	12	0	1	13	0	0
16	14231135	.	G	A	0	7	7	0	7	14	0	0
16	14231138	.	C	T	7	5	12	0	2	14	0	0
16	14231207	.	T	A	4	4	8	0	0	8	0	0
16	14231730	.	G	A	9	13	22	0	0	22	0	0
16	14242688	.	C	T	3	14	17	0	13	30	0	0
16	14255899	.	G	T	1	2	3	0	0	3	0	0
16	14266152	.	G	A	3	4	7	0	0	7	0	0
16	14266614	.	A	G	2	0	2	0	5	7	0	0
16	14269885	.	G	A	3	3	6	0	1	7	0	0
16	14269906	.	G	A	4	4	8	0	1	9	0	0
16	14278173	.	C	T	2	3	5	0	1	6	0	0
16	14280312	.	C	A	1	4	5	0	0	5	0	0
16	14416520	.	C	T	4	3	7	0	0	7	0	0
16	14416599	.	C	T	9	5	14	0	0	14	0	0
16	14416622	.	C	T	9	4	13	0	0	13	0	0
16	14588390	.	T	C	5	5	10	0	0	10	0	0
16	14588430	.	A	G	3	5	8	0	0	8	0	0
16	14597927	.	A	C	5	6	11	0	0	11	0	0
16	14602380	.	C	G	5	6	11	0	0	11	0	0
16	14627207	.	T	C	3	3	6	0	0	6	0	0
16	14627294	.	G	A	5	12	17	0	0	17	0	0
16	14638413	.	G	A	4	4	8	0	0	8	0	0
16	14638476	.	C	T	5	6	11	0	0	11	0	0
16	14670907	.	G	T	4	3	7	0	0	7	0	0
16	14670990	.	A	G	6	0	6	0	6	12	0	0
16	14671098	.	A	T	3	3	6	0	0	6	0	0
16	14671099	.	A	T	3	3	6	0	0	6	0	0
16	14671249	.	T	G	3	0	3	0	5	8	0	0
16	14674718	.	T	G	5	7	12	0	0	12	0	0
16	14674855	.	A	G	2	5	7	0	1	8	0	0
16	14674924	.	A	G	11	2	13	0	0	13	0	0
16	14674930	.	A	G	9	2	11	0	1	12	0	0
16	14675101	.	T	A	5	7	12	0	0	12	0	0
16	14675175	.	C	T	5	2	7	0	1	8	0	0
16	14675373	.	A	C	6	12	18	0	0	18	0	0
16	14675413	.	G	T	1	5	6	0	4	10	0	0
16	14675513	.	A	C	3	3	6	0	0	6	0	0
16	14675572	.	G	A	4	12	16	0	0	16	0	0
16	14675658	.	A	G	10	8	18	0	0	18	0	0
16	14675697	.	A	T	5	10	15	0	1	16	0	0
16	14675780	.	A	G	9	5	14	0	2	16	0	0
16	14710495	.	T	A	2	3	5	0	0	5	0	0
16	14800360	.	A	G	1	0	1	0	12	13	0	0
16	14801567	.	A	G	6	0	6	0	4	10	0	0
16	14801624	.	C	T	3	3	6	0	0	6	0	0
16	14809414	.	G	A	0	10	10	0	2	12	0	0
16	14817095	.	G	A	1	7	8	0	1	9	0	0
16	14865602	.	G	T	2	7	9	0	0	9	0	0
16	14901812	.	C	T	8	9	17	0	1	18	0	0
16	14903581	.	A	C	1	3	4	0	2	6	0	0
16	14908763	.	A	G	3	4	7	0	0	7	0	0
16	14908825	.	C	T	2	2	4	0	0	4	0	0
16	14933154	.	A	G	6	0	6	0	3	9	0	0
16	14973968	.	A	T	4	9	13	0	0	13	0	0
16	14973989	.	A	T	3	10	13	0	0	13	0	0
16	15031839	.	C	T	5	3	8	0	1	9	0	0
16	15034906	.	C	T	10	8	18	0	1	19	0	0
16	15048338	.	G	A	0	6	6	0	13	19	0	0
16	15048561	.	G	T	9	11	20	0	2	22	0	0
16	15050113	.	G	A	0	3	3	0	6	9	0	0
16	15050195	.	T	C	7	5	12	0	1	13	0	0
16	15050367	.	C	A	12	12	24	0	3	27	0	0
16	15114963	.	G	T	1	5	6	0	0	6	0	0
16	15117614	.	A	G	4	3	7	0	0	7	0	0
16	15126319	.	G	T	0	3	3	0	2	5	0	0
16	15140987	.	G	A	0	3	3	0	2	5	0	0
16	15165153	.	A	G	1	2	3	0	0	3	0	0
16	15262854	.	G	T	1	7	8	0	0	8	0	0
16	15262870	.	G	A	1	4	5	0	1	6	0	0
16	15943424	.	C	T	5	11	16	0	1	17	0	0
16	15956855	.	C	A	10	7	17	0	0	17	0	0
16	15958358	.	T	C	10	6	16	0	0	16	0	0
16	15958715	.	T	C	10	0	10	0	10	20	0	0
16	16042986	.	T	C	10	21	31	0	1	32	0	0
16	16078951	.	A	G	10	10	20	0	0	20	0	0
16	16081095	.	C	G	0	4	4	0	3	7	0	0
16	16081104	.	T	A	3	6	9	0	0	9	0	0
16	16165179	.	T	A	29	27	56	0	0	56	0	0
16	16165361	.	A	G	42	34	76	0	1	77	0	0
16	16165418	.	C	T	39	26	65	0	1	66	0	0
16	16165725	.	A	C	40	37	77	0	2	79	0	0
16	16212520	.	A	G	14	7	21	0	1	22	0	0
16	16212579	.	G	A	3	4	7	0	0	7	0	0
16	16232963	.	T	C	2	4	6	0	0	6	0	0
16	16233007	.	A	T	1	2	3	0	1	4	0	0
16	16233410	.	A	G	7	9	16	0	0	16	0	0
16	16234309	.	C	A	0	5	5	0	8	13	0	0
16	16234840	.	A	T	14	10	24	0	0	24	0	0
16	16253948	.	T	A	2	6	8	0	0	8	0	0
16	16265158	.	A	G	3	3	6	0	0	6	0	0
16	16266437	.	A	G	1	3	4	0	0	4	0	0
16	16266645	.	A	G	6	6	12	0	0	12	0	0
16	16266653	.	A	T	7	6	13	0	0	13	0	0
16	16266774	.	A	G	4	3	7	0	1	8	0	0
16	16266809	.	A	G	3	3	6	0	0	6	0	0
16	16266844	.	C	T	3	5	8	0	0	8	0	0
16	16267013	.	T	A	5	3	8	0	0	8	0	0
16	16267033	.	C	G	5	3	8	0	0	8	0	0
16	16267067	.	G	T	1	2	3	0	1	4	0	0
16	16267073	.	A	G	2	2	4	0	0	4	0	0
16	16267189	.	A	G	5	3	8	0	0	8	0	0
16	16267267	.	G	A	3	5	8	0	1	9	0	0
16	16267355	.	T	C	10	3	13	0	0	13	0	0
16	16267602	.	A	T	2	1	3	0	1	4	0	0
16	16267631	.	G	A	2	5	7	0	1	8	0	0
16	16267673	.	C	T	7	7	14	0	1	15	0	0
16	16267814	.	C	G	8	6	14	0	0	14	0	0
16	16267823	.	T	C	7	4	11	0	1	12	0	0
16	16268205	.	A	T	4	2	6	0	0	6	0	0
16	16268208	.	G	A	0	2	2	0	4	6	0	0
16	16268263	.	A	G	2	2	4	0	0	4	0	0
16	16268284	.	C	T	1	3	4	0	0	4	0	0
16	16268590	.	C	T	6	2	8	0	1	9	0	0
16	16269089	.	A	G	2	3	5	0	0	5	0	0
16	16269118	.	C	T	3	2	5	0	0	5	0	0
16	16269285	.	G	A	4	4	8	0	0	8	0	0
16	16269371	.	C	T	4	5	9	0	0	9	0	0
16	16269383	.	G	A	0	5	5	0	4	9	0	0
16	16269502	.	C	T	4	7	11	0	0	11	0	0
16	16269508	.	C	T	6	3	9	0	0	9	0	0
16	16269593	.	G	C	8	5	13	0	0	13	0	0
16	16269690	.	G	A	2	7	9	0	9	18	0	0
16	16269724	.	G	A	7	8	15	0	0	15	0	0
16	16269926	.	G	C	10	7	17	0	1	18	0	0
16	16269964	.	T	C	10	7	17	0	0	17	0	0
16	16270163	.	C	A	6	7	13	0	0	13	0	0
16	16270326	.	G	A	1	6	7	0	0	7	0	0
16	16270358	.	A	G	2	7	9	0	0	9	0	0
16	16270361	.	T	C	2	7	9	0	0	9	0	0
16	16270424	.	T	C	4	5	9	0	0	9	0	0
16	16270448	.	T	G	6	0	6	0	5	11	0	0
16	16271683	.	G	A	4	5	9	0	1	10	0	0
16	16271695	.	A	G	4	7	11	0	0	11	0	0
16	16275288	.	T	C	6	6	12	0	0	12	0	0
16	16276938	.	T	C	8	6	14	0	0	14	0	0
16	16277689	.	A	G	9	5	14	0	1	15	0	0
16	16277728	.	G	A	8	8	16	0	3	19	0	0
16	16278013	.	A	T	4	2	6	0	0	6	0	0
16	16278043	.	T	C	5	2	7	0	1	8	0	0
16	16278172	.	G	T	0	8	8	0	7	15	0	0
16	16278356	.	C	A	7	6	13	0	0	13	0	0
16	16278447	.	C	T	6	2	8	0	1	9	0	0
16	16278755	.	G	C	5	7	12	0	0	12	0	0
16	16278756	.	C	A	4	7	11	0	1	12	0	0
16	16281479	.	A	C	7	9	16	0	0	16	0	0
16	16281740	.	A	C	6	4	10	0	3	13	0	0
16	16281869	.	T	A	11	9	20	0	1	21	0	0
16	16283643	.	G	A	26	0	26	0	2	28	0	0
16	16283667	.	A	G	18	0	18	2	7	27	0	0
16	16283706	.	A	G	5	9	14	8	5	27	0	0
16	16284057	.	T	C	9	9	18	0	1	19	0	0
16	16284159	.	G	A	0	13	13	0	17	30	0	0
16	16284192	.	C	A	22	12	34	0	0	34	0	0
16	16289121	.	C	T	18	18	36	0	2	38	0	0
16	16297057	.	G	A	15	13	28	0	0	28	0	0
16	16302166	.	T	C	12	12	24	0	0	24	0	0
16	16302247	.	A	T	13	10	23	0	1	24	0	0
16	16302371	.	A	C	10	5	15	0	1	16	0	0
16	16302426	.	T	A	9	10	19	0	0	19	0	0
16	16302477	.	G	A	0	12	12	0	8	20	0	0
16	16302835	.	T	C	10	10	20	0	0	20	0	0
16	16303025	.	C	T	17	12	29	0	2	31	0	0
16	16303065	.	A	G	13	11	24	0	0	24	0	0
16	16303086	.	T	A	7	9	16	0	4	20	0	0
16	16303163	.	G	A	0	10	10	0	8	18	0	0
16	16303196	.	A	G	6	1	7	0	13	20	0	0
16	16303293	.	T	G	11	8	19	1	1	21	0	0
16	16547388	.	C	T	11	8	19	0	0	19	0	0
16	16555611	.	A	G	13	11	24	0	1	25	0	0
16	16555975	.	T	A	6	6	12	0	2	14	0	0
16	16565963	.	G	C	9	14	23	0	0	23	0	0
16	16565998	.	C	T	11	12	23	0	1	24	0	0
16	16566182	.	T	C	15	11	26	0	1	27	0	0
16	16566402	.	G	A	8	7	15	0	0	15	0	0
16	16569047	.	G	A	12	11	23	0	0	23	0	0
16	16569578	.	C	G	8	11	19	0	1	20	0	0
16	16574168	.	T	C	8	11	19	0	0	19	0	0
16	16574337	.	A	C	12	14	26	0	0	26	0	0
16	16586232	.	C	T	12	13	25	0	5	30	0	0
16	16586290	.	G	A	17	15	32	0	0	32	0	0
16	16589462	.	G	A	14	5	19	0	0	19	0	0
16	16589552	.	G	A	10	4	14	0	1	15	0	0
16	16590715	.	T	C	10	7	17	0	1	18	0	0
16	16597863	.	A	G	4	0	4	0	0	4	0	0
16	16598232	.	C	T	0	3	3	0	3	6	0	0
16	16598430	.	C	T	2	3	5	0	1	6	0	0
16	16603081	.	C	A	6	5	11	0	0	11	0	0
16	16603651	.	T	A	6	3	9	0	0	9	0	0
16	16849326	.	C	T	6	6	12	0	0	12	0	0
16	16849374	.	G	C	9	8	17	0	0	17	0	0
16	16849404	.	T	A	4	2	6	0	0	6	0	0
16	16877130	.	G	T	3	3	6	0	0	6	0	0
16	16887296	.	G	A	0	4	4	0	4	8	0	0
16	16887359	.	C	T	2	6	8	0	1	9	0	0
16	16887371	.	T	C	3	5	8	0	1	9	0	0
16	16891831	.	T	C	6	2	8	0	0	8	0	0
16	16906094	.	A	G	2	4	6	0	0	6	0	0
16	16906124	.	G	A	2	6	8	0	0	8	0	0
16	16908487	.	C	T	8	9	17	0	0	17	0	0
16	16908586	.	G	A	6	7	13	0	0	13	0	0
16	16912252	.	T	G	6	11	17	0	0	17	0	0
16	16913102	.	G	A	9	9	18	0	1	19	0	0
16	16914234	.	A	G	4	7	11	0	1	12	0	0
16	16916699	.	G	A	12	4	16	0	0	16	0	0
16	16916893	.	C	T	10	11	21	0	0	21	0	0
16	16916955	.	A	G	7	1	8	0	7	15	0	0
16	16920457	.	A	G	4	8	12	0	2	14	0	0
16	16920823	.	G	A	3	8	11	0	1	12	0	0
16	16921134	.	G	A	10	10	20	0	0	20	0	0
16	16923651	.	A	G	6	5	11	0	1	12	0	0
16	16939663	.	G	T	1	2	3	0	1	4	0	0
16	16940732	.	A	G	5	3	8	0	0	8	0	0
16	16940768	.	A	G	7	1	8	0	4	12	0	0
16	16941121	.	G	A	2	7	9	0	4	13	0	0
16	16941237	.	G	A	0	10	10	0	13	23	0	0
16	16941270	.	G	A	1	13	14	0	13	27	0	0
16	16941343	.	G	A	14	8	22	0	1	23	0	0
16	16941361	.	T	C	10	9	19	0	1	20	0	0
16	16941394	.	C	T	9	9	18	0	0	18	0	0
16	16941741	.	C	T	7	9	16	0	0	16	0	0
16	16941927	.	A	G	10	0	10	0	9	19	0	0
16	16941979	.	C	A	4	9	13	0	0	13	0	0
16	16942001	.	G	A	0	9	9	0	5	14	0	0
16	16942097	.	C	T	4	4	8	0	0	8	0	0
16	16942130	.	C	A	4	7	11	0	1	12	0	0
16	16942200	.	C	T	11	12	23	0	0	23	0	0
16	16942293	.	T	A	7	8	15	0	0	15	0	0
16	16942332	.	G	A	11	8	19	0	0	19	0	0
16	16942867	.	A	G	14	17	31	0	3	34	0	0
16	16942906	.	C	G	17	14	31	2	3	36	0	0
16	16942953	.	A	G	14	8	22	2	1	25	0	0
16	16943258	.	C	A	7	11	18	0	0	18	0	0
16	16943348	.	C	A	17	11	28	0	0	28	0	0
16	16943388	.	T	A	7	11	18	0	0	18	0	0
16	16943651	.	A	T	11	13	24	0	0	24	0	0
16	16944023	.	G	T	14	11	25	0	0	25	0	0
16	16944066	.	T	C	13	9	22	0	2	24	0	0
16	16944142	.	A	T	7	9	16	0	1	17	0	0
16	16944150	.	T	C	8	8	16	0	0	16	0	0
16	16944884	.	A	G	7	4	11	0	0	11	0	0
16	16945261	.	A	G	4	6	10	0	0	10	0	0
16	16945328	.	G	A	2	6	8	0	0	8	0	0
16	16945365	.	T	G	6	6	12	0	0	12	0	0
16	17066745	.	C	T	0	2	2	0	5	7	0	0
16	17120136	.	C	T	15	9	24	0	3	27	0	0
16	17136980	.	T	G	11	7	18	0	1	19	0	0
16	17137031	.	A	G	12	6	18	0	0	18	0	0
16	17151833	.	C	T	5	7	12	0	0	12	0	0
16	17151836	.	A	T	5	6	11	0	1	12	0	0
16	17161709	.	T	A	9	10	19	0	0	19	0	0
16	17161739	.	G	A	11	12	23	0	0	23	0	0
16	17161877	.	A	G	15	14	29	0	0	29	0	0
16	17162411	.	A	C	12	15	27	0	0	27	0	0
16	17235486	.	A	G	1	2	3	0	0	3	0	0
16	17235677	.	C	T	4	4	8	0	0	8	0	0
16	17235730	.	A	G	5	3	8	0	0	8	0	0
16	17238475	.	T	A	8	3	11	0	0	11	0	0
16	17238490	.	A	G	10	4	14	0	0	14	0	0
16	17238757	.	A	T	6	3	9	0	0	9	0	0
16	17240732	.	A	G	1	2	3	0	0	3	0	0
16	17240733	.	T	C	1	2	3	0	0	3	0	0
16	17247089	.	A	G	3	5	8	0	0	8	0	0
16	17247509	.	T	C	1	3	4	0	0	4	0	0
16	17249377	.	G	A	2	3	5	0	0	5	0	0
16	17249427	.	T	C	2	4	6	0	0	6	0	0
16	17250859	.	A	C	5	3	8	0	0	8	0	0
16	17252774	.	G	T	9	5	14	1	1	16	0	0
16	17253161	.	A	G	3	14	17	0	0	17	0	0
16	17253189	.	T	A	3	11	14	0	1	15	0	0
16	17253223	.	A	G	2	8	10	0	1	11	0	0
16	17256120	.	C	T	6	4	10	0	0	10	0	0
16	17256165	.	G	A	5	2	7	0	1	8	0	0
16	17256243	.	G	C	2	4	6	0	0	6	0	0
16	17256376	.	A	G	2	2	4	0	1	5	0	0
16	17302526	.	T	C	4	6	10	0	0	10	0	0
16	17302821	.	A	G	7	8	15	0	1	16	0	0
16	17305597	.	C	T	7	10	17	0	1	18	0	0
16	17305620	.	A	G	9	9	18	0	1	19	0	0
16	17311420	.	A	G	4	2	6	0	1	7	0	0
16	17428759	.	T	C	7	6	13	0	0	13	0	0
16	17465977	.	T	A	10	9	19	0	1	20	0	0
16	17466205	.	T	A	8	2	10	0	0	10	0	0
16	17466443	.	A	G	5	5	10	0	0	10	0	0
16	17466886	.	A	G	6	3	9	0	1	10	0	0
16	17467011	.	G	A	13	7	20	0	0	20	0	0
16	17467021	.	C	T	9	6	15	0	2	17	0	0
16	17467287	.	T	G	7	9	16	0	0	16	0	0
16	17467361	.	G	A	2	6	8	0	13	21	0	0
16	17550514	.	A	T	2	2	4	0	0	4	0	0
16	17550518	.	A	C	2	1	3	0	1	4	0	0
16	17550577	.	G	T	1	4	5	0	1	6	0	0
16	17551266	.	A	T	5	5	10	0	1	11	0	0
16	17560763	.	T	G	3	2	5	0	0	5	0	0
16	17580401	.	C	T	7	4	11	0	1	12	0	0
16	17581687	.	G	A	4	3	7	0	0	7	0	0
16	17585924	.	C	G	6	7	13	0	0	13	0	0
16	17586674	.	T	C	3	2	5	0	0	5	0	0
16	17639989	.	T	A	9	6	15	1	0	16	0	0
16	17640297	.	G	A	8	7	15	0	2	17	0	0
16	17646269	.	T	C	9	8	17	0	1	18	0	0
16	18142759	.	C	T	5	2	7	0	1	8	0	0
16	18142765	.	A	G	6	2	8	0	0	8	0	0
16	18552492	.	C	T	5	10	15	0	0	15	0	0
16	18624101	.	T	C	3	0	3	0	4	7	0	0
16	18624122	.	C	T	0	3	3	0	3	6	0	0
16	18960387	.	G	C	1	2	3	0	2	5	0	0
16	19124404	.	T	C	10	8	18	1	0	19	0	0
16	19124452	.	A	G	4	3	7	1	1	9	0	0
16	19126439	.	A	G	9	0	9	0	7	16	0	0
16	19136328	.	C	T	3	5	8	0	0	8	0	0
16	19141362	.	T	A	8	2	10	0	0	10	0	0
16	19145102	.	C	T	6	7	13	0	0	13	0	0
16	19150643	.	A	T	7	8	15	0	2	17	0	0
16	19150678	.	C	T	4	10	14	0	0	14	0	0
16	19150814	.	T	A	4	3	7	0	1	8	0	0
16	19150973	.	A	G	5	5	10	0	0	10	0	0
16	19151174	.	C	A	6	6	12	0	0	12	0	0
16	19151187	.	T	G	6	6	12	0	0	12	0	0
16	19151534	.	T	C	3	6	9	0	1	10	0	0
16	19151656	.	G	T	5	4	9	0	1	10	0	0
16	19151694	.	T	C	4	3	7	1	0	8	0	0
16	19182237	.	C	T	1	3	4	0	0	4	0	0
16	19537565	.	G	A	0	5	5	0	3	8	0	0
16	19537925	.	C	T	4	5	9	0	0	9	0	0
16	19538162	.	T	C	5	6	11	0	1	12	0	0
16	19538712	.	C	G	3	0	3	0	7	10	0	0
16	19538923	.	G	A	9	3	12	0	0	12	0	0
16	19538936	.	A	G	7	2	9	0	1	10	0	0
16	19538982	.	T	A	4	5	9	0	0	9	0	0
16	19539084	.	C	T	2	3	5	0	0	5	0	0
16	19840867	.	A	G	14	15	29	0	1	30	0	0
16	19841082	.	C	G	0	19	19	0	20	39	0	0
16	19841135	.	C	T	17	15	32	1	1	34	0	0
16	19841213	.	G	A	16	8	24	0	0	24	0	0
16	19841215	.	C	T	15	8	23	0	0	23	0	0
16	19841290	.	A	T	13	12	25	0	2	27	0	0
16	19841358	.	C	T	9	9	18	0	1	19	0	0
16	19841591	.	A	G	14	9	23	0	1	24	0	0
16	19841720	.	A	G	13	8	21	0	0	21	0	0
16	19841786	.	A	T	7	9	16	0	1	17	0	0
16	19841890	.	G	A	8	11	19	0	0	19	0	0
16	19842493	.	G	A	8	12	20	0	2	22	0	0
16	19842530	.	A	G	6	10	16	0	2	18	0	0
16	19843053	.	G	T	21	16	37	0	0	37	0	0
16	19843056	.	G	T	17	19	36	0	1	37	0	0
16	19850746	.	G	A	18	23	41	0	2	43	0	0
16	19853074	.	G	A	26	19	45	0	4	49	0	0
16	19853098	.	C	T	21	21	42	0	8	50	0	0
16	19853125	.	A	T	33	17	50	0	1	51	0	0
16	19853230	.	A	C	25	13	38	0	1	39	0	0
16	19854886	.	C	T	2	17	19	0	6	25	0	0
16	20123849	.	T	C	6	4	10	0	0	10	0	0
16	20134015	.	A	G	6	8	14	0	0	14	0	0
16	20137049	.	T	G	2	0	2	0	7	9	0	0
16	20140877	.	T	G	2	6	8	0	0	8	0	0
16	20148369	.	C	T	10	8	18	0	0	18	0	0
16	20151309	.	C	T	11	7	18	0	2	20	0	0
16	20151397	.	C	T	11	7	18	0	3	21	0	0
16	20151460	.	C	T	8	11	19	0	1	20	0	0
16	20151770	.	A	G	10	8	18	0	2	20	0	0
16	20151936	.	A	G	8	13	21	0	1	22	0	0
16	20151991	.	G	A	10	12	22	0	0	22	0	0
16	20152106	.	A	T	11	8	19	0	1	20	0	0
16	20152128	.	G	A	1	8	9	0	9	18	0	0
16	20152203	.	A	G	8	0	8	0	9	17	0	0
16	20152250	.	T	C	4	8	12	0	0	12	0	0
16	20152476	.	C	A	2	3	5	0	1	6	0	0
16	20178263	.	G	A	1	1	2	0	0	2	0	0
16	20178267	.	T	A	1	2	3	0	0	3	0	0
16	20178298	.	A	C	3	4	7	0	0	7	0	0
16	20193787	.	A	G	3	2	5	0	0	5	0	0
16	20193959	.	T	A	1	2	3	0	0	3	0	0
16	20193973	.	T	C	1	2	3	0	0	3	0	0
16	20234576	.	C	T	3	2	5	0	0	5	0	0
16	20234583	.	G	A	3	2	5	0	0	5	0	0
16	20235819	.	T	C	1	3	4	0	0	4	0	0
16	20237041	.	G	T	2	3	5	0	0	5	0	0
16	20238138	.	C	G	1	2	3	0	0	3	0	0
16	20238474	.	C	T	2	2	4	0	1	5	0	0
16	20238498	.	C	T	2	2	4	0	0	4	0	0
16	20265789	.	T	A	6	5	11	0	0	11	0	0
16	20265838	.	C	T	8	2	10	2	0	12	0	0
16	20265848	.	C	A	7	2	9	2	0	11	0	0
16	20265936	.	T	A	3	5	8	0	0	8	0	0
16	20266055	.	T	C	3	2	5	0	0	5	0	0
16	20266106	.	T	C	1	3	4	0	0	4	0	0
16	20266202	.	T	C	4	7	11	0	0	11	0	0
16	20266215	.	G	T	5	8	13	0	0	13	0	0
16	20266799	.	A	C	7	9	16	0	0	16	0	0
16	20267072	.	C	T	3	2	5	0	0	5	0	0
16	20267340	.	T	C	4	11	15	0	1	16	0	0
16	20267651	.	G	C	1	2	3	0	0	3	0	0
16	20267769	.	T	C	1	2	3	0	1	4	0	0
16	20268470	.	C	T	3	3	6	0	0	6	0	0
16	20271634	.	T	G	5	6	11	0	1	12	0	0
16	20271756	.	A	G	3	2	5	0	0	5	0	0
16	20276193	.	T	A	2	4	6	0	0	6	0	0
16	20289453	.	A	G	8	4	12	0	0	12	0	0
16	20289511	.	T	C	3	4	7	0	0	7	0	0
16	20289537	.	T	C	4	4	8	0	0	8	0	0
16	20292156	.	T	C	5	3	8	0	0	8	0	0
16	20298733	.	T	C	1	2	3	0	0	3	0	0
16	20298748	.	G	A	1	1	2	0	1	3	0	0
16	20318550	.	G	A	6	9	15	0	0	15	0	0
16	20324891	.	A	G	9	10	19	0	0	19	0	0
16	20328092	.	C	T	0	9	9	0	6	15	0	0
16	20371350	.	A	G	10	9	19	0	0	19	0	0
16	20402034	.	A	C	12	0	12	0	7	19	0	0
16	20402139	.	G	T	10	9	19	0	0	19	0	0
16	20402193	.	C	T	0	9	9	0	10	19	0	0
16	20402199	.	A	G	8	8	16	0	2	18	0	0
16	20403022	.	C	A	0	10	10	0	6	16	0	0
16	20435444	.	C	T	8	9	17	0	0	17	0	0
16	20492447	.	G	T	11	3	14	0	3	17	0	0
16	20492604	.	C	T	8	3	11	0	0	11	0	0
16	20497218	.	C	T	3	6	9	0	0	9	0	0
16	20497297	.	A	C	2	7	9	0	0	9	0	0
16	20512387	.	G	C	5	7	12	0	0	12	0	0
16	20512408	.	A	C	3	8	11	0	0	11	0	0
16	20512661	.	T	C	7	9	16	0	0	16	0	0
16	20513103	.	T	G	10	0	10	0	13	23	0	0
16	20514738	.	G	A	4	3	7	0	1	8	0	0
16	20529710	.	G	T	1	2	3	0	0	3	0	0
16	20529732	.	A	G	1	2	3	0	0	3	0	0
16	20529746	.	T	A	1	2	3	0	0	3	0	0
16	20792982	.	T	A	11	18	29	0	0	29	0	0
16	20806487	.	C	T	28	16	44	0	2	46	0	0
16	20806747	.	A	G	22	26	48	0	0	48	0	0
16	20815743	.	A	G	18	22	40	0	0	40	0	0
16	20822708	.	T	G	28	19	47	0	0	47	0	0
16	20826703	.	G	A	24	18	42	0	0	42	0	0
16	20836206	.	C	T	22	18	40	0	0	40	0	0
16	20836870	.	G	A	28	20	48	0	1	49	0	0
16	20855636	.	C	T	19	21	40	0	2	42	0	0
16	20874252	.	T	C	18	8	26	0	0	26	0	0
16	20889292	.	G	A	7	3	10	0	3	13	0	0
16	21038585	.	A	T	4	3	7	0	0	7	0	0
16	21038697	.	A	C	7	4	11	0	1	12	0	0
16	21038801	.	T	A	9	5	14	0	0	14	0	0
16	21038832	.	T	A	11	7	18	0	0	18	0	0
16	21038924	.	G	A	12	4	16	0	0	16	0	0
16	21039939	.	G	C	11	8	19	0	4	23	0	0
16	21166622	.	C	T	3	2	5	0	0	5	0	0
16	21166857	.	C	T	2	2	4	0	1	5	0	0
16	21167011	.	A	G	5	2	7	0	0	7	0	0
16	21242865	.	T	A	7	3	10	0	0	10	0	0
16	21398935	.	G	A	5	4	9	0	0	9	0	0
16	21417168	.	C	G	7	4	11	0	0	11	0	0
16	21436449	.	A	C	2	2	4	0	0	4	0	0
16	21436452	.	G	A	2	0	2	0	1	3	0	0
16	21443297	.	A	T	1	2	3	0	0	3	0	0
16	21443326	.	C	A	1	2	3	0	0	3	0	0
16	21548398	.	T	C	2	4	6	0	0	6	0	0
16	21548456	.	C	T	7	6	13	0	1	14	0	0
16	21548547	.	G	A	4	9	13	0	0	13	0	0
16	21548556	.	G	A	5	8	13	0	0	13	0	0
16	21548625	.	G	T	5	9	14	0	3	17	0	0
16	21548776	.	C	T	5	6	11	0	0	11	0	0
16	21548881	.	T	C	7	2	9	0	1	10	0	0
16	21548891	.	A	T	7	3	10	0	0	10	0	0
16	21549022	.	C	T	2	8	10	0	9	19	0	0
16	21549520	.	C	T	1	8	9	0	10	19	0	0
16	21549539	.	A	C	8	4	12	0	1	13	0	0
16	21549924	.	C	T	5	8	13	0	0	13	0	0
16	21550124	.	G	A	3	3	6	0	0	6	0	0
16	21550251	.	C	A	9	7	16	0	0	16	0	0
16	21550255	.	T	A	9	6	15	0	1	16	0	0
16	21550318	.	C	T	6	3	9	0	0	9	0	0
16	21551515	.	G	C	1	3	4	0	0	4	0	0
16	21551609	.	G	C	2	4	6	0	0	6	0	0
16	21551743	.	C	T	5	5	10	0	0	10	0	0
16	21551749	.	T	G	5	6	11	0	0	11	0	0
16	21551928	.	T	C	1	2	3	0	1	4	0	0
16	21551929	.	C	A	1	3	4	0	0	4	0	0
16	21552026	.	C	T	0	2	2	0	4	6	0	0
16	21552029	.	T	C	3	2	5	0	0	5	0	0
16	21552107	.	G	T	3	3	6	0	1	7	0	0
16	21553079	.	C	T	7	3	10	0	0	10	0	0
16	21554696	.	T	C	3	0	3	0	6	9	0	0
16	21554846	.	C	T	1	4	5	0	0	5	0	0
16	21556301	.	C	T	1	2	3	0	2	5	0	0
16	21556328	.	T	C	4	2	6	0	0	6	0	0
16	21570198	.	C	T	1	2	3	0	6	9	0	0
16	21576928	.	T	C	4	2	6	0	0	6	0	0
16	21578987	.	T	C	3	4	7	0	1	8	0	0
16	21579011	.	T	C	3	0	3	0	2	5	0	0
16	21651780	.	T	C	7	0	7	0	7	14	0	0
16	21652059	.	T	A	19	11	30	0	1	31	0	0
16	21655336	.	C	T	6	9	15	0	0	15	0	0
16	21655611	.	G	A	10	10	20	0	1	21	0	0
16	21663023	.	G	A	2	8	10	0	0	10	0	0
16	21665403	.	G	C	11	12	23	0	0	23	0	0
16	21665605	.	G	T	11	13	24	0	0	24	0	0
16	21668063	.	T	C	5	3	8	0	0	8	0	0
16	21668067	.	T	C	3	0	3	0	2	5	0	0
16	21673726	.	A	G	3	3	6	0	1	7	0	0
16	21673735	.	G	A	4	3	7	0	0	7	0	0
16	21689469	.	C	T	0	6	6	0	3	9	0	0
16	21691065	.	T	G	4	4	8	0	0	8	0	0
16	21691101	.	T	C	5	3	8	0	1	9	0	0
16	21711882	.	T	C	1	2	3	0	0	3	0	0
16	21738666	.	A	T	10	14	24	0	4	28	0	0
16	21739233	.	G	A	21	19	40	0	1	41	0	0
16	21763843	.	G	A	13	18	31	0	0	31	0	0
16	21769044	.	G	A	19	13	32	0	1	33	0	0
16	21777508	.	G	C	9	0	9	0	9	18	0	0
16	21780023	.	G	A	1	3	4	0	1	5	0	0
16	21782076	.	C	A	1	7	8	0	0	8	0	0
16	21892173	.	G	A	11	6	17	0	0	17	0	0
16	21892304	.	T	C	22	0	22	0	5	27	0	0
16	21892312	.	C	A	22	5	27	0	0	27	0	0
16	21898159	.	T	A	12	4	16	0	0	16	0	0
16	21898267	.	A	T	10	7	17	0	0	17	0	0
16	21898279	.	C	T	9	12	21	0	0	21	0	0
16	21899211	.	C	T	8	5	13	0	1	14	0	0
16	21899384	.	C	G	1	7	8	0	11	19	0	0
16	21900294	.	A	G	8	7	15	0	0	15	0	0
16	21900333	.	C	A	3	9	12	0	12	24	0	0
16	21901015	.	G	A	6	5	11	0	1	12	0	0
16	21903845	.	C	T	5	6	11	0	0	11	0	0
16	21903911	.	C	A	1	11	12	0	2	14	0	0
16	21904091	.	G	A	8	7	15	0	0	15	0	0
16	21905681	.	A	G	6	5	11	0	0	11	0	0
16	21906282	.	A	C	8	0	8	0	15	23	0	0
16	21907744	.	A	G	10	4	14	0	0	14	0	0
16	21908428	.	T	C	4	0	4	0	9	13	0	0
16	21908775	.	T	C	2	3	5	0	2	7	0	0
16	21908890	.	A	G	3	4	7	0	0	7	0	0
16	21912189	.	A	G	6	5	11	0	0	11	0	0
16	21913069	.	T	A	6	6	12	0	0	12	0	0
16	21913091	.	T	A	5	4	9	0	1	10	0	0
16	21913221	.	A	C	3	2	5	0	0	5	0	0
16	21913227	.	G	C	4	1	5	0	0	5	0	0
16	21917148	.	A	C	6	4	10	0	0	10	0	0
16	21921402	.	G	A	3	4	7	0	0	7	0	0
16	21921453	.	T	G	2	3	5	0	0	5	0	0
16	21921615	.	A	C	7	3	10	0	0	10	0	0
16	21921778	.	T	C	1	3	4	0	0	4	0	0
16	21922155	.	C	T	4	2	6	0	0	6	0	0
16	21922356	.	A	T	5	5	10	0	0	10	0	0
16	21922530	.	C	G	1	0	1	0	3	4	0	0
16	21925257	.	A	G	2	5	7	0	0	7	0	0
16	21928360	.	G	A	3	2	5	0	0	5	0	0
16	21933946	.	G	A	0	2	2	0	2	4	0	0
16	21935398	.	G	T	3	4	7	0	0	7	0	0
16	21937616	.	C	G	4	3	7	0	0	7	0	0
16	21937712	.	T	C	2	5	7	0	0	7	0	0
16	21937834	.	C	G	6	3	9	0	0	9	0	0
16	22063190	.	A	C	2	3	5	1	0	6	0	0
16	22063205	.	T	A	1	3	4	1	0	5	0	0
16	22217835	.	T	C	9	0	9	0	7	16	0	0
16	22218117	.	A	G	2	5	7	0	0	7	0	0
16	22218355	.	C	A	10	8	18	0	0	18	0	0
16	22218451	.	A	G	4	2	6	0	0	6	0	0
16	22222804	.	G	A	3	3	6	0	0	6	0	0
16	22222813	.	C	T	3	3	6	0	0	6	0	0
16	22224698	.	A	G	4	7	11	0	0	11	0	0
16	22224707	.	C	G	4	7	11	0	0	11	0	0
16	22225094	.	C	T	9	6	15	0	0	15	0	0
16	22245156	.	A	G	6	3	9	1	0	10	0	0
16	22358841	.	T	A	6	4	10	0	0	10	0	0
16	22358944	.	A	T	6	9	15	0	1	16	0	0
16	22358947	.	T	A	8	11	19	0	0	19	0	0
16	22360552	.	G	A	15	10	25	0	0	25	0	0
16	22360577	.	G	A	19	9	28	0	1	29	0	0
16	22361101	.	T	C	17	6	23	0	0	23	0	0
16	22363956	.	G	A	6	9	15	0	0	15	0	0
16	22363957	.	G	A	5	9	14	0	1	15	0	0
16	22364064	.	C	T	15	14	29	0	2	31	0	0
16	22364067	.	T	G	14	15	29	0	2	31	0	0
16	22364241	.	A	C	22	11	33	0	1	34	0	0
16	22364501	.	A	C	8	5	13	0	0	13	0	0
16	22365562	.	C	G	7	3	10	2	0	12	0	0
16	22368962	.	T	A	14	6	20	0	4	24	0	0
16	22374908	.	C	T	3	2	5	0	0	5	0	0
16	22649862	.	T	G	7	11	18	0	2	20	0	0
16	22659905	.	A	G	4	14	18	0	0	18	0	0
16	22660094	.	C	A	9	9	18	0	0	18	0	0
16	22673219	.	C	T	14	16	30	0	0	30	0	0
16	22673234	.	C	T	14	15	29	0	1	30	0	0
16	22673528	.	C	G	17	17	34	0	0	34	0	0
16	22673804	.	G	T	5	12	17	0	0	17	0	0
16	22673817	.	G	T	8	13	21	0	0	21	0	0
16	22674181	.	A	C	7	4	11	0	0	11	0	0
16	22674317	.	A	G	9	8	17	0	0	17	0	0
16	22674427	.	C	T	8	11	19	0	0	19	0	0
16	22674490	.	G	A	8	6	14	0	0	14	0	0
16	22675081	.	T	A	10	7	17	0	0	17	0	0
16	22675110	.	A	T	6	7	13	0	2	15	0	0
16	22675253	.	C	T	10	9	19	0	0	19	0	0
16	22675310	.	T	A	8	11	19	0	1	20	0	0
16	22675367	.	C	A	9	6	15	0	1	16	0	0
16	22675418	.	T	C	11	10	21	0	1	22	0	0
16	22675574	.	T	C	6	16	22	0	0	22	0	0
16	22675663	.	T	C	10	17	27	0	0	27	0	0
16	22675795	.	G	A	1	7	8	0	4	12	0	0
16	22676052	.	G	T	6	6	12	0	0	12	0	0
16	22676078	.	A	G	8	4	12	0	0	12	0	0
16	22676478	.	G	C	5	3	8	0	0	8	0	0
16	22676527	.	C	T	7	4	11	2	0	13	0	0
16	22676589	.	G	T	11	11	22	1	1	24	0	0
16	22676671	.	T	A	16	9	25	0	0	25	0	0
16	22677037	.	C	A	7	9	16	0	0	16	0	0
16	22677086	.	G	A	17	8	25	0	0	25	0	0
16	22677206	.	C	A	12	15	27	0	0	27	0	0
16	22677276	.	A	G	12	11	23	0	2	25	0	0
16	22677537	.	A	G	4	7	11	0	0	11	0	0
16	22677658	.	T	C	2	3	5	0	0	5	0	0
16	22750244	.	A	T	8	10	18	0	0	18	0	0
16	22750263	.	A	T	10	13	23	0	0	23	0	0
16	22750460	.	T	C	14	0	14	0	14	28	0	0
16	22750483	.	T	C	9	14	23	0	1	24	0	0
16	22750506	.	A	G	7	15	22	0	1	23	0	0
16	22750754	.	G	A	11	8	19	0	2	21	0	0
16	22750839	.	A	G	7	6	13	0	0	13	0	0
16	22751212	.	A	T	6	2	8	0	0	8	0	0
16	22751679	.	T	A	11	5	16	0	1	17	0	0
16	22752154	.	G	A	27	16	43	0	1	44	0	0
16	22752572	.	A	C	16	11	27	0	0	27	0	0
16	22752624	.	C	T	0	8	8	0	7	15	0	0
16	22752829	.	C	A	10	7	17	0	0	17	0	0
16	22753574	.	C	T	4	16	20	2	17	39	0	0
16	22753583	.	T	C	19	1	20	2	15	37	0	0
16	22753626	.	C	T	25	15	40	2	1	43	0	0
16	22753631	.	C	T	22	14	36	0	4	40	0	0
16	22753744	.	G	C	19	1	20	0	16	36	0	0
16	22754238	.	A	G	11	9	20	0	2	22	0	0
16	22757742	.	G	A	15	16	31	0	1	32	0	0
16	22757795	.	T	C	17	16	33	0	1	34	0	0
16	22757887	.	T	C	19	12	31	0	1	32	0	0
16	22757946	.	T	C	14	2	16	0	9	25	0	0
16	22764803	.	C	T	9	17	26	0	1	27	0	0
16	22764857	.	A	T	6	9	15	0	1	16	0	0
16	22767597	.	A	G	10	12	22	0	1	23	0	0
16	22767603	.	C	T	2	11	13	0	8	21	0	0
16	22767646	.	G	A	4	13	17	0	0	17	0	0
16	22767732	.	A	G	8	13	21	0	1	22	0	0
16	22767796	.	C	G	12	9	21	0	1	22	0	0
16	22782175	.	G	T	5	3	8	0	0	8	0	0
16	22782784	.	T	C	9	9	18	0	0	18	0	0
16	22789640	.	A	G	19	20	39	0	1	40	0	0
16	23963257	.	G	A	22	26	48	0	0	48	0	0
16	23963315	.	G	T	15	20	35	0	1	36	0	0
16	23963421	.	G	T	7	5	12	0	1	13	0	0
16	23963431	.	G	A	7	4	11	0	0	11	0	0
16	23973477	.	G	A	19	27	46	0	1	47	0	0
16	23973501	.	A	G	19	28	47	0	1	48	0	0
16	24030488	.	T	A	2	7	9	0	0	9	0	0
16	24056406	.	T	G	4	7	11	0	0	11	0	0
16	24056497	.	C	T	3	5	8	0	0	8	0	0
16	24058712	.	G	A	3	6	9	0	0	9	0	0
16	24135465	.	T	C	7	0	7	0	6	13	0	0
16	24135547	.	T	C	10	0	10	0	11	21	0	0
16	24190626	.	C	T	3	4	7	0	0	7	0	0
16	24190674	.	C	T	2	5	7	0	0	7	0	0
16	24191468	.	T	C	26	31	57	0	2	59	0	0
16	24191564	.	G	A	33	33	66	0	5	71	0	0
16	24194217	.	A	C	31	35	66	0	3	69	0	0
16	24261548	.	T	C	35	3	38	0	19	57	0	0
16	24261594	.	C	G	30	18	48	0	1	49	0	0
16	24517824	.	G	A	13	18	31	0	0	31	0	0
16	24552032	.	G	A	1	6	7	0	0	7	0	0
16	24552801	.	A	G	6	4	10	0	0	10	0	0
16	24552931	.	G	T	6	5	11	0	0	11	0	0
16	24553018	.	G	T	6	8	14	0	0	14	0	0
16	24553082	.	T	A	2	6	8	0	0	8	0	0
16	24553633	.	A	G	2	5	7	0	1	8	0	0
16	24553663	.	T	G	3	11	14	0	0	14	0	0
16	24553843	.	A	G	7	5	12	0	0	12	0	0
16	24553861	.	T	C	4	6	10	0	0	10	0	0
16	24553884	.	T	C	4	0	4	0	4	8	0	0
16	24554438	.	T	A	8	11	19	0	0	19	0	0
16	24554475	.	A	G	12	9	21	0	1	22	0	0
16	24590950	.	T	A	9	10	19	0	0	19	0	0
16	24590999	.	A	G	15	8	23	0	0	23	0	0
16	24591010	.	G	A	14	6	20	0	0	20	0	0
16	24591036	.	T	C	14	6	20	0	0	20	0	0
16	24591207	.	T	G	13	8	21	0	0	21	0	0
16	24591287	.	C	T	3	6	9	0	9	18	0	0
16	24591330	.	A	G	13	11	24	0	1	25	0	0
16	24591360	.	G	A	10	11	21	0	1	22	0	0
16	24591379	.	C	T	6	8	14	0	0	14	0	0
16	24591410	.	G	A	6	5	11	0	0	11	0	0
16	24591422	.	C	A	4	6	10	0	1	11	0	0
16	24591693	.	G	C	32	12	44	0	2	46	0	0
16	24591751	.	C	T	25	22	47	0	1	48	0	0
16	24596192	.	C	T	24	12	36	2	4	42	0	0
16	24601285	.	A	C	2	6	8	0	0	8	0	0
16	24601306	.	C	T	3	5	8	0	0	8	0	0
16	24601380	.	T	C	2	4	6	1	1	8	0	0
16	24601491	.	C	T	5	4	9	0	0	9	0	0
16	24601513	.	C	T	0	4	4	0	4	8	0	0
16	24601558	.	C	T	3	2	5	0	0	5	0	0
16	24611053	.	T	C	2	0	2	0	4	6	0	0
16	24632231	.	C	T	15	10	25	2	0	27	0	0
16	24632329	.	T	A	13	12	25	0	1	26	0	0
16	24639396	.	G	A	12	13	25	0	0	25	0	0
16	24642327	.	T	C	23	10	33	0	0	33	0	0
16	24645240	.	C	T	22	5	27	0	1	28	0	0
16	24645448	.	C	G	15	5	20	0	0	20	0	0
16	24645476	.	A	T	11	7	18	0	3	21	0	0
16	24645895	.	C	G	5	2	7	0	1	8	0	0
16	24646000	.	A	T	6	2	8	0	0	8	0	0
16	24646684	.	C	A	3	2	5	0	0	5	0	0
16	24695056	.	T	G	2	4	6	0	0	6	0	0
16	24730634	.	C	A	8	6	14	0	1	15	0	0
16	24732829	.	A	G	7	0	7	0	9	16	0	0
16	24732869	.	G	T	5	8	13	0	0	13	0	0
16	24733125	.	A	G	3	5	8	0	0	8	0	0
16	24733127	.	A	G	3	5	8	0	0	8	0	0
16	24819676	.	G	A	1	4	5	0	0	5	0	0
16	24819678	.	A	G	1	4	5	0	0	5	0	0
16	24819936	.	C	T	2	4	6	0	0	6	0	0
16	24820125	.	A	G	3	2	5	0	0	5	0	0
16	24826215	.	T	C	3	0	3	0	3	6	0	0
16	24826221	.	A	G	2	3	5	0	0	5	0	0
16	24842828	.	G	A	1	2	3	0	0	3	0	0
16	24978275	.	C	G	3	11	14	0	1	15	0	0
16	24989526	.	C	A	1	1	2	0	1	3	0	0
16	24989548	.	G	A	2	2	4	0	0	4	0	0
16	24990312	.	T	G	3	7	10	0	0	10	0	0
16	24990672	.	C	T	6	6	12	0	0	12	0	0
16	24990818	.	T	C	4	6	10	0	0	10	0	0
16	24991164	.	G	T	2	5	7	0	9	16	0	0
16	24991225	.	C	G	4	9	13	0	0	13	0	0
16	24991239	.	G	A	2	10	12	0	1	13	0	0
16	24991333	.	T	C	4	6	10	0	0	10	0	0
16	24991391	.	T	C	3	10	13	0	0	13	0	0
16	24991593	.	A	T	5	5	10	0	1	11	0	0
16	24991636	.	G	A	6	4	10	0	0	10	0	0
16	24991637	.	C	T	6	4	10	0	0	10	0	0
16	24991919	.	T	A	2	3	5	0	0	5	0	0
16	24992017	.	A	C	2	5	7	0	0	7	0	0
16	25012003	.	T	A	9	4	13	0	0	13	0	0
16	25012031	.	G	T	10	5	15	0	0	15	0	0
16	25012045	.	A	C	9	7	16	0	0	16	0	0
16	25012123	.	T	C	3	4	7	0	0	7	0	0
16	25012143	.	T	A	6	3	9	0	0	9	0	0
16	25012935	.	T	A	11	7	18	0	0	18	0	0
16	25029841	.	G	C	10	4	14	0	0	15	1	0
16	25030191	.	T	A	4	7	11	0	3	14	0	0
16	25030333	.	C	T	4	4	8	0	0	8	0	0
16	25030338	.	G	A	4	4	8	0	1	9	0	0
16	25030541	.	G	A	3	5	8	0	0	8	0	0
16	25030623	.	A	G	7	3	10	0	1	11	0	0
16	25030649	.	A	T	8	3	11	0	1	12	0	0
16	25030671	.	T	C	6	5	11	0	1	12	0	0
16	25030685	.	A	G	7	4	11	0	1	12	0	0
16	25030732	.	C	G	5	3	8	0	0	8	0	0
16	25030807	.	G	A	11	7	18	0	0	18	0	0
16	25030831	.	G	T	9	10	19	0	0	19	0	0
16	25030848	.	G	A	10	8	18	0	0	18	0	0
16	25030956	.	A	C	3	2	5	0	0	5	0	0
16	25030981	.	G	T	2	1	3	0	2	5	0	0
16	25031019	.	C	A	3	3	6	0	1	7	0	0
16	25031185	.	C	A	9	6	15	0	0	15	0	0
16	25031211	.	C	A	10	6	16	0	0	16	0	0
16	25031220	.	C	T	8	3	11	0	0	11	0	0
16	25031250	.	G	A	8	2	10	0	2	12	0	0
16	25031322	.	C	T	6	5	11	0	0	11	0	0
16	25031359	.	T	A	4	5	9	0	0	9	0	0
16	25031400	.	T	C	4	6	10	0	0	10	0	0
16	25031414	.	C	A	5	7	12	0	0	12	0	0
16	25031435	.	G	C	5	7	12	0	0	12	0	0
16	25031458	.	A	C	5	8	13	0	2	15	0	0
16	25031628	.	C	A	2	2	4	0	0	4	0	0
16	25031712	.	T	G	7	3	10	0	0	10	0	0
16	25031785	.	G	A	7	3	10	0	0	10	0	0
16	25031811	.	T	C	3	3	6	0	0	6	0	0
16	25031884	.	G	A	9	8	17	0	1	18	0	0
16	25032733	.	G	C	5	7	12	0	1	13	0	0
16	25033071	.	G	A	11	9	20	0	0	20	0	0
16	25033306	.	C	T	4	6	10	0	1	11	0	0
16	25033319	.	C	T	5	7	12	0	0	12	0	0
16	25033423	.	A	T	6	6	12	0	1	13	0	0
16	25033659	.	C	A	9	9	18	0	0	18	0	0
16	25033809	.	G	A	10	5	15	0	0	15	0	0
16	25033953	.	G	A	6	6	12	0	1	13	0	0
16	25033983	.	T	A	7	6	13	0	0	13	0	0
16	25034115	.	A	G	6	5	11	0	0	11	0	0
16	25034187	.	C	A	4	9	13	0	0	13	0	0
16	25034223	.	A	C	10	6	16	0	1	17	0	0
16	25034683	.	A	T	16	11	27	0	1	28	0	0
16	25034715	.	C	T	12	17	29	0	0	29	0	0
16	25034766	.	G	A	16	10	26	0	2	28	0	0
16	25035024	.	T	G	7	1	8	0	17	25	0	0
16	25035129	.	A	G	16	11	27	0	0	27	0	0
16	25035169	.	G	T	14	10	24	0	0	24	0	0
16	25035471	.	A	G	5	8	13	0	0	13	0	0
16	25035906	.	A	T	8	14	22	0	0	22	0	0
16	25036217	.	C	T	8	10	18	0	1	19	0	0
16	25038011	.	T	C	14	14	28	0	1	29	0	0
16	25038762	.	C	A	3	2	5	0	1	6	0	0
16	25066960	.	C	T	5	9	14	0	1	15	0	0
16	25069178	.	A	T	7	2	9	0	0	9	0	0
16	25070393	.	A	C	12	12	24	0	0	24	0	0
16	25070693	.	A	G	4	5	9	0	1	10	0	0
16	25070990	.	A	C	6	4	10	0	0	10	0	0
16	25071231	.	T	G	12	7	19	0	1	20	0	0
16	25071329	.	T	G	11	0	11	0	9	20	0	0
16	25071443	.	A	C	7	5	12	0	0	12	0	0
16	25071518	.	C	A	12	10	22	0	1	23	0	0
16	25071533	.	A	G	12	8	20	0	0	20	0	0
16	25071614	.	C	T	6	9	15	0	1	16	0	0
16	25072355	.	G	A	5	7	12	0	1	13	0	0
16	25076704	.	A	G	5	5	10	0	1	11	0	0
16	25076831	.	T	A	7	3	10	0	2	12	0	0
16	25077410	.	G	A	1	5	6	0	3	9	0	0
16	25077608	.	C	T	6	7	13	0	0	13	0	0
16	25078715	.	A	G	6	4	10	0	0	10	0	0
16	25078815	.	G	C	6	5	11	0	0	11	0	0
16	25078907	.	T	A	5	6	11	0	0	11	0	0
16	25079434	.	A	C	9	4	13	2	1	16	0	0
16	25079467	.	C	T	11	4	15	1	2	18	0	0
16	25079493	.	G	A	10	5	15	0	2	17	0	0
16	25080042	.	G	T	4	5	9	0	1	10	0	0
16	25080190	.	T	A	3	3	6	0	0	6	0	0
16	25080207	.	C	T	1	5	6	0	0	6	0	0
16	25080236	.	G	T	2	4	6	0	0	6	0	0
16	25080252	.	A	T	3	3	6	0	0	6	0	0
16	25080306	.	T	C	2	2	4	0	0	4	0	0
16	25080367	.	G	A	4	3	7	0	0	7	0	0
16	25104196	.	A	G	13	13	26	0	1	27	0	0
16	25104226	.	A	G	11	8	19	0	3	22	0	0
16	25104595	.	C	T	20	10	30	0	1	31	0	0
16	25104899	.	T	G	14	14	28	0	1	29	0	0
16	25104970	.	T	C	14	10	24	0	0	24	0	0
16	25111665	.	C	A	5	3	8	0	0	8	0	0
16	25111794	.	G	A	4	5	9	0	1	10	0	0
16	25111899	.	G	A	11	5	16	0	1	17	0	0
16	25111920	.	G	A	2	3	5	0	7	12	0	0
16	25112001	.	A	G	8	5	13	0	0	13	0	0
16	25112316	.	G	A	6	2	8	0	0	8	0	0
16	25118688	.	G	A	2	8	10	0	0	10	0	0
16	25118733	.	A	G	5	10	15	0	1	16	0	0
16	25118847	.	T	C	4	2	6	0	0	6	0	0
16	25119126	.	C	T	4	3	7	0	0	7	0	0
16	25119142	.	A	C	2	3	5	0	0	5	0	0
16	25119501	.	T	A	3	2	5	0	0	5	0	0
16	25119537	.	C	T	4	2	6	0	0	6	0	0
16	25119660	.	C	A	5	5	10	0	0	10	0	0
16	25119690	.	C	T	6	4	10	0	0	10	0	0
16	25119813	.	C	T	2	3	5	0	0	5	0	0
16	25120696	.	G	T	3	2	5	0	0	5	0	0
16	25121209	.	G	A	0	4	4	0	6	10	0	0
16	25121363	.	T	C	2	7	9	0	1	10	0	0
16	25121423	.	T	C	6	11	17	0	1	18	0	0
16	25121694	.	T	C	8	7	15	0	0	15	0	0
16	25121812	.	T	A	10	9	19	0	0	19	0	0
16	25121851	.	G	A	10	6	16	0	0	16	0	0
16	25121970	.	C	T	8	10	18	0	0	18	0	0
16	25122240	.	C	T	5	4	9	0	0	9	0	0
16	25122387	.	C	T	6	5	11	0	0	11	0	0
16	25122503	.	C	T	7	6	13	0	1	14	0	0
16	25122528	.	C	A	8	7	15	0	1	16	0	0
16	25122770	.	T	A	4	3	7	0	0	7	0	0
16	25122798	.	C	T	4	4	8	0	0	8	0	0
16	25122928	.	A	G	4	4	8	0	0	8	0	0
16	25122933	.	A	G	2	0	2	0	8	10	0	0
16	25123058	.	A	G	5	4	9	0	0	9	0	0
16	25123221	.	C	A	2	6	8	0	0	8	0	0
16	25123247	.	G	T	4	7	11	0	0	11	0	0
16	25123263	.	A	G	8	6	14	0	1	15	0	0
16	25123294	.	T	G	9	0	9	0	9	18	0	0
16	25123382	.	G	T	6	5	11	0	2	13	0	0
16	25123424	.	A	G	5	5	10	0	1	11	0	0
16	25123435	.	A	G	2	5	7	0	0	7	0	0
16	25123610	.	T	A	3	2	5	0	0	5	0	0
16	25123884	.	C	G	1	5	6	0	0	6	0	0
16	25124138	.	T	G	1	4	5	0	1	6	0	0
16	25124163	.	T	G	1	0	1	0	4	5	0	0
16	25124500	.	G	A	6	5	11	0	0	11	0	0
16	25124750	.	G	A	1	3	4	0	0	4	0	0
16	25124763	.	A	T	1	3	4	0	0	4	0	0
16	25142125	.	A	G	4	0	4	0	5	9	0	0
16	25142302	.	G	A	0	2	2	0	4	6	0	0
16	25142500	.	G	A	0	5	5	0	4	9	0	0
16	25145978	.	G	A	0	6	6	0	1	7	0	0
16	25146020	.	T	C	2	5	7	0	0	7	0	0
16	25146107	.	A	T	3	2	5	0	0	5	0	0
16	25148515	.	C	T	4	5	9	0	0	9	0	0
16	25148565	.	G	A	0	5	5	0	5	10	0	0
16	25148725	.	C	T	6	6	12	0	0	12	0	0
16	25148748	.	G	A	1	4	5	0	9	14	0	0
16	25149191	.	G	A	3	6	9	0	0	9	0	0
16	25149228	.	C	T	2	9	11	0	0	11	0	0
16	25149254	.	G	T	3	12	15	0	1	16	0	0
16	25149294	.	T	A	8	8	16	0	1	17	0	0
16	25149433	.	C	T	5	5	10	0	0	10	0	0
16	25149474	.	C	T	10	5	15	0	0	15	0	0
16	25149529	.	A	G	7	4	11	0	0	11	0	0
16	25149563	.	T	G	3	5	8	0	1	9	0	0
16	25149654	.	T	C	7	4	11	0	0	11	0	0
16	25149797	.	C	G	6	6	12	0	0	12	0	0
16	25149819	.	T	C	4	4	8	0	0	10	2	0
16	25149889	.	A	G	4	4	8	0	3	11	0	0
16	25149939	.	G	A	2	9	11	0	0	11	0	0
16	25149954	.	C	G	2	9	11	0	0	11	0	0
16	25149992	.	A	C	3	9	12	0	0	12	0	0
16	25150307	.	T	G	5	0	5	0	7	12	0	0
16	25150464	.	G	C	1	4	5	0	4	9	0	0
16	25150641	.	C	T	1	2	3	0	0	3	0	0
16	25151012	.	T	C	9	3	12	0	0	12	0	0
16	25151059	.	G	A	1	6	7	0	4	11	0	0
16	25151079	.	A	G	3	0	3	0	5	8	0	0
16	25151419	.	G	A	10	4	14	0	0	14	0	0
16	25151456	.	G	A	5	5	10	0	0	10	0	0
16	25151512	.	G	C	7	5	12	0	0	12	0	0
16	25154115	.	C	T	4	7	11	0	0	11	0	0
16	25154180	.	T	C	4	4	8	0	0	8	0	0
16	25160922	.	A	T	2	3	5	0	1	6	0	0
16	25160985	.	G	A	0	5	5	0	4	9	0	0
16	25161292	.	A	G	6	6	12	0	0	12	0	0
16	25161693	.	G	A	9	13	22	0	2	24	0	0
16	25161739	.	T	C	12	9	21	0	1	22	0	0
16	25161873	.	G	A	3	9	12	0	13	25	0	0
16	25162163	.	G	T	1	4	5	0	1	6	0	0
16	25162514	.	G	A	0	6	6	0	8	14	0	0
16	25162516	.	T	C	7	7	14	0	0	14	0	0
16	25162777	.	T	A	1	3	4	0	0	4	0	0
16	25162898	.	A	T	2	3	5	0	0	5	0	0
16	25162910	.	T	C	3	3	6	0	0	6	0	0
16	25164326	.	C	A	12	8	20	0	0	20	0	0
16	25168548	.	G	A	13	16	29	0	0	29	0	0
16	25169003	.	A	G	14	8	22	0	0	22	0	0
16	25169501	.	T	A	1	2	3	0	0	3	0	0
16	25169616	.	A	T	1	3	4	0	0	4	0	0
16	25171898	.	C	G	4	4	8	0	0	8	0	0
16	25173902	.	C	T	1	2	3	0	0	3	0	0
16	25176780	.	C	A	6	6	12	0	0	12	0	0
16	25232250	.	T	C	3	3	6	0	0	6	0	0
16	25232262	.	G	A	2	4	6	0	0	6	0	0
16	25232421	.	T	C	1	4	5	0	0	5	0	0
16	25232712	.	C	T	0	4	4	0	3	7	0	0
16	25232967	.	G	A	2	4	6	0	2	8	0	0
16	25232973	.	C	T	0	7	7	0	2	9	0	0
16	25233113	.	G	A	1	3	4	0	0	4	0	0
16	25233226	.	T	C	4	2	6	0	1	7	0	0
16	25233230	.	T	G	5	2	7	0	1	8	0	0
16	25259332	.	T	C	3	2	5	0	0	5	0	0
16	25259477	.	T	A	2	2	4	0	1	5	0	0
16	25272196	.	C	G	1	2	3	0	0	3	0	0
16	25272529	.	A	C	4	3	7	0	0	7	0	0
16	25275842	.	C	A	2	2	4	0	1	5	0	0
16	25275848	.	T	C	2	5	7	0	0	7	0	0
16	25275909	.	A	C	4	15	19	0	0	19	0	0
16	25275984	.	C	T	0	16	16	0	15	31	0	0
16	25276281	.	G	A	6	19	25	0	0	25	0	0
16	25276387	.	T	A	9	13	22	0	1	23	0	0
16	25285506	.	G	A	15	21	36	0	0	36	0	0
16	25285507	.	G	A	15	21	36	0	0	36	0	0
16	25297762	.	C	T	1	4	5	0	0	5	0	0
16	25300614	.	C	A	3	3	6	0	1	7	0	0
16	25308516	.	C	T	4	5	9	0	0	9	0	0
16	25311038	.	A	T	9	4	13	0	0	13	0	0
16	25311394	.	G	A	9	6	15	0	0	15	0	0
16	25314682	.	C	T	5	10	15	0	0	15	0	0
16	25314974	.	T	C	1	2	3	0	1	4	0	0
16	25314996	.	A	G	2	2	4	0	0	4	0	0
16	25317000	.	G	A	7	7	14	0	1	15	0	0
16	25327730	.	C	T	8	5	13	0	1	14	0	0
16	25334326	.	A	G	14	13	27	0	0	27	0	0
16	25334333	.	G	A	13	14	27	0	1	28	0	0
16	25344035	.	T	C	2	2	4	0	0	4	0	0
16	25344133	.	A	G	3	4	7	0	1	8	0	0
16	25345649	.	A	G	2	0	2	0	3	5	0	0
16	25348038	.	T	C	1	2	3	0	0	3	0	0
16	25348683	.	T	C	1	7	8	0	1	9	0	0
16	25348767	.	G	A	2	5	7	0	0	7	0	0
16	25349279	.	T	C	3	4	7	0	1	8	0	0
16	25353019	.	C	T	1	2	3	0	0	3	0	0
16	25354336	.	G	A	3	8	11	0	0	11	0	0
16	25354571	.	A	G	6	0	6	0	4	10	0	0
16	25356717	.	A	C	4	2	6	0	1	7	0	0
16	25357980	.	T	A	3	11	14	0	0	14	0	0
16	25357989	.	C	T	4	10	14	0	0	14	0	0
16	25360557	.	T	A	8	5	13	0	0	13	0	0
16	25360605	.	C	A	7	5	12	0	0	12	0	0
16	25373900	.	A	C	4	2	6	0	0	6	0	0
16	25373924	.	G	A	5	3	8	0	1	9	0	0
16	25374135	.	G	A	6	4	10	0	0	10	0	0
16	25374139	.	T	A	6	4	10	0	0	10	0	0
16	25374275	.	T	C	7	4	11	0	0	11	0	0
16	25374417	.	C	T	1	5	6	0	5	11	0	0
16	25374507	.	T	C	6	0	6	0	6	12	0	0
16	25374508	.	T	G	5	5	10	0	1	11	0	0
16	25374648	.	G	A	6	3	9	0	0	9	0	0
16	25375019	.	T	C	8	0	8	0	9	17	0	0
16	25375095	.	A	G	3	7	10	0	2	12	0	0
16	25376046	.	T	A	5	7	12	0	0	12	0	0
16	25376286	.	A	G	4	3	7	0	0	7	0	0
16	25376586	.	A	G	3	4	7	0	0	7	0	0
16	25376700	.	A	G	1	3	4	0	0	4	0	0
16	25376808	.	T	C	2	4	6	0	0	6	0	0
16	25389061	.	C	T	1	7	8	0	4	12	0	0
16	25389424	.	G	A	14	6	20	0	1	21	0	0
16	25389425	.	C	A	14	6	20	0	0	20	0	0
16	25393277	.	G	T	12	5	17	0	0	17	0	0
16	25394879	.	C	A	2	3	5	0	0	5	0	0
16	25394883	.	C	T	2	3	5	0	0	5	0	0
16	25395154	.	G	T	2	6	8	0	0	9	1	0
16	25395700	.	A	T	5	7	12	0	0	12	0	0
16	25395702	.	G	T	5	7	12	0	0	12	0	0
16	25399585	.	A	T	4	6	10	0	0	10	0	0
16	25399588	.	A	T	4	6	10	0	0	10	0	0
16	25407294	.	T	C	3	6	9	0	0	9	0	0
16	25407426	.	A	T	2	2	4	0	0	4	0	0
16	25407532	.	A	C	6	7	13	0	0	13	0	0
16	25445746	.	G	A	9	5	14	0	1	15	0	0
16	25454790	.	C	T	7	7	14	0	0	14	0	0
16	25454829	.	G	T	1	4	5	0	10	15	0	0
16	25463401	.	C	A	6	5	11	0	1	12	0	0
16	25470975	.	A	G	7	7	14	0	0	14	0	0
16	25477398	.	G	C	1	4	5	0	5	10	0	0
16	25477428	.	G	A	9	6	15	0	1	16	0	0
16	25477692	.	G	A	4	3	7	0	1	8	0	0
16	25477736	.	A	G	3	5	8	0	0	8	0	0
16	25487720	.	A	G	13	8	21	0	0	21	0	0
16	25504126	.	A	G	6	2	8	0	0	8	0	0
16	25504192	.	G	C	16	11	27	0	2	29	0	0
16	25504337	.	G	A	17	8	25	0	0	25	0	0
16	25504425	.	G	T	15	8	23	0	0	23	0	0
16	25504467	.	G	A	15	13	28	0	1	29	0	0
16	25504537	.	T	C	19	1	20	0	16	36	0	0
16	25504792	.	G	C	28	20	48	0	0	48	0	0
16	25504900	.	G	A	31	23	54	0	6	60	0	0
16	25507643	.	T	A	3	3	6	0	0	6	0	0
16	25527520	.	C	T	10	10	20	0	1	21	0	0
16	25527541	.	T	G	7	8	15	0	1	16	0	0
16	25555775	.	G	A	10	8	18	0	1	19	0	0
16	25558135	.	C	T	15	10	25	0	1	26	0	0
16	25558595	.	C	T	13	17	30	0	1	31	0	0
16	25559842	.	G	A	9	5	14	0	1	15	0	0
16	25559886	.	T	A	8	7	15	0	0	15	0	0
16	25560184	.	A	G	5	6	11	0	1	12	0	0
16	25561795	.	C	A	12	9	21	0	0	21	0	0
16	25593973	.	G	A	5	8	13	0	1	14	0	0
16	25594415	.	C	T	5	9	14	0	0	14	0	0
16	25597492	.	A	G	9	3	12	0	0	12	0	0
16	25597510	.	G	A	10	3	13	0	0	13	0	0
16	25597613	.	C	T	1	7	8	0	3	11	0	0
16	25642663	.	G	A	12	11	23	0	0	23	0	0
16	25643452	.	T	A	4	10	14	0	1	15	0	0
16	25644357	.	C	A	5	7	12	0	1	13	0	0
16	25673880	.	T	C	10	10	20	0	0	20	0	0
16	25683018	.	T	C	3	8	11	0	2	13	0	0
16	25698449	.	A	C	9	8	17	0	0	17	0	0
16	25812191	.	T	C	4	4	8	0	0	8	0	0
16	25823719	.	G	T	1	2	3	0	0	3	0	0
16	26046772	.	A	G	11	9	20	0	1	21	0	0
16	26074459	.	G	T	16	10	26	0	5	31	0	0
16	26141395	.	C	A	7	7	14	0	0	14	0	0
16	26141396	.	T	C	7	0	7	0	7	14	0	0
16	26141748	.	T	C	7	1	8	0	6	14	0	0
16	26141880	.	T	A	7	3	10	0	0	10	0	0
16	26142105	.	C	T	13	6	19	0	0	19	0	0
16	26142209	.	C	T	3	3	6	2	3	11	0	0
16	26142218	.	G	A	2	4	6	2	3	11	0	0
16	26142311	.	A	C	7	16	23	0	1	24	0	0
16	26142405	.	A	G	1	4	5	0	1	6	0	0
16	26142773	.	G	A	6	7	13	0	1	14	0	0
16	26142779	.	C	T	6	6	12	0	0	12	0	0
16	26143082	.	A	G	5	2	7	0	0	7	0	0
16	26143371	.	T	G	7	6	13	0	0	13	0	0
16	26143538	.	C	T	6	5	11	0	0	11	0	0
16	26146174	.	G	A	8	9	17	0	0	17	0	0
16	26146736	.	G	A	7	7	14	0	0	14	0	0
16	26167664	.	C	T	8	3	11	0	0	11	0	0
16	26169515	.	T	G	6	7	13	0	0	13	0	0
16	26170400	.	A	G	4	4	8	0	0	8	0	0
16	26170412	.	G	A	3	5	8	0	0	8	0	0
16	26186178	.	C	A	3	5	8	0	0	8	0	0
16	26186187	.	G	C	4	0	4	0	7	11	0	0
16	26188312	.	C	T	3	6	9	0	1	10	0	0
16	26232369	.	G	T	2	3	5	0	0	5	0	0
16	26234460	.	C	T	2	2	4	0	0	4	0	0
16	26236030	.	T	G	1	2	3	0	0	3	0	0
16	26236200	.	A	C	5	3	8	0	0	8	0	0
16	26236208	.	G	C	3	1	4	0	2	6	0	0
16	26236263	.	G	A	2	4	6	0	0	6	0	0
16	26236664	.	C	A	0	6	6	0	1	7	0	0
16	26237122	.	T	C	4	2	6	0	1	7	0	0
16	26237501	.	A	T	4	5	9	0	0	9	0	0
16	26237564	.	T	A	4	5	9	0	0	9	0	0
16	26255826	.	A	G	4	2	6	0	0	6	0	0
16	26378553	.	T	A	2	3	5	0	0	5	0	0
16	26378655	.	T	C	4	0	4	0	4	8	0	0
16	26378665	.	G	T	4	5	9	0	0	9	0	0
16	26378706	.	G	T	3	5	8	0	1	9	0	0
16	26378729	.	A	G	2	7	9	0	1	10	0	0
16	26379397	.	G	A	5	4	9	0	0	9	0	0
16	26380784	.	C	T	1	8	9	0	9	18	0	0
16	26380866	.	G	A	8	8	16	0	0	16	0	0
16	26381192	.	T	G	8	7	15	0	1	16	0	0
16	26381271	.	C	T	14	4	18	0	1	19	0	0
16	26381344	.	T	G	2	7	9	0	3	12	0	0
16	26381463	.	C	T	2	15	17	0	13	30	0	0
16	26381538	.	T	A	10	13	23	0	0	23	0	0
16	26381768	.	C	T	0	10	10	0	11	21	0	0
16	26382084	.	T	C	7	13	20	0	0	20	0	0
16	26382225	.	A	T	20	11	31	0	0	31	0	0
16	26382243	.	G	A	21	13	34	0	0	34	0	0
16	26382308	.	T	C	19	15	34	0	2	36	0	0
16	26382453	.	T	C	14	0	14	1	13	28	0	0
16	26382585	.	A	G	4	6	10	0	1	11	0	0
16	26382942	.	T	C	16	11	27	0	2	29	0	0
16	26383016	.	C	T	2	19	21	0	23	45	1	0
16	26384188	.	C	G	13	11	24	0	0	24	0	0
16	26384417	.	G	A	14	13	27	0	0	27	0	0
16	26386817	.	T	C	9	11	20	0	1	21	0	0
16	26388840	.	A	G	9	11	20	0	0	20	0	0
16	26391447	.	A	G	8	8	16	0	0	16	0	0
16	26391450	.	C	T	9	8	17	0	0	17	0	0
16	26391970	.	C	A	1	7	8	0	11	19	0	0
16	26393459	.	G	T	5	8	13	0	1	14	0	0
16	26393524	.	T	G	5	8	13	0	0	13	0	0
16	26393525	.	G	A	5	8	13	0	0	13	0	0
16	26396381	.	A	C	6	5	11	0	1	12	0	0
16	26398488	.	G	A	4	2	6	0	0	6	0	0
16	26399488	.	C	T	0	10	10	0	6	16	0	0
16	26404077	.	A	G	5	3	8	0	0	8	0	0
16	26408819	.	G	A	8	5	13	0	1	14	0	0
16	26408847	.	C	T	6	4	10	0	1	11	0	0
16	26408967	.	G	A	6	4	10	0	2	12	0	0
16	26410903	.	G	A	5	3	8	0	0	8	0	0
16	26413746	.	T	C	4	0	4	0	7	11	0	0
16	26420512	.	C	G	4	3	7	0	0	7	0	0
16	26424248	.	C	T	3	4	7	0	0	7	0	0
16	26426225	.	T	A	2	3	5	0	0	5	0	0
16	26426291	.	T	C	1	2	3	0	1	4	0	0
16	26428600	.	G	A	3	4	7	0	1	8	0	0
16	26431539	.	A	C	1	2	3	0	0	3	0	0
16	26431590	.	G	T	5	2	7	0	0	7	0	0
16	26431974	.	C	A	3	8	11	0	0	11	0	0
16	26435405	.	C	A	6	3	9	0	0	9	0	0
16	26435424	.	A	G	6	2	8	0	0	8	0	0
16	26437225	.	C	T	0	2	2	0	2	4	0	0
16	26437307	.	C	A	1	2	3	0	3	6	0	0
16	26439610	.	A	T	2	2	4	0	1	5	0	0
16	26439809	.	T	G	4	5	9	0	1	10	0	0
16	26439860	.	T	C	3	5	8	0	0	8	0	0
16	26441624	.	A	T	7	3	10	0	0	10	0	0
16	26443976	.	C	T	7	5	12	0	1	13	0	0
16	26444976	.	T	A	5	3	8	0	0	8	0	0
16	26445458	.	T	C	3	4	7	0	1	8	0	0
16	26445676	.	A	G	6	0	6	0	3	9	0	0
16	26445990	.	G	A	2	2	4	0	1	5	0	0
16	26510997	.	G	A	2	6	8	0	1	9	0	0
16	26513182	.	G	A	5	2	7	0	0	7	0	0
16	26516813	.	G	C	4	9	13	0	1	14	0	0
16	26517226	.	G	A	2	4	6	0	0	6	0	0
16	26517227	.	T	G	2	4	6	0	0	6	0	0
16	26519040	.	G	A	2	2	4	0	1	5	0	0
16	26537044	.	T	C	2	2	4	0	1	5	0	0
16	26579752	.	T	C	1	2	3	0	0	3	0	0
16	26600209	.	A	G	3	3	6	0	0	6	0	0
16	26612488	.	T	C	5	4	9	0	0	9	0	0
16	26634725	.	T	G	0	2	2	0	1	3	0	0
16	26643598	.	G	C	11	6	17	0	0	17	0	0
16	26643769	.	A	T	4	2	6	0	1	7	0	0
16	26689955	.	T	C	8	8	16	0	1	17	0	0
16	26690939	.	A	C	3	3	6	0	1	7	0	0
16	26690971	.	C	A	4	4	8	0	0	8	0	0
16	26691034	.	A	G	1	0	1	0	3	4	0	0
16	26691145	.	T	A	4	4	8	0	0	8	0	0
16	26691151	.	A	T	3	4	7	0	0	7	0	0
16	26691185	.	G	A	3	7	10	0	0	10	0	0
16	26691240	.	G	A	6	6	12	0	0	12	0	0
16	26691295	.	G	A	0	6	6	0	4	10	0	0
16	26691301	.	C	A	4	5	9	0	0	9	0	0
16	26691491	.	C	T	6	8	14	0	0	14	0	0
16	26691622	.	G	A	7	5	12	0	0	12	0	0
16	26691646	.	T	C	8	1	9	0	1	10	0	0
16	26691665	.	C	T	6	2	8	0	0	8	0	0
16	26691832	.	A	T	8	9	17	0	0	17	0	0
16	26691880	.	C	T	8	8	16	0	1	17	0	0
16	26694549	.	G	C	0	4	4	0	5	9	0	0
16	26694669	.	C	T	4	7	11	0	0	11	0	0
16	26696120	.	G	C	5	2	7	0	1	8	0	0
16	26696759	.	T	G	7	4	11	0	2	13	0	0
16	26696816	.	A	T	5	6	11	0	0	11	0	0
16	26698589	.	G	A	2	4	6	0	0	6	0	0
16	26702745	.	T	C	10	11	21	0	3	24	0	0
16	26702786	.	G	A	0	11	11	0	16	27	0	0
16	26702870	.	T	C	10	11	21	0	0	21	0	0
16	26703111	.	T	C	8	5	13	0	1	14	0	0
16	26706584	.	G	A	7	8	15	0	2	17	0	0
16	26706820	.	C	T	5	11	16	0	2	18	0	0
16	26710900	.	C	A	11	15	26	0	1	27	0	0
16	26710954	.	A	T	9	16	25	0	1	26	0	0
16	26710957	.	G	A	9	14	23	0	2	25	0	0
16	26713964	.	G	T	11	16	27	0	0	27	0	0
16	26717457	.	C	A	4	9	13	0	0	13	0	0
16	26766475	.	C	T	4	5	9	0	1	10	0	0
16	26766508	.	A	T	5	5	10	0	1	11	0	0
16	26766878	.	A	T	3	2	5	0	3	8	0	0
16	26816852	.	G	T	8	4	12	0	1	13	0	0
16	26817069	.	C	T	0	8	8	0	9	17	0	0
16	26817178	.	T	A	8	6	14	0	0	14	0	0
16	26817304	.	T	C	11	0	11	0	5	17	1	0
16	26817358	.	C	T	12	9	21	0	0	21	0	0
16	26817556	.	T	C	5	0	5	0	6	11	0	0
16	26817631	.	C	T	2	7	9	0	6	15	0	0
16	26817754	.	C	T	0	9	9	0	9	18	0	0
16	26817823	.	A	T	6	4	10	0	2	12	0	0
16	26817898	.	G	A	7	6	13	0	0	13	0	0
16	26817922	.	T	C	8	0	8	0	5	13	0	0
16	26818147	.	G	A	5	7	12	0	1	13	0	0
16	26818153	.	G	A	4	7	11	0	1	12	0	0
16	26818213	.	A	T	4	4	8	0	0	8	0	0
16	26818666	.	A	C	7	4	11	0	0	11	0	0
16	26846525	.	G	A	1	2	3	0	0	3	0	0
16	26850833	.	C	T	3	8	11	0	0	11	0	0
16	26850845	.	T	C	4	11	15	0	0	15	0	0
16	26850870	.	G	A	2	9	11	0	1	12	0	0
16	26850885	.	C	T	3	10	13	0	0	13	0	0
16	26851025	.	C	G	1	4	5	0	1	6	0	0
16	26851036	.	T	A	2	4	6	0	0	6	0	0
16	26851191	.	C	T	3	2	5	0	1	6	0	0
16	26855674	.	A	G	13	14	27	0	0	27	0	0
16	26855833	.	C	A	2	15	17	0	7	24	0	0
16	26855859	.	C	A	0	15	15	0	10	25	0	0
16	26855909	.	A	G	4	5	9	0	0	9	0	0
16	26863622	.	T	C	1	5	6	0	0	6	0	0
16	26994588	.	C	T	7	7	14	0	1	15	0	0
16	27025096	.	T	C	15	7	22	0	2	24	0	0
16	27061912	.	A	C	15	11	26	0	0	26	0	0
16	27064864	.	A	G	6	10	16	0	1	17	0	0
16	27069608	.	A	G	11	0	11	0	14	25	0	0
16	27080221	.	T	C	7	10	17	0	1	18	0	0
16	27100222	.	T	C	12	14	26	0	0	26	0	0
16	27127959	.	G	A	21	16	37	1	1	39	0	0
16	27136541	.	A	G	17	10	27	0	2	29	0	0
16	27138391	.	C	G	18	13	31	0	0	31	0	0
16	27148691	.	C	T	14	11	25	0	1	26	0	0
16	27148861	.	G	T	10	9	19	0	3	22	0	0
16	27158753	.	T	C	20	11	31	0	0	31	0	0
16	27159111	.	A	G	12	6	18	0	0	18	0	0
16	27159205	.	T	C	9	1	10	0	7	17	0	0
16	27161327	.	A	T	13	8	21	0	1	22	0	0
16	27166174	.	A	G	14	8	22	0	0	22	0	0
16	27166205	.	A	G	15	9	24	0	1	25	0	0
16	27166277	.	G	A	14	23	37	0	1	38	0	0
16	27169664	.	A	T	19	19	38	0	1	39	0	0
16	27170170	.	G	A	17	20	37	0	0	37	0	0
16	27216398	.	G	T	5	2	7	0	0	7	0	0
16	27224450	.	G	C	28	14	42	0	0	43	1	0
16	27225215	.	C	A	11	17	28	0	1	29	0	0
16	27231416	.	C	T	22	23	45	0	1	46	0	0
16	27345418	.	C	T	6	2	8	1	0	9	0	0
16	27346195	.	T	C	5	8	13	0	0	13	0	0
16	27367624	.	A	G	4	10	14	0	0	14	0	0
16	27368086	.	T	C	7	2	9	0	0	9	0	0
16	27368168	.	A	G	13	0	13	0	11	24	0	0
16	27368290	.	G	A	1	7	8	0	13	21	0	0
16	27369057	.	T	C	2	4	6	0	0	6	0	0
16	27404870	.	T	C	1	2	3	0	0	3	0	0
16	27417415	.	C	A	2	3	5	0	0	5	0	0
16	27417907	.	T	C	13	0	13	0	22	35	0	0
16	27427109	.	T	C	13	10	23	0	1	24	0	0
16	27427919	.	A	G	14	8	22	0	0	22	0	0
16	27428048	.	G	A	8	9	17	0	0	17	0	0
16	27430189	.	G	A	8	12	20	0	0	20	0	0
16	27493735	.	T	C	1	1	2	0	1	3	0	0
16	27493736	.	G	A	1	2	3	0	0	3	0	0
16	27493804	.	T	C	3	3	6	0	0	6	0	0
16	27508505	.	G	A	4	2	6	0	0	6	0	0
16	27513694	.	T	C	2	4	6	0	0	6	0	0
16	27522744	.	T	C	13	5	18	0	1	19	0	0
16	27524890	.	A	T	5	3	8	0	0	8	0	0
16	27524893	.	A	T	5	3	8	0	0	8	0	0
16	27529856	.	G	A	6	5	11	0	0	11	0	0
16	27533654	.	G	C	5	4	9	0	0	9	0	0
16	27533729	.	T	C	5	0	5	0	4	9	0	0
16	27536757	.	C	T	1	3	4	0	4	8	0	0
16	27539330	.	A	C	10	3	13	0	1	14	0	0
16	27539462	.	G	T	4	4	8	0	0	8	0	0
16	27543577	.	G	T	0	8	8	1	14	23	0	0
16	27548076	.	A	G	14	9	23	0	0	23	0	0
16	27554909	.	C	G	13	8	21	0	1	22	0	0
16	27555010	.	T	C	14	11	25	0	2	27	0	0
16	27555011	.	A	C	13	12	25	0	2	27	0	0
16	27555069	.	C	T	15	9	24	0	3	27	0	0
16	27555175	.	T	C	20	14	34	0	0	34	0	0
16	27555221	.	C	T	16	16	32	0	0	32	0	0
16	27569881	.	A	G	1	3	4	0	0	4	0	0
16	27571147	.	A	T	1	3	4	0	0	4	0	0
16	27571153	.	T	C	0	1	1	0	1	2	0	0
16	27575339	.	T	C	1	2	3	0	0	3	0	0
16	27578538	.	C	A	2	2	4	0	0	4	0	0
16	27578607	.	T	A	2	4	6	0	1	7	0	0
16	27615203	.	A	G	9	19	28	0	0	28	0	0
16	27621830	.	T	G	11	18	29	0	2	31	0	0
16	27621869	.	A	G	8	20	28	0	1	29	0	0
16	27626228	.	G	A	21	22	43	0	0	43	0	0
16	27626240	.	A	G	26	27	53	0	0	53	0	0
16	27628860	.	A	T	23	15	38	0	1	39	0	0
16	27629052	.	C	T	24	17	41	0	3	44	0	0
16	27629187	.	A	G	20	18	38	0	1	39	0	0
16	27629455	.	T	G	27	14	41	0	0	41	0	0
16	27629639	.	C	A	24	26	50	0	2	52	0	0
16	27629798	.	A	T	23	18	41	0	2	43	0	0
16	27630087	.	C	T	3	20	23	0	25	48	0	0
16	27630209	.	T	C	21	29	50	0	2	52	0	0
16	27630399	.	G	T	27	19	46	0	1	47	0	0
16	27630663	.	G	A	20	20	40	0	0	40	0	0
16	27630785	.	G	A	10	27	37	0	1	38	0	0
16	27630998	.	T	C	17	0	17	0	15	32	0	0
16	27631229	.	A	T	19	10	29	0	0	29	0	0
16	27631585	.	T	A	20	17	37	0	0	37	0	0
16	27631690	.	T	G	14	21	35	0	0	35	0	0
16	27631741	.	C	A	16	17	33	0	0	33	0	0
16	27631751	.	T	A	15	14	29	0	1	30	0	0
16	27632153	.	C	T	11	21	32	1	0	33	0	0
16	27632189	.	G	A	19	16	35	1	0	36	0	0
16	27632228	.	C	T	23	11	34	0	0	34	0	0
16	27632289	.	C	T	13	11	24	0	0	24	0	0
16	27632520	.	A	T	15	18	33	0	0	33	0	0
16	27632705	.	G	A	16	19	35	0	0	35	0	0
16	27632879	.	T	C	13	14	27	0	1	28	0	0
16	27632880	.	G	A	13	14	27	0	1	28	0	0
16	27632934	.	T	C	13	9	22	0	2	24	0	0
16	27633392	.	C	T	2	12	14	0	23	37	0	0
16	27633812	.	C	T	10	14	24	0	0	24	0	0
16	27633839	.	T	C	11	1	12	0	12	24	0	0
16	27633940	.	C	G	12	11	23	0	2	25	0	0
16	27633950	.	G	T	12	11	23	0	1	24	0	0
16	27640955	.	C	A	2	16	18	3	13	34	0	0
16	27660071	.	T	C	2	0	2	0	3	5	0	0
16	27660271	.	A	G	4	4	8	0	0	8	0	0
16	27660321	.	G	A	11	7	18	0	0	18	0	0
16	27660658	.	A	T	9	3	12	0	1	13	0	0
16	27660750	.	C	T	0	6	6	0	4	10	0	0
16	27660934	.	C	T	7	9	16	0	1	17	0	0
16	27661074	.	A	T	8	7	15	0	0	15	0	0
16	27667213	.	G	A	6	4	10	0	0	10	0	0
16	27669912	.	T	C	5	0	5	0	6	11	0	0
16	27669917	.	T	G	5	8	13	0	0	13	0	0
16	27674156	.	A	G	4	3	7	0	0	7	0	0
16	27675865	.	A	C	5	5	10	0	0	10	0	0
16	27675950	.	G	A	2	5	7	0	0	7	0	0
16	27676008	.	G	A	1	2	3	0	0	3	0	0
16	27676051	.	T	C	1	3	4	0	0	4	0	0
16	27735648	.	A	G	2	3	5	0	0	5	0	0
16	27998747	.	A	G	4	5	9	0	0	9	0	0
16	27998813	.	A	T	2	7	9	0	0	9	0	0
16	28112556	.	C	T	2	2	4	0	0	4	0	0
16	28264350	.	C	T	12	5	17	0	0	17	0	0
16	28276383	.	T	C	15	12	27	0	0	27	0	0
16	28277340	.	C	G	15	11	26	0	1	27	0	0
16	28278360	.	T	C	7	5	12	0	0	12	0	0
16	28280057	.	T	C	8	10	18	0	0	18	0	0
16	28305482	.	G	T	6	5	11	0	1	12	0	0
16	28370465	.	C	T	13	13	26	0	1	27	0	0
16	28370513	.	G	C	13	14	27	0	0	27	0	0
16	28370566	.	A	C	10	5	15	0	4	19	0	0
16	28370703	.	A	G	5	4	9	0	0	9	0	0
16	28370872	.	T	A	2	8	10	0	0	10	0	0
16	28371138	.	T	C	6	5	11	0	0	11	0	0
16	28371148	.	A	G	7	9	16	0	0	16	0	0
16	28511709	.	C	T	1	2	3	0	0	3	0	0
16	28547195	.	A	T	4	2	6	0	0	6	0	0
16	28554272	.	C	T	5	5	10	0	0	10	0	0
16	28557817	.	A	G	6	1	7	0	0	7	0	0
16	28557842	.	A	G	3	0	3	0	5	8	0	0
16	28557889	.	G	A	2	4	6	0	1	7	0	0
16	28557909	.	G	A	1	3	4	1	1	6	0	0
16	28573328	.	G	C	0	8	8	0	9	17	0	0
16	28573634	.	C	T	9	6	15	0	1	16	0	0
16	28573871	.	A	C	7	10	17	0	0	17	0	0
16	28573957	.	T	A	7	3	10	0	0	10	0	0
16	28574403	.	C	T	6	5	11	0	0	11	0	0
16	28574465	.	G	A	2	9	11	0	5	16	0	0
16	28574531	.	T	G	10	9	19	0	0	19	0	0
16	28574664	.	G	A	4	7	11	0	0	11	0	0
16	28580818	.	A	G	5	5	10	0	0	10	0	0
16	28580884	.	T	C	11	11	22	0	0	22	0	0
16	28591186	.	T	A	15	7	22	0	0	22	0	0
16	28591277	.	A	G	16	22	38	0	3	41	0	0
16	28591353	.	A	C	12	13	25	0	1	26	0	0
16	28591385	.	C	G	9	13	22	0	2	24	0	0
16	28591459	.	G	A	0	15	15	0	13	28	0	0
16	28592719	.	T	C	6	5	11	0	0	11	0	0
16	28592939	.	G	A	5	2	7	0	0	7	0	0
16	28593056	.	C	T	2	3	5	0	0	5	0	0
16	28593394	.	G	A	1	2	3	0	1	4	0	0
16	28593403	.	G	A	3	2	5	0	0	5	0	0
16	28593430	.	G	A	6	6	12	0	1	13	0	0
16	28593679	.	T	C	6	0	6	0	6	12	0	0
16	28593802	.	T	C	9	5	14	0	0	14	0	0
16	28593867	.	T	C	6	0	6	0	5	11	0	0
16	28593952	.	T	C	12	8	20	0	2	22	0	0
16	28599150	.	C	T	15	13	28	0	1	29	0	0
16	28602514	.	A	G	1	3	4	0	0	4	0	0
16	28620777	.	A	G	4	4	8	0	0	8	0	0
16	28622321	.	G	A	0	6	6	0	5	11	0	0
16	28624580	.	T	C	5	3	8	0	1	9	0	0
16	28626601	.	A	C	3	2	5	0	0	5	0	0
16	28626743	.	A	G	4	2	6	0	0	6	0	0
16	28627127	.	C	T	4	2	6	0	1	7	0	0
16	28627485	.	C	T	2	2	4	0	0	4	0	0
16	28627507	.	G	A	2	2	4	0	0	4	0	0
16	28629504	.	C	T	7	9	16	0	0	16	0	0
16	28632525	.	C	T	5	6	11	0	0	11	0	0
16	28634954	.	G	A	6	5	11	0	1	12	0	0
16	28644445	.	T	C	1	2	3	0	0	3	0	0
16	28663287	.	T	C	0	2	2	0	1	3	0	0
16	28663405	.	A	G	2	2	4	0	1	5	0	0
16	28664970	.	T	G	3	3	6	0	0	6	0	0
16	28665700	.	A	G	1	2	3	0	0	3	0	0
16	28665707	.	C	T	3	4	7	0	0	7	0	0
16	28665912	.	G	T	1	2	3	0	0	3	0	0
16	28665925	.	C	T	1	2	3	0	1	4	0	0
16	28666079	.	C	A	1	5	6	0	0	6	0	0
16	28667189	.	C	A	2	2	4	0	0	4	0	0
16	28667313	.	A	G	3	8	11	0	0	11	0	0
16	28678649	.	C	A	4	2	6	0	1	7	0	0
16	28684937	.	A	G	3	2	5	0	0	5	0	0
16	28684991	.	C	T	2	3	5	0	0	5	0	0
16	28686456	.	C	T	0	2	2	0	4	6	0	0
16	28842438	.	C	T	29	19	48	0	3	51	0	0
16	28846595	.	G	T	21	13	34	0	2	36	0	0
16	28846647	.	G	T	18	14	32	0	1	33	0	0
16	28846761	.	T	C	15	13	28	0	1	29	0	0
16	28855946	.	C	G	15	16	31	0	1	32	0	0
16	28856026	.	G	A	22	28	50	0	2	52	0	0
16	28856034	.	G	A	21	25	46	0	0	46	0	0
16	28965740	.	A	G	2	4	6	1	0	7	0	0
16	28965773	.	C	T	3	3	6	1	0	7	0	0
16	28971390	.	C	T	1	3	4	0	1	5	0	0
16	28983689	.	G	A	1	2	3	0	0	3	0	0
16	28983897	.	G	A	2	3	5	0	2	7	0	0
16	28986722	.	A	G	1	4	5	0	0	5	0	0
16	28986728	.	C	T	3	3	6	0	1	7	0	0
16	28990523	.	C	G	2	4	6	0	0	6	0	0
16	29003349	.	C	T	2	4	6	0	0	6	0	0
16	29009092	.	G	T	5	4	9	0	0	9	0	0
16	29010125	.	C	T	5	2	7	0	0	7	0	0
16	29010293	.	T	G	9	0	9	0	5	14	0	0
16	29010819	.	A	G	4	7	11	0	0	11	0	0
16	29012933	.	G	T	2	11	13	0	8	21	0	0
16	29012961	.	C	T	4	11	15	0	2	17	0	0
16	29012992	.	A	G	5	1	6	0	7	13	0	0
16	29013039	.	C	G	7	4	11	0	0	11	0	0
16	29013126	.	C	T	3	8	11	0	0	11	0	0
16	29013134	.	C	A	3	7	10	0	1	11	0	0
16	29013188	.	C	T	4	6	10	0	0	10	0	0
16	29013327	.	C	A	7	6	13	0	0	13	0	0
16	29013377	.	C	T	9	6	15	0	0	15	0	0
16	29014091	.	A	T	2	5	7	0	0	7	0	0
16	29014109	.	T	C	2	5	7	0	0	7	0	0
16	29016904	.	T	C	8	5	13	0	1	14	0	0
16	29017221	.	T	C	6	5	11	0	0	11	0	0
16	29019039	.	G	A	8	9	17	0	0	17	0	0
16	29020482	.	G	T	8	15	23	0	1	24	0	0
16	29023266	.	A	T	6	7	13	0	0	13	0	0
16	29024280	.	T	G	4	0	4	0	4	8	0	0
16	29024341	.	T	C	3	3	6	0	0	6	0	0
16	29024405	.	C	T	5	2	7	0	1	8	0	0
16	29024409	.	C	T	6	2	8	0	0	8	0	0
16	29029296	.	T	C	6	3	9	0	1	10	0	0
16	29029476	.	A	G	3	2	5	0	0	5	0	0
16	29029593	.	G	A	4	4	8	0	0	8	0	0
16	29029797	.	A	G	4	0	4	0	4	8	0	0
16	29030199	.	A	G	0	2	2	0	1	3	0	0
16	29030204	.	A	G	2	0	2	0	2	4	0	0
16	29030235	.	A	G	1	3	4	0	0	4	0	0
16	29030383	.	G	C	3	3	6	0	0	6	0	0
16	29050827	.	C	T	1	4	5	0	0	5	0	0
16	29050894	.	T	G	3	0	3	0	2	5	0	0
16	29050911	.	C	T	5	4	9	0	0	9	0	0
16	29050964	.	A	T	4	5	9	0	0	9	0	0
16	29050983	.	A	G	2	3	5	0	0	5	0	0
16	29051095	.	A	T	3	3	6	0	0	6	0	0
16	29051102	.	G	A	3	2	5	0	0	5	0	0
16	29051841	.	C	G	5	9	14	0	0	14	0	0
16	29051842	.	C	A	5	9	14	0	0	14	0	0
16	29052030	.	C	T	8	9	17	0	0	17	0	0
16	29052096	.	G	T	2	3	5	0	4	9	0	0
16	29052120	.	A	G	4	7	11	0	1	12	0	0
16	29052137	.	A	G	3	8	11	0	1	12	0	0
16	29052156	.	A	G	3	7	10	0	0	10	0	0
16	29052245	.	G	T	4	3	7	0	2	9	0	0
16	29052653	.	A	T	7	9	16	0	0	16	0	0
16	29052752	.	C	G	5	0	5	0	6	11	0	0
16	29052914	.	G	A	11	4	15	0	2	17	0	0
16	29052991	.	C	T	6	9	15	0	1	16	0	0
16	29053045	.	T	A	8	8	16	0	0	16	0	0
16	29053166	.	A	G	9	4	13	0	0	13	0	0
16	29053669	.	A	G	3	5	8	0	0	8	0	0
16	29053781	.	A	T	9	14	23	0	1	24	0	0
16	29053798	.	C	G	11	0	11	0	17	28	0	0
16	29053923	.	C	A	3	4	7	0	2	9	0	0
16	29073092	.	T	A	5	1	6	0	0	6	0	0
16	29073184	.	A	T	3	2	5	0	1	6	0	0
16	29073621	.	T	A	6	4	10	0	1	11	0	0
16	29074254	.	G	A	32	21	53	0	2	55	0	0
16	29074535	.	A	G	16	15	31	0	1	32	0	0
16	29074688	.	A	G	16	24	40	0	1	41	0	0
16	29075222	.	T	A	9	13	22	0	1	23	0	0
16	29075343	.	G	A	20	13	33	0	2	35	0	0
16	29075674	.	C	A	13	17	30	0	3	33	0	0
16	29075757	.	A	G	14	15	29	0	0	29	0	0
16	29075870	.	G	T	11	22	33	0	0	33	0	0
16	29075959	.	C	T	13	15	28	0	6	34	0	0
16	29076009	.	T	A	13	20	33	0	1	34	0	0
16	29076019	.	A	C	14	21	35	0	1	36	0	0
16	29076407	.	C	T	0	17	17	0	27	44	0	0
16	29076575	.	C	G	2	17	19	0	22	41	0	0
16	29076633	.	G	A	25	19	44	1	1	46	0	0
16	29076669	.	A	G	21	26	47	1	1	49	0	0
16	29076678	.	T	C	18	0	18	1	27	46	0	0
16	29091699	.	T	C	16	16	32	0	4	36	0	0
16	29111066	.	T	C	10	0	10	0	27	37	0	0
16	29146310	.	A	G	15	9	24	0	1	25	0	0
16	29146623	.	G	A	9	16	25	0	2	27	0	0
16	29146646	.	A	G	10	15	25	0	0	25	0	0
16	29194443	.	A	G	25	15	40	0	0	40	0	0
16	29222033	.	T	C	14	25	39	0	1	40	0	0
16	29222167	.	G	A	12	21	33	0	1	34	0	0
16	29225902	.	G	C	3	15	18	0	1	19	0	0
16	29226151	.	C	T	4	4	8	0	0	8	0	0
16	29226538	.	G	T	3	5	8	0	0	8	0	0
16	29226566	.	T	C	1	7	8	0	0	8	0	0
16	29305685	.	A	G	1	3	4	0	1	5	0	0
16	29306111	.	C	T	5	2	7	0	2	9	0	0
16	29306132	.	C	A	3	2	5	0	0	5	0	0
16	29306983	.	T	C	11	7	18	0	0	18	0	0
16	29307100	.	G	C	6	8	14	0	0	14	0	0
16	29310150	.	T	A	1	2	3	0	0	3	0	0
16	29310206	.	A	G	7	3	10	0	1	11	0	0
16	29310213	.	C	A	7	2	9	0	1	10	0	0
16	29310281	.	C	G	10	7	17	1	0	18	0	0
16	29310455	.	C	T	15	4	19	0	1	20	0	0
16	29310530	.	C	A	14	11	25	0	2	27	0	0
16	29310541	.	A	G	14	8	22	0	0	22	0	0
16	29311367	.	C	A	20	9	29	0	1	30	0	0
16	29311381	.	G	A	20	6	26	0	1	27	0	0
16	29311489	.	A	G	18	10	28	0	1	29	0	0
16	29311720	.	T	C	18	6	24	0	0	24	0	0
16	29313766	.	G	A	17	7	24	0	0	24	0	0
16	29314147	.	C	A	19	6	25	0	1	26	0	0
16	29320647	.	A	G	20	7	27	0	0	27	0	0
16	29320897	.	T	A	14	5	19	0	0	19	0	0
16	29321310	.	C	T	16	7	23	0	0	23	0	0
16	29323247	.	A	T	13	9	22	0	1	23	0	0
16	29323865	.	G	A	14	10	24	0	0	24	0	0
16	29324825	.	G	T	7	9	16	0	1	17	0	0
16	29324828	.	T	C	5	9	14	0	2	16	0	0
16	29325232	.	A	G	11	4	15	0	1	16	0	0
16	29328608	.	C	T	1	3	4	0	7	11	0	0
16	29330481	.	G	A	6	2	8	0	0	8	0	0
16	29380846	.	C	G	3	8	11	0	0	11	0	0
16	29381076	.	A	C	4	4	8	0	0	8	0	0
16	29381123	.	G	A	2	3	5	0	4	9	0	0
16	29381125	.	A	G	3	4	7	0	2	9	0	0
16	29381369	.	G	A	2	3	5	0	0	5	0	0
16	29383834	.	A	C	3	3	6	0	1	7	0	0
16	29384090	.	T	C	3	4	7	0	1	9	1	0
16	29384099	.	T	A	3	4	7	0	1	8	0	0
16	29384139	.	G	A	1	4	5	0	0	5	0	0
16	29384182	.	C	T	4	4	8	0	0	8	0	0
16	29384187	.	T	C	4	4	8	0	0	8	0	0
16	29390157	.	T	A	2	2	4	0	0	4	0	0
16	29390189	.	T	G	1	2	3	0	0	3	0	0
16	29407754	.	C	T	3	4	7	0	1	8	0	0
16	29408060	.	T	C	25	17	42	1	3	46	0	0
16	29408172	.	T	A	34	29	63	0	2	66	1	0
16	29408926	.	A	T	20	14	34	0	1	36	1	0
16	29409181	.	T	A	2	3	5	0	0	5	0	0
16	29409219	.	A	G	2	3	5	0	2	7	0	0
16	29409341	.	T	C	23	10	33	0	2	35	0	0
16	29409361	.	T	C	24	15	39	0	0	39	0	0
16	29409476	.	T	C	29	17	46	0	3	49	0	0
16	29409480	.	T	C	33	15	48	0	2	50	0	0
16	29409732	.	T	G	28	24	52	0	2	54	0	0
16	29409810	.	T	C	25	17	42	0	2	44	0	0
16	29409876	.	T	C	27	15	42	0	0	42	0	0
16	29409918	.	T	G	22	10	32	0	2	34	0	0
16	29410032	.	A	G	21	19	40	0	0	40	0	0
16	29410033	.	G	A	21	18	39	0	2	41	0	0
16	29410107	.	A	C	20	33	53	0	1	54	0	0
16	29410129	.	C	T	21	31	52	0	4	56	0	0
16	29410251	.	T	A	22	19	41	0	2	43	0	0
16	29410418	.	C	T	2	24	26	0	29	55	0	0
16	29410425	.	A	G	29	23	52	0	2	54	0	0
16	29410620	.	T	C	25	0	25	2	10	37	0	0
16	29410679	.	T	G	18	24	42	0	0	42	0	0
16	29410921	.	G	A	28	23	51	0	1	52	0	0
16	29411196	.	A	G	24	27	51	0	1	52	0	0
16	29411436	.	G	C	21	23	44	0	0	44	0	0
16	29411646	.	G	A	20	15	35	0	2	37	0	0
16	29411741	.	T	A	15	11	26	0	1	27	0	0
16	29411830	.	T	G	6	4	10	0	1	11	0	0
16	29412074	.	T	A	10	12	22	0	0	23	1	0
16	29413166	.	C	T	23	24	47	0	1	48	0	0
16	29424985	.	T	A	11	17	28	0	0	28	0	0
16	29431617	.	A	G	16	16	32	0	3	35	0	0
16	29456131	.	T	A	3	4	7	0	0	7	0	0
16	29457158	.	A	G	9	12	21	0	1	22	0	0
16	29457320	.	T	C	17	0	17	0	14	31	0	0
16	29457819	.	C	T	1	7	8	0	4	12	0	0
16	29457866	.	A	G	9	5	14	0	0	14	0	0
16	29458226	.	C	G	9	10	19	0	0	19	0	0
16	29458388	.	T	C	9	0	9	0	9	18	0	0
16	29458403	.	A	G	8	8	16	0	0	16	0	0
16	29461000	.	T	A	9	11	20	0	0	20	0	0
16	30268660	.	A	G	11	4	15	0	4	19	0	0
16	30423224	.	T	C	5	0	5	0	5	10	0	0
16	31516398	.	A	G	1	7	8	0	1	9	0	0
16	31516536	.	T	C	5	3	8	0	0	8	0	0
16	31516778	.	A	G	4	2	6	0	0	6	0	0
16	31602170	.	A	G	3	7	10	0	0	10	0	0
16	31608012	.	A	G	12	3	15	0	1	16	0	0
16	31608101	.	C	T	1	4	5	0	6	11	0	0
16	31608967	.	G	T	5	3	8	0	1	9	0	0
16	31609241	.	C	T	1	15	16	0	9	25	0	0
16	31610375	.	C	T	6	8	14	0	0	14	0	0
16	31614272	.	C	G	10	10	20	0	2	22	0	0
16	31614918	.	G	A	7	12	19	0	1	20	0	0
16	31615114	.	G	A	13	10	23	0	3	26	0	0
16	31717856	.	G	T	3	3	6	0	0	6	0	0
16	31762960	.	C	T	10	12	22	0	0	22	0	0
16	31763316	.	T	C	19	13	32	0	2	34	0	0
16	31763318	.	C	T	17	14	31	0	3	34	0	0
16	31763668	.	C	G	10	17	27	2	2	31	0	0
16	31763743	.	T	A	18	21	39	0	1	40	0	0
16	31763751	.	A	C	19	18	37	0	0	37	0	0
16	31763785	.	G	A	22	21	43	0	0	43	0	0
16	31763786	.	C	A	22	21	43	0	0	43	0	0
16	31763880	.	A	G	22	23	45	0	0	45	0	0
16	31764987	.	C	T	13	11	24	0	0	24	0	0
16	31766937	.	T	A	16	12	28	0	2	30	0	0
16	31767116	.	T	C	12	1	13	0	12	25	0	0
16	31767152	.	A	G	17	12	29	1	3	33	0	0
16	31767163	.	G	A	16	14	30	1	0	31	0	0
16	31767191	.	T	C	16	14	30	1	2	33	0	0
16	31768343	.	C	G	10	18	28	0	2	30	0	0
16	31768394	.	T	C	11	14	25	0	1	26	0	0
16	31768436	.	T	C	10	17	27	1	1	29	0	0
16	31769317	.	G	A	26	18	44	0	0	44	0	0
16	31769395	.	A	G	13	14	27	0	1	28	0	0
16	31769428	.	G	A	10	10	20	0	2	22	0	0
16	31770050	.	T	C	10	0	10	0	8	18	0	0
16	31776125	.	C	T	13	9	22	0	1	23	0	0
16	31780108	.	C	T	1	10	11	0	10	21	0	0
16	31782938	.	C	T	5	6	11	0	0	11	0	0
16	31789327	.	C	T	11	8	19	0	1	20	0	0
16	31790262	.	C	T	15	8	23	0	2	25	0	0
16	31810842	.	C	T	0	2	2	0	1	3	0	0
16	31815515	.	G	A	11	2	13	0	3	16	0	0
16	31815517	.	G	A	11	3	14	0	2	16	0	0
16	31815878	.	G	A	8	12	20	0	2	22	0	0
16	31816005	.	C	A	16	5	21	0	0	21	0	0
16	31816205	.	C	T	12	3	15	0	0	15	0	0
16	31816336	.	C	T	1	12	13	0	9	22	0	0
16	31816596	.	C	T	16	18	34	0	0	34	0	0
16	31827642	.	T	A	27	14	41	0	1	42	0	0
16	31827703	.	C	T	27	20	47	0	1	48	0	0
16	31832606	.	A	G	26	3	29	0	35	64	0	0
16	31834549	.	T	A	2	3	5	0	0	5	0	0
16	31853932	.	T	A	14	13	27	0	2	29	0	0
16	31854325	.	C	A	15	8	23	0	5	28	0	0
16	31855271	.	T	C	7	10	17	0	0	17	0	0
16	31855327	.	G	A	7	10	17	0	2	19	0	0
16	31855351	.	G	C	9	10	19	0	2	21	0	0
16	31855575	.	C	T	15	14	29	0	1	30	0	0
16	31855576	.	C	T	17	13	30	0	1	31	0	0
16	31855814	.	T	G	11	4	15	0	14	29	0	0
16	31856239	.	A	G	9	5	14	0	1	15	0	0
16	31856276	.	G	A	2	6	8	0	16	24	0	0
16	31859227	.	T	C	16	21	37	0	1	38	0	0
16	31859341	.	C	T	19	21	40	0	4	44	0	0
16	31859371	.	T	C	23	23	46	2	0	48	0	0
16	31859416	.	T	C	9	20	29	1	6	36	0	0
16	31859425	.	C	T	3	17	20	0	7	27	0	0
16	31859686	.	G	A	5	12	17	0	1	18	0	0
16	31868443	.	G	A	12	15	27	0	1	28	0	0
16	31922892	.	A	G	31	26	57	0	1	58	0	0
16	31923083	.	G	A	39	28	67	0	2	69	0	0
16	31923435	.	A	G	40	22	62	0	2	64	0	0
16	31924485	.	T	C	20	24	44	0	3	47	0	0
16	31924501	.	A	C	18	29	47	0	0	47	0	0
16	31942663	.	C	A	3	3	6	0	0	6	0	0
16	31946327	.	A	G	3	0	3	1	7	11	0	0
16	31946857	.	T	C	6	4	10	0	0	10	0	0
16	31951694	.	G	C	3	4	7	0	1	8	0	0
16	31952252	.	G	C	3	2	5	0	0	5	0	0
16	31955226	.	C	G	5	6	11	0	0	11	0	0
16	31958957	.	G	T	2	7	9	0	0	9	0	0
16	31959156	.	G	A	4	2	6	0	0	6	0	0
16	31959225	.	G	A	7	5	12	0	0	12	0	0
16	31959231	.	A	T	7	6	13	0	0	13	0	0
16	31959612	.	G	A	4	3	7	0	0	7	0	0
16	31959648	.	G	A	0	2	2	0	7	9	0	0
16	31959845	.	A	G	5	1	6	0	3	9	0	0
16	31960037	.	G	A	1	4	5	0	7	12	0	0
16	31960064	.	G	C	5	6	11	0	0	11	0	0
16	31960145	.	C	T	9	4	13	0	0	13	0	0
16	31960152	.	C	T	7	5	12	0	1	13	0	0
16	32013272	.	G	A	7	7	14	0	0	14	0	0
16	32013766	.	T	G	4	2	6	0	0	6	0	0
16	32013861	.	G	A	4	5	9	0	0	9	0	0
16	32013891	.	G	A	3	4	7	0	0	7	0	0
16	32014627	.	T	A	5	5	10	0	0	10	0	0
16	32014633	.	A	T	5	4	9	0	0	9	0	0
16	32019695	.	G	A	6	9	15	0	1	16	0	0
16	32021999	.	C	T	4	7	11	0	0	11	0	0
16	32023124	.	T	A	9	5	14	0	0	14	0	0
16	32025648	.	T	A	9	14	23	0	1	24	0	0
16	32025978	.	G	A	8	4	12	0	2	14	0	0
16	32025987	.	T	A	14	5	19	0	0	19	0	0
16	32026063	.	G	A	1	5	6	2	12	20	0	0
16	32026105	.	T	A	9	6	15	1	0	16	0	0
16	32026154	.	T	G	3	5	8	0	0	8	0	0
16	32051854	.	A	C	5	10	15	0	0	15	0	0
16	32052004	.	T	G	12	9	21	0	0	21	0	0
16	32052283	.	T	A	6	10	16	0	0	16	0	0
16	32052307	.	T	C	11	7	18	0	0	18	0	0
16	32052328	.	T	A	9	10	19	0	0	19	0	0
16	32052404	.	G	T	2	6	8	0	8	16	0	0
16	32055726	.	T	G	8	14	22	0	1	23	0	0
16	32057809	.	T	C	4	5	9	0	0	9	0	0
16	32057853	.	G	A	0	5	5	0	4	9	0	0
16	32060021	.	G	A	0	12	12	0	18	30	0	0
16	32060121	.	G	T	11	7	18	0	3	21	0	0
16	32060130	.	C	A	14	9	23	0	1	24	0	0
16	32063433	.	C	T	11	15	26	0	0	26	0	0
16	32066465	.	T	C	6	8	14	0	0	14	0	0
16	32067316	.	A	C	13	8	21	0	1	22	0	0
16	32068332	.	G	A	6	15	21	0	0	21	0	0
16	32068452	.	C	A	10	9	19	0	1	20	0	0
16	32068503	.	T	C	15	13	28	0	2	30	0	0
16	32068824	.	G	C	7	9	16	0	0	16	0	0
16	32069310	.	T	A	19	20	39	0	4	43	0	0
16	32069653	.	A	G	13	15	28	0	2	30	0	0
16	32070489	.	A	G	15	1	16	0	12	28	0	0
16	32070570	.	C	T	17	8	25	0	2	27	0	0
16	32070981	.	G	C	16	21	37	0	1	38	0	0
16	32071965	.	G	C	13	11	24	0	0	24	0	0
16	32071997	.	C	A	12	11	23	0	2	25	0	0
16	32072334	.	A	G	14	18	32	0	2	34	0	0
16	32073301	.	A	C	22	24	46	0	0	46	0	0
16	32073507	.	A	C	22	26	48	0	0	49	1	0
16	32073555	.	A	G	25	28	53	0	1	54	0	0
16	32073760	.	G	A	24	18	42	0	3	45	0	0
16	32074041	.	G	A	25	13	38	0	4	42	0	0
16	32074257	.	A	G	22	1	23	0	26	49	0	0
16	32074293	.	T	A	23	25	48	0	0	48	0	0
16	32074294	.	A	G	23	24	47	0	1	48	0	0
16	32080069	.	G	T	1	7	8	0	9	17	0	0
16	32080306	.	T	A	8	3	11	0	0	11	0	0
16	32080508	.	T	A	11	8	19	0	0	19	0	0
16	32080738	.	G	A	2	6	8	0	1	9	0	0
16	32082397	.	T	C	19	12	31	0	0	31	0	0
16	32082589	.	G	A	10	16	26	0	1	27	0	0
16	32082597	.	G	A	10	16	26	0	0	26	0	0
16	32082642	.	G	A	9	5	14	0	2	16	0	0
16	32085319	.	T	A	8	10	18	0	4	22	0	0
16	32085631	.	A	G	8	7	15	0	0	15	0	0
16	32085778	.	A	C	4	6	10	0	0	10	0	0
16	32086136	.	C	T	9	8	17	0	1	18	0	0
16	32088580	.	T	A	7	6	13	0	2	15	0	0
16	32090349	.	C	T	12	10	22	0	0	22	0	0
16	32090425	.	G	C	8	8	16	0	0	16	0	0
16	32110659	.	A	G	13	12	25	0	0	25	0	0
16	32111246	.	G	T	14	12	26	0	2	28	0	0
16	32113155	.	G	A	14	11	25	0	3	28	0	0
16	32113218	.	G	A	12	12	24	0	1	25	0	0
16	32116790	.	A	T	14	16	30	0	0	30	0	0
16	32117345	.	T	A	8	18	26	0	7	33	0	0
16	32119581	.	C	A	9	7	16	0	2	18	0	0
16	32119618	.	C	T	9	8	17	0	1	18	0	0
16	32119895	.	G	T	14	7	21	0	0	21	0	0
16	32120138	.	G	T	13	15	28	0	0	28	0	0
16	32120141	.	T	C	11	1	12	0	16	28	0	0
16	32120173	.	G	A	13	13	26	0	1	27	0	0
16	32120204	.	G	T	11	12	23	0	3	26	0	0
16	32120279	.	A	C	11	8	19	0	0	19	0	0
16	32128259	.	T	A	8	10	18	0	1	19	0	0
16	32131692	.	T	G	6	4	10	0	2	12	0	0
16	32140378	.	C	T	4	5	9	0	0	9	0	0
16	32140638	.	G	C	6	5	11	0	0	11	0	0
16	32140767	.	G	A	1	3	4	0	0	4	0	0
16	32140977	.	C	T	5	4	9	0	0	9	0	0
16	32140999	.	A	G	4	4	8	0	0	8	0	0
16	32141036	.	G	A	5	5	10	0	0	10	0	0
16	32141058	.	A	G	4	3	7	0	1	8	0	0
16	32141075	.	G	A	5	5	10	0	0	10	0	0
16	32141544	.	A	G	13	0	13	0	16	29	0	0
16	32141565	.	A	C	17	13	30	0	1	31	0	0
16	32141604	.	A	T	5	5	10	0	1	11	0	0
16	32144337	.	T	C	6	8	14	0	1	15	0	0
16	32144377	.	T	C	5	10	15	0	1	16	0	0
16	32144854	.	G	T	1	5	6	0	7	13	0	0
16	32144989	.	T	C	7	4	11	0	0	11	0	0
16	32145160	.	T	A	3	6	9	0	3	12	0	0
16	32145357	.	G	A	2	2	4	0	0	4	0	0
16	32145391	.	G	A	4	2	6	0	0	6	0	0
16	32145547	.	T	C	5	8	13	0	0	13	0	0
16	32145636	.	A	G	3	9	12	0	0	12	0	0
16	32167742	.	C	A	6	2	8	0	0	8	0	0
16	32184563	.	T	C	1	2	3	0	1	4	0	0
16	32197969	.	C	T	14	13	27	0	1	28	0	0
16	32241591	.	C	T	1	5	6	0	1	7	0	0
16	32252878	.	A	G	4	7	11	0	0	11	0	0
16	32257179	.	T	A	1	1	2	0	1	3	0	0
16	32267128	.	G	A	9	4	13	0	0	13	0	0
16	32267203	.	G	A	0	7	7	0	11	18	0	0
16	32270080	.	T	A	1	2	3	0	0	3	0	0
16	32273066	.	G	T	6	3	9	0	1	10	0	0
16	32273192	.	G	A	1	5	6	0	5	11	0	0
16	32274935	.	G	A	5	7	12	0	2	14	0	0
16	32275601	.	T	A	6	2	8	0	0	8	0	0
16	32275628	.	A	T	4	7	11	0	0	11	0	0
16	32289737	.	G	A	2	2	4	0	0	4	0	0
16	32561581	.	T	A	1	6	7	0	0	7	0	0
16	32562038	.	A	T	9	3	12	0	0	12	0	0
16	32562817	.	A	T	3	2	5	0	0	5	0	0
16	33102463	.	C	T	33	12	45	1	3	49	0	0
16	33735481	.	G	A	5	8	13	0	0	13	0	0
16	33735503	.	C	T	5	6	11	0	0	11	0	0
16	33736038	.	G	A	0	2	2	0	1	3	0	0
16	33773940	.	G	C	3	2	5	0	0	5	0	0
16	33773954	.	T	A	2	3	5	0	0	5	0	0
16	33774448	.	C	T	2	2	4	0	0	4	0	0
16	33902151	.	C	T	2	3	5	0	0	5	0	0
16	33905018	.	C	T	4	4	8	0	1	9	0	0
16	33909384	.	G	A	1	2	3	0	5	8	0	0
16	33910029	.	C	T	3	6	9	0	0	9	0	0
16	33910329	.	T	A	3	3	6	0	0	6	0	0
16	33919623	.	G	A	3	8	11	0	1	12	0	0
16	33923448	.	G	T	5	10	15	1	0	16	0	0
16	33923514	.	G	A	7	8	15	0	0	15	0	0
16	33925132	.	G	C	9	6	15	0	0	15	0	0
16	33925565	.	T	G	5	4	9	0	0	9	0	0
16	33928015	.	G	A	2	2	4	0	0	4	0	0
16	33929746	.	C	T	2	2	4	0	0	4	0	0
16	33933213	.	C	T	10	13	23	0	0	23	0	0
16	33933496	.	G	C	6	3	9	0	0	9	0	0
16	33933498	.	C	T	2	5	7	0	1	8	0	0
16	33939824	.	T	C	11	4	15	0	0	15	0	0
16	33939859	.	C	T	10	4	14	0	0	14	0	0
16	33940098	.	G	A	2	3	5	0	0	5	0	0
16	33940122	.	G	A	3	3	6	0	0	6	0	0
16	33940364	.	A	G	6	0	6	0	9	15	0	0
16	33940379	.	T	A	4	10	14	0	2	16	0	0
16	33953652	.	T	A	3	9	12	0	1	13	0	0
16	33953968	.	C	T	13	9	22	0	0	22	0	0
16	33964788	.	G	T	7	3	10	0	1	12	1	0
16	33971993	.	G	A	2	8	10	1	6	17	0	0
16	33972008	.	G	A	9	7	16	0	0	16	0	0
16	33972037	.	A	C	7	10	17	0	1	18	0	0
16	33972067	.	A	G	9	9	18	0	2	20	0	0
16	33972193	.	G	A	2	9	11	2	13	26	0	0
16	33972242	.	G	T	14	8	22	5	1	28	0	0
16	33972249	.	C	T	9	9	18	4	0	22	0	0
16	33972454	.	C	T	14	14	28	0	2	30	0	0
16	33978019	.	A	G	12	0	12	0	13	25	0	0
16	33979746	.	A	T	5	7	12	0	0	12	0	0
16	33981439	.	C	T	14	8	22	0	1	23	0	0
16	33981873	.	A	G	12	0	12	0	15	27	0	0
16	33983784	.	T	G	7	10	17	0	1	18	0	0
16	33983904	.	C	T	10	11	21	0	0	21	0	0
16	33984178	.	C	T	8	4	12	0	0	12	0	0
16	33984190	.	C	T	9	5	14	0	1	15	0	0
16	33985050	.	G	T	1	13	14	0	18	32	0	0
16	33985362	.	C	T	11	12	23	0	2	25	0	0
16	33986179	.	A	T	14	6	20	0	2	22	0	0
16	33986452	.	T	G	14	19	33	0	1	34	0	0
16	33988021	.	C	T	1	2	3	0	1	4	0	0
16	33988049	.	T	C	2	3	5	0	0	5	0	0
16	33988069	.	C	A	3	4	7	0	0	7	0	0
16	33989231	.	G	A	0	3	3	0	2	5	0	0
16	33989391	.	A	G	2	0	2	0	3	5	0	0
16	33989606	.	G	T	0	2	2	0	5	7	0	0
16	33992799	.	C	G	2	2	4	0	0	4	0	0
16	33994640	.	G	A	0	6	6	0	3	9	0	0
16	33995754	.	G	A	0	5	5	0	5	10	0	0
16	34004562	.	G	A	0	7	7	0	15	22	0	0
16	34004595	.	T	C	18	6	24	0	1	25	0	0
16	34004862	.	C	T	3	7	10	0	0	10	0	0
16	34004957	.	T	A	6	0	6	0	1	8	1	0
16	34005290	.	C	T	6	4	10	0	0	10	0	0
16	34005500	.	C	A	5	3	8	0	0	8	0	0
16	34005577	.	A	G	5	4	9	0	0	9	0	0
16	34005669	.	C	T	6	6	12	0	1	13	0	0
16	34005686	.	C	T	9	5	14	0	0	14	0	0
16	34005845	.	A	G	4	2	6	0	1	7	0	0
16	34005885	.	C	T	3	2	5	0	0	5	0	0
16	34006051	.	G	A	2	2	4	0	0	4	0	0
16	34046775	.	A	G	2	6	8	0	0	8	0	0
16	34053445	.	A	G	1	2	3	0	0	3	0	0
16	34053917	.	A	G	2	2	4	0	1	5	0	0
16	34054141	.	A	G	6	3	9	0	0	9	0	0
16	34054171	.	A	G	5	7	12	0	1	13	0	0
16	34054321	.	C	T	5	3	8	0	0	8	0	0
16	34054345	.	A	G	4	0	4	0	6	10	0	0
16	34054464	.	C	A	2	6	8	0	0	8	0	0
16	34054515	.	A	G	4	4	8	0	0	8	0	0
16	34054519	.	C	T	3	4	7	0	1	8	0	0
16	34054712	.	T	G	7	0	7	0	7	14	0	0
16	34054778	.	G	A	3	3	6	0	0	6	0	0
16	34054786	.	T	G	2	3	5	0	0	5	0	0
16	34055788	.	T	C	1	2	3	0	0	3	0	0
16	34134630	.	T	C	4	2	6	0	0	6	0	0
16	34160860	.	T	G	6	3	9	0	0	9	0	0
16	34172916	.	G	A	7	5	12	0	0	12	0	0
16	34173000	.	T	C	9	4	13	0	2	15	0	0
16	34173331	.	G	A	2	5	7	0	0	7	0	0
16	34173954	.	G	T	3	2	5	0	1	6	0	0
16	34185709	.	A	C	2	2	4	0	1	5	0	0
16	34185906	.	A	T	5	10	15	0	1	16	0	0
16	34193926	.	C	T	5	2	7	0	1	8	0	0
16	34200704	.	C	T	24	17	41	0	1	42	0	0
16	34201023	.	A	G	25	10	35	0	1	36	0	0
16	34208582	.	T	C	19	1	20	0	14	34	0	0
16	34208696	.	A	G	23	17	40	0	1	41	0	0
16	34212477	.	A	G	14	13	27	0	1	28	0	0
16	34212516	.	A	G	16	16	32	0	0	32	0	0
16	34212565	.	G	A	18	20	38	0	4	42	0	0
16	34212567	.	G	C	20	20	40	0	1	41	0	0
16	34212630	.	T	C	19	1	20	0	26	46	0	0
16	34212676	.	G	C	16	2	18	0	13	31	0	0
16	34222439	.	T	G	21	21	42	0	2	44	0	0
16	34225173	.	T	C	16	16	32	0	2	34	0	0
16	34225392	.	A	G	17	14	31	0	2	33	0	0
16	34225472	.	G	A	18	19	37	0	1	38	0	0
16	34267938	.	C	T	0	12	12	0	17	29	0	0
16	34267991	.	G	C	11	24	35	0	2	37	0	0
16	34321568	.	A	T	4	8	12	0	1	13	0	0
16	34322036	.	G	T	5	6	11	0	0	11	0	0
16	34322346	.	G	A	18	14	32	0	0	32	0	0
16	34322372	.	C	T	1	11	12	0	20	32	0	0
16	34331489	.	A	G	14	7	21	0	1	22	0	0
16	34337976	.	A	T	16	13	29	0	2	32	1	0
16	34338475	.	A	G	17	9	26	1	0	27	0	0
16	34339168	.	A	C	17	9	26	0	1	27	0	0
16	34339432	.	A	T	29	11	40	0	1	41	0	0
16	34339693	.	C	T	15	11	26	0	0	26	0	0
16	34339808	.	A	G	9	13	22	0	0	22	0	0
16	34339857	.	T	G	10	11	21	0	1	22	0	0
16	34340179	.	A	T	14	10	24	0	1	25	0	0
16	34340311	.	T	C	11	0	11	0	9	20	0	0
16	34340397	.	A	C	14	9	23	0	2	25	0	0
16	34340520	.	G	T	9	14	23	0	2	25	0	0
16	34340538	.	C	T	9	10	19	0	2	21	0	0
16	34340965	.	C	T	11	5	16	0	1	17	0	0
16	34340967	.	A	G	11	5	16	0	0	16	0	0
16	34341012	.	C	T	11	5	16	0	1	17	0	0
16	34341021	.	C	T	11	5	16	0	1	17	0	0
16	34341080	.	T	C	5	6	11	0	0	11	0	0
16	34342182	.	T	C	10	11	21	0	3	24	0	0
16	34342541	.	C	T	6	3	9	0	1	10	0	0
16	34342542	.	A	G	6	4	10	0	0	10	0	0
16	34461347	.	A	T	3	6	9	0	0	9	0	0
16	34463337	.	G	A	6	2	8	0	0	8	0	0
16	34473533	.	G	C	2	6	8	0	0	8	0	0
16	34477745	.	C	G	0	2	2	0	3	5	0	0
16	34477754	.	G	T	2	1	3	0	1	4	0	0
16	34497992	.	T	A	7	8	15	0	1	16	0	0
16	34498504	.	G	A	2	2	4	0	0	4	0	0
16	34498734	.	A	G	3	1	4	0	10	14	0	0
16	34498785	.	G	C	12	4	16	0	1	17	0	0
16	34498787	.	A	G	12	5	17	0	0	17	0	0
16	34499744	.	G	A	2	3	5	0	0	5	0	0
16	34499778	.	G	A	2	2	4	0	0	4	0	0
16	34500007	.	C	T	5	4	9	0	0	9	0	0
16	34500167	.	A	G	7	2	9	0	0	9	0	0
16	34500542	.	G	C	13	8	21	0	0	21	0	0
16	34500840	.	T	G	11	12	23	0	2	25	0	0
16	34500899	.	G	A	15	13	28	0	0	28	0	0
16	34501050	.	A	T	6	6	12	0	0	12	0	0
16	34501136	.	C	T	8	14	22	0	0	22	0	0
16	34501137	.	A	G	6	14	20	0	2	22	0	0
16	34501380	.	C	T	12	13	25	2	0	27	0	0
16	34501589	.	A	G	7	9	16	0	0	16	0	0
16	34501794	.	G	A	4	9	13	0	2	15	0	0
16	34525621	.	C	A	48	50	98	0	3	101	0	0
16	34526092	.	C	G	32	36	68	0	0	68	0	0
16	34526093	.	A	C	21	34	55	0	13	68	0	0
16	34526926	.	A	T	30	28	58	0	9	68	1	0
16	34527183	.	C	T	4	5	9	0	3	12	0	0
16	34532205	.	G	A	7	20	27	0	22	49	0	0
16	34532635	.	T	C	12	6	18	0	0	18	0	0
16	34532720	.	C	G	9	8	17	0	0	17	0	0
16	34532799	.	G	A	4	7	11	0	12	23	0	0
16	34930635	.	A	G	15	13	28	0	1	29	0	0
16	34930719	.	C	T	2	18	20	0	7	27	0	0
16	34948262	.	C	T	17	14	31	0	0	31	0	0
16	34953166	.	C	T	11	15	26	0	1	27	0	0
16	34975908	.	A	G	24	12	36	0	0	36	0	0
16	34989800	.	C	T	0	8	8	0	11	19	0	0
16	34993814	.	T	C	12	0	12	0	9	21	0	0
16	35022679	.	G	A	8	5	13	0	1	14	0	0
16	35023920	.	C	T	10	9	19	0	0	19	0	0
16	35023934	.	T	C	9	10	19	0	1	20	0	0
16	35023967	.	T	A	11	13	24	0	0	24	0	0
16	35053907	.	C	G	14	10	24	0	2	26	0	0
16	35329655	.	G	A	9	10	19	0	0	19	0	0
16	35351867	.	G	A	0	2	2	0	1	3	0	0
16	35366094	.	A	C	3	5	8	0	0	8	0	0
16	35366154	.	T	A	4	3	7	0	0	7	0	0
16	35367140	.	C	G	4	4	8	0	0	8	0	0
16	35369099	.	A	T	2	6	8	0	0	8	0	0
16	35376598	.	G	T	6	3	9	0	0	9	0	0
16	35376825	.	C	T	1	6	7	0	1	8	0	0
16	35376832	.	G	T	1	6	7	0	1	8	0	0
16	35376929	.	C	T	2	2	4	0	0	4	0	0
16	35376933	.	C	G	2	2	4	0	0	4	0	0
16	35411363	.	T	C	21	19	40	0	1	41	0	0
16	35414455	.	A	G	20	7	27	0	2	29	0	0
16	35414470	.	T	C	20	10	30	0	2	32	0	0
16	35415710	.	A	G	8	16	24	0	1	25	0	0
16	35415872	.	G	A	11	30	41	0	0	41	0	0
16	35416158	.	C	T	12	18	30	0	1	31	0	0
16	35418744	.	T	C	12	1	13	0	18	31	0	0
16	35418792	.	T	C	14	0	14	0	22	36	0	0
16	35418804	.	G	A	15	23	38	0	1	39	0	0
16	35420600	.	T	C	23	0	23	0	13	36	0	0
16	35422323	.	A	G	5	17	22	0	0	22	0	0
16	35423651	.	A	G	16	15	31	0	1	32	0	0
16	35423985	.	C	T	15	13	28	0	2	30	0	0
16	35424003	.	A	T	17	10	27	0	0	27	0	0
16	35426998	.	T	C	11	0	11	0	13	24	0	0
16	35535353	.	T	G	14	11	25	0	0	25	0	0
16	35536480	.	G	A	14	12	26	2	3	31	0	0
16	35536574	.	C	A	16	10	26	0	1	27	0	0
16	35536576	.	G	A	1	11	12	0	15	27	0	0
16	35536739	.	C	T	17	8	25	0	0	25	0	0
16	35536960	.	T	C	11	4	15	0	0	15	0	0
16	35537153	.	G	A	9	7	16	0	1	17	0	0
16	35556078	.	G	A	1	2	3	0	0	3	0	0
16	35556083	.	C	T	1	2	3	0	0	3	0	0
16	35556244	.	G	A	4	2	6	0	0	6	0	0
16	35556275	.	C	A	0	2	2	0	1	3	0	0
16	35556365	.	A	G	4	3	7	0	0	7	0	0
16	35556378	.	G	A	3	3	6	0	0	6	0	0
16	35556819	.	A	T	3	4	7	0	0	7	0	0
16	35560134	.	A	G	3	3	6	0	0	6	0	0
16	35562875	.	C	T	0	6	6	0	1	7	0	0
16	35572583	.	A	G	1	3	4	0	2	6	0	0
16	35572630	.	G	A	1	2	3	0	1	4	0	0
16	35578791	.	G	A	2	2	4	0	1	5	0	0
16	35661979	.	A	G	4	10	14	0	0	14	0	0
16	35661995	.	T	C	3	11	14	0	1	15	0	0
16	35662031	.	T	C	3	5	8	0	0	8	0	0
16	35718538	.	A	G	10	7	17	0	2	19	0	0
16	35729045	.	C	T	9	6	15	0	1	16	0	0
16	35743809	.	A	G	12	8	20	0	0	20	0	0
16	35750548	.	T	C	18	8	26	3	0	29	0	0
16	35750647	.	T	G	14	14	28	0	1	29	0	0
16	35750648	.	G	C	15	14	29	0	0	29	0	0
16	35750714	.	T	A	10	15	25	0	3	28	0	0
16	35762009	.	C	A	5	12	17	0	1	18	0	0
16	35762010	.	A	C	5	13	18	0	0	18	0	0
16	35764580	.	C	T	13	11	24	0	0	24	0	0
16	35772762	.	C	T	13	14	27	0	0	27	0	0
16	35772933	.	T	C	12	11	23	1	1	25	0	0
16	35773005	.	A	G	8	6	14	0	1	15	0	0
16	36041247	.	G	A	10	14	24	0	0	24	0	0
16	36046966	.	G	A	3	2	5	8	0	13	0	0
16	36062265	.	T	C	10	1	11	0	8	19	0	0
16	36074270	.	C	A	2	2	4	0	0	4	0	0
16	36075280	.	T	C	3	4	7	0	0	7	0	0
16	36075312	.	T	C	4	4	8	0	0	8	0	0
16	36075471	.	G	A	8	6	14	0	1	15	0	0
16	36075478	.	T	A	6	7	13	0	0	13	0	0
16	36075677	.	C	A	5	7	12	0	0	12	0	0
16	36075999	.	A	G	8	7	15	0	0	15	0	0
16	36076082	.	G	A	14	11	25	0	0	25	0	0
16	36080364	.	C	T	14	11	25	0	0	25	0	0
16	36080376	.	A	C	14	12	26	0	0	26	0	0
16	36118070	.	T	C	7	0	7	0	6	13	0	0
16	36150674	.	A	G	11	8	19	1	2	22	0	0
16	36150707	.	C	T	14	9	23	0	0	23	0	0
16	36150949	.	C	T	21	20	41	0	2	43	0	0
16	36150964	.	C	T	22	18	40	0	2	42	0	0
16	36151000	.	C	A	22	14	36	0	2	38	0	0
16	36159928	.	T	C	15	23	38	1	2	41	0	0
16	36162013	.	C	T	13	14	27	0	1	28	0	0
16	36162201	.	A	G	10	7	17	0	1	18	0	0
16	36162584	.	G	C	2	7	9	0	9	18	0	0
16	36162650	.	T	C	11	15	26	0	0	26	0	0
16	36162727	.	A	G	17	10	27	0	0	27	0	0
16	36162754	.	A	G	12	12	24	0	0	24	0	0
16	36163005	.	G	A	4	9	13	0	1	14	0	0
16	36163006	.	A	C	3	10	13	0	0	14	1	0
16	36168251	.	C	T	6	8	14	0	1	15	0	0
16	36168317	.	G	C	7	3	10	0	1	11	0	0
16	36168416	.	T	C	5	4	9	0	0	9	0	0
16	36168450	.	A	T	5	5	10	0	0	10	0	0
16	36168510	.	A	T	9	4	13	0	0	13	0	0
16	36168575	.	T	G	7	3	10	0	0	10	0	0
16	36168994	.	C	T	6	6	12	0	0	12	0	0
16	36169007	.	T	C	5	5	10	0	0	10	0	0
16	36169057	.	T	G	5	7	12	0	2	14	0	0
16	36169150	.	T	C	6	4	10	0	0	10	0	0
16	36169568	.	G	T	2	6	8	0	0	8	0	0
16	36169868	.	A	C	4	0	4	0	4	8	0	0
16	36171552	.	A	G	2	6	8	0	0	8	0	0
16	36172961	.	A	G	5	10	15	0	1	16	0	0
16	36172982	.	C	T	5	8	13	0	1	14	0	0
16	36173406	.	A	T	6	5	11	0	0	11	0	0
16	36180540	.	G	A	1	3	4	0	0	4	0	0
16	36180591	.	A	G	2	2	4	0	0	4	0	0
16	36180753	.	A	G	4	3	7	0	2	9	0	0
16	36180810	.	T	A	5	5	10	0	0	10	0	0
16	36183047	.	A	G	4	6	10	0	0	10	0	0
16	36184666	.	T	C	5	0	5	0	3	8	0	0
16	36189865	.	G	A	1	3	4	0	0	4	0	0
16	36195921	.	C	T	6	2	8	0	0	8	0	0
16	36195942	.	C	T	4	2	6	0	0	6	0	0
16	36196411	.	T	C	2	4	6	0	0	6	0	0
16	36196524	.	C	T	2	3	5	0	1	6	0	0
16	36709489	.	G	T	1	2	3	0	0	3	0	0
16	36721589	.	T	G	2	11	13	0	1	14	0	0
16	36724010	.	C	G	0	17	17	1	10	28	0	0
16	36729322	.	A	T	8	7	15	0	0	15	0	0
16	36729352	.	G	T	9	8	17	0	0	17	0	0
16	36729373	.	A	G	9	11	20	0	1	21	0	0
16	36731307	.	A	G	12	14	26	0	0	26	0	0
16	36735751	.	T	C	5	8	13	0	0	13	0	0
16	36735760	.	T	C	4	0	4	0	6	10	0	0
16	36741148	.	T	C	5	4	9	0	0	9	0	0
16	36743328	.	G	A	9	13	22	0	0	22	0	0
16	36743351	.	G	A	9	11	20	0	0	20	0	0
16	36743757	.	T	C	3	8	11	0	1	12	0	0
16	36743787	.	A	G	4	7	11	0	0	11	0	0
16	36745973	.	C	T	2	4	6	0	11	17	0	0
16	36746103	.	C	T	11	7	18	0	0	18	0	0
16	36746466	.	G	A	7	7	14	0	0	14	0	0
16	36746484	.	A	G	8	6	14	0	0	14	0	0
16	36748214	.	T	G	4	7	11	0	2	13	0	0
16	36748366	.	T	C	5	0	5	0	5	10	0	0
16	36749242	.	T	G	2	1	3	0	4	7	0	0
16	36752254	.	A	G	4	2	6	0	1	7	0	0
16	36752278	.	T	C	5	3	8	0	0	8	0	0
16	36759756	.	A	G	2	3	5	0	0	5	0	0
16	36759763	.	G	T	2	1	3	0	0	3	0	0
16	36759812	.	A	G	1	2	3	0	1	4	0	0
16	36759834	.	T	C	2	3	5	0	0	5	0	0
16	36759908	.	A	T	1	3	4	0	0	4	0	0
16	36766180	.	T	G	16	14	30	0	1	31	0	0
16	36766467	.	G	T	8	11	19	0	4	24	1	0
16	36906757	.	A	G	7	6	13	0	1	14	0	0
16	36906805	.	C	T	6	3	9	0	0	9	0	0
16	36906885	.	A	G	6	2	8	0	0	8	0	0
16	36908492	.	A	G	7	1	8	0	3	11	0	0
16	36911214	.	C	A	12	13	25	0	0	25	0	0
16	36911257	.	A	G	8	0	8	0	13	21	0	0
16	36918992	.	G	A	9	4	13	0	3	16	0	0
16	36923298	.	C	T	9	11	20	0	0	20	0	0
16	36925462	.	G	A	2	6	8	0	19	27	0	0
16	36926775	.	C	A	14	12	26	0	0	26	0	0
16	36926779	.	A	C	13	11	24	0	2	26	0	0
16	36928169	.	A	T	7	12	19	0	1	20	0	0
16	36928179	.	A	C	9	11	20	0	0	20	0	0
16	36928429	.	A	G	26	15	41	0	0	41	0	0
16	36931728	.	T	C	21	15	36	0	0	36	0	0
16	36931822	.	T	C	5	2	7	1	1	9	0	0
16	36934191	.	T	A	7	4	11	0	1	12	0	0
16	36934340	.	C	A	0	5	5	0	4	9	0	0
16	36939973	.	T	C	11	0	11	0	9	20	0	0
16	36939982	.	A	G	11	7	18	0	3	21	0	0
16	36940045	.	C	T	11	13	24	0	2	26	0	0
16	36941706	.	T	C	7	13	20	0	4	24	0	0
16	36941790	.	T	C	12	6	18	0	1	19	0	0
16	36941961	.	T	C	5	0	5	0	7	12	0	0
16	36942068	.	C	A	12	11	23	0	0	23	0	0
16	36945182	.	T	G	9	13	22	0	1	23	0	0
16	36945288	.	G	A	11	11	22	0	0	22	0	0
16	36945564	.	T	C	4	5	9	0	0	9	0	0
16	36945566	.	T	A	4	4	8	0	1	9	0	0
16	36975141	.	G	A	16	12	28	0	0	28	0	0
16	36975146	.	C	T	3	12	15	0	14	29	0	0
16	36975183	.	G	C	16	11	27	0	1	28	0	0
16	36975318	.	T	A	14	5	19	0	0	19	0	0
16	36976721	.	A	G	8	6	14	0	2	16	0	0
16	36977387	.	A	G	4	6	10	0	0	10	0	0
16	36979518	.	G	A	12	11	23	0	1	24	0	0
16	36979521	.	A	G	12	10	22	0	2	24	0	0
16	37167442	.	G	C	3	15	18	0	0	18	0	0
16	37167545	.	T	A	4	10	14	0	0	14	0	0
16	37167589	.	T	G	2	15	17	0	0	17	0	0
16	37167784	.	C	G	4	9	13	0	1	14	0	0
16	37306905	.	G	A	10	12	22	0	1	23	0	0
16	37323594	.	A	C	12	10	22	0	0	22	0	0
16	37470964	.	T	C	2	10	12	0	1	13	0	0
16	37471169	.	A	T	3	4	7	0	0	7	0	0
16	37520597	.	T	C	2	9	11	0	1	12	0	0
16	37520679	.	T	A	8	5	13	0	0	13	0	0
16	37521130	.	A	G	8	7	15	0	0	15	0	0
16	37521301	.	G	C	1	8	9	0	5	14	0	0
16	37543114	.	T	C	3	6	9	0	0	9	0	0
16	37543137	.	A	C	6	8	14	0	1	15	0	0
16	37552348	.	A	C	10	8	18	0	0	18	0	0
16	37552966	.	G	A	10	13	23	0	0	23	0	0
16	37554821	.	C	T	12	13	25	0	0	25	0	0
16	37563601	.	G	A	12	17	29	0	0	29	0	0
16	37563643	.	T	G	11	0	11	0	18	30	1	0
16	37565676	.	C	G	8	14	22	0	0	23	1	0
16	37593444	.	G	A	18	15	33	0	3	36	0	0
16	37596645	.	C	T	14	9	23	0	1	24	0	0
16	37596669	.	G	A	16	12	28	0	0	28	0	0
16	37614071	.	A	G	19	12	31	0	1	32	0	0
16	37617219	.	A	G	17	0	17	0	20	37	0	0
16	37617304	.	A	G	17	1	18	0	18	36	0	0
16	37617738	.	T	C	22	19	41	1	0	42	0	0
16	37627218	.	T	G	19	13	32	0	8	40	0	0
16	37627762	.	G	A	2	14	16	0	16	32	0	0
16	37627997	.	T	G	21	22	43	0	0	43	0	0
16	37913139	.	C	T	1	3	4	0	0	4	0	0
16	37944176	.	C	T	7	2	9	0	0	9	0	0
16	37947769	.	T	C	2	4	6	0	0	6	0	0
16	37947944	.	C	T	3	6	9	0	0	9	0	0
16	37948061	.	A	G	3	12	15	0	0	15	0	0
16	37948256	.	G	T	5	2	7	0	0	7	0	0
16	37948425	.	A	G	9	7	16	0	1	17	0	0
16	37948426	.	G	T	9	7	16	0	1	17	0	0
16	37948624	.	G	A	9	6	15	0	0	15	0	0
16	37948625	.	G	A	9	6	15	0	0	15	0	0
16	37964057	.	A	G	5	9	14	0	0	14	0	0
16	37964252	.	T	A	5	1	6	0	0	6	0	0
16	38017710	.	G	C	3	3	6	0	0	6	0	0
16	38017722	.	A	G	2	2	4	0	0	4	0	0
16	38017922	.	A	G	1	2	3	0	0	3	0	0
16	38017933	.	T	G	4	2	6	0	0	6	0	0
16	38018015	.	A	G	2	5	7	0	0	7	0	0
16	38019134	.	C	T	2	3	5	0	0	5	0	0
16	38064909	.	C	G	4	3	7	0	0	7	0	0
16	38067822	.	G	A	3	3	6	0	0	6	0	0
16	38067856	.	G	A	4	2	6	0	0	6	0	0
16	38067881	.	G	A	3	2	5	0	1	6	0	0
16	38119696	.	T	A	6	6	12	0	0	12	0	0
16	38121528	.	G	A	0	5	5	0	8	13	0	0
16	38121981	.	C	T	7	6	13	0	0	13	0	0
16	38124907	.	T	G	8	0	8	0	10	18	0	0
16	38125202	.	T	A	6	7	13	0	3	16	0	0
16	38125293	.	G	C	6	6	12	0	0	12	0	0
16	38125299	.	G	C	7	6	13	0	0	13	0	0
16	38125370	.	C	T	9	8	17	0	0	17	0	0
16	38125650	.	T	C	7	6	13	0	0	13	0	0
16	38125662	.	A	G	6	4	10	0	0	10	0	0
16	38127708	.	T	A	11	6	17	0	1	18	0	0
16	38127789	.	T	C	1	6	7	0	0	7	0	0
16	38129427	.	T	A	2	6	8	1	0	10	1	0
16	38129496	.	T	C	7	4	11	0	0	11	0	0
16	38129689	.	T	C	10	4	14	0	0	14	0	0
16	38130661	.	T	C	3	7	10	0	1	11	0	0
16	38131803	.	G	A	9	6	15	0	1	16	0	0
16	38131813	.	C	A	11	5	16	0	0	16	0	0
16	38132166	.	C	T	1	8	9	0	0	9	0	0
16	38132438	.	A	G	9	4	13	0	0	13	0	0
16	38132537	.	T	A	8	9	17	0	1	18	0	0
16	38133170	.	G	C	10	4	14	0	1	15	0	0
16	38133696	.	A	T	13	5	18	0	0	18	0	0
16	38133732	.	C	G	15	8	23	0	0	23	0	0
16	38133804	.	C	T	9	11	20	0	0	20	0	0
16	38133903	.	A	G	8	13	21	0	0	21	0	0
16	38134152	.	A	G	8	5	13	0	0	13	0	0
16	38134215	.	G	A	7	5	12	0	0	12	0	0
16	38134264	.	T	C	6	2	8	0	0	8	0	0
16	38134302	.	C	T	3	4	7	0	0	7	0	0
16	38134428	.	C	A	7	10	17	0	0	17	0	0
16	38134467	.	G	A	8	11	19	0	0	19	0	0
16	38134515	.	C	T	11	10	21	0	0	21	0	0
16	38134653	.	A	G	9	1	10	0	4	14	0	0
16	38134676	.	C	A	9	3	12	0	0	12	0	0
16	38134710	.	T	A	4	12	16	0	0	16	0	0
16	38134875	.	G	A	5	5	10	0	1	11	0	0
16	38134908	.	A	T	4	6	10	0	0	10	0	0
16	38135166	.	C	A	18	6	24	0	0	24	0	0
16	38135555	.	A	T	2	2	4	0	0	4	0	0
16	38135591	.	G	T	2	3	5	0	0	5	0	0
16	38135740	.	T	C	6	3	9	0	1	10	0	0
16	38135763	.	A	G	4	3	7	0	0	7	0	0
16	38135953	.	A	T	2	5	7	0	0	7	0	0
16	38136022	.	G	A	4	2	6	0	0	6	0	0
16	38136028	.	C	T	4	3	7	0	0	7	0	0
16	38136317	.	G	A	10	6	16	0	0	16	0	0
16	38141992	.	C	A	3	3	6	0	0	6	0	0
16	38143118	.	C	T	2	2	4	0	0	4	0	0
16	38143121	.	A	G	2	0	2	0	2	4	0	0
16	38148116	.	T	C	2	2	4	0	0	4	0	0
16	38154537	.	T	C	4	2	6	0	0	6	0	0
16	38159817	.	C	A	10	8	18	0	2	20	0	0
16	38167311	.	A	G	5	0	5	0	7	12	0	0
16	38167511	.	C	T	8	8	16	0	1	17	0	0
16	38167734	.	T	C	4	8	12	0	2	14	0	0
16	38167904	.	A	G	15	0	15	0	12	27	0	0
16	38168009	.	A	G	20	9	29	0	1	30	0	0
16	38188955	.	G	A	1	12	13	0	13	26	0	0
16	38191645	.	C	T	7	5	12	0	0	12	0	0
16	38193969	.	A	G	8	8	16	0	0	16	0	0
16	38194017	.	T	C	7	7	14	0	0	14	0	0
16	38198125	.	C	A	10	10	20	0	0	20	0	0
16	38198418	.	T	G	12	13	25	0	0	25	0	0
16	38198648	.	G	A	12	13	25	0	0	25	0	0
16	38198836	.	A	T	14	6	20	0	1	21	0	0
16	38240055	.	C	T	1	2	3	0	0	3	0	0
16	38251932	.	T	C	2	2	4	0	0	4	0	0
16	38266188	.	T	A	3	3	6	0	1	7	0	0
16	38312956	.	G	A	2	2	4	0	0	4	0	0
16	38313002	.	A	G	2	3	5	0	0	5	0	0
16	38313003	.	A	T	2	2	4	0	1	5	0	0
16	38313176	.	G	T	1	2	3	0	0	3	0	0
16	38320394	.	C	T	0	2	2	0	1	3	0	0
16	38333904	.	G	T	5	2	7	0	0	7	0	0
16	38342023	.	A	T	1	1	2	0	1	3	0	0
16	38351061	.	T	A	2	5	7	0	0	7	0	0
16	38354134	.	A	G	8	4	12	0	0	12	0	0
16	38556912	.	G	A	5	3	8	0	1	9	0	0
16	38556922	.	C	G	1	4	5	0	4	9	0	0
16	38557876	.	G	C	20	1	21	0	19	40	0	0
16	38590735	.	A	C	24	30	54	0	2	56	0	0
16	38626434	.	T	C	22	18	40	0	2	42	0	0
16	38663163	.	G	A	1	21	22	0	20	42	0	0
16	38729548	.	G	A	5	3	8	0	1	9	0	0
16	38940811	.	T	G	19	19	38	0	1	39	0	0
16	38943547	.	A	G	8	0	8	0	5	13	0	0
16	39154953	.	G	A	23	20	43	0	1	44	0	0
16	39160445	.	C	T	32	24	56	0	2	58	0	0
16	39160458	.	A	C	24	35	59	0	1	60	0	0
16	39162786	.	C	T	32	26	58	0	1	59	0	0
16	39164213	.	G	A	23	30	53	2	2	57	0	0
16	39166299	.	G	T	21	27	48	0	1	49	0	0
16	39166422	.	G	A	3	26	29	0	16	45	0	0
16	39166591	.	G	A	26	22	48	0	3	51	0	0
16	39185271	.	T	G	2	3	5	0	0	5	0	0
16	39185580	.	G	A	12	14	26	0	2	28	0	0
16	39190767	.	T	G	14	20	34	0	0	34	0	0
16	39194303	.	A	G	14	13	27	0	0	27	0	0
16	39196850	.	A	C	6	8	14	0	0	14	0	0
16	39196890	.	A	C	8	6	14	0	1	15	0	0
16	39196956	.	A	G	3	2	5	0	0	5	0	0
16	39213237	.	G	A	0	4	4	0	2	6	0	0
16	39213314	.	G	A	7	6	13	0	2	15	0	0
16	39233140	.	T	C	1	2	3	0	0	3	0	0
16	39233158	.	T	C	1	2	3	0	0	3	0	0
16	39245587	.	C	A	8	8	16	0	0	16	0	0
16	39249184	.	A	G	6	7	13	0	0	13	0	0
16	39249965	.	C	T	4	3	7	0	0	7	0	0
16	39250574	.	G	A	7	2	9	0	0	9	0	0
16	39253200	.	G	A	4	5	9	0	1	10	0	0
16	39256291	.	A	G	5	3	8	0	0	8	0	0
16	39267151	.	T	C	4	2	6	0	2	8	0	0
16	39267164	.	T	A	3	3	6	0	0	6	0	0
16	39271394	.	G	C	3	8	11	0	0	11	0	0
16	39271438	.	A	G	7	3	10	0	0	10	0	0
16	39287126	.	G	T	5	5	10	0	0	10	0	0
16	39297336	.	C	A	3	7	10	0	0	10	0	0
16	39297344	.	A	T	6	4	10	0	0	10	0	0
16	39297378	.	C	T	6	3	9	0	0	9	0	0
16	39325121	.	G	A	1	4	5	0	0	5	0	0
16	39361889	.	C	T	6	5	11	0	0	11	0	0
16	39362147	.	C	A	3	5	8	0	0	8	0	0
16	39362312	.	G	T	0	4	4	0	10	14	0	0
16	39372345	.	G	A	3	4	7	0	2	9	0	0
16	39372372	.	T	C	3	7	10	0	1	11	0	0
16	39372735	.	G	C	1	13	14	0	8	22	0	0
16	39372780	.	C	A	11	12	23	0	0	23	0	0
16	39382047	.	C	G	10	7	17	0	0	17	0	0
16	39382226	.	G	A	3	7	10	0	0	10	0	0
16	39382384	.	A	C	4	2	6	0	1	7	0	0
16	39382467	.	C	G	3	3	6	0	0	6	0	0
16	39385755	.	T	C	12	0	12	0	10	22	0	0
16	39386920	.	C	T	1	17	18	0	15	33	0	0
16	39393370	.	A	G	17	14	31	0	0	31	0	0
16	39394581	.	A	G	24	16	40	0	1	41	0	0
16	39396983	.	C	T	3	20	23	0	21	44	0	0
16	39413496	.	T	C	7	15	22	0	0	22	0	0
16	39413514	.	C	T	16	6	22	0	3	25	0	0
16	39532994	.	A	G	1	3	4	0	0	4	0	0
16	39643512	.	G	A	5	9	14	0	0	14	0	0
16	39742484	.	A	G	8	3	11	0	0	11	0	0
16	39830006	.	C	T	1	3	4	0	5	9	0	0
16	40026573	.	A	G	4	0	4	0	5	9	0	0
16	40031649	.	A	G	6	6	12	0	0	12	0	0
16	40066964	.	C	T	1	8	9	0	0	9	0	0
16	40320237	.	C	A	3	2	5	0	0	5	0	0
16	40340664	.	A	T	2	4	6	0	0	6	0	0
16	40340706	.	T	G	4	6	10	0	0	10	0	0
16	40340844	.	C	A	1	3	4	0	0	4	0	0
16	40340847	.	A	G	1	0	1	0	4	5	0	0
16	40341024	.	T	C	3	2	5	0	0	5	0	0
16	40341055	.	C	A	2	4	6	0	0	6	0	0
16	40343482	.	A	G	1	3	4	0	0	4	0	0
16	40343750	.	C	T	3	3	6	0	1	7	0	0
16	40346614	.	A	C	1	3	4	0	0	4	0	0
16	40347546	.	T	A	2	5	7	0	0	7	0	0
16	40425993	.	A	C	2	5	7	0	0	7	0	0
16	40426284	.	T	C	4	3	7	0	0	7	0	0
16	40426302	.	C	T	4	4	8	0	0	8	0	0
16	40491931	.	A	G	6	6	12	0	0	12	0	0
16	40495482	.	C	T	1	7	8	0	2	10	0	0
16	40541401	.	C	A	1	2	3	0	0	3	0	0
16	40563652	.	T	C	2	4	6	0	1	7	0	0
16	40569123	.	C	T	8	3	11	0	1	12	0	0
16	40569264	.	T	C	8	6	14	0	0	14	0	0
16	40569285	.	T	C	7	5	12	0	0	12	0	0
16	40569480	.	C	G	5	5	10	0	0	10	0	0
16	40569558	.	A	C	4	7	11	0	0	11	0	0
16	40569701	.	T	G	6	5	11	0	0	11	0	0
16	40582960	.	C	T	1	2	3	0	0	3	0	0
16	40594146	.	G	A	5	4	9	0	1	10	0	0
16	40594224	.	A	G	1	5	6	0	0	6	0	0
16	40594302	.	A	G	2	4	6	0	0	6	0	0
16	40594311	.	T	C	2	0	2	0	4	6	0	0
16	40594353	.	T	C	1	0	1	0	6	7	0	0
16	40594590	.	G	C	6	0	6	0	12	18	0	0
16	40597763	.	T	C	2	4	6	0	0	6	0	0
16	40604971	.	A	G	3	3	6	0	3	9	0	0
16	40604977	.	C	A	6	5	11	0	0	11	0	0
16	40606678	.	G	A	5	2	7	0	0	7	0	0
16	40606844	.	T	A	3	2	5	0	0	5	0	0
16	40606883	.	G	A	3	4	7	0	0	7	0	0
16	40607351	.	T	A	3	3	6	0	1	7	0	0
16	40607436	.	C	T	4	5	9	0	0	9	0	0
16	40609954	.	T	G	5	5	10	0	0	10	0	0
16	40610018	.	G	C	5	4	9	0	0	9	0	0
16	40616864	.	G	A	3	5	8	0	0	8	0	0
16	40616923	.	A	G	1	5	6	0	0	6	0	0
16	40616983	.	T	G	3	6	9	0	0	9	0	0
16	40619466	.	A	G	4	4	8	0	1	9	0	0
16	40619514	.	C	G	6	7	13	0	0	13	0	0
16	40619531	.	G	T	7	5	12	0	0	12	0	0
16	40622663	.	G	A	4	5	9	0	0	9	0	0
16	40622799	.	G	A	6	4	10	0	0	10	0	0
16	40625168	.	G	A	7	4	11	0	0	11	0	0
16	40625267	.	A	G	2	4	6	0	1	7	0	0
16	40632736	.	T	C	6	4	10	0	0	10	0	0
16	40632907	.	T	C	5	0	5	0	3	8	0	0
16	40632952	.	C	T	0	2	2	0	6	8	0	0
16	40633036	.	C	T	4	4	8	0	0	8	0	0
16	40633120	.	C	T	1	2	3	0	0	3	0	0
16	40633846	.	C	T	6	6	12	0	0	12	0	0
16	40634820	.	A	G	1	5	6	0	0	6	0	0
16	40634885	.	A	G	3	2	5	0	0	5	0	0
16	40639762	.	G	A	3	3	6	0	0	6	0	0
16	40672801	.	G	A	6	3	9	0	0	9	0	0
16	40673981	.	C	T	0	4	4	0	4	8	0	0
16	40694217	.	C	G	4	4	8	0	1	9	0	0
16	40712299	.	T	C	4	0	4	0	4	8	0	0
16	40954538	.	C	T	13	8	21	0	1	22	0	0
16	40954695	.	A	G	9	1	10	0	13	23	0	0
16	40954866	.	T	C	14	6	20	0	1	21	0	0
16	40954941	.	C	G	12	0	12	0	11	23	0	0
16	40954983	.	A	C	9	14	23	0	1	24	0	0
16	40955515	.	G	T	9	4	13	0	0	13	0	0
16	40955525	.	C	T	9	4	13	0	2	15	0	0
16	40955722	.	G	C	4	3	7	0	0	7	0	0
16	40992167	.	T	A	1	2	3	0	0	3	0	0
16	40992277	.	C	A	1	3	4	0	0	4	0	0
16	40992376	.	C	T	3	6	9	0	0	9	0	0
16	40992466	.	A	G	3	7	10	0	2	12	0	0
16	40992490	.	A	G	4	6	10	0	1	11	0	0
16	40992529	.	G	A	2	2	4	0	0	4	0	0
16	41003665	.	T	C	2	0	2	0	2	4	0	0
16	41003692	.	T	C	1	0	1	0	2	3	0	0
16	41003923	.	G	A	4	2	6	0	0	6	0	0
16	41023341	.	A	G	13	14	27	0	1	28	0	0
16	41023367	.	G	A	11	12	23	0	0	23	0	0
16	41023620	.	G	A	13	11	24	0	0	24	0	0
16	41023689	.	C	A	14	14	28	0	0	28	0	0
16	41023761	.	G	T	10	9	19	2	0	21	0	0
16	41028360	.	T	G	23	0	23	0	15	38	0	0
16	41029588	.	G	A	1	3	4	0	9	13	0	0
16	41029836	.	A	G	3	3	6	0	1	7	0	0
16	41029981	.	T	C	5	7	12	0	1	13	0	0
16	41030017	.	A	C	7	5	12	0	0	12	0	0
16	41030492	.	A	C	5	5	10	0	0	10	0	0
16	41030493	.	G	T	3	5	8	0	1	9	0	0
16	41059342	.	A	G	1	2	3	0	0	3	0	0
16	41085240	.	T	C	5	2	7	0	0	7	0	0
16	41085243	.	T	C	5	2	7	0	0	7	0	0
16	41088990	.	C	T	5	3	8	0	1	9	0	0
16	41089038	.	A	G	3	0	3	0	4	7	0	0
16	41095985	.	C	T	5	2	7	0	0	7	0	0
16	41098207	.	A	G	6	0	6	0	5	11	0	0
16	41100602	.	G	A	0	3	3	0	5	8	0	0
16	41100641	.	T	G	6	5	11	0	0	11	0	0
16	41112571	.	T	C	4	2	6	0	0	6	0	0
16	41112572	.	G	A	4	2	6	0	0	6	0	0
16	41112915	.	A	T	9	13	22	0	1	23	0	0
16	41112916	.	C	T	0	12	12	0	11	23	0	0
16	41113134	.	G	A	11	12	23	0	0	23	0	0
16	41113347	.	A	G	14	13	27	0	1	28	0	0
16	41113434	.	A	T	15	13	28	0	1	29	0	0
16	41113449	.	A	G	14	12	26	0	1	27	0	0
16	41113676	.	T	G	10	12	22	0	0	22	0	0
16	41113698	.	A	T	6	14	20	0	0	21	1	0
16	41113755	.	C	T	8	15	23	0	0	23	0	0
16	41114575	.	A	T	6	8	14	0	0	14	0	0
16	41114779	.	G	A	12	10	22	0	0	22	0	0
16	41114890	.	C	T	4	6	10	0	1	11	0	0
16	41114976	.	G	T	8	10	18	0	0	18	0	0
16	41115997	.	A	T	13	9	22	0	3	25	0	0
16	41115998	.	C	T	1	9	10	0	15	25	0	0
16	41116339	.	A	G	11	11	22	1	1	24	0	0
16	41116367	.	G	A	17	9	26	1	2	29	0	0
16	41116613	.	G	C	7	11	18	0	1	19	0	0
16	41116671	.	C	T	17	8	25	0	3	28	0	0
16	41116843	.	A	G	4	6	10	0	1	11	0	0
16	41116873	.	C	A	3	7	10	0	1	11	0	0
16	41117041	.	C	T	12	8	20	0	0	20	0	0
16	41118743	.	C	T	6	2	8	0	0	8	0	0
16	41119347	.	T	C	2	3	5	0	0	5	0	0
16	41119715	.	T	C	3	3	6	0	0	6	0	0
16	41120922	.	A	G	5	7	12	0	0	12	0	0
16	41120943	.	G	T	4	6	10	0	0	10	0	0
16	41121601	.	A	C	3	1	4	0	6	10	0	0
16	41121628	.	T	C	3	6	9	0	0	9	0	0
16	41121643	.	C	A	2	5	7	0	0	7	0	0
16	41123134	.	G	A	3	3	6	0	0	6	0	0
16	41345674	.	A	T	5	8	13	0	1	14	0	0
16	41345826	.	G	T	6	4	10	0	1	11	0	0
16	41346007	.	C	A	2	8	10	0	9	19	0	0
16	41353140	.	G	A	8	12	20	0	0	20	0	0
16	41353224	.	A	G	9	11	20	0	1	21	0	0
16	41354452	.	G	A	8	11	19	0	0	19	0	0
16	41393773	.	C	T	10	11	21	0	0	21	0	0
16	41413984	.	G	A	10	14	24	0	0	24	0	0
16	41439672	.	A	G	7	6	13	0	1	14	0	0
16	41468848	.	T	G	5	5	10	0	0	10	0	0
16	41469008	.	G	A	9	4	13	0	1	14	0	0
16	41469029	.	C	A	5	4	9	0	0	9	0	0
16	41469130	.	T	A	1	7	8	0	0	8	0	0
16	41469329	.	G	A	3	2	5	0	1	6	0	0
16	41469390	.	A	C	4	6	10	0	0	10	0	0
16	41469426	.	T	A	4	6	10	0	1	11	0	0
16	41470404	.	A	T	1	2	3	0	0	3	0	0
16	41471881	.	C	T	0	5	5	0	2	7	0	0
16	41503836	.	A	G	2	2	4	0	0	4	0	0
16	41533866	.	G	A	4	4	8	0	0	8	0	0
16	41585889	.	C	T	1	2	3	0	0	3	0	0
16	41589214	.	A	G	5	7	12	0	0	12	0	0
16	41599917	.	C	T	12	7	19	0	1	20	0	0
16	41601658	.	T	C	5	4	9	0	0	9	0	0
16	41620163	.	T	C	6	7	13	0	1	14	0	0
16	41621428	.	G	A	1	4	5	0	0	5	0	0
16	41622460	.	A	C	2	0	2	0	3	5	0	0
16	41637931	.	G	A	5	4	9	0	1	10	0	0
16	41646081	.	C	T	6	6	12	0	0	12	0	0
16	41685952	.	T	C	4	2	6	0	0	6	0	0
16	41703703	.	C	T	1	3	4	0	0	4	0	0
16	41704050	.	A	G	1	2	3	0	0	3	0	0
16	41704056	.	T	A	1	1	2	0	1	3	0	0
16	41712506	.	A	G	2	3	5	0	0	5	0	0
16	41717479	.	G	A	14	16	30	0	0	30	0	0
16	41717482	.	A	G	13	14	27	0	0	27	0	0
16	41717666	.	G	A	1	20	21	0	21	42	0	0
16	41720533	.	G	T	12	8	20	0	1	21	0	0
16	41720536	.	T	G	14	8	22	0	0	22	0	0
16	41720587	.	T	C	13	14	27	0	1	28	0	0
16	41723228	.	T	G	18	0	18	0	15	33	0	0
16	41723280	.	A	G	15	0	15	0	22	37	0	0
16	41723778	.	C	G	4	1	5	0	10	15	0	0
16	41725215	.	T	C	8	13	21	0	1	22	0	0
16	41725238	.	T	C	7	9	16	0	2	18	0	0
16	41727162	.	T	G	15	14	29	0	2	31	0	0
16	41727376	.	C	A	12	24	36	0	0	36	0	0
16	41730407	.	G	A	11	20	31	1	0	32	0	0
16	41730625	.	C	G	17	20	37	0	0	37	0	0
16	41731928	.	A	T	7	7	14	0	0	14	0	0
16	41731929	.	C	A	7	7	14	0	0	14	0	0
16	41732009	.	G	T	7	11	18	0	2	20	0	0
16	41732031	.	G	T	0	7	7	0	7	14	0	0
16	41732067	.	T	C	8	10	18	0	0	18	0	0
16	41732158	.	C	A	13	3	16	0	0	16	0	0
16	41732166	.	C	T	10	3	13	0	1	14	0	0
16	41732262	.	T	C	3	12	15	0	0	15	0	0
16	41732295	.	G	T	6	13	19	0	0	19	0	0
16	41732343	.	C	T	4	12	16	0	3	19	0	0
16	41732366	.	A	G	11	7	18	0	0	18	0	0
16	41740704	.	A	T	4	5	9	0	0	9	0	0
16	41740815	.	T	A	4	4	8	0	0	8	0	0
16	41740924	.	A	G	2	3	5	0	3	8	0	0
16	41741050	.	C	T	1	6	7	0	2	9	0	0
16	41741398	.	A	G	2	2	4	0	0	4	0	0
16	41742460	.	T	C	5	1	6	0	1	7	0	0
16	41750501	.	G	A	2	2	4	0	0	4	0	0
16	41794900	.	C	A	0	16	16	0	15	31	0	0
16	41801525	.	G	T	15	20	35	0	2	37	0	0
16	41873717	.	T	A	15	18	33	0	0	33	0	0
16	41873797	.	G	A	9	10	19	0	0	19	0	0
16	41873992	.	C	T	6	7	13	0	0	13	0	0
16	41874039	.	G	C	9	11	20	0	1	21	0	0
16	41882490	.	G	T	0	3	3	0	4	7	0	0
16	41882512	.	A	G	4	4	8	0	0	8	0	0
16	41891572	.	C	T	14	25	39	0	3	42	0	0
16	41891662	.	A	C	12	15	27	0	1	28	0	0
16	41896361	.	G	A	19	13	32	0	5	37	0	0
16	41897244	.	A	G	17	8	25	0	0	26	1	0
16	41897332	.	A	G	15	8	23	0	0	23	0	0
16	41897347	.	G	A	17	11	28	0	1	29	0	0
16	41897375	.	A	T	18	15	33	0	1	34	0	0
16	41897452	.	C	A	20	10	30	1	0	31	0	0
16	41897599	.	A	T	7	12	19	0	0	19	0	0
16	41903475	.	A	T	12	10	22	0	0	22	0	0
16	41903686	.	G	A	9	11	20	0	1	21	0	0
16	41903770	.	T	C	12	7	19	0	0	19	0	0
16	41903801	.	T	G	16	6	22	0	3	25	0	0
16	41903957	.	T	C	12	11	23	0	0	23	0	0
16	41904121	.	T	G	3	12	15	0	0	15	0	0
16	41904209	.	T	C	8	12	20	0	0	20	0	0
16	41904261	.	G	A	8	8	16	0	0	16	0	0
16	41904430	.	C	A	13	11	24	0	1	25	0	0
16	41904440	.	C	A	2	9	11	0	14	25	0	0
16	41904615	.	T	C	21	0	21	1	8	30	0	0
16	41904650	.	G	A	12	5	17	1	0	18	0	0
16	41904680	.	A	T	12	4	16	1	0	17	0	0
16	41904717	.	T	C	5	3	8	0	0	8	0	0
16	41904753	.	C	T	1	2	3	0	1	4	0	0
16	41904816	.	T	C	2	2	4	0	0	4	0	0
16	41904879	.	A	T	6	6	12	0	0	12	0	0
16	41904961	.	A	G	8	10	18	0	0	18	0	0
16	41905631	.	A	G	12	11	23	0	0	23	0	0
16	41905666	.	A	G	7	13	20	0	0	20	0	0
16	41905682	.	G	T	11	14	25	0	0	25	0	0
16	41905720	.	T	A	12	13	25	0	1	26	0	0
16	41905807	.	G	C	7	10	17	0	1	18	0	0
16	41912225	.	G	A	14	12	26	0	0	26	0	0
16	41916819	.	A	G	24	9	33	0	2	35	0	0
16	41925227	.	G	C	18	1	19	0	19	38	0	0
16	41929993	.	T	G	12	13	25	0	1	26	0	0
16	41933222	.	A	C	15	13	28	0	1	29	0	0
16	41933411	.	G	A	12	10	22	0	1	23	0	0
16	42072207	.	T	A	16	16	32	0	1	33	0	0
16	42072719	.	A	C	17	20	37	0	0	37	0	0
16	42073086	.	A	G	8	8	16	0	1	17	0	0
16	42073488	.	T	C	22	2	24	0	23	47	0	0
16	42083039	.	G	A	10	20	30	0	1	31	0	0
16	42091814	.	A	G	21	14	35	0	0	35	0	0
16	42161402	.	C	G	0	2	2	0	2	4	0	0
16	42177840	.	C	T	5	2	7	0	0	7	0	0
16	42178002	.	C	T	2	10	12	0	6	18	0	0
16	42178012	.	A	G	12	8	20	0	1	21	0	0
16	42179879	.	C	A	14	12	26	0	1	27	0	0
16	42180079	.	A	G	12	14	26	0	2	28	0	0
16	42180271	.	G	A	13	18	31	0	0	31	0	0
16	42186022	.	G	A	7	10	17	0	0	17	0	0
16	42186043	.	A	T	7	7	14	0	0	14	0	0
16	42186063	.	A	G	3	4	7	0	0	7	0	0
16	42193194	.	T	A	3	2	5	0	0	5	0	0
16	42193225	.	T	C	2	3	5	0	0	5	0	0
16	42193256	.	C	T	1	3	4	2	0	6	0	0
16	42193489	.	G	A	3	4	7	0	0	7	0	0
16	42193504	.	G	A	3	3	6	0	0	6	0	0
16	42207600	.	A	G	3	3	6	0	1	7	0	0
16	42238055	.	G	T	2	2	4	0	0	4	0	0
16	42302773	.	A	C	2	2	4	0	0	4	0	0
16	42322458	.	T	G	36	43	79	2	2	83	0	0
16	42373933	.	A	C	26	29	55	0	2	57	0	0
16	42374020	.	C	T	2	29	31	0	23	54	0	0
16	42374080	.	G	T	25	35	60	0	0	60	0	0
16	42374254	.	C	T	26	34	60	0	2	62	0	0
16	42374290	.	G	A	26	32	58	0	0	58	0	0
16	42374425	.	A	G	31	18	49	0	0	49	0	0
16	42374434	.	A	C	32	20	52	0	0	52	0	0
16	42390176	.	T	C	21	0	21	0	27	48	0	0
16	42424189	.	G	A	15	8	23	0	1	24	0	0
16	42424240	.	G	A	12	15	27	0	1	28	0	0
16	42424348	.	T	C	13	11	24	0	0	24	0	0
16	42424352	.	G	A	12	9	21	0	0	21	0	0
16	42424504	.	C	A	8	7	15	0	0	15	0	0
16	42424505	.	A	C	7	7	14	0	1	15	0	0
16	42424653	.	G	C	7	7	14	0	1	15	0	0
16	42424762	.	G	A	17	8	25	0	0	25	0	0
16	42441986	.	T	C	10	12	22	0	0	22	0	0
16	42443965	.	G	A	11	9	20	0	0	20	0	0
16	42452554	.	T	C	7	7	14	0	0	14	0	0
16	42452557	.	G	A	7	7	14	0	0	14	0	0
16	42452591	.	C	G	9	8	17	0	0	17	0	0
16	42452592	.	T	A	9	8	17	0	0	17	0	0
16	42453542	.	C	T	2	4	6	0	10	16	0	0
16	42454027	.	G	C	10	5	15	0	1	16	0	0
16	42459378	.	T	C	4	5	9	0	0	9	0	0
16	42461066	.	A	G	3	5	8	0	2	10	0	0
16	42461121	.	T	C	8	0	8	0	10	18	0	0
16	42472146	.	G	T	5	3	8	0	0	8	0	0
16	42472294	.	C	G	1	2	3	0	0	3	0	0
16	42472715	.	C	T	3	2	5	0	0	5	0	0
16	42487947	.	A	G	8	14	22	0	9	31	0	0
16	42490255	.	C	T	14	10	24	0	1	25	0	0
16	42490264	.	T	C	14	10	24	0	2	26	0	0
16	42493796	.	G	C	1	15	16	0	15	31	0	0
16	42493900	.	A	T	14	4	18	0	1	19	0	0
16	42494084	.	G	A	2	9	11	0	6	17	0	0
16	42494143	.	A	T	6	5	11	0	0	11	0	0
16	42667643	.	C	T	5	3	8	0	1	9	0	0
16	42671190	.	C	A	3	3	6	0	0	6	0	0
16	42671229	.	A	C	3	2	5	0	0	5	0	0
16	42673471	.	A	C	2	2	4	0	2	6	0	0
16	42673487	.	A	T	2	3	5	0	0	5	0	0
16	42678919	.	T	C	2	4	6	0	0	6	0	0
16	42681256	.	C	A	4	8	12	0	0	12	0	0
16	42681270	.	G	C	7	4	11	0	2	13	0	0
16	42693252	.	G	A	1	2	3	0	0	3	0	0
16	42700451	.	C	T	3	2	5	0	0	5	0	0
16	42708969	.	C	T	1	4	5	0	0	5	0	0
16	42833084	.	T	C	11	12	23	0	0	23	0	0
16	42842991	.	G	C	4	14	18	0	0	18	0	0
16	42842995	.	A	G	3	14	17	0	1	18	0	0
16	42843128	.	G	A	7	6	13	0	0	13	0	0
16	42938992	.	G	T	5	3	8	0	0	8	0	0
16	42939343	.	C	T	0	8	8	0	10	18	0	0
16	42939351	.	T	C	12	5	17	0	1	18	0	0
16	42939443	.	A	C	12	1	13	0	10	23	0	0
16	42939479	.	A	G	17	20	37	0	1	38	0	0
16	42939480	.	C	T	2	14	16	0	22	38	0	0
16	42939561	.	G	C	18	7	25	0	4	29	0	0
16	42939695	.	A	G	11	12	23	0	0	23	0	0
16	42940259	.	A	G	3	5	8	0	0	8	0	0
16	42940336	.	A	G	7	8	15	0	0	15	0	0
16	42940490	.	T	C	2	4	6	1	0	7	0	0
16	42940836	.	A	C	2	3	5	0	0	5	0	0
16	42940916	.	G	A	3	2	5	0	0	5	0	0
16	42940988	.	T	C	5	2	7	0	0	7	0	0
16	42941124	.	C	A	7	7	14	0	2	16	0	0
16	42941189	.	C	A	9	8	17	0	0	17	0	0
16	42949149	.	G	A	2	6	8	0	0	8	0	0
16	42951876	.	G	A	7	5	12	0	0	12	0	0
16	42975563	.	G	C	1	2	3	0	1	4	0	0
16	42975568	.	G	A	1	2	3	0	1	4	0	0
16	42975613	.	A	G	3	4	7	0	0	7	0	0
16	42975664	.	T	G	1	2	3	0	0	3	0	0
16	42993052	.	G	A	1	2	3	0	0	3	0	0
16	43001246	.	G	C	5	0	5	0	9	14	0	0
16	43001354	.	C	T	0	23	23	0	11	34	0	0
16	43003080	.	A	G	10	16	26	0	2	28	0	0
16	43026164	.	G	T	10	4	14	0	1	15	0	0
16	43026201	.	G	T	7	4	11	0	2	13	0	0
16	43028153	.	T	A	8	3	11	0	0	11	0	0
16	43028156	.	G	A	8	3	11	0	0	11	0	0
16	43028295	.	T	C	7	3	10	0	0	10	0	0
16	43028303	.	C	T	7	3	10	0	0	10	0	0
16	43028453	.	C	T	6	7	13	0	0	13	0	0
16	43028542	.	A	T	8	11	19	0	0	19	0	0
16	43028546	.	C	T	7	11	18	0	0	18	0	0
16	43028626	.	A	C	13	4	17	0	0	17	0	0
16	43031834	.	C	G	11	3	14	0	0	14	0	0
16	43039305	.	T	C	2	2	4	0	1	5	0	0
16	43126424	.	A	T	1	5	6	0	0	6	0	0
16	43126425	.	C	T	1	5	6	0	0	6	0	0
16	43126502	.	G	T	3	4	7	0	4	11	0	0
16	43126546	.	A	C	2	0	2	0	11	13	0	0
16	43126603	.	A	T	3	4	7	0	0	7	0	0
16	43126886	.	A	G	4	12	16	0	0	16	0	0
16	43126887	.	C	T	0	12	12	0	4	16	0	0
16	43145476	.	T	A	3	2	5	0	0	5	0	0
16	43145747	.	A	G	3	0	3	0	2	5	0	0
16	43149664	.	C	T	1	3	4	0	0	4	0	0
16	43149687	.	C	G	2	2	4	0	0	4	0	0
16	43153076	.	C	A	10	9	19	0	0	19	0	0
16	43153537	.	C	A	8	9	17	0	0	17	0	0
16	43198921	.	C	T	10	9	19	0	0	19	0	0
16	43971245	.	T	C	8	16	24	0	1	25	0	0
16	43971248	.	G	A	11	14	25	0	2	27	0	0
16	44044497	.	C	T	7	11	18	0	2	20	0	0
16	44338921	.	T	A	37	21	58	0	0	58	0	0
16	44339284	.	C	T	4	25	29	1	22	52	0	0
16	44339466	.	A	G	23	29	52	0	1	53	0	0
16	44339475	.	A	G	27	30	57	0	0	57	0	0
16	44342679	.	C	T	34	22	56	0	0	56	0	0
16	44379120	.	A	G	17	20	37	0	0	37	0	0
16	44379168	.	T	C	19	21	40	0	2	42	0	0
16	44379219	.	T	A	20	16	36	0	2	38	0	0
16	44984622	.	A	G	1	3	4	1	1	6	0	0
16	46091247	.	T	C	7	4	11	0	0	11	0	0
16	46198406	.	A	G	33	19	52	0	1	53	0	0
16	46399602	.	T	C	6	2	8	0	1	9	0	0
16	46464219	.	G	A	20	7	27	5	1	33	0	0
16	46464279	.	G	A	21	8	29	0	0	29	0	0
16	46464423	.	A	G	7	1	8	1	2	11	0	0
16	46492946	.	G	A	4	2	6	0	0	6	0	0
16	49661388	.	A	G	1	0	1	0	2	3	0	0
16	51094706	.	G	A	2	3	5	0	0	5	0	0
16	51094724	.	G	A	3	2	5	0	0	5	0	0
16	51183892	.	A	T	8	5	13	0	0	13	0	0
16	51244500	.	T	C	2	2	4	0	0	4	0	0
16	51268695	.	T	G	3	2	5	2	0	7	0	0
16	51370110	.	T	C	2	0	2	0	3	5	0	0
16	51370414	.	T	C	1	3	4	0	1	5	0	0
16	51559527	.	C	T	12	6	18	0	0	18	0	0
16	51950940	.	G	A	6	42	48	0	1	49	0	0
16	51951344	.	T	C	25	5	30	0	4	34	0	0
16	51951690	.	T	C	9	13	22	0	1	23	0	0
16	51951691	.	T	C	9	13	22	0	1	23	0	0
16	52130690	.	G	A	1	4	5	0	4	9	0	0
16	52208238	.	C	T	8	4	12	0	2	14	0	0
16	52214476	.	C	T	5	6	11	0	0	11	0	0
16	52218769	.	C	T	3	6	9	0	2	11	0	0
16	52218876	.	C	G	3	6	9	0	0	9	0	0
16	52223760	.	C	G	7	3	10	0	1	11	0	0
16	53150097	.	C	G	1	2	3	0	0	3	0	0
16	53152935	.	C	T	1	2	3	0	0	3	0	0
16	53153058	.	C	T	4	3	7	0	0	7	0	0
16	53188515	.	C	A	1	2	3	0	0	3	0	0
16	53190548	.	A	G	1	0	1	0	2	3	0	0
16	53190563	.	G	A	0	3	3	0	1	4	0	0
16	53191089	.	T	C	1	3	4	0	0	4	0	0
16	53212009	.	G	A	3	4	7	0	0	7	0	0
16	53213713	.	C	T	2	4	6	0	0	6	0	0
16	53224473	.	G	C	2	10	12	0	7	19	0	0
16	53224629	.	C	T	7	5	12	0	1	13	0	0
16	53247109	.	T	A	6	3	9	0	2	11	0	0
16	53247178	.	C	T	4	7	11	0	0	11	0	0
16	53278513	.	A	G	14	0	14	1	12	27	0	0
16	53285758	.	A	C	7	4	11	0	0	11	0	0
16	53290842	.	G	A	1	8	9	0	11	20	0	0
16	53401050	.	G	A	1	2	3	0	6	9	0	0
16	53401101	.	G	A	2	3	5	0	0	5	0	0
16	53430381	.	C	T	5	5	10	0	1	11	0	0
16	53433215	.	G	A	0	2	2	0	4	6	0	0
16	53443714	.	C	T	4	3	7	0	0	7	0	0
16	53443724	.	G	T	0	4	4	0	4	8	0	0
16	53449751	.	C	T	1	2	3	0	0	3	0	0
16	53449799	.	C	G	2	0	2	0	3	5	0	0
16	53449943	.	T	C	2	5	7	0	0	7	0	0
16	53451150	.	A	C	1	2	3	0	1	4	0	0
16	53495455	.	G	A	0	8	8	0	8	16	0	0
16	53495521	.	C	T	9	10	19	0	0	19	0	0
16	53502390	.	C	T	2	2	4	0	0	4	0	0
16	53513549	.	C	T	8	11	19	0	0	19	0	0
16	53513618	.	C	G	11	0	11	0	10	21	0	0
16	53516147	.	T	G	16	8	24	0	0	24	0	0
16	53516232	.	G	A	8	15	23	0	2	25	0	0
16	53516303	.	T	C	7	5	12	0	1	13	0	0
16	53529665	.	T	C	10	3	13	0	0	13	0	0
16	53530047	.	G	C	0	4	4	0	5	9	0	0
16	53530490	.	A	T	3	5	8	0	1	9	0	0
16	53537205	.	C	T	12	6	18	0	0	18	0	0
16	53538806	.	G	A	1	13	14	0	8	22	0	0
16	53539389	.	G	A	10	4	14	0	0	14	0	0
16	53539399	.	T	C	5	8	13	0	0	13	0	0
16	53541879	.	A	G	8	5	13	0	0	13	0	0
16	53541963	.	T	A	5	6	11	0	1	12	0	0
16	53590609	.	C	T	1	3	4	0	0	4	0	0
16	53591872	.	G	A	12	6	18	0	1	19	0	0
16	53591908	.	C	G	4	18	22	0	0	22	0	0
16	53592058	.	T	A	15	10	25	0	1	26	0	0
16	53592375	.	C	T	10	12	22	0	7	29	0	0
16	53596689	.	C	T	3	7	10	0	1	11	0	0
16	53596872	.	C	T	3	7	10	0	0	10	0	0
16	53601486	.	A	G	3	1	4	0	17	21	0	0
16	53609415	.	A	G	3	7	10	0	0	10	0	0
16	53610102	.	C	T	5	2	7	0	0	7	0	0
16	53610144	.	C	T	4	6	10	0	0	10	0	0
16	53618899	.	C	T	8	3	11	0	0	11	0	0
16	53621578	.	A	G	6	0	6	0	11	17	0	0
16	53623357	.	G	A	4	7	11	0	4	15	0	0
16	53626853	.	T	C	7	6	13	0	0	13	0	0
16	53629202	.	G	A	7	10	17	0	1	18	0	0
16	53633125	.	G	A	0	7	7	0	6	13	0	0
16	53701171	.	A	C	22	41	63	0	5	68	0	0
16	53708312	.	C	G	34	34	68	0	1	69	0	0
16	53708537	.	G	T	2	2	4	1	0	5	0	0
16	53708564	.	T	C	4	2	6	1	0	7	0	0
16	53733964	.	G	A	5	2	7	0	0	7	0	0
16	53734226	.	C	T	0	2	2	0	1	3	0	0
16	53734454	.	G	T	1	4	5	0	0	5	0	0
16	53734522	.	A	C	3	2	5	0	0	5	0	0
16	54186911	.	C	T	5	9	14	0	0	14	0	0
16	54210516	.	T	G	3	0	3	0	0	3	0	0
16	54210526	.	G	A	1	2	3	0	3	6	0	0
16	54212731	.	A	G	2	0	2	0	2	4	0	0
16	54217347	.	A	C	3	8	11	0	1	12	0	0
16	54217408	.	G	A	0	6	6	0	6	12	0	0
16	54222382	.	C	T	5	12	17	0	0	17	0	0
16	54222433	.	T	C	7	8	15	0	3	18	0	0
16	54222448	.	G	A	7	8	15	0	0	15	0	0
16	54239233	.	C	T	2	5	7	0	0	7	0	0
16	54245580	.	T	A	6	5	11	0	1	12	0	0
16	54245609	.	C	T	3	5	8	0	0	8	0	0
16	54245777	.	G	A	2	3	5	0	0	5	0	0
16	54245781	.	T	A	2	2	4	0	0	4	0	0
16	54303742	.	G	C	4	7	11	0	1	12	0	0
16	54313643	.	T	A	2	5	7	0	0	7	0	0
16	54314226	.	G	A	2	5	7	0	3	10	0	0
16	54314463	.	C	G	8	7	15	0	0	15	0	0
16	54356904	.	C	A	3	3	6	0	1	7	0	0
16	54474858	.	A	G	3	8	11	0	0	11	0	0
16	54474942	.	G	A	5	7	12	0	1	13	0	0
16	54474943	.	C	T	6	6	12	0	1	13	0	0
16	54483374	.	G	A	0	5	5	0	0	5	0	0
16	54483392	.	C	T	3	2	5	0	0	5	0	0
16	54491760	.	G	A	10	5	15	0	0	15	0	0
16	54498040	.	A	T	13	6	19	0	1	20	0	0
16	54521432	.	T	C	2	2	4	0	0	4	0	0
16	54521453	.	A	T	1	3	4	0	2	6	0	0
16	54521468	.	A	C	1	5	6	0	0	6	0	0
16	54568542	.	G	T	13	9	22	0	0	22	0	0
16	54568755	.	C	A	18	6	24	0	0	24	0	0
16	54568813	.	G	C	15	4	19	0	0	19	0	0
16	54571033	.	C	T	9	7	16	0	0	16	0	0
16	54574237	.	T	G	10	9	19	0	0	19	0	0
16	54574282	.	C	G	13	12	25	0	0	25	0	0
16	54580891	.	G	A	16	9	25	0	0	25	0	0
16	54580930	.	G	A	15	7	22	0	0	22	0	0
16	54580999	.	T	C	12	6	18	0	1	19	0	0
16	54582681	.	G	A	11	10	21	0	0	21	0	0
16	54583177	.	C	T	14	10	24	0	1	25	0	0
16	54584176	.	C	T	12	8	20	0	0	20	0	0
16	54584670	.	C	T	15	9	24	0	1	25	0	0
16	54585298	.	T	A	15	11	26	0	1	27	0	0
16	54585799	.	C	T	8	14	22	0	2	24	0	0
16	54586574	.	C	G	7	9	16	0	0	16	0	0
16	54588989	.	G	A	15	7	22	0	0	22	0	0
16	54590186	.	G	A	1	7	8	0	9	17	0	0
16	54592503	.	T	C	12	9	21	0	1	22	0	0
16	54593401	.	A	G	15	17	32	0	3	35	0	0
16	54594103	.	T	C	27	15	42	1	6	49	0	0
16	54594270	.	A	T	18	18	36	0	3	39	0	0
16	54594334	.	G	T	15	10	25	0	0	25	0	0
16	54594511	.	A	G	19	0	19	0	8	27	0	0
16	54594602	.	C	T	11	12	23	0	2	25	0	0
16	54594605	.	T	C	11	13	24	0	1	25	0	0
16	54594664	.	A	T	6	8	14	0	1	16	1	0
16	54636225	.	C	G	0	5	5	0	4	9	0	0
16	54636692	.	G	A	2	3	5	0	0	5	0	0
16	54636792	.	A	G	2	9	11	0	0	11	0	0
16	54780612	.	G	A	13	12	25	0	0	25	0	0
16	54780864	.	G	A	1	15	16	0	20	36	0	0
16	54781935	.	A	G	1	3	4	0	0	4	0	0
16	54782373	.	T	C	12	16	28	0	0	28	0	0
16	54785429	.	A	T	10	9	19	0	2	21	0	0
16	54786967	.	C	T	14	20	34	2	2	38	0	0
16	54787564	.	T	G	5	8	13	0	1	14	0	0
16	54793964	.	C	A	19	18	37	0	4	41	0	0
16	54794100	.	G	A	20	21	41	0	3	44	0	0
16	54795141	.	A	G	15	21	36	0	1	37	0	0
16	54795732	.	A	G	17	10	27	0	0	27	0	0
16	54795735	.	G	A	17	9	26	0	0	26	0	0
16	54800128	.	A	T	15	11	26	0	1	27	0	0
16	54806749	.	T	G	1	3	4	0	2	6	0	0
16	54806775	.	T	C	1	3	4	0	3	7	0	0
16	54807481	.	T	G	2	2	4	0	0	4	0	0
16	54809840	.	G	T	5	3	8	0	1	9	0	0
16	54809855	.	C	T	5	4	9	0	0	9	0	0
16	54809957	.	G	A	3	3	6	0	0	6	0	0
16	54809990	.	A	G	4	4	8	0	0	8	0	0
16	54829650	.	C	T	26	33	59	0	2	61	0	0
16	54829656	.	A	G	27	34	61	0	0	61	0	0
16	54837250	.	T	C	29	43	72	0	5	77	0	0
16	54843723	.	C	T	45	28	73	0	3	76	0	0
16	54843798	.	A	G	36	1	37	0	42	79	0	0
16	54846250	.	G	A	6	33	39	0	34	73	0	0
16	54926313	.	G	T	2	2	4	0	0	4	0	0
16	54930903	.	A	G	2	6	8	0	0	8	0	0
16	54930916	.	T	A	2	3	5	0	0	5	0	0
16	54932963	.	T	C	4	2	6	0	0	6	0	0
16	54940615	.	A	G	5	4	9	0	0	9	0	0
16	54947827	.	T	G	2	2	4	0	0	4	0	0
16	54947931	.	C	T	1	2	3	0	5	8	0	0
16	54947978	.	G	A	8	3	11	0	0	11	0	0
16	54948227	.	A	G	7	9	16	0	0	16	0	0
16	54948369	.	T	A	6	9	15	0	0	15	0	0
16	54948467	.	C	A	4	7	11	0	0	11	0	0
16	54948483	.	T	A	5	7	12	0	2	14	0	0
16	54948511	.	C	A	2	6	8	0	4	12	0	0
16	54948538	.	A	T	5	1	6	0	1	7	0	0
16	54949140	.	G	A	21	7	28	0	0	28	0	0
16	54952935	.	G	A	10	11	21	0	2	23	0	0
16	54953031	.	C	T	0	14	14	0	8	22	0	0
16	54953067	.	G	A	10	13	23	0	1	24	0	0
16	54956620	.	C	T	12	12	24	0	1	25	0	0
16	54956777	.	T	C	3	10	13	0	1	14	0	0
16	54957387	.	A	G	3	13	16	0	0	16	0	0
16	54957388	.	C	G	3	12	15	0	1	16	0	0
16	54958913	.	G	A	9	6	15	0	0	15	0	0
16	54964128	.	G	T	6	6	12	0	1	13	0	0
16	54964281	.	G	C	16	9	25	0	0	25	0	0
16	54964287	.	G	A	16	8	24	0	1	25	0	0
16	54967883	.	C	T	12	8	20	0	0	20	0	0
16	55004622	.	T	A	6	3	9	0	0	9	0	0
16	55004716	.	T	C	16	1	17	0	11	28	0	0
16	55004723	.	C	G	18	12	30	0	0	30	0	0
16	55012643	.	G	A	11	8	19	0	0	19	0	0
16	55018728	.	T	G	1	4	5	0	0	5	0	0
16	55078485	.	T	C	2	2	4	0	0	4	0	0
16	55090786	.	C	T	3	4	7	0	2	9	0	0
16	55090796	.	C	A	4	4	8	0	1	9	0	0
16	55090845	.	C	T	7	2	9	0	0	9	0	0
16	55102422	.	C	G	11	0	11	0	8	19	0	0
16	55102568	.	T	C	3	2	5	0	0	5	0	0
16	55102781	.	C	G	2	3	5	0	0	5	0	0
16	55102826	.	T	C	1	2	3	0	1	4	0	0
16	55102884	.	T	C	3	2	5	0	0	5	0	0
16	55106474	.	C	T	2	7	9	0	6	15	0	0
16	55106640	.	T	C	12	0	12	0	8	20	0	0
16	55106724	.	A	C	20	0	20	0	15	35	0	0
16	55108801	.	C	T	17	15	32	0	0	32	0	0
16	55108828	.	C	T	15	13	28	0	0	28	0	0
16	55172448	.	G	C	1	2	3	0	2	5	0	0
16	55174925	.	T	C	1	2	3	0	1	4	0	0
16	55181068	.	G	A	0	3	3	0	6	9	0	0
16	55181337	.	A	T	2	2	4	0	0	4	0	0
16	55182249	.	A	T	5	3	8	0	0	8	0	0
16	55220313	.	G	T	2	2	4	0	1	5	0	0
17	69894	.	A	G	15	5	20	0	2	22	0	0
17	70755	.	G	A	0	2	2	0	2	4	0	0
17	70804	.	A	T	2	2	4	0	1	5	0	0
17	70933	.	C	G	7	6	13	0	0	13	0	0
17	70970	.	A	G	8	3	11	0	0	11	0	0
17	71063	.	T	C	2	3	5	0	1	6	0	0
17	118732	.	A	G	1	3	4	0	0	4	0	0
17	132695	.	G	A	4	2	6	0	0	6	0	0
17	132932	.	A	C	6	7	13	0	0	13	0	0
17	133001	.	C	G	8	3	11	0	0	11	0	0
17	133232	.	G	A	0	6	6	0	3	9	0	0
17	136304	.	A	G	18	17	35	0	0	35	0	0
17	136599	.	G	A	13	21	34	0	0	34	0	0
17	139048	.	G	C	2	2	4	0	0	4	0	0
17	198727	.	C	T	1	2	3	0	4	7	0	0
17	198772	.	A	G	2	3	5	0	1	6	0	0
17	199664	.	G	A	4	5	9	0	0	9	0	0
17	200191	.	G	A	3	3	6	0	1	7	0	0
17	338188	.	C	A	7	4	11	0	1	12	0	0
17	338443	.	A	C	6	4	10	0	0	10	0	0
17	338449	.	G	T	7	5	12	0	0	12	0	0
17	346672	.	A	C	3	2	5	0	0	5	0	0
17	347016	.	A	G	6	0	6	0	4	10	0	0
17	402167	.	A	T	3	3	6	0	0	6	0	0
17	445759	.	A	G	2	2	4	0	0	4	0	0
17	445770	.	A	G	3	1	4	0	1	5	0	0
17	599913	.	T	A	7	6	13	0	0	13	0	0
17	600039	.	A	T	8	3	11	0	0	11	0	0
17	601550	.	A	G	4	7	11	0	0	11	0	0
17	604766	.	A	T	3	8	11	0	0	11	0	0
17	604796	.	A	G	4	4	8	0	1	9	0	0
17	604853	.	G	A	3	12	15	0	1	16	0	0
17	604934	.	T	G	4	7	11	0	0	11	0	0
17	604955	.	A	G	6	5	11	0	1	12	0	0
17	605512	.	G	A	3	5	8	0	0	8	0	0
17	635311	.	C	T	7	2	9	0	0	9	0	0
17	635319	.	G	A	6	5	11	0	1	12	0	0
17	636178	.	C	T	6	5	11	0	0	11	0	0
17	643535	.	A	G	3	0	3	0	3	6	0	0
17	645486	.	T	C	6	4	10	0	0	10	0	0
17	660617	.	C	A	6	20	26	0	22	48	0	0
17	681127	.	G	A	16	19	35	0	0	35	0	0
17	734235	.	T	C	15	1	16	0	21	37	0	0
17	734244	.	T	C	21	18	39	0	1	40	0	0
17	734492	.	T	C	10	0	10	0	7	17	0	0
17	735297	.	C	G	1	8	9	1	3	13	0	0
17	735472	.	G	A	5	6	11	0	1	12	0	0
17	735511	.	T	C	2	0	2	0	6	8	0	0
17	735520	.	G	A	2	4	6	0	0	6	0	0
17	742225	.	C	T	5	6	11	0	0	11	0	0
17	742274	.	A	T	6	6	12	0	0	12	0	0
17	743576	.	T	A	17	8	25	0	0	25	0	0
17	743851	.	C	A	17	18	35	0	0	35	0	0
17	860186	.	T	C	3	0	3	0	5	8	0	0
17	860339	.	G	A	8	12	20	0	0	20	0	0
17	860451	.	C	G	14	12	26	0	3	29	0	0
17	860501	.	G	A	8	14	22	0	0	22	0	0
17	860645	.	C	T	0	9	9	0	9	18	0	0
17	860704	.	G	A	8	9	17	0	1	18	0	0
17	860852	.	A	G	8	6	14	0	1	15	0	0
17	861065	.	G	A	4	5	9	0	0	9	0	0
17	867178	.	T	G	5	3	8	0	0	8	0	0
17	867190	.	T	C	3	4	7	0	2	9	0	0
17	867896	.	G	T	6	8	14	0	0	14	0	0
17	921371	.	C	T	1	14	15	2	7	24	0	0
17	923611	.	A	G	15	8	23	0	0	23	0	0
17	927187	.	A	G	12	12	24	0	0	24	0	0
17	931976	.	G	T	14	13	27	0	0	27	0	0
17	932270	.	G	A	10	6	16	0	2	18	0	0
17	932357	.	G	A	12	7	19	0	0	19	0	0
17	932759	.	A	G	12	8	20	0	0	20	0	0
17	932789	.	G	C	12	9	21	0	0	21	0	0
17	932858	.	C	A	1	11	12	0	15	27	0	0
17	932969	.	C	T	2	11	13	0	8	21	0	0
17	933002	.	A	G	9	8	17	0	1	18	0	0
17	936056	.	C	T	14	9	23	0	0	23	0	0
17	936203	.	G	A	12	9	21	0	1	22	0	0
17	937642	.	A	G	15	10	25	0	1	26	0	0
17	937725	.	G	A	14	12	26	0	0	26	0	0
17	937738	.	T	C	15	13	28	0	0	28	0	0
17	939749	.	A	G	13	11	24	0	0	24	0	0
17	939806	.	C	T	11	7	18	0	0	18	0	0
17	940742	.	C	T	9	12	21	0	0	21	0	0
17	945704	.	G	C	10	0	10	0	8	18	0	0
17	945731	.	T	C	10	8	18	0	0	18	0	0
17	945812	.	C	T	3	13	16	0	11	27	0	0
17	945836	.	G	T	14	10	24	0	0	24	0	0
17	973958	.	A	G	6	9	15	0	0	15	0	0
17	974775	.	C	T	13	10	23	0	1	24	0	0
17	974838	.	G	T	11	12	23	0	0	23	0	0
17	979925	.	A	T	12	12	24	1	1	26	0	0
17	1069048	.	G	T	3	2	5	0	1	6	0	0
17	1122515	.	G	A	5	6	11	0	0	11	0	0
17	1122530	.	T	G	6	6	12	0	0	12	0	0
17	1137580	.	T	C	1	0	1	0	7	8	0	0
17	1141376	.	G	T	2	7	9	0	0	9	0	0
17	1144445	.	T	A	4	5	9	0	1	10	0	0
17	1150139	.	G	A	4	5	9	0	1	10	0	0
17	1159904	.	G	T	1	3	4	0	0	4	0	0
17	1256666	.	A	T	5	3	8	0	0	8	0	0
17	1256747	.	C	T	5	4	9	0	0	9	0	0
17	1258380	.	C	T	5	2	7	0	0	7	0	0
17	1258485	.	G	A	1	7	8	0	4	12	0	0
17	1339255	.	G	A	0	1	1	0	2	3	0	0
17	1355243	.	T	G	4	2	6	0	0	6	0	0
17	1355509	.	T	C	7	3	10	0	0	10	0	0
17	1355561	.	A	T	7	3	10	0	0	10	0	0
17	1355562	.	C	T	6	3	9	0	0	9	0	0
17	1355621	.	T	A	1	2	3	0	0	3	0	0
17	1360292	.	G	T	0	3	3	0	5	8	0	0
17	1362172	.	C	T	3	2	5	0	0	5	0	0
17	1369251	.	T	A	2	1	3	0	1	4	0	0
17	1407072	.	T	C	3	1	4	0	2	6	0	0
17	1527642	.	T	C	3	2	5	0	0	5	0	0
17	1527669	.	T	G	1	2	3	0	0	3	0	0
17	1528411	.	A	T	1	2	3	0	0	3	0	0
17	1545150	.	A	G	1	2	3	0	0	3	0	0
17	1579338	.	A	T	1	2	3	0	1	4	0	0
17	1585156	.	G	T	3	3	6	0	0	6	0	0
17	1585557	.	C	T	3	3	6	0	0	6	0	0
17	1591201	.	T	C	2	3	5	0	0	5	0	0
17	1591245	.	A	G	3	3	6	0	0	6	0	0
17	1602351	.	T	A	3	5	8	0	0	8	0	0
17	1603491	.	A	G	3	0	3	0	5	8	0	0
17	1605946	.	T	C	1	3	4	0	1	5	0	0
17	2063925	.	A	G	20	30	50	0	4	54	0	0
17	2091858	.	G	A	2	18	20	0	22	42	0	0
17	2095454	.	T	C	23	25	48	0	0	48	0	0
17	2095525	.	A	G	14	0	14	0	38	52	0	0
17	2109014	.	C	T	1	12	13	0	4	17	0	0
17	2110588	.	G	A	15	9	24	1	1	26	0	0
17	2110642	.	C	G	9	20	29	1	0	30	0	0
17	2110657	.	T	C	8	0	8	0	23	31	0	0
17	2115464	.	A	T	14	21	35	0	0	35	0	0
17	2122175	.	A	G	15	15	30	0	1	31	0	0
17	2122252	.	C	T	14	19	33	0	1	34	0	0
17	2226867	.	T	C	8	6	14	0	0	14	0	0
17	2226876	.	T	C	7	5	12	0	0	12	0	0
17	2226957	.	A	G	4	7	11	0	0	11	0	0
17	2231353	.	C	T	1	4	5	0	0	5	0	0
17	2231359	.	G	A	1	2	3	0	1	4	0	0
17	2231392	.	G	A	0	6	6	0	3	9	0	0
17	2231450	.	C	T	6	5	11	0	0	11	0	0
17	2231608	.	T	C	2	2	4	0	1	5	0	0
17	2231611	.	T	A	2	3	5	0	1	6	0	0
17	2260582	.	G	A	5	5	10	0	0	10	0	0
17	2366309	.	T	C	1	9	10	0	0	10	0	0
17	2369970	.	C	T	2	6	8	0	0	8	0	0
17	2376866	.	G	A	1	2	3	0	2	5	0	0
17	2385989	.	T	C	2	12	14	0	1	15	0	0
17	2419656	.	T	C	1	0	1	0	9	10	0	0
17	2421926	.	T	C	1	0	1	0	6	7	0	0
17	2479620	.	C	A	10	10	20	0	0	20	0	0
17	2498487	.	T	C	7	5	12	0	0	12	0	0
17	2498572	.	C	T	8	5	13	0	1	14	0	0
17	2498573	.	C	G	9	5	14	0	0	14	0	0
17	2498615	.	C	G	10	13	23	0	0	23	0	0
17	2609167	.	C	G	2	4	6	0	0	6	0	0
17	2609207	.	C	T	2	2	4	0	0	4	0	0
17	2696367	.	C	G	2	2	4	3	0	7	0	0
17	2697973	.	A	T	4	3	7	3	0	10	0	0
17	2697982	.	T	A	2	3	5	3	1	10	1	0
17	2698082	.	T	C	3	2	5	1	0	6	0	0
17	2698083	.	C	T	2	3	5	1	0	6	0	0
17	2698340	.	T	C	1	2	3	0	0	3	0	0
17	2704135	.	G	T	4	4	8	0	0	8	0	0
17	2705875	.	G	C	2	2	4	0	0	5	1	0
17	2708233	.	C	T	0	1	1	0	5	6	0	0
17	2711297	.	T	C	4	0	4	0	3	7	0	0
17	2721233	.	C	T	1	3	4	0	0	4	0	0
17	2902815	.	G	T	8	5	13	0	1	14	0	0
17	2902880	.	A	G	3	3	6	0	1	7	0	0
17	2902911	.	T	G	1	2	3	0	0	3	0	0
17	2903230	.	T	A	1	2	3	0	0	3	0	0
17	2903237	.	A	G	2	2	4	0	0	4	0	0
17	2905019	.	A	G	4	3	7	0	0	7	0	0
17	2905049	.	T	A	6	3	9	0	0	9	0	0
17	2905873	.	G	A	1	3	4	0	0	4	0	0
17	3183360	.	A	G	1	4	5	0	0	5	0	0
17	3183694	.	A	G	2	2	4	0	1	5	0	0
17	3183811	.	T	A	1	7	8	0	2	10	0	0
17	3183970	.	A	G	3	2	5	0	1	6	0	0
17	3184246	.	G	A	6	3	9	0	0	9	0	0
17	3281934	.	A	G	3	7	10	0	0	10	0	0
17	3282028	.	G	A	8	4	12	0	0	12	0	0
17	3282034	.	G	A	8	4	12	0	0	12	0	0
17	3282307	.	C	T	5	3	8	0	0	8	0	0
17	3282367	.	A	G	6	5	11	0	0	11	0	0
17	3282394	.	A	G	5	4	9	0	0	9	0	0
17	3283250	.	A	T	11	5	16	0	2	18	0	0
17	3288101	.	A	G	6	7	13	0	0	13	0	0
17	3290657	.	G	C	5	1	6	0	7	13	0	0
17	3290700	.	A	G	5	9	14	0	0	14	0	0
17	3290771	.	A	T	6	4	10	0	1	11	0	0
17	3446847	.	T	C	8	8	16	0	0	16	0	0
17	3514131	.	C	T	5	4	9	0	0	9	0	0
17	3566811	.	A	G	3	8	11	0	0	11	0	0
17	3566844	.	T	A	2	10	12	0	0	12	0	0
17	3569047	.	T	C	8	5	13	0	1	14	0	0
17	3569050	.	A	C	8	6	14	0	1	15	0	0
17	3569264	.	A	C	6	9	15	0	1	16	0	0
17	3841153	.	A	G	18	8	26	0	0	26	0	0
17	3854290	.	C	T	13	12	25	0	0	25	0	0
17	3855436	.	T	C	14	2	16	0	13	29	0	0
17	3855697	.	C	T	1	14	15	0	11	26	0	0
17	3860794	.	C	G	16	9	25	0	1	26	0	0
17	3860797	.	T	C	16	0	16	0	10	26	0	0
17	3860857	.	C	T	2	11	13	0	17	30	0	0
17	3866424	.	A	T	13	11	24	0	0	24	0	0
17	3868759	.	A	C	13	1	14	0	10	24	0	0
17	3868765	.	T	C	13	1	14	0	12	26	0	0
17	3904966	.	A	T	16	9	25	0	0	25	0	0
17	3905005	.	T	C	15	0	15	0	8	23	0	0
17	3905008	.	G	A	15	7	22	0	0	22	0	0
17	3970905	.	C	T	0	10	10	0	6	16	0	0
17	3986153	.	G	A	9	7	16	0	0	16	0	0
17	3986204	.	A	G	8	7	15	0	0	15	0	0
17	3993854	.	A	G	3	0	3	0	6	9	0	0
17	3993866	.	A	G	3	0	3	0	4	7	0	0
17	3999726	.	T	G	1	2	3	0	0	3	0	0
17	4009449	.	T	C	3	2	5	0	0	5	0	0
17	4014676	.	G	A	0	2	2	0	1	3	0	0
17	4014694	.	A	G	2	2	4	0	0	4	0	0
17	4017133	.	A	C	1	2	3	0	0	3	0	0
17	4017271	.	G	A	4	2	6	0	0	6	0	0
17	4017599	.	G	A	1	2	3	0	0	3	0	0
17	4239560	.	G	A	2	3	5	0	0	5	0	0
17	4239567	.	T	A	2	4	6	0	0	6	0	0
17	4239711	.	A	G	11	14	25	0	1	26	0	0
17	4239975	.	C	T	9	8	17	0	1	18	0	0
17	4240034	.	A	T	7	11	18	0	1	19	0	0
17	4240188	.	G	T	22	13	35	0	0	35	0	0
17	4297551	.	A	C	28	18	46	0	2	48	0	0
17	4297600	.	T	C	29	11	40	0	2	42	0	0
17	4297608	.	G	T	25	12	37	0	5	42	0	0
17	4297649	.	T	A	19	8	27	0	2	29	0	0
17	4297669	.	A	C	19	7	26	0	0	26	0	0
17	4298287	.	A	G	17	31	48	0	10	58	0	0
17	4298306	.	T	G	14	32	46	0	5	51	0	0
17	4298764	.	C	A	9	9	18	0	0	18	0	0
17	4299030	.	C	G	22	18	40	1	2	43	0	0
17	4299095	.	A	T	26	7	33	4	0	37	0	0
17	4299098	.	C	A	26	6	32	4	0	36	0	0
17	4304841	.	G	A	31	34	65	1	2	68	0	0
17	4307164	.	G	A	27	19	46	0	5	51	0	0
17	4307242	.	T	C	34	0	34	0	20	54	0	0
17	4317738	.	G	A	25	19	44	0	3	47	0	0
17	4368900	.	T	A	4	5	9	0	0	9	0	0
17	4368935	.	A	T	7	8	15	0	1	16	0	0
17	4369064	.	A	G	5	6	11	0	0	11	0	0
17	4369166	.	C	G	5	4	9	0	0	9	0	0
17	4369304	.	T	C	2	8	10	0	0	10	0	0
17	4369379	.	G	T	2	4	6	0	0	6	0	0
17	4385860	.	C	T	1	3	4	0	0	4	0	0
17	4385871	.	T	C	1	2	3	0	0	3	0	0
17	4385982	.	C	T	1	4	5	0	0	5	0	0
17	4386026	.	T	A	1	2	3	0	0	3	0	0
17	4702341	.	A	G	1	0	1	0	3	4	0	0
17	4702346	.	C	T	1	3	4	0	0	4	0	0
17	4715270	.	C	T	1	3	4	0	0	4	0	0
17	5061184	.	G	C	11	10	21	0	0	21	0	0
17	5071257	.	G	A	7	15	22	0	0	22	0	0
17	5079084	.	T	C	14	14	28	0	2	30	0	0
17	5081406	.	A	C	15	15	30	0	0	30	0	0
17	5081445	.	G	A	2	12	14	0	12	26	0	0
17	5084892	.	G	A	9	14	23	0	1	24	0	0
17	5090829	.	G	A	2	13	15	0	14	29	0	0
17	5094355	.	T	C	28	12	40	0	0	40	0	0
17	5101234	.	A	G	18	0	18	0	13	31	0	0
17	5105828	.	T	C	9	5	14	0	0	14	0	0
17	5215192	.	T	G	12	6	18	0	0	18	0	0
17	5217050	.	T	C	6	1	7	0	3	10	0	0
17	5239046	.	C	T	0	2	2	1	8	11	0	0
17	5296519	.	A	G	14	6	20	0	0	20	0	0
17	5599125	.	A	G	0	4	4	0	0	4	0	0
17	5599130	.	C	A	2	3	5	0	0	5	0	0
17	5599404	.	A	G	2	2	4	0	0	4	0	0
17	5602339	.	C	G	1	4	5	0	2	7	0	0
17	5602444	.	A	G	3	3	6	0	0	6	0	0
17	5605973	.	G	A	3	2	5	0	0	5	0	0
17	5606443	.	G	A	1	1	2	0	1	3	0	0
17	5756664	.	T	C	1	1	2	0	2	4	0	0
17	5766286	.	A	C	2	6	8	0	0	8	0	0
17	5768681	.	A	T	3	4	7	0	0	7	0	0
17	5768712	.	A	G	3	7	10	0	0	10	0	0
17	5768722	.	C	T	2	7	9	0	0	9	0	0
17	5768756	.	T	C	6	0	6	0	4	10	0	0
17	5816002	.	C	G	1	3	4	0	0	4	0	0
17	5816030	.	C	G	1	3	4	0	0	4	0	0
17	5816156	.	A	G	1	0	1	0	3	4	0	0
17	5816567	.	G	A	3	2	5	0	0	5	0	0
17	5816732	.	A	T	1	2	3	0	0	3	0	0
17	5817423	.	G	A	1	2	3	1	0	4	0	0
17	5818438	.	G	A	1	5	6	0	0	6	0	0
17	5820170	.	C	T	3	4	7	0	0	7	0	0
17	5820173	.	C	T	4	2	6	0	0	6	0	0
17	5821130	.	C	T	3	3	6	0	1	7	0	0
17	5821476	.	G	A	8	6	14	0	1	15	0	0
17	5821578	.	C	T	4	2	6	0	0	6	0	0
17	5895821	.	A	G	7	3	10	0	1	11	0	0
17	5895865	.	G	A	0	13	13	0	4	17	0	0
17	5896025	.	G	A	21	14	35	0	0	35	0	0
17	5896210	.	G	T	10	15	25	0	3	28	0	0
17	5916287	.	T	C	11	21	32	0	2	34	0	0
17	5916392	.	A	G	24	15	39	0	1	40	0	0
17	5926722	.	T	C	17	16	33	0	1	34	0	0
17	5926729	.	A	G	19	14	33	0	0	33	0	0
17	5926981	.	A	T	16	10	26	0	0	26	0	0
17	5927085	.	C	A	14	8	22	0	2	24	0	0
17	5927101	.	T	C	14	4	18	0	1	19	0	0
17	5927172	.	G	A	2	3	5	0	0	5	0	0
17	5927214	.	G	A	0	3	3	0	3	6	0	0
17	5927228	.	A	G	4	2	6	0	0	6	0	0
17	6016351	.	C	T	0	2	2	0	4	6	0	0
17	6030661	.	C	T	1	2	3	0	0	3	0	0
17	6079976	.	A	T	5	5	10	0	1	11	0	0
17	6080000	.	A	C	2	4	6	0	0	6	0	0
17	6080026	.	G	A	2	2	4	0	1	5	0	0
17	6088559	.	C	T	1	2	3	0	1	4	0	0
17	6091391	.	G	A	0	2	2	0	1	3	0	0
17	6091392	.	T	G	1	2	3	0	0	3	0	0
17	6101343	.	C	T	8	4	12	0	0	12	0	0
17	6279806	.	C	A	12	12	24	0	0	24	0	0
17	6279876	.	G	T	0	12	12	0	14	26	0	0
17	6394106	.	C	T	7	3	10	0	0	10	0	0
17	6394301	.	C	T	0	10	10	0	6	16	0	0
17	6394744	.	C	T	5	9	14	0	0	14	0	0
17	6395381	.	G	C	15	9	24	0	0	24	0	0
17	6395560	.	T	C	13	0	13	0	6	19	0	0
17	6395971	.	G	T	6	6	12	0	1	13	0	0
17	6396090	.	G	A	8	10	18	0	0	18	0	0
17	6396474	.	A	T	9	4	13	0	1	14	0	0
17	6396513	.	A	G	6	4	10	0	0	10	0	0
17	6396764	.	T	C	2	9	11	0	0	11	0	0
17	6397618	.	C	T	4	4	8	0	0	8	0	0
17	6397654	.	A	T	4	4	8	0	0	8	0	0
17	6397883	.	G	A	12	8	20	0	0	20	0	0
17	6397926	.	C	A	7	8	15	0	1	16	0	0
17	6398456	.	G	C	2	5	7	0	0	7	0	0
17	6398621	.	G	A	4	7	11	0	0	11	0	0
17	6398704	.	G	T	3	7	10	0	1	11	0	0
17	6398916	.	C	G	2	6	8	0	0	8	0	0
17	6398949	.	G	A	3	8	11	0	0	11	0	0
17	6398956	.	G	A	7	5	12	0	0	12	0	0
17	6438334	.	A	G	2	6	8	0	0	8	0	0
17	6438387	.	T	C	1	4	5	0	0	5	0	0
17	6438630	.	T	A	4	7	11	0	1	12	0	0
17	6444514	.	T	A	7	8	15	0	0	15	0	0
17	6447234	.	A	G	6	4	10	0	0	10	0	0
17	6447418	.	G	T	8	6	14	0	0	14	0	0
17	6449404	.	C	T	0	4	4	0	7	11	0	0
17	6451702	.	A	G	3	5	8	0	0	8	0	0
17	6452854	.	C	T	4	3	7	0	1	8	0	0
17	6452857	.	T	C	3	4	7	0	1	8	0	0
17	6460449	.	A	C	4	5	9	0	0	9	0	0
17	6462023	.	A	T	9	5	14	0	0	14	0	0
17	6462228	.	G	A	5	3	8	0	0	8	0	0
17	6462331	.	C	T	2	4	6	0	0	6	0	0
17	6467538	.	C	G	2	2	4	0	0	4	0	0
17	6472902	.	C	T	1	2	3	0	0	3	0	0
17	6472911	.	G	A	1	2	3	0	0	3	0	0
17	6487800	.	G	T	1	2	3	0	0	3	0	0
17	6536033	.	A	C	1	3	4	0	0	4	0	0
17	6538713	.	C	A	2	2	4	0	0	4	0	0
17	6544078	.	C	T	2	2	4	0	0	4	0	0
17	6715755	.	T	A	31	26	57	0	3	60	0	0
17	6716412	.	G	T	37	28	65	0	1	66	0	0
17	6716472	.	G	A	34	42	76	0	1	77	0	0
17	6730114	.	G	A	32	43	75	0	3	78	0	0
17	6737970	.	C	A	2	37	39	0	27	66	0	0
17	6738212	.	C	A	2	9	11	0	7	18	0	0
17	6754428	.	C	T	1	19	20	0	5	25	0	0
17	6754437	.	T	C	5	17	22	0	0	22	0	0
17	6758867	.	T	G	6	26	32	0	0	32	0	0
17	6808341	.	A	G	11	4	15	1	1	17	0	0
17	6936682	.	C	G	2	2	4	2	0	6	0	0
17	6937612	.	T	C	2	2	4	1	0	5	0	0
17	6937614	.	G	A	2	2	4	1	0	5	0	0
17	7775897	.	A	C	2	2	4	0	0	4	0	0
17	7777103	.	T	C	1	1	2	0	1	3	0	0
17	7780518	.	C	T	1	2	3	0	0	3	0	0
17	7783375	.	C	T	2	3	5	0	1	6	0	0
17	7795583	.	T	A	1	5	6	0	0	6	0	0
17	7795593	.	G	A	1	4	5	0	0	5	0	0
17	7799980	.	A	G	4	4	8	0	0	8	0	0
17	7812480	.	A	T	7	5	12	0	0	12	0	0
17	7815212	.	C	T	6	7	13	0	1	14	0	0
17	7818872	.	T	A	4	4	8	0	0	8	0	0
17	7818935	.	C	T	5	5	10	0	0	10	0	0
17	7845085	.	T	A	6	4	10	0	1	11	0	0
17	7845288	.	A	G	5	2	7	0	0	7	0	0
17	7845364	.	G	C	20	10	30	0	0	30	0	0
17	7845412	.	T	C	19	11	30	0	1	31	0	0
17	7845566	.	C	T	18	15	33	0	0	33	0	0
17	7845604	.	G	A	21	19	40	0	1	41	0	0
17	7845661	.	G	T	24	18	42	0	1	43	0	0
17	7845733	.	G	A	22	19	41	0	4	45	0	0
17	7845776	.	C	G	2	23	25	0	15	40	0	0
17	7845800	.	A	G	19	31	50	0	2	52	0	0
17	7853494	.	T	A	5	6	11	0	2	13	0	0
17	7861124	.	C	T	14	16	30	0	2	32	0	0
17	7868632	.	G	A	21	20	41	0	1	42	0	0
17	7879327	.	C	G	13	21	34	0	0	34	0	0
17	7882941	.	G	A	20	11	31	0	0	31	0	0
17	7882998	.	G	A	15	17	32	0	1	33	0	0
17	7883016	.	C	T	21	11	32	0	1	33	0	0
17	7885635	.	G	A	14	17	31	0	1	32	0	0
17	7885662	.	A	G	14	9	23	0	2	25	0	0
17	7888351	.	G	A	14	13	27	0	0	27	0	0
17	7888369	.	G	A	15	10	25	0	2	27	0	0
17	7896340	.	G	A	16	18	34	0	1	35	0	0
17	7896356	.	C	T	3	16	19	0	14	34	1	0
17	7902203	.	A	G	11	15	26	0	1	27	0	0
17	7906612	.	G	A	8	12	20	0	0	20	0	0
17	7910537	.	C	T	9	13	22	0	1	23	0	0
17	7917414	.	T	A	13	14	27	0	1	28	0	0
17	7917997	.	G	A	17	7	24	0	1	25	0	0
17	7918075	.	C	T	9	19	28	0	1	29	0	0
17	7918244	.	C	T	2	8	10	0	17	27	0	0
17	7918310	.	C	T	3	13	16	0	9	25	0	0
17	7924263	.	G	A	16	7	23	0	1	24	0	0
17	7928615	.	T	G	7	8	15	0	0	15	0	0
17	7931722	.	T	A	10	11	21	0	0	21	0	0
17	7931737	.	G	A	8	11	19	0	0	19	0	0
17	7942122	.	G	A	9	10	19	0	1	20	0	0
17	7942127	.	T	C	7	11	18	0	1	19	0	0
17	7942191	.	T	G	7	9	16	0	0	16	0	0
17	7942375	.	C	T	12	10	22	0	1	23	0	0
17	7945421	.	C	G	12	7	19	0	0	19	0	0
17	7949066	.	G	A	11	9	20	0	0	20	0	0
17	7949119	.	G	T	14	14	28	0	1	29	0	0
17	7950339	.	G	T	5	7	12	0	0	12	0	0
17	7974804	.	T	C	6	8	14	0	1	15	0	0
17	7977746	.	A	T	5	6	11	0	0	11	0	0
17	7977806	.	C	T	5	3	8	0	0	8	0	0
17	7978112	.	T	G	4	4	8	0	0	8	0	0
17	7978533	.	G	A	3	2	5	0	2	7	0	0
17	7981566	.	C	T	5	5	10	0	0	10	0	0
17	7985543	.	A	G	2	2	4	0	0	4	0	0
17	7985693	.	G	A	2	4	6	0	0	6	0	0
17	7985720	.	C	T	4	5	9	0	0	9	0	0
17	7985970	.	C	T	1	3	4	0	6	10	0	0
17	7988467	.	C	T	0	4	4	0	4	8	0	0
17	7991338	.	G	A	4	9	13	0	2	15	0	0
17	7994305	.	A	G	2	3	5	0	0	5	0	0
17	7995655	.	T	C	6	0	6	0	4	10	0	0
17	8000122	.	C	A	6	9	15	0	0	15	0	0
17	8002895	.	G	T	10	4	14	0	0	14	0	0
17	8002932	.	G	A	6	7	13	0	0	13	0	0
17	8003009	.	G	A	5	4	9	0	0	9	0	0
17	8003027	.	T	C	6	4	10	0	0	10	0	0
17	8003165	.	G	T	6	2	8	0	1	9	0	0
17	8006088	.	C	T	5	4	9	0	0	9	0	0
17	8006696	.	T	C	1	3	4	0	0	4	0	0
17	8014187	.	G	A	3	4	7	0	0	7	0	0
17	8015404	.	G	A	4	3	7	0	0	7	0	0
17	8022620	.	C	G	1	2	3	0	1	4	0	0
17	8024283	.	A	T	4	8	12	0	0	12	0	0
17	8024338	.	C	T	4	4	8	0	1	9	0	0
17	8029730	.	T	C	9	0	9	0	3	12	0	0
17	8032819	.	A	C	2	0	2	0	4	6	0	0
17	8036086	.	T	C	8	1	9	0	4	13	0	0
17	8041978	.	C	T	7	4	11	0	0	11	0	0
17	8042133	.	G	A	5	4	9	0	0	9	0	0
17	8042148	.	G	A	5	3	8	0	0	8	0	0
17	8042175	.	A	G	2	2	4	0	1	5	0	0
17	8044351	.	A	G	4	3	7	0	1	8	0	0
17	8044522	.	C	T	0	4	4	0	2	6	0	0
17	8045475	.	C	T	2	4	6	0	2	8	0	0
17	8045486	.	C	T	2	2	4	0	2	6	0	0
17	8046725	.	C	T	2	3	5	0	0	5	0	0
17	8046950	.	A	C	3	2	5	0	0	5	0	0
17	8052567	.	G	T	1	2	3	0	1	4	0	0
17	8052803	.	A	G	2	4	6	0	0	6	0	0
17	8054868	.	A	T	3	4	7	0	2	9	0	0
17	8056241	.	A	G	2	3	5	0	0	5	0	0
17	8056251	.	A	T	2	2	4	0	0	4	0	0
17	8060288	.	T	C	3	3	6	0	0	6	0	0
17	8064881	.	C	T	2	2	4	0	0	4	0	0
17	8066214	.	C	T	5	3	8	0	1	9	0	0
17	8066418	.	C	T	1	3	4	0	1	5	0	0
17	8068522	.	C	T	2	3	5	0	0	5	0	0
17	8071674	.	A	G	3	3	6	0	1	7	0	0
17	8072177	.	T	A	1	2	3	0	0	3	0	0
17	8094875	.	A	T	3	3	6	0	0	6	0	0
17	8109421	.	T	A	3	2	5	0	0	5	0	0
17	8109433	.	C	T	1	2	3	0	2	5	0	0
17	8184435	.	A	G	11	0	11	1	11	23	0	0
17	8184515	.	A	T	9	10	19	0	0	19	0	0
17	8188963	.	G	T	0	13	13	0	18	31	0	0
17	8191370	.	C	A	18	14	32	0	2	34	0	0
17	8191382	.	C	A	12	15	27	0	1	28	0	0
17	8191475	.	A	G	12	14	26	0	1	27	0	0
17	8194715	.	C	A	10	14	24	0	1	25	0	0
17	8197141	.	G	A	8	15	23	0	1	24	0	0
17	8197569	.	C	A	9	12	21	0	2	23	0	0
17	8199812	.	C	T	8	8	16	0	0	16	0	0
17	8202778	.	T	C	24	17	41	0	2	43	0	0
17	8203231	.	T	A	25	19	44	0	5	49	0	0
17	8203234	.	G	A	24	18	42	0	5	47	0	0
17	8203471	.	C	T	19	17	36	0	2	38	0	0
17	8203498	.	G	A	19	13	32	0	6	38	0	0
17	8203729	.	T	C	24	20	44	0	1	45	0	0
17	8204086	.	G	C	15	8	23	1	2	26	0	0
17	8204248	.	A	G	17	0	17	0	24	41	0	0
17	8204533	.	C	T	14	22	36	0	2	38	0	0
17	8204755	.	A	G	23	22	45	0	1	46	0	0
17	8204818	.	A	G	19	18	37	0	3	40	0	0
17	8204962	.	C	T	30	19	49	0	0	49	0	0
17	8205508	.	T	C	19	17	36	0	1	37	0	0
17	8209686	.	A	G	14	10	24	0	1	25	0	0
17	8209931	.	C	A	8	7	15	0	0	15	0	0
17	8210327	.	A	T	16	10	26	0	0	26	0	0
17	8210355	.	T	A	11	5	16	0	3	19	0	0
17	8210365	.	C	T	10	10	20	0	1	21	0	0
17	8210415	.	C	A	7	17	24	0	1	25	0	0
17	8210552	.	A	G	12	8	20	0	0	20	0	0
17	8210596	.	A	C	14	15	29	0	4	33	0	0
17	8210801	.	C	T	15	17	32	0	1	33	0	0
17	8229904	.	C	T	7	2	9	0	0	9	0	0
17	8229906	.	G	A	7	2	9	0	0	9	0	0
17	8234886	.	C	G	12	7	19	0	0	19	0	0
17	8234889	.	C	T	1	8	9	0	11	20	0	0
17	8245790	.	C	A	0	6	6	0	9	15	0	0
17	8245868	.	G	A	3	3	6	0	0	6	0	0
17	8246329	.	T	C	2	4	6	0	1	7	0	0
17	8248987	.	A	G	7	4	11	0	0	11	0	0
17	8249153	.	A	T	11	3	14	0	0	14	0	0
17	8253267	.	A	G	4	5	9	0	0	9	0	0
17	8256663	.	G	A	4	3	7	0	0	7	0	0
17	8259808	.	T	C	4	4	8	0	0	8	0	0
17	8261685	.	A	T	5	4	9	0	0	9	0	0
17	8261799	.	C	T	7	7	14	0	1	15	0	0
17	8265406	.	G	A	5	6	11	0	0	11	0	0
17	8272569	.	T	C	1	1	2	0	2	4	0	0
17	8278888	.	A	T	2	4	6	0	0	6	0	0
17	8284537	.	G	T	2	5	7	0	0	7	0	0
17	8286764	.	C	T	2	3	5	0	0	5	0	0
17	8286877	.	A	G	2	2	4	0	0	4	0	0
17	8286879	.	C	A	1	2	3	0	1	4	0	0
17	8427371	.	C	G	3	3	6	0	0	6	0	0
17	8427407	.	C	T	3	3	6	0	0	6	0	0
17	8427443	.	G	A	0	3	3	0	3	6	0	0
17	8427503	.	A	G	3	3	6	0	0	6	0	0
17	8499025	.	C	T	0	3	3	0	9	12	0	0
17	8502883	.	G	A	8	8	16	0	1	17	0	0
17	8502931	.	G	A	6	7	13	0	0	13	0	0
17	8502949	.	G	C	6	1	7	0	7	14	0	0
17	8502982	.	G	A	7	5	12	0	1	13	0	0
17	8505413	.	G	A	8	3	11	0	0	11	0	0
17	8514511	.	G	A	6	7	13	0	0	13	0	0
17	8514709	.	G	A	1	3	4	0	0	4	0	0
17	8515363	.	G	A	6	6	12	0	0	12	0	0
17	8519109	.	A	G	2	2	4	0	0	4	0	0
17	8562349	.	A	G	1	5	6	0	0	6	0	0
17	8562462	.	G	A	2	4	6	0	0	6	0	0
17	8562551	.	G	C	8	0	8	0	4	12	0	0
17	8562560	.	T	A	7	4	11	0	1	12	0	0
17	8597078	.	C	A	2	14	16	0	21	37	0	0
17	8597174	.	T	A	11	16	27	0	1	28	0	0
17	8597515	.	A	T	24	18	42	1	1	44	0	0
17	8597702	.	A	T	20	17	37	0	0	37	0	0
17	8598070	.	C	T	3	31	34	1	19	54	0	0
17	8598168	.	G	A	25	15	40	0	2	42	0	0
17	8598345	.	T	A	25	30	55	2	0	57	0	0
17	8623396	.	G	A	13	20	33	0	1	34	0	0
17	8623480	.	C	T	3	18	21	0	30	51	0	0
17	8623540	.	C	T	0	17	17	0	23	40	0	0
17	8630043	.	C	A	15	17	32	1	1	34	0	0
17	8727630	.	C	A	5	3	8	1	1	10	0	0
17	8754388	.	C	T	1	3	4	0	0	4	0	0
17	8756231	.	A	G	1	3	4	0	0	4	0	0
17	8757694	.	C	T	4	2	6	0	0	6	0	0
17	8760493	.	T	C	2	4	6	0	1	7	0	0
17	8760808	.	C	A	4	2	6	0	0	6	0	0
17	8766176	.	G	A	5	4	9	0	1	10	0	0
17	8766185	.	G	A	4	4	8	0	1	9	0	0
17	8770161	.	C	G	5	6	11	0	1	12	0	0
17	8780716	.	G	A	5	3	8	0	0	8	0	0
17	8780728	.	C	T	2	5	7	0	0	7	0	0
17	8782396	.	C	T	3	2	5	0	0	5	0	0
17	8784742	.	G	A	0	4	4	0	5	9	0	0
17	8784934	.	C	A	6	6	12	0	0	12	0	0
17	8791613	.	T	A	4	4	8	0	0	8	0	0
17	8791618	.	C	G	3	3	6	0	1	7	0	0
17	8791917	.	T	C	4	4	8	0	0	8	0	0
17	8792020	.	C	T	2	2	4	0	0	4	0	0
17	8927397	.	G	A	12	10	22	0	1	23	0	0
17	8927638	.	A	G	12	11	23	0	0	23	0	0
17	8927641	.	A	G	12	9	21	0	1	22	0	0
17	8930017	.	C	T	14	14	28	0	1	29	0	0
17	8934235	.	C	T	14	21	35	0	0	35	0	0
17	8938011	.	G	A	13	11	24	0	2	26	0	0
17	8938249	.	T	C	16	15	31	0	1	32	0	0
17	8938269	.	G	A	16	18	34	0	0	34	0	0
17	8941206	.	G	A	14	12	26	0	0	26	0	0
17	8941264	.	T	C	6	11	17	0	1	18	0	0
17	8951516	.	C	A	7	6	13	0	0	13	0	0
17	8951606	.	C	G	3	12	15	0	11	26	0	0
17	8951867	.	C	T	4	18	22	0	20	42	0	0
17	8954377	.	G	A	17	13	30	0	0	30	0	0
17	8954482	.	C	T	13	28	41	1	0	42	0	0
17	8969278	.	A	G	21	11	32	0	2	34	0	0
17	8972806	.	T	C	14	0	14	0	18	33	1	0
17	8972821	.	G	A	16	14	30	0	1	31	0	0
17	8976273	.	A	G	13	18	31	0	1	32	0	0
17	9017898	.	A	T	10	7	17	0	0	17	0	0
17	9017899	.	T	G	10	7	17	0	0	17	0	0
17	9017950	.	A	G	7	8	15	0	0	15	0	0
17	9017972	.	G	A	6	5	11	0	1	12	0	0
17	9018124	.	C	T	3	3	6	0	0	6	0	0
17	9040248	.	T	C	5	6	11	0	1	12	0	0
17	9041916	.	C	G	3	0	3	0	5	8	0	0
17	9042447	.	C	T	3	9	12	0	0	12	0	0
17	9042623	.	T	C	8	12	20	0	0	20	0	0
17	9042652	.	T	C	9	13	22	0	1	23	0	0
17	9059105	.	A	G	6	12	18	0	4	22	0	0
17	9157385	.	A	G	2	6	8	0	1	9	0	0
17	9225184	.	G	A	1	11	12	0	11	23	0	0
17	9225223	.	A	G	8	6	14	0	2	16	0	0
17	9248656	.	A	G	9	0	9	0	6	15	0	0
17	9253504	.	A	T	8	13	21	0	0	21	0	0
17	9253705	.	T	C	6	5	11	0	3	14	0	0
17	9254269	.	T	A	4	11	15	0	0	15	0	0
17	9255196	.	G	A	0	6	6	0	9	15	0	0
17	9255547	.	G	C	11	22	33	0	0	33	0	0
17	9255703	.	C	T	9	12	21	0	0	21	0	0
17	9266298	.	C	T	18	8	26	0	2	28	0	0
17	9266501	.	G	T	0	12	12	0	5	17	0	0
17	9501630	.	A	G	9	3	12	0	0	12	0	0
17	9601121	.	G	C	12	4	16	1	0	17	0	0
17	9601133	.	C	T	9	3	12	1	2	15	0	0
17	9847215	.	C	T	12	10	22	0	1	23	0	0
17	9888958	.	C	G	14	12	26	0	0	26	0	0
17	9889223	.	C	T	14	11	25	0	4	29	0	0
17	9889427	.	G	A	13	9	22	0	0	22	0	0
17	9944725	.	A	G	5	4	9	0	0	9	0	0
17	9944733	.	A	G	5	5	10	0	0	10	0	0
17	9944848	.	T	A	5	5	10	0	0	10	0	0
17	9944874	.	C	T	6	2	8	0	0	8	0	0
17	9951885	.	G	A	3	5	8	0	0	8	0	0
17	9952033	.	C	T	1	10	11	0	4	15	0	0
17	9955952	.	C	T	4	6	10	0	0	10	0	0
17	9957881	.	C	T	4	7	11	0	1	12	0	0
17	9961079	.	T	C	4	5	9	0	0	9	0	0
17	9961080	.	G	A	4	5	9	0	0	9	0	0
17	9962505	.	A	G	4	4	8	0	0	8	0	0
17	9964177	.	C	A	2	2	4	0	0	4	0	0
17	9964359	.	T	C	1	2	3	0	0	4	1	0
17	9964361	.	A	G	2	1	3	0	1	4	0	0
17	9964437	.	A	T	4	3	7	0	0	7	0	0
17	9964944	.	C	A	7	5	12	0	0	12	0	0
17	9965010	.	C	A	4	2	6	0	0	6	0	0
17	9965231	.	T	C	2	0	2	0	4	6	0	0
17	9967595	.	A	G	5	3	8	0	0	8	0	0
17	9977591	.	G	A	3	2	5	0	0	5	0	0
17	9981995	.	A	G	2	5	7	0	0	7	0	0
17	9986655	.	G	A	2	2	4	0	0	4	0	0
17	10007488	.	A	T	3	2	5	0	0	5	0	0
17	10007721	.	A	T	3	3	6	0	0	6	0	0
17	10014518	.	G	A	1	3	4	0	0	4	0	0
17	10032559	.	C	T	1	2	3	0	0	3	0	0
17	10047010	.	C	T	2	2	4	0	0	4	0	0
17	10049718	.	G	A	2	2	4	0	0	4	0	0
17	10050272	.	C	T	2	2	4	0	0	4	0	0
17	10052886	.	C	T	0	2	2	0	1	3	0	0
17	10053122	.	A	G	2	3	5	0	0	5	0	0
17	10059909	.	G	A	2	5	7	0	0	7	0	0
17	10062203	.	G	A	1	2	3	0	0	3	0	0
17	10062229	.	T	C	1	0	1	0	2	3	0	0
17	10062243	.	T	C	1	0	1	0	2	3	0	0
17	10062318	.	C	T	2	3	5	0	0	5	0	0
17	10079554	.	G	A	12	9	21	0	0	21	0	0
17	10089583	.	G	T	9	12	21	9	3	33	0	0
17	10089705	.	C	T	1	4	5	0	0	5	0	0
17	10089707	.	C	T	1	4	5	0	0	5	0	0
17	10094067	.	C	T	5	14	19	0	0	19	0	0
17	10095554	.	A	G	6	4	10	0	0	10	0	0
17	10095961	.	G	C	1	5	6	0	6	12	0	0
17	10102289	.	T	C	9	9	18	0	0	18	0	0
17	10103185	.	C	T	8	14	22	0	1	23	0	0
17	10128550	.	A	T	1	8	9	0	0	9	0	0
17	10133901	.	G	A	10	12	22	0	1	23	0	0
17	10133902	.	C	T	11	12	23	0	0	23	0	0
17	10142416	.	G	C	7	7	14	0	0	14	0	0
17	10142474	.	T	G	6	7	13	0	0	13	0	0
17	10142481	.	A	G	5	6	11	0	0	11	0	0
17	10143058	.	A	T	0	2	2	0	1	3	0	0
17	10144027	.	A	C	5	8	13	0	0	13	0	0
17	10144155	.	A	G	1	3	4	0	0	4	0	0
17	10144316	.	A	G	3	0	3	0	2	5	0	0
17	10144336	.	G	A	3	6	9	0	0	9	0	0
17	10144467	.	A	G	5	6	11	0	1	12	0	0
17	10145004	.	G	T	18	10	28	0	0	28	0	0
17	10145281	.	C	T	5	15	20	0	0	20	0	0
17	10243069	.	A	G	3	0	3	0	2	5	0	0
17	10243794	.	C	A	2	4	6	0	0	6	0	0
17	10247875	.	C	A	1	2	3	0	0	4	1	0
17	10248157	.	A	G	4	9	13	0	1	14	0	0
17	10277991	.	T	C	1	2	3	0	0	3	0	0
17	10318127	.	A	T	1	5	6	0	0	6	0	0
17	10320093	.	T	C	2	5	7	0	0	7	0	0
17	10320515	.	A	T	1	2	3	0	0	3	0	0
17	10553213	.	A	T	3	3	6	0	0	6	0	0
17	10571044	.	C	T	4	6	10	0	0	10	0	0
17	10571405	.	C	T	4	3	7	1	0	8	0	0
17	10572460	.	C	G	2	0	2	0	8	10	0	0
17	10572650	.	G	A	3	1	4	0	0	4	0	0
17	10572655	.	T	C	4	2	6	0	0	6	0	0
17	10572736	.	T	C	4	3	7	0	0	7	0	0
17	10572844	.	C	T	4	3	7	0	1	8	0	0
17	10572847	.	G	T	5	2	7	0	1	8	0	0
17	10573034	.	G	A	6	6	12	0	0	12	0	0
17	10573186	.	A	G	8	9	17	0	0	17	0	0
17	10573312	.	C	A	3	6	9	0	0	9	0	0
17	10573327	.	T	C	5	6	11	0	0	11	0	0
17	10573366	.	C	T	8	3	11	0	1	12	0	0
17	10573655	.	G	A	2	4	6	0	0	6	0	0
17	10573720	.	T	A	4	4	8	0	0	8	0	0
17	10574139	.	T	C	1	2	3	0	1	4	0	0
17	10574140	.	G	C	2	2	4	0	0	4	0	0
17	10574230	.	C	T	4	5	9	0	0	9	0	0
17	10574981	.	G	A	9	7	16	0	0	16	0	0
17	10575393	.	C	T	4	5	9	0	1	10	0	0
17	10577538	.	C	A	6	2	8	0	0	8	0	0
17	10577539	.	A	T	4	2	6	0	2	8	0	0
17	10577617	.	A	G	4	1	5	0	2	7	0	0
17	10578540	.	C	T	3	4	7	0	0	7	0	0
17	10578806	.	C	A	6	4	10	0	0	10	0	0
17	10581404	.	T	A	10	6	16	0	0	16	0	0
17	10585056	.	G	A	8	6	14	0	1	15	0	0
17	10585083	.	G	A	2	5	7	0	10	17	0	0
17	10585101	.	G	A	9	6	15	0	0	15	0	0
17	10585140	.	C	T	10	5	15	1	0	16	0	0
17	10585363	.	A	T	9	12	21	0	0	21	0	0
17	10586449	.	A	G	10	9	19	0	0	19	0	0
17	10586664	.	A	C	9	10	19	0	0	19	0	0
17	10587020	.	G	T	10	7	17	0	1	18	0	0
17	10587330	.	A	C	8	5	13	0	1	14	0	0
17	10587601	.	A	G	6	9	15	0	0	15	0	0
17	10643288	.	A	G	6	0	6	0	3	9	0	0
17	10679990	.	T	C	7	7	14	0	1	15	0	0
17	10686248	.	A	T	4	6	10	0	0	10	0	0
17	10686287	.	A	G	4	8	12	0	1	13	0	0
17	10694630	.	G	A	3	6	9	0	0	9	0	0
17	10695904	.	G	A	8	6	14	0	1	15	0	0
17	10695922	.	A	G	7	4	11	0	0	11	0	0
17	10696006	.	C	T	2	7	9	0	0	9	0	0
17	10696137	.	A	T	6	10	16	0	0	16	0	0
17	10696498	.	A	T	4	4	8	0	1	9	0	0
17	10696676	.	A	T	10	7	17	0	0	17	0	0
17	10696688	.	T	C	9	7	16	0	0	16	0	0
17	10698537	.	A	C	8	10	18	0	2	20	0	0
17	10698681	.	G	T	9	11	20	0	1	21	0	0
17	10698977	.	A	C	9	3	12	0	0	12	0	0
17	10699076	.	G	T	0	9	9	0	7	16	0	0
17	10699077	.	A	C	6	8	14	0	2	16	0	0
17	10699151	.	A	G	6	0	6	0	9	15	0	0
17	10703478	.	A	G	4	8	12	0	2	14	0	0
17	10703673	.	T	G	4	8	12	0	0	12	0	0
17	10703731	.	C	T	5	10	15	0	3	18	0	0
17	10703764	.	C	A	8	8	16	0	0	16	0	0
17	10736503	.	G	A	7	8	15	0	0	15	0	0
17	10736572	.	G	A	11	2	13	0	0	13	0	0
17	10748708	.	G	C	0	9	9	0	7	16	0	0
17	10750761	.	T	A	6	10	16	0	1	17	0	0
17	10750767	.	G	A	8	12	20	0	0	20	0	0
17	10751051	.	T	C	13	9	22	0	0	22	0	0
17	10755512	.	A	G	13	9	22	0	1	23	0	0
17	10755656	.	T	C	11	8	19	0	0	19	0	0
17	10761763	.	T	C	10	10	20	0	2	22	0	0
17	10765286	.	C	T	9	11	20	0	0	20	0	0
17	10765328	.	A	G	7	0	7	0	10	17	0	0
17	10765773	.	A	G	2	4	6	0	1	7	0	0
17	10766074	.	G	C	15	7	22	0	0	22	0	0
17	10766142	.	T	A	13	6	19	0	2	21	0	0
17	10766181	.	A	G	6	5	11	0	1	12	0	0
17	10766205	.	G	T	4	7	11	0	0	11	0	0
17	10766219	.	A	T	1	6	7	0	0	7	0	0
17	10783885	.	A	G	8	9	17	0	1	18	0	0
17	10784149	.	C	T	1	7	8	0	21	29	0	0
17	10784151	.	T	C	18	7	25	0	3	28	0	0
17	10784210	.	A	C	13	1	14	0	24	38	0	0
17	10784441	.	A	G	14	10	24	0	1	25	0	0
17	10784618	.	G	A	12	7	19	0	0	19	0	0
17	10784646	.	C	G	10	10	20	0	1	21	0	0
17	10784948	.	A	T	15	11	26	0	0	27	1	0
17	10785020	.	A	G	9	13	22	0	0	22	0	0
17	10785206	.	A	G	11	6	17	0	0	17	0	0
17	10785289	.	T	C	10	5	15	0	1	16	0	0
17	10785552	.	A	G	10	6	16	0	2	18	0	0
17	10785616	.	T	A	10	12	22	0	0	22	0	0
17	10785619	.	C	T	11	12	23	0	0	23	0	0
17	10786085	.	C	A	15	6	21	0	0	21	0	0
17	10786149	.	T	A	8	6	14	0	0	14	0	0
17	10786520	.	T	C	9	6	15	0	0	15	0	0
17	10796797	.	T	C	8	9	17	0	3	20	0	0
17	10813718	.	G	A	10	9	19	0	0	19	0	0
17	10813783	.	A	T	12	12	24	0	0	24	0	0
17	10813817	.	G	T	15	13	28	0	0	28	0	0
17	11507478	.	G	C	2	3	5	0	0	5	0	0
17	11508036	.	C	T	2	2	4	0	0	4	0	0
17	11508163	.	G	T	1	5	6	0	0	6	0	0
17	11585063	.	C	G	2	0	2	0	3	5	0	0
17	11585117	.	G	A	1	2	3	0	1	4	0	0
17	11585279	.	G	A	3	3	6	0	0	6	0	0
17	11585399	.	T	C	1	2	3	0	0	3	0	0
17	11585561	.	T	C	2	3	5	0	0	5	0	0
17	11680788	.	T	G	2	0	2	0	3	5	0	0
17	11692350	.	A	C	2	2	4	0	0	4	0	0
17	11707204	.	C	G	4	1	5	0	4	9	0	0
17	11707297	.	C	T	2	2	4	0	0	4	0	0
17	11708690	.	G	A	7	3	10	0	0	10	0	0
17	11708797	.	G	A	2	4	6	0	7	13	0	0
17	11708993	.	G	A	6	2	8	0	1	9	0	0
17	11709001	.	G	A	5	4	9	0	1	10	0	0
17	11709187	.	G	A	3	3	6	0	0	6	0	0
17	11709199	.	C	T	2	4	6	0	0	6	0	0
17	11709394	.	A	T	6	2	8	0	0	8	0	0
17	11714598	.	T	A	11	9	20	0	2	22	0	0
17	11714635	.	G	C	12	8	20	0	0	20	0	0
17	11714874	.	T	C	1	4	5	0	0	5	0	0
17	11715808	.	G	T	0	2	2	0	5	7	0	0
17	11715917	.	G	C	15	8	23	0	0	23	0	0
17	11716113	.	T	G	4	11	15	0	2	17	0	0
17	11716296	.	A	G	4	6	10	0	2	12	0	0
17	11716701	.	A	G	8	0	8	0	6	14	0	0
17	11716702	.	A	G	4	10	14	0	0	14	0	0
17	11717109	.	C	T	10	16	26	1	4	31	0	0
17	11717131	.	C	T	8	6	14	7	8	29	0	0
17	11717362	.	A	G	0	0	0	3	9	12	0	0
17	11718038	.	A	C	19	9	28	0	2	30	0	0
17	11718118	.	A	G	13	9	22	0	1	23	0	0
17	12409440	.	G	A	1	2	3	2	0	5	0	0
17	12737629	.	A	T	1	7	8	0	0	8	0	0
17	13006550	.	A	G	1	3	4	0	0	4	0	0
17	13763454	.	T	C	7	5	12	0	0	12	0	0
17	13763835	.	C	T	9	7	16	0	0	16	0	0
17	13764198	.	C	T	8	10	18	0	1	19	0	0
17	13764513	.	A	C	7	7	14	0	1	15	0	0
17	13764624	.	T	C	11	5	16	0	1	17	0	0
17	14434312	.	A	T	2	2	4	0	0	4	0	0
17	14434592	.	C	A	1	2	3	0	0	3	0	0
17	14443633	.	T	A	2	4	6	0	0	6	0	0
17	14443651	.	T	C	1	0	1	0	5	6	0	0
17	14443697	.	G	A	7	4	11	0	1	12	0	0
17	14444166	.	A	G	10	7	17	0	1	18	0	0
17	14444167	.	G	A	11	7	18	0	0	18	0	0
17	14447282	.	A	G	7	5	12	0	0	12	0	0
17	14449386	.	C	T	0	8	8	0	9	17	0	0
17	14451264	.	T	C	8	7	15	0	1	16	0	0
17	14451658	.	C	A	2	3	5	0	0	5	0	0
17	14457452	.	T	G	6	7	13	0	0	13	0	0
17	14457911	.	C	A	3	4	7	0	1	8	0	0
17	14468247	.	C	T	1	6	7	0	11	18	0	0
17	14468263	.	T	G	8	7	15	0	3	18	0	0
17	14468370	.	A	T	15	9	24	0	2	26	0	0
17	14468386	.	T	A	17	13	30	0	0	30	0	0
17	14468433	.	G	A	16	10	26	0	0	26	0	0
17	14470340	.	A	G	16	14	30	0	0	30	0	0
17	14494395	.	A	G	12	13	25	0	0	25	0	0
17	14494429	.	A	G	12	10	22	0	1	23	0	0
17	14502454	.	T	A	13	13	26	0	2	28	0	0
17	14523518	.	G	T	7	5	12	0	0	12	0	0
17	14614452	.	T	C	12	8	20	0	0	20	0	0
17	14614471	.	A	G	13	8	21	0	0	21	0	0
17	14614509	.	C	A	9	14	23	0	0	23	0	0
17	14614863	.	C	A	9	14	23	0	0	23	0	0
17	14614900	.	G	A	10	12	22	0	1	23	0	0
17	14614973	.	C	G	10	13	23	0	0	23	0	0
17	14615089	.	T	C	18	15	33	0	2	35	0	0
17	14617171	.	G	A	7	8	15	0	0	15	0	0
17	14618038	.	C	G	5	10	15	0	1	16	0	0
17	14618051	.	G	A	3	11	14	0	0	14	0	0
17	14618842	.	C	T	14	18	32	0	0	32	0	0
17	14618857	.	C	T	0	18	18	0	11	29	0	0
17	14620476	.	T	G	3	7	10	0	1	11	0	0
17	14621230	.	C	T	1	8	9	0	3	12	0	0
17	14623340	.	A	G	5	6	11	0	0	11	0	0
17	14623352	.	T	A	6	5	11	0	0	11	0	0
17	14624088	.	G	T	5	12	17	0	0	17	0	0
17	14627407	.	A	G	6	9	15	0	1	16	0	0
17	14694711	.	C	A	15	19	34	0	2	36	0	0
17	14694744	.	A	G	20	16	36	0	0	36	0	0
17	14694802	.	C	G	25	25	50	0	0	50	0	0
17	14722223	.	A	G	10	4	14	0	0	14	0	0
17	14723137	.	C	T	19	16	35	0	2	37	0	0
17	14723208	.	T	C	13	10	23	0	4	27	0	0
17	14723302	.	A	G	16	15	31	0	0	31	0	0
17	14724005	.	C	A	8	14	22	0	1	23	0	0
17	14724057	.	T	C	8	16	24	0	0	24	0	0
17	14724489	.	T	C	16	10	26	0	1	27	0	0
17	14724514	.	T	C	13	0	13	0	11	24	0	0
17	14725246	.	A	C	14	0	14	0	17	31	0	0
17	14725561	.	C	T	2	13	15	0	12	27	0	0
17	14725648	.	C	T	17	13	30	0	1	31	0	0
17	14725831	.	T	A	13	13	26	0	1	27	0	0
17	14731522	.	G	T	8	2	10	0	0	10	0	0
17	14731560	.	T	C	5	5	10	0	0	10	0	0
17	14731819	.	T	C	15	17	32	0	0	33	1	0
17	14734632	.	C	T	8	4	12	0	1	13	0	0
17	14734734	.	G	A	9	5	14	0	0	14	0	0
17	14737070	.	G	A	8	7	15	0	0	15	0	0
17	14751227	.	T	A	11	5	16	0	0	16	0	0
17	14753455	.	G	A	3	5	8	0	0	8	0	0
17	14755275	.	A	G	10	7	17	0	0	17	0	0
17	14755320	.	G	C	4	0	4	0	4	8	0	0
17	14755852	.	G	A	5	5	10	0	0	10	0	0
17	14756129	.	A	G	7	6	13	0	0	13	0	0
17	14758562	.	G	A	13	10	23	0	0	23	0	0
17	14768411	.	G	A	7	4	11	0	0	11	0	0
17	14768475	.	G	A	8	3	11	0	1	12	0	0
17	14770856	.	A	G	3	4	7	0	0	7	0	0
17	14770877	.	A	T	4	6	10	0	0	10	0	0
17	14784281	.	T	G	3	2	5	0	0	5	0	0
17	14784323	.	T	C	15	6	21	0	0	21	0	0
17	14785663	.	C	T	18	7	25	0	0	25	0	0
17	14785701	.	T	C	17	3	20	0	0	20	0	0
17	14794285	.	A	G	14	18	32	0	2	34	0	0
17	14794485	.	G	T	14	21	35	0	1	36	0	0
17	14794639	.	A	T	3	3	6	0	1	7	0	0
17	14918488	.	T	C	1	0	1	0	3	4	0	0
17	14918836	.	T	A	1	3	4	0	0	4	0	0
17	14919126	.	T	G	3	2	5	0	1	6	0	0
17	14933285	.	T	A	8	4	12	0	0	12	0	0
17	14938834	.	C	T	10	6	16	0	0	16	0	0
17	14941594	.	A	G	1	3	4	0	0	4	0	0
17	14941634	.	T	A	2	4	6	0	0	6	0	0
17	14945613	.	T	C	3	6	9	0	1	10	0	0
17	14953698	.	A	G	3	4	7	0	0	7	0	0
17	14953949	.	T	G	7	4	11	0	2	13	0	0
17	14953953	.	T	C	8	4	12	0	2	14	0	0
17	14953989	.	C	G	6	6	12	0	0	12	0	0
17	14953999	.	C	G	5	5	10	0	1	11	0	0
17	14954037	.	C	T	0	3	3	0	6	9	0	0
17	14958838	.	C	T	0	4	4	0	4	8	0	0
17	14961007	.	C	G	2	3	5	0	0	5	0	0
17	14964644	.	C	T	6	5	11	0	1	12	0	0
17	14964690	.	G	A	6	3	9	0	0	9	0	0
17	15005217	.	A	G	5	5	10	0	1	11	0	0
17	15023286	.	G	A	7	2	9	0	0	9	0	0
17	15029220	.	A	T	1	3	4	0	0	4	0	0
17	15029350	.	A	G	2	4	6	0	0	6	0	0
17	15029351	.	A	T	2	4	6	0	0	6	0	0
17	15049262	.	T	C	2	10	12	0	0	12	0	0
17	15049316	.	G	C	1	2	3	0	0	3	0	0
17	15112285	.	G	A	3	2	5	0	0	5	0	0
17	15117504	.	A	T	1	2	3	0	0	3	0	0
17	15122021	.	T	G	6	4	10	0	1	11	0	0
17	15122177	.	T	C	3	0	3	0	3	6	0	0
17	15123023	.	A	G	2	4	6	0	0	6	0	0
17	15125570	.	A	C	4	2	6	0	0	6	0	0
17	15125623	.	T	C	2	5	7	0	0	7	0	0
17	15126051	.	T	C	0	0	0	0	5	5	0	0
17	15126069	.	T	G	1	5	6	0	0	6	0	0
17	15148903	.	A	G	2	2	4	0	1	5	0	0
17	15149034	.	T	C	6	3	9	0	0	9	0	0
17	15149153	.	A	T	7	2	9	0	0	9	0	0
17	15149218	.	A	T	5	3	8	0	0	8	0	0
17	15149221	.	G	A	4	3	7	0	0	7	0	0
17	15213620	.	C	T	2	4	6	0	0	6	0	0
17	15216134	.	A	T	1	3	4	0	1	5	0	0
17	15217763	.	G	A	4	3	7	0	0	7	0	0
17	15219107	.	G	A	7	3	10	0	0	10	0	0
17	15219141	.	C	T	1	6	7	0	0	7	0	0
17	15219325	.	A	C	5	2	7	0	0	7	0	0
17	15220092	.	C	T	3	2	5	0	0	5	0	0
17	15224052	.	G	A	10	4	14	0	0	14	0	0
17	15229577	.	T	C	8	8	16	0	0	16	0	0
17	15247308	.	A	T	1	1	2	0	0	2	0	0
17	15247318	.	G	A	1	1	2	0	1	3	0	0
17	15304284	.	C	T	1	6	7	0	0	7	0	0
17	15309621	.	C	T	2	5	7	0	11	18	0	0
17	15316001	.	T	C	14	10	24	0	2	26	0	0
17	15316022	.	T	C	17	8	25	0	0	25	0	0
17	15319232	.	G	A	19	11	30	0	1	31	0	0
17	15353984	.	G	A	17	12	29	0	0	29	0	0
17	15374185	.	T	C	7	24	31	0	2	33	0	0
17	15374507	.	G	A	11	17	28	0	2	30	0	0
17	15374744	.	C	G	14	10	24	0	1	25	0	0
17	15382421	.	T	A	21	15	36	0	0	36	0	0
17	15382486	.	C	T	18	11	29	0	0	29	0	0
17	15633377	.	T	C	5	14	19	0	1	20	0	0
17	15633379	.	T	C	7	11	18	0	2	20	0	0
17	15633530	.	C	T	3	1	4	0	3	7	0	0
17	15633721	.	T	C	6	4	10	0	0	10	0	0
17	15663424	.	G	A	4	2	6	0	1	7	0	0
17	15741541	.	A	G	3	2	5	0	0	5	0	0
17	15888422	.	A	C	7	7	14	1	0	15	0	0
17	15892233	.	G	A	4	5	9	0	0	9	0	0
17	15892479	.	G	A	0	6	6	0	7	13	0	0
17	15918453	.	G	A	2	2	4	0	0	4	0	0
17	15933912	.	A	T	1	2	3	0	0	3	0	0
17	15943711	.	C	A	1	3	4	0	0	4	0	0
17	15943808	.	C	T	2	3	5	0	0	5	0	0
17	15943839	.	G	A	3	2	5	0	0	5	0	0
17	15964410	.	C	A	1	2	3	0	0	3	0	0
17	15964443	.	A	C	5	2	7	0	0	7	0	0
17	15964462	.	C	A	2	4	6	0	0	6	0	0
17	15964488	.	C	T	1	5	6	0	0	6	0	0
17	15964692	.	T	C	4	2	6	0	0	6	0	0
17	15965169	.	G	C	2	2	4	0	0	4	0	0
17	15965537	.	A	T	2	2	4	0	0	4	0	0
17	15965708	.	T	A	3	2	5	0	0	5	0	0
17	15965951	.	G	T	0	3	3	0	4	7	0	0
17	15983530	.	C	T	13	11	24	0	0	24	0	0
17	16022530	.	C	T	9	13	22	0	1	23	0	0
17	16024587	.	A	G	6	10	16	0	4	20	0	0
17	16024590	.	G	A	9	11	20	0	3	23	0	0
17	16024677	.	A	G	9	14	23	0	6	29	0	0
17	16026207	.	T	A	16	9	25	0	1	26	0	0
17	16026293	.	A	G	20	13	33	0	1	34	0	0
17	16026345	.	A	G	19	17	36	0	0	36	0	0
17	16026486	.	C	T	18	9	27	0	0	27	0	0
17	16026593	.	C	T	10	12	22	0	1	23	0	0
17	16027718	.	G	A	10	12	22	0	0	22	0	0
17	16027720	.	A	G	9	12	21	0	1	22	0	0
17	16027935	.	G	T	15	14	29	0	0	29	0	0
17	16027983	.	A	T	13	16	29	0	1	30	0	0
17	16028040	.	G	A	17	15	32	0	0	32	0	0
17	16028118	.	A	G	12	0	12	0	13	26	1	0
17	16051805	.	A	G	5	4	9	0	0	9	0	0
17	16051968	.	G	A	6	10	16	0	0	16	0	0
17	16052075	.	A	G	7	9	16	0	0	16	0	0
17	16052229	.	C	T	11	11	22	0	0	22	0	0
17	16052282	.	G	A	12	11	23	0	0	23	0	0
17	16052563	.	G	A	16	10	26	0	1	27	0	0
17	16052587	.	T	G	18	10	28	0	0	28	0	0
17	16055049	.	T	C	16	16	32	0	0	32	0	0
17	16055179	.	G	A	18	13	31	0	1	32	0	0
17	16057798	.	C	T	19	15	34	0	1	35	0	0
17	16057877	.	C	A	1	14	15	0	14	30	1	0
17	16059802	.	T	G	9	14	23	0	1	24	0	0
17	16059831	.	T	G	12	12	24	0	0	24	0	0
17	16059854	.	G	T	14	15	29	0	0	29	0	0
17	16059889	.	A	C	14	0	14	0	12	26	0	0
17	16059928	.	T	A	12	10	22	0	0	23	1	0
17	16064779	.	A	T	14	13	27	0	1	28	0	0
17	16064843	.	G	T	14	10	24	0	0	24	0	0
17	16084327	.	T	A	2	2	4	0	0	4	0	0
17	16096383	.	G	C	2	1	3	0	0	3	0	0
17	16096389	.	G	T	2	2	4	0	0	4	0	0
17	16097737	.	A	T	4	4	8	0	0	8	0	0
17	16099691	.	C	T	5	3	8	0	0	8	0	0
17	16099784	.	A	G	3	3	6	0	0	6	0	0
17	16107111	.	C	T	7	2	9	0	0	9	0	0
17	16107167	.	T	A	7	3	10	0	0	10	0	0
17	16107882	.	A	G	3	0	3	0	8	11	0	0
17	16110234	.	A	G	4	3	7	1	0	8	0	0
17	16110336	.	T	C	6	9	15	0	1	16	0	0
17	16110447	.	T	G	10	8	18	0	0	18	0	0
17	16110527	.	C	G	1	5	6	0	7	13	0	0
17	16110552	.	C	T	8	5	13	0	0	13	0	0
17	16110573	.	A	G	6	8	14	0	2	16	0	0
17	16110687	.	G	A	6	7	13	0	0	13	0	0
17	16110773	.	A	G	3	3	6	0	0	6	0	0
17	16111427	.	C	T	8	9	17	0	0	17	0	0
17	16733977	.	C	T	4	2	6	0	4	10	0	0
17	17856107	.	A	G	4	1	5	0	0	5	0	0
17	18070138	.	G	A	3	15	18	0	0	18	0	0
17	18176682	.	A	T	8	3	11	0	0	11	0	0
17	19609705	.	T	C	2	2	4	0	0	4	0	0
17	21152059	.	T	A	1	7	8	0	0	8	0	0
17	23575413	.	A	G	6	5	11	0	0	11	0	0
17	23763176	.	T	C	4	4	8	0	1	9	0	0
17	24443182	.	G	C	9	5	14	0	0	14	0	0
17	24694564	.	A	G	2	1	3	0	0	3	0	0
17	25549216	.	A	G	3	2	5	0	0	5	0	0
17	26285347	.	A	G	1	0	1	0	6	7	0	0
17	26298967	.	C	T	7	7	14	0	0	14	0	0
17	26335000	.	G	A	12	6	18	0	0	18	0	0
17	26346175	.	T	A	11	4	15	0	1	16	0	0
17	26362130	.	G	A	4	3	7	0	2	9	0	0
17	26362261	.	C	T	0	4	4	0	0	4	0	0
17	26362500	.	C	T	6	4	10	0	2	12	0	0
17	26362512	.	A	C	3	5	8	0	0	8	0	0
17	26362539	.	C	T	4	5	9	0	1	10	0	0
17	26362741	.	C	T	3	5	8	0	0	8	0	0
17	26477795	.	A	C	9	6	15	0	0	15	0	0
17	26477857	.	T	C	8	6	14	0	0	14	0	0
17	26477860	.	C	T	8	6	14	0	0	14	0	0
17	26478023	.	T	C	16	3	19	0	0	19	0	0
17	26478403	.	T	G	4	8	12	0	2	14	0	0
17	26478592	.	A	G	13	10	23	0	0	23	0	0
17	26478818	.	T	C	18	0	18	0	7	25	0	0
17	26478952	.	G	A	15	10	25	0	1	26	0	0
17	26478986	.	A	G	5	13	18	0	2	21	1	0
17	26479063	.	A	G	8	7	15	0	0	15	0	0
17	26479145	.	T	C	13	14	27	0	0	27	0	0
17	26479811	.	T	C	1	4	5	0	0	5	0	0
17	26479916	.	G	T	5	4	9	0	1	10	0	0
17	26479960	.	C	T	5	4	9	0	0	9	0	0
17	26479997	.	A	T	4	4	8	0	0	8	0	0
17	26480421	.	A	G	6	4	10	0	1	11	0	0
17	26480423	.	T	C	6	4	10	0	1	11	0	0
17	26480622	.	A	T	7	6	13	0	2	15	0	0
17	26480683	.	A	G	1	8	9	0	0	9	0	0
17	26480926	.	T	G	4	4	8	0	1	9	0	0
17	26502013	.	A	G	6	8	14	0	0	14	0	0
17	26502047	.	A	C	10	1	11	0	6	17	0	0
17	26502107	.	G	A	5	6	11	0	2	13	0	0
17	26507294	.	G	A	8	4	12	0	1	13	0	0
17	26516748	.	G	C	2	9	11	0	0	11	0	0
17	26516878	.	G	A	4	8	12	0	0	12	0	0
17	26517310	.	A	C	8	0	8	0	5	13	0	0
17	26517366	.	G	A	6	5	11	0	1	12	0	0
17	26519475	.	T	C	7	1	8	0	6	14	0	0
17	26519681	.	C	T	10	4	14	0	1	15	0	0
17	26519823	.	T	C	9	0	9	0	5	14	0	0
17	26537805	.	A	T	3	5	8	0	0	8	0	0
17	26577293	.	T	C	10	7	17	0	0	17	0	0
17	26585135	.	G	T	11	9	20	0	1	21	0	0
17	26585163	.	A	T	5	8	13	0	0	13	0	0
17	26585298	.	G	T	0	10	10	0	3	13	0	0
17	26585646	.	C	T	15	7	22	0	2	24	0	0
17	26585727	.	C	T	8	18	26	0	2	28	0	0
17	26585748	.	A	G	16	0	16	0	10	26	0	0
17	26585763	.	T	A	13	10	23	0	0	23	0	0
17	26590001	.	T	G	14	8	22	0	0	22	0	0
17	26590054	.	C	T	10	10	20	0	0	20	0	0
17	26590091	.	C	T	8	9	17	0	0	17	0	0
17	26590330	.	T	C	11	3	14	0	0	14	0	0
17	26590536	.	G	A	6	3	9	0	2	11	0	0
17	26590650	.	G	T	6	13	19	0	0	19	0	0
17	26594931	.	C	T	12	9	21	0	2	23	0	0
17	26594968	.	G	C	7	8	15	0	0	15	0	0
17	26599208	.	C	T	2	13	15	0	11	26	0	0
17	26600555	.	T	A	6	8	14	0	0	14	0	0
17	26600639	.	G	A	16	11	27	0	0	27	0	0
17	26600667	.	C	T	5	13	18	0	0	18	0	0
17	26600785	.	G	A	8	5	13	0	1	14	0	0
17	26600881	.	G	A	7	2	9	0	1	10	0	0
17	26603369	.	A	T	7	8	15	0	0	15	0	0
17	26604572	.	A	G	6	5	11	0	0	11	0	0
17	26604751	.	G	C	6	15	21	0	0	21	0	0
17	26604758	.	C	T	6	12	18	0	0	18	0	0
17	26604801	.	C	A	8	8	16	0	0	16	0	0
17	26604917	.	G	A	5	3	8	0	0	8	0	0
17	26612007	.	G	T	5	3	8	0	0	8	0	0
17	26630909	.	C	T	9	11	20	0	0	20	0	0
17	26639659	.	C	T	16	13	29	0	1	30	0	0
17	26642775	.	C	A	13	10	23	0	0	23	0	0
17	26642817	.	T	G	12	0	12	0	14	26	0	0
17	26642818	.	T	C	11	14	25	0	1	26	0	0
17	26657852	.	T	C	4	15	19	0	2	21	0	0
17	26662347	.	C	T	8	14	22	0	0	22	0	0
17	26683466	.	T	C	16	18	34	3	1	38	0	0
17	26683526	.	C	T	18	12	30	1	0	31	0	0
17	26689753	.	G	A	21	16	37	0	5	42	0	0
17	26689768	.	C	A	28	13	41	0	1	42	0	0
17	26689792	.	C	A	18	19	37	0	2	39	0	0
17	26690112	.	T	A	17	11	28	0	1	29	0	0
17	26690250	.	C	T	9	5	14	0	1	15	0	0
17	26690276	.	C	T	4	7	11	0	2	13	0	0
17	26690478	.	C	T	13	16	29	0	1	30	0	0
17	26690558	.	G	A	0	12	12	0	14	26	0	0
17	26714009	.	C	T	34	28	62	0	2	64	0	0
17	26722954	.	A	C	3	2	5	0	0	5	0	0
17	26725257	.	G	A	0	2	2	0	3	5	0	0
17	26734197	.	C	T	1	3	4	0	0	4	0	0
17	26735735	.	T	C	1	4	5	0	0	5	0	0
17	26741227	.	C	T	6	3	9	0	0	9	0	0
17	26741254	.	T	C	4	4	8	0	0	8	0	0
17	26744207	.	G	C	1	2	3	0	0	3	0	0
17	26744489	.	G	A	1	3	4	0	0	4	0	0
17	26744516	.	A	G	3	0	3	0	4	7	0	0
17	26744748	.	T	A	3	2	5	0	0	5	0	0
17	26744840	.	A	G	2	6	8	0	1	9	0	0
17	26744862	.	G	A	6	5	11	0	0	11	0	0
17	26744927	.	A	G	3	3	6	0	0	6	0	0
17	26744930	.	A	C	2	2	4	0	0	4	0	0
17	26744981	.	C	T	4	4	8	0	1	9	0	0
17	26745106	.	T	C	2	2	4	0	0	4	0	0
17	26745110	.	C	T	1	2	3	0	1	4	0	0
17	26747348	.	A	G	1	3	4	0	0	4	0	0
17	26747392	.	G	T	5	2	7	0	0	7	0	0
17	26749836	.	G	A	3	5	8	0	1	9	0	0
17	26749881	.	T	A	4	3	7	0	0	7	0	0
17	26749889	.	C	T	4	2	6	0	0	6	0	0
17	26810380	.	C	T	22	25	47	0	1	48	0	0
17	26812487	.	T	G	7	27	34	0	0	34	0	0
17	26813285	.	T	C	10	20	30	3	2	35	0	0
17	26831861	.	G	A	11	5	16	0	0	16	0	0
17	26832713	.	C	T	7	4	11	0	0	11	0	0
17	26832738	.	A	G	8	4	12	0	1	13	0	0
17	26846203	.	C	T	15	7	22	0	1	23	0	0
17	26846650	.	G	A	10	4	14	0	3	17	0	0
17	26846707	.	G	A	1	6	7	0	4	11	0	0
17	26846901	.	T	G	9	6	15	1	0	16	0	0
17	26879854	.	A	C	14	12	26	0	1	27	0	0
17	26879869	.	A	G	14	10	24	0	0	24	0	0
17	26879893	.	A	G	15	19	34	0	2	36	0	0
17	26880107	.	G	A	13	22	35	0	2	37	0	0
17	26880231	.	T	C	24	28	52	1	1	54	0	0
17	26880424	.	T	C	22	26	48	0	1	49	0	0
17	26880714	.	G	T	14	0	14	1	1	16	0	0
17	26880926	.	T	C	18	2	20	0	19	39	0	0
17	26880964	.	A	G	25	22	47	0	1	48	0	0
17	26881131	.	T	A	23	16	39	1	0	40	0	0
17	26881354	.	A	G	18	24	42	0	2	44	0	0
17	26881777	.	A	G	29	21	50	2	3	55	0	0
17	26911747	.	A	G	22	17	39	0	2	41	0	0
17	26926548	.	G	A	3	4	7	0	0	7	0	0
17	26928918	.	T	C	10	3	13	2	0	15	0	0
17	26928994	.	C	T	6	6	12	0	0	12	0	0
17	26929029	.	G	A	5	5	10	0	0	10	0	0
17	26929032	.	T	C	5	5	10	0	0	10	0	0
17	26929475	.	T	C	5	2	7	0	0	7	0	0
17	26929577	.	C	A	3	8	11	0	0	11	0	0
17	26929649	.	A	G	4	12	16	0	0	16	0	0
17	26929654	.	T	A	12	4	16	0	0	16	0	0
17	26929776	.	C	T	3	7	10	0	1	11	0	0
17	26929893	.	G	A	11	5	16	0	1	17	0	0
17	26933223	.	A	G	6	5	11	0	0	11	0	0
17	26933328	.	C	T	2	8	10	0	0	10	0	0
17	26934417	.	C	T	1	8	9	0	7	16	0	0
17	26935274	.	G	T	10	5	15	0	0	15	0	0
17	26935331	.	G	C	2	2	4	0	0	4	0	0
17	26985158	.	G	A	2	6	8	0	18	26	0	0
17	26985544	.	T	A	12	9	21	0	0	21	0	0
17	26985561	.	T	G	9	0	9	0	11	20	0	0
17	26985586	.	C	T	8	15	23	0	0	23	0	0
17	26985638	.	T	G	4	11	15	0	1	16	0	0
17	26985656	.	T	A	4	8	12	0	0	12	0	0
17	26985692	.	G	T	12	5	17	0	0	17	0	0
17	27064523	.	T	A	11	5	16	0	0	16	0	0
17	27064725	.	T	C	4	7	11	0	0	11	0	0
17	27064840	.	G	C	1	10	11	0	3	14	0	0
17	27152597	.	T	C	2	6	8	0	1	9	0	0
17	27154580	.	C	A	8	13	21	0	0	21	0	0
17	27154695	.	A	G	7	8	15	0	1	16	0	0
17	27158692	.	C	T	8	5	13	0	1	14	0	0
17	27160846	.	C	T	10	7	17	0	0	17	0	0
17	27160912	.	G	A	16	6	22	0	2	24	0	0
17	27162479	.	C	T	7	14	21	0	0	21	0	0
17	27163266	.	T	C	8	7	15	0	0	15	0	0
17	27164497	.	T	C	8	10	18	0	1	19	0	0
17	27164530	.	C	T	9	11	20	0	1	21	0	0
17	27166221	.	T	C	8	7	15	0	0	15	0	0
17	27166257	.	T	C	10	6	16	0	1	17	0	0
17	27166521	.	C	T	8	9	17	0	2	19	0	0
17	27168957	.	G	T	2	10	12	0	10	22	0	0
17	27169783	.	A	C	6	5	11	0	0	11	0	0
17	27170017	.	G	A	1	8	9	0	6	15	0	0
17	27170153	.	A	T	12	4	16	0	0	16	0	0
17	27170390	.	G	T	4	2	6	0	0	6	0	0
17	27170516	.	G	A	1	5	6	0	7	13	0	0
17	27170549	.	G	A	4	8	12	0	2	14	0	0
17	27170605	.	T	G	7	7	14	0	0	14	0	0
17	27170678	.	C	A	3	5	8	0	0	8	0	0
17	27170730	.	T	G	4	7	11	0	0	11	0	0
17	27170746	.	A	T	4	11	15	0	0	15	0	0
17	27176640	.	G	A	11	5	16	0	1	17	0	0
17	27176871	.	G	A	5	8	13	0	0	13	0	0
17	27176967	.	G	C	8	6	14	0	0	14	0	0
17	27176991	.	C	T	6	10	16	0	1	17	0	0
17	27177064	.	C	T	7	8	15	0	0	15	0	0
17	27177083	.	G	A	0	8	8	0	6	14	0	0
17	27177251	.	A	G	7	6	13	0	0	13	0	0
17	27177302	.	A	G	1	0	1	0	4	5	0	0
17	27177473	.	C	T	4	10	14	0	1	15	0	0
17	27177745	.	G	A	1	6	7	0	0	7	0	0
17	27177776	.	G	T	2	9	11	0	1	12	0	0
17	27177808	.	G	T	5	7	12	1	0	13	0	0
17	27177864	.	C	T	6	3	9	1	1	11	0	0
17	27178024	.	T	A	10	6	16	0	0	16	0	0
17	27178088	.	T	A	6	3	9	0	0	9	0	0
17	27178191	.	G	A	2	9	11	0	0	11	0	0
17	27178232	.	A	G	6	5	11	0	2	13	0	0
17	27178254	.	C	A	4	5	9	0	0	9	0	0
17	27178273	.	G	T	5	3	8	0	1	9	0	0
17	27178296	.	G	A	0	5	5	0	5	10	0	0
17	27178356	.	T	A	7	3	10	0	0	10	0	0
17	27178383	.	C	G	6	6	12	0	1	13	0	0
17	27178401	.	C	T	10	5	15	0	0	15	0	0
17	27178557	.	C	T	15	8	23	0	0	23	0	0
17	27178638	.	C	G	5	6	11	0	0	11	0	0
17	27178730	.	C	A	4	12	16	0	1	17	0	0
17	27178870	.	T	C	7	3	10	0	1	11	0	0
17	27179189	.	A	G	6	11	17	0	2	19	0	0
17	27179203	.	G	T	0	10	10	0	4	14	0	0
17	27179848	.	A	G	6	3	9	2	1	12	0	0
17	27180100	.	G	A	1	3	4	0	0	4	0	0
17	27180407	.	T	A	12	5	17	0	0	17	0	0
17	27180447	.	A	T	6	3	9	0	0	9	0	0
17	27180847	.	A	G	5	5	10	0	1	11	0	0
17	27181021	.	T	C	14	9	23	0	0	23	0	0
17	27181048	.	C	G	12	13	25	0	1	26	0	0
17	27181129	.	G	A	13	13	26	0	1	27	0	0
17	27181130	.	G	A	13	14	27	0	0	27	0	0
17	27181257	.	A	C	8	16	24	0	0	24	0	0
17	27181323	.	A	G	15	1	16	0	7	23	0	0
17	27181411	.	A	G	7	0	7	0	9	16	0	0
17	27181427	.	C	T	7	7	14	0	2	16	0	0
17	27181463	.	A	G	4	0	4	0	7	11	0	0
17	27181481	.	A	G	2	4	6	0	0	6	0	0
17	27181680	.	C	T	1	3	4	0	1	5	0	0
17	27182039	.	T	C	22	7	29	0	0	29	0	0
17	27182114	.	A	G	8	9	17	0	0	17	0	0
17	27182146	.	C	T	7	6	13	0	0	13	0	0
17	27182331	.	T	G	5	11	16	0	0	16	0	0
17	27182340	.	C	T	4	11	15	0	0	15	0	0
17	27182449	.	G	T	9	9	18	0	0	18	0	0
17	27182484	.	T	C	6	13	19	0	2	21	0	0
17	27182645	.	G	T	11	15	26	0	1	27	0	0
17	27182649	.	A	G	12	14	26	0	2	28	0	0
17	27182769	.	A	G	10	7	17	0	0	17	0	0
17	27182894	.	T	C	12	9	21	0	2	23	0	0
17	27182925	.	A	T	12	7	19	0	0	19	0	0
17	27182979	.	C	T	9	10	19	0	0	19	0	0
17	27183207	.	G	T	0	2	2	0	5	7	0	0
17	27183219	.	G	T	4	2	6	0	0	6	0	0
17	27190731	.	C	G	2	3	5	0	0	5	0	0
17	27190732	.	C	T	2	2	4	0	1	5	0	0
17	27191528	.	C	T	4	2	6	0	2	8	0	0
17	27192698	.	C	T	3	2	5	0	0	5	0	0
17	27192756	.	G	C	2	5	7	0	0	7	0	0
17	27194168	.	A	G	4	6	10	0	0	10	0	0
17	27194183	.	A	G	4	6	10	0	0	10	0	0
17	27194669	.	C	T	2	4	6	0	0	6	0	0
17	27194867	.	A	G	3	2	5	0	0	5	0	0
17	27196890	.	T	C	2	5	7	0	0	7	0	0
17	27197664	.	T	C	2	0	2	0	2	4	0	0
17	27197873	.	T	A	1	2	3	0	0	3	0	0
17	27265375	.	T	C	1	0	1	0	3	4	0	0
17	27272913	.	T	C	11	6	17	0	1	18	0	0
17	27273013	.	C	T	6	7	13	0	1	14	0	0
17	27401038	.	A	T	6	5	11	1	4	16	0	0
17	27408386	.	A	G	9	12	21	0	0	21	0	0
17	27408472	.	C	T	10	12	22	0	0	22	0	0
17	27408523	.	G	T	3	6	9	0	2	11	0	0
17	27408531	.	T	A	2	4	6	0	1	8	1	0
17	27408592	.	C	A	1	3	4	0	1	5	0	0
17	27408637	.	T	C	2	0	2	0	7	9	0	0
17	27408836	.	T	G	6	16	22	1	3	26	0	0
17	27408889	.	T	C	8	17	25	1	1	27	0	0
17	27413564	.	T	C	8	19	27	0	3	30	0	0
17	27413705	.	T	C	4	10	14	0	1	15	0	0
17	27414035	.	G	A	6	8	14	0	1	15	0	0
17	27414098	.	C	A	10	12	22	0	0	22	0	0
17	27414203	.	G	A	9	11	20	0	1	21	0	0
17	27414215	.	C	T	2	9	11	0	12	23	0	0
17	27414367	.	A	G	16	10	26	0	0	26	0	0
17	27414658	.	T	C	10	9	19	0	2	21	0	0
17	27414701	.	A	G	16	8	24	0	1	25	0	0
17	27414791	.	A	G	7	8	15	0	1	16	0	0
17	27414815	.	G	A	6	15	21	0	0	21	0	0
17	27415010	.	C	T	1	12	13	0	13	26	0	0
17	27723800	.	G	T	17	19	36	0	1	37	0	0
17	27807455	.	T	C	27	22	49	0	0	49	0	0
17	27808190	.	A	G	9	1	10	0	18	28	0	0
17	27808335	.	A	G	11	23	34	0	1	35	0	0
17	27808686	.	G	A	7	5	12	0	1	13	0	0
17	27808700	.	G	A	10	8	18	0	0	18	0	0
17	27808987	.	G	T	1	23	24	0	24	48	0	0
17	27809548	.	T	A	11	7	18	0	1	19	0	0
17	27809631	.	G	T	4	7	11	0	14	25	0	0
17	27809779	.	C	A	30	19	49	1	1	51	0	0
17	27809885	.	A	G	16	17	33	0	1	34	0	0
17	27811199	.	T	A	10	2	12	0	0	12	0	0
17	27811209	.	A	G	9	3	12	0	1	13	0	0
17	27811254	.	T	C	11	3	14	0	0	14	0	0
17	27812525	.	A	C	19	7	26	0	1	27	0	0
17	27812562	.	G	A	2	11	13	0	15	28	0	0
17	27812702	.	A	T	11	9	20	0	0	20	0	0
17	27812885	.	C	T	3	2	5	0	1	6	0	0
17	27813221	.	C	T	12	7	19	0	0	19	0	0
17	27813222	.	A	G	12	6	18	0	2	20	0	0
17	28049663	.	A	T	6	8	14	0	1	15	0	0
17	28049804	.	G	T	7	6	13	0	0	13	0	0
17	28050500	.	T	A	8	12	20	0	0	20	0	0
17	28050530	.	A	G	9	11	20	0	2	22	0	0
17	28050954	.	G	A	6	7	13	0	2	15	0	0
17	28051073	.	C	T	11	12	23	0	0	23	0	0
17	28051129	.	G	A	8	8	16	0	0	16	0	0
17	28051222	.	C	T	5	3	8	0	1	9	0	0
17	28051247	.	T	A	7	6	13	0	0	13	0	0
17	28051465	.	T	C	6	11	17	0	1	18	0	0
17	28051504	.	G	T	9	7	16	0	0	16	0	0
17	28051605	.	A	G	6	7	13	0	0	13	0	0
17	28051739	.	A	G	15	8	23	0	1	24	0	0
17	28052322	.	C	A	14	7	21	0	0	21	0	0
17	28067389	.	C	T	17	14	31	0	1	32	0	0
17	28067472	.	A	C	15	15	30	0	1	31	0	0
17	28067618	.	A	G	12	5	17	0	1	18	0	0
17	28067856	.	C	T	12	8	20	0	2	22	0	0
17	28068083	.	T	C	11	14	25	0	1	26	0	0
17	28068087	.	G	T	12	16	28	0	0	28	0	0
17	28068168	.	G	A	9	2	11	0	0	11	0	0
17	28068262	.	T	G	8	1	9	0	6	15	0	0
17	28068276	.	C	T	6	4	10	0	1	11	0	0
17	28068507	.	A	G	9	7	16	0	1	17	0	0
17	28068514	.	T	C	8	7	15	0	0	15	0	0
17	28068916	.	C	T	4	10	14	0	0	14	0	0
17	28069170	.	G	A	13	12	25	0	2	27	0	0
17	28069341	.	G	T	11	10	21	0	0	21	0	0
17	28069342	.	T	C	10	10	20	0	1	21	0	0
17	28069645	.	G	T	14	10	24	0	0	24	0	0
17	28069716	.	G	C	19	17	36	0	1	37	0	0
17	28069787	.	G	A	1	23	24	0	10	34	0	0
17	28070078	.	G	C	12	13	25	0	0	25	0	0
17	28070167	.	C	T	14	10	24	0	0	24	0	0
17	28070284	.	G	A	6	10	16	0	0	16	0	0
17	28070286	.	A	C	5	10	15	0	0	15	0	0
17	28070481	.	T	A	19	10	29	0	0	29	0	0
17	28070600	.	C	A	18	8	26	0	4	30	0	0
17	28070840	.	G	A	10	6	16	0	1	17	0	0
17	28071029	.	A	T	5	2	7	0	0	7	0	0
17	28071260	.	A	G	6	9	15	0	0	15	0	0
17	28084592	.	C	T	14	10	24	0	1	25	0	0
17	28084908	.	C	T	12	19	31	0	2	33	0	0
17	28097235	.	G	A	14	18	32	0	0	32	0	0
17	28100598	.	C	T	2	16	18	0	22	40	0	0
17	28167312	.	G	A	8	6	14	0	0	14	0	0
17	28167313	.	A	T	9	6	15	0	0	15	0	0
17	28168645	.	C	T	8	7	15	0	0	15	0	0
17	28168712	.	T	A	4	8	12	0	1	13	0	0
17	28168941	.	A	T	4	6	10	0	0	10	0	0
17	28197797	.	A	T	3	2	5	0	0	5	0	0
17	28197957	.	G	A	4	5	9	0	0	9	0	0
17	28340740	.	A	T	9	3	12	0	0	12	0	0
17	28408024	.	A	C	5	4	9	0	0	9	0	0
17	28440212	.	T	A	10	6	16	0	1	17	0	0
17	28461857	.	G	A	1	6	7	0	8	15	0	0
17	28466273	.	C	T	3	6	9	0	0	9	0	0
17	28610150	.	G	C	1	2	3	0	0	3	0	0
17	28632845	.	G	A	2	4	6	0	0	6	0	0
17	28632871	.	C	T	1	3	4	0	0	4	0	0
17	28637139	.	G	A	1	2	3	0	5	8	0	0
17	28637157	.	T	C	3	7	10	0	0	10	0	0
17	28638008	.	G	A	1	4	5	0	0	5	0	0
17	28638806	.	T	C	2	2	4	0	0	4	0	0
17	28640271	.	A	G	1	3	4	0	0	4	0	0
17	28640625	.	C	T	1	5	6	0	0	6	0	0
17	28640690	.	G	T	2	3	5	0	0	5	0	0
17	28654157	.	G	T	2	2	4	0	0	4	0	0
17	28657009	.	C	T	3	4	7	0	0	7	0	0
17	28658563	.	A	G	3	6	9	0	1	10	0	0
17	28658629	.	C	T	6	4	10	0	0	10	0	0
17	28661628	.	C	G	7	0	7	0	7	14	0	0
17	28661931	.	G	T	1	4	5	0	3	8	0	0
17	28666381	.	C	T	3	8	11	0	0	11	0	0
17	28668627	.	C	T	2	4	6	0	0	6	0	0
17	28670351	.	T	A	10	6	16	0	1	17	0	0
17	28670352	.	C	T	10	6	16	0	1	17	0	0
17	28675202	.	G	A	3	4	7	0	1	8	0	0
17	28680593	.	T	C	7	6	13	0	0	13	0	0
17	28683074	.	C	T	11	8	19	0	1	20	0	0
17	28683415	.	T	C	8	8	16	0	0	16	0	0
17	28683573	.	C	A	11	10	21	0	1	22	0	0
17	28684786	.	C	T	6	10	16	0	3	19	0	0
17	28688931	.	G	T	8	11	19	0	0	19	0	0
17	28694574	.	A	T	15	20	35	0	0	35	0	0
17	28694589	.	T	C	15	18	33	0	3	36	0	0
17	28695956	.	G	A	17	19	36	0	3	39	0	0
17	28696109	.	C	A	16	13	29	0	0	29	0	0
17	28696160	.	C	T	16	15	31	0	0	31	0	0
17	28696311	.	C	T	11	11	22	0	1	23	0	0
17	28696397	.	A	G	16	0	16	0	18	34	0	0
17	28700311	.	T	C	23	19	42	0	1	43	0	0
17	28700428	.	G	A	20	16	36	0	1	37	0	0
17	28701100	.	G	A	7	9	16	0	1	17	0	0
17	28707851	.	C	A	0	9	9	0	7	16	0	0
17	28730705	.	C	T	8	12	20	0	0	20	0	0
17	28738387	.	C	T	7	3	10	0	0	10	0	0
17	28738675	.	A	G	11	0	11	0	9	20	0	0
17	28738714	.	T	C	4	10	14	0	1	15	0	0
17	28741421	.	A	C	15	9	24	0	3	27	0	0
17	28741540	.	A	G	12	0	12	0	12	24	0	0
17	28741752	.	C	T	9	6	15	0	1	16	0	0
17	28741934	.	C	T	14	5	19	0	1	20	0	0
17	28742263	.	G	C	15	14	29	0	0	29	0	0
17	28742385	.	T	A	9	3	12	0	0	12	0	0
17	28742395	.	G	A	0	7	7	0	6	13	0	0
17	28742559	.	C	T	20	18	38	0	1	39	0	0
17	28742681	.	C	T	7	7	14	0	0	14	0	0
17	28742755	.	C	A	2	3	5	0	1	6	0	0
17	28762295	.	A	G	1	2	3	0	0	3	0	0
17	28771228	.	T	A	15	9	24	0	1	25	0	0
17	28777803	.	C	T	8	12	20	0	0	20	0	0
17	28784090	.	G	T	6	15	21	0	0	21	0	0
17	28784102	.	G	A	14	4	18	0	0	18	0	0
17	28785010	.	G	A	11	8	19	0	0	19	0	0
17	28785013	.	C	T	10	10	20	0	0	20	0	0
17	28789014	.	C	T	1	13	14	0	11	25	0	0
17	28793818	.	G	A	7	14	21	0	0	21	0	0
17	28803488	.	A	T	0	2	2	0	1	3	0	0
17	28942683	.	C	T	9	7	16	0	0	16	0	0
17	28948818	.	G	A	6	10	16	0	1	17	0	0
17	28958371	.	C	T	4	7	11	0	1	12	0	0
17	28959148	.	T	C	13	11	24	0	1	25	0	0
17	28968461	.	T	C	20	23	43	0	0	43	0	0
17	28968611	.	C	T	2	5	7	0	0	7	0	0
17	29117355	.	G	A	5	5	10	0	1	11	0	0
17	29196480	.	G	A	2	2	4	0	0	4	0	0
17	29203212	.	A	C	1	2	3	0	0	3	0	0
17	29203277	.	G	A	1	2	3	0	0	3	0	0
17	29252207	.	G	A	4	9	13	0	0	13	0	0
17	29252254	.	C	T	3	5	8	0	0	8	0	0
17	29253050	.	T	C	13	9	22	0	1	23	0	0
17	29282901	.	C	A	8	3	11	1	0	12	0	0
17	29283688	.	G	C	9	3	12	0	0	12	0	0
17	29283866	.	T	C	3	15	18	0	0	18	0	0
17	29283920	.	A	C	4	1	5	0	15	20	0	0
17	29283943	.	A	G	6	15	21	0	0	21	0	0
17	29283962	.	A	G	4	12	16	0	0	16	0	0
17	29288057	.	G	T	7	9	16	0	0	16	0	0
17	29288718	.	A	G	10	12	22	0	0	22	0	0
17	29298191	.	G	C	8	0	8	0	11	19	0	0
17	29300641	.	A	T	10	5	15	0	0	15	0	0
17	29300650	.	A	G	10	5	15	0	0	15	0	0
17	29301058	.	G	C	9	7	16	0	1	17	0	0
17	29306455	.	G	A	7	6	13	0	0	13	0	0
17	29306598	.	A	C	11	3	14	0	0	14	0	0
17	29306670	.	C	T	8	6	14	0	0	14	0	0
17	29306854	.	C	T	0	8	8	0	8	16	0	0
17	29308591	.	C	T	6	9	15	0	0	15	0	0
17	29308639	.	G	T	8	7	15	0	0	15	0	0
17	29308693	.	G	A	8	7	15	0	0	15	0	0
17	29308706	.	G	A	8	7	15	0	0	15	0	0
17	29308987	.	A	T	6	7	13	0	0	13	0	0
17	29310200	.	T	C	5	6	11	0	1	12	0	0
17	29310589	.	G	A	5	4	9	0	0	9	0	0
17	29310619	.	T	C	3	5	8	0	0	8	0	0
17	29310972	.	A	C	4	0	4	0	3	7	0	0
17	29311418	.	G	T	2	3	5	0	0	5	0	0
17	29311501	.	T	A	1	4	5	0	0	5	0	0
17	29311791	.	C	T	0	2	2	0	6	8	0	0
17	29312376	.	G	A	11	6	17	0	0	17	0	0
17	29312434	.	C	T	1	5	6	0	4	10	0	0
17	29334520	.	T	A	12	13	25	0	4	29	0	0
17	29334569	.	A	C	17	10	27	0	1	28	0	0
17	29335645	.	G	A	6	12	18	0	3	21	0	0
17	29336179	.	G	A	11	4	15	0	3	18	0	0
17	29336180	.	G	T	12	6	18	0	0	18	0	0
17	29341079	.	C	T	13	10	23	0	1	24	0	0
17	29341123	.	C	A	14	11	25	0	1	26	0	0
17	29345725	.	T	G	11	6	17	0	1	18	0	0
17	29345890	.	T	A	9	12	21	0	0	21	0	0
17	29349739	.	G	A	0	10	10	0	7	17	0	0
17	29366113	.	G	A	1	9	10	0	6	16	0	0
17	29369642	.	G	T	12	14	26	0	0	26	0	0
17	29369644	.	G	A	12	14	26	0	0	26	0	0
17	29797906	.	C	T	15	10	25	0	1	26	0	0
17	29804291	.	G	C	17	9	26	0	0	26	0	0
17	29804441	.	T	C	3	2	5	1	5	11	0	0
17	29876956	.	G	A	9	9	18	0	0	18	0	0
17	29877094	.	A	G	5	8	13	0	1	14	0	0
17	29877283	.	C	A	1	13	14	0	11	25	0	0
17	30052080	.	C	T	3	2	5	0	1	6	0	0
17	30052097	.	T	C	3	4	7	0	0	7	0	0
17	30381982	.	G	A	2	4	6	0	0	6	0	0
17	30390607	.	T	C	1	2	3	0	0	3	0	0
17	30397135	.	T	A	1	3	4	0	0	4	0	0
17	30409433	.	A	G	2	3	5	0	0	5	0	0
17	30411474	.	C	T	4	3	7	0	0	7	0	0
17	30412354	.	G	A	2	5	7	0	1	8	0	0
17	30414463	.	C	A	4	5	9	0	0	9	0	0
17	30416418	.	G	T	1	2	3	0	0	3	0	0
17	30450275	.	G	A	6	3	9	0	0	9	0	0
17	30451420	.	C	T	1	7	8	0	1	9	0	0
17	30453514	.	A	G	4	0	4	0	7	11	0	0
17	30460090	.	C	T	4	5	9	0	0	9	0	0
17	30474161	.	A	G	1	8	9	0	0	9	0	0
17	30590075	.	A	T	5	7	12	0	0	12	0	0
17	30900986	.	C	A	7	3	10	0	1	11	0	0
17	30979391	.	T	C	7	1	8	0	7	15	0	0
17	30979465	.	T	C	10	7	17	0	1	18	0	0
17	31535903	.	T	G	2	1	3	0	1	4	0	0
17	31565332	.	T	C	2	1	3	0	1	4	0	0
17	31565344	.	A	T	0	3	3	0	0	3	0	0
17	32549416	.	G	A	1	10	11	0	0	11	0	0
17	33306705	.	A	G	6	2	8	0	1	9	0	0
17	33306898	.	A	G	10	3	13	0	0	13	0	0
17	33430370	.	C	T	6	2	8	0	0	8	0	0
17	36938782	.	T	C	18	0	18	0	9	27	0	0
17	37172290	.	T	C	1	5	6	0	0	6	0	0
17	37364009	.	A	G	9	0	9	0	3	12	0	0
17	37445729	.	G	A	2	3	5	0	0	5	0	0
17	37445790	.	T	C	2	4	6	0	0	6	0	0
17	37445924	.	G	A	13	6	19	0	1	20	0	0
17	37445926	.	A	T	6	14	20	0	0	20	0	0
17	37446208	.	A	T	10	9	19	0	0	19	0	0
17	37446379	.	T	C	3	5	8	0	1	9	0	0
17	37446443	.	T	G	11	6	17	0	1	18	0	0
17	37446555	.	T	A	9	10	19	0	0	19	0	0
17	37446563	.	G	A	10	9	19	0	0	19	0	0
17	37446735	.	G	A	14	15	29	0	1	30	0	0
17	37449200	.	G	C	5	5	10	0	0	10	0	0
17	37449823	.	C	T	5	5	10	0	1	11	0	0
17	37450132	.	C	T	10	5	15	0	0	15	0	0
17	37450135	.	A	T	5	8	13	0	2	15	0	0
17	37450180	.	T	G	4	6	10	0	1	11	0	0
17	37570871	.	A	G	5	6	11	0	0	11	0	0
17	37585002	.	A	G	8	6	14	0	0	14	0	0
17	37590024	.	C	T	7	5	12	0	1	13	0	0
17	37593662	.	C	T	13	5	18	0	0	18	0	0
17	37597175	.	A	T	7	10	17	0	0	17	0	0
17	37603748	.	G	A	2	11	13	3	13	29	0	0
17	37605870	.	A	G	18	0	18	0	17	35	0	0
17	37606011	.	G	A	0	12	12	0	19	31	0	0
17	37606101	.	G	A	1	6	7	0	10	17	0	0
17	37606116	.	G	A	8	11	19	0	2	21	0	0
17	37618028	.	C	G	9	6	15	1	0	16	0	0
17	37618083	.	T	G	9	5	14	0	1	15	0	0
17	37618143	.	T	C	11	4	15	0	0	15	0	0
17	37618157	.	A	C	2	9	11	0	0	11	0	0
17	37618316	.	C	T	1	5	6	0	0	6	0	0
17	37618485	.	C	T	8	5	13	1	0	14	0	0
17	37624913	.	A	T	16	17	33	0	1	34	0	0
17	37648766	.	C	T	9	6	15	0	0	15	0	0
17	37792745	.	A	G	8	8	16	0	0	16	0	0
17	37793456	.	C	T	1	7	8	0	6	14	0	0
17	37793606	.	T	A	5	6	11	0	9	20	0	0
17	37793627	.	G	A	6	13	19	0	0	19	0	0
17	37794035	.	G	A	7	4	11	0	0	11	0	0
17	37795730	.	C	T	6	12	18	0	1	19	0	0
17	37795756	.	A	T	5	12	17	0	1	18	0	0
17	38021502	.	C	T	3	2	5	0	0	5	0	0
17	38021526	.	A	G	4	1	5	0	0	5	0	0
17	38022372	.	T	C	4	2	6	0	0	6	0	0
17	38022394	.	T	C	3	2	5	0	0	5	0	0
17	38023053	.	T	C	2	3	5	0	0	5	0	0
17	38030380	.	T	A	1	3	4	0	0	4	0	0
17	38232237	.	T	C	1	5	6	0	0	6	0	0
17	38263804	.	A	G	8	6	14	0	1	15	0	0
17	38263912	.	G	C	0	5	5	0	6	11	0	0
17	38264044	.	G	T	10	7	17	0	2	19	0	0
17	38295925	.	C	A	3	5	8	0	0	8	0	0
17	38295927	.	T	A	5	3	8	0	0	8	0	0
17	38296642	.	G	A	5	7	12	0	0	12	0	0
17	38296644	.	T	G	7	5	12	0	0	12	0	0
17	38303423	.	C	T	9	11	20	0	1	21	0	0
17	38303607	.	A	G	4	5	9	0	0	9	0	0
17	38303652	.	G	A	0	7	7	0	5	12	0	0
17	38393473	.	A	C	3	0	3	0	4	7	0	0
17	38393780	.	G	A	3	2	5	0	0	5	0	0
17	38394057	.	A	T	2	3	5	0	0	5	0	0
17	38394151	.	G	T	3	3	6	0	0	6	0	0
17	38394178	.	G	A	3	5	8	0	0	8	0	0
17	38395070	.	C	T	1	4	5	0	2	7	0	0
17	38395266	.	A	G	2	4	6	0	0	6	0	0
17	38395290	.	C	T	1	5	6	0	1	7	0	0
17	38397534	.	G	A	4	3	7	0	0	7	0	0
17	38401743	.	G	A	2	3	5	0	0	5	0	0
17	38408826	.	G	A	3	3	6	0	0	6	0	0
17	38408838	.	C	T	0	4	4	0	2	6	0	0
17	38452645	.	G	T	3	3	6	0	0	6	0	0
17	38471137	.	C	T	1	2	3	0	0	3	0	0
17	38471166	.	G	T	1	2	3	0	0	3	0	0
17	38471456	.	G	T	0	2	2	0	1	3	0	0
17	38473233	.	C	G	1	0	1	0	2	3	0	0
17	38473254	.	C	T	2	2	4	0	0	4	0	0
17	38545550	.	A	G	4	0	4	0	7	11	0	0
17	38545563	.	C	A	4	4	8	0	0	8	0	0
17	38656377	.	G	A	1	2	3	0	0	3	0	0
17	38673114	.	G	A	0	2	2	0	1	3	0	0
17	38686623	.	G	A	1	2	3	0	0	3	0	0
17	38688600	.	C	T	1	2	3	0	0	3	0	0
17	38688603	.	A	G	2	0	2	0	1	3	0	0
17	38688771	.	G	T	1	2	3	0	0	3	0	0
17	38688885	.	A	T	2	2	4	0	0	4	0	0
17	38712775	.	T	G	4	4	8	0	0	8	0	0
17	38712855	.	C	T	2	3	5	0	0	5	0	0
17	38713174	.	G	T	0	2	2	0	5	7	0	0
17	38713640	.	A	C	5	2	7	0	0	7	0	0
17	38713709	.	C	T	4	4	8	0	0	8	0	0
17	38714002	.	G	C	0	4	4	0	1	5	0	0
17	38714125	.	A	T	5	4	9	0	0	9	0	0
17	38714133	.	G	T	4	4	8	0	1	9	0	0
17	38714216	.	A	C	2	2	4	0	0	4	0	0
17	38714280	.	A	T	2	2	4	0	0	4	0	0
17	38714578	.	A	T	2	2	4	0	0	4	0	0
17	38740684	.	T	C	5	5	10	0	1	11	0	0
17	38740698	.	A	T	4	6	10	0	0	10	0	0
17	38749800	.	G	A	12	10	22	0	1	23	0	0
17	38749807	.	G	A	10	12	22	0	1	23	0	0
17	38751711	.	T	A	9	10	19	0	1	20	0	0
17	38754825	.	C	A	6	12	18	0	2	20	0	0
17	38755038	.	A	G	11	22	33	0	2	35	0	0
17	38755077	.	A	G	15	12	27	0	2	29	0	0
17	38756777	.	T	G	7	12	19	0	0	19	0	0
17	38758682	.	G	A	7	10	17	0	0	17	0	0
17	38760619	.	G	A	11	8	19	0	0	19	0	0
17	38760931	.	T	C	6	5	11	0	1	12	0	0
17	38761035	.	A	G	7	4	11	0	0	11	0	0
17	38768370	.	G	T	7	3	10	0	0	10	0	0
17	38768433	.	C	T	0	10	10	1	4	15	0	0
17	38768483	.	G	A	5	10	15	1	1	17	0	0
17	38769924	.	T	A	17	8	25	0	0	25	0	0
17	38769935	.	T	C	17	8	25	0	1	26	0	0
17	38769975	.	G	A	17	9	26	0	1	27	0	0
17	38784477	.	T	C	18	7	25	0	3	28	0	0
17	38784545	.	G	T	16	9	25	0	1	26	0	0
17	38784642	.	T	C	9	17	26	0	1	27	0	0
17	38787327	.	G	A	5	7	12	0	0	12	0	0
17	38787498	.	G	A	8	10	18	0	0	18	0	0
17	38804808	.	C	T	6	8	14	0	0	14	0	0
17	38804853	.	A	T	6	12	18	0	1	19	0	0
17	38887271	.	T	G	13	6	19	0	0	19	0	0
17	38928073	.	A	T	3	7	10	0	0	10	0	0
17	38928447	.	T	C	7	2	9	0	6	15	0	0
17	38928775	.	C	T	5	4	9	1	0	10	0	0
17	38928947	.	A	T	3	5	8	0	0	8	0	0
17	38929142	.	T	G	8	8	16	0	0	16	0	0
17	38929437	.	C	T	5	3	8	0	1	9	0	0
17	38941109	.	C	T	0	8	8	0	5	13	0	0
17	38941193	.	T	C	7	2	9	0	0	9	0	0
17	38941286	.	G	A	9	8	17	0	0	17	0	0
17	38946528	.	G	A	6	6	12	0	0	12	0	0
17	38946619	.	G	A	6	3	9	0	0	9	0	0
17	38989302	.	G	C	3	0	3	0	2	5	0	0
17	39184067	.	G	A	2	2	4	0	2	6	0	0
17	39184073	.	G	A	3	4	7	0	0	7	0	0
17	39184321	.	G	C	1	3	4	0	0	4	0	0
17	39184823	.	T	C	7	6	13	0	0	13	0	0
17	39184879	.	T	G	4	2	6	0	0	6	0	0
17	39697690	.	T	C	7	4	11	0	1	12	0	0
17	39703380	.	C	A	1	6	7	0	0	7	0	0
17	39707421	.	C	T	13	8	21	0	0	21	0	0
17	39717616	.	T	C	10	9	19	0	0	19	0	0
17	39717645	.	A	G	9	0	9	0	13	22	0	0
17	39720791	.	T	C	15	5	20	0	1	21	0	0
17	39728239	.	C	T	9	12	21	0	1	22	0	0
17	39728261	.	G	T	10	11	21	0	3	24	0	0
17	39728423	.	T	A	20	11	31	0	0	31	0	0
17	39729014	.	G	A	17	9	26	0	2	28	0	0
17	39732512	.	C	T	8	15	23	0	2	25	0	0
17	39732573	.	C	A	6	9	15	0	1	16	0	0
17	39732584	.	G	A	8	7	15	0	1	16	0	0
17	39736088	.	T	A	12	11	23	1	0	24	0	0
17	39736103	.	G	A	12	10	22	1	0	23	0	0
17	39736130	.	T	C	11	12	23	0	0	24	1	0
17	39739842	.	A	T	1	4	5	0	0	5	0	0
17	39862334	.	A	G	5	3	8	0	0	8	0	0
17	39862536	.	C	G	14	4	18	0	0	18	0	0
17	39863633	.	C	T	7	7	14	1	0	15	0	0
17	40223456	.	G	A	6	4	10	0	0	10	0	0
17	40223457	.	G	A	6	4	10	0	0	10	0	0
17	40397668	.	G	C	6	3	9	0	0	9	0	0
17	40873089	.	C	T	1	3	4	0	0	4	0	0
17	40879510	.	A	G	9	5	14	0	0	15	1	0
17	40879822	.	C	T	5	2	7	0	0	7	0	0
17	40879823	.	C	T	5	1	6	0	1	7	0	0
17	40880042	.	G	A	9	7	16	0	0	16	0	0
17	40883361	.	T	A	3	5	8	0	2	10	0	0
17	40883596	.	C	T	3	5	8	0	0	8	0	0
17	40884249	.	C	A	4	8	12	0	1	13	0	0
17	40887272	.	T	C	5	7	12	0	1	13	0	0
17	40887285	.	G	T	8	4	12	0	0	12	0	0
17	40888907	.	A	C	5	4	9	0	0	9	0	0
17	40888909	.	G	C	5	3	8	0	1	9	0	0
17	40889011	.	A	G	6	3	9	0	0	9	0	0
17	40889017	.	C	T	7	4	11	0	0	11	0	0
17	40889613	.	C	A	11	3	14	0	0	14	0	0
17	40889697	.	A	G	9	7	16	0	0	16	0	0
17	40890056	.	C	T	4	6	10	1	0	11	0	0
17	40890107	.	G	T	5	7	12	0	1	13	0	0
17	40890396	.	C	T	3	5	8	0	0	8	0	0
17	40890433	.	G	A	3	5	8	0	0	8	0	0
17	40890443	.	C	T	2	4	6	0	0	6	0	0
17	40893919	.	A	T	9	3	12	0	0	12	0	0
17	40893920	.	A	G	10	1	11	0	1	12	0	0
17	40899873	.	T	G	2	2	4	0	0	4	0	0
17	40899880	.	C	T	2	1	3	0	0	3	0	0
17	40900354	.	C	T	5	6	11	0	0	11	0	0
17	40900686	.	T	G	5	5	10	0	1	11	0	0
17	40901389	.	A	G	2	3	5	0	0	5	0	0
17	40901439	.	T	C	2	2	4	0	0	4	0	0
17	40901695	.	G	C	5	15	20	0	0	21	1	0
17	40901712	.	C	G	3	11	14	0	0	14	0	0
17	40901752	.	G	A	4	6	10	0	0	10	0	0
17	40901799	.	A	C	6	2	8	0	0	8	0	0
17	40901804	.	A	T	6	2	8	0	0	8	0	0
17	40902005	.	C	A	3	7	10	0	2	12	0	0
17	40902065	.	G	A	3	4	7	0	1	8	0	0
17	40902148	.	G	T	6	9	15	0	0	15	0	0
17	40902180	.	G	C	7	7	14	0	0	14	0	0
17	40902256	.	G	T	5	4	9	0	0	9	0	0
17	40902276	.	A	G	7	3	10	0	1	11	0	0
17	40902297	.	A	G	4	6	10	0	1	11	0	0
17	40902347	.	C	T	10	7	17	0	1	18	0	0
17	40902598	.	G	A	8	7	15	0	4	19	0	0
17	40902629	.	A	T	7	6	13	0	1	14	0	0
17	40902657	.	A	C	6	7	13	0	0	13	0	0
17	40902830	.	A	T	5	4	9	0	1	10	0	0
17	40903162	.	C	T	4	5	9	0	1	10	0	0
17	40932270	.	G	A	2	4	6	0	2	8	0	0
17	40932307	.	A	G	4	3	7	0	0	7	0	0
17	40955529	.	G	C	2	2	4	0	0	4	0	0
17	40955577	.	A	T	2	5	7	0	0	7	0	0
17	40990061	.	T	A	13	20	33	0	0	33	0	0
17	40990097	.	T	A	15	18	33	0	1	34	0	0
17	40999460	.	A	G	10	11	21	1	0	22	0	0
17	40999697	.	C	G	8	5	13	0	0	13	0	0
17	40999700	.	C	A	8	7	15	0	0	15	0	0
17	40999732	.	A	G	7	9	16	0	0	16	0	0
17	41084623	.	C	T	10	8	18	0	1	19	0	0
17	41084670	.	T	C	10	13	23	0	1	24	0	0
17	41092465	.	C	T	11	6	17	0	0	17	0	0
17	41121783	.	C	G	9	6	15	0	0	15	0	0
17	41220064	.	T	A	10	3	13	0	0	13	0	0
17	41254741	.	C	T	10	6	16	0	0	16	0	0
17	41314040	.	G	T	3	16	19	0	18	37	0	0
17	41314097	.	T	C	17	13	30	0	1	31	0	0
17	41314471	.	G	A	11	15	26	0	0	26	0	0
17	41314501	.	A	G	13	5	18	2	0	20	0	0
17	41317234	.	A	G	12	0	12	0	13	25	0	0
17	41317494	.	G	A	21	12	33	0	2	35	0	0
17	41317999	.	G	A	16	11	27	0	2	29	0	0
17	41318310	.	A	G	7	9	16	0	1	17	0	0
17	41318392	.	G	A	6	3	9	0	1	10	0	0
17	41368337	.	C	T	1	3	4	0	0	4	0	0
17	41464090	.	G	A	3	8	11	0	8	19	0	0
17	41465504	.	A	C	9	7	16	0	0	16	0	0
17	41475863	.	T	C	8	9	17	0	0	17	0	0
17	41476104	.	T	C	18	1	19	0	19	38	0	0
17	41476161	.	A	G	18	15	33	1	5	39	0	0
17	41476279	.	G	A	21	18	39	0	2	41	0	0
17	41476298	.	T	A	17	17	34	0	0	34	0	0
17	41476393	.	G	T	13	5	18	0	3	21	0	0
17	41476833	.	T	C	7	10	17	0	0	17	0	0
17	41476906	.	A	C	7	0	7	0	8	15	0	0
17	41476917	.	C	T	0	7	7	0	6	13	0	0
17	41476970	.	T	C	5	9	14	0	0	14	0	0
17	41476994	.	G	A	6	10	16	0	0	16	0	0
17	41477007	.	C	T	0	11	11	0	6	17	0	0
17	41477157	.	T	C	9	7	16	0	0	16	0	0
17	41477324	.	G	A	14	9	23	0	0	23	0	0
17	41558269	.	G	C	6	8	14	0	0	14	0	0
17	41571328	.	T	A	6	10	16	0	0	16	0	0
17	41583555	.	C	G	0	9	9	0	8	17	0	0
17	41583747	.	G	T	13	12	25	0	0	25	0	0
17	41583768	.	T	C	9	0	9	0	10	19	0	0
17	41583786	.	A	G	7	11	18	0	0	18	0	0
17	41592172	.	A	C	9	10	19	0	1	20	0	0
17	41601633	.	G	A	8	5	13	0	0	13	0	0
17	41601916	.	G	A	12	8	20	0	0	20	0	0
17	41602081	.	T	C	6	8	14	0	1	15	0	0
17	41610991	.	G	A	3	5	8	0	0	8	0	0
17	41631083	.	C	A	0	2	2	0	6	8	0	0
17	41639674	.	A	G	6	5	11	0	3	14	0	0
17	41639675	.	G	A	7	7	14	0	0	14	0	0
17	41659641	.	C	T	0	6	6	0	4	10	0	0
17	41666581	.	G	A	6	6	12	0	0	12	0	0
17	41667069	.	G	A	8	10	18	0	0	18	0	0
17	41667109	.	C	T	0	11	11	0	8	19	0	0
17	41669288	.	G	A	7	8	15	0	0	15	0	0
17	41669406	.	A	G	4	9	13	0	0	13	0	0
17	41673488	.	C	T	5	6	11	0	0	11	0	0
17	41673513	.	G	A	2	5	7	0	0	7	0	0
17	41675511	.	T	C	5	5	10	0	0	10	0	0
17	41685644	.	G	A	8	6	14	0	0	14	0	0
17	41798753	.	C	T	7	2	9	0	0	9	0	0
17	41992262	.	T	G	2	0	2	0	4	6	0	0
17	41994768	.	G	T	5	6	11	0	0	11	0	0
17	41994868	.	A	G	3	0	3	0	7	10	0	0
17	42003872	.	C	T	6	3	9	0	0	9	0	0
17	42027915	.	C	T	5	12	17	0	0	17	0	0
17	42030083	.	A	G	15	1	16	0	7	23	0	0
17	42032119	.	T	C	12	8	20	0	0	20	0	0
17	42096960	.	C	G	2	5	7	0	6	13	0	0
17	42566169	.	C	T	0	2	2	0	1	3	0	0
17	42566189	.	T	G	1	2	3	0	0	3	0	0
17	42614303	.	C	T	1	3	4	0	0	4	0	0
17	42871419	.	G	T	16	11	27	0	3	30	0	0
17	43006105	.	A	G	2	3	5	0	1	6	0	0
17	43013675	.	G	A	28	32	60	0	1	61	0	0
17	43017672	.	C	T	12	15	27	0	0	27	0	0
17	43017687	.	G	A	13	14	27	0	1	28	0	0
17	43017830	.	A	G	14	7	21	0	1	22	0	0
17	43017863	.	A	C	17	10	27	0	1	28	0	0
17	43018037	.	G	A	0	19	19	0	14	33	0	0
17	43018124	.	A	G	18	0	18	0	16	34	0	0
17	43018273	.	G	A	22	23	45	0	0	45	0	0
17	43018382	.	T	G	15	16	31	0	0	31	0	0
17	43018502	.	T	A	20	22	42	0	2	44	0	0
17	43018549	.	C	G	21	12	33	0	3	36	0	0
17	43018638	.	A	T	16	14	30	0	0	30	0	0
17	43018815	.	A	G	13	13	26	0	0	26	0	0
17	43018899	.	T	A	11	16	27	0	0	27	0	0
17	43030696	.	T	C	6	5	11	0	0	11	0	0
17	43030737	.	T	G	12	7	19	0	1	20	0	0
17	43030828	.	G	A	13	11	24	0	0	24	0	0
17	43031495	.	G	A	7	12	19	0	1	20	0	0
17	43033177	.	G	A	21	13	34	0	1	35	0	0
17	43035798	.	T	C	20	17	37	0	1	38	0	0
17	43035948	.	A	G	15	6	21	0	1	22	0	0
17	43035958	.	A	G	11	6	17	0	1	18	0	0
17	43039706	.	A	G	1	3	4	0	0	4	0	0
17	43075560	.	G	T	3	4	7	0	0	7	0	0
17	43075561	.	G	A	3	4	7	0	0	7	0	0
17	43077265	.	G	T	2	3	5	0	0	5	0	0
17	43077327	.	C	T	2	4	6	0	0	6	0	0
17	43082871	.	G	A	7	3	10	0	0	10	0	0
17	43082976	.	A	T	6	8	14	0	0	14	0	0
17	43104590	.	T	A	5	4	9	0	0	9	0	0
17	43146508	.	C	T	1	6	7	0	0	7	0	0
17	43146607	.	G	C	6	8	14	0	0	14	0	0
17	43158663	.	A	G	2	4	6	0	0	6	0	0
17	43158669	.	C	A	2	3	5	0	0	5	0	0
17	43220001	.	A	G	2	3	5	0	0	5	0	0
17	43220058	.	G	A	2	4	6	0	0	6	0	0
17	43287129	.	C	T	0	5	5	0	5	10	0	0
17	43287146	.	A	G	5	7	12	0	0	12	0	0
17	43297561	.	T	G	3	5	8	0	2	10	0	0
17	43297946	.	G	C	23	19	42	0	0	42	0	0
17	43298011	.	G	A	19	23	42	0	1	43	0	0
17	43298068	.	G	A	12	17	29	0	1	30	0	0
17	43302492	.	G	A	10	18	28	0	1	29	0	0
17	43309095	.	A	G	9	20	29	0	1	30	0	0
17	43309164	.	C	T	1	10	11	0	16	27	0	0
17	43315085	.	C	T	9	17	26	0	0	26	0	0
17	43348986	.	T	C	15	10	25	0	2	27	0	0
17	43391434	.	G	T	9	4	13	1	0	14	0	0
17	43391442	.	C	T	8	7	15	1	0	16	0	0
17	43423472	.	C	T	2	2	4	0	0	4	0	0
17	43436782	.	T	C	22	1	23	0	23	46	0	0
17	43437305	.	G	C	28	24	52	0	0	52	0	0
17	43437365	.	C	G	28	22	50	0	1	51	0	0
17	43439720	.	G	T	21	18	39	1	3	43	0	0
17	43441575	.	A	T	21	22	43	0	2	45	0	0
17	43453507	.	T	C	19	14	33	0	4	37	0	0
17	43453531	.	G	A	18	16	34	0	1	35	0	0
17	43456825	.	C	T	16	12	28	0	5	33	0	0
17	43456900	.	G	A	15	15	30	0	1	31	0	0
17	43456921	.	T	C	16	10	26	0	1	27	0	0
17	43461181	.	G	A	15	13	28	0	0	28	0	0
17	43469204	.	A	C	10	14	24	0	0	24	0	0
17	43469515	.	G	T	7	16	23	0	1	24	0	0
17	43473913	.	T	C	10	9	19	0	0	19	0	0
17	43475562	.	T	C	15	10	25	0	1	26	0	0
17	43475577	.	G	A	2	8	10	0	13	23	0	0
17	43475619	.	A	G	10	0	10	0	10	20	0	0
17	43475691	.	T	A	5	4	9	0	1	10	0	0
17	43475712	.	A	G	3	1	4	0	5	9	0	0
17	43475994	.	T	G	8	5	13	0	1	15	1	0
17	43476137	.	T	A	4	8	12	0	0	12	0	0
17	43476232	.	A	G	6	3	9	0	0	9	0	0
17	43476241	.	A	G	3	3	6	0	0	6	0	0
17	43491218	.	T	C	4	7	11	0	1	12	0	0
17	43494942	.	A	G	5	6	11	0	1	12	0	0
17	43494970	.	A	G	3	0	3	0	11	14	0	0
17	43497376	.	A	G	4	12	16	0	1	17	0	0
17	43513318	.	C	T	1	10	11	0	9	20	0	0
17	43516451	.	T	A	8	9	17	0	1	18	0	0
17	43516464	.	T	A	11	8	19	0	0	19	0	0
17	43516502	.	G	T	11	10	21	0	0	21	0	0
17	43516506	.	A	C	10	9	19	0	1	20	0	0
17	43516548	.	A	G	15	13	28	0	1	29	0	0
17	43524233	.	T	C	1	4	5	0	0	5	0	0
17	43524245	.	T	G	1	4	5	0	0	5	0	0
17	43525185	.	A	T	1	2	3	0	0	3	0	0
17	43525600	.	C	G	8	3	11	0	0	11	0	0
17	43525757	.	A	G	1	4	5	0	1	6	0	0
17	43525804	.	G	A	1	2	3	0	0	3	0	0
17	43538081	.	G	A	3	4	7	0	0	7	0	0
17	43538097	.	C	T	2	5	7	0	0	7	0	0
17	43538209	.	C	T	9	7	16	0	2	18	0	0
17	43547945	.	A	G	5	10	15	0	0	15	0	0
17	43551539	.	A	C	6	6	12	0	0	12	0	0
17	43551547	.	G	T	6	7	13	0	0	13	0	0
17	43565638	.	G	T	7	9	16	1	0	17	0	0
17	43572332	.	G	A	1	7	8	0	0	8	0	0
17	43575504	.	C	T	0	4	4	0	1	5	0	0
17	43575545	.	C	A	3	4	7	0	1	8	0	0
17	43575782	.	C	T	1	4	5	0	0	5	0	0
17	43575924	.	G	C	5	4	9	0	0	9	0	0
17	43576107	.	T	A	2	3	5	0	0	5	0	0
17	43584403	.	T	C	2	2	4	0	0	4	0	0
17	43594693	.	C	A	5	6	11	0	0	11	0	0
17	43594709	.	A	T	5	5	10	0	0	10	0	0
17	43594806	.	T	C	2	2	4	0	0	4	0	0
17	43604511	.	G	C	0	2	2	0	1	3	0	0
17	43611519	.	T	C	1	3	4	0	0	4	0	0
17	43612212	.	C	T	2	2	4	0	1	5	0	0
17	43623214	.	C	T	1	2	3	0	0	3	0	0
17	43623235	.	C	A	0	2	2	0	2	4	0	0
17	43623744	.	T	G	5	5	10	0	0	10	0	0
17	43623856	.	A	T	2	3	5	0	1	6	0	0
17	43623882	.	C	A	1	3	4	0	0	4	0	0
17	43629055	.	G	C	6	3	9	0	0	9	0	0
17	43629092	.	A	G	5	0	5	0	3	8	0	0
17	43629223	.	C	T	1	3	4	0	0	4	0	0
17	43629244	.	A	C	2	3	5	0	0	5	0	0
17	43629286	.	A	T	3	6	9	0	0	9	0	0
17	43629342	.	T	C	2	4	6	0	0	6	0	0
17	43629364	.	C	T	2	4	6	0	0	6	0	0
17	43629418	.	G	A	1	5	6	0	2	8	0	0
17	43629422	.	G	C	2	5	7	0	0	7	0	0
17	43629502	.	G	A	2	6	8	0	1	9	0	0
17	43629604	.	T	C	5	4	9	0	1	10	0	0
17	43629622	.	C	T	4	5	9	0	0	9	0	0
17	43629673	.	G	A	1	3	4	0	1	5	0	0
17	43632931	.	G	T	2	2	4	0	1	5	0	0
17	43660168	.	C	T	14	8	22	0	0	22	0	0
17	43660232	.	G	A	16	9	25	0	2	27	0	0
17	43660779	.	T	C	10	9	19	0	0	19	0	0
17	43661176	.	C	G	6	8	14	0	1	15	0	0
17	43661223	.	G	T	6	5	11	0	0	11	0	0
17	43661291	.	G	T	12	5	17	1	1	19	0	0
17	43661293	.	A	T	10	5	15	1	3	19	0	0
17	43661578	.	A	G	9	4	13	0	0	13	0	0
17	43661618	.	T	A	2	6	8	0	0	8	0	0
17	43663611	.	T	G	8	5	13	0	1	14	0	0
17	43664128	.	G	C	18	21	39	0	1	40	0	0
17	43664176	.	C	A	2	16	18	0	20	38	0	0
17	43664605	.	G	A	23	10	33	0	1	34	0	0
17	43664828	.	G	T	2	7	9	0	1	10	0	0
17	43708608	.	C	T	11	12	23	0	0	23	0	0
17	43711502	.	G	A	4	5	9	0	0	9	0	0
17	43850878	.	A	T	15	5	20	1	2	23	0	0
17	43853538	.	G	A	20	17	37	0	0	37	0	0
17	43853767	.	A	T	20	8	28	0	2	30	0	0
17	43853778	.	C	T	2	17	19	0	11	30	0	0
17	43853938	.	C	T	19	10	29	0	0	29	0	0
17	43854010	.	T	G	15	9	24	0	0	24	0	0
17	43856232	.	T	C	7	10	17	0	2	19	0	0
17	43859306	.	A	T	13	9	22	0	1	23	0	0
17	43859378	.	C	T	14	17	31	0	0	31	0	0
17	43859387	.	C	T	14	15	29	0	2	31	0	0
17	43863540	.	C	A	12	10	22	0	1	23	0	0
17	43874125	.	C	T	2	2	4	0	0	4	0	0
17	43879178	.	T	C	3	2	5	0	0	5	0	0
17	43883424	.	T	C	1	2	3	0	0	3	0	0
17	43883634	.	C	T	1	2	3	0	0	3	0	0
17	43926650	.	C	A	9	8	17	0	0	17	0	0
17	43946490	.	T	G	5	0	5	0	6	11	0	0
17	43951792	.	A	C	15	7	22	0	2	24	0	0
17	43951834	.	G	A	17	5	22	0	0	22	0	0
17	43952984	.	C	T	7	7	14	0	0	14	0	0
17	43954926	.	A	C	9	9	18	0	0	18	0	0
17	43955964	.	G	A	1	14	15	0	9	24	0	0
17	43956910	.	T	C	12	12	24	0	0	24	0	0
17	43959078	.	A	G	6	0	6	0	7	13	0	0
17	43959098	.	A	G	10	0	10	0	6	16	0	0
17	43959594	.	A	G	9	12	21	0	1	22	0	0
17	43961739	.	C	T	9	9	18	0	0	18	0	0
17	43961801	.	T	C	8	6	14	0	0	14	0	0
17	43962039	.	A	G	8	8	16	0	2	18	0	0
17	43968605	.	A	G	8	12	20	0	0	20	0	0
17	43968686	.	A	G	14	14	28	0	2	30	0	0
17	43976947	.	C	A	16	14	30	0	2	32	0	0
17	43977416	.	G	A	14	17	31	0	0	31	0	0
17	43977433	.	T	G	11	17	28	2	0	30	0	0
17	43985045	.	G	A	18	10	28	0	1	29	0	0
17	43985075	.	C	T	17	15	32	0	0	32	0	0
17	43986863	.	C	T	12	20	32	0	0	32	0	0
17	43988711	.	T	A	18	16	34	0	1	35	0	0
17	43990662	.	C	G	1	2	3	0	0	3	0	0
17	43996483	.	G	A	30	10	40	0	2	42	0	0
17	43996485	.	G	A	28	11	39	0	1	40	0	0
17	43996620	.	A	T	28	15	43	0	1	44	0	0
17	43996667	.	G	A	23	17	40	0	0	40	0	0
17	44001833	.	T	C	13	8	21	0	0	21	0	0
17	44001880	.	T	A	14	12	26	0	1	28	1	0
17	44002000	.	C	G	13	1	14	0	9	23	0	0
17	44006443	.	C	A	1	2	3	0	0	3	0	0
17	44006579	.	G	T	1	2	3	0	0	3	0	0
17	44006654	.	A	G	2	4	6	0	0	6	0	0
17	44006924	.	G	C	4	3	7	0	0	7	0	0
17	44006927	.	G	A	4	3	7	0	0	7	0	0
17	44007047	.	A	T	4	2	6	0	0	6	0	0
17	44007326	.	G	T	1	5	6	0	0	6	0	0
17	44074532	.	A	C	2	4	6	0	1	7	0	0
17	44074996	.	C	G	8	0	8	0	6	14	0	0
17	44075035	.	A	G	3	0	3	0	5	8	0	0
17	44079925	.	G	C	5	6	11	0	0	11	0	0
17	44115553	.	G	A	2	2	4	0	0	4	0	0
17	44115587	.	T	C	5	2	7	0	1	8	0	0
17	44245452	.	T	C	18	18	36	0	1	37	0	0
17	44247495	.	G	A	18	16	34	0	0	34	0	0
17	44249428	.	T	G	14	10	24	0	0	24	0	0
17	44413925	.	C	T	12	5	17	0	1	18	0	0
17	44413980	.	G	A	9	6	15	0	0	15	0	0
17	44414030	.	A	G	11	11	22	0	0	22	0	0
17	44420201	.	G	A	9	6	15	0	0	15	0	0
17	44420406	.	T	C	7	4	11	0	1	12	0	0
17	44420602	.	G	A	10	7	17	0	0	17	0	0
17	44425950	.	A	C	6	6	12	0	0	12	0	0
17	44430544	.	A	G	1	2	3	0	0	3	0	0
17	44430586	.	C	T	0	4	4	0	1	5	0	0
17	44443759	.	A	T	2	4	6	0	0	6	0	0
17	44443867	.	T	C	2	2	4	0	0	4	0	0
17	44443885	.	A	T	2	2	4	0	0	4	0	0
17	44444127	.	C	T	3	2	5	0	1	6	0	0
17	44444246	.	G	T	2	3	5	0	0	5	0	0
17	44453771	.	G	A	0	3	3	0	3	6	0	0
17	44463892	.	A	G	3	8	11	0	1	12	0	0
17	44463903	.	G	T	4	9	13	0	0	13	0	0
17	44473954	.	G	C	7	11	18	0	0	18	0	0
17	44474284	.	G	A	6	9	15	0	1	16	0	0
17	44474392	.	A	G	6	5	11	0	1	12	0	0
17	44474445	.	C	A	6	7	13	0	0	13	0	0
17	44474541	.	C	T	6	3	9	0	1	10	0	0
17	44474547	.	T	A	4	3	7	0	0	7	0	0
17	44474592	.	T	G	5	3	8	0	1	9	0	0
17	44474601	.	G	T	6	1	7	0	1	8	0	0
17	44474658	.	A	G	5	1	6	0	5	11	0	0
17	44475047	.	T	G	7	8	15	0	0	15	0	0
17	44475093	.	C	G	14	9	23	0	0	23	0	0
17	44475940	.	C	G	7	4	11	0	0	11	0	0
17	44476075	.	G	T	8	3	11	0	0	11	0	0
17	44502836	.	A	G	7	6	13	0	0	13	0	0
17	44539266	.	T	A	3	5	8	0	0	8	0	0
17	44540475	.	C	T	4	6	10	1	0	11	0	0
17	44542577	.	A	G	4	3	7	0	0	7	0	0
17	44542598	.	G	C	3	2	5	0	0	5	0	0
17	44542712	.	G	C	4	4	8	0	0	8	0	0
17	44542790	.	A	G	4	4	8	0	0	8	0	0
17	44584863	.	G	A	2	2	4	0	0	4	0	0
17	44756390	.	G	A	0	7	7	0	10	17	0	0
17	44756895	.	A	C	7	4	11	0	0	11	0	0
17	44756986	.	C	T	7	4	11	0	1	12	0	0
17	44758025	.	A	T	5	7	12	0	1	13	0	0
17	44758078	.	T	C	3	8	11	0	0	11	0	0
17	44760273	.	T	G	4	0	4	0	4	8	0	0
17	44760544	.	C	A	7	4	11	0	0	11	0	0
17	44760618	.	C	T	7	11	18	0	1	19	0	0
17	44760774	.	C	T	8	6	14	0	1	15	0	0
17	44760858	.	A	G	7	6	13	0	0	13	0	0
17	44761103	.	G	T	8	6	14	0	0	14	0	0
17	44761124	.	A	T	7	6	13	0	0	13	0	0
17	44761140	.	G	T	7	6	13	0	0	13	0	0
17	44761349	.	G	A	7	8	15	0	0	15	0	0
17	44761356	.	G	T	8	5	13	0	3	16	0	0
17	44761504	.	T	C	6	2	8	0	0	8	0	0
17	44761542	.	T	A	3	3	6	0	0	6	0	0
17	44768321	.	T	C	1	4	5	0	0	5	0	0
17	44768622	.	A	G	2	2	4	0	0	4	0	0
17	44768773	.	A	T	0	2	2	0	0	2	0	0
17	44768776	.	C	A	1	3	4	0	0	4	0	0
17	44769039	.	T	A	6	6	12	0	0	12	0	0
17	44769379	.	A	G	4	3	7	0	0	7	0	0
17	44770850	.	A	G	3	3	6	0	0	6	0	0
17	44771236	.	C	G	10	7	17	0	0	17	0	0
17	44771353	.	A	C	4	7	11	0	2	13	0	0
17	44775971	.	C	T	7	9	16	0	0	16	0	0
17	44776034	.	T	A	5	6	11	0	2	13	0	0
17	44833808	.	G	A	7	6	13	0	0	13	0	0
17	44833992	.	T	A	4	7	11	0	0	11	0	0
17	44857662	.	C	T	7	7	14	0	0	14	0	0
17	44860885	.	C	G	9	6	15	0	0	15	0	0
17	44860887	.	C	A	9	6	15	0	0	15	0	0
17	44862308	.	G	C	10	7	17	0	0	17	0	0
17	44865421	.	G	A	0	7	7	0	7	14	0	0
17	44870978	.	G	A	0	4	4	0	8	12	0	0
17	44871033	.	A	T	5	10	15	0	0	15	0	0
17	44873988	.	C	T	18	11	29	0	1	30	0	0
17	44878504	.	G	T	11	11	22	0	1	23	0	0
17	44884774	.	C	T	4	5	9	0	0	9	0	0
17	44884997	.	C	T	8	6	14	0	1	15	0	0
17	44899562	.	G	A	1	9	10	0	14	24	0	0
17	44911803	.	A	G	11	10	21	0	2	23	0	0
17	44921955	.	G	A	2	4	6	0	12	18	0	0
17	44921992	.	A	G	5	0	5	0	8	13	0	0
17	44922442	.	C	T	11	8	19	0	1	20	0	0
17	44922685	.	G	T	6	13	19	0	1	20	0	0
17	44922743	.	G	A	6	10	16	0	0	16	0	0
17	44922788	.	C	A	8	9	17	0	0	17	0	0
17	44922819	.	A	T	10	7	17	0	1	18	0	0
17	44922866	.	C	T	8	9	17	0	0	17	0	0
17	44923053	.	C	T	7	5	12	0	1	13	0	0
17	44923083	.	T	A	7	9	16	0	3	19	0	0
17	44923322	.	T	A	7	5	12	0	1	13	0	0
17	44923345	.	T	C	4	7	11	0	0	11	0	0
17	44923389	.	G	A	4	4	8	0	1	9	0	0
17	44962056	.	G	A	16	9	25	0	0	25	0	0
17	44962502	.	A	T	4	9	13	0	0	13	0	0
17	44962507	.	A	G	8	5	13	0	0	13	0	0
17	44962575	.	G	T	7	7	14	0	0	14	0	0
17	44962693	.	T	C	5	13	18	0	0	18	0	0
17	44962799	.	A	G	4	3	7	0	0	7	0	0
17	44962826	.	C	T	5	3	8	0	0	8	0	0
17	44962860	.	T	G	3	4	7	0	3	10	0	0
17	44962861	.	A	T	8	3	11	0	0	11	0	0
17	44967819	.	G	A	17	14	31	0	0	31	0	0
17	44968095	.	C	T	16	12	28	0	0	28	0	0
17	44980976	.	T	G	2	4	6	0	0	6	0	0
17	44981087	.	C	T	2	2	4	0	0	4	0	0
17	44981175	.	T	C	3	6	9	0	0	9	0	0
17	44981636	.	G	A	6	12	18	0	0	18	0	0
17	44981689	.	A	G	2	5	7	0	0	7	0	0
17	44981693	.	C	G	2	5	7	0	0	7	0	0
17	44998615	.	C	G	5	3	8	0	0	8	0	0
17	45002540	.	C	A	2	4	6	0	0	6	0	0
17	45002782	.	T	G	5	5	10	0	0	10	0	0
17	45002812	.	G	A	4	8	12	0	0	12	0	0
17	45004771	.	C	T	0	9	9	0	3	12	0	0
17	45004833	.	T	C	5	6	11	0	0	11	0	0
17	45005038	.	G	T	4	2	6	0	0	6	0	0
17	45007013	.	C	T	5	2	7	0	0	7	0	0
17	45007168	.	C	T	2	3	5	0	0	5	0	0
17	45009546	.	A	G	5	3	8	0	0	8	0	0
17	45010190	.	A	C	2	5	7	0	3	10	0	0
17	45010337	.	C	T	8	7	15	0	0	15	0	0
17	45010338	.	T	A	7	7	14	0	1	15	0	0
17	45018030	.	C	T	10	4	14	0	1	15	0	0
17	45018207	.	A	G	10	4	14	0	3	17	0	0
17	45022535	.	T	G	7	0	7	0	5	12	0	0
17	45026822	.	C	A	0	2	2	0	1	3	0	0
17	45028248	.	G	A	2	3	5	0	0	5	0	0
17	45028638	.	G	C	1	3	4	0	0	4	0	0
17	45028651	.	A	G	1	2	3	0	1	4	0	0
17	45028689	.	T	A	2	2	4	0	2	6	0	0
17	45073467	.	T	A	5	5	10	0	0	10	0	0
17	45073490	.	C	A	1	6	7	0	6	13	0	0
17	45076111	.	A	G	26	16	42	0	1	43	0	0
17	45082331	.	T	G	17	12	29	0	1	30	0	0
17	45082406	.	A	G	18	11	29	0	2	31	0	0
17	45082466	.	C	A	1	17	18	0	6	24	0	0
17	45085085	.	G	A	17	15	32	0	2	35	1	0
17	45085100	.	C	T	16	21	37	0	0	37	0	0
17	45093134	.	G	T	14	18	32	0	0	32	0	0
17	45093155	.	G	A	19	13	32	0	3	35	0	0
17	45099042	.	G	T	13	7	20	0	0	20	0	0
17	45099141	.	C	A	15	9	24	0	0	24	0	0
17	45138255	.	C	A	0	12	12	0	9	21	0	0
17	45138329	.	A	C	16	12	28	0	0	28	0	0
17	45138391	.	G	T	13	5	18	0	1	20	1	0
17	45138446	.	C	T	2	8	10	0	4	14	0	0
17	45138733	.	T	C	21	9	30	0	0	30	0	0
17	45138741	.	T	C	21	10	31	0	2	33	0	0
17	45139503	.	C	A	12	14	26	0	0	26	0	0
17	45139506	.	G	T	12	14	26	0	0	26	0	0
17	45139750	.	C	T	8	15	23	0	1	24	0	0
17	45139805	.	A	T	10	13	23	0	0	23	0	0
17	45139879	.	C	T	6	20	26	0	0	26	0	0
17	45139881	.	G	A	5	19	24	0	1	25	0	0
17	45140376	.	A	T	2	5	7	0	1	8	0	0
17	45145056	.	A	G	6	14	20	0	0	20	0	0
17	45145065	.	T	C	5	0	5	0	13	18	0	0
17	45145143	.	T	C	9	0	9	0	8	17	0	0
17	45148190	.	G	T	10	12	22	0	2	24	0	0
17	45148302	.	T	A	11	12	23	0	1	24	0	0
17	45148303	.	A	G	11	13	24	0	0	24	0	0
17	45216125	.	C	T	7	8	15	0	1	16	0	0
17	45216312	.	C	T	0	9	9	0	7	16	0	0
17	45216612	.	G	A	6	9	15	0	0	15	0	0
17	45232733	.	G	C	12	6	18	0	0	18	0	0
17	45232856	.	C	T	6	7	13	0	0	13	0	0
17	45232993	.	T	A	4	4	8	0	0	8	0	0
17	45233056	.	T	A	4	2	6	0	0	6	0	0
17	45233125	.	T	A	4	3	7	0	0	7	0	0
17	45233134	.	C	T	3	4	7	0	0	7	0	0
17	45234663	.	T	A	6	6	12	0	0	12	0	0
17	45234816	.	G	C	3	2	5	0	1	6	0	0
17	45235138	.	G	A	4	8	12	0	0	12	0	0
17	45235370	.	C	A	6	8	14	0	1	15	0	0
17	45235379	.	A	T	7	7	14	0	0	14	0	0
17	45238851	.	G	A	5	5	10	0	0	10	0	0
17	45247199	.	A	G	9	7	16	0	1	17	0	0
17	45254339	.	C	T	9	5	14	0	0	14	0	0
17	45259821	.	A	C	1	2	3	0	0	3	0	0
17	45285190	.	C	T	1	2	3	0	0	3	0	0
17	45285208	.	A	C	1	2	3	0	0	3	0	0
17	45295040	.	A	G	2	0	2	0	2	4	0	0
17	45302555	.	A	T	4	2	6	0	0	6	0	0
17	45302562	.	G	A	3	2	5	0	0	5	0	0
17	45302621	.	G	T	0	2	2	0	1	3	0	0
17	45348243	.	G	A	5	4	9	0	0	9	0	0
17	45348585	.	T	A	3	4	7	0	0	7	0	0
17	45348616	.	T	C	2	2	4	0	0	4	0	0
17	45348824	.	T	C	4	3	7	0	0	7	0	0
17	45349061	.	T	A	3	3	6	0	0	6	0	0
17	45349279	.	A	G	3	2	5	0	0	5	0	0
17	45350447	.	G	A	2	2	4	0	0	4	0	0
17	45357141	.	C	T	0	4	4	0	2	6	0	0
17	45362027	.	G	A	2	6	8	0	0	8	0	0
17	45362270	.	T	C	2	2	4	0	0	4	0	0
17	45362482	.	T	A	4	2	6	0	1	7	0	0
17	45362505	.	G	A	3	2	5	0	0	5	0	0
17	45363768	.	C	T	3	2	5	0	1	6	0	0
17	45365191	.	A	C	1	3	4	0	0	4	0	0
17	45366757	.	A	G	3	4	7	0	0	7	0	0
17	45366795	.	G	A	1	4	5	0	0	5	0	0
17	45401883	.	A	G	1	0	1	0	2	3	0	0
17	45458154	.	C	G	7	0	7	0	7	14	0	0
17	45479017	.	C	A	2	2	4	0	0	4	0	0
17	45482087	.	T	C	0	5	5	0	0	5	0	0
17	45482537	.	C	G	1	2	3	0	0	3	0	0
17	45482615	.	T	A	2	2	4	0	0	4	0	0
17	45532532	.	T	A	18	21	39	0	0	39	0	0
17	45532637	.	A	T	27	13	40	0	2	42	0	0
17	45613686	.	T	C	1	2	3	0	0	3	0	0
17	45639367	.	G	A	0	2	2	0	7	9	0	0
17	45639926	.	C	A	4	3	7	0	0	7	0	0
17	45731991	.	T	C	6	5	11	0	0	11	0	0
17	45732147	.	T	C	7	14	21	0	0	21	0	0
17	45732173	.	C	T	0	10	10	0	7	17	0	0
17	45732327	.	G	A	9	7	16	0	2	18	0	0
17	45732601	.	G	A	7	7	14	0	0	14	0	0
17	45732765	.	A	T	9	7	16	0	1	17	0	0
17	45732785	.	T	C	8	14	22	0	0	22	0	0
17	45732802	.	G	T	9	14	23	0	0	23	0	0
17	45733537	.	A	G	3	4	7	0	0	7	0	0
17	45733664	.	G	A	8	3	11	0	0	11	0	0
17	45734170	.	A	G	10	8	18	2	0	20	0	0
17	45738138	.	A	G	9	4	13	0	2	15	0	0
17	45744187	.	C	T	6	7	13	0	0	13	0	0
17	45748014	.	A	G	4	0	4	0	8	12	0	0
17	45748623	.	C	T	5	4	9	0	0	9	0	0
17	45748674	.	A	G	4	5	9	0	0	9	0	0
17	45748701	.	T	A	5	5	10	0	0	10	0	0
17	45750485	.	C	T	8	6	14	1	0	15	0	0
17	45751385	.	C	T	5	9	14	0	0	15	1	0
17	45751404	.	T	C	9	6	15	0	0	15	0	0
17	45756484	.	A	G	10	5	15	0	0	15	0	0
17	45756547	.	C	T	10	13	23	0	0	23	0	0
17	45756610	.	T	C	12	7	19	0	0	19	0	0
17	45756652	.	T	C	9	7	16	0	0	16	0	0
17	45759087	.	C	T	6	12	18	0	0	18	0	0
17	45765222	.	C	T	11	6	17	0	1	18	0	0
17	45765234	.	G	A	16	7	23	0	0	23	0	0
17	45766167	.	A	G	6	0	6	0	13	19	0	0
17	45773982	.	T	G	5	4	9	4	0	13	0	0
17	45979069	.	C	T	1	2	3	0	0	3	0	0
17	45980040	.	C	T	4	3	7	0	0	7	0	0
17	45980743	.	A	G	2	4	6	0	0	6	0	0
17	45980876	.	T	C	1	2	3	0	0	3	0	0
17	45981019	.	C	T	2	5	7	0	0	7	0	0
17	45981067	.	C	T	3	5	8	0	0	8	0	0
17	45981104	.	G	A	4	3	7	0	0	7	0	0
17	45981457	.	G	A	2	2	4	0	0	4	0	0
17	45981896	.	G	C	6	5	11	0	0	11	0	0
17	45981961	.	C	T	3	5	8	0	0	8	0	0
17	45981984	.	G	A	1	5	6	0	1	7	0	0
17	45982135	.	C	T	4	2	6	0	0	6	0	0
17	45982804	.	T	C	2	3	5	0	0	5	0	0
17	45982969	.	A	T	1	2	3	0	0	3	0	0
17	45983347	.	C	A	3	5	8	0	0	8	0	0
17	45983392	.	G	A	4	3	7	0	0	7	0	0
17	45983410	.	C	T	2	2	4	0	1	5	0	0
17	45983626	.	G	A	4	2	6	0	0	6	0	0
17	45984415	.	A	G	5	0	5	0	9	14	0	0
17	45984465	.	G	T	0	7	7	0	3	10	0	0
17	45987075	.	G	A	0	5	5	0	5	10	0	0
17	45987120	.	C	T	7	7	14	0	0	14	0	0
17	45987143	.	A	T	6	4	10	0	0	10	0	0
17	45987512	.	G	A	6	2	8	0	0	8	0	0
17	45987629	.	A	T	3	2	5	0	2	7	0	0
17	45988446	.	G	A	0	2	2	0	4	6	0	0
17	46387253	.	G	T	0	7	7	0	6	13	0	0
17	46387291	.	C	A	6	7	13	0	0	13	0	0
17	46402526	.	A	G	5	0	5	0	5	10	0	0
17	46439098	.	G	A	6	7	13	0	1	14	0	0
17	46439102	.	C	T	6	7	13	0	0	13	0	0
17	46439186	.	A	G	6	6	12	0	0	12	0	0
17	47140969	.	G	A	1	7	8	0	6	14	0	0
17	47164815	.	G	A	1	6	7	0	2	9	0	0
17	47169612	.	A	T	4	6	10	0	0	10	0	0
17	47169660	.	G	C	0	4	4	0	5	9	0	0
17	47175456	.	G	A	7	6	13	0	0	13	0	0
17	47175569	.	G	A	13	9	22	0	0	22	0	0
17	47176050	.	A	T	3	2	5	0	0	5	0	0
17	47188778	.	G	A	7	4	11	0	0	11	0	0
17	47188800	.	T	A	7	3	10	0	0	10	0	0
17	47188932	.	C	T	1	8	9	0	7	16	0	0
17	47188984	.	G	A	8	5	13	0	0	13	0	0
17	47189025	.	C	A	4	4	8	1	0	9	0	0
17	47189129	.	C	A	11	7	18	1	1	20	0	0
17	47189221	.	C	T	5	7	12	0	2	14	0	0
17	47189243	.	T	C	6	9	15	0	2	17	0	0
17	47189258	.	G	T	9	7	16	0	0	16	0	0
17	47189283	.	A	T	7	7	14	0	0	14	0	0
17	47189684	.	G	A	9	11	20	0	0	20	0	0
17	47189725	.	G	A	8	5	13	0	0	13	0	0
17	47189741	.	G	T	4	5	9	0	1	10	0	0
17	47189765	.	G	T	4	5	9	0	0	9	0	0
17	47189790	.	A	G	0	5	5	0	1	6	0	0
17	47189937	.	T	A	13	9	22	0	0	22	0	0
17	47190941	.	G	T	5	8	13	0	0	13	0	0
17	47191229	.	G	A	3	4	7	0	0	7	0	0
17	47191248	.	G	A	5	4	9	0	0	9	0	0
17	47191795	.	C	A	2	3	5	0	0	5	0	0
17	47191871	.	T	C	5	0	5	0	3	8	0	0
17	47192047	.	T	C	5	3	8	0	0	8	0	0
17	47192048	.	T	C	6	2	8	0	0	8	0	0
17	47192178	.	C	T	7	6	13	0	0	13	0	0
17	47192392	.	C	A	1	2	3	0	0	3	0	0
17	47192642	.	G	A	5	3	8	0	0	8	0	0
17	47192651	.	G	C	6	3	9	0	0	9	0	0
17	47192766	.	C	T	2	3	5	0	0	5	0	0
17	47193007	.	C	G	5	2	7	0	0	7	0	0
17	47193180	.	T	A	5	4	9	0	0	9	0	0
17	47193200	.	A	G	7	6	13	0	0	13	0	0
17	47193313	.	T	C	4	4	8	0	0	9	1	0
17	47193692	.	C	T	11	4	15	0	0	15	0	0
17	47193857	.	T	C	9	0	9	0	4	13	0	0
17	47193902	.	C	T	1	5	6	0	2	8	0	0
17	47193995	.	T	C	10	9	19	0	0	19	0	0
17	47196179	.	G	C	7	5	12	0	1	13	0	0
17	47196584	.	T	G	4	5	9	0	2	11	0	0
17	47196587	.	G	A	6	5	11	0	0	11	0	0
17	47238840	.	C	T	1	2	3	0	0	3	0	0
17	47289395	.	C	A	6	8	14	0	0	14	0	0
17	48127489	.	T	A	3	6	9	0	0	9	0	0
17	48138510	.	T	A	5	2	7	0	1	8	0	0
17	48138525	.	G	A	1	2	3	0	3	6	0	0
17	48139427	.	T	C	2	6	8	0	2	10	0	0
17	48156580	.	C	T	2	8	10	0	1	11	0	0
17	48156631	.	G	A	5	9	14	0	0	14	0	0
17	48831725	.	C	T	2	2	4	0	0	4	0	0
17	48837473	.	C	T	2	3	5	0	0	5	0	0
17	48850488	.	C	T	2	8	10	0	0	10	0	0
17	48853270	.	C	T	1	4	5	0	0	5	0	0
17	48862546	.	T	C	5	4	9	0	0	9	0	0
17	48862555	.	G	A	6	4	10	0	0	10	0	0
17	48867268	.	C	T	4	2	6	0	2	8	0	0
17	48883751	.	A	G	3	2	5	0	0	5	0	0
17	48890549	.	A	C	8	6	14	0	0	14	0	0
17	48908911	.	A	G	9	11	20	0	0	20	0	0
17	48911097	.	T	G	7	8	15	0	0	15	0	0
17	48911419	.	G	T	11	8	19	0	0	19	0	0
17	48915387	.	A	T	9	10	19	0	0	19	0	0
17	48926655	.	G	A	2	3	5	0	0	5	0	0
17	48965350	.	T	G	4	0	4	0	11	15	0	0
17	49003651	.	A	G	8	9	17	0	0	17	0	0
17	49006619	.	A	T	6	8	14	0	0	14	0	0
17	49010654	.	T	C	14	8	22	0	0	22	0	0
17	49010678	.	T	C	13	11	24	0	1	25	0	0
17	49010727	.	T	C	9	9	18	0	1	19	0	0
17	49011174	.	A	G	8	15	23	0	0	23	0	0
17	49011177	.	C	A	11	14	25	0	0	25	0	0
17	49011627	.	T	C	11	12	23	0	0	23	0	0
17	49016534	.	C	T	7	10	17	0	0	17	0	0
17	49016858	.	C	T	15	9	24	0	0	24	0	0
17	49018224	.	G	A	1	7	8	0	13	21	0	0
17	49018508	.	C	G	8	19	27	0	0	27	0	0
17	49018575	.	G	A	14	8	22	0	0	22	0	0
17	49019177	.	C	A	25	17	42	0	1	43	0	0
17	49102263	.	G	T	1	2	3	0	0	3	0	0
17	49103133	.	A	G	2	3	5	0	0	5	0	0
17	49103268	.	C	T	3	6	9	0	0	9	0	0
17	49105252	.	C	A	3	3	6	0	0	6	0	0
17	49208633	.	A	G	4	1	5	0	1	6	0	0
17	49275618	.	T	G	2	4	6	0	0	6	0	0
17	49296634	.	T	C	2	2	4	0	0	4	0	0
17	49300314	.	G	A	5	2	7	0	0	7	0	0
17	49300392	.	C	T	4	2	6	0	0	6	0	0
17	49306256	.	C	T	9	4	13	0	1	14	0	0
17	49306334	.	G	A	2	1	3	0	9	12	0	0
17	49306341	.	T	C	9	2	11	0	1	12	0	0
17	49329246	.	G	A	1	3	4	0	0	4	0	0
17	49416327	.	T	C	8	7	15	0	2	17	0	0
17	49416396	.	G	T	15	5	20	0	1	21	0	0
17	49418225	.	G	A	12	7	19	0	1	20	0	0
17	49418765	.	G	A	5	8	13	0	0	13	0	0
17	49418792	.	C	T	5	6	11	0	1	12	0	0
17	49418940	.	T	A	2	2	4	0	0	4	0	0
17	49419182	.	T	A	5	4	9	0	0	9	0	0
17	49419188	.	C	T	6	4	10	0	0	10	0	0
17	49419491	.	A	G	1	2	3	0	1	4	0	0
17	49419590	.	T	C	3	5	8	0	1	9	0	0
17	49419761	.	G	T	4	6	10	0	0	10	0	0
17	49419887	.	C	T	1	6	7	0	9	16	0	0
17	49419954	.	C	T	4	5	9	0	2	11	0	0
17	49420049	.	T	G	8	7	15	0	1	16	0	0
17	49420454	.	A	T	6	2	8	0	1	9	0	0
17	49420565	.	A	C	8	0	8	0	4	12	0	0
17	49420655	.	A	C	6	5	11	0	0	11	0	0
17	49420677	.	G	A	7	6	13	0	0	13	0	0
17	49420727	.	C	A	1	8	9	0	6	15	0	0
17	49420954	.	G	T	6	3	9	0	0	9	0	0
17	49421117	.	A	G	3	8	11	0	0	11	0	0
17	49425030	.	G	A	5	4	9	0	0	9	0	0
17	49429844	.	T	C	4	5	9	0	0	9	0	0
17	49481635	.	C	G	7	10	17	0	0	17	0	0
17	49481638	.	T	C	10	0	10	0	5	15	0	0
17	49485275	.	A	C	6	5	11	0	0	11	0	0
17	49503569	.	G	T	9	7	16	0	0	16	0	0
17	49503632	.	G	A	6	13	19	0	0	19	0	0
17	49503647	.	C	T	6	9	15	0	0	15	0	0
17	49503940	.	G	A	9	7	16	0	0	16	0	0
17	49504033	.	A	T	7	5	12	0	0	12	0	0
17	49507155	.	C	T	9	4	13	0	0	13	0	0
17	49509606	.	G	A	9	7	16	0	2	18	0	0
17	49518977	.	C	T	11	5	16	0	0	16	0	0
17	49519061	.	C	T	7	7	14	0	0	14	0	0
17	49519070	.	T	A	8	5	13	0	1	14	0	0
17	49522248	.	G	A	7	10	17	0	3	20	0	0
17	49526584	.	T	C	12	8	20	0	1	21	0	0
17	49526839	.	A	G	2	3	5	0	0	5	0	0
17	49527099	.	T	G	3	5	8	0	1	9	0	0
17	49527115	.	T	C	6	2	8	0	1	9	0	0
17	49527357	.	A	T	2	7	9	0	0	9	0	0
17	49528082	.	C	G	10	8	18	0	1	19	0	0
17	49528291	.	A	G	9	0	9	0	11	20	0	0
17	49631878	.	A	T	4	3	7	0	0	7	0	0
17	49632267	.	A	C	5	0	5	0	6	11	0	0
17	49632492	.	A	G	9	3	12	0	0	12	0	0
17	49635749	.	C	G	6	10	16	1	0	17	0	0
17	49635881	.	A	T	5	2	7	0	0	7	0	0
17	49636810	.	T	C	3	0	3	0	6	9	0	0
17	49636959	.	T	C	4	9	13	0	0	13	0	0
17	49637284	.	C	G	3	2	5	0	0	5	0	0
17	49638746	.	T	G	1	4	5	0	0	5	0	0
17	49640903	.	A	G	6	2	8	0	0	8	0	0
17	49641629	.	C	T	5	7	12	0	0	12	0	0
17	49642030	.	G	T	1	2	3	0	0	3	0	0
17	49642040	.	G	T	1	2	3	0	0	3	0	0
17	49983202	.	A	T	9	6	15	0	0	15	0	0
17	49983273	.	C	T	16	18	34	0	2	36	0	0
17	49987618	.	A	T	18	36	54	5	1	60	0	0
17	49992629	.	G	A	27	35	62	0	1	63	0	0
17	49998167	.	C	T	20	16	36	0	0	36	0	0
17	49998221	.	G	A	24	16	40	0	0	40	0	0
17	49998591	.	T	G	8	5	13	0	0	13	0	0
17	49998804	.	C	A	27	23	50	0	1	51	0	0
17	49998995	.	G	C	26	0	26	0	16	42	0	0
17	49999037	.	G	T	21	23	44	0	1	45	0	0
17	50002381	.	A	G	28	25	53	0	1	54	0	0
17	50010011	.	A	G	24	18	42	0	1	43	0	0
17	50010024	.	G	C	30	16	46	0	0	46	0	0
17	50076557	.	G	A	5	2	7	0	0	7	0	0
17	50084344	.	T	C	11	7	18	0	1	19	0	0
17	50090049	.	G	T	7	5	12	0	2	14	0	0
17	50097129	.	G	A	2	7	9	0	2	11	0	0
17	50097168	.	G	A	6	3	9	0	1	10	0	0
17	50107391	.	G	A	4	4	8	0	0	8	0	0
17	50110192	.	C	A	6	6	12	0	0	12	0	0
17	50110255	.	G	C	3	4	7	0	0	7	0	0
17	50110304	.	T	A	5	6	11	0	0	11	0	0
17	50110613	.	C	T	4	2	6	0	0	6	0	0
17	50110636	.	C	A	4	2	6	0	0	6	0	0
17	50111397	.	A	G	9	8	17	0	1	18	0	0
17	50111406	.	G	A	12	7	19	0	0	19	0	0
17	50111573	.	C	T	13	6	19	0	1	20	0	0
17	50111680	.	A	T	10	5	15	1	0	16	0	0
17	50111727	.	C	T	10	3	13	0	1	14	0	0
17	50111746	.	A	T	4	6	10	0	0	10	0	0
17	50112112	.	T	G	5	2	7	0	0	7	0	0
17	50112145	.	A	C	13	2	15	0	2	17	0	0
17	50112153	.	T	C	14	2	16	0	1	17	0	0
17	50113141	.	G	A	4	3	7	0	0	7	0	0
17	50113336	.	C	T	6	5	11	0	0	11	0	0
17	50127721	.	A	T	9	5	14	0	1	15	0	0
17	50141766	.	T	A	12	8	20	0	1	21	0	0
17	50145364	.	G	T	11	11	22	0	2	24	0	0
17	50171937	.	T	C	21	12	33	0	1	34	0	0
17	50176061	.	G	A	14	13	27	0	0	27	0	0
17	50176139	.	T	C	14	16	30	0	3	33	0	0
17	50176519	.	C	A	18	5	23	0	0	23	0	0
17	50178553	.	G	C	8	17	25	0	2	27	0	0
17	50180672	.	C	T	15	13	28	1	1	30	0	0
17	50185659	.	C	A	12	19	31	0	1	32	0	0
17	50185665	.	T	A	24	10	34	0	1	35	0	0
17	50185831	.	C	A	9	15	24	0	0	24	0	0
17	50185930	.	T	C	16	12	28	0	1	29	0	0
17	50186011	.	G	A	1	9	10	0	13	23	0	0
17	50186041	.	T	A	11	3	14	0	0	14	0	0
17	50186097	.	G	A	9	5	14	0	1	15	0	0
17	50219716	.	C	G	2	6	8	0	0	8	0	0
17	50229337	.	A	G	16	14	30	0	1	31	0	0
17	50229409	.	T	C	19	7	26	0	0	26	0	0
17	50233858	.	C	A	1	12	13	0	18	31	0	0
17	50233869	.	G	T	12	21	33	0	1	34	0	0
17	50245400	.	G	A	2	4	6	0	0	6	0	0
17	50245673	.	T	C	24	12	36	0	2	38	0	0
17	50245715	.	C	G	16	21	37	0	1	38	0	0
17	50247886	.	T	C	15	0	15	0	21	36	0	0
17	50272729	.	G	A	8	8	16	0	0	16	0	0
17	50278884	.	C	A	7	5	12	0	1	13	0	0
17	50284899	.	T	A	15	15	30	0	0	30	0	0
17	50284935	.	A	T	16	14	30	0	3	33	0	0
17	50285009	.	A	T	5	7	12	0	0	12	0	0
17	50285221	.	A	T	4	8	12	0	0	12	0	0
17	50285401	.	A	C	12	1	13	0	0	13	0	0
17	50285402	.	A	C	12	0	12	0	0	13	1	0
17	50394582	.	G	A	3	2	5	0	0	5	0	0
17	50689204	.	A	G	10	8	18	0	1	19	0	0
17	50840514	.	A	G	2	2	4	0	1	5	0	0
17	51231708	.	T	C	5	2	7	0	0	7	0	0
17	51231756	.	T	C	6	3	9	0	0	9	0	0
17	51231811	.	T	C	5	5	10	0	0	10	0	0
17	51231818	.	T	C	7	1	8	0	1	9	0	0
17	51231980	.	T	C	7	8	15	0	0	15	0	0
17	51232193	.	T	C	2	1	3	0	1	4	0	0
17	51232296	.	T	C	3	0	3	0	4	7	0	0
17	51232429	.	T	C	3	2	5	0	0	5	0	0
17	51241185	.	G	A	6	5	11	0	0	11	0	0
17	51241203	.	C	T	10	6	16	0	0	16	0	0
17	51253919	.	T	C	12	10	22	0	0	22	0	0
17	51257053	.	G	A	12	6	18	0	1	19	0	0
17	51257376	.	C	T	2	16	18	0	10	28	0	0
17	51260322	.	T	G	8	7	15	0	0	15	0	0
17	51260362	.	G	C	10	5	15	0	0	15	0	0
17	51276021	.	G	A	8	6	14	0	5	19	0	0
17	51301246	.	T	C	11	13	24	0	1	25	0	0
17	51303130	.	G	A	2	16	18	0	12	30	0	0
17	51305422	.	A	T	10	8	18	0	0	18	0	0
17	51307706	.	G	A	5	11	16	1	0	17	0	0
17	51307871	.	A	G	6	0	6	0	7	13	0	0
17	51307979	.	G	A	0	1	1	0	2	3	0	0
17	51603994	.	A	G	2	2	4	0	0	4	0	0
17	51604000	.	G	A	2	1	3	0	0	3	0	0
17	51607193	.	T	C	2	2	4	0	0	4	0	0
17	51607196	.	A	G	2	2	4	0	0	4	0	0
17	51682501	.	T	A	2	3	5	0	0	5	0	0
17	51693914	.	T	G	6	4	10	0	0	10	0	0
17	51708541	.	G	A	0	4	4	0	1	5	0	0
17	51711040	.	A	G	3	4	7	0	0	7	0	0
17	51711184	.	C	A	1	6	7	0	0	7	0	0
17	51711194	.	C	A	7	3	10	0	0	10	0	0
17	51711268	.	G	A	1	3	4	0	7	11	0	0
17	51720038	.	A	C	4	4	8	0	0	8	0	0
17	51720064	.	G	C	5	3	8	0	0	8	0	0
17	51720176	.	C	T	6	4	10	0	2	12	0	0
17	51720177	.	A	T	8	4	12	0	0	12	0	0
17	51743916	.	A	G	7	3	10	0	0	10	0	0
17	51749051	.	G	T	4	7	11	0	1	12	0	0
17	51749545	.	G	T	0	17	17	0	10	27	0	0
17	51752790	.	A	G	7	12	19	0	1	20	0	0
17	51753138	.	T	G	14	16	30	0	0	30	0	0
17	51757010	.	G	A	13	9	22	0	1	23	0	0
17	51757216	.	A	T	10	4	14	0	0	14	0	0
17	51757218	.	T	C	10	4	14	0	0	14	0	0
17	51757380	.	T	G	4	3	7	0	0	7	0	0
17	51776636	.	T	G	5	5	10	0	0	10	0	0
17	51777099	.	C	T	5	3	8	0	0	8	0	0
17	51780543	.	G	A	9	3	12	0	0	12	0	0
17	51780881	.	T	A	2	3	5	0	0	5	0	0
17	51780896	.	C	G	2	3	5	0	0	5	0	0
17	51784216	.	A	G	4	2	6	0	0	6	0	0
17	51789032	.	G	A	6	5	11	0	0	11	0	0
17	51789038	.	T	C	5	5	10	0	0	10	0	0
17	51789069	.	T	C	4	6	10	0	0	10	0	0
17	51789079	.	T	G	4	0	4	0	5	9	0	0
17	51789108	.	A	G	2	1	3	0	4	7	0	0
17	51789314	.	T	A	1	4	5	0	0	5	0	0
17	51789426	.	G	T	1	3	4	0	0	4	0	0
17	51796888	.	G	A	3	2	5	0	0	5	0	0
17	51797004	.	G	A	5	6	11	0	0	11	0	0
17	51797015	.	T	C	5	0	5	0	7	12	0	0
17	51797145	.	A	G	5	3	8	0	0	8	0	0
17	51797333	.	A	G	4	6	10	0	0	10	0	0
17	51797782	.	C	T	9	11	20	0	2	22	0	0
17	51797788	.	T	A	8	10	18	0	2	20	0	0
17	51797863	.	G	A	14	7	21	0	0	21	0	0
17	51804037	.	G	A	3	9	12	0	0	12	0	0
17	51805764	.	T	G	4	12	16	0	0	16	0	0
17	51805976	.	G	A	6	6	12	0	1	13	0	0
17	51806043	.	C	T	1	4	5	0	7	12	0	0
17	51807494	.	G	A	8	3	11	0	0	11	0	0
17	51807539	.	T	A	4	5	9	0	0	9	0	0
17	51807545	.	G	A	5	6	11	0	0	11	0	0
17	51808019	.	A	C	6	5	11	0	0	11	0	0
17	51815206	.	C	G	6	5	11	0	1	12	0	0
17	51823152	.	A	G	8	7	15	0	0	15	0	0
17	51823418	.	T	C	5	7	12	4	1	17	0	0
17	51823419	.	T	C	8	5	13	3	0	16	0	0
17	51823462	.	T	C	14	6	20	2	1	23	0	0
17	51823568	.	G	A	14	4	18	1	1	20	0	0
17	51823696	.	T	A	8	4	12	0	3	15	0	0
17	51823841	.	C	A	4	8	12	2	0	14	0	0
17	51823857	.	T	C	6	4	10	2	1	13	0	0
17	51824046	.	C	T	8	4	12	0	0	12	0	0
17	51824145	.	T	C	5	5	10	4	0	14	0	0
17	51824166	.	T	C	6	5	11	1	0	12	0	0
17	51824306	.	T	C	6	4	10	0	0	10	0	0
17	51824790	.	T	C	4	6	10	1	0	12	1	0
17	51825086	.	A	G	6	4	10	0	2	12	0	0
17	51825094	.	G	A	6	5	11	0	0	11	0	0
17	51825138	.	C	T	0	11	11	0	7	18	0	0
17	51825161	.	T	C	5	10	15	0	0	15	0	0
17	51825205	.	T	G	5	9	14	1	2	17	0	0
17	51825225	.	T	C	6	9	15	1	0	16	0	0
17	51825421	.	T	G	5	6	11	0	0	11	0	0
17	51825455	.	A	G	10	8	18	0	0	18	0	0
17	51825576	.	A	C	12	0	12	0	5	18	1	0
17	51825813	.	T	A	11	8	19	0	0	19	0	0
17	51825969	.	A	T	12	5	17	0	4	21	0	0
17	51826025	.	G	T	14	4	18	0	6	24	0	0
17	51826035	.	C	T	13	4	17	0	4	21	0	0
17	51826062	.	G	T	13	10	23	0	3	26	0	0
17	51826088	.	A	G	11	13	24	0	1	25	0	0
17	51826149	.	A	C	10	0	10	0	8	18	0	0
17	51826172	.	T	C	9	0	9	0	9	18	0	0
17	51826236	.	T	C	10	14	24	0	0	24	0	0
17	51832999	.	G	A	7	6	13	0	1	14	0	0
17	51893050	.	T	G	5	6	11	0	0	11	0	0
17	52006019	.	T	A	4	2	6	0	0	6	0	0
17	52036940	.	G	A	1	1	2	0	5	7	0	0
17	52059149	.	T	C	3	0	3	0	5	8	0	0
17	52063114	.	G	T	1	2	3	0	0	3	0	0
17	52067243	.	G	A	1	3	4	0	0	4	0	0
17	52076125	.	A	G	1	5	6	0	0	6	0	0
17	52300202	.	T	G	1	3	4	0	0	4	0	0
17	52385529	.	A	G	2	4	6	0	0	6	0	0
17	52528662	.	G	C	24	20	44	0	0	44	0	0
17	52533036	.	C	G	17	15	32	0	1	33	0	0
17	52533073	.	C	T	18	13	31	0	2	33	0	0
17	52534241	.	G	A	2	17	19	0	23	42	0	0
17	52534343	.	G	A	21	15	36	0	3	39	0	0
17	52541342	.	G	A	1	14	15	0	21	36	0	0
17	52553107	.	C	A	15	21	36	0	4	40	0	0
17	52553141	.	T	C	25	12	37	0	0	37	0	0
17	52553270	.	G	A	12	20	32	0	1	33	0	0
17	52559979	.	T	C	1	4	5	0	0	5	0	0
17	52559984	.	T	C	2	3	5	0	0	5	0	0
17	52560036	.	G	A	4	10	14	0	0	14	0	0
17	52560050	.	G	C	3	8	11	0	1	12	0	0
17	52565832	.	T	G	9	5	14	0	0	14	0	0
17	52565833	.	C	T	2	5	7	0	7	14	0	0
17	52566100	.	C	T	1	7	8	0	9	17	0	0
17	52566423	.	T	C	9	0	9	0	6	15	0	0
17	52566925	.	A	G	2	8	10	0	0	10	0	0
17	52568040	.	A	C	8	0	8	0	6	14	0	0
17	52568112	.	C	G	8	5	13	0	0	13	0	0
17	52570140	.	A	C	3	0	3	0	3	6	0	0
17	52571312	.	G	A	4	5	9	0	0	9	0	0
17	52574059	.	G	A	2	2	4	0	0	4	0	0
17	52576250	.	G	A	4	4	8	0	0	8	0	0
17	52576316	.	G	A	7	6	13	0	1	14	0	0
17	52576380	.	A	G	8	6	14	0	0	14	0	0
17	52576394	.	C	T	8	7	15	0	0	15	0	0
17	52578489	.	A	G	7	8	15	0	1	16	0	0
17	52578491	.	A	G	6	9	15	0	1	16	0	0
17	52615884	.	G	A	0	3	3	0	2	5	0	0
17	52615940	.	T	C	2	3	5	0	0	5	0	0
17	52624619	.	C	G	1	6	7	0	0	7	0	0
17	52624707	.	T	C	3	5	8	0	0	8	0	0
17	52624758	.	A	G	1	4	5	0	0	5	0	0
17	52624926	.	T	G	1	4	5	0	1	6	0	0
17	52626972	.	A	T	2	5	7	0	0	7	0	0
17	52630641	.	A	G	3	4	7	0	0	7	0	0
17	52630752	.	A	C	2	0	2	0	5	7	0	0
17	52632139	.	A	G	6	8	14	0	0	14	0	0
17	52632151	.	G	C	5	9	14	0	0	14	0	0
17	52634553	.	G	C	6	13	19	0	1	20	0	0
17	52635258	.	A	G	11	5	16	0	1	17	0	0
17	52635261	.	C	T	3	4	7	0	10	17	0	0
17	52635954	.	C	T	1	8	9	0	5	14	0	0
17	52636296	.	T	C	10	0	10	0	6	16	0	0
17	52636829	.	C	T	15	7	22	0	1	23	0	0
17	52636831	.	C	G	15	7	22	0	1	23	0	0
17	52636922	.	C	T	1	2	3	0	0	3	0	0
17	52639729	.	C	T	3	12	15	0	11	26	0	0
17	52640311	.	G	A	24	18	42	0	1	43	0	0
17	52640385	.	G	C	22	20	42	0	1	43	0	0
17	52640419	.	C	T	1	22	23	0	16	39	0	0
17	52640540	.	C	T	2	19	21	0	20	41	0	0
17	52640645	.	T	G	15	18	33	0	1	34	0	0
17	52641091	.	A	T	17	14	31	0	2	33	0	0
17	52641571	.	C	T	20	10	30	0	2	32	0	0
17	52641724	.	A	C	19	7	26	0	1	27	0	0
17	52641751	.	G	C	10	0	10	0	18	28	0	0
17	52650878	.	G	C	11	26	37	0	1	38	0	0
17	52856614	.	T	C	21	28	49	0	5	54	0	0
17	52920792	.	C	T	35	14	49	4	2	55	0	0
17	52940710	.	T	C	0	2	2	0	1	3	0	0
17	52987571	.	C	T	4	2	6	0	0	6	0	0
17	52991249	.	C	T	2	2	4	0	0	4	0	0
17	53156722	.	A	C	4	2	6	0	1	7	0	0
17	53190761	.	C	G	4	2	6	0	0	6	0	0
17	53197042	.	G	T	1	2	3	0	0	3	0	0
17	53250861	.	C	T	13	4	17	0	1	18	0	0
17	53250909	.	G	A	0	7	7	0	9	16	0	0
17	53251101	.	A	G	10	5	15	0	1	16	0	0
17	53255614	.	T	A	1	8	9	0	0	9	0	0
17	53259471	.	C	G	6	0	6	0	5	11	0	0
17	53298000	.	C	G	11	0	11	0	5	16	0	0
17	53298033	.	C	T	12	6	18	0	2	20	0	0
17	53298051	.	G	A	4	8	12	0	0	12	0	0
17	53298472	.	A	G	4	4	8	1	0	9	0	0
17	53298514	.	C	G	6	4	10	0	0	10	0	0
17	53298616	.	G	A	3	3	6	0	0	6	0	0
17	53299220	.	G	A	1	7	8	0	5	13	0	0
17	53299485	.	T	C	8	5	13	0	1	14	0	0
17	53301275	.	A	G	7	0	7	0	5	12	0	0
17	53301281	.	C	T	6	7	13	0	1	14	0	0
17	53302527	.	T	C	5	4	9	0	0	9	0	0
17	53303258	.	G	A	1	7	8	0	4	12	0	0
17	53303980	.	G	C	5	10	15	0	1	16	0	0
17	53304100	.	A	G	7	2	9	0	0	9	0	0
17	53304566	.	G	A	4	4	8	0	0	8	0	0
17	53304635	.	A	T	6	4	10	2	1	13	0	0
17	53307346	.	G	A	7	5	12	1	0	13	0	0
17	53307580	.	C	G	15	6	21	0	0	21	0	0
17	53308737	.	T	C	11	13	24	0	2	26	0	0
17	53308820	.	C	T	0	2	2	0	3	5	0	0
17	53315422	.	C	T	5	3	8	0	0	8	0	0
17	53315604	.	G	A	8	8	16	0	1	17	0	0
17	53315750	.	C	G	5	3	8	0	0	8	0	0
17	53317065	.	C	T	5	3	8	0	2	10	0	0
17	53317123	.	T	C	4	5	9	0	0	9	0	0
17	53317175	.	G	A	1	8	9	0	9	18	0	0
17	53346549	.	G	A	5	2	7	0	0	7	0	0
17	53346600	.	G	A	3	4	7	0	0	7	0	0
17	53346648	.	C	A	3	2	5	0	0	5	0	0
17	53350055	.	C	A	2	2	4	0	0	4	0	0
17	53351417	.	C	T	1	2	3	0	1	4	0	0
17	53364109	.	T	C	1	3	4	1	0	5	0	0
17	53364111	.	T	C	1	3	4	1	0	5	0	0
17	53364181	.	C	T	2	9	11	0	0	11	0	0
17	53393165	.	G	A	17	17	34	0	2	36	0	0
18	1689	.	A	C	7	15	22	0	1	23	0	0
18	1983	.	T	C	12	10	22	0	0	22	0	0
18	2725	.	G	A	22	7	29	0	1	30	0	0
18	11295	.	A	G	6	4	10	0	2	12	0	0
18	17639	.	G	A	19	9	28	0	1	29	0	0
18	17786	.	G	A	16	8	24	0	1	25	0	0
18	17795	.	G	A	16	8	24	0	0	24	0	0
18	18606	.	T	A	8	7	15	0	0	15	0	0
18	18731	.	A	G	13	4	17	0	1	18	0	0
18	22746	.	A	G	15	10	25	0	0	25	0	0
18	22891	.	G	A	11	6	17	0	1	18	0	0
18	54387	.	C	G	1	5	6	0	0	6	0	0
18	54502	.	C	T	0	3	3	0	1	4	0	0
18	54600	.	C	T	1	3	4	0	0	4	0	0
18	73714	.	C	G	9	6	15	0	0	15	0	0
18	73740	.	A	C	9	3	12	0	2	14	0	0
18	74050	.	G	A	7	2	9	0	1	10	0	0
18	74788	.	C	T	2	5	7	0	9	16	0	0
18	74866	.	C	T	9	7	16	0	0	16	0	0
18	81898	.	C	T	5	3	8	0	0	8	0	0
18	81944	.	A	T	4	4	8	1	2	11	0	0
18	82705	.	C	T	9	12	21	0	1	22	0	0
18	95776	.	T	A	10	3	13	0	0	13	0	0
18	97588	.	C	T	3	14	17	0	1	18	0	0
18	97762	.	G	A	6	8	14	0	2	16	0	0
18	97789	.	C	T	9	4	13	0	1	14	0	0
18	98622	.	G	A	7	12	19	0	3	22	0	0
18	100483	.	A	G	10	2	12	2	20	34	0	0
18	100944	.	G	A	2	20	22	0	16	38	0	0
18	102350	.	T	G	16	0	16	0	17	33	0	0
18	102353	.	A	G	17	14	31	0	1	32	0	0
18	103101	.	G	C	2	8	10	0	11	21	0	0
18	104405	.	G	A	1	16	17	0	7	24	0	0
18	106814	.	T	C	12	11	23	0	0	23	0	0
18	107015	.	T	C	9	16	25	0	2	27	0	0
18	107135	.	A	T	14	13	27	0	0	27	0	0
18	107345	.	A	G	11	0	11	1	22	34	0	0
18	114089	.	A	C	9	6	15	0	0	15	0	0
18	114502	.	T	C	4	0	4	0	9	13	0	0
18	114713	.	A	T	11	16	27	0	0	27	0	0
18	117788	.	G	A	15	15	30	0	1	31	0	0
18	118729	.	G	A	11	9	20	0	0	20	0	0
18	118912	.	G	A	6	12	18	0	1	19	0	0
18	123917	.	T	C	5	6	11	0	1	12	0	0
18	127438	.	G	A	6	8	14	0	0	14	0	0
18	127444	.	A	G	6	8	14	0	1	15	0	0
18	127678	.	A	G	6	7	13	0	0	13	0	0
18	131065	.	T	C	8	0	8	0	6	14	0	0
18	131092	.	C	T	0	8	8	0	9	17	0	0
18	135852	.	T	A	3	5	8	0	1	9	0	0
18	137781	.	A	G	4	4	8	0	0	8	0	0
18	144447	.	G	A	5	8	13	0	2	15	0	0
18	148197	.	A	G	4	2	6	0	0	6	0	0
18	148200	.	A	G	4	2	6	0	0	6	0	0
18	173660	.	C	T	8	9	17	0	0	17	0	0
18	173694	.	C	T	9	9	18	0	1	19	0	0
18	173903	.	C	A	12	12	24	0	0	24	0	0
18	184917	.	T	C	14	8	22	0	0	22	0	0
18	193689	.	A	C	10	8	18	0	0	19	1	0
18	193982	.	C	T	15	12	27	0	3	30	0	0
18	194006	.	A	G	11	2	13	0	17	30	0	0
18	194078	.	C	T	16	16	32	0	0	32	0	0
18	194162	.	G	C	2	19	21	0	18	39	0	0
18	194318	.	A	G	7	12	19	0	2	21	0	0
18	194460	.	C	G	9	8	17	0	0	17	0	0
18	194464	.	C	T	8	10	18	0	0	18	0	0
18	194799	.	T	C	3	4	7	0	1	8	0	0
18	204678	.	A	C	5	7	12	0	1	13	0	0
18	204742	.	G	A	13	8	21	1	0	22	0	0
18	204828	.	G	A	15	17	32	1	1	34	0	0
18	204866	.	T	A	14	19	33	0	8	41	0	0
18	204980	.	C	T	26	17	43	0	3	46	0	0
18	204982	.	G	A	24	19	43	0	2	45	0	0
18	205095	.	C	T	2	21	23	0	22	45	0	0
18	205105	.	A	G	22	20	42	0	2	44	0	0
18	205152	.	G	A	28	11	39	0	2	41	0	0
18	205177	.	G	C	34	7	41	0	0	41	0	0
18	207172	.	T	C	14	10	24	0	0	24	0	0
18	207184	.	G	A	11	10	21	0	4	25	0	0
18	207314	.	T	A	13	6	19	0	0	19	0	0
18	209114	.	G	A	13	16	29	0	1	30	0	0
18	209118	.	A	G	17	17	34	0	0	34	0	0
18	209321	.	T	G	23	13	36	0	1	37	0	0
18	209382	.	A	G	18	15	33	0	0	33	0	0
18	210385	.	T	A	20	20	40	0	0	40	0	0
18	210899	.	T	A	3	6	9	0	1	10	0	0
18	211186	.	T	A	17	24	41	0	1	42	0	0
18	211304	.	T	C	18	0	18	0	10	28	0	0
18	211346	.	C	T	1	7	8	0	14	22	0	0
18	211380	.	G	A	13	12	25	0	0	25	0	0
18	211399	.	T	C	14	17	31	0	2	33	0	0
18	211438	.	T	A	15	13	28	1	0	29	0	0
18	211469	.	C	A	20	8	28	1	0	29	0	0
18	211483	.	A	T	20	9	29	1	3	33	0	0
18	211605	.	A	G	24	9	33	1	3	37	0	0
18	211610	.	T	C	23	1	24	1	11	36	0	0
18	211812	.	T	A	13	8	21	0	0	21	0	0
18	212305	.	A	G	21	23	44	0	0	44	0	0
18	214688	.	A	G	12	17	29	0	2	31	0	0
18	214717	.	T	C	14	16	30	0	1	31	0	0
18	216775	.	G	A	13	11	24	0	1	25	0	0
18	216779	.	G	A	13	11	24	0	1	25	0	0
18	220144	.	G	A	17	12	29	0	3	32	0	0
18	222448	.	T	C	11	0	11	1	17	29	0	0
18	334298	.	T	C	3	7	10	0	0	10	0	0
18	334361	.	T	C	3	3	6	0	0	6	0	0
18	336586	.	T	C	10	7	17	0	2	19	0	0
18	493387	.	C	T	1	2	3	0	1	4	0	0
18	493779	.	T	C	3	0	3	0	3	6	0	0
18	502683	.	G	A	1	3	4	0	1	5	0	0
18	507687	.	G	A	0	6	6	0	4	10	0	0
18	573798	.	C	T	2	5	7	0	0	7	0	0
18	577515	.	G	A	1	4	5	0	5	10	0	0
18	580961	.	G	A	1	10	11	0	7	18	0	0
18	586067	.	A	G	4	0	4	0	6	10	0	0
18	597148	.	C	T	2	4	6	0	0	6	0	0
18	600337	.	C	T	4	6	10	0	1	11	0	0
18	609365	.	A	G	3	2	5	0	0	5	0	0
18	609877	.	G	A	8	5	13	0	0	13	0	0
18	609935	.	G	A	0	11	11	0	7	18	0	0
18	610126	.	A	T	10	13	23	0	0	23	0	0
18	610148	.	A	T	9	5	14	0	1	15	0	0
18	610291	.	T	C	6	7	13	0	0	13	0	0
18	610631	.	T	A	6	3	9	0	0	9	0	0
18	610721	.	A	C	3	4	7	0	0	7	0	0
18	642918	.	T	C	15	11	26	2	3	31	0	0
18	643164	.	C	T	22	8	30	0	1	31	0	0
18	643517	.	C	T	14	11	25	0	0	25	0	0
18	660616	.	A	G	3	2	5	0	0	5	0	0
18	660688	.	T	C	9	8	17	0	1	18	0	0
18	660752	.	G	C	0	3	3	0	10	13	0	0
18	660846	.	C	A	4	2	6	0	0	6	0	0
18	789974	.	T	A	10	12	22	0	0	23	1	0
18	790247	.	T	C	8	14	22	0	0	22	0	0
18	790301	.	T	A	10	12	22	0	1	23	0	0
18	790451	.	T	G	15	0	15	0	14	29	0	0
18	790962	.	T	G	12	11	23	0	2	25	0	0
18	791069	.	A	G	10	1	11	0	7	18	0	0
18	791076	.	G	C	11	6	17	0	0	17	0	0
18	791137	.	T	A	11	9	20	3	0	23	0	0
18	791171	.	G	C	10	10	20	0	0	20	0	0
18	791246	.	G	A	7	6	13	0	1	14	0	0
18	791348	.	T	A	1	5	6	0	0	6	0	0
18	791350	.	T	A	1	4	5	0	1	6	0	0
18	791449	.	T	G	5	3	8	0	0	8	0	0
18	791582	.	G	A	0	6	6	0	3	9	0	0
18	809012	.	G	T	21	26	47	0	0	47	0	0
18	824994	.	G	A	4	3	7	0	0	7	0	0
18	824998	.	C	T	4	3	7	0	1	8	0	0
18	825448	.	T	A	6	2	8	1	0	9	0	0
18	825457	.	T	C	4	1	5	1	1	7	0	0
18	826116	.	G	A	3	4	7	0	2	9	0	0
18	826190	.	A	T	5	5	10	0	0	10	0	0
18	826488	.	A	T	4	2	6	0	0	6	0	0
18	826497	.	T	C	5	2	7	0	0	7	0	0
18	826574	.	C	T	4	5	9	0	0	9	0	0
18	826745	.	G	A	5	4	9	0	0	9	0	0
18	826749	.	T	A	4	3	7	0	0	7	0	0
18	888440	.	G	A	16	10	26	0	0	26	0	0
18	891534	.	C	A	13	15	28	0	2	30	0	0
18	891586	.	G	A	20	10	30	0	0	30	0	0
18	911036	.	C	A	6	12	18	0	0	18	0	0
18	911076	.	A	G	22	1	23	0	27	50	0	0
18	925088	.	C	T	26	46	72	0	3	75	0	0
18	925100	.	A	C	26	41	67	0	7	74	0	0
18	933299	.	G	A	30	33	63	0	2	65	0	0
18	936728	.	C	T	41	32	73	0	4	77	0	0
18	939430	.	C	T	28	30	58	0	1	59	0	0
18	951004	.	A	T	34	40	74	4	2	80	0	0
18	951005	.	T	C	34	39	73	4	4	81	0	0
18	964525	.	G	A	1	3	4	0	0	4	0	0
18	1004947	.	G	A	2	3	5	0	0	5	0	0
18	1151536	.	C	A	1	2	3	0	0	3	0	0
18	1154270	.	A	G	4	2	6	0	0	6	0	0
18	1154278	.	A	G	4	1	5	0	0	5	0	0
18	1161085	.	A	G	11	5	16	0	1	17	0	0
18	1161750	.	A	G	35	26	61	0	3	64	0	0
18	1173819	.	G	A	30	16	46	0	0	46	0	0
18	1173856	.	G	A	33	22	55	0	0	55	0	0
18	1173898	.	A	G	34	20	54	0	0	54	0	0
18	1249955	.	T	A	1	2	3	0	0	3	0	0
18	1292100	.	C	T	0	4	4	0	6	10	0	0
18	1292164	.	G	A	9	5	14	0	1	15	0	0
18	1292668	.	T	C	8	0	8	0	11	19	0	0
18	1293182	.	G	A	8	4	12	0	0	12	0	0
18	1363189	.	G	A	2	5	7	0	0	7	0	0
18	1391653	.	A	G	2	7	9	0	0	9	0	0
18	1391674	.	T	C	5	0	5	0	6	11	0	0
18	2169254	.	A	T	2	3	5	0	0	5	0	0
18	2169260	.	C	A	2	2	4	0	0	4	0	0
18	2173327	.	A	C	3	2	5	0	0	5	0	0
18	2173415	.	G	A	1	3	4	0	2	6	0	0
18	2174727	.	C	G	2	0	2	0	2	4	0	0
18	2190731	.	G	A	3	7	10	0	3	13	0	0
18	2197638	.	A	C	10	11	21	0	1	22	0	0
18	2205302	.	T	A	7	4	11	0	0	11	0	0
18	2208642	.	A	C	6	6	12	0	2	14	0	0
18	2210570	.	C	T	5	6	11	0	0	11	0	0
18	2211091	.	T	C	5	7	12	0	0	12	0	0
18	2215557	.	C	T	3	2	5	0	0	5	0	0
18	2215642	.	A	G	3	6	9	0	0	9	0	0
18	2225632	.	C	T	11	13	24	2	0	26	0	0
18	2225661	.	C	T	15	13	28	2	2	32	0	0
18	2225947	.	T	C	3	3	6	0	0	6	0	0
18	2377645	.	T	C	15	1	16	0	10	26	0	0
18	2378462	.	A	T	7	5	12	0	1	13	0	0
18	2378495	.	T	A	6	4	10	0	1	11	0	0
18	2378510	.	C	A	5	7	12	0	0	12	0	0
18	2378687	.	A	C	10	8	18	0	1	19	0	0
18	2378713	.	T	G	14	10	24	0	1	25	0	0
18	2378722	.	C	T	0	12	12	0	14	26	0	0
18	2378801	.	A	G	4	6	10	0	0	10	0	0
18	2378803	.	G	A	1	9	10	0	0	10	0	0
18	2379073	.	G	A	2	4	6	0	2	8	0	0
18	2408681	.	C	A	10	21	31	0	4	35	0	0
18	2408886	.	G	A	15	10	25	0	1	26	0	0
18	2412660	.	T	C	5	10	15	0	0	15	0	0
18	2412726	.	G	C	14	16	30	0	0	30	0	0
18	2441690	.	T	C	5	4	9	0	0	9	0	0
18	2443977	.	A	T	5	5	10	0	0	10	0	0
18	2443998	.	C	T	5	5	10	0	0	10	0	0
18	2533358	.	T	C	3	4	7	0	0	7	0	0
18	2533391	.	C	A	8	4	12	0	0	12	0	0
18	2548878	.	G	A	8	7	15	0	0	15	0	0
18	2603521	.	T	C	1	2	3	0	0	3	0	0
18	2603522	.	T	C	1	2	3	0	0	3	0	0
18	2603576	.	T	G	8	4	12	0	0	12	0	0
18	2603786	.	A	G	7	7	14	0	0	14	0	0
18	2612259	.	A	G	5	7	12	0	0	12	0	0
18	2612293	.	A	G	6	10	16	0	0	16	0	0
18	2619228	.	A	G	3	5	8	0	0	8	0	0
18	2629272	.	G	C	2	3	5	0	1	6	0	0
18	2629347	.	A	G	3	2	5	0	0	5	0	0
18	2629415	.	C	T	1	7	8	0	1	9	0	0
18	2631290	.	A	G	3	6	9	0	0	9	0	0
18	2668603	.	G	A	5	2	7	0	0	7	0	0
18	2681965	.	G	A	11	12	23	0	1	25	1	0
18	2682182	.	C	T	0	13	13	0	10	23	0	0
18	2682203	.	A	T	11	11	22	0	0	22	0	0
18	2682610	.	T	C	11	14	25	0	1	26	0	0
18	2682830	.	G	A	8	6	14	0	0	14	0	0
18	2683085	.	T	C	1	0	1	0	6	7	0	0
18	2683365	.	G	T	4	3	7	0	0	7	0	0
18	2683985	.	T	C	2	8	10	0	1	11	0	0
18	2684031	.	T	C	7	17	24	0	0	24	0	0
18	2684069	.	T	C	0	0	0	0	19	19	0	0
18	2684071	.	T	C	5	0	5	0	14	19	0	0
18	2684456	.	T	C	4	4	8	0	0	8	0	0
18	2684458	.	A	G	4	3	7	0	1	8	0	0
18	2684589	.	T	C	6	0	6	0	10	16	0	0
18	2684802	.	G	A	5	3	8	0	1	9	0	0
18	2684807	.	C	A	7	3	10	0	0	10	0	0
18	2684872	.	A	G	12	4	16	0	0	16	0	0
18	2684889	.	A	T	9	4	13	0	1	14	0	0
18	2685138	.	C	T	2	7	9	0	12	21	0	0
18	2685162	.	T	C	15	1	16	0	9	25	0	0
18	2685263	.	A	G	14	8	22	0	1	23	0	0
18	2685297	.	A	G	12	12	24	0	0	24	0	0
18	2685312	.	G	A	9	10	19	0	1	20	0	0
18	2685348	.	C	T	2	6	8	0	14	22	0	0
18	2687992	.	C	T	10	12	22	0	1	23	0	0
18	2692381	.	A	C	3	10	13	0	0	13	0	0
18	2702458	.	G	A	11	12	23	0	1	24	0	0
18	2702524	.	C	T	14	12	26	0	0	26	0	0
18	2702536	.	A	G	13	11	24	0	2	26	0	0
18	2702569	.	C	T	1	15	16	0	10	26	0	0
18	2702888	.	T	C	15	0	15	0	12	27	0	0
18	2702976	.	A	C	8	12	20	0	0	20	0	0
18	2703120	.	A	G	5	14	19	0	0	19	0	0
18	2707108	.	G	A	11	11	22	0	0	22	0	0
18	2708467	.	G	A	8	9	17	0	1	18	0	0
18	2708505	.	C	T	8	8	16	0	0	16	0	0
18	2709356	.	T	C	6	9	15	0	0	15	0	0
18	2709395	.	G	A	8	6	14	0	0	14	0	0
18	2710216	.	A	G	5	8	13	0	1	14	0	0
18	2710231	.	T	C	4	0	4	0	8	12	0	0
18	2711894	.	C	G	4	10	14	0	10	24	0	0
18	2713199	.	C	T	9	15	24	0	0	24	0	0
18	2721518	.	T	C	8	16	24	0	0	24	0	0
18	2721565	.	A	G	8	14	22	0	0	22	0	0
18	2727714	.	G	A	6	4	10	0	1	11	0	0
18	2902985	.	A	G	17	0	17	0	15	32	0	0
18	2922800	.	A	C	14	5	19	0	19	38	0	0
18	2934856	.	A	G	11	13	24	0	0	24	0	0
18	2935243	.	G	C	12	9	21	0	0	21	0	0
18	2935265	.	A	T	12	11	23	0	1	24	0	0
18	2935480	.	C	T	19	17	36	0	0	36	0	0
18	3006843	.	C	T	12	7	19	0	0	19	0	0
18	3039440	.	A	G	29	36	65	0	3	68	0	0
18	3049752	.	T	G	13	28	41	0	3	44	0	0
18	3049756	.	A	G	24	11	35	0	4	39	0	0
18	3049869	.	G	A	0	8	8	0	2	10	0	0
18	3078582	.	C	T	6	4	10	0	1	11	0	0
18	3084660	.	G	C	6	5	11	0	0	11	0	0
18	3084698	.	G	A	5	6	11	0	1	12	0	0
18	3087662	.	G	A	1	8	9	0	1	10	0	0
18	3087695	.	T	G	4	9	13	0	0	13	0	0
18	3087704	.	T	A	3	10	13	0	1	14	0	0
18	3087776	.	G	A	9	8	17	0	0	17	0	0
18	3089906	.	T	C	2	3	5	0	0	5	0	0
18	3096914	.	A	C	2	4	6	0	0	6	0	0
18	3097003	.	A	G	2	3	5	0	0	5	0	0
18	3140795	.	T	C	0	4	4	0	0	4	0	0
18	3140800	.	G	A	0	5	5	0	1	6	0	0
18	3140937	.	C	T	6	2	8	0	0	8	0	0
18	3142685	.	A	G	8	7	15	0	2	17	0	0
18	3144677	.	G	A	2	12	14	0	8	22	0	0
18	3144742	.	A	T	12	7	19	0	1	20	0	0
18	3153072	.	G	C	6	4	10	0	0	11	1	0
18	3153231	.	A	T	2	2	4	0	0	4	0	0
18	3158739	.	A	G	5	14	19	0	0	19	0	0
18	3158776	.	G	A	10	7	17	0	0	17	0	0
18	3159140	.	C	A	4	5	9	0	0	9	0	0
18	3159193	.	G	A	7	3	10	0	0	10	0	0
18	3159249	.	C	A	2	2	4	0	0	4	0	0
18	3159865	.	T	C	4	6	10	0	0	10	0	0
18	3159965	.	A	T	4	9	13	0	0	13	0	0
18	3160148	.	C	G	1	4	5	0	2	7	0	0
18	3160218	.	C	T	1	4	5	0	9	14	0	0
18	3160308	.	A	G	7	7	14	0	1	15	0	0
18	3160354	.	C	T	0	5	5	0	4	9	0	0
18	3160406	.	T	C	4	0	4	0	2	6	0	0
18	3166180	.	G	A	7	6	13	0	0	13	0	0
18	3166360	.	C	T	7	3	10	0	0	10	0	0
18	3259736	.	C	T	19	26	45	0	1	46	0	0
18	3259807	.	C	A	22	20	42	1	1	44	0	0
18	3259847	.	C	T	24	30	54	0	3	57	0	0
18	3265657	.	T	C	15	7	22	0	2	24	0	0
18	3276085	.	G	C	19	22	41	0	2	43	0	0
18	3276187	.	A	G	17	1	18	0	21	39	0	0
18	3283882	.	T	C	20	21	41	0	0	41	0	0
18	3323557	.	A	G	5	0	5	0	5	10	0	0
18	3327571	.	G	A	1	9	10	0	4	14	0	0
18	3334609	.	C	T	9	3	12	0	1	13	0	0
18	3339152	.	G	C	7	12	19	0	1	20	0	0
18	3345052	.	T	A	4	9	13	0	2	15	0	0
18	3345093	.	A	G	7	0	7	0	7	14	0	0
18	3345141	.	T	A	8	6	14	0	0	14	0	0
18	3349011	.	T	C	9	4	13	0	1	14	0	0
18	3425487	.	G	A	1	1	2	0	1	3	0	0
18	3433472	.	T	C	1	2	3	0	0	3	0	0
18	3501282	.	C	T	2	2	4	0	0	4	0	0
18	3501283	.	C	G	2	2	4	0	0	4	0	0
18	3536868	.	A	T	14	12	26	0	1	27	0	0
18	3536937	.	T	C	11	10	21	0	1	22	0	0
18	3539989	.	C	T	1	4	5	0	10	15	0	0
18	3540027	.	C	T	6	10	16	0	0	16	0	0
18	3556542	.	A	G	13	13	26	0	1	27	0	0
18	3556626	.	C	T	2	17	19	0	11	30	0	0
18	3556935	.	C	T	6	6	12	0	0	12	0	0
18	3557043	.	A	T	5	4	9	0	0	9	0	0
18	3562608	.	A	G	8	5	13	0	0	13	0	0
18	3562643	.	C	T	8	3	11	0	0	11	0	0
18	3569275	.	C	T	0	7	7	0	6	13	0	0
18	3572547	.	G	A	6	9	15	0	1	16	0	0
18	3572878	.	T	C	7	6	13	0	2	15	0	0
18	3575938	.	C	A	8	9	17	0	0	17	0	0
18	3617759	.	C	T	4	2	6	0	0	6	0	0
18	3618015	.	C	G	8	4	12	0	0	12	0	0
18	3620556	.	A	C	7	5	12	0	0	12	0	0
18	3635132	.	G	A	3	4	7	0	0	7	0	0
18	3635443	.	C	G	7	2	9	0	0	9	0	0
18	3643699	.	T	C	4	3	7	0	0	7	0	0
18	5170063	.	A	G	34	14	48	0	3	51	0	0
18	5170069	.	A	G	19	3	22	0	30	52	0	0
18	5234937	.	C	A	1	24	25	0	17	42	0	0
18	5234990	.	T	G	11	24	35	0	2	37	0	0
18	5235033	.	C	T	12	20	32	0	0	32	0	0
18	5242329	.	G	A	25	10	35	0	0	35	0	0
18	5243234	.	A	G	20	14	34	0	2	36	0	0
18	5243255	.	T	C	18	16	34	0	0	34	0	0
18	5244632	.	G	A	4	3	7	0	0	7	0	0
18	5244986	.	G	A	3	5	8	0	0	8	0	0
18	5245615	.	G	A	4	6	10	0	0	10	0	0
18	5245806	.	T	C	12	22	34	0	3	37	0	0
18	5245818	.	C	T	1	22	23	0	15	38	0	0
18	5308441	.	T	G	7	9	16	0	0	16	0	0
18	5310018	.	A	G	8	3	11	3	0	14	0	0
18	5316537	.	A	G	3	4	7	0	0	7	0	0
18	5318653	.	G	A	1	2	3	0	0	3	0	0
18	5318658	.	G	T	1	1	2	0	0	2	0	0
18	5318833	.	G	A	2	3	5	0	0	5	0	0
18	5375143	.	A	G	7	10	17	0	0	17	0	0
18	5378093	.	C	A	2	12	14	0	9	23	0	0
18	5454381	.	G	A	9	5	14	0	1	15	0	0
18	5455161	.	C	T	8	6	14	1	1	16	0	0
18	5455347	.	G	T	1	5	6	0	10	16	0	0
18	5456883	.	C	T	3	3	6	0	0	6	0	0
18	5456940	.	G	A	1	2	3	0	0	3	0	0
18	5491697	.	G	A	14	27	41	0	1	42	0	0
18	5494980	.	A	G	18	24	42	0	0	42	0	0
18	5495903	.	T	C	9	19	28	0	1	29	0	0
18	5506578	.	C	T	23	26	49	0	2	51	0	0
18	5509426	.	G	C	17	15	32	0	1	33	0	0
18	5514321	.	T	G	7	6	13	0	0	13	0	0
18	5514544	.	T	A	7	8	15	0	1	16	0	0
18	5514678	.	G	A	2	7	9	0	10	19	0	0
18	5516984	.	T	C	10	3	13	0	2	15	0	0
18	5517046	.	A	G	8	4	12	0	0	12	0	0
18	5518108	.	C	T	10	7	17	0	2	19	0	0
18	5518128	.	T	C	14	13	27	0	0	27	0	0
18	5518749	.	T	C	9	8	17	0	1	18	0	0
18	5518809	.	T	G	4	6	10	0	0	10	0	0
18	5519119	.	A	G	3	5	8	0	0	8	0	0
18	5519138	.	A	G	4	2	6	0	2	8	0	0
18	5519269	.	T	C	8	6	14	0	0	14	0	0
18	5519534	.	T	A	3	2	5	0	0	5	0	0
18	5533186	.	A	C	4	0	4	0	5	9	0	0
18	5534295	.	T	C	5	0	5	0	3	8	0	0
18	5537129	.	G	C	2	6	8	0	1	9	0	0
18	5537138	.	C	T	1	9	10	0	0	10	0	0
18	5537171	.	A	C	1	0	1	0	10	11	0	0
18	5537530	.	A	G	5	4	9	0	0	9	0	0
18	5539488	.	T	C	1	1	2	0	7	9	0	0
18	5539517	.	T	C	1	0	1	0	8	9	0	0
18	5556579	.	G	A	0	2	2	0	1	3	0	0
18	5556606	.	T	C	1	3	4	0	0	4	0	0
18	5619919	.	G	A	1	5	6	0	7	13	0	0
18	5619922	.	G	A	6	6	12	0	1	13	0	0
18	5624614	.	A	G	8	10	18	0	0	18	0	0
18	5624654	.	T	A	11	5	16	0	0	16	0	0
18	5626583	.	G	A	10	11	21	0	0	21	0	0
18	5626661	.	A	C	5	3	8	0	0	8	0	0
18	5692205	.	A	G	15	22	37	0	1	38	0	0
18	5692222	.	A	T	17	23	40	0	1	41	0	0
18	6075348	.	A	T	0	2	2	0	0	2	0	0
18	6075353	.	C	T	2	1	3	0	0	3	0	0
18	6868483	.	A	G	31	9	40	0	0	40	0	0
18	7571381	.	C	T	1	2	3	0	0	3	0	0
18	7571412	.	A	G	5	3	8	0	0	8	0	0
18	7571548	.	T	C	5	5	10	0	0	10	0	0
18	7571657	.	A	G	1	6	7	0	0	7	0	0
18	7571684	.	A	C	1	6	7	0	0	7	0	0
18	7571712	.	G	T	3	6	9	0	2	11	0	0
18	9627844	.	G	A	1	4	5	0	0	5	0	0
18	10693077	.	G	A	8	4	12	0	1	13	0	0
18	10693085	.	T	A	8	5	13	0	0	13	0	0
18	10693123	.	C	T	8	7	15	0	0	15	0	0
18	10693155	.	T	A	8	8	16	0	0	16	0	0
18	10693322	.	A	T	4	4	8	0	0	8	0	0
18	10698083	.	T	C	6	5	11	0	0	11	0	0
18	10698161	.	T	G	10	7	17	0	1	18	0	0
18	10698215	.	T	C	9	11	20	0	0	20	0	0
18	10703669	.	A	G	6	9	15	0	0	15	0	0
18	10708346	.	G	A	5	4	9	0	0	9	0	0
18	10709870	.	C	A	8	7	15	0	0	15	0	0
18	10709876	.	C	A	8	6	14	0	0	14	0	0
18	10713310	.	T	C	3	4	7	0	0	7	0	0
18	10820428	.	A	C	12	9	21	0	0	21	0	0
18	10825951	.	A	G	9	18	27	0	6	33	0	0
18	10840094	.	C	A	8	10	18	0	0	18	0	0
18	10840722	.	C	G	9	10	19	0	0	19	0	0
18	10846601	.	T	C	17	14	31	0	1	32	0	0
18	10847743	.	C	T	18	15	33	0	1	34	0	0
18	10847872	.	A	G	3	16	19	0	2	21	0	0
18	10867181	.	A	C	8	15	23	0	2	25	0	0
18	10870806	.	T	C	9	20	29	0	0	29	0	0
18	10877499	.	G	A	8	13	21	0	0	21	0	0
18	10879495	.	G	A	14	10	24	1	0	25	0	0
18	10887826	.	A	G	15	10	25	1	0	26	0	0
18	10888245	.	A	C	10	11	21	1	0	22	0	0
18	10888551	.	T	C	13	17	30	0	1	31	0	0
18	10888836	.	T	C	13	15	28	0	2	30	0	0
18	10889049	.	C	G	9	0	9	0	13	22	0	0
18	10889880	.	G	A	1	14	15	0	9	24	0	0
18	10889901	.	T	A	7	13	20	0	0	20	0	0
18	10889951	.	G	A	12	11	23	0	0	23	0	0
18	10890432	.	G	A	17	11	28	0	0	28	0	0
18	10921408	.	A	T	11	12	23	0	3	26	0	0
18	10921630	.	A	T	9	14	23	0	0	23	0	0
18	10921734	.	T	C	10	14	24	0	0	24	0	0
18	10921791	.	T	C	12	18	30	0	1	31	0	0
18	10921855	.	T	C	12	12	24	0	0	25	1	0
18	10921857	.	G	A	0	12	12	0	13	25	0	0
18	10921927	.	C	T	5	11	16	0	1	17	0	0
18	11016209	.	G	A	4	7	11	0	0	11	0	0
18	11184522	.	G	A	3	3	6	0	0	6	0	0
18	11506615	.	G	A	2	2	4	0	0	4	0	0
18	11506946	.	T	C	2	3	5	0	1	6	0	0
18	11507253	.	T	G	7	3	10	0	2	12	0	0
18	11507263	.	G	A	4	8	12	0	1	13	0	0
18	11515830	.	C	T	9	5	14	0	0	14	0	0
18	11537703	.	T	G	8	0	8	0	5	13	0	0
18	11541046	.	A	G	6	4	10	0	0	10	0	0
18	11558350	.	G	T	2	2	4	0	0	4	0	0
18	11558360	.	G	A	2	2	4	0	0	4	0	0
18	11581723	.	T	C	1	2	3	0	0	3	0	0
18	11581724	.	G	A	1	2	3	0	0	3	0	0
18	11859121	.	C	T	6	2	8	0	0	8	0	0
18	11862896	.	G	T	3	5	8	0	1	9	0	0
18	11878643	.	G	C	0	4	4	0	6	10	0	0
18	11878673	.	C	G	4	3	7	0	1	8	0	0
18	12058480	.	T	A	7	12	19	0	0	19	0	0
18	12105432	.	T	C	7	8	15	0	0	15	0	0
18	12105548	.	G	A	0	5	5	0	10	15	0	0
18	12111431	.	A	C	6	3	9	0	1	10	0	0
18	12111625	.	A	G	5	4	9	0	3	12	0	0
18	12111628	.	A	T	6	4	10	0	2	12	0	0
18	12111772	.	A	C	7	6	13	0	0	13	0	0
18	12111784	.	G	T	6	5	11	0	1	12	0	0
18	12111925	.	G	A	5	5	10	0	3	13	0	0
18	12112105	.	T	C	9	11	20	0	1	21	0	0
18	12112153	.	T	C	11	3	14	0	0	14	0	0
18	12112219	.	C	T	13	4	17	0	0	17	0	0
18	12112246	.	A	G	9	0	9	0	9	18	0	0
18	12112726	.	C	T	9	3	12	0	0	12	0	0
18	12112750	.	G	A	7	5	12	0	0	12	0	0
18	12113515	.	C	A	8	3	11	0	1	12	0	0
18	12113516	.	C	T	7	4	11	0	1	12	0	0
18	12148050	.	T	G	5	0	5	0	7	12	0	0
18	12148056	.	C	T	5	8	13	0	0	13	0	0
18	12171277	.	C	T	4	5	9	0	0	9	0	0
18	12171313	.	A	G	4	1	5	0	8	13	0	0
18	12196939	.	G	A	2	6	8	0	10	18	0	0
18	12207046	.	A	G	8	12	20	0	0	20	0	0
18	12207070	.	C	A	12	9	21	0	0	22	1	0
18	12214299	.	A	G	10	8	18	0	0	18	0	0
18	12228217	.	C	A	11	17	28	0	1	29	0	0
18	12228758	.	C	T	5	7	12	0	0	12	0	0
18	12228834	.	G	C	8	6	14	0	0	14	0	0
18	12229120	.	A	T	11	8	19	0	1	20	0	0
18	12229223	.	A	C	8	8	16	0	0	16	0	0
18	12229245	.	C	T	7	9	16	0	0	16	0	0
18	12229405	.	G	A	8	8	16	0	1	17	0	0
18	12236351	.	C	T	11	7	18	0	4	22	0	0
18	12238082	.	G	A	7	8	15	0	0	15	0	0
18	12240681	.	C	T	11	10	21	0	0	21	0	0
18	12240740	.	G	C	7	9	16	0	2	18	0	0
18	12242967	.	C	T	2	7	9	0	10	19	0	0
18	12245468	.	A	G	5	6	11	0	0	11	0	0
18	12245525	.	A	G	6	7	13	0	0	13	0	0
18	12245576	.	A	G	5	3	8	0	0	8	0	0
18	12249400	.	G	A	14	6	20	0	2	22	0	0
18	12250727	.	G	A	5	2	7	0	0	7	0	0
18	12251352	.	G	A	2	8	10	0	0	10	0	0
18	12254248	.	G	A	2	3	5	0	1	6	0	0
18	12254398	.	A	G	6	4	10	0	0	10	0	0
18	12254409	.	G	A	7	3	10	0	0	10	0	0
18	12254905	.	G	A	3	3	6	0	0	6	0	0
18	12255012	.	T	C	6	6	12	0	1	13	0	0
18	12256716	.	T	C	2	3	5	0	0	5	0	0
18	12256743	.	G	C	2	0	2	0	4	6	0	0
18	12259919	.	G	A	2	3	5	0	0	5	0	0
18	12261269	.	T	A	1	2	3	0	0	3	0	0
18	12265717	.	T	A	3	2	5	0	0	5	0	0
18	12265725	.	G	T	3	3	6	0	0	6	0	0
18	12276859	.	C	T	9	9	18	0	0	18	0	0
18	12277052	.	A	G	8	7	15	0	0	15	0	0
18	12277206	.	G	C	13	10	23	0	3	27	1	0
18	12277490	.	G	A	18	22	40	0	1	41	0	0
18	12280269	.	C	T	23	19	42	0	0	42	0	0
18	12292017	.	G	A	22	10	32	0	1	33	0	0
18	12327321	.	C	A	1	4	5	0	6	11	0	0
18	12364876	.	G	A	6	5	11	0	0	11	0	0
18	12366097	.	G	T	5	5	10	0	0	10	0	0
18	12366171	.	C	G	3	4	7	0	0	7	0	0
18	12366855	.	A	T	2	3	5	0	0	5	0	0
18	12374108	.	C	A	2	5	7	0	0	7	0	0
18	12374168	.	A	G	1	3	4	0	0	4	0	0
18	12374497	.	C	T	0	4	4	0	3	7	0	0
18	12397571	.	T	C	2	0	2	0	2	4	0	0
18	12406385	.	G	A	3	4	7	0	0	7	0	0
18	12409681	.	C	T	1	5	6	0	0	6	0	0
18	12409705	.	A	T	1	3	4	0	0	4	0	0
18	12416410	.	A	T	5	4	9	0	0	9	0	0
18	12416908	.	G	A	3	2	5	0	0	5	0	0
18	12416944	.	A	T	3	2	5	0	0	5	0	0
18	12417035	.	T	G	2	2	4	0	1	5	0	0
18	12417543	.	G	A	1	2	3	0	0	3	0	0
18	12417547	.	G	A	1	1	2	0	1	3	0	0
18	12417581	.	A	T	1	2	3	0	0	3	0	0
18	12417994	.	G	A	1	2	3	0	0	3	0	0
18	12418054	.	T	A	2	4	6	0	0	6	0	0
18	12418207	.	G	A	1	3	4	0	0	4	0	0
18	12418349	.	G	A	3	3	6	0	0	6	0	0
18	12464794	.	C	T	0	4	4	0	7	11	0	0
18	12465290	.	G	A	12	16	28	0	1	29	0	0
18	12465316	.	C	T	11	14	25	0	4	29	0	0
18	12467834	.	G	C	13	0	13	1	14	28	0	0
18	12470013	.	G	T	10	12	22	0	1	23	0	0
18	12470136	.	G	A	17	10	27	0	0	27	0	0
18	12470148	.	A	G	10	15	25	0	1	26	0	0
18	12470211	.	C	T	1	11	12	0	10	22	0	0
18	12471210	.	T	C	11	7	18	0	0	18	0	0
18	12471225	.	G	A	8	8	16	0	0	16	0	0
18	12495185	.	C	T	8	8	16	0	0	16	0	0
18	12611569	.	T	C	5	3	8	0	0	8	0	0
18	12612031	.	C	T	0	3	3	0	8	11	0	0
18	12612160	.	A	G	5	15	20	0	1	21	0	0
18	12659226	.	C	T	12	5	17	1	1	19	0	0
18	12776727	.	C	T	6	8	14	0	1	15	0	0
18	12779357	.	T	A	15	7	22	1	0	23	0	0
18	12844042	.	A	G	1	3	4	0	1	5	0	0
18	13124493	.	T	C	1	2	3	0	0	3	0	0
18	14772522	.	G	A	3	6	9	0	0	9	0	0
18	14772747	.	C	T	1	6	7	0	5	12	0	0
18	14772889	.	A	G	14	4	18	0	1	19	0	0
18	14773050	.	C	T	9	13	22	0	1	23	0	0
18	14773068	.	G	T	10	11	21	0	1	22	0	0
18	14774568	.	T	C	10	0	10	0	8	18	0	0
18	14774646	.	C	G	7	10	17	0	0	17	0	0
18	14779213	.	C	T	8	10	18	0	0	18	0	0
18	14780581	.	G	A	7	9	16	0	0	16	0	0
18	14782677	.	C	T	4	5	9	0	0	9	0	0
18	14825239	.	G	A	2	6	8	1	0	9	0	0
18	14836678	.	C	T	5	5	10	0	0	10	0	0
18	14836706	.	C	T	5	3	8	0	0	8	0	0
18	14866506	.	G	A	10	11	21	0	1	23	1	0
18	14866508	.	C	T	11	10	21	0	3	24	0	0
18	14867144	.	A	C	2	0	2	0	6	8	0	0
18	14867153	.	C	T	4	6	10	0	0	10	0	0
18	14871133	.	C	T	4	2	6	0	1	7	0	0
18	14871145	.	A	G	3	3	6	0	0	6	0	0
18	14871280	.	A	C	4	0	4	0	4	8	0	0
18	14878691	.	C	G	1	2	3	0	3	6	0	0
18	14886129	.	C	T	2	4	6	0	2	8	0	0
18	14891794	.	T	C	1	7	8	0	0	8	0	0
18	14896331	.	T	C	2	0	2	0	4	6	0	0
18	14901176	.	G	A	2	6	8	0	0	8	0	0
18	14906635	.	A	C	2	2	4	0	0	4	0	0
18	14906670	.	G	C	1	3	4	0	0	4	0	0
18	14909768	.	G	A	3	5	8	0	2	10	0	0
18	14909831	.	A	T	6	5	11	0	0	11	0	0
18	14910929	.	A	G	1	5	6	0	0	6	0	0
18	14911309	.	G	T	1	2	3	0	0	3	0	0
18	14917126	.	C	T	3	3	6	0	0	6	0	0
18	14928654	.	C	T	5	6	11	0	0	11	0	0
18	14928681	.	T	C	5	4	9	0	0	9	0	0
18	14930095	.	T	C	2	3	5	0	0	5	0	0
18	14956171	.	A	G	5	5	10	0	1	11	0	0
18	14956177	.	G	A	5	5	10	0	1	11	0	0
18	14963733	.	G	A	5	5	10	0	1	11	0	0
18	14969855	.	G	A	6	5	11	0	0	11	0	0
18	14969931	.	C	A	0	3	3	0	2	5	0	0
18	14975502	.	G	C	5	3	8	0	0	8	0	0
18	14979233	.	A	G	2	5	7	0	0	7	0	0
18	14979242	.	C	T	0	6	6	0	3	9	0	0
18	15010642	.	C	T	5	3	8	0	0	8	0	0
18	15010681	.	C	T	4	2	6	0	0	6	0	0
18	15010757	.	T	C	2	3	5	0	1	6	0	0
18	15100812	.	T	A	4	5	9	0	1	10	0	0
18	15100866	.	A	G	1	7	8	0	1	9	0	0
18	15106813	.	G	T	3	3	6	0	1	7	0	0
18	15107012	.	C	A	5	3	8	0	0	8	0	0
18	15119795	.	T	C	1	4	5	0	0	5	0	0
18	15121484	.	G	A	8	2	10	0	0	10	0	0
18	15122894	.	C	T	2	7	9	0	0	9	0	0
18	15122915	.	G	A	0	6	6	0	2	8	0	0
18	15123008	.	C	A	3	7	10	0	0	10	0	0
18	15123011	.	A	G	3	6	9	0	0	9	0	0
18	15125122	.	G	A	5	8	13	0	1	14	0	0
18	15128960	.	T	C	4	5	9	0	0	9	0	0
18	15132372	.	T	C	20	10	30	0	0	30	0	0
18	15132383	.	T	C	19	9	28	0	1	29	0	0
18	15136657	.	A	G	4	0	4	0	4	8	0	0
18	15139004	.	T	A	6	4	10	0	0	10	0	0
18	15139150	.	G	A	8	5	13	0	0	13	0	0
18	15139540	.	C	T	9	8	17	0	0	17	0	0
18	15139757	.	G	A	4	4	8	0	1	9	0	0
18	15139784	.	T	C	1	2	3	0	0	3	0	0
18	15148021	.	T	C	6	2	8	0	0	8	0	0
18	15148063	.	A	C	4	0	4	0	5	9	0	0
18	15148199	.	T	C	3	9	12	0	1	13	0	0
18	15148207	.	A	C	4	8	12	0	0	12	0	0
18	15148248	.	T	C	7	6	13	0	0	13	0	0
18	15148259	.	A	C	5	3	8	1	1	10	0	0
18	15148886	.	G	A	1	4	5	0	1	6	0	0
18	15148912	.	A	G	2	4	6	0	0	6	0	0
18	15148985	.	A	G	6	2	8	0	1	9	0	0
18	15149067	.	G	A	2	4	6	0	0	6	0	0
18	15149068	.	G	T	2	4	6	0	0	6	0	0
18	15149538	.	T	C	5	4	9	0	0	9	0	0
18	15149813	.	T	A	2	2	4	0	0	4	0	0
18	15150165	.	A	T	1	3	4	0	0	4	0	0
18	15150207	.	G	A	4	3	7	0	1	8	0	0
18	15150261	.	A	G	5	3	8	0	0	8	0	0
18	15150327	.	C	T	1	7	8	0	0	8	0	0
18	15150330	.	G	A	0	7	7	0	0	7	0	0
18	15150442	.	C	T	4	5	9	0	0	9	0	0
18	15155939	.	G	A	5	3	8	0	0	8	0	0
18	15175672	.	A	G	0	2	2	0	1	3	0	0
18	15175675	.	T	G	1	0	1	0	2	3	0	0
18	15183041	.	G	A	0	2	2	0	1	3	0	0
18	15285055	.	G	A	5	2	7	0	1	8	0	0
18	15285346	.	C	T	7	4	11	0	1	12	0	0
18	15285508	.	T	C	2	3	5	0	0	5	0	0
18	15287610	.	C	T	2	4	6	0	0	6	0	0
18	15295925	.	C	T	0	6	6	0	7	13	0	0
18	15295976	.	G	T	8	6	14	0	0	14	0	0
18	15296062	.	G	A	9	7	16	0	1	17	0	0
18	15329361	.	G	A	6	5	11	0	0	11	0	0
18	15334856	.	G	A	3	2	5	0	0	5	0	0
18	15345012	.	A	G	3	3	6	0	0	6	0	0
18	15345315	.	C	T	0	2	2	0	2	4	0	0
18	15345409	.	G	C	3	2	5	0	0	5	0	0
18	15358344	.	A	T	1	3	4	0	0	4	0	0
18	15383683	.	C	T	6	5	11	0	0	11	0	0
18	15393324	.	G	A	5	5	10	0	0	10	0	0
18	15393787	.	C	G	4	7	11	0	0	11	0	0
18	15394143	.	T	C	1	4	5	0	1	6	0	0
18	15395535	.	A	G	5	7	12	1	0	13	0	0
18	15399135	.	T	C	6	4	10	0	0	10	0	0
18	15403754	.	C	T	2	2	4	0	0	4	0	0
18	15404498	.	A	G	4	3	7	0	0	7	0	0
18	15408140	.	G	A	1	4	5	0	0	5	0	0
18	15408185	.	T	C	1	6	7	0	0	7	0	0
18	15410687	.	G	A	2	3	5	0	0	5	0	0
18	15414558	.	T	C	2	4	6	0	0	6	0	0
18	15414564	.	C	T	2	4	6	0	0	6	0	0
18	15459835	.	T	A	6	8	14	1	1	17	1	0
18	15469907	.	T	C	7	2	9	0	2	11	0	0
18	15470114	.	T	G	6	4	10	0	0	10	0	0
18	15478391	.	T	G	3	5	8	0	0	8	0	0
18	15478394	.	G	A	3	5	8	0	0	8	0	0
18	15478597	.	A	G	4	7	11	0	0	11	0	0
18	15481364	.	T	G	5	3	8	0	0	8	0	0
18	15481636	.	C	T	1	4	5	0	0	5	0	0
18	15483345	.	A	G	8	6	14	0	0	14	0	0
18	15483351	.	C	T	10	5	15	0	0	15	0	0
18	15483994	.	C	T	4	7	11	0	0	11	0	0
18	15484021	.	C	T	1	5	6	0	5	11	0	0
18	15484036	.	G	A	7	2	9	0	0	9	0	0
18	15490146	.	G	A	5	4	9	0	0	9	0	0
18	15512776	.	C	A	0	2	2	0	5	7	0	0
18	15512777	.	G	A	5	2	7	0	0	7	0	0
18	15571189	.	G	C	2	2	4	0	0	4	0	0
18	15584670	.	T	G	1	5	6	0	0	6	0	0
18	15610277	.	A	G	2	2	4	0	0	4	0	0
18	15630980	.	G	A	1	2	3	0	0	3	0	0
18	15635173	.	A	G	1	0	1	0	3	4	0	0
18	15792294	.	T	G	16	15	31	0	1	32	0	0
18	15792368	.	G	C	17	21	38	0	2	40	0	0
18	15792459	.	A	C	34	17	51	0	1	52	0	0
18	15792596	.	T	A	28	21	49	0	0	49	0	0
18	15792611	.	A	G	26	20	46	0	0	46	0	0
18	15792743	.	T	A	25	17	42	0	1	43	0	0
18	15793064	.	A	G	5	5	10	0	0	10	0	0
18	15829588	.	A	G	12	7	19	0	2	21	0	0
18	15836835	.	A	G	6	4	10	1	0	11	0	0
18	15836961	.	C	T	6	6	12	0	0	12	0	0
18	15849413	.	T	C	7	6	13	0	0	13	0	0
18	15858916	.	G	A	7	3	10	0	2	12	0	0
18	15863558	.	G	A	7	8	15	0	0	15	0	0
18	15865085	.	G	C	1	5	6	0	5	11	0	0
18	15865154	.	T	C	5	5	10	0	2	12	0	0
18	15865196	.	C	G	10	12	22	0	0	22	0	0
18	15866874	.	T	G	4	11	15	0	0	15	0	0
18	15866876	.	G	T	3	9	12	0	1	14	1	0
18	15869816	.	C	A	6	5	11	0	0	12	1	0
18	15869854	.	T	G	6	0	6	0	6	12	0	0
18	15872092	.	A	G	5	6	11	0	0	11	0	0
18	15872397	.	G	C	5	4	9	0	1	10	0	0
18	15872435	.	A	G	4	6	10	0	0	10	0	0
18	15872452	.	G	A	5	6	11	0	0	11	0	0
18	15874454	.	T	C	7	5	12	0	0	12	0	0
18	15874550	.	C	T	9	5	14	0	0	14	0	0
18	15875196	.	G	A	16	9	25	0	0	25	0	0
18	15889750	.	G	A	2	2	4	0	0	4	0	0
18	16111467	.	C	G	0	3	3	0	1	4	0	0
18	16127885	.	A	G	22	21	43	0	0	43	0	0
18	16127927	.	A	C	20	20	40	0	1	41	0	0
18	16128427	.	T	A	5	7	12	0	0	12	0	0
18	16128730	.	A	G	8	8	16	0	2	18	0	0
18	16128960	.	T	G	27	14	41	0	0	41	0	0
18	16129210	.	A	C	26	15	41	0	2	43	0	0
18	16129583	.	T	A	20	19	39	0	2	41	0	0
18	16129862	.	C	T	16	18	34	0	2	36	0	0
18	16133772	.	C	G	15	18	33	0	1	34	0	0
18	16133773	.	T	A	15	19	34	0	0	34	0	0
18	16133822	.	T	C	11	16	27	0	1	28	0	0
18	16140047	.	G	A	17	12	29	0	2	31	0	0
18	16140337	.	G	T	1	17	18	0	24	42	0	0
18	16145618	.	T	G	24	20	44	0	0	44	0	0
18	16145621	.	C	T	24	20	44	0	0	44	0	0
18	16145994	.	C	G	5	4	9	0	0	9	0	0
18	16151809	.	T	A	9	5	14	0	1	15	0	0
18	16151936	.	G	A	20	7	27	0	1	28	0	0
18	16152149	.	G	A	17	13	30	0	3	33	0	0
18	16153487	.	T	C	11	0	11	0	17	28	0	0
18	16157998	.	T	C	7	0	7	0	5	12	0	0
18	16158279	.	G	T	7	6	13	0	1	14	0	0
18	16196396	.	T	C	1	1	2	0	0	2	0	0
18	16215514	.	A	G	2	1	3	0	1	4	0	0
18	16215523	.	A	G	3	2	5	0	0	5	0	0
18	16388195	.	G	A	7	11	18	0	2	20	0	0
18	16388342	.	G	A	6	5	11	0	0	11	0	0
18	16388387	.	G	A	4	7	11	0	0	11	0	0
18	16388747	.	T	C	4	2	6	0	0	6	0	0
18	16388864	.	C	T	9	7	16	0	0	16	0	0
18	16391712	.	G	A	4	6	10	0	0	10	0	0
18	16589702	.	T	C	5	6	11	1	0	12	0	0
18	16589760	.	G	T	2	4	6	1	0	7	0	0
18	16719963	.	T	C	11	23	34	0	1	35	0	0
18	16720197	.	G	A	17	13	30	0	0	30	0	0
18	16721705	.	G	A	19	19	38	0	4	42	0	0
18	16721741	.	G	A	26	20	46	0	2	48	0	0
18	16722124	.	G	A	25	30	55	0	2	57	0	0
18	16722584	.	G	A	18	19	37	0	1	38	0	0
18	16723514	.	T	C	20	17	37	0	1	38	0	0
18	16723520	.	A	G	19	1	20	0	16	36	0	0
18	16723785	.	A	G	16	0	16	0	19	35	0	0
18	16725225	.	G	A	0	17	17	1	19	37	0	0
18	16725917	.	A	G	11	14	25	1	4	30	0	0
18	16726011	.	C	T	13	9	22	0	1	23	0	0
18	16755962	.	C	A	24	30	54	0	1	55	0	0
18	16756001	.	C	T	13	28	41	0	3	44	0	0
18	16756058	.	T	A	14	16	30	0	1	31	0	0
18	16756065	.	G	A	14	17	31	0	1	32	0	0
18	16877282	.	C	T	2	3	5	0	0	5	0	0
18	16877283	.	A	G	2	3	5	0	0	5	0	0
18	16885979	.	T	G	9	10	19	0	1	20	0	0
18	16886079	.	C	T	8	10	18	0	0	18	0	0
18	16894571	.	T	A	9	5	14	0	0	14	0	0
18	16894594	.	T	G	9	8	17	0	0	17	0	0
18	16894630	.	A	G	7	9	16	0	0	16	0	0
18	16906522	.	A	G	6	5	11	0	0	11	0	0
18	16915433	.	T	C	4	4	8	0	1	9	0	0
18	16915463	.	A	G	2	3	5	0	0	5	0	0
18	16921173	.	T	C	2	2	4	0	0	4	0	0
18	16929772	.	G	A	11	11	22	5	1	28	0	0
18	16936429	.	G	A	1	2	3	0	0	3	0	0
18	16936758	.	T	C	1	5	6	0	0	6	0	0
18	16936787	.	A	G	1	4	5	0	0	5	0	0
18	16961046	.	A	G	26	17	43	3	3	49	0	0
18	16962778	.	A	G	20	9	29	2	4	35	0	0
18	16962783	.	C	T	19	11	30	2	1	33	0	0
18	16962823	.	C	T	24	15	39	0	2	41	0	0
18	16963091	.	C	G	20	12	32	0	2	34	0	0
18	16966911	.	T	C	20	10	30	0	2	32	0	0
18	16968314	.	T	C	14	21	35	0	1	36	0	0
18	16970132	.	C	T	5	6	11	0	0	11	0	0
18	16970169	.	C	T	8	2	10	0	0	10	0	0
18	16970455	.	A	T	13	5	18	0	0	18	0	0
18	16970459	.	G	A	1	7	8	0	13	21	0	0
18	16970598	.	C	T	15	6	21	0	0	21	0	0
18	16970795	.	A	T	5	4	9	1	0	10	0	0
18	16970950	.	T	G	9	4	13	0	2	15	0	0
18	16970997	.	G	C	2	13	15	0	12	27	0	0
18	16971129	.	C	T	10	8	18	0	0	18	0	0
18	16971155	.	A	T	6	8	14	0	0	14	0	0
18	16986518	.	C	G	3	3	6	0	0	6	0	0
18	16990122	.	C	T	1	2	3	0	3	6	0	0
18	16990150	.	G	T	3	3	6	0	0	6	0	0
18	16990385	.	A	C	5	0	5	0	4	9	0	0
18	16990520	.	C	T	8	6	14	0	0	14	0	0
18	16990550	.	A	G	11	5	16	0	0	16	0	0
18	16993352	.	A	T	4	2	6	0	0	6	0	0
18	16998924	.	A	T	3	6	9	0	1	10	0	0
18	17002614	.	T	C	7	0	7	0	6	13	0	0
18	17002653	.	A	G	6	9	15	0	2	17	0	0
18	17003602	.	A	G	10	7	17	0	1	18	0	0
18	17005917	.	T	C	3	2	5	0	0	5	0	0
18	17007458	.	G	A	1	2	3	0	0	3	0	0
18	17007521	.	G	A	1	4	5	0	0	5	0	0
18	17007527	.	C	T	1	3	4	0	0	4	0	0
18	17007720	.	T	C	4	9	13	0	0	13	0	0
18	17016354	.	C	G	4	3	7	0	0	7	0	0
18	17016697	.	T	C	1	3	4	0	0	4	0	0
18	17016721	.	G	T	1	2	3	0	1	4	0	0
18	17016890	.	G	A	3	3	6	0	0	6	0	0
18	17018541	.	C	G	5	5	10	0	0	10	0	0
18	17021521	.	C	T	1	2	3	0	0	3	0	0
18	17021778	.	A	C	2	3	5	0	1	6	0	0
18	17051417	.	G	A	1	3	4	0	0	4	0	0
18	17062323	.	G	A	4	4	8	0	0	8	0	0
18	17062336	.	T	C	4	3	7	0	0	7	0	0
18	17062364	.	T	G	7	3	10	0	0	10	0	0
18	17062611	.	C	T	2	4	6	0	2	8	0	0
18	17066978	.	T	C	5	5	10	0	0	10	0	0
18	17067688	.	T	C	2	2	4	0	0	4	0	0
18	17067757	.	G	C	3	3	6	0	1	7	0	0
18	17067826	.	G	C	2	0	2	0	3	5	0	0
18	17067842	.	C	T	0	3	3	0	3	6	0	0
18	17070214	.	C	A	1	3	4	0	0	4	0	0
18	17073999	.	C	T	2	4	6	0	0	6	0	0
18	17078575	.	A	T	5	3	8	0	0	8	0	0
18	17078593	.	T	C	4	3	7	0	0	7	0	0
18	17079541	.	T	C	12	9	21	4	1	26	0	0
18	17079724	.	C	T	0	8	8	0	8	16	0	0
18	17080089	.	G	C	10	11	21	0	1	22	0	0
18	17080122	.	A	G	11	13	24	0	0	24	0	0
18	17080131	.	T	C	9	0	9	0	12	21	0	0
18	17084489	.	C	T	2	4	6	0	8	14	0	0
18	17097893	.	T	C	12	8	20	1	2	23	0	0
18	17098317	.	T	A	10	10	20	0	1	21	0	0
18	17098562	.	T	A	13	8	21	0	1	22	0	0
18	17102046	.	C	T	1	12	13	0	9	22	0	0
18	17131006	.	A	G	20	6	26	0	0	26	0	0
18	17134780	.	A	G	5	4	9	0	0	9	0	0
18	17139446	.	G	A	4	4	8	0	0	8	0	0
18	17139461	.	T	C	3	2	5	0	0	5	0	0
18	17144659	.	C	T	9	4	13	0	1	14	0	0
18	17144909	.	T	A	11	7	18	0	2	20	0	0
18	17152045	.	G	C	3	3	6	0	0	6	0	0
18	17173465	.	T	G	3	3	6	0	0	6	0	0
18	17173474	.	A	C	4	4	8	0	0	8	0	0
18	17173629	.	A	G	2	1	3	0	0	3	0	0
18	17173638	.	C	T	2	2	4	0	0	4	0	0
18	17173687	.	G	T	0	3	3	0	1	4	0	0
18	17535748	.	A	T	9	7	16	0	3	19	0	0
18	17994415	.	A	G	4	23	27	0	0	27	0	0
18	19342739	.	A	G	1	4	5	0	0	5	0	0
18	19405533	.	G	A	1	4	5	0	0	5	0	0
18	19419200	.	A	T	20	11	31	0	0	31	0	0
18	19419307	.	C	T	16	15	31	0	0	31	0	0
18	19441492	.	C	G	20	21	41	0	3	45	1	0
18	19441561	.	T	C	24	23	47	0	0	47	0	0
18	19441585	.	C	A	18	20	38	0	1	39	0	0
18	19450486	.	T	C	27	27	54	0	3	57	0	0
18	19450563	.	A	T	37	29	66	0	2	68	0	0
18	19450642	.	A	T	27	24	51	0	1	52	0	0
18	19450692	.	A	G	23	19	42	1	0	43	0	0
18	19450755	.	A	G	24	31	55	3	2	60	0	0
18	19451023	.	C	T	17	20	37	0	1	38	0	0
18	19451117	.	C	T	7	7	14	0	7	21	0	0
18	19451427	.	G	A	47	30	77	0	2	79	0	0
18	19451430	.	T	C	46	2	48	0	29	77	0	0
18	19451477	.	G	A	34	48	82	0	2	84	0	0
18	19452594	.	G	A	30	39	69	0	4	73	0	0
18	19452639	.	A	G	33	38	71	0	4	75	0	0
18	19487779	.	G	A	18	10	28	0	0	28	0	0
18	19490515	.	C	T	13	19	32	0	3	35	0	0
18	19648878	.	T	C	4	4	8	0	1	9	0	0
18	19698539	.	C	T	1	2	3	2	0	5	0	0
18	19698833	.	T	C	5	9	14	0	0	14	0	0
18	19698854	.	G	A	4	5	9	0	0	9	0	0
18	19773113	.	G	A	3	4	7	0	0	7	0	0
18	19793720	.	G	A	5	2	7	0	1	8	0	0
18	19805464	.	C	T	6	5	11	0	0	11	0	0
18	19805731	.	A	T	2	2	4	0	0	4	0	0
18	19805763	.	T	G	1	1	2	0	1	4	1	0
18	19806014	.	A	G	3	1	4	0	4	8	0	0
18	19806135	.	T	G	2	3	5	0	0	5	0	0
18	19812874	.	T	C	9	5	14	0	2	16	0	0
18	19812943	.	A	T	9	9	18	0	0	18	0	0
18	19813002	.	A	G	6	11	17	0	0	17	0	0
18	19814181	.	A	G	8	5	13	0	2	15	0	0
18	19815743	.	A	T	11	6	17	0	1	18	0	0
18	19817682	.	G	A	9	4	13	0	2	15	0	0
18	19817717	.	G	A	6	4	10	0	1	11	0	0
18	19819719	.	C	A	7	4	11	0	1	12	0	0
18	19880206	.	T	A	1	6	7	0	0	7	0	0
18	19883812	.	G	T	1	4	5	0	4	9	0	0
18	19974725	.	C	T	5	4	9	0	0	9	0	0
18	19981584	.	C	T	2	2	4	0	0	4	0	0
18	20006910	.	C	T	7	5	12	0	0	12	0	0
18	20020108	.	A	T	8	8	16	0	0	16	0	0
18	20024856	.	T	C	5	8	13	0	1	14	0	0
18	20024889	.	G	A	7	8	15	0	1	16	0	0
18	20034058	.	T	A	7	3	10	0	0	10	0	0
18	20041825	.	T	C	11	13	24	0	1	25	0	0
18	20042088	.	C	T	13	18	31	0	2	33	0	0
18	20044847	.	T	C	9	13	22	0	1	23	0	0
18	20076539	.	C	T	2	3	5	0	0	5	0	0
18	20076968	.	G	T	2	2	4	0	0	4	0	0
18	20077028	.	C	T	2	2	4	0	0	4	0	0
18	20226023	.	C	A	6	6	12	0	2	14	0	0
18	20226051	.	A	T	4	4	8	0	0	8	0	0
18	20226131	.	G	T	13	7	20	0	0	20	0	0
18	20226288	.	G	A	7	3	10	0	1	11	0	0
18	20228760	.	C	T	6	11	17	0	0	17	0	0
18	20249005	.	G	T	3	13	16	0	19	35	0	0
18	20249735	.	T	C	15	7	22	0	2	24	0	0
18	20252129	.	C	T	10	15	25	0	1	26	0	0
18	20254384	.	C	T	12	4	16	0	1	17	0	0
18	20254398	.	G	A	0	3	3	0	12	15	0	0
18	20256275	.	C	T	13	12	25	0	1	26	0	0
18	20256379	.	A	G	9	3	12	0	2	14	0	0
18	20256491	.	T	A	6	5	11	0	0	11	0	0
18	20256492	.	A	T	5	5	10	0	0	11	1	0
18	20256539	.	G	A	4	9	13	0	1	14	0	0
18	20257005	.	G	A	2	15	17	0	8	25	0	0
18	20257159	.	C	G	5	7	12	0	0	12	0	0
18	20257200	.	A	T	12	7	19	0	0	19	0	0
18	20460397	.	A	G	2	3	5	0	0	5	0	0
18	20468514	.	G	T	0	6	6	0	7	13	0	0
18	20469150	.	G	A	5	3	8	0	0	8	0	0
18	20475854	.	C	T	2	9	11	0	0	11	0	0
18	20479008	.	A	G	7	5	12	0	0	12	0	0
18	20483240	.	G	A	1	5	6	0	0	6	0	0
18	20483276	.	A	C	1	2	3	0	0	3	0	0
18	20489224	.	G	A	5	3	8	0	0	8	0	0
18	20489580	.	G	A	2	2	4	0	0	4	0	0
18	20490370	.	A	C	2	2	4	1	0	5	0	0
18	20490672	.	G	A	2	2	4	0	0	4	0	0
18	20490768	.	A	T	3	3	6	0	1	7	0	0
18	20516811	.	T	C	1	2	3	0	0	3	0	0
18	20516863	.	A	C	1	5	6	0	0	6	0	0
18	20516869	.	T	G	1	5	6	0	0	6	0	0
18	20517000	.	G	A	2	3	5	0	0	5	0	0
18	20518915	.	C	G	3	3	6	0	0	6	0	0
18	20518961	.	A	C	1	3	4	0	0	4	0	0
18	20520964	.	A	G	3	3	6	0	0	6	0	0
18	20521680	.	G	A	3	2	5	0	0	5	0	0
18	20523591	.	C	T	1	2	3	0	0	3	0	0
18	20528128	.	A	G	1	2	3	0	0	3	0	0
18	20529147	.	C	A	2	3	5	0	0	5	0	0
18	20532660	.	G	A	2	7	9	0	0	9	0	0
18	20532685	.	T	C	4	9	13	0	1	14	0	0
18	20534277	.	A	T	6	6	12	0	1	13	0	0
18	20535074	.	T	A	9	10	19	0	2	21	0	0
18	20536533	.	A	G	6	1	7	0	5	12	0	0
18	20539548	.	G	A	0	9	9	0	6	15	0	0
18	20539703	.	T	A	3	5	8	0	1	9	0	0
18	20539844	.	T	A	6	3	9	0	2	11	0	0
18	20539979	.	T	A	7	6	13	0	0	13	0	0
18	20541575	.	A	C	7	8	15	0	0	15	0	0
18	20541735	.	A	G	9	4	13	0	0	13	0	0
18	20542107	.	C	T	2	16	18	0	9	27	0	0
18	20542128	.	T	G	14	10	24	0	0	24	0	0
18	20542214	.	A	T	7	7	14	0	0	14	0	0
18	20542388	.	T	G	11	10	21	0	1	22	0	0
18	20542398	.	A	C	17	8	25	0	0	25	0	0
18	20542503	.	G	A	9	22	31	0	1	32	0	0
18	20542562	.	T	G	10	18	28	0	2	30	0	0
18	20542647	.	C	T	12	13	25	0	0	25	0	0
18	20543466	.	T	A	11	15	26	0	1	27	0	0
18	20544691	.	G	A	12	7	19	0	1	20	0	0
18	20544901	.	G	C	10	12	22	0	0	22	0	0
18	20553607	.	T	C	17	19	36	0	0	36	0	0
18	20554066	.	C	T	1	10	11	0	8	19	0	0
18	20559518	.	C	T	12	12	24	0	2	26	0	0
18	20582109	.	G	A	6	7	13	2	2	17	0	0
18	20582222	.	G	A	8	4	12	0	0	12	0	0
18	20582392	.	C	T	0	3	3	0	3	6	0	0
18	20582629	.	T	C	3	8	11	0	1	12	0	0
18	20582943	.	G	A	5	2	7	0	2	9	0	0
18	20583398	.	C	T	1	5	6	0	0	6	0	0
18	20583487	.	C	G	5	3	8	0	1	9	0	0
18	20583763	.	A	G	8	9	17	0	0	17	0	0
18	20583820	.	A	T	4	3	7	0	0	7	0	0
18	20584077	.	G	A	5	5	10	0	0	10	0	0
18	20584098	.	T	A	3	3	6	0	1	7	0	0
18	20584340	.	C	T	0	4	4	0	3	7	0	0
18	20584797	.	G	A	2	4	6	0	0	6	0	0
18	20584801	.	C	T	2	4	6	0	0	6	0	0
18	20584986	.	T	G	3	2	5	0	0	5	0	0
18	20585314	.	C	T	12	10	22	0	1	23	0	0
18	20585435	.	T	C	8	0	8	1	7	16	0	0
18	20585495	.	C	T	7	6	13	0	1	14	0	0
18	20585883	.	G	A	5	6	11	0	1	12	0	0
18	20607160	.	G	A	9	3	12	0	0	12	0	0
18	20608212	.	A	T	9	3	12	0	0	12	0	0
18	20726304	.	T	C	23	1	24	0	32	56	0	0
18	20729281	.	C	T	2	19	21	0	22	44	1	0
18	20739268	.	G	T	18	14	32	0	0	32	0	0
18	20739298	.	C	T	18	9	27	0	0	27	0	0
18	20742029	.	C	G	15	23	38	0	0	38	0	0
18	20744164	.	T	C	9	15	24	0	1	25	0	0
18	20752848	.	G	A	5	14	19	0	0	19	0	0
18	20755763	.	G	A	9	11	20	0	0	20	0	0
18	20755787	.	G	T	8	12	20	0	1	21	0	0
18	20755843	.	G	C	11	16	27	0	1	28	0	0
18	20755844	.	C	A	11	17	28	0	0	28	0	0
18	20755971	.	G	T	16	9	25	0	1	26	0	0
18	20757663	.	G	A	12	15	27	0	1	28	0	0
18	20757934	.	C	T	20	13	33	0	1	34	0	0
18	20757977	.	A	C	15	0	15	0	16	31	0	0
18	20757979	.	G	A	15	16	31	0	1	32	0	0
18	20768254	.	T	C	9	1	10	0	8	18	0	0
18	20768407	.	C	T	17	15	32	0	14	46	0	0
18	20768818	.	T	A	14	12	26	0	0	26	0	0
18	20768977	.	C	T	9	10	19	0	0	19	0	0
18	20771078	.	T	C	10	0	10	0	15	25	0	0
18	20771085	.	A	G	14	8	22	0	2	24	0	0
18	20821793	.	G	A	9	4	13	0	0	13	0	0
18	20859992	.	G	A	3	5	8	0	0	8	0	0
18	20860597	.	G	A	3	3	6	0	0	6	0	0
18	20860651	.	T	C	3	2	5	0	0	5	0	0
18	20861647	.	G	A	2	2	4	0	0	4	0	0
18	20865498	.	T	C	2	0	2	0	5	7	0	0
18	20865543	.	T	C	3	5	8	0	0	8	0	0
18	20869033	.	T	A	2	2	4	0	0	4	0	0
18	20869089	.	C	T	0	5	5	0	4	9	0	0
18	20869128	.	T	C	4	5	9	0	0	9	0	0
18	20881800	.	G	A	4	4	8	0	0	8	0	0
18	20882057	.	G	A	1	7	8	0	0	8	0	0
18	20882062	.	T	C	2	0	2	0	5	7	0	0
18	20882237	.	C	G	3	5	8	0	0	8	0	0
18	20883141	.	A	G	4	2	6	0	0	6	0	0
18	20894485	.	G	A	2	4	6	0	0	6	0	0
18	20914388	.	C	T	4	7	11	0	0	11	0	0
18	20922931	.	T	A	1	3	4	0	0	4	0	0
18	21071085	.	A	G	7	0	7	0	10	17	0	0
18	21075715	.	A	C	2	5	7	0	0	7	0	0
18	21102797	.	G	T	5	9	14	0	3	17	0	0
18	21102914	.	G	A	4	6	10	0	0	10	0	0
18	21103079	.	G	A	8	4	12	0	1	13	0	0
18	21103274	.	G	A	4	2	6	0	0	6	0	0
18	21105722	.	G	A	7	4	11	0	0	11	0	0
18	21113258	.	G	A	1	9	10	0	8	18	0	0
18	21113273	.	T	C	9	7	16	0	0	16	0	0
18	21113462	.	T	A	7	9	16	0	1	17	0	0
18	21113533	.	G	A	5	4	9	0	0	9	0	0
18	21114475	.	T	C	11	5	16	0	0	16	0	0
18	21116381	.	C	A	9	10	19	0	0	19	0	0
18	21117589	.	C	A	13	8	21	0	0	21	0	0
18	21118232	.	C	G	14	6	20	0	1	21	0	0
18	21119498	.	G	A	6	8	14	0	0	14	0	0
18	21119562	.	G	A	5	11	16	0	0	16	0	0
18	21119579	.	A	T	7	12	19	0	0	19	0	0
18	21119854	.	T	C	4	5	9	0	0	9	0	0
18	21136729	.	C	T	22	14	36	0	1	37	0	0
18	21136948	.	C	T	24	18	42	0	3	45	0	0
18	21143473	.	A	T	17	21	38	0	1	39	0	0
18	21143787	.	C	A	14	13	27	0	3	30	0	0
18	21143938	.	C	G	12	5	17	0	2	19	0	0
18	21143998	.	C	T	16	14	30	0	2	32	0	0
18	21144005	.	C	A	18	13	31	0	1	32	0	0
18	21144060	.	G	A	2	12	14	0	20	34	0	0
18	21144800	.	A	T	5	6	11	0	0	11	0	0
18	21144880	.	G	T	7	16	23	0	0	23	0	0
18	21144965	.	G	C	1	8	9	0	6	15	0	0
18	21145142	.	A	G	13	8	21	0	3	24	0	0
18	21145290	.	G	T	11	7	18	0	0	18	0	0
18	21179325	.	T	C	5	0	5	1	4	10	0	0
18	21179730	.	A	G	15	9	24	0	0	24	0	0
18	21185167	.	A	G	8	13	21	0	2	23	0	0
18	21198961	.	G	T	18	14	32	0	1	33	0	0
18	21199165	.	G	T	20	9	29	0	4	33	0	0
18	21199515	.	T	C	26	24	50	1	2	53	0	0
18	21214976	.	T	C	27	14	41	0	3	44	0	0
18	21218734	.	G	A	20	25	45	0	2	47	0	0
18	21257600	.	A	T	13	7	20	0	1	21	0	0
18	21257657	.	T	C	7	11	18	0	0	18	0	0
18	21257786	.	G	A	14	4	18	0	0	18	0	0
18	21257867	.	G	A	7	8	15	0	1	16	0	0
18	21257946	.	C	T	15	5	20	0	1	21	0	0
18	21258083	.	G	A	11	12	23	0	0	23	0	0
18	21263120	.	G	A	6	11	17	0	1	18	0	0
18	21266815	.	A	G	8	5	13	0	1	14	0	0
18	21266885	.	G	A	6	7	13	0	1	14	0	0
18	21492325	.	T	C	29	17	46	0	2	48	0	0
18	21617864	.	G	A	6	31	37	0	29	66	0	0
18	21618343	.	C	T	22	21	43	0	0	43	0	0
18	21618379	.	A	G	32	22	54	0	1	55	0	0
18	21618496	.	G	A	25	23	48	0	1	49	0	0
18	21618659	.	C	A	20	16	36	0	1	37	0	0
18	21618731	.	G	T	34	16	50	0	1	51	0	0
18	21618910	.	G	T	26	27	53	1	2	57	1	0
18	21619011	.	C	T	20	24	44	0	1	45	0	0
18	21619018	.	A	T	21	26	47	0	1	48	0	0
18	21619055	.	G	T	25	24	49	0	2	51	0	0
18	21619260	.	C	T	24	16	40	0	2	42	0	0
18	21619284	.	G	T	14	28	42	1	0	43	0	0
18	21619672	.	A	G	23	25	48	1	2	51	0	0
18	21619686	.	G	A	22	28	50	2	1	53	0	0
18	21619777	.	A	G	32	29	61	1	0	62	0	0
18	21619799	.	T	G	26	26	52	0	2	54	0	0
18	21619948	.	C	T	17	17	34	1	3	38	0	0
18	21620082	.	A	T	29	9	38	0	0	38	0	0
18	21620376	.	A	C	22	25	47	0	0	47	0	0
18	21620426	.	G	A	6	24	30	0	19	49	0	0
18	21645327	.	G	A	1	2	3	0	0	3	0	0
18	21645492	.	G	A	9	8	17	0	0	17	0	0
18	21645902	.	G	C	17	1	18	0	17	35	0	0
18	21645965	.	G	A	13	16	29	0	3	32	0	0
18	21645989	.	T	G	16	10	26	0	1	27	0	0
18	21647419	.	T	C	6	7	13	0	0	13	0	0
18	21648522	.	C	T	18	8	26	0	0	26	0	0
18	21648582	.	A	G	10	12	22	0	1	23	0	0
18	21648627	.	C	T	9	7	16	0	0	16	0	0
18	21648633	.	A	T	7	6	13	0	1	14	0	0
18	21653937	.	C	T	9	13	22	0	2	24	0	0
18	21654124	.	A	C	15	0	15	0	6	21	0	0
18	21654145	.	C	T	13	9	22	0	0	22	0	0
18	21654375	.	C	A	7	11	18	0	0	18	0	0
18	21654432	.	T	C	9	7	16	0	0	16	0	0
18	21654489	.	C	T	10	10	20	0	1	21	0	0
18	21656271	.	C	A	6	5	11	0	0	11	0	0
18	21656274	.	G	A	6	4	10	0	0	10	0	0
18	21656605	.	C	T	7	7	14	0	1	15	0	0
18	21657642	.	T	G	5	8	13	0	0	13	0	0
18	21664864	.	G	A	6	2	8	0	0	8	0	0
18	21674320	.	G	T	6	6	12	0	0	12	0	0
18	21678723	.	G	A	10	3	13	0	1	14	0	0
18	21689043	.	G	C	7	8	15	0	1	16	0	0
18	21689052	.	A	G	5	9	14	0	0	14	0	0
18	21689079	.	G	A	12	4	16	0	0	16	0	0
18	21693120	.	A	G	6	2	8	0	0	8	0	0
18	21693213	.	G	A	9	12	21	0	0	21	0	0
18	21693441	.	G	A	6	5	11	0	0	11	0	0
18	21697776	.	C	T	9	7	16	0	0	16	0	0
18	21698855	.	G	T	4	8	12	0	2	14	0	0
18	21699581	.	A	T	4	6	10	1	1	12	0	0
18	21724334	.	G	A	3	5	8	0	0	8	0	0
18	21724480	.	A	G	3	4	7	0	0	7	0	0
18	21728655	.	C	T	1	3	4	0	0	4	0	0
18	21729052	.	A	G	2	2	4	0	0	4	0	0
18	21782362	.	T	G	2	2	4	0	0	4	0	0
18	21782445	.	T	G	5	2	7	0	0	7	0	0
18	21782500	.	A	G	4	2	6	0	0	6	0	0
18	21782506	.	G	C	4	2	6	0	0	6	0	0
18	21782908	.	G	A	8	3	11	0	0	11	0	0
18	21783009	.	T	G	8	3	11	0	1	12	0	0
18	21783010	.	A	C	6	3	9	0	2	11	0	0
18	21783257	.	G	T	2	6	8	0	0	8	0	0
18	21783279	.	G	A	5	2	7	0	0	7	0	0
18	21783325	.	A	T	2	6	8	0	0	8	0	0
18	21783368	.	G	A	7	2	9	0	0	9	0	0
18	21784127	.	T	C	2	4	6	0	0	6	0	0
18	21796094	.	G	A	4	5	9	0	0	9	0	0
18	21860755	.	C	T	8	5	13	0	1	14	0	0
18	21861134	.	T	A	9	7	16	0	0	16	0	0
18	21861225	.	T	A	8	11	19	0	1	20	0	0
18	21861381	.	G	T	10	5	15	0	0	15	0	0
18	21861497	.	A	T	6	7	13	0	0	13	0	0
18	21861688	.	C	A	6	4	10	0	0	10	0	0
18	21862000	.	G	C	12	8	20	0	0	20	0	0
18	21862076	.	C	T	4	5	9	2	14	25	0	0
18	21862141	.	T	C	10	0	10	0	12	22	0	0
18	21862175	.	C	T	0	11	11	0	6	17	0	0
18	21862237	.	G	T	3	6	9	0	0	9	0	0
18	21862346	.	T	A	10	6	16	0	0	16	0	0
18	21880098	.	T	C	15	0	15	0	8	23	0	0
18	21880191	.	T	C	9	0	9	0	11	20	0	0
18	21884647	.	T	A	6	3	9	20	0	29	0	0
18	21888256	.	C	T	6	6	12	0	1	13	0	0
18	21890428	.	G	C	6	4	10	0	0	10	0	0
18	21891024	.	G	T	8	9	17	0	1	18	0	0
18	21900940	.	A	G	3	4	7	0	0	7	0	0
18	21900961	.	G	A	4	3	7	0	0	7	0	0
18	21904816	.	C	T	0	3	3	0	4	7	0	0
18	21904846	.	T	A	5	7	12	0	0	12	0	0
18	21906745	.	G	A	3	5	8	0	0	8	0	0
18	21906838	.	C	T	5	4	9	0	1	10	0	0
18	21913799	.	A	T	21	16	37	0	0	37	0	0
18	21913907	.	G	C	16	12	28	0	1	29	0	0
18	21913988	.	C	A	14	17	31	0	0	31	0	0
18	21914018	.	C	A	15	11	26	0	0	26	0	0
18	21914225	.	C	T	2	13	15	0	14	29	0	0
18	21914281	.	G	A	10	14	24	0	2	26	0	0
18	21914283	.	C	A	12	14	26	0	1	27	0	0
18	21945619	.	C	T	0	3	3	0	1	4	0	0
18	22002476	.	G	A	10	9	19	0	1	20	0	0
18	22002508	.	C	T	10	13	23	0	4	27	0	0
18	22030967	.	G	A	6	5	11	0	0	11	0	0
18	22030995	.	A	C	6	6	12	0	0	12	0	0
18	22031018	.	T	G	4	5	9	0	0	9	0	0
18	22082366	.	T	C	5	8	13	0	0	13	0	0
18	22232775	.	T	C	3	6	9	0	0	9	0	0
18	22255005	.	C	T	2	7	9	0	1	10	0	0
18	22261064	.	C	A	5	5	10	0	0	10	0	0
18	22267741	.	C	T	4	4	8	0	0	8	0	0
18	22272969	.	C	A	8	9	17	0	0	17	0	0
18	22275051	.	T	C	8	11	19	0	0	19	0	0
18	22282766	.	A	T	8	11	19	0	3	22	0	0
18	22282809	.	A	T	13	6	19	0	0	19	0	0
18	22282923	.	G	T	11	13	24	0	0	24	0	0
18	22282960	.	C	T	12	12	24	0	0	24	0	0
18	22282961	.	A	G	11	11	22	0	2	24	0	0
18	22283087	.	C	A	9	5	14	0	1	15	0	0
18	22283116	.	T	A	9	6	15	0	0	15	0	0
18	22288650	.	T	C	20	9	29	0	1	30	0	0
18	22288659	.	C	T	17	9	26	0	2	28	0	0
18	22289075	.	T	C	9	15	24	0	0	24	0	0
18	22289314	.	C	T	11	11	22	0	0	22	0	0
18	22290900	.	G	A	21	14	35	0	3	38	0	0
18	22290933	.	C	T	17	12	29	0	0	30	1	0
18	22292215	.	A	T	16	9	25	0	0	25	0	0
18	22292286	.	G	A	14	17	31	0	0	31	0	0
18	22292339	.	A	T	13	18	31	0	4	35	0	0
18	22356989	.	C	T	18	15	33	0	0	33	0	0
18	22377096	.	A	T	16	24	40	0	0	40	0	0
18	22377372	.	G	A	2	28	30	0	20	50	0	0
18	22377471	.	C	T	17	29	46	0	0	46	0	0
18	22385900	.	G	A	34	17	51	0	3	54	0	0
18	22405895	.	A	T	4	7	11	0	0	11	0	0
18	22406162	.	C	T	0	1	1	0	3	4	0	0
18	22406187	.	T	A	2	5	7	0	0	7	0	0
18	22406311	.	T	A	3	7	10	0	0	10	0	0
18	22406324	.	G	A	4	6	10	0	0	10	0	0
18	22406375	.	T	A	4	3	7	0	0	7	0	0
18	22406379	.	G	A	3	4	7	0	0	7	0	0
18	22406728	.	A	T	1	2	3	0	0	3	0	0
18	22406797	.	A	T	1	2	3	0	0	3	0	0
18	22407365	.	C	T	2	8	10	0	7	17	0	0
18	22410983	.	G	A	5	7	12	0	0	12	0	0
18	22414504	.	A	C	5	3	8	0	0	8	0	0
18	22414542	.	T	G	4	5	9	0	1	10	0	0
18	22417058	.	C	T	8	10	18	0	0	18	0	0
18	22417082	.	G	A	1	7	8	0	8	16	0	0
18	22417103	.	C	A	8	4	12	0	0	12	0	0
18	22420551	.	A	T	8	10	18	0	0	18	0	0
18	22420558	.	C	A	8	11	19	0	0	19	0	0
18	22424532	.	T	C	7	7	14	0	0	14	0	0
18	22424536	.	A	G	7	0	7	0	10	17	0	0
18	22424601	.	A	G	7	0	7	0	13	20	0	0
18	22486579	.	A	T	3	5	8	0	0	8	0	0
18	22669708	.	C	G	2	9	11	0	0	11	0	0
18	22679242	.	A	T	3	4	7	0	0	7	0	0
18	22679275	.	C	T	10	4	14	0	0	14	0	0
18	22679444	.	T	G	3	4	7	0	1	8	0	0
18	22679540	.	C	T	1	8	9	0	0	9	0	0
18	22679684	.	G	A	5	5	10	0	0	10	0	0
18	22679786	.	C	T	5	7	12	0	0	12	0	0
18	22679834	.	C	T	5	7	12	0	1	13	0	0
18	22679852	.	C	T	5	5	10	0	0	10	0	0
18	22685266	.	G	A	0	7	7	0	10	17	0	0
18	22685278	.	C	T	10	9	19	0	0	19	0	0
18	22685329	.	T	C	12	16	28	0	1	29	0	0
18	22685380	.	A	T	8	20	28	0	0	28	0	0
18	22685608	.	C	A	8	12	20	0	1	21	0	0
18	22686269	.	A	T	12	10	22	0	0	22	0	0
18	22686320	.	G	A	6	4	10	0	1	11	0	0
18	22686358	.	G	A	4	2	6	0	1	7	0	0
18	22686588	.	C	A	6	3	9	0	1	10	0	0
18	22686723	.	C	T	6	10	16	0	0	16	0	0
18	22686789	.	G	A	14	3	17	0	1	18	0	0
18	22686795	.	C	G	16	4	20	0	1	21	0	0
18	22686927	.	G	A	0	8	8	0	0	9	1	0
18	22687312	.	G	A	10	11	21	0	1	22	0	0
18	22687527	.	G	C	11	15	26	0	0	26	0	0
18	22687575	.	T	A	16	21	37	0	0	37	0	0
18	22687599	.	A	T	19	13	32	0	1	33	0	0
18	22687666	.	C	T	14	13	27	2	0	29	0	0
18	22728794	.	A	G	11	12	23	0	0	23	0	0
18	22732391	.	A	G	18	11	29	0	0	29	0	0
18	22740067	.	A	G	1	2	3	0	0	3	0	0
18	22921942	.	C	T	26	27	53	0	2	55	0	0
18	22921950	.	T	C	27	28	55	0	0	55	0	0
18	22975090	.	T	C	29	31	60	0	1	61	0	0
18	22975297	.	A	C	29	28	57	0	1	58	0	0
18	23071190	.	G	A	1	2	3	0	0	3	0	0
18	23071396	.	T	G	4	3	7	0	0	7	0	0
18	23072082	.	G	T	2	4	6	0	0	6	0	0
18	23072326	.	A	G	1	0	1	0	2	3	0	0
18	23200303	.	G	A	0	6	6	0	10	16	0	0
18	23249388	.	G	A	0	9	9	0	11	20	0	0
18	23270093	.	C	T	12	7	19	0	0	19	0	0
18	23869134	.	C	T	17	22	39	0	2	41	0	0
18	23869784	.	T	A	15	25	40	0	2	42	0	0
18	23870092	.	G	A	23	26	49	0	1	50	0	0
18	23870837	.	C	T	19	11	30	0	0	30	0	0
18	24922149	.	G	A	6	3	9	0	1	10	0	0
18	24929460	.	G	A	1	13	14	0	10	24	0	0
18	24929465	.	T	C	14	10	24	0	2	26	0	0
18	24930189	.	G	A	15	9	24	0	2	26	0	0
18	24930530	.	T	C	10	14	24	0	0	24	0	0
18	24930758	.	T	C	14	18	32	0	1	33	0	0
18	24931044	.	T	A	17	16	33	0	3	36	0	0
18	24931634	.	A	G	16	30	46	0	2	48	0	0
18	24931660	.	G	T	15	22	37	0	2	39	0	0
18	24934333	.	A	T	7	4	11	0	1	12	0	0
18	24934456	.	G	A	17	15	32	0	1	33	0	0
18	24934692	.	C	A	9	6	15	0	0	15	0	0
18	24935099	.	A	G	14	13	27	0	1	28	0	0
18	24938712	.	A	G	6	11	17	0	1	18	0	0
18	24938805	.	A	G	11	13	24	0	0	24	0	0
18	24938871	.	T	C	13	12	25	1	1	27	0	0
18	24938919	.	C	T	9	11	20	0	0	20	0	0
18	24944039	.	A	T	14	10	24	0	1	25	0	0
18	24944045	.	T	C	12	10	22	0	1	23	0	0
18	24946727	.	T	A	11	7	18	0	0	18	0	0
18	24947618	.	G	A	8	8	16	0	0	16	0	0
18	24950214	.	C	T	9	4	13	0	0	13	0	0
18	24952245	.	T	G	13	9	22	0	1	23	0	0
18	24959289	.	G	A	4	4	8	0	0	8	0	0
18	24966110	.	G	A	6	6	12	0	0	12	0	0
18	24968639	.	C	T	6	3	9	0	0	9	0	0
18	24984682	.	T	A	3	4	7	0	0	7	0	0
18	24988707	.	T	A	4	4	8	0	0	8	0	0
18	24989025	.	T	A	3	2	5	0	1	6	0	0
18	24989420	.	G	A	3	5	8	0	1	9	0	0
18	24989427	.	G	T	5	4	9	0	0	9	0	0
18	25003359	.	A	T	12	15	27	0	0	27	0	0
18	25003448	.	G	C	12	10	22	0	0	22	0	0
18	25009326	.	C	A	8	14	22	0	0	22	0	0
18	25009352	.	G	A	15	11	26	0	0	26	0	0
18	25009487	.	A	G	4	4	8	0	0	8	0	0
18	25027750	.	C	G	4	2	6	0	0	6	0	0
18	25037057	.	T	A	4	2	6	0	0	6	0	0
18	25084441	.	C	T	2	3	5	0	0	5	0	0
18	25177111	.	C	T	4	3	7	0	0	7	0	0
18	25177122	.	G	A	4	3	7	0	0	7	0	0
18	25177158	.	C	T	3	2	5	0	0	5	0	0
18	25563379	.	C	T	2	4	6	0	0	6	0	0
18	25568888	.	T	C	1	4	5	0	0	5	0	0
18	25577706	.	C	T	3	2	5	0	0	5	0	0
18	25754551	.	G	A	4	6	10	0	1	11	0	0
18	25754580	.	G	T	5	2	7	0	0	7	0	0
18	25783752	.	G	A	7	7	14	0	0	14	0	0
18	25783851	.	C	G	13	3	16	0	0	16	0	0
18	25783992	.	C	T	4	4	8	0	0	8	0	0
18	25784146	.	C	A	0	3	3	0	2	5	0	0
18	25784196	.	A	T	8	6	14	0	0	14	0	0
18	25825107	.	G	A	6	3	9	0	0	9	0	0
18	25855449	.	A	G	1	3	4	0	0	4	0	0
18	26089004	.	G	C	5	5	10	0	0	10	0	0
18	26089254	.	A	T	4	4	8	0	1	9	0	0
18	26089305	.	G	C	10	5	15	0	0	15	0	0
18	26089657	.	C	T	7	4	11	0	1	12	0	0
18	26094421	.	C	T	4	5	9	0	1	10	0	0
18	26094491	.	A	C	8	8	16	0	0	16	0	0
18	26097091	.	G	T	33	32	65	0	3	68	0	0
18	26097428	.	G	A	31	31	62	0	7	69	0	0
18	26125983	.	A	G	1	2	3	0	0	3	0	0
18	26126046	.	C	T	8	5	13	0	0	13	0	0
18	26338420	.	C	T	18	13	31	0	2	33	0	0
18	26362401	.	A	G	12	12	24	0	1	25	0	0
18	26393716	.	C	A	26	27	53	0	1	54	0	0
18	26401680	.	T	C	36	25	61	0	2	63	0	0
18	26401719	.	T	C	28	21	49	0	4	53	0	0
18	26401743	.	C	T	20	28	48	0	0	48	0	0
18	26405271	.	G	A	17	29	46	0	1	47	0	0
18	26422751	.	G	C	2	2	4	0	0	4	0	0
18	26425376	.	G	A	4	5	9	0	0	9	0	0
18	26426448	.	G	A	5	3	8	0	0	8	0	0
18	26444942	.	C	T	1	2	3	0	0	3	0	0
18	26445228	.	C	T	1	5	6	0	0	6	0	0
18	26460594	.	G	A	4	7	11	0	0	11	0	0
18	26460822	.	G	C	5	15	20	0	0	20	0	0
18	26460846	.	C	A	5	13	18	0	0	18	0	0
18	26474249	.	A	G	8	4	12	0	1	13	0	0
18	26476133	.	C	T	8	11	19	0	0	19	0	0
18	26480081	.	C	T	3	4	7	0	1	8	0	0
18	26502584	.	A	G	10	10	20	2	0	22	0	0
18	26679632	.	C	T	2	4	6	0	0	6	0	0
18	26679646	.	G	T	2	3	5	0	0	5	0	0
18	26776182	.	A	G	6	3	9	0	0	9	0	0
18	26778264	.	A	G	3	7	10	0	0	10	0	0
18	26793948	.	G	A	11	13	24	0	1	25	0	0
18	26800167	.	C	G	5	10	15	0	0	15	0	0
18	26800198	.	T	C	11	3	14	0	0	14	0	0
18	26800280	.	G	A	7	9	16	0	2	18	0	0
18	26800418	.	T	C	12	14	26	0	0	26	0	0
18	26804233	.	T	A	5	5	10	0	0	10	0	0
18	26811801	.	T	G	3	2	5	0	1	6	0	0
18	26863681	.	T	C	4	1	5	0	5	10	0	0
18	26870137	.	G	A	6	10	16	0	0	16	0	0
18	26870469	.	G	C	4	7	11	0	0	11	0	0
18	26874553	.	G	A	3	5	8	0	1	9	0	0
18	26876449	.	A	C	5	5	10	0	0	10	0	0
18	26885718	.	C	T	3	3	6	0	0	6	0	0
18	26891630	.	C	T	6	2	8	0	1	9	0	0
18	26891644	.	C	G	3	5	8	0	0	8	0	0
18	26894677	.	G	A	3	7	10	0	0	10	0	0
18	26896277	.	T	C	5	10	15	0	1	16	0	0
18	26896571	.	C	T	9	8	17	0	0	17	0	0
18	26909470	.	G	A	3	22	25	0	18	43	0	0
18	26913949	.	C	T	30	22	52	0	3	55	0	0
18	26919226	.	C	T	8	10	18	0	3	21	0	0
18	26919989	.	T	A	25	16	41	0	0	41	0	0
18	26968799	.	G	A	8	8	16	0	1	17	0	0
18	26971731	.	A	G	2	4	6	0	0	6	0	0
18	26971868	.	T	C	2	6	8	0	0	8	0	0
18	26971899	.	C	G	3	3	6	0	0	6	0	0
18	26977226	.	T	C	3	2	5	0	0	5	0	0
18	26977837	.	C	T	3	6	9	0	0	10	1	0
18	27007885	.	G	A	0	2	2	0	2	4	0	0
18	27007966	.	C	A	1	2	3	0	0	3	0	0
18	27063668	.	G	A	0	2	2	0	3	5	0	0
18	27063722	.	C	T	5	2	7	0	0	7	0	0
18	27063756	.	C	T	4	2	6	0	0	6	0	0
18	27063809	.	C	T	1	3	4	0	1	5	0	0
18	27063996	.	C	A	2	2	4	0	0	4	0	0
18	27066063	.	C	T	4	5	9	0	0	9	0	0
18	27066080	.	T	A	5	3	8	0	0	8	0	0
18	27072144	.	A	C	5	4	9	0	0	10	1	0
18	27072226	.	C	A	9	6	15	0	0	15	0	0
18	27072690	.	C	T	7	4	11	0	0	11	0	0
18	27072697	.	G	A	6	4	10	0	0	10	0	0
18	27078019	.	C	T	2	2	4	0	0	4	0	0
18	27080674	.	G	A	3	5	8	0	0	8	0	0
18	27085408	.	G	A	1	2	3	0	0	3	0	0
18	27241292	.	G	A	0	2	2	0	1	3	0	0
18	27252533	.	G	A	3	3	6	0	0	6	0	0
18	27252712	.	G	A	2	2	4	0	0	4	0	0
18	27252728	.	G	T	5	2	7	0	0	7	0	0
18	27254538	.	G	A	7	6	13	0	0	13	0	0
18	27254726	.	T	C	5	2	7	0	0	7	0	0
18	27254774	.	T	C	6	2	8	0	0	8	0	0
18	27281673	.	T	G	3	3	6	0	1	7	0	0
18	27281679	.	A	G	4	0	4	0	4	8	0	0
18	27283304	.	C	T	4	4	8	0	0	8	0	0
18	27285337	.	C	T	3	3	6	0	0	6	0	0
18	27285764	.	C	T	1	4	5	0	0	5	0	0
18	27309555	.	G	A	4	5	9	0	0	9	0	0
18	27335597	.	G	A	5	8	13	1	0	14	0	0
18	27335740	.	T	A	11	9	20	0	0	20	0	0
18	27335780	.	A	T	4	6	10	0	0	10	0	0
18	27341170	.	C	T	9	4	13	0	0	13	0	0
18	27358709	.	A	G	3	4	7	0	1	8	0	0
18	27358744	.	G	C	4	4	8	0	0	8	0	0
18	27568352	.	A	G	9	7	16	0	0	16	0	0
18	27620625	.	G	T	3	2	5	0	0	5	0	0
18	27624354	.	C	T	6	3	9	0	0	9	0	0
18	27625675	.	A	T	2	4	6	0	0	6	0	0
18	27625814	.	A	C	2	3	5	0	0	5	0	0
18	27732389	.	T	C	18	15	33	0	0	33	0	0
18	27802795	.	C	T	24	15	39	0	0	39	0	0
18	27812400	.	T	G	19	0	19	0	17	36	0	0
18	27812429	.	T	C	13	18	31	0	1	32	0	0
18	27812618	.	T	A	15	21	36	0	1	37	0	0
18	27927010	.	C	G	4	3	7	0	0	7	0	0
18	27927510	.	A	G	3	0	3	0	7	10	0	0
18	27927528	.	A	T	3	5	8	0	1	9	0	0
18	27970182	.	A	T	11	5	16	0	0	16	0	0
18	27981137	.	A	C	9	8	17	0	0	17	0	0
18	27982320	.	A	G	6	8	14	0	0	14	0	0
18	27984021	.	A	G	9	0	9	0	6	15	0	0
18	27984026	.	C	T	7	5	12	0	1	13	0	0
18	27984080	.	C	T	7	7	14	0	0	14	0	0
18	27988481	.	G	C	9	6	15	0	0	15	0	0
18	27988509	.	T	C	8	9	17	0	2	19	0	0
18	27993392	.	T	G	9	10	19	0	0	19	0	0
18	27993625	.	C	A	6	6	12	0	0	12	0	0
18	28106305	.	T	A	6	9	15	0	0	15	0	0
18	28106790	.	A	G	11	0	11	0	11	22	0	0
18	28123612	.	T	C	6	7	13	0	1	14	0	0
18	28564674	.	T	A	10	4	14	0	0	14	0	0
18	28564737	.	T	C	8	6	14	0	1	15	0	0
18	28564777	.	G	A	7	9	16	0	0	16	0	0
18	28564785	.	A	G	8	7	15	0	0	15	0	0
18	28564856	.	G	T	6	4	10	0	0	10	0	0
18	28564858	.	G	A	3	4	7	0	4	11	0	0
18	28564923	.	G	A	5	4	9	0	5	14	0	0
18	28564947	.	A	G	5	5	10	0	0	10	0	0
18	28565025	.	C	T	13	9	22	0	1	23	0	0
18	28606134	.	C	A	4	7	11	0	0	11	0	0
18	28606191	.	A	G	9	0	9	0	12	21	0	0
18	28821784	.	A	G	2	5	7	0	0	7	0	0
18	28852198	.	A	T	5	6	11	0	0	11	0	0
18	28852204	.	A	G	4	6	10	0	1	11	0	0
18	28867342	.	T	C	4	4	8	0	0	8	0	0
18	28876524	.	C	G	15	17	32	0	0	32	0	0
18	28876569	.	A	G	17	1	18	0	12	30	0	0
18	28879736	.	G	T	0	9	9	0	11	20	0	0
18	28879758	.	C	G	12	10	22	0	1	23	0	0
18	28879847	.	G	T	8	9	17	0	0	17	0	0
18	29008407	.	C	T	16	17	33	0	1	34	0	0
18	29058989	.	C	T	7	6	13	0	3	17	1	0
18	29059194	.	A	G	9	5	14	0	2	16	0	0
18	29402674	.	A	G	3	1	4	0	3	7	0	0
18	29403241	.	G	T	0	3	3	0	2	5	0	0
18	29403433	.	G	T	3	4	7	0	0	7	0	0
18	29886272	.	G	A	2	5	7	0	0	7	0	0
18	29886275	.	C	T	2	5	7	0	0	7	0	0
18	29888072	.	A	T	1	3	4	0	0	4	0	0
18	29888321	.	G	A	1	2	3	0	0	3	0	0
18	29888358	.	G	A	2	2	4	0	1	5	0	0
18	29888360	.	T	G	3	2	5	0	0	5	0	0
18	29888526	.	T	C	1	2	3	0	0	3	0	0
18	29888576	.	A	G	1	3	4	0	0	4	0	0
18	29888586	.	C	T	1	2	3	0	0	3	0	0
18	29898173	.	A	C	8	8	16	0	1	17	0	0
18	29898187	.	T	A	8	7	15	0	1	16	0	0
18	29898341	.	A	G	5	4	9	0	0	9	0	0
18	29950442	.	A	G	5	3	8	0	1	9	0	0
18	29953405	.	T	C	7	7	14	0	2	16	0	0
18	29953867	.	G	A	7	7	14	0	2	16	0	0
18	29954445	.	T	A	2	5	7	0	0	7	0	0
18	29954824	.	C	A	6	9	15	0	0	15	0	0
18	29954918	.	C	T	4	14	18	0	0	18	0	0
18	29954929	.	T	C	4	10	14	0	1	15	0	0
18	29959268	.	A	C	2	2	4	0	0	4	0	0
18	29961398	.	C	T	0	2	2	0	2	4	0	0
18	29961466	.	G	C	3	2	5	0	0	5	0	0
18	29969920	.	A	T	4	5	9	0	0	9	0	0
18	29970458	.	C	G	14	11	25	0	1	26	0	0
18	29970559	.	T	G	18	9	27	0	0	27	0	0
18	29970809	.	A	T	2	2	4	0	0	4	0	0
18	29970817	.	G	A	2	2	4	0	0	4	0	0
18	29970954	.	G	C	1	3	4	0	0	4	0	0
18	29971486	.	C	G	1	2	3	0	0	3	0	0
18	29976560	.	C	A	8	9	17	0	0	17	0	0
18	29976561	.	A	T	8	9	17	0	0	17	0	0
18	29977423	.	C	T	7	8	15	0	0	15	0	0
18	29977753	.	C	T	5	10	15	0	1	16	0	0
18	29977784	.	T	A	8	9	17	0	2	19	0	0
18	29977789	.	C	T	10	8	18	0	0	18	0	0
18	29978794	.	A	T	8	5	13	0	0	13	0	0
18	29978848	.	A	G	9	4	13	0	1	14	0	0
18	29979860	.	A	G	5	3	8	0	0	8	0	0
18	29980462	.	A	G	7	4	11	0	0	11	0	0
18	29980474	.	A	G	8	5	13	0	0	13	0	0
18	29980560	.	A	G	8	4	12	0	0	12	0	0
18	29980584	.	C	T	7	3	10	0	1	11	0	0
18	30014561	.	G	A	4	8	12	0	0	12	0	0
18	30020802	.	C	T	2	3	5	0	0	5	0	0
18	30020875	.	C	G	2	4	6	0	0	6	0	0
18	30021313	.	C	A	4	4	8	0	0	8	0	0
18	30021380	.	A	C	7	0	7	0	4	11	0	0
18	30370469	.	T	C	3	6	9	0	0	9	0	0
18	30441825	.	G	A	2	14	16	0	13	29	0	0
18	30463346	.	C	T	8	10	18	0	0	18	0	0
18	30466712	.	A	T	7	20	27	0	3	30	0	0
18	30467010	.	A	G	11	0	11	0	8	19	0	0
18	30470471	.	A	G	21	10	31	0	2	33	0	0
18	30470929	.	T	C	26	12	38	0	0	38	0	0
18	30470930	.	G	A	24	11	35	0	4	39	0	0
18	30473566	.	C	G	8	0	8	0	12	20	0	0
18	30473905	.	A	G	12	1	13	0	19	32	0	0
18	30476837	.	G	A	16	11	27	0	1	28	0	0
18	30477289	.	G	T	10	9	19	0	0	19	0	0
18	30477469	.	C	T	14	9	23	0	0	23	0	0
18	30477495	.	T	G	11	10	21	0	2	23	0	0
18	30477616	.	A	G	9	10	19	0	0	19	0	0
18	30477625	.	C	T	10	9	19	0	0	19	0	0
18	30477889	.	C	T	22	17	39	0	0	39	0	0
18	30478113	.	A	G	22	0	22	0	13	35	0	0
18	30478156	.	C	T	29	18	47	0	1	48	0	0
18	30492528	.	A	C	2	3	5	0	0	5	0	0
18	30500912	.	G	T	4	3	7	0	0	7	0	0
18	30501194	.	T	C	3	6	9	0	0	9	0	0
18	30501298	.	C	A	8	6	14	0	0	14	0	0
18	30501393	.	G	A	9	5	14	0	0	14	0	0
18	30501639	.	A	G	7	5	12	0	1	13	0	0
18	30501701	.	T	C	10	11	21	0	0	21	0	0
18	30503562	.	T	C	6	0	6	0	11	17	0	0
18	30504366	.	C	T	9	10	19	0	0	19	0	0
18	30511260	.	C	A	6	3	9	0	0	9	0	0
18	30556895	.	G	A	2	5	7	0	2	9	0	0
18	30564199	.	A	G	5	0	5	0	5	10	0	0
18	30564240	.	A	T	4	9	13	0	0	13	0	0
18	30564301	.	C	A	1	6	7	0	0	7	0	0
18	30564334	.	T	G	2	7	9	0	0	9	0	0
18	30564342	.	G	T	2	10	12	0	0	12	0	0
18	30564385	.	T	G	5	9	14	0	0	14	0	0
18	30564443	.	A	T	3	4	7	0	0	7	0	0
18	30564451	.	G	C	0	3	3	0	3	7	1	0
18	30564598	.	A	G	4	2	6	0	0	6	0	0
18	30570982	.	C	T	2	2	4	0	0	4	0	0
18	31033267	.	C	T	0	12	12	0	3	15	0	0
18	31036721	.	A	T	3	5	8	0	1	9	0	0
18	31036722	.	C	A	3	6	9	0	0	9	0	0
18	31041640	.	G	A	8	4	12	0	0	12	0	0
18	31057911	.	C	T	3	3	6	0	0	6	0	0
18	31058577	.	A	G	1	2	3	0	1	4	0	0
18	31058647	.	G	A	0	2	2	0	2	4	0	0
18	31064706	.	A	G	11	0	11	0	12	23	0	0
18	31064734	.	G	A	7	8	15	0	0	15	0	0
18	31068392	.	A	C	6	6	12	0	1	13	0	0
18	31068463	.	A	G	3	2	5	0	0	5	0	0
18	31105257	.	G	A	11	12	23	0	1	24	0	0
18	31151851	.	G	A	8	3	11	0	1	12	0	0
18	31152058	.	G	A	3	4	7	0	0	7	0	0
18	31152067	.	G	A	4	3	7	0	0	7	0	0
18	31152920	.	A	G	3	5	8	0	0	8	0	0
18	31152946	.	C	A	1	4	5	0	0	5	0	0
18	31201750	.	T	C	11	10	21	0	0	21	0	0
18	31281034	.	G	C	1	13	14	0	9	23	0	0
18	31281161	.	T	A	13	13	26	0	1	27	0	0
18	31281186	.	T	C	14	12	26	0	0	26	0	0
18	31281254	.	G	A	12	12	24	0	1	25	0	0
18	31775711	.	G	A	0	6	6	0	7	13	0	0
18	33729298	.	A	G	5	0	5	0	2	7	0	0
18	33729299	.	G	C	5	2	7	0	0	7	0	0
18	33982078	.	G	T	5	7	12	0	1	13	0	0
18	33982224	.	G	A	1	2	3	0	0	3	0	0
18	33982423	.	A	C	14	9	23	0	0	23	0	0
18	33982591	.	T	C	13	13	26	1	1	28	0	0
18	33982811	.	C	T	1	12	13	0	7	20	0	0
18	33983154	.	G	A	22	15	37	0	0	37	0	0
18	33983165	.	T	C	24	15	39	0	1	40	0	0
18	33983300	.	A	C	10	0	10	0	18	28	0	0
18	33983564	.	T	A	10	10	20	0	1	21	0	0
18	33983641	.	T	C	15	9	24	4	0	28	0	0
18	33983771	.	A	C	11	14	25	0	0	25	0	0
18	33984153	.	A	G	7	22	29	0	2	31	0	0
18	33984191	.	C	A	10	13	23	0	3	26	0	0
18	33984215	.	G	T	13	8	21	1	2	24	0	0
18	33984235	.	T	A	17	4	21	1	0	22	0	0
18	33984443	.	G	A	2	2	4	0	0	4	0	0
18	33984596	.	G	A	15	11	26	0	0	26	0	0
18	33984801	.	A	C	7	8	15	0	0	15	0	0
18	33985249	.	T	C	14	13	27	0	1	28	0	0
18	33985414	.	T	C	12	0	12	0	18	30	0	0
18	33985953	.	C	T	15	12	27	0	0	27	0	0
18	33986027	.	A	G	14	16	30	0	0	30	0	0
18	33986199	.	C	T	11	20	31	0	1	32	0	0
18	33986391	.	C	T	11	9	20	0	1	21	0	0
18	33986395	.	A	G	10	10	20	0	1	21	0	0
18	33986470	.	T	C	7	12	19	0	1	20	0	0
18	33988590	.	C	T	1	7	8	0	12	20	0	0
18	33988743	.	A	C	12	0	12	0	13	25	0	0
18	33999714	.	C	G	9	13	22	0	0	22	0	0
18	33999923	.	G	A	9	6	15	0	2	17	0	0
18	34015365	.	T	C	7	7	14	0	0	14	0	0
18	34043325	.	G	A	5	8	13	1	0	14	0	0
18	34046381	.	C	T	2	8	10	1	0	11	0	0
18	34050813	.	A	G	6	7	13	0	1	14	0	0
18	34146890	.	C	T	2	3	5	0	0	5	0	0
18	34156693	.	A	T	4	2	6	0	0	6	0	0
18	34158339	.	C	T	1	4	5	0	0	5	0	0
18	34160136	.	G	T	4	5	9	0	0	9	0	0
18	34161179	.	A	G	6	2	8	0	0	8	0	0
18	34162053	.	T	C	4	5	9	0	1	10	0	0
18	34163687	.	A	G	5	3	8	1	0	9	0	0
18	34189368	.	C	T	4	5	9	0	1	10	0	0
18	34189614	.	G	A	1	9	10	0	7	17	0	0
18	34195231	.	A	G	11	9	20	0	2	22	0	0
18	34195318	.	C	A	5	6	11	0	2	13	0	0
18	34195336	.	A	T	7	6	13	0	0	13	0	0
18	34196270	.	G	C	6	8	14	0	0	14	0	0
18	34207700	.	G	A	10	6	16	0	1	17	0	0
18	34213351	.	C	T	4	6	10	0	0	10	0	0
18	34213378	.	A	T	3	6	9	0	1	10	0	0
18	34213414	.	T	C	4	4	8	0	0	8	0	0
18	34213426	.	T	C	5	2	7	0	0	7	0	0
18	34213530	.	G	A	0	9	9	0	7	16	0	0
18	34213995	.	A	T	5	9	14	0	0	14	0	0
18	34214054	.	C	T	6	7	13	0	0	13	0	0
18	34214141	.	T	G	7	5	12	0	0	12	0	0
18	34214280	.	A	T	11	8	19	0	0	19	0	0
18	34214288	.	G	T	8	13	21	0	2	23	0	0
18	34214478	.	A	G	10	0	10	0	5	15	0	0
18	34214754	.	C	G	16	16	32	0	0	32	0	0
18	34214894	.	T	C	12	11	23	1	0	24	0	0
18	34362633	.	A	T	1	3	4	0	0	4	0	0
18	34534807	.	G	T	9	5	14	0	0	14	0	0
18	34535184	.	A	G	4	9	13	0	0	13	0	0
18	34535235	.	C	T	6	7	13	0	1	14	0	0
18	34535302	.	A	C	5	3	8	0	1	9	0	0
18	34535423	.	A	G	7	6	13	0	0	13	0	0
18	34535518	.	T	C	2	6	8	0	1	9	0	0
18	34535695	.	A	T	5	5	10	0	0	10	0	0
18	34535769	.	T	C	6	8	14	0	1	15	0	0
18	34542620	.	C	A	10	10	20	0	0	20	0	0
18	34601008	.	C	A	8	10	18	0	3	21	0	0
18	34601042	.	A	C	12	14	26	0	3	29	0	0
18	34601323	.	T	G	9	10	19	0	1	20	0	0
18	34601468	.	G	T	4	14	18	0	0	18	0	0
18	34601471	.	A	T	3	13	16	0	0	16	0	0
18	34641352	.	A	C	7	11	18	0	5	23	0	0
18	34641439	.	T	C	16	17	33	0	1	34	0	0
18	34641442	.	T	C	17	16	33	0	2	35	0	0
18	34641622	.	C	G	5	14	19	0	0	19	0	0
18	34641633	.	T	C	9	12	21	0	1	22	0	0
18	35143143	.	T	A	3	3	6	0	0	6	0	0
18	35143242	.	G	T	1	5	6	0	0	6	0	0
18	35179690	.	G	A	0	2	2	0	1	3	0	0
18	35181856	.	A	G	2	3	5	0	1	6	0	0
18	35181919	.	T	C	4	2	6	0	0	6	0	0
18	35238247	.	T	C	3	4	7	0	0	7	0	0
18	35238632	.	G	T	0	2	2	0	5	7	0	0
18	35246809	.	G	A	2	3	5	0	0	5	0	0
18	35251104	.	C	T	3	6	9	0	0	9	0	0
18	35251139	.	C	G	3	0	3	0	4	7	0	0
18	35251214	.	A	C	6	3	9	0	0	9	0	0
18	35251249	.	T	C	4	2	6	0	0	6	0	0
18	35251258	.	G	A	0	1	1	0	4	5	0	0
18	35405389	.	T	C	11	0	11	0	26	37	0	0
18	35406987	.	G	A	21	13	34	0	0	34	0	0
18	35413439	.	T	A	4	2	6	0	0	6	0	0
18	35413451	.	A	C	5	2	7	0	0	7	0	0
18	35429444	.	G	A	2	2	4	0	0	4	0	0
18	35439024	.	T	A	3	2	5	0	0	5	0	0
18	35440658	.	A	G	2	2	4	0	0	4	0	0
18	35443425	.	A	G	1	2	3	0	0	3	0	0
18	35491518	.	A	T	13	18	31	0	0	31	0	0
18	35497031	.	A	C	14	8	22	0	0	22	0	0
18	35501357	.	G	A	14	12	26	0	0	26	0	0
18	35503636	.	A	G	11	10	21	0	0	21	0	0
18	35503654	.	C	T	8	16	24	0	0	24	0	0
18	35503705	.	A	G	7	18	25	0	0	25	0	0
18	35508139	.	C	A	1	8	9	0	7	16	0	0
18	35508151	.	A	T	7	10	17	0	0	17	0	0
18	35508304	.	C	T	12	11	23	1	1	25	0	0
18	35509705	.	G	A	7	10	17	0	0	17	0	0
18	35510290	.	G	T	10	10	20	0	2	22	0	0
18	35510590	.	C	A	7	4	11	0	0	11	0	0
18	35510812	.	G	A	7	8	15	0	0	15	0	0
18	35520248	.	G	A	9	17	26	0	0	26	0	0
18	35520281	.	T	C	10	1	11	0	11	22	0	0
18	35528859	.	C	T	2	11	13	0	0	13	0	0
18	35529482	.	T	G	7	7	14	0	1	15	0	0
18	35548017	.	C	T	4	6	10	0	0	10	0	0
18	35561469	.	A	C	4	0	4	0	7	11	0	0
18	35561496	.	T	G	2	6	8	0	2	10	0	0
18	35561547	.	C	T	7	6	13	0	0	13	0	0
18	35562303	.	C	T	4	4	8	0	1	9	0	0
18	35565108	.	A	G	7	5	12	0	0	12	0	0
18	35577995	.	T	C	6	4	10	0	0	10	0	0
18	35578016	.	G	T	4	6	10	0	0	10	0	0
18	35579487	.	G	C	3	0	3	0	1	4	0	0
18	35579502	.	G	A	5	2	7	0	0	7	0	0
18	35582682	.	C	T	1	6	7	0	0	7	0	0
18	35582928	.	T	G	4	4	8	0	1	9	0	0
18	35582952	.	G	A	4	4	8	0	1	9	0	0
18	35583885	.	G	C	6	0	6	0	6	12	0	0
18	35583888	.	G	A	6	5	11	0	0	11	0	0
18	35584080	.	A	G	3	2	5	0	0	5	0	0
18	35588246	.	A	G	4	4	8	0	0	8	0	0
18	35679721	.	C	T	0	2	2	0	2	4	0	0
18	35736574	.	C	A	1	4	5	0	0	5	0	0
18	35794289	.	T	C	1	6	7	0	0	7	0	0
18	35801124	.	C	T	5	3	8	0	0	8	0	0
18	35807902	.	A	T	8	8	16	0	1	17	0	0
18	35808137	.	C	T	7	3	10	0	0	10	0	0
18	35808223	.	G	A	5	7	12	0	0	12	0	0
18	35808320	.	A	G	23	14	37	0	1	38	0	0
18	35814745	.	T	G	18	20	38	0	2	40	0	0
18	35827185	.	C	T	14	8	22	0	2	24	0	0
18	35829794	.	T	C	14	12	26	0	2	28	0	0
18	35832858	.	G	T	17	15	32	0	1	33	0	0
18	35832896	.	G	A	15	8	23	0	0	23	0	0
18	35832911	.	G	A	14	8	22	0	0	22	0	0
18	35832931	.	C	T	9	9	18	0	1	19	0	0
18	35833077	.	G	A	8	16	24	0	1	25	0	0
18	35837643	.	A	G	21	9	30	0	1	31	0	0
18	35838817	.	A	G	2	2	4	0	0	4	0	0
18	35839193	.	A	T	3	2	5	0	1	6	0	0
18	35839224	.	T	C	1	4	5	0	0	5	0	0
18	35839375	.	A	T	9	4	13	0	0	13	0	0
18	35839384	.	A	G	8	6	14	0	1	15	0	0
18	35839461	.	T	C	6	7	13	0	1	14	0	0
18	35839512	.	A	G	6	6	12	0	1	13	0	0
18	35839543	.	A	T	12	6	18	0	2	20	0	0
18	35839658	.	T	C	7	8	15	0	0	15	0	0
18	35839673	.	A	G	8	7	15	0	0	15	0	0
18	35839730	.	T	C	8	5	13	0	1	14	0	0
18	35839832	.	G	A	6	4	10	0	1	11	0	0
18	35842419	.	T	C	10	5	15	0	0	15	0	0
18	35842440	.	C	T	1	8	9	0	10	19	0	0
18	35842476	.	C	T	13	8	21	0	0	21	0	0
18	36037258	.	T	C	4	6	10	0	0	10	0	0
18	36065768	.	T	G	6	3	9	0	0	9	0	0
18	36066048	.	T	C	6	5	11	0	0	11	0	0
18	36066054	.	C	G	6	3	9	0	0	9	0	0
18	36066450	.	G	C	7	6	13	0	1	14	0	0
18	36066480	.	A	T	7	10	17	0	2	19	0	0
18	36071039	.	G	T	0	7	7	0	5	12	0	0
18	36071217	.	C	G	7	0	7	0	7	14	0	0
18	36071223	.	G	A	6	7	13	0	1	14	0	0
18	36080616	.	G	T	20	15	35	0	1	36	0	0
18	36080688	.	A	G	17	7	24	0	2	26	0	0
18	36080931	.	T	G	12	5	17	0	0	17	0	0
18	36081009	.	A	C	5	11	16	0	2	18	0	0
18	36081018	.	G	A	5	15	20	0	0	20	0	0
18	36081513	.	C	T	9	15	24	0	1	25	0	0
18	36081792	.	T	C	5	3	8	0	0	8	0	0
18	36106031	.	T	C	15	13	28	0	0	28	0	0
18	36114463	.	T	A	5	16	21	0	2	23	0	0
18	36114464	.	A	C	7	15	22	0	1	23	0	0
18	36129218	.	G	A	12	10	22	0	2	24	0	0
18	36591488	.	G	T	5	5	10	0	0	10	0	0
18	36593564	.	T	C	1	3	4	0	0	4	0	0
18	36593874	.	C	T	6	2	8	0	0	8	0	0
18	36597952	.	C	T	6	5	11	0	0	11	0	0
18	36598075	.	G	A	0	2	2	0	4	6	0	0
18	36598076	.	T	A	3	3	6	0	0	6	0	0
18	36598476	.	G	A	0	2	2	0	1	3	0	0
18	36620186	.	C	T	11	10	21	0	1	22	0	0
18	36623275	.	C	T	5	8	13	0	0	13	0	0
18	36630740	.	T	A	15	9	24	0	2	26	0	0
18	36630867	.	C	T	16	7	23	0	0	23	0	0
18	36645330	.	A	T	3	2	5	0	0	5	0	0
18	36647855	.	C	T	3	4	7	0	0	7	0	0
18	36647925	.	T	G	2	2	4	0	0	4	0	0
18	36769901	.	G	A	2	7	9	0	1	10	0	0
18	36774767	.	T	C	8	5	13	0	1	14	0	0
18	36790413	.	C	T	10	5	15	0	1	16	0	0
18	36793799	.	G	C	6	4	10	0	0	10	0	0
18	36799090	.	C	T	8	6	14	0	0	14	0	0
18	36799167	.	A	C	6	3	9	0	2	11	0	0
18	36799219	.	T	C	5	4	9	0	0	9	0	0
18	36799229	.	T	G	7	3	10	0	0	10	0	0
18	36799680	.	A	G	6	1	7	0	1	8	0	0
18	36800002	.	C	T	3	3	6	0	1	7	0	0
18	36806632	.	A	T	17	19	36	0	0	36	0	0
18	36806657	.	T	A	20	8	28	0	6	34	0	0
18	36806681	.	T	C	18	10	28	0	5	33	0	0
18	36806707	.	C	T	17	9	26	0	0	26	0	0
18	36806727	.	C	T	15	4	19	0	0	19	0	0
18	36806749	.	A	G	15	4	19	0	0	19	0	0
18	36858200	.	T	C	9	9	18	0	0	18	0	0
18	36869052	.	A	G	10	5	15	0	0	15	0	0
18	36869120	.	T	G	6	11	17	0	0	17	0	0
18	36869131	.	G	A	1	10	11	0	8	19	0	0
18	36869180	.	T	C	11	18	29	0	0	29	0	0
18	36869530	.	C	G	5	22	27	0	1	28	0	0
18	36869676	.	A	G	18	16	34	0	0	34	0	0
18	36869677	.	A	G	25	9	34	0	1	35	0	0
18	36869774	.	A	G	13	10	23	1	0	24	0	0
18	36869798	.	A	G	17	11	28	0	0	28	0	0
18	36870068	.	G	A	13	15	28	0	3	31	0	0
18	36870174	.	G	A	17	10	27	0	0	27	0	0
18	36870278	.	G	A	15	12	27	0	2	29	0	0
18	36870378	.	A	G	6	0	6	0	11	17	0	0
18	36870448	.	C	G	12	9	21	0	1	22	0	0
18	36870460	.	T	C	12	9	21	0	1	22	0	0
18	36870702	.	A	T	14	20	34	0	0	34	0	0
18	36949014	.	G	A	3	2	5	0	0	5	0	0
18	36949178	.	A	G	10	6	16	0	0	16	0	0
18	36951690	.	C	T	13	4	17	0	0	17	0	0
18	36951693	.	G	A	12	4	16	0	0	16	0	0
18	36951823	.	G	A	6	5	11	0	1	12	0	0
18	36951829	.	T	C	6	7	13	0	0	13	0	0
18	36951888	.	A	G	10	13	23	0	1	24	0	0
18	36954186	.	A	G	8	4	12	0	0	12	0	0
18	36954230	.	C	T	9	5	14	0	0	14	0	0
18	36954250	.	A	G	6	6	12	0	1	13	0	0
18	36954305	.	G	T	4	4	8	0	0	8	0	0
18	36954314	.	C	T	0	4	4	0	6	10	0	0
18	36954662	.	A	G	6	5	11	0	0	11	0	0
18	36956672	.	G	A	6	5	11	0	1	12	0	0
18	36957310	.	T	C	7	9	16	0	1	17	0	0
18	36959656	.	A	T	8	4	12	0	0	12	0	0
18	36959746	.	T	G	9	9	18	0	1	19	0	0
18	36959767	.	T	C	9	8	17	0	0	17	0	0
18	36963204	.	A	G	6	2	8	0	0	8	0	0
18	36963315	.	T	A	1	5	6	0	0	6	0	0
18	36963563	.	A	G	9	3	12	0	0	12	0	0
18	36964110	.	A	G	3	9	12	0	1	13	0	0
18	37007251	.	C	T	4	7	11	0	2	13	0	0
18	37102133	.	G	T	5	2	7	0	1	8	0	0
18	37102180	.	C	T	1	3	4	0	0	4	0	0
18	37119963	.	C	G	5	4	9	0	0	9	0	0
18	37120215	.	A	T	3	3	6	0	0	6	0	0
18	37120642	.	G	A	1	1	2	0	2	4	0	0
18	37133566	.	G	A	6	5	11	0	0	11	0	0
18	37137271	.	A	G	2	0	2	0	4	6	0	0
18	37143773	.	T	C	4	4	8	0	0	8	0	0
18	37153241	.	A	G	3	0	3	0	3	6	0	0
18	37153334	.	T	A	2	2	4	0	0	4	0	0
18	37153394	.	A	G	1	8	9	0	0	9	0	0
18	37153418	.	C	T	2	6	8	0	0	8	0	0
18	37155941	.	C	A	4	3	7	0	0	7	0	0
18	37190979	.	A	T	5	3	8	0	0	8	0	0
18	37191246	.	C	T	8	7	15	0	0	15	0	0
18	37191286	.	G	A	5	4	9	0	1	10	0	0
18	37191396	.	G	C	9	8	17	0	0	17	0	0
18	37197377	.	A	G	3	0	3	0	3	6	0	0
18	37197464	.	T	C	4	5	9	0	1	10	0	0
18	37200052	.	A	C	3	8	11	0	2	13	0	0
18	37219234	.	T	A	7	2	9	0	0	9	0	0
18	37219246	.	T	C	5	2	7	0	1	8	0	0
18	37219291	.	C	G	5	1	6	0	1	7	0	0
18	37219518	.	A	T	4	1	5	0	0	5	0	0
18	37219541	.	A	G	4	3	7	0	0	7	0	0
18	37219558	.	T	C	3	4	7	0	0	7	0	0
18	37219987	.	T	A	2	6	8	0	0	8	0	0
18	37230433	.	A	G	2	6	8	0	1	9	0	0
18	37230456	.	C	G	3	5	8	0	0	8	0	0
18	37230629	.	T	C	12	7	19	0	0	19	0	0
18	37234081	.	T	C	3	5	8	0	0	8	0	0
18	37234289	.	A	G	2	4	6	0	0	6	0	0
18	37234574	.	T	A	1	3	4	0	0	4	0	0
18	37259911	.	A	G	19	25	44	0	7	51	0	0
18	37260088	.	C	T	2	3	5	0	0	5	0	0
18	37260192	.	A	G	24	0	24	0	13	37	0	0
18	37267398	.	C	A	20	17	37	0	0	37	0	0
18	37267464	.	G	A	25	18	43	0	1	44	0	0
18	37267529	.	G	A	24	17	41	0	0	41	0	0
18	37269904	.	A	G	21	15	36	0	0	36	0	0
18	37270225	.	A	G	16	19	35	0	0	35	0	0
18	37270498	.	C	T	12	6	18	0	2	20	0	0
18	37270598	.	T	G	13	7	20	0	1	21	0	0
18	37285808	.	G	A	3	1	4	0	1	5	0	0
18	37285983	.	G	A	1	2	3	0	0	3	0	0
18	37300883	.	A	G	2	2	4	0	0	4	0	0
18	37351334	.	A	G	3	2	5	0	0	5	0	0
18	37837371	.	C	T	0	16	16	0	18	34	0	0
18	37837511	.	A	G	21	13	34	0	1	35	0	0
18	37837536	.	T	C	23	13	36	0	0	36	0	0
18	37837655	.	A	G	19	11	30	0	1	31	0	0
18	37837706	.	A	C	8	13	21	0	3	24	0	0
18	37837708	.	T	A	7	15	22	0	1	23	0	0
18	37837879	.	G	T	17	9	26	0	1	27	0	0
18	37838160	.	G	T	21	15	36	0	0	36	0	0
18	37838250	.	G	C	25	7	32	0	1	33	0	0
18	37840290	.	A	G	29	24	53	1	0	54	0	0
18	37866417	.	C	T	3	26	29	0	20	49	0	0
18	38193279	.	G	A	1	3	4	0	7	11	0	0
18	38194336	.	C	A	4	12	16	0	0	16	0	0
18	38199482	.	A	G	3	8	11	0	0	11	0	0
18	38202827	.	T	C	10	7	17	0	0	17	0	0
18	38206907	.	A	G	1	3	4	0	0	4	0	0
18	38209458	.	G	C	3	3	6	0	1	7	0	0
18	38209562	.	T	G	2	2	4	0	1	5	0	0
18	38217181	.	A	G	12	11	23	0	0	23	0	0
18	38222514	.	A	G	8	7	15	0	1	16	0	0
18	38223448	.	A	G	8	4	12	0	2	14	0	0
18	38223735	.	A	G	7	6	13	0	0	13	0	0
18	38224672	.	G	T	3	5	8	0	1	9	0	0
18	38224681	.	A	C	2	5	7	0	0	7	0	0
18	38225491	.	A	G	3	5	8	0	0	8	0	0
18	38235716	.	T	G	7	6	13	0	0	13	0	0
18	38235726	.	A	T	6	6	12	0	1	13	0	0
18	38238072	.	T	C	6	4	10	0	0	10	0	0
18	38238833	.	C	A	3	3	6	0	0	6	0	0
18	38238866	.	A	T	2	3	5	0	0	5	0	0
18	38239034	.	A	G	4	6	10	0	0	10	0	0
18	38239040	.	A	G	5	6	11	0	0	11	0	0
18	38239073	.	C	T	6	6	12	0	0	12	0	0
18	38240682	.	T	A	4	7	11	0	0	11	0	0
18	38240685	.	A	G	3	8	11	0	0	11	0	0
18	38248121	.	T	C	7	13	20	0	0	20	0	0
18	38250924	.	A	G	27	10	37	0	3	40	0	0
18	38256265	.	T	C	19	0	19	0	9	28	0	0
18	38256668	.	A	G	16	22	38	0	1	39	0	0
18	38260152	.	T	C	17	9	26	0	0	26	0	0
18	38260330	.	A	G	14	12	26	0	1	27	0	0
18	38260352	.	C	A	19	8	27	0	1	28	0	0
18	38260377	.	C	T	18	7	25	0	0	25	0	0
18	38263910	.	G	C	15	14	29	0	1	30	0	0
18	38266979	.	C	T	11	17	28	0	1	29	0	0
18	38270559	.	T	C	12	8	20	0	0	20	0	0
18	38296046	.	C	G	2	8	10	0	0	10	0	0
18	38296089	.	G	T	6	4	10	0	0	10	0	0
18	38296321	.	G	A	1	2	3	0	0	3	0	0
18	38296452	.	A	C	3	2	5	0	0	5	0	0
18	38296467	.	T	C	2	3	5	0	0	5	0	0
18	39172728	.	A	T	1	8	9	0	0	9	0	0
18	41267668	.	A	G	6	6	12	0	0	12	0	0
18	41267988	.	T	A	10	6	16	0	0	16	0	0
18	41278299	.	G	A	10	10	20	0	0	20	0	0
18	41278644	.	T	C	4	11	15	0	0	15	0	0
18	41284700	.	C	T	9	5	14	0	1	15	0	0
18	41293901	.	A	T	7	6	13	0	0	13	0	0
18	41295246	.	C	T	15	8	23	0	2	25	0	0
18	41297082	.	C	T	15	4	19	0	3	22	0	0
18	41300057	.	T	G	16	4	20	0	1	21	0	0
18	41300063	.	A	G	17	0	17	0	7	24	0	0
18	41305867	.	C	T	6	13	19	0	1	20	0	0
18	41309305	.	G	A	18	26	44	0	1	45	0	0
18	41310196	.	A	G	3	2	5	0	8	13	0	0
18	41310464	.	G	A	1	11	12	0	12	24	0	0
18	41364527	.	C	G	2	2	4	0	0	4	0	0
18	41364610	.	A	G	3	4	7	0	1	8	0	0
18	41364874	.	G	T	2	3	5	0	0	5	0	0
18	41365125	.	G	A	3	2	5	0	0	5	0	0
18	41365308	.	C	T	3	3	6	0	0	6	0	0
18	41365482	.	C	T	4	5	9	0	0	9	0	0
18	41365649	.	G	T	4	4	8	0	0	8	0	0
18	41372149	.	G	A	3	4	7	0	0	7	0	0
18	41372193	.	G	A	3	2	5	0	0	5	0	0
18	41372345	.	G	A	3	2	5	0	0	5	0	0
18	41374950	.	C	G	0	4	4	0	2	6	0	0
18	41375020	.	T	G	1	4	5	0	0	5	0	0
18	41414991	.	G	C	3	2	5	0	0	5	0	0
18	41418538	.	C	T	1	4	5	0	0	5	0	0
18	41495859	.	A	G	18	15	33	0	2	35	0	0
18	41495865	.	A	T	17	16	33	0	1	34	0	0
18	41499590	.	T	C	27	13	40	1	1	42	0	0
18	41499679	.	A	G	15	11	26	0	2	28	0	0
18	41499683	.	T	C	15	11	26	0	0	26	0	0
18	41499789	.	C	T	11	18	29	0	1	30	0	0
18	41503578	.	C	A	25	16	41	0	3	44	0	0
18	41505624	.	A	G	26	1	27	0	11	38	0	0
18	41509564	.	C	G	18	14	32	0	0	32	0	0
18	41509716	.	G	T	17	7	24	0	0	24	0	0
18	41512217	.	C	T	16	16	32	0	1	33	0	0
18	41514977	.	C	A	3	8	11	0	1	12	0	0
18	41516232	.	A	G	10	0	10	0	3	13	0	0
18	41524354	.	G	A	28	27	55	0	1	56	0	0
18	41524364	.	C	A	25	26	51	0	1	52	0	0
18	41525864	.	T	C	27	18	45	0	1	46	0	0
18	41525880	.	G	A	1	16	17	0	25	42	0	0
18	41526014	.	C	G	18	0	18	0	10	28	0	0
18	41526026	.	A	G	15	10	25	0	1	26	0	0
18	41526247	.	T	A	23	14	37	0	0	37	0	0
18	41526299	.	T	A	15	10	25	0	0	25	0	0
18	41526318	.	A	G	10	11	21	0	0	21	0	0
18	41526380	.	C	T	5	6	11	0	3	14	0	0
18	41526381	.	T	C	7	3	10	0	4	14	0	0
18	41527949	.	T	A	2	4	6	0	0	6	0	0
18	41533072	.	C	T	4	10	14	1	1	16	0	0
18	41538770	.	G	A	5	8	13	0	0	13	0	0
18	41538795	.	A	G	4	10	14	0	0	14	0	0
18	41538856	.	G	A	4	6	10	0	0	10	0	0
18	41542632	.	A	G	1	2	3	0	1	4	0	0
18	41542661	.	A	T	2	3	5	0	0	5	0	0
18	41542669	.	T	A	2	7	9	0	0	9	0	0
18	41542790	.	T	G	3	2	5	1	0	6	0	0
18	41543076	.	C	T	7	13	20	0	1	21	0	0
18	41549766	.	G	A	2	2	4	0	0	4	0	0
18	41549817	.	T	A	7	7	14	0	1	15	0	0
18	41556239	.	G	A	0	6	6	0	5	11	0	0
18	41558711	.	C	T	7	5	12	0	0	12	0	0
18	41558956	.	C	T	1	2	3	0	1	4	0	0
18	41560857	.	G	T	3	5	8	0	0	8	0	0
18	41560923	.	C	T	8	4	12	0	0	12	0	0
18	41561057	.	C	A	6	4	10	0	0	10	0	0
18	41561127	.	T	C	2	5	7	0	0	7	0	0
18	41561248	.	C	T	4	5	9	0	0	9	0	0
18	41565731	.	G	A	3	3	6	0	3	9	0	0
18	41565746	.	G	A	0	4	4	0	4	8	0	0
18	41571740	.	A	G	5	4	9	0	0	9	0	0
18	41572423	.	A	C	4	4	8	0	0	8	0	0
18	41572445	.	T	C	5	1	6	0	3	9	0	0
18	41573681	.	T	C	4	7	11	0	1	12	0	0
18	41573696	.	A	G	7	8	15	0	0	15	0	0
18	41573813	.	A	G	5	0	5	0	11	16	0	0
18	41573948	.	G	A	0	7	7	0	11	18	0	0
18	41574155	.	A	G	5	5	10	0	0	10	0	0
18	41574287	.	T	C	1	7	8	0	0	8	0	0
18	41574340	.	C	T	4	6	10	0	0	10	0	0
18	41574557	.	T	C	8	8	16	0	0	16	0	0
18	41574608	.	T	C	10	6	16	0	1	17	0	0
18	41579975	.	T	A	6	14	20	0	0	20	0	0
18	41580151	.	A	T	12	9	21	0	0	21	0	0
18	41586440	.	T	C	10	9	19	0	0	19	0	0
18	41588148	.	A	G	11	2	13	0	10	23	0	0
18	41588166	.	C	T	15	8	23	0	0	23	0	0
18	41589613	.	A	C	9	10	19	0	1	20	0	0
18	41591256	.	G	T	13	2	15	0	0	15	0	0
18	41649061	.	C	T	6	10	16	0	0	16	0	0
18	41649571	.	A	G	10	5	15	0	1	16	0	0
18	41757350	.	C	A	8	7	15	0	4	19	0	0
18	41757449	.	G	A	15	24	39	0	0	39	0	0
18	41757454	.	G	A	15	25	40	0	0	40	0	0
18	41757669	.	C	T	28	29	57	0	1	58	0	0
18	41764434	.	G	A	21	24	45	0	4	49	0	0
18	41764452	.	G	C	19	0	19	0	32	51	0	0
18	41876970	.	T	G	1	3	4	0	0	4	0	0
18	42162369	.	G	A	13	12	25	0	1	26	0	0
18	42189660	.	G	A	7	13	20	0	2	22	0	0
18	42189675	.	A	C	6	0	6	0	14	20	0	0
18	42201031	.	C	G	12	8	20	0	0	20	0	0
18	42215403	.	C	T	5	8	13	0	0	13	0	0
18	42218721	.	G	A	11	8	19	0	0	19	0	0
18	42218741	.	G	A	11	8	19	0	1	20	0	0
18	42258933	.	T	A	8	9	17	2	1	20	0	0
18	42276336	.	T	C	8	8	16	0	0	16	0	0
18	42313791	.	G	A	5	6	11	0	0	11	0	0
18	42333382	.	C	T	6	3	9	0	0	9	0	0
18	43439016	.	C	G	1	4	5	0	1	6	0	0
18	43867265	.	A	C	4	6	10	0	2	12	0	0
18	43867416	.	A	G	11	7	18	0	1	19	0	0
18	43867775	.	T	C	2	7	9	0	1	10	0	0
18	43867892	.	C	T	5	5	10	0	0	10	0	0
18	43868073	.	A	C	8	8	16	0	0	16	0	0
18	43868229	.	A	T	9	14	23	0	1	24	0	0
18	43868234	.	T	A	5	12	17	0	4	22	1	0
18	43868682	.	T	G	8	6	14	0	0	14	0	0
18	43869326	.	A	G	6	10	16	0	0	16	0	0
18	43869403	.	T	C	7	4	11	0	0	11	0	0
18	43869424	.	G	A	5	3	8	0	1	9	0	0
18	43869475	.	A	G	2	6	8	0	1	9	0	0
18	43869520	.	T	G	4	4	8	0	0	8	0	0
18	43869522	.	T	C	4	4	8	0	0	8	0	0
18	43869561	.	A	G	7	2	9	0	0	9	0	0
18	43869659	.	C	T	5	6	11	0	0	11	0	0
18	43869976	.	T	C	4	7	11	0	2	13	0	0
18	43870180	.	C	T	2	6	8	0	6	14	0	0
18	43870317	.	G	A	3	9	12	0	2	14	0	0
18	43870501	.	T	C	8	6	14	0	0	14	0	0
18	43870525	.	G	A	8	8	16	0	0	16	0	0
18	43870541	.	A	G	8	10	18	0	1	19	0	0
18	43870592	.	C	A	7	10	17	0	0	17	0	0
18	43870655	.	G	T	11	6	17	2	4	23	0	0
18	43870660	.	A	G	9	6	15	2	4	21	0	0
18	43879920	.	C	T	2	3	5	0	0	5	0	0
18	43879976	.	C	G	1	3	4	0	0	4	0	0
18	43896892	.	A	G	15	14	29	0	0	29	0	0
18	43896919	.	C	T	0	15	15	0	19	34	0	0
18	43897048	.	C	T	3	22	25	0	16	41	0	0
18	43897405	.	C	G	15	11	26	0	1	27	0	0
18	43897522	.	C	T	14	8	22	0	1	23	0	0
18	43897816	.	G	A	12	10	22	0	0	22	0	0
18	43898211	.	G	T	6	13	19	0	1	20	0	0
18	43898223	.	A	T	8	11	19	0	1	20	0	0
18	43898526	.	C	T	14	15	29	0	1	30	0	0
18	43898928	.	A	G	11	7	18	0	0	18	0	0
18	43899558	.	T	C	9	5	14	0	1	15	0	0
18	43899825	.	G	A	14	10	24	0	0	25	1	0
18	43900299	.	G	A	5	5	10	0	2	12	0	0
18	43908395	.	G	C	4	5	9	0	0	9	0	0
18	43993377	.	T	A	6	8	14	5	2	21	0	0
18	44053474	.	G	T	5	2	7	0	1	8	0	0
18	44053584	.	T	C	5	1	6	0	1	7	0	0
18	44057052	.	G	A	7	3	10	0	0	10	0	0
18	44065135	.	A	G	2	2	4	0	0	4	0	0
18	44065238	.	T	C	4	6	10	0	1	11	0	0
18	44075782	.	T	C	1	2	3	0	0	3	0	0
18	44321063	.	A	G	4	5	9	0	0	9	0	0
18	44321260	.	T	A	5	14	19	0	0	20	1	0
18	44321323	.	C	T	5	3	8	1	1	10	0	0
18	44321909	.	G	A	3	2	5	0	1	6	0	0
18	44322000	.	T	A	3	5	8	0	0	9	1	0
18	44322003	.	G	A	4	6	10	0	0	10	0	0
18	44322377	.	T	C	2	4	6	0	0	6	0	0
18	44322381	.	T	A	4	2	6	0	0	6	0	0
18	44322481	.	C	T	0	11	11	0	10	21	0	0
18	44325470	.	A	G	6	10	16	0	1	17	0	0
18	44325526	.	A	T	7	6	13	0	3	16	0	0
18	44327944	.	A	G	5	12	17	0	2	19	0	0
18	44327953	.	G	A	6	13	19	0	1	20	0	0
18	44331117	.	G	C	1	8	9	0	1	10	0	0
18	44332725	.	C	T	3	8	11	0	1	12	0	0
18	44334889	.	C	T	7	7	14	0	0	14	0	0
18	44345920	.	T	C	3	0	3	0	4	7	0	0
18	44346102	.	C	T	3	6	9	0	2	11	0	0
18	44349089	.	C	T	3	6	9	0	0	9	0	0
18	44355473	.	A	G	3	3	6	0	0	6	0	0
18	44355485	.	G	A	2	4	6	0	1	7	0	0
18	44359312	.	T	C	6	3	9	0	0	9	0	0
18	44364647	.	C	A	26	17	43	0	3	46	0	0
18	44365064	.	C	A	24	24	48	0	3	51	0	0
18	44365114	.	T	A	36	23	59	0	2	61	0	0
18	44365650	.	T	C	18	19	37	0	0	37	0	0
18	44365714	.	C	A	27	20	47	1	1	49	0	0
18	44365717	.	A	G	27	22	49	1	1	51	0	0
18	44365854	.	T	C	34	11	45	0	4	49	0	0
18	44365977	.	T	C	14	24	38	0	1	39	0	0
18	44365987	.	T	A	16	24	40	0	1	41	0	0
18	44367241	.	A	T	18	22	40	0	1	41	0	0
18	44367426	.	C	T	34	25	59	0	0	59	0	0
18	44367488	.	G	A	25	29	54	0	1	55	0	0
18	44377404	.	C	A	21	22	43	1	0	44	0	0
18	44377417	.	C	T	28	21	49	1	0	50	0	0
18	44388421	.	C	T	18	24	42	0	2	44	0	0
18	44397330	.	G	A	22	26	48	0	0	48	0	0
18	44404609	.	C	T	31	23	54	0	4	59	1	0
18	44404872	.	C	T	20	25	45	0	5	50	0	0
18	44408841	.	G	A	22	20	42	3	3	48	0	0
18	44418164	.	C	T	20	24	44	0	0	44	0	0
18	44425093	.	A	G	13	32	45	0	2	47	0	0
18	44425105	.	C	T	15	24	39	0	3	42	0	0
18	44425150	.	A	C	14	29	43	0	3	46	0	0
18	44453365	.	G	A	20	21	41	1	1	43	0	0
18	44453377	.	G	C	19	0	19	1	25	45	0	0
18	44564180	.	G	A	0	3	3	0	1	4	0	0
18	44567352	.	C	A	1	3	4	0	0	4	0	0
18	44567471	.	A	C	3	4	7	0	0	7	0	0
18	44568226	.	G	T	3	2	5	0	0	5	0	0
18	44569847	.	A	G	6	2	8	0	0	8	0	0
18	44569895	.	C	T	8	4	12	0	1	13	0	0
18	44574263	.	C	T	2	5	7	0	0	7	0	0
18	44576790	.	C	T	2	3	5	0	0	5	0	0
18	44579965	.	G	A	6	4	10	0	0	10	0	0
18	44587696	.	C	A	2	3	5	0	0	5	0	0
18	44589770	.	G	C	5	3	8	0	0	8	0	0
18	44597048	.	G	A	3	2	5	0	0	5	0	0
18	44597308	.	C	A	15	30	45	0	1	46	0	0
18	44597850	.	A	G	13	11	24	0	0	24	0	0
18	44597884	.	G	A	14	14	28	0	0	28	0	0
18	44598234	.	C	T	2	10	12	0	19	31	0	0
18	44598371	.	C	T	13	8	21	0	2	23	0	0
18	44599837	.	G	A	25	25	50	2	0	52	0	0
18	44606194	.	G	A	11	16	27	0	0	27	0	0
18	44615685	.	G	A	6	7	13	0	0	13	0	0
18	44615770	.	G	A	10	12	22	0	0	22	0	0
18	44615819	.	T	C	4	10	14	0	1	15	0	0
18	44615861	.	A	T	8	7	15	0	0	15	0	0
18	44618795	.	G	T	17	14	31	0	2	33	0	0
18	44619049	.	T	G	7	17	24	0	2	26	0	0
18	44623527	.	G	A	15	16	31	0	1	32	0	0
18	44632604	.	C	T	9	4	13	0	0	13	0	0
18	44633195	.	C	T	2	4	6	0	0	6	0	0
18	44633387	.	G	A	0	5	5	0	3	8	0	0
18	44637835	.	A	T	6	6	12	0	5	17	0	0
18	44637898	.	G	A	8	12	20	0	1	21	0	0
18	44638087	.	G	T	2	5	7	0	5	12	0	0
18	44640663	.	C	G	9	6	15	0	0	15	0	0
18	44644443	.	C	A	10	13	23	0	0	23	0	0
18	44645008	.	A	T	6	12	18	0	2	20	0	0
18	44645350	.	A	G	8	0	8	0	5	13	0	0
18	44645368	.	T	C	6	3	9	0	0	9	0	0
18	44645617	.	G	A	1	12	13	0	8	21	0	0
18	44645782	.	G	C	12	10	22	0	0	22	0	0
18	44645870	.	T	A	8	10	18	0	4	22	0	0
18	44646215	.	C	T	8	5	13	0	0	13	0	0
18	44646467	.	A	C	4	8	12	0	3	15	0	0
18	44646504	.	C	T	6	11	17	0	2	19	0	0
18	44646587	.	G	A	0	10	10	0	13	23	0	0
18	44646678	.	C	T	8	11	19	0	0	19	0	0
18	44646781	.	A	G	6	4	10	0	1	11	0	0
18	44661011	.	G	C	1	2	3	0	0	3	0	0
18	44662511	.	T	A	1	2	3	0	0	3	0	0
18	44662664	.	G	A	0	2	2	0	4	6	0	0
18	44662960	.	C	T	1	2	3	0	0	3	0	0
18	44682124	.	C	T	3	2	5	0	0	5	0	0
18	44682569	.	A	C	1	2	3	0	1	4	0	0
18	44692777	.	T	C	9	4	13	0	1	14	0	0
18	44696096	.	C	T	7	4	11	0	1	12	0	0
18	44696319	.	A	C	3	3	6	0	0	6	0	0
18	44696451	.	A	T	3	2	5	0	0	5	0	0
18	44763419	.	T	C	7	4	11	0	0	11	0	0
18	44764392	.	A	T	7	3	10	0	0	10	0	0
18	44765491	.	A	G	3	0	3	0	10	13	0	0
18	44770632	.	C	T	2	7	9	0	0	9	0	0
18	44779016	.	C	T	2	4	6	0	0	6	0	0
18	44779219	.	C	A	3	1	4	0	2	6	0	0
18	44781653	.	A	G	1	0	1	0	4	5	0	0
18	44782413	.	G	A	2	4	6	0	0	6	0	0
18	44783771	.	C	T	2	5	7	0	0	7	0	0
18	44790506	.	T	C	3	7	10	0	0	10	0	0
18	44790635	.	A	G	1	2	3	0	0	3	0	0
18	44791251	.	A	C	3	4	7	0	0	7	0	0
18	44791318	.	C	A	2	4	6	0	0	6	0	0
18	44791362	.	T	A	2	3	5	0	0	5	0	0
18	44815380	.	C	T	3	1	4	0	1	5	0	0
18	44820453	.	C	T	2	4	6	0	0	6	0	0
18	44826554	.	T	G	6	8	14	0	1	15	0	0
18	44826910	.	C	T	12	4	16	1	1	18	0	0
18	44830217	.	C	T	13	6	19	0	0	19	0	0
18	44830247	.	G	A	10	11	21	0	1	22	0	0
18	44830283	.	G	A	14	16	30	0	0	30	0	0
18	44832693	.	C	A	19	9	28	0	1	29	0	0
18	44834165	.	T	C	6	0	6	0	17	23	0	0
18	44837085	.	T	C	15	7	22	0	0	22	0	0
18	44838285	.	G	A	16	16	32	0	0	32	0	0
18	44838342	.	G	A	11	7	18	1	1	20	0	0
18	44840994	.	C	T	15	13	28	0	1	29	0	0
18	44843407	.	G	A	13	16	29	0	0	29	0	0
18	44843531	.	C	A	14	10	24	0	0	24	0	0
18	44849876	.	G	T	0	2	2	0	3	5	0	0
18	44852404	.	C	T	11	5	16	0	0	16	0	0
18	44857803	.	C	A	15	14	29	0	1	30	0	0
18	44866841	.	C	T	17	21	38	0	1	39	0	0
18	44870505	.	G	A	0	14	14	0	7	21	0	0
18	44870526	.	G	A	1	8	9	0	10	19	0	0
18	44870541	.	G	A	1	8	9	0	10	19	0	0
18	44873083	.	C	T	8	13	21	0	1	22	0	0
18	44873993	.	G	T	10	25	35	1	4	41	1	0
18	44874249	.	T	G	12	1	13	0	9	22	0	0
18	44874252	.	C	T	13	9	22	0	0	22	0	0
18	44886142	.	G	A	1	2	3	0	0	3	0	0
18	44886146	.	C	T	1	2	3	0	0	3	0	0
18	44886379	.	G	A	2	2	4	0	0	4	0	0
18	44913653	.	G	T	8	8	16	0	0	16	0	0
18	44913760	.	A	G	7	5	12	0	1	13	0	0
18	44913993	.	T	C	6	0	6	0	7	13	0	0
18	44927864	.	C	T	2	4	6	0	0	6	0	0
18	44935070	.	C	G	3	6	9	0	0	9	0	0
18	45114550	.	C	T	6	4	10	0	0	10	0	0
18	45231137	.	G	A	4	4	8	0	0	8	0	0
18	45235903	.	G	T	0	3	3	0	3	6	0	0
18	45235924	.	T	C	6	4	10	0	0	10	0	0
18	45248042	.	T	G	2	5	7	0	1	8	0	0
18	45257475	.	C	T	2	5	7	0	0	7	0	0
18	45259886	.	T	C	5	5	10	0	0	10	0	0
18	45259930	.	C	T	4	8	12	0	0	12	0	0
18	45260228	.	T	C	4	13	17	0	0	17	0	0
18	45260529	.	G	A	2	4	6	0	2	8	0	0
18	45260925	.	C	G	4	2	6	0	0	6	0	0
18	45261085	.	G	A	3	2	5	0	0	5	0	0
18	45261319	.	A	T	6	4	10	0	0	10	0	0
18	45261369	.	G	T	3	10	13	0	0	13	0	0
18	45261438	.	G	A	5	8	13	0	0	13	0	0
18	45261845	.	T	A	6	4	10	0	0	10	0	0
18	45261882	.	T	C	5	5	10	0	1	11	0	0
18	45262135	.	G	A	6	3	9	0	1	10	0	0
18	45262138	.	C	T	7	2	9	0	1	10	0	0
18	45262227	.	C	T	9	3	12	0	0	12	0	0
18	45262351	.	C	T	8	3	11	0	0	11	0	0
18	45262687	.	G	T	6	7	13	0	1	14	0	0
18	45262855	.	A	C	4	8	12	0	0	12	0	0
18	45262865	.	T	C	5	6	11	0	0	11	0	0
18	45550831	.	G	C	2	8	10	0	20	30	0	0
18	45550839	.	A	C	24	8	32	0	1	33	0	0
18	45561677	.	G	T	12	16	28	0	2	30	0	0
18	45569037	.	G	A	2	7	9	1	21	31	0	0
18	45569075	.	C	A	16	12	28	0	0	28	0	0
18	45569092	.	A	G	11	1	12	0	13	25	0	0
18	45574140	.	A	G	12	24	36	0	2	38	0	0
18	45574275	.	A	T	23	7	30	0	0	31	1	0
18	45575079	.	G	A	1	13	14	0	20	34	0	0
18	45581704	.	C	A	14	17	31	0	3	34	0	0
18	45581784	.	C	T	25	13	38	0	0	38	0	0
18	45583038	.	A	C	14	18	32	0	3	35	0	0
18	45583042	.	G	A	2	20	22	0	15	37	0	0
18	45584036	.	C	T	12	13	25	0	1	26	0	0
18	45584368	.	T	C	18	29	47	0	1	48	0	0
18	45588336	.	C	T	18	17	35	0	0	35	0	0
18	45591836	.	A	T	7	17	24	0	2	26	0	0
18	45591929	.	G	A	14	14	28	0	0	28	0	0
18	45647838	.	G	A	1	15	16	0	17	33	0	0
18	45647940	.	C	T	21	12	33	0	0	33	0	0
18	45649613	.	C	T	21	13	34	0	0	34	0	0
18	45649658	.	G	T	20	13	33	0	1	34	0	0
18	45651032	.	C	T	24	22	46	0	1	47	0	0
18	45651559	.	T	A	22	22	44	0	3	47	0	0
18	45656062	.	T	C	17	20	37	0	0	37	0	0
18	45656089	.	T	C	13	18	31	0	2	33	0	0
18	45677426	.	G	A	1	2	3	0	4	7	0	0
18	45677520	.	G	T	0	3	3	0	3	6	0	0
18	45682029	.	G	A	0	5	5	1	6	12	0	0
18	45682041	.	C	T	7	7	14	1	0	15	0	0
18	45684119	.	G	T	0	6	6	0	2	8	0	0
18	45684425	.	G	A	1	6	7	0	4	11	0	0
18	45684539	.	T	A	6	4	10	0	0	10	0	0
18	45684542	.	T	C	3	5	8	0	0	8	0	0
18	45684977	.	T	C	4	3	7	0	0	7	0	0
18	45685659	.	T	A	1	5	6	0	0	6	0	0
18	45685695	.	G	C	5	1	6	0	0	6	0	0
18	45685700	.	C	A	5	2	7	0	0	7	0	0
18	45685805	.	A	C	3	2	5	0	0	5	0	0
18	45686840	.	T	C	11	4	15	0	0	15	0	0
18	45686882	.	G	A	0	7	7	0	4	11	0	0
18	45687097	.	A	G	2	5	7	0	0	7	0	0
18	45687258	.	G	C	5	2	7	0	0	7	0	0
18	45687882	.	C	T	9	5	14	0	2	16	0	0
18	45689081	.	C	T	11	4	15	0	1	16	0	0
18	45691123	.	G	A	5	2	7	0	1	8	0	0
18	45697833	.	A	T	4	7	11	0	1	12	0	0
18	45698032	.	A	G	3	0	3	0	3	6	0	0
18	45698344	.	C	A	3	5	8	0	1	9	0	0
18	45734477	.	T	C	6	4	10	0	0	10	0	0
18	45742051	.	C	A	10	17	27	1	0	28	0	0
18	45742059	.	G	A	9	14	23	1	0	24	0	0
18	45743004	.	G	C	14	0	14	0	12	26	0	0
18	45743518	.	G	A	15	13	28	0	0	28	0	0
18	45743522	.	G	A	15	12	27	0	1	28	0	0
18	45743555	.	C	A	15	11	26	0	1	27	0	0
18	45745504	.	A	T	7	9	16	0	3	19	0	0
18	45750912	.	A	C	12	0	12	0	12	24	0	0
18	45750915	.	A	G	10	10	20	0	1	21	0	0
18	45752094	.	C	T	1	6	7	0	6	13	0	0
18	45759309	.	G	T	14	11	25	0	1	26	0	0
18	45784225	.	A	G	42	29	71	0	4	75	0	0
18	45807903	.	C	G	22	1	23	0	10	33	0	0
18	45807942	.	G	C	5	14	19	0	13	32	0	0
18	45809872	.	A	G	12	0	12	0	11	23	0	0
18	45809892	.	T	C	12	9	21	0	1	22	0	0
18	45818602	.	C	T	14	20	34	0	0	34	0	0
18	45820510	.	G	A	2	11	13	0	9	22	0	0
18	45820588	.	A	G	16	13	29	0	1	30	0	0
18	45824315	.	C	T	18	17	35	0	1	36	0	0
18	45824467	.	G	A	1	12	13	0	18	31	0	0
18	45824607	.	G	A	23	11	34	0	2	36	0	0
18	45835115	.	C	T	19	16	35	0	1	36	0	0
18	45840471	.	T	A	14	19	33	0	2	35	0	0
18	45840504	.	C	T	17	16	33	0	2	35	0	0
18	45842491	.	T	C	21	24	45	0	0	45	0	0
18	45842679	.	G	A	3	21	24	0	15	39	0	0
18	45844458	.	C	T	16	18	34	0	2	36	0	0
18	45844473	.	A	T	22	18	40	0	1	41	0	0
18	45848355	.	C	T	17	15	32	0	0	32	0	0
18	45849283	.	C	T	19	16	35	0	1	36	0	0
18	45851540	.	G	A	3	15	18	0	25	43	0	0
18	45862909	.	G	A	2	2	4	0	0	4	0	0
18	45862912	.	C	T	1	1	2	0	2	4	0	0
18	45862949	.	G	A	1	2	3	0	1	4	0	0
18	45863426	.	T	A	2	2	4	0	0	4	0	0
18	45886040	.	T	C	2	2	4	0	0	4	0	0
18	45886458	.	T	A	1	2	3	0	0	3	0	0
18	45932349	.	A	G	6	0	6	0	4	10	0	0
18	45932359	.	C	T	4	5	9	0	0	9	0	0
18	45934646	.	G	A	0	5	5	0	4	9	0	0
18	45934691	.	G	T	4	6	10	0	0	10	0	0
18	45936773	.	G	A	4	5	9	0	0	9	0	0
18	45938733	.	A	G	3	7	10	0	1	11	0	0
18	45944441	.	G	A	0	2	2	0	8	10	0	0
18	45944522	.	G	A	6	7	13	0	0	13	0	0
18	45944546	.	C	T	6	5	11	0	3	14	0	0
18	45944903	.	G	T	10	6	16	0	0	16	0	0
18	45947835	.	C	T	10	7	17	0	0	17	0	0
18	45947880	.	C	A	3	4	7	0	0	7	0	0
18	45948071	.	C	A	3	2	5	0	0	5	0	0
18	45948213	.	G	A	2	7	9	0	0	9	0	0
18	45962500	.	A	G	30	27	57	0	4	61	0	0
18	45962581	.	T	C	36	14	50	3	0	53	0	0
18	45962593	.	G	C	33	13	46	3	1	50	0	0
18	45962668	.	C	T	26	21	47	1	1	49	0	0
18	45969252	.	C	A	30	25	55	0	3	58	0	0
18	45979887	.	C	T	18	28	46	0	1	48	1	0
18	45983268	.	A	C	15	23	38	0	1	39	0	0
18	46012631	.	C	T	10	10	20	0	0	20	0	0
18	46015830	.	G	A	5	13	18	0	0	18	0	0
18	46057023	.	G	T	3	7	10	0	0	10	0	0
18	46059425	.	A	C	7	10	17	0	1	18	0	0
18	46061242	.	G	A	6	10	16	0	1	17	0	0
18	46061326	.	C	A	7	7	14	0	1	15	0	0
18	46063648	.	C	T	10	12	22	0	2	24	0	0
18	46255483	.	T	C	1	0	1	0	2	3	0	0
18	46255484	.	T	G	1	2	3	0	0	3	0	0
18	46263390	.	C	G	0	3	3	0	1	4	0	0
18	46361861	.	C	G	4	7	11	0	0	11	0	0
18	46362772	.	G	T	18	9	27	0	7	34	0	0
18	46367691	.	G	C	7	14	21	0	1	22	0	0
18	46368300	.	C	T	1	9	10	0	10	20	0	0
18	46368771	.	C	T	0	4	4	0	8	12	0	0
18	46368924	.	C	A	6	7	13	0	0	13	0	0
18	46369173	.	T	C	6	5	11	0	1	12	0	0
18	46387493	.	G	A	0	2	2	0	1	3	0	0
18	46393508	.	G	A	0	3	3	0	3	6	0	0
18	46395965	.	G	C	21	26	47	0	1	48	0	0
18	46400979	.	A	G	21	13	34	0	0	34	0	0
18	46401137	.	T	C	14	17	31	0	1	32	0	0
18	46414299	.	C	T	2	3	5	0	10	15	0	0
18	46417624	.	T	C	14	8	22	0	2	24	0	0
18	46417681	.	G	T	16	9	25	0	0	25	0	0
18	46417775	.	T	C	19	0	19	0	11	30	0	0
18	46417807	.	A	G	19	11	30	0	2	32	0	0
18	46418281	.	T	C	10	0	10	0	14	24	0	0
18	46418458	.	C	T	5	12	17	0	14	31	0	0
18	46418497	.	G	A	20	8	28	0	1	29	0	0
18	46418521	.	C	T	23	9	32	0	0	32	0	0
18	46418776	.	C	T	1	13	14	0	9	23	0	0
18	46453240	.	C	T	0	9	9	0	15	24	0	0
18	46634497	.	A	G	8	7	15	0	0	15	0	0
18	46634544	.	T	C	8	4	12	0	1	13	0	0
18	46634572	.	T	C	9	4	13	0	2	15	0	0
18	46635257	.	G	A	6	9	15	1	0	16	0	0
18	46635876	.	G	A	11	10	21	0	0	21	0	0
18	46653253	.	T	G	10	13	23	0	1	24	0	0
18	46653284	.	A	G	9	15	24	0	1	25	0	0
18	46684230	.	A	T	9	16	25	0	0	25	0	0
18	46684258	.	G	T	10	14	24	0	2	26	0	0
18	46699773	.	G	A	27	34	61	0	3	64	0	0
18	46702492	.	G	A	26	29	55	0	1	57	1	0
18	46714896	.	A	G	21	21	42	0	3	45	0	0
18	46729044	.	A	G	21	18	39	0	0	39	0	0
18	46729321	.	A	G	24	19	43	0	4	47	0	0
18	46732406	.	C	G	19	22	41	0	0	41	0	0
18	46732417	.	T	A	17	21	38	0	0	38	0	0
18	46735972	.	T	C	13	16	29	0	0	29	0	0
18	46738862	.	C	A	2	22	24	0	16	41	1	0
18	46738955	.	A	C	25	30	55	0	3	58	0	0
18	46738990	.	A	T	23	29	52	0	0	52	0	0
18	47095659	.	G	A	10	9	19	0	0	19	0	0
18	47301283	.	A	T	7	4	11	0	0	11	0	0
18	47305388	.	T	A	6	7	13	0	4	17	0	0
18	47305433	.	A	G	6	9	15	0	0	15	0	0
18	47306316	.	T	A	6	2	8	0	1	9	0	0
18	47566919	.	A	T	5	8	13	0	1	14	0	0
18	47569514	.	T	A	4	3	7	0	1	8	0	0
18	47603275	.	C	G	4	4	8	0	0	8	0	0
18	47661612	.	T	G	6	3	9	0	1	10	0	0
18	48486246	.	C	T	8	8	16	0	0	16	0	0
18	48620036	.	T	C	6	3	9	0	0	9	0	0
18	48620675	.	G	A	3	7	10	0	0	10	0	0
18	48640143	.	G	C	0	5	5	0	3	8	0	0
18	48640155	.	G	C	0	6	6	0	3	9	0	0
18	48640284	.	C	G	6	0	6	0	3	9	0	0
18	48640323	.	G	A	0	6	6	0	8	14	0	0
18	48640348	.	A	G	8	0	8	0	6	14	0	0
18	48640417	.	G	T	10	8	18	0	1	19	0	0
18	48640596	.	T	C	1	6	7	0	0	7	0	0
18	48640687	.	T	C	3	5	8	0	0	8	0	0
18	48641360	.	A	G	1	3	4	0	0	4	0	0
18	48641507	.	T	A	1	7	8	0	0	8	0	0
18	48641532	.	G	A	0	5	5	0	1	6	0	0
18	48642077	.	T	A	3	4	7	0	0	7	0	0
18	48642868	.	A	T	6	4	10	0	0	10	0	0
18	48643030	.	C	A	5	6	11	0	0	11	0	0
18	48643055	.	A	G	6	3	9	0	0	10	1	0
18	48643334	.	T	C	1	2	3	0	1	4	0	0
18	48643443	.	T	C	2	2	4	0	0	4	0	0
18	48697929	.	A	C	1	0	1	0	2	3	0	0
18	48707436	.	C	T	1	2	3	0	1	4	0	0
18	48715549	.	A	G	1	3	4	0	0	4	0	0
18	48803064	.	G	A	6	5	11	0	1	12	0	0
18	48803191	.	C	T	1	3	4	0	0	4	0	0
18	48807200	.	C	G	1	0	1	0	5	6	0	0
18	48807499	.	A	G	3	3	6	0	0	6	0	0
18	48807521	.	T	C	4	3	7	0	0	7	0	0
18	48808043	.	A	G	6	5	11	0	0	11	0	0
18	48808099	.	A	G	9	7	16	0	0	16	0	0
18	48808185	.	C	T	5	4	9	0	0	9	0	0
18	48809189	.	G	A	6	8	14	0	0	14	0	0
18	48864453	.	C	A	8	3	11	0	0	11	0	0
18	48864702	.	T	C	5	7	12	0	0	12	0	0
18	48898641	.	C	T	8	8	16	0	0	16	0	0
18	48920871	.	A	G	9	0	9	0	10	19	0	0
18	48921166	.	C	G	18	16	34	0	1	35	0	0
18	48921175	.	A	C	14	18	32	0	2	34	0	0
18	48923068	.	C	T	12	11	23	0	1	24	0	0
18	48928342	.	A	G	20	0	20	0	15	35	0	0
18	48928387	.	T	A	18	18	36	0	0	36	0	0
18	48928552	.	C	T	19	16	35	0	3	38	0	0
18	48928843	.	C	T	15	17	32	0	0	32	0	0
18	48934524	.	T	C	13	23	36	0	1	37	0	0
18	48934593	.	T	C	18	25	43	0	0	43	0	0
18	48934805	.	A	G	14	24	38	0	0	38	0	0
18	48934833	.	T	C	13	27	40	0	1	41	0	0
18	48934951	.	A	G	17	1	18	0	15	33	0	0
18	48935279	.	T	G	28	15	43	1	1	45	0	0
18	48954004	.	G	A	2	2	4	0	0	4	0	0
18	48956210	.	A	T	1	3	4	0	0	4	0	0
18	48957768	.	C	T	1	4	5	0	0	5	0	0
18	48957791	.	G	T	0	2	2	0	3	5	0	0
18	48957836	.	A	T	1	3	4	0	1	5	0	0
18	48957845	.	T	A	1	3	4	0	0	4	0	0
18	48960846	.	G	C	4	7	11	0	0	11	0	0
18	48960969	.	A	C	2	5	7	0	0	7	0	0
18	48964731	.	A	G	0	4	4	0	1	5	0	0
18	48964734	.	C	T	1	4	5	0	0	5	0	0
18	48964912	.	G	C	1	4	5	0	1	6	0	0
18	48964915	.	G	A	0	4	4	0	2	6	0	0
18	48966177	.	C	T	4	5	9	0	0	9	0	0
18	48971165	.	T	C	4	10	14	0	1	15	0	0
18	48971192	.	A	G	6	10	16	0	0	16	0	0
18	48972490	.	A	T	7	9	16	0	0	16	0	0
18	49002070	.	T	G	2	2	4	0	1	5	0	0
18	49002812	.	G	A	2	3	5	0	0	5	0	0
18	49007191	.	A	G	3	4	7	0	0	7	0	0
18	49007202	.	C	T	3	3	6	0	0	6	0	0
18	49032695	.	C	T	0	3	3	0	1	4	0	0
18	49125038	.	C	G	4	6	10	0	0	10	0	0
18	49125315	.	C	T	7	3	10	0	0	10	0	0
18	49125347	.	G	A	11	3	14	0	1	15	0	0
18	49125442	.	G	C	6	3	9	0	1	10	0	0
18	49125598	.	C	T	6	5	11	0	0	11	0	0
18	49125599	.	A	G	6	5	11	0	0	11	0	0
18	49125760	.	T	A	3	1	4	0	2	6	0	0
18	49125887	.	T	A	6	6	12	0	2	14	0	0
18	49125996	.	A	C	12	8	20	0	2	22	0	0
18	49126052	.	T	C	9	6	15	0	0	15	0	0
18	49126363	.	A	C	7	8	15	0	0	15	0	0
18	49126732	.	G	A	5	6	11	0	0	11	0	0
18	49126745	.	A	G	6	4	10	0	1	11	0	0
18	49126845	.	C	G	7	6	13	0	0	13	0	0
18	49126958	.	C	T	8	7	15	0	0	15	0	0
18	49153651	.	T	C	12	9	21	0	0	21	0	0
18	49153710	.	A	C	9	10	19	0	0	19	0	0
18	49153735	.	G	A	1	12	13	0	12	25	0	0
18	49153900	.	C	T	16	13	29	0	0	29	0	0
18	49153977	.	G	C	2	6	8	0	8	16	0	0
18	49153984	.	G	T	1	7	8	0	6	14	0	0
18	49154215	.	A	G	13	4	17	0	0	17	0	0
18	49154243	.	T	C	13	6	19	0	0	19	0	0
18	49154251	.	C	T	11	5	16	0	1	17	0	0
18	49154328	.	G	A	8	11	19	0	1	20	0	0
18	49154458	.	G	T	16	15	31	0	2	33	0	0
18	49154483	.	G	T	3	18	21	0	18	39	0	0
18	49154525	.	C	T	22	14	36	0	2	38	0	0
18	49154527	.	T	C	24	12	36	0	3	39	0	0
18	49154722	.	A	G	11	10	21	0	4	25	0	0
18	49155045	.	A	G	5	0	5	0	3	8	0	0
18	49155190	.	C	G	12	7	19	0	0	19	0	0
18	49155211	.	C	A	7	11	18	0	0	18	0	0
18	49155278	.	G	T	5	8	13	0	0	13	0	0
18	49155303	.	G	A	6	6	12	0	2	14	0	0
18	49155776	.	G	A	18	4	22	1	1	24	0	0
18	49155941	.	C	T	20	13	33	0	0	33	0	0
18	49156128	.	A	G	4	5	9	0	1	10	0	0
18	49156133	.	A	C	5	0	5	0	0	6	1	0
18	49156444	.	G	A	2	5	7	0	0	7	0	0
18	49156481	.	T	C	9	5	14	0	0	14	0	0
18	49156567	.	T	C	7	11	18	0	1	19	0	0
18	49156773	.	G	T	10	7	17	0	1	18	0	0
18	49214231	.	G	A	1	4	5	0	1	7	1	0
18	49214441	.	C	T	2	2	4	0	0	4	0	0
18	49214491	.	T	C	1	3	4	0	0	4	0	0
18	49214499	.	A	T	1	2	3	0	0	3	0	0
18	49233439	.	T	C	2	3	5	0	0	5	0	0
18	49233469	.	C	T	3	2	5	0	0	5	0	0
18	49239450	.	T	A	4	4	8	0	0	8	0	0
18	49240072	.	T	C	4	4	8	0	1	9	0	0
18	49241959	.	G	A	3	3	6	0	0	6	0	0
18	49244821	.	C	A	7	8	15	0	0	15	0	0
18	49245256	.	G	C	2	4	6	0	0	6	0	0
18	49246672	.	T	A	5	3	8	0	0	8	0	0
18	49248524	.	G	T	6	11	17	0	0	17	0	0
18	49261736	.	C	T	10	8	18	1	0	19	0	0
18	49266575	.	G	A	6	12	18	0	0	18	0	0
18	49266589	.	A	G	10	9	19	0	1	20	0	0
18	49266998	.	A	G	9	6	15	0	1	16	0	0
18	49267041	.	G	A	11	3	14	0	0	14	0	0
18	49267115	.	A	G	3	0	3	0	4	7	0	0
18	49267327	.	T	G	1	4	5	0	0	5	0	0
18	49267832	.	A	G	2	2	4	0	0	4	0	0
18	49274213	.	C	T	0	2	2	0	1	3	0	0
18	49274228	.	A	G	2	2	4	0	0	4	0	0
18	49310871	.	T	A	1	3	4	0	0	4	0	0
18	49412259	.	T	C	3	3	6	0	0	6	0	0
18	49412367	.	G	T	5	8	13	0	0	13	0	0
18	49412394	.	A	G	4	9	13	0	0	13	0	0
18	49412514	.	T	C	12	13	25	0	0	25	0	0
18	49412709	.	G	A	1	4	5	0	9	14	0	0
18	49428280	.	G	A	1	6	7	0	3	10	0	0
18	49428793	.	T	C	8	9	17	0	2	19	0	0
18	49446190	.	G	T	5	5	10	0	0	10	0	0
18	49446254	.	T	G	6	9	15	0	1	16	0	0
18	49446293	.	C	G	10	8	18	0	1	19	0	0
18	49446312	.	G	A	10	7	17	0	3	20	0	0
18	49446796	.	C	A	4	2	6	0	0	6	0	0
18	49446803	.	T	A	4	3	7	0	0	7	0	0
18	49446881	.	T	C	10	3	13	0	0	13	0	0
18	49447008	.	C	A	13	7	20	0	0	20	0	0
18	49447041	.	G	A	2	12	14	0	15	29	0	0
18	50028566	.	C	T	2	6	8	0	0	8	0	0
18	50037401	.	C	T	9	8	17	0	1	18	0	0
18	50037850	.	C	T	3	2	5	0	0	5	0	0
18	50038325	.	G	T	1	7	8	0	1	9	0	0
18	50038534	.	C	A	4	2	6	2	1	9	0	0
18	50039852	.	G	T	7	4	11	0	0	11	0	0
18	50039939	.	C	T	5	2	7	2	0	9	0	0
18	50040021	.	G	T	1	4	5	0	0	5	0	0
18	50089055	.	G	A	3	6	9	0	0	9	0	0
18	50089090	.	G	A	0	3	3	0	6	9	0	0
18	50090649	.	C	A	1	5	6	0	0	6	0	0
18	50099441	.	A	G	3	3	6	0	0	6	0	0
18	50124802	.	G	A	4	7	11	0	1	12	0	0
18	50124803	.	T	A	4	7	11	0	0	11	0	0
18	50124843	.	A	T	3	7	10	0	1	11	0	0
18	50124847	.	T	C	3	6	9	0	0	9	0	0
18	50124929	.	C	T	4	3	7	0	0	7	0	0
18	50124945	.	G	T	5	2	7	0	0	7	0	0
18	50125048	.	G	T	2	3	5	0	0	5	0	0
18	50125099	.	T	G	4	3	7	0	0	7	0	0
18	50125844	.	A	C	2	2	4	0	0	4	0	0
18	50125868	.	A	G	1	3	4	0	0	4	0	0
18	50125981	.	G	C	2	0	2	0	3	5	0	0
18	50126036	.	T	A	2	3	5	0	0	6	1	0
18	50126465	.	G	A	2	3	5	0	1	6	0	0
18	50126670	.	A	T	1	3	4	0	0	4	0	0
18	50126681	.	A	G	1	3	4	0	0	4	0	0
18	50127179	.	C	T	0	3	3	0	2	5	0	0
18	50127479	.	T	C	2	3	5	0	1	6	0	0
18	50127483	.	T	C	2	4	6	0	0	6	0	0
18	50128902	.	G	A	1	3	4	0	0	4	0	0
18	50276476	.	C	G	12	16	28	0	1	29	0	0
18	50276488	.	T	C	20	1	21	0	1	22	0	0
18	50276681	.	T	G	12	14	26	0	0	26	0	0
18	50279044	.	T	C	28	20	48	0	1	49	0	0
18	50279182	.	G	A	3	10	13	0	25	38	0	0
18	50353568	.	A	C	24	20	44	0	3	47	0	0
18	50353598	.	C	T	32	17	49	0	1	50	0	0
18	50356632	.	T	C	23	20	43	0	1	44	0	0
18	50443786	.	T	C	3	2	5	0	0	5	0	0
18	50443787	.	G	T	3	2	5	0	0	5	0	0
18	50443851	.	G	A	4	2	6	0	0	6	0	0
18	50538340	.	T	C	4	17	21	0	2	23	0	0
18	50538598	.	T	C	11	4	15	1	0	16	0	0
18	50689577	.	T	C	2	6	8	1	0	9	0	0
18	50689583	.	G	A	6	0	6	0	0	6	0	0
18	50706691	.	C	A	4	3	7	1	0	8	0	0
18	50706696	.	C	T	2	3	5	1	1	7	0	0
18	50708755	.	T	A	1	4	5	0	3	8	0	0
18	50911951	.	T	C	2	7	9	4	0	13	0	0
19	175345	.	A	G	8	3	11	0	0	11	0	0
19	175381	.	A	G	10	3	13	0	0	13	0	0
19	175454	.	A	G	6	3	9	0	1	10	0	0
19	371857	.	A	G	5	3	8	0	0	8	0	0
19	372211	.	A	G	2	10	12	0	1	13	0	0
19	433735	.	T	C	1	3	4	0	0	4	0	0
19	433736	.	T	C	1	3	4	0	0	4	0	0
19	1013144	.	G	A	3	6	9	0	2	11	0	0
19	1185281	.	G	A	12	6	18	0	0	18	0	0
19	1619018	.	T	C	1	5	6	0	1	7	0	0
19	1997684	.	A	G	3	2	5	0	1	6	0	0
19	1998287	.	G	A	1	3	4	0	0	4	0	0
19	2000142	.	C	G	5	5	10	0	0	10	0	0
19	2001557	.	T	C	6	6	12	0	1	13	0	0
19	2001618	.	A	C	9	4	13	0	0	13	0	0
19	2002992	.	A	G	4	0	4	0	6	10	0	0
19	2003150	.	T	C	6	3	9	0	0	9	0	0
19	2003158	.	C	T	7	3	10	0	0	10	0	0
19	2003634	.	T	C	4	5	9	0	1	10	0	0
19	2003767	.	C	T	13	5	18	0	0	18	0	0
19	2003803	.	C	G	15	0	15	0	6	21	0	0
19	2003902	.	A	T	11	8	19	0	0	19	0	0
19	2003962	.	G	T	1	12	13	0	10	23	0	0
19	2004046	.	G	C	6	11	17	0	0	17	0	0
19	2019147	.	C	T	0	6	6	0	6	12	0	0
19	2019430	.	G	A	8	8	16	0	0	16	0	0
19	2019480	.	C	T	0	6	6	0	3	9	0	0
19	2064629	.	G	A	2	6	8	0	0	8	0	0
19	2064762	.	G	C	4	6	10	0	0	10	0	0
19	2071597	.	T	C	2	5	7	0	1	8	0	0
19	2071672	.	A	G	4	2	6	0	0	6	0	0
19	2083254	.	C	T	2	3	5	0	0	5	0	0
19	2084982	.	G	A	8	4	12	0	0	12	0	0
19	2088877	.	G	A	3	4	7	0	0	7	0	0
19	2093318	.	G	A	3	2	5	0	0	5	0	0
19	2279284	.	C	T	9	11	20	0	1	21	0	0
19	2290753	.	T	C	6	6	12	0	1	13	0	0
19	2292831	.	T	C	5	5	10	0	0	10	0	0
19	2294971	.	G	C	5	6	11	0	0	11	0	0
19	2296760	.	A	T	5	12	17	0	0	17	0	0
19	2296826	.	G	C	5	8	13	0	0	13	0	0
19	2296827	.	C	T	4	8	12	0	1	13	0	0
19	2300980	.	G	A	4	4	8	0	2	10	0	0
19	2307248	.	C	A	9	5	14	0	0	14	0	0
19	2307268	.	C	T	6	4	10	0	1	11	0	0
19	2315453	.	A	G	3	3	6	0	0	6	0	0
19	2315511	.	C	T	1	6	7	0	3	10	0	0
19	2315666	.	A	G	4	5	9	0	0	9	0	0
19	2315752	.	A	T	6	2	8	1	0	9	0	0
19	2316215	.	G	A	2	2	4	0	0	4	0	0
19	2316354	.	A	T	2	6	8	0	1	9	0	0
19	2316510	.	T	C	6	4	10	0	0	10	0	0
19	2316729	.	G	C	4	2	6	0	0	6	0	0
19	2316765	.	T	C	3	3	6	0	0	6	0	0
19	2316894	.	T	C	5	7	12	0	2	14	0	0
19	2396647	.	C	T	4	2	6	0	0	6	0	0
19	2396675	.	G	T	5	2	7	0	0	7	0	0
19	2396898	.	G	A	1	3	4	0	0	4	0	0
19	2397268	.	A	T	2	3	5	0	0	5	0	0
19	2397381	.	G	C	1	3	4	0	0	4	0	0
19	2397559	.	T	C	1	3	4	0	0	4	0	0
19	2400403	.	G	A	6	6	12	0	0	12	0	0
19	2402535	.	G	C	2	2	4	0	0	4	0	0
19	2402609	.	T	A	6	5	11	0	0	11	0	0
19	2402611	.	T	A	6	5	11	0	0	11	0	0
19	2403804	.	C	G	3	4	7	0	0	7	0	0
19	2403807	.	C	T	3	3	6	0	0	6	0	0
19	2403906	.	T	C	2	0	2	0	4	6	0	0
19	2420904	.	G	A	4	2	6	0	0	6	0	0
19	2421147	.	G	A	1	2	3	1	0	4	0	0
19	2546871	.	T	A	5	2	7	0	0	7	0	0
19	2547046	.	C	T	5	3	8	0	0	8	0	0
19	2550676	.	G	A	9	8	17	0	1	18	0	0
19	2550839	.	C	T	12	3	15	0	0	15	0	0
19	2551178	.	A	G	12	9	21	0	0	21	0	0
19	2551214	.	C	T	10	7	17	0	0	17	0	0
19	2551727	.	C	T	8	6	14	0	0	14	0	0
19	2560950	.	A	G	7	6	13	0	0	13	0	0
19	2561048	.	A	C	13	12	25	0	0	25	0	0
19	2561739	.	G	A	1	16	17	0	6	23	0	0
19	2562153	.	A	C	3	2	5	0	1	6	0	0
19	2562198	.	T	C	4	3	7	0	0	7	0	0
19	2576864	.	A	T	2	2	4	0	0	4	0	0
19	2576879	.	G	T	1	3	4	0	1	5	0	0
19	2602934	.	G	A	6	9	15	0	1	16	0	0
19	2645115	.	C	T	4	14	18	0	1	19	0	0
19	2651272	.	A	G	9	10	19	0	0	19	0	0
19	2651344	.	G	A	2	5	7	1	9	17	0	0
19	2654388	.	A	T	8	6	14	0	2	16	0	0
19	2654424	.	C	T	10	7	17	0	0	17	0	0
19	2663609	.	A	G	8	12	20	0	0	20	0	0
19	2664125	.	G	A	4	5	9	0	3	12	0	0
19	2664394	.	C	T	12	7	19	0	0	19	0	0
19	2664613	.	T	C	14	4	18	0	0	18	0	0
19	2695030	.	T	C	22	14	36	0	1	37	0	0
19	2695314	.	G	A	5	5	10	0	0	10	0	0
19	2731100	.	C	T	12	14	26	0	0	26	0	0
19	2732833	.	C	T	12	11	23	0	0	23	0	0
19	2732836	.	G	A	11	10	21	0	2	23	0	0
19	2744169	.	C	G	15	10	25	0	1	26	0	0
19	2746008	.	G	A	0	13	13	0	10	23	0	0
19	2746134	.	C	T	18	13	31	0	0	31	0	0
19	2750162	.	G	A	1	19	20	0	16	36	0	0
19	2750973	.	C	T	14	6	20	0	0	20	0	0
19	2857957	.	G	C	2	2	4	0	0	4	0	0
19	2871511	.	A	G	11	6	17	0	0	17	0	0
19	2871553	.	C	T	12	5	17	0	0	17	0	0
19	2871559	.	G	A	6	9	15	0	0	15	0	0
19	2877227	.	C	A	2	3	5	0	0	5	0	0
19	2877239	.	G	A	1	4	5	0	0	5	0	0
19	2877298	.	A	C	2	5	7	0	0	7	0	0
19	2877371	.	C	T	2	2	4	0	0	4	0	0
19	2884200	.	G	A	2	6	8	0	0	8	0	0
19	2884207	.	C	T	0	7	7	0	0	7	0	0
19	2886952	.	G	A	3	4	7	0	0	7	0	0
19	2930451	.	G	A	2	2	4	0	0	4	0	0
19	2930521	.	T	C	1	5	6	0	0	6	0	0
19	2930597	.	A	G	8	4	12	0	1	13	0	0
19	2934321	.	A	G	1	5	6	0	0	6	0	0
19	2960590	.	G	A	5	5	10	0	0	10	0	0
19	2960599	.	T	C	3	0	3	0	8	11	0	0
19	2965923	.	A	G	2	5	7	0	0	7	0	0
19	2967894	.	A	G	2	11	13	0	0	13	0	0
19	3001601	.	C	A	1	2	3	0	1	4	0	0
19	3037184	.	T	C	1	6	7	0	0	7	0	0
19	3037186	.	T	A	1	6	7	0	0	7	0	0
19	3052828	.	A	G	3	6	9	0	0	9	0	0
19	3052836	.	A	T	3	5	8	0	0	8	0	0
19	3052970	.	A	G	3	5	8	0	0	8	0	0
19	3056629	.	C	T	4	3	7	0	0	7	0	0
19	3080572	.	G	A	4	3	7	0	1	8	0	0
19	3080712	.	T	A	6	11	17	0	1	18	0	0
19	3080907	.	A	T	8	5	13	0	1	14	0	0
19	3080938	.	A	G	8	3	11	0	0	11	0	0
19	3081096	.	A	T	7	3	10	0	0	10	0	0
19	3081122	.	A	T	6	2	8	0	0	8	0	0
19	3081154	.	G	C	6	2	8	0	1	9	0	0
19	3081206	.	G	T	4	2	6	0	1	7	0	0
19	3081388	.	A	G	7	0	7	0	7	14	0	0
19	3081394	.	A	G	3	8	11	0	1	12	0	0
19	3081554	.	A	G	13	2	15	0	0	15	0	0
19	3081927	.	G	A	16	6	22	0	0	22	0	0
19	3081933	.	G	A	1	6	7	0	15	22	0	0
19	3082102	.	C	T	15	5	20	0	1	21	0	0
19	3087025	.	A	G	2	5	7	0	0	7	0	0
19	3087180	.	C	A	2	2	4	0	0	4	0	0
19	3137727	.	C	T	5	27	32	0	18	50	0	0
19	3137761	.	C	A	19	21	40	0	1	41	0	0
19	3137803	.	A	T	19	23	42	0	3	46	1	0
19	3137888	.	T	C	21	0	21	0	28	49	0	0
19	3138166	.	G	T	16	4	20	1	0	21	0	0
19	3138325	.	A	C	29	19	48	0	3	51	0	0
19	3138355	.	T	G	28	17	45	0	4	49	0	0
19	3138638	.	T	C	19	0	19	1	16	36	0	0
19	3142240	.	T	C	9	18	27	0	2	29	0	0
19	3142260	.	T	C	14	0	14	0	19	33	0	0
19	3142286	.	C	G	17	19	36	0	0	36	0	0
19	3144567	.	A	G	28	14	42	0	1	43	0	0
19	3144841	.	T	A	17	23	40	0	1	41	0	0
19	3144859	.	C	T	16	22	38	0	1	39	0	0
19	3149236	.	T	C	7	18	25	0	2	27	0	0
19	3149296	.	A	C	7	15	22	0	0	22	0	0
19	3149320	.	T	G	9	15	24	0	0	24	0	0
19	3149368	.	A	T	6	16	22	0	0	22	0	0
19	3149692	.	A	G	6	12	18	0	0	18	0	0
19	3152069	.	C	T	1	3	4	0	5	9	0	0
19	3152091	.	A	T	3	5	8	0	0	8	0	0
19	3152108	.	T	A	3	6	9	0	0	9	0	0
19	3155883	.	A	C	4	0	4	0	3	7	0	0
19	3156017	.	C	T	1	3	4	0	2	6	0	0
19	3163598	.	C	A	4	2	6	0	0	6	0	0
19	3163717	.	A	T	4	2	6	0	0	6	0	0
19	3165035	.	G	T	1	4	5	0	0	5	0	0
19	3206382	.	G	A	20	22	42	0	1	43	0	0
19	3215468	.	A	G	17	22	39	0	0	39	0	0
19	3222241	.	G	A	8	11	19	0	0	19	0	0
19	3229424	.	A	G	12	16	28	0	1	29	0	0
19	3231206	.	T	C	22	12	34	0	0	34	0	0
19	3238395	.	T	A	20	21	41	0	0	41	0	0
19	3238425	.	T	C	20	20	40	0	1	41	0	0
19	3238721	.	T	A	32	25	57	0	1	59	1	0
19	3240409	.	G	C	31	23	54	1	5	60	0	0
19	3379035	.	G	T	3	2	5	0	0	5	0	0
19	3386258	.	T	A	7	15	22	0	0	22	0	0
19	3386358	.	A	G	5	8	13	0	1	14	0	0
19	3386485	.	C	A	8	7	15	0	2	17	0	0
19	3386580	.	T	A	5	3	8	0	0	8	0	0
19	3386873	.	C	T	16	5	21	0	1	22	0	0
19	3387040	.	C	A	1	13	14	0	12	26	0	0
19	3387068	.	A	C	15	10	25	0	3	28	0	0
19	3387097	.	C	G	21	15	36	0	1	37	0	0
19	3387506	.	G	A	19	19	38	0	0	38	0	0
19	3387713	.	G	A	18	28	46	0	2	48	0	0
19	3388376	.	T	C	21	19	40	0	0	40	0	0
19	3388467	.	T	C	26	13	39	0	0	39	0	0
19	3388617	.	G	A	19	17	36	0	0	36	0	0
19	3390203	.	G	A	14	26	40	0	0	40	0	0
19	3390283	.	G	T	9	15	24	0	2	26	0	0
19	3390506	.	C	G	11	17	28	0	0	28	0	0
19	3391479	.	G	A	5	8	13	0	1	14	0	0
19	3391530	.	G	T	8	7	15	0	2	17	0	0
19	3391608	.	T	A	16	6	22	0	0	22	0	0
19	3391669	.	A	G	13	7	20	0	0	20	0	0
19	3391805	.	T	G	15	23	38	0	0	38	0	0
19	3392127	.	G	A	15	9	24	0	1	25	0	0
19	3392178	.	C	T	13	11	24	0	0	24	0	0
19	3392415	.	G	T	13	13	26	0	1	27	0	0
19	3392481	.	A	G	18	10	28	0	0	28	0	0
19	3393128	.	A	T	12	13	25	0	0	25	0	0
19	3393343	.	G	C	10	9	19	0	1	20	0	0
19	3393437	.	T	A	5	7	12	0	1	13	0	0
19	3393924	.	G	A	12	12	24	0	0	24	0	0
19	3395277	.	C	G	0	12	12	0	3	15	0	0
19	3395435	.	C	T	4	5	9	0	0	9	0	0
19	3395457	.	T	A	6	6	12	0	0	12	0	0
19	3395523	.	G	A	8	7	15	0	0	15	0	0
19	3395763	.	T	A	10	14	24	0	0	24	0	0
19	3395889	.	A	G	10	9	19	0	0	19	0	0
19	3396103	.	A	G	9	7	16	0	0	16	0	0
19	3396288	.	T	C	7	8	15	0	1	16	0	0
19	3396338	.	T	C	13	0	13	0	8	21	0	0
19	3539763	.	A	G	2	3	5	0	0	5	0	0
19	3540049	.	G	A	1	2	3	0	0	3	0	0
19	3540107	.	T	C	2	3	5	0	0	5	0	0
19	3540154	.	A	G	1	3	4	0	0	4	0	0
19	3540240	.	T	C	4	3	7	0	0	7	0	0
19	3573912	.	A	T	3	4	7	0	0	7	0	0
19	3653989	.	C	T	6	6	12	0	0	12	0	0
19	3654052	.	T	A	4	4	8	0	0	8	0	0
19	3681077	.	T	C	4	5	9	0	0	9	0	0
19	3681134	.	C	T	3	10	13	0	0	13	0	0
19	3698060	.	A	G	9	5	14	0	0	14	0	0
19	3698249	.	C	G	8	3	11	0	0	11	0	0
19	3702314	.	A	G	5	2	7	0	0	7	0	0
19	3702316	.	C	T	2	2	4	0	0	4	0	0
19	3702476	.	A	T	3	4	7	0	1	8	0	0
19	3702620	.	A	C	2	4	6	0	0	6	0	0
19	3702675	.	G	A	5	8	13	0	0	13	0	0
19	3702941	.	G	A	0	4	4	0	6	10	0	0
19	3703149	.	A	G	4	4	8	0	4	12	0	0
19	3703178	.	C	T	8	7	15	0	0	15	0	0
19	3706902	.	C	G	7	2	9	0	7	16	0	0
19	3707235	.	A	G	7	9	16	0	1	17	0	0
19	3707334	.	G	A	2	2	4	0	0	4	0	0
19	3707562	.	T	A	2	4	6	0	0	6	0	0
19	3707625	.	G	A	1	4	5	0	10	15	0	0
19	3707779	.	A	G	1	1	2	0	2	4	0	0
19	3718110	.	A	T	7	12	19	0	0	19	0	0
19	3718222	.	G	A	11	12	23	0	1	24	0	0
19	3718251	.	C	A	12	11	23	0	0	23	0	0
19	3718330	.	G	A	15	19	34	0	0	34	0	0
19	3718415	.	G	T	14	22	36	0	5	41	0	0
19	3718675	.	C	A	19	27	46	0	0	46	0	0
19	3865928	.	C	T	2	7	9	0	15	24	0	0
19	3866029	.	C	T	10	13	23	0	0	23	0	0
19	3866031	.	G	A	7	16	23	0	0	23	0	0
19	3866075	.	T	C	20	9	29	0	0	29	0	0
19	3866102	.	A	G	18	9	27	0	2	29	0	0
19	3866165	.	T	C	15	6	21	0	2	23	0	0
19	3866289	.	C	G	12	7	19	0	0	19	0	0
19	3866424	.	A	T	13	16	29	0	3	32	0	0
19	3866727	.	C	T	0	15	15	0	20	35	0	0
19	3868535	.	T	C	12	18	30	0	0	30	0	0
19	3868541	.	C	T	0	17	17	0	13	30	0	0
19	3872386	.	G	A	5	16	21	0	0	21	0	0
19	3872419	.	C	T	15	7	22	0	0	22	0	0
19	3872833	.	C	T	11	13	24	0	3	27	0	0
19	3873019	.	C	T	14	10	24	0	0	25	1	0
19	3873055	.	C	T	9	15	24	0	0	24	0	0
19	3873137	.	C	T	1	2	3	0	0	3	0	0
19	3873847	.	A	C	12	15	27	0	0	27	0	0
19	3873955	.	G	A	9	12	21	0	1	22	0	0
19	3874195	.	A	G	19	14	33	0	0	33	0	0
19	3874277	.	C	A	14	13	27	0	2	29	0	0
19	3874339	.	G	A	5	10	15	0	0	15	0	0
19	3874381	.	G	A	13	5	18	0	0	18	0	0
19	3876226	.	T	G	13	8	21	0	0	21	0	0
19	3876227	.	C	T	0	7	7	0	14	21	0	0
19	3876296	.	C	T	5	15	20	0	0	20	0	0
19	3878548	.	C	T	15	9	24	0	0	24	0	0
19	3878565	.	G	C	10	7	17	0	0	17	0	0
19	3937971	.	T	C	22	30	52	0	3	55	0	0
19	3939887	.	C	T	35	17	52	0	1	53	0	0
19	3939902	.	G	T	35	20	55	0	1	56	0	0
19	3940022	.	C	T	2	20	22	1	37	60	0	0
19	3945750	.	G	T	31	21	52	0	3	55	0	0
19	4010175	.	C	A	12	13	25	1	1	27	0	0
19	4089974	.	T	C	6	4	10	0	0	10	0	0
19	4090131	.	G	T	1	3	4	0	0	4	0	0
19	4090283	.	C	T	2	2	4	0	1	5	0	0
19	4090292	.	A	T	2	2	4	0	0	4	0	0
19	4090658	.	T	A	4	3	7	0	0	7	0	0
19	4090662	.	A	G	3	3	6	0	1	7	0	0
19	4090992	.	C	T	2	2	4	0	0	4	0	0
19	4102522	.	G	A	2	4	6	0	0	6	0	0
19	4128384	.	C	T	6	6	12	0	0	12	0	0
19	4128405	.	C	T	3	5	8	0	0	8	0	0
19	4130082	.	C	T	1	3	4	0	2	6	0	0
19	4137043	.	G	A	3	2	5	0	0	5	0	0
19	4137044	.	A	G	3	2	5	0	0	5	0	0
19	4142717	.	T	C	4	9	13	0	2	15	0	0
19	4142777	.	G	A	5	9	14	0	0	14	0	0
19	4142918	.	A	G	6	0	6	0	5	11	0	0
19	4143053	.	A	T	7	5	12	0	0	12	0	0
19	4160385	.	T	C	3	5	8	0	0	8	0	0
19	4160401	.	T	C	3	6	9	0	0	9	0	0
19	4194072	.	T	C	5	6	11	0	0	11	0	0
19	4279835	.	A	C	6	7	13	1	0	14	0	0
19	4291716	.	C	T	5	4	9	0	0	9	0	0
19	4341539	.	T	C	10	7	17	0	0	17	0	0
19	4443334	.	T	C	5	8	13	0	0	14	1	0
19	4443403	.	T	C	11	9	20	0	0	20	0	0
19	4445154	.	T	C	4	8	12	0	0	12	0	0
19	4445222	.	A	T	4	5	9	0	0	9	0	0
19	4445269	.	T	C	3	2	5	0	0	5	0	0
19	4445317	.	T	C	2	2	4	0	0	4	0	0
19	4445329	.	T	A	2	2	4	0	0	4	0	0
19	4447347	.	G	A	5	3	8	0	0	8	0	0
19	4447403	.	A	T	9	2	11	0	2	13	0	0
19	4447421	.	T	C	13	1	14	0	0	14	0	0
19	4447502	.	T	A	4	6	10	0	1	11	0	0
19	4463452	.	G	A	4	2	6	0	0	6	0	0
19	4463460	.	C	T	5	2	7	0	0	7	0	0
19	4463962	.	G	T	2	3	5	0	0	5	0	0
19	4464121	.	G	A	3	5	8	0	0	8	0	0
19	4464173	.	C	T	1	3	4	0	0	4	0	0
19	4464232	.	G	A	2	2	4	0	5	9	0	0
19	4464338	.	G	A	4	2	6	0	0	6	0	0
19	4828379	.	T	G	4	2	6	0	1	7	0	0
19	4828395	.	T	C	5	3	8	0	0	8	0	0
19	4828428	.	A	T	7	4	11	0	1	12	0	0
19	4828463	.	A	G	8	5	13	0	0	13	0	0
19	4828464	.	A	T	8	5	13	0	0	13	0	0
19	4828696	.	G	A	6	2	8	0	0	8	0	0
19	4833274	.	A	G	2	4	6	0	0	6	0	0
19	4833322	.	G	A	2	2	4	0	0	4	0	0
19	4857547	.	G	A	14	7	21	0	1	22	0	0
19	4857910	.	A	G	8	10	18	0	1	19	0	0
19	4857967	.	T	C	13	9	22	0	0	22	0	0
19	4866919	.	T	C	15	12	27	0	2	29	0	0
19	4867128	.	C	T	12	19	31	0	0	31	0	0
19	4867132	.	G	A	4	9	13	0	18	31	0	0
19	4875595	.	A	G	16	8	24	0	1	25	0	0
19	4878742	.	G	T	7	9	16	0	0	16	0	0
19	4878751	.	C	T	12	5	17	0	1	18	0	0
19	4881345	.	G	T	7	10	17	0	0	17	0	0
19	4888756	.	G	A	2	10	12	0	20	32	0	0
19	4892154	.	G	A	11	18	29	0	2	31	0	0
19	4892530	.	G	T	0	10	10	0	15	25	0	0
19	4892590	.	C	T	5	6	11	0	0	11	0	0
19	4892946	.	A	T	4	8	12	0	2	14	0	0
19	4903907	.	C	T	10	13	23	0	0	23	0	0
19	4903971	.	A	T	14	16	30	0	0	30	0	0
19	4904041	.	C	T	7	6	13	0	1	14	0	0
19	4904042	.	A	T	6	6	12	0	2	14	0	0
19	4904429	.	G	A	2	3	5	0	0	5	0	0
19	4904467	.	G	A	3	2	5	0	1	6	0	0
19	4904503	.	C	T	4	3	7	0	0	7	0	0
19	4904529	.	T	A	4	2	6	0	0	6	0	0
19	4905088	.	G	T	7	8	15	0	1	16	0	0
19	4905239	.	C	T	5	6	11	0	0	11	0	0
19	4951138	.	C	T	10	8	18	3	0	21	0	0
19	4951183	.	C	A	7	6	13	3	1	17	0	0
19	4961950	.	A	T	5	10	15	0	1	16	0	0
19	4961977	.	A	T	4	8	12	0	0	12	0	0
19	4962019	.	C	T	4	2	6	0	0	6	0	0
19	4970776	.	C	T	9	9	18	0	0	18	0	0
19	4970860	.	C	T	4	2	6	0	1	7	0	0
19	4970878	.	G	A	0	4	4	0	1	5	0	0
19	4973136	.	G	A	1	8	9	0	5	14	0	0
19	4976906	.	C	T	11	7	18	0	0	18	0	0
19	4976925	.	C	G	9	9	18	0	0	18	0	0
19	4977053	.	A	G	5	0	5	0	6	11	0	0
19	4978656	.	A	G	6	0	6	0	5	11	0	0
19	4978660	.	G	T	5	5	10	0	0	10	0	0
19	4978716	.	A	G	7	4	11	0	0	11	0	0
19	4981062	.	C	A	4	5	9	0	1	10	0	0
19	4984668	.	T	G	4	3	7	0	0	7	0	0
19	4984739	.	G	A	6	7	13	0	0	13	0	0
19	5001119	.	C	T	0	12	12	1	17	30	0	0
19	5003359	.	T	G	20	18	38	0	1	39	0	0
19	5007465	.	G	A	20	10	30	0	0	30	0	0
19	5007549	.	G	A	16	15	31	0	0	31	0	0
19	5009353	.	G	A	12	11	23	0	0	23	0	0
19	5009489	.	G	A	9	15	24	0	1	25	0	0
19	5016257	.	G	C	17	0	17	0	15	32	0	0
19	5018307	.	A	G	13	10	23	0	0	23	0	0
19	5019697	.	G	C	18	13	31	0	1	32	0	0
19	5019712	.	A	T	18	12	30	0	0	30	0	0
19	5019736	.	A	G	16	12	28	0	0	28	0	0
19	5022301	.	C	T	15	14	29	0	2	31	0	0
19	5024424	.	G	A	14	7	21	0	0	21	0	0
19	5024436	.	C	T	11	6	17	0	0	17	0	0
19	5024541	.	C	T	8	17	25	0	1	26	0	0
19	5024685	.	T	C	15	10	25	0	0	25	0	0
19	5025813	.	T	C	9	0	9	0	6	15	0	0
19	5030032	.	T	C	9	13	22	0	1	23	0	0
19	5030214	.	G	T	5	14	19	0	1	20	0	0
19	5030274	.	G	A	11	5	16	0	3	19	0	0
19	5031455	.	A	C	2	8	10	0	0	10	0	0
19	5031461	.	G	A	9	2	11	0	1	12	0	0
19	5034965	.	G	A	11	11	22	0	2	24	0	0
19	5035253	.	G	A	5	11	16	0	0	16	0	0
19	5037382	.	T	C	9	0	9	0	10	19	0	0
19	5048361	.	T	C	7	7	14	0	0	14	0	0
19	5048954	.	T	A	8	9	17	0	1	18	0	0
19	5054876	.	C	T	10	10	20	0	0	20	0	0
19	5058188	.	C	T	0	9	9	0	5	14	0	0
19	5058763	.	G	A	9	9	18	0	0	18	0	0
19	5077167	.	A	G	34	29	63	0	1	64	0	0
19	5077173	.	C	T	33	30	63	0	2	65	0	0
19	5081758	.	T	C	37	23	60	0	2	62	0	0
19	5089900	.	C	G	37	1	38	0	33	71	0	0
19	5090035	.	C	G	34	20	54	0	4	58	0	0
19	5091587	.	G	C	22	30	52	0	2	54	0	0
19	5094405	.	C	A	0	10	10	0	5	15	0	0
19	5094471	.	T	C	7	11	18	0	1	19	0	0
19	5094504	.	A	G	10	13	23	0	0	23	0	0
19	5094591	.	C	T	8	8	16	0	1	17	0	0
19	5094616	.	C	T	0	9	9	0	14	23	0	0
19	5100191	.	G	A	9	18	27	0	0	27	0	0
19	5106982	.	A	C	3	2	5	0	0	5	0	0
19	5135247	.	T	G	17	12	29	0	0	29	0	0
19	5135258	.	C	G	14	13	27	0	1	28	0	0
19	5144107	.	C	T	7	8	15	0	0	15	0	0
19	5146708	.	C	T	14	12	26	0	0	26	0	0
19	5149867	.	C	T	16	15	31	0	0	31	0	0
19	5158572	.	G	A	23	33	56	6	3	65	0	0
19	5158657	.	G	A	51	34	85	0	5	90	0	0
19	5158795	.	A	G	34	38	72	0	5	78	1	0
19	5159120	.	C	T	39	36	75	0	4	79	0	0
19	5159399	.	T	A	30	33	63	0	2	65	0	0
19	5160048	.	C	G	39	25	64	0	5	69	0	0
19	5160121	.	T	C	29	0	29	0	27	56	0	0
19	5160133	.	C	A	0	27	27	0	26	53	0	0
19	5160201	.	A	G	28	32	60	0	4	64	0	0
19	5160302	.	T	C	34	0	34	0	14	48	0	0
19	5160310	.	C	T	4	18	22	0	32	54	0	0
19	5160379	.	T	A	30	23	53	0	0	53	0	0
19	5160996	.	A	T	30	21	51	1	2	54	0	0
19	5161556	.	A	G	20	9	29	0	14	43	0	0
19	5161750	.	A	G	21	33	54	0	3	57	0	0
19	5162521	.	G	A	29	20	49	0	1	50	0	0
19	5162679	.	A	G	27	29	56	0	0	56	0	0
19	5163409	.	G	A	26	29	55	0	1	56	0	0
19	5163910	.	T	C	30	35	65	0	1	66	0	0
19	5300120	.	T	C	11	7	18	0	2	20	0	0
19	5302286	.	A	G	3	5	8	0	1	9	0	0
19	5302463	.	A	C	4	4	8	0	0	8	0	0
19	5305193	.	T	C	16	11	27	0	0	27	0	0
19	5305418	.	A	G	9	4	13	0	1	14	0	0
19	5316439	.	T	C	11	8	19	0	2	21	0	0
19	5611772	.	G	A	19	31	50	0	1	51	0	0
19	5611856	.	A	T	18	25	43	0	2	45	0	0
19	5619892	.	G	A	10	10	20	0	2	22	0	0
19	5619926	.	G	A	0	10	10	0	8	18	0	0
19	5620094	.	A	T	14	6	20	0	2	22	0	0
19	5620175	.	T	G	10	7	17	0	4	21	0	0
19	5620208	.	G	T	14	6	20	0	2	22	0	0
19	5620370	.	T	C	15	16	31	0	0	31	0	0
19	5620419	.	G	A	16	18	34	0	1	35	0	0
19	5620459	.	T	C	18	12	30	0	0	30	0	0
19	5621165	.	G	A	10	5	15	0	1	16	0	0
19	5621269	.	C	T	5	5	10	0	2	12	0	0
19	5779170	.	C	T	3	3	6	0	0	6	0	0
19	5779829	.	G	T	8	8	16	0	1	17	0	0
19	5779835	.	C	T	10	10	20	0	0	20	0	0
19	5779897	.	T	C	13	11	24	0	0	24	0	0
19	5780032	.	C	G	0	7	7	0	8	15	0	0
19	5780293	.	A	T	8	13	21	0	0	21	0	0
19	5780312	.	A	T	9	14	23	0	0	23	0	0
19	5780430	.	T	A	6	1	7	1	1	9	0	0
19	5780506	.	T	A	3	4	7	0	0	7	0	0
19	5780585	.	G	T	10	6	16	0	1	17	0	0
19	5780688	.	A	C	8	4	12	0	0	12	0	0
19	5780989	.	G	A	11	8	19	2	1	22	0	0
19	5781259	.	A	T	5	9	14	0	2	16	0	0
19	5781316	.	G	T	8	5	13	0	0	13	0	0
19	5781367	.	T	C	10	11	21	0	1	22	0	0
19	5793484	.	C	G	7	8	15	0	0	15	0	0
19	5793532	.	T	C	7	10	17	0	0	17	0	0
19	5801151	.	G	A	8	5	13	0	1	14	0	0
19	5805833	.	G	A	6	7	13	0	0	13	0	0
19	5805839	.	G	A	6	8	14	0	0	14	0	0
19	6060281	.	T	A	16	17	33	0	0	33	0	0
19	6060309	.	A	T	20	13	33	0	1	34	0	0
19	6060415	.	C	A	1	12	13	0	7	20	0	0
19	6076813	.	C	A	5	10	15	0	2	17	0	0
19	6083524	.	G	A	14	7	21	0	0	21	0	0
19	6086441	.	C	G	10	19	29	0	1	30	0	0
19	6086577	.	C	T	1	15	16	0	10	26	0	0
19	6087130	.	T	A	8	9	17	0	0	17	0	0
19	6087146	.	C	T	2	10	12	0	7	19	0	0
19	6087186	.	A	T	12	10	22	0	1	23	0	0
19	6087619	.	T	C	5	0	5	0	10	15	0	0
19	6087894	.	G	A	11	8	19	0	2	21	0	0
19	6087948	.	A	T	14	9	23	3	0	26	0	0
19	6088000	.	C	T	4	18	22	3	11	36	0	0
19	6088166	.	T	C	10	12	22	0	0	22	0	0
19	6088259	.	A	C	11	15	26	0	1	27	0	0
19	6088368	.	A	G	9	19	28	0	3	31	0	0
19	6090702	.	T	C	12	18	30	1	1	32	0	0
19	6090732	.	T	A	11	18	29	1	0	30	0	0
19	6094162	.	A	C	9	16	25	0	0	25	0	0
19	6097473	.	C	A	17	18	35	0	0	35	0	0
19	6100295	.	A	G	14	11	25	0	0	25	0	0
19	6102594	.	A	T	13	11	24	0	4	28	0	0
19	6102732	.	T	C	10	14	24	0	4	28	0	0
19	6105528	.	A	T	10	10	20	2	2	24	0	0
19	6111085	.	G	A	11	7	18	0	1	19	0	0
19	6111214	.	A	G	16	16	32	0	0	32	0	0
19	6111223	.	A	G	17	16	33	0	0	33	0	0
19	6111268	.	G	A	14	12	26	0	0	26	0	0
19	6111544	.	A	G	5	9	14	0	2	16	0	0
19	6111724	.	T	C	8	9	17	0	2	19	0	0
19	6111793	.	G	A	14	12	26	0	0	26	0	0
19	6116477	.	A	G	12	5	17	0	1	18	0	0
19	6116638	.	A	G	4	10	14	0	0	14	0	0
19	6122614	.	A	G	6	7	13	0	1	14	0	0
19	6124000	.	T	C	10	0	10	0	5	15	0	0
19	6125329	.	G	T	8	11	19	0	1	20	0	0
19	6125350	.	A	G	10	7	17	0	1	18	0	0
19	6125425	.	A	T	6	10	16	0	1	17	0	0
19	6125656	.	G	C	6	11	17	0	1	18	0	0
19	6125926	.	G	A	14	11	25	0	2	27	0	0
19	6125941	.	C	T	16	12	28	0	2	30	0	0
19	6126001	.	G	A	9	19	28	0	2	30	0	0
19	6126046	.	A	T	4	16	20	0	12	32	0	0
19	6126277	.	G	A	5	3	8	0	0	8	0	0
19	6126403	.	C	G	8	5	13	0	0	13	0	0
19	6126544	.	A	G	7	5	12	0	0	12	0	0
19	6126625	.	G	A	13	9	22	0	1	23	0	0
19	6126645	.	T	C	8	9	17	0	4	21	0	0
19	6127108	.	C	A	7	7	14	0	0	14	0	0
19	6127669	.	C	A	4	7	11	0	0	11	0	0
19	6127696	.	T	C	3	5	8	0	0	8	0	0
19	6127764	.	A	G	7	5	12	0	0	12	0	0
19	6127768	.	A	G	7	5	12	0	0	12	0	0
19	6127847	.	G	T	8	3	11	0	1	12	0	0
19	6128416	.	G	A	3	7	10	0	0	10	0	0
19	6142187	.	C	A	1	5	6	0	6	12	0	0
19	6142669	.	T	A	15	5	20	0	0	20	0	0
19	6142714	.	A	T	11	8	19	0	1	20	0	0
19	6142802	.	G	T	6	11	17	0	1	18	0	0
19	6142803	.	A	G	6	11	17	0	1	18	0	0
19	6143608	.	C	T	0	8	8	0	7	15	0	0
19	6143825	.	C	T	6	5	11	0	0	11	0	0
19	6143919	.	T	C	5	7	12	0	0	12	0	0
19	6144267	.	C	A	7	8	15	0	0	15	0	0
19	6144468	.	G	T	3	2	5	0	0	5	0	0
19	6144722	.	C	T	7	6	13	0	0	13	0	0
19	6144822	.	C	G	6	4	10	0	0	10	0	0
19	6145406	.	G	A	7	4	11	0	1	12	0	0
19	6145736	.	G	A	6	7	13	0	0	13	0	0
19	6145964	.	A	G	6	6	12	0	0	12	0	0
19	6146170	.	T	C	2	0	2	0	5	7	0	0
19	6152703	.	T	C	2	3	5	0	0	5	0	0
19	6193005	.	C	G	2	2	4	0	0	4	0	0
19	6193178	.	T	C	1	4	5	0	0	5	0	0
19	6214598	.	G	A	2	6	8	0	0	8	0	0
19	6216471	.	A	C	3	5	8	0	1	9	0	0
19	6217667	.	A	G	4	6	10	0	0	10	0	0
19	6232242	.	T	C	3	0	3	0	5	8	0	0
19	6233690	.	C	A	0	3	3	0	3	6	0	0
19	6235425	.	C	T	2	1	3	0	3	6	0	0
19	6235483	.	G	A	2	2	4	0	1	5	0	0
19	6328442	.	T	C	43	8	51	0	43	94	0	0
19	6328514	.	A	C	53	25	78	0	6	84	0	0
19	6328533	.	A	G	48	37	85	0	6	91	0	0
19	6328830	.	T	G	38	42	80	0	8	88	0	0
19	6328859	.	G	A	32	33	65	0	8	73	0	0
19	6328889	.	C	T	3	41	44	0	29	73	0	0
19	6328906	.	G	A	31	40	71	0	1	72	0	0
19	6328963	.	T	C	39	36	75	0	2	77	0	0
19	6329062	.	A	T	36	28	64	1	2	67	0	0
19	6329381	.	A	T	36	29	65	0	3	68	0	0
19	6329382	.	T	G	39	28	67	0	1	68	0	0
19	6329533	.	C	T	6	35	41	0	37	78	0	0
19	6329813	.	G	A	44	31	75	0	1	76	0	0
19	6330194	.	A	C	35	8	43	1	42	86	0	0
19	6330239	.	C	A	6	45	51	1	28	80	0	0
19	6332767	.	A	C	43	5	48	0	39	87	0	0
19	6332902	.	C	A	5	32	37	0	38	76	1	0
19	6332947	.	C	T	10	34	44	0	39	83	0	0
19	6332973	.	G	A	46	30	76	0	5	81	0	0
19	6338207	.	A	G	42	23	65	0	6	71	0	0
19	6338261	.	A	G	45	26	71	0	3	74	0	0
19	6342278	.	G	T	39	29	68	0	1	69	0	0
19	6344522	.	G	C	37	7	44	0	29	73	0	0
19	6346506	.	C	G	30	39	69	0	1	70	0	0
19	6346587	.	C	T	1	24	25	0	40	65	0	0
19	6347662	.	C	T	29	31	60	0	4	64	0	0
19	6352379	.	A	G	33	24	57	1	7	65	0	0
19	6352448	.	G	A	22	28	50	0	7	58	1	0
19	6352511	.	G	A	33	36	69	1	7	77	0	0
19	6358232	.	A	G	27	21	48	0	2	50	0	0
19	6365777	.	G	A	30	29	59	0	3	62	0	0
19	6606673	.	T	A	8	12	20	0	1	21	0	0
19	6606725	.	T	C	14	6	20	0	3	23	0	0
19	6606764	.	A	T	14	6	20	0	0	20	0	0
19	6612432	.	T	C	5	6	11	0	0	11	0	0
19	6618293	.	A	G	10	7	17	0	0	17	0	0
19	6869051	.	T	C	3	4	7	0	0	7	0	0
19	6871741	.	C	T	1	4	5	5	0	10	0	0
19	6872539	.	T	C	11	10	21	0	0	21	0	0
19	6872595	.	C	T	7	6	13	0	0	13	0	0
19	6892337	.	A	G	2	2	4	1	0	5	0	0
19	6900092	.	T	C	1	3	4	0	0	4	0	0
19	6900162	.	C	T	1	2	3	2	0	5	0	0
19	6900897	.	G	A	3	2	5	0	0	5	0	0
19	6900903	.	T	C	3	2	5	0	1	6	0	0
19	6901023	.	T	C	1	2	3	0	0	3	0	0
19	6901174	.	G	T	0	2	2	0	4	6	0	0
19	6906995	.	A	T	2	1	3	0	0	3	0	0
19	6907006	.	A	G	1	2	3	0	0	3	0	0
19	6908155	.	T	G	2	0	2	0	2	4	0	0
19	6908433	.	A	C	2	2	4	0	0	4	0	0
19	6908495	.	A	T	3	2	5	0	0	5	0	0
19	6910409	.	A	G	1	3	4	0	2	6	0	0
19	6914145	.	G	A	7	4	11	0	0	11	0	0
19	6914280	.	A	T	3	4	7	0	0	7	0	0
19	6914319	.	T	A	3	4	7	0	0	7	0	0
19	6914415	.	T	C	3	4	7	1	0	8	0	0
19	6914589	.	T	C	4	3	7	1	0	8	0	0
19	6914706	.	T	G	4	0	4	0	3	7	0	0
19	6914790	.	G	T	0	4	4	0	2	6	0	0
19	6915030	.	T	C	3	3	6	0	0	6	0	0
19	6915114	.	C	T	5	5	10	0	1	11	0	0
19	6915175	.	A	C	5	4	9	0	0	9	0	0
19	6915177	.	A	G	5	4	9	0	0	9	0	0
19	6915234	.	G	A	4	3	7	1	0	8	0	0
19	6916019	.	T	C	2	3	5	0	0	5	0	0
19	6916029	.	G	A	2	3	5	0	1	6	0	0
19	6918156	.	T	G	1	0	1	0	2	3	0	0
19	6918179	.	C	T	1	2	3	0	0	3	0	0
19	6918219	.	T	C	1	3	4	0	0	4	0	0
19	6921535	.	G	A	0	2	2	0	1	3	0	0
19	6922621	.	G	A	0	1	1	0	1	2	0	0
19	6922645	.	T	C	2	2	4	0	0	4	0	0
19	6928466	.	C	A	1	4	5	0	0	5	0	0
19	6928494	.	A	C	2	4	6	0	0	6	0	0
19	6932453	.	C	A	3	2	5	0	0	6	1	0
19	6933697	.	G	T	0	3	3	0	1	4	0	0
19	6933716	.	T	A	1	2	3	0	1	4	0	0
19	6934005	.	C	T	3	2	5	0	0	5	0	0
19	6934166	.	C	T	2	3	5	0	0	5	0	0
19	6934188	.	G	T	1	4	5	0	0	5	0	0
19	6938364	.	A	T	19	13	32	0	0	32	0	0
19	6938377	.	A	T	19	12	31	0	1	32	0	0
19	6940213	.	C	T	14	15	29	0	1	30	0	0
19	6949256	.	G	A	0	16	16	0	16	32	0	0
19	6949316	.	C	A	23	16	39	0	2	41	0	0
19	6950393	.	G	A	23	25	48	0	2	50	0	0
19	6952600	.	T	C	27	19	46	0	4	50	0	0
19	6955061	.	C	T	24	14	38	0	0	38	0	0
19	6955130	.	C	T	14	15	29	0	0	29	0	0
19	6955131	.	C	T	13	14	27	0	2	29	0	0
19	6955198	.	C	A	20	14	34	1	1	36	0	0
19	6955411	.	C	T	13	7	20	0	3	23	0	0
19	6955475	.	T	C	9	8	17	0	1	18	0	0
19	6955609	.	C	G	10	13	23	1	0	24	0	0
19	6955620	.	G	A	1	11	12	1	11	24	0	0
19	6955920	.	G	A	13	15	28	0	2	30	0	0
19	6956058	.	T	C	19	19	38	1	0	39	0	0
19	6956060	.	G	A	20	19	39	1	0	40	0	0
19	6956665	.	C	A	15	11	26	0	0	26	0	0
19	6956728	.	T	A	21	12	33	0	0	33	0	0
19	6956829	.	T	A	17	6	23	0	0	23	0	0
19	6956835	.	C	G	16	7	23	0	0	23	0	0
19	6956881	.	T	C	12	7	19	0	0	19	0	0
19	6956892	.	T	A	9	7	16	0	0	16	0	0
19	6956939	.	T	C	13	5	18	0	0	18	0	0
19	6956959	.	A	G	5	15	20	0	0	20	0	0
19	6957127	.	A	T	27	12	39	0	0	39	0	0
19	6957131	.	C	A	21	12	33	0	5	38	0	0
19	6960531	.	A	T	1	2	3	0	0	3	0	0
19	6960653	.	C	A	9	5	14	0	0	14	0	0
19	6961421	.	T	A	7	4	11	0	0	11	0	0
19	6961610	.	G	A	4	4	8	0	1	9	0	0
19	6961674	.	A	G	6	8	14	0	0	14	0	0
19	6962787	.	T	C	13	4	17	0	0	17	0	0
19	6963020	.	C	T	1	5	6	0	0	6	0	0
19	6963966	.	G	A	3	6	9	0	0	9	0	0
19	6963996	.	G	A	4	5	9	0	0	9	0	0
19	6964189	.	G	A	7	2	9	0	2	11	0	0
19	6964195	.	C	T	9	1	10	0	2	12	0	0
19	6964273	.	C	A	9	6	15	1	0	16	0	0
19	6964364	.	C	T	14	10	24	0	0	24	0	0
19	6964381	.	T	C	11	10	21	0	1	22	0	0
19	6964417	.	A	G	7	12	19	0	0	19	0	0
19	6964483	.	A	T	5	6	11	0	0	11	0	0
19	6964486	.	C	T	4	5	9	0	0	9	0	0
19	6964636	.	C	T	3	5	8	0	0	8	0	0
19	6964641	.	T	C	3	2	5	0	4	9	0	0
19	6964866	.	C	T	2	2	4	0	0	4	0	0
19	6965088	.	C	T	1	3	4	0	0	4	0	0
19	6965091	.	A	T	1	3	4	0	0	4	0	0
19	6965235	.	A	G	1	3	4	0	0	4	0	0
19	6965250	.	G	A	1	4	5	0	0	5	0	0
19	6965382	.	A	T	4	3	7	0	1	8	0	0
19	6965420	.	A	T	3	4	7	0	0	7	0	0
19	6965548	.	T	C	4	2	6	0	0	6	0	0
19	6965767	.	G	A	7	3	10	0	0	10	0	0
19	6965894	.	C	A	2	4	6	0	3	9	0	0
19	6965897	.	C	T	3	4	7	0	0	7	0	0
19	6966003	.	C	A	3	4	7	0	0	7	0	0
19	6966022	.	A	G	5	4	9	0	0	9	0	0
19	6966208	.	G	A	10	12	22	0	0	22	0	0
19	6966781	.	A	T	15	7	22	0	0	22	0	0
19	6975261	.	A	C	7	0	7	1	6	14	0	0
19	6977067	.	T	C	4	0	4	0	4	8	0	0
19	6980493	.	C	T	5	7	12	0	1	13	0	0
19	6988778	.	T	C	7	8	15	0	0	15	0	0
19	6995165	.	A	T	3	2	5	0	0	5	0	0
19	6995170	.	A	G	2	2	4	0	0	4	0	0
19	7003228	.	C	A	3	3	6	0	0	6	0	0
19	7004841	.	G	A	2	2	4	0	6	10	0	0
19	7005030	.	C	T	8	5	13	0	1	14	0	0
19	7005032	.	G	C	8	6	14	0	0	14	0	0
19	7005282	.	T	C	5	3	8	0	0	8	0	0
19	7005462	.	G	A	2	4	6	0	8	14	0	0
19	7005549	.	A	C	2	5	7	0	1	8	0	0
19	7005821	.	A	G	6	3	9	0	0	9	0	0
19	7005881	.	C	T	7	3	10	0	0	10	0	0
19	7006215	.	C	T	5	5	10	0	2	12	0	0
19	7006682	.	G	A	4	5	9	0	0	9	0	0
19	7006709	.	G	T	1	8	9	0	5	14	0	0
19	7006826	.	C	A	2	2	4	0	0	4	0	0
19	7006837	.	A	C	3	2	5	0	0	5	0	0
19	7006928	.	C	T	3	5	8	0	0	8	0	0
19	7014815	.	C	T	6	3	9	0	0	9	0	0
19	7014909	.	C	A	4	4	8	0	0	8	0	0
19	7014912	.	G	A	2	4	6	0	0	6	0	0
19	7014948	.	T	C	2	0	2	0	3	5	0	0
19	7020179	.	G	A	5	8	13	0	1	14	0	0
19	7020775	.	T	C	5	4	9	0	0	9	0	0
19	7022107	.	G	A	5	4	9	0	1	10	0	0
19	7022128	.	G	A	6	4	10	0	1	11	0	0
19	7024591	.	T	G	7	4	11	0	1	12	0	0
19	7024593	.	C	T	8	3	11	0	1	12	0	0
19	7024627	.	T	C	2	8	10	0	1	11	0	0
19	7027127	.	G	C	3	3	6	0	0	6	0	0
19	7027810	.	A	T	5	4	9	0	1	10	0	0
19	7027927	.	G	A	5	5	10	0	1	11	0	0
19	7028011	.	C	T	2	2	4	0	0	4	0	0
19	7029769	.	A	G	2	4	6	0	1	7	0	0
19	7029770	.	C	G	2	5	7	0	0	7	0	0
19	7029806	.	C	G	4	4	8	0	0	8	0	0
19	7029811	.	G	A	4	4	8	0	0	8	0	0
19	7029883	.	C	A	2	7	9	0	0	9	0	0
19	7029915	.	A	G	1	7	8	0	0	8	0	0
19	7031333	.	A	G	5	3	8	0	0	8	0	0
19	7031350	.	G	A	5	3	8	0	0	8	0	0
19	7031368	.	T	G	4	2	6	0	0	6	0	0
19	7039113	.	G	A	1	2	3	0	0	3	0	0
19	7039308	.	G	A	6	3	9	0	1	10	0	0
19	7040158	.	A	G	3	2	5	1	1	7	0	0
19	7068998	.	C	T	0	3	3	0	1	4	0	0
19	7069019	.	A	G	1	4	5	0	0	5	0	0
19	7100564	.	A	T	9	3	12	0	0	12	0	0
19	7106409	.	A	G	3	2	5	0	0	5	0	0
19	7106433	.	G	A	2	3	5	0	0	5	0	0
19	7120539	.	G	A	2	2	4	0	0	4	0	0
19	7120577	.	T	A	2	3	5	0	0	5	0	0
19	7121648	.	C	G	4	2	6	0	0	6	0	0
19	7121786	.	C	T	1	3	4	0	0	4	0	0
19	7121807	.	C	G	2	2	4	0	0	4	0	0
19	7130309	.	T	C	5	3	8	0	1	9	0	0
19	7130312	.	C	G	5	0	5	0	4	9	0	0
19	7152971	.	G	T	2	11	13	0	10	23	0	0
19	7152974	.	G	A	12	12	24	0	0	24	0	0
19	7154729	.	A	G	18	20	38	0	1	39	0	0
19	7154770	.	A	C	17	23	40	0	0	40	0	0
19	7155001	.	A	T	12	11	23	0	0	23	0	0
19	7155034	.	A	G	17	12	29	0	2	31	0	0
19	7155065	.	T	C	18	14	32	0	0	32	0	0
19	7158469	.	C	T	8	12	20	0	0	20	0	0
19	7159062	.	G	A	1	16	17	0	11	28	0	0
19	7159107	.	T	C	13	18	31	0	2	33	0	0
19	7161452	.	G	A	8	6	14	0	0	14	0	0
19	7161527	.	A	G	9	0	9	0	12	21	0	0
19	7161539	.	G	T	8	11	19	0	0	19	0	0
19	7163872	.	C	T	13	12	25	0	1	26	0	0
19	7163908	.	A	G	13	7	20	0	0	20	0	0
19	7164022	.	G	A	10	14	24	0	1	25	0	0
19	7166211	.	C	T	6	12	18	0	2	20	0	0
19	7166454	.	C	A	10	10	20	0	0	20	0	0
19	7169204	.	A	C	15	12	27	0	2	29	0	0
19	7169228	.	C	T	9	13	22	0	2	24	0	0
19	7169587	.	A	G	4	4	8	0	0	8	0	0
19	7169588	.	G	A	4	3	7	0	1	8	0	0
19	7169770	.	A	C	11	8	19	0	0	19	0	0
19	7169809	.	C	T	8	16	24	0	0	24	0	0
19	7169880	.	T	C	10	8	18	0	0	18	0	0
19	7169886	.	G	A	11	7	18	0	0	18	0	0
19	7169929	.	G	A	14	9	23	0	2	25	0	0
19	7170014	.	A	C	8	5	13	0	0	13	0	0
19	7170015	.	T	C	8	5	13	0	0	13	0	0
19	7170128	.	A	G	11	9	20	0	0	20	0	0
19	7170191	.	A	C	4	6	10	0	0	10	0	0
19	7170228	.	A	T	5	9	14	0	0	14	0	0
19	7174486	.	G	T	5	3	8	0	0	8	0	0
19	7174669	.	T	C	8	4	12	0	0	12	0	0
19	7174672	.	T	A	9	4	13	0	0	13	0	0
19	7176913	.	G	A	0	2	2	0	7	9	0	0
19	7176915	.	C	A	6	2	8	0	1	9	0	0
19	7249800	.	A	G	17	8	25	0	1	26	0	0
19	7249811	.	T	C	20	8	28	0	1	29	0	0
19	7250372	.	T	C	14	6	20	1	0	21	0	0
19	7258085	.	A	G	11	15	26	0	0	26	0	0
19	7258118	.	C	T	10	12	22	0	0	22	0	0
19	7260739	.	G	A	1	3	4	0	0	4	0	0
19	7265377	.	T	C	9	13	22	0	1	23	0	0
19	7270102	.	G	A	11	16	27	0	1	28	0	0
19	7270156	.	C	A	3	12	15	0	5	20	0	0
19	7272224	.	C	A	13	16	29	0	0	29	0	0
19	7272935	.	G	A	9	9	18	0	0	18	0	0
19	7276106	.	G	A	12	8	20	0	1	21	0	0
19	7276149	.	A	G	25	16	41	0	4	45	0	0
19	7276194	.	T	A	29	16	45	0	2	47	0	0
19	7276559	.	G	A	36	37	73	0	0	73	0	0
19	7276610	.	G	A	35	41	76	0	3	79	0	0
19	7279235	.	A	G	31	29	60	2	3	65	0	0
19	7279721	.	A	G	22	29	51	0	5	56	0	0
19	7282541	.	C	T	19	34	53	0	2	55	0	0
19	7282554	.	G	A	22	33	55	0	3	58	0	0
19	7283427	.	C	A	27	30	57	0	2	59	0	0
19	7283499	.	A	G	36	23	59	1	2	62	0	0
19	7284840	.	C	T	4	20	24	0	30	54	0	0
19	7286301	.	A	G	37	23	60	0	3	63	0	0
19	7286355	.	A	G	34	28	62	0	2	64	0	0
19	7286421	.	T	A	31	24	55	0	1	56	0	0
19	7286742	.	A	G	33	24	57	0	3	60	0	0
19	7287600	.	T	C	25	26	51	0	3	54	0	0
19	7287603	.	G	A	26	24	50	0	1	51	0	0
19	7288195	.	A	G	29	30	59	0	5	64	0	0
19	7290175	.	A	G	28	29	57	0	5	62	0	0
19	7290214	.	A	G	35	29	64	0	6	70	0	0
19	7291642	.	A	T	25	27	52	0	1	54	1	0
19	7292621	.	G	A	2	4	6	0	0	6	0	0
19	7292636	.	A	T	2	5	7	0	1	8	0	0
19	7293138	.	A	G	5	3	8	0	0	8	0	0
19	7295279	.	G	A	1	8	9	0	0	9	0	0
19	7295572	.	G	C	2	2	4	0	2	6	0	0
19	7309154	.	G	A	9	6	15	0	2	17	0	0
19	7309391	.	C	A	23	22	45	0	3	48	0	0
19	7309522	.	G	C	17	18	35	0	0	35	0	0
19	7309556	.	T	A	13	14	27	0	0	28	1	0
19	7309557	.	T	A	14	15	29	0	0	29	0	0
19	7309754	.	T	G	9	14	23	0	2	25	0	0
19	7309929	.	A	T	20	9	29	0	4	33	0	0
19	7309968	.	G	T	16	10	26	0	0	26	0	0
19	7310117	.	T	C	21	0	21	0	11	32	0	0
19	7310131	.	C	T	18	9	27	0	3	30	0	0
19	7310154	.	A	T	16	11	27	0	0	27	0	0
19	7310974	.	T	G	10	15	25	0	0	25	0	0
19	7311678	.	T	G	16	14	30	0	0	30	0	0
19	7313933	.	C	G	26	16	42	0	1	43	0	0
19	7327462	.	A	G	16	8	24	0	0	24	0	0
19	7327519	.	C	T	9	11	20	0	2	22	0	0
19	7327564	.	G	T	11	14	25	0	1	26	0	0
19	7327570	.	T	C	9	14	23	0	2	25	0	0
19	7337862	.	C	A	16	10	26	0	0	26	0	0
19	7338033	.	C	T	2	13	15	0	20	35	0	0
19	7338125	.	C	T	10	9	19	0	1	20	0	0
19	7338150	.	G	A	7	7	14	0	0	14	0	0
19	7338218	.	A	T	10	3	13	0	4	17	0	0
19	7338309	.	C	T	2	11	13	0	7	20	0	0
19	7338402	.	C	T	0	15	15	0	12	27	0	0
19	7338425	.	T	C	10	15	25	0	0	25	0	0
19	7338444	.	T	C	13	0	13	0	14	27	0	0
19	7338969	.	C	T	11	15	26	0	0	26	0	0
19	7338978	.	T	C	13	0	13	0	14	27	0	0
19	7339008	.	T	G	16	8	24	0	0	25	1	0
19	7341300	.	G	A	12	12	24	0	0	24	0	0
19	7341385	.	A	G	14	6	20	0	1	21	0	0
19	7358131	.	A	G	13	20	33	1	0	34	0	0
19	7379601	.	C	T	10	5	15	0	1	16	0	0
19	7379637	.	T	C	9	0	9	0	11	20	0	0
19	7406810	.	G	T	6	6	12	0	0	12	0	0
19	7408277	.	C	T	1	3	4	0	0	4	0	0
19	7408360	.	T	G	9	8	17	0	1	18	0	0
19	7409961	.	A	G	5	6	11	0	0	11	0	0
19	7411975	.	T	C	4	8	12	0	0	12	0	0
19	7412062	.	T	C	6	9	15	0	0	15	0	0
19	7412320	.	C	T	4	10	14	0	1	15	0	0
19	7412358	.	A	T	2	13	15	0	0	15	0	0
19	7412562	.	G	T	1	2	3	0	0	3	0	0
19	7424794	.	G	A	14	9	23	0	1	24	0	0
19	7426637	.	C	T	10	10	20	0	0	20	0	0
19	7426814	.	C	T	8	11	19	0	0	19	0	0
19	7426832	.	G	A	9	13	22	0	1	23	0	0
19	7426967	.	T	C	9	13	22	0	1	23	0	0
19	7427099	.	C	A	14	11	25	0	2	27	0	0
19	7430160	.	T	C	11	14	25	0	2	27	0	0
19	7430607	.	G	A	0	4	4	0	16	20	0	0
19	7430652	.	C	T	12	6	18	0	1	19	0	0
19	7430700	.	A	G	3	0	3	0	6	9	0	0
19	7430715	.	C	A	3	5	8	0	0	8	0	0
19	7432806	.	A	C	1	3	4	0	1	5	0	0
19	7433068	.	T	A	1	5	6	0	0	6	0	0
19	7433598	.	C	T	1	3	4	0	0	4	0	0
19	7433601	.	T	C	1	2	3	0	0	3	0	0
19	7433637	.	C	A	1	4	5	0	0	5	0	0
19	7433746	.	A	C	2	2	4	0	0	4	0	0
19	7434010	.	T	C	3	2	5	0	0	5	0	0
19	7434139	.	T	C	4	8	12	0	0	12	0	0
19	7434161	.	G	T	6	5	11	0	2	13	0	0
19	7434252	.	T	C	2	3	5	0	0	5	0	0
19	7434731	.	G	C	4	3	7	0	0	7	0	0
19	7434753	.	A	G	5	6	11	0	0	11	0	0
19	7434866	.	C	T	3	2	5	0	0	5	0	0
19	7435410	.	A	G	1	3	4	0	0	4	0	0
19	7435422	.	G	A	2	1	3	0	1	4	0	0
19	7435535	.	C	A	3	3	6	0	1	7	0	0
19	7435605	.	T	C	6	4	10	0	0	10	0	0
19	7437053	.	A	G	3	7	10	0	1	11	0	0
19	7438363	.	C	A	4	2	6	0	0	6	0	0
19	7439799	.	C	T	5	5	10	0	0	10	0	0
19	7441832	.	T	A	5	3	8	0	0	8	0	0
19	7445676	.	G	A	11	5	16	1	0	17	0	0
19	7445897	.	C	T	23	34	57	0	4	61	0	0
19	7446050	.	T	C	29	26	55	0	0	55	0	0
19	7446137	.	G	T	21	32	53	0	2	55	0	0
19	7446286	.	G	T	34	22	56	0	5	61	0	0
19	7446495	.	G	T	35	35	70	0	5	75	0	0
19	7446621	.	C	A	40	29	69	0	1	70	0	0
19	7446702	.	T	C	35	33	68	0	2	70	0	0
19	7450572	.	G	A	39	27	66	0	4	70	0	0
19	7450658	.	T	C	21	13	34	0	1	35	0	0
19	7450750	.	A	G	6	8	14	0	0	14	0	0
19	7450783	.	C	T	0	10	10	0	9	19	0	0
19	7454109	.	A	C	7	5	12	0	0	12	0	0
19	7456364	.	T	C	6	5	11	0	0	11	0	0
19	7456371	.	A	C	6	5	11	0	0	11	0	0
19	7456722	.	C	G	1	9	10	0	1	11	0	0
19	7456793	.	A	G	5	13	18	0	1	19	0	0
19	7456816	.	C	G	6	9	15	0	1	16	0	0
19	7468556	.	G	T	9	8	17	0	1	18	0	0
19	7468580	.	C	T	9	9	18	0	1	19	0	0
19	7468746	.	T	A	4	8	12	0	1	13	0	0
19	7474242	.	T	C	10	14	24	0	1	25	0	0
19	7474245	.	T	G	9	0	9	0	14	23	0	0
19	7478159	.	A	G	5	14	19	0	0	19	0	0
19	7478283	.	C	T	2	3	5	0	1	6	0	0
19	7478356	.	G	A	2	7	9	0	0	9	0	0
19	7482931	.	C	T	6	6	12	0	1	13	0	0
19	7482993	.	G	A	8	5	13	1	0	14	0	0
19	7483059	.	A	T	6	2	8	0	1	10	1	0
19	7483469	.	T	G	3	8	11	0	0	11	0	0
19	7484313	.	T	A	1	2	3	0	0	3	0	0
19	7484354	.	A	T	1	1	2	0	1	3	0	0
19	7484357	.	G	A	2	2	4	0	0	4	0	0
19	7484536	.	G	T	6	2	8	0	0	8	0	0
19	7484834	.	A	G	1	5	6	0	0	6	0	0
19	7484856	.	C	G	0	3	3	0	1	4	0	0
19	7484990	.	G	T	1	4	5	0	0	5	0	0
19	7485117	.	C	T	2	3	5	0	0	5	0	0
19	7485298	.	A	C	1	2	3	0	0	3	0	0
19	7485339	.	A	C	1	2	3	0	0	3	0	0
19	7485503	.	G	A	4	3	7	0	1	8	0	0
19	7485839	.	G	T	3	5	8	0	0	8	0	0
19	7485890	.	G	A	6	4	10	0	0	10	0	0
19	7486022	.	T	C	5	3	8	1	0	9	0	0
19	7486314	.	A	T	2	3	5	0	0	5	0	0
19	7486353	.	G	A	2	3	5	0	0	5	0	0
19	7486698	.	G	C	5	0	5	0	3	8	0	0
19	7486791	.	T	C	4	8	12	0	0	12	0	0
19	7487103	.	G	A	5	2	7	0	0	7	0	0
19	7487163	.	A	G	1	4	5	0	2	7	0	0
19	7487321	.	C	T	6	5	11	0	1	12	0	0
19	7487592	.	T	A	5	6	11	0	0	11	0	0
19	7490212	.	C	T	3	4	7	0	0	7	0	0
19	7490227	.	A	G	3	2	5	0	0	5	0	0
19	7490873	.	T	A	1	6	7	0	0	7	0	0
19	7495867	.	A	T	18	12	30	0	0	30	0	0
19	7498046	.	T	C	17	12	29	0	2	31	0	0
19	7498079	.	A	G	15	12	27	0	3	30	0	0
19	7498103	.	A	G	14	12	26	0	1	27	0	0
19	7505591	.	A	G	11	11	22	0	1	23	0	0
19	7505907	.	A	G	9	1	10	0	9	19	0	0
19	7506036	.	A	G	6	0	6	0	4	10	0	0
19	7507833	.	A	T	18	13	31	0	1	32	0	0
19	7510223	.	T	C	16	13	29	0	1	30	0	0
19	7510348	.	T	C	11	8	19	0	2	21	0	0
19	7510501	.	G	A	1	14	15	0	13	28	0	0
19	7510567	.	C	T	14	18	32	0	0	32	0	0
19	7512406	.	C	G	10	18	28	0	2	30	0	0
19	7513085	.	C	T	11	11	22	0	2	24	0	0
19	7513291	.	A	C	8	11	19	0	1	20	0	0
19	7513406	.	A	T	14	13	27	0	1	28	0	0
19	7514025	.	T	C	15	4	19	0	0	19	0	0
19	7514280	.	A	G	1	4	5	0	0	5	0	0
19	7514708	.	A	G	8	4	12	1	1	14	0	0
19	7515336	.	A	T	5	8	13	0	0	13	0	0
19	7515356	.	G	A	5	9	14	1	1	16	0	0
19	7515423	.	A	G	11	4	15	0	0	15	0	0
19	7515458	.	A	G	8	2	10	0	0	10	0	0
19	7515468	.	T	G	7	2	9	0	0	9	0	0
19	7515787	.	A	T	10	9	19	0	1	20	0	0
19	7515829	.	C	T	10	12	22	0	0	22	0	0
19	7515845	.	A	T	13	13	26	0	0	26	0	0
19	7516035	.	A	G	9	3	12	0	0	12	0	0
19	7516063	.	A	C	8	6	14	0	0	14	0	0
19	7516169	.	C	A	12	8	20	0	0	20	0	0
19	7516183	.	T	G	11	6	17	0	0	17	0	0
19	7516229	.	A	G	6	1	7	0	1	8	0	0
19	7516231	.	T	A	6	2	8	0	0	8	0	0
19	7525148	.	C	T	1	8	9	0	8	17	0	0
19	7525222	.	T	G	6	8	14	0	0	14	0	0
19	7525337	.	C	A	11	6	17	0	0	17	0	0
19	7525381	.	G	A	5	2	7	0	0	7	0	0
19	7525386	.	G	C	4	2	6	0	0	6	0	0
19	7529754	.	C	G	0	2	2	0	4	6	0	0
19	7530663	.	C	A	3	3	6	0	0	6	0	0
19	7530865	.	C	G	1	2	3	0	0	3	0	0
19	7530925	.	T	G	2	2	4	0	0	4	0	0
19	7530949	.	G	T	3	2	5	0	0	5	0	0
19	7540354	.	C	T	1	3	4	0	2	6	0	0
19	7549916	.	G	A	18	19	37	0	0	37	0	0
19	7552736	.	C	G	20	16	36	0	0	36	0	0
19	7552737	.	G	T	1	15	16	0	20	36	0	0
19	7552875	.	G	C	2	17	19	0	17	36	0	0
19	7552887	.	A	G	15	19	34	0	1	35	0	0
19	7553368	.	T	C	17	19	36	0	0	36	0	0
19	7553416	.	C	T	13	15	28	0	1	29	0	0
19	7557447	.	C	A	15	19	34	1	2	37	0	0
19	7557538	.	T	C	24	19	43	0	0	43	0	0
19	7557589	.	T	G	22	2	24	0	20	44	0	0
19	7557619	.	A	T	18	21	39	0	4	43	0	0
19	7557773	.	A	T	18	19	37	0	0	38	1	0
19	7557793	.	G	C	22	17	39	1	0	40	0	0
19	7557992	.	C	T	16	18	34	0	0	34	0	0
19	7558009	.	G	A	18	19	37	0	1	38	0	0
19	7559818	.	G	T	20	18	38	1	2	41	0	0
19	7559905	.	A	G	11	18	29	0	3	32	0	0
19	7564073	.	A	G	20	22	42	0	0	42	0	0
19	7565142	.	G	A	25	21	46	0	0	46	0	0
19	7565244	.	A	G	25	24	49	0	2	51	0	0
19	7567021	.	T	A	13	15	28	0	0	28	0	0
19	7567196	.	A	C	3	2	5	0	0	5	0	0
19	7590695	.	A	T	3	2	5	0	0	5	0	0
19	7590736	.	C	A	3	2	5	0	0	5	0	0
19	7590737	.	G	C	0	2	2	0	3	5	0	0
19	7627524	.	T	C	4	4	8	0	0	8	0	0
19	7630329	.	T	A	2	7	9	0	0	9	0	0
19	7630359	.	T	A	1	6	7	0	0	7	0	0
19	7630689	.	A	T	7	6	13	0	0	13	0	0
19	7631700	.	G	A	1	19	20	0	9	29	0	0
19	7631784	.	A	G	8	9	17	0	2	19	0	0
19	7631829	.	C	A	7	11	18	0	0	18	0	0
19	7631860	.	T	C	10	15	25	0	0	25	0	0
19	7632056	.	C	T	5	9	14	0	0	14	0	0
19	7632216	.	C	T	12	12	24	0	0	24	0	0
19	7632348	.	G	A	1	6	7	0	14	21	0	0
19	7632470	.	C	T	10	7	17	0	0	17	0	0
19	7632526	.	T	C	8	11	19	0	1	20	0	0
19	7632837	.	C	T	6	8	14	0	2	16	0	0
19	7678900	.	A	G	1	3	4	0	0	4	0	0
19	7761855	.	C	T	15	16	31	0	1	32	0	0
19	7765259	.	G	A	9	4	13	0	1	14	0	0
19	7771431	.	G	A	1	7	8	0	8	16	0	0
19	7784681	.	T	A	26	9	35	0	3	38	0	0
19	7784684	.	T	A	24	11	35	0	1	37	1	0
19	7785138	.	C	T	23	22	45	0	0	45	0	0
19	7794887	.	C	T	22	15	37	1	4	42	0	0
19	7796398	.	C	T	21	23	44	0	1	45	0	0
19	7796842	.	C	A	10	19	29	0	6	35	0	0
19	7796888	.	G	A	15	10	25	0	6	31	0	0
19	7796986	.	A	T	17	11	28	0	3	31	0	0
19	7797259	.	T	A	14	15	29	0	0	29	0	0
19	7797534	.	C	T	23	9	32	0	0	32	0	0
19	7797651	.	G	T	5	9	14	0	0	14	0	0
19	7802700	.	G	A	5	9	14	0	0	14	0	0
19	7802873	.	G	A	5	7	12	0	1	13	0	0
19	7803685	.	C	A	5	9	14	0	1	15	0	0
19	7804785	.	A	C	13	8	21	0	2	23	0	0
19	7819991	.	G	A	9	11	20	0	1	21	0	0
19	7820031	.	T	A	9	8	17	0	1	18	0	0
19	7820040	.	T	C	8	9	17	0	0	17	0	0
19	7820079	.	T	A	5	7	12	0	2	14	0	0
19	7820107	.	G	A	5	4	9	0	0	9	0	0
19	7820466	.	C	A	0	4	4	0	8	12	0	0
19	7820665	.	T	A	10	16	26	0	1	27	0	0
19	7820980	.	C	T	10	6	16	0	0	16	0	0
19	7822581	.	T	C	12	0	12	0	13	25	0	0
19	7823285	.	G	A	9	11	20	0	0	20	0	0
19	7823306	.	G	A	10	8	18	0	0	18	0	0
19	7827016	.	G	A	11	15	26	0	0	26	0	0
19	7827031	.	T	G	16	9	25	0	1	26	0	0
19	7827377	.	C	T	0	9	9	0	4	13	0	0
19	7827579	.	G	A	5	8	13	0	1	14	0	0
19	7827672	.	G	C	7	8	15	0	1	17	1	0
19	7828576	.	G	A	7	9	16	0	0	16	0	0
19	7828621	.	C	A	6	7	13	0	0	13	0	0
19	7828672	.	C	G	5	4	9	0	1	10	0	0
19	7828674	.	G	A	4	6	10	0	0	10	0	0
19	7828774	.	A	G	3	5	8	0	0	8	0	0
19	7828912	.	G	A	11	11	22	0	1	23	0	0
19	7828930	.	T	G	13	8	21	0	0	21	0	0
19	7829080	.	G	A	7	7	14	0	1	15	0	0
19	7829124	.	T	C	5	0	5	0	7	12	0	0
19	7829174	.	C	G	8	5	13	0	0	13	0	0
19	7829175	.	C	T	7	5	12	0	1	13	0	0
19	7829333	.	C	A	5	5	10	0	0	10	0	0
19	7830013	.	G	A	2	4	6	0	0	6	0	0
19	7830622	.	C	T	7	7	14	0	1	15	0	0
19	7830625	.	C	T	8	6	14	0	0	14	0	0
19	7830700	.	G	A	11	8	19	0	0	19	0	0
19	7835708	.	C	T	2	4	6	0	0	6	0	0
19	7835774	.	G	A	2	2	4	0	0	4	0	0
19	7966409	.	T	C	2	6	8	0	0	8	0	0
19	7967084	.	G	A	0	2	2	4	8	14	0	0
19	7967113	.	G	A	2	4	6	6	0	12	0	0
19	8315244	.	T	C	7	9	16	0	1	17	0	0
19	8315385	.	A	G	12	0	12	0	5	17	0	0
19	8315418	.	G	A	6	4	10	0	2	12	0	0
19	8315478	.	C	T	10	7	17	0	0	17	0	0
19	8336054	.	A	G	9	0	9	0	10	19	0	0
19	8336208	.	C	T	8	7	15	0	0	15	0	0
19	8336335	.	C	A	4	2	6	0	1	7	0	0
19	8336642	.	C	T	16	12	28	0	1	29	0	0
19	8336689	.	G	A	7	10	17	0	2	19	0	0
19	8338417	.	A	T	1	4	5	0	1	6	0	0
19	8338559	.	A	G	9	7	16	0	0	16	0	0
19	8338616	.	T	A	7	11	18	0	1	19	0	0
19	8338649	.	T	A	6	15	21	0	0	21	0	0
19	8338711	.	C	G	4	6	10	0	0	10	0	0
19	8339202	.	T	A	9	14	23	0	1	24	0	0
19	8500928	.	A	T	5	3	8	0	1	9	0	0
19	8500960	.	A	T	7	3	10	0	0	10	0	0
19	8501019	.	G	A	0	3	3	0	10	13	0	0
19	8501218	.	G	A	8	8	16	0	0	16	0	0
19	8501490	.	G	T	9	9	18	1	1	20	0	0
19	8501660	.	G	T	1	4	5	0	7	12	0	0
19	8501663	.	C	T	8	4	12	0	0	12	0	0
19	8501703	.	A	C	7	3	10	0	0	10	0	0
19	8502104	.	C	G	7	7	14	0	0	14	0	0
19	8502133	.	C	T	4	7	11	0	1	12	0	0
19	8502166	.	G	T	1	9	10	0	6	16	0	0
19	8502225	.	T	A	14	6	20	0	1	22	1	0
19	8502244	.	G	A	12	9	21	0	0	21	0	0
19	8534126	.	G	C	3	7	10	0	0	10	0	0
19	8534996	.	A	G	5	5	10	0	2	12	0	0
19	8535005	.	T	G	6	6	12	0	0	12	0	0
19	8582763	.	T	C	3	6	9	1	0	10	0	0
19	8583065	.	A	G	9	13	22	0	0	22	0	0
19	8583131	.	G	A	11	7	18	0	0	18	0	0
19	8583170	.	G	T	9	11	20	0	0	20	0	0
19	8587075	.	T	C	7	0	7	0	6	13	0	0
19	8589693	.	C	T	9	10	19	0	1	20	0	0
19	8589714	.	C	T	5	8	13	0	0	13	0	0
19	8592973	.	T	A	8	7	15	0	3	18	0	0
19	8598667	.	A	G	8	7	15	2	1	18	0	0
19	8600156	.	G	A	8	6	14	0	0	14	0	0
19	8604154	.	A	G	8	5	13	0	0	13	0	0
19	8604172	.	G	A	7	3	10	0	0	10	0	0
19	8604268	.	C	A	2	3	5	0	3	8	0	0
19	8612981	.	G	C	0	12	12	0	6	18	0	0
19	8613041	.	G	C	14	9	23	0	1	24	0	0
19	8628830	.	G	T	1	5	6	0	6	12	0	0
19	8637657	.	T	C	8	9	17	0	0	17	0	0
19	8638539	.	C	A	9	8	17	0	0	18	1	0
19	8645192	.	A	C	16	5	21	0	2	23	0	0
19	8647747	.	T	A	10	6	16	0	2	18	0	0
19	8680667	.	C	T	1	5	6	0	7	13	0	0
19	8681317	.	A	T	10	6	16	0	0	16	0	0
19	8681443	.	A	G	3	7	10	0	0	10	0	0
19	8681470	.	G	A	6	9	15	0	0	15	0	0
19	8681509	.	G	A	7	9	16	0	0	16	0	0
19	8689870	.	A	G	6	2	8	0	0	8	0	0
19	8689882	.	T	A	5	2	7	0	0	7	0	0
19	8699707	.	T	C	1	3	4	0	0	4	0	0
19	8701637	.	T	C	2	3	5	0	0	5	0	0
19	8747688	.	G	A	29	42	71	0	0	71	0	0
19	8775362	.	A	T	2	4	6	0	0	6	0	0
19	8777820	.	G	A	2	2	4	0	0	4	0	0
19	8785478	.	G	A	2	2	4	0	1	5	0	0
19	8817074	.	G	T	4	4	8	0	2	10	0	0
19	8817121	.	C	A	8	3	11	0	0	11	0	0
19	8817608	.	G	A	22	17	39	0	1	40	0	0
19	8831895	.	T	C	23	4	27	0	26	53	0	0
19	8831907	.	C	T	8	21	29	0	25	54	0	0
19	8834529	.	A	G	17	27	44	1	4	49	0	0
19	8834583	.	T	C	19	31	50	0	2	52	0	0
19	8836805	.	C	T	21	17	38	0	7	45	0	0
19	8880614	.	C	G	24	18	42	0	0	42	0	0
19	8894119	.	T	A	5	4	9	0	1	10	0	0
19	8894138	.	A	G	8	3	11	0	1	12	0	0
19	8895514	.	C	A	0	5	5	0	5	10	0	0
19	8895546	.	C	T	3	7	10	0	0	10	0	0
19	8895630	.	C	T	11	7	18	0	1	19	0	0
19	8897625	.	A	C	3	1	4	0	11	15	0	0
19	8897649	.	A	T	10	3	13	0	0	13	0	0
19	8898125	.	G	A	4	6	10	0	0	10	0	0
19	8898133	.	T	A	10	0	10	0	0	10	0	0
19	8898184	.	G	A	8	12	20	0	1	21	0	0
19	8898188	.	G	A	7	13	20	0	0	20	0	0
19	8898597	.	A	C	6	0	6	0	6	12	0	0
19	8901419	.	A	G	6	3	9	0	0	9	0	0
19	8904026	.	A	G	7	6	13	0	0	13	0	0
19	8928718	.	G	A	14	4	18	0	1	19	0	0
19	8928767	.	G	C	17	9	26	0	0	26	0	0
19	8929057	.	G	A	4	4	8	0	0	8	0	0
19	8929708	.	A	T	10	3	13	0	0	13	0	0
19	8929839	.	G	A	14	10	24	0	0	24	0	0
19	8929860	.	T	C	11	11	22	0	2	24	0	0
19	8932643	.	T	C	8	0	8	0	12	20	0	0
19	8939917	.	C	T	15	10	25	0	0	25	0	0
19	8958658	.	A	C	1	2	3	0	0	3	0	0
19	8958797	.	C	T	9	7	16	0	0	16	0	0
19	8958892	.	A	G	17	17	34	0	0	34	0	0
19	8962835	.	C	T	11	8	19	0	1	20	0	0
19	8978963	.	G	A	0	2	2	0	2	4	0	0
19	8978964	.	G	A	2	2	4	0	0	4	0	0
19	8979038	.	T	C	3	2	5	0	0	5	0	0
19	8979060	.	G	T	3	2	5	0	1	6	0	0
19	8979185	.	G	T	5	2	7	0	0	7	0	0
19	8979221	.	T	G	4	4	8	0	0	8	0	0
19	8979268	.	G	C	1	2	3	0	0	3	0	0
19	8985221	.	G	A	8	5	13	0	0	13	0	0
19	8985408	.	C	T	9	5	14	0	5	19	0	0
19	8985564	.	G	A	0	17	17	0	22	39	0	0
19	8989992	.	G	A	3	13	16	0	18	34	0	0
19	8997629	.	G	A	10	13	23	0	0	23	0	0
19	8997903	.	C	T	20	15	35	0	0	35	0	0
19	9000665	.	C	T	27	25	52	0	1	53	0	0
19	9000674	.	T	C	27	23	50	0	3	53	0	0
19	9000907	.	A	G	14	0	14	0	28	42	0	0
19	9001058	.	C	T	10	22	32	0	0	32	0	0
19	9001100	.	C	T	20	7	27	1	0	28	0	0
19	9001151	.	C	T	12	17	29	1	0	30	0	0
19	9001246	.	C	T	19	7	26	0	1	27	0	0
19	9001315	.	C	T	20	10	30	0	1	31	0	0
19	9001317	.	G	A	11	21	32	0	0	32	0	0
19	9033383	.	A	T	6	8	14	0	1	15	0	0
19	9033453	.	C	A	5	7	12	2	2	16	0	0
19	9043035	.	C	T	10	10	20	0	1	21	0	0
19	9045651	.	A	T	8	12	20	0	0	20	0	0
19	9046119	.	G	C	7	10	17	0	1	18	0	0
19	9046230	.	T	G	9	12	21	0	0	21	0	0
19	9046327	.	C	T	19	13	32	0	0	32	0	0
19	9046383	.	T	A	13	14	27	0	4	31	0	0
19	9046467	.	G	A	13	13	26	0	1	27	0	0
19	9046542	.	A	C	10	10	20	0	1	21	0	0
19	9046551	.	T	C	13	9	22	0	0	22	0	0
19	9047004	.	G	A	0	3	3	0	7	11	1	0
19	9047283	.	A	G	5	10	15	0	1	16	0	0
19	9047806	.	T	A	20	9	29	0	4	33	0	0
19	9048345	.	C	T	7	4	11	0	1	12	0	0
19	9048538	.	A	C	12	14	26	0	2	28	0	0
19	9048614	.	C	T	11	14	25	0	3	28	0	0
19	9050305	.	G	A	20	15	35	0	1	36	0	0
19	9050319	.	C	T	18	16	34	0	0	34	0	0
19	9050737	.	G	C	12	11	23	0	1	24	0	0
19	9050745	.	A	G	10	12	22	0	0	22	0	0
19	9055793	.	C	T	15	20	35	0	2	37	0	0
19	9058454	.	T	C	11	17	28	0	0	28	0	0
19	9064759	.	T	C	11	20	31	0	0	31	0	0
19	9064777	.	C	A	14	17	31	0	0	31	0	0
19	9064822	.	A	G	14	19	33	0	0	33	0	0
19	9064853	.	T	C	18	18	36	0	1	37	0	0
19	9064885	.	G	A	21	12	33	0	2	35	0	0
19	9067211	.	G	A	18	13	31	0	0	31	0	0
19	9070546	.	T	G	11	1	12	0	14	26	0	0
19	9072451	.	C	T	11	15	26	0	2	28	0	0
19	9077465	.	C	T	19	14	33	0	1	34	0	0
19	9084688	.	T	C	18	14	32	0	0	32	0	0
19	9085359	.	A	T	18	4	22	1	2	25	0	0
19	9085423	.	G	A	9	12	21	0	5	26	0	0
19	9085757	.	A	C	11	16	27	0	1	28	0	0
19	9086084	.	T	A	15	14	29	0	1	30	0	0
19	9086132	.	C	A	16	18	34	1	1	36	0	0
19	9086416	.	T	A	5	3	8	0	0	8	0	0
19	9111649	.	T	G	5	3	8	0	0	8	0	0
19	9111711	.	G	T	2	3	5	1	0	6	0	0
19	9111712	.	T	A	3	2	5	1	0	6	0	0
19	9116534	.	A	G	5	1	6	0	4	10	0	0
19	9117473	.	T	G	7	10	17	0	1	18	0	0
19	9123493	.	C	T	10	5	15	0	0	15	0	0
19	9125062	.	G	A	6	7	13	0	0	13	0	0
19	9130205	.	T	A	11	3	14	0	0	14	0	0
19	9135053	.	C	T	7	5	12	0	1	13	0	0
19	9135754	.	A	T	6	8	14	0	2	16	0	0
19	9138850	.	C	A	9	9	18	0	0	18	0	0
19	9140507	.	A	G	13	6	19	0	1	20	0	0
19	9140618	.	C	T	15	9	24	0	0	24	0	0
19	9140675	.	A	T	10	15	25	0	0	26	1	0
19	9144234	.	C	T	4	2	6	0	1	7	0	0
19	9161595	.	G	A	19	21	40	0	2	42	0	0
19	9161621	.	C	T	21	22	43	0	2	45	0	0
19	9161631	.	T	G	24	20	44	0	0	44	0	0
19	9161824	.	T	C	21	16	37	0	2	39	0	0
19	9161830	.	C	T	15	19	34	0	1	35	0	0
19	9166374	.	G	A	20	24	44	0	2	46	0	0
19	9168513	.	C	T	17	20	37	0	3	40	0	0
19	9168607	.	C	G	24	16	40	0	0	40	0	0
19	9168622	.	C	T	15	21	36	0	1	37	0	0
19	9168947	.	G	T	6	8	14	0	14	28	0	0
19	9169099	.	G	A	18	11	29	0	0	29	0	0
19	9169162	.	G	C	10	3	13	0	1	14	0	0
19	9216201	.	T	A	15	23	38	0	7	45	0	0
19	9216221	.	A	C	15	25	40	0	2	42	0	0
19	9216367	.	G	A	23	16	39	0	1	40	0	0
19	9217143	.	C	T	24	21	45	0	1	46	0	0
19	9218405	.	G	A	21	21	42	0	1	43	0	0
19	9220813	.	C	T	22	27	49	1	0	50	0	0
19	9220828	.	C	T	20	26	46	1	5	52	0	0
19	9220849	.	T	C	26	19	45	1	2	48	0	0
19	9220939	.	T	C	30	17	47	0	2	49	0	0
19	9223369	.	T	C	26	24	50	0	1	51	0	0
19	9228196	.	T	G	24	14	38	0	1	39	0	0
19	9228378	.	A	G	14	0	14	0	14	28	0	0
19	9228380	.	C	T	13	13	26	0	2	28	0	0
19	9228428	.	G	T	14	5	19	0	0	19	0	0
19	9240295	.	G	C	4	2	6	0	0	6	0	0
19	9240607	.	G	T	4	4	8	0	0	8	0	0
19	9240762	.	A	T	4	3	7	0	0	7	0	0
19	9240763	.	A	C	4	3	7	0	0	7	0	0
19	9240882	.	G	A	3	4	7	0	0	7	0	0
19	9241530	.	C	T	2	3	5	0	1	6	0	0
19	9244492	.	G	T	0	6	6	0	2	8	0	0
19	9247534	.	C	G	8	0	8	1	5	14	0	0
19	9247543	.	C	T	6	6	12	1	1	14	0	0
19	9247576	.	G	A	7	9	16	1	0	17	0	0
19	9247724	.	C	T	7	2	9	0	0	9	0	0
19	9251136	.	G	A	0	5	5	0	3	8	0	0
19	9251160	.	C	G	3	0	3	0	2	5	0	0
19	9251171	.	C	T	3	2	5	0	0	5	0	0
19	9252173	.	A	T	4	4	8	0	0	8	0	0
19	9252183	.	C	A	5	2	7	0	0	7	0	0
19	9254877	.	C	T	3	4	7	0	0	7	0	0
19	9255657	.	T	G	2	3	5	0	0	5	0	0
19	9255906	.	C	T	7	2	9	0	0	9	0	0
19	9257885	.	A	G	4	5	9	0	0	9	0	0
19	9260018	.	G	A	1	3	4	0	0	4	0	0
19	9262519	.	C	T	2	4	6	0	0	6	0	0
19	9262904	.	C	T	3	4	7	0	1	8	0	0
19	9263000	.	A	G	7	4	11	0	0	11	0	0
19	9265297	.	G	A	2	6	8	0	0	8	0	0
19	9265417	.	C	T	5	9	14	0	0	14	0	0
19	9265429	.	G	T	6	8	14	0	1	15	0	0
19	9265516	.	A	C	11	6	17	0	0	17	0	0
19	9265517	.	G	A	10	6	16	0	0	16	0	0
19	9266121	.	T	C	3	8	11	0	3	14	0	0
19	9266326	.	C	T	14	6	20	0	0	20	0	0
19	9266793	.	A	C	6	7	13	0	0	13	0	0
19	9266963	.	C	T	3	2	5	0	0	5	0	0
19	9268379	.	G	A	8	2	10	0	0	10	0	0
19	9268433	.	C	T	9	5	14	0	1	15	0	0
19	9268458	.	G	A	8	4	12	0	1	13	0	0
19	9268468	.	A	C	7	3	10	0	0	10	0	0
19	9268619	.	C	A	2	7	9	0	0	9	0	0
19	9273768	.	T	A	11	8	19	0	1	20	0	0
19	9274070	.	G	A	1	7	8	0	8	16	0	0
19	9274095	.	G	T	11	8	19	0	0	19	0	0
19	9274248	.	T	A	6	6	12	0	0	12	0	0
19	9274500	.	T	C	5	4	9	0	0	9	0	0
19	9274666	.	T	C	9	4	13	0	0	13	0	0
19	9274705	.	C	T	6	8	14	0	0	14	0	0
19	9274844	.	A	C	5	4	9	0	1	10	0	0
19	9458166	.	A	G	23	1	24	0	28	52	0	0
19	9458181	.	A	C	26	23	49	0	2	51	0	0
19	9458304	.	G	A	19	18	37	0	0	37	0	0
19	9458328	.	T	C	19	19	38	0	1	39	0	0
19	9458421	.	G	A	20	12	32	0	5	37	0	0
19	9458463	.	C	T	27	14	41	0	1	42	0	0
19	9459325	.	T	A	23	17	40	0	0	40	0	0
19	9459330	.	C	T	22	9	31	0	2	33	0	0
19	9459378	.	A	G	29	0	29	1	23	53	0	0
19	9459597	.	G	A	3	17	20	0	15	35	0	0
19	9459673	.	G	A	2	22	24	0	14	38	0	0
19	9459820	.	T	C	25	15	40	0	2	42	0	0
19	9460128	.	A	C	26	6	32	0	1	33	0	0
19	9460196	.	A	G	19	14	33	0	0	33	0	0
19	9460499	.	A	G	10	22	32	0	2	34	0	0
19	9460531	.	G	T	16	30	46	0	2	48	0	0
19	9461072	.	A	G	36	14	50	0	2	52	0	0
19	9461141	.	T	G	20	26	46	0	2	48	0	0
19	9461376	.	A	G	32	22	54	0	0	54	0	0
19	9461841	.	A	G	37	33	70	0	2	72	0	0
19	9462810	.	T	A	35	41	76	0	2	78	0	0
19	9462822	.	T	G	35	43	78	0	3	81	0	0
19	9471066	.	G	A	37	36	73	0	3	76	0	0
19	9472368	.	T	A	10	13	23	1	1	25	0	0
19	9472405	.	A	G	9	3	12	2	2	16	0	0
19	9472865	.	G	A	28	22	50	0	2	52	0	0
19	9481724	.	A	G	1	5	6	0	0	6	0	0
19	9481733	.	A	G	1	6	7	0	0	7	0	0
19	9481781	.	T	G	3	2	5	0	1	6	0	0
19	9481997	.	A	G	1	4	5	0	0	5	0	0
19	9482071	.	A	G	2	3	5	1	0	6	0	0
19	9482261	.	A	G	15	10	25	0	1	26	0	0
19	9485543	.	A	G	8	13	21	0	1	22	0	0
19	9502229	.	T	G	11	12	23	0	3	26	0	0
19	9502456	.	A	C	6	17	23	0	0	23	0	0
19	9502640	.	T	C	18	12	30	0	1	31	0	0
19	9502656	.	A	G	18	12	30	0	0	30	0	0
19	9502968	.	C	T	12	12	24	0	1	25	0	0
19	9503303	.	A	G	4	11	15	0	0	15	0	0
19	9503356	.	T	G	8	15	23	0	0	23	0	0
19	9513443	.	T	C	12	11	23	0	0	23	0	0
19	9513572	.	A	C	9	9	18	0	1	19	0	0
19	9513863	.	A	C	13	11	24	0	0	24	0	0
19	9513869	.	A	C	13	13	26	0	0	26	0	0
19	9516869	.	A	G	7	12	19	0	0	19	0	0
19	9519284	.	G	A	6	4	10	0	0	10	0	0
19	9533299	.	C	G	9	9	18	0	1	19	0	0
19	9585421	.	C	T	12	5	17	0	1	18	0	0
19	9585436	.	G	A	10	6	16	0	0	16	0	0
19	9598053	.	C	T	9	6	15	0	0	15	0	0
19	9598080	.	A	G	9	8	17	0	0	17	0	0
19	9598119	.	C	A	10	14	24	0	1	25	0	0
19	9603062	.	C	T	10	8	18	0	4	22	0	0
19	9603160	.	G	A	2	10	12	0	8	20	0	0
19	9603233	.	G	T	4	12	16	0	10	26	0	0
19	9603425	.	C	T	14	10	24	0	0	24	0	0
19	9603432	.	T	A	14	10	24	0	1	25	0	0
19	9603752	.	C	T	12	5	17	0	1	18	0	0
19	9604050	.	T	A	5	3	8	0	1	9	0	0
19	9604073	.	T	A	2	6	8	0	0	8	0	0
19	9685506	.	A	G	12	18	30	0	1	31	0	0
19	9685695	.	A	G	30	20	50	0	3	53	0	0
19	9686123	.	G	T	13	5	18	0	3	21	0	0
19	9686128	.	A	G	15	10	25	0	0	25	0	0
19	9686160	.	T	C	16	12	28	0	1	29	0	0
19	9686163	.	C	A	15	14	29	0	1	30	0	0
19	9686421	.	G	T	17	11	28	0	0	28	0	0
19	9686515	.	T	A	10	12	22	1	1	24	0	0
19	9686519	.	G	A	11	12	23	1	1	25	0	0
19	9686615	.	T	C	14	17	31	0	0	31	0	0
19	9686627	.	T	C	16	17	33	0	0	33	0	0
19	9686678	.	T	A	18	14	32	0	0	32	0	0
19	9686806	.	T	C	15	5	20	0	0	20	0	0
19	9686807	.	C	T	14	5	19	0	1	20	0	0
19	9686902	.	T	A	1	11	12	0	0	12	0	0
19	9686905	.	T	C	2	0	2	0	11	13	0	0
19	9687001	.	T	G	16	4	20	0	0	20	0	0
19	9687146	.	T	C	25	15	40	0	0	40	0	0
19	9687206	.	T	A	19	17	36	0	2	39	1	0
19	9687306	.	G	A	24	14	38	0	4	42	0	0
19	9691780	.	A	G	27	15	42	0	2	44	0	0
19	9700886	.	T	C	9	2	11	0	10	21	0	0
19	9711421	.	T	C	14	12	26	0	0	26	0	0
19	9711444	.	G	A	16	15	31	0	1	32	0	0
19	9712337	.	G	A	20	8	28	0	0	28	0	0
19	9712357	.	T	A	19	10	29	0	1	30	0	0
19	9712444	.	G	A	17	14	31	0	0	31	0	0
19	9712514	.	C	T	11	6	17	0	3	20	0	0
19	9813608	.	G	A	19	22	41	0	1	42	0	0
19	9814291	.	C	T	5	32	37	0	24	61	0	0
19	9814336	.	T	C	24	29	53	0	0	53	0	0
19	9814423	.	A	G	23	21	44	0	4	48	0	0
19	9814444	.	G	A	23	20	43	0	0	43	0	0
19	9814504	.	G	A	22	23	45	0	3	48	0	0
19	9814516	.	A	G	25	20	45	0	5	50	0	0
19	9814549	.	T	C	25	27	52	0	3	55	0	0
19	9814611	.	A	G	10	15	25	0	3	28	0	0
19	9814621	.	C	T	0	14	14	0	11	25	0	0
19	9822566	.	G	C	28	18	46	0	2	48	0	0
19	9841077	.	T	A	7	7	14	0	0	14	0	0
19	9841203	.	A	T	10	13	23	0	0	23	0	0
19	9841450	.	C	G	13	11	24	0	0	24	0	0
19	9841728	.	T	C	5	11	16	0	0	16	0	0
19	9841825	.	C	T	16	9	25	0	2	27	0	0
19	9841902	.	A	T	11	14	25	0	1	26	0	0
19	9842306	.	A	G	25	16	41	0	1	42	0	0
19	9866930	.	C	G	6	12	18	0	1	19	0	0
19	9866933	.	C	T	14	7	21	0	0	21	0	0
19	9911419	.	G	A	5	4	9	0	0	9	0	0
19	9911566	.	T	A	3	6	9	0	2	11	0	0
19	9911587	.	T	G	7	5	12	0	0	12	0	0
19	9911855	.	G	A	5	3	8	0	0	8	0	0
19	9911863	.	A	T	4	3	7	0	1	8	0	0
19	9911904	.	A	T	3	6	9	0	0	9	0	0
19	9912063	.	C	T	4	6	10	1	2	13	0	0
19	9912169	.	G	A	2	2	4	0	0	4	0	0
19	9912425	.	A	G	3	4	7	0	0	7	0	0
19	9912487	.	A	T	5	6	11	0	0	11	0	0
19	9912663	.	G	C	10	0	10	0	9	19	0	0
19	9912665	.	G	T	10	7	17	0	1	18	0	0
19	9912756	.	C	A	4	13	17	0	0	17	0	0
19	9912844	.	A	C	1	6	7	0	0	7	0	0
19	9912946	.	A	T	15	5	20	0	0	20	0	0
19	9913647	.	A	T	5	8	13	0	0	13	0	0
19	9913868	.	T	G	2	2	4	0	0	4	0	0
19	9914291	.	T	G	8	10	18	0	0	18	0	0
19	9914357	.	G	A	8	5	13	0	0	13	0	0
19	9914845	.	G	A	6	5	11	0	1	12	0	0
19	9916197	.	C	T	10	4	14	0	0	14	0	0
19	9916597	.	C	T	11	4	15	0	1	16	0	0
19	9916630	.	G	T	13	8	21	0	0	21	0	0
19	9916786	.	A	G	6	8	14	0	2	16	0	0
19	9916840	.	G	A	4	9	13	0	1	14	0	0
19	9916918	.	A	G	6	5	11	0	0	11	0	0
19	9917266	.	C	T	1	2	3	0	3	6	0	0
19	9917437	.	A	G	1	5	6	0	0	6	0	0
19	9917466	.	G	A	5	6	11	0	1	12	0	0
19	9917518	.	C	T	8	3	11	0	1	12	0	0
19	9919114	.	G	T	1	3	4	0	0	4	0	0
19	9919150	.	C	A	2	2	4	0	0	4	0	0
19	9990047	.	G	C	2	2	4	0	0	4	0	0
19	9990050	.	C	T	0	2	2	0	2	4	0	0
19	9990305	.	A	G	5	3	8	0	1	9	0	0
19	10042519	.	T	C	2	2	4	0	0	4	0	0
19	10177290	.	G	A	14	18	32	0	0	32	0	0
19	10177382	.	C	A	23	15	38	0	1	39	0	0
19	10177397	.	T	G	16	22	38	0	1	39	0	0
19	10178339	.	T	A	16	18	34	0	5	39	0	0
19	10180561	.	C	T	2	17	19	0	12	31	0	0
19	10195375	.	C	G	10	5	15	0	0	15	0	0
19	10195376	.	A	C	10	0	10	0	5	15	0	0
19	10195756	.	T	G	19	8	27	0	1	28	0	0
19	10196049	.	T	A	18	8	26	0	1	27	0	0
19	10196070	.	T	A	9	7	16	0	1	25	8	0
19	10196113	.	T	C	11	13	24	0	0	24	0	0
19	10202682	.	T	C	11	0	11	0	13	24	0	0
19	10202756	.	T	A	14	7	21	0	1	22	0	0
19	10203024	.	C	A	1	9	10	1	11	22	0	0
19	10203420	.	T	C	21	12	33	0	0	33	0	0
19	10203936	.	T	G	11	9	20	0	1	21	0	0
19	10204023	.	G	A	16	16	32	0	2	34	0	0
19	10204407	.	G	C	9	10	19	0	2	21	0	0
19	10204476	.	C	T	12	7	19	0	1	20	0	0
19	10205505	.	G	A	9	10	19	0	3	22	0	0
19	10205804	.	T	C	8	0	8	0	4	12	0	0
19	10205946	.	C	T	7	6	13	0	1	14	0	0
19	10205949	.	G	A	7	7	14	0	0	14	0	0
19	10207704	.	A	T	4	8	12	0	1	13	0	0
19	10207735	.	G	A	5	4	9	0	0	9	0	0
19	10217600	.	C	T	3	2	5	0	0	5	0	0
19	10217742	.	A	G	8	8	16	0	5	22	1	0
19	10217844	.	T	A	6	7	13	0	0	13	0	0
19	10219001	.	C	T	9	18	27	0	0	27	0	0
19	10219542	.	G	A	16	19	35	0	2	37	0	0
19	10219547	.	T	C	19	19	38	0	1	39	0	0
19	10219749	.	C	T	11	18	29	0	0	29	0	0
19	10220064	.	A	T	16	26	42	2	2	46	0	0
19	10220283	.	T	G	18	22	40	0	2	42	0	0
19	10220421	.	A	G	19	21	40	0	1	41	0	0
19	10220448	.	C	G	4	18	22	0	22	44	0	0
19	10220651	.	T	C	25	3	28	0	31	59	0	0
19	10220790	.	C	T	20	29	49	0	0	49	0	0
19	10235373	.	T	C	23	12	35	0	3	38	0	0
19	10235899	.	G	C	22	14	36	0	2	38	0	0
19	10236249	.	C	T	18	12	30	0	2	32	0	0
19	10236490	.	C	A	17	12	29	0	2	31	0	0
19	10236569	.	T	C	11	14	25	0	1	26	0	0
19	10236853	.	A	G	11	7	18	0	0	18	0	0
19	10237198	.	G	C	9	4	13	0	1	14	0	0
19	10237241	.	G	A	12	3	15	0	2	17	0	0
19	10237365	.	C	A	2	13	15	0	11	26	0	0
19	10237394	.	A	G	16	19	35	0	0	35	0	0
19	10237446	.	A	T	23	26	49	0	0	50	1	0
19	10237815	.	A	T	10	9	19	0	1	20	0	0
19	10237950	.	T	C	13	0	13	0	15	28	0	0
19	10238011	.	G	C	9	0	9	0	19	29	1	0
19	10238045	.	C	G	16	17	33	0	2	35	0	0
19	10238301	.	G	C	15	0	15	0	8	23	0	0
19	10238303	.	T	C	14	7	21	0	3	24	0	0
19	10238348	.	G	A	10	11	21	0	2	23	0	0
19	10238350	.	C	G	9	11	20	0	2	22	0	0
19	10238580	.	G	A	15	9	24	0	1	25	0	0
19	10252571	.	T	C	3	2	5	0	0	5	0	0
19	10252575	.	T	C	2	3	5	0	0	5	0	0
19	10252630	.	G	C	3	0	3	0	3	6	0	0
19	10252650	.	A	G	1	5	6	0	0	6	0	0
19	10253087	.	T	G	5	2	7	0	0	7	0	0
19	10253140	.	A	T	5	5	10	0	1	11	0	0
19	10253175	.	G	A	5	3	8	0	1	9	0	0
19	10253176	.	T	C	5	0	5	0	4	9	0	0
19	10253316	.	T	C	5	6	11	0	1	12	0	0
19	10253347	.	T	C	2	8	10	0	1	11	0	0
19	10253812	.	T	A	4	3	7	0	0	7	0	0
19	10253977	.	T	C	2	0	2	0	6	8	0	0
19	10254091	.	C	T	7	1	8	0	0	8	0	0
19	10254100	.	C	A	7	2	9	0	0	9	0	0
19	10254146	.	A	C	6	4	10	0	0	10	0	0
19	10254303	.	C	A	4	3	7	0	0	7	0	0
19	10254690	.	A	C	2	7	9	0	0	9	0	0
19	10255241	.	A	T	3	2	5	0	0	5	0	0
19	10255370	.	T	C	3	5	8	0	0	8	0	0
19	10255387	.	T	A	4	4	8	0	0	8	0	0
19	10255458	.	T	C	4	0	4	0	7	11	0	0
19	10255459	.	A	G	4	7	11	0	0	11	0	0
19	10255499	.	A	G	2	3	5	0	0	5	0	0
19	10255552	.	T	G	3	3	6	0	0	6	0	0
19	10255554	.	G	A	3	3	6	0	0	6	0	0
19	10255702	.	A	C	8	11	19	0	0	19	0	0
19	10893175	.	A	G	2	2	4	0	1	5	0	0
19	11271224	.	C	T	1	4	5	0	0	5	0	0
19	11274926	.	T	C	3	0	3	0	5	8	0	0
19	11275304	.	T	A	2	3	5	0	0	5	0	0
19	11275607	.	G	C	2	4	6	0	1	7	0	0
19	11314625	.	C	T	6	4	10	0	1	11	0	0
19	11314807	.	C	T	5	2	7	1	0	8	0	0
19	11314858	.	A	T	6	4	10	1	0	11	0	0
19	11314945	.	A	G	2	6	8	0	0	8	0	0
19	11315067	.	G	A	3	3	6	0	0	6	0	0
19	11331967	.	G	T	9	10	19	0	3	22	0	0
19	11332050	.	G	T	9	15	24	0	0	24	0	0
19	11332071	.	T	C	9	13	22	0	0	22	0	0
19	11332574	.	T	A	15	11	26	0	0	26	0	0
19	11332576	.	C	T	15	12	27	0	0	27	0	0
19	11332670	.	T	C	12	1	13	0	13	26	0	0
19	11344347	.	T	A	14	16	30	0	1	31	0	0
19	11347910	.	C	T	0	14	14	0	14	28	0	0
19	11356692	.	G	A	10	14	24	0	2	26	0	0
19	11429841	.	C	T	0	3	3	0	1	4	0	0
19	11508991	.	G	C	9	7	16	0	0	16	0	0
19	11509029	.	T	C	9	0	9	0	11	20	0	0
19	11545803	.	T	G	7	4	11	0	0	11	0	0
19	11546105	.	G	A	11	6	17	0	0	17	0	0
19	11546181	.	G	A	6	4	10	0	1	11	0	0
19	11632927	.	A	C	2	3	5	0	0	5	0	0
19	11790720	.	C	T	0	4	4	0	4	8	0	0
19	11790915	.	G	A	8	4	12	0	0	12	0	0
19	11792756	.	A	T	2	7	9	0	0	9	0	0
19	11814900	.	A	G	4	2	6	1	1	8	0	0
19	11815024	.	T	C	2	3	5	0	0	5	0	0
19	11815030	.	T	A	2	3	5	0	0	5	0	0
19	11815087	.	G	A	3	4	7	0	0	7	0	0
19	11815306	.	C	T	4	5	9	0	1	10	0	0
19	11815325	.	C	T	3	3	6	0	0	6	0	0
19	11815448	.	T	A	3	4	7	0	0	7	0	0
19	11815507	.	A	T	7	3	10	0	0	10	0	0
19	11815576	.	T	A	6	4	10	0	0	10	0	0
19	11815762	.	T	C	4	0	4	0	3	7	0	0
19	11838654	.	C	T	4	3	7	0	0	7	0	0
19	11846538	.	G	A	3	8	11	0	0	11	0	0
19	11846550	.	G	C	2	8	10	0	0	10	0	0
19	11846607	.	G	T	0	2	2	0	1	3	0	0
19	11846911	.	A	T	3	3	6	0	1	7	0	0
19	11892195	.	T	C	3	2	5	0	0	5	0	0
19	11892419	.	A	T	1	8	9	0	0	9	0	0
19	11892422	.	A	G	1	8	9	0	0	9	0	0
19	11892515	.	A	G	6	10	16	0	0	16	0	0
19	11892636	.	T	A	4	8	12	0	0	12	0	0
19	11892814	.	G	A	1	4	5	1	0	6	0	0
19	11892840	.	A	G	1	2	3	1	0	4	0	0
19	11892961	.	A	G	4	2	6	1	0	7	0	0
19	11893087	.	A	G	7	11	18	0	0	18	0	0
19	11893309	.	G	T	1	4	5	2	5	12	0	0
19	11893313	.	G	A	6	4	10	1	1	12	0	0
19	11893445	.	A	G	7	12	19	0	0	19	0	0
19	11893624	.	T	C	2	7	9	0	0	9	0	0
19	11897841	.	G	T	4	3	7	0	0	7	0	0
19	11899324	.	A	G	10	5	15	0	2	17	0	0
19	11899384	.	T	C	12	9	21	1	3	25	0	0
19	11903571	.	A	G	8	14	22	0	0	22	0	0
19	11906178	.	G	A	10	11	21	0	0	21	0	0
19	11906238	.	T	G	9	12	21	0	0	21	0	0
19	11908436	.	A	G	9	9	18	0	1	19	0	0
19	11908567	.	G	A	5	8	13	0	0	13	0	0
19	11910538	.	T	C	4	0	4	0	6	10	0	0
19	11910595	.	A	C	8	4	12	0	1	13	0	0
19	11912635	.	T	A	10	9	19	0	0	19	0	0
19	11912838	.	T	G	11	7	18	0	0	18	0	0
19	11915066	.	T	G	10	4	14	0	1	15	0	0
19	11915233	.	A	G	7	3	10	0	0	10	0	0
19	11915272	.	A	G	4	7	11	0	0	11	0	0
19	11915320	.	G	A	10	13	23	0	2	25	0	0
19	11917609	.	T	A	9	3	12	0	1	13	0	0
19	11917682	.	A	T	6	6	12	0	0	12	0	0
19	11920819	.	A	G	5	3	8	0	0	8	0	0
19	11921047	.	C	T	5	5	10	0	1	11	0	0
19	11921816	.	G	A	1	9	10	0	2	12	0	0
19	11921817	.	T	A	2	10	12	0	0	12	0	0
19	11927986	.	G	A	14	10	24	0	0	24	0	0
19	11935191	.	A	G	5	8	13	0	0	13	0	0
19	11940071	.	G	T	5	2	7	0	0	7	0	0
19	11940228	.	A	G	4	3	7	0	0	7	0	0
19	11941281	.	T	C	4	0	4	0	4	8	0	0
19	11941516	.	T	A	4	5	9	0	0	9	0	0
19	11941657	.	C	T	3	3	6	0	0	6	0	0
19	11949871	.	C	T	2	3	5	0	0	5	0	0
19	11949909	.	A	G	2	6	8	0	0	8	0	0
19	11960343	.	C	T	4	2	6	0	0	6	0	0
19	11964016	.	A	G	5	7	12	0	0	12	0	0
19	11968998	.	G	A	1	4	5	0	0	5	0	0
19	11969337	.	G	A	3	3	6	0	0	6	0	0
19	11972785	.	G	A	1	6	7	0	0	7	0	0
19	11975110	.	A	G	2	8	10	0	0	10	0	0
19	11975159	.	G	T	1	3	4	0	0	4	0	0
19	11985848	.	C	T	12	7	19	0	2	21	0	0
19	11985858	.	T	C	12	8	20	0	1	21	0	0
19	11996249	.	T	A	6	8	14	0	1	15	0	0
19	11996360	.	A	C	10	8	18	0	0	18	0	0
19	12017902	.	G	A	1	11	12	0	8	20	0	0
19	12018036	.	C	G	4	6	10	0	0	10	0	0
19	12018084	.	C	T	3	3	6	0	0	6	0	0
19	12018367	.	G	T	2	3	5	0	4	9	0	0
19	12031202	.	C	T	1	4	5	0	9	14	0	0
19	12031515	.	T	G	7	3	10	0	1	11	0	0
19	12032273	.	G	T	3	4	7	0	0	7	0	0
19	12032355	.	C	A	1	2	3	0	0	3	0	0
19	12033428	.	T	C	6	3	9	0	0	9	0	0
19	12033494	.	T	C	8	0	8	0	8	16	0	0
19	12046899	.	C	A	6	5	11	0	0	11	0	0
19	12122035	.	A	G	22	20	42	0	2	44	0	0
19	12122039	.	G	A	19	20	39	0	5	44	0	0
19	12122124	.	C	A	41	23	64	0	2	66	0	0
19	12122489	.	G	T	37	29	66	0	2	68	0	0
19	12130089	.	G	A	39	33	72	0	3	75	0	0
19	12134950	.	C	G	1	5	6	0	0	6	0	0
19	12134960	.	T	G	1	4	5	0	0	5	0	0
19	12145548	.	A	T	30	19	49	0	3	52	0	0
19	12171712	.	C	T	32	27	59	0	5	64	0	0
19	12193604	.	A	G	20	17	37	0	0	37	0	0
19	12193617	.	T	A	13	10	23	0	0	23	0	0
19	12211809	.	T	C	26	14	40	0	1	41	0	0
19	12583804	.	T	G	1	1	2	0	16	18	0	0
19	12583815	.	C	G	3	0	3	0	8	11	0	0
19	13413547	.	A	G	5	5	10	0	0	10	0	0
19	15307877	.	T	C	9	2	11	0	0	11	0	0
19	15307895	.	T	C	9	1	10	0	1	11	0	0
19	17517136	.	T	C	11	4	15	0	0	15	0	0
19	17517282	.	T	C	4	2	6	0	0	6	0	0
19	19545090	.	A	G	4	4	8	0	0	8	0	0
19	20404559	.	G	A	4	2	6	0	1	7	0	0
19	20753194	.	G	T	4	5	9	0	2	11	0	0
19	22073563	.	A	T	3	2	5	0	1	6	0	0
19	22338360	.	C	T	6	2	8	0	0	8	0	0
19	22415220	.	C	T	1	3	4	0	0	4	0	0
19	22438264	.	A	G	1	3	4	0	0	4	0	0
19	22731221	.	T	G	2	2	4	0	0	4	0	0
19	23897803	.	T	A	2	2	4	0	2	6	0	0
19	24129616	.	A	T	4	4	8	0	1	9	0	0
19	25653005	.	A	G	0	20	20	0	3	23	0	0
19	26914967	.	A	T	1	6	7	0	0	7	0	0
19	27469130	.	A	G	5	6	11	0	2	13	0	0
19	27776433	.	C	T	1	2	3	0	7	10	0	0
19	29297972	.	A	G	1	7	8	0	0	8	0	0
19	30388091	.	C	T	15	5	20	0	1	21	0	0
19	30388169	.	G	T	5	3	8	0	0	8	0	0
19	30391816	.	T	C	10	9	19	0	1	20	0	0
19	30391968	.	G	T	14	6	20	0	0	20	0	0
19	30393967	.	T	C	13	10	23	0	2	25	0	0
19	30396440	.	T	G	27	1	28	0	10	38	0	0
19	30396777	.	C	T	21	11	32	0	0	32	0	0
19	30398392	.	T	C	6	17	23	0	0	23	0	0
19	30398395	.	T	C	5	17	22	0	1	23	0	0
19	30398487	.	G	A	9	5	14	0	0	14	0	0
19	30398632	.	T	C	7	6	13	0	0	13	0	0
19	30398763	.	T	G	2	3	5	0	0	5	0	0
19	30398909	.	T	C	5	4	9	0	0	9	0	0
19	30399047	.	A	T	4	2	6	0	0	6	0	0
19	30410406	.	A	G	12	7	19	0	3	22	0	0
19	30414279	.	G	A	14	13	27	0	1	28	0	0
19	30416496	.	G	T	9	5	14	0	0	14	0	0
19	30416523	.	A	T	11	4	15	0	0	15	0	0
19	30416724	.	C	A	5	5	10	0	0	11	1	0
19	30417081	.	A	T	4	5	9	0	0	9	0	0
19	30425622	.	T	C	6	7	13	0	0	13	0	0
19	30428688	.	A	C	9	10	19	0	0	19	0	0
19	30428726	.	A	G	7	0	7	0	3	10	0	0
19	30429063	.	G	A	5	7	12	0	0	12	0	0
19	30432742	.	G	A	17	16	33	0	1	34	0	0
19	30434753	.	A	G	12	9	21	0	2	23	0	0
19	30434939	.	C	T	9	5	14	0	1	15	0	0
19	30436825	.	A	G	14	9	23	0	0	23	0	0
19	30438496	.	G	A	12	11	23	0	1	24	0	0
19	30438518	.	A	G	10	10	20	0	3	23	0	0
19	30439733	.	C	T	11	13	24	0	2	26	0	0
19	30439754	.	C	T	10	14	24	0	1	25	0	0
19	30441399	.	A	G	8	4	12	0	2	14	0	0
19	30455697	.	A	G	7	7	14	0	0	14	0	0
19	30457627	.	G	A	12	5	17	0	3	20	0	0
19	30457648	.	C	T	11	5	16	0	0	16	0	0
19	30457811	.	C	A	4	5	9	0	2	11	0	0
19	30458039	.	C	A	16	10	26	0	1	27	0	0
19	30458103	.	G	A	1	12	13	0	9	22	0	0
19	30458121	.	C	T	12	12	24	0	0	24	0	0
19	30460936	.	T	A	7	2	9	0	0	9	0	0
19	30460953	.	C	T	7	2	9	0	0	9	0	0
19	30463210	.	G	C	16	4	20	0	0	20	0	0
19	30481692	.	T	C	15	0	15	0	15	30	0	0
19	30481799	.	T	A	13	14	27	0	4	31	0	0
19	30485029	.	G	A	15	15	30	0	1	31	0	0
19	30485085	.	T	C	14	9	23	0	0	23	0	0
19	30485247	.	T	G	11	7	18	0	0	18	0	0
19	30485253	.	A	G	12	5	17	0	1	18	0	0
19	30495908	.	C	T	11	12	23	0	2	25	0	0
19	30495985	.	T	C	6	0	6	0	8	14	0	0
19	30499969	.	T	A	6	14	20	0	0	20	0	0
19	30500052	.	T	G	7	9	16	0	2	18	0	0
19	30500053	.	G	A	6	10	16	0	1	17	0	0
19	30506619	.	C	T	11	9	20	0	3	23	0	0
19	30506709	.	G	A	3	10	13	0	0	13	0	0
19	30510264	.	T	C	5	7	12	0	0	12	0	0
19	30518480	.	T	A	16	23	39	0	0	39	0	0
19	30518646	.	A	C	33	23	56	0	1	57	0	0
19	30518906	.	A	G	19	21	40	0	1	41	0	0
19	30518973	.	C	T	26	23	49	5	2	56	0	0
19	30519319	.	A	G	8	5	13	0	1	15	1	0
19	30519324	.	C	T	10	7	17	0	1	18	0	0
19	30519459	.	T	A	8	7	15	0	0	15	0	0
19	30519510	.	T	C	4	3	7	0	0	7	0	0
19	30519550	.	T	A	4	4	8	0	0	8	0	0
19	30519802	.	C	T	20	15	35	0	1	36	0	0
19	30519803	.	T	G	21	15	36	0	0	36	0	0
19	30519858	.	A	G	17	9	26	0	0	26	0	0
19	30520061	.	T	G	20	17	37	1	0	38	0	0
19	30520214	.	C	T	25	24	49	0	1	50	0	0
19	30520337	.	A	G	23	12	35	0	1	36	0	0
19	30520419	.	G	A	20	26	46	0	2	48	0	0
19	30520431	.	C	G	19	25	44	0	0	44	0	0
19	30520567	.	T	A	24	15	39	1	3	43	0	0
19	30520569	.	T	A	24	14	38	1	2	41	0	0
19	30521256	.	G	A	12	3	15	0	0	15	0	0
19	30521443	.	C	A	9	3	12	0	0	12	0	0
19	30521782	.	T	A	3	3	6	0	0	6	0	0
19	30522182	.	T	C	11	16	27	0	0	27	0	0
19	30589376	.	T	G	1	0	1	0	7	8	0	0
19	30669900	.	G	A	4	26	30	0	22	52	0	0
19	30669930	.	A	G	22	28	50	0	3	53	0	0
19	30672935	.	T	C	20	30	50	0	3	53	0	0
19	30673004	.	T	A	30	29	59	0	4	63	0	0
19	30676543	.	G	A	28	25	53	0	1	54	0	0
19	30676699	.	C	T	32	25	57	0	3	60	0	0
19	30681938	.	G	A	3	15	18	0	23	41	0	0
19	30682680	.	G	A	31	31	62	0	1	63	0	0
19	30682781	.	C	A	27	29	56	0	2	59	1	0
19	30682947	.	A	G	26	19	45	0	1	46	0	0
19	30683129	.	A	C	22	29	51	0	0	51	0	0
19	30683395	.	A	T	20	20	40	0	1	41	0	0
19	30723456	.	G	A	4	2	6	0	0	6	0	0
19	30723554	.	C	G	4	3	7	0	0	7	0	0
19	30723675	.	A	T	5	3	8	0	0	8	0	0
19	30723691	.	G	A	4	4	8	0	0	8	0	0
19	30755362	.	C	A	3	4	7	0	0	7	0	0
19	30757713	.	A	G	5	8	13	0	1	14	0	0
19	30763040	.	G	T	3	3	6	0	0	6	0	0
19	30805617	.	C	T	5	6	11	0	1	12	0	0
19	30805698	.	C	G	7	5	12	0	1	13	0	0
19	30805886	.	A	C	4	4	8	0	0	8	0	0
19	30807557	.	A	G	11	12	23	0	7	30	0	0
19	30810911	.	A	T	11	7	18	0	0	18	0	0
19	30810916	.	T	G	10	6	16	0	0	16	0	0
19	30810958	.	T	C	9	3	12	0	0	12	0	0
19	30810970	.	G	A	5	6	11	0	0	11	0	0
19	30811103	.	A	G	7	4	11	0	0	11	0	0
19	30867948	.	G	A	8	8	16	0	2	18	0	0
19	30867955	.	A	T	8	7	15	0	1	16	0	0
19	30868030	.	C	T	14	10	24	0	0	24	0	0
19	30868063	.	C	G	8	9	17	0	2	19	0	0
19	30870930	.	C	T	4	9	13	0	2	15	0	0
19	30876669	.	G	A	4	7	11	0	0	11	0	0
19	30876941	.	G	A	8	7	15	0	0	15	0	0
19	30878424	.	G	A	9	15	24	0	0	24	0	0
19	30878655	.	G	T	11	10	21	0	0	21	0	0
19	30878688	.	C	T	6	9	15	0	0	15	0	0
19	30880083	.	C	G	8	6	14	0	1	15	0	0
19	30882576	.	G	T	7	8	15	0	1	16	0	0
19	30882688	.	T	C	8	10	18	0	2	20	0	0
19	30882743	.	G	A	4	5	9	1	2	12	0	0
19	30882973	.	A	T	12	12	24	0	1	25	0	0
19	30883224	.	C	T	11	7	18	0	1	19	0	0
19	30883298	.	G	A	6	15	21	0	0	21	0	0
19	30883302	.	G	A	6	11	17	0	1	18	0	0
19	30883476	.	A	T	7	6	13	0	0	13	0	0
19	30883549	.	T	C	4	4	8	0	0	8	0	0
19	30886970	.	T	C	6	7	13	0	1	14	0	0
19	30894883	.	G	A	8	9	17	0	2	19	0	0
19	30894980	.	A	G	7	3	10	0	0	10	0	0
19	30895163	.	G	A	6	4	10	0	0	10	0	0
19	30897585	.	A	C	4	4	8	0	0	8	0	0
19	30897840	.	C	T	0	2	2	0	4	6	0	0
19	30897916	.	C	A	2	2	4	0	0	4	0	0
19	30898197	.	C	A	0	4	4	0	1	5	0	0
19	30898841	.	C	A	4	2	6	0	1	7	0	0
19	30899213	.	T	A	3	2	5	0	0	5	0	0
19	30899256	.	T	C	2	3	5	0	0	5	0	0
19	30899280	.	T	G	1	2	3	0	0	3	0	0
19	30899536	.	C	A	8	8	16	0	0	16	0	0
19	30899805	.	T	A	2	4	6	0	0	6	0	0
19	30899816	.	T	C	2	0	2	0	2	4	0	0
19	30900150	.	C	T	0	4	4	0	1	5	0	0
19	30901979	.	C	G	1	6	7	0	1	8	0	0
19	30902042	.	C	T	4	2	6	0	0	6	0	0
19	30963329	.	T	G	1	4	5	0	0	5	0	0
19	30963389	.	G	T	2	2	4	0	0	4	0	0
19	30999947	.	T	C	6	0	6	0	5	11	0	0
19	31000077	.	C	T	0	12	12	0	6	18	0	0
19	31000207	.	T	C	10	13	23	0	3	26	0	0
19	31001318	.	T	G	15	16	31	0	1	32	0	0
19	31001417	.	A	G	9	19	28	0	0	28	0	0
19	31003330	.	A	T	14	12	26	0	1	27	0	0
19	31005005	.	A	C	11	13	24	0	2	26	0	0
19	31005053	.	C	T	11	9	20	0	0	20	0	0
19	31010033	.	A	C	23	9	32	0	1	33	0	0
19	31010061	.	T	A	19	9	28	0	0	28	0	0
19	31012900	.	G	A	7	7	14	0	1	15	0	0
19	31016410	.	A	T	12	13	25	0	0	25	0	0
19	31016458	.	C	A	12	15	27	0	0	27	0	0
19	31340089	.	G	A	6	8	14	0	1	15	0	0
19	31340777	.	A	G	7	6	13	0	0	13	0	0
19	31341000	.	C	T	12	10	22	0	0	22	0	0
19	31347747	.	G	A	1	2	3	0	0	3	0	0
19	31348726	.	G	C	2	2	4	0	0	4	0	0
19	31392375	.	C	T	19	21	40	0	0	40	0	0
19	31392700	.	G	A	20	19	39	0	1	40	0	0
19	31392803	.	C	T	0	22	22	0	24	46	0	0
19	31394550	.	A	G	15	17	32	0	2	35	1	0
19	31398928	.	C	T	2	13	15	0	14	29	0	0
19	31398961	.	A	G	13	19	32	0	1	33	0	0
19	31398979	.	A	G	12	13	25	0	2	27	0	0
19	31402418	.	T	C	16	24	40	0	4	44	0	0
19	31416787	.	G	A	13	8	21	0	3	24	0	0
19	31424215	.	C	G	3	0	3	0	11	14	0	0
19	31431021	.	T	C	12	10	22	0	0	22	0	0
19	31437956	.	A	G	9	12	21	0	1	22	0	0
19	31437974	.	G	A	7	11	18	0	0	18	0	0
19	31438009	.	G	T	4	6	10	0	0	10	0	0
19	31438016	.	T	C	3	0	3	0	6	9	0	0
19	31449834	.	T	G	12	16	28	0	1	29	0	0
19	31455562	.	T	C	16	7	23	0	3	26	0	0
19	31461620	.	C	G	9	12	21	0	1	22	0	0
19	31517478	.	T	C	13	11	24	0	0	24	0	0
19	31532236	.	T	A	1	3	4	0	0	4	0	0
19	31555871	.	T	A	6	4	10	0	0	10	0	0
19	31560775	.	G	A	9	6	15	0	0	15	0	0
19	31570339	.	T	C	1	0	1	0	2	3	0	0
19	31570344	.	C	G	1	2	3	0	0	3	0	0
19	31571563	.	T	C	4	4	8	0	1	9	0	0
19	31571572	.	G	A	6	3	9	0	1	10	0	0
19	31574099	.	A	T	5	4	9	0	1	10	0	0
19	31574150	.	G	T	5	5	10	0	0	10	0	0
19	31574192	.	A	T	6	2	8	0	0	8	0	0
19	31575705	.	A	G	4	4	8	0	0	8	0	0
19	31576024	.	T	A	7	6	13	0	0	13	0	0
19	31576954	.	A	G	9	7	16	0	1	17	0	0
19	31579783	.	T	A	17	18	35	0	0	35	0	0
19	31579860	.	G	T	27	25	52	0	0	52	0	0
19	31580071	.	C	A	2	20	22	0	20	42	0	0
19	31580103	.	A	T	30	20	50	0	2	52	0	0
19	31580160	.	T	A	26	16	42	1	9	52	0	0
19	31580186	.	T	G	31	16	47	1	4	52	0	0
19	31580328	.	A	C	20	1	21	0	27	48	0	0
19	31583137	.	A	G	11	15	26	0	0	26	0	0
19	31583179	.	C	T	14	17	31	0	4	35	0	0
19	31583289	.	C	T	15	12	27	1	1	29	0	0
19	31583305	.	A	G	12	12	24	1	0	25	0	0
19	31584018	.	T	G	19	22	41	0	3	44	0	0
19	31585399	.	C	G	1	3	4	0	0	4	0	0
19	31593550	.	A	G	8	3	11	0	0	11	0	0
19	31593594	.	C	A	8	9	17	0	0	17	0	0
19	31593595	.	C	A	7	6	13	0	3	16	0	0
19	31593706	.	G	C	8	9	17	0	0	17	0	0
19	31593762	.	G	A	12	9	21	0	1	22	0	0
19	31593957	.	C	T	12	4	16	0	2	18	0	0
19	31596948	.	C	G	11	8	19	0	1	20	0	0
19	31598108	.	G	T	2	5	7	0	0	7	0	0
19	31598113	.	G	A	5	3	8	0	0	8	0	0
19	31603351	.	G	C	9	10	19	0	0	19	0	0
19	31603398	.	C	T	1	6	7	0	11	18	0	0
19	31603416	.	G	C	13	0	13	0	6	19	0	0
19	31612666	.	T	C	5	2	7	0	0	7	0	0
19	31612876	.	A	G	3	5	8	0	1	9	0	0
19	31613176	.	G	A	9	11	20	0	1	21	0	0
19	31619299	.	G	A	7	3	10	0	0	10	0	0
19	31619311	.	A	G	4	5	9	0	0	9	0	0
19	31621447	.	T	C	4	1	5	0	3	8	0	0
19	31621507	.	G	A	4	6	10	0	1	11	0	0
19	31621891	.	G	T	8	6	14	0	1	15	0	0
19	31621903	.	C	T	8	7	15	0	0	15	0	0
19	31771335	.	T	A	31	24	55	0	3	58	0	0
19	31789666	.	C	T	17	21	38	0	12	50	0	0
19	31790042	.	C	A	29	27	56	1	3	60	0	0
19	31790079	.	A	G	33	21	54	2	2	58	0	0
19	31790097	.	C	T	38	20	58	1	0	59	0	0
19	31790115	.	C	A	26	32	58	1	5	64	0	0
19	31790283	.	G	C	43	25	68	0	5	73	0	0
19	31790385	.	A	G	17	23	40	7	7	54	0	0
19	31797778	.	G	A	4	4	8	0	0	8	0	0
19	31797834	.	G	T	4	4	8	0	0	8	0	0
19	31798203	.	C	G	2	4	6	0	1	7	0	0
19	31798660	.	G	A	5	2	7	0	0	7	0	0
19	31800090	.	G	A	3	2	5	0	0	5	0	0
19	31800147	.	A	G	5	2	7	0	0	7	0	0
19	31882114	.	G	A	4	7	11	0	1	12	0	0
19	31891350	.	A	G	7	4	11	0	1	12	0	0
19	31938817	.	T	C	7	5	12	0	0	12	0	0
19	32041686	.	T	C	6	3	9	0	0	9	0	0
19	32041747	.	T	C	6	6	12	0	1	13	0	0
19	32042056	.	C	T	8	4	12	0	0	12	0	0
19	32049055	.	A	G	10	10	20	0	0	20	0	0
19	32049443	.	T	C	10	8	18	0	0	18	0	0
19	32049485	.	A	T	7	7	14	0	2	16	0	0
19	32049775	.	G	A	8	16	24	0	0	24	0	0
19	32049850	.	A	G	16	12	28	0	2	30	0	0
19	32049891	.	A	G	11	15	26	0	1	27	0	0
19	32050174	.	T	G	9	10	19	1	0	20	0	0
19	32050535	.	A	T	16	21	37	0	0	37	0	0
19	32050536	.	T	A	15	20	35	0	1	36	0	0
19	32050593	.	A	T	12	12	24	0	1	25	0	0
19	32050679	.	C	A	9	9	18	0	0	18	0	0
19	32050702	.	G	A	8	7	15	0	0	15	0	0
19	32050944	.	A	T	20	13	33	0	0	33	0	0
19	32051218	.	C	A	10	15	25	0	0	25	0	0
19	32051226	.	G	A	15	11	26	0	0	26	0	0
19	32051541	.	T	G	11	9	20	0	1	21	0	0
19	32051566	.	G	C	11	13	24	0	2	26	0	0
19	32064557	.	T	G	8	14	22	0	1	23	0	0
19	32064872	.	C	T	1	16	17	0	9	26	0	0
19	32500130	.	T	C	1	2	3	0	1	4	0	0
19	32866663	.	T	A	2	3	5	0	0	5	0	0
19	32895702	.	G	A	20	5	25	1	1	27	0	0
19	32895873	.	T	A	0	11	11	0	0	11	0	0
19	34778303	.	C	T	1	2	3	0	0	3	0	0
19	34781039	.	C	T	1	2	3	0	2	5	0	0
19	34783443	.	C	T	5	3	8	0	0	8	0	0
19	34960099	.	A	G	7	5	12	0	0	12	0	0
19	34960143	.	A	G	9	6	15	0	0	15	0	0
19	34960147	.	G	A	8	6	14	0	1	15	0	0
19	34960190	.	C	G	2	7	9	0	11	20	0	0
19	34960198	.	T	C	11	8	19	0	1	20	0	0
19	34960315	.	T	A	8	7	15	0	0	15	0	0
19	34960574	.	A	G	3	1	4	0	0	4	0	0
19	34960694	.	T	A	4	3	7	0	0	7	0	0
19	34961152	.	C	T	7	10	17	0	0	17	0	0
19	34961269	.	A	G	3	6	9	0	0	9	0	0
19	34966834	.	C	T	3	2	5	0	0	5	0	0
19	34967187	.	G	A	2	3	5	0	0	5	0	0
19	34979819	.	C	T	1	3	4	0	0	4	0	0
19	35002450	.	G	A	4	4	8	0	1	9	0	0
19	35002527	.	G	A	0	2	2	0	1	3	0	0
19	35002714	.	A	C	5	11	16	0	0	16	0	0
19	35002723	.	T	C	7	10	17	0	0	17	0	0
19	35004117	.	A	C	6	7	13	0	0	13	0	0
19	35004135	.	C	T	5	7	12	0	0	12	0	0
19	35004868	.	C	A	4	5	9	0	0	9	0	0
19	35004869	.	C	A	4	5	9	0	0	9	0	0
19	35004920	.	G	A	2	4	6	0	0	6	0	0
19	35004941	.	T	C	3	5	8	0	0	8	0	0
19	35005136	.	A	C	8	4	12	0	1	13	0	0
19	35005137	.	A	T	7	3	10	0	3	13	0	0
19	35005318	.	G	A	6	13	19	0	11	30	0	0
19	35007220	.	G	A	13	14	27	0	4	31	0	0
19	35007235	.	G	A	15	15	30	0	0	30	0	0
19	35013166	.	G	T	5	5	10	0	1	11	0	0
19	35013806	.	C	T	31	18	49	0	1	50	0	0
19	35016477	.	C	T	22	16	38	0	1	39	0	0
19	35016553	.	T	G	15	7	22	0	0	22	0	0
19	35016646	.	A	T	21	18	39	0	2	41	0	0
19	35016696	.	T	G	15	13	28	0	0	28	0	0
19	35016835	.	C	T	15	10	25	0	0	25	0	0
19	35016962	.	T	A	6	8	14	0	0	14	0	0
19	35019339	.	C	A	2	2	4	0	0	4	0	0
19	35019351	.	T	C	2	2	4	0	0	4	0	0
19	35019560	.	A	G	0	3	3	0	1	4	0	0
19	35040003	.	G	T	3	3	6	0	2	8	0	0
19	35041158	.	T	A	24	32	56	0	2	58	0	0
19	35041308	.	A	G	23	33	56	0	3	59	0	0
19	35041458	.	T	C	28	1	29	1	28	58	0	0
19	35052411	.	G	T	26	11	37	0	1	38	0	0
19	35052435	.	T	C	26	0	26	0	12	38	0	0
19	35055889	.	A	G	16	15	31	0	0	31	0	0
19	35057860	.	G	T	13	12	25	0	0	25	0	0
19	35057869	.	C	T	14	11	25	0	1	26	0	0
19	35058232	.	T	C	15	15	30	0	4	34	0	0
19	35060217	.	A	C	10	19	29	0	0	29	0	0
19	35065906	.	A	T	13	18	31	1	0	32	0	0
19	35067367	.	G	A	13	12	25	0	3	28	0	0
19	35069299	.	G	T	23	19	42	0	2	44	0	0
19	35069755	.	C	A	19	15	34	0	0	34	0	0
19	35069934	.	T	G	17	10	27	0	2	29	0	0
19	35070015	.	C	T	20	11	31	0	1	32	0	0
19	35072613	.	A	C	17	13	30	0	0	30	0	0
19	35072712	.	G	C	12	0	12	0	12	24	0	0
19	35075637	.	C	T	1	12	13	0	20	33	0	0
19	35076301	.	C	T	3	19	22	0	13	35	0	0
19	35076773	.	G	A	14	13	27	0	0	27	0	0
19	35078584	.	T	C	13	2	15	0	15	30	0	0
19	35078632	.	T	C	13	2	15	0	12	27	0	0
19	35079259	.	C	T	9	11	20	0	0	20	0	0
19	35079515	.	A	T	8	9	17	0	0	17	0	0
19	35083010	.	G	A	17	15	32	0	1	33	0	0
19	35083019	.	C	T	14	13	27	0	3	30	0	0
19	35083182	.	C	T	13	9	22	0	2	24	0	0
19	35116228	.	A	G	16	11	27	0	0	27	0	0
19	35116297	.	T	C	14	10	24	0	0	24	0	0
19	35116405	.	A	G	17	8	25	0	1	26	0	0
19	35116438	.	G	A	11	13	24	0	4	28	0	0
19	35118813	.	G	C	10	10	20	0	0	20	0	0
19	35118842	.	T	C	11	10	21	0	1	22	0	0
19	35118860	.	G	T	10	10	20	0	1	21	0	0
19	35118911	.	C	A	17	7	24	0	0	24	0	0
19	35118983	.	A	T	12	6	18	0	0	18	0	0
19	35119039	.	T	C	3	6	9	0	1	10	0	0
19	35119052	.	A	G	5	6	11	0	2	13	0	0
19	35119082	.	T	C	10	2	12	0	7	19	0	0
19	35119169	.	G	A	15	13	28	0	0	28	0	0
19	35119205	.	G	A	7	13	20	0	0	20	0	0
19	35119436	.	C	T	13	14	27	0	0	27	0	0
19	35121381	.	T	C	9	10	19	0	1	20	0	0
19	35121459	.	T	C	10	11	21	0	0	21	0	0
19	35122875	.	G	A	7	5	12	0	1	13	0	0
19	35122876	.	C	A	8	4	12	0	1	13	0	0
19	35123452	.	A	T	10	8	18	0	0	18	0	0
19	35123508	.	T	C	7	0	7	0	15	22	0	0
19	35128238	.	T	C	9	10	19	0	0	19	0	0
19	35131332	.	G	A	8	6	14	0	0	14	0	0
19	35134092	.	G	T	8	5	13	0	1	14	0	0
19	35134181	.	G	A	9	5	14	0	1	15	0	0
19	35135406	.	C	A	0	4	4	0	9	13	0	0
19	35135466	.	G	A	11	8	19	0	0	19	0	0
19	35135600	.	A	G	6	7	13	0	1	14	0	0
19	35135626	.	T	G	7	5	12	0	0	12	0	0
19	35135711	.	A	G	7	9	16	0	0	16	0	0
19	35135870	.	C	T	2	3	5	0	0	5	0	0
19	35135883	.	A	G	3	4	7	0	0	7	0	0
19	35135927	.	T	G	8	4	12	0	0	12	0	0
19	35135961	.	A	G	8	3	11	0	2	13	0	0
19	35137910	.	A	G	2	6	8	0	1	9	0	0
19	35138260	.	A	G	5	5	10	0	0	10	0	0
19	35155676	.	C	T	4	7	11	0	0	11	0	0
19	35157472	.	A	G	6	5	11	0	1	12	0	0
19	35157621	.	C	T	3	3	6	0	2	8	0	0
19	35159665	.	G	T	9	8	17	0	0	17	0	0
19	35159668	.	G	A	8	5	13	0	1	14	0	0
19	35159721	.	A	G	11	4	15	0	0	15	0	0
19	35159826	.	G	T	10	6	16	0	0	16	0	0
19	35159841	.	G	T	7	4	11	0	0	11	0	0
19	35164951	.	A	G	5	5	10	0	0	10	0	0
19	35167217	.	G	C	1	7	8	0	0	8	0	0
19	35167278	.	A	T	4	3	7	0	2	9	0	0
19	35167368	.	C	G	2	2	4	0	0	4	0	0
19	35170195	.	A	T	3	6	9	0	0	9	0	0
19	35170263	.	T	G	5	6	11	2	0	13	0	0
19	35175205	.	A	G	1	4	5	0	1	6	0	0
19	35184402	.	A	G	4	4	8	0	0	8	0	0
19	35191348	.	A	G	10	6	16	0	0	16	0	0
19	35339968	.	G	A	1	2	3	0	1	4	0	0
19	35359341	.	C	T	32	33	65	0	0	65	0	0
19	35379917	.	A	G	6	9	15	0	0	15	0	0
19	35379923	.	G	A	7	8	15	0	1	16	0	0
19	35379998	.	A	G	11	6	17	0	0	17	0	0
19	35380031	.	G	A	10	12	22	0	0	22	0	0
19	35380070	.	G	A	2	12	14	0	2	16	0	0
19	35380168	.	T	C	10	0	10	0	8	18	0	0
19	35381625	.	T	A	4	8	12	0	1	14	1	0
19	35381956	.	A	G	9	5	14	0	1	15	0	0
19	35383571	.	G	A	6	5	11	0	0	11	0	0
19	35383586	.	C	T	1	5	6	0	5	11	0	0
19	35386288	.	T	G	9	4	13	0	0	13	0	0
19	35390668	.	T	C	4	4	8	0	0	8	0	0
19	35400397	.	G	A	3	3	6	0	0	6	0	0
19	35400505	.	A	G	1	3	4	0	0	4	0	0
19	35419202	.	A	G	2	4	6	0	0	6	0	0
19	35419215	.	T	A	1	4	5	0	0	5	0	0
19	35422354	.	T	C	10	15	25	0	0	25	0	0
19	35428735	.	G	A	13	12	25	0	0	25	0	0
19	35433592	.	G	A	1	2	3	0	1	4	0	0
19	35433615	.	A	T	2	2	4	0	0	4	0	0
19	35434429	.	T	C	1	2	3	0	0	3	0	0
19	35434834	.	A	G	1	3	4	0	0	4	0	0
19	35445785	.	A	G	1	3	4	0	0	4	0	0
19	35445797	.	G	A	1	3	4	0	0	4	0	0
19	35459414	.	A	G	15	16	31	2	2	35	0	0
19	35459737	.	G	A	24	24	48	0	1	49	0	0
19	35459801	.	A	T	34	22	56	0	0	56	0	0
19	35473080	.	C	A	2	21	23	0	20	43	0	0
19	35496536	.	C	A	1	2	3	0	0	3	0	0
19	35722947	.	T	C	6	7	13	0	0	13	0	0
19	35723040	.	G	T	19	11	30	0	0	30	0	0
19	35723087	.	G	T	18	19	37	0	1	38	0	0
19	35723113	.	G	T	14	24	38	0	4	42	0	0
19	35723214	.	T	C	2	2	4	0	9	13	0	0
19	35723237	.	C	A	7	12	19	0	2	21	0	0
19	35723268	.	A	T	12	11	23	0	1	24	0	0
19	35723289	.	C	A	14	9	23	0	0	23	0	0
19	35723422	.	C	T	12	14	26	0	1	27	0	0
19	35723552	.	C	T	3	17	20	0	8	28	0	0
19	35733351	.	T	C	9	17	26	0	0	26	0	0
19	35849232	.	A	G	1	0	1	0	3	4	0	0
19	35852378	.	C	T	4	5	9	0	0	9	0	0
19	35852381	.	A	G	3	5	8	0	0	8	0	0
19	36115044	.	G	A	7	10	17	0	0	17	0	0
19	36115084	.	C	T	10	14	24	0	0	24	0	0
19	36115100	.	C	T	1	17	18	0	7	25	0	0
19	36115170	.	G	C	5	6	11	0	1	12	0	0
19	36115210	.	G	A	6	10	16	0	1	17	0	0
19	36120265	.	C	T	1	11	12	0	8	20	0	0
19	36167703	.	C	T	1	9	10	0	6	16	0	0
19	36169872	.	A	G	4	4	8	0	0	8	0	0
19	36171682	.	T	C	5	0	5	0	7	12	0	0
19	36171778	.	G	A	7	6	13	0	1	14	0	0
19	36212370	.	G	A	6	4	10	0	0	10	0	0
19	36227281	.	G	A	5	4	9	0	2	11	0	0
19	36227407	.	A	G	11	8	19	0	1	20	0	0
19	36258165	.	C	T	0	5	5	0	6	11	0	0
19	36271838	.	C	T	9	4	13	0	0	13	0	0
19	36277799	.	G	A	1	5	6	0	1	7	0	0
19	36290642	.	A	G	5	6	11	0	0	11	0	0
19	36290669	.	C	T	0	7	7	0	3	10	0	0
19	36311813	.	G	A	5	8	13	0	1	14	0	0
19	36311879	.	G	A	8	4	12	0	0	12	0	0
19	36365526	.	A	C	3	0	3	0	4	7	0	0
19	36374326	.	T	C	4	0	4	0	5	9	0	0
19	36389712	.	G	C	3	2	5	0	0	5	0	0
19	36389748	.	G	A	4	2	6	0	1	7	0	0
19	36409112	.	C	T	1	3	4	0	0	4	0	0
19	36427054	.	C	G	2	3	5	0	0	5	0	0
19	37127483	.	A	T	4	12	16	0	2	18	0	0
19	37133533	.	C	A	7	5	12	0	0	12	0	0
19	37133719	.	G	T	8	3	11	0	0	11	0	0
19	37133872	.	T	C	1	2	3	0	0	3	0	0
19	37135759	.	G	A	5	4	9	0	0	9	0	0
19	37138743	.	C	T	11	7	18	0	3	21	0	0
19	37139266	.	T	C	4	4	8	0	1	9	0	0
19	37154069	.	T	A	3	2	5	0	0	5	0	0
19	37478230	.	C	A	5	5	10	0	0	10	0	0
19	37481658	.	C	T	6	15	21	0	1	22	0	0
19	37485121	.	C	T	3	6	9	0	0	9	0	0
19	37488593	.	C	T	7	2	9	0	1	10	0	0
19	37490921	.	C	T	1	4	5	0	0	5	0	0
19	37491605	.	C	A	3	3	6	0	0	6	0	0
19	37491689	.	G	A	2	4	6	0	0	6	0	0
19	37492351	.	G	A	5	5	10	0	0	10	0	0
19	37501738	.	T	C	5	0	5	0	10	15	0	0
19	37501802	.	C	T	14	16	30	0	2	32	0	0
19	37501935	.	A	G	22	23	45	0	4	49	0	0
19	37501959	.	C	T	28	20	48	0	2	50	0	0
19	37502235	.	G	A	35	22	57	0	3	60	0	0
19	37504201	.	G	A	18	13	31	0	2	33	0	0
19	37505790	.	G	A	18	15	33	0	1	34	0	0
19	37505808	.	G	A	16	16	32	0	0	32	0	0
19	37505880	.	C	G	17	22	39	0	2	41	0	0
19	37506405	.	G	A	21	14	35	1	1	37	0	0
19	37506414	.	T	C	21	13	34	1	0	35	0	0
19	37508533	.	G	A	15	11	26	0	1	27	0	0
19	37701868	.	T	C	5	4	9	0	1	10	0	0
19	37702120	.	A	G	8	5	13	0	0	13	0	0
19	37711097	.	C	A	4	4	8	0	1	9	0	0
19	37737736	.	C	T	6	6	12	0	0	12	0	0
19	37759892	.	T	A	7	7	14	0	0	14	0	0
19	37786292	.	C	A	3	2	5	0	0	5	0	0
19	37799569	.	T	C	9	3	12	0	1	13	0	0
19	37804440	.	T	C	7	5	12	1	0	13	0	0
19	37804719	.	C	T	5	5	10	0	1	11	0	0
19	37815718	.	C	A	7	9	16	0	2	18	0	0
19	37815733	.	A	G	11	8	19	0	0	19	0	0
19	37815763	.	G	A	9	6	15	0	2	17	0	0
19	37829463	.	A	C	4	7	11	0	0	11	0	0
19	37835433	.	A	C	5	4	9	0	0	9	0	0
19	37835502	.	A	G	8	5	13	0	0	13	0	0
19	37835508	.	T	C	9	6	15	0	0	15	0	0
19	37926003	.	C	T	27	12	39	0	1	40	0	0
19	37926066	.	C	A	28	16	44	0	1	45	0	0
19	37926261	.	C	T	12	30	42	0	0	42	0	0
19	37926267	.	C	A	12	27	39	0	2	41	0	0
19	37926447	.	C	T	13	17	30	0	1	31	0	0
19	37926493	.	C	T	14	13	27	0	0	27	0	0
19	37926637	.	A	G	6	1	7	0	9	16	0	0
19	37926816	.	T	G	32	11	43	0	3	46	0	0
19	38171067	.	G	A	12	10	22	0	0	22	0	0
19	38175219	.	C	T	10	5	15	0	0	15	0	0
19	38176911	.	A	G	3	8	11	0	1	12	0	0
19	38205299	.	T	C	10	7	17	0	1	18	0	0
19	38205350	.	T	C	3	4	7	0	0	7	0	0
19	38216302	.	A	C	4	9	13	0	0	13	0	0
19	38216310	.	C	G	5	0	5	0	9	14	0	0
19	38227086	.	T	G	10	5	15	0	0	15	0	0
19	38240541	.	A	G	8	0	8	1	8	17	0	0
19	38240844	.	C	T	4	7	11	0	1	12	0	0
19	38327186	.	T	C	4	3	7	0	0	7	0	0
19	38327305	.	G	A	1	2	3	0	0	3	0	0
19	38327593	.	C	T	1	3	4	0	0	4	0	0
19	38389833	.	G	A	2	6	8	0	0	8	0	0
19	38391681	.	G	T	3	4	7	0	0	7	0	0
19	38464589	.	C	T	1	2	3	0	0	3	0	0
19	38776962	.	A	G	14	16	30	0	1	31	0	0
19	38777235	.	T	C	9	6	15	0	0	15	0	0
19	38793349	.	G	A	8	3	11	0	2	13	0	0
19	40026627	.	A	G	22	23	45	0	3	48	0	0
19	40026661	.	T	C	24	16	40	0	1	41	0	0
19	40027585	.	A	G	20	21	41	0	1	42	0	0
19	40027652	.	C	A	23	22	45	0	1	46	0	0
19	40031164	.	G	A	28	29	57	0	2	59	0	0
19	40039603	.	G	A	9	8	17	0	0	17	0	0
19	40039606	.	T	A	9	8	17	0	0	17	0	0
19	40039651	.	A	T	10	6	16	0	0	16	0	0
19	40052809	.	G	T	13	8	21	0	0	21	0	0
19	40052884	.	G	A	6	4	10	0	0	10	0	0
19	40052894	.	A	T	8	4	12	0	2	14	0	0
19	40071539	.	T	G	6	7	13	0	0	13	0	0
19	40071577	.	T	C	6	5	11	0	1	12	0	0
19	40071619	.	A	G	3	0	3	0	5	8	0	0
19	40071748	.	G	A	1	3	4	0	0	4	0	0
19	40073659	.	G	C	3	5	8	0	0	8	0	0
19	40073715	.	G	A	0	5	5	0	1	6	0	0
19	40076842	.	C	T	4	3	7	0	1	8	0	0
19	40076845	.	T	C	5	3	8	0	0	8	0	0
19	40080719	.	T	C	2	7	9	0	0	9	0	0
19	40081613	.	T	C	2	5	7	0	0	7	0	0
19	40081927	.	A	G	2	3	5	0	1	6	0	0
19	40099361	.	C	T	11	5	16	0	0	16	0	0
19	40110897	.	G	A	7	12	19	0	2	21	0	0
19	40113305	.	G	A	0	8	8	0	9	17	0	0
19	40113618	.	T	C	9	5	14	0	0	14	0	0
19	40122597	.	T	G	4	2	6	0	0	6	0	0
19	40122630	.	A	G	2	3	5	0	1	6	0	0
19	40122651	.	A	C	5	3	8	0	0	8	0	0
19	40122695	.	G	C	3	2	5	0	0	5	0	0
19	40122753	.	G	A	0	4	4	0	1	5	0	0
19	40122758	.	C	G	1	4	5	0	0	5	0	0
19	40126647	.	A	G	4	0	4	0	6	10	0	0
19	40129258	.	A	C	12	6	18	0	0	18	0	0
19	40129443	.	A	G	7	6	13	0	0	13	0	0
19	40145888	.	G	A	6	9	15	0	1	16	0	0
19	40146214	.	C	T	9	6	15	0	1	16	0	0
19	40146215	.	G	A	6	9	15	0	0	15	0	0
19	40147719	.	C	A	17	9	26	0	1	27	0	0
19	40147782	.	T	C	18	8	26	0	1	29	2	0
19	40147821	.	G	A	1	19	20	0	10	30	0	0
19	40151351	.	C	T	10	6	16	0	1	17	0	0
19	40151970	.	G	A	16	18	34	0	0	34	0	0
19	40151983	.	C	T	13	21	34	0	1	35	0	0
19	40152569	.	G	A	13	10	23	0	1	24	0	0
19	40153024	.	A	T	17	11	28	0	1	29	0	0
19	40154957	.	C	T	13	5	18	0	0	18	0	0
19	40155144	.	C	A	11	13	24	0	0	24	0	0
19	40155327	.	C	T	26	10	36	5	4	45	0	0
19	40156805	.	G	A	1	16	17	0	15	32	0	0
19	40157041	.	T	A	18	13	31	0	0	31	0	0
19	40162945	.	C	A	12	17	29	0	0	29	0	0
19	40163077	.	C	T	20	11	31	0	1	32	0	0
19	40163184	.	C	T	20	19	39	0	0	39	0	0
19	40163223	.	G	A	20	19	39	0	0	39	0	0
19	40177726	.	G	C	5	8	13	0	0	13	0	0
19	40177762	.	T	C	8	3	11	0	0	11	0	0
19	40179641	.	C	A	10	5	15	0	1	16	0	0
19	40179916	.	G	C	1	4	5	0	7	12	0	0
19	40180011	.	C	T	6	5	11	0	1	12	0	0
19	40180058	.	G	A	8	3	11	0	0	11	0	0
19	40325166	.	A	G	2	2	4	0	0	4	0	0
19	40326481	.	G	A	1	3	4	0	1	5	0	0
19	40326527	.	G	A	0	3	3	0	2	5	0	0
19	40326691	.	C	T	3	4	7	0	0	7	0	0
19	40326950	.	C	T	7	1	8	0	2	10	0	0
19	40327862	.	C	A	1	3	4	0	0	4	0	0
19	40340319	.	A	G	11	9	20	0	2	22	0	0
19	40343087	.	C	T	20	27	47	0	2	49	0	0
19	40347600	.	T	G	10	0	10	0	14	24	0	0
19	40347702	.	T	A	23	13	36	0	0	36	0	0
19	40347760	.	T	A	10	11	21	0	0	21	0	0
19	40347785	.	A	T	9	11	20	0	0	20	0	0
19	40395930	.	G	C	0	3	3	0	5	8	0	0
19	40540276	.	A	T	5	6	11	0	0	11	0	0
19	40540943	.	T	C	3	3	6	0	0	6	0	0
19	40563396	.	C	T	11	5	16	0	1	17	0	0
19	40565356	.	C	A	2	4	6	0	0	6	0	0
19	40641448	.	G	C	4	5	9	0	0	9	0	0
19	40685424	.	C	T	5	6	11	0	1	12	0	0
19	40685448	.	C	T	5	3	8	0	1	9	0	0
19	40685518	.	G	A	0	7	7	0	10	17	0	0
19	40685935	.	A	G	4	5	9	0	0	9	0	0
19	40686133	.	C	G	3	4	7	0	0	7	0	0
19	40686599	.	T	C	4	7	11	0	0	11	0	0
19	40686626	.	A	T	3	7	10	0	0	10	0	0
19	40717020	.	C	T	8	5	13	0	1	14	0	0
19	40717137	.	G	A	7	8	15	0	0	15	0	0
19	40717649	.	C	A	8	6	14	0	1	15	0	0
19	40746328	.	G	A	4	5	9	0	0	9	0	0
19	40770455	.	G	A	4	9	13	0	0	13	0	0
19	40770527	.	G	A	10	5	15	0	1	16	0	0
19	40770760	.	C	T	0	2	2	0	8	10	0	0
19	40773573	.	G	A	3	7	10	0	1	11	0	0
19	40776907	.	G	A	5	6	11	0	0	11	0	0
19	40862041	.	G	A	0	2	2	0	3	5	0	0
19	40871974	.	T	C	1	2	3	0	0	3	0	0
19	40872040	.	C	T	4	3	7	0	2	9	0	0
19	40872046	.	T	C	4	5	9	0	0	9	0	0
19	40895763	.	G	A	6	11	17	0	0	17	0	0
19	40895829	.	C	T	5	6	11	0	1	12	0	0
19	40898500	.	G	A	4	3	7	0	1	8	0	0
19	40900283	.	G	T	4	8	12	0	0	12	0	0
19	40900334	.	C	T	8	4	12	0	1	13	0	0
19	40906097	.	A	C	13	15	28	0	1	29	0	0
19	40906118	.	T	A	15	12	27	0	1	28	0	0
19	40999248	.	T	A	3	2	5	0	0	5	0	0
19	41013109	.	A	G	14	0	14	0	11	25	0	0
19	41030324	.	A	C	6	7	13	0	1	14	0	0
19	41033811	.	G	A	3	21	24	0	16	40	0	0
19	41033929	.	C	A	19	12	31	0	0	31	0	0
19	41034183	.	A	G	15	0	15	1	4	20	0	0
19	41038728	.	T	A	2	2	4	0	0	4	0	0
19	41038961	.	A	C	28	13	41	0	0	41	0	0
19	41052274	.	G	A	32	25	57	0	0	57	0	0
19	41054464	.	T	C	25	1	26	1	27	54	0	0
19	41057067	.	T	C	20	0	20	0	27	47	0	0
19	41060856	.	A	G	12	18	30	0	0	30	0	0
19	41069442	.	G	A	17	25	42	0	1	43	0	0
19	41069564	.	G	C	9	9	18	0	0	18	0	0
19	41075564	.	T	G	8	1	9	0	2	11	0	0
19	41080353	.	G	A	6	7	13	0	0	13	0	0
19	41081118	.	G	A	5	7	12	0	1	13	0	0
19	41081198	.	T	C	4	8	12	0	2	14	0	0
19	41081211	.	C	G	4	0	4	0	9	13	0	0
19	41081424	.	A	G	4	10	14	0	0	14	0	0
19	41113522	.	C	G	5	8	13	0	0	13	0	0
19	41115545	.	T	C	6	3	9	0	1	10	0	0
19	41127263	.	G	A	6	7	13	0	1	14	0	0
19	41141941	.	C	T	9	9	18	0	0	18	0	0
19	41147081	.	C	T	6	5	11	0	1	12	0	0
19	41150257	.	C	A	6	3	9	0	0	9	0	0
19	41151789	.	C	G	4	4	8	0	1	9	0	0
19	41156254	.	G	A	0	10	10	0	10	20	0	0
19	41159124	.	G	A	1	3	4	0	6	10	0	0
19	41159197	.	T	G	4	3	7	0	0	7	0	0
19	41159916	.	A	T	5	8	13	0	0	13	0	0
19	41159954	.	A	G	7	0	7	0	5	12	0	0
19	41160117	.	G	A	4	4	8	0	1	9	0	0
19	41160291	.	C	T	7	6	13	0	1	14	0	0
19	41160714	.	A	T	2	4	6	0	0	6	0	0
19	41160885	.	G	A	8	7	15	0	0	15	0	0
19	41321897	.	G	C	1	2	3	0	0	3	0	0
19	41324992	.	G	A	2	2	4	0	0	4	0	0
19	41340521	.	A	G	3	3	6	0	0	6	0	0
19	41401637	.	C	A	9	10	19	0	1	20	0	0
19	41401727	.	C	T	0	13	13	0	8	21	0	0
19	41401878	.	G	A	7	7	14	0	0	14	0	0
19	41401926	.	A	G	23	10	33	0	1	34	0	0
19	41401928	.	G	A	23	10	33	0	2	35	0	0
19	41401979	.	G	C	29	16	45	2	1	48	0	0
19	41404250	.	G	A	35	18	53	0	4	57	0	0
19	41404273	.	C	T	1	18	19	0	39	58	0	0
19	41447257	.	A	G	5	6	11	0	0	11	0	0
19	41447420	.	A	G	4	7	11	0	0	11	0	0
19	41447427	.	A	G	5	7	12	0	0	12	0	0
19	41447548	.	A	G	2	4	6	0	0	7	1	0
19	41447600	.	G	T	5	1	6	0	1	7	0	0
19	41447727	.	T	C	1	2	3	0	0	3	0	0
19	41447767	.	A	G	2	2	4	0	0	4	0	0
19	41448040	.	G	A	4	7	11	0	1	12	0	0
19	41448047	.	G	T	6	7	13	0	1	14	0	0
19	41466725	.	T	C	8	5	13	0	0	13	0	0
19	41466726	.	G	A	9	3	12	0	2	14	0	0
19	41466777	.	G	A	0	7	7	0	5	12	0	0
19	41466783	.	T	C	4	6	10	0	0	11	1	0
19	41484847	.	G	A	2	2	4	0	0	4	0	0
19	41492255	.	T	C	1	2	3	0	1	4	0	0
19	41516139	.	T	G	5	4	9	0	0	9	0	0
19	41516204	.	G	T	8	3	11	0	0	11	0	0
19	41516209	.	A	C	7	0	7	0	4	11	0	0
19	41516281	.	C	A	3	3	6	0	0	6	0	0
19	41521060	.	T	C	2	6	8	0	0	8	0	0
19	41521243	.	A	C	1	3	4	0	0	4	0	0
19	41531232	.	A	C	2	4	6	0	0	6	0	0
19	41531236	.	C	T	2	4	6	0	0	6	0	0
19	41533610	.	T	A	8	5	13	0	2	15	0	0
19	41534035	.	G	C	4	3	7	0	0	7	0	0
19	41534050	.	G	A	4	2	6	0	1	7	0	0
19	41537398	.	A	C	3	3	6	0	0	6	0	0
19	41538865	.	A	G	4	2	6	0	0	6	0	0
19	41539516	.	A	T	5	4	9	0	1	10	0	0
19	41539517	.	A	C	6	4	10	0	0	10	0	0
19	41539606	.	T	C	3	2	5	0	0	5	0	0
19	41539663	.	T	C	2	3	5	0	0	5	0	0
19	41539664	.	T	C	2	3	5	0	0	5	0	0
19	41539708	.	G	C	2	4	6	0	0	6	0	0
19	41539821	.	G	T	2	4	6	0	0	6	0	0
19	41539868	.	A	C	3	5	8	0	1	9	0	0
19	41717013	.	G	C	1	13	14	0	11	25	0	0
19	41724049	.	G	A	1	11	12	0	10	22	0	0
19	41813600	.	A	T	2	3	5	0	0	5	0	0
19	41813612	.	G	A	0	2	2	0	4	6	0	0
19	41841261	.	C	A	10	8	18	0	0	18	0	0
19	41841824	.	T	C	24	17	41	0	0	41	0	0
19	41846849	.	G	T	8	17	25	0	0	25	0	0
19	41849679	.	A	G	18	13	31	0	2	33	0	0
19	41851698	.	G	T	15	10	25	0	0	25	0	0
19	41853967	.	G	T	14	19	33	0	2	35	0	0
19	41857514	.	A	G	1	2	3	0	0	3	0	0
19	41857795	.	G	A	13	14	27	0	0	27	0	0
19	41857846	.	C	T	11	10	21	0	0	21	0	0
19	41860157	.	G	A	11	13	24	0	1	25	0	0
19	41870495	.	G	A	12	7	19	0	2	21	0	0
19	41870515	.	T	A	11	8	19	0	2	21	0	0
19	41882152	.	G	A	14	11	25	0	1	26	0	0
19	41882212	.	G	A	14	18	32	0	0	32	0	0
19	41884108	.	A	G	11	8	19	0	0	19	0	0
19	41884129	.	C	T	3	10	13	0	9	22	0	0
19	41884162	.	G	A	13	8	21	0	1	22	0	0
19	41893332	.	A	G	5	11	16	0	1	17	0	0
19	41893335	.	C	T	4	11	15	0	1	16	0	0
19	41902743	.	A	G	10	10	20	0	1	21	0	0
19	41902975	.	A	C	14	13	27	0	0	27	0	0
19	41909305	.	A	G	11	17	28	0	0	28	0	0
19	41933979	.	G	A	5	14	19	0	0	19	0	0
19	41934074	.	A	G	6	7	13	0	0	13	0	0
19	41937394	.	G	A	10	8	18	0	0	18	0	0
19	41946418	.	C	T	6	3	9	0	0	9	0	0
19	41946676	.	G	A	11	8	19	0	0	19	0	0
19	41946709	.	G	A	9	12	21	0	0	21	0	0
19	42061290	.	C	T	8	14	22	0	0	22	0	0
19	42061441	.	C	G	13	11	24	0	0	24	0	0
19	42061455	.	A	G	14	8	22	0	0	22	0	0
19	42061491	.	C	T	13	11	24	0	1	25	0	0
19	42061521	.	A	G	17	13	30	0	1	31	0	0
19	42061605	.	A	G	12	1	13	1	15	29	0	0
19	42063649	.	G	A	1	2	3	0	0	3	0	0
19	42065010	.	C	T	12	16	28	0	1	29	0	0
19	42066899	.	T	C	16	11	27	0	0	27	0	0
19	42067065	.	T	C	17	11	28	0	0	28	0	0
19	42067149	.	T	C	18	10	28	0	2	30	0	0
19	42068537	.	A	C	18	10	28	0	0	28	0	0
19	42068818	.	A	G	1	2	3	0	0	3	0	0
19	42117777	.	A	T	14	9	23	0	1	24	0	0
19	42118040	.	T	G	8	8	16	0	3	19	0	0
19	42118441	.	T	A	4	4	8	0	0	8	0	0
19	42235042	.	G	C	9	4	13	0	0	13	0	0
19	42235161	.	G	T	7	3	10	0	0	10	0	0
19	42235205	.	A	G	9	5	14	0	0	14	0	0
19	42235655	.	A	C	9	9	18	0	0	18	0	0
19	42236052	.	T	A	1	2	3	0	2	5	0	0
19	42241755	.	G	T	4	4	8	0	0	8	0	0
19	42244118	.	G	A	11	8	19	0	1	20	0	0
19	42244281	.	T	C	13	0	13	0	9	22	0	0
19	42244342	.	G	T	5	4	9	0	0	9	0	0
19	42328467	.	T	C	22	21	43	0	2	45	0	0
19	42328510	.	C	T	26	31	57	0	0	57	0	0
19	42336375	.	G	A	31	21	52	0	0	52	0	0
19	42336526	.	C	T	29	21	50	0	1	51	0	0
19	42336636	.	C	T	24	28	52	0	0	52	0	0
19	42336675	.	C	T	25	15	40	0	3	43	0	0
19	42340452	.	A	G	17	1	18	0	16	34	0	0
19	42340455	.	C	T	19	15	34	0	0	34	0	0
19	42340508	.	G	C	27	18	45	0	2	47	0	0
19	42340658	.	G	A	5	28	33	0	24	57	0	0
19	42340855	.	G	A	2	19	21	0	21	42	0	0
19	42341530	.	T	C	23	23	46	0	0	46	0	0
19	42341613	.	T	A	19	22	41	0	3	44	0	0
19	42341693	.	G	A	14	25	39	0	1	40	0	0
19	42368065	.	C	T	1	7	8	0	2	10	0	0
19	42368511	.	A	C	5	3	8	0	0	8	0	0
19	42368619	.	T	A	4	4	8	0	0	8	0	0
19	42368620	.	T	C	5	0	5	0	4	9	0	0
19	42374298	.	C	A	5	2	7	0	0	7	0	0
19	42389797	.	C	T	0	5	5	0	2	7	0	0
19	42389876	.	C	T	1	4	5	0	3	8	0	0
19	42397975	.	G	A	21	11	32	0	0	32	0	0
19	42400567	.	A	G	19	15	34	1	1	36	0	0
19	42402060	.	G	A	22	11	33	0	2	35	0	0
19	42402382	.	A	G	20	11	31	0	1	32	0	0
19	42416665	.	A	T	18	12	30	0	0	30	0	0
19	42439587	.	G	T	1	2	3	0	0	3	0	0
19	42451401	.	C	T	3	2	5	0	0	5	0	0
19	42454302	.	A	G	1	4	5	0	0	5	0	0
19	42455273	.	C	T	2	3	5	0	0	5	0	0
19	42455352	.	G	A	2	2	4	0	1	5	0	0
19	42458099	.	T	C	10	12	22	0	4	26	0	0
19	42458112	.	T	A	12	15	27	0	3	30	0	0
19	42459868	.	T	A	25	23	48	0	0	48	0	0
19	42484956	.	A	G	2	2	4	0	0	4	0	0
19	42484996	.	T	C	4	3	7	0	0	7	0	0
19	42485006	.	G	C	2	4	6	0	0	6	0	0
19	42491132	.	G	T	1	7	8	0	1	9	0	0
19	42493255	.	C	T	11	7	18	0	0	18	0	0
19	42493353	.	T	A	12	5	17	0	1	18	0	0
19	42493986	.	G	T	13	8	21	0	0	21	0	0
19	42494130	.	T	C	13	1	14	0	9	23	0	0
19	42495678	.	T	G	9	9	18	0	0	18	0	0
19	42495829	.	G	A	14	9	23	0	0	23	0	0
19	42495850	.	G	A	11	6	17	0	0	17	0	0
19	42495901	.	A	G	4	8	12	0	0	12	0	0
19	42498306	.	T	C	7	0	7	0	5	12	0	0
19	42498376	.	C	T	8	11	19	0	0	19	0	0
19	42498378	.	A	C	7	9	16	0	2	18	0	0
19	42498715	.	G	A	8	2	10	0	1	11	0	0
19	42502572	.	T	G	8	5	13	0	1	14	0	0
19	42503094	.	T	C	9	9	18	0	0	18	0	0
19	42503104	.	G	A	9	5	14	0	0	14	0	0
19	42571288	.	T	C	5	2	7	4	0	11	0	0
19	42574042	.	C	A	5	3	8	0	0	8	0	0
19	42574523	.	A	T	4	3	7	0	0	7	0	0
19	42630161	.	T	C	4	2	6	0	0	6	0	0
19	42630655	.	C	T	0	9	9	0	3	12	0	0
19	42660271	.	G	C	9	8	17	0	1	18	0	0
19	42667987	.	C	T	3	8	11	0	0	11	0	0
19	42678624	.	G	A	1	9	10	0	10	20	0	0
19	42682502	.	A	G	12	4	16	0	0	16	0	0
19	42682504	.	G	A	0	5	5	0	11	16	0	0
19	42682628	.	G	A	10	7	17	0	0	17	0	0
19	42682678	.	C	T	9	4	13	0	0	13	0	0
19	42682699	.	C	A	5	4	9	0	2	11	0	0
19	42693887	.	C	T	4	4	8	0	0	8	0	0
19	42693947	.	G	A	2	3	5	0	1	6	0	0
19	42694081	.	T	C	5	5	10	0	0	10	0	0
19	42720227	.	G	A	10	11	21	0	2	23	0	0
19	42720248	.	C	T	15	11	26	0	1	27	0	0
19	42732770	.	G	C	12	6	18	0	0	18	0	0
19	42735350	.	C	A	26	21	47	0	1	48	0	0
19	42740353	.	G	C	21	20	41	0	4	45	0	0
19	42743837	.	G	A	15	16	31	0	7	38	0	0
19	42744744	.	C	T	25	20	45	0	5	50	0	0
19	42747212	.	G	A	2	18	20	0	18	38	0	0
19	42754892	.	C	T	19	21	40	0	2	42	0	0
19	42766814	.	T	A	2	3	5	0	0	5	0	0
19	42774755	.	G	A	29	18	47	0	0	47	0	0
19	42791291	.	T	C	26	40	66	0	0	66	0	0
19	42795751	.	A	G	30	27	57	0	4	61	0	0
19	42795799	.	C	T	40	31	71	0	1	72	0	0
19	42798696	.	C	T	29	27	56	0	3	59	0	0
19	42801687	.	G	A	8	31	39	0	22	61	0	0
19	42801708	.	T	A	27	24	51	0	4	55	0	0
19	42802018	.	C	A	27	34	61	0	3	64	0	0
19	42802075	.	T	C	31	22	53	0	0	53	0	0
19	42802077	.	C	T	32	21	53	0	1	54	0	0
19	42806886	.	T	C	12	4	16	0	1	17	0	0
19	42819316	.	C	A	9	15	24	0	1	25	0	0
19	42819989	.	G	A	9	2	11	0	1	12	0	0
19	42821808	.	G	A	3	9	12	0	1	13	0	0
19	42821859	.	T	C	6	10	16	0	0	16	0	0
19	42826201	.	T	C	12	5	17	0	0	17	0	0
19	42835133	.	C	T	12	7	19	0	1	20	0	0
19	42841599	.	A	C	8	11	19	0	1	20	0	0
19	42843642	.	A	G	8	3	11	0	2	13	0	0
19	42843725	.	A	C	9	10	19	0	2	21	0	0
19	42843751	.	A	T	10	9	19	0	0	19	0	0
19	42843894	.	A	G	16	10	26	0	2	28	0	0
19	42843917	.	T	C	19	7	26	0	0	26	0	0
19	42844126	.	A	G	10	7	17	0	1	18	0	0
19	42847620	.	G	A	6	9	15	0	1	16	0	0
19	42856838	.	C	T	10	16	26	0	1	27	0	0
19	42864222	.	G	T	12	10	22	0	2	24	0	0
19	42868330	.	T	C	18	12	30	0	1	31	0	0
19	42868446	.	A	G	10	12	22	0	2	24	0	0
19	42870512	.	C	T	24	23	47	0	2	49	0	0
19	42872200	.	G	C	24	17	41	0	3	44	0	0
19	42872386	.	A	G	6	0	6	0	23	29	0	0
19	42872392	.	A	C	12	0	12	0	18	30	0	0
19	42873858	.	G	A	4	13	17	0	9	26	0	0
19	42874075	.	C	G	11	10	21	0	1	22	0	0
19	42874172	.	C	T	13	10	23	0	2	25	0	0
19	42874188	.	A	G	12	0	12	0	12	24	0	0
19	42874231	.	C	T	17	7	24	0	2	26	0	0
19	42874301	.	G	A	9	17	26	0	1	27	0	0
19	42874336	.	G	C	7	18	25	0	3	28	0	0
19	42874414	.	T	C	10	9	19	0	1	20	0	0
19	42874439	.	T	G	9	0	9	0	5	14	0	0
19	42874564	.	G	A	15	6	21	0	0	21	0	0
19	42874674	.	A	G	21	13	34	0	1	35	0	0
19	42875103	.	A	T	11	8	19	0	0	19	0	0
19	42894574	.	G	A	4	5	9	0	1	10	0	0
19	42894603	.	A	T	2	4	6	0	0	6	0	0
19	42894624	.	C	T	3	8	11	0	0	11	0	0
19	42894742	.	A	C	5	7	12	0	0	12	0	0
19	42896148	.	G	A	3	6	9	0	6	15	0	0
19	42898282	.	A	C	8	7	15	0	1	16	0	0
19	42898813	.	C	T	12	6	18	0	0	18	0	0
19	42902276	.	C	T	1	6	7	0	0	7	0	0
19	42906166	.	T	C	9	8	17	1	0	18	0	0
19	42906169	.	G	A	0	9	9	1	8	18	0	0
19	42908916	.	T	A	5	6	11	0	0	11	0	0
19	42909168	.	C	T	11	12	23	0	0	23	0	0
19	42912376	.	C	A	14	20	34	0	0	34	0	0
19	42912394	.	G	A	3	14	17	0	15	32	0	0
19	42919465	.	C	T	0	8	8	0	9	17	0	0
19	42928647	.	C	T	0	10	10	0	10	20	0	0
19	42928845	.	C	A	1	9	10	0	8	18	0	0
19	42988059	.	C	T	32	31	63	0	3	66	0	0
19	42997106	.	C	G	7	4	11	0	0	11	0	0
19	42997337	.	C	G	5	3	8	0	0	8	0	0
19	43000034	.	G	C	15	0	15	0	18	33	0	0
19	43000067	.	C	T	11	10	21	0	0	21	0	0
19	43000070	.	A	G	9	9	18	0	1	19	0	0
19	43002605	.	A	C	10	19	29	0	0	29	0	0
19	43004118	.	G	A	13	7	20	0	0	20	0	0
19	43004133	.	T	C	8	5	13	0	2	15	0	0
19	43004221	.	T	G	8	19	27	0	2	29	0	0
19	43004259	.	A	G	17	17	34	0	1	35	0	0
19	43004283	.	T	C	13	16	29	0	2	31	0	0
19	43004297	.	C	A	13	11	24	0	2	26	0	0
19	43007838	.	T	C	4	6	10	0	0	10	0	0
19	43007913	.	C	T	3	6	9	0	0	9	0	0
19	43009476	.	C	T	5	7	12	0	1	13	0	0
19	43015255	.	A	C	2	3	5	0	0	5	0	0
19	43015276	.	C	A	2	2	4	0	0	4	0	0
19	43015564	.	C	T	4	4	8	0	0	8	0	0
19	43018243	.	T	C	18	17	35	0	1	36	0	0
19	43018257	.	G	A	3	22	25	0	12	37	0	0
19	43018352	.	T	C	23	9	32	0	2	34	0	0
19	43029462	.	G	A	0	16	16	0	24	40	0	0
19	43030654	.	G	A	30	17	47	0	0	47	0	0
19	43030655	.	A	G	30	17	47	0	0	47	0	0
19	43031169	.	G	A	4	15	19	0	17	36	0	0
19	43031261	.	G	A	1	3	4	0	4	8	0	0
19	43031264	.	A	G	7	1	8	0	0	8	0	0
19	43031340	.	G	T	2	5	7	0	0	7	0	0
19	43054736	.	A	G	11	20	31	0	0	31	0	0
19	43054854	.	C	T	15	23	38	0	1	39	0	0
19	43054881	.	G	A	1	8	9	0	24	33	0	0
19	43059329	.	C	T	12	6	18	0	0	18	0	0
19	43061448	.	G	A	18	15	33	0	2	35	0	0
19	43062374	.	T	A	12	19	31	0	1	33	1	0
19	43063825	.	C	A	15	12	27	0	3	30	0	0
19	43063846	.	C	T	15	14	29	0	1	30	0	0
19	43065875	.	C	T	16	17	33	0	2	35	0	0
19	43068174	.	C	G	6	12	18	12	0	30	0	0
19	43071307	.	T	C	9	11	20	5	1	26	0	0
19	43072588	.	T	C	23	22	45	0	0	45	0	0
19	43072645	.	G	A	3	21	24	0	19	43	0	0
19	43072663	.	C	T	27	18	45	0	0	45	0	0
19	43074584	.	T	A	25	20	45	0	1	46	0	0
19	43074635	.	C	T	17	28	45	0	1	46	0	0
19	43074668	.	G	T	18	19	37	0	4	41	0	0
19	43074692	.	G	C	22	22	44	0	0	44	0	0
19	43074716	.	G	A	20	15	35	0	1	36	0	0
19	43076458	.	C	T	20	15	35	0	1	36	0	0
19	43083844	.	C	T	20	26	46	0	1	47	0	0
19	43120316	.	C	T	30	27	57	12	0	69	0	0
19	43120471	.	T	C	42	32	74	0	1	75	0	0
19	43121440	.	G	A	25	41	66	5	2	73	0	0
19	43121700	.	G	A	7	3	10	79	0	89	0	0
19	43121736	.	G	A	26	18	44	43	2	89	0	0
19	43121784	.	C	T	34	36	70	0	7	77	0	0
19	43121826	.	T	C	39	45	84	0	3	87	0	0
19	43126014	.	G	A	12	22	34	9	4	47	0	0
19	43126104	.	C	T	7	10	17	36	0	53	0	0
19	43126113	.	C	T	11	9	20	27	0	47	0	0
19	43126140	.	C	T	15	20	35	0	0	35	0	0
19	43129049	.	G	T	2	22	24	0	9	33	0	0
19	43129076	.	A	G	12	22	34	0	1	35	0	0
19	43133087	.	A	G	10	21	31	0	0	31	0	0
19	43225981	.	A	G	1	1	2	0	1	3	0	0
19	43269988	.	G	A	0	4	4	0	3	7	0	0
19	43272257	.	T	C	3	4	7	0	0	7	0	0
19	43272295	.	G	A	2	3	5	0	0	5	0	0
19	43305757	.	G	A	0	3	3	0	1	4	0	0
19	43338088	.	C	G	1	2	3	0	0	3	0	0
19	43341218	.	A	C	2	1	3	0	0	3	0	0
19	43341244	.	A	G	1	0	1	0	4	5	0	0
19	43341271	.	G	C	2	4	6	0	0	6	0	0
19	43341281	.	A	T	1	3	4	0	0	4	0	0
19	43344892	.	T	C	1	3	4	0	0	4	0	0
19	43347289	.	A	C	3	5	8	0	0	8	0	0
19	43347290	.	G	T	3	5	8	0	0	8	0	0
19	43350276	.	T	G	5	4	9	0	0	9	0	0
19	43352555	.	G	T	0	3	3	0	5	8	0	0
19	43491305	.	C	T	6	9	15	0	0	15	0	0
19	43491350	.	A	G	8	9	17	0	1	18	0	0
19	43491739	.	T	A	11	16	27	0	1	28	0	0
19	43491972	.	C	A	9	8	17	0	1	18	0	0
19	43492136	.	G	A	12	11	23	0	0	23	0	0
19	43492175	.	A	G	12	10	22	0	1	23	0	0
19	43492280	.	T	C	11	8	19	0	0	19	0	0
19	43492361	.	G	A	2	10	12	0	7	19	0	0
19	43492363	.	T	A	7	10	17	0	1	18	0	0
19	43492439	.	G	A	9	8	17	0	0	17	0	0
19	43492955	.	T	C	8	14	22	0	1	23	0	0
19	43493300	.	G	A	5	7	12	0	0	12	0	0
19	43493372	.	G	A	6	7	13	0	0	13	0	0
19	43493466	.	T	C	8	5	13	0	0	13	0	0
19	43493514	.	G	A	9	9	18	0	0	18	0	0
19	43494040	.	A	C	9	16	25	0	1	26	0	0
19	43494128	.	G	A	1	9	10	0	11	21	0	0
19	43494452	.	G	T	7	5	12	0	0	12	0	0
19	43494456	.	G	C	5	5	10	0	1	11	0	0
19	43494700	.	C	T	17	12	29	0	0	29	0	0
19	43494911	.	C	T	25	14	39	0	1	40	0	0
19	43495202	.	C	G	13	0	13	0	8	21	0	0
19	43495376	.	G	A	1	18	19	0	13	32	0	0
19	43498940	.	A	G	12	15	27	0	1	28	0	0
19	43499311	.	C	T	12	12	24	0	2	26	0	0
19	43499616	.	T	C	12	15	27	0	0	27	0	0
19	43499930	.	G	T	10	9	19	0	1	20	0	0
19	43499942	.	A	T	9	7	16	0	2	18	0	0
19	43500163	.	C	T	2	2	4	0	0	4	0	0
19	43500216	.	T	C	1	4	5	0	0	5	0	0
19	43534097	.	C	T	2	2	4	0	0	4	0	0
19	43539043	.	T	A	4	2	6	0	0	6	0	0
19	43547605	.	T	C	9	9	18	0	0	18	0	0
19	43547685	.	A	T	6	8	14	0	0	14	0	0
19	43547843	.	T	G	7	3	10	1	0	11	0	0
19	43547876	.	C	A	6	10	16	3	0	20	1	0
19	43547888	.	T	G	10	5	15	3	1	19	0	0
19	43548364	.	T	G	6	6	12	2	0	14	0	0
19	43548910	.	T	A	13	10	23	0	0	23	0	0
19	43549200	.	C	T	3	24	27	0	24	51	0	0
19	43549215	.	T	C	25	19	44	0	2	46	0	0
19	43549305	.	A	G	19	19	38	0	3	41	0	0
19	43549554	.	C	T	16	19	35	0	1	36	0	0
19	43549622	.	A	G	8	12	20	0	0	20	0	0
19	43549860	.	G	T	11	9	20	0	3	23	0	0
19	43552135	.	C	T	6	22	28	1	0	29	0	0
19	43552189	.	C	A	1	6	7	0	23	30	0	0
19	43552223	.	G	C	19	8	27	0	1	28	0	0
19	43675957	.	C	T	6	5	11	0	0	11	0	0
19	43681225	.	C	T	1	3	4	0	0	4	0	0
19	43681270	.	C	T	7	6	13	0	0	13	0	0
19	43681375	.	G	A	7	4	11	0	1	12	0	0
19	43681496	.	G	A	7	5	12	0	0	12	0	0
19	43684392	.	C	A	10	5	15	1	0	16	0	0
19	43684431	.	C	T	8	9	17	1	0	18	0	0
19	43684449	.	G	A	11	9	20	1	0	21	0	0
19	43684513	.	G	A	6	5	11	1	0	12	0	0
19	43686899	.	T	C	4	5	9	0	1	10	0	0
19	43688667	.	G	A	12	5	17	0	0	17	0	0
19	43688727	.	C	T	9	10	19	0	2	21	0	0
19	43690890	.	T	G	14	0	14	0	7	21	0	0
19	43693709	.	C	A	10	11	21	0	0	21	0	0
19	43693915	.	C	T	2	8	10	0	0	10	0	0
19	43696851	.	T	C	11	6	17	1	2	20	0	0
19	43696938	.	G	A	2	10	12	0	15	27	0	0
19	43696953	.	G	A	11	13	24	0	0	24	0	0
19	43697424	.	G	C	7	11	18	0	0	18	0	0
19	43697484	.	T	C	8	9	17	0	0	17	0	0
19	43699765	.	T	A	8	6	14	0	0	14	0	0
19	43704324	.	G	A	13	7	20	1	1	22	0	0
19	43704375	.	C	T	14	4	18	0	0	18	0	0
19	43704744	.	C	T	9	8	17	0	1	18	0	0
19	43706681	.	T	C	9	13	22	0	4	26	0	0
19	43706684	.	C	T	12	13	25	0	0	25	0	0
19	43706736	.	G	A	3	12	15	0	15	30	0	0
19	43706808	.	G	C	9	14	23	1	0	24	0	0
19	43706848	.	T	C	8	13	21	1	0	22	0	0
19	43706909	.	C	G	8	6	14	0	1	15	0	0
19	43706921	.	G	T	8	4	12	0	0	12	0	0
19	43706990	.	A	T	6	4	10	0	0	10	0	0
19	43707228	.	T	G	3	5	8	0	0	8	0	0
19	43725304	.	C	T	1	2	3	0	0	3	0	0
19	43727026	.	C	T	3	4	7	0	0	7	0	0
19	43736765	.	G	A	1	7	8	0	4	12	0	0
19	43737835	.	G	C	2	2	4	0	0	4	0	0
19	43738237	.	C	T	5	7	12	0	0	12	0	0
19	43740988	.	A	C	22	14	36	0	2	38	0	0
19	43748671	.	A	C	25	13	38	0	0	38	0	0
19	43748672	.	G	C	24	13	37	0	1	38	0	0
19	43750020	.	T	C	20	1	21	2	13	36	0	0
19	43750085	.	A	G	20	20	40	0	1	41	0	0
19	43782397	.	G	T	26	34	60	0	4	64	0	0
19	43783581	.	C	T	34	27	61	0	1	62	0	0
19	43825877	.	G	T	19	14	33	0	1	34	0	0
19	43831544	.	G	A	15	22	37	0	0	37	0	0
19	43831701	.	C	T	14	16	30	0	2	32	0	0
19	43878258	.	C	T	10	12	22	0	1	23	0	0
19	43880674	.	C	T	7	6	13	0	0	13	0	0
19	43890059	.	G	A	1	16	17	0	8	25	0	0
19	43890068	.	G	A	3	9	12	0	13	25	0	0
19	43891949	.	C	T	14	21	35	0	0	35	0	0
19	43898915	.	C	A	35	15	50	0	1	51	0	0
19	43899208	.	T	A	7	3	10	0	0	10	0	0
19	43899451	.	A	T	12	15	27	0	3	30	0	0
19	43899721	.	G	T	4	5	9	0	0	9	0	0
19	43899851	.	A	G	6	9	15	0	3	18	0	0
19	43899891	.	G	A	6	7	13	0	0	13	0	0
19	43899936	.	G	A	15	10	25	0	1	26	0	0
19	43900013	.	A	G	9	11	20	0	2	22	0	0
19	43900223	.	A	G	12	7	19	0	0	19	0	0
19	43900453	.	C	A	14	8	22	0	0	22	0	0
19	43900470	.	C	T	8	6	14	0	0	14	0	0
19	43900568	.	G	A	12	4	16	0	0	16	0	0
19	43900585	.	A	T	13	8	21	0	0	21	0	0
19	43900630	.	C	T	11	18	29	0	0	29	0	0
19	43900896	.	C	T	13	13	26	0	2	28	0	0
19	43901107	.	T	C	6	3	9	0	3	12	0	0
19	43901305	.	A	C	9	16	25	0	1	26	0	0
19	43923853	.	G	A	0	2	2	0	2	4	0	0
19	43955061	.	C	T	1	3	4	0	0	4	0	0
19	43971087	.	A	G	10	6	16	0	1	17	0	0
19	43971171	.	T	C	4	10	14	0	1	15	0	0
19	43973986	.	T	G	4	0	4	1	6	11	0	0
19	43974224	.	A	T	17	12	29	1	0	30	0	0
19	43976249	.	G	A	4	12	16	0	0	16	0	0
19	44031100	.	T	C	1	2	3	0	0	3	0	0
19	44036517	.	T	A	4	6	10	0	0	10	0	0
19	44049755	.	G	A	28	15	43	0	1	44	0	0
19	44052585	.	A	C	32	37	69	0	1	70	0	0
19	44052588	.	A	G	38	29	67	0	2	69	0	0
19	44054457	.	C	T	28	24	52	0	7	59	0	0
19	44059793	.	G	C	2	2	4	0	0	4	0	0
19	44062448	.	G	A	2	7	9	0	1	10	0	0
19	44063597	.	A	G	5	6	11	0	1	12	0	0
19	44063620	.	T	C	9	9	18	0	0	18	0	0
19	44063765	.	G	T	7	11	18	0	1	19	0	0
19	44063766	.	T	G	7	12	19	0	0	19	0	0
19	44068272	.	G	A	28	11	39	0	0	39	0	0
19	44068292	.	A	G	29	10	39	0	0	39	0	0
19	44068328	.	G	A	29	15	44	0	0	44	0	0
19	44068378	.	C	A	22	23	45	0	1	46	0	0
19	44068543	.	G	A	26	18	44	0	1	45	0	0
19	44123641	.	C	T	0	4	4	0	1	5	0	0
19	44127509	.	G	A	5	2	7	0	0	7	0	0
19	44129454	.	C	T	1	2	3	0	0	3	0	0
19	44144772	.	A	G	1	3	4	0	0	4	0	0
19	44292885	.	G	A	1	2	3	0	0	3	0	0
19	44308437	.	C	A	1	2	3	0	1	4	0	0
19	44316865	.	C	G	1	2	3	0	0	3	0	0
19	44348411	.	G	A	2	3	5	0	1	6	0	0
19	44348423	.	A	T	2	3	5	0	0	5	0	0
19	44445493	.	G	A	0	2	2	0	1	3	0	0
19	44445502	.	G	T	0	2	2	0	0	2	0	0
19	45856295	.	A	G	10	9	19	0	1	20	0	0
19	45859824	.	C	T	24	17	41	1	5	47	0	0
19	45883626	.	C	A	23	11	34	0	1	35	0	0
19	45962080	.	T	G	3	6	9	0	0	9	0	0
19	45962214	.	G	A	5	7	12	0	0	12	0	0
19	45967297	.	C	G	10	0	10	0	3	13	0	0
19	45967306	.	A	T	9	4	13	0	1	14	0	0
19	45967406	.	G	A	9	10	19	0	2	21	0	0
19	45967516	.	A	G	5	0	5	0	6	11	0	0
19	45970765	.	G	A	7	3	10	0	0	10	0	0
19	45979380	.	C	T	13	5	18	0	0	18	0	0
19	46006240	.	G	A	4	7	11	0	0	11	0	0
19	46007628	.	G	A	2	1	3	0	1	4	0	0
19	46010406	.	C	G	2	2	4	0	1	5	0	0
19	46015031	.	G	A	1	3	4	0	0	4	0	0
19	46017789	.	T	A	1	3	4	0	0	4	0	0
19	46019603	.	G	A	6	6	12	0	1	13	0	0
19	46019616	.	G	T	5	5	10	0	3	13	0	0
19	46019803	.	A	G	15	11	26	0	4	30	0	0
19	46020453	.	C	A	10	15	25	0	0	25	0	0
19	46022453	.	C	T	2	11	13	0	12	25	0	0
19	46032793	.	T	G	6	9	15	0	0	15	0	0
19	46032947	.	A	G	4	5	9	0	0	9	0	0
19	46036046	.	T	A	8	5	13	0	0	13	0	0
19	46036083	.	A	G	5	9	14	0	0	14	0	0
19	46036091	.	A	T	4	10	14	0	1	15	0	0
19	46036290	.	G	A	7	11	18	0	0	18	0	0
19	46038800	.	G	A	11	8	19	0	0	19	0	0
19	46049173	.	G	A	5	7	12	0	0	12	0	0
19	46050672	.	C	T	3	6	9	0	9	18	0	0
19	46122698	.	T	C	2	8	10	0	0	10	0	0
19	46158165	.	A	C	2	2	4	0	0	4	0	0
19	46158179	.	T	A	2	3	5	0	0	5	0	0
19	46192325	.	A	G	2	4	6	0	0	6	0	0
19	46192355	.	T	C	1	2	3	0	1	4	0	0
19	46192394	.	G	A	1	4	5	0	0	5	0	0
19	46202060	.	T	C	8	6	14	0	0	14	0	0
19	46202110	.	G	A	7	5	12	0	1	13	0	0
19	46209433	.	G	A	0	2	2	0	3	5	0	0
19	46209516	.	T	A	3	5	8	0	0	8	0	0
19	46209522	.	A	T	3	5	8	0	0	8	0	0
19	46210054	.	T	G	4	2	6	0	0	6	0	0
19	46210209	.	A	T	2	8	10	0	1	11	0	0
19	46210286	.	A	G	2	6	8	0	0	8	0	0
19	46210354	.	A	T	7	2	9	0	0	9	0	0
19	46210355	.	T	G	7	2	9	0	0	9	0	0
19	46224575	.	G	A	15	10	25	0	1	26	0	0
19	46225960	.	C	T	17	15	32	0	2	34	0	0
19	46225972	.	G	A	16	16	32	0	0	32	0	0
19	46237787	.	C	T	20	13	33	0	1	34	0	0
19	46237794	.	A	T	17	15	32	0	6	38	0	0
19	46237844	.	G	T	0	16	16	0	16	32	0	0
19	46238199	.	G	A	0	10	10	0	4	14	0	0
19	46238227	.	T	C	4	9	13	0	0	13	0	0
19	46238297	.	T	G	3	5	8	0	0	8	0	0
19	46238366	.	T	C	4	5	9	0	0	9	0	0
19	46238382	.	G	A	1	3	4	0	4	8	0	0
19	46259649	.	A	G	29	11	40	0	1	41	0	0
19	46259660	.	A	T	30	13	43	0	3	46	0	0
19	46259709	.	G	A	4	22	26	0	33	59	0	0
19	46280672	.	G	T	3	27	30	0	27	57	0	0
19	46280861	.	G	A	2	13	15	0	26	41	0	0
19	46288632	.	T	C	29	17	46	0	0	46	0	0
19	46303140	.	C	T	26	31	57	0	2	59	0	0
19	46303320	.	G	A	19	16	35	0	1	36	0	0
19	46303330	.	G	A	0	21	21	0	17	38	0	0
19	46303414	.	C	T	26	26	52	0	1	53	0	0
19	46303457	.	A	T	32	23	55	0	3	58	0	0
19	46309596	.	T	C	4	2	6	0	0	6	0	0
19	46309664	.	C	A	9	14	23	0	0	23	0	0
19	46309686	.	A	G	6	1	7	0	6	13	0	0
19	46309787	.	G	A	7	8	15	0	0	15	0	0
19	46322385	.	A	G	9	14	23	0	0	23	0	0
19	46332910	.	G	A	0	12	12	0	8	20	0	0
19	46333761	.	A	C	3	3	6	0	1	7	0	0
19	46373704	.	T	G	14	15	29	0	0	29	0	0
19	46373705	.	G	T	13	15	28	0	0	28	0	0
19	47976325	.	C	T	26	18	44	0	2	46	0	0
19	48060471	.	A	T	0	2	2	0	1	3	0	0
2	374634	.	T	C	3	3	6	0	0	6	0	0
2	1062670	.	G	A	0	4	4	0	6	10	0	0
2	1213162	.	A	G	1	2	3	0	0	3	0	0
2	1220802	.	T	C	12	7	19	0	2	21	0	0
2	1595275	.	T	C	7	10	17	0	0	17	0	0
2	1595897	.	T	C	7	4	11	0	0	11	0	0
2	1596165	.	T	C	12	5	17	0	0	17	0	0
2	1597355	.	T	C	12	3	15	0	0	15	0	0
2	1597617	.	T	C	6	7	13	0	0	13	0	0
2	3028893	.	A	G	9	10	19	0	0	19	0	0
2	3028908	.	A	T	5	7	12	0	0	12	0	0
2	3401100	.	A	C	12	11	23	0	2	25	0	0
2	3569740	.	T	C	6	2	8	0	0	8	0	0
2	4901197	.	T	C	15	4	19	0	3	22	0	0
2	5407110	.	A	G	6	5	11	0	1	12	0	0
2	5407137	.	A	G	4	6	10	0	1	11	0	0
2	5579958	.	A	G	5	0	5	0	7	12	0	0
2	5580017	.	A	G	11	6	17	0	0	17	0	0
2	5580032	.	A	G	13	7	20	0	0	20	0	0
2	5734952	.	T	C	4	2	6	0	2	8	0	0
2	5775963	.	C	A	5	6	11	0	0	11	0	0
2	5810006	.	A	G	4	1	5	0	0	5	0	0
2	5810011	.	T	G	1	2	3	0	0	3	0	0
2	5811966	.	G	C	3	3	6	0	0	6	0	0
2	5811971	.	T	G	3	3	6	0	0	6	0	0
2	5812393	.	T	C	1	2	3	0	0	3	0	0
2	5812817	.	C	T	1	2	3	0	0	3	0	0
2	5813681	.	C	T	2	3	5	0	0	5	0	0
2	5813710	.	C	T	4	5	9	0	0	9	0	0
2	5813913	.	G	A	6	4	10	0	0	10	0	0
2	5814004	.	C	T	4	7	11	0	0	11	0	0
2	5817327	.	T	G	5	5	10	0	0	10	0	0
2	5830336	.	G	A	4	6	10	0	0	10	0	0
2	5843885	.	G	A	9	3	12	0	0	12	0	0
2	5844019	.	T	G	4	6	10	0	0	10	0	0
2	5844113	.	G	A	6	7	13	0	1	14	0	0
2	5844235	.	A	G	5	2	7	0	1	8	0	0
2	5844242	.	T	A	4	2	6	0	1	7	0	0
2	5849062	.	C	G	3	4	7	0	0	7	0	0
2	5852823	.	A	T	5	8	13	0	0	13	0	0
2	5856164	.	A	G	6	12	18	0	1	19	0	0
2	5856206	.	T	C	9	11	20	0	0	20	0	0
2	5856242	.	T	C	8	4	12	0	0	12	0	0
2	5856248	.	A	T	8	4	12	0	0	12	0	0
2	5856326	.	G	T	2	3	5	0	1	6	0	0
2	5856557	.	G	T	0	4	4	0	4	9	1	0
2	5866850	.	T	A	10	8	18	0	0	18	0	0
2	5866977	.	C	T	9	6	15	0	0	15	0	0
2	5866989	.	G	A	7	6	13	0	2	15	0	0
2	5872652	.	C	T	3	9	12	0	0	12	0	0
2	5872950	.	C	T	11	4	15	0	1	16	0	0
2	5880396	.	G	A	5	7	12	0	0	12	0	0
2	5880435	.	T	C	8	5	13	0	0	13	0	0
2	5882398	.	A	T	7	4	11	0	2	13	0	0
2	5882793	.	A	C	4	8	12	0	0	12	0	0
2	5882799	.	A	G	8	0	8	0	4	12	0	0
2	5883198	.	G	A	12	15	27	0	0	27	0	0
2	5883558	.	A	T	3	6	9	0	0	9	0	0
2	5883649	.	A	C	1	4	5	0	0	5	0	0
2	5884127	.	A	C	6	6	12	0	0	12	0	0
2	5884322	.	C	T	5	7	12	0	0	12	0	0
2	5884355	.	A	G	6	8	14	0	0	14	0	0
2	5887849	.	C	G	10	4	14	0	1	15	0	0
2	5898946	.	C	T	4	7	11	0	0	11	0	0
2	5898955	.	C	T	3	8	11	0	0	11	0	0
2	5901291	.	G	A	5	6	11	0	0	11	0	0
2	5901471	.	C	T	5	4	9	0	0	9	0	0
2	5909405	.	C	T	4	6	10	0	0	10	0	0
2	5909435	.	C	T	6	8	14	0	0	14	0	0
2	5912062	.	A	G	6	7	13	0	0	13	0	0
2	5912257	.	G	A	9	4	13	0	1	14	0	0
2	5912288	.	C	G	12	0	12	0	6	18	0	0
2	5919314	.	C	T	6	11	17	0	0	17	0	0
2	5921661	.	C	T	10	5	15	0	0	15	0	0
2	5923178	.	G	C	1	7	8	0	11	19	0	0
2	5923438	.	G	A	11	10	21	0	0	21	0	0
2	5923517	.	G	A	3	10	13	0	1	14	0	0
2	5923679	.	G	A	9	4	13	0	0	13	0	0
2	5923728	.	T	A	2	4	6	0	0	6	0	0
2	5923762	.	C	T	4	5	9	0	1	10	0	0
2	5923863	.	C	T	6	8	14	0	0	14	0	0
2	5923890	.	T	A	7	5	12	0	0	12	0	0
2	5923943	.	C	T	9	6	15	0	1	16	0	0
2	5924085	.	A	T	6	2	8	0	0	8	0	0
2	5932656	.	T	A	1	5	6	0	0	6	0	0
2	5933999	.	C	A	0	3	3	0	12	15	0	0
2	5934000	.	G	A	11	3	14	0	1	15	0	0
2	5934195	.	A	T	4	5	9	0	0	9	0	0
2	5934804	.	T	G	6	6	12	0	2	15	1	0
2	5935097	.	A	G	10	7	17	0	0	17	0	0
2	5935132	.	C	T	11	9	20	0	0	20	0	0
2	5935137	.	A	G	11	7	18	0	0	18	0	0
2	5935222	.	C	T	0	15	15	0	13	28	0	0
2	5935223	.	G	T	13	15	28	0	0	28	0	0
2	5935294	.	G	A	9	7	16	1	1	18	0	0
2	5935341	.	T	C	2	1	3	1	6	10	0	0
2	5935364	.	A	C	3	9	12	0	0	12	0	0
2	5935425	.	C	T	1	3	4	1	0	5	0	0
2	5935434	.	A	G	2	1	3	1	1	5	0	0
2	5935861	.	G	T	3	5	8	0	0	8	0	0
2	5936035	.	T	C	5	12	17	0	0	17	0	0
2	5936038	.	A	G	5	10	15	0	0	15	0	0
2	5936153	.	C	A	0	5	5	0	10	15	0	0
2	5936180	.	A	G	6	7	13	0	0	13	0	0
2	5936228	.	G	A	2	4	6	0	0	6	0	0
2	5936248	.	A	C	1	5	6	0	0	6	0	0
2	5936303	.	A	G	2	6	8	0	0	8	0	0
2	5936377	.	G	A	5	3	8	0	0	8	0	0
2	5936380	.	C	T	5	3	8	0	0	8	0	0
2	5936678	.	T	A	11	5	16	0	3	19	0	0
2	5936856	.	C	A	9	6	15	0	1	16	0	0
2	5937020	.	C	T	2	9	11	0	1	12	0	0
2	5937035	.	G	A	2	12	14	0	1	15	0	0
2	5937079	.	T	G	5	10	15	0	0	15	0	0
2	6005568	.	T	G	3	3	6	0	0	6	0	0
2	6011531	.	G	A	11	6	17	0	1	18	0	0
2	6026265	.	A	G	4	3	7	0	0	7	0	0
2	6029769	.	T	A	5	3	8	0	1	9	0	0
2	6033874	.	G	A	4	1	5	0	1	6	0	0
2	6037004	.	C	A	3	5	8	0	0	8	0	0
2	6039644	.	C	T	6	10	16	0	1	17	0	0
2	6039678	.	T	C	4	10	14	0	0	14	0	0
2	6042195	.	T	C	12	6	18	0	0	18	0	0
2	6052066	.	T	C	4	1	5	0	3	8	0	0
2	6052179	.	A	T	8	3	11	0	0	11	0	0
2	6052295	.	A	T	2	3	5	0	0	5	0	0
2	6052932	.	G	A	8	5	13	0	0	13	0	0
2	6054935	.	A	G	3	7	10	0	0	10	0	0
2	6058633	.	G	A	2	6	8	0	1	9	0	0
2	6073604	.	A	T	3	2	5	0	0	5	0	0
2	6073939	.	A	T	2	2	4	0	0	4	0	0
2	6082748	.	T	C	6	5	11	0	1	12	0	0
2	6082752	.	A	C	6	6	12	0	0	12	0	0
2	6089471	.	T	C	9	4	13	0	0	13	0	0
2	6091653	.	A	G	6	2	8	2	0	10	0	0
2	6091689	.	G	A	0	5	5	0	3	8	0	0
2	6091876	.	A	T	1	3	4	0	0	4	0	0
2	6106727	.	T	C	3	1	4	0	2	6	0	0
2	6106742	.	G	A	5	5	10	0	0	10	0	0
2	6107289	.	G	A	15	20	35	2	0	37	0	0
2	6107310	.	A	T	11	19	30	2	0	32	0	0
2	6126753	.	T	A	15	17	32	0	0	32	0	0
2	6126783	.	A	T	10	19	29	1	1	31	0	0
2	6126857	.	T	C	13	12	25	0	0	25	0	0
2	6143912	.	T	C	18	13	31	0	4	35	0	0
2	6144085	.	G	A	2	15	17	0	17	34	0	0
2	6149006	.	T	C	11	6	17	0	2	19	0	0
2	6149220	.	T	G	2	3	5	0	0	5	0	0
2	6167087	.	C	T	2	2	4	0	0	4	0	0
2	6167088	.	A	C	2	2	4	0	0	4	0	0
2	6186956	.	T	A	14	10	24	0	0	24	0	0
2	6187031	.	G	T	14	15	29	0	0	29	0	0
2	6187138	.	T	C	18	15	33	0	1	34	0	0
2	6191691	.	T	C	17	13	30	0	3	33	0	0
2	6191829	.	C	T	6	19	25	0	2	27	0	0
2	6194151	.	T	C	7	8	15	0	7	22	0	0
2	6196798	.	T	A	7	14	21	0	1	22	0	0
2	6196804	.	A	G	7	0	7	0	14	21	0	0
2	6196858	.	C	A	11	6	17	0	0	17	0	0
2	6197216	.	G	T	15	7	22	0	0	22	0	0
2	6197249	.	G	A	13	5	18	0	0	18	0	0
2	6258129	.	G	T	1	2	3	0	0	3	0	0
2	6265929	.	C	A	19	18	37	0	0	37	0	0
2	6266115	.	T	A	14	12	26	0	0	26	0	0
2	6292405	.	T	G	19	21	40	0	0	40	0	0
2	6292416	.	G	C	23	20	43	0	0	43	0	0
2	6292453	.	G	T	20	27	47	0	0	47	0	0
2	6323084	.	C	T	0	5	5	0	5	10	0	0
2	6326226	.	C	T	0	2	2	0	3	5	0	0
2	6338835	.	A	T	1	5	6	0	0	6	0	0
2	6338865	.	C	T	2	3	5	0	0	5	0	0
2	6342572	.	G	A	2	3	5	0	0	5	0	0
2	6356072	.	C	T	1	3	4	0	0	4	0	0
2	6358003	.	T	C	2	2	4	0	0	4	0	0
2	6373790	.	T	A	1	3	4	0	0	4	0	0
2	6373811	.	T	C	2	2	4	0	0	4	0	0
2	6734267	.	A	G	2	3	5	0	0	5	0	0
2	6734356	.	C	A	4	3	7	0	0	7	0	0
2	6734490	.	G	A	2	6	8	0	1	9	0	0
2	6761213	.	C	G	4	6	10	0	0	10	0	0
2	6790185	.	C	T	4	2	6	0	0	6	0	0
2	6805112	.	G	A	5	6	11	0	0	11	0	0
2	6886758	.	T	G	8	0	8	0	9	17	0	0
2	6886837	.	G	A	0	6	6	0	13	19	0	0
2	6888679	.	G	A	5	11	16	0	0	16	0	0
2	6926482	.	A	G	9	4	13	0	1	14	0	0
2	6926573	.	C	T	5	8	13	0	0	13	0	0
2	6926619	.	C	A	11	6	17	0	1	18	0	0
2	6931552	.	A	G	7	13	20	0	1	21	0	0
2	6941439	.	C	T	8	6	14	0	1	15	0	0
2	6941440	.	G	A	0	7	7	0	8	15	0	0
2	6948707	.	C	T	10	12	22	0	1	23	0	0
2	6948717	.	T	C	16	9	25	0	1	26	0	0
2	6952460	.	G	A	3	6	9	0	7	16	0	0
2	6952596	.	C	T	8	5	13	0	0	13	0	0
2	6952610	.	A	C	7	4	11	0	0	11	0	0
2	6952707	.	A	G	3	5	8	0	0	8	0	0
2	6952740	.	C	A	2	4	6	0	0	6	0	0
2	6958671	.	A	T	14	12	26	0	0	26	0	0
2	6958677	.	A	T	13	12	25	0	0	25	0	0
2	6958712	.	T	A	9	12	21	0	0	21	0	0
2	6958940	.	C	A	15	4	19	0	0	19	0	0
2	7037580	.	C	T	7	5	12	0	1	13	0	0
2	7039765	.	C	A	6	10	16	0	1	17	0	0
2	7040053	.	A	T	3	6	9	0	1	10	0	0
2	7040253	.	C	T	9	9	18	0	1	19	0	0
2	7042165	.	C	T	9	9	18	0	0	18	0	0
2	7046777	.	C	T	9	6	15	0	1	16	0	0
2	7051164	.	G	A	1	19	20	1	8	29	0	0
2	7056102	.	G	A	15	14	29	0	0	29	0	0
2	7056359	.	G	T	5	11	16	0	0	16	0	0
2	7056417	.	C	T	3	4	7	0	1	8	0	0
2	7056604	.	A	G	8	0	8	0	10	18	0	0
2	7056610	.	A	G	9	10	19	0	0	19	0	0
2	7056711	.	T	G	8	11	19	0	0	19	0	0
2	7056761	.	G	A	0	7	7	0	13	20	0	0
2	7056763	.	G	A	0	7	7	0	13	20	0	0
2	7057010	.	T	C	5	12	17	0	1	18	0	0
2	7134386	.	T	C	2	2	4	0	0	4	0	0
2	7150075	.	G	T	6	4	10	0	0	10	0	0
2	7150571	.	C	G	13	7	20	0	2	22	0	0
2	7150573	.	A	G	12	7	19	0	2	21	0	0
2	7150790	.	G	C	8	0	8	0	7	15	0	0
2	7150908	.	C	G	7	9	16	0	0	16	0	0
2	7150950	.	A	T	7	7	14	0	1	15	0	0
2	7150995	.	T	A	3	2	5	0	0	5	0	0
2	7150997	.	T	G	2	2	4	0	0	4	0	0
2	7151148	.	A	G	2	3	5	0	0	5	0	0
2	7151161	.	A	T	3	3	6	0	2	8	0	0
2	7151197	.	C	T	3	6	9	0	4	13	0	0
2	7151392	.	C	A	1	8	9	0	16	25	0	0
2	7151485	.	A	T	9	8	17	0	0	17	0	0
2	7151613	.	A	G	7	4	11	0	0	11	0	0
2	7151647	.	C	G	4	4	8	0	0	8	0	0
2	7151667	.	C	G	4	4	8	0	0	8	0	0
2	7151682	.	C	A	4	4	8	0	0	8	0	0
2	7151843	.	C	A	0	6	6	0	8	14	0	0
2	7152196	.	T	A	5	12	17	0	0	17	0	0
2	7152263	.	G	A	10	7	17	0	3	20	0	0
2	7152268	.	T	C	13	8	21	0	0	21	0	0
2	7152326	.	G	A	10	7	17	0	0	17	0	0
2	7152350	.	C	A	0	6	6	0	7	13	0	0
2	7152409	.	T	C	5	8	13	1	0	14	0	0
2	7152431	.	T	C	3	9	12	0	1	13	0	0
2	7152469	.	G	T	3	10	13	0	1	14	0	0
2	7152518	.	A	G	1	8	9	0	0	9	0	0
2	7152520	.	C	G	1	8	9	0	0	9	0	0
2	7152681	.	C	A	3	5	8	0	0	8	0	0
2	7152762	.	T	C	2	5	7	0	0	7	0	0
2	7152774	.	T	C	3	4	7	0	0	7	0	0
2	7153293	.	A	T	4	4	8	0	0	8	0	0
2	7153829	.	T	A	2	6	8	0	0	8	0	0
2	7153861	.	T	C	4	5	9	0	0	9	0	0
2	7153868	.	T	C	3	0	3	0	7	10	0	0
2	7154295	.	C	T	0	2	2	0	2	4	0	0
2	7154297	.	A	G	2	2	4	0	0	4	0	0
2	7163378	.	G	A	11	5	16	0	1	17	0	0
2	7168167	.	G	A	9	8	17	0	0	17	0	0
2	7168179	.	T	A	6	10	16	0	0	16	0	0
2	7168762	.	G	A	7	10	17	0	0	17	0	0
2	7171493	.	G	C	9	0	9	0	4	13	0	0
2	7179325	.	C	T	1	2	3	0	4	7	0	0
2	7184903	.	C	T	1	7	8	0	3	11	0	0
2	7185054	.	G	A	4	6	10	0	0	10	0	0
2	7185277	.	A	C	2	0	2	0	1	3	0	0
2	7185281	.	T	G	1	1	2	0	1	3	0	0
2	7239047	.	C	T	7	4	11	0	0	11	0	0
2	7239079	.	T	C	6	5	11	0	1	12	0	0
2	7239308	.	G	A	11	3	14	0	0	14	0	0
2	7239505	.	T	C	10	9	19	0	0	19	0	0
2	7239812	.	G	A	10	7	17	0	0	17	0	0
2	7239816	.	C	T	10	7	17	0	0	17	0	0
2	7239919	.	A	T	7	4	11	0	2	13	0	0
2	7240378	.	G	A	4	3	7	0	1	8	0	0
2	7240484	.	A	C	4	3	7	0	0	7	0	0
2	7240865	.	C	T	0	3	3	0	6	9	0	0
2	7241356	.	T	G	4	5	9	0	0	9	0	0
2	7241358	.	T	G	4	4	8	0	1	9	0	0
2	7241649	.	C	T	14	7	21	0	3	24	0	0
2	7241704	.	G	C	8	8	16	0	0	16	0	0
2	7241962	.	G	A	11	8	19	0	0	19	0	0
2	7241980	.	T	A	13	7	20	0	0	20	0	0
2	7422927	.	C	T	1	2	3	0	6	9	0	0
2	7423098	.	T	C	3	4	7	0	0	7	0	0
2	7423129	.	T	C	1	3	4	0	1	5	0	0
2	7423142	.	T	C	1	0	1	0	5	6	0	0
2	7602133	.	T	G	9	5	14	0	1	15	0	0
2	7602149	.	A	G	8	5	13	0	1	14	0	0
2	7604906	.	G	A	2	5	7	1	0	8	0	0
2	7720800	.	C	T	16	28	44	0	2	46	0	0
2	7720836	.	T	C	13	27	40	0	3	43	0	0
2	7720879	.	C	A	20	26	46	0	2	48	0	0
2	7726414	.	T	A	22	19	41	1	1	43	0	0
2	7726924	.	T	A	16	13	29	0	1	30	0	0
2	7768293	.	G	A	0	3	3	2	2	7	0	0
2	7991728	.	C	A	11	12	23	0	0	23	0	0
2	8062447	.	A	G	6	3	9	0	0	9	0	0
2	8064838	.	G	A	6	3	9	0	0	9	0	0
2	8065311	.	C	T	1	5	6	0	1	7	0	0
2	8066897	.	C	T	0	3	3	0	2	5	0	0
2	8113705	.	T	C	19	18	37	0	0	37	0	0
2	8113819	.	A	G	27	13	40	0	2	42	0	0
2	8114005	.	G	T	2	17	19	0	15	34	0	0
2	8114179	.	T	C	18	9	27	0	1	28	0	0
2	8840131	.	G	C	2	8	10	0	0	10	0	0
2	10149883	.	C	G	18	0	18	0	18	42	6	0
2	10881278	.	G	A	0	2	2	0	1	3	0	0
2	11216824	.	A	G	4	2	6	0	0	6	0	0
2	11216842	.	C	A	3	4	7	0	0	7	0	0
2	11231959	.	G	A	4	2	6	0	0	6	0	0
2	11490393	.	A	G	7	5	12	0	0	12	0	0
2	11503623	.	C	T	2	2	4	0	0	4	0	0
2	11508771	.	A	G	6	8	14	0	0	14	0	0
2	11509517	.	T	C	27	1	28	0	25	53	0	0
2	11512254	.	C	T	19	22	41	0	1	42	0	0
2	11633304	.	G	C	3	3	6	0	0	6	0	0
2	11633431	.	G	A	7	5	12	0	0	12	0	0
2	11640026	.	C	T	10	15	25	0	0	25	0	0
2	11640104	.	A	T	10	13	23	0	0	23	0	0
2	11643077	.	C	T	14	7	21	0	0	21	0	0
2	11643084	.	C	G	7	13	20	0	0	20	0	0
2	11648332	.	C	T	11	10	21	0	1	22	0	0
2	11648698	.	C	T	2	2	4	0	0	4	0	0
2	11651573	.	A	T	5	6	11	0	0	11	0	0
2	11654370	.	G	A	13	13	26	0	3	29	0	0
2	11656775	.	A	G	22	11	33	0	2	35	0	0
2	11661234	.	G	A	9	14	23	0	1	24	0	0
2	11661287	.	C	T	0	15	15	0	5	20	0	0
2	11662621	.	A	C	21	15	36	1	2	39	0	0
2	11685900	.	C	T	1	2	3	0	0	3	0	0
2	11776060	.	A	G	1	0	1	0	2	3	0	0
2	11792804	.	G	A	2	1	3	0	1	4	0	0
2	11813660	.	T	C	1	2	3	0	0	3	0	0
2	11813880	.	C	T	2	2	4	0	0	4	0	0
2	11831218	.	G	A	2	2	4	0	0	4	0	0
2	11831253	.	G	A	0	2	2	0	2	4	0	0
2	11831421	.	C	T	2	3	5	0	0	5	0	0
2	11926016	.	C	T	5	3	8	0	0	8	0	0
2	11926261	.	A	G	6	0	6	0	4	10	0	0
2	11926447	.	C	G	8	1	9	0	3	12	0	0
2	11929900	.	G	A	0	6	6	0	3	9	0	0
2	11930007	.	A	G	6	6	12	0	0	12	0	0
2	11930012	.	T	C	6	3	9	0	0	9	0	0
2	11930494	.	G	A	5	3	8	0	1	9	0	0
2	11936125	.	T	C	3	3	6	0	0	6	0	0
2	11939719	.	T	G	4	5	9	0	1	10	0	0
2	11945171	.	T	C	6	2	8	0	0	8	0	0
2	11945329	.	G	C	3	6	9	0	0	9	0	0
2	11945334	.	G	C	2	6	8	0	1	9	0	0
2	11945679	.	T	A	1	2	3	0	0	3	0	0
2	11945680	.	T	C	1	2	3	0	0	3	0	0
2	11945823	.	T	C	2	2	4	0	0	4	0	0
2	11960471	.	C	T	2	9	11	0	1	12	0	0
2	11965241	.	C	T	9	10	19	0	2	21	0	0
2	11969431	.	A	G	12	11	23	0	0	23	0	0
2	11970199	.	C	T	9	6	15	0	0	15	0	0
2	11976487	.	A	T	2	10	12	0	0	12	0	0
2	11976563	.	C	T	0	3	3	0	7	10	0	0
2	11976603	.	T	C	6	0	6	0	6	12	0	0
2	11976741	.	C	T	1	3	4	0	9	13	0	0
2	11976896	.	T	G	5	13	18	0	0	18	0	0
2	11977104	.	C	T	1	5	6	0	9	15	0	0
2	11977495	.	A	G	5	6	11	0	1	12	0	0
2	11978032	.	T	A	8	7	15	0	0	15	0	0
2	11978137	.	T	A	11	4	15	0	0	15	0	0
2	11978296	.	G	A	6	2	8	0	2	10	0	0
2	11978342	.	A	G	8	5	13	0	0	13	0	0
2	11980710	.	C	A	0	3	3	0	5	8	0	0
2	11981009	.	G	C	6	11	17	0	0	17	0	0
2	11998037	.	C	T	9	13	22	0	2	24	0	0
2	11998058	.	T	C	13	15	28	0	0	28	0	0
2	12002697	.	A	T	3	6	9	0	0	9	0	0
2	12002766	.	A	G	4	6	10	0	0	10	0	0
2	12002797	.	A	G	5	4	9	0	1	10	0	0
2	12002885	.	T	C	1	3	4	0	0	4	0	0
2	12002899	.	T	G	1	4	5	0	0	5	0	0
2	12002945	.	A	T	3	5	8	0	0	8	0	0
2	12002950	.	T	C	3	4	7	0	0	7	0	0
2	12002993	.	C	G	3	6	9	0	1	10	0	0
2	12104948	.	T	A	7	17	24	0	0	24	0	0
2	12104949	.	C	T	8	16	24	0	0	24	0	0
2	12105078	.	A	T	11	9	20	0	1	21	0	0
2	12130837	.	G	A	7	8	15	0	0	15	0	0
2	12130846	.	A	G	5	9	14	0	2	16	0	0
2	12155797	.	A	G	3	5	8	0	0	8	0	0
2	12155851	.	C	T	0	6	6	0	3	9	0	0
2	12155860	.	A	C	3	7	10	0	0	10	0	0
2	12155959	.	A	C	5	4	9	0	0	9	0	0
2	12242171	.	G	A	4	8	12	0	0	12	0	0
2	12242818	.	G	T	14	8	22	0	0	22	0	0
2	12279540	.	T	C	1	4	5	0	1	6	0	0
2	12307980	.	C	T	2	2	4	0	0	4	0	0
2	12379872	.	C	T	13	20	33	1	2	36	0	0
2	12405310	.	G	A	4	12	16	0	16	32	0	0
2	12406260	.	C	T	11	15	26	0	0	26	0	0
2	12406490	.	A	G	17	20	37	0	1	38	0	0
2	12407113	.	C	G	13	10	23	0	1	24	0	0
2	12407205	.	T	C	17	0	17	0	23	40	0	0
2	12407586	.	G	T	18	14	32	0	2	34	0	0
2	12407610	.	G	A	20	16	36	0	1	37	0	0
2	12407799	.	C	T	21	14	35	0	1	36	0	0
2	12408085	.	G	A	28	17	45	1	1	47	0	0
2	12420413	.	T	A	24	14	38	0	1	39	0	0
2	12425370	.	G	A	12	19	31	0	2	34	1	0
2	12429868	.	G	A	11	23	34	0	0	34	0	0
2	12436163	.	A	G	16	19	35	0	0	35	0	0
2	12436202	.	G	A	19	19	38	0	1	39	0	0
2	12481342	.	G	A	20	13	33	0	0	33	0	0
2	12481522	.	A	G	17	16	33	0	3	36	0	0
2	12481528	.	A	G	20	14	34	0	0	34	0	0
2	12496522	.	G	C	17	15	32	0	1	33	0	0
2	12502394	.	G	A	17	15	32	0	0	32	0	0
2	12898063	.	C	G	4	2	6	0	0	6	0	0
2	12902335	.	C	T	1	2	3	0	0	3	0	0
2	12935519	.	G	A	0	2	2	0	1	3	0	0
2	12939462	.	G	A	2	2	4	0	1	5	0	0
2	12973165	.	G	T	0	5	5	0	5	10	0	0
2	12973201	.	T	G	4	3	7	0	0	7	0	0
2	12982009	.	G	A	5	5	10	0	0	10	0	0
2	12992534	.	T	G	3	7	10	0	0	10	0	0
2	12998961	.	T	A	4	4	8	0	0	8	0	0
2	12999296	.	T	C	4	4	8	0	1	9	0	0
2	13000291	.	A	G	7	0	7	0	8	15	0	0
2	13000418	.	G	A	2	7	9	0	1	10	0	0
2	13001219	.	A	C	4	4	8	0	0	8	0	0
2	13001291	.	C	A	2	7	9	0	0	9	0	0
2	13003417	.	A	C	4	6	10	0	1	11	0	0
2	13003810	.	G	A	7	7	14	0	1	15	0	0
2	13006973	.	A	G	8	0	8	0	6	14	0	0
2	13007141	.	T	A	3	5	8	0	0	8	0	0
2	13007360	.	G	A	7	5	12	0	0	12	0	0
2	13010202	.	A	G	8	4	12	0	0	12	0	0
2	13011555	.	G	T	0	12	12	0	4	16	0	0
2	13018408	.	T	C	10	10	20	0	1	21	0	0
2	13019956	.	A	T	10	7	17	0	0	17	0	0
2	13020122	.	T	A	8	8	16	0	1	17	0	0
2	13020264	.	C	A	10	9	19	0	1	20	0	0
2	13020284	.	G	C	2	8	10	0	8	18	0	0
2	13020611	.	C	A	6	8	14	0	1	15	0	0
2	13023068	.	C	A	10	11	21	0	0	21	0	0
2	13026080	.	G	A	1	16	17	0	9	26	0	0
2	13035847	.	T	A	12	12	24	0	0	24	0	0
2	13036009	.	T	C	15	4	19	0	0	19	0	0
2	13036769	.	T	C	11	12	23	0	1	24	0	0
2	13036951	.	A	T	18	11	29	0	2	31	0	0
2	13037124	.	T	C	4	12	16	0	1	17	0	0
2	13185332	.	T	G	6	7	13	0	0	13	0	0
2	13186237	.	A	T	3	4	7	0	0	7	0	0
2	13186333	.	G	T	19	6	25	0	1	26	0	0
2	13186504	.	C	T	16	19	35	0	1	36	0	0
2	13186521	.	T	C	18	18	36	0	1	37	0	0
2	13186986	.	C	T	21	10	31	0	2	33	0	0
2	13187154	.	A	G	20	7	27	0	0	27	0	0
2	13187210	.	T	G	19	22	41	0	2	43	0	0
2	13187263	.	C	A	26	14	40	0	1	41	0	0
2	13187332	.	G	T	15	19	34	0	5	39	0	0
2	13187386	.	T	G	15	19	34	0	6	40	0	0
2	13187507	.	G	A	21	12	33	0	0	33	0	0
2	13187534	.	A	C	25	12	37	0	0	38	1	0
2	13187749	.	T	A	8	4	12	0	0	12	0	0
2	13187781	.	T	C	5	7	12	0	0	12	0	0
2	13187860	.	T	G	9	6	15	0	1	16	0	0
2	13187868	.	G	A	8	7	15	0	2	17	0	0
2	13187905	.	G	A	15	9	24	0	0	24	0	0
2	13187944	.	G	A	19	13	32	0	0	32	0	0
2	13187958	.	C	A	21	16	37	0	1	38	0	0
2	13188073	.	A	T	19	21	40	0	0	40	0	0
2	13215694	.	C	A	26	16	42	0	0	42	0	0
2	13215795	.	G	T	15	18	33	0	0	33	0	0
2	13215870	.	A	G	8	12	20	0	1	21	0	0
2	13223925	.	A	G	9	10	19	0	0	19	0	0
2	13224274	.	C	T	6	6	12	0	0	12	0	0
2	13224697	.	G	A	8	7	15	0	0	15	0	0
2	13224702	.	T	C	9	6	15	0	0	15	0	0
2	13224981	.	A	G	8	4	12	0	1	13	0	0
2	13225073	.	A	C	8	4	12	0	0	12	0	0
2	13237699	.	A	G	9	9	18	0	0	18	0	0
2	13242171	.	G	A	8	7	15	0	1	16	0	0
2	13254542	.	A	G	3	10	13	0	1	14	0	0
2	13254625	.	C	T	6	2	8	0	1	9	0	0
2	13254670	.	T	C	5	0	5	0	4	9	0	0
2	13256795	.	G	C	9	7	16	0	0	16	0	0
2	13259024	.	C	T	7	5	12	0	1	13	0	0
2	13259120	.	G	T	5	3	8	0	0	8	0	0
2	13691538	.	G	A	2	2	4	0	0	4	0	0
2	13694984	.	C	T	7	9	16	0	0	16	0	0
2	13710826	.	T	C	11	11	22	0	0	22	0	0
2	13717388	.	C	T	7	18	25	0	0	25	0	0
2	13717651	.	A	G	5	2	7	0	0	7	0	0
2	13719652	.	G	A	0	2	2	0	1	3	0	0
2	13722252	.	G	T	1	2	3	0	0	3	0	0
2	13743370	.	G	T	3	4	7	0	0	7	0	0
2	13743776	.	C	T	7	5	12	0	0	12	0	0
2	13743907	.	A	T	3	3	6	0	1	7	0	0
2	13744343	.	A	G	5	4	9	0	1	10	0	0
2	13773911	.	G	C	8	7	15	0	0	15	0	0
2	13800275	.	G	C	8	3	11	0	0	11	0	0
2	13907459	.	G	C	3	3	6	0	0	6	0	0
2	14278412	.	A	C	12	12	24	0	1	25	0	0
2	14278828	.	A	C	7	0	7	0	6	13	0	0
2	14366676	.	T	A	14	15	29	0	0	29	0	0
2	14366886	.	G	C	22	1	23	0	13	36	0	0
2	14445697	.	T	C	3	5	8	0	0	8	0	0
2	14447196	.	G	A	5	4	9	0	0	9	0	0
2	14454087	.	G	A	2	4	6	0	0	6	0	0
2	14456081	.	C	T	0	5	5	0	3	8	0	0
2	14464794	.	T	C	2	0	2	0	7	9	0	0
2	14587127	.	T	C	2	0	2	0	3	5	0	0
2	14587157	.	T	C	1	4	5	0	0	5	0	0
2	14655666	.	G	T	2	2	4	0	0	4	0	0
2	14792918	.	G	A	1	2	3	0	0	3	0	0
2	15039468	.	G	A	2	2	4	0	0	4	0	0
2	15048490	.	C	G	1	1	2	0	0	2	0	0
2	15048500	.	C	T	1	2	3	0	0	3	0	0
2	15069288	.	G	A	0	3	3	0	2	5	0	0
2	15074491	.	C	T	2	3	5	0	2	7	0	0
2	15074672	.	T	C	2	3	5	0	0	5	0	0
2	15075015	.	A	G	1	3	4	0	0	4	0	0
2	15075134	.	G	A	0	2	2	0	2	4	0	0
2	15106502	.	T	A	1	2	3	0	0	3	0	0
2	15106517	.	A	C	2	2	4	0	0	4	0	0
2	15106653	.	T	C	1	2	3	0	0	3	0	0
2	15106678	.	A	G	1	0	1	0	3	4	0	0
2	15109704	.	T	C	4	5	9	0	0	9	0	0
2	15110014	.	T	C	5	7	12	0	0	12	0	0
2	15111806	.	C	T	0	4	4	0	7	11	0	0
2	15111948	.	C	T	7	3	10	0	0	11	1	0
2	15114286	.	C	T	1	7	8	0	5	13	0	0
2	15116120	.	A	T	6	4	10	0	0	10	0	0
2	15116355	.	T	C	4	2	6	0	0	6	0	0
2	15116356	.	C	T	4	2	6	0	0	6	0	0
2	15119619	.	A	G	3	5	8	0	0	8	0	0
2	15125087	.	A	C	5	2	7	0	0	7	0	0
2	15344036	.	A	C	6	0	6	0	4	10	0	0
2	15344081	.	A	G	7	6	13	0	0	13	0	0
2	15344120	.	A	G	5	4	9	0	0	9	0	0
2	15344210	.	C	A	0	4	4	0	8	12	0	0
2	15347268	.	A	G	3	3	6	0	1	7	0	0
2	15391586	.	T	A	0	1	1	0	2	3	0	0
2	15391590	.	T	G	1	2	3	0	0	3	0	0
2	15790060	.	A	G	4	4	8	0	2	10	0	0
2	15790135	.	T	G	5	2	7	0	0	7	0	0
2	15864127	.	C	T	7	9	16	0	0	16	0	0
2	15864349	.	G	A	1	6	7	0	2	9	0	0
2	15864382	.	A	C	4	5	9	0	1	10	0	0
2	15864466	.	C	T	6	4	10	0	1	11	0	0
2	15900093	.	G	A	1	3	4	0	8	12	0	0
2	15942458	.	G	T	9	13	22	0	0	22	0	0
2	15942636	.	A	G	7	4	11	0	0	11	0	0
2	15942877	.	C	T	9	7	16	0	0	16	0	0
2	15942964	.	T	C	4	4	8	0	1	9	0	0
2	16161231	.	T	A	2	13	15	0	0	15	0	0
2	16172089	.	T	C	1	5	6	0	0	6	0	0
2	16174243	.	A	G	1	0	1	0	8	9	0	0
2	16174314	.	G	C	7	4	11	0	0	11	0	0
2	16174346	.	T	C	5	5	10	0	0	10	0	0
2	16176276	.	A	G	7	7	14	0	1	15	0	0
2	16176308	.	G	A	8	9	17	0	0	17	0	0
2	16177521	.	A	G	12	11	23	0	1	24	0	0
2	16177590	.	C	G	9	6	15	0	0	15	0	0
2	16191697	.	G	C	0	15	15	0	15	30	0	0
2	16191748	.	A	G	5	14	19	0	6	25	0	0
2	16191841	.	A	C	12	11	23	0	0	23	0	0
2	16194018	.	A	G	7	1	8	0	4	12	0	0
2	16194019	.	T	C	7	4	11	0	1	12	0	0
2	16198932	.	A	G	17	11	28	0	1	29	0	0
2	16199331	.	A	G	29	24	53	0	1	54	0	0
2	16199332	.	G	A	28	23	51	0	2	53	0	0
2	16199411	.	C	T	3	23	26	0	30	56	0	0
2	16204689	.	T	G	35	22	57	0	2	59	0	0
2	16204716	.	C	G	3	27	30	0	24	54	0	0
2	16206766	.	G	T	25	26	51	0	1	52	0	0
2	16207346	.	T	C	17	18	35	0	1	36	0	0
2	16209406	.	T	C	24	14	38	0	0	38	0	0
2	16209753	.	G	A	26	19	45	0	4	49	0	0
2	16212643	.	G	A	8	8	16	0	1	17	0	0
2	16212924	.	A	G	17	11	28	0	1	29	0	0
2	16212957	.	A	G	19	16	35	0	0	35	0	0
2	16216365	.	T	C	11	0	11	0	5	16	0	0
2	16216524	.	A	T	13	6	19	0	0	19	0	0
2	16216830	.	G	T	14	10	24	0	2	26	0	0
2	16221213	.	T	C	11	1	12	0	11	23	0	0
2	16254439	.	T	G	8	9	17	0	1	18	0	0
2	16254659	.	C	T	0	8	8	0	5	13	0	0
2	16268870	.	C	A	0	4	4	0	2	6	0	0
2	16268888	.	T	C	2	3	5	0	0	5	0	0
2	16268954	.	C	T	0	3	3	0	1	4	0	0
2	16269024	.	A	T	4	2	6	0	0	6	0	0
2	16269276	.	G	A	2	5	7	0	0	7	0	0
2	16269335	.	G	A	2	4	6	0	0	6	0	0
2	16269386	.	C	G	2	2	4	0	0	4	0	0
2	16269431	.	T	A	1	3	4	0	0	4	0	0
2	16269726	.	G	A	2	3	5	0	0	5	0	0
2	16270166	.	T	C	2	1	3	0	1	4	0	0
2	16270185	.	C	T	0	4	4	0	0	4	0	0
2	16270658	.	C	T	1	2	3	0	0	3	0	0
2	16271145	.	A	G	3	2	5	0	0	5	0	0
2	16271545	.	C	T	3	5	8	0	0	8	0	0
2	16271578	.	T	G	1	2	3	0	0	3	0	0
2	16271773	.	T	C	1	2	3	0	0	3	0	0
2	16273207	.	C	T	4	3	7	0	1	8	0	0
2	16273220	.	G	T	3	4	7	0	0	7	0	0
2	16273666	.	T	C	1	2	3	0	0	3	0	0
2	16375976	.	A	G	1	8	9	0	0	9	0	0
2	16376416	.	G	C	3	9	12	0	1	13	0	0
2	16376687	.	C	T	0	5	5	0	8	13	0	0
2	16376947	.	G	A	3	12	15	1	1	17	0	0
2	16377047	.	T	G	5	9	14	0	0	14	0	0
2	16377474	.	A	G	6	11	17	0	0	17	0	0
2	16378027	.	T	C	2	3	5	0	0	5	0	0
2	16378123	.	T	C	7	0	7	0	6	13	0	0
2	16378171	.	G	A	8	4	12	0	1	13	0	0
2	16378195	.	T	G	3	5	8	0	0	8	0	0
2	16378255	.	G	A	2	9	11	0	0	11	0	0
2	16378263	.	A	G	2	9	11	0	0	11	0	0
2	16378355	.	A	G	6	7	13	0	0	13	0	0
2	16378395	.	A	T	4	5	9	0	0	9	0	0
2	16378514	.	A	G	3	3	6	0	0	6	0	0
2	16378601	.	G	T	3	6	9	0	0	9	0	0
2	16378606	.	C	G	1	6	7	0	1	8	0	0
2	16391900	.	G	C	2	3	5	1	1	7	0	0
2	16393337	.	T	C	4	3	7	0	0	7	0	0
2	16393421	.	C	T	0	2	2	0	3	5	0	0
2	16393564	.	G	A	1	5	6	0	0	6	0	0
2	16393720	.	C	T	4	5	9	0	0	9	0	0
2	16397538	.	A	G	2	4	6	0	1	7	0	0
2	16400833	.	G	A	1	2	3	0	0	3	0	0
2	16400915	.	G	A	3	2	5	0	0	5	0	0
2	16405432	.	C	G	1	4	5	0	0	5	0	0
2	16449687	.	A	T	2	6	8	0	0	8	0	0
2	16449721	.	G	A	2	7	9	0	0	9	0	0
2	16458163	.	T	C	5	3	8	0	0	8	0	0
2	16479015	.	A	G	16	13	29	0	1	30	0	0
2	16547866	.	T	C	6	14	20	0	0	20	0	0
2	16548236	.	T	G	12	5	17	0	0	17	0	0
2	16554128	.	T	A	1	2	3	0	0	3	0	0
2	16565384	.	T	G	11	14	25	0	2	27	0	0
2	16565424	.	T	C	17	11	28	0	0	28	0	0
2	16594482	.	A	G	2	4	6	0	0	6	0	0
2	16594510	.	T	G	1	2	3	0	0	3	0	0
2	16594528	.	T	G	2	2	4	0	0	4	0	0
2	16594832	.	A	C	2	2	4	0	0	4	0	0
2	16594847	.	T	G	2	3	5	0	0	5	0	0
2	16594906	.	C	T	1	3	4	0	0	4	0	0
2	16597081	.	T	A	3	3	6	0	0	6	0	0
2	16599771	.	G	A	2	2	4	0	0	4	0	0
2	16607216	.	T	A	1	5	6	0	0	6	0	0
2	16610281	.	C	T	1	3	4	0	0	4	0	0
2	16614749	.	C	T	3	2	5	0	0	5	0	0
2	16614798	.	C	T	6	2	8	0	0	8	0	0
2	16614840	.	C	T	5	3	8	0	0	8	0	0
2	16617920	.	T	C	4	5	9	0	0	9	0	0
2	16618156	.	A	G	1	5	6	0	0	6	0	0
2	16621535	.	G	A	1	2	3	0	0	3	0	0
2	16623248	.	G	A	2	5	7	0	1	8	0	0
2	16625731	.	A	G	4	0	4	0	3	7	0	0
2	16631570	.	C	T	3	3	6	0	0	6	0	0
2	16632334	.	C	T	8	5	13	0	1	14	0	0
2	16632571	.	A	G	2	6	8	0	0	8	0	0
2	16632788	.	T	C	2	5	7	0	0	7	0	0
2	16637276	.	G	A	5	5	10	0	0	10	0	0
2	16637277	.	A	T	4	5	9	0	1	10	0	0
2	16638432	.	C	G	4	6	10	0	1	11	0	0
2	16639434	.	G	A	2	7	9	0	1	10	0	0
2	16639435	.	C	G	4	7	11	0	0	11	0	0
2	16639664	.	T	A	8	9	17	0	1	18	0	0
2	16639827	.	G	T	3	4	7	2	0	9	0	0
2	16642963	.	T	C	5	4	9	0	1	10	0	0
2	16643054	.	C	T	3	5	8	0	1	9	0	0
2	16643718	.	T	C	4	5	9	0	0	9	0	0
2	16646377	.	T	A	3	5	8	0	1	9	0	0
2	16646475	.	T	C	5	11	16	0	1	17	0	0
2	16646519	.	A	T	7	5	12	1	0	13	0	0
2	16646593	.	T	C	7	3	10	1	2	13	0	0
2	16646684	.	A	G	2	4	6	0	0	6	0	0
2	16646693	.	T	C	2	3	5	0	0	5	0	0
2	16647071	.	T	C	5	2	7	0	0	7	0	0
2	16652720	.	T	A	1	2	3	0	0	3	0	0
2	16702630	.	T	C	18	14	32	0	0	32	0	0
2	16706898	.	T	A	14	22	36	0	0	36	0	0
2	16706994	.	T	C	21	13	34	0	0	34	0	0
2	16707014	.	C	A	22	12	34	0	2	36	0	0
2	16707030	.	G	T	26	14	40	0	0	40	0	0
2	16707056	.	C	G	26	9	35	0	4	39	0	0
2	16707209	.	A	G	9	0	9	0	8	17	0	0
2	16707211	.	T	G	9	8	17	0	0	17	0	0
2	16707329	.	A	C	12	8	20	0	2	22	0	0
2	16707371	.	C	T	10	17	27	0	1	28	0	0
2	16707374	.	C	A	11	16	27	0	0	27	0	0
2	16707509	.	C	A	17	16	33	0	0	33	0	0
2	16707582	.	T	A	11	14	25	0	2	27	0	0
2	16707631	.	C	G	11	9	20	0	1	21	0	0
2	16723925	.	C	G	13	6	19	0	0	19	0	0
2	16728507	.	T	C	5	3	8	0	0	8	0	0
2	16731783	.	C	T	5	10	15	0	0	15	0	0
2	16734657	.	A	G	6	2	8	0	0	8	0	0
2	16735052	.	G	T	10	10	20	0	0	20	0	0
2	16735160	.	G	A	7	9	16	0	0	16	0	0
2	16735262	.	G	A	2	7	9	0	6	15	0	0
2	16735292	.	C	A	8	9	17	0	2	19	0	0
2	16736612	.	C	T	7	10	17	0	0	17	0	0
2	16736678	.	T	C	12	10	22	0	1	23	0	0
2	16736941	.	T	A	8	5	13	0	2	15	0	0
2	16736964	.	T	C	9	5	14	0	0	14	0	0
2	16737086	.	C	T	9	10	19	0	2	21	0	0
2	17728132	.	G	A	9	7	16	0	1	17	0	0
2	17946951	.	T	C	7	0	7	0	8	15	0	0
2	17947129	.	A	G	8	9	17	0	1	18	0	0
2	18698517	.	C	A	11	20	31	0	2	33	0	0
2	18698560	.	T	A	12	16	28	0	1	29	0	0
2	18698648	.	G	A	14	8	22	0	0	22	0	0
2	18698659	.	G	T	13	6	19	0	0	19	0	0
2	18698686	.	C	T	10	9	19	0	0	19	0	0
2	18698912	.	C	G	20	20	40	0	0	40	0	0
2	18698920	.	G	A	19	20	39	0	0	39	0	0
2	18698957	.	A	T	23	16	39	0	0	39	0	0
2	18699071	.	G	A	19	12	31	0	1	32	0	0
2	18699192	.	C	T	10	7	17	0	2	19	0	0
2	18699315	.	C	G	13	19	32	0	2	34	0	0
2	18699474	.	G	T	17	22	39	0	0	39	0	0
2	18699533	.	T	A	17	18	35	0	2	37	0	0
2	18699586	.	G	T	15	16	31	0	0	31	0	0
2	18699590	.	G	T	13	16	29	0	2	31	0	0
2	18700102	.	T	A	14	9	23	0	4	27	0	0
2	18700148	.	G	A	19	14	33	0	0	33	0	0
2	18700194	.	T	A	18	13	31	0	0	31	0	0
2	18700346	.	A	T	8	9	17	0	0	17	0	0
2	18700410	.	C	A	4	4	8	0	0	8	0	0
2	18700484	.	C	T	2	2	4	0	0	4	0	0
2	18700489	.	A	G	2	2	4	0	0	4	0	0
2	18700690	.	A	G	6	5	11	1	0	12	0	0
2	18700750	.	G	A	13	16	29	0	0	29	0	0
2	18700753	.	G	A	13	16	29	0	0	29	0	0
2	18701033	.	G	A	10	23	33	0	1	34	0	0
2	18701228	.	A	G	15	7	22	0	0	22	0	0
2	18701232	.	T	C	14	7	21	0	2	23	0	0
2	18701576	.	T	C	9	7	16	0	0	16	0	0
2	18701779	.	T	C	12	5	17	1	0	18	0	0
2	18701827	.	A	C	15	9	24	0	2	26	0	0
2	18701982	.	T	A	8	9	17	0	1	18	0	0
2	18702029	.	C	T	9	7	16	0	0	16	0	0
2	18702199	.	A	T	10	11	21	0	0	21	0	0
2	18702222	.	G	T	10	11	21	0	0	21	0	0
2	18702359	.	G	T	5	3	8	0	0	8	0	0
2	18702657	.	G	T	11	12	23	0	2	25	0	0
2	18702710	.	T	C	12	0	12	0	15	27	0	0
2	18702716	.	A	C	13	14	27	0	1	28	0	0
2	18702772	.	G	A	8	10	18	0	0	18	0	0
2	18702825	.	T	G	12	12	24	0	0	24	0	0
2	18702861	.	C	A	12	11	23	0	0	23	0	0
2	18702862	.	A	G	12	11	23	0	0	23	0	0
2	18703265	.	T	A	11	10	21	0	1	22	0	0
2	18703273	.	A	G	8	11	19	0	2	21	0	0
2	18703344	.	A	T	13	15	28	0	1	29	0	0
2	18703345	.	T	G	13	15	28	0	1	29	0	0
2	18714519	.	A	G	16	15	31	0	2	33	0	0
2	18725918	.	G	A	10	17	27	0	0	27	0	0
2	18727920	.	T	G	13	13	26	1	0	27	0	0
2	18735032	.	A	G	12	19	31	0	0	31	0	0
2	18735038	.	A	G	10	15	25	0	0	26	1	0
2	18830386	.	A	G	13	14	27	0	1	28	0	0
2	18830493	.	G	A	16	6	22	0	3	25	0	0
2	18830645	.	T	A	14	6	20	0	0	20	0	0
2	18830646	.	G	A	14	6	20	0	0	20	0	0
2	18990168	.	C	T	1	2	3	0	0	3	0	0
2	18990241	.	G	C	37	24	61	0	2	63	0	0
2	18991317	.	T	C	37	37	74	0	1	75	0	0
2	18991362	.	T	C	33	27	60	0	2	62	0	0
2	18992144	.	G	C	22	22	44	0	0	44	0	0
2	19101393	.	A	T	9	8	17	1	0	18	0	0
2	19101485	.	T	G	1	2	3	0	0	3	0	0
2	19101732	.	C	G	19	14	33	0	0	33	0	0
2	19101950	.	A	G	12	4	16	0	0	16	0	0
2	19102757	.	T	A	8	5	13	0	1	14	0	0
2	19102996	.	T	A	1	3	4	0	0	4	0	0
2	19103424	.	C	A	3	5	8	0	0	8	0	0
2	19104723	.	T	C	5	0	5	0	4	9	0	0
2	19104850	.	G	A	10	12	22	0	1	23	0	0
2	19109272	.	G	T	5	7	12	0	2	14	0	0
2	19109300	.	T	A	5	6	11	0	0	11	0	0
2	19208883	.	A	C	1	3	4	0	0	4	0	0
2	19209589	.	C	G	1	0	1	0	4	5	0	0
2	19214451	.	T	C	2	2	4	0	1	5	0	0
2	19214616	.	C	T	2	2	4	0	0	4	0	0
2	19214770	.	C	G	1	0	1	0	2	3	0	0
2	19214771	.	C	A	1	2	3	0	0	3	0	0
2	19218230	.	G	A	1	2	3	0	0	3	0	0
2	19242878	.	C	T	2	2	4	0	0	4	0	0
2	19247451	.	C	A	5	3	8	0	0	8	0	0
2	19280915	.	A	T	3	2	5	0	0	5	0	0
2	19281295	.	T	G	4	6	10	0	0	10	0	0
2	19281432	.	T	A	6	3	9	0	1	10	0	0
2	19290129	.	A	G	9	5	14	0	0	14	0	0
2	19308439	.	G	C	15	13	28	0	0	28	0	0
2	19318112	.	C	A	5	4	9	0	0	9	0	0
2	19318459	.	T	C	4	2	6	0	0	6	0	0
2	19318791	.	A	G	3	2	5	0	0	5	0	0
2	19643198	.	A	G	1	3	4	0	0	4	0	0
2	19645797	.	T	A	1	3	4	0	0	4	0	0
2	19784751	.	C	T	11	10	21	0	0	21	0	0
2	19794484	.	C	T	9	7	16	0	2	18	0	0
2	19794753	.	A	G	16	7	23	0	2	25	0	0
2	19794847	.	T	G	12	1	13	0	10	23	0	0
2	19794937	.	C	T	7	7	14	0	2	16	0	0
2	19795249	.	C	T	11	10	21	0	0	21	0	0
2	19795301	.	A	G	9	7	16	0	0	16	0	0
2	19795333	.	G	C	10	12	22	0	0	22	0	0
2	19795344	.	G	A	2	14	16	0	12	28	0	0
2	19795400	.	A	G	12	13	25	0	0	25	0	0
2	20262531	.	A	G	1	2	3	0	0	3	0	0
2	20323825	.	A	G	1	5	6	0	0	6	0	0
2	20323830	.	A	T	1	5	6	0	0	6	0	0
2	20331937	.	C	A	4	10	14	0	0	14	0	0
2	20332061	.	T	A	7	6	13	0	0	13	0	0
2	20332135	.	A	G	9	3	12	0	1	13	0	0
2	20367927	.	G	T	20	13	33	0	1	34	0	0
2	20368101	.	T	C	12	11	23	0	1	25	1	0
2	20368173	.	T	C	4	10	14	0	1	15	0	0
2	20368320	.	G	A	10	10	20	0	0	20	0	0
2	20368383	.	A	G	11	0	11	0	6	17	0	0
2	20368537	.	A	C	18	18	36	0	0	36	0	0
2	20368569	.	A	C	21	20	41	0	1	42	0	0
2	20368812	.	G	A	25	15	40	0	0	40	0	0
2	20368965	.	C	T	25	24	49	0	0	49	0	0
2	20369162	.	A	C	10	13	23	0	8	31	0	0
2	20369240	.	T	G	17	19	36	0	1	37	0	0
2	20369516	.	A	G	13	25	38	0	2	40	0	0
2	20369836	.	A	T	13	24	37	0	0	37	0	0
2	20369925	.	T	A	15	22	37	0	1	38	0	0
2	20369947	.	A	C	13	17	30	1	2	33	0	0
2	20370090	.	G	C	15	19	34	0	0	34	0	0
2	20370143	.	C	T	16	18	34	0	1	35	0	0
2	20370792	.	T	C	21	19	40	0	1	41	0	0
2	20370893	.	C	T	13	20	33	0	0	33	0	0
2	20370998	.	A	G	16	17	33	0	0	33	0	0
2	20371060	.	T	A	10	15	25	0	0	25	0	0
2	20371210	.	G	C	6	7	13	0	1	14	0	0
2	20437703	.	C	A	13	7	20	0	0	20	0	0
2	20437826	.	G	A	2	12	14	0	12	26	0	0
2	20437834	.	C	T	12	12	24	0	0	24	0	0
2	20437878	.	G	A	12	8	20	0	2	22	0	0
2	20437901	.	G	T	6	13	19	0	1	20	0	0
2	20437916	.	G	T	8	14	22	0	1	23	0	0
2	20438061	.	A	T	17	13	30	0	0	30	0	0
2	20438110	.	C	A	12	16	28	0	0	28	0	0
2	20438167	.	G	A	1	12	13	0	14	27	0	0
2	20438219	.	G	A	16	17	33	0	2	35	0	0
2	20438373	.	A	G	8	19	27	0	0	27	0	0
2	20438443	.	G	A	22	10	32	0	0	32	0	0
2	20438589	.	C	T	12	8	20	0	1	21	0	0
2	20438876	.	A	C	16	18	34	0	1	35	0	0
2	20439089	.	T	C	16	14	30	0	3	33	0	0
2	20439303	.	C	T	7	11	18	0	1	19	0	0
2	20439490	.	A	G	21	18	39	0	0	39	0	0
2	20440244	.	G	A	17	5	22	0	0	22	0	0
2	20440307	.	A	C	13	14	27	0	2	29	0	0
2	20440328	.	C	A	15	15	30	0	0	30	0	0
2	20442735	.	G	A	17	16	33	0	3	36	0	0
2	20442939	.	A	G	2	5	7	0	0	7	0	0
2	20473171	.	T	C	12	12	24	0	0	24	0	0
2	20475831	.	A	G	9	12	21	0	1	22	0	0
2	20487136	.	A	C	4	7	11	1	1	13	0	0
2	20487211	.	C	T	5	10	15	0	0	15	0	0
2	20487347	.	C	A	6	19	25	0	2	27	0	0
2	20496286	.	A	C	3	2	5	0	0	5	0	0
2	20496574	.	T	C	6	12	18	0	0	18	0	0
2	20496616	.	T	A	14	11	25	0	0	25	0	0
2	20503698	.	C	A	12	17	29	0	0	29	0	0
2	20503734	.	T	G	12	0	12	0	20	32	0	0
2	20503770	.	C	T	14	14	28	0	1	29	0	0
2	20505995	.	C	T	8	15	23	0	0	23	0	0
2	20506067	.	G	A	10	13	23	0	0	23	0	0
2	20506439	.	T	C	11	10	21	0	0	21	0	0
2	20509561	.	A	G	9	19	28	0	2	30	0	0
2	20509603	.	A	T	6	22	28	0	2	30	0	0
2	20511713	.	C	A	7	13	20	0	1	21	0	0
2	20511725	.	T	C	7	13	20	0	2	22	0	0
2	20511770	.	C	T	13	17	30	0	0	30	0	0
2	20514915	.	A	G	10	15	25	0	1	26	0	0
2	20515377	.	C	T	11	10	21	0	0	21	0	0
2	20516291	.	G	A	13	7	20	0	0	20	0	0
2	20518033	.	A	G	20	18	38	0	0	38	0	0
2	20518057	.	C	G	17	12	29	0	1	30	0	0
2	20518081	.	T	C	17	7	24	0	6	30	0	0
2	20518093	.	C	T	21	8	29	0	2	31	0	0
2	20520618	.	T	C	14	16	30	0	0	30	0	0
2	20520636	.	T	C	12	15	27	0	2	29	0	0
2	20606797	.	T	A	1	3	4	0	0	4	0	0
2	20611985	.	G	C	1	2	3	0	0	3	0	0
2	20614286	.	T	C	2	3	5	0	0	5	0	0
2	20614879	.	T	C	2	2	4	0	0	4	0	0
2	20614955	.	T	A	3	2	5	0	0	5	0	0
2	20811728	.	A	T	1	5	6	0	0	6	0	0
2	20811739	.	A	G	5	4	9	0	0	9	0	0
2	20811792	.	A	C	5	8	13	0	0	13	0	0
2	20814225	.	A	T	11	8	19	0	0	19	0	0
2	20814754	.	G	T	10	11	21	0	0	21	0	0
2	20817736	.	G	A	6	12	18	0	0	18	0	0
2	20818087	.	T	A	9	11	20	0	2	22	0	0
2	20819762	.	G	T	15	9	24	0	4	28	0	0
2	20820587	.	C	T	22	16	38	0	3	41	0	0
2	20824654	.	T	C	8	0	8	0	9	17	0	0
2	20826495	.	T	C	11	8	19	0	1	20	0	0
2	20828322	.	A	G	15	18	33	0	2	35	0	0
2	20830336	.	A	G	10	7	17	0	1	18	0	0
2	20830342	.	C	T	11	8	19	0	0	19	0	0
2	20830405	.	A	G	2	17	19	0	0	19	0	0
2	20830993	.	C	G	13	7	20	0	0	20	0	0
2	20833345	.	G	A	9	6	15	0	0	15	0	0
2	20833432	.	A	C	8	0	8	0	11	19	0	0
2	20833914	.	C	T	6	3	9	0	1	10	0	0
2	20833917	.	A	C	6	4	10	0	0	10	0	0
2	20837017	.	G	A	9	7	16	0	0	16	0	0
2	20840328	.	T	C	2	6	8	0	0	8	0	0
2	20840539	.	C	A	8	4	12	0	1	13	0	0
2	20840596	.	C	T	7	7	14	0	1	15	0	0
2	20840783	.	C	T	9	6	15	0	0	15	0	0
2	20840837	.	T	C	5	0	5	0	3	8	0	0
2	20843816	.	A	G	7	6	13	0	0	13	0	0
2	20844349	.	T	C	2	7	9	0	1	10	0	0
2	20866605	.	A	T	7	4	11	0	1	12	0	0
2	20870961	.	T	C	4	3	7	0	0	7	0	0
2	20871012	.	G	A	0	2	2	0	4	6	0	0
2	20871630	.	T	A	4	4	8	0	0	8	0	0
2	20872021	.	T	C	3	4	7	0	0	7	0	0
2	20874515	.	T	C	2	4	6	0	0	6	0	0
2	20875064	.	C	T	3	4	7	0	0	7	0	0
2	20875112	.	G	A	1	4	5	0	4	9	0	0
2	20875166	.	C	T	3	5	8	0	0	8	0	0
2	20875175	.	A	G	2	5	7	0	0	7	0	0
2	20875922	.	T	A	4	3	7	0	1	8	0	0
2	20920946	.	C	T	1	2	3	0	0	3	0	0
2	20971423	.	T	C	3	3	6	0	0	6	0	0
2	20971441	.	T	C	3	3	6	0	0	6	0	0
2	20973003	.	G	A	4	2	6	0	0	6	0	0
2	20973008	.	G	T	3	2	5	0	1	6	0	0
2	20973176	.	C	T	3	3	6	0	0	6	0	0
2	20973307	.	C	T	2	5	7	0	1	8	0	0
2	20973309	.	T	G	3	0	3	0	5	8	0	0
2	20973369	.	G	A	3	6	9	0	1	10	0	0
2	20973419	.	G	A	3	3	6	0	2	8	0	0
2	20973698	.	A	G	6	7	13	2	0	15	0	0
2	20973864	.	G	A	0	5	5	0	6	11	0	0
2	20973966	.	G	A	1	5	6	0	4	10	0	0
2	20973990	.	T	G	5	2	7	0	0	7	0	0
2	20974085	.	G	A	3	2	5	0	2	7	0	0
2	20974232	.	G	T	6	6	12	0	0	12	0	0
2	20974244	.	A	T	6	3	9	0	1	10	0	0
2	20974867	.	G	A	1	7	8	0	1	9	0	0
2	20974880	.	T	C	1	8	9	0	0	9	0	0
2	20975009	.	C	A	5	8	13	0	0	13	0	0
2	20975010	.	T	C	5	8	13	0	0	13	0	0
2	20975075	.	A	T	2	2	4	0	0	4	0	0
2	20975451	.	T	C	5	7	12	0	0	12	0	0
2	20980280	.	C	G	1	4	5	0	0	5	0	0
2	21063794	.	T	A	2	7	9	0	0	9	0	0
2	21064752	.	T	C	12	7	19	0	0	19	0	0
2	21064754	.	T	C	12	7	19	0	0	19	0	0
2	21064800	.	T	A	4	7	11	0	1	12	0	0
2	21067812	.	C	T	9	6	15	0	0	15	0	0
2	21067984	.	G	T	8	6	14	0	1	15	0	0
2	21068339	.	A	T	8	3	11	0	1	12	0	0
2	21071957	.	G	A	5	4	9	0	1	10	0	0
2	21073286	.	T	A	4	8	12	0	1	13	0	0
2	21073350	.	A	C	12	8	20	0	0	20	0	0
2	21076203	.	C	T	11	4	15	0	1	16	0	0
2	21076466	.	G	T	8	6	14	0	1	15	0	0
2	21076469	.	G	A	8	6	14	0	1	15	0	0
2	21077191	.	A	C	14	2	16	0	11	27	0	0
2	21077208	.	C	G	14	15	29	0	1	30	0	0
2	21077390	.	G	A	8	11	19	0	1	20	0	0
2	21077438	.	T	A	13	5	18	0	1	19	0	0
2	21077466	.	C	A	5	9	14	0	0	14	0	0
2	21077726	.	C	T	4	9	13	0	0	13	0	0
2	21077967	.	G	A	17	22	39	0	3	42	0	0
2	21079612	.	T	C	15	30	45	0	0	45	0	0
2	21080291	.	G	A	21	20	41	0	2	43	0	0
2	21081087	.	T	A	15	18	33	0	1	35	1	0
2	21082460	.	C	A	20	17	37	0	1	38	0	0
2	21082585	.	C	G	3	2	5	0	0	5	0	0
2	21135461	.	T	C	19	13	32	0	0	32	0	0
2	21138516	.	A	G	19	13	32	0	0	32	0	0
2	21151002	.	T	C	16	13	29	0	2	31	0	0
2	21156207	.	T	C	10	4	14	0	1	15	0	0
2	21156350	.	G	A	13	9	22	0	0	22	0	0
2	21156613	.	T	A	3	3	6	0	0	6	0	0
2	21156809	.	T	A	11	13	24	0	3	27	0	0
2	21165176	.	G	A	7	6	13	0	0	13	0	0
2	21166042	.	A	G	8	15	23	0	0	23	0	0
2	21167395	.	G	A	12	6	18	0	2	20	0	0
2	21170190	.	C	T	0	4	4	0	11	15	0	0
2	21175143	.	A	G	17	0	17	0	9	26	0	0
2	21177237	.	G	A	11	5	16	0	0	16	0	0
2	21179467	.	C	T	16	9	25	0	0	25	0	0
2	21179651	.	A	G	9	12	21	0	1	22	0	0
2	21179866	.	T	G	12	11	23	0	1	24	0	0
2	21179939	.	A	G	19	15	34	0	1	35	0	0
2	21182451	.	G	T	5	5	10	0	0	10	0	0
2	21182482	.	G	T	8	4	12	0	0	12	0	0
2	21287590	.	C	T	1	2	3	0	0	3	0	0
2	21300087	.	G	A	2	3	5	0	0	5	0	0
2	21312257	.	T	C	3	11	14	0	0	14	0	0
2	21312464	.	T	C	5	3	8	0	1	9	0	0
2	21312866	.	G	A	1	3	4	0	4	8	0	0
2	21312877	.	C	A	5	5	10	0	0	10	0	0
2	21317042	.	C	T	4	8	12	0	0	12	0	0
2	21320537	.	C	T	6	10	16	0	0	17	1	0
2	21320837	.	A	G	3	6	9	0	0	9	0	0
2	21321015	.	A	G	5	6	11	0	0	11	0	0
2	21321129	.	T	A	3	3	6	0	0	6	0	0
2	21338276	.	T	C	4	5	9	0	1	10	0	0
2	21340519	.	C	T	8	6	14	0	0	14	0	0
2	21346486	.	T	A	2	2	4	0	0	4	0	0
2	21351972	.	A	G	6	6	12	2	0	14	0	0
2	21371159	.	G	A	6	5	11	0	0	11	0	0
2	21376407	.	C	T	14	10	24	0	0	24	0	0
2	21381230	.	C	T	9	10	19	0	5	24	0	0
2	21459157	.	T	C	15	12	27	0	0	28	1	0
2	21459196	.	C	T	15	10	25	0	0	25	0	0
2	21459701	.	C	A	8	4	12	0	0	12	0	0
2	21463923	.	A	T	15	15	30	0	0	31	1	0
2	21466555	.	T	C	14	13	27	0	1	28	0	0
2	21466567	.	A	T	18	13	31	0	0	31	0	0
2	21468732	.	T	G	20	16	36	0	3	39	0	0
2	21468825	.	G	A	22	17	39	0	1	40	0	0
2	21468953	.	C	T	15	8	23	0	0	23	0	0
2	21469080	.	T	G	10	6	16	0	1	17	0	0
2	21469490	.	T	C	7	4	11	0	0	11	0	0
2	21469577	.	A	G	14	11	25	0	2	27	0	0
2	21469579	.	T	G	16	11	27	0	0	27	0	0
2	21469644	.	A	G	11	8	19	0	0	19	0	0
2	21486980	.	T	G	2	3	5	0	0	5	0	0
2	21487190	.	G	A	1	3	4	0	0	4	0	0
2	21501967	.	C	G	5	2	7	0	0	7	0	0
2	21502301	.	G	T	6	6	12	0	0	12	0	0
2	21502364	.	C	T	5	5	10	0	0	10	0	0
2	21607456	.	G	C	1	5	6	0	0	6	0	0
2	21608427	.	C	G	6	2	8	0	0	8	0	0
2	21608582	.	G	A	9	14	23	0	0	23	0	0
2	21608587	.	C	T	9	14	23	0	1	24	0	0
2	21609016	.	A	T	6	11	17	0	0	17	0	0
2	21609223	.	C	T	1	2	3	0	6	9	0	0
2	21609443	.	C	A	6	9	15	0	0	15	0	0
2	21609446	.	C	T	6	9	15	0	0	15	0	0
2	21609872	.	T	A	6	2	8	0	1	9	0	0
2	21612356	.	T	G	9	5	14	0	1	15	0	0
2	21612380	.	C	T	0	6	6	0	9	15	0	0
2	21621762	.	T	C	8	5	13	0	0	13	0	0
2	21625423	.	T	G	1	5	6	0	1	7	0	0
2	21715416	.	C	G	2	0	2	0	3	5	0	0
2	21733971	.	A	G	1	2	3	0	0	3	0	0
2	21766237	.	G	A	4	7	11	0	2	13	0	0
2	21766277	.	G	A	4	6	10	0	0	10	0	0
2	21766319	.	G	A	7	4	11	0	0	11	0	0
2	21766323	.	A	G	7	4	11	0	0	11	0	0
2	21766478	.	T	A	2	9	11	0	1	12	0	0
2	21766554	.	G	A	7	6	13	0	0	13	0	0
2	21767207	.	C	T	10	14	24	0	0	24	0	0
2	21767286	.	T	C	9	4	13	0	0	13	0	0
2	21768168	.	G	A	10	5	15	0	0	15	0	0
2	21768392	.	A	C	3	5	8	0	0	8	0	0
2	21769256	.	A	G	3	3	6	0	1	7	0	0
2	21769386	.	T	A	7	5	12	0	0	12	0	0
2	21769928	.	A	G	8	7	15	0	0	15	0	0
2	21769947	.	A	G	6	7	13	0	0	13	0	0
2	21770775	.	G	A	7	7	14	0	0	14	0	0
2	21770888	.	T	C	7	5	12	0	1	13	0	0
2	21771091	.	G	T	5	6	11	0	0	11	0	0
2	21771191	.	G	T	6	6	12	0	0	12	0	0
2	21771245	.	A	T	13	5	18	0	0	18	0	0
2	21772082	.	G	A	8	3	11	0	0	11	0	0
2	21774400	.	G	A	1	3	4	0	0	4	0	0
2	21777101	.	C	A	5	8	13	0	0	13	0	0
2	21777102	.	A	G	5	8	13	0	0	13	0	0
2	21780896	.	C	T	2	4	6	0	0	6	0	0
2	21781538	.	G	A	2	3	5	0	1	6	0	0
2	21784167	.	G	A	6	7	13	0	0	13	0	0
2	21807194	.	A	G	3	2	5	0	0	5	0	0
2	21807229	.	C	T	4	2	6	0	0	6	0	0
2	21807265	.	T	G	4	2	6	0	2	8	0	0
2	21807295	.	C	T	6	3	9	0	0	9	0	0
2	21807373	.	G	A	5	3	8	0	1	9	0	0
2	21821936	.	A	G	27	25	52	0	0	52	0	0
2	21822288	.	C	A	25	23	48	0	2	51	1	0
2	21822816	.	T	A	24	19	43	0	2	45	0	0
2	21823100	.	C	A	40	17	57	0	5	63	1	0
2	21855248	.	C	G	8	14	22	0	2	24	0	0
2	21865620	.	G	C	20	21	41	0	2	43	0	0
2	21869023	.	T	C	18	17	35	0	1	36	0	0
2	21877560	.	G	A	14	8	22	0	3	25	0	0
2	21877711	.	C	G	14	8	22	0	0	22	0	0
2	21877743	.	T	G	12	14	26	0	0	26	0	0
2	21877769	.	A	T	8	15	23	0	0	23	0	0
2	21877795	.	T	C	7	10	17	0	0	17	0	0
2	21877931	.	T	A	12	6	18	0	2	20	0	0
2	21878036	.	G	C	17	13	30	0	0	30	0	0
2	21878258	.	A	T	17	14	31	0	0	31	0	0
2	21878415	.	C	T	11	13	24	0	1	25	0	0
2	21983059	.	C	T	10	13	23	0	1	24	0	0
2	22058254	.	G	A	17	10	27	0	3	30	0	0
2	22058281	.	C	T	16	10	26	0	1	27	0	0
2	22071062	.	A	C	13	22	35	0	0	35	0	0
2	22073020	.	A	G	14	17	31	0	2	33	0	0
2	22073176	.	C	T	16	16	32	1	3	36	0	0
2	22093084	.	A	G	15	0	15	0	22	37	0	0
2	22104309	.	C	G	19	22	41	0	1	42	0	0
2	22104415	.	C	A	16	17	33	0	3	36	0	0
2	22104506	.	T	C	8	9	17	0	0	17	0	0
2	22104912	.	T	C	13	15	28	0	3	31	0	0
2	22208560	.	G	A	11	4	15	0	1	16	0	0
2	22208767	.	G	A	13	6	19	0	1	20	0	0
2	22208776	.	A	G	14	7	21	0	0	21	0	0
2	22209045	.	C	A	10	13	23	0	1	24	0	0
2	22209743	.	A	G	10	10	20	0	0	20	0	0
2	22209920	.	C	T	15	10	25	0	0	25	0	0
2	22210137	.	T	C	11	0	11	0	12	23	0	0
2	22210412	.	G	A	15	14	29	0	1	30	0	0
2	22286813	.	T	A	6	6	12	0	1	13	0	0
2	22353522	.	T	C	19	0	19	0	16	35	0	0
2	22353568	.	T	C	16	14	30	0	0	30	0	0
2	22353661	.	T	A	10	9	19	0	1	20	0	0
2	22353662	.	A	C	11	9	20	0	0	20	0	0
2	22353993	.	T	C	14	20	34	0	2	36	0	0
2	22362290	.	G	A	13	19	32	0	0	32	0	0
2	22362302	.	G	A	13	21	34	0	1	35	0	0
2	22362347	.	T	C	15	0	15	0	19	34	0	0
2	22363365	.	T	C	15	18	33	0	0	33	0	0
2	22363418	.	T	A	4	6	10	0	0	10	0	0
2	22364024	.	C	G	5	3	8	0	0	8	0	0
2	22364079	.	T	C	7	6	13	0	0	13	0	0
2	22364095	.	A	C	3	3	6	0	1	7	0	0
2	22364250	.	C	A	1	3	4	0	0	4	0	0
2	22388748	.	C	T	4	2	6	0	0	6	0	0
2	22390367	.	A	C	2	6	8	0	0	8	0	0
2	22396383	.	C	G	3	2	5	2	0	7	0	0
2	22396692	.	G	A	0	2	2	0	1	3	0	0
2	22397029	.	A	G	1	2	3	0	0	3	0	0
2	22397527	.	G	T	1	4	5	0	0	5	0	0
2	22397534	.	A	G	2	4	6	0	0	6	0	0
2	22397564	.	G	A	6	3	9	0	0	9	0	0
2	22397571	.	T	C	6	4	10	0	0	10	0	0
2	22480272	.	T	C	5	0	5	0	10	15	0	0
2	22483381	.	A	G	9	10	19	0	0	19	0	0
2	22486393	.	A	G	11	5	16	0	1	17	0	0
2	22507132	.	T	A	9	8	17	0	2	19	0	0
2	22513202	.	A	G	3	4	7	0	0	7	0	0
2	22516758	.	A	G	5	2	7	0	1	8	0	0
2	22517039	.	G	A	7	6	13	0	1	14	0	0
2	22521337	.	G	A	4	4	8	0	1	9	0	0
2	22521557	.	T	A	3	4	7	0	0	7	0	0
2	22521582	.	A	T	3	5	8	0	0	8	0	0
2	22521905	.	C	A	3	3	6	0	1	7	0	0
2	22522302	.	A	G	5	3	8	0	0	8	0	0
2	22522406	.	A	T	1	4	5	0	0	5	0	0
2	22522448	.	A	G	1	3	4	0	0	4	0	0
2	22522472	.	A	G	1	3	4	0	0	4	0	0
2	22522895	.	T	C	6	6	12	0	0	12	0	0
2	22523573	.	G	A	5	3	8	0	1	9	0	0
2	22602424	.	T	C	16	16	32	0	2	34	0	0
2	22602826	.	C	T	17	17	34	0	0	34	0	0
2	22607462	.	G	A	3	17	20	0	16	36	0	0
2	22608314	.	G	T	19	8	27	0	2	29	0	0
2	22612623	.	T	C	14	12	26	0	1	27	0	0
2	22614355	.	G	A	8	9	17	0	0	17	0	0
2	22614357	.	T	A	7	8	15	0	2	17	0	0
2	22614448	.	T	A	4	8	12	0	1	13	0	0
2	22614988	.	T	C	7	9	16	0	1	17	0	0
2	22615055	.	T	A	9	12	21	0	1	22	0	0
2	22615155	.	G	A	7	6	13	0	0	13	0	0
2	22627149	.	G	A	21	23	44	0	0	44	0	0
2	22628981	.	A	G	23	15	38	0	2	40	0	0
2	22634040	.	T	G	24	17	41	1	1	43	0	0
2	22653693	.	T	A	6	7	13	0	0	13	0	0
2	22656723	.	C	T	6	4	10	0	0	10	0	0
2	22656870	.	A	G	12	7	19	0	1	20	0	0
2	22659072	.	G	A	8	7	15	0	3	18	0	0
2	22702423	.	T	C	23	20	43	0	3	46	0	0
2	22702505	.	C	G	15	28	43	0	0	43	0	0
2	22707536	.	A	C	15	24	39	0	3	42	0	0
2	22710985	.	T	C	13	21	34	0	0	34	0	0
2	22714603	.	A	G	24	23	47	0	1	48	0	0
2	22714618	.	G	A	23	20	43	0	3	46	0	0
2	22717198	.	A	G	16	20	36	0	0	36	0	0
2	22721695	.	T	C	25	21	46	0	1	47	0	0
2	22721734	.	A	T	25	12	37	0	4	41	0	0
2	22731426	.	C	T	12	22	34	0	1	35	0	0
2	22731456	.	G	A	15	22	37	0	1	38	0	0
2	22733715	.	T	C	28	22	50	0	1	51	0	0
2	22733813	.	A	G	22	22	44	0	2	46	0	0
2	22735037	.	T	A	24	32	56	0	0	56	0	0
2	22735205	.	A	T	30	24	54	0	3	57	0	0
2	22735232	.	C	T	26	31	57	0	1	58	0	0
2	22742027	.	T	A	18	26	44	0	5	49	0	0
2	22742034	.	A	C	19	30	49	0	1	50	0	0
2	22742179	.	C	T	28	19	47	0	4	51	0	0
2	22747304	.	C	T	22	18	40	0	0	40	0	0
2	22749202	.	A	C	27	22	49	0	1	50	0	0
2	22749221	.	A	G	24	0	24	0	24	48	0	0
2	22750164	.	C	T	31	21	52	0	0	52	0	0
2	22750621	.	C	T	29	21	50	0	1	51	0	0
2	22750622	.	A	G	29	20	49	0	2	51	0	0
2	22756245	.	T	G	34	22	56	0	2	59	1	0
2	22756289	.	A	G	34	21	55	0	3	58	0	0
2	22791540	.	G	C	1	3	4	0	0	4	0	0
2	22791973	.	C	T	1	3	4	0	0	4	0	0
2	22802004	.	T	A	39	22	61	0	0	61	0	0
2	22802402	.	T	C	23	18	41	0	1	42	0	0
2	22802504	.	G	A	16	12	28	0	0	28	0	0
2	22803074	.	G	A	3	22	25	0	24	49	0	0
2	22803366	.	C	T	24	28	52	0	0	52	0	0
2	22853289	.	A	T	3	2	5	0	0	5	0	0
2	22853622	.	A	G	1	0	1	0	3	4	0	0
2	22860300	.	A	G	1	0	1	0	2	3	0	0
2	22860487	.	A	G	1	2	3	0	0	3	0	0
2	22860517	.	A	T	2	3	5	0	0	5	0	0
2	22860541	.	C	T	3	2	5	0	0	5	0	0
2	22932715	.	T	C	3	3	6	0	0	6	0	0
2	22932725	.	G	A	2	4	6	0	0	6	0	0
2	22932931	.	A	G	5	2	7	0	0	7	0	0
2	22933175	.	T	G	1	3	4	0	0	4	0	0
2	22933242	.	A	G	1	2	3	0	0	3	0	0
2	22933377	.	G	T	4	4	8	0	0	8	0	0
2	22933455	.	T	C	6	5	11	0	0	11	0	0
2	22935766	.	A	T	5	5	10	0	1	11	0	0
2	22953005	.	T	C	3	2	5	0	0	5	0	0
2	22953020	.	A	C	2	0	2	0	2	4	0	0
2	22959179	.	A	G	2	4	6	0	0	6	0	0
2	22962013	.	A	G	4	3	7	0	0	7	0	0
2	22965210	.	A	T	5	3	8	0	0	8	0	0
2	22970603	.	A	C	3	2	5	0	0	5	0	0
2	22986552	.	T	C	9	5	14	0	0	14	0	0
2	22986555	.	C	T	9	5	14	0	0	14	0	0
2	22993548	.	G	C	8	5	13	0	0	13	0	0
2	22994322	.	C	T	6	4	10	0	1	11	0	0
2	22994412	.	C	T	9	11	20	0	0	20	0	0
2	23003843	.	C	G	7	8	15	0	0	15	0	0
2	23007678	.	G	A	5	2	7	0	0	7	0	0
2	23007852	.	T	C	5	4	9	0	0	9	0	0
2	23012508	.	C	T	1	3	4	0	1	5	0	0
2	23022896	.	A	G	4	5	9	0	0	9	0	0
2	23023121	.	G	A	0	3	3	0	2	5	0	0
2	23023337	.	G	A	4	3	7	0	0	7	0	0
2	23023535	.	A	T	5	4	9	0	0	9	0	0
2	23023675	.	G	A	3	4	7	0	0	7	0	0
2	23023959	.	A	T	1	4	5	0	0	5	0	0
2	23023971	.	T	C	2	4	6	0	0	6	0	0
2	23048494	.	T	G	10	9	19	0	0	19	0	0
2	23061791	.	T	C	9	13	22	0	2	24	0	0
2	23066671	.	C	T	15	14	29	0	2	31	0	0
2	23073536	.	A	G	7	12	19	0	1	20	0	0
2	23077839	.	A	C	9	10	19	0	3	22	0	0
2	23078532	.	T	C	7	5	12	0	0	12	0	0
2	23081309	.	G	A	0	6	6	0	4	10	0	0
2	23082894	.	G	C	1	3	4	0	1	5	0	0
2	23083308	.	T	C	4	8	12	0	0	12	0	0
2	23085121	.	C	T	8	7	15	0	1	16	0	0
2	23085188	.	T	A	5	3	8	0	1	10	1	0
2	23085189	.	T	G	6	3	9	0	1	10	0	0
2	23085223	.	G	A	5	6	11	0	0	11	0	0
2	23098464	.	A	G	3	4	7	0	0	7	0	0
2	23098472	.	A	T	4	5	9	0	0	9	0	0
2	23098506	.	C	A	4	4	8	0	0	8	0	0
2	23098916	.	T	C	7	5	12	0	1	13	0	0
2	23099173	.	T	C	4	2	6	0	0	6	0	0
2	23099307	.	T	C	2	3	5	0	0	5	0	0
2	23165729	.	G	T	2	2	4	0	0	4	0	0
2	23227385	.	A	G	7	9	16	0	0	16	0	0
2	23232881	.	A	G	7	13	20	1	2	23	0	0
2	23232884	.	T	C	9	14	23	1	0	24	0	0
2	23245557	.	C	T	11	5	16	0	0	16	0	0
2	23254074	.	A	G	14	13	27	0	1	28	0	0
2	23254158	.	G	A	8	17	25	0	1	26	0	0
2	23274792	.	C	T	10	17	27	0	2	29	0	0
2	23292123	.	A	T	12	9	21	0	2	23	0	0
2	23292432	.	C	A	15	13	28	0	2	30	0	0
2	23292490	.	C	G	14	8	22	0	0	22	0	0
2	23292549	.	C	A	10	8	18	0	0	18	0	0
2	23292584	.	C	A	5	12	17	0	1	18	0	0
2	23292595	.	T	A	4	10	14	0	0	14	0	0
2	23292690	.	T	A	11	3	14	0	0	14	0	0
2	23293029	.	T	C	3	4	7	0	0	7	0	0
2	23293123	.	G	C	11	4	15	0	1	16	0	0
2	23293230	.	A	T	10	7	17	1	0	18	0	0
2	23293246	.	T	C	10	5	15	1	1	17	0	0
2	23293376	.	C	A	12	8	20	0	1	21	0	0
2	23352323	.	G	A	18	12	30	0	1	31	0	0
2	23361020	.	T	G	16	10	26	0	0	26	0	0
2	23361208	.	C	T	14	16	30	0	2	32	0	0
2	23361359	.	T	C	11	10	21	0	2	23	0	0
2	23361605	.	C	T	11	11	22	0	0	22	0	0
2	23379532	.	G	A	2	2	4	0	1	5	0	0
2	23379588	.	C	T	7	4	11	0	0	11	0	0
2	23380621	.	C	A	7	6	13	0	1	14	0	0
2	23618849	.	T	A	2	2	4	0	0	4	0	0
2	23624418	.	A	G	1	2	3	0	0	3	0	0
2	23644299	.	A	G	3	2	5	0	0	5	0	0
2	23701651	.	C	T	2	4	6	0	0	6	0	0
2	23707408	.	C	A	7	10	17	0	0	17	0	0
2	23707562	.	A	G	7	4	11	0	0	11	0	0
2	23711756	.	C	T	7	4	11	0	0	11	0	0
2	23711771	.	A	G	6	0	6	0	4	10	0	0
2	23711990	.	T	A	6	6	12	0	1	13	0	0
2	23714650	.	C	T	10	6	16	0	0	16	0	0
2	23714743	.	A	T	12	8	20	0	0	20	0	0
2	23716572	.	T	C	10	7	17	0	2	19	0	0
2	23718286	.	T	C	6	10	16	0	0	16	0	0
2	23721729	.	T	A	10	6	16	0	0	16	0	0
2	23721974	.	C	A	4	12	16	0	2	18	0	0
2	23722241	.	A	G	2	2	4	0	0	4	0	0
2	23722414	.	A	G	1	0	1	0	5	6	0	0
2	23722444	.	A	T	2	7	9	0	0	9	0	0
2	23722594	.	T	A	5	2	7	0	0	7	0	0
2	23722828	.	G	A	9	10	19	0	1	20	0	0
2	23723172	.	A	C	6	4	10	0	0	10	0	0
2	23723187	.	A	G	3	3	6	0	0	6	0	0
2	23723256	.	C	T	6	3	9	0	1	10	0	0
2	23723438	.	G	T	0	5	5	0	3	8	0	0
2	23723711	.	T	G	4	3	7	0	0	7	0	0
2	23725075	.	G	A	9	9	18	0	1	19	0	0
2	23725144	.	T	C	18	5	23	0	0	23	0	0
2	23725184	.	C	A	13	3	16	0	1	17	0	0
2	23725754	.	A	T	2	7	9	0	1	10	0	0
2	23725756	.	A	T	2	5	7	0	3	10	0	0
2	23725834	.	G	C	5	5	10	0	0	10	0	0
2	23725872	.	T	C	5	3	8	0	2	10	0	0
2	23726099	.	A	T	8	9	17	0	1	18	0	0
2	23726155	.	C	A	4	9	13	0	0	13	0	0
2	23726180	.	A	G	4	7	11	0	1	12	0	0
2	23726206	.	T	A	6	4	10	0	0	10	0	0
2	23726230	.	A	T	6	5	11	0	1	12	0	0
2	23726290	.	T	C	10	8	18	0	0	18	0	0
2	23726353	.	G	A	11	14	25	0	0	25	0	0
2	23726393	.	C	T	12	11	23	0	0	23	0	0
2	23796665	.	A	T	2	2	4	0	0	4	0	0
2	23803419	.	G	C	4	2	6	0	0	6	0	0
2	23803439	.	C	A	2	2	4	0	0	4	0	0
2	23808760	.	G	A	6	4	10	0	0	10	0	0
2	23813918	.	T	C	4	5	9	0	0	9	0	0
2	23816293	.	A	C	6	6	12	0	2	14	0	0
2	23816773	.	A	T	2	3	5	0	0	5	0	0
2	23816854	.	T	A	4	7	11	0	0	11	0	0
2	23816932	.	C	T	6	7	13	0	0	13	0	0
2	23816979	.	G	A	5	2	7	0	0	7	0	0
2	23817276	.	T	A	2	3	5	0	0	5	0	0
2	23817924	.	T	G	1	2	3	0	0	3	0	0
2	23817946	.	G	A	1	4	5	0	0	5	0	0
2	23818209	.	A	T	3	2	5	0	0	5	0	0
2	23818580	.	T	A	3	6	9	0	0	9	0	0
2	23818765	.	A	G	3	2	5	0	0	5	0	0
2	23819237	.	T	G	2	2	4	0	1	5	0	0
2	23819241	.	G	C	2	3	5	0	0	5	0	0
2	23819302	.	C	G	5	4	9	0	0	9	0	0
2	23819603	.	T	C	2	2	4	0	0	4	0	0
2	23819640	.	T	A	4	3	7	0	0	7	0	0
2	23819862	.	A	C	3	2	5	0	0	5	0	0
2	23823684	.	A	T	3	6	9	0	0	9	0	0
2	23823719	.	A	G	3	4	7	0	0	7	0	0
2	23937227	.	G	A	2	3	5	0	1	6	0	0
2	23937549	.	T	G	3	3	6	0	0	6	0	0
2	23937631	.	T	G	2	3	5	0	0	5	0	0
2	23979276	.	A	G	2	2	4	0	1	5	0	0
2	24167890	.	T	C	1	2	3	0	0	3	0	0
2	24167893	.	T	A	1	2	3	0	0	3	0	0
2	24168260	.	A	G	2	0	2	0	4	6	0	0
2	24168315	.	T	A	1	4	5	0	0	5	0	0
2	24168398	.	T	G	1	3	4	0	0	4	0	0
2	24202456	.	G	A	14	18	32	0	4	36	0	0
2	24202855	.	A	G	13	0	13	0	11	24	0	0
2	24219115	.	G	A	40	17	57	0	1	58	0	0
2	24222069	.	A	C	35	37	72	0	1	73	0	0
2	24223991	.	A	G	22	34	56	1	9	66	0	0
2	24238629	.	C	T	30	19	49	0	0	49	0	0
2	24238809	.	A	G	33	17	50	0	0	50	0	0
2	24248619	.	T	G	45	19	64	0	2	66	0	0
2	24248677	.	A	T	40	18	58	0	4	62	0	0
2	24248702	.	T	C	38	20	58	0	3	61	0	0
2	24248767	.	T	C	44	12	56	0	1	57	0	0
2	24248768	.	A	G	42	0	42	0	15	57	0	0
2	24248809	.	C	T	29	27	56	0	5	61	0	0
2	24248871	.	A	G	32	1	33	0	27	60	0	0
2	24249044	.	A	C	29	25	54	0	5	59	0	0
2	24249211	.	A	G	30	28	58	0	4	62	0	0
2	24249299	.	A	G	33	28	61	0	4	65	0	0
2	24249411	.	T	A	33	34	67	0	1	68	0	0
2	24249516	.	A	G	23	0	23	0	32	55	0	0
2	24249947	.	T	G	29	0	29	1	8	38	0	0
2	24250140	.	T	C	12	29	41	0	2	43	0	0
2	24250182	.	T	G	16	15	31	2	0	33	0	0
2	24250209	.	A	C	19	4	23	0	2	25	0	0
2	24250303	.	C	T	33	11	44	0	0	44	0	0
2	24250345	.	A	C	28	13	41	0	3	44	0	0
2	24250625	.	T	A	31	23	54	0	2	56	0	0
2	24250637	.	A	G	31	25	56	0	2	58	0	0
2	24250681	.	T	C	30	24	54	0	2	56	0	0
2	24251848	.	T	C	35	31	66	0	2	68	0	0
2	24252088	.	C	T	32	34	66	0	1	67	0	0
2	24310822	.	C	T	16	9	25	0	0	25	0	0
2	24310850	.	G	C	18	11	29	0	0	29	0	0
2	24310897	.	G	A	15	22	37	0	3	40	0	0
2	24311035	.	T	C	13	0	13	0	12	25	0	0
2	24311697	.	C	T	19	20	39	0	1	40	0	0
2	24311703	.	A	G	19	16	35	0	2	37	0	0
2	24311793	.	G	C	18	25	43	0	2	45	0	0
2	24313884	.	T	C	10	9	19	0	0	19	0	0
2	24314185	.	T	A	9	6	15	0	1	16	0	0
2	24315047	.	A	G	12	12	24	0	1	25	0	0
2	24315068	.	A	G	10	10	20	0	2	22	0	0
2	24316545	.	C	T	11	10	21	0	1	22	0	0
2	24317537	.	G	A	7	13	20	0	0	20	0	0
2	24319851	.	T	C	4	7	11	0	1	12	0	0
2	24320173	.	C	T	10	8	18	0	0	18	0	0
2	24321853	.	T	C	13	1	14	0	4	18	0	0
2	24322180	.	G	T	23	12	35	0	2	37	0	0
2	24326455	.	A	G	13	13	26	0	0	26	0	0
2	24326509	.	G	A	8	8	16	0	0	16	0	0
2	24328453	.	A	T	5	6	11	0	0	11	0	0
2	24331297	.	T	C	11	4	15	0	0	15	0	0
2	24335246	.	G	A	8	6	14	0	0	14	0	0
2	24338492	.	G	A	7	3	10	0	0	10	0	0
2	24348609	.	T	G	13	7	20	0	1	21	0	0
2	24348915	.	G	A	4	4	8	0	1	9	0	0
2	24382093	.	A	G	3	5	8	0	0	8	0	0
2	24385361	.	T	C	3	8	11	0	2	13	0	0
2	24385402	.	A	G	7	11	18	0	0	18	0	0
2	24385447	.	T	C	4	5	9	0	0	9	0	0
2	24385885	.	T	A	9	0	9	0	0	9	0	0
2	24410544	.	T	C	3	0	3	0	3	6	0	0
2	24411053	.	A	G	12	12	24	0	0	24	0	0
2	24411056	.	C	T	1	15	16	0	10	26	0	0
2	24411114	.	G	C	17	18	35	0	3	38	0	0
2	24411501	.	T	G	11	13	24	0	2	26	0	0
2	24411536	.	T	C	13	0	13	0	16	29	0	0
2	24411625	.	T	C	15	14	29	0	3	32	0	0
2	24411781	.	T	G	22	11	33	0	1	34	0	0
2	24411812	.	A	T	19	14	33	0	1	34	0	0
2	24411840	.	T	C	14	14	28	0	2	30	0	0
2	24411989	.	C	T	9	5	14	0	1	15	0	0
2	24412150	.	T	C	25	0	25	0	13	38	0	0
2	24413710	.	T	C	18	16	34	0	0	34	0	0
2	24413882	.	T	C	14	6	20	0	1	21	0	0
2	24416775	.	A	G	21	15	36	0	0	36	0	0
2	24421686	.	G	A	11	12	23	0	0	23	0	0
2	24421813	.	T	C	9	0	9	0	8	17	0	0
2	24432538	.	G	A	4	10	14	0	0	14	0	0
2	24444650	.	C	T	7	8	15	0	2	17	0	0
2	24444839	.	C	G	0	4	4	0	7	11	0	0
2	24461305	.	C	T	0	11	11	0	5	16	0	0
2	24461649	.	T	C	9	7	16	0	1	17	0	0
2	24461957	.	G	A	5	9	14	0	3	17	0	0
2	24541478	.	G	A	0	2	2	0	1	3	0	0
2	24565123	.	A	G	10	8	18	0	0	18	0	0
2	24578215	.	G	A	9	4	13	0	0	13	0	0
2	24578272	.	A	G	6	9	15	0	1	16	0	0
2	24578568	.	A	G	6	4	10	0	0	10	0	0
2	24584052	.	C	T	1	8	9	0	5	14	0	0
2	24594669	.	T	G	5	7	12	0	1	13	0	0
2	24594673	.	T	A	5	8	13	0	1	14	0	0
2	24601482	.	G	A	6	7	13	0	1	14	0	0
2	24601643	.	A	G	10	4	14	0	0	14	0	0
2	24649228	.	A	G	6	0	6	0	7	13	0	0
2	24650434	.	G	A	0	10	10	0	7	17	0	0
2	24663596	.	C	G	6	6	12	0	0	12	0	0
2	24664541	.	G	A	0	8	8	0	8	16	0	0
2	24664557	.	C	T	6	9	15	0	0	15	0	0
2	24664583	.	G	A	7	11	18	0	0	18	0	0
2	24666197	.	C	T	8	10	18	0	0	18	0	0
2	24682951	.	T	C	24	9	33	0	3	36	0	0
2	24683093	.	A	G	12	4	16	0	13	29	0	0
2	24701098	.	T	C	6	6	12	0	0	12	0	0
2	24701261	.	T	A	9	6	15	0	0	15	0	0
2	24729837	.	C	T	3	2	5	0	0	5	0	0
2	24737749	.	C	T	7	7	14	0	0	14	0	0
2	24737776	.	C	T	6	8	14	0	1	15	0	0
2	24739910	.	G	T	8	3	11	0	0	11	0	0
2	24740121	.	G	C	1	5	6	0	10	16	0	0
2	24740439	.	C	T	8	5	13	0	0	13	0	0
2	24740468	.	T	A	6	5	11	0	0	11	0	0
2	24743855	.	G	A	4	6	10	0	0	10	0	0
2	24748144	.	A	G	4	7	11	0	0	11	0	0
2	24748197	.	C	T	6	6	12	0	1	13	0	0
2	24748580	.	T	A	4	3	7	0	1	8	0	0
2	24749438	.	A	G	10	3	13	0	1	14	0	0
2	24750034	.	G	T	1	2	3	0	0	3	0	0
2	24750162	.	G	A	1	2	3	0	0	3	0	0
2	24751165	.	T	C	4	3	7	0	0	7	0	0
2	24751286	.	C	T	4	2	6	0	0	6	0	0
2	24751430	.	C	T	6	6	12	0	0	12	0	0
2	24751567	.	T	A	1	8	9	0	0	9	0	0
2	24751572	.	A	G	1	6	7	0	0	7	0	0
2	24751608	.	A	T	2	10	12	0	0	12	0	0
2	24751888	.	A	G	3	0	3	0	4	7	0	0
2	24751986	.	T	G	6	1	7	0	8	15	0	0
2	24751991	.	A	G	6	8	14	0	1	15	0	0
2	24752157	.	G	A	11	4	15	0	0	15	0	0
2	24752179	.	C	T	10	8	18	0	0	18	0	0
2	24752391	.	A	G	10	12	22	0	0	22	0	0
2	24752737	.	A	G	8	5	13	0	0	14	1	0
2	24752842	.	G	T	6	6	12	0	0	12	0	0
2	24753085	.	C	G	2	4	6	0	1	7	0	0
2	24753402	.	A	G	3	4	7	0	0	7	0	0
2	24753535	.	A	C	13	8	21	0	0	21	0	0
2	24753933	.	T	C	2	2	4	0	0	4	0	0
2	24753980	.	T	A	5	2	7	0	0	7	0	0
2	24754489	.	G	A	3	2	5	0	0	5	0	0
2	24754565	.	A	T	9	5	14	0	0	14	0	0
2	24754641	.	G	A	1	9	10	0	10	20	0	0
2	24754794	.	G	A	19	9	28	0	1	29	0	0
2	24754883	.	T	A	10	6	16	0	0	16	0	0
2	24755018	.	T	C	11	10	21	0	1	22	0	0
2	24770603	.	C	T	4	3	7	0	0	7	0	0
2	24770628	.	G	C	0	3	3	0	3	6	0	0
2	24770898	.	T	C	2	7	9	0	0	9	0	0
2	24770928	.	A	G	4	0	4	0	3	7	0	0
2	24773684	.	C	A	5	2	7	0	0	7	0	0
2	24778283	.	A	G	5	2	7	0	1	8	0	0
2	24858670	.	A	G	2	5	7	0	0	7	0	0
2	24858784	.	A	G	2	4	6	0	0	6	0	0
2	24863101	.	G	T	7	8	15	0	0	15	0	0
2	24863306	.	A	T	3	5	8	0	0	8	0	0
2	24863516	.	G	A	2	2	4	0	0	4	0	0
2	24863757	.	G	T	2	4	6	0	0	6	0	0
2	24864536	.	A	T	4	3	7	0	1	8	0	0
2	24865489	.	C	A	2	2	4	0	1	5	0	0
2	24865961	.	A	G	9	2	11	0	0	11	0	0
2	24865972	.	A	T	7	2	9	0	0	10	1	0
2	24873047	.	G	A	14	12	26	0	1	27	0	0
2	24877010	.	A	G	15	15	30	0	2	32	0	0
2	24877227	.	C	T	10	10	20	0	0	20	0	0
2	24877276	.	A	C	8	15	23	0	1	24	0	0
2	24877294	.	T	C	5	17	22	0	0	22	0	0
2	24877327	.	T	C	2	7	9	0	0	9	0	0
2	24877797	.	G	A	1	2	3	0	0	3	0	0
2	24878017	.	T	A	15	8	23	0	0	23	0	0
2	24878081	.	T	A	28	9	37	0	2	39	0	0
2	24878265	.	G	T	8	6	14	0	0	14	0	0
2	24936807	.	G	A	5	3	8	0	1	9	0	0
2	24942639	.	T	C	12	9	21	0	1	22	0	0
2	24943237	.	G	A	3	13	16	0	7	23	0	0
2	24943398	.	C	T	9	5	14	0	2	16	0	0
2	24943567	.	A	G	4	3	7	0	0	7	0	0
2	24944067	.	A	G	19	0	19	0	7	26	0	0
2	24944187	.	C	T	18	9	27	0	0	27	0	0
2	24944317	.	A	G	9	3	12	0	0	12	0	0
2	24944485	.	T	G	9	6	15	0	1	16	0	0
2	24944566	.	G	A	8	2	10	0	1	11	0	0
2	24947372	.	T	C	8	0	8	0	3	11	0	0
2	24952186	.	G	A	5	5	10	0	1	11	0	0
2	24956856	.	T	C	7	0	7	0	6	13	0	0
2	24957008	.	G	A	3	3	6	0	0	6	0	0
2	24957073	.	T	C	4	4	8	0	1	9	0	0
2	24957086	.	C	T	0	4	4	0	6	10	0	0
2	24958873	.	T	C	2	6	8	0	1	9	0	0
2	24958921	.	G	A	4	9	13	0	0	13	0	0
2	24958945	.	C	T	6	6	12	0	0	12	0	0
2	24964691	.	T	A	2	2	4	0	1	5	0	0
2	24969647	.	C	T	4	2	6	0	0	6	0	0
2	24969895	.	A	C	1	3	4	0	0	4	0	0
2	24990621	.	T	A	3	5	8	0	1	9	0	0
2	24990629	.	T	A	3	7	10	0	0	10	0	0
2	24990751	.	A	T	4	5	9	0	0	9	0	0
2	24990845	.	T	C	4	6	10	0	2	12	0	0
2	24991202	.	C	G	10	18	28	0	0	29	1	0
2	24991265	.	T	G	10	7	17	0	1	18	0	0
2	24991387	.	G	T	9	15	24	0	1	25	0	0
2	24991429	.	G	A	14	6	20	0	1	21	0	0
2	24991564	.	A	C	20	0	20	0	16	36	0	0
2	24991573	.	A	G	22	13	35	0	3	38	0	0
2	24991909	.	A	G	17	18	35	0	1	36	0	0
2	24992134	.	G	A	17	10	27	0	0	27	0	0
2	24992185	.	T	C	19	14	33	0	2	35	0	0
2	24992242	.	C	T	2	17	19	0	16	35	0	0
2	24992352	.	G	A	15	16	31	0	0	31	0	0
2	24992407	.	G	A	16	16	32	0	2	34	0	0
2	24992422	.	G	A	19	16	35	0	3	38	0	0
2	24996241	.	C	T	14	10	24	0	6	30	0	0
2	25074756	.	A	T	4	6	10	2	0	12	0	0
2	25074791	.	A	G	6	0	6	2	3	11	0	0
2	25077569	.	T	C	5	3	8	0	0	8	0	0
2	25087019	.	G	T	0	15	15	0	4	19	0	0
2	25087221	.	G	T	12	6	18	0	1	19	0	0
2	25091203	.	G	A	8	6	14	0	0	14	0	0
2	25095096	.	T	C	5	4	9	0	0	9	0	0
2	25095118	.	T	C	6	5	11	0	0	11	0	0
2	25095177	.	T	C	6	3	9	0	0	9	0	0
2	25097289	.	G	A	4	4	8	0	0	8	0	0
2	25097543	.	C	T	4	6	10	0	2	12	0	0
2	25097576	.	T	G	5	6	11	0	2	13	0	0
2	25100106	.	A	G	6	0	6	0	12	18	0	0
2	25101118	.	A	G	8	9	17	0	0	17	0	0
2	25101124	.	T	C	9	8	17	0	0	17	0	0
2	25101160	.	A	G	11	1	12	0	8	20	0	0
2	25104866	.	A	G	10	16	26	0	1	27	0	0
2	25105482	.	G	A	11	4	15	0	0	15	0	0
2	25105507	.	G	C	11	3	14	0	0	14	0	0
2	25105586	.	C	T	9	10	19	0	0	19	0	0
2	25105856	.	T	A	19	8	27	0	0	27	0	0
2	25105857	.	C	A	14	8	22	0	4	26	0	0
2	25105900	.	C	T	12	10	22	0	1	23	0	0
2	25105992	.	G	A	4	13	17	0	2	19	0	0
2	25106082	.	G	A	0	2	2	0	4	6	0	0
2	25106098	.	T	A	5	3	8	0	0	8	0	0
2	25106343	.	T	A	8	5	13	0	1	14	0	0
2	25106477	.	G	A	7	11	18	0	0	18	0	0
2	25106508	.	G	C	9	12	21	0	1	22	0	0
2	25106554	.	G	T	7	11	18	0	0	18	0	0
2	25106631	.	C	G	5	4	9	0	1	10	0	0
2	25106671	.	A	C	3	3	6	0	0	6	0	0
2	25106874	.	A	C	3	7	10	1	0	11	0	0
2	25107026	.	A	C	7	2	9	0	1	10	0	0
2	25107049	.	G	A	3	5	8	0	5	13	0	0
2	25107532	.	T	G	1	3	4	0	0	4	0	0
2	25107710	.	T	C	11	10	21	0	0	21	0	0
2	25107713	.	T	C	11	10	21	0	0	21	0	0
2	25108042	.	A	G	16	9	25	0	0	25	0	0
2	25108052	.	C	T	11	10	21	0	1	22	0	0
2	25108137	.	C	T	10	12	22	0	5	27	0	0
2	25108377	.	T	A	9	8	17	0	0	17	0	0
2	25113168	.	A	G	10	8	18	0	1	19	0	0
2	25118414	.	G	A	10	5	15	0	0	15	0	0
2	25119637	.	A	G	14	10	24	0	0	24	0	0
2	25119667	.	G	T	10	10	20	0	0	20	0	0
2	25119950	.	T	G	12	5	17	0	0	17	0	0
2	25124650	.	T	G	6	6	12	0	0	12	0	0
2	25124875	.	G	A	0	4	4	0	3	7	0	0
2	25125041	.	A	T	4	4	8	0	0	8	0	0
2	25125073	.	G	A	5	3	8	0	0	8	0	0
2	25127042	.	G	T	5	10	15	0	0	15	0	0
2	25127219	.	T	C	5	2	7	0	0	7	0	0
2	25127261	.	G	T	0	6	6	0	1	7	0	0
2	25127651	.	C	T	5	5	10	0	0	10	0	0
2	25127876	.	G	A	0	4	4	0	3	7	0	0
2	25127897	.	T	C	2	4	6	0	0	6	0	0
2	25128019	.	C	G	5	4	9	0	0	9	0	0
2	25128024	.	C	T	5	4	9	0	1	10	0	0
2	25128590	.	C	T	8	5	13	0	1	14	0	0
2	25128668	.	C	T	8	6	14	0	1	15	0	0
2	25128780	.	T	A	5	6	11	0	1	12	0	0
2	25128858	.	C	T	7	8	15	0	0	15	0	0
2	25128920	.	G	T	4	3	7	0	1	8	0	0
2	25128934	.	A	G	5	4	9	0	0	9	0	0
2	25128997	.	C	G	4	0	4	0	3	7	0	0
2	25290595	.	C	A	3	2	5	0	0	5	0	0
2	25290690	.	A	C	1	2	3	0	0	3	0	0
2	25291034	.	A	G	2	2	4	0	0	4	0	0
2	25291035	.	C	A	2	2	4	0	0	4	0	0
2	25540070	.	C	T	3	2	5	0	0	5	0	0
2	25540190	.	T	C	2	3	5	0	0	5	0	0
2	25540390	.	T	A	1	4	5	0	0	5	0	0
2	25540436	.	A	T	4	3	7	0	0	7	0	0
2	25541074	.	A	C	4	1	5	0	0	5	0	0
2	25542890	.	C	A	4	3	7	3	1	11	0	0
2	25542958	.	T	G	2	2	4	0	0	4	0	0
2	25606742	.	C	T	1	2	3	0	0	3	0	0
2	25631627	.	G	T	1	2	3	0	0	3	0	0
2	25756576	.	T	C	6	3	9	0	0	9	0	0
2	25767288	.	A	G	3	7	10	0	0	10	0	0
2	25771840	.	A	G	7	5	12	0	1	13	0	0
2	25781757	.	C	T	10	8	18	0	1	19	0	0
2	25786170	.	A	C	11	9	20	0	3	23	0	0
2	25786254	.	T	C	8	6	14	0	1	15	0	0
2	25787292	.	C	T	6	9	15	0	0	15	0	0
2	25787553	.	G	C	5	4	9	0	1	10	0	0
2	25794226	.	A	G	7	5	12	0	0	12	0	0
2	25797439	.	C	T	10	5	15	0	0	15	0	0
2	25797472	.	C	T	12	8	20	0	0	20	0	0
2	25798611	.	A	G	9	6	15	0	0	15	0	0
2	25800881	.	C	T	6	10	16	0	0	16	0	0
2	25815203	.	A	T	10	3	13	0	1	14	0	0
2	25839381	.	G	T	2	12	14	0	14	28	0	0
2	25843532	.	T	C	10	13	23	0	1	24	0	0
2	25843806	.	G	A	2	17	19	0	18	37	0	0
2	25844341	.	T	C	13	6	19	0	1	20	0	0
2	25844345	.	A	T	14	7	21	0	0	21	0	0
2	25844986	.	T	A	15	6	21	0	0	21	0	0
2	25845264	.	G	A	2	2	4	0	0	4	0	0
2	25947351	.	C	T	14	14	28	0	0	28	0	0
2	25947408	.	G	T	11	6	17	0	1	18	0	0
2	25947531	.	C	T	5	3	8	0	0	8	0	0
2	25947585	.	T	C	10	3	13	0	0	13	0	0
2	25947593	.	G	A	1	3	4	0	12	16	0	0
2	25947678	.	T	C	6	9	15	0	0	15	0	0
2	25947699	.	T	C	4	10	14	0	0	14	0	0
2	25952953	.	T	C	16	13	29	0	0	29	0	0
2	25952983	.	C	T	12	14	26	0	2	28	0	0
2	25963401	.	T	A	8	11	19	0	0	19	0	0
2	25984751	.	G	A	11	7	18	0	2	20	0	0
2	25984772	.	C	T	10	8	18	0	2	20	0	0
2	25984913	.	T	C	13	9	22	0	1	23	0	0
2	25984928	.	T	C	13	8	21	0	0	21	0	0
2	25984970	.	C	T	15	12	27	0	3	30	0	0
2	25984982	.	C	T	11	15	26	0	1	27	0	0
2	25985012	.	C	T	14	15	29	0	0	29	0	0
2	25985219	.	T	C	15	8	23	0	0	23	0	0
2	25985268	.	G	A	14	11	25	0	2	27	0	0
2	25985300	.	A	C	19	13	32	0	0	32	0	0
2	25985351	.	C	G	12	17	29	0	0	29	0	0
2	25988414	.	G	A	4	9	13	0	14	27	0	0
2	25988475	.	C	T	13	10	23	0	1	24	0	0
2	25988570	.	T	C	13	14	27	0	2	29	0	0
2	25989100	.	A	G	16	12	28	0	1	29	0	0
2	25989290	.	T	G	12	11	23	0	3	26	0	0
2	25990020	.	C	A	20	13	33	0	3	37	1	0
2	25990180	.	C	T	15	23	38	0	4	42	0	0
2	25990302	.	A	G	16	14	30	0	3	33	0	0
2	25990337	.	A	G	18	12	30	0	2	32	0	0
2	25990447	.	G	A	22	16	38	0	0	38	0	0
2	25990522	.	A	C	11	10	21	0	1	22	0	0
2	25990563	.	A	G	14	9	23	0	2	25	0	0
2	25990628	.	C	A	20	12	32	0	1	33	0	0
2	26155762	.	G	A	1	3	4	0	1	5	0	0
2	26155917	.	G	A	0	2	2	0	3	5	0	0
2	26156582	.	G	A	1	2	3	0	0	3	0	0
2	26179171	.	A	T	3	4	7	0	0	7	0	0
2	26196646	.	C	T	4	10	14	0	0	14	0	0
2	26206930	.	A	G	9	8	17	0	0	17	0	0
2	26206942	.	G	T	2	9	11	0	8	19	0	0
2	26207038	.	A	C	9	7	16	0	0	16	0	0
2	26207071	.	C	T	11	7	18	0	0	18	0	0
2	26207080	.	G	C	11	8	19	0	0	19	0	0
2	26207155	.	C	T	9	6	15	0	1	16	0	0
2	26207254	.	A	G	12	9	21	0	0	21	0	0
2	26207263	.	T	A	12	9	21	0	0	21	0	0
2	26207368	.	A	G	12	8	20	0	1	21	0	0
2	26207713	.	G	A	9	5	14	0	0	14	0	0
2	26207752	.	C	T	15	6	21	0	0	21	0	0
2	26207938	.	C	T	14	12	26	0	1	27	0	0
2	26208480	.	A	C	6	8	14	0	1	15	0	0
2	26208520	.	A	G	9	9	18	0	1	19	0	0
2	26208589	.	A	G	11	13	24	0	1	25	0	0
2	26208668	.	T	G	12	1	13	0	11	24	0	0
2	26208733	.	C	A	7	5	12	0	0	12	0	0
2	26208815	.	G	T	10	12	22	0	0	22	0	0
2	26208996	.	A	G	12	5	17	0	0	17	0	0
2	26209120	.	C	T	10	6	16	0	1	17	0	0
2	26209141	.	G	A	6	5	11	0	1	12	0	0
2	26209169	.	C	T	7	7	14	0	0	14	0	0
2	26209266	.	A	C	5	2	7	0	0	7	0	0
2	26209325	.	G	A	4	3	7	0	0	7	0	0
2	26240742	.	C	T	26	22	48	0	4	52	0	0
2	26240805	.	T	C	30	20	50	0	4	54	0	0
2	26240857	.	C	T	24	20	44	0	3	47	0	0
2	26277924	.	C	A	24	23	47	0	2	50	1	0
2	26282745	.	C	T	23	24	47	0	5	52	0	0
2	26282814	.	T	C	20	26	46	0	1	47	0	0
2	26282829	.	A	G	21	0	21	0	24	45	0	0
2	26282916	.	A	G	32	1	33	0	20	53	0	0
2	26297144	.	C	T	3	3	6	0	0	6	0	0
2	26298558	.	A	C	4	2	6	0	0	6	0	0
2	26298571	.	C	T	4	2	6	0	0	6	0	0
2	26298878	.	T	C	3	2	5	0	0	5	0	0
2	26299788	.	C	A	1	2	3	0	0	3	0	0
2	26299803	.	A	G	1	2	3	0	0	3	0	0
2	26300016	.	T	C	11	4	15	0	0	15	0	0
2	26303719	.	T	G	7	0	7	0	10	17	0	0
2	26303985	.	A	G	9	9	18	0	2	20	0	0
2	26304266	.	A	G	8	5	13	0	0	13	0	0
2	26304329	.	A	G	9	4	13	0	0	13	0	0
2	26443211	.	A	C	10	7	17	0	1	18	0	0
2	26443476	.	C	T	1	3	4	0	0	4	0	0
2	26444332	.	C	A	6	3	9	0	0	9	0	0
2	26463124	.	T	G	2	3	5	0	0	5	0	0
2	26463459	.	C	T	0	4	4	0	7	11	0	0
2	26463622	.	A	G	12	5	17	0	1	18	0	0
2	26468243	.	G	A	10	9	19	1	1	21	0	0
2	26468665	.	A	T	9	11	20	0	2	22	0	0
2	26470237	.	G	T	11	17	28	0	0	28	0	0
2	26470267	.	G	A	11	19	30	0	0	30	0	0
2	26470357	.	G	A	16	17	33	0	0	33	0	0
2	26470666	.	A	G	22	18	40	0	1	41	0	0
2	26473078	.	A	G	22	21	43	0	3	46	0	0
2	26473361	.	C	T	21	23	44	0	2	46	0	0
2	26476109	.	G	A	3	3	6	0	0	6	0	0
2	26479695	.	T	C	2	1	3	0	2	5	0	0
2	26479821	.	C	T	5	6	11	0	2	13	0	0
2	26480101	.	A	G	7	0	7	0	9	16	0	0
2	26481029	.	C	T	6	8	14	0	0	14	0	0
2	26483946	.	G	T	10	9	19	0	3	22	0	0
2	26489500	.	C	T	6	9	15	0	1	16	0	0
2	26489681	.	T	C	11	9	20	0	0	20	0	0
2	26491830	.	C	A	12	6	18	0	0	18	0	0
2	26494507	.	G	A	14	11	25	0	0	25	0	0
2	26499519	.	C	T	18	32	50	0	1	51	0	0
2	26500872	.	T	C	28	32	60	0	3	63	0	0
2	26500989	.	C	T	38	36	74	1	2	77	0	0
2	26538490	.	A	G	1	2	3	0	0	3	0	0
2	26576936	.	A	G	1	2	3	0	0	3	0	0
2	26577125	.	T	C	1	3	4	0	0	4	0	0
2	26577189	.	T	C	8	6	14	0	0	14	0	0
2	26577267	.	G	C	11	11	22	0	0	22	0	0
2	26577314	.	T	A	6	11	17	0	0	17	0	0
2	26577378	.	A	G	7	12	19	0	1	20	0	0
2	26578227	.	T	G	8	11	19	0	1	20	0	0
2	26578280	.	G	T	7	8	15	0	0	15	0	0
2	26578464	.	G	A	1	3	4	0	0	4	0	0
2	26586185	.	C	G	3	5	8	0	0	8	0	0
2	26586373	.	A	G	6	8	14	0	1	15	0	0
2	26586393	.	T	C	4	9	13	0	1	14	0	0
2	26599248	.	A	G	3	5	8	0	0	8	0	0
2	26599287	.	G	A	3	4	7	0	0	7	0	0
2	26607181	.	G	C	2	2	4	0	0	4	0	0
2	26607399	.	T	C	2	3	5	0	0	5	0	0
2	26609537	.	T	C	1	2	3	0	0	3	0	0
2	26609651	.	C	A	2	2	4	0	0	4	0	0
2	26609660	.	G	T	4	0	4	0	1	5	0	0
2	26609832	.	G	C	3	2	5	0	1	6	0	0
2	26610677	.	T	C	3	3	6	0	0	6	0	0
2	26612624	.	G	C	3	9	12	0	2	14	0	0
2	26612893	.	T	C	10	14	24	0	1	25	0	0
2	26617098	.	A	G	17	17	34	0	3	37	0	0
2	26619829	.	G	T	13	22	35	0	4	39	0	0
2	26620695	.	A	G	22	16	38	0	1	39	0	0
2	26627301	.	C	A	22	21	43	0	1	44	0	0
2	26627332	.	T	A	21	19	40	0	0	40	0	0
2	26630587	.	C	T	2	23	25	0	16	41	0	0
2	26632384	.	T	G	14	18	32	0	0	32	0	0
2	26632627	.	G	C	30	10	40	1	1	42	0	0
2	26638355	.	T	G	13	15	28	0	1	29	0	0
2	26638809	.	C	T	12	22	34	0	1	35	0	0
2	26639157	.	T	C	17	20	37	0	1	38	0	0
2	26639217	.	A	G	27	12	39	0	2	41	0	0
2	26662113	.	T	C	7	13	20	0	1	21	0	0
2	26662143	.	T	A	7	11	18	0	1	19	0	0
2	26665065	.	A	G	11	11	22	0	1	23	0	0
2	26665081	.	A	G	12	11	23	0	2	25	0	0
2	26665198	.	T	C	4	11	15	0	0	15	0	0
2	26665199	.	T	C	4	11	15	0	0	15	0	0
2	26665631	.	A	T	6	7	13	0	0	13	0	0
2	26665650	.	A	G	5	9	14	0	0	14	0	0
2	26672266	.	A	G	12	18	30	0	1	31	0	0
2	26672320	.	G	A	14	10	24	0	1	25	0	0
2	26672395	.	G	A	13	6	19	0	0	19	0	0
2	26672440	.	A	G	13	6	19	0	0	19	0	0
2	26672672	.	G	A	6	12	18	0	0	18	0	0
2	26672761	.	T	G	3	0	3	0	5	8	0	0
2	26672826	.	A	C	3	3	6	1	0	7	0	0
2	26676715	.	T	A	7	8	15	0	0	15	0	0
2	26676759	.	T	C	5	8	13	0	0	13	0	0
2	26676807	.	T	A	5	4	9	0	0	9	0	0
2	26677109	.	T	A	4	4	8	0	0	8	0	0
2	26677111	.	T	A	4	4	8	0	0	8	0	0
2	26677361	.	C	A	8	4	12	2	0	14	0	0
2	26677445	.	A	G	7	7	14	0	1	15	0	0
2	26677453	.	T	C	8	9	17	0	0	17	0	0
2	26677512	.	A	T	10	6	16	0	0	16	0	0
2	26677513	.	G	A	8	6	14	0	1	15	0	0
2	26680213	.	G	A	2	3	5	0	0	5	0	0
2	26680440	.	G	A	2	3	5	0	0	5	0	0
2	26680920	.	T	G	5	3	8	0	1	9	0	0
2	26681076	.	A	G	9	5	14	0	0	14	0	0
2	26681214	.	A	C	3	5	8	0	0	8	0	0
2	26681499	.	T	G	4	2	6	0	1	7	0	0
2	26681500	.	A	T	5	2	7	0	0	7	0	0
2	26681793	.	G	T	3	0	3	0	0	8	5	0
2	26681837	.	G	A	7	7	14	0	1	15	0	0
2	26681942	.	A	C	8	3	11	0	0	11	0	0
2	26681958	.	G	T	9	2	11	0	0	11	0	0
2	26682031	.	G	T	0	4	4	0	9	13	0	0
2	26683155	.	A	T	6	5	11	0	0	11	0	0
2	26688691	.	A	T	3	7	10	0	1	11	0	0
2	26688737	.	G	A	5	3	8	0	0	8	0	0
2	26688747	.	A	G	3	1	4	0	3	8	1	0
2	26697666	.	C	T	0	7	7	0	4	11	0	0
2	26697929	.	A	G	6	9	15	0	2	17	0	0
2	26701246	.	C	T	0	3	3	0	7	10	0	0
2	26704721	.	A	G	5	6	11	0	0	11	0	0
2	26704749	.	A	T	2	3	5	0	1	6	0	0
2	26706312	.	A	G	2	2	4	0	0	4	0	0
2	26706416	.	T	A	2	3	5	0	1	6	0	0
2	26714144	.	A	G	4	5	9	0	1	10	0	0
2	26714291	.	T	C	1	0	1	0	8	9	0	0
2	26716126	.	G	A	4	9	13	0	0	13	0	0
2	27000728	.	G	T	2	9	11	0	4	15	0	0
2	27000729	.	A	C	6	9	15	0	0	15	0	0
2	27010298	.	A	C	2	2	4	0	0	4	0	0
2	27010330	.	A	G	2	0	2	0	6	8	0	0
2	27048999	.	C	A	4	6	10	0	0	10	0	0
2	27064687	.	T	C	8	6	14	0	0	14	0	0
2	27330716	.	A	C	1	5	6	0	0	6	0	0
2	27330756	.	T	A	3	5	8	0	0	8	0	0
2	27330838	.	T	A	3	5	8	0	0	8	0	0
2	27341572	.	C	A	7	3	10	0	0	10	0	0
2	27341611	.	A	T	4	3	7	0	0	7	0	0
2	27341726	.	C	T	7	2	9	0	0	9	0	0
2	27372537	.	C	G	6	7	13	0	1	14	0	0
2	27372576	.	G	A	8	4	12	0	1	13	0	0
2	27377541	.	T	A	3	5	8	0	0	8	0	0
2	27377590	.	T	C	9	5	14	0	0	14	0	0
2	27378071	.	T	A	4	3	7	0	1	8	0	0
2	27378439	.	A	G	6	0	6	0	5	11	0	0
2	27378524	.	T	A	1	3	4	0	1	5	0	0
2	27379550	.	A	C	1	3	4	0	0	4	0	0
2	27380114	.	A	G	3	2	5	0	0	5	0	0
2	27380292	.	G	T	4	5	9	0	0	9	0	0
2	27380336	.	G	A	4	6	10	0	0	10	0	0
2	27380366	.	C	A	1	4	5	0	5	10	0	0
2	27380500	.	G	T	9	5	14	0	0	14	0	0
2	27382232	.	C	G	8	3	11	0	0	11	0	0
2	27382489	.	G	A	2	8	10	0	0	10	0	0
2	27384708	.	C	T	3	4	7	0	0	7	0	0
2	27384765	.	G	C	2	2	4	0	3	7	0	0
2	27385701	.	C	A	2	2	4	0	1	5	0	0
2	27385755	.	T	A	3	2	5	0	0	5	0	0
2	27390931	.	A	G	3	0	3	0	3	6	0	0
2	27390970	.	C	T	3	4	7	0	0	7	0	0
2	27390973	.	A	G	2	0	2	0	4	6	0	0
2	27491075	.	A	C	1	3	4	0	0	4	0	0
2	27532523	.	A	G	9	6	15	0	1	16	0	0
2	27534267	.	G	A	9	7	16	0	0	16	0	0
2	27540182	.	C	T	9	9	18	0	0	18	0	0
2	27540488	.	C	A	16	19	35	0	0	35	0	0
2	27540614	.	C	T	14	15	29	0	0	29	0	0
2	27540905	.	T	C	13	19	32	0	1	33	0	0
2	27541216	.	G	T	2	6	8	0	3	11	0	0
2	27541246	.	A	C	6	5	11	0	0	11	0	0
2	27541468	.	C	T	13	5	18	1	1	20	0	0
2	27541914	.	A	C	9	10	19	0	1	20	0	0
2	27542083	.	G	A	16	8	24	1	0	25	0	0
2	27542958	.	A	G	9	6	15	0	0	15	0	0
2	27543499	.	C	A	8	5	13	0	2	15	0	0
2	27562729	.	T	C	1	2	3	0	0	3	0	0
2	27614046	.	A	G	3	4	7	0	0	7	0	0
2	27614082	.	G	C	5	4	9	0	0	9	0	0
2	27635488	.	T	C	3	2	5	0	1	6	0	0
2	27635849	.	C	A	4	8	12	0	0	12	0	0
2	27635928	.	T	A	4	5	9	0	1	10	0	0
2	27641159	.	T	C	4	0	4	0	6	10	0	0
2	27641287	.	G	A	4	7	11	0	0	11	0	0
2	27642776	.	C	G	3	4	7	0	0	7	0	0
2	27642810	.	T	G	5	5	10	0	0	10	0	0
2	27646615	.	A	C	4	5	9	0	0	9	0	0
2	27646626	.	C	G	4	5	9	0	0	9	0	0
2	27658973	.	T	G	12	4	16	0	0	16	0	0
2	27659018	.	T	C	14	4	18	0	0	18	0	0
2	27662706	.	T	C	1	3	4	0	0	4	0	0
2	27662711	.	T	G	1	0	1	0	2	3	0	0
2	27662744	.	A	T	2	5	7	0	0	7	0	0
2	27662824	.	T	C	2	2	4	0	0	4	0	0
2	27662916	.	A	T	2	2	4	0	0	4	0	0
2	27663673	.	G	A	1	5	6	0	6	12	0	0
2	27663867	.	C	T	2	4	6	0	0	6	0	0
2	27663922	.	G	C	2	3	5	0	0	5	0	0
2	27663938	.	A	T	3	4	7	0	0	7	0	0
2	27664195	.	A	C	2	4	6	0	1	7	0	0
2	27664317	.	G	T	2	3	5	0	0	5	0	0
2	27664380	.	G	A	4	3	7	0	0	7	0	0
2	27664407	.	G	C	4	3	7	0	0	7	0	0
2	27670764	.	T	C	22	2	24	0	1	25	0	0
2	27670836	.	C	T	1	11	12	0	14	26	0	0
2	27670886	.	T	C	10	0	10	0	15	25	0	0
2	27672705	.	A	G	10	9	19	0	1	20	0	0
2	27673041	.	A	G	14	18	32	0	0	32	0	0
2	27673173	.	A	G	11	15	26	0	3	29	0	0
2	27673194	.	C	T	10	13	23	0	0	23	0	0
2	27673233	.	T	C	10	11	21	0	1	22	0	0
2	27691348	.	T	C	11	1	12	0	11	23	0	0
2	27691375	.	G	A	11	12	23	0	1	24	0	0
2	27691408	.	T	C	13	13	26	0	1	27	0	0
2	27691459	.	A	G	13	10	23	0	1	24	0	0
2	27812578	.	G	A	5	5	10	0	0	10	0	0
2	27812592	.	C	A	6	4	10	0	0	10	0	0
2	27827558	.	G	A	3	2	5	2	0	7	0	0
2	27827573	.	C	T	3	2	5	1	0	6	0	0
2	27843848	.	C	T	2	4	6	0	2	8	0	0
2	27845845	.	A	T	5	8	13	0	0	14	1	0
2	27846053	.	T	A	4	5	9	0	1	10	0	0
2	27846108	.	G	A	11	11	22	0	2	24	0	0
2	27848151	.	T	G	9	9	18	0	2	20	0	0
2	27849787	.	G	A	9	4	13	0	1	14	0	0
2	27932918	.	G	A	3	2	5	0	0	5	0	0
2	27932919	.	A	G	3	2	5	0	0	5	0	0
2	27933143	.	C	T	4	6	10	0	0	10	0	0
2	27933215	.	C	A	5	4	9	0	2	11	0	0
2	27933260	.	C	A	9	6	15	0	0	15	0	0
2	27933404	.	A	G	8	0	8	0	3	11	0	0
2	27933764	.	G	T	1	4	5	0	0	5	0	0
2	27969534	.	T	C	3	2	5	0	0	5	0	0
2	27975150	.	G	A	1	3	4	0	0	4	0	0
2	28049445	.	T	C	13	14	27	0	1	28	0	0
2	28049996	.	A	G	12	6	18	0	2	20	0	0
2	28050565	.	T	A	12	9	21	0	0	21	0	0
2	28050600	.	G	C	7	0	7	0	8	15	0	0
2	28050759	.	A	G	5	8	13	0	0	13	0	0
2	28050933	.	G	A	12	5	17	0	0	17	0	0
2	28057518	.	G	A	10	9	19	0	0	19	0	0
2	28077152	.	C	A	1	6	7	0	11	18	0	0
2	28077171	.	A	G	11	6	17	0	0	17	0	0
2	28085730	.	T	A	6	8	14	0	1	15	0	0
2	28085746	.	A	G	8	9	17	0	0	17	0	0
2	28490544	.	G	A	0	2	2	0	2	4	0	0
2	28500871	.	G	A	1	2	3	0	0	3	0	0
2	28503260	.	G	A	1	0	1	0	2	3	0	0
2	28503323	.	T	A	2	2	4	0	0	4	0	0
2	28521107	.	A	C	3	3	6	0	0	6	0	0
2	28650352	.	A	C	4	3	7	0	0	7	0	0
2	28650358	.	T	A	3	4	7	0	0	7	0	0
2	28650422	.	T	C	2	4	6	0	1	7	0	0
2	28650504	.	T	C	3	9	12	0	2	14	0	0
2	28650567	.	G	T	8	4	12	0	0	12	0	0
2	28650612	.	T	G	12	4	16	0	0	16	0	0
2	28650629	.	G	T	13	5	18	0	0	18	0	0
2	28651128	.	T	A	12	12	24	0	1	25	0	0
2	28651193	.	A	G	10	12	22	0	0	22	0	0
2	28651497	.	G	A	4	5	9	0	1	11	1	0
2	28653587	.	A	G	10	3	13	0	0	13	0	0
2	28653707	.	C	G	5	5	10	0	0	10	0	0
2	28657777	.	G	A	4	3	7	0	0	7	0	0
2	28659726	.	A	C	5	6	11	0	0	11	0	0
2	28659998	.	C	G	9	5	14	0	0	14	0	0
2	28902738	.	C	T	6	4	10	0	0	10	0	0
2	28930159	.	T	C	5	4	9	0	0	9	0	0
2	28934011	.	C	T	17	7	24	0	1	25	0	0
2	28934041	.	A	G	13	0	13	0	7	20	0	0
2	29032134	.	T	C	3	3	6	0	0	6	0	0
2	29032141	.	A	C	2	3	5	0	0	5	0	0
2	29105857	.	T	A	1	3	4	0	0	4	0	0
2	29105890	.	C	T	1	5	6	0	0	6	0	0
2	29257726	.	T	C	4	8	12	0	0	12	0	0
2	29310996	.	G	A	0	10	10	0	9	19	0	0
2	29317718	.	G	A	8	8	16	0	0	16	0	0
2	29352333	.	G	A	1	9	10	0	11	21	0	0
2	29352479	.	C	T	6	7	13	0	1	14	0	0
2	29477538	.	A	G	1	2	3	0	0	3	0	0
2	29477733	.	A	T	18	13	31	0	0	31	0	0
2	29477769	.	G	T	13	11	24	0	1	25	0	0
2	29477895	.	A	T	18	5	23	0	0	23	0	0
2	29477979	.	T	G	8	5	13	0	1	14	0	0
2	29484113	.	A	G	15	13	28	0	2	30	0	0
2	29485046	.	G	A	18	11	29	0	0	29	0	0
2	29491445	.	C	T	4	3	7	0	0	7	0	0
2	29491504	.	T	C	6	12	18	0	0	18	0	0
2	29610050	.	A	T	6	6	12	0	1	13	0	0
2	29610350	.	A	G	1	8	9	0	0	9	0	0
2	29610464	.	G	A	4	10	14	0	0	14	0	0
2	29610866	.	A	C	4	5	9	0	0	9	0	0
2	29676848	.	T	C	5	7	12	0	2	14	0	0
2	29685506	.	G	A	7	12	19	0	2	21	0	0
2	29685575	.	A	G	9	0	9	0	8	17	0	0
2	29842836	.	T	C	1	2	3	0	0	3	0	0
2	29892926	.	G	A	4	2	6	0	0	6	0	0
2	29894409	.	A	T	2	2	4	0	1	5	0	0
2	29894410	.	C	T	3	2	5	0	0	5	0	0
2	29894753	.	G	C	1	2	3	0	1	4	0	0
2	29902998	.	A	G	1	3	4	0	0	4	0	0
2	29903018	.	C	A	1	3	4	0	0	4	0	0
2	29905111	.	T	A	4	11	15	0	0	15	0	0
2	29910525	.	A	G	5	7	12	0	0	12	0	0
2	29911153	.	T	C	5	4	9	0	0	9	0	0
2	29914114	.	C	G	10	3	13	0	0	13	0	0
2	29914231	.	G	T	6	2	8	0	0	8	0	0
2	29915582	.	C	G	7	4	11	0	0	11	0	0
2	29915902	.	A	G	4	6	10	0	0	10	0	0
2	29915908	.	A	G	4	6	10	0	0	10	0	0
2	29976452	.	A	T	3	5	8	0	0	8	0	0
2	29976960	.	T	A	7	3	10	0	0	10	0	0
2	30032886	.	T	C	1	2	3	0	0	3	0	0
2	30106271	.	A	G	24	19	43	0	3	46	0	0
2	30108443	.	T	C	15	16	31	0	2	33	0	0
2	30108456	.	T	C	17	16	33	0	1	34	0	0
2	30108542	.	T	G	9	11	20	0	0	20	0	0
2	30109588	.	G	C	2	4	6	0	0	6	0	0
2	30109678	.	C	T	12	8	20	0	0	20	0	0
2	30116206	.	C	T	8	13	21	0	0	21	0	0
2	30116586	.	C	A	10	9	19	0	0	19	0	0
2	30116589	.	C	T	10	9	19	0	1	20	0	0
2	30116688	.	A	C	10	3	13	0	1	14	0	0
2	30116808	.	T	A	16	9	25	1	0	26	0	0
2	30116889	.	C	A	15	8	23	1	1	25	0	0
2	30116905	.	A	G	17	4	21	0	0	21	0	0
2	30117123	.	C	A	5	5	10	0	1	11	0	0
2	30117245	.	A	T	5	5	10	0	1	11	0	0
2	30117249	.	A	T	6	6	12	0	0	12	0	0
2	30178100	.	C	T	20	21	41	0	3	44	0	0
2	30182631	.	G	T	2	2	4	0	0	4	0	0
2	30183676	.	T	A	4	3	7	0	0	7	0	0
2	30183703	.	G	A	1	3	4	0	1	5	0	0
2	30184968	.	T	A	2	4	6	0	0	6	0	0
2	30194436	.	G	T	5	2	7	0	0	7	0	0
2	30194777	.	C	T	5	7	12	0	0	12	0	0
2	30194938	.	G	A	9	4	13	0	0	13	0	0
2	30245900	.	G	C	3	5	8	0	0	8	0	0
2	30245922	.	T	C	3	9	12	0	0	12	0	0
2	30246029	.	T	A	5	15	20	0	0	20	0	0
2	30250126	.	A	T	6	6	12	0	1	14	1	0
2	30251622	.	A	G	3	4	7	0	0	7	0	0
2	30251864	.	G	T	6	4	10	0	0	10	0	0
2	30252029	.	T	C	4	10	14	0	0	14	0	0
2	30252071	.	G	A	0	5	5	0	5	10	0	0
2	30290749	.	A	G	3	4	7	0	0	7	0	0
2	30291072	.	A	C	11	6	17	0	0	17	0	0
2	30295050	.	T	A	7	10	17	0	2	19	0	0
2	30295052	.	T	G	8	10	18	0	1	19	0	0
2	30295155	.	G	C	2	7	9	0	2	11	0	0
2	30295156	.	G	A	2	2	4	0	7	11	0	0
2	30295288	.	A	G	12	14	26	0	3	29	0	0
2	30319374	.	C	T	9	5	14	0	0	14	0	0
2	30319375	.	T	G	9	5	14	0	0	14	0	0
2	30319463	.	C	G	5	9	14	0	0	14	0	0
2	30423663	.	C	G	3	4	7	0	1	8	0	0
2	30428310	.	C	G	7	3	10	0	1	11	0	0
2	30428553	.	G	A	1	5	6	0	7	13	0	0
2	30428790	.	A	T	5	2	7	0	0	7	0	0
2	30429006	.	C	T	2	6	8	0	0	8	0	0
2	30429367	.	C	T	4	3	7	0	0	7	0	0
2	30429710	.	A	T	6	8	14	0	1	15	0	0
2	30429711	.	T	C	5	8	13	0	1	14	0	0
2	30430226	.	T	A	1	2	3	0	0	3	0	0
2	30458754	.	G	A	14	33	47	0	0	47	0	0
2	30460135	.	A	G	11	11	22	0	3	25	0	0
2	30481172	.	T	G	6	6	12	0	0	12	0	0
2	30481379	.	G	A	3	2	5	0	0	5	0	0
2	30503714	.	T	C	5	8	13	0	1	14	0	0
2	30504472	.	A	G	3	6	9	0	1	10	0	0
2	30506562	.	T	C	6	6	12	0	0	12	0	0
2	30519768	.	C	T	7	18	25	0	1	26	0	0
2	30519975	.	G	A	2	11	13	0	12	25	0	0
2	30520026	.	G	T	18	19	37	0	0	37	0	0
2	30523047	.	A	G	9	5	14	0	2	16	0	0
2	30523053	.	C	T	11	6	17	0	0	17	0	0
2	30524966	.	C	T	20	20	40	0	0	40	0	0
2	30524992	.	T	C	18	21	39	0	1	40	0	0
2	30525062	.	A	G	19	13	32	0	1	33	0	0
2	30525105	.	A	G	22	13	35	0	4	39	0	0
2	30525117	.	C	T	25	13	38	0	1	39	0	0
2	30525169	.	G	T	3	11	14	5	21	40	0	0
2	30525297	.	T	C	11	9	20	0	0	20	0	0
2	30525378	.	C	A	7	8	15	0	0	15	0	0
2	30525596	.	A	G	23	1	24	0	16	40	0	0
2	30525970	.	A	G	20	12	32	0	1	33	0	0
2	30554512	.	G	A	15	12	27	0	0	27	0	0
2	30556102	.	C	A	0	20	20	0	16	36	0	0
2	30556103	.	G	T	15	18	33	0	3	36	0	0
2	30556386	.	G	A	19	12	31	0	4	35	0	0
2	30556419	.	G	T	25	13	38	0	2	40	0	0
2	30561285	.	T	C	18	12	30	0	3	33	0	0
2	30568944	.	A	T	16	15	31	0	1	32	0	0
2	30568959	.	C	T	15	19	34	0	0	34	0	0
2	30579831	.	G	A	16	11	27	0	1	28	0	0
2	30613964	.	A	G	15	16	31	0	0	31	0	0
2	30614153	.	C	A	17	12	29	0	2	31	0	0
2	30618155	.	C	T	8	14	22	0	7	29	0	0
2	30693533	.	A	G	10	10	20	0	0	20	0	0
2	30693612	.	A	G	11	4	15	0	0	15	0	0
2	30743041	.	T	C	16	16	32	0	1	33	0	0
2	30743864	.	A	G	9	7	16	0	4	20	0	0
2	30743907	.	T	C	13	19	32	0	1	33	0	0
2	30743951	.	C	A	21	15	36	0	1	37	0	0
2	30752675	.	C	T	3	5	8	0	0	8	0	0
2	30753072	.	A	T	13	12	25	0	0	25	0	0
2	30753273	.	G	A	10	6	16	0	3	19	0	0
2	30753720	.	C	T	2	6	8	0	12	20	0	0
2	30753722	.	A	C	14	6	20	0	0	20	0	0
2	30753813	.	G	A	9	5	14	0	1	15	0	0
2	30753928	.	G	A	3	9	12	0	0	12	0	0
2	30753991	.	A	G	8	4	12	0	3	15	0	0
2	30754113	.	T	C	11	18	29	1	1	31	0	0
2	30754196	.	G	A	16	16	32	0	3	35	0	0
2	30754300	.	C	T	19	18	37	0	2	39	0	0
2	30754346	.	A	G	21	17	38	0	3	41	0	0
2	30754432	.	G	T	18	11	29	0	2	31	0	0
2	30754777	.	A	T	6	14	20	0	0	20	0	0
2	30754793	.	A	T	5	8	13	0	1	14	0	0
2	30754885	.	A	T	11	7	18	0	0	18	0	0
2	30755345	.	T	G	9	6	15	2	0	17	0	0
2	30755386	.	T	C	11	0	11	2	5	18	0	0
2	30755733	.	A	T	7	3	10	0	0	10	0	0
2	30755886	.	C	G	11	6	17	0	2	19	0	0
2	30755887	.	C	A	10	7	17	0	2	19	0	0
2	30756091	.	T	C	4	6	10	0	0	10	0	0
2	30756157	.	G	T	7	8	15	0	0	15	0	0
2	30756264	.	A	G	11	8	19	0	0	19	0	0
2	30756320	.	T	A	4	3	7	0	0	7	0	0
2	30756903	.	A	G	11	12	23	0	2	25	0	0
2	30786795	.	T	C	9	9	18	0	1	19	0	0
2	30787387	.	A	C	20	31	51	3	3	59	2	0
2	30794792	.	T	C	24	19	43	0	2	45	0	0
2	30821859	.	G	A	23	26	49	0	0	49	0	0
2	30821965	.	C	T	25	23	48	0	1	49	0	0
2	30823438	.	T	G	26	1	27	1	23	52	1	0
2	30846719	.	A	G	22	14	36	0	2	38	0	0
2	30883008	.	A	G	1	3	4	0	0	4	0	0
2	30883131	.	G	A	3	3	6	0	0	6	0	0
2	30886240	.	T	C	3	3	6	0	0	6	0	0
2	30886397	.	T	C	5	4	9	0	0	9	0	0
2	30897111	.	C	T	13	13	26	0	0	26	0	0
2	30897990	.	C	T	14	7	21	0	1	22	0	0
2	30898196	.	T	C	13	11	24	0	0	24	0	0
2	30900927	.	C	A	8	13	21	0	2	23	0	0
2	30900945	.	G	C	11	8	19	0	0	19	0	0
2	30900994	.	T	A	13	11	24	0	0	24	0	0
2	30901060	.	A	G	15	2	17	0	7	24	0	0
2	30904137	.	G	A	20	16	36	0	2	38	0	0
2	30905298	.	G	A	13	15	28	0	0	28	0	0
2	30906386	.	C	T	14	13	27	0	0	27	0	0
2	30907655	.	T	A	12	11	23	2	2	27	0	0
2	30908006	.	A	T	4	5	9	0	1	10	0	0
2	30953014	.	T	A	2	2	4	0	0	4	0	0
2	30960401	.	A	G	15	12	27	0	3	30	0	0
2	30960455	.	A	G	12	0	12	0	10	22	0	0
2	30960456	.	T	C	12	10	22	0	0	22	0	0
2	30971642	.	T	C	12	9	21	0	0	21	0	0
2	30971726	.	T	C	11	12	23	0	0	23	0	0
2	30971783	.	T	C	9	7	16	0	8	24	0	0
2	30971951	.	G	A	7	11	18	0	1	19	0	0
2	30972259	.	A	G	14	1	15	0	7	22	0	0
2	30982089	.	C	T	12	11	23	0	1	24	0	0
2	30982409	.	T	C	23	12	35	0	4	39	0	0
2	30982612	.	T	C	18	17	35	0	2	37	0	0
2	30982640	.	A	G	15	14	29	0	0	29	0	0
2	30982897	.	A	G	14	5	19	0	0	19	0	0
2	30982929	.	T	A	13	9	22	0	0	22	0	0
2	30983267	.	G	A	17	10	27	0	1	28	0	0
2	30983294	.	T	C	16	8	24	0	3	27	0	0
2	31297980	.	A	G	29	24	53	0	1	54	0	0
2	31298077	.	A	G	21	35	56	0	1	57	0	0
2	31298280	.	A	G	28	26	54	0	3	57	0	0
2	31298342	.	G	A	37	18	55	0	1	56	0	0
2	31298483	.	C	A	26	25	51	0	1	52	0	0
2	31298550	.	T	C	28	17	45	0	1	46	0	0
2	31298703	.	T	G	21	23	44	0	1	45	0	0
2	31298723	.	C	T	21	29	50	0	3	53	0	0
2	31298824	.	A	C	35	32	67	0	1	68	0	0
2	31299241	.	A	C	12	20	32	0	2	34	0	0
2	31301318	.	T	C	5	6	11	0	0	11	0	0
2	31302609	.	C	T	10	5	15	0	0	15	0	0
2	31308668	.	T	A	7	5	12	0	0	12	0	0
2	31336811	.	C	T	5	6	11	1	0	12	0	0
2	31345207	.	A	C	9	4	13	0	0	13	0	0
2	31348414	.	C	T	9	10	19	0	1	20	0	0
2	31348474	.	G	A	2	9	11	0	11	22	0	0
2	31360724	.	G	A	8	9	17	0	0	17	0	0
2	31360799	.	G	A	15	8	23	0	3	26	0	0
2	31361205	.	C	T	8	13	21	0	1	22	0	0
2	31361380	.	A	C	5	2	7	0	1	8	0	0
2	31361466	.	C	G	8	6	14	1	0	15	0	0
2	31361836	.	A	G	3	3	6	0	0	6	0	0
2	31362285	.	A	G	15	4	19	0	1	20	0	0
2	31362642	.	T	C	8	9	17	0	0	17	0	0
2	31362681	.	T	C	7	7	14	0	0	14	0	0
2	31362730	.	A	T	7	7	14	0	0	14	0	0
2	31362859	.	T	A	5	7	12	0	0	12	0	0
2	31362896	.	T	C	6	6	12	0	1	13	0	0
2	31363190	.	C	T	11	15	26	0	0	26	0	0
2	31430802	.	G	A	1	2	3	0	0	3	0	0
2	31434587	.	A	T	1	2	3	0	0	3	0	0
2	31451518	.	G	A	7	8	15	0	0	15	0	0
2	31451542	.	G	A	8	9	17	0	0	17	0	0
2	31451568	.	C	T	9	9	18	0	0	18	0	0
2	31451778	.	G	T	14	13	27	0	1	28	0	0
2	31451871	.	T	A	12	9	21	0	0	21	0	0
2	31452078	.	C	T	19	12	31	0	2	33	0	0
2	31452226	.	T	C	22	17	39	0	0	39	0	0
2	31452354	.	C	T	21	12	33	0	0	33	0	0
2	31499397	.	A	G	6	4	10	0	0	10	0	0
2	31507750	.	A	T	5	7	12	0	0	12	0	0
2	31507882	.	T	C	7	10	17	0	0	17	0	0
2	31511622	.	G	A	1	12	13	0	10	23	0	0
2	31511760	.	C	A	15	7	22	0	0	22	0	0
2	31511763	.	C	T	17	7	24	0	0	24	0	0
2	31511810	.	C	A	17	7	24	0	1	25	0	0
2	31511884	.	A	C	14	8	22	0	0	22	0	0
2	31511945	.	G	A	12	8	20	0	0	20	0	0
2	31511946	.	G	A	11	8	19	0	1	20	0	0
2	31517100	.	G	A	4	2	6	0	1	7	0	0
2	31627079	.	T	A	5	4	9	0	0	9	0	0
2	31627150	.	C	A	7	4	11	0	0	11	0	0
2	31627173	.	C	T	5	5	10	0	0	10	0	0
2	31627212	.	C	G	8	4	12	0	1	13	0	0
2	31627219	.	C	T	9	3	12	0	0	12	0	0
2	31627423	.	C	G	2	3	5	0	6	11	0	0
2	31630129	.	A	T	7	12	19	0	0	19	0	0
2	31630443	.	G	A	7	9	16	1	1	18	0	0
2	31634870	.	A	G	5	11	16	0	1	17	0	0
2	31634929	.	A	C	9	9	18	0	1	19	0	0
2	31635007	.	A	T	9	6	15	0	3	18	0	0
2	31635161	.	A	G	11	9	20	0	1	21	0	0
2	31635229	.	C	T	6	5	11	0	1	12	0	0
2	31635287	.	T	C	10	7	17	0	2	19	0	0
2	31635395	.	T	G	11	11	22	0	0	22	0	0
2	31635490	.	A	T	12	17	29	0	0	29	0	0
2	31635599	.	T	C	13	7	20	0	3	23	0	0
2	31635803	.	G	T	10	5	15	0	1	16	0	0
2	31635824	.	C	T	8	4	12	0	0	12	0	0
2	31635859	.	C	T	6	4	10	0	0	10	0	0
2	31635860	.	T	C	6	4	10	0	0	10	0	0
2	31635900	.	T	C	8	5	13	0	0	13	0	0
2	31636048	.	A	G	13	7	20	0	0	20	0	0
2	31636057	.	T	C	12	0	12	0	5	17	0	0
2	31638004	.	C	T	8	4	12	0	1	13	0	0
2	31638064	.	G	A	8	2	10	0	2	12	0	0
2	31638111	.	G	T	9	4	13	0	1	14	0	0
2	31638124	.	G	A	10	6	16	0	0	16	0	0
2	31638323	.	A	C	9	0	9	0	7	17	1	0
2	31640332	.	G	A	11	5	16	0	0	16	0	0
2	31640534	.	C	A	7	2	9	0	0	9	0	0
2	31640535	.	C	T	0	2	2	0	7	9	0	0
2	31650963	.	T	G	4	6	10	0	1	11	0	0
2	31687529	.	A	G	1	2	3	0	0	3	0	0
2	31687537	.	A	C	2	0	2	0	2	4	0	0
2	31687697	.	G	A	3	9	12	0	0	12	0	0
2	31690434	.	T	A	6	16	22	0	0	22	0	0
2	31690442	.	A	C	5	13	18	0	1	19	0	0
2	31692370	.	T	C	4	7	11	0	1	12	0	0
2	31696687	.	A	C	2	2	4	0	0	4	0	0
2	31700250	.	A	C	1	8	9	0	0	9	0	0
2	31700352	.	A	T	3	7	10	0	0	10	0	0
2	31700378	.	T	G	1	8	9	0	0	9	0	0
2	31703368	.	T	A	2	11	13	0	1	14	0	0
2	31703407	.	A	G	3	6	9	0	0	9	0	0
2	31703443	.	C	T	1	5	6	0	0	6	0	0
2	31703678	.	C	T	3	7	10	0	0	10	0	0
2	31708075	.	C	G	1	4	5	0	0	5	0	0
2	31709425	.	A	C	1	3	4	0	0	4	0	0
2	31710374	.	A	T	3	4	7	0	0	7	0	0
2	31710653	.	A	T	1	3	4	0	1	5	0	0
2	31719452	.	C	T	3	5	8	0	1	9	0	0
2	31722631	.	A	T	16	8	24	0	0	24	0	0
2	31727584	.	G	C	8	12	20	0	0	20	0	0
2	31735068	.	T	G	6	4	10	0	0	10	0	0
2	31741196	.	A	T	4	2	6	0	1	7	0	0
2	31781957	.	C	T	0	3	3	0	4	7	0	0
2	31782003	.	T	C	10	6	16	0	1	17	0	0
2	31784132	.	A	T	8	6	14	0	1	15	0	0
2	31806920	.	C	T	10	7	17	0	2	19	0	0
2	31820830	.	T	C	9	8	17	0	0	17	0	0
2	31821290	.	C	A	10	11	21	0	1	22	0	0
2	31826750	.	C	T	19	15	34	0	1	35	0	0
2	31826942	.	C	A	7	4	11	0	3	14	0	0
2	31827407	.	G	A	10	2	12	0	1	13	0	0
2	31827649	.	A	G	14	12	26	0	1	27	0	0
2	31827714	.	A	G	10	1	11	0	9	20	0	0
2	31830252	.	C	T	1	2	3	0	0	3	0	0
2	31830367	.	A	G	5	2	7	0	0	7	0	0
2	31830382	.	C	A	5	3	8	0	0	8	0	0
2	31830410	.	G	A	5	6	11	0	0	11	0	0
2	31832360	.	T	C	9	7	16	0	2	18	0	0
2	31833082	.	C	T	6	11	17	0	0	17	0	0
2	31834099	.	G	T	22	18	40	0	1	41	0	0
2	31834110	.	T	C	23	14	37	0	2	39	0	0
2	31834187	.	C	T	14	7	21	0	0	21	0	0
2	31836113	.	T	G	17	14	31	0	1	32	0	0
2	31836119	.	G	T	1	11	12	0	21	33	0	0
2	31836307	.	T	A	25	13	38	0	0	38	0	0
2	31836440	.	A	G	7	0	7	0	9	16	0	0
2	31836508	.	G	A	3	4	7	0	0	7	0	0
2	31836512	.	A	G	3	0	3	0	4	7	0	0
2	31836550	.	C	A	1	3	4	0	0	4	0	0
2	31836588	.	T	C	5	4	9	0	0	9	0	0
2	31838524	.	A	G	15	17	32	0	3	35	0	0
2	31842454	.	T	G	12	7	19	0	2	21	0	0
2	31861353	.	T	C	2	2	4	0	0	4	0	0
2	31861377	.	A	T	2	2	4	0	0	4	0	0
2	31891344	.	T	A	11	8	19	0	0	19	0	0
2	31891447	.	A	T	20	15	35	0	2	37	0	0
2	31891513	.	T	C	15	28	43	0	3	46	0	0
2	31891549	.	C	A	16	30	46	0	0	46	0	0
2	31891618	.	A	G	33	20	53	0	0	53	0	0
2	31892076	.	A	G	23	14	37	0	0	37	0	0
2	31892100	.	C	T	2	16	18	0	26	44	0	0
2	31894220	.	T	C	34	19	53	0	0	53	0	0
2	31901953	.	T	C	22	18	40	0	0	40	0	0
2	31902939	.	G	A	15	17	32	0	0	32	0	0
2	31902954	.	C	T	15	15	30	0	2	32	0	0
2	31913491	.	A	G	14	21	35	0	0	35	0	0
2	31919171	.	G	A	15	22	37	0	0	37	0	0
2	31927266	.	C	T	3	26	29	1	20	50	0	0
2	31942513	.	G	A	5	2	7	0	0	7	0	0
2	31943041	.	A	G	7	7	14	0	0	14	0	0
2	31943187	.	A	G	4	9	13	0	0	13	0	0
2	31944840	.	C	T	4	4	8	0	0	8	0	0
2	31948424	.	A	G	5	6	11	0	1	12	0	0
2	31948438	.	A	G	6	7	13	0	0	13	0	0
2	31948459	.	C	T	7	11	18	0	0	18	0	0
2	31957808	.	T	C	20	20	40	0	2	42	0	0
2	31975190	.	G	C	18	9	27	0	0	27	0	0
2	31987267	.	A	G	16	14	30	0	0	30	0	0
2	31987352	.	A	C	20	17	37	0	0	37	0	0
2	31987360	.	C	T	19	18	37	0	0	37	0	0
2	31989876	.	T	C	16	18	34	0	0	34	0	0
2	31993886	.	T	C	23	23	46	0	3	49	0	0
2	32005371	.	G	A	27	21	48	2	1	51	0	0
2	32018077	.	A	C	4	7	11	0	0	11	0	0
2	32217765	.	C	T	2	2	4	0	0	4	0	0
2	32264673	.	T	C	16	0	16	0	17	33	0	0
2	32264879	.	G	A	9	10	19	0	1	20	0	0
2	32264927	.	T	A	20	6	26	0	3	29	0	0
2	32265437	.	T	A	12	14	26	0	0	26	0	0
2	32265508	.	T	C	6	8	14	0	0	14	0	0
2	32265525	.	T	C	7	0	7	0	9	16	0	0
2	32265543	.	A	T	11	9	20	0	1	21	0	0
2	32265890	.	G	T	13	7	20	1	4	25	0	0
2	32265911	.	T	C	14	7	21	0	2	23	0	0
2	32266064	.	G	C	18	11	29	0	1	30	0	0
2	32266101	.	T	G	9	11	20	2	3	25	0	0
2	32266711	.	C	T	2	24	26	0	14	40	0	0
2	32266895	.	A	G	10	12	22	1	0	23	0	0
2	32267105	.	T	G	12	25	37	0	2	39	0	0
2	32267117	.	C	T	1	21	22	0	14	36	0	0
2	32267285	.	A	G	8	14	22	0	2	24	0	0
2	32267506	.	T	C	9	14	23	0	0	23	0	0
2	32267950	.	G	A	3	10	13	0	0	13	0	0
2	32268096	.	C	T	2	11	13	0	13	26	0	0
2	32270976	.	T	C	11	10	21	0	5	26	0	0
2	32270991	.	T	C	12	0	12	0	13	25	0	0
2	32276277	.	G	A	12	16	28	0	2	30	0	0
2	32299324	.	A	G	8	12	20	0	1	21	0	0
2	32299336	.	C	T	7	11	18	0	1	19	0	0
2	32299387	.	A	C	3	6	9	0	1	10	0	0
2	32306297	.	C	T	12	4	16	0	0	16	0	0
2	32307725	.	A	G	7	9	16	0	0	16	0	0
2	32352883	.	A	G	15	10	25	0	0	25	0	0
2	32357638	.	A	G	1	2	3	0	0	3	0	0
2	32357811	.	G	A	12	7	19	0	3	22	0	0
2	32357980	.	T	C	10	0	10	0	7	17	0	0
2	32358059	.	T	C	8	0	8	0	8	16	0	0
2	32358081	.	A	T	7	9	16	0	1	17	0	0
2	32361446	.	A	T	8	5	13	0	0	13	0	0
2	32361447	.	G	T	8	5	13	0	0	13	0	0
2	32361687	.	T	C	24	1	25	0	18	43	0	0
2	32366137	.	T	C	17	19	36	0	4	40	0	0
2	32366191	.	C	T	13	14	27	0	1	28	0	0
2	32378607	.	T	C	18	10	28	0	1	29	0	0
2	32380649	.	A	G	12	10	22	0	0	22	0	0
2	32394562	.	T	C	3	4	7	0	0	7	0	0
2	32394572	.	C	T	4	3	7	0	0	7	0	0
2	32407242	.	C	T	0	3	3	0	2	5	0	0
2	32407266	.	T	C	2	0	2	0	3	5	0	0
2	32410122	.	A	G	2	3	5	0	0	5	0	0
2	32424224	.	C	A	0	3	3	0	1	4	0	0
2	32424246	.	G	A	1	3	4	0	0	4	0	0
2	32430801	.	G	C	1	0	1	0	4	5	0	0
2	32430903	.	C	A	2	2	4	0	0	4	0	0
2	32441514	.	A	G	0	2	2	0	2	4	0	0
2	32476018	.	T	G	1	4	5	0	1	6	0	0
2	32476288	.	C	T	12	16	28	0	0	28	0	0
2	32477432	.	T	C	14	13	27	0	1	28	0	0
2	32479556	.	T	C	6	1	7	0	11	18	0	0
2	32479616	.	G	A	13	10	23	0	2	25	0	0
2	32483020	.	C	G	8	8	16	0	0	16	0	0
2	32485999	.	A	G	13	6	19	0	0	19	0	0
2	32494486	.	G	A	15	14	29	0	0	29	0	0
2	32494720	.	G	A	16	11	27	0	0	27	0	0
2	32498117	.	A	G	9	13	22	0	0	22	0	0
2	32501188	.	G	A	12	11	23	0	0	23	0	0
2	32505617	.	G	A	1	2	3	0	1	4	0	0
2	32507094	.	C	T	16	12	28	0	1	29	0	0
2	32507218	.	G	A	16	15	31	0	0	31	0	0
2	32508418	.	C	A	12	9	21	0	0	21	0	0
2	32509238	.	T	G	12	9	21	0	2	23	0	0
2	32509309	.	G	T	18	10	28	0	1	29	0	0
2	32509573	.	G	A	11	12	23	0	0	23	0	0
2	32509636	.	C	T	17	11	28	0	1	29	0	0
2	32513440	.	C	T	1	5	6	0	10	16	0	0
2	32515861	.	C	T	1	7	8	0	12	20	0	0
2	32515909	.	A	C	13	9	22	0	0	22	0	0
2	32516110	.	T	C	13	4	17	0	3	20	0	0
2	32516272	.	G	T	14	12	26	0	1	27	0	0
2	32516273	.	C	T	14	12	26	0	2	28	0	0
2	32516359	.	A	T	7	6	13	0	0	13	0	0
2	32516469	.	T	C	9	0	9	0	14	23	0	0
2	32516509	.	A	T	10	9	19	0	0	19	0	0
2	32519666	.	A	G	10	12	22	0	2	24	0	0
2	32531232	.	C	T	13	9	22	0	0	22	0	0
2	32558621	.	G	A	8	11	19	0	2	21	0	0
2	32561583	.	G	C	7	3	10	0	0	10	0	0
2	32561752	.	A	G	5	5	10	0	0	10	0	0
2	32561754	.	G	A	5	5	10	0	0	10	0	0
2	32562059	.	G	A	5	8	13	0	0	13	0	0
2	32569639	.	G	A	12	11	23	0	0	23	0	0
2	32569717	.	A	G	7	6	13	0	0	13	0	0
2	32569930	.	G	A	8	8	16	0	0	16	0	0
2	32577552	.	C	A	6	4	10	0	1	11	0	0
2	32577939	.	G	A	6	5	11	0	1	12	0	0
2	32578230	.	C	T	9	8	17	0	1	18	0	0
2	32578539	.	C	G	6	5	11	0	0	11	0	0
2	32578580	.	C	A	10	12	22	0	0	22	0	0
2	32578642	.	A	G	9	12	21	0	0	21	0	0
2	32578677	.	C	A	9	9	18	0	0	18	0	0
2	32579109	.	C	T	9	9	18	0	0	18	0	0
2	32579333	.	C	T	6	9	15	0	0	15	0	0
2	32579336	.	C	T	7	9	16	0	0	16	0	0
2	32583162	.	T	A	16	5	21	0	0	21	0	0
2	32583411	.	C	A	0	7	7	0	14	21	0	0
2	32583453	.	T	A	7	10	17	0	3	20	0	0
2	32583459	.	A	G	9	9	18	0	1	19	0	0
2	32583528	.	C	T	2	5	7	0	9	16	0	0
2	32583600	.	A	G	9	11	20	0	1	21	0	0
2	32583639	.	T	C	11	0	11	0	7	18	0	0
2	32583681	.	T	A	8	5	13	0	1	14	0	0
2	32583687	.	G	A	8	5	13	0	1	14	0	0
2	32588647	.	C	T	4	3	7	0	1	8	0	0
2	32590552	.	C	T	6	3	9	0	0	9	0	0
2	32590861	.	A	G	8	6	14	0	1	15	0	0
2	32590987	.	C	A	6	3	9	0	1	10	0	0
2	32590989	.	A	G	6	3	9	0	1	10	0	0
2	32591488	.	C	A	9	6	15	0	0	15	0	0
2	32592075	.	G	T	4	10	14	0	2	16	0	0
2	32594233	.	G	C	13	0	13	0	3	16	0	0
2	32594236	.	T	A	14	2	16	0	0	16	0	0
2	32594290	.	T	G	9	6	15	0	0	15	0	0
2	32594614	.	G	A	3	6	9	0	1	10	0	0
2	32594620	.	G	A	3	6	9	0	0	9	0	0
2	32594670	.	A	T	7	5	12	0	1	13	0	0
2	32594699	.	T	A	14	4	18	0	1	19	0	0
2	32636757	.	T	C	25	38	63	3	2	68	0	0
2	32636886	.	T	A	20	25	45	1	1	47	0	0
2	32636912	.	A	C	16	26	42	1	0	44	1	0
2	32637145	.	G	C	12	22	34	17	0	51	0	0
2	32637582	.	T	C	1	3	4	0	1	5	0	0
2	32643288	.	G	A	7	3	10	3	0	13	0	0
2	32654034	.	A	G	4	3	7	0	0	7	0	0
2	32654052	.	G	C	4	0	4	0	3	7	0	0
2	32654570	.	T	C	12	17	29	0	3	32	0	0
2	32665798	.	G	A	13	18	31	0	1	32	0	0
2	32666565	.	C	T	1	8	9	0	14	23	0	0
2	32667941	.	C	A	1	19	20	0	9	29	0	0
2	32668481	.	C	T	1	3	4	0	0	4	0	0
2	32676228	.	T	A	8	8	16	0	2	18	0	0
2	32676292	.	G	A	15	5	20	0	0	20	0	0
2	32676482	.	A	C	9	8	17	0	1	18	0	0
2	32679938	.	C	T	5	6	11	0	0	11	0	0
2	32680383	.	A	C	8	1	9	0	12	21	0	0
2	32681833	.	T	A	9	10	19	0	1	20	0	0
2	32681845	.	C	A	10	10	20	0	0	20	0	0
2	32682129	.	C	T	14	8	22	0	1	23	0	0
2	32682547	.	T	G	9	7	16	0	0	16	0	0
2	32686594	.	C	T	9	5	14	0	0	14	0	0
2	32686597	.	A	G	9	5	14	0	1	15	0	0
2	32738137	.	C	T	13	12	25	0	1	26	0	0
2	32738342	.	T	G	3	6	9	0	0	9	0	0
2	32749875	.	T	C	3	5	8	0	0	8	0	0
2	32750028	.	C	T	3	6	9	0	0	9	0	0
2	32750695	.	A	G	3	2	5	0	0	5	0	0
2	32752294	.	G	A	2	4	6	0	0	6	0	0
2	32752447	.	G	A	4	4	8	0	0	8	0	0
2	32754659	.	G	A	0	3	3	0	2	5	0	0
2	32754749	.	T	G	4	6	10	0	0	10	0	0
2	32756074	.	C	T	5	3	8	0	1	9	0	0
2	32756102	.	C	T	7	3	10	0	0	10	0	0
2	32756630	.	C	T	6	8	14	0	0	14	0	0
2	32756660	.	A	C	6	2	8	0	0	8	0	0
2	32815234	.	G	A	6	10	16	0	0	16	0	0
2	32817615	.	T	A	13	7	20	0	1	21	0	0
2	32817627	.	G	A	14	10	24	0	0	24	0	0
2	32817921	.	G	A	19	6	25	0	0	25	0	0
2	32820764	.	G	A	11	8	19	0	1	20	0	0
2	32820806	.	G	T	12	5	17	0	2	19	0	0
2	32821393	.	G	A	10	11	21	0	1	22	0	0
2	32821622	.	T	G	15	12	27	0	0	27	0	0
2	32823461	.	C	T	18	10	28	0	0	28	0	0
2	32823494	.	C	G	2	9	11	0	19	30	0	0
2	32823521	.	T	C	17	7	24	0	1	25	0	0
2	32824526	.	A	G	8	12	20	0	0	20	0	0
2	32824602	.	A	G	9	8	17	0	2	19	0	0
2	32824805	.	G	A	10	15	25	0	1	26	0	0
2	32825033	.	G	A	11	13	24	0	0	24	0	0
2	32825240	.	T	A	7	12	19	0	1	20	0	0
2	32825294	.	G	A	9	11	20	0	1	21	0	0
2	32825382	.	C	T	8	6	14	0	1	15	0	0
2	32827004	.	C	T	2	5	7	0	2	9	0	0
2	32827005	.	C	T	3	5	8	0	1	9	0	0
2	32827104	.	T	G	4	3	7	0	0	7	0	0
2	32827135	.	A	G	3	4	7	0	0	7	0	0
2	32827181	.	A	T	4	7	11	0	1	12	0	0
2	32828626	.	T	C	3	2	5	0	0	5	0	0
2	32828651	.	A	G	4	3	7	0	0	7	0	0
2	32828683	.	A	G	2	4	6	0	0	6	0	0
2	32829016	.	T	C	2	2	4	0	0	4	0	0
2	32833572	.	T	C	6	7	13	0	0	13	0	0
2	32849667	.	A	G	6	2	8	0	0	8	0	0
2	32850138	.	C	T	3	5	8	0	1	9	0	0
2	32850305	.	T	C	7	9	16	0	0	16	0	0
2	32850401	.	T	C	6	10	16	0	0	16	0	0
2	32850477	.	T	A	4	2	6	0	0	6	0	0
2	33189595	.	A	C	1	2	3	0	0	3	0	0
2	33209645	.	T	G	26	0	26	0	30	56	0	0
2	33216346	.	C	T	21	10	31	0	0	31	0	0
2	33216518	.	G	A	6	9	15	0	26	41	0	0
2	33216563	.	C	G	29	15	44	0	2	46	0	0
2	33415600	.	G	T	4	4	8	0	0	8	0	0
2	33415981	.	A	G	1	3	4	0	1	5	0	0
2	33416242	.	G	T	2	3	5	0	0	5	0	0
2	33417229	.	C	T	3	6	9	0	0	9	0	0
2	33417527	.	A	G	3	5	8	0	0	8	0	0
2	33417533	.	C	G	3	4	7	0	0	7	0	0
2	33417591	.	C	T	1	2	3	0	0	3	0	0
2	33418235	.	T	A	6	2	8	0	1	9	0	0
2	33418476	.	G	A	2	4	6	0	0	6	0	0
2	33418486	.	T	C	3	6	9	0	0	9	0	0
2	33418586	.	C	A	3	3	6	0	0	6	0	0
2	33418604	.	A	T	2	3	5	0	0	5	0	0
2	33419506	.	A	G	4	4	8	0	1	9	0	0
2	33419543	.	T	C	6	4	10	0	0	10	0	0
2	33419563	.	G	A	5	3	8	0	0	8	0	0
2	33419661	.	C	T	6	2	8	0	0	8	0	0
2	33419730	.	A	G	3	3	6	0	0	6	0	0
2	33420218	.	T	A	4	5	9	0	0	9	0	0
2	33420272	.	G	T	6	5	11	0	1	12	0	0
2	33420309	.	T	A	2	4	6	0	0	6	0	0
2	33420318	.	A	G	2	0	2	0	4	6	0	0
2	33420438	.	C	A	5	2	7	0	0	7	0	0
2	33420638	.	T	G	3	5	8	0	0	8	0	0
2	33420679	.	T	G	2	2	4	0	0	4	0	0
2	33420684	.	A	C	2	2	4	0	0	4	0	0
2	33420724	.	C	G	4	3	7	0	0	7	0	0
2	33420925	.	C	A	5	15	20	0	0	20	0	0
2	33420975	.	G	A	1	15	16	0	6	22	0	0
2	33421146	.	G	A	8	4	12	0	0	12	0	0
2	33421154	.	G	A	8	4	12	0	1	13	0	0
2	33421547	.	A	G	4	2	6	0	0	6	0	0
2	33421549	.	A	C	5	1	6	0	1	7	0	0
2	33421613	.	C	T	9	7	16	0	0	16	0	0
2	33421860	.	T	G	9	3	12	0	0	12	0	0
2	33421872	.	A	T	5	3	8	0	0	8	0	0
2	33421985	.	T	A	10	4	14	0	1	15	0	0
2	33422125	.	C	T	4	6	10	0	1	11	0	0
2	33422169	.	T	C	5	7	12	0	1	13	0	0
2	33422287	.	G	A	10	5	15	0	0	15	0	0
2	33422327	.	G	A	9	8	17	0	1	18	0	0
2	33422374	.	T	G	14	1	15	0	14	29	0	0
2	33422484	.	G	A	0	5	5	0	10	15	0	0
2	33422533	.	C	T	14	6	20	0	0	20	0	0
2	33422565	.	C	A	15	12	27	0	1	28	0	0
2	33422604	.	C	T	14	17	31	0	1	32	0	0
2	33466068	.	C	A	3	4	7	0	1	8	0	0
2	33466193	.	T	A	1	2	3	0	0	3	0	0
2	33477014	.	G	T	5	2	7	0	0	7	0	0
2	33477160	.	T	C	6	8	14	0	1	15	0	0
2	33477175	.	A	G	6	8	14	0	0	14	0	0
2	33645344	.	C	A	9	5	14	0	1	15	0	0
2	33676169	.	G	T	5	2	7	0	0	7	0	0
2	33676173	.	T	C	6	1	7	0	1	8	0	0
2	33676255	.	T	C	4	5	9	0	0	9	0	0
2	33676391	.	G	A	4	7	11	0	1	12	0	0
2	33681330	.	G	A	25	25	50	0	0	50	0	0
2	33681483	.	A	G	14	21	35	0	0	35	0	0
2	33681701	.	A	T	19	20	39	0	0	39	0	0
2	33682321	.	G	A	20	24	44	0	0	44	0	0
2	33682323	.	T	A	21	23	44	0	1	45	0	0
2	33685582	.	T	A	21	18	39	0	3	42	0	0
2	33687110	.	C	A	32	20	52	0	2	54	0	0
2	33796281	.	G	T	0	3	3	0	3	6	0	0
2	33949944	.	A	T	1	2	3	0	0	3	0	0
2	33950050	.	C	A	1	2	3	0	0	3	0	0
2	33969861	.	C	A	4	4	8	0	0	8	0	0
2	33970431	.	A	C	1	3	4	0	1	5	0	0
2	34022992	.	T	A	7	8	15	0	1	16	0	0
2	34024832	.	A	G	6	8	14	0	2	16	0	0
2	34025152	.	C	A	8	8	16	0	0	16	0	0
2	34025167	.	G	A	9	9	18	0	1	19	0	0
2	34029353	.	G	A	3	10	13	0	0	13	0	0
2	34047951	.	T	C	3	6	9	0	0	9	0	0
2	34065661	.	G	A	7	6	13	0	0	13	0	0
2	34071479	.	G	T	5	12	17	0	0	18	1	0
2	34071955	.	A	T	7	5	12	0	0	12	0	0
2	34112170	.	C	G	3	0	3	0	8	12	1	0
2	34113147	.	A	G	5	8	13	0	0	13	0	0
2	34113153	.	A	G	5	6	11	0	0	11	0	0
2	34113198	.	T	C	6	2	8	0	1	9	0	0
2	34115340	.	C	A	7	7	14	0	0	14	0	0
2	34122859	.	A	G	9	7	16	0	1	17	0	0
2	34122886	.	C	A	6	3	9	0	1	10	0	0
2	34122928	.	C	T	7	6	13	0	0	13	0	0
2	34125775	.	G	A	3	17	20	0	10	30	0	0
2	34125909	.	A	T	7	13	20	0	1	21	0	0
2	34126040	.	T	C	5	3	8	0	0	8	0	0
2	34126514	.	G	T	8	2	10	0	0	10	0	0
2	34126588	.	A	T	9	1	10	0	0	10	0	0
2	34129366	.	A	G	1	1	2	0	1	3	0	0
2	34138545	.	C	A	2	3	5	0	0	5	0	0
2	34138844	.	G	A	3	3	6	0	0	6	0	0
2	34152985	.	G	A	2	3	5	0	0	5	0	0
2	34156264	.	A	C	2	4	6	0	0	6	0	0
2	34160995	.	G	A	2	2	4	0	1	5	0	0
2	34172900	.	C	T	4	2	6	0	1	7	0	0
2	34172954	.	T	C	5	2	7	0	0	7	0	0
2	34173136	.	G	A	5	3	8	0	0	8	0	0
2	34173253	.	C	T	7	5	12	0	0	12	0	0
2	34173297	.	C	A	7	5	12	0	0	12	0	0
2	34173335	.	A	C	6	6	12	0	0	12	0	0
2	34173360	.	C	T	7	8	15	0	0	15	0	0
2	34381013	.	T	G	17	20	37	0	1	38	0	0
2	34381032	.	T	C	13	21	34	0	0	34	0	0
2	34444801	.	C	T	17	11	28	0	1	29	0	0
2	34460848	.	G	A	15	17	32	0	0	32	0	0
2	34555410	.	A	G	7	11	18	0	0	18	0	0
2	34924412	.	A	G	15	30	45	0	2	47	0	0
2	34962193	.	A	T	18	22	40	0	1	41	0	0
2	34962223	.	A	G	20	0	20	0	26	46	0	0
2	34970135	.	T	C	20	23	43	0	3	46	0	0
2	34970329	.	A	G	24	18	42	0	3	45	0	0
2	34981747	.	G	A	32	20	52	0	1	53	0	0
2	34981986	.	G	A	28	17	45	0	3	48	0	0
2	34982205	.	T	G	19	17	36	0	1	37	0	0
2	34982322	.	A	T	3	4	7	0	0	7	0	0
2	34986337	.	C	A	0	6	6	0	1	7	0	0
2	34986702	.	C	T	1	5	6	0	1	7	0	0
2	35011823	.	A	T	2	3	5	0	0	5	0	0
2	35017023	.	G	A	2	5	7	0	0	7	0	0
2	35024724	.	A	G	1	5	6	0	0	6	0	0
2	35024825	.	G	A	3	2	5	0	0	5	0	0
2	35027672	.	T	A	1	3	4	0	0	4	0	0
2	35042522	.	T	C	1	0	1	0	3	4	0	0
2	35059323	.	C	T	0	4	4	0	1	5	0	0
2	35059449	.	G	T	3	3	6	0	0	6	0	0
2	35096885	.	A	G	1	2	3	0	0	3	0	0
2	35116674	.	T	C	10	6	16	0	0	16	0	0
2	35117066	.	A	C	4	4	8	0	0	8	0	0
2	35118607	.	C	T	5	10	15	0	1	16	0	0
2	35126353	.	A	C	3	8	11	0	2	13	0	0
2	35390472	.	G	A	0	4	4	0	1	5	0	0
2	35395976	.	G	T	0	5	5	0	9	14	0	0
2	35396012	.	T	G	6	8	14	0	0	14	0	0
2	35407144	.	C	T	7	2	9	0	1	10	0	0
2	35418909	.	T	C	5	3	8	0	1	9	0	0
2	35419244	.	G	A	0	3	3	0	10	13	0	0
2	35419385	.	T	C	8	16	24	0	0	24	0	0
2	35420591	.	T	A	9	11	20	0	1	21	0	0
2	35420597	.	T	A	7	12	19	0	3	22	0	0
2	35421306	.	T	C	9	12	21	0	1	22	0	0
2	35421399	.	A	T	10	8	18	0	0	18	0	0
2	35434910	.	C	T	13	10	23	2	2	27	0	0
2	35437417	.	C	T	11	9	20	0	0	20	0	0
2	35437513	.	C	A	15	8	23	0	0	23	0	0
2	35468827	.	A	T	8	13	21	0	1	22	0	0
2	35468911	.	T	C	8	15	23	0	1	24	0	0
2	35473715	.	G	A	1	8	9	0	9	18	0	0
2	35473847	.	G	A	2	12	14	0	6	20	0	0
2	35473975	.	G	T	11	5	16	0	0	16	0	0
2	35474049	.	G	A	3	14	17	0	11	28	0	0
2	35593364	.	T	G	18	10	28	0	1	29	0	0
2	35593848	.	T	C	19	8	27	0	0	27	0	0
2	35593936	.	A	G	7	0	7	0	12	19	0	0
2	35595514	.	C	A	15	19	34	0	0	34	0	0
2	35595561	.	A	G	11	17	28	0	2	30	0	0
2	35596842	.	A	G	22	16	38	0	2	40	0	0
2	35601159	.	A	G	8	0	8	0	18	26	0	0
2	35601212	.	T	G	6	6	12	0	1	13	0	0
2	35603795	.	A	G	11	17	28	0	2	30	0	0
2	35605429	.	C	T	14	9	23	0	1	24	0	0
2	35605841	.	G	A	6	9	15	0	2	17	0	0
2	35607077	.	G	C	11	13	24	0	2	26	0	0
2	35607191	.	C	T	14	20	34	0	1	35	0	0
2	35607472	.	T	C	11	15	26	0	0	26	0	0
2	35608445	.	T	A	17	21	38	0	0	38	0	0
2	35610541	.	T	C	8	20	28	0	1	29	0	0
2	35610598	.	T	C	13	27	40	0	0	40	0	0
2	35610890	.	T	G	17	9	26	0	1	27	0	0
2	35611051	.	T	A	10	17	27	0	3	30	0	0
2	35611172	.	C	T	13	22	35	0	0	35	0	0
2	35611279	.	C	T	21	11	32	2	0	34	0	0
2	35611595	.	T	G	13	17	30	0	1	31	0	0
2	35728228	.	T	A	2	3	5	0	0	5	0	0
2	35730701	.	G	A	4	7	11	0	0	11	0	0
2	35731019	.	C	G	2	5	7	0	0	7	0	0
2	35731033	.	C	G	2	4	6	0	0	6	0	0
2	35731106	.	C	T	1	5	6	0	0	6	0	0
2	35818945	.	C	G	8	5	13	0	1	14	0	0
2	35825679	.	T	C	7	5	12	0	0	12	0	0
2	35837081	.	T	C	8	11	19	0	0	19	0	0
2	35837252	.	A	C	9	5	14	0	0	14	0	0
2	35837270	.	A	G	6	6	12	0	1	13	0	0
2	35837510	.	G	A	0	8	8	0	7	15	0	0
2	35839687	.	G	A	0	8	8	0	10	18	0	0
2	35839714	.	G	A	2	8	10	0	6	16	0	0
2	35841933	.	G	A	1	7	8	0	11	19	0	0
2	35842020	.	G	A	8	3	11	0	5	16	0	0
2	35843605	.	T	C	9	9	18	0	1	19	0	0
2	35843680	.	A	G	14	9	23	0	1	24	0	0
2	35843812	.	G	A	14	15	29	0	3	32	0	0
2	35844070	.	A	G	11	0	11	0	12	23	0	0
2	35844160	.	A	C	10	16	26	0	0	27	1	0
2	35844433	.	A	G	13	13	26	0	7	33	0	0
2	35846511	.	A	G	14	1	15	0	15	30	0	0
2	35851152	.	C	T	6	2	8	0	0	8	0	0
2	35854264	.	T	C	5	7	12	0	0	12	0	0
2	35855502	.	G	A	1	11	12	0	6	18	0	0
2	35857057	.	C	T	8	7	15	0	0	15	0	0
2	35858435	.	C	T	3	5	8	0	2	10	0	0
2	35861574	.	C	T	7	6	13	0	1	14	0	0
2	35862971	.	T	C	8	16	24	0	0	24	0	0
2	35866246	.	A	T	4	7	11	0	1	12	0	0
2	35866440	.	G	T	8	6	14	0	1	15	0	0
2	35866515	.	T	G	5	10	15	0	1	16	0	0
2	35866593	.	G	A	14	9	23	0	1	24	0	0
2	35866787	.	T	C	15	10	25	0	0	25	0	0
2	35868275	.	T	G	14	10	24	0	0	24	0	0
2	35868319	.	A	G	8	16	24	0	0	24	0	0
2	35868568	.	G	A	7	10	17	0	1	18	0	0
2	35868896	.	A	G	10	6	16	0	0	16	0	0
2	35873429	.	T	A	1	1	2	0	1	3	0	0
2	35967830	.	C	T	1	2	3	0	0	3	0	0
2	35973927	.	G	A	1	5	6	0	0	6	0	0
2	35978446	.	G	A	5	2	7	0	1	8	0	0
2	35978570	.	T	C	4	2	6	0	0	6	0	0
2	36028724	.	T	G	32	28	60	0	1	61	0	0
2	36028957	.	G	A	26	25	51	0	2	53	0	0
2	36032791	.	C	T	35	21	56	0	2	58	0	0
2	36035697	.	T	C	24	23	47	0	1	48	0	0
2	36040733	.	T	C	29	26	55	0	3	58	0	0
2	36053260	.	T	C	6	9	15	0	0	15	0	0
2	36061201	.	G	A	1	4	5	0	9	14	0	0
2	36062111	.	T	C	7	16	23	0	1	24	0	0
2	36064439	.	G	A	18	8	26	0	0	26	0	0
2	36065871	.	A	G	18	18	36	0	3	39	0	0
2	36065976	.	A	G	16	0	16	0	21	37	0	0
2	36066156	.	C	T	13	10	23	0	1	24	0	0
2	36067656	.	G	A	12	19	31	1	0	32	0	0
2	36067842	.	A	C	11	8	19	0	3	22	0	0
2	36067849	.	A	G	11	0	11	0	14	25	0	0
2	36076419	.	T	G	13	11	24	0	0	24	0	0
2	36076501	.	A	G	7	0	7	0	13	20	0	0
2	36077276	.	A	G	21	0	21	0	16	37	0	0
2	36077384	.	A	G	9	3	12	0	3	15	0	0
2	36077542	.	T	C	17	15	32	0	0	32	0	0
2	36077543	.	T	G	17	0	17	0	15	32	0	0
2	36077664	.	C	T	9	12	21	0	1	22	0	0
2	36078370	.	T	G	8	9	17	0	2	19	0	0
2	36154761	.	A	G	5	2	7	0	0	7	0	0
2	36609211	.	C	A	3	3	6	0	0	6	0	0
2	36609235	.	C	T	1	4	5	0	0	5	0	0
2	36620148	.	A	C	1	2	3	0	0	3	0	0
2	36626567	.	G	C	3	5	8	0	0	8	0	0
2	36626579	.	C	A	3	3	6	0	0	6	0	0
2	36664493	.	T	G	17	11	28	0	0	28	0	0
2	36664545	.	A	G	17	14	31	0	0	31	0	0
2	36664679	.	C	G	16	13	29	0	1	30	0	0
2	36664799	.	G	T	15	11	26	0	2	29	1	0
2	36670595	.	A	G	12	11	23	0	2	25	0	0
2	36670778	.	G	A	8	2	10	0	1	11	0	0
2	36671026	.	C	A	5	6	11	0	1	12	0	0
2	36673261	.	G	A	16	12	28	0	3	31	0	0
2	36673264	.	T	C	19	10	29	0	0	29	0	0
2	36673643	.	T	A	2	12	14	0	2	16	0	0
2	36673805	.	C	T	17	9	26	0	1	27	0	0
2	36673866	.	G	T	22	12	34	0	3	37	0	0
2	36703773	.	A	G	1	2	3	0	0	3	0	0
2	36704454	.	A	G	1	2	3	0	0	3	0	0
2	36718401	.	T	A	1	4	5	0	0	5	0	0
2	36720559	.	G	A	2	3	5	0	2	7	0	0
2	36722846	.	T	C	16	12	28	0	0	28	0	0
2	36724384	.	A	C	14	14	28	0	3	31	0	0
2	36727360	.	A	T	12	25	37	0	1	38	0	0
2	36816003	.	A	G	13	8	21	0	1	22	0	0
2	36816120	.	T	G	7	9	16	0	0	16	0	0
2	36816312	.	T	C	6	2	8	0	2	10	0	0
2	36816495	.	T	G	5	6	11	0	0	11	0	0
2	36816501	.	T	G	6	5	11	0	0	11	0	0
2	36816828	.	T	C	9	3	12	0	0	12	0	0
2	36817317	.	T	C	12	9	21	0	0	21	0	0
2	36817362	.	G	A	7	9	16	0	0	16	0	0
2	36819320	.	C	T	6	3	9	0	0	9	0	0
2	36819587	.	A	G	8	3	11	0	0	11	0	0
2	36819596	.	A	T	6	2	8	0	1	9	0	0
2	36828901	.	C	G	7	1	8	0	10	18	0	0
2	36831368	.	C	T	2	2	4	0	0	4	0	0
2	36834497	.	C	A	5	12	17	0	0	17	0	0
2	36834542	.	C	T	9	10	19	0	1	20	0	0
2	36834686	.	G	A	7	4	11	0	0	11	0	0
2	36838094	.	C	T	7	16	23	0	1	24	0	0
2	36838274	.	G	A	9	10	19	0	2	21	0	0
2	36838322	.	T	C	7	11	18	0	0	18	0	0
2	36838355	.	A	G	8	0	8	0	8	16	0	0
2	36840594	.	C	T	5	10	15	0	0	15	0	0
2	36840789	.	C	T	2	13	15	0	0	15	0	0
2	36841523	.	A	G	11	5	16	0	0	16	0	0
2	36844035	.	G	T	2	8	10	0	7	17	0	0
2	36852056	.	C	G	14	13	27	0	1	28	0	0
2	36853936	.	T	C	10	6	16	0	1	17	0	0
2	36853955	.	A	C	13	9	22	0	0	22	0	0
2	36854173	.	T	C	10	18	28	0	0	28	0	0
2	36854184	.	C	A	7	15	22	0	0	22	0	0
2	36862501	.	A	G	10	3	13	0	0	13	0	0
2	36862726	.	T	C	5	4	9	0	0	9	0	0
2	36889867	.	A	T	8	3	11	0	0	11	0	0
2	36892504	.	C	T	8	6	14	0	0	14	0	0
2	36892518	.	A	G	8	8	16	0	0	16	0	0
2	36892857	.	A	G	2	3	5	0	1	6	0	0
2	36921495	.	A	T	17	13	30	0	0	30	0	0
2	36921579	.	G	C	13	0	13	0	13	26	0	0
2	36921588	.	A	G	16	11	27	0	1	28	0	0
2	36922595	.	G	A	10	11	21	0	0	21	0	0
2	36922604	.	A	T	10	10	20	0	1	21	0	0
2	36922883	.	C	T	9	5	14	0	1	15	0	0
2	36922988	.	A	T	9	12	21	0	0	21	0	0
2	36923167	.	T	C	11	0	11	0	10	21	0	0
2	36923300	.	A	T	18	12	30	0	1	31	0	0
2	36924020	.	G	T	8	5	13	0	0	13	0	0
2	36924051	.	T	C	8	1	9	0	8	17	0	0
2	36924739	.	T	C	9	9	18	0	0	18	0	0
2	36925218	.	T	C	12	6	18	0	0	18	0	0
2	36925931	.	A	G	11	5	16	0	1	18	1	0
2	36926239	.	T	G	3	6	9	0	0	9	0	0
2	36932846	.	T	C	3	0	3	0	2	5	0	0
2	36932850	.	T	G	4	2	6	0	0	6	0	0
2	36933269	.	C	A	7	3	10	0	0	10	0	0
2	36933356	.	A	T	7	3	10	0	0	10	0	0
2	36933392	.	T	C	5	2	7	0	0	7	0	0
2	36939965	.	T	A	9	4	13	0	0	13	0	0
2	36941365	.	A	G	4	5	9	0	0	9	0	0
2	36990050	.	A	T	20	19	39	0	2	41	0	0
2	36990185	.	A	C	20	23	43	0	2	45	0	0
2	36990283	.	A	T	20	22	42	0	1	43	0	0
2	36990294	.	A	T	20	19	39	0	3	42	0	0
2	36990363	.	A	G	18	32	50	0	2	52	0	0
2	36990458	.	A	G	32	32	64	0	2	66	0	0
2	36992795	.	T	C	14	1	15	0	18	33	0	0
2	37043708	.	A	C	13	1	14	0	5	19	0	0
2	37059643	.	A	G	6	9	15	0	0	15	0	0
2	37059835	.	T	G	5	8	13	0	2	15	0	0
2	37059943	.	G	A	7	4	11	0	0	11	0	0
2	37089448	.	A	G	1	1	2	0	1	3	0	0
2	37123507	.	T	C	18	10	28	0	0	28	0	0
2	37123901	.	T	C	14	9	23	0	0	23	0	0
2	37124181	.	A	C	26	25	51	0	2	53	0	0
2	37124509	.	A	G	15	12	27	0	2	29	0	0
2	37124761	.	C	T	5	5	10	0	0	10	0	0
2	37124821	.	C	A	8	10	18	0	1	19	0	0
2	37124961	.	C	G	19	19	38	0	1	39	0	0
2	37128450	.	C	T	25	12	37	0	0	37	0	0
2	37139120	.	G	A	1	2	3	0	0	3	0	0
2	37141002	.	G	A	1	17	18	0	9	27	0	0
2	37145793	.	T	A	18	21	39	0	2	41	0	0
2	37145820	.	G	C	17	21	38	0	1	39	0	0
2	37146474	.	C	T	10	15	25	0	3	28	0	0
2	37146512	.	A	G	8	0	8	0	7	15	0	0
2	37189834	.	T	C	6	3	9	0	0	9	0	0
2	37191964	.	A	G	5	15	20	0	1	21	0	0
2	37193743	.	G	A	14	14	28	0	0	28	0	0
2	37195406	.	C	A	14	20	34	0	0	34	0	0
2	37195472	.	A	C	20	13	33	0	4	37	0	0
2	37201513	.	G	A	22	13	35	0	1	36	0	0
2	37205437	.	T	G	30	4	34	1	22	57	0	0
2	37257571	.	A	G	11	13	24	0	0	24	0	0
2	37258084	.	C	A	2	3	5	0	0	5	0	0
2	37261326	.	A	T	12	15	27	0	3	30	0	0
2	37263874	.	C	A	29	17	46	0	0	46	0	0
2	37264364	.	A	T	22	9	31	0	0	31	0	0
2	37264423	.	G	T	15	8	23	0	2	25	0	0
2	37264693	.	T	C	11	12	23	0	4	28	1	0
2	37264856	.	T	A	17	20	37	0	1	38	0	0
2	37264889	.	T	G	19	17	36	0	0	36	0	0
2	37264915	.	T	A	14	19	33	0	0	34	1	0
2	37264928	.	A	T	12	18	30	0	0	30	0	0
2	37265021	.	C	T	19	9	28	0	1	29	0	0
2	37265125	.	T	A	9	11	20	0	0	20	0	0
2	37265302	.	G	A	22	10	32	0	3	35	0	0
2	37265409	.	T	A	24	12	36	0	3	39	0	0
2	37267465	.	T	C	7	4	11	0	0	11	0	0
2	37267831	.	T	A	4	4	8	0	0	8	0	0
2	37272392	.	A	G	9	4	13	0	1	14	0	0
2	37274451	.	C	T	6	8	14	0	0	14	0	0
2	37274483	.	T	C	6	5	11	0	0	11	0	0
2	37274504	.	A	G	5	5	10	0	0	10	0	0
2	37277452	.	C	T	0	3	3	0	3	6	0	0
2	37280268	.	T	C	5	5	10	0	0	10	0	0
2	37280399	.	A	G	5	6	11	0	1	12	0	0
2	37280457	.	C	T	0	7	7	0	6	13	0	0
2	37307422	.	T	A	8	17	25	0	4	30	1	0
2	37307557	.	T	C	10	16	26	0	0	26	0	0
2	37322252	.	G	A	12	11	23	0	0	23	0	0
2	37352084	.	G	A	3	3	6	0	0	6	0	0
2	37365855	.	C	T	2	16	18	0	19	37	0	0
2	37366234	.	A	G	7	7	14	0	1	15	0	0
2	37366496	.	A	T	11	14	25	0	1	26	0	0
2	37366526	.	T	C	17	12	29	0	1	30	0	0
2	37366810	.	G	C	12	12	24	0	1	25	0	0
2	37366815	.	G	A	12	13	25	0	0	25	0	0
2	37375027	.	G	A	18	8	26	0	2	28	0	0
2	37379482	.	A	G	14	12	26	0	0	26	0	0
2	37383444	.	A	G	12	8	20	0	1	21	0	0
2	37391319	.	T	C	6	0	6	0	8	14	0	0
2	37424290	.	G	A	2	8	10	0	2	12	0	0
2	37424499	.	G	C	2	8	10	0	1	11	0	0
2	37428557	.	C	T	10	3	13	0	0	13	0	0
2	37428741	.	G	A	9	6	15	0	2	17	0	0
2	37428804	.	A	G	9	13	22	0	1	23	0	0
2	37433540	.	C	T	7	6	13	0	1	14	0	0
2	37436778	.	T	A	11	15	26	0	5	31	0	0
2	37455811	.	A	G	6	3	9	0	1	10	0	0
2	37458464	.	G	C	3	4	7	1	0	8	0	0
2	37458522	.	G	A	3	6	9	1	2	12	0	0
2	37460880	.	C	T	1	2	3	0	6	9	0	0
2	37461082	.	C	G	0	2	2	0	6	8	0	0
2	37469926	.	G	A	23	18	41	0	3	44	0	0
2	37469962	.	A	G	25	11	36	0	0	36	0	0
2	37470001	.	A	G	23	15	38	0	0	38	0	0
2	37471495	.	C	G	19	14	33	0	0	33	0	0
2	37496171	.	A	G	2	9	11	0	1	12	0	0
2	37496982	.	A	G	3	14	17	0	1	18	0	0
2	37502213	.	G	A	3	17	20	0	0	20	0	0
2	37502412	.	T	G	6	11	17	0	0	17	0	0
2	37505368	.	T	A	1	2	3	0	1	4	0	0
2	37545462	.	A	G	13	8	21	0	0	21	0	0
2	37545473	.	C	G	14	7	21	0	0	21	0	0
2	37545628	.	G	A	9	9	18	0	0	18	0	0
2	37546225	.	T	C	12	0	12	0	11	23	0	0
2	37547874	.	T	C	7	6	13	0	0	13	0	0
2	37554817	.	G	A	5	5	10	0	0	10	0	0
2	37555512	.	A	G	6	7	13	0	1	14	0	0
2	37559306	.	C	T	6	8	14	0	0	14	0	0
2	37559318	.	G	A	6	10	16	0	0	16	0	0
2	37564375	.	T	A	11	5	16	0	1	17	0	0
2	37566708	.	C	T	7	6	13	0	0	13	0	0
2	37567233	.	T	G	5	4	9	0	0	9	0	0
2	37567609	.	A	T	11	3	14	0	1	15	0	0
2	37577967	.	C	T	4	2	6	0	0	6	0	0
2	37632100	.	C	T	2	8	10	0	0	10	0	0
2	37632469	.	A	G	4	5	9	0	0	9	0	0
2	37632593	.	T	C	4	2	6	0	0	6	0	0
2	37632737	.	A	C	3	2	5	0	0	5	0	0
2	37656372	.	A	G	10	4	14	0	0	14	0	0
2	37656498	.	T	A	3	6	9	0	1	10	0	0
2	37656572	.	G	C	3	4	7	0	0	7	0	0
2	37656580	.	G	C	3	5	8	0	0	8	0	0
2	37656661	.	C	T	0	2	2	0	2	4	0	0
2	37656662	.	G	A	2	2	4	0	0	4	0	0
2	37664128	.	G	A	12	4	16	0	0	16	0	0
2	37750082	.	G	A	1	2	3	0	0	3	0	0
2	37754405	.	T	C	4	4	8	0	0	8	0	0
2	37754525	.	T	C	3	3	6	0	0	6	0	0
2	37815692	.	T	C	1	3	4	0	0	4	0	0
2	37823104	.	C	T	5	7	12	0	0	12	0	0
2	37823410	.	T	G	1	0	1	0	2	3	0	0
2	37824133	.	G	A	4	4	8	0	0	8	0	0
2	37826915	.	C	T	4	3	7	0	0	7	0	0
2	37826933	.	T	C	6	2	8	0	0	8	0	0
2	37827977	.	C	T	0	6	6	0	8	14	0	0
2	37830066	.	G	T	7	8	15	0	0	15	0	0
2	37830123	.	C	T	0	6	6	0	8	14	0	0
2	37830908	.	G	T	4	2	6	0	1	7	0	0
2	37830922	.	C	T	2	5	7	0	0	7	0	0
2	37831076	.	T	C	8	3	11	0	0	11	0	0
2	37833702	.	A	G	5	4	9	0	0	9	0	0
2	37833708	.	A	T	4	5	9	0	0	9	0	0
2	37833739	.	A	C	5	3	8	0	0	8	0	0
2	37834433	.	T	C	5	2	7	0	0	7	0	0
2	37834703	.	C	T	6	5	11	0	1	12	0	0
2	37837278	.	G	A	5	4	9	0	0	9	0	0
2	37837577	.	A	G	4	8	12	1	1	14	0	0
2	37837608	.	A	G	6	2	8	0	0	8	0	0
2	37838155	.	G	A	3	2	5	0	0	5	0	0
2	37840741	.	G	T	3	9	12	0	1	13	0	0
2	37840887	.	G	A	5	3	8	0	1	9	0	0
2	37841295	.	A	C	5	2	7	0	0	7	0	0
2	37841333	.	T	C	2	4	6	0	0	6	0	0
2	37846286	.	A	G	2	4	6	0	1	7	0	0
2	37846612	.	T	C	1	3	4	0	0	4	0	0
2	37846664	.	A	T	2	2	4	0	0	4	0	0
2	37846705	.	C	T	2	2	4	0	0	4	0	0
2	37867148	.	C	T	9	6	15	0	0	15	0	0
2	37867165	.	C	T	0	6	6	0	9	15	0	0
2	37896290	.	G	A	1	0	1	0	1	7	5	0
2	37899939	.	T	C	1	2	3	0	0	3	0	0
2	37899950	.	A	G	1	2	3	0	0	3	0	0
2	37927082	.	C	T	2	2	4	0	0	4	0	0
2	37927094	.	G	A	0	2	2	0	3	5	0	0
2	37927137	.	T	G	1	0	1	0	4	5	0	0
2	37973679	.	G	A	1	2	3	0	0	3	0	0
2	37990120	.	T	G	2	2	4	0	0	4	0	0
2	37990315	.	A	G	3	6	9	0	1	10	0	0
2	37998116	.	G	A	20	27	47	0	0	47	0	0
2	38000133	.	G	T	20	25	45	0	0	45	0	0
2	38000185	.	G	A	24	26	50	0	0	50	0	0
2	38004485	.	G	A	0	9	9	0	8	17	0	0
2	38004500	.	G	T	10	8	18	0	1	19	0	0
2	38008491	.	G	A	15	7	22	0	1	23	0	0
2	38008916	.	C	T	4	11	15	0	0	15	0	0
2	38018076	.	G	A	12	8	20	0	0	20	0	0
2	38027068	.	G	T	7	12	19	0	0	19	0	0
2	38032270	.	G	A	23	14	37	0	1	38	0	0
2	38033937	.	G	A	14	19	33	0	1	34	0	0
2	38033979	.	C	T	9	18	27	0	0	27	0	0
2	38055638	.	G	C	3	6	9	0	0	9	0	0
2	38055662	.	C	G	2	0	2	0	7	9	0	0
2	38056837	.	T	A	4	3	7	0	0	7	0	0
2	38056840	.	A	G	4	0	4	0	3	7	0	0
2	38064638	.	T	C	5	6	11	0	0	11	0	0
2	38064903	.	T	C	6	2	8	0	0	8	0	0
2	38065056	.	G	A	0	10	10	0	5	15	0	0
2	38065095	.	C	T	4	9	13	0	1	14	0	0
2	38065101	.	G	A	0	6	6	0	4	10	0	0
2	38068593	.	A	G	12	11	23	0	0	23	0	0
2	38068677	.	T	A	12	8	20	0	0	20	0	0
2	38072328	.	T	C	13	14	27	0	1	28	0	0
2	38072460	.	C	T	10	7	17	0	2	19	0	0
2	38072463	.	G	A	9	8	17	0	2	19	0	0
2	38072547	.	C	T	1	12	13	0	14	27	0	0
2	38072670	.	G	T	13	15	28	0	0	28	0	0
2	38072703	.	G	A	17	19	36	0	1	37	0	0
2	38073092	.	A	G	12	11	23	0	1	24	0	0
2	38076425	.	C	T	6	9	15	0	0	15	0	0
2	38076579	.	A	G	6	5	11	0	0	11	0	0
2	38076754	.	G	A	6	4	10	0	1	11	0	0
2	38076884	.	A	T	10	9	19	0	1	20	0	0
2	38078188	.	C	T	9	9	18	0	0	18	0	0
2	38078227	.	G	A	7	7	14	0	0	14	0	0
2	38087879	.	T	A	9	7	16	0	1	17	0	0
2	38088096	.	A	T	8	12	20	0	0	20	0	0
2	38088329	.	C	G	4	9	13	0	0	13	0	0
2	38088454	.	A	G	16	14	30	0	0	30	0	0
2	38088475	.	A	G	15	13	28	0	0	28	0	0
2	38092067	.	G	T	6	3	9	0	0	9	0	0
2	38095343	.	A	T	11	8	19	0	0	19	0	0
2	38098442	.	G	A	3	5	8	0	1	9	0	0
2	38098810	.	G	A	17	7	24	0	1	25	0	0
2	38098871	.	C	T	1	7	8	0	12	20	0	0
2	38101590	.	G	A	5	7	12	0	2	14	0	0
2	38101616	.	T	G	9	5	14	0	0	14	0	0
2	38102335	.	A	T	8	7	15	0	1	16	0	0
2	38106744	.	A	G	9	8	17	0	0	17	0	0
2	38106816	.	G	A	7	4	11	0	0	11	0	0
2	38106825	.	T	C	5	6	11	0	1	12	0	0
2	38109319	.	C	T	0	2	2	0	4	6	0	0
2	38112907	.	T	A	6	3	9	0	0	9	0	0
2	38112917	.	T	C	3	6	9	0	0	9	0	0
2	38112952	.	T	A	5	2	7	0	0	7	0	0
2	38113047	.	C	G	3	4	7	0	0	7	0	0
2	38114196	.	G	T	2	2	4	0	0	4	0	0
2	38114795	.	C	T	5	6	11	0	0	11	0	0
2	38115004	.	T	C	3	6	9	0	0	9	0	0
2	38115528	.	A	T	5	7	12	0	0	12	0	0
2	38115802	.	C	A	5	5	10	0	0	10	0	0
2	38121433	.	T	C	5	7	12	0	0	12	0	0
2	38121536	.	C	T	19	19	38	0	2	40	0	0
2	38121558	.	C	T	17	22	39	0	4	43	0	0
2	38123931	.	G	T	30	28	58	0	2	60	0	0
2	38124030	.	A	G	29	26	55	0	3	58	0	0
2	38125620	.	A	G	4	3	7	0	1	8	0	0
2	38151134	.	C	T	6	5	11	0	0	11	0	0
2	38151154	.	T	A	5	3	8	0	0	8	0	0
2	38151478	.	G	A	0	4	4	0	6	10	0	0
2	38151849	.	T	A	9	4	13	0	0	13	0	0
2	38152523	.	C	T	10	7	17	0	1	18	0	0
2	38152717	.	C	T	9	8	17	0	3	20	0	0
2	38153069	.	T	A	6	8	14	0	0	14	0	0
2	38153884	.	C	T	11	8	19	0	1	20	0	0
2	38153929	.	G	A	11	8	19	0	2	21	0	0
2	38154098	.	T	C	9	7	16	0	5	21	0	0
2	38154107	.	G	A	11	9	20	0	1	21	0	0
2	38154177	.	C	A	10	3	13	0	0	13	0	0
2	38154307	.	A	G	11	9	20	0	0	20	0	0
2	38154879	.	A	T	9	8	17	0	2	19	0	0
2	38155339	.	G	C	6	8	14	1	1	16	0	0
2	38155340	.	T	C	8	6	14	1	1	16	0	0
2	38155479	.	G	A	0	6	6	0	5	11	0	0
2	38155511	.	G	A	5	3	8	0	1	9	0	0
2	38155651	.	G	T	3	4	7	0	0	7	0	0
2	38155802	.	C	T	11	9	20	0	0	20	0	0
2	38156165	.	C	T	6	5	11	0	0	11	0	0
2	38181200	.	G	A	6	3	9	0	1	10	0	0
2	38181561	.	G	T	0	2	2	0	6	8	0	0
2	38182016	.	C	T	3	2	5	0	0	5	0	0
2	38182220	.	G	A	3	3	6	0	0	6	0	0
2	38197892	.	G	A	2	2	4	0	0	4	0	0
2	38198118	.	G	T	25	14	39	0	5	44	0	0
2	38198626	.	C	T	24	29	53	0	2	55	0	0
2	38198627	.	T	G	24	30	54	0	1	55	0	0
2	38199761	.	C	T	19	24	43	0	2	45	0	0
2	38199764	.	G	T	18	22	40	0	3	43	0	0
2	38200181	.	A	G	23	25	48	0	0	49	1	0
2	38200830	.	G	A	23	11	34	0	3	37	0	0
2	38201073	.	T	C	24	0	24	0	13	37	0	0
2	38201864	.	C	A	19	13	32	0	2	34	0	0
2	38202356	.	C	T	24	25	49	0	0	49	0	0
2	38202890	.	C	A	34	37	71	1	1	73	0	0
2	38204025	.	C	A	2	6	8	0	6	14	0	0
2	38204177	.	C	T	9	3	12	0	0	12	0	0
2	38204810	.	T	C	3	3	6	0	0	6	0	0
2	38205968	.	A	C	5	0	5	0	4	9	0	0
2	38205997	.	C	T	0	3	3	0	3	6	0	0
2	38213642	.	G	T	18	15	33	0	6	39	0	0
2	38214094	.	C	T	2	17	19	0	26	45	0	0
2	38214102	.	C	T	27	16	43	0	3	46	0	0
2	38214164	.	C	T	24	28	52	0	1	53	0	0
2	38214720	.	C	T	26	16	42	0	2	44	0	0
2	38214974	.	T	G	8	4	12	26	0	38	0	0
2	38215275	.	C	T	7	7	14	2	2	18	0	0
2	38215391	.	G	A	20	27	47	0	1	49	1	0
2	38215860	.	C	T	1	23	24	0	19	43	0	0
2	38216481	.	C	T	17	23	40	0	8	48	0	0
2	38216502	.	C	T	17	26	43	0	5	48	0	0
2	38216580	.	T	C	17	18	35	0	3	38	0	0
2	38227332	.	C	A	4	2	6	0	0	6	0	0
2	38261830	.	T	C	16	11	27	0	1	28	0	0
2	38265504	.	G	A	10	12	22	0	0	22	0	0
2	38266439	.	C	T	11	10	21	0	0	21	0	0
2	38269105	.	G	A	10	8	18	0	0	18	0	0
2	38269114	.	T	G	7	8	15	0	0	15	0	0
2	38269355	.	G	A	12	4	16	0	1	17	0	0
2	38269435	.	T	C	3	4	7	1	0	8	0	0
2	38269446	.	A	T	4	2	6	1	1	8	0	0
2	38288796	.	A	T	12	15	27	0	2	29	0	0
2	38289260	.	G	A	17	17	34	0	0	34	0	0
2	38289393	.	C	T	10	9	19	1	1	21	0	0
2	38289494	.	T	A	8	7	15	0	2	18	1	0
2	38289496	.	A	G	10	1	11	0	8	19	0	0
2	38289633	.	G	A	7	3	10	0	1	11	0	0
2	38373380	.	T	C	25	23	48	0	1	50	1	0
2	38378888	.	T	A	15	21	36	0	1	37	0	0
2	38391846	.	T	C	18	17	35	1	4	40	0	0
2	38391847	.	T	C	21	18	39	1	1	41	0	0
2	38391945	.	C	T	25	20	45	0	2	47	0	0
2	38687004	.	T	C	11	8	19	0	0	19	0	0
2	38689219	.	C	T	12	5	17	0	1	18	0	0
2	38695337	.	C	T	11	9	20	0	1	21	0	0
2	38699469	.	C	T	7	11	18	0	2	20	0	0
2	38699526	.	G	A	11	13	24	0	0	24	0	0
2	38708714	.	A	T	9	12	21	0	1	22	0	0
2	38708744	.	C	T	19	9	28	0	2	30	0	0
2	38708780	.	T	A	13	14	27	0	3	30	0	0
2	38791377	.	G	A	0	2	2	0	5	7	0	0
2	38791386	.	G	T	0	2	2	0	5	7	0	0
2	38796192	.	C	T	4	6	10	0	0	10	0	0
2	38804272	.	T	C	4	6	10	0	0	10	0	0
2	38852648	.	T	C	5	5	10	0	1	11	0	0
2	38861234	.	C	T	6	7	13	0	0	13	0	0
2	38862666	.	A	T	5	6	11	0	0	11	0	0
2	38880942	.	C	T	11	6	17	0	2	19	0	0
2	38880999	.	G	A	10	7	17	0	0	17	0	0
2	38881164	.	A	G	12	6	18	0	0	18	0	0
2	38887527	.	A	G	4	5	9	0	0	9	0	0
2	38887772	.	C	A	11	4	15	0	1	16	0	0
2	38887932	.	G	C	6	6	12	0	0	12	0	0
2	38888110	.	C	T	6	4	10	1	0	11	0	0
2	38888118	.	T	C	6	4	10	1	0	11	0	0
2	38888170	.	T	C	2	6	8	0	1	9	0	0
2	38888235	.	A	G	11	15	26	0	1	27	0	0
2	38888272	.	T	C	16	8	24	0	0	24	0	0
2	38888517	.	A	C	7	10	17	0	0	17	0	0
2	38888701	.	T	C	5	9	14	0	0	14	0	0
2	38888710	.	G	A	8	4	12	0	1	13	0	0
2	38888789	.	C	T	3	3	6	0	0	6	0	0
2	38888820	.	A	C	8	6	14	0	0	14	0	0
2	38888895	.	T	C	7	6	13	0	0	13	0	0
2	38888939	.	G	T	9	3	12	0	0	12	0	0
2	38888953	.	T	C	2	6	8	0	1	9	0	0
2	38889073	.	G	T	1	3	4	0	0	4	0	0
2	38889114	.	G	A	4	4	8	0	0	8	0	0
2	38889369	.	A	G	14	0	14	0	12	26	0	0
2	38889389	.	G	T	7	16	23	0	1	24	0	0
2	38889487	.	A	G	11	0	11	0	10	21	0	0
2	38889523	.	G	C	0	10	10	0	15	25	0	0
2	38889832	.	G	T	3	6	9	3	0	12	0	0
2	38890481	.	T	C	13	9	22	0	0	22	0	0
2	38890495	.	C	A	8	5	13	0	2	16	1	0
2	38926665	.	C	G	7	6	13	0	0	13	0	0
2	38926780	.	A	C	7	8	15	0	1	16	0	0
2	38926787	.	T	C	8	6	14	0	0	14	0	0
2	38927465	.	A	G	8	0	8	0	9	17	0	0
2	38977157	.	G	A	9	9	18	0	0	18	0	0
2	38977159	.	T	C	7	9	16	0	2	18	0	0
2	38977266	.	C	A	5	2	7	0	0	7	0	0
2	38977269	.	A	G	5	3	8	0	0	8	0	0
2	38997627	.	G	T	22	11	33	1	1	35	0	0
2	38997631	.	A	G	24	10	34	1	3	38	0	0
2	38998100	.	G	T	21	25	46	0	1	47	0	0
2	39001713	.	G	A	18	15	33	0	1	34	0	0
2	39001975	.	A	G	29	19	48	1	0	49	0	0
2	39001993	.	G	T	27	15	42	1	0	43	0	0
2	39002038	.	G	A	24	9	33	1	1	35	0	0
2	39002164	.	C	T	2	23	25	0	12	37	0	0
2	39002546	.	G	C	21	18	39	0	1	40	0	0
2	39002692	.	T	C	17	16	33	0	2	35	0	0
2	39005438	.	C	T	17	19	36	0	0	36	0	0
2	39005447	.	A	G	16	17	33	0	0	33	0	0
2	39011421	.	T	A	16	18	34	0	0	34	0	0
2	39013488	.	T	C	15	0	15	0	19	34	0	0
2	39013572	.	A	T	13	9	22	0	1	23	0	0
2	39015083	.	G	A	8	10	18	0	0	18	0	0
2	39015094	.	A	G	6	5	11	0	0	11	0	0
2	39028695	.	A	G	3	5	8	0	0	8	0	0
2	39028774	.	G	T	2	2	4	0	0	4	0	0
2	39036516	.	G	T	2	11	13	2	0	15	0	0
2	39068306	.	T	A	0	4	4	0	0	4	0	0
2	39068409	.	C	A	5	6	11	0	1	12	0	0
2	39082746	.	A	G	1	4	5	0	0	5	0	0
2	39082799	.	A	G	1	2	3	0	0	3	0	0
2	39108418	.	T	G	7	0	7	0	6	13	0	0
2	39386628	.	G	A	7	3	10	0	0	10	0	0
2	39386670	.	A	G	5	0	5	0	3	8	0	0
2	39394003	.	G	A	0	5	5	0	4	9	0	0
2	39426580	.	T	G	8	0	8	0	4	12	0	0
2	39434308	.	G	T	9	3	12	0	0	12	0	0
2	39497992	.	C	T	6	5	11	0	0	11	0	0
2	39498061	.	A	G	8	6	14	0	0	14	0	0
2	39506808	.	T	G	7	0	7	0	7	14	0	0
2	39523896	.	C	T	4	6	10	0	1	11	0	0
2	39532346	.	C	A	6	5	11	0	0	11	0	0
2	39549780	.	C	T	8	3	11	0	0	11	0	0
2	39549797	.	C	T	10	3	13	0	0	14	1	0
2	39549850	.	A	G	15	4	19	0	0	19	0	0
2	39550141	.	T	C	0	2	2	0	1	3	0	0
2	39550143	.	T	C	1	2	3	0	0	3	0	0
2	39550307	.	T	C	8	6	14	0	1	15	0	0
2	39550343	.	T	A	6	6	12	1	0	13	0	0
2	39550380	.	A	C	5	8	13	2	1	16	0	0
2	39550460	.	A	T	6	4	10	0	0	10	0	0
2	39550494	.	C	T	7	5	12	0	0	12	0	0
2	39550627	.	G	A	12	4	16	0	0	16	0	0
2	39550677	.	T	C	9	10	19	0	1	20	0	0
2	39550755	.	C	T	6	7	13	0	1	14	0	0
2	39550761	.	A	C	5	6	11	0	0	11	0	0
2	39550854	.	G	A	2	13	15	0	5	20	0	0
2	39550901	.	C	T	1	6	7	0	1	8	0	0
2	39551023	.	T	C	4	5	9	0	1	10	0	0
2	39551093	.	A	C	6	5	11	0	1	12	0	0
2	39551185	.	T	C	8	10	18	0	0	18	0	0
2	39551213	.	G	A	0	5	5	0	10	15	0	0
2	39551304	.	C	T	11	7	18	0	0	18	0	0
2	39551529	.	G	A	3	5	8	0	1	9	0	0
2	39551552	.	A	G	3	6	9	0	1	10	0	0
2	39551581	.	C	G	4	4	8	0	0	8	0	0
2	39551869	.	T	G	4	4	8	0	0	8	0	0
2	39552101	.	C	T	3	4	7	0	0	7	0	0
2	39553173	.	A	C	7	4	11	0	0	11	0	0
2	39553209	.	C	T	12	7	19	0	0	19	0	0
2	39553213	.	A	G	11	6	17	0	3	20	0	0
2	39553279	.	G	A	15	7	22	0	0	22	0	0
2	39553283	.	A	T	7	14	21	0	0	21	0	0
2	39553351	.	G	A	8	5	13	0	1	14	0	0
2	39553629	.	T	A	7	1	8	0	0	8	0	0
2	39553633	.	T	A	10	1	11	0	0	11	0	0
2	39554098	.	A	C	5	10	15	0	0	16	1	0
2	39554514	.	A	C	4	12	16	0	0	16	0	0
2	39555273	.	A	G	17	10	27	2	1	30	0	0
2	39584287	.	A	T	2	4	6	0	0	6	0	0
2	39584370	.	T	C	5	0	5	0	3	8	0	0
2	39584465	.	A	T	4	4	8	0	0	8	0	0
2	39584466	.	T	A	5	4	9	0	0	9	0	0
2	39584528	.	G	A	5	5	10	0	2	12	0	0
2	39585130	.	G	A	3	9	12	0	2	14	0	0
2	39649553	.	G	A	4	8	12	0	0	12	0	0
2	39649589	.	C	T	4	7	11	0	0	11	0	0
2	39649592	.	C	T	7	3	10	0	1	11	0	0
2	39649655	.	G	C	6	0	6	0	12	18	0	0
2	39649673	.	C	T	11	4	15	0	1	16	0	0
2	39649799	.	C	T	8	7	15	0	2	17	0	0
2	39650108	.	T	C	6	4	10	0	1	11	0	0
2	39650191	.	T	C	2	10	12	0	2	14	0	0
2	39731567	.	C	T	15	15	30	0	0	30	0	0
2	39732139	.	C	A	12	9	21	0	2	23	0	0
2	39732157	.	G	A	12	10	22	0	0	22	0	0
2	39732710	.	T	C	3	7	10	0	1	11	0	0
2	39732743	.	T	C	3	0	3	0	3	6	0	0
2	39732767	.	A	G	4	5	9	0	0	9	0	0
2	39732818	.	C	T	0	6	6	0	7	13	0	0
2	39732833	.	G	A	10	4	14	0	0	14	0	0
2	39732955	.	A	G	13	12	25	0	0	25	0	0
2	39732967	.	T	G	16	15	31	0	0	31	0	0
2	39733130	.	T	A	16	22	38	0	6	44	0	0
2	39733531	.	C	T	21	6	27	0	1	28	0	0
2	39734298	.	A	G	11	15	26	2	0	28	0	0
2	39734396	.	G	A	17	19	36	0	2	38	0	0
2	39734410	.	A	T	17	21	38	0	2	40	0	0
2	39734444	.	A	G	21	18	39	0	1	40	0	0
2	39734494	.	T	A	10	20	30	0	0	30	0	0
2	39735568	.	T	C	18	0	18	0	17	35	0	0
2	39753775	.	C	A	0	5	5	0	5	10	0	0
2	39758810	.	A	C	7	1	8	0	4	12	0	0
2	39759009	.	G	A	9	16	25	0	0	25	0	0
2	39759044	.	A	G	4	7	11	0	0	11	0	0
2	40067983	.	A	G	4	4	8	0	0	8	0	0
2	40068188	.	C	T	32	23	55	0	1	56	0	0
2	40068238	.	G	A	22	25	47	0	2	49	0	0
2	40068279	.	G	A	23	22	45	0	0	45	0	0
2	40068281	.	T	G	20	21	41	0	4	45	0	0
2	40068372	.	G	A	27	14	41	0	3	44	0	0
2	40068386	.	G	A	14	32	46	0	3	49	0	0
2	40069392	.	G	A	14	17	31	0	2	33	0	0
2	40070040	.	A	G	15	13	28	0	1	29	0	0
2	40074474	.	G	A	8	14	22	0	2	24	0	0
2	40088719	.	G	A	14	14	28	0	0	28	0	0
2	40088785	.	G	A	9	14	23	0	1	24	0	0
2	40090490	.	C	T	18	10	28	0	7	35	0	0
2	40094202	.	A	T	17	18	35	0	1	36	0	0
2	40094217	.	G	C	18	15	33	1	1	35	0	0
2	40100281	.	G	A	6	10	16	0	3	19	0	0
2	40131941	.	G	C	9	12	21	0	3	24	0	0
2	40132034	.	C	T	15	9	24	0	3	27	0	0
2	40134719	.	G	A	10	6	16	0	0	16	0	0
2	40135884	.	G	A	15	7	22	0	0	22	0	0
2	40342644	.	T	C	9	12	21	0	0	21	0	0
2	40342776	.	T	C	15	6	21	0	0	21	0	0
2	40342875	.	G	T	7	9	16	0	1	17	0	0
2	40407135	.	A	G	11	13	24	0	1	25	0	0
2	40412057	.	C	A	7	17	24	0	1	25	0	0
2	40469097	.	T	C	12	14	26	0	1	27	0	0
2	40500542	.	T	C	10	7	17	0	1	18	0	0
2	40500596	.	T	C	10	10	20	0	0	20	0	0
2	40507030	.	T	C	16	12	28	0	1	29	0	0
2	40507060	.	A	G	15	14	29	0	1	30	0	0
2	40513998	.	C	T	9	11	20	0	0	20	0	0
2	40830967	.	T	C	2	9	11	0	0	11	0	0
2	40831047	.	A	G	9	8	17	0	0	17	0	0
2	40831103	.	T	C	5	0	5	0	3	8	0	0
2	40831119	.	C	A	4	3	7	0	0	7	0	0
2	40831176	.	A	T	3	3	6	0	0	6	0	0
2	40831568	.	G	A	4	5	9	0	0	9	0	0
2	40831613	.	A	T	3	2	5	0	1	6	0	0
2	40831728	.	T	C	3	5	8	0	0	8	0	0
2	40831797	.	C	T	6	4	10	0	1	11	0	0
2	40831822	.	T	A	9	4	13	0	0	13	0	0
2	40831974	.	C	G	4	3	7	0	0	7	0	0
2	40832412	.	T	A	3	2	5	0	0	5	0	0
2	40832416	.	A	G	3	2	5	0	0	5	0	0
2	40832537	.	T	A	2	2	4	0	0	4	0	0
2	40832596	.	C	T	2	5	7	0	0	7	0	0
2	40832984	.	T	C	3	5	8	0	0	8	0	0
2	40833032	.	C	T	0	3	3	0	3	6	0	0
2	40833063	.	A	G	2	3	5	0	0	5	0	0
2	40833068	.	A	G	2	4	6	0	0	6	0	0
2	40833229	.	A	T	3	2	5	0	0	5	0	0
2	40834735	.	T	C	3	5	8	0	0	8	0	0
2	40866720	.	G	A	5	3	8	0	0	8	0	0
2	40902411	.	A	G	5	8	13	0	0	13	0	0
2	40902444	.	A	G	5	8	13	0	0	13	0	0
2	41524321	.	A	G	6	9	15	0	0	15	0	0
2	41532745	.	A	G	9	9	18	0	0	18	0	0
2	41532746	.	A	G	7	8	15	0	2	17	0	0
2	41537384	.	T	G	13	1	14	0	11	25	0	0
2	41539251	.	G	A	0	11	11	0	13	24	0	0
2	41542080	.	T	G	15	14	29	0	0	29	0	0
2	41542451	.	T	C	13	4	17	2	1	20	0	0
2	41542601	.	G	A	14	13	27	0	0	27	0	0
2	41542637	.	A	G	16	0	16	0	13	29	0	0
2	41542738	.	T	A	7	8	15	0	3	18	0	0
2	41549678	.	G	A	4	2	6	0	1	7	0	0
2	41552835	.	G	A	1	4	5	0	0	5	0	0
2	41552916	.	A	G	1	3	4	0	0	4	0	0
2	41556739	.	A	G	4	2	6	0	0	6	0	0
2	41558407	.	T	C	3	3	6	0	0	6	0	0
2	41561884	.	C	T	0	2	2	0	3	5	0	0
2	41561902	.	T	C	3	2	5	0	0	5	0	0
2	41563686	.	T	G	10	6	16	0	1	17	0	0
2	41563689	.	G	A	11	5	16	0	0	16	0	0
2	41566463	.	T	C	5	11	16	0	2	18	0	0
2	41566770	.	T	G	15	9	24	0	0	24	0	0
2	41566852	.	C	T	3	6	9	0	1	10	0	0
2	41569177	.	T	C	7	15	22	0	1	23	0	0
2	41571398	.	A	T	10	15	25	0	0	25	0	0
2	41571440	.	A	G	2	3	5	0	0	5	0	0
2	41578181	.	A	T	20	27	47	0	0	47	0	0
2	41578281	.	C	T	12	14	26	1	3	31	1	0
2	41578656	.	C	A	11	5	16	0	0	16	0	0
2	41578716	.	T	A	13	7	20	0	0	20	0	0
2	41578921	.	C	T	8	9	17	0	0	17	0	0
2	41579222	.	T	C	5	4	9	0	0	9	0	0
2	41579539	.	C	G	0	9	9	0	7	17	1	0
2	41579572	.	C	G	9	8	17	0	0	17	0	0
2	41579621	.	A	C	11	0	11	1	5	17	0	0
2	41579646	.	G	T	9	6	15	1	1	17	0	0
2	41579701	.	G	C	11	7	18	0	0	18	0	0
2	41579804	.	T	C	16	14	30	0	0	30	0	0
2	41579952	.	C	A	12	8	20	0	3	23	0	0
2	41579984	.	A	G	17	8	25	0	0	25	0	0
2	41580004	.	C	A	18	9	27	0	0	27	0	0
2	41580028	.	T	C	16	7	23	0	0	23	0	0
2	41580125	.	C	T	8	13	21	0	0	21	0	0
2	41580263	.	T	A	7	15	22	0	1	23	0	0
2	41580473	.	C	T	2	17	19	0	10	29	0	0
2	41580522	.	G	A	9	13	22	0	2	24	0	0
2	41580546	.	A	G	14	6	20	0	3	23	0	0
2	41580715	.	C	T	2	15	17	0	15	32	0	0
2	41580832	.	G	T	7	11	18	0	0	18	0	0
2	41580897	.	T	C	13	7	20	1	0	21	0	0
2	41580946	.	A	C	16	14	30	0	1	31	0	0
2	41580966	.	T	C	23	15	38	0	2	40	0	0
2	41581035	.	T	A	38	14	52	2	0	54	0	0
2	41581042	.	C	G	5	8	13	0	36	49	0	0
2	41581815	.	T	A	11	17	28	2	3	33	0	0
2	41581998	.	G	T	11	11	22	11	6	39	0	0
2	41582383	.	A	C	9	15	24	0	2	26	0	0
2	41582801	.	T	C	4	8	12	0	0	12	0	0
2	41582805	.	C	T	3	6	9	0	2	11	0	0
2	41582923	.	C	T	7	10	17	0	1	18	0	0
2	41583007	.	A	G	13	17	30	0	2	32	0	0
2	41583043	.	A	G	7	20	27	0	1	28	0	0
2	41583171	.	C	T	2	19	21	0	22	43	0	0
2	41585878	.	A	G	10	14	24	0	1	25	0	0
2	41597062	.	A	C	10	0	10	0	18	28	0	0
2	41599247	.	G	A	12	13	25	1	1	27	0	0
2	41835464	.	G	A	1	2	3	0	0	3	0	0
2	41841958	.	C	T	3	1	4	0	1	5	0	0
2	41841970	.	T	C	4	0	4	0	1	5	0	0
2	41846755	.	C	T	1	2	3	0	0	3	0	0
2	41920356	.	C	A	1	2	3	0	0	3	0	0
2	42039046	.	G	A	3	7	10	0	0	10	0	0
2	42039112	.	A	G	2	6	8	0	0	8	0	0
2	42039297	.	C	G	0	7	7	0	7	14	0	0
2	42049030	.	G	C	5	9	14	0	0	14	0	0
2	42049795	.	T	A	6	5	11	0	1	12	0	0
2	42049797	.	T	G	6	5	11	0	1	12	0	0
2	42051071	.	G	A	3	6	9	0	1	10	0	0
2	42063897	.	C	T	1	6	7	0	5	12	0	0
2	42068217	.	T	G	5	4	9	0	0	9	0	0
2	42071276	.	A	T	2	6	8	0	0	8	0	0
2	42071387	.	G	A	1	2	3	0	0	3	0	0
2	42071427	.	T	G	1	3	4	0	0	4	0	0
2	42071507	.	A	T	3	2	5	0	0	5	0	0
2	42072958	.	G	A	5	5	10	0	1	11	0	0
2	42073030	.	T	C	3	2	5	0	0	5	0	0
2	42073153	.	T	C	5	4	9	0	1	10	0	0
2	42073261	.	G	A	5	7	12	0	0	12	0	0
2	42073834	.	T	C	3	5	8	0	0	8	0	0
2	42073879	.	T	C	5	3	8	0	0	8	0	0
2	42073933	.	G	A	0	6	6	0	7	13	0	0
2	42074080	.	A	T	5	4	9	0	1	10	0	0
2	42074173	.	G	A	0	2	2	0	2	4	0	0
2	42074419	.	A	G	5	0	5	0	7	12	0	0
2	42074485	.	C	T	4	6	10	0	1	11	0	0
2	42074515	.	G	A	2	8	10	0	0	10	0	0
2	42074671	.	C	G	7	6	13	0	0	13	0	0
2	42075103	.	T	G	6	0	6	0	4	10	0	0
2	42075106	.	G	T	1	4	5	0	5	10	0	0
2	42075160	.	C	T	6	4	10	0	0	10	0	0
2	42081425	.	T	C	4	12	16	0	0	16	0	0
2	42117827	.	A	G	1	2	3	0	0	3	0	0
2	42117874	.	G	A	1	2	3	0	0	3	0	0
2	42156579	.	A	G	13	15	28	0	0	28	0	0
2	42156637	.	G	A	22	11	33	0	0	33	0	0
2	42158839	.	C	T	16	13	29	0	1	30	0	0
2	42159159	.	G	T	11	15	26	0	1	27	0	0
2	42161309	.	A	G	24	23	47	0	0	47	0	0
2	42161351	.	C	T	13	25	38	0	2	40	0	0
2	42168496	.	G	A	27	17	44	0	0	44	0	0
2	42168505	.	A	T	29	14	43	0	0	43	0	0
2	42176962	.	T	C	13	14	27	0	1	28	0	0
2	42177056	.	C	T	10	10	20	0	2	22	0	0
2	42177075	.	G	A	8	14	22	0	2	24	0	0
2	42179607	.	C	A	7	6	13	0	1	14	0	0
2	42179675	.	A	G	3	0	3	0	6	9	0	0
2	42182051	.	T	A	7	7	14	0	1	15	0	0
2	42182089	.	A	G	3	8	11	0	1	12	0	0
2	42184056	.	T	G	10	10	20	0	0	20	0	0
2	42200453	.	C	A	6	9	15	0	0	15	0	0
2	42200520	.	G	T	7	3	10	0	0	10	0	0
2	42202043	.	T	C	8	13	21	0	2	23	0	0
2	42206954	.	A	G	6	4	10	0	0	10	0	0
2	42210061	.	T	C	3	7	10	0	0	10	0	0
2	42210431	.	G	T	2	2	4	0	0	4	0	0
2	42210486	.	C	T	4	5	9	0	0	9	0	0
2	42220876	.	C	T	10	5	15	0	1	16	0	0
2	42220887	.	C	T	10	5	15	0	1	16	0	0
2	42221346	.	T	G	8	5	13	0	1	14	0	0
2	42221956	.	A	G	4	0	4	0	8	12	0	0
2	42224067	.	C	T	2	4	6	0	0	6	0	0
2	42224171	.	G	T	0	5	5	0	4	9	0	0
2	42224255	.	G	A	4	4	8	0	0	8	0	0
2	42224315	.	C	T	4	8	12	0	0	12	0	0
2	42224403	.	G	C	0	8	8	0	3	11	0	0
2	42224455	.	C	T	3	8	11	0	0	11	0	0
2	42224535	.	T	G	6	9	15	0	1	16	0	0
2	42224544	.	C	A	8	9	17	0	1	18	0	0
2	42224628	.	C	A	3	5	8	0	0	8	0	0
2	42224629	.	A	G	3	5	8	0	0	8	0	0
2	42354655	.	G	A	1	2	3	0	0	3	0	0
2	42354723	.	G	A	4	3	7	1	0	8	0	0
2	42354819	.	G	T	4	2	6	0	0	6	0	0
2	42354839	.	A	G	4	3	7	0	0	7	0	0
2	42354922	.	A	G	4	3	7	0	0	7	0	0
2	42355076	.	T	A	5	2	7	0	0	7	0	0
2	42355086	.	A	G	5	5	10	0	0	10	0	0
2	42355132	.	C	T	6	4	10	0	0	10	0	0
2	42355413	.	G	A	4	3	7	0	0	7	0	0
2	42355443	.	G	T	7	3	10	0	0	10	0	0
2	42355919	.	A	C	3	0	3	0	3	6	0	0
2	42355920	.	A	G	4	3	7	0	0	7	0	0
2	42356022	.	G	T	2	4	6	0	0	6	0	0
2	42360123	.	C	T	8	6	14	0	0	14	0	0
2	42360162	.	C	T	0	5	5	0	8	13	0	0
2	42360216	.	A	T	6	3	9	0	0	9	0	0
2	42361415	.	T	C	3	3	6	0	0	6	0	0
2	42361517	.	C	A	5	12	17	0	0	17	0	0
2	42361616	.	T	A	4	10	14	0	1	15	0	0
2	42361790	.	C	T	11	17	28	0	0	28	0	0
2	42370736	.	A	G	13	24	37	0	0	37	0	0
2	42373646	.	G	T	17	22	39	0	2	41	0	0
2	42374218	.	G	A	21	13	34	0	3	37	0	0
2	42382574	.	G	A	4	5	9	0	0	9	0	0
2	42382609	.	G	T	6	8	14	0	0	14	0	0
2	42382670	.	G	A	5	13	18	0	2	20	0	0
2	42382687	.	C	G	8	11	19	0	0	19	0	0
2	42382744	.	T	C	11	18	29	0	0	29	0	0
2	42382905	.	T	A	15	15	30	0	2	32	0	0
2	42383032	.	A	G	7	9	16	0	2	18	0	0
2	42383064	.	C	T	0	7	7	0	13	20	0	0
2	42383071	.	T	C	16	7	23	0	0	23	0	0
2	42383209	.	A	G	12	9	21	0	4	25	0	0
2	42383227	.	T	G	19	10	29	0	1	30	0	0
2	42383263	.	A	G	22	18	40	0	1	41	0	0
2	42383327	.	G	A	21	13	34	0	1	35	0	0
2	42383757	.	A	C	27	15	42	0	1	43	0	0
2	42383768	.	A	G	26	15	41	0	3	44	0	0
2	42383947	.	C	A	27	14	41	0	0	41	0	0
2	42384313	.	A	G	15	13	28	1	0	29	0	0
2	42384338	.	C	A	20	11	31	1	3	35	0	0
2	42384587	.	C	A	22	9	31	1	3	35	0	0
2	42384588	.	A	G	24	10	34	1	0	35	0	0
2	42384637	.	G	A	16	11	27	1	0	28	0	0
2	42384699	.	A	C	28	10	38	0	4	42	0	0
2	42384961	.	T	G	18	10	28	0	0	28	0	0
2	42385022	.	T	C	16	7	23	0	4	27	0	0
2	42385023	.	T	C	18	8	26	0	1	27	0	0
2	42385447	.	C	G	4	8	12	0	14	26	0	0
2	42385498	.	T	C	10	0	10	0	11	21	0	0
2	42388272	.	G	A	11	10	21	0	0	21	0	0
2	42388341	.	A	G	13	7	20	0	0	20	0	0
2	42391328	.	C	T	11	10	21	0	1	22	0	0
2	42393550	.	C	T	1	8	9	0	9	18	0	0
2	42396218	.	A	G	10	6	16	0	1	17	0	0
2	42399232	.	T	G	30	12	42	1	7	50	0	0
2	42401362	.	G	C	28	24	52	0	3	55	0	0
2	42415745	.	G	A	25	27	52	0	3	55	0	0
2	42415798	.	G	A	18	19	37	0	1	38	0	0
2	42420100	.	T	A	0	2	2	0	1	3	0	0
2	42420296	.	A	G	1	3	4	0	0	4	0	0
2	42420395	.	A	G	3	7	10	0	0	10	0	0
2	42420430	.	T	A	2	6	8	0	0	8	0	0
2	42420541	.	T	C	4	2	6	0	0	6	0	0
2	42420542	.	G	A	2	4	6	0	0	6	0	0
2	42421547	.	T	G	1	3	4	0	0	4	0	0
2	42421884	.	T	C	3	3	6	0	0	6	0	0
2	42421888	.	T	A	3	3	6	0	0	6	0	0
2	42421921	.	T	G	3	3	6	0	0	6	0	0
2	42422169	.	T	C	1	2	3	0	1	4	0	0
2	42422347	.	G	A	1	4	5	0	0	5	0	0
2	42422589	.	C	T	5	3	8	0	0	8	0	0
2	42424988	.	C	T	5	3	8	0	0	8	0	0
2	42425216	.	T	C	6	3	9	0	0	9	0	0
2	42425227	.	C	T	0	3	3	0	4	7	0	0
2	42432137	.	G	C	3	0	3	1	4	8	0	0
2	42432200	.	T	A	5	5	10	0	0	10	0	0
2	42501860	.	G	A	16	18	34	0	0	34	0	0
2	42504589	.	G	C	11	12	23	0	0	23	0	0
2	42508957	.	G	A	8	8	16	0	0	16	0	0
2	42508987	.	C	A	14	9	23	0	0	23	0	0
2	42510637	.	G	A	6	6	12	0	0	12	0	0
2	42510664	.	G	A	8	5	13	0	2	15	0	0
2	42511435	.	C	T	7	6	13	0	1	14	0	0
2	42511464	.	T	G	7	4	11	0	0	11	0	0
2	42511681	.	T	C	5	6	11	0	1	12	0	0
2	42517602	.	G	A	11	10	21	0	0	21	0	0
2	42519767	.	G	A	9	19	28	0	3	31	0	0
2	42519897	.	T	C	11	18	29	0	0	29	0	0
2	42526893	.	A	G	10	5	15	0	0	15	0	0
2	42526931	.	G	A	7	10	17	0	0	17	0	0
2	42530463	.	G	A	5	8	13	0	0	13	0	0
2	42542024	.	T	C	13	5	18	0	0	18	0	0
2	42550602	.	C	T	13	7	20	0	2	22	0	0
2	42552653	.	G	A	5	12	17	0	0	17	0	0
2	42592887	.	G	A	7	3	10	0	0	10	0	0
2	42597593	.	C	T	2	5	7	0	0	7	0	0
2	42599855	.	A	G	6	6	12	0	1	13	0	0
2	42599962	.	C	G	2	7	9	0	2	11	0	0
2	42609479	.	A	G	3	2	5	0	0	5	0	0
2	42609689	.	T	G	6	3	9	0	1	10	0	0
2	42627432	.	T	A	2	4	6	0	0	6	0	0
2	42627465	.	T	G	2	3	5	0	0	5	0	0
2	42717417	.	G	A	0	2	2	0	5	7	0	0
2	42717441	.	G	A	4	2	6	0	0	6	0	0
2	42746504	.	G	C	33	39	72	0	2	74	0	0
2	42746530	.	G	T	10	40	50	0	28	78	0	0
2	42746604	.	C	T	35	31	66	0	4	70	0	0
2	42746833	.	C	T	38	42	80	0	2	82	0	0
2	42747069	.	G	T	35	31	66	0	2	68	0	0
2	42747281	.	T	G	25	33	58	0	3	61	0	0
2	42747389	.	T	C	29	16	45	2	12	59	0	0
2	42748186	.	A	T	31	23	54	1	14	69	0	0
2	42748211	.	A	G	40	35	75	2	3	80	0	0
2	42748257	.	G	C	53	17	70	2	1	73	0	0
2	42776527	.	A	G	10	20	30	0	1	31	0	0
2	42776569	.	A	G	14	15	29	0	0	29	0	0
2	42776683	.	A	G	9	18	27	0	0	27	0	0
2	42780597	.	T	A	12	11	23	0	1	24	0	0
2	42780657	.	T	C	16	15	31	0	1	32	0	0
2	42814888	.	A	G	14	8	22	0	0	22	0	0
2	42814928	.	A	G	15	11	26	0	0	26	0	0
2	42817384	.	G	T	10	7	17	0	1	18	0	0
2	42817462	.	A	T	12	6	18	0	1	19	0	0
2	42817504	.	G	A	15	8	23	0	0	23	0	0
2	42864455	.	A	G	5	4	9	0	1	10	0	0
2	42872714	.	C	A	8	6	14	0	0	14	0	0
2	42878877	.	G	T	8	2	10	0	0	10	0	0
2	42878884	.	G	A	0	3	3	0	7	10	0	0
2	42925153	.	G	A	18	7	25	0	0	25	0	0
2	42926029	.	A	G	1	2	3	0	0	3	0	0
2	42930540	.	A	C	12	9	21	0	1	22	0	0
2	43004419	.	T	C	10	1	11	0	4	15	0	0
2	43005260	.	T	A	7	6	13	0	2	15	0	0
2	43027530	.	A	G	5	7	12	0	1	13	0	0
2	43031914	.	A	G	3	2	5	0	0	5	0	0
2	43082195	.	G	A	2	8	10	0	0	10	0	0
2	43082608	.	G	A	9	14	23	0	0	23	0	0
2	43111833	.	A	T	1	1	2	0	1	3	0	0
2	43113478	.	T	C	5	3	8	0	0	8	0	0
2	43159217	.	T	G	17	15	32	0	1	33	0	0
2	43159293	.	G	A	18	8	26	2	2	30	0	0
2	43159302	.	A	C	20	7	27	2	1	30	0	0
2	43159390	.	A	T	17	8	25	0	1	26	0	0
2	43159396	.	T	C	19	9	28	0	0	28	0	0
2	43159500	.	G	A	10	10	20	0	0	20	0	0
2	43159613	.	A	G	9	6	15	0	1	16	0	0
2	43159781	.	A	G	17	9	26	0	2	28	0	0
2	43159868	.	T	C	14	10	24	1	0	25	0	0
2	43163958	.	T	C	15	0	15	0	6	21	0	0
2	43168096	.	T	C	13	6	19	0	1	20	0	0
2	43168123	.	A	G	14	11	25	0	0	25	0	0
2	43255059	.	A	G	1	0	1	0	2	3	0	0
2	43255535	.	C	T	2	3	5	0	0	5	0	0
2	43255541	.	A	G	2	3	5	0	0	5	0	0
2	43290752	.	G	A	0	3	3	0	1	4	0	0
2	43316494	.	A	T	5	2	7	0	0	7	0	0
2	43316536	.	G	A	4	4	8	0	0	8	0	0
2	43316580	.	A	G	2	3	5	0	0	5	0	0
2	43329425	.	A	G	0	0	0	0	4	4	0	0
2	43385029	.	A	G	3	2	5	0	0	5	0	0
2	43388865	.	A	T	2	3	5	0	0	5	0	0
2	43389036	.	T	A	2	3	5	0	1	6	0	0
2	43389160	.	A	T	1	3	4	0	0	4	0	0
2	43469388	.	C	A	5	0	5	0	2	7	0	0
2	43469389	.	T	C	5	2	7	0	0	7	0	0
2	43493466	.	G	C	0	5	5	0	8	13	0	0
2	43505035	.	C	T	7	6	13	0	0	13	0	0
2	43507219	.	G	A	3	5	8	0	6	14	0	0
2	43509935	.	A	C	5	8	13	0	1	14	0	0
2	43513660	.	G	A	4	4	8	0	1	9	0	0
2	43516460	.	T	C	4	3	7	0	0	7	0	0
2	43577748	.	C	T	0	3	3	0	6	9	0	0
2	43577775	.	T	C	4	0	4	0	4	8	0	0
2	43578658	.	T	C	2	6	8	0	0	8	0	0
2	43586793	.	A	C	19	7	26	0	1	27	0	0
2	43587478	.	A	T	15	15	30	0	0	30	0	0
2	43589691	.	C	G	10	12	22	0	1	23	0	0
2	43589856	.	T	C	20	15	35	0	1	36	0	0
2	43590136	.	A	T	14	15	29	0	0	29	0	0
2	43593210	.	C	T	2	15	17	0	11	28	0	0
2	43593651	.	T	C	15	8	23	0	0	23	0	0
2	43593696	.	T	G	14	10	24	0	0	24	0	0
2	43714362	.	A	G	16	16	32	0	2	34	0	0
2	43723092	.	C	T	19	19	38	0	0	38	0	0
2	43739287	.	T	C	18	15	33	0	0	33	0	0
2	43739401	.	G	C	14	11	25	0	2	27	0	0
2	43787827	.	A	G	6	5	11	0	0	11	0	0
2	43795117	.	G	A	10	5	15	0	0	15	0	0
2	43795990	.	A	C	5	3	8	0	0	8	0	0
2	43796598	.	T	C	5	2	7	0	0	7	0	0
2	43796738	.	G	A	1	3	4	0	4	8	0	0
2	43796756	.	G	A	0	2	2	0	7	9	0	0
2	43807356	.	G	A	3	5	8	0	0	8	0	0
2	43807536	.	A	G	14	9	23	0	0	23	0	0
2	43807566	.	T	G	12	10	22	0	1	23	0	0
2	43813088	.	A	G	5	10	15	0	1	16	0	0
2	43813193	.	G	A	12	11	23	0	2	25	0	0
2	43816952	.	G	T	10	11	21	0	0	21	0	0
2	43817247	.	C	T	4	8	12	0	1	13	0	0
2	43817303	.	C	T	8	7	15	0	0	15	0	0
2	43817593	.	C	T	14	7	21	0	1	22	0	0
2	43817760	.	A	C	10	6	16	0	1	17	0	0
2	43817826	.	C	T	1	5	6	0	5	11	0	0
2	43817875	.	T	G	6	7	13	0	0	13	0	0
2	43826043	.	A	C	6	0	6	0	9	15	0	0
2	43962071	.	C	G	5	11	16	0	0	16	0	0
2	43962108	.	C	A	0	7	7	0	6	13	0	0
2	43962242	.	T	A	8	8	16	0	0	16	0	0
2	43962279	.	C	T	8	13	21	0	0	21	0	0
2	43962328	.	T	A	9	9	18	0	0	18	0	0
2	43962483	.	T	A	6	12	18	0	2	20	0	0
2	43962600	.	C	T	3	5	8	0	0	8	0	0
2	43962864	.	C	T	2	12	14	0	12	26	0	0
2	43962983	.	T	C	8	16	24	0	0	24	0	0
2	43963097	.	G	C	15	16	31	0	1	32	0	0
2	43963136	.	C	T	3	7	10	0	17	27	0	0
2	43963163	.	C	T	1	6	7	0	16	23	0	0
2	43963202	.	T	C	15	0	15	0	10	25	0	0
2	43963454	.	A	T	16	12	28	0	1	29	0	0
2	43963493	.	A	G	15	15	30	0	0	30	0	0
2	43976261	.	G	A	4	7	11	0	2	13	0	0
2	43976333	.	C	A	9	10	19	0	0	19	0	0
2	43976339	.	T	C	8	1	9	0	10	19	0	0
2	43983668	.	T	A	7	18	25	0	1	26	0	0
2	43987317	.	G	A	8	9	17	0	0	17	0	0
2	44082542	.	G	A	13	14	27	0	0	27	0	0
2	44183301	.	G	A	13	18	31	0	1	32	0	0
2	44192871	.	T	C	13	13	26	0	1	27	0	0
2	44192893	.	T	C	14	16	30	0	1	31	0	0
2	44193029	.	T	A	18	24	42	0	2	44	0	0
2	44193742	.	C	T	2	29	31	1	11	43	0	0
2	44193769	.	T	G	18	30	48	1	0	49	0	0
2	44199761	.	G	C	2	0	2	0	8	10	0	0
2	44199776	.	T	G	1	7	8	0	0	8	0	0
2	44259855	.	G	A	43	36	79	0	2	81	0	0
2	44260002	.	C	T	40	50	90	0	4	94	0	0
2	44260088	.	A	G	35	37	72	0	4	76	0	0
2	44260100	.	A	T	32	45	77	0	0	77	0	0
2	44260358	.	G	A	29	42	71	0	10	81	0	0
2	44260836	.	T	C	44	3	47	6	25	78	0	0
2	44261028	.	A	G	34	29	63	0	2	65	0	0
2	44263025	.	G	A	8	10	18	0	0	18	0	0
2	44263063	.	T	C	10	8	18	0	0	18	0	0
2	44263068	.	C	T	10	8	18	0	0	18	0	0
2	44276731	.	A	G	46	28	74	0	4	78	0	0
2	44304374	.	A	G	11	3	14	0	1	15	0	0
2	44304386	.	T	C	11	3	14	0	0	14	0	0
2	44304485	.	G	C	6	0	6	0	7	13	0	0
2	44304515	.	T	C	6	9	15	0	2	17	0	0
2	44312641	.	G	A	3	6	9	0	0	9	0	0
2	44327877	.	C	T	2	9	11	0	0	11	0	0
2	44328056	.	A	G	7	2	9	0	1	10	0	0
2	44331020	.	T	C	3	5	8	0	0	8	0	0
2	44333396	.	G	A	2	3	5	0	0	5	0	0
2	44338314	.	A	T	4	3	7	0	1	8	0	0
2	44338569	.	T	C	4	6	10	0	1	11	0	0
2	44338973	.	G	T	4	3	7	0	1	8	0	0
2	44339189	.	C	A	5	4	9	0	0	9	0	0
2	44340788	.	C	T	3	4	7	0	0	7	0	0
2	44362435	.	G	A	1	2	3	0	0	3	0	0
2	44383457	.	A	G	6	5	11	0	0	11	0	0
2	44398551	.	A	C	15	20	35	0	5	40	0	0
2	44446240	.	T	C	9	4	13	0	0	13	0	0
2	44446246	.	G	A	9	5	14	0	0	14	0	0
2	44470110	.	A	G	8	1	9	0	11	20	0	0
2	44484882	.	T	C	7	13	20	0	0	20	0	0
2	44508273	.	A	G	10	12	22	0	1	23	0	0
2	44509873	.	T	C	16	7	23	0	0	23	0	0
2	44510073	.	T	C	16	18	34	0	1	35	0	0
2	44510263	.	T	A	7	6	13	0	1	14	0	0
2	44510273	.	T	G	5	9	14	0	1	15	0	0
2	44510506	.	A	G	5	1	6	0	3	9	0	0
2	44510569	.	T	C	5	3	8	0	0	8	0	0
2	44510596	.	A	G	2	4	6	0	2	8	0	0
2	44550903	.	G	A	1	3	4	0	4	8	0	0
2	44550950	.	C	T	4	3	7	0	0	7	0	0
2	44554362	.	A	T	7	4	11	0	1	12	0	0
2	44556982	.	G	A	0	2	2	0	3	5	0	0
2	44556983	.	G	A	3	2	5	0	0	5	0	0
2	44557141	.	C	T	5	5	10	0	1	11	0	0
2	44557187	.	T	C	6	6	12	0	1	13	0	0
2	44573974	.	C	T	4	2	6	0	0	6	0	0
2	44574228	.	C	T	4	5	9	0	1	10	0	0
2	44604202	.	T	C	5	2	7	0	0	7	0	0
2	44604220	.	T	C	2	2	4	0	0	4	0	0
2	44604431	.	A	G	2	0	2	0	2	4	0	0
2	44621086	.	A	C	4	7	11	0	0	11	0	0
2	44625144	.	T	C	3	3	6	0	0	6	0	0
2	44633487	.	A	G	5	0	5	0	6	11	0	0
2	44643544	.	A	G	2	3	5	0	0	5	0	0
2	44643559	.	A	G	1	3	4	0	0	4	0	0
2	44643678	.	G	T	1	5	6	1	0	7	0	0
2	44643696	.	T	G	5	4	9	1	0	10	0	0
2	44666553	.	A	T	8	6	14	0	0	14	0	0
2	44666558	.	G	C	9	7	16	0	0	16	0	0
2	44666838	.	G	A	2	6	8	0	2	10	0	0
2	44669595	.	G	T	6	7	13	0	1	14	0	0
2	44678904	.	C	G	5	11	16	0	0	16	0	0
2	44678913	.	A	G	5	9	14	0	0	14	0	0
2	44679856	.	G	A	1	3	4	0	2	6	0	0
2	44682684	.	C	T	6	5	11	0	1	12	0	0
2	44690374	.	T	A	8	4	12	0	0	12	0	0
2	44690398	.	T	C	4	8	12	0	0	12	0	0
2	44692527	.	T	C	2	6	8	0	1	9	0	0
2	44692529	.	C	T	3	4	7	0	2	9	0	0
2	44692570	.	T	A	4	2	6	0	0	6	0	0
2	44692601	.	A	G	6	0	6	0	3	9	0	0
2	44692638	.	C	G	5	6	11	0	0	11	0	0
2	44692641	.	A	G	5	0	5	0	6	11	0	0
2	44692691	.	C	T	6	3	9	0	1	10	0	0
2	44692696	.	T	C	7	3	10	0	0	10	0	0
2	44692746	.	C	T	7	4	11	0	0	11	0	0
2	44692804	.	T	C	7	4	11	0	0	11	0	0
2	44692813	.	G	T	4	3	7	0	0	7	0	0
2	44692848	.	A	G	2	5	7	0	0	7	0	0
2	44697590	.	T	C	17	11	28	0	1	29	0	0
2	44720175	.	A	G	16	18	34	0	1	35	0	0
2	44720201	.	G	A	13	15	28	0	3	31	0	0
2	44720423	.	G	A	11	11	22	0	3	25	0	0
2	44752545	.	A	G	3	6	9	0	1	10	0	0
2	44757781	.	G	A	2	4	6	0	0	6	0	0
2	44757790	.	C	T	1	4	5	0	0	5	0	0
2	44757826	.	A	G	1	7	8	0	0	8	0	0
2	44757967	.	G	A	3	5	8	0	0	8	0	0
2	44759674	.	A	G	4	4	8	0	0	8	0	0
2	44759953	.	A	G	3	2	5	0	0	5	0	0
2	44759956	.	G	A	3	3	6	0	0	6	0	0
2	44760075	.	A	G	1	1	2	0	0	2	0	0
2	44760093	.	C	T	1	3	4	0	0	4	0	0
2	44762311	.	A	G	2	3	5	0	0	5	0	0
2	44765755	.	A	C	3	3	6	0	0	6	0	0
2	44768889	.	C	T	3	3	6	0	0	6	0	0
2	44770749	.	T	C	3	5	8	0	0	8	0	0
2	44770758	.	G	A	3	5	8	0	0	8	0	0
2	44837439	.	T	A	2	4	6	0	0	6	0	0
2	44923148	.	A	G	2	2	4	0	0	4	0	0
2	44924647	.	T	C	1	2	3	0	0	3	0	0
2	44924662	.	G	A	0	2	2	0	1	3	0	0
2	44944789	.	A	T	37	27	64	0	1	65	0	0
2	44963010	.	G	A	1	2	3	0	0	3	0	0
2	44963011	.	A	G	1	2	3	0	0	3	0	0
2	44963053	.	G	A	3	4	7	0	0	7	0	0
2	44963192	.	A	G	3	2	5	0	1	6	0	0
2	44963670	.	G	T	3	2	5	0	0	5	0	0
2	44964111	.	C	T	1	2	3	0	0	3	0	0
2	44964427	.	C	A	1	3	4	0	0	4	0	0
2	44964514	.	C	T	4	3	7	0	0	7	0	0
2	44964516	.	T	A	4	3	7	0	0	7	0	0
2	44964576	.	T	A	2	2	4	0	0	4	0	0
2	44964577	.	C	A	2	2	4	0	0	4	0	0
2	44964688	.	C	G	0	3	3	0	2	5	0	0
2	44964773	.	T	C	2	3	5	0	0	5	0	0
2	44965165	.	A	T	4	2	6	0	0	6	0	0
2	44965921	.	C	A	0	3	3	0	6	9	0	0
2	44965951	.	G	A	3	2	5	0	0	5	0	0
2	44965985	.	A	G	4	2	6	0	0	6	0	0
2	44966227	.	A	G	3	2	5	0	0	5	0	0
2	44980270	.	T	C	5	4	9	0	0	9	0	0
2	44980341	.	C	T	4	3	7	0	0	7	0	0
2	44980359	.	C	T	4	4	8	0	0	8	0	0
2	44980562	.	A	G	3	5	8	2	0	10	0	0
2	44980759	.	C	T	3	3	6	0	0	6	0	0
2	44980782	.	A	G	3	2	5	0	0	5	0	0
2	44981043	.	C	T	2	2	4	0	0	4	0	0
2	45116819	.	A	T	4	3	7	0	0	7	0	0
2	45116988	.	C	G	0	9	9	0	12	21	0	0
2	45117063	.	A	G	8	10	18	0	1	19	0	0
2	45117076	.	T	C	7	10	17	0	0	17	0	0
2	45117280	.	C	A	14	13	27	0	0	27	0	0
2	45117354	.	G	C	17	22	39	0	2	41	0	0
2	45117440	.	T	A	11	15	26	0	2	28	0	0
2	45117712	.	T	A	12	8	20	0	1	21	0	0
2	45129977	.	G	A	13	15	28	0	1	29	0	0
2	45132677	.	A	G	18	7	25	0	0	25	0	0
2	45139622	.	A	G	6	4	10	0	0	10	0	0
2	45139633	.	T	A	6	4	10	0	1	11	0	0
2	45139669	.	A	G	4	4	8	0	0	8	0	0
2	45139894	.	C	T	8	9	17	0	1	18	0	0
2	45142971	.	G	A	7	6	13	0	2	15	0	0
2	45143036	.	T	G	9	5	14	0	0	14	0	0
2	45144030	.	G	A	7	8	15	0	0	15	0	0
2	45144163	.	G	A	4	12	16	0	0	16	0	0
2	45145817	.	A	T	3	8	11	0	1	12	0	0
2	45145969	.	G	C	11	10	21	0	0	21	0	0
2	45145973	.	C	T	13	9	22	0	0	22	0	0
2	45149649	.	G	A	10	8	18	0	0	18	0	0
2	45149730	.	T	G	9	7	16	0	0	16	0	0
2	45149751	.	C	T	10	6	16	0	1	17	0	0
2	45149798	.	T	C	8	0	8	0	4	12	0	0
2	45152302	.	T	C	5	9	14	0	1	15	0	0
2	45152323	.	C	A	7	9	16	0	0	16	0	0
2	45152461	.	A	G	9	7	16	0	0	16	0	0
2	45153108	.	T	C	6	0	6	0	5	11	0	0
2	45326142	.	C	T	4	3	7	0	0	7	0	0
2	45326177	.	G	A	0	4	4	0	7	11	0	0
2	45326207	.	A	G	7	4	11	0	2	13	0	0
2	45349423	.	C	T	14	8	22	0	0	22	0	0
2	45354994	.	T	C	14	10	24	0	2	26	0	0
2	45355036	.	A	G	7	14	21	0	0	21	0	0
2	45355138	.	C	T	9	11	20	0	1	21	0	0
2	45355171	.	C	A	9	9	18	0	2	20	0	0
2	45358712	.	C	A	7	6	13	0	1	14	0	0
2	45358796	.	A	T	4	7	11	0	1	12	0	0
2	45358974	.	G	A	7	11	18	0	1	19	0	0
2	45359045	.	T	G	13	0	13	0	20	33	0	0
2	45359159	.	C	A	9	6	15	0	2	17	0	0
2	45359394	.	A	G	3	10	13	0	0	13	0	0
2	45359400	.	A	G	3	11	14	0	0	14	0	0
2	45359492	.	T	G	10	14	24	0	1	25	0	0
2	45359504	.	T	G	12	15	27	0	0	27	0	0
2	45362087	.	G	A	19	10	29	0	4	33	0	0
2	45362117	.	G	A	20	9	29	0	0	29	0	0
2	45362129	.	A	T	20	11	31	0	0	31	0	0
2	45376148	.	T	C	20	19	39	0	1	40	0	0
2	45382521	.	T	A	13	4	17	0	1	18	0	0
2	45384870	.	G	A	11	13	24	0	0	25	1	0
2	45406944	.	A	G	6	0	6	0	17	23	0	0
2	45410956	.	A	C	7	13	20	0	2	22	0	0
2	45412340	.	T	C	14	15	29	0	1	30	0	0
2	45417195	.	T	C	18	12	30	0	0	30	0	0
2	45419436	.	T	C	12	13	25	0	0	25	0	0
2	45419583	.	T	G	13	5	18	0	0	18	0	0
2	45491595	.	A	C	1	2	3	0	0	3	0	0
2	45491596	.	C	T	1	2	3	0	0	3	0	0
2	45491633	.	T	G	1	3	4	0	0	4	0	0
2	45491663	.	C	T	4	3	7	0	0	7	0	0
2	45492300	.	C	T	2	2	4	0	0	4	0	0
2	45492371	.	G	A	1	4	5	0	1	6	0	0
2	45492575	.	G	A	3	3	6	0	0	6	0	0
2	45493712	.	G	T	3	4	7	0	0	7	0	0
2	45655555	.	G	C	7	5	12	0	1	13	0	0
2	45655644	.	A	G	9	15	24	0	0	24	0	0
2	45655762	.	G	T	19	3	22	0	0	22	0	0
2	45655787	.	G	C	20	5	25	0	0	25	0	0
2	45656177	.	A	T	15	19	34	0	2	36	0	0
2	45656198	.	C	T	14	26	40	0	2	42	0	0
2	45656234	.	T	C	13	21	34	0	1	35	0	0
2	45656260	.	C	T	3	15	18	0	14	32	0	0
2	45656447	.	G	A	19	14	33	0	2	35	0	0
2	45659952	.	G	A	1	2	3	0	0	3	0	0
2	45661511	.	C	A	0	7	7	0	12	19	0	0
2	45663532	.	C	T	12	7	19	0	2	22	1	0
2	45663794	.	G	C	8	8	16	0	0	16	0	0
2	45681804	.	T	A	6	3	9	0	0	9	0	0
2	45689109	.	G	A	5	2	7	0	0	7	0	0
2	45691025	.	G	A	1	3	4	0	0	4	0	0
2	46032857	.	G	T	0	6	6	0	6	12	0	0
2	46032894	.	T	C	5	2	7	0	0	7	0	0
2	46032933	.	T	A	3	3	6	0	0	6	0	0
2	46032934	.	G	T	3	3	6	0	0	6	0	0
2	48304607	.	G	A	9	4	13	0	0	13	0	0
2	49418122	.	A	G	5	2	7	0	0	7	0	0
2	50068309	.	G	A	7	2	9	0	0	9	0	0
2	50892671	.	A	G	12	13	25	0	0	25	0	0
2	52052697	.	A	G	4	0	4	0	5	9	0	0
2	52052790	.	T	C	10	13	23	0	0	23	0	0
2	52057394	.	A	G	7	1	8	0	17	25	0	0
2	52060070	.	T	G	6	7	13	0	1	14	0	0
2	52060365	.	C	T	6	5	11	0	1	12	0	0
2	52060390	.	T	C	8	6	14	0	0	14	0	0
2	52060409	.	A	G	7	8	15	0	0	15	0	0
2	52060450	.	G	A	11	7	18	2	4	24	0	0
2	52060492	.	A	T	13	7	20	2	1	23	0	0
2	52062918	.	G	A	0	11	11	0	10	21	0	0
2	52062989	.	T	A	7	6	13	0	0	13	0	0
2	52063101	.	T	A	1	3	4	0	0	4	0	0
2	52063207	.	T	C	3	5	8	0	0	8	0	0
2	52063208	.	C	T	2	5	7	0	1	8	0	0
2	52063250	.	C	G	6	5	11	0	0	11	0	0
2	52092951	.	C	T	1	2	3	0	0	3	0	0
2	52810997	.	G	T	4	11	15	0	1	16	0	0
2	52814146	.	C	T	16	13	29	0	3	32	0	0
2	52815260	.	G	A	15	14	29	0	0	29	0	0
2	52815292	.	C	T	14	15	29	1	0	30	0	0
2	52826659	.	A	G	13	13	26	0	2	28	0	0
2	52827298	.	A	G	11	11	22	0	2	24	0	0
2	53065149	.	C	T	1	2	3	0	0	3	0	0
2	53065392	.	G	A	4	6	10	0	0	10	0	0
2	53065421	.	A	G	5	2	7	0	0	7	0	0
2	53091285	.	C	T	5	9	14	0	0	14	0	0
2	53205525	.	G	A	0	2	2	0	6	8	0	0
2	53414142	.	C	T	15	5	20	1	0	21	0	0
2	53665098	.	A	G	8	15	23	0	1	24	0	0
2	53673285	.	G	A	0	13	13	0	14	27	0	0
2	53673342	.	G	A	12	17	29	0	0	29	0	0
2	53673354	.	T	G	14	14	28	0	3	31	0	0
2	53673393	.	C	A	19	10	29	0	2	31	0	0
2	53675227	.	C	T	15	4	19	0	0	19	0	0
2	53720058	.	G	C	1	7	8	0	11	19	0	0
2	53720098	.	A	G	13	0	13	0	11	24	0	0
2	53720122	.	C	G	12	11	23	0	0	23	0	0
2	53721966	.	G	C	6	8	14	0	1	15	0	0
2	53721976	.	A	G	7	8	15	0	0	15	0	0
2	53724856	.	G	A	11	8	19	0	0	19	0	0
2	53750668	.	T	C	9	11	20	0	2	22	0	0
2	53750707	.	C	T	12	3	15	0	1	16	0	0
2	53750719	.	C	T	11	5	16	0	1	17	0	0
2	53893969	.	C	T	1	3	4	0	0	4	0	0
2	54017861	.	G	T	8	4	12	0	0	12	0	0
2	54017885	.	C	A	2	7	9	0	9	18	0	0
2	54018350	.	C	T	1	8	9	0	12	21	0	0
2	54018407	.	G	A	9	13	22	0	0	22	0	0
2	54018413	.	T	A	8	12	20	0	0	20	0	0
2	54018461	.	G	A	11	10	21	0	1	22	0	0
2	54039142	.	A	G	6	5	11	0	0	11	0	0
2	54039159	.	C	T	1	9	10	0	6	16	0	0
2	54049402	.	T	C	6	8	14	0	0	14	0	0
2	54049453	.	C	A	1	9	10	0	8	18	0	0
2	54051923	.	G	A	7	8	15	0	1	16	0	0
2	54054112	.	C	T	6	7	13	0	2	15	0	0
2	54054184	.	T	A	8	7	15	0	0	15	0	0
2	54054220	.	G	C	1	2	3	0	0	3	0	0
2	54422234	.	G	A	1	2	3	1	0	4	0	0
2	54771064	.	G	A	1	7	8	0	10	18	0	0
2	54771112	.	C	T	8	10	18	0	0	18	0	0
2	54771296	.	T	G	8	10	18	0	0	18	0	0
2	54774957	.	C	T	8	6	14	0	0	14	0	0
2	54775406	.	C	T	12	18	30	0	1	31	0	0
2	54775415	.	A	G	12	13	25	0	2	27	0	0
2	54775475	.	G	A	17	10	27	0	0	27	0	0
2	54775929	.	G	C	11	7	18	0	0	18	0	0
2	54775940	.	T	C	12	6	18	0	0	18	0	0
2	54775998	.	T	C	13	9	22	0	1	23	0	0
2	54776108	.	G	T	0	10	10	0	10	21	1	0
2	54776170	.	G	T	8	14	22	0	0	22	0	0
2	54776357	.	A	C	12	15	27	0	1	28	0	0
2	54776560	.	T	C	9	12	21	0	0	21	0	0
2	54776870	.	C	T	9	11	20	0	0	20	0	0
2	54776966	.	A	G	9	13	22	0	0	22	0	0
2	54777178	.	T	G	12	17	29	0	3	32	0	0
2	54777642	.	G	A	14	11	25	0	2	27	0	0
2	54777849	.	G	A	15	12	27	0	2	29	0	0
2	54777855	.	C	A	17	14	31	0	0	31	0	0
2	54778064	.	G	A	12	16	28	0	0	28	0	0
2	54778255	.	C	T	13	15	28	0	1	29	0	0
2	54778577	.	C	G	12	19	31	0	3	34	0	0
2	54786533	.	G	A	7	6	13	0	0	13	0	0
2	54786741	.	A	C	16	8	24	0	0	24	0	0
2	54832622	.	A	G	5	2	7	0	0	7	0	0
2	54832668	.	A	G	4	2	6	0	0	6	0	0
2	54924042	.	T	A	4	3	7	0	1	12	4	0
2	54924048	.	A	G	4	8	12	0	1	13	0	0
2	54971216	.	G	T	6	4	10	0	0	10	0	0
2	54971494	.	T	C	6	3	9	0	1	10	0	0
2	54977337	.	A	G	8	0	8	0	11	19	0	0
2	54977431	.	C	T	15	10	25	0	0	25	0	0
2	54977959	.	T	G	3	4	7	0	4	11	0	0
2	54977960	.	T	A	3	8	11	0	0	11	0	0
2	54978348	.	A	G	6	5	11	0	0	11	0	0
2	54978423	.	C	T	6	3	9	0	0	9	0	0
2	54978640	.	T	G	5	1	6	0	7	13	0	0
2	54978647	.	T	A	5	7	12	0	2	14	0	0
2	54978767	.	G	A	12	4	16	0	1	17	0	0
2	54979273	.	G	C	1	9	10	0	8	18	0	0
2	55200769	.	C	A	6	4	10	0	1	11	0	0
2	55200897	.	C	T	8	13	21	0	0	21	0	0
2	55210962	.	C	T	9	10	19	0	0	19	0	0
2	55211004	.	G	A	1	4	5	0	11	16	0	0
2	55211034	.	A	G	8	0	8	0	6	14	0	0
2	55211049	.	C	G	6	0	6	0	6	12	0	0
2	55270727	.	T	C	1	0	1	0	3	4	0	0
2	55272678	.	G	T	1	2	3	0	1	4	0	0
2	55272801	.	T	C	2	2	4	0	0	4	0	0
2	55272865	.	T	A	3	2	5	0	0	5	0	0
2	55273078	.	G	T	1	3	4	0	0	4	0	0
2	55273451	.	C	G	5	4	9	0	0	9	0	0
2	55273472	.	A	G	4	4	8	0	0	8	0	0
2	55273537	.	C	T	5	4	9	0	1	10	0	0
2	55298004	.	G	A	2	7	9	0	1	10	0	0
2	55335849	.	G	A	3	3	6	0	0	6	0	0
2	55432426	.	C	T	15	9	24	4	1	29	0	0
2	55489261	.	C	T	10	6	16	1	0	17	0	0
2	55489317	.	T	A	12	19	31	0	1	32	0	0
2	55489342	.	T	G	14	20	34	0	0	34	0	0
2	55490062	.	C	T	16	7	23	0	0	23	0	0
2	55490181	.	A	G	17	16	33	0	1	34	0	0
2	55490232	.	T	C	22	15	37	2	0	39	0	0
2	55490325	.	T	A	19	13	32	0	1	33	0	0
2	55490326	.	C	T	16	13	29	0	3	32	0	0
2	55490377	.	A	G	20	9	29	0	0	29	0	0
2	55490378	.	G	A	18	9	27	0	1	28	0	0
2	55490521	.	T	C	19	19	38	0	1	39	0	0
2	55490686	.	T	A	12	11	23	0	0	23	0	0
2	55490812	.	T	C	15	9	24	0	1	25	0	0
2	55491380	.	A	G	14	13	27	0	0	27	0	0
2	55491445	.	T	G	19	10	29	0	1	30	0	0
2	55491471	.	C	T	24	11	35	0	1	36	0	0
2	55491666	.	G	A	14	14	28	0	2	30	0	0
2	55491717	.	G	A	15	18	33	0	2	35	0	0
2	55491884	.	T	C	15	20	35	0	2	37	0	0
2	55491893	.	T	C	16	20	36	0	1	37	0	0
2	55492010	.	G	A	15	22	37	0	2	39	0	0
2	55492064	.	T	C	18	15	33	0	0	33	0	0
2	55492108	.	A	G	19	0	19	0	9	28	0	0
2	55492127	.	T	A	16	7	23	0	3	26	0	0
2	55492285	.	T	C	3	4	7	0	0	7	0	0
2	55492286	.	C	T	2	3	5	0	2	7	0	0
2	55667562	.	T	C	2	3	5	0	0	5	0	0
2	55670477	.	C	A	2	2	4	0	0	4	0	0
2	55784243	.	G	T	5	4	9	0	0	9	0	0
2	55784605	.	C	T	5	2	7	0	1	8	0	0
2	55784674	.	G	A	8	7	15	1	0	16	0	0
2	55785044	.	G	A	11	3	14	0	1	15	0	0
2	55785177	.	T	A	10	2	12	0	0	12	0	0
2	55785240	.	T	G	6	6	12	0	0	12	0	0
2	55785341	.	G	T	3	4	7	0	1	8	0	0
2	55785636	.	C	A	12	10	22	0	2	24	0	0
2	55787862	.	C	T	1	10	11	0	4	15	0	0
2	55793442	.	A	G	6	7	13	0	0	13	0	0
2	55915056	.	A	G	4	7	11	0	1	12	0	0
2	55915076	.	A	T	6	9	15	0	0	15	0	0
2	55915156	.	G	C	2	8	10	0	0	10	0	0
2	55916904	.	C	G	7	6	13	0	0	13	0	0
2	55933277	.	C	T	11	11	22	0	2	24	0	0
2	55937285	.	G	A	2	7	9	0	9	18	0	0
2	55962572	.	T	A	8	4	12	0	3	15	0	0
2	55962949	.	G	A	8	6	14	0	0	14	0	0
2	55962973	.	A	T	6	7	13	0	0	13	0	0
2	55963060	.	C	T	5	4	9	0	0	9	0	0
2	55963134	.	T	G	2	0	2	0	4	6	0	0
2	55963215	.	T	C	4	8	12	5	0	17	0	0
2	55963233	.	T	C	4	5	9	5	0	14	0	0
2	55963497	.	C	T	10	4	14	1	0	15	0	0
2	55964201	.	A	G	5	8	13	0	0	13	0	0
2	55964231	.	A	T	5	5	10	0	0	10	0	0
2	55964675	.	G	A	0	8	8	0	11	19	0	0
2	55964727	.	G	A	7	6	13	0	1	14	0	0
2	55964935	.	A	T	4	8	12	0	0	12	0	0
2	55964953	.	G	A	1	10	11	0	7	18	0	0
2	55965050	.	T	C	15	7	22	0	0	22	0	0
2	55965076	.	T	C	18	7	25	0	0	25	0	0
2	55965154	.	C	T	20	5	25	0	1	26	0	0
2	55965163	.	A	T	24	5	29	0	1	30	0	0
2	55965256	.	C	T	9	12	21	0	3	24	0	0
2	55965295	.	G	A	15	8	23	0	2	25	0	0
2	55965330	.	G	A	2	8	10	0	14	24	0	0
2	55965900	.	G	A	0	5	5	0	11	16	0	0
2	55966405	.	G	A	8	3	11	0	0	11	0	0
2	55966595	.	G	C	9	7	16	0	0	17	1	0
2	55966658	.	G	A	7	4	11	0	0	11	0	0
2	55966952	.	T	C	4	5	9	0	1	10	0	0
2	55966996	.	T	C	2	3	5	0	0	5	0	0
2	55967114	.	A	T	5	5	10	0	0	10	0	0
2	55967195	.	T	C	11	8	19	0	1	20	0	0
2	55967341	.	A	T	10	12	22	3	1	26	0	0
2	55967471	.	A	T	9	26	35	0	3	38	0	0
2	55967473	.	C	T	22	15	37	0	2	39	0	0
2	55967758	.	T	C	27	16	43	1	1	45	0	0
2	55968056	.	C	A	2	5	7	0	0	7	0	0
2	55968117	.	G	A	6	5	11	0	0	11	0	0
2	55968383	.	A	C	19	16	35	0	0	35	0	0
2	55968447	.	C	T	14	17	31	0	1	32	0	0
2	55968472	.	A	G	14	3	17	0	15	32	0	0
2	56125687	.	T	C	14	20	34	0	1	35	0	0
2	56125744	.	G	C	22	0	22	0	18	40	0	0
2	56125773	.	C	T	22	17	39	0	0	39	0	0
2	56126011	.	T	A	5	5	10	0	0	10	0	0
2	56126047	.	A	C	5	4	9	0	0	9	0	0
2	56126053	.	T	A	5	3	8	0	1	9	0	0
2	56126359	.	A	G	4	3	7	0	1	8	0	0
2	56127185	.	A	T	2	2	4	0	0	4	0	0
2	56127493	.	T	C	8	8	16	0	2	18	0	0
2	56127693	.	T	G	20	12	32	0	0	32	0	0
2	56127720	.	C	G	23	13	36	0	0	36	0	0
2	56127881	.	T	A	6	9	15	0	0	15	0	0
2	56127884	.	A	T	6	8	14	0	0	14	0	0
2	56127951	.	A	T	6	13	19	0	1	20	0	0
2	56127962	.	T	C	4	16	20	0	2	22	0	0
2	56128025	.	A	G	11	19	30	0	1	31	0	0
2	56128527	.	A	G	6	18	24	0	1	25	0	0
2	56128582	.	A	G	9	22	31	0	3	34	0	0
2	56128622	.	T	C	13	17	30	0	0	30	0	0
2	56128677	.	C	T	13	13	26	0	0	26	0	0
2	56128687	.	A	T	13	11	24	0	1	25	0	0
2	56128768	.	A	T	7	9	16	0	0	16	0	0
2	56129001	.	A	G	18	11	29	0	2	31	0	0
2	56129462	.	C	G	8	5	13	0	0	13	0	0
2	56129633	.	A	G	14	7	21	0	0	21	0	0
2	56129793	.	A	G	6	18	24	0	0	24	0	0
2	56129920	.	T	A	13	15	28	0	0	28	0	0
2	56129931	.	A	G	12	13	25	0	0	25	0	0
2	56130019	.	A	C	8	15	23	0	2	25	0	0
2	56130259	.	A	G	16	11	27	0	2	29	0	0
2	56130260	.	C	A	17	12	29	0	0	29	0	0
2	56131264	.	A	T	28	28	56	0	0	56	0	0
2	56161738	.	G	C	1	2	3	0	2	5	0	0
2	56162221	.	A	G	5	2	7	0	1	8	0	0
2	56162254	.	G	C	9	2	11	0	0	11	0	0
2	56181605	.	C	T	8	6	14	0	0	14	0	0
2	56181821	.	C	T	8	9	17	0	1	18	0	0
2	56196950	.	C	T	10	10	20	0	1	21	0	0
2	56200652	.	G	A	2	6	8	0	10	18	0	0
2	56205744	.	G	A	9	9	18	0	1	19	0	0
2	56213063	.	T	C	10	7	17	0	1	18	0	0
2	56213096	.	A	G	9	0	9	0	11	20	0	0
2	56218685	.	A	G	12	11	23	0	0	23	0	0
2	56219233	.	G	A	11	13	24	0	0	24	0	0
2	56233253	.	C	T	20	13	33	0	0	33	0	0
2	56233498	.	C	G	9	11	20	0	0	20	0	0
2	56233508	.	G	T	9	10	19	0	0	19	0	0
2	56234286	.	C	T	16	6	22	0	1	23	0	0
2	56234580	.	T	G	24	12	36	1	1	38	0	0
2	56234584	.	G	T	18	13	31	0	1	32	0	0
2	56234670	.	A	T	19	11	30	0	0	30	0	0
2	56234700	.	C	T	17	12	29	0	2	31	0	0
2	56234872	.	A	T	9	12	21	0	0	21	0	0
2	56268014	.	C	T	10	8	18	0	1	19	0	0
2	56278750	.	G	C	2	2	4	0	7	26	15	0
2	56342894	.	G	A	30	34	64	0	2	66	0	0
2	56344833	.	A	G	24	42	66	0	3	69	0	0
2	56356730	.	G	T	21	26	47	0	2	49	0	0
2	56356806	.	T	C	20	14	34	0	1	35	0	0
2	56359363	.	G	A	22	10	32	0	1	33	0	0
2	56359434	.	A	G	17	12	29	0	2	31	0	0
2	56359495	.	G	A	7	11	18	0	2	20	0	0
2	56359641	.	G	A	12	5	17	0	0	17	0	0
2	56359680	.	G	A	6	13	19	0	1	20	0	0
2	56361406	.	G	A	21	10	31	0	0	31	0	0
2	56374933	.	C	A	5	5	10	0	2	12	0	0
2	56374961	.	T	G	8	8	16	0	1	17	0	0
2	56380210	.	T	C	8	9	17	0	0	17	0	0
2	56380284	.	G	T	5	13	18	0	0	18	0	0
2	56385241	.	G	A	9	6	15	0	0	15	0	0
2	56463308	.	C	T	11	17	28	4	1	33	0	0
2	56463333	.	C	A	21	10	31	0	1	32	0	0
2	56474451	.	C	T	23	21	44	0	4	48	0	0
2	56476732	.	C	T	22	19	41	0	4	45	0	0
2	56476762	.	A	G	18	13	31	0	3	34	0	0
2	56508570	.	A	C	0	13	13	0	0	13	0	0
2	56508599	.	C	T	8	7	15	0	1	16	0	0
2	56508695	.	T	C	24	13	37	0	0	37	0	0
2	56508715	.	C	G	15	14	29	0	2	31	0	0
2	56508769	.	T	G	21	6	27	0	0	27	0	0
2	56508797	.	A	T	25	9	34	0	1	35	0	0
2	56508878	.	A	G	9	9	18	0	0	18	0	0
2	56508880	.	C	T	9	9	18	0	0	18	0	0
2	56509165	.	T	C	16	3	19	0	0	19	0	0
2	56509183	.	T	C	17	4	21	0	1	22	0	0
2	56509912	.	A	T	20	17	37	0	0	37	0	0
2	56509929	.	A	C	16	19	35	0	1	36	0	0
2	56510040	.	T	C	17	1	18	1	22	41	0	0
2	56510200	.	G	A	13	12	25	0	0	25	0	0
2	56510216	.	G	A	18	13	31	0	1	32	0	0
2	56510424	.	G	T	13	15	28	0	1	29	0	0
2	56510450	.	T	C	10	7	17	0	1	18	0	0
2	56510550	.	T	C	0	0	0	0	30	30	0	0
2	56510782	.	C	T	12	4	16	0	0	16	0	0
2	56510785	.	T	C	13	5	18	0	0	18	0	0
2	56510817	.	T	C	21	0	21	0	11	32	0	0
2	56510824	.	G	T	22	10	32	0	2	34	0	0
2	56511063	.	C	A	17	3	20	0	1	21	0	0
2	56511064	.	G	T	3	17	20	0	1	21	0	0
2	56511575	.	C	T	11	7	18	0	0	18	0	0
2	56511713	.	A	T	10	2	12	1	2	15	0	0
2	56511720	.	A	T	8	4	12	1	0	13	0	0
2	56511778	.	G	A	2	2	4	0	0	4	0	0
2	56511792	.	A	C	2	2	4	0	0	4	0	0
2	56512032	.	C	T	11	6	17	0	1	18	0	0
2	56512054	.	T	C	10	0	10	2	9	21	0	0
2	56512121	.	A	G	7	7	14	1	0	15	0	0
2	56512133	.	A	T	7	8	15	0	0	15	0	0
2	56512162	.	C	T	8	11	19	0	0	19	0	0
2	56512173	.	A	C	6	15	21	0	1	22	0	0
2	56512255	.	T	G	3	12	15	0	1	16	0	0
2	56512266	.	A	T	11	2	13	0	0	13	0	0
2	56513510	.	A	C	11	9	20	0	1	21	0	0
2	56513660	.	C	T	0	11	11	0	7	18	0	0
2	56513742	.	C	A	22	12	34	0	1	35	0	0
2	56533104	.	C	G	15	16	31	0	1	32	0	0
2	56533178	.	A	C	15	0	15	0	18	33	0	0
2	56533234	.	A	T	20	22	42	0	1	43	0	0
2	56541387	.	G	A	19	12	31	0	5	36	0	0
2	56541388	.	T	C	18	1	19	0	17	36	0	0
2	56553809	.	G	T	14	17	31	0	0	31	0	0
2	56572165	.	C	A	18	10	28	0	0	28	0	0
2	56572168	.	C	A	1	11	12	0	15	27	0	0
2	56572431	.	A	G	6	8	14	0	2	16	0	0
2	56572461	.	G	A	5	10	15	0	1	16	0	0
2	56574525	.	C	T	1	6	7	0	9	16	0	0
2	56642185	.	C	G	10	10	20	0	1	21	0	0
2	56643465	.	G	A	29	23	52	1	2	55	0	0
2	56645018	.	G	A	39	20	59	0	1	60	0	0
2	56645027	.	G	A	20	37	57	0	1	58	0	0
2	56827892	.	G	A	4	2	6	0	0	6	0	0
2	56831595	.	G	A	4	3	7	0	0	7	0	0
2	56834009	.	G	C	1	0	1	0	2	3	0	0
2	56834084	.	C	T	0	3	3	0	4	7	0	0
2	56836386	.	C	T	1	2	3	0	3	6	0	0
2	57076329	.	G	T	3	3	6	0	0	6	0	0
2	57082243	.	G	A	5	4	9	0	1	10	0	0
2	57082357	.	G	A	5	2	7	0	0	7	0	0
2	57121623	.	A	T	2	5	7	0	0	7	0	0
2	57121773	.	C	T	2	5	7	1	9	17	0	0
2	57130154	.	G	A	5	6	11	0	0	11	0	0
2	57133362	.	C	T	2	4	6	0	1	7	0	0
2	57135816	.	G	A	7	3	10	0	0	10	0	0
2	57135843	.	T	A	3	5	8	0	0	8	0	0
2	57143433	.	G	A	9	5	14	0	0	14	0	0
2	57143436	.	C	T	8	5	13	0	0	13	0	0
2	57151194	.	G	A	35	29	64	0	2	66	0	0
2	57151242	.	G	T	29	27	56	0	3	59	0	0
2	57151326	.	A	G	19	3	22	0	35	57	0	0
2	57152858	.	T	G	36	14	50	0	6	56	0	0
2	57156050	.	C	A	32	27	59	0	6	65	0	0
2	57156092	.	C	A	31	32	63	0	1	64	0	0
2	57157952	.	C	T	33	26	59	0	2	61	0	0
2	57159557	.	G	A	20	33	53	0	2	55	0	0
2	57159668	.	G	A	38	33	71	0	2	73	0	0
2	57160272	.	C	T	22	33	55	0	3	58	0	0
2	57164902	.	A	G	35	26	61	0	2	63	0	0
2	57165001	.	C	T	28	39	67	0	1	68	0	0
2	57165544	.	C	T	24	39	63	0	4	67	0	0
2	57165565	.	C	T	40	25	65	0	2	67	0	0
2	57212864	.	G	A	9	6	15	0	0	15	0	0
2	57212966	.	T	C	14	0	14	0	7	21	0	0
2	57216903	.	G	A	5	9	14	1	1	16	0	0
2	57225181	.	C	T	0	4	4	0	7	11	0	0
2	57225187	.	A	G	8	4	12	0	0	12	0	0
2	57227354	.	A	C	7	8	15	0	2	17	0	0
2	57240049	.	G	T	3	2	5	0	0	5	0	0
2	57240283	.	G	T	3	3	6	0	0	6	0	0
2	57240649	.	C	T	0	3	3	0	5	8	0	0
2	57240668	.	G	T	2	5	7	0	0	7	0	0
2	57247280	.	C	A	0	9	9	1	9	19	0	0
2	57247385	.	C	G	8	10	18	0	0	18	0	0
2	57251501	.	A	T	6	6	12	0	0	12	0	0
2	57268947	.	C	A	37	11	48	0	1	49	0	0
2	57269031	.	C	G	22	22	44	0	1	45	0	0
2	57269123	.	C	A	27	21	48	0	3	52	1	0
2	57269136	.	T	A	24	29	53	0	1	54	0	0
2	57314905	.	C	T	0	3	3	0	4	7	0	0
2	57325904	.	A	G	1	3	4	0	0	4	0	0
2	57344052	.	G	C	2	2	4	0	0	4	0	0
2	57345959	.	A	G	3	3	6	0	0	6	0	0
2	57417223	.	G	A	4	7	11	0	1	12	0	0
2	57417565	.	T	A	10	5	15	2	2	19	0	0
2	57442945	.	T	C	4	3	7	0	0	7	0	0
2	57609378	.	C	T	0	6	6	0	3	9	0	0
2	57609714	.	T	C	5	8	13	0	0	13	0	0
2	57616908	.	T	G	2	2	4	0	0	4	0	0
2	57617218	.	A	G	1	3	4	0	0	4	0	0
2	57620034	.	A	C	3	2	5	0	0	5	0	0
2	57620076	.	C	T	4	5	9	0	0	9	0	0
2	57830385	.	T	C	18	0	18	0	17	35	0	0
2	57830581	.	A	G	24	9	33	0	1	34	0	0
2	57831603	.	A	T	11	19	30	0	0	30	0	0
2	57834927	.	T	C	15	19	34	0	0	34	0	0
2	57834930	.	T	C	17	19	36	0	0	36	0	0
2	57848889	.	G	C	12	7	19	0	1	20	0	0
2	57848936	.	G	C	8	11	19	0	3	22	0	0
2	57856706	.	C	T	14	7	21	0	2	23	0	0
2	57867406	.	G	A	2	6	8	0	12	20	0	0
2	57867471	.	C	T	8	5	13	0	2	15	0	0
2	57867473	.	C	T	10	5	15	0	0	15	0	0
2	57867579	.	G	T	8	9	17	0	0	17	0	0
2	57868151	.	C	T	5	4	9	0	0	9	0	0
2	57868433	.	T	C	11	7	18	4	0	22	0	0
2	57868580	.	A	G	17	5	22	0	0	22	0	0
2	57869966	.	A	T	1	4	5	0	0	5	0	0
2	57870003	.	A	G	4	7	11	0	1	12	0	0
2	57870049	.	G	A	10	5	15	2	1	18	0	0
2	57870051	.	A	G	9	0	9	2	6	17	0	0
2	57870155	.	C	T	17	5	22	0	0	22	0	0
2	57870180	.	T	C	15	7	22	0	0	22	0	0
2	57870383	.	G	A	6	8	14	0	0	14	0	0
2	57870622	.	G	C	5	2	7	0	0	7	0	0
2	57870659	.	A	T	12	3	15	0	1	16	0	0
2	57870713	.	C	G	9	9	18	0	0	18	0	0
2	57870794	.	G	T	17	10	27	0	2	29	0	0
2	57870795	.	T	A	17	11	28	0	1	29	0	0
2	57870830	.	A	G	14	11	25	0	3	28	0	0
2	57870868	.	G	A	0	14	14	0	20	34	0	0
2	57870887	.	A	G	21	5	26	0	7	33	0	0
2	57870934	.	T	C	10	10	20	0	2	22	0	0
2	57870984	.	A	T	7	6	13	0	0	13	0	0
2	57879582	.	T	C	10	15	25	0	1	26	0	0
2	57879615	.	T	C	8	1	9	0	10	19	0	0
2	57879618	.	T	C	9	11	20	0	1	21	0	0
2	57883433	.	C	T	10	23	33	0	0	33	0	0
2	57883452	.	C	T	11	22	33	0	5	38	0	0
2	57883509	.	C	T	0	28	28	0	12	40	0	0
2	57891444	.	G	A	7	15	22	0	1	23	0	0
2	57891463	.	T	C	3	8	11	0	0	11	0	0
2	57892808	.	A	G	1	5	6	0	0	6	0	0
2	57893340	.	A	T	3	6	9	5	0	14	0	0
2	57893346	.	G	A	4	5	9	6	0	15	0	0
2	57893494	.	G	A	7	6	13	0	0	13	0	0
2	57893547	.	A	G	3	2	5	0	0	5	0	0
2	57893684	.	G	A	1	4	5	0	0	5	0	0
2	57893748	.	A	G	6	5	11	0	1	12	0	0
2	57893826	.	A	G	1	2	3	0	0	3	0	0
2	57893889	.	A	T	2	2	4	0	0	4	0	0
2	57893933	.	C	G	3	4	7	0	0	7	0	0
2	57894012	.	T	C	5	2	7	0	11	18	0	0
2	57894127	.	T	G	6	4	10	0	0	10	0	0
2	57897401	.	G	A	7	2	9	1	0	10	0	0
2	57898837	.	A	T	6	2	8	2	0	10	0	0
2	57898875	.	G	A	7	9	16	3	0	19	0	0
2	57899003	.	G	A	5	2	7	0	1	8	0	0
2	57900156	.	A	G	3	2	5	1	0	6	0	0
2	57900222	.	T	C	3	3	6	0	0	6	0	0
2	57913705	.	A	T	1	3	4	0	0	4	0	0
2	57913799	.	T	C	1	6	7	0	1	8	0	0
2	57913904	.	A	G	4	2	6	0	0	6	0	0
2	57913913	.	G	A	4	2	6	0	0	6	0	0
2	57918008	.	G	A	2	5	7	0	0	7	0	0
2	57918068	.	C	T	3	5	8	0	0	8	0	0
2	57918095	.	G	A	3	4	7	0	0	7	0	0
2	57918149	.	T	C	1	3	4	0	1	5	0	0
2	57918247	.	A	T	4	11	15	0	0	15	0	0
2	57940770	.	G	A	5	4	9	0	0	9	0	0
2	58009111	.	T	C	6	2	8	0	0	8	0	0
2	58009112	.	G	C	6	1	7	0	1	8	0	0
2	58009416	.	A	G	7	3	10	3	1	14	0	0
2	58012041	.	T	G	7	14	21	0	0	21	0	0
2	58012271	.	T	C	6	11	17	0	2	19	0	0
2	58012293	.	T	C	6	15	21	0	1	22	0	0
2	58013448	.	G	A	5	5	10	0	0	10	0	0
2	58013477	.	A	T	1	1	2	0	2	4	0	0
2	58013485	.	G	A	0	2	2	0	1	3	0	0
2	58013903	.	A	G	9	0	9	0	10	19	0	0
2	58014110	.	G	T	6	10	16	0	0	16	0	0
2	58014156	.	A	T	7	10	17	0	0	17	0	0
2	58014364	.	G	A	9	7	16	0	0	16	0	0
2	58014502	.	G	A	2	7	9	0	0	9	0	0
2	58014537	.	T	C	1	6	7	0	0	7	0	0
2	58077869	.	T	C	2	5	7	0	0	7	0	0
2	58078071	.	G	C	7	3	10	0	0	10	0	0
2	58081768	.	G	A	4	4	8	0	0	8	0	0
2	58122023	.	A	T	6	2	8	0	0	8	0	0
2	58126268	.	C	T	9	11	20	0	2	22	0	0
2	58129968	.	C	G	6	7	13	0	0	13	0	0
2	58129992	.	A	G	2	2	4	0	0	4	0	0
2	58132558	.	A	C	7	10	17	0	0	17	0	0
2	58137902	.	A	C	5	10	15	0	1	16	0	0
2	58186849	.	A	T	9	1	10	0	2	12	0	0
2	58186872	.	T	C	12	4	16	0	0	16	0	0
2	58186891	.	G	T	8	4	12	0	2	14	0	0
2	58186945	.	T	C	14	4	18	0	0	18	0	0
2	58187013	.	C	G	10	4	14	0	0	14	0	0
2	58187038	.	G	A	8	4	12	0	1	13	0	0
2	58187052	.	T	A	9	4	13	0	1	14	0	0
2	58187187	.	T	C	14	0	14	0	11	25	0	0
2	58187621	.	G	T	13	7	20	0	1	21	0	0
2	58187624	.	C	T	3	8	11	0	14	25	0	0
2	58227068	.	C	T	2	6	8	0	0	8	0	0
2	58242505	.	C	T	3	2	5	0	0	5	0	0
2	58347944	.	C	T	6	3	9	0	0	9	0	0
2	58347965	.	G	C	6	2	8	1	0	9	0	0
2	58349253	.	G	A	7	6	13	0	0	13	0	0
2	58349274	.	T	C	6	6	12	0	0	12	0	0
2	58355559	.	A	C	4	0	4	0	3	7	0	0
2	58358563	.	A	T	6	4	10	0	1	11	0	0
2	58358627	.	T	G	3	3	6	0	0	6	0	0
2	58411998	.	T	C	21	30	51	0	1	52	0	0
2	58412124	.	G	A	4	11	15	0	35	50	0	0
2	58514819	.	T	C	13	15	28	0	1	29	0	0
2	58523710	.	C	A	0	7	7	2	6	15	0	0
2	58541894	.	C	T	18	10	28	0	1	29	0	0
2	58546821	.	G	T	14	13	27	0	1	28	0	0
2	58560081	.	G	C	18	11	29	0	1	30	0	0
2	58568120	.	C	T	3	2	5	0	0	5	0	0
2	58568129	.	G	A	3	2	5	0	0	5	0	0
2	58570715	.	C	G	5	6	11	0	1	12	0	0
2	58577045	.	A	C	7	7	14	0	0	14	0	0
2	58577080	.	A	G	6	7	13	0	0	13	0	0
2	58632210	.	T	C	3	0	3	0	15	18	0	0
2	58632433	.	G	A	7	8	15	0	0	15	0	0
2	58632475	.	G	A	6	5	11	0	0	11	0	0
2	58639153	.	C	T	1	4	5	0	7	12	0	0
2	58739173	.	G	C	13	18	31	0	1	32	0	0
2	58739467	.	T	C	13	14	27	0	0	27	0	0
2	58739511	.	C	T	8	12	20	0	2	22	0	0
2	58739574	.	C	T	14	9	23	0	0	23	0	0
2	58739714	.	G	A	8	15	23	0	0	23	0	0
2	58742525	.	C	T	1	3	4	0	0	4	0	0
2	58742652	.	G	A	0	8	8	0	13	21	0	0
2	58778264	.	G	A	26	22	48	0	0	48	0	0
2	58785286	.	G	A	9	11	20	5	1	26	0	0
2	58785866	.	T	C	17	15	32	0	1	33	0	0
2	58786091	.	G	A	12	17	29	0	0	29	0	0
2	58788301	.	A	G	21	9	30	0	3	33	0	0
2	58793667	.	G	A	11	16	27	0	1	28	0	0
2	58795599	.	C	T	8	14	22	0	1	23	0	0
2	58841219	.	T	C	20	24	44	0	2	46	0	0
2	58843563	.	G	A	3	11	14	16	9	39	0	0
2	58843569	.	T	C	11	10	21	11	3	35	0	0
2	58845161	.	G	T	2	6	8	0	9	17	0	0
2	58845396	.	T	C	13	12	25	0	0	25	0	0
2	58868190	.	G	A	7	8	15	0	1	16	0	0
2	58868193	.	G	A	9	10	19	0	0	19	0	0
2	58868508	.	A	C	11	0	11	0	8	19	0	0
2	58868577	.	G	C	14	0	14	0	13	27	0	0
2	58868841	.	G	A	6	9	15	0	0	15	0	0
2	58869037	.	C	G	2	4	6	0	0	6	0	0
2	58869142	.	G	A	15	14	29	0	3	32	0	0
2	58869166	.	G	A	15	11	26	0	0	26	0	0
2	58869268	.	A	G	7	5	12	0	0	12	0	0
2	58878288	.	G	A	2	8	10	0	10	20	0	0
2	58878612	.	C	T	13	13	26	0	0	26	0	0
2	58879122	.	C	G	15	0	15	0	9	24	0	0
2	58888966	.	C	A	12	8	20	0	0	20	0	0
2	58892160	.	C	T	11	14	25	1	0	26	0	0
2	58898167	.	C	T	2	11	13	0	13	26	0	0
2	58914802	.	T	C	10	2	12	0	0	12	0	0
2	58917504	.	A	T	8	6	14	0	1	15	0	0
2	58996000	.	A	T	6	8	14	0	0	14	0	0
2	59023901	.	T	C	10	11	21	0	0	21	0	0
2	59032670	.	T	C	9	13	22	0	0	22	0	0
2	59045797	.	G	A	1	8	9	0	7	16	0	0
2	59045912	.	A	G	11	0	11	0	6	17	0	0
2	59050160	.	C	T	12	10	22	0	0	22	0	0
2	59054254	.	A	G	21	19	40	0	1	41	0	0
2	59136533	.	G	A	2	3	5	0	0	5	0	0
2	59136823	.	T	A	1	2	3	0	0	3	0	0
2	59136859	.	T	C	3	3	6	0	0	6	0	0
2	59136919	.	T	G	3	7	10	0	0	10	0	0
2	59137027	.	C	G	5	4	9	7	0	16	0	0
2	59137050	.	T	A	8	7	15	4	1	20	0	0
2	59137113	.	C	T	9	8	17	0	0	17	0	0
2	59137184	.	G	T	6	6	12	0	1	13	0	0
2	59143145	.	G	A	8	4	12	0	3	15	0	0
2	59143183	.	A	G	7	12	19	0	2	21	0	0
2	59144065	.	A	G	4	5	9	0	0	9	0	0
2	59144341	.	G	C	5	2	7	0	0	7	0	0
2	59144357	.	C	A	8	4	12	0	0	12	0	0
2	59144385	.	T	G	8	5	13	0	1	14	0	0
2	59556935	.	G	T	1	13	14	0	5	19	0	0
2	59565508	.	C	T	15	8	23	0	0	23	0	0
2	59565553	.	G	C	13	13	26	0	0	26	0	0
2	59565584	.	G	A	14	13	27	0	0	27	0	0
20	22156	.	C	G	1	3	4	0	0	4	0	0
20	66919	.	C	T	9	5	14	0	0	14	0	0
20	67036	.	T	G	10	10	20	0	0	20	0	0
20	67321	.	C	T	8	3	11	0	0	11	0	0
20	67388	.	C	A	4	8	12	0	0	12	0	0
20	67755	.	C	T	13	6	19	0	0	19	0	0
20	67867	.	T	G	8	9	17	0	0	17	0	0
20	75266	.	G	A	1	8	9	0	6	15	0	0
20	75330	.	T	A	8	9	17	0	0	17	0	0
20	75374	.	A	G	10	6	16	0	1	17	0	0
20	75376	.	G	T	1	6	7	0	11	18	0	0
20	76285	.	C	T	15	7	22	0	2	24	0	0
20	89176	.	A	G	16	12	28	0	2	30	0	0
20	89188	.	G	T	1	11	12	0	14	26	0	0
20	89222	.	A	T	10	12	22	0	0	22	0	0
20	89225	.	T	C	9	10	19	0	1	20	0	0
20	89351	.	C	G	1	3	4	0	0	4	0	0
20	89354	.	C	T	1	3	4	0	0	4	0	0
20	89607	.	G	T	4	4	8	0	5	13	0	0
20	89720	.	G	A	14	8	22	0	0	22	0	0
20	89855	.	G	C	6	12	18	0	0	18	0	0
20	90167	.	C	T	15	19	34	0	2	36	0	0
20	90246	.	T	C	15	12	27	0	1	28	0	0
20	114708	.	A	G	28	23	51	0	3	54	0	0
20	114776	.	A	G	26	24	50	0	4	54	0	0
20	122241	.	C	T	1	2	3	0	0	3	0	0
20	122244	.	C	G	1	3	4	0	0	4	0	0
20	122542	.	T	C	4	4	8	0	0	8	0	0
20	122702	.	C	T	0	2	2	0	3	5	0	0
20	124610	.	C	T	6	3	9	0	0	9	0	0
20	125488	.	A	G	5	4	9	0	0	9	0	0
20	127773	.	G	A	3	4	7	0	0	7	0	0
20	151486	.	C	T	4	3	7	0	1	8	0	0
20	151534	.	A	G	5	9	14	1	1	16	0	0
20	151768	.	G	T	8	13	21	0	3	24	0	0
20	151780	.	G	A	10	14	24	0	0	24	0	0
20	151846	.	C	T	17	9	26	0	0	26	0	0
20	152861	.	A	C	6	10	16	0	0	16	0	0
20	153992	.	C	T	1	5	6	0	8	14	0	0
20	163666	.	G	A	1	2	3	0	0	3	0	0
20	167406	.	G	A	3	2	5	0	0	5	0	0
20	167580	.	C	T	1	2	3	0	0	3	0	0
20	167974	.	T	C	2	3	5	0	0	5	0	0
20	186674	.	C	G	3	13	16	0	1	17	0	0
20	186675	.	T	C	3	14	17	0	0	17	0	0
20	186776	.	A	G	20	6	26	0	1	27	0	0
20	186796	.	C	T	1	9	10	0	20	30	0	0
20	188490	.	T	C	6	0	6	0	10	16	0	0
20	197031	.	C	G	10	15	25	0	0	25	0	0
20	197274	.	T	C	9	13	22	0	2	24	0	0
20	197293	.	T	C	11	12	23	0	0	23	0	0
20	197362	.	C	T	10	6	16	0	1	17	0	0
20	197572	.	C	G	13	9	22	0	0	22	0	0
20	198319	.	G	T	13	16	29	0	3	32	0	0
20	198321	.	G	T	13	19	32	0	0	32	0	0
20	198552	.	G	T	7	8	15	0	0	15	0	0
20	198577	.	G	A	14	7	21	0	1	22	0	0
20	198622	.	A	G	14	13	27	0	1	28	0	0
20	198733	.	A	G	14	7	21	0	1	22	0	0
20	198735	.	C	A	13	8	21	0	0	21	0	0
20	199129	.	T	G	11	12	23	0	1	24	0	0
20	199504	.	C	T	15	7	22	0	2	24	0	0
20	199536	.	C	G	12	7	19	0	0	19	0	0
20	200245	.	C	T	0	8	8	0	9	17	0	0
20	200851	.	G	A	9	8	17	0	1	18	0	0
20	201341	.	T	A	8	8	16	0	0	16	0	0
20	201524	.	G	C	12	15	27	0	0	27	0	0
20	201628	.	T	A	9	5	14	0	0	14	0	0
20	201718	.	G	A	15	5	20	0	0	20	0	0
20	201957	.	C	G	0	7	7	0	4	11	0	0
20	202052	.	A	G	11	8	19	0	0	19	0	0
20	202384	.	G	A	7	12	19	0	0	19	0	0
20	202399	.	A	G	14	3	17	0	1	18	0	0
20	202510	.	G	A	8	9	17	0	0	17	0	0
20	202975	.	G	A	4	5	9	0	0	9	0	0
20	203089	.	C	A	0	5	5	0	9	14	0	0
20	203782	.	G	A	1	3	4	0	0	4	0	0
20	204292	.	A	C	4	1	5	0	5	10	0	0
20	204616	.	G	A	1	2	3	0	2	5	0	0
20	206232	.	C	T	2	3	5	0	10	15	0	0
20	207317	.	C	T	1	3	4	0	3	7	0	0
20	211782	.	C	G	1	3	4	0	2	6	0	0
20	376191	.	A	T	10	6	16	0	0	16	0	0
20	384585	.	G	T	1	4	5	0	3	8	0	0
20	390754	.	C	T	10	7	17	0	0	17	0	0
20	393304	.	A	T	11	11	22	0	0	22	0	0
20	395859	.	T	A	4	7	11	0	1	12	0	0
20	395928	.	G	A	7	3	10	0	0	10	0	0
20	396013	.	A	G	3	5	8	0	1	9	0	0
20	405925	.	A	C	11	8	19	0	2	21	0	0
20	406078	.	A	G	11	6	17	0	0	17	0	0
20	406079	.	C	A	11	6	17	0	0	17	0	0
20	406221	.	T	C	9	13	22	1	1	24	0	0
20	406264	.	T	A	10	7	17	1	0	18	0	0
20	410981	.	A	T	9	3	12	0	1	13	0	0
20	423715	.	G	T	10	4	14	0	0	14	0	0
20	424420	.	T	A	2	6	8	0	2	10	0	0
20	426434	.	T	A	4	5	9	0	1	10	0	0
20	430539	.	C	T	6	5	11	0	0	11	0	0
20	430703	.	A	C	3	7	10	0	0	10	0	0
20	431870	.	C	G	4	4	8	0	0	8	0	0
20	431886	.	C	T	0	4	4	0	3	7	0	0
20	432004	.	C	T	6	5	11	0	0	11	0	0
20	432892	.	C	T	3	2	5	0	0	5	0	0
20	432898	.	T	A	3	2	5	0	0	5	0	0
20	436652	.	G	A	12	5	17	0	0	17	0	0
20	474375	.	T	A	14	10	24	0	1	26	1	0
20	479187	.	A	G	13	0	13	0	9	22	0	0
20	483692	.	C	T	13	4	17	0	0	17	0	0
20	522778	.	C	T	7	16	23	0	1	24	0	0
20	525663	.	G	A	18	17	35	0	0	35	0	0
20	530384	.	G	C	15	17	32	0	1	33	0	0
20	530393	.	C	T	15	15	30	0	1	31	0	0
20	530536	.	C	T	9	10	19	0	0	19	0	0
20	554882	.	C	T	1	2	3	0	0	3	0	0
20	555371	.	C	T	1	2	3	0	0	3	0	0
20	555964	.	T	A	3	3	6	0	1	7	0	0
20	556052	.	C	T	3	2	5	0	0	5	0	0
20	556552	.	T	A	1	2	3	0	0	3	0	0
20	556553	.	C	T	1	2	3	0	0	3	0	0
20	560996	.	G	C	2	3	5	0	0	5	0	0
20	565838	.	T	C	4	2	6	0	0	6	0	0
20	565903	.	A	C	3	3	6	0	0	6	0	0
20	565972	.	G	T	2	2	4	0	1	5	0	0
20	592190	.	G	A	2	9	11	0	0	11	0	0
20	598222	.	T	C	7	4	11	0	1	12	0	0
20	598242	.	T	C	7	2	9	0	0	9	0	0
20	603599	.	T	C	4	4	8	0	0	8	0	0
20	605171	.	A	T	3	7	10	0	0	10	0	0
20	605471	.	G	A	6	3	9	0	0	9	0	0
20	700899	.	C	A	12	20	32	0	0	32	0	0
20	700965	.	C	T	12	9	21	0	2	23	0	0
20	700995	.	C	T	9	6	15	0	0	15	0	0
20	708026	.	G	A	6	7	13	1	0	14	0	0
20	711983	.	T	A	11	8	19	0	1	21	1	0
20	711988	.	C	T	9	11	20	0	1	21	0	0
20	733590	.	G	A	6	9	15	0	1	16	0	0
20	742063	.	G	A	3	7	10	0	1	11	0	0
20	742087	.	A	C	3	5	8	0	0	8	0	0
20	742111	.	A	C	5	4	9	0	0	9	0	0
20	744016	.	A	C	12	8	20	0	0	20	0	0
20	745412	.	C	T	10	5	15	0	0	15	0	0
20	757525	.	C	A	10	5	15	0	2	17	0	0
20	764346	.	A	G	13	9	22	0	1	23	0	0
20	764355	.	G	C	10	12	22	0	0	22	0	0
20	771986	.	C	G	14	9	23	0	1	24	0	0
20	772577	.	C	A	15	7	22	0	0	22	0	0
20	775538	.	G	A	1	8	9	0	14	23	0	0
20	775562	.	C	T	16	15	31	0	0	31	0	0
20	775583	.	T	A	14	20	34	0	3	37	0	0
20	775925	.	G	T	2	20	22	0	22	44	0	0
20	776259	.	A	T	1	32	33	1	3	37	0	0
20	776261	.	A	T	10	20	30	1	6	37	0	0
20	776700	.	T	C	11	9	20	0	2	22	0	0
20	776826	.	G	A	3	8	11	0	0	11	0	0
20	776961	.	G	T	3	8	11	1	1	13	0	0
20	845708	.	T	C	2	2	4	0	0	4	0	0
20	847736	.	G	C	2	2	4	0	0	4	0	0
20	847742	.	A	C	2	2	4	0	0	4	0	0
20	847985	.	G	T	2	2	4	0	0	4	0	0
20	851699	.	G	A	2	2	4	0	0	4	0	0
20	851732	.	T	A	3	2	5	0	0	5	0	0
20	851746	.	G	A	5	4	9	0	0	9	0	0
20	852217	.	C	T	2	8	10	1	16	27	0	0
20	853669	.	C	T	13	10	23	0	0	23	0	0
20	856170	.	G	A	8	14	22	0	0	22	0	0
20	866396	.	G	A	11	6	17	1	1	19	0	0
20	875285	.	A	G	15	8	23	0	0	23	0	0
20	880430	.	G	A	17	9	26	0	0	26	0	0
20	880447	.	A	G	16	8	24	0	1	25	0	0
20	883106	.	C	A	7	9	16	0	1	17	0	0
20	884404	.	A	T	7	9	16	0	3	19	0	0
20	902576	.	T	A	15	10	25	0	0	25	0	0
20	902647	.	A	G	12	7	19	0	0	19	0	0
20	902712	.	A	T	7	20	27	0	1	28	0	0
20	902721	.	T	C	20	9	29	0	1	30	0	0
20	902770	.	G	A	7	15	22	0	2	24	0	0
20	902866	.	G	A	21	12	33	0	1	34	0	0
20	902913	.	C	T	3	10	13	0	22	35	0	0
20	902937	.	G	T	19	16	35	0	0	35	0	0
20	908096	.	C	A	18	18	36	0	0	36	0	0
20	908195	.	A	G	15	12	27	0	0	27	0	0
20	908641	.	C	T	2	9	11	0	10	21	0	0
20	908717	.	G	A	8	9	17	0	0	17	0	0
20	943944	.	T	G	7	4	11	0	0	11	0	0
20	943986	.	T	A	4	5	9	0	0	9	0	0
20	943995	.	T	C	4	5	9	0	0	9	0	0
20	944021	.	T	C	4	2	6	0	0	6	0	0
20	944314	.	A	C	4	8	12	0	0	12	0	0
20	944405	.	T	A	1	6	7	0	1	8	0	0
20	1064213	.	C	T	10	6	16	0	1	17	0	0
20	1079035	.	G	A	7	4	11	0	0	11	0	0
20	1079084	.	G	C	5	10	15	0	1	16	0	0
20	1081960	.	G	A	5	10	15	0	2	17	0	0
20	1121685	.	C	T	15	11	26	0	2	28	0	0
20	1121715	.	A	G	10	16	26	0	1	27	0	0
20	1132194	.	C	T	0	4	4	0	1	5	0	0
20	1132865	.	T	C	2	0	2	1	4	7	0	0
20	1151113	.	G	A	2	2	4	0	0	4	0	0
20	1151123	.	C	A	2	2	4	0	0	4	0	0
20	1177879	.	A	T	9	8	17	0	1	18	0	0
20	1178040	.	T	A	4	4	8	0	1	9	0	0
20	1178041	.	T	C	3	5	8	0	1	9	0	0
20	1178273	.	C	A	2	5	7	0	0	7	0	0
20	1178292	.	T	G	1	5	6	0	0	6	0	0
20	1178505	.	T	C	2	4	6	0	0	6	0	0
20	1178571	.	T	C	6	5	11	0	0	11	0	0
20	1178579	.	A	C	7	0	7	0	6	13	0	0
20	1178759	.	G	C	7	9	16	0	0	16	0	0
20	1178813	.	T	C	9	4	13	0	0	13	0	0
20	1178955	.	T	A	6	11	17	0	0	17	0	0
20	1179309	.	T	C	3	4	7	0	0	7	0	0
20	1179404	.	T	G	4	5	9	0	0	9	0	0
20	1179685	.	A	G	13	10	23	0	6	29	0	0
20	1179715	.	A	C	12	0	12	0	17	29	0	0
20	1182872	.	G	A	5	8	13	0	0	13	0	0
20	1191775	.	G	A	11	15	26	0	1	27	0	0
20	1196435	.	G	A	11	9	20	0	1	21	0	0
20	1201826	.	T	C	3	6	9	0	0	9	0	0
20	1201989	.	G	C	1	3	4	0	0	4	0	0
20	1201993	.	A	G	1	2	3	0	0	3	0	0
20	1202099	.	T	C	8	3	11	0	0	11	0	0
20	1202177	.	G	A	2	6	8	0	0	8	0	0
20	1204020	.	T	G	8	3	11	0	1	12	0	0
20	1204506	.	A	T	2	4	6	0	1	7	0	0
20	1204577	.	G	T	4	11	15	0	1	16	0	0
20	1204727	.	C	G	3	7	10	1	0	11	0	0
20	1205899	.	T	C	4	2	6	0	0	6	0	0
20	1208852	.	C	T	2	5	7	0	0	7	0	0
20	1208919	.	A	T	2	2	4	0	0	4	0	0
20	1209065	.	T	C	3	5	8	0	1	9	0	0
20	1209132	.	G	C	8	0	8	0	7	15	0	0
20	1230195	.	A	G	1	5	6	0	0	6	0	0
20	1230201	.	C	G	0	5	5	0	1	6	0	0
20	1241075	.	G	A	6	4	10	0	0	10	0	0
20	1241081	.	C	T	8	4	12	0	1	13	0	0
20	1241318	.	C	A	1	4	5	0	0	5	0	0
20	1241535	.	T	C	2	4	6	0	1	7	0	0
20	1241596	.	T	A	4	6	10	0	0	10	0	0
20	1242029	.	A	T	5	2	7	0	0	7	0	0
20	1242395	.	A	G	1	3	4	0	1	5	0	0
20	1244021	.	T	A	1	3	4	0	0	4	0	0
20	1244379	.	G	A	9	5	14	0	0	14	0	0
20	1246870	.	C	T	1	4	5	0	1	6	0	0
20	1246936	.	C	T	0	3	3	0	8	11	0	0
20	1255010	.	G	A	1	4	5	0	0	5	0	0
20	1258021	.	G	T	3	2	5	0	0	5	0	0
20	1258054	.	G	A	4	3	7	0	0	7	0	0
20	1265240	.	A	G	2	4	6	0	0	6	0	0
20	1265246	.	C	T	3	4	7	0	0	7	0	0
20	1265315	.	T	C	6	3	9	0	0	9	0	0
20	1265360	.	C	T	0	3	3	0	8	11	0	0
20	1278565	.	A	T	4	2	6	0	0	6	0	0
20	1278796	.	G	A	11	15	26	0	2	28	0	0
20	1279033	.	G	A	18	15	33	0	1	34	0	0
20	1281278	.	G	T	9	14	23	0	0	23	0	0
20	1281883	.	G	A	2	9	11	0	8	19	0	0
20	1282601	.	C	A	10	19	29	0	1	30	0	0
20	1282634	.	A	C	7	20	27	0	1	28	0	0
20	1294062	.	C	G	9	10	19	0	1	20	0	0
20	1294099	.	G	C	18	9	27	0	1	28	0	0
20	1294119	.	A	G	17	11	28	0	2	30	0	0
20	1294196	.	G	A	16	18	34	7	2	43	0	0
20	1294200	.	T	G	19	17	36	7	2	45	0	0
20	1294267	.	T	G	20	30	50	0	1	51	0	0
20	1294275	.	A	G	18	30	48	0	1	49	0	0
20	1294569	.	T	C	12	5	17	1	0	18	0	0
20	1294612	.	T	C	2	2	4	0	0	4	0	0
20	1294735	.	T	C	5	4	9	1	1	11	0	0
20	1294863	.	T	G	15	6	21	0	2	23	0	0
20	1294970	.	A	G	14	13	27	1	0	28	0	0
20	1295017	.	T	C	6	4	10	1	0	11	0	0
20	1295302	.	T	C	8	4	12	1	0	13	0	0
20	1295312	.	T	C	9	7	16	0	0	16	0	0
20	1295840	.	G	A	23	13	36	0	0	36	0	0
20	1296022	.	G	C	11	20	31	0	1	33	1	0
20	1296114	.	G	A	9	25	34	0	2	36	0	0
20	1296139	.	A	G	9	22	31	0	3	34	0	0
20	1316757	.	G	C	7	6	13	0	0	13	0	0
20	1316764	.	A	G	8	7	15	0	0	15	0	0
20	1320057	.	T	G	3	0	3	0	2	5	0	0
20	1327501	.	C	A	7	8	15	0	0	15	0	0
20	1327528	.	A	C	4	12	16	0	0	16	0	0
20	1327545	.	A	T	5	14	19	0	0	19	0	0
20	1338955	.	T	C	6	6	12	0	0	12	0	0
20	1338988	.	T	G	7	0	7	0	4	11	0	0
20	1339021	.	C	T	4	6	10	0	0	10	0	0
20	1339066	.	G	A	0	5	5	0	8	13	0	0
20	1339459	.	G	C	0	6	6	0	6	12	0	0
20	1339486	.	T	G	7	6	13	0	1	14	0	0
20	1339657	.	T	C	7	8	15	0	1	16	0	0
20	1339726	.	A	G	4	0	4	0	13	17	0	0
20	1339786	.	T	C	7	4	11	0	3	14	0	0
20	1339798	.	G	A	8	4	12	0	1	13	0	0
20	1339984	.	C	A	4	5	9	0	0	9	0	0
20	1340266	.	T	C	10	6	16	0	0	16	0	0
20	1340269	.	T	C	10	7	17	0	0	17	0	0
20	1341771	.	A	C	7	7	14	0	0	15	1	0
20	1341782	.	G	A	9	7	16	0	0	16	0	0
20	1341830	.	C	T	13	2	15	0	0	15	0	0
20	1341833	.	T	C	13	2	15	0	0	15	0	0
20	1349153	.	C	G	11	4	15	0	0	15	0	0
20	1349357	.	G	A	0	3	3	0	5	8	0	0
20	1349555	.	T	C	2	2	4	0	0	4	0	0
20	1349622	.	T	C	7	2	9	0	0	9	0	0
20	1349739	.	A	G	5	0	5	0	3	8	0	0
20	1349947	.	G	A	0	3	3	0	5	8	0	0
20	1349955	.	G	A	5	3	8	0	0	8	0	0
20	1350029	.	C	G	5	5	10	0	0	10	0	0
20	1392415	.	T	G	1	2	3	0	0	3	0	0
20	1441777	.	A	G	17	13	30	0	2	32	0	0
20	1441815	.	A	C	17	10	27	0	1	31	3	0
20	1441825	.	T	C	20	13	33	0	0	33	0	0
20	1442515	.	A	T	11	13	24	0	0	24	0	0
20	1442624	.	C	T	13	19	32	0	5	37	0	0
20	1445375	.	C	T	17	16	33	0	4	37	0	0
20	1454098	.	A	G	23	15	38	0	0	38	0	0
20	1455104	.	G	A	12	13	25	0	1	26	0	0
20	1460979	.	C	A	9	10	19	0	1	20	0	0
20	1487486	.	T	A	9	4	13	0	0	13	0	0
20	1487549	.	A	G	8	6	14	0	0	14	0	0
20	1513605	.	A	G	8	11	19	0	0	19	0	0
20	1518291	.	A	G	9	13	22	0	2	24	0	0
20	1524039	.	A	G	14	10	24	0	0	24	0	0
20	1560842	.	C	T	0	10	10	0	8	18	0	0
20	1607674	.	A	G	10	7	17	0	0	17	0	0
20	1607857	.	T	C	4	0	4	0	8	12	0	0
20	1635899	.	G	A	7	8	15	0	1	16	0	0
20	2066940	.	A	G	8	5	13	0	0	13	0	0
20	2067112	.	T	C	4	8	12	0	1	13	0	0
20	2069429	.	T	G	7	5	12	0	1	13	0	0
20	2069445	.	T	A	7	5	12	0	0	13	1	0
20	2070150	.	C	A	3	5	8	0	0	8	0	0
20	2083086	.	T	C	5	4	9	0	0	9	0	0
20	2156208	.	C	T	8	3	11	0	0	11	0	0
20	2156211	.	T	C	3	8	11	0	0	11	0	0
20	2161708	.	C	T	3	3	6	0	1	7	0	0
20	2162052	.	T	C	8	4	12	0	0	12	0	0
20	2164887	.	C	T	1	3	4	0	0	4	0	0
20	2167832	.	A	T	3	4	7	0	0	7	0	0
20	2174775	.	A	G	4	2	6	0	0	6	0	0
20	2174815	.	T	A	4	4	8	0	0	8	0	0
20	2184168	.	A	T	4	3	7	0	0	7	0	0
20	2206103	.	A	C	5	6	11	0	0	11	0	0
20	2206266	.	T	C	3	4	7	0	0	7	0	0
20	2240414	.	C	T	5	2	7	0	0	7	0	0
20	2240685	.	G	A	9	3	12	0	1	13	0	0
20	2240696	.	C	T	7	6	13	0	1	14	0	0
20	2240975	.	C	A	2	3	5	0	0	5	0	0
20	2241401	.	C	T	5	9	14	0	1	15	0	0
20	2241871	.	C	T	4	7	11	0	0	11	0	0
20	2290470	.	G	A	5	8	13	0	0	13	0	0
20	2293263	.	C	A	4	29	33	0	31	64	0	0
20	2295532	.	G	A	27	19	46	0	2	48	0	0
20	2975610	.	A	G	9	4	13	0	0	13	0	0
20	2975614	.	A	G	0	12	12	0	0	12	0	0
20	2976114	.	A	G	17	6	23	5	3	31	0	0
20	2976257	.	A	G	27	10	37	1	1	39	0	0
20	2976909	.	C	A	21	14	35	0	2	37	0	0
20	2977257	.	C	T	32	31	63	1	1	65	0	0
20	2977417	.	C	A	27	8	35	5	3	43	0	0
20	2977418	.	C	A	26	10	36	5	1	42	0	0
20	3001873	.	G	A	7	7	14	0	0	14	0	0
20	3004067	.	A	G	6	8	14	0	0	14	0	0
20	3009920	.	T	G	14	5	19	0	0	19	0	0
20	3016311	.	G	A	10	11	21	0	0	21	0	0
20	3017529	.	C	T	1	11	12	0	4	16	0	0
20	3017604	.	G	C	8	12	20	0	0	20	0	0
20	3018319	.	T	C	7	0	7	0	16	23	0	0
20	3020423	.	G	A	0	2	2	0	1	3	0	0
20	3022582	.	T	A	7	10	17	0	1	18	0	0
20	3026253	.	G	A	5	6	11	0	0	11	0	0
20	3029659	.	A	C	12	5	17	0	2	19	0	0
20	3029662	.	A	G	13	6	19	0	0	19	0	0
20	3039851	.	G	A	2	6	8	0	0	8	0	0
20	3050790	.	T	A	4	5	9	0	0	9	0	0
20	3050877	.	T	C	12	0	12	0	8	20	0	0
20	3061079	.	C	G	11	6	17	0	0	17	0	0
20	3086570	.	G	C	6	5	11	0	1	12	0	0
20	3086662	.	A	G	4	7	11	0	0	11	0	0
20	3087029	.	T	C	3	0	3	0	8	11	0	0
20	3108807	.	A	G	3	3	6	0	0	6	0	0
20	3113415	.	G	C	6	7	13	0	1	14	0	0
20	3115284	.	C	T	10	4	14	0	0	14	0	0
20	3117881	.	G	T	15	8	23	1	2	26	0	0
20	3117915	.	A	C	10	8	18	1	1	20	0	0
20	3117952	.	T	G	8	9	17	0	1	18	0	0
20	3118148	.	G	A	4	4	8	0	0	8	0	0
20	3118502	.	T	G	9	0	9	0	4	13	0	0
20	3118513	.	T	C	10	5	15	0	1	16	0	0
20	3118639	.	G	A	8	6	14	0	0	14	0	0
20	3118649	.	T	C	5	5	10	0	0	10	0	0
20	3120293	.	A	G	9	9	18	0	0	18	0	0
20	3120317	.	T	A	10	9	19	0	1	20	0	0
20	3121027	.	A	C	12	5	17	0	0	17	0	0
20	3121179	.	A	G	11	5	16	0	0	16	0	0
20	3121362	.	G	A	1	4	5	0	0	5	0	0
20	3121462	.	T	A	3	3	6	0	0	6	0	0
20	3121475	.	T	C	1	4	5	0	0	5	0	0
20	3121539	.	T	A	6	6	12	0	0	12	0	0
20	3121623	.	C	T	10	5	15	0	0	15	0	0
20	3121865	.	T	A	11	8	19	0	3	22	0	0
20	3121947	.	G	A	10	8	18	0	0	18	0	0
20	3122091	.	C	T	6	4	10	0	0	10	0	0
20	3122251	.	G	A	10	5	15	0	1	16	0	0
20	3129754	.	C	G	16	5	21	0	0	21	0	0
20	3130185	.	C	T	2	13	15	0	0	15	0	0
20	3130347	.	C	A	3	3	6	0	0	6	0	0
20	3145845	.	C	T	2	3	5	0	0	5	0	0
20	3151239	.	C	A	1	5	6	0	0	6	0	0
20	3223444	.	A	T	1	2	3	0	0	3	0	0
20	3223465	.	A	G	1	2	3	0	0	3	0	0
20	3239094	.	T	G	5	5	10	0	0	10	0	0
20	3239205	.	C	G	3	5	8	0	5	13	0	0
20	3239301	.	A	T	6	6	12	0	0	12	0	0
20	3239324	.	C	T	1	6	7	0	8	15	0	0
20	3239383	.	A	T	5	10	15	0	0	15	0	0
20	3242733	.	G	A	14	10	24	0	1	25	0	0
20	3248778	.	C	A	13	12	25	0	0	25	0	0
20	3248817	.	T	C	9	0	9	0	12	21	0	0
20	3248880	.	T	C	9	0	9	0	13	22	0	0
20	3248883	.	G	C	9	10	19	0	0	19	0	0
20	3248919	.	T	A	10	7	17	0	1	18	0	0
20	3249029	.	G	A	6	15	21	0	2	23	0	0
20	3249060	.	A	T	16	12	28	0	1	29	0	0
20	3249445	.	G	A	8	10	18	0	1	19	0	0
20	3249513	.	G	T	5	7	12	0	1	13	0	0
20	3249600	.	C	A	2	9	11	0	11	22	0	0
20	3249725	.	C	T	13	8	21	0	1	22	0	0
20	3249870	.	C	T	8	5	13	0	0	13	0	0
20	3249872	.	G	A	8	4	12	0	1	13	0	0
20	3254364	.	A	T	6	5	11	0	0	11	0	0
20	3264851	.	G	T	5	10	15	0	0	15	0	0
20	3282039	.	G	T	3	3	6	0	0	6	0	0
20	3288086	.	T	G	3	0	3	1	3	7	0	0
20	3292722	.	A	G	11	13	24	0	0	24	0	0
20	3294838	.	G	T	12	7	19	0	1	20	0	0
20	3377369	.	A	G	1	4	5	0	0	5	0	0
20	3828563	.	T	C	1	0	1	0	4	5	0	0
20	3916456	.	T	A	8	13	21	0	1	22	0	0
20	3916464	.	C	T	8	17	25	0	0	25	0	0
20	3916621	.	T	G	17	9	26	0	0	26	0	0
20	3920746	.	T	G	14	19	33	0	0	33	0	0
20	3920873	.	T	A	22	19	41	0	2	43	0	0
20	3920875	.	G	A	25	19	44	0	1	45	0	0
20	3920977	.	G	A	1	8	9	0	13	22	0	0
20	3921127	.	A	T	12	17	29	0	2	31	0	0
20	3921184	.	G	A	10	13	23	0	0	23	0	0
20	3921202	.	T	C	10	13	23	0	0	23	0	0
20	3923735	.	C	G	11	8	19	0	0	19	0	0
20	3923983	.	G	A	2	11	13	0	13	26	0	0
20	3924098	.	A	T	13	11	24	0	0	24	0	0
20	3924349	.	G	A	11	11	22	0	0	22	0	0
20	3924430	.	G	A	2	8	10	0	10	20	0	0
20	3924528	.	C	A	8	12	20	0	0	20	0	0
20	3924824	.	A	C	5	4	9	0	0	9	0	0
20	3924943	.	T	G	14	0	14	0	9	23	0	0
20	3925146	.	A	T	4	9	13	0	0	13	0	0
20	3925537	.	T	C	10	13	23	0	1	24	0	0
20	3925544	.	T	A	18	9	27	0	2	29	0	0
20	3925604	.	A	G	20	5	25	0	0	25	0	0
20	3925842	.	C	A	19	5	24	0	0	24	0	0
20	3925889	.	C	T	15	6	21	6	0	27	0	0
20	3925907	.	T	A	4	10	14	6	1	21	0	0
20	3925934	.	C	T	5	1	6	7	0	13	0	0
20	3925942	.	A	G	6	3	9	2	1	12	0	0
20	3926020	.	C	T	13	5	18	0	0	18	0	0
20	3926337	.	C	T	3	6	9	3	0	12	0	0
20	3926655	.	T	C	29	4	33	1	0	34	0	0
20	3926679	.	G	T	22	4	26	1	0	27	0	0
20	3926721	.	T	C	22	5	27	0	0	27	0	0
20	3926736	.	T	A	21	7	28	0	1	29	0	0
20	3926907	.	T	G	9	16	25	0	5	30	0	0
20	3926928	.	T	A	17	17	34	0	1	35	0	0
20	3926951	.	A	G	22	17	39	0	3	42	0	0
20	3927267	.	C	A	22	10	32	0	0	32	0	0
20	3927326	.	A	G	9	10	19	0	2	21	0	0
20	3927446	.	C	G	10	8	18	0	0	18	0	0
20	3947006	.	T	G	2	7	9	0	1	10	0	0
20	3947058	.	C	A	2	5	7	0	0	7	0	0
20	3947100	.	C	T	8	2	10	0	2	12	0	0
20	3947116	.	A	G	0	10	10	0	1	11	0	0
20	3953593	.	T	C	9	7	16	0	0	16	0	0
20	3954813	.	G	C	4	4	8	0	0	8	0	0
20	3961046	.	C	T	6	2	8	0	0	8	0	0
20	3971246	.	G	C	7	4	11	0	0	11	0	0
20	3985248	.	G	A	6	5	11	0	0	11	0	0
20	3991416	.	A	G	2	4	6	0	0	6	0	0
20	3994351	.	T	G	2	2	4	0	1	5	0	0
20	4000366	.	C	T	6	4	10	0	0	10	0	0
20	4009409	.	C	G	3	2	5	1	0	6	0	0
20	4010256	.	T	C	3	8	11	0	0	11	0	0
20	4010462	.	C	T	2	6	8	0	0	8	0	0
20	4011135	.	G	A	3	5	8	1	1	10	0	0
20	4011161	.	C	T	3	3	6	1	0	7	0	0
20	4035614	.	T	A	3	2	5	0	0	5	0	0
20	4035769	.	A	T	2	3	5	0	0	5	0	0
20	4035837	.	G	A	9	10	19	0	1	20	0	0
20	4035858	.	G	C	8	9	17	0	0	17	0	0
20	4036272	.	G	T	1	4	5	0	0	5	0	0
20	4036720	.	T	C	3	4	7	0	0	7	0	0
20	4036737	.	T	C	2	4	6	0	0	6	0	0
20	4036795	.	T	C	1	4	5	0	0	5	0	0
20	4037184	.	C	T	1	2	3	0	1	4	0	0
20	4037221	.	C	T	1	2	3	0	0	3	0	0
20	4037222	.	A	T	1	2	3	0	0	3	0	0
20	4037409	.	T	A	1	2	3	0	0	3	0	0
20	4037708	.	C	T	0	2	2	0	2	4	0	0
20	4037823	.	G	C	4	0	4	0	4	8	0	0
20	4037824	.	T	G	3	4	7	0	1	8	0	0
20	4037942	.	C	T	5	2	7	0	0	7	0	0
20	4038242	.	C	A	4	2	6	0	0	6	0	0
20	4043508	.	C	G	2	2	4	0	0	4	0	0
20	4043559	.	G	A	2	3	5	0	0	5	0	0
20	4051818	.	C	T	14	15	29	0	0	29	0	0
20	4052295	.	A	G	5	0	5	0	7	12	0	0
20	4052313	.	T	C	2	4	6	0	0	6	0	0
20	4053012	.	G	A	0	7	7	0	8	15	0	0
20	4060970	.	T	A	4	4	8	0	0	8	0	0
20	4061036	.	T	C	1	6	7	0	0	7	0	0
20	4091851	.	G	A	4	2	6	0	0	6	0	0
20	4124207	.	A	T	3	3	6	0	1	7	0	0
20	4124294	.	T	C	3	5	8	0	0	8	0	0
20	4153436	.	A	G	5	2	7	0	0	7	0	0
20	4157066	.	A	C	4	2	6	0	0	6	0	0
20	4170812	.	T	C	1	3	4	0	0	4	0	0
20	4174220	.	G	A	1	2	3	0	1	4	0	0
20	4175807	.	T	A	4	6	10	0	1	11	0	0
20	4180743	.	C	T	4	7	11	0	0	11	0	0
20	4185382	.	G	A	1	3	4	0	3	7	0	0
20	4393455	.	C	T	1	7	8	1	0	9	0	0
20	4841389	.	A	C	9	0	9	0	7	16	0	0
20	4888037	.	T	C	2	12	14	0	2	16	0	0
20	4896120	.	G	T	2	5	7	0	0	7	0	0
20	4896201	.	G	A	8	7	15	0	2	17	0	0
20	4896240	.	A	C	2	8	10	0	0	10	0	0
20	4898563	.	A	T	12	16	28	0	3	31	0	0
20	4898683	.	C	T	12	10	22	0	2	24	0	0
20	4898776	.	C	T	18	14	32	0	4	36	0	0
20	4898784	.	T	C	19	10	29	0	3	32	0	0
20	4899342	.	T	G	10	11	21	0	0	21	0	0
20	4899716	.	G	T	7	5	12	0	1	14	1	0
20	4899935	.	A	T	11	9	20	0	1	21	0	0
20	4900564	.	T	C	7	6	13	0	0	13	0	0
20	4900600	.	G	A	5	10	15	0	0	15	0	0
20	4900609	.	T	C	4	0	4	0	11	15	0	0
20	4900855	.	C	T	9	11	20	0	1	21	0	0
20	4903334	.	G	C	9	15	24	0	2	26	0	0
20	4903456	.	A	G	7	9	16	0	0	16	0	0
20	4910953	.	G	A	7	8	15	0	0	15	0	0
20	4934016	.	T	C	11	0	11	0	4	15	0	0
20	4938844	.	A	G	7	4	11	0	1	12	0	0
20	4956918	.	C	T	8	9	17	0	1	18	0	0
20	4957041	.	T	A	8	9	17	0	2	19	0	0
20	5003079	.	A	G	8	9	17	0	0	17	0	0
20	5051320	.	A	G	4	9	13	0	0	13	0	0
20	5052048	.	A	G	5	2	7	0	1	8	0	0
20	5065444	.	A	T	2	2	4	0	0	4	0	0
20	5065736	.	T	G	4	4	8	0	0	8	0	0
20	5069252	.	T	A	3	2	5	0	1	6	0	0
20	5069389	.	G	A	4	4	8	0	0	8	0	0
20	5069500	.	T	C	3	4	7	0	0	7	0	0
20	5069565	.	G	A	3	3	6	0	0	6	0	0
20	5089011	.	C	T	8	7	15	0	0	15	0	0
20	5089150	.	C	A	4	9	13	0	0	13	0	0
20	5090938	.	G	A	0	5	5	0	6	11	0	0
20	5094205	.	A	C	5	2	7	0	0	7	0	0
20	5094207	.	G	A	0	5	5	0	2	7	0	0
20	6652278	.	A	T	5	3	8	0	1	9	0	0
20	6666099	.	T	G	6	4	10	0	0	10	0	0
20	6666528	.	A	C	3	5	8	0	0	8	0	0
20	6773973	.	G	C	3	2	5	0	0	5	0	0
20	6774066	.	G	T	4	4	8	0	0	8	0	0
20	6791151	.	G	C	4	11	15	0	0	15	0	0
20	6802879	.	A	G	5	4	9	0	0	9	0	0
20	6803105	.	A	T	7	4	11	0	0	11	0	0
20	6803170	.	G	T	5	4	9	0	0	9	0	0
20	6803213	.	T	G	3	6	9	0	3	12	0	0
20	6803497	.	C	T	3	2	5	0	0	5	0	0
20	6894999	.	A	G	5	14	19	0	0	19	0	0
20	6895083	.	G	T	7	6	13	0	0	13	0	0
20	6895120	.	T	A	4	7	11	0	1	12	0	0
20	6895192	.	C	G	8	5	13	0	2	15	0	0
20	6903803	.	C	T	6	5	11	0	1	12	0	0
20	6903805	.	C	T	4	7	11	0	1	12	0	0
20	6936427	.	T	A	7	5	12	0	0	12	0	0
20	6962650	.	G	A	4	8	12	0	0	12	0	0
20	6962701	.	G	A	4	5	9	1	0	10	0	0
20	6967149	.	A	G	9	4	13	0	0	13	0	0
20	6999419	.	G	A	4	5	9	0	1	10	0	0
20	7072248	.	T	G	2	2	4	0	0	4	0	0
20	7427427	.	C	G	1	2	3	0	0	3	0	0
20	7432753	.	G	A	2	5	7	0	0	7	0	0
20	7432762	.	A	G	2	0	2	0	4	6	0	0
20	7448009	.	T	G	6	4	10	0	2	12	0	0
20	7449788	.	G	A	1	4	5	0	0	5	0	0
20	7449851	.	C	T	7	3	10	0	1	11	0	0
20	7464014	.	C	A	2	2	4	0	0	4	0	0
20	7464122	.	G	T	9	9	18	0	1	19	0	0
20	7464125	.	T	G	10	10	20	0	0	20	0	0
20	7464337	.	G	A	8	4	12	0	0	12	0	0
20	7469280	.	G	A	5	7	12	0	0	12	0	0
20	7471488	.	G	A	1	4	5	0	0	5	0	0
20	7471491	.	C	A	1	4	5	0	0	5	0	0
20	7480286	.	T	C	3	0	3	0	2	5	0	0
20	7486930	.	C	T	0	2	2	0	1	3	0	0
20	7535117	.	T	G	4	3	7	0	0	7	0	0
20	7582816	.	A	G	6	8	14	0	2	16	0	0
20	7582925	.	G	A	6	3	9	0	1	10	0	0
20	7583021	.	T	C	1	0	1	0	3	4	0	0
20	7588957	.	A	G	12	0	12	0	8	20	0	0
20	7965965	.	G	A	4	10	14	0	0	14	0	0
20	7966006	.	A	T	5	2	7	0	1	8	0	0
20	7966049	.	T	G	6	3	9	0	0	9	0	0
20	7966090	.	T	G	6	9	15	0	1	16	0	0
20	7966127	.	G	A	6	7	13	0	1	14	0	0
20	7966135	.	A	C	7	7	14	0	0	14	0	0
20	7966227	.	A	G	3	4	7	0	0	7	0	0
20	7966419	.	G	C	3	5	8	0	0	8	0	0
20	7966555	.	C	G	3	4	7	0	0	7	0	0
20	7966938	.	G	A	5	4	9	1	0	10	0	0
20	7967030	.	T	C	2	0	2	0	2	4	0	0
20	7967128	.	C	T	0	5	5	0	3	8	0	0
20	7967251	.	C	T	8	8	16	0	0	16	0	0
20	7967305	.	A	G	3	6	9	0	1	10	0	0
20	7986791	.	A	T	1	6	7	0	0	7	0	0
20	8040660	.	T	A	1	6	7	0	3	10	0	0
20	8055224	.	C	G	2	5	7	0	0	7	0	0
20	8055260	.	A	C	4	3	7	0	0	7	0	0
20	8055612	.	T	C	4	2	6	0	0	6	0	0
20	8055681	.	G	C	5	2	7	0	0	7	0	0
20	8060310	.	G	A	10	5	15	0	1	16	0	0
20	8066300	.	G	A	4	2	6	0	1	7	0	0
20	8122938	.	T	A	11	6	17	0	0	17	0	0
20	8123047	.	G	A	6	6	12	0	0	12	0	0
20	8138389	.	C	G	10	16	26	0	0	26	0	0
20	8147222	.	C	T	1	5	6	0	9	15	0	0
20	8154139	.	G	A	8	6	14	0	0	14	0	0
20	8154169	.	A	G	11	10	21	0	0	21	0	0
20	8154178	.	G	A	10	11	21	0	0	21	0	0
20	8163955	.	C	T	10	14	24	0	2	26	0	0
20	8189652	.	C	G	0	6	6	0	13	19	0	0
20	8193390	.	T	A	9	7	16	0	1	17	0	0
20	8196380	.	G	A	2	8	10	0	0	10	0	0
20	8245716	.	G	A	6	7	13	0	0	13	0	0
20	9096596	.	C	A	3	2	5	0	0	5	0	0
20	9096615	.	C	G	2	2	4	0	0	4	0	0
20	9109195	.	T	C	4	5	9	0	0	9	0	0
20	9115200	.	C	A	6	6	12	0	0	12	0	0
20	9118783	.	G	A	1	5	6	0	0	6	0	0
20	9124759	.	C	T	1	4	5	0	0	5	0	0
20	9124996	.	A	G	2	0	2	0	4	6	0	0
20	9125264	.	G	A	4	2	6	0	0	6	0	0
20	9125291	.	T	A	3	2	5	0	0	5	0	0
20	9130368	.	C	T	3	2	5	0	0	5	0	0
20	9131049	.	C	T	3	3	6	0	0	6	0	0
20	9133127	.	T	G	5	3	8	0	1	9	0	0
20	9148121	.	G	C	4	4	8	0	0	8	0	0
20	9148162	.	A	G	4	4	8	0	0	8	0	0
20	9148166	.	G	T	2	2	4	0	2	6	0	0
20	9183337	.	T	C	11	0	11	0	14	25	0	0
20	9184696	.	T	C	7	9	16	0	0	16	0	0
20	9184928	.	C	A	7	8	15	0	0	15	0	0
20	9186281	.	T	C	13	0	13	0	12	25	0	0
20	9186310	.	T	C	10	8	18	0	1	19	0	0
20	9190697	.	G	T	10	3	13	0	0	13	0	0
20	9190723	.	A	T	7	4	11	0	0	11	0	0
20	9190767	.	T	C	11	4	15	0	1	16	0	0
20	9190768	.	T	C	12	4	16	0	0	16	0	0
20	9190826	.	A	C	8	0	8	0	15	23	0	0
20	9190829	.	T	G	5	2	7	0	14	21	0	0
20	9190991	.	A	G	10	11	21	0	1	22	0	0
20	9191255	.	T	C	9	0	9	0	5	14	0	0
20	9191267	.	T	A	5	6	11	0	3	14	0	0
20	9191461	.	C	T	9	11	20	0	5	25	0	0
20	9192463	.	C	T	12	5	17	0	0	17	0	0
20	9193285	.	C	T	10	5	15	0	2	17	0	0
20	9193359	.	C	T	3	5	8	0	1	9	0	0
20	9193818	.	T	A	3	6	9	0	0	9	0	0
20	9194069	.	A	T	3	3	6	0	0	6	0	0
20	9199500	.	C	T	13	10	23	0	0	23	0	0
20	9216203	.	T	C	1	4	5	0	0	5	0	0
20	9216564	.	A	G	4	5	9	0	0	9	0	0
20	9216588	.	G	A	2	5	7	0	0	7	0	0
20	9242422	.	G	C	10	8	18	0	0	18	0	0
20	9246461	.	C	A	7	4	11	0	1	12	0	0
20	9248376	.	T	A	3	3	6	0	1	7	0	0
20	9248446	.	G	A	3	4	7	0	0	7	0	0
20	9248482	.	T	C	7	0	7	0	5	12	0	0
20	9248494	.	T	C	7	1	8	0	6	14	0	0
20	9248524	.	T	C	9	6	15	0	2	17	0	0
20	9248635	.	C	T	1	6	7	0	5	12	0	0
20	9248692	.	G	A	6	4	10	0	0	10	0	0
20	9249901	.	A	G	6	8	14	0	0	14	0	0
20	9355967	.	C	T	17	18	35	0	3	38	0	0
20	9412642	.	C	T	21	10	31	0	2	33	0	0
20	9418744	.	A	G	26	15	41	0	2	43	0	0
20	9418804	.	T	C	19	10	29	0	0	29	0	0
20	9419014	.	A	T	25	12	37	0	0	37	0	0
20	9419218	.	G	A	27	14	41	0	0	41	0	0
20	9419314	.	C	T	13	25	38	0	0	38	0	0
20	9419575	.	C	T	12	15	27	0	6	33	0	0
20	9419716	.	T	C	22	21	43	0	2	45	0	0
20	9419842	.	C	T	14	13	27	0	2	29	0	0
20	9419896	.	C	T	18	12	30	0	1	32	1	0
20	9420018	.	C	T	21	10	31	0	3	34	0	0
20	9420168	.	T	C	17	14	31	0	1	32	0	0
20	9420974	.	A	T	29	6	35	2	2	39	0	0
20	9420976	.	C	T	31	5	36	2	2	40	0	0
20	9421011	.	A	G	25	0	25	0	21	46	0	0
20	9421515	.	G	A	2	5	7	0	0	7	0	0
20	9421563	.	G	A	5	4	9	0	0	9	0	0
20	9421672	.	C	T	0	11	11	0	7	18	0	0
20	9421690	.	G	T	6	8	14	0	1	15	0	0
20	9421732	.	T	A	9	11	20	0	1	21	0	0
20	9421781	.	T	C	10	0	10	0	10	20	0	0
20	9422045	.	G	A	4	13	17	0	0	17	0	0
20	9422536	.	G	A	12	10	22	0	0	22	0	0
20	9422566	.	G	A	13	11	24	0	0	24	0	0
20	9427737	.	G	T	15	6	21	0	0	21	0	0
20	9429315	.	G	T	13	16	29	2	1	32	0	0
20	9429363	.	G	A	21	22	43	2	0	45	0	0
20	9429370	.	C	T	19	22	41	1	0	42	0	0
20	9429414	.	T	C	22	2	24	0	17	41	0	0
20	9429648	.	A	G	29	32	61	0	1	62	0	0
20	9436314	.	A	T	14	16	30	0	1	31	0	0
20	9436363	.	A	G	15	25	40	0	2	42	0	0
20	9462312	.	T	A	24	20	44	0	1	45	0	0
20	9462412	.	G	T	15	13	28	0	0	28	0	0
20	9575868	.	T	C	4	0	4	0	6	10	0	0
20	9576550	.	C	T	2	2	4	2	2	8	0	0
20	9577157	.	G	A	2	5	7	0	0	7	0	0
20	9577250	.	A	G	5	6	11	0	0	11	0	0
20	9577487	.	G	A	5	8	13	0	0	13	0	0
20	9577769	.	A	G	4	5	9	0	0	9	0	0
20	9578173	.	A	T	7	3	10	0	2	12	0	0
20	9764211	.	T	C	12	16	28	0	0	28	0	0
20	9766973	.	G	A	15	11	26	0	0	26	0	0
20	9768191	.	C	T	15	14	29	0	2	31	0	0
20	9768230	.	C	T	19	8	27	0	2	29	0	0
20	9768330	.	A	G	9	14	23	0	2	25	0	0
20	9775889	.	A	G	17	13	30	0	1	31	0	0
20	9775934	.	T	C	25	18	43	1	2	46	0	0
20	9776270	.	G	A	11	10	21	0	0	21	0	0
20	9776579	.	T	C	1	2	3	0	0	3	0	0
20	9776653	.	T	C	3	2	5	0	0	5	0	0
20	9776770	.	A	G	4	2	6	0	0	6	0	0
20	9777182	.	C	T	3	4	7	0	0	7	0	0
20	9777200	.	G	A	1	4	5	0	0	5	0	0
20	9777447	.	G	A	2	3	5	0	0	5	0	0
20	9779236	.	T	G	5	2	7	0	0	7	0	0
20	9779333	.	T	C	3	0	3	0	3	6	0	0
20	9782147	.	T	G	11	1	12	0	11	23	0	0
20	9782747	.	C	A	10	9	19	0	2	21	0	0
20	9782913	.	T	C	8	12	20	1	0	21	0	0
20	9782990	.	T	C	10	8	18	0	0	18	0	0
20	9820430	.	T	C	22	8	30	0	0	30	0	0
20	9830642	.	T	C	32	30	62	0	4	66	0	0
20	9830684	.	G	T	31	35	66	0	0	66	0	0
20	9831443	.	G	A	33	35	68	0	0	68	0	0
20	9831703	.	T	A	43	30	73	0	0	73	0	0
20	9837587	.	G	A	42	33	75	0	2	78	1	0
20	9837593	.	T	C	36	24	60	0	12	72	0	0
20	9846751	.	A	G	32	34	66	0	4	70	0	0
20	9846989	.	T	C	36	33	69	0	3	72	0	0
20	9846997	.	A	T	34	32	66	0	4	70	0	0
20	9847078	.	T	C	31	26	57	0	4	61	0	0
20	9847252	.	G	T	11	21	32	0	2	34	0	0
20	9847298	.	T	G	19	19	38	0	3	41	0	0
20	9847304	.	G	A	25	20	45	0	1	46	0	0
20	9847381	.	A	C	26	11	37	0	5	42	0	0
20	9847529	.	A	T	34	20	54	0	0	54	0	0
20	9847772	.	T	C	22	35	57	0	0	57	0	0
20	9847895	.	C	T	33	22	55	0	0	55	0	0
20	9848116	.	C	T	43	17	60	0	0	60	0	0
20	9848181	.	A	T	49	7	56	0	3	59	0	0
20	9959377	.	G	A	2	4	6	0	1	7	0	0
20	9959699	.	T	A	3	8	11	0	0	11	0	0
20	9959725	.	C	T	1	5	6	0	1	7	0	0
20	9959794	.	T	C	3	5	8	0	0	8	0	0
20	9959890	.	G	A	6	2	8	0	0	8	0	0
20	9960091	.	G	A	5	2	7	0	0	7	0	0
20	9960635	.	G	A	3	4	7	0	0	7	0	0
20	9961144	.	G	A	3	7	10	0	1	11	0	0
20	9961145	.	T	C	4	0	4	0	7	11	0	0
20	9974287	.	G	A	2	3	5	0	0	5	0	0
20	9979455	.	A	T	2	2	4	0	0	4	0	0
20	10057929	.	T	C	2	4	6	0	0	6	0	0
20	10057993	.	C	G	1	5	6	0	7	13	0	0
20	10058109	.	T	A	11	8	19	0	0	19	0	0
20	10058111	.	A	G	11	8	19	0	0	19	0	0
20	10058242	.	T	C	15	9	24	0	0	24	0	0
20	10058350	.	C	T	8	11	19	0	0	19	0	0
20	10058441	.	A	T	10	5	15	0	0	15	0	0
20	10058476	.	T	A	11	9	20	0	0	20	0	0
20	10058796	.	G	A	6	2	8	0	2	10	0	0
20	10058829	.	T	A	7	3	10	0	0	10	0	0
20	10058853	.	C	A	10	4	14	0	2	16	0	0
20	10058897	.	C	T	7	6	13	0	1	14	0	0
20	10058901	.	G	C	8	6	14	0	0	14	0	0
20	10058948	.	T	A	8	3	11	0	0	11	0	0
20	10058993	.	T	C	12	0	12	0	8	20	0	0
20	10059194	.	G	A	6	12	18	0	1	19	0	0
20	10059278	.	A	G	11	9	20	0	0	20	0	0
20	10059815	.	A	G	7	3	10	0	0	10	0	0
20	10060391	.	G	A	5	4	9	0	0	9	0	0
20	10060483	.	A	C	9	11	20	0	0	20	0	0
20	10060586	.	C	T	5	5	10	0	0	11	1	0
20	10060768	.	G	C	7	4	11	0	0	11	0	0
20	10060808	.	T	C	5	7	12	0	0	12	0	0
20	10060859	.	C	A	5	6	11	0	2	13	0	0
20	10061144	.	T	A	3	4	7	0	0	7	0	0
20	10061457	.	C	T	3	3	6	0	0	6	0	0
20	10061481	.	T	G	1	3	4	0	1	5	0	0
20	10061535	.	A	T	2	4	6	0	0	6	0	0
20	10061563	.	C	T	5	5	10	0	0	10	0	0
20	10061778	.	T	C	3	9	12	0	0	12	0	0
20	10061837	.	C	T	1	5	6	1	1	8	0	0
20	10061859	.	C	T	4	7	11	1	0	12	0	0
20	10064993	.	A	G	7	6	13	0	0	13	0	0
20	10065033	.	T	A	6	2	8	0	0	8	0	0
20	10099362	.	T	A	4	4	8	0	0	8	0	0
20	10099363	.	C	T	4	4	8	0	0	8	0	0
20	10099521	.	T	G	5	4	9	0	1	10	0	0
20	10099602	.	C	A	6	2	8	0	0	8	0	0
20	10099603	.	C	A	7	2	9	0	0	9	0	0
20	10099816	.	C	T	6	12	18	0	0	18	0	0
20	10116067	.	A	G	13	15	28	0	0	28	0	0
20	10118393	.	A	T	9	6	15	0	0	15	0	0
20	10118691	.	T	C	7	4	11	0	3	14	0	0
20	10204518	.	T	C	4	5	9	0	0	9	0	0
20	10204644	.	A	T	12	4	16	0	0	16	0	0
20	10210328	.	A	G	8	0	8	0	9	17	0	0
20	10210358	.	C	T	7	5	12	0	0	12	0	0
20	10218637	.	T	A	6	6	12	0	1	13	0	0
20	10218890	.	C	T	8	5	13	0	1	14	0	0
20	10218937	.	C	A	8	4	12	0	0	12	0	0
20	10219336	.	T	G	1	2	3	0	0	3	0	0
20	10219360	.	T	C	2	3	5	0	0	5	0	0
20	10219377	.	T	A	3	4	7	0	0	7	0	0
20	10219431	.	A	G	5	0	5	0	6	11	0	0
20	10219467	.	C	A	2	3	5	0	0	5	0	0
20	10219537	.	C	T	2	4	6	0	0	6	0	0
20	10219558	.	T	C	2	2	4	0	0	4	0	0
20	10219597	.	A	G	5	3	8	0	0	8	0	0
20	10219779	.	G	A	1	4	5	0	0	5	0	0
20	10219985	.	A	T	2	2	4	0	0	4	0	0
20	10219988	.	A	G	2	2	4	0	0	4	0	0
20	10220138	.	T	C	5	6	11	0	0	11	0	0
20	10220188	.	A	C	6	7	13	0	0	13	0	0
20	10220213	.	G	A	6	7	13	0	0	13	0	0
20	10220261	.	G	T	8	6	14	0	0	14	0	0
20	10353220	.	G	A	3	3	6	0	0	6	0	0
20	10353222	.	G	A	3	3	6	0	0	6	0	0
20	10353474	.	A	G	11	8	19	0	1	20	0	0
20	10353528	.	G	A	9	7	16	0	0	16	0	0
20	10353718	.	G	T	1	7	8	0	0	8	0	0
20	10353728	.	A	G	1	7	8	0	1	9	0	0
20	10353762	.	T	C	2	10	12	0	0	12	0	0
20	10353797	.	A	G	5	8	13	0	2	15	0	0
20	10353798	.	A	T	5	7	12	0	3	15	0	0
20	10353912	.	G	C	4	16	20	0	1	21	0	0
20	10354329	.	A	G	4	7	11	0	1	12	0	0
20	10354482	.	T	G	13	8	21	1	4	26	0	0
20	10422619	.	A	C	14	12	26	0	1	27	0	0
20	10422658	.	G	T	13	8	21	0	0	21	0	0
20	10489564	.	A	G	3	3	6	0	0	6	0	0
20	11098255	.	G	A	6	3	9	0	0	9	0	0
20	11098301	.	T	C	4	4	8	0	0	8	0	0
20	11098547	.	T	A	3	5	8	0	0	8	0	0
20	11098710	.	C	A	8	6	14	0	0	14	0	0
20	11098851	.	G	A	11	3	14	0	0	14	0	0
20	11098859	.	G	A	9	3	12	0	2	14	0	0
20	11098960	.	G	A	4	3	7	0	0	7	0	0
20	11099013	.	G	A	4	8	12	0	1	13	0	0
20	11099223	.	C	T	0	6	6	0	5	11	0	0
20	11099304	.	A	G	6	5	11	0	5	16	0	0
20	11099345	.	T	A	4	4	8	0	1	9	0	0
20	11102169	.	G	A	3	6	9	0	0	9	0	0
20	11102328	.	C	T	0	2	2	0	8	10	0	0
20	11102551	.	A	G	3	2	5	0	0	5	0	0
20	11102623	.	G	A	3	6	9	0	0	9	0	0
20	11102625	.	G	C	6	3	9	0	0	9	0	0
20	11102805	.	G	A	5	4	9	0	1	10	0	0
20	11103244	.	T	A	2	4	6	0	4	10	0	0
20	11104920	.	C	G	5	3	8	0	1	9	0	0
20	11104994	.	G	A	6	3	9	0	0	9	0	0
20	11105363	.	G	T	2	5	7	0	0	7	0	0
20	11105676	.	A	G	1	2	3	0	0	3	0	0
20	11106023	.	G	A	5	2	7	0	0	7	0	0
20	13567503	.	T	C	7	0	7	0	6	13	0	0
20	13567556	.	T	C	4	2	6	0	0	6	0	0
20	13567574	.	T	C	2	3	5	0	0	5	0	0
20	14893339	.	A	C	6	22	28	0	0	28	0	0
20	14977165	.	G	A	2	12	14	0	15	30	1	0
20	14983779	.	C	T	14	12	26	0	1	27	0	0
20	14983788	.	C	T	11	13	24	0	0	24	0	0
20	14997711	.	G	C	19	9	28	0	3	31	0	0
20	14997729	.	G	A	21	11	32	0	0	32	0	0
20	14997753	.	T	A	23	13	36	0	0	36	0	0
20	15004153	.	T	C	20	17	37	0	2	39	0	0
20	15004205	.	C	T	21	21	42	0	1	43	0	0
20	15004321	.	C	T	21	17	38	0	0	38	0	0
20	15004334	.	A	C	20	17	37	0	1	38	0	0
20	15004518	.	A	G	10	13	23	0	0	23	0	0
20	15004575	.	C	A	14	9	23	0	0	23	0	0
20	15004611	.	A	C	17	6	23	0	0	23	0	0
20	15004710	.	C	T	9	16	25	0	0	25	0	0
20	15004746	.	T	A	12	11	23	0	0	23	0	0
20	15004751	.	T	G	9	10	19	0	2	21	0	0
20	15004806	.	C	T	11	10	21	0	0	21	0	0
20	15004825	.	A	T	11	12	23	0	0	23	0	0
20	15004862	.	T	C	13	6	19	0	2	21	0	0
20	15004874	.	A	G	16	0	16	0	7	23	0	0
20	15004997	.	C	T	10	2	12	0	2	14	0	0
20	15023488	.	T	C	14	9	23	0	1	24	0	0
20	15026847	.	C	T	2	7	9	0	17	26	0	0
20	15033954	.	A	G	16	13	29	1	0	30	0	0
20	15034192	.	A	G	18	13	31	0	0	31	0	0
20	15039385	.	C	T	0	4	4	0	11	15	0	0
20	15050678	.	G	A	5	11	16	0	0	16	0	0
20	15050753	.	G	T	6	10	16	0	0	16	0	0
20	15051266	.	C	T	8	8	16	0	0	16	0	0
20	15051379	.	T	G	6	5	11	0	0	11	0	0
20	15051422	.	C	T	5	5	10	0	0	10	0	0
20	15051770	.	G	A	5	10	15	0	0	15	0	0
20	15051791	.	G	A	6	8	14	0	1	15	0	0
20	15051812	.	T	C	8	8	16	0	0	16	0	0
20	15054365	.	G	A	2	7	9	0	1	10	0	0
20	15093896	.	T	G	2	2	4	0	0	4	0	0
20	15094356	.	C	T	1	3	4	1	1	6	0	0
20	15096974	.	C	T	1	3	4	0	0	4	0	0
20	15097120	.	C	T	2	3	5	0	0	5	0	0
20	15097154	.	C	T	0	2	2	0	2	4	0	0
20	15121481	.	G	T	3	6	9	0	0	9	0	0
20	15121566	.	A	G	1	2	3	0	0	3	0	0
20	15121804	.	G	A	5	3	8	0	0	8	0	0
20	15122143	.	G	T	5	3	8	0	0	8	0	0
20	15126465	.	A	G	1	3	4	0	0	4	0	0
20	15128338	.	G	A	5	4	9	1	1	11	0	0
20	15128363	.	C	T	4	6	10	1	0	11	0	0
20	15151874	.	A	C	1	2	3	0	0	3	0	0
20	15152036	.	T	A	2	2	4	0	0	4	0	0
20	15152160	.	C	A	1	2	3	0	0	3	0	0
20	15152219	.	T	A	2	3	5	0	0	5	0	0
20	15152666	.	C	T	1	2	3	0	7	10	0	0
20	15152679	.	C	A	2	6	8	1	0	9	0	0
20	15161176	.	G	C	2	0	2	0	4	6	0	0
20	15161326	.	T	C	2	2	4	0	2	6	0	0
20	15161512	.	C	T	2	2	4	0	0	4	0	0
20	15161519	.	G	A	2	1	3	0	0	3	0	0
20	15161571	.	G	A	5	3	8	0	0	8	0	0
20	15171711	.	C	T	11	18	29	0	1	30	0	0
20	15184455	.	C	T	25	18	43	0	1	44	0	0
20	15184458	.	A	G	16	0	16	0	26	42	0	0
20	15184527	.	T	A	14	12	26	0	1	27	0	0
20	15184568	.	T	G	12	24	36	0	0	36	0	0
20	15184611	.	A	T	8	20	28	0	0	28	0	0
20	15184629	.	T	G	15	7	22	0	0	22	0	0
20	15184654	.	C	T	7	9	16	0	0	16	0	0
20	15184671	.	A	G	7	6	13	0	0	13	0	0
20	15552681	.	G	A	1	2	3	0	0	3	0	0
20	15553003	.	C	T	17	20	37	0	3	40	0	0
20	15553159	.	A	G	16	12	28	0	1	29	0	0
20	15553366	.	G	T	17	27	44	0	2	46	0	0
20	15554247	.	A	G	15	7	22	0	4	26	0	0
20	15566235	.	C	T	3	2	5	0	0	5	0	0
20	15574202	.	G	A	5	3	8	0	2	10	0	0
20	15578007	.	G	A	0	5	5	0	4	9	0	0
20	15857317	.	G	C	10	10	20	0	0	21	1	0
20	15857761	.	T	A	15	21	36	0	4	40	0	0
20	15857805	.	T	A	17	22	39	0	0	39	0	0
20	15857850	.	C	T	20	16	36	0	1	37	0	0
20	15866267	.	A	G	16	18	34	0	1	35	0	0
20	15866414	.	T	C	14	13	27	0	1	28	0	0
20	15876778	.	A	G	17	15	32	0	1	33	0	0
20	15876812	.	G	A	18	15	33	1	2	36	0	0
20	15876824	.	C	A	2	18	20	1	18	39	0	0
20	15912192	.	C	T	1	14	15	0	7	23	1	0
20	15912906	.	T	C	13	9	22	0	0	22	0	0
20	15933068	.	C	T	1	2	3	0	1	4	0	0
20	15933168	.	G	C	7	6	13	0	0	13	0	0
20	15933223	.	C	A	9	5	14	0	0	14	0	0
20	15933229	.	T	C	10	5	15	0	0	15	0	0
20	15933258	.	C	T	8	8	16	0	0	16	0	0
20	15933289	.	G	A	6	13	19	0	0	19	0	0
20	15933347	.	T	G	12	4	16	1	1	18	0	0
20	15933374	.	C	T	8	5	13	1	0	14	0	0
20	15933419	.	G	A	11	5	16	0	0	16	0	0
20	15933424	.	T	C	5	10	15	0	0	15	0	0
20	15933489	.	T	C	9	0	9	0	5	14	0	0
20	15933553	.	G	A	7	6	13	0	1	14	0	0
20	15933566	.	G	A	9	8	17	0	1	18	0	0
20	15933852	.	C	T	7	10	17	0	2	19	0	0
20	15934395	.	G	T	6	2	8	0	3	11	0	0
20	15934519	.	A	G	10	3	13	0	0	13	0	0
20	15934526	.	G	T	9	2	11	0	0	12	1	0
20	15934639	.	G	C	2	5	7	1	0	8	0	0
20	15935109	.	A	T	4	6	10	0	0	10	0	0
20	15935141	.	T	G	4	3	7	0	1	8	0	0
20	15935146	.	A	C	3	4	7	0	0	8	1	0
20	15937029	.	A	T	3	4	7	0	1	8	0	0
20	15937278	.	C	G	2	4	6	0	0	6	0	0
20	15937351	.	G	A	1	3	4	0	1	5	0	0
20	15937567	.	G	T	6	6	12	0	0	12	0	0
20	15937613	.	G	A	8	5	13	0	1	14	0	0
20	15937637	.	A	G	6	4	10	1	0	11	0	0
20	15937648	.	A	T	12	4	16	1	0	17	0	0
20	15937709	.	G	A	6	3	9	0	0	9	0	0
20	15937926	.	C	A	4	4	8	0	0	8	0	0
20	15943257	.	G	T	3	1	4	0	0	4	0	0
20	15943281	.	G	A	3	6	9	0	0	9	0	0
20	15947218	.	T	C	2	3	5	0	1	6	0	0
20	15947225	.	A	G	2	3	5	0	0	5	0	0
20	15969999	.	G	A	3	3	6	0	2	8	0	0
20	15970177	.	C	T	5	11	16	0	0	16	0	0
20	15974445	.	G	A	6	4	10	0	0	10	0	0
20	16020682	.	A	G	2	8	10	0	0	10	0	0
20	16156347	.	A	G	7	4	11	0	0	11	0	0
20	16163333	.	T	C	12	0	12	0	6	18	0	0
20	16163348	.	T	C	9	9	18	0	1	19	0	0
20	16163384	.	A	G	11	11	22	0	1	23	0	0
20	16163447	.	T	C	6	0	6	0	8	14	0	0
20	16163552	.	G	A	10	8	18	0	0	18	0	0
20	16171113	.	G	C	5	0	5	0	5	10	0	0
20	16171155	.	T	C	6	0	6	0	7	13	0	0
20	16171203	.	A	T	7	4	11	0	0	11	0	0
20	16180064	.	C	A	12	15	27	0	0	27	0	0
20	16180103	.	G	T	11	12	23	0	0	23	0	0
20	16180469	.	G	A	7	5	12	0	2	14	0	0
20	16182806	.	C	T	6	7	13	0	0	13	0	0
20	16184525	.	C	T	6	12	18	0	0	18	0	0
20	16193658	.	T	C	14	13	27	0	0	27	0	0
20	16193899	.	C	T	7	11	18	0	1	19	0	0
20	16198986	.	G	A	2	11	13	0	15	28	0	0
20	16201015	.	C	A	6	6	12	3	4	19	0	0
20	16201017	.	C	T	12	6	18	3	0	21	0	0
20	16201109	.	T	A	8	7	15	1	3	19	0	0
20	16201111	.	G	A	1	9	10	2	8	20	0	0
20	16201200	.	C	T	13	11	24	2	1	27	0	0
20	16201649	.	A	C	6	12	18	0	0	18	0	0
20	16201709	.	A	G	3	3	6	0	0	6	0	0
20	16201759	.	T	C	9	6	15	0	0	15	0	0
20	16437895	.	A	G	2	7	9	0	1	10	0	0
20	16437958	.	A	G	9	5	14	0	0	14	0	0
20	16438097	.	G	A	10	8	18	0	0	18	0	0
20	16438119	.	T	A	9	8	17	0	0	17	0	0
20	16438252	.	G	A	15	9	24	0	0	24	0	0
20	16438258	.	A	T	9	11	20	0	0	20	0	0
20	16438658	.	A	T	4	8	12	0	0	12	0	0
20	16438854	.	T	C	11	6	17	0	0	17	0	0
20	16441658	.	C	T	17	9	26	0	0	26	0	0
20	16443545	.	G	A	9	10	19	0	1	20	0	0
20	16443740	.	C	T	15	20	35	1	0	36	0	0
20	16447831	.	A	G	8	13	21	0	0	21	0	0
20	16448930	.	T	C	5	7	12	0	2	14	0	0
20	16478324	.	G	A	7	6	13	0	1	14	0	0
20	16498881	.	C	T	0	6	6	0	4	10	0	0
20	16498932	.	C	A	6	6	12	0	0	12	0	0
20	16548701	.	T	C	4	0	4	0	7	11	0	0
20	16548833	.	C	T	1	5	6	0	4	10	0	0
20	16640011	.	G	A	4	5	9	0	0	9	0	0
20	16640049	.	C	T	15	8	23	0	1	24	0	0
20	16734343	.	C	T	15	13	28	0	2	30	0	0
20	16736960	.	G	A	16	14	30	0	1	31	0	0
20	16737485	.	C	T	8	16	24	0	0	24	0	0
20	16737512	.	C	T	19	10	29	0	0	29	0	0
20	16737524	.	T	C	14	22	36	0	0	36	0	0
20	16740834	.	G	A	11	14	25	0	1	26	0	0
20	16774513	.	A	T	41	25	66	0	2	68	0	0
20	16774868	.	A	G	34	25	59	3	5	67	0	0
20	16775173	.	C	T	19	25	44	0	1	45	0	0
20	16833019	.	C	T	1	8	9	0	4	13	0	0
20	16833089	.	A	G	7	9	16	0	1	17	0	0
20	16833096	.	A	G	8	8	16	0	0	16	0	0
20	16833125	.	C	T	6	7	13	1	0	14	0	0
20	16833213	.	G	C	2	8	10	0	0	10	0	0
20	16833284	.	A	T	3	6	9	0	1	10	0	0
20	16833893	.	A	G	5	2	7	0	0	7	0	0
20	16834096	.	T	C	3	4	7	0	1	8	0	0
20	16834525	.	A	G	4	4	8	0	1	9	0	0
20	16834572	.	C	T	3	6	9	0	6	15	0	0
20	16834647	.	T	C	3	6	9	0	0	9	0	0
20	16848908	.	C	T	9	13	22	0	0	22	0	0
20	16849100	.	C	A	1	8	9	0	13	22	0	0
20	17740215	.	G	A	28	16	44	0	1	45	0	0
20	17740260	.	G	C	4	8	12	0	24	36	0	0
20	17740261	.	T	C	25	7	32	0	3	35	0	0
20	17798876	.	C	T	20	20	40	0	1	41	0	0
20	17798906	.	T	C	22	18	40	0	4	44	0	0
20	17798930	.	C	T	22	21	43	0	2	45	0	0
20	17800867	.	T	C	21	27	48	0	1	49	0	0
20	17802979	.	C	T	22	17	39	0	1	40	0	0
20	17809123	.	G	A	23	25	48	0	1	49	0	0
20	17809177	.	C	T	28	27	55	0	1	56	0	0
20	17811587	.	G	A	26	25	51	0	1	52	0	0
20	17813702	.	C	T	32	29	61	1	0	62	0	0
20	17817659	.	G	T	17	18	35	0	0	35	0	0
20	17817886	.	T	A	16	14	30	0	1	31	0	0
20	17818177	.	A	C	8	17	25	0	1	26	0	0
20	17818291	.	T	C	15	10	25	0	5	30	0	0
20	17818445	.	T	A	14	20	34	0	1	35	0	0
20	18225441	.	C	A	8	8	16	0	2	18	0	0
20	18255474	.	A	G	7	0	7	0	18	25	0	0
20	18255810	.	T	C	9	20	29	0	1	30	0	0
20	18255931	.	A	T	9	14	23	0	4	27	0	0
20	18256176	.	T	A	5	5	10	0	1	11	0	0
20	18306290	.	T	A	10	10	20	0	0	20	0	0
20	18306298	.	T	G	11	9	20	0	0	20	0	0
20	18307075	.	T	C	23	0	23	0	17	40	0	0
20	18309277	.	C	T	23	14	37	0	2	39	0	0
20	18312803	.	T	C	25	22	47	0	1	48	0	0
20	18312839	.	T	C	25	15	40	0	2	42	0	0
20	18327900	.	A	T	1	2	3	0	0	3	0	0
20	18328878	.	T	A	1	2	3	0	0	3	0	0
20	18357820	.	T	C	3	9	12	0	1	13	0	0
20	18358002	.	T	C	4	8	12	0	0	12	0	0
20	18369979	.	G	A	3	10	13	0	1	14	0	0
20	18373014	.	T	G	3	2	5	0	1	6	0	0
20	18375278	.	G	A	5	4	9	0	0	9	0	0
20	18376800	.	C	T	4	9	13	0	0	13	0	0
20	18392845	.	C	T	18	15	33	0	3	36	0	0
20	18393249	.	T	C	13	16	29	0	0	29	0	0
20	18393359	.	A	T	15	12	27	0	0	27	0	0
20	18393376	.	C	T	14	11	25	0	2	27	0	0
20	18396134	.	A	G	18	21	39	0	1	40	0	0
20	18413987	.	T	C	11	0	11	0	14	25	0	0
20	18414262	.	C	T	9	12	21	0	0	21	0	0
20	18431770	.	T	C	17	0	17	0	15	32	0	0
20	18432732	.	C	T	10	9	19	0	2	21	0	0
20	18443435	.	G	A	13	7	20	0	0	20	0	0
20	18454644	.	G	A	9	5	14	0	1	15	0	0
20	18456519	.	C	A	11	11	22	0	2	24	0	0
20	18591638	.	G	T	17	23	40	3	1	44	0	0
20	18591704	.	G	A	27	20	47	0	2	49	0	0
20	18591716	.	A	C	27	19	46	0	4	50	0	0
20	18591743	.	A	T	25	18	43	0	1	44	0	0
20	18594958	.	C	A	29	16	45	0	4	49	0	0
20	18594980	.	T	A	18	27	45	0	2	47	0	0
20	18595296	.	T	G	15	0	15	0	14	29	0	0
20	18669600	.	G	A	12	7	19	0	0	19	0	0
20	18672064	.	C	T	16	22	38	0	1	39	0	0
20	18672094	.	T	C	16	16	32	0	1	33	0	0
20	18672193	.	G	A	3	11	14	0	15	29	0	0
20	18672733	.	A	T	7	18	25	0	3	28	0	0
20	18672970	.	G	A	5	15	20	0	0	20	0	0
20	18673132	.	C	T	9	15	24	0	1	25	0	0
20	18677343	.	G	A	7	15	22	0	1	23	0	0
20	18677391	.	T	G	14	1	15	0	8	23	0	0
20	18678023	.	T	C	17	10	27	0	0	27	0	0
20	18678466	.	C	T	23	12	35	0	0	35	0	0
20	18683158	.	T	C	16	16	32	0	1	33	0	0
20	18684922	.	A	T	9	16	25	0	0	25	0	0
20	18685139	.	G	A	8	9	17	0	0	17	0	0
20	18708770	.	T	C	23	28	51	0	1	52	0	0
20	18713067	.	T	C	29	25	54	0	3	57	0	0
20	18714024	.	C	T	1	3	4	0	0	4	0	0
20	18714282	.	A	G	1	0	1	0	3	4	0	0
20	18714733	.	A	G	2	4	6	0	0	6	0	0
20	18721383	.	A	T	2	2	4	0	0	4	0	0
20	18721397	.	C	T	2	2	4	0	0	4	0	0
20	18721775	.	T	G	13	6	19	0	1	20	0	0
20	18721910	.	G	A	18	10	28	0	1	29	0	0
20	18722089	.	G	C	19	9	28	0	0	28	0	0
20	18722312	.	A	C	9	20	29	0	2	31	0	0
20	18722565	.	A	T	19	23	42	0	1	43	0	0
20	18722630	.	C	T	0	6	6	0	8	14	0	0
20	18722857	.	G	A	5	7	12	0	1	13	0	0
20	18722860	.	A	T	7	5	12	0	1	13	0	0
20	18722931	.	G	A	5	5	10	0	0	10	0	0
20	18722943	.	G	A	4	4	8	0	0	8	0	0
20	18723062	.	C	T	5	9	14	0	1	15	0	0
20	18723105	.	C	T	18	8	26	0	1	27	0	0
20	18723244	.	G	T	14	7	21	0	1	22	0	0
20	18723441	.	G	A	8	14	22	0	0	22	0	0
20	18723459	.	T	C	5	12	17	0	1	18	0	0
20	18723781	.	T	G	10	14	24	0	0	24	0	0
20	18727472	.	T	C	13	18	31	0	1	32	0	0
20	18727506	.	T	C	20	14	34	0	0	34	0	0
20	18730498	.	G	A	17	10	27	0	1	28	0	0
20	18730840	.	T	C	20	12	32	0	1	33	0	0
20	18731068	.	C	T	19	14	33	0	0	33	0	0
20	18747062	.	C	A	6	3	9	0	0	9	0	0
20	18755283	.	C	T	1	2	3	0	0	3	0	0
20	18755774	.	C	T	1	3	4	0	0	4	0	0
20	18755824	.	A	C	1	2	3	0	0	3	0	0
20	18756288	.	C	T	2	2	4	0	1	5	0	0
20	18756319	.	C	T	1	2	3	0	0	3	0	0
20	18756628	.	A	G	2	2	4	0	0	4	0	0
20	18774552	.	G	A	2	2	4	0	1	5	0	0
20	18774616	.	A	G	4	2	6	0	1	7	0	0
20	18774618	.	T	C	5	2	7	0	0	7	0	0
20	18776489	.	T	G	3	8	11	0	1	12	0	0
20	18780171	.	G	A	1	4	5	0	0	5	0	0
20	18783282	.	A	G	1	4	5	0	0	5	0	0
20	18801644	.	G	A	8	4	12	0	0	12	0	0
20	18802172	.	C	A	3	2	5	0	1	6	0	0
20	18802603	.	C	T	6	4	10	0	1	11	0	0
20	18802651	.	G	A	2	6	8	0	0	8	0	0
20	18803068	.	A	G	1	4	5	0	0	5	0	0
20	18810050	.	G	A	4	5	9	0	0	9	0	0
20	18810201	.	C	T	2	3	5	0	1	6	0	0
20	18915249	.	C	T	8	2	10	0	0	10	0	0
20	18947331	.	G	A	1	13	14	1	10	26	1	0
20	18955563	.	A	T	12	12	24	0	0	24	0	0
20	18956708	.	T	A	11	13	24	0	2	26	0	0
20	18956729	.	C	T	10	17	27	0	0	27	0	0
20	18958106	.	C	G	20	10	30	0	3	33	0	0
20	18958159	.	T	C	12	14	26	0	1	27	0	0
20	18958477	.	G	A	1	15	16	0	14	30	0	0
20	18961835	.	T	C	7	15	22	0	3	25	0	0
20	18961838	.	C	T	8	18	26	0	0	26	0	0
20	18968826	.	C	T	21	13	34	0	1	35	0	0
20	18972850	.	T	A	11	17	28	0	1	29	0	0
20	18992711	.	G	A	3	8	11	0	0	11	0	0
20	18992763	.	T	C	6	12	18	0	1	19	0	0
20	18994634	.	C	T	4	8	12	0	0	12	0	0
20	18996331	.	C	T	11	4	15	0	3	18	0	0
20	18997305	.	A	G	15	12	27	0	0	27	0	0
20	18997610	.	A	G	9	15	24	0	3	27	0	0
20	18997875	.	A	G	6	9	15	0	0	15	0	0
20	19018520	.	G	A	6	7	13	0	2	15	0	0
20	19058143	.	G	A	11	8	19	0	0	19	0	0
20	19058152	.	T	G	10	7	17	0	1	18	0	0
20	19058188	.	A	G	4	9	13	0	0	13	0	0
20	19058194	.	T	C	4	9	13	0	0	13	0	0
20	19058241	.	A	C	4	5	9	0	3	12	0	0
20	19058326	.	A	G	3	4	7	0	0	7	0	0
20	19058475	.	T	G	1	3	4	0	0	4	0	0
20	19075298	.	G	A	5	5	10	0	0	10	0	0
20	19076873	.	C	T	5	4	9	0	1	10	0	0
20	19077156	.	T	C	7	8	15	0	2	17	0	0
20	19077628	.	A	G	7	6	13	0	1	14	0	0
20	19077760	.	T	C	1	3	4	1	1	6	0	0
20	19077764	.	T	A	1	2	3	1	1	5	0	0
20	19078011	.	C	A	1	1	2	0	0	3	1	0
20	19213235	.	G	A	13	5	18	1	3	22	0	0
20	19213586	.	T	A	18	12	30	0	1	31	0	0
20	19213587	.	G	C	18	11	29	0	2	31	0	0
20	19238509	.	A	T	13	13	26	0	2	28	0	0
20	19258639	.	T	C	11	13	24	0	0	24	0	0
20	19277610	.	T	A	7	2	9	0	0	9	0	0
20	19277611	.	C	G	7	2	9	0	0	9	0	0
20	19277663	.	C	T	5	3	8	0	0	8	0	0
20	19277712	.	G	T	3	2	5	0	1	6	0	0
20	19277728	.	G	A	5	3	8	0	0	8	0	0
20	19278011	.	T	A	7	3	10	0	0	10	0	0
20	19278025	.	C	T	4	2	6	0	0	6	0	0
20	19278132	.	C	T	8	4	12	0	0	12	0	0
20	19278143	.	C	T	8	3	11	0	0	11	0	0
20	19290547	.	C	T	3	5	8	0	0	8	0	0
20	19290586	.	G	A	4	11	15	0	0	15	0	0
20	19365664	.	C	T	11	5	16	0	0	16	0	0
20	19373597	.	G	A	4	3	7	0	0	7	0	0
20	19373616	.	T	C	7	2	9	0	0	9	0	0
20	19373647	.	C	T	8	8	16	0	0	16	0	0
20	19373653	.	T	A	8	7	15	0	1	16	0	0
20	19373720	.	T	C	11	0	11	0	12	23	0	0
20	19373852	.	A	G	9	7	16	0	1	17	0	0
20	19373919	.	A	G	12	10	22	0	1	23	0	0
20	19373939	.	G	A	10	13	23	0	1	24	0	0
20	19374058	.	C	T	7	4	11	0	0	11	0	0
20	19374093	.	A	T	9	4	13	0	0	13	0	0
20	19374120	.	G	T	9	3	12	0	0	12	0	0
20	19374242	.	G	T	5	3	8	0	0	8	0	0
20	19374415	.	C	T	1	8	9	0	5	14	0	0
20	19374524	.	G	A	5	3	8	0	0	8	0	0
20	19374714	.	G	A	7	5	12	0	0	12	0	0
20	19374755	.	A	G	6	8	14	0	0	14	0	0
20	19391641	.	A	G	5	11	16	0	0	16	0	0
20	19391677	.	T	A	10	9	19	0	0	19	0	0
20	19391704	.	A	G	8	5	13	0	1	14	0	0
20	19401018	.	T	C	9	5	14	0	0	14	0	0
20	19406475	.	A	G	7	5	12	0	1	13	0	0
20	19406620	.	A	G	9	12	21	0	0	21	0	0
20	19406689	.	G	A	7	7	14	0	0	14	0	0
20	19406709	.	A	C	9	6	15	0	1	16	0	0
20	19429846	.	C	T	3	5	8	0	1	9	0	0
20	19429879	.	T	C	2	4	6	0	0	6	0	0
20	19430075	.	A	G	7	0	7	0	5	12	0	0
20	19430092	.	T	C	7	5	12	0	0	12	0	0
20	19430352	.	C	A	1	7	8	0	0	8	0	0
20	19430778	.	C	A	6	13	19	0	1	20	0	0
20	19430790	.	C	T	5	13	18	0	2	20	0	0
20	19431360	.	C	A	5	3	8	0	0	8	0	0
20	19431385	.	A	G	4	7	11	0	0	11	0	0
20	19431631	.	G	C	9	6	15	0	0	15	0	0
20	19431665	.	G	A	7	5	12	0	0	12	0	0
20	19431960	.	C	G	6	5	11	0	0	11	0	0
20	19432007	.	G	T	10	3	13	0	0	13	0	0
20	19436389	.	G	C	5	7	12	0	1	13	0	0
20	19436440	.	G	A	3	7	10	0	0	10	0	0
20	19436890	.	T	C	6	0	6	0	0	6	0	0
20	19436899	.	C	A	7	12	19	0	0	19	0	0
20	19437434	.	T	C	3	0	3	0	5	8	0	0
20	19437624	.	T	C	8	0	8	0	10	18	0	0
20	19437848	.	T	C	12	0	12	0	11	23	0	0
20	19437969	.	A	G	11	5	16	0	1	17	0	0
20	19438082	.	T	G	8	5	13	1	0	14	0	0
20	19438110	.	C	A	7	6	13	1	0	14	0	0
20	19438146	.	T	C	7	0	7	1	8	16	0	0
20	19438181	.	C	T	0	4	4	0	7	11	0	0
20	19438193	.	T	A	5	4	9	0	1	10	0	0
20	19438425	.	G	A	3	7	10	0	0	10	0	0
20	19438460	.	T	G	5	9	14	0	0	14	0	0
20	19440796	.	T	C	10	10	20	0	2	22	0	0
20	19443045	.	G	T	7	9	16	0	1	17	0	0
20	19447443	.	G	A	8	8	16	0	0	16	0	0
20	19451575	.	A	G	7	3	10	0	0	10	0	0
20	19510892	.	G	C	8	8	16	0	0	16	0	0
20	19510904	.	A	G	7	9	16	0	1	17	0	0
20	19510950	.	C	A	3	8	11	0	1	12	0	0
20	19511070	.	C	A	0	6	6	0	2	8	0	0
20	19515966	.	G	T	7	7	14	0	2	16	0	0
20	19516009	.	A	G	7	5	12	0	0	12	0	0
20	19516068	.	C	T	3	11	14	0	0	14	0	0
20	19516096	.	T	A	4	10	14	1	0	15	0	0
20	19516274	.	C	A	3	3	6	0	1	7	0	0
20	19516276	.	G	A	2	4	6	0	1	7	0	0
20	19516315	.	G	C	1	3	4	0	0	4	0	0
20	19516392	.	T	C	6	9	15	0	2	17	0	0
20	19516406	.	T	G	8	0	8	0	11	19	0	0
20	19516537	.	T	C	4	6	10	0	0	10	0	0
20	19516772	.	T	C	2	4	6	0	1	7	0	0
20	19516837	.	G	A	8	8	16	0	0	16	0	0
20	19517027	.	C	G	13	9	22	0	1	23	0	0
20	19518685	.	A	G	15	16	31	0	1	32	0	0
20	19519403	.	C	G	7	14	21	0	2	24	1	0
20	19519454	.	T	G	5	9	14	0	1	15	0	0
20	19521657	.	C	T	8	12	20	0	0	20	0	0
20	19524966	.	A	G	15	17	32	0	0	32	0	0
20	19524978	.	G	A	14	17	31	0	0	31	0	0
20	19525377	.	G	T	3	2	5	0	0	5	0	0
20	19530702	.	G	A	7	13	20	0	0	20	0	0
20	19562437	.	C	T	1	4	5	0	0	5	0	0
20	19562536	.	C	A	5	5	10	0	0	10	0	0
20	19562630	.	G	T	0	7	7	0	9	16	0	0
20	19562664	.	C	A	6	9	15	0	0	15	0	0
20	19562743	.	G	T	3	13	16	0	1	17	0	0
20	19562853	.	T	A	4	12	16	0	0	16	0	0
20	19575264	.	G	A	4	12	16	0	1	17	0	0
20	19575271	.	A	G	5	10	15	0	1	16	0	0
20	19579897	.	G	A	3	3	6	0	0	6	0	0
20	19580091	.	A	T	7	8	15	0	0	15	0	0
20	19580331	.	C	T	10	7	17	0	0	17	0	0
20	19580367	.	T	A	7	4	11	0	1	12	0	0
20	19580397	.	A	G	5	5	10	0	1	11	0	0
20	19580405	.	G	A	4	4	8	0	1	9	0	0
20	19580441	.	A	G	6	4	10	0	0	10	0	0
20	19580525	.	C	A	13	8	21	0	1	22	0	0
20	19580584	.	T	C	20	1	21	0	14	35	0	0
20	19793708	.	A	G	6	2	8	0	0	8	0	0
20	19793727	.	A	G	7	3	10	0	0	10	0	0
20	19793745	.	A	T	6	3	9	0	0	9	0	0
20	19793999	.	T	G	2	2	4	0	0	4	0	0
20	19819252	.	G	A	0	5	5	0	1	6	0	0
20	19821817	.	T	C	2	3	5	0	0	5	0	0
20	19821886	.	C	T	2	3	5	0	0	5	0	0
20	19822153	.	G	A	1	2	3	0	4	7	0	0
20	19822347	.	A	G	3	0	3	0	6	9	0	0
20	19822442	.	A	G	3	0	3	0	5	8	0	0
20	19822537	.	T	C	3	3	6	0	0	6	0	0
20	19822603	.	G	C	3	4	7	0	0	7	0	0
20	19822612	.	C	T	3	3	6	0	0	6	0	0
20	19823472	.	C	T	3	2	5	0	0	5	0	0
20	19823518	.	A	G	2	4	6	0	0	6	0	0
20	19823859	.	A	G	1	6	7	0	0	7	0	0
20	20019303	.	G	A	1	2	3	0	1	4	0	0
20	20027001	.	C	T	2	3	5	0	0	5	0	0
20	20231995	.	G	C	13	12	25	0	0	25	0	0
20	20232347	.	A	T	13	9	22	0	0	22	0	0
20	20232456	.	G	T	18	8	26	0	0	26	0	0
20	20269729	.	C	T	9	7	16	0	0	16	0	0
20	20269835	.	T	A	11	11	22	0	1	23	0	0
20	20269836	.	T	C	12	12	24	0	0	24	0	0
20	20270109	.	G	T	11	4	15	0	0	15	0	0
20	20270173	.	G	T	5	4	9	0	0	9	0	0
20	20275088	.	G	A	4	4	8	0	0	8	0	0
20	20275095	.	A	T	4	3	7	0	2	9	0	0
20	20275193	.	A	T	9	9	18	0	2	20	0	0
20	20275196	.	C	A	10	10	20	0	0	20	0	0
20	20275306	.	C	T	6	15	21	0	0	21	0	0
20	20275322	.	T	A	9	14	23	0	0	23	0	0
20	20275434	.	T	A	17	9	26	0	0	26	0	0
20	20275455	.	C	T	20	9	29	0	0	29	0	0
20	20275661	.	C	T	3	11	14	0	20	34	0	0
20	20275674	.	A	G	18	9	27	0	3	30	0	0
20	20275766	.	T	G	11	14	25	0	3	28	0	0
20	20275776	.	T	C	12	1	13	0	17	30	0	0
20	20312109	.	T	C	7	5	12	0	1	13	0	0
20	20312278	.	G	A	6	9	15	0	0	15	0	0
20	20312408	.	A	T	6	3	9	0	1	10	0	0
20	20328055	.	A	G	27	11	38	0	7	45	0	0
20	20328137	.	G	A	36	25	61	0	0	61	0	0
20	20330095	.	C	A	29	22	51	0	2	53	0	0
20	20330256	.	T	C	26	23	49	0	0	49	0	0
20	20331235	.	T	A	21	32	53	0	2	55	0	0
20	20331740	.	A	G	26	15	41	0	2	43	0	0
20	20332079	.	G	A	18	27	45	1	0	46	0	0
20	20334705	.	G	A	19	22	41	0	1	42	0	0
20	20335543	.	A	G	18	12	30	0	0	30	0	0
20	20335739	.	G	C	20	13	33	0	1	34	0	0
20	20335784	.	A	T	21	15	36	0	2	38	0	0
20	20337215	.	G	A	17	20	37	0	3	40	0	0
20	20337263	.	A	C	17	18	35	0	0	35	0	0
20	20338509	.	A	G	15	23	38	0	1	39	0	0
20	20338569	.	C	T	16	11	27	0	0	27	0	0
20	20601233	.	C	G	11	7	18	0	1	19	0	0
20	20601651	.	T	G	11	10	21	0	2	23	0	0
20	20601883	.	A	T	14	16	30	0	2	32	0	0
20	20601884	.	A	C	16	14	30	0	3	33	0	0
20	20601985	.	T	C	16	9	25	1	2	28	0	0
20	20602097	.	A	T	7	11	18	0	0	18	0	0
20	20602167	.	T	C	3	4	7	0	0	7	0	0
20	20602187	.	T	C	4	5	9	0	0	9	0	0
20	20602259	.	T	C	14	4	18	1	2	21	0	0
20	20602290	.	G	T	6	9	15	0	1	16	0	0
20	20602370	.	A	T	9	8	17	0	2	20	1	0
20	20603131	.	T	A	8	12	20	0	2	22	0	0
20	20603389	.	T	G	4	3	7	0	0	7	0	0
20	20603906	.	G	A	2	5	7	0	0	7	0	0
20	20604015	.	T	G	1	3	4	0	0	4	0	0
20	20605071	.	T	C	4	7	11	0	0	11	0	0
20	20605136	.	T	C	6	9	15	0	0	15	0	0
20	20605223	.	T	C	5	2	7	0	0	7	0	0
20	20609663	.	G	A	7	11	18	0	1	19	0	0
20	20609735	.	G	C	9	0	9	0	8	17	0	0
20	20611040	.	C	G	6	6	12	0	0	12	0	0
20	20655141	.	G	C	19	11	30	0	2	32	0	0
20	20655142	.	T	C	20	12	32	0	0	32	0	0
20	20655339	.	A	T	11	22	33	0	6	39	0	0
20	20655357	.	G	A	3	23	26	0	14	40	0	0
20	20655394	.	C	G	15	0	15	0	20	35	0	0
20	20658851	.	G	T	20	18	38	0	1	39	0	0
20	20658954	.	C	T	10	24	34	0	1	35	0	0
20	20659009	.	T	C	19	19	38	0	2	40	0	0
20	20659067	.	G	A	20	27	47	0	1	48	0	0
20	20659188	.	C	G	19	16	35	0	1	36	0	0
20	20659305	.	T	C	26	17	43	0	0	43	0	0
20	20659306	.	C	T	25	14	39	0	4	43	0	0
20	20672289	.	T	C	36	29	65	0	1	66	0	0
20	20672335	.	C	T	30	30	60	5	3	68	0	0
20	20693557	.	G	A	2	2	4	0	0	4	0	0
20	20694918	.	A	T	39	29	68	0	5	73	0	0
20	20694999	.	C	T	15	19	34	0	6	41	1	0
20	20695642	.	G	T	3	29	32	0	32	64	0	0
20	20695779	.	T	A	29	20	49	1	5	55	0	0
20	20695829	.	A	T	25	26	51	0	1	52	0	0
20	20695856	.	A	T	21	23	44	0	1	45	0	0
20	20713640	.	T	A	2	2	4	0	0	4	0	0
20	20722032	.	T	C	2	5	7	0	0	7	0	0
20	20722071	.	A	G	3	5	8	0	0	8	0	0
20	20726287	.	G	T	28	31	59	0	1	61	1	0
20	20726291	.	G	A	3	28	31	0	32	63	0	0
20	20726966	.	T	C	31	33	64	0	3	67	0	0
20	20726993	.	C	A	32	30	62	0	3	65	0	0
20	20729975	.	C	T	29	28	57	0	3	60	0	0
20	20730061	.	C	G	12	23	35	0	4	39	0	0
20	20731663	.	A	G	6	12	18	0	0	18	0	0
20	20731706	.	G	A	5	7	12	0	1	13	0	0
20	20793358	.	G	A	8	12	20	0	0	20	0	0
20	20802754	.	C	A	12	27	39	0	2	41	0	0
20	20805250	.	T	G	5	0	5	0	11	16	0	0
20	20805438	.	T	C	10	22	32	0	2	34	0	0
20	20805643	.	G	C	0	18	18	0	9	27	0	0
20	20805690	.	C	T	9	17	26	0	0	26	0	0
20	20808044	.	C	A	8	14	22	0	0	22	0	0
20	20809666	.	T	C	10	13	23	0	3	26	0	0
20	20809702	.	T	C	10	20	30	0	1	31	0	0
20	20812680	.	C	T	10	29	39	0	2	41	0	0
20	20812728	.	T	C	14	28	42	0	0	42	0	0
20	20812898	.	T	C	10	18	28	0	1	29	0	0
20	20813116	.	A	T	18	17	35	0	0	35	0	0
20	20813162	.	T	C	14	23	37	0	2	39	0	0
20	20813197	.	A	C	14	27	41	0	3	44	0	0
20	20813270	.	C	T	11	26	37	0	1	38	0	0
20	20813336	.	T	C	13	24	37	0	1	38	0	0
20	20813460	.	C	T	7	22	29	0	0	29	0	0
20	20813568	.	A	C	12	15	27	1	0	28	0	0
20	20813731	.	T	C	1	3	4	0	0	4	0	0
20	20817263	.	A	G	35	37	72	0	2	74	0	0
20	20817921	.	A	G	47	29	76	0	9	85	0	0
20	20899424	.	A	T	3	4	7	0	0	7	0	0
20	20902553	.	A	G	2	2	4	0	0	4	0	0
20	20927973	.	A	C	3	0	3	1	6	10	0	0
20	20928239	.	C	G	2	14	16	0	14	30	0	0
20	20928536	.	G	A	22	9	31	0	0	31	0	0
20	20928932	.	A	G	15	8	23	0	0	23	0	0
20	20929166	.	G	A	14	17	31	0	1	32	0	0
20	20931142	.	C	G	10	13	23	0	0	23	0	0
20	20948025	.	A	G	2	3	5	0	1	6	0	0
20	20974065	.	T	C	4	9	13	0	1	14	0	0
20	20974071	.	T	G	6	10	16	0	0	16	0	0
20	20978278	.	G	A	4	5	9	0	0	9	0	0
20	21008381	.	G	A	2	9	11	0	0	11	0	0
20	21008471	.	T	A	9	9	18	0	0	18	0	0
20	21015748	.	G	A	1	8	9	0	0	9	0	0
20	21016348	.	C	T	2	6	8	0	0	8	0	0
20	21016575	.	G	A	1	2	3	0	0	3	0	0
20	21269081	.	T	C	16	4	20	0	0	20	0	0
20	21330448	.	G	A	6	12	18	0	0	18	0	0
20	21341814	.	T	C	4	4	8	0	0	8	0	0
20	21341865	.	A	C	3	3	6	0	0	6	0	0
20	21342050	.	T	C	1	2	3	0	0	3	0	0
20	21392135	.	C	T	6	2	8	0	0	8	0	0
20	21453861	.	C	T	6	7	13	0	0	13	0	0
20	21455216	.	T	C	9	7	16	0	1	17	0	0
20	21465782	.	A	G	3	1	4	0	3	7	0	0
20	21469759	.	G	C	6	7	13	0	0	13	0	0
20	21473681	.	T	C	9	14	23	0	0	23	0	0
20	21474159	.	T	C	12	8	20	0	0	20	0	0
20	21474185	.	C	T	7	7	14	0	2	16	0	0
20	21474664	.	A	G	9	0	9	1	6	16	0	0
20	21474700	.	A	G	8	4	12	1	0	13	0	0
20	21474715	.	A	C	6	3	9	1	1	11	0	0
20	21601079	.	G	T	3	3	6	0	0	6	0	0
20	21638431	.	C	A	2	4	6	0	0	6	0	0
20	21638575	.	T	C	3	3	6	0	0	6	0	0
20	21639637	.	G	T	1	2	3	0	0	3	0	0
20	21815659	.	G	T	13	10	23	0	0	23	0	0
20	21815986	.	C	T	1	11	12	0	15	27	0	0
20	21816061	.	C	G	16	11	27	0	1	28	0	0
20	21819062	.	T	C	20	16	36	0	0	36	0	0
20	21828117	.	T	C	9	8	17	0	2	19	0	0
20	21839504	.	G	A	9	8	17	0	0	17	0	0
20	21841312	.	G	A	21	15	36	0	0	36	0	0
20	21841316	.	G	T	19	14	33	0	1	34	0	0
20	21855195	.	T	C	13	8	21	0	1	22	0	0
20	21862963	.	C	T	4	15	19	0	12	31	0	0
20	21862975	.	C	T	4	10	14	0	17	31	0	0
20	21872945	.	A	G	14	7	21	0	1	22	0	0
20	21872990	.	G	A	10	6	16	0	2	18	0	0
20	21875111	.	G	A	17	9	26	0	2	28	0	0
20	21875162	.	G	A	15	8	23	0	1	24	0	0
20	21875165	.	T	G	16	9	25	0	0	25	0	0
20	21875411	.	C	A	13	9	22	0	2	24	0	0
20	21910005	.	C	T	2	14	16	0	14	30	0	0
20	22045209	.	C	T	5	3	8	0	0	8	0	0
20	22045260	.	A	C	8	5	13	0	0	13	0	0
20	22061949	.	C	T	2	3	5	1	0	6	0	0
20	22147798	.	T	C	2	2	4	0	0	4	0	0
20	22160859	.	T	A	5	2	7	0	0	7	0	0
20	22163667	.	T	C	3	10	13	0	1	14	0	0
20	22166199	.	G	A	5	8	13	0	0	13	0	0
20	22166512	.	A	G	5	9	14	0	0	14	0	0
20	22168567	.	C	T	9	3	12	0	1	13	0	0
20	22175326	.	G	A	6	5	11	0	0	11	0	0
20	22175457	.	C	A	2	3	5	0	1	6	0	0
20	22175625	.	T	C	10	5	15	0	0	15	0	0
20	22175815	.	T	C	6	3	9	0	0	9	0	0
20	22175830	.	G	A	5	3	8	0	1	9	0	0
20	22175906	.	T	G	3	3	6	0	0	6	0	0
20	22175928	.	C	T	3	5	8	0	0	8	0	0
20	22179962	.	T	A	11	10	21	0	0	21	0	0
20	22186632	.	G	A	9	5	14	0	1	15	0	0
20	22186738	.	G	A	15	5	20	0	0	20	0	0
20	22186765	.	C	G	12	8	20	0	1	21	0	0
20	22186886	.	A	G	7	9	16	0	0	16	0	0
20	22186914	.	A	G	7	7	14	0	0	14	0	0
20	22186971	.	C	T	6	14	20	0	1	21	0	0
20	22186973	.	C	T	7	13	20	0	1	21	0	0
20	22187233	.	T	C	8	14	22	0	2	24	0	0
20	22191361	.	A	T	18	10	28	0	0	28	0	0
20	22191376	.	A	G	21	8	29	0	1	30	0	0
20	22191493	.	T	C	12	0	12	0	6	18	0	0
20	22193013	.	C	A	2	10	12	0	6	18	0	0
20	22194285	.	C	T	2	4	6	0	6	12	0	0
20	22194385	.	A	T	8	3	11	0	0	11	0	0
20	22194395	.	G	A	8	3	11	0	0	11	0	0
20	22198957	.	C	A	5	3	8	0	1	9	0	0
20	22336000	.	G	A	1	2	3	0	0	3	0	0
20	22349592	.	C	A	1	2	3	0	1	4	0	0
20	22350144	.	G	A	2	2	4	0	0	4	0	0
20	22435548	.	C	T	2	2	4	0	0	4	0	0
20	22435550	.	T	C	2	2	4	0	0	4	0	0
20	22435789	.	G	A	1	2	3	0	1	4	0	0
20	22483771	.	T	C	2	3	5	0	0	5	0	0
20	22484279	.	A	G	2	3	5	0	0	5	0	0
20	22709685	.	T	A	16	17	33	0	4	37	0	0
20	22720443	.	A	G	11	22	33	0	1	34	0	0
20	22730689	.	C	G	17	16	33	0	3	36	0	0
20	22734145	.	C	A	21	23	44	0	1	45	0	0
20	22736625	.	T	C	22	22	44	0	1	45	0	0
20	22739946	.	C	A	31	16	47	0	2	49	0	0
20	22739985	.	T	C	29	18	47	0	4	51	0	0
20	22740056	.	C	T	26	14	40	0	1	41	0	0
20	22740140	.	C	T	21	15	36	0	2	38	0	0
20	22740230	.	A	G	19	22	41	0	4	45	0	0
20	22740567	.	A	G	17	3	20	0	21	41	0	0
20	22800465	.	T	C	1	2	3	0	0	3	0	0
20	22800759	.	G	A	3	2	5	0	1	6	0	0
20	22843640	.	A	G	3	2	5	0	0	5	0	0
20	22907915	.	C	T	4	5	9	0	0	9	0	0
20	22987760	.	C	T	4	3	7	0	0	7	0	0
20	23007497	.	G	A	3	6	9	0	0	9	0	0
20	23007547	.	G	A	5	9	14	0	0	14	0	0
20	23017227	.	T	C	1	4	5	0	0	5	0	0
20	23021287	.	G	T	1	3	4	0	1	5	0	0
20	23021292	.	A	T	2	5	7	0	0	7	0	0
20	23023364	.	G	A	6	4	10	0	0	10	0	0
20	23023471	.	C	T	9	10	19	0	1	20	0	0
20	23023482	.	A	G	9	9	18	0	0	18	0	0
20	23023623	.	G	A	7	11	18	0	0	18	0	0
20	23023641	.	A	G	8	8	16	0	1	17	0	0
20	23023670	.	T	C	7	0	7	0	13	20	0	0
20	23023835	.	A	G	12	4	16	0	1	17	0	0
20	23024096	.	G	A	6	3	9	0	0	9	0	0
20	23175425	.	A	G	12	18	30	1	2	33	0	0
20	23177734	.	G	A	17	11	28	0	5	33	0	0
20	23179786	.	C	T	24	18	42	0	0	42	0	0
20	23181718	.	A	G	15	22	37	0	3	40	0	0
20	23205004	.	G	A	11	11	22	0	0	22	0	0
20	23205831	.	A	C	7	0	7	0	10	17	0	0
20	23205868	.	T	C	14	17	31	0	1	32	0	0
20	23205879	.	G	A	16	15	31	0	2	33	0	0
20	23215901	.	C	T	4	16	20	0	0	20	0	0
20	23215949	.	C	T	20	13	33	0	1	34	0	0
20	23245866	.	T	A	6	4	10	0	1	11	0	0
20	23246105	.	G	A	3	4	7	0	0	7	0	0
20	23246215	.	G	A	3	6	9	0	0	9	0	0
20	23248572	.	G	A	11	8	19	0	1	20	0	0
20	23250491	.	A	C	20	1	21	0	9	30	0	0
20	23250690	.	C	A	2	9	11	0	3	14	0	0
20	23332591	.	G	T	0	3	3	0	2	5	0	0
20	23360243	.	C	T	4	2	6	0	1	7	0	0
20	23366580	.	T	C	9	4	13	0	0	13	0	0
20	23372087	.	C	T	3	2	5	0	1	6	0	0
20	23372290	.	T	C	8	5	13	0	0	13	0	0
20	23376396	.	T	A	5	6	11	0	0	11	0	0
20	23377161	.	T	C	5	4	9	1	1	11	0	0
20	23378401	.	G	A	8	3	11	0	1	12	0	0
20	23378434	.	A	T	5	7	12	0	0	12	0	0
20	23378899	.	G	A	1	8	9	0	7	16	0	0
20	23382695	.	T	A	10	7	17	0	0	17	0	0
20	23385556	.	G	A	9	7	16	0	0	16	0	0
20	23385790	.	G	A	6	5	11	0	0	11	0	0
20	23387619	.	G	A	0	6	6	0	6	12	0	0
20	23389772	.	T	C	12	4	16	0	1	17	0	0
20	23389793	.	A	G	8	0	8	0	6	14	0	0
20	23390621	.	G	A	0	4	4	0	5	9	0	0
20	23390798	.	C	T	7	9	16	0	0	16	0	0
20	23395376	.	T	A	3	2	5	0	15	21	1	0
20	23395404	.	C	T	7	10	17	0	7	24	0	0
20	23406545	.	T	A	16	12	28	0	0	28	0	0
20	23408734	.	T	C	14	12	26	0	0	26	0	0
20	23418228	.	G	A	17	19	36	0	1	37	0	0
20	23418291	.	C	G	18	14	32	0	0	32	0	0
20	23420784	.	A	T	18	15	33	0	1	34	0	0
20	23421442	.	T	C	6	16	22	2	4	28	0	0
20	23421695	.	T	C	12	23	35	0	1	36	0	0
20	23422061	.	T	C	16	19	35	0	0	35	0	0
20	23422205	.	A	T	17	8	25	0	0	25	0	0
20	23431658	.	T	A	2	2	4	0	0	4	0	0
20	23446854	.	C	T	6	8	14	1	0	15	0	0
20	23446868	.	T	A	4	5	9	1	4	14	0	0
20	23446925	.	C	T	6	12	18	0	1	19	0	0
20	23447224	.	T	C	6	0	6	0	5	11	0	0
20	23447467	.	A	T	5	3	8	0	0	8	0	0
20	23447564	.	C	G	11	15	26	0	2	28	0	0
20	23447873	.	C	G	12	13	25	0	1	26	0	0
20	23471859	.	C	A	4	7	11	0	1	12	0	0
20	23471985	.	G	A	4	9	13	0	2	15	0	0
20	23472036	.	C	T	7	3	10	0	0	10	0	0
20	23472039	.	C	T	4	6	10	0	1	11	0	0
20	23472186	.	T	C	9	4	13	0	1	14	0	0
20	23472239	.	C	T	0	6	6	0	13	19	0	0
20	23472259	.	G	T	12	8	20	0	0	20	0	0
20	23475653	.	G	C	4	4	8	0	0	8	0	0
20	23478231	.	C	T	6	2	8	0	0	8	0	0
20	23479857	.	C	T	0	5	5	0	2	7	0	0
20	23488136	.	T	A	1	4	5	0	0	5	0	0
20	23488530	.	G	A	2	3	5	0	0	5	0	0
20	23491758	.	C	T	3	2	5	0	0	5	0	0
20	23491899	.	C	A	3	3	6	0	0	6	0	0
20	23491902	.	A	G	3	3	6	0	0	6	0	0
20	23494596	.	G	A	2	1	3	0	1	4	0	0
20	23621696	.	A	G	1	0	1	0	5	6	0	0
20	23621914	.	G	A	0	4	4	0	4	8	0	0
20	23637561	.	G	A	5	2	7	0	0	7	0	0
20	23643495	.	T	C	3	2	5	0	0	5	0	0
20	23647541	.	C	T	3	2	5	0	0	5	0	0
20	23648092	.	T	C	1	2	3	0	0	3	0	0
20	23648235	.	T	A	4	2	6	0	0	6	0	0
20	23648828	.	G	A	5	2	7	0	1	8	0	0
20	23651156	.	C	A	2	5	7	0	0	7	0	0
20	23651254	.	G	A	6	3	9	0	1	10	0	0
20	23651503	.	T	C	2	0	2	0	13	15	0	0
20	23655749	.	A	T	5	7	12	0	0	12	0	0
20	23655767	.	C	T	7	4	11	0	0	11	0	0
20	23656226	.	T	A	4	7	11	0	0	11	0	0
20	23656454	.	A	G	5	6	11	0	0	11	0	0
20	23658812	.	G	C	7	2	9	0	0	9	0	0
20	23658868	.	G	A	2	3	5	0	1	6	0	0
20	23664970	.	G	A	0	2	2	0	5	7	0	0
20	23665041	.	G	A	0	2	2	0	5	7	0	0
20	23665086	.	C	T	2	3	5	0	0	5	0	0
20	23665185	.	A	T	6	4	10	0	1	11	0	0
20	23665455	.	T	A	2	5	7	0	1	8	0	0
20	23665793	.	G	T	0	8	8	0	4	12	0	0
20	23665863	.	G	A	0	7	7	0	10	17	0	0
20	23666055	.	T	A	3	6	9	0	0	9	0	0
20	23666135	.	G	A	5	4	9	0	0	9	0	0
20	23666137	.	G	T	4	3	7	0	0	7	0	0
20	23674215	.	T	A	1	4	5	0	0	5	0	0
20	23685062	.	G	A	2	3	5	0	1	6	0	0
20	23685106	.	A	T	3	5	8	0	1	9	0	0
20	23685259	.	G	T	2	7	9	0	1	10	0	0
20	23685270	.	T	A	8	2	10	0	0	10	0	0
20	23685529	.	T	A	6	9	15	0	0	15	0	0
20	23689192	.	G	A	3	5	8	0	1	9	0	0
20	23689902	.	T	C	5	4	9	0	1	10	0	0
20	23689933	.	G	C	5	3	8	0	1	9	0	0
20	23689996	.	G	A	5	8	13	0	0	13	0	0
20	23690051	.	A	T	2	3	5	0	0	5	0	0
20	23690077	.	C	A	1	2	3	0	1	4	0	0
20	23691015	.	G	A	2	4	6	0	1	7	0	0
20	23691059	.	A	G	4	0	4	0	3	7	0	0
20	23691911	.	T	C	8	6	14	0	0	14	0	0
20	23691917	.	C	T	9	6	15	0	0	15	0	0
20	23692094	.	T	C	15	6	21	0	0	21	0	0
20	23694005	.	C	T	2	6	8	1	1	10	0	0
20	23694299	.	G	T	0	8	8	0	7	15	0	0
20	23705719	.	G	A	6	6	12	0	0	12	0	0
20	23705974	.	G	A	5	6	11	0	0	11	0	0
20	23713122	.	G	A	2	10	12	0	3	15	0	0
20	23713197	.	A	G	8	1	9	0	3	12	0	0
20	23713475	.	T	A	5	2	7	0	0	7	0	0
20	23713497	.	G	T	4	3	7	0	0	7	0	0
20	23713512	.	A	T	5	2	7	0	0	7	0	0
20	23713535	.	A	G	5	3	8	0	0	8	0	0
20	23713763	.	G	A	2	4	6	0	0	6	0	0
20	23713824	.	A	G	5	6	11	0	1	12	0	0
20	23713858	.	T	G	2	1	3	0	6	9	0	0
20	23713883	.	A	G	1	0	1	0	7	8	0	0
20	23742684	.	T	C	3	9	12	0	0	12	0	0
20	23742692	.	G	A	2	7	9	0	0	9	0	0
20	23746672	.	G	A	0	4	4	1	2	7	0	0
20	23746831	.	G	A	0	4	4	0	2	6	0	0
20	23746966	.	C	G	4	0	4	0	4	8	0	0
20	23747107	.	G	C	0	4	4	0	3	7	0	0
20	23747167	.	A	G	4	8	12	0	1	13	0	0
20	23796406	.	T	C	4	4	8	0	0	8	0	0
20	23797195	.	T	C	5	5	10	0	0	10	0	0
20	23801024	.	C	T	2	2	4	0	0	4	0	0
20	23801069	.	G	T	0	7	7	0	3	10	0	0
20	23801255	.	G	C	2	7	9	0	6	15	0	0
20	23828102	.	G	T	8	6	14	0	1	15	0	0
20	23829131	.	A	G	4	3	7	0	1	8	0	0
20	23829161	.	A	G	7	0	7	0	5	12	0	0
20	23829170	.	C	T	4	7	11	0	0	11	0	0
20	23829413	.	A	G	6	0	6	0	4	10	0	0
20	23832884	.	G	C	8	6	14	0	0	14	0	0
20	23833193	.	G	T	5	5	10	0	0	10	0	0
20	23835228	.	C	T	4	6	10	0	0	10	0	0
20	23835472	.	C	T	10	8	18	0	0	18	0	0
20	23835549	.	C	A	6	2	8	0	0	8	0	0
20	23835591	.	G	T	5	5	10	0	0	10	0	0
20	23835988	.	C	A	2	3	5	0	0	5	0	0
20	23836009	.	G	T	1	2	3	0	0	3	0	0
20	23836037	.	G	A	0	3	3	0	1	4	0	0
20	23836106	.	A	T	9	4	13	0	0	13	0	0
20	23836161	.	C	T	7	5	12	0	0	12	0	0
20	23836310	.	A	T	4	4	8	0	1	9	0	0
20	23836474	.	T	C	1	3	4	0	0	4	0	0
20	23836685	.	A	T	4	7	11	0	0	11	0	0
20	23836688	.	C	A	8	4	12	0	0	12	0	0
20	23836756	.	G	A	1	6	7	0	6	13	0	0
20	23836880	.	C	T	3	3	6	0	0	6	0	0
20	23836915	.	A	G	1	0	1	0	2	3	0	0
20	23856274	.	T	A	14	7	21	0	1	22	0	0
20	23856345	.	A	T	13	18	31	0	0	31	0	0
20	23857214	.	G	C	17	22	39	0	3	42	0	0
20	23857407	.	C	A	26	14	40	0	0	40	0	0
20	23857559	.	G	A	8	20	28	0	3	31	0	0
20	23857592	.	C	T	14	17	31	0	1	32	0	0
20	23859383	.	G	C	16	12	28	0	1	29	0	0
20	23859386	.	A	G	15	11	26	0	2	28	0	0
20	23859425	.	G	A	1	11	12	0	19	31	0	0
20	23859458	.	A	G	21	14	35	0	2	37	0	0
20	23859486	.	G	A	1	17	18	0	22	40	0	0
20	23877623	.	G	A	1	3	4	0	0	4	0	0
20	23879673	.	C	T	6	4	10	0	0	10	0	0
20	23879879	.	G	T	11	7	18	0	2	20	0	0
20	23879903	.	C	A	9	9	18	0	0	18	0	0
20	23881731	.	C	G	12	7	19	0	0	19	0	0
20	23882437	.	C	T	9	6	15	0	0	15	0	0
20	23883008	.	T	C	5	6	11	0	0	11	0	0
20	23883351	.	T	A	9	3	12	0	2	14	0	0
20	23883599	.	T	C	8	11	19	0	1	20	0	0
20	23884479	.	T	C	9	1	10	0	12	22	0	0
20	23885402	.	T	A	9	6	15	0	1	16	0	0
20	23885485	.	T	A	9	11	20	0	0	20	0	0
20	23885505	.	C	T	0	8	8	0	9	17	0	0
20	23885925	.	G	A	9	5	14	0	2	16	0	0
20	23886277	.	A	G	8	12	20	0	0	20	0	0
20	23886358	.	A	G	10	9	19	0	0	19	0	0
20	23888353	.	G	A	1	4	5	0	0	5	0	0
20	23888878	.	C	G	3	4	7	0	0	7	0	0
20	23889403	.	T	G	6	5	11	0	0	11	0	0
20	23890306	.	T	C	5	3	8	0	1	9	0	0
20	23890307	.	C	T	5	2	7	0	1	8	0	0
20	23890376	.	C	T	1	4	5	0	4	9	0	0
20	23890478	.	C	T	5	4	9	0	0	9	0	0
20	23890489	.	C	T	7	4	11	0	0	11	0	0
20	23891746	.	G	T	2	3	5	0	0	5	0	0
20	23892006	.	G	A	7	5	12	0	0	12	0	0
20	23892027	.	C	T	0	5	5	0	4	9	0	0
20	23892059	.	G	A	5	4	9	0	0	9	0	0
20	23892279	.	T	C	2	3	5	0	0	5	0	0
20	23892282	.	A	G	2	3	5	0	0	5	0	0
20	23894213	.	G	A	1	2	3	0	0	3	0	0
20	23897315	.	G	A	1	3	4	0	0	4	0	0
20	23897600	.	T	C	1	4	5	0	0	5	0	0
20	23898394	.	C	T	2	4	6	0	0	6	0	0
20	23898417	.	G	C	2	2	4	0	0	4	0	0
20	23898616	.	A	G	2	2	4	0	0	4	0	0
20	23898904	.	C	G	2	3	5	0	0	5	0	0
20	23899009	.	T	C	3	3	6	0	0	6	0	0
20	23903896	.	A	G	3	5	8	0	0	8	0	0
20	23904152	.	G	T	1	3	4	0	1	5	0	0
20	23905799	.	A	G	2	2	4	0	0	4	0	0
20	23906389	.	G	A	2	3	5	0	0	5	0	0
20	23909865	.	T	C	2	2	4	0	0	4	0	0
20	23919933	.	C	G	3	3	6	0	0	6	0	0
20	23919951	.	C	T	2	3	5	0	0	5	0	0
20	23930636	.	G	A	1	3	4	0	0	4	0	0
20	23950624	.	A	G	2	6	8	0	1	9	0	0
20	23951203	.	C	A	1	4	5	0	0	5	0	0
20	23951412	.	C	T	2	3	5	0	0	5	0	0
20	23951778	.	T	C	1	4	5	0	0	5	0	0
20	23952169	.	A	G	2	4	6	0	0	6	0	0
20	23952198	.	T	A	2	3	5	0	0	5	0	0
20	23952628	.	T	C	4	2	6	0	1	7	0	0
20	23952632	.	A	C	6	2	8	0	0	8	0	0
20	23953026	.	G	C	1	5	6	0	0	6	0	0
20	23953822	.	A	G	1	2	3	0	0	3	0	0
20	23954847	.	G	A	0	2	2	0	1	3	0	0
20	23955171	.	G	T	4	6	10	0	0	10	0	0
20	23955237	.	C	G	4	4	8	0	0	8	0	0
20	23955384	.	A	T	5	2	7	0	0	7	0	0
20	23972997	.	C	T	2	8	10	0	11	21	0	0
20	23973358	.	T	C	4	2	6	0	0	6	0	0
20	23973433	.	T	C	10	4	14	0	0	14	0	0
20	23974755	.	G	A	8	4	12	0	0	12	0	0
20	23974834	.	T	C	6	5	11	0	1	12	0	0
20	23974953	.	T	G	11	8	19	0	2	21	0	0
20	23975055	.	T	C	5	0	5	0	7	12	0	0
20	23978159	.	G	C	1	3	4	0	0	4	0	0
20	24122740	.	G	C	7	10	17	0	1	18	0	0
20	24151599	.	C	T	0	7	7	0	9	16	0	0
20	24152098	.	G	A	5	6	11	0	0	11	0	0
20	24152821	.	G	A	14	13	27	0	2	29	0	0
20	24152822	.	G	A	14	12	26	0	1	27	0	0
20	24175892	.	A	G	5	6	11	0	1	12	0	0
20	24180690	.	C	T	4	4	8	0	1	9	0	0
20	24182980	.	C	T	3	2	5	0	2	7	0	0
20	24183288	.	G	A	7	10	17	0	0	17	0	0
20	24818922	.	T	C	13	14	27	1	0	28	0	0
20	24819091	.	A	G	12	6	18	0	0	18	0	0
20	24819152	.	C	G	5	2	7	0	5	12	0	0
20	24819184	.	G	A	1	4	5	0	4	9	0	0
20	24819403	.	T	A	3	3	6	0	0	6	0	0
20	24819582	.	C	T	3	12	15	0	7	22	0	0
20	24819858	.	T	C	2	5	7	0	0	7	0	0
20	24820032	.	T	C	6	4	10	0	0	10	0	0
20	24820353	.	A	T	6	5	11	0	2	13	0	0
20	24820383	.	T	C	4	8	12	0	3	15	0	0
20	24820405	.	G	A	9	6	15	0	0	15	0	0
20	24820672	.	A	C	5	4	9	0	0	9	0	0
20	24820677	.	C	A	4	3	7	0	0	7	0	0
20	24820963	.	T	A	12	7	19	0	0	19	0	0
20	24821023	.	T	G	16	10	26	0	0	26	0	0
20	24821072	.	A	G	15	10	25	0	0	25	0	0
20	24821499	.	T	G	8	6	14	0	1	15	0	0
20	24835754	.	C	T	0	4	4	0	8	12	0	0
20	24841646	.	G	A	11	5	16	0	1	17	0	0
20	24849372	.	G	A	6	6	12	0	0	12	0	0
20	24849453	.	C	T	1	9	10	0	7	17	0	0
20	24852707	.	C	T	0	6	6	0	3	9	0	0
20	24856399	.	C	T	2	10	12	0	1	13	0	0
20	24915538	.	G	A	4	8	12	0	0	12	0	0
20	24915591	.	T	C	9	0	9	0	7	16	0	0
20	24915763	.	T	G	9	2	11	0	2	13	0	0
20	25271367	.	A	G	1	3	4	0	0	4	0	0
20	25271444	.	C	A	1	2	3	0	0	3	0	0
20	25271776	.	T	A	1	2	3	0	0	3	0	0
20	25342164	.	C	T	4	7	11	0	0	11	0	0
20	25342721	.	C	T	4	6	10	0	0	10	0	0
20	25342837	.	G	A	0	9	9	0	5	14	0	0
20	25371869	.	A	G	4	3	7	0	0	7	0	0
20	25371914	.	C	T	0	2	2	0	1	3	0	0
20	25372057	.	A	G	3	5	8	0	0	8	0	0
20	25378556	.	C	T	4	3	7	0	0	7	0	0
20	25378583	.	T	G	2	5	7	0	0	7	0	0
20	25378610	.	C	T	2	5	7	0	0	7	0	0
20	25384473	.	A	T	7	3	10	0	0	10	0	0
20	25384494	.	G	A	8	3	11	0	0	11	0	0
20	25387850	.	T	A	2	5	7	0	1	8	0	0
20	25400778	.	A	C	3	0	3	0	4	7	0	0
20	25440628	.	T	G	3	3	6	0	0	6	0	0
20	25440648	.	C	G	4	4	8	0	0	8	0	0
20	25440668	.	T	C	5	6	11	0	0	11	0	0
20	25440724	.	G	T	7	6	13	0	0	13	0	0
20	25440731	.	G	A	7	8	15	0	0	15	0	0
20	25440790	.	A	C	5	8	13	0	1	14	0	0
20	25441033	.	G	T	7	14	21	0	1	22	0	0
20	25443159	.	T	A	10	13	23	0	1	24	0	0
20	25444903	.	G	A	11	8	19	0	0	19	0	0
20	25444929	.	A	G	10	6	16	0	0	16	0	0
20	25444943	.	G	A	11	6	17	0	0	17	0	0
20	25489625	.	C	T	8	4	12	0	0	12	0	0
20	25494432	.	G	A	4	4	8	0	0	8	0	0
20	25499025	.	G	T	7	9	16	0	0	16	0	0
20	25510331	.	A	G	15	5	20	0	1	21	0	0
20	25557127	.	C	T	1	2	3	0	1	4	0	0
20	25568000	.	G	T	1	4	5	0	0	5	0	0
20	25586364	.	T	A	1	3	4	0	0	4	0	0
20	25587875	.	G	A	1	3	4	0	0	4	0	0
20	25591248	.	A	G	2	6	8	0	0	8	0	0
20	25593109	.	C	T	2	6	8	0	0	8	0	0
20	25618330	.	G	A	6	4	10	0	0	10	0	0
20	25618601	.	T	A	7	12	19	0	0	19	0	0
20	25618908	.	G	A	5	5	10	0	0	10	0	0
20	25619965	.	G	A	6	7	13	0	0	13	0	0
20	25621633	.	G	A	7	5	12	0	1	13	0	0
20	25623770	.	A	T	10	6	16	0	0	16	0	0
20	25623778	.	A	T	8	8	16	0	0	16	0	0
20	25623921	.	C	T	1	7	8	0	2	10	0	0
20	25625969	.	A	G	2	4	6	0	1	7	0	0
20	25629317	.	C	T	1	3	4	0	0	4	0	0
20	25630961	.	G	A	1	3	4	0	0	4	0	0
20	25630962	.	G	T	1	3	4	0	0	4	0	0
20	25637658	.	G	C	1	2	3	0	0	3	0	0
20	25655568	.	C	T	1	2	3	0	0	3	0	0
20	25660441	.	A	G	20	13	33	0	1	34	0	0
20	25661199	.	A	G	9	15	24	0	5	29	0	0
20	25661396	.	G	A	14	13	27	0	2	29	0	0
20	25661403	.	T	G	14	7	21	0	4	25	0	0
20	25661509	.	G	A	25	17	42	0	1	43	0	0
20	25665325	.	T	G	20	6	26	0	2	28	0	0
20	25666402	.	A	T	15	12	27	0	2	29	0	0
20	25666524	.	T	C	7	5	12	0	1	13	0	0
20	25669512	.	T	C	7	14	21	0	0	21	0	0
20	25669567	.	T	G	14	6	20	0	1	21	0	0
20	25709311	.	C	T	1	7	8	0	5	13	0	0
20	25716116	.	G	T	3	2	5	0	0	5	0	0
20	25716117	.	G	C	3	2	5	0	0	5	0	0
20	25718101	.	C	A	3	2	5	0	1	6	0	0
20	25726388	.	T	C	5	3	8	0	0	8	0	0
20	25729595	.	C	A	5	3	8	0	1	9	0	0
20	25729819	.	G	T	3	3	6	0	0	6	0	0
20	25853191	.	T	C	2	5	7	0	0	7	0	0
20	25875221	.	T	C	18	0	18	0	12	30	0	0
20	25877666	.	G	A	11	5	16	0	1	17	0	0
20	25877787	.	A	T	10	11	21	0	1	22	0	0
20	25904259	.	G	A	4	3	7	0	0	7	0	0
20	25906480	.	A	T	6	4	10	0	0	10	0	0
20	25907347	.	G	C	13	5	18	0	2	20	0	0
20	25909276	.	T	C	12	8	20	0	0	20	0	0
20	25909661	.	C	A	19	5	24	0	0	24	0	0
20	25910099	.	C	T	6	2	8	0	0	8	0	0
20	25910368	.	A	T	2	4	6	0	0	6	0	0
20	25921009	.	C	T	11	13	24	0	0	24	0	0
20	25926688	.	C	A	6	3	9	0	0	9	0	0
20	25927310	.	A	G	12	11	23	0	1	24	0	0
20	25927436	.	T	G	0	18	18	0	1	19	0	0
20	26023822	.	T	C	3	6	9	0	0	9	0	0
20	26213799	.	C	G	1	1	2	0	0	2	0	0
20	26213808	.	A	T	1	2	3	0	0	3	0	0
20	26241666	.	A	G	3	2	5	0	0	5	0	0
20	26268443	.	T	C	4	3	7	0	0	7	0	0
20	26269970	.	C	T	6	3	9	0	0	9	0	0
20	26270730	.	A	G	2	9	11	0	0	11	0	0
20	26271357	.	G	T	2	8	10	0	8	18	0	0
20	26272493	.	A	T	4	4	8	0	0	8	0	0
20	26272494	.	G	T	4	3	7	0	1	8	0	0
20	26273194	.	T	C	4	5	9	0	0	9	0	0
20	26273680	.	C	T	7	12	19	0	0	19	0	0
20	26275207	.	A	T	8	6	14	0	2	16	0	0
20	26279817	.	A	C	2	4	6	0	0	6	0	0
20	26279961	.	A	C	7	4	11	0	0	11	0	0
20	26282602	.	C	G	1	8	9	0	0	9	0	0
20	26289484	.	C	T	6	8	14	0	2	16	0	0
20	26289485	.	A	T	6	9	15	0	1	16	0	0
20	26289572	.	G	A	0	4	4	0	6	10	0	0
20	26305019	.	A	T	11	8	19	0	0	19	0	0
20	26310596	.	T	A	3	9	12	0	2	14	0	0
20	26320221	.	C	T	15	14	29	0	1	30	0	0
20	26321073	.	G	A	9	11	20	0	3	23	0	0
20	26324196	.	T	G	14	13	27	0	0	27	0	0
20	26324307	.	T	A	19	12	31	0	1	32	0	0
20	26325380	.	A	G	10	14	24	1	2	27	0	0
20	26325481	.	T	A	15	15	30	0	0	30	0	0
20	26325493	.	T	C	15	12	27	0	1	28	0	0
20	26329035	.	G	A	11	10	21	0	0	21	0	0
20	26331683	.	C	T	17	15	32	0	2	34	0	0
20	26334414	.	A	G	17	18	35	0	1	36	0	0
20	26334446	.	C	T	23	13	36	0	2	38	0	0
20	26337790	.	C	A	24	26	50	0	2	52	0	0
20	26342889	.	C	T	28	12	40	0	1	41	0	0
20	26345230	.	C	T	17	28	45	0	2	47	0	0
20	26345856	.	T	A	22	19	41	0	4	45	0	0
20	26346710	.	C	T	28	16	44	0	4	48	0	0
20	26353770	.	A	G	19	15	34	0	5	39	0	0
20	26358743	.	G	A	23	26	49	0	1	50	0	0
20	26358964	.	G	A	22	14	36	0	5	41	0	0
20	26359109	.	A	T	10	3	13	0	0	13	0	0
20	26359863	.	A	T	3	3	6	0	0	6	0	0
20	26359872	.	A	T	3	3	6	0	0	6	0	0
20	26360070	.	C	T	2	4	6	0	1	7	0	0
20	26360125	.	T	G	1	1	2	0	3	5	0	0
20	26360470	.	A	G	1	4	5	0	0	5	0	0
20	26361200	.	C	T	3	3	6	0	0	6	0	0
20	26361212	.	C	T	3	4	7	0	0	7	0	0
20	26361333	.	C	T	0	3	3	0	5	8	0	0
20	26377820	.	C	G	2	2	4	0	0	4	0	0
20	26382274	.	C	A	3	2	5	0	0	5	0	0
20	26387181	.	G	A	10	6	16	0	0	16	0	0
20	26387288	.	T	A	13	14	27	0	1	28	0	0
20	26390906	.	C	T	4	5	9	0	0	9	0	0
20	26390912	.	G	A	3	5	8	0	0	8	0	0
20	26394500	.	C	T	1	4	5	0	1	6	0	0
20	26404155	.	C	T	2	8	10	0	0	10	0	0
20	26404320	.	A	G	3	0	3	0	4	7	0	0
20	26404369	.	G	A	3	7	10	0	0	10	0	0
20	26404443	.	G	A	1	3	4	0	4	8	0	0
20	26404479	.	C	T	4	4	8	0	0	8	0	0
20	26404645	.	C	T	7	4	11	0	0	11	0	0
20	26404696	.	G	A	1	5	6	0	2	8	0	0
20	26404753	.	C	A	6	7	13	0	0	13	0	0
20	26404860	.	T	A	9	5	14	0	0	15	1	0
20	26405121	.	G	A	1	5	6	0	6	12	0	0
20	26405356	.	A	T	4	3	7	0	0	7	0	0
20	26405382	.	C	T	4	3	7	0	0	7	0	0
20	26405683	.	T	C	3	3	6	0	0	6	0	0
20	26405808	.	T	A	2	2	4	0	0	4	0	0
20	26406160	.	G	A	0	4	4	0	10	14	0	0
20	26406252	.	T	C	4	2	6	0	0	6	0	0
20	26406551	.	A	T	2	2	4	0	0	4	0	0
20	26406640	.	G	T	0	5	5	0	3	8	0	0
20	26406792	.	T	A	2	2	4	0	1	5	0	0
20	26406806	.	C	T	2	3	5	0	1	6	0	0
20	26409194	.	T	A	5	6	11	0	0	11	0	0
20	26409261	.	C	A	0	4	4	1	8	13	0	0
20	26409295	.	C	A	7	8	15	0	0	15	0	0
20	26409310	.	A	T	9	10	19	0	0	19	0	0
20	26409372	.	T	G	5	7	12	0	2	14	0	0
20	26409471	.	C	T	1	11	12	1	13	26	0	0
20	26409723	.	C	T	10	16	26	0	0	26	0	0
20	26409922	.	T	C	12	17	29	0	1	30	0	0
20	26409991	.	G	A	17	9	26	0	1	27	0	0
20	26410224	.	G	T	11	5	16	0	1	17	0	0
20	26410275	.	G	A	18	8	26	0	0	26	0	0
20	26410341	.	A	G	20	16	36	0	1	37	0	0
20	26410344	.	A	C	19	17	36	0	0	36	0	0
20	26412372	.	T	A	12	12	24	0	1	25	0	0
20	26412479	.	C	T	11	11	22	0	2	24	0	0
20	26412501	.	G	A	11	11	22	0	1	23	0	0
20	26412579	.	C	A	10	18	28	0	1	29	0	0
20	26412876	.	G	A	17	18	35	0	1	37	1	0
20	26412968	.	T	A	20	17	37	0	1	38	0	0
20	26413038	.	C	T	15	15	30	0	1	31	0	0
20	26413057	.	G	A	14	10	24	0	1	25	0	0
20	26413269	.	C	A	12	12	24	0	0	24	0	0
20	26413280	.	A	C	13	1	14	0	14	28	0	0
20	26413311	.	C	T	11	16	27	0	0	27	0	0
20	26413470	.	G	T	10	11	21	0	1	22	0	0
20	26413640	.	C	A	11	7	18	0	0	18	0	0
20	26413923	.	C	T	9	9	18	0	0	18	0	0
20	26413998	.	A	T	9	14	23	0	0	23	0	0
20	26414724	.	C	T	0	10	10	0	6	16	0	0
20	26414747	.	C	T	8	10	18	0	1	19	0	0
20	26414832	.	C	T	11	9	20	0	0	20	0	0
20	26414844	.	G	A	9	8	17	0	0	17	0	0
20	26414919	.	A	G	14	4	18	0	0	18	0	0
20	26415021	.	G	T	8	8	16	0	1	17	0	0
20	26415760	.	G	A	10	5	15	0	2	17	0	0
20	26416068	.	G	C	7	0	7	0	13	20	0	0
20	26416265	.	C	T	9	5	14	0	0	14	0	0
20	26416266	.	T	A	8	5	13	0	0	13	0	0
20	26416469	.	C	G	7	7	14	0	0	14	0	0
20	26416514	.	T	C	7	13	20	0	0	20	0	0
20	26416515	.	C	T	13	7	20	0	1	21	0	0
20	26416551	.	A	T	10	9	19	0	0	19	0	0
20	26467216	.	C	T	11	12	23	0	0	23	0	0
20	26574266	.	C	T	12	7	19	0	0	19	0	0
20	26583972	.	T	C	14	9	23	0	0	23	0	0
20	26584155	.	A	T	11	5	16	0	0	16	0	0
20	26587834	.	A	G	11	9	20	0	0	20	0	0
20	26594516	.	G	T	14	7	21	0	0	21	0	0
20	26599709	.	C	T	11	8	19	0	1	20	0	0
20	26601222	.	G	A	11	20	31	0	1	32	0	0
20	26610433	.	G	A	7	14	21	0	0	21	0	0
20	26613462	.	A	G	17	16	33	0	1	34	0	0
20	26616241	.	G	C	8	0	8	0	13	21	0	0
20	26775892	.	G	A	12	3	15	0	0	15	0	0
20	26809059	.	A	G	10	9	19	0	0	19	0	0
20	26822389	.	A	G	7	8	15	0	1	16	0	0
20	26822449	.	A	G	14	9	23	0	0	23	0	0
20	26885950	.	C	T	2	2	4	0	0	4	0	0
20	26886515	.	A	G	1	3	4	0	0	4	0	0
20	26893097	.	G	A	2	2	4	0	0	4	0	0
20	26907857	.	T	C	4	2	6	0	1	7	0	0
20	26907893	.	C	T	2	3	5	0	0	5	0	0
20	26913236	.	G	T	3	3	6	0	0	6	0	0
20	26915472	.	T	C	3	6	9	0	0	9	0	0
20	26939926	.	C	T	11	17	28	0	0	28	0	0
20	26944106	.	G	A	12	23	35	0	0	36	1	0
20	26944311	.	G	A	22	15	37	0	7	44	0	0
20	26944576	.	C	T	14	22	36	0	0	36	0	0
20	26944762	.	C	T	15	16	31	0	1	32	0	0
20	26944951	.	C	T	5	8	13	0	0	13	0	0
20	26945120	.	A	T	6	7	13	0	1	14	0	0
20	26945394	.	C	T	17	9	26	1	0	27	0	0
20	26945735	.	C	T	13	7	20	0	2	22	0	0
20	26945793	.	T	A	18	9	27	0	0	27	0	0
20	26945950	.	T	A	7	8	15	0	0	15	0	0
20	26948161	.	A	G	8	6	14	0	0	14	0	0
20	26958653	.	C	A	10	10	20	0	2	23	1	0
20	26958685	.	A	G	16	10	26	0	0	26	0	0
20	26959431	.	A	T	5	2	7	0	1	8	0	0
20	26959605	.	T	C	5	3	8	0	1	9	0	0
20	26959624	.	C	T	6	3	9	0	1	10	0	0
20	26959829	.	C	T	8	7	15	0	0	15	0	0
20	26959955	.	A	C	3	9	12	1	1	14	0	0
20	26960039	.	T	G	10	9	19	0	0	19	0	0
20	26960371	.	T	C	8	5	13	0	1	14	0	0
20	26960430	.	C	T	4	4	8	0	0	8	0	0
20	26961469	.	A	G	5	7	12	0	0	12	0	0
20	26961719	.	T	A	5	3	8	0	0	8	0	0
20	26961726	.	C	T	6	3	9	0	1	10	0	0
20	26961758	.	A	T	9	6	15	0	0	15	0	0
20	26961862	.	T	C	9	10	19	0	1	20	0	0
20	26962095	.	T	C	7	8	15	1	2	18	0	0
20	26962119	.	T	C	8	4	12	1	1	14	0	0
20	26962290	.	G	T	12	5	17	0	0	17	0	0
20	26962318	.	G	A	3	4	7	0	4	11	0	0
20	26987599	.	G	A	0	4	4	0	2	6	0	0
20	26989211	.	C	G	6	1	7	0	5	12	0	0
20	26991400	.	C	A	9	6	15	0	0	15	0	0
20	26992102	.	G	A	2	8	10	0	1	11	0	0
20	26993506	.	C	T	6	13	19	0	0	19	0	0
20	26999506	.	T	A	5	8	13	0	0	13	0	0
20	27001816	.	A	C	14	12	26	0	0	26	0	0
20	27002595	.	T	G	3	4	7	0	0	7	0	0
20	27002769	.	T	A	8	4	12	0	0	12	0	0
20	27002989	.	G	A	2	3	5	0	0	5	0	0
20	27020294	.	T	A	22	25	47	0	1	48	0	0
20	27020346	.	A	C	17	20	37	0	3	40	0	0
20	27020442	.	G	T	14	27	41	0	1	42	0	0
20	27029685	.	A	C	38	17	55	0	2	57	0	0
20	27033700	.	C	T	39	24	63	0	3	66	0	0
20	27033847	.	A	T	23	32	55	0	3	58	0	0
20	27033914	.	A	G	24	20	44	2	8	54	0	0
20	27039339	.	A	C	37	18	55	0	4	59	0	0
20	27039364	.	G	T	4	35	39	0	24	63	0	0
20	27039498	.	C	T	33	31	64	0	1	65	0	0
20	27039523	.	C	T	31	24	55	0	4	59	0	0
20	27045501	.	G	A	27	27	54	0	1	55	0	0
20	27045649	.	T	G	30	5	35	0	31	66	0	0
20	27045858	.	T	A	10	6	16	0	1	17	0	0
20	27045875	.	T	C	5	11	16	0	1	17	0	0
20	27087600	.	T	A	4	12	16	0	0	16	0	0
20	27089281	.	C	T	8	10	18	0	0	18	0	0
20	27089613	.	T	C	5	3	8	0	0	8	0	0
20	27089674	.	A	G	1	6	7	0	0	7	0	0
20	27089870	.	T	A	1	3	4	0	0	4	0	0
20	27089954	.	G	A	4	4	8	0	0	8	0	0
20	27089995	.	C	T	1	4	5	0	0	5	0	0
20	27090120	.	C	T	1	2	3	0	0	3	0	0
20	27090134	.	G	T	3	3	6	0	0	6	0	0
20	27090401	.	C	T	6	5	11	0	0	11	0	0
20	27090409	.	C	T	7	5	12	0	1	13	0	0
20	27090525	.	T	G	1	4	5	0	0	5	0	0
20	27091179	.	T	A	13	3	16	0	0	16	0	0
20	27091206	.	G	A	13	6	19	0	0	19	0	0
20	27092231	.	C	T	11	6	17	0	0	17	0	0
20	27093159	.	T	G	9	6	15	0	0	15	0	0
20	27093219	.	T	C	6	4	10	0	2	12	0	0
20	27093269	.	G	C	6	5	11	0	0	11	0	0
20	27093286	.	C	T	6	4	10	0	0	10	0	0
20	27093335	.	G	A	6	5	11	0	1	12	0	0
20	27096092	.	A	T	11	14	25	0	0	25	0	0
20	27096400	.	C	A	11	12	23	0	0	23	0	0
20	27100011	.	A	T	11	7	18	0	0	18	0	0
20	27104562	.	C	T	13	10	23	0	0	23	0	0
20	27107089	.	C	T	12	8	20	0	2	22	0	0
20	27107140	.	C	A	9	13	22	0	0	22	0	0
20	27107241	.	C	A	11	11	22	0	0	22	0	0
20	27107572	.	C	G	7	5	12	0	0	12	0	0
20	27116869	.	G	T	3	5	8	0	0	8	0	0
20	27122383	.	C	T	2	3	5	0	0	5	0	0
20	27194918	.	T	C	1	4	5	0	0	5	0	0
20	27197666	.	C	G	1	2	3	0	1	4	0	0
20	27240885	.	C	T	3	9	12	0	1	13	0	0
20	27264482	.	G	A	4	5	9	0	1	10	0	0
20	27280808	.	G	A	6	7	13	0	0	13	0	0
20	27280840	.	G	A	0	6	6	0	8	14	0	0
20	27280859	.	C	G	5	0	5	0	6	11	0	0
20	27280877	.	C	A	1	5	6	0	1	7	0	0
20	27281624	.	T	C	3	5	8	0	0	8	0	0
20	27282592	.	A	G	7	10	17	0	0	17	0	0
20	27283404	.	A	C	7	5	12	0	0	12	0	0
20	27283604	.	G	A	4	3	7	0	0	7	0	0
20	27331149	.	G	A	12	6	18	0	1	19	0	0
20	27352584	.	T	C	7	7	14	0	2	16	0	0
20	27352591	.	A	G	9	0	9	0	9	18	0	0
20	27353040	.	T	C	7	11	18	0	0	18	0	0
20	27353250	.	G	A	11	14	25	0	0	25	0	0
20	27353265	.	C	T	12	13	25	0	3	28	0	0
20	27358777	.	C	A	14	10	24	0	0	24	0	0
20	27358859	.	G	A	14	20	34	0	2	36	0	0
20	27528655	.	C	A	4	5	9	0	1	10	0	0
20	27528660	.	T	C	4	5	9	0	0	9	0	0
20	27533414	.	A	G	2	0	2	0	5	7	0	0
20	27533439	.	C	A	2	5	7	0	0	7	0	0
20	27537750	.	G	A	1	2	3	0	0	3	0	0
20	27538539	.	G	A	1	5	6	0	0	6	0	0
20	27541716	.	C	T	4	2	6	0	0	6	0	0
20	27541949	.	G	A	7	6	13	0	0	13	0	0
20	27541954	.	G	A	0	6	6	0	7	13	0	0
20	27542005	.	G	A	0	5	5	0	4	9	0	0
20	27542146	.	G	A	1	6	7	0	5	12	0	0
20	27542371	.	G	A	1	5	6	0	2	8	0	0
20	27545984	.	G	A	2	2	4	0	0	4	0	0
20	27546032	.	C	T	5	5	10	0	0	10	0	0
20	27549524	.	G	A	4	7	11	0	0	11	0	0
20	27549847	.	T	G	2	2	4	0	0	4	0	0
20	27550148	.	C	T	3	3	6	0	0	6	0	0
20	27550150	.	A	C	2	3	5	0	1	6	0	0
20	27550287	.	C	T	3	3	6	0	0	6	0	0
20	27550563	.	T	A	1	2	3	0	0	3	0	0
20	27550866	.	G	A	2	3	5	0	0	5	0	0
20	27551123	.	G	T	4	9	13	0	0	13	0	0
20	27551363	.	G	A	1	8	9	0	1	10	0	0
20	27551492	.	C	G	2	2	4	0	0	4	0	0
20	27707974	.	G	A	6	4	10	0	1	11	0	0
20	27708016	.	G	A	4	9	13	0	1	14	0	0
20	27708181	.	C	T	7	2	9	0	0	9	0	0
20	27708306	.	A	G	6	4	10	0	0	10	0	0
20	27708943	.	G	A	5	3	8	0	0	8	0	0
20	27712847	.	T	C	3	4	7	0	0	7	0	0
20	27716086	.	G	A	1	7	8	0	2	10	0	0
20	27716093	.	C	T	3	8	11	0	1	12	0	0
20	27716190	.	T	C	2	4	6	0	0	6	0	0
20	27716227	.	T	C	5	3	8	0	0	8	0	0
20	27717055	.	T	A	4	8	12	0	0	12	0	0
20	27717493	.	A	G	1	7	8	0	1	9	0	0
20	27718549	.	T	A	6	5	11	0	1	12	0	0
20	27718578	.	A	T	4	7	11	0	0	11	0	0
20	27718734	.	A	G	1	2	3	0	0	3	0	0
20	27718751	.	T	G	1	2	3	0	0	3	0	0
20	27719578	.	T	C	1	3	4	0	0	4	0	0
20	27719763	.	G	A	8	3	11	0	1	12	0	0
20	27719859	.	T	C	3	5	8	0	0	8	0	0
20	27732628	.	A	G	3	7	10	0	1	11	0	0
20	27732832	.	A	G	4	9	13	0	2	15	0	0
20	27733034	.	G	A	7	7	14	0	2	16	0	0
20	27733611	.	T	C	10	8	18	0	0	18	0	0
20	27733631	.	G	C	10	0	10	0	5	15	0	0
20	27733650	.	C	A	0	7	7	0	10	17	0	0
20	28294732	.	G	T	2	4	6	0	1	7	0	0
20	28310920	.	A	G	4	7	11	0	0	11	0	0
20	28316845	.	G	T	9	6	15	0	0	15	0	0
20	28322943	.	C	T	4	2	6	0	1	7	0	0
20	28326229	.	G	A	8	4	12	0	1	13	0	0
20	28326283	.	A	T	2	4	6	0	0	6	0	0
20	28326508	.	T	C	5	4	9	0	0	9	0	0
20	28326565	.	T	C	3	3	6	0	0	6	0	0
20	28331772	.	C	T	1	3	4	0	1	5	0	0
20	28337640	.	A	G	2	5	7	0	0	7	0	0
20	28354549	.	T	A	6	6	12	0	1	13	0	0
20	28354588	.	A	G	6	8	14	0	0	14	0	0
20	28354951	.	A	G	5	9	14	0	0	14	0	0
20	28356989	.	T	C	9	10	19	0	1	20	0	0
20	28356998	.	G	A	8	9	17	0	2	19	0	0
20	28357028	.	A	G	8	10	18	0	0	18	0	0
20	28357184	.	A	G	5	6	11	0	1	12	0	0
20	28357190	.	C	T	6	7	13	0	0	13	0	0
20	28357463	.	A	G	4	7	11	0	1	12	0	0
20	28357538	.	G	A	8	5	13	0	0	13	0	0
20	28357570	.	A	G	10	7	17	0	0	17	0	0
20	28357610	.	A	G	13	10	23	0	0	23	0	0
20	28357688	.	T	C	4	11	15	0	1	16	0	0
20	28357718	.	T	C	3	10	13	0	0	13	0	0
20	28357733	.	G	A	2	10	12	0	1	13	0	0
20	28357769	.	A	G	3	10	13	0	0	13	0	0
20	28357823	.	T	A	3	13	16	0	0	16	0	0
20	28357883	.	C	T	2	8	10	0	0	10	0	0
20	28358060	.	C	G	8	3	11	0	0	11	0	0
20	28358333	.	T	C	1	6	7	0	0	7	0	0
20	28361044	.	C	T	9	4	13	0	0	13	0	0
20	28361428	.	A	T	2	2	4	0	0	4	0	0
20	28399987	.	C	A	0	2	2	0	1	3	0	0
20	28400232	.	A	T	2	1	3	0	2	5	0	0
20	28400362	.	A	C	2	5	7	0	0	7	0	0
20	28400422	.	C	T	2	4	6	0	1	7	0	0
20	28400455	.	A	C	10	4	14	0	0	14	0	0
20	28400481	.	A	G	10	6	16	0	0	16	0	0
20	28400619	.	G	A	14	12	26	0	1	27	0	0
20	28401147	.	A	G	10	3	13	0	3	16	0	0
20	28401298	.	C	G	5	8	13	0	0	13	0	0
20	28401309	.	C	T	5	7	12	0	0	12	0	0
20	28401639	.	T	A	3	2	5	0	0	6	1	0
20	28401664	.	C	T	6	2	8	0	0	8	0	0
20	28402253	.	G	A	8	3	11	0	0	11	0	0
20	28402426	.	G	A	13	9	22	0	0	22	0	0
20	28402456	.	A	G	12	8	20	0	2	22	0	0
20	28402470	.	G	A	15	6	21	0	0	21	0	0
20	28404191	.	A	G	10	8	18	0	1	19	0	0
20	28404247	.	T	C	6	0	6	0	12	18	0	0
20	28404270	.	T	G	8	11	19	0	0	19	0	0
20	28404342	.	G	A	4	5	9	0	0	9	0	0
20	28408028	.	C	T	4	7	11	0	0	11	0	0
20	28411204	.	A	G	7	5	12	0	0	12	0	0
20	28411688	.	T	C	5	3	8	0	0	8	0	0
20	28414423	.	T	C	9	7	16	0	0	16	0	0
20	28418587	.	C	T	7	6	13	0	0	13	0	0
20	28418730	.	A	T	4	3	7	0	1	8	0	0
20	28418741	.	A	G	3	0	3	0	4	7	0	0
20	28418939	.	T	C	9	3	12	0	0	12	0	0
20	28419015	.	A	T	8	7	15	0	3	18	0	0
20	28419755	.	G	C	1	3	4	0	0	4	0	0
20	28419767	.	C	A	1	4	5	0	0	5	0	0
20	28419807	.	T	A	7	2	9	0	0	9	0	0
20	28420010	.	C	T	2	2	4	0	2	6	0	0
20	28420438	.	C	G	8	5	13	0	1	14	0	0
20	28420496	.	C	T	5	5	10	0	0	10	0	0
20	28422920	.	A	G	4	3	7	0	0	7	0	0
20	28422927	.	T	C	6	0	6	0	3	9	0	0
20	28423035	.	G	T	5	5	10	0	1	11	0	0
20	28423062	.	G	A	6	4	10	0	1	11	0	0
20	28423072	.	A	T	5	5	10	0	0	10	0	0
20	28427716	.	T	C	5	2	7	0	0	7	0	0
20	28456574	.	T	C	9	6	15	0	0	15	0	0
20	28469982	.	A	G	5	8	13	0	0	13	0	0
20	28470057	.	T	C	7	3	10	0	0	10	0	0
20	28476107	.	T	C	7	5	12	0	0	12	0	0
20	28487287	.	T	C	11	5	16	0	1	17	0	0
20	28514841	.	A	G	10	6	16	0	1	17	0	0
20	28514878	.	T	C	14	6	20	0	0	20	0	0
20	28541670	.	A	G	13	7	20	0	3	23	0	0
20	28541754	.	A	G	9	5	14	0	0	14	0	0
20	28650323	.	T	C	10	13	23	0	1	24	0	0
20	28650328	.	A	C	12	14	26	0	1	27	0	0
20	28650945	.	A	T	16	19	35	0	2	37	0	0
20	28650946	.	T	G	16	20	36	0	1	37	0	0
20	28651194	.	C	T	29	11	40	0	0	40	0	0
20	28651239	.	A	G	20	16	36	0	1	37	0	0
20	28651454	.	G	A	12	25	37	0	3	40	0	0
20	28651709	.	T	C	18	0	18	0	11	29	0	0
20	28651958	.	T	G	17	8	25	0	0	25	0	0
20	28652449	.	G	C	24	14	38	0	4	42	0	0
20	28654339	.	G	A	24	16	40	0	3	43	0	0
20	28658666	.	A	C	17	13	30	0	4	34	0	0
20	28658693	.	T	C	22	2	24	0	13	37	0	0
20	28659924	.	A	G	13	7	20	0	0	20	0	0
20	28660050	.	G	A	18	13	31	0	1	32	0	0
20	28660729	.	T	C	13	0	13	0	15	28	0	0
20	28660795	.	G	A	11	15	26	0	0	26	0	0
20	28660828	.	G	T	7	9	16	0	1	17	0	0
20	28660837	.	T	C	5	8	13	0	0	13	0	0
20	28675587	.	C	A	2	19	21	0	12	33	0	0
20	28677911	.	G	T	21	12	33	0	2	35	0	0
20	28682989	.	T	C	4	6	10	0	0	10	0	0
20	28693295	.	C	T	9	6	15	0	1	16	0	0
20	28697047	.	C	T	0	7	7	0	8	15	0	0
20	28697073	.	C	T	0	8	8	0	7	15	0	0
20	28697848	.	T	C	7	6	13	0	1	14	0	0
20	28698284	.	T	C	8	0	8	0	9	17	0	0
20	28783046	.	T	C	11	11	22	0	0	22	0	0
20	28783327	.	T	C	8	4	12	0	1	13	0	0
20	28783607	.	T	C	8	0	8	0	8	16	0	0
20	28783627	.	T	C	10	10	20	0	1	21	0	0
20	28783688	.	C	A	12	13	25	0	1	26	0	0
20	28783781	.	A	C	13	0	13	0	10	23	0	0
20	28783999	.	G	T	5	4	9	0	1	10	0	0
20	28800961	.	A	G	12	14	26	0	0	26	0	0
20	28804089	.	G	A	8	13	21	0	0	21	0	0
20	28814902	.	T	C	3	5	8	0	0	8	0	0
20	28817492	.	A	G	3	3	6	0	1	7	0	0
20	28822696	.	T	A	7	6	13	0	0	13	0	0
20	28822735	.	T	C	8	5	13	0	2	15	0	0
20	28823116	.	T	C	10	8	18	0	1	19	0	0
20	28825375	.	C	T	11	12	23	0	0	23	0	0
20	28827208	.	A	G	7	10	17	0	1	18	0	0
20	28827350	.	T	C	9	5	14	0	1	15	0	0
20	28827416	.	C	T	9	2	11	0	0	11	0	0
20	28827433	.	A	C	8	4	12	0	1	13	0	0
20	28827633	.	T	C	6	4	10	0	0	10	0	0
20	28833245	.	C	T	16	20	36	0	0	36	0	0
20	28833312	.	C	A	24	19	43	0	3	46	0	0
20	28833793	.	A	G	18	22	40	0	1	41	0	0
20	28833878	.	T	C	22	0	22	0	22	44	0	0
20	28834008	.	C	T	18	22	40	0	7	47	0	0
20	28834536	.	C	A	2	4	6	0	1	7	0	0
20	28834571	.	G	A	2	2	4	0	0	4	0	0
20	28834597	.	T	C	3	0	3	0	2	5	0	0
20	28870806	.	C	G	23	30	53	0	2	55	0	0
20	28870843	.	T	C	39	15	54	0	1	55	0	0
20	28871830	.	G	A	30	38	68	0	5	73	0	0
20	28875824	.	T	C	17	1	18	0	17	35	0	0
20	28876885	.	G	A	7	21	28	0	1	29	0	0
20	28876899	.	A	G	7	19	26	0	0	26	0	0
20	28876942	.	T	A	21	14	35	0	0	35	0	0
20	28876971	.	A	C	19	1	20	0	19	39	0	0
20	28876996	.	T	A	21	19	40	0	2	42	0	0
20	28877028	.	C	T	16	20	36	0	0	36	0	0
20	28877085	.	T	A	11	21	32	0	0	32	0	0
20	28877136	.	A	T	16	17	33	0	2	35	0	0
20	28877696	.	T	C	22	0	22	0	24	46	0	0
20	28878097	.	T	G	15	15	30	0	0	30	0	0
20	28878229	.	T	A	8	9	17	0	0	17	0	0
20	28884768	.	T	A	23	22	45	0	1	46	0	0
20	28886159	.	A	T	7	7	14	0	1	15	0	0
20	28886311	.	T	C	21	11	32	0	0	32	0	0
20	28886530	.	C	T	10	5	15	0	4	20	1	0
20	28886608	.	C	A	7	5	12	0	0	12	0	0
20	28886735	.	T	C	13	10	23	0	1	24	0	0
20	28886771	.	A	C	8	7	15	0	0	15	0	0
20	28887233	.	A	C	3	4	7	0	0	7	0	0
20	28887303	.	A	G	8	10	18	1	0	19	0	0
20	28887498	.	T	A	13	12	25	0	0	25	0	0
20	28887590	.	G	C	12	16	28	0	0	28	0	0
20	28888012	.	C	A	6	5	11	0	1	12	0	0
20	28888041	.	A	T	10	5	15	0	1	17	1	0
20	28888198	.	G	C	10	0	10	0	8	18	0	0
20	28888331	.	T	A	12	15	27	0	0	27	0	0
20	28888514	.	C	G	3	4	7	0	2	9	0	0
20	28888629	.	T	G	7	7	14	0	0	14	0	0
20	28888743	.	T	A	12	3	15	0	1	17	1	0
20	28888856	.	A	G	8	9	17	0	0	17	0	0
20	28889248	.	G	T	8	10	18	0	4	22	0	0
20	28889306	.	A	G	12	9	21	0	1	22	0	0
20	28897255	.	G	A	6	5	11	0	1	12	0	0
20	28897595	.	A	G	11	9	20	0	1	21	0	0
20	28935493	.	G	A	8	4	12	0	0	12	0	0
20	28935820	.	A	G	3	3	6	0	1	7	0	0
20	28935902	.	A	G	3	3	6	0	0	6	0	0
20	28938383	.	C	T	4	3	7	0	0	7	0	0
20	28938389	.	G	A	4	2	6	0	1	7	0	0
20	28938491	.	C	T	5	3	8	0	1	9	0	0
20	28938635	.	C	T	1	1	2	0	0	2	0	0
20	28938642	.	A	C	1	2	3	0	0	3	0	0
20	28973655	.	A	C	4	7	11	0	1	12	0	0
20	28973834	.	T	C	6	5	11	0	0	11	0	0
20	29216103	.	G	T	2	3	5	0	0	5	0	0
20	29216167	.	C	T	4	2	6	0	1	7	0	0
20	29268260	.	A	G	4	3	7	0	0	7	0	0
20	29268358	.	A	G	5	2	7	0	0	7	0	0
20	29269119	.	T	C	6	8	14	0	0	14	0	0
20	30862333	.	T	C	4	2	6	0	0	6	0	0
20	30877378	.	C	G	2	2	4	0	0	4	0	0
20	30877540	.	G	A	2	2	4	0	0	4	0	0
20	30877774	.	C	T	1	2	3	0	1	4	0	0
20	30877864	.	C	T	2	3	5	0	0	5	0	0
20	30878346	.	A	G	2	0	2	0	3	5	0	0
20	30878590	.	T	A	3	2	5	0	0	5	0	0
20	30879211	.	C	T	7	4	11	0	0	11	0	0
20	30879494	.	G	A	6	4	10	0	0	10	0	0
20	30880195	.	A	G	5	2	7	0	0	7	0	0
20	30889723	.	A	G	3	5	8	0	1	9	0	0
20	30889754	.	T	G	3	7	10	0	0	10	0	0
20	30889792	.	T	A	1	5	6	0	0	6	0	0
20	30894333	.	T	C	4	0	4	0	7	11	0	0
20	30894408	.	C	T	1	2	3	0	0	3	0	0
20	30894427	.	C	T	2	2	4	0	0	4	0	0
20	30894496	.	G	T	6	4	10	0	0	10	0	0
20	30894510	.	T	A	5	4	9	0	0	9	0	0
20	30894630	.	A	T	2	5	7	0	0	7	0	0
20	30894834	.	T	C	4	2	6	0	1	7	0	0
20	30895007	.	A	G	2	3	5	0	1	6	0	0
20	30895013	.	A	G	2	5	7	0	0	7	0	0
20	30895070	.	A	G	1	9	10	0	1	11	0	0
20	30895091	.	G	A	1	8	9	0	0	9	0	0
20	30897944	.	G	A	5	6	11	0	0	11	0	0
20	30897948	.	G	T	3	5	8	0	2	10	0	0
20	30899353	.	A	G	6	9	15	0	0	15	0	0
20	30900837	.	A	C	6	0	6	0	7	13	0	0
20	30900880	.	A	C	8	0	8	0	7	15	0	0
20	30900928	.	C	G	1	11	12	0	5	17	0	0
20	30900969	.	T	G	6	7	13	0	0	13	0	0
20	30922687	.	G	A	10	6	16	0	0	16	0	0
20	30922688	.	A	T	9	6	15	0	1	16	0	0
20	30922808	.	T	A	5	9	14	0	2	16	0	0
20	30922836	.	C	A	12	2	14	0	1	17	2	0
20	30923101	.	T	C	9	7	16	0	0	16	0	0
20	30925253	.	T	C	7	0	7	0	10	17	0	0
20	30926205	.	T	C	14	9	23	0	0	23	0	0
20	30928174	.	T	C	11	6	17	0	0	17	0	0
20	30931021	.	A	T	10	10	20	0	2	22	0	0
20	30931108	.	G	A	4	12	16	0	0	16	0	0
20	30932277	.	T	C	23	0	23	0	21	44	0	0
20	30936755	.	T	C	16	1	17	0	18	35	0	0
20	30939177	.	T	C	15	11	26	0	0	26	0	0
20	30940566	.	C	G	19	21	40	1	0	41	0	0
20	30947353	.	T	C	29	14	43	0	3	46	0	0
20	30947433	.	T	C	10	10	20	0	0	20	0	0
20	31002836	.	T	G	1	2	3	0	0	3	0	0
20	31003145	.	T	C	2	2	4	0	0	4	0	0
20	31003147	.	C	T	2	2	4	0	0	4	0	0
20	31017678	.	G	A	2	2	4	0	0	4	0	0
20	31076504	.	T	A	12	6	18	0	1	19	0	0
20	31105619	.	G	A	10	8	18	1	0	19	0	0
20	31147609	.	G	A	11	7	18	1	1	20	0	0
20	31170202	.	G	A	20	10	30	0	2	32	0	0
20	31171010	.	G	A	10	11	21	0	0	21	0	0
20	31171079	.	A	G	11	6	17	0	1	18	0	0
20	31172725	.	A	C	15	6	21	0	0	21	0	0
20	31172996	.	C	T	7	11	18	0	0	18	0	0
20	31178425	.	G	T	12	12	24	0	1	26	1	0
20	31181050	.	A	G	17	13	30	0	0	30	0	0
20	31182194	.	G	A	8	10	18	0	1	19	0	0
20	31185594	.	C	A	6	8	14	0	3	17	0	0
20	31186253	.	T	C	15	8	23	0	1	24	0	0
20	31187975	.	G	A	25	9	34	0	0	34	0	0
20	31192304	.	A	C	12	15	27	0	2	29	0	0
20	31192720	.	C	T	19	13	32	0	0	32	0	0
20	31193762	.	G	A	0	10	10	0	12	22	0	0
20	31193826	.	C	T	19	8	27	0	2	29	0	0
20	31197217	.	G	T	20	10	30	0	1	31	0	0
20	31197307	.	G	A	1	12	13	0	23	36	0	0
20	31197465	.	T	C	13	20	33	0	0	33	0	0
20	31199655	.	G	A	18	14	32	0	0	32	0	0
20	31202316	.	C	T	5	6	11	0	1	12	0	0
20	31204173	.	T	C	11	11	22	0	0	22	0	0
20	31204191	.	A	C	9	13	22	0	1	23	0	0
20	31206649	.	A	G	18	14	32	0	1	33	0	0
20	31211701	.	T	A	18	12	30	0	0	30	0	0
20	31211710	.	A	G	18	14	32	0	1	33	0	0
20	31211812	.	G	A	0	6	6	0	12	18	0	0
20	31211846	.	G	A	1	8	9	0	14	23	0	0
20	31212156	.	G	A	1	10	11	0	14	25	0	0
20	31212390	.	G	C	9	9	18	0	0	18	0	0
20	31217572	.	C	G	14	5	19	0	0	19	0	0
20	31217612	.	T	C	9	9	18	0	0	18	0	0
20	31222978	.	T	G	16	0	16	0	14	30	0	0
20	31223282	.	C	T	15	11	26	0	1	27	0	0
20	31223336	.	C	T	17	8	25	0	1	26	0	0
20	31225875	.	C	T	12	17	29	0	1	30	0	0
20	31233329	.	C	T	0	11	11	1	3	15	0	0
20	31233463	.	T	G	6	5	11	0	0	11	0	0
20	31233566	.	T	G	2	4	6	0	0	6	0	0
20	31233623	.	T	C	4	3	7	0	0	7	0	0
20	31233679	.	A	G	3	10	13	0	0	13	0	0
20	31233780	.	T	G	3	5	8	0	0	8	0	0
20	31233837	.	G	C	8	8	16	0	0	16	0	0
20	31238061	.	A	G	8	11	19	0	0	19	0	0
20	31252532	.	G	A	8	5	13	0	0	13	0	0
20	31309826	.	C	G	0	3	3	0	1	4	0	0
20	31429132	.	T	C	2	3	5	0	0	5	0	0
20	31429181	.	C	T	4	3	7	0	0	7	0	0
20	31429648	.	C	T	16	11	27	0	2	29	0	0
20	31429824	.	G	A	5	3	8	0	0	8	0	0
20	31429917	.	T	G	4	3	7	0	0	7	0	0
20	31430039	.	G	C	7	3	10	0	0	10	0	0
20	31430204	.	C	A	6	5	11	0	1	12	0	0
20	31430279	.	A	G	6	10	16	0	0	16	0	0
20	31430320	.	T	C	4	2	6	0	5	11	0	0
20	31430769	.	C	T	2	10	12	0	7	19	0	0
20	31430922	.	T	A	9	2	11	0	0	11	0	0
20	31430993	.	C	T	2	4	6	0	6	12	0	0
20	31431106	.	A	T	4	3	7	0	0	7	0	0
20	31431160	.	A	T	9	5	14	0	0	14	0	0
20	31431375	.	T	C	3	6	9	0	0	9	0	0
20	31431457	.	T	A	8	8	16	0	0	16	0	0
20	31431561	.	A	G	12	3	15	0	0	15	0	0
20	31431645	.	A	T	5	4	9	0	0	9	0	0
20	31431701	.	A	G	10	7	17	0	0	17	0	0
20	31431739	.	A	G	9	12	21	0	2	23	0	0
20	31431962	.	A	G	9	6	15	0	0	15	0	0
20	31432826	.	G	T	8	5	13	0	1	14	0	0
20	31432850	.	A	G	5	5	10	0	0	10	0	0
20	31436304	.	C	T	12	8	20	0	0	20	0	0
20	31436450	.	G	A	19	10	29	0	1	30	0	0
20	31436483	.	C	T	11	11	22	1	2	25	0	0
20	31436750	.	C	T	1	6	7	0	6	13	0	0
20	31436819	.	C	A	7	8	15	0	0	15	0	0
20	31436984	.	C	T	7	11	18	0	0	18	0	0
20	31440687	.	T	A	1	2	3	0	0	3	0	0
20	31440689	.	C	A	1	2	3	0	0	3	0	0
20	31441076	.	G	A	11	8	19	0	0	19	0	0
20	31447413	.	C	T	0	8	8	0	8	16	0	0
20	31447455	.	C	T	6	3	9	0	0	9	0	0
20	31449416	.	T	C	3	2	5	0	0	5	0	0
20	31471068	.	G	A	6	4	10	0	0	10	0	0
20	31483629	.	C	A	3	6	9	0	0	9	0	0
20	31497034	.	C	T	2	2	4	0	0	4	0	0
20	31743161	.	C	T	5	5	10	0	0	10	0	0
20	31743684	.	T	C	4	3	7	0	1	8	0	0
20	31746247	.	T	A	8	3	11	0	3	14	0	0
20	31746604	.	C	T	13	9	22	0	0	22	0	0
20	31746611	.	A	T	13	9	22	0	0	22	0	0
20	31747116	.	A	T	15	13	28	2	2	32	0	0
20	31747673	.	C	A	0	20	20	0	19	39	0	0
20	31747695	.	G	C	19	16	35	0	1	36	0	0
20	31747792	.	C	T	2	13	15	0	13	28	0	0
20	31747860	.	C	T	1	7	8	4	15	27	0	0
20	31748178	.	T	C	14	19	33	0	1	34	0	0
20	31748183	.	C	T	19	12	31	0	1	32	0	0
20	31748363	.	A	G	14	14	28	0	0	28	0	0
20	31748448	.	A	G	15	15	30	0	1	31	0	0
20	31748518	.	C	T	15	15	30	0	0	30	0	0
20	31748679	.	C	A	7	2	9	0	0	9	0	0
20	31748755	.	G	A	5	6	11	0	0	11	0	0
20	31748845	.	A	T	8	13	21	0	1	22	0	0
20	31771899	.	G	A	13	18	31	0	1	32	0	0
20	31777192	.	C	T	1	13	14	0	21	35	0	0
20	31786688	.	T	A	10	13	23	0	0	23	0	0
20	31790975	.	A	G	9	10	19	0	3	22	0	0
20	32047457	.	T	C	11	9	20	0	1	21	0	0
20	32047741	.	A	C	18	15	33	0	0	33	0	0
20	32061596	.	G	A	21	11	32	0	2	34	0	0
20	32065517	.	G	A	16	23	39	0	2	41	0	0
20	32065650	.	C	T	25	19	44	1	0	45	0	0
20	32071494	.	A	G	20	15	35	1	2	38	0	0
20	32110172	.	T	C	20	3	23	0	14	37	0	0
20	32110331	.	G	A	29	24	53	0	1	54	0	0
20	32110829	.	C	G	21	17	38	0	0	38	0	0
20	32135962	.	T	C	14	9	23	0	2	25	0	0
20	32136451	.	T	G	14	11	25	0	0	25	0	0
20	32136588	.	G	T	13	11	24	0	1	25	0	0
20	32136953	.	C	T	8	13	21	0	0	21	0	0
20	32137365	.	T	A	6	3	9	0	0	9	0	0
20	32137423	.	G	A	3	7	10	0	2	12	0	0
20	32137529	.	A	T	6	7	13	0	0	13	0	0
20	32137638	.	A	G	7	6	13	0	1	14	0	0
20	32137752	.	G	T	16	10	26	0	1	27	0	0
20	32137984	.	A	T	13	15	28	0	1	29	0	0
20	32138029	.	T	A	16	13	29	0	0	29	0	0
20	32138111	.	C	T	7	13	20	0	1	21	0	0
20	32138171	.	T	C	11	12	23	0	2	25	0	0
20	32138478	.	A	G	12	14	26	0	0	26	0	0
20	32145841	.	A	T	1	5	6	0	0	6	0	0
20	32224452	.	A	G	11	0	11	0	14	25	0	0
20	32224485	.	C	A	16	13	29	0	0	29	0	0
20	32225711	.	G	A	7	11	18	0	0	18	0	0
20	32227268	.	G	A	9	12	21	0	0	21	0	0
20	32228863	.	G	A	22	14	36	0	5	41	0	0
20	32228872	.	A	G	16	21	37	0	1	38	0	0
20	32228936	.	A	C	14	19	33	0	2	35	0	0
20	32229004	.	G	A	15	25	40	0	0	40	0	0
20	32229047	.	G	A	22	16	38	0	0	38	0	0
20	32229053	.	C	T	15	20	35	0	0	35	0	0
20	32229095	.	T	C	13	17	30	0	1	31	0	0
20	32229214	.	G	T	13	19	32	0	1	33	0	0
20	32229825	.	G	T	23	10	33	0	5	39	1	0
20	32230017	.	A	C	20	18	38	0	3	41	0	0
20	32230205	.	T	G	13	2	15	0	12	27	0	0
20	32230301	.	T	C	5	5	10	0	0	10	0	0
20	32230362	.	C	A	14	6	20	0	0	20	0	0
20	32230470	.	T	C	11	9	20	0	0	20	0	0
20	32230472	.	A	C	12	9	21	0	1	22	0	0
20	32230518	.	C	A	8	10	18	0	0	18	0	0
20	32230521	.	G	A	1	9	10	0	9	19	0	0
20	32230555	.	C	A	6	11	17	0	0	17	0	0
20	32230620	.	C	T	16	19	35	0	0	35	0	0
20	32230836	.	T	C	6	5	11	0	1	12	0	0
20	32286800	.	C	T	5	10	15	0	10	25	0	0
20	32286875	.	C	T	22	8	30	1	1	32	0	0
20	32286877	.	A	C	8	21	29	1	1	31	0	0
20	32286960	.	A	C	15	13	28	0	0	28	0	0
20	32287317	.	C	T	11	8	19	0	1	20	0	0
20	32287349	.	C	G	7	12	19	0	0	19	0	0
20	32287736	.	T	C	8	16	24	0	0	24	0	0
20	32290160	.	G	A	16	14	30	0	1	31	0	0
20	32290435	.	A	G	15	20	35	0	1	36	0	0
20	32290679	.	G	A	13	22	35	0	0	35	0	0
20	32291287	.	G	A	13	9	22	1	3	26	0	0
20	32332463	.	A	G	6	3	9	0	0	9	0	0
20	32332494	.	A	C	2	0	2	0	2	4	0	0
20	32332633	.	A	T	11	5	16	4	1	22	1	0
20	32348568	.	C	T	4	3	7	0	0	7	0	0
20	32403611	.	C	T	2	5	7	0	1	8	0	0
20	32405330	.	A	G	5	2	7	0	2	9	0	0
20	32405406	.	T	C	3	2	5	0	0	5	0	0
20	32406066	.	T	C	6	4	10	0	0	10	0	0
20	32432156	.	T	C	14	19	33	0	5	38	0	0
20	32432315	.	G	T	19	7	26	0	0	26	0	0
20	32432532	.	C	T	14	18	32	0	0	32	0	0
20	32437598	.	T	A	2	2	4	0	0	4	0	0
20	32441025	.	A	T	2	3	5	0	0	5	0	0
20	32484600	.	C	T	5	11	16	0	1	17	0	0
20	32487624	.	G	A	4	5	9	0	0	9	0	0
20	32487643	.	G	T	3	3	6	0	0	6	0	0
20	32489618	.	G	A	0	5	5	0	2	7	0	0
20	32490403	.	C	T	5	6	11	0	0	11	0	0
20	32490480	.	C	T	6	2	8	0	0	8	0	0
20	32490783	.	C	G	2	2	4	0	0	4	0	0
20	32498335	.	C	T	2	6	8	0	0	8	0	0
20	32498410	.	C	G	7	6	13	0	0	13	0	0
20	32498441	.	G	C	11	8	19	0	0	19	0	0
20	32498517	.	C	T	4	2	6	0	0	6	0	0
20	32498635	.	C	A	1	4	5	0	2	7	0	0
20	32498639	.	C	A	0	5	5	0	1	6	0	0
20	32498690	.	C	T	7	3	10	0	0	10	0	0
20	32498771	.	C	G	3	10	13	0	0	13	0	0
20	32498869	.	A	G	5	5	10	0	0	10	0	0
20	32499166	.	G	A	0	10	10	0	7	17	0	0
20	32505856	.	G	A	5	6	11	0	1	12	0	0
20	32513235	.	G	A	15	12	27	0	1	28	0	0
20	32513256	.	G	A	13	11	24	0	2	26	0	0
20	32513987	.	G	A	15	14	29	0	2	31	0	0
20	32515968	.	C	T	17	8	25	0	0	26	1	0
20	32518298	.	T	C	2	2	4	0	0	4	0	0
20	32518306	.	G	A	2	3	5	0	0	5	0	0
20	32520852	.	A	G	4	11	15	0	0	15	0	0
20	32520853	.	A	T	12	3	15	0	0	15	0	0
20	32521203	.	C	T	11	17	28	0	2	30	0	0
20	32521220	.	T	C	17	9	26	1	1	28	0	0
20	32521686	.	A	C	16	12	28	0	3	31	0	0
20	32521719	.	A	C	19	13	32	0	0	32	0	0
20	32539224	.	G	A	3	3	6	0	0	6	0	0
20	32567835	.	G	T	4	5	9	0	0	9	0	0
20	32567982	.	T	C	2	4	6	0	0	6	0	0
20	32571781	.	C	T	7	6	13	0	3	16	0	0
20	32574157	.	T	C	10	8	18	0	1	19	0	0
20	32574190	.	G	A	8	7	15	0	0	15	0	0
20	32576667	.	T	C	8	5	13	0	0	13	0	0
20	32756790	.	G	A	0	6	6	0	4	10	0	0
20	32757807	.	C	G	15	1	16	0	9	25	0	0
20	32758490	.	A	G	11	10	21	0	0	21	0	0
20	32758558	.	T	C	11	15	26	0	0	26	0	0
20	32838710	.	A	T	3	5	8	0	0	8	0	0
20	32863650	.	A	G	4	7	11	0	0	11	0	0
20	32863657	.	A	G	3	8	11	0	0	11	0	0
20	32872075	.	C	A	0	3	3	0	4	7	0	0
20	32872156	.	C	A	1	6	7	0	0	7	0	0
20	32925890	.	T	C	4	3	7	0	0	7	0	0
20	32927191	.	C	T	2	2	4	0	0	4	0	0
20	32939176	.	T	C	5	8	13	0	1	14	0	0
20	32939208	.	T	A	6	4	10	0	0	10	0	0
20	32948411	.	A	T	3	3	6	0	0	6	0	0
20	32948551	.	A	C	5	7	12	0	0	12	0	0
20	32948591	.	G	C	6	0	6	0	7	13	0	0
20	32963014	.	C	T	0	4	4	0	4	8	0	0
20	32963111	.	A	G	4	3	7	0	0	7	0	0
20	32963132	.	T	A	3	4	7	0	0	7	0	0
20	32996373	.	C	T	3	4	7	0	1	8	0	0
20	32999053	.	G	C	4	2	6	0	0	6	0	0
20	33007836	.	T	C	5	0	5	0	5	10	0	0
20	33127507	.	G	A	5	4	9	0	0	9	0	0
20	33127621	.	C	T	1	2	3	0	0	3	0	0
20	33175232	.	A	G	13	0	13	0	6	19	0	0
20	33175351	.	G	A	18	13	31	0	0	32	1	0
20	33175504	.	T	C	15	17	32	0	0	32	0	0
20	33175549	.	C	T	17	9	26	0	1	27	0	0
20	33175948	.	A	C	16	9	25	0	0	25	0	0
20	33177904	.	C	T	19	9	28	0	2	30	0	0
20	33180111	.	T	C	10	9	19	0	0	19	0	0
20	33180295	.	G	A	7	7	14	0	0	14	0	0
20	33180547	.	C	T	10	5	15	0	0	15	0	0
20	33189326	.	T	G	19	0	19	0	8	27	0	0
20	33189386	.	G	A	1	12	13	0	4	17	0	0
20	33189631	.	G	A	3	5	8	0	2	10	0	0
20	33298184	.	C	T	6	6	12	0	0	12	0	0
20	33467794	.	A	T	12	5	17	1	1	19	0	0
20	33468040	.	T	G	13	17	30	0	6	36	0	0
20	33484083	.	G	A	8	11	19	0	0	19	0	0
20	33484387	.	T	C	10	9	19	0	0	19	0	0
20	33484438	.	G	C	11	0	11	0	10	21	0	0
20	33487143	.	G	T	6	3	9	0	1	10	0	0
20	33487152	.	A	T	7	5	12	0	0	12	0	0
20	33487440	.	A	C	7	0	7	0	4	11	0	0
20	33487603	.	C	T	9	14	23	0	0	23	0	0
20	33494411	.	G	T	18	18	36	0	2	38	0	0
20	33535128	.	A	G	1	0	1	0	2	3	0	0
20	33535173	.	T	C	1	2	3	0	0	3	0	0
20	33535341	.	C	A	1	3	4	0	0	4	0	0
20	33662386	.	C	G	1	2	3	0	0	3	0	0
20	33664996	.	C	T	1	3	4	0	1	5	0	0
20	33668870	.	C	T	3	2	5	0	0	5	0	0
20	33669960	.	G	T	1	2	3	0	0	3	0	0
20	33673472	.	T	C	1	2	3	0	0	3	0	0
20	33758874	.	C	T	12	13	25	0	0	25	0	0
20	33759151	.	G	C	23	0	23	1	12	36	0	0
20	33759196	.	A	C	24	0	24	1	11	36	0	0
20	33771521	.	G	A	17	11	28	0	0	28	0	0
20	33773493	.	G	A	11	19	30	0	0	30	0	0
20	33789729	.	T	C	11	1	12	0	9	21	0	0
20	33789927	.	C	T	0	10	10	0	13	23	0	0
20	33789965	.	G	T	16	13	29	0	2	31	0	0
20	33806290	.	C	T	1	3	4	0	0	4	0	0
20	33809707	.	A	G	8	11	19	0	0	19	0	0
20	33809971	.	C	A	11	6	17	0	2	19	0	0
20	33810099	.	G	A	4	5	9	0	0	9	0	0
20	33810101	.	G	A	3	5	8	0	0	8	0	0
20	33810310	.	T	A	2	3	5	1	0	6	0	0
20	33810775	.	T	A	5	2	7	1	1	9	0	0
20	33810845	.	C	T	13	6	19	0	0	19	0	0
20	33810921	.	T	C	3	0	3	0	21	25	1	0
20	33811519	.	G	T	11	9	20	0	0	21	1	0
20	33839868	.	A	G	7	12	19	0	0	19	0	0
20	33840638	.	T	C	8	9	17	0	0	17	0	0
20	33859788	.	A	T	13	10	23	0	1	24	0	0
20	33859869	.	C	T	4	15	19	0	19	38	0	0
20	33860113	.	G	A	15	20	35	0	1	36	0	0
20	33862741	.	G	A	6	13	19	0	2	21	0	0
20	33864772	.	A	G	13	10	23	0	1	24	0	0
20	33984086	.	G	C	5	11	16	0	1	17	0	0
20	33994771	.	C	A	1	2	3	0	0	3	0	0
20	33994822	.	C	A	1	4	5	0	2	7	0	0
20	33994834	.	C	T	1	5	6	0	0	6	0	0
20	34003047	.	G	A	0	4	4	0	5	9	0	0
20	34007128	.	G	A	2	4	6	0	0	6	0	0
20	34007589	.	G	C	2	6	8	0	0	8	0	0
20	34007607	.	G	A	6	3	9	0	0	9	0	0
20	34008178	.	C	A	3	2	5	0	0	5	0	0
20	34009225	.	C	G	5	0	5	0	6	11	0	0
20	34009952	.	C	A	2	9	11	0	0	11	0	0
20	34012828	.	T	A	7	6	13	0	0	13	0	0
20	34012916	.	A	T	2	5	7	0	0	7	0	0
20	34013073	.	T	G	6	7	13	0	1	14	0	0
20	34015654	.	C	T	1	6	7	0	9	16	0	0
20	34015907	.	G	A	9	10	19	0	1	20	0	0
20	34015921	.	T	A	11	11	22	0	0	22	0	0
20	34018783	.	C	T	10	6	16	0	0	16	0	0
20	34018852	.	C	A	6	3	9	0	0	9	0	0
20	34020560	.	G	A	2	3	5	0	4	9	0	0
20	34020608	.	T	C	8	0	8	0	5	13	0	0
20	34020861	.	T	A	6	5	11	0	0	11	0	0
20	34023551	.	T	C	3	4	7	0	0	7	0	0
20	34024246	.	G	A	6	3	9	0	0	9	0	0
20	34028271	.	C	T	3	6	9	0	1	10	0	0
20	34037825	.	A	G	1	2	3	0	0	3	0	0
20	34039408	.	A	C	9	3	12	0	1	13	0	0
20	34040132	.	C	A	13	13	26	0	0	26	0	0
20	34044813	.	G	A	8	14	22	0	0	22	0	0
20	34044845	.	A	T	13	7	20	0	0	20	0	0
20	34049141	.	G	A	11	8	19	0	0	19	0	0
20	34051237	.	C	T	11	8	19	0	0	19	0	0
20	34051417	.	G	A	14	8	22	1	0	23	0	0
20	34053787	.	T	A	16	11	27	0	2	29	0	0
20	34054401	.	C	T	9	13	22	0	0	22	0	0
20	34056206	.	C	G	7	10	17	0	0	17	0	0
20	34056227	.	C	T	9	7	16	0	0	16	0	0
20	34057323	.	C	A	6	7	13	0	0	13	0	0
20	34059166	.	T	C	7	6	13	0	2	15	0	0
20	34059433	.	C	T	11	6	17	0	0	17	0	0
20	34059440	.	G	C	10	7	17	0	0	17	0	0
20	34061117	.	C	T	4	3	7	0	0	7	0	0
20	34061577	.	A	T	9	4	13	0	0	13	0	0
20	34061784	.	C	T	4	9	13	0	1	14	0	0
20	34061788	.	G	T	4	10	14	0	0	14	0	0
20	34061986	.	G	A	3	6	9	0	0	9	0	0
20	34062250	.	G	T	5	2	7	0	0	7	0	0
20	34063783	.	A	T	6	4	10	0	1	11	0	0
20	34063986	.	T	A	6	8	14	0	0	14	0	0
20	34065620	.	G	A	4	5	9	0	1	10	0	0
20	34066128	.	G	A	3	3	6	0	0	6	0	0
20	34066200	.	T	C	7	6	13	0	1	14	0	0
20	34151818	.	C	A	10	8	18	0	2	20	0	0
20	34151873	.	C	T	7	12	19	0	0	19	0	0
20	34153975	.	G	A	8	9	17	0	0	17	0	0
20	34154122	.	C	T	13	8	21	0	0	21	0	0
20	34154618	.	C	A	11	4	15	0	5	20	0	0
20	34154831	.	G	A	12	4	16	0	0	16	0	0
20	34154982	.	G	T	9	14	23	0	1	24	0	0
20	34155025	.	C	T	10	12	22	0	0	22	0	0
20	34155192	.	T	C	10	9	19	0	1	20	0	0
20	34332683	.	C	A	24	15	39	0	2	41	0	0
20	34333733	.	T	C	19	18	37	0	0	37	0	0
20	34337702	.	G	A	7	6	13	0	0	13	0	0
20	34339473	.	G	A	31	27	58	0	2	60	0	0
20	34339516	.	C	T	24	29	53	0	2	55	0	0
20	34340055	.	T	C	34	23	57	0	0	57	0	0
20	34340678	.	A	T	20	21	41	0	1	42	0	0
20	34364295	.	T	C	2	0	2	0	2	4	0	0
20	34370869	.	T	A	1	2	3	0	0	3	0	0
20	34382964	.	G	A	2	3	5	0	0	5	0	0
20	34383008	.	G	A	2	3	5	0	0	5	0	0
20	34388225	.	G	C	2	2	4	0	0	4	0	0
20	34398646	.	G	A	1	2	3	0	0	3	0	0
20	34420788	.	G	A	21	21	42	0	0	42	0	0
20	34420860	.	A	G	16	17	33	0	2	35	0	0
20	34421307	.	A	G	14	18	32	0	0	32	0	0
20	34421485	.	C	T	14	14	28	0	1	29	0	0
20	34421758	.	G	A	12	16	28	0	1	29	0	0
20	34421801	.	G	C	19	0	19	0	13	32	0	0
20	34421804	.	G	A	21	12	33	0	0	33	0	0
20	34426660	.	T	G	16	23	39	0	1	40	0	0
20	34430100	.	T	G	19	13	32	0	0	32	0	0
20	34431467	.	G	C	17	11	28	0	2	30	0	0
20	34431661	.	A	G	20	13	33	0	0	33	0	0
20	34445005	.	A	G	5	12	17	0	2	19	0	0
20	34446718	.	G	A	14	12	26	0	0	26	0	0
20	34446733	.	A	G	13	10	23	0	1	24	0	0
20	34447477	.	G	C	18	16	34	0	0	34	0	0
20	34447522	.	T	C	18	14	32	0	2	34	0	0
20	34450257	.	T	G	12	7	19	0	1	20	0	0
20	34450535	.	T	C	23	10	33	0	0	33	0	0
20	34501246	.	T	C	4	2	6	0	0	6	0	0
20	34502740	.	T	C	3	3	6	0	0	6	0	0
20	34506925	.	T	G	3	2	5	0	1	6	0	0
20	34506934	.	T	A	2	1	3	0	1	4	0	0
20	34537775	.	A	C	8	9	17	0	1	18	0	0
20	34551195	.	C	T	5	8	13	0	0	13	0	0
20	34551222	.	A	G	10	7	17	0	0	17	0	0
20	34582410	.	T	C	5	10	15	0	0	15	0	0
20	34593729	.	G	A	9	9	18	0	0	18	0	0
20	34596633	.	G	T	6	12	18	0	0	18	0	0
20	34596634	.	T	A	7	12	19	0	0	19	0	0
20	34596710	.	A	T	4	6	10	0	2	12	0	0
20	34596736	.	C	G	6	0	6	0	8	14	0	0
20	34596788	.	C	T	4	6	10	0	0	10	0	0
20	34596797	.	G	T	4	5	9	0	0	9	0	0
20	34596914	.	A	T	1	6	7	0	0	7	0	0
20	34597244	.	A	G	13	8	21	0	2	23	0	0
20	34597631	.	C	T	15	13	28	0	0	28	0	0
20	34597844	.	T	C	16	16	32	0	0	32	0	0
20	34598076	.	T	A	14	6	20	0	2	22	0	0
20	34598113	.	C	A	16	7	23	0	0	23	0	0
20	34601175	.	G	A	24	19	43	0	0	43	0	0
20	34601214	.	A	T	19	16	35	0	0	35	0	0
20	34602561	.	A	C	15	14	29	0	3	32	0	0
20	34602576	.	T	G	16	16	32	0	1	33	0	0
20	34603661	.	C	T	21	16	37	0	1	38	0	0
20	34603733	.	T	G	12	27	39	0	1	40	0	0
20	34604241	.	C	A	18	23	41	0	2	43	0	0
20	34604356	.	C	T	18	19	37	0	0	37	0	0
20	34604432	.	C	T	10	12	22	0	1	23	0	0
20	34607698	.	A	G	12	0	12	0	13	25	0	0
20	34607893	.	A	G	11	12	23	0	0	23	0	0
20	34608235	.	A	G	6	3	9	0	1	10	0	0
20	34608458	.	A	C	4	3	7	0	0	7	0	0
20	34608519	.	T	C	9	7	16	0	0	16	0	0
20	34611709	.	G	T	5	6	11	0	2	13	0	0
20	34613651	.	A	G	5	8	13	0	2	15	0	0
20	34613733	.	G	T	5	7	12	0	0	12	0	0
20	34617642	.	T	C	5	8	13	0	0	13	0	0
20	34617729	.	G	A	3	5	8	0	0	8	0	0
20	34617780	.	A	T	7	6	13	0	1	14	0	0
20	34617837	.	G	A	1	7	8	0	5	13	0	0
20	34627817	.	G	C	8	8	16	0	1	17	0	0
20	34630281	.	A	G	11	10	21	0	0	21	0	0
20	34632577	.	T	C	11	10	21	0	0	21	0	0
20	34632587	.	C	T	10	8	18	0	1	19	0	0
20	34632740	.	C	A	4	3	7	0	0	7	0	0
20	34632864	.	C	A	5	5	10	0	0	10	0	0
20	34632911	.	T	A	4	9	13	0	0	13	0	0
20	34634979	.	T	C	3	2	5	0	2	7	0	0
20	34634988	.	T	C	4	2	6	0	0	6	0	0
20	34638185	.	A	G	6	0	6	0	7	13	0	0
20	34638235	.	G	A	0	3	3	0	9	12	0	0
20	34638251	.	G	A	9	7	16	0	0	16	0	0
20	34642639	.	C	A	10	12	22	0	0	22	0	0
20	34642805	.	A	G	10	3	13	0	2	15	0	0
20	34642931	.	G	A	7	5	12	0	0	12	0	0
20	34643007	.	A	G	8	14	22	0	1	23	0	0
20	34643051	.	T	C	12	12	24	0	0	24	0	0
20	34643054	.	A	G	12	12	24	0	0	24	0	0
20	34643163	.	A	G	8	17	25	0	0	25	0	0
20	34643392	.	G	T	2	2	4	0	0	4	0	0
20	34643433	.	T	A	1	6	7	0	0	7	0	0
20	34643535	.	T	C	5	4	9	0	1	10	0	0
20	34643800	.	C	T	10	2	12	0	2	14	0	0
20	34654381	.	A	T	2	1	3	0	1	4	0	0
20	34673199	.	T	A	5	3	8	0	2	10	0	0
20	34682639	.	C	T	2	7	9	0	0	9	0	0
20	34727666	.	G	A	9	11	20	1	1	22	0	0
20	34733553	.	C	A	15	9	24	0	0	24	0	0
20	34733604	.	G	A	15	13	28	0	1	29	0	0
20	34733752	.	C	T	10	10	20	2	1	23	0	0
20	34737886	.	T	A	2	4	6	0	0	6	0	0
20	34737944	.	G	C	11	11	22	0	0	22	0	0
20	34738198	.	G	A	25	15	40	0	8	48	0	0
20	34738314	.	G	A	16	16	32	1	9	43	1	0
20	34738397	.	G	T	15	9	24	0	1	25	0	0
20	34738473	.	T	G	8	21	29	0	0	29	0	0
20	34738756	.	A	G	20	18	38	0	1	39	0	0
20	34742840	.	G	A	21	14	35	0	1	36	0	0
20	34745872	.	A	G	16	18	34	0	1	35	0	0
20	34746019	.	G	A	13	11	24	0	0	24	0	0
20	34747208	.	T	C	15	13	28	0	2	30	0	0
20	34749747	.	G	A	11	22	33	0	0	33	0	0
20	34772027	.	C	G	1	3	4	0	0	4	0	0
20	34777607	.	C	T	1	4	5	0	0	5	0	0
20	34779183	.	C	T	3	5	8	0	0	8	0	0
20	34794668	.	T	C	6	6	12	0	0	12	0	0
20	34794939	.	C	T	26	29	55	0	1	56	0	0
20	34795111	.	C	A	33	33	66	0	1	67	0	0
20	34795126	.	A	G	31	34	65	0	2	67	0	0
20	34795296	.	T	C	29	32	61	0	1	62	0	0
20	34795379	.	T	C	35	33	68	0	1	69	0	0
20	34795473	.	C	T	6	30	36	0	26	62	0	0
20	34795689	.	C	T	38	34	72	0	8	80	0	0
20	34797252	.	G	T	40	47	87	0	2	89	0	0
20	34797598	.	A	T	36	30	66	0	5	71	0	0
20	34955791	.	C	T	40	27	67	1	3	72	1	0
20	34956159	.	A	T	19	11	30	0	0	30	0	0
20	34956164	.	T	A	21	12	33	0	1	34	0	0
20	34967476	.	T	C	5	0	5	0	6	11	0	0
20	34969773	.	A	T	15	21	36	0	0	36	0	0
20	34975831	.	G	A	10	19	29	0	0	29	0	0
20	34980452	.	T	C	12	17	29	0	0	29	0	0
20	34982018	.	C	T	12	11	23	0	1	24	0	0
20	34982323	.	T	A	10	15	25	0	1	26	0	0
20	34985368	.	C	A	6	11	17	0	9	26	0	0
20	34985384	.	C	T	6	12	18	0	8	26	0	0
20	34985424	.	T	G	8	19	27	0	0	27	0	0
20	34985462	.	A	G	14	15	29	0	0	29	0	0
20	34985480	.	A	T	17	6	23	0	2	25	0	0
20	34985499	.	A	C	14	5	19	0	0	19	0	0
20	34991739	.	T	A	1	2	3	0	1	4	0	0
20	34991804	.	C	T	3	2	5	0	2	7	0	0
20	34993974	.	G	A	4	3	7	0	0	7	0	0
20	35001423	.	G	A	5	6	11	0	0	11	0	0
20	35007466	.	A	G	3	3	6	0	0	6	0	0
20	35008816	.	G	A	4	2	6	0	0	6	0	0
20	35011946	.	C	T	8	2	10	0	2	12	0	0
20	35019062	.	A	T	1	2	3	0	0	3	0	0
20	35019357	.	G	A	4	2	6	0	0	6	0	0
20	35019578	.	T	C	3	2	5	0	0	5	0	0
20	35020427	.	T	G	2	2	4	0	0	4	0	0
20	35030676	.	T	C	1	3	4	0	0	4	0	0
20	35059085	.	G	A	3	13	16	2	21	39	0	0
20	35064469	.	T	C	19	22	41	0	0	41	0	0
20	35064808	.	C	T	19	24	43	0	0	43	0	0
20	35065345	.	G	A	1	17	18	0	20	38	0	0
20	35065573	.	A	C	21	16	37	0	7	44	0	0
20	35066821	.	G	A	3	26	29	0	30	59	0	0
20	35066935	.	G	A	2	23	25	0	25	50	0	0
20	35068064	.	A	G	29	0	29	0	34	63	0	0
20	35068790	.	A	T	8	8	16	0	1	17	0	0
20	35069063	.	A	C	9	11	20	0	4	25	1	0
20	35069756	.	A	G	16	10	26	0	0	26	0	0
20	35069963	.	A	C	24	16	40	0	0	40	0	0
20	35070176	.	C	T	14	22	36	0	1	37	0	0
20	35070217	.	T	G	19	25	44	0	0	44	0	0
20	35086291	.	C	T	3	2	5	0	0	5	0	0
20	35131977	.	G	A	4	7	11	0	1	12	0	0
20	35142856	.	A	G	6	7	13	0	0	13	0	0
20	35159500	.	C	A	12	5	17	0	1	18	0	0
20	35159707	.	T	C	5	8	13	0	0	13	0	0
20	35159766	.	C	T	4	6	10	0	0	10	0	0
20	35161742	.	G	C	0	4	4	0	5	9	0	0
20	35162012	.	T	G	12	5	17	0	0	17	0	0
20	35164811	.	A	T	8	6	14	0	0	14	0	0
20	35165533	.	G	A	7	16	23	0	1	24	0	0
20	35173653	.	C	A	5	2	7	0	0	7	0	0
20	35177501	.	T	C	7	6	13	0	1	14	0	0
20	35183406	.	A	G	9	0	9	0	9	18	0	0
20	35184413	.	T	C	11	9	20	0	0	20	0	0
20	35184419	.	T	C	13	7	20	0	0	20	0	0
20	35186620	.	C	T	2	5	7	1	0	8	0	0
20	35186629	.	G	C	0	4	4	1	2	7	0	0
20	35188776	.	G	A	7	5	12	0	0	12	0	0
20	35195535	.	A	G	8	8	16	0	1	17	0	0
20	35198810	.	A	C	9	10	19	0	0	19	0	0
20	35204702	.	A	C	4	7	11	0	1	12	0	0
20	35204729	.	T	C	2	4	6	0	3	9	0	0
20	35204773	.	C	T	3	8	11	0	0	11	0	0
20	35204814	.	A	G	2	2	4	0	8	12	0	0
20	35204848	.	T	G	4	7	11	0	0	11	0	0
20	35204944	.	G	A	5	9	14	0	2	16	0	0
20	35205061	.	C	T	12	7	19	0	1	20	0	0
20	35205182	.	T	C	9	6	15	0	0	15	0	0
20	35205361	.	T	A	4	3	7	0	0	7	0	0
20	35205600	.	A	T	12	11	23	0	0	23	0	0
20	35205680	.	A	G	9	8	17	0	1	18	0	0
20	35206101	.	A	T	10	8	18	0	1	19	0	0
20	35208046	.	A	G	6	3	9	0	2	11	0	0
20	35209012	.	G	A	1	4	5	0	0	5	0	0
20	35209080	.	T	A	2	3	5	0	0	5	0	0
20	35209405	.	C	T	10	7	17	0	0	17	0	0
20	35209481	.	G	A	11	13	24	0	0	24	0	0
20	35210175	.	C	A	12	9	21	0	0	21	0	0
20	35210212	.	G	T	8	7	15	0	1	16	0	0
20	35210229	.	A	C	5	5	10	0	0	10	0	0
20	35210282	.	T	C	2	0	2	0	7	9	0	0
20	35210299	.	T	C	6	0	6	0	3	9	0	0
20	35210575	.	C	T	4	5	9	0	0	9	0	0
20	35210649	.	A	G	11	4	15	0	1	16	0	0
20	35210690	.	A	G	4	3	7	0	1	8	0	0
20	35210781	.	A	G	4	7	11	0	0	11	0	0
20	35210853	.	A	T	4	6	10	0	0	10	0	0
20	35210909	.	T	C	3	5	8	0	0	8	0	0
20	35211015	.	T	A	4	5	9	0	1	10	0	0
20	35211062	.	A	G	3	3	6	0	1	7	0	0
20	35211153	.	A	G	8	9	17	0	1	18	0	0
20	35211399	.	G	A	5	6	11	0	1	12	0	0
20	35211515	.	C	T	1	6	7	0	6	13	0	0
20	35211760	.	G	A	9	9	18	0	0	18	0	0
20	35212128	.	G	T	5	2	7	0	1	8	0	0
20	35212168	.	A	G	3	5	8	0	0	8	0	0
20	35212366	.	T	C	2	4	6	0	2	8	0	0
20	35212398	.	A	G	3	5	8	0	1	9	0	0
20	35212654	.	A	T	2	2	4	0	0	4	0	0
20	35212860	.	A	T	6	3	9	0	1	10	0	0
20	35215671	.	C	T	7	7	14	0	1	15	0	0
20	35215680	.	T	G	6	7	13	0	0	14	1	0
20	35226167	.	C	A	5	4	9	0	0	9	0	0
20	35226554	.	T	G	6	6	12	0	0	12	0	0
20	35226587	.	G	C	4	0	4	0	5	9	0	0
20	35226665	.	T	C	4	4	8	0	0	8	0	0
20	35227256	.	C	G	1	4	5	0	0	5	0	0
20	35243721	.	T	C	2	0	2	0	6	8	0	0
20	35245968	.	T	A	4	2	6	0	0	6	0	0
20	35245969	.	T	G	4	2	6	0	0	6	0	0
20	35295208	.	C	T	8	4	12	0	0	12	0	0
20	35296980	.	T	C	6	7	13	0	0	13	0	0
20	35297212	.	T	G	9	0	9	0	9	18	0	0
20	35297693	.	G	A	8	5	13	0	2	15	0	0
20	35297699	.	A	G	7	8	15	0	0	15	0	0
20	35297870	.	T	C	4	2	6	0	1	8	1	0
20	35392100	.	C	T	29	39	68	0	6	74	0	0
20	35427409	.	G	C	36	22	58	0	0	58	0	0
20	35427536	.	G	C	2	5	7	0	1	8	0	0
20	35427676	.	T	G	21	1	22	0	43	65	0	0
20	35427745	.	A	G	29	4	33	0	33	66	0	0
20	35427782	.	T	C	29	33	62	0	1	63	0	0
20	35427907	.	C	G	26	29	55	0	1	57	1	0
20	35427946	.	A	G	22	4	26	0	31	57	0	0
20	35428035	.	A	G	36	19	55	0	1	57	1	0
20	35428436	.	G	A	30	36	66	0	5	71	0	0
20	35428633	.	T	C	39	29	68	0	3	71	0	0
20	35428802	.	A	G	18	46	64	0	4	68	0	0
20	35429017	.	T	A	35	8	43	0	0	43	0	0
20	35429054	.	A	G	33	1	34	0	33	67	0	0
20	35429610	.	A	T	34	36	70	0	1	71	0	0
20	35433311	.	A	G	20	1	21	0	31	52	0	0
20	35798370	.	G	A	16	18	34	0	1	35	0	0
20	35798697	.	A	T	5	3	8	0	2	10	0	0
20	35799001	.	A	G	6	6	12	0	0	12	0	0
20	35799135	.	G	A	9	9	18	0	1	19	0	0
20	35799291	.	G	C	6	6	12	0	1	13	0	0
20	35799534	.	T	C	10	9	19	0	0	19	0	0
20	35799612	.	A	T	13	6	19	0	2	21	0	0
20	35799673	.	T	A	12	15	27	0	1	28	0	0
20	35799729	.	T	A	15	12	27	0	1	28	0	0
20	35799751	.	G	A	18	8	26	0	0	26	0	0
20	35799889	.	A	T	15	9	24	0	0	24	0	0
20	35799913	.	T	G	15	5	20	0	0	20	0	0
20	35800032	.	G	A	15	5	20	0	8	28	0	0
20	35800042	.	T	G	15	10	25	0	6	31	0	0
20	35800098	.	G	A	16	18	34	0	0	34	0	0
20	35800338	.	T	G	12	6	18	0	0	18	0	0
20	35800349	.	C	T	8	7	15	0	0	15	0	0
20	35800520	.	G	A	8	7	15	0	0	15	0	0
20	35800557	.	G	A	9	4	13	0	0	13	0	0
20	35800564	.	T	C	8	4	12	0	0	12	0	0
20	35800749	.	G	A	12	8	20	0	1	21	0	0
20	35816533	.	A	G	9	6	15	0	1	16	0	0
20	35816534	.	A	G	9	6	15	0	1	16	0	0
20	35827930	.	A	G	6	7	13	0	1	14	0	0
20	35827945	.	G	C	8	8	16	0	0	16	0	0
20	35831719	.	C	T	7	14	21	0	0	21	0	0
20	35841393	.	C	T	8	9	17	0	0	17	0	0
20	35923939	.	C	T	2	2	4	0	0	4	0	0
20	35941146	.	G	A	2	4	6	0	4	10	0	0
20	35942981	.	T	C	6	6	12	0	0	12	0	0
20	35957401	.	C	A	4	7	11	0	0	11	0	0
20	35972539	.	T	C	2	6	8	0	1	9	0	0
20	35972544	.	G	A	3	6	9	0	0	9	0	0
20	35979899	.	G	T	3	2	5	0	0	5	0	0
20	35979910	.	T	G	2	2	4	0	0	4	0	0
20	36067796	.	C	T	0	3	3	0	4	7	0	0
20	36067823	.	T	C	2	2	4	0	0	4	0	0
20	36068464	.	T	C	2	0	2	0	3	5	0	0
20	36068980	.	G	A	2	5	7	0	0	7	0	0
20	36069181	.	A	G	2	2	4	0	0	4	0	0
20	36069265	.	C	T	0	2	2	0	2	4	0	0
20	36069295	.	A	G	2	4	6	0	0	6	0	0
20	36069553	.	A	G	4	2	6	0	0	6	0	0
20	36069601	.	C	T	4	2	6	0	1	7	0	0
20	36233931	.	C	T	12	11	23	0	1	24	0	0
20	36234084	.	C	A	4	3	7	0	2	9	0	0
20	36290217	.	C	T	10	5	15	0	1	16	0	0
20	36297356	.	G	A	1	15	16	0	17	33	0	0
20	36297418	.	C	A	12	18	30	0	0	30	0	0
20	36297871	.	A	T	7	9	16	0	0	16	0	0
20	36394844	.	G	A	0	1	1	0	1	2	0	0
20	36394856	.	A	T	1	2	3	0	0	3	0	0
20	36395801	.	A	C	2	3	5	0	0	5	0	0
20	36395833	.	T	C	2	4	6	0	0	6	0	0
20	36395895	.	G	A	2	4	6	0	0	6	0	0
20	36396668	.	A	G	4	6	10	0	0	10	0	0
20	36399539	.	T	C	4	0	4	0	3	7	0	0
20	36403820	.	T	A	9	3	12	0	0	12	0	0
20	36420218	.	A	C	15	5	20	0	1	21	0	0
20	36420713	.	C	T	1	12	13	0	13	26	0	0
20	36420753	.	T	A	13	13	26	0	1	27	0	0
20	36420804	.	G	T	19	10	29	0	2	31	0	0
20	36421219	.	G	A	23	5	28	0	2	30	0	0
20	36421238	.	C	T	20	14	34	0	1	35	0	0
20	36421530	.	A	C	14	0	14	0	10	24	0	0
20	36421757	.	C	T	0	13	13	0	7	20	0	0
20	36422098	.	C	A	14	14	28	0	0	28	0	0
20	36422146	.	G	C	12	14	26	0	1	27	0	0
20	36422291	.	G	T	13	7	20	0	0	20	0	0
20	36424252	.	T	C	9	13	22	0	2	24	0	0
20	36424273	.	G	A	8	12	20	0	0	20	0	0
20	36434308	.	A	G	15	14	29	0	1	30	0	0
20	36439858	.	A	C	7	5	12	0	2	14	0	0
20	36440170	.	C	T	2	13	15	0	15	30	0	0
20	36449286	.	G	A	20	11	31	0	1	32	0	0
20	36449385	.	C	T	18	13	31	0	3	34	0	0
20	36449442	.	A	C	17	17	34	0	2	36	0	0
20	36449601	.	C	T	17	11	28	0	1	29	0	0
20	36491016	.	T	C	12	14	26	0	0	26	0	0
20	36559761	.	T	G	4	6	10	0	0	10	0	0
20	36623850	.	C	T	6	2	8	0	0	8	0	0
20	36623860	.	T	A	6	6	12	0	1	13	0	0
20	36626195	.	A	G	15	0	15	0	14	29	0	0
20	36626218	.	C	T	13	11	24	0	1	25	0	0
20	36626248	.	G	A	13	10	23	0	1	24	0	0
20	36626335	.	C	T	17	7	24	0	1	25	0	0
20	36626354	.	C	A	20	5	25	0	0	25	0	0
20	36626465	.	C	T	6	4	10	0	1	11	0	0
20	36629175	.	T	C	1	2	3	0	0	3	0	0
20	36637604	.	T	A	7	6	13	0	1	14	0	0
20	36637657	.	A	C	3	4	7	0	2	9	0	0
20	36637751	.	A	C	4	5	9	0	0	9	0	0
20	36637770	.	A	C	3	3	6	0	0	6	0	0
20	36637999	.	G	A	3	3	6	0	0	6	0	0
20	36638033	.	G	T	3	5	8	0	0	8	0	0
20	36638138	.	C	G	4	3	7	0	0	7	0	0
20	36647218	.	T	C	3	7	10	0	1	11	0	0
20	36649769	.	C	G	4	2	6	0	0	6	0	0
20	36657824	.	C	T	2	2	4	0	0	4	0	0
20	36660896	.	T	C	4	4	8	0	0	8	0	0
20	36675294	.	G	C	6	1	7	0	4	11	0	0
20	36675456	.	G	A	16	7	23	0	0	23	0	0
20	36675468	.	C	T	10	9	19	0	0	19	0	0
20	36677457	.	C	T	5	6	11	0	0	11	0	0
20	36677574	.	G	A	16	7	23	0	0	23	0	0
20	36766231	.	T	C	2	4	6	0	0	6	0	0
20	36767473	.	A	G	2	0	2	0	3	5	0	0
20	36768736	.	T	C	5	4	9	0	0	9	0	0
20	36773807	.	A	G	9	6	15	0	0	15	0	0
20	36773918	.	A	G	6	0	6	0	10	16	0	0
20	36773984	.	A	G	3	0	3	0	8	11	0	0
20	36783480	.	C	T	5	8	13	0	0	13	0	0
20	36785477	.	G	A	9	4	13	0	2	15	0	0
20	36788775	.	C	T	7	4	11	0	1	12	0	0
20	36791885	.	C	T	11	11	22	0	0	22	0	0
20	36792123	.	T	C	6	5	11	0	0	11	0	0
20	36798128	.	T	A	2	3	5	0	0	5	0	0
20	36798154	.	C	G	4	3	7	0	0	7	0	0
20	36816471	.	G	A	7	7	14	0	0	14	0	0
20	36816522	.	G	A	10	6	16	0	0	16	0	0
20	36817095	.	T	A	1	1	2	0	2	4	0	0
20	36817101	.	A	G	2	3	5	0	0	5	0	0
20	36817184	.	G	A	0	4	4	0	5	9	0	0
20	36821214	.	A	G	11	12	23	0	2	25	0	0
20	36828833	.	T	C	7	4	11	0	0	11	0	0
20	36828948	.	A	C	7	8	15	0	1	16	0	0
20	36829040	.	T	C	5	9	14	0	1	15	0	0
20	36829208	.	T	C	9	6	15	0	1	16	0	0
20	36829517	.	T	G	11	0	11	0	9	20	0	0
20	36838717	.	C	T	7	4	11	0	0	11	0	0
20	36838805	.	C	T	6	2	8	0	0	8	0	0
20	36838871	.	C	T	6	14	20	0	0	20	0	0
20	36838896	.	A	G	5	10	15	0	0	15	0	0
20	36915481	.	G	A	6	7	13	0	0	13	0	0
20	36915529	.	G	A	13	6	19	0	0	19	0	0
20	36916004	.	G	A	13	11	24	0	0	24	0	0
20	36916050	.	A	G	11	7	18	0	0	18	0	0
20	36917631	.	C	T	6	9	15	0	0	15	0	0
20	37300862	.	G	C	1	8	9	0	11	20	0	0
20	37332669	.	T	A	9	5	14	0	2	16	0	0
20	37358885	.	G	A	2	9	11	0	20	31	0	0
20	37376467	.	G	A	0	6	6	0	5	11	0	0
20	37512259	.	G	A	17	14	31	0	3	34	0	0
20	37512503	.	T	G	1	6	7	0	0	7	0	0
20	37513257	.	C	A	18	20	38	0	2	40	0	0
20	37513632	.	A	G	43	27	70	0	0	70	0	0
20	37513702	.	G	A	30	32	62	0	3	65	0	0
20	37513753	.	G	T	31	26	57	0	5	62	0	0
20	37515525	.	G	T	19	21	40	0	1	41	0	0
20	37515607	.	T	G	19	18	37	0	2	39	0	0
20	37516363	.	C	T	31	22	53	0	1	54	0	0
20	37517962	.	T	C	26	1	27	0	29	56	0	0
20	37518718	.	A	T	15	20	35	0	0	35	0	0
20	37518823	.	A	G	19	13	32	0	1	33	0	0
20	37519399	.	G	A	16	15	31	0	1	32	0	0
20	37519429	.	A	T	13	13	26	0	0	26	0	0
20	37519453	.	G	T	11	13	24	0	0	24	0	0
20	37521010	.	T	C	17	0	17	0	14	31	0	0
20	37533137	.	C	T	18	21	39	3	0	42	0	0
20	37627953	.	G	A	9	4	13	0	0	13	0	0
20	37736409	.	T	G	5	10	15	0	1	16	0	0
20	37751961	.	A	C	2	2	4	0	0	4	0	0
20	37757085	.	G	A	3	3	6	0	0	6	0	0
20	37760614	.	C	A	2	11	13	0	0	13	0	0
20	37761205	.	C	T	4	10	14	0	0	14	0	0
20	37764120	.	A	G	1	0	1	0	2	3	0	0
20	37764309	.	C	G	4	5	9	0	0	9	0	0
20	37764500	.	C	A	7	4	11	0	0	11	0	0
20	37768543	.	G	A	13	11	24	0	1	25	0	0
20	37768844	.	G	T	6	10	16	0	0	16	0	0
20	37768862	.	T	C	5	7	12	0	0	12	0	0
20	37768997	.	A	T	3	10	13	0	1	14	0	0
20	37769084	.	A	G	5	4	9	0	0	9	0	0
20	37769099	.	C	A	4	5	9	0	1	10	0	0
20	37796387	.	T	C	4	8	12	0	0	12	0	0
20	37796473	.	A	C	4	4	8	0	0	8	0	0
20	37798805	.	A	G	10	3	13	0	0	13	0	0
20	37798860	.	A	C	2	4	6	0	0	6	0	0
20	37798912	.	G	A	2	2	4	0	1	5	0	0
20	37799164	.	A	T	2	2	4	0	0	4	0	0
20	37799880	.	G	A	1	2	3	0	0	3	0	0
20	37799931	.	C	T	1	2	3	0	1	4	0	0
20	37800100	.	A	C	8	6	14	0	0	14	0	0
20	37825839	.	C	T	2	2	4	0	0	4	0	0
20	37826103	.	A	G	1	0	1	0	2	3	0	0
20	37831776	.	T	C	1	2	3	0	0	3	0	0
20	37859577	.	T	C	8	13	21	0	0	21	0	0
20	37862303	.	C	G	3	2	5	0	0	6	1	0
20	37862414	.	T	C	8	6	14	0	1	15	0	0
20	37866514	.	C	T	7	11	18	1	1	20	0	0
20	37866655	.	A	G	6	3	9	0	0	9	0	0
20	37884692	.	A	G	5	0	5	0	6	11	0	0
20	37896247	.	T	C	5	6	11	0	0	11	0	0
20	37896256	.	T	C	5	6	11	0	0	11	0	0
20	37899220	.	A	G	7	11	18	0	1	19	0	0
20	37912862	.	C	G	4	3	7	0	0	7	0	0
20	37912863	.	C	A	4	3	7	0	0	7	0	0
20	37913335	.	A	T	6	6	12	0	0	12	0	0
20	37913410	.	A	C	2	8	10	0	0	10	0	0
20	37913552	.	T	C	3	3	6	0	0	6	0	0
20	37913572	.	A	T	4	4	8	0	2	10	0	0
20	37913752	.	T	C	10	4	14	0	0	14	0	0
20	37913866	.	A	G	6	12	18	0	0	18	0	0
20	37913868	.	T	C	11	7	18	0	0	18	0	0
20	37913988	.	T	G	13	9	22	0	0	22	0	0
20	37914001	.	A	G	12	7	19	0	0	19	0	0
20	37914025	.	A	G	12	0	12	0	6	18	0	0
20	37914048	.	G	C	8	8	16	0	0	16	0	0
20	37914145	.	C	T	8	16	24	0	0	24	0	0
20	37914395	.	A	G	8	3	11	0	0	11	0	0
20	37914497	.	T	C	7	3	10	0	1	11	0	0
20	37914517	.	C	T	8	3	11	0	1	12	0	0
20	37914651	.	C	T	11	10	21	0	0	21	0	0
20	37914668	.	G	T	12	9	21	0	1	22	0	0
20	37914709	.	A	C	8	6	14	0	0	14	0	0
20	37914722	.	C	T	10	4	14	0	0	14	0	0
20	37914750	.	C	A	13	4	17	0	0	17	0	0
20	37914855	.	T	G	16	7	23	0	0	23	0	0
20	37914913	.	A	G	18	11	29	0	1	30	0	0
20	37914924	.	T	C	21	11	32	0	1	33	0	0
20	37915005	.	A	C	9	3	12	0	1	13	0	0
20	37915027	.	C	T	13	3	16	0	0	16	0	0
20	37915080	.	T	A	8	7	15	0	0	15	0	0
20	37915097	.	C	G	7	9	16	0	0	16	0	0
20	37915237	.	C	T	11	12	23	0	0	23	0	0
20	37915292	.	A	G	8	8	16	0	0	16	0	0
20	37915465	.	A	G	12	0	12	0	8	20	0	0
20	37915733	.	C	T	12	5	17	3	1	21	0	0
20	37915859	.	C	T	7	3	10	1	5	16	0	0
20	37920487	.	C	A	5	3	8	0	0	8	0	0
20	37920726	.	A	G	10	10	20	0	0	20	0	0
20	37920773	.	T	C	4	6	10	0	0	10	0	0
20	37925455	.	A	C	9	4	13	0	1	14	0	0
20	37928465	.	C	T	0	4	4	0	6	10	0	0
20	37928510	.	C	G	2	7	9	0	0	9	0	0
20	37930514	.	C	G	9	4	13	0	0	13	0	0
20	37930593	.	A	G	5	6	11	0	1	12	0	0
20	37930605	.	A	G	5	6	11	0	1	12	0	0
20	37930672	.	C	G	4	5	9	0	1	10	0	0
20	37934174	.	A	G	3	3	6	0	1	7	0	0
20	37934178	.	C	A	3	4	7	0	0	7	0	0
20	37934248	.	G	T	3	3	6	0	0	6	0	0
20	38045807	.	T	G	11	10	21	0	1	22	0	0
20	38045859	.	G	T	14	9	23	0	0	23	0	0
20	38076127	.	G	A	0	7	7	0	4	11	0	0
20	38076495	.	G	A	2	5	7	0	1	8	0	0
20	38086653	.	A	G	9	11	20	0	0	20	0	0
20	38091814	.	C	T	13	9	22	0	0	22	0	0
20	38091838	.	G	A	10	10	20	0	0	20	0	0
20	38099500	.	C	T	12	6	18	0	3	21	0	0
20	38201945	.	T	G	7	6	13	0	0	13	0	0
20	38202064	.	G	A	1	9	10	0	11	21	0	0
20	38202135	.	G	T	13	6	19	0	0	19	0	0
20	38202183	.	C	A	12	8	20	0	1	21	0	0
20	38202228	.	T	C	7	15	22	0	2	24	0	0
20	38210484	.	C	T	5	10	15	0	1	16	0	0
20	38210544	.	C	T	4	11	15	2	3	20	0	0
20	38216798	.	C	T	8	9	17	0	0	17	0	0
20	38240907	.	G	A	17	13	30	0	0	30	0	0
20	38241264	.	C	T	8	14	22	0	0	22	0	0
20	38241430	.	G	A	2	3	5	0	0	5	0	0
20	38241508	.	C	T	5	3	8	0	1	9	0	0
20	38241567	.	T	A	4	12	16	0	1	17	0	0
20	38241825	.	T	G	4	8	12	0	0	12	0	0
20	38241843	.	A	G	7	3	10	0	1	11	0	0
20	38322489	.	C	T	8	7	15	0	0	15	0	0
20	38358534	.	T	C	14	10	24	1	1	26	0	0
20	38358657	.	A	C	16	8	24	0	2	26	0	0
20	38358691	.	G	A	14	8	22	0	1	23	0	0
20	38358752	.	C	T	12	6	18	0	0	18	0	0
20	38358755	.	G	C	1	6	7	0	11	18	0	0
20	38358866	.	T	C	4	6	10	0	2	12	0	0
20	38358955	.	A	T	2	10	12	0	0	12	0	0
20	38359137	.	A	T	6	2	8	0	0	8	0	0
20	38359152	.	C	T	5	4	9	0	1	10	0	0
20	38359181	.	T	C	6	7	13	0	0	13	0	0
20	38359235	.	G	A	0	7	7	0	10	17	0	0
20	38359258	.	G	A	8	7	15	0	2	17	0	0
20	38387193	.	A	G	1	3	4	0	0	4	0	0
20	38393472	.	T	A	1	2	3	0	0	3	0	0
20	38458149	.	C	T	5	11	16	0	1	17	0	0
20	38473763	.	T	C	18	5	23	0	1	24	0	0
20	38473805	.	A	T	7	15	22	0	0	22	0	0
20	38473817	.	C	T	14	11	25	0	0	25	0	0
20	38473886	.	T	C	9	10	19	0	0	19	0	0
20	38473940	.	T	G	16	0	16	0	9	25	0	0
20	38517640	.	C	T	17	13	30	0	0	30	0	0
20	38518993	.	G	T	1	2	3	0	0	3	0	0
20	38532334	.	C	T	3	2	5	0	0	5	0	0
20	38538098	.	G	C	4	2	6	0	0	6	0	0
20	38538248	.	C	T	6	5	11	0	1	12	0	0
20	38538249	.	G	A	5	7	12	0	0	12	0	0
20	38538471	.	G	A	0	2	2	0	2	4	0	0
20	38545499	.	C	T	1	2	3	0	0	3	0	0
20	38583632	.	G	A	0	2	2	0	3	5	0	0
20	38583911	.	A	T	3	4	7	0	0	7	0	0
20	38625973	.	C	T	2	6	8	0	0	8	0	0
20	38647270	.	T	A	3	7	10	0	0	10	0	0
20	38657825	.	T	C	10	11	21	0	1	22	0	0
20	38662649	.	A	G	17	8	25	0	1	26	0	0
20	38665194	.	G	A	12	12	24	0	3	27	0	0
20	38669294	.	T	C	7	8	15	0	0	15	0	0
20	38669329	.	A	G	5	0	5	0	9	14	0	0
20	38669406	.	C	A	5	4	9	0	0	9	0	0
20	38669453	.	C	G	4	3	7	0	1	8	0	0
20	38669481	.	C	T	4	3	7	0	1	8	0	0
20	38669562	.	C	T	4	5	9	0	0	9	0	0
20	38669869	.	T	G	1	5	6	0	1	7	0	0
20	38669888	.	T	A	2	4	6	0	0	6	0	0
20	38670071	.	C	T	1	5	6	0	1	7	0	0
20	38670100	.	C	T	4	2	6	0	1	7	0	0
20	38670108	.	T	C	7	2	9	0	0	9	0	0
20	38670143	.	C	T	6	7	13	0	0	13	0	0
20	38670157	.	G	A	1	4	5	0	7	12	0	0
20	38726253	.	A	G	18	14	32	0	1	33	0	0
20	38726283	.	C	T	16	6	22	0	2	28	4	0
20	38726399	.	A	C	7	21	28	0	0	28	0	0
20	38726624	.	C	G	12	10	22	0	0	22	0	0
20	38726664	.	C	T	14	10	24	0	1	25	0	0
20	38726721	.	C	A	7	12	19	0	0	19	0	0
20	38726935	.	C	T	9	12	21	0	0	21	0	0
20	38727047	.	A	G	11	10	21	0	0	21	0	0
20	38764192	.	C	A	15	8	23	0	0	23	0	0
20	38764201	.	C	A	13	7	20	0	0	20	0	0
20	38764265	.	A	G	9	11	20	1	0	21	0	0
20	38764992	.	T	C	11	6	17	0	1	18	0	0
20	38765100	.	C	T	0	7	7	0	15	22	0	0
20	38765296	.	T	G	10	6	16	0	0	16	0	0
20	38765318	.	T	C	8	10	18	0	1	19	0	0
20	38765364	.	T	A	14	7	21	0	0	21	0	0
20	38765552	.	C	T	2	18	20	0	14	34	0	0
20	38778463	.	G	A	7	11	18	0	1	19	0	0
20	38787014	.	T	A	12	17	29	0	0	29	0	0
20	38788358	.	C	A	1	2	3	0	1	4	0	0
20	38788624	.	G	A	1	5	6	0	1	7	0	0
20	38788749	.	A	C	5	6	11	0	1	12	0	0
20	38788887	.	G	A	4	10	14	0	0	14	0	0
20	38789855	.	T	C	9	9	18	0	0	18	0	0
20	38790051	.	C	T	2	8	10	0	10	20	0	0
20	38790283	.	A	G	13	8	21	0	0	21	0	0
20	38793405	.	G	A	18	5	23	0	0	23	0	0
20	38793414	.	C	T	2	6	8	0	15	23	0	0
20	38798501	.	A	C	7	12	19	0	1	20	0	0
20	38802704	.	A	G	4	7	11	0	0	11	0	0
20	38808291	.	G	A	4	5	9	0	0	9	0	0
20	38815159	.	T	C	2	4	6	0	0	6	0	0
20	38815968	.	C	A	3	5	8	0	1	9	0	0
20	38816028	.	G	A	5	6	11	0	1	12	0	0
20	38817844	.	G	A	2	5	7	0	0	7	0	0
20	38817847	.	T	C	2	0	2	0	4	6	0	0
20	38817913	.	T	A	2	3	5	0	0	5	0	0
20	38819044	.	C	T	1	3	4	0	3	7	0	0
20	38820134	.	T	C	5	2	7	0	0	7	0	0
20	38820176	.	A	G	4	7	11	0	0	11	0	0
20	38820450	.	G	C	6	0	6	0	8	14	0	0
20	38821208	.	C	T	2	6	8	0	0	8	0	0
20	38822655	.	T	A	2	3	5	0	0	5	0	0
20	38822827	.	G	A	3	6	9	0	0	9	0	0
20	38841113	.	G	T	5	3	8	0	1	9	0	0
20	38842383	.	A	G	1	5	6	0	0	6	0	0
20	38845182	.	C	A	1	2	3	0	0	3	0	0
20	38854083	.	C	T	5	5	10	0	0	10	0	0
20	38857230	.	A	G	4	3	7	0	1	8	0	0
20	38857772	.	C	T	4	5	9	0	1	10	0	0
20	38857835	.	C	T	6	2	8	0	0	8	0	0
20	38857889	.	A	G	3	4	7	0	0	7	0	0
20	38861536	.	T	C	7	4	11	0	0	11	0	0
20	38861646	.	T	C	4	6	10	0	0	10	0	0
20	38864559	.	A	G	8	6	14	0	0	14	0	0
20	38864684	.	A	G	7	3	10	0	0	10	0	0
20	38866779	.	T	C	6	3	9	0	0	9	0	0
20	38871129	.	A	G	5	9	14	0	0	14	0	0
20	38872436	.	T	C	3	9	12	0	0	12	0	0
20	38877848	.	G	A	1	6	7	0	0	7	0	0
20	38884042	.	C	T	2	2	4	0	0	4	0	0
20	38910374	.	A	G	14	9	23	0	1	24	0	0
20	39045960	.	A	T	11	9	20	0	0	20	0	0
20	39046032	.	T	C	10	6	16	0	0	16	0	0
20	39052063	.	A	T	9	11	20	0	0	20	0	0
20	39052100	.	T	A	13	13	26	0	0	26	0	0
20	39052254	.	C	T	1	29	30	0	17	47	0	0
20	39052505	.	C	A	12	19	31	0	0	31	0	0
20	39055706	.	T	A	10	11	21	0	0	21	0	0
20	39055731	.	G	T	11	9	20	0	1	21	0	0
20	39055868	.	T	A	14	14	28	0	2	30	0	0
20	39081196	.	A	G	20	12	32	0	4	36	0	0
20	39081322	.	C	T	9	20	29	0	1	30	0	0
20	39191708	.	C	T	8	3	11	0	0	11	0	0
20	39210086	.	C	T	0	3	3	1	3	7	0	0
20	39213881	.	A	G	3	2	5	0	0	5	0	0
20	39216188	.	G	A	1	2	3	0	0	3	0	0
20	39219507	.	T	A	1	3	4	0	0	4	0	0
20	39235195	.	A	G	4	1	5	0	9	14	0	0
20	39254961	.	A	G	5	0	5	1	7	13	0	0
20	39256515	.	A	G	6	7	13	0	0	13	0	0
20	39256735	.	G	A	0	11	11	0	8	19	0	0
20	39256968	.	C	T	7	4	11	0	3	14	0	0
20	39257053	.	G	A	5	2	7	0	0	7	0	0
20	39259491	.	C	T	0	4	4	0	1	5	0	0
20	39259836	.	G	A	1	9	10	0	0	10	0	0
20	39260535	.	C	T	2	2	4	0	6	10	0	0
20	39260556	.	T	C	1	0	1	0	8	9	0	0
20	39260755	.	C	T	23	20	43	0	1	44	0	0
20	39260837	.	G	A	20	29	49	0	2	51	0	0
20	39260865	.	T	G	24	34	58	0	1	59	0	0
20	39267227	.	T	G	18	19	37	0	1	38	0	0
20	39271725	.	T	C	22	24	46	0	2	48	0	0
20	39271731	.	G	A	29	18	47	0	4	51	0	0
20	39271833	.	C	G	33	16	49	0	3	52	0	0
20	39273910	.	A	T	22	27	49	0	3	53	1	0
20	39338845	.	C	T	3	3	6	0	0	6	0	0
20	39338929	.	C	T	4	5	9	0	0	9	0	0
20	39338965	.	T	C	7	6	13	0	0	13	0	0
20	39338981	.	G	T	8	7	15	0	1	17	1	0
20	39339030	.	T	C	7	6	13	0	1	14	0	0
20	39339169	.	A	G	9	9	18	0	0	18	0	0
20	39341517	.	G	A	10	10	20	0	0	20	0	0
20	39341520	.	T	C	10	9	19	0	0	19	0	0
20	39343397	.	T	C	9	8	17	0	2	19	0	0
20	39344011	.	C	A	6	5	11	0	1	12	0	0
20	39344085	.	T	C	9	8	17	0	1	18	0	0
20	39513664	.	A	G	3	2	5	0	0	5	0	0
20	39520783	.	A	C	3	2	5	0	0	5	0	0
20	39520835	.	T	C	2	4	6	0	0	6	0	0
20	39554698	.	G	A	1	3	4	0	0	4	0	0
20	39557001	.	A	G	3	5	8	0	0	8	0	0
20	39579329	.	A	G	3	2	5	0	0	5	0	0
20	39582056	.	A	T	3	4	7	0	0	7	0	0
20	40466821	.	C	A	0	63	63	0	1	64	0	0
20	40466840	.	T	C	66	2	68	0	2	70	0	0
20	41237380	.	A	G	4	0	4	0	9	13	0	0
20	41237909	.	A	G	5	2	7	0	0	7	0	0
20	41998507	.	T	C	22	8	30	0	1	31	0	0
20	42047386	.	C	T	9	6	15	0	1	16	0	0
20	42100882	.	G	A	8	9	17	0	0	17	0	0
20	42203254	.	C	T	6	5	11	0	0	11	0	0
20	42203407	.	G	T	14	9	23	0	0	23	0	0
20	42203461	.	T	C	16	15	31	0	1	32	0	0
20	42203465	.	T	C	20	14	34	0	1	35	0	0
20	42221216	.	C	A	0	5	5	1	1	7	0	0
20	42221269	.	T	C	4	6	10	0	2	12	0	0
20	42221360	.	G	A	5	2	7	0	0	7	0	0
20	42221555	.	C	T	16	23	39	0	0	39	0	0
20	42221713	.	C	T	12	4	16	0	2	18	0	0
20	42221731	.	T	G	7	5	12	0	3	15	0	0
20	42221834	.	A	T	3	3	6	0	0	6	0	0
20	42221836	.	G	A	3	3	6	0	0	6	0	0
20	42221964	.	A	C	4	3	7	0	1	8	0	0
20	42222113	.	A	G	2	4	6	0	0	6	0	0
20	42222296	.	A	C	6	9	15	0	0	15	0	0
20	42222444	.	A	T	2	4	6	0	0	6	0	0
20	42222546	.	A	T	9	3	12	0	1	13	0	0
20	42222549	.	A	T	10	3	13	0	1	14	0	0
20	42222621	.	T	C	17	7	24	0	0	24	0	0
20	42222770	.	T	C	2	6	8	0	0	8	0	0
20	42222816	.	C	A	5	7	12	0	0	12	0	0
20	42222883	.	T	C	6	8	14	0	0	14	0	0
20	42223467	.	G	T	7	4	11	0	2	13	0	0
20	42223480	.	A	T	8	4	12	0	0	12	0	0
20	42232554	.	A	G	3	12	15	0	0	15	0	0
20	42233955	.	G	C	5	4	9	0	0	9	0	0
20	42241224	.	T	G	8	8	16	0	1	17	0	0
20	42247018	.	G	C	11	9	20	0	1	21	0	0
20	42247180	.	T	C	10	6	16	0	0	16	0	0
20	42247231	.	G	A	6	6	12	0	0	12	0	0
20	42280782	.	C	T	9	6	15	0	0	15	0	0
20	42280829	.	C	T	11	10	21	0	0	21	0	0
20	42281000	.	G	A	1	10	11	0	9	20	0	0
20	42281369	.	G	A	5	8	13	0	0	13	0	0
20	42281383	.	C	T	5	8	13	0	0	13	0	0
20	42297042	.	T	C	2	0	2	0	3	5	0	0
20	42297141	.	A	G	4	2	6	0	0	6	0	0
20	42299414	.	A	T	1	2	3	0	1	4	0	0
20	42300015	.	T	A	4	3	7	0	0	7	0	0
20	42300042	.	G	A	1	3	4	0	0	4	0	0
20	42304274	.	T	C	2	0	2	0	2	4	0	0
20	42581572	.	T	C	1	2	3	0	0	3	0	0
20	42581573	.	G	A	1	2	3	0	0	3	0	0
20	42587990	.	C	T	4	4	8	0	0	8	0	0
20	42592311	.	C	T	1	2	3	0	0	3	0	0
20	42602236	.	C	G	1	2	3	0	0	3	0	0
20	42602500	.	A	T	1	3	4	0	0	4	0	0
20	42613380	.	G	T	0	3	3	0	6	9	0	0
20	42613389	.	C	T	5	3	8	0	1	9	0	0
20	42614346	.	T	C	7	4	11	0	0	11	0	0
20	42617242	.	A	T	4	7	11	0	0	11	0	0
20	42619333	.	C	T	2	2	4	0	0	4	0	0
20	42624136	.	C	T	2	3	5	0	0	5	0	0
20	42624460	.	T	A	4	6	10	0	0	10	0	0
20	42627360	.	T	C	5	4	9	0	0	9	0	0
20	42629476	.	C	G	5	0	5	0	7	12	0	0
20	42631258	.	T	A	5	4	9	0	3	12	0	0
20	42631316	.	G	A	0	4	4	0	8	12	0	0
20	42643690	.	G	A	2	6	8	0	1	9	0	0
20	42650481	.	G	T	0	4	4	0	5	9	0	0
20	42653409	.	C	T	6	8	14	0	0	14	0	0
20	42653523	.	C	T	3	10	13	0	0	13	0	0
20	42660034	.	A	G	8	7	15	0	1	16	0	0
20	42660273	.	C	G	4	0	4	0	2	6	0	0
20	42660491	.	G	T	3	7	10	0	0	10	0	0
20	42687842	.	G	T	1	2	3	0	0	3	0	0
20	42919792	.	G	A	1	3	4	0	8	12	0	0
20	42929574	.	C	T	4	4	8	0	2	10	0	0
20	42929598	.	A	T	5	7	12	0	1	13	0	0
20	42929610	.	G	T	7	5	12	0	0	12	0	0
20	42932464	.	C	T	6	4	10	0	0	10	0	0
20	42939350	.	T	C	8	4	12	0	1	13	0	0
20	42939407	.	G	A	7	6	13	0	1	14	0	0
20	42939814	.	C	T	7	4	11	0	0	11	0	0
20	42939829	.	A	G	5	0	5	0	6	11	0	0
20	42941107	.	T	C	4	3	7	0	0	7	0	0
20	42941176	.	G	T	6	9	15	0	1	16	0	0
20	42943084	.	G	A	3	3	6	0	0	6	0	0
20	42944949	.	T	C	2	3	5	0	0	5	0	0
20	42953084	.	T	C	7	3	10	0	1	11	0	0
20	42953096	.	G	A	4	7	11	0	0	11	0	0
20	42954302	.	G	A	14	6	20	0	0	20	0	0
20	42968811	.	C	T	0	4	4	0	3	7	0	0
20	42969040	.	G	A	3	3	6	0	0	6	0	0
20	42969082	.	T	C	2	4	6	0	1	7	0	0
20	42969171	.	C	T	0	2	2	0	2	4	0	0
20	43012769	.	G	A	2	2	4	0	0	4	0	0
20	43016669	.	G	C	4	2	6	0	0	6	0	0
20	43016739	.	C	T	1	4	5	0	1	6	0	0
20	43016828	.	G	A	1	3	4	0	1	5	0	0
20	43016890	.	T	A	4	2	6	0	0	6	0	0
20	43017200	.	G	A	2	2	4	0	0	4	0	0
20	43017246	.	C	G	3	3	6	0	0	6	0	0
20	43035137	.	C	T	2	2	4	0	1	5	0	0
20	43041067	.	A	G	3	2	5	0	0	5	0	0
20	43073375	.	T	C	2	2	4	0	0	4	0	0
20	43120658	.	T	G	12	7	19	0	1	20	0	0
20	43120718	.	C	T	1	6	7	1	12	20	0	0
20	43120787	.	G	C	0	0	0	0	23	23	0	0
20	43120796	.	T	C	12	0	12	0	9	21	0	0
20	43121545	.	A	G	9	7	16	0	0	16	0	0
20	43121650	.	T	C	1	5	6	0	0	6	0	0
20	43121799	.	G	A	0	5	5	0	0	5	0	0
20	43121803	.	C	T	1	5	6	0	0	6	0	0
20	43121839	.	A	T	1	3	4	0	0	4	0	0
20	43122744	.	A	C	3	3	6	0	0	6	0	0
20	43122921	.	G	T	0	15	15	0	3	22	4	0
20	43123314	.	C	T	14	7	21	0	0	21	0	0
20	43133228	.	G	C	7	5	12	0	0	12	0	0
20	43133322	.	G	C	13	7	20	0	0	20	0	0
20	43133426	.	A	G	9	10	19	0	1	20	0	0
20	43158910	.	C	T	7	12	19	0	0	20	1	0
20	43159027	.	C	G	7	6	13	0	0	13	0	0
20	43159057	.	T	A	6	7	13	0	0	13	0	0
20	43161797	.	A	G	8	5	13	0	0	13	0	0
20	43184362	.	G	A	5	6	11	0	0	11	0	0
20	43194551	.	G	A	1	5	6	0	0	6	0	0
20	43194650	.	G	A	1	4	5	0	1	6	0	0
20	43194671	.	G	T	2	3	5	0	0	5	0	0
20	43194695	.	T	G	3	2	5	0	0	5	0	0
20	43227292	.	A	C	1	4	5	0	0	5	0	0
20	43252360	.	G	A	4	4	8	0	0	8	0	0
20	43252447	.	T	C	1	0	1	0	2	3	0	0
20	43345866	.	T	C	3	6	9	0	0	9	0	0
20	43648538	.	C	T	4	6	10	0	1	11	0	0
20	43652934	.	T	C	7	8	15	0	0	15	0	0
20	43652967	.	T	C	11	7	18	0	2	20	0	0
20	43655958	.	A	G	8	10	18	0	1	19	0	0
20	43655967	.	C	G	8	9	17	0	1	18	0	0
20	43656030	.	C	T	10	5	15	0	1	16	0	0
20	43670280	.	G	C	5	5	10	0	1	11	0	0
20	43671935	.	G	A	9	9	18	0	0	18	0	0
20	43673532	.	G	A	10	7	17	0	3	20	0	0
20	43673634	.	G	A	1	16	17	0	7	24	0	0
20	43675840	.	G	A	0	5	5	0	6	11	0	0
20	43680616	.	C	A	8	14	22	0	0	22	0	0
20	43680700	.	G	A	9	8	17	0	0	17	0	0
20	43680752	.	C	T	9	6	15	0	1	16	0	0
20	43683238	.	A	G	15	0	15	0	11	26	0	0
20	43686738	.	G	A	9	8	17	0	0	17	0	0
20	43689138	.	T	A	9	11	20	0	0	20	0	0
20	43689254	.	C	A	9	7	16	0	1	17	0	0
20	43689418	.	G	A	0	8	8	0	3	11	0	0
20	43694144	.	G	T	3	3	6	0	0	6	0	0
20	43703844	.	C	T	1	6	7	0	1	8	0	0
20	43714699	.	T	G	1	0	1	0	3	4	0	0
20	43715032	.	T	A	1	2	3	0	0	3	0	0
20	43746749	.	C	T	0	8	8	0	2	10	0	0
20	43746780	.	C	T	3	3	6	0	1	7	0	0
20	43746890	.	T	C	6	0	6	0	12	18	0	0
20	43750362	.	A	G	7	14	21	0	0	21	0	0
20	43750680	.	A	G	11	12	23	0	0	23	0	0
20	43776373	.	T	C	24	24	48	0	4	52	0	0
20	43776456	.	T	A	30	20	50	0	1	51	0	0
20	43776841	.	G	A	28	39	67	0	2	69	0	0
20	43776842	.	A	G	42	23	65	0	2	68	1	0
20	43786415	.	T	C	18	20	38	0	0	38	0	0
20	43793065	.	T	C	5	4	9	0	1	10	0	0
20	43793193	.	G	A	19	13	32	0	1	33	0	0
20	43793329	.	C	T	9	10	19	0	2	21	0	0
20	43793410	.	C	A	1	11	12	0	9	21	0	0
20	43793428	.	G	A	8	15	23	0	0	23	0	0
20	43793666	.	C	T	0	6	6	0	10	16	0	0
20	43793683	.	G	A	11	8	19	0	1	20	0	0
20	43793702	.	C	T	10	12	22	0	1	23	0	0
20	43793867	.	A	C	10	15	25	0	1	26	0	0
20	43793901	.	A	G	13	10	23	0	1	24	0	0
20	43793960	.	A	T	15	12	27	0	1	28	0	0
20	43794004	.	G	A	19	15	34	0	0	34	0	0
20	43794053	.	A	T	24	18	42	0	1	43	0	0
20	43794312	.	C	T	0	2	2	0	4	6	0	0
20	43794488	.	A	G	14	12	26	0	1	27	0	0
20	43812584	.	G	A	20	13	33	0	0	33	0	0
20	43825607	.	A	G	10	14	24	0	1	25	0	0
20	43831482	.	T	C	16	13	29	0	1	30	0	0
20	43895806	.	G	A	13	15	28	0	2	30	0	0
20	43895827	.	T	A	12	17	29	0	2	31	0	0
20	43942365	.	T	C	5	3	8	0	0	8	0	0
20	43942483	.	A	G	2	5	7	0	0	7	0	0
20	43968375	.	C	T	2	2	4	0	0	4	0	0
20	44053224	.	C	A	3	3	6	0	0	6	0	0
20	44053314	.	G	A	1	2	3	0	0	3	0	0
20	44372854	.	G	C	6	3	9	0	0	9	0	0
20	44372973	.	C	A	9	4	13	0	1	14	0	0
20	44372977	.	C	T	8	6	14	0	0	14	0	0
20	44373336	.	G	A	20	14	34	1	3	38	0	0
20	44373378	.	A	G	18	17	35	1	1	37	0	0
20	44386452	.	C	T	3	15	18	0	13	31	0	0
20	44386501	.	A	G	15	14	29	0	2	31	0	0
20	44389647	.	G	A	16	11	27	0	0	27	0	0
20	44402769	.	C	T	14	15	29	0	2	31	0	0
20	44447798	.	G	T	12	15	27	0	1	28	0	0
20	44451262	.	G	A	15	9	24	0	3	27	0	0
20	44451286	.	C	A	1	14	15	0	13	28	0	0
20	44457278	.	C	T	10	11	21	0	2	23	0	0
20	44457311	.	G	C	14	0	14	0	8	22	0	0
20	44457314	.	A	G	10	13	23	0	0	23	0	0
20	44457593	.	C	T	18	14	32	0	1	33	0	0
20	44457595	.	G	T	14	18	32	0	0	32	0	0
20	44457659	.	A	T	16	9	25	0	2	27	0	0
20	44464502	.	G	T	5	2	7	0	0	7	0	0
20	44464579	.	T	C	10	10	20	0	0	20	0	0
20	44498097	.	G	T	3	2	5	0	0	5	0	0
20	44509653	.	C	T	0	8	8	0	4	12	0	0
20	44514469	.	C	T	0	4	4	0	2	6	0	0
20	44514502	.	A	G	2	6	8	0	0	8	0	0
20	44517604	.	C	T	6	8	14	0	1	15	0	0
20	44518070	.	G	T	4	10	14	0	0	14	0	0
20	44519142	.	G	A	3	4	7	0	0	7	0	0
20	44523296	.	A	G	2	4	6	0	0	6	0	0
20	44530085	.	T	A	3	2	5	0	0	5	0	0
20	44555668	.	G	A	8	2	10	0	0	10	0	0
20	44555671	.	A	G	8	1	9	0	0	9	0	0
20	44566955	.	T	G	13	13	26	0	0	26	0	0
20	44567001	.	G	A	13	13	26	0	1	27	0	0
20	44569943	.	C	A	15	9	24	0	1	25	0	0
20	44593924	.	A	T	2	3	5	0	0	5	0	0
20	44593954	.	A	C	3	7	10	0	0	10	0	0
20	44621253	.	G	A	3	1	4	0	1	5	0	0
20	44621259	.	C	T	4	1	5	0	1	6	0	0
20	44621337	.	T	C	1	3	4	0	1	5	0	0
20	44680332	.	G	T	0	3	3	0	4	7	0	0
20	44761074	.	A	G	6	2	8	0	0	8	0	0
20	44761391	.	C	T	2	2	4	0	0	4	0	0
20	44799458	.	T	A	7	5	12	0	1	13	0	0
20	45406783	.	C	T	11	5	16	0	0	16	0	0
20	45406870	.	G	A	13	10	23	0	3	26	0	0
20	45406997	.	T	C	6	7	13	0	1	14	0	0
20	45407313	.	T	A	6	14	20	0	1	21	0	0
20	45407327	.	T	C	13	0	13	0	7	20	0	0
20	45408047	.	T	C	9	9	18	0	0	18	0	0
20	45408179	.	G	C	7	3	10	0	0	10	0	0
20	45408345	.	G	A	7	6	13	0	1	14	0	0
20	45621632	.	A	G	6	4	10	0	0	10	0	0
20	45621641	.	A	T	6	3	9	0	0	9	0	0
20	45621669	.	G	A	6	5	11	0	0	11	0	0
20	45622256	.	A	G	6	4	10	0	0	10	0	0
20	45622267	.	G	T	4	6	10	0	0	10	0	0
20	45643846	.	G	T	5	8	13	1	0	14	0	0
20	45643947	.	G	C	9	9	18	0	2	20	0	0
20	45644095	.	C	T	9	10	19	0	1	20	0	0
20	45644096	.	T	G	9	9	18	0	2	20	0	0
20	45644163	.	G	T	25	7	32	1	1	34	0	0
20	45644275	.	G	A	19	12	31	0	0	31	0	0
20	45645560	.	A	G	18	20	38	0	0	38	0	0
20	45648487	.	C	A	0	20	20	0	16	36	0	0
20	45653434	.	A	G	16	8	24	19	0	43	0	0
20	45656899	.	A	G	18	9	27	0	0	27	0	0
20	45661000	.	C	T	14	6	20	0	2	22	0	0
20	45669311	.	C	T	15	16	31	0	1	32	0	0
20	45669353	.	C	T	2	13	15	0	17	32	0	0
20	45679302	.	T	G	11	13	24	0	0	24	0	0
20	45679303	.	T	A	11	13	24	0	0	24	0	0
20	45682240	.	A	C	12	17	29	0	2	31	0	0
20	45708968	.	A	G	6	12	18	0	1	19	0	0
20	45709967	.	T	A	4	3	7	0	2	9	0	0
20	45742077	.	A	G	9	13	22	0	1	23	0	0
20	45742126	.	C	T	21	6	27	0	1	28	0	0
20	45745423	.	C	T	10	12	22	0	1	23	0	0
20	45745930	.	A	G	12	0	12	0	12	24	0	0
20	45746063	.	C	T	13	21	34	0	1	35	0	0
20	45746064	.	A	G	14	22	36	0	0	36	0	0
20	45746297	.	C	T	13	17	30	0	0	30	0	0
20	45746402	.	G	A	25	20	45	0	3	48	0	0
20	45746432	.	C	T	21	13	34	0	3	37	0	0
20	45746486	.	T	C	12	21	33	0	3	36	0	0
20	45746524	.	T	A	21	20	41	0	1	42	0	0
20	45746567	.	C	T	21	19	40	0	0	40	0	0
20	45746588	.	C	A	19	19	38	0	0	38	0	0
20	45746797	.	T	C	21	22	43	0	1	44	0	0
20	45746807	.	A	C	22	20	42	0	3	45	0	0
20	45747089	.	A	T	18	19	37	0	1	38	0	0
20	45747098	.	A	G	16	19	35	0	0	35	0	0
20	45747125	.	G	A	1	14	15	0	14	29	0	0
20	45751304	.	T	C	11	17	28	0	3	31	0	0
20	45751364	.	T	A	13	16	29	0	1	30	0	0
20	45751561	.	G	C	1	8	9	0	18	27	0	0
20	45751989	.	T	A	5	4	9	0	1	10	0	0
20	45754471	.	C	G	1	3	4	0	0	4	0	0
20	45759488	.	C	T	4	8	12	0	1	13	0	0
20	45759508	.	G	A	4	9	13	0	0	13	0	0
20	45763038	.	T	C	4	4	8	0	0	8	0	0
20	45764707	.	C	T	5	9	14	0	0	14	0	0
20	45764722	.	T	C	8	4	12	0	0	12	0	0
20	45764857	.	G	A	4	4	8	0	0	8	0	0
20	45772010	.	T	A	3	3	6	0	0	6	0	0
20	46316513	.	C	T	5	2	7	1	0	8	0	0
20	46352909	.	C	G	3	3	6	0	0	6	0	0
20	46353024	.	G	T	2	4	6	0	0	6	0	0
20	46353253	.	G	A	2	8	10	0	0	10	0	0
20	46353259	.	G	A	2	7	9	0	0	9	0	0
20	46353321	.	A	T	3	4	7	0	0	7	0	0
20	46353428	.	C	T	8	7	15	0	0	15	0	0
20	46357199	.	C	G	4	4	8	0	0	8	0	0
20	46357298	.	T	G	7	6	13	0	0	13	0	0
20	46357302	.	G	A	6	6	12	0	0	12	0	0
20	46357337	.	T	C	3	5	8	0	0	8	0	0
20	46432917	.	A	C	3	3	6	0	0	6	0	0
20	46435243	.	G	A	3	2	5	0	1	6	0	0
20	46437264	.	G	A	2	4	6	0	0	6	0	0
20	46439988	.	A	G	7	0	7	0	5	12	0	0
20	46441612	.	G	A	0	2	2	0	4	6	0	0
20	46441627	.	C	T	4	3	7	0	0	7	0	0
20	46441695	.	G	C	2	8	10	0	1	11	0	0
20	46441724	.	C	A	3	7	10	0	0	10	0	0
20	46442397	.	T	C	5	4	9	0	0	9	0	0
20	46457175	.	A	T	19	12	31	0	0	31	0	0
20	46457334	.	T	C	19	1	20	0	16	36	0	0
20	46457376	.	A	G	13	21	34	0	2	36	0	0
20	46463315	.	T	A	10	16	26	0	0	26	0	0
20	46463327	.	T	C	9	0	9	0	19	28	0	0
20	46466920	.	G	A	9	16	25	0	0	25	0	0
20	46467054	.	T	C	5	8	13	0	0	13	0	0
20	46467174	.	A	C	10	11	21	0	0	21	0	0
20	46492279	.	T	C	7	4	11	0	0	11	0	0
20	46492305	.	A	C	4	4	8	0	0	8	0	0
20	46498023	.	C	A	3	3	6	0	0	6	0	0
20	46502334	.	C	T	10	5	15	0	0	15	0	0
20	46502423	.	T	A	6	1	7	0	1	8	0	0
20	46502505	.	C	T	9	3	12	0	0	12	0	0
20	46502535	.	C	A	7	5	12	0	0	12	0	0
20	46506079	.	G	A	1	5	6	0	7	13	0	0
20	46506203	.	T	A	9	6	15	0	2	17	0	0
20	46509336	.	G	A	1	8	9	0	4	13	0	0
20	46509343	.	A	G	8	0	8	0	5	13	0	0
20	46513798	.	A	G	7	0	7	0	1	8	0	0
20	46515625	.	G	A	6	4	10	0	0	10	0	0
20	46515680	.	C	T	5	5	10	0	1	11	0	0
20	46517173	.	A	T	6	7	13	0	0	13	0	0
20	46517286	.	C	G	9	7	16	0	0	16	0	0
20	46517429	.	C	T	8	13	21	0	0	21	0	0
20	46519076	.	A	G	5	11	16	0	0	16	0	0
20	46519082	.	G	A	1	12	13	0	5	18	0	0
20	46519148	.	T	A	7	2	9	0	0	9	0	0
20	46522942	.	G	A	6	5	11	0	2	13	0	0
20	46525639	.	T	A	12	20	32	0	2	34	0	0
20	46528643	.	T	C	7	9	16	0	0	16	0	0
20	46529398	.	G	A	7	11	18	0	1	19	0	0
20	46529479	.	T	C	10	11	21	0	1	22	0	0
20	46536707	.	T	A	7	2	9	0	0	9	0	0
20	46536906	.	T	G	21	20	41	0	0	41	0	0
20	46537039	.	A	T	24	26	50	0	0	50	0	0
20	46537231	.	C	G	14	24	38	0	3	41	0	0
20	46537239	.	C	T	29	13	42	0	1	43	0	0
20	46537404	.	G	A	15	12	27	0	0	27	0	0
20	46539619	.	A	G	28	15	43	0	4	47	0	0
20	46540898	.	A	G	13	20	33	0	0	33	0	0
20	46552431	.	C	T	0	8	8	0	6	14	0	0
20	46552965	.	G	T	34	32	66	0	2	68	0	0
20	46552966	.	G	T	33	32	65	0	3	68	0	0
20	46553020	.	T	G	30	36	66	0	1	67	0	0
20	46553274	.	G	C	36	29	65	0	4	69	0	0
20	46553512	.	T	C	2	5	7	0	2	9	0	0
20	46560419	.	G	T	3	3	6	0	0	6	0	0
20	46563938	.	A	G	6	0	6	0	12	18	0	0
20	46564009	.	G	A	9	7	16	0	1	17	0	0
20	46564120	.	G	C	0	5	5	0	5	10	0	0
20	46564267	.	C	T	11	7	18	0	0	18	0	0
20	46564455	.	G	A	2	2	4	0	1	5	0	0
20	46572569	.	C	G	1	3	4	0	0	4	0	0
20	46594507	.	C	T	3	3	6	0	0	6	0	0
20	46646433	.	C	T	2	2	4	0	0	4	0	0
20	46699344	.	T	C	8	7	15	0	0	15	0	0
20	46712835	.	C	T	6	2	8	0	2	10	0	0
20	46713607	.	C	T	9	8	17	0	2	19	0	0
20	46721084	.	G	A	10	4	14	0	3	17	0	0
20	46724740	.	C	T	13	17	30	0	2	32	0	0
20	46730654	.	T	C	16	13	29	0	0	29	0	0
20	46730663	.	G	A	14	9	23	0	3	26	0	0
20	46730734	.	C	T	17	15	32	0	0	32	0	0
20	46731010	.	T	A	5	10	15	0	0	15	0	0
20	46732062	.	G	T	12	5	17	0	1	18	0	0
20	46732336	.	T	G	0	0	0	0	12	12	0	0
20	46732359	.	T	C	3	3	6	0	0	6	0	0
20	46732848	.	T	A	14	12	26	0	0	27	1	0
20	46732887	.	C	T	15	12	27	0	0	27	0	0
20	46733096	.	C	T	3	3	6	0	3	9	0	0
20	46733764	.	A	G	10	12	22	0	0	22	0	0
20	46733809	.	G	A	16	6	22	0	1	23	0	0
20	46741083	.	G	A	1	2	3	0	0	3	0	0
20	46742633	.	A	C	4	7	11	0	0	11	0	0
20	46746711	.	G	A	0	7	7	0	5	12	0	0
20	46758728	.	C	T	5	4	9	0	0	9	0	0
20	46758733	.	C	T	4	4	8	0	1	9	0	0
20	46758852	.	C	T	0	4	4	0	0	4	0	0
20	46758933	.	G	A	1	2	3	0	3	6	0	0
20	46831124	.	T	C	4	8	12	0	0	12	0	0
20	46834576	.	A	G	5	3	8	0	0	8	0	0
20	46835350	.	C	T	0	2	2	0	2	4	0	0
20	46835363	.	G	T	4	2	6	0	0	6	0	0
20	46835432	.	G	A	6	6	12	0	1	13	0	0
20	46858896	.	G	A	13	7	20	0	0	20	0	0
20	46859160	.	G	T	5	7	12	0	1	14	1	0
20	46859259	.	A	G	7	4	11	0	0	11	0	0
20	46859328	.	G	A	5	10	15	0	0	15	0	0
20	46859418	.	A	G	7	5	12	0	0	12	0	0
20	46886820	.	G	A	1	4	5	0	0	5	0	0
20	46886856	.	T	A	1	3	4	0	0	4	0	0
20	46891185	.	C	A	1	1	2	0	1	3	0	0
20	46918805	.	C	G	1	5	6	0	0	6	0	0
20	46918894	.	A	T	1	3	4	0	0	4	0	0
20	46944145	.	G	A	1	3	4	0	0	4	0	0
20	46944156	.	C	T	1	3	4	0	0	4	0	0
20	46945945	.	G	T	1	2	3	0	0	3	0	0
20	46957559	.	G	T	21	24	45	0	0	45	0	0
20	46957575	.	C	G	19	25	44	0	1	45	0	0
20	46957600	.	T	A	19	20	39	0	1	40	0	0
20	46957650	.	A	T	18	21	39	0	0	39	0	0
20	46957803	.	T	A	13	27	40	1	2	43	0	0
20	46958136	.	C	T	10	9	19	0	1	20	0	0
20	46958478	.	T	C	17	0	17	1	15	33	0	0
20	46958705	.	G	T	16	15	31	0	2	33	0	0
20	46958766	.	T	A	10	16	26	0	2	28	0	0
20	46959135	.	T	C	23	24	47	0	1	48	0	0
20	46959147	.	A	T	24	24	48	0	1	49	0	0
20	46959465	.	C	A	8	11	19	0	0	19	0	0
20	46959477	.	A	T	10	9	19	0	0	19	0	0
20	46959504	.	T	C	10	6	16	0	1	17	0	0
20	46959525	.	T	C	13	0	13	0	6	19	0	0
20	46959543	.	A	T	15	5	20	0	0	20	0	0
20	46967415	.	A	G	1	2	3	0	0	3	0	0
20	46967563	.	T	G	4	6	10	0	0	10	0	0
20	46969436	.	A	C	10	0	10	0	11	21	0	0
20	46970314	.	A	G	12	6	18	0	1	19	0	0
20	46970344	.	T	A	9	9	18	0	1	19	0	0
20	46974693	.	G	C	8	4	12	0	0	12	0	0
20	46974942	.	C	T	6	10	16	0	0	16	0	0
20	46980170	.	G	C	6	5	11	0	0	11	0	0
20	46980230	.	A	G	6	8	14	0	2	16	0	0
20	46986128	.	A	C	2	4	6	0	0	6	0	0
20	46988005	.	T	G	7	2	9	0	1	10	0	0
20	46988087	.	C	T	5	5	10	0	2	12	0	0
20	46994504	.	G	A	4	2	6	0	2	8	0	0
20	46994543	.	A	G	5	4	9	0	1	10	0	0
20	47051979	.	C	T	10	6	16	0	0	16	0	0
20	47290466	.	A	T	7	4	11	0	0	11	0	0
20	47291096	.	A	G	1	3	4	0	0	4	0	0
20	47291133	.	C	T	0	3	3	0	4	7	0	0
20	47291137	.	G	A	4	3	7	0	0	7	0	0
20	47297733	.	T	G	6	0	6	0	10	16	0	0
20	47297780	.	T	C	4	0	4	0	14	18	0	0
20	47301729	.	A	G	6	3	9	0	0	9	0	0
20	47305152	.	G	A	9	4	13	0	0	13	0	0
20	47383913	.	A	G	22	16	38	0	2	40	0	0
20	47386932	.	T	G	22	15	37	0	2	39	0	0
20	47386965	.	T	C	17	10	27	0	2	29	0	0
20	47387067	.	T	C	13	14	27	0	0	27	0	0
20	47388431	.	G	A	9	13	22	0	1	23	0	0
20	47421471	.	C	A	8	12	20	0	1	21	0	0
20	47421554	.	A	G	12	12	24	0	1	25	0	0
20	47421891	.	A	G	8	10	18	0	0	18	0	0
20	47435018	.	T	A	30	20	50	0	1	51	0	0
20	47435065	.	G	T	2	21	23	0	18	41	0	0
20	47435186	.	C	A	21	13	34	0	0	34	0	0
20	47471391	.	A	G	30	1	31	0	26	57	0	0
20	47689531	.	G	A	4	2	6	0	0	6	0	0
20	47689621	.	A	T	12	7	19	0	1	20	0	0
20	47689647	.	A	C	11	0	11	0	5	16	0	0
20	47689671	.	T	C	9	8	17	0	1	18	0	0
20	47689801	.	C	T	9	12	21	0	1	23	1	0
20	47700034	.	T	C	17	0	17	0	13	30	0	0
20	47700055	.	C	T	16	14	30	0	2	32	0	0
20	47704959	.	C	T	0	8	8	0	11	19	0	0
20	47718334	.	T	C	8	0	8	0	6	14	0	0
20	47718458	.	T	C	12	3	15	0	3	18	0	0
20	47726010	.	G	A	8	7	15	0	1	16	0	0
20	47726049	.	C	G	11	6	17	0	1	18	0	0
20	47932268	.	G	T	19	8	27	0	0	27	0	0
20	47932424	.	T	C	11	13	24	0	1	25	0	0
20	47932867	.	T	C	6	16	22	0	2	24	0	0
20	47938981	.	C	T	2	15	17	0	17	34	0	0
20	47942600	.	G	A	12	5	17	0	0	17	0	0
20	47942651	.	A	G	8	10	18	0	1	19	0	0
20	47944132	.	C	T	0	9	9	0	7	16	0	0
20	47944151	.	G	A	9	7	16	0	0	16	0	0
20	47944277	.	C	T	1	9	10	0	11	21	0	0
20	47948116	.	A	G	3	4	7	0	0	7	0	0
20	47950971	.	G	A	7	10	17	0	0	17	0	0
20	47960793	.	A	G	6	3	9	0	0	9	0	0
20	47961065	.	C	T	8	3	11	0	0	11	0	0
20	47963967	.	T	C	1	3	4	0	0	4	0	0
20	47964299	.	C	T	4	2	6	0	1	7	0	0
20	47973078	.	A	G	7	5	12	0	1	13	0	0
20	47973272	.	T	C	7	4	11	0	0	11	0	0
20	47995295	.	T	C	1	0	1	0	5	6	0	0
20	47995479	.	G	A	2	2	4	0	0	4	0	0
20	48010837	.	A	G	2	3	5	0	0	5	0	0
20	48037036	.	T	C	5	7	12	0	0	12	0	0
20	48037061	.	G	C	6	4	10	0	0	10	0	0
20	48037071	.	G	A	5	4	9	0	0	9	0	0
20	48037765	.	A	G	6	7	13	0	2	15	0	0
20	48038086	.	T	A	5	2	7	0	0	7	0	0
20	48043220	.	G	A	7	2	9	0	0	9	0	0
20	48043401	.	G	A	6	10	16	0	0	16	0	0
20	48043428	.	G	A	5	10	15	0	1	16	0	0
20	48043470	.	A	G	4	7	11	0	0	11	0	0
20	48053608	.	A	G	8	4	12	0	0	12	0	0
20	48053728	.	T	C	2	0	2	0	3	5	0	0
20	48061288	.	G	A	9	5	14	0	0	14	0	0
20	48104656	.	G	A	6	3	9	0	0	9	0	0
20	48104704	.	G	T	4	3	7	0	0	7	0	0
20	48104797	.	C	T	6	3	9	0	0	9	0	0
20	48296314	.	T	C	20	0	20	0	10	30	0	0
20	48296315	.	A	G	20	10	30	0	0	30	0	0
20	48298716	.	C	T	11	7	18	0	1	19	0	0
20	48312445	.	A	G	11	11	22	0	0	22	0	0
20	48341712	.	T	C	13	0	13	0	20	33	0	0
20	48342821	.	G	A	10	10	20	0	0	20	0	0
20	48344049	.	T	C	14	0	14	0	14	28	0	0
20	48353119	.	C	T	2	13	15	0	8	23	0	0
20	48385393	.	T	C	8	9	17	0	1	18	0	0
20	50184972	.	C	T	5	4	9	0	0	9	0	0
20	50191697	.	C	T	4	7	11	0	0	11	0	0
20	50996515	.	G	T	2	15	17	0	23	40	0	0
20	50998672	.	T	A	18	19	37	0	1	38	0	0
20	50998746	.	A	G	17	20	37	0	3	40	0	0
20	50998858	.	C	T	26	24	50	0	2	52	0	0
20	50999024	.	C	G	19	25	44	0	2	46	0	0
20	50999297	.	C	A	7	3	10	0	1	11	0	0
20	50999311	.	T	C	4	4	8	0	0	8	0	0
20	51069662	.	G	A	14	8	22	0	0	22	0	0
20	51069864	.	A	G	10	1	11	0	10	21	0	0
20	51070017	.	A	G	9	10	19	0	0	19	0	0
20	51073334	.	T	A	9	17	26	0	1	27	0	0
20	51073369	.	A	T	9	16	25	0	0	25	0	0
20	51073449	.	G	A	2	7	9	0	8	17	0	0
20	51073692	.	G	A	10	9	19	0	0	19	0	0
20	51073783	.	G	A	14	8	22	0	0	22	0	0
20	51073800	.	G	A	11	6	17	0	0	17	0	0
20	51074013	.	C	T	4	2	6	0	0	6	0	0
20	51074026	.	C	T	4	2	6	0	0	6	0	0
20	51074291	.	A	G	4	0	4	0	3	7	0	0
20	51074317	.	C	T	2	5	7	0	0	7	0	0
20	51074352	.	A	T	1	3	4	0	0	4	0	0
20	51075030	.	A	G	3	0	3	0	3	6	0	0
20	51075202	.	T	A	3	4	7	0	0	7	0	0
20	51075285	.	A	T	1	2	3	0	0	3	0	0
20	51075560	.	A	C	2	3	5	0	0	5	0	0
20	51075580	.	T	C	1	2	3	0	0	3	0	0
20	51076204	.	C	T	4	2	6	0	0	6	0	0
20	51076206	.	C	T	3	2	5	0	0	5	0	0
20	51076947	.	A	T	1	3	4	0	0	4	0	0
20	51076999	.	C	T	1	2	3	0	1	4	0	0
20	51077187	.	A	G	2	2	4	0	0	4	0	0
20	51088683	.	G	A	20	18	38	0	0	38	0	0
20	51088802	.	A	T	28	36	64	0	2	67	1	0
20	51088920	.	C	T	19	26	45	0	3	48	0	0
20	51088967	.	C	A	22	27	49	0	0	49	0	0
20	51089054	.	T	C	30	17	47	0	2	49	0	0
20	51089236	.	T	C	26	0	26	1	30	57	0	0
20	51089243	.	T	C	23	31	54	1	4	59	0	0
20	51089559	.	G	A	28	22	50	0	1	51	0	0
20	51089877	.	G	A	31	28	59	0	0	59	0	0
20	51089883	.	A	G	29	30	59	0	2	61	0	0
20	51089919	.	A	G	33	27	60	0	1	61	0	0
20	51100498	.	T	C	16	18	34	0	1	35	0	0
20	51112208	.	C	T	12	26	38	0	0	38	0	0
20	51117664	.	G	A	18	17	35	0	1	36	0	0
20	51117706	.	C	G	21	0	21	0	18	39	0	0
20	51118314	.	T	C	16	26	42	0	0	42	0	0
20	51123088	.	C	T	13	13	26	0	0	26	0	0
20	51123151	.	A	T	12	14	26	0	1	28	1	0
20	51132127	.	C	G	5	4	9	0	0	9	0	0
20	51132208	.	A	G	18	19	37	0	1	38	0	0
20	51132219	.	A	G	19	12	31	0	0	31	0	0
20	51145837	.	A	G	10	15	25	0	0	25	0	0
20	51145888	.	T	C	5	0	5	0	10	15	0	0
20	51146152	.	T	G	11	7	18	0	1	19	0	0
20	51146194	.	A	G	6	10	16	0	0	16	0	0
20	51157061	.	C	T	3	12	15	0	11	26	0	0
20	51157082	.	T	C	13	14	27	0	0	27	0	0
20	51168559	.	A	T	8	11	19	0	1	20	0	0
20	51199791	.	T	C	41	33	74	0	7	81	0	0
20	51200015	.	C	T	34	34	68	0	4	72	0	0
20	51204759	.	C	T	34	43	77	0	8	85	0	0
20	51205691	.	T	G	26	48	74	0	4	79	1	0
20	51205745	.	G	A	36	51	87	0	4	91	0	0
20	51206976	.	C	A	28	43	71	0	8	79	0	0
20	51207030	.	C	T	37	40	77	0	3	80	0	0
20	51207051	.	G	A	49	36	85	0	1	86	0	0
20	51207609	.	C	A	44	41	85	0	6	91	0	0
20	51207726	.	C	T	31	47	78	0	8	86	0	0
20	51211459	.	A	G	53	10	63	0	25	88	0	0
20	51211837	.	T	C	7	2	9	0	1	10	0	0
20	51238475	.	T	C	1	0	1	0	3	4	0	0
20	51240121	.	C	G	1	9	10	0	7	17	0	0
20	51240130	.	T	G	6	6	12	0	0	12	0	0
20	51274748	.	G	A	1	3	4	3	0	7	0	0
20	51276459	.	G	A	1	6	7	0	0	7	0	0
20	51283410	.	G	A	1	5	6	0	1	7	0	0
20	51283424	.	C	T	0	2	2	0	1	3	0	0
20	51312886	.	C	T	10	5	15	0	1	16	0	0
20	51312894	.	T	C	10	6	16	0	0	16	0	0
20	51332239	.	C	T	6	2	8	0	0	8	0	0
20	51332296	.	A	G	3	5	8	0	1	9	0	0
20	51332338	.	G	A	2	4	6	0	8	14	0	0
20	51332401	.	C	T	5	4	9	0	0	9	0	0
20	51332587	.	A	T	4	3	7	0	0	7	0	0
20	51332593	.	T	C	5	2	7	0	0	7	0	0
20	51332731	.	T	C	1	8	9	0	0	9	0	0
20	51332917	.	G	C	4	3	7	0	0	7	0	0
20	51332982	.	G	A	7	3	10	0	0	10	0	0
20	51332998	.	G	A	0	5	5	0	7	12	0	0
20	51333118	.	A	T	2	5	7	0	0	7	0	0
20	51333547	.	G	A	4	2	6	0	0	6	0	0
20	51333835	.	C	T	3	2	5	0	1	6	0	0
20	51333840	.	A	G	4	2	6	0	0	6	0	0
20	51334081	.	G	A	4	6	10	0	0	10	0	0
20	51334173	.	G	T	1	4	5	0	2	7	0	0
20	51334229	.	C	T	1	2	3	0	1	4	0	0
20	51363773	.	A	G	3	5	8	0	0	8	0	0
20	51374752	.	A	G	13	10	23	0	2	25	0	0
20	51377158	.	G	A	14	7	21	0	1	22	0	0
20	51377261	.	G	A	9	12	21	0	0	21	0	0
20	51383804	.	C	G	8	10	18	0	1	19	0	0
20	51386487	.	G	A	5	7	12	0	0	12	0	0
20	51475935	.	T	G	2	2	4	0	0	4	0	0
20	51489866	.	G	A	2	2	4	0	0	4	0	0
20	51490177	.	C	T	0	2	2	0	1	3	0	0
20	51490369	.	G	T	1	2	3	0	0	3	0	0
20	51490653	.	G	A	2	2	4	0	0	4	0	0
20	51490981	.	A	G	2	2	4	0	0	4	0	0
20	51491718	.	T	A	1	2	3	0	1	4	0	0
20	51492667	.	G	A	2	2	4	0	0	4	0	0
20	51647872	.	A	T	1	3	4	0	0	4	0	0
20	51647932	.	T	C	7	3	10	0	0	10	0	0
20	51648072	.	A	G	7	4	11	0	0	11	0	0
20	51648114	.	T	G	4	8	12	0	0	12	0	0
20	51649767	.	C	T	6	3	9	0	0	9	0	0
20	51649830	.	C	A	0	4	4	0	5	9	0	0
20	51649935	.	G	A	2	6	8	0	2	10	0	0
20	51702896	.	T	C	2	1	3	0	8	11	0	0
20	51702942	.	T	C	1	3	4	0	0	4	0	0
20	51702954	.	G	T	1	3	4	0	0	4	0	0
20	51703043	.	A	G	7	5	12	0	0	12	0	0
20	51703146	.	A	T	9	2	11	0	1	12	0	0
20	51703153	.	C	T	12	3	15	0	0	15	0	0
20	51703406	.	T	C	11	10	21	1	3	25	0	0
20	51703445	.	C	T	2	17	19	0	9	28	0	0
20	51703939	.	G	A	14	20	34	0	1	35	0	0
20	51713103	.	G	A	22	11	33	0	0	33	0	0
20	51720465	.	A	G	15	9	24	0	3	27	0	0
20	51721612	.	A	G	13	13	26	0	0	26	0	0
20	51721640	.	G	A	16	9	25	0	0	25	0	0
20	51723227	.	A	G	10	17	27	0	0	27	0	0
20	51743891	.	T	C	10	7	17	0	1	18	0	0
20	51745943	.	G	A	9	9	18	0	2	20	0	0
20	51753509	.	G	A	0	6	6	0	10	16	0	0
20	51753512	.	G	T	7	9	16	0	0	16	0	0
20	51753562	.	C	T	4	9	13	0	0	13	0	0
20	51758611	.	A	C	8	4	12	2	0	14	0	0
20	51759191	.	A	C	13	9	22	0	0	22	0	0
20	51759562	.	G	A	12	11	23	0	0	23	0	0
20	51763248	.	G	T	13	19	32	0	1	33	0	0
20	51787392	.	T	C	9	10	19	0	0	19	0	0
20	51789582	.	T	C	6	8	14	0	1	15	0	0
20	51794071	.	A	G	11	14	25	0	0	25	0	0
20	51799052	.	G	A	3	6	9	0	0	9	0	0
20	51799178	.	G	T	2	5	7	0	0	7	0	0
20	51802061	.	A	T	4	5	9	0	0	9	0	0
20	51802242	.	G	A	11	3	14	0	0	14	0	0
20	51804325	.	A	C	8	4	12	0	1	13	0	0
20	51807785	.	A	G	5	6	11	0	0	11	0	0
20	51810878	.	C	T	1	4	5	0	5	10	0	0
20	51813934	.	T	A	3	2	5	0	0	5	0	0
20	51813944	.	A	C	3	3	6	0	0	6	0	0
20	51819257	.	C	A	5	3	8	0	0	8	0	0
20	51819263	.	T	C	3	5	8	0	0	8	0	0
20	51821154	.	G	A	3	4	7	0	0	7	0	0
20	51821275	.	T	C	6	6	12	0	1	13	0	0
20	51822177	.	A	G	2	3	5	0	0	5	0	0
20	51822180	.	C	T	3	3	6	0	0	6	0	0
20	51822375	.	A	G	2	4	6	0	0	6	0	0
20	51822468	.	G	A	4	8	12	0	1	13	0	0
20	51822544	.	C	T	1	4	5	0	0	5	0	0
20	51822907	.	A	G	2	3	5	0	0	5	0	0
20	51822937	.	G	A	3	4	7	0	0	7	0	0
20	51823011	.	G	A	2	2	4	0	0	4	0	0
20	51823065	.	T	G	4	2	6	0	1	7	0	0
20	51823735	.	T	G	2	3	5	0	0	5	0	0
20	51823898	.	A	T	2	3	5	0	0	5	0	0
20	51856586	.	G	A	0	2	2	0	1	3	0	0
20	51873991	.	C	A	3	4	7	0	0	7	0	0
20	51935225	.	C	T	1	2	3	0	0	3	0	0
20	52275622	.	A	T	1	5	6	0	0	6	0	0
20	52275647	.	G	A	2	3	5	0	0	5	0	0
20	52333070	.	A	G	2	7	9	1	0	10	0	0
20	52333385	.	G	A	5	8	13	0	1	14	0	0
20	52390235	.	C	G	10	0	10	0	6	16	0	0
20	52404347	.	G	A	3	8	11	0	1	12	0	0
20	52404387	.	T	A	8	4	12	0	2	14	0	0
20	52404578	.	C	T	8	5	13	0	0	13	0	0
20	52415935	.	C	G	6	7	13	0	1	14	0	0
20	52416080	.	C	T	3	11	14	0	1	15	0	0
20	52416107	.	C	T	4	7	11	0	1	12	0	0
20	52416125	.	C	T	4	5	9	0	0	9	0	0
20	52418108	.	C	T	4	3	7	0	0	7	0	0
20	52418120	.	C	A	3	3	6	0	0	6	0	0
20	52419955	.	A	G	4	0	4	0	4	8	0	0
20	52419982	.	T	A	9	7	16	0	0	16	0	0
20	52420126	.	G	T	1	6	7	0	6	13	0	0
20	52458800	.	G	C	3	8	11	0	1	12	0	0
20	52471685	.	G	C	4	3	7	0	0	7	0	0
20	52471706	.	G	C	0	2	2	0	5	7	0	0
20	52473266	.	C	T	5	13	18	0	1	19	0	0
20	52486247	.	G	A	6	4	10	0	1	11	0	0
20	52487851	.	C	T	2	4	6	0	0	6	0	0
20	52488211	.	C	T	1	3	4	0	0	4	0	0
20	52540721	.	A	G	6	7	13	0	0	13	0	0
20	52546252	.	C	T	18	13	31	1	3	35	0	0
20	52554022	.	G	T	12	8	20	0	0	20	0	0
20	52554065	.	A	C	18	19	37	0	0	37	0	0
20	52554222	.	G	A	24	21	45	0	0	45	0	0
20	52554283	.	C	T	18	24	42	0	3	45	0	0
20	52554547	.	A	C	24	15	39	0	0	40	1	0
20	52554685	.	A	G	14	26	40	0	0	40	0	0
20	52561670	.	A	G	26	26	52	0	1	53	0	0
20	52563215	.	C	A	21	24	45	1	2	48	0	0
20	52568373	.	C	G	6	10	16	0	3	19	0	0
20	52574900	.	G	A	5	28	33	0	23	56	0	0
20	52575020	.	A	G	30	1	31	0	28	59	0	0
20	52582594	.	A	T	9	4	13	1	1	15	0	0
20	52907598	.	T	C	4	0	4	0	7	11	0	0
20	52907631	.	A	T	4	7	11	0	0	11	0	0
20	52923827	.	G	A	7	3	10	0	0	10	0	0
20	52939332	.	C	T	2	5	7	0	0	7	0	0
20	52939410	.	G	A	3	4	7	0	0	7	0	0
20	53074579	.	G	A	8	9	17	0	0	17	0	0
20	53074615	.	T	C	7	0	7	0	6	13	0	0
20	53181085	.	C	T	6	5	11	0	1	12	0	0
20	53181091	.	G	A	0	4	4	0	8	12	0	0
20	53215338	.	A	G	10	0	10	1	11	22	0	0
20	53224594	.	C	T	11	7	18	0	1	19	0	0
20	53230903	.	G	T	3	12	15	0	7	22	0	0
20	53262237	.	G	T	1	9	10	0	11	21	0	0
20	53262283	.	C	T	13	9	22	0	0	22	0	0
20	53278952	.	C	T	1	2	3	0	0	3	0	0
20	53302226	.	T	G	3	3	6	0	17	23	0	0
20	53302300	.	G	A	4	4	8	0	1	9	0	0
20	53318814	.	G	T	11	20	31	0	1	32	0	0
20	53365862	.	C	T	13	14	27	0	1	28	0	0
20	53365921	.	C	T	3	7	10	0	13	23	0	0
20	53377661	.	A	G	6	0	6	0	9	15	0	0
20	53377691	.	G	A	9	8	17	0	0	17	0	0
20	53384643	.	A	G	4	8	12	0	1	13	0	0
20	53393594	.	T	C	6	6	12	1	2	15	0	0
20	53393669	.	C	A	8	11	19	0	2	21	0	0
20	53396115	.	C	G	9	3	12	0	1	13	0	0
20	53396160	.	G	A	1	5	6	0	9	15	0	0
20	53398790	.	C	T	7	6	13	0	1	14	0	0
20	53408532	.	G	A	5	3	8	0	0	8	0	0
20	53429823	.	C	G	1	3	4	0	0	4	0	0
20	53600912	.	A	G	3	3	6	0	0	6	0	0
20	53601011	.	C	T	0	2	2	1	3	6	0	0
20	53601352	.	A	G	2	2	4	0	0	4	0	0
20	53601437	.	C	T	0	2	2	0	2	4	0	0
20	53628547	.	G	A	1	6	7	0	2	9	0	0
20	53639931	.	C	A	4	7	11	0	0	11	0	0
20	53639980	.	C	T	3	3	6	6	2	14	0	0
20	53640039	.	C	A	7	2	9	9	0	18	0	0
20	53640040	.	T	C	5	2	7	9	2	18	0	0
20	53641238	.	T	G	4	12	16	0	0	16	0	0
20	53641462	.	T	C	2	9	11	0	0	11	0	0
20	53802953	.	A	C	1	2	3	0	0	3	0	0
20	53803637	.	C	T	14	11	25	0	2	27	0	0
20	53803783	.	T	A	10	12	22	0	2	24	0	0
20	53804470	.	G	A	4	6	10	0	0	15	5	0
20	53898770	.	C	T	1	17	18	0	14	32	0	0
20	53898930	.	G	A	16	6	22	2	1	25	0	0
20	53898968	.	A	T	24	11	35	0	0	35	0	0
20	53899023	.	G	C	15	28	43	0	2	45	0	0
20	53899035	.	G	A	21	26	47	0	2	49	0	0
20	53899063	.	G	A	25	14	39	0	1	40	0	0
20	53899104	.	A	C	19	1	20	0	13	33	0	0
20	53901098	.	T	A	12	8	20	0	0	20	0	0
20	53901136	.	G	C	14	5	19	1	0	20	0	0
20	53912208	.	C	T	2	11	13	0	15	28	0	0
20	53914528	.	G	A	11	8	19	0	0	19	0	0
20	53928363	.	T	C	7	0	7	0	10	17	0	0
20	53930457	.	G	A	10	16	26	0	0	26	0	0
20	53930466	.	C	T	2	14	16	0	8	24	0	0
20	53949782	.	A	G	7	4	11	0	0	11	0	0
20	53968126	.	A	G	24	24	48	0	1	50	1	0
20	53968273	.	A	G	26	9	35	5	1	41	0	0
20	53970281	.	C	T	21	15	36	1	1	38	0	0
20	53974508	.	T	C	13	11	24	0	2	26	0	0
20	53974565	.	G	A	22	12	34	0	0	34	0	0
20	53974580	.	G	A	20	12	32	0	3	35	0	0
20	53981487	.	C	T	19	10	29	0	0	29	0	0
20	53981577	.	T	G	10	6	16	0	0	16	0	0
20	54047577	.	C	T	1	3	4	0	0	4	0	0
20	54047592	.	T	C	1	3	4	0	0	4	0	0
20	54047628	.	C	T	1	2	3	0	0	3	0	0
20	54048057	.	C	T	3	5	8	0	0	8	0	0
20	54048078	.	T	C	2	3	5	0	0	5	0	0
20	54048099	.	C	T	3	2	5	0	0	5	0	0
20	54048327	.	C	T	2	4	6	0	0	6	0	0
20	54067399	.	G	A	8	9	17	0	1	18	0	0
20	54067414	.	G	A	5	11	16	0	0	16	0	0
20	54074860	.	C	T	2	8	10	0	7	17	0	0
20	54085851	.	T	C	27	15	42	0	2	44	0	0
20	54175011	.	A	G	2	3	5	0	0	5	0	0
20	54175056	.	G	T	4	4	8	0	0	8	0	0
20	54175443	.	C	T	5	8	13	0	0	13	0	0
20	54175527	.	A	G	4	2	6	0	0	6	0	0
20	54180851	.	C	T	3	4	7	0	0	7	0	0
20	54196791	.	T	C	11	0	11	0	13	24	0	0
20	54197263	.	G	C	19	18	37	0	2	39	0	0
20	54197287	.	A	T	21	21	42	0	2	44	0	0
20	54197383	.	G	A	16	12	28	0	2	30	0	0
20	54197473	.	A	G	21	16	37	0	2	39	0	0
20	54205704	.	C	T	28	34	62	0	3	65	0	0
20	54215115	.	A	G	11	11	22	0	2	24	0	0
20	54219286	.	T	C	25	1	26	0	22	48	0	0
20	54232738	.	A	G	23	20	43	0	2	45	0	0
20	54232772	.	G	C	21	1	22	0	19	41	0	0
20	54233207	.	T	C	17	0	17	0	13	30	0	0
20	54236421	.	A	C	12	12	24	0	1	25	0	0
20	54236423	.	G	A	11	12	23	0	1	24	0	0
20	54249577	.	G	C	16	17	33	0	1	34	0	0
20	54251406	.	T	C	20	23	43	0	2	45	0	0
20	54274516	.	T	C	23	15	38	1	2	41	0	0
20	54274521	.	A	T	24	11	35	1	3	39	0	0
20	54278129	.	T	A	14	15	29	0	1	30	0	0
20	54278190	.	C	T	16	14	30	0	1	31	0	0
20	54282796	.	A	G	12	25	37	0	1	38	0	0
20	54283025	.	G	T	3	11	14	0	23	37	0	0
20	54283659	.	A	G	25	1	26	0	14	40	0	0
20	54283695	.	A	G	28	16	44	0	3	47	0	0
20	54286145	.	A	G	8	9	17	0	1	18	0	0
20	54286797	.	G	T	5	5	10	0	2	12	0	0
20	54334389	.	C	G	7	0	7	0	3	10	0	0
20	54334417	.	G	T	1	8	9	0	7	16	0	0
20	54334478	.	C	T	11	6	17	0	2	19	0	0
20	54339998	.	C	T	9	5	14	0	0	14	0	0
20	54340018	.	G	C	14	5	19	0	2	21	0	0
20	54340260	.	G	C	11	10	21	0	2	23	0	0
20	54340285	.	C	T	13	12	25	0	0	25	0	0
20	54340359	.	G	A	2	6	8	0	11	19	0	0
20	54340700	.	T	C	4	4	8	0	0	8	0	0
20	54340750	.	A	C	3	3	6	0	0	6	0	0
20	54340990	.	G	A	0	4	4	0	4	8	0	0
20	54341019	.	A	G	2	2	4	0	0	4	0	0
20	54341203	.	T	A	5	5	10	0	1	11	0	0
20	54341210	.	A	G	7	5	12	0	0	12	0	0
20	54341252	.	A	G	5	5	10	0	0	10	0	0
20	54341438	.	C	T	5	2	7	0	0	7	0	0
20	54341453	.	C	T	3	4	7	0	1	8	0	0
20	54342227	.	A	C	5	4	9	1	0	10	0	0
20	54342263	.	A	G	5	3	8	1	1	10	0	0
20	54342266	.	A	T	6	3	9	1	0	10	0	0
20	54342388	.	A	G	6	4	10	1	2	13	0	0
20	54342804	.	C	G	3	5	8	1	0	9	0	0
20	54343695	.	A	T	11	6	17	0	0	17	0	0
20	54343720	.	A	T	7	11	18	0	1	19	0	0
20	54343866	.	G	A	15	7	22	0	0	22	0	0
20	54343928	.	A	G	13	6	19	0	0	19	0	0
20	54344125	.	C	A	6	6	12	0	1	13	0	0
20	54344373	.	T	G	10	8	18	0	1	19	0	0
20	54344386	.	T	A	9	7	16	0	0	16	0	0
20	54344533	.	G	A	8	7	15	0	0	15	0	0
20	54344711	.	A	G	11	0	11	0	6	17	0	0
20	54344795	.	G	A	9	14	23	0	1	24	0	0
20	54344815	.	G	T	6	13	19	0	1	20	0	0
20	54344900	.	T	G	8	4	12	2	0	14	0	0
20	54345051	.	T	C	6	3	9	0	0	9	0	0
20	54345798	.	C	T	5	4	9	0	0	9	0	0
20	54345895	.	C	T	12	16	28	1	0	29	0	0
20	54346124	.	A	T	7	5	12	0	2	14	0	0
20	54355154	.	G	T	2	3	5	0	0	5	0	0
20	54355173	.	A	T	2	4	6	0	0	6	0	0
20	54355807	.	A	G	15	0	15	0	11	26	0	0
20	54357955	.	C	T	16	9	25	0	1	26	0	0
20	54357979	.	T	C	10	14	24	0	1	25	0	0
20	54358601	.	A	G	5	0	5	0	6	11	0	0
20	54360077	.	T	G	12	2	14	0	13	27	0	0
20	54360143	.	G	A	1	4	5	0	0	5	0	0
20	54360148	.	G	T	1	3	4	0	0	4	0	0
20	54397846	.	A	G	15	1	16	1	8	25	0	0
20	54398005	.	G	A	1	9	10	0	17	27	0	0
20	54398242	.	C	T	9	17	26	0	1	27	0	0
20	54398449	.	G	A	1	14	15	0	12	27	0	0
20	54402121	.	C	T	14	13	27	2	0	29	0	0
20	54402157	.	G	T	3	11	14	0	15	29	0	0
20	54402211	.	G	A	1	14	15	0	18	33	0	0
20	54402346	.	G	A	13	14	27	0	2	29	0	0
20	54402400	.	C	G	19	1	20	0	13	33	0	0
20	54402553	.	C	T	18	21	39	0	0	39	0	0
20	54406954	.	G	A	20	19	39	0	2	41	0	0
20	54407196	.	G	A	2	13	15	0	13	28	0	0
20	54422636	.	G	A	15	16	31	2	2	35	0	0
20	54422780	.	C	G	9	12	21	0	1	22	0	0
20	54422796	.	T	C	16	5	21	0	1	22	0	0
20	54422830	.	T	C	12	1	13	0	5	18	0	0
20	54422868	.	T	G	13	7	20	0	0	20	0	0
20	54422884	.	G	A	10	9	19	0	2	21	0	0
20	54422909	.	C	T	12	14	26	0	1	27	0	0
20	54422929	.	G	A	12	13	25	0	0	25	0	0
20	54423005	.	T	C	13	8	21	0	1	22	0	0
20	54423217	.	C	T	1	5	6	0	17	23	0	0
20	54434895	.	G	A	17	20	37	0	4	41	0	0
20	54434918	.	C	T	21	17	38	0	2	40	0	0
20	54441757	.	A	C	24	26	50	0	5	55	0	0
20	54446877	.	G	A	24	26	50	0	1	51	0	0
20	54462151	.	G	C	15	28	43	0	1	44	0	0
20	54522615	.	G	C	2	2	4	0	0	4	0	0
20	54563425	.	A	G	14	8	22	0	0	22	0	0
20	54563995	.	G	A	3	3	6	0	0	6	0	0
20	54563998	.	G	C	3	3	6	0	0	6	0	0
20	54666245	.	G	C	1	2	3	0	0	3	0	0
20	54670836	.	C	G	3	2	5	0	0	5	0	0
20	54670904	.	C	G	7	0	7	0	5	12	0	0
20	54670966	.	A	G	5	2	7	0	1	8	0	0
20	54670984	.	T	A	4	3	7	0	0	7	0	0
20	54671032	.	A	C	5	2	7	0	1	8	0	0
20	54671864	.	T	G	3	9	12	0	1	13	0	0
20	54671894	.	A	C	3	8	11	0	1	12	0	0
20	54671989	.	G	A	0	4	4	0	6	10	0	0
20	54672009	.	A	C	6	3	9	0	0	9	0	0
20	54672839	.	A	G	7	0	7	0	10	17	0	0
20	54672869	.	T	C	7	10	17	0	0	17	0	0
20	54672891	.	T	C	5	7	12	0	0	12	0	0
20	54672974	.	G	A	1	4	5	0	9	14	0	0
20	54673175	.	T	C	4	5	9	0	1	10	0	0
20	54673198	.	T	A	6	6	12	0	1	13	0	0
20	54675294	.	T	C	6	4	10	0	0	10	0	0
20	54675308	.	C	G	5	0	5	0	7	12	0	0
20	54675356	.	C	T	10	11	21	0	0	21	0	0
20	54675391	.	T	C	11	6	17	0	0	17	0	0
20	54676529	.	A	G	8	0	8	0	15	23	0	0
20	54676532	.	T	G	9	16	25	0	1	26	0	0
20	54676583	.	C	T	10	4	14	0	0	14	0	0
20	54681734	.	G	A	5	12	17	0	1	18	0	0
20	54681797	.	T	A	10	5	15	0	1	16	0	0
20	54681944	.	A	T	10	2	12	0	0	12	0	0
20	54698791	.	C	T	17	5	22	0	2	24	0	0
20	54699133	.	C	T	11	8	19	0	1	20	0	0
20	54708193	.	T	C	13	12	25	0	0	25	0	0
20	54708277	.	G	A	4	11	15	0	14	29	0	0
20	54711535	.	G	C	7	7	14	0	2	16	0	0
20	54738249	.	C	G	12	8	20	0	0	20	0	0
20	54740904	.	G	A	16	13	29	0	1	30	0	0
20	54740907	.	A	G	18	0	18	0	11	29	0	0
20	54740955	.	C	T	16	6	22	0	0	22	0	0
20	54740976	.	G	T	2	10	12	0	12	24	0	0
20	54741552	.	C	G	0	2	2	0	3	5	0	0
20	54742641	.	C	G	10	9	19	0	1	20	0	0
20	54742750	.	A	G	12	0	12	0	7	19	0	0
20	54742765	.	A	C	15	8	23	0	0	23	0	0
20	54742912	.	A	C	14	8	22	0	0	22	0	0
20	54743565	.	T	C	13	12	25	3	0	28	0	0
20	54743917	.	G	A	17	14	31	0	2	33	0	0
20	54743937	.	C	T	13	11	24	1	0	25	0	0
20	54743981	.	A	G	13	1	14	1	3	18	0	0
20	54744230	.	C	T	14	10	24	0	1	25	0	0
20	54744314	.	A	G	21	1	22	0	7	29	0	0
20	54744363	.	A	G	19	0	19	1	15	35	0	0
20	54744419	.	A	G	22	14	36	1	0	37	0	0
20	54744486	.	A	G	8	2	10	0	0	10	0	0
21	734962	.	A	G	10	0	10	0	13	23	0	0
21	735222	.	A	G	34	1	35	0	32	67	0	0
21	1576168	.	T	C	16	6	22	0	2	24	0	0
21	1586408	.	A	T	4	4	8	0	0	8	0	0
21	1589305	.	C	A	2	3	5	0	0	5	0	0
21	1593916	.	T	C	3	5	8	0	0	8	0	0
21	1594104	.	C	T	3	9	12	0	0	13	1	0
21	1594125	.	T	C	6	7	13	0	0	13	0	0
21	1594167	.	T	A	7	6	13	0	0	13	0	0
21	1594228	.	T	G	8	3	11	0	0	11	0	0
21	1604351	.	G	A	1	3	4	0	6	10	0	0
21	1610473	.	C	G	7	3	10	0	0	10	0	0
21	1610673	.	A	G	5	4	9	0	0	9	0	0
21	1741801	.	C	G	1	3	4	0	1	5	0	0
21	1780912	.	A	C	5	7	12	0	0	12	0	0
21	1788234	.	A	G	5	5	10	0	0	10	0	0
21	1788474	.	G	A	4	6	10	0	0	10	0	0
21	1788621	.	G	A	4	4	8	0	0	8	0	0
21	1788624	.	G	A	4	4	8	0	0	8	0	0
21	1798961	.	C	T	3	2	5	0	0	5	0	0
21	2180506	.	C	T	1	2	3	0	0	3	0	0
21	2190210	.	C	T	4	2	6	0	0	6	0	0
21	2190214	.	T	C	2	0	2	0	2	4	0	0
21	2202291	.	A	C	3	3	6	0	0	6	0	0
21	2202458	.	C	T	0	5	5	0	7	12	0	0
21	2202461	.	A	G	6	4	10	0	1	11	0	0
21	2202836	.	G	A	9	5	14	0	0	14	0	0
21	2202911	.	T	C	3	5	8	0	1	9	0	0
21	2202956	.	G	A	4	5	9	0	0	9	0	0
21	2203021	.	G	T	1	4	5	0	0	5	0	0
21	2203070	.	A	G	2	6	8	0	0	8	0	0
21	2203121	.	G	C	3	4	7	0	0	7	0	0
21	2203220	.	C	T	0	2	2	0	2	4	0	0
21	2203455	.	C	T	3	6	9	0	0	9	0	0
21	2203494	.	C	T	0	2	2	0	3	5	0	0
21	2208791	.	C	T	3	7	10	1	0	11	0	0
21	2213276	.	G	A	2	2	4	0	0	4	0	0
21	2213650	.	G	C	3	0	3	0	3	6	0	0
21	2213772	.	C	T	2	5	7	0	3	10	0	0
21	2216678	.	A	G	9	3	12	0	0	12	0	0
21	2219802	.	C	T	3	2	5	0	0	5	0	0
21	2219930	.	A	C	3	3	6	0	1	7	0	0
21	2219969	.	A	G	4	2	6	0	1	7	0	0
21	2219986	.	C	T	5	2	7	0	1	8	0	0
21	2220129	.	G	A	3	3	6	0	0	6	0	0
21	2220141	.	C	T	3	2	5	0	0	5	0	0
21	2220295	.	A	T	7	2	9	0	1	10	0	0
21	2220326	.	G	C	6	3	9	0	1	10	0	0
21	2220388	.	T	C	3	5	8	0	0	8	0	0
21	2220612	.	G	A	7	2	9	0	0	9	0	0
21	2220988	.	C	T	3	3	6	0	0	6	0	0
21	2221022	.	T	A	2	2	4	0	0	4	0	0
21	2236037	.	C	T	1	4	5	3	1	9	0	0
21	2236079	.	G	A	3	7	10	2	0	12	0	0
21	2236114	.	T	C	2	5	7	0	1	8	0	0
21	2236346	.	T	A	3	6	9	0	1	10	0	0
21	2236347	.	G	C	4	6	10	0	0	10	0	0
21	2237552	.	G	T	11	7	18	0	0	18	0	0
21	2237578	.	A	G	7	11	18	0	1	19	0	0
21	2246563	.	G	T	4	2	6	0	0	6	0	0
21	2248169	.	A	G	6	6	12	0	0	12	0	0
21	2269905	.	A	G	3	2	5	0	0	5	0	0
21	2269976	.	C	T	1	2	3	0	0	3	0	0
21	2273203	.	A	T	1	3	4	0	0	4	0	0
21	2281270	.	A	G	3	8	11	0	0	11	0	0
21	2281401	.	A	G	3	5	8	0	0	8	0	0
21	2281482	.	T	C	3	0	3	0	7	10	0	0
21	2738221	.	C	T	24	20	44	0	0	44	0	0
21	2934458	.	T	C	4	3	7	0	0	7	0	0
21	2934512	.	T	A	3	3	6	0	0	6	0	0
21	2948545	.	T	C	1	3	4	0	0	4	0	0
21	2950257	.	G	A	1	2	3	0	0	3	0	0
21	2950290	.	C	A	0	3	3	0	1	5	1	0
21	2950460	.	T	G	3	2	5	0	0	5	0	0
21	3247678	.	A	T	6	2	8	0	0	8	0	0
21	3247687	.	A	G	6	2	8	0	1	9	0	0
21	3301916	.	C	T	3	6	9	0	0	9	0	0
21	3301931	.	C	A	3	7	10	0	1	11	0	0
21	3302296	.	A	G	4	0	4	0	4	8	0	0
21	3422565	.	T	G	6	3	9	0	0	9	0	0
21	3452462	.	A	G	10	5	15	0	0	15	0	0
21	3485351	.	T	C	5	1	6	0	2	8	0	0
21	3536050	.	A	G	7	13	20	0	0	20	0	0
21	3536056	.	T	A	6	11	17	0	0	17	0	0
21	3536113	.	A	C	7	3	10	0	1	11	0	0
21	3536116	.	G	A	7	4	11	0	0	11	0	0
21	3536597	.	C	T	1	6	7	0	6	13	0	0
21	3539275	.	C	T	8	6	14	0	2	16	0	0
21	3567722	.	A	G	11	7	18	1	0	19	0	0
21	3600921	.	G	A	4	2	6	1	1	8	0	0
21	3606571	.	C	T	0	4	4	0	4	8	0	0
21	3613482	.	A	C	2	5	7	0	0	7	0	0
21	3613551	.	G	A	4	4	8	0	0	8	0	0
21	3715950	.	A	G	15	12	27	0	0	27	0	0
21	3715986	.	T	A	18	10	28	0	0	28	0	0
21	3715989	.	A	G	18	9	27	0	1	28	0	0
21	3716058	.	T	A	13	10	23	0	0	23	0	0
21	3716234	.	A	G	4	3	7	0	1	8	0	0
21	3716266	.	T	A	2	3	5	0	0	5	0	0
21	3716732	.	G	T	15	17	32	0	0	32	0	0
21	3716845	.	G	A	8	8	16	0	5	21	0	0
21	3716846	.	A	T	7	7	14	0	8	22	0	0
21	3716930	.	G	A	23	17	40	0	3	43	0	0
21	3717055	.	G	A	24	21	45	0	0	45	0	0
21	3717505	.	T	C	15	0	15	0	17	32	0	0
21	3719779	.	G	A	7	8	15	0	0	15	0	0
21	3725881	.	A	C	11	0	11	0	12	23	0	0
21	3738181	.	C	T	2	10	12	0	29	41	0	0
21	3778633	.	T	C	1	5	6	0	0	6	0	0
21	3786377	.	C	T	2	4	6	0	0	6	0	0
21	3789922	.	T	A	8	11	19	0	0	19	0	0
21	3789930	.	C	T	10	13	23	0	1	24	0	0
21	3789998	.	A	G	15	21	36	0	1	37	0	0
21	3793211	.	G	A	21	17	38	0	2	40	0	0
21	3793309	.	T	C	28	13	41	0	0	41	0	0
21	3793413	.	C	T	18	20	38	0	2	40	0	0
21	3796376	.	G	T	22	10	32	0	2	34	0	0
21	3796398	.	G	T	17	5	22	0	0	22	0	0
21	3796732	.	A	T	5	5	10	0	0	10	0	0
21	3797577	.	A	T	3	2	5	0	0	5	0	0
21	3803354	.	A	G	3	2	5	0	0	5	0	0
21	3822666	.	T	C	5	0	5	0	8	13	0	0
21	3822827	.	T	G	8	13	21	0	1	22	0	0
21	3822841	.	A	T	8	13	21	0	0	21	0	0
21	3822896	.	T	C	8	0	8	0	7	15	0	0
21	3825019	.	T	A	5	11	16	0	0	16	0	0
21	3841327	.	C	T	3	2	5	0	0	5	0	0
21	3852524	.	A	G	2	3	5	0	0	5	0	0
21	3866706	.	A	G	3	0	3	0	3	6	0	0
21	3868983	.	T	C	6	2	8	0	0	8	0	0
21	3880885	.	G	A	1	6	7	0	5	12	0	0
21	3881003	.	G	A	8	3	11	0	0	11	0	0
21	3881105	.	C	T	4	5	9	0	0	9	0	0
21	3917912	.	C	A	9	5	14	0	1	15	0	0
21	3918006	.	A	G	7	13	20	0	0	20	0	0
21	3918186	.	G	A	10	5	15	0	0	15	0	0
21	3953207	.	T	C	3	2	5	0	0	5	0	0
21	3954849	.	A	C	2	2	4	0	0	4	0	0
21	3954932	.	A	T	2	4	6	0	0	6	0	0
21	3955290	.	T	A	4	5	9	0	0	9	0	0
21	3955319	.	C	A	3	4	7	0	1	8	0	0
21	3955445	.	G	A	7	6	13	0	0	13	0	0
21	3958058	.	T	C	3	3	6	0	1	7	0	0
21	3958378	.	T	C	4	2	6	0	0	6	0	0
21	3961084	.	A	C	5	3	8	0	0	8	0	0
21	3972766	.	G	A	8	5	13	0	0	13	0	0
21	3995529	.	A	G	5	4	9	0	1	10	0	0
21	4025201	.	T	A	5	6	11	0	0	11	0	0
21	4166110	.	C	G	2	6	8	0	0	8	0	0
21	4170667	.	A	G	4	0	4	0	6	10	0	0
21	4182859	.	A	G	2	1	3	0	4	7	0	0
21	4185028	.	C	A	3	7	10	0	0	10	0	0
21	4185102	.	G	C	0	5	5	0	7	12	0	0
21	4188200	.	G	A	5	5	10	0	0	10	0	0
21	4188269	.	A	G	5	4	9	0	0	9	0	0
21	4188272	.	G	C	5	4	9	0	1	10	0	0
21	4191043	.	T	A	1	2	3	0	1	4	0	0
21	4201072	.	C	G	5	3	8	0	0	8	0	0
21	4207582	.	A	G	4	2	6	0	2	8	0	0
21	4207585	.	T	C	6	1	7	0	1	8	0	0
21	4208982	.	A	G	3	4	7	0	3	10	0	0
21	4209004	.	C	A	3	5	8	0	2	10	0	0
21	4209027	.	T	C	4	4	8	0	1	9	0	0
21	4209156	.	T	C	3	4	7	0	0	7	0	0
21	4210998	.	A	G	4	0	4	0	4	8	0	0
21	4219400	.	T	A	7	4	11	0	1	12	0	0
21	4219450	.	C	T	4	5	9	0	2	11	0	0
21	4219518	.	C	T	4	3	7	0	0	7	0	0
21	4227261	.	G	T	6	2	8	0	1	9	0	0
21	4227433	.	T	G	2	3	5	0	0	5	0	0
21	4227788	.	G	A	9	13	22	0	1	23	0	0
21	4228026	.	G	A	12	13	25	0	0	25	0	0
21	4232774	.	A	G	8	9	17	0	0	17	0	0
21	4237466	.	T	A	5	8	13	0	1	14	0	0
21	4237496	.	C	T	1	8	9	0	5	14	0	0
21	4240010	.	A	G	6	9	15	0	0	15	0	0
21	4240016	.	A	G	6	10	16	0	0	16	0	0
21	4240121	.	T	C	5	10	15	0	0	15	0	0
21	4244348	.	T	A	9	16	25	0	1	26	0	0
21	4244377	.	C	G	14	10	24	0	0	24	0	0
21	4247684	.	A	G	8	5	13	0	0	13	0	0
21	4250360	.	T	C	4	6	10	0	2	12	0	0
21	4250401	.	C	T	13	6	19	0	0	19	0	0
21	4250583	.	C	A	3	5	8	0	0	8	0	0
21	4250596	.	C	T	0	6	6	0	4	10	0	0
21	4250634	.	G	A	2	2	4	0	0	4	0	0
21	4250642	.	T	A	1	2	3	0	0	3	0	0
21	4284222	.	G	A	1	2	3	0	0	3	0	0
21	4284456	.	T	C	3	4	7	0	0	7	0	0
21	4287853	.	G	A	1	3	4	0	2	6	0	0
21	4287934	.	A	G	2	3	5	0	0	5	0	0
21	4293557	.	C	A	7	2	9	0	0	9	0	0
21	4300254	.	T	C	7	4	11	0	0	11	0	0
21	4300257	.	T	C	7	4	11	0	0	11	0	0
21	4300413	.	A	G	7	2	9	0	0	9	0	0
21	4304262	.	A	G	3	2	5	0	0	5	0	0
21	4304471	.	T	C	1	3	4	0	0	4	0	0
21	4304489	.	A	T	1	1	2	0	1	3	0	0
21	4304725	.	G	A	0	5	5	0	2	7	0	0
21	4304744	.	T	C	4	4	8	0	0	8	0	0
21	4304875	.	T	A	10	4	14	0	1	15	0	0
21	4304912	.	A	T	6	3	9	0	2	11	0	0
21	4304913	.	C	T	8	3	11	0	0	11	0	0
21	4518181	.	A	T	1	4	5	0	1	6	0	0
21	4518209	.	A	G	1	0	1	0	5	6	0	0
21	4534186	.	T	C	1	2	3	0	0	3	0	0
21	4534248	.	A	C	8	3	11	0	0	11	0	0
21	4534374	.	A	G	3	7	10	0	0	10	0	0
21	4535154	.	A	T	1	3	4	0	0	4	0	0
21	4535232	.	A	G	2	2	4	0	0	4	0	0
21	4539862	.	T	A	5	3	8	0	1	9	0	0
21	4556490	.	C	T	6	10	16	0	1	17	0	0
21	4559567	.	C	T	3	5	8	0	0	8	0	0
21	4559722	.	T	C	5	2	7	0	0	7	0	0
21	4562238	.	G	C	1	3	4	0	0	4	0	0
21	4568499	.	T	C	4	7	11	0	0	11	0	0
21	4568502	.	C	T	3	7	10	0	0	10	0	0
21	4571398	.	T	C	6	9	15	0	3	18	0	0
21	4573597	.	A	G	1	3	4	0	0	4	0	0
21	4576310	.	G	C	3	7	10	0	0	10	0	0
21	4576319	.	G	C	0	7	7	0	3	10	0	0
21	4578122	.	G	A	5	8	13	0	0	13	0	0
21	4578137	.	G	A	1	7	8	0	9	17	0	0
21	4578352	.	G	T	0	6	6	0	4	10	0	0
21	4578428	.	C	A	2	12	14	0	0	14	0	0
21	4578520	.	T	C	3	10	13	0	0	13	0	0
21	4578892	.	T	C	3	4	7	0	1	8	0	0
21	4578907	.	T	C	3	4	7	0	0	7	0	0
21	4582249	.	T	C	4	5	9	0	0	9	0	0
21	4582270	.	T	A	6	7	13	0	0	13	0	0
21	4583663	.	A	G	4	0	4	0	11	15	0	0
21	4585012	.	A	C	3	5	8	0	2	10	0	0
21	4585027	.	A	G	4	0	4	0	4	8	0	0
21	4585189	.	C	A	6	5	11	0	0	11	0	0
21	4589826	.	A	G	1	8	9	0	0	9	0	0
21	4591407	.	C	G	1	10	11	0	1	12	0	0
21	4591410	.	A	T	2	11	13	0	0	13	0	0
21	4591443	.	A	G	2	10	12	0	1	13	0	0
21	4592959	.	T	C	2	14	16	0	2	18	0	0
21	4592984	.	A	G	3	15	18	0	0	18	0	0
21	4593008	.	A	T	4	16	20	0	0	20	0	0
21	4596883	.	G	T	8	13	21	0	3	24	0	0
21	4596970	.	A	G	7	9	16	0	1	17	0	0
21	4600889	.	A	G	5	0	5	0	16	21	0	0
21	4603372	.	C	T	7	19	26	0	0	26	0	0
21	4647939	.	C	T	3	4	7	0	0	7	0	0
21	4653403	.	C	T	4	5	9	0	0	9	0	0
21	4653578	.	A	G	5	3	8	0	0	8	0	0
21	4653590	.	T	C	4	4	8	0	0	8	0	0
21	4656793	.	A	T	5	5	10	0	1	11	0	0
21	4659003	.	T	C	3	9	12	0	0	12	0	0
21	4659650	.	A	C	6	0	6	0	4	10	0	0
21	4660804	.	G	C	6	3	9	0	0	9	0	0
21	4660819	.	A	C	6	0	6	0	3	9	0	0
21	4660849	.	C	T	6	4	10	0	0	10	0	0
21	4661022	.	G	C	7	4	11	0	0	11	0	0
21	4667092	.	C	T	2	3	5	0	0	5	0	0
21	4668144	.	T	C	3	5	8	0	0	8	0	0
21	4670376	.	G	A	1	3	4	0	0	4	0	0
21	4679623	.	T	C	6	4	10	0	1	11	0	0
21	4679703	.	C	G	3	5	8	0	0	8	0	0
21	4712743	.	A	G	5	5	10	0	2	12	0	0
21	4712756	.	T	C	4	1	5	0	8	13	0	0
21	4713252	.	T	C	13	0	13	0	13	26	0	0
21	4718518	.	G	A	18	12	30	0	1	31	0	0
21	4720325	.	C	T	7	12	19	0	2	21	0	0
21	4723670	.	G	A	8	11	19	0	0	19	0	0
21	4724351	.	C	T	0	7	7	0	8	15	0	0
21	4724428	.	A	G	6	12	18	0	1	19	0	0
21	4724564	.	G	A	22	10	32	0	0	32	0	0
21	4724810	.	T	C	7	9	16	0	0	16	0	0
21	4729876	.	G	A	13	7	20	0	0	20	0	0
21	4740850	.	A	G	9	6	15	0	0	15	0	0
21	4742721	.	A	G	7	5	12	0	0	12	0	0
21	4742793	.	G	A	5	7	12	0	0	12	0	0
21	4748802	.	G	C	6	7	13	0	0	13	0	0
21	4748841	.	A	G	5	6	11	0	0	11	0	0
21	5004589	.	T	G	1	5	6	0	0	6	0	0
21	5034791	.	G	A	4	3	7	0	0	7	0	0
21	5034793	.	A	C	4	3	7	0	0	7	0	0
21	5042647	.	G	A	4	2	6	0	0	6	0	0
21	5056600	.	T	C	2	0	2	0	4	6	0	0
21	5066371	.	A	G	9	8	17	0	0	17	0	0
21	5066417	.	T	C	10	0	10	0	10	20	0	0
21	5066425	.	T	C	10	0	10	0	9	19	0	0
21	5159695	.	T	C	3	4	7	0	1	8	0	0
21	5160428	.	G	A	5	3	8	0	1	9	0	0
21	5162305	.	T	A	3	5	8	0	0	8	0	0
21	5169217	.	T	A	15	23	38	0	0	38	0	0
21	5171036	.	C	T	35	28	63	0	5	68	0	0
21	5173402	.	T	G	38	3	41	0	35	76	0	0
21	5173447	.	C	T	29	42	71	0	5	76	0	0
21	5173638	.	T	C	34	29	63	2	1	66	0	0
21	5199875	.	G	A	37	35	72	0	1	73	0	0
21	5200683	.	C	T	34	32	66	0	4	70	0	0
21	5209666	.	C	T	20	19	39	0	1	40	0	0
21	5237137	.	G	A	8	20	28	0	0	28	0	0
21	5240259	.	C	T	15	18	33	0	0	33	0	0
21	5797960	.	T	C	48	14	62	0	1	63	0	0
21	6134285	.	A	G	2	3	5	0	0	5	0	0
21	7109908	.	G	A	1	7	8	0	0	8	0	0
21	8145131	.	G	A	1	2	3	0	1	4	0	0
21	8145170	.	G	A	1	4	5	0	1	6	0	0
21	8343954	.	T	C	18	17	35	0	1	36	0	0
21	8344326	.	T	C	20	18	38	0	2	40	0	0
21	8346125	.	T	C	17	21	38	1	3	42	0	0
21	8347256	.	C	T	20	20	40	0	4	44	0	0
21	8348920	.	G	A	2	17	19	0	18	37	0	0
21	8348959	.	T	C	16	16	32	0	3	35	0	0
21	8348980	.	A	G	15	16	31	0	0	31	0	0
21	8348998	.	T	C	18	14	32	0	0	32	0	0
21	8349090	.	A	G	1	2	3	0	0	3	0	0
21	8352010	.	T	A	9	8	17	0	0	17	0	0
21	8427115	.	G	A	1	10	11	0	8	19	0	0
21	8438746	.	G	T	2	3	5	0	1	6	0	0
21	8444077	.	A	G	4	6	10	0	0	10	0	0
21	8454802	.	T	C	5	7	12	0	2	14	0	0
21	8456034	.	T	C	3	6	9	0	0	9	0	0
21	9370684	.	C	T	1	6	7	0	6	13	0	0
21	9370780	.	G	A	3	8	11	0	0	11	0	0
21	9377080	.	G	A	5	4	9	0	0	9	0	0
21	9377107	.	T	C	5	0	5	0	5	10	0	0
21	9377421	.	G	A	6	3	9	0	0	9	0	0
21	9381158	.	G	A	1	5	6	0	2	8	0	0
21	9382258	.	G	A	3	3	6	0	0	6	0	0
21	9384281	.	C	G	6	5	11	0	0	11	0	0
21	9384316	.	T	C	4	5	9	0	0	9	0	0
21	9391712	.	C	T	0	5	5	0	6	11	0	0
21	9399918	.	G	C	8	3	11	0	0	11	0	0
21	9401649	.	T	C	7	3	10	0	1	11	0	0
21	9406459	.	C	T	2	4	6	0	3	9	0	0
21	9406468	.	G	T	4	4	8	0	1	9	0	0
21	9406494	.	A	G	4	4	8	0	0	8	0	0
21	9418214	.	A	G	1	3	4	0	0	4	0	0
21	9418217	.	A	G	2	3	5	0	0	5	0	0
21	9425950	.	G	A	4	4	8	0	0	8	0	0
21	9429749	.	G	A	3	2	5	0	0	5	0	0
21	9429878	.	A	G	3	2	5	0	0	5	0	0
21	9434507	.	A	G	3	3	6	0	0	6	0	0
21	9439493	.	A	T	3	2	5	0	1	6	0	0
21	9439520	.	A	T	5	3	8	0	1	9	0	0
21	9477228	.	A	C	3	4	7	0	0	7	0	0
21	9576315	.	A	C	10	4	14	0	1	15	0	0
21	9576316	.	T	G	10	0	10	0	5	15	0	0
21	9987923	.	C	G	9	5	14	0	0	14	0	0
21	9989373	.	A	G	9	9	18	0	1	19	0	0
21	9991332	.	T	C	8	3	11	0	0	11	0	0
21	9991340	.	A	C	8	4	12	0	1	13	0	0
21	10018291	.	A	G	1	2	3	0	0	3	0	0
21	10018300	.	C	T	1	2	3	0	0	3	0	0
21	10018396	.	T	C	3	4	7	0	0	7	0	0
21	10024780	.	T	G	2	3	5	0	0	5	0	0
21	10024954	.	T	C	3	5	8	0	0	8	0	0
21	10066192	.	T	C	4	2	6	0	0	6	0	0
21	10068203	.	T	C	2	3	5	0	0	5	0	0
21	10095584	.	G	A	0	5	5	0	11	16	0	0
21	10095647	.	A	T	2	5	7	0	0	7	0	0
21	10100254	.	A	G	3	0	3	0	2	5	0	0
21	10100892	.	C	T	6	6	12	1	0	13	0	0
21	10254231	.	A	T	10	7	17	0	1	18	0	0
21	10254246	.	C	T	2	7	9	0	12	21	0	0
21	10288926	.	G	A	15	8	23	0	0	23	0	0
21	10319303	.	G	A	11	11	22	0	0	22	0	0
21	10319372	.	A	G	10	3	13	0	1	14	0	0
21	10422549	.	G	A	8	6	14	0	0	14	0	0
21	10422561	.	C	T	10	7	17	0	1	18	0	0
21	10422603	.	C	T	2	7	9	0	8	17	0	0
21	10702074	.	T	A	5	6	11	0	0	11	0	0
21	10702117	.	G	T	9	12	21	0	0	21	0	0
21	10702132	.	C	G	10	0	10	0	12	22	0	0
21	10702215	.	G	A	2	5	7	0	0	7	0	0
21	10713176	.	G	A	9	5	14	0	2	16	0	0
21	10715837	.	G	A	8	8	16	0	0	16	0	0
21	10715855	.	T	C	10	7	17	0	0	17	0	0
21	10729109	.	C	T	6	12	18	0	0	18	0	0
21	10731101	.	A	G	9	8	17	0	1	18	0	0
21	10731133	.	A	G	10	3	13	1	0	14	0	0
21	10731142	.	G	C	9	4	13	1	0	14	0	0
21	10790784	.	A	G	1	3	4	0	0	4	0	0
21	10790815	.	C	T	1	3	4	0	0	4	0	0
21	10795402	.	T	G	3	0	3	0	4	7	0	0
21	10795557	.	G	A	3	8	11	0	0	11	0	0
21	10795847	.	A	G	3	4	7	0	1	8	0	0
21	10795892	.	A	T	3	6	9	0	0	9	0	0
21	10796054	.	G	A	8	3	11	0	0	11	0	0
21	10796440	.	A	T	5	5	10	0	1	11	0	0
21	10797173	.	C	T	9	3	12	0	0	12	0	0
21	10799550	.	T	A	12	3	15	0	2	17	0	0
21	10816437	.	T	A	3	2	5	0	0	5	0	0
21	10890736	.	G	T	6	8	14	0	0	14	0	0
21	10891065	.	T	G	6	7	13	0	1	14	0	0
21	10891085	.	T	C	6	0	6	0	12	18	0	0
21	10892031	.	A	G	13	14	27	0	0	27	0	0
21	10903625	.	T	C	7	7	14	0	2	16	0	0
21	10918101	.	G	A	10	4	14	0	1	15	0	0
21	10933016	.	G	A	4	12	16	0	0	16	0	0
21	10950890	.	C	T	8	7	15	0	0	15	0	0
21	11054774	.	T	C	1	6	7	0	0	7	0	0
21	11105227	.	T	A	1	3	4	1	0	5	0	0
21	11119243	.	T	C	2	3	5	0	0	5	0	0
21	11130725	.	A	G	4	2	6	0	0	6	0	0
21	11131646	.	A	G	2	0	2	0	2	4	0	0
21	11131649	.	A	G	2	2	4	0	0	4	0	0
21	11131691	.	A	G	4	0	4	0	0	6	2	0
21	11133117	.	C	T	4	3	7	0	0	7	0	0
21	11133426	.	A	G	5	0	5	0	5	10	0	0
21	11133431	.	C	T	6	5	11	0	0	11	0	0
21	11133471	.	A	T	6	3	9	0	0	9	0	0
21	11133633	.	A	G	3	0	3	0	2	5	0	0
21	11133729	.	C	A	1	2	3	0	0	3	0	0
21	11133762	.	A	G	1	2	3	0	0	3	0	0
21	11133944	.	A	G	1	1	2	0	0	2	0	0
21	11133964	.	T	G	1	2	3	0	0	3	0	0
21	11134595	.	G	A	2	3	5	0	0	5	0	0
21	11134720	.	G	A	1	2	3	0	0	3	0	0
21	11135186	.	C	T	1	4	5	0	0	5	0	0
21	11135188	.	T	G	1	4	5	0	0	5	0	0
21	11135389	.	A	T	2	2	4	0	1	5	0	0
21	11180201	.	T	C	4	5	9	0	0	9	0	0
21	11180215	.	C	T	6	5	11	0	0	11	0	0
21	11182127	.	G	T	8	10	18	0	0	18	0	0
21	11189725	.	C	T	6	5	11	0	0	11	0	0
21	11191971	.	A	T	5	6	11	0	0	11	0	0
21	11193317	.	A	G	5	4	9	0	0	9	0	0
21	11193391	.	C	T	4	2	6	0	0	6	0	0
21	11257193	.	A	G	1	2	3	0	0	3	0	0
21	11311376	.	G	A	1	2	3	0	0	3	0	0
21	11330670	.	T	A	6	5	11	0	0	11	0	0
21	11339191	.	C	T	9	4	13	0	0	13	0	0
21	11339704	.	T	C	5	3	8	0	0	8	0	0
21	11339710	.	T	C	6	0	6	0	4	10	0	0
21	11340011	.	G	A	5	2	7	0	0	7	0	0
21	11342305	.	T	C	6	4	10	0	2	12	0	0
21	11342333	.	A	G	7	5	12	0	0	12	0	0
21	11342604	.	C	G	2	2	4	0	3	7	0	0
21	11342622	.	T	C	6	2	8	0	0	8	0	0
21	11342740	.	A	G	2	2	4	0	0	4	0	0
21	11349583	.	A	T	5	4	9	0	1	10	0	0
21	11349584	.	T	G	5	5	10	0	0	10	0	0
21	11349836	.	G	T	3	5	8	0	1	9	0	0
21	11352470	.	G	A	4	3	7	0	1	8	0	0
21	11352504	.	C	T	0	2	2	0	6	8	0	0
21	11354025	.	T	C	1	2	3	0	1	4	0	0
21	11354077	.	A	G	3	5	8	0	2	10	0	0
21	11355508	.	A	G	2	2	4	0	0	4	0	0
21	11356829	.	A	G	3	5	8	0	1	9	0	0
21	11360396	.	T	G	6	2	8	0	1	9	0	0
21	11360429	.	A	T	6	4	10	0	0	10	0	0
21	11363785	.	C	A	3	2	5	0	0	5	0	0
21	11363835	.	G	A	3	2	5	0	0	5	0	0
21	11363946	.	A	G	2	3	5	0	0	5	0	0
21	11364065	.	C	T	3	6	9	0	1	10	0	0
21	11364114	.	A	G	4	6	10	0	0	10	0	0
21	11365441	.	G	A	3	4	7	0	1	8	0	0
21	11369857	.	A	C	5	3	8	0	1	9	0	0
21	11369871	.	A	G	8	3	11	0	1	12	0	0
21	11369899	.	A	T	7	4	11	0	0	11	0	0
21	11382887	.	C	T	10	4	14	0	0	14	0	0
21	11382899	.	T	C	8	4	12	0	0	12	0	0
21	11405676	.	C	T	2	2	4	0	0	4	0	0
21	11405709	.	T	A	3	2	5	0	0	5	0	0
21	11415249	.	T	A	1	7	8	0	0	8	0	0
21	11415494	.	G	A	1	6	7	0	5	12	0	0
21	11425152	.	C	T	10	15	25	0	1	26	0	0
21	11425182	.	G	A	12	14	26	0	2	28	0	0
21	11425218	.	T	C	9	16	25	0	0	25	0	0
21	11427850	.	T	C	8	9	17	0	1	18	0	0
21	11434022	.	C	A	8	9	17	0	3	20	0	0
21	11434116	.	T	C	4	10	14	0	1	15	0	0
21	11468957	.	A	C	29	25	54	0	3	57	0	0
21	11469119	.	A	G	32	30	62	0	3	65	0	0
21	11477418	.	A	G	35	1	36	0	29	65	0	0
21	11477496	.	T	C	30	27	57	0	1	58	0	0
21	11486933	.	T	C	35	29	64	1	4	69	0	0
21	11492826	.	C	T	39	30	69	0	0	69	0	0
21	11494536	.	A	G	38	3	41	0	28	69	0	0
21	11501308	.	T	C	35	31	66	0	2	68	0	0
21	11501618	.	T	A	23	17	40	0	1	42	1	0
21	11501665	.	C	T	24	21	45	1	0	46	0	0
21	11501975	.	A	G	33	18	51	0	1	52	0	0
21	11502120	.	T	C	35	19	54	0	7	61	0	0
21	11502143	.	A	G	26	33	59	0	2	61	0	0
21	11502807	.	G	T	4	13	17	0	18	35	0	0
21	11517544	.	A	G	3	2	5	0	0	5	0	0
21	11518424	.	G	A	2	4	6	0	0	6	0	0
21	11518787	.	G	T	0	2	2	0	1	3	0	0
21	11527950	.	A	G	2	0	2	0	2	4	0	0
21	11528040	.	A	G	5	3	8	0	0	8	0	0
21	11528047	.	A	C	4	3	7	0	0	7	0	0
21	11528094	.	G	A	4	4	8	0	3	11	0	0
21	11528777	.	C	T	1	1	2	0	1	3	0	0
21	11566285	.	T	G	4	5	9	0	0	9	0	0
21	11566478	.	G	T	3	9	12	0	1	13	0	0
21	11571108	.	G	A	3	3	6	0	1	7	0	0
21	11571147	.	T	C	6	7	13	0	1	14	0	0
21	11571159	.	G	T	5	9	14	0	0	14	0	0
21	11571279	.	C	G	6	3	9	0	1	10	0	0
21	11571287	.	T	A	7	3	10	0	1	11	0	0
21	11571353	.	G	A	8	6	14	0	0	14	0	0
21	11579624	.	T	C	8	6	14	0	0	14	0	0
21	11602249	.	T	A	4	4	8	0	0	8	0	0
21	11603878	.	C	T	0	4	4	0	3	7	0	0
21	11605710	.	C	A	0	2	2	0	2	4	0	0
21	11605801	.	C	T	1	3	4	0	0	4	0	0
21	11607758	.	T	C	4	0	4	0	3	7	0	0
21	11709084	.	G	A	16	21	37	0	1	38	0	0
21	11713042	.	G	A	3	19	22	0	24	46	0	0
21	11718420	.	T	C	16	25	41	0	0	41	0	0
21	11721310	.	T	C	27	19	46	0	2	48	0	0
21	11721984	.	A	G	18	0	18	0	24	42	0	0
21	11722262	.	C	T	16	16	32	0	4	36	0	0
21	11722277	.	C	T	19	13	32	0	3	35	0	0
21	11759242	.	A	G	2	4	6	0	2	8	0	0
21	11762387	.	G	T	2	5	7	0	0	7	0	0
21	11764327	.	G	A	0	2	2	0	2	4	0	0
21	11766523	.	A	T	6	5	11	0	0	11	0	0
21	11766535	.	G	A	0	7	7	0	4	11	0	0
21	11766598	.	T	A	5	1	6	0	2	8	0	0
21	11766663	.	T	G	6	0	6	0	5	11	0	0
21	11766664	.	T	C	5	4	9	0	2	11	0	0
21	11767009	.	G	C	4	6	10	0	0	10	0	0
21	11773106	.	G	A	4	4	8	0	1	9	0	0
21	11774330	.	T	A	1	2	3	0	0	3	0	0
21	11774398	.	T	G	2	0	2	0	4	6	0	0
21	11774860	.	C	T	6	2	8	0	0	8	0	0
21	11781541	.	A	G	3	11	14	0	1	15	0	0
21	11791937	.	A	T	3	5	8	0	0	8	0	0
21	11791948	.	G	A	2	6	8	0	0	8	0	0
21	11799553	.	A	G	5	6	11	0	0	11	0	0
21	11814897	.	A	G	5	3	8	0	0	8	0	0
21	11816763	.	C	A	4	7	11	0	0	11	0	0
21	11855947	.	C	T	3	6	9	0	1	10	0	0
21	11866057	.	A	C	18	9	27	0	1	28	0	0
21	11867908	.	T	C	11	6	17	0	2	19	0	0
21	11869420	.	T	A	12	10	22	0	2	24	0	0
21	11869495	.	C	A	12	11	23	0	1	24	0	0
21	11869774	.	G	C	1	8	9	0	14	23	0	0
21	11869870	.	C	T	13	7	20	0	2	22	0	0
21	11880927	.	G	A	9	8	17	0	1	18	0	0
21	11880996	.	G	A	8	15	23	0	0	23	0	0
21	11881129	.	G	C	5	7	12	0	0	12	0	0
21	11881140	.	C	T	8	9	17	0	0	17	0	0
21	11881344	.	G	A	8	11	19	0	0	19	0	0
21	11881715	.	C	T	13	9	22	0	0	22	0	0
21	11881875	.	A	T	4	4	8	0	0	8	0	0
21	11882184	.	C	A	1	1	2	0	0	2	0	0
21	11882794	.	G	A	1	3	4	0	0	4	0	0
21	11883896	.	C	T	1	5	6	0	0	6	0	0
21	11883901	.	A	G	1	5	6	0	0	6	0	0
21	11898772	.	A	C	7	10	17	0	0	17	0	0
21	11911722	.	A	T	21	9	30	0	0	30	0	0
21	11911730	.	A	T	21	7	28	0	0	28	0	0
21	11911921	.	C	T	8	12	20	0	1	21	0	0
21	11927113	.	C	T	24	12	36	0	1	37	0	0
21	11927809	.	G	C	1	19	20	0	14	34	0	0
21	11932372	.	T	C	8	22	30	0	2	32	0	0
21	11937522	.	A	G	15	17	32	0	7	39	0	0
21	11942334	.	T	C	22	20	42	0	7	49	0	0
21	11942407	.	T	C	23	17	40	0	0	40	0	0
21	11945863	.	C	T	19	14	33	0	1	34	0	0
21	11946133	.	C	T	14	18	32	0	2	34	0	0
21	11949317	.	C	T	26	15	41	0	4	45	0	0
21	11950217	.	C	A	20	23	43	0	3	46	0	0
21	11955208	.	A	C	3	5	8	0	13	21	0	0
21	11958852	.	A	T	8	9	17	0	2	19	0	0
21	11958928	.	A	G	13	8	21	0	1	22	0	0
21	11958971	.	G	T	11	7	18	0	0	18	0	0
21	11958982	.	C	T	11	5	16	0	1	17	0	0
21	11959034	.	G	A	4	8	12	0	1	13	0	0
21	11959061	.	T	G	8	11	19	0	1	20	0	0
21	11959185	.	A	G	13	14	27	0	0	27	0	0
21	11959309	.	T	C	11	27	38	0	0	38	0	0
21	11961122	.	C	T	13	15	28	1	2	31	0	0
21	11963068	.	G	A	3	4	7	0	0	7	0	0
21	11963090	.	T	G	1	5	6	0	0	6	0	0
21	11963778	.	C	A	11	11	22	0	2	24	0	0
21	11964981	.	C	T	6	9	15	0	0	15	0	0
21	11965035	.	T	G	15	8	23	0	0	23	0	0
21	11967077	.	T	C	10	9	19	0	1	20	0	0
21	11967857	.	A	C	10	6	16	0	2	18	0	0
21	11970139	.	C	T	1	13	14	0	13	27	0	0
21	12023880	.	A	C	3	2	5	0	1	6	0	0
21	12028080	.	G	A	15	12	27	0	1	28	0	0
21	12036013	.	C	T	7	9	16	0	1	17	0	0
21	12037366	.	C	T	2	2	4	0	0	4	0	0
21	12041221	.	T	C	1	3	4	0	0	4	0	0
21	12080051	.	C	G	1	17	18	0	22	40	0	0
21	12095798	.	A	G	23	24	47	0	0	47	0	0
21	12104957	.	C	A	15	20	35	0	0	35	0	0
21	12107367	.	A	G	19	11	30	0	2	32	0	0
21	12272375	.	T	G	29	15	44	0	0	44	0	0
21	13193928	.	C	T	24	26	50	0	1	51	0	0
21	13217902	.	G	A	7	2	9	0	2	11	0	0
21	13260193	.	T	C	1	4	5	0	0	5	0	0
21	13282455	.	T	A	2	3	5	0	0	5	0	0
21	13329495	.	C	T	17	20	37	0	1	38	0	0
21	13353301	.	T	A	5	5	10	1	2	13	0	0
21	13360446	.	C	T	22	15	37	0	0	37	0	0
21	13362830	.	A	C	27	18	45	0	3	48	0	0
21	13362896	.	C	T	26	20	46	0	3	49	0	0
21	13364790	.	T	A	16	21	37	0	2	39	0	0
21	13364802	.	T	C	16	20	36	0	0	36	0	0
21	13388223	.	T	C	6	4	10	0	0	10	0	0
21	13410331	.	A	G	7	7	14	0	0	14	0	0
21	13431198	.	G	A	11	12	23	0	0	23	0	0
21	13431261	.	G	C	8	6	14	0	1	15	0	0
21	13431309	.	A	G	6	0	6	0	9	15	0	0
21	13431363	.	A	T	8	6	14	0	0	14	0	0
21	13431379	.	T	A	5	3	8	0	0	8	0	0
21	13431470	.	A	G	2	4	6	0	0	6	0	0
21	13431573	.	T	C	3	3	6	0	0	6	0	0
21	13431620	.	T	C	3	3	6	0	0	6	0	0
21	13431639	.	C	T	3	4	7	0	1	8	0	0
21	13431668	.	T	A	5	2	7	0	0	7	0	0
21	13431697	.	C	A	5	4	9	0	0	9	0	0
21	13431720	.	T	A	4	3	7	0	0	7	0	0
21	13431924	.	A	G	1	6	7	0	0	7	0	0
21	13431947	.	A	T	3	6	9	0	0	9	0	0
21	13432071	.	A	C	1	1	2	0	1	3	0	0
21	13432117	.	T	G	2	0	2	0	3	5	0	0
21	13432315	.	T	C	12	7	19	0	0	19	0	0
21	13432369	.	C	A	7	6	13	0	2	15	0	0
21	13463160	.	T	G	11	3	14	0	0	14	0	0
21	13473775	.	A	G	4	10	14	0	0	14	0	0
21	13493234	.	A	G	5	5	10	0	0	10	0	0
21	13493762	.	A	G	5	6	11	0	2	13	0	0
21	13611930	.	G	T	3	3	6	0	0	6	0	0
21	13612174	.	T	A	3	5	8	0	1	9	0	0
21	13612534	.	T	C	3	3	6	0	3	9	0	0
21	13612559	.	A	T	3	8	11	0	1	12	0	0
21	13612827	.	G	A	3	3	6	1	0	7	0	0
21	13612846	.	T	C	4	0	4	1	5	10	0	0
21	13612927	.	A	T	7	3	10	0	1	11	0	0
21	13613017	.	A	G	7	2	9	0	0	9	0	0
21	13613111	.	T	C	1	3	4	0	1	5	0	0
21	13613112	.	G	A	2	3	5	0	0	5	0	0
21	13613172	.	C	T	1	3	4	0	2	6	0	0
21	13613232	.	G	A	1	2	3	0	0	3	0	0
21	13613479	.	T	C	6	3	9	0	0	9	0	0
21	13614022	.	C	T	1	2	3	0	0	3	0	0
21	13614054	.	C	T	1	2	3	0	0	3	0	0
21	13614703	.	G	T	3	4	7	0	2	9	0	0
21	13615217	.	T	C	4	1	5	0	2	7	0	0
21	13617335	.	A	G	1	3	4	0	1	5	0	0
21	13617389	.	C	T	2	6	8	0	0	8	0	0
21	13618076	.	T	G	3	6	9	0	1	10	0	0
21	13619823	.	C	T	0	8	8	0	2	10	0	0
21	13621487	.	G	T	5	2	7	0	1	8	0	0
21	13625355	.	G	A	2	3	5	0	0	5	0	0
21	13629268	.	A	G	1	3	4	0	0	4	0	0
21	13644056	.	C	A	2	1	3	0	0	3	0	0
21	13644068	.	G	A	2	2	4	0	0	4	0	0
21	13657087	.	G	A	2	2	4	0	0	4	0	0
21	13662170	.	G	A	6	3	9	0	0	9	0	0
21	13702751	.	A	T	23	15	38	0	2	40	0	0
21	13714602	.	T	C	18	7	25	0	5	30	0	0
21	13714603	.	G	A	23	7	30	0	0	30	0	0
21	13715285	.	T	A	24	19	43	0	7	50	0	0
21	13715347	.	T	A	24	19	43	0	1	44	0	0
21	13715356	.	A	G	27	18	45	0	0	45	0	0
21	13751205	.	G	C	12	15	27	0	2	29	0	0
21	13762547	.	C	T	3	3	6	0	0	6	0	0
21	13762760	.	C	T	3	2	5	0	1	6	0	0
21	13765938	.	T	C	1	4	5	0	0	5	0	0
21	13765957	.	T	C	1	0	1	0	3	4	0	0
21	13766022	.	C	G	0	3	3	0	4	7	0	0
21	13771160	.	G	T	4	4	8	0	0	8	0	0
21	13771269	.	G	T	4	2	6	0	0	6	0	0
21	13779968	.	C	A	1	3	4	0	3	7	0	0
21	13786089	.	G	A	5	3	8	0	0	8	0	0
21	13794602	.	C	T	4	4	8	0	1	9	0	0
21	13794652	.	G	T	5	7	12	0	0	12	0	0
21	13796033	.	G	A	7	9	16	0	1	17	0	0
21	13796165	.	G	A	8	9	17	0	0	17	0	0
21	13796743	.	A	G	3	12	15	0	1	16	0	0
21	13800157	.	G	A	1	2	3	0	0	3	0	0
21	13895741	.	C	T	32	29	61	0	4	65	0	0
21	13895799	.	C	A	34	33	67	0	5	72	0	0
21	13895849	.	G	A	6	28	34	0	36	70	0	0
21	13895862	.	A	C	38	30	68	0	2	70	0	0
21	14173820	.	T	G	3	5	8	0	0	8	0	0
21	14174060	.	G	A	1	5	6	0	0	6	0	0
21	14174098	.	G	A	3	2	5	0	0	5	0	0
21	14175614	.	C	T	0	2	2	0	2	4	0	0
21	14239956	.	C	T	13	6	19	0	0	19	0	0
21	14239988	.	C	T	7	7	14	0	0	14	0	0
21	14240025	.	G	T	7	8	15	0	0	15	0	0
21	14241982	.	G	T	10	13	23	0	1	24	0	0
21	14251160	.	T	A	7	11	18	0	0	18	0	0
21	14381335	.	G	A	8	5	13	0	0	13	0	0
21	14381356	.	C	T	0	3	3	0	8	11	0	0
21	14381422	.	G	A	3	6	9	0	0	9	0	0
21	14381547	.	T	C	5	0	5	0	9	14	0	0
21	14383767	.	T	C	8	1	9	0	5	14	0	0
21	14383809	.	C	T	0	5	5	0	10	15	0	0
21	14396466	.	C	T	4	3	7	0	0	8	1	0
21	14399414	.	A	C	6	0	6	0	4	10	0	0
21	14399444	.	A	T	4	5	9	0	0	9	0	0
21	14399710	.	T	G	6	5	11	0	1	12	0	0
21	14399729	.	A	G	6	7	13	0	0	13	0	0
21	14415698	.	A	G	2	4	6	0	0	6	0	0
21	14417839	.	A	G	5	4	9	0	0	9	0	0
21	14425017	.	A	T	1	3	4	0	0	4	0	0
21	14456531	.	C	T	3	3	6	0	0	6	0	0
21	14465324	.	G	C	3	4	7	0	0	7	0	0
21	14469501	.	A	G	2	2	4	0	0	4	0	0
21	14492237	.	G	C	2	6	8	0	0	8	0	0
21	14531292	.	G	A	2	3	5	0	0	5	0	0
21	14644363	.	T	C	5	3	8	0	1	9	0	0
21	14644704	.	A	T	3	8	11	0	0	11	0	0
21	14644869	.	C	G	4	13	17	0	0	17	0	0
21	14644885	.	A	T	4	16	20	0	0	20	0	0
21	14644969	.	A	G	11	7	18	0	0	18	0	0
21	14644981	.	G	C	7	10	17	0	0	17	0	0
21	14645006	.	G	A	11	6	17	0	0	17	0	0
21	14645021	.	G	A	9	11	20	0	0	20	0	0
21	14645113	.	A	G	7	6	13	0	1	14	0	0
21	14645125	.	A	G	8	5	13	0	1	14	0	0
21	14645238	.	C	A	6	5	11	0	0	11	0	0
21	14645239	.	C	A	7	5	12	0	0	12	0	0
21	14645300	.	G	A	10	8	18	0	0	18	0	0
21	14645369	.	A	T	6	8	14	0	0	14	0	0
21	14645641	.	C	A	13	3	16	0	1	17	0	0
21	14645642	.	A	C	13	4	17	0	0	17	0	0
21	14654497	.	G	A	6	3	9	0	0	9	0	0
21	14657314	.	C	T	1	6	7	0	7	14	0	0
21	14659421	.	C	T	8	11	19	0	2	21	0	0
21	14659462	.	T	A	5	9	14	0	0	15	1	0
21	14659997	.	T	C	8	7	15	0	0	15	0	0
21	14663428	.	A	G	6	10	16	0	0	16	0	0
21	14663853	.	C	G	7	14	21	0	0	21	0	0
21	14663911	.	T	C	6	5	11	0	1	12	0	0
21	14664425	.	T	C	8	8	16	0	2	18	0	0
21	14664851	.	T	C	7	7	14	0	1	15	0	0
21	14665343	.	C	T	1	7	8	0	8	16	0	0
21	14665397	.	C	A	8	7	15	0	0	15	0	0
21	14665427	.	C	T	9	6	15	0	0	15	0	0
21	14665510	.	C	A	5	10	15	0	1	16	0	0
21	14701897	.	G	A	7	12	19	0	0	19	0	0
21	14702073	.	C	G	12	9	21	1	1	23	0	0
21	14702193	.	C	T	5	5	10	1	0	11	0	0
21	14702211	.	C	T	0	4	4	0	4	8	0	0
21	14704871	.	G	A	9	6	15	0	2	17	0	0
21	14706677	.	C	A	5	5	10	0	0	10	0	0
21	14719613	.	G	C	4	0	4	0	3	7	0	0
21	14810988	.	T	C	2	3	5	0	0	5	0	0
21	14812964	.	G	A	6	4	10	0	0	10	0	0
21	14813064	.	A	G	10	4	14	0	0	14	0	0
21	14813138	.	A	G	5	9	14	0	0	14	0	0
21	14813282	.	C	G	16	13	29	0	1	30	0	0
21	14813380	.	G	C	9	10	19	0	0	19	0	0
21	14813402	.	T	A	10	13	23	0	0	23	0	0
21	14813479	.	T	C	9	1	10	0	16	26	0	0
21	14815804	.	A	G	8	14	22	0	0	22	0	0
21	14817425	.	C	T	2	2	4	0	0	4	0	0
21	14817434	.	A	G	2	3	5	0	0	5	0	0
21	14819421	.	C	G	3	5	8	0	7	15	0	0
21	14819766	.	G	A	5	6	11	0	0	11	0	0
21	14823023	.	G	A	3	4	7	0	0	7	0	0
21	14823035	.	T	C	3	0	3	0	4	7	0	0
21	14823792	.	T	G	1	3	4	0	0	4	0	0
21	14825750	.	G	A	2	3	5	0	0	5	0	0
21	14825756	.	G	A	2	3	5	0	0	5	0	0
21	14825952	.	T	C	5	8	13	0	0	13	0	0
21	14828692	.	C	T	0	4	4	0	1	5	0	0
21	14828722	.	A	C	5	2	7	0	0	7	0	0
21	14828848	.	T	C	3	4	7	0	0	7	0	0
21	14828935	.	T	C	5	2	7	0	0	7	0	0
21	14829081	.	C	A	0	10	10	0	6	16	0	0
21	14829091	.	G	A	5	7	12	0	1	13	0	0
21	14829145	.	A	G	3	4	7	0	0	7	0	0
21	14831911	.	A	G	2	2	4	0	1	5	0	0
21	14831929	.	T	C	2	0	2	0	4	6	0	0
21	14832141	.	C	T	4	2	6	0	1	7	0	0
21	14842944	.	T	C	16	12	28	0	0	28	0	0
21	14843085	.	C	T	15	10	25	0	0	25	0	0
21	14846607	.	T	C	10	10	20	0	3	23	0	0
21	14848426	.	A	C	16	11	27	0	0	27	0	0
21	14848427	.	T	A	15	11	26	0	1	27	0	0
21	14859396	.	C	T	13	7	20	0	0	20	0	0
21	14859447	.	A	C	10	10	20	0	2	22	0	0
21	14862981	.	G	A	21	14	35	0	1	36	0	0
21	14877995	.	C	T	1	7	8	0	8	16	0	0
21	14892293	.	A	T	6	5	11	0	0	11	0	0
21	14904837	.	G	A	6	4	10	0	0	11	1	0
21	14909372	.	C	G	2	5	7	0	0	7	0	0
21	14913330	.	G	C	4	6	10	0	1	11	0	0
21	14921242	.	G	A	8	5	13	0	0	13	0	0
21	14939488	.	C	G	0	4	4	0	2	6	0	0
21	14939576	.	G	A	6	5	11	0	0	11	0	0
21	15125603	.	A	C	12	2	14	0	0	14	0	0
21	15125661	.	G	A	19	11	30	0	1	31	0	0
21	15125667	.	G	A	19	11	30	0	1	31	0	0
21	15125825	.	T	C	17	1	18	0	6	24	0	0
21	15125859	.	T	C	17	11	28	0	0	28	0	0
21	15125867	.	C	T	13	12	25	0	1	26	0	0
21	15126048	.	G	A	19	12	31	0	2	33	0	0
21	15126068	.	G	T	16	12	28	0	2	31	1	0
21	15126088	.	G	A	13	17	30	0	0	30	0	0
21	15154547	.	A	T	23	18	41	0	2	43	0	0
21	15154625	.	A	G	14	17	31	0	2	33	0	0
21	15230556	.	C	T	2	12	14	0	27	41	0	0
21	15234284	.	T	A	29	19	48	0	2	50	0	0
21	15252402	.	G	A	23	28	51	0	0	51	0	0
21	15252491	.	C	A	2	23	25	0	14	39	0	0
21	15260170	.	A	C	16	0	16	0	16	32	0	0
21	15263962	.	C	T	3	20	23	0	18	41	0	0
21	17192940	.	C	T	12	12	24	0	2	26	0	0
21	17246756	.	G	A	12	12	24	0	2	26	0	0
21	17253268	.	A	G	14	12	26	0	1	27	0	0
21	17253496	.	T	C	9	9	18	0	2	20	0	0
21	17255773	.	C	T	10	4	14	0	0	14	0	0
21	17255815	.	C	G	11	8	19	0	0	19	0	0
21	17256590	.	A	C	19	10	29	0	3	32	0	0
21	17256656	.	A	G	15	9	24	0	0	24	0	0
21	17258362	.	A	G	9	16	25	0	0	25	0	0
21	17258421	.	T	A	10	10	20	0	2	22	0	0
21	17258486	.	C	T	15	17	32	0	0	32	0	0
21	17258576	.	T	G	11	13	24	0	1	25	0	0
21	17258670	.	A	G	12	0	12	0	8	20	0	0
21	17258771	.	G	A	1	15	16	0	9	25	0	0
21	17258784	.	A	C	11	16	27	0	0	27	0	0
21	17258842	.	A	G	7	9	16	0	0	16	0	0
21	17259081	.	C	G	10	16	26	0	0	26	0	0
21	17259279	.	G	T	1	8	9	0	9	18	0	0
21	17259332	.	T	C	13	8	21	0	1	22	0	0
21	17259466	.	A	T	10	9	19	0	2	21	0	0
21	17260532	.	C	G	4	5	9	0	0	9	0	0
21	17307144	.	C	T	5	9	14	0	1	15	0	0
21	17312383	.	C	T	5	2	7	0	1	8	0	0
21	17313776	.	G	A	4	5	9	0	1	10	0	0
21	17314037	.	G	A	7	3	10	0	0	10	0	0
21	17314054	.	C	T	6	3	9	0	0	9	0	0
21	17322472	.	G	A	2	16	18	0	16	34	0	0
21	17322478	.	C	A	14	14	28	0	2	30	0	0
21	17325413	.	G	A	10	5	15	0	1	16	0	0
21	17325965	.	G	A	10	7	17	0	2	19	0	0
21	17327264	.	A	G	11	0	11	0	6	17	0	0
21	17327293	.	A	G	9	0	9	0	10	19	0	0
21	17327599	.	C	T	5	2	7	0	0	7	0	0
21	17335595	.	T	C	12	9	21	0	0	21	0	0
21	17335709	.	C	T	9	4	13	0	1	14	0	0
21	17337807	.	C	T	13	10	23	0	2	25	0	0
21	17337865	.	C	T	13	10	23	0	0	23	0	0
21	17337898	.	A	T	16	8	24	0	1	25	0	0
21	17338101	.	A	C	15	9	24	0	1	25	0	0
21	17338141	.	T	G	15	12	27	0	0	27	0	0
21	17338593	.	G	A	4	8	12	0	2	14	0	0
21	17339664	.	C	T	11	23	34	0	1	35	0	0
21	17413852	.	C	T	2	6	8	0	0	8	0	0
21	17419958	.	C	T	1	3	4	0	3	7	0	0
21	17420492	.	G	A	4	3	7	0	0	7	0	0
21	17420960	.	A	C	3	4	7	0	0	7	0	0
21	17421067	.	G	T	1	4	5	0	0	5	0	0
21	17424390	.	G	C	2	0	2	0	3	5	0	0
21	17478552	.	T	A	4	5	9	0	0	9	0	0
21	17478936	.	C	T	3	19	22	0	24	46	0	0
21	17480251	.	T	A	19	13	32	1	3	36	0	0
21	17482237	.	A	G	16	10	26	0	0	26	0	0
21	17549205	.	C	T	7	14	21	0	1	22	0	0
21	17567289	.	G	A	24	13	37	0	2	39	0	0
21	17567593	.	T	C	6	8	14	0	1	15	0	0
21	17567612	.	C	T	9	11	20	0	0	20	0	0
21	17567642	.	T	C	13	9	22	0	1	23	0	0
21	17567649	.	T	C	13	10	23	0	1	24	0	0
21	17567857	.	C	A	19	7	26	0	1	27	0	0
21	17567880	.	A	T	17	8	25	0	0	25	0	0
21	17567911	.	C	T	12	8	20	0	1	21	0	0
21	17567940	.	C	A	8	8	16	0	0	16	0	0
21	17567994	.	A	C	2	2	4	0	0	5	1	0
21	17568027	.	G	A	5	3	8	0	2	10	0	0
21	17568482	.	A	G	8	11	19	0	1	20	0	0
21	17568507	.	A	T	10	13	23	0	0	23	0	0
21	17568543	.	A	G	13	19	32	0	1	33	0	0
21	17568655	.	G	A	1	20	21	1	15	37	0	0
21	17568819	.	G	A	3	5	8	0	9	17	0	0
21	17568825	.	T	A	10	5	15	0	0	15	0	0
21	17569200	.	A	G	13	14	27	0	1	28	0	0
21	17569587	.	C	A	18	12	30	0	4	34	0	0
21	17569647	.	T	C	15	15	30	0	0	30	0	0
21	17569745	.	T	A	7	8	15	0	0	15	0	0
21	17569747	.	T	A	7	8	15	0	0	15	0	0
21	17569808	.	A	C	8	5	13	0	0	13	0	0
21	17569812	.	C	G	10	4	14	0	0	14	0	0
21	17572988	.	C	A	8	5	13	0	1	14	0	0
21	17578655	.	C	T	0	10	10	0	5	15	0	0
21	17578717	.	G	A	5	7	12	0	1	13	0	0
21	17580509	.	G	A	2	7	9	0	0	9	0	0
21	17587774	.	A	G	5	3	8	0	0	8	0	0
21	17587937	.	A	G	2	2	4	0	0	4	0	0
21	17587946	.	A	G	3	3	6	0	0	6	0	0
21	17588000	.	G	A	2	5	7	0	0	7	0	0
21	17589992	.	G	A	2	3	5	0	0	5	0	0
21	17592446	.	C	A	3	5	8	0	0	8	0	0
21	17592516	.	T	A	1	2	3	0	0	3	0	0
21	17592768	.	G	A	4	2	6	0	0	6	0	0
21	17592854	.	G	T	4	2	6	0	1	7	0	0
21	17603075	.	T	A	4	7	11	0	0	11	0	0
21	17603098	.	C	T	0	5	5	0	5	10	0	0
21	17910473	.	A	C	5	5	10	0	0	10	0	0
21	17932675	.	T	C	6	5	11	0	0	11	0	0
21	17984484	.	C	A	18	6	24	0	1	25	0	0
21	17984685	.	G	A	12	11	23	0	0	23	0	0
21	17984919	.	G	A	8	10	18	0	0	18	0	0
21	17984965	.	G	A	8	15	23	0	0	23	0	0
21	17985047	.	C	T	5	2	7	0	1	8	0	0
21	18022981	.	C	T	7	3	10	0	0	10	0	0
21	18023170	.	G	T	12	8	20	0	0	20	0	0
21	18023283	.	G	A	7	6	13	0	2	15	0	0
21	18023309	.	T	G	7	6	13	0	0	13	0	0
21	18023704	.	A	G	4	8	12	0	2	14	0	0
21	18023717	.	A	G	5	7	12	0	0	12	0	0
21	18023792	.	G	T	5	8	13	0	0	13	0	0
21	18024032	.	A	C	7	5	12	0	0	12	0	0
21	18024633	.	C	T	3	7	10	0	11	21	0	0
21	18032121	.	G	T	8	6	14	0	0	14	0	0
21	18032981	.	T	C	1	5	6	0	0	6	0	0
21	18065958	.	T	C	4	5	9	0	1	10	0	0
21	18269653	.	C	T	2	10	12	0	13	25	0	0
21	18269695	.	C	T	7	10	17	0	0	17	0	0
21	18270864	.	G	T	3	2	5	0	0	5	0	0
21	18270958	.	T	G	0	2	2	0	0	2	0	0
21	18270975	.	T	C	1	0	1	0	2	3	0	0
21	18271138	.	C	T	11	14	25	0	1	26	0	0
21	18271650	.	T	A	8	12	20	1	0	21	0	0
21	18272195	.	T	C	12	12	24	0	0	24	0	0
21	18272435	.	T	C	10	6	16	0	2	18	0	0
21	18272507	.	C	G	1	7	8	0	7	15	0	0
21	18272687	.	T	C	2	10	12	0	0	12	0	0
21	18273434	.	G	A	15	9	24	0	0	24	0	0
21	18273485	.	A	T	17	7	24	0	1	25	0	0
21	18276073	.	A	G	14	0	14	0	12	26	0	0
21	18285868	.	C	T	18	11	29	0	2	31	0	0
21	18286641	.	C	T	22	11	33	0	0	33	0	0
21	18289749	.	T	C	20	18	38	0	0	38	0	0
21	18289909	.	G	C	18	9	27	0	1	28	0	0
21	18331963	.	G	A	5	2	7	0	0	7	0	0
21	18339622	.	G	A	7	3	10	1	1	12	0	0
21	18370570	.	G	A	1	6	7	0	11	18	0	0
21	18372902	.	G	A	10	20	30	0	8	38	0	0
21	18375442	.	A	G	12	10	22	0	0	22	0	0
21	18375662	.	G	A	1	12	13	0	15	28	0	0
21	18382501	.	T	C	6	10	16	0	0	16	0	0
21	18382546	.	C	T	8	12	20	0	0	20	0	0
21	18385061	.	C	T	12	4	16	0	2	18	0	0
21	18386613	.	C	T	20	8	28	0	1	29	0	0
21	18386704	.	A	G	11	1	12	0	5	17	0	0
21	18386849	.	C	T	11	9	20	2	1	23	0	0
21	18600454	.	T	C	3	3	6	0	0	6	0	0
21	18600750	.	T	A	1	5	6	0	0	6	0	0
21	18600764	.	A	G	1	5	6	0	0	6	0	0
21	18600880	.	C	T	0	3	3	0	6	9	0	0
21	18602893	.	A	T	6	4	10	0	0	10	0	0
21	18608588	.	G	A	1	3	4	0	1	5	0	0
21	18616068	.	G	A	5	2	7	0	0	7	0	0
21	18616098	.	T	C	7	3	10	0	0	10	0	0
21	18648803	.	A	G	5	6	11	0	0	11	0	0
21	18701475	.	A	G	4	5	9	0	0	9	0	0
21	18759575	.	G	A	1	2	3	0	1	4	0	0
21	18759677	.	T	C	4	4	8	0	0	8	0	0
21	18759773	.	A	G	3	3	6	0	0	6	0	0
21	18759928	.	T	C	1	3	4	0	2	6	0	0
21	18759965	.	A	T	1	6	7	0	0	7	0	0
21	18760160	.	T	C	5	2	7	0	1	8	0	0
21	18921053	.	T	C	7	3	10	0	0	10	0	0
21	18921092	.	A	G	5	0	5	0	3	8	0	0
21	18921369	.	G	A	5	2	7	0	1	8	0	0
21	18922940	.	T	C	3	6	9	0	0	9	0	0
21	18922973	.	G	A	4	5	9	0	0	9	0	0
21	18923115	.	A	G	4	2	6	0	0	6	0	0
21	18924676	.	C	T	4	5	9	0	1	10	0	0
21	18924712	.	T	C	1	3	4	0	0	4	0	0
21	18925111	.	A	C	3	2	5	0	0	5	0	0
21	18929509	.	T	C	11	4	15	0	0	15	0	0
21	18932088	.	A	G	5	14	19	0	1	20	0	0
21	18932287	.	C	T	1	4	5	0	16	21	0	0
21	18932717	.	G	A	10	7	17	0	1	18	0	0
21	18933748	.	G	T	9	9	18	0	0	18	0	0
21	18934265	.	C	A	2	11	13	1	13	27	0	0
21	18934289	.	C	T	1	6	7	1	15	23	0	0
21	18937216	.	C	T	7	13	20	0	7	27	0	0
21	18938388	.	A	G	6	5	11	0	0	11	0	0
21	18938391	.	C	T	4	5	9	0	1	10	0	0
21	18950633	.	C	T	3	8	11	0	0	11	0	0
21	18950754	.	G	A	6	8	14	0	1	15	0	0
21	18950997	.	T	G	19	9	28	0	2	30	0	0
21	18956779	.	C	T	11	8	19	0	1	20	0	0
21	18956883	.	T	A	15	14	29	0	2	31	0	0
21	18957259	.	G	A	15	10	25	0	1	26	0	0
21	18957601	.	C	G	13	7	20	0	0	20	0	0
21	18957624	.	T	C	11	5	16	0	0	16	0	0
21	18957776	.	T	C	11	7	18	0	0	18	0	0
21	19008736	.	G	A	14	15	29	0	0	29	0	0
21	19008845	.	C	T	23	15	38	0	3	41	0	0
21	19009346	.	T	C	15	25	40	0	1	41	0	0
21	19014036	.	T	G	16	16	32	0	2	34	0	0
21	19014298	.	C	T	31	32	63	0	1	64	0	0
21	19015460	.	C	A	30	19	49	0	0	49	0	0
21	19015461	.	C	A	30	19	49	0	0	49	0	0
21	19017819	.	G	A	21	33	54	0	1	55	0	0
21	19018434	.	T	A	13	15	28	0	0	28	0	0
21	19061852	.	A	G	1	0	1	0	2	3	0	0
21	19061861	.	C	A	1	3	4	0	0	4	0	0
21	19067092	.	A	G	35	35	70	0	3	73	0	0
21	19071919	.	C	T	3	5	8	0	0	8	0	0
21	19073046	.	A	T	4	7	11	0	1	12	0	0
21	19073143	.	G	T	4	2	6	0	1	7	0	0
21	19329135	.	C	T	6	8	14	0	0	14	0	0
21	19329971	.	C	G	1	16	17	0	16	33	0	0
21	19333422	.	A	G	1	2	3	0	0	3	0	0
21	19345608	.	A	G	2	3	5	0	0	5	0	0
21	19347892	.	C	G	2	0	2	0	2	4	0	0
21	19350213	.	T	A	2	3	5	0	0	5	0	0
21	19353416	.	C	T	6	6	12	0	0	12	0	0
21	19418953	.	T	A	1	2	3	0	0	3	0	0
21	19438107	.	C	T	2	2	4	0	1	5	0	0
21	19441250	.	C	T	3	2	5	0	0	5	0	0
21	19602415	.	T	C	1	2	3	0	0	3	0	0
21	19602444	.	A	G	2	2	4	0	0	4	0	0
21	19602645	.	G	A	2	2	4	0	0	4	0	0
21	19603286	.	G	A	1	3	4	0	5	9	0	0
21	19603309	.	T	G	3	6	9	0	1	10	0	0
21	19603399	.	G	A	5	4	9	0	0	9	0	0
21	19607552	.	C	T	5	2	7	0	0	7	0	0
21	19763668	.	C	T	18	13	31	0	1	32	0	0
21	19763692	.	A	T	25	13	38	0	0	38	0	0
21	19763715	.	T	G	29	21	50	0	1	51	0	0
21	19763942	.	G	A	26	28	54	0	1	55	0	0
21	19764230	.	C	T	21	31	52	0	6	58	0	0
21	19764432	.	G	A	31	18	49	0	2	51	0	0
21	19785355	.	G	T	21	19	40	0	0	40	0	0
21	19785379	.	A	T	16	26	42	0	2	44	0	0
21	19790527	.	A	C	21	27	48	0	1	49	0	0
21	19790590	.	G	A	19	19	38	0	1	39	0	0
21	19792767	.	T	G	23	19	42	0	0	42	0	0
21	19792803	.	G	A	17	20	37	0	1	38	0	0
21	19796215	.	G	A	19	21	40	0	3	43	0	0
21	19804193	.	T	G	26	13	39	0	0	39	0	0
21	19805635	.	G	A	19	16	35	0	0	35	0	0
21	19805647	.	G	A	22	17	39	0	1	40	0	0
21	19809122	.	T	C	18	0	18	0	18	36	0	0
21	19820016	.	G	T	19	14	33	0	0	33	0	0
21	19821323	.	C	A	4	17	21	0	20	41	0	0
21	19821449	.	A	T	19	18	37	0	6	43	0	0
21	19862896	.	C	T	4	3	7	0	0	7	0	0
21	19868489	.	C	T	6	9	15	0	0	15	0	0
21	19868674	.	G	A	5	3	8	0	0	8	0	0
21	19869129	.	C	T	7	7	14	0	0	14	0	0
21	19872681	.	A	G	9	7	16	0	0	16	0	0
21	19872772	.	G	A	12	7	19	0	0	19	0	0
21	19872904	.	C	T	16	8	24	0	0	24	0	0
21	19903584	.	G	A	10	10	20	0	0	20	0	0
21	19904556	.	T	C	3	11	14	0	2	16	0	0
21	19904713	.	G	C	8	10	18	0	0	18	0	0
21	19904871	.	G	A	5	8	13	0	0	13	0	0
21	19905105	.	G	A	4	2	6	0	0	6	0	0
21	19905553	.	C	T	3	4	7	0	0	7	0	0
21	19905564	.	G	A	4	6	10	0	0	10	0	0
21	19905609	.	C	G	3	8	11	0	0	11	0	0
21	19905762	.	T	C	9	6	15	0	0	15	0	0
21	19905915	.	A	G	3	6	9	0	1	10	0	0
21	19906355	.	G	A	8	5	13	0	0	13	0	0
21	19906513	.	T	C	6	8	14	0	0	14	0	0
21	19906589	.	G	C	3	3	6	0	0	6	0	0
21	19906590	.	A	C	3	0	3	0	3	6	0	0
21	19906666	.	C	T	3	5	8	0	1	9	0	0
21	19911433	.	G	T	4	8	12	1	1	14	0	0
21	19911467	.	C	A	10	7	17	1	0	18	0	0
21	19913445	.	G	C	6	6	12	0	0	12	0	0
21	19914241	.	C	T	8	3	11	0	0	11	0	0
21	19914263	.	T	G	6	2	8	0	0	8	0	0
21	19915594	.	T	G	7	3	10	1	0	11	0	0
21	19915724	.	T	C	3	2	5	0	3	8	0	0
21	19915867	.	T	A	2	3	5	0	0	5	0	0
21	19926210	.	C	T	8	4	12	0	0	12	0	0
21	19926444	.	T	C	6	3	9	0	0	9	0	0
21	19929996	.	T	C	7	4	11	0	2	13	0	0
21	20035065	.	T	C	6	8	14	0	0	14	0	0
21	20064720	.	T	A	3	6	9	0	0	9	0	0
21	20067528	.	C	T	7	8	15	0	0	15	0	0
21	20067531	.	C	T	9	7	16	0	1	17	0	0
21	20080608	.	G	T	2	9	11	0	8	19	0	0
21	20086915	.	C	T	11	8	19	0	1	20	0	0
21	20089886	.	C	T	9	17	26	0	1	27	0	0
21	20101713	.	A	G	11	0	11	0	14	25	0	0
21	20105111	.	A	T	10	18	28	0	0	28	0	0
21	20105129	.	C	T	17	14	31	0	0	31	0	0
21	20106551	.	A	G	16	20	36	0	0	36	0	0
21	20108258	.	A	T	19	13	32	1	0	33	0	0
21	20108772	.	A	G	4	5	9	0	0	12	3	0
21	20108782	.	G	A	6	4	10	0	0	10	0	0
21	20113519	.	C	A	8	7	15	0	1	16	0	0
21	20113659	.	A	G	4	5	9	1	1	11	0	0
21	20114148	.	G	A	12	15	27	1	0	28	0	0
21	20118979	.	C	T	9	8	17	0	1	18	0	0
21	20120057	.	A	G	7	16	23	0	0	23	0	0
21	20120404	.	G	A	9	12	21	0	0	21	0	0
21	20377931	.	C	T	10	7	17	0	0	17	0	0
21	20377944	.	C	T	13	12	25	0	0	25	0	0
21	20394348	.	C	T	2	3	5	0	0	5	0	0
21	20394936	.	C	T	3	2	5	0	0	5	0	0
21	20395011	.	G	A	0	2	2	0	1	3	0	0
21	20633152	.	A	G	4	2	6	0	0	6	0	0
21	20633249	.	T	C	5	5	10	0	1	11	0	0
21	20633300	.	A	G	3	0	3	0	5	8	0	0
21	20634255	.	T	A	2	2	4	0	0	5	1	0
21	20634380	.	T	A	1	6	7	0	0	7	0	0
21	20634883	.	T	A	5	6	11	0	0	11	0	0
21	20634935	.	A	G	1	3	4	1	0	5	0	0
21	20635320	.	T	A	3	3	6	0	0	6	0	0
21	20635659	.	T	A	11	0	11	0	0	11	0	0
21	20636063	.	G	T	0	3	3	0	4	7	0	0
21	20636119	.	T	C	2	4	6	0	1	7	0	0
21	20636130	.	G	T	6	2	8	0	0	8	0	0
21	20636403	.	C	T	4	6	10	0	0	10	0	0
21	20909676	.	C	T	10	10	20	0	1	21	0	0
21	20950679	.	T	C	7	7	14	0	1	15	0	0
21	20950811	.	C	G	3	2	5	0	0	5	0	0
21	20950841	.	A	G	4	2	6	0	0	6	0	0
21	21013693	.	C	G	15	3	18	0	7	25	0	0
21	21017513	.	C	T	16	14	30	0	3	33	0	0
21	21020589	.	C	T	9	9	18	0	1	19	0	0
21	21029465	.	G	C	13	11	24	0	0	24	0	0
21	21038891	.	G	T	20	12	32	0	2	34	0	0
21	21039092	.	C	T	14	18	32	0	2	34	0	0
21	21046882	.	C	T	15	10	25	0	1	26	0	0
21	21046960	.	G	A	9	11	20	0	3	23	0	0
21	21048363	.	G	A	22	13	35	0	0	35	0	0
21	21049323	.	G	A	16	16	32	0	1	33	0	0
21	21051391	.	A	C	16	1	17	0	14	31	0	0
21	21051688	.	G	A	15	17	32	0	0	32	0	0
21	21057398	.	T	A	17	14	31	0	1	32	0	0
21	21065212	.	A	T	11	9	20	0	3	23	0	0
21	21069395	.	C	A	0	12	12	0	13	25	0	0
21	21069692	.	G	C	9	14	23	0	4	27	0	0
21	21069858	.	A	G	11	15	26	0	1	27	0	0
21	21072309	.	C	T	13	16	29	0	0	29	0	0
21	21075987	.	C	T	8	6	14	0	0	14	0	0
21	21076080	.	C	T	3	7	10	0	7	17	0	0
21	21083041	.	C	T	0	3	3	0	6	9	0	0
21	21177120	.	T	C	4	10	14	0	0	14	0	0
21	21210716	.	T	G	8	3	11	0	1	12	0	0
21	21210857	.	T	C	2	6	8	0	1	9	0	0
21	21216078	.	G	A	0	4	4	0	2	6	0	0
21	21217799	.	C	T	4	5	9	0	0	9	0	0
21	21217999	.	G	A	5	4	9	0	0	9	0	0
21	21221016	.	T	G	7	7	14	0	0	14	0	0
21	21224343	.	T	C	6	3	9	0	1	10	0	0
21	21228207	.	T	A	2	3	5	0	1	6	0	0
21	21230016	.	C	T	11	6	17	0	1	18	0	0
21	21230137	.	C	A	4	10	14	0	0	14	0	0
21	21232768	.	G	T	6	8	14	0	1	15	0	0
21	21233095	.	T	C	5	5	10	0	0	10	0	0
21	21233182	.	G	A	7	6	13	0	0	13	0	0
21	21233266	.	A	T	9	6	15	0	0	15	0	0
21	21233281	.	G	A	8	6	14	0	2	16	0	0
21	21233674	.	T	A	5	5	10	0	1	11	0	0
21	21234939	.	C	T	2	5	7	0	0	7	0	0
21	21236883	.	G	A	2	10	12	0	0	12	0	0
21	21238089	.	C	T	1	7	8	0	2	10	0	0
21	21238098	.	C	T	2	8	10	0	0	10	0	0
21	21239969	.	A	G	7	7	14	0	1	15	0	0
21	21239977	.	A	C	6	8	14	0	1	15	0	0
21	21240166	.	A	G	4	4	8	0	0	8	0	0
21	21240568	.	C	T	9	6	15	0	0	15	0	0
21	21240651	.	C	T	16	14	30	0	0	30	0	0
21	21240776	.	G	A	4	2	6	0	0	6	0	0
21	21240927	.	C	G	3	4	7	0	0	7	0	0
21	21241218	.	T	A	3	5	8	0	2	10	0	0
21	21241223	.	T	A	5	5	10	0	0	10	0	0
21	21241364	.	T	A	10	4	14	0	0	14	0	0
21	21241412	.	A	T	7	4	11	0	1	12	0	0
21	21241469	.	A	T	3	2	5	0	0	5	0	0
21	21241598	.	A	G	6	3	9	0	0	9	0	0
21	21241900	.	C	T	9	6	15	0	0	15	0	0
21	21242132	.	A	G	2	5	7	0	0	7	0	0
21	21264861	.	G	A	2	2	4	0	0	4	0	0
21	21269737	.	A	G	6	5	11	0	0	11	0	0
21	21272549	.	C	T	6	3	9	1	0	10	0	0
21	21273096	.	A	G	7	5	12	0	0	12	0	0
21	21277089	.	G	A	0	4	4	0	1	5	0	0
21	21279262	.	G	T	2	9	11	0	15	26	0	0
21	21279360	.	A	G	13	1	14	0	10	24	0	0
21	21279368	.	G	A	1	11	12	0	13	25	0	0
21	21286183	.	G	C	9	7	16	0	2	18	0	0
21	21294260	.	C	T	13	12	25	0	3	28	0	0
21	21294272	.	C	T	16	15	31	0	1	32	0	0
21	21294299	.	C	T	19	11	30	0	0	30	0	0
21	21294362	.	A	G	11	0	11	0	6	17	0	0
21	21295195	.	A	C	16	14	30	0	0	30	0	0
21	21298158	.	G	T	9	8	17	0	0	17	0	0
21	21298340	.	G	A	13	10	23	0	1	24	0	0
21	21298387	.	A	G	13	2	15	0	10	25	0	0
21	21313543	.	G	A	1	2	3	0	3	6	0	0
21	21314012	.	G	A	3	3	6	0	0	6	0	0
21	21314061	.	A	G	3	2	5	0	0	5	0	0
21	21325628	.	T	G	6	6	12	0	0	12	0	0
21	21326118	.	C	A	5	6	11	0	0	11	0	0
21	21326139	.	C	T	3	2	5	0	0	5	0	0
21	21326220	.	A	C	4	2	6	0	1	7	0	0
21	21326222	.	A	G	4	3	7	0	0	7	0	0
21	21333080	.	T	G	3	3	6	0	1	7	0	0
21	21333164	.	C	T	7	3	10	0	1	11	0	0
21	21339410	.	A	T	2	9	11	0	0	11	0	0
21	21342595	.	A	G	6	5	11	0	0	11	0	0
21	21342738	.	C	T	2	2	4	0	0	4	0	0
21	21343266	.	A	G	4	5	9	0	0	9	0	0
21	21346850	.	C	T	16	24	40	0	1	41	0	0
21	21347039	.	G	A	10	4	14	0	2	16	0	0
21	21347053	.	T	A	10	5	15	0	1	16	0	0
21	21347180	.	G	C	4	3	7	0	1	8	0	0
21	21368363	.	A	G	18	11	29	0	0	29	0	0
21	21370406	.	T	C	19	0	19	0	17	36	0	0
21	21372874	.	T	A	14	18	32	0	0	32	0	0
21	21450574	.	C	T	9	3	12	0	0	12	0	0
21	21450608	.	G	C	2	3	5	0	0	5	0	0
21	21450616	.	A	G	0	4	4	0	1	5	0	0
21	21450735	.	A	G	4	3	7	0	1	8	0	0
21	21451013	.	T	C	12	1	13	0	5	18	0	0
21	21451025	.	C	A	12	10	22	0	1	23	0	0
21	21523303	.	T	A	8	6	14	0	0	14	0	0
21	21523344	.	A	G	12	6	18	0	0	18	0	0
21	21523465	.	A	G	4	3	7	0	0	7	0	0
21	21523612	.	G	T	4	2	6	0	1	7	0	0
21	21525887	.	T	C	6	6	12	0	1	13	0	0
21	21525895	.	A	G	8	6	14	0	0	14	0	0
21	21527417	.	A	G	1	5	6	0	0	6	0	0
21	21615351	.	T	G	5	3	8	0	0	8	0	0
21	21633459	.	A	T	4	2	6	0	1	7	0	0
21	21633601	.	G	A	2	6	8	0	0	8	0	0
21	21633774	.	G	A	5	3	8	0	0	8	0	0
21	21639592	.	A	T	3	2	5	0	0	5	0	0
21	21744345	.	T	C	3	7	10	0	0	10	0	0
21	21745489	.	T	G	2	2	4	0	1	5	0	0
21	21745498	.	G	A	2	2	4	0	1	5	0	0
21	21745654	.	G	A	3	6	9	0	0	9	0	0
21	21746132	.	G	A	1	4	5	0	5	10	0	0
21	21746136	.	G	T	5	4	9	0	1	10	0	0
21	21750684	.	T	C	10	6	16	0	2	18	0	0
21	21750702	.	A	G	9	8	17	0	0	17	0	0
21	21751303	.	A	G	5	5	10	0	0	10	0	0
21	21754470	.	T	C	10	5	15	0	1	16	0	0
21	21791917	.	T	C	10	3	13	0	1	14	0	0
21	21791934	.	A	T	11	4	15	0	1	16	0	0
21	21793903	.	C	T	6	2	8	0	0	8	0	0
21	21794361	.	A	G	4	0	4	0	7	11	0	0
21	21798715	.	C	T	1	2	3	0	0	3	0	0
21	21819180	.	A	G	2	2	4	1	0	5	0	0
21	21820136	.	A	G	3	3	6	0	1	7	0	0
21	21996637	.	G	A	23	17	40	0	2	42	0	0
21	22030596	.	A	G	10	1	11	0	16	27	0	0
21	22038369	.	T	C	21	25	46	0	1	47	0	0
21	22044690	.	T	A	14	18	32	0	0	32	0	0
21	22048143	.	G	A	20	5	25	0	2	27	0	0
21	22070486	.	A	G	22	10	32	2	2	36	0	0
21	22070522	.	C	T	26	10	36	2	0	38	0	0
21	22070591	.	G	A	4	11	15	0	15	30	0	0
21	22070633	.	C	T	9	20	29	0	0	29	0	0
21	22082184	.	C	T	18	22	40	0	1	41	0	0
21	22082257	.	C	T	19	8	27	0	0	27	0	0
21	22099610	.	A	G	3	6	9	0	1	10	0	0
21	22099698	.	A	G	23	24	47	0	1	48	0	0
21	22099727	.	A	G	23	24	47	0	0	47	0	0
21	22099869	.	G	A	31	32	63	0	2	65	0	0
21	22100026	.	A	G	34	26	60	0	1	61	0	0
21	22100156	.	A	G	45	5	50	4	8	62	0	0
21	22100453	.	C	T	32	35	67	0	3	70	0	0
21	22100511	.	G	A	32	22	54	1	1	56	0	0
21	22100594	.	A	G	26	26	52	0	4	56	0	0
21	22100767	.	C	T	33	21	54	0	5	59	0	0
21	22101056	.	C	A	26	22	48	0	0	48	0	0
21	22101423	.	C	T	4	24	28	1	34	63	0	0
21	22101460	.	C	T	34	21	55	1	2	58	0	0
21	22101540	.	G	A	35	30	65	0	1	66	0	0
21	22101637	.	T	C	29	0	29	0	23	52	0	0
21	22101769	.	A	G	23	22	45	0	1	46	0	0
21	22101777	.	G	A	18	23	41	0	3	44	0	0
21	22101827	.	C	G	8	20	28	0	30	58	0	0
21	22101835	.	C	T	31	24	55	0	4	59	0	0
21	22101917	.	A	T	30	31	61	0	2	63	0	0
21	22102037	.	G	A	31	26	57	0	2	59	0	0
21	22102154	.	C	A	34	27	61	0	0	61	0	0
21	22102281	.	A	C	27	27	54	0	3	57	0	0
21	22102361	.	C	G	26	26	52	0	1	53	0	0
21	22102365	.	A	T	26	23	49	0	3	52	0	0
21	22102416	.	C	T	4	24	28	0	26	54	0	0
21	22102440	.	A	C	27	27	54	0	1	55	0	0
21	22102457	.	A	C	23	32	55	0	2	57	0	0
21	22102542	.	C	T	14	27	41	0	1	42	0	0
21	22102586	.	C	A	9	42	51	0	1	52	0	0
21	22102653	.	A	G	15	27	42	0	2	44	0	0
21	22102838	.	T	G	27	27	54	0	1	55	0	0
21	22102930	.	C	T	35	32	67	0	4	71	0	0
21	22110288	.	T	C	23	2	25	0	28	53	0	0
21	22110303	.	G	A	26	28	54	0	2	56	0	0
21	22111754	.	A	T	27	21	48	0	6	54	0	0
21	22111880	.	G	A	23	23	46	0	1	48	1	0
21	22111982	.	C	A	20	27	47	0	1	48	0	0
21	22138571	.	C	G	7	7	14	0	0	14	0	0
21	22140654	.	C	G	3	3	6	0	0	6	0	0
21	22140937	.	C	A	8	5	13	0	0	13	0	0
21	22142362	.	A	G	8	8	16	0	1	17	0	0
21	22142820	.	G	A	0	7	7	0	10	17	0	0
21	22209234	.	C	G	1	2	3	0	0	3	0	0
21	22209258	.	A	C	2	3	5	0	0	5	0	0
21	22209273	.	A	G	2	3	5	0	0	5	0	0
21	22210431	.	C	T	1	3	4	0	0	4	0	0
21	22210436	.	C	T	1	3	4	0	0	4	0	0
21	22210511	.	C	T	2	4	6	0	0	7	1	0
21	22282836	.	T	C	1	2	3	0	0	3	0	0
21	22330177	.	A	C	6	2	8	0	0	8	0	0
21	22330250	.	T	C	2	2	4	0	0	4	0	0
21	22336365	.	C	T	7	5	12	0	0	12	0	0
21	22385837	.	T	A	3	2	5	0	0	5	0	0
21	22386107	.	A	C	2	3	5	0	0	5	0	0
21	22386134	.	G	A	2	3	5	0	0	5	0	0
21	22386912	.	A	C	3	2	5	0	0	5	0	0
21	22387072	.	A	C	2	3	5	0	0	5	0	0
21	22388102	.	T	G	3	2	5	0	0	5	0	0
21	22394624	.	T	C	2	2	4	0	0	4	0	0
21	22404852	.	T	C	16	17	33	0	0	33	0	0
21	22404855	.	T	C	15	16	31	0	0	31	0	0
21	22405045	.	T	C	11	13	24	0	2	26	0	0
21	22405232	.	T	A	13	13	26	0	3	29	0	0
21	22406755	.	T	C	11	14	25	0	0	25	0	0
21	22407000	.	T	C	12	17	29	0	2	31	0	0
21	22410965	.	T	A	14	17	31	0	0	31	0	0
21	22412343	.	C	T	19	13	32	0	0	32	0	0
21	22421867	.	T	G	8	9	17	0	1	18	0	0
21	22422052	.	A	G	17	14	31	0	0	31	0	0
21	22422184	.	A	G	19	7	26	0	0	26	0	0
21	22422565	.	C	G	5	9	14	0	2	16	0	0
21	22422733	.	A	G	10	6	16	0	1	17	0	0
21	22880016	.	A	T	3	16	19	0	0	19	0	0
21	25103676	.	T	A	17	11	28	0	0	28	0	0
21	25380817	.	T	A	6	3	9	0	0	9	0	0
21	25605515	.	T	A	9	4	13	0	1	14	0	0
21	25817230	.	A	G	6	5	11	0	0	11	0	0
21	25817779	.	A	G	5	4	9	0	0	9	0	0
21	25817780	.	A	G	6	3	9	0	0	9	0	0
21	25936341	.	G	A	0	7	7	0	1	8	0	0
21	27283932	.	A	C	2	0	2	0	13	15	0	0
21	27356939	.	G	A	1	8	9	1	0	10	0	0
21	28561707	.	T	C	1	8	9	0	0	9	0	0
21	28900932	.	T	G	5	1	6	0	14	20	0	0
21	29075247	.	G	T	10	10	20	0	7	27	0	0
21	30299804	.	C	T	1	8	9	0	0	9	0	0
21	30692632	.	A	G	3	7	10	0	0	10	0	0
21	30692796	.	A	G	7	5	12	0	0	12	0	0
21	30692817	.	A	G	7	0	7	0	3	10	0	0
21	32281076	.	G	A	6	3	9	0	1	10	0	0
21	32281122	.	G	A	11	7	18	0	1	19	0	0
21	32281155	.	G	A	11	10	21	0	0	21	0	0
21	32281680	.	C	T	9	13	22	0	0	22	0	0
21	32283519	.	G	A	14	12	26	0	1	27	0	0
21	32284398	.	A	G	12	8	20	0	0	20	0	0
21	32285080	.	C	T	5	3	8	0	0	8	0	0
21	32285135	.	T	C	3	0	3	0	5	8	0	0
21	32285161	.	A	G	4	4	8	0	0	8	0	0
21	32342458	.	G	A	4	6	10	0	0	10	0	0
21	32343230	.	C	A	11	7	18	0	0	18	0	0
21	32343248	.	C	A	14	8	22	0	0	22	0	0
21	32343316	.	T	A	15	8	23	0	1	24	0	0
21	32343453	.	C	T	15	8	23	0	0	23	0	0
21	32343577	.	T	C	7	12	19	0	2	21	0	0
21	32343649	.	C	A	12	6	18	0	2	20	0	0
21	32343721	.	T	G	4	0	4	0	9	13	0	0
21	32344021	.	C	A	13	7	20	0	0	20	0	0
21	32345162	.	T	C	7	7	14	0	0	14	0	0
21	32345318	.	G	A	0	6	6	0	5	11	0	0
21	32345499	.	A	G	3	5	8	0	0	8	0	0
21	32345607	.	C	T	6	7	13	0	0	13	0	0
21	32345724	.	A	G	1	4	5	1	0	6	0	0
21	32345749	.	A	G	3	4	7	1	0	8	0	0
21	32345774	.	A	T	4	4	8	1	0	9	0	0
21	32345827	.	C	A	2	2	4	0	0	4	0	0
21	32346021	.	A	C	3	2	5	0	1	6	0	0
21	32346273	.	G	A	16	27	43	0	0	43	0	0
21	32346603	.	G	C	10	13	23	0	1	24	0	0
21	32346630	.	T	C	13	14	27	0	1	28	0	0
21	32346674	.	T	A	17	13	30	0	0	30	0	0
21	32346689	.	A	G	16	14	30	1	0	31	0	0
21	32346799	.	G	A	12	11	23	0	0	23	0	0
21	32346800	.	T	A	11	10	21	0	2	23	0	0
21	32346899	.	A	G	19	9	28	0	0	28	0	0
21	32346901	.	A	G	19	9	28	0	1	29	0	0
21	32347134	.	T	A	12	19	31	1	0	32	0	0
21	32347292	.	T	A	11	5	16	0	2	18	0	0
21	32347569	.	G	T	12	18	30	0	0	30	0	0
21	32347855	.	T	C	20	12	32	0	2	34	0	0
21	32347966	.	A	C	18	0	18	0	14	32	0	0
21	32348230	.	A	T	14	11	25	0	1	26	0	0
21	32348321	.	C	A	4	3	7	0	0	7	0	0
21	32348512	.	G	T	11	11	22	0	1	23	0	0
21	32348542	.	A	T	13	17	30	0	3	33	0	0
21	32348570	.	C	T	16	17	33	0	0	33	0	0
21	32348600	.	C	T	13	11	24	0	1	25	0	0
21	32348664	.	G	A	9	16	25	1	0	26	0	0
21	32352459	.	C	G	22	21	43	0	0	43	0	0
21	32353049	.	G	A	9	11	20	0	2	22	0	0
21	32354980	.	A	G	10	20	30	0	2	32	0	0
21	32374460	.	A	T	10	19	29	0	0	29	0	0
21	32457785	.	T	C	9	15	24	0	0	24	0	0
21	32457923	.	C	A	18	14	32	0	2	34	0	0
21	32457931	.	T	G	19	13	32	0	1	33	0	0
21	32457983	.	G	A	13	11	24	0	0	24	0	0
21	32458261	.	A	G	25	17	42	0	2	44	0	0
21	32458315	.	T	A	17	18	35	0	1	36	0	0
21	32460782	.	G	C	10	4	14	0	1	15	0	0
21	32460912	.	A	G	18	25	43	0	3	46	0	0
21	32466140	.	G	C	21	21	42	0	2	44	0	0
21	32467660	.	A	G	27	13	40	0	3	43	0	0
21	32467724	.	T	C	20	20	40	0	0	40	0	0
21	32476760	.	A	G	21	29	50	0	4	54	0	0
21	32477584	.	T	C	31	20	51	0	1	52	0	0
21	32477967	.	C	T	35	25	60	0	0	60	0	0
21	32477987	.	A	T	35	19	54	0	11	65	0	0
21	32478227	.	G	T	41	24	65	1	3	69	0	0
21	32482797	.	C	T	36	19	55	0	5	60	0	0
21	32482854	.	T	C	33	3	36	1	25	62	0	0
21	32486997	.	A	T	4	7	11	0	0	11	0	0
21	32552207	.	G	A	1	2	3	0	0	3	0	0
21	32684537	.	A	T	2	3	5	0	1	6	0	0
21	32684538	.	T	A	2	4	6	0	0	6	0	0
21	32758254	.	G	A	16	9	25	0	1	26	0	0
21	32758351	.	C	T	13	9	22	0	0	22	0	0
21	32758584	.	G	A	24	17	41	0	1	42	0	0
21	32759421	.	C	T	18	12	30	0	0	30	0	0
21	32766389	.	G	A	18	7	25	0	1	26	0	0
21	32772450	.	G	A	12	7	19	0	0	19	0	0
21	33058940	.	G	C	4	4	8	0	0	8	0	0
21	33066214	.	T	G	14	11	25	1	0	26	0	0
21	33069896	.	A	G	8	5	13	0	0	13	0	0
21	33211506	.	T	A	11	13	24	0	0	24	0	0
21	33211568	.	C	T	11	12	23	1	0	24	0	0
21	33211664	.	T	G	11	7	18	1	1	20	0	0
21	33211720	.	A	T	10	11	21	2	0	23	0	0
21	33211809	.	A	T	15	14	29	0	2	31	0	0
21	33213315	.	C	T	11	11	22	0	1	23	0	0
21	33218312	.	T	C	6	6	12	0	0	12	0	0
21	33218405	.	G	A	10	10	20	0	2	22	0	0
21	33249606	.	T	A	5	2	7	0	0	7	0	0
21	33249638	.	A	C	3	3	6	0	0	6	0	0
21	33447251	.	A	G	8	7	15	0	0	15	0	0
21	33463486	.	A	G	6	5	11	0	0	11	0	0
21	33995223	.	G	A	1	2	3	0	0	3	0	0
21	34001982	.	C	T	9	10	19	0	1	20	0	0
21	34002041	.	C	A	11	11	22	0	2	24	0	0
21	34002154	.	A	C	6	9	15	0	0	15	0	0
21	34002155	.	A	T	6	9	15	0	0	15	0	0
21	34002333	.	T	C	6	3	9	0	0	9	0	0
21	34002455	.	G	A	4	2	6	0	0	6	0	0
21	34002507	.	A	G	4	10	14	0	0	14	0	0
21	34026657	.	T	C	4	6	10	0	0	10	0	0
21	34031109	.	C	A	5	7	12	0	1	13	0	0
21	34031232	.	G	A	5	5	10	0	0	10	0	0
21	34057611	.	T	G	1	6	7	0	0	7	0	0
21	34059079	.	A	C	2	9	11	0	0	11	0	0
21	34074618	.	A	G	5	10	15	0	1	16	0	0
21	34074684	.	G	A	5	11	16	0	0	16	0	0
21	34074712	.	T	C	5	10	15	0	1	16	0	0
21	34075010	.	T	G	1	3	4	0	0	4	0	0
21	34103275	.	G	A	2	6	8	1	6	15	0	0
21	34114058	.	C	A	6	4	10	0	0	10	0	0
21	34114410	.	G	A	5	7	12	0	0	12	0	0
21	34128660	.	A	G	18	12	30	0	1	31	0	0
21	34129007	.	C	G	24	0	24	0	18	42	0	0
21	34129073	.	G	C	19	7	26	0	1	27	0	0
21	34129195	.	G	T	10	14	24	0	0	24	0	0
21	34129279	.	A	G	6	21	27	0	1	28	0	0
21	34176051	.	A	T	3	4	7	0	0	7	0	0
21	34195790	.	T	C	1	5	6	0	0	6	0	0
21	34199704	.	T	C	6	6	12	0	0	12	0	0
21	34210970	.	G	A	6	5	11	0	0	11	0	0
21	34211206	.	T	C	8	8	16	0	0	16	0	0
21	34211344	.	G	A	9	13	22	0	0	22	0	0
21	34211418	.	G	A	1	10	11	0	4	15	0	0
21	34211427	.	A	C	5	9	14	0	0	14	0	0
21	34364595	.	G	A	12	2	14	0	1	15	0	0
21	34364962	.	G	T	12	9	21	0	0	21	0	0
21	34391104	.	C	T	11	17	28	0	2	30	0	0
21	34391155	.	T	C	9	12	21	0	2	23	0	0
21	34392786	.	C	T	8	10	18	0	1	19	0	0
21	34392828	.	G	T	11	11	22	0	1	23	0	0
21	34424116	.	A	G	13	11	24	0	0	24	0	0
21	34430533	.	A	G	8	13	21	0	2	23	0	0
21	34430544	.	A	G	7	14	21	0	2	23	0	0
21	34714359	.	G	A	0	9	9	0	7	16	0	0
21	34714403	.	C	A	6	8	14	0	0	14	0	0
21	34724797	.	G	A	14	7	21	0	1	22	0	0
21	34724956	.	C	T	9	11	20	0	0	20	0	0
21	34741120	.	T	C	10	8	18	0	2	20	0	0
21	34770460	.	G	A	8	4	12	0	0	12	0	0
21	34770483	.	G	A	8	7	15	0	1	16	0	0
21	34770510	.	C	T	8	9	17	0	1	18	0	0
21	34792896	.	G	A	11	6	17	0	4	21	0	0
21	34793405	.	C	T	9	9	18	0	1	19	0	0
21	34793660	.	T	A	2	6	8	0	2	10	0	0
21	34793786	.	C	G	1	5	6	0	0	6	0	0
21	34825777	.	T	C	1	3	4	0	0	4	0	0
21	34826838	.	G	C	0	4	4	0	2	6	0	0
21	34834292	.	C	G	1	3	4	0	0	4	0	0
21	34834295	.	A	G	1	0	1	0	3	4	0	0
21	34834508	.	T	A	2	3	5	0	0	5	0	0
21	34834699	.	A	G	2	3	5	0	0	5	0	0
21	34834705	.	A	G	2	0	2	0	4	6	0	0
21	34849534	.	A	G	11	4	15	0	0	15	0	0
21	34851824	.	G	A	0	3	3	0	3	6	0	0
21	34851899	.	G	A	3	5	8	0	0	8	0	0
21	34878938	.	A	C	8	7	15	0	0	15	0	0
21	34897597	.	T	A	2	2	4	0	0	4	0	0
21	34897645	.	A	G	1	2	3	0	0	3	0	0
21	34981031	.	G	A	4	10	14	0	1	15	0	0
21	34987505	.	C	T	7	4	11	0	0	11	0	0
21	34987612	.	G	A	0	5	5	0	8	13	0	0
21	34987662	.	G	T	3	3	6	0	0	6	0	0
21	34993837	.	C	T	3	6	9	0	0	9	0	0
21	35009472	.	C	T	3	4	7	0	0	7	0	0
21	35009509	.	A	G	3	4	7	0	0	7	0	0
21	35009706	.	C	T	6	3	9	0	0	9	0	0
21	35010135	.	A	T	3	5	8	0	0	8	0	0
21	35013762	.	A	G	3	7	10	0	0	10	0	0
21	35025415	.	G	A	2	3	5	0	0	5	0	0
21	35025581	.	A	G	2	4	6	0	0	6	0	0
21	35025588	.	G	A	0	2	2	0	5	7	0	0
21	35033847	.	G	A	1	10	11	0	2	13	0	0
21	35033853	.	G	A	3	10	13	0	0	13	0	0
21	35035560	.	G	A	0	10	10	0	4	14	0	0
21	35040310	.	C	T	7	3	10	0	0	10	0	0
21	35042916	.	G	A	2	3	5	0	0	5	0	0
21	35045447	.	C	T	2	5	7	0	0	7	0	0
21	35048278	.	T	A	4	7	11	0	1	12	0	0
21	35048320	.	A	G	7	0	7	0	3	10	0	0
21	35051605	.	G	T	3	4	7	0	1	8	0	0
21	35054515	.	C	T	3	3	6	0	0	6	0	0
21	35054521	.	C	A	3	3	6	0	0	6	0	0
21	35078983	.	C	T	1	1	2	0	1	3	0	0
21	35081851	.	C	A	2	3	5	0	0	5	0	0
21	35082578	.	C	G	0	1	1	0	2	3	0	0
21	35279874	.	C	T	9	5	14	0	2	16	0	0
21	35280099	.	A	G	12	5	17	0	0	17	0	0
21	35280209	.	G	A	0	5	5	0	6	11	0	0
21	35280233	.	T	C	8	4	12	0	0	12	0	0
21	35280285	.	G	A	6	7	13	0	0	13	0	0
21	35280388	.	T	A	6	7	13	0	0	13	0	0
21	35280389	.	A	T	6	7	13	0	0	13	0	0
21	35280938	.	C	T	13	8	21	0	0	21	0	0
21	35281246	.	A	C	10	6	16	0	0	16	0	0
21	35302246	.	T	C	1	4	5	1	0	6	0	0
21	35306047	.	C	T	14	2	16	0	0	16	0	0
21	35306048	.	A	T	14	2	16	0	0	16	0	0
21	35319331	.	T	C	11	5	16	2	2	20	0	0
21	35325483	.	T	G	6	7	13	0	1	14	0	0
21	35327489	.	C	A	2	6	8	0	0	8	0	0
21	35328108	.	T	G	4	3	7	0	2	9	0	0
21	35359489	.	A	G	2	0	2	0	6	8	0	0
21	35652761	.	G	C	4	3	7	0	1	8	0	0
21	35653043	.	T	C	2	4	6	0	0	6	0	0
21	35653321	.	G	A	8	4	12	1	0	13	0	0
21	35677566	.	C	A	0	6	6	0	2	8	0	0
21	35831056	.	G	A	2	2	4	0	0	4	0	0
21	35831176	.	A	T	2	4	6	0	0	6	0	0
21	36386928	.	G	A	6	4	10	0	1	11	0	0
21	36387018	.	A	G	12	8	20	0	1	21	0	0
21	36387051	.	T	C	11	12	23	1	2	26	0	0
21	36392696	.	A	G	6	12	18	0	0	18	0	0
21	36392866	.	T	C	9	8	17	0	1	18	0	0
21	36399334	.	C	T	1	3	4	0	0	4	0	0
21	36407474	.	C	T	1	2	3	0	0	3	0	0
21	36413239	.	G	A	2	4	6	0	0	6	0	0
21	36413281	.	G	A	2	6	8	0	0	8	0	0
21	36417065	.	C	A	5	3	8	0	0	8	0	0
21	36417086	.	A	G	3	0	3	0	3	6	0	0
21	36419256	.	G	A	4	3	7	0	0	7	0	0
21	36419430	.	A	G	1	3	4	0	0	4	0	0
21	36435575	.	G	C	1	5	6	0	0	6	0	0
21	36439852	.	C	A	2	3	5	0	0	5	0	0
21	36439921	.	C	T	2	2	4	0	0	4	0	0
21	36442260	.	T	A	7	5	12	0	1	13	0	0
21	36442633	.	G	A	12	5	17	0	2	19	0	0
21	36446952	.	A	G	8	7	15	0	0	15	0	0
21	36449385	.	T	G	7	10	17	0	0	17	0	0
21	36449427	.	G	A	9	6	15	0	0	15	0	0
21	36449686	.	T	C	9	17	26	0	0	26	0	0
21	36449716	.	G	A	12	13	25	0	0	25	0	0
21	36465970	.	T	C	2	7	9	0	1	10	0	0
21	36468431	.	G	A	7	4	11	0	0	11	0	0
21	36473774	.	T	C	1	5	6	0	0	6	0	0
21	36489790	.	C	T	0	3	3	0	4	7	0	0
21	36492004	.	G	A	6	2	8	0	0	8	0	0
21	36496157	.	C	T	7	10	17	0	0	17	0	0
21	36496160	.	C	T	0	11	11	0	6	17	0	0
21	36501319	.	C	T	2	3	5	0	0	5	0	0
21	36504733	.	C	T	7	2	9	0	0	9	0	0
21	36546067	.	G	A	3	5	8	0	1	9	0	0
21	36570995	.	A	G	3	3	6	0	0	6	0	0
21	36571428	.	C	T	0	2	2	0	5	7	0	0
21	36571531	.	G	C	4	3	7	0	0	7	0	0
21	36571694	.	T	A	1	2	3	0	1	4	0	0
21	36592117	.	T	C	6	8	14	0	0	14	0	0
21	36592164	.	G	A	11	4	15	0	4	19	0	0
21	36592212	.	T	C	7	8	15	0	0	15	0	0
21	36598047	.	T	C	10	10	20	0	0	20	0	0
21	36598143	.	G	A	2	6	8	0	9	17	0	0
21	36598471	.	T	C	6	5	11	0	0	11	0	0
21	36598474	.	C	A	5	6	11	0	0	11	0	0
21	36598583	.	T	C	6	7	13	0	0	13	0	0
21	36598596	.	A	G	6	6	12	0	0	12	0	0
21	36598750	.	A	G	4	2	6	1	0	7	0	0
21	36598853	.	G	A	0	4	4	3	14	21	0	0
21	36598915	.	C	T	3	2	5	4	0	9	0	0
21	36598959	.	A	T	5	4	9	1	0	10	0	0
21	36599020	.	A	T	12	18	30	0	0	30	0	0
21	36599077	.	T	C	21	8	29	1	0	30	0	0
21	36599320	.	C	T	12	5	17	0	0	17	0	0
21	36599358	.	A	C	8	9	17	1	0	18	0	0
21	36599847	.	G	A	6	3	9	0	1	10	0	0
21	36599895	.	G	A	1	3	4	0	0	4	0	0
21	36599944	.	C	T	1	4	5	0	0	5	0	0
21	36600049	.	G	A	3	3	6	0	0	6	0	0
21	36612493	.	G	A	1	6	7	0	0	7	0	0
21	36612586	.	T	A	4	7	11	0	1	12	0	0
21	36612633	.	T	C	5	5	10	0	0	10	0	0
21	37107035	.	T	A	20	15	35	0	3	38	0	0
21	37107307	.	G	A	6	8	14	0	1	15	0	0
21	37107432	.	A	T	9	7	16	0	1	17	0	0
21	37107614	.	T	C	14	11	25	0	0	25	0	0
21	37107861	.	T	C	5	12	17	0	0	17	0	0
21	37108022	.	A	G	10	10	20	0	0	20	0	0
21	37108204	.	A	T	21	10	31	0	0	31	0	0
21	37397952	.	A	C	2	0	2	0	10	12	0	0
21	38013631	.	T	C	6	4	10	0	0	10	0	0
21	38587378	.	T	C	7	10	17	0	1	18	0	0
21	38783889	.	A	C	1	7	8	0	0	8	0	0
21	40119409	.	G	T	0	2	2	0	2	4	0	0
21	40354884	.	A	G	5	4	9	0	0	9	0	0
21	40354894	.	A	T	7	4	11	0	0	11	0	0
21	40355102	.	G	A	7	4	11	0	0	11	0	0
21	40355113	.	A	G	4	6	10	0	0	10	0	0
21	40355226	.	G	A	3	6	9	0	0	9	0	0
21	40355350	.	T	C	6	2	8	0	1	9	0	0
21	40355844	.	A	T	7	10	17	0	1	18	0	0
21	40355886	.	T	G	8	9	17	0	0	17	0	0
21	40355968	.	T	A	8	11	19	0	0	20	1	0
21	40356104	.	T	C	5	0	5	0	13	18	0	0
21	40364758	.	C	A	10	5	15	0	0	15	0	0
21	40365359	.	A	T	10	5	15	0	0	15	0	0
21	40365404	.	G	A	15	6	21	0	0	21	0	0
21	40369108	.	C	T	3	5	8	0	10	18	0	0
21	40373086	.	A	T	12	10	22	0	1	23	0	0
21	40373137	.	C	T	0	9	9	0	7	16	0	0
21	40373200	.	A	C	6	11	17	0	1	18	0	0
21	40373283	.	C	G	6	4	10	0	1	11	0	0
21	40376536	.	G	A	10	8	18	0	2	20	0	0
21	40377861	.	A	G	9	6	15	0	0	15	0	0
21	40377895	.	A	G	6	8	14	0	0	14	0	0
21	40377904	.	G	A	5	7	12	0	0	12	0	0
21	40381967	.	C	T	8	8	16	0	0	16	0	0
21	40382278	.	C	T	0	4	4	0	9	13	0	0
21	40384140	.	A	G	4	4	8	0	0	8	0	0
21	40384313	.	G	A	3	8	11	0	0	11	0	0
21	40386112	.	G	A	5	4	9	0	0	9	0	0
21	40386127	.	G	A	5	4	9	0	0	9	0	0
21	40387881	.	A	C	6	4	10	0	1	11	0	0
21	40402621	.	G	A	1	3	4	0	0	4	0	0
21	40402644	.	G	A	2	4	6	0	0	6	0	0
21	40402659	.	A	G	1	4	5	0	1	6	0	0
21	40403423	.	A	G	8	13	21	0	2	23	0	0
21	40403581	.	G	C	14	7	21	0	0	21	0	0
21	40406485	.	A	T	7	4	11	1	0	12	0	0
21	40406796	.	C	A	3	5	8	0	0	8	0	0
21	40410983	.	T	A	9	12	21	0	0	21	0	0
21	40411034	.	G	A	7	5	12	0	2	14	0	0
21	40411061	.	C	T	7	3	10	0	2	12	0	0
21	40452357	.	T	C	6	6	12	0	2	14	0	0
21	40455087	.	G	T	7	2	9	0	0	9	0	0
21	40461930	.	T	C	3	2	5	0	1	6	0	0
21	40464991	.	T	C	4	8	12	0	0	12	0	0
21	40466539	.	A	G	11	1	12	0	11	23	0	0
21	40466711	.	G	A	0	7	7	0	6	13	0	0
21	40466893	.	C	T	6	5	11	0	0	11	0	0
21	40467039	.	C	T	6	9	15	0	0	15	0	0
21	40467126	.	G	A	0	10	10	0	9	19	0	0
21	40474875	.	G	A	7	6	13	0	1	14	0	0
21	40475370	.	A	G	11	0	11	0	6	17	0	0
21	40475579	.	G	T	10	5	15	0	1	16	0	0
21	40475643	.	T	C	2	5	7	0	2	9	0	0
21	40509954	.	G	C	0	4	4	0	1	5	0	0
21	40529616	.	T	C	5	6	11	0	0	11	0	0
21	40529628	.	T	C	2	4	6	0	1	7	0	0
21	40530901	.	A	G	13	15	28	0	1	29	0	0
21	40531122	.	T	A	10	3	13	0	0	13	0	0
21	40531217	.	A	T	10	12	22	0	0	22	0	0
21	40531240	.	C	T	0	8	8	0	10	18	0	0
21	40531316	.	C	T	14	13	27	0	0	27	0	0
21	40531615	.	G	A	13	17	30	0	1	31	0	0
21	40531971	.	A	T	10	5	15	0	0	15	0	0
21	40531993	.	G	A	7	7	14	0	1	15	0	0
21	40532139	.	A	T	10	12	22	0	0	22	0	0
21	40532147	.	A	G	10	12	22	0	0	22	0	0
21	40532204	.	A	G	6	9	15	0	1	16	0	0
21	40532206	.	T	C	5	9	14	0	1	15	0	0
21	40532665	.	T	C	9	3	12	0	2	14	0	0
21	40532848	.	G	A	7	11	18	0	0	18	0	0
21	40532886	.	T	C	7	11	18	0	1	19	0	0
21	40532989	.	A	G	10	7	17	0	0	17	0	0
21	40532990	.	T	A	9	7	16	0	1	17	0	0
21	40533076	.	C	T	1	5	6	0	7	13	0	0
21	40533165	.	A	G	16	9	25	0	0	25	0	0
21	40533313	.	C	T	8	8	16	0	1	17	0	0
21	40533456	.	A	G	9	12	21	0	1	22	0	0
21	40537188	.	A	G	12	19	31	0	0	31	0	0
21	40546922	.	T	C	11	14	25	0	1	26	0	0
21	40547729	.	G	A	11	16	27	0	0	27	0	0
21	40553288	.	A	G	11	17	28	2	0	30	0	0
21	40553497	.	G	A	9	13	22	0	1	23	0	0
21	40553547	.	C	T	0	8	8	0	10	18	0	0
21	40562600	.	G	A	9	12	21	0	1	22	0	0
21	40579746	.	C	A	6	7	13	0	0	13	0	0
21	40604225	.	T	C	3	3	6	0	0	6	0	0
21	40612924	.	C	T	1	2	3	0	0	3	0	0
21	40673148	.	A	T	1	2	3	0	2	5	0	0
21	40673203	.	G	A	2	4	6	0	0	6	0	0
21	40685948	.	A	G	4	0	4	0	19	23	0	0
21	40685964	.	A	C	4	19	23	0	0	23	0	0
21	40686010	.	G	C	3	16	19	0	0	19	0	0
21	40686109	.	G	A	6	11	17	0	3	20	0	0
21	40686158	.	T	A	7	6	13	0	0	13	0	0
21	40686170	.	T	A	9	7	16	0	2	18	0	0
21	40691452	.	G	A	7	16	23	0	1	24	0	0
21	40691464	.	G	A	9	11	20	0	4	24	0	0
21	40703190	.	C	T	11	15	26	0	0	26	0	0
21	40703402	.	A	C	11	11	22	0	3	25	0	0
21	40703445	.	G	A	1	13	14	0	13	27	0	0
21	40708974	.	T	A	11	16	27	0	1	28	0	0
21	40708978	.	C	A	13	17	30	0	1	31	0	0
21	40717637	.	G	C	8	6	14	0	0	14	0	0
21	40731131	.	A	C	8	7	15	0	0	15	0	0
21	40731530	.	G	A	2	8	10	0	0	10	0	0
21	40757528	.	G	A	3	10	13	0	0	13	0	0
21	40930179	.	G	A	9	3	12	0	1	13	0	0
21	40930430	.	C	G	3	5	8	0	0	8	0	0
21	40930469	.	T	C	3	8	11	0	1	12	0	0
21	40930528	.	C	A	12	7	19	0	0	19	0	0
21	40930650	.	T	A	7	9	16	0	1	17	0	0
21	40930651	.	G	A	7	9	16	0	1	17	0	0
21	40931215	.	A	G	9	16	25	0	0	25	0	0
21	40931236	.	T	C	14	0	14	0	16	30	0	0
21	40932888	.	T	A	13	8	21	0	0	21	0	0
21	40934586	.	G	A	10	10	20	0	2	22	0	0
21	40934703	.	T	C	9	0	9	0	17	26	0	0
21	40936544	.	G	A	16	9	25	0	1	26	0	0
21	40936548	.	A	G	10	13	23	0	1	24	0	0
21	40944757	.	G	A	0	2	2	0	2	4	0	0
21	40959282	.	A	G	2	0	2	0	4	6	0	0
21	41028902	.	A	G	7	4	11	0	0	11	0	0
21	41029033	.	A	C	4	2	6	0	0	6	0	0
21	41029328	.	C	G	2	2	4	0	0	4	0	0
21	41034863	.	A	G	4	2	6	0	0	6	0	0
21	41039914	.	T	G	3	4	7	0	0	7	0	0
21	41046647	.	T	A	4	7	11	0	2	13	0	0
21	41046745	.	T	A	5	7	12	0	0	12	0	0
21	41046746	.	G	C	5	7	12	0	0	12	0	0
21	41048725	.	G	A	3	3	6	0	0	6	0	0
21	41049005	.	G	A	5	3	8	0	0	8	0	0
21	41049488	.	A	G	2	2	4	0	0	4	0	0
21	41057687	.	A	T	3	5	8	0	0	8	0	0
21	41060822	.	C	A	0	3	3	0	2	5	0	0
21	41061257	.	A	T	4	3	7	0	0	7	0	0
21	41065323	.	G	T	3	4	7	0	0	7	0	0
21	41256821	.	C	T	2	4	6	0	8	14	0	0
21	41257136	.	A	G	25	27	52	2	2	56	0	0
21	41257157	.	C	G	25	19	44	0	4	48	0	0
21	41257228	.	T	G	29	25	54	0	2	56	0	0
21	41257256	.	T	C	24	28	52	0	3	55	0	0
21	41257357	.	G	A	27	32	59	0	3	62	0	0
21	41257374	.	C	T	27	38	65	0	0	65	0	0
21	41257599	.	T	A	28	30	58	0	1	59	0	0
21	41293435	.	G	A	27	34	61	0	5	66	0	0
21	41305128	.	G	T	35	25	60	0	3	63	0	0
21	41305269	.	C	T	27	22	49	0	4	53	0	0
21	41305271	.	C	T	26	24	50	0	3	53	0	0
21	41311605	.	A	G	24	11	35	0	0	35	0	0
21	41311922	.	G	A	14	11	25	0	1	26	0	0
21	41312058	.	A	T	12	11	23	0	0	24	1	0
21	41312822	.	C	G	21	21	42	0	4	46	0	0
21	41313042	.	A	G	25	18	43	0	0	43	0	0
21	41313124	.	G	A	20	23	43	0	2	45	0	0
21	41313216	.	G	A	26	21	47	0	1	48	0	0
21	41313257	.	T	C	28	18	46	1	3	50	0	0
21	41316974	.	C	T	23	14	37	0	1	38	0	0
21	41323551	.	C	T	2	19	21	0	20	41	0	0
21	41598942	.	G	C	16	7	23	0	0	23	0	0
21	41598961	.	T	C	17	0	17	0	9	26	0	0
21	41599060	.	T	C	24	19	43	1	0	44	0	0
21	41600293	.	T	C	8	2	10	0	1	11	0	0
21	41601180	.	T	C	2	3	5	0	0	5	0	0
21	42044215	.	C	T	2	3	5	0	0	5	0	0
21	42046969	.	G	A	19	10	29	53	1	83	0	0
21	42717531	.	T	A	1	2	3	0	0	3	0	0
21	42779043	.	A	C	1	0	1	0	4	5	0	0
21	42779044	.	A	C	1	1	2	0	3	5	0	0
21	42971463	.	T	C	28	13	41	0	8	49	0	0
21	43461082	.	T	C	10	6	16	0	0	16	0	0
21	43461447	.	T	C	2	2	4	0	0	4	0	0
21	43476276	.	T	C	21	8	29	0	0	29	0	0
21	43477894	.	T	C	21	11	32	0	1	33	0	0
21	43505943	.	T	C	1	5	6	0	0	6	0	0
21	44439578	.	C	T	5	3	8	0	0	8	0	0
21	44553806	.	A	G	11	7	18	0	0	18	0	0
21	44556241	.	C	G	2	4	6	0	0	6	0	0
21	44558693	.	C	T	5	6	11	0	0	11	0	0
21	44558697	.	T	C	5	6	11	0	0	11	0	0
21	44558898	.	T	C	19	1	20	0	14	34	0	0
21	44559095	.	C	T	24	11	35	0	1	36	0	0
21	44561900	.	A	G	30	22	52	0	2	54	0	0
21	44563129	.	T	A	28	25	53	0	2	55	0	0
21	44581845	.	A	T	8	4	12	0	1	13	0	0
21	44581947	.	C	T	3	2	5	0	1	6	0	0
21	44581948	.	C	A	5	2	7	0	0	7	0	0
21	44609016	.	T	A	3	3	6	0	0	6	0	0
21	44618620	.	G	A	0	3	3	0	5	8	0	0
21	44777084	.	G	A	1	8	9	0	5	14	0	0
21	44777617	.	G	T	1	11	12	0	5	17	0	0
21	44781745	.	A	G	16	9	25	0	4	29	0	0
21	44784156	.	A	G	7	0	7	0	10	17	0	0
21	44784223	.	A	G	16	0	16	0	12	28	0	0
21	44784493	.	G	T	13	9	22	0	1	23	0	0
21	44784589	.	T	C	4	5	9	0	0	9	0	0
21	45017433	.	T	C	5	5	10	0	0	10	0	0
21	45024622	.	C	T	4	2	6	0	0	6	0	0
21	45031046	.	T	G	4	5	9	0	1	10	0	0
21	45039897	.	G	A	4	6	10	0	0	10	0	0
21	45114642	.	T	A	2	4	6	0	0	6	0	0
21	45114742	.	G	A	0	3	3	0	3	6	0	0
21	45114778	.	C	T	5	4	9	0	0	9	0	0
21	45114925	.	G	A	0	3	3	0	4	7	0	0
21	45115168	.	C	T	3	3	6	0	0	6	0	0
21	45115265	.	C	A	2	3	5	0	0	5	0	0
21	45117465	.	T	C	2	4	6	0	0	6	0	0
21	45117469	.	T	G	2	3	5	0	0	5	0	0
21	45117537	.	C	T	5	3	8	0	0	8	0	0
21	45182345	.	A	G	3	3	6	0	0	6	0	0
21	45182488	.	G	A	6	9	15	0	2	17	0	0
21	45182566	.	C	T	10	7	17	0	0	17	0	0
21	45185829	.	A	G	15	17	32	0	0	32	0	0
21	45186175	.	G	A	18	23	41	0	2	43	0	0
21	45187072	.	T	G	13	17	30	0	1	31	0	0
21	45187248	.	A	G	8	12	20	0	0	20	0	0
21	45187258	.	G	A	10	12	22	0	0	22	0	0
21	45190709	.	T	A	22	24	46	0	2	48	0	0
21	45190754	.	C	T	3	25	28	0	22	50	0	0
21	45190884	.	G	A	17	31	48	0	2	50	0	0
21	45190926	.	C	T	21	27	48	0	1	49	0	0
21	45190975	.	C	T	28	22	50	0	2	52	0	0
21	45190984	.	T	C	28	26	54	0	1	55	0	0
21	45191163	.	A	T	30	42	72	0	2	74	0	0
21	45193365	.	G	A	32	29	61	0	2	63	0	0
21	45198712	.	C	T	4	27	31	0	27	58	0	0
21	45210088	.	G	C	1	2	3	0	0	3	0	0
21	45352415	.	C	T	2	21	23	0	22	45	0	0
21	45356811	.	T	G	24	24	48	0	0	48	0	0
21	45359397	.	G	A	21	23	44	0	0	44	0	0
21	45363684	.	C	T	32	16	48	0	0	48	0	0
21	45363728	.	C	T	22	19	41	0	2	43	0	0
21	45363778	.	T	G	19	27	46	0	2	48	0	0
21	45366262	.	T	A	7	4	11	0	2	13	0	0
21	45366268	.	C	T	8	7	15	0	2	17	0	0
21	45366301	.	A	C	15	14	29	0	0	29	0	0
21	45374413	.	C	A	13	12	25	0	2	27	0	0
21	45374439	.	C	T	13	13	26	0	0	26	0	0
21	45375109	.	G	T	4	7	11	0	0	11	0	0
21	45377351	.	G	T	5	6	11	0	1	12	0	0
21	45377604	.	T	G	11	11	22	0	2	24	0	0
21	45382032	.	G	A	25	19	44	0	0	44	0	0
21	45386175	.	C	T	4	2	6	0	1	7	0	0
21	45388336	.	T	C	4	7	11	0	2	13	0	0
21	45393627	.	C	T	2	8	10	0	0	10	0	0
21	45398178	.	T	C	3	8	11	0	1	12	0	0
21	45399775	.	A	T	5	6	11	1	0	12	0	0
21	45410019	.	G	A	1	15	16	0	8	24	0	0
21	45410118	.	T	C	9	9	18	0	1	19	0	0
21	45410479	.	A	C	6	4	10	0	0	10	0	0
21	45410601	.	G	A	2	6	8	0	0	8	0	0
21	45510503	.	G	C	0	1	1	0	2	3	0	0
21	45510529	.	G	A	2	2	4	0	0	4	0	0
21	45510599	.	G	C	1	6	7	0	1	8	0	0
21	45510699	.	A	G	6	0	6	0	8	14	0	0
21	45535881	.	A	G	6	6	12	0	1	13	0	0
21	45542246	.	A	G	10	0	10	0	6	16	0	0
21	45544374	.	C	T	8	14	22	0	0	22	0	0
21	45544384	.	A	G	12	0	12	0	13	25	0	0
21	45544709	.	A	G	9	11	20	0	2	22	0	0
22	6910	.	A	G	7	3	10	0	1	11	0	0
22	11433	.	T	C	20	21	41	0	2	43	0	0
22	13985	.	C	T	36	30	66	0	1	67	0	0
22	13988	.	C	T	37	29	66	0	2	68	0	0
22	14278	.	C	T	24	29	53	0	2	55	0	0
22	15785	.	T	C	33	31	64	0	4	68	0	0
22	15819	.	T	C	41	29	70	0	1	71	0	0
22	15855	.	A	G	38	1	39	0	31	70	0	0
22	15860	.	C	G	40	28	68	0	1	69	0	0
22	15950	.	A	G	16	0	16	2	18	36	0	0
22	16047	.	G	A	19	17	36	0	2	38	0	0
22	16297	.	C	G	6	10	16	0	0	16	0	0
22	16538	.	A	G	6	1	7	0	3	10	0	0
22	23325	.	C	T	4	3	7	0	0	7	0	0
22	23380	.	C	A	6	8	14	0	0	14	0	0
22	23417	.	C	T	5	7	12	0	1	13	0	0
22	23706	.	A	T	10	5	15	0	0	15	0	0
22	23916	.	A	T	5	10	15	0	1	16	0	0
22	24117	.	C	T	4	5	9	0	1	10	0	0
22	24143	.	A	G	4	4	8	0	0	8	0	0
22	44508	.	A	C	2	2	4	0	0	4	0	0
22	46012	.	T	A	3	5	8	0	0	8	0	0
22	46997	.	T	C	4	5	9	0	0	9	0	0
22	47177	.	G	A	9	5	14	0	0	14	0	0
22	89400	.	C	T	1	2	3	0	0	3	0	0
22	90083	.	A	C	6	6	12	0	1	13	0	0
22	90084	.	C	A	0	6	6	0	7	13	0	0
22	94323	.	C	A	4	10	14	0	0	14	0	0
22	94699	.	A	G	13	4	17	0	15	32	0	0
22	94817	.	A	C	10	8	18	0	0	18	0	0
22	96200	.	C	T	7	9	16	0	0	16	0	0
22	96481	.	G	A	6	2	8	0	2	10	0	0
22	96852	.	T	C	15	9	24	0	1	25	0	0
22	96959	.	T	C	11	14	25	0	2	27	0	0
22	97280	.	T	G	3	1	4	0	4	8	0	0
22	97438	.	C	A	6	9	15	0	1	16	0	0
22	97565	.	A	G	8	7	15	0	1	16	0	0
22	98523	.	A	G	6	10	16	0	2	18	0	0
22	101661	.	C	T	7	9	16	0	1	17	0	0
22	102261	.	C	A	18	17	35	0	2	37	0	0
22	105466	.	C	A	11	10	21	0	3	24	0	0
22	105548	.	T	G	6	0	6	0	8	14	0	0
22	105584	.	G	A	2	11	13	0	10	23	0	0
22	106007	.	T	C	10	10	20	0	0	20	0	0
22	107916	.	G	A	1	17	18	0	7	25	0	0
22	108003	.	G	A	6	14	20	0	0	20	0	0
22	108186	.	A	G	6	0	6	0	7	13	0	0
22	133647	.	T	C	9	1	10	0	15	25	0	0
22	134008	.	C	T	0	16	16	0	16	32	0	0
22	134272	.	T	C	27	12	39	0	0	39	0	0
22	134353	.	T	C	16	12	28	0	3	31	0	0
22	134563	.	T	C	11	1	12	0	20	32	0	0
22	134848	.	C	A	14	9	23	0	0	23	0	0
22	134950	.	G	A	16	11	27	0	0	27	0	0
22	135045	.	C	T	7	12	19	0	0	19	0	0
22	135214	.	C	A	0	18	18	0	18	36	0	0
22	135678	.	T	C	5	11	16	0	0	16	0	0
22	135684	.	A	G	6	13	19	0	0	19	0	0
22	136183	.	T	A	11	10	21	0	1	22	0	0
22	136552	.	C	A	0	3	3	0	9	12	0	0
22	136704	.	C	A	4	3	7	0	2	9	0	0
22	136858	.	C	A	1	8	9	0	5	14	0	0
22	137259	.	T	C	12	11	23	0	0	23	0	0
22	137434	.	T	C	6	0	6	0	8	14	0	0
22	137662	.	C	T	0	9	9	0	9	18	0	0
22	137786	.	G	A	8	7	15	0	1	16	0	0
22	138339	.	C	A	1	8	9	0	7	16	0	0
22	138457	.	C	T	5	3	8	0	0	8	0	0
22	138505	.	G	A	6	4	10	0	0	10	0	0
22	138517	.	G	A	6	4	10	0	0	10	0	0
22	138684	.	A	G	7	9	16	0	0	16	0	0
22	138791	.	C	T	3	3	6	0	0	6	0	0
22	139069	.	G	A	2	6	8	0	0	8	0	0
22	139088	.	G	C	2	6	8	0	0	8	0	0
22	139139	.	C	T	5	8	13	0	0	13	0	0
22	139264	.	G	A	6	4	10	0	0	10	0	0
22	139396	.	T	A	2	10	12	0	0	12	0	0
22	139474	.	G	A	9	12	21	0	1	22	0	0
22	139538	.	G	A	11	7	18	0	0	18	0	0
22	139562	.	G	A	10	6	16	0	0	16	0	0
22	139702	.	C	T	5	11	16	0	0	16	0	0
22	139900	.	A	G	7	10	17	0	1	18	0	0
22	140080	.	G	A	6	5	11	0	0	11	0	0
22	140161	.	T	G	6	3	9	0	3	12	0	0
22	140308	.	T	C	6	0	6	0	13	19	0	0
22	141177	.	G	A	10	5	15	0	1	16	0	0
22	144801	.	T	C	5	6	11	0	0	11	0	0
22	144855	.	G	T	4	2	6	0	2	9	1	0
22	144869	.	T	G	6	6	12	0	0	12	0	0
22	147499	.	A	C	6	4	10	1	0	11	0	0
22	147505	.	A	G	7	4	11	1	0	12	0	0
22	188043	.	C	T	1	2	3	0	0	3	0	0
22	192443	.	G	A	11	13	24	0	1	25	0	0
22	192713	.	C	T	0	4	4	0	15	21	2	0
22	192754	.	A	G	11	10	21	0	3	24	0	0
22	192953	.	A	G	15	14	29	0	0	29	0	0
22	336325	.	T	C	26	35	61	1	0	62	0	0
22	336378	.	A	G	16	24	40	0	3	43	0	0
22	337063	.	A	G	17	35	52	0	2	54	0	0
22	337457	.	T	C	24	18	42	0	6	48	0	0
22	337606	.	G	T	16	14	30	0	1	31	0	0
22	337607	.	T	G	17	14	31	0	1	32	0	0
22	337705	.	C	T	16	23	39	0	1	40	0	0
22	337918	.	G	T	15	11	26	0	1	27	0	0
22	338187	.	G	A	30	16	46	0	2	48	0	0
22	338199	.	G	T	4	17	21	1	25	47	0	0
22	338226	.	C	T	29	17	46	5	0	51	0	0
22	338431	.	C	T	11	12	23	0	2	25	0	0
22	342167	.	A	G	4	2	6	0	0	6	0	0
22	342464	.	A	G	6	4	10	0	0	10	0	0
22	344977	.	T	G	11	14	25	0	1	26	0	0
22	345794	.	C	G	12	11	23	0	1	24	0	0
22	349378	.	G	A	17	26	43	0	3	46	0	0
22	354076	.	G	C	11	12	23	0	2	25	0	0
22	354272	.	C	T	12	20	32	1	5	38	0	0
22	354466	.	C	T	24	11	35	0	7	42	0	0
22	354509	.	T	G	21	17	38	0	0	38	0	0
22	360302	.	A	G	25	18	43	0	1	44	0	0
22	367517	.	A	G	18	15	33	0	0	33	0	0
22	371121	.	T	G	10	10	20	0	1	21	0	0
22	371141	.	G	C	11	10	21	0	1	22	0	0
22	371689	.	C	T	15	16	31	0	4	35	0	0
22	371926	.	C	T	1	7	8	0	16	24	0	0
22	371933	.	T	C	16	0	16	0	8	24	0	0
22	404666	.	T	C	22	13	35	0	1	36	0	0
22	405177	.	T	C	22	17	39	0	3	42	0	0
22	405986	.	C	T	20	28	48	0	3	51	0	0
22	414346	.	T	C	3	7	10	0	0	10	0	0
22	414736	.	G	A	0	2	2	0	2	4	0	0
22	414760	.	C	T	1	2	3	0	0	3	0	0
22	415091	.	T	C	2	2	4	0	0	4	0	0
22	415660	.	C	T	1	2	3	0	0	3	0	0
22	415789	.	A	T	1	2	3	0	1	4	0	0
22	415828	.	T	C	5	2	7	0	0	7	0	0
22	415832	.	T	G	5	0	5	0	2	7	0	0
22	416072	.	C	A	1	3	4	0	0	4	0	0
22	416086	.	C	T	1	2	3	0	1	4	0	0
22	416332	.	C	A	1	3	4	0	0	4	0	0
22	416518	.	A	G	5	1	6	0	3	9	0	0
22	426122	.	A	G	2	6	8	0	1	9	0	0
22	426243	.	C	T	5	11	16	0	0	16	0	0
22	426258	.	G	A	5	7	12	0	2	14	0	0
22	431242	.	C	T	1	5	6	0	0	6	0	0
22	431314	.	T	C	4	4	8	0	0	8	0	0
22	441271	.	G	A	3	4	7	0	1	8	0	0
22	443557	.	A	G	2	0	2	0	4	6	0	0
22	443622	.	T	C	8	7	15	0	0	15	0	0
22	445860	.	A	G	7	5	12	0	1	13	0	0
22	446257	.	A	G	6	0	6	1	3	10	0	0
22	446686	.	G	C	0	4	4	0	3	7	0	0
22	446716	.	G	T	1	7	8	0	3	11	0	0
22	446809	.	T	C	2	2	4	0	0	4	0	0
22	447384	.	T	C	2	3	5	0	0	5	0	0
22	448344	.	C	T	6	5	11	0	0	11	0	0
22	448509	.	C	T	4	6	10	0	0	10	0	0
22	448604	.	C	T	4	7	11	0	0	11	0	0
22	451371	.	T	C	6	7	13	0	0	13	0	0
22	451533	.	G	A	0	11	11	0	6	17	0	0
22	452694	.	T	G	6	7	13	0	0	13	0	0
22	452748	.	A	G	9	0	9	0	4	13	0	0
22	452776	.	A	G	8	0	8	0	6	14	0	0
22	452784	.	A	G	7	5	12	0	0	12	0	0
22	453170	.	C	A	2	5	7	0	0	7	0	0
22	461258	.	T	C	8	11	19	0	0	19	0	0
22	461502	.	G	A	0	13	13	0	2	15	0	0
22	464971	.	T	A	5	10	15	0	0	16	1	0
22	465120	.	A	T	14	14	28	0	0	28	0	0
22	465609	.	A	G	5	0	5	0	6	11	0	0
22	468088	.	T	C	5	6	11	3	4	18	0	0
22	473607	.	A	G	24	26	50	0	1	51	0	0
22	474787	.	C	A	1	17	18	0	18	36	0	0
22	479703	.	C	T	1	16	17	0	11	28	0	0
22	479754	.	C	T	15	15	30	0	1	31	0	0
22	481670	.	A	G	24	10	34	0	1	35	0	0
22	483593	.	G	T	23	12	35	0	1	36	0	0
22	483841	.	C	T	22	14	36	0	2	38	0	0
22	485328	.	A	C	17	1	18	1	12	31	0	0
22	485352	.	G	A	13	13	26	1	0	27	0	0
22	486713	.	C	T	14	16	30	0	0	30	0	0
22	489566	.	T	C	15	17	32	0	1	33	0	0
22	489694	.	G	T	12	13	25	0	0	25	0	0
22	534484	.	A	G	4	3	7	0	0	7	0	0
22	534492	.	C	T	3	3	6	0	0	6	0	0
22	535020	.	T	A	5	3	8	0	0	8	0	0
22	551166	.	C	T	0	7	7	0	21	28	0	0
22	551262	.	A	G	11	8	19	0	0	19	0	0
22	552169	.	T	C	11	1	12	0	10	22	0	0
22	554411	.	T	C	19	0	19	0	9	28	0	0
22	555234	.	C	T	14	14	28	0	1	29	0	0
22	557733	.	G	A	25	12	37	0	1	38	0	0
22	557770	.	C	T	3	13	16	0	25	41	0	0
22	557886	.	G	A	17	13	30	0	0	30	0	0
22	563826	.	G	A	0	7	7	0	7	14	0	0
22	569747	.	T	G	2	0	2	0	3	5	0	0
22	569783	.	T	C	1	2	3	0	0	3	0	0
22	569840	.	C	G	2	6	8	0	0	8	0	0
22	570098	.	C	A	1	1	2	0	0	2	0	0
22	570110	.	G	C	1	3	4	0	0	4	0	0
22	581442	.	C	T	2	4	6	0	0	6	0	0
22	581732	.	A	G	4	5	9	0	0	9	0	0
22	581775	.	T	C	3	2	5	0	0	5	0	0
22	582412	.	C	T	5	2	7	0	0	7	0	0
22	582438	.	C	A	5	4	9	0	0	9	0	0
22	582525	.	A	C	10	4	14	0	0	14	0	0
22	583118	.	A	G	4	3	7	0	0	7	0	0
22	583128	.	A	G	4	3	7	0	0	7	0	0
22	583290	.	G	A	3	4	7	0	1	8	0	0
22	583295	.	T	C	4	3	7	0	1	8	0	0
22	583343	.	A	G	4	6	10	0	0	10	0	0
22	583376	.	T	G	3	4	7	0	0	7	0	0
22	583390	.	T	C	4	3	7	0	0	7	0	0
22	583421	.	C	T	5	1	6	0	1	7	0	0
22	583538	.	A	C	4	5	9	0	1	10	0	0
22	591851	.	A	T	12	16	28	0	0	28	0	0
22	591937	.	A	G	21	17	38	0	1	39	0	0
22	591942	.	G	T	16	18	34	0	2	37	1	0
22	592029	.	A	G	19	18	37	0	1	38	0	0
22	592069	.	G	A	20	19	39	1	2	42	0	0
22	592107	.	T	A	17	18	35	0	3	38	0	0
22	593071	.	A	G	18	26	44	0	1	45	0	0
22	593819	.	C	A	22	11	33	0	0	33	0	0
22	593828	.	G	A	17	12	29	0	2	31	0	0
22	593903	.	T	C	17	1	18	0	15	33	0	0
22	599951	.	A	T	20	17	37	1	2	40	0	0
22	607731	.	A	T	1	2	3	0	0	3	0	0
22	613352	.	G	A	11	20	31	0	1	32	0	0
22	613355	.	C	G	11	19	30	0	2	32	0	0
22	613433	.	C	T	2	24	26	0	23	49	0	0
22	613572	.	T	A	39	8	47	0	3	50	0	0
22	613591	.	C	A	2	12	14	0	25	39	0	0
22	616076	.	T	G	29	22	51	0	3	54	0	0
22	617692	.	G	A	6	3	9	0	0	9	0	0
22	618149	.	G	A	24	31	55	0	5	60	0	0
22	635832	.	C	G	7	3	10	0	0	10	0	0
22	637508	.	C	A	5	4	9	0	0	9	0	0
22	637517	.	G	C	3	3	6	0	0	6	0	0
22	641389	.	A	C	1	2	3	0	0	3	0	0
22	696979	.	C	T	1	2	3	0	0	3	0	0
22	700428	.	G	T	0	4	4	0	1	5	0	0
22	700739	.	C	T	1	2	3	0	0	3	0	0
22	700763	.	T	G	1	2	3	0	0	3	0	0
22	700994	.	C	T	2	3	5	0	0	5	0	0
22	710974	.	A	G	29	18	47	0	8	55	0	0
22	711158	.	T	G	22	22	44	0	1	45	0	0
22	711285	.	G	T	11	13	24	0	4	28	0	0
22	711337	.	T	A	13	7	20	0	0	20	0	0
22	711370	.	A	C	7	9	16	0	1	17	0	0
22	711437	.	C	T	12	3	15	0	0	15	0	0
22	711475	.	T	C	12	4	16	0	0	16	0	0
22	711725	.	A	T	20	24	44	0	1	45	0	0
22	712146	.	T	A	8	17	25	0	1	26	0	0
22	712160	.	A	G	11	20	31	0	0	31	0	0
22	712187	.	G	T	12	19	31	0	1	32	0	0
22	712222	.	G	A	15	20	35	0	5	40	0	0
22	712484	.	G	A	18	24	42	0	2	44	0	0
22	712578	.	A	G	17	21	38	0	1	39	0	0
22	725010	.	C	T	11	5	16	0	0	16	0	0
22	725013	.	C	T	12	5	17	0	0	17	0	0
22	728144	.	T	A	13	3	16	0	3	19	0	0
22	728176	.	C	T	8	7	15	0	1	16	0	0
22	728244	.	T	C	7	6	13	0	0	13	0	0
22	729619	.	C	A	10	8	18	0	0	18	0	0
22	732794	.	T	A	5	5	10	0	0	10	0	0
22	741559	.	T	C	4	4	8	0	1	9	0	0
22	748837	.	C	T	6	9	15	0	0	15	0	0
22	748951	.	T	C	6	5	11	0	0	11	0	0
22	750695	.	T	C	4	9	13	0	0	13	0	0
22	750699	.	G	A	1	9	10	0	3	13	0	0
22	750759	.	C	A	2	4	6	0	1	7	0	0
22	750770	.	C	G	4	5	9	0	1	10	0	0
22	750863	.	T	C	5	6	11	0	1	12	0	0
22	751075	.	A	G	8	11	19	0	0	19	0	0
22	753267	.	A	G	1	0	1	0	2	3	0	0
22	770233	.	T	A	6	7	13	0	2	15	0	0
22	774989	.	T	C	6	0	6	0	25	31	0	0
22	779246	.	C	T	0	10	10	0	13	23	0	0
22	779255	.	G	A	14	6	20	0	1	21	0	0
22	779330	.	T	A	12	14	26	0	2	28	0	0
22	784089	.	C	T	3	2	5	0	1	6	0	0
22	786611	.	T	C	12	12	24	0	0	24	0	0
22	796937	.	C	T	11	12	23	0	1	24	0	0
22	796994	.	G	T	1	15	16	0	13	29	0	0
22	797000	.	G	A	0	13	13	0	15	28	0	0
22	797117	.	G	A	9	16	25	0	2	27	0	0
22	799595	.	A	G	16	2	18	0	19	37	0	0
22	799712	.	C	T	19	18	37	0	1	38	0	0
22	803871	.	G	A	4	2	6	0	0	6	0	0
22	804324	.	G	C	10	9	19	0	0	19	0	0
22	804409	.	C	T	23	20	43	0	1	44	0	0
22	808069	.	T	A	7	9	16	0	0	16	0	0
22	808134	.	G	A	4	6	10	0	1	11	0	0
22	808175	.	T	C	1	6	7	0	0	7	0	0
22	808655	.	G	C	10	11	21	0	1	22	0	0
22	813432	.	G	A	1	4	5	0	0	5	0	0
22	814622	.	T	G	4	3	7	0	0	7	0	0
22	820087	.	G	T	9	15	24	0	0	24	0	0
22	820660	.	A	G	13	14	27	0	0	27	0	0
22	822601	.	A	C	17	0	17	0	16	33	0	0
22	822940	.	G	A	14	13	27	0	0	27	0	0
22	825091	.	T	A	11	16	27	0	0	27	0	0
22	827256	.	A	T	10	8	18	0	1	19	0	0
22	828517	.	C	T	3	9	12	0	6	18	0	0
22	831180	.	C	T	0	5	5	0	10	15	0	0
22	831345	.	A	G	8	13	21	0	2	23	0	0
22	831354	.	C	T	2	14	16	0	7	23	0	0
22	831591	.	T	C	8	0	8	0	7	15	0	0
22	833928	.	G	A	6	7	13	0	0	13	0	0
22	833990	.	T	C	9	14	23	0	0	23	0	0
22	834052	.	A	T	6	3	9	0	0	9	0	0
22	856967	.	C	G	1	2	3	0	0	3	0	0
22	857572	.	A	T	6	8	14	0	1	15	0	0
22	857630	.	A	G	5	2	7	0	0	7	0	0
22	857720	.	A	G	10	15	25	0	0	25	0	0
22	857733	.	T	G	9	12	21	0	0	21	0	0
22	859511	.	T	C	7	0	7	0	16	23	0	0
22	868098	.	A	G	2	7	9	0	0	9	0	0
22	868114	.	T	C	5	7	12	0	0	12	0	0
22	868175	.	A	G	7	8	15	0	1	16	0	0
22	868312	.	A	G	5	8	13	0	1	14	0	0
22	868321	.	T	C	6	8	14	0	0	14	0	0
22	868353	.	T	A	4	11	15	0	1	16	0	0
22	868648	.	G	C	3	8	11	0	0	11	0	0
22	869462	.	A	C	1	5	6	0	1	7	0	0
22	869514	.	C	T	6	5	11	0	0	11	0	0
22	869989	.	A	G	12	11	23	0	2	25	0	0
22	872055	.	C	T	1	2	3	0	7	10	0	0
22	872067	.	C	G	9	3	12	0	0	12	0	0
22	877097	.	C	T	1	7	8	0	3	11	0	0
22	877805	.	A	G	4	7	11	0	1	12	0	0
22	877922	.	C	T	5	7	12	0	1	13	0	0
22	995476	.	T	A	2	4	6	0	0	6	0	0
22	995499	.	A	G	3	3	6	0	0	6	0	0
22	996285	.	G	C	1	2	3	0	0	3	0	0
22	1066714	.	A	C	0	0	0	0	4	4	0	0
22	1066719	.	G	C	0	0	0	0	4	4	0	0
22	1203320	.	A	T	7	7	14	0	0	14	0	0
22	1203373	.	A	T	6	6	12	0	1	13	0	0
22	1209816	.	T	C	9	8	17	0	1	18	0	0
22	1212997	.	A	G	9	11	20	0	0	20	0	0
22	1212998	.	A	G	9	11	20	0	0	20	0	0
22	1214289	.	T	C	4	6	10	0	0	10	0	0
22	1214535	.	T	G	6	7	13	0	0	13	0	0
22	1216047	.	C	T	4	4	8	0	2	10	0	0
22	1223100	.	C	T	2	4	6	0	9	15	0	0
22	1226910	.	T	A	10	4	14	0	0	14	0	0
22	1228158	.	T	C	5	6	11	0	0	11	0	0
22	1234232	.	A	T	6	5	11	0	0	11	0	0
22	1373625	.	T	C	6	2	8	1	0	9	0	0
22	1557752	.	G	C	3	2	5	2	0	7	0	0
22	1557762	.	A	C	2	2	4	2	1	7	0	0
22	1727204	.	C	A	1	3	4	1	0	5	0	0
22	1727238	.	A	G	1	3	4	1	0	5	0	0
22	1737811	.	T	C	3	4	7	0	1	8	0	0
22	1737817	.	T	C	3	4	7	0	0	7	0	0
22	1757201	.	A	T	2	4	6	0	0	6	0	0
22	1773244	.	T	C	4	2	6	0	1	7	0	0
22	1773249	.	G	A	4	2	6	0	0	6	0	0
22	1773592	.	C	T	2	3	5	0	0	5	0	0
22	1773601	.	T	A	2	3	5	0	0	5	0	0
22	1793416	.	T	C	3	3	6	0	0	6	0	0
22	1793551	.	A	T	2	3	5	0	1	6	0	0
22	1793817	.	C	T	4	2	6	0	0	6	0	0
22	1793842	.	A	G	2	2	4	0	0	4	0	0
22	1794099	.	A	G	4	2	6	0	0	6	0	0
22	1794382	.	G	A	1	2	3	0	0	3	0	0
22	1809319	.	C	G	3	3	6	0	0	6	0	0
22	1817629	.	C	A	1	3	4	0	0	4	0	0
22	1818429	.	C	G	1	0	1	0	2	3	0	0
22	1825259	.	T	C	1	2	3	0	0	3	0	0
22	1825311	.	T	A	2	2	4	0	0	4	0	0
22	1825427	.	A	T	1	2	3	0	0	3	0	0
22	1825457	.	A	G	1	2	3	0	0	3	0	0
22	1825467	.	A	G	2	2	4	0	0	4	0	0
22	1837500	.	A	T	3	3	6	6	0	12	0	0
22	1849115	.	G	C	2	4	6	0	0	6	0	0
22	1860845	.	A	G	1	2	3	4	0	7	0	0
22	1860867	.	G	A	1	2	3	3	1	7	0	0
22	1860922	.	G	A	4	5	9	0	0	9	0	0
22	1861431	.	T	C	1	3	4	0	0	4	0	0
22	1861449	.	A	C	1	3	4	0	0	4	0	0
22	1891862	.	T	C	1	2	3	0	0	3	0	0
22	1900416	.	A	G	1	3	4	1	0	5	0	0
22	1901238	.	T	A	2	1	3	0	1	4	0	0
22	1901245	.	T	C	3	2	5	0	1	6	0	0
22	1901428	.	C	A	5	4	9	0	0	9	0	0
22	1901456	.	C	G	4	5	9	0	0	9	0	0
22	1901576	.	G	A	6	2	8	0	1	9	0	0
22	1924442	.	C	A	2	3	5	0	0	5	0	0
22	1924603	.	G	C	7	3	10	0	0	10	0	0
22	1925055	.	G	C	6	3	9	0	0	9	0	0
22	1925182	.	A	G	6	4	10	0	0	10	0	0
22	1925228	.	G	A	0	6	6	0	3	9	0	0
22	1934909	.	C	T	1	4	5	0	0	5	0	0
22	1935800	.	A	G	1	2	3	0	0	3	0	0
22	1944952	.	T	C	1	4	5	1	0	6	0	0
22	1948689	.	A	G	2	2	4	0	1	5	0	0
22	1948847	.	A	C	2	3	5	0	0	5	0	0
22	1948915	.	G	A	1	2	3	0	1	4	0	0
22	1954023	.	C	T	1	2	3	0	0	3	0	0
22	1954032	.	T	A	1	1	2	0	0	2	0	0
22	1960440	.	T	C	3	3	6	0	0	6	0	0
22	2033389	.	C	A	5	1	6	0	2	8	0	0
22	2033430	.	A	G	5	0	5	0	5	10	0	0
22	2033740	.	C	T	6	2	8	0	1	9	0	0
22	2034016	.	A	G	2	0	2	0	4	6	0	0
22	2034118	.	A	G	1	3	4	0	0	4	0	0
22	2106400	.	T	G	3	5	8	0	0	8	0	0
22	2106420	.	T	C	2	6	8	0	0	8	0	0
22	2106630	.	C	T	1	4	5	0	0	6	1	0
22	2106657	.	G	C	1	7	8	0	0	8	0	0
22	2106806	.	A	C	3	5	8	0	0	8	0	0
22	2106814	.	G	A	0	6	6	0	2	8	0	0
22	2107142	.	A	G	1	2	3	0	0	3	0	0
22	2107146	.	G	T	0	2	2	0	1	3	0	0
22	2124946	.	G	C	3	2	5	0	1	6	0	0
22	2125576	.	A	G	5	2	7	0	0	7	0	0
22	2125600	.	T	G	2	4	6	0	0	6	0	0
22	2125636	.	A	C	2	1	3	0	1	4	0	0
22	2125639	.	T	C	2	2	4	0	0	4	0	0
22	2147408	.	A	T	1	2	3	0	0	3	0	0
22	2147723	.	G	A	1	2	3	0	0	3	0	0
22	2147774	.	A	T	1	2	3	0	0	3	0	0
22	2163318	.	C	T	3	3	6	0	0	6	0	0
22	2172051	.	G	C	2	2	4	1	0	5	0	0
22	2172090	.	C	T	3	3	6	0	0	6	0	0
22	2172283	.	G	T	1	3	4	0	0	4	0	0
22	2172294	.	A	G	2	3	5	0	0	5	0	0
22	2178253	.	G	C	4	3	7	0	0	7	0	0
22	2178263	.	C	T	3	3	6	0	0	6	0	0
22	2178333	.	A	C	6	2	8	1	0	9	0	0
22	2178386	.	C	T	1	2	3	0	0	3	0	0
22	2223430	.	A	G	2	2	4	0	0	4	0	0
22	2230064	.	T	A	3	2	5	1	1	7	0	0
22	2233980	.	C	T	2	2	4	0	0	4	0	0
22	2233985	.	T	C	2	3	5	0	0	5	0	0
22	2234325	.	T	A	4	4	8	0	0	8	0	0
22	2234637	.	A	G	1	3	4	0	1	5	0	0
22	2234642	.	T	C	2	1	3	0	0	3	0	0
22	2235082	.	G	T	1	2	3	0	0	3	0	0
22	2235105	.	A	G	3	2	5	0	0	5	0	0
22	2242507	.	G	A	3	2	5	0	0	5	0	0
22	2242763	.	C	T	2	3	5	0	1	6	0	0
22	2251159	.	G	C	0	2	2	1	2	5	0	0
22	2347850	.	C	T	1	2	3	0	0	3	0	0
22	2347889	.	A	G	2	3	5	0	1	6	0	0
22	2347923	.	A	C	4	4	8	0	0	8	0	0
22	2347958	.	T	C	5	4	9	0	0	9	0	0
22	2348129	.	A	G	1	5	6	0	0	6	0	0
22	2348132	.	G	A	1	4	5	0	2	7	0	0
22	2352130	.	G	A	0	3	3	0	2	5	0	0
22	2364988	.	G	A	2	2	4	0	0	4	0	0
22	2368161	.	C	G	4	2	6	0	0	6	0	0
22	2373908	.	C	T	5	2	7	0	0	7	0	0
22	2373909	.	A	G	5	2	7	0	0	7	0	0
22	2385666	.	G	T	5	4	9	0	0	9	0	0
22	2389009	.	A	T	7	2	9	0	0	9	0	0
22	2389041	.	T	C	8	3	11	0	1	12	0	0
22	2389225	.	G	T	3	4	7	0	0	7	0	0
22	2391135	.	A	T	2	3	5	0	0	5	0	0
22	2393992	.	C	T	6	2	8	0	0	8	0	0
22	2394075	.	T	C	5	3	8	0	0	8	0	0
22	2394081	.	A	C	5	3	8	0	0	8	0	0
22	2403919	.	T	A	1	2	3	0	0	3	0	0
22	2417311	.	G	T	0	6	6	0	2	8	0	0
22	2417389	.	T	C	3	3	6	0	0	6	0	0
22	2420325	.	A	G	4	11	15	0	0	15	0	0
22	2420405	.	A	G	3	0	3	0	8	11	0	0
22	2420409	.	G	T	6	6	12	0	1	13	0	0
22	2420744	.	C	A	1	3	4	0	0	4	0	0
22	2420881	.	T	C	6	3	9	0	0	9	0	0
22	2421028	.	A	T	7	2	9	0	0	9	0	0
22	2443724	.	G	A	2	3	5	0	4	9	0	0
22	2443731	.	A	G	5	3	8	0	0	8	0	0
22	2443865	.	T	C	5	3	8	1	0	9	0	0
22	2444186	.	G	T	6	5	11	0	0	11	0	0
22	2444234	.	G	A	1	5	6	0	0	6	0	0
22	2444303	.	G	A	1	4	5	0	0	5	0	0
22	2460333	.	T	C	3	2	5	0	1	6	0	0
22	2460539	.	G	A	1	2	3	0	4	7	0	0
22	2497650	.	C	A	4	2	6	0	0	6	0	0
22	2497872	.	T	C	2	3	5	0	0	5	0	0
22	2498169	.	T	C	1	4	5	0	0	5	0	0
22	2498196	.	G	A	1	3	4	0	1	5	0	0
22	2498212	.	C	T	2	1	3	0	0	3	0	0
22	2498279	.	G	A	0	2	2	0	3	5	0	0
22	2505120	.	A	G	4	5	9	0	0	9	0	0
22	2529008	.	A	G	3	3	6	0	0	6	0	0
22	2529275	.	G	A	2	2	4	0	0	4	0	0
22	2529408	.	G	A	3	4	7	0	0	7	0	0
22	2529914	.	A	C	2	2	4	0	0	4	0	0
22	2529946	.	C	G	0	2	2	0	1	3	0	0
22	2538546	.	T	C	1	3	4	0	0	4	0	0
22	2552748	.	C	G	2	4	6	0	0	6	0	0
22	2552814	.	G	A	0	7	7	0	2	9	0	0
22	2554749	.	A	T	2	8	10	0	0	10	0	0
22	2554793	.	C	A	4	4	8	0	0	8	0	0
22	2554800	.	G	A	4	6	10	0	0	10	0	0
22	2557783	.	G	A	4	8	12	0	2	14	0	0
22	2557876	.	C	T	3	3	6	0	1	7	0	0
22	2557879	.	G	A	3	3	6	0	0	6	0	0
22	2558279	.	A	T	4	6	10	0	0	10	0	0
22	2558344	.	G	A	5	4	9	0	0	9	0	0
22	2558386	.	C	T	8	4	12	0	0	12	0	0
22	2558416	.	A	T	10	3	13	0	0	13	0	0
22	2576717	.	A	G	3	2	5	0	0	5	0	0
22	2577040	.	C	G	2	5	7	0	0	7	0	0
22	2623062	.	G	A	6	3	9	0	0	9	0	0
22	2623083	.	G	A	1	3	4	0	0	4	0	0
22	2626968	.	G	A	0	4	4	0	4	8	0	0
22	2627567	.	C	T	5	3	8	0	0	8	0	0
22	2627736	.	A	T	4	3	7	1	2	10	0	0
22	2627773	.	A	T	5	2	7	2	0	9	0	0
22	2627804	.	C	T	6	2	8	0	0	8	0	0
22	2638000	.	G	T	1	2	3	0	0	3	0	0
22	2645215	.	G	C	2	3	5	0	0	5	0	0
22	2645410	.	G	A	2	5	7	0	0	7	0	0
22	2645503	.	T	C	4	4	8	0	0	8	0	0
22	2645506	.	G	T	4	4	8	0	0	8	0	0
22	2645660	.	G	C	1	3	4	0	0	4	0	0
22	2645662	.	G	A	1	3	4	0	0	4	0	0
22	2645741	.	C	T	3	4	7	0	0	7	0	0
22	2645782	.	C	G	2	3	5	0	0	5	0	0
22	2645801	.	C	T	1	2	3	0	0	3	0	0
22	2647754	.	G	T	1	2	3	0	0	3	0	0
22	2650072	.	T	A	6	3	9	0	2	11	0	0
22	2653023	.	T	C	7	5	12	0	1	13	0	0
22	2659152	.	A	T	4	4	8	0	0	8	0	0
22	2659153	.	C	A	4	4	8	0	0	8	0	0
22	2659385	.	G	T	1	2	3	0	0	3	0	0
22	2659391	.	G	T	1	2	3	0	0	3	0	0
22	2664297	.	C	T	5	6	11	0	1	12	0	0
22	2664411	.	G	A	4	5	9	0	0	9	0	0
22	2668131	.	G	A	0	4	4	0	3	7	0	0
22	2668179	.	C	T	4	2	6	0	0	6	0	0
22	2668467	.	G	C	0	2	2	0	2	4	0	0
22	2668486	.	G	A	2	2	4	0	0	4	0	0
22	2676234	.	G	C	2	2	4	0	1	5	0	0
22	2676415	.	A	C	4	3	7	0	0	7	0	0
22	2690523	.	A	C	4	5	9	0	0	9	0	0
22	2690677	.	C	T	5	2	7	0	0	7	0	0
22	2690718	.	A	C	4	3	7	1	0	8	0	0
22	2897580	.	T	C	11	0	11	0	10	21	0	0
22	2897681	.	A	G	17	14	31	0	0	31	0	0
22	2897742	.	G	A	13	11	24	0	0	24	0	0
22	2897997	.	G	C	8	6	14	0	1	15	0	0
22	2898089	.	C	A	3	16	19	1	17	37	0	0
22	2900999	.	G	A	12	16	28	0	0	28	0	0
22	2908264	.	T	G	13	7	20	0	1	21	0	0
22	2912869	.	G	T	23	14	37	2	0	39	0	0
22	2919050	.	A	G	19	14	33	0	2	35	0	0
22	2919501	.	C	T	12	18	30	0	1	31	0	0
22	2931544	.	T	A	7	3	10	0	1	11	0	0
22	2933861	.	G	C	6	8	14	0	0	14	0	0
22	2937428	.	A	G	2	5	7	0	2	9	0	0
22	2941538	.	A	G	11	0	11	0	8	19	0	0
22	2941886	.	C	T	7	3	10	0	0	10	0	0
22	2941888	.	C	T	7	3	10	0	0	10	0	0
22	2949133	.	G	C	3	2	5	0	0	5	0	0
22	2951416	.	C	G	0	14	14	0	7	21	0	0
22	3077580	.	C	T	8	3	11	0	1	12	0	0
22	3077621	.	T	C	8	3	11	0	0	11	0	0
22	3077657	.	A	C	2	6	8	0	0	8	0	0
22	3077828	.	A	G	3	0	3	0	6	9	0	0
22	3077864	.	T	A	6	6	12	0	1	13	0	0
22	3078101	.	T	C	5	7	12	0	0	12	0	0
22	3121191	.	T	G	7	5	12	0	0	12	0	0
22	3121451	.	C	A	0	5	5	0	7	12	0	0
22	3121531	.	A	T	4	3	7	0	0	7	0	0
22	3121683	.	T	A	6	7	13	0	0	13	0	0
22	3121725	.	T	G	10	9	19	0	0	19	0	0
22	3121789	.	A	T	11	12	23	0	0	23	0	0
22	3122004	.	A	G	6	6	12	0	0	12	0	0
22	3123805	.	G	A	6	10	16	0	0	16	0	0
22	3124031	.	G	A	4	5	9	0	0	9	0	0
22	3124071	.	C	T	0	2	2	0	6	8	0	0
22	3127257	.	T	C	15	0	15	0	8	23	0	0
22	3128036	.	T	A	6	6	12	0	1	13	0	0
22	3143236	.	C	T	2	9	11	0	14	25	0	0
22	3161346	.	C	T	5	7	12	0	0	12	0	0
22	3162405	.	G	A	3	3	6	0	1	7	0	0
22	3169448	.	C	T	2	6	8	0	4	12	0	0
22	3169529	.	T	C	4	7	11	0	0	11	0	0
22	3169723	.	T	C	4	4	8	0	0	8	0	0
22	3172774	.	C	T	9	9	18	0	0	18	0	0
22	3177005	.	C	T	0	7	7	0	5	12	0	0
22	3177026	.	G	C	4	0	4	0	8	12	0	0
22	3177063	.	G	A	4	3	7	0	0	7	0	0
22	3177196	.	T	G	4	14	18	0	0	18	0	0
22	3177227	.	A	G	6	8	14	0	1	15	0	0
22	3181612	.	C	A	1	6	7	0	8	15	0	0
22	3182452	.	G	C	3	3	6	0	8	14	0	0
22	3182457	.	T	C	5	8	13	0	2	15	0	0
22	3182566	.	A	G	5	2	7	0	1	8	0	0
22	3182584	.	C	A	7	3	10	0	0	10	0	0
22	3182698	.	G	C	9	11	20	0	2	23	1	0
22	3182728	.	T	C	8	8	16	0	0	16	0	0
22	3192000	.	C	T	2	2	4	0	0	4	0	0
22	3198047	.	C	T	4	3	7	0	0	7	0	0
22	3198158	.	C	T	2	4	6	0	0	6	0	0
22	3198186	.	T	G	4	3	7	0	0	8	1	0
22	3198233	.	A	G	5	4	9	0	0	9	0	0
22	3204054	.	G	A	2	5	7	0	1	8	0	0
22	3208098	.	A	G	1	5	6	0	0	6	0	0
22	3208281	.	A	G	15	6	21	0	0	21	0	0
22	3214180	.	C	A	2	2	4	0	0	4	0	0
22	3214309	.	G	A	4	2	6	0	0	6	0	0
22	3231635	.	A	G	3	0	3	0	8	11	0	0
22	3231677	.	T	G	4	5	9	0	2	11	0	0
22	3232370	.	T	A	5	4	9	0	0	9	0	0
22	3233100	.	G	A	0	9	9	0	3	12	0	0
22	3233277	.	T	C	6	9	15	0	2	17	0	0
22	3233278	.	C	A	7	9	16	0	1	17	0	0
22	3233409	.	A	G	7	0	7	0	1	8	0	0
22	3233413	.	G	A	1	4	5	0	2	7	0	0
22	3233974	.	G	C	3	4	7	0	0	7	0	0
22	3234267	.	C	T	4	2	6	0	0	6	0	0
22	3261326	.	A	G	1	2	3	0	0	3	0	0
22	3262925	.	C	T	1	4	5	0	7	12	0	0
22	3263129	.	T	C	8	12	20	0	0	20	0	0
22	3263318	.	A	G	9	5	14	0	0	14	0	0
22	3263672	.	G	T	9	6	15	0	0	15	0	0
22	3263917	.	C	T	7	11	18	0	0	18	0	0
22	3265889	.	C	A	5	13	18	0	0	18	0	0
22	3267636	.	C	T	9	4	13	0	1	14	0	0
22	3270790	.	G	A	4	3	7	0	1	8	0	0
22	3271943	.	G	A	2	6	8	0	0	8	0	0
22	3273527	.	C	A	7	6	13	0	1	14	0	0
22	3384831	.	G	A	21	16	37	0	4	41	0	0
22	3384844	.	C	T	16	17	33	0	4	37	0	0
22	3387865	.	T	C	9	6	15	0	2	17	0	0
22	3389500	.	T	G	15	13	28	0	4	32	0	0
22	3389606	.	A	G	13	16	29	1	3	33	0	0
22	3389615	.	T	C	12	15	27	1	0	28	0	0
22	3389803	.	G	A	13	17	30	0	0	30	0	0
22	3392768	.	A	T	17	12	29	0	5	34	0	0
22	3402151	.	A	G	15	10	25	0	0	25	0	0
22	3413876	.	C	T	10	12	22	0	0	22	0	0
22	3413993	.	G	A	7	9	16	0	0	16	0	0
22	4747456	.	C	A	2	3	5	0	0	5	0	0
22	4952823	.	C	A	1	2	3	0	0	3	0	0
22	4962472	.	T	A	6	4	10	0	0	10	0	0
22	4962559	.	G	A	14	6	20	0	1	21	0	0
22	4962610	.	A	T	8	12	20	0	0	20	0	0
22	4962635	.	A	G	5	17	22	0	0	22	0	0
22	4962878	.	G	A	12	19	31	0	0	31	0	0
22	4968955	.	A	G	18	19	37	2	0	39	0	0
22	4969051	.	G	A	12	14	26	0	1	27	0	0
22	4970773	.	T	C	12	1	13	0	16	29	0	0
22	4970797	.	G	C	10	12	22	0	2	24	0	0
22	4972848	.	T	G	10	13	23	0	4	27	0	0
22	4972980	.	C	T	4	18	22	0	19	41	0	0
22	4975236	.	T	A	7	23	30	0	6	36	0	0
22	4977106	.	G	A	14	10	24	0	1	25	0	0
22	4985831	.	G	C	9	9	18	0	0	18	0	0
22	4985888	.	T	C	6	0	6	0	12	18	0	0
22	5056425	.	G	T	9	7	16	0	1	17	0	0
22	5056706	.	G	A	10	6	16	0	1	17	0	0
22	5056760	.	T	G	8	18	26	0	1	27	0	0
22	5056978	.	A	T	9	3	12	0	0	12	0	0
22	5057421	.	C	A	1	8	9	0	10	19	0	0
22	5057443	.	T	C	6	0	6	0	15	21	0	0
22	5057489	.	T	A	11	6	17	0	0	17	0	0
22	5057504	.	T	A	9	6	15	0	2	17	0	0
22	5059916	.	A	G	13	8	21	0	0	21	0	0
22	5060087	.	T	G	9	13	22	0	0	22	0	0
22	5060162	.	T	A	14	13	27	1	1	29	0	0
22	5062457	.	G	A	14	6	20	0	0	20	0	0
22	5075291	.	T	C	10	10	20	0	0	20	0	0
22	5075390	.	A	G	5	10	15	0	1	16	0	0
22	5075673	.	A	G	7	6	13	0	1	14	0	0
22	5075732	.	T	C	9	9	18	0	1	19	0	0
22	5087451	.	G	A	8	9	17	0	0	17	0	0
22	5087488	.	G	A	17	11	28	0	2	30	0	0
22	5090115	.	C	A	2	17	19	0	11	30	0	0
22	5098433	.	G	T	22	6	28	0	1	29	0	0
22	5103769	.	G	A	2	4	6	0	0	6	0	0
22	5109554	.	G	A	28	18	46	0	2	48	0	0
22	5109560	.	T	A	28	13	41	0	6	47	0	0
22	5112644	.	G	T	19	24	43	0	2	45	0	0
22	5112749	.	T	C	25	14	39	0	3	42	0	0
22	5112864	.	G	A	25	21	46	0	0	46	0	0
22	5112915	.	A	C	21	21	42	0	0	42	0	0
22	5114380	.	G	C	0	34	34	1	28	63	0	0
22	5116267	.	A	C	10	4	14	0	0	14	0	0
22	5118373	.	A	G	2	0	2	0	4	6	0	0
22	5118378	.	G	A	1	4	5	0	2	7	0	0
22	5121464	.	C	T	5	9	14	0	0	14	0	0
22	5121471	.	C	T	6	9	15	0	0	15	0	0
22	5121623	.	A	G	7	0	7	0	6	13	0	0
22	5135241	.	T	A	5	3	8	0	0	8	0	0
22	5140122	.	A	G	6	5	11	0	0	11	0	0
22	5140750	.	G	A	5	2	7	0	0	7	0	0
22	5144566	.	G	C	3	6	9	0	0	9	0	0
22	5144645	.	C	T	7	6	13	0	0	13	0	0
22	5144750	.	T	A	3	5	8	0	1	9	0	0
22	5145109	.	C	A	2	4	6	0	1	7	0	0
22	5228744	.	G	A	0	5	5	8	10	23	0	0
22	5228924	.	C	T	2	2	4	5	0	9	0	0
22	5229048	.	G	A	7	4	11	1	1	13	0	0
22	5229077	.	T	C	11	7	18	1	0	19	0	0
22	5230339	.	A	G	15	11	26	4	2	32	0	0
22	5230977	.	A	C	5	3	8	4	0	12	0	0
22	5875501	.	A	C	1	2	3	0	0	3	0	0
22	5909268	.	T	C	1	6	7	0	0	7	0	0
22	5909293	.	C	T	1	5	6	0	0	6	0	0
22	5912968	.	A	G	1	6	7	0	0	7	0	0
22	6028840	.	T	C	2	0	2	0	3	5	0	0
22	6054740	.	C	G	2	3	5	0	0	5	0	0
22	6075315	.	T	C	5	7	12	0	0	12	0	0
22	6077657	.	T	C	3	0	3	0	6	9	0	0
22	6077833	.	A	T	9	4	13	0	0	13	0	0
22	6077844	.	G	A	9	5	14	0	0	14	0	0
22	6077906	.	C	G	11	4	15	0	0	15	0	0
22	6078223	.	C	A	2	10	12	0	0	12	0	0
22	6488003	.	T	G	1	2	3	0	0	3	0	0
22	6527546	.	C	T	9	4	13	2	1	16	0	0
22	6527553	.	C	A	1	8	9	1	8	19	1	0
22	6528059	.	A	T	11	4	15	0	0	15	0	0
22	6528151	.	T	C	7	3	10	0	0	10	0	0
22	6528177	.	C	T	0	3	3	0	6	9	0	0
22	6528247	.	A	G	6	2	8	0	1	9	0	0
22	6528274	.	C	A	1	4	5	0	6	11	0	0
22	6528284	.	T	G	8	7	15	0	1	16	0	0
22	6528313	.	T	C	7	1	8	0	10	18	0	0
22	6528586	.	C	T	7	4	11	0	0	11	0	0
22	6528632	.	C	T	2	5	7	0	0	7	0	0
22	6528746	.	A	G	13	4	17	0	0	17	0	0
22	6529143	.	T	C	1	0	1	0	5	6	0	0
22	6546796	.	G	A	4	5	9	0	0	9	0	0
22	6546800	.	T	C	4	4	8	0	0	8	0	0
22	6546949	.	A	T	3	2	5	0	0	5	0	0
22	6546965	.	C	G	3	3	6	0	0	6	0	0
22	6547309	.	C	T	7	2	9	0	0	9	0	0
22	6548057	.	G	A	1	2	3	0	0	3	0	0
22	6548072	.	G	A	1	2	3	0	0	3	0	0
22	6548408	.	C	T	5	4	9	0	0	9	0	0
22	6548425	.	A	G	4	6	10	0	0	10	0	0
22	6953787	.	T	A	1	5	6	0	0	6	0	0
22	6953840	.	C	T	1	2	3	0	0	3	0	0
22	6956664	.	G	A	0	2	2	0	1	3	0	0
22	6996116	.	T	C	2	1	3	0	6	9	0	0
22	6996343	.	G	A	10	8	18	0	0	18	0	0
22	6998904	.	A	G	11	16	27	0	0	27	0	0
22	6998949	.	G	T	12	14	26	0	0	26	0	0
22	6998988	.	T	C	16	11	27	0	1	28	0	0
22	6999006	.	A	G	18	9	27	0	0	27	0	0
22	6999060	.	G	C	10	0	10	0	7	17	0	0
22	6999148	.	T	A	5	8	13	0	1	14	0	0
22	7001474	.	G	T	9	3	12	0	0	12	0	0
22	7001528	.	C	T	5	5	10	0	0	10	0	0
22	7001827	.	G	A	8	6	14	0	0	14	0	0
22	7003603	.	A	G	13	6	19	0	0	19	0	0
22	7006913	.	T	C	2	0	2	0	4	6	0	0
22	7009333	.	A	T	10	13	23	1	0	24	0	0
22	7009393	.	A	G	5	6	11	1	0	12	0	0
22	7009911	.	A	G	15	8	23	0	0	23	0	0
22	7009915	.	C	T	4	9	13	0	13	26	0	0
22	7010011	.	A	C	20	19	39	0	0	39	0	0
22	7010100	.	T	C	16	1	17	0	19	36	0	0
22	7010151	.	T	C	24	15	39	0	2	41	0	0
22	7012898	.	C	T	0	19	19	0	9	28	0	0
22	7012931	.	C	G	16	20	36	0	0	36	0	0
22	7016655	.	A	G	17	17	34	0	2	36	0	0
22	7018223	.	G	A	10	10	20	0	0	20	0	0
22	7019397	.	C	A	2	17	19	0	24	43	0	0
22	7019701	.	T	A	16	19	35	0	0	35	0	0
22	7044634	.	C	G	12	6	18	0	1	19	0	0
22	7044667	.	T	G	9	6	15	0	2	17	0	0
22	7044681	.	T	C	9	5	14	0	0	14	0	0
22	7045031	.	G	A	9	14	23	0	1	24	0	0
22	7045041	.	C	A	7	13	20	0	1	21	0	0
22	7045070	.	C	T	10	6	16	0	1	17	0	0
22	7045215	.	A	G	7	13	20	0	2	22	0	0
22	7056645	.	C	T	15	7	22	0	1	23	0	0
22	7128829	.	C	T	0	3	3	0	2	5	0	0
22	7128897	.	C	G	2	3	5	0	0	5	0	0
22	7129110	.	C	T	0	2	2	0	4	6	0	0
22	7129212	.	G	C	8	3	11	0	0	11	0	0
22	7359844	.	T	C	5	11	16	0	0	16	0	0
22	7400193	.	A	G	8	9	17	0	0	17	0	0
22	7522830	.	C	T	2	3	5	0	0	5	0	0
22	7523909	.	T	G	3	3	6	0	0	6	0	0
22	7523935	.	G	A	4	2	6	0	1	7	0	0
22	7529580	.	T	C	2	1	3	0	1	4	0	0
22	7529586	.	A	G	2	2	4	0	0	4	0	0
22	7542756	.	A	T	4	3	7	0	1	8	0	0
22	7545827	.	A	C	4	2	6	0	0	6	0	0
22	7545902	.	T	C	4	3	7	0	0	7	0	0
22	7556516	.	C	T	2	4	6	0	0	6	0	0
22	7556580	.	A	G	4	2	6	0	0	6	0	0
22	7558306	.	A	T	3	3	6	0	0	6	0	0
22	7558337	.	T	C	5	2	7	0	0	7	0	0
22	7558417	.	C	T	5	4	9	0	0	9	0	0
22	7558430	.	T	A	5	4	9	0	0	9	0	0
22	7558973	.	C	T	0	4	4	0	1	5	0	0
22	7558980	.	C	T	2	4	6	0	0	6	0	0
22	7640313	.	A	G	1	2	3	0	0	3	0	0
22	7676888	.	C	T	1	2	3	1	0	4	0	0
22	7677356	.	C	T	1	2	3	0	0	3	0	0
22	7682820	.	T	A	10	4	14	4	0	18	0	0
22	7682825	.	T	G	11	4	15	4	0	19	0	0
22	7682887	.	A	C	1	3	4	2	0	6	0	0
22	7682888	.	C	T	0	3	3	2	1	6	0	0
22	7683091	.	C	A	13	2	15	1	0	16	0	0
22	7683092	.	T	A	12	2	14	1	1	16	0	0
22	7683759	.	C	T	0	7	7	0	4	11	0	0
22	7683828	.	T	G	3	9	12	0	0	12	0	0
22	7693582	.	T	A	4	2	6	0	1	7	0	0
22	7693586	.	A	T	4	3	7	0	0	7	0	0
22	7693674	.	C	T	3	3	6	0	0	6	0	0
22	7699287	.	G	A	1	2	3	1	0	4	0	0
22	7699390	.	C	T	0	2	2	2	2	6	0	0
22	7702840	.	G	A	3	2	5	0	0	5	0	0
22	7702850	.	T	C	2	2	4	0	1	5	0	0
22	7972792	.	A	G	5	2	7	2	0	9	0	0
22	7972848	.	A	G	5	3	8	4	0	12	0	0
22	7972851	.	T	C	4	3	7	4	0	11	0	0
22	7974111	.	C	G	1	6	7	0	0	7	0	0
22	7974133	.	C	T	6	2	8	0	0	8	0	0
22	7974164	.	C	A	3	3	6	2	1	9	0	0
22	7974302	.	C	G	1	4	5	1	0	6	0	0
22	7974314	.	T	C	5	2	7	1	0	8	0	0
22	8161183	.	A	C	9	6	15	0	0	15	0	0
22	8163863	.	T	C	13	1	14	0	6	20	0	0
22	8163993	.	G	T	5	9	14	0	0	14	0	0
22	8241735	.	T	C	1	2	3	0	0	3	0	0
22	8241743	.	A	C	1	0	1	0	3	4	0	0
22	8296714	.	C	T	12	5	17	0	2	19	0	0
22	8296763	.	G	T	9	6	15	0	2	17	0	0
22	8328718	.	T	C	1	4	5	1	0	6	0	0
22	8328719	.	G	A	1	3	4	1	1	6	0	0
22	8341622	.	C	T	5	2	7	0	0	7	0	0
22	8341822	.	A	G	9	3	12	0	0	12	0	0
22	8345088	.	T	C	2	8	10	0	0	10	0	0
22	8345121	.	T	C	3	7	10	0	1	11	0	0
22	8345354	.	C	T	0	7	7	0	4	11	0	0
22	8347579	.	A	G	2	5	7	3	0	10	0	0
22	8351214	.	T	C	1	11	12	0	1	13	0	0
22	8351215	.	G	A	1	12	13	0	0	13	0	0
22	8351431	.	A	T	3	3	6	0	0	6	0	0
22	8353029	.	T	A	1	6	7	0	0	9	2	0
22	8387622	.	G	A	1	2	3	0	0	3	0	0
22	8499539	.	G	A	1	3	4	3	0	7	0	0
22	8499542	.	G	T	1	3	4	3	0	7	0	0
22	8638075	.	A	G	1	3	4	0	0	4	0	0
22	8639733	.	G	T	2	2	4	0	0	4	0	0
22	8714656	.	A	G	3	3	6	0	1	7	0	0
22	8715382	.	T	C	1	4	5	0	0	5	0	0
22	8715976	.	C	T	0	2	2	0	1	3	0	0
22	8718386	.	A	T	1	2	3	4	0	7	0	0
22	8718401	.	A	T	1	2	3	3	0	6	0	0
22	8718437	.	T	A	3	4	7	1	1	9	0	0
22	8719170	.	T	C	2	5	7	6	0	13	0	0
22	8721410	.	C	T	2	5	7	0	0	7	0	0
22	8769431	.	A	G	2	5	7	1	0	8	0	0
22	8769613	.	T	A	1	2	3	0	1	4	0	0
22	8770151	.	T	G	5	3	8	0	0	8	0	0
22	8770153	.	G	A	5	3	8	0	0	8	0	0
22	8780697	.	T	C	1	3	4	0	0	4	0	0
22	8780700	.	G	C	0	3	3	0	1	4	0	0
22	8784184	.	A	G	3	0	3	1	4	8	0	0
22	8784446	.	A	T	2	5	7	0	0	7	0	0
22	8784585	.	T	A	1	3	4	0	0	4	0	0
22	8784772	.	A	T	3	3	6	0	0	6	0	0
22	8785016	.	T	C	2	4	6	0	1	7	0	0
22	8785647	.	T	C	3	2	5	0	0	5	0	0
22	8785914	.	C	T	4	4	8	0	0	8	0	0
22	8785965	.	C	T	3	5	8	1	1	10	0	0
22	8786022	.	G	A	1	4	5	1	0	6	0	0
22	8786056	.	T	G	1	4	5	0	0	5	0	0
22	8786060	.	C	T	1	4	5	0	0	5	0	0
22	8786316	.	C	T	4	3	7	0	0	7	0	0
22	8786379	.	T	A	4	4	8	0	0	8	0	0
22	8786385	.	C	T	4	3	7	0	0	7	0	0
22	8786726	.	T	A	1	2	3	0	0	3	0	0
22	8787001	.	A	T	2	2	4	0	0	4	0	0
22	8787382	.	T	G	2	2	4	2	0	6	0	0
22	8787384	.	C	T	2	2	4	2	0	6	0	0
22	8788101	.	T	C	1	1	2	0	0	2	0	0
22	8788109	.	G	A	1	2	3	0	0	3	0	0
22	9029336	.	A	G	1	2	3	0	0	3	0	0
22	9029654	.	A	G	0	0	0	0	3	3	0	0
22	9039816	.	T	A	5	2	7	0	0	7	0	0
22	9052827	.	C	T	2	2	4	0	0	4	0	0
22	9061337	.	T	G	4	3	7	0	1	8	0	0
22	9062299	.	T	G	5	1	6	0	1	7	0	0
22	9062307	.	G	A	3	2	5	0	0	5	0	0
22	9065259	.	C	G	2	0	2	0	2	4	0	0
22	9065277	.	A	C	3	2	5	0	0	5	0	0
22	9448912	.	C	G	1	2	3	0	0	3	0	0
22	9455052	.	T	C	1	2	3	0	0	3	0	0
22	9472870	.	T	C	10	5	15	0	1	16	0	0
22	9472873	.	T	C	13	5	18	0	0	18	0	0
22	9483293	.	C	T	8	11	19	0	0	19	0	0
22	9484355	.	T	C	16	18	34	0	1	35	0	0
22	9489885	.	A	G	10	10	20	0	2	22	0	0
22	9490730	.	C	T	12	13	25	0	1	26	0	0
22	9494144	.	A	G	9	16	25	0	0	25	0	0
22	9496453	.	C	T	7	8	15	0	0	15	0	0
22	9496608	.	A	G	10	10	20	0	0	20	0	0
22	9496766	.	T	C	9	5	14	0	1	15	0	0
22	9496781	.	C	A	10	6	16	0	0	16	0	0
22	9496933	.	T	A	9	21	30	0	1	31	0	0
22	9496954	.	G	A	1	16	17	0	13	30	0	0
22	9499564	.	C	T	16	11	27	0	1	28	0	0
22	9499579	.	C	G	12	0	12	0	11	23	0	0
22	9499762	.	T	C	18	16	34	0	1	35	0	0
22	9508704	.	T	G	15	23	38	0	1	39	0	0
22	9509637	.	G	A	1	22	23	0	15	38	0	0
22	9512565	.	A	C	21	18	39	0	2	41	0	0
22	9512628	.	T	C	24	20	44	0	2	46	0	0
22	9512630	.	T	C	24	19	43	0	4	47	0	0
22	9512670	.	C	T	20	25	45	0	2	47	0	0
22	9512829	.	A	G	9	9	18	0	0	18	0	0
22	9512885	.	T	G	12	5	17	0	2	19	0	0
22	9513039	.	C	T	8	16	24	0	0	24	0	0
22	9513048	.	T	C	9	13	22	0	1	23	0	0
22	9523557	.	A	T	10	11	21	0	1	22	0	0
22	9523618	.	A	G	6	13	19	0	0	19	0	0
22	9524673	.	T	C	6	10	16	0	0	16	0	0
22	9525415	.	C	T	11	3	14	0	0	14	0	0
22	9526254	.	T	G	8	8	16	0	0	16	0	0
22	9526389	.	C	T	12	7	19	0	0	19	0	0
22	9527373	.	T	C	6	7	13	0	1	14	0	0
22	9527409	.	T	C	10	10	20	0	0	20	0	0
22	9527439	.	G	T	14	11	25	0	0	25	0	0
22	9527450	.	C	G	15	12	27	0	1	28	0	0
22	9527983	.	A	G	13	11	24	0	2	26	0	0
22	9530328	.	T	C	6	9	15	0	1	16	0	0
22	9530388	.	C	T	8	11	19	0	0	19	0	0
22	9530418	.	A	G	5	0	5	0	15	20	0	0
22	9530571	.	T	C	11	6	17	0	0	17	0	0
22	9530598	.	G	A	9	5	14	0	1	15	0	0
22	9532339	.	C	T	9	5	14	0	0	14	0	0
22	9532431	.	G	A	13	3	16	0	1	17	0	0
22	9532455	.	T	C	12	6	18	0	1	19	0	0
22	9534066	.	C	T	10	12	22	0	0	22	0	0
22	9534138	.	C	T	14	8	22	0	2	24	0	0
22	9535191	.	T	C	16	13	29	0	1	30	0	0
22	9535290	.	C	T	10	14	24	0	0	24	0	0
22	9535890	.	T	C	12	13	25	0	1	26	0	0
22	9535914	.	G	A	16	10	26	0	2	28	0	0
22	9536134	.	G	A	2	15	17	0	9	26	0	0
22	9536984	.	C	T	11	15	26	0	0	26	0	0
22	9537165	.	A	G	8	15	23	0	4	27	0	0
22	9537186	.	T	C	11	13	24	0	1	25	0	0
22	9537267	.	T	C	10	18	28	0	0	28	0	0
22	9537339	.	C	T	15	18	33	0	0	33	0	0
22	9537637	.	T	C	14	17	31	0	1	32	0	0
22	9537640	.	T	C	14	18	32	0	0	32	0	0
22	9537779	.	A	G	12	3	15	0	7	22	0	0
22	9537859	.	C	T	7	7	14	0	2	16	0	0
22	9538004	.	C	T	4	3	7	0	0	7	0	0
22	9538011	.	G	C	4	2	6	0	0	6	0	0
22	9824674	.	T	G	2	5	7	0	0	7	0	0
22	9828560	.	A	T	2	3	5	0	0	5	0	0
22	9832104	.	A	T	5	3	8	0	2	10	0	0
22	9832109	.	G	A	5	4	9	0	0	9	0	0
22	9834775	.	C	T	1	2	3	0	0	3	0	0
22	9834777	.	A	T	0	1	1	0	1	2	0	0
22	9835039	.	C	T	2	6	8	0	0	8	0	0
22	9835189	.	T	C	3	5	8	0	0	8	0	0
22	9835844	.	T	C	4	2	6	0	0	6	0	0
22	9835951	.	A	G	1	4	5	0	0	5	0	0
22	9835984	.	T	A	1	4	5	0	0	5	0	0
22	9835999	.	T	C	1	3	4	0	0	4	0	0
22	9836301	.	G	C	3	2	5	0	0	5	0	0
22	9836312	.	C	A	0	2	2	0	3	5	0	0
22	9836443	.	T	G	1	2	3	0	0	3	0	0
22	9862962	.	T	C	3	3	6	0	0	6	0	0
22	9863145	.	C	T	4	2	6	0	0	6	0	0
22	9864852	.	T	G	2	3	5	0	0	5	0	0
22	9864857	.	C	G	2	0	2	0	3	5	0	0
22	9877998	.	A	G	10	6	16	0	1	17	0	0
22	9878028	.	T	A	6	2	8	0	1	9	0	0
22	9879322	.	G	C	0	3	3	0	3	6	0	0
22	9879328	.	A	C	3	2	5	0	0	5	0	0
22	9887054	.	A	T	4	5	9	0	1	10	0	0
22	9887293	.	A	G	6	3	9	0	1	10	0	0
22	9887434	.	G	A	1	3	4	0	0	4	0	0
22	9887777	.	T	A	1	2	3	1	0	4	0	0
22	9888366	.	G	A	1	4	5	1	0	6	0	0
22	9888379	.	C	T	0	5	5	1	1	7	0	0
22	9888783	.	T	C	2	3	5	0	0	5	0	0
22	9888851	.	G	C	1	3	4	0	0	4	0	0
22	9893357	.	A	T	3	2	5	1	0	6	0	0
22	9893360	.	T	C	3	3	6	1	0	7	0	0
22	9893577	.	G	T	3	3	6	8	0	14	0	0
22	9893688	.	G	A	2	4	6	0	0	7	1	0
22	9893706	.	T	C	1	4	5	0	2	7	0	0
22	9893729	.	T	G	2	4	6	0	0	6	0	0
22	9894327	.	G	T	1	8	9	0	0	9	0	0
22	9894340	.	T	G	1	6	7	0	0	7	0	0
22	9896120	.	G	A	1	5	6	0	1	7	0	0
22	9898190	.	A	C	1	7	8	0	0	8	0	0
22	9898259	.	C	A	3	2	5	0	0	5	0	0
22	9898355	.	C	T	4	5	9	0	1	10	0	0
22	9899279	.	A	G	6	6	12	0	0	12	0	0
22	9899453	.	T	C	5	4	9	3	1	13	0	0
22	9899741	.	A	G	1	2	3	2	0	5	0	0
22	9900387	.	T	G	1	2	3	0	0	3	0	0
22	9900406	.	A	C	1	2	3	0	0	3	0	0
22	9904652	.	C	G	1	2	3	0	0	3	0	0
22	9906714	.	A	C	1	4	5	0	0	5	0	0
22	9906778	.	T	C	4	2	6	0	0	6	0	0
22	9926204	.	A	G	3	4	7	0	0	7	0	0
22	9926449	.	T	C	2	3	5	0	0	5	0	0
22	9926475	.	A	G	2	2	4	0	0	4	0	0
22	9926532	.	C	G	4	3	7	0	0	7	0	0
22	9926663	.	G	A	3	3	6	0	0	6	0	0
22	9932947	.	C	G	9	9	18	0	0	18	0	0
22	9934854	.	T	C	1	2	3	2	0	5	0	0
22	9947133	.	T	C	1	2	3	0	0	3	0	0
22	9964348	.	G	T	2	2	4	0	0	4	0	0
22	9965704	.	T	A	1	3	4	0	0	4	0	0
22	10019376	.	G	A	1	2	3	0	0	3	0	0
22	10019568	.	C	T	2	4	6	0	0	6	0	0
22	10019645	.	C	G	3	6	9	0	0	9	0	0
22	10019712	.	A	G	3	5	8	0	0	8	0	0
22	10019742	.	T	C	3	0	3	0	3	6	0	0
22	10039344	.	A	C	1	0	1	0	2	3	0	0
22	10039630	.	G	A	5	1	6	0	0	6	0	0
22	10039678	.	G	A	4	3	7	0	0	7	0	0
22	10040000	.	G	A	3	3	6	0	0	6	0	0
22	10040015	.	C	T	0	4	4	0	4	8	0	0
22	10040099	.	C	T	0	4	4	0	1	5	0	0
22	10048389	.	G	T	2	3	5	0	0	5	0	0
22	10048884	.	T	A	4	3	7	0	0	7	0	0
22	10048950	.	C	A	5	3	8	0	0	8	0	0
22	10048952	.	C	T	4	3	7	0	1	8	0	0
22	10049346	.	T	C	0	5	5	0	0	5	0	0
22	10049352	.	A	G	4	3	7	0	0	7	0	0
22	10049382	.	C	A	4	3	7	0	0	7	0	0
22	10049478	.	T	C	2	3	5	0	0	5	0	0
22	10071165	.	T	C	2	3	5	0	0	5	0	0
22	10123910	.	G	C	10	8	18	0	0	18	0	0
22	10123962	.	T	C	13	0	13	0	8	21	0	0
22	10123998	.	C	T	1	11	12	0	11	23	0	0
22	10129878	.	A	G	10	3	13	0	1	14	0	0
22	10159001	.	C	T	4	5	9	0	1	10	0	0
22	10159339	.	C	T	10	7	17	0	1	18	0	0
22	10162958	.	A	T	10	13	23	0	0	23	0	0
22	10168219	.	T	C	10	9	19	0	1	20	0	0
22	10184031	.	G	T	9	10	19	0	0	19	0	0
22	10188095	.	C	T	12	5	17	0	0	17	0	0
22	10196330	.	C	T	13	5	18	0	1	19	0	0
22	10196394	.	G	A	2	7	9	0	14	23	0	0
22	10196468	.	A	T	12	9	21	0	2	23	0	0
22	10196483	.	A	G	13	9	22	0	1	23	0	0
22	10196621	.	C	A	9	13	22	0	2	24	0	0
22	10196634	.	C	T	9	15	24	0	0	24	0	0
22	10196864	.	G	A	20	10	30	1	0	31	0	0
22	10196951	.	C	A	9	11	20	0	3	23	0	0
22	10197061	.	C	T	9	11	20	0	0	20	0	0
22	10197100	.	T	G	14	5	19	0	0	19	0	0
22	10197146	.	C	T	10	16	26	0	1	27	0	0
22	10197180	.	T	A	22	6	28	0	0	28	0	0
22	10197796	.	G	C	2	9	11	0	9	20	0	0
22	10198075	.	T	G	6	1	7	0	8	15	0	0
22	10198167	.	G	A	14	5	19	0	0	19	0	0
22	10198178	.	A	T	9	6	15	0	2	17	0	0
22	10198211	.	T	C	11	10	21	0	0	21	0	0
22	10198232	.	T	A	12	10	22	0	0	22	0	0
22	10198283	.	T	C	10	14	24	0	1	25	0	0
22	10198335	.	A	C	13	19	32	0	1	33	0	0
22	10198399	.	T	A	16	27	43	0	1	44	0	0
22	10198737	.	G	A	13	8	21	0	0	21	0	0
22	10198779	.	G	C	10	9	19	0	0	19	0	0
22	10201858	.	G	C	1	8	9	0	5	14	0	0
22	10201888	.	G	A	20	19	39	0	1	40	0	0
22	10201906	.	G	A	2	23	25	0	28	53	0	0
22	10205736	.	C	T	18	25	43	0	0	43	0	0
22	10207978	.	A	T	24	27	51	0	1	52	0	0
22	10208011	.	T	C	27	23	50	0	3	53	0	0
22	10208032	.	A	C	29	23	52	0	0	52	0	0
22	10208089	.	C	T	25	23	48	0	0	48	0	0
22	10208101	.	T	G	25	23	48	0	2	50	0	0
22	10208134	.	G	A	23	23	46	0	1	47	0	0
22	10208182	.	C	T	23	27	50	0	1	51	0	0
22	10208404	.	C	T	17	23	40	0	1	41	0	0
22	10210467	.	T	C	16	18	34	0	3	37	0	0
22	10211754	.	C	T	24	24	48	0	4	52	0	0
22	10212089	.	C	T	26	24	50	0	1	51	0	0
22	10212161	.	A	C	26	21	47	0	5	52	0	0
22	10212230	.	C	G	23	18	41	0	1	42	0	0
22	10212417	.	T	A	4	9	13	0	1	14	0	0
22	10215007	.	T	C	6	1	7	0	1	8	0	0
22	10215008	.	G	A	6	2	8	0	0	8	0	0
22	10220257	.	C	T	6	4	10	0	0	10	0	0
22	10220259	.	T	C	6	4	10	0	0	10	0	0
22	10220298	.	A	T	10	4	14	0	0	14	0	0
22	10220444	.	G	T	0	11	11	0	7	18	0	0
22	10220451	.	C	T	11	8	19	0	0	19	0	0
22	10260078	.	A	G	7	3	10	0	0	10	0	0
22	10260468	.	A	G	5	0	5	0	6	11	0	0
22	10260774	.	C	T	7	8	15	0	0	15	0	0
22	10260828	.	C	T	4	4	8	0	0	8	0	0
22	10261037	.	C	T	3	2	5	1	0	6	0	0
22	10261792	.	T	A	9	7	16	0	0	16	0	0
22	10261840	.	T	C	10	7	17	0	1	18	0	0
22	10261888	.	C	T	12	8	20	0	0	20	0	0
22	10261945	.	A	C	15	9	24	0	2	26	0	0
22	10262216	.	A	T	6	10	16	0	0	16	0	0
22	10262296	.	C	T	3	3	6	0	0	6	0	0
22	10361324	.	T	C	4	2	6	0	1	7	0	0
22	10361385	.	C	G	3	3	6	0	0	6	0	0
22	10361391	.	T	C	4	3	7	0	0	7	0	0
22	10361577	.	G	C	5	0	5	0	11	16	0	0
22	10361787	.	C	G	13	9	22	0	0	22	0	0
22	10361889	.	A	G	13	13	26	0	0	26	0	0
22	10361892	.	A	G	12	11	23	0	2	25	0	0
22	10361937	.	C	T	0	5	5	0	13	18	0	0
22	10361964	.	T	C	13	0	13	0	9	22	0	0
22	10362003	.	T	G	9	14	23	0	3	26	0	0
22	10362174	.	C	T	1	11	12	0	14	26	0	0
22	10364681	.	A	G	9	12	21	0	0	21	0	0
22	10372847	.	C	T	1	16	17	0	14	31	0	0
22	10372950	.	A	C	12	1	13	0	9	22	0	0
22	10373081	.	T	C	11	0	11	0	8	19	0	0
22	10373118	.	A	T	10	7	17	0	0	17	0	0
22	10373263	.	G	T	12	6	18	0	0	18	0	0
22	10373795	.	A	T	6	4	10	0	0	10	0	0
22	10373849	.	G	A	5	6	11	0	0	11	0	0
22	10373879	.	C	A	4	6	10	0	0	10	0	0
22	10373915	.	T	C	3	7	10	0	0	10	0	0
22	10373931	.	T	A	12	6	18	0	1	19	0	0
22	10374012	.	G	A	12	3	15	0	0	15	0	0
22	10383159	.	A	G	7	2	9	0	0	9	0	0
22	10390580	.	T	A	6	6	12	0	1	13	0	0
22	10390824	.	G	C	6	5	11	0	1	12	0	0
22	10391347	.	C	T	9	4	13	0	0	13	0	0
22	10393045	.	C	T	5	8	13	0	1	14	0	0
22	10396692	.	G	A	6	8	14	0	0	14	0	0
22	10397610	.	G	T	3	8	11	0	0	11	0	0
22	10430183	.	C	A	0	2	2	0	2	4	0	0
22	10430189	.	A	G	3	3	6	0	0	6	0	0
22	10430252	.	A	G	7	5	12	0	0	12	0	0
22	10430709	.	T	C	6	2	8	0	1	9	0	0
22	10432123	.	A	G	3	5	8	0	0	8	0	0
22	10434709	.	T	A	2	4	6	0	0	6	0	0
22	10435233	.	A	T	4	2	6	0	0	6	0	0
22	10435236	.	T	G	3	4	7	0	0	7	0	0
22	10435268	.	C	T	4	3	7	0	0	7	0	0
22	10435385	.	T	C	2	1	3	0	1	4	0	0
22	10435455	.	T	C	3	2	5	0	0	5	0	0
22	10435508	.	A	G	3	5	8	0	0	8	0	0
22	10436247	.	G	A	1	3	4	0	0	4	0	0
22	10439972	.	G	A	2	2	4	0	0	4	0	0
22	10455105	.	T	A	1	2	3	0	0	3	0	0
22	10480806	.	G	A	1	3	4	0	0	4	0	0
22	10513750	.	G	A	3	2	5	0	2	7	0	0
22	10514154	.	T	A	3	5	8	0	0	8	0	0
22	10514288	.	G	T	5	6	11	0	0	11	0	0
22	10514303	.	G	C	3	1	4	0	6	10	0	0
22	10516808	.	C	T	4	6	10	0	0	10	0	0
22	10516864	.	T	A	3	5	8	0	0	8	0	0
22	10517306	.	G	T	4	3	7	0	1	8	0	0
22	10517499	.	T	C	4	0	4	0	3	7	0	0
22	10517505	.	A	C	4	0	4	0	3	7	0	0
22	10545308	.	A	G	3	0	3	0	5	8	0	0
22	13977910	.	T	G	7	15	22	0	0	22	0	0
22	13978228	.	T	C	11	4	15	0	1	16	0	0
22	13978465	.	A	G	10	1	11	0	5	16	0	0
22	13978480	.	T	C	8	5	13	0	0	13	0	0
22	13978849	.	C	T	5	9	14	0	0	14	0	0
22	13978920	.	A	G	13	2	15	0	0	15	0	0
22	13978921	.	A	G	12	3	15	0	0	15	0	0
22	13979348	.	C	A	6	2	8	0	0	8	0	0
22	14072862	.	C	T	3	2	5	0	0	5	0	0
22	14076954	.	G	A	1	3	4	0	0	4	0	0
22	14077029	.	T	C	1	2	3	0	0	3	0	0
22	14078027	.	C	T	1	2	3	0	0	3	0	0
22	14083532	.	T	C	4	4	8	0	0	8	0	0
22	14083823	.	T	C	1	2	3	0	0	3	0	0
22	14124381	.	C	T	18	24	42	0	1	43	0	0
22	14124465	.	G	A	23	18	41	0	1	42	0	0
22	14124655	.	C	T	18	15	33	0	0	33	0	0
22	14125440	.	T	A	9	4	13	0	0	13	0	0
22	14125448	.	A	T	8	5	13	0	1	14	0	0
22	14366222	.	G	A	6	4	10	0	1	11	0	0
22	14380352	.	G	A	3	3	6	0	0	6	0	0
22	14381780	.	A	T	5	3	8	0	0	8	0	0
22	14381812	.	G	T	7	3	10	0	0	10	0	0
22	14390053	.	A	T	2	3	5	0	0	5	0	0
22	14398645	.	G	A	4	3	7	0	0	7	0	0
22	14404788	.	C	A	5	2	7	0	0	7	0	0
22	14422533	.	A	T	7	3	10	0	1	11	0	0
22	14445860	.	G	C	4	0	4	0	7	11	0	0
22	14454650	.	T	C	3	5	8	0	0	8	0	0
22	14458857	.	T	A	2	4	6	0	1	7	0	0
22	14459518	.	A	G	1	2	3	0	0	3	0	0
22	14459714	.	A	G	2	4	6	0	0	6	0	0
22	14461508	.	G	A	4	6	10	0	0	10	0	0
22	14461547	.	A	C	3	1	4	0	2	6	0	0
22	14495941	.	C	T	1	2	3	0	0	3	0	0
22	14539620	.	C	T	0	3	3	0	2	5	0	0
22	14556620	.	T	C	4	3	7	0	0	7	0	0
22	14556663	.	A	T	3	2	5	0	0	5	0	0
22	14557666	.	T	C	5	4	9	0	0	9	0	0
22	14560499	.	G	T	1	4	5	0	0	5	0	0
22	14850790	.	T	A	3	4	7	0	0	7	0	0
22	15009192	.	C	T	3	3	6	0	0	6	0	0
22	15009267	.	G	A	4	2	6	0	0	6	0	0
22	15009648	.	T	C	2	4	6	0	0	6	0	0
22	15009813	.	G	A	4	2	6	0	0	6	0	0
22	15009826	.	G	T	5	2	7	0	0	7	0	0
22	15010349	.	T	C	5	2	7	0	0	7	0	0
22	15010490	.	A	C	4	0	4	0	3	7	0	0
22	15010508	.	G	A	5	2	7	0	0	7	0	0
22	15010604	.	C	A	9	5	14	0	1	15	0	0
22	15345339	.	T	A	2	11	13	0	0	13	0	0
22	15384695	.	T	C	4	1	5	0	9	14	0	0
22	15384759	.	A	T	8	8	16	0	0	16	0	0
22	15385143	.	T	A	5	7	12	0	0	12	0	0
22	15541277	.	C	T	6	6	12	0	0	12	0	0
22	15543490	.	C	T	12	6	18	1	0	19	0	0
22	15545930	.	T	A	9	11	20	0	0	20	0	0
22	15548150	.	C	T	11	10	21	0	1	22	0	0
22	15552200	.	G	T	3	3	6	0	0	6	0	0
22	15567430	.	T	G	1	2	3	0	0	3	0	0
22	15593456	.	C	G	4	1	5	0	0	5	0	0
22	15593466	.	A	T	3	3	6	0	0	6	0	0
22	15628710	.	G	A	5	5	10	0	1	11	0	0
22	15628909	.	C	A	5	9	14	0	0	14	0	0
22	15629686	.	T	C	1	3	4	0	0	4	0	0
22	15629923	.	C	T	2	2	4	0	0	4	0	0
22	15630115	.	T	G	1	0	1	0	4	5	0	0
22	15696007	.	A	G	19	17	36	0	0	36	0	0
22	15696026	.	A	G	22	15	37	0	3	40	0	0
22	15696191	.	T	G	31	14	45	0	0	45	0	0
22	15700157	.	C	T	1	20	21	0	18	39	0	0
22	15701561	.	G	A	17	21	38	1	2	41	0	0
22	15701636	.	A	G	22	28	50	0	1	51	0	0
22	15704622	.	C	T	24	16	40	0	4	44	0	0
22	15719625	.	T	A	14	13	27	0	0	27	0	0
22	15719672	.	G	T	15	14	29	0	0	29	0	0
22	15719682	.	G	A	15	15	30	0	0	30	0	0
22	15719891	.	T	C	9	16	25	0	1	26	0	0
22	15720199	.	A	G	11	8	19	0	1	20	0	0
22	15720200	.	C	A	0	10	10	0	10	20	0	0
22	15720250	.	T	G	16	10	26	0	0	26	0	0
22	15720583	.	C	T	3	4	7	0	0	7	0	0
22	15721436	.	C	T	10	6	16	0	0	16	0	0
22	15721443	.	C	T	5	8	13	0	1	14	0	0
22	15721558	.	C	G	2	2	4	0	1	5	0	0
22	15900745	.	T	C	1	8	9	0	0	9	0	0
22	15900812	.	T	C	2	2	4	0	0	4	0	0
22	15912259	.	A	G	11	9	20	0	0	20	0	0
22	15912298	.	C	T	16	5	21	0	0	21	0	0
22	15912346	.	C	T	2	12	14	0	10	24	0	0
22	15915611	.	G	A	3	2	5	0	0	5	0	0
22	15915749	.	T	A	2	2	4	0	0	4	0	0
22	15917855	.	G	A	14	11	25	0	4	29	0	0
22	15929136	.	A	G	17	15	32	0	2	34	0	0
22	15932428	.	C	A	12	11	23	0	0	23	0	0
22	15943833	.	G	A	11	9	20	0	1	21	0	0
22	15950504	.	A	G	8	7	15	0	0	16	1	0
22	15979490	.	T	G	3	6	9	0	0	9	0	0
22	15979650	.	G	A	0	4	4	0	6	10	0	0
22	15979776	.	A	G	6	5	11	0	0	11	0	0
22	15979827	.	C	T	3	6	9	0	0	9	0	0
22	15979857	.	T	C	2	6	8	0	0	8	0	0
22	15996502	.	T	C	8	6	14	0	0	14	0	0
22	15996726	.	G	A	2	7	9	0	0	9	0	0
22	16000383	.	C	T	3	4	7	0	0	7	0	0
22	16002106	.	C	T	7	8	15	0	0	15	0	0
22	16002121	.	C	G	8	0	8	0	7	15	0	0
22	16002161	.	T	C	11	7	18	0	1	19	0	0
22	16002283	.	A	T	4	7	11	0	1	12	0	0
22	16002397	.	C	T	4	5	9	0	1	10	0	0
22	16003382	.	G	A	3	10	13	0	0	13	0	0
22	16032205	.	G	A	3	4	7	0	0	7	0	0
22	16032550	.	T	G	9	7	16	0	0	16	0	0
22	16033259	.	T	C	10	4	14	0	0	14	0	0
22	16033622	.	G	T	7	4	11	0	2	13	0	0
22	16038660	.	G	A	9	7	16	0	1	17	0	0
22	16038749	.	A	G	6	9	15	0	0	15	0	0
22	16039194	.	C	A	10	12	22	0	0	22	0	0
22	16039398	.	A	C	3	7	10	0	0	10	0	0
22	16039806	.	T	C	8	0	8	0	6	14	0	0
22	16040007	.	T	C	4	5	9	0	1	10	0	0
22	16097243	.	G	A	3	2	5	0	1	6	0	0
22	16097261	.	T	G	3	3	6	0	0	6	0	0
22	16112012	.	T	A	3	4	7	0	0	7	0	0
22	16112039	.	G	A	0	4	4	0	2	6	0	0
22	16120766	.	T	C	4	4	8	0	0	8	0	0
22	16120828	.	A	G	4	4	8	0	0	8	0	0
22	16121035	.	T	A	6	6	12	0	1	13	0	0
22	16121157	.	C	A	7	2	9	0	0	9	0	0
22	16121281	.	C	A	4	3	7	0	0	7	0	0
22	16123437	.	T	G	4	9	13	0	0	13	0	0
22	16123931	.	A	G	4	8	12	0	0	12	0	0
22	16144846	.	G	T	8	11	19	0	5	24	0	0
22	16150462	.	A	G	3	7	10	0	0	10	0	0
22	16171869	.	G	A	5	8	13	0	0	13	0	0
22	16171871	.	A	G	6	8	14	0	0	14	0	0
22	16173329	.	A	G	7	7	14	0	0	14	0	0
22	16173380	.	T	G	4	6	10	0	0	10	0	0
22	16174191	.	A	G	5	5	10	0	0	10	0	0
22	16174400	.	T	A	6	4	10	0	0	10	0	0
22	16176033	.	T	A	3	4	7	0	0	7	0	0
22	16177026	.	C	T	4	3	7	0	1	8	0	0
22	16177033	.	G	T	5	2	7	0	0	7	0	0
22	16177174	.	G	C	6	2	8	0	0	8	0	0
22	16177749	.	C	T	5	3	8	0	0	8	0	0
22	16191841	.	T	C	4	0	4	0	2	6	0	0
22	16191845	.	T	G	3	2	5	0	1	6	0	0
22	16191912	.	C	A	0	3	3	0	1	4	0	0
22	16191920	.	T	A	2	3	5	0	0	5	0	0
22	16192428	.	C	A	2	2	4	0	0	4	0	0
22	16192903	.	G	A	1	3	4	0	0	4	0	0
22	16192905	.	C	T	0	3	3	0	1	4	0	0
22	16193024	.	T	C	3	0	3	0	5	8	0	0
22	16193420	.	T	A	4	5	9	0	0	9	0	0
22	16193494	.	T	A	1	2	3	0	0	3	0	0
22	16201599	.	C	T	0	3	3	0	2	5	0	0
22	16201632	.	G	A	3	2	5	0	0	5	0	0
22	16260272	.	T	C	1	2	3	0	0	3	0	0
22	16270388	.	G	A	2	3	5	0	0	5	0	0
22	16282323	.	A	T	1	3	4	0	0	4	0	0
22	16282571	.	T	A	7	10	17	0	0	17	0	0
22	16282636	.	T	G	6	8	14	0	3	17	0	0
22	16282757	.	C	G	0	11	11	0	6	17	0	0
22	16285578	.	G	A	3	3	6	0	1	7	0	0
22	16287499	.	T	G	7	5	12	0	1	13	0	0
22	16287608	.	T	G	10	8	18	0	1	19	0	0
22	16287659	.	C	T	1	7	8	0	9	17	0	0
22	16290698	.	G	A	5	7	12	0	1	13	0	0
22	16290772	.	G	A	10	5	15	0	0	15	0	0
22	16290869	.	T	A	5	6	11	0	0	11	0	0
22	16290906	.	G	A	5	4	9	0	0	9	0	0
22	16298473	.	A	G	1	0	1	0	6	7	0	0
22	16298535	.	G	T	0	4	4	0	5	10	1	0
22	16298666	.	T	C	7	9	16	0	0	16	0	0
22	16298720	.	A	C	9	9	18	0	1	20	1	0
22	16298756	.	C	T	15	10	25	0	0	25	0	0
22	16302465	.	C	T	7	6	13	0	1	14	0	0
22	16302468	.	C	T	7	7	14	0	1	15	0	0
22	16302877	.	A	T	5	6	11	0	1	12	0	0
22	16302922	.	A	G	6	7	13	0	0	13	0	0
22	16305098	.	C	A	7	3	10	0	0	10	0	0
22	16305164	.	A	C	12	5	17	0	0	17	0	0
22	16311799	.	A	T	1	4	5	0	0	5	0	0
22	16311842	.	C	T	4	2	6	0	0	6	0	0
22	16312075	.	T	C	5	5	10	0	3	13	0	0
22	16312085	.	T	C	6	0	6	0	6	12	0	0
22	16312222	.	T	G	2	4	6	0	0	6	0	0
22	16312228	.	A	G	2	3	5	0	1	6	0	0
22	16312278	.	C	T	2	2	4	0	1	5	0	0
22	16312399	.	A	G	5	2	7	0	0	7	0	0
22	16312755	.	T	C	5	7	12	0	0	12	0	0
22	16312783	.	C	T	0	7	7	0	6	13	0	0
22	16313005	.	T	A	6	4	10	0	1	11	0	0
22	16313093	.	C	A	1	2	3	0	4	7	0	0
22	16313095	.	C	A	5	2	7	0	0	7	0	0
22	16317797	.	A	T	4	3	7	0	1	8	0	0
22	16320351	.	A	T	1	3	4	0	0	4	0	0
22	16324766	.	G	A	1	2	3	0	0	3	0	0
22	16340761	.	A	G	3	3	6	0	0	6	0	0
22	16340915	.	A	G	2	1	3	0	0	3	0	0
22	16340930	.	C	G	2	2	4	0	0	4	0	0
22	16340960	.	A	G	3	0	3	0	3	6	0	0
22	16345485	.	A	G	2	2	4	0	1	5	0	0
22	16345668	.	C	A	4	2	6	0	1	7	0	0
22	16350811	.	T	G	27	18	45	0	1	46	0	0
22	16351199	.	C	G	21	11	32	0	0	32	0	0
22	16351204	.	C	T	1	8	9	0	20	29	0	0
22	16351404	.	C	T	4	5	9	0	0	9	0	0
22	16351490	.	T	G	7	8	15	0	0	15	0	0
22	16351552	.	A	T	4	2	6	0	0	6	0	0
22	16352146	.	G	T	1	5	6	0	0	6	0	0
22	16352154	.	C	G	1	5	6	0	0	6	0	0
22	16352215	.	A	G	7	7	14	0	2	16	0	0
22	16352349	.	A	G	16	18	34	0	1	35	0	0
22	16352463	.	C	A	3	15	18	0	10	28	0	0
22	16352469	.	A	G	14	14	28	0	1	29	0	0
22	16352528	.	G	A	18	15	33	0	0	33	0	0
22	16352668	.	T	C	22	0	22	0	10	32	0	0
22	16352739	.	C	T	2	13	15	0	15	30	0	0
22	16355013	.	A	C	18	16	34	0	1	35	0	0
22	16355042	.	C	A	16	14	30	0	0	30	0	0
22	16355555	.	A	G	14	23	37	0	0	37	0	0
22	16357818	.	A	G	18	12	30	0	1	31	0	0
22	16357831	.	A	G	21	11	32	0	1	33	0	0
22	16357867	.	G	A	22	11	33	0	0	33	0	0
22	16367007	.	T	C	11	0	11	0	6	17	0	0
22	16367055	.	A	G	13	9	22	2	0	24	0	0
22	16368886	.	G	A	23	12	35	0	1	36	0	0
22	16377364	.	A	G	12	14	26	0	1	27	0	0
22	16377891	.	C	T	3	2	5	0	0	5	0	0
22	16407173	.	T	G	3	2	5	0	1	6	0	0
22	16407177	.	G	C	3	2	5	0	1	6	0	0
22	16408228	.	C	T	0	2	2	0	1	3	0	0
22	16410600	.	A	G	2	2	4	0	0	4	0	0
22	16411199	.	G	A	2	3	5	0	0	5	0	0
22	16422166	.	A	G	13	0	13	0	11	24	0	0
22	16424576	.	T	C	11	10	21	0	1	22	0	0
22	16430672	.	C	T	12	11	23	0	0	23	0	0
22	16432627	.	C	T	18	15	33	0	2	35	0	0
22	16432628	.	A	T	17	16	33	0	1	34	0	0
22	16433078	.	G	A	12	11	23	0	0	23	0	0
22	16433096	.	A	G	14	9	23	0	1	24	0	0
22	16433131	.	T	G	13	7	20	0	2	22	0	0
22	16433250	.	G	A	6	3	9	0	0	9	0	0
22	16433337	.	T	C	2	2	4	0	0	4	0	0
22	16433394	.	G	A	5	12	17	0	1	18	0	0
22	16433422	.	A	G	3	9	12	0	2	14	0	0
22	16433748	.	T	A	1	2	3	0	0	3	0	0
22	16433912	.	T	A	13	4	17	0	0	18	1	0
22	16433940	.	C	T	17	5	22	0	0	22	0	0
22	16434056	.	G	A	20	14	34	0	0	34	0	0
22	16438112	.	A	C	20	19	39	0	1	40	0	0
22	16440086	.	T	C	10	0	10	0	23	33	0	0
22	16473823	.	C	T	2	2	4	0	0	4	0	0
22	16483102	.	T	A	1	2	3	0	0	3	0	0
22	16483112	.	A	G	2	2	4	0	0	4	0	0
22	16484621	.	G	A	10	7	17	0	1	18	0	0
22	16484877	.	A	T	9	7	16	0	2	18	0	0
22	16484938	.	A	G	14	10	24	0	0	24	0	0
22	16484944	.	T	C	13	10	23	0	0	23	0	0
22	16485035	.	A	G	8	10	18	0	0	18	0	0
22	16485538	.	T	C	8	0	8	0	5	13	0	0
22	16485563	.	A	T	6	1	7	0	1	8	0	0
22	16485625	.	A	G	3	5	8	1	0	9	0	0
22	16485688	.	G	A	2	6	8	1	0	9	0	0
22	16485920	.	G	A	13	9	22	0	1	23	0	0
22	16485954	.	C	T	11	9	20	0	4	24	0	0
22	16485962	.	C	G	12	7	19	0	1	20	0	0
22	16485994	.	C	A	6	6	12	0	2	14	0	0
22	16486004	.	C	A	3	8	11	0	3	14	0	0
22	16486112	.	T	C	7	11	18	0	1	19	0	0
22	16491693	.	G	A	18	9	27	0	1	28	0	0
22	16491720	.	T	C	16	0	16	0	7	23	0	0
22	16491942	.	G	A	18	16	34	0	1	35	0	0
22	16492000	.	T	A	19	16	35	0	2	37	0	0
22	16497953	.	G	A	11	15	26	0	1	27	0	0
22	16498155	.	G	C	1	16	17	0	17	34	0	0
22	16498317	.	A	G	28	10	38	0	1	39	0	0
22	16498661	.	A	G	13	0	13	0	15	28	0	0
22	16537701	.	C	T	6	3	9	0	0	9	0	0
22	16543627	.	C	T	17	18	35	0	2	37	0	0
22	16543714	.	T	C	8	13	21	0	2	23	0	0
22	16544186	.	A	G	4	7	11	0	0	11	0	0
22	16544197	.	A	G	7	6	13	0	1	14	0	0
22	16544243	.	C	T	9	8	17	0	0	17	0	0
22	16544260	.	C	T	10	7	17	1	1	19	0	0
22	16544384	.	G	A	14	9	23	0	0	23	0	0
22	16544400	.	T	G	13	13	26	0	0	26	0	0
22	16544599	.	A	G	11	0	11	0	14	25	0	0
22	16544674	.	T	G	12	22	34	0	3	37	0	0
22	16544780	.	A	T	15	13	28	0	0	28	0	0
22	16544800	.	G	A	15	10	25	0	1	26	0	0
22	16569862	.	C	T	18	8	26	0	1	27	0	0
22	16584241	.	C	G	13	13	26	0	3	29	0	0
22	16592011	.	A	G	12	18	30	0	0	30	0	0
22	16592029	.	C	G	2	14	16	0	15	31	0	0
22	16594870	.	T	A	9	14	23	0	1	24	0	0
22	16594981	.	C	A	14	8	22	0	0	22	0	0
22	16595022	.	A	G	14	11	25	0	0	25	0	0
22	16601400	.	C	T	7	10	17	0	3	20	0	0
22	16609449	.	T	C	11	16	27	0	2	29	0	0
22	16609494	.	G	A	14	13	27	0	1	28	0	0
22	16614011	.	C	T	12	6	18	0	0	18	0	0
22	16759111	.	G	A	17	4	21	0	1	22	0	0
22	16775306	.	C	T	8	7	15	0	1	16	0	0
22	16840292	.	T	C	7	7	14	1	0	15	0	0
22	18233234	.	T	C	4	5	9	0	1	10	0	0
22	18233238	.	T	C	8	3	11	0	0	11	0	0
22	18966298	.	T	C	6	6	12	0	0	12	0	0
22	18966421	.	G	A	4	2	6	0	0	6	0	0
22	18966529	.	A	T	3	6	9	0	0	9	0	0
22	18966575	.	T	C	1	3	4	0	0	4	0	0
22	18971667	.	T	C	7	9	16	0	0	16	0	0
22	18971697	.	T	C	6	11	17	0	0	17	0	0
22	18971725	.	T	C	3	6	9	0	0	9	0	0
22	18971736	.	T	C	3	3	6	0	0	6	0	0
22	19004989	.	A	T	2	6	8	0	0	8	0	0
22	19006676	.	A	G	3	9	12	0	0	12	0	0
22	19006763	.	T	C	10	7	17	0	1	18	0	0
22	19006994	.	T	C	11	11	22	0	2	24	0	0
22	19007574	.	A	G	18	10	28	0	0	28	0	0
22	19007677	.	C	A	8	14	22	1	0	23	0	0
22	19007764	.	A	G	6	6	12	0	1	13	0	0
22	19024732	.	T	G	2	2	4	0	0	4	0	0
22	19065870	.	G	A	2	3	5	0	0	5	0	0
22	19065966	.	G	C	3	2	5	0	0	5	0	0
22	19067871	.	T	C	1	1	2	0	1	3	0	0
22	19099044	.	T	C	2	0	2	0	2	4	0	0
22	19099085	.	C	T	0	1	1	0	4	5	0	0
22	19099095	.	T	A	2	2	4	0	1	5	0	0
22	19547501	.	A	T	4	11	15	0	0	15	0	0
22	19547573	.	C	G	0	5	5	0	13	18	0	0
22	19547575	.	A	C	12	0	12	0	7	19	0	0
22	19547796	.	C	T	9	18	27	0	1	28	0	0
22	19552745	.	C	T	6	19	25	0	3	28	0	0
22	19642960	.	T	A	4	2	6	0	0	6	0	0
22	19642982	.	T	C	3	1	4	0	1	5	0	0
22	19643017	.	A	G	3	0	3	0	3	6	0	0
22	19643020	.	G	A	1	2	3	0	4	7	0	0
22	19645155	.	G	A	1	3	4	0	0	4	0	0
22	19645170	.	G	A	1	4	5	0	0	5	0	0
22	19645233	.	T	C	5	7	12	0	0	12	0	0
22	19645464	.	A	G	8	0	8	0	4	12	0	0
22	19645673	.	C	G	4	0	4	0	4	8	0	0
22	19645802	.	G	A	3	5	8	0	0	8	0	0
22	19665618	.	C	T	11	15	26	0	1	27	0	0
22	19671776	.	A	G	20	15	35	0	0	35	0	0
22	20011558	.	T	C	2	2	4	0	0	4	0	0
22	20105242	.	A	G	4	3	7	0	0	7	0	0
22	20105686	.	T	C	3	3	6	0	1	7	0	0
22	20139410	.	C	T	5	2	7	0	0	7	0	0
22	20140913	.	G	A	0	3	3	0	1	4	0	0
22	20141632	.	T	C	2	2	4	0	0	4	0	0
22	20141635	.	C	A	2	2	4	0	0	4	0	0
22	20142031	.	T	C	3	3	6	2	0	8	0	0
22	20142035	.	A	T	3	3	6	2	0	8	0	0
22	20142160	.	T	C	2	4	6	0	0	6	0	0
22	20142178	.	A	T	3	5	8	0	0	8	0	0
22	20142226	.	C	G	3	3	6	0	0	6	0	0
22	20142315	.	A	T	5	2	7	0	0	7	0	0
22	20142352	.	A	G	4	2	6	0	0	6	0	0
22	20142373	.	A	T	4	2	6	0	0	6	0	0
22	20142723	.	A	T	5	2	7	0	1	8	0	0
22	20143002	.	G	T	1	3	4	0	0	4	0	0
22	20143138	.	A	G	6	3	9	0	0	9	0	0
22	20143143	.	G	T	5	3	8	0	1	9	0	0
22	20159200	.	A	C	16	8	24	0	0	24	0	0
22	20159576	.	A	T	17	19	36	0	0	36	0	0
22	20159771	.	C	A	24	16	40	0	1	41	0	0
22	20164449	.	T	C	21	22	43	0	1	44	0	0
22	20169411	.	A	C	10	10	20	0	0	20	0	0
22	20169429	.	G	A	13	13	26	0	1	27	0	0
22	20172105	.	A	G	9	0	9	0	7	16	0	0
22	20172642	.	A	G	5	15	20	0	1	21	0	0
22	20175295	.	G	A	9	4	13	0	1	14	0	0
22	20177970	.	G	A	0	5	5	0	6	11	0	0
22	20177981	.	G	A	8	5	13	0	0	13	0	0
22	20178045	.	C	T	7	6	13	0	0	13	0	0
22	20178065	.	T	C	6	4	10	0	0	10	0	0
22	20202641	.	G	A	13	8	21	0	0	21	0	0
22	20204719	.	A	C	10	0	10	1	5	16	0	0
22	20211187	.	T	C	7	7	14	0	2	16	0	0
22	20211289	.	G	T	1	7	8	0	14	22	0	0
22	20212794	.	G	T	1	20	21	0	13	34	0	0
22	20214649	.	G	A	2	22	24	0	13	37	0	0
22	20215089	.	T	A	15	23	38	0	0	38	0	0
22	20215351	.	C	T	8	12	20	0	1	21	0	0
22	20220161	.	A	G	12	0	12	0	18	30	0	0
22	20220197	.	C	T	13	18	31	0	0	32	1	0
22	20222950	.	G	C	11	11	22	0	1	23	0	0
22	20230044	.	T	C	22	23	45	0	0	45	0	0
22	20240483	.	T	C	20	21	41	0	5	46	0	0
22	20240835	.	A	G	20	19	39	0	1	40	0	0
22	20292595	.	A	T	9	8	17	0	1	18	0	0
22	20292789	.	T	C	18	18	36	0	2	38	0	0
22	20293440	.	G	A	10	11	21	0	2	23	0	0
22	20296615	.	A	T	14	22	36	0	2	38	0	0
22	20296669	.	T	C	22	17	39	1	6	46	0	0
22	20299280	.	A	G	27	25	52	0	5	57	0	0
22	20299283	.	G	A	28	30	58	0	0	58	0	0
22	20299349	.	T	C	24	25	49	0	1	50	0	0
22	20303406	.	A	G	20	23	43	0	4	47	0	0
22	20303412	.	G	T	25	23	48	0	1	49	0	0
22	20303487	.	A	G	22	32	54	0	1	55	0	0
22	20305443	.	G	T	27	25	52	0	3	55	0	0
22	20313722	.	C	A	17	14	31	0	2	33	0	0
22	20313791	.	A	G	13	15	28	0	0	28	0	0
22	20313887	.	C	G	19	10	29	0	3	32	0	0
22	20313926	.	C	A	1	12	13	0	21	34	0	0
22	20315851	.	T	C	11	0	11	0	12	23	0	0
22	20315883	.	C	T	8	15	23	0	2	25	0	0
22	20315896	.	G	A	8	22	30	0	0	30	0	0
22	20318937	.	C	T	3	10	13	0	22	35	0	0
22	20319149	.	A	G	15	9	24	0	0	24	0	0
22	20388853	.	G	A	11	10	21	0	0	21	0	0
22	20389198	.	C	A	11	14	25	0	0	25	0	0
22	20389286	.	A	G	13	5	18	0	1	19	0	0
22	20389392	.	A	G	5	13	18	0	2	20	0	0
22	20389538	.	A	T	21	12	33	0	0	33	0	0
22	20389545	.	G	A	19	14	33	0	2	35	0	0
22	20389580	.	T	G	21	13	34	0	1	35	0	0
22	20389620	.	T	A	18	9	27	0	1	28	0	0
22	20390002	.	C	A	10	16	26	0	0	26	0	0
22	20390041	.	C	T	15	22	37	0	1	38	0	0
22	20402889	.	T	C	9	9	18	0	0	18	0	0
22	20407002	.	C	T	1	7	8	0	5	13	0	0
22	20408865	.	T	C	9	0	9	0	14	23	0	0
22	20409099	.	C	T	4	11	15	0	1	16	0	0
22	20475073	.	G	A	2	2	4	0	0	4	0	0
22	20478001	.	T	A	2	3	5	0	0	5	0	0
22	20478274	.	T	C	1	4	5	0	0	5	0	0
22	20574066	.	T	C	11	14	25	0	1	26	0	0
22	20574402	.	A	G	11	12	23	0	2	25	0	0
22	20574585	.	A	G	12	11	23	0	0	23	0	0
22	20575634	.	G	A	11	8	19	0	0	19	0	0
22	20783269	.	T	A	4	2	6	0	0	6	0	0
22	20788656	.	C	T	4	2	6	0	0	6	0	0
22	20791016	.	T	C	4	3	7	0	0	7	0	0
22	20792042	.	G	A	5	3	8	0	0	8	0	0
22	20792054	.	T	C	3	3	6	0	0	6	0	0
22	20794383	.	A	G	5	6	11	0	0	11	0	0
22	20797091	.	C	T	4	2	6	0	0	6	0	0
22	20797280	.	G	A	3	4	7	0	0	7	0	0
22	20797490	.	C	T	0	9	9	0	4	13	0	0
22	20797511	.	A	G	3	8	11	0	0	11	0	0
22	20797556	.	G	A	4	4	8	0	1	9	0	0
22	20797691	.	G	A	4	3	7	0	0	7	0	0
22	20801339	.	G	C	4	2	6	0	0	6	0	0
22	20814342	.	A	G	2	2	4	0	0	4	0	0
22	20848297	.	G	A	3	7	10	0	0	10	0	0
22	20848326	.	C	T	3	4	7	0	1	8	0	0
22	20848488	.	G	A	3	9	12	0	1	13	0	0
22	20848501	.	A	G	3	7	10	0	1	11	0	0
22	20849615	.	T	C	5	0	5	0	10	15	0	0
22	20877036	.	T	C	7	0	7	0	14	21	0	0
22	20926412	.	C	T	4	4	8	0	0	8	0	0
22	20926466	.	G	A	6	7	13	0	2	15	0	0
22	20926511	.	G	A	11	6	17	0	0	17	0	0
22	20940039	.	C	T	1	12	13	0	4	17	0	0
22	20940048	.	G	A	4	12	16	0	0	16	0	0
22	20944679	.	A	G	11	7	18	0	1	19	0	0
22	20951387	.	T	C	7	0	7	0	4	11	0	0
22	20951514	.	C	T	0	10	10	0	17	27	0	0
22	20951788	.	G	A	16	10	26	0	0	26	0	0
22	20951861	.	C	T	11	12	23	0	1	24	0	0
22	20951866	.	G	T	10	11	21	0	0	21	0	0
22	20952257	.	A	G	18	18	36	0	1	37	0	0
22	20952292	.	A	T	20	10	30	0	0	30	0	0
22	20953053	.	T	A	9	10	19	0	0	19	0	0
22	20953127	.	A	T	15	6	21	0	0	21	0	0
22	20953141	.	C	A	12	5	17	0	2	19	0	0
22	20953418	.	G	A	15	11	26	0	0	26	0	0
22	20953555	.	C	A	20	6	26	0	1	27	0	0
22	20953578	.	A	G	23	6	29	0	0	29	0	0
22	20954083	.	A	T	4	0	4	0	1	5	0	0
22	20954386	.	C	T	6	2	8	0	1	9	0	0
22	20954391	.	C	T	6	4	10	0	0	10	0	0
22	20954557	.	T	A	9	11	20	0	0	20	0	0
22	20954717	.	A	T	11	15	26	0	6	32	0	0
22	20954810	.	C	T	1	19	20	0	16	36	0	0
22	20954953	.	C	T	9	26	35	0	1	36	0	0
22	20955427	.	C	T	0	10	10	0	10	20	0	0
22	20955469	.	C	T	1	12	13	1	10	24	0	0
22	21032184	.	A	G	14	14	28	0	0	28	0	0
22	21128200	.	A	G	19	18	37	2	4	43	0	0
22	21129075	.	G	A	24	34	58	0	2	60	0	0
22	21129101	.	G	A	23	40	63	0	2	65	0	0
22	21129407	.	A	G	31	38	69	0	3	72	0	0
22	21129558	.	T	G	26	34	60	0	0	60	0	0
22	21129575	.	T	C	23	35	58	0	2	60	0	0
22	21341023	.	C	T	2	3	5	0	0	5	0	0
22	21342155	.	A	T	1	2	3	0	0	3	0	0
22	21361753	.	T	C	6	2	8	0	0	8	0	0
22	21365143	.	C	T	0	4	4	0	4	8	0	0
22	21369882	.	C	T	1	4	5	0	5	10	0	0
22	21399836	.	A	G	1	0	1	0	4	5	0	0
22	21407312	.	T	C	2	5	7	0	0	7	0	0
22	21446480	.	A	G	2	5	7	0	1	8	0	0
22	21465109	.	T	C	2	2	4	0	0	4	0	0
22	21465232	.	T	C	3	2	5	0	1	6	0	0
22	21465597	.	G	T	5	6	11	0	0	11	0	0
22	21465606	.	T	C	3	6	9	0	1	10	0	0
22	21541437	.	A	G	2	3	5	0	0	5	0	0
22	21544232	.	G	A	3	3	6	0	0	6	0	0
22	21583985	.	G	A	3	3	6	0	0	6	0	0
22	21584038	.	G	A	2	3	5	0	0	5	0	0
22	21618495	.	A	G	9	1	10	0	10	20	0	0
22	21618633	.	G	A	11	9	20	0	0	20	0	0
22	21624764	.	G	C	7	7	14	0	1	15	0	0
22	21657871	.	C	T	9	11	20	1	1	22	0	0
22	21661029	.	T	C	11	3	14	0	0	14	0	0
22	21661258	.	T	A	13	9	22	0	1	23	0	0
22	21661789	.	G	A	14	4	18	3	0	21	0	0
22	21661819	.	T	C	3	11	14	3	1	18	0	0
22	21662138	.	G	A	0	2	2	1	4	7	0	0
22	21675983	.	G	C	6	3	9	1	1	11	0	0
22	21676215	.	A	G	7	5	12	13	0	25	0	0
22	21676233	.	G	A	11	4	15	12	0	27	0	0
22	21676296	.	G	A	4	16	20	2	0	22	0	0
22	21680179	.	T	C	0	0	0	0	7	10	3	0
22	21680218	.	G	T	12	5	17	0	5	22	0	0
22	21680240	.	T	A	12	5	17	0	1	18	0	0
22	21697826	.	T	C	2	4	6	1	1	8	0	0
22	21737900	.	C	T	5	3	8	0	0	8	0	0
22	21737948	.	T	C	5	0	5	0	3	8	0	0
22	21852158	.	C	T	17	24	41	0	1	42	0	0
22	21852269	.	A	G	18	16	34	0	2	36	0	0
22	21852281	.	T	C	16	0	16	0	19	35	0	0
22	22129883	.	T	C	4	7	11	0	1	12	0	0
22	22130015	.	T	A	7	5	12	0	0	12	0	0
22	22130085	.	C	T	10	7	17	0	0	17	0	0
22	22130255	.	G	A	9	10	19	0	0	19	0	0
22	22130414	.	A	C	4	1	5	0	6	11	0	0
22	22130468	.	T	C	1	0	1	0	11	12	0	0
22	22130528	.	G	A	7	6	13	0	0	13	0	0
22	22130549	.	T	C	7	6	13	0	1	14	0	0
22	22164223	.	T	G	3	7	10	0	0	10	0	0
22	22172281	.	T	G	3	0	3	0	21	24	0	0
22	22175516	.	C	T	1	16	17	0	8	25	0	0
22	22179825	.	C	T	17	10	27	0	0	27	0	0
22	22188682	.	T	C	10	15	25	0	2	27	0	0
22	22196339	.	G	A	10	10	20	0	0	20	0	0
22	22199227	.	G	A	18	9	27	0	1	28	0	0
22	22204002	.	C	T	10	13	23	0	0	23	0	0
22	22204098	.	C	T	12	9	21	0	0	21	0	0
22	22204395	.	G	A	21	11	32	0	0	32	0	0
22	22204440	.	G	A	8	14	22	0	0	22	0	0
22	22214852	.	T	C	7	8	15	0	2	17	0	0
22	22215458	.	G	T	8	17	25	0	1	26	0	0
22	22231662	.	C	T	11	9	20	0	1	21	0	0
22	22231717	.	A	T	17	14	31	0	0	31	0	0
22	22234418	.	C	T	4	14	18	2	9	29	0	0
22	22240918	.	G	A	10	18	28	1	1	30	0	0
22	22241772	.	A	T	13	17	30	0	1	31	0	0
22	22245400	.	T	C	13	14	27	0	1	28	0	0
22	22245781	.	G	T	13	14	27	0	2	29	0	0
22	22251493	.	A	C	16	0	16	0	14	30	0	0
22	22259155	.	G	A	5	11	16	0	0	16	0	0
22	22260456	.	G	A	8	10	18	0	0	18	0	0
22	22266519	.	T	C	7	4	11	0	0	11	0	0
22	22267524	.	G	C	0	9	9	0	4	13	0	0
22	22273388	.	C	T	12	11	23	0	0	23	0	0
22	22273736	.	G	A	1	15	16	0	9	25	0	0
22	22273871	.	A	C	10	10	20	0	0	20	0	0
22	22274000	.	A	T	2	7	9	0	1	10	0	0
22	22274137	.	C	T	6	4	10	0	0	10	0	0
22	22274157	.	G	T	5	7	12	0	0	12	0	0
22	22274249	.	T	G	8	5	13	0	0	13	0	0
22	22276357	.	G	A	2	2	4	0	0	4	0	0
22	22276595	.	T	C	1	2	3	0	0	3	0	0
22	22276958	.	T	C	2	0	2	0	4	6	0	0
22	22276974	.	G	A	1	3	4	0	1	5	0	0
22	22282758	.	C	T	2	3	5	0	0	5	0	0
22	22282815	.	G	A	1	2	3	0	0	3	0	0
22	22303024	.	A	G	6	0	6	0	4	10	0	0
22	22303040	.	T	G	6	4	10	0	1	11	0	0
22	22303230	.	A	G	2	2	4	0	1	5	0	0
22	22311283	.	T	C	5	3	8	0	0	8	0	0
22	22312443	.	G	A	1	6	7	0	0	7	0	0
22	22312463	.	G	A	7	3	10	0	2	12	0	0
22	22312496	.	C	A	5	8	13	0	0	13	0	0
22	22312548	.	C	A	5	3	8	0	1	9	0	0
22	22313260	.	A	T	4	3	7	0	1	8	0	0
22	22313376	.	T	C	10	6	16	0	1	17	0	0
22	22313395	.	G	A	2	6	8	0	7	15	0	0
22	22313574	.	A	G	4	1	5	0	5	10	0	0
22	22313601	.	C	T	4	7	11	0	0	11	0	0
22	22313639	.	A	C	2	8	10	0	0	10	0	0
22	22313927	.	G	C	5	3	8	0	0	8	0	0
22	22313953	.	T	A	4	5	9	0	0	9	0	0
22	22314547	.	T	A	8	8	16	0	0	16	0	0
22	22314564	.	C	A	8	9	17	0	0	17	0	0
22	22314721	.	A	G	20	10	30	0	0	30	0	0
22	22314861	.	C	G	3	2	5	0	0	5	0	0
22	22314870	.	G	C	3	4	7	0	0	7	0	0
22	22314991	.	T	C	6	2	8	0	0	8	0	0
22	22315011	.	G	A	1	2	3	0	7	10	0	0
22	22315048	.	T	C	6	2	8	0	0	8	0	0
22	22315211	.	A	G	2	4	6	0	0	6	0	0
22	22315277	.	A	G	4	2	6	0	0	6	0	0
22	22345136	.	C	T	1	13	14	0	7	21	0	0
22	22345179	.	A	C	13	15	28	0	0	28	0	0
22	22345255	.	G	A	12	15	27	0	1	28	0	0
22	22345367	.	C	T	1	9	10	0	20	30	0	0
22	22345403	.	G	A	18	13	31	0	2	33	0	0
22	22345418	.	G	A	20	14	34	0	2	36	0	0
22	22351103	.	A	T	21	15	36	0	0	37	1	0
22	22351180	.	A	T	19	17	36	0	0	36	0	0
22	22352611	.	A	C	17	11	28	0	2	30	0	0
22	22352693	.	T	A	13	10	23	0	0	23	0	0
22	22353222	.	G	A	14	13	27	0	0	27	0	0
22	22353416	.	A	G	15	11	26	0	1	27	0	0
22	22353779	.	G	A	12	11	23	0	0	23	0	0
22	22353887	.	G	A	11	10	21	0	0	21	0	0
22	22354145	.	G	A	8	8	16	0	0	16	0	0
22	22354217	.	G	A	6	8	14	0	0	14	0	0
22	22354698	.	C	T	0	12	12	0	8	20	0	0
22	22376081	.	G	C	5	1	6	0	8	14	0	0
22	22376174	.	C	T	0	11	11	0	8	19	0	0
22	22397336	.	G	A	13	8	21	0	0	21	0	0
22	22397402	.	A	C	6	0	6	0	9	15	0	0
22	22416255	.	G	T	3	3	6	0	1	7	0	0
22	22418224	.	C	T	2	3	5	0	0	5	0	0
22	22418245	.	G	T	4	5	9	0	0	9	0	0
22	22418465	.	A	T	6	6	12	0	0	12	0	0
22	22420420	.	A	G	4	6	10	0	0	10	0	0
22	22420646	.	G	T	0	6	6	0	6	12	0	0
22	22420664	.	A	G	4	5	9	0	1	10	0	0
22	22420746	.	G	T	4	11	15	0	0	15	0	0
22	22422123	.	A	T	4	4	8	0	0	8	0	0
22	22422264	.	C	T	3	2	5	0	0	5	0	0
22	22422270	.	G	T	3	3	6	0	0	6	0	0
22	22424034	.	G	A	2	5	7	0	0	7	0	0
22	22424058	.	C	T	6	3	9	0	0	9	0	0
22	22425439	.	T	C	5	4	9	0	0	9	0	0
22	22427442	.	T	C	10	7	17	0	0	17	0	0
22	22427612	.	C	T	14	11	25	0	0	25	0	0
22	22427694	.	C	T	10	7	17	0	0	17	0	0
22	22634864	.	G	A	3	2	5	0	0	5	0	0
22	22635879	.	G	C	5	2	7	0	0	7	0	0
22	22636277	.	C	T	1	4	5	0	1	6	0	0
22	22636374	.	G	T	1	2	3	0	0	3	0	0
22	23452957	.	C	T	2	4	6	0	0	6	0	0
22	23478541	.	A	G	2	8	10	0	2	12	0	0
22	23479064	.	G	A	2	5	7	0	2	9	0	0
22	23479096	.	G	T	4	3	7	0	0	7	0	0
22	23479628	.	C	G	1	2	3	0	0	3	0	0
22	23493268	.	C	A	1	3	4	0	1	5	0	0
22	23512435	.	G	A	2	2	4	0	0	4	0	0
22	23512452	.	C	T	2	2	4	0	0	4	0	0
22	23531366	.	G	T	1	2	3	0	0	3	0	0
22	23569162	.	A	C	2	2	4	0	0	4	0	0
22	23569877	.	G	A	2	3	5	0	0	5	0	0
22	23575276	.	T	A	2	4	6	0	0	6	0	0
22	24157961	.	G	C	16	17	33	0	3	36	0	0
22	24158037	.	T	A	12	8	20	0	3	23	0	0
22	24158146	.	A	C	9	9	18	0	1	19	0	0
22	24158190	.	C	T	14	17	31	0	0	31	0	0
22	24158242	.	C	A	18	21	39	0	1	40	0	0
22	24158275	.	G	C	15	20	35	0	1	36	0	0
22	24166896	.	G	A	1	12	13	0	20	33	0	0
22	24166919	.	A	G	20	18	38	0	1	39	0	0
22	24167633	.	C	T	18	17	35	0	1	36	0	0
22	24168125	.	T	C	24	10	34	0	0	34	0	0
22	24168573	.	T	C	18	13	31	0	4	35	0	0
22	24168610	.	T	A	21	18	39	0	1	40	0	0
22	24218656	.	T	A	4	4	8	0	0	8	0	0
22	24220962	.	A	G	13	18	31	0	1	32	0	0
22	24220996	.	G	A	24	13	37	0	1	38	0	0
22	24221009	.	C	T	13	23	36	0	2	38	0	0
22	24224676	.	A	T	12	14	26	0	1	27	0	0
22	24225409	.	T	C	19	19	38	0	1	39	0	0
22	24229293	.	C	T	19	15	34	0	0	34	0	0
22	24229513	.	T	C	23	16	39	0	0	39	0	0
22	24229890	.	T	C	14	13	27	0	0	27	0	0
22	24230005	.	G	A	1	17	18	0	19	37	0	0
22	24230020	.	G	A	17	22	39	0	0	39	0	0
22	24233536	.	G	T	19	19	38	0	0	38	0	0
22	24233730	.	C	T	2	3	5	0	1	6	0	0
22	24248368	.	A	T	3	2	5	0	0	5	0	0
22	24359933	.	G	T	3	2	5	0	1	6	0	0
22	24621873	.	A	G	5	2	7	0	1	8	0	0
22	24715404	.	A	G	11	0	11	0	26	37	0	0
22	24716636	.	T	A	18	15	33	0	0	33	0	0
22	24717105	.	G	A	27	20	47	0	1	48	0	0
22	24718973	.	T	C	15	30	45	0	0	45	0	0
22	24724279	.	T	C	4	6	10	13	1	24	0	0
22	24724459	.	A	G	9	9	18	3	0	21	0	0
22	24975613	.	C	T	6	4	10	0	0	10	0	0
22	24981171	.	T	C	7	2	9	0	0	9	0	0
22	24984053	.	A	C	1	4	5	0	0	5	0	0
22	25025208	.	G	A	29	25	54	0	2	56	0	0
22	25028424	.	G	A	31	24	55	0	0	55	0	0
22	25028660	.	G	A	16	22	38	0	2	40	0	0
22	25028694	.	G	A	22	14	36	0	0	36	0	0
22	25032266	.	C	T	28	24	52	0	0	52	0	0
22	25032344	.	C	T	4	15	19	0	20	39	0	0
22	25032532	.	C	G	17	14	31	0	2	33	0	0
22	25032572	.	G	A	18	18	36	0	1	37	0	0
22	25032620	.	A	C	14	4	18	0	19	37	0	0
22	25032857	.	G	A	21	12	33	0	1	34	0	0
22	25032863	.	A	G	21	11	32	0	0	32	0	0
22	25032921	.	A	T	7	14	21	0	1	22	0	0
22	25034863	.	C	G	2	4	6	0	0	6	0	0
22	25034865	.	C	T	2	4	6	0	0	6	0	0
22	25049594	.	T	C	2	3	5	0	0	5	0	0
22	25049596	.	C	T	4	2	6	0	0	6	0	0
22	25053542	.	C	T	5	3	8	0	0	8	0	0
22	25055645	.	G	T	0	2	2	0	1	3	0	0
22	25058509	.	C	G	5	0	5	0	3	8	0	0
22	25058518	.	T	G	3	3	6	0	0	6	0	0
22	25059919	.	G	A	0	6	6	0	3	9	0	0
22	25060629	.	C	A	2	7	9	0	0	9	0	0
22	25063696	.	A	G	5	0	5	0	7	12	0	0
22	25063745	.	C	A	6	8	14	0	0	14	0	0
22	25063767	.	C	A	4	6	10	0	1	12	1	0
22	25066332	.	C	T	0	2	2	1	4	7	0	0
22	25066410	.	T	C	8	8	16	0	0	16	0	0
22	25066583	.	A	G	1	9	10	0	1	11	0	0
22	25066585	.	G	A	6	4	10	0	1	11	0	0
22	25066939	.	C	T	5	7	12	0	0	12	0	0
22	25067274	.	A	G	2	4	6	0	0	6	0	0
22	25067596	.	C	T	8	10	18	0	0	18	0	0
22	25069856	.	G	A	4	3	7	0	1	8	0	0
22	25069884	.	C	A	3	3	6	0	0	6	0	0
22	25072073	.	G	A	5	4	9	0	1	10	0	0
22	25072107	.	A	C	3	0	3	0	10	13	0	0
22	25072474	.	C	G	13	4	17	0	1	18	0	0
22	25076701	.	G	A	6	7	13	0	0	13	0	0
22	25076727	.	A	G	12	9	21	0	0	21	0	0
22	25078630	.	A	C	11	9	20	0	2	22	0	0
22	25097170	.	G	A	1	2	3	0	0	3	0	0
22	25554433	.	C	T	1	3	4	0	0	4	0	0
22	25558774	.	T	C	2	2	4	0	0	4	0	0
22	25566318	.	T	G	2	2	4	0	0	4	0	0
22	25566539	.	C	T	4	6	10	0	0	10	0	0
22	25566572	.	A	T	4	5	9	0	0	9	0	0
22	25573161	.	C	T	3	6	9	0	0	9	0	0
22	25573197	.	G	T	4	8	12	0	0	12	0	0
22	25573313	.	G	A	1	2	3	0	1	4	0	0
22	25577248	.	C	T	6	4	10	0	0	10	0	0
22	25577265	.	A	G	7	4	11	0	0	11	0	0
22	25586906	.	T	A	3	2	5	0	0	5	0	0
22	25586963	.	C	T	5	2	7	0	0	7	0	0
22	25842741	.	G	T	1	2	3	0	0	3	0	0
22	25843768	.	A	G	1	2	3	0	0	3	0	0
22	25843804	.	C	T	1	2	3	0	0	3	0	0
22	25845159	.	T	G	2	3	5	0	0	5	0	0
22	25931976	.	A	G	5	1	6	0	11	17	0	0
22	25935627	.	G	A	0	7	7	0	8	15	0	0
22	25937001	.	G	A	0	9	9	0	2	11	0	0
22	25937037	.	T	A	2	11	13	0	0	13	0	0
22	25937052	.	T	C	4	10	14	0	1	15	0	0
22	25938882	.	T	C	3	3	6	0	0	6	0	0
22	25938915	.	C	T	5	5	10	0	1	11	0	0
22	25939060	.	C	T	3	4	7	0	1	8	0	0
22	25942660	.	A	G	2	3	5	0	1	6	0	0
22	25942728	.	A	G	4	1	5	0	2	7	0	0
22	25942822	.	A	G	3	4	7	0	0	7	0	0
22	25942884	.	C	T	2	5	7	0	0	7	0	0
22	25942934	.	T	G	4	5	9	0	0	9	0	0
22	25942940	.	A	G	5	3	8	0	0	8	0	0
22	25942997	.	T	G	5	5	10	0	0	10	0	0
22	26239602	.	T	C	1	6	7	0	1	8	0	0
22	26239654	.	A	T	8	10	18	0	0	18	0	0
22	26239681	.	C	T	1	9	10	0	6	16	0	0
22	26239752	.	G	A	5	6	11	0	0	11	0	0
22	26239774	.	T	A	5	7	12	0	0	12	0	0
22	26239798	.	C	A	1	6	7	0	3	11	1	0
22	26239873	.	T	A	4	4	8	0	0	8	0	0
22	26239879	.	G	A	4	3	7	0	0	7	0	0
22	26243236	.	A	C	2	1	3	0	3	6	0	0
22	26243242	.	C	T	2	4	6	0	0	6	0	0
22	26244755	.	C	T	6	3	9	0	0	9	0	0
22	26245881	.	T	C	2	0	2	0	5	7	0	0
22	26265498	.	A	T	4	9	13	0	0	13	0	0
22	26266807	.	T	A	12	6	18	0	0	18	0	0
22	26274099	.	G	A	6	5	11	0	0	11	0	0
22	26274106	.	A	T	6	5	11	0	0	11	0	0
22	26277695	.	T	C	17	10	27	0	0	27	0	0
22	26277735	.	A	C	12	13	25	0	1	27	1	0
22	26277773	.	G	A	10	10	20	0	0	20	0	0
22	26277820	.	T	C	8	5	13	0	0	13	0	0
22	26277871	.	C	A	9	8	17	0	0	17	0	0
22	26278042	.	T	C	5	3	8	0	1	9	0	0
22	26278081	.	C	T	6	4	10	0	1	11	0	0
22	26278144	.	T	G	9	7	16	0	2	18	0	0
22	26278273	.	G	A	13	7	20	0	0	20	0	0
22	26281043	.	A	G	12	14	26	0	0	26	0	0
22	26289397	.	A	C	9	8	17	0	1	18	0	0
22	26289430	.	G	A	11	11	22	0	0	22	0	0
22	26289501	.	A	T	2	5	7	0	0	7	0	0
22	26290508	.	C	T	19	11	30	0	0	30	0	0
22	26290764	.	A	G	4	3	7	0	0	7	0	0
22	26290797	.	T	G	2	1	3	0	4	7	0	0
22	26290851	.	A	T	2	3	5	0	0	5	0	0
22	26304186	.	T	C	6	6	12	0	0	12	0	0
22	26307620	.	T	G	3	10	13	0	1	14	0	0
22	26307671	.	A	G	4	5	9	0	0	9	0	0
22	26307728	.	A	G	6	5	11	0	0	11	0	0
22	26307743	.	T	C	6	1	7	0	5	12	0	0
22	26313876	.	A	T	3	4	7	0	0	7	0	0
22	26317666	.	T	A	6	6	12	0	0	12	0	0
22	26317671	.	A	G	5	6	11	0	1	12	0	0
22	26320622	.	C	A	5	5	10	0	0	10	0	0
22	26320661	.	A	G	3	6	9	0	0	9	0	0
22	26323861	.	G	A	6	5	11	0	0	11	0	0
22	26524896	.	G	A	3	4	7	0	0	7	0	0
22	26525112	.	T	C	6	5	11	0	0	11	0	0
22	26525118	.	C	T	3	5	8	0	4	12	0	0
22	26525646	.	A	T	2	2	4	0	0	4	0	0
22	26525935	.	T	G	5	7	12	0	0	12	0	0
22	26525960	.	A	G	7	5	12	0	0	12	0	0
22	26525979	.	C	T	10	3	13	0	1	14	0	0
22	26526057	.	C	T	0	6	6	0	6	12	0	0
22	26526249	.	A	T	4	3	7	0	0	7	0	0
22	26526412	.	G	A	7	4	11	1	0	12	0	0
22	26526471	.	A	G	1	3	4	0	0	4	0	0
22	26526522	.	G	A	3	3	6	0	0	6	0	0
22	26526564	.	T	C	3	3	6	0	0	6	0	0
22	26526864	.	C	A	13	4	17	0	0	17	0	0
22	26527880	.	A	G	1	3	4	0	0	4	0	0
22	26528575	.	A	T	5	2	7	0	0	7	0	0
22	26528740	.	T	A	6	4	10	1	0	11	0	0
22	26528861	.	A	T	3	4	7	0	0	7	0	0
22	26529011	.	C	T	4	2	6	0	0	6	0	0
22	26529165	.	T	G	6	3	9	0	1	10	0	0
22	26529204	.	C	T	0	2	2	0	7	9	0	0
22	26529315	.	G	A	6	9	15	0	0	15	0	0
22	26529438	.	C	A	1	7	8	0	4	12	0	0
22	26529471	.	G	T	6	5	11	0	0	11	0	0
22	26529500	.	T	G	3	6	9	0	1	10	0	0
22	26536435	.	C	A	4	1	5	0	2	7	0	0
22	26536443	.	T	A	4	3	7	0	0	7	0	0
22	26673323	.	C	T	1	2	3	0	0	3	0	0
22	26673328	.	T	C	1	2	3	0	0	3	0	0
22	26696558	.	T	C	1	2	3	0	0	3	0	0
22	26696672	.	A	T	1	2	3	0	0	3	0	0
22	26703503	.	C	T	5	7	12	0	0	12	0	0
22	26738889	.	A	C	7	6	13	1	0	14	0	0
22	26739000	.	C	T	5	7	12	0	1	13	0	0
22	26739087	.	A	G	7	0	7	0	11	18	0	0
22	26739094	.	G	A	6	10	16	0	0	16	0	0
22	26739273	.	T	C	4	4	8	0	0	8	0	0
22	26739297	.	G	C	1	6	7	0	0	7	0	0
22	26739441	.	G	T	1	6	7	0	7	14	0	0
22	26739480	.	C	T	11	6	17	0	2	19	0	0
22	26751297	.	C	T	7	3	10	0	0	10	0	0
22	26768020	.	C	G	10	9	19	0	0	19	0	0
22	26768023	.	T	C	10	8	18	0	0	18	0	0
22	26768400	.	A	G	7	1	8	0	8	16	0	0
22	26768433	.	A	G	7	5	12	0	0	12	0	0
22	26771067	.	G	T	14	17	31	0	1	32	0	0
22	26771414	.	G	A	0	1	1	1	10	12	0	0
22	26774079	.	G	A	1	13	14	0	10	24	0	0
22	26774660	.	C	T	13	10	23	0	1	24	0	0
22	26776678	.	C	T	6	11	17	0	0	17	0	0
22	26776681	.	G	A	6	11	17	0	0	17	0	0
22	26785290	.	C	T	12	8	20	0	0	20	0	0
22	26786013	.	A	G	13	8	21	1	0	22	0	0
22	26786559	.	C	A	9	7	16	0	1	17	0	0
22	26787710	.	G	T	14	13	27	0	0	27	0	0
22	26787911	.	C	T	16	16	32	0	2	34	0	0
22	26788340	.	G	A	18	15	33	0	4	37	0	0
22	26788449	.	T	C	14	18	32	0	4	36	0	0
22	26788565	.	T	C	11	24	35	0	1	36	0	0
22	26788885	.	C	A	10	17	27	0	8	35	0	0
22	26789228	.	G	A	2	27	29	0	21	50	0	0
22	26789465	.	A	G	12	0	12	0	20	32	0	0
22	26789742	.	G	A	3	3	6	0	0	6	0	0
22	26789813	.	A	T	11	13	24	1	0	25	0	0
22	26790074	.	C	T	16	7	23	0	0	23	0	0
22	26790436	.	A	T	7	10	17	0	0	17	0	0
22	26798936	.	G	C	0	2	2	0	2	4	0	0
22	26799960	.	A	G	5	3	8	0	0	8	0	0
22	26800113	.	T	A	3	5	8	0	0	8	0	0
22	26811854	.	G	A	3	4	7	0	0	7	0	0
22	26811877	.	G	A	3	5	8	0	0	8	0	0
22	26812016	.	A	G	7	3	10	0	0	10	0	0
22	26812031	.	G	A	6	3	9	0	1	10	0	0
22	26812058	.	G	A	7	3	10	0	0	10	0	0
22	26812153	.	A	G	5	0	5	0	6	11	0	0
22	26812336	.	A	G	3	0	3	0	4	7	0	0
22	26812506	.	C	T	5	5	10	0	1	11	0	0
22	26812751	.	G	A	5	3	8	0	0	8	0	0
22	26812754	.	A	G	5	2	7	0	1	8	0	0
22	26813028	.	T	A	3	6	9	0	0	9	0	0
22	26813046	.	G	A	0	7	7	0	4	11	0	0
22	26813179	.	G	A	4	2	6	0	0	6	0	0
22	26813185	.	C	T	2	3	5	0	1	6	0	0
22	26813224	.	T	C	4	3	7	0	0	7	0	0
22	26813725	.	T	G	3	3	6	0	0	6	0	0
22	26813801	.	A	C	4	7	11	0	0	11	0	0
22	26813851	.	T	G	8	8	16	0	0	16	0	0
22	26813963	.	A	G	4	2	6	0	0	6	0	0
22	26813970	.	T	C	4	2	6	0	0	6	0	0
22	26814164	.	C	G	7	3	10	0	1	11	0	0
22	26818086	.	G	A	2	4	6	0	9	15	0	0
22	26818700	.	T	C	5	6	11	0	0	11	0	0
22	26818851	.	T	A	6	6	12	0	0	12	0	0
22	26818907	.	A	G	5	1	6	0	3	9	0	0
22	26832125	.	G	A	10	5	15	0	1	16	0	0
22	26839502	.	T	A	7	6	13	0	0	13	0	0
22	26839505	.	G	A	5	6	11	0	2	13	0	0
22	26839538	.	T	G	4	7	11	0	1	12	0	0
22	26844260	.	G	A	13	8	21	0	0	21	0	0
22	26844345	.	A	C	8	14	22	0	1	23	0	0
22	26851904	.	A	C	9	0	9	0	7	16	0	0
22	26851963	.	T	C	4	6	10	0	2	12	0	0
22	26852142	.	A	C	4	5	9	0	0	9	0	0
22	26852163	.	A	C	6	4	10	0	0	10	0	0
22	26852209	.	G	A	5	5	10	0	0	10	0	0
22	26852243	.	C	T	1	5	6	0	2	8	0	0
22	26854201	.	A	C	1	2	3	0	0	3	0	0
22	26854336	.	T	G	1	4	5	0	0	5	0	0
22	26854465	.	A	G	6	3	9	0	1	10	0	0
22	26854530	.	T	C	3	3	6	0	1	7	0	0
22	26854626	.	C	A	6	6	12	0	1	13	0	0
22	26854815	.	A	C	3	2	5	0	0	5	0	0
22	26854965	.	A	G	3	5	8	0	0	8	0	0
22	26855037	.	C	G	5	2	7	0	0	7	0	0
22	26855844	.	T	C	2	2	4	0	0	4	0	0
22	26856059	.	A	T	7	3	10	0	0	10	0	0
22	26857762	.	A	G	1	2	3	0	1	4	0	0
22	26858002	.	A	G	6	2	8	0	0	8	0	0
22	26858153	.	T	C	2	1	3	0	6	9	0	0
22	26858161	.	T	C	3	5	8	0	0	8	0	0
22	26860639	.	C	T	2	21	23	0	14	37	0	0
22	26860753	.	T	C	11	27	38	0	1	39	0	0
22	26861264	.	T	C	8	0	8	0	14	22	0	0
22	26865182	.	C	A	3	6	9	0	0	9	0	0
22	26929689	.	G	A	4	2	6	0	0	6	0	0
22	26929826	.	C	A	11	16	27	0	1	28	0	0
22	26929931	.	A	T	14	18	32	0	0	32	0	0
22	26929969	.	A	G	16	15	31	0	2	33	0	0
22	26930076	.	A	G	15	13	28	0	3	31	0	0
22	26930079	.	G	T	13	14	27	0	4	31	0	0
22	26930133	.	G	C	16	16	32	0	1	33	0	0
22	26930313	.	C	T	16	9	25	0	0	25	0	0
22	26930335	.	A	T	16	6	22	0	1	23	0	0
22	26930390	.	C	T	15	11	26	0	0	26	0	0
22	26930489	.	C	G	17	13	30	0	1	31	0	0
22	26930527	.	T	A	15	16	31	0	0	31	0	0
22	26930601	.	T	C	10	8	18	0	0	18	0	0
22	26930735	.	G	C	12	0	12	0	5	17	0	0
22	26930894	.	C	T	1	17	18	0	18	36	0	0
22	26931373	.	T	C	3	3	6	0	0	6	0	0
22	26931467	.	C	T	3	4	7	0	1	8	0	0
22	26931509	.	G	T	1	5	6	0	0	6	0	0
22	26931544	.	G	A	2	4	6	0	0	6	0	0
22	26931567	.	C	A	3	3	6	0	0	6	0	0
22	26931906	.	C	T	10	9	19	1	1	21	0	0
22	26931967	.	G	A	17	13	30	0	1	31	0	0
22	26940409	.	G	A	14	6	20	0	0	20	0	0
22	27091989	.	C	T	2	6	8	0	0	8	0	0
22	27092183	.	A	C	3	2	5	0	0	5	0	0
22	27098736	.	G	A	9	9	18	0	2	20	0	0
22	27098899	.	T	C	6	8	14	0	0	14	0	0
22	27102556	.	C	T	11	6	17	0	0	17	0	0
22	27104159	.	C	G	8	7	15	0	1	16	0	0
22	28236839	.	A	T	3	9	12	0	0	12	0	0
22	28240544	.	A	G	6	6	12	0	0	12	0	0
22	28240555	.	T	A	5	6	11	0	1	12	0	0
22	28241719	.	A	T	8	3	11	0	1	12	0	0
22	28241831	.	T	A	6	10	16	0	1	17	0	0
22	28244972	.	A	G	6	9	15	0	0	15	0	0
22	28255399	.	G	T	2	6	8	0	0	8	0	0
22	28255514	.	C	G	4	0	4	0	5	9	0	0
22	28265596	.	T	G	3	7	10	0	0	10	0	0
22	28265621	.	T	C	3	8	11	0	0	11	0	0
22	28265636	.	G	T	3	5	8	0	1	9	0	0
22	28284646	.	A	C	5	8	13	0	0	13	0	0
22	28284659	.	C	T	5	6	11	0	0	11	0	0
22	28287669	.	T	C	5	9	14	0	1	15	0	0
22	28290817	.	C	T	2	11	13	0	0	13	0	0
22	28303025	.	C	T	6	6	12	0	1	13	0	0
22	28303091	.	C	A	9	16	25	0	3	28	0	0
22	28461603	.	T	C	2	4	6	0	0	6	0	0
22	28481589	.	C	T	1	3	4	0	0	4	0	0
22	28481616	.	A	C	2	3	5	0	0	5	0	0
22	28481641	.	G	A	0	4	4	0	3	7	0	0
22	28481742	.	C	T	1	2	3	0	0	3	0	0
22	28482204	.	G	A	0	3	3	0	3	7	1	0
22	28642695	.	A	C	5	3	8	0	0	8	0	0
22	28642715	.	C	A	2	2	4	0	1	5	0	0
22	28642818	.	C	A	5	2	7	0	0	7	0	0
22	28642997	.	C	A	4	3	7	0	0	7	0	0
22	28804013	.	G	A	1	4	5	0	11	16	0	0
22	28832823	.	G	C	13	7	20	1	0	21	0	0
22	28836202	.	C	T	14	8	22	0	0	22	0	0
22	28836346	.	G	A	12	12	24	0	2	26	0	0
22	28836631	.	A	G	12	9	21	0	1	22	0	0
22	28837231	.	A	G	19	15	34	0	3	37	0	0
22	28837546	.	G	C	2	4	6	0	13	19	0	0
22	28839917	.	A	C	12	7	19	0	1	20	0	0
22	28840101	.	C	A	21	14	35	0	0	36	1	0
22	28840154	.	A	G	18	9	27	0	4	31	0	0
22	28847988	.	G	A	13	8	21	0	2	23	0	0
22	28848724	.	A	T	13	6	19	1	0	20	0	0
22	28848735	.	T	C	13	7	20	1	0	21	0	0
22	28848920	.	A	G	5	6	11	0	0	11	0	0
22	28858314	.	A	G	21	13	34	0	0	34	0	0
22	28859346	.	G	A	30	20	50	0	0	50	0	0
22	28859409	.	A	G	25	21	46	0	1	47	0	0
22	28859618	.	A	G	27	11	38	0	4	42	0	0
22	28859683	.	G	T	26	10	36	0	0	36	0	0
22	28862336	.	C	T	21	10	31	0	1	32	0	0
22	28862387	.	C	T	18	10	28	0	4	32	0	0
22	28862534	.	A	G	13	9	22	0	1	23	0	0
22	28863137	.	G	A	14	16	30	0	1	31	0	0
22	28863140	.	G	A	12	14	26	0	2	28	0	0
22	28865752	.	G	A	20	12	32	0	0	32	0	0
22	28865970	.	A	G	11	14	25	0	2	27	0	0
22	28868174	.	A	G	22	11	33	0	0	33	0	0
22	28868183	.	T	C	19	13	32	0	4	36	0	0
22	28871698	.	G	C	21	3	24	0	18	42	0	0
22	29075278	.	C	T	4	6	10	0	1	11	0	0
22	29076058	.	T	G	3	4	7	0	0	7	0	0
22	29076126	.	A	G	9	4	13	0	0	13	0	0
22	29076172	.	G	A	9	8	17	0	0	17	0	0
22	29076236	.	T	C	14	11	25	0	0	25	0	0
22	29076381	.	G	C	11	8	19	0	1	20	0	0
22	29076389	.	A	G	11	9	20	0	2	22	0	0
22	29076444	.	G	C	2	5	7	0	0	7	0	0
22	29076755	.	G	A	3	2	5	0	0	5	0	0
22	29077023	.	T	A	7	10	17	0	0	17	0	0
22	29077380	.	G	A	8	4	12	0	1	13	0	0
22	29077432	.	A	G	2	4	6	0	0	6	0	0
22	29077515	.	G	A	4	2	6	0	1	7	0	0
22	29078255	.	T	A	4	4	8	0	0	8	0	0
22	29078715	.	C	T	6	6	12	0	3	15	0	0
22	29079722	.	G	T	8	9	17	0	0	17	0	0
22	29079761	.	T	C	4	11	15	0	0	15	0	0
22	29080205	.	G	A	8	16	24	0	2	26	0	0
22	29080233	.	G	A	12	11	23	0	3	26	0	0
22	29080427	.	G	A	14	7	21	0	1	23	1	0
22	29080477	.	T	G	7	9	16	0	0	16	0	0
22	29080864	.	C	T	7	11	18	0	1	19	0	0
22	29091732	.	G	C	7	9	16	0	1	17	0	0
22	29092222	.	C	A	7	12	19	0	0	19	0	0
22	29093632	.	G	T	7	6	13	1	0	14	0	0
22	29096343	.	C	T	2	4	6	0	1	7	0	0
22	29096361	.	G	A	2	4	6	0	0	6	0	0
22	29097228	.	C	T	6	9	15	0	0	15	0	0
22	29097303	.	A	G	8	0	8	0	6	14	0	0
22	29097327	.	T	C	8	6	14	0	0	14	0	0
22	29097354	.	T	A	7	4	11	0	0	12	1	0
22	29103453	.	A	G	8	5	13	0	1	14	0	0
22	29113803	.	G	A	2	5	7	0	10	17	0	0
22	29113882	.	A	G	10	6	16	0	0	16	0	0
22	29114351	.	G	A	5	8	13	0	3	16	0	0
22	29118736	.	G	A	0	11	11	0	10	21	0	0
22	29119270	.	T	C	3	8	11	0	1	12	0	0
22	29119326	.	T	A	7	3	10	0	0	10	0	0
22	29121740	.	G	A	1	4	5	0	7	12	0	0
22	29121765	.	C	T	8	6	14	0	0	14	0	0
22	29121789	.	G	A	0	6	6	0	8	14	0	0
22	29125660	.	C	T	8	3	11	0	0	11	0	0
22	29125791	.	T	A	6	5	11	0	1	12	0	0
22	29126556	.	G	C	1	3	4	0	0	4	0	0
22	29126682	.	A	G	3	3	6	0	1	7	0	0
22	29126817	.	G	A	1	1	2	0	1	3	0	0
22	29168879	.	G	A	37	27	64	0	0	64	0	0
22	29168940	.	T	A	36	27	63	0	3	66	0	0
22	29242280	.	A	G	27	10	37	0	1	38	0	0
22	29242296	.	G	C	20	12	32	0	3	35	0	0
22	29242317	.	G	A	13	9	22	0	2	24	0	0
22	29312851	.	A	C	3	4	7	0	0	7	0	0
22	29316013	.	T	C	7	6	13	0	0	13	0	0
22	29316091	.	T	A	6	2	8	0	0	8	0	0
22	29316139	.	A	T	3	3	6	0	0	6	0	0
22	29316153	.	A	C	3	0	3	0	2	5	0	0
22	29316302	.	T	A	1	5	6	0	0	6	0	0
22	29316479	.	A	T	3	5	8	0	1	9	0	0
22	29335986	.	C	T	1	4	5	0	2	7	0	0
22	29585244	.	G	A	3	3	6	0	0	6	0	0
22	29585247	.	G	C	3	3	6	0	0	6	0	0
22	29585358	.	A	G	1	4	5	0	0	5	0	0
22	29585571	.	C	T	4	3	7	0	0	7	0	0
22	29612096	.	A	G	5	10	15	0	0	15	0	0
22	29615056	.	A	G	8	5	13	0	0	13	0	0
22	29617050	.	G	A	6	4	10	0	1	11	0	0
22	29620306	.	A	G	8	11	19	0	1	20	0	0
22	29620488	.	T	G	10	9	19	0	0	19	0	0
22	29640098	.	T	C	5	3	8	0	0	8	0	0
22	29651938	.	C	T	12	14	26	0	3	29	0	0
22	29652161	.	T	A	6	12	18	0	1	19	0	0
22	29652201	.	A	G	4	1	5	0	10	15	0	0
22	29659031	.	T	A	3	8	11	0	0	11	0	0
22	29659637	.	G	A	28	21	49	0	0	49	0	0
22	29666501	.	G	A	25	19	44	0	4	48	0	0
22	29666505	.	C	T	1	28	29	0	19	48	0	0
22	29666746	.	G	A	17	20	37	0	1	38	0	0
22	29668796	.	C	T	13	10	23	0	3	26	0	0
22	29668799	.	C	T	13	11	24	0	2	26	0	0
22	29670324	.	G	A	24	14	38	1	0	39	0	0
22	29671553	.	A	G	14	17	31	1	4	36	0	0
22	29689458	.	T	C	22	22	44	0	0	44	0	0
22	29858935	.	T	C	9	8	17	2	0	19	0	0
22	29858936	.	T	C	9	7	16	2	1	19	0	0
22	31044052	.	A	T	1	7	8	0	0	8	0	0
22	31364253	.	A	G	3	0	3	0	2	5	0	0
22	31364277	.	A	T	1	3	4	0	0	4	0	0
22	31383515	.	A	G	3	2	5	0	0	5	0	0
22	31404427	.	T	A	3	6	9	0	0	9	0	0
22	31406548	.	G	A	1	2	3	0	4	7	0	0
22	31407736	.	G	C	3	3	6	0	0	6	0	0
22	31407847	.	A	T	1	2	3	0	1	4	0	0
22	31407859	.	C	G	1	0	1	0	4	5	0	0
22	31440674	.	C	T	3	2	5	0	0	5	0	0
22	31440806	.	C	T	4	3	7	0	0	7	0	0
22	31445113	.	A	G	4	4	8	0	2	10	0	0
22	31456026	.	A	T	2	2	4	0	0	4	0	0
22	31504546	.	C	A	6	6	12	0	0	12	0	0
22	31513575	.	C	T	0	5	5	0	4	9	0	0
22	31517163	.	A	G	5	4	9	0	1	10	0	0
22	31668049	.	T	C	12	1	13	0	14	27	0	0
22	31671957	.	T	A	19	18	37	0	1	38	0	0
22	31821990	.	G	C	7	7	14	0	0	14	0	0
22	31933332	.	G	A	0	6	6	0	9	15	0	0
22	31933335	.	T	G	6	9	15	0	0	15	0	0
22	31992224	.	G	A	1	4	5	0	4	9	0	0
22	32103392	.	T	C	6	7	13	0	1	14	0	0
22	32106535	.	C	T	5	7	12	0	0	12	0	0
22	34701901	.	G	C	15	15	30	0	3	33	0	0
22	34702200	.	A	G	28	29	57	0	2	59	0	0
22	34706938	.	T	C	28	30	58	0	0	58	0	0
22	34707041	.	A	G	25	1	26	0	13	39	0	0
22	34707062	.	T	G	28	8	36	0	0	36	0	0
22	34707084	.	C	T	23	17	40	0	0	40	0	0
22	34707119	.	G	T	19	19	38	0	1	39	0	0
22	34707272	.	T	A	15	16	31	0	7	38	0	0
22	34707295	.	C	T	11	16	27	0	2	29	0	0
22	34817865	.	C	G	4	2	6	0	0	6	0	0
22	34818012	.	C	A	5	3	8	0	0	8	0	0
22	34843569	.	C	T	1	7	8	0	0	8	0	0
22	34843892	.	C	T	0	5	5	0	1	6	0	0
22	34843910	.	T	C	2	5	7	0	0	7	0	0
22	34843964	.	C	A	0	4	4	0	7	11	0	0
22	34847690	.	A	G	5	2	7	0	1	8	0	0
22	34849054	.	A	C	2	0	2	0	4	6	0	0
22	34854810	.	A	C	4	3	7	0	0	7	0	0
22	34859662	.	C	T	0	5	5	0	3	8	0	0
22	34860946	.	G	A	2	2	4	0	0	4	0	0
22	34870371	.	G	A	4	3	7	0	0	7	0	0
22	34880584	.	C	G	1	3	4	0	0	4	0	0
22	34964031	.	G	A	1	2	3	0	0	3	0	0
22	34989095	.	C	T	1	2	3	0	1	4	0	0
22	35013549	.	A	T	1	3	4	0	1	5	0	0
22	35013675	.	C	T	2	4	6	0	2	8	0	0
22	35013679	.	C	T	2	5	7	0	0	7	0	0
22	35013855	.	A	T	4	2	6	0	0	6	0	0
22	35013856	.	T	G	4	1	5	0	1	6	0	0
22	35014014	.	G	A	1	3	4	0	0	4	0	0
22	35015828	.	C	T	5	7	12	0	0	12	0	0
22	35016177	.	G	A	6	8	14	0	1	15	0	0
22	35016185	.	A	G	6	6	12	0	1	13	0	0
22	35041537	.	T	C	9	10	19	0	1	20	0	0
22	35042857	.	T	C	7	1	8	0	11	19	0	0
22	35049063	.	A	G	8	5	13	0	0	13	0	0
22	35176526	.	C	G	2	0	2	0	16	18	0	0
22	35520343	.	C	T	1	3	4	0	0	4	0	0
22	35520389	.	C	T	3	5	8	0	0	8	0	0
22	35528132	.	T	G	3	0	3	0	2	5	0	0
22	35530470	.	C	T	2	4	6	0	0	6	0	0
22	35530535	.	T	C	2	2	4	0	0	4	0	0
22	35531122	.	G	A	3	3	6	0	0	6	0	0
22	35531376	.	A	G	1	3	4	0	1	5	0	0
22	36505067	.	G	A	3	2	5	0	0	5	0	0
22	36505097	.	A	G	2	3	5	0	0	5	0	0
22	36521415	.	C	T	3	2	5	0	0	5	0	0
22	36521438	.	C	G	2	2	4	0	0	4	0	0
22	36521516	.	G	A	1	3	4	0	0	4	0	0
22	36530090	.	C	T	0	4	4	0	6	10	0	0
22	36530155	.	T	C	2	4	6	0	0	6	0	0
22	36547873	.	C	T	2	3	5	0	0	5	0	0
22	36592638	.	T	C	6	2	8	0	0	8	0	0
22	36592878	.	T	C	3	3	6	0	1	7	0	0
22	36598190	.	C	T	5	3	8	0	0	8	0	0
22	36616814	.	G	A	0	2	2	0	4	6	0	0
22	36676056	.	G	C	23	31	54	0	2	56	0	0
22	36679390	.	G	A	29	28	57	0	3	60	0	0
22	36683803	.	C	A	27	14	41	0	1	42	0	0
22	36685729	.	C	T	32	22	54	2	1	57	0	0
22	36686828	.	G	A	25	20	45	2	3	51	1	0
22	36686867	.	G	A	32	19	51	0	0	51	0	0
22	36686870	.	A	G	31	16	47	0	3	50	0	0
22	36686948	.	G	T	26	24	50	0	6	56	0	0
22	36687328	.	G	A	27	21	48	1	3	52	0	0
22	36687403	.	G	A	25	29	54	0	1	55	0	0
22	36687541	.	T	C	21	19	40	0	4	44	0	0
22	36687616	.	C	T	2	33	35	0	21	56	0	0
22	36690668	.	T	A	29	18	47	0	0	47	0	0
22	36741381	.	G	C	1	2	3	0	0	3	0	0
22	36741467	.	T	C	2	0	2	0	4	6	0	0
22	36749724	.	C	G	2	2	4	0	0	4	0	0
22	36750518	.	G	A	3	4	7	0	0	7	0	0
22	36755371	.	T	G	1	0	1	0	1	2	0	0
22	36755458	.	A	T	1	2	3	0	0	4	1	0
22	36755554	.	A	C	3	4	7	0	0	7	0	0
22	36755641	.	C	T	2	3	5	0	0	5	0	0
22	36755751	.	A	T	5	6	11	0	0	11	0	0
22	36755831	.	G	A	3	5	8	0	1	9	0	0
22	36755963	.	G	C	5	0	5	0	6	11	0	0
22	36756112	.	A	G	8	5	13	0	1	14	0	0
22	36756325	.	G	A	4	5	9	0	0	9	0	0
22	36756333	.	T	C	5	2	7	0	1	8	0	0
22	36756400	.	C	T	14	2	16	0	1	17	0	0
22	36756404	.	G	C	15	4	19	0	0	19	0	0
22	36756464	.	T	A	4	10	14	0	0	14	0	0
22	36757155	.	A	C	7	0	7	0	5	12	0	0
22	36768060	.	C	T	0	3	3	2	7	12	0	0
22	36768102	.	G	A	2	8	10	0	0	10	0	0
22	36795845	.	G	T	8	11	19	0	2	21	0	0
22	36798416	.	G	A	2	11	13	0	0	13	0	0
22	36800981	.	G	C	7	9	16	0	1	17	0	0
22	36801611	.	C	T	0	2	2	0	2	4	0	0
22	36801929	.	T	A	3	5	8	0	1	9	0	0
22	36802034	.	A	T	4	3	7	0	0	7	0	0
22	36802185	.	A	G	4	2	6	1	0	7	0	0
22	36802765	.	T	G	2	4	6	0	0	6	0	0
22	36802898	.	G	A	6	3	9	0	0	9	0	0
22	36802928	.	C	T	0	2	2	0	5	7	0	0
22	36802988	.	A	T	4	4	8	0	0	8	0	0
22	36803075	.	G	T	2	2	4	0	1	5	0	0
22	36803414	.	G	T	2	2	4	0	0	4	0	0
22	36803501	.	T	C	5	3	8	0	0	8	0	0
22	36803531	.	G	A	7	5	12	0	0	12	0	0
22	36803561	.	A	G	3	5	8	0	0	8	0	0
22	36805515	.	G	C	4	6	10	0	2	12	0	0
22	36820464	.	C	T	0	4	4	0	5	9	0	0
22	36820470	.	A	G	5	4	9	0	0	9	0	0
22	36836043	.	T	A	3	4	7	0	0	7	0	0
22	36875581	.	T	C	3	13	16	0	1	17	0	0
22	36875584	.	A	G	4	1	5	0	12	17	0	0
22	36877484	.	G	T	12	9	21	0	0	21	0	0
22	36877531	.	G	A	1	4	5	0	6	11	0	0
22	36877534	.	G	T	0	4	4	0	6	10	0	0
22	36877963	.	G	A	8	6	14	0	0	14	0	0
22	36878044	.	T	A	10	10	20	0	2	22	0	0
22	36879468	.	G	T	16	7	23	0	0	23	0	0
22	36879483	.	C	T	14	7	21	0	1	22	0	0
22	36882150	.	G	A	14	11	25	0	0	25	0	0
22	36882168	.	G	A	1	13	14	0	8	22	0	0
22	36882189	.	G	A	2	12	14	0	6	20	0	0
22	36882388	.	T	C	8	13	21	0	0	21	0	0
22	36882409	.	T	A	7	8	15	0	4	19	0	0
22	36885065	.	T	G	9	0	9	0	6	15	0	0
22	36887954	.	C	T	14	6	20	0	0	20	0	0
22	36888623	.	A	G	12	12	24	0	1	25	0	0
22	36891142	.	G	A	8	12	20	1	2	23	0	0
22	36893330	.	T	C	11	11	22	0	1	23	0	0
22	36893357	.	G	A	9	15	24	0	2	26	0	0
22	36894316	.	T	A	10	10	20	0	2	22	0	0
22	36894410	.	A	C	8	16	24	0	0	24	0	0
22	36896641	.	G	A	3	14	17	0	7	24	0	0
22	36896677	.	G	T	10	12	22	0	1	23	0	0
22	36899269	.	C	T	15	20	35	0	1	36	0	0
22	36899483	.	G	A	1	4	5	0	7	12	0	0
22	36899611	.	C	A	3	5	8	0	0	8	0	0
22	36899621	.	A	T	5	2	7	0	1	8	0	0
22	36947793	.	T	A	7	8	15	0	0	15	0	0
22	36947836	.	C	A	4	7	11	0	0	11	0	0
22	36947849	.	G	A	3	6	9	0	0	9	0	0
22	36947879	.	G	C	6	9	15	0	0	15	0	0
22	36947997	.	A	G	9	10	19	0	0	19	0	0
22	36948052	.	T	G	6	6	12	0	0	12	0	0
22	36948133	.	G	A	4	5	9	1	0	10	0	0
22	36948134	.	C	T	4	4	8	1	1	10	0	0
22	36948202	.	C	A	4	4	8	0	1	9	0	0
22	36948312	.	C	T	0	3	3	0	7	10	0	0
22	36948395	.	T	C	9	0	9	0	10	19	0	0
22	36970952	.	G	C	2	4	6	0	0	6	0	0
22	36988248	.	C	T	4	1	5	0	1	6	0	0
22	37000107	.	T	A	4	1	5	0	1	6	0	0
22	37002533	.	G	A	2	3	5	0	0	5	0	0
22	37276635	.	T	C	4	0	4	0	8	12	0	0
22	37278283	.	A	T	4	2	6	0	1	7	0	0
22	37278475	.	A	G	12	9	21	0	0	21	0	0
22	37278479	.	T	C	10	0	10	0	9	19	0	0
22	37278634	.	C	T	21	19	40	0	3	43	0	0
22	37352700	.	C	G	20	20	40	0	2	43	1	0
22	37542836	.	C	A	2	6	8	0	1	9	0	0
22	37543070	.	A	T	11	9	20	0	0	20	0	0
22	37543457	.	A	G	10	11	21	0	2	23	0	0
22	37551481	.	G	C	14	1	15	0	11	26	0	0
22	37551496	.	T	C	11	1	12	0	12	24	0	0
22	37552717	.	G	A	9	12	21	0	0	21	0	0
22	37552783	.	A	C	10	1	11	0	15	26	0	0
22	37553015	.	C	T	1	3	4	0	8	12	0	0
22	37557531	.	G	A	17	11	28	0	1	29	0	0
22	37558433	.	C	T	0	6	6	0	6	12	0	0
22	37559603	.	G	A	6	6	12	0	2	14	0	0
22	37561609	.	G	A	7	3	10	0	1	11	0	0
22	37561642	.	C	G	8	5	13	0	1	14	0	0
22	37588622	.	T	C	9	0	9	0	6	15	0	0
22	37588667	.	A	C	7	11	18	0	1	19	0	0
22	37588715	.	T	C	7	5	12	0	4	16	0	0
22	37589898	.	A	T	10	3	13	3	0	16	0	0
22	37590171	.	C	T	3	2	5	1	0	6	0	0
22	37590339	.	A	T	9	9	18	0	0	18	0	0
22	37590535	.	C	T	8	6	14	0	0	14	0	0
22	37590710	.	T	G	4	4	8	0	0	8	0	0
22	37590711	.	C	T	4	4	8	0	0	8	0	0
22	37590925	.	T	C	5	12	17	0	1	18	0	0
22	37591023	.	A	C	3	5	8	0	0	8	0	0
22	37591491	.	A	T	8	5	13	0	0	13	0	0
22	37596906	.	C	T	5	10	15	0	0	15	0	0
22	37599007	.	C	A	8	7	15	0	1	16	0	0
22	37599058	.	G	A	6	3	9	0	1	10	0	0
22	37599076	.	A	G	3	6	9	0	0	9	0	0
22	37602190	.	C	T	0	5	5	0	5	10	0	0
22	37602479	.	A	C	4	4	8	0	0	8	0	0
22	37608435	.	T	C	2	0	2	0	3	5	0	0
22	37608465	.	G	A	3	2	5	0	0	5	0	0
22	37609996	.	G	A	6	6	12	0	0	12	0	0
22	37610001	.	T	C	5	5	10	0	0	10	0	0
22	37610043	.	C	T	0	6	6	0	3	9	0	0
22	37611298	.	T	G	3	3	6	0	2	8	0	0
22	37611394	.	A	G	1	4	5	0	1	6	0	0
22	37611407	.	T	C	1	5	6	0	0	6	0	0
22	37611498	.	A	G	3	4	7	0	0	7	0	0
22	37611657	.	A	G	4	2	6	0	0	6	0	0
22	37635796	.	C	G	7	10	17	0	0	17	0	0
22	37639239	.	C	T	11	9	20	0	0	20	0	0
22	37639311	.	C	T	12	11	23	0	0	23	0	0
22	37641741	.	G	A	16	5	21	0	1	22	0	0
22	37644009	.	C	A	16	17	33	0	2	35	0	0
22	37644021	.	C	G	19	18	37	0	0	37	0	0
22	37644048	.	A	G	10	18	28	0	2	30	0	0
22	37645990	.	T	C	14	16	30	0	0	30	0	0
22	37646124	.	C	T	16	19	35	0	1	36	0	0
22	37646226	.	T	A	17	22	39	0	3	42	0	0
22	37652191	.	C	T	18	14	32	0	3	35	0	0
22	37652925	.	C	T	16	8	24	0	1	25	0	0
22	37655702	.	C	T	13	6	19	0	0	19	0	0
22	37697408	.	C	T	14	11	25	0	3	28	0	0
22	37708199	.	T	A	24	18	42	0	1	43	0	0
22	37710178	.	G	T	21	15	36	0	2	38	0	0
22	37712570	.	A	G	13	0	13	0	19	32	0	0
22	37716493	.	G	C	16	11	27	0	0	27	0	0
22	37738162	.	C	T	1	4	5	0	8	13	0	0
22	37738195	.	C	T	4	4	8	0	0	8	0	0
22	37746900	.	G	C	1	7	8	0	0	8	0	0
22	37746901	.	G	A	1	6	7	0	1	8	0	0
22	37751709	.	A	G	1	5	6	0	0	6	0	0
22	37773189	.	C	T	1	3	4	0	7	11	0	0
22	37805329	.	C	T	18	21	39	1	0	40	0	0
22	37823332	.	C	A	1	19	20	0	14	34	0	0
22	37875270	.	T	C	2	5	7	0	1	8	0	0
22	37881620	.	C	G	1	0	1	0	3	4	0	0
22	37951706	.	A	G	2	4	6	0	0	6	0	0
22	37951790	.	G	C	1	2	3	0	1	4	0	0
22	37952126	.	G	A	1	2	3	0	0	3	0	0
22	37995706	.	C	T	2	2	4	0	0	4	0	0
22	38001504	.	G	A	4	5	9	0	0	9	0	0
22	38005162	.	C	G	0	2	2	0	1	3	0	0
22	38014726	.	T	C	2	4	6	0	0	6	0	0
22	38016901	.	G	C	3	3	6	0	0	6	0	0
22	38026190	.	G	T	3	2	5	0	0	5	0	0
22	38028903	.	A	G	2	3	5	0	0	5	0	0
22	38029013	.	T	C	5	5	10	0	1	11	0	0
22	38030803	.	C	T	1	2	3	0	1	4	0	0
22	38030812	.	C	T	1	2	3	0	0	3	0	0
22	38034290	.	T	G	1	4	5	0	0	5	0	0
22	38034547	.	G	T	3	2	5	0	0	5	0	0
22	38034577	.	A	T	1	3	4	0	1	5	0	0
22	38037578	.	A	T	4	12	16	0	0	16	0	0
22	38037603	.	G	T	4	7	11	0	0	11	0	0
22	38040050	.	G	A	0	9	9	0	6	15	0	0
22	38040070	.	T	G	10	6	16	0	0	16	0	0
22	38044902	.	G	C	0	12	12	0	3	15	0	0
22	38168007	.	T	A	1	2	3	0	0	3	0	0
22	38178747	.	G	A	4	3	7	0	1	8	0	0
22	38183762	.	C	T	2	6	8	0	0	8	0	0
22	38186385	.	C	A	3	8	11	0	0	11	0	0
22	38191136	.	G	A	3	8	11	0	0	11	0	0
22	38191168	.	C	G	10	5	15	0	0	15	0	0
22	38191715	.	A	G	9	6	15	0	1	16	0	0
22	38191718	.	T	A	7	10	17	0	0	17	0	0
22	38192440	.	A	G	9	6	15	0	0	15	0	0
22	38194106	.	C	T	14	13	27	0	1	28	0	0
22	38194415	.	A	G	16	14	30	0	0	30	0	0
22	38194419	.	G	C	17	15	32	0	0	32	0	0
22	38195217	.	G	A	19	8	27	1	1	29	0	0
22	38197777	.	C	T	32	25	57	0	1	58	0	0
22	38197783	.	G	C	31	26	57	0	1	58	0	0
22	38202898	.	T	C	8	9	17	0	1	18	0	0
22	38202904	.	C	T	9	9	18	0	0	18	0	0
22	38205099	.	C	T	1	7	8	0	8	16	0	0
22	38207031	.	G	A	7	5	12	0	0	12	0	0
22	38207367	.	T	A	5	3	8	0	0	8	0	0
22	38209190	.	C	T	3	4	7	0	0	7	0	0
22	38209295	.	A	G	2	5	7	0	0	7	0	0
22	38211271	.	C	A	0	5	5	0	1	6	0	0
22	38211350	.	A	G	2	3	5	0	0	5	0	0
22	38216690	.	G	T	2	3	5	0	0	5	0	0
22	38217308	.	G	C	1	0	1	0	5	6	0	0
22	38280834	.	T	G	2	0	2	0	7	10	1	0
22	38283993	.	A	G	9	7	16	0	1	17	0	0
22	38284020	.	A	C	8	11	19	0	0	19	0	0
22	38289964	.	T	C	6	8	14	0	1	15	0	0
22	38289982	.	T	C	5	8	13	0	0	13	0	0
22	38290307	.	G	A	8	9	17	0	0	17	0	0
22	38424119	.	C	G	1	4	5	0	0	5	0	0
22	38468249	.	C	A	11	2	13	1	1	15	0	0
22	38468250	.	A	T	12	2	14	1	0	15	0	0
22	38475593	.	A	G	32	23	55	0	0	55	0	0
22	38475664	.	A	T	34	9	43	0	1	44	0	0
22	38475676	.	G	A	26	12	38	0	0	38	0	0
22	38492116	.	G	A	22	26	48	0	3	51	0	0
22	38496335	.	A	G	14	25	39	0	0	39	0	0
22	38499727	.	C	T	0	26	26	1	15	42	0	0
22	38501815	.	G	C	24	11	35	0	3	38	0	0
22	38507937	.	C	T	17	12	29	0	3	32	0	0
22	38508006	.	C	A	20	17	37	0	2	39	0	0
22	38508018	.	C	A	22	16	38	0	0	38	0	0
22	38508100	.	C	T	11	21	32	1	0	33	0	0
22	38508102	.	C	T	11	22	33	1	0	34	0	0
22	38516814	.	A	T	15	20	35	0	0	35	0	0
22	38516816	.	C	T	15	20	35	0	1	36	0	0
22	38516899	.	G	A	5	9	14	0	0	14	0	0
22	38520336	.	A	C	12	0	12	0	5	17	0	0
22	38520360	.	A	C	8	5	13	0	1	14	0	0
22	38520867	.	A	T	8	16	24	0	0	24	0	0
22	38521353	.	G	C	14	10	24	0	1	25	0	0
22	38521454	.	C	A	4	10	14	0	0	14	0	0
22	38521596	.	C	G	2	9	11	1	1	13	0	0
22	38521683	.	A	T	16	19	35	0	0	35	0	0
22	38521841	.	C	T	2	2	4	0	0	4	0	0
22	38521883	.	C	A	4	4	8	0	1	9	0	0
22	38522271	.	G	T	18	8	26	0	3	30	1	0
22	38522468	.	C	T	4	5	9	0	1	10	0	0
22	38522471	.	T	A	4	5	9	0	0	9	0	0
22	38522622	.	G	C	13	11	24	0	1	25	0	0
22	38523540	.	T	A	10	13	23	0	1	24	0	0
22	38523917	.	C	A	1	8	9	0	9	18	0	0
22	38523941	.	T	C	12	10	22	0	0	22	0	0
22	38524033	.	T	C	12	8	20	0	0	20	0	0
22	38524099	.	C	T	3	8	11	0	0	11	0	0
22	38524107	.	C	T	10	3	13	0	0	13	0	0
22	38524304	.	T	A	11	10	21	0	1	22	0	0
22	38524322	.	G	A	5	10	15	0	0	15	0	0
22	38524544	.	A	G	7	9	16	0	1	17	0	0
22	38524621	.	G	C	18	9	27	0	1	28	0	0
22	38524721	.	T	C	11	1	12	0	5	17	0	0
22	38525003	.	C	T	1	7	8	0	8	16	0	0
22	38525326	.	T	G	7	9	16	0	0	16	0	0
22	38525996	.	G	T	5	13	18	0	0	18	0	0
22	38526033	.	A	G	9	8	17	0	0	17	0	0
22	38541489	.	C	T	1	10	11	0	12	23	0	0
22	38543597	.	C	G	12	8	20	1	2	23	0	0
22	38549152	.	G	A	11	6	17	0	2	19	0	0
22	38549990	.	A	G	10	16	26	0	1	27	0	0
22	38550922	.	T	C	10	7	17	0	0	17	0	0
22	38559907	.	A	G	13	10	23	0	1	24	0	0
22	38567348	.	C	T	1	9	10	0	8	18	0	0
22	38615186	.	T	A	4	2	6	1	0	7	0	0
22	38615220	.	T	G	5	4	9	0	1	10	0	0
22	38617884	.	G	A	14	6	20	0	1	21	0	0
22	38621256	.	A	T	7	7	14	0	0	14	0	0
22	38621418	.	G	T	4	2	6	0	0	6	0	0
22	38796652	.	A	T	6	7	13	0	1	14	0	0
22	38796656	.	T	A	1	9	10	0	1	11	0	0
22	38796811	.	T	C	7	0	7	0	5	12	0	0
22	38798816	.	T	C	3	0	3	0	6	9	0	0
22	38800038	.	T	A	3	3	6	0	1	7	0	0
22	38801483	.	C	T	1	3	4	0	0	4	0	0
22	38899717	.	A	G	3	0	3	0	3	6	0	0
22	38911481	.	G	A	0	3	3	0	2	5	0	0
22	38911514	.	C	T	2	5	7	0	0	7	0	0
22	38911553	.	T	G	2	0	2	0	4	6	0	0
22	38911814	.	G	T	2	2	4	0	0	4	0	0
22	38912602	.	T	A	1	2	3	0	0	3	0	0
22	38912605	.	T	A	1	2	3	0	0	3	0	0
22	38912723	.	G	A	2	2	4	0	0	4	0	0
22	38912747	.	A	G	1	2	3	0	0	3	0	0
22	38915071	.	T	A	10	6	16	0	0	16	0	0
22	38919010	.	A	C	4	3	7	0	1	8	0	0
22	38919290	.	A	C	5	3	8	0	0	8	0	0
22	38919325	.	G	T	0	5	5	0	3	8	0	0
22	38919354	.	G	C	4	3	7	0	0	7	0	0
22	38919752	.	C	T	3	2	5	0	0	5	0	0
22	38928275	.	T	A	8	11	19	0	0	19	0	0
22	38928367	.	G	C	1	2	3	0	6	9	0	0
22	38928450	.	A	T	5	3	8	0	1	9	0	0
22	38928517	.	T	A	7	3	10	0	0	10	0	0
22	38928586	.	G	A	6	5	11	0	0	11	0	0
22	38928593	.	G	T	7	6	13	0	0	13	0	0
22	38928738	.	G	A	1	5	6	0	0	6	0	0
22	38928979	.	T	G	1	8	9	0	0	9	0	0
22	38929002	.	T	C	2	6	8	0	0	8	0	0
22	38929112	.	T	C	9	5	14	0	0	14	0	0
22	38932288	.	G	A	17	12	29	0	2	31	0	0
22	38934663	.	C	T	6	16	22	0	0	22	0	0
22	38934759	.	T	C	12	0	12	1	8	21	0	0
22	38942981	.	A	T	2	4	6	0	2	8	0	0
22	38943059	.	T	C	8	5	13	0	0	13	0	0
22	38943113	.	T	C	2	6	8	0	0	8	0	0
22	38943160	.	G	A	2	4	6	0	5	11	0	0
22	38945312	.	C	T	12	3	15	0	0	15	0	0
22	38945316	.	A	C	12	3	15	0	0	15	0	0
22	38945420	.	T	C	5	2	7	0	0	7	0	0
22	38945546	.	A	G	2	3	5	0	0	5	0	0
22	38945937	.	C	T	2	4	6	0	0	6	0	0
22	38946148	.	G	C	2	2	4	0	0	4	0	0
22	38946246	.	T	A	3	6	9	0	0	9	0	0
22	38946287	.	A	G	4	2	6	0	0	6	0	0
22	38946553	.	T	C	7	9	16	0	2	18	0	0
22	38946576	.	T	C	8	11	19	0	1	20	0	0
22	38946608	.	A	C	8	13	21	0	0	21	0	0
22	38946953	.	T	A	22	8	30	0	0	30	0	0
22	38951084	.	T	C	14	12	26	0	1	27	0	0
22	38951130	.	A	T	13	12	25	0	0	25	0	0
22	38951137	.	C	A	13	10	23	0	0	23	0	0
22	38990652	.	C	A	3	3	6	0	0	6	0	0
22	39015203	.	A	T	5	8	13	0	1	14	0	0
22	39015567	.	A	G	8	4	12	0	0	12	0	0
22	39017130	.	G	A	0	5	5	0	7	12	0	0
22	39023318	.	G	C	1	5	6	0	4	10	0	0
22	39023435	.	A	G	5	2	7	0	0	7	0	0
22	39023501	.	T	C	6	3	9	0	0	9	0	0
22	39023680	.	C	A	12	10	22	0	0	22	0	0
22	39026706	.	T	C	8	7	15	0	0	15	0	0
22	39027520	.	A	C	7	3	10	0	0	10	0	0
22	39028350	.	G	A	0	5	5	0	5	10	0	0
22	39028700	.	T	G	8	0	8	0	13	21	0	0
22	39032738	.	C	A	8	5	13	0	1	14	0	0
22	39032814	.	A	G	10	9	19	0	0	19	0	0
22	39032925	.	A	G	5	3	8	0	1	9	0	0
22	39033134	.	C	T	12	9	21	0	0	21	0	0
22	39033332	.	A	G	10	0	10	0	9	19	0	0
22	39033637	.	C	G	8	6	14	0	1	15	0	0
22	39033644	.	T	C	6	8	14	0	1	15	0	0
22	39033838	.	T	G	4	2	6	0	0	6	0	0
22	39054209	.	A	G	7	5	12	0	1	13	0	0
22	39054260	.	A	C	6	7	13	0	0	13	0	0
22	39054270	.	G	A	3	6	9	0	0	9	0	0
22	39054510	.	G	A	1	6	7	0	0	7	0	0
22	39076602	.	C	T	9	12	21	0	0	21	0	0
22	39077407	.	C	G	17	1	18	0	10	28	0	0
22	39079335	.	G	A	1	12	13	0	9	22	0	0
22	39079356	.	A	C	8	6	14	0	3	17	0	0
22	39079379	.	C	A	15	10	25	1	0	26	0	0
22	39079428	.	C	G	15	8	23	1	0	24	0	0
22	39079470	.	G	A	0	10	10	4	10	24	0	0
22	39079528	.	T	A	4	14	18	0	0	18	0	0
22	39079950	.	C	A	14	12	26	0	0	26	0	0
22	39080035	.	C	G	15	7	22	0	2	24	0	0
22	39080043	.	G	C	15	8	23	0	0	23	0	0
22	39080290	.	C	T	7	11	18	0	3	21	0	0
22	39080402	.	A	C	9	10	19	0	0	19	0	0
22	39080547	.	A	C	9	12	21	0	1	22	0	0
22	39080679	.	C	G	10	14	24	0	0	24	0	0
22	39080701	.	C	A	14	14	28	0	0	28	0	0
22	39081126	.	A	T	12	10	22	0	1	23	0	0
22	39084966	.	A	T	10	13	23	0	2	25	0	0
22	39096080	.	C	A	7	2	9	0	0	9	0	0
22	39096117	.	A	C	4	4	8	0	0	8	0	0
22	39100984	.	C	T	8	3	11	0	0	11	0	0
22	39104849	.	G	A	1	6	7	0	0	7	0	0
22	39105022	.	T	C	8	5	13	0	1	14	0	0
22	39107877	.	G	A	1	2	3	0	0	3	0	0
23	16928	.	G	A	3	3	6	0	0	6	0	0
23	16943	.	C	G	0	2	2	0	2	4	0	0
23	252280	.	T	C	5	0	5	0	3	8	0	0
23	252305	.	T	C	3	2	5	0	1	6	0	0
23	585657	.	A	G	7	0	7	0	9	16	0	0
23	585825	.	A	G	5	10	15	0	1	16	0	0
23	587161	.	A	G	10	11	21	0	0	21	0	0
23	587398	.	A	G	10	0	10	0	9	19	0	0
23	863395	.	T	C	5	3	8	0	0	8	0	0
23	863712	.	T	A	6	4	10	0	0	10	0	0
23	863715	.	G	A	6	4	10	0	0	10	0	0
23	1719384	.	A	G	4	6	10	0	1	11	0	0
23	1723720	.	A	G	8	0	8	0	10	18	0	0
23	1723748	.	G	A	11	7	18	0	1	19	0	0
23	1723992	.	C	T	13	8	21	0	0	21	0	0
23	1725456	.	T	C	9	8	17	0	0	17	0	0
23	1725664	.	G	A	7	2	9	0	1	10	0	0
23	1725959	.	C	T	11	4	15	0	0	15	0	0
23	1725974	.	T	A	11	9	20	0	0	20	0	0
23	1726080	.	T	C	16	5	21	0	0	21	0	0
23	1726467	.	T	A	4	5	9	0	0	9	0	0
23	2053414	.	A	G	2	4	6	0	0	6	0	0
23	2053418	.	C	A	2	4	6	0	0	6	0	0
23	2054010	.	C	T	9	14	23	0	2	25	0	0
23	2054175	.	G	A	10	8	18	0	0	18	0	0
23	2054316	.	C	G	9	7	16	0	0	16	0	0
23	2054505	.	G	A	11	8	19	0	0	19	0	0
23	2054584	.	G	C	5	6	11	0	1	12	0	0
23	2054613	.	A	G	4	7	11	0	0	11	0	0
23	2054622	.	T	C	3	0	3	0	6	9	0	0
23	2054760	.	G	A	11	4	15	0	0	15	0	0
23	2054838	.	C	T	0	7	7	0	3	10	0	0
23	2054952	.	T	G	5	11	16	0	1	17	0	0
23	2055162	.	G	A	8	8	16	0	0	16	0	0
23	2055219	.	T	C	6	12	18	0	1	19	0	0
23	2081004	.	T	G	5	4	9	0	0	9	0	0
23	2099158	.	A	G	9	9	18	0	0	18	0	0
23	2099214	.	A	G	7	9	16	0	0	16	0	0
23	2136417	.	T	C	12	6	18	0	1	19	0	0
23	2155134	.	T	C	11	7	18	0	0	18	0	0
23	2158054	.	T	C	10	8	18	0	2	20	0	0
23	2160242	.	T	C	7	5	12	0	0	12	0	0
23	2192341	.	T	A	2	2	4	0	0	4	0	0
23	2216245	.	G	A	2	3	5	0	0	5	0	0
23	2216256	.	T	A	2	3	5	0	0	5	0	0
23	2216281	.	C	T	1	2	3	0	0	3	0	0
23	2224276	.	T	A	2	3	5	0	0	5	0	0
23	2242494	.	T	C	3	2	5	0	0	5	0	0
23	2246536	.	G	A	2	5	7	0	0	7	0	0
23	2249537	.	A	G	1	1	2	0	1	3	0	0
23	2249589	.	G	A	0	6	6	0	3	9	0	0
23	2249633	.	T	C	1	4	5	0	1	6	0	0
23	2252812	.	G	A	4	6	10	0	0	10	0	0
23	2256142	.	G	C	3	4	7	0	0	7	0	0
23	2256348	.	C	T	4	4	8	0	0	8	0	0
23	2256349	.	A	T	4	4	8	0	0	8	0	0
23	2256422	.	A	T	2	5	7	0	0	7	0	0
23	2361516	.	A	G	15	9	24	1	0	25	0	0
23	2391852	.	G	A	1	14	15	0	18	33	0	0
23	2435776	.	G	A	23	22	45	0	0	45	0	0
23	2438388	.	G	A	24	21	45	0	0	45	0	0
23	2438463	.	G	T	3	19	22	0	13	35	0	0
23	2438641	.	A	T	22	23	45	0	2	48	1	0
23	2440698	.	G	A	19	21	40	0	1	41	0	0
23	2443160	.	C	T	18	20	38	0	1	39	0	0
23	2443613	.	C	T	13	18	31	0	0	31	0	0
23	2443772	.	T	C	7	3	10	0	0	10	0	0
23	2443782	.	T	C	6	3	9	0	0	9	0	0
23	2542247	.	T	A	5	9	14	0	0	15	1	0
23	2547556	.	A	C	9	9	18	1	1	20	0	0
23	2564339	.	T	A	22	18	40	3	1	45	1	0
23	2564420	.	T	C	19	19	38	0	1	39	0	0
23	2679634	.	G	A	1	13	14	22	7	43	0	0
23	2689807	.	T	C	13	19	32	0	4	36	0	0
23	2690659	.	C	T	17	23	40	0	3	43	0	0
23	2703243	.	T	A	11	6	17	0	2	19	0	0
23	2712360	.	G	A	1	10	11	0	1	12	0	0
23	2716519	.	C	A	4	8	12	0	0	12	0	0
23	2717852	.	A	C	25	16	41	0	2	43	0	0
23	2717867	.	T	G	23	12	35	0	3	38	0	0
23	2718009	.	C	G	15	17	32	0	1	33	0	0
23	2721539	.	A	G	17	14	31	0	1	32	0	0
23	2725095	.	A	C	9	13	22	0	0	22	0	0
23	2757841	.	C	T	12	9	21	0	1	22	0	0
23	2757876	.	T	A	11	8	19	0	2	21	0	0
23	2762007	.	A	G	9	5	14	0	1	15	0	0
23	2762855	.	G	A	5	2	7	0	1	8	0	0
23	2767194	.	G	A	1	9	10	1	10	21	0	0
23	2767227	.	C	T	10	5	15	1	1	17	0	0
23	2773310	.	C	T	15	4	19	0	1	20	0	0
23	2774812	.	G	A	6	21	27	0	0	27	0	0
23	2775033	.	G	A	6	5	11	0	0	11	0	0
23	2777534	.	G	A	4	9	13	0	0	13	0	0
23	2837155	.	T	C	7	12	19	0	1	20	0	0
23	2837188	.	C	T	9	12	21	0	0	21	0	0
23	2837218	.	T	C	12	10	22	0	0	22	0	0
23	2839156	.	G	T	2	9	11	0	9	20	0	0
23	2842292	.	G	T	0	10	10	0	9	19	0	0
23	2842407	.	C	A	8	7	15	0	1	16	0	0
23	2842409	.	G	A	9	7	16	0	0	16	0	0
23	2849307	.	G	A	0	7	7	0	7	14	0	0
23	2860937	.	T	G	10	0	10	0	6	16	0	0
23	2861990	.	C	T	10	21	31	0	1	32	0	0
23	2864186	.	A	T	10	13	23	0	0	23	0	0
23	2870732	.	T	A	12	17	29	0	0	29	0	0
23	2871264	.	C	T	7	4	11	0	0	11	0	0
23	2871699	.	G	A	12	12	24	0	0	24	0	0
23	2871908	.	A	G	16	5	21	0	0	21	0	0
23	2871994	.	T	C	10	12	22	0	1	23	0	0
23	2872206	.	T	C	12	18	30	0	0	30	0	0
23	2872338	.	T	G	23	0	23	0	11	34	0	0
23	2872517	.	G	T	21	21	42	0	1	43	0	0
23	2873327	.	A	T	5	10	15	0	0	15	0	0
23	2877144	.	C	T	3	5	8	0	4	12	0	0
23	2877519	.	T	C	9	0	9	0	8	17	0	0
23	2877603	.	A	C	10	5	15	0	0	15	0	0
23	2877792	.	C	A	0	2	2	0	5	7	0	0
23	2877930	.	T	C	8	5	13	0	0	13	0	0
23	2878041	.	C	A	1	7	8	0	10	18	0	0
23	2878401	.	A	G	4	3	7	0	0	7	0	0
23	2878629	.	T	G	7	5	12	0	1	13	0	0
23	2878630	.	A	C	7	5	12	0	1	13	0	0
23	2879235	.	A	G	5	2	7	0	1	8	0	0
23	2879618	.	A	G	3	4	7	0	1	8	0	0
23	2880272	.	G	T	3	3	6	0	0	6	0	0
23	2906312	.	A	G	10	8	18	0	1	19	0	0
23	2914612	.	A	G	3	0	3	0	5	8	0	0
23	2914789	.	C	A	4	6	10	0	0	10	0	0
23	2917463	.	T	C	8	8	16	0	1	17	0	0
23	2919264	.	A	G	5	1	6	0	11	17	0	0
23	2919276	.	T	C	2	7	9	0	1	10	0	0
23	2920448	.	C	T	3	4	7	0	0	7	0	0
23	2920588	.	G	T	2	5	7	0	4	11	0	0
23	2920603	.	T	C	4	6	10	0	1	11	0	0
23	2920753	.	G	A	7	6	13	0	0	13	0	0
23	2923068	.	G	A	0	6	6	0	4	10	0	0
23	2925086	.	T	C	12	3	15	0	0	15	0	0
23	2925137	.	C	T	5	10	15	0	1	16	0	0
23	2925238	.	A	T	8	3	11	0	0	11	0	0
23	2925357	.	T	C	4	5	9	0	0	9	0	0
23	2927117	.	A	G	6	8	14	0	1	15	0	0
23	2927144	.	A	G	8	9	17	0	2	19	0	0
23	2927175	.	C	T	9	11	20	0	0	20	0	0
23	2929180	.	A	G	5	7	12	0	1	13	0	0
23	2931288	.	T	A	7	4	11	0	0	11	0	0
23	2931321	.	G	A	7	3	10	0	0	10	0	0
23	2931329	.	C	A	7	5	12	0	0	12	0	0
23	2931358	.	C	T	9	5	14	0	0	14	0	0
23	2931409	.	C	T	16	8	24	0	0	24	0	0
23	2931461	.	A	G	4	0	4	0	10	14	0	0
23	2931732	.	C	A	3	9	12	0	0	12	0	0
23	2931836	.	C	A	6	7	13	0	0	13	0	0
23	2931970	.	T	A	10	8	18	0	0	18	0	0
23	2932241	.	A	T	7	6	13	0	0	13	0	0
23	3406094	.	C	A	7	5	12	0	0	12	0	0
23	3406708	.	T	C	9	8	17	0	0	17	0	0
23	3406729	.	A	G	8	10	18	0	1	19	0	0
23	3406811	.	T	C	8	19	27	0	0	27	0	0
23	3406950	.	T	G	3	6	9	0	0	9	0	0
23	3407285	.	T	A	6	21	27	0	4	31	0	0
23	3407305	.	C	A	8	20	28	0	0	28	0	0
23	3503614	.	C	A	4	7	11	1	0	13	1	0
23	3503622	.	A	G	3	8	11	1	0	12	0	0
23	3511204	.	C	A	5	4	9	0	1	10	0	0
23	3511291	.	T	C	6	4	10	0	0	10	0	0
23	3517582	.	T	A	5	6	11	0	3	14	0	0
23	3517621	.	T	G	7	4	11	0	0	11	0	0
23	3517734	.	T	G	15	0	15	0	9	24	0	0
23	3517800	.	C	T	3	3	6	0	1	7	0	0
23	3519953	.	A	G	12	0	12	0	13	25	0	0
23	3520120	.	C	T	9	11	20	0	0	20	0	0
23	3653478	.	G	T	23	22	45	0	3	48	0	0
23	3653846	.	T	C	20	26	46	0	1	47	0	0
23	3653859	.	G	A	21	21	42	0	2	44	0	0
23	3653953	.	T	A	15	11	26	0	1	27	0	0
23	3654034	.	A	G	13	13	26	0	1	27	0	0
23	3654106	.	C	T	1	7	8	0	1	9	0	0
23	3654134	.	A	G	1	5	6	0	0	6	0	0
23	3654356	.	C	T	11	13	24	0	1	25	0	0
23	3654490	.	A	C	16	19	35	0	0	35	0	0
23	3654747	.	C	T	2	24	26	0	21	47	0	0
23	3654774	.	G	A	21	24	45	0	1	46	0	0
23	3654989	.	A	G	29	26	55	0	0	55	0	0
23	3655139	.	T	A	26	18	44	0	2	46	0	0
23	3655207	.	T	G	30	16	46	0	6	52	0	0
23	3655220	.	A	G	33	21	54	0	2	56	0	0
23	3657557	.	T	C	39	24	63	0	0	63	0	0
23	3657602	.	T	C	36	1	37	0	29	66	0	0
23	3660060	.	C	A	5	26	31	0	28	59	0	0
23	3660674	.	A	G	32	29	61	0	1	62	0	0
23	3660713	.	G	A	27	27	54	0	3	57	0	0
23	3662210	.	G	A	27	30	57	0	1	58	0	0
23	3662246	.	C	T	3	36	39	0	23	62	0	0
23	3664306	.	A	G	19	24	43	1	2	47	1	0
23	3667257	.	T	C	30	27	57	0	0	57	0	0
23	3711308	.	C	A	2	5	7	0	0	7	0	0
23	3711949	.	T	G	3	13	16	0	1	17	0	0
23	3712002	.	G	A	6	7	13	0	1	14	0	0
23	3712955	.	G	A	7	2	9	0	0	9	0	0
23	3712973	.	A	C	5	4	9	0	0	9	0	0
23	3712998	.	G	A	3	6	9	0	0	9	0	0
23	3713045	.	T	G	5	7	12	0	0	12	0	0
23	3713098	.	G	A	2	3	5	0	0	5	0	0
23	3713321	.	A	G	10	5	15	0	2	17	0	0
23	3713363	.	A	G	10	11	21	0	1	22	0	0
23	3713388	.	C	T	11	12	23	0	0	23	0	0
23	3713400	.	A	C	12	12	24	0	0	24	0	0
23	3713452	.	T	C	8	9	17	0	1	18	0	0
23	3713453	.	G	A	7	10	17	0	0	17	0	0
23	3713491	.	G	A	10	8	18	0	0	18	0	0
23	3713622	.	A	G	11	12	23	0	1	24	0	0
23	3713643	.	G	A	11	12	23	0	0	23	0	0
23	3713692	.	T	A	8	5	13	0	1	14	0	0
23	3713928	.	A	G	10	6	16	0	0	16	0	0
23	3713968	.	C	T	10	6	16	0	0	16	0	0
23	3740379	.	T	A	6	13	19	0	1	20	0	0
23	3744621	.	C	T	11	8	19	0	2	21	0	0
23	3744654	.	A	C	6	3	9	0	0	9	0	0
23	3751965	.	A	G	22	16	38	0	2	40	0	0
23	3751990	.	A	G	23	21	44	0	0	44	0	0
23	3752305	.	C	G	19	19	38	0	3	41	0	0
23	3752394	.	C	T	2	12	14	0	18	32	0	0
23	3752992	.	T	A	20	18	38	1	2	41	0	0
23	3758554	.	A	C	1	2	3	0	0	3	0	0
23	3758560	.	G	C	2	2	4	0	0	4	0	0
23	3777687	.	G	A	2	1	3	0	0	3	0	0
23	3777694	.	G	T	2	2	4	0	0	4	0	0
23	3777788	.	T	A	2	2	4	0	0	4	0	0
23	3951804	.	T	C	5	6	11	0	1	12	0	0
23	3951942	.	G	C	11	1	12	0	2	14	0	0
23	3951948	.	G	T	12	5	17	0	0	17	0	0
23	3962692	.	A	G	1	2	3	0	0	3	0	0
23	3982480	.	G	A	5	5	10	0	0	10	0	0
23	3982588	.	G	A	4	3	7	0	0	7	0	0
23	3982936	.	G	C	5	0	5	0	6	11	0	0
23	4017626	.	G	A	7	4	11	0	0	11	0	0
23	4063013	.	T	A	4	2	6	0	1	7	0	0
23	4088188	.	T	C	0	1	1	0	2	3	0	0
23	4088361	.	A	G	2	3	5	0	0	5	0	0
23	4090264	.	G	A	1	2	3	0	0	3	0	0
23	4216221	.	G	A	5	2	7	0	0	7	0	0
23	4216241	.	C	T	4	5	9	0	1	10	0	0
23	4216363	.	T	C	7	0	7	0	3	10	0	0
23	4216472	.	C	T	2	5	7	0	0	7	0	0
23	4222119	.	A	G	9	5	14	0	0	14	0	0
23	4222149	.	G	A	9	6	15	0	0	15	0	0
23	4222164	.	G	T	9	5	14	0	0	14	0	0
23	4225038	.	A	G	7	5	12	0	1	13	0	0
23	4225051	.	A	C	7	6	13	0	0	13	0	0
23	4254105	.	G	T	1	31	32	0	25	57	0	0
23	4254192	.	A	C	24	14	38	0	3	41	0	0
23	4255566	.	C	G	29	0	29	0	19	48	0	0
23	4259194	.	A	G	16	28	44	0	1	45	0	0
23	4259369	.	T	G	20	22	42	0	1	43	0	0
23	4259626	.	G	A	13	15	28	0	2	30	0	0
23	4259635	.	G	C	3	14	17	0	12	29	0	0
23	4259674	.	G	T	8	5	13	0	1	14	0	0
23	4260629	.	G	A	14	6	20	0	0	20	0	0
23	4269780	.	C	G	27	19	46	0	0	46	0	0
23	4270928	.	T	C	28	22	50	0	2	52	0	0
23	4271333	.	A	G	25	24	49	0	0	49	0	0
23	4271730	.	G	C	22	8	30	1	1	32	0	0
23	4274411	.	G	T	3	2	5	0	0	5	0	0
23	4274423	.	C	T	3	2	5	0	1	6	0	0
23	4277683	.	A	G	1	2	3	0	1	4	0	0
23	4280198	.	A	C	9	4	13	0	0	13	0	0
23	4280602	.	A	G	2	0	2	0	4	6	0	0
23	4280818	.	G	C	2	5	7	0	5	12	0	0
23	4280821	.	C	T	6	3	9	0	1	10	0	0
23	4289066	.	C	G	12	12	24	0	0	24	0	0
23	4292251	.	C	T	11	13	24	0	1	25	0	0
23	4307737	.	C	T	16	16	32	0	1	33	0	0
23	4307740	.	T	C	15	15	30	0	2	32	0	0
23	4312033	.	T	G	15	10	25	0	0	25	0	0
23	4314691	.	G	A	6	16	22	0	1	23	0	0
23	4353456	.	C	T	1	3	4	0	1	5	0	0
23	4353495	.	G	A	0	3	3	0	1	4	0	0
23	4353498	.	A	C	2	3	5	0	0	5	0	0
23	4356999	.	C	T	4	2	6	0	1	7	0	0
23	4357124	.	T	C	3	2	5	0	0	5	0	0
23	4357457	.	G	C	0	2	2	0	3	5	0	0
23	4357463	.	C	T	3	1	4	0	0	4	0	0
23	4362874	.	T	C	10	3	13	0	1	14	0	0
23	4364914	.	C	T	9	12	21	0	1	22	0	0
23	4392598	.	T	G	3	2	5	0	0	5	0	0
23	4492820	.	C	T	2	3	5	0	2	7	0	0
23	4498728	.	A	T	1	2	3	0	0	3	0	0
23	4502495	.	T	C	1	2	3	0	0	3	0	0
23	4525139	.	A	C	3	3	6	0	0	6	0	0
23	4528318	.	A	G	2	3	5	0	1	6	0	0
23	4538412	.	C	T	1	2	3	0	0	3	0	0
23	4540349	.	G	A	0	2	2	0	1	3	0	0
23	4540397	.	A	G	2	3	5	0	1	6	0	0
23	4540400	.	T	G	1	0	1	0	5	6	0	0
23	4540439	.	C	T	3	4	7	0	0	7	0	0
23	4542695	.	A	T	3	3	6	0	0	6	0	0
23	4557069	.	C	G	1	2	3	0	0	3	0	0
23	4677464	.	T	G	9	0	9	0	17	26	0	0
23	5010006	.	C	T	4	3	7	0	1	8	0	0
23	5010070	.	T	A	3	2	5	0	0	5	0	0
23	5010178	.	C	T	2	3	5	0	0	5	0	0
23	5010228	.	T	C	2	3	5	0	0	5	0	0
23	5010250	.	T	A	6	2	8	0	0	8	0	0
23	5010722	.	C	T	10	9	19	0	3	22	0	0
23	5011064	.	T	A	5	5	10	0	0	10	0	0
23	5011968	.	A	G	6	3	9	0	0	9	0	0
23	5012763	.	A	G	5	8	13	0	0	13	0	0
23	5012788	.	T	C	5	6	11	0	0	11	0	0
23	5012826	.	C	T	5	7	12	0	0	12	0	0
23	5012832	.	T	C	5	7	12	0	0	12	0	0
23	5565897	.	A	G	10	9	19	0	0	19	0	0
23	5583113	.	C	T	6	5	11	0	0	11	0	0
23	5583185	.	A	G	3	0	3	0	5	8	0	0
23	5585483	.	T	C	1	7	8	0	0	8	0	0
23	5585528	.	G	T	3	7	10	0	0	10	0	0
23	5585555	.	T	C	5	5	10	0	1	11	0	0
23	5587625	.	T	C	1	3	4	0	0	4	0	0
23	5587626	.	C	A	1	2	3	0	1	4	0	0
23	5587860	.	G	A	3	7	10	1	0	11	0	0
23	5756781	.	G	T	4	2	6	0	0	6	0	0
23	5756847	.	C	T	1	3	4	0	0	4	0	0
23	5757010	.	G	A	4	4	8	0	0	8	0	0
23	5757047	.	A	T	2	4	6	0	1	7	0	0
23	5757193	.	G	T	6	6	12	0	0	12	0	0
23	5757202	.	C	T	0	6	6	0	6	12	0	0
23	5758610	.	G	A	6	3	9	0	1	10	0	0
23	5759014	.	A	T	3	2	5	0	1	6	0	0
23	5759102	.	C	T	0	3	3	0	3	6	0	0
23	5759124	.	A	G	3	2	5	0	0	5	0	0
23	5767365	.	T	A	2	4	6	0	0	6	0	0
23	5872575	.	T	C	2	2	4	0	0	4	0	0
23	5873048	.	C	T	2	2	4	0	0	4	0	0
23	5873049	.	G	A	0	2	2	0	2	4	0	0
23	5873124	.	C	T	3	3	6	0	1	7	0	0
23	5919146	.	C	T	6	3	9	0	0	9	0	0
23	5919147	.	G	A	1	3	4	0	6	10	0	0
23	5919188	.	C	T	8	3	11	0	0	11	0	0
23	5919239	.	G	A	1	2	3	0	4	7	0	0
23	5919293	.	C	T	4	4	8	0	0	8	0	0
23	5919430	.	A	T	3	3	6	0	0	6	0	0
23	6011931	.	G	A	7	6	13	0	1	14	0	0
23	6011958	.	A	G	5	4	9	0	2	11	0	0
23	6027379	.	G	A	8	3	11	0	0	11	0	0
23	6027415	.	T	G	6	7	13	0	0	13	0	0
23	6027439	.	G	A	5	6	11	0	1	12	0	0
23	6027578	.	C	T	5	9	14	0	1	15	0	0
23	6027781	.	T	C	6	2	8	0	0	8	0	0
23	6028015	.	C	T	10	9	19	0	0	19	0	0
23	6028029	.	C	T	9	9	18	0	1	19	0	0
23	6028051	.	G	A	9	8	17	0	0	18	1	0
23	6028093	.	G	A	4	8	12	0	2	14	0	0
23	6030946	.	T	C	7	7	14	0	0	14	0	0
23	6031126	.	C	T	6	8	14	0	1	15	0	0
23	6035912	.	C	G	10	9	19	0	0	19	0	0
23	6046850	.	T	C	4	6	10	0	0	10	0	0
23	6046867	.	T	C	7	4	11	0	0	11	0	0
23	6056016	.	T	C	5	4	9	0	0	9	0	0
23	6058704	.	C	T	9	6	15	0	0	15	0	0
23	6059847	.	G	A	0	4	4	0	7	11	0	0
23	6060084	.	C	A	5	3	8	0	0	8	0	0
23	6062654	.	C	T	5	3	8	0	0	8	0	0
23	6064579	.	T	C	13	8	21	0	1	22	0	0
23	6272793	.	C	T	13	11	24	0	0	24	0	0
23	6301287	.	T	A	18	25	43	0	1	44	0	0
23	6301332	.	T	C	13	21	34	0	1	35	0	0
23	6301413	.	A	G	15	16	31	0	2	33	0	0
23	6301416	.	T	C	16	13	29	0	4	33	0	0
23	6304243	.	A	G	15	0	15	0	24	39	0	0
23	6304249	.	T	C	13	22	35	0	0	35	0	0
23	6347742	.	C	T	1	6	7	0	2	9	0	0
23	6421776	.	T	C	5	5	10	0	0	10	0	0
23	6432235	.	T	C	2	2	4	0	0	4	0	0
23	6736265	.	C	A	13	5	18	0	0	18	0	0
23	6926414	.	G	A	3	2	5	0	1	6	0	0
23	6938373	.	G	A	4	5	9	0	0	9	0	0
23	6951037	.	T	G	1	3	4	0	0	4	0	0
23	6951157	.	C	T	0	5	5	0	1	6	0	0
23	6952261	.	T	C	8	0	8	0	4	12	0	0
23	6955860	.	G	A	6	7	13	0	0	13	0	0
23	6982389	.	T	C	4	1	5	0	2	7	0	0
23	7003744	.	C	T	12	5	17	0	2	19	0	0
23	7007480	.	C	T	7	5	12	0	0	12	0	0
23	7027534	.	C	T	0	12	12	0	11	23	0	0
23	7029600	.	G	A	11	7	18	0	0	18	0	0
23	7029741	.	G	A	10	12	22	0	1	23	0	0
23	7029777	.	A	T	12	12	24	0	1	25	0	0
23	7029916	.	A	T	8	8	16	0	0	16	0	0
23	7029964	.	A	C	5	0	5	0	8	13	0	0
23	7032435	.	C	A	4	9	13	0	0	13	0	0
23	7040708	.	T	A	5	10	15	0	0	15	0	0
23	7067257	.	T	C	6	7	13	0	1	14	0	0
23	7068334	.	A	T	3	4	7	0	0	7	0	0
23	7068349	.	G	A	3	3	6	0	1	7	0	0
23	7074645	.	A	G	1	6	7	0	0	7	0	0
23	7077232	.	T	A	2	2	4	0	0	4	0	0
23	7089527	.	A	C	1	5	6	0	0	6	0	0
23	7089569	.	A	C	6	3	9	0	0	9	0	0
23	7093722	.	C	T	1	2	3	0	2	5	0	0
23	7093830	.	T	C	0	0	0	0	6	6	0	0
23	7556970	.	C	G	6	10	16	0	0	16	0	0
23	7556979	.	G	C	6	10	16	0	1	17	0	0
23	7557383	.	G	A	1	10	11	0	11	22	0	0
23	7567446	.	C	T	10	7	17	0	2	19	0	0
23	7572445	.	A	G	7	0	7	0	7	14	0	0
23	7578710	.	T	C	10	11	21	0	2	23	0	0
23	7715282	.	G	T	2	6	8	0	0	8	0	0
23	7715651	.	C	T	8	4	12	0	0	12	0	0
23	7715747	.	A	G	7	8	15	0	0	15	0	0
23	7715801	.	G	A	0	8	8	0	10	18	0	0
23	7715873	.	G	A	5	8	13	0	0	13	0	0
23	7715909	.	T	C	5	7	12	0	0	12	0	0
23	7715945	.	G	C	1	7	8	0	6	14	0	0
23	7716281	.	T	C	8	4	12	0	0	12	0	0
23	7718380	.	G	A	14	8	22	0	2	24	0	0
23	7718972	.	G	A	2	6	8	0	6	14	0	0
23	7718999	.	C	T	8	4	12	0	0	12	0	0
23	7721342	.	A	G	7	7	14	0	0	14	0	0
23	7732578	.	T	C	11	10	21	0	0	21	0	0
23	7733088	.	C	G	7	10	17	0	2	19	0	0
23	7733603	.	T	C	5	7	12	0	0	12	0	0
23	7733614	.	G	T	5	9	14	0	1	15	0	0
23	7733732	.	T	C	6	5	11	0	0	11	0	0
23	7733770	.	T	A	4	3	7	0	0	7	0	0
23	7734801	.	C	A	2	3	5	0	0	5	0	0
23	7735423	.	G	A	6	2	8	0	0	8	0	0
23	7735497	.	T	C	5	2	7	0	0	7	0	0
23	7735649	.	C	T	10	8	18	0	0	18	0	0
23	7735809	.	A	T	5	3	8	0	0	8	0	0
23	7736024	.	A	G	2	1	3	0	1	4	0	0
23	7743670	.	T	C	5	12	17	0	0	17	0	0
23	7743691	.	T	C	8	11	19	0	0	19	0	0
23	7746618	.	T	C	3	0	3	0	8	11	0	0
23	7746797	.	T	G	4	8	12	0	1	13	0	0
23	7750693	.	A	C	7	12	19	0	0	19	0	0
23	7755088	.	T	C	5	1	6	0	10	16	0	0
23	7755112	.	A	C	4	7	11	0	1	12	0	0
23	7755189	.	T	G	6	10	16	0	0	16	0	0
23	7755215	.	T	C	1	6	7	0	0	7	0	0
23	7762045	.	A	G	10	9	19	0	2	21	0	0
23	7765955	.	G	A	9	11	20	0	1	21	0	0
23	7765961	.	C	T	8	9	17	0	3	20	0	0
23	7768416	.	T	C	7	0	7	0	17	24	0	0
23	7771305	.	T	C	10	7	17	0	0	17	0	0
23	7778670	.	G	A	15	11	26	0	0	26	0	0
23	7778715	.	A	G	19	11	30	0	0	30	0	0
23	7789553	.	T	A	8	4	12	0	0	12	0	0
23	7789556	.	T	A	12	2	14	0	0	14	0	0
23	7789635	.	G	A	9	15	24	0	1	25	0	0
23	7789802	.	C	T	8	11	19	0	0	19	0	0
23	7789930	.	C	T	0	10	10	0	13	23	0	0
23	7802575	.	C	T	11	4	15	0	0	15	0	0
23	7823544	.	T	G	7	4	11	0	0	11	0	0
23	8285094	.	G	T	10	5	15	0	1	16	0	0
23	8285236	.	G	T	12	17	29	0	2	31	0	0
23	8285297	.	C	T	1	18	19	0	11	30	0	0
23	8285365	.	G	A	14	13	27	0	1	28	0	0
23	8285468	.	T	C	5	5	10	0	1	11	0	0
23	8285585	.	A	T	8	8	16	0	1	17	0	0
23	8285640	.	C	T	11	7	18	0	0	18	0	0
23	8286192	.	T	C	10	1	11	0	17	28	0	0
23	8286237	.	G	A	15	16	31	0	1	32	0	0
23	8286342	.	C	T	2	9	11	0	11	22	0	0
23	8286384	.	G	T	14	10	24	0	1	25	0	0
23	8286483	.	G	A	10	10	20	0	0	20	0	0
23	8372159	.	T	C	8	1	9	0	10	20	1	0
23	8373535	.	T	G	5	16	21	0	0	21	0	0
23	8373641	.	A	G	7	12	19	0	2	21	0	0
23	8687821	.	G	A	2	3	5	0	0	5	0	0
23	8699956	.	C	T	3	5	8	0	0	8	0	0
23	8719074	.	T	C	10	6	16	0	0	16	0	0
23	8721202	.	G	A	7	5	12	0	0	12	0	0
23	8724467	.	G	A	16	12	28	0	1	29	0	0
23	8799808	.	A	G	1	2	3	0	0	3	0	0
23	8993280	.	G	A	9	5	14	0	0	14	0	0
23	9013456	.	C	G	5	1	6	0	3	9	0	0
23	9013597	.	T	C	11	9	20	0	0	20	0	0
23	9013843	.	G	A	12	13	25	0	1	26	0	0
23	9013876	.	T	A	7	12	19	0	3	22	0	0
23	9014122	.	G	A	0	11	11	0	6	17	0	0
23	9014259	.	G	A	9	7	16	0	1	17	0	0
23	9058105	.	A	T	2	3	5	0	0	5	0	0
23	9058108	.	C	A	5	3	8	0	0	8	0	0
23	9058213	.	C	T	1	1	2	0	1	3	0	0
23	9067121	.	G	A	0	3	3	0	5	8	0	0
23	9069798	.	G	A	3	2	5	0	0	5	0	0
23	9069816	.	G	A	2	2	4	0	0	4	0	0
23	9069900	.	A	G	3	4	7	0	0	7	0	0
23	9112869	.	C	T	3	2	5	0	0	5	0	0
23	9131416	.	A	G	2	0	2	0	3	5	0	0
23	9132147	.	A	G	3	6	9	0	0	9	0	0
23	9132150	.	T	C	4	4	8	0	0	8	0	0
23	9137372	.	G	A	2	3	5	0	1	6	0	0
23	9137400	.	A	C	4	3	7	0	0	7	0	0
23	9137410	.	A	G	5	0	5	0	3	8	0	0
23	9137628	.	T	C	2	2	4	0	0	4	0	0
23	9137629	.	G	A	2	2	4	0	0	4	0	0
23	9268466	.	T	C	4	9	13	0	1	14	0	0
23	9272674	.	C	T	4	6	10	0	0	10	0	0
23	9272984	.	T	C	5	7	12	0	0	12	0	0
23	9287619	.	G	A	3	2	5	0	0	5	0	0
23	9287629	.	C	A	2	3	5	0	1	6	0	0
23	9287666	.	C	T	1	3	4	0	0	4	0	0
23	9287689	.	T	C	2	3	5	0	1	6	0	0
23	9288047	.	T	A	5	6	11	0	0	11	0	0
23	9288062	.	C	G	5	8	13	0	1	14	0	0
23	9288200	.	G	T	3	9	12	0	0	12	0	0
23	9400848	.	G	C	8	5	13	0	1	14	0	0
23	9400902	.	G	A	4	8	12	0	0	12	0	0
23	9401006	.	A	T	1	7	8	0	0	8	0	0
23	9401107	.	C	T	2	6	8	0	0	8	0	0
23	9401210	.	T	C	8	0	8	0	14	22	0	0
23	9401344	.	G	A	8	8	16	0	0	16	0	0
23	9401439	.	T	C	8	8	16	0	0	16	0	0
23	9401470	.	C	T	7	9	16	0	1	17	0	0
23	9401918	.	A	G	8	7	15	0	1	16	0	0
23	9401954	.	G	A	5	4	9	0	1	10	0	0
23	9402065	.	T	C	5	4	9	0	0	9	0	0
23	9402326	.	G	A	4	5	9	0	0	9	0	0
23	9402459	.	G	A	4	4	8	0	0	8	0	0
23	9402734	.	A	G	5	5	10	0	1	11	0	0
23	9402857	.	C	T	4	3	7	0	0	7	0	0
23	9402971	.	T	G	4	6	10	0	1	11	0	0
23	9403284	.	C	A	5	2	7	0	0	7	0	0
23	9405562	.	C	T	5	4	9	0	1	10	0	0
23	9405572	.	C	G	1	5	6	0	5	11	0	0
23	9405633	.	C	A	0	5	5	0	2	7	0	0
23	9405713	.	G	T	5	7	12	0	1	13	0	0
23	9405765	.	A	G	8	6	14	0	1	15	0	0
23	9413456	.	C	T	6	5	11	0	0	11	0	0
23	9415690	.	A	T	3	3	6	0	0	6	0	0
23	9422205	.	C	A	2	2	4	0	1	5	0	0
23	9422427	.	G	A	2	5	7	0	0	7	0	0
23	9422685	.	T	C	7	4	11	0	0	11	0	0
23	9423138	.	C	A	2	6	8	0	0	8	0	0
23	9423270	.	T	C	6	3	9	0	0	9	0	0
23	9423312	.	A	G	3	3	6	0	0	6	0	0
23	9423314	.	A	C	3	3	6	0	0	6	0	0
23	9794959	.	T	A	22	14	36	0	1	37	0	0
23	9795057	.	A	G	20	13	33	0	0	33	0	0
23	9795097	.	C	T	2	18	20	0	15	35	0	0
23	9795663	.	A	C	13	14	27	0	0	27	0	0
23	9795908	.	C	T	16	18	34	0	0	34	0	0
23	9800761	.	T	G	13	23	36	0	1	37	0	0
23	9800872	.	T	C	15	19	34	0	1	35	0	0
23	9800993	.	G	T	13	20	33	0	0	33	0	0
23	9801083	.	G	A	1	2	3	0	0	3	0	0
23	9801402	.	T	A	1	2	3	0	0	3	0	0
23	9801729	.	G	A	2	2	4	0	0	4	0	0
23	9809863	.	A	G	12	9	21	0	0	21	0	0
23	9809977	.	C	T	0	8	8	0	10	18	0	0
23	9810491	.	C	G	21	14	35	1	4	40	0	0
23	9818153	.	C	T	6	9	15	0	1	16	0	0
23	9828802	.	T	C	13	0	13	0	10	23	0	0
23	9837018	.	G	A	9	5	14	0	1	15	0	0
23	9840151	.	A	G	14	5	19	0	0	19	0	0
23	9840154	.	A	C	13	6	19	0	1	20	0	0
23	9840669	.	G	A	6	6	12	0	0	12	0	0
23	9842935	.	G	A	5	5	10	0	0	10	0	0
23	9842980	.	C	T	3	4	7	0	2	9	0	0
23	9843221	.	T	C	4	7	11	0	0	11	0	0
23	9938497	.	G	A	4	4	8	0	0	8	0	0
23	9938714	.	G	T	5	4	9	0	1	10	0	0
23	9938765	.	A	G	6	6	12	0	0	12	0	0
23	9938812	.	A	T	4	7	11	0	0	11	0	0
23	9938824	.	T	C	3	0	3	0	6	9	0	0
23	9938869	.	C	T	3	6	9	0	0	10	1	0
23	9938905	.	T	C	8	0	8	0	6	14	0	0
23	9939602	.	T	C	5	7	12	0	1	13	0	0
23	9950087	.	A	C	8	8	16	0	0	16	0	0
23	9952460	.	C	T	1	6	7	0	0	7	0	0
23	9952532	.	C	G	0	4	4	0	7	11	0	0
23	9959766	.	A	G	4	9	13	0	0	13	0	0
23	9959772	.	G	A	3	8	11	0	2	13	0	0
23	9962955	.	T	C	5	2	7	0	0	7	0	0
23	9963048	.	T	C	4	2	6	0	0	6	0	0
23	9963087	.	T	C	1	3	4	0	0	4	0	0
23	9963108	.	C	T	3	6	9	0	0	9	0	0
23	9965037	.	A	G	11	5	16	0	1	17	0	0
23	9967419	.	T	G	2	6	8	1	0	9	0	0
23	9967563	.	A	G	4	4	8	0	1	9	0	0
23	9967565	.	C	A	4	5	9	0	0	9	0	0
23	9973557	.	G	A	6	5	11	0	0	11	0	0
23	9973621	.	G	A	2	3	5	0	0	5	0	0
23	9985619	.	A	G	2	5	7	0	0	7	0	0
23	10016995	.	T	C	3	0	3	0	6	9	0	0
23	10045892	.	A	G	1	2	3	0	0	3	0	0
23	10045928	.	C	T	2	2	4	0	0	4	0	0
23	10137175	.	C	A	2	3	5	0	0	5	0	0
23	10137296	.	T	A	4	5	9	0	1	10	0	0
23	10137306	.	A	G	2	5	7	0	0	7	0	0
23	10174422	.	A	G	4	3	7	0	0	7	0	0
23	10174426	.	T	C	6	4	10	0	0	10	0	0
23	10174773	.	G	A	7	2	9	0	2	11	0	0
23	10174961	.	A	G	6	4	10	0	0	10	0	0
23	10250357	.	G	A	18	20	38	0	0	38	0	0
23	10251076	.	A	G	19	15	34	0	1	35	0	0
23	10251750	.	T	C	11	13	24	0	0	24	0	0
23	10252499	.	A	G	8	10	18	0	0	18	0	0
23	10252526	.	G	A	7	13	20	0	0	20	0	0
23	10252625	.	T	A	11	16	27	0	0	27	0	0
23	10254018	.	A	G	14	13	27	0	1	28	0	0
23	10254075	.	G	A	10	12	22	0	0	22	0	0
23	10254081	.	A	G	10	12	22	0	1	23	0	0
23	10348052	.	C	T	7	2	9	0	0	9	0	0
23	10350105	.	T	C	7	4	11	0	0	11	0	0
23	10350534	.	A	C	6	5	11	0	0	11	0	0
23	10350549	.	T	C	6	7	13	0	0	13	0	0
23	10350591	.	G	A	5	5	10	0	0	10	0	0
23	10405707	.	A	G	9	0	9	0	16	25	0	0
23	10405742	.	G	C	0	13	13	0	12	25	0	0
23	10411562	.	A	C	7	12	19	0	2	21	0	0
23	10419933	.	A	C	16	9	25	0	1	26	0	0
23	10421216	.	A	C	16	12	28	0	1	29	0	0
23	10423909	.	C	G	18	16	34	0	0	34	0	0
23	10426291	.	C	T	8	12	20	0	0	20	0	0
23	10448936	.	C	T	4	11	15	0	1	16	0	0
23	10449063	.	T	C	10	4	14	0	0	14	0	0
23	10449136	.	A	G	8	1	9	0	4	13	0	0
23	10449185	.	C	T	7	6	13	0	0	13	0	0
23	10449405	.	A	T	2	6	8	0	0	8	0	0
23	10568850	.	T	A	1	1	2	0	1	3	0	0
23	10570219	.	A	T	2	2	4	0	0	4	0	0
23	10638386	.	A	G	2	2	4	0	0	4	0	0
23	10638430	.	T	A	4	2	6	0	0	6	0	0
23	10639121	.	G	A	5	3	8	0	0	8	0	0
23	10650348	.	G	A	1	2	3	0	0	3	0	0
23	10696523	.	A	G	2	4	6	0	0	6	0	0
23	10725272	.	A	T	3	6	9	0	1	10	0	0
23	10725320	.	T	C	7	6	13	0	0	13	0	0
23	10725334	.	T	C	8	4	12	0	0	12	0	0
23	10725638	.	A	T	8	2	10	0	1	11	0	0
23	10725919	.	C	A	14	7	21	0	2	23	0	0
23	10727563	.	G	A	5	16	21	0	0	21	0	0
23	10727614	.	C	T	11	12	23	0	0	23	0	0
23	10727644	.	C	T	11	15	26	0	0	26	0	0
23	10745058	.	G	T	10	5	15	0	0	15	0	0
23	10762922	.	G	A	8	9	17	0	2	19	0	0
23	10762972	.	T	A	7	8	15	0	0	15	0	0
23	10763070	.	G	A	6	6	12	0	0	12	0	0
23	10771991	.	C	A	1	10	11	0	17	28	0	0
23	10805322	.	A	G	1	3	4	0	0	4	0	0
23	10817292	.	T	G	6	3	9	0	0	9	0	0
23	10825591	.	C	T	11	8	19	0	1	20	0	0
23	10826427	.	C	T	8	4	12	0	0	12	0	0
23	10826718	.	C	A	8	7	15	0	0	15	0	0
23	10826754	.	C	T	7	9	16	0	0	16	0	0
23	10826917	.	C	T	3	2	5	0	0	5	0	0
23	11015322	.	G	A	1	2	3	0	0	3	0	0
23	11669513	.	G	A	2	4	6	0	0	6	0	0
23	11763235	.	A	G	1	0	1	0	4	5	0	0
23	11763431	.	C	A	3	4	7	0	0	7	0	0
23	11764269	.	C	T	3	2	5	0	1	6	0	0
23	11764385	.	T	C	1	7	8	0	0	8	0	0
23	11772230	.	A	C	4	2	6	0	0	6	0	0
23	11772310	.	C	T	4	3	7	0	0	7	0	0
23	11802582	.	C	T	6	3	9	0	0	9	0	0
23	11842406	.	C	A	4	4	8	0	0	8	0	0
23	11851459	.	C	A	3	6	9	0	0	9	0	0
23	11851467	.	C	T	1	6	7	0	1	8	0	0
23	11851545	.	T	C	6	4	10	0	0	10	0	0
23	11851603	.	C	T	3	3	6	0	0	6	0	0
23	11855160	.	A	G	5	8	13	0	0	13	0	0
23	11855169	.	G	A	6	7	13	0	0	13	0	0
23	11859294	.	C	T	7	4	11	0	0	11	0	0
23	11865055	.	T	A	17	9	26	0	1	27	0	0
23	11865934	.	C	T	15	17	32	1	1	34	0	0
23	11866086	.	G	A	22	17	39	0	1	40	0	0
23	11866183	.	G	A	17	26	43	0	0	43	0	0
23	11866259	.	T	C	29	15	44	0	2	46	0	0
23	11870203	.	A	T	27	13	40	0	2	42	0	0
23	11870893	.	G	A	24	16	40	0	1	41	0	0
23	11896251	.	G	A	16	12	28	0	2	30	0	0
23	11920705	.	G	A	6	8	14	0	1	15	0	0
23	11920712	.	C	T	10	6	16	0	0	16	0	0
23	12155166	.	G	A	7	11	18	0	1	19	0	0
23	12155298	.	G	A	8	9	17	0	2	19	0	0
23	12155319	.	G	A	14	11	25	0	1	26	0	0
23	12155364	.	A	G	14	18	32	0	0	32	0	0
23	12155391	.	G	A	13	14	27	0	1	28	0	0
23	12158643	.	A	G	10	5	15	0	0	15	0	0
23	12161399	.	T	C	2	5	7	0	1	8	0	0
23	12161557	.	A	G	1	0	1	0	5	6	0	0
23	12161593	.	G	C	0	2	2	0	2	4	0	0
23	12161794	.	T	C	1	5	6	0	0	6	0	0
23	12162034	.	G	A	4	6	10	0	0	10	0	0
23	12162073	.	T	G	6	1	7	0	4	11	0	0
23	12162099	.	G	C	4	3	7	0	1	8	0	0
23	12162163	.	C	T	4	4	8	0	0	8	0	0
23	12162386	.	A	C	3	7	10	0	0	10	0	0
23	12232873	.	G	A	6	2	8	0	2	10	0	0
23	12233117	.	G	A	11	14	25	0	1	26	0	0
23	12233121	.	C	T	3	11	14	0	13	27	0	0
23	12245729	.	A	C	1	2	3	0	0	3	0	0
23	12259026	.	C	T	3	16	19	0	17	36	0	0
23	12345695	.	G	A	14	10	24	0	3	27	0	0
23	12362054	.	G	A	2	2	4	0	0	4	0	0
23	12362157	.	C	T	1	2	3	0	0	3	0	0
23	12384087	.	C	T	1	2	3	0	0	3	0	0
23	12486063	.	T	C	5	3	8	0	0	8	0	0
23	12840452	.	C	T	4	3	7	0	1	8	0	0
23	13332216	.	G	C	1	4	5	0	0	5	0	0
23	13332269	.	T	C	1	4	5	0	0	5	0	0
23	13332325	.	A	C	3	2	5	0	0	5	0	0
23	13454551	.	A	G	3	2	5	0	0	5	0	0
23	13516827	.	A	T	2	2	4	0	0	4	0	0
23	13558711	.	C	T	2	4	6	0	0	6	0	0
23	13567194	.	C	T	7	2	9	0	0	9	0	0
23	13567257	.	G	T	3	4	7	0	0	7	0	0
23	13567264	.	A	C	4	4	8	0	0	8	0	0
23	13598632	.	T	C	8	7	15	0	0	15	0	0
23	13598679	.	C	T	7	9	16	0	0	16	0	0
23	13599008	.	G	A	4	3	7	0	0	7	0	0
23	13599079	.	G	A	0	2	2	0	2	4	0	0
23	13722416	.	C	A	10	9	19	0	1	20	0	0
23	13722728	.	G	A	1	13	14	2	8	24	0	0
23	13722755	.	C	G	11	0	11	2	15	28	0	0
23	13806408	.	C	T	22	14	36	0	0	36	0	0
23	13833376	.	T	A	12	14	26	0	1	27	0	0
23	13835932	.	C	A	18	9	27	0	0	27	0	0
23	13840297	.	G	A	7	8	15	0	1	16	0	0
23	13840362	.	C	T	0	8	8	0	17	25	0	0
23	13845114	.	A	C	7	9	16	0	0	16	0	0
23	13845131	.	G	A	8	6	14	0	0	14	0	0
23	13845149	.	T	G	6	7	13	0	0	13	0	0
23	13845201	.	A	G	3	9	12	0	0	12	0	0
23	13845247	.	G	T	1	6	7	0	0	7	0	0
23	13845258	.	A	T	4	2	6	0	0	6	0	0
23	13845389	.	C	A	4	6	10	0	0	10	0	0
23	13845411	.	G	T	10	4	14	0	0	14	0	0
23	13845447	.	T	C	13	10	23	0	0	24	1	0
23	13845901	.	G	T	7	5	12	0	0	12	0	0
23	13846627	.	G	T	4	6	10	0	0	10	0	0
23	13846631	.	C	T	5	5	10	0	1	11	0	0
23	13846664	.	T	C	4	6	10	0	1	11	0	0
23	13846802	.	A	C	1	0	1	0	6	7	0	0
23	13846885	.	A	G	7	3	10	0	0	10	0	0
23	13846938	.	G	T	6	3	9	2	0	11	0	0
23	13846953	.	C	A	6	4	10	2	0	12	0	0
23	13847142	.	G	A	4	2	6	2	1	9	0	0
23	13847220	.	T	C	5	3	8	0	1	9	0	0
23	13848537	.	G	A	12	8	20	0	0	20	0	0
23	13857114	.	G	A	7	8	15	0	2	17	0	0
23	13857170	.	G	T	6	8	14	0	1	15	0	0
23	13941275	.	C	T	14	12	26	1	0	27	0	0
23	13946174	.	C	T	2	10	12	0	10	22	0	0
23	13948993	.	G	A	6	11	17	0	0	17	0	0
23	13949110	.	C	T	1	7	8	0	13	21	0	0
23	14006105	.	G	A	8	4	12	0	1	13	0	0
23	14056306	.	C	T	4	9	13	0	0	13	0	0
23	14056640	.	G	A	10	5	15	0	0	15	0	0
23	14056679	.	G	A	6	5	11	0	0	11	0	0
23	14057102	.	C	T	5	5	10	0	2	12	0	0
23	14193676	.	A	G	3	5	8	1	1	10	0	0
23	14193777	.	C	T	7	12	19	0	1	20	0	0
23	14193880	.	C	T	12	6	18	0	0	18	0	0
23	14193923	.	A	C	10	11	21	0	0	21	0	0
23	14193940	.	C	T	9	13	22	1	2	25	0	0
23	14194035	.	C	G	8	13	21	0	0	21	0	0
23	14194058	.	G	A	10	12	22	0	2	24	0	0
23	14198137	.	G	A	22	10	32	0	0	32	0	0
23	14201512	.	T	C	12	10	22	0	0	22	0	0
23	14201521	.	T	C	13	9	22	0	0	22	0	0
23	14203829	.	T	G	15	7	22	0	0	22	0	0
23	14208718	.	A	G	6	13	19	0	2	21	0	0
23	14208817	.	A	T	11	18	29	0	1	30	0	0
23	14209024	.	T	G	21	12	33	0	1	34	0	0
23	14211707	.	C	T	24	14	38	0	2	40	0	0
23	14217769	.	G	A	0	4	4	0	6	10	0	0
23	14217799	.	G	A	3	2	5	0	0	5	0	0
23	14218065	.	C	T	3	5	8	0	0	8	0	0
23	14222913	.	A	G	4	4	8	0	0	8	0	0
23	14432386	.	C	A	2	5	7	0	0	7	0	0
23	14432447	.	T	C	6	3	9	0	1	10	0	0
23	14504141	.	C	T	4	7	11	0	0	11	0	0
23	14591009	.	G	A	3	2	5	0	0	5	0	0
23	14696246	.	C	T	1	3	4	0	0	4	0	0
23	14720234	.	G	A	0	2	2	0	3	5	0	0
23	14731394	.	A	G	3	3	6	0	0	6	0	0
23	14731424	.	G	A	5	3	8	0	0	8	0	0
23	14731430	.	A	G	5	2	7	0	0	7	0	0
23	14731509	.	C	T	2	2	4	0	0	4	0	0
23	14743154	.	G	A	1	3	4	0	0	4	0	0
23	14743404	.	C	A	2	2	4	0	0	4	0	0
23	14743419	.	G	A	1	2	3	0	1	4	0	0
23	14743447	.	G	A	4	2	6	0	1	7	0	0
23	14752817	.	G	A	1	4	5	0	0	5	0	0
23	14752841	.	T	C	2	3	5	0	0	5	0	0
23	14769323	.	G	T	2	4	6	0	0	6	0	0
23	14772079	.	G	A	7	2	9	0	0	9	0	0
23	14777039	.	A	C	11	8	19	0	0	19	0	0
23	14777492	.	T	A	4	3	7	0	0	7	0	0
23	14782599	.	C	T	3	2	5	0	0	5	0	0
23	14784150	.	G	A	3	4	7	0	0	7	0	0
23	14784192	.	C	T	4	5	9	0	0	9	0	0
23	14784237	.	A	C	4	6	10	0	0	10	0	0
23	14786347	.	T	C	11	6	17	0	0	17	0	0
23	14786429	.	A	T	5	9	14	0	0	15	1	0
23	14787318	.	T	A	13	9	22	0	0	22	0	0
23	14787409	.	G	A	2	4	6	0	7	13	0	0
23	14787426	.	G	A	6	6	12	0	1	13	0	0
23	14788082	.	A	G	9	0	9	0	9	18	0	0
23	14790429	.	G	A	12	6	18	0	0	18	0	0
23	14790611	.	C	T	6	8	14	0	0	14	0	0
23	14790827	.	G	A	7	3	10	0	1	11	0	0
23	14808490	.	G	A	5	4	9	0	0	9	0	0
23	14808537	.	G	T	2	3	5	0	0	5	0	0
23	14809613	.	C	A	3	2	5	0	0	5	0	0
23	14809673	.	G	A	1	2	3	0	0	3	0	0
23	14819798	.	G	A	2	2	4	0	0	4	0	0
23	14832677	.	G	A	29	19	48	0	0	48	0	0
23	14832774	.	G	A	31	22	53	0	1	54	0	0
23	14832835	.	C	T	34	26	60	0	1	61	0	0
23	14832866	.	C	T	25	27	52	0	4	56	0	0
23	14832926	.	A	T	28	23	51	0	1	52	0	0
23	14833032	.	C	T	29	20	49	0	3	52	0	0
23	14833142	.	A	T	22	25	47	0	2	49	0	0
23	14833143	.	A	T	23	23	46	0	3	49	0	0
23	14833189	.	A	C	26	20	46	0	1	47	0	0
23	14833552	.	T	C	28	31	59	1	1	61	0	0
23	14833581	.	T	C	25	2	27	3	30	60	0	0
23	14833664	.	G	A	34	22	56	0	2	58	0	0
23	14833765	.	G	A	33	30	63	2	3	68	0	0
23	14851621	.	A	G	25	28	53	0	0	53	0	0
23	14853221	.	G	A	26	22	48	0	0	49	1	0
23	14853342	.	G	A	32	20	52	0	0	52	0	0
23	14853411	.	C	T	29	17	46	0	1	47	0	0
23	14853414	.	C	T	6	18	24	0	24	48	0	0
23	14853833	.	C	T	35	18	53	0	4	57	0	0
23	14861941	.	T	C	33	14	47	0	0	47	0	0
23	14993089	.	G	A	15	11	26	0	1	27	0	0
23	14993140	.	T	C	6	0	6	0	14	20	0	0
23	14993200	.	A	T	15	7	22	0	0	22	0	0
23	14993393	.	C	A	10	7	17	0	0	17	0	0
23	14993936	.	A	T	7	8	15	0	0	15	0	0
23	14999053	.	C	T	14	11	25	0	0	25	0	0
23	14999095	.	C	T	4	11	15	0	15	30	0	0
23	15006653	.	C	T	3	20	23	0	13	36	0	0
23	15021985	.	A	T	11	10	21	0	0	21	0	0
23	15022206	.	T	C	16	1	17	0	12	29	0	0
23	15022526	.	C	T	16	9	25	0	0	25	0	0
23	15025084	.	G	C	8	1	9	0	5	14	0	0
23	15036698	.	G	A	12	9	21	0	1	22	0	0
23	15047065	.	G	T	2	4	6	0	0	6	0	0
23	15047732	.	C	T	3	3	6	0	0	6	0	0
23	15047745	.	C	T	0	3	3	0	4	7	0	0
23	15048070	.	A	G	8	4	12	0	0	12	0	0
23	15048874	.	G	A	3	3	6	0	0	6	0	0
23	15053352	.	A	G	10	6	16	0	0	16	0	0
23	15053420	.	C	G	10	3	13	0	1	14	0	0
23	15076070	.	T	C	4	4	8	0	0	8	0	0
23	15087289	.	G	A	5	3	8	0	1	9	0	0
23	15087457	.	T	C	1	0	1	0	2	3	0	0
23	15088005	.	C	G	2	3	5	0	0	5	0	0
23	15088076	.	G	T	1	4	5	0	0	5	0	0
23	15204222	.	C	T	2	19	21	0	15	36	0	0
23	15204417	.	A	G	9	21	30	0	0	30	0	0
23	15204936	.	G	T	10	13	23	0	4	27	0	0
23	15205428	.	A	T	19	20	39	0	2	41	0	0
23	15205487	.	C	G	27	22	49	0	2	51	0	0
23	15205994	.	G	A	32	24	56	0	0	56	0	0
23	15206057	.	A	G	22	23	45	1	1	47	0	0
23	15206061	.	G	C	22	20	42	1	2	45	0	0
23	15211253	.	G	C	32	18	50	0	0	50	0	0
23	15215796	.	T	G	25	20	45	0	3	49	1	0
23	15216314	.	G	A	16	26	42	0	1	43	0	0
23	15216644	.	T	C	16	0	16	0	25	41	0	0
23	15216664	.	G	T	21	21	42	0	0	42	0	0
23	15222572	.	G	A	30	17	47	0	2	49	0	0
23	15232380	.	T	G	18	22	40	0	4	44	0	0
23	15259821	.	G	A	17	22	39	0	1	40	0	0
23	15270775	.	G	A	25	16	41	1	0	42	0	0
23	15284590	.	C	T	27	15	42	0	1	43	0	0
23	16490450	.	C	T	4	3	7	0	0	7	0	0
23	16621314	.	C	T	10	10	20	0	0	20	0	0
23	16640925	.	A	G	9	19	28	0	3	31	0	0
23	16641012	.	A	G	19	0	19	0	6	25	0	0
23	16641017	.	A	G	19	7	26	0	0	26	0	0
23	16641127	.	A	G	17	7	24	0	1	25	0	0
23	16648643	.	A	G	2	3	5	0	1	6	0	0
23	16648950	.	T	A	11	15	26	0	1	27	0	0
23	16649008	.	T	C	15	5	20	0	1	21	0	0
23	16649054	.	C	T	10	4	14	0	2	16	0	0
23	16649599	.	G	T	20	9	29	0	3	32	0	0
23	16649855	.	T	C	19	1	20	1	18	39	0	0
23	16650074	.	G	A	26	23	49	0	0	49	0	0
23	16654424	.	A	G	18	23	41	0	0	41	0	0
23	16688448	.	G	A	13	14	27	0	0	27	0	0
23	16688565	.	A	G	37	14	51	0	0	51	0	0
23	16748903	.	A	T	6	3	9	0	0	9	0	0
23	16748915	.	T	A	5	3	8	0	0	8	0	0
23	16753735	.	T	C	8	6	14	0	1	15	0	0
23	16757528	.	G	T	3	2	5	0	0	5	0	0
23	16761309	.	C	A	1	2	3	0	0	3	0	0
23	16762698	.	A	G	1	0	1	0	2	3	0	0
23	16769695	.	T	C	3	2	5	0	0	5	0	0
23	16786790	.	G	C	1	3	4	0	0	4	0	0
23	16817055	.	T	C	4	6	10	2	0	12	0	0
23	16821752	.	T	G	3	2	5	0	1	6	0	0
23	16822464	.	G	A	1	3	4	0	3	7	0	0
23	16822469	.	T	C	3	3	6	0	0	6	0	0
23	16822707	.	G	A	1	2	3	0	2	5	0	0
23	16822736	.	A	G	2	0	2	0	2	4	0	0
23	16831344	.	A	T	2	2	4	0	1	5	0	0
23	16831469	.	T	C	0	3	3	0	1	4	0	0
23	16831507	.	A	T	3	5	8	0	1	9	0	0
23	16831822	.	G	A	1	6	7	0	6	13	0	0
23	16831928	.	G	A	2	2	4	1	0	5	0	0
23	16833875	.	C	A	4	3	7	0	0	7	0	0
23	16834080	.	G	A	3	8	11	0	0	11	0	0
23	16849056	.	T	C	4	5	9	0	0	9	0	0
23	16849183	.	A	G	2	3	5	0	0	5	0	0
23	16849341	.	C	T	8	4	12	2	0	14	0	0
23	16849383	.	A	G	5	5	10	0	0	10	0	0
23	16883535	.	C	T	1	2	3	0	0	3	0	0
23	16883822	.	G	T	5	6	11	0	0	11	0	0
23	16883836	.	C	A	6	4	10	0	0	10	0	0
23	16883860	.	C	T	5	2	7	0	0	7	0	0
23	16910294	.	T	A	1	2	3	0	0	3	0	0
23	16910963	.	A	T	3	2	5	0	0	5	0	0
23	16961626	.	T	C	3	2	5	0	0	5	0	0
23	16964089	.	C	A	0	3	3	0	5	8	0	0
23	16964113	.	C	A	2	4	6	0	0	6	0	0
23	16966364	.	T	C	4	0	4	0	3	7	0	0
23	16973907	.	A	C	2	3	5	0	0	5	0	0
23	16978857	.	T	C	1	0	1	0	4	5	0	0
23	16979460	.	C	T	1	2	3	0	1	4	0	0
23	16979996	.	T	C	2	2	4	0	0	4	0	0
23	17105324	.	C	T	3	9	12	0	0	12	0	0
23	17113706	.	C	T	6	5	11	0	0	11	0	0
23	17113831	.	G	A	1	3	4	0	5	9	0	0
23	17113842	.	A	G	4	4	8	0	1	9	0	0
23	17339044	.	C	T	11	9	20	0	0	20	0	0
23	17340346	.	G	A	2	14	16	0	7	23	0	0
23	17340355	.	G	A	10	12	22	0	1	23	0	0
23	17354437	.	G	C	2	2	4	0	0	4	0	0
23	17354662	.	T	C	3	4	7	0	0	7	0	0
23	17354693	.	G	T	3	2	5	0	0	5	0	0
23	17354718	.	A	T	1	4	5	0	0	5	0	0
23	17354853	.	G	A	5	8	13	0	0	13	0	0
23	17354868	.	C	A	3	10	13	0	0	13	0	0
23	17355063	.	C	T	9	10	19	0	0	19	0	0
23	17355109	.	C	T	9	9	18	0	0	18	0	0
23	17355498	.	G	T	3	3	6	0	0	6	0	0
23	17370877	.	C	A	10	3	13	0	2	15	0	0
23	17381564	.	G	A	2	2	4	0	0	4	0	0
23	17384981	.	A	G	4	6	10	0	0	10	0	0
23	17385050	.	T	A	8	4	12	0	0	12	0	0
23	17428153	.	C	T	47	32	79	0	7	86	0	0
23	17429632	.	C	T	4	33	37	0	32	69	0	0
23	17431644	.	A	T	22	24	46	0	0	46	0	0
23	17431707	.	T	A	14	15	29	0	0	29	0	0
23	17431734	.	C	T	16	12	28	0	0	28	0	0
23	17432036	.	T	C	20	17	37	0	0	37	0	0
23	17432133	.	A	C	11	12	23	0	0	23	0	0
23	17432169	.	T	A	11	14	25	0	0	25	0	0
23	17432412	.	T	C	17	13	30	0	2	32	0	0
23	17447240	.	A	G	8	15	23	0	0	23	0	0
23	17450623	.	T	G	13	17	30	0	0	30	0	0
23	17450650	.	G	T	19	12	31	0	0	31	0	0
23	17450661	.	A	T	12	18	30	0	1	31	0	0
23	17450779	.	A	T	10	7	17	0	2	19	0	0
23	17473187	.	C	T	13	10	23	0	0	23	0	0
23	17473309	.	G	A	12	16	28	0	0	28	0	0
23	17473365	.	T	C	11	4	15	0	1	16	0	0
23	17473398	.	G	T	8	3	11	0	1	12	0	0
23	17473611	.	C	G	9	14	23	0	0	23	0	0
23	17473649	.	T	A	6	4	10	0	1	11	0	0
23	17473795	.	A	C	17	21	38	1	1	40	0	0
23	17473857	.	A	G	20	19	39	1	1	41	0	0
23	17473981	.	G	A	15	9	24	0	3	27	0	0
23	17474167	.	G	A	3	6	9	0	0	9	0	0
23	17474206	.	A	T	4	3	7	0	1	8	0	0
23	17474532	.	T	C	10	6	16	0	0	16	0	0
23	17474801	.	T	G	14	7	21	0	1	22	0	0
23	17474862	.	C	T	16	7	23	0	4	27	0	0
23	17474928	.	C	G	22	11	33	0	1	34	0	0
23	17475043	.	C	A	13	15	28	0	0	28	0	0
23	17475329	.	G	C	12	0	12	0	0	22	10	0
23	17475349	.	A	T	10	10	20	0	0	20	0	0
23	17475378	.	C	A	12	8	20	0	0	20	0	0
23	17475389	.	T	A	12	7	19	0	0	19	0	0
23	17475552	.	G	A	9	8	17	0	0	17	0	0
23	17475553	.	T	C	8	0	8	0	8	16	0	0
23	17475662	.	A	T	8	9	17	2	0	19	0	0
23	17475702	.	C	T	12	9	21	2	0	23	0	0
23	17475808	.	G	T	17	14	31	0	2	33	0	0
23	17475830	.	G	A	19	17	36	0	3	39	0	0
23	17475922	.	G	T	9	14	23	0	2	25	0	0
23	17476145	.	T	A	7	4	11	0	1	12	0	0
23	17476164	.	C	T	11	8	19	0	1	20	0	0
23	17476213	.	C	T	3	5	8	0	11	19	0	0
23	17476453	.	T	C	8	12	20	0	0	20	0	0
23	17476459	.	G	T	6	10	16	0	1	17	0	0
23	17476491	.	A	G	10	7	17	0	1	18	0	0
23	17481905	.	C	T	3	9	12	0	9	21	0	0
23	17484395	.	C	T	13	17	30	0	0	30	0	0
23	17484484	.	A	G	9	3	12	0	2	14	0	0
23	17509537	.	A	G	14	13	27	0	4	31	0	0
23	17516889	.	C	T	17	14	31	0	2	33	0	0
23	17516897	.	C	T	19	15	34	0	0	34	0	0
23	17520025	.	C	G	17	16	33	0	2	35	0	0
23	17520245	.	T	C	21	11	32	0	0	32	0	0
23	17520311	.	T	G	21	13	34	0	1	35	0	0
23	17520338	.	G	A	14	15	29	0	4	33	0	0
23	17520632	.	A	T	5	4	9	0	0	9	0	0
23	17520870	.	T	C	5	7	12	0	0	12	0	0
23	17523056	.	C	G	3	2	5	0	0	5	0	0
23	17530838	.	G	A	0	3	3	0	2	5	0	0
23	17530854	.	A	T	2	2	4	0	0	4	0	0
23	17656654	.	G	A	16	16	32	0	1	33	0	0
23	17657265	.	G	C	10	16	26	0	1	27	0	0
23	17782767	.	G	A	1	3	4	0	0	4	0	0
23	17812711	.	C	T	26	23	49	0	0	49	0	0
23	17812720	.	T	A	22	27	49	0	1	50	0	0
23	17812755	.	G	T	25	24	49	0	0	49	0	0
23	17813057	.	G	A	17	17	34	2	1	37	0	0
23	17813161	.	T	A	15	13	28	1	7	36	0	0
23	17813717	.	G	A	17	27	44	0	0	44	0	0
23	17813952	.	G	T	8	7	15	0	0	15	0	0
23	17814056	.	G	A	21	22	43	0	1	44	0	0
23	17814223	.	C	T	17	17	34	0	4	38	0	0
23	17814281	.	G	T	23	26	49	0	0	49	0	0
23	17814299	.	A	C	22	24	46	0	1	47	0	0
23	17814408	.	A	C	14	15	29	0	0	29	0	0
23	17842285	.	G	A	1	2	3	0	0	3	0	0
23	17848981	.	A	G	1	2	3	0	0	3	0	0
23	17849044	.	T	A	4	3	7	0	0	7	0	0
23	17849275	.	T	G	7	8	15	0	1	16	0	0
23	17849296	.	C	G	2	12	14	0	10	24	0	0
23	17849627	.	C	T	8	9	17	0	0	17	0	0
23	17851768	.	C	T	0	9	9	0	11	20	0	0
23	17853145	.	T	G	9	6	15	0	0	15	0	0
23	17853396	.	A	T	7	3	10	0	0	10	0	0
23	17855427	.	C	A	6	4	10	0	0	11	1	0
23	17857831	.	G	A	6	8	14	0	0	14	0	0
23	17865973	.	T	C	6	0	6	0	6	12	0	0
23	17870758	.	G	T	1	8	9	0	3	12	0	0
23	17871220	.	A	G	5	0	5	0	4	9	0	0
23	17871893	.	G	C	2	2	4	0	0	4	0	0
23	17872334	.	A	G	3	0	3	0	4	7	0	0
23	17872338	.	C	T	3	3	6	0	0	6	0	0
23	17873750	.	C	A	37	29	66	0	1	67	0	0
23	17879066	.	C	A	6	2	8	0	1	9	0	0
23	17879107	.	C	T	4	9	13	0	0	13	0	0
23	17879152	.	A	T	3	4	7	0	0	7	0	0
23	17879153	.	A	C	5	3	8	0	0	8	0	0
23	17880800	.	C	T	3	6	9	0	1	10	0	0
23	17899284	.	A	C	1	5	6	0	0	6	0	0
23	17901655	.	A	G	5	0	5	0	3	8	0	0
23	17901724	.	A	G	5	0	5	0	9	14	0	0
23	17903519	.	G	A	0	12	12	0	5	17	0	0
23	17903574	.	C	T	6	5	11	0	0	11	0	0
23	17907323	.	A	C	3	4	7	0	0	7	0	0
23	17994354	.	T	C	2	11	13	0	2	15	0	0
23	17994615	.	T	C	5	3	8	0	0	8	0	0
23	17995469	.	G	T	12	3	15	0	0	15	0	0
23	17995521	.	C	A	2	11	13	0	0	13	0	0
23	17996051	.	A	T	5	5	10	0	0	10	0	0
23	17997033	.	A	G	4	14	18	0	0	18	0	0
23	17997043	.	T	C	4	0	4	0	11	15	0	0
23	18001836	.	A	C	6	3	9	0	0	9	0	0
23	18004297	.	A	G	6	9	15	0	0	15	0	0
23	18014942	.	A	G	1	4	5	0	0	5	0	0
23	18032772	.	G	A	3	3	6	0	0	6	0	0
23	18032912	.	A	C	2	4	6	0	0	6	0	0
23	18118922	.	G	A	16	22	38	0	0	38	0	0
23	18119166	.	C	T	20	13	33	0	1	34	0	0
23	18119192	.	T	C	16	0	16	0	17	33	0	0
23	18119399	.	A	G	12	22	34	0	0	34	0	0
23	18286781	.	G	A	6	6	12	0	1	13	0	0
23	18286782	.	C	T	6	6	12	0	0	12	0	0
23	18372065	.	G	C	1	2	3	0	0	3	0	0
23	18372135	.	C	T	1	8	9	0	0	9	0	0
23	18375847	.	G	A	7	18	25	0	0	25	0	0
23	18375853	.	T	C	18	1	19	0	10	29	0	0
23	18387709	.	T	A	30	19	49	0	2	51	0	0
23	18388004	.	G	A	24	6	30	0	0	30	0	0
23	18388166	.	T	A	11	16	27	0	1	28	0	0
23	18388476	.	G	A	8	8	16	0	1	17	0	0
23	18388555	.	A	G	8	20	28	0	0	28	0	0
23	18388620	.	A	C	16	15	31	0	0	31	0	0
23	18388685	.	G	A	16	9	25	0	3	28	0	0
23	18388764	.	G	A	9	11	20	0	0	20	0	0
23	18388858	.	T	G	8	6	14	3	2	19	0	0
23	18388954	.	G	A	11	9	20	0	1	21	0	0
23	18389594	.	G	T	19	14	33	0	0	33	0	0
23	18390402	.	G	A	11	14	25	0	1	26	0	0
23	18390635	.	G	A	10	15	25	0	2	27	0	0
23	18390758	.	T	C	8	0	8	0	20	28	0	0
23	18390780	.	C	T	17	9	26	0	0	26	0	0
23	18391490	.	G	A	13	7	20	0	1	21	0	0
23	18394401	.	T	G	13	16	29	0	3	32	0	0
23	18405812	.	C	T	7	6	13	0	1	14	0	0
23	18405862	.	A	G	11	9	20	0	1	21	0	0
23	18406479	.	G	A	7	12	19	0	0	19	0	0
23	18406573	.	C	A	11	11	22	0	2	24	0	0
23	18409242	.	C	T	18	11	29	0	0	29	0	0
23	18415329	.	G	C	12	11	23	0	0	23	0	0
23	18415427	.	T	A	7	9	16	0	0	16	0	0
23	18415493	.	C	A	1	9	10	0	6	16	0	0
23	18527070	.	C	A	2	2	4	0	0	4	0	0
23	18543166	.	C	T	3	2	5	0	0	5	0	0
23	18561289	.	T	A	17	11	28	0	0	28	0	0
23	18561434	.	C	T	0	10	10	0	12	22	0	0
23	18562299	.	A	T	3	3	6	0	0	6	0	0
23	18562358	.	T	G	7	5	12	0	0	12	0	0
23	18562484	.	G	A	5	9	14	0	1	15	0	0
23	18562522	.	A	C	8	9	17	1	0	18	0	0
23	18562623	.	C	T	10	17	27	0	0	27	0	0
23	18562911	.	C	A	1	19	20	0	12	32	0	0
23	18563951	.	G	T	13	14	27	0	0	27	0	0
23	18563952	.	T	C	12	0	12	0	14	26	0	0
23	18568144	.	G	A	6	12	18	0	0	18	0	0
23	18568206	.	G	A	4	9	13	0	0	13	0	0
23	18568520	.	G	A	1	3	4	0	0	4	0	0
23	18569380	.	T	A	8	4	12	0	0	12	0	0
23	18569399	.	C	A	0	6	6	0	4	10	0	0
23	18569543	.	T	C	15	10	25	0	0	25	0	0
23	18569625	.	A	G	24	15	39	0	0	39	0	0
23	18570887	.	C	T	11	17	28	0	1	29	0	0
23	18570941	.	A	T	16	17	33	1	0	34	0	0
23	18572547	.	T	A	24	12	36	0	1	38	1	0
23	18572605	.	T	A	10	10	20	0	1	21	0	0
23	18572618	.	G	A	9	6	15	0	2	17	0	0
23	18574353	.	G	A	13	10	23	0	0	23	0	0
23	18574720	.	T	C	11	17	28	0	1	29	0	0
23	18574800	.	C	T	1	13	14	0	16	30	0	0
23	18580933	.	C	A	12	18	30	0	1	31	0	0
23	18580939	.	C	A	0	11	11	0	19	30	0	0
23	18581835	.	G	A	18	17	35	0	3	38	0	0
23	18581933	.	T	G	19	24	43	0	2	46	1	0
23	18584225	.	G	A	13	16	29	0	2	31	0	0
23	18586793	.	C	T	3	6	9	0	18	27	0	0
23	18588969	.	C	T	12	10	22	0	2	24	0	0
23	18597667	.	G	A	11	18	29	0	1	30	0	0
23	18616880	.	T	A	10	9	19	0	2	21	0	0
23	18616980	.	C	G	10	8	18	0	0	18	0	0
23	18617300	.	G	A	17	16	33	0	2	35	0	0
23	18619766	.	C	T	13	10	23	0	1	24	0	0
23	18622541	.	T	G	13	9	22	0	0	22	0	0
23	18628460	.	T	G	10	12	22	0	0	22	0	0
23	18628746	.	C	T	13	10	23	0	0	23	0	0
23	18629024	.	T	C	7	7	14	0	1	15	0	0
23	18651789	.	G	A	9	8	17	0	0	17	0	0
23	18651918	.	C	A	9	13	22	0	1	23	0	0
23	18652067	.	T	C	7	15	22	0	3	25	0	0
23	18668440	.	T	C	5	12	17	0	1	18	0	0
23	18707455	.	T	C	2	3	5	0	0	5	0	0
23	18707478	.	C	T	2	2	4	0	1	5	0	0
23	18759802	.	C	A	9	8	17	0	0	17	0	0
23	18759827	.	T	C	5	5	10	0	0	10	0	0
23	18759944	.	C	T	5	5	10	1	0	11	0	0
23	18760004	.	G	C	7	1	8	0	4	12	0	0
23	18760049	.	T	A	10	5	15	0	0	15	0	0
23	18760223	.	T	A	2	6	8	0	0	8	0	0
23	18760256	.	C	T	3	2	5	0	0	5	0	0
23	18760519	.	T	A	7	8	15	0	0	15	0	0
23	18764770	.	A	C	3	7	10	0	0	10	0	0
23	18769005	.	T	G	2	8	10	0	0	10	0	0
23	18769161	.	T	C	10	0	10	0	5	15	0	0
23	18774122	.	T	C	9	6	15	1	0	16	0	0
23	18777816	.	C	T	6	3	9	0	0	9	0	0
23	18795055	.	T	C	6	6	12	0	1	13	0	0
23	18795620	.	A	G	16	19	35	0	0	35	0	0
23	18795721	.	C	T	21	17	38	1	1	40	0	0
23	18801275	.	G	A	16	20	36	0	3	39	0	0
23	18869550	.	C	A	0	4	4	0	5	9	0	0
23	18870235	.	A	T	8	5	13	0	1	14	0	0
23	18870245	.	T	C	7	0	7	0	10	17	0	0
23	18870716	.	G	T	5	6	11	0	0	11	0	0
23	18944489	.	A	G	8	4	12	0	1	13	0	0
23	18944543	.	G	A	0	17	17	0	13	30	0	0
23	18947344	.	C	A	16	17	33	0	0	33	0	0
23	18947385	.	G	C	15	18	33	0	1	34	0	0
23	18950968	.	T	C	13	11	24	0	1	25	0	0
23	18950970	.	T	A	12	11	23	0	0	23	0	0
23	18951010	.	G	A	8	10	18	0	1	19	0	0
23	18954023	.	A	G	11	10	21	0	1	22	0	0
23	18954100	.	A	G	6	7	13	0	0	13	0	0
23	18954151	.	G	A	11	5	16	0	0	16	0	0
23	18954759	.	T	G	20	14	34	0	0	34	0	0
23	18979342	.	C	T	19	18	37	0	2	39	0	0
23	18979561	.	G	A	23	19	42	0	4	46	0	0
23	18979756	.	T	C	9	11	20	0	2	22	0	0
23	18982375	.	G	A	14	9	23	0	0	23	0	0
23	18986338	.	G	A	7	11	18	0	2	20	0	0
23	18986344	.	G	A	10	9	19	0	0	19	0	0
23	18990914	.	C	T	1	10	11	0	7	18	0	0
23	18993525	.	T	C	24	7	31	0	0	31	0	0
23	18993827	.	C	T	2	5	7	0	18	25	0	0
23	18996030	.	C	T	10	14	24	0	1	25	0	0
23	19003263	.	A	G	12	8	20	0	0	20	0	0
23	19005426	.	G	T	13	5	18	0	1	19	0	0
23	19005486	.	T	C	14	10	24	0	1	25	0	0
23	19005758	.	C	T	5	4	9	0	0	9	0	0
23	19005761	.	C	G	6	3	9	0	1	10	0	0
23	19007389	.	G	T	9	9	18	0	1	19	0	0
23	19008149	.	C	T	7	5	12	0	1	13	0	0
23	19012845	.	C	G	11	8	19	0	0	19	0	0
23	19017421	.	C	A	5	5	10	0	0	10	0	0
23	19017466	.	G	T	8	7	15	0	1	16	0	0
23	19022254	.	A	G	14	4	18	0	0	18	0	0
23	19022534	.	G	A	4	8	12	0	1	13	0	0
23	19027408	.	G	A	4	7	11	0	0	11	0	0
23	19027510	.	A	C	7	0	7	0	5	12	0	0
23	19032787	.	C	T	1	3	4	0	0	4	0	0
23	19035542	.	A	G	5	6	11	0	0	11	0	0
23	19036052	.	C	G	12	8	20	0	1	21	0	0
23	19042706	.	A	T	3	5	8	0	2	10	0	0
23	19051645	.	C	T	4	3	7	0	1	8	0	0
23	19051737	.	C	T	10	7	17	0	0	17	0	0
23	19051739	.	G	A	8	7	15	0	1	16	0	0
23	19051831	.	C	T	8	3	11	0	3	14	0	0
23	19098900	.	G	A	1	3	4	0	0	4	0	0
23	19106781	.	G	A	10	4	14	0	0	14	0	0
23	19118372	.	G	T	5	6	11	0	1	12	0	0
23	19118960	.	G	T	3	2	5	0	0	5	0	0
23	19153221	.	A	T	3	3	6	0	0	6	0	0
23	19181008	.	A	C	14	3	17	10	0	27	0	0
23	19198348	.	A	T	8	8	16	0	0	16	0	0
23	19198588	.	A	T	13	7	20	0	0	20	0	0
23	19200168	.	G	A	9	8	17	0	0	17	0	0
23	19201103	.	C	A	8	8	16	0	0	16	0	0
23	19201148	.	G	T	2	2	4	0	0	4	0	0
23	19202958	.	A	G	1	4	5	0	0	5	0	0
23	19203952	.	C	T	2	4	6	0	1	7	0	0
23	19204126	.	C	T	1	5	6	0	1	7	0	0
23	19204130	.	T	C	1	5	6	0	1	7	0	0
23	19204597	.	G	A	3	3	6	0	0	6	0	0
23	19205844	.	A	C	2	2	4	0	0	4	0	0
23	19221073	.	G	T	2	2	4	0	0	4	0	0
23	19250355	.	T	A	2	2	4	0	0	4	0	0
23	19250476	.	G	T	4	2	6	0	0	6	0	0
23	19257756	.	C	T	1	2	3	0	2	5	0	0
23	19312731	.	C	G	0	2	2	1	2	5	0	0
23	19312737	.	A	G	0	2	2	1	0	3	0	0
23	19312803	.	C	T	0	2	2	0	1	3	0	0
23	19312824	.	G	A	1	2	3	0	0	3	0	0
23	19434147	.	A	G	1	4	5	0	1	6	0	0
23	19474823	.	G	T	7	10	17	0	1	18	0	0
23	19483010	.	C	T	1	6	7	0	7	14	0	0
23	19483260	.	A	G	6	2	8	0	0	8	0	0
23	19483497	.	A	C	10	0	10	0	5	15	0	0
23	19484162	.	C	T	3	3	6	0	0	6	0	0
23	19575044	.	G	A	1	16	17	0	12	29	0	0
23	19575134	.	C	T	17	19	36	0	1	37	0	0
23	19577464	.	G	A	3	28	31	0	14	45	0	0
23	19582481	.	T	C	21	16	37	0	1	38	0	0
23	19582559	.	G	T	13	8	21	0	0	21	0	0
23	19582668	.	T	C	23	15	38	0	1	39	0	0
23	19582678	.	C	T	24	14	38	0	0	38	0	0
23	19583208	.	G	A	1	8	9	0	12	21	0	0
23	19583252	.	C	T	15	10	25	0	0	25	0	0
23	19603630	.	T	C	29	30	59	1	2	62	0	0
23	19603753	.	T	C	37	21	58	1	1	60	0	0
23	19603803	.	T	C	20	26	46	0	2	48	0	0
23	19603880	.	A	T	23	17	40	0	1	41	0	0
23	19603994	.	G	A	21	16	37	0	1	38	0	0
23	19604263	.	A	G	15	0	15	0	19	34	0	0
23	19604351	.	G	T	7	10	17	0	0	17	0	0
23	19670139	.	G	C	8	3	11	0	0	11	0	0
23	19670185	.	A	T	10	12	22	0	1	23	0	0
23	19672720	.	T	C	8	12	20	0	0	20	0	0
23	19673170	.	C	T	15	10	25	0	1	26	0	0
23	19673376	.	C	T	9	10	19	0	2	21	0	0
23	19704279	.	G	A	1	2	3	0	0	3	0	0
23	19712898	.	G	A	28	38	66	0	2	68	0	0
23	19713291	.	A	G	32	34	66	1	3	70	0	0
23	19713324	.	A	G	30	32	62	1	7	70	0	0
23	19759280	.	G	C	1	6	7	0	0	7	0	0
23	19759370	.	T	C	4	2	6	0	0	6	0	0
23	19775565	.	C	T	2	4	6	0	1	7	0	0
23	19786351	.	C	T	4	1	5	0	0	5	0	0
23	19786363	.	T	C	3	2	5	0	0	5	0	0
23	19788102	.	T	C	3	3	6	0	0	6	0	0
23	19788562	.	A	T	5	6	11	0	1	12	0	0
23	19790413	.	A	G	5	4	9	0	0	9	0	0
23	19790452	.	G	A	0	4	4	0	5	9	0	0
23	19790712	.	C	T	3	2	5	0	0	5	0	0
23	19792704	.	G	A	8	4	12	0	0	12	0	0
23	19792737	.	C	T	4	6	10	0	0	10	0	0
23	19792821	.	T	C	3	3	6	0	0	6	0	0
23	19796643	.	A	T	8	3	11	0	0	11	0	0
23	19796651	.	G	A	7	2	9	0	1	10	0	0
23	19798168	.	T	C	6	2	8	0	1	9	0	0
23	19798174	.	A	G	8	2	10	0	0	10	0	0
23	19798216	.	T	C	5	4	9	0	0	9	0	0
23	19798493	.	T	C	3	4	7	0	0	7	0	0
23	19800228	.	T	C	6	5	11	0	0	11	0	0
23	19804543	.	C	A	8	3	11	0	1	12	0	0
23	19804878	.	T	C	2	4	6	0	0	6	0	0
23	19805577	.	A	T	6	2	8	0	0	8	0	0
23	19808022	.	C	T	12	6	18	0	1	19	0	0
23	19808078	.	T	C	7	8	15	0	0	15	0	0
23	19808691	.	G	A	0	14	14	0	8	22	0	0
23	19808895	.	A	G	3	1	4	0	6	10	0	0
23	19815467	.	G	A	9	14	23	0	1	24	0	0
23	19816699	.	A	T	10	9	19	0	0	19	0	0
23	19821136	.	A	G	6	1	7	1	11	19	0	0
23	19821150	.	C	T	7	12	19	0	0	19	0	0
23	19821277	.	A	C	9	10	19	0	2	21	0	0
23	19821408	.	C	T	4	6	10	0	0	10	0	0
23	19821447	.	G	C	6	2	8	0	0	8	0	0
23	19822100	.	G	T	1	2	3	0	0	3	0	0
23	19825629	.	C	T	0	4	4	0	1	5	0	0
23	19825653	.	G	C	2	2	4	0	1	5	0	0
23	19825909	.	C	T	0	3	3	0	1	4	0	0
23	19835308	.	T	C	37	15	52	0	1	53	0	0
23	19836260	.	C	T	33	20	53	0	3	56	0	0
23	19837080	.	T	C	27	34	61	0	4	65	0	0
23	19837503	.	G	A	28	23	51	0	4	55	0	0
23	19837939	.	A	G	16	17	33	0	1	34	0	0
23	19837974	.	G	A	15	16	31	0	0	31	0	0
23	19838100	.	C	A	28	26	54	0	1	55	0	0
23	19838295	.	T	G	5	5	10	0	1	11	0	0
23	19838312	.	A	T	6	7	13	0	0	13	0	0
23	19838387	.	A	T	12	15	27	0	3	30	0	0
23	19838388	.	T	A	13	17	30	0	1	31	0	0
23	19838458	.	A	T	15	17	32	0	1	33	0	0
23	19838459	.	A	C	15	17	32	0	1	33	0	0
23	19869132	.	G	A	19	18	37	0	2	39	0	0
23	19871615	.	A	G	34	22	56	0	1	57	0	0
23	19879576	.	C	T	2	13	15	0	32	47	0	0
23	19883318	.	T	C	28	14	42	0	2	44	0	0
23	19893409	.	A	T	23	31	54	0	1	55	0	0
23	19933542	.	A	G	18	19	37	1	4	42	0	0
23	19933578	.	G	A	20	14	34	1	2	37	0	0
23	19933742	.	G	A	13	18	31	0	1	32	0	0
23	19933850	.	A	G	18	16	34	0	1	35	0	0
23	19933896	.	A	G	20	18	38	0	2	40	0	0
23	19933952	.	A	G	19	20	39	0	2	41	0	0
23	19952743	.	C	T	1	20	21	0	28	49	0	0
23	19952869	.	T	A	20	20	40	0	2	42	0	0
23	19969136	.	C	A	2	3	5	0	0	5	0	0
23	19969552	.	A	T	3	2	5	0	0	5	0	0
23	19969557	.	T	A	4	2	6	0	0	6	0	0
23	19969710	.	G	A	5	7	12	0	0	12	0	0
23	19974092	.	G	A	2	4	6	0	0	6	0	0
23	19976882	.	G	C	2	3	5	0	0	5	0	0
23	19980707	.	A	T	3	3	6	0	0	6	0	0
23	19980896	.	A	C	3	2	5	0	0	5	0	0
23	19981510	.	G	T	6	6	12	0	0	13	1	0
23	19981554	.	T	C	3	6	9	0	0	9	0	0
23	19981608	.	A	T	4	4	8	0	0	8	0	0
23	19985054	.	A	G	7	6	13	0	1	14	0	0
23	19985201	.	A	G	3	6	9	0	0	9	0	0
23	19985210	.	G	T	3	7	10	0	0	10	0	0
23	19985307	.	G	T	2	2	4	0	1	5	0	0
23	19985403	.	T	C	10	5	15	0	1	16	0	0
23	20000716	.	A	G	5	6	11	0	5	16	0	0
23	20002339	.	G	C	9	7	16	0	0	16	0	0
23	20002439	.	G	C	10	0	10	0	3	13	0	0
23	20002524	.	A	G	5	5	10	0	0	10	0	0
23	20010287	.	T	A	5	3	8	0	0	8	0	0
23	20010481	.	A	C	5	0	5	0	5	10	0	0
23	20014390	.	C	T	0	3	3	0	3	6	0	0
23	20014407	.	A	T	3	4	7	0	1	8	0	0
23	20014474	.	T	A	7	5	12	0	0	12	0	0
23	20014486	.	C	T	0	3	3	0	9	12	0	0
23	20014802	.	T	A	5	6	11	0	0	11	0	0
23	20014811	.	C	T	0	4	4	0	5	9	0	0
23	20015234	.	T	C	1	2	3	0	0	3	0	0
23	20015251	.	T	C	1	3	4	0	0	4	0	0
23	20015819	.	C	T	3	2	5	0	0	5	0	0
23	20015822	.	C	T	0	2	2	0	3	5	0	0
23	20021141	.	A	G	1	3	4	0	0	4	0	0
23	20022144	.	A	G	2	2	4	0	0	4	0	0
23	20051300	.	A	T	2	3	5	0	0	5	0	0
23	20051340	.	G	A	1	3	4	0	0	4	0	0
23	20051353	.	C	G	1	2	3	0	0	3	0	0
23	20091430	.	C	T	1	2	3	0	0	3	0	0
23	20113599	.	T	C	18	16	34	0	1	35	0	0
23	20113848	.	G	T	23	13	36	0	1	37	0	0
23	20114327	.	C	A	32	17	49	0	2	51	0	0
23	20117625	.	C	G	0	14	14	0	19	33	0	0
23	20117830	.	A	G	23	15	38	0	2	40	0	0
23	20117938	.	A	C	16	0	16	0	20	36	0	0
23	20118597	.	T	G	17	19	36	0	0	36	0	0
23	20118730	.	T	A	17	16	33	0	1	34	0	0
23	20120646	.	T	C	21	2	23	0	16	39	0	0
23	20121265	.	T	A	31	14	45	0	5	50	0	0
23	20121270	.	G	T	34	16	50	0	0	50	0	0
23	20121326	.	G	A	21	23	44	0	1	45	0	0
23	20122190	.	A	G	22	14	36	0	2	38	0	0
23	20123375	.	G	A	24	12	36	0	0	36	0	0
23	20123386	.	G	T	21	8	29	0	4	33	0	0
23	20123575	.	C	A	25	6	31	0	0	31	0	0
23	20123576	.	C	T	25	5	30	0	1	31	0	0
23	20123629	.	A	G	16	21	37	0	2	39	0	0
23	20139320	.	T	C	1	3	4	0	0	4	0	0
23	20142886	.	G	A	1	2	3	0	0	3	0	0
23	20143177	.	G	A	3	4	7	0	0	7	0	0
23	20145420	.	T	A	13	15	28	0	2	30	0	0
23	20145823	.	T	C	5	11	16	0	0	16	0	0
23	20146080	.	A	G	10	9	19	0	0	19	0	0
23	20152477	.	T	C	8	9	17	0	1	18	0	0
23	20152640	.	G	A	13	14	27	0	2	29	0	0
23	20154486	.	A	G	5	12	17	0	1	18	0	0
23	20157790	.	G	A	13	10	23	0	1	24	0	0
23	20157923	.	G	C	10	0	10	0	5	15	0	0
23	20157930	.	T	C	11	1	12	0	5	17	0	0
23	20159225	.	C	T	0	8	8	0	6	14	0	0
23	20159234	.	G	T	6	7	13	0	0	13	0	0
23	20162522	.	C	T	1	5	6	0	7	13	0	0
23	20167966	.	G	A	7	6	13	0	0	13	0	0
23	20168111	.	T	A	6	12	18	0	0	18	0	0
23	20168127	.	C	T	2	12	14	0	5	19	0	0
23	20168404	.	C	G	7	16	23	0	0	23	0	0
23	20168568	.	T	C	5	5	10	0	0	10	0	0
23	20168573	.	A	G	3	6	9	0	1	10	0	0
23	20168642	.	G	A	7	8	15	0	0	15	0	0
23	20168739	.	T	C	11	7	18	0	0	18	0	0
23	20169105	.	C	G	0	3	3	0	8	11	0	0
23	20170945	.	T	A	8	2	10	0	2	12	0	0
23	20183551	.	A	G	1	4	5	0	0	5	0	0
23	20189590	.	T	G	2	2	4	0	0	4	0	0
23	20190137	.	T	C	1	3	4	0	0	4	0	0
23	20191595	.	G	C	1	0	1	0	2	3	0	0
23	20192748	.	T	C	3	3	6	0	0	6	0	0
23	20193137	.	G	A	3	3	6	0	0	6	0	0
23	20193272	.	T	C	1	0	1	0	2	3	0	0
23	20262546	.	G	T	1	2	3	0	0	3	0	0
23	20264937	.	T	C	1	3	4	0	0	4	0	0
23	21111170	.	A	G	16	0	16	0	9	25	0	0
23	21805482	.	G	A	6	2	8	0	0	8	0	0
23	21997751	.	T	G	4	0	4	0	3	7	0	0
23	22874433	.	T	A	4	5	9	0	0	9	0	0
23	22876775	.	G	A	6	9	15	0	1	16	0	0
23	22886149	.	C	T	13	8	21	0	0	21	0	0
23	22888817	.	G	A	6	5	11	0	0	11	0	0
23	22918609	.	A	T	9	12	21	0	2	23	0	0
23	22919817	.	C	T	22	10	32	0	4	36	0	0
23	22919883	.	T	C	18	19	37	0	4	41	0	0
23	22920221	.	T	A	18	14	32	0	5	37	0	0
23	22920594	.	C	T	18	21	39	0	3	42	0	0
23	22923021	.	A	C	18	13	31	0	6	37	0	0
23	22923057	.	A	G	18	0	18	0	17	35	0	0
23	22923093	.	C	T	16	18	34	0	3	37	0	0
23	22923147	.	C	T	19	18	37	0	0	38	1	0
23	22923198	.	C	T	12	12	24	0	3	28	1	0
23	22923537	.	C	T	20	16	36	0	3	39	0	0
23	23096495	.	A	G	7	0	7	0	3	10	0	0
23	23096497	.	G	C	9	3	12	0	0	12	0	0
23	23118653	.	A	T	8	9	17	0	0	17	0	0
23	23118815	.	C	T	4	6	10	0	0	10	0	0
23	23122178	.	G	A	1	9	10	0	8	18	0	0
23	23122381	.	C	T	3	8	11	0	1	12	0	0
23	23122412	.	G	A	1	5	6	0	11	17	0	0
23	23122528	.	C	T	7	5	12	0	0	12	0	0
23	23122898	.	A	G	7	7	14	0	1	15	0	0
23	23123146	.	G	T	4	4	8	0	1	9	0	0
23	23123420	.	G	T	3	6	9	0	1	10	0	0
23	23126414	.	A	G	1	5	6	0	0	6	0	0
23	23126447	.	G	A	3	5	8	0	0	8	0	0
23	23126621	.	T	C	2	4	6	0	0	6	0	0
23	23136745	.	G	A	3	6	9	0	0	9	0	0
23	23154388	.	T	A	3	8	11	0	1	12	0	0
23	23160057	.	C	T	6	3	9	0	0	9	0	0
23	23171172	.	C	T	2	6	8	0	1	9	0	0
23	23174035	.	A	G	2	4	6	0	0	6	0	0
23	23174059	.	G	A	6	2	8	0	0	8	0	0
23	23174799	.	C	A	2	4	6	0	0	7	1	0
23	23174808	.	A	C	5	2	7	0	0	7	0	0
23	23178359	.	G	A	3	2	5	0	0	5	0	0
23	23182145	.	C	T	11	3	14	0	0	14	0	0
23	23204533	.	A	T	17	5	22	0	0	22	0	0
23	23212257	.	C	T	4	24	28	0	0	28	0	0
23	23213068	.	A	C	3	8	11	0	0	11	0	0
23	23213069	.	A	C	3	8	11	0	0	11	0	0
23	23399987	.	T	C	6	5	11	0	1	12	0	0
23	23400032	.	A	G	6	4	10	0	1	11	0	0
23	23487818	.	G	A	0	3	3	0	2	5	0	0
23	23658506	.	T	A	7	6	13	0	1	14	0	0
23	23658708	.	A	T	5	10	15	0	1	16	0	0
23	23658766	.	C	T	6	8	14	0	0	14	0	0
23	23754415	.	C	T	14	7	21	0	0	21	0	0
23	23794656	.	T	C	14	16	30	0	0	30	0	0
23	23830952	.	T	C	10	9	19	0	3	22	0	0
23	23830985	.	C	G	15	13	28	0	0	28	0	0
23	23860113	.	T	A	7	18	25	0	1	26	0	0
23	23860117	.	G	A	6	18	24	0	1	25	0	0
23	23863569	.	G	A	15	18	33	0	1	34	0	0
23	23869182	.	T	C	19	11	30	0	1	31	0	0
23	23877088	.	A	G	25	0	25	0	13	38	0	0
23	23888136	.	G	A	3	13	16	0	29	45	0	0
23	23890928	.	T	C	9	25	34	0	3	37	0	0
23	23891535	.	C	T	22	12	34	0	1	35	0	0
23	23891551	.	G	A	4	13	17	0	16	33	0	0
23	23903278	.	G	A	2	22	24	0	14	38	0	0
23	23903308	.	C	T	21	10	31	0	1	32	0	0
23	23912720	.	G	T	22	15	37	0	2	39	0	0
23	23912723	.	C	A	24	16	40	0	0	40	0	0
23	23912881	.	C	T	16	20	36	0	0	36	0	0
23	23913054	.	T	A	14	4	18	0	1	19	0	0
23	23913240	.	G	T	12	16	28	0	2	30	0	0
23	23913417	.	T	C	28	28	56	0	1	57	0	0
23	23913818	.	A	T	19	21	40	0	0	40	0	0
23	23913832	.	G	A	24	16	40	0	0	40	0	0
23	23913858	.	A	C	18	25	43	0	0	43	0	0
23	23914176	.	A	T	18	13	31	0	4	35	0	0
23	23973724	.	T	A	10	3	13	0	0	13	0	0
23	23977689	.	T	C	6	4	10	0	0	10	0	0
23	23994646	.	C	A	13	4	17	0	0	17	0	0
23	23995260	.	T	A	4	5	9	0	0	9	0	0
23	23995278	.	T	A	7	4	11	0	0	11	0	0
23	23995349	.	A	T	9	5	14	0	0	14	0	0
23	23995375	.	C	T	3	9	12	0	0	12	0	0
23	24144860	.	A	G	5	4	9	0	0	9	0	0
23	24144872	.	T	C	4	4	8	0	0	8	0	0
23	24167144	.	C	G	2	6	8	0	0	8	0	0
23	24167169	.	C	G	2	4	6	0	0	6	0	0
23	24167254	.	T	A	4	5	9	0	0	9	0	0
23	24176425	.	C	T	2	20	22	0	22	44	0	0
23	24176474	.	A	G	18	19	37	0	0	37	0	0
23	24178789	.	C	T	0	11	11	0	13	24	0	0
23	24181913	.	G	A	14	11	25	0	1	26	0	0
23	24183523	.	A	C	13	11	24	0	2	26	0	0
23	24190677	.	C	T	9	10	19	0	0	19	0	0
23	24195611	.	T	C	8	0	8	6	4	18	0	0
23	24202583	.	A	T	8	3	11	0	0	11	0	0
23	24202734	.	C	A	0	7	7	0	6	13	0	0
23	24202754	.	A	C	6	0	6	0	6	12	0	0
23	24202833	.	G	A	3	11	14	0	0	14	0	0
23	24202859	.	A	T	4	9	13	0	0	13	0	0
23	24202985	.	T	C	3	11	14	0	1	15	0	0
23	24207787	.	G	A	6	3	9	0	0	9	0	0
23	24208208	.	G	C	6	8	14	0	0	14	0	0
23	24209873	.	C	T	0	2	2	0	2	4	0	0
23	24214381	.	G	A	6	8	14	0	0	14	0	0
23	24216339	.	A	C	3	0	3	0	8	11	0	0
23	24219220	.	G	A	4	4	8	0	0	8	0	0
23	24227400	.	G	A	6	3	9	0	0	9	0	0
23	24227696	.	C	T	15	13	28	0	2	30	0	0
23	24227702	.	T	A	15	12	27	0	2	29	0	0
23	24229110	.	G	A	11	15	26	0	2	28	0	0
23	24231596	.	T	C	21	8	29	0	1	30	0	0
23	24233831	.	A	G	15	13	28	0	0	28	0	0
23	24234181	.	T	C	4	15	19	0	0	20	1	0
23	24234232	.	T	C	9	18	27	0	0	27	0	0
23	24239009	.	C	T	16	9	25	0	0	25	0	0
23	24241090	.	C	G	1	7	8	0	7	15	0	0
23	24243168	.	G	A	3	5	8	0	0	8	0	0
23	24244694	.	C	T	0	5	5	0	6	11	0	0
23	24246864	.	A	G	5	8	13	0	0	13	0	0
23	24249074	.	G	T	11	9	20	0	0	20	0	0
23	24249227	.	C	T	11	8	19	0	2	21	0	0
23	24251531	.	C	A	8	8	16	0	1	17	0	0
23	24253171	.	T	G	2	5	7	0	0	7	0	0
23	24263392	.	G	A	2	2	4	0	0	4	0	0
23	24301297	.	C	T	3	5	8	0	1	9	0	0
23	24304648	.	T	C	5	4	9	0	0	9	0	0
23	24308629	.	A	C	4	5	9	0	0	9	0	0
23	24315930	.	G	A	3	3	6	0	0	6	0	0
23	24439480	.	G	T	10	12	22	0	1	23	0	0
23	24439580	.	T	C	21	0	21	0	25	46	0	0
23	24439780	.	G	A	10	15	25	0	2	27	0	0
23	24440031	.	C	T	6	3	9	0	0	9	0	0
23	24440414	.	C	A	11	14	25	0	0	25	0	0
23	24443161	.	G	T	9	13	22	0	0	22	0	0
23	24444279	.	C	T	16	9	25	0	0	25	0	0
23	24444803	.	T	G	16	16	32	0	0	32	0	0
23	24444861	.	G	A	14	17	31	0	0	31	0	0
23	24445112	.	G	T	24	14	38	0	1	39	0	0
23	24445584	.	A	G	15	13	28	0	1	29	0	0
23	24445906	.	G	C	7	18	25	0	1	26	0	0
23	24446040	.	T	A	6	15	21	0	0	21	0	0
23	24446411	.	C	T	10	15	25	0	1	26	0	0
23	24447113	.	C	T	12	10	22	0	1	23	0	0
23	24447534	.	C	T	0	10	10	0	6	16	0	0
23	24448071	.	T	A	6	9	15	0	0	15	0	0
23	24448568	.	T	A	11	10	21	0	0	21	0	0
23	24448621	.	G	C	6	8	14	0	0	14	0	0
23	24448630	.	G	T	5	7	12	0	1	13	0	0
23	24450618	.	G	A	11	4	15	0	0	15	0	0
23	24451083	.	A	G	8	5	13	0	0	13	0	0
23	24451283	.	A	G	9	9	18	0	1	19	0	0
23	24451920	.	T	A	6	8	14	0	2	16	0	0
23	24452496	.	C	T	4	6	10	0	0	10	0	0
23	24452508	.	G	A	4	5	9	0	0	9	0	0
23	24475749	.	G	T	3	6	9	0	1	10	0	0
23	24483315	.	G	C	9	5	14	0	1	15	0	0
23	24507550	.	A	G	10	6	16	0	1	17	0	0
23	24507555	.	T	C	11	7	18	0	0	18	0	0
23	24508155	.	A	T	7	6	13	1	2	16	0	0
23	24508422	.	T	G	7	10	17	0	1	18	0	0
23	24508500	.	C	T	11	5	16	0	1	17	0	0
23	24508630	.	T	C	7	12	19	0	1	20	0	0
23	24513096	.	C	T	0	3	3	0	2	5	0	0
23	24538892	.	T	A	3	2	5	0	0	5	0	0
23	24581809	.	G	A	18	12	30	0	0	30	0	0
23	24582165	.	G	A	9	9	18	0	1	19	0	0
23	24582185	.	C	T	10	11	21	0	0	21	0	0
23	24589983	.	G	A	2	2	4	0	0	4	0	0
23	24590274	.	T	C	1	3	4	0	0	4	0	0
23	24590361	.	C	A	2	3	5	0	0	5	0	0
23	24591051	.	A	T	1	5	6	0	0	6	0	0
23	24591658	.	C	T	4	1	5	0	0	5	0	0
23	24591676	.	G	A	6	2	8	0	0	8	0	0
23	24591764	.	G	A	4	4	8	0	1	9	0	0
23	24591799	.	G	A	1	6	7	0	0	7	0	0
23	24591808	.	G	A	1	6	7	0	0	7	0	0
23	24595720	.	C	T	4	2	6	0	1	7	0	0
23	24595725	.	C	G	3	3	6	0	0	6	0	0
23	24595782	.	T	A	3	4	7	0	1	8	0	0
23	24600513	.	C	T	12	11	23	0	1	24	0	0
23	24600947	.	T	C	13	8	21	0	0	21	0	0
23	24604042	.	C	T	14	19	33	0	0	33	0	0
23	24604323	.	C	T	10	15	25	0	1	26	0	0
23	24604461	.	A	G	10	0	10	0	8	18	0	0
23	24605243	.	T	A	15	12	27	0	0	27	0	0
23	24608805	.	G	A	9	7	16	0	0	16	0	0
23	24608847	.	G	A	1	11	12	0	11	23	0	0
23	24611786	.	G	A	0	4	4	0	10	14	0	0
23	24652909	.	G	A	0	4	4	0	5	9	0	0
23	24652929	.	G	A	0	7	7	0	2	9	0	0
23	24653640	.	T	C	6	2	8	0	0	8	0	0
23	24654287	.	G	T	9	3	12	0	0	12	0	0
23	24654391	.	A	T	3	3	6	0	0	6	0	0
23	24655227	.	T	C	5	4	9	0	0	9	0	0
23	24655478	.	C	T	2	3	5	0	0	5	0	0
23	24655761	.	T	G	9	1	10	0	11	21	0	0
23	24655833	.	A	G	7	6	13	0	0	13	0	0
23	24659777	.	C	T	5	9	14	0	0	14	0	0
23	24661762	.	A	G	8	1	9	0	7	16	0	0
23	24661851	.	C	T	11	8	19	0	0	19	0	0
23	24669319	.	A	T	22	9	31	0	0	31	0	0
23	24669381	.	C	T	1	7	8	0	12	20	0	0
23	24669561	.	A	G	16	10	26	0	0	26	0	0
23	24669633	.	T	C	14	0	14	0	11	25	0	0
23	24676192	.	G	C	14	10	24	0	1	25	0	0
23	24694096	.	C	T	7	15	22	0	0	22	0	0
23	24694184	.	G	C	22	10	32	0	0	32	0	0
23	24694242	.	C	A	25	10	35	0	1	36	0	0
23	24694387	.	A	G	20	19	39	0	1	40	0	0
23	24694756	.	C	T	19	21	40	0	0	40	0	0
23	24696943	.	A	G	15	21	36	0	0	36	0	0
23	24697036	.	G	A	20	18	38	0	1	39	0	0
23	24697287	.	A	C	19	20	39	0	0	39	0	0
23	24699281	.	T	A	21	28	49	0	2	51	0	0
23	24819831	.	C	G	14	11	25	0	1	26	0	0
23	24819936	.	G	A	13	16	29	0	1	30	0	0
23	24823899	.	T	C	10	11	21	0	0	21	0	0
23	24824048	.	C	T	8	7	15	0	1	16	0	0
23	24824056	.	G	A	6	6	12	0	0	12	0	0
23	24926470	.	G	A	10	11	21	0	2	23	0	0
23	24932979	.	G	A	16	6	22	0	0	22	0	0
23	24933121	.	C	T	12	9	21	0	1	22	0	0
23	24934567	.	T	C	11	10	21	0	1	22	0	0
23	24934597	.	C	G	9	12	21	0	1	22	0	0
23	24934646	.	G	A	10	9	19	0	1	20	0	0
23	24937143	.	T	C	20	14	34	0	5	39	0	0
23	24937357	.	T	C	13	13	26	0	1	27	0	0
23	24937676	.	T	C	6	6	12	0	0	12	0	0
23	24937750	.	T	A	7	10	17	0	2	19	0	0
23	24937813	.	G	A	7	4	11	0	0	11	0	0
23	24937848	.	T	C	6	5	11	0	1	12	0	0
23	24937905	.	C	A	3	3	6	0	1	7	0	0
23	24938401	.	G	A	8	6	14	0	4	18	0	0
23	24938446	.	T	C	8	5	13	0	1	14	0	0
23	24938559	.	T	C	4	7	11	0	0	11	0	0
23	24938627	.	G	A	6	2	8	0	0	8	0	0
23	24938642	.	C	T	5	2	7	0	0	7	0	0
23	24938791	.	A	G	3	0	3	0	4	7	0	0
23	24938901	.	G	A	3	4	7	0	0	7	0	0
23	24939008	.	T	C	3	4	7	0	1	8	0	0
23	24941449	.	T	C	4	4	8	0	0	8	0	0
23	24941479	.	C	A	3	5	8	0	0	8	0	0
23	24941524	.	T	C	4	4	8	0	0	8	0	0
23	24941572	.	G	A	4	3	7	0	0	7	0	0
23	24944247	.	G	A	2	3	5	0	1	6	0	0
23	24948934	.	C	G	3	3	6	0	0	6	0	0
23	24955580	.	C	T	3	2	5	0	0	5	0	0
23	24956985	.	A	T	2	4	6	0	0	6	0	0
23	24957161	.	G	C	4	5	9	0	1	10	0	0
23	24957184	.	A	G	9	0	9	0	4	13	0	0
23	24959374	.	G	C	4	4	8	0	0	8	0	0
23	24960393	.	T	A	3	4	7	0	0	7	0	0
23	24968676	.	C	A	8	4	12	0	0	12	0	0
23	24970331	.	A	G	6	0	6	0	8	14	0	0
23	24970564	.	G	A	6	3	9	0	0	9	0	0
23	24973857	.	C	T	3	11	14	0	0	14	0	0
23	24973871	.	T	C	3	12	15	0	0	15	0	0
23	24980093	.	A	G	6	1	7	0	5	12	0	0
23	24980415	.	G	A	3	4	7	0	0	7	0	0
23	24983469	.	C	G	4	2	6	0	0	6	0	0
23	24983479	.	G	C	4	2	6	0	0	6	0	0
23	24984588	.	T	A	3	3	6	0	0	6	0	0
23	24984969	.	A	C	5	3	8	0	1	9	0	0
23	25009886	.	A	G	1	4	5	0	0	5	0	0
23	25009935	.	C	T	3	3	6	0	0	6	0	0
23	25012510	.	G	T	2	4	6	0	0	6	0	0
23	25012584	.	T	C	6	11	17	0	0	17	0	0
23	25014445	.	G	C	7	10	17	0	0	17	0	0
23	25122283	.	T	A	7	4	11	0	1	12	0	0
23	25132264	.	G	A	17	15	32	0	1	33	0	0
23	25135899	.	C	G	5	5	10	0	0	10	0	0
23	25135944	.	T	A	8	12	20	0	1	21	0	0
23	25135945	.	T	A	8	13	21	0	0	21	0	0
23	25136067	.	G	A	2	5	7	0	0	7	0	0
23	25149777	.	C	T	15	11	26	0	2	28	0	0
23	25149921	.	A	G	11	9	20	0	0	20	0	0
23	25172729	.	A	C	5	4	9	0	0	9	0	0
23	25173282	.	C	T	5	3	8	0	0	8	0	0
23	25211392	.	T	G	16	9	25	0	0	25	0	0
23	25211419	.	C	A	9	15	24	0	0	24	0	0
23	25217774	.	C	T	7	9	16	0	0	16	0	0
23	25218647	.	C	G	13	14	27	0	0	27	0	0
23	25218728	.	G	A	6	9	15	0	0	15	0	0
23	25218850	.	A	G	12	10	22	0	0	22	0	0
23	25218854	.	A	G	10	10	20	0	1	21	0	0
23	25220160	.	A	G	10	6	16	0	3	19	0	0
23	25220217	.	T	C	11	9	20	0	0	20	0	0
23	25220226	.	G	T	11	9	20	0	0	20	0	0
23	25220262	.	T	C	6	11	17	0	1	18	0	0
23	25220286	.	C	A	7	8	15	0	2	17	0	0
23	25220545	.	C	T	11	4	15	0	0	15	0	0
23	25221198	.	G	A	11	4	15	0	1	16	0	0
23	25221264	.	G	A	17	7	24	0	3	27	0	0
23	25222196	.	C	T	20	14	34	0	1	35	0	0
23	25222214	.	G	A	2	13	15	0	20	35	0	0
23	25222578	.	G	T	14	7	21	0	0	21	0	0
23	25222585	.	A	T	11	7	18	0	2	20	0	0
23	25257927	.	C	T	1	2	3	0	0	3	0	0
23	25268652	.	T	C	1	4	5	0	1	6	0	0
23	25270745	.	C	A	2	2	4	0	0	4	0	0
23	25274483	.	G	A	5	3	8	0	0	8	0	0
23	25274526	.	T	C	3	3	6	0	0	6	0	0
23	25274537	.	C	A	4	2	6	0	1	7	0	0
23	25276277	.	A	G	5	0	5	0	3	8	0	0
23	25280235	.	G	A	1	3	4	0	0	4	0	0
23	25282205	.	G	A	7	2	9	0	0	9	0	0
23	25282883	.	T	A	3	4	7	0	0	7	0	0
23	25284824	.	C	T	7	3	10	0	0	10	0	0
23	25286802	.	A	C	6	7	13	0	0	13	0	0
23	25287292	.	A	C	3	5	8	0	0	8	0	0
23	25287308	.	G	A	0	8	8	0	5	13	0	0
23	25292000	.	G	A	18	8	26	1	0	27	0	0
23	25293908	.	A	C	5	13	18	0	0	18	0	0
23	25308040	.	A	G	3	0	3	0	3	6	0	0
23	25317939	.	A	G	3	0	3	0	6	9	0	0
23	25338908	.	T	C	4	5	9	0	0	9	0	0
23	25339950	.	T	C	4	3	7	0	0	7	0	0
23	25339986	.	G	T	3	3	6	0	0	6	0	0
23	25423956	.	C	T	1	2	3	0	0	3	0	0
23	25434376	.	C	T	1	2	3	0	0	3	0	0
23	25446691	.	G	T	1	3	4	0	0	4	0	0
23	25447185	.	T	C	2	2	4	0	0	4	0	0
23	25448377	.	T	A	2	4	6	0	0	6	0	0
23	25448403	.	A	T	2	2	4	0	0	4	0	0
23	25448451	.	T	C	3	4	7	0	1	8	0	0
23	25448554	.	T	C	2	3	5	0	0	5	0	0
23	25458584	.	G	A	12	21	33	0	2	35	0	0
23	25458615	.	G	A	14	18	32	0	1	33	0	0
23	25464156	.	A	G	17	15	32	0	0	32	0	0
23	25471197	.	G	A	14	4	18	0	1	19	0	0
23	25471652	.	G	A	13	4	17	0	2	19	0	0
23	25484859	.	G	A	8	11	19	0	0	19	0	0
23	25484886	.	G	A	11	14	25	0	0	25	0	0
23	25491895	.	T	C	5	0	5	0	6	11	0	0
23	25495443	.	A	G	6	6	12	0	0	12	0	0
23	25501969	.	T	G	3	5	8	0	0	8	0	0
23	25502162	.	C	T	12	3	15	0	0	15	0	0
23	25502163	.	T	C	12	3	15	0	0	15	0	0
23	25504804	.	G	T	4	8	12	0	0	12	0	0
23	25505753	.	G	T	3	9	12	0	0	12	0	0
23	25506675	.	C	A	8	6	14	0	1	15	0	0
23	25514702	.	G	A	4	9	13	0	0	13	0	0
23	25515733	.	G	A	3	8	11	0	0	11	0	0
23	25518832	.	G	T	3	4	7	0	1	8	0	0
23	25525236	.	A	G	1	4	5	0	1	6	0	0
23	25525287	.	T	G	3	4	7	0	0	7	0	0
23	25525335	.	A	G	2	3	5	0	0	5	0	0
23	25532166	.	T	C	4	6	10	0	0	10	0	0
23	25532238	.	T	C	7	6	13	0	0	13	0	0
23	25533685	.	C	T	2	3	5	0	7	12	0	0
23	25539868	.	A	G	1	2	3	0	0	3	0	0
23	25539994	.	G	A	4	2	6	0	0	6	0	0
23	25550894	.	A	G	8	4	12	0	1	13	0	0
23	25551312	.	T	C	4	0	4	0	3	7	0	0
23	25555473	.	G	A	4	5	9	0	1	10	0	0
23	25560480	.	C	T	4	3	7	0	0	7	0	0
23	25560899	.	G	A	4	6	10	0	2	12	0	0
23	25564701	.	T	C	3	6	9	0	0	9	0	0
23	25564716	.	C	T	3	6	9	0	0	9	0	0
23	25567086	.	C	T	1	4	5	0	0	5	0	0
23	25592044	.	G	A	4	8	12	0	0	12	0	0
23	25592116	.	T	A	4	4	8	0	0	8	0	0
23	25592155	.	T	C	3	5	8	0	0	8	0	0
23	25592666	.	C	A	2	7	9	0	0	9	0	0
23	25756641	.	A	G	7	6	13	0	0	13	0	0
23	25768079	.	G	A	1	5	6	0	2	8	0	0
23	25768133	.	C	G	3	6	9	0	0	9	0	0
23	25770804	.	T	A	3	2	5	0	0	5	0	0
23	25771107	.	G	A	8	9	17	0	0	17	0	0
23	25772648	.	A	G	8	8	16	0	1	17	0	0
23	25772799	.	G	A	3	5	8	0	0	8	0	0
23	25773469	.	G	A	5	5	10	0	1	11	0	0
23	25773505	.	G	T	4	2	6	0	2	8	0	0
23	25774726	.	G	T	3	5	8	0	0	8	0	0
23	25774855	.	A	G	3	6	9	0	0	9	0	0
23	25775017	.	C	T	2	6	8	0	3	11	0	0
23	25776499	.	G	A	5	2	7	0	1	8	0	0
23	25776811	.	G	T	3	7	10	0	1	11	0	0
23	25776879	.	A	G	4	6	10	0	1	11	0	0
23	25777286	.	A	G	4	4	8	0	0	8	0	0
23	25792923	.	A	T	7	8	15	0	0	15	0	0
23	25792952	.	A	T	7	3	10	0	2	12	0	0
23	25796355	.	C	T	4	2	6	0	0	6	0	0
23	25796444	.	T	C	5	3	8	0	1	9	0	0
23	25796899	.	G	A	9	3	12	0	0	12	0	0
23	25796975	.	G	A	2	8	10	0	0	10	0	0
23	25797143	.	G	C	5	4	9	0	0	9	0	0
23	25797950	.	A	T	3	4	7	0	0	7	0	0
23	25869424	.	A	G	16	0	16	0	20	36	0	0
23	25869571	.	G	A	8	9	17	0	1	18	0	0
23	25869596	.	C	A	7	7	14	0	0	14	0	0
23	25869658	.	C	T	17	6	23	0	1	24	0	0
23	25869706	.	A	G	13	8	21	0	0	21	0	0
23	25871493	.	A	G	7	9	16	0	0	16	0	0
23	25871628	.	G	C	5	9	14	0	1	15	0	0
23	25871764	.	C	A	12	9	21	0	0	21	0	0
23	25873979	.	A	T	1	11	12	1	0	13	0	0
23	25874089	.	A	C	14	7	21	0	1	22	0	0
23	25874100	.	A	T	14	7	21	0	3	24	0	0
23	25874135	.	G	A	1	7	8	0	16	24	0	0
23	25874154	.	T	G	13	8	21	0	1	22	0	0
23	25874249	.	A	G	17	0	17	0	12	29	0	0
23	25874261	.	T	A	13	11	24	0	1	25	0	0
23	25874334	.	C	G	6	4	10	0	1	11	0	0
23	25874355	.	A	T	7	4	11	0	0	11	0	0
23	25874385	.	T	C	10	5	15	0	0	15	0	0
23	25874452	.	A	T	7	10	17	0	0	17	0	0
23	25874570	.	T	C	2	4	6	0	0	6	0	0
23	25930689	.	C	T	16	19	35	0	2	37	0	0
23	25942399	.	T	G	14	1	15	1	7	23	0	0
23	25942559	.	T	A	7	6	13	0	0	13	0	0
23	25942708	.	G	A	1	2	3	0	1	4	0	0
23	25946530	.	A	G	1	2	3	0	0	3	0	0
23	25946732	.	A	G	1	3	4	0	0	4	0	0
23	25946882	.	T	C	2	0	2	0	3	5	0	0
23	25947416	.	T	G	2	3	5	0	0	5	0	0
23	25947599	.	T	C	3	0	3	0	5	8	0	0
23	25948000	.	G	A	2	2	4	0	0	4	0	0
23	25954602	.	G	A	1	2	3	0	0	3	0	0
23	26063560	.	A	T	24	31	55	0	1	56	0	0
23	26063581	.	T	C	22	1	23	0	28	51	0	0
23	26063614	.	A	C	28	28	56	0	1	57	0	0
23	26064050	.	T	A	33	13	46	0	4	50	0	0
23	26064122	.	T	A	16	25	41	1	1	43	0	0
23	26064124	.	T	A	28	12	40	1	1	42	0	0
23	26064186	.	C	G	15	21	36	0	0	36	0	0
23	26064192	.	T	A	12	23	35	0	1	36	0	0
23	26064234	.	G	T	17	25	42	0	2	44	0	0
23	26064266	.	T	A	21	20	41	0	0	41	0	0
23	26074123	.	G	A	24	24	48	0	3	51	0	0
23	26074252	.	T	A	24	20	44	0	1	45	0	0
23	26074288	.	T	C	21	17	38	0	0	38	0	0
23	26074312	.	C	T	24	16	40	0	1	41	0	0
23	26083603	.	A	G	6	5	11	0	1	12	0	0
23	26083822	.	A	C	5	6	11	0	0	11	0	0
23	26088857	.	T	C	6	4	10	0	0	10	0	0
23	26184132	.	T	C	10	16	26	0	1	27	0	0
23	26184225	.	G	A	12	4	16	0	0	16	0	0
23	26187373	.	C	T	1	3	4	0	13	17	0	0
23	26187415	.	A	G	4	8	12	0	0	12	0	0
23	26187603	.	C	A	1	4	5	0	6	11	0	0
23	26187657	.	A	G	6	3	9	0	1	10	0	0
23	26187735	.	C	T	7	6	13	0	0	13	0	0
23	26187885	.	T	C	7	8	15	0	0	15	0	0
23	26187912	.	G	A	7	6	13	0	1	14	0	0
23	26225670	.	T	C	5	3	8	0	1	9	0	0
23	26225739	.	G	A	4	2	6	0	2	8	0	0
23	26225871	.	G	A	7	4	11	0	0	11	0	0
23	26225907	.	A	T	9	7	16	0	0	16	0	0
23	26226066	.	G	T	6	7	13	0	1	14	0	0
23	26227697	.	C	T	0	6	6	0	10	16	0	0
23	26232509	.	C	A	9	10	19	0	0	19	0	0
23	26240897	.	C	T	9	10	19	0	0	19	0	0
23	26241224	.	T	A	12	5	17	0	1	18	0	0
23	26249884	.	G	A	9	5	14	0	1	15	0	0
23	26251973	.	C	T	4	6	10	0	3	13	0	0
23	26251979	.	A	T	4	7	11	0	0	11	0	0
23	26252012	.	A	G	6	9	15	0	1	16	0	0
23	26273212	.	C	T	0	2	2	0	7	9	0	0
23	26299011	.	T	C	4	0	4	0	5	9	0	0
23	26311056	.	T	C	4	6	10	0	0	10	0	0
23	26343689	.	C	G	3	4	7	0	0	7	0	0
23	26504151	.	A	C	33	1	34	1	24	59	0	0
23	26504202	.	A	T	53	12	65	2	3	70	0	0
23	26504254	.	G	A	43	12	55	1	0	56	0	0
23	26504264	.	C	T	36	14	50	1	0	51	0	0
23	26507741	.	G	A	25	29	54	0	2	56	0	0
23	26509764	.	G	A	31	24	55	0	0	55	0	0
23	26514677	.	G	A	29	27	56	0	0	56	0	0
23	26514797	.	T	C	18	19	37	0	0	37	0	0
23	26517183	.	G	A	27	25	52	0	2	54	0	0
23	26519635	.	T	G	12	24	36	0	0	36	0	0
23	26522647	.	A	G	16	25	41	0	1	42	0	0
23	26543878	.	A	T	2	3	5	0	0	5	0	0
23	26550203	.	G	A	1	4	5	0	0	5	0	0
23	26556164	.	T	C	3	2	5	0	0	5	0	0
23	26562183	.	A	G	1	2	3	0	0	3	0	0
23	26763798	.	A	T	3	6	9	0	1	10	0	0
23	26764138	.	T	C	6	3	9	0	0	9	0	0
23	26764269	.	G	A	5	7	12	0	0	12	0	0
23	26764324	.	C	A	4	3	7	0	1	8	0	0
23	26764351	.	A	C	3	6	9	0	0	9	0	0
23	26770174	.	A	G	1	6	7	0	0	7	0	0
23	26775784	.	C	T	0	5	5	0	1	6	0	0
23	26777399	.	G	A	3	3	6	0	1	7	0	0
23	26777402	.	A	G	4	2	6	0	0	6	0	0
23	26777492	.	G	A	2	6	8	0	0	8	0	0
23	26777537	.	G	A	3	4	7	0	0	7	0	0
23	26797108	.	T	A	3	3	6	0	0	6	0	0
23	26801660	.	G	A	2	5	7	0	0	7	0	0
23	26801696	.	C	T	1	4	5	0	0	5	0	0
23	26804988	.	G	A	1	5	6	0	0	6	0	0
23	26811454	.	G	A	1	2	3	0	1	4	0	0
23	26819681	.	T	G	1	2	3	0	1	4	0	0
23	26821780	.	G	A	3	2	5	0	0	5	0	0
23	26821792	.	C	G	3	2	5	0	0	5	0	0
23	26828760	.	G	A	4	3	7	0	1	8	0	0
23	26832320	.	C	T	0	3	3	0	4	7	0	0
23	26879781	.	A	C	2	4	6	0	0	6	0	0
23	26946805	.	A	G	4	5	9	0	1	10	0	0
23	26950928	.	G	A	0	7	7	0	2	9	0	0
23	26955401	.	A	G	9	4	13	0	0	13	0	0
23	26979212	.	C	A	9	13	22	0	0	22	0	0
23	27003720	.	G	A	24	28	52	0	0	52	0	0
23	27003925	.	T	C	21	25	46	0	1	47	0	0
23	27003983	.	A	T	20	17	37	0	5	43	1	0
23	27005195	.	G	A	21	19	40	0	1	41	0	0
23	27041132	.	G	T	2	3	5	0	0	5	0	0
23	27041461	.	A	T	6	3	9	0	0	9	0	0
23	27042357	.	G	A	8	5	13	0	0	13	0	0
23	27044136	.	G	A	4	3	7	0	0	7	0	0
23	27044307	.	A	G	5	10	15	0	0	15	0	0
23	27044526	.	A	G	8	7	15	0	0	15	0	0
23	27044653	.	G	A	3	7	10	0	0	10	0	0
23	27044946	.	C	G	7	5	12	0	0	12	0	0
23	27045022	.	G	A	4	7	11	0	0	11	0	0
23	27049986	.	A	T	5	4	9	0	0	9	0	0
23	27052058	.	C	T	20	38	58	0	1	59	0	0
23	27054361	.	C	T	16	12	28	0	0	28	0	0
23	27056877	.	G	A	18	19	37	0	3	40	0	0
23	27059120	.	G	A	3	12	15	0	17	32	0	0
23	27059376	.	T	A	16	15	31	0	1	32	0	0
23	27059422	.	C	T	17	16	33	0	2	35	0	0
23	27059526	.	G	A	3	21	24	0	14	38	0	0
23	27059591	.	C	A	10	18	28	0	1	29	0	0
23	27059782	.	A	G	14	19	33	0	1	34	0	0
23	27135674	.	T	C	2	2	4	0	0	4	0	0
23	27135893	.	G	A	2	2	4	0	0	4	0	0
23	27251789	.	G	C	23	19	42	0	1	43	0	0
23	27252024	.	G	A	32	21	53	0	1	54	0	0
23	27252425	.	G	A	35	28	63	0	0	63	0	0
23	27252587	.	A	G	29	16	45	0	0	45	0	0
23	27252833	.	A	G	17	20	37	0	1	38	0	0
23	27274110	.	G	A	12	11	23	0	3	26	0	0
23	27274266	.	G	A	19	20	39	0	0	39	0	0
23	27279320	.	A	G	20	16	36	0	1	37	0	0
23	27279533	.	C	T	16	16	32	0	1	33	0	0
23	27283466	.	T	C	14	14	28	0	0	28	0	0
23	27283475	.	A	G	16	13	29	0	0	29	0	0
23	27293293	.	C	T	4	11	15	0	12	27	0	0
23	27293335	.	G	A	16	15	31	0	1	32	0	0
23	27296964	.	G	C	19	0	19	0	13	33	1	0
23	27318104	.	C	T	10	13	23	0	1	24	0	0
23	27336193	.	G	A	17	8	25	0	1	26	0	0
23	27359176	.	A	G	5	13	18	0	0	18	0	0
23	27359526	.	T	C	11	3	14	0	0	14	0	0
23	27359528	.	C	G	11	3	14	0	0	14	0	0
23	27359825	.	C	A	7	12	19	0	2	21	0	0
23	27361210	.	A	T	7	6	13	0	0	13	0	0
23	27361216	.	G	A	7	5	12	0	1	13	0	0
23	27364018	.	C	T	10	5	15	0	0	15	0	0
23	27366669	.	C	T	9	12	21	0	0	21	0	0
23	27380215	.	C	T	0	2	2	0	1	3	0	0
23	27380430	.	A	C	1	1	2	0	3	5	0	0
23	27383362	.	G	A	5	6	11	0	0	11	0	0
23	27385057	.	G	A	6	3	9	0	1	10	0	0
23	27386226	.	G	A	4	4	8	0	0	8	0	0
23	27498040	.	C	G	6	6	12	0	1	13	0	0
23	27498111	.	C	A	10	9	19	0	1	20	0	0
23	27498177	.	T	C	8	13	21	0	0	21	0	0
23	27498195	.	A	T	13	11	24	0	1	25	0	0
23	27498359	.	T	A	11	5	16	0	0	16	0	0
23	27498798	.	C	T	2	13	15	0	27	42	0	0
23	27498865	.	G	A	18	14	32	0	2	34	0	0
23	27499096	.	G	A	11	12	23	0	0	23	0	0
23	27499135	.	G	A	11	9	20	0	1	21	0	0
23	27499195	.	A	T	10	18	28	0	3	31	0	0
23	27499246	.	G	A	12	20	32	0	0	32	0	0
23	27505790	.	A	G	2	3	5	0	0	5	0	0
23	27505822	.	A	T	4	3	7	0	0	7	0	0
23	27513919	.	G	A	10	5	15	0	0	15	0	0
23	27513934	.	T	C	13	5	18	0	1	19	0	0
23	27518434	.	G	A	14	10	24	0	2	26	0	0
23	27521608	.	A	T	10	7	17	0	1	18	0	0
23	27547467	.	C	T	1	9	10	0	9	19	0	0
23	27547568	.	G	A	14	8	22	0	0	22	0	0
23	27547650	.	A	T	6	5	11	0	0	11	0	0
23	27547850	.	C	T	1	5	6	0	7	13	0	0
23	27576397	.	G	C	1	3	4	0	0	4	0	0
23	27576533	.	T	G	2	3	5	0	0	5	0	0
23	27576535	.	G	A	2	3	5	0	0	5	0	0
23	27581369	.	G	T	2	2	4	0	0	4	0	0
23	27581407	.	C	T	1	3	4	0	2	6	0	0
23	27583700	.	C	T	1	2	3	0	0	3	0	0
23	27583703	.	T	A	2	2	4	0	0	4	0	0
23	27591378	.	G	T	10	12	22	0	0	22	0	0
23	27593230	.	C	T	8	17	25	0	1	26	0	0
23	27595823	.	C	A	2	10	12	0	11	23	0	0
23	27595868	.	T	C	10	13	23	0	0	23	0	0
23	27596059	.	G	A	13	13	26	0	0	26	0	0
23	27597141	.	C	A	1	4	5	0	15	20	0	0
23	27601731	.	G	A	5	6	11	0	0	11	0	0
23	27601803	.	C	T	5	7	12	0	2	14	0	0
23	27603158	.	C	T	9	6	15	0	1	16	0	0
23	27605903	.	C	T	10	3	13	0	0	13	0	0
23	27605927	.	C	T	2	6	8	0	0	8	0	0
23	27606827	.	T	A	5	4	9	0	0	9	0	0
23	27622036	.	T	A	23	23	46	0	1	47	0	0
23	27622094	.	C	A	18	23	41	0	1	43	1	0
23	27622324	.	T	C	19	11	30	0	0	30	0	0
23	27622452	.	C	A	4	2	6	0	0	6	0	0
23	27622531	.	A	T	19	8	27	0	2	29	0	0
23	27629713	.	G	A	19	21	40	0	1	41	0	0
23	27629923	.	A	T	27	14	41	0	0	41	0	0
23	27643894	.	T	C	1	0	1	0	2	3	0	0
23	27654841	.	C	A	2	2	4	0	0	4	0	0
23	27655846	.	T	C	2	2	4	0	0	4	0	0
23	27657498	.	C	A	1	2	3	0	1	4	0	0
23	27676223	.	G	T	33	32	65	0	1	66	0	0
23	27677278	.	G	A	36	21	57	0	2	59	0	0
23	27677457	.	G	A	9	17	26	0	0	26	0	0
23	27683143	.	G	T	6	5	11	0	0	11	0	0
23	27683248	.	C	A	1	3	4	0	2	6	0	0
23	27683497	.	C	T	4	8	12	0	0	12	0	0
23	27683629	.	C	T	0	4	4	0	4	8	0	0
23	27683710	.	G	A	2	7	9	0	0	9	0	0
23	27684618	.	T	C	9	0	9	0	9	18	0	0
23	27727163	.	T	C	1	2	3	0	0	3	0	0
23	27727346	.	C	T	4	3	7	0	0	7	0	0
23	27784090	.	C	A	4	5	9	0	0	9	0	0
23	27784412	.	G	C	6	6	12	0	1	13	0	0
23	27788665	.	C	T	10	13	23	0	0	23	0	0
23	27800681	.	G	T	7	5	12	0	1	13	0	0
23	27801101	.	T	C	14	0	14	0	8	22	0	0
23	27801104	.	T	C	10	6	16	0	4	20	0	0
23	27807523	.	A	G	10	9	19	0	0	19	0	0
23	27807664	.	G	A	6	8	14	0	0	14	0	0
23	27809601	.	A	C	13	12	25	0	0	25	0	0
23	27822743	.	T	C	4	15	19	0	0	19	0	0
23	27836003	.	C	G	6	5	11	0	0	11	0	0
23	27836235	.	C	T	0	5	5	0	5	10	0	0
23	27842530	.	A	T	2	7	9	0	0	9	0	0
23	27845306	.	C	G	1	2	3	0	4	7	0	0
23	27849837	.	G	A	4	4	8	0	0	8	0	0
23	28344855	.	G	A	2	2	4	0	0	4	0	0
23	28374570	.	G	A	23	21	44	0	1	45	0	0
23	28374711	.	C	A	22	23	45	0	2	47	0	0
23	28374722	.	C	T	24	19	43	0	3	46	0	0
23	28378254	.	G	A	15	12	27	0	0	27	0	0
23	28382953	.	C	T	23	33	56	0	2	58	0	0
23	28388013	.	C	A	25	23	48	0	3	51	0	0
23	28388318	.	C	T	18	14	32	0	0	32	0	0
23	28388325	.	T	C	19	15	34	0	0	34	0	0
23	28422830	.	A	G	3	2	5	0	0	5	0	0
23	28422929	.	A	G	4	4	8	0	0	8	0	0
23	28486698	.	G	A	1	2	3	0	0	3	0	0
23	28494838	.	C	T	4	6	10	0	0	10	0	0
23	28497962	.	C	T	6	2	8	0	0	8	0	0
23	28500660	.	G	A	2	2	4	0	0	4	0	0
23	28508169	.	C	A	6	10	16	0	0	16	0	0
23	28510075	.	C	T	4	4	8	0	0	8	0	0
23	28510826	.	A	G	6	3	9	0	0	9	0	0
23	28511093	.	T	C	6	5	11	0	0	11	0	0
23	28511109	.	A	G	6	5	11	0	0	11	0	0
23	28514324	.	G	A	6	6	12	0	0	12	0	0
23	28514441	.	T	C	5	6	11	0	0	11	0	0
23	28514549	.	T	C	5	2	7	0	0	7	0	0
23	28514820	.	G	A	5	6	11	0	1	12	0	0
23	28515768	.	C	T	5	5	10	0	0	10	0	0
23	28518036	.	G	A	12	3	15	0	0	15	0	0
23	28522491	.	A	G	15	0	15	0	8	23	0	0
23	28525270	.	T	C	6	9	15	0	0	15	0	0
23	28525828	.	G	T	0	5	5	0	10	15	0	0
23	28532518	.	G	A	5	12	17	0	0	17	0	0
23	28537575	.	G	A	1	10	11	0	9	20	0	0
23	28541633	.	A	G	12	6	18	0	1	19	0	0
23	28541683	.	G	T	14	10	24	0	1	25	0	0
23	28546870	.	G	A	0	8	8	0	12	20	0	0
23	28547207	.	C	G	10	15	25	0	1	26	0	0
23	28547242	.	A	G	6	0	6	0	17	23	0	0
23	28547261	.	A	G	5	17	22	0	2	24	0	0
23	28548883	.	A	G	14	0	14	1	9	24	0	0
23	28551306	.	A	T	8	15	23	0	0	23	0	0
23	28551671	.	A	G	17	0	17	0	11	28	0	0
23	28551764	.	A	G	8	0	8	0	15	23	0	0
23	28551770	.	G	A	15	9	24	0	1	25	0	0
23	28554784	.	A	T	16	9	25	0	5	30	0	0
23	28557337	.	T	C	14	11	25	0	5	30	0	0
23	28561502	.	C	A	16	19	35	0	0	35	0	0
23	28564191	.	C	A	15	24	39	0	1	40	0	0
23	28659252	.	A	T	11	18	29	0	0	29	0	0
23	28661419	.	C	T	7	14	21	0	0	21	0	0
23	28661490	.	C	T	13	14	27	0	0	27	0	0
23	28662989	.	T	C	11	10	21	0	1	22	0	0
23	28663197	.	T	C	13	18	31	0	1	32	0	0
23	28663227	.	T	C	12	18	30	0	4	34	0	0
23	28663266	.	G	A	16	10	26	0	0	26	0	0
23	28667217	.	T	C	12	11	23	0	2	25	0	0
23	28667300	.	C	A	19	17	36	0	1	37	0	0
23	28669550	.	C	T	20	12	32	0	2	34	0	0
23	28672063	.	G	A	4	9	13	0	17	30	0	0
23	28672155	.	G	A	1	16	17	0	18	35	0	0
23	28674046	.	C	T	14	12	26	0	3	29	0	0
23	28674252	.	G	A	18	14	32	0	0	32	0	0
23	28674890	.	A	C	14	14	28	0	1	29	0	0
23	28679693	.	A	G	25	11	36	0	2	38	0	0
23	28679696	.	C	T	28	12	40	0	1	41	0	0
23	28679753	.	C	T	20	14	34	0	1	35	0	0
23	28680239	.	A	G	15	19	34	0	0	34	0	0
23	28687446	.	C	T	3	3	6	0	1	7	0	0
23	28687448	.	C	G	2	1	3	0	3	6	0	0
23	28687656	.	G	A	2	3	5	0	1	6	0	0
23	28687766	.	C	T	1	3	4	0	0	4	0	0
23	28693280	.	T	A	14	7	21	0	0	21	0	0
23	28693308	.	T	A	14	10	24	0	0	24	0	0
23	28704635	.	C	T	12	16	28	0	2	30	0	0
23	28705908	.	C	T	11	8	19	0	2	21	0	0
23	28707051	.	C	T	13	16	29	0	2	31	0	0
23	28707195	.	T	A	19	11	30	0	2	32	0	0
23	28713648	.	C	T	18	13	31	0	1	32	0	0
23	28722887	.	G	A	5	3	8	0	0	8	0	0
23	28722917	.	C	T	5	5	10	0	0	10	0	0
23	28723338	.	C	A	5	4	9	0	0	9	0	0
23	28724964	.	A	G	3	5	8	0	1	9	0	0
23	28725174	.	G	A	0	7	7	0	12	19	0	0
23	28725425	.	C	T	4	3	7	0	2	9	0	0
23	28725743	.	A	G	5	4	9	0	0	9	0	0
23	28725899	.	T	A	8	4	12	0	0	12	0	0
23	28725916	.	A	C	6	3	9	0	1	10	0	0
23	28726486	.	A	T	2	5	7	0	0	7	0	0
23	28726521	.	A	G	8	5	13	0	0	13	0	0
23	28726738	.	A	G	4	9	13	0	1	14	0	0
23	28726852	.	T	C	6	5	11	0	0	11	0	0
23	28726937	.	C	A	6	3	9	0	1	10	0	0
23	28731499	.	C	T	25	27	52	0	2	54	0	0
23	28803302	.	T	C	2	6	8	0	3	11	0	0
23	28882538	.	T	C	5	6	11	0	0	11	0	0
23	28882550	.	C	T	4	7	11	0	0	11	0	0
23	28922300	.	G	A	0	5	5	0	2	7	0	0
23	28922650	.	A	C	2	3	5	0	0	5	0	0
23	28922716	.	C	T	3	2	5	0	0	5	0	0
23	28922729	.	G	A	3	2	5	0	0	5	0	0
23	28922778	.	T	A	1	6	7	0	0	7	0	0
23	28922854	.	A	C	2	2	4	0	1	5	0	0
23	28923151	.	C	T	1	2	3	0	0	3	0	0
23	28923760	.	T	A	4	4	8	0	0	8	0	0
23	28923797	.	G	A	3	2	5	0	2	7	0	0
23	28923962	.	A	G	2	9	11	0	0	11	0	0
23	28924079	.	A	C	1	5	6	1	0	7	0	0
23	28924687	.	G	A	0	10	10	1	4	15	0	0
23	28924873	.	G	A	6	3	9	0	0	9	0	0
23	28925156	.	A	T	4	6	10	0	0	10	0	0
23	28925159	.	G	A	1	7	8	0	4	12	0	0
23	28925275	.	T	C	2	5	7	0	1	8	0	0
23	28925441	.	G	A	4	7	11	0	1	12	0	0
23	28925451	.	A	T	2	8	10	0	1	11	0	0
23	28925589	.	G	A	0	5	5	0	3	8	0	0
23	28969691	.	A	G	3	7	10	0	0	10	0	0
23	28979087	.	T	C	1	3	4	0	0	4	0	0
23	28979387	.	G	A	3	3	6	0	0	6	0	0
23	29358241	.	G	A	1	25	26	0	26	52	0	0
23	29358253	.	C	T	26	30	56	0	0	56	0	0
23	29360044	.	T	C	13	27	40	0	4	44	0	0
23	29360687	.	G	T	5	6	11	0	0	11	0	0
23	29360707	.	G	T	6	5	11	0	0	11	0	0
23	29360757	.	T	G	7	4	11	1	0	12	0	0
23	29361357	.	C	A	11	24	35	3	0	38	0	0
23	29361365	.	A	C	14	20	34	3	1	38	0	0
23	29361557	.	A	T	10	11	21	0	0	21	0	0
23	29376111	.	T	C	7	13	20	0	2	22	0	0
23	29376480	.	A	G	15	5	20	0	0	20	0	0
23	29376485	.	T	C	14	5	19	0	0	19	0	0
23	29381816	.	G	A	12	18	30	0	1	31	0	0
23	29381819	.	T	G	14	17	31	0	0	31	0	0
23	29381855	.	T	G	10	18	28	0	1	29	0	0
23	29383693	.	C	A	15	19	34	0	2	37	1	0
23	29386735	.	C	T	7	4	11	0	0	11	0	0
23	29386973	.	G	T	5	10	15	0	0	15	0	0
23	29392421	.	G	A	4	16	20	0	2	22	0	0
23	29393414	.	C	T	1	13	14	0	7	21	0	0
23	29393628	.	G	A	4	16	20	0	0	20	0	0
23	29393643	.	A	T	3	16	19	0	1	20	0	0
23	29396452	.	C	T	2	16	18	0	29	47	0	0
23	29396482	.	C	T	21	33	54	0	2	56	0	0
23	29396588	.	T	C	41	2	43	0	25	68	0	0
23	29397230	.	T	A	27	20	47	0	2	49	0	0
23	29397451	.	T	G	19	27	46	0	0	46	0	0
23	29397501	.	C	T	21	26	47	0	0	47	0	0
23	29397506	.	T	G	21	24	45	0	3	48	0	0
23	29397537	.	G	A	26	23	49	0	2	51	0	0
23	29397816	.	G	A	24	20	44	0	7	51	0	0
23	29397907	.	T	C	41	16	57	0	1	58	0	0
23	29398015	.	C	A	3	22	25	0	36	61	0	0
23	29398025	.	G	A	35	23	58	0	1	59	0	0
23	29398310	.	C	T	41	11	52	0	3	55	0	0
23	29398343	.	A	G	36	18	54	0	5	59	0	0
23	29398390	.	C	T	25	28	53	0	2	55	0	0
23	29398718	.	A	T	26	27	53	0	3	56	0	0
23	29402103	.	A	G	32	28	60	0	2	62	0	0
23	29403243	.	G	A	40	20	60	0	3	64	1	0
23	29403297	.	G	A	37	22	59	0	2	61	0	0
23	29403306	.	T	G	29	36	65	0	1	66	0	0
23	29408929	.	G	A	33	29	62	0	3	65	0	0
23	29421959	.	C	G	29	25	54	0	2	56	0	0
23	29422007	.	G	C	22	2	24	0	35	59	0	0
23	29423410	.	G	A	22	28	50	0	2	52	0	0
23	29433670	.	G	A	18	31	49	0	4	53	0	0
23	29433715	.	C	A	32	21	53	0	4	57	0	0
23	29435330	.	C	T	21	23	44	0	2	46	0	0
23	29435381	.	G	A	22	28	50	1	3	54	0	0
23	29582416	.	T	C	19	41	60	0	1	61	0	0
23	29582420	.	T	C	12	46	58	0	3	61	0	0
23	29582496	.	T	C	29	32	61	0	1	62	0	0
23	29712670	.	G	A	16	9	25	0	3	28	0	0
23	29756977	.	T	C	1	5	6	0	0	6	0	0
23	30061605	.	A	C	20	10	30	0	2	32	0	0
23	30061606	.	A	C	25	6	31	0	1	32	0	0
23	30065641	.	T	G	7	8	15	0	0	15	0	0
23	30128781	.	A	T	14	4	18	0	1	19	0	0
23	30128788	.	G	A	11	6	17	0	1	18	0	0
23	30712041	.	T	A	7	6	13	0	0	13	0	0
23	30715397	.	G	A	0	7	7	0	6	13	0	0
23	30716096	.	C	T	2	5	7	0	0	7	0	0
23	30718514	.	T	A	5	4	9	0	1	10	0	0
23	30723747	.	A	T	7	4	11	0	2	13	0	0
23	30724362	.	T	G	5	4	9	0	0	9	0	0
23	30724440	.	T	C	3	7	10	0	1	11	0	0
23	30726306	.	C	T	1	2	3	0	0	3	0	0
23	30726314	.	A	T	1	2	3	0	0	3	0	0
23	30727016	.	T	C	1	0	1	0	3	4	0	0
23	30727052	.	T	C	2	2	4	0	0	4	0	0
23	30727172	.	T	C	2	0	2	0	3	5	0	0
23	30727288	.	T	G	1	7	8	0	0	8	0	0
23	30730374	.	C	T	8	4	12	0	0	12	0	0
23	30747357	.	G	C	7	13	20	0	1	21	0	0
23	30747953	.	G	A	13	11	24	0	0	24	0	0
23	30748097	.	G	A	11	13	24	0	4	28	0	0
23	30748712	.	C	G	10	1	11	0	16	27	0	0
23	30748743	.	C	T	11	14	25	0	1	26	0	0
23	30750402	.	C	A	9	13	22	0	4	26	0	0
23	30750694	.	C	A	17	14	31	0	0	31	0	0
23	30750751	.	G	A	1	11	12	0	20	32	0	0
23	30750932	.	A	C	22	15	37	1	0	38	0	0
23	30751008	.	T	C	12	17	29	0	0	29	0	0
23	30751027	.	A	T	8	18	26	0	4	30	0	0
23	30751061	.	A	G	11	1	12	0	20	32	0	0
23	30751117	.	T	C	8	24	32	0	1	33	0	0
23	30751132	.	T	G	11	0	11	0	21	32	0	0
23	30751252	.	A	G	17	18	35	0	1	36	0	0
23	30751570	.	C	T	15	18	33	0	3	36	0	0
23	30751633	.	T	C	17	13	30	0	2	32	0	0
23	30755989	.	C	T	15	13	28	0	0	28	0	0
23	30758493	.	G	T	13	6	19	0	4	23	0	0
23	30764058	.	T	A	7	12	19	0	0	19	0	0
23	30767575	.	T	A	8	15	23	0	0	23	0	0
23	30770193	.	A	G	9	18	27	0	0	27	0	0
23	30772610	.	C	T	1	9	10	0	16	26	0	0
23	30775315	.	T	C	13	0	13	0	20	33	0	0
23	30776329	.	T	A	16	15	31	0	0	31	0	0
23	30776380	.	T	C	16	1	17	0	13	30	0	0
23	30776574	.	A	T	10	11	21	0	0	21	0	0
23	30778358	.	T	C	7	6	13	0	0	13	0	0
23	30778499	.	G	A	12	15	27	0	1	28	0	0
23	30778864	.	C	G	0	14	14	0	11	25	0	0
23	30781226	.	T	A	13	9	22	0	1	23	0	0
23	30781319	.	A	G	10	9	19	0	0	19	0	0
23	30781367	.	T	C	13	10	23	0	1	24	0	0
23	30828279	.	A	C	1	2	3	0	1	4	0	0
23	30859543	.	C	A	5	5	10	0	2	12	0	0
23	30878451	.	G	A	1	3	4	0	1	5	0	0
23	30890018	.	G	T	4	3	7	0	0	7	0	0
23	30890191	.	T	G	4	3	7	0	0	7	0	0
23	30890701	.	T	A	4	3	7	0	1	8	0	0
23	30898132	.	C	T	5	5	10	0	2	12	0	0
23	30898150	.	T	C	5	5	10	0	1	11	0	0
23	30898297	.	T	C	3	5	8	0	0	8	0	0
23	30898355	.	A	C	3	4	7	0	0	7	0	0
23	30898387	.	C	T	2	4	6	0	0	6	0	0
23	30898467	.	G	C	2	4	6	0	7	13	0	0
23	30918961	.	G	T	4	2	6	0	0	6	0	0
23	30918998	.	A	G	6	4	10	0	0	10	0	0
23	30919027	.	T	G	5	6	11	0	0	11	0	0
23	30919151	.	C	T	2	1	3	0	1	4	0	0
23	30951633	.	A	G	5	3	8	0	0	8	0	0
23	30967766	.	T	G	1	4	5	0	0	5	0	0
23	30967779	.	T	C	2	2	4	0	0	4	0	0
23	30980625	.	A	G	1	2	3	0	0	3	0	0
23	31245593	.	A	T	6	5	11	0	0	11	0	0
23	31248605	.	A	T	6	5	11	0	1	12	0	0
23	31276453	.	G	A	9	9	18	0	1	19	0	0
23	31276509	.	C	T	5	5	10	0	1	11	0	0
23	31276657	.	T	C	12	7	19	0	0	19	0	0
23	31278183	.	G	T	6	9	15	0	0	15	0	0
23	31278237	.	C	T	0	3	3	0	6	9	0	0
23	31278322	.	A	G	11	7	18	0	0	18	0	0
23	31278375	.	A	G	9	8	17	0	0	17	0	0
23	31278417	.	G	T	9	5	14	0	3	17	0	0
23	31278450	.	T	A	6	11	17	0	1	18	0	0
23	31278732	.	C	T	6	6	12	0	1	13	0	0
23	31278792	.	G	T	5	2	7	0	2	9	0	0
23	31279122	.	G	T	9	11	20	0	0	20	0	0
23	31280198	.	G	A	4	3	7	0	0	7	0	0
23	31280892	.	T	A	9	5	14	0	0	14	0	0
23	31281768	.	T	G	4	4	8	0	0	8	0	0
23	31307138	.	C	A	3	5	8	0	0	8	0	0
23	31309431	.	A	T	1	2	3	0	0	3	0	0
23	31309710	.	T	C	2	7	9	0	0	9	0	0
23	31309722	.	T	C	2	6	8	0	1	9	0	0
23	31341052	.	A	G	4	2	6	0	1	7	0	0
23	31358342	.	A	T	24	19	43	0	2	45	0	0
23	31358344	.	A	T	22	20	42	0	1	43	0	0
23	31358489	.	T	G	21	24	45	0	2	47	0	0
23	31358631	.	G	A	27	28	55	0	1	56	0	0
23	31381068	.	C	T	4	3	7	0	1	8	0	0
23	31381335	.	A	G	5	2	7	0	0	7	0	0
23	31381356	.	G	A	3	3	6	0	0	6	0	0
23	31381389	.	T	C	2	4	6	0	1	7	0	0
23	31381392	.	C	T	3	6	9	0	0	9	0	0
23	31381425	.	C	T	6	5	11	0	2	13	0	0
23	31387936	.	T	A	1	2	3	0	0	3	0	0
23	31388492	.	A	T	4	2	6	0	0	6	0	0
23	31396169	.	C	T	3	4	7	0	0	7	0	0
23	31405519	.	C	T	10	7	17	0	0	17	0	0
23	31405570	.	A	C	15	8	23	0	2	25	0	0
23	31419172	.	A	T	7	5	12	0	1	13	0	0
23	31422429	.	C	T	5	5	10	0	0	10	0	0
23	31422600	.	C	T	8	5	13	0	1	14	0	0
23	31422768	.	A	G	2	9	11	0	1	12	0	0
23	31422791	.	A	G	9	1	10	0	3	13	0	0
23	31423091	.	T	C	4	3	7	0	0	7	0	0
23	31423145	.	G	A	1	5	6	0	6	12	0	0
23	31423392	.	C	A	17	7	24	0	1	25	0	0
23	31423427	.	A	G	15	0	15	0	12	27	0	0
23	31423432	.	C	A	15	12	27	0	0	27	0	0
23	31432102	.	A	G	8	1	9	0	13	22	0	0
23	31440119	.	T	A	1	2	3	0	0	3	0	0
23	31596584	.	T	G	7	0	7	0	6	13	0	0
23	31604900	.	C	T	5	2	7	0	1	8	0	0
23	31604912	.	G	T	4	4	8	0	1	9	0	0
23	31641153	.	C	A	22	20	42	0	2	45	1	0
23	31641197	.	A	G	22	23	45	1	1	47	0	0
23	31641270	.	G	A	22	24	46	0	2	48	0	0
23	31643818	.	A	G	16	18	34	0	0	34	0	0
23	31644368	.	A	G	15	15	30	0	1	31	0	0
23	31644419	.	A	G	14	14	28	0	1	29	0	0
23	31644602	.	T	G	14	12	26	0	3	29	0	0
23	31684352	.	G	A	14	21	35	0	1	36	0	0
23	31768596	.	T	C	8	12	20	0	1	21	0	0
23	31771282	.	T	C	3	14	17	0	0	17	0	0
23	31774194	.	G	A	11	7	18	0	0	18	0	0
23	31778174	.	A	G	9	6	15	0	0	15	0	0
23	31778183	.	C	T	9	5	14	0	0	14	0	0
23	31782969	.	T	C	3	1	4	0	12	16	0	0
23	31785175	.	G	A	3	10	13	0	0	13	0	0
23	31785183	.	T	G	3	11	14	0	0	14	0	0
23	31787127	.	C	G	3	8	11	0	2	13	0	0
23	31804162	.	A	G	10	4	14	0	1	15	0	0
23	31915069	.	T	C	2	3	5	0	0	5	0	0
23	31933674	.	C	G	1	2	3	0	0	3	0	0
23	31933739	.	T	G	3	5	8	0	0	8	0	0
23	31940192	.	T	A	5	2	7	0	1	8	0	0
23	31940681	.	C	A	3	4	7	0	0	7	0	0
23	31940775	.	T	A	3	2	5	0	0	5	0	0
23	31940776	.	A	G	3	2	5	0	0	5	0	0
23	31940818	.	C	T	4	2	6	0	0	6	0	0
23	31953501	.	A	G	1	3	4	0	1	5	0	0
23	31962648	.	A	T	6	4	10	0	0	10	0	0
23	31962650	.	T	C	6	4	10	0	0	10	0	0
23	31963226	.	C	T	4	8	12	0	1	13	0	0
23	31963360	.	A	G	3	5	8	0	0	8	0	0
23	31964680	.	C	T	11	11	22	0	0	22	0	0
23	31981951	.	A	C	3	7	10	0	0	10	0	0
23	31981972	.	A	G	4	5	9	0	0	9	0	0
23	31982041	.	T	C	11	3	14	0	0	14	0	0
23	31982042	.	C	T	10	3	13	0	0	13	0	0
23	31984871	.	C	T	5	3	8	0	0	8	0	0
23	31986705	.	T	G	1	0	1	0	3	4	0	0
23	31992375	.	T	C	3	4	7	1	0	8	0	0
23	31992522	.	T	C	5	7	12	0	0	12	0	0
23	31992537	.	C	T	5	6	11	0	0	11	0	0
23	31992690	.	C	T	5	4	9	0	0	9	0	0
23	31997582	.	G	A	6	9	15	0	1	16	0	0
23	31997953	.	C	T	9	7	16	0	0	16	0	0
23	31998162	.	T	C	7	7	14	0	0	14	0	0
23	31998741	.	A	G	4	2	6	0	5	11	0	0
23	32000336	.	G	C	5	12	17	0	0	17	0	0
23	32001190	.	C	T	9	7	16	0	0	16	0	0
23	32003354	.	T	A	7	3	10	0	1	11	0	0
23	32003808	.	T	C	6	8	14	0	0	14	0	0
23	32003820	.	G	T	5	8	13	0	2	15	0	0
23	32007376	.	T	G	6	10	16	0	0	16	0	0
23	32007445	.	T	A	9	10	19	0	1	20	0	0
23	32007520	.	T	C	1	6	7	0	1	8	0	0
23	32007526	.	C	G	2	6	8	0	0	8	0	0
23	32018302	.	A	G	1	1	2	0	1	3	0	0
23	32026927	.	T	C	9	12	21	0	1	22	0	0
23	32026978	.	C	T	4	5	9	0	0	9	0	0
23	32026996	.	G	A	0	1	1	0	4	5	0	0
23	32033105	.	A	C	1	3	4	0	0	4	0	0
23	32033330	.	A	G	3	3	6	0	0	6	0	0
23	32034159	.	G	A	0	2	2	0	4	6	0	0
23	32037265	.	C	T	1	2	3	0	0	3	0	0
23	32081708	.	C	T	21	11	32	0	1	33	0	0
23	32081717	.	T	C	20	10	30	0	1	31	0	0
23	32088077	.	T	G	5	2	7	0	1	8	0	0
23	32096873	.	C	T	0	3	3	0	3	6	0	0
23	32128785	.	T	A	1	1	2	0	0	2	0	0
23	32128799	.	G	A	1	2	3	0	0	3	0	0
23	32128848	.	A	T	3	3	6	0	1	7	0	0
23	32128893	.	T	C	4	5	9	0	0	9	0	0
23	32129476	.	G	T	4	5	9	0	0	9	0	0
23	32129514	.	G	T	4	5	9	0	0	9	0	0
23	32151669	.	A	C	23	16	39	0	1	40	0	0
23	32152022	.	C	T	17	20	37	0	0	37	0	0
23	32154021	.	G	T	8	15	23	0	0	23	0	0
23	32155325	.	A	G	12	13	25	0	1	26	0	0
23	32155719	.	C	T	14	16	30	0	1	31	0	0
23	32155720	.	C	T	2	17	19	0	12	31	0	0
23	32155864	.	A	C	13	0	13	0	12	25	0	0
23	32155975	.	C	T	15	8	23	0	0	23	0	0
23	32157787	.	G	T	8	18	26	0	1	27	0	0
23	32200004	.	A	G	3	2	5	0	0	5	0	0
23	32200071	.	A	G	5	2	7	0	1	9	1	0
23	32200076	.	T	G	4	2	6	0	2	8	0	0
23	32200114	.	A	C	4	4	8	0	0	8	0	0
23	32200482	.	T	C	6	2	8	0	0	8	0	0
23	32200517	.	C	A	6	2	8	0	0	8	0	0
23	32200583	.	C	T	0	3	3	0	5	8	0	0
23	32200979	.	A	G	11	5	16	0	0	16	0	0
23	32201087	.	G	T	5	4	9	0	1	10	0	0
23	32216002	.	G	C	2	0	2	0	4	6	0	0
23	32227626	.	C	T	0	2	2	0	4	6	0	0
23	32235742	.	G	A	1	2	3	0	0	3	0	0
23	32236040	.	T	A	3	3	6	0	0	6	0	0
23	32239672	.	G	A	12	6	18	0	0	18	0	0
23	32239688	.	C	A	13	5	18	0	1	19	0	0
23	32239708	.	G	A	13	9	22	0	0	22	0	0
23	32239824	.	G	A	13	14	27	1	0	28	0	0
23	32240258	.	C	T	10	3	13	0	0	13	0	0
23	32240290	.	A	G	12	4	16	0	0	16	0	0
23	32242086	.	C	A	16	12	28	0	0	28	0	0
23	32242251	.	T	C	23	10	33	0	0	33	0	0
23	32246169	.	A	G	13	7	20	0	2	22	0	0
23	32246190	.	A	G	15	9	24	0	0	24	0	0
23	32248595	.	C	G	7	13	20	0	0	20	0	0
23	32250286	.	C	T	8	9	17	0	3	20	0	0
23	32251473	.	T	G	18	6	24	0	0	24	0	0
23	32252805	.	A	G	9	5	14	0	1	15	0	0
23	32262708	.	G	A	4	14	18	0	1	19	0	0
23	32309187	.	T	C	16	17	33	0	1	34	0	0
23	32309193	.	G	A	13	16	29	0	3	32	0	0
23	32309323	.	G	A	16	19	35	0	1	36	0	0
23	32309533	.	A	G	8	11	19	0	0	19	0	0
23	32309659	.	C	A	1	6	7	0	9	16	0	0
23	32309709	.	G	A	10	12	22	0	0	22	0	0
23	32309787	.	A	C	5	12	17	0	0	17	0	0
23	32309846	.	T	A	3	3	6	0	0	6	0	0
23	32309860	.	C	T	3	2	5	0	0	5	0	0
23	32309943	.	A	G	6	6	12	0	1	13	0	0
23	32310254	.	T	A	3	3	6	0	0	6	0	0
23	32310349	.	A	G	3	3	6	0	0	6	0	0
23	32310359	.	C	T	0	3	3	0	3	6	0	0
23	32310423	.	C	T	0	1	1	0	0	1	0	0
23	32310782	.	T	G	2	3	5	0	0	5	0	0
23	32310808	.	C	T	3	6	9	0	0	9	0	0
23	32310864	.	G	A	8	12	20	0	0	20	0	0
23	32311418	.	T	C	16	6	22	0	0	22	0	0
23	32311555	.	G	C	21	15	36	0	0	36	0	0
23	32311612	.	G	A	17	20	37	0	0	37	0	0
23	32318047	.	A	G	13	20	33	0	1	34	0	0
23	32326532	.	A	G	16	9	25	0	0	25	0	0
23	32362317	.	A	G	7	12	19	0	5	24	0	0
23	32589398	.	C	T	10	14	24	0	0	24	0	0
23	32592518	.	A	G	6	5	11	0	1	12	0	0
23	32592593	.	C	T	1	6	7	0	12	20	1	0
23	32592608	.	A	C	10	5	15	0	0	15	0	0
23	32599214	.	G	T	8	15	23	0	0	24	1	0
23	32621780	.	C	T	1	10	11	0	7	18	0	0
23	32621792	.	G	A	9	9	18	0	0	18	0	0
23	32636209	.	T	C	7	6	13	0	2	15	0	0
23	32636251	.	G	A	9	11	20	0	0	20	0	0
23	32638952	.	A	C	7	0	7	0	3	10	0	0
23	32641956	.	C	T	1	6	7	0	5	12	0	0
23	32641959	.	G	A	4	6	10	0	1	11	0	0
23	32668999	.	A	G	7	11	18	0	0	18	0	0
23	32685487	.	C	A	4	5	9	0	0	9	0	0
23	32702903	.	C	T	4	3	7	0	0	7	0	0
23	32716713	.	C	T	0	3	3	0	4	7	0	0
23	32878736	.	G	A	4	5	9	0	0	9	0	0
23	32891503	.	A	T	3	2	5	0	0	5	0	0
23	32891673	.	T	G	3	4	7	0	0	7	0	0
23	32891703	.	C	A	3	4	7	0	0	7	0	0
23	32892256	.	G	A	4	2	6	0	0	6	0	0
23	32892310	.	A	G	3	5	8	0	0	8	0	0
23	32892403	.	G	T	3	4	7	0	0	7	0	0
23	32892469	.	C	T	0	5	5	0	4	9	0	0
23	32944345	.	G	T	2	4	6	0	0	6	0	0
23	33357953	.	T	A	7	7	14	0	2	16	0	0
23	33361256	.	C	T	0	10	10	0	4	14	0	0
23	33361310	.	C	T	17	8	25	0	2	27	0	0
23	33425642	.	A	T	1	2	3	0	0	3	0	0
23	33633620	.	G	A	5	5	10	0	0	10	0	0
23	33654535	.	G	A	3	4	7	0	0	7	0	0
23	33657205	.	A	G	13	9	22	0	2	24	0	0
23	33657451	.	A	G	17	8	25	0	0	25	0	0
23	33658031	.	A	C	14	4	18	0	1	19	0	0
23	33658052	.	G	A	6	11	17	0	0	17	0	0
23	33663285	.	C	T	13	11	24	0	1	25	0	0
23	33664546	.	C	T	9	12	21	0	0	21	0	0
23	33678530	.	G	A	14	7	21	0	1	22	0	0
23	33728039	.	T	G	16	0	16	0	27	43	0	0
23	33728042	.	T	G	16	0	16	0	22	38	0	0
23	34384939	.	C	T	5	2	7	0	0	7	0	0
23	34385149	.	G	T	8	3	11	0	0	11	0	0
23	34385393	.	G	A	0	3	3	0	7	10	0	0
23	34386119	.	T	C	6	4	10	0	2	12	0	0
23	34427379	.	T	C	2	7	9	0	0	9	0	0
23	34559897	.	C	T	8	9	17	0	0	17	0	0
23	34559971	.	C	T	7	7	14	0	0	14	0	0
23	34641484	.	C	T	3	5	8	0	0	8	0	0
23	34641505	.	G	A	1	8	9	0	6	15	0	0
23	34658549	.	C	T	10	7	17	0	0	17	0	0
23	34659533	.	C	T	8	5	13	0	0	13	0	0
23	34678957	.	G	T	10	11	21	0	1	22	0	0
23	34679008	.	A	G	10	7	17	0	1	18	0	0
23	34696631	.	C	T	6	7	13	0	0	13	0	0
23	34710333	.	C	T	12	13	25	0	2	27	0	0
23	34726384	.	A	G	8	0	8	0	9	17	0	0
23	34726387	.	A	G	7	11	18	0	0	18	0	0
23	34726438	.	T	C	12	14	26	0	0	26	0	0
23	34726444	.	G	T	14	14	28	0	1	29	0	0
23	34732871	.	A	G	17	0	17	0	11	28	0	0
23	34748833	.	G	A	2	9	11	0	10	21	0	0
23	34753803	.	A	G	15	13	28	0	3	31	0	0
23	35027386	.	T	G	4	4	8	0	0	8	0	0
23	35027518	.	T	A	3	2	5	0	0	5	0	0
23	35027541	.	A	G	5	3	8	0	0	8	0	0
23	35027736	.	C	G	5	4	9	0	0	9	0	0
23	35039803	.	C	T	6	6	12	0	2	14	0	0
23	35064271	.	T	G	1	3	4	0	0	4	0	0
23	35188009	.	G	C	0	0	0	0	3	3	0	0
23	35188012	.	T	C	1	2	3	0	0	3	0	0
23	35188562	.	G	A	5	3	8	0	0	8	0	0
23	35192619	.	A	G	4	3	7	0	0	7	0	0
23	35192697	.	G	T	4	5	9	0	0	9	0	0
23	35256186	.	G	A	7	6	13	0	0	13	0	0
23	35256414	.	A	C	4	0	4	0	6	10	0	0
23	35310779	.	G	A	2	8	10	0	0	10	0	0
23	35362951	.	C	T	3	8	11	0	1	12	0	0
23	35362973	.	G	T	2	10	12	0	3	15	0	0
23	35363024	.	A	T	4	7	11	0	2	13	0	0
23	35363049	.	T	G	1	0	1	0	10	11	0	0
23	35363067	.	A	T	8	4	12	0	2	14	0	0
23	35363106	.	G	A	11	9	20	0	0	20	0	0
23	35363111	.	C	G	10	9	19	0	0	19	0	0
23	35363226	.	T	C	16	0	16	0	15	31	0	0
23	35363341	.	A	G	18	6	24	0	1	25	0	0
23	35369733	.	G	A	9	8	17	0	1	18	0	0
23	35376893	.	A	G	3	6	9	0	0	9	0	0
23	35382971	.	C	T	5	7	12	0	0	12	0	0
23	35383037	.	C	T	6	2	8	0	1	9	0	0
23	35386349	.	A	G	6	2	8	0	0	8	0	0
23	35386394	.	C	T	0	4	4	0	5	9	0	0
23	35386415	.	G	A	5	6	11	0	0	11	0	0
23	35386436	.	T	C	4	6	10	0	0	10	0	0
23	35389118	.	C	T	6	3	9	0	0	9	0	0
23	35393459	.	A	G	10	3	13	0	2	15	0	0
23	35393473	.	G	T	10	7	17	0	0	17	0	0
23	35394053	.	G	C	5	6	11	0	0	11	0	0
23	35396735	.	C	A	6	6	12	0	1	13	0	0
23	35396791	.	C	A	5	6	11	0	0	11	0	0
23	35469006	.	T	A	2	3	5	0	0	5	0	0
23	35469135	.	T	C	2	3	5	0	0	5	0	0
23	35469136	.	G	A	2	2	4	0	1	5	0	0
23	35469479	.	A	G	8	9	17	0	1	18	0	0
23	35469668	.	G	T	9	13	22	0	0	22	0	0
23	35473640	.	A	G	8	7	15	0	0	15	0	0
23	35479283	.	A	C	2	6	8	0	1	9	0	0
23	35537599	.	G	A	9	5	14	0	1	15	0	0
23	35537617	.	G	A	6	6	12	0	0	12	0	0
23	35537693	.	A	C	2	6	8	0	0	8	0	0
23	35642327	.	T	G	7	6	13	0	0	13	0	0
23	35644234	.	C	T	5	8	13	0	0	13	0	0
23	35651790	.	T	C	2	4	6	0	0	6	0	0
23	35661380	.	C	T	5	5	10	0	0	10	0	0
23	35661530	.	T	C	9	4	13	0	0	13	0	0
23	35661549	.	A	C	6	9	15	0	0	15	0	0
23	35661572	.	A	C	5	8	13	0	1	14	0	0
23	35661660	.	T	G	4	0	4	0	7	11	0	0
23	35661692	.	C	A	9	6	15	0	0	15	0	0
23	35661723	.	A	C	9	10	19	0	0	19	0	0
23	35663421	.	T	G	10	5	15	0	1	16	0	0
23	35664298	.	A	G	4	4	8	0	0	8	0	0
23	35664504	.	A	G	5	0	5	0	1	6	0	0
23	35709839	.	T	C	31	12	43	18	4	65	0	0
23	35710620	.	A	C	30	19	49	2	2	53	0	0
23	35714883	.	T	C	10	4	14	26	0	40	0	0
23	35727222	.	A	C	0	1	1	0	3	4	0	0
23	35771483	.	T	C	12	13	25	0	2	27	0	0
23	35771486	.	T	C	14	12	26	0	0	26	0	0
23	35782311	.	T	C	7	8	15	0	1	16	0	0
23	35787110	.	T	A	3	3	6	0	0	6	0	0
23	35787331	.	T	G	4	2	6	1	0	7	0	0
23	35787449	.	A	G	1	4	5	0	0	5	0	0
23	35787573	.	A	G	2	2	4	0	0	4	0	0
23	35788328	.	G	A	8	3	11	0	1	12	0	0
23	35788775	.	G	A	6	7	13	0	2	15	0	0
23	35789168	.	G	A	2	5	7	0	0	7	0	0
23	35789716	.	G	T	4	3	7	0	1	8	0	0
23	35789720	.	T	G	3	4	7	0	1	8	0	0
23	35798545	.	G	A	7	4	11	0	0	11	0	0
23	35800378	.	T	C	10	0	10	0	9	19	0	0
23	35800550	.	C	T	2	13	15	0	11	26	0	0
23	35800591	.	C	T	12	12	24	0	0	24	0	0
23	35821352	.	G	A	6	3	9	0	1	10	0	0
23	35821401	.	C	T	3	7	10	0	0	10	0	0
23	35821403	.	C	T	0	7	7	0	3	10	0	0
23	35821442	.	T	A	6	11	17	0	1	18	0	0
23	35918697	.	A	T	3	10	13	0	1	14	0	0
23	35918795	.	G	A	8	4	12	0	0	12	0	0
23	35960683	.	G	A	15	10	25	0	0	25	0	0
23	35963076	.	G	T	2	7	9	0	12	21	0	0
23	35963176	.	T	G	10	13	23	0	1	24	0	0
23	35963316	.	C	T	7	5	12	0	0	12	0	0
23	35963322	.	T	G	7	3	10	0	0	10	0	0
23	35982441	.	A	G	9	7	16	0	0	16	0	0
23	35982637	.	G	A	11	4	15	1	1	17	0	0
23	35982726	.	C	G	8	10	18	4	0	22	0	0
23	35982755	.	T	C	7	9	16	2	0	18	0	0
23	35983029	.	A	G	21	9	30	0	2	32	0	0
23	35993540	.	T	A	13	14	27	0	3	30	0	0
23	35993793	.	T	C	12	13	25	0	1	26	0	0
23	36000704	.	T	C	9	0	9	0	9	18	0	0
23	36103404	.	C	A	1	3	4	0	0	4	0	0
23	36132338	.	C	A	8	5	13	0	0	13	0	0
23	36188108	.	A	G	1	2	3	0	0	3	0	0
23	36297367	.	C	T	1	5	6	0	5	11	0	0
23	36297471	.	C	T	9	15	24	0	1	25	0	0
23	36297532	.	T	C	0	8	8	1	0	9	0	0
23	36297916	.	C	T	5	5	10	0	1	11	0	0
23	36298320	.	T	A	14	20	34	0	0	34	0	0
23	36298327	.	A	T	21	14	35	0	0	35	0	0
23	36298375	.	T	C	13	16	29	0	0	29	0	0
23	36298719	.	G	A	18	15	33	0	1	34	0	0
23	36301544	.	G	A	20	11	31	0	2	33	0	0
23	36301679	.	A	G	23	19	42	0	0	42	0	0
23	36303266	.	G	C	26	18	44	0	1	45	0	0
23	36306566	.	G	T	2	10	12	0	9	21	0	0
23	36307656	.	A	T	28	15	43	0	2	46	1	0
23	36307779	.	C	T	16	16	32	0	1	33	0	0
23	36307906	.	C	G	10	7	17	1	1	19	0	0
23	36343467	.	T	C	19	14	33	0	0	33	0	0
23	36353698	.	A	G	18	22	40	0	1	41	0	0
23	36353869	.	C	G	12	14	26	0	1	27	0	0
23	36353876	.	G	T	5	10	15	0	12	27	0	0
23	36353979	.	G	T	1	2	3	0	13	16	0	0
23	36401686	.	G	T	1	2	3	0	0	3	0	0
23	36401844	.	A	G	3	4	7	0	0	7	0	0
23	36401926	.	T	C	2	4	6	0	0	6	0	0
23	36401930	.	A	G	2	2	4	0	0	4	0	0
23	36401986	.	G	C	4	3	7	0	0	7	0	0
23	36402184	.	A	G	2	4	6	0	0	6	0	0
23	36402256	.	A	C	1	4	5	0	0	5	0	0
23	36402274	.	T	C	1	3	4	0	0	4	0	0
23	36404967	.	A	G	2	5	7	0	0	7	0	0
23	36405429	.	A	G	5	7	12	0	1	13	0	0
23	36443511	.	A	T	6	4	10	0	0	10	0	0
23	36444201	.	G	C	10	0	10	0	10	20	0	0
23	36445967	.	C	G	6	5	11	0	1	12	0	0
23	36446023	.	G	A	6	6	12	0	1	13	0	0
23	36446132	.	A	G	5	3	8	0	0	8	0	0
23	36446190	.	A	T	7	5	12	0	0	12	0	0
23	36446258	.	T	C	4	0	4	0	8	12	0	0
23	36446271	.	C	T	8	4	12	0	2	14	0	0
23	36477749	.	A	G	5	0	5	0	3	8	0	0
23	36484210	.	C	G	4	0	4	0	5	9	0	0
23	36487257	.	C	T	1	4	5	0	0	5	0	0
23	36487280	.	A	G	1	3	4	0	0	4	0	0
23	36487865	.	C	T	3	4	7	0	1	8	0	0
23	36491169	.	C	G	1	7	8	0	7	15	0	0
23	36497530	.	A	T	5	3	8	0	0	8	0	0
23	36500252	.	G	T	8	4	12	0	0	12	0	0
23	36500273	.	G	A	8	5	13	0	0	13	0	0
23	36538298	.	G	A	6	5	11	0	0	11	0	0
23	36604488	.	G	A	12	7	19	0	0	19	0	0
23	36616998	.	C	T	10	16	26	0	1	27	0	0
23	36627793	.	C	T	13	12	25	1	0	26	0	0
23	36627859	.	G	C	11	21	32	0	0	32	0	0
23	36638542	.	G	A	10	12	22	0	1	23	0	0
23	36644423	.	T	G	22	11	33	1	3	37	0	0
23	36644907	.	C	T	16	19	35	0	3	38	0	0
23	36662097	.	A	G	4	4	8	0	0	8	0	0
23	36662098	.	C	G	0	4	4	0	4	8	0	0
23	36662273	.	G	A	4	4	8	0	0	8	0	0
23	36662400	.	A	G	6	4	10	1	0	11	0	0
23	36662651	.	G	C	1	3	4	0	0	4	0	0
23	36662685	.	C	A	1	2	3	0	0	3	0	0
23	36662714	.	G	A	3	7	10	0	0	10	0	0
23	36662772	.	A	T	2	5	7	0	0	7	0	0
23	36663346	.	G	A	4	3	7	0	1	8	0	0
23	36663407	.	G	A	8	3	11	0	1	12	0	0
23	36663506	.	C	A	1	4	5	0	5	10	0	0
23	36663512	.	C	T	1	3	4	0	6	10	0	0
23	36663953	.	T	G	4	3	7	0	0	7	0	0
23	36667131	.	T	C	6	1	7	0	2	9	0	0
23	36679751	.	C	T	17	30	47	0	1	48	0	0
23	36679829	.	G	C	20	1	21	0	23	44	0	0
23	36679874	.	T	C	17	0	17	0	21	38	0	0
23	36681545	.	C	T	2	17	19	0	26	45	0	0
23	36681557	.	A	G	23	16	39	0	2	41	0	0
23	36681927	.	T	C	16	21	37	0	0	37	0	0
23	36683801	.	G	A	29	15	44	1	0	45	0	0
23	36688236	.	T	C	21	0	21	0	16	37	0	0
23	36689677	.	C	T	10	18	28	0	1	29	0	0
23	36690595	.	G	A	8	14	22	0	2	24	0	0
23	36690641	.	T	A	15	11	26	0	2	28	0	0
23	36700836	.	T	G	14	20	34	0	0	34	0	0
23	36700891	.	G	A	21	14	35	0	3	38	0	0
23	36700896	.	T	A	23	15	38	0	3	41	0	0
23	36730854	.	A	T	11	16	27	0	1	28	0	0
23	36738776	.	C	T	8	17	25	0	0	25	0	0
23	36749380	.	G	A	2	21	23	0	25	48	0	0
23	36750005	.	C	G	12	18	30	0	1	31	0	0
23	36772018	.	G	A	1	9	10	0	11	21	0	0
23	36798184	.	C	T	17	8	25	0	0	25	0	0
23	36798220	.	G	A	12	17	29	0	0	29	0	0
23	36798612	.	G	A	1	19	20	0	5	25	0	0
23	36816573	.	A	G	6	4	10	0	0	10	0	0
23	36846006	.	C	T	0	4	4	0	5	9	0	0
23	36848586	.	G	A	2	3	5	0	0	5	0	0
23	36857488	.	A	C	1	3	4	0	1	5	0	0
23	36857512	.	C	A	7	2	9	0	0	9	0	0
23	36907624	.	G	A	4	8	12	0	0	12	0	0
23	36907690	.	A	G	5	5	10	0	0	10	0	0
23	36910155	.	G	A	6	6	12	0	0	12	0	0
23	36914223	.	A	G	4	7	11	0	0	11	0	0
23	36920063	.	C	T	1	6	7	0	5	12	0	0
23	36920076	.	C	G	1	3	4	0	7	11	0	0
23	37068571	.	T	C	6	7	13	0	0	13	0	0
23	37075407	.	C	T	5	2	7	0	0	7	0	0
23	37077689	.	A	C	3	3	6	0	0	6	0	0
23	37083054	.	G	T	4	4	8	0	2	10	0	0
23	37086288	.	A	C	9	8	17	0	0	17	0	0
23	37086317	.	G	T	7	8	15	0	0	15	0	0
23	37086368	.	G	A	7	7	14	0	1	15	0	0
23	37089102	.	G	A	5	12	17	0	1	18	0	0
23	37089162	.	C	T	12	9	21	0	0	21	0	0
23	37089192	.	C	T	11	9	20	0	1	21	0	0
23	37089333	.	C	T	10	3	13	0	1	14	0	0
23	37089568	.	C	T	7	4	11	0	0	11	0	0
23	37089609	.	T	G	8	5	13	0	0	13	0	0
23	37089852	.	A	T	8	3	11	0	1	12	0	0
23	37090003	.	T	C	5	9	14	0	0	14	0	0
23	37093411	.	C	T	2	3	5	0	0	5	0	0
23	37187430	.	G	A	2	4	6	0	0	6	0	0
23	37277157	.	A	G	10	16	26	0	0	26	0	0
23	37277289	.	G	A	17	17	34	0	1	35	0	0
23	37280658	.	C	T	19	19	38	0	0	38	0	0
23	37288351	.	G	C	2	2	4	0	0	4	0	0
23	37288362	.	G	C	4	2	6	0	0	6	0	0
23	37288406	.	A	G	4	5	9	0	0	9	0	0
23	37288467	.	A	G	3	2	5	0	0	5	0	0
23	37324009	.	A	G	10	1	11	1	24	36	0	0
23	37324638	.	A	C	15	18	33	0	0	33	0	0
23	37324848	.	G	A	15	12	27	1	0	28	0	0
23	37324868	.	G	C	16	11	27	1	0	28	0	0
23	37324990	.	A	G	24	17	41	0	3	44	0	0
23	37325026	.	C	T	22	15	37	0	1	38	0	0
23	37325138	.	T	G	17	1	18	0	22	40	0	0
23	37325570	.	A	C	15	17	32	0	1	33	0	0
23	37325817	.	T	G	15	11	26	0	2	28	0	0
23	37419006	.	G	A	0	3	3	0	1	4	0	0
23	37458748	.	G	A	11	8	19	0	0	19	0	0
23	37458791	.	A	T	13	11	24	0	1	25	0	0
23	37461642	.	T	C	7	15	22	0	0	22	0	0
23	37464452	.	A	G	7	5	12	0	0	12	0	0
23	37464621	.	A	G	6	5	11	0	1	12	0	0
23	37464661	.	T	A	5	4	9	0	0	10	1	0
23	37464760	.	G	C	1	4	5	0	6	11	0	0
23	37464804	.	C	A	7	5	12	0	1	13	0	0
23	37465007	.	T	C	9	8	17	0	0	17	0	0
23	37465257	.	A	G	8	0	8	0	3	11	0	0
23	37465276	.	A	T	8	5	13	0	0	13	0	0
23	37465332	.	A	T	9	8	17	0	0	17	0	0
23	37465414	.	G	A	7	5	12	0	1	13	0	0
23	37465479	.	G	C	9	10	19	0	0	19	0	0
23	37465505	.	A	G	11	10	21	0	0	21	0	0
23	37465527	.	A	G	7	13	20	0	0	20	0	0
23	37465584	.	T	C	2	5	7	0	0	7	0	0
23	37467073	.	A	G	8	8	16	0	0	16	0	0
23	37467109	.	A	G	11	0	11	0	14	25	0	0
23	37467115	.	A	G	13	0	13	0	12	25	0	0
23	37468225	.	T	C	6	12	18	0	1	19	0	0
23	37468267	.	C	T	5	8	13	0	0	13	0	0
23	37468393	.	A	G	5	8	13	0	0	13	0	0
23	37476475	.	T	C	7	14	21	0	0	21	0	0
23	37476675	.	G	A	2	8	10	0	11	21	0	0
23	37478227	.	G	T	9	6	15	0	0	15	0	0
23	37478506	.	C	G	5	3	8	0	0	8	0	0
23	37497367	.	A	T	5	5	10	0	0	10	0	0
23	37503288	.	A	G	8	8	16	0	0	16	0	0
23	37503413	.	A	G	5	2	7	0	2	9	0	0
23	37504791	.	T	G	9	6	15	0	1	16	0	0
23	37504803	.	A	G	8	7	15	0	0	15	0	0
23	37504900	.	A	G	5	10	15	0	0	15	0	0
23	37505129	.	G	A	8	4	12	0	0	12	0	0
23	37507497	.	C	T	4	2	6	0	1	7	0	0
23	37510822	.	C	T	6	3	9	0	0	9	0	0
23	37701748	.	G	A	2	2	4	0	0	4	0	0
23	37712886	.	G	T	1	4	5	0	1	6	0	0
23	37761023	.	C	T	5	3	8	0	0	8	0	0
23	37823651	.	T	A	11	6	17	0	0	17	0	0
23	37823782	.	T	C	6	5	11	0	0	11	0	0
23	37823795	.	T	C	8	5	13	0	0	13	0	0
23	37824108	.	G	T	8	7	15	0	0	15	0	0
23	37827012	.	A	T	5	3	8	0	1	9	0	0
23	37828884	.	A	G	9	5	14	0	1	15	0	0
23	37955083	.	C	T	5	2	7	0	0	7	0	0
23	37955662	.	G	C	0	4	4	0	6	10	0	0
23	37970998	.	C	T	4	3	7	0	0	7	0	0
23	37973729	.	C	T	5	4	9	0	1	10	0	0
23	38093419	.	G	A	1	4	5	2	0	7	0	0
23	38151520	.	C	T	11	11	22	0	0	22	0	0
23	38173199	.	C	G	1	3	4	0	0	4	0	0
23	38257428	.	A	G	0	0	0	0	3	3	0	0
23	38262647	.	G	A	1	3	4	0	0	4	0	0
23	38379786	.	C	T	4	15	19	0	13	32	0	0
23	38380005	.	C	T	21	15	36	0	2	38	0	0
23	38380047	.	G	A	20	16	36	0	1	37	0	0
23	38381217	.	C	T	1	12	13	0	9	22	0	0
23	38381281	.	T	C	13	7	20	0	0	20	0	0
23	38381316	.	T	C	12	0	12	0	9	21	0	0
23	38381490	.	G	A	15	6	21	0	0	21	0	0
23	38810913	.	A	G	5	3	8	0	0	8	0	0
23	38810927	.	T	C	5	3	8	0	0	8	0	0
23	38814154	.	T	C	2	3	5	0	0	5	0	0
23	38816824	.	T	C	2	6	8	0	0	8	0	0
23	38816827	.	T	C	2	6	8	0	0	8	0	0
23	38817049	.	A	G	2	3	5	0	2	7	0	0
23	38817350	.	T	G	1	3	4	0	0	4	0	0
23	38817509	.	T	C	4	4	8	0	0	8	0	0
23	38817745	.	G	A	1	4	5	0	0	5	0	0
23	38817922	.	T	A	1	2	3	0	0	3	0	0
23	38818001	.	G	A	2	2	4	0	0	4	0	0
23	38818004	.	G	A	3	2	5	0	0	5	0	0
23	38818234	.	A	G	4	0	4	0	5	9	0	0
23	38818249	.	G	T	6	4	10	0	0	10	0	0
23	38818395	.	G	A	1	2	3	0	1	4	0	0
23	38945714	.	C	T	2	3	5	0	0	5	0	0
23	38947052	.	C	A	1	2	3	0	0	3	0	0
23	38961787	.	A	G	2	0	2	0	2	4	0	0
23	38998433	.	G	C	0	3	3	0	5	8	0	0
23	39002515	.	G	A	1	3	4	0	5	9	0	0
23	39006575	.	C	T	3	4	7	0	0	7	0	0
23	39010500	.	C	T	3	5	8	0	0	8	0	0
23	39015280	.	C	T	3	2	5	0	0	5	0	0
23	39028471	.	T	A	2	2	4	0	1	5	0	0
23	39028489	.	G	A	1	4	5	0	0	5	0	0
23	39028513	.	C	T	4	2	6	0	0	6	0	0
23	39321992	.	T	C	1	2	3	0	0	3	0	0
23	39331323	.	A	G	2	4	6	0	1	7	0	0
23	39332325	.	T	A	3	2	5	1	0	6	0	0
23	39332770	.	C	G	1	0	1	0	2	3	0	0
23	39413341	.	A	C	8	8	16	0	1	17	0	0
23	39425547	.	G	A	11	7	18	0	3	21	0	0
23	39433818	.	C	T	5	4	9	0	0	9	0	0
23	39440432	.	A	C	7	7	14	0	1	15	0	0
23	39442965	.	C	T	9	6	15	0	0	15	0	0
23	39445059	.	A	G	3	0	3	0	2	5	0	0
23	39448012	.	A	G	9	0	9	0	3	12	0	0
23	39449770	.	C	G	15	8	23	0	0	23	0	0
23	39450022	.	A	G	8	2	10	0	1	11	0	0
23	39516525	.	T	C	4	6	10	0	0	10	0	0
23	39516528	.	T	C	4	6	10	0	0	10	0	0
23	39516572	.	C	A	8	5	13	0	0	13	0	0
23	39516810	.	T	A	7	2	9	0	4	13	0	0
23	39516879	.	C	T	2	5	7	0	0	7	0	0
23	39519414	.	G	A	0	6	6	0	7	13	0	0
23	39587272	.	T	C	3	4	7	0	0	7	0	0
23	39587284	.	G	C	6	3	9	0	0	9	0	0
23	39587323	.	A	G	7	0	7	0	6	13	0	0
23	39587347	.	G	T	8	3	11	0	0	11	0	0
23	39591674	.	C	T	4	7	11	0	0	11	0	0
23	39593793	.	T	C	11	3	14	0	0	14	0	0
23	39594141	.	C	T	5	3	8	0	0	8	0	0
23	39594211	.	A	G	9	0	9	0	7	16	0	0
23	39594950	.	T	A	5	8	13	0	0	13	0	0
23	39594962	.	C	T	5	6	11	0	0	11	0	0
23	39594993	.	A	G	6	0	6	0	4	10	0	0
23	39595026	.	A	G	4	3	7	0	0	7	0	0
23	39595044	.	C	T	3	3	6	0	1	7	0	0
23	39595159	.	G	A	0	3	3	0	6	9	0	0
23	39595248	.	T	G	7	4	11	0	0	11	0	0
23	39595297	.	G	T	5	7	12	0	0	12	0	0
23	39595974	.	C	T	8	6	14	0	0	14	0	0
23	39596028	.	C	T	6	8	14	0	0	14	0	0
23	39596776	.	T	C	6	2	8	0	0	8	0	0
23	39596919	.	G	A	2	5	7	0	5	12	0	0
23	39597119	.	G	T	4	7	11	0	0	11	0	0
23	39597309	.	G	A	1	3	4	0	7	11	0	0
23	39597566	.	T	C	3	7	10	0	1	11	0	0
23	39597657	.	A	T	1	4	5	1	0	6	0	0
23	39611787	.	G	T	1	4	5	0	10	15	0	0
23	39615660	.	C	T	4	8	12	0	0	12	0	0
23	39615689	.	G	C	6	5	11	0	0	11	0	0
23	39615706	.	C	A	4	4	8	0	1	9	0	0
23	39620973	.	A	G	2	0	2	0	3	5	0	0
23	39623042	.	G	A	1	7	8	0	7	15	0	0
23	39626230	.	G	C	7	9	16	0	0	16	0	0
23	39626311	.	C	T	9	14	23	0	0	23	0	0
23	39626525	.	G	A	1	3	4	0	0	4	0	0
23	39632901	.	A	G	2	8	10	0	1	11	0	0
23	39633114	.	C	T	2	4	6	0	15	21	0	0
23	39633254	.	T	C	1	3	4	0	0	4	0	0
23	39633277	.	G	T	1	2	3	0	1	4	0	0
23	39635959	.	C	T	2	6	8	0	10	18	0	0
23	39636079	.	G	T	2	2	4	0	2	6	0	0
23	39636181	.	C	T	9	5	14	0	0	14	0	0
23	39638480	.	A	G	3	5	8	0	1	9	0	0
23	39642002	.	C	T	0	4	4	0	5	9	0	0
23	39649499	.	C	A	3	4	7	0	0	7	0	0
23	39649671	.	A	G	3	2	5	0	0	5	0	0
23	39737744	.	G	A	1	2	3	0	1	4	0	0
23	39744788	.	T	A	7	0	7	0	0	7	0	0
23	39744943	.	A	T	24	11	35	0	1	36	0	0
23	39756666	.	A	G	7	5	12	0	0	12	0	0
23	39756775	.	T	G	7	9	16	0	0	16	0	0
23	39756864	.	T	C	6	13	19	4	2	25	0	0
23	39756893	.	T	A	9	10	19	1	0	20	0	0
23	39756917	.	C	A	7	10	17	1	0	18	0	0
23	39756958	.	A	G	7	7	14	0	0	14	0	0
23	39757017	.	A	G	2	6	8	0	0	8	0	0
23	39757050	.	T	C	4	3	7	0	0	7	0	0
23	39757625	.	T	C	2	3	5	0	0	5	0	0
23	39758527	.	C	A	4	3	7	0	0	7	0	0
23	39758587	.	G	A	4	3	7	0	0	7	0	0
23	39758842	.	T	A	3	3	6	0	0	6	0	0
23	39758849	.	A	C	3	3	6	0	0	6	0	0
23	39758980	.	T	C	3	3	6	0	0	6	0	0
23	39759088	.	C	A	0	3	3	0	1	4	0	0
23	39759116	.	C	T	3	1	4	0	1	5	0	0
23	39759125	.	C	T	3	1	4	0	1	5	0	0
23	39759290	.	A	C	1	5	6	0	0	6	0	0
23	39759344	.	A	C	4	1	5	0	4	9	0	0
23	39759355	.	T	C	8	0	8	0	6	14	0	0
23	39759400	.	T	C	7	0	7	0	11	18	0	0
23	39764804	.	G	A	7	5	12	0	1	13	0	0
23	39764906	.	C	T	2	7	9	0	1	10	0	0
23	39765105	.	G	A	5	12	17	0	1	18	0	0
23	39767894	.	A	G	8	17	25	0	0	25	0	0
23	39768001	.	T	G	5	10	15	0	0	15	0	0
23	39771935	.	C	T	5	10	15	0	1	16	0	0
23	39771972	.	A	T	6	6	12	0	0	13	1	0
23	39772002	.	C	T	6	10	16	0	1	17	0	0
23	39772035	.	G	A	3	8	11	0	0	11	0	0
23	39808332	.	G	A	17	11	28	0	1	29	0	0
23	39808337	.	G	C	17	9	26	0	0	26	0	0
23	39808439	.	A	G	22	12	34	0	1	35	0	0
23	39808644	.	A	C	20	10	30	0	2	32	0	0
23	39808705	.	A	G	11	13	24	0	0	24	0	0
23	39809381	.	A	T	10	8	18	10	1	29	0	0
23	39809437	.	A	G	22	11	33	0	1	34	0	0
23	39809454	.	T	G	25	10	35	0	0	35	0	0
23	39809876	.	C	T	2	16	18	4	16	38	0	0
23	39810625	.	T	A	16	9	25	1	1	27	0	0
23	39811187	.	C	T	1	7	8	0	18	26	0	0
23	39811191	.	C	A	18	7	25	0	0	25	0	0
23	39811242	.	T	C	13	9	22	0	3	25	0	0
23	39811324	.	A	G	13	9	22	0	0	22	0	0
23	39811401	.	T	C	9	6	15	0	0	15	0	0
23	39811423	.	G	A	5	3	8	0	0	8	0	0
23	39811548	.	A	G	7	9	16	0	0	16	0	0
23	39811587	.	G	A	15	5	20	0	0	20	0	0
23	39811612	.	T	C	13	7	20	0	1	21	0	0
23	39811647	.	C	G	10	8	18	0	0	18	0	0
23	39811741	.	G	A	13	11	24	0	2	26	0	0
23	39811956	.	T	A	14	5	19	1	0	20	0	0
23	39812003	.	A	G	10	15	25	1	0	26	0	0
23	39812131	.	T	C	14	4	18	0	1	19	0	0
23	39812142	.	C	G	13	5	18	0	1	19	0	0
23	39812482	.	G	A	5	5	10	0	2	12	0	0
23	39812535	.	T	C	10	15	25	0	0	25	0	0
23	39812608	.	C	T	4	11	15	0	17	33	1	0
23	39812633	.	A	T	22	12	34	0	2	36	0	0
23	39812643	.	C	T	3	15	18	0	19	37	0	0
23	39901454	.	T	C	4	2	6	0	0	6	0	0
23	39903927	.	T	C	5	2	7	0	0	7	0	0
23	39919571	.	T	C	4	3	7	0	0	7	0	0
23	39924005	.	G	C	6	3	9	0	0	9	0	0
23	39926437	.	T	C	4	4	8	0	0	8	0	0
23	39929955	.	G	A	11	4	15	0	1	16	0	0
23	39936352	.	A	G	6	0	6	0	4	10	0	0
23	39940473	.	A	C	3	3	6	0	0	6	0	0
23	39940504	.	T	G	5	4	9	0	0	9	0	0
23	39940519	.	G	T	4	5	9	0	0	9	0	0
23	39940575	.	G	C	5	6	11	0	0	11	0	0
23	39940577	.	G	A	5	6	11	0	0	11	0	0
23	39988019	.	G	A	4	2	6	0	0	6	0	0
23	39989354	.	C	T	2	2	4	0	0	4	0	0
23	39989640	.	A	G	2	2	4	0	1	5	0	0
23	39989677	.	A	G	1	0	1	0	2	3	0	0
23	39990138	.	G	A	0	3	3	0	0	3	0	0
23	39990148	.	T	C	1	3	4	0	0	4	0	0
23	40007485	.	G	A	2	2	4	0	0	4	0	0
23	40019225	.	T	G	2	0	2	0	2	4	0	0
23	40283318	.	G	A	1	2	3	0	0	3	0	0
23	40283350	.	A	T	1	2	3	0	0	3	0	0
23	40284741	.	G	A	1	2	3	0	0	3	0	0
23	40285845	.	A	T	1	3	4	0	0	4	0	0
23	40438000	.	T	A	3	2	5	0	0	5	0	0
23	40452660	.	A	T	11	9	20	0	1	21	0	0
23	40452667	.	T	C	12	11	23	0	0	23	0	0
23	40452735	.	G	T	15	16	31	0	0	31	0	0
23	40452739	.	G	C	4	17	21	0	11	32	0	0
23	40452793	.	A	G	11	14	25	0	0	25	0	0
23	40460860	.	G	C	16	8	24	0	0	24	0	0
23	40462004	.	A	G	8	5	13	0	0	13	0	0
23	40462538	.	G	A	9	11	20	0	3	23	0	0
23	40466320	.	C	T	10	11	21	0	1	22	0	0
23	40466623	.	C	G	13	5	18	0	1	19	0	0
23	40466714	.	T	A	9	4	13	0	0	13	0	0
23	40471895	.	G	T	9	9	18	0	3	21	0	0
23	40471897	.	C	A	11	8	19	0	3	22	0	0
23	40471963	.	G	A	1	15	16	0	8	24	0	0
23	40472068	.	A	G	12	0	12	0	10	22	0	0
23	40480255	.	C	A	16	6	22	0	1	23	0	0
23	40480263	.	C	T	15	9	24	0	0	24	0	0
23	40526117	.	C	A	4	4	8	0	0	8	0	0
23	40526713	.	T	C	6	9	15	1	0	16	0	0
23	40526883	.	T	G	7	7	14	1	0	15	0	0
23	40527174	.	A	T	9	5	14	0	0	14	0	0
23	40527205	.	C	T	5	3	8	0	2	10	0	0
23	40527254	.	T	C	1	2	3	5	0	8	0	0
23	40527276	.	T	C	2	2	4	5	0	9	0	0
23	40527425	.	C	T	0	2	2	0	4	6	0	0
23	40527427	.	A	C	4	0	4	0	2	6	0	0
23	40527556	.	C	G	6	2	8	1	0	9	0	0
23	40527564	.	C	T	7	3	10	3	0	13	0	0
23	40527632	.	G	A	12	3	15	7	0	22	0	0
23	40527653	.	T	G	5	3	8	5	0	13	0	0
23	40528019	.	C	T	11	5	16	1	0	17	0	0
23	40528172	.	T	C	3	0	3	4	2	9	0	0
23	40528182	.	T	C	3	0	3	4	4	11	0	0
23	40528209	.	C	T	2	2	4	3	1	8	0	0
23	40528226	.	G	C	2	4	6	1	0	7	0	0
23	40528397	.	A	G	6	3	9	0	0	9	0	0
23	40528427	.	C	T	5	2	7	0	0	7	0	0
23	40528669	.	C	T	0	11	11	0	6	17	0	0
23	40528727	.	G	A	9	17	26	0	0	26	0	0
23	40528886	.	T	A	6	12	18	0	1	19	0	0
23	40528998	.	G	A	6	11	17	0	1	18	0	0
23	40529137	.	T	C	9	11	20	0	1	21	0	0
23	40529288	.	T	C	5	13	18	0	1	19	0	0
23	40529318	.	A	G	8	15	23	0	2	25	0	0
23	40529693	.	T	C	7	11	18	0	0	18	0	0
23	40529708	.	T	C	6	10	16	0	0	16	0	0
23	40529747	.	G	A	5	11	16	0	0	16	0	0
23	40605107	.	C	T	2	5	7	0	0	7	0	0
23	40605193	.	A	T	3	4	7	0	0	7	0	0
23	40605223	.	T	A	2	5	7	0	0	7	0	0
23	40605234	.	A	G	3	4	7	0	0	7	0	0
23	40605356	.	C	T	4	7	11	0	1	12	0	0
23	40655395	.	T	G	4	3	7	0	1	8	0	0
23	40655425	.	A	G	2	5	7	0	0	7	0	0
23	40709943	.	A	G	4	0	4	0	8	12	0	0
23	40709944	.	C	T	7	6	13	0	0	13	0	0
23	40720200	.	T	C	5	7	12	0	1	13	0	0
23	40720216	.	G	A	0	5	5	0	5	10	0	0
23	40731713	.	G	A	0	2	2	0	5	7	0	0
23	40731757	.	A	G	4	3	7	0	0	7	0	0
23	40738428	.	T	C	5	5	10	0	0	10	0	0
23	40738508	.	A	G	1	6	7	0	0	7	0	0
23	40741673	.	A	G	6	4	10	0	0	10	0	0
23	40742067	.	G	A	1	8	9	0	7	16	0	0
23	40742145	.	A	G	7	0	7	0	5	12	0	0
23	40742236	.	G	C	15	8	23	0	0	23	0	0
23	40756296	.	A	C	9	7	16	0	0	16	0	0
23	40761073	.	T	A	7	11	18	0	1	19	0	0
23	40761326	.	T	A	7	6	13	0	0	13	0	0
23	40766436	.	A	G	9	9	18	0	2	20	0	0
23	40766470	.	C	T	6	6	12	0	0	12	0	0
23	40873341	.	G	A	1	2	3	0	0	3	0	0
23	40937532	.	T	C	4	5	9	0	0	9	0	0
23	40937583	.	G	T	7	3	10	0	2	13	1	0
23	40951613	.	A	G	0	4	4	0	1	5	0	0
23	40951622	.	G	A	1	2	3	0	2	5	0	0
23	40972121	.	G	A	2	4	6	0	11	17	0	0
23	40972205	.	A	T	14	9	23	0	4	27	0	0
23	40976740	.	T	C	3	5	8	0	1	9	0	0
23	40976760	.	C	T	2	5	7	0	1	8	0	0
23	40986765	.	G	A	8	10	18	0	1	19	0	0
23	41198104	.	G	C	2	4	6	0	0	6	0	0
23	41198837	.	C	T	0	4	4	0	1	5	0	0
23	41198844	.	C	T	1	4	5	0	0	5	0	0
23	41223982	.	A	G	3	0	3	0	2	5	0	0
23	41225006	.	A	G	3	0	3	0	3	6	0	0
23	41225249	.	C	A	1	4	5	0	0	5	0	0
23	41225825	.	C	G	3	0	3	0	3	6	0	0
23	41226179	.	A	G	2	0	2	0	4	6	0	0
23	41227092	.	T	C	5	3	8	0	0	8	0	0
23	41227146	.	C	G	2	0	2	0	2	4	0	0
23	41313116	.	G	C	11	11	22	0	1	23	0	0
23	41320957	.	G	A	4	5	9	0	0	9	0	0
23	41334628	.	T	C	4	2	6	0	0	6	0	0
23	41341833	.	A	G	3	3	6	0	0	6	0	0
23	41346686	.	G	A	1	4	5	0	0	5	0	0
23	41381026	.	A	C	1	4	5	0	0	5	0	0
23	41431885	.	C	T	1	3	4	0	0	4	0	0
23	41739874	.	C	A	4	10	14	0	1	15	0	0
23	41754587	.	A	G	3	8	11	0	0	11	0	0
23	41799849	.	C	A	8	10	18	0	0	18	0	0
23	41801492	.	C	T	15	13	28	0	1	29	0	0
23	41801555	.	G	A	21	7	28	0	1	29	0	0
23	41801940	.	G	T	7	18	25	0	0	25	0	0
23	41802130	.	T	G	14	7	21	0	0	21	0	0
23	41802944	.	G	T	2	3	5	0	1	6	0	0
23	41803017	.	G	A	7	3	10	0	0	10	0	0
23	41803160	.	C	T	2	9	11	0	0	11	0	0
23	41803217	.	T	C	3	1	4	0	7	11	0	0
23	41803447	.	G	A	6	7	13	0	1	14	0	0
23	41803473	.	A	G	1	6	7	0	1	8	0	0
23	41803643	.	G	C	6	3	9	0	0	9	0	0
23	41803672	.	C	T	6	4	10	0	0	10	0	0
23	41803740	.	A	G	2	16	18	0	1	19	0	0
23	41804039	.	A	G	4	3	7	0	1	8	0	0
23	41804070	.	C	T	1	3	4	0	1	5	0	0
23	41804202	.	T	A	5	5	10	0	1	11	0	0
23	41804518	.	A	C	2	7	9	0	0	9	0	0
23	41804600	.	T	A	6	7	13	0	1	14	0	0
23	41804776	.	G	C	3	5	8	0	0	8	0	0
23	41804779	.	A	T	3	3	6	0	0	6	0	0
23	41804934	.	A	C	1	0	1	0	4	5	0	0
23	41805158	.	C	T	5	11	16	0	0	16	0	0
23	41805348	.	G	A	8	10	18	1	1	20	0	0
23	41808038	.	G	A	3	12	15	0	0	15	0	0
23	41821117	.	G	C	5	5	10	0	0	10	0	0
23	41831305	.	T	A	18	16	34	0	1	35	0	0
23	41831306	.	C	T	18	16	34	0	1	35	0	0
23	41839373	.	G	A	2	15	17	0	15	32	0	0
23	41853782	.	T	C	12	9	21	0	0	21	0	0
23	41853876	.	T	C	7	10	17	0	1	18	0	0
23	41853892	.	A	T	11	11	22	0	0	22	0	0
23	41853989	.	T	C	12	2	14	1	0	15	0	0
23	41854025	.	C	A	17	5	22	0	0	22	0	0
23	41854030	.	C	A	17	6	23	0	0	23	0	0
23	41854068	.	G	T	14	7	21	0	1	22	0	0
23	41949703	.	G	A	1	3	4	0	0	4	0	0
23	41949748	.	T	G	2	3	5	0	1	6	0	0
23	41949751	.	A	G	4	3	7	0	1	8	0	0
23	41964709	.	G	A	4	4	8	0	0	8	0	0
23	41965438	.	G	A	1	5	6	0	0	6	0	0
23	41976989	.	C	T	0	3	3	0	1	4	0	0
23	41983378	.	G	C	1	4	5	0	0	5	0	0
23	42000700	.	C	T	2	4	6	0	1	7	0	0
23	42131766	.	G	A	3	4	7	0	0	7	0	0
23	42131779	.	A	T	2	5	7	0	0	7	0	0
23	42259236	.	G	A	0	3	3	0	1	4	0	0
23	42275411	.	A	T	5	3	8	0	0	8	0	0
23	42283476	.	A	G	7	4	11	0	1	12	0	0
23	42640037	.	A	T	1	2	3	0	0	3	0	0
23	42640631	.	C	T	2	2	4	0	1	5	0	0
23	42641879	.	T	C	10	4	14	1	1	16	0	0
23	42642044	.	G	A	7	2	9	0	1	10	0	0
23	42642182	.	T	G	14	4	18	0	2	20	0	0
23	42642253	.	C	T	16	5	21	0	0	21	0	0
23	42642361	.	G	A	13	2	15	0	1	16	0	0
23	42642435	.	A	G	11	0	11	2	9	22	0	0
23	42642593	.	T	G	9	3	12	0	1	13	0	0
23	42642623	.	C	A	8	2	10	0	2	12	0	0
23	42642629	.	T	G	7	4	11	0	0	11	0	0
23	42642672	.	T	C	3	4	7	0	0	7	0	0
23	42642673	.	G	A	3	3	6	0	1	7	0	0
23	42642780	.	G	T	4	2	6	0	0	6	0	0
23	42765741	.	C	T	5	3	8	0	0	8	0	0
23	42766124	.	C	A	3	3	6	0	0	6	0	0
23	42766311	.	T	A	1	3	4	0	0	4	0	0
23	42766378	.	A	G	2	2	4	0	1	5	0	0
23	42766561	.	T	C	1	0	1	0	4	5	0	0
23	42766563	.	T	C	3	3	6	0	0	6	0	0
23	42766607	.	G	A	4	3	7	0	0	7	0	0
23	42766609	.	A	T	4	3	7	0	0	7	0	0
23	42766656	.	A	G	4	2	6	1	0	7	0	0
23	42766672	.	C	T	0	2	2	1	3	6	0	0
23	42767453	.	C	T	1	7	8	0	7	15	0	0
23	43499036	.	C	G	5	4	9	0	0	9	0	0
23	43508198	.	A	G	1	0	1	0	2	3	0	0
23	43508528	.	A	G	1	0	1	0	2	3	0	0
23	43513159	.	T	G	4	0	4	0	3	7	0	0
23	43516287	.	C	T	4	3	7	0	0	7	0	0
23	43519409	.	G	A	4	3	7	0	0	7	0	0
23	43519414	.	G	A	4	3	7	0	0	7	0	0
23	43519618	.	G	C	3	3	6	0	0	6	0	0
23	43519636	.	C	G	3	3	6	0	0	6	0	0
23	43535874	.	G	A	2	3	5	0	0	5	0	0
23	43539296	.	G	T	5	3	8	0	0	8	0	0
23	43540359	.	G	C	2	3	5	0	1	6	0	0
23	43543197	.	A	G	2	4	6	0	0	6	0	0
23	43543281	.	G	T	2	3	5	0	0	5	0	0
23	43543618	.	T	C	1	2	3	0	0	3	0	0
23	43543654	.	C	T	3	3	6	0	1	7	0	0
23	43543860	.	G	T	4	4	8	0	0	8	0	0
23	43544974	.	A	G	2	5	7	0	0	7	0	0
23	43544995	.	C	T	3	5	8	0	0	8	0	0
23	43548754	.	A	G	5	3	8	0	0	8	0	0
23	43556499	.	A	G	1	6	7	0	0	7	0	0
23	43559313	.	T	C	3	0	3	0	6	9	0	0
23	43561561	.	T	G	1	9	10	0	0	10	0	0
23	43565947	.	T	C	1	3	4	0	0	4	0	0
23	43642345	.	A	G	4	0	4	0	3	7	0	0
23	43643229	.	C	T	4	2	6	0	0	6	0	0
23	43643265	.	T	C	2	4	6	0	0	6	0	0
23	43649431	.	T	C	3	2	5	0	0	5	0	0
23	43652819	.	T	C	5	2	7	0	1	8	0	0
23	43652912	.	G	T	0	2	2	0	3	5	0	0
23	43668792	.	C	T	2	2	4	0	0	4	0	0
23	43668793	.	C	T	2	2	4	0	0	4	0	0
23	43668973	.	T	A	1	2	3	0	0	3	0	0
23	43668990	.	G	T	1	4	5	0	0	5	0	0
23	43686023	.	G	A	2	3	5	0	0	5	0	0
23	43686048	.	G	C	1	2	3	0	1	4	0	0
23	43688341	.	C	T	5	3	8	0	1	9	0	0
23	43688810	.	T	C	5	5	10	0	0	10	0	0
23	43688838	.	C	A	3	6	9	0	0	9	0	0
23	43689026	.	A	T	7	5	12	0	1	13	0	0
23	43689034	.	C	G	7	4	11	0	2	13	0	0
23	43689202	.	T	C	2	3	5	0	0	5	0	0
23	43690394	.	A	G	3	3	6	0	1	7	0	0
23	43690506	.	C	A	5	2	7	0	1	8	0	0
23	43690629	.	C	G	8	0	8	0	4	12	0	0
23	43691069	.	G	A	2	3	5	0	0	5	0	0
23	43691117	.	T	G	5	5	10	0	0	10	0	0
23	43691810	.	A	T	1	3	4	0	0	4	0	0
23	43695927	.	C	A	0	8	8	0	8	16	0	0
23	43696095	.	G	A	19	15	34	0	1	35	0	0
23	43696211	.	G	T	26	17	43	0	1	44	0	0
23	43696355	.	G	A	17	21	38	0	4	42	0	0
23	43699846	.	A	G	19	15	34	0	1	35	0	0
23	43700064	.	T	C	13	0	13	0	17	30	0	0
23	43700114	.	G	A	11	13	24	0	0	24	0	0
23	43700121	.	G	A	11	11	22	0	0	22	0	0
23	43705961	.	G	T	15	25	40	0	2	42	0	0
23	43706003	.	A	G	15	27	42	0	1	43	0	0
23	43706102	.	T	G	16	18	34	0	1	35	0	0
23	43713602	.	A	G	8	10	18	0	0	18	0	0
23	43713692	.	T	A	6	7	13	0	1	14	0	0
23	43718169	.	T	A	2	6	8	0	0	8	0	0
23	43718185	.	T	A	2	6	8	0	0	8	0	0
23	43718225	.	G	A	0	4	4	0	1	5	0	0
23	43718257	.	G	T	2	7	9	0	0	9	0	0
23	43718947	.	A	G	4	6	10	0	0	10	0	0
23	43718977	.	C	T	5	4	9	0	0	9	0	0
23	43723615	.	G	A	9	9	18	0	0	18	0	0
23	43723633	.	C	T	8	9	17	0	1	18	0	0
23	43723765	.	C	T	5	3	8	0	0	8	0	0
23	43770210	.	C	T	9	9	18	0	0	18	0	0
23	43770240	.	A	C	12	12	24	0	0	24	0	0
23	43770279	.	A	T	10	9	19	0	0	19	0	0
23	43770319	.	T	G	9	0	9	0	8	17	0	0
23	43770360	.	A	T	9	6	15	0	0	15	0	0
23	43770414	.	T	C	11	10	21	0	1	22	0	0
23	43770433	.	T	C	11	11	22	0	1	23	0	0
23	43770467	.	T	C	11	12	23	0	0	23	0	0
23	43770583	.	C	A	16	5	21	0	0	21	0	0
23	43770634	.	G	C	11	12	23	0	2	25	0	0
23	43770832	.	T	C	15	9	24	0	0	24	0	0
23	43778396	.	T	G	7	12	19	0	2	21	0	0
23	43780214	.	C	T	14	8	22	0	0	22	0	0
23	43781781	.	C	T	12	8	20	0	0	20	0	0
23	43784985	.	C	T	11	9	20	0	1	21	0	0
23	43799463	.	T	C	2	3	5	0	0	5	0	0
23	43799542	.	G	C	4	4	8	0	0	8	0	0
23	43799598	.	G	C	0	2	2	0	2	4	0	0
23	43799798	.	A	C	1	7	8	0	0	8	0	0
23	43799835	.	A	G	2	0	2	0	4	6	0	0
23	43800684	.	G	A	0	3	3	0	6	9	0	0
23	43800701	.	T	C	5	3	8	0	1	9	0	0
23	43800723	.	G	A	1	6	7	0	3	10	0	0
23	43800747	.	A	C	2	3	5	0	0	5	0	0
23	43800912	.	C	T	3	2	5	0	0	5	0	0
23	43800968	.	T	G	1	5	6	0	1	8	1	0
23	43800983	.	G	A	3	5	8	0	0	8	0	0
23	43801018	.	A	G	6	0	6	0	3	9	0	0
23	43801090	.	A	C	2	3	5	0	0	5	0	0
23	43801284	.	C	G	3	2	5	0	0	5	0	0
23	43801687	.	C	T	2	3	5	0	0	5	0	0
23	43802158	.	A	T	3	3	6	0	0	6	0	0
23	43829883	.	C	T	1	2	3	0	0	3	0	0
23	43829943	.	A	G	3	2	5	0	0	5	0	0
23	43876103	.	C	A	5	3	8	0	0	8	0	0
23	43876109	.	T	A	5	3	8	0	0	8	0	0
23	43876158	.	A	C	3	5	8	0	0	8	0	0
23	43876163	.	T	G	4	0	4	0	5	9	0	0
23	43889641	.	T	C	5	7	12	0	1	13	0	0
23	43898097	.	A	C	4	3	7	0	0	7	0	0
23	44180513	.	C	A	2	5	7	1	0	8	0	0
23	44521330	.	A	G	9	7	16	0	1	17	0	0
23	44621690	.	C	A	2	14	16	0	0	16	0	0
23	44713115	.	C	T	0	4	4	0	4	8	0	0
23	45201028	.	T	C	6	2	8	5	0	13	0	0
23	45244364	.	C	T	5	5	10	0	0	10	0	0
23	45254318	.	T	C	11	4	15	0	1	16	0	0
23	45254321	.	T	C	11	5	16	0	0	16	0	0
23	45287609	.	C	A	2	4	6	0	0	6	0	0
23	45295434	.	G	A	0	3	3	0	1	4	0	0
23	45423068	.	C	T	3	3	6	0	5	11	0	0
23	45423138	.	A	C	5	5	10	0	1	11	0	0
23	45423167	.	T	C	6	4	10	0	2	12	0	0
23	45423268	.	A	G	1	2	3	0	0	3	0	0
23	45423324	.	G	T	4	4	8	0	0	8	0	0
23	45424249	.	A	C	3	1	4	0	0	4	0	0
23	45425030	.	A	C	3	2	5	0	0	5	0	0
23	45515555	.	C	G	8	3	11	0	2	13	0	0
23	45515570	.	C	G	8	0	8	0	3	11	0	0
23	45516336	.	C	T	5	11	16	0	0	16	0	0
23	45516867	.	C	G	4	6	10	0	1	11	0	0
23	45521246	.	G	C	6	5	11	0	1	12	0	0
23	45521385	.	T	G	2	4	6	0	0	7	1	0
23	45521492	.	G	A	8	3	11	0	1	12	0	0
23	45521557	.	A	G	6	6	12	0	0	12	0	0
23	45521622	.	C	T	6	6	12	0	0	12	0	0
23	45521742	.	T	G	6	3	9	0	0	9	0	0
23	45521775	.	C	T	5	3	8	0	0	8	0	0
23	45521811	.	A	G	8	6	14	0	1	15	0	0
23	45521816	.	T	A	7	8	15	0	0	15	0	0
23	45521853	.	G	A	10	11	21	0	1	22	0	0
23	45521857	.	G	A	10	9	19	0	3	22	0	0
23	45521942	.	A	G	10	11	21	0	0	21	0	0
23	45521995	.	G	A	6	4	10	0	1	11	0	0
23	45522046	.	G	A	10	7	17	0	1	18	0	0
23	45522166	.	T	G	10	7	17	0	0	17	0	0
23	45522170	.	T	G	8	6	14	0	3	17	0	0
23	45522238	.	A	G	13	14	27	0	0	27	0	0
23	45522434	.	G	A	8	14	22	0	1	23	0	0
23	45523295	.	C	T	10	6	16	0	0	16	0	0
23	45523321	.	A	C	6	3	9	0	0	9	0	0
23	45523409	.	T	C	16	7	23	0	1	24	0	0
23	45523562	.	A	G	4	0	4	0	6	10	0	0
23	45523619	.	C	T	1	6	7	0	0	7	0	0
23	45523669	.	A	T	5	4	9	0	0	9	0	0
23	45547600	.	A	C	7	20	27	0	2	29	0	0
23	45547807	.	A	G	6	1	7	0	15	22	0	0
23	45547902	.	C	T	13	15	28	0	1	29	0	0
23	45548034	.	G	C	8	10	18	1	0	19	0	0
23	45548140	.	G	A	7	8	15	0	4	19	0	0
23	45548355	.	A	G	3	5	8	0	0	8	0	0
23	45548641	.	A	C	3	3	6	0	3	9	0	0
23	45548703	.	C	T	2	6	8	0	0	8	0	0
23	45548704	.	T	A	2	5	7	0	1	8	0	0
23	45579547	.	A	G	25	19	44	0	1	45	0	0
23	45579629	.	A	C	30	19	49	0	4	53	0	0
23	45580052	.	C	T	32	24	56	0	2	58	0	0
23	45580442	.	C	T	32	39	71	0	2	73	0	0
23	45580508	.	C	T	37	23	60	0	4	64	0	0
23	45580562	.	C	T	43	20	63	0	1	64	0	0
23	45581181	.	C	T	18	31	49	0	2	51	0	0
23	45586565	.	T	C	4	5	9	0	0	9	0	0
23	45586744	.	C	A	3	3	6	0	0	6	0	0
23	45586828	.	A	T	6	4	10	0	0	10	0	0
23	45586833	.	G	A	6	5	11	0	0	11	0	0
23	45586979	.	G	A	7	9	16	0	0	16	0	0
23	45587030	.	G	C	7	6	13	0	0	13	0	0
23	45587301	.	G	A	4	3	7	0	0	7	0	0
23	45587537	.	T	A	4	2	6	0	1	7	0	0
23	45587552	.	A	G	3	3	6	0	0	6	0	0
23	45587609	.	T	C	6	4	10	0	0	10	0	0
23	45587702	.	C	T	6	2	8	0	0	8	0	0
23	45587732	.	T	C	7	4	11	0	0	11	0	0
23	45587875	.	T	C	5	5	10	1	0	11	0	0
23	45587883	.	C	A	5	5	10	0	0	10	0	0
23	45588149	.	T	C	3	4	7	0	1	8	0	0
23	45588412	.	G	A	0	3	3	0	10	13	0	0
23	45588595	.	T	C	5	6	11	0	0	11	0	0
23	45591606	.	A	G	8	0	8	0	8	16	0	0
23	45591639	.	A	G	5	14	19	0	2	21	0	0
23	45595151	.	C	T	14	11	25	0	1	26	0	0
23	45595178	.	C	T	8	10	18	0	1	19	0	0
23	45596217	.	C	T	3	3	6	0	0	6	0	0
23	45600575	.	A	G	9	4	13	0	0	13	0	0
23	45600773	.	G	C	0	5	5	0	8	13	0	0
23	45622106	.	G	A	2	11	13	0	0	13	0	0
23	46208578	.	T	G	14	16	30	0	1	31	0	0
23	46208611	.	T	G	17	16	33	0	1	34	0	0
23	46208718	.	G	A	26	11	37	0	2	39	0	0
23	46217045	.	C	A	26	16	42	0	0	42	0	0
24	187640	.	A	G	17	0	17	0	9	26	0	0
24	187643	.	A	G	14	11	25	0	0	25	0	0
24	187946	.	A	G	5	4	9	0	0	9	0	0
24	187971	.	A	G	4	3	7	0	0	7	0	0
24	788018	.	T	C	4	2	6	0	0	6	0	0
24	788021	.	T	C	4	1	5	0	1	6	0	0
24	788384	.	A	G	1	5	6	0	0	6	0	0
24	788409	.	A	G	5	0	5	0	3	8	0	0
24	788419	.	A	G	3	0	3	0	2	5	0	0
24	903325	.	C	G	1	2	3	0	0	3	0	0
24	926274	.	C	A	1	4	5	0	0	5	0	0
24	941176	.	G	A	1	2	3	0	0	3	0	0
24	945526	.	C	T	0	16	16	0	5	21	0	0
24	945537	.	G	A	5	15	20	0	2	22	0	0
24	945706	.	T	C	12	13	25	0	0	25	0	0
24	945841	.	T	G	8	5	13	0	0	13	0	0
24	945869	.	T	G	6	6	12	0	2	14	0	0
24	945883	.	G	A	5	7	12	0	0	12	0	0
24	947503	.	G	C	7	4	11	0	0	11	0	0
24	947518	.	C	T	3	4	7	1	4	12	0	0
24	947611	.	C	T	3	8	11	0	3	14	0	0
24	947680	.	T	C	9	1	10	0	7	17	0	0
24	947957	.	C	A	4	8	12	0	6	18	0	0
24	947984	.	G	C	8	8	16	0	1	17	0	0
24	948351	.	T	A	6	9	15	0	0	15	0	0
24	948438	.	T	C	12	2	14	0	7	21	0	0
24	948466	.	C	G	4	8	12	0	5	17	0	0
24	948503	.	C	T	5	13	18	0	5	23	0	0
24	948565	.	T	C	11	3	14	0	6	20	0	0
24	948609	.	G	T	6	13	19	0	5	24	0	0
24	948729	.	G	A	8	8	16	0	2	18	0	0
24	948806	.	G	A	10	12	22	0	1	23	0	0
24	984888	.	C	A	3	6	9	0	1	10	0	0
24	985094	.	A	T	11	8	19	0	0	19	0	0
24	985438	.	A	C	10	8	18	0	0	18	0	0
24	985748	.	G	A	11	7	18	0	1	19	0	0
24	988274	.	G	A	13	6	19	0	1	20	0	0
24	988373	.	A	C	7	0	7	0	9	16	0	0
24	988810	.	G	A	6	6	12	0	2	14	0	0
24	992228	.	T	G	1	5	6	0	1	7	0	0
24	1000040	.	A	G	5	12	17	0	1	18	0	0
24	1002664	.	T	C	6	10	16	0	0	16	0	0
24	1002757	.	T	C	9	3	12	0	0	12	0	0
24	1003265	.	G	C	11	8	19	0	1	20	0	0
24	1003278	.	C	T	1	9	10	0	12	22	0	0
24	1003596	.	G	A	10	8	18	0	1	19	0	0
24	1009078	.	A	G	5	9	14	0	1	15	0	0
24	1009381	.	C	A	0	5	5	0	2	7	0	0
24	1010190	.	T	C	3	0	3	0	3	6	0	0
24	1010205	.	A	T	5	3	8	0	0	8	0	0
24	1010347	.	G	T	10	4	14	0	0	14	0	0
24	1011355	.	A	T	1	1	2	0	0	2	0	0
24	1011372	.	G	A	2	3	5	0	0	5	0	0
24	1011897	.	T	A	2	4	6	0	0	6	0	0
24	1013105	.	T	G	8	3	11	0	0	11	0	0
24	1013106	.	G	T	8	3	11	0	0	11	0	0
24	1013142	.	G	A	9	5	14	0	1	15	0	0
24	1013799	.	C	A	3	2	5	0	1	6	0	0
24	1014927	.	G	A	3	4	7	0	0	7	0	0
24	1015292	.	T	C	14	0	14	0	15	29	0	0
24	1018672	.	T	C	17	0	17	0	20	37	0	0
24	1021216	.	T	G	25	9	34	0	0	34	0	0
24	1021222	.	A	G	23	6	29	0	0	29	0	0
24	1022962	.	G	A	3	5	8	4	1	13	0	0
24	1022986	.	C	A	1	9	10	3	7	20	0	0
24	1110429	.	A	G	1	2	3	0	1	4	0	0
24	1110748	.	T	C	1	4	5	0	0	5	0	0
24	1111024	.	C	G	2	3	5	0	0	5	0	0
24	1111055	.	C	A	3	4	7	0	0	8	1	0
24	1111102	.	G	T	6	2	8	0	0	8	0	0
24	1111273	.	T	C	5	3	8	0	0	8	0	0
24	1111571	.	T	A	3	7	10	0	0	10	0	0
24	1111572	.	G	T	3	6	9	0	1	10	0	0
24	1111628	.	A	C	4	2	6	0	1	7	0	0
24	1112365	.	T	C	1	0	1	0	2	3	0	0
24	1112679	.	A	T	3	3	6	0	1	7	0	0
24	1113036	.	T	A	2	2	4	0	0	4	0	0
24	1113050	.	A	G	2	2	4	0	0	4	0	0
24	1113121	.	A	G	5	4	9	0	0	9	0	0
24	1113148	.	G	T	5	3	8	0	0	8	0	0
24	1119112	.	G	A	4	4	8	0	0	8	0	0
24	1120999	.	T	C	3	2	5	0	0	5	0	0
24	1126974	.	G	A	1	2	3	0	0	3	0	0
24	1151291	.	G	C	1	3	4	0	0	4	0	0
24	1162622	.	T	A	9	24	33	0	1	34	0	0
24	1163184	.	A	G	19	16	35	0	2	37	0	0
24	1165052	.	A	G	23	15	38	0	1	39	0	0
24	1165088	.	G	C	19	12	31	0	1	32	0	0
24	1167263	.	G	A	15	13	28	0	0	28	0	0
24	1167338	.	C	T	1	15	16	0	13	29	0	0
24	1167413	.	A	G	23	9	32	0	6	38	0	0
24	1167506	.	G	A	22	17	39	0	0	39	0	0
24	1169336	.	T	C	30	0	30	2	18	50	0	0
24	1185225	.	G	T	14	9	23	0	2	25	0	0
24	1185374	.	G	C	12	18	30	0	0	30	0	0
24	1195775	.	C	T	9	11	20	0	1	21	0	0
24	1203573	.	A	G	11	11	22	1	1	24	0	0
24	1229571	.	A	G	19	16	35	0	0	35	0	0
24	1229646	.	G	C	15	0	15	0	21	36	0	0
24	1229683	.	G	C	18	18	36	0	1	37	0	0
24	1236358	.	A	G	22	17	39	0	2	41	0	0
24	1301258	.	C	T	11	13	24	0	0	24	0	0
24	1303660	.	G	T	18	11	29	0	0	29	0	0
24	1374847	.	G	A	5	2	7	2	0	9	0	0
24	2284197	.	G	C	15	11	26	0	0	26	0	0
24	2284279	.	C	T	2	20	22	0	12	34	0	0
24	2284458	.	G	A	15	13	28	0	1	29	0	0
24	2287254	.	C	G	14	14	28	0	1	29	0	0
24	2289991	.	C	T	1	11	12	0	10	22	0	0
24	2290232	.	T	C	9	0	9	0	12	21	0	0
24	2293360	.	G	A	15	9	24	1	1	26	0	0
24	2298000	.	A	G	9	9	18	0	2	20	0	0
24	2303778	.	G	A	8	9	17	0	0	17	0	0
24	2307342	.	C	T	10	8	18	0	2	20	0	0
24	2308075	.	A	G	6	8	14	0	0	14	0	0
24	2319969	.	A	G	3	2	5	0	1	6	0	0
24	2322219	.	C	T	3	3	6	0	0	6	0	0
24	2322228	.	C	T	2	3	5	0	0	5	0	0
24	2322261	.	G	A	2	6	8	0	0	8	0	0
24	2322351	.	T	C	2	4	6	0	0	6	0	0
24	2322519	.	A	G	3	2	5	0	0	5	0	0
24	2322748	.	A	G	1	2	3	0	1	4	0	0
24	2324438	.	A	G	1	2	3	0	0	3	0	0
24	2324477	.	C	T	1	2	3	0	0	3	0	0
24	2326950	.	G	C	3	4	7	0	0	7	0	0
24	2327254	.	A	G	4	0	4	0	7	11	0	0
24	2327295	.	T	C	3	3	6	0	0	6	0	0
24	2327815	.	G	A	1	3	4	0	4	8	0	0
24	2327832	.	C	T	4	5	9	0	0	9	0	0
24	2327866	.	C	G	3	5	8	0	0	8	0	0
24	2327935	.	T	C	4	6	10	0	0	10	0	0
24	2330491	.	T	C	8	3	11	0	0	11	0	0
24	2331156	.	A	G	1	0	1	0	5	6	0	0
24	2331198	.	G	A	6	3	9	0	0	9	0	0
24	2331387	.	G	A	1	2	3	0	7	10	0	0
24	2333841	.	T	C	4	4	8	0	0	8	0	0
24	2340379	.	C	T	2	3	5	0	0	5	0	0
24	2348580	.	C	T	1	2	3	0	0	3	0	0
24	2348589	.	T	C	1	2	3	0	0	3	0	0
24	2524848	.	C	A	30	19	49	0	1	50	0	0
24	2524868	.	C	T	26	23	49	0	3	52	0	0
24	2524903	.	A	T	22	16	38	0	3	41	0	0
24	2558323	.	G	A	6	2	8	0	0	8	0	0
24	2558354	.	G	A	1	4	5	0	0	5	0	0
24	2642517	.	G	A	4	3	7	0	1	8	0	0
24	2684081	.	T	G	4	4	8	0	0	8	0	0
24	2684208	.	A	G	4	5	9	0	0	9	0	0
24	2684265	.	T	C	5	2	7	0	0	7	0	0
24	2684314	.	C	T	2	3	5	0	0	5	0	0
24	2684417	.	C	T	0	6	6	0	7	13	0	0
24	2684455	.	A	G	6	4	10	0	0	10	0	0
24	2684481	.	G	A	4	7	11	0	1	12	0	0
24	2762780	.	C	A	6	3	9	0	1	10	0	0
24	2762782	.	G	A	1	3	4	0	6	10	0	0
24	2821435	.	G	A	6	9	15	2	0	17	0	0
24	2890937	.	T	A	1	2	3	0	0	3	0	0
24	2890943	.	A	G	1	2	3	0	0	3	0	0
24	2891081	.	T	C	1	0	1	0	2	3	0	0
24	2891187	.	T	G	4	3	7	0	0	7	0	0
24	2891188	.	A	T	4	3	7	0	0	7	0	0
24	2891258	.	A	G	2	3	5	0	0	5	0	0
24	2891263	.	T	C	2	2	4	0	0	4	0	0
24	2892688	.	G	T	12	7	19	0	0	19	0	0
24	2892951	.	T	C	3	3	6	0	2	8	0	0
24	2893003	.	A	T	2	10	12	0	2	14	0	0
24	2893056	.	T	G	6	9	15	0	2	17	0	0
24	2893175	.	C	G	5	2	7	0	0	7	0	0
24	2893342	.	T	C	3	4	7	0	0	7	0	0
24	2917174	.	A	T	4	3	7	0	0	7	0	0
24	2961142	.	C	G	11	11	22	0	0	22	0	0
24	2963066	.	C	G	5	6	11	0	0	11	0	0
24	2964809	.	C	T	15	7	22	0	0	22	0	0
24	2966557	.	C	T	8	4	12	0	0	13	1	0
24	2971595	.	T	C	18	13	31	0	2	33	0	0
24	2971684	.	A	G	6	14	20	0	0	20	0	0
24	2971747	.	G	T	16	10	26	0	0	26	0	0
24	2971890	.	A	G	5	5	10	0	1	11	0	0
24	3059710	.	C	T	4	8	12	0	0	12	0	0
24	3061408	.	A	G	3	0	3	0	5	8	0	0
24	3061476	.	C	T	2	4	6	0	0	6	0	0
24	3325645	.	C	G	3	3	6	0	0	6	0	0
24	3325851	.	G	C	2	2	4	0	0	4	0	0
24	3325877	.	T	A	2	3	5	0	0	5	0	0
24	3326069	.	T	A	1	2	3	0	0	3	0	0
24	3328397	.	C	G	14	11	25	0	1	26	0	0
24	3328473	.	A	T	8	8	16	0	1	17	0	0
24	3328532	.	T	C	8	9	17	0	0	17	0	0
24	3333539	.	A	G	6	7	13	0	0	13	0	0
24	3333940	.	G	A	8	11	19	0	1	20	0	0
24	3335963	.	G	A	2	11	13	0	12	25	0	0
24	3336199	.	C	T	13	17	30	0	2	32	0	0
24	3336236	.	G	A	0	11	11	0	13	24	0	0
24	3348012	.	G	T	7	7	14	0	0	14	0	0
24	3348503	.	C	T	1	7	8	0	15	23	0	0
24	3348530	.	C	T	14	7	21	0	0	21	0	0
24	3350081	.	T	C	13	0	13	0	7	20	0	0
24	3350408	.	T	G	7	7	14	0	0	15	1	0
24	3350426	.	T	C	8	5	13	0	3	16	0	0
24	3350639	.	A	G	5	10	15	0	1	16	0	0
24	3374783	.	G	A	10	6	16	0	0	16	0	0
24	3470088	.	T	C	11	8	19	0	1	20	0	0
24	3470608	.	T	C	5	2	7	0	0	7	0	0
24	3471272	.	T	C	7	3	10	0	1	11	0	0
24	3572355	.	G	A	2	3	5	0	1	6	0	0
24	3623954	.	G	A	1	3	4	0	0	4	0	0
24	3623984	.	C	T	4	2	6	0	0	6	0	0
24	3624089	.	G	A	2	4	6	0	0	6	0	0
24	3783180	.	G	A	1	3	4	0	0	4	0	0
24	3963803	.	G	A	11	6	17	0	0	17	0	0
24	3972295	.	C	T	31	24	55	0	3	58	0	0
24	3983324	.	G	A	26	29	55	0	4	59	0	0
24	3990337	.	G	A	4	37	41	0	22	64	1	0
24	4000242	.	C	T	39	22	61	0	1	62	0	0
24	4000308	.	T	C	25	32	57	0	3	60	0	0
24	4000323	.	C	T	32	22	54	0	2	56	0	0
24	4002905	.	C	G	34	20	54	0	0	54	0	0
24	4002966	.	A	G	27	27	54	0	1	55	0	0
24	4002997	.	C	T	31	25	56	1	0	57	0	0
24	4003172	.	C	T	19	27	46	0	0	46	0	0
24	4003533	.	C	T	36	34	70	0	3	73	0	0
24	4003559	.	G	A	28	40	68	0	2	70	0	0
24	4003598	.	C	T	11	39	50	0	12	62	0	0
24	4003693	.	A	C	34	30	64	0	5	69	0	0
24	4003782	.	C	A	34	20	54	0	0	54	0	0
24	4003800	.	T	C	34	19	53	0	4	57	0	0
24	4003842	.	G	A	29	24	53	5	3	61	0	0
24	4003947	.	G	A	2	30	32	0	12	44	0	0
24	4003978	.	G	A	17	14	31	0	6	37	0	0
24	4004041	.	C	A	5	17	22	0	0	22	0	0
24	4004046	.	G	C	3	17	20	0	0	20	0	0
24	4142777	.	C	T	0	5	5	0	9	14	0	0
24	4142856	.	C	T	11	7	18	0	0	18	0	0
24	4142898	.	T	C	11	7	18	0	3	21	0	0
24	4143517	.	T	A	11	6	17	0	0	17	0	0
24	4373109	.	C	T	7	6	13	0	0	13	0	0
24	4412690	.	G	A	1	7	8	0	4	12	0	0
24	4412717	.	C	T	8	3	11	0	1	12	0	0
24	4417793	.	G	A	4	5	9	0	1	10	0	0
24	4421183	.	C	T	5	8	13	0	0	13	0	0
24	4448608	.	T	C	6	5	11	0	0	11	0	0
24	4449787	.	G	A	6	4	10	0	0	10	0	0
24	4449939	.	C	A	7	7	14	0	0	14	0	0
24	4450011	.	G	A	5	2	7	0	0	7	0	0
24	4450139	.	A	C	4	4	8	0	0	8	0	0
24	4450161	.	C	T	8	7	15	0	0	15	0	0
24	4970956	.	T	C	28	21	49	0	3	52	0	0
24	4971126	.	G	T	28	30	58	0	4	62	0	0
24	4972735	.	G	A	28	29	57	0	10	67	0	0
24	4981740	.	G	A	9	12	21	0	1	22	0	0
24	4981964	.	A	T	1	2	3	0	1	4	0	0
24	4982070	.	A	T	1	2	3	0	0	3	0	0
24	5210628	.	G	A	11	11	22	0	0	22	0	0
24	5213008	.	G	T	9	4	13	0	0	13	0	0
24	5213029	.	C	T	9	6	15	0	0	15	0	0
24	5214786	.	A	C	4	9	13	0	0	13	0	0
24	5996942	.	A	T	13	10	23	0	0	23	0	0
24	5996996	.	G	A	17	12	29	0	5	34	0	0
24	6002538	.	C	G	15	0	15	0	22	37	0	0
24	6002628	.	T	C	22	11	33	0	0	33	0	0
24	6008674	.	G	A	9	7	16	0	4	20	0	0
24	6010450	.	C	T	9	9	18	0	1	19	0	0
24	6010598	.	G	A	3	5	8	0	13	21	0	0
24	6010690	.	G	A	12	8	20	0	0	20	0	0
24	6010700	.	A	T	11	7	18	0	0	18	0	0
24	6010770	.	C	T	15	8	23	0	0	23	0	0
24	6010801	.	G	A	14	13	27	0	0	27	0	0
24	6010830	.	A	T	10	9	19	0	0	19	0	0
24	6011063	.	G	T	1	3	4	0	0	4	0	0
24	6011271	.	T	G	4	3	7	0	2	9	0	0
24	6012374	.	T	C	13	13	26	0	0	26	0	0
24	6012381	.	T	C	14	13	27	0	0	27	0	0
24	6012499	.	T	A	9	8	17	0	1	18	0	0
24	6012535	.	T	A	5	7	12	0	0	12	0	0
24	6012540	.	A	T	2	8	10	0	0	11	1	0
24	6012662	.	G	A	6	4	10	0	0	10	0	0
24	6016749	.	A	C	7	5	12	0	1	13	0	0
24	6018727	.	C	T	5	4	9	0	0	9	0	0
24	6018908	.	C	T	6	8	14	0	1	15	0	0
24	6021001	.	G	A	6	6	12	0	0	12	0	0
24	6021022	.	G	C	8	0	8	0	7	15	0	0
24	6021277	.	T	C	10	3	13	0	3	16	0	0
24	6024355	.	C	T	6	4	10	0	3	13	0	0
24	6024366	.	T	C	8	5	13	0	0	13	0	0
24	6024401	.	A	T	6	5	11	2	0	13	0	0
24	6024411	.	C	A	0	4	4	2	4	10	0	0
24	6134324	.	T	G	39	29	68	0	3	71	0	0
24	6134456	.	C	T	6	41	47	0	26	73	0	0
24	6134881	.	C	T	30	19	49	0	1	50	0	0
24	6134888	.	C	G	1	21	22	0	31	53	0	0
24	6134946	.	A	T	28	21	49	0	3	52	0	0
24	6135002	.	A	G	23	38	61	0	4	66	1	0
24	6135100	.	A	T	27	30	57	0	1	58	0	0
24	6135118	.	A	G	25	33	58	0	2	60	0	0
24	6135375	.	A	C	26	30	56	0	1	57	0	0
24	6135701	.	G	A	27	22	49	0	4	53	0	0
24	6136089	.	T	G	10	9	19	0	2	21	0	0
24	6136243	.	T	G	7	9	16	0	0	16	0	0
24	6136414	.	A	T	15	8	23	1	1	25	0	0
24	6136415	.	A	T	16	8	24	1	0	25	0	0
24	6136714	.	T	A	27	25	52	0	0	52	0	0
24	6137061	.	C	T	1	29	30	0	11	41	0	0
24	6137622	.	C	T	4	29	33	0	36	69	0	0
24	6153202	.	C	T	3	32	35	0	27	62	0	0
24	6153515	.	A	G	32	25	57	0	2	59	0	0
24	6155751	.	T	C	30	0	30	0	34	64	0	0
24	6157154	.	G	A	37	23	60	0	0	60	0	0
24	6157832	.	A	G	39	30	69	0	1	70	0	0
24	6158835	.	C	A	19	21	40	0	2	42	0	0
24	6158868	.	C	T	20	18	38	0	4	42	0	0
24	6162350	.	G	T	2	4	6	0	0	6	0	0
24	6171157	.	T	A	3	2	5	0	0	5	0	0
24	6176408	.	T	C	3	3	6	0	0	6	0	0
24	6178829	.	G	T	3	3	6	0	0	6	0	0
24	6180117	.	C	T	1	2	3	0	0	3	0	0
24	6216318	.	A	G	1	2	3	0	0	3	0	0
24	6339629	.	G	A	5	3	8	0	0	8	0	0
24	6339714	.	G	T	9	7	16	0	0	16	0	0
24	6342644	.	T	C	7	7	14	0	2	16	0	0
24	6344909	.	G	A	7	7	14	0	0	14	0	0
24	6361637	.	T	A	3	4	7	0	1	8	0	0
24	6361639	.	G	A	3	5	8	0	0	8	0	0
24	6362079	.	G	C	8	1	9	0	3	12	0	0
24	6362123	.	A	C	5	11	16	4	1	21	0	0
24	6362609	.	A	T	23	15	38	0	0	38	0	0
24	6362688	.	T	C	18	12	30	0	1	31	0	0
24	6362730	.	T	C	13	5	18	0	3	21	0	0
24	6362791	.	C	A	8	4	12	0	0	12	0	0
24	6362801	.	G	A	8	3	11	0	0	11	0	0
24	6363502	.	G	A	18	26	44	0	1	45	0	0
24	6368235	.	G	A	20	16	36	0	5	41	0	0
24	6373660	.	A	G	16	16	32	0	2	34	0	0
24	6395401	.	G	A	7	5	12	0	0	12	0	0
24	6395655	.	G	A	14	15	29	0	0	29	0	0
24	6395734	.	T	C	12	11	23	0	1	24	0	0
24	6395838	.	G	T	5	7	12	0	0	12	0	0
24	6395877	.	G	A	9	6	15	0	0	15	0	0
24	6396137	.	C	G	10	11	21	0	1	22	0	0
24	6396198	.	T	A	4	9	13	0	0	13	0	0
24	6396558	.	T	C	9	8	17	0	0	17	0	0
24	6396720	.	A	G	8	14	22	0	0	22	0	0
24	6402552	.	T	C	4	4	8	0	1	9	0	0
24	6444204	.	C	T	0	5	5	0	6	11	0	0
24	6449650	.	C	G	7	5	12	0	0	12	0	0
24	6477938	.	T	A	8	4	12	0	0	12	0	0
24	6500411	.	C	T	2	4	6	0	0	6	0	0
24	6500812	.	C	T	7	6	13	0	0	13	0	0
24	6500973	.	G	A	13	4	17	0	0	17	0	0
24	6501024	.	T	C	5	7	12	0	0	12	0	0
24	6501044	.	C	T	4	10	14	0	0	14	0	0
24	6513857	.	A	T	11	13	24	0	0	24	0	0
24	6513996	.	G	A	6	10	16	0	0	16	0	0
24	6514012	.	C	T	7	8	15	0	0	15	0	0
24	6514117	.	T	C	7	8	15	0	0	15	0	0
24	6514263	.	T	G	15	12	27	0	1	28	0	0
24	6514882	.	A	T	8	15	23	0	0	23	0	0
24	6515019	.	C	T	0	10	10	0	14	24	0	0
24	6515245	.	G	A	15	13	28	0	1	29	0	0
24	6515327	.	G	A	11	14	25	0	1	26	0	0
24	6515364	.	A	T	16	16	32	0	0	32	0	0
24	6515499	.	A	G	6	12	18	0	1	19	0	0
24	6515519	.	T	C	8	0	8	0	11	19	0	0
24	6538447	.	T	C	13	0	13	0	12	25	0	0
24	6538504	.	C	T	0	6	6	0	9	15	0	0
24	6543068	.	A	G	5	8	13	0	0	13	0	0
24	6543443	.	G	A	10	11	21	0	0	21	0	0
24	6546364	.	A	C	13	8	21	0	0	21	0	0
24	6546594	.	A	T	4	7	11	0	2	13	0	0
24	6546749	.	C	T	1	9	10	0	6	16	0	0
24	6546841	.	G	A	17	14	31	0	0	31	0	0
24	6546863	.	T	C	14	1	15	0	14	29	0	0
24	6546909	.	T	C	10	0	10	0	12	22	0	0
24	6546999	.	T	C	7	9	16	0	0	16	0	0
24	6547020	.	T	C	6	9	15	0	0	15	0	0
24	6547278	.	A	G	9	5	14	0	0	14	0	0
24	6547727	.	G	A	18	11	29	0	0	29	0	0
24	6547812	.	C	T	16	8	24	0	3	27	0	0
24	6547890	.	C	G	9	10	19	0	0	19	0	0
24	6547956	.	A	G	12	12	24	0	0	24	0	0
24	6547958	.	A	T	10	9	19	0	3	22	0	0
24	6548027	.	C	T	2	11	13	0	11	24	0	0
24	6548064	.	T	C	6	0	6	0	19	25	0	0
24	7513566	.	C	G	3	2	5	0	0	5	0	0
24	8861380	.	T	C	1	2	3	0	0	3	0	0
24	8862702	.	T	C	2	4	6	0	0	6	0	0
24	8980079	.	T	C	2	2	4	0	0	4	0	0
24	9162589	.	T	C	5	2	7	0	0	7	0	0
24	9163246	.	A	C	1	4	5	0	0	5	0	0
24	9178093	.	C	T	1	4	5	0	0	5	0	0
24	9572907	.	A	G	1	8	9	0	0	9	0	0
24	10271594	.	A	G	1	0	1	0	2	3	0	0
24	10271597	.	A	G	1	0	1	0	2	3	0	0
24	10303221	.	A	G	3	0	3	0	4	7	0	0
24	10303240	.	T	A	6	4	10	0	0	10	0	0
24	10309243	.	A	G	6	4	10	0	0	10	0	0
24	10309382	.	T	C	6	2	8	0	0	8	0	0
24	10309532	.	T	A	4	3	7	0	0	7	0	0
24	10318892	.	G	A	2	2	4	0	0	4	0	0
24	10319239	.	G	C	1	2	3	0	2	5	0	0
24	10319734	.	C	T	1	2	3	0	0	3	0	0
24	10323534	.	G	A	0	4	4	0	2	6	0	0
24	10329528	.	C	G	6	7	13	0	0	13	0	0
24	10335692	.	G	A	3	2	5	0	0	5	0	0
24	10349671	.	C	T	2	4	6	0	0	6	0	0
24	10349783	.	G	T	1	2	3	0	0	4	1	0
24	10349818	.	G	A	2	6	8	0	0	8	0	0
24	10349865	.	T	G	1	6	7	0	0	7	0	0
24	10349898	.	T	C	2	6	8	0	0	8	0	0
24	10350089	.	T	A	3	2	5	0	0	5	0	0
24	10350135	.	A	T	2	4	6	0	0	6	0	0
24	10350239	.	T	A	4	3	7	0	1	8	0	0
24	10356563	.	G	A	2	6	8	0	0	8	0	0
24	10356592	.	T	C	1	4	5	0	1	6	0	0
24	10376984	.	G	A	1	3	4	0	0	4	0	0
24	10376990	.	T	C	1	3	4	0	0	4	0	0
24	10394027	.	A	G	6	7	13	0	1	14	0	0
24	10394224	.	G	A	3	5	8	0	0	8	0	0
24	10406104	.	C	T	1	2	3	0	0	3	0	0
24	10406159	.	G	A	4	1	5	0	2	7	0	0
24	10406190	.	A	G	5	2	7	0	0	7	0	0
24	10413560	.	C	T	12	3	15	0	0	15	0	0
24	10414039	.	T	C	12	11	23	0	0	23	0	0
24	10414439	.	G	T	2	6	8	0	5	13	0	0
24	10415193	.	A	G	14	11	25	0	1	26	0	0
24	10415370	.	G	C	9	7	16	1	0	17	0	0
24	10415790	.	C	T	2	3	5	0	0	5	0	0
24	10415827	.	T	G	1	2	3	0	0	3	0	0
24	10464188	.	C	A	2	3	5	0	0	5	0	0
24	10464195	.	A	G	2	3	5	0	0	5	0	0
24	10793390	.	T	G	2	3	5	0	2	7	0	0
24	10797306	.	T	C	11	11	22	0	0	22	0	0
24	10810390	.	C	T	2	15	17	0	13	30	0	0
24	10824235	.	C	T	3	13	16	0	2	18	0	0
24	10828512	.	A	G	7	15	22	0	1	23	0	0
24	10897254	.	G	A	12	17	29	0	1	30	0	0
24	10897340	.	C	A	2	4	6	0	0	6	0	0
24	10901467	.	A	C	4	3	7	0	0	7	0	0
24	10901696	.	C	G	21	23	44	1	2	47	0	0
24	10901759	.	G	T	25	23	48	0	2	50	0	0
24	10901946	.	C	T	14	11	25	0	0	25	0	0
24	10902065	.	T	G	7	15	22	0	1	23	0	0
24	10902268	.	G	A	9	15	24	0	1	25	0	0
24	10902568	.	T	C	25	0	25	0	24	49	0	0
24	10902688	.	G	A	25	11	36	0	2	38	0	0
24	10907000	.	T	C	18	15	33	0	1	34	0	0
24	10907473	.	C	T	25	17	42	0	5	47	0	0
24	10907587	.	G	T	24	12	36	0	1	37	0	0
24	10915813	.	A	G	21	20	41	0	0	41	0	0
24	10917040	.	C	T	22	26	48	0	0	48	0	0
24	10917046	.	C	T	2	16	18	0	28	46	0	0
24	10917238	.	C	T	14	17	31	0	1	32	0	0
24	10919519	.	A	G	6	10	16	0	2	18	0	0
24	10919563	.	G	T	7	11	18	0	1	19	0	0
24	10924880	.	C	T	18	14	32	0	1	33	0	0
24	10924912	.	C	T	18	11	29	0	1	31	1	0
24	10924930	.	T	A	13	10	23	0	2	25	0	0
24	10925951	.	G	A	8	11	19	0	0	19	0	0
24	10928291	.	G	A	7	6	13	0	0	13	0	0
24	10944579	.	T	A	9	15	24	0	0	24	0	0
24	10961510	.	T	C	12	14	26	0	2	28	0	0
24	10971127	.	C	T	6	11	17	0	0	17	0	0
24	10971160	.	G	A	7	8	15	0	0	15	0	0
24	11049819	.	C	G	25	14	39	0	0	39	0	0
24	11049825	.	C	T	25	12	37	0	1	38	0	0
24	11060154	.	C	G	1	2	3	0	0	3	0	0
24	11060716	.	T	A	1	2	3	1	0	4	0	0
24	11083475	.	G	A	11	5	16	0	1	17	0	0
24	11084035	.	G	A	5	4	9	0	1	10	0	0
24	11084074	.	A	C	6	3	9	0	0	9	0	0
24	11086465	.	T	A	5	4	9	0	0	9	0	0
24	11086679	.	T	A	6	5	11	0	0	11	0	0
24	11086752	.	A	G	4	5	9	0	0	9	0	0
24	11086887	.	C	A	6	5	11	0	0	11	0	0
24	11087015	.	G	A	6	3	9	0	0	9	0	0
24	11112173	.	C	A	8	8	16	1	0	17	0	0
24	11112174	.	C	G	7	8	15	1	0	17	1	0
24	11112290	.	G	A	5	7	12	0	0	12	0	0
24	11112474	.	A	G	9	3	12	0	0	12	0	0
24	11112710	.	A	C	17	0	17	3	8	28	0	0
24	11112839	.	G	A	8	14	22	0	0	22	0	0
24	11113027	.	T	C	6	8	14	0	3	17	0	0
24	11113156	.	T	C	7	9	16	0	0	16	0	0
24	11113243	.	G	A	7	7	14	3	1	18	0	0
24	11113330	.	C	T	0	9	9	0	8	17	0	0
24	11113383	.	C	A	7	8	15	0	0	15	0	0
24	11113392	.	G	T	6	7	13	0	0	13	0	0
24	11113900	.	A	T	10	18	28	0	1	29	0	0
24	11113912	.	A	T	10	20	30	0	0	30	0	0
24	11113966	.	T	C	7	13	20	0	1	21	0	0
24	11113972	.	C	G	8	13	21	0	1	22	0	0
24	11114184	.	G	T	5	5	10	0	0	10	0	0
24	11114356	.	C	T	7	2	9	0	1	10	0	0
24	11114385	.	T	C	3	7	10	0	0	10	0	0
24	11114464	.	C	T	7	3	10	0	0	10	0	0
24	11114470	.	A	G	7	4	11	0	0	11	0	0
24	11114549	.	G	A	8	8	16	0	0	16	0	0
24	11114560	.	T	C	10	0	10	0	7	17	0	0
24	11114584	.	T	C	10	9	19	0	0	19	0	0
24	11114670	.	C	T	4	10	14	0	10	24	0	0
24	11114688	.	T	G	10	8	18	0	0	18	0	0
24	11114709	.	T	A	12	9	21	0	0	21	0	0
24	11114786	.	A	G	8	7	15	0	0	15	0	0
24	11114953	.	A	T	1	3	4	0	0	4	0	0
24	11114996	.	G	T	6	3	9	0	0	9	0	0
24	11115048	.	T	A	5	3	8	0	3	11	0	0
24	11115078	.	A	G	10	6	16	0	0	16	0	0
24	11115269	.	C	A	6	9	15	0	2	17	0	0
24	11115338	.	A	T	1	9	10	0	1	11	0	0
24	11115339	.	C	T	1	10	11	0	0	11	0	0
24	11115373	.	C	T	5	9	14	0	0	14	0	0
24	11115451	.	C	A	3	3	6	0	0	6	0	0
24	11115894	.	A	G	3	7	10	0	0	10	0	0
24	11115920	.	T	C	5	4	9	0	0	9	0	0
24	11116025	.	G	C	3	0	3	0	10	13	0	0
24	11116032	.	C	T	2	10	12	0	0	12	0	0
24	11141027	.	G	A	11	5	16	0	0	16	0	0
24	11141065	.	C	T	9	5	14	0	0	14	0	0
24	11141253	.	A	C	8	6	14	0	1	15	0	0
24	11145148	.	C	T	6	12	18	0	1	19	0	0
24	11145190	.	C	T	11	10	21	0	0	21	0	0
24	11145193	.	G	A	10	9	19	0	1	20	0	0
24	11145232	.	G	A	10	7	17	0	0	17	0	0
24	11145250	.	G	A	10	9	19	0	2	21	0	0
24	11145445	.	G	A	8	9	17	0	0	17	0	0
24	11145499	.	T	G	7	3	10	0	0	10	0	0
24	11145592	.	C	T	0	5	5	0	6	11	0	0
24	11145622	.	C	A	9	3	12	0	0	12	0	0
24	11145628	.	G	A	9	4	13	0	1	14	0	0
24	11150791	.	A	T	10	8	18	0	0	18	0	0
24	11150803	.	C	T	0	6	6	0	10	16	0	0
24	11153576	.	C	T	6	3	9	0	1	10	0	0
24	11452184	.	T	A	5	3	8	0	0	8	0	0
24	11467334	.	G	A	1	3	4	0	0	4	0	0
24	11467352	.	T	C	0	3	3	0	0	3	0	0
24	11473351	.	G	T	3	3	6	0	0	6	0	0
24	11473788	.	T	A	5	4	9	0	0	9	0	0
24	11473845	.	T	G	5	2	7	0	1	8	0	0
24	11473891	.	G	A	5	7	12	0	0	12	0	0
24	11473968	.	T	C	9	1	10	0	6	16	0	0
24	11474103	.	C	G	6	18	24	0	0	24	0	0
24	11474110	.	G	A	6	15	21	0	0	21	0	0
24	11474257	.	G	A	10	11	21	0	2	23	0	0
24	11474730	.	A	G	7	8	15	0	0	15	0	0
24	11487067	.	G	C	7	11	18	0	0	18	0	0
24	11490280	.	A	T	6	4	10	0	0	10	0	0
24	11496640	.	T	A	6	6	12	0	0	12	0	0
24	11496890	.	G	A	8	4	12	0	1	13	0	0
24	11496922	.	G	A	5	7	12	0	0	12	0	0
24	11496937	.	A	G	6	7	13	0	0	13	0	0
24	11497201	.	T	A	11	8	19	0	1	20	0	0
24	11497243	.	A	G	8	4	12	0	1	13	0	0
24	11497351	.	C	T	9	14	23	0	0	23	0	0
24	11528577	.	A	G	1	2	3	0	0	3	0	0
24	11529966	.	C	T	6	2	8	0	0	8	0	0
24	11530137	.	G	T	1	4	5	0	0	5	0	0
24	11531180	.	T	C	4	5	9	0	0	9	0	0
24	11531184	.	G	A	4	5	9	0	0	9	0	0
24	11531307	.	A	G	5	2	7	0	0	7	0	0
24	11531595	.	C	G	1	4	5	0	0	5	0	0
24	11531639	.	C	A	0	3	3	0	1	4	0	0
24	11532686	.	T	C	2	3	5	0	0	5	0	0
24	11539565	.	C	T	5	3	8	0	0	8	0	0
24	11539574	.	G	A	3	2	5	0	0	5	0	0
24	11888694	.	G	A	2	4	6	0	0	6	0	0
24	11888788	.	G	A	5	5	10	0	1	11	0	0
24	11889579	.	T	C	8	5	13	0	0	13	0	0
24	11889617	.	T	C	4	4	8	0	1	9	0	0
24	11893314	.	G	A	7	6	13	0	0	13	0	0
24	11894908	.	A	G	9	7	16	0	0	16	0	0
24	11894968	.	C	T	1	7	8	0	4	12	0	0
24	11895910	.	C	A	3	4	7	0	0	7	0	0
24	11896033	.	A	G	4	2	6	0	0	6	0	0
24	11900230	.	A	C	3	6	9	0	0	9	0	0
24	11900292	.	C	T	5	5	10	0	1	11	0	0
24	11905534	.	G	A	2	3	5	0	0	5	0	0
24	11905817	.	A	G	7	4	11	0	0	11	0	0
24	11905834	.	G	A	6	3	9	0	0	9	0	0
24	11905881	.	A	G	4	5	9	0	0	9	0	0
24	11908000	.	A	C	3	0	3	0	5	8	0	0
24	11908852	.	T	C	6	3	9	0	1	10	0	0
24	11909441	.	T	G	5	5	10	0	1	11	0	0
24	11918846	.	G	A	8	10	18	0	0	18	0	0
24	12744202	.	C	A	3	2	5	0	0	5	0	0
24	12744203	.	A	C	3	2	5	0	0	5	0	0
24	12744541	.	C	A	1	4	5	0	0	5	0	0
24	12744559	.	G	T	1	4	5	0	1	6	0	0
24	12744894	.	G	T	10	12	22	0	0	22	0	0
24	12745075	.	T	G	6	3	9	0	0	9	0	0
24	12747941	.	A	G	2	5	7	0	0	7	0	0
24	12766875	.	G	T	4	4	8	0	1	9	0	0
24	12780716	.	T	C	5	2	7	0	1	8	0	0
24	12967163	.	G	A	7	13	20	0	0	20	0	0
24	12975210	.	A	G	14	10	24	0	1	25	0	0
24	12977735	.	A	T	3	10	13	0	0	13	0	0
24	12977738	.	G	A	2	9	11	0	1	12	0	0
24	12978892	.	A	G	8	7	15	0	1	16	0	0
24	12981349	.	A	T	7	7	14	0	0	14	0	0
24	12981384	.	C	T	1	10	11	0	9	20	0	0
24	13009351	.	T	A	1	4	5	0	0	5	0	0
24	13013596	.	T	C	4	9	13	0	0	13	0	0
24	13101128	.	A	G	25	29	54	0	2	56	0	0
24	13101185	.	A	G	29	2	31	0	34	65	0	0
24	13138165	.	T	C	29	29	58	0	3	61	0	0
24	13229408	.	G	A	27	29	56	2	3	61	0	0
24	13239123	.	T	A	25	16	41	0	3	47	3	0
24	13239248	.	A	G	11	18	29	0	17	46	0	0
24	13239712	.	G	T	4	25	29	0	30	60	1	0
24	13239934	.	G	T	23	19	42	0	3	45	0	0
24	13251963	.	T	C	5	5	10	0	2	12	0	0
24	13252065	.	G	A	4	10	14	0	0	14	0	0
24	13252122	.	A	C	6	0	6	0	5	11	0	0
24	13252448	.	A	G	3	6	9	0	0	9	0	0
24	13262409	.	G	C	3	0	3	0	5	8	0	0
24	13271566	.	T	C	6	3	9	0	0	9	0	0
24	13271628	.	A	G	6	5	11	0	0	11	0	0
24	13271637	.	C	T	0	2	2	0	6	8	0	0
24	13361973	.	C	T	4	6	10	0	0	10	0	0
24	13361974	.	C	T	4	6	10	0	0	10	0	0
24	13362125	.	C	A	0	3	3	0	2	5	0	0
24	13362401	.	A	G	4	3	7	0	0	7	0	0
24	13362559	.	T	C	3	2	5	0	0	5	0	0
24	13363745	.	T	A	2	6	8	0	0	8	0	0
24	13565952	.	G	A	3	4	7	0	0	7	0	0
24	14007871	.	G	A	0	3	3	0	2	5	0	0
24	14014772	.	C	A	2	2	4	0	0	4	0	0
24	14222641	.	T	A	3	2	5	0	0	5	0	0
24	14233793	.	C	T	5	4	9	0	0	9	0	0
24	14233799	.	C	T	4	2	6	0	2	8	0	0
24	14233833	.	G	A	1	3	4	0	4	8	0	0
24	14233840	.	T	G	4	3	7	0	0	7	0	0
24	14234518	.	T	A	2	7	9	0	0	9	0	0
24	14234594	.	A	C	2	2	4	0	0	4	0	0
24	14338708	.	T	G	13	1	14	2	9	25	0	0
24	14355885	.	T	C	4	10	14	0	0	14	0	0
24	14384979	.	C	T	12	8	20	0	0	20	0	0
24	14385751	.	G	A	1	10	11	0	11	22	0	0
24	14385765	.	G	T	11	7	18	0	0	18	0	0
24	14385882	.	T	G	6	1	7	0	9	16	0	0
24	14386089	.	A	G	7	3	10	0	0	10	0	0
24	14414325	.	G	A	0	6	6	0	7	13	0	0
24	14415844	.	C	T	11	7	18	0	0	18	0	0
24	14420990	.	T	G	11	0	11	1	9	21	0	0
24	14432194	.	T	C	10	11	21	1	1	23	0	0
24	14442831	.	A	G	6	4	10	0	1	11	0	0
24	14442832	.	A	G	7	5	12	0	0	12	0	0
24	14443578	.	A	G	11	8	19	0	1	20	0	0
24	14443592	.	C	G	11	7	18	0	0	18	0	0
24	14443953	.	A	G	10	0	10	0	7	17	0	0
24	14550242	.	T	G	7	11	18	0	0	18	0	0
24	14550305	.	T	A	7	5	12	0	4	16	0	0
24	14550479	.	G	A	9	13	22	0	0	22	0	0
24	14550487	.	A	T	6	16	22	0	0	22	0	0
24	14550554	.	G	A	10	16	26	0	2	28	0	0
24	14550596	.	T	C	16	10	26	0	0	26	0	0
24	14559778	.	A	T	39	32	71	0	3	75	1	0
24	14559828	.	T	A	41	29	70	0	5	75	0	0
24	14560155	.	G	A	22	28	50	2	3	55	0	0
24	14577512	.	G	C	5	6	11	0	0	11	0	0
24	14597264	.	G	A	7	6	13	0	1	14	0	0
24	14597311	.	C	T	4	8	12	0	1	13	0	0
24	14597313	.	G	A	4	7	11	0	2	13	0	0
24	14624012	.	T	C	4	3	7	0	0	7	0	0
24	14636271	.	A	G	2	6	8	0	0	8	0	0
24	14636649	.	G	A	4	5	9	0	0	9	0	0
24	14706845	.	A	G	4	4	8	0	0	8	0	0
24	14706851	.	A	G	4	5	9	0	0	9	0	0
24	14706890	.	G	A	3	1	4	0	1	5	0	0
24	14711545	.	G	A	7	3	10	0	0	10	0	0
24	14711696	.	A	G	3	3	6	0	0	6	0	0
24	14713796	.	T	C	2	6	8	0	0	8	0	0
24	14713865	.	A	G	20	18	38	0	2	40	0	0
24	14718163	.	T	C	34	22	56	0	3	59	0	0
24	14718476	.	A	G	17	19	36	0	1	37	0	0
24	14725323	.	T	C	12	24	36	0	3	39	0	0
24	14725400	.	G	A	4	22	26	0	16	42	0	0
24	14725410	.	C	T	17	23	40	0	0	40	0	0
24	14725480	.	G	A	15	11	26	0	0	26	0	0
24	14725505	.	G	A	1	15	16	0	17	33	0	0
24	14725551	.	G	A	13	15	28	0	2	30	0	0
24	14725634	.	C	T	2	7	9	0	0	9	0	0
24	14725642	.	T	C	1	4	5	0	0	5	0	0
24	14885169	.	A	T	1	2	3	0	0	3	0	0
24	14937209	.	T	G	5	3	8	0	0	8	0	0
24	15124785	.	A	T	7	6	13	0	2	15	0	0
24	15124818	.	C	T	10	5	15	0	2	17	0	0
24	15124847	.	C	T	1	7	8	0	6	14	0	0
24	15124880	.	T	C	8	0	8	0	10	18	0	0
24	15124937	.	T	G	6	9	15	0	1	16	0	0
24	15127376	.	G	T	5	8	13	0	0	13	0	0
24	15127581	.	G	T	11	4	15	0	0	15	0	0
24	15137464	.	A	C	1	0	1	0	2	3	0	0
24	15137487	.	T	C	1	0	1	0	2	3	0	0
24	15277338	.	G	C	2	6	8	0	0	8	0	0
24	15277347	.	T	C	1	7	8	0	0	8	0	0
24	15277410	.	T	C	4	2	6	0	0	6	0	0
24	15277470	.	A	G	6	2	8	0	0	8	0	0
24	15277512	.	C	T	7	2	9	0	0	9	0	0
24	15277707	.	C	T	6	3	9	0	0	9	0	0
24	15277791	.	T	C	6	3	9	0	1	10	0	0
24	15278208	.	C	T	5	5	10	0	0	10	0	0
24	15278697	.	G	A	3	3	6	0	0	6	0	0
24	15645617	.	G	T	4	10	14	0	13	27	0	0
24	15645669	.	G	T	7	5	12	1	1	14	0	0
24	15648504	.	T	C	8	6	14	0	1	15	0	0
24	15648713	.	G	C	4	2	6	0	0	6	0	0
24	15898196	.	T	G	1	2	3	0	0	3	0	0
24	15898505	.	C	G	3	5	8	0	2	10	0	0
24	16111914	.	T	C	7	7	14	0	0	14	0	0
24	16121362	.	G	A	1	5	6	0	10	16	0	0
24	16121462	.	G	A	6	7	13	0	1	14	0	0
24	16149704	.	G	C	2	4	6	0	0	6	0	0
24	16162009	.	A	T	6	3	9	0	0	9	0	0
24	16162056	.	A	T	8	3	11	0	1	12	0	0
24	16162107	.	T	G	6	3	9	0	0	9	0	0
24	16162422	.	A	T	5	8	13	0	1	14	0	0
24	16163559	.	C	T	4	2	6	0	0	6	0	0
24	16163591	.	G	A	3	1	4	0	0	4	0	0
24	16393606	.	C	T	6	6	12	0	0	12	0	0
24	16572141	.	C	T	7	11	18	0	0	18	0	0
24	16596414	.	A	G	16	1	17	0	10	27	0	0
24	16612792	.	G	T	11	11	22	0	1	23	0	0
24	16612819	.	G	A	2	13	15	0	12	27	0	0
24	16615706	.	A	G	14	15	29	0	0	29	0	0
24	16630964	.	T	C	10	17	27	0	1	28	0	0
24	16646712	.	C	G	18	15	33	0	0	33	0	0
24	16646781	.	C	G	18	0	18	0	11	29	0	0
24	16685001	.	G	A	15	19	34	0	3	37	0	0
24	16693526	.	T	C	14	18	32	0	2	34	0	0
24	16696713	.	G	C	17	22	39	0	2	41	0	0
24	16696741	.	T	C	24	24	48	0	0	48	0	0
24	16705878	.	C	T	8	23	31	0	1	32	0	0
24	16705890	.	A	C	11	24	35	0	0	35	0	0
24	16706108	.	A	G	12	22	34	0	0	34	0	0
24	16706349	.	T	C	15	13	28	0	1	29	0	0
24	16706709	.	A	C	1	2	3	0	0	3	0	0
24	16706834	.	A	G	2	6	8	0	0	8	0	0
24	16855593	.	A	G	3	2	5	0	0	5	0	0
24	16855646	.	C	T	1	7	8	0	2	10	0	0
24	16855974	.	G	A	1	3	4	0	0	4	0	0
24	16870586	.	G	T	3	3	6	0	0	6	0	0
24	16896701	.	C	T	2	4	6	0	0	6	0	0
24	16896769	.	T	C	4	2	6	0	0	6	0	0
24	16896776	.	G	A	4	2	6	0	0	6	0	0
24	16903305	.	G	A	2	5	7	0	0	7	0	0
24	16903313	.	G	A	2	5	7	0	0	7	0	0
24	16905265	.	A	C	16	9	25	0	0	25	0	0
24	16905292	.	C	T	16	15	31	0	0	31	0	0
24	16906200	.	T	G	14	16	30	0	1	31	0	0
24	16906239	.	A	G	17	23	40	0	0	40	0	0
24	16908771	.	A	C	23	20	43	0	2	46	1	0
24	16908848	.	C	T	23	13	36	1	1	38	0	0
24	16909052	.	T	C	19	16	35	0	0	35	0	0
24	16911600	.	A	C	21	23	44	0	1	45	0	0
24	16911898	.	C	T	19	21	40	0	0	40	0	0
24	16911940	.	G	C	16	28	44	0	1	45	0	0
24	16911949	.	T	A	20	24	44	0	0	44	0	0
24	16912086	.	G	A	2	28	30	0	29	59	0	0
24	16912188	.	G	A	2	22	24	0	26	50	0	0
24	16912710	.	G	A	21	19	40	0	0	40	0	0
24	16965503	.	G	A	4	8	12	0	0	12	0	0
24	16965648	.	C	G	9	7	16	0	0	16	0	0
24	16965729	.	A	C	9	6	15	0	0	15	0	0
24	16965765	.	T	C	12	9	21	0	0	21	0	0
24	16965770	.	T	C	13	9	22	0	0	22	0	0
24	16965900	.	A	C	8	0	8	0	7	15	0	0
24	16966389	.	A	G	8	8	16	0	0	16	0	0
24	16966932	.	A	G	7	6	13	0	0	13	0	0
24	16969220	.	T	C	6	5	11	0	1	12	0	0
24	16979675	.	G	T	4	5	9	0	0	9	0	0
24	16979678	.	A	T	4	3	7	0	1	8	0	0
24	16985547	.	C	T	10	17	27	0	1	28	0	0
24	16992440	.	A	G	21	11	32	0	1	33	0	0
24	16992506	.	A	C	12	17	29	0	0	29	0	0
24	16992605	.	G	A	2	16	18	0	14	32	0	0
24	16992915	.	C	T	19	15	34	0	3	37	0	0
24	16998976	.	A	T	34	23	57	0	1	58	0	0
24	16999057	.	T	G	24	30	54	0	2	56	0	0
24	17002611	.	C	T	29	17	46	0	2	48	0	0
24	17002666	.	A	T	22	23	45	2	3	51	1	0
24	17005737	.	A	G	4	4	8	0	0	8	0	0
24	17007501	.	C	G	3	7	10	0	0	10	0	0
24	17010923	.	G	T	6	6	12	0	0	12	0	0
24	17010932	.	G	T	6	6	12	0	0	12	0	0
24	17010995	.	C	A	4	2	6	0	2	8	0	0
24	17011082	.	C	A	6	5	11	0	0	11	0	0
24	17020761	.	T	A	6	3	9	0	0	9	0	0
24	17020764	.	A	T	4	3	7	0	0	7	0	0
24	17021848	.	G	A	20	26	46	0	1	47	0	0
24	17021894	.	T	C	33	1	34	0	12	46	0	0
24	17021942	.	A	C	34	14	48	0	1	49	0	0
24	17022164	.	G	A	4	2	6	0	0	6	0	0
24	17022265	.	A	G	2	4	6	0	0	6	0	0
24	17023063	.	G	A	23	19	42	0	0	42	0	0
24	17027464	.	G	A	15	10	25	0	2	27	0	0
24	17027484	.	C	A	20	13	33	0	1	34	0	0
24	17028690	.	T	A	18	18	36	0	1	37	0	0
24	17028990	.	C	T	19	12	31	0	1	32	0	0
24	17041159	.	G	C	1	7	8	0	1	9	0	0
24	17041208	.	T	G	3	3	6	0	0	6	0	0
24	17041267	.	T	A	5	6	11	0	0	11	0	0
24	17041354	.	A	G	6	9	15	0	0	15	0	0
24	17042014	.	A	G	7	4	11	0	0	11	0	0
24	17042022	.	A	G	6	4	10	0	1	11	0	0
24	17042698	.	A	T	7	4	11	0	2	13	0	0
24	17042763	.	C	T	8	7	15	0	1	16	0	0
24	17051649	.	A	T	1	3	4	0	0	4	0	0
24	17119170	.	C	T	13	22	35	0	1	36	0	0
24	17124306	.	T	A	1	7	8	0	1	9	0	0
24	17124476	.	G	A	2	12	14	0	12	26	0	0
24	17124567	.	T	C	19	13	32	0	0	32	0	0
24	17124591	.	T	A	14	16	30	0	2	32	0	0
24	17125503	.	G	A	9	19	28	0	1	29	0	0
24	17126341	.	C	T	14	20	34	0	3	37	0	0
24	17126391	.	T	C	8	12	20	0	0	20	0	0
24	17126738	.	T	A	20	19	39	0	0	39	0	0
24	17177262	.	G	A	0	8	8	0	6	14	0	0
24	17181103	.	A	G	8	0	8	0	5	13	0	0
24	17181217	.	C	A	5	6	11	0	0	11	0	0
24	17189815	.	T	A	6	9	15	1	0	16	0	0
24	17209371	.	T	C	3	5	8	0	1	9	0	0
24	17211821	.	C	A	11	19	30	0	0	30	0	0
24	17214493	.	A	T	10	12	22	0	1	23	0	0
24	17214642	.	G	A	19	13	32	0	1	33	0	0
24	17214746	.	C	T	5	8	13	0	0	13	0	0
24	17215894	.	A	G	3	4	7	0	0	7	0	0
24	17257693	.	C	A	12	14	26	0	2	28	0	0
24	17257866	.	T	C	12	15	27	0	0	27	0	0
24	17260568	.	C	A	4	9	13	0	0	13	0	0
24	17266564	.	G	T	5	6	11	0	0	11	0	0
24	17334815	.	T	C	12	6	18	0	0	18	0	0
24	17345634	.	T	C	1	3	4	0	0	4	0	0
24	17345708	.	T	C	2	3	5	0	0	5	0	0
24	17345804	.	A	C	2	4	6	0	1	7	0	0
24	17350069	.	G	A	2	3	5	0	0	5	0	0
24	17352009	.	C	T	3	4	7	0	0	7	0	0
24	17352335	.	C	A	1	3	4	0	0	4	0	0
24	17360174	.	T	C	5	3	8	0	0	8	0	0
24	17360183	.	T	C	5	2	7	0	1	8	0	0
24	17364985	.	G	A	8	14	22	0	2	24	0	0
24	17366374	.	G	A	18	13	31	0	2	33	0	0
24	17367882	.	G	A	14	10	24	0	1	25	0	0
24	17374611	.	T	C	9	8	17	0	1	18	0	0
24	17378457	.	A	G	8	6	14	0	0	14	0	0
24	17378478	.	C	A	5	6	11	0	0	11	0	0
24	17378493	.	T	G	4	7	11	0	0	11	0	0
24	17381017	.	G	A	16	10	26	0	0	26	0	0
24	17389385	.	A	T	10	10	20	0	0	20	0	0
24	17389415	.	G	A	10	15	25	0	0	25	0	0
24	17389460	.	A	G	12	16	28	0	0	28	0	0
24	17389462	.	A	G	11	16	27	0	0	27	0	0
24	17400069	.	T	A	10	14	24	0	1	25	0	0
24	17404219	.	G	A	9	4	13	0	0	13	0	0
24	17409892	.	T	G	2	3	5	0	0	5	0	0
24	17410039	.	G	C	7	4	11	0	0	11	0	0
24	17410153	.	A	T	6	3	9	0	0	9	0	0
24	17410494	.	C	T	4	3	7	0	1	8	0	0
24	17417855	.	G	C	11	10	21	0	0	21	0	0
24	17418292	.	T	A	10	5	15	0	0	15	0	0
24	17418306	.	C	T	13	5	18	0	0	18	0	0
24	17418460	.	T	C	14	9	23	0	0	23	0	0
24	17418548	.	T	C	10	3	13	0	0	13	0	0
24	17418576	.	T	C	7	7	14	0	0	14	0	0
24	17418659	.	A	T	3	4	7	0	1	8	0	0
24	17418668	.	T	C	3	6	9	0	1	10	0	0
24	17418741	.	G	C	3	17	20	0	0	20	0	0
24	17418837	.	A	G	1	5	6	0	0	6	0	0
24	17418993	.	C	T	1	2	3	0	5	8	0	0
24	17419049	.	T	A	4	3	7	0	0	7	0	0
24	17419228	.	A	G	1	2	3	0	0	3	0	0
24	17420761	.	G	T	7	12	19	0	0	19	0	0
24	17420989	.	T	C	22	0	22	0	9	31	0	0
24	17421270	.	C	T	0	18	18	0	15	33	0	0
24	17421338	.	A	T	17	13	30	0	0	30	0	0
24	17421396	.	C	A	17	16	33	0	0	33	0	0
24	17421655	.	G	A	17	6	23	0	2	25	0	0
24	17497190	.	A	G	15	7	22	0	2	24	0	0
24	17505248	.	C	T	9	6	15	0	0	15	0	0
24	17505358	.	C	T	0	7	7	0	7	14	0	0
24	17521598	.	G	A	7	11	18	0	0	18	0	0
24	17521686	.	A	G	10	13	23	0	2	25	0	0
24	17611267	.	A	G	9	8	17	0	1	18	0	0
24	17611316	.	G	C	7	5	12	0	0	12	0	0
24	17611349	.	G	A	4	5	9	0	0	9	0	0
24	17733647	.	T	G	10	5	15	0	1	16	0	0
24	17733684	.	G	A	10	9	19	0	0	19	0	0
24	17733735	.	T	G	11	7	18	0	0	18	0	0
24	17736234	.	A	G	11	9	20	0	0	20	0	0
24	17754509	.	T	C	9	0	9	0	8	17	0	0
24	17754557	.	G	A	11	11	22	0	0	22	0	0
24	17817767	.	A	G	8	5	13	0	0	13	0	0
24	17835698	.	G	A	4	5	9	0	0	9	0	0
24	17835788	.	G	A	2	5	7	0	0	7	0	0
24	17835812	.	A	G	1	7	8	0	0	8	0	0
24	17871763	.	T	C	6	6	12	0	0	12	0	0
24	18444095	.	A	C	4	4	8	0	1	9	0	0
24	18444265	.	A	T	20	17	37	0	1	38	0	0
24	18444267	.	T	C	19	4	23	0	18	41	0	0
24	18444334	.	G	T	30	31	61	0	2	63	0	0
24	18444429	.	A	C	3	3	6	0	0	6	0	0
24	18444434	.	T	C	3	2	5	0	0	5	0	0
24	18444679	.	A	G	1	4	5	0	0	5	0	0
24	18446527	.	T	A	25	26	51	0	2	53	0	0
24	18448348	.	G	A	2	3	5	0	0	5	0	0
24	18465403	.	C	T	2	2	4	1	2	7	0	0
24	18486030	.	A	G	1	2	3	0	0	3	0	0
24	18492081	.	G	A	1	2	3	0	0	3	0	0
24	18521384	.	T	A	6	3	9	0	0	9	0	0
24	18549388	.	A	G	10	9	19	0	0	19	0	0
24	18557481	.	A	G	7	5	12	0	0	12	0	0
24	18563714	.	A	G	5	11	16	0	0	16	0	0
24	18563826	.	C	A	14	9	23	0	0	23	0	0
24	18565564	.	A	G	8	10	18	0	1	19	0	0
24	18565591	.	C	T	7	10	17	0	0	17	0	0
24	18598654	.	C	T	5	5	10	0	0	10	0	0
24	18599254	.	A	G	7	5	12	0	0	12	0	0
24	18618371	.	A	G	6	5	11	0	0	11	0	0
24	18618372	.	G	T	6	5	11	0	0	11	0	0
24	18693646	.	T	G	2	3	5	0	0	5	0	0
24	18696665	.	T	C	1	3	4	0	0	4	0	0
24	18707070	.	C	T	1	3	4	0	0	4	0	0
24	18714339	.	C	T	1	3	4	0	0	4	0	0
24	18732055	.	A	G	3	2	5	0	0	5	0	0
24	18737876	.	C	T	7	10	17	0	0	17	0	0
24	18749985	.	A	G	15	14	29	0	1	30	0	0
24	18751785	.	G	A	21	18	39	0	1	40	0	0
24	18752695	.	C	T	8	4	12	0	1	13	0	0
24	18754752	.	G	A	8	10	18	0	0	18	0	0
24	18769556	.	G	A	10	6	16	0	0	16	0	0
24	18769625	.	C	G	5	8	13	0	0	13	0	0
24	18776192	.	T	A	10	14	24	0	1	25	0	0
24	18776298	.	A	G	8	11	19	0	3	22	0	0
24	18777699	.	T	G	6	12	18	0	0	18	0	0
24	18780044	.	G	A	8	9	17	0	0	17	0	0
24	18780131	.	C	T	0	5	5	0	4	9	0	0
24	18782982	.	G	T	10	12	22	0	2	24	0	0
24	18783713	.	T	G	1	6	7	0	1	8	0	0
24	18784241	.	C	T	7	5	12	0	0	12	0	0
24	18784259	.	C	T	0	6	6	0	5	11	0	0
24	18784288	.	G	A	4	5	9	0	0	9	0	0
24	18794371	.	G	A	5	8	13	0	0	13	0	0
24	18794455	.	T	C	2	6	8	0	5	13	0	0
24	18814782	.	G	T	9	6	15	0	1	16	0	0
24	19129518	.	C	T	3	4	7	0	0	7	0	0
24	19129530	.	G	A	4	2	6	0	1	7	0	0
24	19249658	.	C	T	2	3	5	0	0	5	0	0
24	19260900	.	C	T	3	6	9	0	0	9	0	0
24	19342704	.	C	G	2	5	7	0	0	7	0	0
24	19342705	.	A	T	2	5	7	0	0	7	0	0
24	19402505	.	G	T	7	2	9	0	0	9	0	0
24	19402645	.	C	T	3	3	6	0	0	6	0	0
24	19593169	.	G	T	2	2	4	0	0	4	0	0
24	19661721	.	G	A	2	7	9	0	0	9	0	0
24	19692718	.	T	G	3	4	7	0	0	7	0	0
24	19692822	.	C	A	0	6	6	0	0	6	0	0
24	19692828	.	G	A	0	4	4	0	3	7	0	0
24	19695943	.	T	C	2	6	8	0	1	9	0	0
24	19696265	.	C	T	5	2	7	0	0	7	0	0
24	19696375	.	C	T	3	2	5	0	0	5	0	0
24	19696431	.	G	C	2	3	5	0	1	6	0	0
24	19696442	.	T	A	3	4	7	0	0	7	0	0
24	19696549	.	A	T	3	3	6	0	1	7	0	0
24	19696855	.	A	G	4	3	7	0	1	8	0	0
24	19696884	.	A	G	4	3	7	0	0	7	0	0
24	19697048	.	G	A	3	3	6	0	0	6	0	0
24	19707742	.	G	A	15	17	32	0	0	32	0	0
24	19708366	.	C	T	13	8	21	0	2	23	0	0
24	19708448	.	G	T	17	17	34	0	1	35	0	0
24	19708927	.	G	A	15	13	28	0	1	29	0	0
24	19709272	.	C	A	8	17	25	0	0	25	0	0
24	19719132	.	C	A	1	18	19	0	16	35	0	0
24	20064341	.	C	T	1	5	6	0	0	6	0	0
24	20064892	.	G	A	7	3	10	0	1	11	0	0
24	20064924	.	A	G	3	4	7	0	0	7	0	0
24	20065002	.	T	A	5	2	7	0	1	8	0	0
24	20065115	.	C	T	0	4	4	0	4	8	0	0
24	20065156	.	C	A	1	3	4	0	5	9	0	0
24	20065236	.	T	C	1	5	6	0	0	6	0	0
24	20065290	.	G	T	2	3	5	0	0	5	0	0
24	20065292	.	T	C	3	3	6	0	0	6	0	0
24	20065993	.	T	C	3	0	3	0	3	6	0	0
24	20066021	.	T	C	2	8	10	0	0	10	0	0
24	20066110	.	T	C	2	1	3	0	3	6	0	0
24	20066488	.	G	C	2	2	4	0	0	4	0	0
24	20066903	.	C	A	5	7	12	0	1	13	0	0
24	20082944	.	G	A	1	8	9	0	0	9	0	0
24	20087709	.	T	C	5	4	9	0	0	9	0	0
24	20095469	.	G	A	3	3	6	0	0	6	0	0
24	20152839	.	C	T	2	6	8	0	1	9	0	0
24	20189216	.	T	C	2	2	4	0	0	4	0	0
24	20189245	.	C	A	3	2	5	0	0	5	0	0
24	20196172	.	A	G	5	7	12	0	0	12	0	0
24	20197755	.	C	A	6	5	11	0	0	11	0	0
24	20199122	.	A	C	3	2	5	0	0	5	0	0
24	20202041	.	C	T	3	2	5	0	0	5	0	0
24	20207173	.	T	G	2	2	4	0	0	4	0	0
24	20214463	.	G	T	3	3	6	0	0	6	0	0
24	20216163	.	A	T	4	5	9	0	0	9	0	0
24	20227798	.	T	C	2	3	5	0	0	5	0	0
24	20328430	.	C	T	7	4	11	1	1	13	0	0
24	20328821	.	C	A	6	5	11	0	1	12	0	0
24	20328999	.	T	A	4	6	10	0	0	10	0	0
24	20329493	.	G	A	12	11	23	0	0	23	0	0
24	20329589	.	G	C	6	10	16	0	1	17	0	0
24	20332145	.	A	G	7	5	12	0	0	12	0	0
24	20332187	.	A	T	5	3	8	0	0	8	0	0
24	20334326	.	T	G	1	3	4	0	3	7	0	0
24	20501159	.	G	A	10	7	17	0	2	19	0	0
24	20531624	.	C	A	11	7	18	1	0	19	0	0
24	20536110	.	G	C	9	8	17	0	0	17	0	0
24	20536188	.	C	A	15	7	22	0	0	22	0	0
24	20536235	.	G	A	2	11	13	0	12	25	0	0
24	20539454	.	G	A	16	9	25	0	1	26	0	0
24	20542907	.	G	A	9	13	22	1	3	26	0	0
24	20542909	.	C	T	10	15	25	1	1	27	0	0
24	20542972	.	T	C	10	7	17	0	0	17	0	0
24	20552393	.	A	T	21	18	39	0	0	39	0	0
24	20554732	.	A	G	11	13	24	0	0	24	0	0
24	20554812	.	T	A	9	8	17	0	0	18	1	0
24	20589565	.	G	C	5	4	9	0	0	9	0	0
24	20589592	.	C	T	1	2	3	0	5	9	1	0
24	20589791	.	G	A	7	17	24	0	0	24	0	0
24	20643765	.	T	C	5	5	10	0	0	10	0	0
24	20644063	.	A	C	10	9	19	2	9	30	0	0
24	20644123	.	A	C	8	14	22	0	0	22	0	0
24	20644548	.	A	G	23	27	50	0	1	51	0	0
24	20644685	.	C	T	1	20	21	0	24	45	0	0
24	20645101	.	T	C	20	19	39	0	3	42	0	0
24	20645273	.	T	C	22	17	39	0	2	41	0	0
24	20645662	.	T	C	20	0	20	0	11	31	0	0
24	20646270	.	T	A	13	15	28	0	0	28	0	0
24	20647394	.	C	T	13	7	20	0	1	21	0	0
24	20648942	.	C	T	16	12	28	0	0	28	0	0
24	20648945	.	T	C	11	16	27	0	1	28	0	0
24	20649039	.	T	G	14	20	34	0	1	35	0	0
24	20658386	.	C	A	12	14	26	0	0	26	0	0
24	20897560	.	T	C	4	4	8	0	0	8	0	0
24	20897561	.	G	T	4	4	8	0	0	8	0	0
24	20897954	.	G	A	6	7	13	0	0	13	0	0
24	20899947	.	C	A	2	3	5	0	0	5	0	0
24	20903523	.	C	T	2	2	4	0	0	4	0	0
24	20916841	.	C	A	11	5	16	0	1	17	0	0
24	20917075	.	G	C	9	3	12	1	0	13	0	0
24	20917080	.	T	C	2	4	6	1	2	9	0	0
24	20921431	.	C	T	8	7	15	16	0	31	0	0
24	20931626	.	G	A	8	13	21	0	3	24	0	0
24	20934528	.	G	A	7	10	17	0	0	17	0	0
24	20941540	.	G	A	9	3	12	0	0	12	0	0
24	20941605	.	A	G	7	2	9	0	1	10	0	0
24	20946263	.	G	A	21	17	38	0	1	39	0	0
24	20948122	.	C	T	20	25	45	0	0	45	0	0
24	20949494	.	A	G	16	13	29	0	0	29	0	0
24	20952215	.	T	A	10	12	22	0	1	23	0	0
24	20952306	.	C	T	0	9	9	0	14	23	0	0
24	20953415	.	C	T	13	23	36	0	1	37	0	0
24	20954109	.	G	A	10	6	16	0	1	17	0	0
24	20954151	.	C	A	18	11	29	0	0	29	0	0
24	20954154	.	T	C	15	14	29	0	1	30	0	0
24	20968317	.	G	A	3	2	5	0	0	5	0	0
24	20968324	.	T	A	3	2	5	0	0	5	0	0
24	20968381	.	T	G	4	0	4	0	2	6	0	0
24	20968384	.	C	T	4	2	6	0	0	6	0	0
24	20968416	.	T	A	5	2	7	0	0	7	0	0
24	20968424	.	A	C	2	4	6	0	0	6	0	0
24	20968498	.	A	T	3	3	6	0	0	6	0	0
24	20968514	.	A	T	2	4	6	0	0	6	0	0
24	20969449	.	C	T	3	3	6	0	0	6	0	0
24	20980039	.	A	G	4	0	4	0	4	8	0	0
24	20987732	.	C	T	7	4	11	0	1	12	0	0
24	20987798	.	T	C	3	4	7	0	0	7	0	0
24	21005546	.	C	T	3	7	10	0	0	10	0	0
24	21006053	.	A	G	8	10	18	0	1	19	0	0
24	21006082	.	G	A	6	8	14	0	1	15	0	0
24	21154160	.	G	A	6	7	13	0	0	13	0	0
24	21154203	.	C	T	9	15	24	0	1	25	0	0
24	21154419	.	T	G	17	11	28	0	0	28	0	0
24	21154496	.	C	A	5	14	19	0	19	38	0	0
24	21154586	.	T	C	31	20	51	0	2	53	0	0
24	21157712	.	G	A	29	17	46	0	1	47	0	0
24	21167720	.	G	A	20	15	35	0	1	36	0	0
24	21168638	.	G	T	15	15	30	0	1	31	0	0
24	21179803	.	T	A	9	8	17	0	0	17	0	0
24	21182156	.	A	G	3	2	5	0	1	6	0	0
24	21182642	.	G	A	13	12	25	0	1	26	0	0
24	21182783	.	C	T	12	15	27	0	2	29	0	0
24	21182834	.	G	A	2	15	17	0	11	28	0	0
24	21182911	.	G	A	1	10	11	0	6	17	0	0
24	21183474	.	G	A	7	5	12	0	0	12	0	0
24	21195098	.	A	T	3	3	6	0	0	6	0	0
24	21195122	.	A	T	3	4	7	0	0	7	0	0
24	21195406	.	C	T	5	4	9	0	0	9	0	0
24	21195698	.	G	A	0	3	3	0	2	5	0	0
24	21196136	.	G	A	0	4	4	0	1	5	0	0
24	21196211	.	C	A	4	7	11	0	1	12	0	0
24	21196256	.	A	G	6	0	6	0	5	11	0	0
24	21197018	.	G	A	0	5	5	0	4	9	0	0
24	21197144	.	A	C	3	0	3	0	2	5	0	0
24	21197152	.	T	C	3	3	6	0	1	7	0	0
24	21197257	.	A	C	2	3	5	0	0	5	0	0
24	21197324	.	A	G	1	6	7	0	0	7	0	0
24	21197665	.	T	G	2	5	7	0	0	7	0	0
24	21197930	.	C	A	3	4	7	0	0	7	0	0
24	21198025	.	T	C	6	8	14	0	0	14	0	0
24	21198990	.	G	A	8	5	13	0	0	13	0	0
24	21199460	.	C	T	3	5	8	0	0	8	0	0
24	21200739	.	C	T	5	6	11	0	1	12	0	0
24	21201380	.	T	C	7	8	15	0	0	15	0	0
24	21201860	.	G	A	1	14	15	0	6	21	0	0
24	21202203	.	A	G	5	6	11	0	0	11	0	0
24	21202225	.	C	T	5	3	8	0	1	9	0	0
24	21202256	.	G	T	2	3	5	0	0	5	0	0
24	21202310	.	C	A	2	2	4	0	0	4	0	0
24	21206352	.	G	T	3	2	5	0	0	5	0	0
24	21206401	.	T	C	3	3	6	0	0	6	0	0
24	21210608	.	T	G	1	4	5	0	0	5	0	0
24	21214898	.	G	A	7	3	10	0	1	11	0	0
24	21220660	.	C	T	0	4	4	0	2	6	0	0
24	21222697	.	C	T	0	6	6	0	3	9	0	0
24	21226923	.	G	C	2	2	4	0	0	4	0	0
24	21340985	.	A	G	1	2	3	0	0	3	0	0
24	21343058	.	T	C	1	1	2	0	0	2	0	0
24	21343068	.	T	C	0	2	2	0	0	2	0	0
24	21371481	.	T	C	17	17	34	0	1	35	0	0
24	21371520	.	G	C	20	16	36	0	2	38	0	0
24	21371547	.	T	C	21	24	45	0	3	48	0	0
24	21371599	.	C	T	29	19	48	0	2	50	0	0
24	21371801	.	T	G	19	33	52	0	3	55	0	0
24	21371919	.	G	A	19	22	41	3	1	45	0	0
24	21372417	.	A	G	15	24	39	0	2	41	0	0
24	21372435	.	G	A	24	12	36	0	1	37	0	0
24	21403620	.	C	T	15	22	37	0	0	37	0	0
24	21411463	.	G	A	18	15	33	0	1	34	0	0
24	21411514	.	G	A	15	7	22	0	2	24	0	0
24	21411876	.	T	A	18	19	37	0	3	40	0	0
24	21417872	.	C	T	15	18	33	0	3	36	0	0
24	21438161	.	G	A	20	7	27	0	1	28	0	0
24	21445237	.	C	T	13	14	27	0	4	31	0	0
24	21445240	.	G	A	12	21	33	0	0	33	0	0
24	21447610	.	T	G	17	14	31	0	2	33	0	0
24	21447668	.	C	T	0	16	16	0	15	31	0	0
24	21450130	.	C	T	15	17	32	0	0	32	0	0
24	21450383	.	G	A	13	7	20	0	2	22	0	0
24	21470881	.	A	T	4	4	8	0	1	9	0	0
24	21470933	.	C	A	2	2	4	0	1	5	0	0
24	21470934	.	C	A	2	2	4	0	1	5	0	0
24	21490167	.	G	A	2	2	4	0	0	4	0	0
24	21498770	.	G	A	12	13	25	0	0	25	0	0
24	21502007	.	A	G	5	7	12	0	0	12	0	0
24	21502069	.	G	A	4	11	15	0	1	16	0	0
24	21502133	.	T	C	5	0	5	0	10	15	0	0
24	21502305	.	A	G	8	6	14	0	0	14	0	0
24	21502817	.	C	A	4	4	8	0	0	8	0	0
24	21502842	.	T	A	5	9	14	0	0	14	0	0
24	21502880	.	G	T	8	13	21	0	1	22	0	0
24	21502973	.	G	A	6	8	14	0	0	14	0	0
24	21502999	.	G	A	6	8	14	0	2	16	0	0
24	21503043	.	G	T	9	7	16	0	0	17	1	0
24	21503575	.	A	G	4	6	10	0	1	11	0	0
24	21503682	.	C	T	5	4	9	0	0	9	0	0
24	21503694	.	C	G	5	3	8	0	1	9	0	0
24	21503748	.	T	C	9	4	13	0	0	13	0	0
24	21504725	.	C	T	1	8	9	0	10	19	0	0
24	21504785	.	A	G	8	9	17	0	0	17	0	0
24	21504860	.	G	T	8	10	18	0	0	18	0	0
24	21505043	.	C	A	8	7	15	0	0	15	0	0
24	21505271	.	C	T	1	6	7	0	7	14	0	0
24	21505446	.	A	T	4	7	11	0	0	11	0	0
24	21505505	.	C	T	2	4	6	0	10	16	0	0
24	21505623	.	G	A	7	2	9	0	0	9	0	0
24	21505931	.	G	T	10	6	16	0	1	17	0	0
24	21506033	.	C	T	5	6	11	0	0	11	0	0
24	21514386	.	T	A	8	14	22	0	1	23	0	0
24	21514437	.	T	C	11	4	15	0	1	16	0	0
24	21538568	.	A	C	12	10	22	0	0	22	0	0
24	21561074	.	C	T	7	9	16	0	2	18	0	0
24	21575273	.	T	A	12	21	33	1	0	34	0	0
24	21575311	.	G	C	16	11	27	1	2	31	1	0
24	21577239	.	G	A	5	11	16	0	0	16	0	0
24	21577394	.	C	A	9	10	19	0	0	19	0	0
24	21577573	.	T	G	8	3	11	0	0	11	0	0
24	21577638	.	A	G	4	7	11	0	1	12	0	0
24	21577898	.	C	A	2	2	4	0	1	5	0	0
24	21584189	.	G	A	9	10	19	0	0	19	0	0
24	21584355	.	C	T	6	3	9	0	0	9	0	0
24	21584367	.	C	G	4	3	7	0	0	7	0	0
24	21584673	.	T	G	4	4	8	0	0	8	0	0
24	21584731	.	G	A	7	4	11	0	0	11	0	0
24	21584756	.	A	C	10	3	13	0	0	13	0	0
24	21584794	.	G	A	6	4	10	0	0	10	0	0
24	21584904	.	T	C	2	2	4	0	0	4	0	0
24	21584937	.	C	T	3	3	6	0	0	6	0	0
24	21585042	.	A	C	5	4	9	0	0	9	0	0
24	21585043	.	A	C	3	4	7	0	2	9	0	0
24	21585157	.	A	G	4	3	7	0	1	8	0	0
24	21585366	.	C	A	0	7	7	0	8	15	0	0
24	21585396	.	C	T	0	6	6	0	6	12	0	0
24	21585719	.	C	T	2	3	5	0	5	10	0	0
24	21586190	.	C	G	7	10	17	0	0	17	0	0
24	21586454	.	C	G	6	9	15	0	1	16	0	0
24	21600984	.	C	A	15	17	32	0	1	33	0	0
24	21606035	.	G	A	12	16	28	0	2	30	0	0
24	21606325	.	C	T	3	19	22	0	14	36	0	0
24	21610064	.	G	A	18	14	32	0	1	33	0	0
24	21625149	.	C	T	33	19	52	0	6	58	0	0
24	21646375	.	G	A	3	11	14	0	1	15	0	0
24	21646802	.	A	C	19	20	39	0	0	39	0	0
24	21646805	.	C	G	0	19	19	0	19	38	0	0
24	21657567	.	C	G	18	18	36	0	2	39	1	0
24	21657639	.	G	A	17	13	30	0	2	32	0	0
24	21657642	.	G	A	16	13	29	0	1	30	0	0
24	21659593	.	T	C	17	0	17	0	17	34	0	0
24	21659792	.	C	T	1	16	17	0	16	33	0	0
24	21659819	.	G	A	15	16	31	0	2	33	0	0
24	21659864	.	A	T	10	17	27	0	0	28	1	0
24	21671114	.	G	A	23	18	41	0	2	43	0	0
24	21671381	.	A	G	15	5	20	0	1	21	0	0
24	21671506	.	G	A	11	15	26	0	0	26	0	0
24	21680747	.	C	G	5	2	7	0	0	7	0	0
24	21680970	.	A	C	5	5	10	0	1	12	1	0
24	21681162	.	C	T	3	3	6	0	0	6	0	0
24	21735379	.	G	A	4	9	13	0	0	13	0	0
24	21735466	.	A	G	6	3	9	0	0	9	0	0
24	21735502	.	C	T	11	5	16	0	0	16	0	0
24	21744200	.	C	T	8	12	20	0	0	20	0	0
24	21744266	.	A	G	9	10	19	0	1	20	0	0
24	21747316	.	T	G	8	4	12	0	0	12	0	0
24	21747325	.	T	C	6	6	12	0	0	12	0	0
24	21747368	.	T	C	6	9	15	0	2	17	0	0
24	21747376	.	C	T	5	10	15	0	2	17	0	0
24	21747705	.	T	C	12	4	16	1	0	17	0	0
24	21747714	.	C	T	6	9	15	1	1	17	0	0
24	21748249	.	T	C	14	11	25	0	1	26	0	0
24	21748279	.	C	T	10	14	24	0	1	25	0	0
24	21748374	.	T	C	3	3	6	0	0	6	0	0
24	21751095	.	A	G	8	3	11	0	0	11	0	0
24	21752764	.	G	A	3	3	6	0	1	7	0	0
24	21759639	.	G	A	1	2	3	0	0	3	0	0
24	21781146	.	A	G	6	2	8	0	0	8	0	0
24	21781238	.	C	A	2	4	6	0	1	7	0	0
24	21781451	.	T	G	3	9	12	0	0	12	0	0
24	21781452	.	T	A	3	9	12	0	0	12	0	0
24	21788960	.	G	T	1	3	4	0	0	4	0	0
24	21883954	.	G	T	1	3	4	0	0	4	0	0
24	21927638	.	G	A	8	6	14	0	1	15	0	0
24	21934112	.	A	G	3	2	5	0	0	5	0	0
24	21960293	.	C	T	3	10	13	0	0	13	0	0
24	21960299	.	G	A	3	10	13	0	0	13	0	0
24	21960445	.	A	T	2	3	5	0	1	6	0	0
24	21967802	.	T	C	8	3	11	0	0	11	0	0
24	21968103	.	A	G	11	8	19	0	0	19	0	0
24	21968441	.	C	T	0	5	5	0	2	7	0	0
24	21969526	.	G	A	7	3	10	0	0	10	0	0
24	21978470	.	A	G	8	12	20	0	1	21	0	0
24	21978524	.	C	T	8	6	14	0	3	17	0	0
24	21978531	.	A	G	10	8	18	0	1	19	0	0
24	21978647	.	C	G	10	17	27	0	0	27	0	0
24	21978733	.	C	T	16	17	33	0	0	33	0	0
24	21978790	.	T	C	10	16	26	0	0	26	0	0
24	21978805	.	T	C	17	8	25	1	1	27	0	0
24	21986307	.	C	T	13	10	23	0	0	23	0	0
24	21986794	.	A	G	19	14	33	0	1	34	0	0
24	21986802	.	C	T	21	8	29	0	10	39	0	0
24	21989334	.	C	A	18	12	30	1	0	31	0	0
24	22070477	.	A	G	2	11	13	0	0	13	0	0
24	22070877	.	G	A	2	3	5	1	2	8	0	0
24	22070878	.	A	G	6	2	8	1	1	10	0	0
24	22071644	.	G	T	18	18	36	1	2	39	0	0
24	22122826	.	A	C	10	5	15	0	2	17	0	0
24	22122922	.	C	T	3	7	10	0	16	26	0	0
24	22122929	.	G	A	7	17	24	0	1	25	0	0
24	22123024	.	G	A	7	9	16	0	0	17	1	0
24	22123115	.	C	T	1	13	14	0	12	26	0	0
24	22123176	.	T	A	14	23	37	0	0	37	0	0
24	22123434	.	G	C	15	8	23	0	0	23	0	0
24	22123446	.	A	G	12	6	18	0	0	18	0	0
24	22123640	.	A	G	22	13	35	0	0	35	0	0
24	22124020	.	G	A	21	15	36	0	1	37	0	0
24	22174462	.	C	T	7	14	21	0	1	22	0	0
24	22174486	.	G	A	10	14	24	0	0	24	0	0
24	22219741	.	C	T	15	13	28	0	0	28	0	0
24	22219792	.	G	A	21	9	30	0	0	30	0	0
24	22219810	.	C	T	2	21	23	0	5	28	0	0
24	22254056	.	G	T	4	9	13	0	0	13	0	0
24	22275400	.	C	T	10	8	18	0	1	19	0	0
24	22275403	.	A	T	10	8	18	0	2	20	0	0
24	22291190	.	C	T	1	10	11	0	7	18	0	0
24	22291193	.	T	C	7	2	9	0	10	19	0	0
24	22395255	.	T	C	15	10	25	0	0	25	0	0
24	22412434	.	C	T	0	10	10	0	15	25	0	0
24	22442301	.	T	C	5	0	5	0	9	14	0	0
24	22442340	.	G	A	10	5	15	0	0	15	0	0
24	22731340	.	T	A	1	2	3	0	0	3	0	0
24	22740589	.	T	C	7	5	12	0	1	13	0	0
24	22740897	.	A	T	12	10	22	0	0	22	0	0
24	22740949	.	A	G	15	10	25	0	0	25	0	0
24	22740996	.	C	T	11	8	19	0	0	19	0	0
24	22741051	.	G	A	4	11	15	0	0	15	0	0
24	22741088	.	C	T	16	8	24	0	1	25	0	0
24	22741403	.	T	A	15	5	20	0	2	22	0	0
24	22741453	.	C	T	15	10	25	0	0	25	0	0
24	22744502	.	A	G	10	15	25	0	0	25	0	0
24	22746843	.	T	G	21	15	36	0	3	39	0	0
24	22748633	.	C	T	8	10	18	0	3	21	0	0
24	22769225	.	A	T	11	17	28	0	0	28	0	0
24	22769333	.	A	G	4	1	5	0	9	14	0	0
24	22769447	.	G	A	8	4	12	0	0	12	0	0
24	22769593	.	C	A	5	6	11	1	0	12	0	0
24	22769595	.	T	A	6	4	10	1	0	11	0	0
24	23213411	.	C	A	1	4	5	0	0	5	0	0
24	23213552	.	T	C	1	2	3	0	0	3	0	0
24	23214125	.	G	A	0	2	2	0	2	4	0	0
24	23214154	.	G	A	1	2	3	0	1	4	0	0
24	23243116	.	T	C	5	0	5	0	12	17	0	0
24	23243257	.	A	G	4	2	6	0	0	6	0	0
24	23243872	.	A	T	9	9	18	0	1	19	0	0
24	23243946	.	C	A	15	7	22	0	0	22	0	0
24	23244161	.	T	A	9	9	18	0	1	19	0	0
24	23300755	.	A	G	5	4	9	0	0	9	0	0
24	23302371	.	A	G	8	7	15	0	0	15	0	0
24	23302441	.	A	G	2	9	11	0	0	11	0	0
24	23937877	.	T	G	7	2	9	0	5	14	0	0
24	24015086	.	G	T	6	7	13	0	1	14	0	0
24	24017837	.	C	T	10	7	17	0	2	19	0	0
24	24027914	.	T	A	14	8	22	0	0	22	0	0
24	24027990	.	A	T	12	13	25	0	1	26	0	0
24	24028059	.	T	A	12	10	22	0	0	22	0	0
24	24048682	.	C	T	1	2	3	0	0	3	0	0
24	24111606	.	T	A	4	3	7	0	0	7	0	0
24	24176723	.	A	G	1	3	4	0	0	4	0	0
24	25008702	.	T	A	5	2	7	0	0	7	0	0
24	25301457	.	A	T	1	2	3	1	0	4	0	0
24	25448741	.	T	C	9	5	14	0	1	15	0	0
24	25988133	.	C	A	1	2	3	2	1	6	0	0
24	26196676	.	A	G	2	3	5	0	0	5	0	0
24	26333084	.	T	C	1	5	6	0	0	6	0	0
24	26694412	.	A	G	3	2	5	0	0	5	0	0
24	26887490	.	C	A	2	5	7	0	1	8	0	0
24	26889347	.	C	T	3	2	5	0	0	5	0	0
24	26889359	.	G	A	3	4	7	0	0	7	0	0
24	26891144	.	G	T	3	2	5	0	1	6	0	0
24	26891149	.	A	G	4	2	6	0	0	6	0	0
24	26901831	.	C	T	4	3	7	0	2	9	0	0
24	26936841	.	T	C	3	2	5	0	1	6	0	0
24	26941996	.	A	G	9	5	14	1	1	16	0	0
24	26942242	.	C	G	11	10	21	0	1	22	0	0
24	26942614	.	C	T	1	14	15	0	15	30	0	0
24	26948933	.	A	T	3	2	5	0	0	5	0	0
24	26949229	.	T	C	4	7	11	0	0	11	0	0
24	26949555	.	T	G	6	4	10	0	1	11	0	0
24	26959891	.	T	C	8	0	8	0	4	12	0	0
24	26961917	.	A	G	9	8	17	0	0	17	0	0
24	26962107	.	G	A	5	3	8	0	0	8	0	0
24	26962277	.	C	T	16	5	21	0	1	22	0	0
24	26970690	.	C	G	3	5	8	0	6	14	0	0
24	26970726	.	C	T	6	5	11	0	1	12	0	0
24	26980360	.	A	G	5	3	8	0	1	9	0	0
24	26980376	.	A	G	4	2	6	0	0	6	0	0
24	26980842	.	A	G	6	2	8	0	0	8	0	0
24	26997881	.	T	G	6	8	14	0	0	14	0	0
24	26998086	.	T	A	2	6	8	0	0	8	0	0
24	27009231	.	C	A	10	9	19	0	0	19	0	0
24	27013469	.	A	T	13	8	21	0	2	23	0	0
24	27019523	.	T	A	11	5	16	0	1	17	0	0
24	27151634	.	T	C	7	7	14	0	3	17	0	0
24	27168939	.	C	T	10	4	14	0	1	15	0	0
24	27169668	.	T	C	3	3	6	0	0	6	0	0
24	27169734	.	T	C	8	6	14	0	0	14	0	0
24	27181057	.	G	A	7	11	18	0	1	19	0	0
24	27181135	.	A	G	13	2	15	0	9	24	0	0
24	27185574	.	A	G	15	11	26	0	0	26	0	0
24	27203410	.	C	T	4	9	13	3	0	16	0	0
24	27207238	.	G	T	12	12	24	0	2	26	0	0
24	27222574	.	G	A	10	15	25	0	0	25	0	0
24	27222610	.	A	C	12	19	31	0	3	34	0	0
24	27222662	.	C	T	15	11	26	0	1	27	0	0
24	27222713	.	A	G	18	0	18	0	7	25	0	0
24	27222731	.	A	G	18	0	18	0	10	28	0	0
24	27222937	.	G	A	1	11	12	0	17	29	0	0
24	27223018	.	C	T	13	6	19	1	0	20	0	0
24	27224383	.	T	A	18	5	23	1	3	27	0	0
24	27224415	.	G	A	21	10	31	1	0	33	1	0
24	27224484	.	A	T	15	15	30	0	6	36	0	0
24	27224842	.	G	A	11	15	26	0	1	27	0	0
24	27224990	.	G	A	13	16	29	0	1	30	0	0
24	27225423	.	C	A	13	9	22	0	1	23	0	0
24	27225842	.	A	G	12	12	24	0	0	24	0	0
24	27226044	.	A	G	10	9	19	1	0	20	0	0
24	27236412	.	A	C	14	10	24	0	1	25	0	0
24	27236653	.	C	T	11	19	30	0	0	30	0	0
24	27236716	.	T	C	16	23	39	0	1	40	0	0
24	27238527	.	G	A	12	13	25	0	0	25	0	0
24	27238808	.	C	T	3	20	23	0	13	36	0	0
24	27713822	.	G	A	3	3	6	0	0	6	0	0
24	27714331	.	C	T	7	5	12	0	1	13	0	0
24	27714338	.	C	T	9	5	14	0	0	14	0	0
24	27714396	.	G	A	0	3	3	0	4	7	0	0
24	27715145	.	T	C	1	2	3	0	0	3	0	0
24	27783955	.	G	A	5	5	10	0	0	10	0	0
24	27784009	.	C	T	10	5	15	0	1	16	0	0
24	27784036	.	A	G	11	11	22	0	0	22	0	0
24	27784057	.	T	C	10	14	24	0	0	24	0	0
24	27784102	.	C	G	11	10	21	0	1	22	0	0
24	27784129	.	A	G	12	11	23	0	2	25	0	0
24	27784210	.	G	T	8	10	18	0	2	20	0	0
24	27784246	.	G	A	10	11	21	0	2	23	0	0
24	27784342	.	A	G	4	7	11	0	0	11	0	0
24	27784444	.	G	A	5	10	15	0	0	15	0	0
24	27879057	.	G	C	4	0	4	0	7	11	0	0
24	28137226	.	T	A	2	2	4	0	0	4	0	0
24	28137679	.	C	T	0	4	4	0	2	6	0	0
24	28228495	.	G	A	5	5	10	0	0	10	0	0
24	28228572	.	G	A	6	5	11	0	0	11	0	0
24	28228587	.	T	C	6	3	9	0	0	9	0	0
24	28252605	.	C	T	4	7	11	0	0	11	0	0
24	28252608	.	C	T	7	4	11	0	0	11	0	0
24	28252677	.	T	A	2	4	6	0	1	7	0	0
24	28252699	.	G	A	7	6	13	0	0	13	0	0
24	28253646	.	A	T	17	12	29	0	0	29	0	0
24	28253663	.	G	A	18	8	26	0	0	26	0	0
24	28253782	.	A	T	16	25	41	0	0	41	0	0
24	28253802	.	T	C	23	0	23	1	15	39	0	0
24	28258991	.	G	A	5	6	11	0	0	11	0	0
24	28259011	.	G	A	5	7	12	0	0	12	0	0
24	28259128	.	C	T	16	13	29	0	3	32	0	0
24	28426244	.	G	C	9	8	17	0	0	17	0	0
24	28426597	.	G	A	21	22	43	0	0	43	0	0
24	28426617	.	C	T	3	19	22	0	18	40	0	0
24	28432465	.	C	T	22	7	29	0	1	30	0	0
24	28532255	.	C	T	1	4	5	0	0	5	0	0
24	28555955	.	C	T	1	2	3	0	0	3	0	0
24	28686815	.	C	T	0	6	6	0	6	12	0	0
24	28686864	.	T	A	5	6	11	0	0	11	0	0
24	28687245	.	A	C	3	0	3	0	5	8	0	0
24	28687253	.	G	A	3	8	11	0	0	11	0	0
24	28687424	.	C	T	1	6	7	0	9	16	0	0
24	28687783	.	G	T	12	11	23	0	0	23	0	0
24	28688137	.	G	A	12	8	20	0	0	20	0	0
24	28688416	.	G	A	13	8	21	0	2	23	0	0
24	28691389	.	C	T	7	3	10	0	0	10	0	0
24	28691457	.	C	T	0	12	12	0	6	18	0	0
24	28781184	.	C	T	1	2	3	0	2	5	0	0
24	28781199	.	G	A	2	2	4	0	1	5	0	0
24	28818477	.	T	A	1	2	3	0	0	3	0	0
24	28936771	.	C	T	14	15	29	0	1	30	0	0
24	28936801	.	A	T	8	20	28	0	1	29	0	0
24	28949511	.	G	A	8	14	22	0	2	24	0	0
24	28964708	.	T	A	3	2	5	0	0	5	0	0
24	28964747	.	T	A	2	3	5	0	0	5	0	0
24	28965616	.	C	T	3	5	8	0	0	8	0	0
24	28966892	.	T	C	3	3	6	0	0	6	0	0
24	28967234	.	A	G	1	0	1	0	3	4	0	0
24	30160494	.	G	T	2	7	9	0	0	9	0	0
24	30182343	.	T	G	1	0	1	0	5	6	0	0
24	30194386	.	G	A	0	3	3	0	6	9	0	0
24	30198967	.	C	G	4	7	11	0	2	13	0	0
24	30198977	.	T	C	3	8	11	0	0	11	0	0
24	30228429	.	A	G	1	2	3	0	0	3	0	0
24	30350077	.	T	G	6	5	11	0	0	11	0	0
24	30352234	.	C	T	4	9	13	0	1	14	0	0
24	30352276	.	T	C	7	9	16	0	0	16	0	0
24	30352907	.	T	C	18	16	34	0	0	34	0	0
24	30352940	.	T	A	14	20	34	0	0	34	0	0
24	30353036	.	T	A	20	17	37	0	3	40	0	0
24	30353065	.	G	A	25	11	36	0	0	36	0	0
24	30353083	.	G	A	25	10	35	0	0	35	0	0
24	30353298	.	A	G	14	10	24	0	1	25	0	0
24	30353447	.	T	C	13	10	23	0	2	25	0	0
24	30353683	.	A	G	9	11	20	0	0	20	0	0
24	30353825	.	A	G	7	0	7	0	8	15	0	0
24	30353893	.	C	A	9	12	21	0	0	21	0	0
24	30353918	.	C	T	7	7	14	0	0	14	0	0
24	30521947	.	A	T	2	2	4	0	0	4	0	0
24	30521950	.	A	T	2	2	4	0	0	4	0	0
24	30835934	.	T	C	5	8	13	0	0	13	0	0
24	30835936	.	A	G	5	7	12	0	1	13	0	0
24	30835992	.	G	T	0	8	8	0	3	11	0	0
24	30836042	.	C	T	12	4	16	0	0	16	0	0
24	30837512	.	A	G	11	6	17	0	0	17	0	0
24	30845845	.	G	A	7	4	11	0	0	11	0	0
24	30845875	.	G	C	6	0	6	0	8	14	0	0
24	30845893	.	C	T	7	10	17	0	1	18	0	0
24	30852329	.	C	T	0	4	4	0	3	7	0	0
24	30862120	.	C	A	4	4	8	0	1	9	0	0
24	31098564	.	A	C	14	10	24	1	1	26	0	0
24	31098720	.	A	G	17	18	35	0	1	36	0	0
24	31098874	.	G	T	5	11	16	0	0	16	0	0
24	31116765	.	T	C	8	4	12	0	0	12	0	0
24	31140110	.	G	A	5	3	8	0	0	8	0	0
24	31140187	.	A	T	11	5	16	0	0	16	0	0
24	31140251	.	A	G	4	7	11	0	0	11	0	0
24	31140269	.	C	T	8	8	16	0	0	16	0	0
24	31140293	.	G	A	12	6	18	0	0	18	0	0
24	31170751	.	A	T	3	5	8	0	0	8	0	0
24	31171285	.	G	A	3	6	9	0	0	9	0	0
24	31171417	.	G	A	8	5	13	0	1	14	0	0
24	31171468	.	A	T	8	6	14	0	0	14	0	0
24	31174152	.	A	G	6	5	11	0	0	11	0	0
24	31176087	.	A	G	4	5	9	0	0	9	0	0
24	31194653	.	T	C	5	5	10	0	0	10	0	0
24	31218903	.	G	T	1	2	3	1	1	5	0	0
24	31220033	.	G	C	2	0	2	0	2	4	0	0
24	31222959	.	T	C	2	2	4	0	0	4	0	0
24	31223116	.	A	G	1	2	3	0	0	3	0	0
24	31223165	.	T	A	4	2	6	0	0	6	0	0
24	31281109	.	C	T	1	2	3	0	0	3	0	0
24	31283637	.	C	T	1	3	4	0	1	5	0	0
24	31283676	.	G	A	1	4	5	0	1	6	0	0
24	31310849	.	T	A	3	6	9	0	0	9	0	0
24	31311185	.	T	G	6	6	12	0	0	12	0	0
24	31311323	.	C	G	0	11	11	0	3	14	0	0
24	31311334	.	G	C	3	11	14	0	0	14	0	0
24	31313234	.	G	A	13	8	21	0	0	21	0	0
24	31315985	.	A	G	7	11	18	0	0	18	0	0
24	31319592	.	C	T	2	6	8	0	8	16	0	0
24	31321950	.	G	A	9	10	19	1	0	20	0	0
24	31323142	.	C	T	11	10	21	0	0	21	0	0
24	31323287	.	A	C	13	7	20	0	0	20	0	0
24	31323293	.	G	A	11	9	20	0	1	21	0	0
24	31330040	.	G	A	4	9	13	0	1	14	0	0
24	31334313	.	A	G	20	23	43	0	0	43	0	0
24	31340819	.	A	T	20	25	45	0	5	50	0	0
24	31342727	.	A	G	1	3	4	0	0	4	0	0
24	31342729	.	A	G	1	3	4	0	0	4	0	0
24	31346647	.	G	T	23	18	41	0	1	42	0	0
24	31364654	.	A	G	4	0	4	0	4	8	0	0
24	31367880	.	A	G	6	0	6	0	5	11	0	0
24	31367891	.	C	T	5	5	10	0	0	10	0	0
24	31367999	.	A	G	3	5	8	0	0	8	0	0
24	31368340	.	T	G	1	2	3	0	0	3	0	0
24	31374494	.	T	C	8	3	11	0	0	11	0	0
24	31379444	.	A	C	5	2	7	0	0	7	0	0
24	31379885	.	C	A	4	2	6	0	0	6	0	0
24	31379892	.	C	G	2	4	6	0	0	6	0	0
24	31390756	.	G	A	0	3	3	0	5	8	0	0
24	31397840	.	G	A	8	10	18	0	1	19	0	0
24	31398002	.	A	G	14	9	23	0	0	23	0	0
24	31404580	.	C	G	8	11	19	0	0	19	0	0
24	31832549	.	G	A	3	13	16	0	2	18	0	0
24	31832615	.	T	G	6	4	10	0	0	10	0	0
24	31832657	.	G	A	8	7	15	0	0	15	0	0
24	31833114	.	A	T	12	12	24	0	1	25	0	0
24	31833991	.	G	A	6	7	13	0	0	13	0	0
24	31834286	.	A	G	8	9	17	0	0	17	0	0
24	31834396	.	G	A	6	12	18	0	0	18	0	0
24	31834681	.	A	T	6	10	16	0	0	16	0	0
24	31836483	.	A	T	8	9	17	0	0	17	0	0
24	31838972	.	T	C	7	5	12	0	0	12	0	0
24	31838995	.	C	A	4	5	9	0	1	10	0	0
24	31839067	.	G	A	7	3	10	0	2	12	0	0
24	31942105	.	T	G	9	5	14	1	0	15	0	0
24	31942597	.	A	C	6	1	7	0	3	10	0	0
24	32152862	.	A	G	2	3	5	0	0	5	0	0
24	32152877	.	T	G	2	3	5	0	0	5	0	0
24	32152921	.	T	C	3	3	6	0	0	6	0	0
24	32163896	.	C	A	1	3	4	0	4	8	0	0
24	32163954	.	T	C	3	0	3	0	3	6	0	0
24	32164027	.	C	T	1	4	5	0	0	5	0	0
24	32164366	.	A	G	1	3	4	0	0	4	0	0
24	32164395	.	A	G	0	1	1	0	0	1	0	0
24	32164402	.	C	T	1	2	3	0	0	3	0	0
24	32173200	.	A	T	6	4	10	0	0	10	0	0
24	32173246	.	G	A	6	5	11	0	1	12	0	0
24	32176222	.	T	C	4	13	17	0	0	17	0	0
24	32176448	.	C	T	14	19	33	0	1	34	0	0
24	32176499	.	T	C	28	19	47	0	1	48	0	0
24	32180747	.	C	T	19	15	34	0	2	36	0	0
24	32192518	.	G	A	2	18	20	0	25	45	0	0
24	32192529	.	T	C	24	18	42	0	2	44	0	0
24	32192558	.	G	A	21	19	40	0	4	44	0	0
24	32192622	.	T	C	19	11	30	0	1	31	0	0
24	32472919	.	T	C	13	5	18	0	2	20	0	0
24	32473291	.	C	T	10	6	16	0	0	16	0	0
24	32473326	.	C	G	10	0	10	0	7	17	0	0
24	32473386	.	C	T	20	6	26	0	0	26	0	0
24	32473464	.	T	C	8	9	17	0	1	18	0	0
24	32473594	.	C	G	12	11	23	0	0	23	0	0
24	32473750	.	G	A	1	2	3	0	1	4	0	0
24	32473821	.	G	A	13	4	17	0	0	17	0	0
24	32473829	.	A	G	12	5	17	0	1	18	0	0
24	32474070	.	G	C	2	6	8	0	1	9	0	0
24	32474439	.	A	T	1	5	6	0	0	6	0	0
24	32474546	.	A	C	8	9	17	0	1	18	0	0
24	32519528	.	C	T	3	28	31	0	25	56	0	0
24	32522526	.	A	G	25	26	51	0	1	52	0	0
24	32522577	.	A	T	12	8	20	0	2	22	0	0
24	32533158	.	G	C	5	9	14	0	0	14	0	0
24	32533395	.	T	A	1	3	4	0	0	4	0	0
24	32536788	.	A	G	3	0	3	0	6	9	0	0
24	32536869	.	T	C	6	5	11	0	0	11	0	0
24	32537805	.	C	T	8	8	16	0	1	17	0	0
24	32547755	.	T	C	1	5	6	0	0	6	0	0
24	32547920	.	A	G	5	1	6	0	2	8	0	0
24	32547926	.	A	C	3	6	9	0	0	9	0	0
24	32548038	.	A	C	3	6	9	0	0	9	0	0
24	32658577	.	C	T	10	12	22	0	1	23	0	0
24	32658868	.	A	C	13	0	13	0	11	24	0	0
24	32664790	.	A	T	10	5	15	0	2	17	0	0
24	32664823	.	T	G	9	8	17	0	0	17	0	0
24	32664870	.	A	C	6	2	8	0	0	8	0	0
24	32668834	.	G	A	6	10	16	0	0	16	0	0
24	32668880	.	T	A	9	16	25	0	2	27	0	0
24	32674686	.	T	A	8	14	22	1	0	23	0	0
24	32674798	.	T	G	9	0	9	0	6	15	0	0
24	32674886	.	A	G	9	7	16	0	2	18	0	0
24	32674960	.	T	A	1	7	8	1	0	9	0	0
24	33228611	.	A	G	9	10	19	1	0	20	0	0
24	33228620	.	C	T	7	10	17	1	0	18	0	0
24	33234934	.	T	C	6	0	6	0	10	16	0	0
24	33279954	.	G	T	1	2	3	0	0	3	0	0
24	33279982	.	T	A	2	2	4	0	1	5	0	0
24	33280061	.	C	T	6	3	9	0	0	9	0	0
24	33284689	.	G	A	8	11	19	0	1	20	0	0
24	33284915	.	A	G	3	3	6	0	0	6	0	0
24	33290278	.	G	A	7	3	10	0	0	10	0	0
24	33290546	.	A	G	7	2	9	1	0	10	0	0
24	33290618	.	T	G	10	4	14	0	0	14	0	0
24	33301855	.	T	G	1	2	3	0	0	3	0	0
24	33301867	.	A	G	1	2	3	0	0	3	0	0
24	33301893	.	T	G	1	3	4	0	0	4	0	0
24	33400863	.	C	T	4	7	11	0	0	11	0	0
24	33401158	.	C	T	2	4	6	0	0	6	0	0
24	33402901	.	G	A	5	5	10	0	0	10	0	0
24	33403196	.	A	G	6	0	6	0	15	22	1	0
24	33403328	.	G	A	2	5	7	0	3	10	0	0
24	33410992	.	G	A	7	7	14	0	0	14	0	0
24	33411097	.	C	T	8	6	14	0	0	14	0	0
24	33411157	.	A	C	5	5	10	0	0	10	0	0
24	33670903	.	C	T	3	3	6	0	0	6	0	0
24	33670909	.	T	C	3	3	6	0	0	6	0	0
24	33673230	.	C	T	1	2	3	0	0	3	0	0
24	33673652	.	A	G	1	2	3	0	0	3	0	0
24	33673670	.	C	T	1	2	3	0	0	3	0	0
24	33685278	.	A	T	2	2	4	0	0	4	0	0
24	33709247	.	C	G	27	28	55	0	3	58	0	0
24	33714797	.	A	G	27	19	46	0	1	47	0	0
24	33714854	.	G	A	20	24	44	0	1	45	0	0
24	33723289	.	C	A	3	23	26	0	20	46	0	0
24	33755683	.	C	T	27	19	46	0	0	47	1	0
24	33767992	.	T	C	11	5	16	0	0	16	0	0
24	33768192	.	G	A	7	2	9	0	1	10	0	0
24	33768346	.	T	A	15	7	22	1	0	23	0	0
24	33768509	.	C	T	9	8	17	0	0	17	0	0
24	33768530	.	G	T	10	6	16	0	1	17	0	0
24	33768705	.	A	G	21	13	34	0	0	34	0	0
24	33774457	.	G	A	5	8	13	0	0	13	0	0
24	33777341	.	C	T	0	2	2	0	4	6	0	0
24	33784409	.	A	C	4	7	11	0	0	11	0	0
24	33785898	.	G	A	5	5	10	0	0	10	0	0
24	33788330	.	G	A	1	5	6	0	0	6	0	0
24	33790094	.	G	A	9	4	13	0	0	13	0	0
24	33792254	.	C	T	0	4	4	0	5	9	0	0
24	33800095	.	C	T	0	4	4	0	3	7	0	0
24	33801615	.	T	A	4	2	6	0	0	6	0	0
24	33806426	.	C	T	5	6	11	0	0	11	0	0
24	33813399	.	G	A	1	7	8	0	5	13	0	0
24	33813525	.	C	T	13	4	17	0	1	18	0	0
24	33813573	.	A	G	7	0	7	0	9	16	0	0
24	33813891	.	G	C	2	2	4	0	0	4	0	0
24	33824590	.	A	G	5	0	5	0	5	10	0	0
24	33824635	.	C	T	4	7	11	0	0	11	0	0
24	33826850	.	C	T	14	7	21	0	0	21	0	0
24	33832513	.	G	A	7	5	12	1	0	13	0	0
24	33834884	.	G	A	1	3	4	0	2	6	0	0
24	33835143	.	T	A	6	4	10	0	0	10	0	0
24	33835259	.	T	G	5	3	8	0	0	8	0	0
24	33835327	.	A	G	1	4	5	0	0	5	0	0
24	33836236	.	T	A	2	3	5	0	0	5	0	0
24	33836490	.	T	A	4	3	7	0	0	7	0	0
24	33836693	.	A	G	4	2	6	0	1	7	0	0
24	33837272	.	A	G	4	2	6	0	0	6	0	0
24	33837595	.	A	G	2	2	4	0	0	4	0	0
24	33837636	.	G	T	1	7	8	0	0	8	0	0
24	33837753	.	A	G	5	9	14	0	1	15	0	0
24	33837777	.	A	G	10	0	10	0	3	13	0	0
24	33837790	.	A	G	5	7	12	0	0	12	0	0
24	33837865	.	A	G	3	2	5	1	0	6	0	0
24	33837914	.	A	G	2	5	7	0	0	7	0	0
24	33837916	.	A	G	2	4	6	0	0	6	0	0
24	33838012	.	A	C	1	6	7	0	1	9	1	0
24	33838097	.	A	G	5	5	10	0	0	10	0	0
24	33838293	.	A	G	6	3	9	0	0	9	0	0
24	33838486	.	G	A	2	4	6	0	4	10	0	0
24	33838533	.	T	G	3	0	3	0	4	7	0	0
24	33838753	.	G	A	1	3	4	0	0	4	0	0
24	33838876	.	A	G	3	0	3	0	13	16	0	0
24	33839031	.	G	A	13	6	19	0	0	19	0	0
24	33839211	.	T	C	4	3	7	1	0	8	0	0
24	33839221	.	A	C	4	3	7	1	0	8	0	0
24	33873397	.	C	T	0	4	4	0	6	10	0	0
24	34034647	.	T	G	5	3	8	0	0	8	0	0
24	34115343	.	C	T	5	2	7	0	0	7	0	0
24	34115830	.	G	A	2	9	11	0	0	11	0	0
24	34116138	.	C	T	2	2	4	0	0	4	0	0
24	34139278	.	G	A	17	7	24	0	1	25	0	0
24	34139317	.	C	T	10	5	15	0	1	16	0	0
24	34139323	.	T	C	11	0	11	0	2	13	0	0
24	34176593	.	C	T	3	4	7	0	0	7	0	0
24	34185156	.	T	C	4	5	9	0	0	9	0	0
24	34185357	.	G	T	12	3	15	0	0	15	0	0
24	34185364	.	G	A	11	5	16	0	0	16	0	0
24	34208678	.	G	A	9	7	16	0	1	17	0	0
24	34208684	.	T	C	9	7	16	0	1	17	0	0
24	34208747	.	A	G	7	10	17	0	0	17	0	0
24	34284596	.	G	T	17	22	39	0	0	39	0	0
24	34973991	.	C	T	8	12	20	0	0	20	0	0
24	34974022	.	C	A	11	8	19	0	0	19	0	0
24	34974105	.	C	T	4	10	14	0	0	14	0	0
24	34974536	.	C	T	7	10	17	0	1	18	0	0
24	34976187	.	A	G	10	0	10	0	11	21	0	0
24	34976465	.	G	A	10	5	15	0	1	16	0	0
24	34979444	.	T	C	7	9	16	0	0	16	0	0
24	34991185	.	A	G	11	10	21	0	0	21	0	0
24	34993400	.	A	G	18	8	26	0	2	28	0	0
24	34993406	.	T	C	21	10	31	0	0	31	0	0
24	34996173	.	C	T	11	14	25	0	1	26	0	0
24	35000961	.	G	T	0	18	18	0	17	35	0	0
24	35002871	.	G	A	13	9	22	0	1	23	0	0
24	35196205	.	C	G	17	8	25	0	1	26	0	0
24	35216541	.	C	T	21	19	40	0	1	41	0	0
24	35216973	.	C	T	10	10	20	0	3	23	0	0
24	35217222	.	A	T	16	15	31	0	1	32	0	0
24	35217302	.	T	G	5	9	14	0	0	14	0	0
24	35217426	.	C	T	6	9	15	0	2	17	0	0
24	35218334	.	G	A	0	3	3	0	2	5	0	0
24	35218336	.	T	G	2	3	5	0	0	5	0	0
24	35218874	.	A	G	3	3	6	0	0	6	0	0
24	35218889	.	A	G	4	3	7	0	0	7	0	0
24	35219022	.	C	A	3	2	5	0	0	5	0	0
24	35232722	.	C	T	0	6	6	0	2	8	0	0
24	35242956	.	C	T	1	4	5	0	0	5	0	0
24	35269903	.	G	T	4	3	7	0	0	7	0	0
24	35269915	.	A	G	3	4	7	0	1	8	0	0
24	35270459	.	A	G	2	3	5	0	0	5	0	0
24	35522379	.	A	T	11	8	19	0	1	20	0	0
24	35522417	.	C	A	11	8	19	0	1	20	0	0
24	35522568	.	C	T	25	15	40	0	0	40	0	0
24	35522962	.	A	G	21	24	45	0	0	45	0	0
24	35523088	.	A	T	18	31	49	0	14	63	0	0
24	35523134	.	T	A	34	12	46	1	5	52	0	0
24	35523135	.	T	A	37	14	51	1	0	52	0	0
24	35530249	.	T	G	25	24	49	1	3	53	0	0
24	35544514	.	C	A	4	3	7	0	0	7	0	0
24	35546042	.	G	A	1	3	4	0	0	4	0	0
24	35546660	.	G	A	1	3	4	0	0	4	0	0
24	35550606	.	C	T	1	2	3	0	1	4	0	0
24	35559069	.	G	A	1	2	3	0	0	3	0	0
24	35559115	.	C	T	2	3	5	0	0	5	0	0
24	35559117	.	C	A	3	2	5	0	0	5	0	0
24	35565350	.	C	G	8	1	9	0	8	17	0	0
24	35681625	.	G	A	26	20	46	0	1	47	0	0
24	35681753	.	G	A	23	38	61	0	3	64	0	0
24	35683349	.	T	C	29	22	51	0	3	54	0	0
24	35683883	.	A	G	22	21	43	1	4	48	0	0
24	35686180	.	A	G	21	23	44	0	1	45	0	0
24	35692741	.	C	T	1	19	20	0	26	46	0	0
24	35713710	.	T	C	3	5	8	0	0	8	0	0
24	35713835	.	G	A	6	4	10	0	0	10	0	0
24	35720364	.	G	A	12	9	21	0	1	22	0	0
24	35720498	.	C	T	3	15	18	0	10	29	1	0
24	35726377	.	A	G	8	5	13	0	0	13	0	0
24	35735837	.	C	T	7	4	11	0	0	11	0	0
24	35742791	.	A	G	4	5	9	0	1	10	0	0
24	35749830	.	T	C	2	3	5	0	0	5	0	0
24	35749858	.	C	A	1	6	7	0	3	10	0	0
24	35899121	.	A	G	2	0	2	0	6	8	0	0
24	35906191	.	G	A	0	4	4	0	9	13	0	0
24	35914362	.	A	T	3	2	5	0	0	5	0	0
24	35914422	.	T	G	1	2	3	0	0	3	0	0
24	35918445	.	C	G	3	4	7	0	1	8	0	0
24	35925145	.	T	C	3	4	7	0	1	8	0	0
24	35925163	.	C	A	5	3	8	0	2	10	0	0
24	35925322	.	C	T	6	5	11	0	1	12	0	0
24	35925499	.	T	C	5	4	9	0	0	9	0	0
24	35927589	.	G	A	1	4	5	0	7	12	0	0
24	35927598	.	C	T	8	5	13	0	0	13	0	0
24	35929814	.	A	C	3	3	6	0	0	6	0	0
24	35930005	.	A	C	2	6	8	0	1	9	0	0
24	35930056	.	T	G	3	2	5	0	0	5	0	0
24	36027212	.	T	C	15	13	28	0	0	28	0	0
24	36166121	.	T	G	5	4	9	0	0	9	0	0
24	36175078	.	G	A	9	5	14	0	0	14	0	0
24	36175099	.	T	G	9	6	15	0	1	16	0	0
24	36175205	.	G	A	7	7	14	0	0	14	0	0
24	36175208	.	C	T	9	7	16	0	0	16	0	0
24	36177713	.	T	C	6	0	6	0	4	10	0	0
24	36180824	.	C	T	1	5	6	0	0	6	0	0
24	36182443	.	A	G	4	5	9	0	0	9	0	0
24	36182455	.	G	A	4	7	11	0	0	11	0	0
24	36182503	.	G	C	5	4	9	0	0	9	0	0
24	36185723	.	G	A	6	5	11	0	0	11	0	0
24	36187507	.	G	T	8	3	11	0	0	11	0	0
24	36187933	.	A	T	5	3	8	0	1	10	1	0
24	36187963	.	C	T	5	1	6	0	2	8	0	0
24	36193431	.	C	T	1	6	7	0	5	12	0	0
24	36193557	.	C	A	7	8	15	0	0	15	0	0
24	36193938	.	A	C	2	2	4	0	1	5	0	0
24	36194151	.	G	A	3	3	6	0	0	6	0	0
24	36194330	.	T	C	6	5	11	0	0	11	0	0
24	36194365	.	C	T	5	5	10	0	0	10	0	0
24	36194535	.	A	T	3	2	5	0	0	5	0	0
24	36194679	.	A	T	1	3	4	0	0	4	0	0
24	36194682	.	G	T	1	2	3	0	1	4	0	0
24	36195168	.	A	G	6	4	10	0	0	10	0	0
24	36223627	.	T	C	3	6	9	0	1	10	0	0
24	36227850	.	A	C	2	0	2	0	2	4	0	0
24	36244407	.	C	T	5	2	7	0	0	7	0	0
24	36247261	.	A	T	7	8	15	0	1	16	0	0
24	36247537	.	C	T	8	7	15	0	0	15	0	0
24	36248705	.	C	T	7	6	13	0	0	13	0	0
24	36249910	.	G	T	4	8	12	0	1	13	0	0
24	36250403	.	T	C	4	8	12	0	0	12	0	0
24	36253324	.	C	T	20	18	38	0	2	40	0	0
24	36261666	.	T	C	2	6	8	0	0	8	0	0
24	36261730	.	C	T	1	3	4	0	2	6	0	0
24	36266460	.	C	A	2	5	7	0	0	7	0	0
24	36266484	.	A	G	3	3	6	0	0	6	0	0
24	36266649	.	T	C	4	0	4	0	4	8	0	0
24	36270846	.	G	T	1	2	3	0	0	3	0	0
24	36271163	.	G	A	3	3	6	0	0	6	0	0
24	36271269	.	T	A	9	2	11	0	0	11	0	0
24	36271274	.	T	A	9	2	11	0	1	12	0	0
24	36276035	.	A	C	3	4	7	0	0	7	0	0
24	36276059	.	G	T	6	5	11	0	0	11	0	0
24	36276087	.	A	G	5	4	9	0	0	9	0	0
24	36276363	.	A	G	8	6	14	0	3	17	0	0
24	36276364	.	G	T	10	7	17	0	0	17	0	0
24	36280272	.	A	G	8	7	15	0	0	15	0	0
24	36280296	.	T	G	6	10	16	0	0	16	0	0
24	36287396	.	G	T	4	3	7	0	0	7	0	0
24	36289642	.	T	C	1	5	6	0	0	6	0	0
24	36295355	.	C	T	2	4	6	0	1	7	0	0
24	36295445	.	C	T	0	5	5	0	5	10	0	0
24	36295448	.	C	T	5	4	9	0	1	10	0	0
24	36295817	.	A	G	4	9	13	0	0	13	0	0
24	36295833	.	G	C	2	7	9	0	0	9	0	0
24	36298928	.	G	A	16	8	24	0	0	24	0	0
24	36298934	.	G	A	15	8	23	0	1	24	0	0
24	36298963	.	A	G	13	7	20	0	1	21	0	0
24	36300941	.	T	A	8	8	16	0	0	16	0	0
24	36301035	.	T	G	6	4	10	0	0	10	0	0
24	36321435	.	C	T	1	3	4	0	0	4	0	0
24	36323341	.	C	T	3	4	7	0	1	8	0	0
24	36323362	.	T	C	3	1	4	0	1	5	0	0
24	36323386	.	T	A	4	3	7	0	0	7	0	0
24	36325256	.	C	G	5	4	9	0	0	9	0	0
24	36325262	.	C	G	5	4	9	0	0	9	0	0
24	36331150	.	A	G	1	3	4	0	0	4	0	0
24	36331180	.	G	C	2	3	5	0	0	5	0	0
24	36331207	.	G	T	3	3	6	0	0	6	0	0
24	36331220	.	G	T	3	2	5	0	0	5	0	0
24	36334589	.	G	A	2	3	5	0	0	5	0	0
24	36334677	.	T	C	4	7	11	0	0	11	0	0
24	36334724	.	A	G	6	5	11	0	0	11	0	0
24	36334848	.	A	G	3	4	7	0	3	10	0	0
24	36334857	.	G	A	3	5	8	0	1	9	0	0
24	36335024	.	C	G	3	7	10	0	0	10	0	0
24	36335106	.	A	T	4	3	7	0	1	8	0	0
24	36335139	.	T	C	3	0	3	0	7	10	0	0
24	36335196	.	C	G	7	7	14	0	1	15	0	0
24	36335228	.	T	C	8	0	8	0	7	15	0	0
24	36339310	.	A	C	5	3	8	0	0	8	0	0
24	36343161	.	T	A	1	5	6	0	0	6	0	0
24	36345004	.	A	G	4	0	4	0	3	7	0	0
24	36345031	.	C	T	1	4	5	0	0	5	0	0
24	36345506	.	C	T	2	2	4	0	0	4	0	0
24	36349911	.	C	T	3	2	5	0	0	5	0	0
24	36349915	.	G	A	2	1	3	0	2	5	0	0
24	36352446	.	G	A	0	8	8	0	7	15	0	0
24	36352450	.	G	A	7	8	15	0	0	15	0	0
24	36357149	.	A	C	2	3	5	0	0	5	0	0
24	36358711	.	T	C	5	6	11	0	1	12	0	0
24	36362031	.	G	C	3	4	7	0	0	7	0	0
24	36362141	.	T	C	10	7	17	0	0	17	0	0
24	36399687	.	A	G	1	3	4	0	0	4	0	0
24	36399691	.	A	G	1	3	4	0	0	4	0	0
24	36798775	.	G	A	6	2	8	0	0	8	0	0
24	37170198	.	G	A	1	6	7	0	6	13	0	0
24	37195514	.	T	A	12	15	27	0	1	28	0	0
24	37203849	.	A	G	11	8	19	8	0	27	0	0
24	37206315	.	G	A	7	5	12	0	0	12	0	0
24	37211694	.	C	T	1	9	10	0	3	13	0	0
24	37214116	.	T	A	6	8	14	0	0	14	0	0
24	37214122	.	C	T	7	8	15	0	0	15	0	0
24	37221248	.	C	T	4	6	10	0	0	10	0	0
24	37221302	.	C	T	4	9	13	0	0	14	1	0
24	37221323	.	C	T	1	8	9	0	5	14	0	0
24	37257922	.	T	G	18	7	25	0	1	31	5	0
24	37261221	.	A	G	21	14	35	0	4	39	0	0
24	37275494	.	T	A	1	2	3	0	0	3	0	0
24	37275495	.	C	A	1	2	3	0	0	3	0	0
24	37276218	.	C	T	1	3	4	0	0	4	0	0
24	37276305	.	C	T	4	3	7	0	0	7	0	0
24	37276788	.	A	G	1	3	4	0	0	4	0	0
24	37277246	.	G	T	3	7	10	0	0	10	0	0
24	37277257	.	T	G	4	9	13	0	0	13	0	0
24	37302011	.	T	A	12	6	18	0	1	19	0	0
24	37302539	.	G	A	21	15	36	0	3	39	0	0
24	37302747	.	G	A	20	18	38	0	4	42	0	0
24	37302764	.	G	T	24	16	40	0	1	41	0	0
24	37303266	.	A	G	11	15	26	0	6	32	0	0
24	37303275	.	G	T	16	20	36	0	1	37	0	0
24	37310338	.	A	C	12	12	24	0	0	24	0	0
24	37312146	.	T	C	14	13	27	0	3	30	0	0
24	37312173	.	A	G	19	16	35	0	0	35	0	0
24	37319839	.	G	A	10	6	16	0	1	17	0	0
24	37319851	.	G	A	12	5	17	0	0	17	0	0
24	37329390	.	A	G	2	2	4	0	0	4	0	0
24	37329476	.	T	A	3	6	9	0	0	9	0	0
24	37336975	.	A	G	3	4	7	0	0	7	0	0
24	37337763	.	C	T	10	2	12	0	1	13	0	0
24	37338980	.	T	C	6	8	14	0	0	14	0	0
24	37340776	.	A	G	8	1	9	0	3	12	0	0
24	37340846	.	A	T	5	4	9	0	0	9	0	0
24	37344146	.	A	T	12	14	26	0	1	27	0	0
24	37344164	.	G	A	14	15	29	0	0	29	0	0
24	37347758	.	A	C	3	4	7	0	0	7	0	0
24	37347937	.	A	C	2	2	4	0	0	4	0	0
24	37347946	.	T	C	2	3	5	0	0	5	0	0
24	37370207	.	T	G	15	0	15	0	9	24	0	0
24	37375160	.	C	T	13	20	33	0	4	37	0	0
24	37375165	.	T	C	11	19	30	0	5	35	0	0
24	37469699	.	G	A	8	14	22	0	2	24	0	0
24	37474110	.	A	G	8	15	23	0	1	24	0	0
24	37476633	.	A	C	6	12	18	0	1	19	0	0
24	37476735	.	A	C	7	14	21	0	0	21	0	0
24	37476759	.	T	C	6	13	19	0	0	19	0	0
24	37476955	.	A	G	8	13	21	0	0	21	0	0
24	37477036	.	C	T	8	10	18	0	2	20	0	0
24	37482699	.	T	A	5	6	11	0	2	13	0	0
24	37513394	.	G	A	1	4	5	0	0	5	0	0
24	37518733	.	T	A	1	2	3	0	0	3	0	0
24	37531454	.	A	C	1	3	4	0	0	4	0	0
24	37537870	.	T	C	2	2	4	0	0	4	0	0
24	37539395	.	G	A	1	3	4	0	0	4	0	0
24	37539572	.	T	C	4	7	11	0	1	12	0	0
24	37542624	.	C	T	2	3	5	0	0	5	0	0
24	37544901	.	C	T	3	3	6	0	0	6	0	0
24	37547639	.	T	C	3	3	6	0	0	6	0	0
24	37555605	.	C	T	11	3	14	0	0	14	0	0
24	37567342	.	C	T	14	15	29	1	3	33	0	0
24	37567734	.	C	T	3	18	21	0	24	45	0	0
24	37567953	.	A	G	26	24	50	0	3	53	0	0
24	37568186	.	A	C	23	20	43	0	1	45	1	0
24	37568349	.	T	G	6	4	10	0	0	10	0	0
24	37604311	.	G	T	8	6	14	0	1	15	0	0
24	37604362	.	C	T	2	7	9	0	0	9	0	0
24	37615204	.	A	G	5	5	10	0	0	10	0	0
24	37623208	.	C	T	7	4	11	0	0	11	0	0
24	37631842	.	G	A	2	3	5	0	0	5	0	0
24	37649846	.	G	A	0	4	4	0	1	5	0	0
24	37653377	.	A	G	8	0	8	0	4	12	0	0
24	37653447	.	C	T	2	4	6	0	1	7	0	0
24	37654952	.	A	C	5	3	8	0	0	8	0	0
24	37657713	.	C	T	0	2	2	0	0	2	0	0
24	37657719	.	C	T	1	2	3	0	0	3	0	0
24	37657923	.	C	T	1	2	3	0	0	3	0	0
24	37657974	.	T	C	3	3	6	0	0	6	0	0
24	37661521	.	C	A	1	2	3	0	0	3	0	0
24	37661949	.	C	T	3	2	5	0	0	5	0	0
24	37661996	.	C	T	3	1	4	0	1	5	0	0
24	37661999	.	G	A	2	2	4	0	0	4	0	0
24	37681556	.	G	T	1	2	3	0	0	3	0	0
24	37685942	.	C	T	0	5	5	0	6	11	0	0
24	37688804	.	C	T	22	18	40	0	0	40	0	0
24	37688810	.	A	C	25	20	45	0	0	45	0	0
24	37689919	.	T	C	27	34	61	0	1	62	0	0
24	37692529	.	G	A	38	27	65	0	0	65	0	0
24	37696427	.	G	A	6	5	11	0	0	11	0	0
24	37700263	.	A	G	2	2	4	0	0	4	0	0
24	37702758	.	G	A	1	6	7	0	3	10	0	0
24	37705685	.	C	G	4	0	4	0	3	7	0	0
24	37708017	.	T	C	5	4	9	0	0	9	0	0
24	37709278	.	G	A	4	2	6	0	0	6	0	0
24	37722115	.	T	C	6	4	10	0	0	10	0	0
24	37722127	.	C	A	5	4	9	0	1	10	0	0
24	37722245	.	T	C	5	2	7	0	1	8	0	0
24	37722247	.	T	G	2	5	7	0	1	8	0	0
24	37722412	.	A	G	3	4	7	0	0	7	0	0
24	37722702	.	C	A	1	2	3	0	0	3	0	0
24	37722743	.	T	A	2	3	5	0	0	5	0	0
24	37722747	.	A	G	3	2	5	0	0	5	0	0
24	37723110	.	C	T	3	7	10	0	2	12	0	0
24	37723574	.	T	C	2	3	5	0	0	5	0	0
24	37724164	.	C	A	6	3	9	0	0	9	0	0
24	37724550	.	G	A	3	4	7	0	0	7	0	0
24	37724881	.	T	C	4	6	10	0	0	10	0	0
24	37725117	.	T	C	7	5	12	0	1	13	0	0
24	37725179	.	T	A	5	7	12	0	0	12	0	0
24	37725286	.	G	T	0	7	7	0	9	16	0	0
24	37725423	.	G	C	4	10	14	1	0	15	0	0
24	37725593	.	C	T	2	5	7	0	0	7	0	0
24	37726004	.	G	A	5	8	13	0	0	13	0	0
24	37726022	.	A	G	5	0	5	0	8	13	0	0
24	37726329	.	C	T	8	5	13	1	2	16	0	0
24	37726367	.	C	T	5	6	11	0	0	11	0	0
24	37726377	.	A	G	6	4	10	0	1	11	0	0
24	37726453	.	A	G	6	0	6	0	6	12	0	0
24	37726475	.	C	T	6	8	14	0	0	14	0	0
24	37726562	.	C	A	5	9	14	0	1	15	0	0
24	37726598	.	A	G	14	5	19	0	1	20	0	0
24	37726649	.	G	A	0	7	7	0	6	13	0	0
24	37726763	.	A	T	5	6	11	0	1	12	0	0
24	37726867	.	C	G	6	5	11	0	2	13	0	0
24	37726991	.	C	T	4	8	12	0	1	13	0	0
24	37727272	.	C	A	13	7	20	0	2	22	0	0
24	37746094	.	G	A	0	7	7	0	8	15	0	0
24	37767077	.	C	T	9	6	15	0	0	15	0	0
24	37781446	.	C	T	12	9	21	0	0	21	0	0
24	37786365	.	C	T	11	12	23	0	0	23	0	0
24	37788853	.	G	A	15	12	27	0	1	28	0	0
24	37793276	.	C	A	9	14	23	0	1	24	0	0
24	37793282	.	C	T	10	16	26	0	1	27	0	0
24	37793315	.	C	T	9	15	24	0	1	25	0	0
24	37793725	.	C	T	8	13	21	0	0	21	0	0
24	37800148	.	G	A	5	3	8	0	0	8	0	0
24	37802311	.	T	A	1	4	5	0	0	5	0	0
24	37804855	.	G	A	0	2	2	0	1	3	0	0
24	37813474	.	G	T	3	5	8	0	1	9	0	0
24	37815037	.	G	A	1	4	5	0	0	5	0	0
24	37818511	.	G	A	7	5	12	0	0	12	0	0
24	37822250	.	A	G	1	10	11	0	0	11	0	0
24	37829270	.	A	T	0	3	3	0	1	4	0	0
24	37829278	.	C	T	1	2	3	0	0	3	0	0
24	37830689	.	T	A	3	3	6	0	0	6	0	0
24	37833539	.	G	T	1	2	3	0	5	8	0	0
24	37895022	.	C	T	2	3	5	0	0	5	0	0
24	37897208	.	G	C	1	2	3	0	0	3	0	0
24	37901014	.	A	G	5	3	8	0	0	8	0	0
24	37901035	.	T	G	6	4	10	0	0	10	0	0
24	37901114	.	A	G	3	2	5	0	0	5	0	0
24	37901178	.	C	T	3	5	8	0	0	8	0	0
24	37919753	.	T	G	2	2	4	0	0	4	0	0
24	37920255	.	T	G	1	3	4	0	0	4	0	0
24	37941862	.	C	T	1	7	8	0	3	11	0	0
24	37941922	.	A	C	10	6	16	0	0	16	0	0
24	37941958	.	A	G	8	11	19	0	0	19	0	0
24	37942032	.	C	T	11	5	16	0	0	16	0	0
24	37942183	.	A	T	2	4	6	0	0	6	0	0
24	37942323	.	C	T	0	7	7	0	3	10	0	0
24	37942359	.	G	A	4	4	8	0	0	8	0	0
24	37942406	.	T	C	3	4	7	0	0	7	0	0
24	37942559	.	C	T	6	2	8	0	0	8	0	0
24	37942866	.	C	A	4	2	6	0	0	6	0	0
24	37943005	.	T	A	3	3	6	0	0	6	0	0
24	37943012	.	A	G	4	3	7	0	0	7	0	0
24	37943052	.	A	G	2	4	6	0	0	6	0	0
24	37943666	.	T	C	2	3	5	0	0	5	0	0
24	37943767	.	C	T	0	2	2	0	4	6	0	0
24	37943803	.	A	G	1	3	4	0	0	4	0	0
24	38073271	.	G	A	24	20	44	0	5	49	0	0
24	38073319	.	G	A	34	26	60	0	0	60	0	0
24	38073502	.	G	C	34	27	61	0	1	62	0	0
24	38073511	.	G	A	31	27	58	0	2	60	0	0
24	38073655	.	A	G	22	21	43	0	4	47	0	0
24	38073688	.	G	A	27	24	51	0	1	52	0	0
24	38073712	.	C	T	25	27	52	0	0	52	0	0
24	38073793	.	G	A	25	30	55	0	0	55	0	0
24	38163638	.	A	T	2	2	4	0	0	4	0	0
24	38166248	.	T	C	3	3	6	0	0	6	0	0
24	38174842	.	C	T	3	3	6	0	0	6	0	0
24	38180213	.	G	A	0	8	8	0	5	13	0	0
24	38180221	.	C	A	8	4	12	0	0	12	0	0
24	38184900	.	G	A	11	4	15	0	0	15	0	0
24	38187862	.	T	C	3	4	7	0	0	7	0	0
24	38187937	.	T	C	5	3	8	0	1	9	0	0
24	38188084	.	T	C	2	2	4	0	0	4	0	0
24	38188149	.	G	A	0	5	5	0	3	8	0	0
24	38188361	.	G	A	6	2	8	0	1	9	0	0
24	38188388	.	C	A	6	4	10	0	0	10	0	0
24	38188416	.	C	G	5	3	8	0	0	8	0	0
24	38189350	.	T	C	3	3	6	0	0	6	0	0
24	38189475	.	G	C	4	2	6	0	0	6	0	0
24	38189498	.	G	A	1	2	3	0	3	6	0	0
24	38189957	.	G	A	2	7	9	0	1	10	0	0
24	38189988	.	T	C	4	5	9	0	0	9	0	0
24	38190160	.	T	A	5	2	7	1	0	8	0	0
24	38190172	.	G	A	1	2	3	2	3	8	0	0
24	38190933	.	G	A	0	3	3	0	2	5	0	0
24	38191443	.	G	C	1	3	4	0	0	4	0	0
24	38191643	.	A	G	2	2	4	0	0	4	0	0
24	38191841	.	C	T	1	2	3	0	1	4	0	0
24	38191900	.	A	G	1	2	3	0	0	3	0	0
24	38369559	.	T	A	29	15	44	0	3	47	0	0
24	38369819	.	A	G	30	21	51	0	1	52	0	0
24	38369873	.	G	A	22	26	48	0	4	52	0	0
24	38370188	.	A	G	20	18	38	0	0	38	0	0
24	38370325	.	A	G	16	19	35	0	3	38	0	0
24	38370404	.	T	A	21	17	38	0	0	38	0	0
24	38370518	.	C	T	19	15	34	0	3	37	0	0
24	38370796	.	T	G	8	12	20	0	0	20	0	0
24	38370998	.	A	G	15	17	32	0	0	32	0	0
24	38371178	.	A	G	15	9	24	0	1	25	0	0
24	38374684	.	G	A	16	11	27	0	2	29	0	0
24	38384245	.	A	T	8	9	17	0	0	17	0	0
24	38558011	.	C	T	1	2	3	0	0	3	0	0
24	38568118	.	T	A	1	2	3	0	0	3	0	0
24	38618802	.	G	A	1	2	3	0	0	3	0	0
24	38619152	.	C	T	1	3	4	0	0	4	0	0
24	38644847	.	A	G	2	4	6	0	0	6	0	0
24	38816010	.	G	T	8	5	13	0	0	13	0	0
24	38816184	.	T	G	2	2	4	0	0	4	0	0
24	38816340	.	T	G	3	4	7	0	0	7	0	0
24	39051042	.	T	C	7	12	19	0	0	19	0	0
24	39051114	.	A	G	9	0	9	0	6	15	0	0
24	39051612	.	T	C	5	3	8	0	2	10	0	0
24	39051692	.	G	C	13	12	25	0	1	26	0	0
24	39051981	.	G	A	1	7	8	0	10	18	0	0
24	39052117	.	T	C	8	11	19	0	0	19	0	0
24	39052125	.	A	G	10	8	18	0	0	18	0	0
24	39052200	.	C	T	6	8	14	0	1	15	0	0
24	39052302	.	G	A	10	9	19	0	0	19	0	0
24	39052386	.	A	G	8	6	14	0	2	16	0	0
24	39052410	.	C	T	6	4	10	0	1	11	0	0
24	39064643	.	T	C	5	10	15	0	0	15	0	0
24	39064719	.	T	C	5	6	11	0	0	11	0	0
24	39065822	.	A	G	5	0	5	0	6	11	0	0
24	39065978	.	T	C	6	5	11	0	0	11	0	0
24	39075534	.	T	C	10	6	16	0	2	18	0	0
24	39136940	.	A	C	7	7	14	0	0	14	0	0
24	39137015	.	C	T	7	14	21	0	0	21	0	0
24	39137027	.	G	C	7	13	20	0	0	20	0	0
24	39137165	.	A	G	5	11	16	0	5	21	0	0
24	39147852	.	A	G	17	13	30	0	0	30	0	0
24	39147871	.	A	G	13	0	13	0	16	29	0	0
24	39150853	.	C	G	11	0	11	0	9	20	0	0
24	39150946	.	T	C	6	12	18	0	0	18	0	0
24	39150975	.	G	T	4	16	20	0	0	20	0	0
24	39151004	.	A	T	7	18	25	0	0	25	0	0
24	39151040	.	C	T	14	14	28	0	0	28	0	0
24	39151067	.	A	G	3	0	3	0	16	19	0	0
24	39151075	.	A	G	4	15	19	0	1	20	0	0
24	39151301	.	A	C	12	10	22	0	0	22	0	0
24	39151343	.	G	A	11	11	22	0	1	23	0	0
24	39151467	.	T	C	13	10	23	0	0	23	0	0
24	39151637	.	G	C	25	10	35	0	0	35	0	0
24	39151675	.	T	C	20	7	27	0	1	28	0	0
24	39151725	.	C	T	14	18	32	0	0	32	0	0
24	39151727	.	T	C	14	18	32	0	0	32	0	0
24	39151796	.	A	G	5	7	12	0	0	12	0	0
24	39151989	.	A	G	22	5	27	0	0	27	0	0
24	39152001	.	A	G	16	10	26	0	0	26	0	0
24	39152077	.	C	G	5	9	14	0	1	15	0	0
24	39152452	.	A	G	1	0	1	0	4	5	0	0
24	39152504	.	A	G	1	10	11	0	0	11	0	0
24	39152523	.	A	G	7	6	13	0	1	14	0	0
24	39152564	.	A	T	8	4	12	0	0	12	0	0
24	39152917	.	G	A	11	5	16	0	0	16	0	0
24	39153817	.	G	A	10	11	21	1	0	22	0	0
24	39153995	.	A	G	10	10	20	0	0	20	0	0
24	39154001	.	C	T	10	12	22	0	0	22	0	0
24	39154044	.	G	A	16	13	29	0	1	30	0	0
24	39154315	.	C	T	14	25	39	0	2	41	0	0
24	39154551	.	C	A	12	15	27	0	0	27	0	0
24	39154620	.	C	T	11	15	26	0	0	26	0	0
24	39154865	.	C	A	7	7	14	0	0	14	0	0
24	39154892	.	T	G	7	4	11	0	0	11	0	0
24	39172141	.	T	C	39	31	70	0	3	73	0	0
24	39172222	.	A	G	37	36	73	0	0	73	0	0
24	39174437	.	T	C	35	44	79	0	0	79	0	0
24	39174570	.	C	T	38	35	73	0	3	76	0	0
24	39175002	.	A	C	31	17	48	0	6	54	0	0
24	39175044	.	A	G	36	30	66	0	1	67	0	0
24	39175047	.	T	C	34	30	64	0	2	66	0	0
24	39175083	.	C	G	31	26	57	0	4	61	0	0
24	39175109	.	T	A	37	28	65	0	1	66	0	0
24	39175143	.	C	T	29	37	66	0	5	71	0	0
24	39175207	.	A	G	40	2	42	0	31	73	0	0
24	39178484	.	C	G	2	1	3	0	1	4	0	0
24	39178516	.	T	G	1	4	5	0	0	5	0	0
24	39178591	.	C	A	0	5	5	0	3	8	0	0
24	39178627	.	C	A	1	4	5	0	5	10	0	0
24	39182404	.	G	A	8	5	13	0	1	14	0	0
24	39182676	.	G	A	9	6	15	0	0	15	0	0
24	39184715	.	T	C	5	6	11	0	1	12	0	0
24	39268891	.	A	G	17	21	38	0	0	38	0	0
24	39274786	.	C	A	10	12	22	0	2	24	0	0
24	39274821	.	A	G	8	11	19	0	3	22	0	0
24	39277575	.	C	G	18	9	27	0	0	27	0	0
24	39277581	.	T	A	16	9	25	0	2	27	0	0
24	39309684	.	A	G	23	0	23	0	16	39	0	0
24	39309698	.	T	G	14	1	15	0	20	35	0	0
24	39310061	.	A	G	14	12	26	0	2	28	0	0
24	39310129	.	G	A	17	8	25	0	1	26	0	0
24	39310163	.	G	T	9	11	20	0	1	22	1	0
24	39322945	.	G	T	3	24	27	0	21	48	0	0
24	39323791	.	C	T	23	32	55	0	2	57	0	0
24	39333916	.	C	T	19	24	43	0	1	44	0	0
24	39333972	.	A	C	24	23	47	0	1	48	0	0
24	39334054	.	A	G	24	17	41	0	1	42	0	0
24	39334187	.	G	A	3	17	20	0	21	41	0	0
24	39334388	.	A	G	30	24	54	0	2	56	0	0
24	39334400	.	G	A	1	28	29	0	30	59	0	0
24	39353603	.	C	A	0	3	3	0	1	4	0	0
24	39353867	.	G	A	2	3	5	0	0	5	0	0
24	39353885	.	T	C	1	2	3	0	0	3	0	0
24	39510079	.	C	T	1	2	3	0	0	3	0	0
24	39510108	.	T	C	1	3	4	0	0	4	0	0
24	39510651	.	T	C	2	2	4	0	0	4	0	0
24	39510668	.	T	A	1	3	4	0	0	4	0	0
24	39510694	.	G	T	1	2	3	0	0	3	0	0
24	39510891	.	T	C	3	5	8	0	0	8	0	0
24	39511157	.	G	A	4	6	10	0	0	10	0	0
24	39511374	.	A	G	3	2	5	0	0	5	0	0
24	39511382	.	G	T	3	2	5	0	0	5	0	0
24	39514056	.	T	C	3	12	15	0	0	15	0	0
24	39514296	.	C	G	10	6	16	0	0	16	0	0
24	39518841	.	T	C	6	9	15	0	0	15	0	0
24	39530034	.	G	A	0	6	6	0	7	13	0	0
24	39533337	.	A	G	6	9	15	0	0	15	0	0
24	39533987	.	T	A	3	7	10	0	2	12	0	0
24	39537605	.	C	T	5	8	13	0	0	13	0	0
24	39544398	.	G	A	4	2	6	0	0	6	0	0
24	39549379	.	C	T	2	4	6	0	0	6	0	0
24	39549427	.	A	G	2	0	2	0	9	11	0	0
24	39556276	.	G	T	1	5	6	0	5	11	0	0
24	39556324	.	G	A	6	6	12	0	0	12	0	0
24	39556760	.	G	A	1	4	5	0	5	10	0	0
24	39559205	.	T	C	5	2	7	0	0	7	0	0
24	39559345	.	A	G	8	0	8	0	5	13	0	0
24	39559356	.	C	T	5	6	11	0	1	12	0	0
24	39559386	.	G	A	6	9	15	0	1	16	0	0
24	39576071	.	A	T	5	5	10	0	0	10	0	0
24	39576247	.	C	T	5	6	11	0	0	11	0	0
24	39576414	.	C	T	3	4	7	0	1	9	1	0
24	39579569	.	G	A	8	3	11	0	1	12	0	0
24	39579730	.	A	G	8	4	12	0	0	12	0	0
24	39579989	.	G	A	2	8	10	0	9	19	0	0
24	39586778	.	A	T	6	7	13	0	1	14	0	0
24	39587369	.	C	G	9	5	14	0	1	15	0	0
24	39593009	.	T	C	2	7	9	0	0	9	0	0
24	39593038	.	G	A	0	5	5	0	4	9	0	0
24	39595866	.	A	C	3	10	13	0	0	13	0	0
24	39606237	.	G	A	24	21	45	0	3	48	0	0
24	39610535	.	G	T	19	11	30	0	0	30	0	0
24	39615584	.	C	G	8	3	11	2	1	14	0	0
24	39616170	.	C	A	4	2	6	0	0	6	0	0
24	39620479	.	T	C	1	0	1	0	2	3	0	0
24	39625539	.	T	C	1	1	2	0	1	3	0	0
24	39628474	.	G	A	1	3	4	0	0	4	0	0
24	39632991	.	G	T	1	4	5	0	0	5	0	0
24	39633018	.	C	T	1	5	6	0	0	6	0	0
24	39638642	.	G	A	24	18	42	0	0	42	0	0
24	39642072	.	A	T	10	10	20	1	1	23	1	0
24	39642220	.	A	G	7	6	13	0	1	14	0	0
24	39642229	.	A	G	9	7	16	0	0	16	0	0
24	39642336	.	C	A	10	10	20	1	0	21	0	0
24	39642361	.	G	T	12	12	24	0	1	25	0	0
24	39644259	.	T	C	20	14	34	0	2	36	0	0
24	39646762	.	C	T	22	19	41	0	1	42	0	0
24	39647021	.	C	T	16	20	36	0	0	36	0	0
24	39647042	.	G	C	25	16	41	0	0	41	0	0
24	39648806	.	C	T	27	20	47	0	1	48	0	0
24	39651567	.	T	G	19	28	47	0	3	50	0	0
24	39651612	.	A	T	18	26	44	0	4	49	1	0
24	39653626	.	G	A	29	18	47	14	2	63	0	0
24	39660219	.	C	T	13	16	29	0	1	30	0	0
24	39661890	.	T	A	18	13	31	0	1	32	0	0
24	39661905	.	C	T	18	8	26	0	1	27	0	0
24	39662074	.	T	C	14	15	29	0	0	29	0	0
24	39663197	.	A	G	10	14	24	0	2	26	0	0
24	39667348	.	T	C	11	8	19	3	0	22	0	0
24	39742273	.	G	A	10	9	19	0	0	19	0	0
24	39742396	.	G	A	7	11	18	0	0	18	0	0
24	39742786	.	T	A	6	8	14	0	0	14	0	0
24	39742869	.	G	T	11	8	19	0	0	19	0	0
24	39771659	.	G	T	13	7	20	0	0	20	0	0
24	39771976	.	G	A	11	4	15	0	0	15	0	0
24	39771983	.	A	G	11	4	15	0	1	16	0	0
24	39778970	.	C	T	2	2	4	0	0	4	0	0
24	39778982	.	C	G	3	2	5	0	0	5	0	0
24	39779108	.	G	T	2	2	4	0	0	4	0	0
24	39779637	.	A	G	6	3	9	0	0	9	0	0
24	39787653	.	G	C	4	0	4	0	3	7	0	0
24	39792961	.	C	T	0	2	2	0	1	3	0	0
24	40001698	.	C	T	3	4	7	0	0	7	0	0
24	40001802	.	C	T	0	4	4	1	5	10	0	0
24	40004620	.	G	A	4	4	8	0	1	9	0	0
24	40004839	.	A	G	5	4	9	0	0	9	0	0
24	40006620	.	G	T	4	4	8	0	1	9	0	0
24	40006905	.	G	T	4	5	9	0	0	9	0	0
24	40006932	.	G	A	3	3	6	0	0	6	0	0
24	40007220	.	T	A	7	3	10	0	0	10	0	0
24	40007583	.	T	C	2	0	2	0	5	7	0	0
24	40141393	.	C	T	1	2	3	0	0	3	0	0
24	40141410	.	A	C	1	2	3	0	1	4	0	0
24	40156163	.	G	A	3	3	6	0	3	9	0	0
24	40156272	.	C	A	5	3	8	0	0	8	0	0
24	40156345	.	T	G	3	0	3	0	6	9	0	0
24	40156350	.	A	G	3	0	3	0	5	8	0	0
24	40171381	.	C	A	1	2	3	0	0	3	0	0
24	40475179	.	C	T	3	3	6	0	0	6	0	0
24	40475221	.	C	T	3	3	6	1	0	7	0	0
24	40495532	.	T	C	5	3	8	0	1	9	0	0
24	40495574	.	C	G	3	2	5	0	0	5	0	0
24	40498585	.	T	C	4	6	10	0	0	10	0	0
24	41259381	.	C	G	0	2	2	0	1	3	0	0
24	41273330	.	A	G	4	0	4	0	6	10	0	0
24	41281276	.	T	G	4	0	4	1	4	9	0	0
24	41281297	.	T	C	5	7	12	1	1	14	0	0
24	41283316	.	C	T	2	3	5	0	0	5	0	0
24	41283323	.	A	C	3	2	5	0	0	5	0	0
24	41288031	.	G	A	2	2	4	0	0	4	0	0
24	41290550	.	G	A	2	6	8	0	0	8	0	0
24	41290712	.	C	T	6	8	14	0	1	15	0	0
24	41293409	.	G	A	4	10	14	0	0	14	0	0
24	41317090	.	A	T	26	5	31	0	7	38	0	0
24	41317132	.	G	A	16	7	23	2	0	25	0	0
24	41473576	.	T	C	10	0	10	0	9	19	0	0
24	41473618	.	G	A	16	5	21	0	1	22	0	0
24	41473627	.	G	A	16	5	21	0	0	21	0	0
24	41478831	.	C	T	14	10	24	0	2	26	0	0
24	41560116	.	G	C	12	6	18	0	0	18	0	0
24	41560146	.	G	A	14	4	18	0	4	22	0	0
24	41737212	.	G	A	0	2	2	0	6	8	0	0
24	41738508	.	C	G	3	0	3	0	1	4	0	0
24	41738523	.	G	A	1	3	4	0	0	4	0	0
24	41738882	.	G	A	1	3	4	0	0	4	0	0
24	41742858	.	G	C	7	2	9	0	0	9	0	0
24	41745445	.	G	A	2	2	4	1	1	6	0	0
24	41747414	.	C	T	4	4	8	0	0	8	0	0
24	41751347	.	A	C	2	1	3	0	0	3	0	0
24	41751368	.	G	A	0	2	2	0	2	4	0	0
24	41757521	.	A	G	1	0	1	0	8	9	0	0
24	41757522	.	C	G	0	7	7	0	1	8	0	0
24	41757941	.	C	A	1	5	6	0	0	6	0	0
24	41764121	.	G	A	0	4	4	0	1	5	0	0
24	41770645	.	A	G	8	0	8	0	4	12	0	0
24	41773216	.	G	C	0	6	6	0	4	10	0	0
24	41773287	.	A	T	5	8	13	0	1	14	0	0
24	41773318	.	C	T	9	5	14	0	0	14	0	0
24	41783906	.	G	A	0	11	11	0	7	18	0	0
24	41783999	.	C	T	2	10	12	0	0	12	0	0
24	41916447	.	G	T	9	9	18	0	0	18	0	0
24	41916584	.	G	A	9	11	20	0	0	20	0	0
24	41916677	.	A	G	9	0	9	0	6	15	0	0
24	41916887	.	G	A	5	14	19	0	0	19	0	0
24	41917543	.	T	C	8	8	16	0	1	17	0	0
24	41953649	.	T	G	30	22	52	1	0	53	0	0
24	41954745	.	A	G	12	2	14	0	11	25	0	0
24	41954764	.	A	C	14	11	25	0	2	27	0	0
24	41954781	.	C	T	16	12	28	0	0	28	0	0
24	41964613	.	A	C	18	11	29	0	1	30	0	0
24	41965111	.	G	A	14	14	28	0	3	31	0	0
24	41965147	.	T	C	19	15	34	0	0	34	0	0
24	41969781	.	C	A	27	16	43	0	1	44	0	0
24	41972519	.	A	G	20	16	36	0	1	37	0	0
24	41972633	.	C	G	28	1	29	0	17	46	0	0
24	41972638	.	A	T	24	17	41	0	3	45	1	0
24	41974769	.	C	T	16	17	33	0	1	34	0	0
24	41981865	.	A	G	28	20	48	0	1	49	0	0
24	41986626	.	G	C	2	14	16	0	14	30	0	0
24	41986704	.	C	T	21	16	37	0	0	37	0	0
24	41989196	.	A	C	3	7	10	0	1	11	0	0
24	41989416	.	C	G	10	3	13	0	0	13	0	0
24	41989455	.	C	T	8	5	13	0	2	15	0	0
24	41990626	.	A	T	7	9	16	0	1	17	0	0
24	41990821	.	G	A	3	5	8	0	11	19	0	0
24	41994096	.	G	A	4	6	10	0	0	10	0	0
24	41994147	.	G	T	9	13	22	0	0	22	0	0
24	42061369	.	C	T	11	9	20	0	0	20	0	0
24	42061423	.	G	T	9	8	17	0	1	18	0	0
24	42061426	.	G	A	8	8	16	0	1	17	0	0
24	42061460	.	A	G	6	7	13	0	3	16	0	0
24	42083876	.	A	G	24	13	37	0	1	38	0	0
24	42133270	.	G	A	3	16	19	9	6	34	0	0
24	42133646	.	C	T	14	9	23	3	0	26	0	0
24	42138533	.	A	G	17	1	18	0	21	39	0	0
24	42141461	.	T	C	6	0	6	0	3	9	0	0
24	42141605	.	G	A	9	6	15	0	0	15	0	0
24	42141770	.	T	C	15	7	22	0	2	24	0	0
24	42153241	.	A	G	13	11	24	0	1	25	0	0
24	42155187	.	T	C	11	13	24	0	1	25	0	0
25	13978	.	C	T	14	25	39	0	1	40	0	0
25	14095	.	C	T	7	12	19	0	0	19	0	0
25	14101	.	C	T	12	7	19	0	0	19	0	0
25	15524	.	C	T	17	9	26	0	1	27	0	0
25	15704	.	C	T	15	20	35	0	1	36	0	0
25	127734	.	A	G	14	9	23	0	1	24	0	0
25	127770	.	G	T	0	10	10	0	13	23	0	0
25	136788	.	T	C	11	18	29	0	0	29	0	0
25	137033	.	C	T	10	6	16	1	9	26	0	0
25	137064	.	G	A	1	5	6	2	12	20	0	0
25	137128	.	G	A	1	18	19	1	22	42	0	0
25	137492	.	C	A	9	9	18	4	2	24	0	0
25	146159	.	G	A	3	32	35	0	25	60	0	0
25	146198	.	C	T	33	23	56	0	0	56	0	0
25	146237	.	G	A	31	17	48	0	3	51	0	0
25	146735	.	C	G	24	31	55	0	2	57	0	0
25	146778	.	C	T	30	14	44	0	2	46	0	0
25	146918	.	G	A	22	21	43	0	1	44	0	0
25	154392	.	T	C	14	11	25	0	0	25	0	0
25	154440	.	C	T	16	14	30	0	1	31	0	0
25	157142	.	C	A	22	1	23	0	2	25	0	0
25	158958	.	C	T	18	8	26	0	4	30	0	0
25	159510	.	C	T	18	11	29	0	2	31	0	0
25	160490	.	C	T	23	14	37	0	2	39	0	0
25	196495	.	T	C	31	24	55	0	6	61	0	0
25	203396	.	T	C	25	24	49	0	6	55	0	0
25	236835	.	G	A	10	6	16	0	0	16	0	0
25	237012	.	G	A	3	5	8	0	0	8	0	0
25	238588	.	A	G	6	3	9	0	1	10	0	0
25	244305	.	G	C	2	3	5	0	0	5	0	0
25	252326	.	C	T	5	3	8	0	0	8	0	0
25	254542	.	G	A	1	7	8	0	9	17	0	0
25	260616	.	C	T	5	3	8	0	1	9	0	0
25	261008	.	C	T	7	13	20	0	0	20	0	0
25	261081	.	G	A	11	3	14	0	0	14	0	0
25	261376	.	G	A	5	8	13	0	3	16	0	0
25	265617	.	G	A	4	5	9	0	0	9	0	0
25	267153	.	G	A	3	2	5	0	0	5	0	0
25	314758	.	T	A	4	6	10	0	0	10	0	0
25	314781	.	A	T	5	5	10	0	0	10	0	0
25	315708	.	T	A	3	3	6	0	0	6	0	0
25	315725	.	G	A	3	2	5	0	1	6	0	0
25	317221	.	C	T	1	2	3	0	3	6	0	0
25	325130	.	G	T	2	2	4	0	0	4	0	0
25	399657	.	G	A	1	6	7	0	0	7	0	0
25	1635498	.	A	C	8	0	8	0	5	13	0	0
25	1635505	.	T	G	6	0	6	0	7	13	0	0
25	2702880	.	A	T	2	3	5	0	0	5	0	0
25	2707168	.	T	C	1	5	6	0	0	6	0	0
25	2707178	.	T	C	1	3	4	0	1	5	0	0
25	3245895	.	A	G	12	9	21	0	0	21	0	0
25	3881306	.	A	G	3	3	6	0	0	6	0	0
25	3881331	.	A	G	3	3	6	0	0	6	0	0
25	3881346	.	A	G	2	2	4	0	0	4	0	0
25	4689362	.	A	G	1	2	3	0	0	3	0	0
25	4689513	.	A	G	5	0	5	0	2	7	0	0
25	4689573	.	A	G	2	2	4	0	0	4	0	0
25	4689688	.	A	G	2	2	4	0	0	4	0	0
25	4850989	.	G	A	3	36	39	0	0	39	0	0
25	4977289	.	C	T	1	5	6	0	1	7	0	0
25	5652363	.	A	T	2	1	3	0	4	7	0	0
25	5940030	.	T	G	2	2	4	0	4	8	0	0
25	6403852	.	T	C	3	8	11	0	0	11	0	0
25	6403853	.	T	C	7	4	11	0	0	11	0	0
25	7229255	.	T	A	10	11	21	0	3	25	1	0
25	7229462	.	A	C	8	8	16	0	0	16	0	0
25	7230239	.	T	C	8	14	22	0	1	23	0	0
25	7324580	.	C	T	12	14	26	0	1	27	0	0
25	7327718	.	C	T	13	17	30	0	1	31	0	0
25	7333751	.	G	A	19	11	30	0	0	30	0	0
25	7333841	.	C	T	12	23	35	0	1	36	0	0
25	7334951	.	T	C	21	7	28	1	0	29	0	0
25	7334987	.	G	C	10	19	29	1	0	30	0	0
25	7336096	.	T	A	11	8	19	0	3	22	0	0
25	7398773	.	C	T	1	3	4	0	0	4	0	0
25	7398977	.	C	A	3	6	9	0	1	10	0	0
25	7399684	.	C	T	5	2	7	0	0	7	0	0
25	7399814	.	C	T	3	2	5	0	1	6	0	0
25	7400872	.	T	A	2	6	8	0	2	10	0	0
25	7401054	.	C	T	7	3	10	0	0	10	0	0
25	7401539	.	C	T	4	5	9	0	0	9	0	0
25	7401580	.	A	G	2	4	6	0	0	6	0	0
25	7410399	.	A	G	7	5	12	0	0	12	0	0
25	7410558	.	C	A	6	8	14	0	0	14	0	0
25	7410822	.	G	A	0	2	2	0	5	7	0	0
25	7412640	.	T	G	8	8	16	0	0	16	0	0
25	7412985	.	C	T	7	6	13	0	0	13	0	0
25	7413288	.	T	A	4	5	9	0	0	9	0	0
25	7413501	.	C	T	1	3	4	0	0	4	0	0
25	7413736	.	G	T	3	3	6	0	0	6	0	0
25	7413815	.	G	A	0	3	3	0	5	8	0	0
25	7428932	.	A	C	3	7	10	0	0	10	0	0
25	7428944	.	T	C	3	6	9	0	1	10	0	0
25	7429028	.	C	A	3	2	5	0	0	5	0	0
25	7431611	.	G	A	2	5	7	0	1	8	0	0
25	7431626	.	T	C	6	4	10	0	0	10	0	0
25	7445927	.	G	C	1	4	5	0	0	5	0	0
25	7445962	.	G	A	2	3	5	0	0	5	0	0
25	7446435	.	T	C	3	2	5	0	0	5	0	0
25	7451133	.	C	A	6	2	8	0	0	8	0	0
25	7454578	.	T	C	10	4	14	0	0	14	0	0
25	7456535	.	C	A	3	7	10	0	2	12	0	0
25	7456843	.	G	A	0	5	5	0	3	8	0	0
25	7456860	.	G	A	0	2	2	0	6	9	1	0
25	7477641	.	C	T	16	24	40	0	3	43	0	0
25	7487835	.	G	C	26	18	44	0	5	49	0	0
25	7488407	.	T	C	14	32	46	0	2	48	0	0
25	7488599	.	G	T	20	15	35	1	2	38	0	0
25	7488660	.	C	T	23	9	32	0	1	33	0	0
25	7488812	.	G	A	29	19	48	0	2	50	0	0
25	7488813	.	G	T	30	19	49	0	1	50	0	0
25	7489011	.	A	T	29	26	55	0	2	58	1	0
25	7489034	.	G	A	6	27	33	0	25	58	0	0
25	7489197	.	G	T	10	17	27	0	1	28	0	0
25	7492888	.	C	T	8	10	18	0	0	18	0	0
25	7492927	.	T	A	6	9	15	0	0	15	0	0
25	7494243	.	G	A	2	17	19	0	4	23	0	0
25	7496003	.	C	T	11	8	19	0	3	22	0	0
25	7496021	.	C	T	15	9	24	0	3	27	0	0
25	7496039	.	C	T	10	9	19	0	2	21	0	0
25	7496992	.	G	C	1	12	13	0	9	22	0	0
25	7500473	.	T	C	14	20	34	0	1	35	0	0
25	7501997	.	G	A	5	13	18	0	0	18	0	0
25	7502022	.	G	C	14	10	24	0	0	24	0	0
25	7502119	.	T	C	9	6	15	0	0	15	0	0
25	7502241	.	G	A	5	3	8	0	1	9	0	0
25	7533220	.	T	C	4	5	9	0	0	9	0	0
25	7533559	.	G	C	4	3	7	0	3	10	0	0
25	7549175	.	G	A	2	6	8	0	1	9	0	0
25	7549339	.	G	C	0	5	5	0	5	10	0	0
25	7678424	.	T	C	2	15	17	0	0	17	0	0
25	7890351	.	T	C	5	3	8	0	1	9	0	0
25	7890372	.	T	C	3	4	7	0	0	7	0	0
25	7890814	.	T	C	2	2	4	0	0	4	0	0
25	7891836	.	T	C	2	6	8	0	0	8	0	0
25	7892019	.	T	C	4	1	5	0	1	6	0	0
25	8183761	.	T	C	0	0	0	0	2	2	0	0
25	8183770	.	T	C	1	0	1	0	1	2	0	0
25	8627943	.	T	C	3	4	7	0	0	7	0	0
25	8665979	.	A	C	3	9	12	0	1	13	0	0
25	9678666	.	G	A	5	12	17	0	0	17	0	0
25	9679242	.	G	A	18	11	29	0	4	33	0	0
25	9679389	.	G	A	12	15	27	0	0	27	0	0
25	9679413	.	C	T	2	15	17	0	8	25	0	0
25	9679539	.	T	C	5	8	13	0	0	13	0	0
25	9680022	.	T	C	11	5	16	0	0	16	0	0
25	9680196	.	T	A	9	6	15	0	0	15	0	0
25	9680448	.	A	G	8	9	17	0	1	18	0	0
25	9805253	.	G	C	9	12	21	0	0	21	0	0
25	9805257	.	G	C	8	13	21	0	0	21	0	0
25	11307394	.	A	T	2	2	4	0	0	4	0	0
25	11538805	.	T	C	1	1	2	0	1	3	0	0
25	11540401	.	G	A	2	3	5	0	0	5	0	0
25	11796531	.	T	C	11	0	11	0	10	21	0	0
25	11796579	.	T	A	20	14	34	0	0	34	0	0
25	11796728	.	A	T	12	16	28	1	1	30	0	0
25	11796860	.	T	C	17	9	26	0	1	27	0	0
25	11796973	.	T	C	8	0	8	0	15	23	0	0
25	11796987	.	A	G	10	12	22	0	1	23	0	0
25	11797056	.	G	C	7	3	10	0	0	10	0	0
25	11797515	.	A	G	12	11	23	0	0	23	0	0
25	11797550	.	G	T	13	6	19	0	0	19	0	0
25	11797789	.	A	T	3	8	11	1	0	12	0	0
25	11797912	.	T	A	3	8	11	1	0	12	0	0
25	11797979	.	A	G	3	6	9	0	0	9	0	0
25	11797990	.	A	G	4	5	9	0	0	9	0	0
25	11798081	.	T	C	7	0	7	0	6	13	0	0
25	11798215	.	A	C	11	10	21	0	2	23	0	0
25	11798227	.	T	A	11	7	18	0	1	19	0	0
25	11798333	.	A	T	4	8	12	1	0	13	0	0
25	11798381	.	T	A	9	14	23	0	0	23	0	0
25	11798509	.	A	T	6	10	16	0	2	18	0	0
25	11798511	.	C	A	0	11	11	0	6	17	0	0
25	11798598	.	C	T	2	5	7	0	1	8	0	0
25	11798659	.	A	T	4	4	8	0	1	9	0	0
25	11798863	.	G	C	3	2	5	0	0	5	0	0
25	11798922	.	A	G	8	5	13	0	1	14	0	0
25	11799527	.	A	T	10	7	17	1	2	20	0	0
25	11799577	.	G	A	10	6	16	1	0	17	0	0
25	11799625	.	A	T	8	7	15	0	2	17	0	0
25	11799670	.	G	T	7	8	15	1	0	16	0	0
25	11799685	.	A	G	9	5	14	1	1	16	0	0
25	11800098	.	G	C	10	13	23	0	0	23	0	0
25	11800140	.	A	G	13	6	19	0	0	19	0	0
25	11800319	.	T	G	1	5	6	0	0	6	0	0
25	11800328	.	C	T	0	5	5	0	1	6	0	0
25	11800358	.	C	A	3	4	7	0	0	7	0	0
25	11800522	.	G	A	11	11	22	0	1	23	0	0
25	11800652	.	C	T	1	9	10	0	8	18	0	0
25	11800883	.	C	T	9	5	14	0	1	15	0	0
25	11801111	.	C	A	1	2	3	0	1	4	0	0
25	11801513	.	A	C	7	4	11	0	0	11	0	0
25	11801642	.	C	G	8	11	19	0	0	19	0	0
25	11801731	.	C	G	5	9	14	0	0	14	0	0
25	11801838	.	A	C	10	0	10	0	5	15	0	0
25	11801841	.	G	T	9	4	13	0	1	14	0	0
25	11802066	.	C	G	1	6	7	0	0	7	0	0
25	11802115	.	C	A	5	7	12	0	0	12	0	0
25	11802192	.	T	A	7	11	18	0	0	18	0	0
25	11802306	.	C	A	1	12	13	0	9	22	0	0
25	11802485	.	C	T	0	11	11	0	16	27	0	0
25	11803455	.	G	T	8	11	19	0	0	19	0	0
25	11803467	.	A	T	8	8	16	0	0	16	0	0
25	11803813	.	T	A	2	2	4	0	0	4	0	0
25	11803817	.	A	T	1	2	3	0	0	3	0	0
25	11803850	.	T	G	2	2	4	0	0	4	0	0
25	11803996	.	A	C	1	3	4	0	0	4	0	0
25	11804128	.	A	G	2	4	6	0	0	6	0	0
25	11804330	.	C	G	0	2	2	0	4	6	0	0
25	11804490	.	T	G	5	3	8	0	0	8	0	0
25	11804688	.	T	G	11	9	20	0	0	20	0	0
25	11804969	.	T	A	4	2	6	0	0	6	0	0
25	11805270	.	C	G	4	4	8	0	0	8	0	0
25	11805675	.	T	A	7	2	9	0	2	11	0	0
25	11806125	.	C	T	2	2	4	0	0	4	0	0
25	11806408	.	C	A	6	6	12	0	0	12	0	0
25	11833526	.	G	A	10	6	16	0	1	17	0	0
25	11844148	.	C	T	3	3	6	0	0	6	0	0
25	12008336	.	A	G	5	5	10	0	1	11	0	0
25	12853211	.	C	T	1	4	5	0	1	6	0	0
25	12853691	.	C	T	10	45	55	0	1	56	0	0
25	12853971	.	T	A	18	27	45	0	1	48	2	0
25	12854112	.	C	T	40	18	58	0	0	58	0	0
25	12854201	.	C	T	22	21	43	2	1	46	0	0
25	12854266	.	A	T	23	17	40	2	2	44	0	0
25	13104333	.	C	A	1	6	7	0	7	14	0	0
25	13104393	.	T	C	8	9	17	0	0	18	1	0
25	13105029	.	A	G	6	3	9	0	0	9	0	0
25	13332531	.	C	T	31	27	58	0	3	61	0	0
25	13332693	.	G	A	25	48	73	0	0	73	0	0
25	13332737	.	A	G	37	37	74	0	8	82	0	0
25	13333027	.	A	G	48	24	72	1	2	75	0	0
25	13333287	.	A	G	28	39	67	0	8	75	0	0
25	13333986	.	T	A	50	28	78	0	0	78	0	0
25	13333994	.	C	T	52	26	78	0	4	82	0	0
25	13334023	.	T	A	49	28	77	0	1	78	0	0
25	13334049	.	A	T	42	31	73	0	1	74	0	0
25	13334061	.	A	G	41	32	73	0	2	75	0	0
25	13334334	.	A	T	38	29	67	0	2	69	0	0
25	13334371	.	T	C	37	27	64	0	3	67	0	0
25	13334397	.	C	G	37	32	69	0	2	71	0	0
25	13334429	.	T	C	32	36	68	0	4	72	0	0
25	13334526	.	A	G	50	18	68	0	2	70	0	0
25	13334537	.	T	C	50	1	51	0	16	67	0	0
25	13334729	.	C	T	48	31	79	0	6	85	0	0
25	13335021	.	G	T	41	32	73	0	1	74	0	0
25	13335059	.	G	C	47	22	69	0	3	73	1	0
25	13335078	.	A	G	45	25	70	0	1	71	0	0
25	13335185	.	A	G	41	30	71	0	4	75	0	0
25	13335225	.	T	C	29	33	62	0	6	68	0	0
25	13335331	.	T	C	26	40	66	0	2	68	0	0
25	13335359	.	C	T	2	36	38	2	29	69	0	0
25	13335524	.	T	C	28	33	61	1	5	67	0	0
25	13335892	.	A	G	26	33	59	0	0	59	0	0
25	13335897	.	T	C	27	32	59	0	2	61	0	0
25	13336236	.	G	T	37	24	61	0	1	62	0	0
25	13336391	.	G	A	38	39	77	0	0	77	0	0
25	13336409	.	A	C	35	42	77	0	0	77	0	0
25	13336755	.	G	T	35	30	65	0	3	68	0	0
25	13336780	.	A	G	33	26	59	0	4	63	0	0
25	13336815	.	T	A	30	32	62	0	2	64	0	0
25	13336967	.	T	A	26	20	46	1	3	50	0	0
25	13337044	.	G	A	29	35	64	1	4	69	0	0
25	13337136	.	A	G	33	36	69	0	3	72	0	0
25	13340180	.	C	T	40	35	75	1	0	76	0	0
25	13346723	.	G	A	35	38	73	1	1	75	0	0
25	13346730	.	A	G	34	39	73	1	0	74	0	0
25	13350259	.	A	G	39	28	67	0	3	70	0	0
25	13351894	.	T	A	33	39	72	0	5	77	0	0
25	13352304	.	T	A	32	37	69	0	3	72	0	0
25	13352316	.	A	G	35	34	69	0	0	69	0	0
25	13353747	.	G	A	29	32	61	0	3	64	0	0
25	13469844	.	A	G	17	1	18	1	12	31	0	0
25	13469858	.	T	C	16	9	25	1	1	27	0	0
25	13470424	.	C	T	14	13	27	0	1	28	0	0
25	13470430	.	A	T	16	12	28	0	1	29	0	0
25	13470544	.	A	T	6	10	16	0	0	16	0	0
25	13471127	.	A	G	11	0	11	0	12	23	0	0
25	13474246	.	C	T	5	6	11	0	1	12	0	0
25	13474362	.	C	G	5	8	13	0	0	13	0	0
25	13474411	.	A	G	9	7	16	1	0	17	0	0
25	13479710	.	G	A	5	7	12	0	0	12	0	0
25	13509942	.	T	A	11	4	15	0	0	15	0	0
25	13510356	.	A	G	8	5	13	0	0	13	0	0
25	13525164	.	A	T	5	10	15	0	1	16	0	0
25	13525295	.	C	G	12	11	23	0	0	23	0	0
25	13525407	.	G	A	15	9	24	0	0	24	0	0
25	13525453	.	C	T	15	11	26	0	0	26	0	0
25	13525521	.	A	C	12	8	20	0	1	21	0	0
25	13525633	.	A	C	11	7	18	0	0	18	0	0
25	13525848	.	A	T	17	15	32	0	1	33	0	0
25	13525864	.	G	A	19	13	32	0	0	32	0	0
25	13525890	.	A	C	15	13	28	0	1	29	0	0
25	13526171	.	A	C	20	16	36	0	0	36	0	0
25	13529243	.	A	T	5	3	8	0	1	9	0	0
25	13529294	.	A	G	5	5	10	0	0	10	0	0
25	13553159	.	G	A	1	2	3	0	0	3	0	0
25	13559168	.	T	G	6	8	14	0	0	14	0	0
25	13559194	.	G	A	7	14	21	0	0	21	0	0
25	13559220	.	G	A	10	12	22	0	0	22	0	0
25	13559446	.	T	A	10	11	21	0	1	22	0	0
25	13559500	.	T	C	10	9	19	0	0	19	0	0
25	13559723	.	T	A	4	4	8	0	2	10	0	0
25	13559740	.	A	G	4	6	10	0	1	11	0	0
25	13559760	.	T	C	6	1	7	0	4	11	0	0
25	13559953	.	A	T	9	12	21	2	0	23	0	0
25	13560080	.	C	T	7	9	16	0	0	16	0	0
25	13560136	.	C	T	13	3	16	0	1	17	0	0
25	13560149	.	C	T	10	4	14	0	0	14	0	0
25	13560207	.	T	C	11	4	15	0	1	16	0	0
25	13560547	.	C	T	1	8	9	0	11	21	1	0
25	13560576	.	C	T	5	12	17	0	1	18	0	0
25	13560598	.	T	G	5	9	14	0	0	14	0	0
25	13560638	.	C	A	4	7	11	0	1	12	0	0
25	13561133	.	T	C	8	6	14	0	0	14	0	0
25	13561149	.	T	C	7	4	11	0	1	12	0	0
25	13561296	.	A	G	15	7	22	0	0	22	0	0
25	13561775	.	C	A	1	4	5	0	9	14	0	0
25	13561851	.	A	C	6	5	11	0	1	12	0	0
25	13562066	.	G	A	6	5	11	0	0	11	0	0
25	13562371	.	G	A	8	9	17	0	0	17	0	0
25	13562742	.	T	C	11	0	11	1	12	24	0	0
25	13614475	.	G	C	5	0	5	0	6	11	0	0
25	13614509	.	C	G	5	4	9	0	1	10	0	0
25	13614536	.	C	T	0	3	3	0	5	8	0	0
25	13614593	.	G	A	2	4	6	0	0	6	0	0
25	13645911	.	C	T	23	11	34	0	0	34	0	0
25	13646153	.	G	A	6	14	20	1	0	21	0	0
25	13649206	.	C	T	0	8	8	0	9	17	0	0
25	13651394	.	A	T	13	7	20	0	1	21	0	0
25	13658316	.	C	T	0	9	9	0	15	24	0	0
25	13658940	.	G	A	10	9	19	1	1	21	0	0
25	13658976	.	T	C	8	0	8	0	11	19	0	0
25	13659075	.	T	A	19	10	29	0	0	29	0	0
25	13672106	.	T	A	7	4	11	0	0	11	0	0
25	13672111	.	A	T	8	4	12	0	0	12	0	0
25	13672226	.	C	T	8	4	12	0	2	14	0	0
25	13672296	.	T	G	8	8	16	0	0	16	0	0
25	13672349	.	G	A	6	5	11	0	0	11	0	0
25	13672455	.	A	T	1	1	2	0	1	3	0	0
25	13672477	.	T	A	5	2	7	0	0	7	0	0
25	13672522	.	T	A	7	4	11	0	0	11	0	0
25	13672523	.	T	A	7	4	11	0	0	11	0	0
25	13673119	.	A	G	7	3	10	0	2	12	0	0
25	13673377	.	A	G	5	9	14	0	1	15	0	0
25	13674202	.	A	G	8	7	15	0	1	16	0	0
25	13674214	.	A	G	7	6	13	0	1	14	0	0
25	13676274	.	T	C	3	3	6	0	1	7	0	0
25	13677519	.	C	T	2	4	6	0	0	6	0	0
25	13677726	.	G	C	1	4	5	0	0	5	0	0
25	13685517	.	T	C	1	5	6	0	0	6	0	0
25	13689341	.	T	C	5	5	10	0	1	11	0	0
25	13689359	.	C	A	5	8	13	0	0	13	0	0
25	13689486	.	T	C	5	0	5	0	3	8	0	0
25	13689575	.	A	G	7	8	15	0	2	17	0	0
25	13689612	.	A	G	5	5	10	0	0	10	0	0
25	13689617	.	C	A	4	4	8	0	1	9	0	0
25	13695726	.	G	A	3	5	8	0	0	8	0	0
25	13695768	.	A	G	4	4	8	0	0	8	0	0
25	13698970	.	G	A	6	5	11	0	0	11	0	0
25	13744547	.	G	T	2	2	4	0	0	4	0	0
25	13744587	.	T	C	2	3	5	0	0	5	0	0
25	13745659	.	A	G	28	40	68	0	1	69	0	0
25	13745665	.	A	G	31	37	68	0	1	69	0	0
25	13745776	.	A	G	34	28	62	0	0	62	0	0
25	13745788	.	A	C	35	1	36	0	28	64	0	0
25	13747722	.	G	C	22	2	24	0	37	62	1	0
25	13747948	.	T	C	25	2	27	0	22	49	0	0
25	13750734	.	T	A	21	22	43	0	1	44	0	0
25	13754015	.	A	G	25	21	46	0	1	47	0	0
25	13754094	.	T	A	20	25	45	0	0	45	0	0
25	13754338	.	T	G	21	17	38	0	1	40	1	0
25	13754359	.	A	G	17	16	33	0	0	33	0	0
25	13759547	.	G	A	19	19	38	0	4	42	0	0
25	13762889	.	T	C	14	15	29	0	0	29	0	0
25	13763626	.	A	G	14	17	31	0	0	31	0	0
25	13763641	.	C	T	14	12	26	0	0	26	0	0
25	13767612	.	G	A	16	17	33	0	1	34	0	0
25	13767726	.	G	A	18	10	28	1	0	30	1	0
25	13768396	.	G	A	18	12	30	0	1	31	0	0
25	13768547	.	A	G	22	14	36	0	1	37	0	0
25	13774036	.	C	T	17	20	37	0	1	38	0	0
25	13774400	.	G	A	12	12	24	0	1	25	0	0
25	13775158	.	A	G	13	16	29	0	3	32	0	0
25	13776771	.	T	A	14	9	23	0	0	23	0	0
25	13777997	.	T	A	16	7	23	0	1	24	0	0
25	13780322	.	C	G	14	12	26	0	4	30	0	0
25	13782361	.	T	C	12	10	22	0	0	22	0	0
25	13782376	.	A	G	14	9	23	0	0	23	0	0
25	13782544	.	A	G	10	18	28	0	0	28	0	0
25	13787514	.	A	T	18	17	35	0	0	35	0	0
25	13791698	.	A	C	1	3	4	0	0	4	0	0
25	13791853	.	A	C	13	11	24	0	1	25	0	0
25	13795332	.	G	A	20	11	31	0	1	32	0	0
25	13795440	.	T	C	23	12	35	0	2	37	0	0
25	13795441	.	G	A	24	12	36	0	1	37	0	0
25	13795494	.	A	G	28	13	41	0	1	42	0	0
25	13796379	.	T	C	27	17	44	1	1	46	0	0
25	13799172	.	G	A	1	2	3	0	0	3	0	0
25	13801895	.	G	C	16	12	28	0	0	28	0	0
25	13801933	.	C	T	16	17	33	0	0	33	0	0
25	13802100	.	C	T	24	13	37	0	3	40	0	0
25	13802235	.	T	A	10	12	22	0	1	23	0	0
25	13802673	.	C	T	3	16	19	0	6	25	0	0
25	13802688	.	C	A	13	17	30	0	0	30	0	0
25	13802710	.	C	T	11	18	29	0	1	30	0	0
25	13802876	.	G	A	12	22	34	0	4	38	0	0
25	13802901	.	G	A	13	22	35	0	1	36	0	0
25	13802918	.	A	G	13	22	35	0	2	37	0	0
25	13802940	.	A	T	16	19	35	0	1	36	0	0
25	13803710	.	A	G	20	15	35	0	2	37	0	0
25	13803712	.	T	G	22	15	37	0	0	37	0	0
25	13803895	.	A	G	18	16	34	0	2	36	0	0
25	13803903	.	C	T	18	15	33	0	1	34	0	0
25	13804056	.	C	T	23	11	34	0	0	34	0	0
25	13804097	.	T	A	12	31	43	0	0	43	0	0
25	13804216	.	C	T	14	22	36	0	0	36	0	0
25	13813656	.	A	G	22	21	43	0	0	43	0	0
25	13813659	.	G	A	21	21	42	0	2	44	0	0
25	13815325	.	G	A	14	13	27	0	1	28	0	0
25	13815361	.	A	G	17	14	31	0	0	31	0	0
25	13816724	.	G	A	22	7	29	0	0	29	0	0
25	13817135	.	C	G	11	15	26	0	0	26	0	0
25	13817243	.	C	T	3	16	19	0	11	30	0	0
25	13821187	.	C	T	22	12	34	1	1	36	0	0
25	13846984	.	A	G	8	4	12	0	2	14	0	0
25	13847533	.	A	G	16	7	23	0	1	24	0	0
25	13848801	.	G	A	21	13	34	0	1	35	0	0
25	13848930	.	A	G	29	17	46	0	1	47	0	0
25	13850757	.	A	C	26	14	40	0	0	40	0	0
25	13854838	.	G	A	15	8	23	0	0	23	0	0
25	13855707	.	T	A	15	15	30	0	1	31	0	0
25	13856023	.	C	A	2	13	15	0	13	28	0	0
25	13871070	.	C	T	15	12	27	0	0	27	0	0
25	14018007	.	T	C	12	8	20	0	0	20	0	0
25	14019921	.	G	A	2	5	7	0	14	21	0	0
25	14020828	.	A	G	6	0	6	0	5	11	0	0
25	14020973	.	C	T	4	4	8	0	0	8	0	0
25	14021000	.	A	C	4	3	7	0	1	8	0	0
25	14021062	.	A	G	4	2	6	0	0	6	0	0
25	14021070	.	T	C	1	2	3	0	2	5	0	0
25	14033013	.	G	C	4	4	8	0	0	9	1	0
25	14033268	.	T	C	9	17	26	0	2	28	0	0
25	14033670	.	T	G	7	9	16	0	0	16	0	0
25	14033867	.	A	G	11	6	17	0	0	17	0	0
25	14033914	.	G	A	6	8	14	0	0	14	0	0
25	14033984	.	G	T	4	6	10	0	1	11	0	0
25	14034065	.	T	C	5	4	9	0	0	9	0	0
25	14034240	.	G	C	16	14	30	0	1	31	0	0
25	14034398	.	C	T	23	6	29	0	1	30	0	0
25	14034406	.	G	A	21	6	27	0	0	27	0	0
25	14034512	.	C	T	20	7	27	0	0	27	0	0
25	14034513	.	T	A	20	6	26	0	1	27	0	0
25	14034620	.	A	G	10	14	24	0	3	27	0	0
25	14034667	.	C	T	14	7	21	0	1	22	0	0
25	14034725	.	T	A	10	5	15	0	1	16	0	0
25	14034881	.	T	C	16	8	24	0	0	24	0	0
25	14034911	.	C	G	9	10	19	0	2	21	0	0
25	14035012	.	T	G	10	15	25	0	0	25	0	0
25	14035017	.	T	A	11	16	27	0	0	27	0	0
25	14035229	.	C	T	12	9	21	0	4	25	0	0
25	14035247	.	T	G	10	10	20	0	2	22	0	0
25	14035278	.	C	A	3	10	13	0	11	24	0	0
25	14035292	.	C	T	12	7	19	0	3	22	0	0
25	14035414	.	A	T	15	9	24	0	0	24	0	0
25	14035500	.	T	G	12	10	22	0	1	23	0	0
25	14035559	.	T	G	8	6	14	0	1	15	0	0
25	14035833	.	A	C	4	6	10	0	0	10	0	0
25	14035834	.	A	T	3	5	8	0	1	9	0	0
25	14035908	.	A	C	11	3	14	0	1	15	0	0
25	14035990	.	T	C	10	0	10	0	5	15	0	0
25	14351449	.	C	T	7	7	14	0	0	14	0	0
25	14351932	.	G	A	0	8	8	0	9	17	0	0
25	14361812	.	C	T	15	13	28	0	1	29	0	0
25	14363216	.	C	T	10	21	31	0	0	31	0	0
25	14363291	.	T	A	14	19	33	0	2	35	0	0
25	14363572	.	G	T	12	13	25	0	1	26	0	0
25	14365546	.	G	A	18	28	46	0	0	46	0	0
25	14365781	.	C	T	11	12	23	0	1	24	0	0
25	14365834	.	C	T	14	8	22	0	2	24	0	0
25	14366056	.	T	A	15	12	27	0	0	27	0	0
25	14369587	.	G	T	5	6	11	0	2	13	0	0
25	14369631	.	C	T	11	15	26	0	1	27	0	0
25	14369712	.	G	A	12	12	24	0	4	29	1	0
25	14369869	.	T	A	8	2	10	0	1	11	0	0
25	14369883	.	T	C	3	3	6	0	6	12	0	0
25	14374076	.	G	A	5	5	10	0	1	11	0	0
25	14381583	.	A	G	8	17	25	0	0	25	0	0
25	14381763	.	G	A	14	18	32	0	1	33	0	0
25	14384028	.	G	T	17	11	28	0	2	30	0	0
25	14387616	.	C	T	17	21	38	0	1	39	0	0
25	14388955	.	A	T	15	7	22	0	1	23	0	0
25	14392808	.	C	G	8	16	24	0	0	24	0	0
25	14393533	.	A	G	19	8	27	0	0	27	0	0
25	14398703	.	A	C	5	6	11	0	1	12	0	0
25	14398744	.	A	T	17	12	29	1	0	30	0	0
25	14401150	.	C	T	14	7	21	0	1	22	0	0
25	14401219	.	C	A	13	11	24	0	0	24	0	0
25	14403369	.	T	C	13	14	27	0	0	27	0	0
25	14403404	.	C	T	12	11	23	0	0	23	0	0
25	14406608	.	A	C	15	5	20	0	1	21	0	0
25	14406621	.	T	C	5	12	17	0	0	17	0	0
25	14406649	.	A	T	4	5	9	0	2	11	0	0
25	14409222	.	T	A	2	2	4	0	0	4	0	0
25	14409642	.	G	A	5	9	14	0	0	14	0	0
25	14409936	.	T	C	3	1	4	0	6	10	0	0
25	14419928	.	A	T	2	3	5	0	0	5	0	0
25	14426344	.	A	C	2	2	4	0	0	4	0	0
25	14507856	.	G	T	1	2	3	0	0	3	0	0
25	14511458	.	T	A	2	2	4	0	0	4	0	0
25	14511470	.	G	T	1	2	3	0	0	3	0	0
25	14517342	.	C	T	3	2	5	0	0	5	0	0
25	14517370	.	C	G	0	2	2	0	1	3	0	0
25	14548386	.	T	C	2	0	2	0	3	5	0	0
25	14694924	.	T	C	3	5	8	0	0	8	0	0
25	14694942	.	C	T	4	9	13	0	0	13	0	0
25	14694979	.	T	C	8	6	14	0	2	16	0	0
25	14695065	.	T	C	5	7	12	0	0	12	0	0
25	14695092	.	C	T	8	4	12	0	1	13	0	0
25	14702821	.	C	T	6	7	13	0	0	13	0	0
25	14733824	.	C	T	6	8	14	0	1	15	0	0
25	14734122	.	A	G	4	7	11	0	0	11	0	0
25	14738244	.	A	G	1	2	3	0	0	3	0	0
25	14738298	.	T	C	3	5	8	0	0	8	0	0
25	14738462	.	T	A	5	2	7	0	0	7	0	0
25	14738535	.	A	T	5	4	9	0	0	9	0	0
25	14738541	.	T	C	5	4	9	0	0	9	0	0
25	14870072	.	G	A	0	4	4	1	1	6	0	0
25	14870811	.	T	C	3	7	10	0	1	11	0	0
25	14897695	.	C	T	2	3	5	0	0	5	0	0
25	15029225	.	C	T	5	9	14	0	0	14	0	0
25	15031773	.	G	A	11	8	19	0	0	19	0	0
25	15031851	.	A	G	13	11	24	0	1	25	0	0
25	15032087	.	A	G	14	14	28	0	1	29	0	0
25	15034012	.	C	T	1	9	10	0	17	27	0	0
25	15045221	.	T	A	6	9	15	0	0	15	0	0
25	15273455	.	A	T	13	13	26	0	1	27	0	0
25	15275985	.	G	A	8	8	16	0	0	16	0	0
25	15276105	.	T	C	8	13	21	0	0	21	0	0
25	15281889	.	C	T	13	10	23	0	1	24	0	0
25	15281891	.	A	G	13	11	24	0	0	24	0	0
25	15284485	.	T	C	7	7	14	0	0	14	0	0
25	15284644	.	C	G	9	0	9	0	6	15	0	0
25	15284734	.	G	T	16	16	32	0	1	33	0	0
25	15284799	.	C	T	11	23	34	0	2	36	0	0
25	15284862	.	T	C	13	18	31	0	0	31	0	0
25	15284959	.	T	C	13	13	26	0	1	27	0	0
25	15285004	.	A	C	13	11	24	0	1	25	0	0
25	15285092	.	T	C	10	8	18	0	0	18	0	0
25	15285105	.	C	A	9	9	18	0	1	19	0	0
25	15285213	.	G	C	12	10	22	0	0	22	0	0
25	15285256	.	T	A	7	14	21	0	1	22	0	0
25	15285470	.	C	T	7	4	11	0	1	12	0	0
25	15285471	.	C	A	8	4	12	0	0	12	0	0
25	15287107	.	A	C	5	3	8	0	0	8	0	0
25	15287108	.	A	G	3	0	3	0	5	8	0	0
25	15287216	.	G	A	2	2	4	0	2	6	0	0
25	15292574	.	T	G	4	2	6	0	0	6	0	0
25	15292705	.	G	A	2	2	4	0	0	4	0	0
25	15292922	.	C	T	5	2	7	0	0	7	0	0
25	15342700	.	G	A	3	7	10	0	0	10	0	0
25	15343016	.	C	A	5	7	12	0	1	13	0	0
25	15345474	.	C	A	4	5	9	0	2	11	0	0
25	15347416	.	A	G	6	0	6	0	11	17	0	0
25	15347460	.	G	A	1	5	6	0	3	9	0	0
25	15347613	.	A	G	3	0	3	0	3	6	0	0
25	15347688	.	G	A	4	5	9	0	0	9	0	0
25	15348359	.	A	G	1	6	7	0	1	8	0	0
25	15350012	.	A	G	4	4	8	0	0	8	0	0
25	15350016	.	G	A	5	3	8	0	1	9	0	0
25	15350058	.	A	G	7	3	10	0	0	10	0	0
25	15350402	.	T	G	7	8	15	0	0	15	0	0
25	15350467	.	T	C	6	9	15	0	0	15	0	0
25	15351088	.	A	G	6	8	14	0	0	14	0	0
25	15354333	.	G	T	21	14	35	0	0	35	0	0
25	15354360	.	C	T	21	14	35	0	0	35	0	0
25	15404898	.	G	A	19	20	39	0	2	41	0	0
25	15408820	.	G	A	1	24	25	0	30	55	0	0
25	15409013	.	T	C	23	19	42	0	2	44	0	0
25	15430310	.	T	C	26	23	49	0	1	50	0	0
25	15430334	.	T	C	20	25	45	0	1	46	0	0
25	15432769	.	G	A	19	20	39	0	0	39	0	0
25	15434566	.	T	C	24	15	39	0	3	42	0	0
25	15434579	.	C	T	25	21	46	0	0	46	0	0
25	15438723	.	G	A	1	22	23	0	26	50	1	0
25	15438789	.	C	A	25	13	38	0	6	44	0	0
25	15450807	.	C	G	21	21	42	1	0	43	0	0
25	15465167	.	T	C	27	23	50	0	3	53	0	0
25	15472286	.	C	A	33	30	63	0	2	65	0	0
25	15477186	.	G	A	3	15	18	0	28	46	0	0
25	15478092	.	A	G	39	19	58	0	1	59	0	0
25	15480676	.	G	A	3	23	26	0	35	61	0	0
25	15480711	.	T	C	34	22	56	0	2	58	0	0
25	15481040	.	C	T	11	11	22	10	3	35	0	0
25	15481240	.	A	G	21	31	52	0	8	60	0	0
25	15481481	.	T	G	17	14	31	0	0	31	0	0
25	15481759	.	G	A	23	23	46	0	1	47	0	0
25	15647886	.	C	T	5	9	14	0	0	14	0	0
25	15648042	.	G	A	8	14	22	0	0	22	0	0
25	15648092	.	A	G	13	10	23	0	1	24	0	0
25	15648237	.	T	A	19	13	32	0	1	33	0	0
25	15648243	.	C	A	17	13	30	0	1	31	0	0
25	15648330	.	C	A	14	16	30	0	0	30	0	0
25	15648342	.	G	C	13	14	27	0	1	28	0	0
25	15649992	.	G	A	12	11	23	0	0	23	0	0
25	16963906	.	T	C	2	5	7	0	0	7	0	0
25	17977709	.	A	G	1	6	7	0	0	7	0	0
25	18906751	.	A	G	2	2	4	0	0	4	0	0
25	18906757	.	A	G	1	3	4	0	0	4	0	0
25	18906917	.	A	G	10	3	13	0	0	13	0	0
25	18908650	.	A	G	7	0	7	0	3	10	0	0
25	18908651	.	A	G	7	3	10	0	1	11	0	0
25	18961695	.	C	T	2	3	5	0	3	8	0	0
25	18962268	.	A	G	7	2	9	0	1	10	0	0
25	18963193	.	A	G	3	3	6	0	1	7	0	0
25	18977066	.	A	G	2	2	4	0	0	4	0	0
25	18977133	.	A	G	2	5	7	0	0	7	0	0
25	18977138	.	A	G	0	6	6	0	0	6	0	0
25	18977422	.	A	G	7	9	16	0	0	16	0	0
25	18977429	.	A	G	11	4	15	0	1	16	0	0
25	19125229	.	G	A	6	2	8	0	0	8	0	0
25	19205277	.	G	A	1	2	3	0	0	3	0	0
25	20624636	.	G	A	33	5	38	0	0	38	0	0
25	20669202	.	T	G	5	3	8	0	1	9	0	0
25	20670669	.	G	A	1	7	8	0	0	8	0	0
25	20687338	.	A	G	1	8	9	0	0	9	0	0
25	20726933	.	A	C	4	0	4	1	5	10	0	0
25	20726981	.	A	G	2	0	2	0	16	18	0	0
25	21518625	.	T	A	4	4	8	0	0	8	0	0
25	21522639	.	A	G	5	2	7	0	0	7	0	0
25	22055704	.	A	G	1	0	1	0	4	5	0	0
25	22066772	.	G	C	0	3	3	0	5	8	0	0
25	22079368	.	T	C	3	6	9	0	0	9	0	0
25	22079372	.	T	A	2	6	8	0	0	8	0	0
25	22079521	.	G	A	0	2	2	0	6	8	0	0
25	22079742	.	G	A	5	3	8	0	0	8	0	0
25	22085025	.	G	A	0	3	3	0	8	11	0	0
25	22085155	.	C	A	7	4	11	0	0	11	0	0
25	22094967	.	G	A	4	2	6	0	0	6	0	0
25	22095022	.	C	T	3	4	7	0	0	7	0	0
25	22095054	.	G	A	3	2	5	0	2	7	0	0
25	22095118	.	A	G	1	7	8	0	0	8	0	0
25	22095199	.	T	C	4	2	6	0	0	6	0	0
25	22095325	.	G	C	1	3	4	0	0	4	0	0
25	22095549	.	A	T	3	3	6	0	0	6	0	0
25	22224836	.	C	T	1	2	3	0	0	3	0	0
25	22224953	.	G	T	0	2	2	0	2	4	0	0
25	22224960	.	G	A	1	2	3	0	2	5	0	0
25	22232767	.	A	T	4	4	8	0	0	8	0	0
25	22232831	.	C	A	5	3	8	0	0	8	0	0
25	22232870	.	C	T	2	5	7	0	0	7	0	0
25	22232873	.	C	A	0	6	6	0	0	6	0	0
25	22281504	.	C	A	3	2	5	0	0	5	0	0
25	22281645	.	G	A	5	3	8	0	0	8	0	0
25	22291332	.	G	T	3	3	6	0	0	6	0	0
25	22291805	.	G	A	2	2	4	0	0	4	0	0
25	22635759	.	A	G	32	30	62	0	0	62	0	0
25	22635812	.	T	G	32	27	59	0	3	62	0	0
25	22636075	.	C	A	20	12	32	1	3	36	0	0
25	22636574	.	G	A	37	24	61	0	1	62	0	0
25	22636967	.	C	T	28	21	49	0	0	49	0	0
25	22637012	.	C	T	23	23	46	0	0	46	0	0
25	22637039	.	A	G	20	25	45	0	1	46	0	0
25	22637290	.	C	A	1	24	25	0	34	59	0	0
25	22637384	.	G	A	29	20	49	0	4	53	0	0
25	22637444	.	A	T	25	22	47	0	3	50	0	0
25	22637501	.	A	G	24	20	44	0	2	46	0	0
25	22637584	.	A	T	23	20	43	0	2	45	0	0
25	22637667	.	T	C	29	30	59	0	2	61	0	0
25	22637729	.	G	T	33	21	54	0	2	56	0	0
25	22637732	.	G	A	35	20	55	0	1	56	0	0
25	22637873	.	C	A	24	24	48	0	3	51	0	0
25	22638170	.	C	G	1	12	13	0	16	29	0	0
25	22639039	.	G	A	25	19	44	0	3	47	0	0
25	22720533	.	T	C	4	2	6	0	1	7	0	0
25	22720574	.	T	A	4	4	8	0	1	9	0	0
25	22720583	.	T	A	4	3	7	0	0	7	0	0
25	22730504	.	T	C	3	10	13	0	0	13	0	0
25	22730594	.	G	A	1	9	10	0	10	20	0	0
25	22979987	.	T	A	10	3	13	0	0	13	0	0
25	23449787	.	A	G	6	3	9	1	0	10	0	0
25	23524975	.	T	G	4	5	9	0	0	9	0	0
25	23556378	.	C	G	7	8	15	0	1	16	0	0
25	23556452	.	T	C	7	3	10	0	1	11	0	0
25	23562487	.	C	T	1	8	9	0	11	20	0	0
25	23571614	.	A	G	7	9	16	0	0	16	0	0
25	23571823	.	T	C	7	7	14	0	0	14	0	0
25	23583076	.	G	C	4	0	4	0	9	13	0	0
25	23630701	.	C	T	2	5	7	0	0	7	0	0
25	23636135	.	G	T	5	3	8	0	0	8	0	0
25	23636144	.	C	T	5	4	9	0	0	9	0	0
25	23636329	.	C	T	3	3	6	0	0	6	0	0
25	23643477	.	C	T	4	2	6	0	0	6	0	0
25	23777510	.	C	A	9	11	20	0	0	20	0	0
25	23777545	.	G	A	18	21	39	0	1	40	0	0
25	23815540	.	C	T	13	12	25	0	0	25	0	0
25	24040312	.	T	C	1	1	2	0	1	3	0	0
25	24041252	.	T	G	1	2	3	0	0	3	0	0
25	24055419	.	T	C	9	0	9	0	6	15	0	0
25	24059983	.	A	G	15	8	23	0	1	24	0	0
25	24059991	.	A	G	15	8	23	0	1	24	0	0
25	24060460	.	G	A	6	2	8	0	0	8	0	0
25	24177857	.	G	A	1	0	1	0	1	2	0	0
25	24177865	.	T	G	1	0	1	0	2	3	0	0
25	24181456	.	T	C	1	5	6	0	2	8	0	0
25	24181674	.	A	G	5	2	7	0	0	7	0	0
25	24236397	.	G	A	1	4	5	0	0	5	0	0
25	24237636	.	G	A	8	9	17	0	0	17	0	0
25	24238066	.	T	G	14	8	22	0	0	22	0	0
25	24238243	.	T	C	5	3	8	0	0	8	0	0
25	24240918	.	C	T	10	7	17	0	0	17	0	0
25	24241338	.	T	G	9	14	23	0	2	25	0	0
25	24241350	.	G	A	8	12	20	0	3	23	0	0
25	24242001	.	A	G	12	13	25	0	0	25	0	0
25	24242103	.	A	G	6	16	22	0	0	22	0	0
25	24242115	.	T	C	5	17	22	0	0	22	0	0
25	24247267	.	C	G	6	14	20	0	0	20	0	0
25	24247282	.	A	C	6	15	21	0	1	22	0	0
25	24247758	.	A	C	9	1	10	0	6	16	0	0
25	24247765	.	T	C	8	7	15	0	1	16	0	0
25	24247814	.	T	C	3	9	12	0	0	12	0	0
25	24247852	.	A	G	6	13	19	0	1	20	0	0
25	24247985	.	G	A	3	12	15	0	0	15	0	0
25	24250326	.	T	A	6	5	11	0	1	12	0	0
25	24262194	.	T	A	5	2	7	0	0	7	0	0
25	24262227	.	A	T	4	2	6	0	0	6	0	0
25	24262417	.	A	G	1	2	3	0	0	3	0	0
25	24264276	.	G	A	0	8	8	0	5	13	0	0
25	24291234	.	G	A	1	5	6	0	0	6	0	0
25	24291235	.	A	G	1	3	4	0	2	6	0	0
25	24291451	.	T	C	1	2	3	0	0	3	0	0
25	24291831	.	T	A	1	2	3	0	0	3	0	0
25	24292067	.	T	C	2	2	4	0	0	4	0	0
25	24292287	.	C	A	2	3	5	0	0	5	0	0
25	24292326	.	C	T	3	3	6	0	0	6	0	0
25	24292708	.	G	A	1	5	6	0	0	6	0	0
25	24388630	.	A	G	1	0	1	1	7	9	0	0
25	24593493	.	G	A	1	4	5	0	4	9	0	0
25	24593517	.	C	T	3	5	8	0	1	9	0	0
25	24593686	.	C	G	13	7	20	0	0	20	0	0
25	24593689	.	G	A	12	7	19	0	0	19	0	0
25	24593766	.	A	G	7	5	12	0	2	14	0	0
25	24593833	.	A	T	9	7	16	0	0	16	0	0
25	24594339	.	C	T	7	10	17	0	0	17	0	0
25	24594474	.	T	G	1	0	1	0	3	4	0	0
25	24596961	.	T	C	2	9	11	0	0	11	0	0
25	24596976	.	T	A	4	8	12	0	0	12	0	0
25	24598869	.	T	C	10	8	18	0	0	18	0	0
25	24605595	.	G	T	6	7	13	0	0	13	0	0
25	24605598	.	A	C	6	7	13	0	0	13	0	0
25	24607933	.	A	G	5	0	5	0	4	9	0	0
25	24609348	.	C	T	7	2	9	0	0	9	0	0
25	24609418	.	A	T	7	4	11	0	0	11	0	0
25	24609463	.	T	A	4	8	12	0	1	13	0	0
25	24609515	.	A	G	6	7	13	0	1	14	0	0
25	24610020	.	G	A	8	6	14	0	0	14	0	0
25	24610030	.	T	C	9	5	14	0	0	14	0	0
25	24610543	.	A	T	7	9	16	0	0	16	0	0
25	24610544	.	A	G	7	9	16	0	0	16	0	0
25	24691325	.	C	T	1	4	5	0	0	5	0	0
25	24714795	.	C	T	1	2	3	0	0	3	0	0
25	24716984	.	A	G	2	0	2	0	3	5	0	0
25	24716990	.	C	G	1	3	4	0	0	4	0	0
25	24720580	.	A	G	6	5	11	0	0	11	0	0
25	24723447	.	C	T	1	4	5	0	0	5	0	0
25	24723468	.	T	C	2	6	8	0	0	8	0	0
25	24736579	.	A	T	7	11	18	0	0	18	0	0
25	24736828	.	A	T	5	6	11	0	1	12	0	0
25	24736875	.	T	G	5	7	12	0	2	14	0	0
25	24736921	.	G	A	3	7	10	0	0	10	0	0
25	24737026	.	C	T	5	4	9	0	1	10	0	0
25	24737154	.	C	T	0	2	2	0	5	7	0	0
25	24737664	.	C	A	9	7	16	0	0	16	0	0
25	24737961	.	C	T	1	2	3	0	0	3	0	0
25	24738023	.	T	C	2	0	2	0	7	9	0	0
25	24738084	.	T	C	10	0	10	0	17	27	0	0
25	24738114	.	C	G	10	14	24	0	1	25	0	0
25	24738826	.	G	A	5	5	10	0	1	11	0	0
25	24739029	.	A	G	17	16	33	0	0	33	0	0
25	24752181	.	A	G	9	14	23	0	0	23	0	0
25	24760448	.	C	A	1	12	13	0	19	32	0	0
25	24763746	.	A	G	7	15	22	0	0	22	0	0
25	24763755	.	G	T	9	13	22	0	1	23	0	0
25	24770089	.	G	A	12	19	31	0	1	32	0	0
25	24792647	.	C	A	9	8	17	0	1	18	0	0
25	24805912	.	T	A	10	14	24	0	2	26	0	0
25	24826237	.	G	T	11	11	22	0	0	22	0	0
25	24826240	.	T	C	11	0	11	0	10	21	0	0
25	24826290	.	A	G	7	11	18	0	1	19	0	0
25	24847561	.	A	T	1	4	5	0	2	7	0	0
25	25058302	.	C	T	12	7	19	0	1	20	0	0
25	25058334	.	A	C	11	0	11	0	12	23	0	0
25	25058469	.	T	C	1	2	3	0	0	3	0	0
25	25123445	.	T	C	18	14	32	0	1	33	0	0
25	25124779	.	A	T	18	26	44	0	0	44	0	0
25	25127090	.	C	T	19	21	40	0	2	42	0	0
25	25127250	.	A	G	16	24	40	0	2	42	0	0
25	25130648	.	C	T	30	23	53	0	2	55	0	0
25	25130693	.	C	T	25	24	49	0	4	53	0	0
25	25130747	.	C	T	24	29	53	0	1	54	0	0
25	25130782	.	G	A	29	27	56	0	1	57	0	0
25	25130908	.	C	T	26	16	42	2	2	46	0	0
25	25130924	.	T	C	25	19	44	2	2	48	0	0
25	25130968	.	C	T	22	20	42	0	0	42	0	0
25	25131274	.	A	G	17	15	32	0	1	33	0	0
25	25131298	.	A	T	16	25	41	0	1	42	0	0
25	25131389	.	A	T	24	22	46	0	0	46	0	0
25	25131464	.	G	A	27	25	52	0	0	52	0	0
25	25131631	.	C	T	20	21	41	0	0	48	7	0
25	25131710	.	A	G	16	16	32	0	0	32	0	0
25	25132985	.	C	T	8	8	16	0	2	18	0	0
25	25133030	.	G	A	8	14	22	0	1	23	0	0
25	25133123	.	T	G	16	17	33	0	2	35	0	0
25	25133171	.	A	G	21	19	40	0	1	41	0	0
25	25133353	.	G	A	20	20	40	0	0	40	0	0
25	25133365	.	T	A	17	22	39	0	0	39	0	0
25	25133509	.	A	G	20	12	32	0	2	34	0	0
25	25142127	.	G	A	8	7	15	0	5	22	2	0
25	25142171	.	T	C	15	8	23	0	1	24	0	0
25	25396237	.	T	C	8	18	26	0	0	26	0	0
25	25396295	.	T	C	8	15	23	0	1	24	0	0
25	25488460	.	T	A	2	3	5	0	0	5	0	0
25	25488772	.	T	G	6	5	11	0	0	11	0	0
25	25535319	.	T	G	5	7	12	0	1	13	0	0
25	25536088	.	A	C	5	3	8	0	0	8	0	0
25	25536089	.	G	A	5	3	8	0	0	8	0	0
25	25536394	.	C	A	10	6	16	0	0	16	0	0
25	25536707	.	T	C	6	2	8	0	0	8	0	0
25	25538143	.	A	C	10	3	13	0	0	13	0	0
25	25538151	.	C	T	12	4	16	0	0	16	0	0
25	25538206	.	G	T	12	7	19	0	0	19	0	0
25	25538354	.	T	A	5	6	11	0	0	11	0	0
25	25538440	.	T	G	12	8	20	0	0	20	0	0
25	25538624	.	C	A	6	5	11	0	1	12	0	0
25	25538786	.	T	G	9	1	10	0	7	17	0	0
25	25538834	.	C	A	7	2	9	0	0	9	0	0
25	25539028	.	G	A	5	9	14	0	0	14	0	0
25	25539270	.	C	A	10	8	18	0	1	19	0	0
25	25539398	.	G	A	11	6	17	0	0	17	0	0
25	25539434	.	G	A	1	7	8	0	6	14	0	0
25	25539518	.	A	G	6	5	11	0	0	11	0	0
25	25539569	.	A	G	3	1	4	0	4	8	0	0
25	25539723	.	C	A	10	16	26	0	0	26	0	0
25	25539783	.	G	C	4	16	20	0	0	20	0	0
25	25539800	.	A	G	5	11	16	0	1	17	0	0
25	25539834	.	A	T	5	10	15	0	0	15	0	0
25	25539928	.	A	G	5	0	5	0	9	14	0	0
25	25540058	.	T	A	5	13	18	0	0	18	0	0
25	25540060	.	G	A	5	13	18	0	0	18	0	0
25	25540181	.	A	T	6	6	12	0	0	12	0	0
25	25540245	.	A	G	5	8	13	1	0	14	0	0
25	25540444	.	T	C	5	3	8	0	0	8	0	0
25	25540490	.	C	T	7	5	12	0	0	12	0	0
25	25540954	.	G	A	11	11	22	0	1	23	0	0
25	25545131	.	T	C	8	11	19	0	0	19	0	0
25	25545149	.	G	C	9	11	20	0	0	20	0	0
25	25545700	.	A	T	2	4	6	0	0	6	0	0
25	25545722	.	T	C	1	3	4	0	1	5	0	0
25	25545989	.	G	C	4	5	9	0	0	9	0	0
25	25546053	.	G	A	1	4	5	0	0	5	0	0
25	25546292	.	A	G	2	0	2	0	3	5	0	0
25	25546319	.	G	A	3	2	5	0	0	5	0	0
25	25547043	.	C	A	6	5	11	0	0	11	0	0
25	25547228	.	G	A	3	3	6	0	0	6	0	0
25	25565819	.	A	G	1	7	8	0	0	8	0	0
25	25575645	.	T	G	1	6	7	0	0	7	0	0
25	25592238	.	A	G	6	3	9	0	0	9	0	0
25	25592821	.	G	A	2	2	4	0	1	5	0	0
25	25592875	.	C	T	5	3	8	0	0	8	0	0
25	25593980	.	T	C	4	2	6	0	0	6	0	0
25	25619515	.	C	T	1	2	3	0	5	8	0	0
25	25646510	.	A	T	1	4	5	0	0	5	0	0
25	25646521	.	T	G	1	3	4	0	0	4	0	0
25	25646548	.	A	G	3	5	8	0	1	9	0	0
25	25646690	.	C	T	4	2	6	0	1	7	0	0
25	25736865	.	T	C	8	1	9	0	9	18	0	0
25	25737674	.	C	A	9	3	12	0	0	12	0	0
25	25747119	.	C	A	6	3	9	0	0	9	0	0
25	25747271	.	C	T	4	3	7	0	0	7	0	0
25	25766157	.	G	A	25	22	47	0	2	49	0	0
25	25806264	.	C	T	15	14	29	0	6	35	0	0
25	25823529	.	T	C	15	16	31	0	3	34	0	0
25	26673233	.	A	G	16	8	24	0	1	25	0	0
25	26744995	.	G	T	1	6	7	0	1	8	0	0
25	26811959	.	C	A	1	5	6	0	0	6	0	0
25	26813023	.	A	C	1	3	4	0	0	4	0	0
25	26813323	.	G	T	2	2	4	0	0	4	0	0
25	26821795	.	T	C	4	5	9	0	0	9	0	0
25	26821844	.	A	T	5	4	9	0	1	10	0	0
25	26822823	.	C	T	7	2	9	0	0	9	0	0
25	26823244	.	C	T	2	4	6	0	0	6	0	0
25	26824155	.	G	A	2	2	4	0	0	4	0	0
25	26824177	.	G	A	2	4	6	0	0	6	0	0
25	26829266	.	G	T	6	3	9	0	0	9	0	0
25	26830142	.	C	T	3	5	8	0	2	10	0	0
25	26832141	.	A	G	8	5	13	0	0	13	0	0
25	26840452	.	G	T	7	2	9	0	3	12	0	0
25	26840480	.	T	G	8	8	16	0	0	16	0	0
25	26840678	.	A	T	4	7	11	0	1	12	0	0
25	26840919	.	G	A	4	11	15	0	0	15	0	0
25	26842444	.	G	A	6	7	13	0	0	13	0	0
25	26842565	.	T	G	5	8	13	0	2	15	0	0
25	26844218	.	C	A	6	2	8	0	0	8	0	0
25	26845327	.	G	A	1	3	4	0	0	4	0	0
25	26853906	.	C	T	1	3	4	0	0	4	0	0
25	26853918	.	T	A	1	4	5	0	0	5	0	0
25	26856310	.	C	T	2	3	5	0	0	5	0	0
25	26856358	.	C	T	3	2	5	0	0	5	0	0
25	26866606	.	C	A	2	2	4	0	0	4	0	0
25	26867210	.	A	T	2	1	3	0	0	3	0	0
25	26867226	.	A	G	2	0	2	0	2	4	0	0
25	26867671	.	A	T	2	3	5	0	0	5	0	0
25	26867682	.	G	T	5	2	7	0	0	7	0	0
25	26867731	.	C	T	2	2	4	0	0	4	0	0
25	26867765	.	C	A	1	2	3	0	1	4	0	0
25	26867787	.	C	T	0	6	6	1	0	7	0	0
25	26877783	.	A	T	4	13	17	0	1	18	0	0
25	26877865	.	A	T	14	8	22	0	0	22	0	0
25	26877966	.	A	G	16	16	32	0	4	36	0	0
25	26879592	.	T	C	30	18	48	1	0	49	0	0
25	26884286	.	G	A	17	14	31	0	0	31	0	0
25	26884407	.	C	T	11	17	28	1	0	29	0	0
25	26888170	.	A	G	17	15	32	0	1	33	0	0
25	26890845	.	A	G	29	17	46	0	1	47	0	0
25	26908396	.	T	G	3	4	7	0	0	7	0	0
25	26908888	.	C	T	2	3	5	0	1	6	0	0
25	26909101	.	C	T	6	6	12	0	0	12	0	0
25	26909197	.	G	A	8	8	16	0	1	17	0	0
25	26909269	.	A	G	9	12	21	0	1	22	0	0
25	26909392	.	A	T	10	12	22	0	2	24	0	0
25	26909618	.	A	C	3	6	9	0	1	10	0	0
25	26911428	.	A	C	2	4	6	0	0	6	0	0
25	26911554	.	T	A	4	8	12	0	2	14	0	0
25	26911605	.	C	A	6	7	13	0	1	14	0	0
25	26911768	.	A	G	3	5	8	0	0	8	0	0
25	26911792	.	G	A	6	2	8	0	0	8	0	0
25	26912062	.	C	T	1	2	3	0	0	3	0	0
25	26923180	.	T	A	5	4	9	0	1	10	0	0
25	27010243	.	G	A	1	3	4	0	3	7	0	0
25	27173852	.	G	A	5	5	10	0	0	10	0	0
25	27173936	.	C	T	9	9	18	0	0	18	0	0
25	27173940	.	A	C	8	11	19	0	1	20	0	0
25	27174065	.	C	T	5	6	11	0	2	13	0	0
25	27210906	.	T	C	17	9	26	0	3	29	0	0
25	27237022	.	A	G	3	7	10	0	2	12	0	0
25	27493723	.	A	T	5	2	7	0	0	7	0	0
25	27493783	.	A	C	1	2	3	0	1	4	0	0
25	27494094	.	T	A	5	3	8	0	0	8	0	0
25	27494109	.	G	A	0	2	2	0	2	4	0	0
25	27494243	.	A	G	1	3	4	0	0	4	0	0
25	27499172	.	A	G	2	3	5	0	0	5	0	0
25	27499175	.	G	A	4	2	6	0	0	6	0	0
25	27499304	.	T	A	3	6	9	0	0	9	0	0
25	27499385	.	T	C	3	4	7	0	0	7	0	0
25	27499983	.	G	A	0	2	2	0	5	7	0	0
25	27499996	.	T	A	5	2	7	0	0	7	0	0
25	27500038	.	C	A	2	4	6	0	0	6	0	0
25	27500055	.	A	G	3	2	5	0	0	5	0	0
25	27500109	.	A	G	1	3	4	0	0	4	0	0
25	27542291	.	A	T	1	2	3	0	0	3	0	0
25	27543087	.	T	C	1	3	4	0	0	4	0	0
25	27543882	.	A	T	1	2	3	0	0	3	0	0
25	27543883	.	A	G	1	2	3	0	0	3	0	0
25	27550352	.	C	T	1	3	4	0	0	4	0	0
25	27550559	.	G	A	3	2	5	0	0	5	0	0
25	27550907	.	G	A	2	2	4	0	0	4	0	0
25	27564074	.	C	T	1	2	3	0	1	4	0	0
25	27564093	.	G	T	2	2	4	0	0	4	0	0
25	27629801	.	C	T	1	2	3	0	0	3	0	0
25	27636712	.	G	A	1	2	3	0	0	3	0	0
25	27744408	.	C	A	10	8	18	0	2	20	0	0
25	27759983	.	A	G	5	11	16	0	0	16	0	0
25	27795017	.	A	G	12	19	31	0	5	36	0	0
25	27795083	.	C	T	10	13	23	0	2	25	0	0
25	27801759	.	T	G	9	0	9	0	18	27	0	0
25	27802122	.	C	A	19	18	37	0	1	38	0	0
25	27802149	.	G	A	14	20	34	0	1	35	0	0
25	27811761	.	C	T	16	11	27	0	7	34	0	0
25	27937676	.	T	G	4	2	6	0	0	6	0	0
25	27937719	.	T	C	4	3	7	0	0	7	0	0
25	27937788	.	C	A	2	2	4	0	0	4	0	0
25	27995812	.	G	A	5	3	8	0	0	8	0	0
25	28070532	.	C	T	7	4	11	0	0	11	0	0
25	28070634	.	G	A	1	4	5	0	7	12	0	0
25	28070637	.	G	A	8	4	12	0	0	12	0	0
25	28070673	.	A	C	6	6	12	0	0	12	0	0
25	28120150	.	C	T	2	6	8	0	2	10	0	0
25	28122051	.	C	T	9	5	14	0	2	16	0	0
25	28138918	.	A	C	10	8	18	0	0	18	0	0
25	28334379	.	A	G	6	2	8	0	0	8	0	0
25	28640724	.	T	G	27	25	52	0	3	55	0	0
25	28640890	.	T	G	16	14	30	0	2	32	0	0
25	28641207	.	A	T	12	14	26	0	8	34	0	0
25	28641261	.	T	A	20	12	32	0	2	35	1	0
25	28641321	.	T	G	22	14	36	0	0	36	0	0
25	28648067	.	T	C	9	16	25	0	4	29	0	0
25	28648078	.	A	G	6	22	28	0	1	29	0	0
25	28650764	.	T	A	25	11	36	0	2	38	0	0
25	28655056	.	G	A	18	12	30	0	1	31	0	0
25	28661185	.	C	T	17	12	29	0	0	29	0	0
25	28661227	.	T	C	18	9	27	0	1	28	0	0
25	28661351	.	G	A	19	13	32	0	0	32	0	0
25	28661626	.	G	A	13	18	31	1	0	32	0	0
25	28665446	.	T	A	12	13	25	0	0	25	0	0
25	28665464	.	A	C	12	11	23	0	0	23	0	0
25	28668001	.	G	A	15	18	33	0	0	33	0	0
25	28668723	.	C	A	12	20	32	0	0	32	0	0
25	28714775	.	A	T	4	2	6	0	0	6	0	0
25	28714796	.	C	G	4	2	6	0	0	6	0	0
25	28715206	.	A	T	8	3	11	0	0	11	0	0
25	28715221	.	G	A	7	2	9	0	0	9	0	0
25	28715605	.	C	G	1	3	4	0	2	6	0	0
25	28715785	.	T	C	2	0	2	0	2	4	0	0
25	28715791	.	T	A	2	2	4	0	0	4	0	0
25	28716206	.	G	A	3	4	7	0	0	7	0	0
25	28719957	.	T	G	10	13	23	0	0	23	0	0
25	28720044	.	T	C	4	0	4	0	6	10	0	0
25	28726537	.	C	A	1	7	8	0	5	13	0	0
25	28726758	.	A	G	5	5	10	0	0	10	0	0
25	28726788	.	G	T	6	4	10	0	0	10	0	0
25	28726797	.	C	T	0	6	6	0	6	12	0	0
25	28736679	.	C	T	7	2	9	1	0	10	0	0
25	28736893	.	A	G	10	7	17	0	2	19	0	0
25	28737007	.	A	T	10	11	21	0	0	21	0	0
25	28739882	.	A	G	5	3	8	0	1	9	0	0
25	28739891	.	A	G	4	4	8	0	1	9	0	0
25	28740295	.	A	T	3	3	6	0	1	7	0	0
25	28740319	.	G	A	3	4	7	0	0	7	0	0
25	28740366	.	T	C	2	0	2	0	5	7	0	0
25	28745047	.	C	T	5	4	9	0	0	9	0	0
25	28745070	.	T	G	4	5	9	0	0	9	0	0
25	28745128	.	A	G	5	3	8	0	0	8	0	0
25	28745260	.	G	A	2	2	4	0	0	4	0	0
25	28745266	.	C	T	2	2	4	0	0	4	0	0
25	28752579	.	C	T	1	5	6	0	5	11	0	0
25	28753499	.	A	C	5	6	11	0	0	11	0	0
25	28758996	.	G	A	5	4	9	0	0	9	0	0
25	28759005	.	T	C	5	0	5	0	4	9	0	0
25	28763084	.	T	A	6	2	8	0	0	8	0	0
25	28763144	.	A	G	4	5	9	0	1	10	0	0
25	28825652	.	G	C	10	4	14	1	0	15	0	0
25	28826630	.	A	G	13	0	13	0	9	22	0	0
25	28827752	.	A	G	12	0	12	0	11	23	0	0
25	28846383	.	G	T	1	7	8	1	13	22	0	0
25	28893665	.	T	A	4	7	11	0	0	11	0	0
25	28893713	.	C	A	11	10	21	0	2	23	0	0
25	28893956	.	C	T	10	9	19	0	1	20	0	0
25	28903105	.	A	C	12	13	25	0	1	26	0	0
25	28903253	.	A	G	4	1	5	0	5	10	0	0
25	28926529	.	T	G	2	4	6	0	0	6	0	0
25	29076852	.	T	A	38	29	67	3	0	70	0	0
25	29083827	.	T	A	1	3	4	0	0	4	0	0
25	29084154	.	G	A	1	6	7	0	1	8	0	0
25	29087845	.	T	C	5	0	5	0	4	9	0	0
25	29087859	.	T	C	3	0	3	0	2	5	0	0
25	29109251	.	G	A	6	7	13	0	1	14	0	0
25	29110052	.	A	G	5	9	14	0	0	14	0	0
25	29114835	.	G	A	4	11	15	0	2	17	0	0
25	29117835	.	A	G	6	9	15	0	0	15	0	0
25	29128870	.	G	C	8	6	14	0	0	14	0	0
25	29211978	.	G	C	1	0	1	0	4	5	0	0
25	29212008	.	G	A	3	7	10	0	0	10	0	0
25	29212167	.	G	T	9	4	13	0	0	13	0	0
25	29212302	.	C	T	1	5	6	0	3	9	0	0
25	29212476	.	T	C	9	5	14	0	0	14	0	0
25	29212780	.	A	T	10	7	17	0	2	19	0	0
25	29212781	.	C	G	0	7	7	0	12	19	0	0
25	29212835	.	A	T	11	7	18	0	2	20	0	0
25	29212851	.	G	T	6	8	14	0	1	15	0	0
25	29212986	.	A	G	8	9	17	0	1	18	0	0
25	29213001	.	G	C	9	9	18	0	0	18	0	0
25	29213804	.	A	G	8	5	13	0	0	13	0	0
25	29231956	.	C	T	2	2	4	0	1	5	0	0
25	29318927	.	C	G	1	1	2	0	1	3	0	0
25	29319097	.	A	G	21	31	52	0	0	52	0	0
25	29319239	.	A	T	21	20	41	0	1	42	0	0
25	29319706	.	T	C	35	2	37	0	31	68	0	0
25	29319712	.	A	G	35	28	63	0	3	66	0	0
25	29319831	.	A	G	44	27	71	0	3	74	0	0
25	29319849	.	G	A	39	25	64	0	4	68	0	0
25	29329949	.	A	G	48	32	80	0	7	87	0	0
25	29427951	.	A	C	12	8	20	0	0	20	0	0
25	29427955	.	A	C	9	7	16	0	1	17	0	0
25	29428094	.	A	G	16	11	27	0	1	28	0	0
25	29428300	.	C	A	18	18	36	0	0	36	0	0
25	29428638	.	A	G	17	12	29	0	0	29	0	0
25	29428806	.	T	A	13	5	18	0	1	19	0	0
25	29428963	.	G	A	20	23	43	0	1	44	0	0
25	29429187	.	A	G	17	12	29	0	2	31	0	0
25	29429420	.	G	A	22	10	32	0	1	33	0	0
25	29429569	.	T	C	20	1	21	0	11	32	0	0
25	29429589	.	G	T	21	10	31	0	0	31	0	0
25	29429984	.	T	C	13	1	14	0	10	24	0	0
25	29444782	.	A	G	16	16	32	0	0	32	0	0
25	29662436	.	C	A	8	4	12	0	0	12	0	0
25	29662642	.	T	C	4	8	12	0	0	12	0	0
25	29662739	.	C	T	5	11	16	0	1	17	0	0
25	29663116	.	T	G	9	5	14	0	1	15	0	0
25	29664955	.	T	C	6	8	14	0	0	14	0	0
25	29665705	.	G	A	4	6	10	0	18	28	0	0
25	29666170	.	T	G	12	1	13	0	7	20	0	0
25	29666299	.	A	G	17	9	26	0	0	26	0	0
25	29666607	.	G	T	1	2	3	0	0	3	0	0
25	29666640	.	T	A	6	4	10	0	0	10	0	0
25	29666797	.	T	A	4	9	13	0	0	13	0	0
25	29694272	.	T	A	6	3	9	0	1	10	0	0
25	29694487	.	A	C	3	5	8	0	0	8	0	0
25	29694545	.	A	G	2	5	7	0	1	8	0	0
25	29694824	.	A	C	6	5	11	0	0	11	0	0
25	29695067	.	G	A	2	3	5	0	1	6	0	0
25	29696881	.	A	G	6	4	10	0	0	10	0	0
25	29696896	.	A	G	6	0	6	0	4	10	0	0
25	29697015	.	G	A	4	7	11	0	0	11	0	0
25	29697064	.	C	T	11	5	16	0	0	16	0	0
25	29697575	.	C	A	8	3	11	0	0	11	0	0
25	29698784	.	C	T	10	7	17	0	1	18	0	0
25	29698922	.	A	T	8	7	15	0	0	15	0	0
25	29699018	.	G	A	3	7	10	0	0	10	0	0
25	29699227	.	T	C	12	7	19	0	0	19	0	0
25	29699236	.	A	T	10	8	18	1	0	19	0	0
25	29701710	.	G	A	10	7	17	1	0	18	0	0
25	29711597	.	A	T	5	5	10	0	0	10	0	0
25	29711754	.	C	A	8	5	13	0	2	15	0	0
25	30151659	.	T	G	1	6	7	0	1	8	0	0
25	31556702	.	G	A	1	5	6	0	0	6	0	0
25	32216389	.	A	G	4	0	4	0	9	13	0	0
25	32252408	.	T	G	6	0	6	0	13	19	0	0
25	32888015	.	A	G	1	3	4	0	0	4	0	0
25	33006913	.	G	T	5	2	7	0	0	7	0	0
25	33038216	.	A	G	3	0	3	0	8	11	0	0
25	33050967	.	T	C	2	4	6	0	0	6	0	0
25	33052316	.	G	T	3	2	5	0	0	5	0	0
25	33052340	.	A	G	3	0	3	0	4	7	0	0
25	33052544	.	C	T	3	3	6	0	0	6	0	0
25	33065530	.	A	G	2	0	2	0	5	7	0	0
25	33065551	.	C	T	2	4	6	0	0	6	0	0
25	33065593	.	T	C	3	4	7	0	0	7	0	0
25	33065605	.	C	T	3	5	8	0	0	8	0	0
25	33068039	.	G	T	0	3	3	0	4	7	0	0
25	33078229	.	G	A	10	6	16	0	0	16	0	0
25	33078253	.	A	C	9	6	15	0	0	15	0	0
25	33081889	.	A	G	3	7	10	0	0	10	0	0
25	33091554	.	A	G	6	0	6	0	13	19	0	0
25	33093485	.	T	C	10	8	18	0	0	18	0	0
25	33104491	.	T	C	8	3	11	0	0	11	0	0
25	33104494	.	T	C	8	3	11	0	0	11	0	0
25	33121219	.	T	C	3	6	9	0	0	9	0	0
25	33121740	.	C	T	4	8	12	0	0	12	0	0
25	33121782	.	A	G	5	0	5	0	6	11	0	0
25	33125194	.	A	C	8	3	11	0	5	16	0	0
25	33145031	.	C	T	9	4	13	0	1	14	0	0
25	33151573	.	C	G	8	0	8	0	7	15	0	0
25	33194649	.	A	G	1	4	5	0	0	5	0	0
25	33194667	.	A	C	2	3	5	0	1	6	0	0
25	33225248	.	A	G	27	23	50	0	3	53	0	0
25	33225287	.	G	A	23	22	45	0	0	45	0	0
25	33226972	.	A	G	22	20	42	0	2	44	0	0
25	33226984	.	A	G	17	24	41	0	2	43	0	0
25	33238370	.	C	T	3	2	5	0	0	5	0	0
25	33238373	.	T	A	3	2	5	0	0	5	0	0
25	33239223	.	T	A	10	3	13	0	0	13	0	0
25	33239228	.	T	C	9	3	12	0	0	12	0	0
25	33249905	.	T	G	13	20	33	0	0	33	0	0
25	33250017	.	C	A	10	3	13	0	2	15	0	0
25	33250053	.	A	G	10	8	18	0	2	20	0	0
25	33258739	.	G	A	0	5	5	0	1	6	0	0
25	33258745	.	T	G	0	0	0	0	4	4	0	0
25	33258811	.	A	G	3	1	4	0	4	8	0	0
25	33258817	.	C	T	3	6	9	0	1	10	0	0
25	33259778	.	T	C	4	5	9	0	2	11	0	0
25	33262180	.	A	G	6	8	14	0	0	14	0	0
25	33265759	.	A	G	4	6	10	0	0	10	0	0
25	33265814	.	C	T	8	10	18	0	1	19	0	0
25	33265898	.	C	T	8	5	13	0	0	13	0	0
25	33266029	.	G	A	5	8	13	0	0	13	0	0
25	33266128	.	A	G	3	0	3	0	7	10	0	0
25	33266157	.	A	C	2	7	9	0	1	10	0	0
25	33962809	.	G	A	2	13	15	0	26	41	0	0
25	33963168	.	C	A	11	10	21	0	1	22	0	0
25	33963427	.	A	T	16	7	23	0	0	23	0	0
25	33964791	.	A	G	12	7	19	2	1	22	0	0
25	33964962	.	A	G	16	5	21	0	0	21	0	0
25	33964968	.	A	G	15	5	20	0	2	22	0	0
25	33965016	.	C	A	18	4	22	0	1	23	0	0
25	33965238	.	A	G	6	5	11	0	0	11	0	0
25	33965251	.	G	A	0	5	5	0	6	11	0	0
25	33965518	.	G	T	16	8	24	0	2	26	0	0
25	33965541	.	C	T	18	9	27	0	1	28	0	0
25	33965695	.	C	T	11	5	16	0	1	17	0	0
25	33965786	.	T	C	8	3	11	0	1	12	0	0
25	33965893	.	C	T	8	8	16	0	0	16	0	0
25	33965974	.	A	C	21	10	31	0	0	31	0	0
25	33966100	.	G	A	7	9	16	0	2	18	0	0
25	33966251	.	T	G	19	10	29	0	0	31	2	0
25	33966585	.	C	G	15	0	15	0	11	26	0	0
25	33966731	.	T	C	8	11	19	0	2	21	0	0
25	33966854	.	C	T	12	14	26	0	1	27	0	0
25	33966969	.	T	A	11	12	23	0	0	23	0	0
25	33967133	.	T	A	13	12	25	0	1	26	0	0
25	33967361	.	A	G	22	10	32	0	0	32	0	0
25	33967495	.	T	C	14	12	26	0	1	27	0	0
25	33967695	.	T	C	9	10	19	0	1	20	0	0
25	33967791	.	C	T	10	9	19	0	2	21	0	0
25	33967803	.	G	A	11	9	20	0	2	23	1	0
25	33968091	.	C	T	13	18	31	0	1	32	0	0
25	33968470	.	T	A	16	15	31	0	1	32	0	0
25	33968691	.	A	G	15	15	30	0	0	30	0	0
25	33968842	.	G	C	28	15	43	0	3	46	0	0
25	33968857	.	C	T	25	17	42	0	2	44	0	0
25	33968881	.	T	A	26	11	37	0	3	40	0	0
25	33983031	.	G	A	4	4	8	0	1	9	0	0
25	33983108	.	G	A	1	4	5	0	0	5	0	0
25	33983286	.	C	T	3	3	6	0	2	8	0	0
25	33983303	.	T	C	4	4	8	0	0	8	0	0
25	33988864	.	T	G	3	4	7	0	0	7	0	0
25	33988893	.	G	A	2	9	11	0	0	11	0	0
25	33988899	.	T	C	3	7	10	0	1	11	0	0
25	33988928	.	A	T	4	10	14	0	0	14	0	0
25	33991881	.	G	T	1	5	6	0	3	9	0	0
25	34002853	.	T	C	5	7	12	0	0	12	0	0
25	34014573	.	A	G	8	12	20	0	1	21	0	0
25	34018537	.	C	T	8	8	16	0	1	17	0	0
25	34020631	.	T	A	6	5	11	0	0	11	0	0
25	34022288	.	T	C	8	17	25	0	0	25	0	0
25	34022309	.	T	C	13	17	30	0	0	30	0	0
25	34027086	.	A	T	13	6	19	0	0	19	0	0
25	34027215	.	C	A	6	5	11	0	1	12	0	0
25	34027263	.	G	T	6	3	9	0	0	9	0	0
25	34154496	.	A	T	6	7	13	0	2	15	0	0
25	34154540	.	T	G	13	13	26	0	1	27	0	0
25	34154678	.	G	A	18	19	37	0	1	38	0	0
25	34246669	.	G	T	0	4	4	0	3	7	0	0
25	34246687	.	A	T	5	4	9	0	0	9	0	0
25	34247031	.	T	C	2	3	5	0	0	5	0	0
25	34247047	.	T	G	2	0	2	0	3	5	0	0
25	34257427	.	T	C	3	3	6	0	1	7	0	0
25	34257433	.	G	A	4	3	7	0	0	7	0	0
25	34260688	.	C	G	3	3	6	0	0	6	0	0
25	34267634	.	T	A	1	2	3	0	0	3	0	0
25	34267800	.	C	G	1	2	3	0	0	3	0	0
25	34267806	.	G	T	2	2	4	0	0	4	0	0
25	34268026	.	C	G	3	2	5	0	0	5	0	0
25	34268035	.	C	T	3	2	5	0	0	5	0	0
25	34956376	.	T	C	5	3	8	0	1	9	0	0
25	34972856	.	T	A	5	6	11	0	0	11	0	0
25	34973070	.	C	T	5	4	9	0	1	10	0	0
25	34979457	.	C	A	1	3	4	0	2	6	0	0
25	34979482	.	C	T	3	2	5	0	2	7	0	0
25	34979497	.	T	C	3	3	6	0	0	6	0	0
25	35002394	.	G	A	29	33	62	2	4	68	0	0
25	35005362	.	G	A	28	33	61	1	4	66	0	0
25	35006830	.	G	A	5	42	47	0	30	77	0	0
25	35006989	.	C	T	34	31	65	0	0	65	0	0
25	35007857	.	C	T	32	31	63	0	2	65	0	0
25	35007864	.	G	A	30	32	62	0	4	66	0	0
25	35244227	.	A	G	3	0	3	0	3	6	0	0
25	35270407	.	A	G	24	23	47	0	1	48	0	0
25	35450757	.	C	T	1	6	7	0	1	8	0	0
25	35467246	.	A	C	8	12	20	1	0	21	0	0
25	35467298	.	G	A	3	14	17	1	2	20	0	0
25	35542663	.	G	A	1	8	9	0	1	10	0	0
25	35678375	.	A	G	1	3	4	0	0	4	0	0
25	35713260	.	G	A	25	11	36	0	0	36	0	0
25	35713263	.	G	C	24	7	31	0	0	32	1	0
25	36199114	.	T	C	14	5	19	0	3	22	0	0
25	37335961	.	A	G	3	3	6	0	0	6	0	0
25	37470603	.	A	C	10	5	15	0	1	16	0	0
3	13937	.	C	T	7	6	13	12	0	25	0	0
3	13952	.	T	C	5	5	10	5	0	15	0	0
3	40869	.	G	C	2	8	10	4	1	15	0	0
3	146934	.	C	G	2	2	4	1	0	5	0	0
3	180618	.	C	A	0	5	5	0	0	5	0	0
3	240680	.	G	A	0	7	7	0	3	10	0	0
3	240735	.	C	A	6	13	19	0	2	21	0	0
3	248924	.	T	G	4	2	6	0	0	6	0	0
3	249464	.	A	G	5	3	8	1	0	9	0	0
3	249467	.	G	A	5	3	8	1	1	10	0	0
3	441365	.	A	G	6	2	8	2	0	10	0	0
3	1192748	.	A	G	23	6	29	0	1	30	0	0
3	1323879	.	T	A	3	7	10	0	1	11	0	0
3	1324383	.	G	T	1	2	3	0	2	5	0	0
3	1324509	.	C	A	8	1	9	0	2	11	0	0
3	1324515	.	C	T	11	4	15	0	0	15	0	0
3	1337593	.	A	G	11	8	19	0	2	21	0	0
3	1337674	.	T	C	6	1	7	0	13	20	0	0
3	1339147	.	T	A	16	10	26	0	3	29	0	0
3	1388845	.	T	C	10	6	16	0	35	51	0	0
3	1500004	.	A	T	11	14	25	0	0	25	0	0
3	3610150	.	A	T	2	8	10	0	0	10	0	0
3	3610185	.	C	A	12	7	19	0	1	20	0	0
3	3610202	.	A	T	10	6	16	0	1	17	0	0
3	3610224	.	C	T	7	6	13	1	0	14	0	0
3	3617633	.	G	A	1	10	11	0	10	21	0	0
3	3630587	.	T	C	8	12	20	0	1	21	0	0
3	3631407	.	T	C	13	11	24	0	1	25	0	0
3	3634408	.	G	A	19	9	28	0	5	33	0	0
3	3813805	.	G	A	6	7	13	0	0	13	0	0
3	3813838	.	C	T	5	9	14	0	0	14	0	0
3	3820708	.	T	C	3	5	8	0	0	8	0	0
3	4465966	.	T	C	3	2	5	0	0	5	0	0
3	4466011	.	A	G	2	3	5	0	0	5	0	0
3	4475886	.	G	C	1	0	1	0	2	3	0	0
3	4500852	.	C	A	3	2	5	0	0	5	0	0
3	4500860	.	C	T	3	2	5	0	0	5	0	0
3	4502158	.	C	A	14	14	28	0	1	29	0	0
3	4506897	.	A	G	6	13	19	0	1	20	0	0
3	4506961	.	G	A	0	10	10	0	7	17	0	0
3	4507825	.	T	C	11	8	19	0	0	19	0	0
3	4508042	.	A	C	11	13	24	0	1	25	0	0
3	4508093	.	C	A	10	10	20	0	4	24	0	0
3	4508120	.	C	T	17	13	30	0	0	30	0	0
3	4511020	.	C	T	17	12	29	0	0	29	0	0
3	4511052	.	T	C	11	14	25	0	1	26	0	0
3	4511163	.	A	G	9	0	9	0	6	15	0	0
3	4514030	.	G	A	7	7	14	0	0	14	0	0
3	4522767	.	A	G	5	0	5	1	14	20	0	0
3	4530061	.	G	A	12	6	18	0	1	19	0	0
3	4530118	.	T	A	4	5	9	0	0	9	0	0
3	4644400	.	A	G	4	2	6	0	0	6	0	0
3	4644469	.	A	C	1	2	3	0	0	3	0	0
3	4997559	.	C	T	7	2	9	0	0	9	0	0
3	4997623	.	C	T	6	7	13	0	1	14	0	0
3	4997917	.	A	T	6	6	12	0	2	14	0	0
3	5009112	.	G	C	15	1	16	0	10	27	1	0
3	5012832	.	C	G	0	20	20	0	10	30	0	0
3	5021432	.	G	A	16	6	22	2	1	25	0	0
3	5021453	.	C	T	0	13	13	2	12	27	0	0
3	5040591	.	A	G	10	6	16	0	1	17	0	0
3	5040757	.	A	G	4	5	9	0	1	10	0	0
3	5040798	.	A	C	3	9	12	0	1	13	0	0
3	5052823	.	T	G	6	15	21	1	0	22	0	0
3	5052868	.	G	A	14	15	29	6	0	35	0	0
3	5053060	.	C	T	4	18	22	0	28	50	0	0
3	5053454	.	T	A	15	25	40	0	2	42	0	0
3	5053934	.	G	A	19	25	44	0	0	44	0	0
3	5053988	.	C	G	30	21	51	0	2	53	0	0
3	5056247	.	G	A	21	21	42	0	3	45	0	0
3	5056390	.	A	T	30	25	55	2	1	58	0	0
3	5062827	.	C	T	25	27	52	0	0	52	0	0
3	5063125	.	G	A	15	25	40	0	1	41	0	0
3	5063176	.	G	A	20	18	38	0	1	39	0	0
3	5067581	.	T	A	11	18	29	0	0	29	0	0
3	5130791	.	C	A	7	10	17	0	1	18	0	0
3	5130851	.	T	C	8	18	26	0	1	27	0	0
3	5134113	.	G	A	8	15	23	0	2	25	0	0
3	5134122	.	G	A	16	8	24	0	1	25	0	0
3	5134669	.	T	C	12	9	21	0	0	21	0	0
3	5136617	.	G	A	7	6	13	0	0	13	0	0
3	5140851	.	A	G	11	13	24	0	2	26	0	0
3	5141035	.	C	T	10	14	24	0	2	26	0	0
3	5141152	.	C	T	8	13	21	1	1	23	0	0
3	5143119	.	C	T	8	6	14	0	0	14	0	0
3	5143522	.	C	T	8	12	20	0	0	20	0	0
3	5145139	.	C	A	1	4	5	0	8	13	0	0
3	5145797	.	C	T	0	3	3	0	14	17	0	0
3	5145988	.	G	A	7	4	11	0	0	11	0	0
3	5145991	.	T	C	6	0	6	0	4	10	0	0
3	5147544	.	G	A	7	3	10	0	0	10	0	0
3	5147606	.	G	T	12	7	19	0	0	19	0	0
3	5150391	.	G	A	5	3	8	0	0	8	0	0
3	5159345	.	G	A	7	4	11	0	0	11	0	0
3	5163352	.	C	T	5	3	8	0	0	8	0	0
3	5163418	.	C	G	3	5	8	0	1	9	0	0
3	5163442	.	G	T	4	3	7	0	1	8	0	0
3	5163826	.	C	T	1	4	5	0	4	9	0	0
3	5163889	.	G	A	2	6	8	0	0	8	0	0
3	5171303	.	G	T	2	6	8	1	0	9	0	0
3	5171431	.	C	A	1	1	2	0	2	4	0	0
3	5171449	.	G	C	2	0	2	0	3	5	0	0
3	5188128	.	T	C	1	1	2	6	2	10	0	0
3	5193439	.	C	T	1	4	5	1	0	6	0	0
3	5193511	.	T	C	1	0	1	2	5	8	0	0
3	5228084	.	A	G	5	3	8	0	3	11	0	0
3	5265411	.	T	C	7	4	11	0	1	12	0	0
3	5265412	.	T	C	7	5	12	0	0	12	0	0
3	5267221	.	G	A	7	19	26	2	0	28	0	0
3	5267251	.	C	T	4	14	18	2	1	21	0	0
3	5270274	.	C	T	1	17	18	0	19	37	0	0
3	5611576	.	T	C	4	3	7	0	0	7	0	0
3	5611600	.	A	G	4	3	7	0	0	7	0	0
3	5624487	.	C	T	4	9	13	0	22	35	0	0
3	5633056	.	A	G	17	15	32	0	0	32	0	0
3	5633089	.	G	A	19	18	37	0	0	37	0	0
3	5633122	.	A	G	14	18	32	0	2	34	0	0
3	5634976	.	A	G	17	16	33	0	0	33	0	0
3	5637213	.	A	C	20	11	31	0	1	32	0	0
3	5637222	.	A	G	22	11	33	0	1	34	0	0
3	5723632	.	A	G	1	2	3	0	0	3	0	0
3	5723652	.	A	T	1	2	3	0	0	3	0	0
3	5778981	.	G	A	8	8	16	0	1	17	0	0
3	5779044	.	T	A	3	13	16	0	1	17	0	0
3	5779093	.	G	T	12	14	26	0	0	26	0	0
3	5782501	.	A	G	9	10	19	0	0	19	0	0
3	5782715	.	A	G	7	11	18	0	0	18	0	0
3	5792569	.	T	A	14	4	18	0	0	18	0	0
3	5812205	.	C	T	10	6	16	0	1	17	0	0
3	5812802	.	C	T	2	7	9	0	14	23	0	0
3	5812813	.	G	A	9	5	14	0	7	21	0	0
3	5814475	.	C	T	6	9	15	0	0	15	0	0
3	5814478	.	C	T	5	9	14	0	1	15	0	0
3	5824826	.	T	C	3	10	13	0	0	13	0	0
3	5824858	.	C	T	7	4	11	0	0	11	0	0
3	5824870	.	C	T	6	8	14	0	1	15	0	0
3	5829415	.	A	G	5	4	9	0	0	9	0	0
3	5882661	.	T	C	0	4	4	0	1	5	0	0
3	5882912	.	A	T	2	5	7	0	0	7	0	0
3	5882973	.	T	C	2	6	8	0	0	8	0	0
3	5886917	.	C	T	4	22	26	0	29	55	0	0
3	5887223	.	T	C	21	16	37	0	2	39	0	0
3	5887463	.	T	G	20	23	43	0	3	46	0	0
3	5887661	.	A	T	30	17	47	0	0	47	0	0
3	5887673	.	G	C	27	3	30	0	21	51	0	0
3	5887715	.	T	C	24	23	47	0	1	48	0	0
3	5887841	.	T	A	21	29	50	0	3	54	1	0
3	5887931	.	A	T	24	15	39	0	5	44	0	0
3	5888245	.	C	T	21	16	37	0	2	39	0	0
3	5888664	.	G	A	12	21	33	0	1	34	0	0
3	5888868	.	G	A	20	15	35	0	4	39	0	0
3	5889077	.	G	T	20	15	35	0	0	35	0	0
3	5889302	.	T	C	21	12	33	0	1	34	0	0
3	5889642	.	A	T	15	12	27	0	1	28	0	0
3	5889983	.	A	G	8	6	14	0	0	14	0	0
3	5890274	.	T	A	15	19	34	0	0	34	0	0
3	5890287	.	A	G	13	18	31	0	4	35	0	0
3	5890698	.	C	T	2	28	30	0	16	46	0	0
3	5890833	.	G	A	26	18	44	0	5	49	0	0
3	5908262	.	C	T	13	20	33	0	1	34	0	0
3	5908302	.	T	C	13	0	13	0	20	33	0	0
3	5908452	.	T	C	18	1	19	0	23	42	0	0
3	5908569	.	C	A	3	23	26	0	17	43	0	0
3	5964113	.	G	A	8	10	18	0	2	20	0	0
3	5991798	.	C	T	0	5	5	0	1	6	0	0
3	5991822	.	G	A	2	5	7	0	0	7	0	0
3	5994984	.	C	T	10	11	21	0	0	21	0	0
3	5995038	.	A	G	5	9	14	0	0	14	0	0
3	5995071	.	A	G	6	5	11	0	0	11	0	0
3	6015843	.	A	G	5	6	11	0	0	11	0	0
3	6018562	.	A	G	6	5	11	0	0	11	0	0
3	6018622	.	G	A	2	3	5	0	1	6	0	0
3	6380368	.	T	C	28	17	45	3	0	48	0	0
3	6417172	.	G	A	23	29	52	0	3	55	0	0
3	6444075	.	C	A	5	4	9	0	1	10	0	0
3	6454507	.	G	A	2	2	4	0	0	4	0	0
3	6457308	.	T	G	2	3	5	0	0	5	0	0
3	6460039	.	G	T	5	3	8	0	0	8	0	0
3	6474593	.	A	G	5	5	10	0	0	10	0	0
3	6477596	.	G	C	5	4	9	0	0	9	0	0
3	6491011	.	T	G	6	6	12	1	0	13	0	0
3	6491540	.	C	T	8	6	14	1	0	15	0	0
3	6491542	.	G	T	9	5	14	1	0	16	1	0
3	6491670	.	C	T	5	7	12	1	0	13	0	0
3	6491820	.	A	T	7	7	14	0	2	16	0	0
3	6491833	.	A	G	10	10	20	0	0	20	0	0
3	6491881	.	G	T	9	16	25	0	0	25	0	0
3	6491906	.	T	C	6	13	19	0	0	19	0	0
3	6495017	.	G	A	7	9	16	0	1	17	0	0
3	6498049	.	C	G	1	16	17	0	13	30	0	0
3	6499606	.	T	C	7	1	8	0	9	17	0	0
3	6499636	.	A	G	6	9	15	0	1	16	0	0
3	6502039	.	G	A	11	10	21	0	0	21	0	0
3	6504814	.	T	A	8	13	21	0	1	22	0	0
3	6505007	.	G	T	6	8	14	0	0	14	0	0
3	6505010	.	T	C	6	8	14	0	0	14	0	0
3	6515014	.	C	G	7	7	14	0	0	14	0	0
3	6515029	.	A	G	8	10	18	0	0	18	0	0
3	6516457	.	C	T	2	8	10	0	10	20	0	0
3	6608024	.	C	A	1	2	3	0	0	3	0	0
3	6639871	.	G	C	2	3	5	1	0	6	0	0
3	6659702	.	G	A	0	6	6	0	5	11	0	0
3	6659843	.	C	T	2	5	7	0	0	7	0	0
3	6663606	.	G	A	1	4	5	0	0	5	0	0
3	6664358	.	T	G	3	4	7	0	0	7	0	0
3	6664603	.	A	G	2	10	12	0	0	12	0	0
3	6664609	.	T	C	5	6	11	0	1	12	0	0
3	6664915	.	A	G	2	3	5	0	0	5	0	0
3	6664943	.	A	G	1	2	3	0	0	3	0	0
3	6665902	.	G	T	6	5	11	0	0	11	0	0
3	6665912	.	A	G	9	4	13	0	0	13	0	0
3	6665951	.	C	A	8	5	13	0	1	14	0	0
3	6665985	.	A	T	7	5	12	0	2	14	0	0
3	6666027	.	C	T	5	8	13	0	0	13	0	0
3	6666080	.	A	G	7	8	15	0	0	15	0	0
3	6666092	.	T	C	9	9	18	0	0	18	0	0
3	6666194	.	G	C	13	8	21	0	0	21	0	0
3	6666283	.	A	T	3	7	10	0	3	13	0	0
3	6666342	.	A	G	6	3	9	0	0	9	0	0
3	6666362	.	G	A	4	6	10	0	1	11	0	0
3	6666689	.	T	C	3	6	9	0	0	9	0	0
3	6666691	.	T	C	6	3	9	0	0	9	0	0
3	6666730	.	C	T	2	3	5	0	0	5	0	0
3	6666846	.	T	C	2	2	4	0	0	4	0	0
3	6667060	.	G	C	19	10	29	0	0	29	0	0
3	6667209	.	C	T	11	3	14	0	1	15	0	0
3	6667771	.	G	T	1	1	2	0	0	2	0	0
3	6667781	.	G	T	1	2	3	0	0	3	0	0
3	6721278	.	A	G	4	6	10	0	0	10	0	0
3	6721286	.	G	C	3	6	9	0	0	9	0	0
3	6721421	.	T	G	12	5	17	0	1	18	0	0
3	6721456	.	A	T	7	2	9	0	1	10	0	0
3	6721497	.	T	A	1	5	6	0	1	7	0	0
3	6721504	.	A	T	2	5	7	0	1	8	0	0
3	6721763	.	T	C	5	6	11	0	0	11	0	0
3	6721773	.	T	G	7	7	14	0	0	14	0	0
3	6721851	.	C	T	9	4	13	0	0	13	0	0
3	6722021	.	T	A	9	8	17	0	0	17	0	0
3	6722070	.	C	G	10	5	15	0	0	15	0	0
3	6722333	.	C	A	4	7	11	1	2	14	0	0
3	6722341	.	G	A	6	10	16	0	0	16	0	0
3	6722401	.	T	C	10	14	24	0	0	24	0	0
3	6722438	.	C	T	10	8	18	0	0	18	0	0
3	6722487	.	T	G	4	2	6	0	1	7	0	0
3	6723257	.	A	G	5	8	13	3	0	16	0	0
3	6725130	.	C	T	9	7	16	0	2	18	0	0
3	6725150	.	G	C	3	8	11	0	0	11	0	0
3	6725378	.	A	T	9	6	15	0	0	16	1	0
3	6725497	.	C	T	2	2	4	0	3	7	0	0
3	6725699	.	C	G	2	4	6	0	7	13	0	0
3	6725704	.	A	G	8	5	13	0	1	14	0	0
3	6725737	.	T	A	9	5	14	0	0	14	0	0
3	6725951	.	A	G	4	4	8	0	0	8	0	0
3	6726004	.	A	G	6	2	8	0	0	8	0	0
3	6726053	.	T	C	8	8	16	0	1	17	0	0
3	6726170	.	G	T	9	12	21	0	0	21	0	0
3	6726284	.	A	T	6	15	21	0	1	22	0	0
3	6726323	.	T	G	6	15	21	0	1	22	0	0
3	6726359	.	G	A	8	18	26	0	0	26	0	0
3	6727154	.	C	T	2	17	19	0	9	28	0	0
3	6731289	.	G	T	5	11	16	0	0	16	0	0
3	6732346	.	T	A	5	2	7	0	0	7	0	0
3	6732696	.	G	A	7	2	9	0	1	10	0	0
3	6732697	.	C	T	2	3	5	0	5	10	0	0
3	6737079	.	G	A	9	10	19	0	0	19	0	0
3	6737099	.	G	T	11	11	22	0	0	22	0	0
3	6744653	.	A	G	5	6	11	0	1	12	0	0
3	6895940	.	A	T	3	4	7	0	0	7	0	0
3	6895972	.	A	G	2	2	4	0	0	4	0	0
3	6993551	.	G	A	0	1	1	0	1	2	0	0
3	6993563	.	G	A	1	2	3	0	0	3	0	0
3	7008220	.	G	T	1	2	3	0	0	3	0	0
3	7008234	.	G	A	1	4	5	0	0	5	0	0
3	7008290	.	C	T	2	6	8	0	0	8	0	0
3	7008415	.	C	T	3	5	8	0	1	9	0	0
3	7008690	.	C	A	1	2	3	0	0	3	0	0
3	7081625	.	C	T	0	2	2	0	2	4	0	0
3	7099049	.	C	T	1	3	4	0	0	4	0	0
3	7099160	.	A	G	4	5	9	1	0	10	0	0
3	7099285	.	G	T	5	4	9	0	0	9	0	0
3	7099344	.	A	G	3	8	11	0	0	11	0	0
3	7099452	.	T	C	3	0	3	0	5	8	0	0
3	7099460	.	T	G	2	5	7	0	0	7	0	0
3	7099600	.	T	C	3	3	6	0	1	7	0	0
3	7099704	.	A	T	2	5	7	0	0	7	0	0
3	7099710	.	T	G	2	4	6	0	0	6	0	0
3	7112990	.	C	T	0	4	4	1	7	12	0	0
3	7113036	.	G	T	10	4	14	1	0	15	0	0
3	7113075	.	T	G	5	4	9	0	1	10	0	0
3	7113126	.	A	G	4	5	9	0	0	9	0	0
3	7113327	.	T	C	3	0	3	0	5	8	0	0
3	7113330	.	T	C	3	4	7	0	0	7	0	0
3	7113424	.	G	C	2	5	7	0	0	7	0	0
3	7113433	.	T	C	1	5	6	0	0	6	0	0
3	7113465	.	A	G	2	3	5	0	0	5	0	0
3	7113660	.	A	G	5	4	9	0	0	9	0	0
3	7113669	.	C	T	4	6	10	0	0	10	0	0
3	7113720	.	G	A	4	8	12	0	0	12	0	0
3	7113821	.	A	T	7	2	9	0	0	9	0	0
3	7113822	.	A	G	6	3	9	0	0	9	0	0
3	7113934	.	A	G	5	5	10	5	1	16	0	0
3	7124140	.	G	A	5	4	9	0	0	9	0	0
3	7124437	.	A	G	2	2	4	0	1	5	0	0
3	7124584	.	G	T	5	3	8	0	0	8	0	0
3	7124585	.	G	T	4	3	7	0	1	8	0	0
3	7124659	.	C	T	7	4	11	0	0	11	0	0
3	7124705	.	C	T	5	3	8	1	0	9	0	0
3	7128979	.	A	G	6	3	9	0	0	9	0	0
3	7133388	.	G	A	2	6	8	1	0	9	0	0
3	7133435	.	T	G	1	6	7	0	0	7	0	0
3	7133743	.	A	G	6	4	10	0	1	11	0	0
3	7133751	.	A	G	5	5	10	0	0	10	0	0
3	7133967	.	G	A	2	4	6	0	0	6	0	0
3	7141369	.	T	C	1	5	6	0	0	6	0	0
3	7141527	.	G	T	5	7	12	0	1	14	1	0
3	7141562	.	A	T	3	5	8	0	0	8	0	0
3	7141846	.	G	A	4	4	8	1	0	9	0	0
3	7141924	.	G	A	6	3	9	0	1	10	0	0
3	7141981	.	C	T	2	4	6	0	0	6	0	0
3	7142411	.	T	G	8	2	10	0	1	11	0	0
3	7142442	.	T	C	5	3	8	0	0	8	0	0
3	7142473	.	C	T	5	2	7	2	1	10	0	0
3	7155012	.	T	C	1	0	1	0	3	4	0	0
3	7155039	.	T	C	1	3	4	0	0	4	0	0
3	7155156	.	C	T	9	4	13	1	0	14	0	0
3	7155196	.	T	A	7	10	17	0	0	17	0	0
3	7155198	.	A	G	7	8	15	0	2	17	0	0
3	7155428	.	G	A	6	6	12	0	0	12	0	0
3	7156035	.	C	T	4	9	13	0	0	13	0	0
3	7156141	.	C	T	4	3	7	0	0	7	0	0
3	7160634	.	G	A	3	2	5	2	0	7	0	0
3	7160637	.	T	C	3	2	5	2	0	7	0	0
3	7263924	.	T	G	1	2	3	2	0	5	0	0
3	7276770	.	A	C	1	0	1	0	3	4	0	0
3	7277080	.	G	C	1	2	3	0	0	3	0	0
3	7509800	.	T	A	3	2	5	0	0	5	0	0
3	7511290	.	T	C	2	2	4	0	0	4	0	0
3	7638510	.	A	G	10	4	14	0	0	14	0	0
3	8323624	.	G	A	1	4	5	0	0	5	0	0
3	8399709	.	A	G	5	5	10	0	1	11	0	0
3	8399799	.	C	T	9	8	17	0	0	17	0	0
3	9380616	.	C	T	1	2	3	1	0	4	0	0
3	9380619	.	T	A	1	1	2	1	1	4	0	0
3	9752734	.	C	T	0	5	5	0	1	6	0	0
3	10163116	.	G	A	0	4	4	0	3	7	0	0
3	10163153	.	C	A	2	3	5	0	0	5	0	0
3	10163287	.	C	G	6	0	6	0	7	13	0	0
3	10163302	.	T	C	7	4	11	0	0	11	0	0
3	10163785	.	A	G	6	1	7	0	5	12	0	0
3	10163815	.	G	A	6	6	12	0	0	12	0	0
3	10163971	.	G	A	1	4	5	0	0	5	0	0
3	10164025	.	C	T	3	5	8	0	0	8	0	0
3	10164338	.	C	G	2	4	6	0	0	6	0	0
3	10164352	.	A	C	2	4	6	0	0	6	0	0
3	10311956	.	G	T	2	2	4	0	1	5	0	0
3	10411054	.	T	C	3	2	5	0	0	5	0	0
3	10421097	.	A	G	1	4	5	0	0	5	0	0
3	11548516	.	C	T	8	7	15	0	0	15	0	0
3	11554135	.	A	G	11	0	11	0	9	20	0	0
3	11554141	.	T	C	10	9	19	0	1	20	0	0
3	11558287	.	G	A	5	6	11	0	1	12	0	0
3	11575354	.	G	A	0	11	11	0	8	19	0	0
3	11575471	.	T	C	13	7	20	0	0	20	0	0
3	11575591	.	C	A	5	14	19	1	2	22	0	0
3	11575675	.	C	G	3	16	19	0	0	19	0	0
3	11575946	.	C	T	4	2	6	0	0	6	0	0
3	11575955	.	T	A	1	4	5	0	0	5	0	0
3	11576127	.	C	T	4	2	6	0	0	6	0	0
3	11585488	.	T	A	26	12	38	0	5	43	0	0
3	11585492	.	G	A	28	13	41	0	3	44	0	0
3	11585549	.	T	C	5	11	16	0	0	16	0	0
3	11585815	.	A	G	14	8	22	0	0	22	0	0
3	11585852	.	T	A	11	9	20	0	0	20	0	0
3	11585937	.	G	A	17	12	29	0	1	30	0	0
3	11586227	.	C	A	9	3	12	0	1	13	0	0
3	11586331	.	C	T	4	17	21	0	24	45	0	0
3	11586346	.	C	T	27	18	45	0	2	47	0	0
3	11586382	.	G	A	32	15	47	0	2	49	0	0
3	11586635	.	A	G	29	12	41	0	3	44	0	0
3	11586679	.	C	T	27	9	36	2	0	38	0	0
3	11586695	.	C	T	1	5	6	4	17	27	0	0
3	11590280	.	A	G	11	24	35	0	4	39	0	0
3	11614970	.	T	C	29	13	42	0	5	47	0	0
3	11615007	.	A	T	33	18	51	0	3	54	0	0
3	11615041	.	T	C	35	0	35	0	21	56	0	0
3	11615109	.	G	A	27	23	50	0	1	51	0	0
3	11615133	.	A	G	32	21	53	0	2	55	0	0
3	11615224	.	A	G	37	15	52	0	3	55	0	0
3	11624298	.	A	G	26	14	40	0	1	41	0	0
3	11781003	.	A	C	27	9	36	2	1	39	0	0
3	11781079	.	T	C	19	9	28	1	1	30	0	0
3	11781113	.	G	A	25	18	43	0	3	46	0	0
3	11784743	.	G	A	21	17	38	0	10	48	0	0
3	11797076	.	C	T	2	13	15	0	13	28	0	0
3	11947254	.	A	G	19	5	24	0	1	25	0	0
3	11947261	.	A	G	18	6	24	0	0	24	0	0
3	13166099	.	T	C	1	3	4	0	0	4	0	0
3	13166108	.	T	C	2	3	5	0	0	5	0	0
3	13424418	.	T	A	5	3	8	0	0	8	0	0
3	13424467	.	C	A	6	4	10	0	0	10	0	0
3	13424595	.	A	T	2	5	7	0	0	7	0	0
3	13424601	.	T	G	3	4	7	0	0	7	0	0
3	13424635	.	G	A	1	3	4	0	0	4	0	0
3	13424738	.	A	T	2	3	5	0	0	5	0	0
3	13424739	.	A	T	2	3	5	0	0	5	0	0
3	13424808	.	C	A	1	3	4	0	8	12	0	0
3	13424817	.	G	T	8	4	12	0	0	12	0	0
3	13424847	.	G	T	9	6	15	0	0	15	0	0
3	13424877	.	T	C	8	6	14	0	0	14	0	0
3	13424919	.	T	C	7	10	17	0	1	18	0	0
3	13424950	.	A	T	8	17	25	0	2	27	0	0
3	13424968	.	C	T	10	15	25	0	0	25	0	0
3	13424989	.	C	A	1	13	14	0	13	27	0	0
3	13426691	.	G	A	11	15	26	0	0	26	0	0
3	13426754	.	C	A	0	12	12	0	3	15	0	0
3	13430606	.	A	G	9	14	23	0	2	25	0	0
3	13431327	.	G	A	18	13	31	0	1	32	0	0
3	13432609	.	C	T	14	12	26	0	2	28	0	0
3	13434860	.	C	T	1	10	11	1	14	26	0	0
3	13434888	.	A	G	14	14	28	0	1	29	0	0
3	13434920	.	C	G	10	16	26	0	0	26	0	0
3	13434930	.	A	T	8	15	23	0	1	24	0	0
3	13437767	.	G	A	8	8	16	0	1	17	0	0
3	13441459	.	G	A	4	6	10	0	11	21	0	0
3	13445758	.	G	A	2	4	6	0	5	11	0	0
3	13445819	.	T	C	1	6	7	0	0	7	0	0
3	13445884	.	T	G	6	4	10	0	0	10	0	0
3	13446019	.	C	T	3	3	6	0	0	6	0	0
3	13447870	.	C	T	7	13	20	0	2	22	0	0
3	13453494	.	C	T	6	12	18	0	0	18	0	0
3	13453500	.	A	G	5	11	16	0	1	17	0	0
3	13455893	.	T	C	5	0	5	0	5	10	0	0
3	13456064	.	C	T	1	2	3	0	4	7	0	0
3	13456108	.	G	T	4	2	6	0	0	6	0	0
3	13456214	.	A	G	2	3	5	0	0	5	0	0
3	13456303	.	G	A	3	6	9	0	1	10	0	0
3	13456316	.	T	C	4	4	8	0	0	8	0	0
3	13456436	.	A	G	3	4	7	0	0	7	0	0
3	13456472	.	C	T	0	4	4	0	6	10	0	0
3	13456492	.	T	C	4	6	10	0	1	11	0	0
3	13458400	.	T	C	6	0	6	0	6	12	0	0
3	13458430	.	C	T	0	2	2	0	6	8	0	0
3	13458443	.	G	A	4	4	8	0	0	8	0	0
3	13459669	.	A	G	1	2	3	0	0	3	0	0
3	13459678	.	G	C	1	0	1	0	2	3	0	0
3	13488422	.	C	T	4	2	6	0	0	6	0	0
3	13502218	.	T	G	2	3	5	0	0	5	0	0
3	13502219	.	A	T	2	3	5	0	0	5	0	0
3	13502299	.	A	C	0	2	2	0	1	3	0	0
3	13525775	.	T	A	2	2	4	0	0	4	0	0
3	13525976	.	C	G	1	8	9	0	0	9	0	0
3	13526043	.	A	G	1	5	6	0	0	6	0	0
3	13534291	.	C	T	0	5	5	0	3	8	0	0
3	13534311	.	G	C	6	3	9	0	0	9	0	0
3	13534339	.	C	T	2	6	8	0	5	13	0	0
3	13535786	.	A	T	4	2	6	0	0	6	0	0
3	13535827	.	C	T	1	5	6	0	2	8	0	0
3	13541879	.	C	T	1	4	5	0	3	8	0	0
3	13542252	.	C	T	6	4	10	0	0	10	0	0
3	13582156	.	T	C	12	11	23	0	0	23	0	0
3	13582181	.	G	A	15	11	26	0	0	26	0	0
3	13582217	.	G	T	19	10	29	0	0	29	0	0
3	13582220	.	A	T	17	8	25	0	2	27	0	0
3	13582288	.	A	T	19	11	30	1	1	32	0	0
3	13582295	.	T	A	14	11	25	1	4	30	0	0
3	13582547	.	C	G	1	18	19	0	14	33	0	0
3	13589391	.	G	T	15	19	34	0	0	34	0	0
3	13589412	.	G	A	13	18	31	0	1	32	0	0
3	13589469	.	A	G	10	19	29	0	2	31	0	0
3	13590995	.	G	A	10	16	26	0	3	29	0	0
3	13593605	.	C	T	17	15	32	0	0	32	0	0
3	13595100	.	A	G	10	10	20	0	0	20	0	0
3	13595245	.	G	A	10	13	23	0	0	23	0	0
3	13595686	.	C	T	16	19	35	0	1	36	0	0
3	13599436	.	A	G	12	8	20	0	0	20	0	0
3	13603365	.	T	G	5	7	12	0	1	13	0	0
3	13607036	.	G	A	1	4	5	0	4	9	0	0
3	13607051	.	T	C	5	7	12	0	0	12	0	0
3	13608054	.	A	G	2	0	2	0	8	10	0	0
3	13608153	.	A	G	5	2	7	0	0	7	0	0
3	13609168	.	T	A	3	9	12	0	0	12	0	0
3	13618095	.	A	G	2	4	6	0	0	6	0	0
3	13618115	.	G	A	0	4	4	0	2	6	0	0
3	13618157	.	T	G	2	3	5	0	0	5	0	0
3	13618203	.	A	T	2	4	6	0	0	6	0	0
3	13651226	.	T	C	5	2	7	0	0	7	0	0
3	14450993	.	A	G	9	12	21	0	0	21	0	0
3	14451012	.	A	G	10	13	23	0	0	23	0	0
3	14451642	.	A	G	6	6	12	0	1	13	0	0
3	14497004	.	T	C	7	24	31	0	1	32	0	0
3	14497015	.	T	C	26	8	34	0	1	35	0	0
3	14580728	.	G	A	1	6	7	0	0	7	0	0
3	14860158	.	C	T	14	15	29	0	2	31	0	0
3	15057191	.	A	T	13	22	35	0	4	39	0	0
3	15057214	.	G	T	18	24	42	0	3	45	0	0
3	15057321	.	T	C	15	18	33	0	2	35	0	0
3	15057549	.	T	G	15	19	34	0	2	36	0	0
3	15057656	.	G	A	2	16	18	0	19	37	0	0
3	15057696	.	T	C	18	11	29	0	1	30	0	0
3	15057928	.	G	A	11	10	21	0	0	21	0	0
3	15058259	.	G	T	14	16	30	0	0	30	0	0
3	15058323	.	A	G	17	8	25	0	1	26	0	0
3	15085420	.	G	T	1	0	1	0	5	6	0	0
3	15085422	.	G	A	0	4	4	0	1	5	0	0
3	15085528	.	C	T	5	5	10	0	0	10	0	0
3	15085530	.	G	T	5	4	9	0	1	10	0	0
3	15085673	.	G	A	4	15	19	0	0	19	0	0
3	15085784	.	G	C	13	10	23	0	1	24	0	0
3	15085821	.	C	T	12	6	18	0	2	20	0	0
3	15091183	.	C	T	1	7	8	0	6	14	0	0
3	15098847	.	A	G	8	6	14	0	1	15	0	0
3	15098913	.	C	G	2	7	9	0	0	9	0	0
3	15391552	.	G	C	3	6	9	0	26	35	0	0
3	15391564	.	G	C	4	3	7	0	30	37	0	0
3	15629022	.	T	C	9	7	16	0	0	16	0	0
3	15988337	.	A	G	22	19	41	6	2	49	0	0
3	16020756	.	C	T	0	2	2	0	2	4	0	0
3	16389180	.	G	T	8	5	13	0	2	15	0	0
3	16389517	.	C	T	18	6	24	0	2	26	0	0
3	16391695	.	G	A	8	10	18	0	1	19	0	0
3	16391719	.	T	C	5	0	5	0	9	14	0	0
3	16394522	.	A	G	6	7	13	0	1	14	0	0
3	16395548	.	A	G	14	8	22	0	2	24	0	0
3	16397627	.	A	T	8	12	20	0	0	20	0	0
3	16404204	.	T	C	7	7	14	0	2	16	0	0
3	16404370	.	G	A	5	6	11	0	0	11	0	0
3	16404382	.	G	A	6	5	11	0	0	11	0	0
3	16404406	.	G	C	6	7	13	0	0	13	0	0
3	16408960	.	A	G	3	5	8	0	0	8	0	0
3	16409330	.	G	A	6	6	12	0	0	12	0	0
3	16409485	.	C	A	0	7	7	0	6	13	0	0
3	16409491	.	T	A	4	7	11	0	2	13	0	0
3	16409551	.	A	G	5	6	11	0	0	11	0	0
3	16411173	.	C	T	1	2	3	0	1	4	0	0
3	16644872	.	C	T	11	12	23	0	1	24	0	0
3	16648459	.	G	T	13	13	26	0	0	26	0	0
3	16650129	.	G	A	12	6	18	0	0	18	0	0
3	16664476	.	T	C	6	4	10	0	0	10	0	0
3	16668614	.	G	A	2	9	11	0	4	15	0	0
3	16668671	.	C	T	11	8	19	0	0	19	0	0
3	16671903	.	G	A	0	13	13	0	7	20	0	0
3	16678754	.	G	A	2	5	7	0	17	24	0	0
3	16679136	.	C	T	8	9	17	0	1	18	0	0
3	16679248	.	C	T	4	9	13	0	0	13	0	0
3	16679331	.	T	C	4	9	13	0	0	13	0	0
3	16679349	.	G	A	4	5	9	0	1	10	0	0
3	16679387	.	G	A	6	3	9	0	0	9	0	0
3	16679520	.	G	A	7	4	11	0	1	12	0	0
3	16679556	.	G	A	0	3	3	0	5	8	0	0
3	16679561	.	A	G	5	0	5	0	4	9	0	0
3	16679820	.	C	T	3	4	7	0	0	7	0	0
3	16692232	.	A	G	5	4	9	0	0	9	0	0
3	16696150	.	T	C	0	0	0	0	3	3	0	0
3	16696215	.	G	A	1	2	3	0	0	3	0	0
3	16717961	.	C	A	2	2	4	0	0	4	0	0
3	16729101	.	G	A	11	8	19	0	1	20	0	0
3	16731938	.	A	G	12	0	12	0	9	21	0	0
3	16733790	.	C	T	7	7	14	0	0	14	0	0
3	16735384	.	T	C	4	5	9	0	0	9	0	0
3	16735423	.	C	T	5	5	10	0	0	10	0	0
3	16735507	.	C	T	4	8	12	0	0	12	0	0
3	16738857	.	T	A	10	8	18	0	0	18	0	0
3	16741179	.	A	C	11	10	21	0	0	21	0	0
3	16741830	.	A	G	6	10	16	0	1	17	0	0
3	16741851	.	T	C	9	10	19	0	1	20	0	0
3	16746756	.	G	A	1	7	8	0	0	8	0	0
3	16746796	.	G	A	4	3	7	0	1	8	0	0
3	16746947	.	A	T	13	5	18	0	1	19	0	0
3	16747229	.	A	G	6	0	6	0	4	10	0	0
3	16747233	.	G	T	0	4	4	0	6	10	0	0
3	16841984	.	C	A	6	3	9	0	1	10	0	0
3	16842343	.	G	A	4	4	8	0	1	9	0	0
3	16872842	.	T	C	1	2	3	0	0	3	0	0
3	16972226	.	C	A	1	2	3	0	0	3	0	0
3	16972949	.	T	A	1	2	3	0	0	3	0	0
3	16972991	.	T	C	1	4	5	0	0	5	0	0
3	17070052	.	G	A	1	5	6	0	2	8	0	0
3	17070259	.	A	G	3	3	6	0	3	9	0	0
3	17074268	.	A	G	4	4	8	0	0	8	0	0
3	17074430	.	A	C	2	4	6	0	0	6	0	0
3	17074469	.	A	T	1	7	8	0	0	8	0	0
3	17090941	.	G	A	5	5	10	0	0	10	0	0
3	17093097	.	T	C	11	10	21	0	0	21	0	0
3	17107026	.	A	T	5	2	7	0	0	7	0	0
3	17289476	.	G	A	3	2	5	0	1	6	0	0
3	17289515	.	G	A	0	5	5	0	2	7	0	0
3	17315024	.	G	A	0	2	2	0	4	6	0	0
3	17318089	.	T	C	2	2	4	0	0	4	0	0
3	17318146	.	C	T	4	2	6	0	0	6	0	0
3	17457157	.	A	T	6	6	12	0	0	12	0	0
3	17457475	.	T	C	4	3	7	0	1	8	0	0
3	17457550	.	G	T	1	3	4	0	0	4	0	0
3	17458054	.	C	T	4	5	9	0	0	9	0	0
3	17458183	.	A	T	3	5	8	0	0	8	0	0
3	17458888	.	A	G	11	0	11	0	10	21	0	0
3	17458960	.	C	T	8	7	15	0	1	16	0	0
3	17488995	.	A	G	11	0	11	0	8	19	0	0
3	17489004	.	A	T	9	6	15	0	2	17	0	0
3	17600108	.	G	T	1	7	8	0	2	10	0	0
3	17600190	.	C	T	6	3	9	0	0	9	0	0
3	17600201	.	C	T	6	4	10	0	0	10	0	0
3	17600702	.	C	T	3	3	6	0	0	6	0	0
3	17600870	.	A	T	5	4	9	0	0	9	0	0
3	17600916	.	T	C	4	4	8	0	0	8	0	0
3	17601239	.	A	C	4	3	7	0	0	7	0	0
3	17601247	.	C	T	4	2	6	0	0	6	0	0
3	17601346	.	C	T	3	4	7	0	1	8	0	0
3	17601383	.	A	C	3	4	7	0	0	7	0	0
3	17601473	.	T	G	4	4	8	0	0	8	0	0
3	17603313	.	A	G	4	3	7	0	0	7	0	0
3	17603512	.	T	C	2	2	4	0	0	4	0	0
3	17603558	.	G	A	1	2	3	0	0	3	0	0
3	17603926	.	T	C	1	2	3	0	0	3	0	0
3	17650983	.	G	A	19	29	48	0	2	50	0	0
3	17651208	.	C	A	20	19	39	0	7	46	0	0
3	17651508	.	G	A	12	20	32	0	1	33	0	0
3	17651718	.	C	T	21	18	39	0	2	41	0	0
3	17651837	.	C	T	9	12	21	0	0	21	0	0
3	17651847	.	C	A	13	3	16	0	3	19	0	0
3	17653924	.	T	C	4	8	12	0	1	13	0	0
3	17660156	.	C	T	5	10	15	0	1	16	0	0
3	17663630	.	C	G	4	3	7	0	0	7	0	0
3	17668976	.	A	T	9	3	12	0	0	12	0	0
3	17669406	.	G	A	3	9	12	0	0	12	0	0
3	17669427	.	A	G	2	7	9	0	1	10	0	0
3	17669502	.	T	A	4	7	11	0	0	11	0	0
3	17671567	.	C	T	6	6	12	0	0	12	0	0
3	17671843	.	G	A	6	3	9	0	1	10	0	0
3	17671888	.	G	A	8	3	11	0	0	11	0	0
3	17671897	.	T	C	6	3	9	0	0	9	0	0
3	17673250	.	C	T	9	7	16	0	0	16	0	0
3	17678335	.	T	C	12	11	23	0	0	23	0	0
3	17744438	.	T	A	6	8	14	0	0	14	0	0
3	17744500	.	T	C	6	1	7	0	0	7	0	0
3	17867319	.	A	G	1	3	4	0	0	4	0	0
3	17867334	.	A	G	2	4	6	0	0	6	0	0
3	17867440	.	T	C	11	4	15	0	0	15	0	0
3	17867716	.	C	A	7	8	15	0	0	15	0	0
3	17867870	.	T	C	7	9	16	0	1	17	0	0
3	17868174	.	T	G	5	9	14	0	0	14	0	0
3	17868669	.	C	A	11	4	15	0	0	15	0	0
3	17868673	.	A	G	9	4	13	0	1	14	0	0
3	17868710	.	T	C	6	11	17	0	0	17	0	0
3	17868776	.	C	T	4	6	10	0	1	11	0	0
3	17868949	.	G	C	11	13	24	0	2	26	0	0
3	17869030	.	G	C	6	20	26	0	1	27	0	0
3	17869300	.	G	A	17	10	27	0	0	27	0	0
3	17871801	.	G	T	3	3	6	0	0	6	0	0
3	17878505	.	A	G	26	10	36	0	3	39	0	0
3	17886528	.	G	A	22	20	42	0	3	45	0	0
3	17886996	.	C	T	17	14	31	0	1	32	0	0
3	17943332	.	A	G	11	4	15	0	0	15	0	0
3	18562418	.	T	C	2	11	13	0	0	13	0	0
3	18686781	.	T	C	19	0	19	0	23	42	0	0
3	18838559	.	T	A	6	4	10	0	0	10	0	0
3	18838595	.	T	A	7	6	13	0	2	15	0	0
3	18838878	.	C	T	3	4	7	0	0	7	0	0
3	18839017	.	C	T	6	3	9	0	0	9	0	0
3	18866315	.	A	C	3	2	5	0	0	5	0	0
3	18922801	.	G	A	2	3	5	0	0	5	0	0
3	18922819	.	C	T	3	3	6	0	0	6	0	0
3	18923209	.	C	A	3	3	6	0	0	6	0	0
3	18923246	.	A	G	2	4	6	0	0	6	0	0
3	18923586	.	C	G	3	0	3	0	4	7	0	0
3	18923601	.	T	C	3	4	7	0	0	7	0	0
3	19006010	.	G	A	8	10	18	0	0	18	0	0
3	19006388	.	G	A	12	23	35	0	0	35	0	0
3	19019232	.	A	G	6	5	11	0	0	11	0	0
3	19042691	.	A	C	5	9	14	0	1	15	0	0
3	19068868	.	G	A	4	9	13	0	0	13	0	0
3	19090629	.	A	G	4	4	8	0	0	8	0	0
3	19090695	.	A	G	4	5	9	0	0	9	0	0
3	19090884	.	A	G	6	7	13	0	1	14	0	0
3	19132983	.	T	C	1	3	4	0	0	4	0	0
3	19162582	.	A	G	6	9	15	0	1	16	0	0
3	19162654	.	A	G	10	11	21	0	0	21	0	0
3	19162663	.	A	G	10	10	20	0	0	20	0	0
3	19162717	.	A	G	10	11	21	0	1	22	0	0
3	19172078	.	A	G	8	4	12	0	1	13	0	0
3	19172087	.	C	T	0	3	3	0	11	14	0	0
3	19172284	.	G	T	12	5	17	0	1	18	0	0
3	19180634	.	G	A	10	4	14	0	0	14	0	0
3	19180650	.	C	G	8	4	12	0	0	12	0	0
3	19180775	.	C	A	8	4	12	0	0	12	0	0
3	19180778	.	A	G	8	4	12	0	0	12	0	0
3	19180811	.	C	T	7	4	11	0	1	12	0	0
3	19194126	.	C	T	1	10	11	0	4	15	0	0
3	19194135	.	A	T	5	9	14	0	0	14	0	0
3	19200437	.	C	T	7	4	11	0	0	11	0	0
3	19207219	.	A	G	9	0	9	0	8	17	0	0
3	19210238	.	T	C	7	16	23	0	3	26	0	0
3	19210287	.	A	G	13	0	13	0	15	28	0	0
3	19210352	.	A	G	5	6	11	0	3	14	0	0
3	19264751	.	A	G	7	11	18	0	0	18	0	0
3	19264760	.	T	A	7	9	16	0	1	17	0	0
3	19264787	.	G	T	9	14	23	0	0	23	0	0
3	19264874	.	T	C	7	7	14	0	5	19	0	0
3	19267552	.	C	T	18	14	32	0	0	32	0	0
3	19267564	.	T	C	20	17	37	0	1	38	0	0
3	19267906	.	A	G	14	2	16	0	16	32	0	0
3	19267963	.	A	G	17	19	36	0	0	36	0	0
3	19270732	.	C	T	14	17	31	0	2	33	0	0
3	19271549	.	A	G	17	17	34	0	0	34	0	0
3	19273907	.	A	G	18	16	34	0	0	34	0	0
3	19274532	.	C	G	23	19	42	0	0	42	0	0
3	19274544	.	A	C	20	23	43	0	2	45	0	0
3	19274688	.	T	C	18	10	28	0	2	30	0	0
3	19277027	.	A	G	18	13	31	0	1	32	0	0
3	19277084	.	T	A	11	21	32	0	1	33	0	0
3	19278247	.	T	C	18	21	39	0	0	39	0	0
3	19278796	.	C	T	20	26	46	0	0	46	0	0
3	19281259	.	G	A	1	15	16	0	23	39	0	0
3	19281295	.	A	G	14	16	30	0	0	30	0	0
3	19281310	.	T	A	12	18	30	0	0	30	0	0
3	19338875	.	C	T	6	5	11	0	0	11	0	0
3	19339833	.	A	G	11	4	15	0	0	15	0	0
3	19346162	.	C	G	8	7	15	0	0	15	0	0
3	19346376	.	C	T	12	6	18	0	0	18	0	0
3	19346394	.	C	T	11	5	16	0	0	16	0	0
3	19354657	.	G	C	8	7	15	0	0	15	0	0
3	19354768	.	A	C	3	7	10	0	2	12	0	0
3	19354902	.	T	C	8	6	14	0	1	15	0	0
3	19609716	.	G	A	18	13	31	0	1	32	0	0
3	19609747	.	G	A	20	10	30	0	1	31	0	0
3	19609897	.	A	C	22	15	37	0	2	39	0	0
3	19610495	.	T	A	2	4	6	0	0	6	0	0
3	19610648	.	A	T	15	12	27	0	1	28	0	0
3	19610655	.	G	T	17	12	29	0	0	29	0	0
3	19610865	.	A	C	27	15	42	0	1	43	0	0
3	19610933	.	A	G	4	5	9	0	1	10	0	0
3	19665429	.	G	A	5	8	13	0	0	13	0	0
3	19673523	.	A	C	3	2	5	0	1	6	0	0
3	19674329	.	G	A	1	2	3	0	2	5	0	0
3	19676791	.	A	G	3	3	6	0	0	6	0	0
3	19685977	.	T	G	5	8	13	0	0	13	0	0
3	19686149	.	C	T	11	5	16	0	1	17	0	0
3	19686332	.	G	T	7	7	14	0	2	16	0	0
3	19687393	.	T	C	7	8	15	0	0	15	0	0
3	19702196	.	G	A	14	9	23	0	0	23	0	0
3	19702224	.	T	C	13	9	22	0	0	22	0	0
3	19702551	.	T	C	12	6	18	0	0	18	0	0
3	19706564	.	A	G	10	12	22	0	1	23	0	0
3	19707181	.	G	A	10	6	16	0	2	18	0	0
3	19710389	.	T	C	14	11	25	0	2	27	0	0
3	19716761	.	C	T	9	7	16	0	1	17	0	0
3	19717171	.	T	A	6	5	11	0	1	12	0	0
3	19717459	.	C	T	16	12	28	0	0	28	0	0
3	19717589	.	T	G	11	3	14	0	14	28	0	0
3	19717656	.	T	C	7	9	16	0	1	17	0	0
3	19717669	.	G	A	8	12	20	0	0	20	0	0
3	19768892	.	C	T	1	1	2	0	1	3	0	0
3	19792066	.	G	A	2	3	5	0	0	5	0	0
3	19807316	.	T	A	1	3	4	0	0	4	0	0
3	19810425	.	T	C	1	3	4	0	1	5	0	0
3	19851120	.	G	C	4	3	7	0	1	8	0	0
3	19851289	.	G	T	21	10	31	0	1	32	0	0
3	19851325	.	T	C	17	13	30	0	0	30	0	0
3	19914453	.	A	G	26	20	46	0	0	46	0	0
3	19914619	.	C	T	22	28	50	0	2	52	0	0
3	19914781	.	G	A	2	29	31	0	18	49	0	0
3	19969409	.	C	T	27	21	48	0	0	48	0	0
3	19969416	.	G	C	26	19	45	0	1	46	0	0
3	19969530	.	G	C	32	26	58	0	2	60	0	0
3	19969560	.	C	T	35	24	59	0	2	61	0	0
3	19969909	.	C	T	31	27	58	0	1	59	0	0
3	19970397	.	C	A	26	26	52	0	2	54	0	0
3	19970589	.	G	A	7	25	32	0	21	53	0	0
3	19971063	.	T	G	29	31	60	0	1	61	0	0
3	19971316	.	A	G	28	25	53	0	1	54	0	0
3	19971719	.	A	C	16	23	39	0	12	51	0	0
3	20015458	.	G	T	13	14	27	0	0	27	0	0
3	20015752	.	T	C	17	12	29	0	1	30	0	0
3	20015785	.	G	C	17	15	32	0	1	33	0	0
3	20021477	.	C	T	8	12	20	0	0	20	0	0
3	20021593	.	C	T	8	7	15	0	0	15	0	0
3	20026042	.	G	T	18	9	27	0	0	27	0	0
3	20026106	.	G	A	21	15	36	0	1	37	0	0
3	20026148	.	G	A	16	13	29	0	4	33	0	0
3	20035849	.	C	T	2	15	17	0	20	37	0	0
3	20036309	.	A	G	17	11	28	0	0	28	0	0
3	20040557	.	C	G	0	19	19	0	16	36	1	0
3	20042325	.	A	T	18	19	37	0	2	39	0	0
3	20042453	.	G	C	18	20	38	0	0	38	0	0
3	20042476	.	C	T	18	17	35	0	2	37	0	0
3	20042679	.	A	G	8	9	17	1	1	19	0	0
3	20042681	.	A	G	7	9	16	1	1	18	0	0
3	20042824	.	A	G	12	25	37	0	3	40	0	0
3	20042965	.	T	C	19	13	32	0	2	34	0	0
3	20043024	.	A	G	20	15	35	0	0	35	0	0
3	20043069	.	C	A	19	12	31	0	1	32	0	0
3	20043121	.	A	T	19	18	37	0	0	37	0	0
3	20043279	.	A	T	17	8	25	0	1	26	0	0
3	20043556	.	C	T	12	14	26	0	1	27	0	0
3	20045679	.	A	G	26	18	44	0	0	44	0	0
3	20049714	.	G	A	19	13	32	0	0	32	0	0
3	20051185	.	G	A	13	18	31	0	1	32	0	0
3	20051290	.	G	A	19	14	33	0	0	33	0	0
3	20062718	.	A	G	22	15	37	0	0	37	0	0
3	20063757	.	A	G	4	19	23	0	2	25	0	0
3	20063901	.	C	T	5	7	12	0	0	12	0	0
3	20063917	.	G	A	4	5	9	0	0	9	0	0
3	20063978	.	T	C	2	4	6	0	0	6	0	0
3	20064002	.	C	T	4	7	11	0	1	12	0	0
3	20108424	.	A	T	20	26	46	0	0	46	0	0
3	20108636	.	A	T	18	14	32	0	0	32	0	0
3	20108643	.	G	T	16	15	31	0	2	33	0	0
3	20108790	.	T	C	17	15	32	3	1	36	0	0
3	20109247	.	T	C	17	0	17	0	13	30	0	0
3	20109421	.	T	C	14	19	33	0	0	33	0	0
3	20109583	.	A	G	10	14	24	0	1	25	0	0
3	20109861	.	G	A	13	23	36	0	3	39	0	0
3	20109951	.	C	A	16	24	40	0	1	41	0	0
3	20110268	.	T	C	36	14	50	0	0	50	0	0
3	20110269	.	T	C	37	12	49	0	1	50	0	0
3	20110346	.	A	G	19	19	38	0	1	39	0	0
3	20110359	.	T	A	17	16	33	0	1	34	0	0
3	20110444	.	C	A	14	18	32	0	0	32	0	0
3	20110557	.	A	G	23	28	51	0	1	52	0	0
3	20118281	.	C	G	28	13	41	0	1	42	0	0
3	20192178	.	A	G	4	2	6	0	0	6	0	0
3	20208474	.	A	G	4	0	4	0	4	8	0	0
3	20224065	.	A	G	3	3	6	0	0	6	0	0
3	20224161	.	A	T	5	3	8	0	0	8	0	0
3	20224364	.	A	T	5	4	9	0	1	10	0	0
3	20224548	.	C	A	7	3	10	0	0	10	0	0
3	20224700	.	A	C	4	7	11	0	0	11	0	0
3	20224704	.	G	T	0	8	8	0	4	12	0	0
3	20224832	.	T	C	4	2	6	0	0	6	0	0
3	20226074	.	A	T	1	3	4	0	0	4	0	0
3	20226092	.	A	G	2	0	2	0	2	4	0	0
3	20226274	.	T	C	6	2	8	0	0	8	0	0
3	20226300	.	T	G	8	3	11	0	0	11	0	0
3	20226515	.	T	C	3	6	9	0	1	10	0	0
3	20226924	.	T	C	6	5	11	0	0	11	0	0
3	20226937	.	A	C	5	3	8	0	0	8	0	0
3	20227147	.	T	A	4	2	6	0	1	7	0	0
3	20227420	.	A	T	3	5	8	0	0	8	0	0
3	20227443	.	A	G	6	8	14	0	0	14	0	0
3	20227480	.	G	A	0	4	4	0	9	13	0	0
3	20227531	.	A	G	9	4	13	0	0	13	0	0
3	20227555	.	G	A	7	5	12	0	0	12	0	0
3	20227781	.	T	A	2	3	5	0	1	6	0	0
3	20227805	.	T	C	4	4	8	0	0	8	0	0
3	20227848	.	A	C	3	4	7	0	0	7	0	0
3	20228052	.	C	T	3	5	8	0	0	8	0	0
3	20228168	.	A	T	5	2	7	0	0	7	0	0
3	20228303	.	C	T	7	5	12	0	0	12	0	0
3	20228335	.	T	C	5	4	9	0	2	11	0	0
3	20228736	.	T	A	2	3	5	0	0	5	0	0
3	20228874	.	C	T	3	9	12	0	0	12	0	0
3	20228961	.	A	G	7	0	7	0	8	15	0	0
3	20229033	.	C	G	9	0	9	0	7	16	0	0
3	20229057	.	A	T	10	3	13	0	0	13	0	0
3	20229235	.	A	G	12	6	18	0	1	19	0	0
3	20229260	.	G	A	10	8	18	0	2	20	0	0
3	20229479	.	A	G	4	5	9	0	0	9	0	0
3	20229503	.	T	A	4	3	7	0	1	8	0	0
3	20229697	.	T	A	3	2	5	0	0	5	0	0
3	20229712	.	T	A	3	1	4	0	0	4	0	0
3	20231025	.	T	G	7	6	13	0	1	14	0	0
3	20231060	.	C	T	6	7	13	0	0	13	0	0
3	20231080	.	G	A	0	5	5	0	4	9	0	0
3	20231288	.	G	A	3	3	6	0	1	7	0	0
3	20231289	.	C	T	3	4	7	0	0	7	0	0
3	20231385	.	C	T	13	11	24	0	0	24	0	0
3	20231483	.	T	A	7	5	12	0	0	12	0	0
3	20231510	.	G	A	4	3	7	0	0	7	0	0
3	20231539	.	C	G	6	6	12	0	0	13	1	0
3	20404926	.	A	C	3	3	6	0	3	9	0	0
3	20658235	.	C	T	7	7	14	0	1	15	0	0
3	20658333	.	G	T	19	16	35	0	1	36	0	0
3	20658653	.	C	G	16	8	24	0	1	25	0	0
3	20658809	.	C	T	13	11	24	0	1	25	0	0
3	20658899	.	T	A	11	8	19	0	2	21	0	0
3	20659051	.	T	G	19	24	43	0	4	47	0	0
3	20666937	.	A	G	13	12	25	0	0	25	0	0
3	20666970	.	A	T	12	8	20	0	2	22	0	0
3	20677240	.	A	G	12	15	27	0	0	27	0	0
3	20677261	.	C	A	11	14	25	0	0	25	0	0
3	20720843	.	G	A	8	14	22	0	0	22	0	0
3	20721042	.	C	A	9	9	18	0	0	18	0	0
3	20721049	.	T	A	8	6	14	0	1	15	0	0
3	20752904	.	A	T	13	10	23	0	3	26	0	0
3	20752928	.	A	T	17	11	28	0	3	31	0	0
3	20793587	.	G	A	19	13	32	0	0	32	0	0
3	20950366	.	C	T	19	10	29	0	2	31	0	0
3	20950529	.	T	C	18	33	51	2	3	56	0	0
3	20956926	.	C	A	20	28	48	0	5	53	0	0
3	20956957	.	G	A	15	15	30	0	4	34	0	0
3	20973017	.	C	T	7	5	12	0	0	12	0	0
3	20982056	.	G	A	7	8	15	0	1	16	0	0
3	20982061	.	T	C	9	7	16	0	1	17	0	0
3	20982156	.	C	T	8	7	15	0	0	15	0	0
3	20982159	.	C	T	6	8	14	0	1	15	0	0
3	20982340	.	G	T	3	11	14	0	1	15	0	0
3	21020188	.	A	G	11	15	26	0	1	27	0	0
3	21022558	.	C	A	5	17	22	0	0	22	0	0
3	21022993	.	A	G	12	6	18	0	1	19	0	0
3	21022996	.	T	C	13	6	19	0	1	20	0	0
3	21025709	.	A	T	27	16	43	0	3	46	0	0
3	21025986	.	A	T	14	21	35	0	0	35	0	0
3	21026079	.	A	G	21	26	47	0	2	49	0	0
3	21026293	.	A	G	15	19	34	0	2	36	0	0
3	21026370	.	T	C	18	16	34	0	1	35	0	0
3	21026573	.	G	A	10	7	17	0	0	17	0	0
3	21026576	.	C	T	11	7	18	0	0	18	0	0
3	21026729	.	A	G	2	3	5	0	0	5	0	0
3	21026748	.	G	A	1	4	5	0	1	6	0	0
3	21026894	.	A	T	7	3	10	0	0	10	0	0
3	21027101	.	A	T	15	21	36	0	1	37	0	0
3	21027504	.	C	T	24	7	31	0	1	32	0	0
3	21027715	.	C	T	21	19	40	2	3	45	0	0
3	21027749	.	A	T	41	15	56	4	1	61	0	0
3	21029813	.	C	A	26	19	45	0	0	45	0	0
3	21029902	.	T	G	16	27	43	0	0	43	0	0
3	21030101	.	G	A	18	16	34	0	4	38	0	0
3	21030293	.	C	T	29	29	58	0	2	60	0	0
3	21030318	.	A	C	26	31	57	0	1	58	0	0
3	21030730	.	T	C	18	12	30	0	4	34	0	0
3	21037760	.	C	T	5	3	8	0	1	9	0	0
3	21044189	.	G	A	12	19	31	1	3	35	0	0
3	21062703	.	T	C	10	0	10	0	11	21	0	0
3	21062721	.	T	A	5	6	11	0	1	12	0	0
3	21066745	.	A	T	9	9	18	0	0	18	0	0
3	21067384	.	A	G	7	8	15	0	2	17	0	0
3	21067565	.	A	G	4	7	11	0	0	11	0	0
3	21067606	.	A	T	6	12	18	0	1	19	0	0
3	21067718	.	T	A	11	8	19	0	1	20	0	0
3	21067911	.	G	T	13	10	23	0	2	25	0	0
3	21068176	.	G	A	10	6	16	1	1	18	0	0
3	21068205	.	G	T	6	8	14	2	0	16	0	0
3	21068378	.	T	G	10	14	24	2	1	27	0	0
3	21074598	.	G	A	13	10	23	0	1	24	0	0
3	21074667	.	G	A	13	6	19	0	1	20	0	0
3	21086092	.	G	A	8	8	16	0	2	18	0	0
3	21087743	.	G	T	9	9	18	0	1	19	0	0
3	21094398	.	C	A	6	5	11	2	1	14	0	0
3	21094462	.	G	A	6	4	10	0	0	10	0	0
3	21096176	.	C	T	9	5	14	0	0	14	0	0
3	21096487	.	G	A	10	13	23	0	0	23	0	0
3	21096693	.	T	A	16	14	30	0	0	30	0	0
3	21104470	.	A	G	10	20	30	0	1	31	0	0
3	21111671	.	C	T	2	12	14	0	12	26	0	0
3	21111680	.	T	C	15	11	26	0	0	26	0	0
3	21111916	.	G	C	15	17	32	0	0	32	0	0
3	21111940	.	A	G	17	12	29	0	0	29	0	0
3	21113913	.	C	A	23	22	45	0	0	45	0	0
3	21125687	.	G	T	23	17	40	0	0	40	0	0
3	21126015	.	C	T	33	29	62	0	1	63	0	0
3	21139754	.	T	C	13	7	20	2	1	23	0	0
3	21140789	.	A	G	5	5	10	0	0	10	0	0
3	21140823	.	T	C	3	8	11	0	0	11	0	0
3	21140824	.	T	C	0	10	10	0	0	10	0	0
3	21141184	.	C	T	5	12	17	0	1	18	0	0
3	21142429	.	A	T	8	9	17	0	2	19	0	0
3	21240878	.	A	T	4	5	9	0	0	9	0	0
3	21240971	.	C	G	2	4	6	0	0	6	0	0
3	21241269	.	A	G	5	9	14	0	1	15	0	0
3	21241413	.	C	A	0	9	9	0	1	10	0	0
3	21241416	.	A	G	1	8	9	0	1	10	0	0
3	21242399	.	A	T	3	3	6	0	0	6	0	0
3	21242438	.	C	G	0	4	4	0	2	6	0	0
3	21251642	.	A	T	16	10	26	0	1	27	0	0
3	21251732	.	G	C	15	11	26	0	1	27	0	0
3	21251873	.	A	G	19	5	24	0	1	25	0	0
3	21251924	.	G	A	11	7	18	0	1	19	0	0
3	21252172	.	C	G	24	20	44	0	1	45	0	0
3	21281117	.	A	G	5	2	7	0	0	7	0	0
3	21281483	.	G	C	5	7	12	0	0	12	0	0
3	21281677	.	C	T	2	8	10	0	22	32	0	0
3	21281926	.	A	C	6	6	12	0	0	12	0	0
3	21281927	.	T	A	6	6	12	0	0	12	0	0
3	21282192	.	T	C	9	8	17	0	0	17	0	0
3	21282299	.	T	A	10	5	15	0	0	15	0	0
3	21282340	.	A	G	10	10	20	0	0	20	0	0
3	21282546	.	G	A	15	5	20	0	1	21	0	0
3	21282981	.	A	G	8	12	20	0	1	21	0	0
3	21283365	.	T	C	13	2	15	0	16	31	0	0
3	21283509	.	C	A	7	8	15	0	0	15	0	0
3	21283741	.	T	C	12	13	25	0	2	27	0	0
3	21283759	.	T	C	12	9	21	0	1	22	0	0
3	21283811	.	T	G	17	10	27	0	0	27	0	0
3	21284429	.	A	G	12	8	20	0	1	21	0	0
3	21284430	.	A	G	11	9	20	0	1	21	0	0
3	21284514	.	A	T	11	6	17	0	0	17	0	0
3	21284752	.	G	A	11	7	18	0	1	19	0	0
3	21284794	.	G	T	11	12	23	0	0	23	0	0
3	21287697	.	A	G	10	8	18	0	0	18	0	0
3	21287872	.	G	C	10	6	16	0	0	16	0	0
3	21287938	.	A	C	16	0	16	0	11	27	0	0
3	21287981	.	C	T	18	12	30	0	1	31	0	0
3	21288007	.	T	C	13	12	25	0	3	28	0	0
3	21288016	.	C	T	13	12	25	0	2	27	0	0
3	21348283	.	T	G	15	8	23	0	0	23	0	0
3	21670010	.	T	C	5	3	8	0	0	8	0	0
3	21670373	.	C	T	1	2	3	0	1	4	0	0
3	21740587	.	G	T	3	2	5	1	0	6	0	0
3	21868222	.	G	A	2	3	5	0	0	5	0	0
3	21881762	.	A	G	5	5	10	0	0	10	0	0
3	21882580	.	A	T	1	2	3	0	0	3	0	0
3	21883211	.	A	C	2	2	4	0	1	5	0	0
3	21883252	.	G	T	0	2	2	0	2	4	0	0
3	21883505	.	C	A	3	2	5	0	0	5	0	0
3	21883524	.	G	A	4	4	8	0	0	8	0	0
3	21883568	.	T	C	3	5	8	0	0	8	0	0
3	21883572	.	A	G	2	5	7	0	0	7	0	0
3	21883622	.	T	C	3	2	5	0	0	5	0	0
3	21883990	.	A	C	2	2	4	0	1	5	0	0
3	21884015	.	C	T	4	3	7	0	0	7	0	0
3	21884589	.	A	T	1	2	3	0	0	3	0	0
3	21884963	.	A	G	4	4	8	0	0	8	0	0
3	21885954	.	C	T	5	2	7	0	0	7	0	0
3	21886743	.	A	T	1	3	4	0	0	4	0	0
3	21887512	.	T	A	2	2	4	0	0	4	0	0
3	21887513	.	A	T	2	2	4	0	0	4	0	0
3	21887641	.	G	A	3	6	9	0	1	10	0	0
3	21888195	.	A	G	1	4	5	0	0	5	0	0
3	21888207	.	G	A	1	3	4	0	0	4	0	0
3	21888924	.	T	G	2	3	5	0	0	5	0	0
3	21889154	.	C	A	4	3	7	0	0	7	0	0
3	21889213	.	A	T	2	5	7	0	0	7	0	0
3	21889240	.	A	G	6	2	8	0	0	8	0	0
3	21889268	.	A	G	6	3	9	0	0	9	0	0
3	21889451	.	A	G	4	0	4	0	3	7	0	0
3	21889476	.	A	G	1	4	5	0	0	5	0	0
3	22039893	.	C	T	6	6	12	0	0	12	0	0
3	22050000	.	C	A	8	5	13	0	0	13	0	0
3	22050026	.	G	A	4	6	10	0	0	10	0	0
3	22050263	.	G	A	12	12	24	0	0	24	0	0
3	22054324	.	G	A	11	19	30	0	0	30	0	0
3	22054356	.	C	T	12	10	22	0	0	22	0	0
3	22054491	.	C	T	5	13	18	2	2	22	0	0
3	22054724	.	T	C	8	4	12	0	1	13	0	0
3	22054793	.	A	C	9	6	15	0	0	15	0	0
3	22055128	.	A	G	5	0	5	0	6	11	0	0
3	22055216	.	T	A	5	4	9	0	0	9	0	0
3	22059083	.	A	T	6	3	9	0	1	10	0	0
3	22079377	.	C	T	5	7	12	0	0	12	0	0
3	22079815	.	A	T	11	3	14	0	0	14	0	0
3	22080117	.	A	G	6	9	15	0	0	15	0	0
3	22080356	.	T	G	6	7	13	0	0	13	0	0
3	22127948	.	G	A	2	3	5	0	7	12	0	0
3	22130419	.	G	T	6	7	13	0	1	14	0	0
3	22146900	.	G	C	2	14	16	0	12	28	0	0
3	22146945	.	T	C	10	15	25	0	2	27	0	0
3	22146969	.	C	T	11	11	22	0	0	22	0	0
3	22153178	.	C	T	6	2	8	0	1	9	0	0
3	22153372	.	A	G	5	0	5	0	10	15	0	0
3	22153762	.	C	G	4	2	6	0	1	7	0	0
3	22153885	.	A	G	4	4	8	1	0	9	0	0
3	22153944	.	T	G	1	1	2	0	7	9	0	0
3	22154008	.	A	G	4	0	4	0	2	6	0	0
3	22154274	.	C	G	7	3	10	0	0	10	0	0
3	22154306	.	G	T	0	5	5	0	7	12	0	0
3	22154429	.	C	T	9	10	19	0	1	20	0	0
3	22154610	.	A	C	11	12	23	0	0	23	0	0
3	22158373	.	G	T	38	13	51	0	7	58	0	0
3	22158416	.	G	C	29	24	53	0	1	54	0	0
3	22158551	.	T	C	33	24	57	0	1	58	0	0
3	22158768	.	T	G	35	23	58	0	1	59	0	0
3	22158904	.	A	T	37	30	67	0	4	72	1	0
3	22159569	.	A	G	28	16	44	3	1	48	0	0
3	22159584	.	C	A	2	10	12	3	25	40	0	0
3	22159697	.	A	G	18	30	48	1	1	50	0	0
3	22159797	.	G	A	7	16	23	0	0	23	0	0
3	22160042	.	T	G	19	15	34	0	3	37	0	0
3	22160131	.	C	G	11	14	25	0	0	25	0	0
3	22160421	.	C	T	22	20	42	0	0	42	0	0
3	22160436	.	A	C	23	26	49	0	2	51	0	0
3	22160706	.	T	A	19	15	34	0	0	34	0	0
3	22160767	.	G	T	20	8	28	0	2	39	9	0
3	22160779	.	C	T	24	9	33	0	0	33	0	0
3	22160888	.	A	T	14	13	27	0	5	32	0	0
3	22160947	.	C	A	5	9	14	0	1	19	4	0
3	22161153	.	A	G	20	23	43	0	1	44	0	0
3	22161176	.	G	T	18	25	43	0	2	45	0	0
3	22161317	.	C	T	2	18	20	0	16	36	0	0
3	22161366	.	G	A	15	17	32	0	1	33	0	0
3	22161389	.	T	A	18	14	32	0	1	33	0	0
3	22161588	.	C	T	11	8	19	0	0	19	0	0
3	22168615	.	C	T	17	18	35	0	2	37	0	0
3	22172765	.	A	G	26	28	54	1	1	56	0	0
3	22172837	.	G	A	23	29	52	0	4	56	0	0
3	22179727	.	T	A	6	6	12	0	2	14	0	0
3	22179743	.	A	G	8	4	12	0	0	12	0	0
3	22179835	.	A	C	11	6	17	0	0	17	0	0
3	22179857	.	T	A	9	5	14	0	0	14	0	0
3	22179899	.	A	C	9	4	13	1	2	16	0	0
3	22180013	.	G	A	3	2	5	0	0	5	0	0
3	22180139	.	T	G	4	2	6	0	2	8	0	0
3	22180315	.	T	C	4	7	11	0	0	11	0	0
3	22180600	.	C	T	0	2	2	0	3	5	0	0
3	22180666	.	T	C	7	6	13	0	1	14	0	0
3	22181770	.	T	C	6	2	8	0	0	8	0	0
3	22191042	.	T	C	20	25	45	0	4	49	0	0
3	22191044	.	C	A	22	28	50	0	0	50	0	0
3	22213993	.	T	A	22	25	47	0	1	48	0	0
3	22216212	.	T	C	14	0	14	0	14	28	0	0
3	22216265	.	G	A	6	10	16	0	2	18	0	0
3	22216296	.	A	T	6	10	16	0	0	16	0	0
3	22216358	.	G	A	11	21	32	0	0	32	0	0
3	22216413	.	C	G	4	10	14	0	1	15	0	0
3	22432213	.	G	T	1	8	9	0	0	9	0	0
3	22534277	.	C	T	1	3	4	0	0	4	0	0
3	22542258	.	C	T	2	2	4	0	0	4	0	0
3	22547182	.	A	G	9	11	20	0	0	20	0	0
3	22548052	.	G	A	5	10	15	0	0	15	0	0
3	22548094	.	A	G	5	9	14	0	0	14	0	0
3	22548095	.	G	T	5	7	12	0	2	14	0	0
3	22548177	.	G	T	1	3	4	0	0	4	0	0
3	22548263	.	T	A	4	4	8	0	0	8	0	0
3	22548388	.	G	A	8	11	19	0	0	19	0	0
3	22548666	.	C	G	5	8	13	0	0	13	0	0
3	22548677	.	C	T	7	7	14	0	0	14	0	0
3	22548903	.	A	C	9	12	21	0	0	21	0	0
3	22548928	.	T	A	10	12	22	0	1	23	0	0
3	22578532	.	T	C	8	3	11	0	0	11	0	0
3	22578705	.	A	T	6	9	15	0	0	15	0	0
3	22578717	.	G	C	5	7	12	0	1	13	0	0
3	22636680	.	A	T	9	8	17	0	0	17	0	0
3	22636743	.	T	A	5	7	12	0	0	12	0	0
3	22760872	.	C	A	10	12	22	0	0	22	0	0
3	22783133	.	G	A	0	7	7	0	6	13	0	0
3	22783277	.	A	G	3	8	11	0	1	12	0	0
3	22783298	.	G	A	3	12	15	0	0	15	0	0
3	22784434	.	A	G	5	0	5	0	12	17	0	0
3	22788163	.	T	C	12	11	23	0	0	23	0	0
3	22788430	.	G	T	1	8	9	0	9	18	0	0
3	22788457	.	T	C	7	8	15	0	1	16	0	0
3	22789725	.	G	T	9	11	20	0	2	22	0	0
3	22790117	.	A	G	4	10	14	0	1	15	0	0
3	22790318	.	A	G	5	12	17	0	0	17	0	0
3	22792033	.	T	C	11	7	18	0	0	18	0	0
3	22794477	.	A	G	10	7	17	0	0	17	0	0
3	22794705	.	T	C	6	6	12	0	0	12	0	0
3	22811835	.	G	A	1	16	17	0	15	32	0	0
3	22812753	.	A	G	17	0	17	0	16	33	0	0
3	22812759	.	C	A	16	16	32	0	2	34	0	0
3	22813052	.	G	A	4	14	18	0	26	44	0	0
3	22813515	.	T	A	10	12	22	0	0	22	0	0
3	22813563	.	G	T	9	11	20	0	0	20	0	0
3	22813569	.	T	G	8	9	17	0	2	19	0	0
3	22813628	.	C	A	11	11	22	0	2	24	0	0
3	22813629	.	T	A	12	11	23	0	0	24	1	0
3	22813778	.	C	T	5	11	16	0	1	17	0	0
3	22813998	.	T	G	7	10	17	0	0	17	0	0
3	22814109	.	G	A	14	16	30	0	1	31	0	0
3	22814147	.	G	A	2	15	17	0	15	32	0	0
3	22814209	.	T	C	19	13	32	0	0	32	0	0
3	22814230	.	A	G	15	0	15	0	17	32	0	0
3	22814453	.	A	G	7	18	25	0	1	26	0	0
3	22814478	.	A	G	7	16	23	0	1	24	0	0
3	22814546	.	G	A	14	15	29	1	1	31	0	0
3	22815296	.	C	A	2	3	5	0	0	5	0	0
3	22815994	.	C	T	4	9	13	0	13	26	0	0
3	22816030	.	A	G	12	3	15	0	1	17	1	0
3	22816166	.	T	C	8	7	15	0	1	16	0	0
3	22816167	.	G	A	8	7	15	0	1	16	0	0
3	22816360	.	A	G	1	2	3	0	0	3	0	0
3	22816368	.	T	A	1	2	3	0	0	3	0	0
3	22816586	.	G	A	9	6	15	0	1	16	0	0
3	22816616	.	T	A	11	9	20	0	1	21	0	0
3	22816652	.	A	G	11	15	26	0	0	26	0	0
3	22816676	.	T	C	8	12	20	0	1	21	0	0
3	22816783	.	A	C	11	0	11	0	6	17	0	0
3	22816793	.	T	C	13	3	16	0	1	17	0	0
3	22816909	.	T	C	15	0	15	0	5	20	0	0
3	22816910	.	A	G	15	5	20	0	0	20	0	0
3	22816989	.	C	T	12	6	18	0	1	19	0	0
3	22817004	.	G	T	9	6	15	0	0	15	0	0
3	22817300	.	T	C	14	0	14	0	10	24	0	0
3	22821125	.	A	G	8	7	15	0	0	15	0	0
3	22823823	.	A	C	10	3	13	1	0	14	0	0
3	22828206	.	C	A	4	7	11	0	1	12	0	0
3	22828257	.	A	G	4	8	12	0	0	12	0	0
3	22829559	.	A	T	3	3	6	0	0	6	0	0
3	22935364	.	G	A	9	5	14	0	1	15	0	0
3	22947802	.	A	G	5	1	6	0	8	14	0	0
3	22947820	.	T	C	6	9	15	0	0	15	0	0
3	22953826	.	G	A	0	12	12	0	9	21	0	0
3	22953926	.	T	C	13	13	26	0	0	26	0	0
3	22967007	.	A	G	7	3	10	0	0	10	0	0
3	22967183	.	T	C	7	7	14	0	0	14	0	0
3	22993542	.	G	A	7	7	14	0	0	14	0	0
3	22993614	.	C	T	4	6	10	0	0	10	0	0
3	22993828	.	C	T	3	4	7	0	0	7	0	0
3	22993844	.	A	C	2	2	4	0	0	4	0	0
3	22994078	.	G	T	1	9	10	0	8	18	0	0
3	22994318	.	A	G	4	0	4	0	3	7	0	0
3	22994344	.	G	T	1	2	3	0	2	5	0	0
3	23019762	.	A	C	1	2	3	0	0	3	0	0
3	23019920	.	G	A	0	2	2	0	2	4	0	0
3	23020490	.	C	T	2	2	4	0	0	4	0	0
3	23248840	.	A	G	11	5	16	0	1	17	0	0
3	23250603	.	C	G	9	6	15	0	2	17	0	0
3	23250652	.	G	A	2	11	13	0	16	29	0	0
3	23251018	.	A	G	14	14	28	0	1	29	0	0
3	23251258	.	A	C	10	11	21	0	2	23	0	0
3	23251299	.	C	G	16	14	30	0	0	30	0	0
3	23251744	.	G	A	1	14	15	0	13	28	0	0
3	23251822	.	A	G	12	18	30	0	4	34	0	0
3	23302371	.	A	G	13	11	24	0	4	28	0	0
3	23307870	.	G	T	2	10	12	1	15	28	0	0
3	23309155	.	C	A	10	16	26	0	3	29	0	0
3	23309214	.	A	G	17	17	34	0	1	35	0	0
3	23318362	.	G	A	15	14	29	0	1	30	0	0
3	23318368	.	C	T	15	14	29	0	1	30	0	0
3	23323560	.	T	A	10	12	22	0	1	23	0	0
3	23323719	.	T	C	4	2	6	0	2	8	0	0
3	23323788	.	G	A	8	6	14	0	0	14	0	0
3	23323829	.	T	C	4	5	9	0	0	9	0	0
3	23324159	.	T	A	5	11	16	0	1	17	0	0
3	23324235	.	G	A	10	9	19	0	2	21	0	0
3	23324536	.	C	T	11	9	20	0	0	20	0	0
3	23324746	.	T	A	13	10	23	0	1	24	0	0
3	23324815	.	T	A	11	13	24	0	1	25	0	0
3	23324829	.	C	T	10	12	22	0	0	22	0	0
3	23325207	.	A	C	5	8	13	0	1	14	0	0
3	23325476	.	G	A	10	7	17	0	0	17	0	0
3	23325559	.	C	T	2	3	5	0	1	6	0	0
3	23326478	.	G	A	8	7	15	0	1	16	0	0
3	23327282	.	C	T	26	14	40	0	0	40	0	0
3	23334465	.	A	T	15	11	26	0	1	27	0	0
3	23335024	.	G	A	21	13	34	0	1	35	0	0
3	23348300	.	T	G	18	20	38	0	1	39	0	0
3	23348304	.	C	T	19	21	40	0	0	40	0	0
3	23351944	.	G	A	13	14	27	0	0	27	0	0
3	23363193	.	G	A	18	14	32	0	0	32	0	0
3	23406614	.	G	A	16	22	38	0	1	39	0	0
3	23406637	.	G	C	21	1	22	0	18	41	1	0
3	23406701	.	C	T	28	14	42	0	1	43	0	0
3	23407085	.	G	T	16	15	31	0	2	33	0	0
3	23429169	.	A	C	11	7	18	0	1	19	0	0
3	23429262	.	A	T	9	5	14	0	1	15	0	0
3	23429263	.	T	C	9	6	15	0	0	15	0	0
3	23429433	.	A	G	4	3	7	0	3	10	0	0
3	23429696	.	A	G	4	6	10	1	1	12	0	0
3	23429763	.	A	C	6	0	6	0	15	21	0	0
3	23430011	.	G	A	7	10	17	0	1	18	0	0
3	23430067	.	A	G	23	8	31	0	1	32	0	0
3	23430116	.	T	A	19	8	27	0	1	28	0	0
3	23430119	.	C	T	3	8	11	0	18	29	0	0
3	23436305	.	T	A	18	18	36	0	2	38	0	0
3	23442923	.	A	G	15	12	27	0	1	28	0	0
3	23443487	.	G	A	12	7	19	0	1	20	0	0
3	23444539	.	A	T	14	14	28	0	0	28	0	0
3	23444551	.	T	G	13	12	25	0	0	25	0	0
3	23456344	.	T	C	15	0	15	0	8	23	0	0
3	23465292	.	T	C	6	6	12	0	0	12	0	0
3	23466160	.	A	G	8	4	12	0	1	13	0	0
3	23469391	.	C	T	5	6	11	0	1	12	0	0
3	23469438	.	A	G	3	5	8	0	2	10	0	0
3	23469472	.	T	C	2	8	10	0	0	10	0	0
3	23469848	.	T	A	9	8	17	0	0	17	0	0
3	23470037	.	A	C	14	0	14	0	5	19	0	0
3	23470044	.	T	A	16	7	23	0	1	24	0	0
3	23488794	.	T	A	15	11	26	0	3	30	1	0
3	23493694	.	T	C	27	23	50	0	0	50	0	0
3	23495767	.	T	C	21	18	39	0	0	39	0	0
3	23495872	.	T	C	11	14	25	0	3	28	0	0
3	23495905	.	G	T	6	10	16	0	3	19	0	0
3	23495908	.	A	G	7	11	18	0	2	20	0	0
3	23584128	.	G	A	8	4	12	0	0	12	0	0
3	23584577	.	A	C	15	9	24	0	0	24	0	0
3	23584703	.	A	T	8	10	18	0	1	19	0	0
3	23584704	.	T	A	8	11	19	0	0	19	0	0
3	23584748	.	C	A	10	7	17	0	0	17	0	0
3	23591620	.	T	C	7	0	7	0	17	24	0	0
3	23591662	.	G	C	10	0	10	0	16	26	0	0
3	23599844	.	A	C	31	26	57	1	3	61	0	0
3	23690146	.	C	T	3	5	8	0	0	8	0	0
3	23692197	.	C	T	1	3	4	0	0	4	0	0
3	23705327	.	T	G	3	0	3	0	9	12	0	0
3	23709399	.	A	G	5	1	6	0	5	11	0	0
3	23723582	.	C	G	2	4	6	0	0	6	0	0
3	23723655	.	T	A	2	3	5	0	1	6	0	0
3	23723715	.	C	A	2	1	3	0	1	4	0	0
3	23746344	.	T	C	4	3	7	0	0	7	0	0
3	23748084	.	T	A	2	3	5	0	2	7	0	0
3	23748628	.	T	A	10	3	13	0	0	14	1	0
3	24071108	.	T	C	10	15	25	0	1	26	0	0
3	24100770	.	C	T	13	10	23	0	2	25	0	0
3	24109865	.	T	A	5	7	12	0	0	12	0	0
3	24111146	.	T	C	4	2	6	0	1	7	0	0
3	24111188	.	G	C	3	4	7	0	0	7	0	0
3	24134600	.	C	T	9	7	16	0	0	16	0	0
3	24134607	.	T	G	8	1	9	0	6	15	0	0
3	24142965	.	C	T	6	9	15	0	0	15	0	0
3	24143559	.	G	A	4	3	7	0	0	7	0	0
3	24144037	.	A	G	3	5	8	0	0	8	0	0
3	24145191	.	G	A	1	4	5	0	1	6	0	0
3	24182320	.	C	A	1	2	3	0	0	3	0	0
3	24196092	.	C	T	4	8	12	0	1	13	0	0
3	24196204	.	T	C	5	5	10	0	0	10	0	0
3	24196365	.	T	G	6	4	10	0	0	10	0	0
3	24196576	.	T	G	3	3	6	0	0	6	0	0
3	24198970	.	G	A	21	33	54	0	1	55	0	0
3	24200563	.	T	A	11	10	21	0	0	21	0	0
3	24203310	.	A	G	13	4	17	0	2	19	0	0
3	24203504	.	A	G	12	6	18	0	0	18	0	0
3	24203588	.	T	C	4	13	17	0	0	17	0	0
3	24203654	.	G	A	3	5	8	0	0	8	0	0
3	24203676	.	G	T	9	6	15	0	0	15	0	0
3	24203767	.	A	G	10	5	15	0	2	17	0	0
3	24207390	.	G	A	6	7	13	0	1	14	0	0
3	24209715	.	T	A	4	4	8	0	1	9	0	0
3	24209852	.	T	C	7	4	11	0	1	12	0	0
3	24214534	.	G	T	11	7	18	0	0	18	0	0
3	24216029	.	A	G	8	5	13	0	0	13	0	0
3	24216161	.	T	C	16	8	24	0	1	25	0	0
3	24218282	.	C	T	5	3	8	0	0	8	0	0
3	24287630	.	T	C	2	2	4	0	0	4	0	0
3	24289646	.	T	C	6	2	8	0	0	8	0	0
3	24290104	.	T	C	3	4	7	0	0	7	0	0
3	24292535	.	C	T	6	6	12	1	0	13	0	0
3	24295149	.	A	G	6	2	8	0	0	8	0	0
3	24295198	.	C	T	1	4	5	0	0	5	0	0
3	24295292	.	T	C	3	2	5	0	0	5	0	0
3	24295562	.	G	T	3	3	6	0	0	6	0	0
3	24361257	.	T	C	32	27	59	0	1	60	0	0
3	24434494	.	T	A	40	24	64	0	12	76	0	0
3	24434512	.	C	G	35	32	67	0	4	71	0	0
3	24434601	.	C	T	35	18	53	0	6	59	0	0
3	24438902	.	A	G	0	2	2	0	1	3	0	0
3	24438906	.	C	T	0	2	2	0	1	3	0	0
3	24443008	.	G	A	2	2	4	0	0	4	0	0
3	24446999	.	G	A	1	2	3	0	0	3	0	0
3	24447008	.	T	C	1	1	2	0	1	3	0	0
3	24483164	.	A	T	28	22	50	0	3	53	0	0
3	24483259	.	G	A	3	23	26	0	19	45	0	0
3	24487821	.	A	G	26	22	48	0	2	50	0	0
3	24487905	.	A	G	19	22	41	0	1	42	0	0
3	24489662	.	T	C	23	27	50	0	1	51	0	0
3	24489838	.	A	G	20	19	39	0	0	39	0	0
3	24501686	.	G	C	23	24	47	0	3	50	0	0
3	24501757	.	G	A	5	18	23	0	22	45	0	0
3	24501772	.	G	A	23	20	43	0	5	48	0	0
3	24516825	.	A	C	5	6	11	0	1	12	0	0
3	24516948	.	G	A	1	2	3	0	0	3	0	0
3	24517728	.	A	G	3	6	9	0	0	9	0	0
3	24517950	.	G	A	0	3	3	0	1	4	0	0
3	24518063	.	A	G	6	2	8	0	0	8	0	0
3	24554727	.	C	T	2	2	4	0	0	4	0	0
3	24687642	.	C	T	1	3	4	0	0	4	0	0
3	24690027	.	A	G	1	1	2	0	1	3	0	0
3	24690061	.	T	A	1	2	3	0	1	4	0	0
3	24690115	.	G	T	1	1	2	0	1	3	0	0
3	24690120	.	A	G	1	2	3	0	0	3	0	0
3	24690486	.	T	G	1	5	6	0	0	6	0	0
3	24690526	.	T	C	3	2	5	0	0	5	0	0
3	24691685	.	C	T	1	2	3	0	0	3	0	0
3	24691714	.	A	T	1	2	3	0	0	3	0	0
3	24692005	.	G	T	1	1	2	0	1	3	0	0
3	24692014	.	T	C	3	2	5	0	0	5	0	0
3	24692117	.	T	C	1	2	3	0	1	4	0	0
3	24708699	.	G	T	2	2	4	0	0	4	0	0
3	24745345	.	T	C	2	4	6	0	0	6	0	0
3	24763271	.	A	G	2	5	7	0	1	8	0	0
3	24763903	.	A	C	1	1	2	0	2	4	0	0
3	24765117	.	C	G	1	5	6	1	1	8	0	0
3	24793957	.	T	A	1	2	3	0	0	3	0	0
3	24793963	.	G	A	2	2	4	0	0	4	0	0
3	24838785	.	G	T	3	4	7	0	0	7	0	0
3	24903865	.	G	A	3	2	5	0	0	5	0	0
3	24973436	.	T	C	8	8	16	0	1	17	0	0
3	24973439	.	T	C	3	15	18	0	0	18	0	0
3	24973667	.	T	A	13	21	34	0	1	35	0	0
3	24973867	.	T	A	10	17	27	0	0	27	0	0
3	24973912	.	T	C	12	0	12	0	14	26	0	0
3	24974298	.	G	A	19	19	38	0	1	39	0	0
3	24990641	.	G	A	2	25	27	0	18	45	0	0
3	24990746	.	A	C	21	27	48	0	2	50	0	0
3	24993657	.	G	C	26	22	48	0	2	50	0	0
3	24993682	.	A	G	26	20	46	0	1	47	0	0
3	24994253	.	T	C	21	21	42	0	2	44	0	0
3	24997055	.	A	T	9	17	26	0	4	30	0	0
3	24997955	.	A	T	8	12	20	0	1	21	0	0
3	24998204	.	C	G	9	7	16	0	1	17	0	0
3	24998533	.	A	G	18	17	35	0	3	38	0	0
3	24998536	.	A	G	21	18	39	0	0	39	0	0
3	24998797	.	C	T	8	11	19	0	2	21	0	0
3	24998833	.	C	T	10	10	20	0	0	20	0	0
3	24998860	.	C	T	10	12	22	2	2	26	0	0
3	24999049	.	T	C	15	6	21	0	1	22	0	0
3	24999601	.	C	T	2	11	13	0	7	20	0	0
3	24999636	.	A	C	10	14	24	0	1	25	0	0
3	24999916	.	A	G	12	9	21	0	0	21	0	0
3	24999955	.	T	G	13	12	25	0	1	26	0	0
3	24999967	.	A	G	15	10	25	0	0	25	0	0
3	25000051	.	G	T	12	8	20	0	0	20	0	0
3	25000114	.	G	A	13	10	23	0	1	24	0	0
3	25000417	.	C	A	0	14	14	0	6	20	0	0
3	25002169	.	A	G	12	12	24	0	0	24	0	0
3	25005814	.	A	C	6	8	14	0	0	14	0	0
3	25007702	.	C	A	6	8	14	0	0	14	0	0
3	25025273	.	G	A	10	2	12	0	0	12	0	0
3	25027734	.	G	A	7	5	12	0	1	13	0	0
3	25031948	.	C	T	2	3	5	0	0	5	0	0
3	25036604	.	C	T	10	3	13	0	0	13	0	0
3	25039367	.	C	G	3	6	9	0	0	9	0	0
3	25039390	.	T	C	6	5	11	0	0	11	0	0
3	25039408	.	C	G	6	3	9	0	0	9	0	0
3	25039489	.	A	G	4	3	7	0	0	7	0	0
3	25039555	.	C	T	2	5	7	0	0	7	0	0
3	25040475	.	T	C	2	4	6	0	0	6	0	0
3	25040538	.	G	A	1	5	6	0	0	6	0	0
3	25040779	.	G	A	6	6	12	0	1	13	0	0
3	25040812	.	G	A	3	7	10	0	0	10	0	0
3	25046133	.	A	G	4	4	8	0	0	8	0	0
3	25046136	.	A	G	4	5	9	0	0	9	0	0
3	25051437	.	A	G	5	7	12	0	0	12	0	0
3	25054458	.	G	A	3	6	9	0	0	9	0	0
3	25059771	.	A	G	5	2	7	0	0	7	0	0
3	25060009	.	C	T	1	3	4	0	0	4	0	0
3	25066348	.	A	G	9	5	14	0	0	14	0	0
3	25081126	.	T	G	6	2	8	0	0	8	0	0
3	25085122	.	G	A	6	3	9	0	0	9	0	0
3	25086904	.	A	G	5	3	8	0	0	8	0	0
3	25094590	.	G	A	17	15	32	0	1	33	0	0
3	25094623	.	G	A	2	20	22	0	17	40	1	0
3	25097047	.	C	A	27	27	54	0	3	57	0	0
3	25097218	.	T	A	23	22	45	0	0	45	0	0
3	25097257	.	T	C	28	23	51	0	4	55	0	0
3	25099018	.	A	G	30	26	56	0	3	59	0	0
3	25099883	.	T	C	16	26	42	0	1	43	0	0
3	25099988	.	T	A	21	18	39	0	0	39	0	0
3	25100004	.	A	G	21	14	35	0	1	36	0	0
3	25100182	.	A	T	20	23	43	0	1	44	0	0
3	25100222	.	G	A	1	30	31	0	19	50	0	0
3	25100311	.	C	G	27	20	47	1	0	48	0	0
3	25100379	.	A	T	33	17	50	0	3	53	0	0
3	25102030	.	A	T	15	15	30	0	3	33	0	0
3	25102095	.	A	G	19	18	37	0	1	38	0	0
3	25105097	.	A	C	19	1	20	0	19	39	0	0
3	25107705	.	T	C	20	22	42	0	2	44	0	0
3	25107729	.	A	T	16	16	32	0	0	32	0	0
3	25136479	.	C	T	1	9	10	0	6	16	0	0
3	25136571	.	G	A	7	5	12	0	0	12	0	0
3	25136706	.	C	G	9	4	13	0	1	14	0	0
3	25136819	.	T	G	5	10	15	0	0	15	0	0
3	25136855	.	G	T	6	10	16	0	0	16	0	0
3	25136868	.	A	G	7	9	16	0	0	16	0	0
3	25137144	.	G	T	3	6	9	0	0	9	0	0
3	25137544	.	T	C	2	0	2	0	4	6	0	0
3	25137545	.	A	G	2	4	6	0	0	6	0	0
3	25137585	.	T	C	2	5	7	0	0	7	0	0
3	25138011	.	G	A	4	3	7	0	0	7	0	0
3	25138264	.	G	T	11	8	19	0	2	21	0	0
3	25138306	.	C	T	14	8	22	0	0	22	0	0
3	25138543	.	C	T	0	8	8	0	8	16	0	0
3	25144108	.	A	C	8	9	17	0	2	19	0	0
3	25144109	.	T	C	10	9	19	0	0	19	0	0
3	25144211	.	A	G	8	10	18	0	1	19	0	0
3	25147989	.	G	A	3	7	10	0	1	11	0	0
3	25147990	.	C	G	0	7	7	0	4	11	0	0
3	25167162	.	A	G	10	5	15	0	0	15	0	0
3	25167238	.	C	A	6	11	17	0	1	18	0	0
3	25167332	.	A	C	10	10	20	0	0	20	0	0
3	25167351	.	A	C	8	10	18	0	0	18	0	0
3	25168907	.	A	T	13	14	27	0	1	28	0	0
3	25168994	.	C	T	7	12	19	0	0	19	0	0
3	25169181	.	C	T	6	4	10	0	0	10	0	0
3	25169426	.	C	T	9	3	12	0	0	12	0	0
3	25169483	.	C	T	4	2	6	0	0	6	0	0
3	25169600	.	A	T	2	2	4	0	0	4	0	0
3	25169612	.	A	T	1	2	3	0	1	4	0	0
3	25269936	.	A	C	2	16	18	0	0	18	0	0
3	25269960	.	A	G	6	22	28	0	1	29	0	0
3	25270023	.	A	G	12	12	24	0	0	24	0	0
3	25270048	.	G	T	15	11	26	0	0	26	0	0
3	25270058	.	A	C	15	10	25	0	1	26	0	0
3	25270311	.	A	G	35	21	56	1	15	72	0	0
3	25270320	.	A	G	35	21	56	1	16	73	0	0
3	25270602	.	C	G	32	37	69	0	9	78	0	0
3	25270680	.	C	T	37	35	72	0	3	75	0	0
3	25270710	.	A	C	39	34	73	0	2	75	0	0
3	25270752	.	A	G	40	35	75	0	6	81	0	0
3	25271209	.	T	A	25	35	60	0	6	66	0	0
3	25271579	.	C	T	27	24	51	0	0	51	0	0
3	25271653	.	T	C	23	26	49	0	4	53	0	0
3	25272051	.	T	A	32	43	75	0	0	75	0	0
3	25272623	.	C	T	33	31	64	0	3	67	0	0
3	25272859	.	T	A	28	35	63	0	1	64	0	0
3	25273463	.	G	A	25	34	59	0	2	61	0	0
3	25273524	.	G	C	35	28	63	0	2	65	0	0
3	25273648	.	A	G	34	21	55	0	5	60	0	0
3	25286050	.	G	A	10	13	23	0	0	23	0	0
3	25333049	.	A	G	9	5	14	0	1	15	0	0
3	25379483	.	C	A	2	14	16	0	15	31	0	0
3	25379546	.	A	G	17	20	37	0	0	37	0	0
3	25381494	.	G	A	21	11	32	0	0	32	0	0
3	25393308	.	A	G	16	17	33	0	3	36	0	0
3	25396677	.	G	T	21	17	38	0	8	46	0	0
3	25400673	.	C	T	1	12	13	0	14	27	0	0
3	25403654	.	G	A	8	9	17	0	2	19	0	0
3	25403685	.	G	A	9	8	17	0	1	18	0	0
3	25403812	.	G	C	8	9	17	0	0	17	0	0
3	25403865	.	G	T	6	9	15	0	0	15	0	0
3	25404038	.	G	A	7	4	11	0	0	11	0	0
3	25404045	.	A	G	7	4	11	0	0	11	0	0
3	25404444	.	G	T	5	7	12	0	0	12	0	0
3	25404591	.	G	A	8	11	19	0	1	20	0	0
3	25404618	.	T	C	9	9	18	0	1	19	0	0
3	25404626	.	G	T	8	10	18	0	0	18	0	0
3	25404699	.	G	A	13	8	21	0	1	22	0	0
3	25405033	.	C	T	3	6	9	0	3	12	0	0
3	25405540	.	T	C	12	5	17	0	0	17	0	0
3	25409641	.	C	T	1	3	4	0	5	9	0	0
3	25409655	.	C	T	6	4	10	0	0	10	0	0
3	25417279	.	G	A	7	5	12	0	0	12	0	0
3	25417345	.	C	T	6	9	15	0	1	16	0	0
3	25420845	.	T	C	13	9	22	0	1	23	0	0
3	25436830	.	T	C	10	10	20	0	2	22	0	0
3	25436893	.	T	G	11	8	19	0	1	20	0	0
3	25437284	.	G	T	26	11	37	0	1	38	0	0
3	25491134	.	A	G	18	9	27	0	1	28	0	0
3	26057839	.	G	A	1	18	19	0	3	22	0	0
3	26057842	.	G	T	0	19	19	0	4	23	0	0
3	26120592	.	G	A	1	2	3	4	0	7	0	0
3	26157652	.	T	C	2	2	4	0	0	4	0	0
3	27695410	.	A	G	6	4	10	1	0	11	0	0
3	27695434	.	A	G	2	0	2	0	4	6	0	0
3	27695450	.	A	G	1	0	1	0	3	4	0	0
3	27833108	.	T	C	24	6	30	0	3	33	0	0
3	27834305	.	T	C	24	8	32	0	0	32	0	0
3	27834412	.	T	C	25	17	42	0	2	44	0	0
3	27834552	.	T	C	16	11	27	0	0	27	0	0
3	27834563	.	T	C	23	5	28	0	2	30	0	0
3	27836036	.	T	C	14	5	19	1	4	24	0	0
3	28594831	.	T	C	3	3	6	0	0	6	0	0
3	28621351	.	C	T	2	2	4	0	0	4	0	0
3	28626340	.	A	C	7	5	12	0	0	12	0	0
3	28627044	.	T	A	6	5	11	0	0	11	0	0
3	28634485	.	T	A	11	7	18	0	0	18	0	0
3	28634549	.	A	G	15	15	30	0	0	30	0	0
3	28634883	.	C	A	11	14	25	2	6	33	0	0
3	28634884	.	A	C	10	16	26	2	5	33	0	0
3	28635106	.	G	A	20	14	34	0	1	35	0	0
3	28640608	.	C	T	0	20	20	1	16	37	0	0
3	28640734	.	G	A	16	19	35	0	0	35	0	0
3	28650721	.	T	C	13	0	13	0	7	20	0	0
3	28665218	.	T	C	14	14	28	0	0	28	0	0
3	28665239	.	G	A	13	18	31	0	0	31	0	0
3	28719103	.	G	A	6	2	8	0	1	9	0	0
3	28719506	.	C	G	7	8	15	0	1	16	0	0
3	28719592	.	T	G	12	9	21	0	0	21	0	0
3	28719636	.	T	A	11	7	18	0	1	19	0	0
3	28719649	.	C	T	11	2	13	0	0	13	0	0
3	28719730	.	G	T	6	9	15	0	0	15	0	0
3	28719852	.	T	C	3	5	8	0	1	9	0	0
3	28719878	.	G	A	4	4	8	0	0	8	0	0
3	28719905	.	C	A	0	5	5	0	3	8	0	0
3	28720010	.	G	A	4	2	6	0	0	6	0	0
3	28750223	.	G	T	7	4	11	0	1	12	0	0
3	28750376	.	A	C	4	12	16	0	0	16	0	0
3	28750377	.	G	C	4	12	16	0	0	16	0	0
3	29950919	.	T	C	21	6	27	0	0	27	0	0
3	29950927	.	T	C	13	12	25	0	0	25	0	0
3	29951384	.	T	C	16	6	22	1	1	24	0	0
3	30665379	.	A	T	3	2	5	0	0	5	0	0
3	30749508	.	T	C	8	0	8	0	3	11	0	0
3	30749541	.	G	A	10	5	15	0	0	15	0	0
3	30801282	.	G	A	6	15	21	0	1	22	0	0
3	30801297	.	G	T	6	15	21	0	0	21	0	0
3	30801370	.	T	C	15	0	15	0	7	22	0	0
3	30860896	.	A	T	6	7	13	0	0	13	0	0
3	30861043	.	G	A	2	3	5	0	0	5	0	0
3	30868430	.	A	G	1	2	3	0	0	3	0	0
3	30868853	.	T	G	9	7	16	0	0	16	0	0
3	30868855	.	T	C	9	7	16	0	0	16	0	0
3	30869205	.	A	G	10	10	20	0	1	21	0	0
3	30869206	.	C	T	8	7	15	0	6	21	0	0
3	30869662	.	C	T	5	7	12	0	1	13	0	0
3	30869728	.	C	T	0	11	11	0	11	22	0	0
3	30869938	.	A	G	7	5	12	0	1	13	0	0
3	30870382	.	T	G	6	9	15	0	0	15	0	0
3	30870409	.	G	A	6	7	13	0	0	13	0	0
3	30870508	.	G	A	11	8	19	0	0	19	0	0
3	30870670	.	G	A	5	5	10	0	0	10	0	0
3	30870838	.	T	A	5	7	12	0	1	13	0	0
3	30870974	.	A	C	3	10	13	0	1	15	1	0
3	30871021	.	G	T	3	7	10	0	0	10	0	0
3	30871478	.	A	T	5	7	12	0	0	12	0	0
3	30871873	.	C	G	0	5	5	0	4	9	0	0
3	30872004	.	C	T	5	5	10	0	1	11	0	0
3	30872264	.	T	G	13	6	19	0	0	19	0	0
3	30872608	.	C	T	0	5	5	0	6	11	0	0
3	30872655	.	T	C	5	11	16	0	1	17	0	0
3	30873029	.	G	A	3	8	11	0	0	11	0	0
3	30873048	.	G	A	3	7	10	0	0	10	0	0
3	30873102	.	T	C	5	2	7	0	1	8	0	0
3	30873165	.	C	T	2	4	6	0	1	7	0	0
3	30873185	.	A	T	3	5	8	0	0	8	0	0
3	30873316	.	C	G	0	2	2	0	4	6	0	0
3	30873408	.	T	C	3	2	5	0	0	5	0	0
3	30877163	.	C	T	4	5	9	0	1	10	0	0
3	30890630	.	T	A	9	15	24	1	0	25	0	0
3	30890869	.	G	A	19	24	43	0	2	45	0	0
3	30891201	.	A	G	27	25	52	0	1	53	0	0
3	30894281	.	A	G	16	24	40	0	0	40	0	0
3	30926689	.	A	G	3	2	5	0	0	5	0	0
3	30926817	.	T	C	2	0	2	0	2	4	0	0
3	30932219	.	G	A	5	4	9	0	0	9	0	0
3	30935001	.	A	G	3	3	6	0	0	6	0	0
3	30948173	.	G	A	5	8	13	0	0	13	0	0
3	30948206	.	C	A	6	7	13	0	0	13	0	0
3	30962536	.	C	T	0	4	4	0	6	10	0	0
3	31043733	.	A	C	2	4	6	0	1	7	0	0
3	31043800	.	T	C	2	2	4	0	0	4	0	0
3	31043876	.	A	C	1	0	1	0	2	3	0	0
3	31044579	.	A	G	1	7	8	0	1	9	0	0
3	31044649	.	T	C	1	4	5	0	1	6	0	0
3	31044782	.	A	C	5	0	5	0	4	9	0	0
3	31045098	.	G	A	5	3	8	0	1	9	0	0
3	31045271	.	T	G	3	4	7	0	0	7	0	0
3	31045335	.	C	G	2	5	7	0	0	7	0	0
3	31045407	.	C	A	1	5	6	0	0	6	0	0
3	31050126	.	T	A	6	9	15	0	0	15	0	0
3	31050554	.	T	C	3	3	6	0	1	7	0	0
3	31052589	.	G	A	3	2	5	0	1	6	0	0
3	31053145	.	A	G	2	4	6	0	0	6	0	0
3	31053268	.	A	C	3	0	3	2	5	10	0	0
3	31057563	.	G	A	2	2	4	0	0	4	0	0
3	31060219	.	A	G	5	0	5	0	7	12	0	0
3	31060366	.	C	T	2	2	4	0	0	4	0	0
3	31063319	.	A	G	1	2	3	0	1	4	0	0
3	31063625	.	A	T	6	7	13	0	0	13	0	0
3	31066143	.	C	G	4	5	9	0	1	10	0	0
3	31066259	.	A	G	7	6	13	0	0	13	0	0
3	31066269	.	A	C	6	5	11	0	0	11	0	0
3	31066637	.	G	A	6	3	9	0	0	9	0	0
3	31070541	.	T	C	1	0	1	0	2	3	0	0
3	31070892	.	A	G	26	18	44	0	0	44	0	0
3	31080994	.	G	A	2	2	4	0	0	4	0	0
3	31081017	.	T	C	2	2	4	0	0	4	0	0
3	31082995	.	T	A	2	2	4	0	0	4	0	0
3	31084598	.	C	T	5	4	9	0	1	10	0	0
3	31086366	.	A	G	3	4	7	0	0	7	0	0
3	31089600	.	C	G	1	3	4	0	1	5	0	0
3	31090424	.	T	C	2	3	5	0	0	5	0	0
3	31090444	.	G	A	2	2	4	0	0	4	0	0
3	31090557	.	G	C	1	5	6	0	0	6	0	0
3	31102353	.	G	C	2	2	4	0	0	4	0	0
3	31102468	.	C	T	1	2	3	0	0	3	0	0
3	31104279	.	A	G	3	3	6	0	1	7	0	0
3	31104280	.	C	T	3	4	7	0	0	7	0	0
3	31104369	.	A	C	3	1	4	0	2	6	0	0
3	31104652	.	G	A	3	2	5	0	0	5	0	0
3	31104655	.	G	T	3	2	5	0	0	5	0	0
3	31104943	.	C	T	3	2	5	0	2	7	0	0
3	31104969	.	G	A	6	4	10	0	1	11	0	0
3	31105259	.	A	C	19	32	51	0	0	51	0	0
3	31120249	.	C	T	18	18	36	0	1	37	0	0
3	31122581	.	T	G	11	16	27	0	2	29	0	0
3	31135832	.	T	C	13	1	14	0	11	25	0	0
3	31135898	.	T	C	11	0	11	1	16	28	0	0
3	31137926	.	T	C	8	13	21	0	2	23	0	0
3	31137957	.	G	A	8	9	17	0	0	17	0	0
3	31138225	.	A	G	11	12	23	0	1	24	0	0
3	31138247	.	C	T	11	6	17	0	1	18	0	0
3	31140267	.	C	T	5	4	9	0	1	10	0	0
3	31143129	.	T	G	9	10	19	0	0	19	0	0
3	31144674	.	A	G	2	12	14	0	0	14	0	0
3	31146690	.	C	T	6	7	13	0	1	14	0	0
3	31146909	.	G	A	4	2	6	0	1	7	0	0
3	31149781	.	C	A	7	7	14	0	0	14	0	0
3	31150996	.	G	A	13	2	15	0	0	15	0	0
3	31151008	.	T	A	11	2	13	0	2	15	0	0
3	31152156	.	A	C	3	3	6	0	0	6	0	0
3	31152284	.	A	G	7	4	11	0	0	11	0	0
3	31152443	.	G	A	1	8	9	0	2	11	0	0
3	31155340	.	C	T	1	2	3	0	4	7	0	0
3	31179384	.	G	A	1	3	4	0	3	7	0	0
3	31187564	.	C	G	4	8	12	0	0	12	0	0
3	31187608	.	C	T	4	3	7	0	4	11	0	0
3	31187719	.	G	A	3	2	5	0	2	7	0	0
3	31187721	.	A	C	3	4	7	0	0	7	0	0
3	31201643	.	T	G	6	5	11	0	0	11	0	0
3	31214520	.	G	A	2	6	8	0	0	8	0	0
3	31217714	.	G	T	2	6	8	0	1	9	0	0
3	31217723	.	G	A	3	7	10	0	0	10	0	0
3	31218153	.	C	T	0	5	5	0	6	11	0	0
3	31218230	.	G	A	4	7	11	0	0	11	0	0
3	31218240	.	T	A	10	3	13	0	0	13	0	0
3	31396212	.	A	G	9	0	9	0	6	15	0	0
3	31396679	.	A	G	15	9	24	0	3	27	0	0
3	31396760	.	A	C	17	7	24	0	1	25	0	0
3	31396781	.	C	G	11	0	11	0	11	22	0	0
3	31396826	.	T	C	8	9	17	2	0	19	0	0
3	31430327	.	T	C	14	10	24	0	0	24	0	0
3	31600731	.	T	C	6	7	13	0	0	13	0	0
3	31603925	.	A	G	4	4	8	0	0	8	0	0
3	31603976	.	G	A	1	4	5	0	0	5	0	0
3	31604030	.	T	C	4	3	7	0	0	7	0	0
3	31604411	.	T	A	3	4	7	0	0	7	0	0
3	31604834	.	A	T	5	5	10	0	2	13	1	0
3	31605033	.	A	G	4	4	8	0	0	8	0	0
3	31605039	.	C	T	4	3	7	0	0	8	1	0
3	31621879	.	A	T	1	3	4	0	0	4	0	0
3	31622861	.	C	T	1	2	3	0	0	3	0	0
3	31706607	.	C	A	13	10	23	0	0	23	0	0
3	31706966	.	T	C	5	9	14	0	1	15	0	0
3	31709010	.	C	T	9	19	28	0	4	32	0	0
3	31709079	.	G	A	19	16	35	0	1	36	0	0
3	31711526	.	T	C	17	11	28	0	0	28	0	0
3	31712328	.	G	T	10	7	17	0	0	17	0	0
3	31717595	.	C	T	8	24	32	0	3	35	0	0
3	31722101	.	A	T	26	20	46	0	1	47	0	0
3	31722342	.	A	G	22	23	45	0	0	45	0	0
3	31725824	.	C	T	17	15	32	0	1	33	0	0
3	31726066	.	T	C	11	23	34	0	2	36	0	0
3	31726395	.	G	A	3	6	9	0	13	22	0	0
3	31726541	.	A	T	4	11	15	0	1	16	0	0
3	31726829	.	C	T	11	11	22	1	0	23	0	0
3	31729087	.	T	G	2	3	5	0	0	5	0	0
3	31729328	.	A	G	3	5	8	0	0	8	0	0
3	31729531	.	C	T	4	3	7	0	0	7	0	0
3	31729707	.	C	T	1	2	3	0	4	7	0	0
3	31734188	.	C	T	0	5	5	0	10	15	0	0
3	31742271	.	G	T	4	2	6	0	0	6	0	0
3	31742277	.	C	T	2	3	5	0	0	5	0	0
3	31783718	.	G	A	2	2	4	0	0	4	0	0
3	31783768	.	C	G	2	3	5	0	0	5	0	0
3	31784001	.	A	G	3	3	6	0	0	6	0	0
3	31792683	.	G	T	13	6	19	0	2	21	0	0
3	31792856	.	G	A	15	8	23	0	0	23	0	0
3	31793080	.	C	T	11	8	19	0	1	20	0	0
3	31793515	.	T	G	10	8	18	0	0	18	0	0
3	31793518	.	G	A	8	9	17	0	0	17	0	0
3	31793557	.	A	G	8	10	18	0	0	18	0	0
3	31793715	.	G	C	12	12	24	0	1	25	0	0
3	31793739	.	C	T	14	11	25	0	1	26	0	0
3	31797508	.	C	G	8	12	20	0	1	21	0	0
3	31797749	.	A	G	7	11	18	0	1	19	0	0
3	31799575	.	G	A	5	9	14	0	0	14	0	0
3	31804244	.	A	G	5	3	8	0	0	8	0	0
3	31815456	.	G	T	1	2	3	0	0	3	0	0
3	31815498	.	G	A	2	2	4	0	0	4	0	0
3	31874969	.	G	T	9	13	22	0	1	23	0	0
3	31879513	.	T	A	5	4	9	0	0	9	0	0
3	31879626	.	G	A	2	4	6	0	0	6	0	0
3	31879646	.	A	C	0	7	7	0	0	7	0	0
3	31879725	.	T	A	7	7	14	0	0	14	0	0
3	31879726	.	C	A	8	7	15	0	0	15	0	0
3	31879880	.	G	T	10	13	23	0	0	23	0	0
3	31879911	.	T	C	7	12	19	0	1	20	0	0
3	31880184	.	C	G	1	3	4	0	12	16	0	0
3	31880641	.	C	T	1	14	15	0	13	28	0	0
3	31881082	.	G	T	13	7	20	0	0	20	0	0
3	31884001	.	A	G	7	9	16	0	1	17	0	0
3	31884321	.	C	T	1	13	14	0	11	25	0	0
3	31884477	.	C	T	7	8	15	0	1	16	0	0
3	31886783	.	C	T	1	7	8	0	5	13	0	0
3	31890010	.	T	C	17	10	27	0	1	28	0	0
3	31892324	.	C	T	10	6	16	0	1	17	0	0
3	31897070	.	A	G	4	3	7	0	0	7	0	0
3	31914167	.	T	A	7	5	12	0	1	13	0	0
3	31916624	.	T	G	6	0	6	3	18	27	0	0
3	31916701	.	A	T	10	5	15	0	2	17	0	0
3	31916724	.	A	G	14	8	22	0	0	22	0	0
3	31916787	.	G	T	13	11	24	0	0	24	0	0
3	31916863	.	T	C	13	11	24	0	0	24	0	0
3	31917279	.	G	T	3	8	11	0	0	11	0	0
3	31922838	.	G	C	4	5	9	0	0	9	0	0
3	31926052	.	C	A	15	17	32	0	2	34	0	0
3	31939272	.	A	G	14	13	27	0	2	29	0	0
3	31939473	.	G	T	2	27	29	0	13	42	0	0
3	31939566	.	C	A	22	18	40	1	2	43	0	0
3	31941152	.	C	T	14	17	31	0	1	32	0	0
3	31944357	.	A	T	11	14	25	3	1	29	0	0
3	31951034	.	A	C	1	2	3	0	0	3	0	0
3	31961992	.	G	A	4	13	17	0	20	37	0	0
3	32021628	.	G	A	17	10	27	0	0	27	0	0
3	32049674	.	C	G	2	2	4	1	23	28	0	0
3	32049689	.	C	A	22	6	28	0	0	28	0	0
3	32049740	.	C	T	20	7	27	0	3	30	0	0
3	32078695	.	T	G	2	1	3	0	1	4	0	0
3	32078699	.	C	T	2	2	4	0	0	4	0	0
3	32083116	.	G	T	0	2	2	0	1	3	0	0
3	32085821	.	T	A	1	3	4	0	0	4	0	0
3	32085822	.	C	T	1	3	4	0	0	4	0	0
3	32087455	.	T	G	4	4	8	0	1	9	0	0
3	32092698	.	A	T	3	6	9	0	0	9	0	0
3	32098130	.	G	A	0	3	3	0	1	4	0	0
3	32099841	.	A	G	18	0	18	1	26	45	0	0
3	32100183	.	G	T	16	13	29	20	1	50	0	0
3	32100206	.	T	C	8	5	13	26	0	39	0	0
3	32100755	.	T	C	27	12	39	9	1	49	0	0
3	32105746	.	C	A	18	7	25	0	3	28	0	0
3	32105759	.	G	T	21	5	26	2	0	28	0	0
3	32119573	.	T	C	1	2	3	0	0	3	0	0
3	32120187	.	A	T	1	4	5	3	0	8	0	0
3	32139671	.	G	A	5	2	7	0	0	7	0	0
3	32169545	.	G	A	3	1	4	0	2	6	0	0
3	32169677	.	C	T	2	2	4	0	1	5	0	0
3	32172913	.	C	G	2	2	4	0	1	5	0	0
3	32172915	.	G	A	2	2	4	0	1	5	0	0
3	32175758	.	C	T	1	3	4	0	5	9	0	0
3	32175918	.	C	A	4	4	8	0	1	9	0	0
3	32175945	.	T	C	2	0	2	0	5	7	0	0
3	32294745	.	G	A	23	12	35	0	2	37	0	0
3	32294869	.	C	G	2	15	17	0	32	49	0	0
3	32295151	.	C	T	22	16	38	0	1	39	0	0
3	32295294	.	G	A	24	12	36	7	1	44	0	0
3	32295519	.	A	C	28	12	40	0	0	40	0	0
3	32295635	.	T	A	11	15	26	0	1	27	0	0
3	32296122	.	C	T	20	9	29	0	3	32	0	0
3	32296202	.	G	A	15	12	27	0	0	27	0	0
3	32296253	.	T	A	14	6	20	0	2	22	0	0
3	32296283	.	G	A	11	8	19	0	0	19	0	0
3	32296306	.	G	A	8	6	14	0	0	14	0	0
3	32296379	.	A	G	12	12	24	0	0	24	0	0
3	32296559	.	G	A	15	14	29	0	2	31	0	0
3	32296560	.	C	T	1	15	16	0	16	32	0	0
3	32296673	.	A	G	25	12	37	0	1	38	0	0
3	32296873	.	G	A	20	12	32	0	0	32	0	0
3	32303045	.	G	A	13	9	22	0	2	24	0	0
3	32303589	.	G	C	2	0	2	0	2	4	0	0
3	32303590	.	T	G	2	2	4	0	0	4	0	0
3	32303698	.	A	G	20	22	42	0	2	44	0	0
3	32314732	.	G	A	17	15	32	0	1	33	0	0
3	32325218	.	A	G	3	6	9	0	1	10	0	0
3	32329167	.	A	T	13	15	28	0	0	28	0	0
3	32357596	.	C	T	27	23	50	2	5	57	0	0
3	32357799	.	A	C	23	30	53	0	3	56	0	0
3	32360978	.	G	A	19	17	36	0	1	37	0	0
3	32361669	.	G	A	21	24	45	0	1	46	0	0
3	32361865	.	A	G	26	14	40	1	0	41	0	0
3	32366131	.	T	C	21	15	36	0	4	40	0	0
3	32366279	.	T	C	24	7	31	1	0	32	0	0
3	32366332	.	G	A	20	14	34	0	1	35	0	0
3	32366403	.	C	T	25	19	44	0	1	45	0	0
3	32400967	.	C	T	30	32	62	0	4	66	0	0
3	32401159	.	C	A	39	28	67	1	0	68	0	0
3	32401252	.	C	T	23	21	44	0	4	48	0	0
3	32403959	.	T	G	20	1	21	0	12	33	0	0
3	32405571	.	C	T	23	21	44	0	2	46	0	0
3	32405865	.	G	C	25	22	47	1	1	49	0	0
3	32405910	.	C	T	21	24	45	0	2	47	0	0
3	32406447	.	T	C	31	25	56	0	5	61	0	0
3	32406547	.	T	C	27	23	50	0	2	52	0	0
3	32406618	.	G	A	26	30	56	0	2	58	0	0
3	32406631	.	C	G	32	17	49	0	4	53	0	0
3	32415781	.	A	C	2	2	4	0	0	4	0	0
3	32433953	.	T	C	11	20	31	0	2	33	0	0
3	32434974	.	G	A	0	17	17	0	16	33	0	0
3	32435034	.	G	T	4	11	15	0	18	33	0	0
3	32435757	.	G	A	0	16	16	0	13	29	0	0
3	32435874	.	G	A	0	10	10	0	8	18	0	0
3	32436024	.	C	A	13	5	18	0	3	21	0	0
3	32436109	.	T	A	7	9	16	0	1	17	0	0
3	32436156	.	T	C	7	8	15	0	1	16	0	0
3	32436426	.	C	T	19	12	31	0	1	32	0	0
3	32436736	.	G	C	13	17	30	0	1	31	0	0
3	32436774	.	G	A	9	11	20	0	2	22	0	0
3	32438425	.	A	C	15	19	34	0	0	34	0	0
3	32440805	.	A	G	20	11	31	0	1	32	0	0
3	32441156	.	T	G	22	0	22	0	21	43	0	0
3	32441297	.	C	A	16	15	31	0	1	32	0	0
3	32441385	.	G	C	19	17	36	0	1	37	0	0
3	32441532	.	G	A	11	21	32	0	8	40	0	0
3	32441779	.	C	T	25	25	50	0	0	50	0	0
3	32447386	.	G	A	15	6	21	0	1	22	0	0
3	32447505	.	G	T	22	17	39	0	0	39	0	0
3	32447674	.	C	G	20	9	29	0	0	30	1	0
3	32447800	.	T	C	13	15	28	0	1	29	0	0
3	32450399	.	T	C	18	22	40	0	1	41	0	0
3	32453727	.	G	A	18	19	37	1	2	40	0	0
3	32457325	.	G	A	1	24	25	1	24	50	0	0
3	32457620	.	T	C	17	15	32	0	1	33	0	0
3	32457686	.	T	C	14	16	30	0	1	31	0	0
3	32458627	.	C	T	10	10	20	0	0	20	0	0
3	32477891	.	T	C	18	11	29	0	1	30	0	0
3	32477950	.	T	A	11	10	21	0	3	24	0	0
3	32479471	.	T	C	7	6	13	0	1	14	0	0
3	32482222	.	A	T	12	9	21	0	0	21	0	0
3	32482231	.	A	G	15	2	17	0	8	25	0	0
3	32482495	.	G	T	2	16	18	0	12	30	0	0
3	32482834	.	A	G	12	7	19	0	2	21	0	0
3	32483557	.	T	G	20	19	39	0	2	41	0	0
3	32483956	.	T	C	17	8	25	0	2	27	0	0
3	32484034	.	A	G	26	0	26	0	14	40	0	0
3	32484039	.	A	G	25	0	25	0	14	39	0	0
3	32484204	.	T	C	17	19	36	0	0	36	0	0
3	32484472	.	T	C	15	21	36	0	3	39	0	0
3	32484676	.	T	G	24	19	43	0	0	44	1	0
3	32484892	.	A	G	10	14	24	0	3	27	0	0
3	32485306	.	A	G	22	21	43	0	1	44	0	0
3	32485324	.	C	T	24	24	48	0	0	48	0	0
3	32485366	.	A	G	24	21	45	0	0	45	0	0
3	32485519	.	A	C	16	20	36	0	4	40	0	0
3	32485967	.	C	A	37	14	51	0	0	51	0	0
3	32486049	.	A	T	18	20	38	0	0	38	0	0
3	32486069	.	C	G	19	0	19	0	14	33	0	0
3	32489613	.	C	T	21	19	40	0	1	41	0	0
3	32490098	.	C	T	15	7	22	0	2	24	0	0
3	32490251	.	G	T	14	10	24	0	0	24	0	0
3	32490264	.	G	A	11	10	21	0	2	23	0	0
3	32490487	.	G	T	6	12	18	0	1	19	0	0
3	32534263	.	A	G	13	11	24	0	1	25	0	0
3	32534353	.	C	T	11	12	23	0	1	24	0	0
3	32534365	.	T	A	13	11	24	0	1	25	0	0
3	32587304	.	C	T	5	4	9	0	0	9	0	0
3	32589231	.	T	A	3	2	5	0	1	6	0	0
3	32589250	.	G	C	4	0	4	0	2	6	0	0
3	32641716	.	T	G	13	11	24	0	0	24	0	0
3	32643512	.	G	A	15	15	30	0	1	31	0	0
3	32647124	.	T	C	17	20	37	0	1	38	0	0
3	32647194	.	C	T	13	8	21	0	2	23	0	0
3	32647252	.	G	A	11	12	23	0	2	25	0	0
3	32647308	.	G	C	16	13	29	0	1	30	0	0
3	32647414	.	A	G	4	11	15	0	0	15	0	0
3	32647558	.	A	G	17	0	17	0	14	31	0	0
3	32649846	.	C	T	8	17	25	0	1	26	0	0
3	32649960	.	G	A	14	13	27	0	0	27	0	0
3	32650004	.	A	G	13	11	24	0	0	24	0	0
3	32650199	.	C	A	4	5	9	0	0	9	0	0
3	32657323	.	C	T	1	2	3	0	0	3	0	0
3	32658076	.	T	C	3	3	6	0	0	6	0	0
3	32661856	.	A	T	2	2	4	0	0	4	0	0
3	32662034	.	A	C	1	4	5	0	0	5	0	0
3	32663255	.	T	C	1	5	6	0	0	6	0	0
3	32663335	.	A	G	7	0	7	0	5	12	0	0
3	32663485	.	T	C	4	7	11	0	0	11	0	0
3	32663638	.	A	G	3	1	4	0	1	5	0	0
3	32663764	.	T	G	5	3	8	0	0	9	1	0
3	32667118	.	A	C	6	7	13	0	0	13	0	0
3	32668806	.	A	G	6	7	13	0	1	14	0	0
3	32668818	.	A	G	5	6	11	0	1	12	0	0
3	32672501	.	C	A	8	6	14	0	1	15	0	0
3	32675236	.	G	A	14	10	24	0	0	24	0	0
3	32679267	.	T	A	14	16	30	0	0	30	0	0
3	32679289	.	T	A	18	11	29	0	2	31	0	0
3	32679332	.	C	T	24	9	33	0	0	33	0	0
3	32679528	.	C	A	16	10	26	0	1	27	0	0
3	32685708	.	A	G	12	0	12	0	17	29	0	0
3	32686230	.	A	G	13	0	13	0	21	34	0	0
3	32686245	.	T	C	13	21	34	0	0	34	0	0
3	32698458	.	T	C	5	2	7	0	0	7	0	0
3	32698500	.	A	G	21	11	32	0	2	34	0	0
3	32700697	.	A	G	9	17	26	0	1	27	0	0
3	32700758	.	A	G	20	15	35	0	1	37	1	0
3	32700988	.	C	T	20	20	40	0	0	40	0	0
3	32701031	.	T	G	14	1	15	0	30	45	0	0
3	32702596	.	T	A	21	17	38	0	1	39	0	0
3	32707219	.	G	A	5	10	15	0	0	15	0	0
3	32707267	.	T	C	9	12	21	0	1	22	0	0
3	32707272	.	C	A	8	12	20	0	0	20	0	0
3	32707480	.	C	T	9	13	22	0	0	22	0	0
3	32707621	.	C	G	14	14	28	0	0	28	0	0
3	32707813	.	C	G	13	15	28	0	1	29	0	0
3	32708077	.	T	C	27	24	51	0	1	52	0	0
3	32710705	.	A	G	20	24	44	0	4	48	0	0
3	32710812	.	G	A	3	28	31	1	16	48	0	0
3	32710999	.	C	A	8	8	16	1	0	17	0	0
3	32715514	.	C	T	0	4	4	0	1	5	0	0
3	32715571	.	G	A	2	7	9	0	0	9	0	0
3	32717529	.	C	T	2	2	4	1	1	6	0	0
3	32718451	.	T	G	3	2	5	0	0	5	0	0
3	32718460	.	C	T	3	2	5	0	0	5	0	0
3	32718605	.	A	G	2	4	6	0	0	6	0	0
3	32718851	.	T	C	5	5	10	0	0	10	0	0
3	32718945	.	C	G	6	8	14	0	0	14	0	0
3	32719715	.	T	C	14	11	25	0	1	26	0	0
3	32720184	.	A	C	9	5	14	0	0	14	0	0
3	32720342	.	T	C	7	6	13	0	0	13	0	0
3	32722973	.	C	T	5	11	16	0	0	16	0	0
3	32723033	.	A	G	10	0	10	0	10	20	0	0
3	32723119	.	A	G	2	0	2	0	7	9	0	0
3	32723497	.	A	G	10	1	11	0	11	22	0	0
3	32723698	.	C	T	8	6	14	0	0	14	0	0
3	32724010	.	G	A	0	5	5	0	7	12	0	0
3	32724100	.	G	A	3	7	10	0	1	11	0	0
3	32726271	.	A	G	3	8	11	0	0	11	0	0
3	32726357	.	A	G	2	7	9	0	0	9	0	0
3	32728304	.	T	C	8	9	17	0	0	17	0	0
3	32729150	.	T	C	13	10	23	0	1	24	0	0
3	32729232	.	T	C	8	9	17	0	3	20	0	0
3	32729429	.	T	A	9	2	11	0	2	13	0	0
3	32729591	.	C	T	14	9	23	0	0	23	0	0
3	32729663	.	C	T	3	8	11	0	1	12	0	0
3	32729759	.	C	A	7	10	17	0	0	17	0	0
3	32729827	.	A	T	7	7	14	0	1	15	0	0
3	32729845	.	G	A	8	7	15	0	1	16	0	0
3	32730011	.	A	G	6	1	7	0	9	16	0	0
3	32730071	.	T	A	3	9	12	0	3	15	0	0
3	32730131	.	A	G	6	8	14	0	3	17	0	0
3	32731255	.	A	G	12	0	12	0	10	22	0	0
3	32731418	.	C	T	8	10	18	0	1	20	1	0
3	32731750	.	A	G	5	1	6	0	8	14	0	0
3	32731804	.	T	C	8	9	17	0	0	17	0	0
3	32731840	.	T	C	7	7	14	0	0	14	0	0
3	32731855	.	T	C	5	4	9	0	0	9	0	0
3	32731879	.	A	G	7	0	7	0	5	12	0	0
3	32734926	.	G	A	1	4	5	0	10	15	0	0
3	32737727	.	C	T	10	6	16	0	0	17	1	0
3	32741137	.	G	A	2	7	9	0	12	21	0	0
3	32741385	.	G	A	3	9	12	3	11	26	0	0
3	32741809	.	A	G	14	0	14	0	8	22	0	0
3	32742293	.	A	G	5	3	8	0	0	8	0	0
3	32777481	.	A	C	10	16	26	0	1	27	0	0
3	32777733	.	G	T	7	8	15	0	1	16	0	0
3	32789654	.	G	T	6	6	12	0	10	22	0	0
3	32789985	.	T	C	15	13	28	0	0	28	0	0
3	32794931	.	C	A	7	10	17	0	0	17	0	0
3	32795068	.	C	T	15	15	30	0	0	30	0	0
3	32795425	.	G	A	10	12	22	0	0	22	0	0
3	32795461	.	A	T	10	15	25	0	0	25	0	0
3	32795614	.	C	T	13	11	24	0	1	25	0	0
3	32807667	.	G	A	6	17	23	0	1	24	0	0
3	32808023	.	T	A	10	18	28	0	1	29	0	0
3	32808185	.	T	C	10	16	26	0	1	27	0	0
3	32808214	.	G	A	12	19	31	0	6	37	0	0
3	32808338	.	A	C	13	25	38	0	3	42	1	0
3	32808554	.	T	G	15	15	30	0	2	32	0	0
3	32808771	.	G	A	14	13	27	0	1	28	0	0
3	32808772	.	G	C	13	12	25	0	3	28	0	0
3	32808979	.	T	G	10	14	24	0	0	24	0	0
3	32809154	.	A	T	14	8	22	0	1	23	0	0
3	32809368	.	G	A	9	19	28	0	3	31	0	0
3	32809410	.	G	A	12	14	26	0	1	27	0	0
3	32809432	.	T	A	13	11	24	0	1	25	0	0
3	32809548	.	T	C	9	11	20	0	1	21	0	0
3	32809561	.	G	A	12	14	26	0	0	26	0	0
3	32809836	.	A	G	11	0	11	0	10	21	0	0
3	32809927	.	T	C	11	9	20	0	0	20	0	0
3	32810011	.	T	A	11	8	19	0	2	21	0	0
3	32810580	.	C	T	17	13	30	0	2	32	0	0
3	32810715	.	A	G	9	22	31	0	1	32	0	0
3	32811094	.	A	T	5	3	8	0	0	8	0	0
3	32831417	.	T	C	2	4	6	0	0	6	0	0
3	32831814	.	C	T	3	4	7	0	0	7	0	0
3	32837514	.	G	A	19	17	36	0	3	39	0	0
3	32837643	.	G	A	19	14	33	0	10	43	0	0
3	32837904	.	A	G	28	0	28	0	18	46	0	0
3	32838033	.	G	A	1	12	13	0	18	31	0	0
3	32838039	.	A	G	18	14	32	0	0	32	0	0
3	32842163	.	C	T	11	8	19	1	0	20	0	0
3	32842235	.	G	T	6	13	19	0	0	19	0	0
3	32847607	.	C	T	3	6	9	0	0	9	0	0
3	32847771	.	G	A	0	12	12	0	4	16	0	0
3	32847839	.	C	A	7	3	10	0	0	10	0	0
3	32847887	.	C	G	7	5	12	0	0	12	0	0
3	32847923	.	C	A	8	4	12	0	0	12	0	0
3	32847942	.	A	G	8	0	8	0	7	15	0	0
3	32848175	.	T	G	5	8	13	0	0	13	0	0
3	32848418	.	C	T	11	11	22	0	0	22	0	0
3	32848714	.	A	G	10	11	21	0	0	21	0	0
3	32849079	.	C	T	12	6	18	0	1	19	0	0
3	32849679	.	T	A	16	11	27	0	0	27	0	0
3	32850029	.	A	T	16	6	22	0	1	23	0	0
3	32850265	.	A	G	6	0	6	0	9	15	0	0
3	32850499	.	T	C	13	7	20	0	1	21	0	0
3	32854276	.	T	C	5	8	13	0	1	14	0	0
3	32854533	.	T	C	11	7	18	1	0	19	0	0
3	32854743	.	C	G	7	0	7	0	7	14	0	0
3	32854744	.	A	G	8	5	13	0	1	14	0	0
3	32855066	.	G	A	9	6	15	0	0	15	0	0
3	32855416	.	A	G	2	0	2	0	2	4	0	0
3	32855425	.	T	A	2	2	4	0	0	4	0	0
3	32863016	.	A	G	6	8	14	0	1	15	0	0
3	32863128	.	C	A	4	3	7	0	0	7	0	0
3	32865030	.	T	A	2	2	4	0	0	5	1	0
3	32866068	.	A	T	1	6	7	0	0	7	0	0
3	32866135	.	C	T	3	2	5	0	0	5	0	0
3	32867711	.	C	A	2	4	6	0	1	7	0	0
3	32867865	.	A	G	1	2	3	0	1	4	0	0
3	32868114	.	G	T	2	3	5	0	0	5	0	0
3	32868143	.	C	T	2	4	6	0	0	6	0	0
3	32868519	.	G	T	4	3	7	1	1	9	0	0
3	32869770	.	C	T	2	2	4	0	2	6	0	0
3	32869773	.	G	A	4	2	6	0	0	6	0	0
3	32869913	.	C	T	1	4	5	0	1	6	0	0
3	32869930	.	C	T	2	4	6	0	0	6	0	0
3	32870756	.	A	G	2	1	3	0	4	7	0	0
3	32870766	.	G	A	2	5	7	0	0	7	0	0
3	32870947	.	A	G	7	7	14	0	0	14	0	0
3	32871247	.	A	G	1	2	3	0	1	4	0	0
3	32871350	.	T	C	4	3	7	0	4	11	0	0
3	32871413	.	G	A	1	4	5	0	0	5	0	0
3	32871414	.	A	C	1	2	3	0	2	5	0	0
3	32889849	.	T	C	7	1	8	0	12	20	0	0
3	32890002	.	G	T	17	14	31	0	2	33	0	0
3	32890058	.	A	G	14	17	31	0	3	34	0	0
3	32892061	.	G	A	10	17	27	0	0	27	0	0
3	32892422	.	A	G	10	14	24	0	1	25	0	0
3	32900428	.	A	G	13	18	31	0	2	33	0	0
3	32924386	.	G	A	3	2	5	0	0	5	0	0
3	32924643	.	G	A	3	5	8	0	2	10	0	0
3	32924836	.	T	A	9	16	25	0	1	26	0	0
3	32924989	.	G	A	9	13	22	0	0	22	0	0
3	32925066	.	G	A	5	10	15	0	0	15	0	0
3	32925248	.	C	T	12	12	24	0	0	24	0	0
3	32925264	.	G	T	11	11	22	0	0	22	0	0
3	32925400	.	C	T	4	5	9	0	0	9	0	0
3	32926016	.	C	T	0	10	10	0	8	18	0	0
3	32926025	.	G	A	6	9	15	0	0	15	0	0
3	32926058	.	A	G	5	10	15	0	0	15	0	0
3	32926148	.	G	A	4	6	10	0	0	10	0	0
3	32926184	.	A	T	3	5	8	0	0	8	0	0
3	32926934	.	A	G	2	2	4	0	0	4	0	0
3	32927336	.	A	G	1	2	3	0	0	3	0	0
3	32933774	.	A	C	6	12	18	0	1	19	0	0
3	32933849	.	A	T	6	15	21	0	0	21	0	0
3	32935936	.	A	G	10	0	10	0	15	25	0	0
3	32937628	.	A	G	11	18	29	0	1	30	0	0
3	32941242	.	G	A	12	14	26	1	1	28	0	0
3	32941661	.	A	G	13	16	29	0	2	31	0	0
3	32944203	.	C	A	20	19	39	0	1	40	0	0
3	32944569	.	C	T	19	20	39	0	0	39	0	0
3	32944668	.	C	A	18	21	39	0	2	41	0	0
3	32944854	.	C	T	20	22	42	0	1	43	0	0
3	32947971	.	T	C	13	29	42	0	0	42	0	0
3	32950959	.	G	A	13	16	29	0	1	30	0	0
3	32950977	.	G	A	3	14	17	0	12	29	0	0
3	32951001	.	G	T	3	18	21	0	12	33	0	0
3	32951394	.	G	A	22	27	49	0	0	49	0	0
3	32951564	.	A	C	9	8	17	0	0	17	0	0
3	32951637	.	G	A	11	4	15	0	2	17	0	0
3	32951778	.	C	T	12	15	27	0	2	29	0	0
3	32951891	.	T	C	12	13	25	0	0	25	0	0
3	33047597	.	G	T	2	2	4	5	0	9	0	0
3	33065643	.	T	A	6	2	8	6	0	14	0	0
3	33065950	.	T	C	8	8	16	2	0	18	0	0
3	33065985	.	A	G	7	6	13	3	0	16	0	0
3	33066155	.	C	T	1	8	9	0	10	19	0	0
3	33066241	.	C	T	0	4	4	2	9	15	0	0
3	33066292	.	C	T	13	6	19	0	0	19	0	0
3	33066629	.	C	T	0	5	5	0	4	9	0	0
3	33066714	.	A	T	7	5	12	0	0	12	0	0
3	33066804	.	T	C	4	0	4	0	10	14	0	0
3	33066809	.	C	G	6	8	14	0	0	14	0	0
3	33066969	.	T	C	8	1	9	0	8	17	0	0
3	33066976	.	T	C	7	8	15	0	1	16	0	0
3	33067092	.	A	T	3	2	5	0	0	5	0	0
3	33067337	.	A	G	2	6	8	0	0	8	0	0
3	33067340	.	A	G	3	6	9	0	1	10	0	0
3	33067376	.	G	A	6	6	12	0	1	13	0	0
3	33067438	.	G	A	10	4	14	0	0	14	0	0
3	33069274	.	A	C	7	6	13	0	0	13	0	0
3	33069596	.	G	A	12	7	19	0	2	21	0	0
3	33075167	.	C	T	3	8	11	0	0	11	0	0
3	33259382	.	A	T	3	4	7	0	0	7	0	0
3	33259407	.	G	A	2	4	6	0	1	7	0	0
3	33341072	.	T	A	15	27	42	0	1	43	0	0
3	33344470	.	T	A	24	10	34	0	1	35	0	0
3	33344636	.	A	T	5	3	8	0	0	8	0	0
3	33345445	.	T	A	6	2	8	0	1	9	0	0
3	33345482	.	G	A	0	8	8	0	17	25	0	0
3	33360480	.	A	G	17	0	17	0	14	31	0	0
3	33368134	.	T	C	9	12	21	0	3	24	0	0
3	33372555	.	G	C	1	11	12	1	9	22	0	0
3	33373443	.	T	C	10	13	23	0	2	25	0	0
3	33373540	.	A	C	8	9	17	0	0	17	0	0
3	33375645	.	C	A	13	8	21	0	2	23	0	0
3	33379072	.	C	T	6	6	12	0	0	12	0	0
3	33396846	.	C	T	0	3	3	0	1	4	0	0
3	33396861	.	A	G	1	2	3	0	0	3	0	0
3	33424010	.	C	T	5	3	8	0	6	14	0	0
3	33424420	.	G	A	27	22	49	0	7	56	0	0
3	33426513	.	G	A	35	30	65	0	2	67	0	0
3	33433621	.	G	A	4	7	11	0	0	11	0	0
3	33437399	.	T	C	6	5	11	0	1	12	0	0
3	33440693	.	C	T	10	8	18	0	1	19	0	0
3	33445039	.	A	T	11	8	19	0	0	19	0	0
3	33445090	.	G	C	0	11	11	0	12	23	0	0
3	33449405	.	C	T	19	21	40	0	1	41	0	0
3	33449554	.	G	A	1	9	10	0	9	19	0	0
3	33452168	.	C	T	24	22	46	0	0	46	0	0
3	33455809	.	G	A	1	22	23	0	14	37	0	0
3	33458803	.	C	T	20	20	40	0	4	44	0	0
3	33458911	.	A	T	16	12	28	0	1	29	0	0
3	33459394	.	T	A	9	4	13	0	1	14	0	0
3	33459489	.	C	T	9	3	12	0	0	12	0	0
3	33459517	.	C	T	7	6	13	0	0	13	0	0
3	33459532	.	G	A	7	5	12	0	0	12	0	0
3	33461366	.	C	T	3	7	10	0	11	21	0	0
3	33461646	.	C	T	3	10	13	0	9	22	0	0
3	33461796	.	A	T	7	15	22	0	0	22	0	0
3	33469413	.	A	G	18	13	31	0	1	32	0	0
3	33469614	.	T	A	12	20	32	0	1	33	0	0
3	33473131	.	C	T	2	15	17	0	14	31	0	0
3	33476589	.	T	C	12	14	26	0	0	26	0	0
3	33478690	.	G	A	9	10	19	1	2	22	0	0
3	33494089	.	A	T	15	17	32	0	1	33	0	0
3	33494091	.	G	C	14	18	32	0	0	32	0	0
3	33570763	.	G	A	5	2	7	0	1	8	0	0
3	33571002	.	C	T	5	3	8	0	1	9	0	0
3	33571231	.	C	T	5	5	10	0	2	12	0	0
3	33571264	.	T	C	4	0	4	0	4	8	0	0
3	33571294	.	C	T	9	5	14	0	0	14	0	0
3	33571840	.	G	C	5	0	5	0	5	10	0	0
3	33572095	.	G	A	12	4	16	0	0	16	0	0
3	33572206	.	G	C	10	0	10	0	9	19	0	0
3	33572298	.	G	A	4	5	9	0	0	9	0	0
3	33572335	.	C	T	6	4	10	0	0	10	0	0
3	33572404	.	C	T	0	4	4	0	4	8	0	0
3	33572464	.	T	C	9	0	9	0	7	16	0	0
3	33572473	.	A	G	10	8	18	0	0	18	0	0
3	33572512	.	C	A	8	3	11	0	2	13	0	0
3	33572553	.	T	G	5	5	10	0	0	10	0	0
3	33572617	.	A	T	3	3	6	0	0	6	0	0
3	33573178	.	G	A	3	2	5	0	0	5	0	0
3	33747527	.	A	G	15	16	31	0	0	31	0	0
3	33747563	.	A	G	15	1	16	0	11	27	0	0
3	33761597	.	C	T	13	6	19	0	2	21	0	0
3	33761705	.	G	A	4	20	24	0	21	45	0	0
3	33761834	.	G	A	22	16	38	0	0	38	0	0
3	33761835	.	A	T	19	16	35	0	3	38	0	0
3	33762068	.	A	G	12	13	25	0	0	25	0	0
3	33762278	.	A	G	16	17	33	0	0	33	0	0
3	33762310	.	C	A	14	14	28	0	2	30	0	0
3	33762408	.	T	A	12	16	28	0	0	28	0	0
3	33762480	.	C	T	13	10	23	0	1	24	0	0
3	33773294	.	A	G	23	17	40	0	3	43	0	0
3	33777317	.	T	G	17	26	43	0	5	48	0	0
3	33777425	.	A	G	17	23	40	1	1	42	0	0
3	33777807	.	A	G	25	18	43	2	2	47	0	0
3	33820291	.	T	C	4	14	18	0	0	18	0	0
3	33820297	.	T	C	14	7	21	0	0	21	0	0
3	33820568	.	C	T	10	14	24	0	1	25	0	0
3	33820580	.	A	G	11	14	25	0	2	27	0	0
3	33821929	.	C	T	6	7	13	0	2	15	0	0
3	33834678	.	T	C	9	4	13	0	1	14	0	0
3	33840740	.	T	C	5	2	7	0	2	9	0	0
3	33842844	.	A	G	8	9	17	0	1	18	0	0
3	33844761	.	T	C	11	0	11	0	14	25	0	0
3	33847104	.	A	G	4	7	11	0	0	11	0	0
3	33847131	.	C	T	2	3	5	0	0	5	0	0
3	33847191	.	T	C	4	9	13	0	1	14	0	0
3	33854879	.	T	C	8	9	17	0	1	18	0	0
3	33854927	.	G	A	8	9	17	0	0	17	0	0
3	33854972	.	A	G	12	8	20	0	0	20	0	0
3	33918537	.	T	A	3	2	5	0	0	5	0	0
3	33918611	.	A	G	8	5	13	0	0	13	0	0
3	33918675	.	T	G	6	11	17	0	1	18	0	0
3	33918775	.	A	G	6	6	12	0	1	13	0	0
3	33921663	.	A	C	5	13	18	0	1	19	0	0
3	33922233	.	T	A	5	2	7	0	0	7	0	0
3	33922245	.	T	C	6	2	8	0	0	8	0	0
3	33922269	.	A	G	4	2	6	0	0	6	0	0
3	33922359	.	G	A	2	18	20	0	1	21	0	0
3	33922413	.	T	A	7	7	14	0	1	15	0	0
3	33922415	.	G	A	8	7	15	0	0	15	0	0
3	33922471	.	T	C	8	3	11	0	1	12	0	0
3	33932170	.	C	T	2	6	8	0	7	15	0	0
3	33932430	.	T	A	5	10	15	0	0	15	0	0
3	33932628	.	G	A	5	4	9	0	1	10	0	0
3	33934848	.	T	C	6	4	10	0	0	10	0	0
3	33934849	.	G	C	5	4	9	0	1	10	0	0
3	33936783	.	G	C	4	7	11	0	0	11	0	0
3	33948734	.	T	C	1	2	3	0	0	3	0	0
3	33948783	.	G	A	0	1	1	0	0	1	0	0
3	34129941	.	C	T	0	16	16	0	12	28	0	0
3	34135868	.	C	T	3	7	10	0	0	10	0	0
3	34144353	.	A	T	8	4	12	0	0	12	0	0
3	34144807	.	C	G	5	3	8	0	0	8	0	0
3	34144808	.	G	A	0	3	3	0	5	8	0	0
3	34145131	.	T	G	2	4	6	0	0	6	0	0
3	34146338	.	C	T	5	3	8	0	0	8	0	0
3	34146882	.	G	T	3	7	10	0	0	10	0	0
3	34146955	.	A	G	3	4	7	0	0	7	0	0
3	34166288	.	C	A	15	18	33	1	1	35	0	0
3	34170913	.	G	A	11	19	30	0	0	30	0	0
3	34180096	.	G	T	6	13	19	0	0	19	0	0
3	34180332	.	A	G	7	3	10	0	0	10	0	0
3	34180386	.	G	A	12	5	17	0	0	17	0	0
3	34182164	.	C	T	6	9	15	0	0	15	0	0
3	34182306	.	G	C	7	4	11	0	1	12	0	0
3	34182376	.	A	C	8	8	16	0	0	16	0	0
3	34182386	.	G	A	0	8	8	0	7	15	0	0
3	34220359	.	A	T	3	13	16	0	1	17	0	0
3	34244901	.	G	C	9	8	17	0	0	17	0	0
3	34258965	.	G	A	8	15	23	0	1	24	0	0
3	34259013	.	C	G	12	15	27	0	0	27	0	0
3	34259060	.	C	T	25	13	38	0	0	38	0	0
3	34259868	.	A	G	11	5	16	0	11	27	0	0
3	34260325	.	T	C	6	14	20	0	1	21	0	0
3	34260808	.	T	C	10	14	24	0	0	24	0	0
3	34261204	.	T	C	6	6	12	0	2	14	0	0
3	34261354	.	A	G	18	19	37	0	0	37	0	0
3	34261795	.	G	A	12	13	25	0	0	25	0	0
3	34262290	.	C	T	13	10	23	0	0	23	0	0
3	34262421	.	C	A	10	20	30	0	0	30	0	0
3	34262639	.	G	A	17	17	34	0	0	34	0	0
3	34262823	.	A	T	16	15	31	0	0	31	0	0
3	34263007	.	C	T	1	7	8	0	17	27	2	0
3	34263101	.	T	A	16	5	21	0	1	22	0	0
3	34264140	.	A	T	10	8	18	0	0	18	0	0
3	34264634	.	T	A	8	10	18	0	6	24	0	0
3	34264657	.	A	T	17	9	26	0	1	27	0	0
3	34270546	.	A	G	15	10	25	0	0	25	0	0
3	34323584	.	C	T	6	3	9	0	0	9	0	0
3	34327103	.	G	A	4	5	9	0	1	10	0	0
3	34337582	.	A	G	1	4	5	0	1	6	0	0
3	34337695	.	C	T	4	2	6	0	1	7	0	0
3	34337734	.	A	T	2	2	4	0	0	4	0	0
3	34337828	.	T	A	2	3	5	0	0	5	0	0
3	34456131	.	G	T	2	2	4	0	0	4	0	0
3	34456175	.	C	A	0	3	3	0	2	5	0	0
3	34456538	.	A	G	5	4	9	0	0	9	0	0
3	34588493	.	A	G	2	3	5	0	0	5	0	0
3	34588788	.	G	A	5	3	8	0	0	8	0	0
3	34589350	.	C	T	1	2	3	0	0	3	0	0
3	34590350	.	A	C	3	4	7	0	0	7	0	0
3	34599655	.	T	G	3	2	5	0	1	6	0	0
3	34604202	.	A	G	3	4	7	0	1	8	0	0
3	34697461	.	G	A	5	9	14	0	1	15	0	0
3	34697514	.	T	C	8	0	8	0	12	20	0	0
3	34703722	.	T	G	3	4	7	0	0	7	0	0
3	34703731	.	G	C	3	5	8	0	0	8	0	0
3	34706676	.	G	A	3	8	11	0	0	11	0	0
3	34724968	.	A	C	3	5	8	0	0	8	0	0
3	34767112	.	G	T	24	18	42	0	8	50	0	0
3	34767662	.	T	G	32	33	65	0	2	67	0	0
3	34767669	.	G	A	28	33	61	0	1	63	1	0
3	34772941	.	T	G	43	27	70	0	4	74	0	0
3	34775942	.	G	A	39	31	70	0	4	74	0	0
3	34776115	.	T	G	27	21	48	0	9	57	0	0
3	34776133	.	G	C	34	25	59	0	2	61	0	0
3	34776151	.	C	A	27	34	61	0	3	64	0	0
3	34781074	.	A	G	32	35	67	0	2	69	0	0
3	34781095	.	C	T	29	38	67	0	4	71	0	0
3	34781448	.	T	C	18	27	45	0	3	48	0	0
3	34781586	.	T	C	23	3	26	0	27	53	0	0
3	34783970	.	G	A	26	34	60	0	1	61	0	0
3	34783982	.	A	G	21	29	50	0	3	53	0	0
3	34801034	.	T	C	4	15	19	0	0	19	0	0
3	34804427	.	A	G	16	7	23	0	2	25	0	0
3	34811099	.	T	C	8	7	15	0	1	16	0	0
3	34814839	.	A	G	9	8	17	0	1	18	0	0
3	34822049	.	C	T	25	11	36	0	1	37	0	0
3	34822169	.	C	T	26	8	34	0	1	35	0	0
3	34822214	.	T	C	22	10	32	0	0	32	0	0
3	34889384	.	T	C	1	2	3	0	0	3	0	0
3	34911747	.	T	C	1	3	4	0	0	4	0	0
3	34919853	.	A	G	7	0	7	0	5	12	0	0
3	34919892	.	C	T	9	14	23	0	1	24	0	0
3	34977497	.	A	G	9	1	10	1	9	20	0	0
3	34977508	.	A	G	9	0	9	1	9	19	0	0
3	34981394	.	T	C	3	3	6	0	0	6	0	0
3	34994140	.	C	T	39	23	62	1	3	66	0	0
3	34994750	.	A	G	19	9	28	0	2	30	0	0
3	35170112	.	T	C	26	14	40	2	1	43	0	0
3	35225160	.	A	G	27	0	27	0	24	51	0	0
3	35225202	.	C	T	25	27	52	0	2	54	0	0
3	35248470	.	T	C	9	13	22	0	1	23	0	0
3	35248492	.	T	A	11	11	22	0	1	23	0	0
3	35249369	.	T	C	24	12	36	0	1	37	0	0
3	35249535	.	T	C	18	18	36	0	1	37	0	0
3	35250145	.	A	T	24	17	41	0	0	42	1	0
3	35250188	.	A	G	9	18	27	0	3	30	0	0
3	35264406	.	T	G	29	21	50	0	2	52	0	0
3	35264460	.	C	T	34	13	47	1	4	52	0	0
3	35264744	.	T	A	14	16	30	0	3	33	0	0
3	35264951	.	G	A	13	19	32	1	1	34	0	0
3	35265350	.	T	C	10	18	28	4	1	33	0	0
3	35265419	.	T	G	24	14	38	0	0	38	0	0
3	35265654	.	G	A	4	32	36	0	22	58	0	0
3	35266006	.	G	A	2	4	6	0	0	6	0	0
3	35298531	.	G	T	14	10	24	0	0	24	0	0
3	35298725	.	T	A	8	13	21	0	0	21	0	0
3	35374514	.	C	T	1	2	3	0	0	3	0	0
3	35374719	.	C	T	12	10	22	0	1	23	0	0
3	35375112	.	G	A	17	11	28	0	1	29	0	0
3	35375162	.	T	A	21	13	34	0	0	34	0	0
3	35375279	.	A	T	10	13	23	0	0	23	0	0
3	35375306	.	T	C	12	11	23	0	1	24	0	0
3	35375448	.	T	G	20	0	20	0	12	32	0	0
3	35375638	.	T	A	13	8	21	0	1	22	0	0
3	35406475	.	G	A	6	3	9	0	3	12	0	0
3	35406648	.	G	T	1	5	6	0	6	12	0	0
3	35418047	.	A	G	8	10	18	0	0	18	0	0
3	35419683	.	A	T	13	14	27	0	0	27	0	0
3	35420588	.	A	G	8	8	16	0	0	16	0	0
3	35420604	.	C	T	7	9	16	0	0	16	0	0
3	35513674	.	A	G	8	8	16	1	0	17	0	0
3	35514786	.	C	T	11	15	26	0	0	26	0	0
3	35514849	.	C	A	17	8	25	0	2	27	0	0
3	35515053	.	G	T	9	11	20	0	2	22	0	0
3	35515074	.	C	T	8	9	17	0	0	17	0	0
3	35515103	.	G	A	4	7	11	0	1	12	0	0
3	35515179	.	T	C	6	17	23	0	1	24	0	0
3	35515206	.	G	A	5	12	17	0	3	20	0	0
3	35515304	.	T	G	9	8	17	0	1	18	0	0
3	35515866	.	A	T	8	9	17	0	0	17	0	0
3	35517999	.	A	C	9	10	19	0	1	20	0	0
3	35518036	.	C	G	8	8	16	0	1	17	0	0
3	35518464	.	A	C	13	15	28	0	0	28	0	0
3	35518962	.	C	A	12	13	25	0	0	25	0	0
3	35523824	.	C	G	16	17	33	0	1	34	0	0
3	35527024	.	T	C	14	7	21	0	0	21	0	0
3	35529040	.	T	C	15	15	30	0	0	30	0	0
3	35530787	.	C	T	7	6	13	0	2	15	0	0
3	35531018	.	T	C	13	6	19	0	3	22	0	0
3	35531328	.	G	A	0	16	16	0	10	26	0	0
3	35531329	.	A	T	10	16	26	0	0	26	0	0
3	35531671	.	A	T	18	12	30	0	2	32	0	0
3	35531791	.	A	G	12	1	13	0	16	29	0	0
3	35531866	.	T	A	16	17	33	0	3	36	0	0
3	35531985	.	G	A	24	15	39	1	2	42	0	0
3	35532074	.	A	T	9	14	23	0	1	24	0	0
3	35532452	.	A	T	15	18	33	0	1	34	0	0
3	35532634	.	A	G	9	0	9	0	19	28	0	0
3	35532665	.	C	T	13	13	26	0	2	28	0	0
3	35532736	.	A	C	15	7	22	0	1	23	0	0
3	35536115	.	C	G	13	14	27	0	1	28	0	0
3	35536269	.	G	A	13	8	21	0	1	22	0	0
3	35541273	.	A	G	28	28	56	0	1	57	0	0
3	35548780	.	T	C	5	1	6	0	3	9	0	0
3	35548822	.	C	A	4	2	6	0	1	7	0	0
3	35548903	.	G	A	3	3	6	0	1	7	0	0
3	35551047	.	A	T	14	13	27	0	2	29	0	0
3	35551190	.	C	T	1	9	10	0	8	18	0	0
3	35589548	.	C	T	24	21	45	0	0	45	0	0
3	35589908	.	A	G	29	22	51	0	0	51	0	0
3	35590270	.	T	C	32	2	34	0	24	58	0	0
3	35602007	.	A	C	21	1	22	0	31	53	0	0
3	35602047	.	A	G	17	29	46	0	1	47	0	0
3	35602153	.	A	G	20	18	38	0	0	38	0	0
3	35602154	.	T	A	20	18	38	0	0	38	0	0
3	35608511	.	C	T	2	3	5	0	0	5	0	0
3	35617940	.	A	C	4	6	10	0	0	10	0	0
3	35617943	.	A	C	4	5	9	0	1	10	0	0
3	35621473	.	G	A	2	9	11	0	10	21	0	0
3	35621515	.	T	G	7	0	7	0	5	12	0	0
3	35623614	.	A	G	8	3	11	0	0	11	0	0
3	35634953	.	A	G	5	5	10	0	0	10	0	0
3	35635039	.	C	T	9	7	16	0	0	16	0	0
3	35635152	.	A	G	7	2	9	0	4	13	0	0
3	35636072	.	C	T	3	1	4	0	0	4	0	0
3	35636095	.	A	G	1	4	5	0	0	5	0	0
3	35636183	.	A	G	5	3	8	0	0	8	0	0
3	35636388	.	A	G	4	3	7	0	1	8	0	0
3	35636410	.	A	G	6	6	12	0	0	12	0	0
3	35636476	.	A	G	4	2	6	0	0	6	0	0
3	35638008	.	T	A	13	6	19	0	0	19	0	0
3	35638119	.	A	C	18	10	28	0	0	28	0	0
3	35638201	.	A	G	17	11	28	0	1	29	0	0
3	35638240	.	C	T	13	10	23	0	0	23	0	0
3	35638450	.	T	A	10	6	16	0	0	16	0	0
3	35638513	.	G	A	14	7	21	0	0	21	0	0
3	35638908	.	C	T	5	17	22	0	17	39	0	0
3	35638986	.	C	A	16	21	37	0	0	37	0	0
3	35639020	.	A	G	15	16	31	0	1	32	0	0
3	35639021	.	G	A	16	15	31	0	0	32	1	0
3	35639194	.	T	C	19	19	38	0	2	40	0	0
3	35639621	.	A	C	18	9	27	0	2	29	0	0
3	35639817	.	T	A	7	7	14	0	2	16	0	0
3	35639862	.	G	T	12	11	23	0	0	23	0	0
3	35639884	.	T	C	12	0	12	0	10	22	0	0
3	35639958	.	T	C	9	4	13	0	0	13	0	0
3	35640042	.	A	G	12	9	21	0	1	22	0	0
3	35640122	.	G	T	7	18	25	1	0	26	0	0
3	35640441	.	C	A	15	5	20	0	0	20	0	0
3	35640554	.	G	A	12	4	16	0	0	16	0	0
3	35640588	.	A	G	8	10	18	0	0	18	0	0
3	35640625	.	C	T	11	14	25	0	3	28	0	0
3	35640784	.	T	C	20	17	37	0	0	37	0	0
3	35641173	.	C	T	11	9	20	0	1	21	0	0
3	35641371	.	C	T	2	15	17	0	19	36	0	0
3	35641382	.	G	A	19	17	36	0	1	37	0	0
3	35641595	.	A	T	19	17	36	0	0	36	0	0
3	35641785	.	C	T	0	9	9	0	10	19	0	0
3	35642012	.	A	T	14	11	25	0	1	27	1	0
3	35642072	.	A	G	10	15	25	0	0	25	0	0
3	35642242	.	T	C	8	0	8	0	11	19	0	0
3	35642462	.	T	C	9	1	10	0	11	21	0	0
3	35643320	.	G	A	10	6	16	0	2	18	0	0
3	35643357	.	G	A	4	4	8	0	1	9	0	0
3	35643359	.	G	A	4	2	6	0	2	8	0	0
3	35643540	.	G	A	18	19	37	0	1	38	0	0
3	35643546	.	A	T	16	17	33	0	3	36	0	0
3	35645380	.	T	C	21	2	23	0	13	36	0	0
3	35645411	.	G	A	23	15	38	0	0	38	0	0
3	35645661	.	T	G	14	19	33	0	1	34	0	0
3	35646025	.	G	T	16	13	29	0	1	30	0	0
3	35646160	.	G	T	8	12	20	0	1	21	0	0
3	35646611	.	T	G	9	9	18	0	0	18	0	0
3	35647181	.	A	G	20	13	33	0	0	33	0	0
3	35647321	.	G	A	10	14	24	0	0	24	0	0
3	35647882	.	G	A	6	4	10	0	1	11	0	0
3	35647975	.	A	G	11	8	19	0	0	19	0	0
3	35652750	.	G	A	8	6	14	0	0	14	0	0
3	35652765	.	G	A	7	7	14	0	0	14	0	0
3	35800614	.	C	G	4	6	10	0	4	14	0	0
3	35800738	.	T	C	7	5	12	0	1	13	0	0
3	35800758	.	T	G	8	3	11	0	3	14	0	0
3	35831029	.	T	C	3	5	8	0	0	8	0	0
3	35831095	.	G	T	3	4	7	0	0	7	0	0
3	35831167	.	T	C	3	5	8	0	0	8	0	0
3	35837532	.	C	T	5	4	9	0	0	9	0	0
3	35840264	.	A	G	5	0	5	0	5	10	0	0
3	35840267	.	T	A	6	5	11	0	0	11	0	0
3	35845735	.	A	G	3	6	9	0	0	9	0	0
3	35845774	.	T	C	2	5	7	0	0	7	0	0
3	35845805	.	A	G	1	5	6	0	0	6	0	0
3	35846120	.	C	G	4	5	9	0	1	10	0	0
3	35846343	.	C	G	8	5	13	1	0	14	0	0
3	35846410	.	A	T	5	6	11	0	0	11	0	0
3	35846440	.	G	A	4	6	10	0	0	10	0	0
3	35846823	.	A	G	4	4	8	0	1	9	0	0
3	35850380	.	C	T	5	2	7	1	0	8	0	0
3	35862555	.	A	C	1	4	5	0	0	5	0	0
3	35862955	.	G	A	1	2	3	0	0	3	0	0
3	35864419	.	G	A	2	3	5	0	0	5	0	0
3	35864914	.	C	T	2	2	4	1	0	5	0	0
3	36023342	.	T	G	23	25	48	0	0	48	0	0
3	36023455	.	A	G	16	20	36	0	0	36	0	0
3	36023465	.	A	G	14	18	32	0	2	34	0	0
3	36026294	.	C	G	3	25	28	0	29	57	0	0
3	36032241	.	G	A	20	24	44	0	0	44	0	0
3	36038631	.	G	A	26	19	45	0	2	47	0	0
3	36040863	.	A	G	20	24	44	0	3	47	0	0
3	36041017	.	A	C	27	25	52	1	3	56	0	0
3	36123546	.	G	A	4	5	9	0	0	9	0	0
3	36125256	.	C	G	0	3	3	0	5	8	0	0
3	36127402	.	A	G	3	0	3	0	4	7	0	0
3	36129027	.	A	T	2	4	6	0	0	6	0	0
3	36129646	.	T	G	2	3	5	0	0	5	0	0
3	36131883	.	T	A	4	4	8	0	0	8	0	0
3	36132099	.	C	T	10	7	17	0	0	17	0	0
3	36132740	.	T	C	8	8	16	0	0	16	0	0
3	36135084	.	A	G	4	5	9	0	0	9	0	0
3	36135867	.	A	C	2	3	5	0	0	5	0	0
3	36136184	.	T	A	2	3	5	0	0	5	0	0
3	36136186	.	A	T	2	3	5	0	0	5	0	0
3	36136609	.	T	C	3	3	6	0	0	6	0	0
3	36143917	.	C	T	0	2	2	0	1	3	0	0
3	36148380	.	C	G	1	4	5	0	0	5	0	0
3	36167286	.	T	C	5	4	9	0	0	9	0	0
3	36173633	.	T	C	15	11	26	1	2	29	0	0
3	36174175	.	C	A	13	15	28	0	0	28	0	0
3	36174248	.	C	G	12	13	25	0	0	25	0	0
3	36174276	.	T	C	12	1	13	0	13	26	0	0
3	36184806	.	A	G	23	9	32	0	1	33	0	0
3	36188400	.	A	G	12	13	25	0	2	27	0	0
3	36210030	.	G	A	16	8	24	0	0	24	0	0
3	36210074	.	C	T	13	8	21	0	1	22	0	0
3	36210307	.	T	A	3	3	6	0	0	6	0	0
3	36224109	.	C	T	3	3	6	0	0	6	0	0
3	36226431	.	A	G	2	2	4	0	0	4	0	0
3	36228235	.	A	G	3	0	3	0	2	5	0	0
3	36228295	.	G	A	3	2	5	0	0	5	0	0
3	36229886	.	A	T	3	5	8	0	1	9	0	0
3	36232218	.	A	G	3	3	6	0	0	6	0	0
3	36232331	.	C	T	5	5	10	0	0	10	0	0
3	36232368	.	A	C	4	3	7	0	0	7	0	0
3	36241839	.	T	C	12	10	22	0	2	24	0	0
3	36241938	.	T	C	16	0	16	0	15	31	0	0
3	36242239	.	C	T	1	13	14	0	11	25	0	0
3	36249172	.	C	T	5	3	8	0	1	9	0	0
3	36249419	.	G	A	20	9	29	0	2	31	0	0
3	36249476	.	T	A	27	13	40	0	1	41	0	0
3	36249516	.	T	A	19	11	30	0	2	32	0	0
3	36249518	.	A	C	17	11	28	0	3	31	0	0
3	36253186	.	G	A	13	14	27	0	0	27	0	0
3	36255436	.	A	G	23	19	42	0	1	43	0	0
3	36259855	.	T	C	17	20	37	0	1	38	0	0
3	36262799	.	A	C	14	0	14	0	19	33	0	0
3	36263099	.	T	C	22	1	23	0	17	40	0	0
3	36263151	.	A	G	21	20	41	0	0	41	0	0
3	36263163	.	C	T	18	19	37	0	1	38	0	0
3	36263464	.	C	A	9	20	29	0	2	31	0	0
3	36263557	.	A	G	16	17	33	0	3	36	0	0
3	36263563	.	T	A	15	18	33	0	2	35	0	0
3	36263596	.	T	C	7	0	7	0	15	22	0	0
3	36263666	.	T	C	2	1	3	0	13	16	0	0
3	36263824	.	T	C	23	20	43	0	0	43	0	0
3	36263895	.	A	T	14	23	37	0	1	38	0	0
3	36264028	.	T	C	12	0	12	0	20	32	0	0
3	36264204	.	T	G	14	15	29	0	0	29	0	0
3	36264217	.	A	C	10	13	23	0	4	27	0	0
3	36264248	.	T	C	15	11	26	0	1	27	0	0
3	36264822	.	C	A	5	7	12	0	0	12	0	0
3	36265895	.	C	T	2	16	18	0	24	42	0	0
3	36266137	.	T	A	21	17	38	0	1	39	0	0
3	36266173	.	A	G	18	16	34	0	2	36	0	0
3	36268616	.	A	G	24	9	33	0	0	33	0	0
3	36285177	.	C	A	4	3	7	0	1	8	0	0
3	36291213	.	A	G	18	0	18	0	9	27	0	0
3	36292481	.	G	C	1	10	11	0	12	23	0	0
3	36292657	.	T	C	9	11	20	0	0	20	0	0
3	36293950	.	C	T	16	8	24	0	1	25	0	0
3	36293964	.	C	T	17	7	24	0	2	26	0	0
3	36305854	.	A	G	14	19	33	0	5	38	0	0
3	36305860	.	A	G	19	0	19	0	21	40	0	0
3	36305971	.	T	A	15	9	24	0	1	25	0	0
3	36319778	.	T	A	7	2	9	0	0	9	0	0
3	36322947	.	C	T	6	5	11	0	0	11	0	0
3	36323064	.	C	T	2	2	4	0	1	5	0	0
3	36323397	.	C	A	4	5	9	0	0	9	0	0
3	36323436	.	A	G	4	3	7	0	0	7	0	0
3	36325569	.	T	A	6	4	10	0	0	10	0	0
3	36325599	.	G	C	4	5	9	0	0	9	0	0
3	36325648	.	A	T	5	5	10	0	2	12	0	0
3	36325726	.	C	T	3	3	6	0	0	6	0	0
3	36325802	.	A	G	4	0	4	0	8	12	0	0
3	36326031	.	C	T	3	3	6	0	1	7	0	0
3	36326091	.	A	C	2	3	5	0	1	6	0	0
3	36326108	.	A	T	2	2	4	0	0	4	0	0
3	36326139	.	T	G	4	2	6	0	0	6	0	0
3	36326370	.	A	G	3	4	7	0	1	8	0	0
3	36326482	.	T	A	2	3	5	0	0	5	0	0
3	36326490	.	A	T	3	3	6	0	0	6	0	0
3	36326554	.	G	A	6	2	8	0	0	8	0	0
3	36327060	.	G	A	0	4	4	0	2	6	0	0
3	36327061	.	A	C	2	4	6	0	0	6	0	0
3	36327097	.	C	T	5	3	8	0	0	8	0	0
3	36327129	.	G	A	10	5	15	0	1	16	0	0
3	36327260	.	T	C	5	2	7	0	0	7	0	0
3	36327872	.	G	A	6	3	9	0	2	11	0	0
3	36327906	.	G	T	5	2	7	0	0	7	0	0
3	36327909	.	G	T	0	2	2	0	5	7	0	0
3	36328029	.	T	G	3	3	6	0	0	6	0	0
3	36328083	.	G	T	4	3	7	0	0	7	0	0
3	36328204	.	C	A	6	2	8	0	0	8	0	0
3	36328218	.	G	A	9	2	11	0	1	12	0	0
3	36328339	.	G	A	2	3	5	0	0	5	0	0
3	36349063	.	G	A	3	3	6	0	0	6	0	0
3	36349176	.	T	C	1	2	3	0	0	3	0	0
3	36402930	.	T	C	1	2	3	0	7	10	0	0
3	36407283	.	C	A	7	7	14	0	0	14	0	0
3	36407604	.	A	G	6	6	12	0	0	12	0	0
3	36408402	.	G	T	2	3	5	0	0	5	0	0
3	36409721	.	G	A	4	2	6	0	0	6	0	0
3	36409877	.	C	T	4	7	11	0	0	11	0	0
3	36409969	.	T	C	2	3	5	0	0	5	0	0
3	36409995	.	T	C	2	0	2	0	3	5	0	0
3	36410038	.	T	A	1	2	3	0	0	3	0	0
3	36410157	.	A	G	3	2	5	0	0	5	0	0
3	36410172	.	A	G	2	2	4	0	0	4	0	0
3	36415987	.	A	G	5	4	9	0	0	9	0	0
3	36415999	.	A	C	6	4	10	0	0	10	0	0
3	36416026	.	C	A	3	3	6	0	0	6	0	0
3	36419512	.	C	T	4	3	7	0	0	7	0	0
3	36428612	.	T	A	19	20	39	1	1	41	0	0
3	36428620	.	T	A	19	23	42	1	2	45	0	0
3	36431380	.	T	C	34	21	55	0	0	55	0	0
3	36441465	.	G	A	6	3	9	0	0	9	0	0
3	36441484	.	T	C	8	3	11	0	0	11	0	0
3	36442021	.	T	C	4	5	9	0	1	10	0	0
3	36442029	.	A	G	2	4	6	0	1	7	0	0
3	36442071	.	A	G	5	5	10	0	0	10	0	0
3	36442551	.	C	T	2	21	23	0	14	37	0	0
3	36442661	.	T	G	10	14	24	0	1	25	0	0
3	36442726	.	A	G	19	9	28	0	0	28	0	0
3	36443189	.	G	A	19	15	34	0	1	35	0	0
3	36446613	.	A	G	5	13	18	0	1	19	0	0
3	36683597	.	A	T	4	2	6	0	1	7	0	0
3	37558571	.	C	A	6	3	9	0	0	9	0	0
3	37558591	.	G	A	1	2	3	0	2	5	0	0
3	37559334	.	A	T	26	28	54	0	4	58	0	0
3	37559905	.	A	C	17	27	44	0	0	44	0	0
3	37560271	.	A	G	19	12	31	1	2	34	0	0
3	37564769	.	G	A	25	34	59	0	1	60	0	0
3	37649598	.	G	C	14	6	20	0	0	20	0	0
3	37660307	.	G	A	5	4	9	0	0	9	0	0
3	37664117	.	A	T	6	13	19	0	0	19	0	0
3	37664635	.	A	G	24	9	33	0	0	33	0	0
3	37665855	.	G	A	18	26	44	0	3	47	0	0
3	37666774	.	C	T	2	20	22	0	15	37	0	0
3	37667562	.	C	T	2	23	25	0	22	47	0	0
3	37667608	.	G	C	27	16	43	0	3	46	0	0
3	37667646	.	C	T	23	14	37	0	2	39	0	0
3	37667952	.	C	T	1	15	16	0	19	35	0	0
3	37668319	.	A	G	15	5	20	0	0	20	0	0
3	37668370	.	T	C	4	4	8	0	0	8	0	0
3	37668578	.	T	A	12	14	26	0	3	29	0	0
3	37668667	.	C	A	14	9	23	0	0	23	0	0
3	37670156	.	G	T	4	7	11	0	0	11	0	0
3	37673750	.	T	A	9	7	16	0	0	16	0	0
3	37725453	.	A	G	5	0	5	0	5	10	0	0
3	37726111	.	C	T	4	3	7	0	0	7	0	0
3	37727784	.	T	C	3	5	8	0	0	8	0	0
3	37727926	.	C	G	7	5	12	0	1	13	0	0
3	37737680	.	C	A	9	7	16	0	0	16	0	0
3	37737735	.	T	G	7	0	7	0	7	14	0	0
3	37737736	.	C	T	7	7	14	0	0	14	0	0
3	37738024	.	A	G	4	8	12	0	0	12	0	0
3	37738089	.	G	A	4	7	11	0	1	12	0	0
3	37742116	.	A	C	4	2	6	0	2	8	0	0
3	37742152	.	T	C	5	3	8	0	0	8	0	0
3	37742245	.	C	T	8	5	13	0	0	13	0	0
3	37742247	.	A	G	8	5	13	0	0	13	0	0
3	37742338	.	C	G	6	2	8	0	0	8	0	0
3	37742363	.	C	T	4	3	7	0	0	7	0	0
3	37776713	.	T	C	1	4	5	0	0	5	0	0
3	37777309	.	A	T	7	5	12	0	0	12	0	0
3	37777417	.	G	C	4	2	6	0	0	6	0	0
3	37777590	.	C	T	7	5	12	0	1	13	0	0
3	37777811	.	C	T	0	6	6	0	12	18	0	0
3	37781162	.	A	G	6	5	11	0	0	11	0	0
3	37788401	.	T	C	36	23	59	0	4	63	0	0
3	37789216	.	G	T	3	6	9	0	0	9	0	0
3	37827364	.	G	A	6	9	15	0	0	15	0	0
3	37827420	.	G	A	2	4	6	0	0	6	0	0
3	37827822	.	C	T	8	6	14	0	1	15	0	0
3	37827948	.	C	T	5	5	10	0	0	10	0	0
3	38505629	.	A	G	16	11	27	0	2	29	0	0
3	38614366	.	C	T	15	12	27	0	1	28	0	0
3	38614426	.	A	G	13	0	13	0	12	25	0	0
3	38614562	.	C	T	18	11	29	0	1	30	0	0
3	38624737	.	A	G	18	1	19	0	13	33	1	0
3	38624823	.	G	A	27	9	36	0	0	36	0	0
3	38625098	.	A	C	17	11	28	0	0	28	0	0
3	38625497	.	G	T	15	10	25	0	1	26	0	0
3	38625559	.	T	C	16	13	29	0	2	31	0	0
3	38625605	.	G	A	22	15	37	0	1	38	0	0
3	38625751	.	A	C	12	11	23	0	0	23	0	0
3	38625901	.	T	G	14	11	25	0	1	26	0	0
3	38649062	.	T	A	2	3	5	0	0	5	0	0
3	38649991	.	A	T	15	14	29	0	0	29	0	0
3	38650341	.	T	C	10	7	17	3	2	22	0	0
3	38650348	.	T	C	4	15	19	3	0	22	0	0
3	38650440	.	T	C	9	9	18	0	1	19	0	0
3	38763153	.	T	A	9	6	15	0	4	19	0	0
3	38763391	.	A	G	2	9	11	0	0	11	0	0
3	38763564	.	C	A	3	4	7	0	0	7	0	0
3	38763700	.	G	A	6	6	12	0	0	12	0	0
3	38764227	.	C	T	3	5	8	0	2	10	0	0
3	38764229	.	G	A	3	7	10	0	0	10	0	0
3	38764738	.	A	C	4	0	4	0	6	10	0	0
3	38764990	.	G	T	2	2	4	0	1	5	0	0
3	38765149	.	A	T	7	2	9	0	0	9	0	0
3	38765447	.	T	G	1	0	1	0	0	4	3	0
3	38765636	.	T	A	1	2	3	0	0	3	0	0
3	38765811	.	A	T	3	2	5	0	0	5	0	0
3	38766108	.	A	C	1	0	1	0	4	5	0	0
3	38766207	.	C	T	1	7	8	0	8	16	0	0
3	38766395	.	G	A	6	6	12	0	0	12	0	0
3	38766507	.	G	A	5	6	11	0	1	12	0	0
3	38766813	.	A	G	8	4	12	0	0	12	0	0
3	38767750	.	T	C	6	6	12	0	0	12	0	0
3	38793631	.	C	T	5	3	8	0	0	8	0	0
3	38793729	.	G	T	0	4	4	0	8	12	0	0
3	38793808	.	G	A	3	4	7	0	1	8	0	0
3	38794422	.	G	C	7	8	15	0	0	15	0	0
3	38858514	.	T	G	4	0	4	0	4	8	0	0
3	38858649	.	A	G	7	4	11	0	0	11	0	0
3	38858908	.	G	A	0	7	7	0	7	14	0	0
3	38858949	.	G	C	2	7	9	0	1	10	0	0
3	38859066	.	G	A	4	4	8	0	0	8	0	0
3	38859126	.	A	T	4	3	7	0	1	8	0	0
3	39181635	.	C	T	4	4	8	0	0	8	0	0
3	39181745	.	T	A	2	2	4	0	0	4	0	0
3	39181758	.	C	A	2	1	3	0	0	3	0	0
3	39184156	.	A	G	7	10	17	0	0	17	0	0
3	39184180	.	C	T	8	9	17	0	0	17	0	0
3	39184710	.	A	G	6	6	12	0	0	12	0	0
3	39186729	.	T	C	4	6	10	1	0	11	0	0
3	39189208	.	G	T	4	2	6	4	0	10	0	0
3	39189212	.	A	G	3	2	5	4	0	9	0	0
3	39238579	.	C	A	7	8	15	0	0	15	0	0
3	39238580	.	C	A	7	8	15	0	1	16	0	0
3	39239380	.	A	G	20	16	36	0	2	38	0	0
3	39241350	.	G	T	25	10	35	0	0	35	0	0
3	39248863	.	A	G	11	13	24	0	0	24	0	0
3	39251020	.	G	T	8	8	16	0	0	16	0	0
3	39251341	.	T	C	9	8	17	0	0	17	0	0
3	39259624	.	T	C	11	0	11	0	11	22	0	0
3	39260767	.	A	T	2	4	6	0	0	6	0	0
3	39260818	.	A	G	1	2	3	0	1	4	0	0
3	39261182	.	C	A	0	2	2	0	4	6	0	0
3	39261230	.	C	T	4	3	7	0	0	7	0	0
3	39261270	.	C	T	0	2	2	0	1	3	0	0
3	39261709	.	T	C	1	0	1	0	1	2	0	0
3	39261718	.	C	T	1	3	4	0	0	4	0	0
3	39261765	.	C	T	1	3	4	0	0	4	0	0
3	39262925	.	C	A	2	2	4	0	0	4	0	0
3	39263444	.	T	G	1	2	3	0	0	3	0	0
3	39263613	.	A	G	1	2	3	0	0	3	0	0
3	39263625	.	T	A	1	2	3	0	0	3	0	0
3	39269898	.	T	C	2	2	4	0	0	4	0	0
3	39269922	.	T	C	2	2	4	0	0	4	0	0
3	39313310	.	A	G	8	7	15	0	1	16	0	0
3	39313625	.	T	C	8	8	16	0	0	16	0	0
3	39314028	.	C	T	8	23	31	0	0	31	0	0
3	39314101	.	T	C	13	17	30	0	2	32	0	0
3	39314146	.	C	G	10	12	22	0	2	24	0	0
3	39314260	.	A	G	9	5	14	0	0	14	0	0
3	39314502	.	G	C	12	9	21	0	1	22	0	0
3	39314631	.	C	T	2	11	13	0	10	23	0	0
3	39314677	.	C	T	6	11	17	0	0	17	0	0
3	39314857	.	G	T	3	3	6	0	1	7	0	0
3	39314893	.	C	A	5	4	9	0	1	10	0	0
3	39314899	.	C	T	4	5	9	0	1	10	0	0
3	39314931	.	C	G	3	4	7	0	1	8	0	0
3	39314948	.	C	T	5	2	7	0	1	8	0	0
3	39314968	.	G	A	4	2	6	0	1	7	0	0
3	39315154	.	C	A	3	10	13	0	0	13	0	0
3	39315169	.	C	G	4	10	14	0	0	14	0	0
3	39315191	.	C	G	6	6	12	0	1	13	0	0
3	39315292	.	A	G	4	3	7	0	1	8	0	0
3	39315728	.	C	T	6	3	9	0	0	9	0	0
3	39315737	.	T	C	5	2	7	0	0	7	0	0
3	39315816	.	A	G	7	8	15	0	0	15	0	0
3	39315874	.	C	A	7	11	18	0	1	19	0	0
3	39315876	.	C	T	7	11	18	0	1	19	0	0
3	39315937	.	A	C	6	0	6	0	7	13	0	0
3	39316037	.	T	C	13	6	19	0	0	19	0	0
3	39316062	.	G	A	13	3	16	0	0	16	0	0
3	39316167	.	A	G	6	9	15	0	0	15	0	0
3	39316570	.	G	A	10	6	16	0	0	16	0	0
3	39316846	.	T	C	14	19	33	0	1	34	0	0
3	39316906	.	C	A	21	21	42	0	1	43	0	0
3	39316912	.	G	A	19	17	36	0	3	39	0	0
3	39316996	.	A	G	21	19	40	0	1	41	0	0
3	39317215	.	C	G	10	9	19	0	0	19	0	0
3	39317279	.	C	T	6	9	15	0	2	17	0	0
3	39317310	.	T	C	6	10	16	0	1	17	0	0
3	39317370	.	C	T	7	7	14	0	1	15	0	0
3	39322109	.	G	A	6	11	17	0	0	17	0	0
3	39328095	.	G	C	13	11	24	0	0	24	0	0
3	39330407	.	T	C	7	0	7	0	21	28	0	0
3	39348533	.	G	A	11	13	24	0	0	24	0	0
3	39348914	.	G	A	6	8	14	0	1	15	0	0
3	39454708	.	C	G	3	7	10	0	0	10	0	0
3	39560664	.	T	C	2	4	6	0	0	6	0	0
3	39563187	.	T	C	1	2	3	0	0	3	0	0
3	39563457	.	T	C	1	1	2	0	1	3	0	0
3	39568368	.	T	G	33	17	50	0	0	50	0	0
3	39568856	.	A	G	26	32	58	1	1	60	0	0
3	39574883	.	C	A	37	30	67	0	3	70	0	0
3	39574961	.	G	A	32	35	67	0	4	72	1	0
3	39576621	.	T	G	43	0	43	0	30	73	0	0
3	39576663	.	A	G	34	41	75	0	5	80	0	0
3	39576866	.	T	C	19	29	48	0	1	49	0	0
3	39579562	.	T	C	1	4	5	0	2	7	0	0
3	39579616	.	C	A	2	5	7	0	0	7	0	0
3	39579660	.	G	T	6	3	9	0	0	9	0	0
3	39586473	.	A	T	7	4	11	0	0	11	0	0
3	39592640	.	T	G	4	7	11	0	0	11	0	0
3	39592797	.	C	T	4	6	10	0	0	10	0	0
3	39592800	.	G	C	0	7	7	0	4	11	0	0
3	39601391	.	A	G	1	2	3	0	1	4	0	0
3	39606220	.	C	T	8	5	13	0	1	14	0	0
3	39612261	.	T	A	13	11	24	0	0	24	0	0
3	39612430	.	T	C	12	13	25	0	2	27	0	0
3	39612579	.	G	C	11	8	19	0	0	19	0	0
3	39612715	.	A	T	8	11	19	0	0	19	0	0
3	39613024	.	T	C	9	13	22	0	1	23	0	0
3	39631505	.	T	C	1	7	8	0	0	8	0	0
3	39663915	.	C	T	6	2	8	0	0	8	0	0
3	39663929	.	T	C	7	3	10	1	0	11	0	0
3	39683715	.	A	G	4	5	9	0	0	9	0	0
3	39685635	.	G	T	0	2	2	0	6	8	0	0
3	39686016	.	C	A	5	2	7	0	0	7	0	0
3	39686776	.	T	A	6	3	9	0	1	10	0	0
3	39686807	.	A	T	6	5	11	0	0	11	0	0
3	39686915	.	T	C	3	3	6	0	0	6	0	0
3	39687418	.	C	T	4	8	12	0	1	13	0	0
3	39688558	.	T	G	4	2	6	0	0	6	0	0
3	39688892	.	T	C	6	4	10	0	0	10	0	0
3	39688906	.	C	T	4	2	6	0	1	7	0	0
3	39689216	.	T	C	7	5	12	0	0	12	0	0
3	39689234	.	G	T	6	5	11	0	0	11	0	0
3	39689277	.	A	G	6	3	9	0	0	9	0	0
3	39691611	.	G	A	1	2	3	0	0	3	0	0
3	39691978	.	C	G	2	5	7	0	0	7	0	0
3	39692008	.	G	T	2	4	6	0	0	6	0	0
3	39692165	.	A	T	4	8	12	0	0	12	0	0
3	39692196	.	C	T	0	6	6	0	8	14	0	0
3	39692206	.	C	T	6	4	10	0	1	11	0	0
3	39692235	.	C	A	4	8	12	0	0	12	0	0
3	39692265	.	G	A	6	7	13	0	0	13	0	0
3	39692307	.	A	G	10	9	19	0	0	19	0	0
3	39695744	.	T	C	3	5	8	0	0	8	0	0
3	39876186	.	C	T	4	4	8	0	0	8	0	0
3	39878822	.	T	C	10	11	21	0	0	21	0	0
3	39884348	.	G	A	0	6	6	0	5	11	0	0
3	39909569	.	A	G	2	0	2	0	6	8	0	0
3	39919127	.	G	A	5	2	7	0	1	8	0	0
3	39923512	.	G	A	0	3	3	0	4	7	0	0
3	39925012	.	T	G	10	0	10	0	6	16	0	0
3	39925087	.	T	C	10	3	13	0	0	13	0	0
3	39940210	.	T	C	5	13	18	1	1	20	0	0
3	39945696	.	A	G	13	8	21	0	0	21	0	0
3	39949389	.	G	A	19	5	24	1	0	25	0	0
3	39949650	.	G	A	2	20	22	0	14	36	0	0
3	39950276	.	A	C	14	13	27	1	3	31	0	0
3	39950340	.	C	T	15	8	23	0	0	23	0	0
3	39950414	.	T	C	12	16	28	0	2	30	0	0
3	39950954	.	T	C	10	7	17	0	1	18	0	0
3	39951124	.	C	T	13	5	18	0	0	18	0	0
3	39951216	.	T	C	7	9	16	0	0	16	0	0
3	39951703	.	A	T	9	5	14	0	1	15	0	0
3	39952025	.	T	C	5	8	13	0	0	13	0	0
3	39952272	.	A	G	10	11	21	0	0	21	0	0
3	39952273	.	A	T	10	9	19	0	2	21	0	0
3	39958680	.	C	T	3	4	7	0	1	8	0	0
3	39958729	.	T	A	11	6	17	0	0	17	0	0
3	39959679	.	A	C	6	6	12	0	3	15	0	0
3	39960535	.	G	C	1	4	5	0	2	7	0	0
3	39962906	.	T	G	5	12	17	0	0	17	0	0
3	39962981	.	T	C	11	13	24	0	0	24	0	0
3	39963053	.	T	C	10	6	16	0	0	16	0	0
3	39963089	.	A	G	5	5	10	0	1	11	0	0
3	39963128	.	G	A	5	5	10	0	0	10	0	0
3	39963131	.	A	G	4	5	9	0	0	9	0	0
3	39970555	.	G	A	8	3	11	0	1	12	0	0
3	39970641	.	T	G	8	8	16	0	1	17	0	0
3	39971470	.	T	C	8	9	17	0	0	17	0	0
3	39971499	.	T	C	5	7	12	0	0	12	0	0
3	39971592	.	T	C	3	7	10	0	0	10	0	0
3	39971894	.	T	C	7	7	14	0	0	14	0	0
3	39971930	.	T	C	9	2	11	0	1	12	0	0
3	39972055	.	T	C	1	4	5	0	2	7	0	0
3	39972073	.	G	A	4	3	7	0	0	7	0	0
3	39975467	.	T	C	7	0	7	0	13	20	0	0
3	39982019	.	C	T	6	7	13	0	0	13	0	0
3	39982198	.	A	T	5	2	7	0	0	7	0	0
3	39982423	.	T	C	4	1	5	0	2	7	0	0
3	39984551	.	C	T	0	7	7	0	3	10	0	0
3	39984581	.	G	A	4	6	10	0	1	11	0	0
3	39984776	.	G	T	1	2	3	0	0	3	0	0
3	39987992	.	T	C	5	1	6	0	5	11	0	0
3	39990027	.	A	C	1	5	6	0	0	6	0	0
3	40003947	.	T	G	4	5	9	0	0	9	0	0
3	40015244	.	T	G	5	5	10	0	0	10	0	0
3	40054647	.	C	T	1	4	5	0	2	7	0	0
3	40207086	.	T	C	15	20	35	0	0	35	0	0
3	40207227	.	T	C	21	5	26	0	0	26	0	0
3	40207232	.	T	C	3	22	25	0	0	25	0	0
3	40207357	.	T	C	8	3	11	0	2	13	0	0
3	40256199	.	A	T	6	4	10	0	0	10	0	0
3	40256334	.	T	C	9	5	14	0	0	14	0	0
3	40256418	.	C	T	6	9	15	0	0	15	0	0
3	40256734	.	G	A	6	3	9	0	0	9	0	0
3	40256735	.	C	A	6	2	8	0	1	9	0	0
3	40257357	.	A	G	6	0	6	0	9	15	0	0
3	40258465	.	T	C	12	7	19	0	1	20	0	0
3	40268423	.	T	C	1	0	1	0	2	3	0	0
3	40268432	.	T	C	1	1	2	0	0	2	0	0
3	40278023	.	C	T	3	14	17	0	11	28	0	0
3	40278180	.	T	C	16	0	16	0	7	23	0	0
3	40280034	.	T	C	10	10	20	0	0	20	0	0
3	40284375	.	T	C	11	1	12	0	10	22	0	0
3	40284447	.	T	A	12	12	24	0	0	24	0	0
3	40284823	.	C	A	2	4	6	0	0	6	0	0
3	40284860	.	G	T	17	12	29	0	0	29	0	0
3	40284982	.	T	C	21	12	33	0	2	35	0	0
3	40287185	.	G	C	2	10	12	0	14	26	0	0
3	40287188	.	G	A	15	11	26	0	0	26	0	0
3	40287227	.	C	T	11	17	28	0	0	28	0	0
3	40287538	.	C	T	4	3	7	0	1	8	0	0
3	40290123	.	T	C	4	10	14	0	0	14	0	0
3	40290138	.	A	G	5	7	12	0	0	12	0	0
3	40294179	.	G	A	9	11	20	0	1	21	0	0
3	40294260	.	A	T	12	13	25	0	0	25	0	0
3	40294511	.	G	C	6	12	18	0	0	18	0	0
3	40297428	.	G	A	34	27	61	0	1	62	0	0
3	40297479	.	C	T	28	30	58	0	1	59	0	0
3	40299995	.	G	A	33	36	69	0	2	71	0	0
3	40301233	.	A	G	7	8	15	0	0	15	0	0
3	40315555	.	G	T	9	4	13	0	2	15	0	0
3	40318555	.	C	G	9	7	16	0	0	16	0	0
3	40318556	.	C	G	8	7	15	0	1	16	0	0
3	40318613	.	A	G	9	3	12	0	0	12	0	0
3	40318733	.	T	A	8	5	13	0	0	13	0	0
3	40329683	.	T	C	11	5	16	0	0	16	0	0
3	40333577	.	A	G	9	0	9	0	12	21	0	0
3	40333592	.	C	T	7	8	15	0	3	18	0	0
3	40333700	.	A	G	8	0	8	0	9	17	0	0
3	40333793	.	T	C	6	9	15	0	1	16	0	0
3	40346035	.	C	T	19	6	25	0	0	25	0	0
3	40346059	.	T	C	21	10	31	0	0	31	0	0
3	40348839	.	T	C	24	11	35	0	0	36	1	0
3	40349310	.	A	G	10	10	20	0	0	20	0	0
3	40349354	.	T	G	9	7	16	0	0	16	0	0
3	40430922	.	G	A	2	8	10	0	10	20	0	0
3	40443096	.	C	G	11	7	18	0	1	19	0	0
3	40444020	.	C	T	6	3	9	0	0	9	0	0
3	40444539	.	T	C	14	12	26	0	0	26	0	0
3	40448097	.	A	C	6	10	16	0	0	16	0	0
3	40448130	.	A	G	11	0	11	0	10	21	0	0
3	40448220	.	T	C	11	9	20	0	4	24	0	0
3	40449595	.	C	A	15	13	28	0	1	29	0	0
3	40449603	.	T	C	13	16	29	0	0	29	0	0
3	40449696	.	C	T	19	18	37	0	3	40	0	0
3	40450743	.	C	T	16	11	27	0	0	27	0	0
3	40450961	.	T	G	6	0	6	0	17	23	0	0
3	40451268	.	C	T	13	13	26	0	0	26	0	0
3	40451319	.	T	C	17	9	26	0	0	26	0	0
3	40451352	.	A	T	7	9	16	0	0	16	0	0
3	40451407	.	A	G	2	1	3	0	10	13	0	0
3	40452119	.	G	C	12	8	20	0	2	22	0	0
3	40452134	.	A	G	13	1	14	0	11	25	0	0
3	40458531	.	C	A	13	12	25	0	0	25	0	0
3	40458594	.	G	A	5	9	14	0	17	31	0	0
3	40467464	.	C	T	7	9	16	1	2	19	0	0
3	40467486	.	G	A	2	14	16	0	8	24	0	0
3	40467693	.	A	G	9	0	9	0	13	22	0	0
3	40467756	.	C	T	19	8	27	0	4	31	0	0
3	40469891	.	T	C	14	12	26	0	3	29	0	0
3	40480877	.	G	A	2	18	20	0	21	41	0	0
3	40480986	.	G	T	19	18	37	0	2	39	0	0
3	40481346	.	G	A	1	22	23	0	23	46	0	0
3	40481459	.	C	T	11	22	33	0	1	34	0	0
3	40481513	.	A	G	15	10	25	0	0	25	0	0
3	40481649	.	T	G	16	11	27	0	0	27	0	0
3	40481930	.	T	A	20	20	40	0	0	40	0	0
3	40482007	.	T	C	19	15	34	0	2	36	0	0
3	40482027	.	A	G	15	0	15	0	14	29	0	0
3	40482289	.	C	A	25	23	48	0	1	49	0	0
3	40482446	.	A	G	13	18	31	0	1	32	0	0
3	40484376	.	A	T	20	12	32	1	1	34	0	0
3	40485360	.	C	A	11	13	24	0	1	25	0	0
3	40485378	.	T	G	12	12	24	0	0	24	0	0
3	40485422	.	G	T	1	17	18	0	15	33	0	0
3	40485499	.	G	A	17	22	39	0	1	40	0	0
3	40485965	.	G	C	7	5	12	0	0	12	0	0
3	40487095	.	G	T	15	9	24	0	0	24	0	0
3	40487162	.	A	C	12	6	18	0	0	18	0	0
3	40487385	.	T	A	13	16	29	0	0	29	0	0
3	40487820	.	A	G	19	9	28	0	0	28	0	0
3	40487821	.	G	C	19	9	28	0	0	28	0	0
3	40488212	.	C	T	16	15	31	0	3	34	0	0
3	40488264	.	C	T	5	20	25	0	8	33	0	0
3	40488630	.	T	C	1	3	4	0	0	4	0	0
3	40488640	.	T	C	0	4	4	0	0	4	0	0
3	40527028	.	G	A	46	42	88	0	2	90	0	0
3	40527512	.	G	A	33	43	76	1	5	82	0	0
3	40527575	.	G	A	47	63	110	5	18	133	0	0
3	40527665	.	A	G	16	11	27	0	0	27	0	0
3	40527727	.	G	A	19	12	31	0	0	31	0	0
3	40528132	.	C	T	0	3	3	0	4	7	0	0
3	40528241	.	A	T	49	32	81	0	1	82	0	0
3	40576600	.	C	T	24	29	53	0	1	54	0	0
3	40576736	.	C	T	26	17	43	0	2	45	0	0
3	40576972	.	A	G	24	2	26	0	27	53	0	0
3	40577032	.	C	T	23	26	49	0	0	49	0	0
3	40583989	.	C	G	24	26	50	0	4	54	0	0
3	40584318	.	T	A	23	24	47	0	3	50	0	0
3	40587967	.	C	T	28	31	59	0	0	59	0	0
3	40588109	.	A	T	20	28	48	0	4	52	0	0
3	40588195	.	T	C	29	29	58	0	0	58	0	0
3	40588363	.	C	T	35	13	48	0	0	48	0	0
3	40588410	.	C	A	28	16	44	0	0	44	0	0
3	40588467	.	T	C	20	15	35	0	0	35	0	0
3	40588595	.	A	C	17	22	39	0	1	40	0	0
3	40588746	.	C	G	14	28	42	0	0	42	0	0
3	40588845	.	A	G	21	17	38	0	2	40	0	0
3	40589147	.	T	C	38	21	59	0	1	60	0	0
3	40589179	.	C	A	39	22	61	0	1	62	0	0
3	40589191	.	T	G	40	22	62	0	1	63	0	0
3	40589214	.	C	A	31	25	56	0	0	56	0	0
3	40589232	.	A	G	32	27	59	0	2	61	0	0
3	40589266	.	C	T	27	19	46	0	0	46	0	0
3	40589348	.	A	G	14	21	35	0	2	37	0	0
3	40589356	.	A	G	14	21	35	0	2	37	0	0
3	40690704	.	T	C	4	0	4	0	7	11	0	0
3	40690901	.	G	A	2	8	10	2	1	13	0	0
3	40691448	.	A	G	3	4	7	0	1	8	0	0
3	40691473	.	A	T	9	3	12	0	0	12	0	0
3	40691643	.	A	T	8	5	13	0	0	13	0	0
3	40691969	.	C	T	8	11	19	0	0	19	0	0
3	40692064	.	A	T	8	6	14	0	1	15	0	0
3	40698424	.	C	A	5	13	18	1	0	19	0	0
3	40698481	.	A	G	5	7	12	0	0	12	0	0
3	40712935	.	G	A	9	7	16	0	1	17	0	0
3	40713085	.	G	T	9	13	22	0	0	22	0	0
3	40715629	.	T	C	4	6	10	0	0	10	0	0
3	40768371	.	A	T	8	5	13	0	0	13	0	0
3	40814521	.	T	C	3	5	8	0	0	8	0	0
3	40814587	.	G	A	2	3	5	0	0	5	0	0
3	40820007	.	A	G	3	2	5	0	1	6	0	0
3	40821838	.	C	A	10	17	27	0	0	27	0	0
3	40821871	.	A	T	15	19	34	0	0	34	0	0
3	40821953	.	C	A	0	20	20	0	14	34	0	0
3	40828768	.	T	C	5	1	6	0	18	24	0	0
3	40876757	.	G	A	7	3	10	0	1	11	0	0
3	40881515	.	C	T	4	2	6	0	0	6	0	0
3	40882964	.	A	T	2	3	5	0	0	5	0	0
3	40902163	.	C	T	0	8	8	0	3	11	0	0
3	40907953	.	T	C	7	0	7	0	13	20	0	0
3	40913730	.	G	A	9	13	22	0	0	22	0	0
3	40927653	.	C	T	10	11	21	0	2	23	0	0
3	40973539	.	C	T	2	7	9	0	0	9	0	0
3	40974842	.	A	C	2	2	4	0	0	4	0	0
3	40979281	.	T	C	5	5	10	0	0	10	0	0
3	40980024	.	G	A	8	3	11	0	1	12	0	0
3	40980166	.	T	A	12	6	18	0	0	18	0	0
3	40983062	.	A	G	12	9	21	0	0	21	0	0
3	40983077	.	G	A	13	7	20	0	0	20	0	0
3	40985992	.	T	C	8	5	13	0	0	13	0	0
3	40997589	.	T	A	4	5	9	0	0	9	0	0
3	41000159	.	T	C	4	0	4	0	5	9	0	0
3	41003413	.	G	A	8	8	16	1	0	17	0	0
3	41023331	.	G	A	4	6	10	0	0	10	0	0
3	41030861	.	T	G	5	7	12	0	1	13	0	0
3	41037795	.	A	C	9	1	10	0	7	17	0	0
3	41047649	.	C	T	5	4	9	0	0	9	0	0
3	41069430	.	G	A	6	5	11	0	0	11	0	0
3	41084346	.	C	T	5	2	7	0	0	7	0	0
3	41084442	.	G	C	5	0	5	0	7	12	0	0
3	41086781	.	T	C	6	3	9	0	1	10	0	0
3	41088977	.	A	G	1	3	4	0	0	4	0	0
3	41088983	.	G	A	1	3	4	0	0	4	0	0
3	41092046	.	G	C	1	2	3	0	1	4	0	0
3	41092137	.	A	T	1	5	6	0	1	7	0	0
3	41103034	.	T	C	3	0	3	0	3	6	0	0
3	41162819	.	C	T	4	6	10	0	1	11	0	0
3	41511204	.	T	A	1	3	4	0	0	4	0	0
3	41511741	.	C	T	2	3	5	0	1	6	0	0
3	41511750	.	A	G	3	2	5	0	0	5	0	0
3	41511993	.	T	G	1	3	4	0	0	4	0	0
3	41705027	.	T	C	1	2	3	0	0	3	0	0
3	41705031	.	G	A	1	2	3	0	0	3	0	0
3	41705468	.	A	T	2	3	5	0	0	5	0	0
3	41705476	.	C	T	3	3	6	0	0	6	0	0
3	41705560	.	A	G	4	2	6	0	2	8	0	0
3	41705597	.	C	T	4	2	6	0	0	6	0	0
3	41719049	.	G	A	13	11	24	0	3	27	0	0
3	41721916	.	G	A	17	19	36	0	3	39	0	0
3	41723437	.	G	A	18	18	36	0	1	37	0	0
3	41724806	.	G	A	16	13	29	0	0	29	0	0
3	41917608	.	G	T	4	7	11	0	0	11	0	0
3	41917747	.	T	C	8	7	15	0	0	15	0	0
3	41917830	.	T	C	5	4	9	0	0	9	0	0
3	41922243	.	C	T	3	2	5	0	0	5	0	0
3	41922587	.	C	T	4	4	8	0	0	8	0	0
3	41922766	.	A	G	2	0	2	0	4	6	0	0
3	41922799	.	C	T	2	5	7	0	0	7	0	0
3	41923195	.	T	C	7	4	11	0	0	11	0	0
3	41923288	.	C	T	4	3	7	0	0	7	0	0
3	41925508	.	A	G	6	5	11	0	0	11	0	0
3	41925541	.	C	G	6	5	11	0	0	11	0	0
3	41925663	.	C	T	6	7	13	1	0	14	0	0
3	41925694	.	A	C	2	8	10	2	0	12	0	0
3	41925823	.	C	T	3	3	6	0	0	6	0	0
3	41925889	.	T	C	3	2	5	0	1	6	0	0
3	41926020	.	T	A	4	4	8	0	0	8	0	0
3	41926557	.	G	A	1	3	4	0	0	4	0	0
3	41926633	.	T	A	2	3	5	0	0	5	0	0
3	41926695	.	T	C	3	5	8	0	1	9	0	0
3	41955449	.	A	G	2	2	4	0	0	4	0	0
3	41955526	.	C	T	1	5	6	0	0	6	0	0
3	41955613	.	G	T	20	10	30	0	1	31	0	0
3	41955911	.	C	G	14	17	31	0	1	32	0	0
3	41956040	.	G	T	12	11	23	0	1	24	0	0
3	41956299	.	T	C	6	12	18	0	1	19	0	0
3	41956353	.	T	A	6	11	17	0	2	19	0	0
3	41956467	.	T	A	3	2	5	0	1	6	0	0
3	41956504	.	C	T	5	2	7	0	0	7	0	0
3	41956792	.	A	T	13	9	22	0	0	22	0	0
3	41956818	.	T	C	11	5	16	0	2	18	0	0
3	41956837	.	T	G	13	4	17	0	0	17	0	0
3	41956855	.	C	T	12	7	19	0	0	19	0	0
3	41956921	.	T	A	5	10	15	0	0	15	0	0
3	41956941	.	T	C	11	3	14	0	0	14	0	0
3	41956978	.	G	A	2	13	15	0	0	15	0	0
3	41957096	.	A	T	4	2	6	0	0	6	0	0
3	41957457	.	T	A	4	3	7	0	1	8	0	0
3	41957580	.	G	T	2	9	11	0	1	12	0	0
3	41957660	.	A	T	4	3	7	0	0	7	0	0
3	41957993	.	G	A	6	2	8	0	0	8	0	0
3	41958004	.	G	T	7	2	9	0	0	9	0	0
3	41958291	.	T	G	4	4	8	0	0	8	0	0
3	41958829	.	A	G	7	5	12	0	0	12	0	0
3	41959370	.	G	T	11	17	28	0	0	28	0	0
3	41959658	.	G	T	10	8	18	0	0	18	0	0
3	41959772	.	A	G	11	11	22	0	2	24	0	0
3	41959906	.	T	A	9	3	12	0	0	12	0	0
3	41959943	.	T	C	8	9	17	0	0	17	0	0
3	41959958	.	A	G	8	9	17	0	0	17	0	0
3	41960005	.	C	A	7	10	17	0	1	18	0	0
3	41960069	.	G	T	10	7	17	0	1	18	0	0
3	41960462	.	T	A	1	3	4	0	0	4	0	0
3	41961314	.	G	A	6	8	14	0	1	15	0	0
3	41961341	.	T	G	8	7	15	0	2	17	0	0
3	41961469	.	A	G	9	7	16	0	1	17	0	0
3	41961558	.	A	T	10	7	17	0	0	17	0	0
3	41961587	.	T	G	12	7	19	0	0	19	0	0
3	41961651	.	G	A	8	7	15	0	2	17	0	0
3	41961688	.	T	C	11	0	11	0	12	23	0	0
3	41962098	.	T	C	7	5	12	0	0	12	0	0
3	41962463	.	G	A	3	6	9	0	0	9	0	0
3	41985866	.	G	A	3	12	15	0	1	16	0	0
3	41985953	.	C	T	6	5	11	0	1	12	0	0
3	41985959	.	G	A	5	6	11	0	1	12	0	0
3	42016675	.	A	T	3	3	6	0	0	6	0	0
3	42016682	.	C	G	1	2	3	0	1	4	0	0
3	42119558	.	C	A	1	2	3	0	0	3	0	0
3	42121500	.	G	A	2	2	4	0	0	4	0	0
3	42126504	.	G	C	1	2	3	0	0	3	0	0
3	42126551	.	A	G	1	2	3	0	0	3	0	0
3	42126639	.	T	C	1	2	3	0	0	3	0	0
3	42918924	.	C	A	10	9	19	0	1	20	0	0
3	42919474	.	C	T	11	11	22	0	0	22	0	0
3	42919510	.	C	T	7	9	16	0	2	18	0	0
3	42919664	.	C	T	9	7	16	0	0	16	0	0
3	42919846	.	T	G	1	5	6	0	0	6	0	0
3	42919849	.	C	T	1	5	6	0	0	6	0	0
3	42919881	.	C	T	2	6	8	0	0	8	0	0
3	42919895	.	A	G	2	4	6	0	0	6	0	0
3	43000474	.	A	G	2	9	11	0	1	12	0	0
3	43000489	.	G	A	1	6	7	0	5	12	0	0
3	43000552	.	T	A	1	4	5	0	0	5	0	0
3	43003017	.	G	T	7	2	9	0	0	9	0	0
3	43011337	.	T	C	2	2	4	0	1	5	0	0
3	43011376	.	C	T	1	2	3	0	0	3	0	0
3	43014152	.	A	G	3	8	11	0	0	11	0	0
3	43014396	.	T	C	3	6	9	0	0	9	0	0
3	43017888	.	A	C	5	2	7	0	0	7	0	0
3	43017912	.	T	C	3	3	6	0	0	6	0	0
3	43018005	.	C	T	6	5	11	0	0	11	0	0
3	43021221	.	A	G	2	4	6	0	0	6	0	0
3	43024872	.	T	C	2	2	4	0	0	4	0	0
3	43029889	.	T	C	3	4	7	0	0	7	0	0
3	43036193	.	T	C	5	4	9	0	0	9	0	0
3	43038222	.	G	A	2	10	12	0	1	13	0	0
3	43039306	.	A	G	6	7	13	0	0	13	0	0
3	43039479	.	C	T	4	4	8	0	0	8	0	0
3	43040677	.	G	A	2	5	7	0	5	12	0	0
3	43052230	.	T	C	8	9	17	0	0	17	0	0
3	43059090	.	A	G	5	9	14	0	0	14	0	0
3	43059153	.	A	G	8	8	16	0	0	16	0	0
3	43060866	.	T	C	3	2	5	1	0	6	0	0
3	43376543	.	A	G	2	10	12	1	0	13	0	0
3	43380283	.	C	T	6	6	12	0	0	13	1	0
3	43392755	.	T	A	5	12	17	0	1	18	0	0
3	43392795	.	C	A	5	8	13	0	1	14	0	0
3	43467654	.	T	C	7	5	12	0	0	12	0	0
3	43474920	.	A	T	4	6	10	0	0	10	0	0
3	43475184	.	C	T	7	7	14	0	0	14	0	0
3	43475265	.	G	A	8	3	11	0	0	11	0	0
3	43475376	.	T	C	10	6	16	0	1	17	0	0
3	43475397	.	C	T	8	8	16	0	0	16	0	0
3	43475592	.	A	C	4	8	12	0	0	12	0	0
3	43475617	.	G	T	1	6	7	0	4	11	0	0
3	43475654	.	C	T	5	6	11	0	0	11	0	0
3	43475742	.	G	T	5	5	10	1	0	11	0	0
3	43475772	.	A	G	7	8	15	1	0	16	0	0
3	43476017	.	A	G	4	2	6	0	0	6	0	0
3	43476088	.	G	T	5	2	7	0	0	7	0	0
3	43476411	.	A	T	6	3	9	0	0	9	0	0
3	43476435	.	G	T	7	4	11	0	1	12	0	0
3	43476508	.	T	A	12	0	12	0	0	12	0	0
3	43476514	.	A	C	9	4	13	0	0	13	0	0
3	43476698	.	A	G	8	4	12	0	1	13	0	0
3	43476880	.	C	T	11	5	16	0	0	16	0	0
3	43476887	.	T	G	11	5	16	0	0	16	0	0
3	43477705	.	T	A	5	2	7	0	0	7	0	0
3	43477975	.	T	G	6	3	9	0	0	9	0	0
3	43478137	.	T	C	8	5	13	0	0	13	0	0
3	43478238	.	C	T	7	4	11	0	1	12	0	0
3	43478433	.	A	T	10	4	14	0	0	14	0	0
3	43478586	.	C	T	4	5	9	0	0	9	0	0
3	43579820	.	C	T	3	12	15	1	11	27	0	0
3	43580055	.	A	G	10	9	19	0	0	19	0	0
3	43580195	.	A	T	8	14	22	0	0	22	0	0
3	43580583	.	T	C	12	10	22	0	0	22	0	0
3	43581272	.	A	C	14	9	23	0	0	23	0	0
3	43584423	.	T	C	13	1	14	0	12	26	0	0
3	43584453	.	T	C	10	14	24	0	2	26	0	0
3	43594256	.	A	G	12	14	26	0	0	26	0	0
3	43594358	.	C	T	9	13	22	0	1	23	0	0
3	43594376	.	C	T	5	13	18	0	8	26	0	0
3	43594577	.	G	A	16	6	22	0	1	23	0	0
3	43594655	.	C	T	1	8	9	0	15	24	0	0
3	43594658	.	G	A	14	9	23	0	0	23	0	0
3	43594735	.	T	C	5	8	13	0	1	14	0	0
3	43600999	.	C	T	1	7	8	0	13	21	0	0
3	43645900	.	G	C	11	13	24	0	1	25	0	0
3	43646161	.	A	G	7	6	13	0	0	13	0	0
3	43646362	.	C	T	2	8	10	0	1	11	0	0
3	43711455	.	A	T	5	2	7	0	0	7	0	0
3	43774440	.	C	A	8	10	18	0	0	18	0	0
3	43776859	.	T	C	3	7	10	0	1	11	0	0
3	43791284	.	T	C	6	15	21	0	0	21	0	0
3	43791317	.	G	A	6	11	17	0	0	17	0	0
3	43793147	.	T	C	5	14	19	0	0	19	0	0
3	43793273	.	G	A	7	8	15	0	0	15	0	0
3	43793389	.	T	C	5	6	11	0	1	12	0	0
3	43796956	.	T	G	10	0	10	0	7	17	0	0
3	43801338	.	C	T	16	11	27	0	1	28	0	0
3	43807512	.	T	C	8	4	12	0	0	12	0	0
3	43807921	.	C	A	6	10	16	0	0	16	0	0
3	43807945	.	T	A	5	7	12	0	0	13	1	0
3	43814607	.	C	T	10	11	21	0	0	21	0	0
3	43821273	.	G	T	11	12	23	0	1	24	0	0
3	43821328	.	A	G	11	7	18	0	0	18	0	0
3	43828902	.	G	A	1	2	3	0	0	3	0	0
3	43828906	.	T	C	1	2	3	0	0	3	0	0
3	43829154	.	G	C	2	4	6	0	1	7	0	0
3	43829712	.	G	A	4	5	9	0	4	13	0	0
3	43942053	.	A	C	1	4	5	0	0	5	0	0
3	43944611	.	A	G	6	4	10	0	0	10	0	0
3	43953805	.	C	T	5	5	10	0	0	10	0	0
3	43953883	.	T	C	4	0	4	0	9	13	0	0
3	44082439	.	A	G	1	3	4	0	0	4	0	0
3	44089225	.	T	G	3	3	6	0	2	8	0	0
3	44089529	.	A	G	2	5	7	0	0	7	0	0
3	44093661	.	T	C	1	0	1	0	3	4	0	0
3	44094114	.	C	T	1	4	5	0	0	5	0	0
3	44094172	.	C	T	0	2	2	0	2	4	0	0
3	44541766	.	C	T	0	7	7	0	3	10	0	0
3	44541955	.	C	A	5	4	9	1	1	11	0	0
3	45286379	.	T	C	4	2	6	0	0	6	0	0
3	45714552	.	C	T	3	2	5	0	1	6	0	0
3	45715511	.	T	A	2	4	6	0	0	6	0	0
3	45715655	.	A	G	3	3	6	0	0	6	0	0
3	45716766	.	A	G	3	0	3	0	3	6	0	0
3	45717180	.	C	T	6	14	20	0	2	22	0	0
3	45776520	.	T	C	18	3	21	0	25	46	0	0
3	45776721	.	T	C	28	36	64	0	0	64	0	0
3	45790559	.	T	C	5	7	12	0	0	12	0	0
3	45805605	.	C	G	15	13	28	0	1	29	0	0
3	45814631	.	A	T	8	5	13	0	0	13	0	0
3	45815894	.	A	C	5	5	10	0	0	10	0	0
3	45815997	.	G	A	1	3	4	0	8	12	0	0
3	45816004	.	C	T	9	3	12	0	0	12	0	0
3	45816549	.	A	G	3	11	14	0	0	14	0	0
3	45816618	.	T	C	13	10	23	0	0	23	0	0
3	46043483	.	G	A	6	7	13	0	0	13	0	0
3	46043528	.	T	A	8	7	15	0	0	15	0	0
3	46044097	.	C	T	2	3	5	0	1	6	0	0
3	46044190	.	G	T	5	6	11	0	0	11	0	0
3	46114398	.	A	G	7	4	11	0	0	11	0	0
3	46114458	.	C	T	0	5	5	0	3	8	0	0
3	46114491	.	C	A	5	5	10	0	0	10	0	0
3	46114925	.	C	G	4	2	6	0	0	6	0	0
3	46338289	.	G	A	1	4	5	0	2	7	0	0
3	46353405	.	C	A	5	2	7	0	0	7	0	0
3	46353747	.	C	A	4	6	10	0	0	10	0	0
3	46353917	.	C	T	5	3	8	0	0	8	0	0
3	46354031	.	C	T	6	6	12	0	1	13	0	0
3	46354217	.	A	G	4	4	8	0	0	8	0	0
3	46354230	.	G	A	5	4	9	0	0	9	0	0
3	46358537	.	A	G	5	1	6	0	11	17	0	0
3	46361536	.	C	A	4	4	8	0	0	8	0	0
3	46362514	.	C	T	6	7	13	0	1	14	0	0
3	46362640	.	C	T	2	9	11	0	1	12	0	0
3	46362753	.	C	A	4	3	7	0	2	9	0	0
3	46362830	.	G	A	0	2	2	0	6	8	0	0
3	46362844	.	C	G	1	0	1	0	3	4	0	0
3	46362895	.	T	C	2	2	4	0	0	4	0	0
3	46363103	.	G	A	4	3	7	0	0	7	0	0
3	46363127	.	G	A	1	3	4	0	3	7	0	0
3	46363569	.	G	A	1	3	4	0	0	4	0	0
3	46363666	.	A	G	2	0	2	0	5	7	0	0
3	46364162	.	T	A	3	3	6	0	1	7	0	0
3	46364583	.	T	C	4	5	9	0	0	9	0	0
3	46364788	.	T	A	1	2	3	0	0	3	0	0
3	46364840	.	G	T	4	3	7	0	1	8	0	0
3	46364847	.	T	G	2	0	2	0	6	8	0	0
3	46365323	.	G	A	0	2	2	0	2	4	0	0
3	46365432	.	T	C	2	4	6	0	0	6	0	0
3	46377497	.	A	T	3	6	9	0	0	9	0	0
3	46377528	.	C	A	4	6	10	0	0	10	0	0
3	46379849	.	C	G	3	2	5	0	0	5	0	0
3	46380144	.	A	C	3	5	8	0	0	8	0	0
3	46380189	.	A	G	11	9	20	0	0	20	0	0
3	46380194	.	T	A	11	9	20	0	1	21	0	0
3	46388058	.	C	T	11	13	24	0	0	24	0	0
3	46388285	.	G	A	17	8	25	1	2	28	0	0
3	46388439	.	A	T	10	7	17	0	0	17	0	0
3	46388487	.	A	C	12	9	21	0	0	21	0	0
3	46388490	.	T	A	12	9	21	0	0	21	0	0
3	46388636	.	T	C	5	2	7	0	0	7	0	0
3	46388711	.	C	T	8	9	17	0	0	17	0	0
3	46388714	.	G	A	9	9	18	0	0	18	0	0
3	46388854	.	T	C	18	7	25	0	1	26	0	0
3	46388905	.	G	A	14	11	25	0	0	25	0	0
3	46388954	.	A	C	13	12	25	0	1	26	0	0
3	46388968	.	G	C	9	13	22	0	1	23	0	0
3	46389009	.	C	T	18	16	34	0	2	36	0	0
3	46391844	.	C	T	0	10	10	0	16	26	0	0
3	46398380	.	G	A	14	12	26	0	1	27	0	0
3	46403743	.	C	T	1	9	10	0	22	32	0	0
3	46410288	.	T	C	15	15	30	0	1	31	0	0
3	46459939	.	G	A	0	2	2	0	4	6	0	0
3	46463156	.	C	T	3	5	8	0	1	9	0	0
3	46463213	.	A	C	5	5	10	0	1	11	0	0
3	46463240	.	C	T	4	4	8	0	1	9	0	0
3	46473247	.	G	C	1	6	7	0	2	9	0	0
3	46479971	.	G	A	2	2	4	0	0	4	0	0
3	46502666	.	T	C	4	2	6	0	0	6	0	0
3	46502744	.	C	T	1	3	4	0	0	4	0	0
3	46502745	.	T	C	1	3	4	0	0	4	0	0
3	46505569	.	A	T	3	2	5	0	0	5	0	0
3	46505751	.	T	C	4	2	6	0	0	6	0	0
3	46512104	.	T	A	1	3	4	0	0	4	0	0
3	46512161	.	T	A	4	3	7	0	1	8	0	0
3	46512175	.	G	C	4	3	7	0	0	7	0	0
3	46524720	.	A	G	3	2	5	0	0	5	0	0
3	46528835	.	G	A	2	3	5	0	0	5	0	0
3	46528871	.	T	C	2	2	4	0	0	4	0	0
3	46543928	.	G	T	3	4	7	0	0	7	0	0
3	46550242	.	T	C	5	7	12	0	0	12	0	0
3	46550909	.	T	A	1	2	3	0	1	4	0	0
3	46551189	.	G	A	2	3	5	0	0	5	0	0
3	46551285	.	T	A	5	5	10	0	0	10	0	0
3	46552832	.	A	C	6	3	9	0	0	9	0	0
3	46552993	.	A	G	2	4	6	0	0	6	0	0
3	46553206	.	T	G	3	3	6	0	0	6	0	0
3	46553234	.	G	C	2	2	4	0	0	4	0	0
3	46553399	.	T	G	1	2	3	0	0	3	0	0
3	46553534	.	C	T	9	7	16	0	2	18	0	0
3	46553540	.	C	A	8	7	15	0	3	18	0	0
3	46553850	.	A	C	5	5	10	2	0	12	0	0
3	46553893	.	T	C	6	7	13	0	1	14	0	0
3	46553986	.	A	T	8	9	17	0	1	18	0	0
3	46554085	.	G	T	3	6	9	0	0	9	0	0
3	46554177	.	C	A	8	4	12	0	0	12	0	0
3	46554181	.	C	A	4	7	11	0	0	11	0	0
3	46554259	.	G	A	6	4	10	0	0	10	0	0
3	46554307	.	T	A	2	2	4	0	0	4	0	0
3	46554348	.	G	A	3	2	5	0	0	5	0	0
3	46554360	.	C	G	3	6	9	0	0	9	0	0
3	46554458	.	G	T	2	4	6	0	1	7	0	0
3	46554564	.	A	G	9	5	14	0	0	14	0	0
3	46554648	.	T	A	6	6	12	3	0	15	0	0
3	46554711	.	G	A	5	9	14	0	1	15	0	0
3	46586065	.	C	G	1	2	3	0	0	3	0	0
3	46749479	.	A	G	9	15	24	0	0	24	0	0
3	46750272	.	C	T	13	11	24	0	2	26	0	0
3	46750752	.	G	A	12	11	23	0	0	23	0	0
3	46750996	.	C	T	8	11	19	0	0	19	0	0
3	46751630	.	G	A	8	7	15	0	0	15	0	0
3	46752486	.	A	C	9	9	18	0	0	18	0	0
3	46752522	.	T	G	2	5	7	0	0	7	0	0
3	46752859	.	T	A	5	4	9	0	0	9	0	0
3	46753340	.	T	G	8	0	8	0	2	12	2	0
3	46753613	.	T	C	7	4	11	0	0	11	0	0
3	46753619	.	G	A	7	4	11	0	0	11	0	0
3	46753742	.	A	G	13	0	13	0	17	30	0	0
3	46754078	.	T	A	31	15	46	0	0	46	0	0
3	46754296	.	A	T	6	7	13	0	1	14	0	0
3	46764069	.	G	T	1	2	3	0	4	7	0	0
3	46764485	.	A	T	11	14	25	0	1	26	0	0
3	46764572	.	A	T	8	5	13	0	4	17	0	0
3	46767646	.	T	C	11	7	18	0	1	19	0	0
3	46778789	.	G	T	8	16	24	0	2	26	0	0
3	46800490	.	A	T	35	31	66	0	2	68	0	0
3	46800692	.	G	A	21	31	52	0	5	57	0	0
3	46800940	.	C	T	37	26	63	2	0	65	0	0
3	46800946	.	T	G	36	26	62	2	3	67	0	0
3	46802227	.	T	C	31	1	32	0	18	50	0	0
3	46802864	.	G	A	8	5	13	0	2	15	0	0
3	46919523	.	C	T	2	3	5	0	0	5	0	0
3	46923471	.	T	C	6	2	8	0	0	8	0	0
3	46923509	.	G	A	7	4	11	0	0	11	0	0
3	46925154	.	G	A	5	5	10	0	1	11	0	0
3	46925227	.	A	G	3	3	6	0	0	6	0	0
3	46926885	.	A	C	4	3	7	0	1	8	0	0
3	46928958	.	A	G	3	4	7	0	0	7	0	0
3	46928982	.	G	T	3	4	7	0	0	7	0	0
3	46932545	.	A	G	1	3	4	0	0	4	0	0
3	46932602	.	C	A	0	3	3	0	3	6	0	0
3	46942272	.	A	G	7	4	11	0	0	11	0	0
3	46942335	.	C	G	5	3	8	0	0	8	0	0
3	47000841	.	T	A	1	3	4	0	1	5	0	0
3	47000852	.	A	G	2	2	4	0	0	4	0	0
3	47010631	.	A	G	2	2	4	0	0	4	0	0
3	47114407	.	T	A	1	2	3	0	0	3	0	0
3	47114558	.	G	A	3	4	7	0	0	7	0	0
3	47114573	.	A	G	5	5	10	0	0	10	0	0
3	47114734	.	A	G	4	3	7	0	1	8	0	0
3	47114746	.	G	A	5	5	10	0	0	10	0	0
3	47119662	.	T	A	1	4	5	0	0	6	1	0
3	47119900	.	G	A	4	6	10	0	0	10	0	0
3	47125693	.	G	A	5	3	8	0	0	8	0	0
3	47125771	.	T	C	4	3	7	0	1	8	0	0
3	47128073	.	A	G	1	2	3	0	0	3	0	0
3	47131249	.	C	T	3	1	4	0	1	5	0	0
3	47164655	.	G	A	0	3	3	0	1	4	0	0
3	47164661	.	A	G	1	4	5	0	0	5	0	0
3	47167516	.	C	T	5	2	7	0	1	8	0	0
3	47167574	.	C	A	2	2	4	0	0	4	0	0
3	47173202	.	C	T	2	2	4	1	1	6	0	0
3	47173208	.	C	T	3	2	5	1	1	7	0	0
3	47198805	.	G	A	1	4	5	0	0	5	0	0
3	47201409	.	C	T	3	5	8	0	1	9	0	0
3	47201440	.	A	G	4	6	10	0	0	10	0	0
3	47201479	.	T	C	5	5	10	0	1	11	0	0
3	47201482	.	T	C	6	4	10	0	0	10	0	0
3	47201518	.	C	T	7	4	11	0	0	11	0	0
3	47205408	.	C	T	8	8	16	0	0	16	0	0
3	47205417	.	A	G	8	0	8	0	11	19	0	0
3	47205507	.	G	A	8	9	17	0	0	17	0	0
3	47205534	.	A	G	12	0	12	0	11	23	0	0
3	47205543	.	C	T	8	14	22	0	0	22	0	0
3	47205585	.	A	T	13	9	22	0	1	23	0	0
3	47205597	.	C	T	10	12	22	0	0	22	0	0
3	47209433	.	T	C	14	5	19	0	0	19	0	0
3	47209445	.	A	T	10	5	15	0	4	19	0	0
3	47212662	.	A	G	2	4	6	0	0	6	0	0
3	47212774	.	T	C	4	2	6	0	0	6	0	0
3	47212790	.	A	G	3	0	3	0	3	6	0	0
3	47212896	.	A	T	2	4	6	0	2	8	0	0
3	47212914	.	T	C	3	5	8	0	0	8	0	0
3	47213009	.	A	T	3	5	8	0	0	8	0	0
3	47213025	.	G	T	4	4	8	0	0	8	0	0
3	47213046	.	G	A	4	5	9	0	0	9	0	0
3	47213067	.	C	G	6	4	10	0	0	11	1	0
3	47322641	.	G	A	1	2	3	0	3	6	0	0
3	47322646	.	T	C	5	1	6	0	1	7	0	0
3	47376649	.	A	G	4	2	6	0	0	6	0	0
3	47376778	.	C	T	3	2	5	0	0	5	0	0
3	47376818	.	C	T	3	2	5	0	0	5	0	0
3	47376878	.	C	T	3	2	5	0	0	5	0	0
3	47384568	.	C	T	5	4	9	0	0	9	0	0
3	47384653	.	T	C	6	3	9	0	0	9	0	0
3	47498493	.	C	T	0	1	1	0	2	3	0	0
3	47498565	.	A	T	5	4	9	0	2	11	0	0
3	47498625	.	C	A	7	5	12	0	0	12	0	0
3	47498633	.	G	A	7	4	11	0	0	11	0	0
3	47498937	.	G	C	7	4	11	0	0	11	0	0
3	47498981	.	T	G	3	4	7	0	1	8	0	0
3	47498985	.	C	T	4	3	7	0	0	7	0	0
3	47499042	.	A	G	2	2	4	0	0	4	0	0
3	47526005	.	A	G	3	3	6	0	0	6	0	0
3	47526262	.	C	T	6	10	16	0	1	17	0	0
3	47526271	.	G	A	7	11	18	0	0	18	0	0
3	47529406	.	G	A	3	4	7	0	0	7	0	0
3	47529469	.	T	G	1	4	5	0	0	5	0	0
3	47537356	.	A	G	2	2	4	0	0	4	0	0
3	47548175	.	G	A	3	2	5	0	0	5	0	0
3	47548208	.	T	G	3	2	5	0	0	5	0	0
3	47548264	.	A	G	1	3	4	0	0	4	0	0
3	47550275	.	C	T	0	3	3	0	4	7	0	0
3	47550282	.	G	A	5	3	8	0	1	9	0	0
3	47554609	.	A	C	7	3	10	0	1	11	0	0
3	47554651	.	T	C	6	3	9	0	0	9	0	0
3	47557276	.	A	G	4	5	9	0	1	10	0	0
3	47571417	.	C	A	2	3	5	0	0	5	0	0
3	47572406	.	G	A	4	2	6	0	0	6	0	0
3	47572433	.	G	A	4	2	6	0	0	6	0	0
3	47572451	.	G	A	3	2	5	0	0	5	0	0
3	47573343	.	C	T	0	3	3	0	3	6	0	0
3	47645203	.	A	T	1	3	4	0	0	4	0	0
3	47645251	.	C	G	3	2	5	0	0	5	0	0
3	47694756	.	G	A	1	2	3	0	3	6	0	0
3	47875576	.	A	T	3	4	7	0	0	7	0	0
3	48226259	.	G	A	3	4	7	0	0	7	0	0
3	48229390	.	A	G	3	0	3	0	5	8	0	0
3	48229423	.	C	T	3	5	8	0	0	8	0	0
3	48229507	.	A	G	6	4	10	0	1	11	0	0
3	48229654	.	C	T	1	7	8	0	0	8	0	0
3	48241645	.	G	T	4	6	10	0	0	10	0	0
3	48241805	.	C	T	4	2	6	0	0	6	0	0
3	48245071	.	C	A	5	3	8	0	0	8	0	0
3	48247601	.	A	G	6	6	12	0	3	15	0	0
3	48253319	.	G	A	4	4	8	0	0	8	0	0
3	48253649	.	A	G	5	4	9	0	0	9	0	0
3	48253673	.	C	T	7	3	10	0	0	10	0	0
3	48253733	.	T	G	4	4	8	0	1	9	0	0
3	48253881	.	C	T	4	4	8	0	0	8	0	0
3	48278752	.	C	T	6	9	15	0	0	15	0	0
3	48283580	.	G	A	8	4	12	0	0	12	0	0
3	48283768	.	C	A	7	6	13	0	0	13	0	0
3	48286490	.	C	T	4	6	10	0	0	10	0	0
3	48301180	.	A	G	8	4	12	0	1	13	0	0
3	48305837	.	C	G	13	7	20	0	0	20	0	0
3	48305841	.	G	A	3	13	16	0	8	24	0	0
3	48305898	.	C	G	12	13	25	0	3	28	0	0
3	48305908	.	C	A	14	9	23	0	0	23	0	0
3	48320968	.	A	G	7	6	13	0	0	13	0	0
3	48326568	.	G	A	6	6	12	0	0	12	0	0
3	48326631	.	C	T	5	10	15	0	0	15	0	0
3	48326725	.	A	C	8	8	16	0	0	16	0	0
3	48327002	.	G	A	5	9	14	0	0	14	0	0
3	48473565	.	A	G	6	3	9	0	0	9	0	0
3	48473641	.	A	G	3	4	7	0	0	7	0	0
3	48479982	.	C	T	3	4	7	0	0	7	0	0
3	48480156	.	T	G	6	5	11	0	2	13	0	0
3	48480333	.	T	C	5	3	8	0	1	9	0	0
3	48486609	.	C	T	4	6	10	0	2	12	0	0
3	48488909	.	G	T	11	7	18	0	0	18	0	0
3	48488993	.	T	C	8	6	14	0	1	15	0	0
3	48489101	.	C	G	5	1	6	0	7	13	0	0
3	48489154	.	A	G	5	0	5	1	6	12	0	0
3	48550676	.	G	A	20	18	38	0	0	38	0	0
3	48557707	.	T	C	31	1	32	0	27	59	0	0
3	48584800	.	A	T	8	12	20	0	0	20	0	0
3	48585222	.	C	T	2	15	17	0	9	26	0	0
3	48585236	.	C	A	17	10	27	0	0	27	0	0
3	48585271	.	A	C	12	14	26	0	2	28	0	0
3	48585331	.	A	G	30	6	36	1	1	38	0	0
3	48585377	.	G	T	19	9	28	0	2	30	0	0
3	48585411	.	G	T	15	12	27	0	1	28	0	0
3	48586985	.	A	G	12	16	28	0	1	29	0	0
3	48587176	.	C	A	19	17	36	0	1	37	0	0
3	48587191	.	C	T	22	11	33	0	2	35	0	0
3	48588830	.	A	G	10	21	31	0	2	33	0	0
3	48588884	.	A	G	15	10	25	0	1	26	0	0
3	48589156	.	A	G	13	12	25	0	1	26	0	0
3	48591769	.	A	G	15	13	28	0	1	29	0	0
3	48591825	.	G	T	11	15	26	0	0	26	0	0
3	48593781	.	T	C	18	18	36	0	0	36	0	0
3	48593811	.	G	A	10	23	33	0	0	33	0	0
3	48594098	.	T	C	12	1	13	0	15	28	0	0
3	48596834	.	T	C	11	10	21	0	1	22	0	0
3	48612027	.	T	C	8	0	8	0	19	27	0	0
3	48612038	.	A	G	7	13	20	0	0	20	0	0
3	48638932	.	C	T	4	5	9	0	0	9	0	0
3	48645801	.	G	T	13	8	21	0	0	21	0	0
3	48645863	.	A	C	9	8	17	0	0	17	0	0
3	48661465	.	C	A	0	6	6	0	13	19	0	0
3	48661500	.	A	G	9	7	16	0	2	18	0	0
3	48661700	.	G	A	10	3	13	0	2	15	0	0
3	48665796	.	C	G	2	6	8	0	12	20	0	0
3	48665832	.	T	A	15	8	23	0	1	24	0	0
3	48665841	.	T	G	14	7	21	0	1	22	0	0
3	48686990	.	G	A	8	10	18	0	1	19	0	0
3	48687134	.	C	T	1	10	11	0	8	20	1	0
3	48691411	.	A	G	9	9	18	0	0	18	0	0
3	48700453	.	G	A	5	6	11	0	0	11	0	0
3	48713618	.	G	A	4	4	8	0	0	8	0	0
3	49130387	.	A	C	9	0	9	0	10	19	0	0
3	49130480	.	G	A	11	7	18	0	1	19	0	0
3	49134236	.	A	C	7	10	17	0	0	17	0	0
3	49134373	.	A	G	12	6	18	0	0	18	0	0
3	49137821	.	C	A	0	6	6	0	11	17	0	0
3	49154025	.	G	A	3	5	8	0	1	9	0	0
3	49154124	.	C	A	4	10	14	0	0	14	0	0
3	49163407	.	G	T	5	4	9	0	0	9	0	0
3	49163417	.	C	T	5	4	9	0	0	9	0	0
3	49163528	.	G	T	6	8	14	0	1	15	0	0
3	49163558	.	T	C	5	9	14	0	0	14	0	0
3	49426063	.	G	A	10	9	19	0	1	20	0	0
3	49426184	.	G	A	11	7	18	0	0	18	0	0
3	49439450	.	G	T	9	10	19	2	0	22	1	0
3	49439587	.	A	G	14	10	24	2	1	27	0	0
3	49440129	.	G	T	8	3	11	0	1	12	0	0
3	49447514	.	C	A	0	15	15	0	8	23	0	0
3	49478380	.	T	C	13	5	18	0	2	20	0	0
3	49503880	.	A	G	21	25	46	0	0	46	0	0
3	49559444	.	C	T	19	34	53	0	2	55	0	0
3	49559523	.	C	T	39	35	74	0	2	76	0	0
3	49559527	.	G	T	38	32	70	0	3	73	0	0
3	49559637	.	G	T	40	33	73	0	9	83	1	0
3	49559703	.	G	A	42	35	77	0	1	78	0	0
3	49559904	.	G	A	35	32	67	0	5	72	0	0
3	49559979	.	A	G	39	31	70	0	2	72	0	0
3	49559988	.	T	A	38	29	67	0	2	70	1	0
3	49560084	.	A	G	36	34	70	0	1	71	0	0
3	49560204	.	G	C	33	38	71	0	2	73	0	0
3	49560276	.	T	G	25	44	69	0	2	71	0	0
3	49560420	.	C	T	29	33	62	0	5	67	0	0
3	49560507	.	G	A	26	37	63	0	3	66	0	0
3	49758151	.	A	T	0	2	2	0	0	2	0	0
3	49758152	.	A	C	1	2	3	0	0	3	0	0
3	49758207	.	A	T	2	2	4	0	0	4	0	0
3	49758790	.	C	A	3	2	5	0	0	5	0	0
3	49758799	.	A	G	2	2	4	0	0	4	0	0
3	49759897	.	T	A	1	3	4	0	0	4	0	0
3	49759921	.	C	A	0	3	3	0	1	4	0	0
3	49759974	.	A	G	1	2	3	0	0	3	0	0
3	49760049	.	T	C	4	3	7	0	0	7	0	0
3	49760104	.	C	A	2	2	4	0	0	4	0	0
3	49760116	.	A	G	1	2	3	0	1	4	0	0
3	49760147	.	C	T	1	3	4	0	0	4	0	0
3	49760173	.	T	C	1	0	1	0	5	6	0	0
3	49760465	.	A	G	1	3	4	0	0	4	0	0
3	49760488	.	A	G	1	3	4	0	0	4	0	0
3	50054508	.	G	A	7	3	10	0	0	10	0	0
3	50054578	.	C	G	1	6	7	0	0	7	0	0
3	50054619	.	A	T	6	5	11	0	0	11	0	0
3	50054766	.	G	A	3	17	20	0	0	20	0	0
3	50059143	.	A	T	14	17	31	0	1	32	0	0
3	50063458	.	C	T	11	10	21	0	0	21	0	0
3	50063491	.	C	T	0	14	14	0	14	28	0	0
3	50066373	.	A	G	10	21	31	0	5	36	0	0
3	50066402	.	G	A	20	23	43	0	2	45	0	0
3	50077311	.	A	G	16	22	38	0	0	38	0	0
3	50077364	.	T	A	17	15	32	5	5	42	0	0
3	50077371	.	G	A	16	18	34	6	0	40	0	0
3	50077428	.	G	C	16	24	40	1	1	42	0	0
3	50081696	.	G	A	24	21	45	0	1	46	0	0
3	50083980	.	C	A	25	20	45	0	1	46	0	0
3	50084011	.	A	G	23	16	39	0	6	45	0	0
3	50087361	.	C	A	1	23	24	0	22	46	0	0
3	50087370	.	G	A	23	23	46	0	1	47	0	0
3	50087433	.	C	A	0	19	19	0	17	36	0	0
3	50089113	.	G	A	12	14	26	0	0	26	0	0
3	50089470	.	T	C	13	20	33	0	1	34	0	0
3	50091985	.	A	G	17	16	33	0	1	34	0	0
3	50092630	.	T	G	19	22	41	0	0	41	0	0
3	50092633	.	A	G	18	22	40	0	2	42	0	0
3	50095869	.	A	T	16	7	23	0	1	24	0	0
3	50095929	.	C	T	1	11	12	0	17	29	0	0
3	50099806	.	G	A	12	15	27	0	0	27	0	0
3	50104084	.	C	T	9	13	22	0	0	22	0	0
3	50110202	.	T	C	7	0	7	0	17	24	0	0
3	50110205	.	C	A	11	11	22	0	1	23	0	0
3	50110369	.	T	C	12	7	19	0	0	19	0	0
3	50110399	.	A	G	12	11	23	0	0	23	0	0
3	50123650	.	C	A	1	8	9	0	20	29	0	0
3	50123709	.	A	G	21	18	39	0	0	39	0	0
3	50123758	.	A	G	21	25	46	0	2	48	0	0
3	50123760	.	C	A	25	20	45	0	3	48	0	0
3	50123936	.	G	A	22	27	49	0	3	52	0	0
3	50124107	.	A	G	19	15	34	0	1	35	0	0
3	50124108	.	C	G	21	15	36	0	0	36	0	0
3	50127196	.	G	A	4	7	11	0	0	11	0	0
3	50155293	.	G	A	2	3	5	0	0	5	0	0
3	50155405	.	T	A	3	4	7	0	0	7	0	0
3	50155406	.	A	T	3	4	7	0	0	7	0	0
3	50155592	.	C	T	5	3	8	0	1	9	0	0
3	50155593	.	T	C	5	3	8	0	1	9	0	0
3	50156200	.	A	G	2	2	4	0	0	4	0	0
3	50159356	.	C	G	0	0	0	0	5	5	0	0
3	50159431	.	C	T	1	4	5	0	1	6	0	0
3	50166550	.	T	C	6	5	11	0	0	11	0	0
3	50170236	.	A	G	5	1	6	0	3	9	0	0
3	50170338	.	T	A	4	9	13	0	0	13	0	0
3	50170354	.	C	T	5	8	13	0	1	14	0	0
3	50171713	.	A	G	2	8	10	0	0	10	0	0
3	50172725	.	G	C	6	6	12	0	1	13	0	0
3	50172735	.	T	A	7	4	11	0	0	11	0	0
3	50172788	.	C	T	4	3	7	0	0	7	0	0
3	50175940	.	G	T	3	4	7	0	0	7	0	0
3	50176620	.	G	T	11	9	20	0	0	20	0	0
3	50253969	.	G	A	6	6	12	0	2	14	0	0
3	50256147	.	G	A	2	5	7	0	0	7	0	0
3	50256938	.	A	C	13	9	22	0	2	24	0	0
3	50265852	.	C	T	8	12	20	1	0	21	0	0
3	50265903	.	A	C	13	9	22	0	1	23	0	0
3	50265906	.	T	C	15	10	25	0	0	25	0	0
3	50265994	.	C	T	3	9	12	0	0	12	0	0
3	50266043	.	C	A	4	10	14	0	0	14	0	0
3	50266063	.	A	G	5	10	15	0	0	15	0	0
3	50266198	.	T	C	1	4	5	0	0	5	0	0
3	50266330	.	T	A	6	5	11	0	1	12	0	0
3	50266384	.	A	G	2	8	10	0	0	10	0	0
3	50266394	.	T	A	2	9	11	0	0	11	0	0
3	50266624	.	C	A	1	3	4	0	0	4	0	0
3	50267171	.	T	G	4	3	7	0	0	7	0	0
3	50267460	.	G	A	6	8	14	0	0	14	0	0
3	50267471	.	A	T	5	6	11	0	0	11	0	0
3	50267686	.	T	C	2	13	15	0	0	15	0	0
3	50267860	.	A	T	7	8	15	0	2	17	0	0
3	50267981	.	G	C	4	11	15	0	0	15	0	0
3	50267992	.	T	A	8	7	15	0	1	16	0	0
3	50268016	.	T	C	9	8	17	0	1	18	0	0
3	50268052	.	A	T	9	7	16	0	0	16	0	0
3	50268073	.	A	G	8	6	14	0	0	14	0	0
3	50268106	.	G	T	6	3	9	0	1	10	0	0
3	50268220	.	C	T	2	7	9	0	1	10	0	0
3	50268535	.	A	C	12	6	18	0	1	19	0	0
3	50268715	.	C	T	7	10	17	0	0	17	0	0
3	50268744	.	G	A	9	10	19	0	1	20	0	0
3	50272273	.	G	A	6	6	12	0	1	13	0	0
3	50272435	.	T	G	10	6	16	0	0	16	0	0
3	50272438	.	T	G	8	6	14	0	1	15	0	0
3	50273026	.	G	A	4	10	14	0	0	14	0	0
3	50273031	.	C	T	4	9	13	0	0	13	0	0
3	50273469	.	C	T	2	2	4	0	5	9	0	0
3	50276336	.	A	T	5	5	10	0	1	11	0	0
3	50277660	.	C	T	1	4	5	0	0	5	0	0
3	50365808	.	C	A	4	15	19	0	0	19	0	0
3	50366189	.	G	A	14	7	21	0	0	21	0	0
3	50418826	.	G	C	14	16	30	0	2	32	0	0
3	50419046	.	C	T	6	10	16	0	1	17	0	0
3	50419155	.	C	T	6	7	13	0	0	13	0	0
3	50419329	.	G	A	4	2	6	0	1	7	0	0
3	50419344	.	T	A	3	4	7	0	0	7	0	0
3	50419626	.	A	T	1	2	3	0	0	3	0	0
3	50419686	.	A	T	11	3	14	0	0	14	0	0
3	50419722	.	G	C	11	5	16	0	0	16	0	0
3	50419723	.	C	A	11	5	16	0	0	16	0	0
3	50419759	.	C	T	7	7	14	0	1	15	0	0
3	50419791	.	T	C	10	6	16	0	1	17	0	0
3	50419803	.	C	A	7	11	18	0	0	18	0	0
3	50419827	.	T	C	10	9	19	0	1	20	0	0
3	50419866	.	T	A	10	5	15	0	0	17	2	0
3	50419867	.	A	C	7	11	18	0	0	18	0	0
3	50420001	.	A	C	3	6	9	0	0	9	0	0
3	50420087	.	A	G	9	8	17	0	0	17	0	0
3	50420139	.	A	T	15	6	21	0	2	23	0	0
3	50420152	.	G	T	5	19	24	0	1	25	0	0
3	50861448	.	G	T	1	1	2	0	1	3	0	0
3	50861538	.	A	G	1	1	2	0	1	3	0	0
3	50951272	.	C	T	4	6	10	0	0	10	0	0
3	50951299	.	C	A	4	9	13	0	0	13	0	0
3	50951644	.	C	G	10	5	15	0	1	16	0	0
3	50951770	.	T	G	9	8	17	0	0	17	0	0
3	50951862	.	A	G	7	6	13	0	0	13	0	0
3	50952021	.	T	C	3	4	7	0	0	7	0	0
3	50952163	.	G	A	10	6	16	0	1	17	0	0
3	50952404	.	G	T	1	3	4	0	0	4	0	0
3	50998386	.	T	C	5	2	7	0	0	7	0	0
3	51034995	.	G	T	7	12	19	0	1	20	0	0
3	51039012	.	C	T	0	6	6	0	7	13	0	0
3	51043176	.	G	A	5	5	10	0	0	10	0	0
3	51043715	.	A	T	1	4	5	0	0	5	0	0
3	51043916	.	G	A	6	6	12	0	0	12	0	0
3	51043976	.	G	A	12	6	18	0	0	18	0	0
3	51043994	.	G	A	9	4	13	0	0	13	0	0
3	51046799	.	A	G	5	8	13	0	0	13	0	0
3	51046805	.	A	G	4	7	11	0	1	12	0	0
3	51056311	.	C	G	7	5	12	0	0	12	0	0
3	51056350	.	A	G	8	5	13	0	0	13	0	0
3	51056368	.	T	A	4	6	10	0	3	13	0	0
3	51056559	.	G	A	4	4	8	0	0	8	0	0
3	51058962	.	T	C	6	2	8	0	0	8	0	0
3	51060341	.	G	A	5	2	7	0	0	7	0	0
3	51065588	.	T	C	1	0	1	0	4	5	0	0
3	51065802	.	A	G	3	2	5	0	0	5	0	0
3	51066110	.	C	T	0	3	3	0	3	6	0	0
3	51066925	.	C	T	0	7	7	0	5	12	0	0
3	51071651	.	G	T	2	2	4	0	0	4	0	0
3	51071888	.	G	A	1	5	6	0	0	6	0	0
3	51074564	.	A	G	4	9	13	0	0	13	0	0
3	51074579	.	T	A	6	10	16	0	0	16	0	0
3	51074618	.	C	T	0	6	6	0	6	12	0	0
3	51074648	.	C	G	3	3	6	0	0	6	0	0
3	51077458	.	G	A	1	4	5	0	0	5	0	0
3	51096235	.	C	T	3	2	5	0	0	5	0	0
3	51096247	.	A	G	3	3	6	0	0	6	0	0
3	51099056	.	C	T	1	2	3	0	0	3	0	0
3	51109189	.	G	A	1	3	4	0	0	4	0	0
3	51115354	.	C	T	3	3	6	0	1	7	0	0
3	51115363	.	C	A	2	2	4	0	2	6	0	0
3	51131469	.	T	C	4	0	4	0	5	9	0	0
3	51139108	.	G	A	1	2	3	0	1	4	0	0
3	51563736	.	G	A	1	8	9	0	5	14	0	0
3	51563824	.	T	C	6	3	9	0	0	9	0	0
3	51563874	.	G	C	5	4	9	0	0	9	0	0
3	51563876	.	T	G	4	4	8	0	1	9	0	0
3	51563911	.	T	C	3	4	7	0	0	7	0	0
3	51619762	.	C	T	6	2	8	0	0	8	0	0
3	51619789	.	A	C	5	3	8	0	0	8	0	0
3	51619801	.	T	A	3	3	6	0	0	6	0	0
3	51619846	.	T	C	4	7	11	0	0	11	0	0
3	51642491	.	G	A	7	7	14	0	3	17	0	0
3	51642536	.	A	C	6	8	14	0	1	15	0	0
3	51642720	.	C	T	5	3	8	0	0	8	0	0
3	51645783	.	C	T	6	5	11	0	1	12	0	0
3	51653411	.	G	A	11	6	17	0	1	18	0	0
3	51653435	.	C	T	11	8	19	0	0	19	0	0
3	51656720	.	G	A	11	6	17	0	0	17	0	0
3	51656726	.	C	A	12	5	17	0	0	17	0	0
3	51656762	.	G	A	6	5	11	0	0	11	0	0
3	51656849	.	T	A	6	9	15	0	0	15	0	0
3	51656921	.	T	C	11	4	15	0	1	16	0	0
3	51656931	.	G	A	10	4	14	0	1	15	0	0
3	51656973	.	C	A	11	11	22	0	0	22	0	0
3	51657033	.	T	A	8	7	15	0	0	15	0	0
3	51657082	.	C	T	4	8	12	0	1	13	0	0
3	51657158	.	A	G	9	0	9	0	7	16	0	0
3	51657291	.	G	A	13	6	19	0	0	19	0	0
3	51657314	.	G	A	9	4	13	0	1	14	0	0
3	51657339	.	C	T	5	4	9	0	0	9	0	0
3	51657382	.	G	C	3	6	9	1	2	12	0	0
3	51657439	.	A	G	6	5	11	0	0	11	0	0
3	51657456	.	C	T	8	6	14	0	0	14	0	0
3	51742263	.	G	A	11	12	23	0	0	23	0	0
3	51808378	.	C	T	12	6	18	0	1	19	0	0
3	51813083	.	G	A	13	12	25	0	0	25	0	0
3	51834434	.	C	T	11	18	29	0	0	29	0	0
3	51861767	.	G	A	8	9	17	0	0	17	0	0
3	51871663	.	A	T	12	13	25	0	1	26	0	0
3	51871671	.	C	T	12	12	24	0	0	24	0	0
3	51871704	.	G	C	12	13	25	0	0	26	1	0
3	51871788	.	G	A	10	16	26	0	1	27	0	0
3	51874119	.	C	A	17	11	28	0	0	28	0	0
3	51874163	.	G	A	14	9	23	0	0	23	0	0
3	51874274	.	G	A	13	13	26	0	2	28	0	0
3	51879297	.	G	T	13	15	28	0	0	28	0	0
3	51891785	.	A	G	10	0	10	0	10	20	0	0
3	51891787	.	C	T	11	8	19	0	1	20	0	0
3	51892095	.	T	A	6	2	8	0	0	8	0	0
3	51892106	.	A	G	5	3	8	0	0	8	0	0
3	51892136	.	A	T	3	4	7	0	0	7	0	0
3	51892162	.	A	G	5	3	8	0	0	8	0	0
3	51892176	.	T	A	5	6	11	0	0	11	0	0
3	51892212	.	A	G	7	6	13	0	1	14	0	0
3	51892225	.	T	A	6	8	14	0	0	14	0	0
3	51892502	.	G	A	6	4	10	0	0	10	0	0
3	51899772	.	T	A	7	12	19	1	1	21	0	0
3	51899802	.	C	T	3	10	13	0	8	21	0	0
3	51899872	.	C	T	3	5	8	0	13	21	0	0
3	51900357	.	C	A	8	17	25	0	0	25	0	0
3	51900400	.	A	G	16	5	21	0	0	21	0	0
3	51900415	.	T	C	13	12	25	0	0	25	0	0
3	51900487	.	A	C	11	22	33	0	3	36	0	0
3	51900552	.	A	G	4	17	21	0	2	23	0	0
3	51900587	.	C	T	8	14	22	0	1	23	0	0
3	51900589	.	A	C	9	14	23	0	0	23	0	0
3	51900693	.	C	G	13	19	32	0	0	32	0	0
3	51900702	.	C	A	3	17	20	0	12	32	0	0
3	51900768	.	T	A	11	15	26	0	2	28	0	0
3	51900784	.	T	C	10	0	10	0	15	25	0	0
3	51901018	.	C	T	10	7	17	0	2	19	0	0
3	51901092	.	A	T	20	17	37	0	1	38	0	0
3	51901127	.	A	G	25	16	41	0	2	43	0	0
3	51901178	.	T	A	15	26	41	0	1	42	0	0
3	51901199	.	G	T	15	27	42	0	0	42	0	0
3	51901309	.	G	A	21	20	41	0	0	41	0	0
3	51901344	.	T	C	23	11	34	0	4	38	0	0
3	51901413	.	A	G	21	7	28	0	1	29	0	0
3	51901670	.	C	T	13	17	30	0	1	31	0	0
3	51901799	.	T	C	20	20	40	0	1	41	0	0
3	51901835	.	G	A	19	20	39	0	2	41	0	0
3	51901873	.	A	G	21	18	39	0	0	39	0	0
3	51901885	.	T	C	18	19	37	0	3	40	0	0
3	51902099	.	C	T	19	12	31	0	0	31	0	0
3	51902171	.	T	A	14	6	20	0	0	20	0	0
3	51902454	.	T	A	13	13	26	0	1	27	0	0
3	51902471	.	C	T	12	14	26	0	0	26	0	0
3	51902591	.	T	A	8	15	23	0	0	23	0	0
3	51902695	.	C	T	12	8	20	0	4	24	0	0
3	51902834	.	A	G	25	11	36	0	1	37	0	0
3	51902883	.	G	A	19	18	37	0	3	40	0	0
3	51902987	.	A	G	9	12	21	0	0	21	0	0
3	51903048	.	A	C	13	13	26	0	0	26	0	0
3	51903080	.	A	G	11	13	24	0	0	24	0	0
3	51903168	.	C	T	4	18	22	0	1	23	0	0
3	51903198	.	A	C	7	1	8	0	21	29	0	0
3	51903211	.	T	G	14	18	32	0	1	33	0	0
3	51903233	.	A	G	16	18	34	0	2	36	0	0
3	51903286	.	G	T	14	18	32	0	0	32	0	0
3	51903495	.	A	G	10	15	25	0	3	28	0	0
3	51903591	.	C	T	18	14	32	0	0	32	0	0
3	51903605	.	G	A	16	15	31	0	1	32	0	0
3	51903810	.	T	G	8	8	16	0	2	18	0	0
3	51903815	.	T	A	11	10	21	0	0	21	0	0
3	51903979	.	T	C	12	6	18	0	0	18	0	0
3	51904019	.	G	T	19	9	28	0	0	28	0	0
3	51904043	.	G	T	14	12	26	0	2	28	0	0
3	51904226	.	A	G	7	14	21	0	0	21	0	0
3	51904359	.	T	A	15	12	27	0	0	27	0	0
3	51904826	.	G	A	12	15	27	0	1	28	0	0
3	51907077	.	G	T	12	11	23	0	1	24	0	0
3	51907297	.	G	A	16	10	26	0	0	26	0	0
3	51907657	.	A	G	13	7	20	0	0	20	0	0
3	51911718	.	A	C	6	8	14	0	0	14	0	0
3	51911727	.	A	G	7	6	13	0	1	14	0	0
3	52539390	.	G	A	1	2	3	0	0	3	0	0
3	52539423	.	G	A	0	3	3	0	2	5	0	0
3	52558309	.	G	A	2	2	4	0	5	9	0	0
3	52558333	.	A	G	7	4	11	0	0	11	0	0
3	52558558	.	T	A	3	5	8	0	0	8	0	0
3	52563568	.	C	T	3	6	9	0	2	11	0	0
3	52578008	.	C	T	3	4	7	0	0	7	0	0
3	52584332	.	C	T	8	8	16	0	1	17	0	0
3	52588941	.	C	T	8	5	13	0	1	14	0	0
3	52594760	.	G	A	7	6	13	0	2	15	0	0
3	52594966	.	T	C	9	10	19	0	0	19	0	0
3	52603216	.	A	C	9	9	18	0	2	20	0	0
3	52641771	.	C	A	9	3	12	0	0	12	0	0
3	52641819	.	T	C	3	0	3	0	4	7	0	0
3	52641831	.	C	T	0	6	6	0	4	10	0	0
3	52642132	.	T	A	4	8	12	0	0	12	0	0
3	52642488	.	A	G	6	6	12	0	0	12	0	0
3	52642614	.	T	C	9	0	9	0	3	12	0	0
3	52644648	.	G	A	5	2	7	0	1	8	0	0
3	52647283	.	A	G	4	5	9	0	2	11	0	0
3	52647284	.	A	T	4	3	7	0	4	11	0	0
3	52647825	.	G	A	2	3	5	0	1	6	0	0
3	52647870	.	C	T	4	3	7	0	0	7	0	0
3	52648764	.	G	A	8	4	12	0	0	12	0	0
3	52648842	.	T	C	3	2	5	0	0	5	0	0
3	52649217	.	G	A	2	5	7	0	0	7	0	0
3	52660438	.	A	G	2	2	4	0	0	4	0	0
3	52660538	.	A	T	1	3	4	0	0	4	0	0
3	52660909	.	T	C	3	5	8	0	0	8	0	0
3	52660929	.	T	A	2	4	6	0	0	6	0	0
3	52668150	.	C	T	0	2	2	0	4	6	0	0
3	52668542	.	G	A	7	10	17	0	0	17	0	0
3	52668679	.	C	T	1	5	6	0	11	17	0	0
3	52669995	.	G	A	2	6	8	0	0	8	0	0
3	52673834	.	T	A	5	5	10	0	2	12	0	0
3	52673854	.	A	T	4	6	10	0	0	10	0	0
3	52673936	.	G	A	5	5	10	0	0	10	0	0
3	52674017	.	T	A	4	9	13	0	0	13	0	0
3	52674018	.	A	C	10	4	14	0	0	14	0	0
3	52674105	.	A	C	1	2	3	0	0	3	0	0
3	52677087	.	C	T	1	4	5	0	6	11	0	0
3	52679637	.	T	A	3	2	5	0	0	5	0	0
3	52689511	.	C	T	4	6	10	0	0	10	0	0
3	52697304	.	G	C	8	8	16	0	0	16	0	0
3	52697312	.	A	C	6	9	15	0	0	15	0	0
3	52697371	.	T	A	6	11	17	0	0	17	0	0
3	52699405	.	G	A	12	4	16	0	0	16	0	0
3	52699441	.	G	A	10	3	13	0	0	13	0	0
3	52699449	.	G	T	3	3	6	0	7	13	0	0
3	52699775	.	C	T	8	5	13	0	0	13	0	0
3	52699995	.	T	C	12	4	16	0	1	17	0	0
3	52700104	.	C	T	3	3	6	0	0	6	0	0
3	52703102	.	C	T	1	2	3	0	0	3	0	0
3	52875857	.	C	G	2	0	2	0	3	5	0	0
3	52895631	.	G	A	3	11	14	0	0	14	0	0
3	52895667	.	G	A	4	11	15	0	1	16	0	0
3	52895688	.	C	T	4	11	15	0	1	16	0	0
3	52895725	.	C	G	7	4	11	0	0	11	0	0
3	52898520	.	C	T	0	4	4	0	4	8	0	0
3	52899872	.	A	T	3	8	11	0	1	12	0	0
3	52899911	.	A	T	4	3	7	0	0	7	0	0
3	52902240	.	G	A	1	3	4	0	2	6	0	0
3	52902344	.	G	A	1	8	9	0	5	14	0	0
3	52902356	.	T	C	5	6	11	0	2	13	0	0
3	52911245	.	A	G	7	6	13	0	0	13	0	0
3	52913391	.	T	C	6	6	12	0	0	12	0	0
3	52913529	.	A	G	11	4	15	0	1	16	0	0
3	52921735	.	C	T	3	5	8	0	0	8	0	0
3	52921926	.	A	G	2	0	2	0	5	7	0	0
3	52925915	.	G	A	1	5	6	0	7	13	0	0
3	52931588	.	T	C	3	7	10	0	0	10	0	0
3	52932770	.	C	T	10	2	12	0	0	12	0	0
3	52932793	.	A	C	13	4	17	0	1	18	0	0
3	52935355	.	C	A	4	10	14	0	1	15	0	0
3	52937419	.	T	C	3	7	10	0	2	12	0	0
3	52937723	.	G	T	9	9	18	0	1	19	0	0
3	52937747	.	G	A	0	10	10	0	11	21	0	0
3	52945346	.	G	A	3	6	9	0	1	10	0	0
3	53000280	.	G	A	0	9	9	0	5	14	0	0
3	53000517	.	T	C	4	10	14	0	0	14	0	0
3	53000558	.	A	G	4	0	4	0	3	7	0	0
3	53000673	.	G	T	0	14	14	0	8	22	0	0
3	53001045	.	C	A	12	13	25	0	0	25	0	0
3	53047903	.	C	T	2	6	8	0	0	8	0	0
3	53047981	.	A	G	10	0	10	0	11	21	0	0
3	53048032	.	C	T	12	6	18	11	1	30	0	0
3	53074317	.	C	T	26	13	39	0	2	41	0	0
3	53074581	.	C	T	14	15	29	0	1	30	0	0
3	53075050	.	C	A	8	8	16	0	0	16	0	0
3	53075475	.	T	G	15	8	23	0	0	23	0	0
3	53076037	.	A	T	18	9	27	0	3	30	0	0
3	53076160	.	G	T	2	24	26	3	20	49	0	0
3	53140883	.	A	G	5	7	12	0	1	13	0	0
3	53192505	.	C	T	12	7	19	0	3	22	0	0
3	53196776	.	C	T	9	6	15	0	0	15	0	0
3	53198571	.	A	C	8	7	15	0	2	17	0	0
3	53198736	.	T	C	7	9	16	0	3	19	0	0
3	53198987	.	T	G	12	9	21	0	0	21	0	0
3	53199113	.	G	A	0	8	8	0	8	16	0	0
3	53199182	.	C	T	7	6	13	0	1	14	0	0
3	53199433	.	A	T	7	5	12	1	0	13	0	0
3	53201554	.	A	G	4	2	6	0	0	6	0	0
3	53203455	.	A	G	4	3	7	0	0	7	0	0
3	53203782	.	A	G	5	3	8	0	1	9	0	0
3	53203823	.	T	G	6	0	6	0	7	13	0	0
3	53204009	.	C	T	6	7	13	0	0	13	0	0
3	53204135	.	A	G	6	0	6	0	6	12	0	0
3	53206055	.	A	G	8	0	8	0	9	17	0	0
3	53206260	.	A	G	10	13	23	0	1	24	0	0
3	53206418	.	G	A	18	13	31	0	2	33	0	0
3	53206427	.	C	T	20	9	29	0	2	31	0	0
3	53206469	.	A	T	17	13	30	0	0	30	0	0
3	53206472	.	C	T	17	12	29	0	1	30	0	0
3	53211032	.	A	G	15	11	26	1	3	30	0	0
3	53211168	.	G	C	16	5	21	1	5	27	0	0
3	53211170	.	T	C	17	7	24	1	1	26	0	0
3	53211206	.	A	T	14	10	24	0	3	27	0	0
3	53211239	.	A	G	19	11	30	0	3	33	0	0
3	53211248	.	T	G	21	1	22	0	9	31	0	0
3	53211356	.	A	T	7	5	12	0	0	12	0	0
3	53211366	.	C	A	8	6	14	0	0	14	0	0
3	53211604	.	C	G	18	10	28	0	0	28	0	0
3	53211605	.	C	T	17	10	27	0	1	28	0	0
3	53214615	.	T	C	9	14	23	0	0	23	0	0
3	53215644	.	C	T	13	13	26	0	0	26	0	0
3	53215711	.	T	A	13	5	18	0	2	20	0	0
3	53215729	.	G	A	11	7	18	0	0	18	0	0
3	53218471	.	C	T	12	13	25	0	0	25	0	0
3	53222943	.	G	T	1	10	11	0	10	21	0	0
3	53223032	.	C	A	9	12	21	0	1	22	0	0
3	53223110	.	T	C	11	5	16	0	2	18	0	0
3	53223290	.	G	A	15	11	26	0	1	27	0	0
3	53223415	.	C	T	12	5	17	0	1	18	0	0
3	53223686	.	G	T	11	9	20	0	2	22	0	0
3	53223691	.	G	T	13	6	19	0	2	21	0	0
3	53223783	.	C	T	13	6	19	0	2	21	0	0
3	53223973	.	A	C	13	8	21	0	0	21	0	0
3	53224029	.	G	A	11	6	17	0	3	20	0	0
3	53224181	.	A	G	15	9	24	0	2	26	0	0
3	53224231	.	C	G	9	11	20	0	1	21	0	0
3	53228771	.	T	A	11	15	26	0	0	26	0	0
3	53229021	.	G	A	13	17	30	0	1	31	0	0
3	53229036	.	T	A	13	14	27	0	0	27	0	0
3	53230980	.	T	C	9	6	15	0	2	17	0	0
3	53231102	.	A	T	9	4	13	0	1	14	0	0
3	53231133	.	T	G	8	5	13	0	0	13	0	0
3	53231144	.	G	A	11	5	16	0	0	16	0	0
3	53240607	.	G	A	0	3	3	0	1	4	0	0
3	53243754	.	G	C	1	2	3	0	0	3	0	0
3	53248260	.	C	T	1	3	4	1	1	6	0	0
3	53248278	.	A	G	1	0	1	1	2	4	0	0
3	53264433	.	T	A	2	2	4	0	1	5	0	0
3	53264626	.	C	T	3	3	6	0	1	7	0	0
3	53264641	.	T	G	2	4	6	0	0	6	0	0
3	53264689	.	T	C	2	5	7	0	0	7	0	0
3	53271759	.	A	G	3	1	4	0	4	8	0	0
3	53271890	.	A	G	1	4	5	0	0	5	0	0
3	53273599	.	A	G	3	2	5	0	0	5	0	0
3	53319396	.	G	A	2	3	5	0	0	5	0	0
3	53319426	.	C	T	1	4	5	0	0	5	0	0
3	53327031	.	C	A	5	6	11	0	1	12	0	0
3	53327058	.	T	A	5	10	15	0	1	16	0	0
3	53329518	.	C	T	2	2	4	0	1	5	0	0
3	53329569	.	G	A	0	3	3	0	2	5	0	0
3	53329596	.	C	A	2	2	4	0	0	4	0	0
3	53330005	.	A	G	2	10	12	0	0	12	0	0
3	53340939	.	G	C	0	3	3	0	5	8	0	0
3	53342694	.	G	A	5	4	9	0	0	9	0	0
3	53342706	.	C	A	6	5	11	0	0	11	0	0
3	53343415	.	C	T	3	3	6	0	0	6	0	0
3	53343418	.	C	T	3	3	6	0	0	6	0	0
3	53344694	.	T	C	7	5	12	0	1	13	0	0
3	53344842	.	C	T	3	3	6	0	0	6	0	0
3	53344968	.	C	T	4	6	10	0	1	11	0	0
3	53350410	.	T	C	3	6	9	0	0	9	0	0
3	53350411	.	G	A	3	6	9	0	0	9	0	0
3	53352516	.	G	T	5	4	9	0	0	9	0	0
3	53352579	.	A	G	1	7	8	0	0	8	0	0
3	53352604	.	A	G	3	8	11	0	0	11	0	0
3	53352621	.	G	A	1	3	4	0	8	12	0	0
3	53352706	.	C	T	2	5	7	0	0	7	0	0
3	53352736	.	G	A	1	2	3	0	1	4	0	0
3	53398022	.	C	T	2	3	5	0	0	5	0	0
3	53398058	.	T	A	2	6	8	0	0	8	0	0
3	53398107	.	G	T	8	4	12	0	0	12	0	0
3	53444674	.	G	A	1	5	6	0	3	9	0	0
3	53445378	.	A	T	10	7	17	0	0	17	0	0
3	53445505	.	A	C	4	3	7	0	1	8	0	0
3	53445979	.	C	T	8	4	12	0	0	12	0	0
3	53446039	.	A	C	4	7	11	0	0	11	0	0
3	53446126	.	G	A	5	3	8	0	0	8	0	0
3	53446429	.	A	G	3	7	10	0	0	10	0	0
3	53446569	.	C	T	5	6	11	0	1	12	0	0
3	53447714	.	C	T	3	9	12	0	0	12	0	0
3	53447717	.	C	T	2	9	11	0	1	12	0	0
3	53447960	.	C	T	5	6	11	0	0	11	0	0
3	53448920	.	A	G	6	1	7	0	6	13	0	0
3	53449227	.	C	A	8	7	15	0	1	16	0	0
3	53449263	.	A	G	8	10	18	0	1	19	0	0
3	53476654	.	T	C	13	4	17	0	0	17	0	0
3	53484528	.	A	T	3	2	5	0	0	5	0	0
3	53484534	.	G	A	3	2	5	0	0	5	0	0
3	53527681	.	T	C	3	5	8	0	0	8	0	0
3	53528190	.	T	C	10	6	16	0	0	16	0	0
3	53528251	.	C	A	1	9	10	0	10	20	0	0
3	53528750	.	T	A	5	2	7	0	0	7	0	0
3	53528814	.	T	C	9	5	14	0	0	14	0	0
3	53528893	.	A	T	5	4	9	0	0	9	0	0
3	53529027	.	A	G	4	2	6	0	0	6	0	0
3	53529969	.	A	G	1	4	5	0	0	5	0	0
3	53530097	.	C	A	5	6	11	0	1	12	0	0
3	53530298	.	G	A	5	4	9	0	0	9	0	0
3	53530334	.	G	A	5	4	9	0	1	10	0	0
3	53530423	.	C	T	7	6	13	0	2	15	0	0
3	53530656	.	C	T	10	5	15	0	1	16	0	0
3	53530700	.	G	A	6	5	11	0	0	11	0	0
3	53532935	.	C	T	2	3	5	0	0	5	0	0
3	53534037	.	G	A	1	2	3	0	0	3	0	0
3	53687701	.	G	T	1	2	3	0	0	3	0	0
3	53688276	.	T	C	3	0	3	0	4	7	0	0
3	53688381	.	G	A	4	5	9	0	1	10	0	0
3	53918655	.	C	A	1	2	3	0	0	3	0	0
3	54047599	.	T	G	15	11	26	0	0	26	0	0
3	54047881	.	T	C	16	19	35	0	1	36	0	0
3	54168046	.	C	T	19	16	35	0	0	35	0	0
3	54168127	.	C	T	10	11	21	0	2	23	0	0
3	54168174	.	T	C	11	13	24	0	1	25	0	0
3	54168192	.	T	C	10	11	21	0	2	23	0	0
3	54168318	.	T	C	16	16	32	0	1	33	0	0
3	54207610	.	C	T	31	19	50	0	4	54	0	0
3	54223504	.	G	A	17	20	37	0	1	38	0	0
3	54236612	.	A	G	27	0	27	0	23	51	1	0
3	54236621	.	T	G	24	26	50	0	0	50	0	0
3	54236657	.	C	A	25	20	45	0	0	45	0	0
3	54236750	.	A	G	28	18	46	0	0	46	0	0
3	54236996	.	G	A	3	26	29	0	27	56	0	0
3	54237347	.	C	T	29	19	48	0	0	48	0	0
3	54237443	.	G	C	17	10	27	0	0	27	0	0
3	54237472	.	T	C	15	6	21	0	0	21	0	0
3	54434378	.	A	T	3	4	7	0	0	7	0	0
3	54434398	.	C	T	0	4	4	0	3	7	0	0
3	54435018	.	A	G	7	3	10	0	0	10	0	0
3	54435088	.	G	A	1	2	3	1	1	5	0	0
3	54435273	.	G	A	7	7	14	0	1	15	0	0
3	54435336	.	C	G	2	5	7	0	11	18	0	0
3	54435453	.	G	A	8	10	18	1	0	19	0	0
3	54438753	.	G	A	7	5	12	0	0	13	1	0
3	54438776	.	T	G	10	4	14	0	2	16	0	0
3	54455057	.	T	C	7	5	12	0	1	13	0	0
3	54455120	.	T	C	8	0	8	0	3	11	0	0
3	54455168	.	C	T	1	5	6	0	4	11	1	0
3	54455616	.	G	T	6	5	11	0	0	11	0	0
3	54455657	.	T	G	3	10	13	0	0	13	0	0
3	54455827	.	G	A	9	5	14	0	0	14	0	0
3	54456183	.	T	C	6	7	13	0	0	13	0	0
3	54474860	.	G	A	3	5	8	0	1	9	0	0
3	54500103	.	T	C	3	9	12	0	0	12	0	0
3	54500111	.	C	G	4	8	12	0	0	12	0	0
3	54555875	.	A	G	4	3	7	0	0	7	0	0
3	54561375	.	A	G	5	3	8	0	0	8	0	0
3	54567186	.	G	A	6	6	12	0	1	13	0	0
3	54567303	.	T	A	7	8	15	0	1	16	0	0
3	54567463	.	T	A	7	11	18	0	0	18	0	0
3	54567502	.	G	A	11	4	15	0	1	16	0	0
3	54567715	.	A	C	4	4	8	0	0	8	0	0
3	54567856	.	A	C	2	2	4	0	0	4	0	0
3	54567857	.	C	T	2	2	4	0	0	4	0	0
3	54583742	.	C	T	21	31	52	0	4	56	0	0
3	54585281	.	A	G	23	20	43	0	2	45	0	0
3	54585359	.	C	T	24	26	50	0	1	51	0	0
3	54585637	.	T	C	31	16	47	0	4	51	0	0
3	54585685	.	C	T	20	21	41	0	2	43	0	0
3	54586125	.	T	C	15	12	27	0	2	29	0	0
3	54589582	.	T	C	28	16	44	0	3	47	0	0
3	54591385	.	G	A	3	3	6	0	0	6	0	0
3	54591432	.	A	C	7	5	12	0	0	13	1	0
3	54591677	.	G	A	8	5	13	0	0	13	0	0
3	54591701	.	A	G	5	4	9	0	0	9	0	0
3	54591849	.	G	A	12	10	22	0	1	23	0	0
3	54592322	.	G	A	7	8	15	0	2	17	0	0
3	54592376	.	A	T	10	11	21	0	2	24	1	0
3	54592986	.	T	C	10	0	10	0	9	19	0	0
3	54593034	.	A	T	8	13	21	0	1	22	0	0
3	54593046	.	C	T	7	13	20	0	1	21	0	0
3	54594823	.	C	T	9	5	14	0	1	15	0	0
3	54594865	.	T	A	9	5	14	0	0	14	0	0
3	54594880	.	T	C	7	5	12	0	2	14	0	0
3	54595071	.	G	A	6	7	13	0	0	13	0	0
3	54596362	.	A	G	8	13	21	0	2	23	0	0
3	54596385	.	C	T	4	13	17	0	1	18	0	0
3	54596634	.	G	A	11	9	20	0	1	21	0	0
3	54596651	.	G	A	7	14	21	0	1	22	0	0
3	54596892	.	T	C	7	0	7	0	12	19	0	0
3	54596935	.	A	G	13	10	23	0	4	27	0	0
3	54597183	.	G	A	9	9	18	0	0	18	0	0
3	54597712	.	A	C	9	4	13	0	1	14	0	0
3	54598196	.	T	G	5	3	8	0	0	8	0	0
3	54600682	.	A	G	5	7	12	0	0	12	0	0
3	54601833	.	G	A	3	7	10	0	2	12	0	0
3	54601836	.	C	T	0	5	5	0	7	12	0	0
3	54601958	.	T	C	8	0	8	0	5	13	0	0
3	54601991	.	C	T	6	10	16	0	0	16	0	0
3	54602027	.	A	G	6	4	10	0	0	10	0	0
3	54602054	.	G	A	4	4	8	0	0	8	0	0
3	54602194	.	C	T	6	5	11	0	0	11	0	0
3	54603808	.	C	T	3	7	10	0	0	10	0	0
3	54604010	.	C	T	2	4	6	0	5	11	0	0
3	54616383	.	A	G	2	3	5	0	0	5	0	0
3	54748546	.	T	C	4	3	7	1	0	8	0	0
3	54748578	.	T	C	3	2	5	1	1	7	0	0
3	54748602	.	A	T	1	2	3	3	0	6	0	0
3	54749083	.	C	T	2	2	4	0	0	4	0	0
3	54749121	.	C	G	3	2	5	0	0	5	0	0
3	54752111	.	C	T	1	3	4	0	0	4	0	0
3	54767478	.	C	T	4	2	6	0	0	6	0	0
3	54771720	.	C	A	1	3	4	0	0	4	0	0
3	54771773	.	T	C	3	2	5	0	2	7	0	0
3	54809627	.	C	T	3	6	9	2	0	11	0	0
3	54809707	.	C	T	3	6	9	1	0	10	0	0
3	54810164	.	G	A	4	10	14	1	0	15	0	0
3	54810588	.	A	G	13	0	13	0	5	18	0	0
3	54834906	.	T	C	3	2	5	0	0	5	0	0
3	54835295	.	T	A	2	5	7	0	1	8	0	0
3	54835951	.	C	T	0	2	2	0	1	3	0	0
3	54835969	.	T	A	1	2	3	0	0	3	0	0
3	54837844	.	G	A	5	4	9	0	0	10	1	0
3	54837862	.	T	C	2	0	2	0	5	7	0	0
3	54849375	.	A	G	6	0	6	0	9	15	0	0
3	54849409	.	T	A	8	11	19	1	1	21	0	0
3	54849576	.	T	A	2	7	9	2	0	11	0	0
3	54850678	.	C	T	6	12	18	0	0	18	0	0
3	54852507	.	G	A	12	5	17	1	1	19	0	0
3	54855164	.	G	A	18	15	33	0	1	34	0	0
3	54856591	.	T	C	13	4	17	0	1	18	0	0
3	54856592	.	C	T	13	5	18	0	0	18	0	0
3	54856645	.	T	C	13	10	23	0	0	23	0	0
3	54859022	.	G	A	1	8	9	0	11	20	0	0
3	54859127	.	T	C	18	5	23	0	0	23	0	0
3	54866207	.	A	G	21	15	36	1	0	37	0	0
3	54868514	.	C	T	11	16	27	0	1	28	0	0
3	54871515	.	C	A	26	21	47	0	3	50	0	0
3	54871745	.	C	T	11	16	27	0	0	27	0	0
3	54872003	.	C	G	9	18	27	0	0	27	0	0
3	54872172	.	T	A	17	8	25	0	0	25	0	0
3	54872494	.	A	G	12	11	23	0	0	23	0	0
3	54872520	.	C	G	13	6	19	0	1	20	0	0
3	54872889	.	T	A	0	17	17	0	0	17	0	0
3	54873055	.	C	A	16	17	33	0	1	34	0	0
3	54873844	.	T	C	13	9	22	0	1	23	0	0
3	54874245	.	C	T	9	18	27	0	0	27	0	0
3	54874371	.	C	T	16	8	24	0	0	24	0	0
3	54874477	.	A	G	24	11	35	0	0	35	0	0
3	54874631	.	G	A	13	9	22	0	1	23	0	0
3	54874660	.	C	T	13	13	26	0	4	30	0	0
3	54874711	.	G	A	5	15	20	0	0	20	0	0
3	54888004	.	A	G	3	4	7	0	0	7	0	0
3	54897039	.	G	A	2	4	6	0	1	7	0	0
3	54897099	.	G	T	3	4	7	0	1	8	0	0
3	54897152	.	G	A	5	5	10	0	0	10	0	0
3	54902365	.	C	T	1	4	5	0	0	5	0	0
3	54907937	.	C	T	1	4	5	0	5	10	0	0
3	54908057	.	C	T	4	3	7	0	0	7	0	0
3	54910359	.	A	G	4	3	7	0	0	7	0	0
3	54911854	.	T	G	3	3	6	0	0	6	0	0
3	54911890	.	T	C	3	2	5	0	0	5	0	0
3	54912019	.	C	T	6	2	8	0	0	8	0	0
3	54916497	.	T	C	7	3	10	0	1	11	0	0
3	54992928	.	T	G	2	3	5	0	1	6	0	0
3	55039143	.	C	T	2	4	6	0	0	6	0	0
3	55042728	.	C	T	5	5	10	0	0	10	0	0
3	55042836	.	C	A	2	1	3	0	0	3	0	0
3	55042882	.	G	A	1	2	3	0	0	3	0	0
3	55042962	.	C	T	2	2	4	0	0	4	0	0
3	55043016	.	A	G	2	2	4	0	0	4	0	0
3	55045602	.	T	A	3	3	6	0	0	6	0	0
3	55045709	.	G	T	4	4	8	0	1	9	0	0
3	55045854	.	A	G	2	4	6	0	0	6	0	0
3	55045980	.	A	T	5	2	7	0	0	7	0	0
3	55046014	.	C	T	6	2	8	0	0	8	0	0
3	55046016	.	G	T	5	2	7	0	0	7	0	0
3	55046165	.	A	G	1	2	3	0	0	3	0	0
3	55050175	.	A	G	5	9	14	0	0	14	0	0
3	55050191	.	T	A	7	5	12	0	0	12	0	0
3	55051090	.	C	T	8	5	13	0	0	13	0	0
3	55057370	.	T	C	4	3	7	0	0	7	0	0
3	55057421	.	T	G	4	2	6	0	0	6	0	0
3	55063295	.	C	T	0	2	2	0	2	4	0	0
3	55079251	.	C	T	2	4	6	0	0	6	0	0
3	55079269	.	T	C	4	2	6	0	0	6	0	0
3	55079508	.	A	T	3	3	6	0	1	7	0	0
3	55079530	.	G	T	3	2	5	0	1	6	0	0
3	55098813	.	G	T	23	7	30	28	5	63	0	0
3	55100228	.	T	C	22	11	33	4	1	38	0	0
3	55100413	.	C	A	28	6	34	7	2	43	0	0
3	55100522	.	A	G	6	11	17	32	1	50	0	0
3	55100590	.	T	G	24	16	40	11	2	53	0	0
3	55100795	.	A	G	22	12	34	11	1	46	0	0
3	55104214	.	T	C	10	0	10	16	8	34	0	0
3	55104215	.	A	G	9	7	16	16	1	33	0	0
3	55105254	.	T	C	7	7	14	15	0	29	0	0
3	55161659	.	A	C	3	3	6	0	0	6	0	0
3	55161680	.	C	T	0	3	3	0	4	7	0	0
3	55161697	.	G	T	4	3	7	0	0	7	0	0
3	55161724	.	C	T	5	2	7	0	0	7	0	0
3	55161753	.	C	T	4	4	8	0	1	9	0	0
3	55161763	.	G	T	6	5	11	0	0	11	0	0
3	55162551	.	G	A	2	5	7	0	0	7	0	0
3	55164243	.	C	T	0	4	4	0	5	9	0	0
3	55174830	.	G	A	4	10	14	0	0	14	0	0
3	55174832	.	C	A	4	10	14	0	0	14	0	0
3	55174998	.	G	A	2	5	7	0	0	7	0	0
3	55175054	.	G	A	5	3	8	0	1	9	0	0
3	55177759	.	C	T	1	3	4	0	0	4	0	0
3	55197782	.	T	C	1	2	3	0	0	3	0	0
3	55218724	.	C	T	1	5	6	0	0	6	0	0
3	55218772	.	G	A	2	3	5	0	0	5	0	0
3	55218830	.	T	C	3	0	3	0	3	6	0	0
3	55218943	.	T	G	2	2	4	0	0	4	0	0
3	55218956	.	C	T	0	2	2	0	1	3	0	0
3	55219205	.	G	A	3	5	8	0	0	8	0	0
3	55222778	.	G	T	5	3	8	0	0	8	0	0
3	55226275	.	A	G	6	2	8	0	0	8	0	0
3	55229436	.	G	A	1	3	4	0	0	4	0	0
3	55232194	.	G	A	3	5	8	0	0	8	0	0
3	55233840	.	G	T	2	5	7	0	0	7	0	0
3	55237696	.	T	C	2	2	4	0	0	4	0	0
3	55240288	.	T	C	4	3	7	0	0	7	0	0
3	55256537	.	T	C	1	0	1	0	4	5	0	0
3	55269307	.	G	A	1	4	5	0	1	6	0	0
3	55269870	.	A	G	2	5	7	0	1	8	0	0
3	55422831	.	G	A	7	4	11	0	0	11	0	0
3	55422850	.	G	T	4	6	10	0	0	10	0	0
3	55422926	.	C	A	0	8	8	0	2	10	0	0
3	55422980	.	T	C	4	4	8	0	0	8	0	0
3	55423363	.	G	A	3	2	5	0	0	5	0	0
3	55423611	.	G	A	2	8	10	0	0	10	0	0
3	55423663	.	A	G	2	2	4	0	0	4	0	0
3	55424465	.	C	T	6	6	12	0	0	12	0	0
3	55426258	.	T	C	8	6	14	0	0	14	0	0
3	55430451	.	T	C	4	3	7	0	0	7	0	0
3	55430475	.	G	A	3	3	6	0	0	6	0	0
3	55430826	.	A	G	2	7	9	0	0	9	0	0
3	55438733	.	C	T	4	3	7	0	0	7	0	0
3	57462962	.	T	C	3	11	14	0	1	15	0	0
3	58197600	.	A	G	2	5	7	9	1	17	0	0
3	58197648	.	C	T	14	11	25	5	4	34	0	0
3	58197871	.	G	A	7	7	14	4	1	19	0	0
3	58210564	.	A	G	1	7	8	1	1	10	0	0
3	58210593	.	T	A	2	10	12	2	0	14	0	0
3	58608283	.	C	G	2	7	9	13	0	22	0	0
3	58608335	.	G	A	2	8	10	19	1	30	0	0
3	58608380	.	G	A	1	6	7	24	0	31	0	0
3	58615428	.	T	G	4	4	8	5	1	14	0	0
3	58615543	.	G	C	6	3	9	5	2	16	0	0
3	58704640	.	T	C	5	9	14	0	0	14	0	0
3	58710350	.	T	C	2	28	30	2	0	32	0	0
3	59805622	.	G	A	1	3	4	0	0	4	0	0
3	59815955	.	C	A	5	7	12	0	0	12	0	0
3	59816007	.	C	T	5	4	9	0	0	9	0	0
3	59868371	.	A	G	19	0	19	0	7	26	0	0
3	59868391	.	T	C	17	7	24	0	1	25	0	0
3	59868427	.	G	A	8	12	20	0	1	21	0	0
3	59870578	.	C	T	13	12	25	0	1	26	0	0
3	59876195	.	C	T	14	10	24	1	2	27	0	0
3	59876233	.	T	C	16	9	25	0	2	27	0	0
3	59876405	.	C	A	10	10	20	0	1	21	0	0
3	59876772	.	G	A	0	2	2	0	1	3	0	0
3	59880349	.	C	T	21	13	34	0	0	34	0	0
3	59880544	.	C	T	18	14	32	0	0	32	0	0
3	59883465	.	T	A	16	9	25	0	1	26	0	0
3	59883489	.	C	A	15	8	23	0	0	23	0	0
3	59887325	.	G	A	8	25	33	0	23	56	0	0
3	59889663	.	C	A	27	17	44	3	2	49	0	0
3	59941534	.	C	T	13	19	32	1	3	36	0	0
3	59941542	.	C	T	18	14	32	1	0	33	0	0
3	59941572	.	C	T	21	17	38	0	0	38	0	0
3	59942142	.	G	A	15	14	29	0	0	29	0	0
3	59945851	.	T	C	21	30	51	1	2	54	0	0
3	59946094	.	A	T	17	18	35	2	0	37	0	0
3	59946097	.	T	A	19	9	28	2	0	30	0	0
3	59946432	.	C	T	11	17	28	0	2	30	0	0
3	59946642	.	G	T	2	17	19	0	21	40	0	0
3	59946828	.	T	C	14	20	34	7	1	42	0	0
3	59946877	.	C	T	15	11	26	6	1	33	0	0
3	59946901	.	C	T	19	11	30	0	0	30	0	0
3	59947092	.	A	T	14	9	23	0	0	23	0	0
3	59951426	.	C	A	14	12	26	0	1	27	0	0
3	59951767	.	T	C	13	1	14	0	18	32	0	0
3	59951800	.	G	A	14	11	25	0	3	28	0	0
3	59952046	.	T	C	14	2	16	0	16	32	0	0
3	59952268	.	C	G	10	21	31	0	1	32	0	0
3	59961399	.	G	A	15	19	34	0	2	36	0	0
3	59986172	.	C	T	0	2	2	0	3	5	0	0
3	59986181	.	G	T	2	5	7	0	0	7	0	0
3	59994744	.	G	A	10	14	24	0	0	24	0	0
3	59995019	.	T	G	4	14	18	0	0	18	0	0
3	59995028	.	C	T	6	12	18	0	1	19	0	0
3	59995122	.	G	T	8	10	18	0	3	21	0	0
3	59997180	.	C	T	1	6	7	0	1	8	0	0
3	59999933	.	T	A	7	4	11	0	0	11	0	0
3	60002951	.	T	C	3	7	10	0	0	10	0	0
3	60003007	.	T	A	6	2	8	0	1	9	0	0
3	60025587	.	C	T	4	4	8	0	0	8	0	0
3	60025650	.	T	C	2	0	2	0	6	8	0	0
3	60073164	.	C	G	2	2	4	0	2	6	0	0
3	60073820	.	G	C	0	2	2	0	2	4	0	0
3	60073825	.	T	C	2	2	4	0	0	4	0	0
3	60074233	.	A	T	5	3	8	3	0	11	0	0
3	60074316	.	C	T	2	3	5	2	0	7	0	0
3	60074324	.	G	A	2	3	5	2	0	7	0	0
3	60177849	.	G	A	5	3	8	0	0	8	0	0
3	60219020	.	A	G	3	0	3	0	5	8	0	0
3	60222532	.	T	C	5	3	8	0	0	8	0	0
3	60222551	.	T	C	4	2	6	0	0	6	0	0
3	60225646	.	G	A	0	2	2	0	7	9	0	0
3	60225995	.	T	C	1	2	3	0	0	3	0	0
3	60226005	.	T	C	1	2	3	0	0	3	0	0
3	60526316	.	C	T	1	3	4	0	4	8	0	0
3	60526385	.	G	C	1	2	3	0	0	3	0	0
3	60526426	.	A	G	1	2	3	1	0	4	0	0
3	60526504	.	T	A	2	3	5	0	0	5	0	0
3	60526620	.	C	A	4	3	7	0	0	7	0	0
3	60526647	.	A	G	2	4	6	0	0	6	0	0
3	60567573	.	C	G	4	4	8	0	0	8	0	0
3	60576005	.	A	T	3	4	7	0	0	7	0	0
3	60576371	.	G	A	2	3	5	0	0	5	0	0
3	60576415	.	C	A	2	3	5	0	0	5	0	0
3	60577258	.	A	T	1	3	4	0	0	4	0	0
3	60578176	.	T	A	2	10	12	0	0	12	0	0
3	60578201	.	C	T	0	5	5	0	2	7	0	0
3	60578217	.	C	T	1	6	7	0	0	7	0	0
3	60578394	.	C	T	1	3	4	0	2	6	0	0
3	60578408	.	G	A	4	4	8	0	0	8	0	0
3	60579049	.	C	A	4	4	8	0	0	8	0	0
3	60582361	.	A	G	4	3	7	0	0	7	0	0
3	60584225	.	A	G	4	3	7	0	0	7	0	0
3	60585462	.	C	T	0	3	3	0	2	5	0	0
3	60589244	.	G	T	2	6	8	0	1	9	0	0
3	60589503	.	G	A	6	10	16	0	0	16	0	0
3	60594169	.	A	G	1	2	3	0	0	3	0	0
3	60594703	.	G	A	10	5	15	0	0	15	0	0
3	60596020	.	G	A	6	7	13	0	0	13	0	0
3	60596647	.	A	G	10	3	13	0	1	14	0	0
3	60596808	.	A	C	6	8	14	0	1	15	0	0
3	60600097	.	T	C	10	2	12	0	1	13	0	0
3	60600113	.	T	C	9	4	13	0	0	13	0	0
3	60601907	.	A	T	11	7	18	0	1	19	0	0
3	60601958	.	G	A	7	6	13	0	0	13	0	0
3	60618971	.	G	A	2	4	6	0	1	7	0	0
3	60620712	.	A	G	2	3	5	0	1	6	0	0
3	60685042	.	G	A	7	3	10	0	0	10	0	0
3	60710969	.	C	T	8	3	11	0	0	11	0	0
3	60711017	.	T	C	6	6	12	0	0	12	0	0
3	60722308	.	C	A	1	4	5	0	0	5	0	0
3	60730287	.	C	G	2	2	4	0	0	4	0	0
3	60730449	.	C	G	2	3	5	0	1	6	0	0
3	60730556	.	G	A	1	2	3	0	1	4	0	0
3	60731022	.	A	C	2	5	7	0	0	7	0	0
3	60731100	.	A	T	3	4	7	0	0	7	0	0
3	60731132	.	G	A	3	4	7	0	0	7	0	0
3	60731330	.	G	A	0	3	3	0	3	6	0	0
3	60731942	.	C	T	3	3	6	0	0	6	0	0
3	60731956	.	G	A	1	3	4	0	4	8	0	0
3	60732098	.	A	T	6	2	8	0	0	8	0	0
3	60732761	.	G	T	0	3	3	0	1	4	0	0
3	60782579	.	G	T	0	2	2	0	1	3	0	0
3	60789331	.	G	A	0	2	2	0	6	8	0	0
3	60789730	.	C	A	1	2	3	0	0	3	0	0
3	60818405	.	A	G	1	4	5	0	0	5	0	0
3	60829456	.	G	T	6	4	10	0	1	11	0	0
3	60832805	.	T	C	6	2	8	0	1	9	0	0
3	60834600	.	C	T	6	6	12	0	1	13	0	0
3	60834672	.	G	A	0	3	3	0	5	8	0	0
3	60836838	.	G	A	0	6	6	0	5	11	0	0
3	60839133	.	G	A	0	5	5	0	9	14	0	0
3	60839303	.	C	T	3	4	7	0	1	8	0	0
3	60841105	.	C	T	6	7	13	0	0	13	0	0
3	60841149	.	C	T	8	4	12	0	0	12	0	0
3	60854011	.	C	T	7	6	13	0	1	14	0	0
3	60855800	.	C	T	5	6	11	0	0	11	0	0
3	60855961	.	G	C	6	6	12	0	1	13	0	0
3	60862519	.	G	A	21	9	30	0	2	32	0	0
3	60864804	.	G	A	11	6	17	0	1	18	0	0
3	60875101	.	C	T	7	13	20	1	1	22	0	0
3	60875169	.	T	G	9	10	19	0	0	19	0	0
3	60962589	.	T	C	5	8	13	0	1	14	0	0
3	60971719	.	G	C	12	7	19	0	1	20	0	0
3	60976921	.	C	T	12	8	20	0	1	21	0	0
3	60976985	.	G	A	3	9	12	0	12	24	0	0
3	60977060	.	A	G	13	0	13	0	7	20	0	0
3	60977134	.	T	A	13	8	21	0	0	21	0	0
3	60978344	.	G	A	18	5	23	0	0	23	0	0
3	60982492	.	A	C	13	13	26	0	1	27	0	0
3	60984213	.	A	G	12	0	12	0	17	29	0	0
3	60985862	.	C	T	8	9	17	0	1	18	0	0
3	60992134	.	A	G	19	0	19	0	11	30	0	0
3	60994781	.	G	C	17	16	33	0	0	33	0	0
3	60997781	.	C	G	13	13	26	0	1	27	0	0
3	61004295	.	G	A	4	11	15	0	19	34	0	0
3	61004397	.	C	T	13	11	24	0	2	26	0	0
3	61004442	.	G	T	16	12	28	0	0	28	0	0
3	61013397	.	C	T	12	19	31	0	0	31	0	0
3	61026883	.	G	T	23	15	38	0	0	38	0	0
3	61030127	.	G	A	20	13	33	0	3	36	0	0
3	61030181	.	C	T	15	19	34	0	0	34	0	0
3	61030220	.	C	T	12	25	37	0	0	37	0	0
3	61030699	.	G	C	16	17	33	0	1	34	0	0
3	61030800	.	G	A	21	10	31	0	2	33	0	0
3	61030829	.	G	A	16	16	32	0	2	34	0	0
3	61033183	.	C	T	22	28	50	1	3	54	0	0
3	61033859	.	C	A	25	17	42	0	6	48	0	0
3	61033979	.	C	A	25	25	50	0	4	54	0	0
3	61034060	.	T	G	26	1	27	0	28	55	0	0
3	61034096	.	T	C	20	30	50	0	5	55	0	0
3	61043871	.	G	A	8	10	18	0	0	18	0	0
3	61043925	.	G	T	13	14	27	0	0	27	0	0
3	61078285	.	T	C	5	2	7	0	1	8	0	0
3	61078325	.	T	G	8	6	14	0	1	15	0	0
3	61078337	.	A	C	6	8	14	0	0	14	0	0
3	61078363	.	T	G	8	4	12	0	0	12	0	0
3	61078372	.	A	G	6	2	8	0	0	8	0	0
3	61078484	.	C	T	5	2	7	0	0	7	0	0
3	61078691	.	A	T	2	2	4	0	0	4	0	0
3	61078757	.	G	A	3	5	8	0	2	10	0	0
3	61079085	.	A	T	2	4	6	0	0	6	0	0
3	61079390	.	A	G	4	5	9	0	0	9	0	0
3	61079477	.	G	A	4	3	7	0	0	7	0	0
3	61079567	.	G	A	2	3	5	0	0	5	0	0
3	61082677	.	G	A	3	3	6	0	0	6	0	0
3	61082852	.	T	C	1	0	1	0	5	6	0	0
3	61098695	.	C	T	5	3	8	0	0	8	0	0
3	61098925	.	G	C	1	2	3	0	0	3	0	0
3	61108600	.	G	T	18	12	30	0	1	31	0	0
3	61108732	.	A	G	19	13	32	0	3	35	0	0
3	61108734	.	T	C	19	0	19	0	16	35	0	0
3	61108830	.	C	A	2	16	18	0	18	36	0	0
3	61111826	.	G	T	12	11	23	0	2	25	0	0
3	61116160	.	C	T	6	12	18	0	0	18	0	0
3	61221441	.	T	A	6	6	12	0	0	12	0	0
3	61221589	.	C	T	5	4	9	0	0	9	0	0
3	61244015	.	C	T	7	6	13	0	0	13	0	0
3	61264122	.	G	A	6	13	19	0	1	20	0	0
3	61276907	.	C	T	2	6	8	0	1	9	0	0
3	61277028	.	C	G	10	11	21	0	1	22	0	0
3	61278584	.	C	T	8	7	15	0	0	15	0	0
3	61278866	.	C	T	10	4	14	0	0	14	0	0
3	61278992	.	C	T	9	5	14	0	0	14	0	0
3	61279124	.	T	C	5	7	12	0	1	13	0	0
3	61279308	.	T	G	7	4	11	0	0	11	0	0
3	61279427	.	A	C	19	7	26	0	1	27	0	0
3	61279585	.	G	A	2	7	9	0	13	22	0	0
3	61279588	.	T	A	11	11	22	0	2	24	0	0
3	61279643	.	T	C	12	17	29	0	0	29	0	0
3	61279781	.	C	T	9	7	16	0	0	16	0	0
3	61279844	.	G	A	2	9	11	0	10	21	0	0
3	61280198	.	G	T	5	4	9	0	0	9	0	0
3	61280495	.	T	C	5	15	20	0	1	21	0	0
3	61280579	.	T	G	12	0	12	0	7	19	0	0
3	61280717	.	A	G	13	0	13	0	9	22	0	0
3	61285784	.	C	T	7	10	17	0	0	17	0	0
3	61285947	.	A	G	4	0	4	0	7	11	0	0
3	61286007	.	T	G	4	7	11	0	0	11	0	0
3	61286325	.	C	G	11	0	11	0	7	18	0	0
3	61286468	.	C	T	7	7	14	0	0	14	0	0
3	61286528	.	A	T	5	7	12	1	0	13	0	0
3	61286889	.	T	C	9	8	17	0	2	19	0	0
3	61286998	.	G	A	2	13	15	0	14	29	0	0
3	61287010	.	A	G	14	11	25	0	1	26	0	0
3	61287094	.	A	G	5	0	5	0	7	12	0	0
3	61287214	.	A	T	10	12	22	0	0	22	0	0
3	61287260	.	G	T	11	7	18	0	0	18	0	0
3	61287289	.	C	T	6	11	17	0	0	17	0	0
3	61287343	.	G	T	11	15	26	0	0	26	0	0
3	61287491	.	T	A	11	13	24	0	0	24	0	0
3	61287627	.	C	G	14	12	26	0	1	27	0	0
3	61287893	.	T	G	22	0	22	0	12	34	0	0
3	61288028	.	T	C	12	15	27	0	0	27	0	0
3	61288238	.	A	C	17	10	27	0	0	27	0	0
3	61306473	.	C	G	1	3	4	0	0	4	0	0
3	61306994	.	C	T	3	4	7	0	0	7	0	0
3	61309022	.	C	G	1	4	5	0	0	5	0	0
3	61312331	.	G	A	2	5	7	0	0	7	0	0
3	61316918	.	G	A	1	3	4	0	1	5	0	0
3	61326352	.	A	C	3	0	3	0	5	8	0	0
3	61331732	.	C	T	2	2	4	0	0	4	0	0
3	61336778	.	A	T	2	2	4	0	0	4	0	0
3	61342032	.	C	T	2	5	7	0	3	10	0	0
3	61342770	.	G	A	19	8	27	0	1	28	0	0
3	61343014	.	T	A	13	5	18	1	0	19	0	0
3	61343019	.	T	A	9	5	14	1	2	17	0	0
3	61343181	.	C	G	5	3	8	0	1	9	0	0
3	61343425	.	T	A	4	3	7	0	0	7	0	0
3	61343589	.	T	C	5	8	13	0	0	13	0	0
3	61349495	.	C	A	2	4	6	0	0	6	0	0
3	61349556	.	C	G	2	3	5	0	1	6	0	0
3	61349602	.	G	A	9	4	13	0	0	13	0	0
3	61349654	.	C	T	12	7	19	0	0	19	0	0
3	61349734	.	G	A	10	6	16	0	0	16	0	0
3	61349816	.	T	G	10	7	17	0	0	17	0	0
3	61349887	.	A	T	7	10	17	0	1	18	0	0
3	61350466	.	T	A	3	3	6	0	0	6	0	0
3	61350487	.	T	C	6	4	10	0	1	11	0	0
3	61350667	.	C	T	7	5	12	0	0	12	0	0
3	61350673	.	T	G	5	3	8	0	0	8	0	0
3	61351007	.	A	G	3	6	9	0	0	9	0	0
3	61351073	.	C	T	6	2	8	0	0	8	0	0
3	61351109	.	C	T	2	2	4	0	1	5	0	0
3	61351135	.	T	C	6	0	6	0	4	10	0	0
3	61351294	.	A	G	4	5	9	0	0	9	0	0
3	61351458	.	C	G	3	5	8	0	0	8	0	0
3	61351465	.	C	T	0	5	5	0	3	8	0	0
3	61351640	.	G	T	4	4	8	0	0	8	0	0
3	61351967	.	T	C	2	4	6	0	1	7	0	0
3	61352062	.	C	T	3	4	7	0	0	7	0	0
3	61354125	.	T	A	5	4	9	0	0	9	0	0
3	61354143	.	C	T	5	4	9	0	0	9	0	0
3	61354221	.	A	G	3	5	8	0	0	8	0	0
3	61358195	.	T	C	1	2	3	0	0	3	0	0
3	61358196	.	T	C	1	1	2	0	1	3	0	0
3	61358361	.	T	C	3	3	6	0	0	6	0	0
3	61358547	.	C	T	1	2	3	0	0	3	0	0
3	61358682	.	T	C	2	3	5	2	0	7	0	0
3	61358716	.	G	T	5	2	7	2	0	9	0	0
3	61361409	.	G	A	2	3	5	0	0	5	0	0
3	61365083	.	C	T	8	2	10	5	0	15	0	0
3	61371506	.	T	A	4	2	6	0	1	7	0	0
3	61372060	.	T	G	1	3	4	1	0	5	0	0
3	61372724	.	A	G	2	3	5	0	0	5	0	0
3	61372736	.	T	C	1	0	1	0	2	3	0	0
3	61375586	.	G	A	4	2	6	0	1	7	0	0
3	61383072	.	C	T	0	4	4	2	1	7	0	0
3	61383492	.	T	C	2	0	2	0	4	6	0	0
3	61383550	.	T	G	3	4	7	0	0	8	1	0
3	61385043	.	A	G	2	3	5	0	0	5	0	0
3	61391687	.	T	C	11	16	27	0	0	27	0	0
3	61391797	.	G	A	1	10	11	0	6	17	0	0
3	61392048	.	A	G	7	0	7	0	12	19	0	0
3	61396523	.	C	T	11	8	19	0	1	20	0	0
3	61396868	.	A	T	3	4	7	0	0	7	0	0
3	61397093	.	C	T	11	8	19	0	0	19	0	0
3	61397231	.	C	A	12	5	17	0	1	18	0	0
3	61397294	.	C	T	8	5	13	0	1	14	0	0
3	61398612	.	C	T	6	11	17	0	1	18	0	0
3	61398728	.	A	G	11	8	19	0	0	19	0	0
3	61398809	.	T	C	8	4	12	0	0	12	0	0
3	61398882	.	T	C	2	2	4	0	0	4	0	0
3	61401583	.	A	C	1	3	4	0	0	4	0	0
3	61542663	.	G	A	0	4	4	0	1	5	0	0
3	61542700	.	C	T	4	2	6	0	0	6	0	0
3	61542854	.	G	T	5	3	8	0	1	9	0	0
3	61542889	.	C	A	6	5	11	0	0	11	0	0
3	61542910	.	C	T	4	6	10	0	0	10	0	0
3	61542973	.	T	C	5	4	9	0	1	10	0	0
3	61543009	.	T	G	3	0	3	0	2	5	0	0
3	61566380	.	T	C	2	0	2	0	2	4	0	0
3	61566456	.	A	T	2	3	5	0	0	5	0	0
3	61566559	.	G	A	1	4	5	0	1	6	0	0
3	61585516	.	G	A	2	2	4	0	0	4	0	0
3	61958773	.	G	A	0	2	2	0	3	5	0	0
3	61959321	.	G	A	1	3	4	0	0	4	0	0
3	62034943	.	G	A	6	6	12	0	0	12	0	0
3	62035030	.	G	A	2	6	8	0	7	15	0	0
3	62035861	.	C	T	4	8	12	0	2	14	0	0
3	62035952	.	A	G	2	0	2	0	6	8	0	0
3	62036047	.	G	A	0	9	9	0	5	14	0	0
3	62036320	.	A	G	8	5	13	0	0	13	0	0
3	62036323	.	A	G	8	6	14	0	0	14	0	0
3	62036426	.	G	A	7	8	15	0	1	16	0	0
3	62036570	.	G	A	10	9	19	0	0	19	0	0
3	62037105	.	T	C	9	6	15	0	1	16	0	0
3	62037343	.	G	C	5	5	10	0	0	10	0	0
3	62037430	.	A	G	7	0	7	0	9	16	0	0
3	62037716	.	G	A	6	6	12	0	0	12	0	0
3	62038526	.	T	C	7	9	16	0	0	16	0	0
3	62038739	.	G	C	9	12	21	0	0	21	0	0
3	62038993	.	G	A	2	16	18	0	15	33	0	0
3	62039278	.	A	G	13	0	13	0	10	23	0	0
3	62039657	.	G	A	0	9	9	0	11	20	0	0
3	62039689	.	C	A	11	11	22	0	0	22	0	0
3	62039718	.	G	A	10	9	19	0	1	20	0	0
3	62039813	.	T	A	10	14	24	0	2	26	0	0
3	62040555	.	G	A	13	20	33	0	1	34	0	0
3	62051107	.	C	T	20	3	23	0	1	24	0	0
3	62051125	.	C	T	14	2	16	0	4	20	0	0
3	62051395	.	A	G	14	9	23	0	1	24	0	0
3	62051660	.	T	A	8	16	24	0	0	24	0	0
3	62068866	.	A	G	7	10	17	0	0	17	0	0
3	62068871	.	A	G	5	9	14	0	0	14	0	0
3	62068902	.	C	T	0	7	7	0	5	12	0	0
3	62069739	.	G	T	9	12	21	0	1	22	0	0
3	62069815	.	G	A	15	12	27	0	0	27	0	0
3	62069821	.	G	A	14	15	29	0	0	29	0	0
3	62070890	.	G	A	8	8	16	0	1	17	0	0
3	62073967	.	T	A	15	15	30	0	0	30	0	0
3	62074030	.	T	C	5	14	19	0	1	20	0	0
3	62080117	.	G	C	20	12	32	0	4	36	0	0
3	62080172	.	G	A	4	18	22	0	6	28	0	0
3	62080183	.	G	A	18	8	26	0	3	29	0	0
3	62091398	.	A	G	2	6	8	0	0	8	0	0
3	62091632	.	T	A	7	7	14	0	0	14	0	0
3	62091660	.	T	A	11	5	16	0	0	16	0	0
3	62091880	.	C	T	9	9	18	0	1	19	0	0
3	62091975	.	C	A	16	13	29	0	1	30	0	0
3	62091995	.	G	T	19	11	30	0	2	32	0	0
3	62092025	.	C	T	1	13	14	0	13	27	0	0
3	62092262	.	T	A	11	8	19	0	0	19	0	0
3	62092279	.	A	T	9	7	16	0	1	17	0	0
3	62092666	.	G	A	9	10	19	0	0	19	0	0
3	62092715	.	A	C	13	12	25	0	0	25	0	0
3	62092749	.	G	C	12	11	23	0	1	24	0	0
3	62092801	.	C	T	12	8	20	0	1	21	0	0
3	62093241	.	T	A	16	12	28	0	2	30	0	0
3	62093955	.	T	A	1	4	5	0	0	5	0	0
3	62094006	.	A	C	2	3	5	0	0	5	0	0
3	62094190	.	A	C	5	2	7	0	0	7	0	0
3	62094327	.	C	T	8	5	13	0	0	13	0	0
3	62094645	.	A	G	4	7	11	0	3	14	0	0
3	62094686	.	C	A	0	3	3	0	10	13	0	0
3	62094849	.	A	G	10	5	15	0	0	15	0	0
3	62095051	.	G	A	4	7	11	0	0	11	0	0
3	62095175	.	T	A	2	6	8	0	0	8	0	0
3	62095572	.	T	A	5	4	9	0	1	10	0	0
3	62095573	.	G	T	5	5	10	0	0	10	0	0
3	62095734	.	G	A	3	3	6	0	0	6	0	0
3	62095887	.	T	C	4	1	5	0	4	9	0	0
3	62095940	.	G	C	3	9	12	0	0	12	0	0
3	62095980	.	A	C	4	8	12	0	0	12	0	0
3	62096021	.	G	A	4	3	7	0	0	7	0	0
3	62096912	.	A	G	2	3	5	0	0	5	0	0
3	62096937	.	C	T	1	2	3	0	1	4	0	0
3	62097490	.	A	T	5	7	12	0	3	15	0	0
3	62097548	.	A	T	6	13	19	0	0	19	0	0
3	62114615	.	C	T	1	10	11	0	6	17	0	0
3	62114663	.	C	T	5	11	16	0	1	17	0	0
3	62117154	.	C	T	1	6	7	0	9	16	0	0
3	62117187	.	C	T	8	9	17	0	1	18	0	0
3	62129751	.	T	C	6	3	9	0	0	9	0	0
3	62129754	.	G	A	6	3	9	0	0	9	0	0
3	62137708	.	C	T	8	5	13	0	1	14	0	0
3	62138746	.	A	G	5	4	9	0	1	10	0	0
3	62147737	.	G	A	3	6	9	0	0	9	0	0
3	62163609	.	G	C	0	2	2	0	1	3	0	0
3	62167857	.	A	G	1	0	1	0	3	4	0	0
3	62173443	.	A	T	4	5	9	0	0	9	0	0
3	62173459	.	C	T	1	5	6	0	0	6	0	0
3	62173503	.	G	T	3	5	8	0	0	8	0	0
3	62173546	.	C	T	3	5	8	0	0	8	0	0
3	62173593	.	T	C	4	7	11	0	0	11	0	0
3	62173628	.	T	C	7	7	14	0	0	14	0	0
3	62180638	.	G	A	5	4	9	0	2	11	0	0
3	62180788	.	G	A	3	5	8	0	1	9	0	0
3	62188877	.	A	G	2	4	6	0	1	7	0	0
3	62188883	.	G	A	3	4	7	0	1	8	0	0
3	62196977	.	C	T	8	7	15	0	0	15	0	0
3	62203509	.	G	A	12	7	19	0	1	20	0	0
3	62203653	.	T	A	3	5	8	0	0	8	0	0
3	62205906	.	C	A	8	5	13	3	0	16	0	0
3	62208678	.	C	T	2	3	5	0	0	5	0	0
3	62209024	.	A	G	9	7	16	1	1	18	0	0
3	62209033	.	A	G	7	5	12	0	1	13	0	0
3	62209183	.	A	G	6	0	6	0	7	13	0	0
3	62209216	.	A	G	3	9	12	0	0	12	0	0
3	62209325	.	A	G	6	5	11	0	1	12	0	0
3	62238692	.	G	A	1	4	5	4	0	9	0	0
3	62238721	.	C	T	4	3	7	0	1	8	0	0
3	62238997	.	T	G	5	1	6	1	4	11	0	0
3	62275598	.	G	A	4	3	7	0	0	7	0	0
3	62275743	.	T	C	3	4	7	0	0	7	0	0
3	62276009	.	A	T	7	3	10	0	0	10	0	0
3	62276101	.	G	A	5	5	10	0	0	10	0	0
3	62276104	.	A	G	5	4	9	0	0	9	0	0
3	62323165	.	T	C	5	4	9	0	0	9	0	0
3	62323384	.	G	A	3	5	8	2	0	10	0	0
3	62323405	.	G	A	0	2	2	2	0	4	0	0
3	62323510	.	C	G	9	3	12	0	0	12	0	0
3	62323564	.	C	T	3	7	10	0	0	10	0	0
3	62323579	.	A	G	9	0	9	0	4	13	0	0
3	62324063	.	A	T	3	7	10	0	0	10	0	0
3	62324312	.	T	C	3	2	5	3	1	9	0	0
3	62324346	.	C	A	4	2	6	0	0	6	0	0
3	62328846	.	G	C	9	3	12	6	0	18	0	0
3	62328938	.	A	C	2	4	6	0	0	6	0	0
3	62328970	.	A	G	6	3	9	0	0	9	0	0
3	62329097	.	G	C	6	2	8	0	1	9	0	0
3	62329274	.	T	A	0	8	8	0	0	8	0	0
3	62329285	.	T	A	3	4	7	0	1	8	0	0
3	62329545	.	G	T	3	6	9	0	0	9	0	0
3	62345335	.	A	G	3	4	7	0	0	7	0	0
3	62345471	.	A	T	5	3	8	0	0	8	0	0
3	62345588	.	T	A	4	6	10	0	0	10	0	0
3	62345686	.	T	A	6	7	13	0	0	13	0	0
3	62345708	.	G	A	3	6	9	0	1	10	0	0
3	62345770	.	A	T	4	9	13	0	0	13	0	0
3	62346026	.	C	A	3	3	6	0	0	6	0	0
3	62353679	.	G	T	10	5	15	0	0	15	0	0
3	62353952	.	G	A	12	8	20	0	3	23	0	0
3	62359440	.	G	T	15	9	24	0	0	24	0	0
3	62360484	.	C	T	17	11	28	0	0	28	0	0
3	62360736	.	C	A	3	4	7	0	0	7	0	0
3	62369864	.	G	A	21	17	38	0	0	38	0	0
3	62370068	.	A	G	19	14	33	0	1	34	0	0
3	62370381	.	A	G	9	16	25	0	1	26	0	0
3	62370476	.	G	A	11	9	20	0	1	21	0	0
3	62379739	.	C	T	12	16	28	0	3	31	0	0
3	62379771	.	T	A	13	8	21	0	0	21	0	0
3	62382863	.	A	G	38	28	66	0	0	66	0	0
3	62383314	.	T	G	54	10	64	0	0	64	0	0
3	62383315	.	G	T	54	10	64	0	0	64	0	0
3	62383438	.	G	A	37	22	59	0	1	60	0	0
3	62383439	.	A	G	36	23	59	0	0	59	0	0
3	62383565	.	T	A	29	22	51	0	2	53	0	0
3	62383589	.	A	C	25	20	45	2	2	49	0	0
3	62383610	.	G	C	27	2	29	3	18	50	0	0
3	62383706	.	C	T	36	23	59	4	0	63	0	0
3	62384055	.	G	A	13	16	29	6	0	35	0	0
3	62384112	.	T	A	3	3	6	3	1	10	0	0
3	62384208	.	C	T	4	36	40	0	22	62	0	0
3	62384219	.	G	A	39	15	54	0	5	59	0	0
3	62384423	.	C	G	31	36	67	0	2	69	0	0
3	62384428	.	T	A	38	28	66	0	1	67	0	0
3	62384565	.	C	G	34	25	59	1	6	66	0	0
3	62386420	.	T	C	31	3	34	0	30	64	0	0
3	62386955	.	G	T	30	27	57	0	4	61	0	0
3	62387141	.	C	T	5	22	27	1	31	59	0	0
3	62387144	.	C	T	25	29	54	1	4	59	0	0
3	62390349	.	A	G	40	19	59	0	0	59	0	0
3	62393321	.	G	A	31	10	41	0	2	43	0	0
3	62393337	.	C	T	30	15	45	0	1	46	0	0
3	62398784	.	C	A	0	2	2	0	2	4	0	0
3	62398790	.	G	A	2	2	4	0	0	4	0	0
3	62398820	.	A	G	2	4	6	0	0	6	0	0
3	62398836	.	G	C	3	2	5	0	0	5	0	0
3	62433064	.	C	T	6	7	13	0	0	13	0	0
3	62433138	.	T	G	9	9	18	0	0	18	0	0
3	62521137	.	G	A	1	3	4	0	1	5	0	0
3	62521142	.	T	C	2	0	2	0	3	5	0	0
3	62521263	.	T	A	11	11	22	0	2	24	0	0
3	62521956	.	G	A	13	9	22	0	1	23	0	0
3	62522063	.	A	T	11	15	26	0	2	28	0	0
3	62522065	.	G	T	9	16	25	0	2	27	0	0
3	62522238	.	A	G	10	8	18	0	0	18	0	0
3	62522742	.	C	A	6	6	12	0	0	12	0	0
3	62522750	.	G	C	6	5	11	0	0	11	0	0
3	62522804	.	C	T	1	6	7	0	8	15	0	0
3	62522808	.	C	T	2	6	8	0	8	16	0	0
3	62522899	.	C	G	17	9	26	0	2	28	0	0
3	62523031	.	A	G	10	15	25	3	2	30	0	0
3	62523032	.	A	T	14	11	25	3	2	30	0	0
3	62523325	.	G	T	13	16	29	0	3	32	0	0
3	62523502	.	G	A	9	8	17	0	1	18	0	0
3	62523550	.	C	T	10	9	19	0	2	21	0	0
3	62527379	.	G	T	14	4	18	0	2	20	0	0
3	62527397	.	G	T	7	6	13	0	5	18	0	0
4	308804	.	T	A	27	22	49	0	0	49	0	0
4	313108	.	A	C	24	28	52	1	4	57	0	0
4	314745	.	A	C	3	4	7	0	0	7	0	0
4	314824	.	G	A	2	2	4	0	0	4	0	0
4	314843	.	T	C	3	2	5	0	0	5	0	0
4	317091	.	A	G	21	15	36	0	1	37	0	0
4	317275	.	G	T	10	10	20	0	2	22	0	0
4	317658	.	C	T	2	2	4	0	1	5	0	0
4	317872	.	G	A	2	2	4	0	2	6	0	0
4	325126	.	G	A	6	4	10	0	0	10	0	0
4	325136	.	G	A	4	7	11	0	1	13	1	0
4	325161	.	A	C	6	0	6	0	13	19	0	0
4	329743	.	G	A	11	9	20	0	2	22	0	0
4	329746	.	A	G	10	11	21	0	0	21	0	0
4	332491	.	G	T	1	7	8	0	4	12	0	0
4	343328	.	T	C	5	2	7	0	1	8	0	0
4	344264	.	T	G	2	3	5	0	0	5	0	0
4	348201	.	G	A	0	4	4	0	8	13	1	0
4	348216	.	C	T	7	7	14	0	0	14	0	0
4	348297	.	T	C	8	5	13	0	2	15	0	0
4	349298	.	T	C	4	3	7	0	0	7	0	0
4	349304	.	A	G	4	3	7	0	0	7	0	0
4	349490	.	A	C	7	7	14	0	0	14	0	0
4	349514	.	T	C	7	8	15	0	1	16	0	0
4	349886	.	T	C	6	5	11	0	0	11	0	0
4	350652	.	C	T	2	5	7	0	0	7	0	0
4	351055	.	G	A	7	5	12	0	1	13	0	0
4	351654	.	T	A	5	4	9	0	0	9	0	0
4	351840	.	G	C	5	4	9	0	1	10	0	0
4	351845	.	A	C	5	3	8	0	1	9	0	0
4	352031	.	C	G	3	8	11	0	0	11	0	0
4	352284	.	A	G	10	0	10	0	8	18	0	0
4	352289	.	T	C	11	7	18	0	0	18	0	0
4	352504	.	T	C	13	11	24	0	0	24	0	0
4	353049	.	A	T	16	8	24	0	0	24	0	0
4	353064	.	C	G	14	8	22	0	0	22	0	0
4	353247	.	T	C	10	3	13	0	0	13	0	0
4	353379	.	A	T	6	15	21	0	1	22	0	0
4	353481	.	A	G	4	0	4	0	9	13	0	0
4	353638	.	C	T	9	5	14	0	0	14	0	0
4	353778	.	T	A	4	5	9	0	0	9	0	0
4	357887	.	T	G	8	9	17	0	1	18	0	0
4	357954	.	G	A	9	4	13	0	1	14	0	0
4	358080	.	T	C	6	7	13	0	0	13	0	0
4	362282	.	C	T	9	14	23	0	2	25	0	0
4	367532	.	T	G	8	0	8	0	6	14	0	0
4	385092	.	C	T	19	12	31	0	4	35	0	0
4	385576	.	T	A	2	3	5	0	0	5	0	0
4	385625	.	A	T	2	2	4	0	0	4	0	0
4	385668	.	G	A	4	5	9	0	0	9	0	0
4	385710	.	T	C	8	10	18	0	0	18	0	0
4	386014	.	A	C	17	7	24	0	2	26	0	0
4	386037	.	T	G	17	9	26	0	0	26	0	0
4	386085	.	G	A	11	7	18	0	0	18	0	0
4	386124	.	C	A	4	3	7	0	4	11	0	0
4	386537	.	T	A	17	17	34	0	7	41	0	0
4	386538	.	T	A	27	16	43	0	2	45	0	0
4	386839	.	A	G	34	0	34	0	3	37	0	0
4	386961	.	G	A	34	17	51	1	5	57	0	0
4	394020	.	T	C	36	32	68	0	4	72	0	0
4	397913	.	A	G	10	3	13	0	1	14	0	0
4	647752	.	G	T	12	7	19	0	0	19	0	0
4	659276	.	C	T	7	14	21	0	1	22	0	0
4	659345	.	T	C	5	13	18	0	1	19	0	0
4	660571	.	G	A	9	9	18	0	1	20	1	0
4	660649	.	T	A	11	13	24	0	1	25	0	0
4	660655	.	G	A	2	15	17	0	11	28	0	0
4	660715	.	T	C	11	14	25	0	1	26	0	0
4	667358	.	T	C	15	13	28	0	0	28	0	0
4	667382	.	A	G	16	0	16	0	9	25	0	0
4	674838	.	T	C	10	16	26	0	1	27	0	0
4	675080	.	T	C	8	7	15	0	3	18	0	0
4	676885	.	A	G	5	5	10	0	2	13	1	0
4	676942	.	A	G	9	8	17	0	0	17	0	0
4	678853	.	C	T	9	7	16	0	0	16	0	0
4	679441	.	C	G	2	12	14	0	20	34	0	0
4	680314	.	G	T	14	3	17	0	0	17	0	0
4	680320	.	C	T	15	4	19	0	0	19	0	0
4	680359	.	C	T	11	7	18	0	0	18	0	0
4	680395	.	T	C	14	0	14	0	7	21	0	0
4	680404	.	G	A	12	8	20	0	2	22	0	0
4	681595	.	G	A	10	4	14	0	0	14	0	0
4	686987	.	G	A	0	5	5	0	5	10	0	0
4	686999	.	C	G	9	6	15	0	0	15	0	0
4	687083	.	A	G	10	1	11	0	10	21	0	0
4	694254	.	T	C	4	5	9	0	0	9	0	0
4	694680	.	A	C	8	6	14	0	0	14	0	0
4	694718	.	G	A	7	9	16	0	0	16	0	0
4	694741	.	T	G	6	7	13	0	0	13	0	0
4	694757	.	A	T	7	7	14	0	0	14	0	0
4	700281	.	A	C	7	11	18	0	3	21	0	0
4	700284	.	G	T	1	9	10	0	12	22	0	0
4	700563	.	G	T	8	3	11	0	0	11	0	0
4	700569	.	G	A	2	3	5	0	6	11	0	0
4	700634	.	A	C	1	2	3	0	0	3	0	0
4	702061	.	C	G	2	13	15	0	0	15	0	0
4	702130	.	G	A	4	15	19	0	0	19	0	0
4	702138	.	C	A	4	15	19	0	0	19	0	0
4	736442	.	A	G	8	13	21	0	1	22	0	0
4	737636	.	A	T	5	4	9	0	1	10	0	0
4	737811	.	A	G	8	5	13	0	1	14	0	0
4	737883	.	T	A	5	6	11	1	0	12	0	0
4	737927	.	T	G	10	7	17	1	0	18	0	0
4	740435	.	A	T	8	8	16	0	0	16	0	0
4	740921	.	T	C	5	1	6	0	2	8	0	0
4	740965	.	T	G	8	5	13	1	2	16	0	0
4	749803	.	G	A	18	12	30	0	2	32	0	0
4	749989	.	G	T	13	12	25	0	3	28	0	0
4	750016	.	T	C	13	0	13	0	10	23	0	0
4	750526	.	C	G	12	10	22	0	1	23	0	0
4	750531	.	C	T	14	9	23	0	1	24	0	0
4	750661	.	C	T	3	6	9	0	15	24	0	0
4	751275	.	A	G	10	11	21	0	1	22	0	0
4	751546	.	G	A	18	10	28	0	0	28	0	0
4	751553	.	C	T	16	11	27	0	1	28	0	0
4	751640	.	T	G	11	9	20	0	1	21	0	0
4	753723	.	T	C	5	0	5	0	8	13	0	0
4	755539	.	C	T	10	8	18	0	1	19	0	0
4	757405	.	C	T	10	10	20	0	0	20	0	0
4	757613	.	T	C	13	16	29	0	1	30	0	0
4	760555	.	G	T	6	6	12	0	0	12	0	0
4	765112	.	A	G	10	10	20	0	0	20	0	0
4	766575	.	G	A	9	9	18	0	0	18	0	0
4	766588	.	G	A	7	7	14	0	0	14	0	0
4	766613	.	A	C	6	7	13	1	0	14	0	0
4	769533	.	A	T	15	9	24	0	1	25	0	0
4	769726	.	G	A	12	21	33	1	1	35	0	0
4	772363	.	C	T	14	10	24	0	3	27	0	0
4	776550	.	G	T	10	15	25	0	1	26	0	0
4	777976	.	A	G	10	15	25	0	1	26	0	0
4	778111	.	G	A	19	11	30	0	1	31	0	0
4	779310	.	G	A	18	12	30	0	0	30	0	0
4	779363	.	T	C	18	0	18	0	11	29	0	0
4	779429	.	A	G	16	9	25	0	1	26	0	0
4	779442	.	G	A	15	9	24	0	3	27	0	0
4	779523	.	T	C	1	3	4	0	0	4	0	0
4	783816	.	G	T	15	21	36	0	1	37	0	0
4	783835	.	A	G	21	20	41	0	0	41	0	0
4	784002	.	T	A	33	14	47	0	0	47	0	0
4	784177	.	T	C	33	21	54	0	3	57	0	0
4	784325	.	A	T	14	16	30	0	1	31	0	0
4	784373	.	T	A	5	12	17	0	0	17	0	0
4	784435	.	G	T	8	5	13	0	0	13	0	0
4	784472	.	T	C	3	2	5	0	0	5	0	0
4	784473	.	A	C	3	2	5	0	0	5	0	0
4	784642	.	G	A	11	7	18	0	0	18	0	0
4	784733	.	T	A	7	3	10	0	0	10	0	0
4	784854	.	C	A	6	3	9	0	0	9	0	0
4	784990	.	T	A	19	13	32	1	2	35	0	0
4	785011	.	T	C	16	9	25	1	3	29	0	0
4	785060	.	T	A	16	4	20	0	1	21	0	0
4	785132	.	G	A	24	15	39	0	0	39	0	0
4	788970	.	G	C	20	0	20	0	21	41	0	0
4	789589	.	A	G	29	16	45	0	1	46	0	0
4	798743	.	G	C	5	6	11	0	0	11	0	0
4	798804	.	G	A	10	12	22	0	0	22	0	0
4	798850	.	A	C	16	15	31	0	1	32	0	0
4	798861	.	G	T	18	12	30	0	0	30	0	0
4	799006	.	G	T	15	18	33	0	1	34	0	0
4	799090	.	T	C	16	13	29	0	1	30	0	0
4	799127	.	T	G	15	13	28	0	0	28	0	0
4	799245	.	G	A	16	16	32	0	0	32	0	0
4	799385	.	C	G	3	7	10	0	1	11	0	0
4	799475	.	A	G	15	13	28	0	1	29	0	0
4	799513	.	G	A	16	19	35	0	0	35	0	0
4	799620	.	C	T	24	9	33	0	1	34	0	0
4	799643	.	T	A	25	8	33	0	0	33	0	0
4	799933	.	C	T	24	20	44	0	2	46	0	0
4	800027	.	C	T	7	19	26	0	1	27	0	0
4	800094	.	A	G	17	23	40	0	3	43	0	0
4	800113	.	A	G	19	20	39	0	2	41	0	0
4	800363	.	C	T	2	18	20	0	27	47	0	0
4	800520	.	T	C	29	21	50	1	0	51	0	0
4	802909	.	T	A	21	24	45	0	4	49	0	0
4	803862	.	T	C	24	0	24	0	26	50	0	0
4	806319	.	G	A	16	19	35	0	0	36	1	0
4	806322	.	T	C	14	20	34	0	3	37	0	0
4	807895	.	C	G	17	22	39	0	4	43	0	0
4	807898	.	A	G	18	21	39	0	3	42	0	0
4	808421	.	A	G	16	24	40	0	0	40	0	0
4	809456	.	A	G	23	15	38	0	2	41	1	0
4	809512	.	T	C	19	0	19	0	23	42	0	0
4	809549	.	A	G	13	20	33	0	1	34	0	0
4	813157	.	G	A	9	12	21	0	4	25	0	0
4	813226	.	A	G	20	19	39	0	1	40	0	0
4	823659	.	G	A	1	3	4	0	0	4	0	0
4	823755	.	C	A	0	2	2	0	1	3	0	0
4	824127	.	A	G	1	2	3	0	0	3	0	0
4	824682	.	A	G	1	2	3	0	0	3	0	0
4	862009	.	A	G	7	4	11	0	1	12	0	0
4	864324	.	T	A	4	4	8	0	0	8	0	0
4	864712	.	C	T	5	6	11	0	0	11	0	0
4	864739	.	G	C	4	5	9	0	1	10	0	0
4	867601	.	G	C	5	4	9	0	1	10	0	0
4	867692	.	A	C	1	3	4	0	0	4	0	0
4	870833	.	C	T	1	2	3	0	3	6	0	0
4	870876	.	C	T	5	4	9	0	0	9	0	0
4	872296	.	T	C	3	0	3	0	3	6	0	0
4	872356	.	A	G	4	2	6	0	0	6	0	0
4	874241	.	G	T	7	2	9	0	1	10	0	0
4	874323	.	C	T	5	3	8	0	0	8	0	0
4	875350	.	A	G	5	2	7	0	0	7	0	0
4	880033	.	A	G	4	5	9	0	0	9	0	0
4	880201	.	A	C	6	2	8	0	0	8	0	0
4	880275	.	A	G	2	4	6	0	1	7	0	0
4	880286	.	C	T	2	4	6	0	0	6	0	0
4	880318	.	G	T	4	2	6	0	0	6	0	0
4	880323	.	C	G	4	2	6	0	0	6	0	0
4	880394	.	A	G	3	2	5	0	0	5	0	0
4	880402	.	G	A	3	2	5	0	0	5	0	0
4	880692	.	T	G	7	6	13	0	0	13	0	0
4	880693	.	G	T	7	6	13	0	0	13	0	0
4	881997	.	A	C	6	3	9	0	1	10	0	0
4	882294	.	A	T	3	3	6	0	0	6	0	0
4	882808	.	C	T	4	1	5	14	7	26	0	0
4	883799	.	T	C	2	2	4	0	1	5	0	0
4	889824	.	T	C	1	2	3	0	0	3	0	0
4	890077	.	A	G	1	2	3	0	0	3	0	0
4	905657	.	A	G	1	4	5	0	0	5	0	0
4	905801	.	A	C	4	3	7	0	0	7	0	0
4	929705	.	G	C	1	0	1	0	3	4	0	0
4	958978	.	A	T	1	7	8	0	0	8	0	0
4	959015	.	T	C	4	4	8	0	1	9	0	0
4	961542	.	G	A	7	3	10	0	1	11	0	0
4	963452	.	A	G	4	5	9	0	0	9	0	0
4	967974	.	C	T	11	7	18	1	0	19	0	0
4	968001	.	G	A	2	9	11	1	8	20	0	0
4	968121	.	T	C	11	6	17	0	0	17	0	0
4	969475	.	A	T	10	5	15	0	0	15	0	0
4	969486	.	T	G	11	0	11	0	5	16	0	0
4	970689	.	A	G	6	0	6	0	6	12	0	0
4	971765	.	A	G	5	10	15	0	0	15	0	0
4	971842	.	G	C	0	7	7	0	5	12	0	0
4	974482	.	C	T	10	12	22	0	1	23	0	0
4	975735	.	G	C	1	11	12	0	11	23	0	0
4	975758	.	C	T	11	14	25	0	0	25	0	0
4	975792	.	G	C	1	8	9	0	14	23	0	0
4	975938	.	T	C	17	6	23	0	0	23	0	0
4	982892	.	G	A	4	2	6	0	0	6	0	0
4	982893	.	T	C	2	4	6	0	0	6	0	0
4	986350	.	C	A	2	3	5	0	4	9	0	0
4	1054775	.	G	A	15	15	30	0	0	30	0	0
4	1054866	.	G	T	32	6	38	1	4	44	1	0
4	1054868	.	G	A	26	5	31	1	12	44	0	0
4	1055008	.	C	T	38	12	50	0	0	50	0	0
4	1055081	.	C	T	27	18	45	0	1	46	0	0
4	1055095	.	T	A	29	18	47	0	1	48	0	0
4	1055149	.	A	G	16	8	24	0	0	24	0	0
4	1055454	.	T	G	29	30	59	0	4	63	0	0
4	1055526	.	T	C	24	27	51	3	1	55	0	0
4	1055671	.	G	A	23	26	49	0	4	53	0	0
4	1055724	.	C	T	29	22	51	0	4	55	0	0
4	1055770	.	A	G	37	15	52	0	0	52	0	0
4	1055807	.	G	C	29	27	56	2	6	64	0	0
4	1055831	.	T	A	29	18	47	2	5	54	0	0
4	1055863	.	A	T	20	28	48	2	4	54	0	0
4	1055868	.	G	A	29	22	51	2	2	55	0	0
4	1389028	.	A	G	10	13	23	0	0	23	0	0
4	1392957	.	G	A	10	8	18	0	0	18	0	0
4	1393004	.	T	A	10	7	17	0	2	19	0	0
4	1470672	.	T	C	4	0	4	0	6	10	0	0
4	1652192	.	C	T	1	8	9	0	9	18	0	0
4	1789473	.	A	T	5	3	8	0	0	8	0	0
4	2045053	.	T	A	2	2	4	0	1	5	0	0
4	2549069	.	T	C	3	4	7	0	1	8	0	0
4	2549080	.	T	C	4	2	6	0	0	6	0	0
4	2665987	.	T	C	6	6	12	0	0	12	0	0
4	3338195	.	A	G	1	3	4	0	0	4	0	0
4	4111260	.	G	T	4	0	4	0	11	15	0	0
4	4228648	.	G	A	5	2	7	11	3	21	0	0
4	4228654	.	G	A	3	4	7	11	1	19	0	0
4	4714437	.	G	A	4	3	7	0	0	7	0	0
4	5365307	.	C	T	5	4	9	0	0	9	0	0
4	5365325	.	C	T	6	4	10	0	0	10	0	0
4	5450518	.	C	G	3	4	7	0	0	7	0	0
4	5910105	.	A	G	1	6	7	0	0	7	0	0
4	6432112	.	G	A	26	11	37	0	1	38	0	0
4	6436701	.	G	A	22	19	41	0	1	42	0	0
4	6436845	.	G	A	17	23	40	0	1	41	0	0
4	6449366	.	G	A	16	11	27	0	0	27	0	0
4	6455849	.	G	A	18	14	32	0	0	32	0	0
4	6506457	.	G	A	1	4	5	0	0	5	0	0
4	6507418	.	C	T	1	2	3	0	0	3	0	0
4	6508482	.	A	C	1	2	3	0	0	3	0	0
4	6552491	.	T	A	5	3	8	0	0	8	0	0
4	6578133	.	A	G	1	3	4	0	0	4	0	0
4	6578421	.	T	C	0	2	2	0	0	3	1	0
4	6578428	.	C	T	1	2	3	0	0	3	0	0
4	6639440	.	A	G	9	10	19	0	2	21	0	0
4	6639665	.	G	A	13	16	29	1	1	31	0	0
4	6639786	.	C	T	16	7	23	0	1	24	0	0
4	6640145	.	G	C	10	10	20	0	0	20	0	0
4	6640156	.	T	C	9	11	20	0	0	20	0	0
4	6645994	.	C	T	11	6	17	0	3	20	0	0
4	6646283	.	A	C	14	8	22	0	1	23	0	0
4	6646851	.	G	A	14	10	24	0	1	25	0	0
4	6737471	.	C	T	1	3	4	0	0	4	0	0
4	6749054	.	T	C	1	5	6	0	0	6	0	0
4	6749060	.	C	G	1	4	5	0	1	6	0	0
4	6749222	.	C	T	3	2	5	0	0	5	0	0
4	6799942	.	A	G	19	20	39	0	1	40	0	0
4	6800153	.	T	C	18	18	36	0	3	39	0	0
4	6800162	.	C	T	17	21	38	0	1	39	0	0
4	6800393	.	G	A	21	22	43	0	6	49	0	0
4	6802173	.	T	G	15	27	42	0	3	45	0	0
4	6802506	.	A	C	25	22	47	0	1	48	0	0
4	6802518	.	C	G	2	23	25	0	24	49	0	0
4	6877975	.	T	C	3	4	7	0	0	7	0	0
4	6884753	.	C	T	7	4	11	0	0	11	0	0
4	6902159	.	C	T	5	6	11	0	0	11	0	0
4	6909858	.	G	A	6	6	12	0	0	12	0	0
4	6940374	.	C	T	7	9	16	0	0	16	0	0
4	6946831	.	G	A	7	8	15	0	0	15	0	0
4	6948909	.	C	T	8	8	16	0	0	16	0	0
4	6948918	.	C	A	6	7	13	0	0	13	0	0
4	6960365	.	G	A	2	6	8	0	10	18	0	0
4	6989731	.	G	A	3	12	15	0	11	26	0	0
4	6990096	.	C	T	13	11	24	0	1	25	0	0
4	6990392	.	G	T	5	4	9	0	0	9	0	0
4	6990421	.	T	C	4	7	11	0	1	12	0	0
4	6990621	.	G	A	0	5	5	0	4	9	0	0
4	6990632	.	A	G	6	5	11	0	0	11	0	0
4	6990682	.	G	A	3	8	11	0	0	11	0	0
4	6990882	.	C	T	9	10	19	0	1	20	0	0
4	6990886	.	C	A	9	9	18	0	3	21	0	0
4	6991150	.	C	T	1	6	7	0	0	7	0	0
4	6991220	.	T	A	6	7	13	0	0	13	0	0
4	6991272	.	G	A	7	4	11	0	0	11	0	0
4	6991480	.	T	G	5	5	10	0	0	10	0	0
4	6991582	.	C	A	10	8	18	0	0	18	0	0
4	6991764	.	G	T	7	6	13	0	0	13	0	0
4	6991825	.	C	A	4	9	13	0	1	14	0	0
4	6991975	.	T	A	5	11	16	0	0	16	0	0
4	6992348	.	C	A	20	15	35	0	0	35	0	0
4	6992808	.	T	C	7	13	20	0	0	20	0	0
4	6992918	.	G	C	12	12	24	0	0	24	0	0
4	7211013	.	G	A	17	21	38	0	2	40	0	0
4	7211097	.	C	T	13	25	38	0	0	38	0	0
4	7211264	.	A	G	14	23	37	0	0	37	0	0
4	7211364	.	C	T	0	11	11	0	16	27	0	0
4	7212228	.	G	A	17	14	31	0	0	31	0	0
4	7212236	.	G	A	17	12	29	0	0	29	0	0
4	7212342	.	G	A	8	12	20	0	0	20	0	0
4	7212461	.	G	A	16	14	30	0	1	31	0	0
4	7212606	.	A	G	22	11	33	0	1	34	0	0
4	7212624	.	G	A	18	9	27	0	1	28	0	0
4	7222118	.	G	T	15	7	22	0	0	22	0	0
4	7415423	.	C	T	1	4	5	0	0	5	0	0
4	7465914	.	T	C	5	4	9	0	0	9	0	0
4	7471682	.	A	T	4	7	11	0	1	12	0	0
4	7476736	.	C	T	2	8	10	0	0	10	0	0
4	7479985	.	A	G	2	2	4	0	0	4	0	0
4	7546046	.	T	A	12	10	22	0	0	22	0	0
4	7653670	.	T	C	3	2	5	0	0	5	0	0
4	7653671	.	T	A	3	2	5	0	0	5	0	0
4	7653887	.	C	T	8	3	11	0	0	11	0	0
4	7659924	.	G	A	3	3	6	0	1	7	0	0
4	7664811	.	G	A	4	6	10	0	0	10	0	0
4	7665110	.	T	A	5	5	10	0	2	12	0	0
4	7666604	.	A	C	3	0	3	0	4	7	0	0
4	7668432	.	G	A	3	4	7	0	0	7	0	0
4	7668510	.	A	G	4	6	10	0	0	10	0	0
4	7668516	.	G	A	3	5	8	0	1	9	0	0
4	7713041	.	A	G	3	0	3	0	4	7	0	0
4	7713070	.	T	C	3	4	7	0	0	7	0	0
4	7713360	.	C	A	2	3	5	0	0	5	0	0
4	7718868	.	C	T	12	15	27	1	1	29	0	0
4	7726665	.	G	A	4	14	18	0	0	18	0	0
4	7726752	.	T	C	13	12	25	0	0	25	0	0
4	7729807	.	G	A	13	15	28	0	0	28	0	0
4	7737468	.	G	T	9	13	22	0	0	22	0	0
4	7743092	.	C	T	2	15	17	0	11	28	0	0
4	8027183	.	A	T	3	2	5	0	0	5	0	0
4	8046099	.	C	T	18	5	23	0	0	23	0	0
4	8609608	.	T	A	0	4	4	0	2	6	0	0
4	9604014	.	T	C	7	2	9	0	0	9	0	0
4	9618867	.	A	C	11	12	23	0	0	23	0	0
4	9632179	.	A	G	1	0	1	0	3	4	0	0
4	9632188	.	C	A	1	3	4	0	0	4	0	0
4	9785985	.	C	T	1	5	6	0	1	7	0	0
4	10044556	.	G	A	29	17	46	0	5	51	0	0
4	10044605	.	C	T	22	20	42	0	4	46	0	0
4	10044777	.	A	G	23	23	46	0	2	48	0	0
4	10045599	.	C	T	13	22	35	0	3	38	0	0
4	10045605	.	A	G	14	23	37	0	1	38	0	0
4	10048885	.	T	C	1	2	3	0	0	3	0	0
4	10124153	.	A	C	2	5	7	0	0	7	0	0
4	10130239	.	C	A	2	4	6	0	0	6	0	0
4	10366043	.	G	A	2	4	6	0	2	8	0	0
4	10366045	.	C	T	4	4	8	0	0	8	0	0
4	10366557	.	A	T	9	3	12	0	0	12	0	0
4	10366710	.	G	A	5	5	10	0	1	11	0	0
4	10366884	.	G	A	4	6	10	0	2	12	0	0
4	10367151	.	C	T	5	3	8	0	0	8	0	0
4	10367313	.	C	T	6	3	9	0	0	9	0	0
4	10367349	.	G	A	8	5	13	0	1	14	0	0
4	10367610	.	C	T	7	10	17	0	0	17	0	0
4	10367619	.	C	T	5	10	15	0	1	16	0	0
4	10553452	.	C	T	11	11	22	0	0	22	0	0
4	10553515	.	C	A	6	8	14	0	0	14	0	0
4	10553528	.	G	A	10	4	14	0	1	15	0	0
4	10558403	.	G	A	0	7	7	0	8	15	0	0
4	10558510	.	T	C	4	3	7	0	0	7	0	0
4	10559042	.	A	T	10	4	14	0	0	14	0	0
4	10559621	.	C	A	8	8	16	0	1	17	0	0
4	10560246	.	G	A	10	10	20	0	2	22	0	0
4	10560253	.	A	T	8	13	21	0	1	22	0	0
4	10560284	.	C	T	12	14	26	0	1	27	0	0
4	10560437	.	A	C	14	15	29	0	0	29	0	0
4	10560507	.	C	T	12	10	22	0	0	22	0	0
4	10560607	.	A	G	3	4	7	0	3	10	0	0
4	10560820	.	T	G	6	3	9	0	0	9	0	0
4	10560916	.	C	T	8	5	13	0	2	15	0	0
4	10561101	.	T	A	10	26	36	0	1	37	0	0
4	10612052	.	T	G	9	0	9	0	6	15	0	0
4	10614856	.	T	C	4	8	12	0	2	14	0	0
4	10614862	.	T	C	4	7	11	0	2	13	0	0
4	10687691	.	C	G	1	2	3	0	0	3	0	0
4	10704373	.	C	T	2	2	4	0	0	4	0	0
4	10704375	.	A	G	2	1	3	0	1	4	0	0
4	10712963	.	T	G	1	3	4	0	0	4	0	0
4	10756086	.	A	G	1	3	4	0	0	4	0	0
4	10756892	.	C	T	1	4	5	0	0	5	0	0
4	10757096	.	A	G	2	5	7	0	0	7	0	0
4	10761803	.	C	G	2	0	2	0	7	9	0	0
4	10762071	.	G	A	7	3	10	3	0	13	0	0
4	10762087	.	G	A	0	2	2	3	5	10	0	0
4	10762335	.	T	A	2	3	5	0	0	5	0	0
4	10784418	.	C	T	2	3	5	0	0	5	0	0
4	10791979	.	C	T	0	2	2	15	3	20	0	0
4	10812042	.	C	G	0	2	2	4	3	9	0	0
4	10816272	.	A	G	2	0	2	0	3	5	0	0
4	10825618	.	G	A	1	6	7	0	0	7	0	0
4	10825629	.	G	A	2	4	6	0	0	6	0	0
4	10826346	.	C	T	1	2	3	0	0	3	0	0
4	10826385	.	C	T	2	2	4	0	0	4	0	0
4	10888842	.	G	C	0	7	7	0	5	12	0	0
4	10888890	.	T	A	6	3	9	0	1	10	0	0
4	10888935	.	C	A	4	3	7	0	0	7	0	0
4	10890516	.	G	T	7	5	12	0	0	12	0	0
4	10890822	.	G	A	4	12	16	0	1	17	0	0
4	10896354	.	G	C	8	6	14	0	0	14	0	0
4	10896570	.	G	A	8	10	18	0	0	18	0	0
4	10896582	.	G	T	7	8	15	0	0	15	0	0
4	10896618	.	C	T	4	3	7	0	1	8	0	0
4	10896620	.	A	T	2	3	5	0	3	8	0	0
4	10904784	.	C	T	7	9	16	0	0	16	0	0
4	10905246	.	C	T	8	12	20	0	0	20	0	0
4	10906254	.	C	T	7	5	12	0	0	12	0	0
4	10907182	.	C	A	6	2	8	0	2	10	0	0
4	10908001	.	C	T	8	21	29	0	1	30	0	0
4	10908182	.	T	C	7	5	12	0	0	12	0	0
4	10908294	.	C	T	10	9	19	0	0	19	0	0
4	10908726	.	T	C	9	2	11	0	0	11	0	0
4	10974722	.	G	A	2	3	5	0	0	5	0	0
4	10974747	.	A	T	6	2	8	0	0	8	0	0
4	10975629	.	A	G	7	6	13	0	0	13	0	0
4	10975632	.	G	A	6	6	12	0	0	12	0	0
4	10976944	.	G	A	3	5	8	0	0	8	0	0
4	10982291	.	C	T	6	6	12	0	0	12	0	0
4	10982339	.	T	G	7	5	12	0	0	12	0	0
4	10982390	.	C	A	1	4	5	0	6	11	0	0
4	10987895	.	T	A	3	2	5	0	0	5	0	0
4	10988147	.	A	G	4	2	6	0	0	6	0	0
4	10988546	.	G	C	12	5	17	0	0	17	0	0
4	10988581	.	C	T	2	8	10	0	4	14	0	0
4	10994841	.	G	A	2	5	7	0	0	7	0	0
4	10994967	.	A	G	5	2	7	0	0	7	0	0
4	10995138	.	G	A	8	5	13	0	0	13	0	0
4	11024616	.	C	T	0	4	4	0	1	5	0	0
4	11050883	.	T	G	1	1	2	0	1	3	0	0
4	11050893	.	G	A	1	2	3	0	1	4	0	0
4	11051552	.	C	T	0	2	2	0	1	3	0	0
4	11053745	.	T	C	2	7	9	0	0	9	0	0
4	11053771	.	G	A	0	9	9	0	3	12	0	0
4	11053851	.	G	A	0	2	2	0	7	9	0	0
4	11054484	.	A	C	6	8	14	0	0	14	0	0
4	11054509	.	G	C	6	8	14	0	0	14	0	0
4	11311383	.	G	A	11	11	22	1	1	24	0	0
4	11311632	.	T	A	5	5	10	0	0	10	0	0
4	11311751	.	C	T	3	4	7	0	1	8	0	0
4	11344781	.	G	T	6	6	12	0	0	12	0	0
4	11344964	.	G	A	8	5	13	0	1	14	0	0
4	11348745	.	A	T	9	6	15	0	0	15	0	0
4	11348754	.	C	T	11	7	18	0	0	18	0	0
4	11356462	.	C	T	7	4	11	0	0	11	0	0
4	11366316	.	G	A	1	7	8	0	9	17	0	0
4	11366360	.	T	C	13	7	20	0	1	21	0	0
4	11366481	.	G	A	16	6	22	0	3	25	0	0
4	11366848	.	A	G	24	15	39	0	0	39	0	0
4	11366868	.	T	A	19	11	30	0	3	33	0	0
4	11366984	.	T	A	14	9	23	0	3	26	0	0
4	11367668	.	T	A	9	10	19	0	0	19	0	0
4	11367884	.	C	T	12	8	20	0	0	20	0	0
4	11367896	.	A	G	12	10	22	0	0	22	0	0
4	11368076	.	G	T	18	18	36	0	2	38	0	0
4	11368143	.	C	T	21	19	40	0	1	41	0	0
4	11368171	.	G	A	4	17	21	0	23	44	0	0
4	11387698	.	A	T	6	10	16	0	0	16	0	0
4	11389061	.	T	C	6	10	16	0	0	16	0	0
4	11389070	.	A	C	7	11	18	0	0	18	0	0
4	11389171	.	C	G	3	0	3	0	9	12	0	0
4	11389372	.	G	C	1	8	9	0	8	17	0	0
4	11389441	.	T	A	11	10	21	0	2	23	0	0
4	11411648	.	C	T	5	2	7	0	3	10	0	0
4	11414567	.	A	T	4	4	8	0	1	9	0	0
4	11414799	.	T	C	6	7	13	0	0	13	0	0
4	11414824	.	A	T	6	6	12	0	0	12	0	0
4	11414937	.	A	G	7	4	11	0	1	12	0	0
4	11415150	.	G	A	1	6	7	0	9	17	1	0
4	11415471	.	G	A	5	14	19	0	0	19	0	0
4	11415483	.	G	A	4	10	14	0	0	14	0	0
4	11415852	.	A	T	6	5	11	0	0	11	0	0
4	11415853	.	G	A	6	5	11	0	0	11	0	0
4	11416701	.	C	T	16	10	26	0	3	29	0	0
4	11416758	.	T	A	20	10	30	0	2	32	0	0
4	11416854	.	G	A	13	18	31	0	2	33	0	0
4	11417753	.	G	T	6	8	14	0	0	14	0	0
4	11417829	.	C	A	9	6	15	0	1	16	0	0
4	11418261	.	G	T	9	3	12	0	0	12	0	0
4	11418969	.	C	T	13	10	23	0	1	24	0	0
4	11419163	.	C	G	5	9	14	0	0	14	0	0
4	11419836	.	A	T	12	10	22	0	2	24	0	0
4	11420136	.	C	T	11	15	26	0	1	27	0	0
4	11422664	.	T	C	21	18	39	0	0	39	0	0
4	11427820	.	A	C	26	17	43	1	1	45	0	0
4	11431768	.	A	C	13	19	32	0	0	32	0	0
4	11432273	.	T	C	15	12	27	0	0	27	0	0
4	11432535	.	C	G	18	0	18	0	15	33	0	0
4	11439544	.	C	A	9	10	19	0	3	22	0	0
4	11441789	.	T	A	25	17	42	0	6	48	0	0
4	11442085	.	C	T	19	25	44	1	1	46	0	0
4	11444080	.	C	T	23	21	44	0	0	44	0	0
4	11444209	.	C	A	18	19	37	0	2	39	0	0
4	11445978	.	T	C	17	17	34	1	0	35	0	0
4	11446365	.	A	T	21	15	36	0	1	37	0	0
4	11446703	.	C	T	12	11	23	0	0	23	0	0
4	11447037	.	T	G	19	17	36	0	2	38	0	0
4	11447144	.	G	A	21	19	40	0	0	40	0	0
4	11447226	.	T	G	12	2	14	0	19	33	0	0
4	11447251	.	T	C	14	16	30	0	3	33	0	0
4	11447599	.	C	T	27	18	45	0	1	46	0	0
4	11447632	.	C	G	20	21	41	0	1	42	0	0
4	11448403	.	G	A	2	21	23	0	24	47	0	0
4	11448680	.	A	G	16	24	40	0	2	42	0	0
4	11458318	.	T	G	6	3	9	0	0	9	0	0
4	11461181	.	C	G	2	5	7	0	0	7	0	0
4	11461479	.	C	T	6	4	10	0	0	10	0	0
4	11461865	.	T	A	7	2	9	0	1	10	0	0
4	11461914	.	A	G	1	7	8	0	0	8	0	0
4	11462054	.	A	T	11	6	17	0	0	17	0	0
4	11470854	.	A	G	21	15	36	0	2	38	0	0
4	11470920	.	C	T	27	21	48	0	3	51	0	0
4	11471203	.	T	C	20	28	48	0	1	49	0	0
4	11472674	.	T	C	27	23	50	0	2	52	0	0
4	11476406	.	T	C	31	21	52	2	4	58	0	0
4	11476472	.	G	A	5	21	26	0	35	61	0	0
4	11476487	.	C	T	38	21	59	0	5	64	0	0
4	11476740	.	C	T	29	29	58	1	0	59	0	0
4	11477566	.	G	A	17	9	26	0	0	26	0	0
4	11480083	.	A	G	4	0	4	0	4	8	0	0
4	11480866	.	C	T	7	5	12	0	0	12	0	0
4	11482235	.	G	A	3	6	9	0	4	13	0	0
4	11482259	.	G	A	4	8	12	0	0	12	0	0
4	11482358	.	T	G	1	13	14	0	0	14	0	0
4	11482367	.	C	G	1	11	12	0	0	12	0	0
4	11482792	.	C	T	8	4	12	0	0	12	0	0
4	11482797	.	A	G	8	4	12	0	0	12	0	0
4	11483439	.	A	G	7	4	11	0	4	16	1	0
4	11483469	.	C	A	5	2	7	0	2	9	0	0
4	11483483	.	T	A	4	3	7	0	0	8	1	0
4	11485587	.	G	A	0	2	2	0	2	4	0	0
4	11485626	.	G	T	1	2	3	0	0	3	0	0
4	11485671	.	C	T	3	1	4	0	1	5	0	0
4	11487176	.	C	T	7	5	12	0	0	12	0	0
4	11574391	.	C	T	1	2	3	0	0	3	0	0
4	11574513	.	G	A	1	2	3	0	0	3	0	0
4	11576512	.	C	T	2	3	5	0	0	5	0	0
4	11576602	.	A	G	1	1	2	0	1	3	0	0
4	11576608	.	G	C	1	2	3	0	0	3	0	0
4	11704180	.	C	T	5	2	7	0	0	7	0	0
4	11704195	.	A	G	6	2	8	0	0	8	0	0
4	11709544	.	C	T	7	13	20	0	0	20	0	0
4	11712653	.	C	T	8	11	19	0	0	19	0	0
4	11712704	.	G	T	0	7	7	0	7	14	0	0
4	11712722	.	T	A	7	5	12	0	0	12	0	0
4	11712794	.	T	C	7	9	16	0	1	17	0	0
4	11713012	.	G	A	2	6	8	0	3	11	0	0
4	11721659	.	T	C	8	10	18	0	0	18	0	0
4	11721731	.	C	T	6	3	9	0	0	9	0	0
4	11721770	.	T	C	5	5	10	0	1	11	0	0
4	11726366	.	T	A	6	11	17	0	3	20	0	0
4	11728959	.	G	A	4	13	17	0	13	30	0	0
4	11729471	.	A	T	9	5	14	0	0	14	0	0
4	11729719	.	G	A	2	7	9	0	1	10	0	0
4	11729792	.	G	A	7	11	18	0	1	19	0	0
4	11730033	.	G	A	1	7	8	0	8	16	0	0
4	11730088	.	A	T	9	9	18	0	0	18	0	0
4	11730199	.	C	T	2	6	8	0	0	8	0	0
4	11730515	.	C	A	11	7	18	0	1	19	0	0
4	11732764	.	G	A	1	6	7	0	0	7	0	0
4	11732956	.	A	G	5	6	11	0	0	11	0	0
4	11732975	.	G	A	3	6	9	0	1	10	0	0
4	11733140	.	T	C	2	0	2	0	2	4	0	0
4	11733427	.	A	G	4	2	6	0	0	6	0	0
4	11733778	.	C	A	0	5	5	0	4	9	0	0
4	11733830	.	G	A	4	6	10	0	0	10	0	0
4	11734001	.	A	T	6	3	9	0	0	9	0	0
4	11734150	.	A	G	3	2	5	0	0	5	0	0
4	11734196	.	A	T	2	2	4	1	0	5	0	0
4	11737021	.	G	A	4	7	11	0	0	11	0	0
4	11737991	.	G	C	2	2	4	0	0	4	0	0
4	11738266	.	G	A	2	7	9	0	0	9	0	0
4	11738417	.	A	G	3	3	6	0	0	6	0	0
4	11738447	.	C	T	4	2	6	0	0	6	0	0
4	11738555	.	G	T	4	4	8	0	1	9	0	0
4	11738647	.	G	A	1	2	3	0	0	3	0	0
4	11738720	.	C	T	3	2	5	0	0	5	0	0
4	11738731	.	C	A	3	2	5	0	0	5	0	0
4	11767943	.	C	T	2	5	7	3	0	10	0	0
4	11780027	.	T	G	3	4	7	3	0	10	0	0
4	11780031	.	C	T	0	2	2	3	4	9	0	0
4	11780598	.	C	A	8	5	13	2	0	15	0	0
4	11804769	.	T	A	4	4	8	0	0	8	0	0
4	11805095	.	G	T	5	5	10	0	0	10	0	0
4	11805149	.	C	A	4	7	11	0	1	12	0	0
4	11805241	.	T	C	1	2	3	0	0	3	0	0
4	11805557	.	G	A	2	7	9	0	1	10	0	0
4	11806934	.	G	A	9	7	16	0	1	17	0	0
4	11806965	.	G	C	9	5	14	0	0	14	0	0
4	11810129	.	A	G	8	7	15	0	0	15	0	0
4	11814055	.	C	T	3	28	31	0	17	48	0	0
4	11814074	.	T	A	16	27	43	0	3	46	0	0
4	11814264	.	A	C	6	10	16	0	0	16	0	0
4	11814407	.	G	A	6	8	14	0	1	15	0	0
4	11814471	.	G	A	9	5	14	0	0	14	0	0
4	11814494	.	C	T	7	7	14	0	1	15	0	0
4	11814641	.	T	A	12	12	24	0	0	24	0	0
4	11814723	.	A	C	18	16	34	0	0	34	0	0
4	11814997	.	G	A	13	8	21	0	1	22	0	0
4	11815137	.	G	T	16	14	30	0	0	30	0	0
4	11815143	.	C	G	14	14	28	0	1	29	0	0
4	11815324	.	A	C	15	12	27	0	0	27	0	0
4	11815413	.	A	G	16	13	29	0	0	29	0	0
4	11815417	.	T	A	16	12	28	0	1	29	0	0
4	11815772	.	C	A	6	6	12	0	1	13	0	0
4	11816346	.	C	A	14	9	23	0	0	23	0	0
4	11816347	.	C	A	1	8	9	0	14	23	0	0
4	11816420	.	G	A	12	13	25	0	0	25	0	0
4	11816687	.	C	T	13	23	36	0	2	38	0	0
4	11818347	.	G	A	12	14	26	0	0	26	0	0
4	11827171	.	C	T	19	9	28	0	0	28	0	0
4	11829423	.	A	G	12	9	21	0	4	25	0	0
4	12006542	.	G	A	10	8	18	0	1	19	0	0
4	12006761	.	C	T	1	6	7	0	9	16	0	0
4	12007149	.	T	A	7	7	14	0	0	14	0	0
4	12013583	.	T	A	6	12	18	0	4	22	0	0
4	12020263	.	C	T	18	13	31	0	0	31	0	0
4	12021748	.	G	T	3	16	19	0	29	48	0	0
4	12021754	.	C	T	16	30	46	0	1	47	0	0
4	12022108	.	A	G	22	1	23	0	18	41	0	0
4	12023382	.	C	T	21	23	44	0	1	45	0	0
4	12025771	.	G	A	46	11	57	1	2	60	0	0
4	12026098	.	G	A	5	4	9	0	0	9	0	0
4	12026305	.	T	C	13	14	27	0	1	28	0	0
4	12026363	.	G	A	11	8	19	0	1	20	0	0
4	12026369	.	G	T	7	10	17	0	1	18	0	0
4	12026429	.	C	A	6	13	19	0	2	21	0	0
4	12026488	.	T	C	4	5	9	0	1	10	0	0
4	12026500	.	C	T	4	3	7	0	0	7	0	0
4	12034566	.	G	T	1	2	3	0	0	3	0	0
4	12034618	.	G	T	2	2	4	0	0	4	0	0
4	12075100	.	G	A	12	15	27	0	0	27	0	0
4	12076395	.	T	C	12	15	27	0	4	31	0	0
4	12086701	.	C	T	4	20	24	0	14	38	0	0
4	12087077	.	G	A	15	10	25	0	1	26	0	0
4	12087262	.	G	C	9	0	9	0	8	17	0	0
4	12089200	.	T	C	12	12	24	0	0	24	0	0
4	12089269	.	C	T	1	13	14	0	12	26	0	0
4	12091104	.	G	T	15	8	23	0	1	24	0	0
4	12101955	.	G	A	14	14	28	0	3	31	0	0
4	12103602	.	G	A	4	3	7	1	0	8	0	0
4	12103911	.	A	T	3	9	12	0	0	12	0	0
4	12104100	.	T	C	16	17	33	0	4	37	0	0
4	12113128	.	C	T	6	12	18	0	0	18	0	0
4	12113199	.	G	T	7	6	13	0	0	13	0	0
4	12229942	.	C	T	13	15	28	0	0	28	0	0
4	12230029	.	C	T	16	14	30	0	1	31	0	0
4	12230443	.	T	C	15	13	28	0	1	29	0	0
4	12230698	.	C	T	7	2	9	0	0	9	0	0
4	12230890	.	T	A	2	3	5	0	0	5	0	0
4	12230962	.	T	A	13	5	18	0	1	19	0	0
4	12231008	.	G	A	0	9	9	0	5	14	0	0
4	12231019	.	G	A	7	5	12	0	2	14	0	0
4	12231101	.	A	G	8	4	12	0	2	14	0	0
4	12231131	.	A	C	7	5	12	0	1	13	0	0
4	12231143	.	T	C	10	9	19	0	1	20	0	0
4	12231173	.	A	C	12	9	21	0	0	21	0	0
4	12231188	.	C	T	15	8	23	0	1	24	0	0
4	12231208	.	G	A	2	8	10	0	15	25	0	0
4	12231398	.	T	C	4	11	15	0	0	15	0	0
4	12231423	.	A	G	10	0	10	0	10	20	0	0
4	12231625	.	T	C	9	4	13	0	0	13	0	0
4	12231828	.	A	G	7	2	9	1	0	10	0	0
4	12231835	.	A	G	6	0	6	1	3	10	0	0
4	12232254	.	C	T	15	9	24	0	3	27	0	0
4	12232323	.	A	T	17	6	23	0	0	23	0	0
4	12232480	.	G	T	9	3	12	0	0	12	0	0
4	12232509	.	C	T	10	7	17	0	0	17	0	0
4	12232644	.	A	T	8	12	20	0	1	21	0	0
4	12232737	.	G	A	3	4	7	0	0	7	0	0
4	12233220	.	C	T	13	7	20	0	0	20	0	0
4	12233252	.	A	T	8	6	14	0	1	15	0	0
4	12233355	.	A	G	0	3	3	0	0	3	0	0
4	12233363	.	G	T	3	1	4	0	0	4	0	0
4	12233402	.	G	T	1	3	4	0	0	4	0	0
4	12233595	.	C	T	9	4	13	1	1	15	0	0
4	12233651	.	A	T	6	4	10	2	0	12	0	0
4	12233856	.	G	A	1	1	2	5	1	8	0	0
4	12233860	.	C	T	2	4	6	5	0	11	0	0
4	12234458	.	C	T	11	13	24	0	1	25	0	0
4	12234599	.	A	G	6	11	17	0	0	17	0	0
4	12234603	.	A	G	8	8	16	0	0	16	0	0
4	12234670	.	A	G	10	0	10	0	13	23	0	0
4	12234792	.	A	G	23	6	29	0	1	30	0	0
4	12234955	.	C	T	11	17	28	0	1	29	0	0
4	12235123	.	G	A	18	15	33	0	1	34	0	0
4	12235414	.	A	C	11	6	17	0	0	17	0	0
4	12235416	.	A	C	1	7	8	0	0	8	0	0
4	12235838	.	T	A	11	14	25	0	2	27	0	0
4	12236171	.	G	A	15	13	28	6	0	34	0	0
4	12236471	.	G	T	13	8	21	0	0	21	0	0
4	12236496	.	A	G	15	5	20	0	0	20	0	0
4	12237508	.	A	G	21	11	32	0	0	32	0	0
4	12238064	.	G	T	19	9	28	0	2	30	0	0
4	12238065	.	C	A	19	9	28	0	2	30	0	0
4	12238418	.	C	T	20	15	35	0	0	35	0	0
4	12238711	.	G	A	14	6	20	1	1	22	0	0
4	12238956	.	G	A	24	10	34	0	5	39	0	0
4	12244153	.	T	A	16	12	28	0	0	28	0	0
4	12244258	.	T	C	6	6	12	0	0	12	0	0
4	12244322	.	C	T	8	12	20	0	1	21	0	0
4	12244373	.	G	A	11	11	22	0	0	22	0	0
4	12245058	.	G	A	6	9	15	0	0	15	0	0
4	12245324	.	T	A	10	5	15	0	0	15	0	0
4	12245470	.	G	A	11	7	18	0	3	21	0	0
4	12245548	.	A	C	8	0	8	0	18	26	0	0
4	12265268	.	T	A	7	6	13	0	3	16	0	0
4	12265355	.	T	C	7	5	12	0	0	12	0	0
4	12270202	.	A	T	6	5	11	0	0	11	0	0
4	12275400	.	T	C	5	4	9	0	0	9	0	0
4	12286040	.	C	T	4	4	8	0	0	8	0	0
4	12298513	.	A	T	21	20	41	2	1	44	0	0
4	12304561	.	C	T	21	14	35	0	0	35	0	0
4	12306880	.	G	A	16	21	37	0	1	38	0	0
4	12311110	.	T	G	10	7	17	0	0	17	0	0
4	12311632	.	G	A	6	6	12	0	0	12	0	0
4	12312195	.	T	C	1	2	3	0	0	3	0	0
4	12312670	.	C	A	5	8	13	0	0	13	0	0
4	12312712	.	C	T	3	4	7	0	0	7	0	0
4	12312717	.	T	G	5	2	7	0	1	8	0	0
4	12312899	.	G	A	4	6	10	0	0	10	0	0
4	12317636	.	T	G	2	4	6	1	0	7	0	0
4	12381900	.	T	C	7	9	16	0	1	17	0	0
4	12381930	.	G	A	9	5	14	0	1	15	0	0
4	12382076	.	A	G	15	17	32	0	0	32	0	0
4	12382336	.	T	G	5	9	14	0	0	14	0	0
4	12382712	.	G	A	6	13	19	0	0	19	0	0
4	12382871	.	G	A	14	9	23	0	0	23	0	0
4	12382921	.	G	A	18	5	23	0	1	24	0	0
4	12383081	.	C	T	18	12	30	0	1	31	0	0
4	12384840	.	G	A	14	7	21	0	2	23	0	0
4	12384873	.	C	G	2	10	12	0	16	28	0	0
4	12612715	.	T	A	9	3	12	0	1	13	0	0
4	12620983	.	G	A	18	19	37	0	1	38	0	0
4	12657838	.	G	A	2	19	21	0	25	46	0	0
4	12657905	.	G	C	25	20	45	2	3	50	0	0
4	12678204	.	C	G	24	24	48	0	1	49	0	0
4	12678676	.	C	A	20	18	38	0	0	38	0	0
4	12678885	.	T	C	22	21	43	0	4	47	0	0
4	12715830	.	C	T	2	2	4	0	1	5	0	0
4	12715837	.	G	A	2	3	5	0	0	5	0	0
4	12715871	.	C	T	2	5	7	0	0	7	0	0
4	12716265	.	A	G	1	5	6	0	0	6	0	0
4	12719248	.	A	C	3	2	5	0	0	5	0	0
4	12755207	.	C	A	5	3	8	0	0	8	0	0
4	12755275	.	G	T	3	4	7	0	0	7	0	0
4	12760655	.	C	A	5	3	8	1	1	10	0	0
4	12771892	.	A	C	2	0	2	0	2	4	0	0
4	12793632	.	G	A	3	5	8	0	0	8	0	0
4	12793806	.	G	A	5	7	12	0	0	12	0	0
4	12793893	.	G	A	5	8	13	0	1	14	0	0
4	12793914	.	T	A	4	8	12	0	1	13	0	0
4	12793943	.	C	G	5	10	15	0	0	15	0	0
4	12794153	.	C	A	12	13	25	0	0	25	0	0
4	12794160	.	T	G	10	14	24	0	2	26	0	0
4	12795394	.	G	A	22	18	40	0	0	40	0	0
4	12893825	.	A	C	2	2	4	0	0	4	0	0
4	12900856	.	G	T	3	3	6	0	0	6	0	0
4	12902609	.	G	A	3	5	8	0	0	8	0	0
4	12917237	.	G	T	12	8	20	0	0	20	0	0
4	12917348	.	A	G	15	6	21	0	2	23	0	0
4	12917534	.	C	T	3	12	15	0	14	29	0	0
4	12917796	.	A	G	12	14	26	0	0	26	0	0
4	12921893	.	T	C	4	1	5	0	7	12	0	0
4	12929147	.	C	T	2	10	12	0	11	23	0	0
4	12971436	.	A	G	15	19	34	0	4	38	0	0
4	12971495	.	C	A	25	13	38	0	0	38	0	0
4	12971935	.	A	T	15	13	28	0	1	29	0	0
4	12972000	.	T	A	11	9	20	0	1	21	0	0
4	12972215	.	C	T	2	30	32	0	21	53	0	0
4	12976735	.	G	A	18	26	44	0	1	45	0	0
4	12976983	.	T	C	27	0	27	0	28	55	0	0
4	12978779	.	G	A	21	20	41	0	1	42	0	0
4	12978843	.	A	C	18	23	41	0	1	42	0	0
4	13035881	.	A	G	20	10	30	0	1	31	0	0
4	13035962	.	T	C	20	11	31	0	1	32	0	0
4	13036046	.	G	A	12	23	35	0	0	35	0	0
4	13036572	.	G	A	15	13	28	0	1	29	0	0
4	13041589	.	C	T	2	16	18	0	12	30	0	0
4	13054610	.	G	A	10	10	20	0	0	20	0	0
4	13056441	.	G	A	18	7	25	0	0	25	0	0
4	13079354	.	A	T	7	12	19	0	0	19	0	0
4	13138021	.	T	C	12	15	27	0	0	27	0	0
4	13416734	.	T	C	9	5	14	0	0	14	0	0
4	13421182	.	T	A	7	5	12	0	0	12	0	0
4	13422116	.	G	A	1	13	14	0	15	29	0	0
4	13425028	.	T	G	7	2	9	0	7	16	0	0
4	13449938	.	C	T	1	3	4	0	0	4	0	0
4	13449940	.	A	T	1	3	4	0	0	4	0	0
4	13453413	.	G	A	6	10	16	0	0	16	0	0
4	13457587	.	T	G	4	9	13	0	1	14	0	0
4	13457770	.	G	C	9	6	15	0	0	15	0	0
4	13457965	.	A	G	2	7	9	0	0	9	0	0
4	13458010	.	T	C	7	5	12	0	0	12	0	0
4	13458052	.	G	T	0	7	7	0	8	15	0	0
4	13458241	.	C	G	10	14	24	0	0	24	0	0
4	13458469	.	C	T	5	6	11	0	0	11	0	0
4	13458703	.	C	G	5	14	19	0	1	20	0	0
4	13458800	.	C	T	5	6	11	0	1	12	0	0
4	13458888	.	G	A	0	5	5	0	6	11	0	0
4	13458952	.	G	T	4	5	9	0	0	9	0	0
4	13459453	.	A	G	6	5	11	0	0	11	0	0
4	13459602	.	T	G	7	5	12	0	2	14	0	0
4	13459670	.	A	G	12	8	20	0	1	21	0	0
4	13459917	.	G	A	8	7	15	0	0	15	0	0
4	13459964	.	A	T	9	6	15	0	0	15	0	0
4	13460125	.	G	A	8	9	17	0	2	19	0	0
4	13460244	.	A	G	5	7	12	0	1	13	0	0
4	13460289	.	G	A	8	7	15	0	0	15	0	0
4	13460653	.	G	A	10	5	15	1	0	16	0	0
4	13460937	.	T	C	9	7	16	0	0	16	0	0
4	13461216	.	T	A	13	6	19	0	0	19	0	0
4	13461302	.	T	C	7	4	11	0	1	12	0	0
4	13555289	.	C	G	1	3	4	0	0	4	0	0
4	13555327	.	G	A	2	4	6	0	0	6	0	0
4	13570514	.	G	T	3	13	16	0	1	17	0	0
4	13570609	.	G	A	6	9	15	0	3	18	0	0
4	13570899	.	T	C	10	11	21	0	0	21	0	0
4	13571711	.	T	C	13	9	22	0	1	23	0	0
4	13572951	.	G	A	1	12	13	0	9	22	0	0
4	13575521	.	C	T	3	5	8	0	1	9	0	0
4	13575570	.	A	G	1	0	1	0	4	5	0	0
4	13575618	.	G	A	0	6	6	0	2	8	0	0
4	13575623	.	A	G	1	5	6	0	0	6	0	0
4	13575672	.	A	G	1	0	1	0	4	5	0	0
4	13575701	.	C	T	2	4	6	0	0	6	0	0
4	13575709	.	A	C	2	3	5	0	0	5	0	0
4	13575996	.	C	T	8	6	14	0	2	16	0	0
4	13576105	.	G	T	3	7	10	0	0	10	0	0
4	13576139	.	G	A	1	5	6	0	3	9	0	0
4	13586824	.	C	A	5	5	10	0	0	10	0	0
4	13591793	.	A	G	8	6	14	0	1	15	0	0
4	13592863	.	G	A	13	8	21	0	2	23	0	0
4	13593078	.	T	C	9	8	17	0	0	17	0	0
4	13593097	.	T	C	10	7	17	0	0	17	0	0
4	13595838	.	G	A	1	11	12	0	6	18	0	0
4	13597393	.	A	T	1	8	9	0	1	10	0	0
4	13597399	.	A	G	2	7	9	0	0	9	0	0
4	13597646	.	A	G	15	7	22	0	2	24	0	0
4	13597782	.	C	G	10	0	10	0	6	16	0	0
4	13597849	.	C	T	4	10	14	0	0	14	0	0
4	13604574	.	T	C	17	12	29	0	2	31	0	0
4	13619072	.	A	G	2	3	5	0	0	5	0	0
4	13626756	.	C	A	1	3	4	0	0	4	0	0
4	13626759	.	G	T	1	3	4	0	0	4	0	0
4	13628281	.	C	T	5	9	14	0	1	15	0	0
4	13628328	.	G	T	6	7	13	0	0	13	0	0
4	13628583	.	G	A	6	11	17	0	0	17	0	0
4	13628724	.	G	A	15	7	22	0	0	22	0	0
4	13629927	.	T	G	5	12	17	0	1	18	0	0
4	13631269	.	G	A	6	14	20	0	0	20	0	0
4	13640812	.	C	T	15	10	25	0	0	25	0	0
4	13642486	.	C	T	14	11	25	0	0	25	0	0
4	13642676	.	T	G	13	0	13	0	14	27	0	0
4	13642897	.	A	G	6	3	9	0	0	9	0	0
4	13643251	.	G	T	2	8	10	0	7	17	0	0
4	13643349	.	A	T	7	4	11	0	0	11	0	0
4	13643461	.	G	A	1	8	9	0	4	13	0	0
4	13643547	.	C	T	2	2	4	0	0	4	0	0
4	13702331	.	C	T	8	9	17	0	0	17	0	0
4	13702400	.	C	T	14	9	23	0	0	23	0	0
4	13702409	.	C	T	14	11	25	0	1	26	0	0
4	13703106	.	T	C	12	11	23	0	0	23	0	0
4	13706180	.	A	C	18	11	29	0	0	29	0	0
4	13706184	.	A	T	16	12	28	0	0	28	0	0
4	13706810	.	C	T	10	10	20	0	2	22	0	0
4	13708840	.	C	A	19	24	43	0	1	44	0	0
4	13709490	.	T	G	22	16	38	0	2	40	0	0
4	13710585	.	G	T	1	12	13	0	6	19	0	0
4	13712997	.	C	G	10	12	22	0	0	22	0	0
4	13713042	.	A	G	8	12	20	0	0	20	0	0
4	13714209	.	G	A	12	14	26	0	1	27	0	0
4	13723362	.	C	T	15	13	28	0	0	28	0	0
4	13723446	.	C	T	20	20	40	0	0	40	0	0
4	13723458	.	C	T	21	18	39	0	4	43	0	0
4	13724578	.	G	A	24	21	45	0	0	45	0	0
4	13724581	.	T	C	24	20	44	0	0	44	0	0
4	13728097	.	T	C	24	26	50	0	2	52	0	0
4	13744441	.	T	C	22	12	34	1	1	36	0	0
4	13744451	.	C	A	20	11	31	1	1	33	0	0
4	13744525	.	C	A	16	9	25	0	2	27	0	0
4	13744591	.	T	A	12	11	23	0	0	23	0	0
4	13747503	.	C	T	22	14	36	0	0	36	0	0
4	13747566	.	A	C	20	16	36	0	1	37	0	0
4	13747793	.	C	A	13	14	27	0	2	29	0	0
4	13747799	.	C	T	16	15	31	0	1	32	0	0
4	13750453	.	T	A	21	13	34	0	3	37	0	0
4	13753404	.	G	A	34	14	48	0	0	48	0	0
4	13755213	.	G	A	35	18	53	0	2	55	0	0
4	13755254	.	T	G	19	13	32	2	4	38	0	0
4	13755392	.	G	A	2	16	18	0	18	36	0	0
4	13755521	.	T	A	9	3	12	0	0	12	0	0
4	13755813	.	C	T	16	11	27	0	1	28	0	0
4	13756124	.	A	G	2	1	3	0	5	8	0	0
4	13756269	.	A	T	10	10	20	0	1	21	0	0
4	13756273	.	C	A	11	10	21	0	0	21	0	0
4	13810875	.	C	T	4	4	8	0	0	8	0	0
4	13810885	.	A	C	4	4	8	0	1	9	0	0
4	13810923	.	G	A	0	3	3	0	4	7	0	0
4	13810947	.	G	A	0	3	3	0	5	8	0	0
4	13810958	.	T	A	3	6	9	0	0	9	0	0
4	13859969	.	A	T	5	3	8	0	0	8	0	0
4	13859984	.	G	A	4	2	6	0	1	7	0	0
4	13860345	.	A	C	2	4	6	0	0	6	0	0
4	13893341	.	G	A	2	3	5	0	0	5	0	0
4	13893369	.	C	T	1	3	4	0	0	4	0	0
4	13905730	.	T	C	6	0	6	0	9	15	0	0
4	13905846	.	A	G	4	8	12	0	0	12	0	0
4	13905926	.	T	A	10	7	17	0	0	17	0	0
4	13906051	.	T	C	2	0	2	0	3	5	0	0
4	13906567	.	A	G	16	7	23	0	0	23	0	0
4	13920902	.	A	G	4	3	7	1	0	8	0	0
4	13925621	.	A	G	6	6	12	0	1	13	0	0
4	13925714	.	C	T	11	9	20	0	0	20	0	0
4	13928522	.	C	T	8	1	9	0	1	10	0	0
4	13929511	.	A	G	3	8	11	0	0	11	0	0
4	13931460	.	T	A	4	3	7	0	0	7	0	0
4	13931827	.	G	A	0	9	9	0	4	13	0	0
4	13931831	.	T	A	5	8	13	0	0	13	0	0
4	13935470	.	A	G	6	10	16	0	1	17	0	0
4	13935509	.	T	C	9	7	16	0	0	16	0	0
4	13943890	.	A	T	7	10	17	1	0	18	0	0
4	13943911	.	T	A	9	7	16	1	2	19	0	0
4	13944129	.	T	A	10	5	15	0	1	16	0	0
4	13963048	.	T	A	11	8	19	0	1	20	0	0
4	13963202	.	T	A	3	9	12	0	0	12	0	0
4	13963554	.	C	T	4	2	6	0	0	6	0	0
4	13964679	.	C	G	1	7	8	0	0	8	0	0
4	13964865	.	G	A	1	3	4	0	0	4	0	0
4	13965149	.	A	G	6	2	8	0	0	8	0	0
4	13965185	.	C	T	3	3	6	0	0	6	0	0
4	13965245	.	A	G	5	4	9	0	0	9	0	0
4	13965558	.	G	A	5	5	10	0	0	10	0	0
4	13965824	.	T	G	6	6	12	0	0	12	0	0
4	13966709	.	C	T	2	3	5	0	1	6	0	0
4	13966829	.	G	A	3	5	8	0	0	8	0	0
4	13966874	.	G	A	2	2	4	0	0	4	0	0
4	13967782	.	C	T	2	2	4	0	0	4	0	0
4	13969955	.	G	A	4	2	6	0	0	6	0	0
4	13969964	.	C	G	0	2	2	0	3	5	0	0
4	14169604	.	T	C	2	4	6	0	0	6	0	0
4	14169619	.	C	T	2	4	6	1	1	8	0	0
4	14191951	.	G	A	4	2	6	0	0	6	0	0
4	14193462	.	G	T	10	10	20	0	0	20	0	0
4	14193473	.	C	A	9	11	20	0	1	21	0	0
4	14193962	.	C	T	2	6	8	0	0	8	0	0
4	14194650	.	G	A	11	7	18	0	1	19	0	0
4	14205253	.	A	T	10	5	15	0	2	17	0	0
4	14247890	.	G	C	13	20	33	2	2	37	0	0
4	14248043	.	A	G	23	31	54	0	2	56	0	0
4	14248157	.	G	A	37	23	60	0	0	60	0	0
4	14248277	.	A	T	24	19	43	0	3	46	0	0
4	14248279	.	G	A	23	21	44	0	1	45	0	0
4	14248332	.	C	A	7	20	27	0	29	56	0	0
4	14248419	.	T	C	43	2	45	3	17	65	0	0
4	14248433	.	A	T	40	20	60	3	0	63	0	0
4	14248643	.	A	G	27	30	57	0	5	62	0	0
4	14248715	.	G	A	32	16	48	1	0	49	0	0
4	14248716	.	A	T	33	16	49	1	0	50	0	0
4	14248750	.	T	G	47	7	54	1	1	56	0	0
4	14248751	.	A	G	47	8	55	1	0	56	0	0
4	14248804	.	G	A	29	20	49	1	3	53	0	0
4	14248848	.	G	A	23	23	46	0	1	47	0	0
4	14248856	.	C	T	22	22	44	0	2	46	0	0
4	14248948	.	A	G	25	6	31	0	1	32	0	0
4	14248969	.	T	G	22	7	29	0	1	30	0	0
4	14249043	.	C	T	23	17	40	0	2	42	0	0
4	14249151	.	T	C	17	9	26	0	2	28	0	0
4	14249159	.	T	G	14	10	24	0	1	26	1	0
4	14249247	.	A	T	17	10	27	0	1	28	0	0
4	14249269	.	T	C	12	13	25	0	0	25	0	0
4	14249329	.	C	T	6	7	13	0	0	13	0	0
4	14249358	.	T	A	9	4	13	0	2	15	0	0
4	14249374	.	G	T	6	5	11	0	7	18	0	0
4	14249402	.	T	A	7	4	11	0	9	20	0	0
4	14249544	.	G	T	14	8	22	0	1	23	0	0
4	14249549	.	C	A	13	10	23	0	1	24	0	0
4	14249583	.	A	T	10	7	17	0	0	17	0	0
4	14249588	.	A	T	10	7	17	0	0	17	0	0
4	14249710	.	T	A	10	8	18	0	1	19	0	0
4	14249725	.	T	G	8	7	15	0	3	18	0	0
4	14249799	.	T	C	6	13	19	0	0	19	0	0
4	14249984	.	T	G	33	23	56	0	6	62	0	0
4	14250053	.	G	A	42	12	54	3	4	61	0	0
4	14250678	.	G	A	31	32	63	0	5	68	0	0
4	14250840	.	T	C	24	0	24	0	40	64	0	0
4	14282192	.	G	T	26	27	53	0	1	54	0	0
4	14282244	.	A	G	29	24	53	0	2	55	0	0
4	14282301	.	C	T	31	22	53	0	1	54	0	0
4	14303321	.	A	G	24	33	57	0	2	59	0	0
4	14311380	.	G	A	23	20	43	0	3	46	0	0
4	14895902	.	T	C	2	4	6	0	0	6	0	0
4	14896000	.	G	C	5	2	7	0	0	7	0	0
4	14896037	.	T	C	7	4	11	0	0	11	0	0
4	14896040	.	T	C	8	3	11	0	0	11	0	0
4	14896223	.	A	G	3	5	8	0	0	8	0	0
4	14896374	.	C	T	3	5	8	0	0	8	0	0
4	14896390	.	T	G	3	3	6	0	0	6	0	0
4	14896509	.	G	A	4	6	10	0	0	10	0	0
4	14906291	.	G	A	2	3	5	0	1	6	0	0
4	14909287	.	G	C	9	11	20	0	2	22	0	0
4	14909532	.	T	C	8	11	19	0	0	19	0	0
4	14912823	.	A	G	3	8	11	0	1	12	0	0
4	14912826	.	G	A	4	9	13	0	1	14	0	0
4	14917508	.	T	C	2	4	6	0	0	6	0	0
4	14917510	.	C	T	3	4	7	0	0	7	0	0
4	14917895	.	G	A	5	10	15	0	1	16	0	0
4	14919678	.	C	T	2	6	8	0	5	13	0	0
4	14919877	.	T	C	4	5	9	0	0	9	0	0
4	14922086	.	G	A	5	3	8	0	0	8	0	0
4	14922650	.	T	C	5	0	5	0	4	9	0	0
4	14923158	.	C	T	2	6	8	0	5	13	0	0
4	14925742	.	A	G	8	10	18	1	1	20	0	0
4	14926096	.	G	A	7	8	15	0	0	15	0	0
4	14926618	.	T	G	6	6	12	0	0	12	0	0
4	14926967	.	C	T	18	9	27	0	0	27	0	0
4	14928719	.	C	T	7	9	16	0	0	16	0	0
4	14928731	.	G	A	5	11	16	0	0	16	0	0
4	14928916	.	C	T	20	8	28	0	0	28	0	0
4	14928973	.	G	A	2	7	9	0	23	32	0	0
4	14929107	.	T	G	12	13	25	0	1	27	1	0
4	14932200	.	T	C	7	13	20	0	0	20	0	0
4	14932676	.	A	T	2	4	6	0	0	6	0	0
4	14932821	.	G	C	3	8	11	0	0	11	0	0
4	14933337	.	A	G	6	5	11	0	0	11	0	0
4	14933513	.	G	T	2	6	8	0	0	8	0	0
4	14938320	.	G	A	9	9	18	0	0	18	0	0
4	14938326	.	T	C	9	9	18	0	0	18	0	0
4	14942525	.	A	G	3	4	7	0	0	7	0	0
4	14942552	.	A	G	4	6	10	0	0	10	0	0
4	14945558	.	G	A	1	3	4	0	0	4	0	0
4	14945653	.	G	C	2	4	6	0	0	6	0	0
4	14951465	.	A	G	2	8	10	0	1	11	0	0
4	14976645	.	T	C	1	2	3	0	1	4	0	0
4	14992080	.	A	G	5	4	9	0	1	10	0	0
4	14992081	.	T	C	6	4	10	0	0	10	0	0
4	14992131	.	C	A	8	3	11	0	1	12	0	0
4	14992142	.	G	C	6	3	9	0	1	10	0	0
4	14992257	.	T	A	3	2	5	0	0	5	0	0
4	14992264	.	T	C	5	0	5	0	2	7	0	0
4	14992353	.	T	C	8	4	12	0	0	12	0	0
4	14992499	.	T	C	9	3	12	0	0	12	0	0
4	14992529	.	T	C	10	5	15	0	2	17	0	0
4	14993076	.	T	C	10	10	20	0	0	20	0	0
4	14993263	.	A	C	10	12	22	0	1	23	0	0
4	14994200	.	C	T	0	8	8	0	14	22	0	0
4	14995395	.	G	T	3	10	13	0	2	15	0	0
4	15003761	.	G	A	7	6	13	0	0	13	0	0
4	15006334	.	T	C	4	3	7	0	0	7	0	0
4	15007992	.	G	A	0	8	8	0	4	12	0	0
4	15009243	.	C	T	9	6	15	0	0	15	0	0
4	15009874	.	T	C	2	8	10	0	0	10	0	0
4	15009947	.	G	A	6	2	8	0	0	8	0	0
4	15009971	.	A	T	8	4	12	0	0	12	0	0
4	15010172	.	T	A	6	4	10	0	0	10	0	0
4	15010557	.	A	G	13	1	14	0	4	18	0	0
4	15010680	.	A	G	2	4	6	0	1	7	0	0
4	15058352	.	A	G	22	27	49	0	0	49	0	0
4	15058663	.	A	C	20	10	30	1	2	33	0	0
4	15058968	.	T	G	11	1	12	0	20	32	0	0
4	15059028	.	G	A	1	8	9	0	9	18	0	0
4	15059070	.	A	T	16	7	23	0	0	23	0	0
4	15059147	.	A	G	11	20	31	0	1	32	0	0
4	15059367	.	A	G	16	7	23	0	1	24	0	0
4	15059498	.	T	A	18	18	36	0	0	36	0	0
4	15059823	.	A	T	15	19	34	0	0	34	0	0
4	15081490	.	C	T	6	4	10	0	0	10	0	0
4	15081703	.	G	A	11	11	22	0	1	23	0	0
4	15081829	.	T	C	9	12	21	0	2	23	0	0
4	15081871	.	C	T	12	14	26	0	0	26	0	0
4	15081985	.	T	C	11	15	26	0	0	27	1	0
4	15082573	.	C	G	2	2	4	0	1	6	1	0
4	15096627	.	A	G	14	13	27	0	0	27	0	0
4	15100365	.	C	T	5	8	13	0	0	13	0	0
4	15218134	.	T	C	18	1	19	0	14	33	0	0
4	15218258	.	A	G	10	12	22	0	2	24	0	0
4	15218342	.	T	A	25	19	44	0	1	45	0	0
4	15218389	.	C	T	20	17	37	0	2	39	0	0
4	15218505	.	C	T	15	18	33	0	3	36	0	0
4	15218595	.	T	C	9	7	16	0	1	17	0	0
4	15218656	.	G	A	12	7	19	0	2	21	0	0
4	15218772	.	C	A	19	11	30	0	2	33	1	0
4	15218886	.	A	C	10	20	30	0	1	31	0	0
4	15219291	.	G	A	22	9	31	0	0	31	0	0
4	15219368	.	C	T	4	12	16	0	16	32	0	0
4	15219533	.	T	A	16	10	26	0	1	27	0	0
4	15219787	.	T	C	16	20	36	0	0	36	0	0
4	15219840	.	G	T	16	17	33	0	0	33	0	0
4	15219955	.	G	A	22	24	46	0	0	46	0	0
4	15220001	.	A	T	22	16	38	0	2	40	0	0
4	15220022	.	A	G	19	13	32	0	0	32	0	0
4	15220467	.	T	G	12	11	23	0	1	24	0	0
4	15238347	.	G	A	15	12	27	0	0	27	0	0
4	15247902	.	A	T	7	8	15	0	1	16	0	0
4	15250568	.	C	T	4	7	11	0	1	12	0	0
4	15272169	.	T	C	6	4	10	0	1	11	0	0
4	15272170	.	T	C	7	0	7	0	4	11	0	0
4	15294169	.	C	T	4	8	12	0	0	12	0	0
4	15500617	.	G	T	5	10	15	0	0	15	0	0
4	15500663	.	T	C	4	0	4	0	7	11	0	0
4	15500720	.	T	C	7	5	12	0	0	12	0	0
4	15585852	.	G	T	3	5	8	0	0	8	0	0
4	15600812	.	G	C	5	6	11	0	0	11	0	0
4	15600824	.	G	A	4	7	11	0	0	11	0	0
4	15601126	.	C	T	0	5	5	0	16	21	0	0
4	15603487	.	G	C	9	10	19	0	0	19	0	0
4	15630128	.	A	G	9	1	10	0	0	10	0	0
4	15630131	.	G	A	9	2	11	0	0	11	0	0
4	15636947	.	A	G	8	10	18	0	1	19	0	0
4	15775430	.	G	A	13	8	21	0	0	21	0	0
4	15795098	.	G	A	11	9	20	0	0	20	0	0
4	15799320	.	T	C	9	5	14	0	0	14	0	0
4	15799413	.	G	A	11	8	19	0	0	19	0	0
4	15799452	.	G	T	12	11	23	0	0	23	0	0
4	15799488	.	T	C	15	10	25	0	0	25	0	0
4	15816414	.	G	A	2	9	11	0	17	28	0	0
4	15937624	.	G	A	1	2	3	0	0	3	0	0
4	15981260	.	A	G	12	11	23	0	0	23	0	0
4	15981266	.	C	T	14	10	24	0	1	25	0	0
4	15981362	.	T	C	13	10	23	0	2	25	0	0
4	15981428	.	C	T	12	9	21	0	1	22	0	0
4	15984753	.	C	T	19	14	33	0	0	33	0	0
4	15988446	.	T	C	18	6	24	1	2	27	0	0
4	15989142	.	G	A	4	12	16	0	13	29	0	0
4	15989313	.	A	C	20	8	28	0	1	29	0	0
4	15989643	.	T	C	17	15	32	0	0	32	0	0
4	15989661	.	A	G	15	14	29	0	0	29	0	0
4	15989988	.	C	T	16	15	31	0	1	32	0	0
4	15991026	.	C	T	19	9	28	0	1	29	0	0
4	15992146	.	G	A	20	23	43	0	0	43	0	0
4	15992206	.	T	C	20	12	32	0	0	32	0	0
4	15993801	.	C	T	20	13	33	0	1	34	0	0
4	15993917	.	G	C	20	18	38	0	1	39	0	0
4	15993959	.	C	T	12	21	33	0	1	34	0	0
4	15995876	.	A	G	10	13	23	0	3	26	0	0
4	15996044	.	T	C	9	9	18	0	1	19	0	0
4	15996066	.	C	G	5	10	15	0	2	17	0	0
4	15998315	.	A	T	9	8	17	0	3	20	0	0
4	15999618	.	A	T	12	9	21	0	0	21	0	0
4	15999783	.	T	A	8	9	17	0	0	17	0	0
4	16001060	.	T	A	10	11	21	0	0	21	0	0
4	16077260	.	T	C	18	12	30	0	5	35	0	0
4	16077663	.	G	A	5	3	8	0	11	19	0	0
4	16078080	.	A	T	16	14	30	0	3	33	0	0
4	16078203	.	C	T	29	19	48	0	0	48	0	0
4	16078979	.	A	G	34	38	72	0	2	74	0	0
4	16081306	.	G	T	25	19	44	0	0	44	0	0
4	16085420	.	T	G	15	30	45	0	2	47	0	0
4	16086969	.	A	G	22	21	43	0	0	43	0	0
4	16086987	.	C	G	19	17	36	0	2	38	0	0
4	16087595	.	T	G	13	16	29	0	3	32	0	0
4	16088528	.	C	T	23	12	35	0	2	37	0	0
4	16088622	.	T	C	22	0	22	0	11	33	0	0
4	16088673	.	C	T	17	17	34	0	4	38	0	0
4	16090262	.	A	G	13	14	27	0	1	28	0	0
4	16098903	.	A	C	21	19	40	0	3	43	0	0
4	16098930	.	C	T	23	19	42	0	0	42	0	0
4	16111890	.	A	T	12	12	24	0	2	26	0	0
4	16112013	.	C	T	15	13	28	0	0	29	1	0
4	16315830	.	A	G	3	3	6	0	1	7	0	0
4	16318963	.	G	A	0	4	4	0	4	8	0	0
4	16319377	.	C	T	4	4	8	0	0	8	0	0
4	16319839	.	T	A	1	5	6	0	0	7	1	0
4	16320221	.	G	A	0	5	5	0	1	6	0	0
4	16320389	.	T	A	1	2	3	0	0	3	0	0
4	16368805	.	T	C	12	0	12	0	7	19	0	0
4	16368977	.	G	A	9	11	20	0	0	20	0	0
4	16369033	.	T	A	9	6	15	0	2	17	0	0
4	16369335	.	T	C	6	0	6	0	11	17	0	0
4	16369375	.	G	C	8	4	12	0	0	12	0	0
4	16369384	.	T	C	6	3	9	0	3	12	0	0
4	16369440	.	C	T	7	4	11	0	0	11	0	0
4	16369486	.	T	C	5	2	7	0	0	7	0	0
4	16380491	.	G	C	6	0	6	0	6	12	0	0
4	16382917	.	A	G	5	4	9	0	0	9	0	0
4	16536356	.	G	A	1	7	8	0	3	11	0	0
4	16536946	.	C	A	19	16	35	0	1	36	0	0
4	16537045	.	T	C	22	11	33	0	6	39	0	0
4	16537099	.	A	T	37	18	55	0	5	60	0	0
4	16537575	.	T	G	24	29	53	0	2	55	0	0
4	16537770	.	G	A	31	24	55	0	1	56	0	0
4	16538055	.	T	A	25	11	36	0	1	37	0	0
4	16539253	.	A	G	21	27	48	0	0	48	0	0
4	16615212	.	A	C	2	0	2	0	2	4	0	0
4	16615258	.	C	T	2	2	4	0	0	4	0	0
4	16616546	.	T	C	3	0	3	0	2	5	0	0
4	16617785	.	T	C	2	2	4	0	0	4	0	0
4	16632415	.	G	A	4	4	8	0	2	10	0	0
4	16632650	.	A	T	10	13	23	0	0	23	0	0
4	16632762	.	A	T	6	10	16	1	2	19	0	0
4	16632907	.	T	A	3	2	5	0	1	6	0	0
4	16633208	.	C	T	9	7	16	0	0	16	0	0
4	16633481	.	C	T	0	4	4	0	7	11	0	0
4	16634791	.	C	A	2	7	9	0	0	9	0	0
4	16634794	.	G	T	2	8	10	0	0	10	0	0
4	16634916	.	A	G	13	11	24	0	2	26	0	0
4	16634929	.	A	T	15	7	22	0	0	22	0	0
4	16635088	.	G	A	7	8	15	0	0	15	0	0
4	16635162	.	G	A	4	12	16	0	0	16	0	0
4	16635208	.	G	A	11	8	19	0	1	20	0	0
4	16635426	.	A	G	5	2	7	0	0	7	0	0
4	16635460	.	T	A	7	4	11	0	2	13	0	0
4	16635710	.	T	C	9	7	16	0	2	18	0	0
4	16638015	.	T	C	17	4	21	0	3	24	0	0
4	16638021	.	T	G	15	4	19	0	1	20	0	0
4	16641677	.	T	C	7	8	15	0	0	15	0	0
4	16650102	.	T	C	8	6	14	0	0	14	0	0
4	16650142	.	A	T	6	10	16	0	0	16	0	0
4	16650433	.	A	C	15	14	29	0	1	30	0	0
4	16650482	.	T	C	10	11	21	0	0	21	0	0
4	16650611	.	T	G	10	11	21	0	0	21	0	0
4	16650618	.	A	G	11	9	20	0	0	20	0	0
4	16650855	.	A	G	11	4	15	1	1	17	0	0
4	16651010	.	G	C	12	0	12	0	6	18	0	0
4	16651046	.	G	C	9	8	17	0	1	18	0	0
4	16651121	.	A	G	19	8	27	0	2	29	0	0
4	16651414	.	G	A	17	9	26	0	1	27	0	0
4	16652890	.	A	G	12	12	24	0	0	24	0	0
4	16654337	.	G	C	23	15	38	0	0	38	0	0
4	16654349	.	C	T	3	10	13	0	27	40	0	0
4	16659679	.	G	A	12	13	25	0	1	26	0	0
4	16666267	.	C	T	14	13	27	0	3	30	0	0
4	16671133	.	T	C	15	6	21	0	0	21	0	0
4	16671232	.	C	T	0	11	11	0	11	22	0	0
4	16672481	.	G	T	8	15	23	0	0	23	0	0
4	16672771	.	C	T	20	13	33	0	0	33	0	0
4	16677348	.	T	C	14	8	22	0	0	22	0	0
4	16677354	.	C	G	14	10	24	0	0	24	0	0
4	16680671	.	T	G	11	8	19	0	2	21	0	0
4	16680674	.	T	G	11	10	21	0	0	21	0	0
4	16706865	.	T	C	13	13	26	0	0	26	0	0
4	16706889	.	A	T	17	11	28	0	1	29	0	0
4	16733585	.	G	A	7	15	22	0	1	23	0	0
4	16733984	.	C	T	10	12	22	0	0	22	0	0
4	16736812	.	C	G	8	1	9	0	9	18	0	0
4	16736833	.	A	G	9	2	11	0	9	20	0	0
4	16739122	.	G	A	0	6	6	0	3	9	0	0
4	16741979	.	T	G	13	10	23	0	2	25	0	0
4	16742444	.	G	C	10	9	19	0	1	20	0	0
4	16784712	.	A	T	1	2	3	0	0	3	0	0
4	16784840	.	G	T	23	18	41	0	1	42	0	0
4	16784876	.	C	T	16	24	40	0	2	42	0	0
4	16785393	.	A	G	14	19	33	0	1	34	0	0
4	16785664	.	A	T	23	12	35	0	1	36	0	0
4	16785766	.	T	C	4	9	13	0	0	13	0	0
4	16786018	.	A	T	3	4	7	0	0	7	0	0
4	16786059	.	T	C	4	7	11	0	0	11	0	0
4	16786077	.	G	A	2	9	11	0	0	11	0	0
4	16786208	.	C	T	3	13	16	0	0	16	0	0
4	16788485	.	C	T	4	3	7	0	0	7	0	0
4	16788500	.	G	A	1	4	5	0	4	9	0	0
4	16791616	.	G	A	7	7	14	0	0	14	0	0
4	16791673	.	C	A	11	4	15	0	0	15	0	0
4	16791780	.	A	G	7	0	7	0	5	12	0	0
4	16791781	.	G	C	7	5	12	0	0	12	0	0
4	16791883	.	T	A	3	2	5	1	0	6	0	0
4	16797248	.	C	T	2	2	4	0	1	5	0	0
4	16829355	.	T	C	31	40	71	0	1	72	0	0
4	16829387	.	T	G	33	35	68	0	1	69	0	0
4	16829651	.	G	A	29	35	64	0	7	71	0	0
4	16831399	.	A	T	31	35	66	0	2	68	0	0
4	16832124	.	C	A	6	29	35	0	30	65	0	0
4	16832894	.	G	A	28	38	66	0	2	68	0	0
4	16858155	.	G	A	2	2	4	0	0	4	0	0
4	16858289	.	G	C	7	0	7	0	6	13	0	0
4	16858414	.	A	T	3	2	5	0	1	6	0	0
4	16858442	.	C	G	2	4	6	0	2	8	0	0
4	16877387	.	C	T	1	17	18	0	19	37	0	0
4	16879505	.	T	C	14	0	14	0	27	41	0	0
4	16881865	.	T	G	14	19	33	0	2	35	0	0
4	16885898	.	A	T	19	18	37	0	0	37	0	0
4	16889709	.	C	T	16	16	32	0	0	32	0	0
4	16889745	.	G	A	8	15	23	0	0	23	0	0
4	16893050	.	A	G	18	8	26	0	0	26	0	0
4	16893062	.	T	C	17	11	28	0	0	28	0	0
4	16898904	.	A	T	14	22	36	0	0	36	0	0
4	16899273	.	T	C	17	26	43	0	2	45	0	0
4	16904521	.	C	G	23	27	50	0	1	51	0	0
4	16904527	.	A	G	22	2	24	0	25	49	0	0
4	16905090	.	T	C	23	18	41	0	1	42	0	0
4	16905119	.	T	C	17	24	41	0	1	42	0	0
4	16905184	.	T	C	17	21	38	0	0	38	0	0
4	16905224	.	A	G	16	16	32	0	0	32	0	0
4	16905318	.	G	A	16	16	32	2	0	34	0	0
4	16905370	.	G	A	10	6	16	0	1	17	0	0
4	16905410	.	C	A	2	2	4	0	0	4	0	0
4	16905511	.	C	T	7	11	18	0	0	18	0	0
4	16905684	.	T	G	15	12	27	0	0	27	0	0
4	16905708	.	T	A	17	11	28	0	1	29	0	0
4	16905723	.	C	A	18	12	30	0	1	31	0	0
4	16905853	.	T	A	11	20	31	0	1	32	0	0
4	16906173	.	C	A	14	24	38	0	2	40	0	0
4	16906198	.	C	A	14	17	31	0	8	39	0	0
4	16906244	.	A	T	29	15	44	0	2	46	0	0
4	16906562	.	G	A	21	20	41	0	0	41	0	0
4	16982269	.	G	A	9	15	24	0	1	25	0	0
4	16982682	.	C	A	16	10	26	0	0	26	0	0
4	16983131	.	A	G	8	7	15	0	0	15	0	0
4	16983183	.	G	A	7	6	13	0	0	13	0	0
4	16983434	.	T	C	20	0	20	0	21	41	0	0
4	16984252	.	C	G	12	9	21	0	2	23	0	0
4	16984542	.	A	G	13	5	18	2	2	22	0	0
4	16985045	.	C	T	3	5	8	0	1	9	0	0
4	16988139	.	A	G	19	15	34	0	2	36	0	0
4	17008995	.	A	G	18	6	24	0	1	25	0	0
4	17253737	.	A	G	5	6	11	0	1	12	0	0
4	17253758	.	C	T	6	7	13	0	0	13	0	0
4	17253813	.	A	C	6	4	10	0	1	11	0	0
4	17253818	.	A	G	5	4	9	0	0	9	0	0
4	17253925	.	T	A	13	8	21	0	0	21	0	0
4	17253927	.	T	A	13	8	21	0	0	21	0	0
4	17254046	.	A	G	10	13	23	0	0	23	0	0
4	17256855	.	C	T	9	7	16	0	2	18	0	0
4	17257386	.	G	A	11	9	20	0	1	21	0	0
4	17257458	.	C	T	4	14	18	0	0	18	0	0
4	17260535	.	G	A	6	6	12	0	0	12	0	0
4	17287446	.	T	G	6	19	25	0	4	29	0	0
4	17288964	.	T	C	14	23	37	0	0	37	0	0
4	17291024	.	A	G	9	22	31	0	2	33	0	0
4	17292575	.	C	A	18	16	34	0	0	34	0	0
4	17292770	.	G	A	30	19	49	0	1	50	0	0
4	17292789	.	A	C	29	20	49	0	1	50	0	0
4	17292837	.	A	G	22	18	40	0	4	44	0	0
4	17294947	.	T	C	18	20	38	0	0	38	0	0
4	17296974	.	A	G	5	14	19	0	2	21	0	0
4	17297086	.	C	A	14	21	35	0	1	36	0	0
4	17297338	.	T	G	7	6	13	0	1	14	0	0
4	17326234	.	C	T	2	3	5	0	1	6	0	0
4	17328010	.	G	C	1	6	7	0	0	7	0	0
4	17336624	.	C	T	5	3	8	0	0	8	0	0
4	17336693	.	G	A	4	6	10	0	1	11	0	0
4	17338664	.	T	C	7	3	10	0	0	10	0	0
4	17382830	.	T	C	1	4	5	0	0	5	0	0
4	17382833	.	A	G	2	3	5	0	0	5	0	0
4	17382878	.	G	A	3	2	5	0	1	6	0	0
4	17385929	.	T	C	3	2	5	0	1	6	0	0
4	17385943	.	G	T	4	2	6	0	0	6	0	0
4	17417668	.	T	G	3	0	3	0	6	9	0	0
4	17417692	.	C	T	3	3	6	0	0	6	0	0
4	17418109	.	G	A	2	4	6	0	1	7	0	0
4	17524485	.	T	C	7	3	10	0	0	10	0	0
4	17524604	.	T	A	1	2	3	0	1	4	0	0
4	17530542	.	G	A	3	3	6	0	0	6	0	0
4	17530572	.	T	C	4	2	6	0	1	7	0	0
4	17530763	.	C	T	3	4	7	0	0	7	0	0
4	17533769	.	C	T	3	6	9	0	0	9	0	0
4	17534198	.	A	G	1	0	1	0	4	5	0	0
4	17537939	.	G	T	0	5	5	0	6	11	0	0
4	17539157	.	G	A	2	2	4	0	1	5	0	0
4	17539261	.	T	G	3	2	5	0	0	5	0	0
4	17541666	.	A	G	4	4	8	0	0	8	0	0
4	17541730	.	G	A	4	4	8	0	0	8	0	0
4	17545083	.	A	G	10	0	10	0	10	20	0	0
4	17572583	.	C	T	14	16	30	0	1	31	0	0
4	17572589	.	C	A	11	15	26	0	0	26	0	0
4	17572898	.	T	C	19	15	34	1	2	37	0	0
4	17572901	.	A	C	19	15	34	1	2	37	0	0
4	17573071	.	A	T	7	10	17	0	1	18	0	0
4	17573081	.	G	C	10	10	20	0	0	20	0	0
4	17573464	.	A	G	7	11	18	0	0	18	0	0
4	17573465	.	A	G	7	11	18	0	0	18	0	0
4	17573594	.	T	A	11	11	22	0	0	22	0	0
4	17573616	.	A	G	8	11	19	0	0	19	0	0
4	17573644	.	A	C	13	7	20	0	0	20	0	0
4	17573697	.	G	A	17	6	23	3	0	26	0	0
4	17573706	.	A	G	15	6	21	3	1	25	0	0
4	17573802	.	T	C	20	12	32	0	2	34	0	0
4	17573841	.	A	G	21	19	40	0	0	40	0	0
4	17573865	.	T	A	16	17	33	0	8	41	0	0
4	17573959	.	T	A	17	7	24	0	1	25	0	0
4	17573982	.	A	T	18	11	29	0	0	29	0	0
4	17574093	.	A	G	16	11	27	0	0	27	0	0
4	17574175	.	G	C	13	12	25	0	0	25	0	0
4	17574390	.	C	T	21	9	30	0	3	33	0	0
4	17574608	.	A	C	13	6	19	0	0	19	0	0
4	17574706	.	T	C	6	9	15	0	2	17	0	0
4	17577307	.	C	A	17	16	33	0	0	33	0	0
4	17580468	.	A	T	22	11	33	0	1	34	0	0
4	17596433	.	T	C	11	1	12	0	19	31	0	0
4	17596490	.	T	C	15	11	26	0	0	26	0	0
4	17629138	.	C	T	0	9	9	0	14	23	0	0
4	17629266	.	C	A	7	11	18	0	1	19	0	0
4	17634398	.	C	T	0	3	3	0	1	4	0	0
4	17635835	.	T	A	1	1	2	0	1	3	0	0
4	17636616	.	C	T	1	2	3	0	0	3	0	0
4	17641351	.	T	C	1	0	1	0	4	5	0	0
4	17642813	.	G	T	10	3	13	0	0	13	0	0
4	17643252	.	A	G	3	5	8	0	0	8	0	0
4	17644600	.	T	C	6	5	11	0	0	11	0	0
4	17644913	.	A	G	6	9	15	0	0	15	0	0
4	17644964	.	G	A	6	6	12	0	0	12	0	0
4	17645408	.	T	C	4	6	10	0	0	10	0	0
4	17645890	.	A	C	8	6	14	0	0	14	0	0
4	17645962	.	C	T	5	3	8	0	0	8	0	0
4	17657549	.	A	G	11	0	11	0	8	19	0	0
4	17660723	.	C	T	2	4	6	0	0	6	0	0
4	17660732	.	A	G	2	5	7	0	1	8	0	0
4	17660859	.	G	A	5	7	12	0	0	12	0	0
4	17660871	.	A	G	4	6	10	0	0	10	0	0
4	17660913	.	G	A	1	4	5	0	0	5	0	0
4	17661102	.	T	G	6	3	9	1	0	10	0	0
4	17661191	.	T	C	8	3	11	0	0	11	0	0
4	17661200	.	C	T	8	3	11	0	0	11	0	0
4	17661349	.	C	T	6	2	8	0	0	8	0	0
4	17661354	.	T	G	6	2	8	0	0	8	0	0
4	17674690	.	T	C	1	5	6	0	0	6	0	0
4	17675998	.	G	A	0	2	2	0	3	5	0	0
4	17684505	.	C	T	2	4	6	0	0	6	0	0
4	17684535	.	A	T	1	3	4	0	0	4	0	0
4	17686494	.	T	C	4	3	7	0	0	7	0	0
4	17686515	.	G	C	3	3	6	0	0	6	0	0
4	17688726	.	G	A	9	6	15	0	0	15	0	0
4	17688795	.	T	C	10	13	23	0	0	23	0	0
4	17688849	.	T	C	11	9	20	0	0	20	0	0
4	17688874	.	T	C	12	7	19	0	0	19	0	0
4	17688897	.	C	T	11	4	15	0	0	15	0	0
4	17689128	.	C	T	4	3	7	0	0	7	0	0
4	17689133	.	A	T	4	3	7	0	0	7	0	0
4	17689377	.	A	G	3	3	6	0	0	6	0	0
4	17689395	.	C	T	3	3	6	0	0	6	0	0
4	17689464	.	C	A	2	6	8	0	0	8	0	0
4	17689476	.	A	G	3	0	3	0	6	9	0	0
4	17689551	.	G	A	5	3	8	0	0	8	0	0
4	17689561	.	T	C	4	4	8	0	0	8	0	0
4	17693223	.	C	T	4	6	10	0	0	10	0	0
4	17693232	.	C	T	4	5	9	0	0	9	0	0
4	17693286	.	T	C	4	6	10	0	2	12	0	0
4	17693400	.	A	G	9	6	15	1	0	16	0	0
4	17695054	.	A	G	4	4	8	0	1	9	0	0
4	17696254	.	G	A	6	3	9	0	1	10	0	0
4	17696341	.	A	G	4	0	4	0	4	8	0	0
4	17704067	.	G	A	4	5	9	0	0	9	0	0
4	17704123	.	T	C	4	5	9	0	1	10	0	0
4	17704279	.	T	A	5	3	8	0	0	8	0	0
4	17704345	.	C	T	6	4	10	0	0	10	0	0
4	17704393	.	A	T	9	4	13	0	1	14	0	0
4	17704885	.	T	C	1	2	3	0	1	4	0	0
4	17704915	.	A	T	1	5	6	0	1	7	0	0
4	17704928	.	T	A	2	3	5	0	1	6	0	0
4	17707849	.	A	C	3	4	7	0	0	7	0	0
4	17708230	.	T	C	10	5	15	0	0	15	0	0
4	17708346	.	G	A	6	6	12	0	0	12	0	0
4	17821696	.	A	G	1	2	3	0	0	3	0	0
4	17822109	.	A	G	3	2	5	0	0	5	0	0
4	17822112	.	T	C	3	2	5	0	0	5	0	0
4	17822279	.	G	A	2	5	7	0	0	7	0	0
4	17847911	.	T	C	2	2	4	0	0	4	0	0
4	17848917	.	A	T	1	2	3	0	1	4	0	0
4	17849010	.	C	T	3	2	5	0	0	5	0	0
4	17853738	.	T	C	3	3	6	0	0	6	0	0
4	17854396	.	C	T	5	2	7	0	0	7	0	0
4	17873351	.	A	G	4	13	17	0	0	17	0	0
4	17873530	.	T	G	6	7	13	0	1	14	0	0
4	17873711	.	A	T	2	4	6	0	0	6	0	0
4	17873743	.	C	T	4	2	6	0	1	7	0	0
4	17873808	.	G	C	4	2	6	0	0	6	0	0
4	17886974	.	G	A	13	21	34	0	1	35	0	0
4	17887059	.	T	C	14	12	26	0	2	28	0	0
4	17887388	.	A	T	16	19	35	0	1	36	0	0
4	17887826	.	C	T	20	28	48	0	1	49	0	0
4	17902098	.	A	G	16	23	39	0	0	39	0	0
4	17904325	.	A	C	29	0	29	0	14	43	0	0
4	17915070	.	G	A	23	21	44	0	3	47	0	0
4	17949261	.	C	T	17	11	28	0	1	29	0	0
4	17999156	.	G	A	3	6	9	0	0	9	0	0
4	17999310	.	C	A	5	8	13	0	1	14	0	0
4	17999412	.	G	T	3	4	7	0	0	7	0	0
4	18067311	.	C	T	8	9	17	0	0	17	0	0
4	18067324	.	G	T	10	9	19	0	0	19	0	0
4	18098108	.	C	T	0	3	3	0	1	4	0	0
4	18208005	.	A	G	5	2	7	0	0	7	0	0
4	18208068	.	A	G	7	7	14	0	0	14	0	0
4	18208347	.	C	G	4	5	9	0	6	15	0	0
4	18208519	.	A	G	2	2	4	0	0	4	0	0
4	18208557	.	C	A	2	3	5	0	0	5	0	0
4	18208569	.	T	C	2	4	6	0	0	6	0	0
4	18208635	.	T	A	1	4	5	0	0	5	0	0
4	18208939	.	C	T	6	3	9	0	0	9	0	0
4	18209107	.	G	C	5	7	12	1	0	13	0	0
4	18209181	.	A	T	6	3	9	0	3	12	0	0
4	18213267	.	C	T	8	7	15	0	1	16	0	0
4	18216182	.	A	G	12	7	19	0	0	19	0	0
4	18216251	.	T	C	13	9	22	0	1	23	0	0
4	18216332	.	A	G	8	11	19	0	1	20	0	0
4	18235106	.	T	C	8	5	13	0	0	13	0	0
4	18235397	.	A	T	6	4	10	0	0	10	0	0
4	18237355	.	A	G	3	5	8	0	1	9	0	0
4	18240451	.	G	A	6	12	18	0	0	18	0	0
4	18240536	.	G	T	8	3	11	0	1	12	0	0
4	18240546	.	C	T	0	3	3	0	8	11	0	0
4	18240607	.	C	A	0	6	6	0	4	10	0	0
4	18240640	.	C	G	4	4	8	0	0	8	0	0
4	18240658	.	T	C	4	4	8	0	0	8	0	0
4	18240690	.	A	T	4	4	8	0	1	9	0	0
4	18240811	.	G	A	2	2	4	0	0	4	0	0
4	18240822	.	G	A	3	2	5	0	0	5	0	0
4	18241030	.	A	G	8	4	12	0	0	12	0	0
4	18241255	.	C	G	8	7	15	0	0	15	0	0
4	18241297	.	C	T	5	3	8	0	0	8	0	0
4	18242936	.	G	T	7	8	15	0	0	15	0	0
4	18244632	.	T	A	8	4	12	0	0	12	0	0
4	18244669	.	G	A	11	4	15	0	0	15	0	0
4	18244670	.	G	C	12	0	12	0	4	16	0	0
4	18248692	.	C	T	2	5	7	0	14	21	0	0
4	18249120	.	G	C	3	7	10	0	0	10	0	0
4	18249414	.	T	C	7	6	13	0	0	13	0	0
4	18249423	.	G	T	6	5	11	0	1	12	0	0
4	18250996	.	G	A	4	2	6	0	1	7	0	0
4	18251171	.	T	G	2	4	6	0	0	6	0	0
4	18280931	.	A	G	1	2	3	0	1	4	0	0
4	18280978	.	C	T	0	3	3	0	1	4	0	0
4	18283222	.	A	G	2	2	4	0	1	5	0	0
4	18287049	.	G	C	3	3	6	0	1	7	0	0
4	18287263	.	T	C	2	3	5	0	0	5	0	0
4	18287739	.	T	G	0	2	2	0	0	2	0	0
4	18287744	.	A	G	1	2	3	0	0	3	0	0
4	18304850	.	C	G	0	4	4	0	1	5	0	0
4	18309456	.	T	A	3	3	6	0	0	6	0	0
4	18416371	.	C	G	5	8	13	0	0	13	0	0
4	18416429	.	A	G	2	2	4	0	0	4	0	0
4	18432317	.	T	C	3	2	5	0	0	5	0	0
4	18432363	.	G	T	1	5	6	0	0	6	0	0
4	18432790	.	C	A	1	4	5	0	0	5	0	0
4	18436549	.	G	A	1	2	3	0	1	4	0	0
4	18436831	.	T	C	1	2	3	0	0	3	0	0
4	18445825	.	C	T	1	2	3	0	0	3	0	0
4	18454352	.	A	G	3	5	8	0	0	8	0	0
4	18454363	.	T	A	3	6	9	0	1	10	0	0
4	18454400	.	C	T	0	6	6	0	6	12	0	0
4	18454423	.	G	A	6	3	9	0	1	10	0	0
4	18497179	.	A	T	2	2	4	0	0	4	0	0
4	18502437	.	A	G	3	3	6	0	0	6	0	0
4	18504433	.	C	G	1	3	4	0	3	7	0	0
4	18505935	.	G	C	2	2	4	0	0	4	0	0
4	18507196	.	G	A	3	3	6	0	0	6	0	0
4	18509231	.	A	G	3	2	5	0	0	5	0	0
4	18510675	.	C	T	0	4	4	1	2	7	0	0
4	18512419	.	T	C	2	2	4	0	0	4	0	0
4	18592863	.	A	C	6	6	12	0	0	12	0	0
4	18592916	.	T	A	1	2	3	0	0	3	0	0
4	18593839	.	G	A	17	9	26	0	2	28	0	0
4	18594019	.	G	T	12	7	19	0	1	20	0	0
4	18594045	.	T	C	8	9	17	0	0	17	0	0
4	18594125	.	T	A	11	10	21	0	3	24	0	0
4	18594789	.	T	G	3	2	5	0	0	5	0	0
4	18594871	.	T	C	15	9	24	0	4	28	0	0
4	18594920	.	G	A	20	7	27	0	0	27	0	0
4	18597841	.	C	G	8	10	18	0	3	21	0	0
4	18606501	.	G	T	19	22	41	0	3	44	0	0
4	18606512	.	C	T	12	23	35	0	0	35	0	0
4	18609613	.	T	G	5	5	10	0	0	10	0	0
4	18609812	.	A	C	3	3	6	0	0	6	0	0
4	18609855	.	G	C	4	3	7	0	0	7	0	0
4	18614034	.	A	G	10	5	15	0	0	15	0	0
4	18614208	.	C	T	5	2	7	0	0	7	0	0
4	18614232	.	A	G	6	2	8	0	1	9	0	0
4	18707376	.	C	T	1	2	3	0	2	5	0	0
4	18720942	.	C	T	5	3	8	0	0	8	0	0
4	18720947	.	G	T	5	2	7	0	2	9	0	0
4	18738057	.	A	G	2	3	5	0	0	5	0	0
4	18738072	.	T	C	1	4	5	0	0	5	0	0
4	18741452	.	C	T	1	3	4	0	0	4	0	0
4	18837898	.	A	T	14	9	23	0	1	24	0	0
4	18850630	.	A	G	4	5	9	0	0	9	0	0
4	18853972	.	C	G	10	13	23	0	1	24	0	0
4	18854250	.	A	C	17	0	17	0	12	29	0	0
4	18854433	.	A	G	11	6	17	0	0	17	0	0
4	18939328	.	A	G	2	2	4	1	0	5	0	0
4	18963897	.	G	A	1	10	11	0	12	23	0	0
4	18963908	.	C	A	12	9	21	0	1	22	0	0
4	18963960	.	G	C	6	7	13	0	2	15	0	0
4	18976182	.	A	G	8	6	14	0	0	14	0	0
4	18976574	.	C	T	14	8	22	0	0	22	0	0
4	18979820	.	T	A	13	22	35	0	1	36	0	0
4	18985251	.	C	T	12	2	14	0	1	15	0	0
4	18985268	.	C	A	12	2	14	0	0	14	0	0
4	18985807	.	T	A	14	12	26	0	1	27	0	0
4	18985846	.	A	G	19	13	32	0	0	32	0	0
4	18985995	.	G	A	13	9	22	0	0	22	0	0
4	18986107	.	C	T	7	6	13	0	0	13	0	0
4	18986413	.	G	A	9	14	23	0	0	23	0	0
4	18986497	.	C	T	3	16	19	0	15	34	0	0
4	18986771	.	A	T	9	4	13	1	0	14	0	0
4	18986805	.	G	T	8	8	16	1	0	17	0	0
4	18986893	.	C	G	8	8	16	0	1	17	0	0
4	18986897	.	T	A	9	5	14	0	0	14	0	0
4	18987202	.	C	A	8	6	14	0	0	14	0	0
4	18987216	.	T	C	11	5	16	0	1	17	0	0
4	18987250	.	G	A	11	6	17	0	1	18	0	0
4	18987275	.	A	G	10	6	16	0	1	17	0	0
4	18987391	.	G	A	9	6	15	0	2	17	0	0
4	18987523	.	T	C	14	13	27	0	1	28	0	0
4	18987835	.	G	C	14	0	14	0	21	35	0	0
4	18988068	.	T	C	9	0	9	0	13	22	0	0
4	18988084	.	G	A	11	9	20	0	1	21	0	0
4	18988150	.	T	G	11	15	26	0	1	27	0	0
4	18988222	.	A	G	8	14	22	0	1	23	0	0
4	18988270	.	T	A	6	14	20	0	0	20	0	0
4	18988426	.	G	C	5	9	14	0	0	14	0	0
4	18988912	.	G	A	12	9	21	0	0	21	0	0
4	18989185	.	T	C	7	0	7	0	8	15	0	0
4	18999680	.	C	T	2	8	10	0	10	20	0	0
4	19007158	.	C	T	0	11	11	0	9	20	0	0
4	19007377	.	T	A	16	7	23	0	1	24	0	0
4	19007486	.	A	C	11	12	23	0	1	24	0	0
4	19007601	.	A	T	10	13	23	0	0	23	0	0
4	19007711	.	T	C	11	0	11	0	9	20	0	0
4	19007811	.	T	C	12	18	30	0	2	32	0	0
4	19007823	.	A	G	13	15	28	0	0	28	0	0
4	19008090	.	C	T	2	7	9	0	7	16	0	0
4	19397641	.	A	T	14	7	21	0	0	21	0	0
4	19414905	.	G	A	9	14	23	0	0	23	0	0
4	19421890	.	G	A	11	12	23	0	1	24	0	0
4	19493773	.	G	T	13	16	29	0	0	29	0	0
4	19493808	.	G	A	13	16	29	0	0	29	0	0
4	19535841	.	T	G	21	14	35	2	0	37	0	0
4	19536422	.	T	C	13	18	31	0	1	32	0	0
4	19536917	.	C	T	26	23	49	0	2	51	0	0
4	19537703	.	A	G	25	29	54	0	1	55	0	0
4	19537937	.	A	G	23	1	24	0	27	51	0	0
4	19539017	.	C	T	13	7	20	0	1	21	0	0
4	19567605	.	A	G	20	11	31	0	0	31	0	0
4	19611694	.	G	A	10	19	29	0	1	30	0	0
4	19611739	.	T	G	10	13	23	0	1	24	0	0
4	19630280	.	A	G	12	12	24	0	1	26	1	0
4	19651917	.	G	A	14	10	24	0	0	24	0	0
4	19686284	.	A	G	8	4	12	0	0	12	0	0
4	19690484	.	C	A	0	10	10	0	7	17	0	0
4	19776011	.	G	A	4	4	8	0	1	9	0	0
4	19776014	.	G	C	4	0	4	0	4	8	0	0
4	19783537	.	C	T	1	3	4	0	0	4	0	0
4	19947781	.	G	T	3	3	6	0	0	6	0	0
4	19948131	.	G	A	4	3	7	0	1	8	0	0
4	19948312	.	A	G	3	3	6	0	0	6	0	0
4	19948313	.	A	G	3	3	6	0	0	6	0	0
4	19948746	.	T	C	4	6	10	0	0	10	0	0
4	19949148	.	T	C	8	5	13	0	0	13	0	0
4	19949178	.	A	T	4	5	9	0	0	9	0	0
4	19949260	.	A	G	1	2	3	0	0	3	0	0
4	19949271	.	T	C	1	2	3	0	0	3	0	0
4	19949615	.	T	C	1	4	5	0	0	5	0	0
4	19949651	.	C	T	1	5	6	0	4	10	0	0
4	19949730	.	T	C	2	7	9	0	0	9	0	0
4	19949963	.	T	C	6	9	15	0	0	15	0	0
4	19949985	.	T	C	4	5	9	0	0	9	0	0
4	19950024	.	T	A	2	4	6	0	0	6	0	0
4	19950032	.	T	A	5	3	8	0	0	8	0	0
4	19950081	.	A	G	4	2	6	0	0	6	0	0
4	19950162	.	C	T	0	2	2	0	1	3	0	0
4	19950212	.	A	C	3	3	6	0	0	6	0	0
4	19950412	.	A	G	2	2	4	0	0	4	0	0
4	19954907	.	G	C	2	0	2	0	8	10	0	0
4	19955017	.	G	T	3	3	6	0	1	7	0	0
4	19955237	.	A	G	3	2	5	0	0	5	0	0
4	19955276	.	A	G	4	2	6	0	0	6	0	0
4	19962613	.	T	G	0	2	2	0	2	4	0	0
4	19962725	.	T	C	3	0	3	2	5	10	0	0
4	19981777	.	C	T	3	4	7	0	0	7	0	0
4	20049543	.	C	T	24	22	46	0	2	48	0	0
4	20051021	.	A	G	29	31	60	0	3	63	0	0
4	20051092	.	C	T	0	24	24	0	17	41	0	0
4	20051485	.	A	G	6	8	14	0	1	15	0	0
4	20051488	.	A	G	8	11	19	0	0	19	0	0
4	20053199	.	T	C	25	11	36	0	2	38	0	0
4	20053211	.	A	G	26	12	38	0	2	40	0	0
4	20053901	.	C	T	23	15	38	0	2	40	0	0
4	20054036	.	C	T	19	13	32	0	3	35	0	0
4	20054135	.	A	G	5	5	10	0	2	12	0	0
4	20054243	.	A	G	3	5	8	0	1	9	0	0
4	20054516	.	C	T	2	3	5	0	0	5	0	0
4	20060589	.	A	G	2	2	4	0	2	6	0	0
4	20065233	.	C	T	6	3	9	0	1	10	0	0
4	20066194	.	T	G	1	8	9	0	0	9	0	0
4	20066208	.	G	A	2	6	8	0	1	9	0	0
4	20066263	.	T	C	8	3	11	0	0	11	0	0
4	20068149	.	T	G	7	9	16	0	0	17	1	0
4	20068185	.	A	G	7	10	17	0	0	17	0	0
4	20068266	.	A	G	11	9	20	0	2	22	0	0
4	20068446	.	G	A	15	11	26	0	0	26	0	0
4	20068470	.	C	G	15	9	24	0	1	25	0	0
4	20068717	.	G	A	10	5	15	0	1	16	0	0
4	20068890	.	G	A	11	7	18	0	0	18	0	0
4	20068903	.	T	C	9	9	18	0	0	18	0	0
4	20069091	.	T	C	5	4	9	0	1	10	0	0
4	20069343	.	C	A	8	8	16	0	0	16	0	0
4	20071344	.	A	T	3	7	10	0	0	10	0	0
4	20071401	.	G	T	3	9	12	0	0	12	0	0
4	20072035	.	T	C	3	2	5	0	0	5	0	0
4	20072084	.	G	C	7	3	10	0	0	10	0	0
4	20072094	.	C	T	8	3	11	0	0	11	0	0
4	20072394	.	C	G	5	15	20	0	1	21	0	0
4	20072429	.	T	G	9	17	26	0	0	26	0	0
4	20073790	.	T	C	8	10	18	0	1	19	0	0
4	20073799	.	A	G	7	10	17	0	1	18	0	0
4	20075455	.	T	C	4	5	9	0	1	10	0	0
4	20075473	.	G	A	4	9	13	0	0	13	0	0
4	20078569	.	G	A	4	2	6	0	0	6	0	0
4	20081451	.	A	G	5	3	8	0	0	8	0	0
4	20081520	.	C	A	1	8	9	0	6	15	0	0
4	20085183	.	A	G	1	4	5	0	0	5	0	0
4	20089075	.	C	A	8	5	13	0	0	13	0	0
4	20091055	.	G	C	2	6	8	0	4	12	0	0
4	20098793	.	C	G	4	6	10	0	0	10	0	0
4	20098937	.	C	T	2	4	6	0	1	7	0	0
4	20099022	.	G	A	6	6	12	0	0	12	0	0
4	20099261	.	C	T	6	5	11	0	0	11	0	0
4	20099516	.	G	A	1	3	4	0	9	13	0	0
4	20099564	.	C	T	5	8	13	0	0	13	0	0
4	20101105	.	G	T	4	3	7	0	1	8	0	0
4	20102901	.	C	A	8	3	11	0	0	11	0	0
4	20103319	.	A	G	2	3	5	0	0	5	0	0
4	20103813	.	T	A	5	2	7	0	0	7	0	0
4	20103864	.	G	A	3	4	7	0	0	7	0	0
4	20103873	.	T	C	5	5	10	0	0	10	0	0
4	20105455	.	T	A	2	3	5	0	1	6	0	0
4	20117591	.	A	G	1	3	4	0	0	4	0	0
4	20125767	.	A	G	3	3	6	0	0	6	0	0
4	20127909	.	C	T	2	4	6	0	0	6	0	0
4	20129813	.	C	T	2	2	4	0	0	4	0	0
4	20129822	.	C	T	1	2	3	0	0	3	0	0
4	20130015	.	G	T	5	6	11	0	0	11	0	0
4	20133945	.	G	C	3	4	7	0	1	8	0	0
4	20135088	.	A	C	4	0	4	0	6	10	0	0
4	20150186	.	A	G	1	2	3	0	0	3	0	0
4	20187823	.	G	A	1	2	3	0	0	3	0	0
4	20226677	.	A	G	12	9	21	0	1	22	0	0
4	20226826	.	T	C	7	8	15	0	0	15	0	0
4	20226916	.	A	C	8	13	21	0	0	21	0	0
4	20229626	.	C	T	10	13	23	0	0	23	0	0
4	20229920	.	C	A	1	11	12	0	13	25	0	0
4	20230213	.	G	A	11	8	19	0	1	20	0	0
4	20232838	.	A	G	7	16	23	0	2	25	0	0
4	20235766	.	G	A	14	10	24	0	1	25	0	0
4	20255240	.	T	C	8	4	12	0	1	13	0	0
4	20265275	.	A	T	15	13	28	0	1	29	0	0
4	20265309	.	C	T	17	14	31	0	0	31	0	0
4	20303545	.	T	C	3	2	5	0	0	5	0	0
4	20303604	.	T	C	3	2	5	0	1	6	0	0
4	20305777	.	T	G	5	3	8	0	0	8	0	0
4	20306278	.	T	C	3	2	5	0	0	5	0	0
4	20306333	.	G	A	4	2	6	0	0	6	0	0
4	20306436	.	C	T	3	3	6	0	0	6	0	0
4	20306447	.	T	C	4	0	4	0	3	7	0	0
4	20313085	.	G	A	1	2	3	0	0	3	0	0
4	20313106	.	T	G	2	2	4	0	0	4	0	0
4	20447754	.	A	G	5	8	13	0	0	13	0	0
4	20453583	.	A	C	10	4	14	0	1	15	0	0
4	20453824	.	A	G	5	11	16	0	0	16	0	0
4	20464937	.	C	T	9	9	18	0	2	20	0	0
4	20465711	.	T	C	7	14	21	0	0	21	0	0
4	20465899	.	C	T	7	10	17	0	1	18	0	0
4	20467610	.	T	C	14	13	27	0	1	28	0	0
4	20470061	.	G	A	19	16	35	0	0	35	0	0
4	20470205	.	C	T	14	16	30	0	1	31	0	0
4	20470316	.	C	T	8	12	20	0	1	21	0	0
4	20473032	.	G	A	19	7	26	0	2	28	0	0
4	20473127	.	G	A	0	17	17	0	12	29	0	0
4	20473142	.	C	T	9	18	27	0	0	27	0	0
4	20473175	.	C	T	10	18	28	0	0	28	0	0
4	20474363	.	A	T	17	11	28	0	2	30	0	0
4	20474728	.	A	T	13	8	21	0	1	22	0	0
4	20474969	.	A	G	11	1	12	0	8	20	0	0
4	20480734	.	G	A	8	8	16	0	0	16	0	0
4	20482150	.	T	C	3	2	5	0	0	5	0	0
4	20482425	.	A	G	6	6	12	0	0	12	0	0
4	20482506	.	C	T	6	10	16	0	1	17	0	0
4	20482615	.	G	T	7	2	9	0	0	9	0	0
4	20482726	.	A	G	5	7	12	0	1	13	0	0
4	20483785	.	G	A	4	3	7	0	0	7	0	0
4	20483846	.	T	G	6	3	9	0	0	9	0	0
4	20483881	.	C	T	4	2	6	0	0	6	0	0
4	20483901	.	G	A	6	3	9	0	0	9	0	0
4	20483918	.	A	G	5	2	7	0	0	7	0	0
4	20486173	.	T	C	3	3	6	0	0	6	0	0
4	20488741	.	T	C	3	3	6	0	0	6	0	0
4	20490031	.	C	T	4	3	7	0	0	7	0	0
4	20490043	.	T	C	4	3	7	0	0	7	0	0
4	20494332	.	C	T	9	3	12	0	0	12	0	0
4	20496653	.	A	G	1	5	6	0	3	9	0	0
4	20496655	.	C	T	1	7	8	0	0	8	0	0
4	20498240	.	A	G	8	4	12	0	0	12	0	0
4	20499405	.	C	T	7	2	9	0	0	9	0	0
4	20499421	.	G	C	1	7	8	0	0	8	0	0
4	20499440	.	A	G	1	5	6	0	0	6	0	0
4	20499493	.	T	G	5	4	9	0	0	9	0	0
4	20499516	.	G	T	6	3	9	0	0	9	0	0
4	20499557	.	G	A	6	4	10	0	0	10	0	0
4	20507121	.	T	A	11	10	21	0	0	21	0	0
4	20507155	.	A	C	17	11	28	0	0	28	0	0
4	20507473	.	T	A	6	8	14	0	3	17	0	0
4	20507546	.	T	A	11	7	18	0	0	18	0	0
4	20508691	.	G	A	10	8	18	1	1	20	0	0
4	20508913	.	A	G	13	9	22	0	1	23	0	0
4	20508928	.	A	G	12	11	23	0	0	23	0	0
4	20508992	.	C	T	15	10	25	0	0	25	0	0
4	20930170	.	C	T	3	4	7	0	0	7	0	0
4	20949623	.	G	C	4	6	10	0	0	10	0	0
4	20950073	.	C	T	5	5	10	0	1	11	0	0
4	20950816	.	T	C	2	4	6	0	2	8	0	0
4	20950990	.	A	C	4	6	10	0	0	10	0	0
4	20951080	.	C	T	5	3	8	0	0	8	0	0
4	20951111	.	G	A	5	3	8	0	0	8	0	0
4	20951390	.	C	T	12	13	25	0	0	25	0	0
4	20952889	.	C	T	6	8	14	0	0	14	0	0
4	20952934	.	A	G	9	0	9	0	6	15	0	0
4	20955052	.	T	C	11	7	18	0	0	18	0	0
4	20958929	.	G	A	0	7	7	0	12	19	0	0
4	20959176	.	T	C	7	9	16	0	0	16	0	0
4	20965426	.	A	T	3	3	6	0	0	6	0	0
4	20965483	.	T	C	12	9	21	0	0	21	0	0
4	20971490	.	C	T	15	11	26	0	1	27	0	0
4	20974250	.	C	T	13	11	24	0	0	24	0	0
4	20974343	.	C	A	12	10	22	0	1	23	0	0
4	20976062	.	A	T	8	8	16	1	1	18	0	0
4	20976085	.	G	A	12	13	25	0	0	25	0	0
4	20976252	.	G	A	8	8	16	0	1	17	0	0
4	20976371	.	C	T	8	4	12	0	0	12	0	0
4	20979435	.	C	A	8	13	21	0	0	21	0	0
4	20980971	.	A	G	10	8	18	0	1	19	0	0
4	20981198	.	G	A	0	17	17	0	10	27	0	0
4	20981273	.	A	C	10	9	19	0	0	19	0	0
4	21290798	.	G	A	26	31	57	0	1	58	0	0
4	21295949	.	T	C	30	32	62	0	7	69	0	0
4	21297417	.	A	C	31	32	63	0	5	68	0	0
4	21312642	.	T	C	35	19	54	0	7	61	0	0
4	21312981	.	C	T	20	38	58	0	8	66	0	0
4	21313120	.	A	G	27	3	30	0	38	68	0	0
4	21313136	.	T	C	30	35	65	0	6	71	0	0
4	21313779	.	T	G	39	22	61	0	2	63	0	0
4	21313805	.	G	A	4	26	30	0	44	74	0	0
4	21314120	.	T	C	33	23	56	0	1	57	0	0
4	21314204	.	G	T	25	22	47	0	3	50	0	0
4	21314338	.	G	T	30	36	66	0	0	66	0	0
4	21314583	.	T	C	37	27	64	0	0	64	0	0
4	21323174	.	T	A	2	3	5	0	0	5	0	0
4	21323215	.	T	C	1	0	1	0	4	5	0	0
4	21323216	.	T	G	2	3	5	0	0	5	0	0
4	21323363	.	G	C	7	5	12	0	0	12	0	0
4	21323454	.	A	G	1	3	4	0	0	4	0	0
4	21323467	.	G	C	1	4	5	0	0	5	0	0
4	21323532	.	C	T	0	6	6	0	3	9	0	0
4	21323536	.	T	C	3	5	8	0	1	9	0	0
4	21369434	.	G	A	2	7	9	0	0	9	0	0
4	21489549	.	A	G	2	5	7	0	2	9	0	0
4	21489629	.	G	T	12	14	26	0	0	26	0	0
4	21490320	.	T	C	26	9	35	0	2	37	0	0
4	21490344	.	A	G	21	16	37	0	2	39	0	0
4	21499521	.	G	A	24	11	35	0	1	36	0	0
4	21507026	.	G	A	11	12	23	0	1	24	0	0
4	21508353	.	C	T	15	13	28	0	1	29	0	0
4	21512191	.	C	T	17	15	32	1	1	34	0	0
4	21517970	.	A	G	14	12	26	0	0	26	0	0
4	21523541	.	A	T	17	22	39	3	2	44	0	0
4	21523789	.	T	G	17	6	23	0	0	23	0	0
4	21525430	.	G	T	7	9	16	0	1	17	0	0
4	21526300	.	A	G	9	10	19	0	0	19	0	0
4	21649505	.	G	A	34	28	62	1	4	67	0	0
4	21651486	.	G	A	40	30	70	0	0	70	0	0
4	21652609	.	A	T	8	10	18	0	1	19	0	0
4	21752284	.	G	A	11	8	19	0	1	20	0	0
4	21752291	.	C	T	12	6	18	0	2	20	0	0
4	21752357	.	T	G	8	4	12	0	0	12	0	0
4	21752688	.	G	C	12	0	12	0	9	21	0	0
4	21752736	.	T	C	8	13	21	0	1	22	0	0
4	21752941	.	T	A	12	15	27	0	2	29	0	0
4	21752969	.	C	T	10	12	22	0	0	22	0	0
4	21752984	.	C	A	5	13	18	0	0	18	0	0
4	21753139	.	C	T	7	21	28	0	0	28	0	0
4	21753185	.	T	C	10	24	34	0	0	34	0	0
4	21753316	.	T	C	15	22	37	0	1	38	0	0
4	21753344	.	G	A	16	15	31	0	1	32	0	0
4	21761688	.	A	T	15	25	40	0	0	40	0	0
4	21958043	.	A	G	11	12	23	0	1	24	0	0
4	21958150	.	C	T	13	11	24	1	0	25	0	0
4	21958226	.	T	G	18	14	32	0	0	32	0	0
4	21958276	.	C	T	0	13	13	0	17	30	0	0
4	21967383	.	C	A	1	2	3	0	0	3	0	0
4	21967393	.	A	C	1	2	3	0	0	3	0	0
4	21973713	.	T	C	14	12	26	0	0	26	0	0
4	21975248	.	G	A	19	11	30	0	1	31	0	0
4	21975489	.	G	T	12	14	26	0	1	27	0	0
4	21981022	.	G	A	5	14	19	0	0	19	0	0
4	21981118	.	T	C	11	11	22	0	2	24	0	0
4	21988402	.	G	A	18	12	30	0	0	30	0	0
4	21988481	.	G	A	9	12	21	0	2	23	0	0
4	21998265	.	G	A	6	2	8	0	0	8	0	0
4	22002244	.	A	C	10	7	17	0	2	19	0	0
4	22006507	.	C	A	2	13	15	0	4	19	0	0
4	22016509	.	G	A	12	7	19	0	0	19	0	0
4	22016531	.	C	T	2	9	11	0	11	22	0	0
4	22029459	.	A	C	10	5	15	0	3	18	0	0
4	22033404	.	G	A	10	12	22	0	0	22	0	0
4	22299747	.	G	A	11	6	17	0	0	17	0	0
4	22300125	.	A	C	4	6	10	0	0	10	0	0
4	22300153	.	T	A	3	3	6	0	0	6	0	0
4	22300178	.	C	T	3	2	5	0	0	5	0	0
4	22300257	.	C	T	1	3	4	0	0	4	0	0
4	22313107	.	A	T	5	4	9	0	1	10	0	0
4	22313195	.	G	C	11	10	21	0	1	22	0	0
4	22313216	.	T	G	8	13	21	0	0	21	0	0
4	22313244	.	G	A	11	9	20	0	0	20	0	0
4	22313351	.	G	A	3	12	15	0	0	15	0	0
4	22313398	.	T	A	3	6	9	0	0	9	0	0
4	22313582	.	T	C	7	0	7	0	4	11	0	0
4	22313722	.	A	C	3	6	9	0	0	9	0	0
4	22314001	.	A	T	6	8	14	0	1	15	0	0
4	22314085	.	G	A	5	4	9	0	1	10	0	0
4	22316148	.	T	C	11	7	18	0	0	18	0	0
4	22316321	.	C	T	13	7	20	0	0	20	0	0
4	22316624	.	A	T	17	8	25	0	1	26	0	0
4	22317702	.	T	A	10	7	17	0	0	17	0	0
4	22318828	.	G	A	5	7	12	0	1	13	0	0
4	22319033	.	G	A	4	4	8	0	0	8	0	0
4	22319101	.	G	T	3	2	5	0	0	5	0	0
4	22319133	.	G	A	2	4	6	0	0	6	0	0
4	22319428	.	G	C	10	5	15	0	0	15	0	0
4	22319434	.	T	C	10	5	15	0	0	15	0	0
4	22319558	.	G	A	9	7	16	0	0	16	0	0
4	22319562	.	G	A	8	8	16	0	0	16	0	0
4	22319624	.	C	T	4	8	12	0	0	12	0	0
4	22320043	.	C	T	4	7	11	0	0	11	0	0
4	22321391	.	C	A	2	2	4	0	0	4	0	0
4	22321803	.	A	G	2	2	4	0	1	5	0	0
4	22321822	.	A	C	3	3	6	0	0	6	0	0
4	22322003	.	C	A	2	6	8	0	0	8	0	0
4	22322080	.	G	A	2	3	5	0	0	5	0	0
4	22322859	.	C	A	4	2	6	0	0	6	0	0
4	22327318	.	G	C	4	3	7	0	1	8	0	0
4	22327963	.	T	G	5	2	7	0	2	9	0	0
4	22328562	.	C	T	5	2	7	0	0	7	0	0
4	22328596	.	C	T	8	2	10	0	0	10	0	0
4	22328645	.	T	G	4	2	6	0	0	6	0	0
4	22328679	.	C	T	4	2	6	0	0	6	0	0
4	22328770	.	A	C	2	4	6	0	0	6	0	0
4	22329129	.	G	T	3	4	7	0	0	7	0	0
4	22329137	.	A	T	2	3	5	0	0	5	0	0
4	22329174	.	G	T	2	3	5	0	0	5	0	0
4	22329181	.	T	C	4	3	7	0	0	7	0	0
4	22329327	.	T	C	4	5	9	0	0	9	0	0
4	22335207	.	A	G	1	2	3	0	0	3	0	0
4	22357306	.	T	A	3	3	6	0	0	6	0	0
4	22363259	.	T	A	3	3	6	0	0	6	0	0
4	22363264	.	A	T	2	1	3	0	1	4	0	0
4	22363610	.	A	G	1	3	4	0	0	4	0	0
4	22365152	.	C	T	17	13	30	0	2	32	0	0
4	22365163	.	G	C	17	14	31	0	1	32	0	0
4	22365251	.	G	A	11	14	25	0	1	26	0	0
4	22365747	.	C	T	24	24	48	0	2	50	0	0
4	22419473	.	C	A	24	27	51	0	2	53	0	0
4	22419483	.	G	T	23	25	48	0	1	49	0	0
4	22419663	.	T	G	6	11	17	0	0	17	0	0
4	22419739	.	A	G	3	1	4	0	4	8	0	0
4	22424854	.	G	A	15	17	32	0	0	32	0	0
4	22424891	.	A	G	15	17	32	0	1	33	0	0
4	22425115	.	G	A	15	14	29	0	1	30	0	0
4	22428110	.	G	A	14	12	26	0	2	28	0	0
4	22428619	.	T	C	16	11	27	0	0	27	0	0
4	22428745	.	C	T	0	14	14	0	8	22	0	0
4	22428871	.	C	T	1	9	10	0	11	21	0	0
4	22430827	.	C	T	3	21	24	0	12	36	0	0
4	22432794	.	T	A	11	11	22	0	1	23	0	0
4	22432825	.	G	T	13	9	22	0	1	23	0	0
4	22433307	.	A	G	16	19	35	0	2	37	0	0
4	22433366	.	A	T	18	21	39	0	2	41	0	0
4	22433474	.	T	C	12	15	27	0	1	28	0	0
4	22438644	.	C	T	16	8	24	0	0	24	0	0
4	22440324	.	C	T	5	10	15	0	1	16	0	0
4	22445415	.	C	T	2	7	9	0	13	22	0	0
4	22472526	.	C	T	0	11	11	0	8	19	0	0
4	22472541	.	T	A	8	10	18	0	2	20	0	0
4	22472603	.	A	T	13	10	23	0	1	24	0	0
4	22756239	.	T	C	15	14	29	0	0	29	0	0
4	23550737	.	C	T	4	5	9	1	0	10	0	0
4	23550740	.	C	A	4	5	9	1	0	10	0	0
4	23550854	.	C	T	2	2	4	0	4	8	0	0
4	23636947	.	A	G	4	4	8	1	0	9	0	0
4	23636987	.	C	A	2	6	8	4	1	13	0	0
4	23741043	.	T	A	2	3	5	0	0	5	0	0
4	23741048	.	T	G	2	2	4	0	1	5	0	0
4	23746254	.	A	G	2	4	6	0	0	6	0	0
4	23773529	.	A	G	4	4	8	0	0	8	0	0
4	23773977	.	A	G	3	9	12	0	1	13	0	0
4	23773982	.	T	G	2	9	11	0	1	12	0	0
4	23774038	.	C	A	3	3	6	0	0	6	0	0
4	23775252	.	C	A	9	11	20	0	1	21	0	0
4	23775630	.	G	C	12	0	12	0	17	29	0	0
4	23775759	.	C	T	0	9	9	0	8	17	0	0
4	23775827	.	T	C	4	0	4	0	10	14	0	0
4	23784376	.	A	G	6	8	14	0	1	15	0	0
4	23785175	.	C	A	4	4	8	0	3	11	0	0
4	23788493	.	C	T	0	5	5	0	9	14	0	0
4	23790723	.	A	G	10	10	20	0	1	21	0	0
4	23887318	.	C	T	4	27	31	0	26	57	0	0
4	23887847	.	T	A	15	9	24	0	0	24	0	0
4	23888406	.	A	T	21	14	35	0	0	35	0	0
4	23892938	.	C	T	3	17	20	1	18	39	0	0
4	23892998	.	G	A	18	21	39	0	2	41	0	0
4	23893052	.	C	A	16	24	40	0	3	43	0	0
4	23908758	.	C	T	21	15	36	1	1	38	0	0
4	23913316	.	C	T	26	24	50	0	1	51	0	0
4	23938614	.	G	A	24	22	46	0	3	49	0	0
4	23938617	.	C	T	27	21	48	0	2	50	0	0
4	24019484	.	C	G	3	6	9	0	0	9	0	0
4	24031700	.	T	C	10	3	13	0	1	15	1	0
4	25054826	.	G	A	15	4	19	0	1	20	0	0
4	25055230	.	G	A	20	17	37	0	2	39	0	0
4	25055479	.	C	G	5	15	20	0	10	30	0	0
4	25055602	.	A	G	22	26	48	0	4	52	0	0
4	25084487	.	T	G	6	2	8	0	1	9	0	0
4	25084744	.	A	G	6	8	14	0	0	14	0	0
4	25105502	.	G	T	15	8	23	0	3	26	0	0
4	25105662	.	A	G	11	9	20	0	0	20	0	0
4	25168280	.	T	C	6	6	12	0	1	13	0	0
4	25168417	.	A	G	6	6	12	0	0	12	0	0
4	25168418	.	A	G	6	6	12	0	0	12	0	0
4	25173387	.	T	C	23	23	46	0	1	47	0	0
4	25173396	.	A	G	23	19	42	0	4	46	0	0
4	25176093	.	A	G	36	28	64	0	1	65	0	0
4	25176420	.	C	T	28	29	57	4	4	65	0	0
4	25178069	.	G	T	24	20	44	0	1	45	0	0
4	25178402	.	G	C	23	20	43	0	2	45	0	0
4	25179897	.	A	G	18	29	47	0	2	49	0	0
4	25179948	.	C	T	1	29	30	0	22	52	0	0
4	25179996	.	A	G	24	30	54	0	3	57	0	0
4	25181863	.	T	C	5	4	9	0	0	9	0	0
4	25184430	.	T	A	8	5	13	0	1	14	0	0
4	25184718	.	G	A	5	2	7	0	0	7	0	0
4	25184757	.	C	T	5	6	11	0	0	11	0	0
4	25184760	.	C	T	4	6	10	0	0	10	0	0
4	25185797	.	T	C	7	9	16	0	1	17	0	0
4	25271105	.	T	A	1	2	3	0	0	3	0	0
4	25357238	.	A	T	2	3	5	0	0	5	0	0
4	25358346	.	T	C	1	3	4	0	0	4	0	0
4	25358409	.	A	G	2	4	6	0	2	8	0	0
4	25358412	.	T	C	3	5	8	0	0	8	0	0
4	25358624	.	T	A	2	4	6	0	0	6	0	0
4	25358713	.	A	G	1	2	3	0	0	3	0	0
4	25358746	.	A	C	1	2	3	0	0	3	0	0
4	25473316	.	T	G	2	3	5	0	0	5	0	0
4	25473934	.	T	G	8	9	17	0	0	17	0	0
4	25474177	.	T	C	15	17	32	0	2	34	0	0
4	25474301	.	T	C	13	19	32	0	1	33	0	0
4	25474305	.	A	T	14	19	33	0	0	33	0	0
4	25474417	.	G	A	18	17	35	0	2	37	0	0
4	25474419	.	C	T	2	18	20	0	16	36	0	0
4	25476524	.	A	T	13	11	24	0	0	24	0	0
4	25479114	.	G	A	12	10	22	0	0	22	0	0
4	25479126	.	A	G	13	13	26	0	1	27	0	0
4	25480983	.	T	C	12	0	12	0	9	21	0	0
4	25480989	.	G	A	13	9	22	0	0	22	0	0
4	25481164	.	T	G	10	6	16	0	0	16	0	0
4	25481188	.	A	G	12	10	22	0	0	22	0	0
4	25481656	.	T	C	9	6	15	0	0	15	0	0
4	25482595	.	C	A	8	12	20	0	0	20	0	0
4	25485302	.	C	T	10	3	13	0	0	13	0	0
4	25485394	.	A	T	4	2	6	0	0	6	0	0
4	25497398	.	G	A	4	5	9	0	0	9	0	0
4	25503078	.	T	C	16	0	16	0	9	25	0	0
4	25506417	.	G	A	13	8	21	0	0	21	0	0
4	25506896	.	A	G	11	8	19	0	1	20	0	0
4	25506944	.	T	C	6	0	6	0	8	14	0	0
4	25511562	.	T	C	12	0	12	0	13	25	0	0
4	25515157	.	C	T	6	11	17	0	2	19	0	0
4	25694866	.	G	T	0	3	3	0	4	7	0	0
4	25694974	.	C	A	4	3	7	1	0	8	0	0
4	25694998	.	T	C	4	4	8	1	0	9	0	0
4	25700800	.	A	T	2	7	9	0	2	11	0	0
4	25702919	.	C	T	10	5	15	0	0	15	0	0
4	25703048	.	G	A	6	3	9	0	0	9	0	0
4	25703135	.	C	A	1	2	3	0	0	3	0	0
4	25703139	.	C	T	1	2	3	0	0	3	0	0
4	25703251	.	C	T	2	2	4	0	0	4	0	0
4	25747994	.	C	T	2	3	5	0	0	5	0	0
4	25750850	.	G	A	1	4	5	0	0	5	0	0
4	25755137	.	C	T	4	5	9	0	0	9	0	0
4	25755191	.	T	A	6	3	9	0	0	9	0	0
4	25755194	.	A	G	7	3	10	0	0	10	0	0
4	25755269	.	C	T	9	8	17	0	1	18	0	0
4	25755834	.	T	C	3	0	3	0	4	7	0	0
4	25756453	.	G	T	8	3	11	0	0	11	0	0
4	25759183	.	T	C	8	8	16	0	0	16	0	0
4	25759327	.	G	A	6	9	15	0	1	16	0	0
4	25759518	.	C	A	1	4	5	0	5	10	0	0
4	25759549	.	T	C	5	7	12	0	1	13	0	0
4	25759690	.	A	G	7	6	13	0	0	13	0	0
4	25759816	.	T	C	4	6	10	0	1	11	0	0
4	25796742	.	T	C	7	0	7	0	7	14	0	0
4	25796765	.	G	A	9	9	18	0	0	18	0	0
4	25796784	.	C	T	0	7	7	0	6	13	0	0
4	25829939	.	G	A	8	7	15	0	0	15	0	0
4	25833146	.	A	G	24	24	48	0	1	49	0	0
4	25833221	.	G	A	25	27	52	0	0	52	0	0
4	25839737	.	G	A	5	4	9	0	1	10	0	0
4	25839832	.	A	G	3	4	7	0	0	7	0	0
4	25839911	.	G	C	8	3	11	0	0	11	0	0
4	25839931	.	C	T	1	4	5	0	5	10	0	0
4	25842788	.	C	T	5	6	11	0	0	11	0	0
4	25843659	.	A	G	5	5	10	0	0	10	0	0
4	25846927	.	G	A	4	3	7	0	0	7	0	0
4	25853058	.	C	T	5	2	7	0	0	7	0	0
4	25860890	.	G	A	4	2	6	0	0	6	0	0
4	25862009	.	A	G	3	3	6	0	0	6	0	0
4	25862270	.	A	G	2	3	5	0	0	5	0	0
4	25862284	.	G	A	2	4	6	0	0	6	0	0
4	25862309	.	G	A	2	2	4	0	0	4	0	0
4	25862332	.	T	C	1	2	3	0	0	3	0	0
4	25864326	.	T	C	2	3	5	0	0	5	0	0
4	25881181	.	C	T	3	2	5	0	0	5	0	0
4	25907213	.	A	G	1	2	3	0	0	3	0	0
4	25907450	.	T	A	4	3	7	0	0	7	0	0
4	25907462	.	T	C	2	3	5	0	0	5	0	0
4	25908337	.	T	C	0	2	2	0	1	3	0	0
4	25932628	.	A	G	7	0	7	0	6	13	0	0
4	25932664	.	A	T	5	7	12	0	1	13	0	0
4	25934667	.	G	A	4	7	11	0	0	11	0	0
4	25934722	.	T	C	4	3	7	0	0	7	0	0
4	25936437	.	A	G	7	7	14	0	1	15	0	0
4	25936491	.	A	G	11	9	20	0	1	21	0	0
4	25939158	.	A	G	11	8	19	0	1	20	0	0
4	25939185	.	C	A	6	6	12	0	2	14	0	0
4	26004581	.	G	A	6	3	9	0	0	9	0	0
4	26012322	.	C	T	6	4	10	0	0	10	0	0
4	26015476	.	C	T	1	4	5	0	1	6	0	0
4	26016340	.	A	C	6	5	11	0	0	11	0	0
4	26021876	.	G	A	2	2	4	0	0	4	0	0
4	26022413	.	C	T	3	8	11	0	0	11	0	0
4	26022447	.	T	C	6	0	6	0	7	13	0	0
4	26026444	.	T	C	5	3	8	0	1	9	0	0
4	26027022	.	A	G	7	7	14	0	0	14	0	0
4	26028813	.	C	T	6	3	9	0	0	9	0	0
4	26028873	.	C	T	0	2	2	0	5	7	0	0
4	26028947	.	C	T	0	2	2	0	3	5	0	0
4	26029119	.	A	G	4	4	8	0	0	8	0	0
4	26029362	.	T	A	4	6	10	0	0	10	0	0
4	26029413	.	T	C	2	0	2	0	4	6	0	0
4	26056542	.	A	G	4	2	6	0	2	8	0	0
4	26056580	.	C	T	4	4	8	0	0	8	0	0
4	26056589	.	A	G	4	4	8	0	0	8	0	0
4	26065007	.	G	C	2	5	7	0	4	11	0	0
4	26067359	.	C	A	2	4	6	0	0	6	0	0
4	26068170	.	T	C	6	5	11	0	1	12	0	0
4	26072844	.	G	A	10	8	18	0	0	18	0	0
4	26075640	.	G	C	6	12	18	0	0	18	0	0
4	26075673	.	G	A	1	6	7	0	7	14	0	0
4	26075856	.	G	A	9	8	17	0	0	17	0	0
4	26075882	.	A	G	8	0	8	0	9	17	0	0
4	26077483	.	T	C	14	6	20	0	0	20	0	0
4	26077671	.	A	T	19	10	29	0	0	29	0	0
4	26078008	.	T	C	14	8	22	0	0	22	0	0
4	26078118	.	T	C	6	5	11	0	0	11	0	0
4	26078134	.	A	G	7	7	14	0	0	14	0	0
4	26078675	.	A	T	2	3	5	0	0	5	0	0
4	26078847	.	A	G	2	4	6	0	0	6	0	0
4	26079096	.	A	C	7	13	20	0	1	21	0	0
4	26079116	.	T	C	6	11	17	0	0	17	0	0
4	26079174	.	A	C	4	5	9	0	0	9	0	0
4	26079267	.	T	G	6	0	6	0	3	9	0	0
4	26079838	.	A	G	2	2	4	0	0	4	0	0
4	26079844	.	A	G	2	2	4	0	0	4	0	0
4	26080028	.	T	C	8	1	9	0	0	9	0	0
4	26080036	.	T	A	9	1	10	0	1	11	0	0
4	26080071	.	T	C	12	5	17	0	0	17	0	0
4	26080294	.	A	G	11	7	18	0	0	18	0	0
4	26080441	.	C	T	5	7	12	0	0	12	0	0
4	26080593	.	T	C	3	3	6	0	0	6	0	0
4	26304240	.	T	G	12	12	24	0	0	24	0	0
4	26304451	.	T	C	12	16	28	0	3	31	0	0
4	26304730	.	G	T	7	9	16	0	0	16	0	0
4	26305191	.	T	C	11	8	19	0	0	19	0	0
4	26305286	.	C	A	9	11	20	0	0	20	0	0
4	26305309	.	T	A	12	12	24	0	0	24	0	0
4	26305324	.	C	T	10	7	17	0	1	18	0	0
4	26305413	.	A	C	20	7	27	0	2	29	0	0
4	26305468	.	A	T	13	8	21	0	0	21	0	0
4	26305516	.	A	T	10	5	15	0	2	17	0	0
4	26305578	.	A	T	11	9	20	0	1	21	0	0
4	26306209	.	A	G	14	12	26	0	1	27	0	0
4	26321216	.	A	G	10	9	19	0	2	21	0	0
4	26322655	.	C	A	1	17	18	0	16	34	0	0
4	26322721	.	C	T	2	12	14	0	16	30	0	0
4	26496683	.	G	A	19	14	33	0	3	36	0	0
4	26496730	.	G	A	20	13	33	0	2	35	0	0
4	26762518	.	G	T	6	3	9	0	0	9	0	0
4	26762524	.	G	T	8	4	12	0	1	13	0	0
4	26763314	.	A	T	1	2	3	0	0	3	0	0
4	26764217	.	C	T	8	6	14	0	0	14	0	0
4	26765056	.	T	C	1	2	3	0	0	3	0	0
4	26765057	.	A	T	1	2	3	0	0	3	0	0
4	26765359	.	A	T	2	2	4	0	0	4	0	0
4	27082234	.	G	A	3	3	6	0	0	6	0	0
4	27098536	.	C	T	3	2	5	0	0	5	0	0
4	27112663	.	T	A	2	3	5	0	1	6	0	0
4	27113093	.	A	G	1	4	5	0	1	6	0	0
4	27113479	.	G	A	6	2	8	0	0	8	0	0
4	27113986	.	G	A	2	2	4	0	0	4	0	0
4	27114157	.	T	C	5	3	8	0	0	8	0	0
4	27114894	.	A	G	9	3	12	0	1	13	0	0
4	27115765	.	A	G	6	8	14	0	0	14	0	0
4	27116335	.	A	G	2	2	4	0	0	4	0	0
4	27116905	.	C	A	1	4	5	0	0	5	0	0
4	27131924	.	C	T	2	3	5	0	0	5	0	0
4	27132077	.	A	T	3	6	9	0	0	9	0	0
4	27132114	.	A	G	4	5	9	0	0	9	0	0
4	27132314	.	A	C	5	3	8	0	0	8	0	0
4	27133405	.	T	A	4	5	9	0	0	9	0	0
4	27133498	.	G	A	1	6	7	0	0	7	0	0
4	27137874	.	G	A	5	5	10	0	1	11	0	0
4	27137991	.	T	G	7	4	11	0	0	11	0	0
4	27139739	.	T	C	2	5	7	0	0	7	0	0
4	27139955	.	T	A	2	7	9	0	0	9	0	0
4	27140031	.	G	A	0	3	3	0	4	7	0	0
4	27140644	.	C	T	5	4	9	0	0	9	0	0
4	27140658	.	A	G	5	2	7	0	0	7	0	0
4	27145549	.	T	C	6	4	10	0	0	10	0	0
4	27147440	.	T	G	4	5	9	0	1	10	0	0
4	27147510	.	T	C	7	3	10	0	0	10	0	0
4	27147712	.	C	T	7	11	18	0	1	19	0	0
4	27147752	.	A	G	5	8	13	0	0	13	0	0
4	27148291	.	G	T	5	8	13	0	0	13	0	0
4	27148417	.	T	C	11	9	20	0	1	21	0	0
4	27148425	.	A	T	9	11	20	0	2	22	0	0
4	27148545	.	A	C	3	3	6	0	1	7	0	0
4	27148943	.	A	C	9	4	13	0	0	13	0	0
4	27149017	.	G	A	1	3	4	0	5	9	0	0
4	27149634	.	A	T	1	3	4	0	0	4	0	0
4	27149680	.	G	T	3	4	7	0	2	9	0	0
4	27252027	.	T	C	8	5	13	0	0	13	0	0
4	27252096	.	C	T	5	8	13	0	0	13	0	0
4	27252178	.	C	T	3	6	9	0	11	20	0	0
4	27252581	.	G	A	12	13	25	0	1	26	0	0
4	27350432	.	G	T	7	9	16	0	0	16	0	0
4	27350666	.	G	A	11	7	18	0	0	18	0	0
4	27350674	.	C	G	0	5	5	0	13	18	0	0
4	27628190	.	T	A	7	3	10	0	0	10	0	0
4	27628373	.	G	A	1	4	5	0	0	5	0	0
4	27628540	.	G	A	3	4	7	0	0	7	0	0
4	27628643	.	C	G	0	2	2	0	2	4	0	0
4	27628788	.	T	A	3	3	6	0	1	7	0	0
4	27869781	.	C	T	5	3	8	0	0	8	0	0
4	27898949	.	C	T	7	8	15	0	0	15	0	0
4	27921925	.	A	G	6	9	15	0	1	16	0	0
4	27921962	.	G	C	0	8	8	0	10	18	0	0
4	27945941	.	T	C	6	5	11	0	0	11	0	0
4	28062562	.	G	C	2	8	10	0	0	10	0	0
4	28062581	.	A	G	3	7	10	0	0	10	0	0
4	28062603	.	G	A	6	4	10	0	1	11	0	0
4	28062846	.	T	A	5	5	10	0	0	10	0	0
4	28063086	.	G	A	7	9	16	0	0	16	0	0
4	28063385	.	G	A	6	5	11	0	0	11	0	0
4	28063469	.	T	C	6	0	6	0	4	10	0	0
4	28063635	.	A	G	7	9	16	0	0	16	0	0
4	28063653	.	G	T	8	11	19	0	1	20	0	0
4	28063715	.	A	G	7	11	18	0	1	19	0	0
4	28063873	.	T	C	6	3	9	0	0	9	0	0
4	28063876	.	T	C	6	3	9	0	0	9	0	0
4	28063911	.	C	G	1	5	6	0	3	9	0	0
4	28064028	.	T	C	6	4	10	0	1	11	0	0
4	28066394	.	G	A	8	12	20	0	0	20	0	0
4	28066425	.	C	T	5	15	20	0	0	20	0	0
4	28068908	.	G	A	6	7	13	0	0	13	0	0
4	28078078	.	A	T	4	3	7	0	0	7	0	0
4	28084928	.	T	C	7	4	11	0	0	11	0	0
4	28084993	.	A	G	10	6	16	0	0	16	0	0
4	28093323	.	A	G	3	17	20	0	0	20	0	0
4	28194299	.	C	T	3	6	9	0	0	9	0	0
4	28194359	.	G	A	2	4	6	0	1	7	0	0
4	28195380	.	A	C	2	4	6	0	0	6	0	0
4	28195396	.	T	C	3	2	5	0	0	5	0	0
4	28195552	.	G	A	3	5	8	0	0	8	0	0
4	28195558	.	C	T	1	4	5	0	3	8	0	0
4	28197964	.	T	G	1	4	5	0	1	6	0	0
4	28215389	.	G	A	2	3	5	0	0	5	0	0
4	28217211	.	C	A	1	2	3	0	0	3	0	0
4	28343865	.	G	C	2	0	2	0	4	6	0	0
4	28343976	.	A	G	4	2	6	0	0	6	0	0
4	28344209	.	G	T	3	2	5	0	0	5	0	0
4	28347921	.	A	G	3	2	5	0	0	5	0	0
4	28351103	.	G	A	1	2	3	0	1	4	0	0
4	28372151	.	T	C	7	3	10	0	0	10	0	0
4	28373691	.	A	G	7	5	12	0	0	12	0	0
4	28373791	.	T	G	10	8	18	0	0	18	0	0
4	28379240	.	G	T	1	6	7	0	0	7	0	0
4	28419637	.	G	A	3	2	5	0	0	5	0	0
4	28422162	.	T	A	1	2	3	0	0	3	0	0
4	28422166	.	T	C	1	2	3	0	0	3	0	0
4	28422589	.	T	A	1	3	4	0	0	4	0	0
4	28422935	.	G	A	2	3	5	0	0	5	0	0
4	28422950	.	G	A	3	2	5	0	0	5	0	0
4	28423528	.	C	G	2	0	2	0	2	4	0	0
4	28423547	.	C	T	2	2	4	0	1	5	0	0
4	28423669	.	A	G	2	6	8	0	1	9	0	0
4	28423735	.	C	T	4	5	9	0	0	9	0	0
4	28423775	.	T	G	4	0	4	0	3	7	0	0
4	28423786	.	A	T	4	3	7	0	0	7	0	0
4	28821220	.	C	A	5	4	9	0	0	9	0	0
4	28821416	.	G	A	2	2	4	1	2	7	0	0
4	28821417	.	A	T	3	2	5	1	0	6	0	0
4	28975867	.	A	G	3	2	5	0	0	5	0	0
4	28975943	.	G	A	1	5	6	0	1	7	0	0
4	29040247	.	C	T	5	2	7	0	0	7	0	0
4	29040548	.	A	G	4	4	8	0	0	8	0	0
4	29040677	.	G	A	5	5	10	0	0	10	0	0
4	29040980	.	C	A	1	3	4	0	0	4	0	0
4	29041388	.	T	C	4	2	6	0	0	6	0	0
4	29041592	.	G	A	2	2	4	0	0	4	0	0
4	29041830	.	C	T	1	5	6	0	0	6	0	0
4	29042658	.	G	T	1	4	5	0	0	5	0	0
4	29285855	.	G	T	0	1	1	0	2	3	0	0
4	29285873	.	C	T	1	2	3	0	0	3	0	0
4	29287449	.	G	A	1	2	3	0	0	3	0	0
4	29287803	.	C	A	2	5	7	0	1	8	0	0
4	29287864	.	A	C	1	3	4	0	0	4	0	0
4	29287874	.	T	C	1	2	3	0	0	3	0	0
4	29287920	.	A	G	1	1	2	0	1	3	0	0
4	29854266	.	A	C	2	2	4	0	0	4	0	0
4	29854268	.	T	C	2	2	4	0	0	4	0	0
4	29910556	.	C	A	1	3	4	1	0	5	0	0
4	31022126	.	G	C	1	2	3	1	0	4	0	0
4	31022127	.	G	A	1	2	3	1	0	4	0	0
4	31412388	.	G	A	0	3	3	7	1	11	0	0
4	32458353	.	G	C	1	2	3	0	0	3	0	0
4	37245784	.	G	C	1	2	3	1	1	5	0	0
4	42066262	.	A	C	1	5	6	1	0	7	0	0
4	43717421	.	T	G	2	0	2	0	3	5	0	0
4	43724949	.	G	T	3	2	5	3	1	9	0	0
4	43909091	.	A	G	1	2	3	0	0	3	0	0
4	44572939	.	T	G	2	2	4	1	0	5	0	0
4	44572949	.	A	G	4	3	7	1	0	8	0	0
4	46914925	.	C	T	2	12	14	1	0	15	0	0
4	49552111	.	A	G	6	2	8	0	0	8	0	0
4	49573842	.	A	C	3	2	5	1	0	6	0	0
4	50755658	.	C	A	0	3	3	0	2	5	0	0
4	50756495	.	G	A	1	3	4	0	0	4	0	0
4	51172528	.	A	C	1	3	4	0	0	4	0	0
4	54447816	.	T	C	1	2	3	0	0	3	0	0
4	54447822	.	A	T	1	2	3	0	0	3	0	0
4	54974202	.	G	T	2	2	4	0	0	4	0	0
4	54989207	.	T	C	1	2	3	0	0	3	0	0
4	55876986	.	G	C	6	2	8	0	0	8	0	0
4	57106013	.	C	G	1	2	3	5	0	8	0	0
4	60381622	.	T	C	1	3	4	0	0	4	0	0
4	61685344	.	A	C	1	3	4	0	0	4	0	0
4	62496990	.	C	T	1	3	4	2	0	6	0	0
4	64349556	.	C	T	2	3	5	1	0	6	0	0
4	65727822	.	G	A	2	6	8	2	0	10	0	0
4	68485254	.	C	T	2	2	4	1	0	5	0	0
4	68497199	.	G	A	4	5	9	0	1	10	0	0
4	69899771	.	C	T	1	3	4	1	0	5	0	0
4	70842132	.	G	C	1	3	4	1	0	5	0	0
4	70850688	.	G	A	1	2	3	0	0	3	0	0
4	70850966	.	G	T	7	6	13	0	0	13	0	0
4	70851202	.	T	C	4	1	5	0	6	11	0	0
4	70860034	.	A	C	14	0	14	1	8	23	0	0
4	70860166	.	A	G	14	8	22	6	1	29	0	0
4	70866683	.	C	T	4	2	6	0	0	6	0	0
4	70866787	.	A	T	7	7	14	0	0	14	0	0
4	70866791	.	A	T	5	9	14	0	0	14	0	0
4	70867005	.	G	C	9	3	12	5	0	17	0	0
4	70889808	.	C	G	1	0	1	0	2	3	0	0
4	70889835	.	A	G	1	3	4	2	0	6	0	0
4	70889858	.	T	G	1	3	4	3	0	7	0	0
4	70889872	.	G	C	1	2	3	3	0	6	0	0
4	71610368	.	T	G	1	3	4	3	0	7	0	0
4	71896898	.	C	A	1	2	3	1	0	4	0	0
4	72216932	.	A	C	2	2	4	0	0	4	0	0
4	72217285	.	T	C	3	5	8	0	0	8	0	0
4	72217438	.	A	C	2	3	5	0	0	5	0	0
4	72217495	.	C	A	1	5	6	0	0	6	0	0
4	72217508	.	C	T	2	5	7	0	0	7	0	0
4	72217647	.	T	C	2	6	8	0	2	10	0	0
4	72217779	.	A	G	1	1	2	0	5	7	0	0
4	72217813	.	T	C	2	6	8	0	0	8	0	0
4	72217847	.	G	A	0	6	6	0	4	10	0	0
4	72235663	.	A	G	2	4	6	0	0	6	0	0
4	72235685	.	C	G	2	2	4	0	0	4	0	0
4	72272239	.	G	A	6	5	11	0	1	12	0	0
4	72272461	.	C	T	3	2	5	0	0	5	0	0
4	72272779	.	T	C	8	5	13	0	0	13	0	0
4	72275308	.	C	T	5	3	8	0	0	8	0	0
4	72295873	.	T	A	3	5	8	0	0	8	0	0
4	72296038	.	A	T	1	4	5	0	0	5	0	0
4	72296413	.	C	G	2	4	6	0	0	6	0	0
4	72296433	.	C	G	2	4	6	0	0	6	0	0
4	72348855	.	A	C	2	0	2	0	2	4	0	0
4	72348919	.	C	T	4	2	6	0	2	8	0	0
4	72348921	.	C	T	5	2	7	0	1	8	0	0
4	72349083	.	G	A	1	4	5	0	0	5	0	0
4	72349343	.	C	T	2	3	5	0	0	5	0	0
4	72349376	.	C	T	0	2	2	0	3	5	0	0
4	72356870	.	G	A	1	3	4	0	0	4	0	0
4	72559171	.	G	T	1	2	3	0	0	3	0	0
4	72559558	.	A	G	3	5	8	0	0	8	0	0
4	72559585	.	A	G	4	5	9	0	1	10	0	0
4	72559612	.	A	G	2	4	6	0	2	8	0	0
4	72560536	.	C	A	0	3	3	0	1	4	0	0
4	72560546	.	T	A	1	3	4	0	0	4	0	0
4	72603483	.	C	A	1	2	3	0	0	3	0	0
4	72604255	.	G	A	4	3	7	0	1	8	0	0
4	72604336	.	G	C	4	5	9	0	0	9	0	0
4	72604579	.	T	C	2	2	4	0	0	4	0	0
4	72629250	.	T	A	1	4	5	0	0	5	0	0
4	72629601	.	G	A	3	1	4	0	1	5	0	0
4	72629622	.	G	A	3	3	6	0	1	7	0	0
4	72629739	.	G	A	1	4	5	0	0	5	0	0
4	72629787	.	G	A	4	6	10	0	0	10	0	0
4	72629859	.	G	A	1	2	3	0	0	3	0	0
4	72630231	.	G	A	4	6	10	0	1	11	0	0
4	72630316	.	G	A	5	2	7	0	0	7	0	0
4	72630351	.	C	A	5	4	9	0	0	9	0	0
4	72630360	.	C	G	5	4	9	0	0	9	0	0
4	72638407	.	T	A	5	4	9	0	0	9	0	0
4	72754244	.	C	T	17	20	37	1	1	39	0	0
4	72772769	.	T	C	23	10	33	0	0	33	0	0
4	72774085	.	C	T	19	14	33	0	0	33	0	0
4	72775687	.	C	A	15	21	36	1	0	37	0	0
4	72781277	.	A	G	14	20	34	0	2	36	0	0
4	72784800	.	T	C	8	6	14	0	2	16	0	0
4	72784939	.	T	G	3	0	3	0	7	10	0	0
4	72784940	.	A	C	3	7	10	0	0	10	0	0
4	72785055	.	T	C	1	2	3	0	0	3	0	0
4	72785056	.	T	C	1	2	3	0	0	3	0	0
4	72785147	.	T	C	1	4	5	0	0	5	0	0
4	72785238	.	T	A	3	4	7	0	0	7	0	0
4	72785245	.	C	T	3	4	7	0	0	7	0	0
4	72785903	.	G	A	2	2	4	0	0	4	0	0
4	72785914	.	T	C	2	2	4	0	0	4	0	0
4	73015398	.	C	T	2	2	4	2	0	6	0	0
4	73059245	.	C	T	4	2	6	0	0	6	0	0
4	73059299	.	T	A	2	3	5	0	1	6	0	0
4	73059408	.	T	C	3	4	7	0	0	7	0	0
4	73063082	.	A	G	5	1	6	0	5	11	0	0
4	73063249	.	G	A	8	3	11	0	1	12	0	0
4	73063417	.	T	G	4	2	6	0	0	6	0	0
4	73063427	.	A	C	2	1	3	0	1	4	0	0
4	73064399	.	A	G	2	2	4	0	0	4	0	0
4	73186793	.	C	T	1	2	3	0	0	3	0	0
4	73186939	.	T	C	1	0	1	0	3	4	0	0
4	73186955	.	G	T	1	2	3	0	0	3	0	0
4	73187999	.	G	A	1	6	7	0	0	7	0	0
4	73274151	.	T	C	2	6	8	0	0	8	0	0
4	73288085	.	C	A	0	5	5	0	7	12	0	0
4	73299285	.	C	T	1	3	4	0	1	5	0	0
4	73299305	.	T	G	1	2	3	0	0	3	0	0
4	73335956	.	G	A	1	4	5	0	0	5	0	0
4	73335990	.	T	A	2	6	8	0	3	11	0	0
4	73336618	.	C	T	2	4	6	0	0	6	0	0
4	73336629	.	C	T	3	3	6	0	0	6	0	0
4	73336664	.	T	C	5	2	7	0	0	7	0	0
4	73336818	.	C	T	4	3	7	0	0	7	0	0
4	73336863	.	A	C	3	4	7	0	0	7	0	0
4	73336869	.	G	C	3	4	7	0	0	7	0	0
4	73336909	.	G	A	3	5	8	0	0	8	0	0
4	73337244	.	A	G	4	2	6	0	0	6	0	0
4	73337248	.	G	A	3	3	6	0	0	6	0	0
4	73337911	.	T	A	1	5	6	0	0	6	0	0
4	73338060	.	C	A	4	3	7	0	0	7	0	0
4	73338062	.	T	C	3	3	6	0	1	7	0	0
4	73347191	.	C	T	1	4	5	0	0	5	0	0
4	73382588	.	T	C	3	2	5	1	0	6	0	0
4	73383217	.	G	A	2	2	4	1	1	6	0	0
4	73383499	.	G	A	3	4	7	0	0	7	0	0
4	73393951	.	T	C	2	2	4	0	0	4	0	0
4	73398893	.	A	G	2	2	4	0	0	4	0	0
4	73418744	.	A	T	4	3	7	0	0	7	0	0
4	73419010	.	G	A	1	3	4	1	0	5	0	0
4	73419026	.	C	T	1	3	4	0	0	4	0	0
4	73419160	.	C	T	3	2	5	1	1	7	0	0
4	73419418	.	G	A	6	2	8	0	0	8	0	0
4	73419799	.	G	A	2	5	7	0	0	7	0	0
4	73446988	.	C	G	0	2	2	0	2	4	0	0
4	73447030	.	T	C	7	3	10	0	0	10	0	0
4	73447096	.	C	T	1	4	5	0	2	7	0	0
4	73455996	.	C	T	0	2	2	0	2	4	0	0
4	73456044	.	A	G	6	2	8	0	0	8	0	0
4	73471021	.	G	A	3	3	6	0	0	6	0	0
4	73471048	.	A	G	3	5	8	0	1	9	0	0
4	73473685	.	G	A	2	3	5	0	0	5	0	0
4	73491352	.	C	A	3	2	5	0	1	6	0	0
4	73491361	.	G	A	4	2	6	0	0	6	0	0
4	73491478	.	C	T	1	3	4	0	1	5	0	0
4	73499736	.	T	A	1	3	4	0	0	4	0	0
4	73500011	.	T	C	2	0	2	0	3	5	0	0
4	73500041	.	T	C	6	2	8	1	0	9	0	0
4	73501516	.	T	C	4	2	6	0	1	7	0	0
4	73501699	.	T	C	3	3	6	0	0	6	0	0
4	73502140	.	G	A	3	1	4	0	1	5	0	0
4	73502698	.	C	G	1	2	3	2	0	5	0	0
4	73502708	.	G	A	1	2	3	2	0	5	0	0
4	73502780	.	C	T	0	2	2	0	3	5	0	0
4	73502798	.	T	A	2	2	4	0	1	5	0	0
4	73515839	.	A	C	2	1	3	0	1	4	0	0
4	73515840	.	A	T	2	2	4	0	0	4	0	0
4	73519301	.	T	A	3	2	5	0	0	5	0	0
4	73519433	.	A	G	3	4	7	0	0	7	0	0
4	73519792	.	C	T	1	2	3	0	0	3	0	0
4	73519814	.	C	G	2	1	3	0	0	3	0	0
4	73542582	.	A	G	5	4	9	0	1	10	0	0
4	73542707	.	T	G	6	2	8	0	1	9	0	0
4	73542757	.	C	A	5	3	8	0	0	8	0	0
4	73542775	.	C	T	1	2	3	0	3	6	0	0
4	73542913	.	A	G	1	3	4	0	0	4	0	0
4	73543369	.	A	G	0	2	2	0	1	3	0	0
4	73543687	.	T	C	1	0	1	0	3	4	0	0
4	73545576	.	G	A	1	3	4	0	0	4	0	0
4	73550570	.	A	T	2	2	4	0	0	4	0	0
4	73551456	.	T	C	2	3	5	0	0	5	0	0
4	73551507	.	A	G	2	3	5	0	1	6	0	0
4	73551581	.	T	A	4	2	6	0	0	6	0	0
4	73551600	.	T	C	3	2	5	0	0	5	0	0
4	73565026	.	A	G	2	2	4	0	0	4	0	0
4	73573887	.	A	C	6	2	8	0	0	8	0	0
4	73574134	.	C	A	6	3	9	0	0	9	0	0
4	73574235	.	A	G	4	3	7	0	0	7	0	0
4	73574579	.	A	G	2	3	5	0	0	5	0	0
4	73574583	.	C	G	2	3	5	0	0	5	0	0
4	73574981	.	T	C	2	2	4	0	0	4	0	0
4	73575171	.	A	G	3	3	6	0	0	6	0	0
4	73575339	.	A	C	4	4	8	0	0	8	0	0
4	73575354	.	T	C	4	0	4	0	3	7	0	0
4	73575381	.	G	A	2	3	5	0	0	5	0	0
4	73575576	.	G	T	5	7	12	0	0	12	0	0
4	73575746	.	T	A	1	5	6	0	0	6	0	0
4	73575807	.	A	T	3	2	5	0	0	5	0	0
4	73575834	.	G	A	3	3	6	0	0	6	0	0
4	73575958	.	C	T	4	1	5	0	1	6	0	0
4	73575967	.	C	T	3	2	5	0	1	6	0	0
4	73638451	.	T	C	3	3	6	0	0	6	0	0
4	73681574	.	A	G	2	2	4	0	0	4	0	0
4	73690525	.	A	T	1	1	2	0	0	2	0	0
4	73690547	.	A	G	1	0	1	0	2	3	0	0
4	73690572	.	G	T	2	2	4	0	0	4	0	0
4	73690631	.	C	T	3	2	5	0	0	5	0	0
4	73690653	.	T	C	1	2	3	0	0	3	0	0
4	73702314	.	C	T	1	2	3	0	0	3	0	0
4	73702353	.	C	T	1	2	3	0	0	3	0	0
4	73702535	.	G	T	3	5	8	0	0	8	0	0
4	73711740	.	G	C	2	2	4	2	0	6	0	0
4	73713039	.	C	G	2	2	4	0	0	4	0	0
4	73713139	.	C	T	1	2	3	0	0	3	0	0
4	73713173	.	C	T	1	4	5	0	0	5	0	0
4	73713789	.	T	C	3	4	7	0	0	7	0	0
4	73713818	.	A	G	4	7	11	0	0	11	0	0
4	73713850	.	G	T	3	5	8	0	1	9	0	0
4	73714089	.	A	T	1	2	3	0	0	3	0	0
4	73715031	.	C	G	3	3	6	0	0	6	0	0
4	73715233	.	T	C	3	3	6	0	0	6	0	0
4	73715619	.	T	C	2	3	5	0	0	5	0	0
4	73715666	.	A	T	2	3	5	0	0	5	0	0
4	73718242	.	G	T	1	6	7	0	0	7	0	0
4	73729780	.	C	A	1	4	5	0	0	5	0	0
4	73730341	.	G	A	2	4	6	0	0	6	0	0
4	73730469	.	C	T	1	3	4	0	0	4	0	0
4	73730609	.	A	G	5	4	9	3	0	12	0	0
4	73730713	.	T	G	2	2	4	0	0	4	0	0
4	73730961	.	G	T	3	2	5	0	0	5	0	0
4	73740087	.	G	A	1	2	3	0	0	3	0	0
4	73740209	.	G	A	6	3	9	0	0	9	0	0
4	73740301	.	G	A	10	6	16	0	1	17	0	0
4	73740391	.	C	G	8	8	16	0	0	16	0	0
4	73740409	.	C	A	8	5	13	0	0	13	0	0
4	73740487	.	C	G	5	2	7	0	0	7	0	0
4	73740651	.	G	C	3	2	5	0	0	5	0	0
4	73740691	.	T	A	3	2	5	0	0	5	0	0
4	73741110	.	T	A	2	4	6	0	1	7	0	0
4	73741124	.	T	C	1	3	4	0	0	4	0	0
4	73741764	.	G	A	3	2	5	0	1	6	0	0
4	73755900	.	G	A	1	2	3	0	0	3	0	0
4	73755904	.	A	T	1	2	3	0	0	3	0	0
4	73756083	.	T	A	2	3	5	0	0	5	0	0
4	73773222	.	T	G	4	2	6	0	1	7	0	0
4	73796355	.	A	T	3	2	5	0	0	5	0	0
4	73796397	.	G	A	2	2	4	0	0	4	0	0
4	73796694	.	C	T	2	2	4	0	1	5	0	0
4	73797144	.	C	G	1	2	3	0	0	3	0	0
4	73797146	.	C	T	0	2	2	0	1	3	0	0
4	73816163	.	T	C	1	0	1	0	2	3	0	0
4	73816175	.	T	C	1	0	1	0	2	3	0	0
4	73816252	.	C	T	4	2	6	0	0	6	0	0
4	73817044	.	C	T	2	2	4	0	1	5	0	0
4	73817238	.	T	C	1	1	2	0	3	5	0	0
4	73817252	.	T	C	3	0	3	0	3	6	0	0
4	73821450	.	T	A	3	4	7	0	0	7	0	0
4	73821452	.	T	C	3	0	3	0	4	7	0	0
4	73824958	.	C	G	4	3	7	0	0	7	0	0
4	73897713	.	T	C	2	2	4	0	0	4	0	0
4	73897725	.	C	T	3	2	5	0	0	5	0	0
4	73897923	.	T	C	3	4	7	0	0	7	0	0
4	73899078	.	T	A	3	3	6	0	1	7	0	0
4	73899511	.	A	G	5	0	5	0	3	8	0	0
4	73980836	.	C	A	6	3	9	0	0	9	0	0
4	73980884	.	G	A	3	4	7	0	0	7	0	0
4	73980890	.	A	C	2	4	6	0	0	6	0	0
4	73980954	.	G	A	3	3	6	0	1	7	0	0
4	73981397	.	C	T	2	2	4	0	0	4	0	0
4	73981558	.	G	A	0	2	2	0	5	7	0	0
4	73981718	.	A	G	1	2	3	0	0	3	0	0
4	74006572	.	C	T	1	7	8	0	0	8	0	0
4	74008326	.	C	G	1	0	1	0	2	3	0	0
4	74008362	.	A	G	2	3	5	0	0	5	0	0
4	74008378	.	T	A	1	3	4	0	0	4	0	0
4	74008621	.	A	G	1	0	1	0	2	3	0	0
4	74087781	.	G	A	17	14	31	0	0	31	0	0
4	74087785	.	G	C	17	15	32	0	1	33	0	0
4	74087951	.	G	A	12	8	20	1	13	34	0	0
4	74088060	.	T	G	25	19	44	0	0	44	0	0
4	74109763	.	A	T	10	13	23	0	1	24	0	0
4	74131583	.	T	G	11	0	11	0	10	21	0	0
4	74131652	.	T	C	18	15	33	0	0	33	0	0
4	74131717	.	G	A	4	13	17	0	17	34	0	0
4	74135244	.	G	T	10	13	23	0	1	24	0	0
4	74135295	.	A	G	11	15	26	0	0	26	0	0
4	74135415	.	C	T	24	16	40	0	0	40	0	0
4	74141580	.	C	A	9	3	12	0	1	13	0	0
4	74141797	.	A	G	9	5	14	0	1	15	0	0
4	74141819	.	T	C	10	4	14	0	1	15	0	0
4	74174078	.	C	T	4	4	8	0	0	8	0	0
4	74176550	.	G	A	2	2	4	0	0	4	0	0
4	74180716	.	G	A	1	10	11	0	16	27	0	0
4	74180788	.	T	C	12	13	25	0	0	25	0	0
4	74182382	.	G	C	7	10	17	0	1	18	0	0
4	74182389	.	G	T	10	12	22	0	0	22	0	0
4	74193480	.	C	G	9	6	15	0	0	15	0	0
4	74196686	.	T	C	7	8	15	0	1	16	0	0
4	74196704	.	T	C	8	11	19	0	0	19	0	0
4	74196764	.	G	T	4	13	17	0	1	18	0	0
4	74200391	.	C	T	12	9	21	0	1	22	0	0
4	74204177	.	T	C	18	7	25	0	0	25	0	0
4	74204236	.	G	T	1	10	11	0	9	20	0	0
4	74204387	.	G	T	4	5	9	0	0	9	0	0
4	74204494	.	A	T	3	6	9	0	1	10	0	0
4	74204687	.	A	G	5	4	9	0	0	9	0	0
4	74204715	.	A	G	2	6	8	0	0	8	0	0
4	74204722	.	A	G	6	2	8	0	0	8	0	0
4	74204842	.	A	G	10	9	19	0	1	20	0	0
4	74205295	.	T	C	5	3	8	0	0	8	0	0
4	74267225	.	A	G	9	14	23	0	0	23	0	0
4	74267348	.	C	T	5	4	9	0	0	9	0	0
4	74267519	.	A	G	18	9	27	0	0	27	0	0
4	74267540	.	G	A	4	12	16	0	15	31	0	0
4	74267582	.	T	G	7	18	25	0	0	25	0	0
4	74267639	.	T	A	16	9	25	0	2	27	0	0
4	74267733	.	A	T	17	16	33	0	0	33	0	0
4	74267748	.	C	T	16	15	31	0	3	34	0	0
4	74267865	.	A	C	10	13	23	0	0	23	0	0
4	74268175	.	A	G	4	3	7	0	0	7	0	0
4	74268182	.	C	T	3	3	6	0	0	6	0	0
4	74271251	.	G	A	6	3	9	0	0	9	0	0
4	74278079	.	T	G	6	6	12	0	1	13	0	0
4	74278093	.	C	T	1	4	5	0	5	10	0	0
4	74282709	.	C	T	3	3	6	0	0	6	0	0
4	74282917	.	G	A	7	9	16	0	1	17	0	0
4	74302589	.	T	A	2	4	6	0	0	6	0	0
4	74302645	.	A	G	5	4	9	0	0	9	0	0
4	74303174	.	T	C	4	0	4	0	2	6	0	0
4	74303216	.	G	A	2	3	5	0	0	5	0	0
4	74312660	.	T	C	2	0	2	0	2	4	0	0
4	74312741	.	C	T	0	2	2	0	1	3	0	0
4	74315331	.	C	T	1	3	4	0	0	4	0	0
4	74367358	.	C	G	2	2	4	0	0	4	0	0
4	74367361	.	T	A	2	2	4	0	0	4	0	0
4	74452873	.	T	A	1	2	3	0	0	3	0	0
4	74828261	.	C	A	4	3	7	0	0	7	0	0
4	74875802	.	A	G	7	2	9	0	0	9	0	0
4	74875829	.	A	G	2	4	6	0	0	6	0	0
4	74888611	.	G	A	1	4	5	0	0	5	0	0
4	74891524	.	C	T	0	6	6	0	1	7	0	0
4	74891617	.	A	T	8	3	11	0	0	11	0	0
4	74891619	.	C	G	8	3	11	0	0	11	0	0
4	74943202	.	A	T	18	18	36	0	0	36	0	0
4	74952477	.	G	A	11	16	27	0	1	28	0	0
4	74952525	.	A	G	16	0	16	0	17	33	0	0
4	74952660	.	G	T	2	15	17	0	14	31	0	0
4	74960826	.	C	T	17	13	30	0	3	33	0	0
4	74961011	.	C	T	12	8	20	0	3	23	0	0
4	74961075	.	G	A	15	13	28	0	0	28	0	0
4	74961520	.	T	A	3	6	9	0	0	9	0	0
4	74970342	.	T	C	2	4	6	0	0	6	0	0
4	74970343	.	T	C	2	4	6	0	0	6	0	0
4	75138750	.	A	G	1	5	6	0	0	6	0	0
4	75138987	.	C	T	8	7	15	1	1	17	0	0
4	75139002	.	A	T	8	2	10	1	0	11	0	0
4	75139194	.	C	T	8	11	19	0	1	20	0	0
4	75139264	.	T	C	9	8	17	0	0	17	0	0
4	75142269	.	G	A	12	6	18	0	1	19	0	0
4	75149056	.	C	T	10	11	21	0	1	22	0	0
4	75149071	.	T	A	13	9	22	0	0	22	0	0
4	75149125	.	C	A	0	6	6	0	15	21	0	0
4	75149149	.	C	T	2	5	7	0	15	22	0	0
4	75150806	.	T	G	16	9	25	0	0	25	0	0
4	75153925	.	C	T	10	11	21	0	0	21	0	0
4	75153930	.	G	A	11	8	19	0	3	22	0	0
4	75251782	.	A	C	9	8	17	0	1	18	0	0
4	75270438	.	G	C	10	10	20	0	0	20	0	0
4	75294036	.	G	A	2	2	4	0	0	4	0	0
4	75294225	.	G	C	0	2	2	0	1	3	0	0
4	75380706	.	A	C	3	7	10	0	0	10	0	0
4	75406065	.	G	A	0	4	4	1	4	9	0	0
4	75416605	.	C	T	9	7	16	0	0	16	0	0
4	75416647	.	G	A	5	2	7	0	1	8	0	0
4	75416760	.	G	A	1	3	4	0	6	10	0	0
4	75416980	.	C	T	8	3	11	0	1	12	0	0
4	75417138	.	C	T	6	4	10	0	0	10	0	0
4	75417250	.	T	G	4	2	6	0	0	6	0	0
4	75417258	.	T	A	3	2	5	0	0	5	0	0
4	75417414	.	C	T	1	3	4	0	2	6	0	0
4	75417608	.	C	A	3	2	5	0	0	5	0	0
4	75417916	.	C	A	6	3	9	0	0	9	0	0
4	75417925	.	G	A	6	3	9	0	0	9	0	0
4	75417994	.	C	T	5	2	7	0	0	7	0	0
4	75418018	.	A	G	7	2	9	0	0	9	0	0
4	75419127	.	A	T	2	4	6	0	1	7	0	0
4	75419163	.	C	A	6	2	8	0	0	8	0	0
4	75419303	.	C	A	4	4	8	0	0	8	0	0
4	75419353	.	C	T	4	2	6	0	0	6	0	0
4	75419421	.	G	T	4	5	9	0	0	9	0	0
4	75419428	.	C	T	3	5	8	0	0	8	0	0
4	75419551	.	G	C	2	2	4	0	1	5	0	0
4	75419653	.	G	A	7	4	11	0	0	11	0	0
4	75419819	.	C	G	5	13	18	0	1	19	0	0
4	75419822	.	A	C	4	12	16	0	2	18	0	0
4	75419916	.	G	T	12	8	20	0	1	21	0	0
4	75419928	.	T	G	12	1	13	0	5	18	0	0
4	75419961	.	A	C	13	6	19	0	0	19	0	0
4	75419970	.	G	A	3	6	9	0	11	20	0	0
4	75420086	.	C	T	12	4	16	0	1	17	0	0
4	75420159	.	T	C	8	7	15	0	0	15	0	0
4	75420186	.	A	G	6	1	7	0	6	13	0	0
4	75420203	.	T	G	8	3	11	0	0	12	1	0
4	75420270	.	A	G	8	3	11	0	1	12	0	0
4	75420318	.	T	A	9	4	13	0	0	13	0	0
4	75420558	.	A	T	4	5	9	0	0	9	0	0
4	75420754	.	T	A	3	3	6	0	0	6	0	0
4	75420778	.	A	T	3	3	6	0	0	6	0	0
4	75420873	.	A	C	1	9	10	0	0	10	0	0
4	75420931	.	A	T	0	6	6	0	0	6	0	0
4	75420934	.	A	G	1	6	7	0	0	7	0	0
4	76305380	.	A	G	2	5	7	1	1	9	0	0
4	76317041	.	T	C	1	6	7	2	0	9	0	0
4	76320752	.	G	A	4	4	8	2	0	10	0	0
4	76320798	.	C	G	3	7	10	2	0	12	0	0
4	76322771	.	T	C	9	5	14	0	0	14	0	0
4	76322882	.	G	A	0	2	2	1	7	10	0	0
4	76336468	.	T	A	3	6	9	0	1	10	0	0
4	76336471	.	A	C	6	3	9	0	1	10	0	0
4	76343790	.	A	C	3	3	6	0	1	7	0	0
4	76343802	.	T	C	5	3	8	0	0	8	0	0
4	76343850	.	A	G	6	4	10	3	0	13	0	0
4	76343867	.	A	G	3	3	6	4	2	12	0	0
4	76344109	.	C	A	11	6	17	0	0	17	0	0
4	76344120	.	C	A	9	6	15	0	0	15	0	0
4	76345115	.	A	G	3	2	5	2	1	8	0	0
4	76345427	.	C	T	4	3	7	8	0	15	0	0
4	76345433	.	T	C	2	4	6	8	1	15	0	0
4	76345689	.	C	T	11	5	16	1	0	17	0	0
4	76345923	.	A	G	7	0	7	2	3	12	0	0
4	76345974	.	A	G	6	2	8	0	0	8	0	0
4	76346004	.	T	C	4	2	6	0	0	6	0	0
4	76346011	.	T	C	4	2	6	0	0	6	0	0
4	76346153	.	G	C	5	3	8	0	1	9	0	0
4	76346188	.	T	A	4	10	14	0	0	14	0	0
4	76346238	.	C	A	7	9	16	2	0	18	0	0
4	76346554	.	A	G	11	0	11	0	5	16	0	0
4	76346564	.	C	T	7	5	12	0	2	14	0	0
4	76347126	.	T	C	6	4	10	2	0	12	0	0
4	76347163	.	A	G	5	1	6	1	3	10	0	0
4	76347354	.	A	G	9	2	11	1	2	14	0	0
4	76347508	.	T	G	5	6	11	0	1	12	0	0
4	76347885	.	G	C	3	6	9	0	0	9	0	0
4	76359636	.	C	T	2	3	5	0	1	6	0	0
4	76359666	.	C	T	5	3	8	0	0	8	0	0
4	76360086	.	A	G	1	2	3	0	0	3	0	0
4	76360241	.	T	A	2	5	7	0	0	7	0	0
4	76360368	.	C	T	2	2	4	1	1	6	0	0
4	76360446	.	T	C	1	2	3	0	0	3	0	0
4	76360593	.	C	G	3	2	5	0	0	5	0	0
4	76361224	.	A	G	3	0	3	0	2	5	0	0
4	76361286	.	T	C	1	2	3	0	0	3	0	0
4	76361624	.	T	A	5	2	7	0	0	7	0	0
4	76361627	.	G	A	0	3	3	0	5	8	0	0
4	76362977	.	T	G	1	2	3	0	0	3	0	0
4	76363195	.	C	T	0	4	4	0	1	5	0	0
4	76363204	.	A	C	1	4	5	0	0	5	0	0
4	76408988	.	G	A	4	9	13	0	1	14	0	0
4	76409155	.	T	C	2	6	8	0	0	8	0	0
4	76409192	.	A	G	1	10	11	0	0	11	0	0
4	76409226	.	G	A	11	3	14	0	1	15	0	0
4	76409422	.	C	T	1	8	9	0	0	9	0	0
4	76409751	.	A	T	5	2	7	0	0	7	0	0
4	76410940	.	G	T	1	2	3	0	0	3	0	0
4	76410955	.	C	T	2	2	4	0	0	4	0	0
4	76411005	.	A	G	3	3	6	0	0	6	0	0
4	76411505	.	C	T	3	4	7	1	0	8	0	0
4	76411517	.	T	C	3	5	8	0	0	8	0	0
4	76411547	.	G	A	6	3	9	0	1	10	0	0
4	76411990	.	A	G	4	0	4	0	7	11	0	0
4	76412531	.	A	T	2	6	8	0	1	9	0	0
4	76420841	.	G	T	3	3	6	0	0	6	0	0
4	76420875	.	C	T	1	5	6	0	1	7	0	0
4	76420883	.	G	A	2	5	7	0	0	7	0	0
4	76420930	.	T	A	1	6	7	0	2	9	0	0
4	76421193	.	C	T	3	3	6	0	0	6	0	0
4	76421602	.	A	C	6	4	10	0	1	11	0	0
4	76421739	.	T	C	2	6	8	0	0	8	0	0
4	76421886	.	C	T	7	3	10	0	1	11	0	0
4	76422231	.	G	A	0	6	6	0	4	10	0	0
4	76422424	.	A	G	4	7	11	0	0	11	0	0
4	76423234	.	G	A	3	5	8	1	0	9	0	0
4	76423537	.	C	T	2	5	7	0	0	7	0	0
4	76423635	.	C	T	1	2	3	0	0	3	0	0
4	76427137	.	G	C	4	4	8	0	0	8	0	0
4	76427145	.	A	G	4	4	8	0	1	9	0	0
4	76429102	.	A	G	5	6	11	0	0	11	0	0
4	76429202	.	A	C	2	7	9	0	0	9	0	0
4	76429545	.	C	A	1	4	5	0	0	5	0	0
4	76429584	.	A	G	2	4	6	0	0	6	0	0
4	76429719	.	G	T	2	8	10	0	0	10	0	0
4	76429969	.	G	A	2	7	9	0	1	10	0	0
4	76430256	.	G	A	3	2	5	0	0	5	0	0
4	76430257	.	A	G	3	1	4	0	1	5	0	0
4	76430458	.	A	T	2	2	4	0	0	4	0	0
4	76430460	.	G	A	0	3	3	0	1	4	0	0
4	76437183	.	T	C	2	2	4	0	0	4	0	0
4	76463068	.	A	G	2	3	5	0	0	5	0	0
4	76463366	.	A	T	1	4	5	0	1	6	0	0
4	76463378	.	A	C	1	4	5	0	0	5	0	0
4	76463517	.	G	A	1	2	3	0	0	3	0	0
4	76473425	.	G	T	1	2	3	0	4	7	0	0
4	76473696	.	T	A	4	2	6	0	0	6	0	0
4	76473716	.	G	A	2	2	4	0	1	5	0	0
4	76474412	.	G	T	2	3	5	0	0	5	0	0
4	76474430	.	A	G	4	0	4	0	2	6	0	0
4	76480694	.	C	A	1	5	6	0	0	6	0	0
4	76480756	.	C	A	1	3	4	0	1	5	0	0
4	76480834	.	C	G	1	3	4	0	0	4	0	0
4	76481087	.	C	A	0	3	3	0	2	5	0	0
4	76481103	.	T	C	4	4	8	0	0	8	0	0
4	76481168	.	C	G	7	3	10	0	0	10	0	0
4	76481177	.	T	C	5	0	5	0	3	8	0	0
4	76481262	.	A	G	4	8	12	0	0	12	0	0
4	76481403	.	T	A	7	11	18	0	0	18	0	0
4	76481409	.	T	G	7	11	18	0	0	18	0	0
4	76481572	.	G	A	4	5	9	0	0	9	0	0
4	76481576	.	C	A	4	6	10	0	0	10	0	0
4	76482245	.	C	T	4	4	8	0	0	8	0	0
4	76482273	.	C	G	3	3	6	0	0	6	0	0
4	76482696	.	T	A	3	5	8	0	1	9	0	0
4	76484688	.	C	T	2	3	5	0	0	5	0	0
4	76488244	.	A	T	1	3	4	0	3	7	0	0
4	76488269	.	G	T	1	6	7	0	0	7	0	0
4	76488624	.	A	G	6	2	8	0	1	9	0	0
4	76488742	.	G	C	4	3	7	0	1	8	0	0
4	76575587	.	A	G	8	2	10	2	0	12	0	0
4	76575611	.	A	G	9	2	11	2	0	13	0	0
4	76581336	.	G	A	1	2	3	1	4	8	0	0
4	76581351	.	A	G	7	0	7	0	4	11	0	0
4	76581399	.	A	T	6	5	11	0	0	11	0	0
4	76581438	.	G	A	1	2	3	0	1	4	0	0
4	76582384	.	A	G	6	2	8	1	0	9	0	0
4	76582696	.	G	A	1	8	9	0	6	15	0	0
4	76587462	.	T	C	11	10	21	0	1	22	0	0
4	76587474	.	C	T	10	10	20	2	1	23	0	0
4	76588133	.	A	C	6	6	12	2	1	15	0	0
4	76588134	.	C	G	7	0	7	1	7	15	0	0
4	76588177	.	T	C	8	3	11	0	0	11	0	0
4	76588295	.	G	T	14	7	21	0	0	21	0	0
4	76839306	.	C	T	7	3	10	0	0	10	0	0
4	76839534	.	G	C	9	3	12	0	3	15	0	0
4	76849100	.	T	C	3	2	5	0	0	5	0	0
4	76849103	.	G	T	3	2	5	0	0	5	0	0
4	76855934	.	A	C	2	2	4	0	0	4	0	0
4	76855936	.	T	C	3	2	5	0	0	5	0	0
4	76856033	.	G	A	4	2	6	0	0	6	0	0
4	76866860	.	A	G	4	4	8	1	0	9	0	0
4	76866875	.	A	G	3	0	3	2	5	10	0	0
4	76867743	.	T	C	6	6	12	0	1	13	0	0
4	76867829	.	C	G	3	7	10	0	1	11	0	0
4	77050378	.	C	T	1	2	3	0	0	3	0	0
4	77051047	.	C	T	2	2	4	0	0	4	0	0
4	77052194	.	T	C	1	2	3	0	0	3	0	0
4	77053686	.	G	T	0	2	2	0	1	3	0	0
4	77053689	.	C	G	1	2	3	0	0	3	0	0
4	77057152	.	C	A	2	3	5	0	0	5	0	0
4	77057169	.	A	G	3	2	5	0	1	6	0	0
4	77057205	.	T	C	5	2	7	0	1	8	0	0
4	77057877	.	A	T	5	3	8	0	1	9	0	0
4	77058024	.	G	A	1	3	4	0	1	5	0	0
4	77058162	.	G	A	2	2	4	0	0	4	0	0
4	77058167	.	A	T	3	1	4	0	0	4	0	0
4	77058754	.	T	C	7	3	10	0	0	10	0	0
4	77058875	.	T	A	4	2	6	0	0	7	1	0
4	77059969	.	C	T	2	2	4	0	0	4	0	0
4	77060148	.	C	T	4	2	6	0	1	7	0	0
4	77060189	.	G	T	3	2	5	0	1	6	0	0
4	77064830	.	G	A	3	2	5	0	0	5	0	0
4	77064946	.	A	G	1	2	3	0	0	3	0	0
4	77100775	.	G	T	1	4	5	0	1	6	0	0
4	77100790	.	A	G	2	2	4	0	1	5	0	0
4	77101177	.	C	T	3	2	5	0	1	6	0	0
4	77101246	.	G	C	2	2	4	0	0	4	0	0
4	77103734	.	A	G	4	2	6	0	0	6	0	0
4	77145931	.	C	T	1	3	4	0	0	4	0	0
4	77146423	.	A	G	2	2	4	0	0	4	0	0
4	77146608	.	G	A	3	3	6	0	0	6	0	0
4	77147344	.	C	T	3	3	6	0	0	6	0	0
4	77147353	.	G	A	3	2	5	0	0	5	0	0
4	77147450	.	T	C	2	2	4	0	0	4	0	0
4	77147496	.	A	G	2	2	4	0	1	5	0	0
4	77147600	.	T	C	3	2	5	0	1	6	0	0
4	77147706	.	G	C	1	2	3	0	1	4	0	0
4	77148112	.	A	G	2	3	5	0	0	5	0	0
4	77148125	.	A	C	1	3	4	0	0	4	0	0
4	77148661	.	T	C	5	5	10	0	0	10	0	0
4	77148695	.	G	T	4	4	8	0	1	9	0	0
4	77148706	.	G	C	3	5	8	0	1	9	0	0
4	77149888	.	C	T	4	3	7	0	0	7	0	0
4	77156216	.	C	T	1	4	5	0	0	5	0	0
4	77207768	.	G	C	5	7	12	0	0	12	0	0
4	77207903	.	C	T	1	12	13	0	6	19	0	0
4	77209054	.	A	G	12	7	19	0	6	25	0	0
4	77211866	.	G	A	13	7	20	0	0	20	0	0
4	77211872	.	G	A	13	6	19	0	0	19	0	0
4	77212126	.	G	T	4	7	11	0	0	11	0	0
4	77214843	.	C	A	1	7	8	0	4	12	0	0
4	77214846	.	G	A	5	7	12	0	0	12	0	0
4	77216563	.	C	A	5	17	22	1	0	23	0	0
4	77219843	.	G	A	2	3	5	0	0	5	0	0
4	77222161	.	A	C	3	2	5	0	0	5	0	0
4	77222573	.	T	C	2	4	6	0	0	6	0	0
4	77222815	.	G	C	3	3	6	0	0	6	0	0
4	77222939	.	C	G	0	4	4	0	2	6	0	0
4	77227478	.	C	G	0	3	3	0	1	4	0	0
4	77227487	.	C	T	0	3	3	0	1	4	0	0
4	77227541	.	T	C	1	4	5	0	0	5	0	0
4	77227589	.	A	G	2	3	5	0	0	5	0	0
4	77227628	.	A	G	2	3	5	0	0	5	0	0
4	77228165	.	C	T	4	2	6	0	0	6	0	0
4	77229875	.	G	A	2	2	4	0	0	4	0	0
4	77229982	.	T	A	1	2	3	0	0	3	0	0
4	77230003	.	T	A	1	2	3	0	1	4	0	0
4	77230034	.	G	C	3	2	5	0	0	5	0	0
4	77230046	.	A	G	2	2	4	0	0	4	0	0
4	77231078	.	A	G	2	2	4	1	0	5	0	0
4	77231088	.	G	A	1	2	3	2	0	5	0	0
4	77250925	.	T	C	11	6	17	0	0	17	0	0
4	77250931	.	T	C	7	6	13	0	1	14	0	0
4	77255062	.	A	T	7	3	10	0	0	10	0	0
4	77349501	.	G	A	4	2	6	0	0	6	0	0
4	77389776	.	A	C	6	2	8	0	0	8	0	0
4	77389832	.	G	C	4	6	10	0	0	10	0	0
4	77389877	.	C	T	8	9	17	0	0	17	0	0
4	77389929	.	G	C	13	3	16	0	0	16	0	0
4	77389932	.	C	A	11	2	13	0	2	15	0	0
4	77390006	.	G	A	7	11	18	0	1	19	0	0
4	77390083	.	A	T	5	9	14	0	0	14	0	0
4	77390164	.	G	T	6	8	14	0	0	14	0	0
4	77390174	.	C	T	6	9	15	0	0	15	0	0
4	77390254	.	T	G	8	6	14	0	1	15	0	0
4	77390288	.	A	C	9	11	20	0	0	20	0	0
4	77390314	.	A	G	10	10	20	0	1	21	0	0
4	77390347	.	G	C	10	10	20	0	1	21	0	0
4	77390400	.	G	A	9	4	13	0	0	13	0	0
4	77400439	.	G	T	2	5	7	0	2	9	0	0
4	77400454	.	A	T	4	5	9	0	0	9	0	0
4	77402102	.	C	T	0	6	6	0	4	10	0	0
4	77402123	.	A	G	4	6	10	0	1	11	0	0
4	77402753	.	A	G	4	2	6	0	0	6	0	0
4	77407992	.	C	T	0	2	2	0	4	6	0	0
4	77928526	.	G	C	2	2	4	0	0	4	0	0
4	77928565	.	T	C	12	16	28	0	0	28	0	0
4	77931408	.	G	A	18	11	29	0	2	31	0	0
4	77932143	.	C	T	17	13	30	0	1	31	0	0
4	77932186	.	T	C	17	10	27	0	1	28	0	0
4	77932198	.	A	G	17	8	25	0	3	28	0	0
4	77932221	.	A	G	9	7	16	0	5	21	0	0
4	77932360	.	G	C	8	7	15	0	2	18	1	0
4	77932408	.	G	C	9	11	20	0	0	20	0	0
4	77932414	.	T	C	9	7	16	0	0	16	0	0
4	77944562	.	T	C	1	3	4	0	1	5	0	0
4	77945088	.	A	G	3	3	6	0	0	6	0	0
4	77948591	.	G	A	1	2	3	0	0	3	0	0
4	77950572	.	G	A	2	5	7	0	0	7	0	0
4	77957718	.	C	A	4	2	6	0	1	7	0	0
4	77960215	.	T	A	8	7	15	0	0	15	0	0
4	77963210	.	C	G	5	5	10	0	1	11	0	0
4	77963270	.	A	G	2	2	4	0	0	4	0	0
4	77963819	.	C	T	5	6	11	0	0	11	0	0
4	77964609	.	G	A	0	4	4	0	13	17	0	0
4	77966107	.	T	C	1	2	3	0	1	4	0	0
4	77966135	.	C	T	1	5	6	0	0	6	0	0
4	77966234	.	A	G	1	0	1	0	5	6	0	0
4	77967745	.	A	G	1	0	1	0	5	6	0	0
4	77967759	.	G	A	0	3	3	0	5	8	0	0
4	77968667	.	C	T	1	2	3	0	0	3	0	0
4	77971683	.	C	T	1	4	5	0	0	5	0	0
4	77972024	.	C	A	1	2	3	0	0	3	0	0
4	77981599	.	C	T	1	5	6	0	2	8	0	0
4	77993148	.	T	A	5	4	9	1	1	11	0	0
4	77993210	.	G	A	7	4	11	0	0	11	0	0
4	77993813	.	T	C	7	6	13	0	0	15	2	0
4	77993916	.	G	A	7	10	17	0	0	17	0	0
4	77995476	.	T	C	13	15	28	0	1	29	0	0
4	77995941	.	C	T	7	9	16	0	0	16	0	0
4	77995990	.	C	G	8	8	16	0	0	16	0	0
4	77996032	.	C	A	7	9	16	0	0	16	0	0
4	77996171	.	C	T	3	7	10	0	1	11	0	0
4	78008782	.	T	C	17	29	46	0	1	47	0	0
4	78022570	.	A	G	3	5	8	0	1	9	0	0
4	78024558	.	C	T	5	37	42	0	16	58	0	0
4	78025040	.	C	T	27	21	48	0	2	50	0	0
4	78025052	.	T	G	24	22	46	0	1	47	0	0
4	78025223	.	C	T	2	24	26	0	24	50	0	0
5	32110	.	C	T	8	3	11	0	1	12	0	0
5	32121	.	A	T	2	7	9	0	0	9	0	0
5	43375	.	G	T	3	6	9	0	0	9	0	0
5	97140	.	A	G	7	4	11	0	0	11	0	0
5	299391	.	A	C	0	2	2	0	1	3	0	0
5	318077	.	G	A	10	14	24	0	3	27	0	0
5	318125	.	C	T	15	12	27	0	0	27	0	0
5	320383	.	T	C	3	0	3	0	14	17	0	0
5	341698	.	A	C	12	0	12	0	1	13	0	0
5	342076	.	A	G	3	0	3	0	10	13	0	0
5	894613	.	C	T	9	5	14	0	0	14	0	0
5	894882	.	T	A	11	9	20	0	0	20	0	0
5	895581	.	T	C	7	15	22	0	1	23	0	0
5	896908	.	C	A	7	4	11	0	1	12	0	0
5	899952	.	C	T	10	11	21	0	0	21	0	0
5	905263	.	C	A	9	7	16	0	0	16	0	0
5	917336	.	C	T	17	13	30	0	0	30	0	0
5	1055103	.	C	T	21	19	40	0	1	41	0	0
5	1059697	.	T	C	20	20	40	0	1	41	0	0
5	1064013	.	A	G	19	18	37	0	3	40	0	0
5	1068116	.	T	A	21	15	36	0	0	38	2	0
5	1073789	.	C	T	0	2	2	1	2	5	0	0
5	1079480	.	C	T	7	12	19	0	0	19	0	0
5	1079558	.	G	T	9	10	19	1	1	21	0	0
5	1083073	.	A	G	2	0	2	0	5	7	0	0
5	1083203	.	G	C	5	4	9	1	0	10	0	0
5	1083237	.	T	A	2	3	5	1	0	6	0	0
5	1083242	.	T	C	2	2	4	1	0	5	0	0
5	1083894	.	T	G	12	0	12	0	10	22	0	0
5	1109244	.	C	T	2	3	5	0	0	5	0	0
5	1138161	.	C	T	4	2	6	0	0	6	0	0
5	1149757	.	C	G	1	2	3	0	0	3	0	0
5	1152013	.	G	C	1	8	9	0	0	9	0	0
5	1155594	.	G	A	4	3	7	0	0	7	0	0
5	1207835	.	C	T	4	8	12	0	0	12	0	0
5	1216494	.	A	G	3	6	9	0	0	9	0	0
5	1216536	.	C	T	0	9	9	0	8	17	0	0
5	1216575	.	G	A	7	10	17	0	0	17	0	0
5	1218781	.	G	A	3	3	6	0	1	7	0	0
5	1219263	.	C	T	22	11	33	0	0	33	0	0
5	1219381	.	G	A	17	12	29	0	2	31	0	0
5	1223368	.	A	T	6	6	12	2	1	15	0	0
5	1223369	.	C	T	7	6	13	2	0	15	0	0
5	1223460	.	G	A	7	12	19	0	0	19	0	0
5	1223487	.	G	T	7	11	18	0	0	18	0	0
5	1240403	.	C	A	1	8	9	0	3	12	0	0
5	1240517	.	T	C	1	4	5	0	0	5	0	0
5	1240534	.	G	A	2	2	4	0	0	4	0	0
5	1240589	.	C	T	0	11	11	0	2	13	0	0
5	1244945	.	A	G	1	4	5	0	0	5	0	0
5	1244952	.	C	T	0	3	3	0	1	4	0	0
5	1259820	.	T	C	3	3	6	0	0	6	0	0
5	1259838	.	T	A	3	2	5	0	0	5	0	0
5	1264403	.	G	A	3	2	5	0	1	6	0	0
5	1270554	.	T	C	1	0	1	0	3	4	0	0
5	1274734	.	C	T	5	3	8	0	0	8	0	0
5	1274749	.	T	C	3	2	5	0	0	5	0	0
5	1299350	.	C	G	18	0	18	0	15	33	0	0
5	1311041	.	G	A	18	24	42	0	1	43	0	0
5	1317871	.	T	C	15	23	38	0	2	40	0	0
5	1317883	.	G	A	13	25	38	0	1	39	0	0
5	1346838	.	T	C	20	24	44	0	1	45	0	0
5	1420926	.	C	A	11	2	13	0	0	13	0	0
5	1420949	.	A	C	9	2	11	0	0	11	0	0
5	1421052	.	T	A	2	4	6	0	1	7	0	0
5	1438628	.	G	A	10	12	22	0	1	23	0	0
5	1445964	.	G	A	7	6	13	0	1	14	0	0
5	1451568	.	G	A	6	3	9	0	0	9	0	0
5	1451666	.	T	C	7	1	8	0	12	20	0	0
5	1456393	.	G	A	13	7	20	0	0	20	0	0
5	1456411	.	T	C	9	6	15	0	3	18	0	0
5	1461953	.	C	T	11	3	14	0	0	14	0	0
5	1464617	.	G	T	5	8	13	0	0	13	0	0
5	1467806	.	C	T	2	8	10	0	4	14	0	0
5	1468472	.	T	C	11	0	11	1	7	19	0	0
5	1519571	.	G	C	14	11	25	0	3	28	0	0
5	1519574	.	T	A	13	13	26	0	1	27	0	0
5	1990001	.	T	A	0	0	0	0	1	5	4	0
5	1990836	.	A	T	4	1	5	4	4	13	0	0
5	1990838	.	A	T	4	2	6	4	3	13	0	0
5	2242447	.	A	G	0	2	2	0	0	2	0	0
5	2242456	.	A	T	1	2	3	0	1	4	0	0
5	2242599	.	G	A	10	3	13	0	1	14	0	0
5	2242602	.	G	T	10	3	13	0	0	13	0	0
5	2242708	.	A	G	5	2	7	0	0	7	0	0
5	2242795	.	G	A	8	5	13	0	0	13	0	0
5	2251629	.	C	T	3	4	7	0	1	8	0	0
5	2251669	.	A	G	4	6	10	0	1	11	0	0
5	2251670	.	T	A	5	7	12	0	0	12	0	0
5	2251704	.	T	C	4	0	4	0	8	12	0	0
5	2254721	.	G	T	4	2	6	0	0	6	0	0
5	2658348	.	G	A	13	7	20	0	0	20	0	0
5	2686225	.	G	C	1	7	8	0	0	8	0	0
5	2693660	.	G	A	4	5	9	0	0	9	0	0
5	2693740	.	C	G	3	4	7	0	0	7	0	0
5	2693768	.	G	A	0	4	4	0	4	8	0	0
5	2696450	.	A	C	1	3	4	0	0	4	0	0
5	2709533	.	A	G	1	3	4	0	1	5	0	0
5	2709561	.	T	C	1	1	2	0	1	3	0	0
5	2713967	.	A	G	23	22	45	0	5	50	0	0
5	2714042	.	C	T	21	29	50	0	0	50	0	0
5	2714135	.	C	T	25	24	49	0	2	51	0	0
5	2714237	.	G	A	21	28	49	0	3	52	0	0
5	2714495	.	G	A	22	28	50	0	0	50	0	0
5	2714507	.	A	G	25	25	50	0	2	52	0	0
5	2714531	.	T	C	29	2	31	0	21	52	0	0
5	2716930	.	G	A	17	20	37	2	0	39	0	0
5	2716963	.	G	A	16	22	38	0	1	39	0	0
5	2717014	.	G	A	11	23	34	0	1	35	0	0
5	2717022	.	G	A	10	20	30	0	0	30	0	0
5	2717260	.	T	C	15	15	30	0	1	31	0	0
5	2717350	.	G	C	23	1	24	0	15	39	0	0
5	2717611	.	C	T	10	21	31	0	1	32	0	0
5	2717623	.	A	G	9	21	30	0	1	31	0	0
5	2717960	.	A	G	17	14	31	0	0	31	0	0
5	2718696	.	A	G	15	6	21	0	1	22	0	0
5	2718834	.	G	A	6	17	23	0	0	23	0	0
5	2720119	.	A	G	11	23	34	0	2	36	0	0
5	2721588	.	C	T	17	8	25	0	0	25	0	0
5	2742784	.	A	G	5	10	15	0	1	16	0	0
5	2744938	.	C	T	9	12	21	0	1	22	0	0
5	2744962	.	C	G	9	11	20	0	0	20	0	0
5	2744998	.	C	T	6	6	12	0	1	13	0	0
5	2745220	.	G	T	17	15	32	0	2	34	0	0
5	2750087	.	G	A	15	12	27	0	0	27	0	0
5	2750127	.	G	A	13	15	28	0	0	28	0	0
5	2750244	.	G	A	14	8	22	0	0	22	0	0
5	2750256	.	G	A	8	11	19	0	0	19	0	0
5	2751319	.	G	A	10	10	20	0	0	20	0	0
5	2751511	.	G	A	16	11	27	0	0	27	0	0
5	3185164	.	C	G	1	2	3	0	1	4	0	0
5	3192019	.	C	T	0	3	3	0	3	6	0	0
5	3362996	.	G	A	2	1	3	0	2	6	1	0
5	3363014	.	C	T	2	5	7	0	0	7	0	0
5	3363050	.	C	T	2	3	5	0	0	5	0	0
5	3544098	.	C	T	35	24	59	0	1	60	0	0
5	3544380	.	C	T	27	33	60	0	6	66	0	0
5	3544955	.	T	C	27	18	45	0	2	47	0	0
5	3545011	.	T	A	27	17	44	0	4	48	0	0
5	3545205	.	A	T	35	1	36	0	0	37	1	0
5	3568494	.	C	T	2	13	15	0	0	15	0	0
5	3568518	.	G	T	1	12	13	0	2	15	0	0
5	3611952	.	C	T	1	2	3	0	4	7	0	0
5	3612011	.	A	T	3	4	7	0	0	7	0	0
5	3612025	.	C	A	4	4	8	0	0	8	0	0
5	3612254	.	A	G	5	13	18	0	0	18	0	0
5	3618064	.	G	A	10	7	17	0	1	18	0	0
5	3670231	.	G	A	4	4	8	0	0	8	0	0
5	3839271	.	A	T	1	2	3	0	0	3	0	0
5	3891603	.	C	T	5	4	9	0	0	9	0	0
5	3901564	.	A	C	1	6	7	0	0	7	0	0
5	3914638	.	T	G	15	11	26	0	1	27	0	0
5	3925732	.	A	C	28	1	29	0	9	38	0	0
5	3925769	.	T	C	13	29	42	0	3	45	0	0
5	3927524	.	G	A	15	16	31	0	2	33	0	0
5	3928017	.	T	C	3	2	5	0	0	5	0	0
5	3928112	.	T	C	4	2	6	0	0	6	0	0
5	4010666	.	A	G	1	0	1	0	3	4	0	0
5	4010747	.	T	C	1	5	6	0	0	6	0	0
5	4024746	.	A	G	4	0	4	0	5	9	0	0
5	4024797	.	G	T	8	10	18	0	0	19	1	0
5	4024857	.	G	A	1	4	5	0	10	15	0	0
5	4024863	.	T	C	5	7	12	0	1	13	0	0
5	4052191	.	G	A	3	4	7	0	0	7	0	0
5	4054996	.	G	T	3	2	5	1	0	6	0	0
5	4054997	.	A	T	3	2	5	1	0	6	0	0
5	4137043	.	A	G	2	3	5	0	1	6	0	0
5	4142284	.	T	G	1	4	5	0	0	5	0	0
5	4142487	.	G	A	8	4	12	0	0	12	0	0
5	4142581	.	T	A	1	2	3	0	0	4	1	0
5	4142582	.	T	G	2	2	4	0	0	4	0	0
5	4254061	.	C	T	3	3	6	1	6	13	0	0
5	4260424	.	T	C	12	6	18	0	0	18	0	0
5	4265417	.	T	C	11	9	20	0	1	21	0	0
5	4270791	.	C	A	2	10	12	0	13	25	0	0
5	4271102	.	C	T	1	5	6	0	13	19	0	0
5	4273144	.	T	C	9	13	22	0	1	23	0	0
5	4273159	.	T	C	9	11	20	0	1	21	0	0
5	4275481	.	C	T	4	14	18	0	13	31	0	0
5	4281626	.	A	G	8	11	19	0	0	19	0	0
5	4281634	.	A	G	10	11	21	0	1	22	0	0
5	4292545	.	A	T	5	7	12	0	1	13	0	0
5	4292578	.	A	G	4	12	16	0	0	16	0	0
5	4293975	.	T	C	12	12	24	0	2	26	0	0
5	4293978	.	C	A	14	11	25	0	2	27	0	0
5	4296556	.	C	G	11	11	22	0	0	22	0	0
5	4298902	.	G	C	11	16	27	0	0	27	0	0
5	4299588	.	A	G	12	0	12	0	11	23	0	0
5	4384706	.	G	A	1	5	6	0	0	6	0	0
5	4387137	.	T	G	7	4	11	0	0	11	0	0
5	4397741	.	A	G	2	5	7	0	0	7	0	0
5	4397901	.	T	C	4	7	11	1	0	12	0	0
5	4414178	.	C	T	4	8	12	0	2	14	0	0
5	4469479	.	A	T	2	3	5	0	0	5	0	0
5	4469658	.	G	A	0	4	4	0	6	10	0	0
5	4469754	.	G	A	1	7	8	0	9	17	0	0
5	4470225	.	T	G	8	0	8	0	6	14	0	0
5	4482992	.	G	A	14	6	20	0	0	20	0	0
5	4493427	.	C	G	2	12	14	0	15	29	0	0
5	4493502	.	T	G	4	5	9	0	0	9	0	0
5	4523677	.	T	C	7	1	8	0	3	11	0	0
5	4528225	.	G	A	9	5	14	0	1	15	0	0
5	4532499	.	A	G	6	3	9	0	0	9	0	0
5	4545106	.	G	A	6	5	11	0	0	11	0	0
5	4545115	.	A	G	5	4	9	0	0	9	0	0
5	4729334	.	G	A	5	14	19	0	0	19	0	0
5	5171750	.	G	A	3	2	5	0	0	5	0	0
5	5171770	.	G	A	4	4	8	0	0	8	0	0
5	5171978	.	G	A	4	2	6	0	0	6	0	0
5	5172020	.	G	C	3	2	5	0	1	6	0	0
5	5172021	.	A	C	3	0	3	0	3	6	0	0
5	5185955	.	G	C	10	12	22	0	0	22	0	0
5	5195882	.	A	G	3	13	16	0	0	16	0	0
5	5313840	.	C	T	1	4	5	0	3	8	0	0
5	5313879	.	T	C	8	4	12	0	0	12	0	0
5	5321110	.	A	G	6	3	9	0	0	9	0	0
5	5325772	.	G	A	1	2	3	1	0	4	0	0
5	5394341	.	A	C	2	0	2	1	7	10	0	0
5	5399019	.	C	T	3	2	5	0	0	5	0	0
5	5399025	.	T	A	2	3	5	0	0	5	0	0
5	5406568	.	C	T	2	4	6	0	0	6	0	0
5	5406727	.	G	A	0	5	5	0	1	6	0	0
5	5486039	.	T	C	5	4	9	0	0	9	0	0
5	5498155	.	C	T	3	5	8	0	0	8	0	0
5	5498206	.	G	A	4	4	8	0	0	8	0	0
5	5619609	.	G	C	2	3	5	0	0	5	0	0
5	5619670	.	G	T	1	5	6	0	0	6	0	0
5	5619677	.	C	G	0	5	5	0	1	6	0	0
5	5619722	.	A	G	3	5	8	0	0	8	0	0
5	5622094	.	C	G	2	8	10	0	2	12	0	0
5	5622265	.	A	G	2	8	10	0	0	10	0	0
5	5628973	.	G	A	3	5	8	0	0	8	0	0
5	5628979	.	C	T	2	4	6	0	0	6	0	0
5	5632351	.	T	C	2	2	4	0	0	4	0	0
5	5632397	.	G	A	2	6	8	0	0	8	0	0
5	5640388	.	T	C	1	2	3	0	0	3	0	0
5	5640389	.	G	A	1	2	3	0	0	3	0	0
5	5649223	.	A	G	2	3	5	0	0	5	0	0
5	5689538	.	G	T	4	4	8	0	0	8	0	0
5	5689542	.	C	T	4	4	8	0	0	8	0	0
5	5689889	.	A	G	3	3	6	0	0	6	0	0
5	5691879	.	A	G	2	3	5	0	0	5	0	0
5	5696023	.	G	A	2	3	5	0	1	6	0	0
5	5696044	.	T	C	2	2	4	0	0	4	0	0
5	5736683	.	C	T	0	4	4	0	1	5	0	0
5	5780207	.	G	A	3	3	6	0	1	7	0	0
5	5780248	.	A	T	2	6	8	0	0	8	0	0
5	5783092	.	T	A	5	2	7	0	1	8	0	0
5	5796908	.	A	T	2	4	6	0	0	6	0	0
5	5797883	.	T	A	4	4	8	0	1	9	0	0
5	5797960	.	C	G	0	5	5	0	4	9	0	0
5	5798255	.	G	A	4	4	8	0	2	10	0	0
5	5798690	.	C	T	0	6	6	0	4	10	0	0
5	5799011	.	C	G	1	3	4	0	0	4	0	0
5	5799197	.	C	T	3	5	8	0	0	8	0	0
5	5830819	.	G	C	1	3	4	0	0	4	0	0
5	6858380	.	C	A	7	11	18	0	0	18	0	0
5	6858540	.	T	A	13	6	19	0	0	19	0	0
5	6858779	.	G	T	0	6	6	0	15	21	0	0
5	6863647	.	C	T	13	10	23	0	0	23	0	0
5	6863768	.	G	C	8	18	26	0	0	26	0	0
5	6863793	.	G	A	12	16	28	0	0	28	0	0
5	6863834	.	A	G	14	1	15	0	13	28	0	0
5	6863855	.	G	A	11	15	26	0	2	28	0	0
5	6863912	.	A	C	12	4	16	0	1	17	0	0
5	6864010	.	C	T	3	6	9	0	0	9	0	0
5	8006474	.	A	G	5	4	9	1	1	11	0	0
5	8006503	.	A	G	3	9	12	1	2	15	0	0
5	8537820	.	T	C	1	3	4	0	0	4	0	0
5	8542678	.	A	G	6	2	8	0	1	9	0	0
5	9824375	.	T	C	5	2	7	0	1	8	0	0
5	9824444	.	G	C	4	3	7	0	0	7	0	0
5	9824694	.	G	A	6	5	11	0	0	11	0	0
5	9824885	.	C	T	4	3	7	0	0	7	0	0
5	9824894	.	G	T	4	2	6	0	0	6	0	0
5	9986173	.	A	G	3	2	5	0	0	5	0	0
5	10002156	.	G	T	2	2	4	0	0	4	0	0
5	10046718	.	G	A	0	3	3	0	2	5	0	0
5	10051017	.	G	A	0	3	3	0	2	5	0	0
5	10053778	.	C	A	1	2	3	0	0	3	0	0
5	10084232	.	T	G	2	3	5	0	0	5	0	0
5	10766286	.	G	A	10	6	16	0	0	16	0	0
5	10766505	.	A	G	14	16	30	2	1	33	0	0
5	10766529	.	G	A	17	11	28	2	1	31	0	0
5	10766879	.	A	G	24	7	31	0	1	32	0	0
5	10767113	.	C	T	14	17	31	0	0	31	0	0
5	10767259	.	A	G	22	15	37	0	1	38	0	0
5	10767456	.	G	A	11	5	16	0	0	16	0	0
5	10767588	.	C	T	3	12	15	0	1	16	0	0
5	10768089	.	G	A	10	15	25	0	0	25	0	0
5	10768182	.	G	A	7	17	24	0	0	24	0	0
5	10768215	.	T	C	14	0	14	0	7	21	0	0
5	10946038	.	G	A	6	13	19	0	1	20	0	0
5	10946085	.	G	T	6	9	15	0	2	17	0	0
5	11244675	.	A	G	4	3	7	0	0	7	0	0
5	11250049	.	C	T	2	2	4	0	0	4	0	0
5	11507602	.	A	G	11	10	21	0	2	23	0	0
5	11573461	.	C	T	8	10	18	0	0	18	0	0
5	11727417	.	C	T	0	3	3	0	1	4	0	0
5	11727696	.	T	G	1	2	3	0	0	3	0	0
5	11741855	.	C	G	2	2	4	0	1	5	0	0
5	11812278	.	C	T	16	5	21	0	1	22	0	0
5	11816439	.	C	T	3	2	5	0	0	5	0	0
5	11816599	.	G	A	5	13	18	0	0	18	0	0
5	11824059	.	G	A	1	10	11	0	7	18	0	0
5	11824188	.	T	C	4	6	10	0	0	10	0	0
5	11826347	.	T	C	14	9	23	0	0	23	0	0
5	11836437	.	T	C	14	9	23	0	2	25	0	0
5	11864572	.	C	G	2	3	5	0	0	5	0	0
5	11864774	.	T	G	9	7	16	0	0	16	0	0
5	11900230	.	T	C	9	0	9	0	6	15	0	0
5	11905038	.	G	A	4	2	6	0	0	6	0	0
5	11905086	.	A	T	8	3	11	0	0	11	0	0
5	11905661	.	T	C	2	0	2	0	4	6	0	0
5	11905725	.	C	T	5	5	10	0	0	10	0	0
5	11905890	.	A	G	10	7	17	0	0	17	0	0
5	11905903	.	T	G	5	8	13	0	1	14	0	0
5	11917125	.	C	T	5	5	10	0	0	10	0	0
5	11917405	.	G	A	11	5	16	0	0	16	0	0
5	11917436	.	G	A	3	10	13	0	0	13	0	0
5	11917485	.	G	A	10	6	16	0	0	16	0	0
5	11917596	.	C	A	3	14	17	0	11	28	0	0
5	11933155	.	A	G	13	10	23	0	3	26	0	0
5	11935444	.	G	A	10	11	21	0	0	21	0	0
5	11937486	.	G	A	10	10	20	0	0	20	0	0
5	11941903	.	T	C	5	0	5	0	10	15	0	0
5	11943662	.	A	C	5	10	15	0	0	15	0	0
5	11943868	.	G	A	8	8	16	0	0	16	0	0
5	11943934	.	C	A	11	9	20	0	0	20	0	0
5	11943948	.	T	A	10	8	18	0	0	18	0	0
5	11943989	.	G	A	8	5	13	0	1	14	0	0
5	11944060	.	T	G	7	4	11	0	0	11	0	0
5	11949244	.	G	T	11	11	22	0	0	22	0	0
5	11959776	.	G	T	1	18	19	0	15	34	0	0
5	11959777	.	C	T	18	15	33	0	1	34	0	0
5	11959818	.	C	T	17	19	36	0	0	36	0	0
5	11959966	.	C	G	7	13	20	0	1	21	0	0
5	11959988	.	G	A	2	7	9	0	9	18	0	0
5	11982950	.	C	A	4	3	7	0	0	7	0	0
5	11983017	.	T	C	5	2	7	0	1	8	0	0
5	11983395	.	T	A	6	4	10	1	0	11	0	0
5	11983548	.	C	G	3	6	9	0	0	9	0	0
5	11983959	.	C	T	3	6	9	0	1	10	0	0
5	11983964	.	C	T	4	4	8	0	0	8	0	0
5	11984086	.	T	C	1	4	5	0	0	5	0	0
5	11984133	.	C	T	5	5	10	0	0	10	0	0
5	11985546	.	A	T	1	6	7	0	0	7	0	0
5	12000924	.	A	G	2	3	5	0	0	5	0	0
5	12011302	.	C	T	0	3	3	0	3	6	0	0
5	12100335	.	G	A	6	6	12	1	0	13	0	0
5	12115313	.	A	G	6	3	9	0	0	9	0	0
5	12135260	.	C	T	0	6	6	0	2	8	0	0
5	12136669	.	G	C	2	9	11	0	3	14	0	0
5	12144035	.	T	C	3	7	10	0	1	11	0	0
5	12146026	.	A	G	3	6	9	0	0	9	0	0
5	12168413	.	A	G	6	5	11	0	0	11	0	0
5	12170258	.	G	A	2	6	8	0	0	8	0	0
5	12219580	.	A	G	4	4	8	0	0	8	0	0
5	12284075	.	C	T	9	20	29	0	0	29	0	0
5	12285172	.	T	C	15	1	16	0	7	23	0	0
5	12285316	.	C	T	5	5	10	0	1	11	0	0
5	12285504	.	C	A	1	2	3	0	0	3	0	0
5	12285601	.	C	G	10	4	14	0	0	14	0	0
5	12288511	.	T	C	6	12	18	0	4	22	0	0
5	12288541	.	A	G	14	15	29	0	0	29	0	0
5	12297084	.	C	T	13	10	23	0	0	23	0	0
5	12322321	.	G	A	7	11	18	0	1	19	0	0
5	12357538	.	G	A	13	8	21	0	1	22	0	0
5	12357554	.	C	T	14	9	23	0	1	24	0	0
5	12454563	.	T	C	14	0	14	0	15	29	0	0
5	12503554	.	G	A	9	7	16	0	0	16	0	0
5	12524938	.	A	G	9	6	15	0	0	15	0	0
5	12530423	.	G	T	11	8	19	0	0	19	0	0
5	12530425	.	C	A	12	8	20	0	0	20	0	0
5	12533197	.	C	T	6	5	11	0	0	11	0	0
5	12535785	.	A	T	6	6	12	0	0	12	0	0
5	12549258	.	C	T	14	5	19	0	2	21	0	0
5	12549561	.	T	C	5	2	7	0	0	7	0	0
5	12549642	.	C	A	3	2	5	0	0	5	0	0
5	12549807	.	A	G	5	3	8	0	1	9	0	0
5	12549981	.	G	T	10	6	16	0	0	16	0	0
5	12553935	.	C	T	0	7	7	0	4	11	0	0
5	12554073	.	G	A	4	5	9	0	1	10	0	0
5	12554119	.	A	G	8	3	11	0	1	12	0	0
5	12558090	.	C	T	6	7	13	0	0	13	0	0
5	12613409	.	C	A	4	2	6	0	0	6	0	0
5	12618524	.	G	A	0	3	3	0	1	4	0	0
5	12620755	.	G	T	1	2	3	0	0	3	0	0
5	12620762	.	T	C	1	2	3	0	0	3	0	0
5	12624200	.	G	T	1	4	5	0	0	5	0	0
5	12625831	.	A	T	2	2	4	0	0	4	0	0
5	12645971	.	G	A	1	3	4	0	0	4	0	0
5	12648074	.	G	A	3	2	5	0	0	5	0	0
5	12664278	.	G	A	2	5	7	0	1	8	0	0
5	12701122	.	A	G	2	4	6	0	0	6	0	0
5	12701139	.	C	T	2	4	6	0	0	6	0	0
5	12724121	.	C	T	6	7	13	0	0	13	0	0
5	12724224	.	G	A	5	9	14	0	1	15	0	0
5	12724412	.	A	G	2	2	4	0	0	4	0	0
5	12724450	.	C	T	2	2	4	0	4	8	0	0
5	12724505	.	C	A	13	10	23	0	2	25	0	0
5	12724518	.	G	C	14	2	16	0	12	28	0	0
5	12724567	.	A	G	14	13	27	0	0	27	0	0
5	12724694	.	C	T	0	6	6	0	18	24	0	0
5	12725930	.	G	A	16	29	45	0	1	46	0	0
5	12726842	.	A	G	27	14	41	0	2	43	0	0
5	12729397	.	C	T	9	7	16	0	0	16	0	0
5	12732247	.	C	T	11	11	22	0	0	22	0	0
5	12734883	.	G	T	15	21	36	0	0	36	0	0
5	12734910	.	T	C	12	16	28	0	0	28	0	0
5	12743011	.	C	A	7	7	14	0	1	15	0	0
5	12743088	.	T	A	6	3	9	0	0	9	0	0
5	12743159	.	A	T	5	5	10	0	1	11	0	0
5	12790004	.	T	C	1	2	3	0	0	3	0	0
5	12837013	.	T	A	4	3	7	0	0	7	0	0
5	12837064	.	G	A	11	8	19	0	0	19	0	0
5	12859258	.	T	C	16	12	28	0	0	28	0	0
5	12903740	.	T	C	1	4	5	0	0	5	0	0
5	12903862	.	G	C	3	3	6	0	0	6	0	0
5	12904933	.	A	G	2	3	5	0	0	5	0	0
5	12905466	.	C	T	2	3	5	0	0	5	0	0
5	12905621	.	T	G	3	2	5	0	0	5	0	0
5	12905672	.	A	C	1	3	4	0	1	5	0	0
5	12905681	.	A	G	1	3	4	0	0	4	0	0
5	12905968	.	T	G	2	2	4	0	0	4	0	0
5	12906014	.	C	T	2	2	4	0	0	4	0	0
5	12906273	.	C	T	3	4	7	1	0	8	0	0
5	12906343	.	A	G	3	0	3	0	3	6	0	0
5	12908828	.	C	A	5	11	16	0	0	16	0	0
5	12926507	.	C	A	9	8	17	0	0	17	0	0
5	12935223	.	A	G	5	4	9	0	0	9	0	0
5	12956918	.	T	C	6	5	11	0	0	11	0	0
5	12956960	.	C	T	5	7	12	0	0	12	0	0
5	12975297	.	G	A	0	10	10	0	4	14	0	0
5	12975532	.	C	T	5	7	12	0	2	14	0	0
5	13037199	.	C	T	1	6	7	0	7	14	0	0
5	13037203	.	C	T	1	5	6	0	9	15	0	0
5	13037939	.	T	G	11	16	27	0	1	28	0	0
5	13037967	.	G	A	12	17	29	0	2	31	0	0
5	13037998	.	A	G	13	12	25	0	1	26	0	0
5	13105020	.	C	T	26	22	48	0	7	55	0	0
5	13105070	.	C	A	7	28	35	0	19	54	0	0
5	13112979	.	G	A	16	30	46	1	1	48	0	0
5	13167048	.	A	T	17	18	35	0	1	36	0	0
5	13214802	.	C	G	6	6	12	0	2	14	0	0
5	13223062	.	G	A	5	2	7	0	0	7	0	0
5	13227057	.	C	T	1	9	10	0	7	17	0	0
5	13229024	.	C	A	6	5	11	0	0	11	0	0
5	13239172	.	A	G	4	2	6	0	0	6	0	0
5	13239412	.	A	G	4	3	7	0	0	7	0	0
5	13240441	.	A	G	5	3	8	0	0	8	0	0
5	13251681	.	A	C	2	0	2	0	9	11	0	0
5	13251737	.	C	A	0	4	4	0	2	6	0	0
5	13308997	.	G	T	4	4	8	0	0	8	0	0
5	13309174	.	T	C	6	1	7	0	13	20	0	0
5	13309215	.	C	T	13	6	19	0	0	19	0	0
5	13309273	.	C	T	9	13	22	0	1	23	0	0
5	13309309	.	G	A	13	16	29	0	0	29	0	0
5	13309402	.	A	G	11	18	29	0	0	29	0	0
5	13309435	.	A	T	13	18	31	0	1	32	0	0
5	13309522	.	G	A	9	23	32	1	0	33	0	0
5	13312671	.	A	T	12	17	29	0	1	30	0	0
5	13312746	.	G	A	8	19	27	0	1	28	0	0
5	13315490	.	G	C	16	12	28	0	1	29	0	0
5	13315526	.	T	C	10	11	21	0	1	22	0	0
5	13315603	.	A	C	12	10	22	0	0	23	1	0
5	13326851	.	C	T	5	4	9	0	0	9	0	0
5	13326911	.	G	A	0	5	5	0	2	7	0	0
5	13329785	.	G	C	7	2	9	0	0	9	0	0
5	13332930	.	A	G	4	2	6	0	2	8	0	0
5	13335333	.	G	A	1	5	6	0	0	6	0	0
5	13335373	.	G	T	1	2	3	0	4	7	0	0
5	13335423	.	C	T	7	4	11	0	0	11	0	0
5	13337803	.	C	T	14	11	25	0	0	25	0	0
5	13337883	.	T	A	17	13	30	0	1	31	0	0
5	13338441	.	C	T	1	16	17	0	13	30	0	0
5	13338762	.	A	T	9	11	20	0	0	20	0	0
5	13339038	.	G	C	20	14	34	0	9	43	0	0
5	13385888	.	A	G	3	0	3	0	3	6	0	0
5	13385916	.	T	A	6	5	11	0	0	11	0	0
5	13394714	.	A	G	2	2	4	0	0	4	0	0
5	13401174	.	C	T	1	3	4	0	0	4	0	0
5	13410020	.	G	T	1	2	3	0	4	7	0	0
5	13426709	.	A	C	1	2	3	0	0	3	0	0
5	13445433	.	C	T	1	5	6	0	0	6	0	0
5	13445511	.	A	G	7	4	11	0	1	12	0	0
5	13465095	.	T	C	4	4	8	0	1	9	0	0
5	13468108	.	G	T	0	13	13	0	4	17	0	0
5	13468172	.	C	T	3	5	8	0	0	8	0	0
5	13468574	.	G	A	2	3	5	0	0	5	0	0
5	13468655	.	G	A	6	3	9	0	0	9	0	0
5	13468656	.	A	T	5	3	8	0	1	9	0	0
5	13472279	.	C	T	10	10	20	0	0	20	0	0
5	13472295	.	G	T	11	10	21	0	0	21	0	0
5	13472743	.	A	T	3	3	6	0	0	6	0	0
5	13473094	.	T	G	1	5	6	0	0	6	0	0
5	13473418	.	C	T	1	4	5	0	0	5	0	0
5	13473436	.	T	C	1	3	4	0	0	4	0	0
5	13501228	.	T	C	2	3	5	0	0	5	0	0
5	13501288	.	C	A	4	3	7	0	0	7	0	0
5	13501336	.	C	T	5	2	7	0	0	7	0	0
5	13501345	.	C	T	4	4	8	0	0	8	0	0
5	13539403	.	A	G	6	0	6	1	6	13	0	0
5	13539493	.	A	G	4	0	4	0	9	13	0	0
5	13540689	.	C	T	3	14	17	0	1	18	0	0
5	13540738	.	C	T	7	3	10	0	0	10	0	0
5	13540846	.	T	A	6	3	9	0	0	9	0	0
5	13553448	.	T	A	1	2	3	0	0	3	0	0
5	13553485	.	C	T	1	2	3	0	0	3	0	0
5	13554195	.	A	T	2	2	4	0	0	4	0	0
5	13554215	.	C	T	2	2	4	0	0	4	0	0
5	13643325	.	G	A	13	11	24	0	1	25	0	0
5	13643411	.	C	T	3	22	25	0	17	42	0	0
5	13643824	.	G	A	16	17	33	0	0	33	0	0
5	13644126	.	A	T	27	14	41	0	0	41	0	0
5	13644185	.	T	G	17	15	32	0	4	36	0	0
5	13644189	.	T	G	22	14	36	0	2	38	0	0
5	13644227	.	A	G	19	11	30	3	1	34	0	0
5	13644256	.	A	T	19	10	29	9	0	38	0	0
5	13644581	.	T	G	21	14	35	0	2	37	0	0
5	13644602	.	T	A	22	17	39	0	1	41	1	0
5	13644781	.	C	T	17	10	27	0	0	27	0	0
5	13644797	.	A	G	8	13	21	0	2	23	0	0
5	13645047	.	C	G	18	14	32	0	0	32	0	0
5	13645746	.	A	G	15	18	33	0	0	33	0	0
5	13645885	.	T	C	8	14	22	0	1	23	0	0
5	13649518	.	C	T	18	17	35	0	1	36	0	0
5	13652410	.	T	C	14	18	32	0	2	34	0	0
5	13671624	.	G	T	11	10	21	0	1	22	0	0
5	13671631	.	A	C	10	9	19	0	2	21	0	0
5	13671899	.	C	G	16	21	37	0	1	38	0	0
5	13672004	.	C	T	3	23	26	0	23	49	0	0
5	13672211	.	C	T	20	26	46	0	2	48	0	0
5	13672232	.	C	T	34	17	51	0	3	54	0	0
5	13673016	.	C	G	6	15	21	0	26	47	0	0
5	13684132	.	A	G	27	17	44	0	1	45	0	0
5	13684502	.	C	A	10	25	35	0	27	62	0	0
5	13766188	.	A	T	15	9	24	0	0	24	0	0
5	13766276	.	A	G	12	12	24	1	1	26	0	0
5	13772666	.	T	C	27	19	46	1	3	50	0	0
5	13778659	.	G	T	25	24	49	0	0	49	0	0
5	13778663	.	C	T	25	23	48	0	0	48	0	0
5	13782325	.	T	C	29	11	40	1	2	43	0	0
5	13782786	.	C	A	13	6	19	1	1	21	0	0
5	13783350	.	C	A	2	4	6	0	0	6	0	0
5	13783377	.	A	G	3	3	6	0	0	6	0	0
5	13783391	.	G	A	2	3	5	0	0	5	0	0
5	13783516	.	A	C	8	19	27	0	1	28	0	0
5	13784243	.	T	A	13	17	30	0	0	30	0	0
5	13784486	.	G	T	12	8	20	0	0	20	0	0
5	13784559	.	T	A	6	13	19	2	1	22	0	0
5	13784914	.	G	T	5	4	9	0	1	10	0	0
5	13784916	.	C	T	6	4	10	0	0	10	0	0
5	13785289	.	T	C	13	0	13	3	6	22	0	0
5	13785304	.	A	G	15	5	20	3	1	24	0	0
5	13785326	.	A	G	11	8	19	3	3	25	0	0
5	13785441	.	A	G	8	14	22	0	1	23	0	0
5	13785485	.	T	C	11	0	11	0	6	17	0	0
5	13785490	.	G	A	8	6	14	0	1	15	0	0
5	13785522	.	T	C	8	7	15	0	4	19	0	0
5	13785677	.	T	C	20	0	20	0	9	29	0	0
5	13785735	.	C	T	20	10	30	0	3	33	0	0
5	13791984	.	G	A	15	11	26	0	4	30	0	0
5	13793333	.	T	C	14	13	27	0	0	27	0	0
5	13799613	.	G	A	16	11	27	0	2	29	0	0
5	13799635	.	C	T	10	11	21	0	6	27	0	0
5	13799704	.	G	A	13	15	28	0	1	29	0	0
5	13800062	.	C	T	10	7	17	0	1	18	0	0
5	13800170	.	C	A	8	9	17	0	0	17	0	0
5	13803960	.	C	T	4	9	13	0	2	15	0	0
5	13820304	.	C	T	15	13	28	0	1	29	0	0
5	13820457	.	G	A	7	12	19	0	0	19	0	0
5	13835410	.	T	A	4	2	6	0	0	6	0	0
5	13835462	.	T	G	4	3	7	0	0	7	0	0
5	13988382	.	C	T	2	3	5	0	0	5	0	0
5	14306793	.	G	T	19	14	33	0	2	35	0	0
5	14307459	.	G	A	13	9	22	0	1	23	0	0
5	14307720	.	C	T	11	16	27	0	0	27	0	0
5	14308394	.	A	C	16	0	16	0	0	16	0	0
5	14308710	.	A	G	13	13	26	0	1	27	0	0
5	14308773	.	G	A	14	11	25	0	0	25	0	0
5	14308792	.	C	A	15	12	27	0	2	29	0	0
5	14309073	.	T	C	10	4	14	0	1	15	0	0
5	14309219	.	A	G	8	7	15	0	1	16	0	0
5	14309334	.	C	T	0	9	9	0	10	19	0	0
5	14310874	.	T	A	18	16	34	0	3	38	1	0
5	14312030	.	C	T	3	15	18	0	15	34	1	0
5	14312091	.	G	A	15	13	28	0	1	29	0	0
5	14321243	.	G	A	6	12	18	0	0	18	0	0
5	14321336	.	G	A	6	13	19	0	0	19	0	0
5	14321393	.	C	T	7	13	20	0	0	20	0	0
5	14321438	.	A	G	8	11	19	0	1	20	0	0
5	14321488	.	G	A	13	8	21	0	0	21	0	0
5	14322022	.	C	T	15	12	27	0	0	27	0	0
5	14322037	.	C	T	15	12	27	0	0	27	0	0
5	14322212	.	C	T	17	9	26	0	4	30	0	0
5	14322269	.	T	C	6	10	16	0	2	18	0	0
5	14322433	.	A	T	15	13	28	0	2	30	0	0
5	14322647	.	C	T	10	5	15	0	0	15	0	0
5	14322898	.	T	G	13	23	36	0	1	37	0	0
5	14323082	.	A	T	13	9	22	0	1	23	0	0
5	14323934	.	T	C	10	5	15	0	0	15	0	0
5	14375330	.	T	A	3	2	5	0	1	6	0	0
5	14375529	.	A	G	15	10	25	0	2	27	0	0
5	14375598	.	A	G	12	17	29	0	1	30	0	0
5	14375623	.	A	G	12	20	32	0	0	32	0	0
5	14375881	.	T	C	13	8	21	0	0	21	0	0
5	14376155	.	A	G	18	18	36	1	2	39	0	0
5	14380632	.	C	T	18	15	33	0	0	33	0	0
5	14382534	.	C	G	10	22	32	0	0	33	1	0
5	14383193	.	G	A	22	12	34	0	0	34	0	0
5	14386045	.	T	A	12	12	24	0	0	24	0	0
5	14386277	.	A	G	11	17	28	0	1	29	0	0
5	14387338	.	G	A	19	11	30	0	1	31	0	0
5	14394466	.	A	G	19	20	39	0	1	40	0	0
5	14394515	.	G	A	16	20	36	0	2	38	0	0
5	14394872	.	T	A	15	17	32	0	3	35	0	0
5	14395430	.	G	A	11	16	27	0	1	28	0	0
5	14395664	.	G	A	25	19	44	0	1	45	0	0
5	14395697	.	G	A	20	16	36	0	1	37	0	0
5	14396030	.	C	T	13	7	20	0	0	20	0	0
5	14396438	.	C	G	2	19	21	0	23	44	0	0
5	14396609	.	T	C	4	9	13	0	0	13	0	0
5	14396783	.	C	T	12	12	24	0	1	25	0	0
5	14396876	.	C	T	13	11	24	0	1	25	0	0
5	14396893	.	G	T	10	14	24	0	0	25	1	0
5	14397231	.	T	A	10	11	21	0	0	21	0	0
5	14397232	.	G	T	10	10	20	0	1	21	0	0
5	14398364	.	C	T	9	6	15	0	2	17	0	0
5	14398876	.	A	T	8	9	17	0	0	17	0	0
5	14399766	.	G	C	5	7	12	0	0	12	0	0
5	14402108	.	C	T	8	8	16	0	0	16	0	0
5	14402144	.	C	T	3	11	14	0	5	19	0	0
5	14402848	.	C	T	8	6	14	0	0	14	0	0
5	14413810	.	A	G	8	8	16	0	0	16	0	0
5	14442388	.	C	T	0	5	5	0	8	13	0	0
5	14529221	.	C	T	2	11	13	0	25	38	0	0
5	14529450	.	C	T	16	10	26	0	0	26	0	0
5	14530091	.	T	G	17	12	29	0	2	31	0	0
5	14530346	.	C	T	12	5	17	0	2	19	0	0
5	14530457	.	G	A	10	8	18	0	0	18	0	0
5	14530511	.	T	C	5	16	21	0	1	22	0	0
5	14530571	.	A	G	13	10	23	0	0	23	0	0
5	14530595	.	C	T	13	13	26	0	0	26	0	0
5	14533937	.	C	T	0	12	12	0	9	21	0	0
5	14534025	.	G	A	12	11	23	0	0	23	0	0
5	14543331	.	G	A	11	17	28	0	1	29	0	0
5	14545814	.	C	T	2	10	12	0	14	26	0	0
5	14560993	.	G	A	10	12	22	0	3	25	0	0
5	14564831	.	G	A	11	12	23	0	1	24	0	0
5	14584305	.	G	A	15	9	24	0	1	25	0	0
5	14647979	.	T	C	12	10	22	0	0	22	0	0
5	14648272	.	G	A	3	3	6	0	0	6	0	0
5	15263332	.	A	G	1	2	3	0	0	3	0	0
5	15357517	.	A	G	4	8	12	0	1	13	0	0
5	15394285	.	G	T	10	11	21	0	0	21	0	0
5	15394354	.	G	A	15	12	27	0	0	27	0	0
5	15394357	.	A	G	15	12	27	0	0	27	0	0
5	15394396	.	C	T	1	10	11	0	12	23	0	0
5	15416836	.	T	A	7	3	10	0	0	10	0	0
5	15809754	.	C	T	2	3	5	0	1	6	0	0
5	15809903	.	C	T	4	9	13	0	0	13	0	0
5	15811149	.	A	G	5	2	7	0	1	8	0	0
5	15811534	.	A	G	2	2	4	0	1	5	0	0
5	15811705	.	A	G	5	2	7	0	0	7	0	0
5	16123097	.	A	T	1	4	5	0	0	5	0	0
5	16124919	.	C	T	1	6	7	0	0	7	0	0
5	16126203	.	C	T	5	4	9	0	0	9	0	0
5	16126392	.	G	A	1	3	4	0	0	4	0	0
5	16126440	.	T	C	1	3	4	0	0	4	0	0
5	16126762	.	C	A	4	3	7	0	0	7	0	0
5	16128798	.	C	T	8	4	12	0	0	12	0	0
5	16128841	.	G	A	6	5	11	0	0	11	0	0
5	16134766	.	C	T	0	3	3	0	5	8	0	0
5	16138840	.	G	C	4	5	9	0	0	9	0	0
5	16139401	.	G	A	5	2	7	0	0	7	0	0
5	16139451	.	A	G	5	3	8	0	0	8	0	0
5	16360785	.	G	A	4	2	6	0	0	6	0	0
5	16360826	.	C	T	2	2	4	0	0	4	0	0
5	16364074	.	T	C	1	2	3	0	0	3	0	0
5	16580961	.	C	A	2	3	5	0	0	5	0	0
5	16581381	.	C	T	2	2	4	1	0	5	0	0
5	16720830	.	G	A	11	9	20	0	1	21	0	0
5	16800437	.	A	G	10	14	24	0	0	24	0	0
5	16800710	.	T	C	23	0	23	0	15	38	0	0
5	16800955	.	C	T	2	15	17	0	6	23	0	0
5	16815222	.	C	G	13	15	28	0	1	29	0	0
5	16818828	.	G	A	17	15	32	0	2	34	0	0
5	16818858	.	T	G	17	12	29	0	1	30	0	0
5	16833631	.	A	G	9	5	14	0	1	15	0	0
5	16916446	.	T	C	15	11	26	0	0	26	0	0
5	16916476	.	G	A	17	11	28	0	0	28	0	0
5	16916575	.	T	C	12	14	26	0	1	27	0	0
5	16928099	.	T	C	14	1	15	0	14	29	0	0
5	16956501	.	G	A	14	15	29	0	1	30	0	0
5	16956615	.	C	T	15	15	30	0	0	30	0	0
5	16982624	.	G	A	14	11	25	0	1	26	0	0
5	16983206	.	C	T	14	6	20	0	2	22	0	0
5	17624676	.	G	A	0	8	8	0	7	15	0	0
5	17624944	.	G	T	2	4	6	0	0	6	0	0
5	17727417	.	C	A	17	15	32	0	1	33	0	0
5	17727421	.	A	C	15	14	29	0	3	32	0	0
5	17731592	.	C	A	10	4	14	0	6	20	0	0
5	17738720	.	G	A	1	10	11	0	11	22	0	0
5	17751119	.	G	A	12	6	18	0	4	22	0	0
5	17751681	.	G	A	1	18	19	0	13	32	0	0
5	17751894	.	A	T	18	19	37	0	3	40	0	0
5	17751939	.	A	G	24	18	42	0	0	42	0	0
5	17752545	.	A	G	21	17	38	0	1	39	0	0
5	17752702	.	C	T	12	11	23	0	1	24	0	0
5	17752778	.	A	T	6	6	12	0	0	12	0	0
5	17753214	.	G	A	1	6	7	0	3	10	0	0
5	17753216	.	G	A	2	7	9	0	1	10	0	0
5	17753529	.	A	T	12	10	22	0	0	22	0	0
5	17812618	.	G	A	2	2	4	0	0	4	0	0
5	17813051	.	T	G	2	2	4	0	0	4	0	0
5	17813181	.	C	T	5	3	8	0	0	8	0	0
5	17881715	.	A	C	3	2	5	0	0	5	0	0
5	17881851	.	A	T	3	2	5	0	0	5	0	0
5	17881995	.	A	T	4	3	7	0	0	7	0	0
5	17882282	.	T	A	2	2	4	0	2	6	0	0
5	17882291	.	C	T	4	4	8	0	0	8	0	0
5	17882438	.	G	A	6	5	11	0	0	11	0	0
5	17882454	.	G	A	8	6	14	0	0	14	0	0
5	17885194	.	T	C	10	0	10	0	4	14	0	0
5	17885287	.	A	C	3	6	9	0	0	9	0	0
5	17885863	.	G	A	7	6	13	0	1	14	0	0
5	17885902	.	G	A	4	9	13	0	0	13	0	0
5	17885920	.	C	T	6	5	11	0	0	11	0	0
5	17885995	.	A	G	7	6	13	0	2	15	0	0
5	17886028	.	T	G	9	6	15	0	1	16	0	0
5	17886039	.	G	T	9	7	16	0	0	16	0	0
5	17908986	.	C	T	1	2	3	0	1	4	0	0
5	18052799	.	G	A	1	8	9	0	0	9	0	0
5	18827368	.	T	C	6	11	17	0	0	17	0	0
5	18827701	.	T	C	9	0	9	0	3	12	0	0
5	19008335	.	A	G	24	11	35	1	8	44	0	0
5	19038145	.	G	A	1	8	9	0	0	9	0	0
5	19915511	.	C	T	9	2	11	0	0	11	0	0
5	20257270	.	G	T	3	2	5	1	0	6	0	0
5	20281149	.	T	C	1	2	3	0	0	3	0	0
5	20283504	.	T	A	2	5	7	0	0	7	0	0
5	20416565	.	G	C	1	8	9	0	6	15	0	0
5	20416618	.	A	T	8	4	12	0	0	12	0	0
5	20416958	.	T	C	7	6	13	0	0	13	0	0
5	20416976	.	C	T	3	2	5	0	2	7	0	0
5	20417018	.	A	C	4	6	10	0	0	10	0	0
5	20417099	.	T	C	10	6	16	0	0	16	0	0
5	20417180	.	G	A	0	11	11	0	12	23	0	0
5	20417274	.	G	A	2	10	12	0	6	18	0	0
5	20417399	.	G	C	2	9	11	0	1	12	0	0
5	20417405	.	C	G	2	9	11	0	1	12	0	0
5	20417515	.	T	C	9	8	17	0	0	17	0	0
5	20418151	.	C	T	1	2	3	0	0	3	0	0
5	20418175	.	T	G	1	2	3	0	0	3	0	0
5	20418958	.	A	T	6	6	12	0	0	12	0	0
5	20419008	.	A	T	12	8	20	0	1	21	0	0
5	20419078	.	C	T	10	0	10	0	1	11	0	0
5	20419087	.	A	G	8	5	13	0	0	13	0	0
5	20419563	.	A	C	4	4	8	0	0	8	0	0
5	20419613	.	G	A	6	5	11	0	0	11	0	0
5	20443949	.	A	G	4	4	8	0	2	10	0	0
5	20444017	.	G	T	10	12	22	0	1	23	0	0
5	20444216	.	G	C	21	24	45	0	1	46	0	0
5	20445065	.	G	A	12	18	30	0	0	30	0	0
5	20445985	.	A	T	20	25	45	0	1	46	0	0
5	20446021	.	T	A	13	13	26	0	0	26	0	0
5	20457291	.	T	C	6	16	22	0	0	22	0	0
5	20457390	.	C	T	9	18	27	0	1	28	0	0
5	20467641	.	A	G	8	14	22	0	0	22	0	0
5	20471875	.	G	C	11	15	26	0	1	27	0	0
5	20473812	.	A	G	7	0	7	0	18	25	0	0
5	20473818	.	G	A	0	13	13	0	10	23	0	0
5	20474076	.	A	G	11	17	28	0	2	30	0	0
5	20475730	.	A	G	12	13	25	0	0	25	0	0
5	20477419	.	T	C	16	21	37	0	1	38	0	0
5	20479921	.	C	A	7	10	17	0	0	17	0	0
5	20479990	.	A	G	6	7	13	0	0	13	0	0
5	20480036	.	A	T	5	8	13	0	0	13	0	0
5	20480758	.	T	A	12	13	25	0	2	27	0	0
5	20480867	.	C	T	6	10	16	0	1	17	0	0
5	20481132	.	G	A	7	5	12	0	3	15	0	0
5	20485754	.	G	A	2	6	8	0	0	8	0	0
5	20485769	.	T	C	2	4	6	0	0	6	0	0
5	20485863	.	A	C	1	5	6	0	1	7	0	0
5	20485896	.	T	C	1	2	3	0	1	4	0	0
5	20485912	.	G	T	2	2	4	0	1	5	0	0
5	20486442	.	T	A	5	3	8	0	0	8	0	0
5	20486444	.	A	T	6	2	8	0	0	8	0	0
5	20486485	.	G	A	4	5	9	0	0	9	0	0
5	20486727	.	G	T	9	4	13	0	1	14	0	0
5	20486746	.	A	G	6	7	13	0	1	14	0	0
5	20486866	.	T	C	1	2	3	0	0	3	0	0
5	20487175	.	A	G	16	5	21	0	1	22	0	0
5	20487328	.	G	A	8	8	16	0	1	17	0	0
5	20487379	.	G	A	7	5	12	0	1	13	0	0
5	20487433	.	C	T	2	4	6	0	2	8	0	0
5	20487490	.	A	G	4	2	6	0	1	7	0	0
5	20590725	.	C	T	0	2	2	0	0	2	0	0
5	20590730	.	T	C	1	2	3	0	0	3	0	0
5	20627301	.	G	A	6	3	9	0	3	12	0	0
5	20627556	.	G	T	2	4	6	0	0	6	0	0
5	20627569	.	A	G	2	4	6	0	0	6	0	0
5	20639285	.	C	G	0	5	5	0	2	7	0	0
5	20647434	.	A	G	1	4	5	0	1	6	0	0
5	20678070	.	T	C	1	5	6	0	1	7	0	0
5	20678159	.	T	C	4	0	4	0	3	7	0	0
5	20787190	.	T	C	7	5	12	0	0	12	0	0
5	20933332	.	T	C	7	0	7	8	38	53	0	0
5	21295883	.	G	A	7	7	14	1	2	17	0	0
5	21296027	.	T	C	11	0	11	0	10	21	0	0
5	21296298	.	C	G	12	9	21	0	0	21	0	0
5	21296363	.	T	C	19	0	19	0	7	26	0	0
5	21296527	.	A	G	13	16	29	0	0	29	0	0
5	21296693	.	G	T	19	19	38	0	2	40	0	0
5	21296720	.	T	A	17	11	28	0	1	29	0	0
5	21296822	.	T	C	16	11	27	0	0	27	0	0
5	21297014	.	A	G	11	19	30	0	1	31	0	0
5	21297188	.	A	T	15	15	30	0	0	30	0	0
5	21297320	.	G	A	11	13	24	0	2	26	0	0
5	21301127	.	A	G	10	6	16	0	1	17	0	0
5	21301232	.	C	A	0	8	8	0	11	19	0	0
5	21301322	.	T	C	5	8	13	0	1	14	0	0
5	21301424	.	T	C	16	1	17	0	15	32	0	0
5	21301445	.	A	G	17	17	34	0	0	34	0	0
5	21301871	.	G	A	5	11	16	0	0	16	0	0
5	21302012	.	A	G	11	17	28	0	0	28	0	0
5	21309754	.	T	C	12	0	12	0	15	27	0	0
5	21309886	.	G	A	16	13	29	0	1	30	0	0
5	21331520	.	C	T	9	6	15	0	0	15	0	0
5	21340998	.	A	G	9	5	14	1	0	15	0	0
5	21341060	.	A	T	9	12	21	0	0	21	0	0
5	21359091	.	C	T	1	15	16	1	10	27	0	0
5	21374171	.	C	T	6	4	10	0	0	10	0	0
5	21384089	.	C	T	0	9	9	0	7	16	0	0
5	21393534	.	A	G	3	2	5	0	0	5	0	0
5	21422329	.	A	G	11	8	19	0	0	19	0	0
5	21460199	.	G	A	7	3	10	0	0	10	0	0
5	21460310	.	G	A	13	10	23	0	1	24	0	0
5	21471337	.	C	T	3	9	12	0	6	18	0	0
5	22012345	.	T	C	6	2	8	0	0	8	0	0
5	22012459	.	T	C	7	4	11	0	1	12	0	0
5	22012895	.	T	C	5	3	8	0	0	8	0	0
5	22013352	.	C	T	2	3	5	0	2	7	0	0
5	22013412	.	G	A	4	5	9	0	0	9	0	0
5	22013511	.	A	T	6	6	12	0	0	12	0	0
5	22013581	.	G	A	6	3	9	0	1	10	0	0
5	22013658	.	G	A	13	8	21	0	1	22	0	0
5	22013712	.	A	G	11	11	22	0	0	22	0	0
5	22013913	.	C	T	4	4	8	0	1	9	0	0
5	22013966	.	A	G	2	3	5	0	1	6	0	0
5	22013985	.	T	C	3	0	3	0	5	8	0	0
5	22014023	.	T	C	1	0	1	0	5	6	0	0
5	22014062	.	C	T	5	4	9	0	0	9	0	0
5	22014560	.	C	G	5	6	11	0	0	11	0	0
5	22014589	.	G	A	10	7	17	0	0	17	0	0
5	22015364	.	A	T	2	5	7	0	0	7	0	0
5	22015496	.	G	A	7	4	11	0	0	11	0	0
5	22015568	.	A	C	2	5	7	0	0	7	0	0
5	22015583	.	G	A	4	4	8	0	0	8	0	0
5	22015952	.	T	C	7	7	14	0	2	16	0	0
5	22015991	.	G	A	8	7	15	0	0	15	0	0
5	22016003	.	A	G	9	7	16	0	0	16	0	0
5	22016668	.	G	A	3	3	6	0	0	6	0	0
5	22016771	.	T	C	2	3	5	0	0	5	0	0
5	22016831	.	T	C	4	2	6	0	1	7	0	0
5	22017104	.	T	C	8	0	8	0	5	13	0	0
5	22021447	.	A	T	2	4	6	0	0	6	0	0
5	22024022	.	A	G	4	5	9	0	0	9	0	0
5	22024040	.	A	C	3	3	6	0	1	7	0	0
5	22025729	.	C	A	1	8	9	0	4	13	0	0
5	22025891	.	C	T	5	2	7	0	0	7	0	0
5	22028901	.	G	C	1	2	3	0	0	3	0	0
5	22073813	.	C	T	2	2	4	0	0	4	0	0
5	22073989	.	A	T	18	15	33	0	1	34	0	0
5	22074040	.	C	T	16	14	30	0	2	33	1	0
5	22074118	.	A	T	15	15	30	0	0	30	0	0
5	22074132	.	T	C	11	17	28	0	0	28	0	0
5	22074376	.	C	T	3	17	20	0	23	43	0	0
5	22074407	.	C	T	16	18	34	0	1	35	0	0
5	22082786	.	T	C	17	16	33	0	1	34	0	0
5	22098739	.	C	T	8	8	16	0	1	17	0	0
5	22098790	.	G	A	0	7	7	0	5	12	0	0
5	22106043	.	C	G	10	0	10	0	11	21	0	0
5	22106168	.	T	G	9	1	10	0	12	22	0	0
5	22106174	.	T	C	9	13	22	0	0	22	0	0
5	22106264	.	T	C	8	5	13	0	1	14	0	0
5	22106347	.	A	G	8	6	14	0	0	14	0	0
5	22115256	.	G	A	9	6	15	0	1	16	0	0
5	22115277	.	A	G	6	6	12	0	2	14	0	0
5	22115319	.	C	T	6	2	8	0	1	9	0	0
5	22115579	.	A	G	4	4	8	0	0	8	0	0
5	22115821	.	A	C	2	9	11	0	0	11	0	0
5	22115915	.	G	T	3	6	9	0	0	9	0	0
5	22121467	.	G	A	3	9	12	0	2	14	0	0
5	22123288	.	G	T	6	6	12	0	2	14	0	0
5	22123557	.	G	A	6	2	8	0	0	8	0	0
5	22125222	.	G	A	4	4	8	0	0	8	0	0
5	22125248	.	G	A	5	3	8	0	0	8	0	0
5	22127703	.	T	A	5	7	12	0	1	13	0	0
5	22130671	.	A	G	4	7	11	0	0	11	0	0
5	22130791	.	G	C	3	3	6	0	0	6	0	0
5	22151549	.	A	G	1	0	1	0	4	5	0	0
5	22161350	.	T	C	2	10	12	0	0	12	0	0
5	22161359	.	T	C	2	11	13	0	0	13	0	0
5	22163437	.	C	T	10	11	21	0	0	21	0	0
5	22172613	.	T	A	8	4	12	0	3	15	0	0
5	22173409	.	G	A	5	5	10	0	0	10	0	0
5	22173691	.	T	A	10	9	19	0	1	20	0	0
5	22173875	.	T	G	11	1	12	0	4	16	0	0
5	22173999	.	C	T	2	5	7	0	2	9	0	0
5	22368805	.	A	G	2	2	4	0	0	4	0	0
5	22465140	.	A	G	9	10	19	0	0	19	0	0
5	22465152	.	A	C	8	7	15	0	2	17	0	0
5	22465206	.	A	G	8	9	17	0	3	20	0	0
5	22473572	.	T	C	7	14	21	0	2	23	0	0
5	22473746	.	C	T	18	17	35	0	2	37	0	0
5	22474043	.	A	T	18	13	31	0	1	32	0	0
5	22474151	.	G	A	13	17	30	0	0	30	0	0
5	22474349	.	A	G	19	22	41	0	1	42	0	0
5	22476208	.	G	A	11	11	22	0	2	24	0	0
5	22479469	.	C	T	15	13	28	0	1	29	0	0
5	22479571	.	T	C	14	0	14	0	17	31	0	0
5	22481954	.	A	G	16	10	26	0	1	27	0	0
5	22482071	.	T	C	11	13	24	0	2	26	0	0
5	22482875	.	A	G	8	8	16	0	0	16	0	0
5	22484165	.	G	C	13	10	23	0	2	25	0	0
5	22485748	.	T	C	13	11	24	0	2	26	0	0
5	22489258	.	A	G	11	10	21	0	2	23	0	0
5	22489369	.	A	G	26	13	39	0	2	41	0	0
5	22489390	.	G	A	19	14	33	0	3	36	0	0
5	22489501	.	G	A	18	16	34	0	1	35	0	0
5	22501577	.	G	A	24	12	36	0	2	38	0	0
5	22544064	.	C	T	1	3	4	0	0	4	0	0
5	22550983	.	G	A	12	5	17	0	2	19	0	0
5	22550990	.	A	G	15	5	20	0	1	21	0	0
5	22557201	.	T	C	14	10	24	0	0	24	0	0
5	22557626	.	T	G	8	16	24	0	1	25	0	0
5	22560446	.	G	A	6	11	17	0	0	17	0	0
5	22562118	.	A	G	6	11	17	0	0	17	0	0
5	22562154	.	T	C	13	0	13	0	10	23	0	0
5	22562177	.	T	A	19	12	31	0	0	31	0	0
5	22564829	.	G	A	4	7	11	0	0	11	0	0
5	22564843	.	G	A	3	5	8	0	0	8	0	0
5	22564997	.	G	T	2	6	8	0	0	8	0	0
5	22569353	.	G	T	10	11	21	0	0	21	0	0
5	22571595	.	C	A	7	9	16	0	0	16	0	0
5	22573616	.	T	C	12	0	12	0	9	21	0	0
5	22593801	.	A	G	7	16	23	0	1	24	0	0
5	22593877	.	G	A	20	14	34	0	2	36	0	0
5	22593882	.	T	A	21	14	35	0	1	36	0	0
5	22593930	.	A	G	19	16	35	0	0	35	0	0
5	22594126	.	G	A	17	8	25	3	0	28	0	0
5	22594145	.	G	T	21	6	27	0	0	27	0	0
5	22596067	.	T	C	14	19	33	0	1	34	0	0
5	22598531	.	C	G	13	20	33	0	0	34	1	0
5	22598746	.	G	A	9	21	30	0	0	30	0	0
5	22600498	.	A	C	11	1	12	0	9	21	0	0
5	22600552	.	A	G	15	12	27	0	0	27	0	0
5	22600579	.	A	G	14	8	22	0	0	22	0	0
5	22606101	.	A	T	4	2	6	0	0	6	0	0
5	22609837	.	T	C	20	6	26	0	2	28	0	0
5	22683531	.	C	T	17	9	26	0	0	26	0	0
5	22683556	.	G	A	11	10	21	1	1	23	0	0
5	22683732	.	G	T	15	19	34	0	1	35	0	0
5	22683836	.	G	A	15	7	22	0	0	22	0	0
5	22794448	.	C	T	3	3	6	0	0	6	0	0
5	22794499	.	A	G	4	2	6	0	0	6	0	0
5	22822569	.	C	T	9	5	14	0	1	15	0	0
5	22830639	.	A	T	8	9	17	0	0	17	0	0
5	22851915	.	T	A	9	4	13	0	0	13	0	0
5	22852200	.	C	T	7	10	17	0	0	17	0	0
5	22852263	.	G	A	4	7	11	0	3	14	0	0
5	22856713	.	C	T	0	12	12	0	12	24	0	0
5	22856788	.	T	G	1	0	1	0	11	12	0	0
5	22856939	.	T	G	16	13	29	0	0	29	0	0
5	22857069	.	T	G	15	12	27	0	0	27	0	0
5	22857109	.	G	A	9	14	23	0	2	25	0	0
5	22858028	.	A	G	6	9	15	0	0	15	0	0
5	22860557	.	C	T	4	8	12	0	0	12	0	0
5	22860577	.	C	T	0	9	9	0	4	13	0	0
5	22860626	.	T	C	3	0	3	0	9	12	0	0
5	22860897	.	A	G	4	4	8	0	1	9	0	0
5	22872067	.	A	C	13	13	26	0	0	26	0	0
5	22872627	.	A	T	27	18	45	0	0	45	0	0
5	22876443	.	T	A	13	14	27	0	2	29	0	0
5	22876475	.	G	T	14	13	27	0	0	27	0	0
5	22876587	.	G	A	19	19	38	0	1	39	0	0
5	22876890	.	A	G	20	19	39	0	0	39	0	0
5	22879260	.	T	C	19	12	31	0	1	32	0	0
5	22888231	.	G	A	12	17	29	0	2	31	0	0
5	22888369	.	G	A	13	28	41	0	1	43	1	0
5	22916732	.	A	G	6	7	13	0	0	13	0	0
5	22916789	.	G	A	4	7	11	0	0	11	0	0
5	22959404	.	A	T	1	2	3	0	0	3	0	0
5	22959422	.	C	G	1	2	3	0	0	3	0	0
5	22971270	.	G	A	6	38	44	0	43	87	0	0
5	22971463	.	T	C	29	38	67	0	3	70	0	0
5	22972573	.	A	G	19	28	47	0	0	47	0	0
5	22972597	.	A	C	13	26	39	0	3	43	1	0
5	22975295	.	A	G	3	2	5	0	1	6	0	0
5	22975308	.	G	C	2	2	4	0	0	4	0	0
5	22978543	.	A	G	1	0	1	0	5	6	0	0
5	22980250	.	G	A	6	1	7	0	1	8	0	0
5	22988785	.	A	G	7	4	11	0	1	12	0	0
5	22989109	.	A	G	4	0	4	0	5	9	0	0
5	22989148	.	T	C	7	6	13	0	0	13	0	0
5	22994447	.	A	G	1	3	4	0	0	4	0	0
5	23014929	.	C	T	3	4	7	0	1	8	0	0
5	23019939	.	G	A	1	11	12	0	2	14	0	0
5	23020075	.	G	C	7	5	12	0	1	13	0	0
5	23020084	.	C	T	7	6	13	0	1	14	0	0
5	23026604	.	G	A	21	21	42	0	0	42	0	0
5	23026779	.	C	T	17	27	44	0	0	44	0	0
5	23027597	.	G	C	15	14	29	0	0	29	0	0
5	23027642	.	A	C	15	18	33	0	2	35	0	0
5	23027770	.	T	C	12	17	29	0	2	31	0	0
5	23027937	.	C	T	18	15	33	0	3	36	0	0
5	23028131	.	C	A	7	5	12	0	2	14	0	0
5	23045605	.	G	T	6	10	16	0	1	17	0	0
5	23056697	.	A	G	12	7	19	0	1	20	0	0
5	23062252	.	A	G	1	0	1	0	2	3	0	0
5	23065556	.	T	C	1	3	4	0	0	4	0	0
5	23071329	.	T	G	2	3	5	0	0	5	0	0
5	23072356	.	G	T	0	2	2	0	2	4	0	0
5	23076015	.	C	T	2	4	6	0	0	6	0	0
5	23079094	.	A	G	4	11	15	0	0	15	0	0
5	23079272	.	A	G	3	5	8	0	0	8	0	0
5	23082105	.	C	A	2	8	10	0	0	10	0	0
5	23082128	.	T	C	3	5	8	0	1	9	0	0
5	23082721	.	C	T	2	6	8	0	1	9	0	0
5	23082845	.	G	A	2	4	6	0	0	6	0	0
5	23082847	.	T	A	2	4	6	0	0	6	0	0
5	23107927	.	C	T	6	5	11	0	2	13	0	0
5	23108019	.	G	A	10	15	25	0	1	26	0	0
5	23108042	.	T	A	9	13	22	0	3	25	0	0
5	23108128	.	G	A	25	24	49	0	0	49	0	0
5	23110281	.	A	G	19	11	30	0	0	30	0	0
5	23110311	.	C	T	18	13	31	0	0	31	0	0
5	23118253	.	A	T	12	16	28	0	2	30	0	0
5	23125545	.	G	A	11	15	26	0	0	26	0	0
5	23125555	.	C	T	11	14	25	0	1	26	0	0
5	23126065	.	C	T	20	16	36	0	1	37	0	0
5	23126431	.	C	T	13	9	22	0	1	23	0	0
5	23126464	.	T	G	6	1	7	0	13	20	0	0
5	23126500	.	G	A	9	15	24	0	1	25	0	0
5	23126677	.	C	G	17	13	30	0	2	32	0	0
5	23126856	.	C	G	14	17	31	0	0	31	0	0
5	23127025	.	C	T	12	17	29	0	2	31	0	0
5	23127376	.	T	C	19	21	40	0	2	42	0	0
5	23127418	.	C	T	19	24	43	0	1	44	0	0
5	23127451	.	A	G	23	20	43	0	1	44	0	0
5	23127946	.	T	G	41	18	59	0	1	60	0	0
5	23127979	.	A	G	21	17	38	0	8	46	0	0
5	23128135	.	T	C	19	18	37	0	1	38	0	0
5	23128651	.	A	C	16	19	35	0	1	36	0	0
5	23128696	.	T	A	17	10	27	0	1	28	0	0
5	23128714	.	C	A	16	13	29	0	1	30	0	0
5	23128957	.	T	C	15	8	23	0	1	24	0	0
5	23129161	.	C	T	14	24	38	0	2	40	0	0
5	23129902	.	G	T	14	9	23	0	2	25	0	0
5	23130629	.	T	C	21	18	39	0	1	40	0	0
5	23130970	.	C	T	15	15	30	0	0	30	0	0
5	23131106	.	G	C	19	21	40	0	2	42	0	0
5	23131147	.	T	C	22	22	44	0	0	44	0	0
5	23136584	.	T	C	6	5	11	0	0	11	0	0
5	23136635	.	G	A	15	16	31	0	3	34	0	0
5	23140527	.	T	G	15	20	35	0	1	36	0	0
5	23140548	.	A	G	18	0	18	0	18	36	0	0
5	23143454	.	G	T	17	14	31	0	0	31	0	0
5	23143725	.	A	G	10	0	10	0	22	32	0	0
5	23143755	.	C	T	10	21	31	0	1	32	0	0
5	23146414	.	T	C	13	23	36	0	3	39	0	0
5	23146537	.	G	A	1	11	12	2	17	31	0	0
5	23146576	.	T	A	20	18	38	0	0	38	0	0
5	23146790	.	G	T	19	15	34	0	1	35	0	0
5	23146897	.	T	G	11	7	18	0	1	19	0	0
5	23147007	.	A	T	5	3	8	0	0	8	0	0
5	23147008	.	T	A	5	3	8	0	0	8	0	0
5	23147118	.	C	A	7	6	13	0	1	14	0	0
5	23147127	.	T	C	9	6	15	0	0	15	0	0
5	23147185	.	T	A	14	12	26	0	0	26	0	0
5	23147479	.	C	G	7	11	18	0	0	18	0	0
5	23212042	.	T	C	2	4	6	0	0	6	0	0
5	23218683	.	T	C	6	2	8	0	1	9	0	0
5	23218785	.	T	C	2	2	4	0	0	4	0	0
5	23223647	.	T	A	4	6	10	0	0	10	0	0
5	23230692	.	C	T	6	5	11	0	0	11	0	0
5	23268370	.	A	C	28	37	65	0	6	71	0	0
5	23268371	.	C	A	27	37	64	0	6	70	0	0
5	23268542	.	T	G	43	31	74	0	21	97	2	0
5	23268785	.	C	G	42	67	109	0	6	115	0	0
5	23272981	.	T	G	43	46	89	0	2	92	1	0
5	23275945	.	G	A	39	31	70	0	2	72	0	0
5	23276037	.	G	A	32	31	63	0	2	65	0	0
5	23277139	.	G	A	34	41	75	0	8	84	1	0
5	23277816	.	C	A	27	27	54	0	1	55	0	0
5	23284014	.	T	C	13	7	20	0	2	22	0	0
5	23284867	.	A	G	13	12	25	0	0	25	0	0
5	23285133	.	T	C	11	17	28	0	1	29	0	0
5	23285206	.	G	A	26	16	42	0	2	44	0	0
5	23285546	.	A	G	21	31	52	0	0	52	0	0
5	23285554	.	A	G	23	29	52	0	1	53	0	0
5	23285611	.	G	A	30	30	60	0	3	63	0	0
5	23286004	.	A	G	30	30	60	0	1	61	0	0
5	23286280	.	A	G	24	23	47	0	0	47	0	0
5	23286361	.	A	G	24	26	50	0	2	52	0	0
5	23286376	.	G	A	26	25	51	0	0	51	0	0
5	23288545	.	A	G	15	19	34	0	0	34	0	0
5	23288560	.	C	T	17	16	33	0	1	34	0	0
5	23288653	.	G	A	16	6	22	0	1	23	0	0
5	23288710	.	T	C	16	0	16	0	16	32	0	0
5	23288725	.	C	T	18	17	35	0	0	35	0	0
5	23316807	.	C	T	24	16	40	0	1	41	0	0
5	23317367	.	C	T	12	8	20	0	1	21	0	0
5	23353648	.	A	G	23	26	49	0	4	53	0	0
5	23357357	.	T	A	3	7	10	0	0	10	0	0
5	23370824	.	T	C	20	14	34	1	1	36	0	0
5	23386277	.	C	T	13	15	28	0	1	29	0	0
5	23389025	.	C	T	1	13	14	0	21	35	0	0
5	23389190	.	A	G	20	14	34	0	1	35	0	0
5	23389268	.	G	A	15	13	28	0	1	29	0	0
5	23397221	.	T	C	20	16	36	0	0	36	0	0
5	23403173	.	T	C	21	20	41	1	0	42	0	0
5	23417421	.	G	C	10	21	31	0	0	31	0	0
5	23428594	.	C	T	2	20	22	0	12	34	0	0
5	23574916	.	T	C	2	4	6	0	0	6	0	0
5	23575646	.	T	C	4	6	10	0	0	10	0	0
5	23575679	.	T	C	3	0	3	0	3	6	0	0
5	23575683	.	T	C	5	2	7	0	1	8	0	0
5	24128962	.	G	C	9	9	18	0	0	18	0	0
5	24129047	.	A	T	6	16	22	0	0	22	0	0
5	24129122	.	C	T	9	7	16	2	0	18	0	0
5	24130706	.	T	C	8	16	24	0	0	24	0	0
5	24130715	.	C	T	7	18	25	0	1	26	0	0
5	24130809	.	C	T	18	17	35	0	1	36	0	0
5	24131320	.	A	C	18	10	28	0	0	29	1	0
5	24131611	.	A	G	22	15	37	0	1	38	0	0
5	24132457	.	G	A	5	12	17	0	0	17	0	0
5	24132615	.	T	C	8	9	17	0	0	17	0	0
5	24133732	.	G	A	2	17	19	0	17	36	0	0
5	24134952	.	A	T	11	14	25	0	0	25	0	0
5	24134997	.	A	T	13	10	23	0	1	24	0	0
5	24135361	.	G	T	3	14	17	0	12	30	1	0
5	24138964	.	G	A	10	12	22	0	1	23	0	0
5	24147460	.	C	T	12	10	22	0	2	24	0	0
5	24147508	.	C	G	11	8	19	0	1	20	0	0
5	24147529	.	A	G	10	8	18	0	2	20	0	0
5	24148419	.	T	G	9	8	17	0	1	18	0	0
5	24148431	.	C	T	10	7	17	0	1	18	0	0
5	24153202	.	C	T	0	14	14	0	7	21	0	0
5	24153253	.	G	C	5	11	16	0	0	16	0	0
5	24153289	.	T	C	6	0	6	0	14	20	0	0
5	24153331	.	T	C	13	0	13	0	9	22	0	0
5	24153403	.	C	T	9	10	19	0	0	19	0	0
5	24153441	.	T	C	8	9	17	0	2	19	0	0
5	24153523	.	T	G	13	6	19	0	0	19	0	0
5	24153524	.	C	T	1	6	7	0	12	19	0	0
5	24153887	.	C	T	1	10	11	0	9	20	0	0
5	24156193	.	G	A	2	9	11	0	3	14	0	0
5	24157083	.	C	T	1	5	6	0	1	7	0	0
5	24162191	.	T	G	5	6	11	0	0	11	0	0
5	24163000	.	T	A	5	5	10	0	1	11	0	0
5	24163059	.	A	G	4	2	6	0	0	6	0	0
5	24163143	.	A	C	3	2	5	0	0	5	0	0
5	24163289	.	A	G	4	3	7	0	0	7	0	0
5	24163437	.	T	A	1	2	3	0	0	3	0	0
5	24184011	.	G	A	2	2	4	0	0	4	0	0
5	24184030	.	A	G	3	3	6	0	0	6	0	0
5	24184052	.	A	T	3	2	5	0	0	5	0	0
5	24199739	.	T	C	4	11	15	0	1	16	0	0
5	24199757	.	T	A	3	13	16	0	0	16	0	0
5	24199987	.	C	A	7	4	11	0	1	12	0	0
5	24200017	.	C	A	10	4	14	0	0	14	0	0
5	24200592	.	G	A	14	5	19	0	0	19	0	0
5	24200611	.	G	A	15	5	20	0	0	20	0	0
5	24201232	.	G	T	8	3	11	0	0	11	0	0
5	24208781	.	G	C	34	24	58	2	1	61	0	0
5	24208900	.	G	C	16	0	16	0	27	44	1	0
5	24209088	.	C	T	21	13	34	0	1	35	0	0
5	24209293	.	A	T	25	29	54	0	4	58	0	0
5	24209460	.	A	G	35	28	63	0	0	63	0	0
5	24213273	.	T	G	31	29	60	0	2	62	0	0
5	24213291	.	T	C	34	2	36	0	30	66	0	0
5	24223858	.	T	G	5	9	14	0	0	14	0	0
5	24223890	.	G	T	8	9	17	0	0	17	0	0
5	24227532	.	A	G	11	7	18	0	1	19	0	0
5	24227658	.	C	T	4	7	11	0	0	11	0	0
5	24227700	.	T	C	3	12	15	0	0	15	0	0
5	24230996	.	C	T	1	7	8	0	5	13	0	0
5	24231082	.	T	C	7	5	12	0	1	13	0	0
5	24240491	.	C	T	2	7	9	0	0	9	0	0
5	24240586	.	A	T	7	4	11	0	1	12	0	0
5	24240932	.	T	C	8	7	15	0	0	15	0	0
5	24240968	.	T	A	11	8	19	0	0	19	0	0
5	24244891	.	G	T	6	3	9	0	0	9	0	0
5	24244952	.	G	T	3	6	9	0	0	9	0	0
5	24245085	.	T	A	6	3	9	0	0	9	0	0
5	24252744	.	A	G	32	14	46	0	4	50	0	0
5	24256387	.	G	A	26	31	57	0	2	59	0	0
5	24259642	.	A	G	29	3	32	0	23	55	0	0
5	24288003	.	T	C	2	3	5	0	0	5	0	0
5	24288404	.	A	G	1	5	6	0	0	6	0	0
5	24291504	.	C	T	3	3	6	0	0	6	0	0
5	24294152	.	A	T	1	2	3	0	0	3	0	0
5	24330492	.	A	G	9	3	12	0	2	14	0	0
5	24330527	.	T	C	9	0	9	0	3	12	0	0
5	24330840	.	G	T	8	13	21	0	2	23	0	0
5	24330932	.	C	A	9	12	21	0	1	22	0	0
5	24331724	.	G	C	12	13	25	0	0	25	0	0
5	24331840	.	T	A	9	9	18	0	1	19	0	0
5	24332216	.	T	G	5	10	15	0	0	15	0	0
5	24333135	.	C	T	7	11	18	0	1	19	0	0
5	24333612	.	C	G	3	5	8	0	0	8	0	0
5	24511111	.	C	T	2	22	24	0	12	36	0	0
5	24511748	.	G	A	6	6	12	0	0	12	0	0
5	24513193	.	G	A	16	10	26	0	0	26	0	0
5	24516819	.	A	G	19	9	28	0	1	29	0	0
5	24521408	.	A	G	11	3	14	0	0	14	0	0
5	24521812	.	G	A	11	9	20	0	0	20	0	0
5	24522206	.	A	T	22	16	38	1	1	40	0	0
5	24530663	.	A	T	6	17	23	0	2	26	1	0
5	24530821	.	T	G	10	1	11	0	9	20	0	0
5	24530853	.	C	T	12	7	19	0	3	22	0	0
5	24531370	.	C	T	7	6	13	0	9	22	0	0
5	24531538	.	T	G	15	11	26	0	1	27	0	0
5	24531854	.	A	T	2	6	8	0	1	9	0	0
5	24532661	.	T	C	1	0	1	0	7	8	0	0
5	24535171	.	C	A	2	3	5	0	0	5	0	0
5	24535421	.	G	T	3	3	6	0	0	6	0	0
5	24542490	.	G	A	5	2	7	0	0	7	0	0
5	24547634	.	C	T	0	1	1	0	2	3	0	0
5	24566917	.	A	G	4	4	8	0	0	8	0	0
5	24567269	.	A	T	1	4	5	0	0	5	0	0
5	24567297	.	C	T	3	3	6	0	0	6	0	0
5	24567351	.	G	A	1	1	2	0	5	7	0	0
5	24567412	.	A	G	4	2	6	0	0	6	0	0
5	24578500	.	C	A	0	7	7	0	9	16	0	0
5	24584547	.	C	T	10	12	22	0	0	22	0	0
5	24596078	.	G	C	11	0	11	0	15	26	0	0
5	24596080	.	C	T	1	13	14	0	12	26	0	0
5	24665621	.	C	T	3	4	7	0	1	8	0	0
5	24665647	.	C	T	4	2	6	0	0	6	0	0
5	24665678	.	G	A	1	2	3	0	0	3	0	0
5	24712264	.	G	A	5	2	7	0	0	7	0	0
5	24756844	.	G	A	5	16	21	0	5	26	0	0
5	24756845	.	A	G	10	12	22	0	4	26	0	0
5	24756967	.	A	T	18	18	36	1	1	38	0	0
5	24757494	.	A	C	5	7	12	0	0	12	0	0
5	24757497	.	C	A	5	7	12	0	0	12	0	0
5	24757561	.	A	T	8	10	18	0	0	18	0	0
5	24757656	.	A	G	8	9	17	0	1	18	0	0
5	24757748	.	T	A	6	4	10	0	2	12	0	0
5	24757916	.	G	A	15	18	33	0	1	34	0	0
5	24757952	.	A	T	16	10	26	0	0	26	0	0
5	24757976	.	G	A	13	15	28	0	1	29	0	0
5	24758013	.	C	T	3	18	21	0	15	36	0	0
5	24768725	.	A	G	21	12	33	0	1	34	0	0
5	24772801	.	C	T	21	10	31	1	1	33	0	0
5	24778244	.	A	G	16	10	26	0	1	27	0	0
5	24790326	.	C	A	8	7	15	0	1	16	0	0
5	24790335	.	C	T	0	8	8	0	8	16	0	0
5	24796678	.	G	A	11	7	18	0	0	18	0	0
5	24800407	.	T	C	6	6	12	0	2	14	0	0
5	24803418	.	A	G	7	6	13	0	0	13	0	0
5	24805457	.	A	G	3	3	6	0	1	7	0	0
5	24816788	.	A	T	2	3	5	0	1	6	0	0
5	24816838	.	G	T	6	2	8	0	0	8	0	0
5	24816854	.	T	A	3	6	9	0	1	10	0	0
5	24817014	.	C	G	17	9	26	0	0	26	0	0
5	24817142	.	A	T	6	7	13	0	0	13	0	0
5	24817445	.	A	G	11	11	22	1	0	23	0	0
5	24817450	.	T	C	10	11	21	1	1	23	0	0
5	24817674	.	T	C	10	6	16	0	0	16	0	0
5	24817947	.	C	T	7	5	12	0	2	14	0	0
5	24818475	.	T	C	7	3	10	0	1	11	0	0
5	24818529	.	T	C	8	4	12	0	0	12	0	0
5	24818564	.	T	C	8	7	15	0	1	16	0	0
5	24818955	.	T	C	1	5	6	0	0	6	0	0
5	24826299	.	G	A	8	9	17	0	1	18	0	0
5	24826464	.	C	T	2	8	10	0	14	24	0	0
5	24875097	.	T	A	21	16	37	7	0	44	0	0
5	24875494	.	A	G	17	14	31	2	1	34	0	0
5	24878138	.	C	T	18	6	24	11	1	36	0	0
5	24886066	.	T	C	7	5	12	0	0	12	0	0
5	24886291	.	G	T	2	4	6	0	0	6	0	0
5	24887238	.	G	C	2	4	6	0	0	6	0	0
5	24887340	.	C	T	2	4	6	0	4	10	0	0
5	24887472	.	T	G	8	4	12	0	0	12	0	0
5	24887541	.	G	T	9	14	23	0	2	25	0	0
5	24887707	.	C	T	9	14	23	2	0	25	0	0
5	24887828	.	A	G	10	4	14	1	1	16	0	0
5	24887830	.	T	A	9	4	13	1	2	16	0	0
5	24896837	.	C	T	7	9	16	0	0	16	0	0
5	24909161	.	C	T	2	6	8	0	3	11	0	0
5	24997236	.	C	T	1	8	9	0	4	13	0	0
5	25047223	.	T	C	3	5	8	0	1	9	0	0
5	25047527	.	G	A	2	2	4	0	0	4	0	0
5	25048598	.	C	T	5	2	7	0	0	7	0	0
5	25052995	.	G	A	7	4	11	0	0	11	0	0
5	25055473	.	C	T	3	2	5	0	0	5	0	0
5	25059369	.	T	C	1	2	3	0	0	3	0	0
5	25074812	.	C	T	11	12	23	0	0	23	0	0
5	25074917	.	C	T	7	13	20	0	0	20	0	0
5	25075040	.	G	A	3	4	7	0	2	9	0	0
5	25077434	.	T	C	1	0	1	0	2	3	0	0
5	25077792	.	G	A	6	8	14	0	1	15	0	0
5	25082805	.	C	T	0	2	2	0	1	3	0	0
5	25083986	.	G	A	3	3	6	0	0	6	0	0
5	25084459	.	A	T	1	2	3	0	0	3	0	0
5	25085617	.	A	G	1	2	3	0	0	3	0	0
5	25088966	.	T	G	7	18	25	1	0	27	1	0
5	25089174	.	A	G	16	7	23	0	2	25	0	0
5	25089212	.	C	T	1	16	17	0	11	28	0	0
5	25094191	.	G	A	15	16	31	0	0	31	0	0
5	25094203	.	G	T	14	16	30	0	2	32	0	0
5	25100142	.	C	T	15	13	28	0	4	32	0	0
5	25100473	.	C	T	2	15	17	0	11	28	0	0
5	25100494	.	G	A	13	11	24	1	1	26	0	0
5	25101971	.	G	A	9	20	29	0	1	30	0	0
5	25102013	.	A	G	18	19	37	0	3	40	0	0
5	25102025	.	C	A	19	18	37	0	3	40	0	0
5	25104670	.	G	A	19	16	35	0	0	35	0	0
5	25104733	.	C	A	15	14	29	0	1	30	0	0
5	25104945	.	G	A	20	16	36	0	0	36	0	0
5	25107035	.	T	C	16	0	16	0	10	27	1	0
5	25115171	.	T	A	13	8	21	0	3	24	0	0
5	25118134	.	C	G	13	13	26	0	1	27	0	0
5	25119495	.	T	C	10	0	10	0	10	20	0	0
5	25119519	.	G	A	8	9	17	0	0	17	0	0
5	25121240	.	G	A	7	4	11	0	0	11	0	0
5	25122848	.	T	C	8	7	15	0	3	18	0	0
5	25122851	.	A	G	9	10	19	0	0	19	0	0
5	25129252	.	A	G	5	4	9	0	0	9	0	0
5	25129312	.	C	T	0	8	8	0	8	16	0	0
5	25129378	.	T	C	10	0	10	0	12	22	0	0
5	25129690	.	C	T	8	9	17	0	0	17	0	0
5	25141739	.	C	T	4	10	14	0	0	14	0	0
5	25141763	.	C	T	4	8	12	0	0	12	0	0
5	25141784	.	A	G	5	6	11	0	0	11	0	0
5	25143264	.	G	A	4	2	6	0	0	6	0	0
5	25143277	.	A	C	6	4	10	0	0	10	0	0
5	25156822	.	C	T	10	5	15	0	1	16	0	0
5	25156846	.	G	C	6	0	6	0	3	9	0	0
5	25163928	.	G	A	7	4	11	0	0	11	0	0
5	25166506	.	C	T	0	4	4	0	3	7	0	0
5	25236262	.	C	T	7	3	10	0	0	10	0	0
5	25308490	.	T	C	1	2	3	0	0	3	0	0
5	25311388	.	T	A	5	9	14	0	0	14	0	0
5	25311468	.	T	C	4	4	8	0	1	9	0	0
5	25311636	.	G	A	0	5	5	0	4	9	0	0
5	25314181	.	C	G	7	9	16	0	0	16	0	0
5	25314213	.	G	A	7	4	11	0	1	12	0	0
5	25369610	.	C	A	7	6	13	0	1	14	0	0
5	25369772	.	A	G	4	4	8	0	0	8	0	0
5	25372429	.	C	T	1	6	7	0	3	10	0	0
5	25376277	.	G	T	12	8	20	0	1	21	0	0
5	25376283	.	G	T	11	8	19	0	0	19	0	0
5	25536786	.	G	A	1	4	5	0	1	6	0	0
5	25537107	.	A	G	3	2	5	0	0	5	0	0
5	25537398	.	T	A	7	2	9	0	0	9	0	0
5	25571629	.	G	A	7	6	13	0	1	14	0	0
5	25607175	.	T	G	2	2	4	0	1	5	0	0
5	25613887	.	A	G	2	2	4	0	0	4	0	0
5	25613899	.	G	A	3	2	5	0	0	5	0	0
5	25613922	.	T	C	2	0	2	0	3	5	0	0
5	25683970	.	C	A	15	14	29	0	1	30	0	0
5	25693229	.	C	T	6	7	13	0	1	14	0	0
5	25693550	.	C	A	7	4	11	0	1	12	0	0
5	25693551	.	G	A	4	9	13	0	0	13	0	0
5	25693790	.	T	C	13	18	31	0	1	32	0	0
5	25722644	.	A	G	2	3	5	0	0	5	0	0
5	25722927	.	C	G	3	4	7	0	0	7	0	0
5	25726755	.	C	T	4	4	8	0	0	8	0	0
5	25726813	.	T	A	4	4	8	0	2	10	0	0
5	25726838	.	T	G	3	9	12	0	0	12	0	0
5	25726882	.	T	C	11	0	11	0	5	16	0	0
5	25727267	.	T	C	4	3	7	1	0	8	0	0
5	25728393	.	C	A	2	2	4	0	0	4	0	0
5	25728424	.	T	C	2	2	4	0	0	4	0	0
5	25728428	.	C	T	3	2	5	0	0	5	0	0
5	25729900	.	C	T	0	3	3	0	5	8	0	0
5	25733877	.	T	C	5	15	20	0	1	21	0	0
5	25750414	.	C	T	9	5	14	0	0	14	0	0
5	25753013	.	A	G	4	1	5	0	6	11	0	0
5	25753265	.	C	A	9	9	18	0	0	18	0	0
5	25753410	.	G	A	0	2	2	0	2	4	0	0
5	25753990	.	G	A	10	6	16	0	0	16	0	0
5	25754054	.	T	C	9	9	18	0	0	18	0	0
5	25754092	.	T	C	10	8	18	0	0	18	0	0
5	25754231	.	T	A	3	5	8	0	0	9	1	0
5	25754277	.	A	G	2	5	7	0	0	7	0	0
5	25754913	.	T	C	10	5	15	0	0	15	0	0
5	25755051	.	G	A	2	11	13	0	0	13	0	0
5	25801829	.	C	A	1	2	3	0	0	3	0	0
5	25955323	.	G	C	0	3	3	0	7	10	0	0
5	25962593	.	C	T	5	2	7	0	0	7	0	0
5	26026525	.	C	T	8	6	14	0	0	14	0	0
5	26036099	.	T	C	5	5	10	0	0	10	0	0
5	26036192	.	A	T	4	2	6	0	1	7	0	0
5	26050872	.	C	T	1	5	6	0	0	6	0	0
5	26060141	.	C	T	6	6	12	0	1	13	0	0
5	26061919	.	G	A	6	5	11	0	0	11	0	0
5	26062514	.	A	G	9	6	15	0	0	15	0	0
5	26062532	.	A	G	7	10	17	0	0	17	0	0
5	26062888	.	A	G	10	4	14	0	0	14	0	0
5	26075235	.	T	A	2	3	5	0	0	5	0	0
5	26075722	.	A	C	6	6	12	0	0	12	0	0
5	26075740	.	C	A	10	5	15	0	0	15	0	0
5	26077498	.	A	T	9	7	16	0	1	17	0	0
5	26077504	.	G	T	0	5	5	0	10	15	0	0
5	26077666	.	C	T	4	5	9	0	0	9	0	0
5	26077692	.	A	G	5	7	12	0	0	12	0	0
5	26077762	.	A	T	2	11	13	0	0	13	0	0
5	26077892	.	T	A	5	8	13	0	0	13	0	0
5	26077909	.	G	T	10	4	14	0	0	14	0	0
5	26082485	.	G	T	17	14	31	0	1	32	0	0
5	26082537	.	T	A	14	20	34	0	2	36	0	0
5	26092042	.	G	A	20	18	38	0	2	40	0	0
5	26093962	.	A	T	12	19	31	0	3	34	0	0
5	26101020	.	C	T	0	2	2	0	4	6	0	0
5	26101332	.	T	C	4	12	16	0	0	16	0	0
5	26101353	.	C	T	2	11	13	0	0	13	0	0
5	26102254	.	G	A	10	6	16	0	0	16	0	0
5	26102258	.	G	C	6	8	14	0	1	15	0	0
5	26102365	.	A	G	4	7	11	0	1	12	0	0
5	26102370	.	C	G	8	4	12	0	0	12	0	0
5	26102421	.	T	C	2	4	6	0	0	6	0	0
5	26102692	.	G	C	5	6	11	0	0	11	0	0
5	26102909	.	T	G	3	7	10	0	0	10	0	0
5	26102973	.	A	G	2	11	13	0	0	13	0	0
5	26103162	.	A	G	5	5	10	0	0	10	0	0
5	26103388	.	A	G	2	2	4	0	1	5	0	0
5	26103521	.	A	C	9	5	14	0	1	15	0	0
5	26103601	.	T	C	4	2	6	0	0	6	0	0
5	26109318	.	C	T	6	5	11	0	0	11	0	0
5	26109349	.	A	G	8	3	11	0	0	11	0	0
5	26135751	.	A	G	1	0	1	0	3	4	0	0
5	26135879	.	G	T	2	2	4	0	0	4	0	0
5	26135927	.	G	A	1	2	3	0	2	5	0	0
5	26142660	.	C	G	1	3	4	0	0	4	0	0
5	26158745	.	C	G	3	0	3	0	4	7	0	0
5	26158753	.	G	C	5	3	8	0	0	8	0	0
5	26159245	.	G	A	0	3	3	0	1	4	0	0
5	26159387	.	C	T	5	2	7	0	0	7	0	0
5	26159543	.	G	A	1	3	4	0	0	4	0	0
5	26165257	.	C	A	3	3	6	0	1	7	0	0
5	26167933	.	G	A	6	5	11	0	0	11	0	0
5	26168049	.	C	A	4	2	6	0	0	6	0	0
5	26168758	.	A	T	3	2	5	0	0	5	0	0
5	26168782	.	G	A	2	2	4	0	0	4	0	0
5	26170087	.	G	T	1	2	3	0	1	4	0	0
5	26189514	.	C	A	0	2	2	0	3	5	0	0
5	26194287	.	C	T	3	4	7	0	0	7	0	0
5	26200679	.	T	G	14	7	21	0	1	22	0	0
5	26200802	.	T	C	12	8	20	0	0	20	0	0
5	26202863	.	T	A	5	4	9	0	0	9	0	0
5	26202898	.	T	C	5	3	8	0	1	9	0	0
5	26202914	.	T	A	6	2	8	0	2	10	0	0
5	26224496	.	G	A	1	2	3	0	0	3	0	0
5	26227758	.	C	T	6	3	9	0	0	9	0	0
5	26232765	.	G	C	3	6	9	0	0	9	0	0
5	26232790	.	A	T	1	4	5	0	0	5	0	0
5	26234758	.	G	A	2	6	8	0	0	8	0	0
5	26234797	.	C	T	5	6	11	0	0	11	0	0
5	26234819	.	C	T	0	5	5	0	4	9	0	0
5	26235098	.	T	C	3	6	9	0	0	9	0	0
5	26235156	.	A	G	3	3	6	0	1	7	0	0
5	26235183	.	C	T	0	3	3	0	6	9	0	0
5	26236243	.	C	T	2	5	7	0	0	7	0	0
5	26241449	.	C	G	0	4	4	0	1	5	0	0
5	26244132	.	G	A	1	4	5	0	0	5	0	0
5	26263562	.	T	A	20	22	42	0	0	42	0	0
5	26274540	.	C	T	0	18	18	0	11	29	0	0
5	26274582	.	C	T	12	17	29	0	3	32	0	0
5	26281262	.	G	T	21	16	37	0	0	37	0	0
5	26281331	.	T	C	16	0	16	0	13	29	0	0
5	26322742	.	C	T	8	14	22	0	0	22	0	0
5	26330230	.	T	A	15	19	34	0	2	36	0	0
5	26334568	.	G	A	13	8	21	1	1	23	0	0
5	26355982	.	C	T	13	16	29	0	0	29	0	0
5	26356000	.	G	C	15	14	29	0	0	29	0	0
5	26356051	.	C	T	0	14	14	0	10	24	0	0
5	26387686	.	G	A	24	15	39	0	0	39	0	0
5	26493095	.	A	G	2	9	11	0	0	11	0	0
5	26493185	.	G	A	7	6	13	0	0	13	0	0
5	26566397	.	C	T	7	6	13	2	2	17	0	0
5	26697420	.	A	G	4	7	11	0	0	11	0	0
5	26721436	.	A	T	5	2	7	0	1	8	0	0
5	26721601	.	T	C	4	2	6	0	1	7	0	0
5	26721659	.	A	G	3	3	6	0	0	6	0	0
5	26721663	.	A	G	2	3	5	0	0	5	0	0
5	26721787	.	C	T	1	3	4	0	0	4	0	0
5	26721872	.	T	A	6	0	6	0	0	6	0	0
5	26721966	.	T	G	5	3	8	0	0	8	0	0
5	26722268	.	T	G	4	3	7	0	0	7	0	0
5	26722361	.	T	C	5	3	8	0	0	8	0	0
5	26750165	.	A	T	4	2	6	0	0	6	0	0
5	26750291	.	C	A	4	8	12	0	1	13	0	0
5	26756338	.	C	T	3	4	7	0	0	7	0	0
5	26756560	.	A	G	4	2	6	0	0	6	0	0
5	26756863	.	A	G	1	2	3	0	0	3	0	0
5	26787426	.	A	G	8	8	16	0	2	18	0	0
5	26789576	.	T	C	5	4	9	0	0	9	0	0
5	26790133	.	C	T	3	5	8	0	0	8	0	0
5	26790339	.	T	C	5	7	12	0	1	13	0	0
5	26790342	.	C	A	4	8	12	0	0	12	0	0
5	26793573	.	G	C	9	6	15	0	0	15	0	0
5	26793625	.	T	A	6	6	12	0	1	13	0	0
5	26795584	.	G	A	2	1	3	0	1	4	0	0
5	26798713	.	C	T	7	3	10	0	0	10	0	0
5	26802371	.	G	A	0	3	3	0	2	5	0	0
5	26802968	.	G	A	2	5	7	0	2	9	0	0
5	26805115	.	G	A	1	6	7	0	0	7	0	0
5	26805168	.	G	A	4	2	6	0	0	6	0	0
5	26805746	.	G	T	4	2	6	0	0	6	0	0
5	26805748	.	C	A	3	2	5	0	0	5	0	0
5	26805952	.	G	T	2	1	3	0	0	3	0	0
5	26805961	.	T	A	3	2	5	0	0	5	0	0
5	26806240	.	C	T	8	6	14	0	1	15	0	0
5	26806262	.	G	A	0	8	8	0	5	13	0	0
5	26807122	.	A	C	6	4	10	0	1	11	0	0
5	26809221	.	C	T	7	11	18	0	0	18	0	0
5	26814159	.	G	A	0	8	8	0	11	19	0	0
5	26814171	.	C	T	9	9	18	0	1	19	0	0
5	26816779	.	G	A	2	8	10	0	23	34	1	0
5	26823191	.	G	A	17	10	27	0	0	27	0	0
5	26823636	.	C	G	19	11	30	0	1	31	0	0
5	26850037	.	A	C	3	3	6	0	0	6	0	0
5	26851902	.	T	A	2	5	7	0	0	7	0	0
5	26856272	.	C	T	4	7	11	0	0	11	0	0
5	26856339	.	C	A	8	4	12	0	0	12	0	0
5	26858053	.	G	A	1	8	9	0	3	12	0	0
5	26858086	.	C	T	5	5	10	0	1	11	0	0
5	26859409	.	C	A	1	3	4	0	0	4	0	0
5	26859778	.	G	A	3	6	9	0	0	9	0	0
5	26862098	.	C	T	2	7	9	0	0	9	0	0
5	26862176	.	T	C	4	4	8	0	0	8	0	0
5	26864939	.	G	T	5	3	8	0	0	8	0	0
5	26864948	.	C	T	4	2	6	0	1	7	0	0
5	26865204	.	A	T	2	5	7	0	1	8	0	0
5	26865257	.	T	C	4	2	6	0	1	7	0	0
5	26865334	.	G	A	1	2	3	0	0	3	0	0
5	26865900	.	G	A	0	8	8	0	8	16	0	0
5	26865914	.	T	G	10	5	15	0	0	15	0	0
5	26866118	.	T	A	5	3	8	0	0	8	0	0
5	26866123	.	T	C	6	3	9	0	0	9	0	0
5	26866284	.	A	G	2	3	5	0	0	5	0	0
5	26866435	.	T	A	6	5	11	0	0	11	0	0
5	26867065	.	T	A	5	4	9	0	0	9	0	0
5	26867066	.	A	T	5	4	9	0	0	9	0	0
5	26867151	.	G	A	6	6	12	0	1	13	0	0
5	26867240	.	G	C	1	6	7	0	0	7	0	0
5	26867252	.	G	A	0	4	4	0	2	6	0	0
5	26867482	.	G	T	10	5	15	0	1	16	0	0
5	26867516	.	C	A	6	9	15	0	0	15	0	0
5	26868133	.	A	G	3	6	9	0	0	9	0	0
5	26868223	.	T	C	5	2	7	0	0	7	0	0
5	26868351	.	C	A	7	4	11	0	0	11	0	0
5	26869044	.	G	C	10	6	16	0	1	17	0	0
5	26870057	.	G	C	3	2	5	0	0	5	0	0
5	26870071	.	A	G	3	1	4	0	1	5	0	0
5	26884809	.	C	T	4	4	8	0	1	9	0	0
5	26884825	.	A	G	3	4	7	0	1	8	0	0
5	26884861	.	C	T	2	4	6	0	0	6	0	0
5	26885199	.	A	G	4	3	7	0	0	7	0	0
5	26887993	.	T	C	4	6	10	0	0	10	0	0
5	26889792	.	G	A	3	6	9	0	0	9	0	0
5	26890282	.	C	T	2	4	6	0	0	6	0	0
5	26921041	.	C	T	8	8	16	0	0	16	0	0
5	26926488	.	T	A	2	0	2	0	2	4	0	0
5	26926496	.	G	T	2	2	4	0	0	4	0	0
5	27137691	.	G	T	6	5	11	0	0	11	0	0
5	27137703	.	G	A	1	5	6	0	6	12	0	0
5	27137736	.	A	G	6	7	13	0	0	13	0	0
5	27330313	.	C	T	6	4	10	0	0	10	0	0
5	27345083	.	C	T	7	2	9	0	0	9	0	0
5	27345134	.	C	T	5	7	12	0	0	12	0	0
5	27354960	.	A	G	10	4	14	0	0	14	0	0
5	27355029	.	G	T	0	4	4	0	7	11	0	0
5	27375711	.	G	A	6	4	10	0	0	10	0	0
5	27375774	.	C	A	5	11	16	0	0	16	0	0
5	27381557	.	G	A	7	4	11	0	0	11	0	0
5	27385471	.	A	G	8	0	8	1	4	13	0	0
5	27392278	.	G	A	3	3	6	0	0	6	0	0
5	27424323	.	G	A	0	3	3	0	2	5	0	0
5	27438338	.	T	G	1	2	3	0	0	3	0	0
5	27866921	.	G	A	35	11	46	0	2	48	0	0
5	27867129	.	G	A	22	25	47	0	0	47	0	0
5	27910923	.	A	T	1	2	3	0	0	3	0	0
5	27924458	.	C	A	6	7	13	1	1	15	0	0
5	27924827	.	A	G	12	18	30	0	1	31	0	0
5	28789611	.	C	T	4	2	6	0	0	6	0	0
5	29001096	.	A	G	4	4	8	0	5	13	0	0
5	29004127	.	T	A	10	3	13	0	0	13	0	0
5	29491156	.	T	C	2	2	4	0	0	4	0	0
5	29491219	.	T	C	2	3	5	0	0	5	0	0
5	29491363	.	A	G	4	5	9	0	0	9	0	0
5	29491467	.	A	T	7	5	12	0	0	12	0	0
5	29495881	.	A	G	3	3	6	0	0	6	0	0
5	29498314	.	G	T	5	3	8	0	0	8	0	0
5	29498332	.	G	A	4	4	8	0	0	8	0	0
5	29506697	.	C	A	2	3	5	0	0	5	0	0
5	29506724	.	C	T	3	2	5	0	0	5	0	0
5	29508793	.	G	A	2	6	8	0	0	8	0	0
5	29510104	.	T	C	2	1	3	0	0	3	0	0
5	29510107	.	T	G	2	2	4	0	0	4	0	0
5	29512149	.	G	A	2	2	4	0	0	4	0	0
5	29512529	.	C	T	6	3	9	0	0	9	0	0
5	29549279	.	A	G	8	4	12	0	2	14	0	0
5	29551150	.	A	G	6	7	13	0	1	14	0	0
5	29551337	.	C	A	1	6	7	0	1	8	0	0
5	29552891	.	T	C	4	2	6	0	1	7	0	0
5	29553944	.	T	G	4	6	10	0	0	10	0	0
5	29598008	.	A	G	5	10	15	0	1	16	0	0
5	29598312	.	C	T	2	28	30	0	27	57	0	0
5	29598386	.	A	G	24	19	43	1	1	45	0	0
5	29598425	.	G	A	15	31	46	1	5	52	0	0
5	29598513	.	G	A	18	22	40	0	0	40	0	0
5	29598984	.	T	C	35	0	35	0	16	51	0	0
5	29599023	.	A	G	29	23	52	0	0	52	0	0
5	29599153	.	T	A	5	3	8	0	10	18	0	0
5	29599236	.	T	C	18	25	43	0	0	43	0	0
5	29599315	.	T	C	18	0	18	0	30	48	0	0
5	29599429	.	A	G	21	29	50	0	1	51	0	0
5	29599754	.	A	T	34	28	62	0	2	64	0	0
5	29599784	.	C	T	26	37	63	1	3	67	0	0
5	29599878	.	A	C	25	23	48	1	4	53	0	0
5	29611084	.	G	A	24	31	55	0	4	59	0	0
5	29614090	.	G	A	23	27	50	0	2	52	0	0
5	29619464	.	G	T	18	20	38	0	2	40	0	0
5	29619500	.	A	G	11	18	29	0	2	31	0	0
5	29622609	.	A	T	17	21	38	0	6	44	0	0
5	29628856	.	A	T	24	22	46	0	1	47	0	0
5	29639357	.	C	T	2	17	19	0	22	41	0	0
5	29639384	.	A	G	19	16	35	0	3	38	0	0
5	29639451	.	T	A	21	21	42	0	1	43	0	0
5	29643158	.	C	T	26	24	50	0	1	51	0	0
5	29643692	.	A	G	6	3	9	0	0	9	0	0
5	29657218	.	T	C	6	2	8	0	1	9	0	0
5	29658561	.	T	C	6	5	11	0	0	11	0	0
5	29660282	.	C	G	8	0	8	0	7	15	0	0
5	29660509	.	A	T	10	7	17	0	1	18	0	0
5	29661032	.	C	A	7	8	15	0	0	15	0	0
5	29661116	.	T	C	8	5	13	0	0	13	0	0
5	29661119	.	T	C	8	5	13	0	0	13	0	0
5	29661461	.	T	C	10	5	15	0	0	15	0	0
5	29663745	.	T	C	11	9	20	0	0	20	0	0
5	29664763	.	G	A	15	8	23	0	0	23	0	0
5	29666599	.	T	C	14	12	26	0	1	27	0	0
5	29666947	.	G	C	9	6	15	0	0	15	0	0
5	29667260	.	T	C	10	8	18	0	0	18	0	0
5	29667305	.	G	A	12	8	20	0	1	21	0	0
5	29667437	.	T	G	7	4	11	0	0	11	0	0
5	29667470	.	A	C	5	6	11	0	1	12	0	0
5	29668519	.	G	A	4	9	13	0	0	13	0	0
5	29668551	.	G	A	4	9	13	0	0	13	0	0
5	29668570	.	G	A	7	8	15	0	0	15	0	0
5	29668676	.	T	C	9	8	17	0	1	18	0	0
5	29668691	.	G	A	8	9	17	0	1	18	0	0
5	29668754	.	C	T	8	8	16	0	0	16	0	0
5	29668867	.	G	A	5	12	17	0	0	17	0	0
5	29711393	.	A	G	2	2	4	0	0	4	0	0
5	29711421	.	C	T	2	2	4	0	0	4	0	0
5	29714931	.	A	T	1	2	3	0	0	3	0	0
5	29714945	.	C	T	1	2	3	0	0	3	0	0
5	29714987	.	A	G	1	3	4	0	0	4	0	0
5	29745268	.	A	G	1	0	1	0	3	4	0	0
5	29746404	.	T	A	3	4	7	0	1	8	0	0
5	29746419	.	T	C	5	5	10	0	0	10	0	0
5	29746642	.	A	G	1	4	5	0	0	5	0	0
5	29746706	.	A	T	5	7	12	0	0	12	0	0
5	29747027	.	C	T	14	11	25	0	4	29	0	0
5	29747121	.	G	T	22	19	41	0	2	43	0	0
5	29749734	.	T	C	18	16	34	0	0	34	0	0
5	29749827	.	C	G	19	12	31	0	0	31	0	0
5	29750074	.	G	A	8	11	19	0	2	21	0	0
5	29750189	.	T	C	4	9	13	0	0	13	0	0
5	29750285	.	G	A	14	9	23	1	1	25	0	0
5	29784196	.	T	A	15	6	21	0	2	23	0	0
5	29784200	.	G	C	15	8	23	0	1	24	0	0
5	29789706	.	T	C	15	8	23	0	3	26	0	0
5	29790175	.	T	A	13	16	29	0	1	30	0	0
5	29790301	.	G	C	11	11	22	0	0	22	0	0
5	29790390	.	A	C	7	8	15	0	0	15	0	0
5	29803960	.	A	C	9	22	31	0	2	33	0	0
5	29817468	.	C	A	1	2	3	0	1	4	0	0
5	29817493	.	G	T	2	2	4	0	0	4	0	0
5	29817549	.	A	C	3	2	5	0	0	5	0	0
5	29884098	.	T	G	7	4	11	0	0	11	0	0
5	29884125	.	T	C	10	5	15	0	0	15	0	0
5	29886410	.	T	C	4	7	11	0	0	11	0	0
5	29886728	.	A	T	6	3	9	0	0	9	0	0
5	29891094	.	A	T	5	4	9	0	1	10	0	0
5	29891314	.	A	C	2	4	6	0	0	6	0	0
5	29893544	.	T	C	5	5	10	0	0	10	0	0
5	30053182	.	G	A	4	5	9	0	0	9	0	0
5	30053291	.	C	T	1	2	3	0	4	7	0	0
5	30054008	.	G	T	1	2	3	0	0	3	0	0
5	30054062	.	T	C	5	6	11	0	0	11	0	0
5	30054122	.	T	A	8	5	13	0	0	13	0	0
5	30054201	.	T	C	1	0	1	0	2	3	0	0
5	30054203	.	G	T	1	2	3	0	0	3	0	0
5	30054255	.	G	T	3	3	6	0	0	6	0	0
5	30054403	.	T	A	1	2	3	0	1	4	0	0
5	30054566	.	G	A	1	3	4	0	0	4	0	0
5	30055267	.	A	T	3	3	6	0	0	6	0	0
5	30055327	.	A	G	2	3	5	0	1	6	0	0
5	30055344	.	C	A	1	3	4	0	0	4	0	0
5	30055542	.	C	T	0	2	2	0	3	5	0	0
5	30055549	.	A	T	4	3	7	0	0	7	0	0
5	30056098	.	T	C	4	2	6	0	0	6	0	0
5	30056162	.	G	T	4	4	8	0	0	8	0	0
5	30056723	.	A	C	2	5	7	0	0	7	0	0
5	30056993	.	G	C	2	9	11	0	0	11	0	0
5	30057443	.	C	T	1	3	4	0	1	5	0	0
5	30058358	.	C	T	2	2	4	0	5	9	0	0
5	30058412	.	G	A	5	4	9	0	0	9	0	0
5	30060772	.	C	T	0	4	4	0	2	6	0	0
5	30061149	.	G	A	2	3	5	0	0	5	0	0
5	30062635	.	G	T	3	2	5	0	0	5	0	0
5	30062903	.	C	A	1	3	4	0	0	4	0	0
5	30068381	.	G	C	8	4	12	0	0	12	0	0
5	30068396	.	T	A	5	5	10	0	0	10	0	0
5	30070497	.	C	T	1	3	4	0	0	4	0	0
5	30074289	.	C	T	2	3	5	0	4	9	0	0
5	30074314	.	A	G	1	3	4	0	0	4	0	0
5	30081359	.	G	A	9	11	20	0	0	20	0	0
5	30081495	.	G	A	14	7	21	0	1	22	0	0
5	30081737	.	C	T	11	6	17	0	2	19	0	0
5	30087667	.	C	A	8	7	15	3	0	18	0	0
5	30087954	.	G	A	5	7	12	0	0	12	0	0
5	30088074	.	C	T	1	3	4	0	5	9	0	0
5	30090364	.	C	A	10	3	13	0	0	13	0	0
5	30145265	.	A	G	6	5	11	0	0	11	0	0
5	30145601	.	C	T	7	8	15	0	0	15	0	0
5	30145718	.	T	A	2	5	7	0	0	7	0	0
5	30145850	.	A	G	5	4	9	0	0	9	0	0
5	30151073	.	A	G	1	5	6	0	0	6	0	0
5	30179816	.	A	C	1	2	3	0	2	5	0	0
5	30200329	.	A	G	3	0	3	0	3	6	0	0
5	30200362	.	G	A	0	6	6	0	2	8	0	0
5	30200574	.	T	C	2	4	6	0	0	6	0	0
5	30203411	.	C	A	1	3	4	0	0	4	0	0
5	30203719	.	C	A	1	3	4	0	0	4	0	0
5	30206077	.	C	T	2	4	6	0	0	6	0	0
5	30208505	.	C	T	4	4	8	0	1	9	0	0
5	30208905	.	A	T	7	4	11	0	0	11	0	0
5	30415236	.	A	G	19	22	41	0	2	43	0	0
5	30437327	.	T	C	4	1	5	0	3	8	0	0
5	30437804	.	C	T	3	5	8	0	2	10	0	0
5	30440415	.	T	C	3	0	3	0	8	11	0	0
5	30440486	.	G	T	6	3	9	0	1	10	0	0
5	30456179	.	T	A	5	8	13	0	0	13	0	0
5	30459036	.	C	T	0	4	4	0	3	7	0	0
5	30466621	.	A	C	2	3	5	0	0	5	0	0
5	30466678	.	C	G	2	3	5	0	0	5	0	0
5	30466705	.	T	G	2	3	5	0	0	5	0	0
5	30466951	.	C	G	2	3	5	0	2	7	0	0
5	30467107	.	A	G	8	9	17	0	0	17	0	0
5	30502862	.	A	G	13	4	17	0	1	18	0	0
5	30503022	.	A	G	5	4	9	0	0	9	0	0
5	30503194	.	C	A	6	5	11	0	1	12	0	0
5	30507329	.	T	G	6	7	13	0	0	13	0	0
5	30507745	.	A	T	5	8	13	0	0	13	0	0
5	30510396	.	A	G	7	10	17	0	1	18	0	0
5	30511154	.	G	T	10	7	17	0	0	17	0	0
5	30513045	.	G	T	6	3	9	0	1	10	0	0
5	30513069	.	G	A	6	5	11	0	0	11	0	0
5	30513102	.	C	T	2	3	5	0	5	10	0	0
5	30516553	.	G	A	8	12	20	0	0	20	0	0
5	30534910	.	G	A	19	9	28	0	0	28	0	0
5	30537647	.	A	G	13	13	26	0	1	27	0	0
5	30538043	.	T	C	15	0	15	0	25	40	0	0
5	30538110	.	G	T	20	25	45	0	2	48	1	0
5	30542683	.	A	G	22	12	34	0	2	36	0	0
5	30542695	.	C	T	24	11	35	0	0	35	0	0
5	30544147	.	T	C	20	21	41	0	0	41	0	0
5	30544364	.	G	A	19	19	38	0	0	38	0	0
5	30549756	.	G	A	12	14	26	0	0	26	0	0
5	30554108	.	C	A	18	4	22	0	2	24	0	0
5	30554110	.	T	G	16	6	22	0	1	23	0	0
5	30554190	.	T	C	15	15	30	0	0	30	0	0
5	30554191	.	G	T	15	15	30	0	0	30	0	0
5	30583872	.	G	C	14	0	14	0	11	25	0	0
5	30583995	.	G	A	13	14	27	0	0	27	0	0
5	30586171	.	A	T	9	11	20	0	1	21	0	0
5	30588933	.	T	C	4	3	7	0	1	8	0	0
5	30589728	.	C	T	6	2	8	0	0	8	0	0
5	30591570	.	C	T	6	4	10	0	0	10	0	0
5	30594075	.	A	G	7	6	13	0	1	14	0	0
5	30597105	.	T	C	4	3	7	0	1	8	0	0
5	30605226	.	G	A	7	3	10	0	0	10	0	0
5	30605541	.	T	C	2	5	7	0	1	8	0	0
5	30605651	.	A	T	6	3	9	0	0	9	0	0
5	30605656	.	G	T	6	3	9	0	0	9	0	0
5	30606067	.	T	A	2	5	7	0	0	7	0	0
5	30606225	.	A	G	4	3	7	0	0	7	0	0
5	30606454	.	A	T	3	2	5	0	0	5	0	0
5	30624183	.	G	A	3	4	7	0	1	8	0	0
5	30624264	.	C	A	9	10	19	0	1	20	0	0
5	30624345	.	G	C	13	13	26	0	1	27	0	0
5	30624432	.	C	A	9	12	21	0	0	21	0	0
5	30624638	.	A	G	8	8	16	0	0	16	0	0
5	30635431	.	T	A	11	9	20	0	1	21	0	0
5	30635497	.	C	T	8	14	22	0	0	22	0	0
5	30661242	.	G	A	11	17	28	0	1	29	0	0
5	30661296	.	T	C	12	12	24	0	2	26	0	0
5	30661443	.	C	A	14	11	25	0	0	25	0	0
5	30661533	.	C	T	18	12	30	0	0	30	0	0
5	30663282	.	G	A	3	13	16	0	12	28	0	0
5	30665690	.	G	A	2	10	12	0	16	28	0	0
5	30665720	.	C	T	20	9	29	0	1	30	0	0
5	30665738	.	A	G	16	7	23	0	0	23	0	0
5	30665804	.	A	C	9	7	16	0	2	18	0	0
5	30669581	.	C	T	10	4	14	0	0	14	0	0
5	30670212	.	A	G	10	20	30	0	0	30	0	0
5	30670251	.	G	C	15	17	32	0	0	32	0	0
5	30672016	.	A	T	9	5	14	0	0	14	0	0
5	30672019	.	T	C	9	5	14	0	0	14	0	0
5	30672366	.	T	C	10	15	25	0	1	26	0	0
5	30672446	.	C	T	18	19	37	0	0	37	0	0
5	30699337	.	A	T	32	23	55	0	0	55	0	0
5	30702796	.	G	A	6	5	11	0	0	11	0	0
5	30702903	.	A	T	4	11	15	0	0	15	0	0
5	30704029	.	C	T	6	11	17	0	0	17	0	0
5	30704188	.	G	A	2	12	14	0	0	14	0	0
5	30760569	.	A	T	10	11	21	0	0	21	0	0
5	30760821	.	C	T	6	9	15	0	0	15	0	0
5	30763118	.	T	C	10	10	20	0	2	22	0	0
5	30764160	.	T	G	13	14	27	0	0	27	0	0
5	30764214	.	T	C	9	13	22	0	1	23	0	0
5	30764629	.	T	G	15	12	27	0	0	27	0	0
5	30766804	.	T	C	11	9	20	0	0	20	0	0
5	30770617	.	C	T	2	6	8	0	0	8	0	0
5	30805072	.	T	A	4	6	10	0	0	10	0	0
5	30805623	.	A	G	16	15	31	0	1	32	0	0
5	30805781	.	A	G	11	8	19	0	0	19	0	0
5	30806237	.	C	T	12	7	19	0	0	19	0	0
5	30806391	.	C	G	12	8	20	0	1	21	0	0
5	30806553	.	T	C	16	9	25	0	1	26	0	0
5	30806962	.	G	A	9	9	18	0	1	19	0	0
5	30806966	.	T	G	9	11	20	0	0	20	0	0
5	30828381	.	T	G	4	2	6	0	0	6	0	0
5	30828486	.	A	G	16	5	21	0	1	22	0	0
5	30828680	.	G	A	4	7	11	0	0	11	0	0
5	30828761	.	C	T	1	6	7	0	3	10	0	0
5	30842345	.	G	A	15	9	24	0	0	24	0	0
5	30891023	.	C	T	1	2	3	0	0	3	0	0
5	30891565	.	A	C	5	2	7	0	0	7	0	0
5	30924101	.	T	C	9	13	22	0	1	23	0	0
5	30924247	.	T	A	14	12	26	0	1	27	0	0
5	30994105	.	T	A	17	10	27	0	0	27	0	0
5	30994256	.	C	T	5	5	10	0	1	11	0	0
5	30994610	.	T	C	5	6	11	0	0	11	0	0
5	30994818	.	C	T	7	6	13	0	0	13	0	0
5	30994843	.	G	T	2	5	7	0	1	8	0	0
5	30994862	.	C	T	2	4	6	0	0	6	0	0
5	30994882	.	C	T	2	1	3	0	0	3	0	0
5	31007548	.	T	A	3	3	6	0	0	6	0	0
5	31007635	.	C	T	3	2	5	0	0	5	0	0
5	31012293	.	T	A	4	6	10	0	0	10	0	0
5	31012606	.	A	G	7	4	11	0	1	12	0	0
5	31015348	.	T	C	1	4	5	0	0	5	0	0
5	31015399	.	G	A	4	5	9	0	1	10	0	0
5	31015566	.	T	C	3	8	11	0	1	12	0	0
5	31016680	.	T	A	7	6	13	0	0	13	0	0
5	31016741	.	C	T	2	5	7	0	0	7	0	0
5	31016833	.	T	C	7	3	10	0	0	10	0	0
5	31017021	.	C	T	5	10	15	0	0	15	0	0
5	31021146	.	G	A	5	10	15	0	0	15	0	0
5	31021450	.	C	T	6	3	9	0	0	9	0	0
5	31025009	.	G	T	0	11	11	0	9	20	0	0
5	31029089	.	G	A	3	10	13	0	6	19	0	0
5	31029471	.	G	A	3	7	10	0	12	22	0	0
5	31029520	.	G	A	0	8	8	0	5	13	0	0
5	31029701	.	G	T	7	5	12	0	0	12	0	0
5	31029702	.	G	T	7	5	12	0	0	12	0	0
5	31029766	.	C	T	12	6	18	0	0	18	0	0
5	31029886	.	A	C	5	5	10	0	0	10	0	0
5	31029898	.	A	G	5	5	10	0	0	10	0	0
5	31030435	.	A	G	9	3	12	0	8	20	0	0
5	31034559	.	G	A	8	4	12	0	2	14	0	0
5	31038882	.	A	G	2	3	5	0	0	5	0	0
5	31040719	.	A	G	3	2	5	0	0	5	0	0
5	31041153	.	T	C	1	4	5	0	2	7	0	0
5	31043890	.	G	T	1	3	4	0	9	13	0	0
5	31058447	.	A	G	2	0	2	0	4	6	0	0
5	31061637	.	C	A	5	3	8	0	1	9	0	0
5	31068612	.	C	T	10	4	14	0	0	14	0	0
5	31069699	.	C	T	1	2	3	0	0	3	0	0
5	31069714	.	C	T	1	3	4	0	0	4	0	0
5	31071802	.	C	A	4	5	9	0	0	9	0	0
5	31071820	.	C	A	6	6	12	0	0	12	0	0
5	31073991	.	T	A	5	4	9	0	0	9	0	0
5	31074007	.	T	C	4	3	7	0	1	8	0	0
5	31078042	.	T	C	3	6	9	0	0	9	0	0
5	31078048	.	A	G	3	7	10	0	0	10	0	0
5	31082425	.	T	C	8	3	11	0	1	12	0	0
5	31084531	.	G	A	1	4	5	0	6	11	0	0
5	31084778	.	A	G	5	7	12	0	0	12	0	0
5	31087232	.	G	A	0	5	5	0	7	12	0	0
5	31092294	.	T	C	7	3	10	0	0	10	0	0
5	31092321	.	C	T	5	5	10	0	0	10	0	0
5	31108180	.	G	A	5	2	7	0	0	7	0	0
5	31108523	.	A	G	2	0	2	0	3	5	0	0
5	31108569	.	T	A	5	3	8	0	0	8	0	0
5	31108690	.	C	T	4	5	9	0	1	10	0	0
5	31108800	.	A	G	10	0	10	0	2	12	0	0
5	31108804	.	T	C	10	3	13	0	0	13	0	0
5	31108876	.	C	A	4	4	8	0	0	8	0	0
5	31108922	.	A	G	5	3	8	0	0	8	0	0
5	31230971	.	T	A	15	15	30	0	1	31	0	0
5	31264263	.	C	T	20	25	45	0	1	46	0	0
5	31266352	.	T	A	21	22	43	0	2	45	0	0
5	31266620	.	G	A	14	23	37	0	3	40	0	0
5	31266676	.	T	C	20	20	40	0	2	42	0	0
5	31266716	.	T	G	20	19	39	0	0	39	0	0
5	31267009	.	C	G	13	23	36	0	2	38	0	0
5	31267164	.	A	G	14	18	32	2	0	34	0	0
5	31267233	.	A	C	16	19	35	0	1	36	0	0
5	31267254	.	A	G	13	21	34	0	2	36	0	0
5	31267313	.	T	A	10	24	34	0	0	34	0	0
5	31267336	.	G	A	13	29	42	0	0	42	0	0
5	31267450	.	T	G	24	0	24	0	24	48	0	0
5	31267655	.	C	T	19	25	44	0	1	45	0	0
5	31267975	.	T	C	18	22	40	0	2	42	0	0
5	31268104	.	A	T	17	25	42	0	2	44	0	0
5	31268417	.	A	G	15	32	47	0	1	48	0	0
5	31268489	.	T	C	12	29	41	0	0	41	0	0
5	31268601	.	G	A	19	20	39	0	2	41	0	0
5	31269004	.	C	T	16	16	32	0	5	37	0	0
5	31283726	.	G	T	5	6	11	0	0	11	0	0
5	31284068	.	C	A	6	9	15	0	0	15	0	0
5	31334390	.	T	C	5	8	13	0	0	13	0	0
5	31350771	.	A	G	5	1	6	0	6	12	0	0
5	31419826	.	G	A	12	11	23	0	0	23	0	0
5	31431901	.	C	T	5	6	11	0	0	11	0	0
5	31432024	.	C	G	9	8	17	0	0	17	0	0
5	31432032	.	G	T	1	8	9	0	10	19	0	0
5	31432252	.	C	T	2	2	4	0	0	4	0	0
5	31432387	.	A	G	2	4	6	0	0	6	0	0
5	31432444	.	G	T	7	2	9	0	0	9	0	0
5	31432498	.	A	T	5	5	10	0	2	12	0	0
5	31480399	.	C	G	5	5	10	0	0	10	0	0
5	31480674	.	C	T	7	6	13	0	0	13	0	0
5	31480891	.	A	T	2	2	4	0	2	6	0	0
5	31562670	.	G	A	1	8	9	0	8	17	0	0
5	31579415	.	C	A	7	9	16	0	1	17	0	0
5	31579508	.	T	C	10	11	21	0	0	21	0	0
5	31607220	.	A	G	1	2	3	0	0	3	0	0
5	31644517	.	T	A	9	12	21	0	0	21	0	0
5	31644614	.	T	G	13	16	29	1	0	30	0	0
5	31644709	.	C	T	1	10	11	0	12	23	0	0
5	31644867	.	A	G	11	16	27	0	3	30	0	0
5	31649757	.	G	A	12	26	38	0	2	40	0	0
5	31658294	.	C	T	24	16	40	0	3	43	0	0
5	31658303	.	T	C	24	13	37	0	1	38	0	0
5	31699112	.	T	C	4	0	4	0	8	12	0	0
5	31703395	.	A	G	2	10	12	0	0	12	0	0
5	31703432	.	T	C	2	0	2	0	8	10	0	0
5	31711869	.	C	G	1	8	9	0	0	9	0	0
5	31712295	.	A	G	1	2	3	0	0	3	0	0
5	31714550	.	C	T	9	11	20	0	0	20	0	0
5	31714742	.	A	C	22	13	35	0	1	36	0	0
5	31714914	.	T	C	11	18	29	0	1	30	0	0
5	31723845	.	G	A	15	11	26	0	1	27	0	0
5	31723870	.	A	G	12	13	25	0	0	25	0	0
5	31723960	.	T	A	3	5	8	0	0	8	0	0
5	31724003	.	G	A	5	4	9	0	1	10	0	0
5	31724004	.	A	T	6	4	10	0	0	10	0	0
5	31724052	.	T	G	6	3	9	0	2	11	0	0
5	31724330	.	G	T	5	3	8	0	0	8	0	0
5	31724347	.	A	G	4	2	6	0	1	7	0	0
5	31724395	.	T	C	8	2	10	0	5	15	0	0
5	31730513	.	T	C	3	10	13	0	0	13	0	0
5	31730525	.	T	G	3	9	12	0	1	13	0	0
5	31735704	.	T	C	5	10	15	0	3	18	0	0
5	31804718	.	T	C	6	2	8	0	0	8	0	0
5	32061059	.	T	A	2	1	3	0	2	5	0	0
5	33018841	.	A	G	2	2	4	0	1	5	0	0
5	33018851	.	G	C	1	0	1	0	5	6	0	0
5	33019181	.	G	A	9	8	17	0	1	18	0	0
5	33019571	.	C	G	7	8	15	0	0	15	0	0
5	33019598	.	G	A	5	7	12	0	0	12	0	0
5	33019826	.	T	C	6	5	11	0	1	12	0	0
5	33021257	.	A	T	4	3	7	0	0	7	0	0
5	33200071	.	G	A	8	11	19	0	1	20	0	0
5	33200279	.	T	C	15	1	16	0	8	24	0	0
5	33208429	.	A	G	8	17	25	1	2	28	0	0
5	33215307	.	G	A	8	3	11	0	1	12	0	0
5	33238950	.	C	A	4	5	9	0	1	10	0	0
5	33239099	.	C	T	0	2	2	0	2	4	0	0
5	33239444	.	G	T	7	4	11	0	1	12	0	0
5	33239486	.	A	G	8	4	12	0	1	13	0	0
5	33239551	.	A	T	6	7	13	0	1	14	0	0
5	33239625	.	T	C	2	9	11	0	0	11	0	0
5	33239965	.	G	C	7	7	14	0	1	15	0	0
5	33239996	.	T	C	5	7	12	0	0	12	0	0
5	33240295	.	G	A	8	9	17	0	2	19	0	0
5	33240425	.	A	T	6	7	13	2	1	16	0	0
5	33240469	.	T	C	7	13	20	2	2	24	0	0
5	33240600	.	G	A	7	10	17	0	0	17	0	0
5	33240930	.	A	T	8	5	13	0	0	13	0	0
5	33245668	.	C	A	0	8	8	0	5	13	0	0
5	33245860	.	C	T	1	9	10	0	12	22	0	0
5	33247152	.	C	T	3	9	12	0	1	13	0	0
5	33248925	.	G	A	8	7	15	0	0	15	0	0
5	33251276	.	A	T	3	10	13	0	0	13	0	0
5	33266832	.	T	A	3	2	5	0	0	5	0	0
5	33266919	.	C	G	3	2	5	0	1	6	0	0
5	33266924	.	A	C	3	2	5	0	1	6	0	0
5	33267041	.	A	T	4	3	7	0	0	7	0	0
5	33268218	.	T	C	5	2	7	0	1	8	0	0
5	33268417	.	A	G	3	3	6	0	0	6	0	0
5	33268426	.	T	G	3	3	6	0	0	6	0	0
5	33274592	.	C	A	1	2	3	0	3	6	0	0
5	33274623	.	G	T	4	2	6	0	1	7	0	0
5	33274630	.	T	C	5	2	7	0	0	7	0	0
5	33277928	.	C	T	1	3	4	0	2	6	0	0
5	33280612	.	C	T	2	4	6	0	1	7	0	0
5	33280658	.	C	T	5	5	10	0	0	10	0	0
5	33280951	.	A	G	5	6	11	0	0	11	0	0
5	33280976	.	G	A	6	6	12	0	1	13	0	0
5	33282484	.	A	C	5	8	13	0	0	14	1	0
5	33283644	.	T	C	3	2	5	0	0	5	0	0
5	33285096	.	C	T	2	41	43	0	29	73	1	0
5	33289072	.	T	G	11	8	19	0	2	21	0	0
5	33289170	.	A	T	6	8	14	0	0	14	0	0
5	33290815	.	A	G	6	0	6	0	9	15	0	0
5	33295805	.	A	G	2	2	4	0	0	4	0	0
5	33295806	.	A	G	2	2	4	0	0	4	0	0
5	33296924	.	G	T	12	17	29	0	0	29	0	0
5	33297994	.	G	A	10	7	17	0	1	18	0	0
5	33302826	.	C	A	7	8	15	0	0	15	0	0
5	33304310	.	G	C	8	8	16	0	0	16	0	0
5	33304337	.	T	C	10	12	22	0	0	22	0	0
5	33307621	.	C	G	14	18	32	0	1	33	0	0
5	33307805	.	C	G	10	7	17	0	0	17	0	0
5	33307812	.	C	A	10	6	16	0	0	16	0	0
5	33310458	.	G	T	13	8	21	0	1	22	0	0
5	33310947	.	T	G	12	7	19	0	0	19	0	0
5	33314422	.	G	C	9	8	17	0	0	17	0	0
5	33314610	.	T	C	10	10	20	1	1	22	0	0
5	33315247	.	A	T	12	9	21	0	0	21	0	0
5	33318597	.	G	A	0	10	10	0	18	28	0	0
5	33328791	.	C	A	8	12	20	0	0	20	0	0
5	33328939	.	A	G	9	13	22	0	0	22	0	0
5	33329210	.	G	A	1	7	8	0	8	16	0	0
5	33329345	.	G	A	1	11	12	0	15	27	0	0
5	33329418	.	G	A	16	12	28	0	2	30	0	0
5	33329600	.	T	C	12	12	24	0	0	24	0	0
5	33329740	.	G	T	11	11	22	0	0	22	0	0
5	33329774	.	A	G	6	8	14	0	3	17	0	0
5	33329786	.	A	G	6	10	16	0	1	17	0	0
5	33330146	.	G	C	3	18	21	0	0	21	0	0
5	33336805	.	C	A	4	8	12	0	0	12	0	0
5	33336920	.	A	G	3	3	6	0	0	6	0	0
5	33336934	.	C	T	5	3	8	0	0	8	0	0
5	33337041	.	T	A	4	5	9	0	1	11	1	0
5	33337050	.	G	A	4	7	11	0	0	11	0	0
5	33337366	.	T	G	2	2	4	0	1	5	0	0
5	33337470	.	C	G	6	3	9	0	0	9	0	0
5	33337593	.	A	T	8	2	10	0	0	10	0	0
5	33337610	.	A	G	6	4	10	0	1	11	0	0
5	33347302	.	G	A	2	2	4	0	0	4	0	0
5	33347583	.	A	G	2	2	4	0	0	4	0	0
5	33360761	.	C	G	15	11	26	0	3	29	0	0
5	33360835	.	T	G	24	13	37	0	1	38	0	0
5	33360884	.	T	C	22	16	38	0	3	41	0	0
5	33382095	.	G	A	7	9	16	0	1	17	0	0
5	33385512	.	T	A	8	11	19	0	7	26	0	0
5	33387624	.	A	G	12	11	23	0	1	24	0	0
5	33460936	.	A	G	4	8	12	0	2	14	0	0
5	33537918	.	T	A	2	2	4	0	1	5	0	0
5	33538011	.	G	T	6	5	11	0	0	11	0	0
5	33554892	.	T	C	3	3	6	0	0	6	0	0
5	33555115	.	T	C	4	6	10	0	0	10	0	0
5	33558640	.	T	C	2	0	2	0	5	7	0	0
5	33612040	.	G	A	4	5	9	0	1	10	0	0
5	33636887	.	A	G	3	6	9	0	0	9	0	0
5	33640552	.	A	G	2	5	7	0	0	7	0	0
5	33658010	.	G	A	5	2	7	0	0	7	0	0
5	33668755	.	A	G	9	5	14	0	0	14	0	0
5	33668821	.	G	A	8	7	15	0	0	15	0	0
5	33668827	.	C	T	8	8	16	0	0	16	0	0
5	33668894	.	C	T	5	5	10	0	2	12	0	0
5	33668936	.	G	T	2	4	6	0	1	7	0	0
5	33668943	.	A	T	5	0	5	0	1	6	0	0
5	33680184	.	T	G	14	13	27	0	1	28	0	0
5	33694109	.	T	C	14	16	30	0	2	32	0	0
5	33698666	.	G	A	13	11	24	0	0	24	0	0
5	34066594	.	C	T	2	3	5	0	0	5	0	0
5	34066837	.	G	A	13	7	20	0	0	20	0	0
5	34098880	.	G	T	8	12	20	0	0	20	0	0
5	34142962	.	A	G	4	7	11	0	0	11	0	0
5	34185186	.	C	G	7	5	12	0	0	12	0	0
5	34185195	.	C	T	6	4	10	0	0	10	0	0
5	34185399	.	A	T	5	4	9	0	0	9	0	0
5	34532592	.	A	C	2	2	4	0	0	4	0	0
5	34568883	.	T	C	21	18	39	0	1	40	0	0
5	34573792	.	T	C	23	19	42	0	1	43	0	0
5	34573807	.	T	C	20	23	43	0	1	44	0	0
5	34574165	.	G	A	10	16	26	0	1	27	0	0
5	34574191	.	T	G	14	14	28	0	0	28	0	0
5	34574224	.	G	A	18	14	32	0	0	32	0	0
5	34574238	.	C	A	13	14	27	0	1	28	0	0
5	34574267	.	G	A	12	13	25	0	1	26	0	0
5	34574546	.	A	G	22	0	22	0	13	35	0	0
5	34574915	.	C	T	14	16	30	0	3	33	0	0
5	34574919	.	A	G	15	18	33	0	1	34	0	0
5	34575079	.	T	A	24	1	25	0	0	25	0	0
5	34586139	.	T	G	3	3	6	0	1	7	0	0
5	34588977	.	A	G	3	0	3	1	5	9	0	0
5	34589009	.	G	T	4	4	8	0	1	9	0	0
5	34589225	.	G	T	4	5	9	0	0	9	0	0
5	34593289	.	A	C	1	5	6	0	0	6	0	0
5	34593568	.	A	G	2	5	7	0	0	7	0	0
5	34603792	.	T	G	9	5	14	0	0	14	0	0
5	34603811	.	T	C	8	6	14	0	0	14	0	0
5	34606570	.	C	T	8	7	15	0	0	15	0	0
5	34609005	.	A	G	8	11	19	0	1	20	0	0
5	34609116	.	G	C	5	0	5	0	2	7	0	0
5	34609321	.	A	G	1	5	6	0	0	6	0	0
5	34609324	.	G	A	1	5	6	0	0	6	0	0
5	34609357	.	G	A	2	6	8	0	0	8	0	0
5	34614057	.	A	G	8	7	15	0	1	16	0	0
5	34624322	.	A	G	4	2	6	0	0	6	0	0
5	34624816	.	G	C	2	4	6	0	0	6	0	0
5	34625152	.	G	A	1	3	4	0	5	9	0	0
5	34625278	.	T	G	1	5	6	0	1	7	0	0
5	34626076	.	T	C	9	6	15	0	0	15	0	0
5	34633673	.	C	T	7	3	10	0	0	10	0	0
5	34634180	.	C	A	4	7	11	0	0	11	0	0
5	34634253	.	T	G	10	6	16	0	0	16	0	0
5	34634754	.	T	A	3	7	10	0	0	10	0	0
5	34634894	.	G	T	11	5	16	0	1	17	0	0
5	34635098	.	T	A	5	10	15	0	2	17	0	0
5	34635133	.	A	T	5	9	14	0	0	14	0	0
5	34635194	.	A	G	6	11	17	0	0	17	0	0
5	34635451	.	A	C	7	1	8	0	1	9	0	0
5	34635673	.	G	A	13	5	18	0	0	18	0	0
5	34635795	.	A	T	4	4	8	0	0	9	1	0
5	34636252	.	G	A	12	9	21	0	0	21	0	0
5	34636347	.	G	T	7	5	12	0	1	13	0	0
5	34636413	.	G	A	4	6	10	0	0	10	0	0
5	34636457	.	A	T	5	4	9	0	0	9	0	0
5	34636638	.	T	C	5	4	9	0	0	9	0	0
5	34636731	.	A	T	11	11	22	0	0	23	1	0
5	34636986	.	T	G	5	6	11	0	0	11	0	0
5	34637067	.	T	C	7	7	14	0	0	14	0	0
5	34637399	.	A	C	12	8	20	1	0	21	0	0
5	34637466	.	T	C	6	6	12	0	0	12	0	0
5	34637539	.	A	G	7	11	18	0	0	18	0	0
5	34637667	.	T	G	11	3	14	0	0	14	0	0
5	34637681	.	A	G	10	6	16	0	0	16	0	0
5	34637706	.	T	G	10	11	21	0	2	23	0	0
5	34637843	.	A	G	9	11	20	0	1	21	0	0
5	34637849	.	G	C	11	11	22	0	0	22	0	0
5	34637997	.	A	C	19	16	35	0	1	36	0	0
5	34837117	.	A	G	1	3	4	0	0	4	0	0
5	34981636	.	A	T	4	11	15	0	0	15	0	0
5	34982414	.	G	A	6	14	20	0	1	21	0	0
5	34982866	.	C	G	10	1	11	0	13	24	0	0
5	34987043	.	A	T	15	15	30	0	2	32	0	0
5	34987812	.	G	A	32	27	59	1	4	64	0	0
5	34991271	.	C	T	21	35	56	0	4	60	0	0
5	35123955	.	C	T	6	4	10	0	1	11	0	0
5	35124398	.	C	T	10	9	19	0	1	20	0	0
5	35124435	.	T	C	9	0	9	0	11	20	0	0
5	35124939	.	G	A	8	5	13	0	0	13	0	0
5	35125414	.	C	T	0	7	7	1	4	12	0	0
5	35125423	.	C	T	4	8	12	1	0	13	0	0
5	35125492	.	C	T	1	6	7	0	6	13	0	0
5	35125882	.	G	A	9	11	20	0	0	20	0	0
5	35125883	.	A	T	8	11	19	0	1	20	0	0
5	35127255	.	G	C	6	9	15	0	1	16	0	0
5	35129861	.	C	A	6	5	11	0	0	11	0	0
5	35129892	.	T	C	4	0	4	0	5	9	0	0
5	35133188	.	A	T	8	4	12	0	0	12	0	0
5	35137621	.	C	T	1	5	6	0	14	20	0	0
5	35178640	.	G	A	4	5	9	0	0	9	0	0
5	35178673	.	T	C	8	0	8	0	3	11	0	0
5	35202771	.	G	T	7	6	13	0	0	13	0	0
5	35202815	.	T	A	15	6	21	0	0	21	0	0
5	35202876	.	A	T	8	7	15	0	1	16	0	0
5	35202958	.	G	A	13	9	22	0	0	24	2	0
5	35202959	.	A	T	15	9	24	0	1	25	0	0
5	35203092	.	G	A	7	9	16	1	1	18	0	0
5	35203629	.	C	T	2	16	18	0	13	31	0	0
5	35204077	.	T	G	6	8	14	0	0	14	0	0
5	35204390	.	G	A	8	4	12	0	1	13	0	0
5	35204681	.	A	C	3	12	15	0	0	15	0	0
5	35204689	.	A	C	2	1	3	0	10	13	0	0
5	35204857	.	T	C	10	0	10	0	6	16	0	0
5	35204934	.	A	T	15	5	20	0	1	21	0	0
5	35204945	.	T	C	12	11	23	0	1	24	0	0
5	35205005	.	G	A	16	9	25	0	1	26	0	0
5	35205123	.	C	G	6	5	11	0	0	11	0	0
5	35207914	.	T	G	10	5	15	0	1	16	0	0
5	35218361	.	G	A	6	6	12	0	0	12	0	0
5	35220402	.	T	A	4	4	8	0	0	8	0	0
5	35222413	.	T	G	12	9	21	0	1	22	0	0
5	35224334	.	A	G	4	3	7	0	0	7	0	0
5	35229964	.	G	A	15	7	22	0	0	22	0	0
5	35230015	.	G	A	9	9	18	0	1	19	0	0
5	35241882	.	A	T	5	5	10	0	0	10	0	0
5	35241963	.	A	T	4	5	9	0	0	9	0	0
5	35245159	.	A	G	5	5	10	0	1	11	0	0
5	35253608	.	T	C	1	0	1	0	8	9	0	0
5	35258669	.	T	C	7	0	7	0	4	11	0	0
5	35258880	.	C	T	5	4	9	0	1	10	0	0
5	35259846	.	G	C	7	5	12	0	2	14	0	0
5	35260553	.	A	G	1	2	3	0	0	3	0	0
5	35260554	.	C	T	1	2	3	0	0	3	0	0
5	35261066	.	T	A	3	4	7	0	1	8	0	0
5	35262439	.	C	A	3	5	8	0	1	9	0	0
5	35271001	.	C	T	20	10	30	0	1	31	0	0
5	35271465	.	T	C	29	24	53	0	3	56	0	0
5	35271613	.	G	A	20	21	41	0	1	42	0	0
5	35271706	.	C	T	23	22	45	0	0	45	0	0
5	35271791	.	T	A	18	25	43	0	5	48	0	0
5	35271824	.	C	A	25	22	47	0	2	49	0	0
5	35271889	.	T	A	24	13	37	0	1	38	0	0
5	35272562	.	A	C	15	15	30	0	1	31	0	0
5	35272774	.	T	G	20	22	42	0	1	43	0	0
5	35272835	.	G	A	24	23	47	0	2	49	0	0
5	35272909	.	A	G	24	22	46	0	0	46	0	0
5	35273099	.	G	C	24	22	46	0	0	46	0	0
5	35273164	.	T	C	19	23	42	0	2	44	0	0
5	35273632	.	T	C	13	13	26	0	2	28	0	0
5	35273793	.	A	T	26	13	39	0	0	39	0	0
5	35273825	.	C	A	10	26	36	0	2	38	0	0
5	35273838	.	A	C	27	12	39	0	1	40	0	0
5	35274029	.	C	A	22	24	46	0	1	47	0	0
5	35275070	.	G	A	14	28	42	0	0	43	1	0
5	35275103	.	C	T	34	12	46	0	0	46	0	0
5	35276154	.	A	G	31	13	44	0	2	46	0	0
5	35276911	.	C	T	4	14	18	0	14	32	0	0
5	35277256	.	T	A	7	22	29	0	1	30	0	0
5	35277319	.	T	C	15	18	33	0	0	33	0	0
5	35277459	.	T	C	20	26	46	0	3	49	0	0
5	35278597	.	C	T	23	10	33	0	0	33	0	0
5	35278863	.	C	T	10	18	28	0	5	33	0	0
5	35278933	.	T	C	19	0	19	0	15	34	0	0
5	35278977	.	T	G	16	17	33	0	1	34	0	0
5	35279275	.	T	G	16	16	32	1	0	33	0	0
5	35279341	.	G	A	25	22	47	0	0	47	0	0
5	35279387	.	T	G	27	16	43	0	2	45	0	0
5	35279647	.	G	T	12	21	33	0	0	33	0	0
5	35279884	.	G	A	6	9	15	0	0	15	0	0
5	35280157	.	T	C	10	0	10	0	17	27	0	0
5	35280226	.	C	T	13	14	27	0	0	27	0	0
5	35301563	.	A	G	17	15	32	0	0	32	0	0
5	35422411	.	T	C	3	1	4	0	0	4	0	0
5	35422550	.	G	C	5	0	5	0	5	10	0	0
5	35422692	.	C	T	13	7	20	0	0	21	1	0
5	35431641	.	A	G	14	6	20	0	0	20	0	0
5	35431703	.	T	G	9	7	16	0	2	18	0	0
5	35454416	.	C	T	2	12	14	0	9	23	0	0
5	35454464	.	C	T	15	8	23	0	2	25	0	0
5	35478326	.	G	A	6	5	11	0	1	12	0	0
5	35478593	.	G	C	1	5	6	0	1	7	0	0
5	35486917	.	C	A	2	3	5	0	0	5	0	0
5	35487132	.	C	T	11	9	20	0	0	20	0	0
5	35487658	.	G	C	4	4	8	0	0	8	0	0
5	35562419	.	C	T	3	2	5	0	0	5	0	0
5	35607881	.	C	T	3	2	5	0	0	5	0	0
5	35678570	.	G	A	2	2	4	0	5	9	0	0
5	35679080	.	A	G	4	3	7	0	0	7	0	0
5	35683950	.	T	A	3	4	7	0	0	7	0	0
5	35683965	.	C	T	0	6	6	0	4	10	0	0
5	35683991	.	A	G	3	6	9	0	1	10	0	0
5	35684014	.	C	T	4	5	9	0	0	9	0	0
5	35749458	.	A	G	12	8	20	0	1	21	0	0
5	35749470	.	A	G	9	7	16	0	0	16	0	0
5	35749826	.	A	G	4	4	8	0	1	9	0	0
5	35751883	.	G	T	14	8	22	0	0	22	0	0
5	35751970	.	C	T	10	6	16	0	0	16	0	0
5	35751977	.	A	G	8	10	18	0	1	19	0	0
5	35754354	.	A	G	11	11	22	0	0	22	0	0
5	35754481	.	T	G	10	9	19	0	0	19	0	0
5	35877578	.	C	A	2	4	6	0	0	6	0	0
5	35955514	.	T	C	10	16	26	0	2	28	0	0
5	35955534	.	G	T	19	12	31	0	1	32	0	0
5	35955663	.	T	A	12	10	22	0	1	23	0	0
5	35967234	.	C	T	8	10	18	0	2	20	0	0
5	35967270	.	T	A	4	8	12	0	1	13	0	0
5	36274750	.	C	A	3	7	10	0	1	11	0	0
5	36296066	.	G	A	5	6	11	0	1	12	0	0
5	36296114	.	T	C	4	5	9	0	1	10	0	0
5	36416597	.	C	G	12	22	34	0	1	35	0	0
5	36421991	.	G	A	1	10	11	0	5	16	0	0
5	36537182	.	G	A	1	5	6	0	6	12	0	0
5	36551614	.	C	A	7	7	14	0	3	17	0	0
5	36551824	.	C	T	1	16	17	0	12	29	0	0
5	36558059	.	G	A	15	22	37	0	1	38	0	0
5	36558286	.	G	A	24	14	38	0	0	38	0	0
5	36558369	.	G	A	18	8	26	0	1	27	0	0
5	36558441	.	C	T	15	18	33	0	2	35	0	0
5	36563257	.	T	C	12	11	23	0	0	23	0	0
5	36567750	.	C	A	2	11	13	0	8	21	0	0
5	36568071	.	A	T	13	15	28	0	1	29	0	0
5	36570280	.	G	A	11	8	19	0	1	20	0	0
5	36577828	.	T	C	7	5	12	0	1	13	0	0
5	36583575	.	C	T	1	6	7	0	15	22	0	0
5	36583644	.	G	A	8	6	14	1	0	15	0	0
5	36584779	.	G	T	10	5	15	0	0	15	0	0
5	36584985	.	C	T	5	13	18	0	0	18	0	0
5	36585662	.	G	A	9	9	18	0	0	18	0	0
5	36585933	.	C	T	8	7	15	0	0	15	0	0
5	36586190	.	G	A	10	5	15	0	0	15	0	0
5	36586844	.	A	C	8	8	16	0	1	17	0	0
5	36588938	.	A	G	7	8	15	0	2	17	0	0
5	36596278	.	G	A	5	8	13	0	0	13	0	0
5	36596294	.	G	A	3	6	9	0	1	10	0	0
5	36596517	.	C	A	0	8	8	0	10	18	0	0
5	36624638	.	A	T	14	14	28	1	1	30	0	0
5	36625809	.	A	T	22	29	51	0	2	53	0	0
5	36626632	.	A	T	24	16	40	0	6	46	0	0
5	36650153	.	C	A	6	5	11	0	0	11	0	0
5	36650176	.	A	T	3	4	7	0	0	7	0	0
5	36650289	.	T	G	6	3	9	0	0	9	0	0
5	36653522	.	G	A	9	4	13	0	1	14	0	0
5	36653876	.	T	G	7	0	7	0	5	12	0	0
5	36654147	.	G	A	1	6	7	0	7	14	0	0
5	36654334	.	A	T	2	3	5	0	0	5	0	0
5	36654344	.	G	A	3	2	5	0	0	5	0	0
5	36665351	.	C	T	11	10	21	0	0	21	0	0
5	36668321	.	C	T	6	9	15	0	0	15	0	0
5	36673347	.	C	T	6	4	10	0	0	10	0	0
5	36673470	.	C	A	1	3	4	0	1	5	0	0
5	36673609	.	A	G	3	3	6	0	0	6	0	0
5	36673687	.	A	T	3	6	9	0	0	9	0	0
5	36674796	.	G	C	4	5	9	0	0	9	0	0
5	36674831	.	C	T	5	7	12	0	0	12	0	0
5	36695991	.	T	A	1	2	3	0	0	3	0	0
5	36696009	.	A	C	0	2	2	0	1	3	0	0
5	36732199	.	G	C	16	25	41	0	1	42	0	0
5	36732217	.	A	G	16	24	40	0	2	42	0	0
5	36739134	.	T	C	21	17	38	0	1	39	0	0
5	36739310	.	T	A	13	11	24	0	1	25	0	0
5	36739316	.	T	C	14	10	24	0	0	24	0	0
5	36739352	.	T	A	14	11	25	0	0	25	0	0
5	36739361	.	T	C	11	9	20	0	1	21	0	0
5	36801510	.	G	A	0	12	12	0	7	19	0	0
5	36802452	.	A	G	8	0	8	0	8	16	0	0
5	36805119	.	A	G	14	12	26	0	0	26	0	0
5	36833814	.	G	A	1	2	3	0	0	3	0	0
5	36851191	.	C	T	7	9	16	0	0	16	0	0
5	36852564	.	A	G	4	0	4	0	7	11	0	0
5	36852808	.	T	A	11	10	21	0	1	22	0	0
5	36853849	.	C	G	19	6	25	0	0	26	1	0
5	36897226	.	G	T	1	2	3	0	0	3	0	0
5	36897361	.	T	A	4	3	7	0	0	7	0	0
5	36898476	.	C	T	23	24	47	0	1	48	0	0
5	36898668	.	A	G	34	1	35	0	18	53	0	0
5	36901003	.	T	G	11	16	27	0	1	28	0	0
5	36902610	.	A	G	24	1	25	0	19	44	0	0
5	36902628	.	T	C	18	20	38	0	2	40	0	0
5	36903072	.	C	T	29	17	46	0	1	47	0	0
5	36903131	.	C	T	21	29	50	0	1	51	0	0
5	36907111	.	G	A	8	2	10	0	0	10	0	0
5	36907117	.	C	T	7	3	10	0	0	10	0	0
5	36908004	.	G	T	21	25	46	0	1	47	0	0
5	36908034	.	T	C	22	29	51	0	2	53	0	0
5	36913570	.	A	G	4	2	6	0	0	6	0	0
5	36913916	.	A	T	3	3	6	0	0	6	0	0
5	36916257	.	C	A	0	4	4	0	4	8	0	0
5	36916615	.	C	T	5	7	12	0	0	12	0	0
5	36945327	.	T	G	4	9	13	0	2	15	0	0
5	36945378	.	T	A	17	14	31	7	3	41	0	0
5	36945518	.	T	G	28	20	48	0	2	50	0	0
5	36945608	.	G	A	34	36	70	0	1	71	0	0
5	36945680	.	T	C	37	39	76	0	1	77	0	0
5	36945927	.	A	C	34	30	64	0	1	65	0	0
5	36945937	.	C	T	38	27	65	0	0	65	0	0
5	36946133	.	A	G	22	41	63	0	4	67	0	0
5	36946244	.	A	G	40	33	73	0	12	85	0	0
5	36996638	.	A	G	21	1	22	0	21	43	0	0
5	36997133	.	A	G	13	17	30	0	1	31	0	0
5	37032095	.	A	G	17	18	35	0	2	37	0	0
5	37032225	.	C	G	13	14	27	0	1	28	0	0
5	37032280	.	C	G	12	10	22	0	0	22	0	0
5	37032339	.	A	G	12	0	12	0	7	19	0	0
5	37032446	.	T	C	17	13	30	0	2	32	0	0
5	37032500	.	A	G	14	17	31	0	2	33	0	0
5	37032717	.	A	C	14	17	31	0	2	33	0	0
5	37032782	.	G	A	18	25	43	0	2	45	0	0
5	37032959	.	A	G	11	18	29	0	1	30	0	0
5	37033688	.	C	T	10	16	26	0	0	26	0	0
5	37036421	.	G	A	5	15	20	0	0	20	0	0
5	37036562	.	A	T	12	11	23	0	1	24	0	0
5	37037232	.	A	G	8	10	18	0	0	18	0	0
5	37037256	.	G	T	7	12	19	0	0	19	0	0
5	37037284	.	C	T	10	12	22	0	0	22	0	0
5	37037325	.	G	A	6	4	10	0	0	10	0	0
5	37037392	.	G	T	3	4	7	0	0	7	0	0
5	37037436	.	G	T	1	7	8	0	3	11	0	0
5	37037489	.	A	C	7	12	19	0	0	19	0	0
5	37037669	.	T	G	15	14	29	0	1	30	0	0
5	37037742	.	A	T	13	22	35	0	2	37	0	0
5	37037987	.	A	C	12	10	22	0	1	23	0	0
5	37038017	.	T	C	8	6	14	0	1	15	0	0
5	37065508	.	T	C	22	15	37	0	0	37	0	0
5	37065537	.	T	C	21	9	30	0	1	31	0	0
5	37065729	.	C	T	23	8	31	0	1	39	7	0
5	37092021	.	C	T	3	6	9	0	0	9	0	0
5	37092067	.	T	C	4	7	11	0	0	11	0	0
5	37093389	.	T	A	2	4	6	0	1	7	0	0
5	37094944	.	T	A	8	5	13	0	1	14	0	0
5	37095008	.	A	C	9	5	14	1	0	15	0	0
5	37095066	.	A	C	7	4	11	1	0	12	0	0
5	37141356	.	T	G	2	2	4	0	0	4	0	0
5	37247535	.	G	A	3	3	6	0	0	6	0	0
5	37277355	.	A	G	1	3	4	0	0	4	0	0
5	37277534	.	A	G	2	2	4	0	0	4	0	0
5	37280125	.	A	G	1	5	6	0	0	6	0	0
5	37280343	.	T	G	4	6	10	0	0	10	0	0
5	37280856	.	C	T	1	3	4	0	0	4	0	0
5	37286325	.	A	G	1	0	1	0	3	4	0	0
5	37286590	.	G	A	1	7	8	0	0	8	0	0
5	37295469	.	C	T	5	7	12	0	0	12	0	0
5	37295646	.	C	T	12	7	19	0	0	19	0	0
5	37296298	.	C	T	11	6	17	0	1	18	0	0
5	37299125	.	G	A	13	9	22	0	3	25	0	0
5	37301236	.	G	A	10	9	19	0	1	20	0	0
5	37301249	.	C	T	9	9	18	0	2	20	0	0
5	37301282	.	C	T	11	9	20	0	2	22	0	0
5	37301505	.	A	G	8	10	18	0	1	19	0	0
5	37301783	.	A	G	14	10	24	0	4	28	0	0
5	37304028	.	T	C	11	7	18	0	0	18	0	0
5	37304070	.	G	T	9	5	14	0	1	15	0	0
5	37307921	.	C	G	16	18	34	0	0	34	0	0
5	37309734	.	A	G	17	17	34	0	2	36	0	0
5	37309881	.	C	T	19	20	39	0	1	40	0	0
5	37312520	.	T	A	20	18	38	0	4	42	0	0
5	37312556	.	A	T	19	18	37	0	4	41	0	0
5	37312577	.	A	G	17	0	17	0	17	34	0	0
5	37312681	.	C	A	8	11	19	0	0	19	0	0
5	37316716	.	G	C	10	0	10	0	19	29	0	0
5	37316743	.	A	G	12	15	27	0	0	27	0	0
5	37316954	.	A	G	14	19	33	0	1	34	0	0
5	37320254	.	A	G	9	9	18	0	0	18	0	0
5	37321251	.	C	G	0	17	17	0	10	27	0	0
5	37321488	.	G	A	7	9	16	0	0	16	0	0
5	37321519	.	C	T	7	11	18	0	0	18	0	0
5	37323690	.	C	T	18	12	30	0	0	30	0	0
5	37380533	.	T	C	12	5	17	0	2	19	0	0
5	37380701	.	T	G	11	6	17	0	1	18	0	0
5	37406445	.	G	A	0	7	7	0	14	21	0	0
5	37413846	.	C	T	9	9	18	0	1	19	0	0
5	37422993	.	C	T	11	10	21	0	1	22	0	0
5	37422999	.	A	T	9	10	19	0	0	19	0	0
5	37423298	.	G	A	0	6	6	0	16	22	0	0
5	37439388	.	C	T	3	17	20	0	0	20	0	0
5	37439418	.	C	T	6	14	20	0	0	20	0	0
5	37439505	.	T	C	8	7	15	0	1	16	0	0
5	37439517	.	A	C	9	8	17	0	0	17	0	0
5	37439891	.	T	C	18	11	29	0	0	29	0	0
5	37494630	.	A	T	2	5	7	0	0	7	0	0
5	37494666	.	C	T	1	5	6	0	0	6	0	0
5	37494694	.	C	T	1	3	4	0	0	4	0	0
5	37495042	.	T	C	1	3	4	0	0	4	0	0
5	37504340	.	T	A	5	2	7	0	0	7	0	0
5	37504422	.	T	C	3	5	8	0	1	9	0	0
5	37504439	.	T	A	2	3	5	0	1	6	0	0
5	37504470	.	C	A	3	3	6	0	0	6	0	0
5	37504531	.	T	C	6	6	12	0	1	13	0	0
5	37504720	.	T	C	7	4	11	0	0	11	0	0
5	37504913	.	C	T	5	7	12	0	0	12	0	0
5	37504927	.	G	T	7	7	14	0	0	14	0	0
5	37504966	.	G	A	5	9	14	0	2	16	0	0
5	37507823	.	T	C	10	14	24	0	1	25	0	0
5	37507901	.	C	T	9	13	22	0	0	22	0	0
5	37508303	.	T	C	3	6	9	0	0	9	0	0
5	37508828	.	C	T	2	10	12	0	0	12	0	0
5	37508832	.	T	G	2	9	11	0	0	11	0	0
5	37509093	.	A	T	2	1	3	0	0	3	0	0
5	37509102	.	T	C	2	3	5	0	0	5	0	0
5	37509156	.	G	A	2	2	4	0	0	4	0	0
5	37509285	.	T	C	13	10	23	0	1	24	0	0
5	37509296	.	G	C	13	10	23	0	1	24	0	0
5	37509374	.	T	A	4	6	10	0	0	10	0	0
5	37509428	.	T	G	3	5	8	0	0	9	1	0
5	37509703	.	C	T	10	18	28	0	1	29	0	0
5	37509766	.	G	A	2	14	16	0	9	25	0	0
5	37509857	.	A	G	7	7	14	0	0	14	0	0
5	37509916	.	A	G	6	5	11	0	0	11	0	0
5	37510292	.	C	T	4	9	13	0	0	13	0	0
5	37510293	.	T	C	4	9	13	0	0	13	0	0
5	37510496	.	G	T	6	15	21	0	0	21	0	0
5	37510565	.	A	T	9	12	21	0	0	22	1	0
5	37564513	.	G	A	3	2	5	0	0	5	0	0
5	37580857	.	C	T	1	3	4	0	1	5	0	0
5	37584220	.	T	A	2	4	6	0	0	6	0	0
5	37585024	.	T	A	1	3	4	0	0	4	0	0
5	37680403	.	G	A	0	20	20	0	14	34	0	0
5	37680600	.	C	T	16	9	25	0	0	25	0	0
5	37684289	.	G	A	13	12	25	0	1	26	0	0
5	37686590	.	C	T	25	16	41	0	1	42	0	0
5	37688077	.	C	T	12	16	28	0	0	28	0	0
5	37688371	.	C	T	25	23	48	0	1	49	0	0
5	37688560	.	C	G	11	12	23	0	1	24	0	0
5	37688878	.	A	C	24	21	45	0	0	45	0	0
5	37691459	.	T	C	15	19	34	0	2	36	0	0
5	37691516	.	C	T	9	22	31	0	1	32	0	0
5	37692198	.	C	T	18	25	43	0	0	43	0	0
5	37694568	.	A	C	17	14	31	0	0	31	0	0
5	37695528	.	A	G	13	10	23	0	1	24	0	0
5	37696582	.	G	A	12	12	24	0	2	26	0	0
5	37697134	.	C	T	15	30	45	0	2	47	0	0
5	37699115	.	A	G	25	19	44	0	0	44	0	0
5	37699373	.	C	T	15	18	33	0	2	35	0	0
5	37700687	.	C	A	16	19	35	0	1	36	0	0
5	37700905	.	C	T	20	17	37	0	1	38	0	0
5	37701281	.	C	T	17	13	30	0	5	36	1	0
5	37703176	.	G	A	2	23	25	0	12	37	0	0
5	37703180	.	G	A	21	13	34	0	1	35	0	0
5	37707190	.	G	A	20	20	40	0	1	41	0	0
5	37729393	.	A	T	1	2	3	0	0	3	0	0
5	37747276	.	C	T	7	6	13	0	0	13	0	0
5	37749854	.	G	C	6	7	13	0	1	14	0	0
5	37754583	.	A	G	2	4	6	0	0	6	0	0
5	37757331	.	A	G	4	0	4	0	4	8	0	0
5	37757505	.	C	T	3	5	8	0	0	8	0	0
5	37757677	.	C	T	10	10	20	0	1	21	0	0
5	37807668	.	C	T	1	2	3	0	0	3	0	0
5	37807783	.	G	C	0	3	3	0	2	5	0	0
5	37807834	.	A	G	3	2	5	0	0	5	0	0
5	37812090	.	C	T	3	4	7	0	1	8	0	0
5	37851989	.	T	C	5	2	7	0	0	7	0	0
5	37912292	.	T	A	16	19	35	0	1	36	0	0
5	37912859	.	A	C	11	10	21	0	1	22	0	0
5	37918855	.	G	A	8	5	13	0	1	14	0	0
5	37918882	.	C	T	1	7	8	0	9	17	0	0
5	37918932	.	A	T	15	8	23	0	1	24	0	0
5	37919253	.	A	T	6	4	10	0	1	11	0	0
5	37919258	.	T	C	6	0	6	0	5	11	0	0
5	37919293	.	C	T	7	7	14	0	0	14	0	0
5	37926362	.	C	T	1	5	6	0	7	13	0	0
5	37933891	.	A	G	6	6	12	0	0	12	0	0
5	37933914	.	A	G	6	4	10	0	0	10	0	0
5	37933930	.	C	G	2	3	5	0	6	11	0	0
5	37934058	.	G	A	15	8	23	0	0	23	0	0
5	37935468	.	A	C	9	3	12	0	0	12	0	0
5	37948723	.	T	C	1	3	4	0	0	4	0	0
5	37948752	.	G	A	1	2	3	0	0	3	0	0
5	37963259	.	C	T	11	17	28	0	3	31	0	0
5	37968912	.	T	G	9	15	24	0	0	24	0	0
5	37970764	.	C	T	15	14	29	0	0	29	0	0
5	37970773	.	A	T	14	11	25	0	0	25	0	0
5	37970818	.	T	G	8	1	9	0	9	18	0	0
5	37981997	.	T	C	1	0	1	0	2	3	0	0
5	37982040	.	A	G	3	4	7	0	0	7	0	0
5	37982156	.	G	C	4	0	4	0	3	7	0	0
5	37987114	.	A	T	8	5	13	1	1	15	0	0
5	37987301	.	T	C	8	6	14	0	1	15	0	0
5	37987325	.	C	T	1	4	5	0	7	12	0	0
5	37987369	.	G	A	5	2	7	0	0	7	0	0
5	37989128	.	G	C	9	0	9	0	12	21	0	0
5	37989135	.	A	G	8	12	20	0	0	20	0	0
5	37989204	.	A	G	9	13	22	0	0	22	0	0
5	37989325	.	G	A	6	13	19	0	0	19	0	0
5	37989379	.	G	T	9	9	18	0	1	19	0	0
5	37989443	.	A	C	13	17	30	0	2	32	0	0
5	37989447	.	A	G	13	16	29	0	2	31	0	0
5	37991350	.	T	A	10	12	22	0	1	23	0	0
5	37991535	.	T	G	8	4	12	0	0	12	0	0
5	37991566	.	C	A	1	6	7	0	7	14	0	0
5	37991756	.	C	T	8	3	11	0	1	12	0	0
5	37991757	.	C	T	9	3	12	0	0	12	0	0
5	37992120	.	T	C	3	5	8	0	0	9	1	0
5	37993446	.	G	T	2	6	8	0	0	8	0	0
5	37994266	.	G	C	4	5	9	1	0	10	0	0
5	37997251	.	T	A	6	5	11	0	0	11	0	0
5	38302158	.	C	A	5	27	32	0	0	32	0	0
5	38302159	.	A	C	17	15	32	0	1	33	0	0
5	38390672	.	C	T	3	6	9	0	0	9	0	0
5	39386709	.	T	A	2	2	4	0	0	4	0	0
5	39386721	.	A	T	2	2	4	0	0	4	0	0
5	39386752	.	T	A	1	2	3	0	0	3	0	0
5	39389327	.	G	A	2	3	5	0	0	5	0	0
5	39389340	.	T	C	2	2	4	0	0	4	0	0
5	39461249	.	G	A	2	2	4	0	1	5	0	0
5	39504190	.	C	A	9	15	24	0	1	25	0	0
5	39504307	.	C	A	7	9	16	0	0	16	0	0
5	39506614	.	G	T	9	5	14	0	0	14	0	0
5	39508009	.	C	T	20	19	39	0	6	45	0	0
5	39508059	.	T	A	22	16	38	0	2	40	0	0
5	39508589	.	A	G	5	2	7	0	0	7	0	0
5	39673363	.	C	T	6	3	9	0	0	9	0	0
5	39707424	.	G	A	8	5	13	0	0	13	0	0
5	39707825	.	G	A	10	6	16	0	0	16	0	0
5	39708565	.	A	T	17	10	27	0	1	28	0	0
5	39708576	.	G	T	18	11	29	0	2	31	0	0
5	39708658	.	T	C	20	9	29	0	0	29	0	0
5	39708686	.	G	A	26	7	33	0	0	33	0	0
5	39708711	.	G	A	20	11	31	0	1	33	1	0
5	39715249	.	G	A	14	15	29	0	1	30	0	0
5	39730575	.	C	T	6	13	19	0	0	19	0	0
5	40040058	.	T	C	10	0	10	0	9	19	0	0
5	40040065	.	G	T	10	7	17	0	1	18	0	0
5	40040152	.	A	G	8	8	16	0	1	17	0	0
5	40054407	.	C	G	18	16	34	0	0	34	0	0
5	40059610	.	A	G	18	24	42	0	2	44	0	0
5	40059811	.	A	C	18	1	19	0	29	48	0	0
5	40059860	.	T	C	18	27	45	0	1	46	0	0
5	40062094	.	G	A	19	13	32	0	3	35	0	0
5	40062121	.	G	T	15	16	31	0	2	33	0	0
5	40062276	.	T	C	14	1	15	0	17	32	0	0
5	40062351	.	A	G	17	12	29	0	6	35	0	0
5	40062396	.	C	A	10	12	22	0	2	24	0	0
5	40069356	.	C	T	24	15	39	0	2	41	0	0
5	40069741	.	C	T	11	16	27	0	0	27	0	0
5	40077300	.	G	A	15	11	26	0	2	28	0	0
5	40078717	.	C	A	23	16	39	0	1	40	0	0
5	40093858	.	G	A	9	16	25	0	0	25	0	0
5	40095602	.	C	T	0	9	9	0	8	17	0	0
5	40097502	.	A	G	15	10	25	0	1	26	0	0
5	40097505	.	A	G	16	9	25	0	1	26	0	0
5	40097831	.	A	G	6	11	17	0	1	18	0	0
5	40111613	.	G	T	9	4	13	0	1	14	0	0
5	40203540	.	G	A	6	9	15	0	0	15	0	0
5	40206117	.	G	A	9	6	15	0	0	15	0	0
5	40206358	.	A	C	10	10	20	0	1	21	0	0
5	40273166	.	C	A	2	2	4	0	0	4	0	0
5	40273468	.	T	C	5	1	6	0	1	7	0	0
5	40273510	.	G	T	2	3	5	0	0	5	0	0
5	40273606	.	C	T	1	3	4	0	4	8	0	0
5	40273727	.	T	A	4	3	7	0	1	8	0	0
5	40273864	.	G	A	1	2	3	0	2	5	0	0
5	40291079	.	A	G	3	2	5	0	0	5	0	0
5	40291229	.	A	G	2	9	11	0	1	12	0	0
5	40291739	.	C	A	0	5	5	0	2	7	0	0
5	40292111	.	C	T	1	3	4	0	3	7	0	0
5	40501035	.	G	A	19	21	40	0	2	42	0	0
5	40505074	.	C	A	1	3	4	0	0	4	0	0
5	40505124	.	C	T	3	3	6	0	5	11	0	0
5	40506670	.	G	A	1	8	9	0	0	9	0	0
5	40507577	.	C	A	4	4	8	0	0	8	0	0
5	40508604	.	C	A	3	6	9	0	0	9	0	0
5	40728852	.	A	G	2	3	5	0	0	5	0	0
5	40729147	.	T	C	5	3	8	0	0	8	0	0
5	40729408	.	G	A	6	11	17	0	0	17	0	0
5	40729618	.	A	G	8	7	15	0	1	16	0	0
5	40732293	.	A	G	6	2	8	0	0	8	0	0
5	40732341	.	T	A	8	4	12	0	0	12	0	0
5	42067486	.	T	C	15	17	32	11	1	44	0	0
5	42067588	.	G	A	14	6	20	41	0	61	0	0
5	42094464	.	C	A	3	6	9	1	1	11	0	0
5	43073005	.	A	T	8	6	14	0	0	14	0	0
5	43073019	.	T	C	9	6	15	0	0	15	0	0
5	43073116	.	T	C	5	6	11	0	1	12	0	0
5	43082997	.	A	G	12	0	12	0	12	24	0	0
5	43083084	.	A	C	7	9	16	0	0	16	0	0
5	43428514	.	A	G	0	3	3	0	1	4	0	0
5	43479236	.	C	T	1	3	4	0	3	7	0	0
5	43479449	.	G	A	1	3	4	0	0	4	0	0
5	43479488	.	G	A	1	6	7	0	4	11	0	0
5	43479880	.	A	C	5	3	8	0	0	8	0	0
5	43602425	.	C	T	1	5	6	0	1	7	0	0
5	43602431	.	T	C	3	4	7	0	0	7	0	0
5	43603689	.	A	T	2	3	5	0	0	5	0	0
5	43617277	.	C	G	14	11	25	0	0	25	0	0
5	43617295	.	C	G	15	9	24	0	0	24	0	0
5	43617692	.	T	C	16	0	16	0	15	31	0	0
5	43626060	.	C	T	3	11	14	0	6	20	0	0
5	43629881	.	G	C	5	0	5	0	8	13	0	0
5	43629884	.	T	C	5	0	5	0	8	13	0	0
5	43638710	.	C	T	1	2	3	0	5	8	0	0
5	43682888	.	C	A	3	6	9	0	0	9	0	0
5	43682889	.	T	G	3	6	9	0	0	9	0	0
5	43862663	.	T	A	6	2	8	1	0	9	0	0
5	43863986	.	A	G	5	2	7	0	0	7	0	0
5	44795297	.	A	G	8	0	8	0	14	22	0	0
5	44795308	.	A	G	15	5	20	0	2	22	0	0
5	44930053	.	T	A	1	7	8	0	0	8	0	0
5	45748528	.	T	C	13	8	21	0	0	21	0	0
5	45748593	.	T	C	8	8	16	0	0	16	0	0
5	46492303	.	T	C	2	1	3	0	1	4	0	0
5	48986398	.	T	C	14	30	44	0	2	46	0	0
5	50520057	.	C	A	16	4	20	0	1	21	0	0
5	51375102	.	G	A	2	2	4	0	0	4	0	0
5	51522426	.	A	T	5	4	9	0	0	9	0	0
5	51525744	.	G	A	4	4	8	0	0	8	0	0
5	51525750	.	T	C	4	5	9	1	0	10	0	0
5	51575586	.	C	T	5	5	10	0	0	10	0	0
5	51575756	.	C	T	7	5	12	0	1	13	0	0
5	51575827	.	C	T	7	6	13	0	0	13	0	0
5	51578163	.	T	C	6	3	9	0	1	10	0	0
5	51578289	.	A	T	6	8	14	0	0	14	0	0
5	51579025	.	G	A	0	5	5	0	7	12	0	0
5	51616474	.	A	T	2	4	6	0	0	6	0	0
5	51617022	.	T	C	8	11	19	0	0	19	0	0
5	51775052	.	A	G	4	4	8	0	1	9	0	0
5	51775291	.	A	T	14	14	28	0	4	32	0	0
5	51775391	.	A	G	14	21	35	0	0	35	0	0
5	51775501	.	T	G	17	20	37	0	1	38	0	0
5	51775715	.	G	A	19	11	30	0	4	34	0	0
5	51775805	.	A	G	18	14	32	0	4	36	0	0
5	51775837	.	G	C	15	13	28	0	1	29	0	0
5	51775997	.	A	T	23	19	42	0	1	43	0	0
5	51776171	.	T	C	13	14	27	0	1	28	0	0
5	51776183	.	C	A	14	10	24	0	4	28	0	0
5	51789264	.	T	G	8	8	16	0	1	17	0	0
5	51789286	.	A	T	9	6	15	0	0	15	0	0
5	51789428	.	A	G	4	5	9	0	0	9	0	0
5	51789580	.	C	G	0	2	2	0	4	6	0	0
5	51789646	.	T	C	6	0	6	0	4	10	0	0
5	51793031	.	C	T	3	20	23	0	21	44	0	0
5	51893952	.	A	G	13	13	26	0	0	26	0	0
5	51898868	.	C	T	7	8	15	0	0	15	0	0
5	51913733	.	C	T	1	3	4	0	0	4	0	0
5	51914528	.	G	A	0	2	2	0	2	4	0	0
5	51932684	.	T	C	2	3	5	0	0	5	0	0
5	51932690	.	C	T	2	2	4	0	0	4	0	0
5	51942131	.	G	A	3	2	5	0	0	5	0	0
5	51947551	.	T	C	15	5	20	0	0	20	0	0
5	51947621	.	T	A	3	9	12	0	2	14	0	0
5	51947759	.	G	T	9	5	14	0	0	14	0	0
5	51947852	.	A	T	8	4	12	0	0	12	0	0
5	51947927	.	T	C	5	0	5	0	5	10	0	0
5	51948076	.	G	A	5	5	10	0	0	10	0	0
5	51948189	.	T	G	4	7	11	0	0	11	0	0
5	51948222	.	G	C	8	3	11	0	1	12	0	0
5	51948389	.	A	T	10	4	14	0	1	15	0	0
5	51948436	.	G	T	5	6	11	0	1	12	0	0
5	51948762	.	G	A	10	3	13	0	2	15	0	0
5	51948858	.	T	A	7	8	15	0	0	15	0	0
5	51948946	.	T	C	17	0	17	0	13	30	0	0
5	51949071	.	T	A	12	10	22	0	0	22	0	0
5	51949896	.	G	A	5	5	10	0	1	11	0	0
5	51949926	.	T	C	4	3	7	0	1	8	0	0
5	51950054	.	T	C	10	0	10	0	11	21	0	0
5	51958596	.	G	A	5	5	10	0	2	12	0	0
5	51985355	.	G	A	8	4	12	0	0	12	0	0
5	51985456	.	G	A	6	6	12	0	0	12	0	0
5	52005851	.	G	T	7	8	15	0	0	15	0	0
5	52005893	.	C	T	4	8	12	0	0	12	0	0
5	52007921	.	C	T	0	7	7	0	7	14	0	0
5	52007930	.	C	T	7	5	12	0	1	13	0	0
5	52008999	.	A	G	7	6	13	0	0	13	0	0
5	52039493	.	A	G	4	3	7	2	0	9	0	0
5	52068452	.	G	A	6	7	13	0	0	13	0	0
5	52121940	.	T	G	7	6	13	0	0	13	0	0
5	52121945	.	C	T	6	4	10	0	1	11	0	0
5	52122021	.	C	T	4	5	9	0	0	9	0	0
5	52122052	.	G	A	6	6	12	0	1	13	0	0
5	52122682	.	C	T	7	2	9	0	0	9	0	0
5	52122841	.	T	G	3	6	9	0	0	9	0	0
5	52123862	.	C	T	11	7	18	0	2	20	0	0
5	52123903	.	A	G	8	6	14	0	0	14	0	0
5	52124144	.	C	A	5	14	19	0	0	19	0	0
5	52124259	.	G	A	10	8	18	0	0	18	0	0
5	52132672	.	G	A	14	9	23	0	1	24	0	0
5	52132966	.	A	G	8	6	14	0	1	15	0	0
5	52190948	.	G	T	2	3	5	0	0	5	0	0
5	52190969	.	A	G	2	2	4	0	1	5	0	0
5	52191263	.	T	C	4	6	10	0	1	11	0	0
5	52191270	.	C	T	7	4	11	0	0	11	0	0
5	52191329	.	T	G	2	3	5	0	0	5	0	0
5	52191617	.	C	T	3	8	11	0	0	11	0	0
5	52191715	.	A	C	7	3	10	0	1	11	0	0
5	52191722	.	T	C	2	0	2	0	8	10	0	0
5	52191987	.	A	G	3	2	5	0	0	5	0	0
5	52192361	.	T	C	7	5	12	0	0	12	0	0
5	52192364	.	A	G	7	5	12	0	0	12	0	0
5	52192649	.	A	C	1	4	5	0	0	5	0	0
5	52192668	.	C	T	0	5	5	0	1	6	0	0
5	52193154	.	G	A	2	4	6	0	1	7	0	0
5	52193240	.	A	T	4	2	6	0	1	7	0	0
5	52193249	.	T	G	3	3	6	0	0	6	0	0
5	52193507	.	A	T	11	10	21	0	0	21	0	0
5	52193508	.	T	G	11	10	21	0	0	21	0	0
5	52201265	.	C	T	5	6	11	0	1	12	0	0
5	52211507	.	C	G	4	2	6	0	1	7	0	0
5	52212199	.	G	T	2	5	7	0	0	7	0	0
5	52227269	.	T	A	2	3	5	0	0	5	0	0
5	52227404	.	T	C	2	0	2	0	2	4	0	0
5	52227660	.	T	A	6	2	8	0	0	8	0	0
5	52234672	.	T	C	1	3	4	0	1	5	0	0
5	52234729	.	G	A	1	5	6	0	0	6	0	0
5	52235362	.	C	T	0	3	3	0	2	5	0	0
5	52235385	.	C	T	5	2	7	0	1	8	0	0
5	52236775	.	G	T	3	2	5	0	0	5	0	0
5	52237001	.	T	G	3	3	6	0	0	6	0	0
5	52237270	.	A	T	2	4	6	0	0	6	0	0
5	52239374	.	C	T	2	2	4	0	0	4	0	0
5	52240220	.	T	C	1	4	5	0	0	5	0	0
5	52257463	.	T	C	5	9	14	0	3	17	0	0
5	52257530	.	A	G	12	14	26	0	0	26	0	0
5	52257905	.	A	G	12	12	24	0	1	25	0	0
5	52258036	.	G	A	14	8	22	0	0	22	0	0
5	52258068	.	C	T	2	8	10	0	14	24	0	0
5	52258152	.	C	A	16	16	32	0	2	34	0	0
5	52258653	.	C	G	9	2	11	0	0	11	0	0
5	52258772	.	A	T	9	7	16	0	0	16	0	0
5	52258801	.	T	A	12	6	18	0	1	19	0	0
5	52258995	.	C	G	11	4	15	0	0	15	0	0
5	52259289	.	A	G	7	10	17	0	1	18	0	0
5	52259503	.	G	T	10	7	17	1	3	21	0	0
5	52259887	.	G	A	8	15	23	0	2	25	0	0
5	52733496	.	A	T	3	0	3	0	10	13	0	0
5	54459325	.	T	C	11	4	15	0	0	15	0	0
5	54459337	.	T	C	2	13	15	0	0	15	0	0
5	54459672	.	T	C	6	3	9	0	0	9	0	0
5	54459740	.	T	C	6	2	8	0	0	8	0	0
5	54459746	.	T	C	3	4	7	0	2	9	0	0
5	56270933	.	T	C	4	2	6	0	0	6	0	0
5	56277951	.	A	T	7	5	12	0	0	12	0	0
5	56280651	.	G	C	5	5	10	0	1	11	0	0
5	56287987	.	T	A	2	4	6	0	0	6	0	0
5	56289713	.	G	A	2	4	6	0	1	7	0	0
5	56289841	.	C	T	3	5	8	0	0	8	0	0
5	56289925	.	G	A	0	5	5	0	1	6	0	0
5	56290079	.	C	T	3	2	5	0	0	5	0	0
5	56294045	.	C	T	3	5	8	0	0	8	0	0
5	56294160	.	T	C	3	7	10	1	0	11	0	0
5	56294202	.	C	T	4	3	7	1	1	9	0	0
5	56309445	.	C	T	16	15	31	0	1	32	0	0
5	56309506	.	G	A	9	11	20	0	2	22	0	0
5	56309677	.	C	A	12	9	21	0	0	21	0	0
5	56313246	.	C	T	22	19	41	0	3	44	0	0
5	56317470	.	C	T	11	27	38	0	2	40	0	0
5	56317473	.	T	G	12	27	39	0	2	41	0	0
5	56343032	.	C	T	0	12	12	0	17	29	0	0
5	56343053	.	G	A	14	12	26	0	2	28	0	0
5	56343095	.	C	T	6	7	13	0	1	14	0	0
5	56345036	.	G	C	19	11	30	0	0	30	0	0
5	56345157	.	C	T	12	11	23	0	0	23	0	0
5	56355129	.	C	T	15	11	26	0	2	28	0	0
5	56360829	.	G	A	16	14	30	0	0	30	0	0
5	56362376	.	C	T	9	12	21	0	0	21	0	0
5	56375262	.	G	T	15	17	32	0	0	32	0	0
5	56376648	.	A	G	3	4	7	0	1	8	0	0
5	56378093	.	C	T	11	6	17	0	0	17	0	0
5	56378108	.	A	G	12	3	15	0	1	16	0	0
5	56381655	.	G	A	10	3	13	4	0	17	0	0
5	56381781	.	G	A	5	8	13	1	0	14	0	0
5	56390247	.	G	A	4	5	9	0	0	9	0	0
5	56390253	.	G	A	4	4	8	0	0	8	0	0
5	56405852	.	A	G	6	7	13	0	0	13	0	0
5	56405867	.	G	A	6	6	12	0	0	12	0	0
5	56412062	.	G	A	5	5	10	0	1	11	0	0
5	56412248	.	G	A	4	7	11	0	0	11	0	0
5	56915422	.	G	A	13	4	17	0	1	18	0	0
5	56918884	.	G	T	3	8	11	0	1	12	0	0
5	56921906	.	G	A	6	3	9	0	0	9	0	0
5	56924356	.	C	T	2	7	9	0	1	10	0	0
5	56924460	.	T	C	2	3	5	0	0	5	0	0
5	56924686	.	C	T	6	6	12	0	0	12	0	0
5	56935240	.	A	G	4	4	8	0	0	8	0	0
5	56935245	.	C	T	4	4	8	0	0	8	0	0
5	56937131	.	C	A	2	2	4	0	0	4	0	0
5	56942864	.	A	G	2	2	4	0	0	4	0	0
5	56942904	.	C	T	1	5	6	0	1	7	0	0
5	56942940	.	A	T	2	4	6	0	0	6	0	0
5	56943513	.	C	T	1	3	4	0	0	4	0	0
5	56943528	.	T	A	1	2	3	0	0	3	0	0
5	56951034	.	G	A	7	7	14	0	0	14	0	0
5	56951229	.	C	T	15	11	26	0	2	28	0	0
5	56951769	.	A	G	2	7	9	0	1	10	0	0
5	56952141	.	T	C	17	1	18	0	22	40	0	0
5	56952316	.	A	G	19	15	34	0	0	34	0	0
5	56955460	.	C	T	16	14	30	1	0	31	0	0
5	56955508	.	T	G	20	20	40	0	1	41	0	0
5	56956359	.	G	A	17	17	34	0	0	34	0	0
5	56958516	.	C	T	2	9	11	0	14	25	0	0
5	56961194	.	A	G	12	10	22	0	0	22	0	0
5	56961348	.	G	A	8	9	17	0	0	17	0	0
5	56964475	.	G	A	4	8	12	0	0	12	0	0
5	57217380	.	G	C	6	7	13	0	1	14	0	0
5	57217391	.	C	G	4	8	12	0	0	12	0	0
5	57219496	.	G	A	8	4	12	0	0	12	0	0
5	57219736	.	T	C	6	4	10	0	0	10	0	0
5	57219789	.	C	T	7	2	9	0	2	11	0	0
5	57219938	.	G	C	0	8	8	0	7	15	0	0
5	57219941	.	G	A	6	9	15	0	2	17	0	0
5	57220033	.	T	C	7	4	11	0	0	11	0	0
5	57220108	.	G	A	1	9	10	0	9	19	0	0
5	57220190	.	A	G	5	0	5	0	17	22	0	0
5	57220324	.	T	C	3	8	11	0	1	12	0	0
5	57225343	.	C	T	6	12	18	0	1	19	0	0
5	57225496	.	C	G	14	0	14	0	9	23	0	0
5	57231089	.	C	T	16	17	33	0	1	34	0	0
5	57243648	.	A	G	1	2	3	0	1	4	0	0
5	57244075	.	T	G	0	2	2	0	1	3	0	0
5	57258282	.	C	T	1	3	4	0	3	7	0	0
5	57258300	.	C	A	0	3	3	0	4	7	0	0
5	57264605	.	G	A	1	2	3	0	0	3	0	0
5	57272967	.	G	A	1	3	4	0	0	4	0	0
5	57325118	.	C	A	27	40	67	0	0	67	0	0
5	57325123	.	G	T	26	41	67	0	1	68	0	0
5	57325204	.	T	G	32	1	33	0	32	65	0	0
5	57325210	.	G	A	34	33	67	0	2	69	0	0
5	57325381	.	A	T	27	25	52	0	2	54	0	0
5	57325537	.	C	T	5	4	9	0	2	11	0	0
5	57347626	.	C	T	6	2	8	0	0	8	0	0
5	57347737	.	T	C	3	4	7	0	0	7	0	0
5	57351036	.	A	G	3	0	3	0	2	5	0	0
5	57352180	.	G	T	4	2	6	0	0	6	0	0
5	57352295	.	A	T	4	2	6	0	0	6	0	0
5	57354166	.	T	C	5	2	7	0	0	7	0	0
5	57354452	.	C	T	4	9	13	0	1	14	0	0
5	57354552	.	C	T	5	6	11	0	0	11	0	0
5	57354786	.	G	T	3	3	6	0	3	9	0	0
5	57359699	.	G	T	5	3	8	0	1	9	0	0
5	57361541	.	T	C	4	8	12	0	0	12	0	0
5	57422118	.	T	C	5	8	13	1	0	14	0	0
5	57422146	.	A	T	3	7	10	1	0	11	0	0
5	57444345	.	A	G	1	2	3	0	1	4	0	0
5	57447301	.	C	T	4	5	9	0	0	9	0	0
5	57450440	.	C	A	7	8	15	0	0	15	0	0
5	57451036	.	A	T	1	9	10	0	0	10	0	0
5	57453635	.	T	C	4	7	11	0	0	11	0	0
5	57483494	.	T	A	1	2	3	0	0	3	0	0
5	57489777	.	T	C	12	1	13	0	9	22	0	0
5	57489821	.	G	A	15	11	26	0	2	28	0	0
5	57490344	.	C	A	2	11	13	0	12	25	0	0
5	57490371	.	C	T	1	11	12	0	13	25	0	0
5	57499990	.	T	C	14	0	14	0	21	35	0	0
5	57505050	.	C	T	11	12	23	0	2	25	0	0
5	57526813	.	C	T	0	5	5	0	3	8	0	0
5	57641788	.	C	A	10	2	12	0	1	13	0	0
5	57641789	.	G	A	0	2	2	0	11	13	0	0
5	57693699	.	C	T	3	3	6	0	0	6	0	0
5	57704805	.	T	C	7	0	7	0	5	12	0	0
5	57708608	.	G	A	3	2	5	0	0	5	0	0
5	57718488	.	A	C	10	12	22	0	0	23	1	0
5	57718651	.	A	T	7	5	12	0	0	12	0	0
5	57718716	.	T	C	9	8	17	0	1	18	0	0
5	57718739	.	T	C	2	9	11	0	1	12	0	0
5	57726576	.	T	C	5	4	9	0	0	9	0	0
5	57726655	.	G	C	1	2	3	0	1	4	0	0
5	57735420	.	A	G	5	5	10	0	0	10	0	0
5	57737535	.	C	G	3	2	5	0	1	6	0	0
5	57737589	.	T	C	2	2	4	0	0	4	0	0
5	57737919	.	T	A	6	4	10	0	1	11	0	0
5	57744722	.	C	A	13	7	20	0	2	22	0	0
5	57744731	.	T	C	15	8	23	0	0	23	0	0
5	57753791	.	G	T	11	14	25	0	0	25	0	0
5	57755422	.	T	C	9	10	19	0	1	20	0	0
5	57759107	.	C	T	12	11	23	0	0	23	0	0
5	57759159	.	G	A	1	17	18	0	14	32	0	0
5	57762423	.	A	T	18	15	33	1	1	35	0	0
5	57762608	.	A	G	12	2	14	0	12	26	0	0
5	57762986	.	C	G	12	9	21	0	0	21	0	0
5	57773231	.	A	T	1	4	5	0	0	5	0	0
5	57781459	.	T	A	20	21	41	0	1	42	0	0
5	57797086	.	C	T	36	30	66	0	4	70	0	0
5	57814468	.	C	T	11	7	18	0	0	18	0	0
5	57814523	.	A	G	11	9	20	0	0	20	0	0
5	57814630	.	T	C	8	0	8	0	16	24	0	0
5	57818963	.	G	T	8	8	16	0	0	16	0	0
5	57819001	.	A	G	6	11	17	0	0	17	0	0
5	57819091	.	A	T	3	4	7	0	2	9	0	0
5	57820641	.	C	A	8	6	14	0	2	16	0	0
5	57820658	.	C	T	7	10	17	0	0	17	0	0
5	57820716	.	C	T	7	11	18	0	0	18	0	0
5	57842223	.	C	T	5	7	12	0	0	12	0	0
5	57879040	.	T	A	5	6	11	0	0	11	0	0
5	58075815	.	T	G	2	3	5	1	1	7	0	0
5	58081110	.	C	T	5	2	7	0	3	10	0	0
5	58081173	.	T	A	4	3	7	0	1	8	0	0
5	58086215	.	G	C	8	0	8	0	9	17	0	0
5	58380876	.	A	G	2	0	2	0	4	6	0	0
5	58382267	.	G	A	30	23	53	0	0	53	0	0
5	58382415	.	C	T	27	17	44	2	2	48	0	0
5	58382474	.	T	A	21	12	33	1	2	36	0	0
5	58776499	.	G	A	2	4	6	0	0	6	0	0
5	58851232	.	G	A	2	17	19	0	1	20	0	0
5	58853688	.	A	G	13	9	22	0	0	22	0	0
5	58868948	.	A	C	11	9	20	0	0	20	0	0
5	58871633	.	T	G	10	4	14	1	1	16	0	0
5	58875035	.	C	T	0	10	10	0	13	23	0	0
5	58876301	.	C	T	1	7	8	0	11	19	0	0
5	58876471	.	G	A	10	5	15	0	0	15	0	0
5	58878899	.	G	T	11	6	17	0	0	17	0	0
5	58939388	.	C	A	0	9	9	0	16	26	1	0
5	58997286	.	T	A	6	4	10	0	1	11	0	0
5	59008759	.	T	A	6	4	10	0	1	11	0	0
5	59008762	.	G	C	8	4	12	0	0	12	0	0
5	59030172	.	T	C	3	4	7	0	0	7	0	0
5	59041862	.	T	C	8	4	12	0	0	12	0	0
5	59044021	.	G	A	5	7	12	0	0	12	0	0
5	59046296	.	T	C	2	8	10	0	0	10	0	0
5	59050241	.	A	G	9	14	23	0	1	24	0	0
5	59050307	.	G	A	7	12	19	0	0	19	0	0
5	59063090	.	C	A	8	13	21	0	0	21	0	0
5	59063102	.	C	T	10	7	17	0	0	17	0	0
5	59079618	.	A	T	19	11	30	0	1	31	0	0
5	59079732	.	A	C	13	15	28	0	1	29	0	0
5	59079806	.	C	A	20	13	33	0	0	33	0	0
5	59080050	.	C	T	1	4	5	0	0	5	0	0
5	59080163	.	C	T	7	3	10	0	0	10	0	0
5	59080392	.	C	A	8	3	11	0	2	13	0	0
5	59080452	.	G	T	2	9	11	0	11	22	0	0
5	59080526	.	T	A	10	15	25	0	1	26	0	0
5	59080682	.	A	T	6	6	12	0	0	12	0	0
5	59082758	.	G	T	7	12	19	0	0	19	0	0
5	59082761	.	C	T	6	12	18	0	0	18	0	0
5	59095793	.	C	T	7	8	15	0	0	15	0	0
5	59095862	.	G	A	7	9	16	0	1	17	0	0
5	59100577	.	G	A	3	6	9	0	0	9	0	0
5	59101602	.	A	G	8	4	12	0	1	13	0	0
5	59101605	.	G	A	7	5	12	0	1	13	0	0
5	59103052	.	A	G	4	7	11	0	0	11	0	0
5	59103118	.	A	T	4	6	10	0	0	10	0	0
5	59107979	.	T	A	4	4	8	0	0	8	0	0
5	59147690	.	C	T	5	7	12	0	0	12	0	0
5	59147711	.	T	C	10	9	19	0	0	19	0	0
5	59198649	.	C	G	8	6	14	0	0	14	0	0
5	59198658	.	A	G	6	6	12	0	2	14	0	0
5	59198979	.	G	A	1	3	4	0	0	4	0	0
5	59198982	.	A	G	1	3	4	0	0	4	0	0
5	59199018	.	G	A	0	2	2	0	1	3	0	0
5	59199028	.	C	T	2	4	6	0	0	6	0	0
5	59200303	.	G	A	5	2	7	0	0	7	0	0
5	59200369	.	T	C	3	5	8	0	0	8	0	0
5	59200383	.	A	G	2	5	7	1	0	8	0	0
5	59200412	.	G	T	2	6	8	1	0	9	0	0
5	59200523	.	C	G	3	4	7	0	0	7	0	0
5	59201040	.	T	C	4	2	6	0	0	6	0	0
5	59201192	.	C	T	2	3	5	0	1	6	0	0
5	59201211	.	A	T	3	2	5	0	0	5	0	0
5	59201308	.	G	A	0	4	4	0	6	10	0	0
5	59201690	.	T	C	5	4	9	0	1	10	0	0
5	59201825	.	G	A	6	12	18	0	0	18	0	0
5	59201883	.	T	G	5	4	9	0	0	9	0	0
5	59201914	.	G	A	6	8	14	0	1	15	0	0
5	59201918	.	G	C	8	6	14	0	1	15	0	0
5	59239773	.	C	G	9	10	19	0	0	19	0	0
5	59248031	.	T	C	7	4	11	0	0	11	0	0
5	59278508	.	T	G	11	6	17	0	0	17	0	0
5	59278520	.	T	G	11	5	16	0	0	16	0	0
5	59297918	.	C	G	4	4	8	0	2	10	0	0
5	59328475	.	C	T	8	5	13	0	0	13	0	0
5	59341675	.	C	A	8	4	12	0	1	13	0	0
5	59361402	.	A	G	2	2	4	0	0	4	0	0
5	59367819	.	C	G	11	9	20	0	0	20	0	0
5	59384206	.	A	G	8	5	13	0	0	13	0	0
5	59386289	.	T	G	9	4	13	0	0	13	0	0
5	59386456	.	T	C	3	9	12	0	2	14	0	0
5	59386588	.	T	C	3	6	9	0	0	9	0	0
5	59386964	.	G	T	6	5	11	0	0	11	0	0
5	59386997	.	T	G	3	6	9	0	1	10	0	0
5	59387007	.	G	A	3	11	14	0	0	14	0	0
5	59387094	.	A	T	11	4	15	0	1	16	0	0
5	59387298	.	C	T	9	5	14	0	0	14	0	0
5	59387306	.	A	G	10	6	16	0	0	16	0	0
5	59388343	.	T	C	9	5	14	1	0	15	0	0
5	59388586	.	T	A	9	7	16	0	1	17	0	0
5	59388604	.	T	C	12	10	22	0	0	22	0	0
5	59388739	.	A	G	2	8	10	0	0	10	0	0
5	59388922	.	G	C	1	11	12	0	6	18	0	0
5	59388932	.	C	T	5	11	16	0	1	17	0	0
5	59389002	.	G	A	7	11	18	0	0	18	0	0
5	59389079	.	A	G	5	0	5	0	9	14	0	0
5	59389210	.	T	A	8	3	11	0	0	11	0	0
5	59389440	.	T	A	6	3	9	0	0	9	0	0
5	59389693	.	A	T	8	8	16	0	1	17	0	0
5	59397551	.	A	G	4	0	4	0	2	6	0	0
5	59397600	.	G	A	1	7	8	0	0	8	0	0
5	59398452	.	T	C	4	8	12	0	0	12	0	0
5	59398522	.	A	G	6	6	12	0	0	12	0	0
5	59398655	.	A	G	5	13	18	0	2	20	0	0
5	59419988	.	T	C	9	5	14	0	2	16	0	0
5	59420096	.	T	C	2	4	6	0	1	7	0	0
5	59420138	.	G	A	1	5	6	0	6	12	0	0
5	59420249	.	A	G	5	0	5	0	9	14	0	0
5	59420291	.	A	G	10	0	10	0	5	15	0	0
5	59420321	.	A	C	12	6	18	0	0	18	0	0
5	59420366	.	T	C	13	10	23	0	0	23	0	0
5	59420375	.	C	T	14	9	23	0	0	23	0	0
5	59420414	.	G	T	1	7	8	0	10	18	0	0
5	59449692	.	G	A	0	7	7	0	13	20	0	0
5	59449713	.	G	A	1	8	9	0	11	20	0	0
5	59449764	.	G	A	11	6	17	0	0	17	0	0
5	59449818	.	C	T	9	6	15	0	0	15	0	0
5	59450034	.	C	T	7	9	16	0	0	16	0	0
5	59462424	.	G	T	2	4	6	0	0	6	0	0
5	59462457	.	G	A	4	7	11	0	1	12	0	0
5	59462501	.	G	A	0	10	10	0	5	15	0	0
5	59462534	.	A	G	5	10	15	0	0	15	0	0
5	59462595	.	C	T	10	10	20	0	0	20	0	0
5	59462679	.	C	T	14	5	19	0	2	21	0	0
5	59462727	.	C	T	13	9	22	0	1	23	0	0
5	59462790	.	C	T	16	5	21	0	0	21	0	0
5	59463327	.	A	C	10	9	19	0	0	19	0	0
5	59466882	.	G	A	0	12	12	0	9	21	0	0
5	59466930	.	A	G	10	15	25	0	0	25	0	0
5	59473728	.	T	C	11	3	14	0	1	15	0	0
5	59473885	.	A	C	14	11	25	0	0	25	0	0
5	59479541	.	C	A	13	8	21	1	2	24	0	0
5	59479546	.	A	C	14	10	24	1	0	25	0	0
5	59510265	.	A	C	3	6	9	0	0	9	0	0
5	59512335	.	C	T	2	4	6	0	0	6	0	0
5	59512460	.	G	A	2	5	7	0	0	7	0	0
5	59515419	.	A	T	4	3	7	0	3	10	0	0
5	59515497	.	A	T	3	3	6	0	0	6	0	0
5	59515509	.	A	G	3	4	7	0	0	7	0	0
5	59515573	.	T	C	5	7	12	0	1	13	0	0
5	59542153	.	T	C	7	5	12	0	0	12	0	0
5	59544222	.	C	G	6	5	11	0	0	11	0	0
5	59544249	.	T	C	5	6	11	0	2	13	0	0
5	59544291	.	T	C	10	8	18	0	0	18	0	0
5	59544642	.	A	C	6	2	8	0	0	8	0	0
5	59548944	.	T	A	6	3	9	0	0	9	0	0
5	59548976	.	C	G	5	4	9	0	0	9	0	0
5	59549354	.	T	C	6	2	8	0	0	8	0	0
5	59549381	.	G	A	6	2	8	0	0	8	0	0
5	59549397	.	A	G	6	3	9	0	0	9	0	0
5	59550029	.	T	A	2	3	5	0	0	5	0	0
5	59550365	.	G	A	6	7	13	0	0	13	0	0
5	59550713	.	T	C	8	4	12	0	0	12	0	0
5	59559905	.	T	C	10	11	21	0	1	22	0	0
5	59559950	.	T	C	13	15	28	0	0	28	0	0
5	59560171	.	A	G	12	9	21	0	1	22	0	0
5	59560176	.	A	G	13	9	22	0	0	22	0	0
5	59575772	.	C	T	2	4	6	0	0	6	0	0
5	59584548	.	G	A	10	9	19	0	0	19	0	0
5	59593231	.	C	T	6	8	14	0	1	15	0	0
5	59593441	.	G	A	11	7	18	0	2	20	0	0
5	59593447	.	G	C	1	7	8	0	11	19	0	0
5	59593502	.	C	T	10	6	16	0	1	17	0	0
5	59593520	.	C	T	8	8	16	0	0	16	0	0
5	59593699	.	T	C	9	5	14	0	0	14	0	0
5	59593773	.	G	C	6	8	14	0	0	14	0	0
5	59593795	.	T	A	3	6	9	0	1	10	0	0
5	59593844	.	C	T	4	3	7	0	0	7	0	0
5	59594437	.	T	A	8	6	14	0	1	15	0	0
5	59594729	.	A	G	12	6	18	0	1	19	0	0
5	59594763	.	T	G	9	7	16	0	0	16	0	0
5	59594878	.	C	T	3	7	10	0	0	10	0	0
5	59594893	.	C	T	2	6	8	0	0	8	0	0
5	59594943	.	A	C	3	5	8	0	0	8	0	0
5	59595241	.	T	C	5	6	11	0	0	11	0	0
5	59595252	.	C	T	5	6	11	0	0	11	0	0
5	59595502	.	T	C	3	6	9	0	0	9	0	0
5	60520653	.	C	A	7	2	9	0	0	9	0	0
5	60520995	.	C	T	3	3	6	0	1	7	0	0
5	60521010	.	C	T	3	3	6	0	0	6	0	0
5	60605673	.	T	C	3	3	6	0	0	6	0	0
5	60684296	.	A	G	1	0	1	0	8	9	0	0
5	60684434	.	C	T	6	8	14	0	1	15	0	0
5	60684494	.	T	C	7	6	13	0	0	13	0	0
5	60684603	.	A	G	8	0	8	0	10	18	0	0
5	60684728	.	C	T	9	6	15	0	0	15	0	0
5	60684731	.	C	T	9	6	15	0	0	15	0	0
5	60684866	.	C	T	6	4	10	0	3	13	0	0
5	60685202	.	A	T	12	3	15	0	0	15	0	0
5	60685209	.	A	T	4	10	14	0	0	14	0	0
5	60685676	.	C	T	2	4	6	0	0	6	0	0
5	60685773	.	C	T	8	8	16	0	0	16	0	0
5	60686452	.	C	T	7	6	13	0	0	13	0	0
5	60686473	.	C	T	8	3	11	0	1	12	0	0
5	60686541	.	A	G	7	3	10	0	0	10	0	0
5	60686603	.	C	T	9	3	12	0	1	13	0	0
5	60686636	.	C	T	10	5	15	0	0	15	0	0
5	60686910	.	G	T	13	12	25	0	0	25	0	0
5	60686918	.	A	T	9	11	20	0	2	22	0	0
5	60687327	.	T	C	8	6	14	0	0	14	0	0
5	60687344	.	A	T	6	10	16	0	0	16	0	0
5	60687362	.	A	G	6	12	18	0	1	19	0	0
5	60687537	.	T	C	2	7	9	0	0	9	0	0
5	60847925	.	G	A	1	8	9	0	0	9	0	0
5	60850390	.	T	C	3	1	4	0	1	5	0	0
5	60850397	.	G	T	3	3	6	0	0	6	0	0
5	60850570	.	G	C	3	2	5	0	0	5	0	0
5	60851962	.	A	T	6	3	9	0	1	10	0	0
5	60852068	.	C	T	2	5	7	0	0	7	0	0
5	60854846	.	C	T	2	6	8	0	0	8	0	0
5	60855129	.	G	A	2	5	7	1	0	8	0	0
5	60861610	.	C	T	4	4	8	0	0	8	0	0
5	60863107	.	C	T	1	4	5	0	0	5	0	0
5	60866063	.	G	T	7	4	11	0	1	12	0	0
5	60867948	.	A	C	5	8	13	0	0	13	0	0
5	60868009	.	A	G	3	0	3	0	7	10	0	0
5	60869015	.	C	A	8	7	15	0	0	15	0	0
5	60871969	.	C	T	9	8	17	0	0	17	0	0
5	60872126	.	G	A	10	8	18	0	1	19	0	0
5	60872472	.	G	A	3	5	8	0	0	8	0	0
5	60877439	.	A	T	3	2	5	0	1	6	0	0
5	60880068	.	A	G	3	3	6	0	0	6	0	0
5	60893432	.	C	T	6	3	9	0	0	9	0	0
5	60894651	.	T	A	7	4	11	0	1	12	0	0
5	60894768	.	A	G	11	5	16	0	0	16	0	0
5	60894846	.	A	G	9	0	9	0	6	15	0	0
5	60902623	.	G	A	0	13	13	0	5	18	0	0
5	61949989	.	A	C	1	5	6	0	0	6	0	0
5	61951038	.	A	G	7	7	14	0	0	14	0	0
5	62052685	.	T	G	1	5	6	0	0	6	0	0
5	62290448	.	A	T	5	5	10	0	1	11	0	0
5	62333198	.	C	A	1	8	9	0	0	9	0	0
5	62639596	.	G	A	26	28	54	0	1	55	0	0
5	62642989	.	A	G	18	5	23	0	2	25	0	0
5	62806599	.	T	A	3	6	9	0	1	10	0	0
5	62806675	.	A	G	9	6	15	0	0	15	0	0
5	62806701	.	A	G	9	3	12	0	2	14	0	0
5	62806786	.	C	A	5	3	8	0	0	8	0	0
5	62806867	.	C	T	0	6	6	0	7	13	0	0
5	62806951	.	A	G	1	5	6	0	1	7	0	0
5	62807357	.	G	A	1	4	5	1	0	6	0	0
5	62860901	.	A	G	2	5	7	0	0	7	0	0
5	62860902	.	G	T	2	5	7	0	0	7	0	0
5	62860943	.	T	C	11	6	17	0	0	17	0	0
5	62860969	.	T	A	12	6	18	0	2	20	0	0
5	62865289	.	G	A	7	7	14	0	0	14	0	0
5	62884052	.	T	C	9	7	16	0	0	16	0	0
5	62889651	.	C	T	8	10	18	0	0	18	0	0
5	62889957	.	G	A	12	7	19	0	1	20	0	0
5	62889966	.	C	G	14	6	20	0	0	20	0	0
5	62890011	.	T	G	7	5	12	0	2	14	0	0
5	62890026	.	G	A	8	4	12	0	1	13	0	0
5	62890161	.	A	G	7	9	16	0	0	16	0	0
5	62890405	.	C	T	4	9	13	0	0	13	0	0
5	62890642	.	G	A	13	5	18	0	2	20	0	0
5	62890846	.	A	G	8	7	15	0	3	18	0	0
5	62937329	.	C	T	8	4	12	0	4	16	0	0
5	62937377	.	T	G	11	5	16	0	0	16	0	0
5	62937410	.	C	A	14	6	20	0	0	20	0	0
5	62937428	.	C	T	1	10	11	0	9	20	0	0
5	62989260	.	C	T	9	10	19	0	0	19	0	0
5	63003145	.	G	A	3	3	6	0	0	6	0	0
5	63026448	.	C	T	2	1	3	0	0	3	0	0
5	63026458	.	T	C	2	0	2	0	3	5	0	0
5	63026570	.	T	C	1	3	4	0	1	5	0	0
5	63065718	.	C	T	2	2	4	0	0	4	0	0
5	63065739	.	G	A	4	4	8	0	0	8	0	0
5	63065768	.	A	C	7	1	8	0	6	14	0	0
5	63089582	.	T	G	8	5	13	0	0	13	0	0
5	63092339	.	A	G	5	8	13	0	0	13	0	0
5	63248320	.	G	T	5	4	9	0	0	9	0	0
5	63248335	.	A	G	6	3	9	0	0	9	0	0
5	63248433	.	G	A	3	3	6	0	0	6	0	0
5	63248486	.	G	A	1	3	4	0	0	4	0	0
5	63248665	.	A	C	7	8	15	0	0	15	0	0
5	63248668	.	T	C	6	9	15	0	0	15	0	0
5	63267269	.	A	G	3	3	6	0	0	6	0	0
5	63268917	.	G	A	3	3	6	0	0	6	0	0
5	63273840	.	T	G	3	2	5	0	0	5	0	0
5	63285995	.	T	G	2	4	6	0	1	7	0	0
5	63288868	.	C	A	1	3	4	0	0	4	0	0
5	63288876	.	A	T	1	2	3	0	1	4	0	0
5	63289312	.	C	A	4	4	8	0	0	8	0	0
5	63305505	.	A	T	2	3	5	0	0	5	0	0
5	63305522	.	A	G	1	0	1	0	3	4	0	0
5	63305607	.	G	A	4	5	9	0	0	9	0	0
5	63308418	.	C	T	4	2	6	0	1	7	0	0
5	63319045	.	C	T	1	2	3	0	1	4	0	0
5	63319324	.	T	C	1	4	5	0	0	5	0	0
5	63322568	.	A	T	1	3	4	2	0	6	0	0
5	63322584	.	G	T	2	3	5	1	0	6	0	0
5	63329526	.	G	A	5	4	9	0	1	10	0	0
5	63335216	.	C	A	3	5	8	2	0	10	0	0
5	63338422	.	C	T	3	3	6	1	0	7	0	0
5	63338518	.	A	T	2	9	11	0	0	11	0	0
5	63338557	.	C	T	3	7	10	0	0	10	0	0
5	63338563	.	A	G	3	4	7	0	0	7	0	0
5	63360290	.	A	G	1	4	5	0	1	6	0	0
5	63360311	.	A	G	2	6	8	0	0	8	0	0
5	63360344	.	T	C	2	6	8	0	0	8	0	0
5	63362964	.	A	G	2	0	2	0	3	5	0	0
5	63363010	.	G	A	2	2	4	0	0	4	0	0
5	63373584	.	A	G	7	4	11	0	0	11	0	0
5	63375980	.	C	T	3	3	6	0	0	6	0	0
5	63376032	.	A	G	3	2	5	0	0	5	0	0
5	63394174	.	C	A	29	23	52	0	1	53	0	0
5	63395057	.	A	T	27	24	51	0	2	53	0	0
5	63398847	.	T	C	5	20	25	0	0	25	0	0
5	63398973	.	G	A	18	17	35	0	6	41	0	0
5	63399066	.	G	C	20	25	45	0	1	46	0	0
5	63399111	.	T	A	24	27	51	0	2	53	0	0
5	63399683	.	T	A	18	18	36	0	1	37	0	0
5	63400685	.	G	A	2	2	4	0	2	6	0	0
5	63410281	.	T	C	2	2	4	0	0	4	0	0
5	63412535	.	G	C	1	2	3	0	0	3	0	0
5	63412595	.	C	G	2	2	4	0	0	4	0	0
5	63416987	.	G	A	2	2	4	0	0	4	0	0
5	63419231	.	T	A	2	2	4	0	0	4	0	0
5	63510908	.	G	T	2	10	12	0	0	12	0	0
5	63511045	.	A	G	6	4	10	0	0	10	0	0
5	63511264	.	A	G	6	8	14	0	0	14	0	0
5	63511315	.	A	G	4	3	7	1	0	8	0	0
5	63511788	.	A	T	12	6	18	0	1	19	0	0
5	63511791	.	A	G	10	7	17	0	0	17	0	0
5	63514810	.	T	C	7	0	7	0	9	16	0	0
5	63629121	.	C	A	8	4	12	0	0	12	0	0
5	63629136	.	G	A	7	8	15	0	0	15	0	0
5	63629299	.	A	T	9	11	20	0	0	20	0	0
5	63644850	.	G	A	7	2	9	0	0	9	0	0
5	63648324	.	C	T	1	2	3	0	0	3	0	0
5	63648811	.	A	G	4	6	10	0	0	10	0	0
5	63653276	.	A	G	2	2	4	0	0	4	0	0
5	63655829	.	T	C	1	3	4	0	0	4	0	0
5	63657628	.	A	G	3	2	5	0	0	5	0	0
5	63658512	.	G	A	1	3	4	0	0	4	0	0
5	63659321	.	A	C	1	4	5	0	0	5	0	0
5	63659513	.	C	T	1	3	4	0	0	4	0	0
5	63663749	.	A	T	3	2	5	0	0	5	0	0
5	63680655	.	A	G	18	0	18	0	9	27	0	0
5	63680661	.	C	G	19	11	30	0	0	30	0	0
5	63680709	.	T	G	14	18	32	0	1	33	0	0
5	63680718	.	A	G	14	0	14	0	16	30	0	0
5	63681123	.	A	G	9	13	22	0	2	24	0	0
5	63695760	.	C	T	25	18	43	0	0	43	0	0
5	63698549	.	T	C	17	23	40	0	0	40	0	0
5	63699468	.	T	C	24	18	42	0	0	42	0	0
5	63720639	.	A	G	25	18	43	0	5	48	0	0
5	63723807	.	G	A	2	18	20	0	23	43	0	0
5	63730115	.	G	A	5	24	29	1	27	57	0	0
5	63740093	.	C	T	12	14	26	0	0	26	0	0
5	63740097	.	T	A	12	12	24	0	0	24	0	0
5	63740438	.	A	G	12	18	30	0	0	30	0	0
5	63740465	.	C	A	14	7	21	0	2	24	1	0
5	63740815	.	A	C	27	20	47	0	1	48	0	0
5	63740874	.	A	C	28	23	51	0	0	51	0	0
5	63740895	.	A	C	23	23	46	0	0	46	0	0
5	63740910	.	A	G	16	23	39	0	3	42	0	0
5	63741023	.	T	A	12	13	25	0	1	26	0	0
5	63741077	.	A	T	11	12	23	0	0	23	0	0
5	63797598	.	A	G	1	2	3	0	0	3	0	0
5	63848261	.	T	C	14	6	20	0	0	20	0	0
5	63848593	.	T	C	6	4	10	0	2	12	0	0
5	63848662	.	C	T	6	3	9	0	0	9	0	0
5	63848668	.	G	T	7	3	10	0	0	10	0	0
5	63857154	.	A	C	2	1	3	0	1	4	0	0
5	63857156	.	G	A	2	2	4	0	0	4	0	0
5	63858951	.	C	A	8	6	14	0	0	14	0	0
5	63860815	.	C	T	8	2	10	0	1	11	0	0
5	63860936	.	A	G	10	7	17	0	0	17	0	0
5	63860943	.	A	G	10	0	10	0	5	15	0	0
5	63861355	.	G	A	0	3	3	0	2	5	0	0
5	63863073	.	A	G	3	2	5	0	0	5	0	0
5	63863651	.	C	G	5	0	5	0	5	10	0	0
5	63863656	.	G	A	6	4	10	0	0	10	0	0
5	63863945	.	G	C	3	4	7	0	0	7	0	0
5	63864117	.	C	T	8	5	13	0	0	13	0	0
5	63864150	.	T	C	6	3	9	0	0	9	0	0
5	64205763	.	T	C	11	6	17	0	0	17	0	0
5	64206485	.	T	C	6	2	8	3	1	12	0	0
5	64207071	.	T	C	5	4	9	0	0	9	0	0
5	64848401	.	T	C	1	6	7	0	0	7	0	0
5	66250917	.	C	T	8	4	12	0	0	12	0	0
5	66252054	.	G	A	0	5	5	0	8	13	0	0
5	66252127	.	A	T	6	3	9	0	0	9	0	0
5	67079569	.	G	A	4	7	11	0	0	11	0	0
5	67079660	.	A	G	12	7	19	0	1	20	0	0
5	67086931	.	C	T	5	6	11	0	1	12	0	0
5	67091502	.	C	T	6	3	9	0	0	9	0	0
5	67095814	.	C	T	7	6	13	0	1	14	0	0
5	67110116	.	G	C	3	0	3	0	4	7	0	0
5	67112739	.	G	T	6	5	11	0	0	11	0	0
5	67188350	.	C	T	8	14	22	0	0	22	0	0
5	67188515	.	C	G	0	9	9	0	14	23	0	0
5	67188524	.	G	A	8	11	19	0	1	20	0	0
5	67192155	.	G	A	8	5	13	0	0	13	0	0
5	67194260	.	G	A	8	7	15	0	0	15	0	0
5	67198919	.	C	T	4	9	13	0	1	14	0	0
5	67200217	.	G	T	4	8	12	0	0	12	0	0
5	67205474	.	T	C	7	7	14	0	0	14	0	0
5	67205570	.	C	T	3	7	10	0	1	11	0	0
5	67205590	.	C	T	5	7	12	0	0	12	0	0
5	67209125	.	T	C	4	5	9	0	0	9	0	0
5	67211298	.	A	G	4	7	11	0	0	11	0	0
5	67211335	.	T	C	6	1	7	0	5	12	0	0
5	67211372	.	T	C	5	4	9	0	0	9	0	0
5	67211634	.	T	C	11	0	11	0	9	20	0	0
5	67211643	.	T	C	11	0	11	0	9	20	0	0
5	67217758	.	T	A	15	11	26	0	0	26	0	0
5	67217839	.	A	G	6	2	8	0	0	8	0	0
5	67217933	.	C	T	0	3	3	0	4	7	0	0
5	67229772	.	G	T	4	9	13	0	0	13	0	0
5	67229824	.	T	C	6	0	6	0	3	9	0	0
5	67229827	.	A	C	7	0	7	0	2	9	0	0
5	67234603	.	T	G	7	6	13	0	1	14	0	0
5	67239316	.	T	C	3	0	3	0	5	8	0	0
5	67239317	.	T	G	5	2	7	0	1	8	0	0
5	67239399	.	C	A	1	7	8	0	6	14	0	0
5	67239425	.	G	A	6	9	15	0	0	15	0	0
5	67254234	.	C	T	0	5	5	0	6	11	0	0
5	67254501	.	T	G	6	4	10	0	1	11	0	0
5	67254531	.	G	A	6	8	14	0	1	15	0	0
5	67254601	.	T	G	4	9	13	0	2	15	0	0
5	67254648	.	G	T	4	10	14	0	1	15	0	0
5	67254861	.	G	A	5	7	12	0	1	13	0	0
5	67254908	.	T	C	12	1	13	0	7	20	0	0
5	67255049	.	C	T	11	9	20	0	1	21	0	0
5	67260308	.	C	A	4	12	16	1	1	18	0	0
5	67260354	.	A	G	6	7	13	1	1	15	0	0
5	67265591	.	C	G	2	4	6	0	0	6	0	0
5	67268171	.	A	G	1	3	4	0	0	4	0	0
5	67272557	.	T	C	3	3	6	0	1	7	0	0
5	67272580	.	A	G	3	4	7	0	1	8	0	0
5	67272745	.	C	T	1	2	3	0	0	3	0	0
5	67272760	.	C	G	1	4	5	0	0	5	0	0
5	67272835	.	T	C	2	6	8	0	0	8	0	0
5	67273308	.	A	G	2	2	4	0	0	4	0	0
5	67275952	.	C	T	0	3	3	0	2	5	0	0
5	67276069	.	C	T	0	2	2	0	1	3	0	0
5	67278712	.	T	C	12	28	40	0	3	43	0	0
5	67280269	.	C	T	5	20	25	0	30	55	0	0
5	67280329	.	C	A	3	25	28	0	29	57	0	0
5	67280332	.	G	T	29	24	53	0	2	55	0	0
5	67288532	.	C	T	0	5	5	0	3	8	0	0
5	67288575	.	C	T	1	6	7	0	0	7	0	0
5	67288576	.	T	G	1	6	7	0	0	7	0	0
5	67288662	.	A	G	9	15	24	1	1	26	0	0
5	67288733	.	G	A	7	10	17	0	0	17	0	0
5	67289050	.	G	T	3	2	5	0	1	6	0	0
5	67292110	.	C	T	2	20	22	0	24	46	0	0
5	67292599	.	A	T	16	27	43	0	1	44	0	0
5	67316940	.	C	T	0	3	3	0	2	5	0	0
5	67317069	.	T	G	2	4	6	0	0	6	0	0
5	67317324	.	T	G	1	2	3	0	0	3	0	0
5	67317762	.	A	C	2	0	2	0	3	5	0	0
5	67317957	.	T	A	3	2	5	0	0	5	0	0
5	67328518	.	C	T	0	2	2	0	4	6	0	0
5	67329016	.	C	T	1	2	3	0	4	7	0	0
5	67329037	.	A	C	5	2	7	0	1	8	0	0
5	67335956	.	T	C	2	0	2	0	2	4	0	0
5	67474362	.	T	C	5	4	9	0	1	10	0	0
5	67474365	.	A	G	7	4	11	0	0	11	0	0
5	67481356	.	C	T	2	3	5	0	0	5	0	0
5	67481663	.	A	G	1	2	3	0	0	3	0	0
5	67484657	.	C	T	4	3	7	0	0	7	0	0
5	67484741	.	A	T	5	3	8	0	0	8	0	0
5	67487770	.	C	T	5	3	8	0	1	9	0	0
5	67487863	.	T	C	4	3	7	0	0	7	0	0
5	67489548	.	T	A	1	3	4	0	1	5	0	0
5	67492020	.	A	C	2	2	4	0	0	4	0	0
5	67542789	.	A	G	4	4	8	0	0	8	0	0
5	67543071	.	G	A	2	4	6	0	0	6	0	0
5	67672694	.	C	T	1	3	4	0	0	4	0	0
5	67672900	.	G	A	1	2	3	0	0	3	0	0
5	67681400	.	C	T	3	2	5	0	0	5	0	0
5	67736969	.	A	G	3	5	8	0	0	8	0	0
5	67736986	.	T	C	4	0	4	0	4	8	0	0
5	67737009	.	G	A	1	3	4	0	0	4	0	0
5	67737210	.	A	G	1	4	5	0	0	5	0	0
5	67737223	.	C	T	3	4	7	0	0	7	0	0
5	67750862	.	G	A	2	4	6	0	0	6	0	0
5	67755518	.	C	A	1	3	4	0	1	5	0	0
5	67755859	.	A	T	2	2	4	0	0	4	0	0
5	67838362	.	G	A	7	10	17	0	0	17	0	0
5	67838400	.	C	T	8	9	17	0	1	18	0	0
5	67838455	.	C	T	20	10	30	0	0	30	0	0
5	67838521	.	T	G	5	1	6	1	6	13	0	0
5	67838608	.	G	T	2	3	5	0	7	12	0	0
5	67838659	.	C	T	16	7	23	0	0	23	0	0
5	67839973	.	C	G	12	10	22	0	0	22	0	0
5	67839975	.	A	T	9	9	18	0	4	22	0	0
5	67840542	.	G	A	2	9	11	0	9	20	0	0
5	67840572	.	C	T	8	6	14	0	0	14	0	0
5	67840721	.	C	T	6	3	9	0	2	11	0	0
5	67842735	.	C	T	10	9	19	0	0	19	0	0
5	67842800	.	C	T	8	8	16	0	0	16	0	0
5	67842965	.	A	T	5	14	19	0	0	19	0	0
5	67845505	.	A	G	6	8	14	0	0	14	0	0
5	67845527	.	A	C	5	9	14	0	0	14	0	0
5	67847635	.	G	A	7	9	16	0	0	16	0	0
5	67849749	.	A	G	8	6	14	0	0	14	0	0
5	67855969	.	G	A	0	8	8	0	9	17	0	0
5	67857796	.	A	G	16	6	22	0	1	23	0	0
5	67857877	.	T	C	12	11	23	0	1	24	0	0
5	67859619	.	A	G	9	0	9	0	11	20	0	0
5	67860007	.	A	G	9	10	19	0	1	20	0	0
5	67873094	.	G	A	20	17	37	0	0	37	0	0
5	67873103	.	C	T	0	15	15	0	22	37	0	0
5	67874952	.	T	G	15	21	36	0	1	37	0	0
5	67874988	.	C	T	15	20	35	0	1	36	0	0
5	67884293	.	C	T	2	4	6	0	0	6	0	0
5	67884361	.	A	G	1	7	8	0	0	8	0	0
5	67884436	.	A	G	5	6	11	0	0	11	0	0
5	67884508	.	G	A	3	2	5	0	2	7	0	0
5	67884533	.	G	A	3	3	6	0	0	6	0	0
5	67884583	.	G	A	6	2	8	0	0	8	0	0
5	67884688	.	G	T	3	2	5	0	0	5	0	0
5	67884701	.	T	C	2	3	5	0	0	5	0	0
5	67884737	.	A	T	2	3	5	0	0	5	0	0
5	67884762	.	T	G	2	2	4	0	0	4	0	0
5	67884779	.	G	A	4	5	9	0	0	9	0	0
5	67885131	.	T	A	6	8	14	0	0	14	0	0
5	67885142	.	G	A	6	10	16	0	0	16	0	0
5	67885211	.	A	T	11	4	15	0	1	16	0	0
5	67885444	.	G	A	9	9	18	0	2	20	0	0
5	67885526	.	C	T	0	13	13	0	11	24	0	0
5	67885592	.	C	T	1	3	4	3	8	15	0	0
5	67885599	.	A	G	9	2	11	3	0	14	0	0
5	67886945	.	G	T	3	2	5	0	0	5	0	0
5	67886996	.	A	T	3	5	8	0	0	8	0	0
5	67887028	.	C	T	4	6	10	0	0	10	0	0
5	67887143	.	A	G	11	13	24	0	1	25	0	0
5	67887239	.	T	C	6	10	16	0	2	18	0	0
5	67887281	.	T	C	4	12	16	0	0	16	0	0
5	67887380	.	G	A	4	8	12	0	0	12	0	0
5	67889104	.	A	G	6	4	10	0	0	10	0	0
5	67889124	.	A	G	6	4	10	0	3	13	0	0
5	67891030	.	A	G	5	14	19	0	0	19	0	0
5	67892776	.	G	A	13	6	19	0	0	19	0	0
5	67892821	.	T	C	13	8	21	0	0	21	0	0
5	67895445	.	A	G	3	2	5	0	0	5	0	0
5	67895490	.	G	C	2	0	2	0	4	6	0	0
5	67895502	.	T	G	1	4	5	0	0	5	0	0
5	67910829	.	T	A	12	8	20	0	0	20	0	0
5	67911097	.	G	T	3	2	5	0	0	5	0	0
5	67974464	.	C	T	8	6	14	0	0	14	0	0
5	67974485	.	C	T	7	5	12	0	0	12	0	0
5	67977911	.	G	T	10	9	19	0	1	20	0	0
5	67977914	.	C	T	6	9	15	0	4	19	0	0
5	67978636	.	G	A	7	7	14	0	1	15	0	0
5	67978662	.	G	T	5	6	11	0	1	12	0	0
5	67978673	.	G	T	6	5	11	0	0	11	0	0
5	67980543	.	C	T	4	2	6	0	1	7	0	0
5	67980719	.	G	A	7	8	15	0	0	15	0	0
5	67980720	.	T	A	7	7	14	0	1	15	0	0
5	67982853	.	G	A	10	9	19	0	0	19	0	0
5	67991148	.	A	G	10	11	21	0	0	21	0	0
5	67992910	.	T	G	7	9	16	0	0	16	0	0
5	67992912	.	C	G	7	7	14	0	2	16	0	0
5	67992962	.	G	A	12	9	21	0	0	21	0	0
5	67992980	.	T	A	10	10	20	0	0	20	0	0
5	67992997	.	A	G	9	8	17	0	0	17	0	0
5	67993017	.	C	T	1	4	5	0	7	12	0	0
5	67993035	.	G	C	2	3	5	0	0	5	0	0
5	68037759	.	A	C	12	0	12	0	12	24	0	0
5	68037950	.	T	C	23	0	23	0	15	38	0	0
5	68042238	.	C	G	0	7	7	0	7	14	0	0
5	68044752	.	A	G	2	8	10	0	1	11	0	0
5	68044996	.	G	A	3	7	10	0	0	10	0	0
5	68045047	.	G	C	5	0	5	0	6	11	0	0
5	68045050	.	T	A	5	5	10	0	0	10	0	0
5	68047999	.	A	G	6	6	12	0	0	12	0	0
5	68048062	.	G	A	6	10	16	0	3	19	0	0
5	68060091	.	T	C	3	5	8	0	0	8	0	0
5	68060097	.	A	G	3	7	10	0	0	10	0	0
5	68060143	.	T	A	9	9	18	0	1	19	0	0
5	68060327	.	A	T	1	11	12	0	1	13	0	0
5	68060406	.	A	T	9	6	15	0	0	15	0	0
5	68060407	.	C	G	9	6	15	0	0	15	0	0
5	68060578	.	T	C	11	9	20	0	1	21	0	0
5	68060617	.	T	C	7	0	7	0	10	17	0	0
5	68060634	.	T	C	6	14	20	0	1	21	0	0
5	68060721	.	T	C	13	1	14	0	7	21	0	0
5	68060789	.	T	G	6	8	14	1	0	15	0	0
5	68066856	.	C	T	12	18	30	0	0	30	0	0
5	68068550	.	C	T	1	18	19	0	24	43	0	0
5	68068574	.	A	G	30	13	43	0	2	45	0	0
5	68069003	.	C	T	4	26	30	1	23	54	0	0
5	68074508	.	G	A	26	19	45	0	2	47	0	0
5	68074565	.	A	G	8	12	20	0	1	21	0	0
5	68076925	.	T	A	8	18	26	0	0	26	0	0
5	68088638	.	T	C	14	1	15	0	20	35	0	0
5	68088641	.	T	A	21	14	35	0	1	36	0	0
5	68090104	.	G	A	31	20	51	0	0	51	0	0
5	68093051	.	A	C	23	2	25	0	21	46	0	0
5	68170797	.	G	A	0	3	3	0	6	9	0	0
5	68180870	.	A	G	17	13	30	0	2	32	0	0
5	68181041	.	A	G	11	16	27	0	1	28	0	0
5	68181056	.	G	A	13	15	28	0	0	28	0	0
5	68188140	.	C	T	9	12	21	0	0	21	0	0
5	68188170	.	C	A	17	12	29	0	0	29	0	0
5	68409956	.	C	T	2	10	12	0	14	26	0	0
5	68409977	.	T	C	14	2	16	0	13	29	0	0
5	68415142	.	C	T	4	8	12	0	2	14	0	0
5	68431452	.	G	A	13	7	20	0	1	21	0	0
5	68431509	.	A	T	6	9	15	0	1	16	0	0
5	68767186	.	T	C	10	3	13	0	2	15	0	0
5	68767358	.	T	C	2	2	4	0	0	4	0	0
5	68767712	.	A	C	4	1	5	0	5	10	0	0
5	68845160	.	C	T	8	2	10	0	0	10	0	0
5	68891782	.	A	G	0	2	2	0	0	2	0	0
5	68891791	.	G	T	5	4	9	0	0	9	0	0
5	68892515	.	A	C	22	20	42	8	0	50	0	0
5	69014276	.	T	C	5	10	15	0	1	16	0	0
5	69140658	.	T	C	4	5	9	0	1	10	0	0
5	69291567	.	T	C	1	3	4	0	0	4	0	0
5	69581937	.	G	A	1	5	6	4	0	10	0	0
5	69595361	.	G	A	5	32	37	1	0	38	0	0
5	69599798	.	G	T	5	13	18	1	1	20	0	0
5	69607398	.	T	C	2	10	12	0	1	13	0	0
5	69608211	.	G	A	4	18	22	3	0	25	0	0
5	69616625	.	A	T	2	4	6	4	1	11	0	0
5	69651935	.	A	G	1	0	1	0	6	7	0	0
5	69907537	.	T	C	8	3	11	0	0	11	0	0
5	69934338	.	G	T	2	2	4	0	0	4	0	0
5	71929353	.	T	C	1	5	6	0	0	6	0	0
5	72126319	.	C	T	1	2	3	1	0	4	0	0
6	28313	.	G	A	5	5	10	0	0	10	0	0
6	29439	.	T	C	14	15	29	0	3	32	0	0
6	31812	.	G	C	0	6	6	0	5	11	0	0
6	31854	.	C	T	3	6	9	0	1	10	0	0
6	32344	.	G	C	3	3	6	0	0	6	0	0
6	32358	.	G	A	0	3	3	0	4	7	0	0
6	32673	.	C	T	4	3	7	0	0	7	0	0
6	33139	.	A	G	3	3	6	0	0	6	0	0
6	35464	.	G	C	6	6	12	0	0	12	0	0
6	36084	.	A	G	4	0	4	0	4	8	0	0
6	37050	.	C	T	5	6	11	0	1	12	0	0
6	37919	.	C	T	8	6	14	0	0	14	0	0
6	38168	.	C	T	6	6	12	0	1	13	0	0
6	38264	.	C	G	10	7	17	0	1	18	0	0
6	41065	.	A	T	8	13	21	0	0	21	0	0
6	41164	.	A	G	4	1	5	0	5	10	0	0
6	42301	.	A	T	10	11	21	0	2	23	0	0
6	58559	.	G	A	0	7	7	0	15	22	0	0
6	59048	.	C	T	13	10	23	0	1	24	0	0
6	59171	.	G	A	9	7	16	0	1	17	0	0
6	59459	.	T	C	7	8	15	0	0	15	0	0
6	59465	.	G	A	6	7	13	0	2	15	0	0
6	59732	.	T	C	15	7	22	0	0	22	0	0
6	68277	.	A	T	4	10	14	0	0	14	0	0
6	92359	.	T	G	23	15	38	0	1	39	0	0
6	92383	.	A	G	19	12	31	0	4	35	0	0
6	93840	.	T	C	20	16	36	0	1	37	0	0
6	93966	.	A	G	19	18	37	0	1	38	0	0
6	102633	.	T	C	4	6	10	0	1	11	0	0
6	103645	.	C	T	1	6	7	0	1	8	0	0
6	104111	.	G	A	1	4	5	0	4	9	0	0
6	121239	.	C	T	3	5	8	0	1	9	0	0
6	125868	.	C	T	1	2	3	0	1	4	0	0
6	132157	.	G	C	5	10	15	0	0	15	0	0
6	132394	.	G	T	9	4	13	1	1	15	0	0
6	132867	.	C	T	6	5	11	1	0	12	0	0
6	132868	.	A	G	6	5	11	1	0	12	0	0
6	134267	.	C	G	4	12	16	0	0	16	0	0
6	134270	.	C	T	1	11	12	0	4	16	0	0
6	136816	.	G	A	2	5	7	0	0	7	0	0
6	136988	.	A	T	7	5	12	0	0	12	0	0
6	152306	.	A	G	14	0	14	0	14	28	0	0
6	152557	.	A	G	7	0	7	2	3	12	0	0
6	152680	.	T	A	8	6	14	0	1	15	0	0
6	184361	.	C	T	12	16	28	0	2	30	0	0
6	184382	.	A	G	12	0	12	0	20	32	0	0
6	202561	.	T	C	10	12	22	0	0	22	0	0
6	202699	.	C	A	16	12	28	0	1	29	0	0
6	203950	.	A	T	5	14	19	0	0	19	0	0
6	204004	.	C	T	7	12	19	0	0	19	0	0
6	204014	.	A	C	5	13	18	0	0	18	0	0
6	204106	.	G	A	2	8	10	0	16	26	0	0
6	204354	.	T	C	9	13	22	0	0	22	0	0
6	204385	.	C	T	5	6	11	0	0	11	0	0
6	204952	.	T	C	8	8	16	0	0	16	0	0
6	205090	.	T	C	9	10	19	0	1	20	0	0
6	205102	.	G	A	10	8	18	0	2	20	0	0
6	205159	.	T	C	16	13	29	0	0	29	0	0
6	205258	.	G	A	1	10	11	0	16	27	0	0
6	265188	.	G	T	13	14	27	0	1	28	0	0
6	265191	.	A	T	15	13	28	0	1	29	0	0
6	265837	.	G	A	20	7	27	0	0	27	0	0
6	267412	.	C	T	8	5	13	0	1	14	0	0
6	267417	.	C	G	9	5	14	0	1	15	0	0
6	267451	.	G	A	3	5	8	0	11	19	0	0
6	267568	.	A	G	10	6	16	0	0	16	0	0
6	267817	.	G	A	5	5	10	0	1	11	0	0
6	267884	.	T	C	3	3	6	0	0	6	0	0
6	267886	.	T	C	2	3	5	0	1	6	0	0
6	271793	.	C	A	27	21	48	0	6	54	0	0
6	272041	.	C	T	27	31	58	0	3	61	0	0
6	272056	.	A	G	29	25	54	0	0	54	0	0
6	272298	.	G	A	0	22	22	0	30	52	0	0
6	272503	.	T	C	12	9	21	0	1	22	0	0
6	322371	.	C	T	20	16	36	0	0	36	0	0
6	331909	.	T	A	17	11	28	0	0	28	0	0
6	331912	.	C	T	17	11	28	0	2	30	0	0
6	340480	.	A	C	27	11	38	0	1	39	0	0
6	340488	.	T	C	24	10	34	0	3	37	0	0
6	340670	.	A	G	16	26	42	0	0	42	0	0
6	340800	.	T	G	11	14	25	0	1	26	0	0
6	340839	.	A	G	11	7	18	0	0	18	0	0
6	340931	.	G	A	13	7	20	0	1	21	0	0
6	341882	.	G	A	20	22	42	0	1	43	0	0
6	341933	.	G	A	15	26	41	0	1	42	0	0
6	341953	.	C	T	15	28	43	0	1	44	0	0
6	342017	.	T	A	16	15	31	0	3	34	0	0
6	342123	.	C	T	12	10	22	0	0	22	0	0
6	374956	.	T	A	4	5	9	0	1	10	0	0
6	374988	.	G	T	5	6	11	0	0	11	0	0
6	375007	.	A	C	4	7	11	0	0	11	0	0
6	375051	.	T	C	1	2	3	0	0	3	0	0
6	378232	.	C	G	1	2	3	0	0	3	0	0
6	521758	.	C	T	2	2	4	0	0	4	0	0
6	543216	.	G	A	5	5	10	0	0	10	0	0
6	543474	.	A	G	3	0	3	0	3	6	0	0
6	840792	.	C	G	13	14	27	0	1	28	0	0
6	841511	.	T	C	14	8	22	0	0	22	0	0
6	841557	.	A	G	8	11	19	0	1	20	0	0
6	841851	.	T	C	16	16	32	1	0	33	0	0
6	841941	.	G	A	11	8	19	1	0	20	0	0
6	842009	.	G	A	9	15	24	0	0	24	0	0
6	842010	.	C	T	4	15	19	0	8	27	0	0
6	842149	.	A	T	17	10	27	0	1	29	1	0
6	842192	.	T	C	16	0	16	0	9	25	0	0
6	842241	.	T	C	11	5	16	0	0	16	0	0
6	842309	.	T	A	25	8	33	0	0	33	0	0
6	842343	.	C	T	8	16	24	0	2	26	0	0
6	842461	.	C	T	4	12	16	0	0	16	0	0
6	842739	.	C	T	2	11	13	0	17	30	0	0
6	842791	.	C	A	22	13	35	0	1	36	0	0
6	842816	.	A	C	13	16	29	0	0	29	0	0
6	843745	.	C	A	13	6	19	1	0	20	0	0
6	843836	.	G	A	6	9	15	1	0	16	0	0
6	843978	.	T	A	3	13	16	0	0	19	3	0
6	844146	.	G	T	4	10	14	0	0	14	0	0
6	844164	.	C	T	9	4	13	0	0	13	0	0
6	844209	.	G	A	6	6	12	0	0	12	0	0
6	844282	.	T	C	6	5	11	0	0	11	0	0
6	844337	.	A	G	5	11	16	0	1	17	0	0
6	844388	.	A	G	17	9	26	0	0	26	0	0
6	858026	.	C	T	0	14	14	0	10	24	0	0
6	858128	.	C	T	2	12	14	0	26	40	0	0
6	858713	.	A	G	11	18	29	0	0	29	0	0
6	859364	.	C	T	12	16	28	0	1	29	0	0
6	859907	.	A	G	7	5	12	0	0	12	0	0
6	859910	.	C	T	5	5	10	0	1	11	0	0
6	866742	.	G	T	5	11	16	0	1	17	0	0
6	869374	.	T	C	3	16	19	0	4	23	0	0
6	1351820	.	C	T	4	4	8	0	0	8	0	0
6	1352177	.	G	A	2	6	8	0	0	8	0	0
6	1431028	.	G	A	6	5	11	0	0	11	0	0
6	1431202	.	C	T	1	3	4	0	1	5	0	0
6	1431370	.	A	G	3	2	5	0	0	5	0	0
6	1431514	.	C	T	0	2	2	0	2	4	0	0
6	1431901	.	T	G	5	2	7	0	1	8	0	0
6	1431940	.	T	C	3	4	7	0	1	8	0	0
6	1431988	.	A	C	3	5	8	0	0	8	0	0
6	1511685	.	A	G	24	26	50	0	1	51	0	0
6	1535603	.	G	T	9	6	15	0	0	15	0	0
6	1538150	.	G	A	17	7	24	0	2	26	0	0
6	1539074	.	G	A	7	8	15	0	1	16	0	0
6	1541215	.	C	G	1	6	7	0	8	15	0	0
6	1541393	.	A	G	9	7	16	0	0	16	0	0
6	1554299	.	T	G	2	3	5	0	0	5	0	0
6	1554922	.	A	T	3	7	10	0	0	10	0	0
6	1555711	.	A	G	3	2	5	0	0	5	0	0
6	1555718	.	G	A	3	2	5	0	0	5	0	0
6	1556890	.	C	T	3	5	8	0	0	8	0	0
6	1557177	.	G	C	3	3	6	0	0	6	0	0
6	1561714	.	A	G	3	2	5	0	0	5	0	0
6	1561807	.	C	G	1	2	3	0	3	6	0	0
6	1562026	.	A	C	2	3	5	0	1	6	0	0
6	1562089	.	A	G	1	2	3	0	2	5	0	0
6	1562230	.	G	A	4	3	7	0	1	8	0	0
6	1571379	.	G	T	1	7	8	0	0	8	0	0
6	1581411	.	C	A	2	2	4	0	0	4	0	0
6	1581418	.	G	A	2	2	4	0	0	4	0	0
6	1581750	.	A	C	1	0	1	0	4	5	0	0
6	1582095	.	C	T	1	2	3	0	0	3	0	0
6	1780069	.	T	C	6	9	15	0	0	15	0	0
6	1780353	.	T	C	16	4	20	0	1	21	0	0
6	1794944	.	T	C	1	6	7	0	0	7	0	0
6	1797352	.	A	C	3	6	9	0	1	10	0	0
6	1797567	.	G	T	1	6	7	0	0	7	0	0
6	1797619	.	T	A	1	3	4	0	0	4	0	0
6	1797624	.	A	T	1	3	4	0	0	4	0	0
6	1798645	.	T	G	5	5	10	0	0	10	0	0
6	1798716	.	T	G	4	6	10	4	1	15	0	0
6	1799112	.	A	T	1	2	3	0	0	3	0	0
6	1812818	.	T	A	2	2	4	0	0	4	0	0
6	1833542	.	C	T	13	8	21	0	2	23	0	0
6	1838527	.	C	T	9	13	22	0	1	23	0	0
6	1843300	.	G	C	14	0	14	0	3	18	1	0
6	1843315	.	C	T	1	4	5	0	12	17	0	0
6	1843342	.	C	T	0	7	7	0	11	18	0	0
6	1843423	.	C	G	3	9	12	0	9	21	0	0
6	1843468	.	G	A	4	5	9	1	0	10	0	0
6	1872047	.	G	A	3	6	9	0	1	10	0	0
6	1874191	.	A	G	8	8	16	0	1	17	0	0
6	1874251	.	A	C	9	0	9	0	6	15	0	0
6	1874305	.	A	G	5	6	11	0	1	12	0	0
6	1874341	.	T	C	9	3	12	0	0	12	0	0
6	1874539	.	T	C	5	5	10	0	0	10	0	0
6	1874554	.	C	T	0	6	6	0	5	11	0	0
6	1874606	.	T	G	8	11	19	0	0	19	0	0
6	1874656	.	C	A	7	12	19	0	0	19	0	0
6	2079288	.	G	A	0	2	2	0	3	5	0	0
6	2089145	.	C	T	2	2	4	1	0	5	0	0
6	2089197	.	A	C	2	2	4	0	0	4	0	0
6	2120821	.	A	C	2	3	5	0	0	5	0	0
6	2120833	.	T	C	2	2	4	0	0	4	0	0
6	2121397	.	A	T	1	5	6	0	0	6	0	0
6	2126043	.	G	A	3	2	5	0	0	5	0	0
6	2126184	.	A	T	2	5	7	0	0	7	0	0
6	2126227	.	G	A	2	3	5	0	0	5	0	0
6	2126469	.	T	C	0	8	8	0	0	8	0	0
6	2126486	.	T	A	2	7	9	0	0	9	0	0
6	2126512	.	C	T	4	3	7	0	0	7	0	0
6	2165703	.	T	G	2	4	6	0	0	6	0	0
6	2165735	.	A	T	1	3	4	0	0	4	0	0
6	2165955	.	A	G	6	4	10	0	0	10	0	0
6	2165982	.	A	T	3	6	9	0	0	9	0	0
6	2166074	.	G	A	4	4	8	0	1	9	0	0
6	2166085	.	T	G	4	5	9	0	0	9	0	0
6	2166111	.	A	T	6	4	10	0	0	10	0	0
6	2166157	.	G	A	2	9	11	0	0	11	0	0
6	2166240	.	T	C	6	0	6	0	5	11	0	0
6	2166287	.	A	T	3	3	6	0	0	6	0	0
6	2166531	.	A	T	9	6	15	0	0	15	0	0
6	2170215	.	A	C	4	3	7	0	0	7	0	0
6	2171341	.	A	G	5	8	13	0	0	13	0	0
6	2190325	.	T	A	7	7	14	0	1	15	0	0
6	2190337	.	C	T	7	7	14	0	1	15	0	0
6	2190857	.	C	T	5	8	13	0	0	13	0	0
6	2194178	.	A	G	7	13	20	0	1	21	0	0
6	2198105	.	G	C	15	14	29	0	1	30	0	0
6	2206682	.	C	T	4	3	7	0	0	7	0	0
6	2206884	.	G	A	5	4	9	0	0	9	0	0
6	2207189	.	G	T	3	3	6	0	0	6	0	0
6	2208117	.	G	A	1	3	4	0	0	4	0	0
6	2208261	.	A	T	4	3	7	0	2	9	0	0
6	2208479	.	T	G	10	7	17	0	0	17	0	0
6	2208522	.	T	C	5	8	13	0	0	13	0	0
6	2208562	.	C	T	3	5	8	0	0	8	0	0
6	2208609	.	C	T	3	4	7	0	1	8	0	0
6	2210120	.	A	G	9	7	16	0	0	16	0	0
6	2215208	.	T	A	11	4	15	0	1	16	0	0
6	2216896	.	G	T	9	4	13	0	0	13	0	0
6	2217689	.	C	T	1	6	7	0	4	11	0	0
6	2271637	.	A	C	11	7	18	0	0	18	0	0
6	2372043	.	A	T	7	5	12	0	0	12	0	0
6	2384828	.	C	T	8	6	14	0	0	14	0	0
6	2391475	.	G	A	1	11	12	1	14	27	0	0
6	2453730	.	T	C	8	8	16	0	1	17	0	0
6	2453751	.	A	C	8	12	20	0	0	20	0	0
6	2492862	.	A	T	4	3	7	0	0	7	0	0
6	2524835	.	C	T	1	3	4	0	1	5	0	0
6	2533345	.	T	G	2	4	6	0	0	6	0	0
6	2537890	.	G	T	2	3	5	0	0	5	0	0
6	2537896	.	G	T	3	3	6	0	0	6	0	0
6	2560464	.	C	T	4	2	6	0	0	6	0	0
6	2560494	.	G	A	0	5	5	0	5	10	0	0
6	2560500	.	C	T	6	4	10	0	0	10	0	0
6	2562615	.	G	A	0	3	3	0	3	6	0	0
6	2586037	.	A	G	1	0	1	0	4	5	0	0
6	2586154	.	G	A	3	3	6	0	0	6	0	0
6	2621637	.	C	G	1	4	5	0	6	11	0	0
6	2621656	.	G	A	2	8	10	0	0	10	0	0
6	2621677	.	C	T	3	8	11	0	2	13	0	0
6	2621719	.	T	A	5	3	8	0	0	8	0	0
6	2623378	.	G	C	11	7	18	0	1	19	0	0
6	2624527	.	G	C	3	2	5	0	0	5	0	0
6	3005115	.	C	A	6	8	14	0	0	14	0	0
6	3005179	.	G	T	5	7	12	0	0	12	0	0
6	3005215	.	T	C	8	6	14	0	0	14	0	0
6	3040572	.	G	A	10	7	17	0	0	17	0	0
6	3142968	.	T	C	5	5	10	0	0	10	0	0
6	3143019	.	C	T	6	6	12	0	0	12	0	0
6	3143292	.	T	A	4	12	16	0	0	16	0	0
6	3145256	.	C	A	5	14	19	0	1	20	0	0
6	3197028	.	C	T	7	10	17	0	0	17	0	0
6	3205538	.	T	C	9	17	26	0	1	27	0	0
6	3223245	.	C	T	9	6	15	0	0	15	0	0
6	3223341	.	C	G	8	5	13	0	0	13	0	0
6	3268327	.	T	C	10	19	29	0	0	29	0	0
6	3270011	.	G	A	14	21	35	0	1	36	0	0
6	3273341	.	T	A	11	9	20	0	3	23	0	0
6	3273379	.	A	G	12	9	21	0	0	21	0	0
6	3273588	.	A	T	11	7	18	0	2	20	0	0
6	3273826	.	A	T	13	13	26	0	0	26	0	0
6	3273965	.	C	T	15	11	26	0	0	26	0	0
6	3273986	.	T	C	17	16	33	0	0	33	0	0
6	3274114	.	G	C	4	13	17	0	19	36	0	0
6	3274289	.	C	T	16	13	29	0	0	29	0	0
6	3280986	.	A	T	4	2	6	0	1	7	0	0
6	3284988	.	A	C	4	3	7	0	0	7	0	0
6	3290433	.	A	G	2	0	2	0	5	7	0	0
6	3293193	.	G	A	0	5	5	0	1	6	0	0
6	3293321	.	A	T	2	2	4	0	1	5	0	0
6	3293322	.	T	C	3	2	5	0	0	5	0	0
6	3293428	.	T	A	3	6	9	0	0	9	0	0
6	3293441	.	C	G	4	4	8	0	0	8	0	0
6	3295998	.	C	A	5	6	11	0	4	15	0	0
6	3296303	.	G	A	8	4	12	0	0	12	0	0
6	3298797	.	C	T	1	8	9	0	0	9	0	0
6	3302644	.	T	C	2	3	5	0	1	6	0	0
6	3302645	.	A	G	3	0	3	0	3	6	0	0
6	3302734	.	T	C	3	4	7	0	0	7	0	0
6	3309358	.	C	T	9	5	14	0	2	16	0	0
6	3312750	.	A	T	5	5	10	0	0	10	0	0
6	3318673	.	T	C	4	4	8	0	1	10	1	0
6	3318990	.	C	T	3	2	5	0	0	5	0	0
6	3319047	.	A	G	3	3	6	0	0	6	0	0
6	3334494	.	A	G	4	0	4	0	3	7	0	0
6	3334502	.	T	C	4	4	8	0	0	8	0	0
6	3343800	.	T	C	2	4	6	0	0	6	0	0
6	3395649	.	C	T	4	3	7	0	0	7	0	0
6	3404956	.	G	A	0	4	4	0	1	5	0	0
6	3405060	.	G	A	0	4	4	0	5	9	0	0
6	3405143	.	T	C	6	7	13	0	1	14	0	0
6	3405191	.	G	C	6	9	15	0	0	15	0	0
6	3405244	.	A	G	8	5	13	0	0	13	0	0
6	3405245	.	C	A	7	5	12	0	0	12	0	0
6	3500040	.	C	T	0	4	4	0	2	6	0	0
6	3500212	.	G	A	1	4	5	0	0	5	0	0
6	3506566	.	A	G	1	2	3	0	1	4	0	0
6	3506783	.	T	C	2	3	5	0	0	5	0	0
6	3506837	.	A	G	1	2	3	0	0	3	0	0
6	3514481	.	A	C	32	23	55	2	2	59	0	0
6	3531910	.	C	T	1	2	3	0	0	3	0	0
6	3537472	.	G	A	2	3	5	0	0	5	0	0
6	3540138	.	A	G	1	4	5	0	0	5	0	0
6	3540159	.	G	A	0	4	4	0	2	6	0	0
6	3564143	.	C	T	2	2	4	0	0	4	0	0
6	3564404	.	A	G	3	5	8	0	0	8	0	0
6	3698558	.	C	T	4	5	9	0	0	9	0	0
6	3704391	.	G	A	0	7	7	0	13	20	0	0
6	3707095	.	A	G	14	9	23	0	1	24	0	0
6	3707116	.	G	A	13	11	24	0	2	26	0	0
6	3707371	.	G	A	0	9	9	0	16	25	0	0
6	3707372	.	A	G	14	10	24	0	1	25	0	0
6	3707407	.	T	C	9	16	25	0	1	26	0	0
6	3708061	.	A	G	11	5	16	0	1	17	0	0
6	3708149	.	T	C	6	6	12	0	0	12	0	0
6	3711200	.	T	A	10	11	21	0	0	21	0	0
6	3711221	.	A	G	12	12	24	0	1	25	0	0
6	3711282	.	T	G	13	2	15	0	13	29	1	0
6	3711338	.	A	G	9	13	22	0	0	22	0	0
6	3711386	.	T	C	9	8	17	0	2	19	0	0
6	3711419	.	A	G	6	5	11	0	0	11	0	0
6	3711448	.	C	A	5	6	11	0	0	11	0	0
6	3711616	.	G	A	3	6	9	0	0	9	0	0
6	3711665	.	A	T	6	5	11	0	0	11	0	0
6	3711703	.	G	A	0	2	2	0	2	4	0	0
6	3711971	.	G	A	10	5	15	0	0	15	0	0
6	3712045	.	T	A	12	10	22	0	0	22	0	0
6	3712069	.	A	T	9	14	23	0	0	23	0	0
6	3712136	.	G	A	7	4	11	0	1	12	0	0
6	3712198	.	G	T	10	6	16	0	0	16	0	0
6	3712199	.	A	C	8	6	14	0	2	16	0	0
6	3712238	.	A	T	6	4	10	0	0	10	0	0
6	3712264	.	A	C	5	3	8	0	0	8	0	0
6	3712335	.	T	G	6	0	6	0	6	12	0	0
6	3712389	.	C	T	2	8	10	0	0	10	0	0
6	3712713	.	C	G	8	6	14	0	0	14	0	0
6	3717060	.	T	A	6	5	11	0	0	11	0	0
6	3717110	.	A	T	17	8	25	0	1	26	0	0
6	3717843	.	C	T	14	10	24	0	0	24	0	0
6	3724870	.	A	C	13	12	25	0	2	27	0	0
6	3725767	.	C	A	26	10	36	0	2	38	0	0
6	3727891	.	C	T	10	9	19	0	2	21	0	0
6	3728295	.	A	T	9	7	16	0	1	17	0	0
6	3728559	.	G	C	3	2	5	0	0	5	0	0
6	3827894	.	C	A	19	25	44	0	2	46	0	0
6	3834630	.	G	C	26	35	61	0	5	66	0	0
6	3853120	.	T	G	32	0	32	0	37	69	0	0
6	3853165	.	T	C	34	39	73	0	4	77	0	0
6	3862018	.	A	G	8	14	22	0	2	24	0	0
6	3867542	.	A	T	8	13	21	0	1	22	0	0
6	3869454	.	G	A	2	18	20	0	20	40	0	0
6	3869891	.	C	T	21	25	46	0	2	48	0	0
6	3871982	.	T	A	26	20	46	0	2	48	0	0
6	3874504	.	G	A	4	19	23	0	20	43	0	0
6	3874533	.	C	T	16	28	44	0	2	46	0	0
6	3874686	.	A	G	17	9	26	0	1	27	0	0
6	3878513	.	T	A	3	6	9	0	0	9	0	0
6	3878593	.	A	G	5	8	13	0	1	14	0	0
6	3878831	.	G	C	4	2	6	0	0	6	0	0
6	3878983	.	A	T	9	10	19	0	5	24	0	0
6	3879158	.	A	G	10	8	18	0	0	18	0	0
6	3879247	.	C	A	3	12	15	0	10	25	0	0
6	3879314	.	C	G	0	15	15	0	12	27	0	0
6	3879335	.	C	T	11	14	25	0	0	25	0	0
6	3879367	.	G	A	10	16	26	0	0	27	1	0
6	3881078	.	G	A	14	10	24	0	0	24	0	0
6	3885451	.	C	T	8	13	21	0	4	25	0	0
6	3895442	.	A	T	11	8	19	0	0	19	0	0
6	3895460	.	C	T	0	11	11	0	12	23	0	0
6	3901120	.	C	T	0	6	6	0	15	21	0	0
6	3906051	.	C	T	1	12	13	0	13	26	0	0
6	3907796	.	A	T	7	7	14	0	0	14	0	0
6	3944518	.	G	T	6	9	15	0	0	15	0	0
6	3945773	.	C	A	6	8	14	0	1	15	0	0
6	3945792	.	C	A	8	7	15	0	0	15	0	0
6	3950267	.	C	T	5	7	12	0	0	12	0	0
6	3950270	.	C	T	7	5	12	0	0	12	0	0
6	3950309	.	C	T	8	4	12	0	0	12	0	0
6	3953280	.	T	C	4	11	15	0	2	17	0	0
6	3953302	.	A	C	3	10	13	0	1	14	0	0
6	3961387	.	G	A	2	4	6	0	0	6	0	0
6	3962132	.	G	A	26	24	50	0	4	54	0	0
6	3962192	.	A	T	29	15	44	0	1	45	0	0
6	3965389	.	G	T	14	11	25	0	1	26	0	0
6	3965461	.	A	G	16	15	31	0	0	31	0	0
6	3973572	.	G	A	8	15	23	0	1	24	0	0
6	3973638	.	T	G	12	15	27	0	0	27	0	0
6	3974047	.	G	A	7	16	23	0	0	23	0	0
6	3984909	.	T	A	1	3	4	0	0	4	0	0
6	3985083	.	G	A	7	3	10	0	0	10	0	0
6	3985137	.	G	A	5	9	14	0	0	14	0	0
6	3987131	.	A	G	5	4	9	0	0	9	0	0
6	3987145	.	T	C	3	4	7	0	0	7	0	0
6	3989704	.	C	A	1	2	3	0	1	4	0	0
6	4109915	.	T	C	0	5	5	0	0	5	0	0
6	4109924	.	C	T	2	4	6	0	0	6	0	0
6	4110014	.	T	C	3	2	5	0	0	5	0	0
6	4144415	.	C	T	4	4	8	0	0	8	0	0
6	4144448	.	C	T	4	3	7	0	0	7	0	0
6	4145917	.	C	G	3	5	8	0	0	8	0	0
6	4185678	.	G	A	19	18	37	0	3	40	0	0
6	4191449	.	C	T	11	12	23	0	0	23	0	0
6	4191554	.	A	T	10	15	25	0	0	25	0	0
6	4192025	.	G	A	14	9	23	0	1	24	0	0
6	4192031	.	A	G	8	12	20	0	1	21	0	0
6	4192171	.	G	A	8	3	11	0	0	11	0	0
6	4199494	.	T	C	9	6	15	0	1	16	0	0
6	4200799	.	C	T	6	6	12	0	0	12	0	0
6	4204072	.	G	T	2	10	12	0	2	14	0	0
6	4204117	.	G	T	3	9	12	0	2	14	0	0
6	4206411	.	G	A	7	2	9	0	0	9	0	0
6	4206435	.	G	A	6	8	14	0	1	15	0	0
6	4219856	.	G	A	9	12	21	0	0	21	0	0
6	4229789	.	T	C	7	4	11	0	0	11	0	0
6	4229790	.	T	C	7	4	11	0	0	11	0	0
6	4229830	.	C	T	4	3	7	0	0	7	0	0
6	4229854	.	A	G	6	6	12	0	0	12	0	0
6	4241945	.	C	T	4	3	7	0	0	7	0	0
6	4241954	.	A	G	5	4	9	0	0	9	0	0
6	4245276	.	C	T	8	9	17	0	0	17	0	0
6	4246466	.	T	C	7	8	15	1	0	16	0	0
6	4246496	.	G	A	1	7	8	0	7	15	0	0
6	4247442	.	C	G	3	7	10	2	1	13	0	0
6	4247928	.	C	T	10	4	14	0	0	14	0	0
6	4247942	.	T	C	2	9	11	0	2	13	0	0
6	4248231	.	A	G	4	1	5	0	7	12	0	0
6	4248307	.	G	A	0	5	5	0	3	8	0	0
6	4248399	.	A	T	4	2	6	1	0	7	0	0
6	4248412	.	T	A	4	2	6	1	0	7	0	0
6	4249420	.	C	T	4	8	12	0	0	12	0	0
6	4249437	.	A	G	2	8	10	0	0	10	0	0
6	4249684	.	A	G	7	4	11	0	0	11	0	0
6	4314415	.	A	T	4	3	7	0	0	7	0	0
6	4314446	.	C	T	5	5	10	0	0	10	0	0
6	4319805	.	C	A	5	3	8	0	0	8	0	0
6	4322404	.	G	A	1	7	8	0	8	16	0	0
6	4329801	.	C	T	3	3	6	0	0	6	0	0
6	4332730	.	G	A	0	2	2	0	6	8	0	0
6	4337436	.	C	T	6	6	12	0	0	12	0	0
6	4337442	.	C	T	5	6	11	0	0	11	0	0
6	4341944	.	G	A	5	2	7	0	0	7	0	0
6	4347490	.	C	A	1	5	6	0	0	6	0	0
6	4347505	.	A	T	1	3	4	0	0	4	0	0
6	4347541	.	T	C	1	6	7	0	0	7	0	0
6	4349060	.	A	G	5	5	10	0	0	10	0	0
6	4352140	.	G	T	5	5	10	0	0	10	0	0
6	4357277	.	C	T	2	6	8	0	0	8	0	0
6	4357299	.	G	A	2	3	5	0	1	6	0	0
6	4359857	.	C	G	5	6	11	0	0	11	0	0
6	4360110	.	C	T	5	2	7	0	1	8	0	0
6	4365163	.	C	T	7	5	12	0	0	12	0	0
6	4365295	.	G	C	9	8	17	0	1	18	0	0
6	4376831	.	T	C	10	8	18	0	0	18	0	0
6	4376849	.	G	A	0	8	8	0	6	14	0	0
6	4377182	.	A	G	9	4	13	0	0	13	0	0
6	4379559	.	G	C	13	10	23	0	1	24	0	0
6	4379760	.	G	A	1	5	6	0	9	15	0	0
6	4386999	.	C	T	12	5	17	0	0	17	0	0
6	4389434	.	G	A	7	10	17	0	0	17	0	0
6	4389436	.	T	C	12	7	19	0	0	19	0	0
6	4392639	.	C	T	5	9	14	0	0	14	0	0
6	4397173	.	G	A	13	8	21	0	2	23	0	0
6	4397181	.	C	A	13	11	24	0	0	24	0	0
6	4397262	.	C	T	12	7	19	0	0	19	0	0
6	4398906	.	C	T	5	12	17	0	0	17	0	0
6	4398939	.	A	C	7	13	20	0	1	21	0	0
6	4400803	.	T	A	3	3	6	0	0	6	0	0
6	4400999	.	C	T	4	5	9	0	0	9	0	0
6	4401087	.	T	A	3	6	9	0	1	10	0	0
6	4401088	.	A	T	4	6	10	0	0	10	0	0
6	4416859	.	G	A	3	3	6	0	0	6	0	0
6	4531158	.	T	C	2	4	6	0	0	6	0	0
6	4540115	.	C	A	2	2	4	0	0	4	0	0
6	4540422	.	A	G	5	11	16	0	0	16	0	0
6	4542260	.	G	A	0	3	3	0	3	6	0	0
6	4542492	.	A	G	2	0	2	0	3	5	0	0
6	4542573	.	A	C	2	5	7	0	0	7	0	0
6	4873028	.	T	A	6	4	10	0	0	10	0	0
6	4873119	.	G	A	4	8	12	0	1	13	0	0
6	4873321	.	C	G	4	5	9	0	0	9	0	0
6	4874563	.	C	T	5	3	8	0	1	9	0	0
6	4874821	.	G	C	4	4	8	0	0	8	0	0
6	4875031	.	G	A	2	4	6	0	10	16	0	0
6	4875292	.	C	T	6	4	10	0	1	11	0	0
6	4876522	.	G	C	0	8	8	0	6	14	0	0
6	4876738	.	G	A	15	20	35	0	0	35	0	0
6	4876946	.	C	A	6	9	15	0	1	16	0	0
6	4877023	.	C	T	10	7	17	0	0	17	0	0
6	6231186	.	C	A	2	2	4	0	0	4	0	0
6	6231244	.	T	C	2	3	5	0	0	5	0	0
6	6231262	.	T	C	3	2	5	0	0	5	0	0
6	6231321	.	C	A	2	4	6	0	0	6	0	0
6	6231337	.	A	C	1	4	5	0	1	6	0	0
6	6232301	.	A	C	33	23	56	0	0	56	0	0
6	6232315	.	T	C	35	0	35	0	23	58	0	0
6	6234779	.	A	G	25	22	47	0	0	47	0	0
6	6235307	.	G	A	30	19	49	0	2	51	0	0
6	6258045	.	G	C	15	1	16	0	5	21	0	0
6	6258130	.	C	T	7	12	19	0	1	20	0	0
6	6258239	.	C	T	2	7	9	0	11	20	0	0
6	6258240	.	A	G	7	13	20	0	0	20	0	0
6	6270882	.	G	C	23	20	43	0	1	44	0	0
6	6273345	.	C	T	33	35	68	0	1	69	0	0
6	6273396	.	C	T	28	31	59	0	2	61	0	0
6	6275574	.	G	A	3	2	5	0	1	6	0	0
6	6275599	.	A	G	6	4	10	0	1	11	0	0
6	6275667	.	C	T	7	5	12	0	0	12	0	0
6	6275668	.	A	G	6	5	11	0	0	11	0	0
6	6284114	.	A	G	12	5	17	0	0	17	0	0
6	6293926	.	T	C	6	0	6	0	10	16	0	0
6	6303823	.	C	A	1	3	4	0	0	4	0	0
6	6308018	.	A	G	4	2	6	0	0	6	0	0
6	6317168	.	G	A	2	2	4	0	0	4	0	0
6	6317246	.	G	A	2	2	4	0	0	4	0	0
6	6317290	.	T	C	2	2	4	0	0	4	0	0
6	6317308	.	A	C	1	3	4	0	0	4	0	0
6	6317327	.	C	T	1	4	5	0	0	5	0	0
6	6317383	.	G	A	2	2	4	0	0	4	0	0
6	6317395	.	G	T	2	2	4	0	0	4	0	0
6	6321624	.	G	A	2	2	4	0	0	4	0	0
6	6330877	.	C	T	3	4	7	0	1	8	0	0
6	6395035	.	T	G	4	8	12	0	0	12	0	0
6	6395096	.	C	T	0	7	7	0	5	12	0	0
6	6395099	.	C	T	7	3	10	0	1	11	0	0
6	6395211	.	T	A	9	7	16	0	0	16	0	0
6	6395222	.	T	A	11	6	17	0	0	17	0	0
6	6395367	.	C	T	0	4	4	0	8	12	0	0
6	6395405	.	C	T	8	6	14	0	1	15	0	0
6	6413400	.	G	A	1	4	5	0	0	5	0	0
6	6423664	.	G	C	0	0	0	0	5	5	0	0
6	6423669	.	A	G	1	3	4	0	0	4	0	0
6	6423827	.	C	T	0	3	3	1	3	7	0	0
6	6459235	.	T	C	9	7	16	0	1	17	0	0
6	6459315	.	G	A	7	6	13	0	1	14	0	0
6	6463633	.	T	G	5	8	13	0	0	13	0	0
6	6466502	.	C	T	9	4	13	0	1	14	0	0
6	6467931	.	C	T	0	7	7	0	12	19	0	0
6	6470529	.	G	A	7	8	15	0	0	15	0	0
6	6471174	.	C	G	5	8	13	0	0	13	0	0
6	6471391	.	G	A	6	6	12	1	0	13	0	0
6	6471726	.	T	C	7	6	13	0	0	13	0	0
6	6471843	.	T	G	8	9	17	0	0	17	0	0
6	6471875	.	C	G	8	7	15	0	1	16	0	0
6	6472040	.	T	G	6	9	15	0	0	15	0	0
6	6472059	.	T	A	7	3	10	0	0	10	0	0
6	6472177	.	T	C	5	3	8	0	0	8	0	0
6	6475515	.	C	T	1	3	4	0	5	9	0	0
6	6475576	.	G	T	7	3	10	0	1	11	0	0
6	6475578	.	G	T	5	5	10	0	2	12	0	0
6	6475712	.	C	T	6	4	10	0	0	10	0	0
6	6475740	.	T	A	6	3	9	0	0	9	0	0
6	6475836	.	T	C	4	0	4	0	5	9	0	0
6	6477578	.	C	A	0	7	7	0	4	11	0	0
6	6480100	.	T	A	5	7	12	0	0	12	0	0
6	6480405	.	G	A	4	6	10	0	1	11	0	0
6	6480417	.	G	A	4	5	9	0	0	9	0	0
6	6480583	.	A	G	4	5	9	0	1	10	0	0
6	6482512	.	C	T	6	13	19	0	0	19	0	0
6	6491108	.	C	T	4	3	7	0	0	7	0	0
6	6491152	.	T	C	2	4	6	0	0	6	0	0
6	6498842	.	C	T	2	2	4	0	0	4	0	0
6	6498866	.	G	A	1	3	4	0	2	6	0	0
6	6539842	.	T	G	7	0	7	0	5	12	0	0
6	6539848	.	T	A	5	5	10	0	0	10	0	0
6	6540903	.	A	G	4	5	9	0	1	10	0	0
6	6540964	.	T	A	4	2	6	0	0	6	0	0
6	6541128	.	G	A	2	7	9	0	1	10	0	0
6	6541360	.	T	C	3	3	6	0	0	6	0	0
6	6541369	.	A	G	3	0	3	0	3	6	0	0
6	6666079	.	C	T	7	3	10	0	0	10	0	0
6	6666322	.	T	A	4	2	6	0	0	6	0	0
6	6669502	.	C	G	1	5	6	0	0	6	0	0
6	6671545	.	G	C	7	4	11	0	0	11	0	0
6	6671607	.	C	G	7	3	10	0	0	10	0	0
6	6673527	.	C	A	7	6	13	0	3	16	0	0
6	6737391	.	C	T	17	7	24	0	0	24	0	0
6	6737401	.	G	T	14	6	20	0	0	20	0	0
6	6737982	.	T	A	14	23	37	0	1	38	0	0
6	6737998	.	C	T	1	25	26	0	15	41	0	0
6	6769345	.	T	A	14	8	22	0	0	22	0	0
6	6769716	.	C	T	11	16	27	0	0	27	0	0
6	6769719	.	T	C	10	12	22	0	1	24	1	0
6	6769782	.	A	G	10	5	15	0	0	15	0	0
6	6775689	.	G	T	8	7	15	0	1	17	1	0
6	6784095	.	G	A	7	11	18	0	2	20	0	0
6	6784239	.	G	C	6	7	13	0	0	13	0	0
6	6785788	.	G	A	6	11	17	0	1	18	0	0
6	6788714	.	A	G	6	0	6	0	3	9	0	0
6	6793164	.	C	T	11	13	24	0	0	24	0	0
6	6793224	.	G	A	0	11	11	0	5	16	0	0
6	6795520	.	T	A	5	3	8	0	0	8	0	0
6	6795526	.	C	T	2	5	7	0	0	7	0	0
6	6795664	.	T	C	4	9	13	0	1	14	0	0
6	6797583	.	A	G	5	6	11	0	1	12	0	0
6	6797598	.	T	C	11	7	18	0	1	19	0	0
6	6797694	.	T	A	8	5	13	0	0	13	0	0
6	6800091	.	A	G	3	3	6	0	0	6	0	0
6	6800107	.	T	A	4	2	6	0	0	6	0	0
6	6803534	.	T	A	11	9	20	0	2	22	0	0
6	6803726	.	T	A	11	10	21	0	0	21	0	0
6	6805245	.	C	T	10	11	21	1	0	22	0	0
6	6805275	.	G	A	11	10	21	1	1	23	0	0
6	6805381	.	C	A	2	1	3	0	0	3	0	0
6	6805388	.	G	A	0	2	2	0	2	4	0	0
6	6805477	.	T	C	2	4	6	0	1	7	0	0
6	6805572	.	G	T	17	17	34	0	2	36	0	0
6	6806828	.	A	C	0	1	1	0	2	3	0	0
6	6808431	.	C	G	3	8	11	0	0	11	0	0
6	6900767	.	T	C	5	8	13	0	0	13	0	0
6	6903468	.	C	T	10	11	21	0	0	21	0	0
6	6903513	.	G	A	13	12	25	0	1	26	0	0
6	6905848	.	G	A	2	11	13	0	15	28	0	0
6	6908699	.	A	G	3	7	10	0	0	10	0	0
6	6908955	.	A	G	3	11	14	0	2	16	0	0
6	6916417	.	A	G	7	0	7	0	8	15	0	0
6	6919866	.	G	T	0	9	9	0	9	18	0	0
6	6920135	.	G	A	2	2	4	0	0	4	0	0
6	6920171	.	C	T	3	2	5	0	0	5	0	0
6	6920673	.	A	T	9	9	18	0	0	18	0	0
6	6920938	.	G	A	3	3	6	0	1	7	0	0
6	6921577	.	C	T	6	10	16	0	0	16	0	0
6	6921581	.	T	C	5	8	13	0	2	15	0	0
6	6921802	.	G	A	13	21	34	1	1	36	0	0
6	6921889	.	T	A	10	15	25	0	2	27	0	0
6	6922072	.	G	T	10	14	24	0	0	24	0	0
6	6922187	.	T	C	8	8	16	0	1	17	0	0
6	6944662	.	T	C	1	2	3	0	0	3	0	0
6	6973009	.	A	T	5	7	12	0	1	13	0	0
6	6973383	.	G	T	5	7	12	22	3	37	0	0
6	6990063	.	G	A	1	6	7	10	0	17	0	0
6	7086134	.	G	C	1	3	4	0	0	4	0	0
6	7089952	.	C	G	5	3	8	0	0	8	0	0
6	7105400	.	C	T	1	8	9	0	0	9	0	0
6	7107034	.	A	G	3	5	8	1	0	9	0	0
6	7110148	.	C	T	11	12	23	0	0	23	0	0
6	7110434	.	C	T	10	6	16	0	1	17	0	0
6	7110435	.	T	G	11	6	17	0	0	17	0	0
6	7110551	.	C	T	15	20	35	0	0	35	0	0
6	7113001	.	T	G	12	7	19	0	2	21	0	0
6	7114482	.	C	T	11	16	27	0	2	29	0	0
6	7114937	.	A	G	18	11	29	0	2	31	0	0
6	7115967	.	T	C	16	19	35	0	0	35	0	0
6	7118398	.	A	C	10	8	18	0	0	18	0	0
6	7133402	.	C	T	1	2	3	0	0	3	0	0
6	7157570	.	G	A	9	9	18	0	1	19	0	0
6	7157615	.	C	T	6	11	17	0	0	17	0	0
6	7157771	.	G	A	3	6	9	0	0	9	0	0
6	7207652	.	G	A	4	4	8	0	0	8	0	0
6	7207934	.	G	A	3	7	10	0	0	10	0	0
6	7251362	.	A	T	5	2	7	0	0	7	0	0
6	7251426	.	A	G	9	5	14	0	0	14	0	0
6	7251564	.	G	A	6	8	14	0	0	14	0	0
6	7251627	.	A	G	9	6	15	0	0	15	0	0
6	7251694	.	G	A	5	5	10	0	0	10	0	0
6	7265179	.	G	A	2	4	6	1	0	7	0	0
6	7270355	.	T	C	10	6	16	0	1	17	0	0
6	7273005	.	A	G	7	1	8	0	4	12	0	0
6	7273021	.	C	T	9	7	16	0	0	16	0	0
6	7273518	.	G	A	1	4	5	0	2	7	0	0
6	7276139	.	T	C	1	5	6	0	0	6	0	0
6	7276178	.	T	A	5	7	12	0	0	12	0	0
6	7276212	.	C	T	8	7	15	0	0	15	0	0
6	7276263	.	G	A	0	7	7	0	4	11	0	0
6	7276776	.	A	C	4	4	8	0	0	8	0	0
6	7381197	.	T	C	3	2	5	0	0	5	0	0
6	7390358	.	A	G	2	1	3	0	1	4	0	0
6	7415105	.	A	G	1	1	2	0	1	3	0	0
6	7415108	.	T	C	1	1	2	0	0	2	0	0
6	7438474	.	C	T	11	5	16	0	0	16	0	0
6	7444930	.	T	C	28	20	48	0	1	49	0	0
6	7451563	.	T	G	23	19	42	0	1	43	0	0
6	7452519	.	T	C	13	25	38	0	0	38	0	0
6	7453379	.	T	G	30	1	31	1	17	49	0	0
6	7453567	.	G	T	21	10	31	0	1	32	0	0
6	7453649	.	C	G	20	10	30	1	2	33	0	0
6	7453660	.	C	T	20	8	28	1	1	30	0	0
6	7529346	.	A	G	1	2	3	0	0	3	0	0
6	7529493	.	G	C	1	3	4	0	0	4	0	0
6	7530295	.	T	C	1	2	3	0	0	3	0	0
6	7530494	.	T	A	0	2	2	0	1	3	0	0
6	7530577	.	A	G	4	2	6	0	0	6	0	0
6	7542491	.	G	T	1	14	15	0	18	33	0	0
6	7545794	.	C	T	22	9	31	0	1	32	0	0
6	7545824	.	T	C	20	12	32	0	3	35	0	0
6	7547451	.	C	T	12	12	24	0	1	25	0	0
6	7549967	.	G	A	25	22	47	0	1	48	0	0
6	7550040	.	A	C	8	3	11	1	9	21	0	0
6	7550046	.	A	C	10	7	17	1	7	25	0	0
6	7550210	.	A	C	13	8	21	0	6	27	0	0
6	7550405	.	C	T	15	12	27	0	1	28	0	0
6	7551087	.	C	A	3	2	5	0	0	5	0	0
6	7555618	.	C	T	6	14	20	0	1	21	0	0
6	7555634	.	G	T	13	7	20	0	0	20	0	0
6	7555871	.	G	A	12	9	21	0	1	22	0	0
6	7591018	.	G	A	10	8	18	0	1	19	0	0
6	7624725	.	T	C	14	8	22	0	0	22	0	0
6	7626457	.	C	T	12	10	22	0	1	23	0	0
6	7633452	.	G	C	2	8	10	0	18	28	0	0
6	7636811	.	A	T	13	15	28	0	2	30	0	0
6	7637195	.	C	T	16	22	38	0	2	40	0	0
6	7638717	.	G	A	14	16	30	0	0	30	0	0
6	7645319	.	T	C	16	15	31	0	2	34	1	0
6	7646039	.	A	G	26	15	41	0	1	42	0	0
6	7646102	.	G	A	21	18	39	0	2	41	0	0
6	7646111	.	G	C	20	20	40	0	1	41	0	0
6	7648224	.	A	G	17	0	17	0	17	34	0	0
6	7652458	.	C	T	24	19	43	0	2	45	0	0
6	7652470	.	A	C	27	18	45	0	0	45	0	0
6	7652896	.	G	A	2	22	24	0	26	50	0	0
6	7652959	.	C	T	16	27	43	0	3	46	0	0
6	7652989	.	C	T	16	28	44	0	2	46	0	0
6	7656920	.	A	G	17	2	19	1	31	51	0	0
6	7656932	.	A	G	15	30	45	1	3	49	0	0
6	7657177	.	C	T	17	14	31	0	0	31	0	0
6	7657793	.	A	C	16	15	31	0	0	31	0	0
6	7657886	.	T	A	24	20	44	0	2	46	0	0
6	7657887	.	G	T	24	22	46	0	0	46	0	0
6	7657972	.	T	G	14	7	21	1	0	22	0	0
6	7658076	.	G	A	9	14	23	0	0	23	0	0
6	7659915	.	G	A	0	2	2	0	2	4	0	0
6	7660119	.	A	G	14	9	23	0	0	23	0	0
6	7660300	.	T	C	2	0	2	0	3	5	0	0
6	7660369	.	T	C	3	5	8	0	0	8	0	0
6	7660458	.	A	C	4	0	4	0	5	9	0	0
6	7660594	.	C	T	4	3	7	0	0	7	0	0
6	7660659	.	C	A	0	5	5	0	3	8	0	0
6	7660707	.	C	T	0	5	5	0	3	8	0	0
6	7679455	.	G	A	1	2	3	0	0	3	0	0
6	7682793	.	C	A	0	4	4	0	5	9	0	0
6	7686080	.	G	A	4	6	10	0	0	10	0	0
6	7688757	.	A	C	2	0	2	0	4	6	0	0
6	7697573	.	G	A	4	6	10	0	1	11	0	0
6	7699948	.	C	T	9	5	14	1	1	16	0	0
6	7702770	.	G	T	8	3	11	0	0	11	0	0
6	7705984	.	G	A	5	3	8	0	1	9	0	0
6	7711239	.	G	A	7	3	10	0	0	10	0	0
6	7713433	.	G	A	24	22	46	0	3	49	0	0
6	7721530	.	T	A	8	5	13	0	0	13	0	0
6	7721860	.	G	A	4	5	9	0	0	9	0	0
6	7721906	.	G	A	11	15	26	0	1	27	0	0
6	7721958	.	C	A	11	20	31	1	1	33	0	0
6	7722143	.	G	T	13	15	28	0	0	28	0	0
6	7722159	.	A	T	16	15	31	0	2	33	0	0
6	7722195	.	G	T	13	10	23	0	3	26	0	0
6	7722205	.	G	A	8	11	19	0	1	20	0	0
6	7722333	.	G	A	15	10	25	0	4	29	0	0
6	7722387	.	T	C	14	14	28	3	1	32	0	0
6	7722402	.	T	C	8	11	19	3	2	24	0	0
6	7722577	.	C	T	0	10	10	0	17	27	0	0
6	7722626	.	T	C	26	4	30	0	0	30	0	0
6	7722634	.	T	C	22	4	26	0	0	26	0	0
6	7722921	.	A	T	4	2	6	0	0	6	0	0
6	7723008	.	G	T	16	7	23	0	0	23	0	0
6	7723155	.	A	C	11	6	17	0	0	17	0	0
6	7723232	.	A	T	10	7	17	0	0	17	0	0
6	7723850	.	C	T	1	7	8	1	9	18	0	0
6	7723961	.	G	A	12	13	25	0	3	28	0	0
6	7726824	.	G	A	10	16	26	0	0	26	0	0
6	7734250	.	A	C	5	5	10	0	0	10	0	0
6	7734271	.	C	A	5	4	9	0	1	10	0	0
6	7795698	.	C	T	19	8	27	1	9	37	0	0
6	7842013	.	C	T	1	14	15	0	15	30	0	0
6	7842034	.	C	A	16	17	33	0	2	35	0	0
6	8176101	.	A	G	6	11	17	0	0	17	0	0
6	8176575	.	C	T	16	6	22	0	0	22	0	0
6	8177030	.	T	C	13	14	27	0	0	27	0	0
6	8177399	.	T	C	14	10	24	0	1	25	0	0
6	8177600	.	T	C	13	10	23	0	0	23	0	0
6	8177678	.	C	T	10	8	18	0	1	19	0	0
6	8178002	.	T	C	14	12	26	0	1	27	0	0
6	8178053	.	G	A	1	11	12	0	12	24	0	0
6	8178113	.	T	C	20	8	28	0	0	28	0	0
6	8178351	.	G	A	13	8	21	0	0	21	0	0
6	8179022	.	G	T	1	17	18	0	16	35	1	0
6	8179205	.	A	T	12	16	28	0	1	29	0	0
6	8179373	.	G	A	21	10	31	0	0	31	0	0
6	8179683	.	A	T	4	4	8	0	0	8	0	0
6	8210902	.	C	G	1	2	3	0	0	3	0	0
6	8211075	.	C	T	3	3	6	0	0	6	0	0
6	8211143	.	A	T	3	4	7	0	0	7	0	0
6	8211154	.	T	C	4	2	6	0	0	6	0	0
6	8211253	.	G	A	5	5	10	0	0	10	0	0
6	8212174	.	G	A	2	5	7	0	0	7	0	0
6	8214044	.	G	A	1	5	6	0	0	6	0	0
6	8214045	.	T	G	1	5	6	0	0	6	0	0
6	8217870	.	G	A	3	5	8	0	1	9	0	0
6	8225270	.	T	C	1	2	3	0	0	3	0	0
6	8225275	.	C	T	1	2	3	0	0	3	0	0
6	8232314	.	C	G	1	2	3	0	0	3	0	0
6	8265282	.	G	A	3	11	14	0	0	14	0	0
6	8267111	.	C	T	21	14	35	0	0	35	0	0
6	8267266	.	A	G	14	20	34	0	1	35	0	0
6	8267284	.	G	A	11	24	35	0	0	35	0	0
6	8267307	.	G	C	10	14	24	0	0	25	1	0
6	8267352	.	A	T	19	17	36	0	0	36	0	0
6	8267519	.	G	A	15	25	40	0	2	42	0	0
6	8267563	.	G	T	20	22	42	0	3	45	0	0
6	8267635	.	T	C	20	26	46	0	0	47	1	0
6	8267795	.	T	A	15	9	24	0	0	24	0	0
6	8267880	.	G	A	8	14	22	0	1	23	0	0
6	8268529	.	A	G	19	17	36	0	0	36	0	0
6	8273066	.	G	A	7	14	21	0	1	22	0	0
6	8277141	.	C	A	10	10	20	0	0	20	0	0
6	8282275	.	A	G	8	14	22	0	1	23	0	0
6	8283360	.	A	G	9	5	14	0	0	14	0	0
6	8283393	.	T	C	6	0	6	0	6	12	0	0
6	8289112	.	G	A	10	9	19	0	0	19	0	0
6	8291577	.	T	G	6	6	12	0	0	12	0	0
6	8291791	.	A	G	5	4	9	0	1	10	0	0
6	8310840	.	C	T	4	5	9	0	0	9	0	0
6	8315076	.	A	G	12	21	33	0	2	35	0	0
6	8315078	.	A	G	13	21	34	0	2	36	0	0
6	8316947	.	A	G	6	14	20	0	1	21	0	0
6	8318001	.	T	C	9	10	19	0	0	19	0	0
6	8318037	.	G	A	1	8	9	0	14	23	0	0
6	8328181	.	G	T	11	10	21	0	0	21	0	0
6	8366006	.	A	T	9	7	16	0	0	16	0	0
6	8366167	.	C	T	22	8	30	1	0	31	0	0
6	8370489	.	T	C	15	9	24	0	3	27	0	0
6	8374716	.	G	A	6	5	11	0	0	11	0	0
6	8375089	.	C	T	16	13	29	0	0	29	0	0
6	8380345	.	G	A	7	5	12	0	1	13	0	0
6	8380433	.	G	C	12	6	18	0	0	18	0	0
6	8380485	.	G	T	5	5	10	0	0	10	0	0
6	8391629	.	C	T	1	4	5	0	16	21	0	0
6	8392005	.	G	A	12	12	24	0	1	25	0	0
6	8455483	.	T	C	3	1	4	0	3	7	0	0
6	8460400	.	A	T	2	4	6	0	0	6	0	0
6	8460435	.	G	T	3	6	9	0	0	9	0	0
6	8460493	.	G	T	2	3	5	0	0	5	0	0
6	8460603	.	T	G	5	4	9	0	0	9	0	0
6	8460622	.	T	C	2	0	2	0	5	7	0	0
6	8460793	.	T	C	5	3	8	0	0	8	0	0
6	8460808	.	A	T	3	5	8	0	0	8	0	0
6	8465662	.	A	G	3	5	8	0	1	9	0	0
6	8501017	.	A	G	4	2	6	0	0	6	0	0
6	8516687	.	T	C	1	3	4	0	1	5	0	0
6	8518776	.	C	G	1	3	4	0	0	4	0	0
6	8518808	.	G	A	2	2	4	0	0	4	0	0
6	8518860	.	C	T	1	3	4	0	0	4	0	0
6	9130482	.	A	G	8	3	11	0	0	11	0	0
6	9130517	.	A	G	7	5	12	0	0	12	0	0
6	9130521	.	A	G	6	6	12	0	0	12	0	0
6	9856434	.	A	G	1	0	1	0	6	7	0	0
6	9997661	.	G	C	2	2	4	0	23	27	0	0
6	9997665	.	A	C	4	1	5	0	21	26	0	0
6	10740162	.	G	A	1	3	4	0	0	4	0	0
6	10741853	.	T	G	2	5	7	0	0	7	0	0
6	10982877	.	C	T	1	2	3	0	0	3	0	0
6	10983029	.	A	C	1	7	8	0	0	8	0	0
6	10983066	.	T	C	2	5	7	0	1	8	0	0
6	10983193	.	T	A	1	3	4	0	0	4	0	0
6	10983203	.	C	T	1	3	4	0	0	4	0	0
6	10983409	.	A	T	2	4	6	0	0	6	0	0
6	10983465	.	A	T	5	2	7	0	0	7	0	0
6	10985878	.	C	T	7	14	21	0	1	22	0	0
6	10986131	.	C	T	1	11	12	0	13	25	0	0
6	10986652	.	A	G	12	10	22	0	0	22	0	0
6	11070411	.	G	C	17	7	24	0	1	25	0	0
6	11070563	.	A	C	33	22	55	1	2	58	0	0
6	11070806	.	G	A	29	28	57	0	4	61	0	0
6	11071056	.	T	A	23	25	48	0	2	50	0	0
6	11071222	.	A	G	23	27	50	1	3	54	0	0
6	11071345	.	G	A	25	31	56	1	0	57	0	0
6	11071357	.	A	G	21	34	55	0	2	57	0	0
6	11101852	.	G	A	12	8	20	0	0	20	0	0
6	11107326	.	T	C	5	0	5	0	7	12	0	0
6	11113028	.	C	T	3	6	9	0	0	9	0	0
6	11120420	.	G	A	4	2	6	0	0	6	0	0
6	11122682	.	T	C	3	0	3	0	3	6	0	0
6	11122754	.	G	A	4	4	8	0	0	8	0	0
6	11129033	.	G	A	6	3	9	0	0	9	0	0
6	11129105	.	C	T	3	5	8	0	0	8	0	0
6	11129282	.	C	T	0	2	2	0	6	8	0	0
6	11129447	.	A	T	3	2	5	0	0	5	0	0
6	11250077	.	G	T	15	16	31	0	2	33	0	0
6	11250309	.	A	C	2	3	5	0	0	5	0	0
6	11250973	.	T	C	12	5	17	0	1	18	0	0
6	11253396	.	T	C	10	8	18	0	1	19	0	0
6	11253417	.	T	C	7	10	17	0	1	18	0	0
6	11253432	.	A	G	5	8	13	0	1	14	0	0
6	11253881	.	T	C	10	8	18	0	1	19	0	0
6	11253890	.	C	T	12	10	22	0	0	22	0	0
6	11253989	.	C	T	13	13	26	0	2	28	0	0
6	11254196	.	C	T	12	12	24	0	0	24	0	0
6	11254358	.	A	G	11	0	11	0	14	25	0	0
6	11254430	.	C	T	10	11	21	0	0	21	0	0
6	11254610	.	C	T	18	6	24	0	1	25	0	0
6	11257788	.	C	T	20	21	41	0	0	41	0	0
6	11261308	.	C	A	23	18	41	0	1	44	2	0
6	11262080	.	C	T	17	20	37	0	1	38	0	0
6	11264258	.	G	A	17	17	34	0	1	35	0	0
6	11265321	.	G	T	17	16	33	0	0	33	0	0
6	11265424	.	T	C	11	23	34	0	0	34	0	0
6	11265505	.	A	T	10	22	32	0	0	32	0	0
6	11265562	.	T	A	13	20	33	0	1	34	0	0
6	11265761	.	A	T	21	19	40	0	0	40	0	0
6	11265833	.	A	G	22	0	22	0	20	42	0	0
6	11266104	.	A	G	5	25	30	0	0	30	0	0
6	11266111	.	A	G	17	0	17	0	14	31	0	0
6	11266164	.	T	C	21	18	39	0	1	40	0	0
6	11266176	.	C	T	18	17	35	0	0	35	0	0
6	11266360	.	T	G	12	16	28	0	0	28	0	0
6	11266490	.	A	T	6	3	9	0	0	9	0	0
6	11266496	.	T	C	5	2	7	0	0	7	0	0
6	11276827	.	T	A	3	2	5	0	0	5	0	0
6	11276912	.	A	G	6	6	12	0	0	12	0	0
6	11279686	.	T	C	3	6	9	0	2	11	0	0
6	11279815	.	T	C	3	3	6	0	0	6	0	0
6	11281923	.	A	G	5	4	9	0	0	9	0	0
6	11281973	.	G	A	3	3	6	0	0	6	0	0
6	11282272	.	G	C	3	0	3	0	3	6	0	0
6	11282709	.	G	A	1	4	5	0	0	5	0	0
6	11282741	.	C	T	2	4	6	0	1	7	0	0
6	11285310	.	C	T	5	5	10	0	1	11	0	0
6	11285362	.	T	C	9	0	9	0	9	18	0	0
6	11285374	.	C	T	11	9	20	0	0	20	0	0
6	11285453	.	T	C	8	6	14	0	1	15	0	0
6	11285459	.	C	G	8	6	14	0	0	14	0	0
6	11285583	.	C	T	10	6	16	0	0	16	0	0
6	11285772	.	C	T	8	4	12	0	1	13	0	0
6	11285835	.	G	A	2	8	10	0	0	10	0	0
6	11288179	.	T	A	5	4	9	0	1	10	0	0
6	11288265	.	T	G	4	5	9	0	0	9	0	0
6	11292023	.	A	G	5	2	7	0	0	7	0	0
6	11292087	.	G	T	2	4	6	0	0	6	0	0
6	11295352	.	C	T	0	3	3	0	1	4	0	0
6	11295408	.	T	G	3	2	5	0	0	5	0	0
6	11295435	.	G	T	3	4	7	0	0	7	0	0
6	11295553	.	A	G	8	5	13	0	0	13	0	0
6	11298557	.	G	A	3	4	7	0	0	7	0	0
6	11299643	.	C	T	2	5	7	0	0	7	0	0
6	11299680	.	A	T	3	2	5	0	1	6	0	0
6	11299682	.	C	T	3	1	4	0	2	6	0	0
6	11299883	.	A	G	4	2	6	0	1	7	0	0
6	11299909	.	C	T	4	2	6	0	0	6	0	0
6	11299961	.	C	A	4	4	8	0	0	8	0	0
6	11299963	.	C	T	3	4	7	0	0	7	0	0
6	11303035	.	A	G	3	3	6	0	0	6	0	0
6	11303050	.	T	C	2	6	8	0	0	8	0	0
6	11303338	.	C	T	4	2	6	0	0	6	0	0
6	11303424	.	T	G	4	6	10	0	0	10	0	0
6	11309502	.	C	T	0	3	3	0	4	7	0	0
6	11309571	.	C	T	2	4	6	0	0	6	0	0
6	11309604	.	G	A	3	3	6	0	0	6	0	0
6	11316705	.	T	C	1	2	3	0	0	3	0	0
6	11316726	.	G	A	2	3	5	0	0	5	0	0
6	11320584	.	C	T	0	3	3	0	2	5	0	0
6	11327083	.	G	A	2	3	5	0	0	5	0	0
6	11330630	.	G	T	2	2	4	0	0	4	0	0
6	11330918	.	T	A	2	4	6	0	0	6	0	0
6	11330927	.	C	T	2	4	6	0	0	6	0	0
6	11331569	.	A	G	0	2	2	0	1	3	0	0
6	11331572	.	T	C	1	2	3	0	0	3	0	0
6	11331671	.	C	T	4	2	6	0	0	6	0	0
6	11331736	.	A	T	5	3	8	0	0	8	0	0
6	11334929	.	G	A	2	3	5	0	0	5	0	0
6	11337568	.	C	T	1	2	3	0	1	4	0	0
6	11337576	.	T	G	2	2	4	0	0	4	0	0
6	11340037	.	T	C	1	3	4	0	0	4	0	0
6	11349895	.	C	A	3	2	5	0	0	5	0	0
6	11362831	.	A	G	2	3	5	0	0	5	0	0
6	11398324	.	G	T	5	8	13	0	0	13	0	0
6	11407918	.	G	A	5	13	18	0	0	18	0	0
6	11407944	.	A	G	8	12	20	0	2	22	0	0
6	11407954	.	A	G	10	16	26	0	0	26	0	0
6	11414431	.	A	G	14	0	14	0	10	24	0	0
6	11414448	.	T	C	18	11	29	0	2	31	0	0
6	11414748	.	G	A	7	3	10	0	0	10	0	0
6	11414822	.	T	G	7	1	8	0	8	16	0	0
6	11415089	.	G	A	4	2	6	0	1	7	0	0
6	11415104	.	C	T	6	3	9	0	3	12	0	0
6	11486714	.	C	T	2	2	4	0	0	4	0	0
6	11507994	.	A	G	2	5	7	0	0	7	0	0
6	11508125	.	T	C	4	7	11	0	2	13	0	0
6	11522921	.	C	T	4	3	7	0	0	7	0	0
6	11765506	.	A	G	27	27	54	0	1	55	0	0
6	11766190	.	T	A	17	22	39	0	3	42	0	0
6	11766267	.	G	A	22	22	44	0	1	45	0	0
6	11766276	.	A	G	24	23	47	0	2	49	0	0
6	11766765	.	T	C	27	24	51	0	0	51	0	0
6	11978886	.	T	G	4	4	8	0	0	8	0	0
6	12503989	.	T	G	5	6	11	0	0	11	0	0
6	12504230	.	T	C	5	5	10	0	3	13	0	0
6	12504362	.	C	T	4	7	11	0	2	13	0	0
6	12504392	.	G	C	6	5	11	1	0	12	0	0
6	12529163	.	C	T	9	14	23	0	1	24	0	0
6	12529247	.	C	T	11	9	20	0	1	21	0	0
6	12550437	.	G	A	17	10	27	0	2	29	0	0
6	12550674	.	C	G	1	1	2	0	12	14	0	0
6	12550764	.	G	A	12	7	19	0	2	21	0	0
6	12550934	.	C	T	14	14	28	0	2	30	0	0
6	12627321	.	T	A	2	7	9	0	0	9	0	0
6	12629345	.	T	C	7	3	10	0	0	10	0	0
6	12633166	.	C	T	0	4	4	0	3	7	0	0
6	12670979	.	C	T	0	2	2	0	2	4	0	0
6	12671341	.	T	C	1	3	4	0	0	4	0	0
6	12671681	.	A	G	2	3	5	0	0	5	0	0
6	12675992	.	G	A	3	2	5	0	0	5	0	0
6	12678651	.	A	G	2	3	5	0	0	5	0	0
6	12680601	.	C	T	0	3	3	0	1	4	0	0
6	12680604	.	A	G	2	3	5	0	0	5	0	0
6	12681048	.	G	A	2	2	4	0	1	5	0	0
6	12682563	.	T	G	5	2	7	0	0	7	0	0
6	12684618	.	A	T	2	2	4	0	0	4	0	0
6	12684627	.	T	C	4	2	6	0	0	6	0	0
6	12701412	.	G	A	2	2	4	0	0	4	0	0
6	12701453	.	G	A	2	4	6	0	0	6	0	0
6	12797677	.	C	T	10	5	15	0	0	15	0	0
6	12797755	.	G	A	16	10	26	0	0	26	0	0
6	12797815	.	A	G	23	11	34	0	3	37	0	0
6	12798083	.	G	T	5	11	16	0	0	16	0	0
6	12798124	.	T	C	4	5	9	0	0	9	0	0
6	12803257	.	C	A	14	9	23	0	0	23	0	0
6	12803325	.	A	G	5	4	9	0	0	9	0	0
6	12803568	.	A	G	12	9	21	0	1	22	0	0
6	12803598	.	T	C	12	11	23	0	1	24	0	0
6	12803664	.	G	A	10	11	21	0	0	21	0	0
6	12803790	.	A	G	9	11	20	0	0	20	0	0
6	12803919	.	C	G	10	4	14	0	1	15	0	0
6	12804024	.	A	T	16	11	27	0	0	27	0	0
6	12804132	.	G	A	12	12	24	0	2	26	0	0
6	12810249	.	C	G	2	14	16	0	8	24	0	0
6	13506931	.	G	C	4	5	9	0	0	9	0	0
6	13507066	.	A	T	2	2	4	0	0	4	0	0
6	13509296	.	C	T	2	6	8	0	1	9	0	0
6	13510493	.	G	A	2	6	8	0	0	8	0	0
6	13510565	.	T	C	5	5	10	0	0	10	0	0
6	13513936	.	C	T	4	3	7	0	0	7	0	0
6	13513962	.	A	G	2	5	7	0	1	8	0	0
6	13668970	.	T	C	2	4	6	0	0	6	0	0
6	13677198	.	A	G	5	0	5	0	4	9	0	0
6	13699951	.	C	T	0	3	3	0	3	6	0	0
6	13700485	.	G	A	5	3	8	0	0	8	0	0
6	13700554	.	T	C	2	0	2	0	2	4	0	0
6	13730697	.	G	A	6	4	10	0	0	10	0	0
6	13734266	.	G	A	3	3	6	0	0	6	0	0
6	13734439	.	C	T	3	6	9	0	0	9	0	0
6	13734449	.	C	T	2	3	5	0	1	6	0	0
6	13734474	.	C	T	4	2	6	0	0	6	0	0
6	13743317	.	G	A	21	31	52	0	2	54	0	0
6	13743753	.	T	C	32	30	62	0	1	63	0	0
6	13743923	.	C	T	30	37	67	0	1	68	0	0
6	13744099	.	C	T	39	29	68	0	2	70	0	0
6	13806522	.	C	T	10	14	24	0	0	24	0	0
6	13862171	.	C	T	8	13	21	0	2	23	0	0
6	13862576	.	A	C	22	22	44	0	0	44	0	0
6	13866551	.	G	A	23	17	40	0	1	41	0	0
6	13868823	.	A	G	24	20	44	0	2	46	0	0
6	13868850	.	A	T	22	15	37	0	5	45	3	0
6	13869343	.	A	C	6	6	12	2	4	18	0	0
6	13869540	.	C	A	17	10	27	0	2	29	0	0
6	13869608	.	C	T	22	16	38	0	1	39	0	0
6	13871941	.	T	G	3	2	5	0	0	5	0	0
6	13897552	.	G	A	7	6	13	0	0	13	0	0
6	13901255	.	A	T	6	4	10	0	4	14	0	0
6	13901312	.	C	T	7	7	14	0	0	14	0	0
6	13903413	.	T	C	1	5	6	0	1	7	0	0
6	13907856	.	T	A	5	7	12	0	0	12	0	0
6	13908633	.	G	A	0	12	12	0	9	21	0	0
6	13914821	.	T	C	8	4	12	0	0	12	0	0
6	13914824	.	G	A	8	4	12	0	0	12	0	0
6	13920194	.	A	G	6	2	8	0	0	8	0	0
6	13920549	.	C	T	10	6	16	2	0	18	0	0
6	13941729	.	C	A	19	23	42	0	2	44	0	0
6	13967038	.	A	T	22	14	36	0	1	37	0	0
6	13967328	.	G	A	17	18	35	0	1	36	0	0
6	13967512	.	C	A	17	22	39	0	6	51	6	0
6	13977080	.	T	A	25	18	43	0	4	47	0	0
6	13977567	.	G	T	25	28	53	0	1	55	1	0
6	13977588	.	C	T	26	25	51	0	1	52	0	0
6	13977648	.	G	A	23	22	45	0	0	45	0	0
6	13987287	.	G	C	25	9	34	0	1	35	0	0
6	13987299	.	A	T	24	22	46	1	2	49	0	0
6	13987346	.	C	T	20	20	40	1	3	44	0	0
6	13987560	.	T	C	20	22	42	0	2	44	0	0
6	13987631	.	G	A	27	28	55	0	1	56	0	0
6	13987663	.	T	A	18	23	41	0	4	45	0	0
6	13987710	.	G	A	17	12	29	0	1	30	0	0
6	13987713	.	T	G	16	12	28	0	0	28	0	0
6	13993783	.	A	T	7	2	9	0	0	9	0	0
6	14032693	.	T	C	27	12	39	0	0	39	0	0
6	14032698	.	T	A	26	8	34	0	3	37	0	0
6	14032739	.	G	A	19	8	27	0	0	27	0	0
6	14033030	.	G	T	14	7	21	0	0	21	0	0
6	14033167	.	G	A	27	16	43	0	1	44	0	0
6	14033556	.	T	A	18	9	27	0	1	28	0	0
6	14033836	.	G	C	8	11	19	0	0	19	0	0
6	14034887	.	G	C	11	17	28	0	1	29	0	0
6	14034907	.	C	T	0	19	19	0	13	32	0	0
6	14034949	.	G	A	11	12	23	1	0	24	0	0
6	14038306	.	C	T	18	7	25	0	0	25	0	0
6	14038506	.	T	A	10	8	18	0	2	20	0	0
6	14086810	.	T	C	28	27	55	0	1	56	0	0
6	14086901	.	G	T	28	25	53	0	0	53	0	0
6	14086942	.	G	C	32	14	46	0	2	48	0	0
6	14087182	.	C	A	29	19	48	0	1	49	0	0
6	14087220	.	T	A	20	24	44	0	2	46	0	0
6	14087569	.	T	G	22	29	51	0	1	52	0	0
6	14087641	.	A	C	26	26	52	0	4	56	0	0
6	14087883	.	T	C	18	18	36	0	0	36	0	0
6	14088095	.	C	T	25	28	53	0	4	57	0	0
6	14092942	.	T	A	20	27	47	0	3	51	1	0
6	14096684	.	C	T	2	26	28	0	25	53	0	0
6	14098760	.	C	T	8	22	30	0	30	60	0	0
6	14105071	.	G	T	24	26	50	0	1	51	0	0
6	14172926	.	A	T	6	5	11	0	0	11	0	0
6	14173159	.	C	A	6	8	14	0	3	17	0	0
6	14173599	.	A	G	4	8	12	0	2	14	0	0
6	14173641	.	G	A	6	14	20	0	0	20	0	0
6	14191637	.	A	G	9	11	20	0	0	20	0	0
6	14191676	.	G	A	8	7	15	0	1	16	0	0
6	14191709	.	T	C	7	1	8	0	10	18	0	0
6	14209151	.	C	T	8	17	25	0	1	26	0	0
6	14209674	.	A	G	6	10	16	0	0	16	0	0
6	14209764	.	A	G	9	7	16	0	0	16	0	0
6	14212352	.	G	A	6	11	17	0	1	18	0	0
6	14212370	.	G	A	5	13	18	0	0	18	0	0
6	14212430	.	T	G	4	7	11	0	0	11	0	0
6	14220145	.	G	T	10	12	22	0	1	23	0	0
6	14240226	.	C	T	6	5	11	0	0	11	0	0
6	15235659	.	T	C	5	2	7	0	0	7	0	0
6	15491538	.	T	C	4	4	8	0	0	8	0	0
6	15491568	.	A	G	3	5	8	0	0	8	0	0
6	15527385	.	G	A	12	12	24	0	0	24	0	0
6	15538138	.	G	A	15	19	34	0	1	35	0	0
6	15541015	.	G	A	8	15	23	0	0	23	0	0
6	15543412	.	C	A	9	10	19	0	1	20	0	0
6	15543451	.	C	T	14	7	21	0	0	21	0	0
6	15548966	.	A	G	12	16	28	0	1	29	0	0
6	15557526	.	T	G	7	5	12	0	0	12	0	0
6	15603784	.	G	A	8	11	19	0	0	19	0	0
6	15603866	.	T	C	9	6	15	0	2	17	0	0
6	15604016	.	G	A	9	4	13	0	0	13	0	0
6	15604079	.	A	G	8	10	18	0	0	18	0	0
6	15604133	.	C	T	7	9	16	0	0	16	0	0
6	15604142	.	A	G	7	6	13	0	0	13	0	0
6	15752417	.	A	C	5	6	11	0	0	11	0	0
6	15752602	.	A	G	2	4	6	0	0	6	0	0
6	15752641	.	C	T	2	3	5	0	0	5	0	0
6	15752681	.	A	C	2	4	6	0	0	6	0	0
6	15753199	.	G	A	3	3	6	0	0	6	0	0
6	15753325	.	A	G	4	2	6	0	0	6	0	0
6	15753355	.	T	G	3	3	6	0	0	6	0	0
6	15753785	.	C	T	0	2	2	0	3	5	0	0
6	15757754	.	T	G	2	2	4	0	0	4	0	0
6	15757769	.	A	G	2	3	5	0	0	5	0	0
6	15757840	.	G	A	4	2	6	0	0	6	0	0
6	15757848	.	C	G	3	2	5	0	0	5	0	0
6	15780982	.	A	G	1	2	3	0	0	3	0	0
6	15798145	.	A	G	4	1	5	0	1	6	0	0
6	16031524	.	T	C	1	2	3	0	0	3	0	0
6	16031714	.	C	T	6	5	11	0	0	11	0	0
6	16043950	.	C	T	3	16	19	0	8	27	0	0
6	16043980	.	A	G	11	14	25	0	0	25	0	0
6	16043999	.	T	C	14	15	29	0	0	29	0	0
6	16044019	.	T	C	12	0	12	0	17	29	0	0
6	16044282	.	A	G	10	14	24	0	2	26	0	0
6	16044597	.	C	T	12	8	20	0	1	21	0	0
6	16045046	.	G	C	7	5	12	0	2	14	0	0
6	16045413	.	T	C	10	11	21	0	1	22	0	0
6	16045463	.	G	C	8	1	9	0	15	24	0	0
6	16045516	.	G	C	11	16	27	0	1	28	0	0
6	16045712	.	C	T	10	11	21	0	1	22	0	0
6	16045768	.	C	G	8	11	19	0	1	20	0	0
6	16045798	.	T	C	16	4	20	0	1	21	0	0
6	16045946	.	A	C	14	11	25	0	1	26	0	0
6	16045947	.	A	T	15	11	26	0	1	27	0	0
6	16046049	.	G	T	21	9	30	0	1	32	1	0
6	16046115	.	T	C	10	15	25	0	1	26	0	0
6	16046272	.	G	T	5	10	15	0	0	15	0	0
6	16046365	.	G	A	4	3	7	0	3	10	0	0
6	16046371	.	A	T	7	1	8	0	1	9	0	0
6	16046452	.	T	C	6	7	13	0	0	13	0	0
6	16046676	.	G	A	12	8	20	0	0	20	0	0
6	16046761	.	A	C	10	6	16	0	0	16	0	0
6	16046850	.	G	A	20	6	26	0	1	27	0	0
6	16046934	.	A	C	16	15	31	1	2	34	0	0
6	16104448	.	G	T	7	16	23	0	3	26	0	0
6	16104463	.	T	C	9	14	23	0	2	25	0	0
6	16135966	.	C	T	9	14	23	1	0	24	0	0
6	16162994	.	G	A	9	6	15	0	1	16	0	0
6	16169641	.	G	A	11	12	23	0	0	23	0	0
6	16194568	.	G	A	13	10	23	0	0	23	0	0
6	16214658	.	C	T	1	11	12	0	11	23	0	0
6	16393459	.	G	T	6	8	14	0	0	14	0	0
6	16393816	.	G	C	2	7	9	0	0	9	0	0
6	16393890	.	C	G	4	2	6	0	1	7	0	0
6	16394004	.	G	A	5	6	11	0	0	11	0	0
6	16394018	.	C	T	4	5	9	0	0	9	0	0
6	16394244	.	A	G	9	5	14	0	0	14	0	0
6	16394341	.	A	T	4	5	9	0	0	9	0	0
6	16446760	.	G	A	1	2	3	0	0	3	0	0
6	16473889	.	C	G	6	0	6	0	9	15	0	0
6	16474107	.	G	A	6	4	10	0	1	11	0	0
6	16474381	.	T	C	13	9	22	0	0	22	0	0
6	16474853	.	T	C	7	3	10	0	0	10	0	0
6	16474879	.	T	C	8	3	11	0	0	11	0	0
6	16474948	.	T	C	5	8	13	0	1	14	0	0
6	16475047	.	T	A	6	9	15	0	0	15	0	0
6	16475269	.	C	G	12	5	17	0	0	17	0	0
6	16475395	.	A	C	6	3	9	0	1	10	0	0
6	16475611	.	A	C	1	4	5	2	1	8	0	0
6	16475728	.	G	A	1	9	10	0	4	14	0	0
6	16478198	.	C	A	0	5	5	0	11	16	0	0
6	16491056	.	G	A	18	14	32	0	1	33	0	0
6	16493381	.	A	T	30	14	44	0	0	44	0	0
6	16493415	.	T	C	16	22	38	0	1	39	0	0
6	16499260	.	A	G	6	6	12	0	2	14	0	0
6	16499311	.	C	T	4	9	13	0	1	14	0	0
6	16499428	.	G	A	9	8	17	0	0	17	0	0
6	16499473	.	G	C	13	8	21	0	0	21	0	0
6	16509980	.	G	A	14	15	29	0	1	30	0	0
6	16510064	.	T	G	8	7	15	0	3	18	0	0
6	16523788	.	G	A	7	7	14	0	0	14	0	0
6	16524067	.	A	G	19	6	25	0	2	27	0	0
6	16524468	.	G	T	5	15	20	0	0	20	0	0
6	16524618	.	C	G	9	7	16	0	0	16	0	0
6	16540645	.	G	A	6	5	11	0	0	11	0	0
6	16540646	.	G	C	6	1	7	0	4	11	0	0
6	16548741	.	T	C	2	5	7	0	0	7	0	0
6	16548873	.	C	T	2	8	10	0	1	11	0	0
6	16551826	.	G	A	5	5	10	0	0	10	0	0
6	16558508	.	A	T	2	10	12	0	0	12	0	0
6	16558556	.	T	G	3	6	9	0	0	9	0	0
6	16558568	.	G	A	5	3	8	0	0	8	0	0
6	16561379	.	C	T	8	3	11	0	1	12	0	0
6	16565258	.	T	C	3	0	3	0	4	7	0	0
6	16571935	.	G	A	7	3	10	0	1	11	0	0
6	16571947	.	G	T	9	3	12	0	1	13	0	0
6	16572007	.	C	T	6	2	8	0	0	8	0	0
6	16574765	.	G	C	6	5	11	0	0	11	0	0
6	16574794	.	T	A	4	4	8	0	0	8	0	0
6	16577229	.	C	T	0	7	7	0	5	12	0	0
6	16577736	.	G	A	5	4	9	0	0	9	0	0
6	16589347	.	C	T	4	7	11	0	1	12	0	0
6	16589452	.	T	G	5	3	8	0	0	8	0	0
6	16589455	.	T	C	3	5	8	0	0	8	0	0
6	16599048	.	A	G	4	4	8	0	0	8	0	0
6	16656833	.	C	T	5	3	8	0	1	9	0	0
6	16661736	.	T	A	6	4	10	0	0	10	0	0
6	16664776	.	C	T	3	2	5	0	1	6	0	0
6	16664780	.	G	A	3	3	6	0	0	6	0	0
6	16664830	.	G	A	6	2	8	0	0	8	0	0
6	16665359	.	G	A	2	5	7	0	0	7	0	0
6	16674296	.	A	G	10	9	19	0	0	19	0	0
6	16674344	.	T	A	15	9	24	0	1	25	0	0
6	16674371	.	T	C	5	6	11	0	8	19	0	0
6	16674435	.	A	C	9	13	22	0	1	23	0	0
6	16674618	.	G	A	12	10	22	0	1	23	0	0
6	16674808	.	T	C	10	15	25	0	0	25	0	0
6	16683385	.	T	C	12	15	27	0	3	30	0	0
6	16684004	.	A	G	8	10	18	0	0	18	0	0
6	16687429	.	C	A	16	14	30	0	2	32	0	0
6	16687432	.	T	A	17	15	32	0	0	32	0	0
6	16688900	.	T	C	6	6	12	0	3	15	0	0
6	16689083	.	G	A	11	8	19	0	0	19	0	0
6	16689416	.	T	A	8	8	16	0	0	16	0	0
6	16695771	.	C	T	8	7	15	0	0	15	0	0
6	16695994	.	A	C	7	7	14	0	2	16	0	0
6	16696083	.	C	T	10	7	17	0	2	19	0	0
6	16699616	.	G	A	5	7	12	0	0	12	0	0
6	16704848	.	T	C	4	7	11	0	0	11	0	0
6	16704876	.	G	A	5	5	10	0	1	11	0	0
6	16714138	.	A	T	5	4	9	0	0	9	0	0
6	16714175	.	G	T	3	2	5	0	1	6	0	0
6	16714192	.	C	T	3	3	6	0	0	6	0	0
6	16714219	.	G	A	2	3	5	0	0	5	0	0
6	16714231	.	G	C	2	4	6	0	0	6	0	0
6	16714407	.	A	G	5	7	12	0	0	12	0	0
6	16714419	.	A	G	5	8	13	0	0	13	0	0
6	16714599	.	T	A	2	5	7	0	0	7	0	0
6	17837240	.	A	T	4	2	6	0	0	6	0	0
6	17910266	.	C	T	4	3	7	0	0	7	0	0
6	17911148	.	C	T	1	6	7	0	4	11	0	0
6	17929118	.	C	T	2	5	7	0	0	7	0	0
6	17939679	.	T	C	2	3	5	0	0	5	0	0
6	18077210	.	G	A	8	8	16	0	0	16	0	0
6	18203782	.	C	A	19	16	35	0	0	35	0	0
6	18204420	.	A	G	10	9	19	0	1	20	0	0
6	18220141	.	G	A	8	6	14	0	1	15	0	0
6	18226653	.	T	G	16	13	29	0	0	29	0	0
6	18228324	.	G	A	13	9	22	0	0	22	0	0
6	18244987	.	C	T	1	3	4	0	1	5	0	0
6	18245385	.	G	A	18	17	35	0	2	37	0	0
6	18251271	.	A	G	2	4	6	0	0	6	0	0
6	18251299	.	T	C	1	3	4	0	0	4	0	0
6	18270731	.	G	A	2	2	4	0	0	4	0	0
6	18346465	.	T	A	1	2	3	0	0	3	0	0
6	18359376	.	C	T	11	8	19	0	0	19	0	0
6	18361359	.	A	T	11	13	24	0	2	26	0	0
6	18361444	.	C	G	14	11	25	0	2	27	0	0
6	18361609	.	T	C	7	11	18	0	1	19	0	0
6	18361729	.	G	C	10	9	19	0	1	20	0	0
6	18362043	.	T	G	4	0	4	0	6	10	0	0
6	18364051	.	A	T	1	3	4	0	0	4	0	0
6	18364543	.	A	T	4	5	9	0	1	10	0	0
6	18367543	.	T	C	4	6	10	0	1	11	0	0
6	18367758	.	C	T	4	4	8	0	0	8	0	0
6	18388387	.	T	G	5	4	9	0	0	9	0	0
6	18388569	.	C	T	6	7	13	0	0	13	0	0
6	18388835	.	C	A	4	6	10	0	0	10	0	0
6	18388975	.	G	A	11	6	17	0	0	17	0	0
6	18389220	.	G	A	5	5	10	0	0	10	0	0
6	18389324	.	T	C	6	1	7	0	8	15	0	0
6	18389541	.	C	T	4	13	17	0	0	17	0	0
6	18393826	.	A	T	7	6	13	0	1	14	0	0
6	18399981	.	C	T	1	6	7	0	5	12	0	0
6	18418861	.	C	A	5	3	8	0	0	8	0	0
6	18423882	.	G	A	2	5	7	0	0	7	0	0
6	18431063	.	A	C	2	3	5	0	0	5	0	0
6	18436500	.	C	T	12	12	24	0	1	25	0	0
6	18436880	.	C	A	20	11	31	0	0	31	0	0
6	18436966	.	G	A	17	13	30	0	1	31	0	0
6	18436969	.	T	C	16	13	29	0	1	30	0	0
6	18438322	.	C	G	8	15	23	0	0	23	0	0
6	18439222	.	C	T	15	5	20	0	0	20	0	0
6	18439540	.	G	A	11	4	15	0	0	15	0	0
6	18439683	.	C	T	13	7	20	0	0	20	0	0
6	18520930	.	T	A	21	20	41	0	1	42	0	0
6	18523549	.	C	A	12	16	28	0	0	28	0	0
6	18523770	.	A	T	11	11	22	0	1	23	0	0
6	18523772	.	C	G	13	10	23	0	0	23	0	0
6	18523817	.	T	A	18	5	23	0	0	23	0	0
6	18524466	.	G	A	3	3	6	0	0	6	0	0
6	18524550	.	A	G	5	5	10	0	1	11	0	0
6	18524579	.	A	G	6	6	12	0	0	12	0	0
6	18526432	.	A	G	5	5	10	0	0	10	0	0
6	18526754	.	G	T	10	4	14	0	0	14	0	0
6	18529148	.	G	T	4	2	6	0	0	6	0	0
6	18529589	.	G	A	7	1	8	0	1	9	0	0
6	18529593	.	T	G	7	2	9	0	0	9	0	0
6	18530378	.	C	T	7	4	11	0	0	11	0	0
6	18531296	.	T	G	2	6	8	0	1	9	0	0
6	18531946	.	T	C	7	5	12	0	0	12	0	0
6	18532445	.	A	T	5	7	12	0	1	13	0	0
6	18533201	.	T	C	7	6	13	0	0	13	0	0
6	18536239	.	G	T	7	10	17	0	0	17	0	0
6	18540911	.	T	C	10	13	23	0	1	24	0	0
6	18540932	.	C	T	13	15	28	0	1	29	0	0
6	18541077	.	A	G	1	3	4	0	0	4	0	0
6	18541083	.	A	G	1	2	3	0	0	3	0	0
6	18541159	.	A	T	3	2	5	0	0	5	0	0
6	18543253	.	G	A	1	7	8	0	14	22	0	0
6	18543400	.	A	G	16	10	26	0	1	27	0	0
6	18543637	.	A	G	9	11	20	0	1	21	0	0
6	18543950	.	G	T	10	9	19	0	0	19	0	0
6	18544301	.	T	A	5	5	10	0	1	11	0	0
6	18554541	.	G	A	3	7	10	0	0	10	0	0
6	18554580	.	C	T	5	4	9	0	0	9	0	0
6	18554836	.	T	G	3	4	7	0	0	7	0	0
6	18555195	.	T	C	1	4	5	0	0	5	0	0
6	18557909	.	T	C	1	0	1	0	2	3	0	0
6	18557997	.	C	G	2	3	5	0	0	5	0	0
6	18558098	.	A	G	4	3	7	0	0	7	0	0
6	18558110	.	C	G	4	3	7	0	0	7	0	0
6	18558137	.	G	A	1	3	4	0	0	4	0	0
6	18569606	.	T	G	3	2	5	0	1	6	0	0
6	18573617	.	C	T	3	3	6	0	0	6	0	0
6	18578070	.	A	T	5	2	7	1	0	8	0	0
6	18584751	.	A	G	2	6	8	0	1	9	0	0
6	18584793	.	T	A	2	5	7	0	0	7	0	0
6	18585103	.	C	T	4	2	6	0	1	7	0	0
6	18587728	.	G	A	8	5	13	0	0	13	0	0
6	18588570	.	G	A	4	8	12	0	0	12	0	0
6	18589090	.	T	C	2	9	11	0	0	11	0	0
6	18589235	.	T	C	8	3	11	0	0	11	0	0
6	18594656	.	T	C	6	3	9	0	0	9	0	0
6	18598494	.	A	T	2	5	7	0	0	7	0	0
6	18606063	.	T	C	6	10	16	0	1	17	0	0
6	18606230	.	G	T	13	17	30	0	2	32	0	0
6	18607151	.	G	A	13	16	29	0	1	30	0	0
6	18607557	.	C	T	17	18	35	0	0	35	0	0
6	18612230	.	C	T	20	16	36	0	1	37	0	0
6	18617255	.	A	T	11	13	24	0	2	27	1	0
6	18618051	.	C	T	14	8	22	0	0	22	0	0
6	18624162	.	T	A	4	6	10	0	1	11	0	0
6	18624964	.	C	T	2	4	6	0	7	13	0	0
6	18625021	.	G	A	12	6	18	0	0	18	0	0
6	18715712	.	A	G	9	4	13	0	0	13	0	0
6	18716085	.	C	T	3	11	14	0	0	14	0	0
6	18716539	.	C	T	0	7	7	0	8	15	0	0
6	18716611	.	T	C	9	0	9	1	10	20	0	0
6	18717886	.	T	C	1	5	6	0	0	6	0	0
6	18717934	.	T	C	2	5	7	0	0	7	0	0
6	18718397	.	G	A	6	4	10	1	0	11	0	0
6	18718438	.	T	G	7	4	11	0	2	13	0	0
6	18718473	.	C	T	4	6	10	0	1	11	0	0
6	18718846	.	A	T	6	7	13	0	0	13	0	0
6	18718964	.	A	G	6	5	11	0	0	11	0	0
6	18721021	.	A	G	6	7	13	0	1	14	0	0
6	18721060	.	T	G	3	4	7	0	2	9	0	0
6	18721099	.	T	C	5	4	9	0	1	10	0	0
6	18724415	.	T	A	8	10	18	0	0	18	0	0
6	18725196	.	C	T	6	5	11	0	0	11	0	0
6	18725232	.	A	G	7	6	13	0	0	13	0	0
6	18725881	.	T	A	9	8	17	0	1	18	0	0
6	18728766	.	A	G	5	4	9	0	0	9	0	0
6	18731328	.	G	C	10	5	15	0	1	16	0	0
6	18731389	.	G	A	5	5	10	0	1	11	0	0
6	18736413	.	A	C	2	6	8	0	0	8	0	0
6	18736460	.	A	G	2	6	8	0	0	8	0	0
6	18737442	.	A	G	9	3	12	0	0	12	0	0
6	18737807	.	T	C	8	4	12	0	0	12	0	0
6	18738949	.	C	T	4	2	6	0	0	6	0	0
6	18738969	.	G	A	4	3	7	0	0	7	0	0
6	18751091	.	C	T	8	6	14	0	1	15	0	0
6	18751146	.	C	T	1	2	3	0	7	10	0	0
6	18936455	.	T	C	5	0	5	0	11	16	0	0
6	18958920	.	C	T	5	3	8	0	0	8	0	0
6	19265802	.	C	A	1	2	3	0	0	3	0	0
6	19270328	.	G	A	5	2	7	0	0	7	0	0
6	19271131	.	A	T	3	2	5	0	0	5	0	0
6	19295454	.	C	T	21	21	42	0	1	43	0	0
6	19295469	.	T	C	20	0	20	0	20	40	0	0
6	19295609	.	A	T	10	12	22	0	3	25	0	0
6	19295625	.	T	A	16	15	31	0	1	32	0	0
6	19295644	.	C	T	4	15	19	0	16	35	0	0
6	19327320	.	T	G	4	4	8	0	1	9	0	0
6	19327380	.	C	T	12	6	18	0	2	20	0	0
6	19328873	.	G	T	1	4	5	0	0	5	0	0
6	19330232	.	T	C	2	4	6	0	0	6	0	0
6	19330729	.	T	C	5	3	8	0	1	9	0	0
6	19331045	.	G	A	4	2	6	0	0	6	0	0
6	19331054	.	C	T	3	3	6	0	0	6	0	0
6	19333946	.	T	C	1	2	3	0	0	3	0	0
6	19334715	.	C	T	1	2	3	0	3	6	0	0
6	19334722	.	A	C	1	3	4	0	1	5	0	0
6	19344846	.	C	T	17	5	22	0	1	23	0	0
6	19344862	.	T	C	7	14	21	0	0	21	0	0
6	19344930	.	G	C	11	8	19	0	1	20	0	0
6	19345191	.	G	A	8	9	17	1	0	18	0	0
6	19347426	.	C	T	0	8	8	0	10	18	0	0
6	19378992	.	G	A	8	7	15	0	1	16	0	0
6	19381816	.	T	G	5	2	7	0	1	8	0	0
6	19381843	.	A	G	3	3	6	0	0	6	0	0
6	19381856	.	C	T	4	3	7	0	0	7	0	0
6	19715552	.	G	A	0	6	6	0	4	10	0	0
6	19802042	.	T	C	5	3	8	0	0	8	0	0
6	19802145	.	G	T	0	7	7	0	9	16	0	0
6	19802148	.	C	A	8	6	14	0	1	15	0	0
6	19802242	.	C	T	11	9	20	0	0	20	0	0
6	19802330	.	G	A	6	9	15	0	1	16	0	0
6	19802354	.	G	A	4	7	11	0	1	12	0	0
6	19802415	.	G	A	0	3	3	0	6	9	0	0
6	19804702	.	A	C	4	4	8	0	0	8	0	0
6	19804878	.	C	T	4	3	7	0	0	7	0	0
6	19805524	.	A	C	2	0	2	0	3	5	0	0
6	19806990	.	C	T	1	2	3	0	0	3	0	0
6	19807126	.	T	A	2	2	4	0	0	4	0	0
6	19807658	.	C	G	3	5	8	0	0	8	0	0
6	19807762	.	A	G	2	3	5	0	0	5	0	0
6	19808670	.	C	T	4	3	7	0	0	7	0	0
6	19808818	.	G	A	5	3	8	0	0	8	0	0
6	19925889	.	G	A	2	2	4	0	0	4	0	0
6	19926081	.	G	A	2	5	7	0	0	7	0	0
6	19926234	.	G	A	2	2	4	0	0	4	0	0
6	20766299	.	G	A	7	18	25	0	0	25	0	0
6	20766307	.	A	G	16	7	23	0	0	23	0	0
6	20766352	.	C	T	7	17	24	0	0	24	0	0
6	20766500	.	G	T	9	7	16	0	2	18	0	0
6	20766565	.	C	G	1	8	9	0	5	14	0	0
6	20767015	.	T	A	22	13	35	0	1	36	0	0
6	20767167	.	C	A	9	5	14	0	1	15	0	0
6	20767502	.	A	G	16	13	29	0	1	30	0	0
6	20767575	.	G	C	14	0	14	0	21	35	0	0
6	20767830	.	T	G	7	2	9	0	1	10	0	0
6	20767910	.	A	G	4	4	8	0	0	8	0	0
6	20767958	.	T	G	8	4	12	0	0	12	0	0
6	20768076	.	C	A	11	7	18	0	2	20	0	0
6	20768107	.	A	T	13	14	27	0	2	29	0	0
6	20768338	.	G	A	16	13	29	0	2	31	0	0
6	20768346	.	T	G	15	18	33	0	0	33	0	0
6	20768407	.	A	T	13	25	38	0	0	38	0	0
6	20768558	.	C	G	16	14	30	0	0	30	0	0
6	20773961	.	G	A	16	21	37	0	0	37	0	0
6	20774048	.	A	C	17	15	32	1	2	35	0	0
6	20774701	.	G	A	20	16	36	0	1	37	0	0
6	20774752	.	G	A	21	14	35	0	0	35	0	0
6	20774768	.	C	T	19	14	33	0	2	35	0	0
6	20910625	.	C	T	7	6	13	0	0	13	0	0
6	20910627	.	A	C	6	7	13	0	0	13	0	0
6	20910713	.	G	T	5	6	11	0	0	11	0	0
6	20910759	.	A	T	10	5	15	0	0	15	0	0
6	20910830	.	T	C	6	10	16	0	1	17	0	0
6	20910880	.	G	A	7	6	13	0	2	15	0	0
6	20910898	.	A	G	8	0	8	0	9	17	0	0
6	20917730	.	A	T	6	8	14	0	0	14	0	0
6	20917780	.	T	A	6	8	14	0	0	14	0	0
6	20917921	.	G	A	4	11	15	0	1	16	0	0
6	20917922	.	A	C	3	12	15	0	1	16	0	0
6	20917988	.	C	A	9	3	12	0	0	12	0	0
6	20917991	.	A	T	1	10	11	0	0	12	1	0
6	20918028	.	C	T	4	3	7	0	0	7	0	0
6	20918418	.	G	T	5	11	16	0	1	17	0	0
6	20921859	.	G	A	5	7	12	0	0	12	0	0
6	20921919	.	G	A	4	7	11	0	0	11	0	0
6	20922271	.	G	T	7	7	14	0	1	15	0	0
6	20922396	.	G	A	11	5	16	0	0	16	0	0
6	20922468	.	G	A	6	6	12	0	1	13	0	0
6	20954511	.	T	C	3	6	9	0	1	10	0	0
6	20954521	.	T	C	2	8	10	0	0	11	1	0
6	20956017	.	C	G	1	6	7	0	1	8	0	0
6	20956724	.	G	A	1	5	6	0	4	10	0	0
6	20956881	.	C	T	4	3	7	0	0	7	0	0
6	20965723	.	G	A	0	7	7	0	2	9	0	0
6	20965780	.	A	G	4	0	4	0	5	9	0	0
6	20965855	.	A	G	5	5	10	0	1	11	0	0
6	20969124	.	A	T	7	4	11	0	0	11	0	0
6	20969126	.	G	T	6	4	10	0	0	10	0	0
6	20976263	.	A	G	2	4	6	0	1	7	0	0
6	20977715	.	T	C	5	2	7	0	0	7	0	0
6	20978972	.	C	T	9	2	11	0	0	11	0	0
6	20979015	.	C	T	5	6	11	0	1	12	0	0
6	20986906	.	C	G	6	0	6	0	12	18	0	0
6	20995800	.	A	G	6	6	12	0	0	12	0	0
6	20996640	.	C	T	9	9	18	0	0	18	0	0
6	20997166	.	C	T	2	4	6	0	0	6	0	0
6	21009375	.	T	G	1	2	3	0	0	3	0	0
6	21116134	.	C	G	5	12	17	1	0	18	0	0
6	21119574	.	C	T	9	8	17	0	1	18	0	0
6	21119598	.	C	T	7	9	16	0	1	17	0	0
6	21119910	.	G	A	6	7	13	0	1	14	0	0
6	21119914	.	A	G	5	8	13	0	1	14	0	0
6	21119949	.	T	C	8	4	12	0	0	12	0	0
6	21119953	.	C	A	4	8	12	0	0	12	0	0
6	21120080	.	A	G	6	14	20	0	2	22	0	0
6	21120193	.	T	C	6	12	18	0	1	19	0	0
6	21120261	.	C	T	8	18	26	0	2	28	0	0
6	21121977	.	T	C	5	6	11	0	0	11	0	0
6	21121987	.	C	T	7	4	11	0	1	12	0	0
6	21130850	.	T	G	2	6	8	0	0	8	0	0
6	21131414	.	C	A	6	14	20	0	1	21	0	0
6	21131504	.	G	A	9	8	17	0	0	17	0	0
6	21131549	.	A	G	4	1	5	0	7	12	0	0
6	21135702	.	G	A	10	5	15	0	1	16	0	0
6	21138869	.	C	T	7	7	14	0	0	14	0	0
6	21138870	.	T	G	6	7	13	0	1	14	0	0
6	21140553	.	G	T	7	7	14	0	0	14	0	0
6	21143033	.	T	C	6	9	15	0	0	15	0	0
6	21143041	.	C	A	10	5	15	0	0	15	0	0
6	21143417	.	C	A	9	9	18	0	2	20	0	0
6	21143685	.	C	T	7	7	14	0	0	14	0	0
6	21144233	.	G	A	4	4	8	0	0	8	0	0
6	21144245	.	C	T	4	5	9	0	0	9	0	0
6	21146252	.	C	T	18	7	25	0	0	25	0	0
6	21146501	.	C	T	12	5	17	0	0	17	0	0
6	21146505	.	C	A	13	5	18	0	0	19	1	0
6	21146549	.	G	T	14	11	25	0	2	27	0	0
6	21146633	.	G	A	16	12	28	0	0	28	0	0
6	21146648	.	G	A	20	10	30	0	0	30	0	0
6	21146813	.	T	G	8	0	8	0	10	18	0	0
6	21147332	.	T	A	10	4	14	0	1	15	0	0
6	21147334	.	T	A	9	5	14	0	0	14	0	0
6	21147837	.	A	G	11	6	17	0	0	17	0	0
6	21147920	.	A	C	7	14	21	0	2	23	0	0
6	21148166	.	A	T	7	13	20	0	1	21	0	0
6	21148167	.	T	C	7	13	20	0	1	21	0	0
6	21148367	.	G	A	13	7	20	0	0	20	0	0
6	21148393	.	T	A	13	8	21	0	0	21	0	0
6	21148736	.	T	A	6	5	11	0	0	11	0	0
6	21148737	.	A	T	7	5	12	0	0	12	0	0
6	21148972	.	G	C	9	10	19	0	0	19	0	0
6	21149353	.	G	C	2	15	17	0	17	34	0	0
6	21149383	.	A	T	15	12	27	0	1	28	0	0
6	21150672	.	G	A	9	20	29	0	1	30	0	0
6	21150712	.	A	T	9	22	31	0	0	31	0	0
6	21150772	.	A	T	27	9	36	0	3	39	0	0
6	21150872	.	C	T	24	22	46	0	2	48	0	0
6	21151474	.	C	T	13	11	24	1	1	26	0	0
6	21151664	.	T	G	15	13	28	0	3	32	1	0
6	21151751	.	C	T	15	17	32	0	0	32	0	0
6	21347996	.	A	G	2	4	6	0	0	6	0	0
6	21376635	.	T	G	5	4	9	0	0	9	0	0
6	21390653	.	G	T	3	5	8	0	0	8	0	0
6	21390667	.	A	T	3	5	8	0	0	8	0	0
6	21391499	.	T	A	5	4	9	0	0	9	0	0
6	21391810	.	T	A	3	4	7	0	0	7	0	0
6	21392049	.	A	T	3	7	10	0	1	11	0	0
6	21392057	.	C	A	3	5	8	0	0	8	0	0
6	21428926	.	A	G	4	0	4	0	4	8	0	0
6	21454984	.	C	A	6	7	13	0	1	14	0	0
6	21513778	.	A	G	3	6	9	0	0	9	0	0
6	21513826	.	C	A	3	3	6	0	0	6	0	0
6	21513984	.	G	C	3	2	5	0	0	5	0	0
6	21514002	.	G	C	2	2	4	0	0	4	0	0
6	21514529	.	C	T	2	3	5	0	1	6	0	0
6	21514961	.	C	T	1	5	6	0	4	10	0	0
6	21515063	.	A	G	3	3	6	0	0	6	0	0
6	21526395	.	A	G	12	20	32	0	1	33	0	0
6	21526620	.	T	C	15	14	29	0	0	29	0	0
6	21526783	.	G	A	12	15	27	0	0	27	0	0
6	21529229	.	A	G	12	18	30	0	0	30	0	0
6	21529379	.	A	T	23	27	50	0	2	52	0	0
6	21529767	.	A	T	14	13	27	0	3	30	0	0
6	21532427	.	T	C	12	0	12	0	15	27	0	0
6	21545980	.	C	T	2	3	5	0	0	5	0	0
6	21570468	.	A	G	1	5	6	0	0	6	0	0
6	21570917	.	G	A	7	2	9	0	0	9	0	0
6	21576216	.	T	G	3	4	7	0	0	7	0	0
6	21588285	.	C	T	12	9	21	0	1	22	0	0
6	21589102	.	A	G	5	6	11	0	0	11	0	0
6	21589103	.	G	A	4	5	9	0	2	11	0	0
6	21589280	.	A	G	7	2	9	0	1	10	0	0
6	21589325	.	C	T	2	3	5	0	6	11	0	0
6	21596632	.	A	G	13	9	22	0	1	23	0	0
6	21602529	.	T	A	15	17	32	0	2	34	0	0
6	21602679	.	T	G	11	16	27	0	4	31	0	0
6	21602849	.	C	A	14	12	26	0	0	26	0	0
6	21615621	.	T	A	13	11	24	0	1	25	0	0
6	21687292	.	C	T	3	4	7	0	0	7	0	0
6	21692821	.	A	G	5	7	12	0	0	12	0	0
6	21693589	.	G	T	0	10	10	0	6	16	0	0
6	21693910	.	A	G	12	10	22	0	0	22	0	0
6	21693969	.	C	T	10	6	16	0	0	16	0	0
6	21694306	.	G	A	16	4	20	0	0	20	0	0
6	21694401	.	C	A	7	9	16	0	1	17	0	0
6	21694544	.	A	G	8	5	13	0	2	15	0	0
6	21694624	.	C	A	6	8	14	0	1	15	0	0
6	21699390	.	A	T	1	2	3	0	0	3	0	0
6	21699689	.	A	T	1	5	6	0	0	6	0	0
6	21699902	.	A	G	1	3	4	0	0	4	0	0
6	21700062	.	T	C	6	3	9	0	2	11	0	0
6	21700138	.	G	A	7	10	17	0	1	18	0	0
6	21700212	.	A	G	7	5	12	0	0	12	0	0
6	21700263	.	A	G	6	4	10	0	0	10	0	0
6	21703020	.	T	G	4	3	7	0	1	8	0	0
6	21710226	.	T	G	4	2	6	0	0	6	0	0
6	21716195	.	T	C	3	4	7	0	0	7	0	0
6	21811593	.	A	G	6	6	12	0	1	13	0	0
6	21815090	.	T	C	7	3	10	0	0	10	0	0
6	21815301	.	C	A	0	9	9	0	6	15	0	0
6	21815389	.	G	A	2	9	11	0	2	13	0	0
6	21830392	.	G	A	2	5	7	0	1	8	0	0
6	21861324	.	G	T	20	19	39	0	6	45	0	0
6	21861490	.	C	A	1	23	24	0	17	41	0	0
6	21861526	.	T	G	20	15	35	0	0	35	0	0
6	21861736	.	T	G	10	9	19	0	1	20	0	0
6	21861771	.	G	A	12	11	23	0	0	23	0	0
6	21861949	.	G	A	23	18	41	0	2	43	0	0
6	21862288	.	G	A	25	16	41	0	2	43	0	0
6	21862359	.	A	T	22	25	47	1	2	50	0	0
6	21862460	.	A	G	21	17	38	0	1	39	0	0
6	21871928	.	T	C	23	20	43	0	3	46	0	0
6	21871931	.	G	T	24	21	45	0	2	47	0	0
6	21875469	.	G	A	4	2	6	0	0	6	0	0
6	21875511	.	T	C	1	4	5	0	0	5	0	0
6	21875741	.	G	T	2	6	8	0	2	10	0	0
6	21875930	.	T	A	0	3	3	0	2	5	0	0
6	21876182	.	T	C	4	4	8	0	1	9	0	0
6	21876183	.	T	C	4	5	9	0	0	9	0	0
6	21876234	.	T	C	1	2	3	0	0	3	0	0
6	21876266	.	T	C	1	2	3	0	0	3	0	0
6	21876852	.	C	T	0	9	9	0	7	16	0	0
6	21876909	.	C	A	2	7	9	0	0	9	0	0
6	21877086	.	A	G	3	5	8	0	0	8	0	0
6	21877586	.	T	C	1	3	4	0	0	4	0	0
6	21878474	.	T	C	3	0	3	0	2	5	0	0
6	21880932	.	G	A	1	2	3	0	0	3	0	0
6	21993967	.	A	C	4	7	11	0	0	11	0	0
6	21996458	.	G	A	4	2	6	1	0	7	0	0
6	22013133	.	A	G	4	3	7	0	0	7	0	0
6	22026249	.	G	T	8	9	17	0	0	17	0	0
6	22026339	.	T	A	5	4	9	0	0	9	0	0
6	22026431	.	G	C	8	9	17	0	0	17	0	0
6	22026440	.	G	A	8	8	16	0	1	17	0	0
6	22026636	.	A	G	3	7	10	0	0	10	0	0
6	22026645	.	A	C	3	4	7	0	0	7	0	0
6	22026825	.	C	A	1	8	9	0	0	9	0	0
6	22027263	.	A	G	6	1	7	0	8	15	0	0
6	22030296	.	G	A	9	8	17	0	0	17	0	0
6	22034802	.	A	G	4	11	15	1	1	17	0	0
6	22034961	.	A	C	8	6	14	0	0	14	0	0
6	22034985	.	A	C	6	4	10	0	0	10	0	0
6	22035352	.	A	G	6	6	12	0	0	12	0	0
6	22035426	.	A	G	13	10	23	0	0	23	0	0
6	22035534	.	G	A	7	7	14	0	0	14	0	0
6	22037715	.	A	T	6	6	12	0	0	12	0	0
6	22037743	.	C	T	4	6	10	0	1	11	0	0
6	22058313	.	G	T	2	3	5	0	0	5	0	0
6	22064116	.	G	A	1	3	4	0	0	4	0	0
6	22090275	.	T	C	2	3	5	0	1	6	0	0
6	22093501	.	A	G	0	2	2	0	1	3	0	0
6	22093528	.	T	C	1	4	5	0	0	5	0	0
6	22105135	.	C	A	20	7	27	0	1	28	0	0
6	22105554	.	A	G	16	6	22	0	4	26	0	0
6	22112395	.	A	G	18	0	18	0	24	42	0	0
6	22112416	.	C	T	22	20	42	0	2	44	0	0
6	22118165	.	T	C	18	24	42	0	0	42	0	0
6	22118216	.	G	A	9	40	49	0	4	53	0	0
6	22118630	.	G	A	21	21	42	4	0	46	0	0
6	22118681	.	C	T	16	18	34	0	1	35	0	0
6	22118690	.	C	T	18	16	34	0	1	35	0	0
6	22118885	.	T	G	29	0	29	0	14	43	0	0
6	22119056	.	C	T	18	35	53	0	2	55	0	0
6	22119478	.	A	T	0	16	16	0	2	18	0	0
6	22119582	.	T	C	22	10	32	0	0	32	0	0
6	22119977	.	T	A	7	13	20	0	2	22	0	0
6	22120074	.	C	T	9	11	20	0	0	20	0	0
6	22120342	.	T	A	10	5	15	0	0	15	0	0
6	22120793	.	A	G	7	6	13	0	1	14	0	0
6	22120877	.	A	G	4	8	12	0	0	12	0	0
6	22127197	.	A	G	9	6	15	0	2	17	0	0
6	22128520	.	G	A	9	13	22	0	1	23	0	0
6	22128603	.	G	A	7	13	20	0	0	20	0	0
6	22134174	.	G	A	5	4	9	0	0	9	0	0
6	22134649	.	T	G	8	8	16	0	0	16	0	0
6	22137403	.	C	T	8	7	15	0	0	15	0	0
6	22330400	.	A	T	24	12	36	0	1	37	0	0
6	22333884	.	A	T	4	12	16	0	1	17	0	0
6	22338938	.	A	G	22	26	48	0	3	51	0	0
6	22344003	.	A	T	28	19	47	0	1	48	0	0
6	22344452	.	C	T	18	27	45	0	0	45	0	0
6	22347259	.	G	A	25	22	47	0	1	48	0	0
6	22348271	.	T	A	23	23	46	0	0	46	0	0
6	22348274	.	G	C	25	25	50	0	0	50	0	0
6	22351770	.	A	C	22	26	48	0	0	48	0	0
6	22352370	.	C	T	5	7	12	0	0	12	0	0
6	22354738	.	C	A	3	4	7	0	0	7	0	0
6	22355040	.	T	C	3	1	4	0	6	10	0	0
6	22363740	.	A	T	2	6	8	0	0	8	0	0
6	22463151	.	A	G	3	4	7	0	2	9	0	0
6	22463346	.	C	T	3	2	5	0	0	5	0	0
6	22464834	.	A	G	0	0	0	0	5	5	0	0
6	22464835	.	C	A	1	4	5	0	0	5	0	0
6	22628997	.	T	G	2	0	2	0	6	8	0	0
6	22980251	.	T	C	6	3	9	0	0	9	0	0
6	22986191	.	A	C	3	5	8	0	0	8	0	0
6	22986242	.	T	G	4	7	11	0	0	11	0	0
6	22988839	.	T	C	5	2	7	0	0	7	0	0
6	22998568	.	G	T	6	3	9	0	0	9	0	0
6	22998590	.	C	T	0	5	5	0	6	11	0	0
6	22998625	.	A	G	4	5	9	0	0	9	0	0
6	22998653	.	C	A	3	4	7	0	0	7	0	0
6	23001656	.	G	T	5	12	17	0	0	17	0	0
6	23001704	.	C	T	10	14	24	0	0	24	0	0
6	23010479	.	T	A	1	4	5	0	0	5	0	0
6	23010502	.	T	A	2	4	6	0	0	6	0	0
6	23018861	.	G	A	2	4	6	0	0	6	0	0
6	23053296	.	A	G	6	4	10	0	0	10	0	0
6	23053393	.	C	A	14	7	21	0	1	22	0	0
6	23053482	.	G	C	4	11	15	0	1	16	0	0
6	23053761	.	A	G	10	12	22	0	1	23	0	0
6	23053824	.	T	C	13	9	22	0	0	22	0	0
6	23053968	.	A	G	10	11	21	0	0	21	0	0
6	23053980	.	A	T	12	12	24	0	0	24	0	0
6	23054266	.	C	T	15	8	23	1	0	24	0	0
6	23054267	.	A	G	12	4	16	1	7	24	0	0
6	23054334	.	A	T	18	8	26	0	1	28	1	0
6	23054569	.	C	T	7	8	15	0	7	22	0	0
6	23054705	.	A	G	8	0	8	0	7	15	0	0
6	23125548	.	G	A	0	4	4	0	5	9	0	0
6	23128699	.	C	T	3	6	9	0	0	9	0	0
6	23617815	.	C	T	2	3	5	0	0	5	0	0
6	23752615	.	G	A	0	6	6	0	9	15	0	0
6	23752775	.	G	A	2	8	10	0	7	17	0	0
6	23778255	.	G	A	6	5	11	0	0	11	0	0
6	23781314	.	C	T	5	5	10	0	0	10	0	0
6	23810518	.	T	C	8	9	17	0	1	18	0	0
6	23810922	.	G	C	14	16	30	0	0	30	0	0
6	23811154	.	C	T	16	15	31	0	0	31	0	0
6	23812885	.	T	C	11	18	29	0	0	29	0	0
6	23813361	.	G	A	2	14	16	0	19	35	0	0
6	23813437	.	G	C	11	10	21	0	0	21	0	0
6	23813554	.	C	A	14	9	23	0	1	24	0	0
6	23938676	.	A	C	2	7	9	0	0	9	0	0
6	23938738	.	A	G	5	7	12	0	0	12	0	0
6	23938829	.	G	A	7	2	9	0	2	11	0	0
6	24056103	.	C	T	0	7	7	0	4	11	0	0
6	24056319	.	T	C	7	10	17	0	2	19	0	0
6	24065975	.	C	G	0	9	9	0	8	17	0	0
6	24066296	.	G	A	9	9	18	0	0	18	0	0
6	24066382	.	T	A	12	6	18	0	0	18	0	0
6	24066611	.	G	A	7	10	17	0	0	17	0	0
6	24093048	.	G	A	3	3	6	0	0	6	0	0
6	24153075	.	G	A	25	25	50	0	0	50	0	0
6	24153114	.	A	G	21	26	47	0	0	47	0	0
6	24153159	.	C	T	25	18	43	0	1	44	0	0
6	24153297	.	T	C	30	19	49	0	4	53	0	0
6	24155357	.	C	T	18	30	48	0	3	51	0	0
6	24155442	.	A	T	24	24	48	0	0	48	0	0
6	24155459	.	T	G	25	24	49	0	0	49	0	0
6	24155744	.	T	C	13	19	32	0	3	35	0	0
6	24156027	.	T	C	21	22	43	0	2	46	1	0
6	24156219	.	T	C	16	0	16	0	17	33	0	0
6	24156344	.	T	G	17	14	31	0	0	31	0	0
6	24156399	.	C	G	23	17	40	0	1	41	0	0
6	24156428	.	A	T	21	17	38	0	2	40	0	0
6	24156476	.	T	G	16	15	31	0	2	33	0	0
6	24156567	.	T	C	12	1	13	0	13	26	0	0
6	24158601	.	T	C	18	0	18	0	17	35	0	0
6	24163420	.	T	C	8	5	13	0	0	13	0	0
6	24163505	.	C	T	4	3	7	0	1	8	0	0
6	24163535	.	A	C	2	3	5	0	1	6	0	0
6	24176062	.	C	T	1	3	4	0	0	4	0	0
6	24179197	.	A	G	2	3	5	0	0	5	0	0
6	24202458	.	C	T	6	3	9	0	1	10	0	0
6	24203829	.	A	C	3	5	8	0	0	8	0	0
6	24203928	.	C	T	5	3	8	0	0	8	0	0
6	24329685	.	C	T	1	4	5	0	0	5	0	0
6	24330029	.	C	T	14	11	25	0	2	27	0	0
6	24330196	.	G	A	19	21	40	0	1	41	0	0
6	24330229	.	G	A	18	16	34	0	1	35	0	0
6	24338496	.	T	A	11	25	36	0	2	38	0	0
6	24338526	.	G	A	21	9	30	0	1	31	0	0
6	24340631	.	G	A	15	12	27	0	0	27	0	0
6	24340688	.	G	T	24	13	37	0	1	38	0	0
6	24349237	.	T	C	6	6	12	0	3	15	0	0
6	24358323	.	A	T	10	9	19	0	0	19	0	0
6	24358596	.	G	A	7	8	15	0	0	15	0	0
6	24358720	.	C	T	1	3	4	0	1	5	0	0
6	24364878	.	G	T	3	5	8	0	1	9	0	0
6	24365276	.	C	A	2	4	6	0	0	6	0	0
6	24365453	.	G	A	12	6	18	0	0	18	0	0
6	24365482	.	C	A	7	8	15	0	1	16	0	0
6	24365838	.	G	A	10	8	18	0	0	18	0	0
6	24384613	.	T	C	6	5	11	0	0	11	0	0
6	24389518	.	A	T	8	9	17	0	0	17	0	0
6	24392318	.	C	T	10	5	15	0	0	15	0	0
6	24392498	.	G	A	3	2	5	0	0	5	0	0
6	24392562	.	T	C	6	0	6	0	5	11	0	0
6	24392674	.	G	T	1	5	6	0	0	6	0	0
6	24392732	.	T	C	3	8	11	0	0	11	0	0
6	24681529	.	C	T	7	6	13	0	0	13	0	0
6	24681563	.	G	A	6	3	9	0	0	9	0	0
6	24682913	.	A	T	12	5	17	0	2	19	0	0
6	24683723	.	A	T	11	6	17	0	1	18	0	0
6	24690886	.	A	G	12	7	19	0	0	19	0	0
6	24691366	.	C	T	12	9	21	0	0	21	0	0
6	24691718	.	A	T	9	6	15	0	0	15	0	0
6	24691845	.	A	T	12	7	19	0	2	21	0	0
6	24692075	.	G	A	2	2	4	1	0	5	0	0
6	24692307	.	A	G	3	8	11	0	0	11	0	0
6	24697891	.	T	G	6	8	14	0	1	15	0	0
6	24698036	.	A	G	1	0	1	0	3	4	0	0
6	24821631	.	G	A	8	3	11	0	0	11	0	0
6	25168647	.	G	C	5	4	9	0	0	9	0	0
6	25169334	.	A	C	2	2	4	0	1	5	0	0
6	25169385	.	T	A	3	2	5	0	0	5	0	0
6	25170022	.	G	C	0	2	2	0	0	2	0	0
6	25170035	.	C	T	2	2	4	0	0	4	0	0
6	25170438	.	T	C	6	3	9	0	0	9	0	0
6	25170743	.	G	A	4	2	6	0	0	6	0	0
6	25171100	.	A	G	1	3	4	0	1	5	0	0
6	25171285	.	A	G	6	3	9	0	0	9	0	0
6	25173005	.	G	A	2	4	6	0	0	6	0	0
6	25173026	.	A	G	4	7	11	0	1	12	0	0
6	25174178	.	T	C	5	0	5	0	6	11	0	0
6	25188279	.	A	C	2	2	4	0	0	4	0	0
6	25261426	.	T	A	5	4	9	0	0	9	0	0
6	25264512	.	C	T	2	2	4	1	0	5	0	0
6	25266345	.	T	C	2	2	4	0	0	4	0	0
6	25337826	.	T	G	1	2	3	0	0	3	0	0
6	26874861	.	A	T	10	3	13	0	0	13	0	0
6	27212949	.	G	A	12	8	20	9	0	29	0	0
6	27220317	.	C	T	28	21	49	0	3	52	0	0
6	27221029	.	T	C	16	23	39	0	2	41	0	0
6	27231706	.	G	A	2	15	17	0	21	38	0	0
6	27232880	.	T	C	15	15	30	0	2	32	0	0
6	27234032	.	T	G	25	22	47	0	2	49	0	0
6	27234250	.	C	T	25	22	47	0	1	48	0	0
6	27260541	.	A	G	26	1	27	1	20	48	0	0
6	27265350	.	T	C	30	28	58	0	0	58	0	0
6	27265434	.	C	T	28	23	51	0	1	52	0	0
6	27269268	.	G	A	20	31	51	1	1	53	0	0
6	27269425	.	G	A	2	24	26	0	22	48	0	0
6	27269612	.	T	A	21	17	38	0	1	39	0	0
6	27269662	.	A	T	25	21	46	0	0	46	0	0
6	27269674	.	C	T	25	22	47	0	0	47	0	0
6	27269862	.	G	A	4	27	31	0	18	49	0	0
6	27269902	.	T	A	25	23	48	0	0	48	0	0
6	27270147	.	G	A	10	15	25	0	0	25	0	0
6	27270288	.	A	C	22	13	35	0	4	39	0	0
6	27270449	.	G	A	16	7	23	0	0	23	0	0
6	27270548	.	G	A	25	18	43	0	2	45	0	0
6	27270664	.	T	A	27	23	50	0	0	50	0	0
6	27270738	.	A	G	23	2	25	0	11	36	0	0
6	27270959	.	C	A	16	13	29	0	2	31	0	0
6	27271114	.	A	G	34	0	34	0	23	57	0	0
6	27271115	.	A	T	34	21	55	0	2	57	0	0
6	27271352	.	G	A	5	16	21	0	21	42	0	0
6	27271355	.	C	T	23	18	41	0	0	41	0	0
6	27271409	.	G	A	29	20	49	0	0	49	0	0
6	27271443	.	G	A	26	27	53	0	1	54	0	0
6	27271610	.	A	T	21	18	39	0	0	39	0	0
6	27271617	.	G	A	21	19	40	0	0	40	0	0
6	27272081	.	T	C	32	31	63	0	2	66	1	0
6	27272205	.	G	C	20	22	42	0	0	42	0	0
6	27272364	.	T	A	27	21	48	0	0	48	0	0
6	27272373	.	A	T	21	20	41	0	3	44	0	0
6	27272440	.	C	T	11	25	36	0	0	36	0	0
6	27272555	.	T	C	17	32	49	0	2	51	0	0
6	27272623	.	A	G	17	32	49	0	3	52	0	0
6	27272660	.	C	G	20	23	43	0	1	45	1	0
6	27272835	.	G	T	20	20	40	0	0	40	0	0
6	27284093	.	C	T	3	5	8	0	0	8	0	0
6	27284481	.	T	C	2	1	3	0	0	3	0	0
6	27284490	.	C	G	2	0	2	0	2	4	0	0
6	27284678	.	G	A	3	4	7	0	1	8	0	0
6	27445976	.	C	A	3	2	5	0	0	5	0	0
6	27449452	.	G	A	1	2	3	0	0	3	0	0
6	27498168	.	G	A	1	2	3	0	0	3	0	0
6	27574439	.	C	G	6	4	10	0	0	10	0	0
6	27574472	.	G	A	6	3	9	0	0	9	0	0
6	27578216	.	C	T	1	3	4	0	0	4	0	0
6	27593999	.	C	T	5	2	7	0	0	7	0	0
6	27598823	.	C	T	1	4	5	0	0	5	0	0
6	27607528	.	C	T	2	7	9	0	0	9	0	0
6	27607591	.	T	C	2	8	10	0	0	10	0	0
6	27614446	.	T	C	3	5	8	0	0	8	0	0
6	27653337	.	A	T	2	2	4	0	0	4	0	0
6	27655200	.	C	G	1	3	4	0	0	4	0	0
6	27660420	.	C	T	1	2	3	0	0	3	0	0
6	27667378	.	C	A	20	12	32	0	0	32	0	0
6	27775416	.	T	A	27	23	50	0	1	51	0	0
6	27816260	.	T	C	13	33	46	0	0	46	0	0
6	27874487	.	G	A	28	24	52	0	6	58	0	0
6	27874529	.	G	A	5	37	42	0	15	57	0	0
6	27874591	.	T	A	19	31	50	0	2	52	0	0
6	27875383	.	G	T	28	27	55	0	0	55	0	0
6	27875519	.	G	T	34	27	61	0	3	64	0	0
6	27875555	.	C	T	21	42	63	0	7	70	0	0
6	27875598	.	T	C	1	47	48	0	1	49	0	0
6	27875600	.	A	C	58	1	59	0	3	62	0	0
6	27875876	.	T	G	26	15	41	0	0	41	0	0
6	27875941	.	C	G	26	27	53	0	3	56	0	0
6	27875944	.	G	A	1	27	28	0	26	54	0	0
6	27915478	.	T	A	2	2	4	0	0	4	0	0
6	27922994	.	A	T	1	2	3	0	0	3	0	0
6	27922995	.	G	A	1	1	2	0	1	3	0	0
6	27992129	.	A	T	1	4	5	0	0	5	0	0
6	27993450	.	A	T	3	4	7	0	0	7	0	0
6	27993735	.	T	C	1	3	4	0	2	6	0	0
6	27997333	.	C	T	10	8	18	0	0	18	0	0
6	27997528	.	A	G	3	3	6	0	1	7	0	0
6	27997662	.	C	A	8	4	12	0	2	14	0	0
6	27998329	.	C	A	11	7	18	0	1	19	0	0
6	27999373	.	T	C	5	6	11	0	0	11	0	0
6	27999396	.	G	C	5	2	7	0	1	8	0	0
6	28000316	.	G	A	2	4	6	0	6	12	0	0
6	28000768	.	G	T	2	8	10	0	1	11	0	0
6	28020204	.	T	C	2	2	4	0	0	4	0	0
6	28025129	.	A	C	6	7	13	1	0	14	0	0
6	28025189	.	A	G	5	0	5	0	6	11	0	0
6	28025213	.	C	T	5	7	12	0	0	12	0	0
6	28031468	.	G	A	7	6	13	0	0	13	0	0
6	28031474	.	T	C	7	5	12	0	0	12	0	0
6	28031610	.	T	A	12	8	20	0	0	20	0	0
6	28031622	.	C	T	8	10	18	0	0	18	0	0
6	28033036	.	C	T	10	5	15	0	0	15	0	0
6	28033174	.	G	C	8	5	13	0	1	14	0	0
6	28035197	.	G	A	1	11	12	0	12	24	0	0
6	28036714	.	A	G	8	1	9	0	5	14	0	0
6	28038882	.	C	G	11	7	18	0	0	18	0	0
6	28044308	.	C	T	7	9	16	0	0	16	0	0
6	28044398	.	C	T	8	6	14	0	1	15	0	0
6	28044401	.	A	G	6	8	14	0	1	15	0	0
6	28048870	.	C	T	4	3	7	0	0	7	0	0
6	28048923	.	C	A	3	4	7	0	2	9	0	0
6	28048957	.	G	T	3	0	3	0	1	4	0	0
6	28049185	.	G	A	0	3	3	0	3	6	0	0
6	28124470	.	A	G	2	0	2	0	5	7	0	0
6	28124823	.	A	G	7	0	7	0	5	12	0	0
6	28124863	.	G	C	8	4	12	0	0	12	0	0
6	28125013	.	T	A	5	3	8	0	0	8	0	0
6	28125028	.	G	A	5	3	8	0	0	8	0	0
6	28206112	.	C	T	15	16	31	0	1	32	0	0
6	28206124	.	T	C	15	14	29	0	1	30	0	0
6	28207532	.	C	A	3	6	9	0	1	10	0	0
6	28207534	.	A	G	4	6	10	0	0	10	0	0
6	28208257	.	A	T	1	3	4	0	0	4	0	0
6	28216496	.	G	A	6	6	12	0	1	13	0	0
6	28216535	.	C	T	12	14	26	0	1	27	0	0
6	28217058	.	C	G	7	8	15	0	1	16	0	0
6	28217103	.	T	C	7	0	7	0	14	21	0	0
6	28217674	.	T	C	12	0	12	2	15	29	0	0
6	28218159	.	G	T	14	10	24	0	0	24	0	0
6	28218367	.	G	A	9	11	20	0	2	22	0	0
6	28218555	.	T	G	8	11	19	0	0	19	0	0
6	28914336	.	C	T	7	4	11	0	0	11	0	0
6	28914790	.	G	A	12	11	23	0	1	24	0	0
6	28914975	.	T	A	12	9	21	0	1	23	1	0
6	28915342	.	T	G	5	13	18	0	1	19	0	0
6	28929960	.	A	G	5	8	13	0	0	13	0	0
6	28931649	.	A	G	14	12	26	0	0	26	0	0
6	28934498	.	A	G	5	12	17	0	0	17	0	0
6	28946048	.	A	T	16	15	31	0	0	31	0	0
6	28956350	.	T	A	23	15	38	1	4	43	0	0
6	28957820	.	G	T	14	19	33	0	0	33	0	0
6	28961407	.	A	G	12	24	36	0	0	36	0	0
6	29011988	.	C	T	5	7	12	0	0	12	0	0
6	29012037	.	A	T	6	7	13	0	1	14	0	0
6	29034576	.	G	C	17	13	30	0	1	31	0	0
6	29039981	.	A	C	11	1	12	0	15	27	0	0
6	29040066	.	A	C	13	12	25	0	2	27	0	0
6	29040789	.	C	T	1	11	12	0	7	19	0	0
6	29040870	.	C	T	1	13	14	0	19	33	0	0
6	29040885	.	C	T	1	13	14	0	18	32	0	0
6	29043162	.	T	G	6	9	15	0	0	15	0	0
6	29044465	.	A	G	5	4	9	0	0	9	0	0
6	29044900	.	G	A	6	9	15	0	0	15	0	0
6	29086676	.	A	T	22	28	50	0	4	54	0	0
6	29087164	.	T	G	33	26	59	0	2	61	0	0
6	29089480	.	T	A	27	32	59	0	2	61	0	0
6	29097297	.	G	A	22	11	33	0	2	35	0	0
6	29097344	.	T	C	5	6	11	0	0	11	0	0
6	29103419	.	G	A	6	5	11	0	1	12	0	0
6	29103470	.	T	C	7	3	10	0	5	15	0	0
6	29103551	.	C	A	2	7	9	0	4	13	0	0
6	29103722	.	T	C	2	0	2	0	9	11	0	0
6	29103749	.	T	C	6	4	10	0	0	10	0	0
6	29105698	.	C	T	5	8	13	0	0	13	0	0
6	29145079	.	C	A	3	3	6	0	0	6	0	0
6	29145081	.	A	G	3	3	6	0	0	6	0	0
6	29145433	.	C	A	1	5	6	0	9	15	0	0
6	29145742	.	T	A	7	5	12	0	1	13	0	0
6	29147764	.	C	T	2	10	12	0	1	13	0	0
6	29152334	.	G	A	6	6	12	0	0	12	0	0
6	29152466	.	T	C	4	0	4	0	7	11	0	0
6	29152618	.	A	G	5	4	9	0	0	9	0	0
6	29152669	.	A	G	6	4	10	0	0	10	0	0
6	29152819	.	C	T	8	2	10	0	0	10	0	0
6	29154193	.	C	T	2	7	9	0	0	9	0	0
6	29154295	.	T	C	12	0	12	0	8	20	0	0
6	29154496	.	A	G	8	7	15	0	1	16	0	0
6	29154601	.	T	C	6	0	6	0	4	10	0	0
6	29154721	.	G	A	5	5	10	0	0	10	0	0
6	29156573	.	A	C	5	6	11	0	0	11	0	0
6	29158227	.	T	C	5	7	12	0	1	13	0	0
6	29159735	.	C	T	0	8	8	0	4	12	0	0
6	29159768	.	A	G	2	6	8	0	0	8	0	0
6	29222796	.	A	C	11	15	26	0	0	26	0	0
6	29223513	.	G	A	1	10	11	0	9	20	0	0
6	29223651	.	T	C	15	13	28	1	2	31	0	0
6	29226126	.	G	A	1	19	20	0	21	41	0	0
6	29227149	.	A	G	19	9	28	0	3	33	2	0
6	29227555	.	T	C	3	4	7	0	0	7	0	0
6	29258214	.	T	A	2	18	20	0	0	20	0	0
6	29273855	.	G	A	13	5	18	0	1	19	0	0
6	29287954	.	G	A	7	6	13	0	0	13	0	0
6	29288121	.	A	G	7	5	12	0	0	12	0	0
6	29289386	.	G	A	0	3	3	0	1	4	0	0
6	29289437	.	G	A	1	5	6	0	0	6	0	0
6	29289844	.	A	T	2	6	8	0	1	9	0	0
6	29289883	.	C	T	3	8	11	0	0	11	0	0
6	29289905	.	G	A	6	3	9	0	0	9	0	0
6	29292610	.	A	C	2	9	11	0	0	11	0	0
6	29292651	.	A	G	6	7	13	0	1	14	0	0
6	29292728	.	C	T	3	4	7	0	0	7	0	0
6	29292780	.	G	A	7	3	10	0	0	10	0	0
6	29292849	.	G	T	5	2	7	0	0	7	0	0
6	29295388	.	T	A	6	8	14	0	0	14	0	0
6	29295414	.	A	T	6	9	15	0	1	16	0	0
6	29295713	.	C	A	0	6	6	0	14	20	0	0
6	29298696	.	C	T	15	15	30	0	1	31	0	0
6	29303573	.	C	T	10	8	18	0	1	19	0	0
6	29303625	.	G	A	13	9	22	0	3	25	0	0
6	29303863	.	T	A	14	17	31	0	0	31	0	0
6	29313312	.	C	A	3	5	8	0	0	8	0	0
6	29313607	.	A	T	10	6	16	0	2	18	0	0
6	29313679	.	A	G	8	8	16	0	2	18	0	0
6	29322029	.	T	C	8	0	8	0	7	15	0	0
6	29322547	.	G	A	12	11	23	1	0	24	0	0
6	29322595	.	C	G	15	11	26	1	0	27	0	0
6	29328308	.	G	A	13	6	19	0	0	19	0	0
6	29328524	.	A	G	9	7	16	0	0	16	0	0
6	29330676	.	G	A	5	5	10	0	0	10	0	0
6	29330727	.	A	G	10	3	13	0	0	13	0	0
6	29332546	.	A	T	4	4	8	0	1	9	0	0
6	29332603	.	C	T	1	5	6	0	1	7	0	0
6	29335675	.	G	A	13	9	22	0	1	23	0	0
6	29336100	.	T	C	3	4	7	0	0	7	0	0
6	29337926	.	A	G	4	7	11	0	0	11	0	0
6	29347514	.	G	A	3	5	8	0	0	8	0	0
6	29347875	.	T	C	6	0	6	0	5	11	0	0
6	29348152	.	T	A	5	3	8	0	1	9	0	0
6	29387493	.	G	A	9	5	14	0	0	14	0	0
6	29390565	.	A	G	7	4	11	0	0	11	0	0
6	29391718	.	T	C	5	10	15	0	1	16	0	0
6	29393533	.	T	A	6	11	17	0	0	17	0	0
6	29394244	.	A	T	8	6	14	0	0	15	1	0
6	29395297	.	C	T	14	10	24	0	0	24	0	0
6	29401837	.	T	C	11	11	22	0	0	22	0	0
6	29402220	.	C	T	10	10	20	0	1	21	0	0
6	29402451	.	C	A	1	8	9	0	10	19	0	0
6	29403076	.	C	T	21	16	37	0	0	37	0	0
6	29403550	.	G	A	16	18	34	0	3	37	0	0
6	29404094	.	T	C	30	20	50	0	1	51	0	0
6	29414883	.	T	G	3	2	5	0	0	5	0	0
6	29430722	.	G	A	1	3	4	0	0	4	0	0
6	29434711	.	G	A	4	2	6	0	1	7	0	0
6	29459034	.	T	C	5	2	7	0	0	7	0	0
6	29466626	.	C	A	7	3	10	0	0	10	0	0
6	29466897	.	A	C	2	2	4	0	0	4	0	0
6	29467919	.	A	G	1	2	3	0	1	4	0	0
6	29468797	.	C	T	3	2	5	0	0	5	0	0
6	29477093	.	T	A	6	3	9	0	0	9	0	0
6	29477094	.	T	C	6	2	8	0	1	9	0	0
6	29477188	.	C	T	9	8	17	0	0	17	0	0
6	29477739	.	C	T	2	4	6	0	1	7	0	0
6	29477929	.	T	C	3	8	11	0	0	11	0	0
6	29477962	.	C	T	3	5	8	0	0	8	0	0
6	29485253	.	T	C	3	3	6	0	0	6	0	0
6	29488695	.	A	G	4	3	7	0	0	7	0	0
6	29498150	.	A	T	8	5	13	0	0	13	0	0
6	29519903	.	G	A	2	5	7	1	0	8	0	0
6	29611905	.	T	C	4	0	4	0	5	9	0	0
6	29612067	.	G	A	2	4	6	0	0	6	0	0
6	29703526	.	C	T	11	4	15	0	1	16	0	0
6	29703846	.	A	C	10	6	16	0	0	16	0	0
6	29703865	.	A	T	12	7	19	0	0	19	0	0
6	29705343	.	C	T	7	10	17	0	0	17	0	0
6	29705709	.	T	A	8	6	14	0	1	15	0	0
6	29705710	.	T	C	7	7	14	0	0	14	0	0
6	29705767	.	A	G	7	12	19	0	0	19	0	0
6	29708010	.	T	C	15	11	26	0	0	26	0	0
6	29708073	.	A	C	8	11	19	0	2	21	0	0
6	29708100	.	C	T	5	11	16	0	0	16	0	0
6	29710111	.	C	T	9	9	18	0	0	18	0	0
6	29710157	.	A	G	7	0	7	0	11	18	0	0
6	29710216	.	C	T	10	10	20	0	2	22	0	0
6	29710252	.	T	C	11	11	22	0	0	22	0	0
6	29710927	.	G	A	2	2	4	0	0	4	0	0
6	29712410	.	C	T	11	12	23	0	1	24	0	0
6	29712420	.	C	A	9	15	24	0	1	25	0	0
6	29712470	.	T	C	7	9	16	0	2	18	0	0
6	29712651	.	G	A	12	16	28	0	2	30	0	0
6	29754191	.	T	G	1	2	3	0	0	3	0	0
6	29791206	.	C	G	7	16	23	0	0	23	0	0
6	29791310	.	A	C	27	40	67	0	0	67	0	0
6	29793798	.	C	A	27	45	72	0	2	74	0	0
6	29793814	.	C	T	44	24	68	0	8	77	1	0
6	29794042	.	G	A	48	30	78	0	1	80	1	0
6	29794639	.	T	C	29	25	54	2	2	58	0	0
6	29794695	.	T	C	18	35	53	1	3	57	0	0
6	30019954	.	C	T	19	12	31	0	2	33	0	0
6	30032574	.	A	G	15	0	15	2	14	31	0	0
6	30048285	.	A	G	3	0	3	0	9	12	0	0
6	30048421	.	G	A	2	9	11	0	19	30	0	0
6	30060296	.	C	T	19	27	46	0	1	47	0	0
6	30066414	.	A	T	7	2	9	0	0	9	0	0
6	30081420	.	C	T	22	8	30	0	6	36	0	0
6	30081421	.	T	C	21	6	27	0	9	36	0	0
6	30081503	.	A	G	23	17	40	0	0	40	0	0
6	30081725	.	C	T	17	23	40	0	0	40	0	0
6	30082255	.	G	A	10	8	18	0	3	21	0	0
6	30082752	.	T	G	30	14	44	0	0	44	0	0
6	30082838	.	G	T	15	12	27	0	1	28	0	0
6	30113800	.	C	T	4	7	11	0	0	11	0	0
6	30115399	.	A	G	3	4	7	0	0	7	0	0
6	30117495	.	G	A	6	3	9	0	0	9	0	0
6	30120409	.	C	A	5	5	10	0	0	10	0	0
6	30121872	.	G	T	10	4	14	0	0	14	0	0
6	30122248	.	A	T	6	6	12	0	0	12	0	0
6	30122255	.	C	A	7	3	10	0	0	10	0	0
6	30133958	.	G	T	21	18	39	0	4	43	0	0
6	30147219	.	G	A	21	14	35	0	3	38	0	0
6	30147831	.	C	T	17	8	25	0	0	25	0	0
6	30148056	.	A	T	20	13	33	0	3	36	0	0
6	30148143	.	G	A	18	11	29	0	1	30	0	0
6	30148182	.	G	A	11	11	22	0	1	23	0	0
6	30148863	.	T	C	22	19	41	0	1	42	0	0
6	30151519	.	G	A	23	16	39	0	2	41	0	0
6	30177635	.	G	A	16	10	26	0	2	28	0	0
6	30177724	.	G	A	11	5	16	0	0	16	0	0
6	30432467	.	G	A	1	3	4	0	2	6	0	0
6	30432477	.	C	A	3	3	6	0	0	6	0	0
6	30432533	.	T	G	2	5	7	0	0	7	0	0
6	30433843	.	C	G	1	2	3	0	1	4	0	0
6	30434078	.	A	T	6	3	9	0	0	9	0	0
6	30434201	.	G	A	4	3	7	0	2	9	0	0
6	30434288	.	A	T	5	3	8	0	0	8	0	0
6	30440258	.	G	A	1	3	4	0	8	12	0	0
6	30441333	.	G	A	4	3	7	0	1	8	0	0
6	30441399	.	G	A	0	4	4	0	3	7	0	0
6	30441536	.	G	A	9	4	13	0	0	13	0	0
6	30450464	.	G	A	2	9	11	0	0	11	0	0
6	30452316	.	T	C	6	9	15	0	1	16	0	0
6	30452811	.	C	T	3	2	5	0	0	5	0	0
6	30452932	.	G	C	3	2	5	0	0	5	0	0
6	30566560	.	T	C	2	2	4	0	0	4	0	0
6	30573564	.	T	G	4	4	8	0	0	8	0	0
6	30573792	.	C	T	2	2	4	0	0	4	0	0
6	30579379	.	C	T	2	4	6	0	0	6	0	0
6	30583746	.	A	G	5	0	5	0	4	9	0	0
6	30587201	.	T	A	2	4	6	0	0	6	0	0
6	30592556	.	T	C	1	2	3	0	1	4	0	0
6	30592558	.	A	T	2	2	4	0	0	4	0	0
6	30592593	.	A	T	2	2	4	0	0	4	0	0
6	30626227	.	A	G	9	15	24	0	1	25	0	0
6	30626240	.	A	T	11	17	28	0	1	29	0	0
6	30626276	.	T	C	13	12	25	0	1	26	0	0
6	30626630	.	T	G	10	10	20	0	3	24	1	0
6	30626715	.	T	G	17	13	30	0	0	30	0	0
6	30626765	.	C	T	16	7	23	0	1	24	0	0
6	30627182	.	T	A	22	10	32	1	0	33	0	0
6	30627228	.	A	C	20	13	33	0	1	34	0	0
6	30627292	.	T	C	21	13	34	0	5	39	0	0
6	30627605	.	G	C	21	9	30	0	2	32	0	0
6	30627606	.	A	C	20	0	20	0	12	32	0	0
6	30627660	.	A	C	18	10	28	0	0	28	0	0
6	30627674	.	G	T	17	12	29	0	1	30	0	0
6	30627744	.	C	T	15	19	34	0	1	35	0	0
6	30627764	.	G	T	13	17	30	0	2	32	0	0
6	30627811	.	T	C	21	8	29	0	1	30	0	0
6	30627914	.	T	C	14	14	28	0	0	28	0	0
6	30627921	.	G	T	13	14	27	0	1	28	0	0
6	30627996	.	A	C	11	0	11	0	10	21	0	0
6	30627998	.	T	C	10	0	10	0	10	20	0	0
6	30628097	.	C	T	20	9	29	0	0	29	0	0
6	30628170	.	T	C	2	8	10	0	1	11	0	0
6	30628228	.	A	G	7	6	13	1	1	15	0	0
6	30628848	.	C	T	18	8	26	0	0	26	0	0
6	30628922	.	T	C	11	11	22	0	1	23	0	0
6	30628976	.	T	A	6	15	21	0	0	21	0	0
6	30629229	.	T	A	5	9	14	0	0	14	0	0
6	30629303	.	T	A	1	8	9	0	0	9	0	0
6	30629317	.	C	A	2	8	10	0	0	10	0	0
6	30629384	.	T	C	5	1	6	0	9	15	0	0
6	30629459	.	A	G	5	6	11	0	0	11	0	0
6	30629553	.	C	T	0	7	7	0	12	19	0	0
6	30629827	.	C	A	8	5	13	0	2	15	0	0
6	30629850	.	G	C	8	9	17	0	1	18	0	0
6	30629865	.	A	C	7	8	15	0	0	16	1	0
6	30629895	.	G	A	8	8	16	0	1	17	0	0
6	30629912	.	A	T	10	8	18	0	1	19	0	0
6	30629935	.	T	C	9	0	9	0	9	18	0	0
6	30630017	.	C	T	0	3	3	0	3	6	0	0
6	30630057	.	G	A	6	2	8	0	0	8	0	0
6	30630163	.	G	A	5	3	8	1	1	10	0	0
6	30630438	.	G	A	14	9	23	0	0	23	0	0
6	30630811	.	T	C	14	11	25	0	0	25	0	0
6	30630904	.	A	G	7	11	18	0	0	18	0	0
6	30631021	.	T	C	9	6	15	0	2	17	0	0
6	30658102	.	T	C	11	6	17	0	1	18	0	0
6	30658545	.	G	A	7	8	15	0	0	15	0	0
6	30658728	.	A	C	9	9	18	0	3	21	0	0
6	30677475	.	A	G	5	3	8	0	0	8	0	0
6	30677582	.	T	C	13	4	17	0	0	17	0	0
6	30677602	.	A	T	10	7	17	0	0	17	0	0
6	30677646	.	A	G	12	8	20	0	0	20	0	0
6	30677654	.	A	C	10	7	17	0	0	17	0	0
6	30677701	.	C	T	0	4	4	0	8	12	0	0
6	30677734	.	A	C	4	0	4	0	2	6	0	0
6	30677920	.	T	A	8	7	15	0	0	15	0	0
6	30678406	.	C	A	4	4	8	0	0	8	0	0
6	30681208	.	C	T	3	5	8	0	0	8	0	0
6	30682141	.	A	G	3	4	7	0	0	7	0	0
6	30683382	.	G	A	2	6	8	0	0	8	0	0
6	30683571	.	T	A	6	8	14	0	0	14	0	0
6	30683578	.	T	C	8	9	17	0	0	17	0	0
6	30685391	.	G	T	2	3	5	0	0	5	0	0
6	30685632	.	A	G	1	2	3	0	1	4	0	0
6	30685644	.	A	T	2	1	3	0	1	4	0	0
6	30687631	.	C	T	1	3	4	0	0	4	0	0
6	30687664	.	T	C	1	2	3	0	0	3	0	0
6	30687736	.	T	C	1	4	5	0	0	5	0	0
6	30687858	.	T	C	2	3	5	0	0	5	0	0
6	30698007	.	T	C	1	2	3	0	0	3	0	0
6	30710270	.	A	G	18	27	45	0	0	45	0	0
6	30710313	.	C	A	20	16	36	0	1	37	0	0
6	30710342	.	T	G	26	15	41	0	1	42	0	0
6	30710351	.	G	T	24	14	38	0	2	40	0	0
6	30710457	.	C	T	29	14	43	0	0	43	0	0
6	30710460	.	T	G	23	15	38	0	2	40	0	0
6	30710496	.	T	A	18	10	28	0	0	29	1	0
6	30710516	.	T	A	13	10	23	0	3	26	0	0
6	30711554	.	C	T	1	14	15	0	20	35	0	0
6	30711777	.	C	T	19	19	38	0	3	41	0	0
6	30711779	.	G	A	17	21	38	0	2	40	0	0
6	30711844	.	A	G	14	20	34	0	1	35	0	0
6	30711851	.	T	C	13	21	34	0	1	35	0	0
6	30712265	.	T	C	11	17	28	0	0	28	0	0
6	30712455	.	A	T	5	12	17	0	0	17	0	0
6	30712616	.	C	T	0	11	11	0	8	19	0	0
6	30712622	.	A	G	11	10	21	2	2	25	0	0
6	30712917	.	G	A	27	10	37	0	0	37	0	0
6	30713296	.	C	T	16	11	27	0	0	27	0	0
6	30713334	.	G	C	15	14	29	2	1	32	0	0
6	30713647	.	C	T	7	7	14	0	0	14	0	0
6	30713666	.	T	C	6	9	15	0	0	15	0	0
6	30713822	.	T	G	17	15	32	0	0	32	0	0
6	30713824	.	A	T	17	15	32	0	0	32	0	0
6	30713869	.	C	T	4	21	25	0	17	42	0	0
6	30713910	.	C	T	29	23	52	0	1	53	0	0
6	30714020	.	T	C	15	22	37	0	0	37	0	0
6	30714053	.	T	C	14	18	32	1	3	36	0	0
6	30714177	.	T	A	13	15	28	0	0	28	0	0
6	30715009	.	T	G	11	10	21	0	1	22	0	0
6	30715446	.	T	C	10	1	11	0	10	21	0	0
6	30717579	.	T	C	26	12	38	0	2	40	0	0
6	30719319	.	G	A	10	17	27	0	1	28	0	0
6	30719935	.	C	T	12	12	24	0	2	26	0	0
6	30740064	.	A	G	14	16	30	0	0	30	0	0
6	30740106	.	G	A	14	14	28	0	0	28	0	0
6	30740127	.	T	A	8	8	16	0	4	21	1	0
6	30740160	.	C	A	2	6	8	0	3	11	0	0
6	30742651	.	A	G	22	22	44	0	2	46	0	0
6	30747415	.	A	G	18	12	30	0	1	31	0	0
6	30761742	.	G	A	14	7	21	0	0	21	0	0
6	30761775	.	G	A	14	7	21	0	2	23	0	0
6	30851611	.	A	T	7	5	12	0	0	12	0	0
6	30855423	.	G	A	20	22	42	0	2	44	0	0
6	30868450	.	A	G	7	8	15	0	1	16	0	0
6	31069556	.	G	A	7	6	13	0	0	13	0	0
6	31069622	.	T	A	5	5	10	0	1	11	0	0
6	31069682	.	T	C	5	8	13	0	0	13	0	0
6	31069748	.	A	G	3	8	11	0	0	11	0	0
6	31146921	.	T	C	4	3	7	0	0	7	0	0
6	31146955	.	A	T	1	6	7	0	0	7	0	0
6	31147138	.	T	A	1	3	4	0	0	4	0	0
6	31184478	.	A	G	3	3	6	0	1	7	0	0
6	31184674	.	C	T	1	3	4	0	0	4	0	0
6	31185037	.	T	C	2	3	5	0	0	5	0	0
6	31185074	.	C	T	1	3	4	0	0	4	0	0
6	31185523	.	C	T	1	2	3	0	0	3	0	0
6	31185825	.	A	T	2	3	5	0	0	5	0	0
6	31186981	.	G	A	6	11	17	0	0	17	0	0
6	31187043	.	A	C	3	5	8	0	0	8	0	0
6	31187067	.	A	C	3	3	6	0	0	6	0	0
6	31198291	.	C	T	6	5	11	0	0	11	0	0
6	31198381	.	G	C	1	5	6	0	0	6	0	0
6	31198869	.	G	A	4	2	6	0	0	6	0	0
6	31198876	.	T	A	4	3	7	0	0	7	0	0
6	31209550	.	T	C	2	3	5	0	0	5	0	0
6	31209552	.	T	C	2	0	2	0	3	5	0	0
6	31214339	.	T	C	4	4	8	0	1	9	0	0
6	31214421	.	C	G	6	5	11	0	0	11	0	0
6	31279834	.	G	A	11	15	26	0	1	27	0	0
6	31280141	.	G	A	23	14	37	0	0	37	0	0
6	31280164	.	T	C	15	19	34	0	2	36	0	0
6	31280185	.	T	A	15	20	35	0	1	36	0	0
6	31280645	.	C	A	19	4	23	0	0	25	2	0
6	31280681	.	C	A	10	8	18	0	0	18	0	0
6	31280735	.	T	G	15	14	29	0	0	29	0	0
6	31280741	.	G	A	13	17	30	0	0	30	0	0
6	31280936	.	A	T	14	14	28	0	1	29	0	0
6	31280945	.	A	T	15	16	31	0	1	32	0	0
6	31281282	.	G	A	16	15	31	0	3	34	0	0
6	31281304	.	C	A	18	18	36	0	3	39	0	0
6	31281481	.	A	G	10	4	14	0	0	14	0	0
6	31281533	.	T	A	9	14	23	0	0	23	0	0
6	31281537	.	A	G	9	14	23	0	0	23	0	0
6	31281594	.	A	T	18	13	31	0	0	31	0	0
6	31281674	.	T	C	19	9	28	0	0	28	0	0
6	31281694	.	C	T	16	10	26	0	2	28	0	0
6	31281732	.	T	A	15	12	27	1	0	28	0	0
6	31282205	.	C	T	8	9	17	0	0	17	0	0
6	31282399	.	T	C	8	8	16	0	0	16	0	0
6	31282494	.	C	T	15	8	23	0	1	24	0	0
6	31282835	.	A	G	1	6	7	0	0	7	0	0
6	31283055	.	G	A	10	9	19	0	0	19	0	0
6	31283180	.	C	T	24	6	30	0	1	31	0	0
6	31283191	.	T	C	19	5	24	0	7	31	0	0
6	31283245	.	A	G	9	12	21	1	2	24	0	0
6	31285874	.	G	A	17	18	35	0	1	36	0	0
6	31288637	.	C	G	18	17	35	0	0	35	0	0
6	31288642	.	C	G	1	18	19	0	18	37	0	0
6	31288742	.	T	C	25	0	25	0	15	41	1	0
6	31288894	.	T	A	19	22	41	0	4	45	0	0
6	31291030	.	G	A	16	18	34	0	1	35	0	0
6	31291033	.	C	A	15	20	35	0	0	35	0	0
6	31309823	.	C	T	0	11	11	0	12	23	0	0
6	31352298	.	T	A	13	5	18	0	2	20	0	0
6	31352406	.	C	A	18	5	23	0	0	23	0	0
6	31352555	.	T	C	5	5	10	0	0	10	0	0
6	31352556	.	G	A	5	5	10	0	0	10	0	0
6	31352635	.	T	G	5	5	10	0	0	10	0	0
6	31352697	.	A	G	6	2	8	0	0	8	0	0
6	31352907	.	T	C	13	3	16	1	1	18	0	0
6	31352956	.	A	C	8	10	18	0	0	18	0	0
6	31352963	.	A	G	8	10	18	0	1	19	0	0
6	31353022	.	G	C	15	10	25	0	0	25	0	0
6	31353073	.	T	C	17	5	22	1	0	23	0	0
6	31353345	.	T	A	12	11	23	0	1	24	0	0
6	31353451	.	A	T	15	6	21	0	1	22	0	0
6	31353613	.	G	A	25	6	31	0	1	32	0	0
6	31355787	.	C	T	18	17	35	0	0	35	0	0
6	31358525	.	C	T	2	17	19	0	13	32	0	0
6	31368096	.	C	T	4	3	7	0	1	8	0	0
6	31394445	.	A	C	2	7	9	0	0	9	0	0
6	31394453	.	A	C	4	7	11	0	0	11	0	0
6	31395835	.	G	A	10	3	13	0	0	13	0	0
6	31396249	.	A	T	6	5	11	0	0	11	0	0
6	31405898	.	G	A	1	6	7	0	8	15	0	0
6	31405923	.	C	T	8	9	17	0	1	18	0	0
6	31411751	.	C	T	8	8	16	0	0	16	0	0
6	31414061	.	A	C	9	5	14	0	0	14	0	0
6	31416100	.	A	G	6	0	6	0	6	12	0	0
6	31419749	.	T	C	7	4	11	0	1	12	0	0
6	31426287	.	G	T	13	12	25	0	1	26	0	0
6	31426465	.	T	C	14	12	26	0	0	26	0	0
6	31426546	.	C	A	11	6	17	0	0	17	0	0
6	31426551	.	C	A	12	5	17	0	0	17	0	0
6	31426727	.	C	G	11	11	22	0	0	22	0	0
6	31426886	.	C	T	5	15	20	0	2	23	1	0
6	31426955	.	G	A	14	7	21	0	1	22	0	0
6	31427226	.	C	T	3	4	7	0	0	7	0	0
6	31427363	.	C	G	10	0	10	0	7	17	0	0
6	31427397	.	T	C	17	6	23	0	0	23	0	0
6	31427437	.	C	A	11	6	17	0	0	17	0	0
6	31427468	.	A	G	5	7	12	0	2	14	0	0
6	31427650	.	A	G	7	8	15	0	0	15	0	0
6	31427654	.	A	G	10	4	14	0	0	14	0	0
6	31427815	.	G	T	2	7	9	0	9	18	0	0
6	31428565	.	T	G	7	3	10	0	0	10	0	0
6	31428566	.	A	G	7	3	10	0	0	10	0	0
6	31428705	.	C	T	11	7	18	0	2	20	0	0
6	31428746	.	G	A	7	8	15	0	0	15	0	0
6	31428920	.	G	A	3	2	5	0	0	5	0	0
6	31428954	.	C	T	3	2	5	0	0	5	0	0
6	31430950	.	T	C	3	0	3	0	5	8	0	0
6	31431355	.	G	A	12	15	27	0	2	29	0	0
6	31431422	.	A	G	15	17	32	0	1	33	0	0
6	31431520	.	A	G	13	12	25	0	1	26	0	0
6	31431646	.	A	T	16	17	33	0	0	33	0	0
6	31431775	.	T	C	18	10	28	0	3	31	0	0
6	31431926	.	A	T	20	18	38	0	1	39	0	0
6	31432232	.	G	A	9	6	15	0	0	15	0	0
6	31432315	.	T	C	10	4	14	0	0	14	0	0
6	31432391	.	T	A	6	3	9	0	0	9	0	0
6	31432554	.	A	T	6	5	11	0	0	11	0	0
6	31432617	.	T	G	10	4	14	0	0	14	0	0
6	31432679	.	T	A	9	6	15	0	0	15	0	0
6	31432746	.	A	C	12	8	20	0	1	21	0	0
6	31432761	.	A	G	15	10	25	0	1	26	0	0
6	31433056	.	C	T	17	8	25	0	0	25	0	0
6	31433060	.	T	C	16	6	22	0	0	22	0	0
6	31433126	.	C	G	1	8	9	1	15	25	0	0
6	31433362	.	T	A	5	4	9	0	0	9	0	0
6	31433392	.	T	G	7	6	13	0	1	14	0	0
6	31433412	.	A	G	6	7	13	0	0	13	0	0
6	31433572	.	T	A	7	9	16	0	0	16	0	0
6	31433756	.	C	A	4	4	8	0	0	8	0	0
6	31434470	.	G	T	14	4	18	0	0	18	0	0
6	31434554	.	G	A	7	7	14	1	0	15	0	0
6	31434555	.	A	G	6	6	12	1	1	14	0	0
6	31434773	.	T	G	18	9	27	0	0	27	0	0
6	31434830	.	A	G	13	10	23	0	0	23	0	0
6	31434923	.	C	T	1	7	8	0	9	17	0	0
6	31435005	.	T	C	9	9	18	0	3	21	0	0
6	31438395	.	T	C	14	18	32	0	1	33	0	0
6	31438404	.	T	G	15	15	30	0	3	33	0	0
6	31441574	.	A	T	17	11	28	1	2	31	0	0
6	31465978	.	G	C	5	1	6	0	11	17	0	0
6	31469966	.	T	G	7	6	13	0	3	16	0	0
6	31483364	.	A	C	4	8	12	0	0	12	0	0
6	31518368	.	T	C	2	0	2	0	6	8	0	0
6	31591116	.	C	T	11	3	14	0	1	15	0	0
6	31591123	.	C	T	8	3	11	0	4	15	0	0
6	31591163	.	A	G	11	5	16	0	1	17	0	0
6	31591452	.	C	T	13	9	22	0	1	23	0	0
6	31591619	.	G	A	8	12	20	0	1	21	0	0
6	31591838	.	T	G	14	17	31	0	4	36	1	0
6	31591997	.	A	C	20	0	20	0	18	38	0	0
6	31598783	.	C	T	13	8	21	0	2	23	0	0
6	31607768	.	T	G	11	7	18	0	0	18	0	0
6	31611647	.	T	A	6	7	13	0	0	13	0	0
6	31617167	.	C	G	1	5	6	0	10	16	0	0
6	31632508	.	T	C	7	10	17	0	0	17	0	0
6	31632519	.	G	A	7	10	17	0	0	17	0	0
6	31632550	.	G	C	6	0	6	0	9	15	0	0
6	31646560	.	C	T	1	5	6	0	6	12	0	0
6	32020326	.	G	A	19	12	31	0	0	31	0	0
6	32020327	.	T	A	17	12	29	0	2	31	0	0
6	32021615	.	T	A	13	16	29	0	0	29	0	0
6	32029432	.	A	T	1	3	4	0	0	4	0	0
6	32032374	.	A	C	8	6	14	0	0	14	0	0
6	32035947	.	A	G	4	6	10	0	0	10	0	0
6	32037710	.	T	C	8	4	12	0	1	13	0	0
6	32040581	.	G	A	3	5	8	0	0	8	0	0
6	32040620	.	G	A	1	4	5	0	0	5	0	0
6	32042325	.	C	T	1	6	7	0	0	7	0	0
6	32042501	.	G	A	5	6	11	0	0	11	0	0
6	32065310	.	C	T	3	4	7	0	0	7	0	0
6	32068390	.	C	T	0	2	2	0	1	3	0	0
6	32092825	.	C	T	1	2	3	0	4	7	0	0
6	32301137	.	A	T	7	6	13	0	1	14	0	0
6	32301161	.	C	T	6	3	9	0	0	9	0	0
6	32301214	.	A	T	3	7	10	0	0	10	0	0
6	32301265	.	A	T	8	6	14	0	0	14	0	0
6	32301487	.	G	C	6	3	9	0	0	9	0	0
6	32301969	.	T	G	7	5	12	0	0	12	0	0
6	32302086	.	T	A	4	6	10	0	0	10	0	0
6	32302236	.	C	T	0	2	2	0	2	4	0	0
6	32314240	.	G	A	2	3	5	0	0	5	0	0
6	32331333	.	G	A	0	6	6	0	6	12	0	0
6	32338356	.	T	C	5	5	10	0	1	11	0	0
6	32339606	.	T	C	8	11	19	0	0	19	0	0
6	32339831	.	C	A	9	8	17	0	1	18	0	0
6	32340005	.	C	T	8	9	17	0	1	18	0	0
6	32344428	.	T	A	1	2	3	0	0	3	0	0
6	32346790	.	G	A	3	2	5	0	0	5	0	0
6	32347382	.	A	T	3	2	5	0	1	6	0	0
6	32355221	.	C	T	8	10	18	0	0	18	0	0
6	32359371	.	A	G	8	4	12	0	0	12	0	0
6	32359533	.	G	A	5	8	13	0	0	13	0	0
6	32364439	.	C	T	6	8	14	0	1	15	0	0
6	32368787	.	A	T	5	4	9	0	0	9	0	0
6	32368952	.	C	T	6	6	12	0	1	13	0	0
6	32368970	.	A	T	8	9	17	0	0	17	0	0
6	32371414	.	A	G	8	10	18	0	0	18	0	0
6	32371423	.	T	C	7	10	17	0	0	17	0	0
6	32371466	.	A	T	7	9	16	0	1	17	0	0
6	32375581	.	T	C	10	5	15	0	0	15	0	0
6	32375838	.	T	C	4	9	13	0	1	14	0	0
6	32378097	.	G	A	0	5	5	0	12	17	0	0
6	32378689	.	T	C	11	12	23	0	0	23	0	0
6	32385091	.	A	G	20	7	27	0	0	27	0	0
6	32386908	.	T	C	16	6	22	0	1	23	0	0
6	32396755	.	T	C	9	11	20	0	1	21	0	0
6	32397659	.	T	C	18	11	29	0	0	29	0	0
6	32398844	.	G	A	15	17	32	0	0	32	0	0
6	32403028	.	G	A	12	12	24	0	2	26	0	0
6	32403052	.	T	C	12	9	21	0	2	24	1	0
6	32404957	.	A	G	10	14	24	0	0	24	0	0
6	32404984	.	A	G	11	10	21	0	0	21	0	0
6	32405020	.	G	A	14	10	24	0	0	24	0	0
6	32405054	.	A	T	7	7	14	0	2	16	0	0
6	32405784	.	A	G	8	12	20	0	0	20	0	0
6	32408182	.	A	G	8	3	11	0	0	11	0	0
6	32408742	.	A	T	4	3	7	0	0	7	0	0
6	32409490	.	T	A	5	5	10	0	0	10	0	0
6	32409846	.	G	A	6	3	9	0	1	10	0	0
6	32409931	.	A	G	6	2	8	0	0	8	0	0
6	32410848	.	A	G	2	3	5	0	0	5	0	0
6	32411039	.	C	T	0	4	4	0	5	9	0	0
6	32411623	.	C	A	4	12	16	0	0	16	0	0
6	32482376	.	G	A	6	5	11	0	0	11	0	0
6	32483456	.	T	G	5	5	10	0	0	10	0	0
6	32483750	.	T	C	8	5	13	1	0	14	0	0
6	32487220	.	A	T	5	10	15	0	1	16	0	0
6	32497525	.	A	G	4	0	4	0	5	9	0	0
6	32497549	.	A	G	4	5	9	0	0	9	0	0
6	32502390	.	T	C	4	7	11	0	0	11	0	0
6	32504356	.	C	T	11	6	17	0	1	18	0	0
6	32506350	.	G	A	5	13	18	0	0	18	0	0
6	32506473	.	G	A	1	6	7	0	10	17	0	0
6	32507270	.	C	T	2	2	4	0	0	4	0	0
6	32699666	.	G	A	6	6	12	0	0	12	0	0
6	32699682	.	T	A	7	3	10	0	0	10	0	0
6	32699775	.	A	C	8	0	8	0	4	12	0	0
6	32699870	.	A	T	3	3	6	0	0	6	0	0
6	32700064	.	A	G	2	1	3	1	1	5	0	0
6	32700069	.	G	A	1	3	4	1	0	5	0	0
6	32700530	.	T	C	1	3	4	0	0	4	0	0
6	32700607	.	T	G	4	4	8	0	1	9	0	0
6	32702198	.	C	T	8	6	14	0	0	14	0	0
6	32722579	.	A	G	5	3	8	0	1	9	0	0
6	32722640	.	C	T	0	10	10	0	5	15	0	0
6	32722680	.	A	T	6	8	14	0	0	14	0	0
6	32744121	.	G	A	3	3	6	0	0	6	0	0
6	32773726	.	T	C	4	0	4	1	4	9	0	0
6	32830082	.	T	C	6	9	15	0	0	15	0	0
6	32830083	.	A	G	8	6	14	0	1	15	0	0
6	32831529	.	C	T	0	3	3	0	2	5	0	0
6	32831584	.	A	G	3	3	6	0	1	7	0	0
6	32831635	.	A	G	2	6	8	0	0	8	0	0
6	32831644	.	A	T	2	6	8	0	0	8	0	0
6	32832003	.	A	G	1	5	6	0	0	6	0	0
6	32832113	.	G	A	2	6	8	0	0	8	0	0
6	32832166	.	T	C	4	0	4	0	4	8	0	0
6	32832409	.	G	T	3	6	9	0	0	9	0	0
6	32832499	.	C	T	1	3	4	0	0	4	0	0
6	32832525	.	G	C	1	3	4	0	0	4	0	0
6	32832662	.	A	G	3	5	8	0	0	8	0	0
6	32832747	.	A	C	6	7	13	0	0	13	0	0
6	32883127	.	G	A	2	2	4	0	0	4	0	0
6	32960689	.	C	T	0	2	2	0	1	3	0	0
6	32966915	.	G	C	5	18	23	0	0	23	0	0
6	32967065	.	C	T	8	18	26	0	1	27	0	0
6	32967080	.	T	C	10	16	26	0	1	27	0	0
6	32967174	.	G	A	15	16	31	0	2	33	0	0
6	32967182	.	A	T	16	15	31	0	2	33	0	0
6	32967357	.	G	A	17	14	31	0	1	33	1	0
6	32970032	.	G	A	13	12	25	0	0	25	0	0
6	32970178	.	T	C	10	9	19	0	1	20	0	0
6	32976281	.	G	A	8	9	17	0	1	18	0	0
6	32979285	.	A	C	15	7	22	0	1	23	0	0
6	32999747	.	A	C	16	0	16	0	7	23	0	0
6	33023389	.	T	A	5	9	14	0	0	14	0	0
6	33023439	.	G	A	11	10	21	0	1	22	0	0
6	33023545	.	T	C	12	1	13	0	16	29	0	0
6	33023601	.	A	G	6	17	23	0	1	24	0	0
6	33023625	.	G	C	14	7	21	0	0	21	0	0
6	33083415	.	G	A	3	4	7	0	0	7	0	0
6	33085555	.	G	T	3	4	7	0	1	8	0	0
6	33085558	.	G	T	4	4	8	0	0	8	0	0
6	33085730	.	G	A	3	4	7	0	0	7	0	0
6	33086403	.	T	C	5	2	7	0	1	8	0	0
6	33089139	.	G	A	0	6	6	0	7	13	0	0
6	33089475	.	G	A	2	3	5	0	0	5	0	0
6	33091561	.	C	T	1	2	3	0	0	3	0	0
6	33091567	.	T	C	2	2	4	0	0	4	0	0
6	33092969	.	A	C	4	4	8	0	0	8	0	0
6	33094767	.	A	C	7	6	13	0	1	14	0	0
6	33095174	.	G	A	1	3	4	0	0	4	0	0
6	33095499	.	T	C	2	4	6	0	0	6	0	0
6	33549187	.	T	G	15	0	15	0	12	27	0	0
6	33550455	.	C	T	8	10	18	0	2	20	0	0
6	33550691	.	C	A	13	8	21	0	0	21	0	0
6	33550947	.	G	A	15	15	30	0	1	31	0	0
6	33552574	.	T	C	20	17	37	0	0	37	0	0
6	33552601	.	A	T	21	12	33	0	1	35	1	0
6	33552793	.	A	G	14	7	21	0	3	24	0	0
6	33553084	.	G	A	8	8	16	0	0	16	0	0
6	33554009	.	T	A	9	10	19	2	1	22	0	0
6	33554231	.	T	C	9	13	22	0	1	23	0	0
6	33554356	.	T	C	14	17	31	0	1	32	0	0
6	33554576	.	T	C	5	11	16	0	1	17	0	0
6	33554620	.	A	G	2	0	2	0	12	14	0	0
6	33554702	.	T	C	10	7	17	0	0	17	0	0
6	33554737	.	T	C	15	7	22	0	2	24	0	0
6	33554904	.	T	G	1	4	5	0	0	5	0	0
6	33555108	.	A	T	6	2	8	0	0	8	0	0
6	33555159	.	G	A	1	7	8	0	7	15	0	0
6	33555168	.	C	T	6	6	12	0	1	13	0	0
6	33555227	.	A	T	7	5	12	0	1	13	0	0
6	33555241	.	T	C	7	4	11	0	0	11	0	0
6	33555351	.	A	G	10	13	23	0	0	23	0	0
6	33555374	.	G	A	0	8	8	0	14	22	0	0
6	33555397	.	A	G	12	6	18	0	0	18	0	0
6	33555427	.	G	A	2	4	6	0	16	22	0	0
6	33555448	.	A	C	15	4	19	1	0	20	0	0
6	33555570	.	G	A	7	16	23	0	0	23	0	0
6	33555691	.	T	G	6	0	6	1	4	11	0	0
6	33555952	.	T	A	10	11	21	0	0	21	0	0
6	33556325	.	A	T	10	12	22	0	0	22	0	0
6	33556441	.	G	A	10	12	22	0	0	22	0	0
6	33556486	.	C	T	8	14	22	0	1	23	0	0
6	33556493	.	A	T	9	18	27	0	0	27	0	0
6	33556730	.	A	G	15	9	24	0	1	25	0	0
6	33556772	.	A	T	10	16	26	0	1	27	0	0
6	33556819	.	G	A	17	13	30	0	1	31	0	0
6	33556835	.	T	C	15	13	28	0	1	29	0	0
6	33556968	.	G	C	14	13	27	0	1	28	0	0
6	33557077	.	G	A	3	11	14	0	8	22	0	0
6	33557141	.	G	C	8	8	16	0	2	18	0	0
6	33557227	.	A	G	10	14	24	0	0	24	0	0
6	33557377	.	A	C	9	10	19	0	1	20	0	0
6	33557438	.	T	A	8	12	20	0	1	21	0	0
6	33557562	.	T	G	25	21	46	1	0	47	0	0
6	33558711	.	G	C	12	19	31	0	2	33	0	0
6	33558837	.	C	T	9	8	17	0	0	17	0	0
6	33663690	.	T	C	8	13	21	0	0	21	0	0
6	33663701	.	T	C	15	5	20	0	0	20	0	0
6	33663776	.	A	T	16	10	26	0	0	26	0	0
6	33663842	.	T	A	15	10	25	0	6	31	0	0
6	33664137	.	C	G	2	12	14	0	6	20	0	0
6	33664182	.	A	G	11	15	26	0	0	26	0	0
6	33664390	.	A	G	10	8	18	1	0	19	0	0
6	33664460	.	A	G	8	3	11	0	0	11	0	0
6	33664612	.	T	C	17	0	17	0	8	25	0	0
6	33664801	.	A	G	8	13	21	0	0	21	0	0
6	33664852	.	T	C	9	5	14	2	3	19	0	0
6	33664899	.	G	A	13	4	17	2	0	19	0	0
6	33664957	.	T	C	10	4	14	0	1	15	0	0
6	33665062	.	A	G	17	7	24	0	2	26	0	0
6	33665097	.	A	G	10	14	24	0	1	25	0	0
6	33665123	.	T	G	12	12	24	0	2	26	0	0
6	33665320	.	G	A	8	7	15	0	0	15	0	0
6	33665327	.	C	T	6	6	12	0	2	14	0	0
6	33665408	.	A	T	9	5	14	0	1	15	0	0
6	33665513	.	C	T	0	9	9	0	11	20	0	0
6	33665578	.	A	T	5	11	16	0	0	16	0	0
6	33665867	.	G	T	17	17	34	0	0	34	0	0
6	33666166	.	G	A	9	13	22	0	0	22	0	0
6	33666250	.	C	A	2	11	13	0	14	27	0	0
6	33666532	.	A	C	19	0	19	0	16	35	0	0
6	33666660	.	A	T	15	18	33	0	2	35	0	0
6	33666715	.	C	A	14	16	30	0	1	31	0	0
6	33666733	.	A	G	17	18	35	0	0	35	0	0
6	33666777	.	C	T	20	17	37	0	0	37	0	0
6	33666871	.	A	T	10	13	23	0	0	23	0	0
6	33666952	.	T	C	14	0	14	0	10	24	0	0
6	33666964	.	G	C	12	0	12	0	8	20	0	0
6	33667006	.	C	T	7	8	15	0	1	16	0	0
6	33667162	.	A	G	7	7	14	0	0	14	0	0
6	33667180	.	C	T	1	7	8	0	8	16	0	0
6	33667222	.	G	A	11	7	18	0	4	22	0	0
6	33667252	.	G	C	11	7	18	0	2	20	0	0
6	33667257	.	G	A	10	7	17	0	2	19	0	0
6	33667369	.	G	A	18	14	32	0	2	34	0	0
6	33667435	.	G	A	18	16	34	0	2	36	0	0
6	33667483	.	T	G	10	15	25	0	15	40	0	0
6	33667546	.	G	A	19	20	39	0	2	41	0	0
6	33668681	.	A	G	6	8	14	0	1	15	0	0
6	33669168	.	G	C	6	0	6	0	8	14	0	0
6	33669460	.	A	C	7	6	13	0	1	14	0	0
6	33671910	.	C	T	9	5	14	0	1	15	0	0
6	33672116	.	C	A	5	6	11	0	1	12	0	0
6	33672134	.	A	G	5	7	12	0	1	13	0	0
6	33683816	.	A	G	6	7	13	0	0	13	0	0
6	33683837	.	G	A	4	10	14	0	1	15	0	0
6	33683882	.	A	G	5	8	13	0	0	13	0	0
6	33683885	.	T	A	5	6	11	0	1	12	0	0
6	33694269	.	G	A	13	4	17	0	0	17	0	0
6	33883580	.	C	T	13	8	21	0	0	21	0	0
6	33883916	.	T	A	19	15	34	0	1	35	0	0
6	33884447	.	G	A	2	19	21	0	20	41	0	0
6	33896399	.	T	A	25	21	46	0	1	47	0	0
6	33896406	.	T	G	26	1	27	0	19	46	0	0
6	33896476	.	T	C	17	23	40	0	1	41	0	0
6	33896508	.	A	T	19	22	41	1	1	43	0	0
6	33896620	.	C	T	17	19	36	0	2	38	0	0
6	33896858	.	T	C	19	20	39	0	1	40	0	0
6	33896975	.	A	C	18	15	33	0	0	33	0	0
6	33897193	.	T	A	12	6	18	0	0	18	0	0
6	33897472	.	T	A	13	9	22	0	0	22	0	0
6	33897766	.	A	T	5	10	15	0	0	15	0	0
6	33905876	.	G	A	2	2	4	0	0	4	0	0
6	33910226	.	G	T	0	2	2	0	1	3	0	0
6	33912240	.	G	A	7	7	14	0	2	16	0	0
6	33918916	.	A	G	2	5	7	0	0	7	0	0
6	33921298	.	C	T	7	3	10	0	1	11	0	0
6	33921304	.	T	C	9	4	13	0	0	13	0	0
6	33921511	.	G	A	6	12	18	0	1	19	0	0
6	33921559	.	G	A	5	10	15	0	0	15	0	0
6	33921631	.	A	G	5	5	10	0	0	10	0	0
6	33923900	.	C	T	3	7	10	0	0	10	0	0
6	33925345	.	G	A	8	4	12	1	0	13	0	0
6	33927040	.	A	T	5	9	14	0	1	15	0	0
6	33929724	.	G	C	5	9	14	0	2	16	0	0
6	33931582	.	T	C	12	11	23	0	2	25	0	0
6	33983610	.	C	A	2	2	4	0	0	4	0	0
6	33984216	.	T	A	4	4	8	0	0	8	0	0
6	34045412	.	A	T	1	3	4	0	0	4	0	0
6	34710598	.	C	T	4	3	7	0	0	7	0	0
6	34767055	.	T	A	2	2	4	2	0	6	0	0
6	34767154	.	T	C	6	3	9	0	1	10	0	0
6	34767157	.	T	A	6	4	10	0	0	10	0	0
6	34767193	.	T	C	4	4	8	0	0	8	0	0
6	34767202	.	C	T	3	4	7	0	0	7	0	0
6	34772224	.	T	C	2	2	4	0	1	5	0	0
6	34787495	.	C	G	8	0	8	0	13	21	0	0
6	34787632	.	C	T	5	8	13	0	1	14	0	0
6	34805923	.	C	T	2	9	11	0	0	11	0	0
6	34806257	.	G	A	10	5	15	0	1	16	0	0
6	34806450	.	G	T	5	10	15	0	0	15	0	0
6	34806494	.	C	T	7	4	11	0	1	12	0	0
6	34806636	.	A	T	0	11	11	0	1	12	0	0
6	34806893	.	A	T	7	6	13	0	2	15	0	0
6	34807576	.	T	C	3	5	8	0	1	9	0	0
6	34807809	.	G	A	7	5	12	0	0	12	0	0
6	34807862	.	T	C	5	3	8	0	1	9	0	0
6	34808517	.	A	G	4	13	17	0	0	17	0	0
6	34808591	.	G	A	11	9	20	0	0	20	0	0
6	34808754	.	C	T	10	13	23	0	0	23	0	0
6	34808821	.	G	A	4	10	14	0	0	14	0	0
6	34808835	.	C	A	13	3	16	0	0	16	0	0
6	34808914	.	C	T	6	9	15	0	1	16	0	0
6	34809040	.	G	A	10	7	17	0	0	17	0	0
6	34809564	.	A	T	9	4	13	0	0	13	0	0
6	34809826	.	C	A	11	11	22	0	0	22	0	0
6	34809850	.	G	T	6	14	20	0	0	20	0	0
6	34810313	.	C	T	18	14	32	0	1	33	0	0
6	34810415	.	A	G	17	0	17	0	8	25	0	0
6	34810490	.	G	A	1	6	7	0	11	18	0	0
6	34810495	.	G	A	1	8	9	0	6	15	0	0
6	34810890	.	T	C	10	8	18	0	0	18	0	0
6	34810908	.	T	C	6	12	18	0	1	19	0	0
6	34811130	.	A	T	6	4	10	0	0	10	0	0
6	34811150	.	A	C	5	8	13	0	0	13	0	0
6	34825910	.	A	C	2	5	7	0	0	7	0	0
6	34826002	.	T	C	3	3	6	0	0	6	0	0
6	34826051	.	T	C	3	2	5	0	0	5	0	0
6	34826598	.	G	A	6	4	10	3	1	14	0	0
6	34826711	.	A	T	1	3	4	0	0	4	0	0
6	34826736	.	A	T	1	4	5	0	0	5	0	0
6	34828893	.	A	T	12	7	19	0	0	19	0	0
6	34847761	.	T	A	3	3	6	0	0	6	0	0
6	34848434	.	T	C	2	1	3	0	4	7	0	0
6	34848447	.	C	A	3	4	7	0	0	7	0	0
6	34851921	.	G	A	3	3	6	0	0	6	0	0
6	34931646	.	G	A	18	11	29	0	1	30	0	0
6	34931911	.	C	T	27	28	55	0	1	57	1	0
6	34931912	.	C	T	27	26	53	0	3	56	0	0
6	34932657	.	G	A	30	26	56	0	2	58	0	0
6	34932927	.	A	T	24	31	55	0	2	57	0	0
6	34934870	.	C	T	3	16	19	0	43	62	0	0
6	34943550	.	A	G	1	3	4	0	0	4	0	0
6	34943683	.	A	T	5	3	8	0	0	8	0	0
6	34943714	.	G	A	6	4	10	0	0	10	0	0
6	34943938	.	T	C	2	2	4	0	1	5	0	0
6	34944056	.	T	C	3	3	6	0	0	6	0	0
6	34947195	.	T	A	7	7	14	0	0	14	0	0
6	34961041	.	C	T	0	2	2	0	1	3	0	0
6	34961611	.	A	G	2	2	4	0	0	4	0	0
6	35036275	.	A	C	1	2	3	0	0	3	0	0
6	35036520	.	A	G	3	6	9	0	0	9	0	0
6	35036755	.	T	A	7	3	10	0	0	10	0	0
6	35046852	.	T	C	6	3	9	0	0	9	0	0
6	35047157	.	G	A	5	5	10	0	0	10	0	0
6	35054984	.	T	G	5	5	10	0	1	11	0	0
6	35056497	.	A	G	1	2	3	0	0	3	0	0
6	35058696	.	A	G	7	7	14	0	0	14	0	0
6	35058850	.	A	G	3	10	13	1	1	15	0	0
6	35060985	.	C	A	3	3	6	0	1	7	0	0
6	35061226	.	C	T	3	8	11	1	0	12	0	0
6	35100461	.	T	A	1	5	6	0	0	6	0	0
6	35100484	.	C	T	0	5	5	0	1	6	0	0
6	35101641	.	A	T	1	4	5	0	0	5	0	0
6	35101645	.	T	C	1	4	5	0	0	5	0	0
6	35102305	.	T	A	4	2	6	0	0	6	0	0
6	35106614	.	G	T	2	2	4	0	0	4	0	0
6	35365098	.	A	T	4	7	11	0	2	13	0	0
6	35365179	.	T	C	3	7	10	0	0	10	0	0
6	35365185	.	T	A	3	7	10	0	0	10	0	0
6	35365422	.	T	A	4	3	7	0	0	7	0	0
6	35365441	.	C	A	4	3	7	0	0	7	0	0
6	35365462	.	T	A	6	2	8	0	1	9	0	0
6	35365649	.	G	T	2	4	6	0	0	6	0	0
6	35365714	.	T	C	3	3	6	0	0	6	0	0
6	35365730	.	C	T	3	3	6	0	1	7	0	0
6	35365768	.	C	T	5	3	8	0	0	8	0	0
6	35365785	.	C	G	5	2	7	0	0	7	0	0
6	35365872	.	C	T	12	11	23	0	0	23	0	0
6	35365877	.	C	T	13	10	23	0	0	23	0	0
6	35366253	.	C	T	3	2	5	0	0	5	0	0
6	35388025	.	G	C	5	0	5	0	6	11	0	0
6	35388874	.	C	T	1	5	6	1	4	11	0	0
6	35388971	.	G	A	4	4	8	0	0	8	0	0
6	35388989	.	T	C	4	4	8	0	1	9	0	0
6	35389007	.	T	G	6	5	11	0	0	11	0	0
6	35389181	.	C	A	7	2	9	0	0	9	0	0
6	35389254	.	T	C	3	4	7	0	0	7	0	0
6	35389493	.	C	T	5	4	9	0	0	9	0	0
6	35389773	.	G	A	7	4	11	0	0	11	0	0
6	35389826	.	A	G	7	6	13	0	0	13	0	0
6	35389915	.	C	T	0	3	3	0	10	13	0	0
6	35392431	.	G	C	2	6	8	0	0	8	0	0
6	35401154	.	C	T	2	2	4	0	0	4	0	0
6	35443604	.	T	G	5	2	7	0	0	7	0	0
6	35443636	.	A	T	9	4	13	0	0	13	0	0
6	35443819	.	G	T	19	3	22	0	0	22	0	0
6	35443822	.	C	T	18	7	25	0	0	25	0	0
6	35443951	.	T	C	24	21	45	0	2	47	0	0
6	35443960	.	C	T	1	20	21	0	25	47	1	0
6	35444467	.	G	A	24	27	51	0	2	53	0	0
6	35461688	.	T	C	4	7	11	0	1	12	0	0
6	35461812	.	A	T	1	2	3	0	0	3	0	0
6	35461859	.	A	G	1	2	3	0	0	3	0	0
6	35462087	.	G	A	16	13	29	0	0	29	0	0
6	35462088	.	A	G	17	13	30	0	0	30	0	0
6	35462134	.	G	A	17	11	28	4	2	34	0	0
6	35462186	.	A	G	16	16	32	0	0	32	0	0
6	35462470	.	G	A	27	12	39	0	0	39	0	0
6	35472834	.	C	T	17	18	35	0	0	35	0	0
6	35472858	.	G	T	19	17	36	0	3	39	0	0
6	35676724	.	C	T	10	6	16	2	0	18	0	0
6	35676784	.	A	G	13	8	21	2	1	24	0	0
6	35677534	.	T	A	11	6	17	0	2	19	0	0
6	35688251	.	T	C	10	1	11	0	5	16	0	0
6	35713078	.	T	A	6	4	10	0	0	10	0	0
6	35718058	.	T	C	8	13	21	0	1	22	0	0
6	35738430	.	C	A	0	6	6	0	6	12	0	0
6	36128976	.	C	T	4	2	6	0	0	6	0	0
6	36129135	.	T	A	2	2	4	0	0	4	0	0
6	36129164	.	T	C	1	3	4	0	0	4	0	0
6	36129565	.	C	T	0	10	10	0	6	16	0	0
6	36129580	.	G	A	6	9	15	0	2	17	0	0
6	36129601	.	G	A	7	10	17	0	1	18	0	0
6	36129779	.	C	T	3	3	6	0	0	6	0	0
6	36130245	.	G	A	7	4	11	0	0	11	0	0
6	36130501	.	A	G	2	2	4	0	0	4	0	0
6	36131055	.	A	G	2	7	9	0	1	10	0	0
6	36131097	.	A	C	2	0	2	0	8	10	0	0
6	36131376	.	A	G	7	8	15	0	1	17	1	0
6	36131538	.	C	T	0	12	12	0	13	25	0	0
6	36131876	.	G	A	5	8	13	0	0	13	0	0
6	36131937	.	G	A	6	5	11	0	1	12	0	0
6	36136977	.	A	G	7	10	17	0	0	17	0	0
6	36157011	.	T	C	6	0	6	0	5	11	0	0
6	36178531	.	A	G	5	2	7	0	0	7	0	0
6	36197454	.	G	A	2	3	5	0	1	6	0	0
6	36462395	.	G	C	1	3	4	0	1	5	0	0
6	36463161	.	A	G	1	2	3	0	0	3	0	0
6	36463162	.	C	A	1	2	3	0	0	3	0	0
6	36552508	.	A	G	10	8	18	0	0	18	0	0
6	36720006	.	G	A	2	3	5	0	2	7	0	0
6	36720457	.	C	T	11	8	19	0	0	19	0	0
6	36720558	.	G	A	6	2	8	0	0	8	0	0
6	36720936	.	C	T	7	7	14	0	1	15	0	0
6	36721061	.	T	A	20	14	34	0	1	35	0	0
6	36721066	.	G	T	22	15	37	0	2	39	0	0
6	36721125	.	A	T	20	20	40	0	0	40	0	0
6	36721159	.	A	T	23	17	40	0	0	40	0	0
6	36721339	.	G	T	26	26	52	0	4	56	0	0
6	36721366	.	G	A	24	26	50	0	2	52	0	0
6	36721380	.	C	G	29	20	49	0	0	49	0	0
6	36724345	.	A	G	15	23	38	0	3	41	0	0
6	36724375	.	G	A	26	12	38	1	1	40	0	0
6	36876939	.	A	G	4	3	7	0	0	7	0	0
6	36877313	.	A	G	4	0	4	0	4	8	0	0
6	36877365	.	A	G	2	2	4	0	1	5	0	0
6	37163932	.	T	C	27	21	48	0	0	48	0	0
6	37163943	.	C	T	26	18	44	0	0	44	0	0
6	37164060	.	T	C	21	18	39	0	3	42	0	0
6	37164173	.	T	G	17	14	31	0	2	33	0	0
6	37301438	.	G	T	17	12	29	0	0	29	0	0
6	37301458	.	A	G	21	7	28	0	0	28	0	0
6	37301479	.	A	T	26	9	35	0	1	36	0	0
6	37305142	.	A	C	14	18	32	0	0	32	0	0
6	37305368	.	A	G	4	0	4	0	4	8	0	0
6	37305383	.	A	G	6	5	11	0	0	11	0	0
6	37305532	.	G	T	6	8	14	0	0	14	0	0
6	37305539	.	G	T	5	8	13	0	0	13	0	0
6	37306620	.	A	T	20	15	35	1	0	37	1	0
6	37306827	.	C	T	13	9	22	0	0	22	0	0
6	37307034	.	C	T	2	5	7	0	3	10	0	0
6	37310902	.	A	G	2	0	2	0	2	4	0	0
6	37409738	.	C	T	12	11	23	0	1	24	0	0
6	37409986	.	C	T	5	4	9	0	0	9	0	0
6	37410029	.	A	G	9	4	13	0	1	14	0	0
6	37410047	.	C	T	11	7	18	0	1	19	0	0
6	37410119	.	C	T	8	12	20	0	0	20	0	0
6	37417345	.	T	A	9	4	13	0	1	14	0	0
6	37419449	.	G	A	11	5	16	0	1	17	0	0
6	37419479	.	G	A	9	7	16	0	0	16	0	0
6	37419491	.	A	T	7	7	14	0	0	14	0	0
6	37420172	.	A	C	4	2	6	0	1	7	0	0
6	37421038	.	C	A	0	2	2	0	5	7	0	0
6	37422787	.	A	G	6	7	13	0	0	13	0	0
6	37431476	.	T	G	1	5	6	0	1	7	0	0
6	37431532	.	G	C	4	4	8	0	1	9	0	0
6	37431592	.	C	T	4	4	8	0	0	8	0	0
6	37431649	.	T	C	5	8	13	0	2	15	0	0
6	37440068	.	G	A	1	3	4	0	0	4	0	0
6	37440302	.	A	G	4	7	11	0	0	11	0	0
6	37440515	.	G	T	6	10	16	0	0	16	0	0
6	37440547	.	T	A	5	10	15	0	0	15	0	0
6	37441474	.	T	C	7	7	14	0	1	15	0	0
6	37441492	.	G	A	5	4	9	0	0	9	0	0
6	37442218	.	A	C	5	2	7	0	0	7	0	0
6	37442276	.	A	G	6	4	10	0	0	10	0	0
6	37442314	.	A	T	2	7	9	0	0	9	0	0
6	37442821	.	G	A	1	3	4	0	0	4	0	0
6	37443530	.	G	A	4	2	6	0	1	7	0	0
6	37443945	.	T	C	1	5	6	0	0	6	0	0
6	37445357	.	T	C	4	6	10	0	0	10	0	0
6	37459781	.	A	C	1	2	3	0	0	3	0	0
6	37461661	.	G	A	6	3	9	0	0	9	0	0
6	37461662	.	T	A	6	3	9	0	0	9	0	0
6	37465953	.	C	T	1	5	6	0	1	7	0	0
6	37469571	.	C	A	1	5	6	0	1	7	0	0
6	37469637	.	C	A	3	4	7	0	0	7	0	0
6	37478859	.	G	A	2	7	9	0	1	10	0	0
6	37478878	.	G	A	3	5	8	0	0	8	0	0
6	37478905	.	G	A	2	4	6	0	0	6	0	0
6	37479506	.	G	A	10	4	14	0	0	14	0	0
6	37479563	.	C	G	5	5	10	0	1	11	0	0
6	37479578	.	G	A	4	5	9	0	2	11	0	0
6	37479779	.	A	C	8	7	15	0	2	17	0	0
6	37479785	.	A	C	7	9	16	0	1	17	0	0
6	37479910	.	T	G	8	7	15	0	0	15	0	0
6	37479932	.	G	A	6	9	15	0	1	16	0	0
6	37479998	.	A	G	2	8	10	0	0	10	0	0
6	37480028	.	A	G	3	7	10	0	2	12	0	0
6	37480100	.	T	A	3	7	10	0	1	11	0	0
6	37485828	.	G	A	2	5	7	0	0	7	0	0
6	37498477	.	A	G	2	2	4	0	0	4	0	0
6	37499562	.	A	C	1	2	3	0	0	3	0	0
6	37515270	.	A	G	2	3	5	0	0	5	0	0
6	37515300	.	C	T	6	6	12	0	0	12	0	0
6	37515353	.	T	A	6	7	13	0	0	13	0	0
6	37521529	.	A	T	6	8	14	0	0	14	0	0
6	37521594	.	C	A	6	8	14	0	1	15	0	0
6	37521778	.	G	A	7	2	9	0	0	9	0	0
6	37529504	.	C	A	28	17	45	0	1	46	0	0
6	37548605	.	T	C	10	15	25	0	2	27	0	0
6	37548897	.	C	T	16	14	30	0	0	31	1	0
6	37551165	.	G	A	1	18	19	0	15	34	0	0
6	37551548	.	T	C	18	14	32	0	0	32	0	0
6	37552621	.	C	T	21	19	40	0	1	41	0	0
6	37554293	.	C	T	24	11	35	0	1	36	0	0
6	37598966	.	C	T	11	21	32	0	1	33	0	0
6	37599293	.	C	T	9	13	22	0	0	22	0	0
6	37599406	.	G	A	19	13	32	0	1	33	0	0
6	37599499	.	G	T	11	17	28	0	0	29	1	0
6	37599687	.	A	T	19	12	31	1	2	34	0	0
6	37599937	.	T	G	21	11	32	0	0	32	0	0
6	37599954	.	C	T	16	12	28	0	1	29	0	0
6	37600173	.	A	G	18	0	18	0	16	34	0	0
6	37600210	.	G	A	4	20	24	1	19	44	0	0
6	37600233	.	G	A	20	23	43	1	2	46	0	0
6	37604105	.	T	C	1	0	1	0	4	5	0	0
6	37604410	.	T	A	6	12	18	0	0	18	0	0
6	37604547	.	A	G	6	2	8	0	0	8	0	0
6	37604724	.	G	A	9	7	16	0	0	16	0	0
6	37604866	.	A	C	7	10	17	0	2	19	0	0
6	37621150	.	T	C	5	3	8	0	0	8	0	0
6	37621204	.	A	G	5	3	8	0	0	8	0	0
6	37621213	.	A	G	5	2	7	0	0	7	0	0
6	37621918	.	A	G	10	5	15	0	1	16	0	0
6	37622089	.	C	T	1	4	5	0	10	15	0	0
6	37623826	.	A	G	5	5	10	0	1	11	0	0
6	37623836	.	A	T	5	7	12	0	0	12	0	0
6	37626084	.	T	A	6	5	11	0	1	12	0	0
6	37627004	.	A	G	8	9	17	0	1	18	0	0
6	37627114	.	G	A	11	5	16	0	0	16	0	0
6	37627141	.	C	A	9	6	15	0	0	15	0	0
6	37628973	.	G	A	6	10	16	0	1	17	0	0
6	37628991	.	C	T	7	7	14	0	1	15	0	0
6	37629402	.	A	G	7	0	7	0	12	19	0	0
6	37631456	.	A	G	4	9	13	0	0	13	0	0
6	37632921	.	G	A	5	8	13	0	1	14	0	0
6	37632963	.	A	G	4	0	4	0	9	13	0	0
6	37632966	.	C	T	3	9	12	0	1	13	0	0
6	37633005	.	C	A	6	7	13	0	0	13	0	0
6	37633549	.	G	A	3	5	8	0	9	17	0	0
6	37635589	.	G	A	4	8	12	0	1	13	0	0
6	37635595	.	C	A	5	8	13	0	0	13	0	0
6	37635649	.	T	C	3	4	7	0	0	7	0	0
6	37637987	.	G	A	5	6	11	0	1	12	0	0
6	37648171	.	C	G	8	4	12	0	0	12	0	0
6	37651619	.	T	C	13	10	23	0	0	23	0	0
6	37728484	.	T	C	3	2	5	0	0	6	1	0
6	37728496	.	T	C	5	3	8	0	0	8	0	0
6	37729880	.	T	C	2	5	7	0	0	7	0	0
6	37730423	.	G	T	5	3	8	0	1	9	0	0
6	37730520	.	C	T	3	3	6	1	0	8	1	0
6	37730527	.	C	T	3	2	5	1	0	6	0	0
6	37737188	.	C	A	6	6	12	0	1	13	0	0
6	37743319	.	A	C	4	0	4	0	7	11	0	0
6	37743373	.	C	G	3	6	9	0	0	9	0	0
6	37743456	.	T	C	2	0	2	0	5	7	0	0
6	37744304	.	C	A	7	7	14	0	0	14	0	0
6	37746085	.	C	T	1	4	5	0	0	5	0	0
6	37746099	.	G	A	1	3	4	0	0	4	0	0
6	37752838	.	A	G	4	4	8	0	0	8	0	0
6	37754825	.	C	T	4	6	10	0	0	10	0	0
6	37771609	.	T	C	3	5	8	0	0	8	0	0
6	37772316	.	T	C	3	7	10	0	0	10	0	0
6	37772400	.	C	T	3	6	9	0	0	9	0	0
6	37772406	.	A	G	6	3	9	0	0	9	0	0
6	37775562	.	G	A	1	4	5	0	5	10	0	0
6	37786017	.	T	C	3	2	5	0	0	5	0	0
6	37787764	.	C	T	1	6	7	0	0	7	0	0
6	37794637	.	C	A	5	7	12	0	0	12	0	0
6	37796222	.	G	C	6	7	13	0	0	13	0	0
6	37797710	.	G	A	5	3	8	0	2	10	0	0
6	37800824	.	G	A	1	5	6	0	6	12	0	0
6	37801954	.	A	G	2	1	3	0	7	10	0	0
6	37808238	.	G	A	0	4	4	0	11	15	0	0
6	37808262	.	G	C	0	7	7	0	10	17	0	0
6	37808349	.	G	A	6	5	11	0	0	11	0	0
6	37809918	.	C	T	4	6	10	0	1	11	0	0
6	37810029	.	T	C	12	6	18	0	0	18	0	0
6	37810256	.	C	T	4	5	9	0	0	9	0	0
6	37812199	.	A	G	9	6	15	0	0	15	0	0
6	37812271	.	G	A	0	5	5	0	3	8	0	0
6	37815348	.	C	G	9	7	16	0	1	17	0	0
6	37815525	.	T	C	11	7	18	0	1	19	0	0
6	37815621	.	T	G	14	7	21	0	0	21	0	0
6	37818324	.	A	C	7	9	16	0	2	18	0	0
6	37818327	.	G	A	8	9	17	0	0	18	1	0
6	37820306	.	C	T	14	11	25	0	0	25	0	0
6	37820960	.	T	C	8	8	16	0	1	17	0	0
6	37821169	.	G	T	1	7	8	0	2	10	0	0
6	37824355	.	G	T	9	14	23	0	0	23	0	0
6	37824645	.	T	C	7	12	19	0	1	20	0	0
6	37825508	.	T	G	7	0	7	0	17	24	0	0
6	37829585	.	G	A	12	12	24	0	1	25	0	0
6	37829613	.	T	C	13	13	26	0	3	29	0	0
6	37830742	.	A	T	13	13	26	0	0	26	0	0
6	37830784	.	C	T	16	12	28	0	3	32	1	0
6	37830811	.	C	T	16	13	29	0	2	31	0	0
6	37832947	.	C	T	22	13	35	0	1	36	0	0
6	37832953	.	G	A	22	14	36	0	2	38	0	0
6	37833493	.	T	C	18	10	28	0	2	30	0	0
6	37835767	.	T	C	14	14	28	0	1	29	0	0
6	37835797	.	C	T	12	17	29	0	1	30	0	0
6	37836387	.	G	A	17	13	30	0	2	32	0	0
6	37841100	.	C	T	10	8	18	0	0	18	0	0
6	37846026	.	C	T	25	15	40	0	0	40	0	0
6	38367062	.	G	C	27	0	27	0	15	42	0	0
6	38367107	.	T	C	14	20	34	0	2	36	0	0
6	38375020	.	G	A	26	16	42	0	1	43	0	0
6	38381094	.	G	A	18	11	29	0	0	29	0	0
6	38415315	.	G	A	15	14	29	0	1	30	0	0
6	38415385	.	A	G	11	20	31	0	1	32	0	0
6	38427427	.	G	A	8	7	15	0	1	16	0	0
6	38427515	.	A	T	12	6	18	0	0	18	0	0
6	38477019	.	G	T	18	8	26	0	1	27	0	0
6	38503673	.	C	T	16	13	29	0	1	30	0	0
6	38511604	.	G	A	23	12	35	0	1	36	0	0
6	38511739	.	C	T	15	16	31	0	0	31	0	0
6	38511921	.	T	C	12	10	22	0	1	23	0	0
6	38511967	.	A	T	17	12	29	0	0	29	0	0
6	38512160	.	T	C	15	12	27	0	1	28	0	0
6	38512178	.	G	A	17	15	32	0	0	32	0	0
6	38512236	.	C	T	16	14	30	0	0	30	0	0
6	38512629	.	C	T	17	21	38	0	0	38	0	0
6	38513231	.	C	T	18	11	29	0	0	29	0	0
6	38778327	.	T	C	6	2	8	0	2	10	0	0
6	38782025	.	C	T	10	10	20	0	0	20	0	0
6	38782439	.	C	A	2	8	10	0	2	12	0	0
6	38782442	.	C	T	4	8	12	0	0	12	0	0
6	38782511	.	A	G	4	11	15	0	0	15	0	0
6	38782712	.	T	C	9	12	21	0	0	21	0	0
6	38782794	.	C	T	10	12	22	0	1	23	0	0
6	38782799	.	T	A	10	13	23	0	1	24	0	0
6	38783002	.	T	A	8	7	15	0	2	17	0	0
6	38783044	.	T	A	8	3	11	0	0	11	0	0
6	38786301	.	G	A	1	8	9	0	7	16	0	0
6	38786622	.	C	A	10	12	22	0	2	24	0	0
6	38789065	.	C	A	12	10	22	0	1	23	0	0
6	38789292	.	C	T	7	12	19	0	1	20	0	0
6	38789317	.	C	T	11	8	19	0	2	21	0	0
6	38789507	.	A	T	10	8	18	0	2	20	0	0
6	38789583	.	G	C	11	12	23	0	1	24	0	0
6	38789733	.	A	G	8	10	18	0	4	22	0	0
6	38789832	.	A	G	12	14	26	0	0	26	0	0
6	38789853	.	T	A	12	16	28	0	0	28	0	0
6	38789899	.	G	T	7	8	15	1	5	21	0	0
6	38789903	.	A	T	7	7	14	1	6	21	0	0
6	38845797	.	G	A	7	8	15	0	0	15	0	0
6	38845817	.	T	C	8	5	13	0	0	13	0	0
6	38845865	.	G	A	9	9	18	0	1	19	0	0
6	38845943	.	C	G	8	8	16	0	1	17	0	0
6	38845964	.	A	G	5	6	11	0	1	12	0	0
6	38845986	.	A	G	6	1	7	0	6	13	0	0
6	38846240	.	A	G	5	5	10	0	0	10	0	0
6	38858036	.	G	T	2	5	7	0	13	20	0	0
6	38858558	.	T	A	5	4	9	0	0	9	0	0
6	38858784	.	T	G	12	10	22	0	0	22	0	0
6	38858832	.	T	G	9	9	18	0	0	18	0	0
6	38858902	.	T	A	4	3	7	0	1	8	0	0
6	38859796	.	T	A	5	3	8	0	0	8	0	0
6	38860293	.	C	G	6	4	10	0	5	15	0	0
6	38860362	.	T	A	9	7	16	0	0	16	0	0
6	38860421	.	C	T	5	5	10	0	0	10	0	0
6	38860815	.	A	G	2	14	16	0	0	16	0	0
6	38860823	.	C	T	2	14	16	0	1	17	0	0
6	38860898	.	T	C	4	19	23	0	0	23	0	0
6	38860905	.	C	T	5	19	24	0	0	24	0	0
6	38860981	.	T	C	8	3	11	0	0	11	0	0
6	38860985	.	T	G	9	3	12	0	0	12	0	0
6	38861020	.	G	A	9	3	12	0	0	12	0	0
6	38861035	.	C	A	8	5	13	0	1	14	0	0
6	38896523	.	T	C	17	8	25	0	0	25	0	0
6	38899123	.	T	C	6	8	14	0	3	17	0	0
6	38901991	.	T	C	10	8	18	0	2	20	0	0
6	38902291	.	T	A	4	8	12	0	0	12	0	0
6	39014527	.	T	A	1	2	3	0	0	3	0	0
6	39014616	.	T	C	2	0	2	0	2	4	0	0
6	39068424	.	A	G	15	18	33	0	2	35	0	0
6	39075254	.	A	C	21	13	34	0	1	35	0	0
6	39075513	.	G	A	12	18	30	0	2	32	0	0
6	39077308	.	G	C	10	23	33	0	2	35	0	0
6	39077364	.	C	T	8	8	16	0	0	16	0	0
6	39123712	.	A	T	1	4	5	0	0	5	0	0
6	39123923	.	C	A	1	5	6	0	0	6	0	0
6	39124288	.	C	A	6	7	13	0	0	13	0	0
6	39124304	.	A	C	6	5	11	0	0	11	0	0
6	39124389	.	G	A	1	5	6	0	0	6	0	0
6	39124688	.	C	T	1	3	4	0	4	8	0	0
6	39124784	.	T	A	4	2	6	0	1	7	0	0
6	39124789	.	C	A	5	3	8	0	0	8	0	0
6	39125296	.	C	T	5	3	8	0	0	8	0	0
6	39125390	.	T	A	2	3	5	0	0	5	0	0
6	39125392	.	C	A	2	3	5	0	0	5	0	0
6	39125609	.	A	C	2	5	7	0	0	7	0	0
6	39125626	.	G	A	2	2	4	0	1	5	0	0
6	39125653	.	G	A	1	4	5	0	0	5	0	0
6	39125746	.	A	C	1	3	4	0	0	4	0	0
6	39126503	.	G	A	3	4	7	0	0	7	0	0
6	39126533	.	C	T	0	4	4	0	5	9	0	0
6	39126884	.	C	T	2	9	11	0	0	11	0	0
6	39127005	.	A	T	9	5	14	0	0	14	0	0
6	39127012	.	A	T	10	5	15	0	0	15	0	0
6	39127231	.	G	C	3	3	6	0	0	6	0	0
6	39136487	.	A	G	5	6	11	0	0	11	0	0
6	39141303	.	C	T	7	4	11	0	0	11	0	0
6	39151644	.	A	G	2	4	6	0	0	6	0	0
6	39160327	.	C	T	2	2	4	0	1	5	0	0
6	39160328	.	A	G	2	3	5	0	0	5	0	0
6	39162488	.	C	A	1	3	4	0	1	5	0	0
6	39162491	.	C	G	2	2	4	0	0	4	0	0
6	39162607	.	C	T	9	6	15	0	0	15	0	0
6	39162718	.	A	T	3	6	9	0	0	9	0	0
6	39162756	.	T	A	4	7	11	0	1	12	0	0
6	39162855	.	C	T	6	5	11	0	0	11	0	0
6	39162896	.	G	A	6	7	13	0	1	14	0	0
6	39163058	.	T	A	3	8	11	2	0	13	0	0
6	39163286	.	G	A	6	7	13	0	0	13	0	0
6	39163363	.	A	T	5	7	12	0	1	13	0	0
6	39163690	.	T	C	6	0	6	0	7	13	0	0
6	39163876	.	A	G	4	7	11	0	0	11	0	0
6	39164046	.	T	G	6	5	11	0	0	11	0	0
6	39208979	.	C	T	11	4	15	0	0	15	0	0
6	39364559	.	A	G	1	2	3	0	0	3	0	0
6	39994107	.	A	T	1	9	10	3	0	13	0	0
6	41435866	.	A	G	34	20	54	0	1	55	0	0
6	41460563	.	A	T	1	7	8	0	0	9	1	0
6	41460565	.	T	A	8	4	12	0	0	12	0	0
6	42915581	.	C	T	5	2	7	0	0	7	0	0
6	42934096	.	G	A	1	7	8	0	0	8	0	0
6	44007258	.	G	A	15	4	19	0	0	19	0	0
6	45375002	.	A	G	3	3	6	0	1	7	0	0
6	48163738	.	G	T	4	8	12	0	0	12	0	0
6	48172890	.	C	T	11	10	21	0	1	22	0	0
6	48181994	.	A	C	12	11	23	0	2	25	0	0
6	48182033	.	A	G	9	1	10	1	15	26	0	0
6	48182090	.	T	A	8	11	19	1	0	20	0	0
6	48182720	.	A	G	8	0	8	0	6	14	0	0
6	48193191	.	T	C	2	15	17	0	0	17	0	0
6	48193426	.	T	C	5	6	11	0	0	11	0	0
6	48195610	.	G	C	7	7	14	0	0	14	0	0
6	48198255	.	T	A	12	11	23	0	0	23	0	0
6	48198431	.	T	C	16	16	32	0	0	32	0	0
6	48198533	.	C	G	11	5	16	0	0	16	0	0
6	48198718	.	C	A	7	3	10	0	0	11	1	0
6	48198883	.	G	A	4	9	13	0	0	13	0	0
6	48198892	.	A	T	6	9	15	0	0	15	0	0
6	48199068	.	G	A	10	4	14	0	1	15	0	0
6	48241389	.	C	T	1	2	3	0	0	3	0	0
6	48294637	.	A	G	10	7	17	0	1	18	0	0
6	48312582	.	A	G	5	8	13	0	0	13	0	0
6	48323184	.	A	C	4	3	7	0	0	7	0	0
6	48323373	.	A	T	14	13	27	0	0	27	0	0
6	48323476	.	A	G	8	4	12	0	8	20	0	0
6	48325997	.	C	G	15	19	34	0	2	36	0	0
6	48333375	.	C	T	0	11	11	0	7	18	0	0
6	48333480	.	C	T	2	13	15	1	8	24	0	0
6	48333483	.	C	T	8	11	19	1	2	22	0	0
6	48352739	.	C	T	1	2	3	0	0	3	0	0
6	48360491	.	C	T	3	3	6	0	0	6	0	0
6	48360849	.	A	G	2	1	3	0	2	5	0	0
6	48366555	.	T	C	5	5	10	0	0	10	0	0
6	48366570	.	A	C	5	5	10	0	0	10	0	0
6	48368655	.	T	C	4	3	7	0	2	9	0	0
6	48369018	.	G	C	4	2	6	0	0	6	0	0
6	48369069	.	A	T	4	3	7	0	0	7	0	0
6	48370800	.	T	C	4	2	6	0	0	6	0	0
6	48375954	.	T	G	4	5	9	0	0	9	0	0
6	48376139	.	G	A	0	2	2	0	1	3	0	0
6	48380626	.	T	A	1	1	2	0	0	2	0	0
6	48380631	.	T	C	1	2	3	0	0	3	0	0
6	48380884	.	C	A	2	4	6	0	0	6	0	0
6	48381090	.	T	C	4	0	4	0	3	7	0	0
6	48381104	.	G	T	3	4	7	0	0	7	0	0
6	48382970	.	A	C	2	3	5	0	0	5	0	0
6	48383002	.	G	A	6	3	9	0	1	10	0	0
6	48383068	.	T	C	4	5	9	0	0	9	0	0
6	48383105	.	G	C	7	6	13	1	0	14	0	0
6	48383142	.	C	A	7	4	11	1	1	13	0	0
6	48383149	.	A	T	7	3	10	1	1	12	0	0
6	48383239	.	G	A	5	3	8	0	3	11	0	0
6	48383291	.	T	C	6	4	10	0	0	10	0	0
6	48383353	.	A	G	5	7	12	0	0	12	0	0
6	48383371	.	A	C	4	5	9	0	0	9	0	0
6	48383414	.	G	A	10	8	18	0	0	18	0	0
6	48383573	.	G	A	13	8	21	0	0	21	0	0
6	48383653	.	A	C	7	5	12	0	0	12	0	0
6	48383998	.	T	G	3	3	6	0	2	8	0	0
6	48384325	.	T	C	1	2	3	0	1	4	0	0
6	48384368	.	T	C	3	5	8	0	0	8	0	0
6	48384602	.	G	A	4	3	7	0	2	9	0	0
6	48394224	.	T	C	6	0	6	0	10	16	0	0
6	48417892	.	A	T	8	11	19	0	0	19	0	0
6	48425552	.	A	T	7	5	12	0	0	12	0	0
6	48425590	.	T	C	6	4	10	0	1	11	0	0
6	48425632	.	G	T	3	4	7	0	0	7	0	0
6	48425744	.	T	A	1	3	4	0	0	4	0	0
6	48425824	.	A	C	2	3	5	0	0	5	0	0
6	48425842	.	G	A	1	2	3	0	0	3	0	0
6	48425967	.	A	C	5	2	7	0	0	7	0	0
6	48425975	.	C	T	6	3	9	0	0	9	0	0
6	48426052	.	A	G	3	8	11	0	1	12	0	0
6	48426088	.	T	C	3	10	13	0	2	15	0	0
6	48426171	.	C	T	3	8	11	0	0	11	0	0
6	48426381	.	C	T	18	11	29	0	0	29	0	0
6	48426400	.	G	A	16	11	27	0	0	27	0	0
6	48426429	.	A	T	15	7	22	0	4	26	0	0
6	48426535	.	G	A	10	4	14	0	2	16	0	0
6	48426754	.	A	G	9	10	19	0	0	19	0	0
6	48431429	.	T	C	7	8	15	0	1	16	0	0
6	48437957	.	G	A	3	6	9	0	0	9	0	0
6	48439781	.	C	T	7	6	13	0	0	13	0	0
6	48439949	.	G	A	11	8	19	0	1	20	0	0
6	48440054	.	A	G	5	8	13	0	0	13	0	0
6	48440063	.	T	G	4	8	12	0	0	12	0	0
6	48473168	.	C	T	10	9	19	0	2	21	0	0
6	48473183	.	G	A	10	8	18	0	2	20	0	0
6	48473318	.	T	C	9	7	16	1	1	18	0	0
6	48689312	.	T	G	18	13	31	0	1	32	0	0
6	48689484	.	G	A	5	7	12	0	0	12	0	0
6	49100132	.	G	A	6	5	11	0	0	11	0	0
6	49103203	.	G	A	2	6	8	0	0	8	0	0
6	49105852	.	G	T	7	7	14	0	0	14	0	0
6	49106155	.	A	T	4	7	11	0	0	11	0	0
6	49106450	.	C	T	14	10	24	0	0	24	0	0
6	49106605	.	C	T	15	19	34	0	1	35	0	0
6	49106744	.	C	T	6	9	15	0	0	15	0	0
6	49107156	.	A	C	20	25	45	0	2	47	0	0
6	49107390	.	G	A	30	24	54	0	3	58	1	0
6	49107477	.	T	G	15	24	39	0	8	48	1	0
6	49108152	.	T	C	18	5	23	0	0	23	0	0
6	49108157	.	T	C	12	10	22	0	0	22	0	0
6	49108244	.	T	A	9	17	26	0	1	27	0	0
6	49108313	.	T	C	15	15	30	0	4	34	0	0
6	49108352	.	A	T	19	23	42	0	0	42	0	0
6	49108355	.	T	G	19	22	41	0	1	43	1	0
6	49108604	.	T	C	19	22	41	7	2	50	0	0
6	49108739	.	T	C	27	23	50	0	1	51	0	0
6	49108838	.	A	T	27	26	53	0	1	54	0	0
6	49108954	.	C	G	33	13	46	1	2	49	0	0
6	49108970	.	T	C	33	11	44	1	2	47	0	0
6	49109347	.	T	C	35	25	60	0	4	64	0	0
6	49109366	.	G	A	36	28	64	0	2	66	0	0
6	49114982	.	C	T	23	23	46	0	1	47	0	0
6	49115141	.	T	C	21	27	48	0	1	49	0	0
6	49115259	.	A	G	15	27	42	0	2	44	0	0
6	49115292	.	A	G	13	26	39	0	1	40	0	0
6	49139928	.	G	A	18	20	38	0	1	39	0	0
6	49159082	.	G	A	9	11	20	0	2	22	0	0
6	49159096	.	T	G	6	4	10	0	2	12	0	0
6	49412900	.	C	T	5	2	7	0	0	7	0	0
6	49413209	.	C	T	10	6	16	0	0	16	0	0
6	49413281	.	A	T	8	3	11	0	0	11	0	0
6	49413500	.	T	C	6	3	9	0	0	9	0	0
6	49413653	.	T	C	4	3	7	0	0	7	0	0
6	49413728	.	G	A	11	5	16	0	0	16	0	0
6	49520723	.	C	T	3	2	5	0	4	9	0	0
6	49534100	.	A	G	1	7	8	0	0	8	0	0
6	49534301	.	T	G	3	2	5	0	0	5	0	0
6	49551892	.	C	T	8	9	17	0	0	17	0	0
6	49556795	.	T	C	7	8	15	0	1	16	0	0
6	49556822	.	T	C	9	7	16	0	0	16	0	0
6	49573883	.	T	C	8	6	14	0	1	15	0	0
6	49575605	.	T	C	11	6	17	0	0	17	0	0
6	49575715	.	A	C	7	3	10	0	0	10	0	0
6	49575745	.	T	C	6	3	9	0	0	9	0	0
6	49575756	.	C	G	7	4	11	0	0	11	0	0
6	49575792	.	A	C	7	6	13	0	0	13	0	0
6	49575795	.	C	T	8	6	14	0	0	14	0	0
6	49576011	.	T	G	3	3	6	0	0	6	0	0
6	49576099	.	A	G	3	5	8	0	0	8	0	0
6	49576487	.	C	G	4	2	6	0	0	6	0	0
6	49576666	.	T	A	5	4	9	0	0	9	0	0
6	49576723	.	T	C	5	2	7	0	0	7	0	0
6	49576770	.	T	C	6	4	10	0	0	10	0	0
6	49577047	.	C	T	4	11	15	0	2	17	0	0
6	49577139	.	C	G	5	4	9	0	4	13	0	0
6	49577157	.	A	G	6	5	11	0	0	11	0	0
6	49577349	.	A	G	2	3	5	0	0	5	0	0
6	49577363	.	G	T	3	4	7	0	0	7	0	0
6	49577405	.	A	G	5	3	8	0	1	9	0	0
6	49577473	.	G	A	7	8	15	0	0	15	0	0
6	49577546	.	A	C	4	4	8	0	0	8	0	0
6	49577549	.	A	G	4	4	8	0	0	8	0	0
6	49577873	.	C	T	11	4	15	0	0	15	0	0
6	49578468	.	G	C	3	8	11	0	1	12	0	0
6	49579458	.	G	T	0	7	7	0	6	13	0	0
6	49580020	.	G	A	0	4	4	0	1	5	0	0
6	49583348	.	C	T	15	15	30	0	1	31	0	0
6	49605308	.	G	A	4	13	17	0	26	43	0	0
6	49628476	.	T	C	21	18	39	0	1	40	0	0
6	49635461	.	G	A	32	24	56	0	1	57	0	0
6	49636372	.	T	C	25	17	42	0	1	43	0	0
6	49652891	.	T	C	1	1	2	0	2	4	0	0
6	49723071	.	G	A	4	7	11	0	1	12	0	0
6	49730334	.	G	A	3	9	12	0	11	23	0	0
6	49734513	.	G	A	1	4	5	0	8	13	0	0
6	49737251	.	A	T	5	9	14	0	1	15	0	0
6	49737331	.	A	C	10	5	15	0	0	15	0	0
6	49737337	.	C	A	12	7	19	0	0	19	0	0
6	49737477	.	T	A	10	9	19	0	0	19	0	0
6	49737524	.	T	G	6	8	14	0	1	15	0	0
6	49737584	.	A	G	4	0	4	0	8	12	0	0
6	49737590	.	A	G	5	7	12	0	0	12	0	0
6	49737806	.	T	C	1	2	3	0	0	3	0	0
6	49737842	.	T	G	3	8	11	0	0	11	0	0
6	49737847	.	A	C	3	8	11	0	0	11	0	0
6	49738006	.	A	G	9	6	15	0	3	18	0	0
6	49738218	.	A	G	8	5	13	0	0	13	0	0
6	49738348	.	A	G	5	0	5	1	12	18	0	0
6	49738353	.	A	G	7	0	7	1	9	17	0	0
6	49738479	.	A	G	10	5	15	0	0	15	0	0
6	49738519	.	A	G	11	4	15	0	0	15	0	0
6	49738534	.	A	G	12	0	12	0	5	17	0	0
6	49738787	.	G	A	12	9	21	0	0	21	0	0
6	49738863	.	A	G	12	0	12	0	10	22	0	0
6	49739084	.	G	A	11	7	18	0	1	19	0	0
6	49739151	.	A	G	14	7	21	0	0	21	0	0
6	49739503	.	G	A	4	3	7	0	0	7	0	0
6	49739628	.	C	T	8	5	13	1	1	15	0	0
6	49739698	.	A	T	9	7	16	1	1	18	0	0
6	49739845	.	T	C	8	7	15	0	2	17	0	0
6	49739868	.	A	G	10	8	18	0	1	19	0	0
6	49740059	.	A	G	11	10	21	0	1	22	0	0
6	49740067	.	C	A	10	10	20	0	1	21	0	0
6	49740247	.	G	A	10	11	21	0	0	21	0	0
6	49744383	.	T	C	12	10	22	0	0	22	0	0
6	49744443	.	C	T	9	8	17	0	1	18	0	0
6	49749689	.	G	A	1	12	13	0	8	21	0	0
6	49751721	.	T	C	12	17	29	0	0	29	0	0
6	49757650	.	T	C	10	12	22	0	1	24	1	0
6	49760016	.	T	C	15	16	31	0	1	32	0	0
6	49760278	.	G	C	11	26	37	0	0	37	0	0
6	49760581	.	A	T	8	6	14	0	1	15	0	0
6	49760609	.	A	G	7	8	15	0	2	17	0	0
6	49760740	.	A	G	7	4	11	1	0	12	0	0
6	49771734	.	A	C	7	4	11	0	0	11	0	0
6	49777322	.	G	A	3	2	5	0	0	5	0	0
6	49777475	.	C	T	2	3	5	0	0	5	0	0
6	49777598	.	C	T	1	5	6	0	0	6	0	0
6	49777640	.	A	C	2	6	8	0	0	8	0	0
6	49778844	.	C	A	2	2	4	0	0	4	0	0
6	49778919	.	A	C	4	4	8	0	0	8	0	0
6	49780781	.	T	G	4	3	7	0	0	7	0	0
6	49780905	.	T	A	1	2	3	0	0	3	0	0
6	49789216	.	C	T	0	7	7	0	10	17	0	0
6	49793870	.	T	G	11	6	17	0	2	19	0	0
6	49796925	.	A	T	1	4	5	0	1	6	0	0
6	49797253	.	A	G	3	6	9	0	0	9	0	0
6	49799982	.	C	T	6	4	10	0	0	10	0	0
6	49811940	.	C	T	2	8	10	0	11	21	0	0
6	49812476	.	G	A	18	24	42	0	2	44	0	0
6	49815667	.	T	G	16	18	34	0	0	34	0	0
6	49816372	.	A	G	24	10	34	0	2	36	0	0
6	49901591	.	C	T	19	15	34	0	0	34	0	0
6	49914387	.	T	C	13	22	35	0	1	36	0	0
6	49919063	.	A	G	19	23	42	0	2	44	0	0
6	49919211	.	C	T	21	15	36	0	2	38	0	0
6	49919232	.	A	T	28	15	43	0	1	44	0	0
6	49919326	.	T	A	19	15	34	0	1	35	0	0
6	49919358	.	C	T	15	18	33	1	2	36	0	0
6	49919908	.	A	G	12	2	14	0	16	30	0	0
6	49920119	.	C	A	5	5	10	0	1	11	0	0
6	49920159	.	T	A	7	4	11	0	0	11	0	0
6	49920218	.	A	T	11	13	24	0	0	24	0	0
6	49920253	.	A	G	9	0	9	0	14	23	0	0
6	49920392	.	C	T	5	5	10	0	1	11	0	0
6	49920405	.	A	C	6	2	8	0	1	9	0	0
6	49920433	.	A	G	8	0	8	0	11	19	0	0
6	49920442	.	C	T	6	11	17	0	0	17	0	0
6	49920468	.	G	A	6	17	23	0	1	24	0	0
6	49920498	.	T	A	5	13	18	0	0	18	0	0
6	49920514	.	T	C	6	12	18	0	0	18	0	0
6	49920614	.	T	C	3	13	16	1	2	19	0	0
6	49920626	.	T	A	2	13	15	1	2	18	0	0
6	49921770	.	G	A	1	7	8	0	10	18	0	0
6	49921853	.	T	A	7	9	16	1	1	18	0	0
6	49930806	.	G	C	3	7	10	0	0	10	0	0
6	49930809	.	T	C	3	6	9	0	0	9	0	0
6	50203687	.	G	A	2	3	5	0	0	5	0	0
6	50382957	.	G	A	1	24	25	0	22	47	0	0
6	50389352	.	C	T	33	24	57	0	1	58	0	0
6	50389424	.	G	A	34	21	55	0	3	58	0	0
6	50390067	.	A	C	2	2	4	0	0	4	0	0
6	50401756	.	T	A	13	22	35	0	0	35	0	0
6	50401894	.	A	T	13	22	35	0	1	36	0	0
6	50402037	.	T	G	16	23	39	0	4	43	0	0
6	50402294	.	G	A	22	26	48	2	2	52	0	0
6	50404635	.	T	A	23	30	53	0	0	53	0	0
6	50404677	.	A	G	17	25	42	0	1	43	0	0
6	50408885	.	G	A	0	5	5	0	6	11	0	0
6	50413410	.	G	A	13	13	26	0	1	27	0	0
6	50413422	.	C	A	12	13	25	0	1	26	0	0
6	50413449	.	T	A	10	12	22	0	1	23	0	0
6	50414033	.	C	A	12	10	22	0	1	23	0	0
6	50414089	.	A	G	8	5	13	0	0	13	0	0
6	50451856	.	T	C	2	3	5	0	0	5	0	0
6	50452882	.	G	T	0	4	4	0	7	11	0	0
6	50453092	.	T	C	6	3	9	0	0	9	0	0
6	50453119	.	C	T	4	3	7	0	0	7	0	0
6	50453956	.	T	C	6	8	14	0	0	14	0	0
6	50454183	.	G	T	1	5	6	0	0	6	0	0
6	50581261	.	A	G	1	5	6	0	0	6	0	0
6	50581346	.	C	A	11	13	24	0	0	24	0	0
6	50581579	.	C	T	7	2	9	0	0	9	0	0
6	50581589	.	G	A	6	3	9	0	0	9	0	0
6	50581794	.	G	T	7	5	12	0	0	12	0	0
6	50581851	.	C	T	0	6	6	0	4	10	0	0
6	50582087	.	A	T	5	3	8	0	1	9	0	0
6	50582513	.	G	A	18	11	29	0	1	30	0	0
6	50582597	.	C	G	2	5	7	0	10	17	0	0
6	50596389	.	T	C	8	7	15	0	1	16	0	0
6	50685246	.	T	A	7	6	13	0	0	13	0	0
6	50685617	.	A	G	7	3	10	0	0	10	0	0
6	50685722	.	G	A	9	6	15	0	0	15	0	0
6	50695569	.	T	C	6	4	10	0	1	11	0	0
6	50695857	.	G	A	6	5	11	0	1	12	0	0
6	50696532	.	A	T	4	9	13	0	0	13	0	0
6	50698791	.	T	C	10	5	15	0	0	15	0	0
6	50699761	.	G	A	6	8	14	0	0	14	0	0
6	50704678	.	A	T	2	2	4	0	0	4	0	0
6	50713945	.	C	T	5	2	7	0	0	7	0	0
6	50714298	.	G	A	5	2	7	0	0	7	0	0
6	50714358	.	G	C	4	7	11	0	1	12	0	0
6	50722206	.	G	A	6	6	12	0	0	12	0	0
6	50722230	.	T	C	4	7	11	0	0	11	0	0
6	50730682	.	C	T	10	5	15	0	1	16	0	0
6	51021093	.	C	T	11	14	25	0	0	25	0	0
6	51021107	.	C	T	2	11	13	0	10	23	0	0
6	51045271	.	C	T	12	12	24	0	1	25	0	0
6	51054581	.	G	A	10	14	24	0	1	25	0	0
6	51054614	.	G	A	10	12	22	0	2	24	0	0
6	51054620	.	C	T	11	14	25	0	1	26	0	0
6	51054671	.	G	A	15	5	20	0	0	20	0	0
6	51064869	.	C	T	10	5	15	0	0	15	0	0
6	51101562	.	A	G	11	6	17	0	0	17	0	0
6	51161255	.	T	A	7	14	21	0	0	21	0	0
6	51161306	.	A	T	11	7	18	0	0	18	0	0
6	51195641	.	A	C	10	0	10	0	8	18	0	0
6	51237577	.	G	A	8	6	14	0	1	15	0	0
6	51277499	.	G	T	3	4	7	0	1	8	0	0
6	51321555	.	A	T	6	6	12	0	0	12	0	0
6	51529410	.	C	T	0	4	4	0	8	12	0	0
6	51529422	.	C	T	4	6	10	0	2	12	0	0
6	51529477	.	A	T	6	3	9	0	0	9	0	0
6	51531004	.	G	A	7	3	10	0	1	11	0	0
6	51531067	.	G	A	9	4	13	0	0	13	0	0
6	51531104	.	T	C	3	6	9	0	0	9	0	0
6	51531797	.	G	T	4	2	6	0	0	6	0	0
6	51531922	.	G	T	5	5	10	0	2	12	0	0
6	51531924	.	G	A	6	6	12	0	0	12	0	0
6	51532015	.	C	T	1	4	5	0	8	13	0	0
6	51532140	.	G	A	5	12	17	0	0	17	0	0
6	51532156	.	G	C	4	9	13	0	1	14	0	0
6	51532187	.	C	T	1	7	8	0	7	15	0	0
6	51532334	.	G	T	5	8	13	0	1	14	0	0
6	51535160	.	C	G	9	3	12	0	1	14	1	0
6	51535191	.	A	T	3	8	11	0	0	11	0	0
6	51541166	.	A	C	4	9	13	1	0	14	0	0
6	51541258	.	G	A	6	7	13	0	0	13	0	0
6	51552172	.	C	T	1	2	3	0	0	3	0	0
6	51558136	.	A	T	1	3	4	0	0	4	0	0
6	51558200	.	A	G	3	2	5	0	0	5	0	0
6	51573921	.	T	G	2	2	4	0	0	4	0	0
6	51576354	.	A	C	16	7	23	0	1	24	0	0
6	51576379	.	T	C	12	8	20	0	3	23	0	0
6	51577116	.	G	A	7	10	17	0	0	17	0	0
6	51577365	.	A	T	8	4	12	0	1	13	0	0
6	51577601	.	A	T	2	2	4	0	0	4	0	0
6	51577678	.	C	T	1	4	5	0	6	11	0	0
6	51577963	.	A	C	9	5	14	0	1	15	0	0
6	51578537	.	A	G	6	5	11	0	1	12	0	0
6	51578595	.	A	G	5	5	10	0	2	12	0	0
6	51578666	.	G	C	5	9	14	0	0	14	0	0
6	51578684	.	C	T	1	9	10	0	3	13	0	0
6	51578704	.	A	G	3	8	11	0	3	14	0	0
6	51579133	.	G	A	5	2	7	0	0	7	0	0
6	51579196	.	C	A	7	4	11	0	0	11	0	0
6	51579813	.	T	C	9	0	9	0	7	16	0	0
6	51580373	.	G	A	11	4	15	0	0	15	0	0
6	51580457	.	G	A	10	5	15	0	0	15	0	0
6	51580529	.	A	G	14	11	25	0	1	26	0	0
6	51581201	.	A	G	10	7	17	0	2	19	0	0
6	51581267	.	C	T	0	7	7	0	6	13	0	0
6	51586559	.	C	T	1	7	8	0	12	20	0	0
6	51591176	.	C	T	5	6	11	0	0	11	0	0
6	51592403	.	T	C	4	6	10	0	0	10	0	0
6	51592538	.	C	T	6	7	13	0	2	15	0	0
6	51594323	.	T	C	7	6	13	0	1	14	0	0
6	51594474	.	G	T	5	9	14	0	0	14	0	0
6	51594490	.	T	C	5	9	14	0	1	15	0	0
6	51594894	.	T	C	5	6	11	0	0	11	0	0
6	51594926	.	C	T	0	10	10	0	5	15	0	0
6	51595043	.	C	T	0	5	5	0	7	12	0	0
6	51595052	.	A	G	7	5	12	0	0	12	0	0
6	51595124	.	G	A	7	7	14	0	0	14	0	0
6	51595561	.	A	C	3	6	9	0	1	10	0	0
6	51595679	.	T	C	5	0	5	0	6	11	0	0
6	51598123	.	C	A	8	9	17	0	0	17	0	0
6	51598153	.	T	G	6	7	13	0	1	14	0	0
6	51599855	.	C	A	5	4	9	0	0	9	0	0
6	51601898	.	G	A	1	3	4	0	0	4	0	0
6	51608662	.	T	G	10	6	16	0	0	16	0	0
6	51612481	.	G	A	3	8	11	0	0	12	1	0
6	51631098	.	A	C	5	6	11	0	0	11	0	0
6	51666427	.	T	C	3	2	5	0	0	5	0	0
6	51666438	.	T	C	2	2	4	0	0	4	0	0
6	51770340	.	C	T	14	21	35	0	0	35	0	0
6	51770436	.	C	T	2	21	23	0	20	43	0	0
6	51770503	.	A	G	14	13	27	0	0	27	0	0
6	51773930	.	T	C	1	2	3	0	0	3	0	0
6	51779940	.	A	C	3	6	9	0	0	9	0	0
6	51779980	.	T	A	5	7	12	0	1	13	0	0
6	51780532	.	G	C	5	6	11	0	0	11	0	0
6	51780612	.	C	T	2	3	5	0	1	6	0	0
6	51780636	.	T	A	4	3	7	0	0	7	0	0
6	51796672	.	T	C	18	0	18	0	19	37	0	0
6	51796714	.	T	A	14	24	38	0	0	38	0	0
6	51797732	.	A	G	9	22	31	0	3	34	0	0
6	51797741	.	C	T	1	20	21	0	11	32	0	0
6	51808858	.	C	T	1	13	14	0	13	27	0	0
6	51808983	.	T	G	17	15	32	0	3	35	0	0
6	51810855	.	T	G	10	5	15	0	0	15	0	0
6	51810941	.	A	C	5	0	5	0	9	14	0	0
6	51810957	.	A	G	5	7	12	0	0	12	0	0
6	51811024	.	T	C	6	14	20	0	1	21	0	0
6	52024437	.	G	C	2	2	4	0	0	4	0	0
6	52030461	.	A	T	1	4	5	0	0	5	0	0
6	52030490	.	C	T	1	3	4	0	0	4	0	0
6	52030720	.	C	T	4	3	7	0	1	8	0	0
6	52081983	.	C	A	8	6	14	0	0	14	0	0
6	52082324	.	G	A	8	8	16	0	0	16	0	0
6	52082328	.	A	T	7	9	16	0	0	16	0	0
6	52082361	.	A	T	7	9	16	0	0	16	0	0
6	52082391	.	A	G	10	9	19	0	1	20	0	0
6	52082402	.	A	G	10	6	16	0	2	18	0	0
6	52082433	.	G	A	11	7	18	0	1	19	0	0
6	52082569	.	C	A	7	14	21	0	0	21	0	0
6	52082811	.	A	G	6	16	22	0	0	22	0	0
6	52089379	.	T	C	9	0	9	0	15	24	0	0
6	52119079	.	T	C	7	1	8	0	8	16	0	0
6	52155931	.	G	A	4	10	14	0	2	16	0	0
6	52156247	.	A	G	16	24	40	2	1	43	0	0
6	52224090	.	A	G	31	26	57	0	1	58	0	0
6	52224406	.	A	G	45	27	72	0	1	73	0	0
6	52227273	.	G	A	7	9	16	0	0	16	0	0
6	52227301	.	G	A	12	4	16	0	3	19	0	0
6	52227568	.	C	A	9	10	19	0	1	20	0	0
6	52227755	.	T	C	4	0	4	0	10	14	0	0
6	52227844	.	A	G	4	11	15	0	2	17	0	0
6	52234688	.	T	C	5	4	9	0	1	10	0	0
6	52239517	.	A	G	40	6	46	0	32	78	0	0
6	52239573	.	T	C	33	24	57	0	5	62	0	0
6	52239613	.	G	C	26	28	54	0	0	54	0	0
6	52247876	.	T	G	4	0	4	0	3	7	0	0
6	52248124	.	A	T	3	3	6	0	0	6	0	0
6	52248223	.	A	G	6	3	9	0	0	9	0	0
6	52248250	.	A	G	8	6	14	0	1	15	0	0
6	52248262	.	A	C	12	8	20	0	0	20	0	0
6	52248478	.	G	A	2	11	13	0	8	21	0	0
6	52248679	.	T	C	2	4	6	0	0	6	0	0
6	52248802	.	T	C	7	6	13	0	0	13	0	0
6	52248847	.	A	C	7	9	16	0	0	16	0	0
6	52249015	.	T	G	6	5	11	0	0	11	0	0
6	52249042	.	T	C	5	4	9	0	0	9	0	0
6	52255504	.	C	T	1	2	3	1	0	4	0	0
6	52278709	.	A	G	2	0	2	0	2	4	0	0
6	52278723	.	A	C	1	2	3	0	0	3	0	0
6	52306429	.	C	T	2	2	4	0	0	4	0	0
6	52317241	.	C	G	4	4	8	0	0	8	0	0
6	52317262	.	A	T	4	2	6	0	2	8	0	0
6	52318249	.	A	G	2	2	4	0	0	4	0	0
6	52321959	.	G	C	1	2	3	0	0	3	0	0
6	52323967	.	G	A	0	4	4	0	3	7	0	0
6	52324684	.	A	G	1	8	9	0	0	9	0	0
6	52324871	.	T	C	1	3	4	0	0	4	0	0
6	52324872	.	A	G	1	0	1	0	3	4	0	0
6	52326540	.	G	A	4	4	8	0	0	8	0	0
6	52326955	.	A	G	3	5	8	0	1	9	0	0
6	52327951	.	G	C	1	5	6	0	4	10	0	0
6	52339728	.	G	A	7	8	15	0	0	15	0	0
6	52351748	.	A	C	7	3	10	0	0	10	0	0
6	52352164	.	A	C	3	3	6	0	0	6	0	0
6	52352182	.	G	T	3	3	6	0	0	6	0	0
6	52352339	.	T	C	5	3	8	0	0	8	0	0
6	52352636	.	G	A	0	2	2	0	1	3	0	0
6	52352718	.	T	G	3	6	9	0	1	10	0	0
6	52352758	.	G	A	6	7	13	0	0	13	0	0
6	52352788	.	C	G	5	5	10	0	0	10	0	0
6	52353064	.	G	A	6	3	9	0	0	9	0	0
6	52353074	.	T	A	6	4	10	0	0	10	0	0
6	52353105	.	G	C	0	3	3	0	8	11	0	0
6	52353112	.	C	T	7	4	11	0	0	11	0	0
6	52353246	.	A	G	6	3	9	0	1	10	0	0
6	52353262	.	C	A	5	2	7	0	1	8	0	0
6	52353345	.	T	C	3	6	9	0	0	9	0	0
6	52353357	.	C	G	3	5	8	0	0	8	0	0
6	52353747	.	T	G	3	3	6	0	0	6	0	0
6	52353827	.	T	G	2	4	6	0	1	7	0	0
6	52354536	.	T	C	5	11	16	0	1	17	0	0
6	52354717	.	T	A	4	6	10	0	0	10	0	0
6	52354726	.	A	T	5	7	12	0	0	12	0	0
6	52354892	.	A	T	1	3	4	0	0	4	0	0
6	52354939	.	G	A	2	2	4	0	0	4	0	0
6	52354953	.	T	C	2	2	4	0	0	4	0	0
6	52356457	.	C	G	0	2	2	0	1	3	0	0
6	52356755	.	G	C	9	13	22	0	1	23	0	0
6	52362427	.	G	A	11	7	18	0	1	19	0	0
6	52362517	.	A	T	10	14	24	1	0	25	0	0
6	52362553	.	T	C	9	9	18	0	1	19	0	0
6	52362578	.	A	G	13	10	23	0	0	23	0	0
6	52362605	.	T	C	13	10	23	0	0	23	0	0
6	52362623	.	A	C	13	0	13	0	9	22	0	0
6	52362798	.	A	G	7	6	13	0	0	13	0	0
6	52362956	.	T	C	5	0	5	1	10	16	0	0
6	52362980	.	T	C	6	7	13	1	0	14	0	0
6	52363152	.	G	A	3	6	9	0	1	10	0	0
6	52363153	.	G	T	3	6	9	0	1	10	0	0
6	52363683	.	A	T	4	3	7	0	0	7	0	0
6	52363704	.	C	A	2	3	5	0	0	5	0	0
6	52364371	.	G	C	13	9	22	0	1	23	0	0
6	52364539	.	C	T	9	9	18	0	0	18	0	0
6	52364701	.	C	T	1	4	5	0	6	11	0	0
6	52372698	.	C	T	1	6	7	0	10	17	0	0
6	52383370	.	G	A	10	8	18	0	0	18	0	0
6	52397326	.	G	A	10	10	20	0	0	20	0	0
6	52397362	.	C	T	2	6	8	0	12	20	0	0
6	52428660	.	A	G	2	2	4	0	1	5	0	0
6	52521891	.	T	G	16	14	30	0	2	32	0	0
6	52533228	.	G	A	16	11	27	0	0	27	0	0
6	52536386	.	C	T	2	10	12	0	10	22	0	0
6	52552993	.	G	A	6	14	20	0	0	20	0	0
6	52563953	.	A	C	11	8	19	0	0	19	0	0
6	52663447	.	A	C	8	3	11	0	0	11	0	0
6	52663452	.	T	A	1	2	3	0	0	3	0	0
6	52664120	.	A	T	1	3	4	0	0	4	0	0
6	52664300	.	A	G	2	5	7	0	1	8	0	0
6	52664319	.	A	T	5	5	10	0	0	10	0	0
6	52675561	.	G	A	3	2	5	0	0	5	0	0
6	52715879	.	G	T	9	11	20	0	2	22	0	0
6	52715929	.	A	T	12	10	22	0	0	22	0	0
6	52716119	.	T	G	11	4	15	0	0	15	0	0
6	52716311	.	C	T	9	14	23	0	5	28	0	0
6	52716325	.	G	A	18	8	26	0	1	27	0	0
6	52716630	.	G	A	9	14	23	0	1	24	0	0
6	52716795	.	G	T	17	9	26	0	3	29	0	0
6	52720727	.	T	G	13	13	26	0	2	28	0	0
6	52807012	.	A	G	1	0	1	0	4	5	0	0
6	52807045	.	C	T	1	3	4	0	0	4	0	0
6	52827970	.	A	T	4	2	6	0	0	6	0	0
6	52845491	.	G	A	1	5	6	0	0	6	0	0
6	52845522	.	A	G	2	0	2	0	2	4	0	0
6	52845576	.	A	C	1	2	3	0	0	3	0	0
6	53050515	.	T	A	24	24	48	0	0	48	0	0
6	53050517	.	G	A	25	22	47	0	0	47	0	0
6	53050589	.	G	A	21	23	44	1	2	47	0	0
6	53050761	.	C	T	14	16	30	0	1	31	0	0
6	53050805	.	C	T	22	19	41	1	3	45	0	0
6	53050847	.	G	A	22	23	45	1	1	47	0	0
6	53050895	.	C	T	19	26	45	1	2	48	0	0
6	53052693	.	C	T	18	19	37	0	0	37	0	0
6	53052741	.	G	A	16	28	44	0	2	46	0	0
6	53065954	.	G	A	17	17	34	0	1	35	0	0
6	53143647	.	C	A	2	15	17	0	20	37	0	0
6	53152823	.	T	C	1	1	2	0	1	3	0	0
6	53264192	.	T	C	23	30	53	0	2	55	0	0
6	53264365	.	T	A	30	26	56	0	6	62	0	0
6	53264383	.	C	T	38	27	65	0	1	66	0	0
6	53272169	.	G	A	31	24	55	0	7	62	0	0
6	53272571	.	A	G	39	23	62	0	2	64	0	0
6	53273943	.	A	G	26	28	54	0	2	56	0	0
6	53273979	.	A	G	22	30	52	0	1	53	0	0
6	53279886	.	G	T	27	22	49	0	2	51	0	0
6	53279995	.	C	T	24	25	49	0	5	54	0	0
6	53305633	.	T	C	28	19	47	1	1	49	0	0
6	53306806	.	G	T	22	11	33	1	0	34	0	0
6	53306847	.	G	T	22	10	32	0	5	37	0	0
6	53306886	.	C	A	22	11	33	0	2	35	0	0
6	53306897	.	A	G	22	5	27	0	3	30	0	0
6	53350083	.	T	C	8	10	18	0	2	20	0	0
6	53350105	.	A	T	10	14	24	0	0	24	0	0
6	53350217	.	G	A	8	12	20	0	0	20	0	0
6	53361818	.	T	C	9	14	23	0	0	23	0	0
6	53583122	.	T	C	4	4	8	0	0	8	0	0
6	53611488	.	A	G	6	6	12	0	0	12	0	0
6	54078764	.	G	T	1	3	4	1	5	10	0	0
6	54078765	.	A	T	5	2	7	1	2	10	0	0
6	54079171	.	T	G	3	3	6	0	0	6	0	0
6	54079439	.	A	T	4	3	7	0	0	7	0	0
6	54079586	.	T	A	1	3	4	0	0	4	0	0
6	54079590	.	G	C	1	3	4	0	0	4	0	0
6	54079657	.	T	C	3	4	7	0	0	7	0	0
6	54117367	.	A	G	10	7	17	0	0	17	0	0
6	54120966	.	G	C	12	6	18	0	2	20	0	0
6	54142351	.	T	G	11	17	28	1	0	29	0	0
6	54149554	.	C	T	24	20	44	0	1	46	1	0
6	54150332	.	C	T	6	2	8	0	0	8	0	0
6	54150640	.	C	G	22	11	33	0	1	34	0	0
6	54150918	.	C	T	7	6	13	0	0	13	0	0
6	54151406	.	G	A	15	14	29	0	0	29	0	0
6	54151554	.	G	A	1	9	10	4	10	24	0	0
6	54151680	.	G	A	23	10	33	0	1	34	0	0
6	54151683	.	C	T	20	10	30	0	2	32	0	0
6	54151768	.	G	A	17	19	36	0	0	36	0	0
6	54151951	.	T	C	18	16	34	0	1	35	0	0
6	54151963	.	T	C	17	15	32	0	3	35	0	0
6	54152125	.	T	A	10	4	14	8	0	22	0	0
6	54152492	.	C	T	22	17	39	0	2	41	0	0
6	54152529	.	T	A	24	11	35	0	0	35	0	0
6	54154905	.	A	T	8	8	16	0	0	16	0	0
6	54154909	.	G	T	1	6	7	0	5	12	0	0
6	54165082	.	G	T	0	4	4	0	10	14	0	0
6	54175226	.	T	G	31	20	51	0	4	55	0	0
6	54175384	.	A	G	50	18	68	0	3	71	0	0
6	54177352	.	A	T	30	36	66	0	2	68	0	0
6	54177478	.	A	G	32	36	68	2	3	73	0	0
6	54262298	.	C	T	7	12	19	0	0	19	0	0
6	54266244	.	G	A	8	9	17	0	1	18	0	0
6	54266337	.	T	A	14	11	25	0	0	25	0	0
6	54270266	.	C	T	10	9	19	0	1	20	0	0
6	54270561	.	T	A	9	9	18	0	1	19	0	0
6	54270680	.	G	T	16	9	25	0	3	28	0	0
6	54270773	.	T	A	8	6	14	0	0	14	0	0
6	54271481	.	T	A	2	2	4	0	0	4	0	0
6	54325234	.	A	G	9	5	14	0	1	15	0	0
6	54325368	.	A	G	10	11	21	0	1	22	0	0
6	54325487	.	A	G	5	5	10	0	0	10	0	0
6	54326031	.	T	A	6	8	14	0	0	14	0	0
6	54326759	.	T	C	6	10	16	0	0	16	0	0
6	54337568	.	G	A	10	12	22	0	0	22	0	0
6	54397394	.	C	T	9	4	13	0	2	15	0	0
6	54397805	.	C	T	4	5	9	0	1	10	0	0
6	54409160	.	T	A	6	5	11	0	0	11	0	0
6	54409807	.	A	T	2	5	7	0	0	7	0	0
6	54421228	.	T	G	4	0	4	0	5	9	0	0
6	54422087	.	A	G	4	2	6	0	0	6	0	0
6	54422599	.	T	A	7	5	12	0	0	12	0	0
6	54422635	.	T	A	8	5	13	0	0	13	0	0
6	54422659	.	A	G	7	0	7	0	5	12	0	0
6	54438466	.	G	A	11	9	20	0	0	20	0	0
6	54698197	.	G	T	0	2	2	0	1	3	0	0
6	54704691	.	T	G	2	3	5	0	1	6	0	0
6	54807103	.	A	G	2	2	4	0	0	4	0	0
6	54807312	.	T	G	6	2	8	0	0	8	0	0
6	54807409	.	C	T	1	3	4	0	2	6	0	0
6	54815767	.	A	C	4	2	6	0	1	7	0	0
6	54838467	.	G	A	13	9	22	0	2	24	0	0
6	54838496	.	T	C	15	14	29	0	0	29	0	0
6	54840083	.	T	C	19	1	20	0	28	48	0	0
6	54843108	.	T	G	31	23	54	0	3	57	0	0
6	54888903	.	C	T	4	3	7	0	0	7	0	0
6	54888975	.	T	C	5	7	12	0	0	12	0	0
6	54889038	.	C	T	9	4	13	0	0	13	0	0
6	54889323	.	T	C	4	4	8	0	0	8	0	0
6	54900913	.	A	C	6	4	10	0	0	10	0	0
6	54959695	.	T	C	6	4	10	0	0	10	0	0
6	54970317	.	T	C	8	7	15	1	0	16	0	0
6	54970672	.	A	C	9	3	12	0	1	13	0	0
6	54970673	.	G	T	10	4	14	0	0	14	0	0
6	54970870	.	C	T	10	5	15	0	1	16	0	0
6	54978063	.	G	A	12	4	16	1	2	19	0	0
6	54983647	.	A	C	6	6	12	0	0	12	0	0
6	54998449	.	C	T	5	4	9	0	1	10	0	0
6	54998500	.	A	G	10	5	15	0	0	15	0	0
6	55000756	.	T	C	10	5	15	0	2	17	0	0
6	55004574	.	T	C	10	11	21	0	0	21	0	0
6	55006252	.	A	G	11	9	20	0	0	20	0	0
6	55006778	.	C	T	9	8	17	0	0	17	0	0
6	55006971	.	C	T	5	4	9	0	0	9	0	0
6	55010951	.	T	C	6	3	9	0	1	10	0	0
6	55010972	.	C	T	9	5	14	0	0	14	0	0
6	55016519	.	A	G	10	1	11	0	7	18	0	0
6	55016522	.	C	A	10	8	18	0	0	18	0	0
6	55017151	.	T	G	11	10	21	0	1	22	0	0
6	55020076	.	A	C	11	10	21	0	0	21	0	0
6	55020094	.	G	A	2	10	12	0	9	21	0	0
6	55020288	.	A	G	14	1	15	0	18	33	0	0
6	55020327	.	A	T	17	14	31	0	0	31	0	0
6	55020477	.	C	A	12	5	17	0	1	18	0	0
6	55021617	.	T	C	2	4	6	0	0	6	0	0
6	55021735	.	A	C	9	7	16	0	1	17	0	0
6	55021736	.	A	C	10	7	17	0	0	17	0	0
6	55021941	.	A	T	10	8	18	0	0	18	0	0
6	55021943	.	G	T	0	8	8	0	10	18	0	0
6	55022039	.	A	G	11	13	24	0	0	24	0	0
6	55022109	.	T	C	15	11	26	0	0	26	0	0
6	55022114	.	T	A	15	11	26	0	1	27	0	0
6	55022244	.	A	T	3	5	8	0	1	9	0	0
6	55022263	.	G	C	6	5	11	0	1	12	0	0
6	55022286	.	A	T	6	7	13	0	0	13	0	0
6	55022319	.	A	T	9	6	15	0	0	15	0	0
6	55022330	.	A	T	7	8	15	0	1	16	0	0
6	55022437	.	C	T	9	8	17	0	1	18	0	0
6	55217796	.	A	G	10	4	14	0	3	17	0	0
6	55217907	.	A	G	5	3	8	0	0	8	0	0
6	55218127	.	A	G	4	8	12	1	3	16	0	0
6	55218340	.	A	G	5	9	14	0	0	14	0	0
6	58562436	.	T	A	9	14	23	9	1	33	0	0
6	58768370	.	G	A	0	3	3	0	2	5	0	0
6	58867240	.	A	G	14	7	21	0	1	22	0	0
6	59047962	.	T	C	0	4	4	0	0	4	0	0
6	59047982	.	C	A	2	1	3	0	0	3	0	0
6	59883458	.	T	A	8	0	8	0	15	23	0	0
6	59883460	.	A	C	5	2	7	0	16	23	0	0
6	59971580	.	A	G	36	12	48	0	1	49	0	0
6	59971598	.	A	G	32	18	50	0	0	50	0	0
7	622356	.	A	T	2	1	3	0	14	17	0	0
7	742828	.	T	C	10	14	24	0	1	25	0	0
7	762325	.	A	G	2	1	3	0	1	4	0	0
7	837955	.	T	G	10	6	16	0	2	18	0	0
7	841689	.	G	A	2	4	6	3	1	10	0	0
7	841887	.	C	T	1	6	7	3	0	10	0	0
7	841888	.	G	C	4	2	6	3	1	10	0	0
7	846579	.	C	T	7	11	18	0	0	18	0	0
7	846972	.	T	C	9	11	20	0	0	20	0	0
7	847189	.	A	T	11	11	22	0	0	22	0	0
7	854854	.	C	G	4	13	17	0	0	17	0	0
7	860914	.	A	G	5	4	9	1	1	11	0	0
7	861057	.	G	C	4	9	13	0	0	13	0	0
7	1051029	.	G	A	0	4	4	1	1	6	0	0
7	1418631	.	T	C	4	4	8	0	0	8	0	0
7	3931029	.	A	G	31	14	45	0	1	46	0	0
7	3931264	.	C	T	15	30	45	0	0	45	0	0
7	3931396	.	A	T	24	33	57	0	2	59	0	0
7	3931543	.	A	T	22	33	55	0	2	57	0	0
7	3931598	.	G	T	28	27	55	0	0	55	0	0
7	3931644	.	T	C	29	1	30	0	18	48	0	0
7	3932209	.	A	T	12	27	39	0	3	42	0	0
7	3932402	.	T	C	14	19	33	0	1	34	0	0
7	3932405	.	A	T	16	19	35	0	0	35	0	0
7	3932463	.	T	G	14	9	23	1	1	25	0	0
7	3932694	.	G	A	31	11	42	0	0	42	0	0
7	3932698	.	T	C	32	13	45	0	1	46	0	0
7	3932731	.	C	A	30	15	45	0	3	48	0	0
7	3932935	.	C	A	19	19	38	1	3	42	0	0
7	3933121	.	G	A	32	16	48	0	1	49	0	0
7	3933243	.	C	A	18	18	36	0	1	37	0	0
7	3933271	.	C	T	18	19	37	0	2	39	0	0
7	3933383	.	A	C	10	2	12	0	28	40	0	0
7	3933481	.	T	C	27	0	27	0	14	41	0	0
7	3933483	.	C	T	1	12	13	0	29	42	0	0
7	3933998	.	C	T	27	16	43	0	1	44	0	0
7	3934038	.	A	T	12	16	28	0	1	30	1	0
7	3934208	.	T	C	33	6	39	0	5	44	0	0
7	3934387	.	C	T	23	20	43	0	0	43	0	0
7	3934428	.	G	T	26	22	48	0	1	49	0	0
7	3934551	.	A	T	14	11	25	1	0	26	0	0
7	3934645	.	A	C	8	12	20	1	1	22	0	0
7	3934818	.	G	A	15	10	25	0	0	25	0	0
7	3934970	.	A	G	8	14	22	0	0	22	0	0
7	3935055	.	T	C	14	17	31	0	1	32	0	0
7	3935123	.	A	G	13	16	29	0	2	31	0	0
7	3935283	.	G	A	10	19	29	0	1	30	0	0
7	3935737	.	C	T	5	21	26	0	15	41	0	0
7	3935788	.	C	A	13	10	23	1	1	25	0	0
7	3936127	.	C	T	3	12	15	0	15	30	0	0
7	3936702	.	A	G	9	5	14	0	0	14	0	0
7	3936764	.	G	A	11	13	24	0	0	24	0	0
7	3936946	.	C	T	1	10	11	0	20	31	0	0
7	3951010	.	C	T	1	19	20	0	19	39	0	0
7	3951115	.	G	A	21	14	35	0	3	38	0	0
7	3952993	.	A	G	21	20	41	0	2	43	0	0
7	3955628	.	G	A	10	18	28	0	3	31	0	0
7	4088334	.	C	T	14	16	30	0	1	31	0	0
7	4088545	.	C	T	0	19	19	0	9	28	0	0
7	4088680	.	G	A	13	17	30	0	2	32	0	0
7	4088727	.	A	T	23	22	45	0	2	47	0	0
7	4088832	.	A	G	15	23	38	0	3	41	0	0
7	4089042	.	A	G	19	11	30	0	2	32	0	0
7	4089090	.	G	A	15	10	25	0	0	25	0	0
7	4095265	.	C	T	3	20	23	0	26	49	0	0
7	4100931	.	C	T	13	18	31	0	4	35	0	0
7	4100967	.	G	A	19	19	38	0	0	38	0	0
7	4110441	.	T	C	10	0	10	0	13	23	0	0
7	4174962	.	G	A	0	14	14	0	4	18	0	0
7	4175054	.	G	A	4	9	13	0	0	13	0	0
7	4175078	.	G	A	6	9	15	0	0	15	0	0
7	4175372	.	T	C	2	4	6	0	0	6	0	0
7	4177157	.	A	G	3	2	5	0	0	5	0	0
7	4177165	.	T	C	3	1	4	0	0	4	0	0
7	4180366	.	A	G	1	2	3	0	0	3	0	0
7	4180375	.	A	T	1	3	4	0	0	4	0	0
7	4181728	.	G	A	1	6	7	1	0	8	0	0
7	4183317	.	G	A	1	5	6	0	0	6	0	0
7	4184141	.	A	G	5	2	7	0	0	7	0	0
7	4184897	.	G	T	6	5	11	0	0	11	0	0
7	4185160	.	A	T	11	10	21	0	0	21	0	0
7	4186532	.	G	A	0	4	4	0	4	8	0	0
7	4186564	.	G	A	0	3	3	0	4	7	0	0
7	4186568	.	T	A	3	3	6	0	0	6	0	0
7	7242384	.	T	C	1	4	5	0	1	6	0	0
7	7245508	.	C	G	3	2	5	0	0	5	0	0
7	7248193	.	C	T	18	16	34	0	3	37	0	0
7	7248212	.	A	T	15	9	24	0	7	31	0	0
7	7365912	.	G	A	1	3	4	1	2	7	0	0
7	7367538	.	G	C	2	4	6	0	1	7	0	0
7	7372255	.	A	G	3	2	5	0	0	5	0	0
7	7372287	.	A	G	8	3	11	0	0	11	0	0
7	7373018	.	C	T	4	2	6	0	2	8	0	0
7	7478533	.	T	C	10	10	20	0	2	22	0	0
7	7478546	.	T	C	15	8	23	0	1	24	0	0
7	7552113	.	G	A	26	13	39	0	1	40	0	0
7	7597059	.	A	G	11	0	11	0	17	28	0	0
7	7608920	.	G	A	1	13	14	0	16	30	0	0
7	7608944	.	T	G	16	1	17	0	12	29	0	0
7	7608965	.	C	T	15	9	24	0	2	26	0	0
7	7611758	.	C	T	24	25	49	0	0	49	0	0
7	7611803	.	C	A	7	12	19	0	15	34	0	0
7	7611866	.	T	C	14	15	29	0	1	30	0	0
7	7617855	.	T	C	24	19	43	0	2	45	0	0
7	7617963	.	C	G	24	12	36	0	0	36	0	0
7	7624082	.	A	G	31	18	49	0	3	52	0	0
7	7624090	.	T	C	34	19	53	0	1	54	0	0
7	7641230	.	A	T	21	18	39	0	3	42	0	0
7	7641351	.	G	A	22	15	37	0	0	37	0	0
7	7641353	.	G	A	18	16	34	0	3	37	0	0
7	7641559	.	C	T	23	21	44	0	0	44	0	0
7	7641567	.	C	T	24	18	42	0	3	45	0	0
7	7641608	.	A	G	22	16	38	0	4	42	0	0
7	7641678	.	T	A	18	11	29	0	1	30	0	0
7	7642730	.	C	T	26	10	36	0	1	37	0	0
7	7642819	.	G	A	19	10	29	0	1	30	0	0
7	7642840	.	T	A	16	13	29	0	1	30	0	0
7	7642856	.	C	T	14	16	30	0	2	32	0	0
7	7642944	.	C	T	11	6	17	0	0	17	0	0
7	7643107	.	C	T	5	2	7	0	0	7	0	0
7	7643184	.	A	G	11	0	11	0	18	29	0	0
7	7643348	.	G	A	20	15	35	1	2	38	0	0
7	7643362	.	T	A	18	18	36	1	2	39	0	0
7	7643488	.	A	G	23	20	43	1	1	45	0	0
7	7643629	.	A	G	30	21	51	0	5	56	0	0
7	7662467	.	C	G	10	7	17	0	1	18	0	0
7	7662475	.	T	C	8	0	8	0	10	18	0	0
7	7662527	.	A	C	7	8	15	0	0	15	0	0
7	7662580	.	G	A	14	18	32	0	0	32	0	0
7	7662872	.	A	C	12	11	23	0	0	23	0	0
7	7662978	.	A	C	6	13	19	0	0	19	0	0
7	7663017	.	T	A	11	19	30	0	1	31	0	0
7	7663048	.	A	G	14	22	36	0	2	39	1	0
7	7663132	.	A	G	21	12	33	0	0	33	0	0
7	7663152	.	A	T	18	9	27	0	1	28	0	0
7	7663236	.	T	C	16	0	16	0	0	17	1	0
7	7663254	.	G	A	17	6	23	0	2	25	0	0
7	7663320	.	C	G	20	8	28	0	1	29	0	0
7	7663449	.	A	C	18	0	18	0	7	25	0	0
7	7663453	.	A	T	19	7	26	0	1	27	0	0
7	7663682	.	C	T	1	4	5	0	14	19	0	0
7	7663902	.	G	T	8	12	20	1	0	21	0	0
7	7664011	.	A	G	11	2	13	0	1	14	0	0
7	7664026	.	G	A	9	5	14	0	0	14	0	0
7	7664083	.	G	A	2	2	4	0	0	4	0	0
7	7664237	.	C	T	2	2	4	0	0	4	0	0
7	7664503	.	G	A	1	2	3	0	0	3	0	0
7	7664558	.	G	T	5	9	14	1	2	17	0	0
7	7664838	.	G	T	16	8	24	0	0	25	1	0
7	7665338	.	G	T	10	7	17	0	0	17	0	0
7	7665353	.	T	A	15	7	22	0	0	22	0	0
7	7665480	.	A	C	16	9	25	0	1	26	0	0
7	7665952	.	T	A	4	2	6	0	0	6	0	0
7	7665961	.	T	C	5	2	7	0	0	7	0	0
7	7666388	.	G	A	22	7	29	0	1	30	0	0
7	7666625	.	G	A	10	13	23	0	1	24	0	0
7	7674378	.	T	C	11	0	11	0	15	26	0	0
7	7674462	.	C	G	12	19	31	0	1	32	0	0
7	7674474	.	T	A	9	18	27	0	0	27	0	0
7	7676086	.	C	T	10	10	20	0	2	22	0	0
7	7676112	.	C	T	10	14	24	0	0	24	0	0
7	7676185	.	C	T	5	6	11	0	0	11	0	0
7	7681415	.	T	G	5	2	7	0	0	7	0	0
7	7681419	.	C	G	0	3	3	0	4	7	0	0
7	7683342	.	G	A	4	4	8	0	1	9	0	0
7	7684895	.	T	A	1	2	3	0	1	4	0	0
7	7687435	.	G	A	1	6	7	0	0	7	0	0
7	7687513	.	A	G	2	7	9	0	0	9	0	0
7	7696726	.	G	C	14	10	24	0	0	24	0	0
7	7696742	.	A	G	12	12	24	0	2	26	0	0
7	7696785	.	T	A	6	7	13	0	0	13	0	0
7	7696794	.	G	T	0	6	6	0	5	11	0	0
7	7700867	.	G	A	1	14	15	0	10	25	0	0
7	7700965	.	T	G	12	1	13	0	12	25	0	0
7	7700987	.	T	C	13	13	26	0	1	27	0	0
7	7701016	.	G	C	11	11	22	0	0	22	0	0
7	7701293	.	T	C	10	5	15	0	1	16	0	0
7	7705993	.	C	G	4	1	5	0	15	20	0	0
7	7706005	.	C	T	5	14	19	0	0	19	0	0
7	7706702	.	G	A	1	10	11	0	5	16	0	0
7	7706869	.	A	G	2	7	9	0	0	9	0	0
7	7706997	.	C	A	7	7	14	0	0	14	0	0
7	7707029	.	T	G	11	7	18	0	0	18	0	0
7	7707191	.	A	C	4	4	8	0	1	9	0	0
7	7707214	.	T	C	4	3	7	0	0	7	0	0
7	7708527	.	C	T	5	3	8	0	0	8	0	0
7	7708572	.	T	C	5	2	7	0	1	8	0	0
7	7708714	.	T	C	8	7	15	0	0	15	0	0
7	7709061	.	A	G	4	6	10	0	1	11	0	0
7	7717685	.	G	A	3	2	5	0	0	5	0	0
7	7779060	.	G	A	0	3	3	0	2	5	0	0
7	7797598	.	T	C	3	2	5	0	1	6	0	0
7	7797616	.	C	A	4	2	6	0	0	6	0	0
7	8694709	.	T	A	2	2	4	0	0	4	0	0
7	8694999	.	T	A	1	4	5	0	1	6	0	0
7	8695001	.	C	A	1	4	5	0	1	6	0	0
7	8695191	.	C	T	0	4	4	0	9	13	0	0
7	8702121	.	C	T	2	3	5	0	0	5	0	0
7	8890495	.	C	T	0	6	6	0	5	11	0	0
7	8890515	.	G	C	5	0	5	0	13	18	0	0
7	8891675	.	T	A	6	5	11	0	1	12	0	0
7	8891710	.	A	G	4	10	14	0	1	15	0	0
7	8891717	.	A	G	4	7	11	0	1	12	0	0
7	8891808	.	T	C	6	0	6	6	2	14	0	0
7	8891823	.	T	C	4	0	4	2	8	14	0	0
7	8909438	.	C	T	6	3	9	0	0	9	0	0
7	8950378	.	G	A	1	2	3	0	1	4	0	0
7	8950386	.	C	A	2	4	6	0	0	6	0	0
7	9189605	.	T	C	3	3	6	0	0	6	0	0
7	9212234	.	A	G	6	5	11	0	0	11	0	0
7	9224366	.	G	A	0	3	3	0	5	8	0	0
7	9229327	.	A	C	6	7	13	0	0	13	0	0
7	9232531	.	T	C	5	6	11	0	1	12	0	0
7	9232615	.	C	T	4	2	6	0	0	6	0	0
7	9232621	.	C	G	4	2	6	0	0	6	0	0
7	9238631	.	A	G	2	0	2	0	5	7	0	0
7	9247556	.	C	T	6	7	13	0	0	13	0	0
7	9291049	.	C	A	11	11	22	0	1	23	0	0
7	9299699	.	G	A	5	3	8	0	0	8	0	0
7	9299726	.	A	G	6	2	8	0	0	8	0	0
7	9302654	.	G	A	1	2	3	0	5	8	0	0
7	9302664	.	T	C	10	3	13	0	0	13	0	0
7	9302736	.	C	A	9	3	12	0	0	13	1	0
7	9302750	.	A	G	9	4	13	0	1	14	0	0
7	9302796	.	A	G	5	5	10	0	1	11	0	0
7	9302990	.	T	A	18	4	22	0	0	22	0	0
7	9303000	.	T	A	16	3	19	0	1	20	0	0
7	9304692	.	T	C	19	10	29	0	1	30	0	0
7	9308683	.	A	G	16	21	37	0	1	38	0	0
7	9308715	.	C	T	18	21	39	0	1	40	0	0
7	9308817	.	A	G	17	18	35	0	1	36	0	0
7	9312770	.	G	A	2	19	21	0	20	41	0	0
7	9317990	.	G	A	23	21	44	0	0	44	0	0
7	9319626	.	T	C	18	20	38	0	2	40	0	0
7	9320431	.	A	T	14	9	23	0	2	25	0	0
7	9320719	.	C	T	17	13	30	0	1	31	0	0
7	9321188	.	G	A	6	4	10	0	0	10	0	0
7	9321374	.	C	T	4	4	8	0	1	9	0	0
7	9321375	.	T	A	5	4	9	0	0	9	0	0
7	9321528	.	A	C	1	3	4	0	1	5	0	0
7	9321529	.	C	G	2	0	2	0	3	5	0	0
7	9321800	.	G	A	0	9	9	0	8	17	0	0
7	9321981	.	G	T	16	19	35	0	1	36	0	0
7	9322176	.	C	A	17	4	21	2	0	26	3	0
7	9322178	.	T	C	21	3	24	2	2	28	0	0
7	9322216	.	A	G	18	5	23	0	0	23	0	0
7	9322271	.	G	C	8	10	18	0	1	19	0	0
7	9322441	.	C	T	3	8	11	0	0	11	0	0
7	9509429	.	C	T	6	3	9	0	0	9	0	0
7	9509450	.	C	T	4	5	9	0	0	9	0	0
7	9509567	.	G	T	0	6	6	0	1	7	0	0
7	9509583	.	A	C	1	5	6	0	0	6	0	0
7	9844342	.	T	C	2	0	2	0	4	6	0	0
7	9844344	.	T	C	3	2	5	0	1	6	0	0
7	10582829	.	A	T	6	3	9	0	1	10	0	0
7	10875187	.	A	G	19	15	34	0	0	34	0	0
7	10875552	.	A	G	13	9	22	0	0	22	0	0
7	10875761	.	A	G	23	9	32	0	2	34	0	0
7	10875923	.	A	G	19	8	27	0	1	28	0	0
7	10875930	.	A	G	13	14	27	0	1	28	0	0
7	11340658	.	A	G	6	0	6	0	7	13	0	0
7	11340718	.	A	G	10	3	13	0	2	15	0	0
7	11340820	.	A	G	5	4	9	0	0	9	0	0
7	11340868	.	A	G	7	0	7	0	3	10	0	0
7	11341012	.	A	G	10	0	10	0	5	15	0	0
7	12142037	.	T	C	3	0	3	0	2	5	0	0
7	12142048	.	T	C	3	2	5	0	0	5	0	0
7	12844513	.	T	C	4	7	11	0	1	12	0	0
7	13242820	.	A	G	4	0	4	0	2	6	0	0
7	13316899	.	G	A	1	5	6	0	0	6	0	0
7	13334754	.	G	A	1	8	9	0	0	9	0	0
7	13566588	.	A	G	3	2	5	0	1	6	0	0
7	13570652	.	A	G	1	0	1	1	7	9	0	0
7	13618270	.	A	G	2	3	5	0	0	5	0	0
7	13897633	.	T	C	1	7	8	0	0	8	0	0
7	13897765	.	A	C	7	5	12	0	0	12	0	0
7	13897768	.	A	C	6	0	6	0	6	12	0	0
7	13897822	.	G	A	4	5	9	0	0	9	0	0
7	13897878	.	G	A	4	4	8	0	0	8	0	0
7	13897897	.	T	C	2	5	7	0	0	7	0	0
7	13906372	.	C	T	4	3	7	0	0	7	0	0
7	13906396	.	A	G	3	3	6	0	0	6	0	0
7	14203690	.	A	G	3	3	6	0	1	7	0	0
7	15374420	.	G	A	2	2	4	0	0	4	0	0
7	15607809	.	A	G	5	3	8	1	2	11	0	0
7	15607815	.	A	G	4	0	4	1	4	9	0	0
7	17754811	.	T	A	5	11	16	1	1	19	1	0
7	17942481	.	A	G	1	3	4	0	0	4	0	0
7	17942540	.	A	G	4	2	6	0	0	6	0	0
7	17970124	.	T	A	3	8	11	0	0	11	0	0
7	18464700	.	A	C	5	3	8	0	1	9	0	0
7	19071617	.	T	C	21	7	28	0	0	28	0	0
7	19072665	.	T	C	10	4	14	0	2	16	0	0
7	19073818	.	T	C	5	8	13	0	0	13	0	0
7	19182773	.	T	C	2	4	6	0	0	6	0	0
7	19518544	.	G	A	1	6	7	0	0	7	0	0
7	19681539	.	G	C	4	0	4	0	7	11	0	0
7	19693400	.	A	G	1	2	3	0	0	3	0	0
7	19899331	.	A	G	9	0	9	0	3	12	0	0
7	20053633	.	T	C	2	0	2	0	0	2	0	0
7	20636216	.	A	G	3	4	7	0	0	7	0	0
7	20781592	.	T	C	1	5	6	0	0	6	0	0
7	20781593	.	T	C	2	3	5	0	1	6	0	0
7	20966369	.	G	A	2	7	9	0	0	9	0	0
7	21777213	.	A	T	13	4	17	0	1	18	0	0
7	22295624	.	G	A	1	9	10	0	13	23	0	0
7	22295636	.	T	G	11	1	12	0	11	23	0	0
7	22322131	.	C	T	3	4	7	0	1	8	0	0
7	22322275	.	A	T	1	3	4	0	0	4	0	0
7	22322290	.	T	G	4	1	5	0	0	5	0	0
7	22322330	.	C	T	1	3	4	0	1	5	0	0
7	22322492	.	T	C	1	2	3	0	2	5	0	0
7	22322616	.	C	G	3	2	5	0	0	5	0	0
7	22322931	.	C	T	4	4	8	0	0	8	0	0
7	22323574	.	G	C	2	4	6	0	0	6	0	0
7	22323821	.	A	G	1	4	5	0	1	6	0	0
7	22323884	.	T	G	7	6	13	0	0	13	0	0
7	22323934	.	C	T	3	5	8	0	1	9	0	0
7	22324261	.	C	T	4	5	9	0	0	9	0	0
7	22324371	.	A	C	3	2	5	0	0	5	0	0
7	22324880	.	C	T	3	2	5	0	0	5	0	0
7	22626223	.	T	A	10	4	14	0	1	15	0	0
7	22626525	.	A	T	4	2	6	0	0	6	0	0
7	22630003	.	T	A	20	11	31	0	0	31	0	0
7	22630087	.	A	G	14	18	32	0	3	35	0	0
7	22630096	.	T	C	14	0	14	0	18	32	0	0
7	22630189	.	C	T	20	21	41	0	1	42	0	0
7	22630297	.	A	G	17	12	29	0	0	29	0	0
7	22630581	.	C	T	3	25	28	0	22	50	0	0
7	22630655	.	T	C	24	0	24	0	28	52	0	0
7	22630670	.	A	G	15	28	43	0	1	44	0	0
7	22632253	.	T	A	23	27	50	0	1	51	0	0
7	22632850	.	C	A	0	2	2	0	7	9	0	0
7	22632873	.	G	A	4	2	6	0	0	6	0	0
7	22718516	.	C	T	10	10	20	0	0	20	0	0
7	22718686	.	C	G	8	10	18	0	0	18	0	0
7	22723701	.	G	A	1	10	11	0	10	21	0	0
7	22726604	.	A	G	7	10	17	0	1	18	0	0
7	22732755	.	T	C	11	9	20	0	2	22	0	0
7	22735394	.	C	A	14	15	29	0	1	30	0	0
7	22735421	.	A	T	15	12	27	0	0	27	0	0
7	22751600	.	G	A	12	17	29	0	0	29	0	0
7	22760761	.	G	T	11	9	20	0	2	22	0	0
7	22795566	.	G	A	2	2	4	0	1	5	0	0
7	22795583	.	T	C	2	3	5	0	0	5	0	0
7	22806668	.	G	A	1	15	16	0	16	32	0	0
7	22809956	.	G	A	10	18	28	0	1	29	0	0
7	22810208	.	C	T	15	17	32	0	1	33	0	0
7	22816078	.	G	A	1	23	24	1	10	35	0	0
7	22816487	.	T	C	14	6	20	0	0	20	0	0
7	22819933	.	T	A	22	21	43	1	7	51	0	0
7	22819975	.	A	T	9	13	22	0	16	38	0	0
7	22820704	.	C	G	5	0	5	0	3	8	0	0
7	22824278	.	A	G	26	24	50	0	1	51	0	0
7	22830405	.	G	A	31	19	50	1	3	54	0	0
7	22830423	.	G	A	25	25	50	1	2	53	0	0
7	22833512	.	T	C	16	12	28	0	4	32	0	0
7	22833739	.	C	T	16	10	26	0	0	26	0	0
7	22834021	.	G	A	24	23	47	0	1	48	0	0
7	22838359	.	T	C	25	26	51	0	1	52	0	0
7	22843256	.	A	G	25	20	45	0	0	45	0	0
7	22843310	.	A	T	25	25	50	0	1	51	0	0
7	22849948	.	A	T	21	19	40	0	3	43	0	0
7	22849949	.	C	T	19	21	40	0	1	41	0	0
7	22850098	.	T	C	24	24	48	0	1	49	0	0
7	22850137	.	T	A	29	19	48	0	0	48	0	0
7	22850231	.	T	G	23	18	41	0	0	41	0	0
7	22850234	.	C	T	19	22	41	0	0	41	0	0
7	22850277	.	A	T	17	16	33	0	1	34	0	0
7	22850340	.	T	A	15	16	31	0	1	33	1	0
7	22850365	.	C	T	13	19	32	0	1	33	0	0
7	22850446	.	C	A	18	8	26	0	4	30	0	0
7	22851036	.	C	T	12	16	28	2	1	31	0	0
7	22851133	.	C	T	32	18	50	0	2	52	0	0
7	22851739	.	A	C	29	21	50	0	2	52	0	0
7	22898231	.	C	T	2	2	4	0	0	4	0	0
7	22898354	.	A	T	2	3	5	0	0	5	0	0
7	22898375	.	C	T	1	2	3	0	0	3	0	0
7	22898684	.	C	G	2	3	5	0	0	5	0	0
7	22911938	.	T	C	5	8	13	0	0	13	0	0
7	22911984	.	G	T	2	6	8	0	0	8	0	0
7	22912419	.	G	T	3	4	7	0	0	7	0	0
7	22912642	.	A	G	3	5	8	0	0	8	0	0
7	22912919	.	C	T	1	3	4	0	0	4	0	0
7	22912928	.	G	A	1	2	3	0	0	3	0	0
7	22913385	.	A	T	2	3	5	0	0	5	0	0
7	22913408	.	G	T	2	3	5	0	0	5	0	0
7	22914429	.	G	C	1	3	4	0	0	4	0	0
7	22916341	.	C	T	2	2	4	0	0	4	0	0
7	23000352	.	A	G	1	0	1	0	2	3	0	0
7	23457851	.	T	C	1	2	3	0	0	3	0	0
7	23458202	.	A	G	5	0	5	0	4	9	0	0
7	23482722	.	T	C	5	2	7	0	0	7	0	0
7	23482728	.	C	T	4	3	7	0	1	8	0	0
7	23492044	.	C	A	6	2	8	0	0	8	0	0
7	23492311	.	C	T	3	2	5	0	0	5	0	0
7	23492312	.	A	G	3	2	5	0	0	5	0	0
7	23492695	.	T	C	1	3	4	0	1	5	0	0
7	23492704	.	C	T	2	3	5	0	0	5	0	0
7	23493140	.	G	A	4	5	9	0	0	9	0	0
7	23493168	.	T	C	6	3	9	0	0	9	0	0
7	23493268	.	C	T	2	2	4	0	0	4	0	0
7	23494082	.	T	G	3	2	5	0	0	5	0	0
7	23494107	.	A	T	2	3	5	0	0	5	0	0
7	23496152	.	G	A	9	9	18	0	0	18	0	0
7	23533440	.	G	T	1	11	12	0	13	25	0	0
7	23533464	.	A	G	18	0	18	0	16	34	0	0
7	23536981	.	T	A	20	18	38	0	6	44	0	0
7	23539695	.	C	A	19	15	34	1	2	37	0	0
7	23539824	.	G	A	17	14	31	0	0	31	0	0
7	23539951	.	G	A	1	17	18	0	11	29	0	0
7	23540270	.	T	A	8	12	20	0	2	22	0	0
7	23540323	.	G	A	17	10	27	0	0	27	0	0
7	23540328	.	C	T	17	10	27	0	0	27	0	0
7	23540414	.	T	C	17	9	26	0	1	27	0	0
7	23540505	.	A	C	15	8	23	0	0	24	1	0
7	23540540	.	A	G	15	0	15	0	16	31	0	0
7	23540629	.	T	C	11	15	26	0	0	26	0	0
7	23540643	.	A	G	9	16	25	0	1	26	0	0
7	23540887	.	G	A	18	18	36	0	0	36	0	0
7	23541083	.	C	T	14	13	27	0	0	27	0	0
7	23541230	.	A	C	10	11	21	0	3	24	0	0
7	23541508	.	T	G	9	9	18	0	0	18	0	0
7	23541696	.	G	T	15	12	27	0	2	29	0	0
7	23541847	.	G	C	23	14	37	0	1	38	0	0
7	23541852	.	T	C	21	16	37	0	1	39	1	0
7	23542151	.	T	G	11	7	18	0	0	18	0	0
7	23542543	.	C	T	19	13	32	0	1	33	0	0
7	23542586	.	G	T	12	11	23	0	3	26	0	0
7	23542678	.	C	A	11	14	25	0	0	25	0	0
7	23542785	.	T	G	11	1	12	0	15	27	0	0
7	23542794	.	T	C	14	17	31	0	0	31	0	0
7	23561158	.	C	T	1	8	9	0	5	14	0	0
7	23561431	.	G	A	13	12	25	0	1	26	0	0
7	23561605	.	A	G	12	6	18	0	0	18	0	0
7	23563034	.	C	T	15	16	31	0	0	31	0	0
7	23688670	.	C	G	8	11	19	0	1	20	0	0
7	23691846	.	G	A	12	13	25	0	2	27	0	0
7	23696140	.	C	T	13	10	23	0	0	23	0	0
7	23704869	.	G	A	15	17	32	0	2	34	0	0
7	23707079	.	G	A	18	17	35	0	1	36	0	0
7	23710275	.	T	A	21	22	43	0	2	45	0	0
7	23710311	.	C	T	24	17	41	0	3	44	0	0
7	23713828	.	G	T	7	8	15	0	0	15	0	0
7	23713855	.	T	G	10	1	11	0	10	21	0	0
7	23718778	.	C	G	14	13	27	0	0	27	0	0
7	23718924	.	A	G	19	13	32	0	2	34	0	0
7	23724311	.	T	A	18	13	31	0	1	32	0	0
7	23724418	.	C	T	20	14	34	0	0	34	0	0
7	23724556	.	C	A	10	12	22	2	0	24	0	0
7	23724607	.	C	T	15	19	34	0	1	35	0	0
7	23725087	.	A	G	10	6	16	1	0	17	0	0
7	23725239	.	C	T	7	14	21	0	0	21	0	0
7	23725276	.	T	C	14	10	24	0	0	24	0	0
7	23725285	.	A	T	13	10	23	0	1	24	0	0
7	23725366	.	T	A	13	10	23	0	1	24	0	0
7	23725426	.	C	A	12	13	25	0	0	25	0	0
7	23728312	.	A	G	3	3	6	0	0	6	0	0
7	23728504	.	T	C	6	4	10	0	0	10	0	0
7	23749277	.	G	A	10	13	23	0	0	23	0	0
7	23749490	.	G	A	15	18	33	0	2	35	0	0
7	23749513	.	A	T	17	11	28	0	1	29	0	0
7	23749679	.	A	G	15	10	25	0	1	26	0	0
7	23749831	.	C	A	13	15	28	0	1	29	0	0
7	23749954	.	A	T	14	17	31	0	0	31	0	0
7	23750469	.	T	C	6	1	7	0	15	22	0	0
7	23750477	.	C	T	14	6	20	0	2	22	0	0
7	23750665	.	C	T	12	5	17	0	0	17	0	0
7	23750955	.	C	T	12	9	21	0	1	22	0	0
7	23750962	.	A	T	11	8	19	0	1	20	0	0
7	23750992	.	T	A	10	7	17	0	2	19	0	0
7	23751043	.	C	T	19	9	28	0	1	29	0	0
7	23751106	.	A	C	25	1	26	0	7	33	0	0
7	23751188	.	T	G	5	4	9	1	1	11	0	0
7	23751197	.	A	T	7	4	11	0	0	11	0	0
7	23751291	.	A	G	4	4	8	0	0	8	0	0
7	23751348	.	A	C	7	6	13	0	0	13	0	0
7	23751363	.	A	T	6	7	13	0	0	13	0	0
7	23751866	.	C	G	12	12	24	0	2	26	0	0
7	23752249	.	T	C	11	3	14	0	0	14	0	0
7	23752254	.	T	C	11	3	14	0	0	14	0	0
7	23752519	.	C	T	8	3	11	0	0	11	0	0
7	23753061	.	A	G	7	9	16	0	1	17	0	0
7	23753070	.	T	C	11	7	18	0	1	19	0	0
7	23753154	.	C	T	5	4	9	0	1	10	0	0
7	23753341	.	T	A	15	10	25	0	1	26	0	0
7	23753450	.	A	T	8	8	16	0	0	16	0	0
7	23753713	.	T	C	9	0	9	0	4	13	0	0
7	23753873	.	T	C	2	6	8	0	0	8	0	0
7	23753999	.	A	G	3	4	7	0	0	7	0	0
7	23754338	.	C	T	11	6	17	0	0	17	0	0
7	23754467	.	T	A	8	12	20	0	5	25	0	0
7	23754498	.	G	A	13	8	21	0	1	22	0	0
7	23754878	.	C	T	5	12	17	0	0	17	0	0
7	23754927	.	T	C	6	6	12	0	2	14	0	0
7	23755082	.	C	G	3	4	7	0	0	7	0	0
7	23755354	.	C	T	6	3	9	0	1	10	0	0
7	23755668	.	G	C	7	9	16	0	0	16	0	0
7	23755734	.	C	T	7	5	12	1	3	16	0	0
7	23755994	.	C	T	0	2	2	0	2	4	0	0
7	23756023	.	T	A	2	3	5	0	1	6	0	0
7	23756208	.	T	C	19	9	28	0	3	31	0	0
7	23756475	.	A	G	5	13	18	0	1	19	0	0
7	23756545	.	C	T	3	11	14	0	0	14	0	0
7	23756640	.	A	T	11	6	17	0	0	17	0	0
7	23756645	.	A	C	10	8	18	0	0	18	0	0
7	23768138	.	G	A	10	8	18	0	1	19	0	0
7	23768153	.	G	A	9	7	16	0	0	16	0	0
7	23768222	.	C	A	13	8	21	0	0	21	0	0
7	23854555	.	G	T	2	2	4	0	0	4	0	0
7	23854648	.	A	T	2	2	4	0	0	4	0	0
7	23854661	.	G	A	3	2	5	0	0	5	0	0
7	23854779	.	A	T	2	3	5	0	0	5	0	0
7	23857608	.	A	G	3	2	5	0	0	5	0	0
7	23857923	.	T	C	7	0	7	0	5	12	0	0
7	23857939	.	C	A	3	6	9	0	2	11	0	0
7	23883399	.	G	A	10	12	22	0	1	23	0	0
7	23883548	.	A	C	19	20	39	0	5	44	0	0
7	23883970	.	C	T	12	17	29	0	3	32	0	0
7	23884004	.	G	A	9	20	29	0	0	29	0	0
7	23884058	.	T	C	19	11	30	0	3	33	0	0
7	23884061	.	C	G	19	12	31	0	4	35	0	0
7	23884445	.	C	T	22	23	45	0	3	48	0	0
7	23884641	.	A	G	27	2	29	0	11	40	0	0
7	23884667	.	C	A	17	12	29	0	0	29	0	0
7	23887034	.	G	A	1	3	4	0	1	5	0	0
7	23887604	.	C	G	3	2	5	0	0	5	0	0
7	23887738	.	T	G	8	5	13	0	0	13	0	0
7	23887784	.	C	T	6	11	17	0	0	17	0	0
7	23887865	.	T	C	11	13	24	0	0	24	0	0
7	23888099	.	A	G	7	8	15	0	0	15	0	0
7	23888155	.	T	G	12	10	22	0	2	24	0	0
7	23889947	.	C	T	18	7	25	0	0	25	0	0
7	23892884	.	G	A	8	19	27	0	2	29	0	0
7	23894605	.	G	A	20	13	33	0	1	34	0	0
7	23907703	.	T	G	2	0	2	0	2	4	0	0
7	23907785	.	C	A	29	26	55	0	3	58	0	0
7	23909369	.	A	C	28	26	54	0	1	55	0	0
7	23909456	.	T	G	31	21	52	0	2	54	0	0
7	23909699	.	C	G	28	0	28	0	24	52	0	0
7	23909735	.	T	C	27	24	51	0	1	52	0	0
7	23909757	.	C	T	24	24	48	0	1	49	0	0
7	23909975	.	A	G	27	28	55	0	1	56	0	0
7	23915104	.	G	A	3	22	25	1	34	60	0	0
7	23915203	.	C	T	35	24	59	0	4	63	0	0
7	23915296	.	C	T	31	27	58	0	5	63	0	0
7	23915379	.	T	A	28	31	59	0	1	60	0	0
7	23915485	.	A	T	35	27	62	0	4	66	0	0
7	23915731	.	G	T	22	19	41	0	1	42	0	0
7	23915916	.	T	A	32	22	54	0	3	57	0	0
7	23915926	.	C	T	26	26	52	0	2	54	0	0
7	23915963	.	A	G	22	2	24	0	22	46	0	0
7	23915964	.	A	T	22	24	46	0	0	46	0	0
7	23967515	.	A	C	8	0	8	0	9	17	0	0
7	23967522	.	G	A	9	8	17	0	0	17	0	0
7	23967591	.	G	A	2	7	9	0	2	11	0	0
7	23967596	.	G	A	2	6	8	0	1	9	0	0
7	23967705	.	G	A	4	4	8	0	0	8	0	0
7	23967772	.	A	G	10	18	28	0	1	29	0	0
7	23967861	.	C	T	2	21	23	0	15	38	0	0
7	23967930	.	A	G	16	17	33	0	4	37	0	0
7	23968009	.	T	C	16	0	16	0	18	34	0	0
7	23968108	.	G	A	17	18	35	1	1	37	0	0
7	23968152	.	T	A	15	12	27	1	1	29	0	0
7	23968330	.	C	G	10	7	17	0	1	18	0	0
7	23968344	.	C	T	8	6	14	0	1	15	0	0
7	23968920	.	C	T	26	9	35	0	0	35	0	0
7	23969163	.	G	A	7	5	12	0	1	13	0	0
7	23969191	.	C	T	3	5	8	0	10	18	0	0
7	23969361	.	G	A	10	11	21	0	1	22	0	0
7	23969446	.	C	T	8	13	21	0	0	21	0	0
7	23969535	.	G	A	17	8	25	0	0	25	0	0
7	23969970	.	T	C	6	6	12	4	0	16	0	0
7	23970088	.	C	A	10	4	14	0	1	15	0	0
7	23970428	.	T	C	14	9	23	0	1	24	0	0
7	23970674	.	T	A	1	5	6	0	0	6	0	0
7	23970695	.	T	C	3	8	11	0	1	12	0	0
7	23971181	.	G	C	7	5	12	0	0	12	0	0
7	23971418	.	T	C	9	12	21	0	2	23	0	0
7	23971714	.	G	C	10	11	21	0	0	21	0	0
7	23971728	.	T	G	9	7	16	0	2	18	0	0
7	23974326	.	T	A	13	9	22	0	0	22	0	0
7	23977915	.	C	T	5	8	13	0	0	13	0	0
7	23982433	.	A	G	6	10	16	0	0	16	0	0
7	23984264	.	C	T	5	7	12	0	0	12	0	0
7	24006951	.	G	T	1	2	3	0	2	5	0	0
7	24006992	.	A	T	5	4	9	0	0	9	0	0
7	24007014	.	T	C	3	4	7	0	0	7	0	0
7	24007176	.	G	T	2	8	10	0	0	10	0	0
7	24011926	.	T	C	8	7	15	0	0	15	0	0
7	24013044	.	A	G	6	0	6	0	8	14	0	0
7	24013274	.	A	C	5	4	9	0	0	9	0	0
7	24013560	.	T	C	8	7	15	0	0	15	0	0
7	24013662	.	C	A	6	3	9	0	1	10	0	0
7	24031838	.	G	A	0	4	4	0	4	8	0	0
7	24033572	.	T	A	1	3	4	0	3	7	0	0
7	24033639	.	C	G	4	11	15	0	1	16	0	0
7	24033949	.	G	A	0	2	2	0	8	10	0	0
7	24039773	.	T	C	3	3	6	0	0	6	0	0
7	24041600	.	G	A	3	2	5	0	0	5	0	0
7	24043391	.	G	A	3	10	13	0	0	13	0	0
7	24051024	.	A	G	2	1	3	0	3	6	0	0
7	24052845	.	T	A	2	3	5	0	0	5	0	0
7	24053314	.	G	A	1	2	3	0	0	3	0	0
7	24053451	.	G	A	4	3	7	0	0	7	0	0
7	24053553	.	A	G	4	3	7	0	0	7	0	0
7	24053575	.	A	G	4	0	4	0	4	8	0	0
7	24053689	.	C	T	4	4	8	0	0	8	0	0
7	24053850	.	C	T	3	5	8	0	0	8	0	0
7	24059570	.	C	T	10	8	18	0	0	18	0	0
7	24059705	.	G	A	6	8	14	0	0	14	0	0
7	24059773	.	C	T	13	7	20	0	0	20	0	0
7	24059861	.	C	G	11	4	15	0	1	16	0	0
7	24059873	.	C	T	9	4	13	0	3	16	0	0
7	24060071	.	A	C	7	10	17	0	0	17	0	0
7	24060107	.	G	T	4	6	10	0	0	10	0	0
7	24066825	.	C	T	3	4	7	0	0	7	0	0
7	24067359	.	C	T	2	6	8	0	0	8	0	0
7	24067403	.	A	T	8	7	15	0	0	15	0	0
7	24067571	.	C	T	10	7	17	0	1	18	0	0
7	24067611	.	C	T	8	9	17	0	1	18	0	0
7	24067906	.	C	A	8	8	16	0	1	17	0	0
7	24067907	.	T	A	7	9	16	0	1	17	0	0
7	24068078	.	T	G	5	4	9	0	0	9	0	0
7	24068230	.	C	T	9	11	20	0	0	20	0	0
7	24068491	.	C	T	10	3	13	0	0	13	0	0
7	24068523	.	C	A	5	7	12	0	0	12	0	0
7	24068722	.	T	C	2	7	9	0	0	9	0	0
7	24068868	.	G	A	0	2	2	0	4	6	0	0
7	24069484	.	T	C	8	6	14	0	0	14	0	0
7	24072217	.	C	T	13	6	19	0	1	20	0	0
7	24075155	.	C	G	3	9	12	0	0	12	0	0
7	24075226	.	C	G	12	10	22	0	0	22	0	0
7	24075776	.	C	T	10	9	19	0	0	19	0	0
7	24075842	.	A	C	14	7	21	0	1	22	0	0
7	24075911	.	G	A	9	6	15	0	1	16	0	0
7	24076009	.	A	T	6	4	10	0	1	11	0	0
7	24076044	.	A	C	6	5	11	0	0	11	0	0
7	24076086	.	C	A	6	6	12	0	1	13	0	0
7	24076088	.	A	G	7	7	14	0	0	14	0	0
7	24076192	.	C	T	0	14	14	0	1	15	0	0
7	24076198	.	C	T	12	8	20	0	1	21	0	0
7	24076269	.	C	T	11	9	20	0	2	22	0	0
7	24076329	.	C	T	11	18	29	0	2	31	0	0
7	24076373	.	C	T	13	12	25	0	1	26	0	0
7	24084783	.	C	T	17	21	38	0	1	39	0	0
7	24084887	.	G	A	0	12	12	0	10	22	0	0
7	24087255	.	C	A	3	6	9	0	0	9	0	0
7	24087362	.	A	T	10	6	16	0	0	16	0	0
7	24087365	.	T	C	6	9	15	0	0	15	0	0
7	24087453	.	C	G	6	4	10	0	0	10	0	0
7	24087622	.	T	A	6	5	11	0	0	11	0	0
7	24087724	.	C	A	5	7	12	0	0	12	0	0
7	24090128	.	A	G	18	0	18	0	10	28	0	0
7	24090182	.	G	A	11	17	28	0	0	28	0	0
7	24091249	.	A	G	10	14	24	1	0	25	0	0
7	24091269	.	G	A	3	12	15	1	11	27	0	0
7	24092626	.	C	T	9	13	22	0	2	24	0	0
7	24093102	.	C	T	19	20	39	0	3	42	0	0
7	24093105	.	C	T	21	22	43	0	2	45	0	0
7	24095717	.	G	A	1	15	16	0	18	34	0	0
7	24095788	.	A	G	15	18	33	0	1	34	0	0
7	24095836	.	C	T	9	14	23	0	3	26	0	0
7	24095848	.	G	A	11	17	28	0	0	28	0	0
7	24095978	.	T	A	11	22	33	0	2	35	0	0
7	24096015	.	C	T	22	11	33	0	2	35	0	0
7	24096165	.	T	C	16	22	38	0	2	40	0	0
7	24096195	.	C	G	15	20	35	0	2	37	0	0
7	24096447	.	T	G	19	20	39	0	1	40	0	0
7	24096541	.	C	T	14	11	25	2	1	28	0	0
7	24153839	.	T	C	4	6	10	0	0	10	0	0
7	24153885	.	G	A	3	4	7	0	0	7	0	0
7	24154878	.	C	T	6	2	8	0	0	8	0	0
7	24156373	.	A	G	4	3	7	0	1	8	0	0
7	24156994	.	G	A	0	2	2	0	6	8	0	0
7	24158843	.	A	G	9	0	9	0	11	20	0	0
7	24158918	.	G	A	0	7	7	0	3	10	0	0
7	24159155	.	G	T	2	6	8	0	0	8	0	0
7	24159248	.	C	A	6	5	11	0	0	11	0	0
7	24159284	.	G	A	4	6	10	0	0	10	0	0
7	24161776	.	C	G	9	6	15	0	2	17	0	0
7	24161786	.	G	C	10	8	18	0	1	19	0	0
7	24162267	.	G	T	10	8	18	0	3	21	0	0
7	24162368	.	A	T	3	9	12	0	2	14	0	0
7	24162369	.	A	C	4	9	13	0	1	14	0	0
7	24162457	.	T	C	7	8	15	0	3	18	0	0
7	24162567	.	T	C	12	4	16	0	0	16	0	0
7	24162761	.	G	T	5	5	10	0	0	10	0	0
7	24162782	.	G	A	6	2	8	0	1	9	0	0
7	24197607	.	A	T	6	4	10	0	0	10	0	0
7	24197622	.	G	T	1	4	5	0	0	5	0	0
7	24197793	.	C	T	0	2	2	0	1	3	0	0
7	24197916	.	A	G	2	3	5	0	1	6	0	0
7	24197962	.	T	C	3	0	3	0	5	8	0	0
7	24198146	.	T	C	6	2	8	0	0	8	0	0
7	24198281	.	T	C	1	6	7	0	0	7	0	0
7	24200052	.	C	T	2	10	12	0	14	26	0	0
7	24200112	.	A	G	11	4	15	0	0	15	0	0
7	24201447	.	A	T	12	9	21	0	1	22	0	0
7	24201453	.	G	A	14	10	24	0	0	24	0	0
7	24201686	.	A	G	13	13	26	0	1	27	0	0
7	24204166	.	T	A	10	7	17	0	1	18	0	0
7	24204660	.	C	A	0	2	2	0	1	3	0	0
7	24205077	.	C	A	15	6	21	0	2	23	0	0
7	24210323	.	C	T	1	13	14	0	8	22	0	0
7	24210656	.	A	C	16	21	37	1	2	40	0	0
7	24210913	.	T	C	11	1	12	0	18	30	0	0
7	24211027	.	G	T	13	14	27	0	0	27	0	0
7	24211104	.	C	T	4	15	19	0	13	32	0	0
7	24211342	.	C	T	0	18	18	0	11	29	0	0
7	24211443	.	C	T	1	9	10	0	16	26	0	0
7	24211560	.	A	T	4	8	12	0	0	12	0	0
7	24211672	.	A	T	7	5	12	0	0	12	0	0
7	24211785	.	T	A	1	2	3	0	0	3	0	0
7	24211911	.	A	T	3	3	6	0	0	6	0	0
7	24212093	.	C	G	17	18	35	0	0	35	0	0
7	24212122	.	T	C	13	12	25	0	0	25	0	0
7	24212383	.	G	A	13	16	29	0	2	32	1	0
7	24213387	.	A	T	14	10	24	0	1	25	0	0
7	24213401	.	G	A	11	16	27	0	1	28	0	0
7	24213426	.	G	A	11	15	26	0	1	27	0	0
7	24214673	.	C	A	17	13	30	0	1	31	0	0
7	24219052	.	A	G	12	4	16	0	1	17	0	0
7	24227149	.	T	G	8	11	19	0	0	19	0	0
7	24235722	.	G	T	4	3	7	0	0	7	0	0
7	24235936	.	A	C	4	7	11	0	0	11	0	0
7	24236177	.	C	G	11	13	24	0	0	24	0	0
7	24341474	.	A	G	2	2	4	0	0	4	0	0
7	24357396	.	C	T	0	2	2	0	1	3	0	0
7	24357403	.	C	T	2	3	5	0	0	5	0	0
7	24377040	.	G	A	3	8	11	0	0	11	0	0
7	24377237	.	A	G	10	3	13	0	1	14	0	0
7	24378317	.	C	A	9	5	14	0	0	14	0	0
7	24378422	.	C	A	7	3	10	0	0	10	0	0
7	24378432	.	G	A	7	2	9	0	0	9	0	0
7	24380652	.	C	A	10	3	13	0	0	13	0	0
7	24457647	.	A	T	27	27	54	0	3	58	1	0
7	24457691	.	C	A	26	27	53	0	1	54	0	0
7	24457788	.	C	A	26	17	43	0	3	46	0	0
7	24457803	.	A	C	24	17	41	0	0	41	0	0
7	24457845	.	T	C	33	10	43	0	0	43	0	0
7	24458103	.	C	A	30	12	42	0	1	43	0	0
7	24458205	.	G	A	30	23	53	0	1	54	0	0
7	24458513	.	T	C	20	29	49	0	0	49	0	0
7	24458713	.	T	C	20	0	20	0	15	35	0	0
7	24458717	.	G	A	18	14	32	0	1	33	0	0
7	24459452	.	G	A	25	19	44	0	0	44	0	0
7	24459667	.	T	A	17	25	42	0	3	45	0	0
7	24460025	.	G	A	13	19	32	0	4	36	0	0
7	24460026	.	C	T	15	18	33	0	3	36	0	0
7	24460189	.	T	C	13	15	28	0	1	29	0	0
7	24470812	.	A	G	24	27	51	1	1	53	0	0
7	24486546	.	G	C	26	26	52	0	1	56	3	0
7	24486822	.	G	A	31	29	60	0	1	61	0	0
7	24489888	.	A	G	38	24	62	0	0	62	0	0
7	24491382	.	G	A	38	26	64	0	2	66	0	0
7	24497012	.	G	A	5	7	12	0	1	13	0	0
7	24501133	.	G	A	1	3	4	0	12	16	0	0
7	24501168	.	T	C	6	7	13	0	1	14	0	0
7	24502016	.	C	T	11	10	21	0	0	21	0	0
7	24502858	.	G	A	1	10	11	0	12	23	0	0
7	24502867	.	C	T	10	9	19	0	2	21	0	0
7	24502948	.	C	T	10	10	20	0	1	21	0	0
7	24528917	.	T	A	12	3	15	0	1	16	0	0
7	24529257	.	G	A	1	2	3	0	1	4	0	0
7	24551057	.	G	C	1	4	5	0	0	5	0	0
7	24569961	.	T	C	5	8	13	0	6	19	0	0
7	24569990	.	T	G	10	11	21	0	1	22	0	0
7	24570012	.	A	T	12	12	24	0	0	24	0	0
7	24570714	.	G	A	1	3	4	0	9	13	0	0
7	24570973	.	G	A	1	4	5	0	0	5	0	0
7	24593439	.	T	C	8	9	17	0	1	18	0	0
7	24593452	.	T	A	9	11	20	0	1	21	0	0
7	24594860	.	T	A	9	11	20	0	1	21	0	0
7	24598728	.	G	T	8	9	17	0	1	18	0	0
7	24603028	.	G	T	7	13	20	0	2	22	0	0
7	24603231	.	C	T	1	12	13	0	5	18	0	0
7	24612524	.	G	A	8	10	18	0	0	18	0	0
7	24612623	.	C	T	7	6	13	0	0	13	0	0
7	24616240	.	G	A	8	9	17	0	0	17	0	0
7	24621385	.	C	T	5	7	12	0	0	12	0	0
7	24621480	.	T	C	7	3	10	0	0	10	0	0
7	24621564	.	A	C	6	2	8	0	1	9	0	0
7	24631757	.	C	A	2	2	4	0	0	4	0	0
7	24632080	.	C	T	1	4	5	0	6	11	0	0
7	24635159	.	G	A	2	9	11	0	1	12	0	0
7	24637765	.	C	A	5	4	9	0	1	10	0	0
7	24637934	.	T	C	7	4	11	0	0	11	0	0
7	24638015	.	C	A	1	7	8	0	9	17	0	0
7	24640622	.	T	C	9	7	16	0	0	16	0	0
7	24643742	.	C	T	4	2	6	0	0	6	0	0
7	24644434	.	G	C	11	9	20	0	1	21	0	0
7	24644446	.	A	C	12	7	19	0	1	20	0	0
7	24645292	.	A	G	6	7	13	0	0	13	0	0
7	24645402	.	G	A	5	3	8	0	0	8	0	0
7	24646602	.	T	C	4	6	10	1	0	11	0	0
7	24649421	.	C	T	9	6	15	0	0	15	0	0
7	24649610	.	G	C	5	3	8	0	0	8	0	0
7	24649694	.	T	C	9	6	15	0	0	15	0	0
7	24651636	.	C	T	8	6	14	0	1	15	0	0
7	24651645	.	G	A	9	5	14	0	1	15	0	0
7	24652951	.	A	G	8	0	8	0	5	13	0	0
7	24653020	.	G	A	3	4	7	0	1	8	0	0
7	24653068	.	C	T	8	4	12	0	1	13	0	0
7	24653079	.	G	A	8	6	14	0	1	15	0	0
7	24653121	.	G	A	10	11	21	0	0	21	0	0
7	24655086	.	T	A	10	8	18	0	0	18	0	0
7	24655094	.	T	C	10	8	18	0	0	18	0	0
7	24655261	.	A	G	5	7	12	0	0	12	0	0
7	24658938	.	G	A	0	7	7	0	8	15	0	0
7	24663995	.	T	C	2	9	11	0	0	11	0	0
7	24672147	.	A	G	15	0	15	0	10	25	0	0
7	24672257	.	G	C	14	16	30	0	1	31	0	0
7	24672721	.	G	T	0	2	2	0	2	4	0	0
7	24681673	.	A	G	26	23	49	0	1	50	0	0
7	24681731	.	T	C	26	25	51	0	3	54	0	0
7	24681755	.	A	G	25	25	50	0	2	52	0	0
7	24681806	.	A	G	19	20	39	0	2	41	0	0
7	24697400	.	T	C	16	15	31	0	0	31	0	0
7	24699881	.	G	T	15	13	28	0	0	28	0	0
7	24715058	.	T	C	1	2	3	0	0	3	0	0
7	24715143	.	G	A	2	4	6	0	0	6	0	0
7	24715168	.	A	C	2	5	7	0	0	7	0	0
7	24715361	.	T	C	1	4	5	0	0	5	0	0
7	24715870	.	C	T	0	2	2	0	4	6	0	0
7	24715879	.	C	T	4	2	6	0	0	6	0	0
7	24716056	.	G	T	1	2	3	0	1	4	0	0
7	24716258	.	C	T	4	3	7	0	0	7	0	0
7	24716373	.	G	A	1	3	4	0	0	4	0	0
7	24716393	.	G	T	1	3	4	0	0	4	0	0
7	24716508	.	T	G	4	3	7	0	0	7	0	0
7	24716697	.	T	C	2	6	8	0	0	8	0	0
7	24717234	.	A	T	3	4	7	0	0	7	0	0
7	24717322	.	T	G	2	2	4	0	0	4	0	0
7	24717327	.	T	G	2	2	4	0	0	4	0	0
7	24792792	.	T	C	2	2	4	0	0	4	0	0
7	24792813	.	T	C	1	2	3	0	0	3	0	0
7	24795979	.	C	A	2	3	5	0	0	5	0	0
7	24796095	.	A	C	5	3	8	0	0	8	0	0
7	24796137	.	G	A	1	2	3	0	3	6	0	0
7	24801593	.	G	A	0	5	5	0	2	7	0	0
7	24801682	.	G	A	1	3	4	0	1	5	0	0
7	24801886	.	G	A	5	7	12	0	0	12	0	0
7	24801920	.	G	T	0	4	4	0	5	9	0	0
7	24801961	.	T	A	1	2	3	0	1	4	0	0
7	24812538	.	G	C	3	4	7	0	0	7	0	0
7	24812587	.	C	T	6	5	11	0	0	11	0	0
7	24812783	.	A	G	2	0	2	0	2	4	0	0
7	24812829	.	A	G	2	2	4	0	0	4	0	0
7	24815992	.	C	T	11	9	20	0	0	20	0	0
7	24819788	.	G	A	25	19	44	0	1	45	0	0
7	24819812	.	G	A	28	17	45	0	1	46	0	0
7	24822914	.	G	A	20	18	38	0	1	39	0	0
7	24830127	.	G	A	0	2	2	0	1	3	0	0
7	24887998	.	C	A	1	2	3	0	0	3	0	0
7	24888110	.	C	G	1	2	3	0	0	3	0	0
7	24888986	.	T	C	9	6	15	0	0	15	0	0
7	24889051	.	G	C	0	5	5	0	6	11	0	0
7	24889617	.	T	G	7	0	7	0	7	14	0	0
7	24889758	.	T	C	8	9	17	0	2	19	0	0
7	24889808	.	C	G	9	5	14	1	1	16	0	0
7	24923112	.	G	A	1	7	8	0	9	17	0	0
7	24944724	.	C	T	9	8	17	0	0	17	0	0
7	24946895	.	C	T	10	11	21	0	0	21	0	0
7	24946913	.	T	C	9	11	20	0	1	21	0	0
7	24947440	.	T	C	9	13	22	0	1	23	0	0
7	24974916	.	T	C	13	11	24	1	1	26	0	0
7	24974937	.	T	C	12	11	23	1	0	24	0	0
7	24975264	.	T	C	14	17	31	0	1	32	0	0
7	24975646	.	C	T	13	12	25	0	1	26	0	0
7	24975678	.	G	A	12	11	23	0	0	23	0	0
7	24976539	.	T	C	14	16	30	0	0	30	0	0
7	24979979	.	A	G	2	4	6	0	0	6	0	0
7	24980107	.	T	G	3	5	8	0	0	8	0	0
7	24980185	.	T	G	3	6	9	0	0	9	0	0
7	24980469	.	C	T	10	12	22	0	0	22	0	0
7	24983328	.	C	T	2	13	15	0	6	21	0	0
7	24984869	.	G	T	7	4	11	0	0	11	0	0
7	24985300	.	A	C	1	0	1	0	8	9	0	0
7	25010745	.	C	T	25	19	44	0	1	45	0	0
7	25011238	.	A	G	14	6	20	0	0	20	0	0
7	25011375	.	T	C	7	5	12	0	0	12	0	0
7	25015154	.	C	T	5	7	12	0	0	12	0	0
7	25015239	.	C	T	6	10	16	0	3	19	0	0
7	25015419	.	T	C	7	6	13	2	0	15	0	0
7	25015424	.	G	A	6	4	10	2	1	13	0	0
7	25017967	.	G	C	8	12	20	0	0	20	0	0
7	25018043	.	G	T	7	6	13	0	0	14	1	0
7	25021647	.	T	G	6	13	19	0	0	19	0	0
7	25021697	.	T	C	10	13	23	0	0	23	0	0
7	25021718	.	C	T	12	8	20	0	1	21	0	0
7	25024266	.	T	C	10	8	18	0	0	18	0	0
7	25024277	.	A	T	10	10	20	0	0	20	0	0
7	25024346	.	G	C	2	10	12	3	15	30	0	0
7	25026873	.	C	T	13	4	17	0	0	17	0	0
7	25026960	.	C	T	9	8	17	0	0	17	0	0
7	25027022	.	T	C	9	11	20	0	0	20	0	0
7	25027034	.	A	G	8	14	22	0	0	22	0	0
7	25027208	.	G	A	8	8	16	0	0	16	0	0
7	25027211	.	G	T	1	7	8	0	9	17	0	0
7	25027397	.	T	C	5	3	8	0	0	8	0	0
7	25027399	.	T	G	4	3	7	0	1	8	0	0
7	25027466	.	C	A	5	4	9	0	2	11	0	0
7	25027561	.	C	T	6	10	16	0	1	17	0	0
7	25027571	.	A	G	6	11	17	0	1	18	0	0
7	25027756	.	T	C	11	5	16	0	1	17	0	0
7	25028034	.	C	T	9	4	13	0	1	14	0	0
7	25028081	.	A	G	9	7	16	0	2	18	0	0
7	25028085	.	G	C	12	8	20	0	0	20	0	0
7	25028205	.	T	A	11	10	21	0	0	22	1	0
7	25028219	.	C	G	9	9	18	0	0	18	0	0
7	25028440	.	A	T	6	3	9	0	1	10	0	0
7	25028598	.	A	G	5	4	9	0	1	10	0	0
7	25028627	.	T	A	8	5	13	0	0	13	0	0
7	25029169	.	G	A	1	2	3	0	0	3	0	0
7	25029191	.	G	A	0	2	2	0	1	3	0	0
7	25042942	.	A	C	10	12	22	0	1	23	0	0
7	25045642	.	C	T	3	2	5	0	0	5	0	0
7	25045777	.	A	G	11	8	19	0	0	19	0	0
7	25047228	.	A	C	1	5	6	0	0	6	0	0
7	25047307	.	G	C	5	6	11	0	1	12	0	0
7	25047318	.	A	C	7	6	13	0	1	14	0	0
7	25047441	.	T	G	9	16	25	0	2	27	0	0
7	25047604	.	T	A	5	10	15	0	0	15	0	0
7	25047954	.	G	A	10	18	28	0	0	28	0	0
7	25049262	.	A	G	12	13	25	0	1	26	0	0
7	25059856	.	C	T	25	16	41	0	0	41	0	0
7	25096889	.	T	C	15	12	27	1	2	30	0	0
7	25098910	.	G	A	35	20	55	0	1	56	0	0
7	25099133	.	A	G	36	3	39	0	15	54	0	0
7	25099302	.	T	C	12	11	23	0	2	25	0	0
7	25099594	.	T	G	14	15	29	0	1	30	0	0
7	25099704	.	T	C	19	18	37	0	1	38	0	0
7	25128575	.	T	A	1	2	3	0	0	3	0	0
7	25211895	.	T	G	1	0	1	0	3	4	0	0
7	25211901	.	A	G	1	3	4	0	0	4	0	0
7	25292455	.	T	C	6	4	10	0	0	10	0	0
7	25292978	.	G	A	1	3	4	0	2	6	0	0
7	25293123	.	C	A	2	2	4	0	0	4	0	0
7	25293131	.	G	T	3	2	5	0	0	5	0	0
7	25293261	.	T	C	5	5	10	0	0	10	0	0
7	25293666	.	A	G	5	4	9	0	0	9	0	0
7	25339872	.	A	T	3	3	6	0	0	6	0	0
7	25341280	.	G	A	0	5	5	0	6	11	0	0
7	25346765	.	T	C	4	5	9	0	0	9	0	0
7	25346924	.	G	C	2	9	11	0	12	23	0	0
7	25347024	.	C	T	8	8	16	0	0	16	0	0
7	25347459	.	T	G	13	14	27	0	1	28	0	0
7	25347679	.	A	T	8	3	11	0	0	11	0	0
7	25348031	.	C	T	3	5	8	0	0	8	0	0
7	25558952	.	C	A	1	4	5	0	3	8	0	0
7	25559010	.	T	C	2	5	7	0	0	7	0	0
7	25559093	.	A	G	1	3	4	0	0	4	0	0
7	25559362	.	C	G	1	2	3	0	1	4	0	0
7	25559380	.	C	T	1	4	5	0	0	5	0	0
7	25561039	.	T	G	1	2	3	0	0	3	0	0
7	25561094	.	A	T	1	3	4	0	0	4	0	0
7	25564797	.	T	C	2	2	4	0	0	4	0	0
7	25843605	.	A	C	2	6	8	0	0	8	0	0
7	25843661	.	G	A	5	5	10	0	1	11	0	0
7	25846562	.	C	T	2	6	8	0	0	8	0	0
7	25854239	.	T	C	3	9	12	0	0	12	0	0
7	25854245	.	C	G	3	9	12	0	0	12	0	0
7	25854290	.	A	G	2	3	5	0	1	6	0	0
7	25863631	.	C	T	14	10	24	0	0	24	0	0
7	25867412	.	C	T	18	11	29	0	0	29	0	0
7	25869960	.	C	T	8	13	21	0	0	21	0	0
7	25870003	.	C	T	16	8	24	0	1	25	0	0
7	25870065	.	C	T	11	9	20	0	1	21	0	0
7	25870068	.	T	C	12	8	20	0	2	22	0	0
7	25872580	.	C	T	13	11	24	0	2	26	0	0
7	25872691	.	G	A	1	7	8	0	12	20	0	0
7	25873009	.	C	T	17	9	26	0	0	26	0	0
7	25873601	.	A	T	17	13	30	0	2	32	0	0
7	25873728	.	T	G	20	0	20	0	12	32	0	0
7	25873743	.	C	A	24	13	37	0	1	38	0	0
7	25873857	.	T	C	12	15	27	0	1	28	0	0
7	25877033	.	A	T	13	16	29	0	1	30	0	0
7	25877038	.	G	A	14	17	31	0	1	32	0	0
7	25877420	.	T	C	13	7	20	0	2	22	0	0
7	25877445	.	G	C	9	10	19	0	3	22	0	0
7	25877541	.	T	A	4	2	6	0	0	6	0	0
7	25877553	.	G	A	1	2	3	0	3	6	0	0
7	25877615	.	A	G	2	0	2	0	2	4	0	0
7	25877622	.	C	T	2	3	5	0	0	5	0	0
7	25878282	.	G	A	11	18	29	0	2	31	0	0
7	25878417	.	T	G	11	5	16	0	0	16	0	0
7	25878432	.	C	T	4	6	10	0	1	11	0	0
7	25878642	.	G	T	13	10	23	0	0	23	0	0
7	25878723	.	A	C	22	23	45	0	1	46	0	0
7	25878786	.	C	T	2	19	21	0	30	51	0	0
7	25878849	.	T	C	18	16	34	0	4	38	0	0
7	25878901	.	G	A	16	16	32	0	1	33	0	0
7	25879514	.	T	A	17	18	35	0	0	35	0	0
7	25879534	.	C	T	21	14	35	0	2	37	0	0
7	25879637	.	A	G	24	15	39	5	2	46	0	0
7	25879787	.	C	G	13	24	37	0	2	39	0	0
7	25879887	.	A	G	19	21	40	0	1	41	0	0
7	25879920	.	G	T	17	21	38	0	1	39	0	0
7	25879936	.	G	A	14	26	40	0	1	41	0	0
7	25880033	.	A	T	14	17	31	0	1	32	0	0
7	25880226	.	G	A	12	9	21	0	0	21	0	0
7	25880340	.	C	T	3	16	19	0	23	42	0	0
7	25880413	.	G	A	24	23	47	0	2	49	0	0
7	25880843	.	G	A	14	20	34	0	0	34	0	0
7	25880979	.	C	G	15	17	32	0	3	35	0	0
7	25881103	.	T	G	14	17	31	0	2	33	0	0
7	25881303	.	C	T	22	17	39	0	0	39	0	0
7	25881583	.	G	A	19	11	30	2	4	36	0	0
7	25881589	.	C	T	11	8	19	2	13	39	5	0
7	25884007	.	G	T	29	13	42	0	1	43	0	0
7	25884282	.	G	A	21	23	44	1	1	46	0	0
7	25884285	.	T	A	22	23	45	1	0	46	0	0
7	25895150	.	A	G	25	16	41	0	0	41	0	0
7	25895154	.	G	T	24	15	39	0	0	39	0	0
7	25895388	.	T	C	2	0	2	0	4	6	0	0
7	25918056	.	C	T	32	31	63	3	8	74	0	0
7	25918112	.	A	T	35	22	57	0	0	57	0	0
7	25918252	.	G	A	1	3	4	0	0	4	0	0
7	25979203	.	T	A	19	11	30	0	2	32	0	0
7	25979372	.	C	T	22	18	40	0	2	42	0	0
7	25979510	.	T	C	26	24	50	0	2	52	0	0
7	25986186	.	A	G	19	0	19	0	20	39	0	0
7	25998602	.	C	T	32	18	50	0	0	50	0	0
7	26002674	.	C	T	14	21	35	0	1	36	0	0
7	26002812	.	T	C	21	14	35	0	4	39	0	0
7	26002915	.	T	A	19	17	36	0	2	38	0	0
7	26003424	.	G	A	13	20	33	0	3	36	0	0
7	26004391	.	C	A	14	10	24	0	0	24	0	0
7	26004519	.	G	A	9	19	28	0	2	30	0	0
7	26004876	.	T	A	9	9	18	1	0	19	0	0
7	26004907	.	A	G	4	0	4	1	6	11	0	0
7	26005033	.	A	G	2	6	8	0	1	9	0	0
7	26008444	.	A	G	6	7	13	0	0	13	0	0
7	26011665	.	A	T	6	6	12	0	1	13	0	0
7	26015595	.	C	A	15	14	29	0	1	30	0	0
7	26015628	.	T	C	17	14	31	0	0	31	0	0
7	26015663	.	T	C	14	15	29	0	1	31	1	0
7	26015693	.	C	A	16	19	35	0	0	35	0	0
7	26020174	.	A	T	11	10	21	0	0	21	0	0
7	26020192	.	C	T	11	15	26	0	1	27	0	0
7	26020659	.	C	T	17	12	29	0	1	30	0	0
7	26020779	.	C	T	14	11	25	0	1	26	0	0
7	26020927	.	A	T	11	6	17	0	0	17	0	0
7	26021146	.	A	G	18	11	29	0	1	30	0	0
7	26026114	.	A	G	18	0	18	0	9	27	0	0
7	26026176	.	C	T	8	11	19	0	0	19	0	0
7	26026188	.	C	A	7	12	19	0	1	20	0	0
7	26026220	.	A	T	10	7	17	0	1	19	1	0
7	26048541	.	G	A	4	2	6	0	0	6	0	0
7	26051750	.	C	T	1	2	3	0	0	3	0	0
7	26073519	.	A	T	4	4	8	0	1	9	0	0
7	26076531	.	G	C	3	9	12	0	0	12	0	0
7	26077845	.	G	T	24	18	42	0	1	43	0	0
7	26077947	.	T	A	23	30	53	0	2	55	0	0
7	26077949	.	C	T	23	29	52	0	2	54	0	0
7	26078061	.	T	C	22	19	41	2	2	45	0	0
7	26078345	.	T	A	34	18	52	0	0	52	0	0
7	26078897	.	G	A	33	21	54	0	2	56	0	0
7	26078947	.	G	A	31	14	45	0	1	46	0	0
7	26078967	.	A	G	26	26	52	1	3	56	0	0
7	26078983	.	G	A	27	20	47	1	1	49	0	0
7	26079667	.	C	G	4	25	29	0	26	55	0	0
7	26081252	.	A	G	24	24	48	0	1	49	0	0
7	26081546	.	T	G	21	27	48	0	1	49	0	0
7	26081744	.	T	C	16	28	44	0	2	46	0	0
7	26081951	.	T	C	22	18	40	0	1	41	0	0
7	26082371	.	G	A	13	11	24	0	0	24	0	0
7	26082428	.	A	G	11	15	26	0	0	26	0	0
7	26122110	.	C	T	2	1	3	0	1	4	0	0
7	26122433	.	T	G	1	3	4	0	0	4	0	0
7	26132724	.	C	T	27	23	50	0	1	51	0	0
7	26132743	.	C	T	22	27	49	0	0	49	0	0
7	26141022	.	C	T	34	17	51	0	3	54	0	0
7	26141310	.	C	T	30	21	51	0	4	55	0	0
7	26141394	.	G	C	18	17	35	0	0	35	0	0
7	26141568	.	T	A	31	27	58	0	1	59	0	0
7	26141853	.	C	T	20	20	40	0	1	41	0	0
7	26142315	.	T	A	13	12	25	0	5	30	0	0
7	26142489	.	G	A	29	25	54	0	0	54	0	0
7	26142702	.	A	G	17	34	51	0	2	53	0	0
7	26142736	.	A	T	18	30	48	0	0	48	0	0
7	26143022	.	G	A	22	13	35	0	0	35	0	0
7	26143343	.	A	G	14	17	31	0	1	32	0	0
7	26143668	.	G	T	10	18	28	0	23	51	0	0
7	26144271	.	A	G	32	2	34	0	22	56	0	0
7	26144305	.	T	A	30	28	58	0	1	59	0	0
7	26144684	.	A	G	6	5	11	0	1	12	0	0
7	26144882	.	A	G	18	3	21	0	31	52	0	0
7	26144944	.	A	G	18	2	20	0	22	42	0	0
7	26145252	.	A	C	19	30	49	0	0	49	0	0
7	26145267	.	T	A	19	28	47	0	0	47	0	0
7	26145329	.	T	A	35	19	54	0	5	59	0	0
7	26145441	.	C	G	18	17	35	0	0	35	0	0
7	26145451	.	A	G	21	15	36	0	0	36	0	0
7	26145491	.	G	A	27	18	45	0	0	45	0	0
7	26145492	.	G	A	27	17	44	0	1	45	0	0
7	26145703	.	C	T	8	3	11	0	0	11	0	0
7	26145873	.	C	T	8	10	18	0	0	18	0	0
7	26145910	.	T	C	17	11	28	0	0	28	0	0
7	26146411	.	T	C	33	26	59	0	2	61	0	0
7	26146796	.	A	G	28	3	31	0	30	61	0	0
7	26146952	.	A	G	34	35	69	0	2	71	0	0
7	26146993	.	C	T	33	35	68	0	1	69	0	0
7	26146998	.	G	A	5	32	37	0	36	73	0	0
7	26147167	.	T	C	36	27	63	0	0	63	0	0
7	26147756	.	C	T	33	38	71	0	0	71	0	0
7	26148169	.	C	T	35	35	70	0	2	72	0	0
7	26148260	.	A	G	45	0	45	0	16	61	0	0
7	26148263	.	A	G	43	17	60	0	3	63	0	0
7	26148567	.	T	C	36	23	59	0	1	60	0	0
7	26148796	.	C	T	6	4	10	0	2	12	0	0
7	26149067	.	C	T	13	22	35	0	2	37	0	0
7	26149069	.	A	T	13	22	35	0	3	38	0	0
7	26149252	.	G	A	26	30	56	0	0	56	0	0
7	26149690	.	C	T	28	23	51	0	4	55	0	0
7	26150096	.	T	A	16	25	41	0	0	41	0	0
7	26150195	.	G	A	14	4	18	0	1	19	0	0
7	26179837	.	C	T	4	3	7	0	0	7	0	0
7	26226977	.	C	T	22	25	47	0	2	49	0	0
7	26227119	.	C	T	31	23	54	0	0	54	0	0
7	26227242	.	T	C	28	29	57	0	4	61	0	0
7	26228290	.	C	T	20	24	44	0	1	45	0	0
7	26229529	.	C	T	30	21	51	0	1	52	0	0
7	26229584	.	G	A	1	26	27	3	26	56	0	0
7	26245318	.	T	A	10	13	23	0	0	23	0	0
7	26246528	.	T	C	12	0	12	0	14	26	0	0
7	26263153	.	C	T	9	14	23	0	0	23	0	0
7	26265875	.	T	G	4	2	6	0	0	6	0	0
7	26265877	.	T	C	4	2	6	0	0	6	0	0
7	26266096	.	A	G	7	2	9	0	1	10	0	0
7	26266126	.	T	C	8	1	9	0	5	14	0	0
7	26266295	.	C	T	1	10	11	0	6	17	0	0
7	26268579	.	C	T	3	2	5	0	0	5	0	0
7	26268882	.	C	T	0	3	3	0	2	5	0	0
7	26300955	.	T	C	2	0	2	0	5	7	0	0
7	26308064	.	C	G	6	2	8	0	0	8	0	0
7	26366620	.	T	C	14	4	18	0	1	19	0	0
7	26366684	.	C	T	10	7	17	0	0	17	0	0
7	26366846	.	C	T	0	9	9	0	12	21	0	0
7	26366897	.	A	C	7	8	15	1	0	16	0	0
7	26367111	.	T	C	5	6	11	0	1	12	0	0
7	26367764	.	C	T	3	2	5	0	0	5	0	0
7	26367797	.	T	C	1	8	9	0	0	9	0	0
7	26368080	.	T	A	4	9	13	0	0	13	0	0
7	26368087	.	G	C	9	4	13	0	0	13	0	0
7	26368531	.	C	T	2	8	10	0	0	10	0	0
7	26368748	.	A	T	10	4	14	0	0	14	0	0
7	26368955	.	G	T	10	7	17	0	0	17	0	0
7	26369394	.	T	C	4	9	13	0	0	13	0	0
7	26371711	.	G	A	10	7	17	0	0	17	0	0
7	26378224	.	G	A	9	9	18	0	0	18	0	0
7	26378455	.	A	G	5	12	17	0	0	17	0	0
7	26380290	.	T	C	8	5	13	0	1	14	0	0
7	26380335	.	G	A	3	3	6	0	1	7	0	0
7	26389261	.	C	T	3	6	9	0	0	9	0	0
7	26389351	.	C	T	2	7	9	0	0	9	0	0
7	26389369	.	G	A	3	6	9	0	2	11	0	0
7	26389429	.	C	T	11	15	26	0	1	27	0	0
7	26389486	.	G	A	7	6	13	0	0	13	0	0
7	26394791	.	A	G	20	18	38	0	0	38	0	0
7	26394951	.	T	A	8	12	20	0	0	20	0	0
7	26395816	.	T	C	8	11	19	0	0	19	0	0
7	26396013	.	T	A	8	21	29	0	2	31	0	0
7	26396170	.	G	A	13	10	23	0	1	24	0	0
7	26396418	.	A	T	16	7	23	0	1	24	0	0
7	26396506	.	T	A	7	6	13	0	1	14	0	0
7	26396768	.	G	A	15	20	35	1	0	36	0	0
7	26396783	.	C	G	5	13	18	1	16	35	0	0
7	26396886	.	G	A	13	7	20	0	0	20	0	0
7	26397129	.	A	G	5	11	16	0	2	18	0	0
7	26397243	.	G	A	14	9	23	0	0	23	0	0
7	26397289	.	G	A	4	15	19	0	2	21	0	0
7	26397336	.	C	T	1	16	17	0	12	29	0	0
7	26397365	.	A	T	11	12	23	0	1	24	0	0
7	26397541	.	G	A	13	17	30	0	1	31	0	0
7	26398159	.	A	T	10	15	25	0	1	26	0	0
7	26398189	.	C	T	14	6	20	0	0	20	0	0
7	26398351	.	A	G	22	10	32	0	0	32	0	0
7	26398360	.	G	A	12	21	33	0	0	33	0	0
7	26408340	.	C	T	10	4	14	0	3	17	0	0
7	26431942	.	G	A	1	2	3	0	0	3	0	0
7	26432073	.	G	C	1	2	3	0	0	3	0	0
7	26432403	.	A	G	3	3	6	0	0	6	0	0
7	26432553	.	C	T	1	5	6	0	3	9	0	0
7	26457085	.	A	G	2	2	4	0	0	4	0	0
7	26459917	.	C	T	0	2	2	0	2	4	0	0
7	26460001	.	T	G	3	8	11	0	0	11	0	0
7	26460821	.	G	T	5	2	7	0	0	7	0	0
7	26462439	.	T	G	1	3	4	0	0	4	0	0
7	26462440	.	G	C	1	3	4	0	0	4	0	0
7	26462500	.	C	A	2	2	4	0	0	4	0	0
7	26462724	.	A	G	3	3	6	0	0	6	0	0
7	26469820	.	G	A	0	4	4	0	6	10	0	0
7	26472244	.	G	A	15	4	19	0	1	20	0	0
7	26472258	.	A	G	16	0	16	0	6	22	0	0
7	26472290	.	C	T	10	3	13	0	1	14	0	0
7	26472398	.	C	T	4	8	12	0	0	12	0	0
7	26472512	.	G	T	3	6	9	0	0	9	0	0
7	26472522	.	C	T	8	2	10	0	0	10	0	0
7	28042060	.	G	A	9	13	22	1	0	23	0	0
7	28042070	.	A	C	10	9	19	2	1	23	1	0
7	28044303	.	A	G	15	7	22	0	0	22	0	0
7	28044339	.	A	G	6	6	12	0	0	12	0	0
7	28624968	.	T	C	3	0	3	0	2	5	0	0
7	29051855	.	A	G	6	2	8	0	0	8	0	0
7	29189503	.	C	G	15	9	24	0	1	25	0	0
7	29189508	.	G	C	13	10	23	0	0	23	0	0
7	29189652	.	C	T	9	11	20	0	0	20	0	0
7	29189694	.	G	A	12	6	18	0	1	19	0	0
7	29192331	.	C	T	2	14	16	0	15	31	0	0
7	29199642	.	C	T	11	9	20	0	1	21	0	0
7	29200013	.	G	A	14	9	23	0	0	23	0	0
7	29210943	.	T	C	5	0	5	0	7	12	0	0
7	29211102	.	C	T	7	4	11	0	5	16	0	0
7	29211354	.	T	C	2	4	6	0	0	6	0	0
7	29211387	.	G	A	4	4	8	0	0	8	0	0
7	29214910	.	G	A	11	3	14	0	0	14	0	0
7	29215502	.	C	T	5	5	10	0	0	10	0	0
7	29215945	.	T	A	5	3	8	0	2	10	0	0
7	29217983	.	G	A	5	2	7	0	0	7	0	0
7	29220089	.	G	A	8	6	14	0	1	15	0	0
7	29220161	.	G	A	8	4	12	0	1	13	0	0
7	29224517	.	G	A	2	3	5	0	0	5	0	0
7	29227361	.	A	G	4	7	11	0	0	11	0	0
7	29227602	.	G	A	13	7	20	0	0	20	0	0
7	29229377	.	G	T	5	4	9	0	0	9	0	0
7	29229594	.	T	G	4	4	8	0	0	8	0	0
7	29231558	.	A	G	8	4	12	0	0	12	0	0
7	29234155	.	C	T	0	4	4	0	5	9	0	0
7	29239767	.	G	A	5	5	10	0	0	10	0	0
7	29240040	.	G	A	1	4	5	0	1	6	0	0
7	29245865	.	G	A	5	5	10	0	0	10	0	0
7	29252324	.	G	T	4	6	10	0	2	12	0	0
7	29255770	.	C	T	0	3	3	0	2	5	0	0
7	29255773	.	C	T	0	2	2	0	2	4	0	0
7	29262646	.	G	A	3	2	5	0	0	5	0	0
7	29270798	.	T	G	2	3	5	0	0	5	0	0
7	29270882	.	C	G	0	4	4	0	1	5	0	0
7	29270999	.	A	T	3	2	5	0	1	6	0	0
7	29308621	.	G	T	4	2	6	0	0	6	0	0
7	29308659	.	G	T	6	3	9	0	0	9	0	0
7	29308739	.	T	A	3	3	6	0	0	6	0	0
7	29308745	.	A	G	3	4	7	0	0	7	0	0
7	29308910	.	G	A	6	2	8	0	1	9	0	0
7	29308930	.	C	A	8	4	12	0	0	12	0	0
7	29308968	.	A	T	6	8	14	0	0	14	0	0
7	29309027	.	A	G	5	8	13	0	0	13	0	0
7	29309271	.	A	T	6	6	12	0	0	12	0	0
7	29309315	.	A	C	8	6	14	0	0	14	0	0
7	29309726	.	G	A	6	5	11	0	0	11	0	0
7	29309851	.	T	C	13	8	21	0	0	21	0	0
7	29309897	.	T	C	6	6	12	0	1	13	0	0
7	29309994	.	T	C	10	0	10	0	0	10	0	0
7	29310355	.	A	C	8	11	19	0	0	19	0	0
7	29310409	.	T	C	10	10	20	0	0	20	0	0
7	29310537	.	C	T	8	13	21	0	1	22	0	0
7	29310543	.	G	A	1	14	15	0	8	23	0	0
7	29310654	.	C	T	2	13	15	1	2	18	0	0
7	29461565	.	C	T	1	2	3	0	0	3	0	0
7	29539523	.	T	A	7	9	16	0	1	17	0	0
7	29540207	.	A	G	8	8	16	0	0	16	0	0
7	29540311	.	A	C	18	12	30	0	0	30	0	0
7	29540412	.	G	A	17	20	37	0	1	38	0	0
7	29540536	.	A	T	15	15	30	0	0	30	0	0
7	29540537	.	C	T	1	15	16	0	14	30	0	0
7	29540693	.	A	G	3	9	12	0	1	13	0	0
7	29553317	.	A	T	18	11	29	0	0	29	0	0
7	29553338	.	G	A	17	11	28	0	0	28	0	0
7	29553446	.	G	A	15	14	29	0	0	29	0	0
7	29553473	.	G	A	8	12	20	0	2	22	0	0
7	29625326	.	C	T	8	8	16	0	1	17	0	0
7	29625427	.	G	A	19	9	28	0	1	29	0	0
7	29628889	.	A	G	4	2	6	0	0	6	0	0
7	29629613	.	T	A	1	2	3	0	0	3	0	0
7	29630953	.	A	T	1	4	5	0	0	5	0	0
7	29630993	.	C	T	2	2	4	0	1	5	0	0
7	29633743	.	G	A	8	5	13	0	1	14	0	0
7	29649401	.	C	G	5	5	10	0	0	10	0	0
7	29649414	.	T	C	4	3	7	0	0	7	0	0
7	29653004	.	A	G	9	6	15	0	1	16	0	0
7	29653500	.	C	T	0	7	7	0	4	11	0	0
7	29653521	.	C	T	3	9	12	0	0	12	0	0
7	29655006	.	A	G	4	6	10	0	1	11	0	0
7	29657144	.	T	C	7	0	7	0	9	16	0	0
7	29657186	.	A	G	8	5	13	1	0	14	0	0
7	29657213	.	T	A	5	4	9	1	1	11	0	0
7	29657231	.	A	G	6	6	12	1	0	13	0	0
7	29660377	.	G	A	6	11	17	0	0	17	0	0
7	29660410	.	G	A	7	8	15	0	0	15	0	0
7	29661260	.	C	T	3	6	9	0	1	10	0	0
7	29663064	.	T	A	1	5	6	0	1	7	0	0
7	29664300	.	G	T	6	6	12	0	0	12	0	0
7	29664372	.	C	T	5	3	8	0	0	8	0	0
7	29664373	.	A	G	5	3	8	0	0	8	0	0
7	29666328	.	C	T	6	5	11	0	0	11	0	0
7	29666527	.	T	G	2	3	5	0	0	5	0	0
7	29670445	.	G	A	4	4	8	0	1	9	0	0
7	29670934	.	C	T	3	3	6	0	0	6	0	0
7	29673377	.	G	C	4	4	8	0	0	8	0	0
7	29673577	.	C	T	4	5	9	0	0	9	0	0
7	29673681	.	G	A	9	5	14	0	0	14	0	0
7	29674931	.	T	C	2	4	6	0	0	6	0	0
7	29674985	.	C	T	0	4	4	0	4	8	0	0
7	29675798	.	C	G	3	2	5	0	0	5	0	0
7	29677810	.	T	A	5	5	10	0	0	10	0	0
7	29681302	.	G	A	3	5	8	0	1	9	0	0
7	29681317	.	A	G	4	5	9	0	0	9	0	0
7	29683914	.	C	T	2	1	3	0	1	4	0	0
7	29683915	.	A	G	0	2	2	0	0	2	0	0
7	29684041	.	G	A	3	2	5	0	0	5	0	0
7	29684140	.	T	A	5	3	8	0	0	8	0	0
7	29684842	.	G	C	3	2	5	0	1	6	0	0
7	29686974	.	T	C	3	2	5	0	0	5	0	0
7	29686975	.	A	C	2	1	3	0	2	5	0	0
7	29689632	.	G	A	3	5	8	0	0	8	0	0
7	29689668	.	G	A	3	3	6	0	0	6	0	0
7	29689837	.	G	A	2	4	6	0	0	6	0	0
7	29694329	.	T	C	3	3	6	0	0	6	0	0
7	29698400	.	A	G	3	3	6	0	0	6	0	0
7	29890343	.	A	G	2	2	4	0	0	4	0	0
7	29890356	.	C	T	3	2	5	0	1	6	0	0
7	29890386	.	T	C	4	4	8	0	0	8	0	0
7	29890398	.	G	A	4	7	11	0	0	11	0	0
7	29899601	.	C	T	3	3	6	0	0	6	0	0
7	29899616	.	C	T	4	2	6	0	0	6	0	0
7	29900028	.	G	A	0	2	2	0	2	4	0	0
7	29902696	.	T	C	4	4	8	0	0	8	0	0
7	29909421	.	A	T	5	2	7	0	1	8	0	0
7	29921317	.	G	A	1	2	3	0	0	3	0	0
7	29923340	.	A	G	6	8	14	0	0	14	0	0
7	29923392	.	T	C	3	4	7	0	0	7	0	0
7	29923403	.	G	A	1	3	4	0	1	5	0	0
7	29924142	.	T	C	6	5	11	0	0	11	0	0
7	29925438	.	G	A	5	5	10	0	1	11	0	0
7	29927700	.	T	C	4	6	10	0	0	10	0	0
7	29927903	.	C	T	8	5	13	0	0	13	0	0
7	29928164	.	T	G	10	5	15	0	0	15	0	0
7	29928703	.	C	A	4	5	9	0	0	9	0	0
7	29930218	.	C	T	9	4	13	0	0	13	0	0
7	29930351	.	G	A	2	5	7	0	2	9	0	0
7	29930445	.	C	T	4	5	9	0	0	9	0	0
7	29930576	.	G	A	0	5	5	0	4	9	0	0
7	29932496	.	T	A	2	4	6	0	1	7	0	0
7	29932743	.	C	G	3	5	8	0	1	9	0	0
7	29935803	.	C	T	7	7	14	0	0	14	0	0
7	29936168	.	C	T	10	4	14	0	1	15	0	0
7	29939655	.	G	A	0	9	9	0	8	17	0	0
7	29939673	.	T	C	8	6	14	0	0	14	0	0
7	29939694	.	G	C	11	8	19	0	0	19	0	0
7	29941546	.	A	G	6	5	11	0	1	12	0	0
7	29941709	.	G	A	2	4	6	0	11	17	0	0
7	29944366	.	G	C	1	13	14	0	6	20	0	0
7	29945050	.	A	T	4	3	7	0	0	7	0	0
7	29945372	.	A	T	2	2	4	0	0	4	0	0
7	29945564	.	C	A	10	14	24	0	0	24	0	0
7	29945607	.	T	C	9	15	24	0	0	24	0	0
7	29945609	.	C	A	13	9	22	0	2	24	0	0
7	29945837	.	G	A	13	12	25	0	1	26	0	0
7	29961207	.	A	C	5	8	13	0	1	14	0	0
7	29961296	.	A	G	12	11	23	0	4	27	0	0
7	29961455	.	G	C	19	4	23	0	0	23	0	0
7	29961479	.	A	T	15	5	20	0	0	20	0	0
7	29961513	.	T	A	9	11	20	0	0	21	1	0
7	29961567	.	C	T	17	13	30	0	1	31	0	0
7	29961592	.	G	A	12	13	25	1	1	27	0	0
7	29961649	.	G	A	2	3	5	1	0	6	0	0
7	29961876	.	T	C	1	4	5	0	0	5	0	0
7	29964713	.	G	A	3	6	9	0	1	10	0	0
7	29966892	.	A	G	5	4	9	0	0	9	0	0
7	29967989	.	C	T	6	7	13	0	0	13	0	0
7	29968099	.	C	T	7	2	9	0	0	9	0	0
7	29968285	.	C	T	5	4	9	0	0	9	0	0
7	29968298	.	G	A	5	4	9	0	2	11	0	0
7	29968454	.	T	A	5	6	11	0	1	12	0	0
7	29968534	.	A	G	2	6	8	0	0	8	0	0
7	29968855	.	C	A	2	2	4	0	0	4	0	0
7	29969461	.	G	T	4	5	9	0	0	9	0	0
7	29969996	.	A	T	5	6	11	0	0	11	0	0
7	29970015	.	T	G	7	3	10	0	0	10	0	0
7	30075289	.	T	G	1	2	3	0	0	3	0	0
7	30075430	.	G	A	10	8	18	0	1	19	0	0
7	30075631	.	C	A	8	9	17	0	3	20	0	0
7	30075823	.	C	T	5	12	17	0	2	19	0	0
7	30075845	.	T	C	6	19	25	0	0	25	0	0
7	30075974	.	A	G	16	19	35	0	0	35	0	0
7	30075983	.	G	A	12	20	32	0	1	33	0	0
7	30076036	.	A	C	15	14	29	3	0	32	0	0
7	30076083	.	A	T	12	13	25	0	0	25	0	0
7	30076141	.	T	G	7	9	16	0	4	20	0	0
7	30076179	.	C	T	8	6	14	0	0	14	0	0
7	30076185	.	C	A	8	6	14	0	0	14	0	0
7	30076217	.	T	C	11	8	19	0	1	20	0	0
7	30076241	.	G	T	12	5	17	0	0	17	0	0
7	30076591	.	G	A	13	16	29	0	0	29	0	0
7	30076608	.	T	G	13	9	22	0	0	22	0	0
7	30076653	.	C	A	16	9	25	0	0	25	0	0
7	30076692	.	C	T	13	22	35	0	1	36	0	0
7	30076744	.	G	A	9	31	40	0	0	40	0	0
7	30076962	.	A	T	3	11	14	0	0	14	0	0
7	30077288	.	C	T	7	3	10	0	2	13	1	0
7	30077347	.	A	G	2	7	9	0	0	9	0	0
7	30077479	.	G	C	3	13	16	0	1	17	0	0
7	30077581	.	T	G	6	15	21	0	3	24	0	0
7	30176506	.	G	A	3	4	7	0	1	8	0	0
7	30176521	.	G	C	1	0	1	0	3	4	0	0
7	30179568	.	G	C	2	2	4	0	0	4	0	0
7	30179577	.	C	G	2	3	5	0	0	5	0	0
7	30187381	.	A	G	1	3	4	0	1	5	0	0
7	30210250	.	A	C	8	4	12	0	0	12	0	0
7	30210282	.	T	G	10	9	19	0	0	19	0	0
7	30210359	.	C	T	10	6	16	0	1	17	0	0
7	30210364	.	G	T	10	6	16	0	0	16	0	0
7	30210579	.	G	T	6	9	15	0	0	15	0	0
7	30210772	.	G	A	5	9	14	0	0	14	0	0
7	30210785	.	A	G	8	5	13	0	1	14	0	0
7	30210833	.	C	T	4	9	13	0	0	13	0	0
7	30213672	.	A	G	6	14	20	0	0	20	0	0
7	30213948	.	A	G	18	11	29	0	0	29	0	0
7	30214023	.	A	T	17	9	26	0	1	27	0	0
7	30214047	.	G	C	18	0	18	0	11	29	0	0
7	30214333	.	A	C	4	3	7	0	1	8	0	0
7	30246186	.	A	C	2	2	4	0	1	5	0	0
7	30259366	.	C	T	1	2	3	0	0	3	0	0
7	30260956	.	G	A	0	2	2	0	3	5	0	0
7	30264178	.	C	T	1	2	3	0	0	3	0	0
7	30265579	.	A	G	1	0	1	0	3	4	0	0
7	30265622	.	G	A	1	2	3	0	0	3	0	0
7	30265630	.	A	T	1	2	3	0	0	3	0	0
7	30266374	.	G	A	2	3	5	0	0	5	0	0
7	30270984	.	G	A	7	9	16	0	0	16	0	0
7	30272459	.	T	C	4	0	4	0	4	8	0	0
7	30275676	.	A	T	9	5	14	0	0	14	0	0
7	30275834	.	G	A	5	5	10	0	0	10	0	0
7	30276365	.	C	T	19	23	42	0	1	43	0	0
7	30276528	.	T	A	21	22	43	0	2	45	0	0
7	30283329	.	C	A	3	3	6	0	0	6	0	0
7	30285369	.	A	C	2	4	6	0	0	6	0	0
7	30286057	.	C	G	1	4	5	0	0	5	0	0
7	30286489	.	T	C	6	5	11	0	0	11	0	0
7	30327708	.	C	T	0	3	3	0	3	6	0	0
7	30327887	.	G	T	5	5	10	0	1	11	0	0
7	30409322	.	T	C	9	7	16	0	0	16	0	0
7	30409539	.	T	A	13	15	28	0	4	32	0	0
7	30409580	.	A	T	8	12	20	0	0	20	0	0
7	30409585	.	G	A	6	11	17	0	0	17	0	0
7	30409661	.	G	A	4	8	12	0	1	13	0	0
7	30410035	.	T	A	8	9	17	0	1	18	0	0
7	30410089	.	C	T	1	7	8	0	7	15	0	0
7	30410443	.	G	T	8	6	14	0	1	15	0	0
7	30410447	.	T	C	6	7	13	0	0	13	0	0
7	30410739	.	T	C	3	2	5	0	0	5	0	0
7	30411187	.	T	C	8	14	22	0	0	22	0	0
7	30412857	.	C	T	9	12	21	0	1	22	0	0
7	30413850	.	A	G	5	6	11	0	1	12	0	0
7	30416824	.	A	T	5	9	14	0	2	16	0	0
7	30421505	.	G	A	8	7	15	0	0	15	0	0
7	30421664	.	T	G	5	11	16	0	0	16	0	0
7	30425287	.	A	G	2	5	7	0	0	7	0	0
7	30494089	.	G	A	2	2	4	0	2	6	0	0
7	30494442	.	G	A	6	4	10	0	0	10	0	0
7	30512705	.	G	A	5	7	12	0	0	12	0	0
7	30525709	.	G	A	0	5	5	0	5	10	0	0
7	30530240	.	G	T	8	5	13	0	0	14	1	0
7	30533152	.	A	T	6	7	13	0	0	13	0	0
7	30533905	.	A	C	3	4	7	0	0	7	0	0
7	30534082	.	T	C	10	5	15	0	2	17	0	0
7	30534499	.	C	G	4	6	10	0	2	12	0	0
7	30534538	.	C	T	7	6	13	0	1	14	0	0
7	30534556	.	C	T	5	7	12	0	0	12	0	0
7	30534824	.	G	C	3	5	8	0	0	8	0	0
7	30535210	.	T	C	3	4	7	0	1	8	0	0
7	30535874	.	T	A	2	8	10	2	0	12	0	0
7	30536377	.	T	A	6	6	12	0	0	12	0	0
7	30536480	.	G	A	7	5	12	0	1	13	0	0
7	30536566	.	A	G	10	0	10	0	4	14	0	0
7	30536829	.	A	T	7	13	20	0	0	20	0	0
7	30536932	.	T	C	8	11	19	0	2	22	1	0
7	30537080	.	A	C	3	3	6	0	0	6	0	0
7	30537365	.	G	T	8	3	11	1	1	13	0	0
7	30537370	.	T	A	3	8	11	1	0	12	0	0
7	30537445	.	A	T	2	7	9	0	0	9	0	0
7	30537630	.	G	A	5	2	7	0	1	8	0	0
7	30537783	.	A	T	9	7	16	0	0	16	0	0
7	30537848	.	A	C	9	11	20	0	2	22	0	0
7	30537955	.	G	A	8	14	22	0	0	22	0	0
7	30538022	.	C	A	8	4	12	0	1	13	0	0
7	30538074	.	G	A	7	4	11	0	0	11	0	0
7	30538081	.	G	A	5	9	14	0	0	14	0	0
7	30538280	.	G	A	4	3	7	0	1	8	0	0
7	30538439	.	C	T	0	4	4	0	2	6	0	0
7	30538995	.	G	A	17	23	40	0	2	42	0	0
7	30541693	.	G	A	19	20	39	0	0	39	0	0
7	30542295	.	C	T	20	21	41	0	1	42	0	0
7	30543151	.	A	G	27	18	45	0	2	47	0	0
7	30543452	.	G	A	28	22	50	0	3	53	0	0
7	30543682	.	T	C	20	30	50	0	3	53	0	0
7	30543754	.	A	G	22	37	59	0	1	60	0	0
7	30543882	.	C	T	26	30	56	0	2	58	0	0
7	30544903	.	A	G	15	21	36	1	1	38	0	0
7	30552603	.	G	A	15	10	25	0	0	25	0	0
7	30552610	.	G	A	11	11	22	0	2	24	0	0
7	30553495	.	T	C	14	21	35	0	1	36	0	0
7	30560354	.	C	T	2	20	22	0	17	39	0	0
7	30562400	.	T	C	10	11	21	0	1	22	0	0
7	30562552	.	T	A	9	10	19	0	0	19	0	0
7	30562645	.	T	A	8	10	18	0	1	19	0	0
7	30563080	.	T	C	6	8	14	0	0	14	0	0
7	30563160	.	G	T	6	8	14	0	2	16	0	0
7	30571228	.	T	A	8	12	20	0	5	25	0	0
7	30578818	.	C	T	0	8	8	0	9	17	0	0
7	30583147	.	G	A	13	8	21	0	0	21	0	0
7	30604846	.	C	T	0	5	5	0	1	6	0	0
7	30624214	.	G	A	6	6	12	0	0	12	0	0
7	30632477	.	G	A	3	3	6	0	0	6	0	0
7	30632486	.	T	C	3	3	6	0	0	6	0	0
7	30632765	.	G	A	4	2	6	0	0	6	0	0
7	30632797	.	T	G	4	3	7	0	0	7	0	0
7	30633038	.	A	G	1	5	6	0	0	6	0	0
7	30641118	.	T	C	4	4	8	0	0	8	0	0
7	30641187	.	G	T	4	5	9	0	0	9	0	0
7	30641217	.	C	T	11	6	17	0	0	17	0	0
7	30644307	.	C	T	3	6	9	0	0	9	0	0
7	30652971	.	C	T	4	3	7	0	0	7	0	0
7	30663214	.	C	T	2	2	4	0	0	4	0	0
7	30673972	.	C	T	2	4	6	0	0	6	0	0
7	30722762	.	G	C	1	2	3	0	0	3	0	0
7	30722776	.	C	G	1	2	3	0	0	3	0	0
7	30758965	.	T	C	2	2	4	0	0	4	0	0
7	30760352	.	T	C	1	7	8	0	0	8	0	0
7	30760359	.	T	A	0	6	6	0	0	6	0	0
7	30763671	.	G	A	1	4	5	0	0	5	0	0
7	30765760	.	C	T	3	3	6	0	0	6	0	0
7	30768496	.	T	A	2	6	8	0	0	8	0	0
7	30768499	.	T	A	6	2	8	0	0	8	0	0
7	30769847	.	A	C	7	9	16	0	1	17	0	0
7	30769978	.	T	A	7	3	10	0	0	10	0	0
7	30770003	.	C	T	6	3	9	0	0	9	0	0
7	30770021	.	A	G	6	5	11	0	1	12	0	0
7	30770041	.	A	G	5	7	12	0	0	12	0	0
7	30770103	.	T	A	5	2	7	0	0	7	0	0
7	30770107	.	T	A	5	2	7	0	0	7	0	0
7	30770204	.	G	A	8	5	13	0	0	13	0	0
7	30770366	.	G	T	0	8	8	0	2	10	0	0
7	30770549	.	T	C	7	8	15	0	1	16	0	0
7	30770702	.	G	A	0	2	2	0	1	3	0	0
7	30770971	.	T	A	1	4	5	0	0	5	0	0
7	30773168	.	T	A	3	2	5	0	1	6	0	0
7	30773169	.	T	A	4	2	6	0	0	6	0	0
7	30775306	.	C	T	9	7	16	0	0	16	0	0
7	30775882	.	C	T	7	8	15	0	0	15	0	0
7	30777592	.	C	A	7	12	19	0	1	20	0	0
7	30778394	.	C	T	8	8	16	0	0	16	0	0
7	30778577	.	G	C	7	3	10	0	0	10	0	0
7	30778657	.	T	C	8	4	12	0	1	13	0	0
7	30778726	.	T	C	5	0	5	0	1	6	0	0
7	30778802	.	T	C	8	4	12	0	0	12	0	0
7	30778840	.	A	T	3	8	11	0	1	12	0	0
7	30778859	.	G	A	4	7	11	0	1	12	0	0
7	30778906	.	C	T	5	7	12	0	0	12	0	0
7	30780272	.	G	A	7	3	10	0	0	10	0	0
7	30782559	.	G	A	4	4	8	0	1	9	0	0
7	30782669	.	A	G	7	4	11	0	3	14	0	0
7	30782802	.	G	A	1	4	5	0	6	11	0	0
7	30782837	.	G	T	1	3	4	0	0	4	0	0
7	30782929	.	A	T	2	6	8	0	1	9	0	0
7	30867286	.	T	C	27	23	50	0	3	53	0	0
7	30867550	.	G	T	28	25	53	0	3	56	0	0
7	30867670	.	A	G	27	2	29	0	22	51	0	0
7	30867702	.	T	C	22	27	49	0	1	50	0	0
7	30867731	.	A	G	23	17	40	0	2	42	0	0
7	30867740	.	A	G	22	17	39	0	3	42	0	0
7	30867817	.	G	A	1	19	20	0	24	44	0	0
7	30867855	.	G	A	2	15	17	0	21	38	0	0
7	30875277	.	G	A	22	20	42	0	4	46	0	0
7	30879211	.	G	A	19	27	46	0	0	47	1	0
7	31500424	.	T	C	1	3	4	0	0	4	0	0
7	31626553	.	C	T	5	2	7	0	0	7	0	0
7	32743231	.	A	G	10	3	13	2	0	15	0	0
7	32746213	.	A	G	16	9	25	0	1	26	0	0
7	32747956	.	A	G	13	0	13	0	11	24	0	0
7	32747973	.	A	G	10	17	27	0	2	29	0	0
7	32835573	.	T	A	3	3	6	0	0	6	0	0
7	33885057	.	G	A	2	3	5	0	1	6	0	0
7	33885079	.	G	A	3	5	8	0	0	8	0	0
7	33885100	.	C	T	3	4	7	0	1	8	0	0
7	33885119	.	G	T	0	3	3	0	0	5	2	0
7	33972242	.	G	A	1	4	5	0	0	5	0	0
7	34105890	.	T	C	4	4	8	0	0	8	0	0
7	34236350	.	T	C	8	3	11	0	0	11	0	0
7	34236359	.	T	C	8	3	11	0	0	11	0	0
7	34237281	.	T	C	2	3	5	0	0	5	0	0
7	34242358	.	C	T	1	6	7	0	6	13	0	0
7	34242478	.	T	C	3	7	10	0	0	10	0	0
7	34244976	.	A	G	4	4	8	0	1	9	0	0
7	34245034	.	C	T	3	4	7	0	1	8	0	0
7	34246282	.	A	G	4	3	7	0	1	8	0	0
7	34246750	.	C	T	2	4	6	0	0	6	0	0
7	34256235	.	C	T	4	4	8	0	0	8	0	0
7	34290102	.	A	C	3	2	5	0	1	6	0	0
7	34291237	.	A	T	2	2	4	0	0	4	0	0
7	34291419	.	C	T	1	3	4	0	0	4	0	0
7	34292306	.	T	C	5	4	9	0	0	9	0	0
7	34292354	.	C	A	2	4	6	0	2	8	0	0
7	34292617	.	G	A	3	3	6	0	0	6	0	0
7	34292848	.	G	A	2	2	4	0	0	4	0	0
7	34314106	.	C	T	1	2	3	0	0	3	0	0
7	34314826	.	A	G	3	4	7	0	0	7	0	0
7	34317746	.	C	T	1	19	20	0	16	36	0	0
7	34318079	.	T	C	24	22	46	0	1	47	0	0
7	34318485	.	G	A	30	15	45	0	1	46	0	0
7	34321887	.	T	G	4	11	15	0	1	16	0	0
7	34324215	.	T	C	16	10	26	0	0	26	0	0
7	34329845	.	A	G	23	20	43	0	0	43	0	0
7	34341457	.	A	G	24	21	45	0	1	47	1	0
7	34341538	.	A	G	33	21	54	0	0	54	0	0
7	34342185	.	T	C	25	24	49	0	1	50	0	0
7	34342251	.	C	T	13	15	28	1	1	30	0	0
7	34342266	.	G	C	16	17	33	1	2	36	0	0
7	34352928	.	G	A	27	17	44	0	3	47	0	0
7	34353161	.	C	T	2	21	23	1	19	43	0	0
7	34618184	.	T	G	1	2	3	0	0	3	0	0
7	34651779	.	T	C	6	2	8	0	0	8	0	0
7	34651890	.	C	T	2	2	4	0	0	4	0	0
7	35211680	.	A	G	5	3	8	0	0	8	0	0
7	35283793	.	T	C	2	4	6	0	0	6	0	0
7	35283794	.	T	C	3	3	6	0	0	6	0	0
7	35351172	.	T	C	3	2	5	0	0	5	0	0
7	36619052	.	A	C	20	0	20	0	0	20	0	0
7	37861725	.	T	A	9	3	12	0	1	13	0	0
7	38532570	.	A	G	2	3	5	0	0	5	0	0
7	38703963	.	T	C	11	5	16	0	1	17	0	0
7	38704126	.	T	C	5	2	7	0	0	7	0	0
7	39660240	.	A	T	5	26	31	0	0	31	0	0
7	39676947	.	T	G	10	11	21	0	1	22	0	0
7	39983885	.	G	A	3	6	9	0	1	10	0	0
7	40023279	.	C	T	7	5	12	0	0	12	0	0
7	40040982	.	C	T	5	6	11	0	1	12	0	0
7	40043273	.	C	T	4	2	6	0	0	6	0	0
7	40043336	.	T	C	4	3	7	0	0	7	0	0
7	40046715	.	G	A	5	7	12	0	0	12	0	0
7	40046734	.	T	C	5	6	11	0	0	11	0	0
7	40050962	.	C	T	2	10	12	0	0	12	0	0
7	40050986	.	G	C	1	11	12	0	2	14	0	0
7	40053306	.	G	A	5	10	15	0	0	15	0	0
7	40053490	.	T	C	14	13	27	0	0	27	0	0
7	40053537	.	C	T	13	13	26	0	0	26	0	0
7	40053717	.	T	A	10	8	18	0	1	19	0	0
7	40053720	.	G	A	9	9	18	0	1	19	0	0
7	40053978	.	C	T	10	10	20	0	0	20	0	0
7	40054234	.	G	A	4	6	10	0	0	10	0	0
7	40054464	.	A	C	8	10	18	0	0	18	0	0
7	40054814	.	C	T	5	8	13	0	0	13	0	0
7	40054901	.	G	T	9	8	17	0	0	17	0	0
7	40054925	.	G	T	1	9	10	0	9	19	0	0
7	40055080	.	T	C	14	21	35	1	1	37	0	0
7	40055099	.	C	T	23	9	32	1	0	33	0	0
7	40055117	.	T	A	21	5	26	1	0	27	0	0
7	40055178	.	C	G	4	11	15	2	4	21	0	0
7	40055219	.	A	T	7	4	11	3	0	14	0	0
7	40055353	.	A	G	6	0	6	0	9	15	0	0
7	40055612	.	C	T	9	8	17	0	1	18	0	0
7	40055628	.	G	A	10	11	21	0	0	21	0	0
7	40055672	.	G	A	13	8	21	0	0	21	0	0
7	40055711	.	A	T	3	10	13	0	1	14	0	0
7	40055844	.	C	T	4	12	16	0	0	16	0	0
7	40055928	.	T	C	7	4	11	0	0	11	0	0
7	40055945	.	C	T	8	2	10	0	1	11	0	0
7	40056060	.	C	T	10	5	15	0	1	16	0	0
7	40056112	.	T	G	12	12	24	0	0	24	0	0
7	40056243	.	C	A	12	5	17	5	0	22	0	0
7	40056307	.	C	T	13	11	24	0	0	24	0	0
7	40056353	.	G	A	14	9	23	0	1	24	0	0
7	40056417	.	C	A	11	4	15	0	1	16	0	0
7	40056542	.	A	T	9	10	19	0	1	20	0	0
7	40056587	.	C	T	5	12	17	0	0	17	0	0
7	40056589	.	T	C	4	12	16	0	0	16	0	0
7	40056729	.	A	T	6	11	17	0	1	18	0	0
7	40056851	.	T	C	10	3	13	0	1	14	0	0
7	40056854	.	C	T	3	10	13	0	1	14	0	0
7	40056982	.	C	T	8	9	17	0	1	18	0	0
7	40057140	.	G	A	9	5	14	0	0	14	0	0
7	40057393	.	C	T	8	10	18	0	0	18	0	0
7	40057581	.	T	G	4	7	11	0	2	13	0	0
7	40057674	.	A	G	1	4	5	0	0	5	0	0
7	40059207	.	G	A	7	6	13	0	0	13	0	0
7	40059248	.	T	C	12	5	17	0	0	17	0	0
7	40059673	.	G	A	2	3	5	0	0	5	0	0
7	40060505	.	C	T	1	5	6	0	0	6	0	0
7	40060543	.	A	T	2	9	11	0	0	11	0	0
7	40060665	.	T	A	1	4	5	0	0	5	0	0
7	40063669	.	G	T	4	5	9	0	0	9	0	0
7	40070301	.	G	A	5	4	9	0	0	9	0	0
7	40070461	.	T	C	2	3	5	0	0	5	0	0
7	40070464	.	T	C	2	3	5	0	0	5	0	0
7	40070531	.	C	G	1	3	4	0	0	4	0	0
7	40071308	.	C	T	1	2	3	0	0	3	0	0
7	40071776	.	G	A	3	5	8	0	1	9	0	0
7	40072184	.	T	C	4	5	9	0	1	10	0	0
7	40072371	.	T	G	7	14	21	0	0	21	0	0
7	40074825	.	A	G	13	7	20	0	0	20	0	0
7	40076634	.	T	C	10	0	10	0	12	22	0	0
7	40076782	.	A	G	4	9	13	0	0	13	0	0
7	40079824	.	A	C	6	0	6	0	5	11	0	0
7	40080166	.	C	T	8	4	12	0	3	15	0	0
7	40081813	.	C	T	2	9	11	0	4	15	0	0
7	40083683	.	T	A	16	16	32	0	1	33	0	0
7	40083762	.	C	G	8	9	17	0	1	18	0	0
7	40083786	.	A	T	9	7	16	0	1	17	0	0
7	40083815	.	T	A	11	6	17	0	0	18	1	0
7	40090547	.	T	A	11	12	23	0	0	23	0	0
7	40090602	.	T	C	27	14	41	0	0	41	0	0
7	40091261	.	A	T	4	3	7	0	0	7	0	0
7	40091460	.	C	T	6	7	13	0	2	15	0	0
7	40091510	.	G	T	4	3	7	0	0	7	0	0
7	40091552	.	A	T	4	5	9	0	1	10	0	0
7	40091622	.	C	G	12	7	19	0	1	20	0	0
7	40091718	.	G	A	9	10	19	0	1	20	0	0
7	40091749	.	T	C	10	12	22	0	0	22	0	0
7	40091818	.	T	G	11	7	18	0	2	20	0	0
7	40091951	.	A	T	5	4	9	0	1	10	0	0
7	40091985	.	A	G	2	2	4	0	0	4	0	0
7	40092003	.	T	G	3	2	5	0	0	5	0	0
7	40094283	.	T	C	4	2	6	0	1	7	0	0
7	40094359	.	C	A	7	4	11	0	0	11	0	0
7	40097105	.	A	C	7	4	11	0	1	12	0	0
7	40097271	.	C	G	4	3	7	0	0	7	0	0
7	40097304	.	C	A	9	3	12	0	0	12	0	0
7	40097313	.	G	C	10	2	12	0	0	12	0	0
7	40097345	.	A	G	8	4	12	0	0	12	0	0
7	40097395	.	A	G	3	7	10	0	0	10	0	0
7	40097396	.	T	C	3	7	10	0	0	10	0	0
7	40097602	.	A	G	5	0	5	0	4	9	0	0
7	40100168	.	A	C	3	4	7	0	0	7	0	0
7	40100294	.	C	T	5	4	9	0	0	9	0	0
7	40100306	.	T	C	4	4	8	0	0	8	0	0
7	40100357	.	C	T	3	3	6	0	0	6	0	0
7	40100976	.	C	T	1	3	4	0	0	4	0	0
7	40104296	.	T	C	1	3	4	0	0	4	0	0
7	40111436	.	A	T	1	2	3	0	0	3	0	0
7	40111437	.	A	G	1	2	3	0	0	3	0	0
7	40123342	.	T	C	1	5	6	0	0	6	0	0
7	40123350	.	A	T	2	2	4	0	1	5	0	0
7	40123989	.	T	C	3	1	4	0	6	10	0	0
7	40126570	.	T	C	1	0	1	0	2	3	0	0
7	40126962	.	T	C	3	2	5	0	0	5	0	0
7	40138226	.	A	G	1	3	4	0	0	4	0	0
7	40138250	.	G	C	1	4	5	0	0	5	0	0
7	40140152	.	C	T	2	2	4	0	0	4	0	0
7	40140399	.	T	C	2	4	6	0	1	7	0	0
7	40144195	.	C	T	3	2	5	0	2	7	0	0
7	40144329	.	T	A	2	4	6	0	0	6	0	0
7	40144339	.	C	T	2	4	6	0	0	6	0	0
7	40144428	.	T	A	6	2	8	0	0	8	0	0
7	40145032	.	A	T	4	4	8	0	0	8	0	0
7	40183822	.	T	A	2	4	6	0	0	6	0	0
7	40183825	.	G	A	2	4	6	0	0	6	0	0
7	40185017	.	G	C	5	2	7	0	0	7	0	0
7	40188991	.	C	T	5	11	16	0	0	16	0	0
7	40197623	.	C	A	12	6	18	0	0	18	0	0
7	40200740	.	G	A	7	5	12	0	0	12	0	0
7	40201016	.	C	T	4	9	13	0	2	15	0	0
7	40201108	.	G	T	7	10	17	0	0	17	0	0
7	40201200	.	G	A	1	8	9	0	0	9	0	0
7	40201975	.	A	G	7	5	12	0	2	14	0	0
7	40228499	.	A	T	20	25	45	0	5	50	0	0
7	40292834	.	T	C	24	17	41	0	1	42	0	0
7	40318309	.	T	A	17	20	37	0	2	39	0	0
7	40318486	.	A	G	28	0	28	0	25	53	0	0
7	40318580	.	G	T	17	20	37	0	1	38	0	0
7	40318593	.	G	A	21	16	37	0	1	38	0	0
7	40320956	.	A	C	23	23	46	0	0	46	0	0
7	40321174	.	C	T	22	27	49	0	1	50	0	0
7	40321224	.	A	G	16	26	42	0	2	44	0	0
7	40321273	.	G	T	21	26	47	0	2	49	0	0
7	40321443	.	C	T	26	21	47	0	1	48	0	0
7	40460256	.	T	C	26	23	49	1	5	55	0	0
7	40460371	.	C	T	14	28	42	0	2	44	0	0
7	40466026	.	A	G	27	35	62	0	1	63	0	0
7	40471301	.	A	G	34	29	63	0	1	64	0	0
7	40492740	.	T	A	49	26	75	0	1	76	0	0
7	40492764	.	G	C	5	31	36	0	39	75	0	0
7	40492789	.	T	C	46	23	69	0	2	71	0	0
7	40492800	.	G	T	47	20	67	0	0	67	0	0
7	40498598	.	G	A	30	22	52	0	1	53	0	0
7	40498934	.	C	A	32	27	59	0	1	61	1	0
7	40499177	.	A	C	8	12	20	0	2	22	0	0
7	40499182	.	A	G	6	11	17	0	3	20	0	0
7	40560398	.	C	T	3	4	7	0	0	7	0	0
7	40560934	.	G	A	9	8	17	0	1	18	0	0
7	40561366	.	G	A	8	5	13	3	0	17	1	0
7	40562662	.	C	T	2	6	8	0	9	17	0	0
7	40562743	.	G	A	10	4	14	0	0	14	0	0
7	40562757	.	T	G	8	3	11	0	1	12	0	0
7	40567075	.	T	C	9	9	18	0	0	18	0	0
7	40569966	.	G	A	9	6	15	0	1	16	0	0
7	40578658	.	C	G	12	12	24	0	0	24	0	0
7	40584065	.	A	C	5	5	10	0	0	10	0	0
7	40584121	.	A	C	9	11	20	0	1	21	0	0
7	40584148	.	T	C	7	0	7	0	10	17	0	0
7	40584395	.	G	C	12	9	21	0	1	22	0	0
7	40584415	.	G	C	12	11	23	0	1	24	0	0
7	40584469	.	C	T	4	7	11	0	0	11	0	0
7	40584988	.	A	C	11	4	15	0	0	15	0	0
7	40585112	.	A	G	4	6	10	0	0	10	0	0
7	40585217	.	T	C	10	7	17	0	0	17	0	0
7	40585546	.	A	T	9	4	13	0	0	13	0	0
7	40602439	.	G	A	5	4	9	0	0	9	0	0
7	40605299	.	T	A	5	8	13	0	0	13	0	0
7	40607911	.	T	A	5	7	12	0	0	12	0	0
7	40608459	.	T	C	7	0	7	0	7	14	0	0
7	40615648	.	T	C	6	0	6	0	3	9	0	0
7	40616896	.	A	G	8	6	14	0	0	14	0	0
7	40617137	.	G	C	2	3	5	0	0	5	0	0
7	40617139	.	G	A	2	3	5	0	0	5	0	0
7	40624281	.	A	T	3	4	7	0	0	7	0	0
7	40626449	.	C	T	3	3	6	0	0	6	0	0
7	40630634	.	A	C	5	0	5	0	6	11	0	0
7	40644913	.	A	G	1	2	3	0	0	3	0	0
7	40649674	.	G	A	2	5	7	0	0	7	0	0
7	40650862	.	G	T	5	2	7	0	0	7	0	0
7	40650869	.	G	A	5	2	7	0	0	7	0	0
7	40655735	.	T	C	1	2	3	0	0	3	0	0
7	40657775	.	G	A	3	2	5	0	0	5	0	0
7	40676025	.	G	A	4	3	7	0	1	8	0	0
7	40707966	.	G	A	0	8	8	0	4	12	0	0
7	40708059	.	A	G	3	5	8	0	1	9	0	0
7	40889981	.	C	T	8	5	13	0	0	13	0	0
7	40890410	.	A	G	5	11	16	0	0	16	0	0
7	40890678	.	G	A	3	6	9	0	0	9	0	0
7	40891190	.	C	T	2	2	4	0	0	4	0	0
7	40900772	.	G	A	7	7	14	1	0	15	0	0
7	40900785	.	C	A	0	7	7	1	10	18	0	0
7	40901126	.	A	T	5	2	7	0	0	7	0	0
7	40901425	.	T	A	0	3	3	0	2	5	0	0
7	40901436	.	G	A	1	5	6	0	0	6	0	0
7	40901584	.	A	C	4	6	10	0	0	10	0	0
7	40901592	.	T	C	9	2	11	0	0	11	0	0
7	40901628	.	A	G	3	6	9	0	0	9	0	0
7	40901659	.	A	G	4	3	7	0	1	8	0	0
7	40901704	.	C	T	2	6	8	0	6	14	0	0
7	40901779	.	C	G	6	5	11	0	0	11	0	0
7	40901945	.	T	C	7	8	15	0	1	16	0	0
7	40902205	.	G	A	2	2	4	0	0	4	0	0
7	40903292	.	G	A	2	5	7	0	0	7	0	0
7	40903491	.	T	A	7	9	16	0	2	18	0	0
7	40904099	.	A	G	4	2	6	0	0	6	0	0
7	40904129	.	T	A	4	3	7	0	0	7	0	0
7	40904446	.	C	T	2	5	7	1	1	9	0	0
7	40904949	.	G	T	2	2	4	0	0	4	0	0
7	40905164	.	A	T	3	5	8	0	0	8	0	0
7	40905695	.	A	T	10	16	26	0	1	27	0	0
7	40905774	.	C	T	1	9	10	0	12	22	0	0
7	40906286	.	T	C	4	14	18	0	1	19	0	0
7	40906377	.	T	C	6	5	11	0	0	11	0	0
7	40906415	.	T	A	1	7	8	0	0	8	0	0
7	40906516	.	C	A	0	2	2	0	3	5	0	0
7	40931758	.	G	C	9	7	16	0	0	16	0	0
7	40931873	.	T	A	13	5	18	0	2	20	0	0
7	40931874	.	C	T	0	4	4	0	16	20	0	0
7	40935308	.	C	T	9	12	21	0	0	21	0	0
7	40942588	.	G	C	7	9	16	0	0	16	0	0
7	40951391	.	G	A	14	8	22	0	0	22	0	0
7	40989156	.	A	G	2	3	5	0	0	5	0	0
7	40990473	.	G	C	5	4	9	0	0	9	0	0
7	40993298	.	G	A	10	11	21	0	1	22	0	0
7	40993422	.	G	A	2	8	10	0	0	10	0	0
7	40993442	.	T	G	1	8	9	0	0	9	0	0
7	41008076	.	T	A	1	3	4	0	0	4	0	0
7	41008618	.	T	C	10	8	18	0	0	18	0	0
7	41008856	.	C	T	1	14	15	0	16	31	0	0
7	41009217	.	C	T	1	16	17	0	17	34	0	0
7	41009797	.	T	A	29	19	48	0	2	50	0	0
7	41012081	.	A	T	13	15	28	1	0	29	0	0
7	41012505	.	C	T	3	9	12	0	13	25	0	0
7	41093959	.	A	G	1	4	5	0	0	5	0	0
7	41093962	.	T	G	1	4	5	0	0	5	0	0
7	41147792	.	A	G	16	0	16	0	18	34	0	0
7	41157531	.	G	C	15	16	31	0	1	32	0	0
7	41157735	.	T	C	16	15	31	0	0	31	0	0
7	41157805	.	C	A	17	24	41	0	0	41	0	0
7	41157997	.	G	A	15	7	22	1	0	23	0	0
7	41158057	.	C	T	12	13	25	1	0	26	0	0
7	41223561	.	C	T	7	4	11	0	0	11	0	0
7	41229427	.	T	C	5	4	9	0	0	9	0	0
7	41238313	.	C	T	6	7	13	0	0	13	0	0
7	41238671	.	T	C	6	6	12	0	0	12	0	0
7	41244570	.	C	G	5	0	5	0	10	15	0	0
7	41249282	.	A	G	4	7	11	0	1	12	0	0
7	41249387	.	T	C	8	5	13	0	0	13	0	0
7	41249526	.	C	T	8	3	11	0	0	11	0	0
7	41249613	.	A	G	6	0	6	0	8	14	0	0
7	41250813	.	T	C	8	6	14	0	0	14	0	0
7	41255443	.	A	T	14	13	27	0	0	27	0	0
7	41257549	.	G	T	4	4	8	0	0	8	0	0
7	41258015	.	T	C	8	13	21	0	3	24	0	0
7	41261343	.	C	A	17	18	35	0	2	37	0	0
7	41262058	.	T	G	10	18	28	0	1	29	0	0
7	41262277	.	A	G	19	12	31	0	0	31	0	0
7	41262361	.	G	A	8	16	24	0	0	24	0	0
7	41263277	.	G	A	1	5	6	0	8	14	0	0
7	41267424	.	C	T	8	15	23	0	3	26	0	0
7	41269653	.	C	G	15	17	32	0	1	33	0	0
7	41273527	.	T	C	6	14	20	0	1	21	0	0
7	41273889	.	T	C	7	9	16	0	0	16	0	0
7	41274080	.	T	G	6	10	16	0	1	17	0	0
7	41274258	.	T	C	9	13	22	0	0	22	0	0
7	41274261	.	A	G	8	1	9	0	12	21	0	0
7	41274802	.	C	A	20	6	26	0	2	28	0	0
7	41274896	.	A	C	13	11	24	0	2	26	0	0
7	41274916	.	A	C	10	14	24	0	0	25	1	0
7	41274943	.	T	A	12	14	26	0	0	26	0	0
7	41313645	.	G	A	3	4	7	0	0	7	0	0
7	41313894	.	G	C	5	2	7	0	0	7	0	0
7	41314900	.	G	T	3	5	8	0	0	8	0	0
7	41316722	.	T	G	8	6	14	0	0	14	0	0
7	41318020	.	A	G	1	2	3	0	0	3	0	0
7	41318023	.	A	T	1	2	3	0	0	3	0	0
7	41318087	.	A	T	1	3	4	0	0	4	0	0
7	41322946	.	G	A	4	4	8	0	0	8	0	0
7	41322973	.	C	A	4	4	8	0	0	8	0	0
7	41323119	.	T	G	4	4	8	0	0	8	0	0
7	41329674	.	T	G	2	2	4	0	0	4	0	0
7	41329683	.	A	G	1	2	3	0	0	3	0	0
7	41329736	.	C	T	4	2	6	0	0	6	0	0
7	41329778	.	A	G	2	0	2	0	2	5	1	0
7	41329840	.	G	A	1	2	3	0	0	3	0	0
7	41330059	.	T	A	3	2	5	0	0	5	0	0
7	41336553	.	C	T	1	2	3	0	0	3	0	0
7	41340641	.	T	C	9	5	14	0	1	15	0	0
7	41340840	.	C	A	7	6	13	0	0	13	0	0
7	41344440	.	T	A	5	3	8	0	0	8	0	0
7	41345059	.	G	A	7	2	9	0	0	9	0	0
7	41345105	.	C	T	3	5	8	0	0	8	0	0
7	41345123	.	C	T	3	5	8	0	0	8	0	0
7	41345282	.	A	C	6	2	8	0	1	9	0	0
7	41345393	.	A	T	3	2	5	0	1	6	0	0
7	41345463	.	T	G	5	2	7	0	0	7	0	0
7	41345720	.	G	A	2	5	7	0	0	7	0	0
7	41345723	.	T	C	2	5	7	0	0	7	0	0
7	41347123	.	A	G	9	0	9	0	7	16	0	0
7	41347138	.	C	T	9	6	15	0	0	15	0	0
7	41347642	.	T	C	6	6	12	0	1	13	0	0
7	41347813	.	C	T	4	4	8	0	0	8	0	0
7	41347897	.	C	T	5	2	7	0	0	7	0	0
7	41348023	.	C	T	2	2	4	0	0	4	0	0
7	41348026	.	T	C	2	1	3	0	0	3	0	0
7	41349128	.	C	T	0	3	3	0	6	9	0	0
7	41349454	.	G	T	7	9	16	0	0	16	0	0
7	41350424	.	A	G	5	3	8	0	0	8	0	0
7	41352145	.	T	A	8	5	13	0	1	15	1	0
7	41355308	.	T	C	5	5	10	0	2	13	1	0
7	41356140	.	T	C	2	3	5	0	0	5	0	0
7	41356188	.	A	G	3	4	7	0	1	8	0	0
7	41356547	.	C	T	8	4	12	0	0	12	0	0
7	41357331	.	C	T	3	5	8	0	0	8	0	0
7	41357602	.	G	A	3	6	9	0	0	9	0	0
7	41357623	.	G	C	3	4	7	0	0	7	0	0
7	41358708	.	C	T	2	3	5	0	0	5	0	0
7	41360436	.	T	C	4	2	6	0	1	7	0	0
7	41361864	.	A	G	1	5	6	0	0	6	0	0
7	41362017	.	A	T	2	4	6	0	1	7	0	0
7	41362029	.	G	A	1	6	7	0	0	7	0	0
7	41362945	.	A	G	3	2	5	0	0	5	0	0
7	41362984	.	G	A	1	4	5	0	0	5	0	0
7	41363014	.	C	G	1	6	7	0	0	7	0	0
7	41363031	.	C	G	1	3	4	0	0	4	0	0
7	41363065	.	T	C	3	6	9	0	1	10	0	0
7	41363510	.	C	T	4	3	7	0	0	7	0	0
7	41364202	.	C	T	4	2	6	0	0	6	0	0
7	41364578	.	G	A	4	4	8	0	0	8	0	0
7	41367337	.	G	A	2	3	5	0	0	5	0	0
7	41367380	.	A	T	2	4	6	0	0	6	0	0
7	41367788	.	C	G	0	5	5	0	4	9	0	0
7	41369467	.	T	C	2	3	5	0	0	5	0	0
7	41370434	.	G	A	3	2	5	0	0	5	0	0
7	41372423	.	A	G	4	3	7	0	0	7	0	0
7	41374552	.	A	G	2	3	5	0	0	5	0	0
7	41376151	.	G	A	1	2	3	0	0	3	0	0
7	41376169	.	A	G	1	2	3	0	0	3	0	0
7	41377516	.	G	A	2	4	6	0	0	6	0	0
7	41384202	.	G	A	2	2	4	0	0	4	0	0
7	41384359	.	G	T	4	2	6	0	0	6	0	0
7	41384630	.	G	A	2	4	6	0	0	6	0	0
7	41385386	.	A	G	2	2	4	0	0	4	0	0
7	41401851	.	C	T	5	4	9	0	0	9	0	0
7	41401881	.	T	C	6	3	9	0	0	9	0	0
7	41402943	.	C	G	3	7	10	0	0	10	0	0
7	41402988	.	G	C	2	7	9	0	0	9	0	0
7	41403991	.	A	T	7	6	13	0	0	13	0	0
7	41404012	.	A	G	12	7	19	0	0	19	0	0
7	41404081	.	C	T	16	4	20	0	1	21	0	0
7	41404090	.	T	C	11	5	16	0	1	17	0	0
7	41404219	.	A	T	16	3	19	1	0	20	0	0
7	41404434	.	T	C	9	0	9	0	3	12	0	0
7	41404552	.	G	A	6	8	14	0	0	14	0	0
7	41404564	.	A	G	3	9	12	0	1	13	0	0
7	41405926	.	A	G	5	7	12	1	0	13	0	0
7	41413530	.	G	A	9	3	12	0	0	12	0	0
7	41413760	.	C	T	6	5	11	0	0	11	0	0
7	41413781	.	A	T	4	3	7	0	2	9	0	0
7	41413829	.	T	C	11	4	15	0	1	16	0	0
7	41413838	.	A	C	12	0	12	0	5	17	0	0
7	41416192	.	G	A	9	3	12	0	0	12	0	0
7	41419036	.	A	C	2	4	6	0	0	6	0	0
7	41419132	.	G	A	4	11	15	0	1	16	0	0
7	41419183	.	G	T	8	9	17	0	2	19	0	0
7	41422030	.	T	A	6	3	9	0	0	9	0	0
7	41422123	.	C	A	3	2	5	0	0	5	0	0
7	41422318	.	C	G	5	4	9	0	0	9	0	0
7	41427737	.	G	T	6	10	16	0	0	16	0	0
7	41430417	.	T	C	8	13	21	0	0	21	0	0
7	41431901	.	A	T	8	9	17	0	0	17	0	0
7	41431916	.	T	C	10	7	17	0	1	18	0	0
7	41432220	.	G	A	2	10	12	0	13	25	0	0
7	41432324	.	T	A	5	6	11	0	0	11	0	0
7	41432676	.	T	C	9	12	21	0	1	22	0	0
7	41432732	.	A	T	12	10	22	0	1	23	0	0
7	41432906	.	T	C	11	6	17	0	0	17	0	0
7	41433244	.	A	G	1	0	1	0	7	8	0	0
7	41436575	.	T	C	6	0	6	0	3	9	0	0
7	41436811	.	T	A	6	3	9	0	0	9	0	0
7	41436902	.	A	G	6	5	11	0	0	11	0	0
7	41436907	.	G	A	8	6	14	0	0	14	0	0
7	41437342	.	A	C	9	15	24	0	3	27	0	0
7	41437363	.	A	G	8	12	20	0	1	21	0	0
7	41437623	.	C	A	9	13	22	0	1	23	0	0
7	41437715	.	T	G	11	9	20	0	0	20	0	0
7	41437827	.	C	A	0	14	14	0	7	21	0	0
7	41437948	.	G	A	10	7	17	0	0	17	0	0
7	41438036	.	A	C	8	7	15	0	0	15	0	0
7	41438417	.	T	A	9	3	12	0	0	12	0	0
7	41438502	.	C	T	1	3	4	0	6	10	0	0
7	41438676	.	G	T	6	5	11	0	0	12	1	0
7	41438677	.	T	C	5	6	11	0	1	12	0	0
7	41438826	.	C	T	2	10	12	0	11	23	0	0
7	41438871	.	C	T	2	8	10	0	8	18	0	0
7	41438896	.	C	T	1	5	6	0	11	17	0	0
7	41438970	.	G	A	8	10	18	0	0	18	0	0
7	41439411	.	C	T	2	16	18	0	11	29	0	0
7	41443125	.	G	A	8	11	19	0	0	19	0	0
7	41443186	.	C	T	0	11	11	1	9	21	0	0
7	41452225	.	T	C	9	0	9	0	10	19	0	0
7	41491635	.	T	G	2	5	7	0	1	8	0	0
7	41491652	.	C	T	1	4	5	0	0	5	0	0
7	41491701	.	A	T	7	4	11	0	0	11	0	0
7	41491785	.	A	G	8	5	13	0	1	14	0	0
7	41496791	.	G	A	10	7	17	0	0	17	0	0
7	41498075	.	T	C	6	6	12	0	0	12	0	0
7	41500538	.	A	G	6	5	11	0	1	12	0	0
7	41500676	.	G	A	5	4	9	0	0	9	0	0
7	41501061	.	A	G	7	3	10	0	0	10	0	0
7	41501124	.	A	G	13	5	18	0	0	18	0	0
7	41503775	.	G	A	6	4	10	0	0	10	0	0
7	41506677	.	A	G	4	5	9	0	1	10	0	0
7	41506683	.	T	C	4	6	10	0	0	10	0	0
7	41511515	.	G	T	2	2	4	0	1	5	0	0
7	41511626	.	C	T	3	7	10	0	0	10	0	0
7	41511804	.	T	C	3	5	8	0	0	8	0	0
7	41511939	.	A	C	6	7	13	0	1	14	0	0
7	41512171	.	A	T	3	4	7	0	0	7	0	0
7	41512833	.	T	A	7	4	11	0	0	11	0	0
7	41517442	.	C	G	6	5	11	0	1	12	0	0
7	41517467	.	A	G	9	6	15	0	2	17	0	0
7	41517659	.	G	A	3	2	5	0	1	6	0	0
7	41517909	.	T	A	4	4	8	0	1	9	0	0
7	41517978	.	A	G	7	8	15	0	0	15	0	0
7	41518033	.	G	A	6	11	17	0	1	18	0	0
7	41518109	.	C	A	8	7	15	0	0	15	0	0
7	41518146	.	G	A	6	9	15	0	0	15	0	0
7	41518147	.	C	G	6	9	15	0	0	15	0	0
7	41518217	.	C	A	1	9	10	0	11	21	0	0
7	41518328	.	T	G	7	6	13	0	2	15	0	0
7	41518420	.	G	C	5	5	10	0	0	10	0	0
7	41518721	.	G	T	14	6	20	0	1	21	0	0
7	41518727	.	C	T	14	7	21	0	0	21	0	0
7	41518871	.	T	G	4	7	11	0	0	11	0	0
7	41518875	.	G	A	5	6	11	0	0	11	0	0
7	41519283	.	A	C	3	4	7	0	1	8	0	0
7	41519284	.	G	A	4	4	8	0	0	8	0	0
7	41519390	.	A	G	4	4	8	0	0	8	0	0
7	41550790	.	T	A	4	5	9	0	1	10	0	0
7	41574673	.	C	G	3	4	7	0	0	7	0	0
7	41627738	.	C	T	0	2	2	0	2	4	0	0
7	41627745	.	C	T	1	3	4	0	1	5	0	0
7	41627849	.	G	C	4	4	8	0	1	9	0	0
7	41627885	.	T	G	4	4	8	0	0	8	0	0
7	41635155	.	C	T	2	3	5	0	0	5	0	0
7	41635183	.	A	T	1	3	4	0	0	4	0	0
7	41714059	.	C	T	1	5	6	0	0	6	0	0
7	41714076	.	A	T	1	5	6	0	0	6	0	0
7	41714140	.	C	T	0	5	5	0	4	9	0	0
7	41714196	.	T	A	7	5	12	0	1	13	0	0
7	41714205	.	C	T	8	4	12	0	1	13	0	0
7	41714244	.	A	G	5	2	7	0	0	7	0	0
7	41714377	.	T	G	6	3	9	0	1	10	0	0
7	41714385	.	T	C	2	4	6	0	3	9	0	0
7	41714481	.	C	T	3	5	8	0	0	8	0	0
7	41714923	.	G	A	7	8	15	0	0	15	0	0
7	41715156	.	A	T	2	4	6	0	0	6	0	0
7	41715288	.	C	T	0	4	4	0	4	8	0	0
7	41715446	.	G	A	11	5	16	0	1	17	0	0
7	41715594	.	T	A	3	11	14	0	2	16	0	0
7	41715721	.	T	A	5	7	12	0	0	12	0	0
7	41715794	.	C	T	1	3	4	0	8	12	0	0
7	41726186	.	C	T	11	4	15	0	3	18	0	0
7	41726280	.	A	C	14	1	15	0	5	20	0	0
7	41726339	.	C	T	1	8	9	0	14	23	0	0
7	41726355	.	G	T	13	11	24	0	0	24	0	0
7	41726535	.	G	T	3	2	5	0	0	5	0	0
7	41748916	.	G	T	14	9	23	0	2	25	0	0
7	41749093	.	A	T	11	7	18	0	1	19	0	0
7	41749150	.	A	G	11	12	23	0	1	24	0	0
7	41749382	.	C	T	14	5	19	0	0	19	0	0
7	41751146	.	C	T	17	7	24	0	0	24	0	0
7	41751510	.	T	C	7	10	17	0	0	17	0	0
7	41751671	.	C	T	18	10	28	0	0	28	0	0
7	41752422	.	G	T	15	4	19	1	0	20	0	0
7	41752440	.	A	C	15	8	23	1	0	24	0	0
7	41752463	.	A	G	17	0	17	1	13	31	0	0
7	41752497	.	C	A	15	9	24	3	0	27	0	0
7	41752507	.	C	G	15	6	21	3	0	24	0	0
7	41752631	.	A	G	21	9	30	0	1	31	0	0
7	41752662	.	G	A	22	7	29	0	2	31	0	0
7	41752892	.	T	A	7	6	13	0	1	14	0	0
7	41752974	.	T	G	11	0	11	0	7	18	0	0
7	41753107	.	T	A	7	2	9	0	0	9	0	0
7	41753195	.	A	T	6	7	13	1	1	15	0	0
7	41757730	.	G	A	22	20	42	0	3	45	0	0
7	41773951	.	T	G	20	21	41	0	0	41	0	0
7	41774020	.	A	G	16	24	40	0	2	42	0	0
7	41774035	.	G	A	15	25	40	0	3	43	0	0
7	41774125	.	A	G	20	32	52	0	3	55	0	0
7	41780925	.	A	T	19	18	37	0	4	41	0	0
7	41791391	.	A	G	12	8	20	0	0	20	0	0
7	41791469	.	T	C	26	28	54	0	0	54	0	0
7	41791538	.	G	A	26	18	44	0	2	46	0	0
7	41791857	.	C	T	20	24	44	0	1	45	0	0
7	41791920	.	C	T	14	22	36	0	2	38	0	0
7	41805215	.	G	T	17	14	31	0	0	31	0	0
7	41805518	.	C	T	12	12	24	0	0	24	0	0
7	41805881	.	G	A	24	11	35	0	2	37	0	0
7	41873215	.	A	T	4	5	9	0	1	10	0	0
7	41873256	.	C	T	8	11	19	0	1	20	0	0
7	41873257	.	T	G	9	11	20	0	1	21	0	0
7	41873368	.	T	A	13	9	22	0	2	24	0	0
7	41873426	.	T	C	14	7	21	0	0	21	0	0
7	41873503	.	A	G	12	10	22	0	1	23	0	0
7	41873554	.	A	T	19	11	30	0	1	31	0	0
7	41873691	.	T	C	12	17	29	0	2	31	0	0
7	41875854	.	C	A	1	2	3	0	1	4	0	0
7	41875856	.	T	A	1	2	3	0	0	3	0	0
7	41875951	.	T	C	17	14	31	0	1	32	0	0
7	41887524	.	A	C	2	3	5	0	1	6	0	0
7	41887690	.	C	A	8	4	12	0	0	12	0	0
7	41890937	.	A	T	2	5	7	0	0	7	0	0
7	41891612	.	C	G	9	4	13	0	0	13	0	0
7	41896315	.	A	C	2	6	8	0	0	8	0	0
7	41896385	.	A	G	3	9	12	0	0	12	0	0
7	41899051	.	A	C	5	4	9	0	0	9	0	0
7	41899096	.	G	A	1	2	3	0	0	3	0	0
7	41899097	.	C	T	1	2	3	0	0	3	0	0
7	41899352	.	C	T	4	3	7	0	2	9	0	0
7	41899426	.	C	A	6	8	14	0	1	15	0	0
7	41899674	.	T	C	2	6	8	0	2	10	0	0
7	41900180	.	C	T	0	2	2	0	4	6	0	0
7	41900402	.	G	C	3	3	6	0	1	7	0	0
7	41901355	.	A	G	7	9	16	0	0	16	0	0
7	41903555	.	A	G	1	2	3	0	0	3	0	0
7	41903633	.	T	A	10	12	22	1	1	24	0	0
7	41903681	.	C	T	18	17	35	0	1	36	0	0
7	41903907	.	A	G	5	14	19	0	0	19	0	0
7	41904152	.	A	G	23	28	51	0	2	53	0	0
7	41904520	.	G	A	20	37	57	0	1	58	0	0
7	41911604	.	C	T	2	32	34	0	18	52	0	0
7	41912618	.	T	C	22	9	31	0	2	33	0	0
7	41957814	.	G	A	13	10	23	0	0	23	0	0
7	41995046	.	T	C	20	19	39	0	0	39	0	0
7	42068201	.	C	T	10	10	20	0	0	20	0	0
7	42096376	.	C	A	11	8	19	0	1	20	0	0
7	42096378	.	A	G	12	8	20	0	0	20	0	0
7	42096413	.	C	T	2	9	11	0	12	23	0	0
7	42125466	.	G	A	12	15	27	0	1	28	0	0
7	42125480	.	C	G	11	12	23	0	2	25	0	0
7	42161814	.	G	A	13	8	21	0	0	21	0	0
7	42203869	.	T	C	9	8	17	0	0	17	0	0
7	42229877	.	C	T	9	9	18	0	2	20	0	0
7	42255966	.	C	T	16	9	25	0	0	25	0	0
7	42267249	.	C	T	8	7	15	0	0	15	0	0
7	42267339	.	T	C	7	6	13	0	0	13	0	0
7	42323699	.	G	C	0	10	10	0	15	25	0	0
7	42338816	.	A	G	18	12	30	6	0	36	0	0
7	42345361	.	G	T	11	11	22	0	0	22	0	0
7	42345681	.	T	A	21	10	31	0	0	31	0	0
7	42345782	.	G	A	4	2	6	0	0	6	0	0
7	42545468	.	G	A	1	2	3	0	0	3	0	0
7	42546067	.	G	A	1	2	3	0	2	5	0	0
7	42547161	.	C	T	1	2	3	0	0	3	0	0
7	43174642	.	G	A	21	13	34	0	1	35	0	0
7	43309851	.	T	G	8	16	24	0	3	27	0	0
7	43760755	.	T	C	13	5	18	0	5	24	1	0
7	43760822	.	G	A	16	13	29	0	2	31	0	0
7	43760875	.	T	A	14	17	31	0	1	32	0	0
7	43760881	.	G	A	13	15	28	0	0	28	0	0
7	43761810	.	T	A	10	10	20	0	3	23	0	0
7	43761966	.	C	T	2	17	19	0	19	38	0	0
7	43765189	.	A	G	13	15	28	0	0	28	0	0
7	43765197	.	A	G	15	13	28	0	0	28	0	0
7	43765348	.	G	A	19	15	34	0	0	34	0	0
7	43775054	.	G	A	14	20	34	0	1	35	0	0
7	43778690	.	C	G	13	21	34	0	1	35	0	0
7	43781554	.	G	T	12	10	22	0	1	23	0	0
7	43787480	.	C	G	10	9	19	0	1	20	0	0
7	43840624	.	C	T	6	9	15	0	0	15	0	0
7	43840669	.	G	C	6	3	9	0	0	9	0	0
7	45400754	.	A	T	3	2	5	0	0	5	0	0
7	45400790	.	C	T	18	7	25	0	0	25	0	0
7	45402452	.	C	T	30	18	48	0	0	48	0	0
7	45402887	.	C	A	14	20	34	0	2	36	0	0
7	45402989	.	C	T	16	15	31	0	0	31	0	0
7	45403244	.	C	T	18	11	29	0	0	29	0	0
7	45403292	.	G	A	20	8	28	0	3	31	0	0
7	45403294	.	A	T	21	10	31	0	0	31	0	0
7	45403360	.	T	G	15	11	26	0	0	26	0	0
7	45403370	.	A	T	15	12	27	0	1	28	0	0
7	45403416	.	C	T	12	11	23	1	1	25	0	0
7	45403735	.	G	A	2	5	7	0	5	12	0	0
7	45403793	.	G	A	4	8	12	0	0	12	0	0
7	45403831	.	A	C	6	3	9	0	0	9	0	0
7	45403868	.	C	T	4	2	6	0	0	6	0	0
7	45404063	.	T	G	3	4	7	0	1	8	0	0
7	45404098	.	T	A	2	3	5	0	0	5	0	0
7	45404107	.	G	T	3	2	5	0	0	5	0	0
7	45404490	.	C	T	8	12	20	0	0	20	0	0
7	45405163	.	C	T	9	8	17	0	0	17	0	0
7	45405179	.	G	T	10	5	15	0	1	16	0	0
7	45405236	.	T	G	1	1	2	0	8	10	0	0
7	45405244	.	T	C	2	8	10	0	0	10	0	0
7	45405839	.	G	T	4	5	9	0	0	9	0	0
7	45405871	.	A	C	4	3	7	0	0	7	0	0
7	45405992	.	C	T	2	3	5	0	0	5	0	0
7	45829008	.	A	G	1	2	3	0	0	3	0	0
7	45840234	.	T	A	1	3	4	0	0	4	0	0
7	45851949	.	A	C	1	2	3	0	0	3	0	0
7	45966120	.	C	T	5	3	8	0	0	8	0	0
7	45971509	.	A	T	5	3	8	0	1	9	0	0
7	45971514	.	C	T	6	2	8	0	3	11	0	0
7	46004948	.	T	G	12	8	20	0	2	22	0	0
7	46004971	.	C	G	13	8	21	0	1	22	0	0
7	46004991	.	C	G	14	1	15	0	8	23	0	0
7	46009596	.	A	G	6	2	8	0	0	8	0	0
7	46009637	.	G	C	1	2	3	0	0	3	0	0
7	46019166	.	G	T	1	2	3	0	0	3	0	0
7	46019199	.	C	G	1	4	5	0	0	5	0	0
7	46373295	.	A	G	3	8	11	0	0	11	0	0
7	46374272	.	T	A	5	6	11	0	2	13	0	0
7	46374390	.	A	G	10	9	19	0	0	19	0	0
7	46430098	.	C	T	11	6	17	0	0	18	1	0
7	46430530	.	G	A	15	8	23	0	0	23	0	0
7	46430696	.	T	A	10	10	20	0	1	21	0	0
7	46430847	.	C	G	11	11	22	0	3	25	0	0
7	46431108	.	T	A	11	15	26	0	0	26	0	0
7	46431256	.	C	A	16	12	28	0	3	31	0	0
7	46431273	.	C	G	15	15	30	0	0	30	0	0
7	46431319	.	A	G	13	10	23	0	1	24	0	0
7	46431577	.	G	A	18	14	32	0	0	32	0	0
7	46486048	.	C	T	9	12	21	0	0	21	0	0
7	46486244	.	A	C	8	17	25	0	1	26	0	0
7	46486629	.	G	A	0	17	17	0	10	27	0	0
7	46486719	.	G	T	17	14	31	0	0	31	0	0
7	46487322	.	C	T	8	15	23	0	1	24	0	0
7	46728721	.	A	C	8	0	8	0	5	13	0	0
7	46728791	.	A	C	9	3	12	0	0	12	0	0
7	46729545	.	C	T	0	8	8	0	4	12	0	0
7	46730076	.	A	G	7	6	13	0	0	13	0	0
7	46730178	.	A	T	8	9	17	0	1	18	0	0
7	46730199	.	A	C	12	3	15	0	4	19	0	0
7	46730469	.	C	T	12	18	30	0	1	31	0	0
7	46730705	.	C	T	10	10	20	0	2	22	0	0
7	46730754	.	G	A	9	6	15	0	0	15	0	0
7	46730820	.	T	C	5	0	5	0	15	20	0	0
7	46731141	.	C	T	7	8	15	0	1	16	0	0
7	46731669	.	T	C	7	8	15	0	0	15	0	0
7	46732134	.	G	A	11	7	18	0	0	18	0	0
7	46732365	.	C	T	3	4	7	0	0	7	0	0
7	46732680	.	G	A	8	10	18	0	1	19	0	0
7	46782166	.	A	T	2	5	7	0	0	7	0	0
7	47258811	.	T	A	1	4	5	0	0	5	0	0
7	47258820	.	T	C	1	4	5	0	0	5	0	0
7	47265898	.	G	A	1	3	4	0	1	5	0	0
7	47265934	.	G	A	0	3	3	0	1	4	0	0
7	47312602	.	G	A	2	6	8	0	1	9	0	0
7	47312817	.	C	T	2	9	11	0	0	11	0	0
7	47320044	.	G	A	11	5	16	0	0	16	0	0
7	47323685	.	C	T	10	4	14	0	0	14	0	0
7	47358452	.	A	G	10	0	10	0	6	16	0	0
7	47410829	.	C	T	12	6	18	0	1	19	0	0
7	47411358	.	C	A	9	11	20	0	0	20	0	0
7	47411617	.	A	G	3	3	6	0	1	7	0	0
7	47411764	.	G	A	2	7	9	0	0	9	0	0
7	47411783	.	G	T	3	10	13	0	0	13	0	0
7	47411837	.	T	G	7	0	7	0	7	14	0	0
7	47411838	.	G	A	7	6	13	0	1	14	0	0
7	47411934	.	C	T	8	12	20	0	0	20	0	0
7	47411962	.	C	A	12	7	19	0	1	20	0	0
7	47411977	.	C	T	7	13	20	0	0	20	0	0
7	47412000	.	T	A	19	6	25	0	0	25	0	0
7	47412040	.	C	T	18	10	28	0	0	28	0	0
7	47412203	.	A	C	17	10	27	0	3	30	0	0
7	47412215	.	C	T	12	11	23	0	0	23	0	0
7	47412366	.	C	T	12	3	15	0	0	15	0	0
7	47412373	.	C	T	4	10	14	0	0	14	0	0
7	47412447	.	T	A	14	11	25	0	0	25	0	0
7	47412525	.	C	T	4	6	10	0	1	11	0	0
7	47413691	.	A	T	8	2	10	0	0	10	0	0
7	47414174	.	C	T	10	5	15	0	1	16	0	0
7	47415036	.	G	A	12	13	25	0	0	25	0	0
7	47415181	.	G	T	1	4	5	0	1	6	0	0
7	47415257	.	A	T	6	6	12	0	0	12	0	0
7	47415272	.	C	T	4	6	10	0	1	11	0	0
7	47416473	.	G	A	11	5	16	1	0	17	0	0
7	47416825	.	A	G	14	1	15	0	13	28	0	0
7	47417002	.	C	A	8	10	18	0	0	18	0	0
7	47417080	.	T	C	9	2	11	0	0	11	0	0
7	47417195	.	T	A	2	6	8	0	0	8	0	0
7	47417821	.	C	T	3	14	17	0	1	18	0	0
7	47418320	.	C	T	11	8	19	0	1	20	0	0
7	47418526	.	T	C	10	17	27	0	0	27	0	0
7	47418657	.	G	A	19	16	35	0	1	36	0	0
7	47418697	.	C	A	17	13	30	0	0	30	0	0
7	47418847	.	T	A	10	7	17	0	0	17	0	0
7	47419070	.	T	A	11	9	20	0	2	22	0	0
7	47419114	.	A	C	10	7	17	0	1	18	0	0
7	47419842	.	G	A	17	18	35	0	0	35	0	0
7	47420115	.	T	G	7	1	8	0	28	36	0	0
7	47420119	.	T	G	6	1	7	0	28	35	0	0
7	47420208	.	A	G	24	15	39	0	0	39	0	0
7	47488312	.	G	A	14	13	27	0	1	28	0	0
7	47524444	.	T	C	10	11	21	0	0	21	0	0
7	47540131	.	G	C	6	0	6	0	6	12	0	0
7	47563381	.	A	T	8	9	17	0	0	17	0	0
7	47563614	.	C	A	7	4	11	0	0	11	0	0
7	47563677	.	A	G	8	10	18	0	0	18	0	0
7	47563853	.	G	A	5	3	8	0	0	8	0	0
7	47563872	.	A	G	3	4	7	0	1	8	0	0
7	47563890	.	A	G	3	5	8	0	0	8	0	0
7	47564430	.	A	G	2	6	8	0	0	9	1	0
7	47564703	.	A	G	6	4	10	0	0	10	0	0
7	47596554	.	G	A	8	7	15	0	1	16	0	0
7	47596641	.	G	A	8	4	12	0	2	14	0	0
7	47596707	.	T	C	4	0	4	0	8	12	0	0
7	47614319	.	G	A	4	7	11	0	1	12	0	0
7	47617247	.	T	C	12	5	17	0	0	17	0	0
7	47628203	.	G	A	6	6	12	0	0	12	0	0
7	47685609	.	G	A	5	4	9	0	0	9	0	0
7	47685610	.	C	G	3	5	8	0	1	9	0	0
7	47685718	.	C	T	4	6	10	0	0	10	0	0
7	47685719	.	G	A	6	3	9	0	0	9	0	0
7	47691411	.	C	T	1	3	4	0	3	7	0	0
7	47691435	.	A	G	5	3	8	0	0	8	0	0
7	47691483	.	A	G	6	5	11	0	0	11	0	0
7	47850274	.	C	T	1	2	3	0	0	3	0	0
7	48041940	.	G	A	8	14	22	0	0	22	0	0
7	48041967	.	G	A	9	15	24	0	1	25	0	0
7	48042195	.	G	A	8	7	15	0	1	16	0	0
7	48042456	.	A	G	6	19	25	0	0	25	0	0
7	48042483	.	G	T	8	13	21	0	2	23	0	0
7	48054942	.	T	A	4	5	9	0	1	10	0	0
7	48054990	.	G	A	8	10	18	0	1	19	0	0
7	48063519	.	A	G	3	11	14	1	0	15	0	0
7	48063546	.	A	G	2	5	7	1	1	9	0	0
7	48071605	.	T	C	5	10	15	0	1	16	0	0
7	48138432	.	T	C	11	0	11	0	7	18	0	0
7	48172753	.	A	G	6	5	11	0	0	11	0	0
7	48241629	.	T	A	7	2	9	0	0	9	0	0
7	48248933	.	A	T	2	3	5	0	0	5	0	0
7	48252774	.	A	T	2	3	5	0	0	5	0	0
7	48253584	.	T	G	3	1	4	0	1	5	0	0
7	48253589	.	A	C	2	2	4	0	0	4	0	0
7	48263490	.	G	A	2	2	4	0	0	4	0	0
7	48288848	.	A	G	9	22	31	0	1	32	0	0
7	48291844	.	A	G	15	16	31	0	2	33	0	0
7	48291864	.	G	A	16	19	35	0	0	35	0	0
7	48295902	.	G	T	14	9	23	0	0	23	0	0
7	48295910	.	C	T	14	9	23	0	0	23	0	0
7	48296181	.	T	G	3	3	6	0	0	6	0	0
7	48300621	.	T	C	6	3	9	0	0	9	0	0
7	48300648	.	G	C	9	5	14	0	0	14	0	0
7	48300795	.	C	T	2	6	8	0	1	9	0	0
7	48302925	.	A	G	7	10	17	0	2	19	0	0
7	48304118	.	C	T	4	6	10	0	0	10	0	0
7	48327801	.	A	G	4	5	9	0	0	9	0	0
7	48327867	.	C	A	5	15	20	0	0	20	0	0
7	48327906	.	T	C	3	8	11	0	0	11	0	0
7	48327912	.	C	T	4	8	12	0	0	12	0	0
7	48342519	.	A	T	3	4	7	0	0	7	0	0
7	48342526	.	T	C	2	4	6	0	0	6	0	0
7	48342575	.	C	T	1	3	4	0	0	4	0	0
7	48347478	.	T	G	9	8	17	0	0	17	0	0
7	48347680	.	A	C	12	10	22	0	1	23	0	0
7	48348003	.	G	A	8	16	24	0	0	24	0	0
7	48348006	.	A	G	8	14	22	0	1	23	0	0
7	48348062	.	C	T	5	9	14	0	0	14	0	0
7	48348485	.	A	G	8	9	17	0	1	18	0	0
7	48348519	.	C	T	7	4	11	0	0	11	0	0
7	48348554	.	G	A	5	9	14	2	0	16	0	0
7	48353844	.	G	A	14	7	21	0	0	21	0	0
7	48358792	.	A	T	9	6	15	0	0	15	0	0
7	48369043	.	C	G	1	10	11	0	15	26	0	0
7	48369306	.	G	A	4	4	8	0	0	8	0	0
7	48369999	.	C	T	9	6	15	0	0	15	0	0
7	48370014	.	T	G	9	6	15	0	0	15	0	0
7	48375704	.	A	G	4	4	8	0	0	8	0	0
7	48383527	.	A	G	9	5	14	0	0	14	0	0
7	48383605	.	A	G	1	3	4	0	0	4	0	0
7	48383811	.	C	T	2	4	6	0	0	6	0	0
7	48391532	.	C	T	5	8	13	0	1	14	0	0
7	48460315	.	C	T	24	15	39	0	2	41	0	0
7	48482286	.	C	A	12	20	32	0	0	32	0	0
7	48482370	.	C	T	7	12	19	0	0	19	0	0
7	48482616	.	T	C	7	3	10	0	0	10	0	0
7	48483513	.	T	A	16	17	33	0	2	35	0	0
7	48484269	.	T	C	13	18	31	1	2	34	0	0
7	48484307	.	G	A	0	12	12	1	5	18	0	0
7	48484416	.	G	A	7	3	10	0	1	11	0	0
7	48484621	.	C	T	8	13	21	0	0	21	0	0
7	48664032	.	A	G	4	4	8	0	0	8	0	0
7	48664862	.	C	T	1	5	6	0	0	6	0	0
7	48721692	.	C	T	1	4	5	0	1	6	0	0
7	48721832	.	A	C	4	3	7	0	0	7	0	0
7	48788256	.	G	A	1	2	3	0	0	3	0	0
7	48788265	.	A	T	1	3	4	0	0	4	0	0
7	48788369	.	T	C	5	10	15	0	0	15	0	0
7	48788389	.	G	C	7	0	7	0	7	14	0	0
7	48788622	.	G	A	3	4	7	0	0	7	0	0
7	48788790	.	A	T	3	3	6	0	0	6	0	0
7	48788791	.	T	A	3	3	6	0	0	6	0	0
7	48788910	.	C	T	4	5	9	0	0	9	0	0
7	48788966	.	C	T	4	4	8	0	1	9	0	0
7	48790794	.	A	C	3	4	7	0	1	8	0	0
7	48790824	.	A	G	1	4	5	0	1	6	0	0
7	48800907	.	G	A	2	2	4	0	0	4	0	0
7	48800943	.	T	C	1	2	3	0	0	3	0	0
7	48800997	.	G	T	4	2	6	0	1	7	0	0
7	48804973	.	C	T	2	2	4	0	1	5	0	0
7	48805026	.	G	A	1	3	4	0	0	4	0	0
7	48805629	.	C	T	7	8	15	0	1	16	0	0
7	48805874	.	G	A	1	2	3	0	0	3	0	0
7	48805939	.	A	G	1	4	5	0	0	5	0	0
7	48806542	.	G	A	13	6	19	0	0	19	0	0
7	48806809	.	T	C	11	15	26	0	0	26	0	0
7	48809031	.	T	C	9	14	23	0	0	23	0	0
7	48811446	.	C	T	10	9	19	0	1	20	0	0
7	48818563	.	T	C	16	13	29	0	1	30	0	0
7	48819684	.	A	G	9	25	34	0	3	37	0	0
7	48820740	.	T	A	12	9	21	0	0	21	0	0
7	48820773	.	C	T	15	11	26	0	0	26	0	0
7	48821065	.	T	C	14	4	18	0	2	20	0	0
7	48821331	.	T	C	13	9	22	1	0	23	0	0
7	48821362	.	C	T	14	12	26	1	0	27	0	0
7	48823809	.	A	T	12	13	25	0	0	25	0	0
7	48829569	.	G	C	18	14	32	0	1	33	0	0
7	48829728	.	A	G	10	5	15	0	2	17	0	0
7	48829926	.	A	T	2	4	6	1	0	7	0	0
7	49020658	.	G	A	11	9	20	0	0	20	0	0
7	49033078	.	A	G	6	7	13	0	0	13	0	0
7	49033102	.	T	G	7	0	7	0	6	13	0	0
7	49036296	.	T	C	8	8	16	0	0	16	0	0
7	49036549	.	A	G	6	0	6	0	11	17	0	0
7	49046764	.	C	T	11	10	21	0	0	21	0	0
7	49049686	.	G	C	12	8	20	0	0	20	0	0
7	49051660	.	C	T	14	12	26	0	2	28	0	0
7	49052044	.	T	A	18	13	31	0	3	34	0	0
7	49052097	.	T	G	15	17	32	0	1	33	0	0
7	49052112	.	C	T	11	18	29	0	1	30	0	0
7	49052138	.	G	A	11	14	25	0	1	26	0	0
7	49052333	.	C	T	9	10	19	0	0	19	0	0
7	49052359	.	A	G	9	10	19	0	1	20	0	0
7	49052476	.	G	A	12	10	22	0	3	25	0	0
7	49052575	.	G	A	10	6	16	0	0	16	0	0
7	49052625	.	C	T	5	7	12	0	0	12	0	0
7	49052840	.	T	G	9	0	9	0	13	22	0	0
7	49053143	.	T	C	4	2	6	0	0	6	0	0
7	49053300	.	A	T	4	16	20	0	0	20	0	0
7	49053314	.	T	A	6	15	21	0	0	21	0	0
7	49053445	.	A	G	15	8	23	0	1	24	0	0
7	49053454	.	T	A	16	8	24	0	1	25	0	0
7	49053483	.	A	C	18	3	21	0	1	22	0	0
7	49053491	.	T	A	15	3	18	0	2	20	0	0
7	49053785	.	G	C	15	10	25	0	4	29	0	0
7	49053977	.	C	T	9	6	15	0	1	16	0	0
7	49053991	.	A	G	13	0	13	0	4	17	0	0
7	49054161	.	G	A	5	3	8	0	0	8	0	0
7	49054212	.	C	A	4	3	7	0	0	7	0	0
7	49054419	.	A	G	21	6	27	0	0	27	0	0
7	49054475	.	T	C	11	10	21	0	0	21	0	0
7	49054739	.	A	G	11	13	24	0	2	26	0	0
7	49054885	.	C	T	15	9	24	0	0	24	0	0
7	49054899	.	C	T	11	7	18	0	3	21	0	0
7	49054981	.	T	A	2	2	4	0	0	4	0	0
7	49054985	.	T	C	2	2	4	0	0	4	0	0
7	49055227	.	G	A	0	8	8	0	7	15	0	0
7	49055256	.	T	C	6	8	14	0	2	16	0	0
7	49078896	.	T	A	2	2	4	0	0	4	0	0
7	49079010	.	A	T	2	5	7	0	0	7	0	0
7	49079029	.	T	G	3	4	7	0	1	8	0	0
7	49079163	.	C	A	2	4	6	0	0	6	0	0
7	49079167	.	T	C	2	4	6	0	0	6	0	0
7	49079241	.	A	T	4	3	7	0	0	7	0	0
7	49079278	.	T	C	3	3	6	0	0	6	0	0
7	49147462	.	G	C	5	2	7	0	1	8	0	0
7	49147525	.	C	T	6	4	10	0	1	11	0	0
7	49169991	.	C	T	6	2	8	0	0	8	0	0
7	49251540	.	A	G	5	6	11	0	0	11	0	0
7	49257220	.	C	T	8	11	19	0	2	21	0	0
7	49257333	.	T	C	5	9	14	0	0	14	0	0
7	49257384	.	T	C	9	7	16	0	0	16	0	0
7	49257686	.	G	T	8	4	12	0	0	12	0	0
7	49257774	.	C	T	7	6	13	0	3	16	0	0
7	49257979	.	A	G	12	13	25	0	0	25	0	0
7	49258012	.	G	A	14	11	25	0	1	26	0	0
7	49258132	.	G	C	11	5	16	0	0	16	0	0
7	49258279	.	C	T	11	6	17	0	1	18	0	0
7	49266802	.	G	C	10	6	16	0	1	17	0	0
7	49269896	.	A	G	6	1	7	0	10	17	0	0
7	49269913	.	A	G	7	0	7	0	11	18	0	0
7	49270932	.	T	C	7	7	14	0	0	14	0	0
7	49271069	.	C	T	7	8	15	0	0	15	0	0
7	49271121	.	G	T	3	8	11	0	2	13	0	0
7	49271147	.	A	C	8	9	17	0	0	17	0	0
7	49271208	.	C	T	11	10	21	0	0	21	0	0
7	49307224	.	C	G	3	2	5	0	1	6	0	0
7	49309592	.	T	C	2	3	5	0	0	5	0	0
7	49313688	.	T	C	2	5	7	0	0	7	0	0
7	49313925	.	T	A	4	3	7	0	0	7	0	0
7	49313966	.	A	C	4	3	7	0	0	7	0	0
7	49318812	.	C	T	1	2	3	0	0	3	0	0
7	49318819	.	G	A	1	2	3	0	0	3	0	0
7	49320253	.	G	A	3	6	9	0	0	9	0	0
7	49320342	.	A	T	4	3	7	0	1	8	0	0
7	49325125	.	G	A	10	3	13	0	0	13	0	0
7	49325319	.	T	C	5	9	14	0	1	15	0	0
7	49325346	.	A	G	5	11	16	0	0	16	0	0
7	49338336	.	G	A	14	22	36	0	1	37	0	0
7	49354829	.	A	T	3	2	5	0	0	5	0	0
7	49355496	.	T	C	9	0	9	0	19	28	0	0
7	49357357	.	G	A	17	26	43	0	2	45	0	0
7	49358228	.	A	C	17	16	33	0	1	34	0	0
7	49620241	.	T	C	3	0	3	0	4	7	0	0
7	49620298	.	C	T	2	2	4	0	1	5	0	0
7	49624379	.	T	C	5	0	5	0	3	8	0	0
7	49633361	.	A	G	1	2	3	0	0	3	0	0
7	49637226	.	A	T	2	3	5	0	0	5	0	0
7	49638742	.	G	A	4	2	6	0	0	6	0	0
7	49638748	.	T	A	4	2	6	0	0	6	0	0
7	49638880	.	T	G	6	6	12	0	0	12	0	0
7	49639272	.	G	T	7	4	11	0	0	11	0	0
7	49639609	.	C	T	3	2	5	0	1	6	0	0
7	49639701	.	T	C	4	2	6	0	1	7	0	0
7	49639876	.	A	T	10	10	20	0	0	20	0	0
7	49639926	.	A	C	7	7	14	0	0	14	0	0
7	49640040	.	G	A	12	8	20	0	3	23	0	0
7	49715779	.	C	G	1	4	5	0	0	5	0	0
7	49716731	.	C	G	2	2	4	0	0	4	0	0
7	49716935	.	T	A	1	2	3	0	1	4	0	0
7	49799470	.	A	T	5	3	8	0	0	8	0	0
7	49799526	.	T	A	5	3	8	0	1	9	0	0
7	49799584	.	G	A	2	3	5	0	0	5	0	0
7	49799805	.	A	T	5	3	8	0	0	8	0	0
7	49799890	.	T	C	1	2	3	0	0	3	0	0
7	49800039	.	T	C	6	0	6	0	4	10	0	0
7	50053347	.	C	T	3	10	13	0	0	13	0	0
7	50109317	.	T	C	11	6	17	0	0	17	0	0
7	50110585	.	C	T	11	6	17	0	1	18	0	0
7	50111330	.	C	T	13	8	21	0	0	21	0	0
7	50112025	.	C	T	9	11	20	0	1	21	0	0
7	50112039	.	T	G	11	11	22	0	1	23	0	0
7	50112063	.	G	A	15	11	26	0	0	26	0	0
7	50112196	.	A	G	8	0	8	0	0	20	12	0
7	50112286	.	T	C	4	11	15	0	0	15	0	0
7	50112383	.	G	A	15	6	21	0	3	24	0	0
7	50112460	.	C	T	18	10	28	0	0	28	0	0
7	50112825	.	A	T	18	13	31	0	0	31	0	0
7	50112922	.	C	A	6	5	11	0	3	14	0	0
7	50228314	.	C	A	7	11	18	0	0	18	0	0
7	50228326	.	T	C	9	1	10	0	10	20	0	0
7	50228355	.	C	T	11	12	23	0	0	23	0	0
7	50228548	.	T	C	5	6	11	0	0	11	0	0
7	50228702	.	A	T	2	6	8	0	0	8	0	0
7	50228785	.	C	G	2	8	10	0	0	10	0	0
7	50228872	.	A	C	4	3	7	0	0	7	0	0
7	50229223	.	T	C	4	8	12	1	0	13	0	0
7	50272707	.	G	A	15	16	31	0	0	31	0	0
7	50272779	.	A	G	14	14	28	0	1	29	0	0
7	50272859	.	A	G	7	7	14	0	2	16	0	0
7	50277832	.	G	C	1	2	3	0	0	3	0	0
7	50277869	.	T	A	3	3	6	0	0	6	0	0
7	50295823	.	G	A	8	9	17	0	0	17	0	0
7	50295974	.	G	T	8	7	15	0	0	15	0	0
7	50295997	.	T	A	6	4	10	0	2	12	0	0
7	50296016	.	A	G	5	2	7	0	0	7	0	0
7	50296545	.	T	G	5	4	9	0	0	9	0	0
7	50296815	.	G	A	2	6	8	0	0	8	0	0
7	50296981	.	A	G	14	6	20	0	0	20	0	0
7	50299379	.	G	A	11	8	19	0	0	19	0	0
7	50323793	.	A	G	7	4	11	0	0	11	0	0
7	50323934	.	G	A	6	8	14	0	1	15	0	0
7	50323967	.	C	T	0	5	5	0	3	8	0	0
7	50324984	.	C	T	5	6	11	0	0	11	0	0
7	50325006	.	G	C	6	5	11	0	1	12	0	0
7	50333581	.	T	C	4	5	9	0	0	9	0	0
7	50333629	.	T	C	1	9	10	0	0	10	0	0
7	50338221	.	A	T	10	7	17	0	0	17	0	0
7	50348175	.	A	G	2	4	6	0	0	6	0	0
7	50348280	.	T	C	4	3	7	0	0	7	0	0
7	50348448	.	T	C	4	2	6	0	1	7	0	0
7	50349225	.	T	C	11	10	21	0	1	22	0	0
7	50362952	.	T	C	1	2	3	0	0	3	0	0
7	50376255	.	A	G	1	2	3	0	0	3	0	0
7	50376285	.	A	G	2	3	5	0	0	5	0	0
7	50376395	.	G	A	3	4	7	0	1	8	0	0
7	50376518	.	C	A	6	6	12	1	0	13	0	0
7	50376720	.	A	T	10	4	14	0	0	14	0	0
7	50376751	.	G	A	6	5	11	0	0	11	0	0
7	50377025	.	A	G	7	6	13	0	0	13	0	0
7	50377045	.	C	T	0	6	6	0	7	13	0	0
7	50388219	.	C	T	2	5	7	0	6	13	0	0
7	50388859	.	C	T	6	3	9	0	0	9	0	0
7	50394956	.	C	T	4	5	9	0	2	11	0	0
7	50395016	.	T	C	2	4	6	0	0	6	0	0
7	50395043	.	A	T	2	4	6	0	0	6	0	0
7	50395947	.	T	G	3	4	7	0	0	7	0	0
7	50396019	.	C	T	4	2	6	0	0	6	0	0
7	50399759	.	A	G	9	1	10	0	13	23	0	0
7	50399782	.	T	C	8	9	17	0	0	17	0	0
7	50400267	.	A	G	10	10	20	0	0	20	0	0
7	50407469	.	A	G	5	10	15	0	2	17	0	0
7	50407532	.	T	C	6	7	13	0	1	14	0	0
7	50407587	.	T	C	10	11	21	0	1	22	0	0
7	50407588	.	C	A	11	11	22	0	0	22	0	0
7	50407724	.	C	T	11	16	27	1	1	29	0	0
7	50410394	.	T	A	15	30	45	0	2	47	0	0
7	50410475	.	T	C	9	12	21	0	1	22	0	0
7	50476306	.	A	T	1	2	3	0	0	3	0	0
7	50476320	.	G	A	1	2	3	0	0	3	0	0
7	50481338	.	G	A	2	2	4	0	0	4	0	0
7	50482454	.	T	C	1	2	3	0	0	3	0	0
7	50482575	.	T	C	1	0	1	0	2	3	0	0
7	50548086	.	A	G	3	6	9	0	1	10	0	0
7	50551859	.	A	T	2	3	5	0	0	5	0	0
7	50586497	.	A	T	3	3	6	0	1	7	0	0
7	50766151	.	T	C	1	4	5	0	1	6	0	0
7	50766240	.	A	C	3	5	8	0	0	8	0	0
7	50828894	.	T	A	7	10	17	0	0	17	0	0
7	50828998	.	C	T	4	12	16	0	1	17	0	0
7	50829201	.	A	C	8	7	15	0	1	16	0	0
7	50829360	.	G	C	10	8	18	0	1	19	0	0
7	50829393	.	G	A	8	9	17	0	2	19	0	0
7	50830997	.	C	T	8	14	22	0	0	22	0	0
7	50831901	.	G	A	10	10	20	0	1	21	0	0
7	50833143	.	T	C	4	10	14	0	0	14	0	0
7	50833262	.	C	T	8	13	21	0	1	22	0	0
7	50833928	.	C	G	5	0	5	0	10	15	0	0
7	50833943	.	C	A	5	6	11	0	0	11	0	0
7	50833979	.	C	T	8	11	19	0	1	20	0	0
7	50834821	.	A	G	9	13	22	0	1	23	0	0
7	50836382	.	C	T	11	11	22	0	1	23	0	0
7	50836424	.	C	T	12	10	22	0	1	23	0	0
7	50837949	.	G	A	11	12	23	1	0	24	0	0
7	50838135	.	G	C	0	13	13	0	12	25	0	0
7	50838194	.	C	A	11	10	21	0	0	21	0	0
7	50838210	.	G	T	0	10	10	0	13	23	0	0
7	50838251	.	C	T	13	11	24	0	0	24	0	0
7	50840008	.	C	T	11	11	22	0	2	24	0	0
7	50840428	.	G	A	11	8	19	0	0	19	0	0
7	50840512	.	C	T	9	20	29	0	2	31	0	0
7	50841072	.	G	A	18	14	32	0	0	32	0	0
7	50841237	.	C	T	25	17	42	0	1	43	0	0
7	50841690	.	G	A	1	10	11	0	11	22	0	0
7	50841693	.	A	T	10	11	21	0	1	22	0	0
7	50843813	.	C	A	20	14	34	0	2	36	0	0
7	50843827	.	A	G	17	14	31	0	8	39	0	0
7	50844142	.	G	A	15	22	37	1	0	38	0	0
7	50844165	.	C	T	17	17	34	1	0	35	0	0
7	50844830	.	G	T	10	6	16	0	2	18	0	0
7	50844834	.	G	A	0	11	11	0	9	20	0	0
7	50844895	.	A	T	10	14	24	0	0	24	0	0
7	50844936	.	A	T	8	9	17	0	1	18	0	0
7	50845000	.	G	A	25	12	37	0	2	39	0	0
7	50845105	.	A	T	14	9	23	0	1	24	0	0
7	50845158	.	A	G	13	8	21	0	2	23	0	0
7	50845210	.	A	G	12	18	30	0	1	31	0	0
7	50845331	.	G	A	1	3	4	0	6	10	0	0
7	50845486	.	A	T	6	6	12	0	0	12	0	0
7	50845646	.	C	T	7	3	10	0	0	10	0	0
7	50845892	.	C	A	12	15	27	0	2	29	0	0
7	50846055	.	T	C	9	12	21	1	0	22	0	0
7	50846081	.	T	A	10	4	14	1	2	17	0	0
7	50877064	.	T	C	2	8	10	0	0	10	0	0
7	50878385	.	T	C	7	4	11	0	0	11	0	0
7	50879257	.	C	G	3	3	6	0	0	6	0	0
7	50879591	.	T	C	3	5	8	0	2	10	0	0
7	50879595	.	C	T	4	6	10	0	0	10	0	0
7	50880436	.	A	G	3	2	5	0	1	6	0	0
7	50880703	.	G	A	1	4	5	0	0	5	0	0
7	50880885	.	C	A	1	3	4	0	3	7	0	0
7	50880927	.	G	T	1	3	4	0	0	4	0	0
7	50880933	.	T	A	1	3	4	0	0	4	0	0
7	50881252	.	G	A	1	2	3	0	0	3	0	0
7	50881363	.	C	T	3	6	9	0	2	11	0	0
7	50881465	.	A	G	4	4	8	0	0	8	0	0
7	50881600	.	G	A	4	2	6	0	0	6	0	0
7	50881641	.	G	T	3	6	9	0	3	12	0	0
7	50882104	.	G	A	5	2	7	0	0	7	0	0
7	50882215	.	A	T	3	9	12	0	0	12	0	0
7	50882379	.	C	T	1	4	5	0	1	6	0	0
7	50883030	.	C	T	1	4	5	0	0	5	0	0
7	50883281	.	C	T	3	5	8	0	0	8	0	0
7	50911223	.	T	A	9	4	13	0	1	14	0	0
7	50911278	.	C	T	20	18	38	0	0	38	0	0
7	50912212	.	C	T	14	10	24	0	1	25	0	0
7	50912227	.	C	G	15	9	24	0	2	26	0	0
7	50917219	.	C	T	16	5	21	0	0	21	0	0
7	50922406	.	C	T	1	1	2	0	1	3	0	0
7	51186556	.	G	A	0	2	2	0	1	3	0	0
7	51219420	.	C	G	3	8	11	0	2	13	0	0
7	51219436	.	A	C	12	4	16	0	0	16	0	0
7	51219963	.	T	C	12	4	16	0	0	16	0	0
7	51219964	.	T	C	14	3	17	0	0	17	0	0
7	51220739	.	A	G	9	13	22	0	0	22	0	0
7	51220740	.	C	A	0	12	12	0	9	22	1	0
7	51221418	.	T	A	5	7	12	0	0	12	0	0
7	51221475	.	C	T	3	3	6	0	1	7	0	0
7	51221784	.	A	G	5	3	8	0	0	8	0	0
7	51222115	.	G	A	5	6	11	0	0	11	0	0
7	51222297	.	G	A	5	4	9	0	0	9	0	0
7	51246316	.	T	C	4	2	6	0	2	8	0	0
7	51246426	.	G	A	10	12	22	0	2	24	0	0
7	51246457	.	G	T	15	10	25	0	1	26	0	0
7	51246573	.	T	C	15	12	27	0	0	27	0	0
7	51247467	.	C	T	0	6	6	0	8	14	0	0
7	51248010	.	C	A	3	4	7	0	0	7	0	0
7	51248756	.	C	A	0	10	10	0	7	17	0	0
7	51248834	.	C	T	0	5	5	0	6	11	0	0
7	51249441	.	G	T	4	5	9	0	2	11	0	0
7	51353191	.	G	A	7	3	10	0	0	10	0	0
7	51353421	.	C	T	6	4	10	0	0	10	0	0
7	51353447	.	G	T	8	5	13	0	0	13	0	0
7	51353854	.	T	A	2	3	5	0	0	5	0	0
7	51354424	.	T	A	4	4	8	0	0	8	0	0
7	51354442	.	C	A	5	2	7	0	0	7	0	0
7	51355196	.	A	G	5	3	8	0	0	8	0	0
7	51356078	.	A	G	1	3	4	0	0	4	0	0
7	51356100	.	A	T	4	4	8	0	0	8	0	0
7	51356282	.	T	C	3	0	3	0	1	4	0	0
7	51356303	.	G	A	2	3	5	0	0	5	0	0
7	51356319	.	G	A	0	3	3	0	4	7	0	0
7	51356542	.	C	G	11	6	17	0	0	17	0	0
7	51356625	.	C	A	11	4	15	0	2	17	0	0
7	51356733	.	G	T	5	2	7	0	0	7	0	0
7	51376177	.	G	C	3	3	6	0	0	6	0	0
7	51468119	.	C	T	12	17	29	0	1	30	0	0
7	51468241	.	C	T	16	9	25	0	1	26	0	0
7	51468389	.	C	T	1	12	13	0	20	33	0	0
7	51468411	.	A	T	16	9	25	0	2	27	0	0
7	51468577	.	C	A	16	17	33	0	1	34	0	0
7	51469048	.	T	G	23	18	41	0	0	41	0	0
7	51469166	.	A	T	15	14	29	0	0	29	0	0
7	51469267	.	G	C	12	11	23	0	1	24	0	0
7	51469304	.	T	A	9	11	20	0	0	20	0	0
7	51469518	.	T	A	12	15	27	0	1	28	0	0
7	51469578	.	T	G	10	13	23	0	0	23	0	0
7	51469814	.	C	T	3	14	17	0	7	24	0	0
7	51469897	.	A	G	8	9	17	0	0	17	0	0
7	51470070	.	T	C	4	1	5	0	6	11	0	0
7	51470286	.	T	C	2	5	7	0	0	7	0	0
7	51470569	.	G	T	2	9	11	0	2	13	0	0
7	51471026	.	G	T	1	2	3	0	0	3	0	0
7	51471201	.	G	A	9	11	20	0	0	20	0	0
7	51471379	.	G	A	2	9	11	0	1	12	0	0
7	51471714	.	A	G	11	8	19	0	1	20	0	0
7	51472102	.	C	T	5	4	9	0	0	9	0	0
7	51472456	.	C	T	6	4	10	0	0	10	0	0
7	51472534	.	T	A	8	3	11	0	0	11	0	0
7	51472536	.	T	A	7	3	10	0	0	11	1	0
7	51472793	.	A	C	7	1	8	0	8	16	0	0
7	51472853	.	G	A	10	12	22	0	1	23	0	0
7	51473814	.	C	T	10	9	19	0	0	19	0	0
7	51473831	.	T	G	8	8	16	0	1	17	0	0
7	51474238	.	G	A	5	13	18	0	0	18	0	0
7	51474279	.	C	A	11	7	18	0	1	19	0	0
7	51474300	.	G	T	11	7	18	0	1	19	0	0
7	51474832	.	T	G	9	8	17	0	0	17	0	0
7	51475180	.	A	G	7	9	16	0	0	16	0	0
7	51475288	.	G	A	5	7	12	0	0	12	0	0
7	51475578	.	A	G	9	5	14	0	0	14	0	0
7	51475795	.	T	A	9	8	17	0	0	17	0	0
7	51476108	.	G	A	5	10	15	0	0	15	0	0
7	51476634	.	G	T	5	5	10	1	0	11	0	0
7	51483327	.	G	A	4	5	9	0	0	9	0	0
7	51483357	.	G	A	5	2	7	0	0	7	0	0
7	51493063	.	C	T	0	5	5	0	5	10	0	0
7	51634285	.	C	T	28	33	61	0	2	63	0	0
7	51634480	.	G	A	40	29	69	0	1	70	0	0
7	51635615	.	A	G	29	41	70	0	1	71	0	0
7	51643163	.	A	G	4	3	7	0	0	7	0	0
7	51643212	.	G	A	3	4	7	0	0	7	0	0
7	51643409	.	C	A	2	4	6	0	0	6	0	0
7	51643639	.	A	C	1	5	6	0	0	6	0	0
7	51656560	.	A	T	2	2	4	0	0	4	0	0
7	51656576	.	A	G	1	2	3	0	0	3	0	0
7	51698403	.	T	A	4	6	10	0	0	10	0	0
7	51702899	.	G	C	7	0	7	0	3	10	0	0
7	51705806	.	C	G	4	4	8	0	0	8	0	0
7	51709223	.	A	G	9	6	15	0	0	15	0	0
7	51713257	.	G	A	2	5	7	0	0	7	0	0
7	51713267	.	G	A	1	5	6	0	1	7	0	0
7	51714712	.	A	G	3	3	6	0	0	6	0	0
7	51716162	.	C	G	1	2	3	0	0	3	0	0
7	51779628	.	G	A	17	25	42	0	0	42	0	0
7	51779636	.	T	C	18	25	43	0	1	44	0	0
7	51785901	.	T	C	22	22	44	0	4	48	0	0
7	51788227	.	T	G	32	25	57	0	3	60	0	0
7	51788756	.	A	C	17	17	34	2	3	39	0	0
7	51795788	.	T	C	7	5	12	0	0	12	0	0
7	51795791	.	G	T	6	5	11	0	1	12	0	0
7	51795827	.	C	T	6	6	12	0	1	13	0	0
7	51808319	.	T	A	4	2	6	0	1	7	0	0
7	51808327	.	T	C	3	6	9	0	0	9	0	0
7	51808555	.	A	G	2	0	2	0	3	5	0	0
7	51811165	.	G	A	5	3	8	0	0	8	0	0
7	51814445	.	T	A	8	3	11	0	0	11	0	0
7	51826045	.	A	G	2	0	2	0	3	5	0	0
7	52150911	.	A	G	3	4	7	0	0	7	0	0
7	52151265	.	T	G	2	2	4	0	0	4	0	0
7	52152016	.	C	T	2	3	5	0	0	5	0	0
7	52152053	.	A	T	2	2	4	0	0	4	0	0
7	52152063	.	C	T	0	2	2	0	3	5	0	0
7	52152791	.	C	A	0	2	2	0	2	4	0	0
7	52152863	.	G	A	1	4	5	0	1	6	0	0
7	52153006	.	C	T	2	3	5	0	0	5	0	0
7	52156095	.	G	A	0	5	5	0	3	8	0	0
7	52156113	.	G	A	0	3	3	0	6	9	0	0
7	52156137	.	T	A	4	4	8	0	0	8	0	0
7	52157845	.	A	T	3	8	11	0	0	11	0	0
7	52161931	.	C	G	3	3	6	0	1	7	0	0
7	52165468	.	G	C	8	5	13	0	0	13	0	0
7	52165601	.	C	T	4	5	9	0	0	9	0	0
7	52165631	.	C	T	6	6	12	0	0	12	0	0
7	52173207	.	G	A	8	5	13	0	0	13	0	0
7	52173228	.	A	G	8	3	11	0	0	11	0	0
7	52285027	.	T	C	8	8	16	0	1	17	0	0
7	52285035	.	C	T	9	6	15	0	0	15	0	0
7	52285113	.	C	G	7	7	14	0	2	16	0	0
7	52293935	.	C	T	1	2	3	0	1	4	0	0
7	52294009	.	G	T	5	5	10	0	0	10	0	0
7	52294540	.	A	T	18	14	32	0	0	32	0	0
7	52294579	.	C	T	18	12	30	0	0	30	0	0
7	52294756	.	A	T	9	15	24	0	0	24	0	0
7	52295016	.	C	T	4	16	20	0	13	33	0	0
7	52295183	.	G	A	21	13	34	0	2	36	0	0
7	52295795	.	C	T	2	13	15	0	10	25	0	0
7	52296018	.	T	C	19	5	24	1	5	30	0	0
7	52296064	.	A	C	15	0	15	0	15	30	0	0
7	52296221	.	G	A	17	14	31	0	0	31	0	0
7	52296281	.	T	C	15	5	20	0	2	22	0	0
7	52296320	.	G	A	7	8	15	0	1	16	0	0
7	52296352	.	G	T	6	6	12	0	0	12	0	0
7	52296791	.	G	A	14	19	33	0	0	33	0	0
7	52309924	.	G	A	12	10	22	0	2	24	0	0
7	52315434	.	C	G	2	12	14	0	7	21	0	0
7	52328569	.	C	T	7	9	16	0	0	16	0	0
7	52432249	.	G	A	1	3	4	0	0	4	0	0
7	52460969	.	G	A	2	3	5	0	1	6	0	0
7	52517759	.	G	A	9	4	13	0	1	14	0	0
7	52518529	.	T	G	8	6	14	0	1	15	0	0
7	52519015	.	T	C	6	13	19	0	1	20	0	0
7	52521352	.	G	A	10	7	17	0	1	18	0	0
7	52522182	.	T	C	17	11	28	0	2	30	0	0
7	52531152	.	C	T	3	7	10	0	5	15	0	0
7	52532811	.	G	A	2	9	11	0	1	12	0	0
7	52533621	.	C	T	8	3	11	0	0	11	0	0
7	52533649	.	C	T	6	2	8	0	2	10	0	0
7	52551518	.	G	A	11	6	17	0	1	18	0	0
7	52716777	.	T	A	7	5	12	0	0	12	0	0
7	52716875	.	C	A	16	6	22	0	0	22	0	0
7	52717095	.	T	C	6	14	20	0	0	20	0	0
7	52750565	.	C	T	19	9	28	0	2	30	0	0
7	52750656	.	G	A	5	8	13	0	1	14	0	0
7	52750776	.	G	T	14	9	23	0	0	23	0	0
7	52750847	.	C	T	10	9	19	0	0	19	0	0
7	52751016	.	C	T	7	9	16	0	0	16	0	0
7	52753582	.	C	T	3	4	7	0	0	7	0	0
7	52753772	.	C	T	3	2	5	0	1	6	0	0
7	52761325	.	A	G	5	2	7	0	1	8	0	0
7	52765884	.	C	A	15	4	19	0	3	22	0	0
7	52765985	.	G	T	0	4	4	0	5	9	0	0
7	52765999	.	T	A	4	2	6	0	1	7	0	0
7	52766191	.	C	T	5	7	12	0	0	12	0	0
7	52778290	.	C	T	4	3	7	0	1	8	0	0
7	52780616	.	C	T	2	2	4	0	1	5	0	0
7	52780861	.	A	T	5	3	8	0	0	8	0	0
7	52785384	.	A	G	9	3	12	0	1	13	0	0
7	52788912	.	T	G	6	1	7	0	6	13	0	0
7	52793313	.	C	T	9	8	17	0	0	17	0	0
7	52820092	.	G	C	10	9	19	0	1	20	0	0
7	52820221	.	G	A	1	5	6	0	17	23	0	0
7	52820320	.	C	T	11	9	20	0	1	21	0	0
7	52820588	.	A	C	5	4	9	0	0	9	0	0
7	52821216	.	T	C	2	2	4	1	0	5	0	0
7	52821270	.	T	A	0	3	3	1	1	5	0	0
7	52821272	.	A	C	4	2	6	1	0	7	0	0
7	52821451	.	A	G	1	4	5	0	1	14	8	0
7	52821561	.	T	A	7	2	9	0	1	10	0	0
7	52821658	.	C	A	5	2	7	0	1	9	1	0
7	52821691	.	A	C	7	4	11	0	1	12	0	0
7	52821904	.	G	A	7	7	14	0	2	16	0	0
7	52822136	.	G	A	15	9	24	0	0	24	0	0
7	52822217	.	T	A	14	7	21	0	1	22	0	0
7	52822351	.	A	T	15	6	21	0	0	21	0	0
7	52822493	.	A	C	9	8	17	1	1	19	0	0
7	52822773	.	C	T	8	5	13	0	0	13	0	0
7	52822791	.	T	G	8	0	8	0	8	16	0	0
7	52822860	.	A	G	3	4	7	0	0	7	0	0
7	52823161	.	G	A	9	9	18	0	1	19	0	0
7	52823210	.	C	G	4	10	14	0	1	15	0	0
7	52823377	.	T	A	2	4	6	0	0	6	0	0
7	52823388	.	C	T	2	4	6	0	0	6	0	0
7	52823429	.	A	T	9	6	15	0	0	15	0	0
7	52830447	.	G	T	4	4	8	0	1	9	0	0
7	52830591	.	A	T	9	23	32	0	1	33	0	0
7	52830601	.	T	G	19	13	32	0	2	34	0	0
7	52830639	.	C	T	25	17	42	0	1	43	0	0
7	52831053	.	G	T	22	26	48	0	4	52	0	0
7	52831198	.	T	A	8	15	23	0	3	26	0	0
7	52831236	.	A	G	14	11	25	0	5	30	0	0
7	52831430	.	C	T	10	15	25	0	1	26	0	0
7	52833126	.	C	G	12	14	26	0	1	27	0	0
7	52833248	.	A	T	17	13	30	0	2	32	0	0
7	52833329	.	G	T	19	16	35	0	2	37	0	0
7	52833682	.	T	A	17	14	31	5	0	36	0	0
7	52833792	.	G	A	22	18	40	0	2	42	0	0
7	52834334	.	T	G	13	7	20	0	2	22	0	0
7	52836325	.	C	T	26	30	56	0	2	58	0	0
7	52836403	.	A	G	29	28	57	0	2	59	0	0
7	52836451	.	C	T	25	20	45	0	0	45	0	0
7	52837644	.	G	A	27	18	45	0	0	45	0	0
7	52837686	.	C	A	27	19	46	0	1	47	0	0
7	52837687	.	T	A	27	19	46	0	1	47	0	0
7	52839062	.	C	T	16	11	27	0	0	27	0	0
7	52840871	.	T	A	22	14	36	0	3	39	0	0
7	52841033	.	T	C	12	0	12	0	15	27	0	0
7	52841276	.	A	G	17	20	37	0	1	38	0	0
7	52842329	.	C	T	7	14	21	0	0	21	0	0
7	52900987	.	C	T	8	18	26	0	0	26	0	0
7	52921521	.	C	A	18	11	29	0	0	29	0	0
7	52924873	.	T	A	13	15	28	0	1	29	0	0
7	52929182	.	G	A	19	23	42	0	1	43	0	0
7	52933088	.	C	A	19	12	31	0	1	32	0	0
7	52933191	.	C	T	2	6	8	0	0	8	0	0
7	52937334	.	G	A	7	13	20	0	2	22	0	0
7	52942312	.	G	T	10	8	18	0	0	18	0	0
7	52942472	.	C	T	8	4	12	0	1	13	0	0
7	52944199	.	G	A	10	4	14	0	0	14	0	0
7	52957486	.	C	A	7	3	10	0	1	11	0	0
7	52959270	.	G	T	1	2	3	0	0	3	0	0
7	53162425	.	T	C	1	2	3	1	1	5	0	0
7	54274047	.	C	T	1	2	3	0	0	3	0	0
7	54307309	.	T	A	2	2	4	0	0	4	0	0
7	54307898	.	T	C	1	2	3	0	1	4	0	0
7	54307917	.	G	A	0	1	1	0	2	3	0	0
7	54323986	.	T	C	15	0	15	0	14	29	0	0
7	54331379	.	G	C	9	6	15	0	0	15	0	0
7	54356092	.	A	T	8	5	13	0	1	14	0	0
7	54407619	.	C	T	10	11	21	0	0	21	0	0
7	54430450	.	T	C	5	8	13	0	1	14	0	0
7	54655025	.	A	T	6	5	11	0	0	11	0	0
7	55261074	.	C	T	9	5	14	0	1	15	0	0
7	55530884	.	G	C	6	2	8	0	0	9	1	0
7	55532316	.	A	G	3	4	7	0	0	7	0	0
7	55532524	.	A	G	1	7	8	0	0	8	0	0
7	55536487	.	G	A	2	3	5	0	0	5	0	0
7	55593170	.	T	C	1	0	1	0	2	3	0	0
7	55616188	.	T	G	1	2	3	0	0	3	0	0
7	55629611	.	A	G	1	3	4	0	0	4	0	0
7	55635202	.	T	C	13	11	24	0	1	25	0	0
7	55635355	.	G	A	0	7	7	0	6	13	0	0
7	55635521	.	T	G	1	2	3	0	0	3	0	0
7	55637122	.	C	A	7	3	10	0	0	10	0	0
7	55660269	.	G	A	11	20	31	0	1	32	0	0
7	55669479	.	G	A	11	10	21	0	1	22	0	0
7	55671547	.	T	C	13	8	21	0	0	21	0	0
7	55675544	.	T	C	11	0	11	0	24	35	0	0
7	55675577	.	G	A	17	12	29	0	1	30	0	0
7	55952866	.	T	C	3	3	6	0	0	6	0	0
7	55952877	.	C	T	3	3	6	0	0	6	0	0
7	55952904	.	A	G	1	3	4	0	0	4	0	0
7	55953452	.	C	T	1	2	3	0	0	3	0	0
7	56037600	.	T	C	2	2	4	0	0	4	0	0
7	56037601	.	G	A	2	2	4	0	0	4	0	0
7	56152686	.	G	C	12	7	19	0	0	19	0	0
7	56158111	.	G	A	18	16	34	0	0	34	0	0
7	56158197	.	G	A	8	11	19	0	3	22	0	0
7	56158823	.	A	G	15	4	19	0	1	20	0	0
7	56158874	.	C	T	12	5	17	0	0	17	0	0
7	56172458	.	T	C	6	7	13	0	0	13	0	0
7	56174222	.	T	C	8	9	17	0	2	19	0	0
7	56177177	.	C	T	1	11	12	0	8	20	0	0
7	56177188	.	T	G	8	12	20	0	0	20	0	0
7	56180258	.	C	T	13	4	17	0	1	18	0	0
7	56180482	.	G	A	3	3	6	0	0	6	0	0
7	56180555	.	G	A	3	3	6	0	2	8	0	0
7	56180589	.	C	A	0	5	5	0	10	15	0	0
7	56253928	.	T	A	5	5	10	0	0	10	0	0
7	56395283	.	A	G	6	4	10	0	1	11	0	0
7	56397859	.	G	A	17	9	26	0	0	26	0	0
7	56398522	.	A	T	9	7	16	0	2	18	0	0
7	56398651	.	C	T	9	4	13	0	0	13	0	0
7	56405508	.	T	C	8	7	15	0	0	15	0	0
7	56484426	.	G	A	16	9	25	0	4	29	0	0
7	56523233	.	A	G	3	6	9	0	0	9	0	0
7	56528494	.	C	T	2	4	6	0	0	6	0	0
7	56528922	.	G	A	4	7	11	0	0	11	0	0
7	56737268	.	C	G	6	0	6	0	4	10	0	0
7	56743837	.	G	C	3	3	6	0	0	6	0	0
7	56743879	.	A	G	6	4	10	0	0	10	0	0
7	56746311	.	C	T	9	6	15	0	0	15	0	0
7	56751971	.	A	G	19	6	25	0	0	25	0	0
7	56752243	.	G	A	14	12	26	0	0	26	0	0
7	56761453	.	A	T	11	8	19	0	0	19	0	0
7	56766115	.	C	T	2	4	6	0	10	16	0	0
7	56766282	.	A	C	6	0	6	0	9	15	0	0
7	56766455	.	A	T	3	4	7	0	0	7	0	0
7	56766754	.	A	T	5	5	10	0	1	11	0	0
7	56766828	.	C	G	6	3	9	0	0	9	0	0
7	56766845	.	T	C	4	5	9	0	0	9	0	0
7	56777813	.	T	C	9	0	9	0	8	17	0	0
7	56778235	.	T	A	23	18	41	0	0	41	0	0
7	56778251	.	T	C	20	18	38	0	1	39	0	0
7	56778282	.	C	T	0	16	16	0	16	32	0	0
7	56778305	.	G	A	14	14	28	0	1	29	0	0
7	56778672	.	G	T	20	14	34	0	1	35	0	0
7	56778721	.	G	T	21	16	37	0	1	39	1	0
7	56778822	.	A	T	8	9	17	0	0	17	0	0
7	56778895	.	A	G	9	8	17	0	1	18	0	0
7	56784070	.	A	T	14	11	25	0	1	26	0	0
7	56785006	.	T	C	16	14	30	0	0	30	0	0
7	56785308	.	C	T	22	18	40	0	0	40	0	0
7	56785315	.	G	A	20	17	37	0	2	39	0	0
7	56787414	.	A	T	20	18	38	0	0	38	0	0
7	56787483	.	T	A	19	15	34	0	0	34	0	0
7	56787527	.	C	T	10	15	25	0	0	25	0	0
7	56793362	.	G	A	9	7	16	0	0	16	0	0
7	56830948	.	C	T	4	2	6	0	0	6	0	0
7	56835254	.	T	C	2	2	4	0	0	4	0	0
7	56890326	.	G	A	0	6	6	0	2	8	0	0
7	56890418	.	G	A	2	3	5	0	0	5	0	0
7	56981010	.	T	C	3	2	5	0	1	6	0	0
7	56981950	.	C	T	2	3	5	0	0	5	0	0
7	56998877	.	C	T	2	3	5	0	0	5	0	0
7	57017140	.	C	T	3	4	7	0	1	8	0	0
7	57047942	.	G	A	3	4	7	0	0	7	0	0
7	57047947	.	G	A	1	4	5	0	3	8	0	0
7	57048022	.	C	T	7	0	7	0	0	7	0	0
7	57048677	.	T	C	2	2	4	0	0	4	0	0
7	57048682	.	C	A	2	3	5	0	0	5	0	0
7	57048885	.	T	A	1	3	4	0	0	4	0	0
7	57048945	.	A	T	5	4	9	0	0	9	0	0
7	57049308	.	T	C	5	6	11	0	0	11	0	0
7	57049578	.	C	T	6	9	15	0	0	15	0	0
7	57049638	.	A	G	3	4	7	0	1	8	0	0
7	57049911	.	C	T	3	3	6	0	0	6	0	0
7	57071707	.	C	T	2	6	8	0	0	8	0	0
7	57081143	.	C	T	3	4	7	0	0	7	0	0
7	57083043	.	C	T	2	6	8	0	0	8	0	0
7	57083088	.	G	A	3	6	9	0	0	9	0	0
7	57083094	.	A	G	3	0	3	0	6	9	0	0
7	57086153	.	C	T	5	4	9	0	0	9	0	0
7	57086216	.	G	A	1	4	5	0	8	13	0	0
7	57086277	.	G	A	0	9	9	0	7	16	0	0
7	57086383	.	C	A	7	6	13	0	2	15	0	0
7	57123513	.	T	G	2	0	2	0	5	7	0	0
7	57129474	.	A	G	4	3	7	0	0	7	0	0
7	57129518	.	C	T	3	4	7	0	1	8	0	0
7	57129520	.	A	T	4	4	8	0	0	8	0	0
7	57129553	.	C	A	4	4	8	0	0	8	0	0
7	57129729	.	G	T	1	2	3	0	0	3	0	0
7	57485710	.	T	C	4	8	12	0	0	12	0	0
7	57485736	.	A	G	4	7	11	0	0	11	0	0
7	57485766	.	A	G	1	6	7	0	0	7	0	0
7	57485847	.	G	A	8	6	14	0	0	14	0	0
7	57497353	.	T	C	9	9	18	0	0	18	0	0
7	57497455	.	C	G	6	5	11	0	1	12	0	0
7	57504905	.	C	G	12	8	20	0	2	23	1	0
7	57546767	.	C	T	2	2	4	0	0	4	0	0
7	57800754	.	C	T	7	12	19	0	0	19	0	0
7	57839716	.	A	C	12	18	30	0	1	31	0	0
7	57862456	.	C	T	13	12	25	0	0	25	0	0
7	57874026	.	G	A	10	13	23	0	0	23	0	0
7	57874038	.	A	C	11	12	23	0	1	24	0	0
7	57874083	.	G	A	2	8	10	0	12	22	0	0
7	57876512	.	T	C	10	7	17	0	1	18	0	0
7	57878712	.	T	C	8	10	18	0	1	19	0	0
7	57878726	.	A	T	6	9	15	0	0	15	0	0
7	57878788	.	A	C	3	5	8	0	1	9	0	0
7	57878885	.	C	T	7	8	15	0	0	15	0	0
7	57878973	.	A	T	6	9	15	0	0	15	0	0
7	57878974	.	C	T	6	9	15	0	0	15	0	0
7	57879076	.	A	G	8	1	9	0	4	13	0	0
7	57879205	.	C	T	8	6	14	0	0	14	0	0
7	57879245	.	C	T	6	5	11	0	0	11	0	0
7	57879396	.	T	A	15	14	29	0	1	30	0	0
7	57879431	.	G	T	2	19	21	0	11	32	0	0
7	57879436	.	C	A	11	19	30	0	1	31	0	0
7	57879576	.	C	A	17	20	37	0	1	38	0	0
7	57879601	.	T	C	19	14	33	0	0	33	0	0
7	57879959	.	C	A	2	11	13	0	1	14	0	0
7	57879992	.	G	A	5	11	16	0	1	17	0	0
7	57880073	.	G	C	2	6	8	0	2	10	0	0
7	57880099	.	T	C	2	4	6	0	0	6	0	0
7	57886347	.	C	A	16	20	36	0	1	37	0	0
7	57886392	.	T	A	29	14	43	0	0	43	0	0
7	57886964	.	T	G	21	28	49	0	4	53	0	0
7	57887480	.	C	T	35	26	61	0	4	66	1	0
7	57898605	.	G	A	24	27	51	0	4	55	0	0
7	57898623	.	C	T	28	30	58	0	3	61	0	0
7	57898650	.	T	C	29	27	56	0	3	59	0	0
7	57898658	.	C	G	29	30	59	0	2	61	0	0
7	57900948	.	T	A	1	4	5	0	0	5	0	0
7	57904582	.	G	A	1	2	3	0	0	3	0	0
7	57904595	.	G	A	1	2	3	0	0	3	0	0
7	57913558	.	C	A	25	29	54	0	2	56	0	0
7	57914155	.	T	G	26	28	54	0	0	54	0	0
7	57918590	.	A	G	16	17	33	0	0	33	0	0
7	57918799	.	G	A	29	31	60	0	1	61	0	0
7	57919087	.	T	G	31	19	50	0	3	53	0	0
7	57919241	.	G	A	34	18	52	0	1	53	0	0
7	57919249	.	T	C	31	1	32	0	18	50	0	0
7	57919567	.	T	C	22	23	45	0	0	45	0	0
7	57920608	.	A	T	13	17	30	0	3	33	0	0
7	57920908	.	A	G	25	20	45	0	1	46	0	0
7	57921094	.	A	G	24	23	47	0	4	51	0	0
7	57921335	.	A	G	19	14	33	0	1	34	0	0
7	57921914	.	G	A	20	19	39	0	0	39	0	0
7	57922018	.	T	G	9	11	20	0	3	24	1	0
7	57922480	.	G	A	21	18	39	0	0	39	0	0
7	57922555	.	G	T	16	15	31	0	3	35	1	0
7	57922793	.	G	T	23	8	31	0	0	31	0	0
7	57922827	.	C	T	8	17	25	0	0	25	0	0
7	57922828	.	A	G	8	17	25	0	0	25	0	0
7	57928407	.	A	T	14	15	29	0	1	30	0	0
7	57934036	.	A	T	18	15	33	0	1	34	0	0
7	57934051	.	T	C	16	13	29	0	1	30	0	0
7	57936171	.	G	A	16	15	31	0	0	32	1	0
7	57952714	.	T	C	21	14	35	0	1	36	0	0
7	57954099	.	G	A	19	14	33	1	2	36	0	0
7	57954123	.	A	C	15	15	30	1	2	33	0	0
7	57956503	.	C	T	15	12	27	0	1	28	0	0
7	57959962	.	G	A	31	15	46	0	0	46	0	0
7	57961917	.	C	A	18	13	31	0	2	33	0	0
7	57967373	.	A	G	15	16	31	0	1	32	0	0
7	57972616	.	T	C	12	7	19	0	0	19	0	0
7	57994952	.	T	A	7	12	19	0	0	19	0	0
7	58007916	.	G	T	15	13	28	0	2	30	0	0
7	58130494	.	C	T	0	4	4	0	3	7	0	0
7	58130658	.	A	G	4	4	8	0	1	9	0	0
7	58143104	.	A	G	4	6	10	0	0	10	0	0
7	58143123	.	G	C	6	6	12	0	0	12	0	0
7	58143877	.	G	A	6	2	8	0	0	8	0	0
7	58150120	.	A	T	8	6	14	0	0	14	0	0
7	58153549	.	A	G	6	7	13	0	0	13	0	0
7	58158456	.	C	T	1	11	12	0	3	15	0	0
7	58158484	.	T	C	4	6	10	0	1	11	0	0
7	58158847	.	T	C	6	4	10	0	1	11	0	0
7	58166226	.	G	C	3	2	5	0	0	5	0	0
7	58170243	.	C	T	0	5	5	0	3	8	0	0
7	58188252	.	A	G	7	4	11	0	0	11	0	0
7	58188253	.	A	C	7	4	11	0	0	11	0	0
7	58193141	.	T	C	2	3	5	0	1	6	0	0
7	58193195	.	A	G	3	4	7	0	0	7	0	0
7	58199935	.	A	G	5	4	9	0	0	9	0	0
7	58200145	.	G	A	4	7	11	0	0	11	0	0
7	58205460	.	A	T	8	7	15	0	1	16	0	0
7	58205622	.	T	C	4	4	8	0	0	8	0	0
7	58207453	.	A	G	4	3	7	0	0	7	0	0
7	58259472	.	C	T	8	13	21	0	1	22	0	0
7	58259494	.	T	A	10	13	23	0	1	24	0	0
7	58259808	.	C	T	0	9	9	0	10	19	0	0
7	58262100	.	G	A	10	20	30	0	0	30	0	0
7	58264129	.	T	C	15	7	22	0	1	23	0	0
7	58265533	.	G	A	10	14	24	0	1	25	0	0
7	58687138	.	G	A	11	17	28	0	1	29	0	0
7	58695379	.	A	C	7	8	15	0	0	15	0	0
7	58695441	.	C	A	18	14	32	0	1	33	0	0
7	58695599	.	G	T	11	10	21	0	0	21	0	0
7	58720718	.	T	C	2	2	4	0	0	4	0	0
7	58748871	.	A	C	30	28	58	0	1	59	0	0
7	58748891	.	T	C	27	26	53	0	2	56	1	0
7	58750327	.	A	C	21	22	43	0	0	43	0	0
7	58841391	.	T	C	7	0	7	0	9	16	0	0
7	58841552	.	T	G	12	5	17	0	1	18	0	0
7	58843134	.	T	C	8	10	18	0	0	18	0	0
7	59037573	.	A	C	3	4	7	0	1	8	0	0
7	59037972	.	C	T	6	4	10	0	0	10	0	0
7	59041471	.	A	G	5	2	7	0	0	7	0	0
7	59041504	.	A	G	4	2	6	0	0	6	0	0
7	59041531	.	A	G	6	0	6	0	3	9	0	0
7	59043246	.	C	A	2	6	8	0	0	8	0	0
7	59043421	.	T	C	4	7	11	0	2	13	0	0
7	59046711	.	T	A	4	4	8	0	0	8	0	0
7	59046966	.	T	A	12	18	30	0	1	31	0	0
7	59048307	.	C	T	4	16	20	0	15	35	0	0
7	59048907	.	G	A	12	10	22	0	0	22	0	0
7	59202852	.	T	G	1	3	4	0	0	4	0	0
7	59203097	.	A	G	5	3	8	0	0	8	0	0
7	59203289	.	G	A	6	7	13	0	0	13	0	0
7	59210423	.	T	A	6	5	11	0	0	11	0	0
7	59210625	.	C	T	4	3	7	0	0	7	0	0
7	59240761	.	G	A	4	3	7	0	0	7	0	0
7	59456904	.	A	C	4	2	6	0	0	6	0	0
7	59469015	.	G	A	9	4	13	0	0	13	0	0
7	59589259	.	A	G	13	10	23	0	0	23	0	0
7	59677296	.	C	A	3	2	5	0	0	5	0	0
7	59677543	.	C	T	2	2	4	0	0	4	0	0
7	60149599	.	C	T	18	24	42	0	1	43	0	0
7	60240748	.	T	C	2	4	6	0	1	7	0	0
7	60240881	.	C	T	3	2	5	0	0	5	0	0
7	60240944	.	C	T	2	2	4	0	0	4	0	0
7	60240946	.	C	A	2	2	4	0	0	4	0	0
7	60244637	.	A	G	5	6	11	0	0	11	0	0
7	60244868	.	C	T	3	2	5	0	0	5	0	0
7	60258938	.	C	A	2	3	5	0	0	5	0	0
7	60258947	.	A	G	2	3	5	0	0	5	0	0
7	60359455	.	A	G	3	0	3	0	5	8	0	0
7	60359512	.	G	A	3	4	7	0	0	7	0	0
7	60359516	.	A	C	3	4	7	0	0	7	0	0
7	60359574	.	G	A	1	4	5	0	5	10	0	0
7	60359584	.	C	T	4	3	7	0	0	7	0	0
7	60359719	.	A	T	4	3	7	0	0	7	0	0
7	60409230	.	T	C	11	10	21	0	1	22	0	0
7	60415571	.	G	T	3	7	10	0	1	11	0	0
7	60416010	.	T	C	10	4	14	0	1	15	0	0
7	60416016	.	A	G	9	6	15	0	0	15	0	0
7	60416175	.	C	T	3	7	10	0	1	11	0	0
7	60416317	.	A	G	4	0	4	0	8	12	0	0
7	60416327	.	C	T	4	8	12	0	1	13	0	0
7	60416379	.	G	A	4	5	9	0	0	9	0	0
7	60416383	.	C	T	4	7	11	0	0	11	0	0
7	60416439	.	A	G	2	11	13	0	3	16	0	0
7	60416724	.	A	G	3	3	6	0	0	6	0	0
7	60416764	.	T	G	4	5	9	0	0	9	0	0
7	60417176	.	T	A	3	4	7	0	1	8	0	0
7	60551171	.	A	C	26	14	40	0	0	41	1	0
7	60551471	.	A	G	13	11	24	0	4	28	0	0
7	60585523	.	A	G	20	1	21	0	23	44	0	0
7	60585599	.	G	A	27	12	39	0	0	39	0	0
7	60585702	.	G	A	13	12	25	0	3	28	0	0
7	60585748	.	G	T	14	10	24	0	0	24	0	0
7	60585818	.	G	C	19	15	34	0	0	34	0	0
7	60586187	.	T	C	17	21	38	0	3	41	0	0
7	60586364	.	A	C	13	16	29	0	2	31	0	0
7	60586771	.	C	T	11	11	22	0	0	22	0	0
7	60586784	.	A	T	13	10	23	0	0	24	1	0
7	60586835	.	C	T	12	13	25	0	0	25	0	0
7	60586874	.	G	A	1	13	14	0	13	27	0	0
7	60586976	.	C	T	19	16	35	0	1	36	0	0
7	60597482	.	G	A	13	15	28	0	0	28	0	0
7	60597500	.	T	G	18	13	31	0	1	32	0	0
7	60597863	.	C	T	22	17	39	0	0	39	0	0
7	60598265	.	T	A	23	19	42	0	0	42	0	0
7	61083293	.	C	A	6	6	12	0	0	12	0	0
7	61522597	.	A	C	2	0	2	0	10	12	0	0
7	61522607	.	A	C	3	2	5	0	9	14	0	0
7	61586719	.	C	T	0	5	5	0	6	11	0	0
7	61586910	.	C	T	1	5	6	0	0	6	0	0
7	61588778	.	A	G	2	5	7	0	0	7	0	0
7	61764102	.	G	A	3	2	5	0	1	6	0	0
7	61766585	.	T	C	6	2	8	0	0	8	0	0
7	61767441	.	A	C	4	2	6	0	0	6	0	0
7	61771497	.	C	T	2	4	6	0	1	7	0	0
7	61772930	.	G	T	3	3	6	0	0	6	0	0
7	61775744	.	G	A	3	3	6	0	0	6	0	0
7	61804557	.	A	T	1	6	7	0	0	7	0	0
7	61804880	.	A	T	5	5	10	0	0	10	0	0
7	61804909	.	C	A	2	2	4	0	0	4	0	0
7	61805102	.	G	A	6	3	9	0	1	10	0	0
7	61805104	.	T	A	7	3	10	0	1	11	0	0
7	61921320	.	G	A	7	8	15	0	0	15	0	0
7	61921463	.	C	T	5	6	11	0	1	12	0	0
7	61921465	.	T	A	5	5	10	0	2	12	0	0
7	61934189	.	T	A	9	9	18	0	1	19	0	0
7	61934278	.	C	T	4	7	11	0	3	14	0	0
7	61934306	.	A	G	8	0	8	0	6	14	0	0
7	61934330	.	A	G	7	0	7	0	5	12	0	0
7	61945030	.	A	G	2	3	5	0	0	5	0	0
7	61959031	.	G	A	6	8	14	0	1	15	0	0
7	61961063	.	G	A	9	6	15	0	2	17	0	0
7	61961229	.	T	C	4	4	8	0	0	8	0	0
7	61961581	.	A	G	1	3	4	0	0	4	0	0
7	61961743	.	A	G	2	2	4	0	1	5	0	0
7	61962002	.	A	G	2	3	5	0	1	6	0	0
7	61962040	.	T	C	2	3	5	0	0	5	0	0
7	61962292	.	G	T	3	5	8	0	0	8	0	0
7	61977170	.	G	C	9	4	13	0	0	13	0	0
7	61977499	.	T	C	11	7	18	0	0	18	0	0
7	61977514	.	G	A	11	13	24	0	0	24	0	0
7	61977769	.	G	A	7	12	19	0	0	19	0	0
7	61981518	.	A	G	9	6	15	0	0	15	0	0
7	61995758	.	A	T	2	7	9	0	0	9	0	0
7	62004146	.	C	T	15	12	27	0	3	30	0	0
7	62009630	.	T	A	8	5	13	0	1	14	0	0
7	62009677	.	G	A	1	12	13	0	7	20	0	0
7	62194008	.	G	A	5	2	7	0	0	7	0	0
7	62248670	.	T	A	7	8	15	0	1	16	0	0
7	62251340	.	T	C	4	2	6	0	0	6	0	0
7	62251342	.	G	A	4	2	6	0	0	6	0	0
7	62258058	.	A	T	8	3	11	0	1	12	0	0
7	62260866	.	C	T	4	5	9	0	0	9	0	0
7	62261533	.	A	T	5	7	12	0	0	12	0	0
7	62415412	.	T	C	1	1	2	0	0	2	0	0
7	62415418	.	C	T	1	2	3	0	0	3	0	0
7	64740893	.	T	C	5	1	6	1	6	13	0	0
7	64741726	.	G	C	1	0	1	0	2	3	0	0
7	64741855	.	T	C	2	3	5	0	0	5	0	0
7	64962956	.	G	A	1	2	3	0	0	3	0	0
7	64978891	.	A	C	20	6	26	0	1	27	0	0
7	64980793	.	A	G	13	8	21	0	0	21	0	0
7	64980820	.	A	G	15	11	26	0	1	27	0	0
7	64988061	.	A	G	14	18	32	0	0	32	0	0
7	64996666	.	A	G	17	9	26	0	0	26	0	0
7	65019731	.	T	C	6	8	14	0	1	15	0	0
7	65024082	.	C	T	1	12	13	0	15	28	0	0
7	65026828	.	C	T	1	7	8	0	6	14	0	0
7	65035275	.	A	G	14	9	23	0	0	23	0	0
7	65035416	.	G	T	13	10	23	0	0	23	0	0
7	65035437	.	C	T	10	15	25	0	0	25	0	0
7	65039374	.	T	A	11	11	22	0	1	23	0	0
7	65039436	.	A	C	15	0	15	0	15	30	0	0
7	65049706	.	C	T	2	6	8	0	11	19	0	0
7	65050312	.	A	T	8	11	19	0	1	20	0	0
7	65092935	.	G	A	2	8	10	0	0	10	0	0
7	65093097	.	G	A	15	13	28	0	1	29	0	0
7	65104080	.	A	G	1	3	4	0	0	4	0	0
7	65104219	.	T	C	1	3	4	0	0	4	0	0
7	65104308	.	T	G	2	2	4	0	0	4	0	0
7	65104792	.	C	T	3	2	5	0	0	5	0	0
7	65104840	.	C	A	4	3	7	0	0	8	1	0
7	65105011	.	G	C	3	6	9	0	0	9	0	0
7	65113970	.	C	A	7	6	13	0	0	13	0	0
7	65121982	.	C	T	13	13	26	0	0	26	0	0
7	65132884	.	C	T	16	12	28	0	1	29	0	0
7	65138868	.	A	G	12	15	27	0	1	28	0	0
7	65140532	.	C	A	12	7	19	0	3	22	0	0
7	65140738	.	T	A	10	10	20	0	1	21	0	0
7	65140786	.	G	A	10	7	17	0	1	18	0	0
7	65144861	.	G	T	1	13	14	0	11	25	0	0
7	65147905	.	G	A	6	8	14	0	1	15	0	0
7	65152024	.	T	C	7	7	14	0	1	15	0	0
7	65152036	.	C	A	7	10	17	0	0	17	0	0
7	65152075	.	A	G	10	11	21	0	1	22	0	0
7	65157397	.	A	C	15	14	29	0	2	31	0	0
7	65162339	.	G	A	1	15	16	0	16	32	0	0
7	65173289	.	A	T	10	17	27	0	1	28	0	0
7	65173534	.	C	T	10	9	19	0	0	19	0	0
7	65178135	.	C	T	2	4	6	0	2	8	0	0
7	65178270	.	C	T	5	2	7	0	0	7	0	0
7	65297041	.	A	T	3	9	12	0	0	12	0	0
7	65297313	.	G	T	3	4	7	0	0	7	0	0
7	65306229	.	G	A	4	5	9	0	0	9	0	0
7	65309852	.	T	C	4	2	6	0	0	6	0	0
7	65324213	.	G	A	9	6	15	0	0	15	0	0
7	65333843	.	T	C	4	8	12	0	0	12	0	0
7	65333874	.	C	T	5	8	13	0	0	13	0	0
7	65333930	.	T	A	5	10	15	0	0	15	0	0
7	65433092	.	T	C	8	10	18	0	1	19	0	0
7	65433343	.	G	T	6	7	13	0	1	14	0	0
7	65433352	.	C	A	8	6	14	0	1	15	0	0
7	65434589	.	C	T	9	6	15	0	0	15	0	0
7	65434610	.	C	T	8	9	17	0	0	17	0	0
7	65440232	.	T	A	11	5	16	0	0	16	0	0
7	65440308	.	T	A	6	11	17	0	0	17	0	0
7	65440361	.	G	A	1	5	6	0	13	19	0	0
7	65440493	.	C	T	6	12	18	0	1	19	0	0
7	65440505	.	G	A	12	8	20	0	0	20	0	0
7	65443348	.	T	C	9	7	16	0	1	17	0	0
7	65443396	.	G	A	6	9	15	0	0	15	0	0
7	65445483	.	G	A	7	7	14	0	1	15	0	0
7	65451324	.	T	A	12	10	22	0	1	23	0	0
7	65451369	.	C	T	10	7	17	0	0	17	0	0
7	65452005	.	G	A	0	9	9	0	16	25	0	0
7	65452017	.	G	A	14	9	23	0	1	24	0	0
7	65453057	.	G	A	2	11	13	0	6	19	0	0
7	65461040	.	G	A	3	7	10	0	11	21	0	0
7	65463165	.	C	A	10	9	19	0	0	19	0	0
7	65463297	.	G	T	1	12	13	0	14	27	0	0
7	65463511	.	G	A	3	13	16	0	25	41	0	0
7	65463586	.	C	T	6	8	14	0	0	14	0	0
7	65463906	.	T	C	7	5	12	0	1	13	0	0
7	65473137	.	G	T	18	9	27	0	0	27	0	0
7	65473421	.	G	C	21	21	42	0	2	44	0	0
7	65473775	.	G	T	14	30	44	0	0	44	0	0
7	65473972	.	T	C	21	15	36	0	2	38	0	0
7	65475422	.	T	G	21	23	44	0	3	47	0	0
7	65475708	.	T	G	23	8	31	0	0	31	0	0
7	65491835	.	G	A	33	30	63	0	3	66	0	0
7	65917322	.	G	A	0	3	3	0	3	6	0	0
7	65918176	.	A	T	3	3	6	0	0	6	0	0
7	65918445	.	A	G	2	3	5	0	1	6	0	0
7	65918473	.	G	T	3	2	5	0	0	5	0	0
7	65918566	.	A	G	2	5	7	0	1	8	0	0
7	65918569	.	T	C	2	5	7	0	1	8	0	0
7	65918793	.	T	G	5	4	9	0	0	9	0	0
7	65919136	.	C	A	2	2	4	0	0	4	0	0
7	65919167	.	A	G	3	3	6	0	0	6	0	0
7	65919326	.	C	A	4	6	10	0	0	11	1	0
7	65919360	.	C	G	4	3	7	0	0	7	0	0
7	65919940	.	T	G	6	0	6	0	4	10	0	0
7	65919942	.	T	A	7	4	11	0	0	11	0	0
7	65920194	.	C	T	3	3	6	0	0	6	0	0
7	65920214	.	A	G	4	0	4	0	3	7	0	0
7	65921037	.	G	A	0	4	4	0	3	7	0	0
7	65921467	.	G	C	7	4	11	0	1	12	0	0
7	65921645	.	T	A	3	4	7	0	0	7	0	0
7	65921695	.	A	G	4	5	9	0	0	9	0	0
7	65921726	.	G	T	0	5	5	0	3	8	0	0
7	65922336	.	A	G	5	3	8	0	0	8	0	0
7	65922732	.	G	C	1	5	6	0	1	7	0	0
7	65922868	.	T	C	1	5	6	0	1	7	0	0
7	65923179	.	C	T	2	5	7	0	0	7	0	0
7	65923238	.	C	T	1	2	3	0	0	3	0	0
7	65923921	.	T	C	5	6	11	0	0	11	0	0
7	65923944	.	T	G	3	4	7	0	0	7	0	0
7	65924277	.	T	C	4	4	8	0	0	8	0	0
7	65924621	.	T	C	1	4	5	0	0	5	0	0
7	65924634	.	A	G	2	4	6	0	0	6	0	0
7	65940058	.	C	A	2	4	6	0	0	6	0	0
7	65940063	.	G	A	2	4	6	0	0	6	0	0
7	66069906	.	A	G	6	5	11	0	0	11	0	0
7	66080231	.	G	A	6	3	9	1	0	10	0	0
7	66090927	.	C	T	8	4	12	0	0	12	0	0
7	66093051	.	T	A	5	9	14	0	0	14	0	0
7	66093216	.	C	T	4	5	9	0	0	9	0	0
7	66105498	.	C	T	12	4	16	0	1	17	0	0
7	66105663	.	A	G	11	1	12	0	3	15	0	0
7	66105752	.	C	T	10	7	17	0	0	17	0	0
7	66112702	.	T	C	13	7	20	0	1	21	0	0
7	66126466	.	T	C	7	9	16	0	0	16	0	0
7	66133626	.	A	T	7	6	13	0	0	13	0	0
7	66259325	.	C	T	1	3	4	0	0	4	0	0
7	66259574	.	A	T	2	5	7	0	0	7	0	0
7	66276243	.	G	A	9	9	18	0	1	19	0	0
7	66361984	.	A	G	8	6	14	0	0	14	0	0
7	66368605	.	G	C	7	0	7	0	3	10	0	0
7	66368653	.	T	C	7	0	7	0	7	14	0	0
7	67418988	.	C	T	2	2	4	0	0	4	0	0
7	67434693	.	A	C	17	17	34	0	1	35	0	0
7	67434807	.	T	C	16	11	27	0	1	28	0	0
7	67435587	.	T	C	15	11	26	0	2	28	0	0
7	67436273	.	C	T	15	15	30	0	0	30	0	0
7	67439428	.	A	C	15	13	28	0	0	28	0	0
7	67439496	.	T	A	13	16	29	0	1	30	0	0
7	67439520	.	T	A	14	14	28	0	0	28	0	0
7	67439742	.	T	C	15	16	31	0	0	31	0	0
7	67439743	.	C	T	13	16	29	0	1	30	0	0
7	67439781	.	T	C	15	12	27	0	1	28	0	0
7	67443766	.	T	C	22	10	32	0	0	32	0	0
7	67444837	.	G	A	25	14	39	0	1	40	0	0
7	67446295	.	C	T	21	22	43	0	1	44	0	0
7	67448338	.	T	C	20	15	35	0	1	36	0	0
7	67448363	.	A	T	17	14	31	0	0	31	0	0
7	67448373	.	T	A	16	13	29	0	0	29	0	0
7	67476376	.	T	C	30	31	61	0	2	63	0	0
7	67493909	.	C	T	11	5	16	0	0	16	0	0
7	67493955	.	C	T	1	5	6	0	0	6	0	0
7	67524394	.	G	A	10	4	14	0	0	14	0	0
7	67524520	.	C	A	9	5	14	0	0	14	0	0
7	68225837	.	T	G	3	0	3	1	1	5	0	0
7	68225858	.	G	A	0	2	2	1	2	5	0	0
7	69144274	.	T	C	7	3	10	0	0	10	0	0
7	69145516	.	T	C	11	4	15	0	0	15	0	0
7	69518021	.	T	A	14	15	29	0	1	30	0	0
7	69518077	.	T	A	9	17	26	0	3	30	1	0
7	69521129	.	A	T	17	8	25	0	1	26	0	0
7	69540248	.	G	A	6	11	17	0	0	17	0	0
7	69540312	.	T	C	17	7	24	0	0	24	0	0
7	69566848	.	G	A	9	12	21	0	0	21	0	0
7	69566908	.	G	A	0	9	9	0	19	28	0	0
7	69576019	.	C	A	11	15	26	0	2	28	0	0
7	69576031	.	G	A	17	13	30	0	2	32	0	0
7	69583133	.	A	T	9	11	20	0	0	20	0	0
7	69583139	.	C	T	8	10	18	0	0	18	0	0
7	69615015	.	G	A	16	16	32	0	0	32	0	0
7	69617937	.	C	A	9	10	19	0	0	19	0	0
7	69636439	.	G	A	3	11	14	0	1	15	0	0
7	69636454	.	T	C	2	5	7	0	1	8	0	0
7	69913830	.	C	T	4	4	8	0	0	8	0	0
7	69917639	.	C	A	4	3	7	0	0	7	0	0
7	69918165	.	A	T	5	2	7	0	0	7	0	0
7	69921912	.	C	A	4	2	6	0	0	6	0	0
7	69934781	.	A	C	1	4	5	0	0	5	0	0
7	69943002	.	C	T	5	7	12	0	0	12	0	0
7	69943491	.	A	G	2	3	5	0	0	5	0	0
7	69946805	.	C	T	1	3	4	0	0	4	0	0
7	69946917	.	G	A	1	2	3	0	1	4	0	0
7	69959980	.	G	A	8	8	16	0	1	17	0	0
7	71977178	.	G	A	2	1	3	0	1	4	0	0
7	72018290	.	G	T	1	17	18	0	17	36	1	0
7	72024034	.	T	G	14	19	33	0	1	34	0	0
7	72024081	.	G	T	12	21	33	0	0	33	0	0
7	72024117	.	C	G	14	19	33	0	2	35	0	0
7	72024239	.	T	A	11	17	28	0	0	28	0	0
7	72024350	.	T	C	10	16	26	0	0	26	0	0
7	72024446	.	C	G	10	19	29	0	1	30	0	0
7	72024467	.	G	A	11	18	29	0	0	29	0	0
7	72024491	.	A	T	10	12	22	0	2	24	0	0
7	72024733	.	A	G	9	13	22	0	0	22	0	0
7	72025428	.	T	A	11	14	25	0	2	27	0	0
7	72025430	.	G	A	3	14	17	0	12	29	0	0
7	72025548	.	A	T	14	19	33	0	0	33	0	0
7	72025688	.	A	G	17	2	19	0	17	36	0	0
7	72025689	.	C	G	17	18	35	0	0	35	0	0
7	72025748	.	G	A	13	14	27	0	1	28	0	0
7	72025774	.	T	C	11	10	21	0	2	23	0	0
7	72027982	.	C	T	24	22	46	0	2	48	0	0
7	72028015	.	C	T	25	23	48	0	1	49	0	0
7	72028326	.	A	G	37	10	47	0	1	48	0	0
7	72028386	.	T	A	27	18	45	0	2	47	0	0
7	72028442	.	G	T	29	17	46	2	1	49	0	0
7	72028458	.	T	C	30	11	41	2	2	45	0	0
7	72028746	.	A	G	19	1	20	0	8	28	0	0
7	72028841	.	A	G	16	20	36	0	1	37	0	0
7	72028893	.	G	T	0	6	6	0	14	20	0	0
7	72028976	.	A	T	23	13	36	0	2	38	0	0
7	72029011	.	C	T	11	25	36	0	2	38	0	0
7	72029083	.	T	C	19	19	38	0	2	40	0	0
7	72029127	.	G	T	25	23	48	0	2	50	0	0
7	72029383	.	G	C	18	19	37	0	2	39	0	0
7	72029424	.	G	A	17	26	43	0	2	45	0	0
7	72029429	.	T	G	12	1	13	0	29	42	0	0
7	72032982	.	A	T	20	10	30	0	1	31	0	0
7	72033024	.	G	C	18	14	32	0	2	34	0	0
7	72033053	.	A	C	10	18	28	0	2	30	0	0
7	72033186	.	A	C	14	26	40	0	2	42	0	0
7	72033264	.	G	A	12	15	27	0	1	28	0	0
7	72033286	.	C	T	12	16	28	0	3	31	0	0
7	72033312	.	G	A	12	15	27	0	1	28	0	0
7	72033370	.	A	C	12	16	28	0	2	30	0	0
7	72033384	.	A	C	14	18	32	0	2	34	0	0
7	72034012	.	T	C	14	10	24	0	0	24	0	0
7	72034024	.	C	T	12	6	18	0	1	19	0	0
7	72034151	.	T	C	13	10	23	0	3	26	0	0
7	72034271	.	A	C	3	0	3	0	12	15	0	0
7	72034304	.	G	A	16	8	24	0	1	25	0	0
7	72034339	.	C	A	20	12	32	0	2	34	0	0
7	72034805	.	T	C	2	0	2	0	5	7	0	0
7	72034856	.	A	G	3	7	10	1	2	13	0	0
7	72034874	.	T	C	4	9	13	3	0	16	0	0
7	72035075	.	G	A	10	15	25	0	0	25	0	0
7	72035258	.	G	T	5	5	10	0	0	10	0	0
7	72035321	.	A	T	11	11	22	0	2	24	0	0
7	72035339	.	T	G	14	13	27	0	0	27	0	0
7	72035422	.	C	A	12	3	15	0	0	15	0	0
7	72035475	.	C	T	0	10	10	0	10	20	0	0
7	72035526	.	C	T	8	5	13	0	0	13	0	0
7	72040996	.	G	C	10	6	16	0	1	17	0	0
7	72045451	.	A	C	12	0	12	0	5	17	0	0
7	72051864	.	C	T	6	6	12	0	1	13	0	0
7	72410082	.	A	G	11	14	25	0	0	25	0	0
7	72411694	.	A	T	13	12	25	0	1	26	0	0
7	72415298	.	A	T	7	13	20	0	2	22	0	0
7	72416996	.	T	G	11	10	21	0	2	23	0	0
7	72417089	.	G	A	12	15	27	0	1	28	0	0
7	72417095	.	C	T	1	11	12	0	16	28	0	0
7	72417322	.	G	A	6	11	17	0	0	17	0	0
7	72417355	.	T	A	8	14	22	0	3	25	0	0
7	72419933	.	G	A	8	15	23	0	2	25	0	0
7	72421715	.	T	C	7	8	15	0	1	16	0	0
7	72421754	.	T	A	5	16	21	0	0	21	0	0
7	72434978	.	A	T	3	9	12	0	1	13	0	0
7	72466025	.	T	C	1	3	4	0	0	4	0	0
7	72476087	.	C	G	2	3	5	0	0	5	0	0
7	72476129	.	C	T	1	2	3	0	0	3	0	0
7	72476237	.	A	G	1	2	3	0	0	3	0	0
7	72492354	.	A	C	1	4	5	0	0	5	0	0
7	72494180	.	C	T	1	2	3	0	0	3	0	0
7	72494183	.	A	G	1	0	1	0	2	3	0	0
7	72507236	.	C	A	3	3	6	0	1	7	0	0
7	72507239	.	A	T	3	4	7	0	0	7	0	0
7	72512494	.	T	C	2	2	4	0	0	4	0	0
7	72512557	.	C	T	1	2	3	0	0	3	0	0
7	72512572	.	A	G	1	3	4	0	0	4	0	0
7	72517237	.	A	G	0	2	2	0	2	4	0	0
7	72517243	.	C	T	1	3	4	0	0	4	0	0
7	72520253	.	T	C	2	2	4	0	0	4	0	0
7	72520370	.	A	G	1	0	1	0	2	3	0	0
7	72528428	.	T	C	4	3	7	0	0	7	0	0
7	72528459	.	C	T	5	2	7	0	0	7	0	0
7	72532261	.	T	C	3	4	7	0	0	7	0	0
7	72534477	.	G	A	4	3	7	0	0	7	0	0
7	72541307	.	T	C	5	4	9	0	0	9	0	0
7	72541310	.	G	A	5	2	7	0	2	9	0	0
7	72541394	.	G	C	0	5	5	0	3	8	0	0
7	72545962	.	C	T	4	7	11	0	0	11	0	0
7	72546664	.	T	A	7	2	9	0	0	9	0	0
7	72549193	.	A	G	4	11	15	0	0	15	0	0
7	72552129	.	A	G	8	6	14	0	0	14	0	0
7	72558361	.	T	C	3	2	5	0	0	5	0	0
7	72562004	.	T	G	4	5	9	0	0	9	0	0
7	72567016	.	G	A	5	5	10	0	0	10	0	0
7	72567240	.	A	G	7	7	14	0	0	14	0	0
7	72569230	.	C	G	4	0	4	0	10	14	0	0
7	72570359	.	A	G	10	15	25	0	0	25	0	0
7	72578005	.	C	G	9	12	21	0	0	21	0	0
7	73617792	.	A	G	5	10	15	0	0	15	0	0
7	73617817	.	A	G	15	9	24	0	0	24	0	0
7	73618288	.	A	G	1	4	5	0	1	6	0	0
7	73618303	.	A	G	6	2	8	0	0	8	0	0
7	73618617	.	A	G	11	7	18	0	2	20	0	0
7	73618739	.	A	G	9	4	13	0	0	13	0	0
7	73618841	.	A	G	3	7	10	0	1	11	0	0
7	73618842	.	A	G	7	4	11	0	0	11	0	0
7	73656361	.	G	A	2	5	7	0	4	11	0	0
7	74056606	.	G	T	12	18	30	0	2	32	0	0
7	74084768	.	G	A	3	3	6	0	0	6	0	0
7	74084783	.	T	A	3	3	6	0	0	6	0	0
7	74085487	.	C	T	0	4	4	0	3	7	0	0
7	74086382	.	T	C	1	0	1	0	4	5	0	0
7	74134988	.	T	C	22	17	39	0	0	39	0	0
7	74135136	.	G	A	4	23	27	0	26	53	0	0
7	74135375	.	C	T	18	18	36	0	5	41	0	0
7	74135462	.	A	G	16	17	33	0	1	34	0	0
7	74141299	.	T	C	4	4	8	0	0	8	0	0
7	74143628	.	C	T	6	3	9	0	0	9	0	0
7	74144167	.	A	G	12	0	12	0	7	19	0	0
7	74154066	.	C	T	20	31	51	0	2	53	0	0
8	5733	.	T	C	26	24	50	0	2	52	0	0
8	6265	.	C	T	37	25	62	0	2	64	0	0
8	6368	.	T	C	25	10	35	0	5	43	3	0
8	6440	.	A	T	20	9	29	0	2	31	0	0
8	7184	.	T	C	11	11	22	0	0	22	0	0
8	7276	.	G	A	11	11	22	0	1	23	0	0
8	7346	.	G	T	8	10	18	0	1	19	0	0
8	8584	.	T	A	1	2	3	0	0	3	0	0
8	41751	.	G	C	14	12	26	0	1	27	0	0
8	41754	.	C	T	14	12	26	0	2	28	0	0
8	43740	.	T	C	13	0	13	0	11	24	0	0
8	43800	.	A	G	8	21	29	0	2	31	0	0
8	44337	.	G	A	10	11	21	0	1	22	0	0
8	52280	.	C	T	8	13	21	0	0	21	0	0
8	56225	.	T	G	7	8	15	0	0	15	0	0
8	56285	.	A	G	7	6	13	0	0	13	0	0
8	56884	.	C	T	10	8	18	0	0	18	0	0
8	57732	.	C	T	2	8	10	0	11	21	0	0
8	58399	.	C	G	9	5	14	0	1	15	0	0
8	61833	.	G	A	5	8	13	0	0	13	0	0
8	75188	.	C	A	5	11	16	0	1	17	0	0
8	75446	.	G	T	1	3	4	0	4	8	0	0
8	75646	.	G	C	0	3	3	0	4	7	0	0
8	75669	.	C	G	1	5	6	0	1	7	0	0
8	81536	.	A	G	4	0	4	0	5	9	0	0
8	109321	.	G	A	1	11	12	0	5	17	0	0
8	109375	.	C	A	5	4	9	0	0	9	0	0
8	109378	.	T	C	4	3	7	0	2	9	0	0
8	109489	.	T	C	7	9	16	0	0	16	0	0
8	115080	.	T	C	5	5	10	0	1	11	0	0
8	118378	.	T	C	11	5	16	0	2	18	0	0
8	120282	.	G	A	3	10	13	0	2	15	0	0
8	120377	.	A	G	2	1	3	0	4	7	0	0
8	120839	.	G	A	1	8	9	0	8	17	0	0
8	120896	.	T	C	11	9	20	0	0	20	0	0
8	121145	.	A	C	6	7	13	0	0	13	0	0
8	121149	.	A	C	5	6	11	0	1	12	0	0
8	121205	.	A	G	7	5	12	0	0	12	0	0
8	158431	.	C	T	4	7	11	0	0	11	0	0
8	173841	.	A	G	13	13	26	0	1	27	0	0
8	174020	.	G	A	12	10	22	1	0	23	0	0
8	248757	.	C	T	4	8	12	0	0	12	0	0
8	252789	.	A	T	2	2	4	0	0	4	0	0
8	252833	.	T	C	6	2	8	0	0	8	0	0
8	261498	.	T	C	4	4	8	0	0	8	0	0
8	262012	.	C	T	4	6	10	0	1	11	0	0
8	262054	.	C	A	1	6	7	0	0	7	0	0
8	262858	.	G	T	1	6	7	0	7	14	0	0
8	268215	.	G	A	7	3	10	0	0	10	0	0
8	276277	.	C	T	5	8	13	0	0	13	0	0
8	276334	.	A	G	6	13	19	0	2	21	0	0
8	286192	.	A	G	12	12	24	0	2	26	0	0
8	286251	.	C	T	12	12	24	0	0	24	0	0
8	286302	.	G	A	9	10	19	0	1	20	0	0
8	387853	.	A	T	4	2	6	0	0	6	0	0
8	387915	.	A	G	4	2	6	0	0	6	0	0
8	387926	.	G	A	5	2	7	0	0	7	0	0
8	388885	.	C	T	21	13	34	0	0	34	0	0
8	391712	.	T	C	4	1	5	0	1	7	1	0
8	391715	.	T	C	6	2	8	0	0	8	0	0
8	392047	.	G	T	12	11	23	0	2	25	0	0
8	392160	.	C	A	5	6	11	0	0	11	0	0
8	395281	.	C	A	2	13	15	0	13	28	0	0
8	395287	.	C	T	13	14	27	0	1	28	0	0
8	395428	.	G	A	11	12	23	0	0	23	0	0
8	397338	.	T	C	11	9	20	0	1	21	0	0
8	397341	.	C	T	3	9	12	0	9	21	0	0
8	406330	.	T	G	6	10	16	0	0	16	0	0
8	406432	.	A	C	13	10	23	0	0	23	0	0
8	412296	.	T	C	18	0	18	0	7	25	0	0
8	412303	.	G	A	19	4	23	0	3	26	0	0
8	412355	.	A	G	15	6	21	0	0	21	0	0
8	412358	.	A	G	12	6	18	0	2	20	0	0
8	412504	.	T	C	20	0	20	0	11	31	0	0
8	413845	.	G	C	21	0	21	0	12	33	0	0
8	417849	.	A	G	9	9	18	0	3	21	0	0
8	418575	.	A	G	8	10	18	0	0	18	0	0
8	423723	.	C	T	9	8	17	0	1	18	0	0
8	423920	.	T	C	12	6	18	0	2	20	0	0
8	424969	.	G	A	15	8	23	0	0	23	0	0
8	428851	.	A	C	3	5	8	0	1	9	0	0
8	473773	.	G	A	2	7	9	0	0	9	0	0
8	473875	.	G	A	4	4	8	0	0	8	0	0
8	478707	.	C	T	4	6	10	0	0	10	0	0
8	478844	.	T	C	4	6	10	0	0	10	0	0
8	478889	.	G	T	1	4	5	0	0	5	0	0
8	482033	.	A	G	10	5	15	0	0	15	0	0
8	484740	.	A	G	5	0	5	0	2	7	0	0
8	484746	.	T	C	5	2	7	0	0	7	0	0
8	489120	.	C	T	1	4	5	0	0	5	0	0
8	489135	.	C	T	2	3	5	0	0	5	0	0
8	532998	.	T	A	10	2	12	0	0	12	0	0
8	533004	.	A	G	9	2	11	0	0	11	0	0
8	534387	.	G	C	2	9	11	0	0	11	0	0
8	539973	.	T	G	12	0	12	0	10	22	0	0
8	539979	.	C	G	11	9	20	0	0	20	0	0
8	541376	.	C	A	12	16	28	0	0	28	0	0
8	543963	.	T	G	2	2	4	0	0	4	0	0
8	600882	.	G	A	2	3	5	0	0	5	0	0
8	653919	.	A	G	4	0	4	0	5	9	0	0
8	705549	.	C	T	11	5	16	0	0	16	0	0
8	926772	.	G	A	2	3	5	0	0	5	0	0
8	926779	.	C	T	0	3	3	0	2	5	0	0
8	928341	.	G	A	6	10	16	0	1	17	0	0
8	941343	.	T	C	4	4	8	0	0	8	0	0
8	941369	.	T	C	7	3	10	0	0	10	0	0
8	941378	.	C	T	1	3	4	0	7	11	0	0
8	943953	.	G	C	8	3	11	0	1	12	0	0
8	1094388	.	G	A	11	12	23	0	3	26	0	0
8	1094542	.	T	C	14	20	34	0	0	34	0	0
8	1094566	.	C	T	17	10	27	0	1	28	0	0
8	1094590	.	G	A	2	9	11	0	10	21	0	0
8	1094910	.	T	A	15	14	29	0	0	29	0	0
8	1100463	.	C	T	22	9	31	0	0	31	0	0
8	1102404	.	T	C	12	25	37	0	1	38	0	0
8	1104980	.	A	G	22	0	22	0	11	33	0	0
8	1106149	.	C	T	14	16	30	0	3	33	0	0
8	1106494	.	C	A	11	13	24	0	0	24	0	0
8	1121315	.	C	G	5	4	9	0	0	9	0	0
8	1130331	.	C	T	7	4	11	0	0	11	0	0
8	1133689	.	A	G	7	4	11	0	0	11	0	0
8	1133743	.	A	G	3	0	3	0	4	7	0	0
8	1133753	.	C	G	3	2	5	0	0	5	0	0
8	1151416	.	T	C	14	13	27	0	3	30	0	0
8	1222356	.	A	T	3	4	7	0	0	7	0	0
8	1222357	.	G	A	3	4	7	0	0	7	0	0
8	1222417	.	T	C	7	0	7	0	15	22	0	0
8	1222504	.	T	C	12	0	12	0	23	35	0	0
8	1222558	.	A	G	11	17	28	0	3	31	0	0
8	1253651	.	G	A	25	12	37	1	1	39	0	0
8	1254337	.	C	T	23	9	32	0	2	34	0	0
8	1255292	.	C	G	1	14	15	0	21	36	0	0
8	1255304	.	G	A	25	9	34	0	3	37	0	0
8	1259023	.	G	A	27	14	41	0	2	43	0	0
8	1264645	.	A	G	23	10	33	0	2	35	0	0
8	1298792	.	C	T	2	6	8	0	0	8	0	0
8	1298813	.	C	T	2	9	11	0	0	11	0	0
8	1852056	.	A	G	2	6	8	0	1	9	0	0
8	1852067	.	A	G	6	3	9	0	0	9	0	0
8	1852196	.	A	G	2	5	7	0	1	8	0	0
8	1852948	.	A	G	10	4	14	0	0	14	0	0
8	1853004	.	A	G	7	3	10	0	0	10	0	0
8	1853366	.	A	G	2	2	4	0	0	4	0	0
8	1853400	.	A	G	2	7	9	0	1	10	0	0
8	1853406	.	A	G	7	3	10	0	0	10	0	0
8	1853474	.	A	G	6	5	11	0	0	11	0	0
8	1855233	.	A	G	11	3	14	0	1	15	0	0
8	1855312	.	A	G	13	5	18	0	1	19	0	0
8	1856254	.	A	G	7	9	16	0	2	18	0	0
8	1856265	.	A	G	8	12	20	0	0	20	0	0
8	2216013	.	A	G	4	2	6	0	0	6	0	0
8	2219604	.	G	A	4	5	9	0	1	10	0	0
8	2222522	.	T	C	3	3	6	0	0	6	0	0
8	2229821	.	G	A	5	4	9	0	1	10	0	0
8	2230055	.	A	G	5	5	10	0	0	10	0	0
8	2230070	.	C	T	3	5	8	0	0	8	0	0
8	2233401	.	G	A	2	2	4	0	0	4	0	0
8	2261052	.	T	C	6	3	9	0	0	9	0	0
8	2262694	.	G	C	3	3	6	0	0	6	0	0
8	2270172	.	G	C	1	0	1	0	3	4	0	0
8	2278859	.	C	T	0	2	2	0	2	4	0	0
8	2387885	.	T	C	1	2	3	0	0	3	0	0
8	2412800	.	C	T	36	7	43	1	0	44	0	0
8	2412911	.	G	A	32	28	60	0	0	60	0	0
8	2413133	.	T	G	28	40	68	0	4	72	0	0
8	2413160	.	G	C	29	1	30	0	39	69	0	0
8	2416886	.	G	A	27	23	50	0	3	53	0	0
8	2416931	.	C	T	4	26	30	0	24	54	0	0
8	2417891	.	T	C	22	27	49	0	1	50	0	0
8	2421318	.	T	C	27	21	48	0	2	50	0	0
8	2421342	.	C	A	30	18	48	0	0	48	0	0
8	2426500	.	A	G	26	24	50	1	1	52	0	0
8	2438671	.	T	C	3	3	6	0	0	6	0	0
8	2442765	.	C	T	4	7	11	0	2	13	0	0
8	2446957	.	C	T	3	2	5	0	0	5	0	0
8	2456933	.	C	T	3	8	11	0	0	11	0	0
8	2456953	.	C	G	3	10	13	0	0	13	0	0
8	2457571	.	T	C	4	5	9	0	1	10	0	0
8	2467230	.	A	G	11	0	11	0	4	15	0	0
8	2467233	.	A	G	10	3	13	0	3	16	0	0
8	2469292	.	G	A	8	11	19	0	0	19	0	0
8	2469377	.	G	C	4	3	7	0	0	7	0	0
8	2469401	.	C	T	4	2	6	0	1	7	0	0
8	2469559	.	C	T	5	2	7	0	0	7	0	0
8	2469660	.	T	C	4	2	6	0	0	6	0	0
8	2469693	.	C	T	0	2	2	0	0	2	0	0
8	2487329	.	T	C	29	23	52	0	4	56	0	0
8	2490968	.	C	T	30	21	51	0	3	55	1	0
8	2491338	.	G	A	9	9	18	0	1	19	0	0
8	2502037	.	G	A	42	32	74	0	1	75	0	0
8	2502067	.	C	T	46	30	76	0	3	79	0	0
8	2502088	.	A	G	42	33	75	0	3	78	0	0
8	2502112	.	A	G	43	33	76	0	1	77	0	0
8	2516019	.	C	T	0	5	5	0	7	12	0	0
8	2525435	.	A	G	1	6	7	0	1	8	0	0
8	2525450	.	T	C	3	5	8	0	0	8	0	0
8	2525492	.	A	T	8	5	13	0	0	13	0	0
8	2529817	.	T	A	7	5	12	0	0	12	0	0
8	2530118	.	G	A	4	14	18	0	1	19	0	0
8	2535588	.	T	A	18	9	27	0	1	28	0	0
8	2535642	.	T	C	9	5	14	0	0	14	0	0
8	2536560	.	A	G	2	2	4	0	0	4	0	0
8	2536673	.	A	G	3	2	5	0	0	5	0	0
8	2536761	.	G	C	5	2	7	0	0	7	0	0
8	2549002	.	A	G	1	5	6	0	0	6	0	0
8	2549011	.	G	A	1	6	7	0	0	7	0	0
8	2549579	.	T	C	7	7	14	0	0	14	0	0
8	2549582	.	A	G	8	8	16	0	0	16	0	0
8	2560680	.	T	G	9	0	9	0	7	16	0	0
8	2560848	.	A	G	10	13	23	0	1	24	0	0
8	2566882	.	G	T	8	2	10	0	0	10	0	0
8	2567788	.	T	C	1	8	9	0	0	9	0	0
8	2567818	.	C	T	4	10	14	0	0	14	0	0
8	2571478	.	T	C	9	2	11	0	1	12	0	0
8	2574336	.	A	T	3	5	8	0	0	8	0	0
8	2574463	.	A	G	3	0	3	0	4	7	0	0
8	2574470	.	T	G	3	5	8	0	0	8	0	0
8	2574514	.	A	C	4	9	13	0	0	13	0	0
8	2574524	.	A	C	4	9	13	0	0	13	0	0
8	2585329	.	G	C	5	9	14	0	0	14	0	0
8	2585681	.	C	A	23	10	33	0	0	33	0	0
8	2588348	.	A	G	29	25	54	0	5	59	0	0
8	2588354	.	C	A	3	29	32	0	32	64	0	0
8	2591624	.	A	C	9	0	9	0	16	25	0	0
8	2600595	.	T	C	1	0	1	0	3	4	0	0
8	2606435	.	A	T	2	2	4	0	1	5	0	0
8	2606519	.	T	A	1	3	4	0	0	4	0	0
8	2606668	.	T	C	2	2	4	0	0	4	0	0
8	2649827	.	A	G	2	5	7	0	1	8	0	0
8	2649832	.	G	A	2	6	8	0	0	8	0	0
8	2720286	.	G	C	3	2	5	0	0	5	0	0
8	2730530	.	A	G	1	2	3	0	0	3	0	0
8	2733900	.	G	A	0	4	4	0	1	5	0	0
8	2757867	.	A	T	2	5	7	0	0	7	0	0
8	2757956	.	C	T	5	10	15	0	0	15	0	0
8	2770202	.	A	G	8	4	12	0	0	12	0	0
8	2780722	.	A	G	5	6	11	0	0	11	0	0
8	2787035	.	C	T	2	15	17	0	1	18	0	0
8	2787141	.	T	C	2	10	12	0	0	12	0	0
8	2789535	.	T	C	6	10	16	1	0	17	0	0
8	2789536	.	C	A	5	10	15	1	0	16	0	0
8	2789592	.	T	C	8	11	19	0	0	19	0	0
8	2789655	.	C	A	3	7	10	0	0	10	0	0
8	2789697	.	G	A	5	8	13	0	0	13	0	0
8	2789748	.	T	A	6	8	14	0	1	15	0	0
8	2789757	.	G	T	9	9	18	0	0	18	0	0
8	2905956	.	A	T	2	2	4	0	0	4	0	0
8	3085393	.	G	A	2	4	6	0	1	7	0	0
8	3085423	.	T	C	4	5	9	0	0	9	0	0
8	3085466	.	C	A	2	5	7	0	2	9	0	0
8	3085565	.	A	G	5	9	14	0	0	14	0	0
8	3085841	.	T	A	5	4	9	0	1	10	0	0
8	3085863	.	A	G	5	3	8	0	2	10	0	0
8	3099585	.	G	A	1	16	17	0	7	24	0	0
8	3099946	.	A	C	2	2	4	0	0	4	0	0
8	3100184	.	G	C	3	6	9	0	0	9	0	0
8	3100800	.	C	T	4	2	6	0	0	6	0	0
8	3101081	.	T	A	5	3	8	0	0	8	0	0
8	3101086	.	C	A	5	3	8	0	0	8	0	0
8	3101241	.	G	T	7	7	14	0	1	15	0	0
8	3101277	.	T	C	5	10	15	0	0	15	0	0
8	3426825	.	T	C	3	3	6	0	0	6	0	0
8	3431825	.	C	T	5	4	9	0	1	10	0	0
8	3434203	.	G	A	1	4	5	0	0	5	0	0
8	3434302	.	T	C	4	2	6	0	1	7	0	0
8	3434449	.	C	T	2	3	5	0	0	5	0	0
8	3439283	.	G	C	7	4	11	0	0	11	0	0
8	3501875	.	A	T	2	3	5	0	0	5	0	0
8	3537152	.	G	A	0	4	4	0	4	8	0	0
8	3539482	.	C	T	4	7	11	0	0	11	0	0
8	3545108	.	G	A	2	8	10	0	0	10	0	0
8	3545121	.	C	T	3	7	10	0	1	11	0	0
8	3557831	.	T	C	4	4	8	0	2	10	0	0
8	3561501	.	T	C	3	5	8	0	0	8	0	0
8	3561515	.	G	A	3	6	9	0	0	9	0	0
8	3566172	.	A	T	6	2	8	0	0	8	0	0
8	3566190	.	C	T	4	3	7	0	0	7	0	0
8	3568004	.	C	T	6	8	14	0	0	14	0	0
8	3568037	.	C	T	8	5	13	0	1	14	0	0
8	3569907	.	C	T	13	12	25	0	0	25	0	0
8	3571727	.	T	A	9	3	12	0	0	12	0	0
8	3573804	.	A	G	2	3	5	0	0	5	0	0
8	3589375	.	T	G	8	4	12	0	0	12	0	0
8	3591154	.	T	C	6	8	14	0	1	15	0	0
8	3591211	.	C	A	5	13	18	0	1	19	0	0
8	3594308	.	A	G	3	0	3	0	8	11	0	0
8	3595161	.	G	A	2	7	9	0	9	18	0	0
8	3595359	.	C	T	11	11	22	0	0	22	0	0
8	3597233	.	T	C	7	12	19	0	0	19	0	0
8	3602715	.	T	A	6	9	15	0	0	15	0	0
8	3605050	.	A	G	4	0	4	0	5	9	0	0
8	3612263	.	T	A	12	5	17	0	0	18	1	0
8	3612308	.	A	T	12	11	23	0	2	25	0	0
8	3624208	.	G	C	16	13	29	0	0	29	0	0
8	3628747	.	C	A	9	10	19	0	2	21	0	0
8	3628758	.	T	A	9	10	19	0	1	20	0	0
8	3628782	.	G	A	2	14	16	0	10	26	0	0
8	3631371	.	T	C	10	11	21	0	1	22	0	0
8	3631932	.	C	T	12	21	33	0	0	33	0	0
8	3641218	.	G	C	15	21	36	0	1	37	0	0
8	3643299	.	T	C	21	16	37	0	2	39	0	0
8	3659979	.	T	C	8	13	21	0	0	21	0	0
8	3660034	.	C	T	8	8	16	0	0	16	0	0
8	3674701	.	T	C	9	1	10	0	0	10	0	0
8	3691097	.	C	T	3	3	6	0	0	6	0	0
8	3701238	.	T	C	1	1	2	0	1	3	0	0
8	3716675	.	C	T	0	3	3	0	4	7	0	0
8	3756287	.	C	A	2	4	6	0	2	8	0	0
8	3859383	.	T	A	16	14	30	0	1	32	1	0
8	3865233	.	T	C	18	16	34	0	1	35	0	0
8	3883831	.	C	G	15	16	31	0	0	31	0	0
8	3886220	.	T	C	14	19	33	0	1	34	0	0
8	3889662	.	G	A	5	14	19	0	13	32	0	0
8	3890837	.	T	C	15	11	26	0	1	27	0	0
8	3904963	.	C	T	17	20	37	0	1	38	0	0
8	3915909	.	G	A	12	17	29	0	0	29	0	0
8	3923371	.	C	T	15	11	26	0	2	28	0	0
8	3932889	.	A	T	8	5	13	0	0	13	0	0
8	3932974	.	A	G	11	5	16	1	1	18	0	0
8	3932990	.	A	G	13	7	20	1	0	21	0	0
8	3933498	.	T	A	10	13	23	0	0	23	0	0
8	3949558	.	G	T	4	6	10	0	2	12	0	0
8	3950039	.	C	G	8	10	18	0	0	18	0	0
8	3950317	.	G	A	6	8	14	0	0	14	0	0
8	3950341	.	A	G	9	3	12	0	0	12	0	0
8	3950529	.	C	T	5	3	8	0	0	8	0	0
8	3950554	.	C	T	3	3	6	0	0	6	0	0
8	3950655	.	C	T	4	2	6	0	1	7	0	0
8	3952495	.	G	T	5	7	12	0	2	14	0	0
8	3956898	.	G	A	5	3	8	0	3	11	0	0
8	3960992	.	G	A	8	7	15	0	0	15	0	0
8	4010894	.	G	A	4	2	6	0	0	6	0	0
8	4044846	.	G	A	9	7	16	0	0	16	0	0
8	4045163	.	G	A	3	4	7	0	0	7	0	0
8	4048565	.	G	A	4	2	6	0	0	6	0	0
8	4048709	.	A	T	4	2	6	0	0	6	0	0
8	4059000	.	G	A	1	1	2	0	1	3	0	0
8	4059039	.	C	T	2	3	5	0	1	6	0	0
8	4059886	.	G	A	1	4	5	0	0	5	0	0
8	4067291	.	G	A	7	2	9	0	0	9	0	0
8	4067419	.	T	A	1	2	3	0	1	4	0	0
8	4074424	.	G	A	2	2	4	0	1	5	0	0
8	4097856	.	A	T	2	2	4	0	0	4	0	0
8	4368586	.	T	G	4	3	7	2	2	11	0	0
8	4368847	.	T	A	4	2	6	0	1	7	0	0
8	4368848	.	C	G	4	2	6	0	1	7	0	0
8	4369021	.	A	C	12	6	18	0	1	19	0	0
8	4381510	.	A	G	11	0	11	0	7	18	0	0
8	4381624	.	G	A	10	7	17	0	0	17	0	0
8	4386198	.	A	G	8	5	13	0	0	13	0	0
8	4393910	.	C	G	8	8	16	0	0	16	0	0
8	4398425	.	A	T	5	9	14	0	1	15	0	0
8	4398531	.	T	C	5	8	13	0	2	15	0	0
8	4398737	.	C	T	8	16	24	0	1	25	0	0
8	4398762	.	A	G	13	14	27	0	0	27	0	0
8	4398981	.	G	A	1	12	13	0	8	21	0	0
8	4399268	.	G	A	10	2	12	1	0	13	0	0
8	4399288	.	C	T	9	2	11	2	1	15	1	0
8	4399334	.	T	C	9	3	12	3	0	15	0	0
8	4399366	.	G	A	1	7	8	0	5	13	0	0
8	4399394	.	C	G	11	5	16	0	0	16	0	0
8	4399754	.	T	A	2	5	7	0	1	8	0	0
8	4400242	.	A	G	2	3	5	1	0	6	0	0
8	4400253	.	T	C	2	3	5	0	0	5	0	0
8	4400525	.	C	T	2	2	4	0	0	4	0	0
8	4400699	.	C	A	6	7	13	0	0	13	0	0
8	4400861	.	T	C	9	6	15	0	0	15	0	0
8	4400872	.	G	A	1	3	4	0	10	14	0	0
8	4401053	.	T	G	3	7	10	0	1	11	0	0
8	4401068	.	C	T	6	7	13	0	1	14	0	0
8	4401374	.	G	A	2	10	12	0	4	16	0	0
8	4401514	.	A	T	6	10	16	0	0	16	0	0
8	4401687	.	G	A	15	18	33	0	1	34	0	0
8	4401708	.	C	T	16	17	33	0	2	35	0	0
8	4401813	.	G	T	15	21	36	0	0	36	0	0
8	4401913	.	T	G	8	9	17	0	0	17	0	0
8	4401931	.	T	C	5	7	12	0	0	12	0	0
8	4440705	.	A	C	2	2	4	0	0	4	0	0
8	4440720	.	T	C	3	2	5	0	0	5	0	0
8	4442655	.	G	A	0	4	4	0	3	7	0	0
8	4446247	.	A	C	6	1	7	0	4	11	0	0
8	4446266	.	C	T	0	5	5	0	5	10	0	0
8	4446303	.	T	C	1	5	6	0	0	6	0	0
8	4446407	.	T	C	1	0	1	0	5	6	0	0
8	4453655	.	G	T	1	2	3	0	0	3	0	0
8	4522035	.	T	A	2	3	5	0	0	5	0	0
8	4529598	.	A	G	2	3	5	0	0	5	0	0
8	4530635	.	C	A	1	3	4	0	0	4	0	0
8	4531840	.	A	G	1	2	3	0	0	3	0	0
8	4531903	.	C	A	1	1	2	0	1	3	0	0
8	4538760	.	A	T	4	2	6	0	0	6	0	0
8	4538766	.	C	T	4	2	6	0	0	6	0	0
8	4547444	.	A	G	1	2	3	0	0	3	0	0
8	4547446	.	C	A	1	2	3	0	0	3	0	0
8	4553698	.	A	T	1	5	6	1	0	7	0	0
8	4556863	.	A	T	4	3	7	0	1	8	0	0
8	4576991	.	T	C	2	1	3	0	0	3	0	0
8	4576998	.	A	T	3	1	4	0	1	5	0	0
8	4577051	.	T	C	2	0	2	0	2	4	0	0
8	4577054	.	A	G	2	1	3	0	0	3	0	0
8	4589148	.	A	G	20	26	46	0	1	47	0	0
8	4589169	.	T	G	23	22	45	0	3	48	0	0
8	4589216	.	A	T	27	17	44	0	1	45	0	0
8	4589402	.	C	T	38	17	55	0	1	56	0	0
8	4596649	.	T	A	25	27	52	0	2	54	0	0
8	4609822	.	T	C	22	0	22	0	26	48	0	0
8	4618536	.	G	A	28	14	42	0	1	43	0	0
8	4618562	.	C	T	1	10	11	0	16	27	0	0
8	4621454	.	A	G	3	4	7	0	0	7	0	0
8	4621544	.	G	A	4	3	7	0	0	7	0	0
8	4621817	.	G	T	3	6	9	0	0	9	0	0
8	4697808	.	A	C	2	5	7	0	0	7	0	0
8	4697849	.	G	C	2	3	5	0	1	6	0	0
8	4698161	.	G	A	4	4	8	0	1	9	0	0
8	4698518	.	G	A	2	8	10	0	6	16	0	0
8	4698940	.	A	C	1	4	5	0	0	5	0	0
8	4762881	.	G	A	3	7	10	0	15	25	0	0
8	4771987	.	C	T	14	15	29	0	0	29	0	0
8	4776243	.	A	T	10	13	23	0	0	23	0	0
8	4779959	.	A	G	2	3	5	0	0	5	0	0
8	4779962	.	G	T	2	3	5	0	0	5	0	0
8	4780110	.	A	C	3	4	7	0	0	7	0	0
8	4780127	.	A	T	2	3	5	0	0	5	0	0
8	4780262	.	T	A	8	6	14	0	1	15	0	0
8	4780269	.	G	C	6	0	6	0	7	13	0	0
8	4780368	.	T	A	4	2	6	0	0	6	0	0
8	4780552	.	C	T	1	9	10	0	8	18	0	0
8	4780586	.	G	A	6	13	19	0	0	19	0	0
8	4788763	.	A	G	11	8	19	0	2	21	0	0
8	4788942	.	T	C	14	0	14	0	15	29	0	0
8	4799126	.	T	A	4	3	7	0	0	7	0	0
8	4799921	.	C	T	3	2	5	12	0	17	0	0
8	4800683	.	G	A	1	2	3	0	5	8	0	0
8	4858530	.	C	T	1	2	3	0	0	3	0	0
8	4858566	.	C	T	0	3	3	0	2	5	0	0
8	4964521	.	G	A	14	13	27	0	0	27	0	0
8	4972812	.	C	T	13	4	17	0	1	18	0	0
8	5844982	.	T	C	3	6	9	0	2	11	0	0
8	5845014	.	C	G	3	5	8	0	0	8	0	0
8	5845042	.	C	T	3	4	7	0	1	8	0	0
8	5845060	.	T	G	5	5	10	0	0	10	0	0
8	5845210	.	T	A	10	8	18	0	0	18	0	0
8	5845222	.	C	T	9	6	15	0	0	15	0	0
8	5845807	.	A	G	5	5	10	0	0	10	0	0
8	5845891	.	T	C	5	9	14	0	1	15	0	0
8	5845957	.	T	C	3	4	7	0	0	7	0	0
8	6415248	.	G	A	0	3	3	0	3	6	0	0
8	6415959	.	T	C	4	4	8	0	0	8	0	0
8	6863678	.	A	G	21	2	23	0	16	39	0	0
8	6863822	.	G	A	13	6	19	0	0	19	0	0
8	6864062	.	C	G	11	4	15	0	0	15	0	0
8	6864077	.	T	C	8	5	13	0	1	14	0	0
8	6864416	.	C	A	22	13	35	0	0	35	0	0
8	6865247	.	T	A	21	16	37	0	3	40	0	0
8	6865357	.	C	T	20	22	42	0	0	42	0	0
8	6865542	.	C	T	20	19	39	0	4	43	0	0
8	6865834	.	A	G	16	17	33	0	1	34	0	0
8	6866083	.	G	A	26	20	46	0	2	48	0	0
8	6866592	.	G	T	19	17	36	0	4	40	0	0
8	6866835	.	T	G	4	10	14	0	0	14	0	0
8	6874937	.	C	T	13	7	20	0	0	20	0	0
8	6874968	.	A	G	15	9	24	0	0	24	0	0
8	6875061	.	G	T	8	18	26	0	0	26	0	0
8	6875300	.	C	T	14	10	24	0	2	26	0	0
8	6875354	.	T	C	14	7	21	0	0	21	0	0
8	6875562	.	C	T	7	5	12	0	1	13	0	0
8	6875563	.	C	T	8	5	13	0	0	13	0	0
8	6875722	.	A	G	16	13	29	0	2	31	0	0
8	6876297	.	T	C	9	13	22	0	1	23	0	0
8	6876381	.	A	G	15	11	26	0	1	27	0	0
8	6876705	.	A	C	21	14	35	0	1	36	0	0
8	6876941	.	G	T	12	14	26	0	1	27	0	0
8	6876999	.	T	C	12	15	27	0	0	27	0	0
8	6877130	.	T	G	9	11	20	0	0	20	0	0
8	6877248	.	T	C	8	0	8	0	7	15	0	0
8	6877268	.	T	C	6	9	15	0	0	15	0	0
8	6887089	.	G	C	1	1	2	0	1	3	0	0
8	6887103	.	A	C	1	3	4	0	0	4	0	0
8	6903650	.	A	G	5	4	9	0	1	10	0	0
8	6903778	.	A	T	2	3	5	0	0	5	0	0
8	6904092	.	C	T	2	4	6	0	2	8	0	0
8	6908059	.	C	T	1	5	6	0	6	12	0	0
8	6913809	.	T	C	6	1	7	0	6	13	0	0
8	6920909	.	A	G	8	3	11	0	2	13	0	0
8	6921117	.	C	G	2	22	24	0	19	43	0	0
8	6921344	.	A	C	16	15	31	0	0	31	0	0
8	6921421	.	T	A	17	24	41	0	0	41	0	0
8	6921581	.	A	C	24	26	50	0	0	50	0	0
8	6921671	.	G	A	19	22	41	0	7	48	0	0
8	6927428	.	T	C	17	18	35	0	3	38	0	0
8	6935642	.	A	T	19	18	37	0	1	38	0	0
8	6943167	.	A	T	3	8	11	0	0	11	0	0
8	6970040	.	G	A	11	12	23	0	1	24	0	0
8	6985008	.	A	G	11	10	21	0	0	21	0	0
8	7014341	.	A	G	16	15	31	0	1	32	0	0
8	7018017	.	G	A	18	12	30	0	1	31	0	0
8	7022216	.	T	A	10	17	27	0	0	27	0	0
8	7022227	.	A	G	12	14	26	0	0	26	0	0
8	7022305	.	C	T	12	15	27	0	1	28	0	0
8	7108624	.	C	T	6	5	11	0	2	13	0	0
8	7114497	.	T	C	8	11	19	0	0	19	0	0
8	7118497	.	T	C	5	11	16	1	0	17	0	0
8	7118520	.	T	G	9	0	9	1	13	23	0	0
8	7118809	.	G	A	14	10	24	0	1	25	0	0
8	7119013	.	G	A	1	5	6	0	17	23	0	0
8	7119189	.	A	G	1	3	4	0	0	4	0	0
8	7119391	.	T	C	2	2	4	0	0	4	0	0
8	7119718	.	C	G	3	0	3	0	9	12	0	0
8	7119757	.	A	G	6	4	10	0	0	10	0	0
8	7120014	.	C	A	4	4	8	0	0	8	0	0
8	7120395	.	G	A	0	2	2	0	5	7	0	0
8	7120479	.	A	T	6	4	10	0	0	10	0	0
8	7120498	.	A	G	9	5	14	0	0	14	0	0
8	7120546	.	A	G	11	6	17	0	1	18	0	0
8	7120572	.	C	G	9	5	14	0	1	15	0	0
8	7120604	.	T	C	8	8	16	1	1	18	0	0
8	7120805	.	T	C	6	2	8	0	0	8	0	0
8	7120822	.	C	T	5	2	7	0	0	7	0	0
8	7120873	.	G	A	7	6	13	0	2	15	0	0
8	7121011	.	T	A	16	7	23	0	2	25	0	0
8	7121312	.	C	T	4	3	7	0	0	7	0	0
8	7121347	.	A	T	6	8	14	0	0	14	0	0
8	7121593	.	T	A	5	2	7	0	0	7	0	0
8	7121868	.	C	T	4	9	13	0	1	14	0	0
8	7121877	.	A	G	6	9	15	0	0	15	0	0
8	7121939	.	A	C	2	2	4	0	0	4	0	0
8	7122171	.	A	T	4	6	10	0	0	10	0	0
8	7122186	.	T	C	4	3	7	0	0	7	0	0
8	7122221	.	T	A	4	2	6	0	0	6	0	0
8	7122332	.	A	G	1	4	5	0	1	6	0	0
8	7122459	.	A	G	9	5	14	0	0	14	0	0
8	7122460	.	A	T	8	5	13	0	1	14	0	0
8	7122592	.	G	A	1	2	3	0	1	4	0	0
8	7122830	.	A	T	5	4	9	0	0	9	0	0
8	7122931	.	G	A	2	9	11	0	9	20	0	0
8	7123171	.	G	C	1	12	13	0	17	30	0	0
8	7123233	.	A	T	13	14	27	0	0	27	0	0
8	7123257	.	T	C	10	13	23	0	2	25	0	0
8	7123323	.	C	A	13	8	21	0	1	22	0	0
8	7123326	.	A	G	13	9	22	0	0	22	0	0
8	7123360	.	A	T	12	6	18	0	0	18	0	0
8	7123414	.	G	A	2	7	9	0	7	16	0	0
8	7123415	.	G	C	9	7	16	0	0	16	0	0
8	7123452	.	G	A	9	14	23	0	1	24	0	0
8	7123472	.	A	G	12	11	23	0	1	24	0	0
8	7123491	.	T	C	13	15	28	0	0	28	0	0
8	7123538	.	G	A	11	9	20	0	1	21	0	0
8	7344519	.	A	G	4	2	6	0	0	6	0	0
8	7908374	.	A	G	8	1	9	0	3	12	0	0
8	7908520	.	A	G	7	7	14	0	0	14	0	0
8	7911294	.	A	T	2	2	4	0	0	4	0	0
8	8695773	.	G	T	1	3	4	0	0	4	0	0
8	8695935	.	G	T	3	3	6	0	0	6	0	0
8	8699163	.	A	T	4	4	8	0	0	8	0	0
8	8699174	.	T	A	3	4	7	0	0	7	0	0
8	8699235	.	G	A	4	6	10	0	0	10	0	0
8	8704215	.	C	T	6	5	11	0	0	11	0	0
8	8729278	.	C	G	14	7	21	0	0	21	0	0
8	8729308	.	T	A	11	7	18	0	0	18	0	0
8	8735644	.	T	C	9	7	16	0	0	16	0	0
8	8735698	.	C	A	12	6	18	0	2	20	0	0
8	8846132	.	C	T	7	9	16	0	0	16	0	0
8	8846877	.	C	T	12	11	23	0	1	24	0	0
8	8846924	.	G	A	13	15	28	0	1	29	0	0
8	8847341	.	T	A	11	13	24	0	0	24	0	0
8	8847476	.	C	T	6	4	10	0	1	11	0	0
8	8847648	.	T	A	17	13	30	0	0	30	0	0
8	8847893	.	A	T	13	9	22	1	3	26	0	0
8	8848122	.	C	A	7	5	12	0	1	13	0	0
8	8861240	.	G	A	1	10	11	0	8	19	0	0
8	8914911	.	C	T	11	5	16	0	1	17	0	0
8	8919045	.	G	A	3	18	21	0	12	33	0	0
8	8954016	.	C	A	2	2	4	0	0	4	0	0
8	8974572	.	G	A	1	12	13	0	18	31	0	0
8	8975929	.	T	C	13	16	29	0	2	31	0	0
8	8977919	.	G	A	13	10	23	0	1	24	0	0
8	8993240	.	A	G	22	12	34	0	2	36	0	0
8	9015855	.	A	G	10	16	26	0	0	26	0	0
8	9015894	.	G	C	14	10	24	0	0	24	0	0
8	9028945	.	G	A	0	11	11	0	9	20	0	0
8	9029047	.	C	A	8	7	15	0	0	15	0	0
8	9029076	.	A	G	6	5	11	0	1	12	0	0
8	9052123	.	C	T	10	17	27	0	1	28	0	0
8	9076296	.	T	C	8	17	25	0	0	25	0	0
8	9076389	.	C	T	1	3	4	0	10	14	0	0
8	9093623	.	A	T	13	10	23	0	2	25	0	0
8	9149459	.	G	A	3	2	5	0	0	5	0	0
8	9232930	.	C	T	22	9	31	0	1	32	0	0
8	9234574	.	G	A	8	15	23	0	1	24	0	0
8	9262024	.	G	A	12	11	23	0	0	23	0	0
8	9267615	.	G	C	17	7	24	0	0	24	0	0
8	9270038	.	A	G	12	15	27	0	2	29	0	0
8	9270041	.	G	A	14	15	29	0	2	31	0	0
8	9270373	.	G	A	9	9	18	0	0	18	0	0
8	9275165	.	C	T	0	11	11	0	10	21	0	0
8	9275180	.	G	A	11	11	22	0	0	22	0	0
8	9280472	.	G	A	7	14	21	0	0	21	0	0
8	9390769	.	G	A	7	9	16	1	1	18	0	0
8	9395005	.	G	A	12	9	21	1	0	22	0	0
8	9429697	.	G	A	5	13	18	0	0	18	0	0
8	9542541	.	G	A	9	6	15	0	2	17	0	0
8	9542724	.	C	T	6	3	9	0	1	10	0	0
8	9543159	.	G	T	5	7	12	0	0	12	0	0
8	9543482	.	C	T	6	7	13	0	1	14	0	0
8	9543703	.	G	T	8	6	14	1	0	15	0	0
8	9543704	.	G	A	6	7	13	1	0	14	0	0
8	9570386	.	A	C	6	7	13	0	0	13	0	0
8	9570464	.	T	A	7	3	10	0	0	10	0	0
8	9699228	.	A	C	5	5	10	0	0	10	0	0
8	9700176	.	G	T	1	9	10	0	7	17	0	0
8	9704537	.	T	C	9	4	13	0	0	13	0	0
8	9704548	.	T	C	9	4	13	0	1	14	0	0
8	9716087	.	C	G	8	9	17	0	1	18	0	0
8	9716114	.	G	A	9	11	20	0	1	21	0	0
8	9716229	.	A	G	11	7	18	0	0	18	0	0
8	9728650	.	G	A	0	10	10	1	5	16	0	0
8	9733153	.	G	A	1	13	14	0	8	22	0	0
8	9733174	.	G	A	10	10	20	0	0	20	0	0
8	9736134	.	A	G	13	10	23	0	0	23	0	0
8	9736287	.	G	A	14	9	23	0	0	23	0	0
8	9743078	.	T	C	12	8	20	0	0	20	0	0
8	9743081	.	A	T	11	8	19	0	1	20	0	0
8	9748783	.	A	G	13	11	24	0	0	24	0	0
8	9748864	.	A	G	14	8	22	0	0	22	0	0
8	9755356	.	T	G	18	10	28	1	0	29	0	0
8	9755411	.	A	G	6	0	6	0	10	16	0	0
8	9781903	.	G	A	14	10	24	0	0	24	0	0
8	9791577	.	G	A	0	8	8	0	11	19	0	0
8	9791902	.	T	C	11	4	15	0	1	16	0	0
8	9791977	.	G	A	0	9	9	0	10	19	0	0
8	9792083	.	C	G	4	5	9	0	0	9	0	0
8	9866518	.	G	C	5	4	9	0	0	9	0	0
8	9867382	.	A	G	4	2	6	0	0	6	0	0
8	9867514	.	G	A	0	5	5	0	7	12	0	0
8	9867730	.	C	T	1	2	3	0	0	3	0	0
8	9867902	.	G	A	8	8	16	0	0	16	0	0
8	9868004	.	C	T	9	4	13	0	0	13	0	0
8	9868973	.	G	A	0	9	9	0	7	16	0	0
8	9985326	.	C	T	11	9	20	0	1	21	0	0
8	9985374	.	A	G	10	11	21	0	0	21	0	0
8	10305260	.	C	T	17	16	33	0	1	34	0	0
8	10306061	.	C	T	26	10	36	0	1	37	0	0
8	10307924	.	G	A	16	13	29	0	1	30	0	0
8	10308278	.	G	T	23	18	41	1	1	44	1	0
8	10562144	.	C	T	12	9	21	0	1	22	0	0
8	10562198	.	A	G	5	11	16	0	0	16	0	0
8	10823405	.	G	A	0	7	7	0	3	10	0	0
8	10856883	.	A	C	8	4	12	0	0	12	0	0
8	10862635	.	C	A	8	9	17	0	0	17	0	0
8	10869215	.	T	C	8	5	13	0	0	13	0	0
8	10869953	.	C	T	2	5	7	0	0	7	0	0
8	10870571	.	C	A	7	6	13	0	0	13	0	0
8	10873945	.	A	G	1	5	6	0	2	8	0	0
8	10884375	.	G	A	0	5	5	0	10	15	0	0
8	10884492	.	C	T	5	10	15	0	1	16	0	0
8	10890013	.	C	T	8	9	17	0	0	17	0	0
8	10890056	.	G	A	1	4	5	0	9	14	0	0
8	10890079	.	C	T	11	6	17	0	0	17	0	0
8	10890169	.	T	C	12	8	20	0	0	20	0	0
8	10894887	.	C	T	7	3	10	0	1	11	0	0
8	10956794	.	G	C	9	4	13	0	0	13	0	0
8	10956824	.	A	G	8	10	18	0	1	19	0	0
8	10957045	.	G	T	12	8	20	0	0	20	0	0
8	10967342	.	T	C	17	0	17	0	14	31	0	0
8	10969694	.	C	T	10	9	19	0	0	19	0	0
8	10972414	.	G	A	18	9	27	1	0	28	0	0
8	10987621	.	G	A	11	11	22	1	0	23	0	0
8	10988903	.	C	T	10	10	20	0	2	22	0	0
8	11004226	.	A	G	11	8	19	0	0	19	0	0
8	11004246	.	G	A	17	7	24	0	0	24	0	0
8	11004484	.	C	A	1	11	12	0	8	20	0	0
8	11004549	.	C	T	13	12	25	0	2	27	0	0
8	11004597	.	G	T	12	14	26	0	0	26	0	0
8	11010149	.	T	C	14	12	26	0	1	27	0	0
8	11045363	.	T	C	2	4	6	0	0	6	0	0
8	11055988	.	A	G	0	3	3	0	0	3	0	0
8	11055994	.	G	A	2	2	4	0	0	4	0	0
8	11056045	.	T	C	3	3	6	0	1	7	0	0
8	11056065	.	G	A	4	2	6	0	1	7	0	0
8	11066300	.	G	A	1	2	3	0	0	3	0	0
8	11076871	.	C	T	1	3	4	0	0	4	0	0
8	11115005	.	A	T	4	4	8	0	0	8	0	0
8	11115117	.	A	T	1	2	3	0	1	4	0	0
8	11115818	.	A	T	5	2	7	0	0	7	0	0
8	11115853	.	T	C	3	2	5	0	0	5	0	0
8	11115873	.	G	A	1	2	3	0	0	3	0	0
8	11116617	.	G	A	2	2	4	0	0	4	0	0
8	11136791	.	G	A	3	10	13	0	1	14	0	0
8	11139954	.	C	G	4	10	14	0	3	17	0	0
8	11141807	.	C	T	6	5	11	0	0	11	0	0
8	11144820	.	T	C	7	1	8	0	6	14	0	0
8	11179228	.	T	A	7	6	13	0	0	13	0	0
8	11180061	.	C	T	6	7	13	0	3	16	0	0
8	11180063	.	T	G	7	6	13	0	2	15	0	0
8	11182873	.	G	A	3	4	7	0	0	8	1	0
8	11182905	.	A	C	4	3	7	0	0	7	0	0
8	11183508	.	T	A	3	5	8	0	1	9	0	0
8	11183555	.	G	T	5	2	7	0	0	7	0	0
8	11183576	.	A	T	6	5	11	0	0	11	0	0
8	11183690	.	T	C	4	7	11	0	0	11	0	0
8	11183708	.	G	A	3	4	7	0	1	8	0	0
8	11183733	.	C	T	7	7	14	0	0	14	0	0
8	11183787	.	G	A	6	7	13	0	1	14	0	0
8	11183817	.	C	G	2	5	7	0	5	12	0	0
8	11183892	.	T	A	6	6	12	0	0	12	0	0
8	11184030	.	C	A	1	8	9	0	0	9	0	0
8	11184192	.	T	G	2	3	5	0	0	5	0	0
8	11184222	.	A	G	1	2	3	0	0	3	0	0
8	11184609	.	T	G	4	4	8	0	0	8	0	0
8	11185406	.	G	C	4	4	8	0	0	8	0	0
8	11185411	.	A	G	5	4	9	0	0	9	0	0
8	11185453	.	T	A	5	7	12	0	0	12	0	0
8	11185476	.	T	G	4	6	10	0	1	11	0	0
8	11185729	.	A	G	3	2	5	0	0	5	0	0
8	11185986	.	T	C	5	0	5	0	4	9	0	0
8	11186470	.	A	C	4	0	4	0	3	7	0	0
8	11186520	.	C	T	3	6	9	0	0	9	0	0
8	11186812	.	G	A	1	2	3	0	0	3	0	0
8	11189117	.	C	G	2	6	8	0	0	8	0	0
8	11189290	.	A	G	2	3	5	0	0	5	0	0
8	11190319	.	T	C	2	0	2	0	3	5	0	0
8	11190323	.	G	A	3	2	5	0	0	5	0	0
8	11191051	.	T	G	3	2	5	0	0	5	0	0
8	11191221	.	C	A	2	3	5	0	0	5	0	0
8	11191339	.	T	G	4	4	8	0	0	8	0	0
8	11191378	.	C	T	2	4	6	0	0	6	0	0
8	11204441	.	C	T	0	2	2	2	5	9	0	0
8	11204699	.	C	T	2	3	5	0	1	6	0	0
8	11207204	.	G	A	1	3	4	0	0	4	0	0
8	11209538	.	G	A	1	3	4	0	0	4	0	0
8	11209559	.	G	A	1	3	4	0	0	4	0	0
8	11209601	.	G	A	1	3	4	0	0	4	0	0
8	11234522	.	T	G	1	5	6	0	1	7	0	0
8	11234678	.	G	A	3	2	5	0	0	5	0	0
8	11236914	.	T	C	9	8	17	0	0	17	0	0
8	11241284	.	A	T	7	4	11	0	1	12	0	0
8	11245967	.	A	G	6	7	13	0	0	13	0	0
8	11246006	.	G	A	4	6	10	0	0	10	0	0
8	11250740	.	A	T	9	9	18	0	0	18	0	0
8	11268795	.	G	A	7	8	15	0	0	15	0	0
8	11268807	.	G	A	8	5	13	0	0	13	0	0
8	11268837	.	G	A	7	6	13	0	0	13	0	0
8	11278615	.	G	A	5	5	10	0	0	10	0	0
8	11288949	.	C	T	6	3	9	0	0	9	0	0
8	11338660	.	A	G	2	6	8	0	2	10	0	0
8	11477573	.	C	T	9	7	16	0	0	16	0	0
8	11483097	.	G	A	0	13	13	0	11	24	0	0
8	11483163	.	C	T	13	13	26	0	1	27	0	0
8	11488468	.	C	T	14	8	22	0	3	25	0	0
8	11491332	.	C	T	8	14	22	0	0	22	0	0
8	11503000	.	A	C	12	7	19	0	0	19	0	0
8	11503006	.	T	C	10	6	16	0	0	16	0	0
8	11504189	.	A	C	4	0	4	0	4	8	0	0
8	11511403	.	C	T	5	11	16	0	0	16	0	0
8	11520599	.	C	T	4	6	10	0	2	12	0	0
8	11521145	.	G	A	9	8	17	0	2	19	0	0
8	11521229	.	C	T	10	7	17	0	0	17	0	0
8	11540815	.	G	T	14	12	26	0	0	26	0	0
8	11541829	.	A	G	10	12	22	0	3	25	0	0
8	11541844	.	C	A	11	11	22	0	2	24	0	0
8	11542207	.	C	G	4	5	9	0	0	9	0	0
8	11543431	.	G	C	1	2	3	0	0	3	0	0
8	11548419	.	A	G	1	4	5	0	0	5	0	0
8	11578414	.	G	T	6	4	10	0	0	10	0	0
8	11584163	.	T	C	11	8	19	0	0	19	0	0
8	11584385	.	A	G	7	6	13	0	0	13	0	0
8	11590898	.	G	A	6	7	13	0	0	13	0	0
8	11590903	.	G	A	5	8	13	0	1	14	0	0
8	11590976	.	G	A	12	4	16	0	1	17	0	0
8	11603914	.	G	A	10	8	18	0	1	19	0	0
8	11607223	.	G	A	2	7	9	0	0	9	0	0
8	11615923	.	C	T	1	9	10	0	6	16	0	0
8	11648291	.	A	G	2	7	9	0	0	9	0	0
8	11648725	.	C	T	4	2	6	0	0	6	0	0
8	11648767	.	G	A	6	2	8	0	0	8	0	0
8	11648815	.	T	G	7	3	10	0	0	10	0	0
8	11661708	.	C	T	8	4	12	0	0	12	0	0
8	11661816	.	A	C	1	6	7	0	0	7	0	0
8	11681128	.	T	C	1	3	4	0	0	4	0	0
8	11681227	.	A	G	1	3	4	0	0	4	0	0
8	11681297	.	T	G	1	3	4	0	0	4	0	0
8	11690690	.	G	A	7	5	12	1	2	15	0	0
8	11724218	.	A	G	5	2	7	0	1	8	0	0
8	11728172	.	A	G	5	0	5	0	8	13	0	0
8	11728191	.	C	T	7	4	11	0	0	11	0	0
8	11728655	.	C	A	7	5	12	0	0	13	1	0
8	11734317	.	C	T	2	8	10	0	1	11	0	0
8	11734353	.	C	A	6	12	18	0	0	18	0	0
8	11736671	.	T	A	8	10	18	0	1	19	0	0
8	11737937	.	A	G	5	9	14	0	2	16	0	0
8	11740461	.	A	C	5	6	11	0	0	11	0	0
8	11744619	.	A	G	5	9	14	0	0	14	0	0
8	11744660	.	A	G	6	11	17	0	0	17	0	0
8	11744723	.	T	G	6	6	12	0	0	12	0	0
8	11744758	.	A	G	4	4	8	0	0	8	0	0
8	11744810	.	G	A	4	3	7	0	0	7	0	0
8	11746647	.	A	G	3	5	8	0	0	8	0	0
8	11746684	.	A	G	4	8	12	0	0	12	0	0
8	11746701	.	G	T	4	9	13	0	0	13	0	0
8	11746741	.	G	A	6	14	20	0	0	20	0	0
8	11746759	.	G	A	12	4	16	0	1	17	0	0
8	11752669	.	C	T	1	5	6	0	8	14	0	0
8	11756494	.	C	T	4	4	8	0	0	8	0	0
8	11757034	.	T	C	7	3	10	0	1	11	0	0
8	11761820	.	C	T	0	4	4	0	3	7	0	0
8	11761829	.	T	A	3	2	5	0	1	6	0	0
8	11770027	.	A	G	2	7	9	0	0	9	0	0
8	11779630	.	C	A	1	4	5	0	5	10	0	0
8	11789512	.	G	A	4	5	9	0	0	9	0	0
8	11794663	.	C	T	3	3	6	0	0	6	0	0
8	11803515	.	T	C	1	2	3	0	0	3	0	0
8	11884842	.	A	G	1	2	3	0	0	3	0	0
8	11884857	.	C	T	0	3	3	0	1	4	0	0
8	11884919	.	T	A	5	2	7	0	0	7	0	0
8	11884930	.	A	G	5	3	8	0	2	10	0	0
8	11985228	.	A	G	3	7	10	0	1	11	0	0
8	12016553	.	G	A	10	12	22	0	0	22	0	0
8	12111198	.	C	T	14	14	28	0	2	30	0	0
8	12118473	.	A	G	10	3	13	0	0	13	0	0
8	12135256	.	G	A	13	11	24	1	3	28	0	0
8	12136448	.	A	G	18	11	29	0	2	31	0	0
8	12149688	.	C	T	9	9	18	0	0	18	0	0
8	12149865	.	G	T	15	9	24	0	1	25	0	0
8	12149994	.	G	A	10	3	13	0	0	13	0	0
8	12150108	.	A	G	12	3	15	0	0	15	0	0
8	12150471	.	C	T	6	8	14	0	3	17	0	0
8	12150516	.	G	C	13	0	13	0	9	22	0	0
8	12182923	.	G	A	5	5	10	0	0	10	0	0
8	12189722	.	G	A	13	6	19	0	1	20	0	0
8	12342284	.	A	G	1	2	3	0	0	3	0	0
8	12342324	.	A	G	1	2	3	0	0	3	0	0
8	14170863	.	C	A	14	4	18	0	0	18	0	0
8	14441524	.	A	G	11	7	18	1	1	20	0	0
8	14441535	.	C	T	16	4	20	2	1	23	0	0
8	14792860	.	A	G	4	12	16	0	1	17	0	0
8	14983211	.	A	G	4	6	10	0	0	10	0	0
8	15094314	.	C	T	1	2	3	0	5	8	0	0
8	16464100	.	A	G	13	12	25	0	1	26	0	0
8	16464166	.	G	A	13	8	21	0	0	21	0	0
8	16470750	.	C	T	5	4	9	0	0	9	0	0
8	16516832	.	A	T	4	8	12	0	0	12	0	0
8	16517152	.	C	A	1	5	6	0	1	7	0	0
8	16517265	.	C	T	0	3	3	0	4	7	0	0
8	16517310	.	C	G	6	3	9	0	0	9	0	0
8	16518493	.	T	A	2	3	5	0	0	5	0	0
8	16518724	.	C	T	3	3	6	0	0	6	0	0
8	16519055	.	C	T	8	4	12	0	1	13	0	0
8	16519084	.	C	A	8	10	18	0	0	18	0	0
8	16519370	.	G	A	3	4	7	0	0	7	0	0
8	16519389	.	C	T	2	3	5	0	1	6	0	0
8	16519637	.	C	T	3	11	14	0	1	15	0	0
8	16519646	.	G	T	3	12	15	0	0	15	0	0
8	16519692	.	G	A	11	8	19	0	0	19	0	0
8	16519695	.	G	C	11	8	19	0	0	19	0	0
8	16519782	.	C	T	21	6	27	0	2	29	0	0
8	16519821	.	G	A	16	6	22	0	0	22	0	0
8	16524401	.	G	C	12	0	12	0	6	18	0	0
8	16525504	.	T	A	10	5	15	0	0	15	0	0
8	16525519	.	A	G	11	4	15	0	0	15	0	0
8	16527055	.	C	G	6	9	15	0	0	15	0	0
8	16528223	.	A	G	9	10	19	0	3	22	0	0
8	16528390	.	T	G	6	7	13	0	0	13	0	0
8	16528454	.	C	T	1	4	5	0	10	15	0	0
8	16528475	.	C	T	1	4	5	0	7	12	0	0
8	16531802	.	C	T	7	4	11	0	1	12	0	0
8	16583174	.	C	A	24	13	37	0	0	37	0	0
8	16584037	.	C	T	2	15	17	17	26	60	0	0
8	16587964	.	A	T	22	20	42	0	3	45	0	0
8	16588421	.	C	T	26	21	47	1	3	51	0	0
8	16588444	.	G	A	26	12	38	1	1	40	0	0
8	16591864	.	A	G	12	14	26	0	0	26	0	0
8	16597377	.	T	C	24	5	29	0	0	29	0	0
8	16597424	.	T	C	17	5	22	1	2	25	0	0
8	16597524	.	T	C	6	5	11	0	1	12	0	0
8	16597589	.	T	A	3	6	9	0	0	9	0	0
8	16597654	.	T	C	2	0	2	0	7	9	0	0
8	16597680	.	C	G	2	8	10	0	0	10	0	0
8	16597949	.	A	T	10	7	17	0	0	17	0	0
8	16597964	.	G	A	11	11	22	0	0	22	0	0
8	16597986	.	G	A	7	10	17	0	1	18	0	0
8	16598076	.	C	T	2	13	15	0	10	25	0	0
8	16605597	.	A	G	6	12	18	0	0	18	0	0
8	16605615	.	G	A	9	6	15	0	1	16	0	0
8	16605678	.	G	A	4	10	14	0	0	14	0	0
8	16605723	.	G	A	6	12	18	0	1	19	0	0
8	16608287	.	G	A	13	4	17	0	0	17	0	0
8	16608875	.	G	A	6	4	10	0	0	10	0	0
8	16608898	.	C	T	1	5	6	0	2	8	0	0
8	16608988	.	A	T	6	2	8	0	0	8	0	0
8	16610107	.	T	C	13	0	13	0	5	18	0	0
8	16610142	.	C	T	13	4	17	0	1	18	0	0
8	16610196	.	A	G	2	5	7	0	1	8	0	0
8	16610387	.	G	A	8	4	12	0	3	15	0	0
8	16610585	.	T	C	6	6	12	0	0	12	0	0
8	16611008	.	A	G	2	4	6	0	0	6	0	0
8	16615866	.	T	C	6	4	10	0	1	11	0	0
8	16615867	.	A	G	4	7	11	0	0	11	0	0
8	16615929	.	A	T	7	8	15	0	2	18	1	0
8	16616190	.	C	A	11	15	26	1	0	27	0	0
8	16616697	.	C	T	1	16	17	0	24	41	0	0
8	16616899	.	G	A	15	11	26	0	1	27	0	0
8	16621919	.	A	G	17	17	34	0	4	38	0	0
8	16625575	.	C	A	11	11	22	0	1	23	0	0
8	16653843	.	A	G	7	10	17	0	0	17	0	0
8	16685796	.	T	A	2	2	4	1	0	5	0	0
8	16686289	.	G	A	0	2	2	0	3	5	0	0
8	16686301	.	G	C	2	2	4	0	0	4	0	0
8	16688316	.	T	G	1	5	6	0	0	6	0	0
8	17044516	.	G	A	5	4	9	1	0	10	0	0
8	17055727	.	C	T	2	23	25	0	27	52	0	0
8	17055751	.	C	T	28	13	41	0	10	51	0	0
8	17055766	.	G	A	20	25	45	0	4	49	0	0
8	17055802	.	C	T	3	30	33	0	21	54	0	0
8	17062173	.	G	A	19	25	44	0	0	44	0	0
8	17067268	.	A	T	19	20	39	0	2	41	0	0
8	17067269	.	T	C	21	21	42	0	0	42	0	0
8	17081728	.	G	T	20	18	38	0	1	39	0	0
8	17081734	.	G	A	19	16	35	0	3	38	0	0
8	17081976	.	C	T	14	16	30	0	1	31	0	0
8	17082696	.	C	A	16	13	29	0	0	29	0	0
8	17084696	.	G	C	19	22	41	0	1	42	0	0
8	17085921	.	G	A	19	18	37	0	2	39	0	0
8	17086033	.	C	T	10	6	16	0	1	17	0	0
8	17086096	.	A	T	3	6	9	0	1	10	0	0
8	17146845	.	T	G	5	7	12	0	1	13	0	0
8	17152826	.	A	G	3	5	8	0	1	9	0	0
8	17154080	.	A	C	8	7	15	0	1	16	0	0
8	17154128	.	A	G	7	0	7	0	7	14	0	0
8	17154188	.	C	T	6	8	14	0	0	14	0	0
8	17154406	.	T	C	9	8	17	0	1	18	0	0
8	17156641	.	A	G	12	10	22	0	0	22	0	0
8	17156772	.	G	C	7	8	15	0	0	15	0	0
8	17156806	.	A	G	8	7	15	0	0	15	0	0
8	17156869	.	C	T	5	13	18	0	0	18	0	0
8	17156950	.	T	A	6	7	13	0	0	13	0	0
8	17163611	.	A	G	7	6	13	0	0	13	0	0
8	17163704	.	C	T	4	9	13	0	1	14	0	0
8	17163766	.	T	A	13	16	29	0	0	29	0	0
8	17163771	.	A	G	13	14	27	0	1	28	0	0
8	17163847	.	C	G	2	11	13	0	13	26	0	0
8	17163852	.	C	T	12	12	24	0	2	26	0	0
8	17164208	.	G	A	15	20	35	0	2	37	0	0
8	17164302	.	A	G	22	15	37	0	3	40	0	0
8	17166577	.	C	T	20	10	30	1	0	31	0	0
8	17175466	.	T	C	3	0	3	0	3	6	0	0
8	17179051	.	G	C	3	2	5	0	0	5	0	0
8	17181187	.	T	C	2	0	2	0	5	7	0	0
8	17181190	.	T	A	3	5	8	0	0	8	0	0
8	17182911	.	A	G	2	2	4	0	0	4	0	0
8	17184425	.	A	T	2	2	4	0	1	5	0	0
8	17184734	.	C	T	2	3	5	0	0	5	0	0
8	17186987	.	C	T	2	5	7	0	0	7	0	0
8	17189932	.	T	C	4	2	6	0	0	6	0	0
8	17190086	.	C	T	2	2	4	0	0	4	0	0
8	17190095	.	A	G	4	0	4	0	2	6	0	0
8	17190128	.	C	T	4	2	6	0	0	6	0	0
8	17396186	.	T	G	17	23	40	0	2	42	0	0
8	17396815	.	T	A	12	2	14	0	0	14	0	0
8	17396904	.	T	C	21	0	21	0	9	30	0	0
8	17397095	.	C	T	4	4	8	0	0	8	0	0
8	17397780	.	T	C	6	4	10	0	0	10	0	0
8	17397793	.	T	A	6	6	12	0	0	12	0	0
8	17397995	.	A	T	17	8	25	0	2	27	0	0
8	17398070	.	T	C	12	13	25	0	3	28	0	0
8	17398113	.	C	T	2	11	13	0	7	20	0	0
8	17398277	.	G	A	5	5	10	0	0	10	0	0
8	17398712	.	G	A	12	4	16	0	0	16	0	0
8	17399061	.	C	T	13	5	18	0	0	18	0	0
8	17399609	.	C	T	16	22	38	0	1	39	0	0
8	17407150	.	G	A	8	9	17	0	1	18	0	0
8	17407210	.	C	G	0	13	13	0	9	22	0	0
8	17407258	.	T	C	12	1	13	0	17	30	0	0
8	17516363	.	G	A	6	5	11	0	0	11	0	0
8	17529502	.	T	A	2	0	2	0	1	3	0	0
8	17529521	.	C	T	2	1	3	0	1	4	0	0
8	17534908	.	T	G	2	0	2	0	4	6	0	0
8	17534992	.	T	C	1	3	4	0	0	4	0	0
8	17535026	.	C	A	3	2	5	0	0	5	0	0
8	17609003	.	C	T	10	12	22	0	1	23	0	0
8	17775526	.	A	T	2	2	4	0	0	4	0	0
8	17775550	.	T	G	1	3	4	0	0	4	0	0
8	17775655	.	A	C	7	3	10	0	0	10	0	0
8	17778741	.	T	C	6	4	10	0	0	10	0	0
8	17778744	.	A	G	6	3	9	0	2	11	0	0
8	17778843	.	G	C	7	6	13	0	1	14	0	0
8	17778864	.	C	T	7	6	13	0	0	13	0	0
8	17781076	.	G	A	1	6	7	0	6	13	0	0
8	17781096	.	C	A	7	4	11	0	2	13	0	0
8	17781537	.	T	C	11	6	17	0	1	18	0	0
8	17781576	.	T	C	2	5	7	0	3	10	0	0
8	17781721	.	A	G	2	2	4	0	0	4	0	0
8	17782436	.	G	T	1	3	4	0	0	4	0	0
8	17783508	.	A	C	0	2	2	0	1	3	0	0
8	17783614	.	A	G	1	1	2	0	1	3	0	0
8	17783674	.	A	G	5	4	9	0	0	9	0	0
8	17783703	.	G	T	5	7	12	0	0	12	0	0
8	17784308	.	A	G	8	6	14	0	0	14	0	0
8	17784322	.	T	A	8	5	13	0	0	13	0	0
8	17784466	.	G	A	3	2	5	0	0	5	0	0
8	17790323	.	C	T	3	3	6	0	1	7	0	0
8	17790883	.	A	C	2	0	2	0	9	11	0	0
8	17800833	.	A	G	3	5	8	0	0	8	0	0
8	17801438	.	A	G	8	6	14	0	1	15	0	0
8	17820773	.	T	C	1	8	9	0	0	9	0	0
8	17820839	.	C	G	4	6	10	0	0	10	0	0
8	17820846	.	G	A	5	5	10	0	0	10	0	0
8	17822149	.	C	G	5	5	10	0	1	11	0	0
8	17822181	.	G	A	10	7	17	0	1	18	0	0
8	17895075	.	G	A	0	8	8	0	6	14	0	0
8	17905324	.	A	C	6	9	15	0	1	16	0	0
8	17906164	.	C	T	2	6	8	0	0	8	0	0
8	17907779	.	G	A	7	5	12	0	0	12	0	0
8	17909833	.	C	T	2	7	9	0	0	9	0	0
8	17917301	.	C	T	2	3	5	0	0	5	0	0
8	17917305	.	G	A	1	3	4	0	1	5	0	0
8	17937121	.	C	G	1	0	1	0	7	8	0	0
8	17943928	.	A	C	2	3	5	0	0	5	0	0
8	17944398	.	C	T	3	2	5	0	0	5	0	0
8	17984835	.	T	C	3	0	3	0	4	7	0	0
8	17994298	.	C	T	0	2	2	0	2	4	0	0
8	18024959	.	C	T	14	24	38	0	1	39	0	0
8	18026052	.	G	A	2	10	12	0	17	29	0	0
8	18030857	.	C	T	8	14	22	0	0	22	0	0
8	18030884	.	G	A	12	9	21	0	0	21	0	0
8	18033113	.	T	C	12	11	23	0	0	23	0	0
8	18035129	.	A	T	18	16	34	0	1	35	0	0
8	18035428	.	G	A	22	10	32	0	0	32	0	0
8	18035786	.	C	T	14	17	31	0	0	31	0	0
8	18035946	.	T	A	19	8	27	0	0	27	0	0
8	18036167	.	T	C	9	4	13	0	0	13	0	0
8	18040581	.	G	A	1	4	5	0	1	6	0	0
8	18041925	.	A	C	1	0	1	0	5	6	0	0
8	18041974	.	A	T	2	5	7	0	0	7	0	0
8	18193373	.	C	G	9	9	18	0	1	19	0	0
8	18193420	.	C	G	10	8	18	0	1	19	0	0
8	18193591	.	A	T	11	11	22	0	1	23	0	0
8	18193628	.	T	C	22	9	31	0	1	32	0	0
8	18193707	.	T	C	24	18	42	0	1	43	0	0
8	18194238	.	T	C	31	18	49	0	0	49	0	0
8	18194283	.	G	A	29	22	51	0	0	51	0	0
8	18196444	.	C	T	3	11	14	0	34	48	0	0
8	18198801	.	C	T	15	13	28	0	3	31	0	0
8	18199999	.	A	G	6	5	11	1	0	12	0	0
8	18207373	.	A	G	3	2	5	0	1	6	0	0
8	18209680	.	G	T	3	4	7	0	1	8	0	0
8	18210162	.	G	T	3	3	6	0	0	6	0	0
8	18210185	.	A	G	3	3	6	0	0	6	0	0
8	18242762	.	G	T	2	4	6	0	0	6	0	0
8	18242977	.	C	A	1	2	3	0	0	3	0	0
8	18242978	.	A	C	1	2	3	0	0	3	0	0
8	18243671	.	G	T	1	5	6	0	0	6	0	0
8	18243725	.	T	C	2	3	5	0	0	5	0	0
8	18244542	.	C	T	0	2	2	0	2	4	0	0
8	18256270	.	G	A	2	2	4	0	0	4	0	0
8	18258843	.	A	G	3	3	6	0	0	6	0	0
8	18258846	.	C	T	3	4	7	0	0	7	0	0
8	18314002	.	G	T	1	2	3	0	0	3	0	0
8	18356524	.	G	A	12	14	26	0	2	28	0	0
8	18356688	.	G	A	10	20	30	0	0	30	0	0
8	18358694	.	T	G	3	5	8	0	0	8	0	0
8	18358709	.	T	C	3	2	5	0	0	5	0	0
8	18358760	.	C	A	3	4	7	0	0	7	0	0
8	18358879	.	G	A	10	6	16	0	0	16	0	0
8	18361223	.	G	A	7	9	16	0	2	18	0	0
8	18364066	.	G	A	11	12	23	0	0	23	0	0
8	18365788	.	C	T	7	2	9	0	0	9	0	0
8	18367707	.	G	T	10	5	15	0	0	15	0	0
8	18367709	.	A	G	9	5	14	0	0	14	0	0
8	18486796	.	C	A	2	3	5	0	0	5	0	0
8	18512015	.	A	T	6	4	10	0	1	11	0	0
8	18512195	.	G	A	1	5	6	0	0	6	0	0
8	18515778	.	G	A	3	6	9	0	1	10	0	0
8	18519633	.	A	C	1	6	7	0	0	7	0	0
8	18532014	.	C	T	1	4	5	0	1	6	0	0
8	18537826	.	T	G	2	2	4	0	0	4	0	0
8	18545641	.	A	T	6	8	14	0	0	14	0	0
8	18550469	.	T	A	15	6	21	0	0	21	0	0
8	18554720	.	G	T	13	7	20	0	1	21	0	0
8	18554825	.	T	C	11	15	26	0	0	26	0	0
8	18562153	.	A	G	22	16	38	0	3	41	0	0
8	18562225	.	C	A	16	19	35	0	1	36	0	0
8	18562283	.	G	A	3	15	18	0	14	32	0	0
8	18562317	.	C	T	17	14	31	0	0	31	0	0
8	18562570	.	C	T	3	13	16	0	0	16	0	0
8	18566278	.	G	A	5	13	18	0	0	18	0	0
8	18566327	.	C	A	7	11	18	0	0	18	0	0
8	18566419	.	T	A	12	10	22	0	1	23	0	0
8	18566466	.	A	T	9	11	20	0	1	21	0	0
8	18566615	.	T	G	15	13	28	0	0	28	0	0
8	18566669	.	C	T	14	22	36	0	0	36	0	0
8	18566687	.	T	C	13	21	34	0	2	36	0	0
8	18566970	.	C	A	20	10	30	0	1	31	0	0
8	18567230	.	G	A	8	13	21	0	6	27	0	0
8	18567453	.	A	G	16	13	29	0	0	29	0	0
8	18567519	.	A	T	8	4	12	2	0	14	0	0
8	18567536	.	T	A	5	3	8	2	0	10	0	0
8	18568167	.	G	T	13	7	20	0	0	20	0	0
8	18568189	.	C	A	12	11	23	0	0	23	0	0
8	18568264	.	T	A	15	6	21	0	0	21	0	0
8	18568350	.	C	G	6	8	14	0	1	15	0	0
8	18568468	.	A	T	12	9	21	0	1	22	0	0
8	18568473	.	T	G	10	10	20	0	0	20	0	0
8	18568527	.	C	T	7	16	23	0	2	25	0	0
8	18568571	.	T	G	10	14	24	0	2	26	0	0
8	18568677	.	C	T	1	11	12	0	12	24	0	0
8	18568687	.	A	G	15	11	26	0	0	26	0	0
8	18568800	.	A	G	20	8	28	0	1	29	0	0
8	18568812	.	C	G	17	5	22	0	0	22	0	0
8	18569592	.	T	G	14	5	19	0	0	19	0	0
8	18569605	.	A	T	15	4	19	0	1	20	0	0
8	18569856	.	T	C	11	8	19	0	0	19	0	0
8	18569871	.	G	A	11	7	18	0	0	18	0	0
8	18570116	.	A	T	11	12	23	0	0	23	0	0
8	18570117	.	C	G	1	10	11	0	11	22	0	0
8	18570190	.	G	C	8	6	14	0	0	14	0	0
8	18570201	.	C	T	8	12	20	0	0	20	0	0
8	18589779	.	C	T	7	3	10	0	0	10	0	0
8	18593094	.	C	T	3	5	8	0	1	9	0	0
8	18593266	.	T	C	3	4	7	0	0	7	0	0
8	18593288	.	T	A	4	4	8	0	0	8	0	0
8	18593353	.	T	C	6	2	8	0	0	8	0	0
8	18593388	.	T	C	3	8	11	0	2	13	0	0
8	18593405	.	G	A	4	5	9	0	2	11	0	0
8	18593465	.	C	T	5	5	10	0	0	10	0	0
8	18598306	.	C	T	8	6	14	0	0	14	0	0
8	18598333	.	A	T	7	9	16	0	1	17	0	0
8	18598391	.	T	A	9	10	19	0	0	19	0	0
8	18598593	.	C	G	11	5	16	0	0	16	0	0
8	18598628	.	A	T	5	12	17	0	3	20	0	0
8	18598915	.	A	G	11	13	24	0	0	24	0	0
8	18598920	.	G	C	11	15	26	0	0	26	0	0
8	18599014	.	G	T	1	8	9	0	12	21	0	0
8	18599088	.	C	A	9	7	16	0	1	17	0	0
8	18599235	.	G	A	8	4	12	0	0	12	0	0
8	18609265	.	A	T	8	6	14	0	0	14	0	0
8	18609272	.	C	A	7	7	14	0	0	14	0	0
8	18609308	.	C	T	7	6	13	0	0	13	0	0
8	18611048	.	G	A	12	5	17	0	0	17	0	0
8	18613661	.	A	T	11	7	18	0	1	19	0	0
8	18633221	.	C	T	9	7	16	0	0	16	0	0
8	18635266	.	G	A	13	4	17	0	0	17	0	0
8	18640339	.	T	C	11	6	17	0	1	18	0	0
8	18640342	.	T	C	11	6	17	0	0	17	0	0
8	18646867	.	T	G	11	13	24	0	0	24	0	0
8	18646894	.	C	T	16	10	26	0	2	28	0	0
8	18647113	.	T	C	14	5	19	0	0	19	0	0
8	18647252	.	A	G	17	9	26	0	1	27	0	0
8	18647357	.	G	T	8	4	12	0	0	12	0	0
8	18837255	.	C	A	5	2	7	0	0	7	0	0
8	18837494	.	C	A	5	9	14	0	3	17	0	0
8	18837533	.	A	G	8	10	18	0	0	18	0	0
8	18837864	.	C	T	8	4	12	0	1	14	1	0
8	18840330	.	C	T	2	11	13	0	0	13	0	0
8	18853540	.	T	C	10	5	15	0	0	15	0	0
8	18885207	.	G	A	6	11	17	0	0	17	0	0
8	18885507	.	G	A	10	6	16	0	0	16	0	0
8	18888742	.	G	A	5	5	10	0	0	10	0	0
8	18888748	.	G	A	6	5	11	0	0	11	0	0
8	18891001	.	G	A	9	6	15	0	0	15	0	0
8	18891033	.	T	A	12	10	22	0	0	22	0	0
8	18893166	.	G	T	9	5	14	0	1	15	0	0
8	18936643	.	A	C	10	4	14	0	0	14	0	0
8	18936665	.	C	T	7	3	10	0	0	10	0	0
8	18936754	.	C	T	8	3	11	0	0	11	0	0
8	18965152	.	A	C	5	7	12	0	1	13	0	0
8	18971535	.	C	T	1	7	8	0	11	19	0	0
8	18977632	.	C	T	13	9	22	0	1	23	0	0
8	18977684	.	A	C	8	0	8	0	13	21	0	0
8	18977710	.	T	G	5	9	14	0	1	15	0	0
8	18982386	.	A	C	12	0	12	0	5	17	0	0
8	19003298	.	T	G	6	5	11	0	0	11	0	0
8	19035280	.	C	T	6	4	10	0	0	10	0	0
8	19232258	.	A	C	3	9	12	0	0	12	0	0
8	19232562	.	T	C	5	2	7	0	0	7	0	0
8	19253718	.	G	A	11	8	19	0	1	20	0	0
8	19258719	.	C	T	1	4	5	0	12	17	0	0
8	19258761	.	G	A	12	5	17	0	3	20	0	0
8	19275288	.	C	G	2	2	4	0	0	4	0	0
8	19284169	.	A	G	1	4	5	0	0	5	0	0
8	19284349	.	T	A	1	2	3	0	0	3	0	0
8	19285193	.	C	T	2	3	5	0	0	5	0	0
8	19285261	.	A	G	2	4	6	0	1	7	0	0
8	19291429	.	T	A	1	4	5	0	1	6	0	0
8	19291435	.	A	C	2	0	2	0	3	5	0	0
8	19300358	.	A	T	1	2	3	0	0	3	0	0
8	19305186	.	C	T	0	4	4	0	2	6	0	0
8	19305213	.	C	T	0	6	6	0	1	7	0	0
8	19308277	.	G	A	1	4	5	0	0	5	0	0
8	19400350	.	A	T	1	1	2	0	1	3	0	0
8	19402136	.	G	T	4	11	15	0	1	16	0	0
8	19402363	.	A	G	17	18	35	0	3	38	0	0
8	19402374	.	C	T	3	23	26	0	16	42	0	0
8	19474072	.	T	C	11	0	11	0	7	18	0	0
8	19476600	.	A	G	11	7	18	0	0	18	0	0
8	19477798	.	C	T	0	10	10	0	12	22	0	0
8	19477928	.	A	G	9	10	19	0	1	20	0	0
8	19478140	.	C	T	10	7	17	0	2	19	0	0
8	19479784	.	A	G	7	3	10	0	0	10	0	0
8	19481909	.	A	G	7	5	12	0	0	12	0	0
8	19481987	.	G	A	4	11	15	0	0	15	0	0
8	19483818	.	G	A	5	7	12	0	0	12	0	0
8	19485951	.	G	C	3	0	3	0	4	7	0	0
8	19489979	.	G	A	3	6	9	0	0	9	0	0
8	19490196	.	T	G	4	0	4	0	8	12	0	0
8	19490204	.	A	G	3	7	10	0	1	11	0	0
8	19490532	.	A	G	2	4	6	0	0	6	0	0
8	19504144	.	A	G	12	15	27	0	0	27	0	0
8	19506793	.	C	T	11	12	23	5	0	28	0	0
8	19508927	.	A	G	22	14	36	0	3	39	0	0
8	19508961	.	C	A	20	20	40	0	3	43	0	0
8	19511480	.	G	A	2	13	15	0	11	26	0	0
8	19512186	.	A	G	4	0	4	0	9	13	0	0
8	19512187	.	C	A	4	7	11	0	2	13	0	0
8	19616033	.	T	G	3	0	3	0	3	6	0	0
8	19616228	.	C	A	2	3	5	0	0	5	0	0
8	19632757	.	G	A	5	3	8	0	0	8	0	0
8	19642555	.	A	T	5	4	9	0	0	9	0	0
8	19642570	.	C	A	5	6	11	0	0	11	0	0
8	19674668	.	C	T	1	2	3	0	0	3	0	0
8	19675481	.	C	A	3	6	9	0	0	9	0	0
8	19676049	.	A	C	3	6	9	0	0	9	0	0
8	19982443	.	A	T	2	2	4	0	0	4	0	0
8	19984995	.	G	C	2	2	4	0	0	4	0	0
8	19990460	.	A	G	1	2	3	0	0	3	0	0
8	19990774	.	A	G	2	3	5	0	0	5	0	0
8	20041185	.	A	G	2	0	2	0	5	7	0	0
8	20053600	.	G	A	3	3	6	0	0	6	0	0
8	20059115	.	T	C	4	6	10	0	0	10	0	0
8	20059302	.	A	C	6	7	13	0	0	13	0	0
8	20059401	.	C	T	7	4	11	0	0	11	0	0
8	20059563	.	C	A	4	7	11	0	0	11	0	0
8	20059860	.	T	A	5	6	11	0	0	11	0	0
8	20062344	.	C	T	7	9	16	0	0	16	0	0
8	20065519	.	T	G	4	1	5	0	9	14	0	0
8	20068125	.	T	C	4	3	7	0	0	7	0	0
8	20068366	.	T	C	7	2	9	0	1	10	0	0
8	20073213	.	T	C	1	2	3	0	0	3	0	0
8	20073580	.	A	T	4	2	6	0	0	6	0	0
8	20073872	.	G	C	4	4	8	0	0	8	0	0
8	20075796	.	A	G	1	3	4	0	0	4	0	0
8	20075808	.	T	G	1	2	3	0	0	3	0	0
8	20077950	.	A	G	2	2	4	0	0	4	0	0
8	20080141	.	A	G	1	2	3	0	1	4	0	0
8	20082877	.	A	G	3	3	6	0	0	6	0	0
8	20157840	.	A	G	19	12	31	0	0	31	0	0
8	20170561	.	C	T	20	10	30	0	3	33	0	0
8	20170672	.	T	C	11	10	21	0	0	21	0	0
8	20170795	.	T	C	19	10	29	0	2	31	0	0
8	20175907	.	A	C	15	15	30	0	4	34	0	0
8	20177126	.	C	G	15	0	15	0	10	25	0	0
8	20183420	.	T	C	12	16	28	0	3	31	0	0
8	20184545	.	A	G	14	14	28	0	4	32	0	0
8	20184698	.	T	C	22	13	35	0	1	36	0	0
8	20185652	.	A	G	21	1	22	0	17	39	0	0
8	20185664	.	A	G	22	1	23	0	17	40	0	0
8	20185694	.	C	T	19	14	33	0	0	33	0	0
8	20185718	.	G	T	24	15	39	0	1	40	0	0
8	20185793	.	G	A	1	15	16	0	14	30	0	0
8	20185796	.	G	C	16	14	30	0	1	31	0	0
8	20187793	.	T	C	19	13	32	0	1	33	0	0
8	20187829	.	A	T	26	9	35	0	2	37	0	0
8	20187835	.	A	G	25	0	25	0	11	36	0	0
8	20190489	.	A	G	20	9	29	0	0	29	0	0
8	20190764	.	G	C	13	14	27	0	0	27	0	0
8	20190790	.	T	C	11	24	35	0	1	36	0	0
8	20190809	.	G	C	11	32	43	0	0	43	0	0
8	20190876	.	A	G	21	13	34	3	2	39	0	0
8	20190967	.	G	A	2	16	18	0	18	36	0	0
8	20191067	.	T	C	12	14	26	0	0	26	0	0
8	20191286	.	A	G	19	0	19	0	20	39	0	0
8	20191301	.	C	A	19	20	39	0	3	42	0	0
8	20191354	.	A	G	19	16	35	0	1	36	0	0
8	20191561	.	A	G	24	15	39	0	1	40	0	0
8	20191651	.	T	C	18	18	36	0	2	38	0	0
8	20191965	.	T	A	18	15	33	0	3	36	0	0
8	20191999	.	C	T	10	11	21	0	0	21	0	0
8	20192046	.	A	G	6	0	6	0	4	10	0	0
8	20192049	.	G	A	7	4	11	0	0	11	0	0
8	20194236	.	C	T	1	4	5	0	0	5	0	0
8	20194246	.	C	T	1	4	5	0	0	5	0	0
8	20194583	.	C	T	7	3	10	0	0	10	0	0
8	20194647	.	T	C	6	6	12	0	0	12	0	0
8	20194787	.	T	C	2	5	7	0	0	7	0	0
8	20195308	.	T	A	1	3	4	0	0	4	0	0
8	20195674	.	T	G	3	3	6	0	1	7	0	0
8	20195688	.	A	G	4	2	6	0	0	6	0	0
8	20196627	.	C	T	2	4	6	0	1	7	0	0
8	20196748	.	A	T	5	2	7	0	0	7	0	0
8	20197237	.	A	G	3	5	8	0	0	8	0	0
8	20197240	.	A	T	3	5	8	0	0	8	0	0
8	20207046	.	A	G	4	3	7	0	0	7	0	0
8	20207147	.	A	C	1	2	3	0	0	3	0	0
8	20207385	.	T	A	2	2	4	0	0	4	0	0
8	20207415	.	C	T	0	2	2	0	3	5	0	0
8	20298465	.	C	A	0	3	3	0	1	4	0	0
8	20298639	.	G	A	1	3	4	0	0	4	0	0
8	20305295	.	G	A	2	4	6	0	0	6	0	0
8	20471391	.	C	T	3	4	7	0	0	7	0	0
8	20471480	.	C	T	5	5	10	0	1	11	0	0
8	20471508	.	T	A	5	4	9	0	0	9	0	0
8	20496037	.	T	C	11	11	22	0	0	22	0	0
8	20503515	.	C	T	7	11	18	0	1	19	0	0
8	20503697	.	A	G	11	7	18	0	0	18	0	0
8	20503829	.	C	T	3	8	11	0	1	12	0	0
8	20546122	.	T	C	17	19	36	0	2	38	0	0
8	20546182	.	T	C	14	10	24	0	4	28	0	0
8	20559241	.	G	A	17	20	37	0	1	38	0	0
8	20853149	.	A	G	12	8	20	0	1	21	0	0
8	20853314	.	A	G	9	15	24	0	0	24	0	0
8	20853335	.	A	T	15	12	27	0	0	27	0	0
8	20853803	.	G	A	9	8	17	0	0	17	0	0
8	20853900	.	G	A	10	11	21	0	1	22	0	0
8	20853951	.	G	C	11	3	14	0	2	16	0	0
8	20856365	.	T	G	17	9	26	0	0	27	1	0
8	20856383	.	G	A	13	8	21	0	1	22	0	0
8	20856505	.	A	G	7	18	25	0	0	25	0	0
8	20856643	.	G	A	16	15	31	0	1	32	0	0
8	20856646	.	C	A	14	14	28	0	4	32	0	0
8	20861582	.	T	C	3	2	5	0	0	5	0	0
8	20861659	.	G	C	2	2	4	0	0	4	0	0
8	20861801	.	G	A	2	4	6	0	1	7	0	0
8	20862385	.	C	A	6	3	9	0	0	9	0	0
8	20863117	.	A	G	12	3	15	0	1	16	0	0
8	20865545	.	A	C	12	5	17	0	5	22	0	0
8	20865557	.	A	T	9	13	22	0	0	22	0	0
8	20868122	.	G	A	12	14	26	0	0	26	0	0
8	20868167	.	T	A	15	10	25	0	1	26	0	0
8	20868191	.	G	A	9	11	20	0	2	22	0	0
8	20868203	.	C	A	7	13	20	0	1	21	0	0
8	20871596	.	A	G	11	8	19	0	0	19	0	0
8	20872987	.	G	T	10	10	20	0	1	21	0	0
8	20873116	.	T	C	15	8	23	0	1	24	0	0
8	21047673	.	G	T	2	4	6	0	0	6	0	0
8	21047824	.	C	A	7	6	13	0	0	13	0	0
8	21048116	.	G	A	2	4	6	0	0	6	0	0
8	21049648	.	G	C	1	2	3	0	0	3	0	0
8	21052672	.	G	A	2	3	5	0	0	5	0	0
8	21052694	.	A	G	3	3	6	0	0	6	0	0
8	21053030	.	G	A	10	9	19	0	0	19	0	0
8	21053084	.	A	T	8	8	16	0	1	17	0	0
8	21053122	.	G	A	8	10	18	0	0	18	0	0
8	21053345	.	T	C	11	1	12	0	7	19	0	0
8	21053371	.	G	A	8	9	17	0	0	17	0	0
8	21053404	.	T	C	2	11	13	0	2	15	0	0
8	21053744	.	G	A	8	8	16	0	0	16	0	0
8	21053754	.	A	G	7	9	16	0	2	18	0	0
8	21068401	.	G	A	3	10	13	2	0	15	0	0
8	21068849	.	C	T	4	5	9	0	0	9	0	0
8	21068865	.	C	T	0	5	5	0	6	11	0	0
8	21071433	.	G	A	12	12	24	0	0	24	0	0
8	21071672	.	T	C	2	0	2	0	15	17	0	0
8	21089923	.	A	T	1	2	3	2	0	5	0	0
8	21095288	.	G	A	7	7	14	0	2	16	0	0
8	21095439	.	G	C	12	9	21	0	0	21	0	0
8	21095504	.	A	C	8	8	16	0	0	16	0	0
8	21099650	.	A	T	1	3	4	2	0	6	0	0
8	21100075	.	G	A	11	6	17	0	0	17	0	0
8	21100096	.	A	G	11	3	14	0	0	14	0	0
8	21101847	.	G	A	13	9	22	1	0	23	0	0
8	21104853	.	G	T	3	4	7	0	0	7	0	0
8	21110074	.	A	G	9	17	26	0	1	27	0	0
8	21110172	.	C	T	9	12	21	0	2	23	0	0
8	21114444	.	C	T	11	9	20	0	0	20	0	0
8	21123607	.	T	C	7	9	16	0	3	19	0	0
8	21130049	.	C	T	10	6	16	0	1	17	0	0
8	21130158	.	G	A	4	9	13	0	0	13	0	0
8	21130910	.	C	T	2	3	5	0	0	5	0	0
8	21131432	.	G	A	4	2	6	0	0	6	0	0
8	21131443	.	G	A	4	2	6	0	0	6	0	0
8	21131996	.	A	G	2	0	2	0	5	7	0	0
8	21132300	.	C	T	12	11	23	1	1	25	0	0
8	21132318	.	G	A	11	15	26	1	0	27	0	0
8	21132538	.	C	G	12	9	21	0	3	24	0	0
8	21132599	.	G	A	1	11	12	0	10	22	0	0
8	21132648	.	T	C	13	11	24	0	0	24	0	0
8	21132696	.	C	T	14	13	27	0	0	27	0	0
8	21134088	.	G	T	18	23	41	0	2	43	0	0
8	21134536	.	T	C	18	25	43	0	1	44	0	0
8	21135606	.	T	C	4	2	6	0	1	7	0	0
8	21137733	.	T	C	1	3	4	0	0	4	0	0
8	21139950	.	C	A	1	4	5	0	6	11	0	0
8	21140121	.	G	C	6	1	7	0	8	15	0	0
8	21140175	.	G	T	5	8	13	0	0	13	0	0
8	21140181	.	G	T	5	10	15	0	0	15	0	0
8	21140286	.	C	T	1	2	3	0	7	10	0	0
8	21140313	.	A	C	6	1	7	0	3	11	1	0
8	21140433	.	G	A	3	6	9	0	0	9	0	0
8	21140862	.	T	C	1	5	6	0	0	6	0	0
8	21140937	.	C	G	3	3	6	0	2	8	0	0
8	21141006	.	G	A	8	6	14	0	2	16	0	0
8	21141055	.	G	C	6	9	15	0	0	15	0	0
8	21141072	.	A	G	4	9	13	0	0	13	0	0
8	21141329	.	G	C	2	0	2	0	5	7	0	0
8	21141330	.	A	G	2	5	7	0	0	7	0	0
8	21141479	.	G	T	9	7	16	0	0	16	0	0
8	21146292	.	C	A	4	4	8	0	0	8	0	0
8	21146324	.	C	T	4	6	10	0	0	10	0	0
8	21146373	.	G	A	0	2	2	0	8	10	0	0
8	21146789	.	C	T	5	5	10	0	0	10	0	0
8	21146936	.	C	T	4	4	8	0	2	10	0	0
8	21148814	.	G	A	5	5	10	0	0	10	0	0
8	21149051	.	G	A	2	4	6	0	0	6	0	0
8	21153088	.	G	T	4	8	12	0	1	13	0	0
8	21153257	.	A	T	8	5	13	0	0	13	0	0
8	21155392	.	T	G	6	5	11	0	0	11	0	0
8	21155439	.	G	A	5	6	11	0	0	11	0	0
8	21155445	.	A	G	5	6	11	0	0	11	0	0
8	21155864	.	A	G	6	11	17	0	0	17	0	0
8	21159168	.	G	T	0	3	3	0	2	5	0	0
8	21159196	.	A	G	7	9	16	0	0	16	0	0
8	21159288	.	A	G	6	13	19	0	0	19	0	0
8	21162056	.	C	T	4	10	14	0	0	14	0	0
8	21162161	.	C	T	6	14	20	0	0	20	0	0
8	21162191	.	C	T	7	13	20	0	0	20	0	0
8	21162284	.	A	G	11	0	11	0	6	17	0	0
8	21162318	.	T	C	13	9	22	0	0	22	0	0
8	21207516	.	C	T	1	2	3	0	0	3	0	0
8	21212897	.	C	T	1	2	3	0	0	3	0	0
8	21225077	.	A	C	2	2	4	0	0	4	0	0
8	21229867	.	T	C	25	20	45	0	0	45	0	0
8	21239835	.	A	C	22	17	39	0	1	40	0	0
8	21240124	.	T	C	19	19	38	0	0	38	0	0
8	21245386	.	A	T	7	3	10	0	0	10	0	0
8	21245422	.	T	C	10	3	13	0	0	13	0	0
8	21245463	.	C	A	2	2	4	0	3	7	0	0
8	21245484	.	T	A	5	2	7	0	0	7	0	0
8	21245803	.	C	T	13	11	24	0	0	24	0	0
8	21248852	.	C	A	30	24	54	0	2	56	0	0
8	21248879	.	G	A	32	27	59	0	0	59	0	0
8	21250132	.	T	A	24	22	46	0	0	46	0	0
8	21250458	.	C	A	13	8	21	0	0	21	0	0
8	21250485	.	C	A	9	10	19	0	1	20	0	0
8	21250553	.	T	C	22	2	24	0	7	31	0	0
8	21250558	.	G	A	11	9	20	0	10	30	0	0
8	21250709	.	C	A	17	25	42	0	0	42	0	0
8	21250897	.	G	A	1	11	12	0	16	28	0	0
8	21250982	.	G	A	20	15	35	0	0	35	0	0
8	21250988	.	C	T	16	15	31	0	3	34	0	0
8	21251241	.	G	A	24	22	46	0	3	49	0	0
8	21251325	.	C	A	25	20	45	0	1	46	0	0
8	21251456	.	T	G	36	17	53	1	0	54	0	0
8	21251623	.	A	G	8	0	8	0	7	15	0	0
8	21251820	.	A	T	16	18	34	0	1	35	0	0
8	21251856	.	G	A	18	12	30	0	1	31	0	0
8	21251993	.	A	C	10	9	19	0	2	21	0	0
8	21252125	.	A	T	23	27	50	0	0	50	0	0
8	21252155	.	T	C	28	24	52	0	1	53	0	0
8	21252215	.	A	T	29	20	49	0	2	51	0	0
8	21252237	.	T	C	31	20	51	0	2	53	0	0
8	21265488	.	C	G	3	2	5	0	0	5	0	0
8	21265536	.	T	C	1	2	3	0	0	3	0	0
8	21265688	.	G	T	4	2	6	0	0	6	0	0
8	21265728	.	C	G	5	7	12	0	0	12	0	0
8	21344337	.	G	A	3	2	5	0	1	6	0	0
8	21368033	.	A	T	2	2	4	0	0	4	0	0
8	21398636	.	G	C	1	5	6	0	0	6	0	0
8	21407066	.	G	A	2	3	5	0	0	5	0	0
8	21408468	.	G	A	4	2	6	0	0	6	0	0
8	21588443	.	G	T	0	11	11	0	10	21	0	0
8	21629342	.	G	C	9	4	13	0	0	13	0	0
8	21629800	.	T	G	15	0	15	0	17	32	0	0
8	21664443	.	C	T	7	14	21	0	1	22	0	0
8	21671568	.	G	A	1	16	17	0	11	28	0	0
8	21671593	.	A	T	11	15	26	0	0	26	0	0
8	21671769	.	G	A	10	7	17	0	0	17	0	0
8	21672085	.	A	C	16	10	26	1	1	28	0	0
8	21672280	.	T	A	9	9	18	0	0	18	0	0
8	21672329	.	T	A	12	11	23	0	0	23	0	0
8	21672605	.	A	G	8	6	14	0	1	15	0	0
8	21672688	.	T	G	10	13	23	0	1	24	0	0
8	21673516	.	G	A	0	15	15	0	18	33	0	0
8	21673629	.	T	G	11	15	26	0	1	27	0	0
8	21673650	.	G	T	17	10	27	0	3	30	0	0
8	21673789	.	T	G	12	0	12	0	14	26	0	0
8	21674080	.	G	T	10	8	18	1	1	20	0	0
8	21674155	.	A	G	11	4	15	0	0	15	0	0
8	21674169	.	A	G	9	0	9	0	6	15	0	0
8	21674499	.	T	C	3	9	12	0	0	12	0	0
8	21674610	.	C	T	7	3	10	0	0	10	0	0
8	21674662	.	T	C	5	5	10	0	0	10	0	0
8	21674795	.	A	C	8	10	18	0	1	19	0	0
8	21674815	.	A	T	9	13	22	0	0	22	0	0
8	21674841	.	A	G	12	0	12	0	16	28	0	0
8	21675000	.	G	A	17	13	30	0	4	34	0	0
8	21675054	.	A	G	23	0	23	0	0	23	0	0
8	21675208	.	T	C	16	9	25	0	0	25	0	0
8	21675745	.	G	A	17	9	26	0	0	26	0	0
8	21675755	.	A	G	7	12	19	0	0	19	0	0
8	21675954	.	A	G	2	0	2	0	5	7	0	0
8	21675992	.	T	A	3	3	6	0	0	6	0	0
8	21982767	.	C	T	3	8	11	0	0	11	0	0
8	21982860	.	T	A	3	7	10	0	1	11	0	0
8	21988698	.	A	G	5	3	8	0	0	8	0	0
8	22014523	.	T	A	3	3	6	0	0	6	0	0
8	22014552	.	C	T	1	5	6	0	0	6	0	0
8	22115469	.	C	G	1	2	3	0	1	4	0	0
8	22273778	.	C	T	1	3	4	0	0	4	0	0
8	22277216	.	T	C	1	2	3	0	0	3	0	0
8	22277346	.	T	C	1	3	4	0	0	4	0	0
8	22283782	.	G	A	1	2	3	0	1	4	0	0
8	22284266	.	C	T	3	6	9	0	0	9	0	0
8	22284316	.	C	T	7	6	13	0	0	13	0	0
8	22284379	.	T	G	8	6	14	0	2	16	0	0
8	22286820	.	G	A	10	9	19	0	0	19	0	0
8	22287063	.	A	C	5	0	5	0	14	19	0	0
8	22290025	.	A	G	3	2	5	0	1	6	0	0
8	22302712	.	C	T	4	3	7	0	0	7	0	0
8	22302716	.	G	A	3	4	7	0	0	7	0	0
8	22307003	.	C	T	5	6	11	0	0	11	0	0
8	22311505	.	T	C	3	0	3	0	4	7	0	0
8	22319173	.	G	A	4	5	9	0	0	9	0	0
8	22319260	.	A	C	2	0	2	0	4	6	0	0
8	22319303	.	A	G	2	8	10	0	0	10	0	0
8	22319331	.	T	G	3	6	9	0	1	10	0	0
8	22320748	.	A	G	8	6	14	0	1	15	0	0
8	22320853	.	C	T	8	3	11	0	0	11	0	0
8	22321217	.	A	G	2	2	4	0	0	4	0	0
8	22321242	.	G	A	1	4	5	0	0	5	0	0
8	22324449	.	T	C	3	5	8	0	0	8	0	0
8	22325928	.	G	A	2	5	7	0	1	8	0	0
8	22345353	.	C	G	3	3	6	0	0	6	0	0
8	22345458	.	T	A	8	3	11	0	0	11	0	0
8	22345517	.	G	A	1	4	5	0	2	7	0	0
8	22345520	.	G	A	2	5	7	0	0	7	0	0
8	22345747	.	A	C	1	6	7	0	0	7	0	0
8	22346508	.	T	C	5	8	13	0	0	13	0	0
8	22359864	.	A	C	1	2	3	0	0	3	0	0
8	22405559	.	T	A	1	3	4	1	0	5	0	0
8	22489113	.	T	G	3	0	3	0	5	8	0	0
8	22489116	.	A	G	3	4	7	0	0	7	0	0
8	22500274	.	C	T	2	7	9	0	4	13	0	0
8	22500293	.	C	T	4	6	10	0	1	11	0	0
8	22500436	.	G	A	5	2	7	0	0	7	0	0
8	22500739	.	G	A	6	8	14	1	0	15	0	0
8	22503494	.	G	T	8	9	17	0	1	18	0	0
8	22503539	.	A	G	4	8	12	0	0	12	0	0
8	22503569	.	A	G	2	10	12	0	0	12	0	0
8	22503725	.	T	G	6	7	13	0	0	13	0	0
8	22503748	.	C	T	6	6	12	0	0	12	0	0
8	22503782	.	C	T	1	4	5	0	8	13	0	0
8	22504329	.	C	G	8	7	15	0	1	16	0	0
8	22504337	.	A	C	9	6	15	0	0	15	0	0
8	22504424	.	T	A	7	4	11	0	0	11	0	0
8	22504463	.	T	A	6	4	10	0	2	12	0	0
8	22511045	.	G	A	1	2	3	0	1	4	0	0
8	22511092	.	A	C	3	2	5	0	0	5	0	0
8	22511252	.	A	T	5	6	11	0	0	11	0	0
8	22511375	.	C	T	6	11	17	0	0	17	0	0
8	22511387	.	G	A	6	10	16	0	1	17	0	0
8	22511518	.	C	T	1	4	5	0	5	10	0	0
8	22511551	.	C	A	4	8	12	0	0	12	0	0
8	22511852	.	G	A	7	3	10	0	2	12	0	0
8	22511945	.	T	G	3	5	8	0	0	8	0	0
8	22512537	.	T	G	3	2	5	0	1	6	0	0
8	22512881	.	G	A	3	3	6	0	1	7	0	0
8	22521792	.	G	C	3	9	12	0	0	12	0	0
8	22522035	.	G	A	18	22	40	3	7	50	0	0
8	22522136	.	A	G	23	16	39	3	1	43	0	0
8	22522385	.	T	C	11	1	12	0	6	18	0	0
8	22522397	.	G	A	6	8	14	0	0	14	0	0
8	22522742	.	T	C	16	15	31	0	2	33	0	0
8	22522744	.	A	G	17	16	33	0	0	33	0	0
8	22523010	.	A	T	26	18	44	0	2	46	0	0
8	22523118	.	G	A	16	24	40	0	1	41	0	0
8	22525228	.	G	A	23	18	41	0	0	41	0	0
8	22525336	.	G	A	20	20	40	0	2	42	0	0
8	22530423	.	T	C	13	17	30	0	1	31	0	0
8	22530633	.	A	G	23	14	37	0	1	38	0	0
8	22544985	.	G	A	4	2	6	0	0	6	0	0
8	22551016	.	T	A	1	5	6	0	0	6	0	0
8	22551311	.	G	A	3	4	7	0	0	7	0	0
8	22554363	.	A	C	4	5	9	0	0	9	0	0
8	22556565	.	C	G	1	3	4	0	0	4	0	0
8	22556630	.	A	G	2	3	5	0	0	5	0	0
8	22558582	.	G	A	2	3	5	0	0	5	0	0
8	22558686	.	T	A	1	2	3	0	0	3	0	0
8	22603951	.	C	T	5	4	9	0	0	9	0	0
8	22604028	.	C	T	4	5	9	0	1	10	0	0
8	22608378	.	C	T	6	5	11	0	0	11	0	0
8	22611837	.	C	T	6	11	17	0	1	18	0	0
8	22612068	.	C	A	9	11	20	0	0	20	0	0
8	22612069	.	C	A	8	10	18	0	1	19	0	0
8	22612158	.	A	C	10	10	20	0	1	21	0	0
8	22612227	.	A	T	9	7	16	0	0	16	0	0
8	22612258	.	G	A	7	9	16	0	0	16	0	0
8	22612328	.	A	G	6	6	12	0	2	14	0	0
8	22612329	.	C	T	7	5	12	0	1	13	0	0
8	22612608	.	T	C	11	9	20	0	0	20	0	0
8	22612638	.	T	C	7	9	16	0	0	16	0	0
8	22612712	.	C	T	6	7	13	0	1	14	0	0
8	22612917	.	T	G	5	5	10	0	1	11	0	0
8	22613136	.	C	T	5	7	12	0	0	12	0	0
8	22613346	.	G	T	7	11	18	0	0	18	0	0
8	22613404	.	T	C	5	2	7	0	4	11	0	0
8	22613419	.	C	A	2	5	7	0	4	11	0	0
8	22613493	.	G	A	3	8	11	0	1	12	0	0
8	22613553	.	A	G	2	6	8	0	2	10	0	0
8	22618864	.	A	G	36	10	46	0	9	55	0	0
8	22619110	.	G	A	26	20	46	0	3	49	0	0
8	22619669	.	G	A	8	19	27	0	9	36	0	0
8	22622632	.	G	C	8	11	19	0	1	20	0	0
8	22622674	.	A	T	17	15	32	0	0	32	0	0
8	22622712	.	C	T	3	15	18	0	12	30	0	0
8	22624324	.	C	A	1	7	8	0	17	25	0	0
8	22631760	.	T	A	14	17	31	0	1	32	0	0
8	22631775	.	T	C	14	12	26	0	6	32	0	0
8	22631865	.	A	G	13	14	27	0	0	27	0	0
8	22631898	.	C	A	0	17	17	0	15	32	0	0
8	22632185	.	G	A	20	17	37	0	1	38	0	0
8	22632213	.	A	G	13	19	32	0	0	32	0	0
8	22632249	.	A	G	11	14	25	0	2	27	0	0
8	22635426	.	T	C	12	1	13	2	13	28	0	0
8	22635807	.	C	T	0	12	12	0	16	28	0	0
8	22637674	.	G	A	19	11	30	0	0	30	0	0
8	22660118	.	A	T	7	5	12	0	2	14	0	0
8	22762339	.	C	T	2	2	4	0	0	4	0	0
8	22762365	.	T	C	3	0	3	0	3	6	0	0
8	22762380	.	C	G	5	4	9	0	0	9	0	0
8	22762442	.	A	G	8	8	16	0	0	16	0	0
8	22766857	.	A	G	11	6	17	0	0	17	0	0
8	22787968	.	C	A	4	4	8	0	0	8	0	0
8	22788116	.	G	A	7	6	13	0	1	14	0	0
8	22788410	.	A	T	2	4	6	0	0	6	0	0
8	22788511	.	A	G	6	9	15	0	0	15	0	0
8	22788541	.	T	G	12	10	22	0	0	22	0	0
8	22788583	.	T	G	12	9	21	0	0	21	0	0
8	22788956	.	A	G	4	7	11	0	0	11	0	0
8	22788971	.	A	G	3	8	11	0	1	12	0	0
8	22788994	.	C	T	8	9	17	0	1	18	0	0
8	22859856	.	A	G	1	2	3	0	0	3	0	0
8	22910089	.	A	C	1	3	4	0	0	4	0	0
8	22922749	.	A	G	2	0	2	0	5	7	0	0
8	22922809	.	A	G	4	0	4	0	4	8	0	0
8	22922845	.	A	G	1	3	4	0	0	4	0	0
8	22926876	.	A	C	1	3	4	0	0	4	0	0
8	22945179	.	G	T	28	38	66	0	0	67	1	0
8	22945572	.	T	C	29	35	64	0	1	65	0	0
8	22945605	.	T	C	34	33	67	0	8	75	0	0
8	22946780	.	T	C	33	23	56	0	1	57	0	0
8	22946987	.	G	C	42	28	70	0	5	75	0	0
8	22947209	.	C	T	38	33	71	0	10	81	0	0
8	22951053	.	G	A	38	24	62	0	1	63	0	0
8	22951054	.	C	G	36	23	59	0	2	61	0	0
8	22951406	.	T	A	25	22	47	2	10	59	0	0
8	22951691	.	A	T	29	16	45	0	3	48	0	0
8	22951847	.	A	T	31	29	60	1	0	61	0	0
8	22951880	.	A	G	31	28	59	0	1	60	0	0
8	22951919	.	C	T	28	36	64	0	3	67	0	0
8	22952243	.	T	A	37	31	68	0	1	69	0	0
8	22952330	.	A	T	35	41	76	0	2	78	0	0
8	22952758	.	G	A	1	2	3	0	7	10	0	0
8	22977364	.	T	A	6	2	8	0	0	8	0	0
8	22977372	.	T	A	5	2	7	0	0	7	0	0
8	22985516	.	G	C	5	4	9	0	0	9	0	0
8	23040902	.	G	A	15	8	23	0	0	23	0	0
8	23040913	.	G	C	15	8	23	0	0	23	0	0
8	23041461	.	C	T	3	9	12	0	20	32	0	0
8	23044374	.	C	G	0	11	11	0	18	29	0	0
8	23044752	.	A	G	16	11	27	0	0	27	0	0
8	23056164	.	T	A	11	6	17	0	1	18	0	0
8	23081314	.	T	C	12	0	12	0	12	24	0	0
8	23101463	.	A	G	4	3	7	0	0	8	1	0
8	23102846	.	C	T	6	8	14	0	0	14	0	0
8	23102951	.	T	A	3	7	10	0	0	10	0	0
8	23103307	.	C	T	10	13	23	0	0	23	0	0
8	23103379	.	T	C	3	4	7	0	0	7	0	0
8	23109443	.	G	A	7	13	20	0	0	20	0	0
8	23109803	.	A	C	5	9	14	0	4	18	0	0
8	23109890	.	T	C	16	8	24	0	3	27	0	0
8	23110301	.	T	A	18	14	32	0	1	33	0	0
8	23110475	.	A	G	14	11	25	0	0	25	0	0
8	23118396	.	A	G	5	11	16	0	0	16	0	0
8	23118830	.	T	C	13	12	25	0	0	25	0	0
8	23119524	.	C	A	18	18	36	0	3	39	0	0
8	23120097	.	G	A	1	2	3	0	0	3	0	0
8	23120102	.	G	A	0	2	2	0	0	2	0	0
8	23122210	.	T	G	3	4	7	0	0	7	0	0
8	23122348	.	A	G	6	10	16	0	1	17	0	0
8	23147528	.	C	T	4	5	9	0	0	9	0	0
8	23147536	.	G	A	4	4	8	0	1	9	0	0
8	23147682	.	C	G	5	7	12	0	0	12	0	0
8	23147794	.	C	T	1	5	6	0	0	6	0	0
8	23149815	.	C	G	12	16	28	0	1	29	0	0
8	23151375	.	C	T	3	9	12	0	3	15	0	0
8	23151428	.	T	A	4	8	12	0	0	12	0	0
8	23177298	.	C	T	18	35	53	0	2	55	0	0
8	23194322	.	A	T	5	6	11	0	3	14	0	0
8	23195394	.	C	T	9	5	14	0	0	14	0	0
8	23202689	.	C	T	9	9	18	0	0	18	0	0
8	23202730	.	T	C	6	11	17	0	0	17	0	0
8	23202757	.	C	T	7	9	16	0	2	18	0	0
8	23206529	.	G	A	1	4	5	0	0	5	0	0
8	23206939	.	C	T	13	7	20	0	1	21	0	0
8	23210432	.	C	T	20	11	31	0	2	33	0	0
8	23210441	.	T	C	21	12	33	0	0	33	0	0
8	23210598	.	G	C	12	4	16	0	1	17	0	0
8	23210767	.	G	A	3	3	6	0	0	6	0	0
8	23210832	.	A	T	13	3	16	0	0	16	0	0
8	23210944	.	T	C	16	7	23	0	0	23	0	0
8	23210955	.	C	T	16	7	23	0	0	23	0	0
8	23211109	.	G	T	9	4	13	0	0	13	0	0
8	23211200	.	G	T	9	7	16	0	0	16	0	0
8	23211615	.	A	G	1	1	2	0	2	4	0	0
8	23211624	.	A	G	1	2	3	0	0	3	0	0
8	23213414	.	C	T	17	6	23	0	0	23	0	0
8	23215631	.	C	T	11	6	17	0	0	17	0	0
8	23215634	.	C	T	11	6	17	0	0	17	0	0
8	23215762	.	T	C	5	7	12	0	1	13	0	0
8	23253068	.	T	A	3	6	9	0	1	10	0	0
8	23253118	.	T	C	6	8	14	0	1	15	0	0
8	23253169	.	T	C	3	6	9	0	0	9	0	0
8	23253200	.	A	G	4	5	9	0	0	9	0	0
8	23253238	.	A	T	2	5	7	0	0	7	0	0
8	23253610	.	G	C	2	3	5	0	0	5	0	0
8	23253843	.	A	G	2	13	15	0	1	16	0	0
8	23253892	.	A	G	4	9	13	0	0	13	0	0
8	23256703	.	C	T	6	7	13	0	0	13	0	0
8	23260866	.	G	A	3	8	11	0	1	12	0	0
8	23261031	.	A	G	4	5	9	0	2	11	0	0
8	23286153	.	G	A	4	6	10	0	0	10	0	0
8	23296377	.	A	G	4	10	14	0	0	14	0	0
8	23364378	.	G	A	1	2	3	0	0	3	0	0
8	23374672	.	T	C	1	2	3	0	0	3	0	0
8	23377767	.	A	C	2	4	6	0	0	6	0	0
8	23380532	.	G	A	3	2	5	0	0	5	0	0
8	23380680	.	G	T	2	2	4	0	0	4	0	0
8	23389781	.	T	A	1	4	5	0	0	5	0	0
8	23390113	.	T	C	4	7	11	0	1	12	0	0
8	23415717	.	A	G	12	7	19	0	1	20	0	0
8	23485480	.	T	C	6	4	10	0	0	10	0	0
8	23544205	.	G	T	3	7	10	0	0	10	0	0
8	23553476	.	A	G	11	7	18	0	1	19	0	0
8	23553749	.	A	C	4	3	7	0	0	7	0	0
8	23567555	.	C	T	0	1	1	0	6	7	0	0
8	23567670	.	T	C	4	2	6	0	1	7	0	0
8	23580239	.	C	T	1	2	3	0	1	4	0	0
8	23580286	.	C	A	1	3	4	0	0	4	0	0
8	23615202	.	T	A	5	4	9	0	0	9	0	0
8	23615206	.	A	T	5	4	9	0	0	9	0	0
8	23615247	.	C	T	7	5	12	0	2	14	0	0
8	23615456	.	C	T	3	3	6	0	1	7	0	0
8	23617372	.	C	T	4	6	10	0	1	11	0	0
8	23620494	.	G	A	17	12	29	0	1	30	0	0
8	23627345	.	G	A	1	2	3	0	8	11	0	0
8	23627371	.	T	C	8	3	11	0	0	11	0	0
8	23627494	.	T	C	11	5	16	0	0	16	0	0
8	23636923	.	C	T	7	5	12	0	0	12	0	0
8	23636973	.	T	G	3	2	5	0	0	5	0	0
8	23637140	.	A	G	5	7	12	0	0	12	0	0
8	23637751	.	T	C	1	2	3	0	0	3	0	0
8	23639163	.	G	A	4	3	7	0	0	7	0	0
8	23639165	.	T	C	5	3	8	0	0	8	0	0
8	23639214	.	T	G	12	12	24	0	0	24	0	0
8	23639298	.	C	A	8	10	18	0	5	23	0	0
8	23639301	.	T	C	8	13	21	0	2	23	0	0
8	23640048	.	A	G	10	0	10	0	6	16	0	0
8	23642117	.	T	C	8	8	16	0	3	19	0	0
8	23644351	.	C	A	8	8	16	0	1	17	0	0
8	23644363	.	T	A	8	7	15	0	1	16	0	0
8	23647323	.	G	C	9	4	13	0	0	13	0	0
8	23647389	.	T	A	8	15	23	0	1	24	0	0
8	23648725	.	G	A	13	11	24	0	1	25	0	0
8	23648753	.	T	C	10	12	22	0	1	23	0	0
8	23651328	.	C	T	8	13	21	0	0	21	0	0
8	23651370	.	C	T	6	11	17	0	1	18	0	0
8	23651397	.	G	A	2	5	7	0	11	18	0	0
8	23655968	.	C	T	5	5	10	0	0	10	0	0
8	23656058	.	G	A	4	4	8	0	0	8	0	0
8	23656125	.	G	T	8	7	15	0	0	15	0	0
8	23656151	.	C	T	10	6	16	0	0	16	0	0
8	23656212	.	A	T	4	10	14	0	0	14	0	0
8	23656321	.	C	A	8	7	15	0	2	17	0	0
8	23666962	.	T	C	10	5	15	0	0	15	0	0
8	23667281	.	T	C	4	8	12	0	0	12	0	0
8	23667290	.	A	G	4	0	4	0	10	14	0	0
8	23667549	.	T	C	3	3	6	0	1	7	0	0
8	23667810	.	T	C	8	7	15	0	0	15	0	0
8	23668371	.	A	T	1	7	8	0	2	10	0	0
8	23668623	.	G	C	10	9	19	0	0	19	0	0
8	23669307	.	T	C	4	5	9	0	0	9	0	0
8	23669451	.	A	G	2	6	8	0	0	8	0	0
8	23669617	.	T	C	13	7	20	0	1	21	0	0
8	23669885	.	G	T	4	13	17	0	0	17	0	0
8	23670019	.	T	C	4	2	6	0	0	6	0	0
8	23670246	.	T	G	2	0	2	0	5	7	0	0
8	23703754	.	C	T	6	3	9	0	0	9	0	0
8	23703775	.	T	A	5	2	7	1	1	9	0	0
8	23711867	.	G	A	4	4	8	0	1	9	0	0
8	23711882	.	C	T	3	4	7	0	0	7	0	0
8	23711985	.	G	A	2	8	10	0	0	10	0	0
8	23712098	.	C	T	4	4	8	0	0	8	0	0
8	23713465	.	G	A	8	3	11	0	1	12	0	0
8	23713578	.	T	C	3	4	7	0	0	7	0	0
8	23724045	.	A	C	6	4	10	0	1	11	0	0
8	23724752	.	A	T	4	3	7	0	0	7	0	0
8	23733221	.	C	T	6	2	8	0	0	8	0	0
8	23733248	.	C	A	5	2	7	0	0	7	0	0
8	23733260	.	C	T	3	2	5	0	0	5	0	0
8	23733413	.	G	A	3	5	8	0	1	9	0	0
8	23733414	.	G	A	4	4	8	0	1	9	0	0
8	23738160	.	C	G	15	10	25	0	0	25	0	0
8	23740148	.	T	C	6	6	12	0	0	12	0	0
8	23740519	.	G	A	35	25	60	0	4	64	0	0
8	23742978	.	G	A	3	4	7	0	2	9	0	0
8	23753566	.	T	A	7	5	12	0	0	12	0	0
8	23753793	.	C	T	0	5	5	0	8	13	0	0
8	23753834	.	C	G	2	9	11	0	2	13	0	0
8	23753934	.	G	A	3	4	7	0	0	7	0	0
8	23756221	.	T	A	9	4	13	0	3	16	0	0
8	23756557	.	G	A	5	12	17	0	1	18	0	0
8	23756680	.	T	A	7	7	14	0	0	14	0	0
8	23760297	.	C	T	0	4	4	0	2	6	0	0
8	23760323	.	G	A	2	4	6	0	0	6	0	0
8	23760703	.	A	T	2	5	7	0	0	7	0	0
8	23763809	.	T	C	3	2	5	0	0	5	0	0
8	23765199	.	T	C	5	7	12	0	1	13	0	0
8	23781194	.	G	A	1	5	6	0	0	6	0	0
8	23781195	.	C	A	1	5	6	0	0	6	0	0
8	23781358	.	G	C	2	3	5	0	0	5	0	0
8	23827610	.	C	T	14	10	24	0	1	25	0	0
8	23827617	.	G	A	13	9	22	0	1	23	0	0
8	23827665	.	A	G	14	0	14	0	3	17	0	0
8	23827670	.	C	T	13	4	17	0	0	17	0	0
8	23857845	.	T	C	14	7	21	0	0	21	0	0
8	23857997	.	G	A	3	7	10	0	2	12	0	0
8	23860641	.	G	T	0	7	7	0	7	14	0	0
8	23865804	.	A	C	10	12	22	0	1	23	0	0
8	23865837	.	A	G	13	11	24	0	1	25	0	0
8	23867417	.	A	G	11	6	17	0	0	17	0	0
8	23868598	.	T	C	15	7	22	0	1	23	0	0
8	23871782	.	C	T	11	16	27	0	0	27	0	0
8	23878905	.	T	A	13	7	20	0	0	20	0	0
8	23878994	.	G	A	18	10	28	0	2	30	0	0
8	23879044	.	T	A	9	7	16	0	1	17	0	0
8	23879238	.	T	A	9	10	19	0	0	19	0	0
8	23879365	.	G	A	15	10	25	0	0	25	0	0
8	23879461	.	C	T	6	3	9	0	0	9	0	0
8	23961168	.	G	T	9	8	17	0	0	17	0	0
8	24063987	.	T	C	4	8	12	0	1	13	0	0
8	24064017	.	G	A	5	5	10	0	0	10	0	0
8	24108749	.	T	G	3	3	6	0	1	7	0	0
8	24109195	.	A	T	6	14	20	0	0	20	0	0
8	24109336	.	A	G	7	9	16	0	1	17	0	0
8	24109399	.	A	G	13	9	22	0	3	25	0	0
8	24109496	.	C	T	1	8	9	0	12	21	0	0
8	24109561	.	C	T	15	3	18	0	0	18	0	0
8	24109562	.	T	C	15	3	18	0	0	18	0	0
8	24109693	.	A	G	12	12	24	0	0	24	0	0
8	24109787	.	C	T	10	8	18	0	1	19	0	0
8	24109879	.	G	A	7	8	15	0	1	16	0	0
8	24110817	.	A	G	9	4	13	0	0	13	0	0
8	24111073	.	A	G	10	10	20	0	0	20	0	0
8	24113519	.	G	C	8	9	17	0	0	17	0	0
8	24120176	.	T	A	4	3	7	1	0	8	0	0
8	24120187	.	A	T	3	3	6	1	0	7	0	0
8	24123072	.	C	T	7	3	10	0	2	12	0	0
8	24123161	.	G	T	5	3	8	0	0	8	0	0
8	24135022	.	G	A	9	6	15	0	1	16	0	0
8	24297664	.	A	G	2	2	4	0	1	5	0	0
8	24297667	.	C	T	1	2	3	0	1	4	0	0
8	24300985	.	C	A	2	3	5	0	0	5	0	0
8	24303878	.	T	C	1	6	7	0	1	8	0	0
8	24303958	.	A	G	2	5	7	0	0	7	0	0
8	24304217	.	T	A	2	4	6	0	0	6	0	0
8	24304419	.	T	C	4	6	10	0	0	10	0	0
8	24304436	.	A	C	5	5	10	0	0	10	0	0
8	24304721	.	C	T	1	2	3	0	0	3	0	0
8	24310463	.	G	T	4	3	7	0	0	7	0	0
8	24310532	.	T	G	4	4	8	0	0	8	0	0
8	24312737	.	T	C	1	3	4	0	0	4	0	0
8	24313399	.	T	C	6	4	10	0	0	10	0	0
8	24314382	.	G	A	0	5	5	0	2	7	0	0
8	24316393	.	T	G	6	0	6	0	6	12	0	0
8	24316484	.	A	G	7	0	7	0	5	12	0	0
8	24316499	.	G	A	6	4	10	0	0	10	0	0
8	24318472	.	G	A	2	5	7	0	0	7	0	0
8	24322223	.	G	A	5	3	8	2	0	10	0	0
8	24322229	.	G	T	5	4	9	0	0	9	0	0
8	24322489	.	T	C	5	5	10	0	1	11	0	0
8	24323336	.	T	C	4	7	11	0	0	11	0	0
8	24325254	.	G	A	10	6	16	0	1	17	0	0
8	24740093	.	T	A	2	8	10	0	0	10	0	0
8	24740094	.	A	C	2	8	10	0	0	10	0	0
8	24740168	.	C	A	11	11	22	0	1	24	1	0
8	24741031	.	A	T	10	8	18	0	0	18	0	0
8	24743676	.	A	T	7	8	15	0	0	15	0	0
8	24743696	.	T	G	5	0	5	0	6	11	0	0
8	24743823	.	C	A	2	5	7	0	0	7	0	0
8	24789324	.	C	T	2	11	13	0	13	26	0	0
8	24789513	.	T	G	15	5	20	0	0	20	0	0
8	24790017	.	G	A	4	11	15	0	0	15	0	0
8	24790139	.	A	G	13	11	24	0	0	24	0	0
8	24790724	.	C	T	11	6	17	0	0	17	0	0
8	24854637	.	G	A	9	13	22	0	0	22	0	0
8	24861530	.	T	C	9	15	24	1	0	25	0	0
8	24870404	.	T	C	14	11	25	1	6	32	0	0
8	24870426	.	C	T	20	10	30	1	3	34	0	0
8	24875117	.	C	G	11	2	13	0	15	28	0	0
8	24880304	.	C	T	20	14	34	0	2	36	0	0
8	24883487	.	T	C	16	20	36	0	2	38	0	0
8	24883577	.	C	T	14	12	26	0	1	27	0	0
8	24883873	.	C	T	15	8	23	0	0	23	0	0
8	24883975	.	A	G	15	9	24	0	2	26	0	0
8	24886194	.	T	C	15	18	33	0	2	35	0	0
8	24886251	.	A	G	11	12	23	0	1	24	0	0
8	24886626	.	T	G	14	12	26	0	0	26	0	0
8	24889230	.	G	A	2	23	25	0	25	50	0	0
8	24889403	.	C	T	20	26	46	0	0	46	0	0
8	24889468	.	C	T	16	17	33	0	1	34	0	0
8	24889482	.	A	T	16	15	31	0	1	32	0	0
8	24889586	.	C	T	15	12	27	0	2	29	0	0
8	24889609	.	T	A	22	12	34	0	0	34	0	0
8	24889674	.	C	T	26	15	41	0	2	43	0	0
8	24890084	.	T	A	20	10	30	5	0	35	0	0
8	24890798	.	C	T	14	6	20	0	1	21	0	0
8	24890891	.	C	T	11	19	30	0	1	31	0	0
8	24938274	.	C	T	7	4	11	0	0	11	0	0
8	24939910	.	A	T	3	3	6	0	0	6	0	0
8	24939940	.	G	A	4	2	6	0	2	8	0	0
8	24940006	.	C	T	6	5	11	0	0	11	0	0
8	24940165	.	C	T	3	4	7	0	0	7	0	0
8	24964775	.	G	A	5	5	10	0	1	11	0	0
8	24964823	.	C	G	0	6	6	0	2	8	0	0
8	24972006	.	T	C	15	14	29	0	1	30	0	0
8	24972594	.	T	C	19	19	38	0	2	40	0	0
8	24972595	.	T	A	20	20	40	0	0	40	0	0
8	24972665	.	T	C	17	13	30	0	3	33	0	0
8	24972743	.	C	T	1	13	14	0	17	31	0	0
8	24972776	.	C	T	2	14	16	0	18	34	0	0
8	24973010	.	T	A	15	18	33	0	1	34	0	0
8	24973116	.	C	G	13	11	24	0	0	24	0	0
8	24973276	.	A	G	15	9	24	0	1	25	0	0
8	24973462	.	A	G	11	7	18	0	0	18	0	0
8	24983245	.	C	G	1	32	33	0	21	54	0	0
8	24985735	.	T	C	19	15	34	0	0	34	0	0
8	24985741	.	G	C	21	16	37	0	0	37	0	0
8	24986965	.	G	A	24	10	34	0	3	37	0	0
8	24991169	.	G	A	14	10	24	1	1	26	0	0
8	25028646	.	A	G	4	4	8	0	1	9	0	0
8	25036367	.	A	T	9	6	15	1	1	17	0	0
8	25036450	.	T	A	7	3	10	0	0	10	0	0
8	25036679	.	T	A	7	6	13	0	0	13	0	0
8	25036694	.	C	G	8	7	15	0	0	15	0	0
8	25039704	.	T	C	9	8	17	0	0	17	0	0
8	25039840	.	T	C	7	4	11	0	1	12	0	0
8	25040479	.	T	C	1	5	6	0	0	6	0	0
8	25040499	.	T	G	1	3	4	0	0	4	0	0
8	25040609	.	A	G	2	2	4	0	0	4	0	0
8	25041986	.	G	A	7	11	18	0	0	18	0	0
8	25042447	.	T	C	11	3	14	0	2	16	0	0
8	25043021	.	A	G	6	3	9	3	1	13	0	0
8	25043112	.	T	G	12	4	16	0	0	16	0	0
8	25044564	.	C	G	1	11	12	0	13	25	0	0
8	25044591	.	C	T	2	6	8	0	14	22	0	0
8	25045766	.	T	C	9	12	21	0	0	21	0	0
8	25055972	.	G	T	10	9	19	0	2	21	0	0
8	25056041	.	T	C	17	0	17	0	10	27	0	0
8	25074028	.	T	C	4	10	14	0	2	16	0	0
8	25074042	.	A	C	8	10	18	0	0	18	0	0
8	25094117	.	A	G	6	0	6	0	5	11	0	0
8	25094247	.	G	A	0	9	9	0	8	17	0	0
8	25094248	.	A	T	7	9	16	0	1	17	0	0
8	25094288	.	C	T	6	4	10	0	1	11	0	0
8	25094489	.	C	G	3	2	5	0	1	6	0	0
8	25097206	.	T	C	2	2	4	0	0	4	0	0
8	25103719	.	T	C	7	8	15	0	0	15	0	0
8	25103731	.	T	C	10	8	18	0	0	18	0	0
8	25103887	.	G	A	4	4	8	0	0	8	0	0
8	25117654	.	T	C	17	12	29	0	2	31	0	0
8	25117981	.	G	A	21	12	33	0	0	33	0	0
8	25117990	.	T	C	18	13	31	0	0	31	0	0
8	25118128	.	C	T	13	13	26	0	1	27	0	0
8	25118608	.	A	T	13	8	21	0	0	21	0	0
8	25176250	.	T	C	11	5	16	0	0	16	0	0
8	25177264	.	G	C	13	8	21	0	1	22	0	0
8	25177501	.	T	G	6	7	13	0	0	13	0	0
8	25190442	.	C	T	4	2	6	0	0	6	0	0
8	25190513	.	C	T	2	2	4	0	0	4	0	0
8	25269942	.	G	A	14	8	22	0	1	23	0	0
8	25269993	.	G	A	10	9	19	0	2	21	0	0
8	25270753	.	G	C	0	7	7	0	11	18	0	0
8	25271550	.	G	A	3	4	7	0	9	16	0	0
8	25272507	.	C	T	9	15	24	0	1	25	0	0
8	25277047	.	G	A	1	14	15	0	23	38	0	0
8	25280807	.	C	T	11	3	14	0	1	15	0	0
8	25280849	.	C	T	4	8	12	0	0	12	0	0
8	25283346	.	T	G	16	1	17	0	12	29	0	0
8	25283768	.	A	G	13	17	30	0	0	30	0	0
8	25283771	.	T	C	13	15	28	0	1	29	0	0
8	25288980	.	T	C	12	13	25	0	0	25	0	0
8	25289180	.	C	T	18	16	34	1	1	36	0	0
8	25291308	.	C	T	19	9	28	0	1	29	0	0
8	25291478	.	A	T	5	7	12	0	0	12	0	0
8	25291573	.	C	A	11	4	15	1	1	17	0	0
8	25291839	.	T	C	17	18	35	0	4	39	0	0
8	25291876	.	A	G	20	20	40	0	1	41	0	0
8	25292020	.	A	T	31	23	54	0	0	54	0	0
8	25292188	.	C	T	9	7	16	0	2	18	0	0
8	25292274	.	G	A	1	9	10	0	15	25	0	0
8	25292330	.	C	T	17	10	27	0	0	27	0	0
8	25292370	.	A	G	12	17	29	0	2	31	0	0
8	25292482	.	T	C	18	18	36	0	1	37	0	0
8	25292492	.	A	T	22	17	39	0	1	40	0	0
8	25292608	.	T	C	29	14	43	0	0	43	0	0
8	25292865	.	G	C	17	15	32	0	0	32	0	0
8	25293008	.	A	G	27	12	39	0	1	40	0	0
8	25293064	.	C	T	9	28	37	0	1	38	0	0
8	25293111	.	G	T	17	18	35	0	2	37	0	0
8	25293145	.	C	T	17	24	41	0	1	42	0	0
8	25293184	.	C	T	21	15	36	0	0	36	0	0
8	25293225	.	T	A	12	12	24	0	1	25	0	0
8	25293346	.	C	T	16	12	28	0	0	28	0	0
8	25295219	.	A	T	6	3	9	0	1	10	0	0
8	25297326	.	A	G	23	1	24	0	27	51	0	0
8	25297617	.	G	C	12	21	33	0	0	33	0	0
8	25297741	.	C	T	10	24	34	0	0	34	0	0
8	25300511	.	C	T	1	5	6	0	0	6	0	0
8	25330065	.	T	A	13	11	24	0	0	24	0	0
8	25330181	.	C	T	10	3	13	0	0	13	0	0
8	25332708	.	C	T	36	37	73	0	2	75	0	0
8	25332900	.	A	G	34	34	68	0	1	69	0	0
8	25332945	.	G	A	31	40	71	0	3	74	0	0
8	25335063	.	G	A	30	29	59	0	1	60	0	0
8	25336097	.	T	A	26	30	56	0	1	57	0	0
8	25336102	.	T	G	25	32	57	0	2	59	0	0
8	25368613	.	G	A	6	6	12	0	1	13	0	0
8	25370776	.	T	C	3	5	8	0	0	8	0	0
8	25397375	.	A	G	3	4	7	0	0	7	0	0
8	25397537	.	A	G	4	2	6	0	0	6	0	0
8	25398628	.	A	T	2	4	6	0	0	6	0	0
8	25399925	.	G	A	2	2	4	0	0	4	0	0
8	25408122	.	G	A	2	3	5	0	0	5	0	0
8	25408134	.	C	T	2	4	6	0	0	6	0	0
8	25424272	.	C	T	6	5	11	0	1	12	0	0
8	25424658	.	G	A	3	5	8	0	0	8	0	0
8	25425311	.	T	C	4	7	11	0	1	12	0	0
8	25425391	.	C	T	5	2	7	0	0	7	0	0
8	25425395	.	G	A	2	5	7	0	0	7	0	0
8	25425749	.	T	C	3	2	5	0	0	5	0	0
8	25426338	.	T	G	4	5	9	0	0	9	0	0
8	25426405	.	G	A	1	2	3	0	0	3	0	0
8	25433771	.	A	G	3	2	5	0	0	5	0	0
8	25438858	.	C	A	0	5	5	0	3	8	0	0
8	25445604	.	C	T	1	4	5	0	5	10	0	0
8	25452003	.	G	A	7	3	10	0	0	10	0	0
8	25452089	.	G	A	3	5	8	0	2	10	0	0
8	25455977	.	C	T	1	3	4	0	4	8	0	0
8	25467852	.	T	C	1	2	3	0	0	3	0	0
8	25497525	.	G	A	1	4	5	0	0	5	0	0
8	25522512	.	G	C	1	1	2	0	1	3	0	0
8	25591038	.	C	A	1	3	4	0	0	4	0	0
8	25659531	.	A	G	1	3	4	0	1	5	0	0
8	25697178	.	T	G	2	4	6	0	0	6	0	0
8	25708263	.	A	G	4	5	9	0	0	9	0	0
8	25708311	.	C	T	5	3	8	0	0	8	0	0
8	25709085	.	T	G	9	10	19	1	1	21	0	0
8	25709694	.	T	G	11	10	21	0	0	21	0	0
8	25712660	.	G	T	16	23	39	0	0	39	0	0
8	25713035	.	T	A	12	9	21	0	1	22	0	0
8	25713053	.	G	A	11	12	23	0	0	23	0	0
8	25714884	.	G	A	6	10	16	0	0	16	0	0
8	25715028	.	T	A	9	12	21	0	2	23	0	0
8	25717075	.	C	T	1	2	3	0	0	3	0	0
8	25717126	.	C	T	1	2	3	0	1	4	0	0
8	25733949	.	T	A	10	7	17	0	0	17	0	0
8	25734814	.	C	A	5	3	8	0	2	10	0	0
8	25745724	.	C	T	21	7	28	0	0	28	0	0
8	25745840	.	C	T	9	9	18	0	1	19	0	0
8	25745877	.	T	A	12	9	21	0	1	22	0	0
8	25746125	.	C	T	7	12	19	0	0	19	0	0
8	25746183	.	G	A	0	6	6	0	8	14	0	0
8	25746213	.	A	G	7	1	8	0	9	17	0	0
8	25746376	.	G	A	7	7	14	0	0	14	0	0
8	25746508	.	A	G	5	8	13	0	0	13	0	0
8	25746535	.	C	A	7	9	16	0	0	16	0	0
8	25746606	.	C	T	5	11	16	0	1	17	0	0
8	25746650	.	T	G	5	8	13	0	0	13	0	0
8	25746684	.	C	T	3	9	12	0	1	13	0	0
8	25746788	.	C	G	5	10	15	0	0	15	0	0
8	25746999	.	G	A	1	11	12	0	7	19	0	0
8	25747028	.	T	A	6	8	14	0	1	15	0	0
8	25747202	.	A	C	10	11	21	1	0	22	0	0
8	25747365	.	T	C	17	13	30	0	1	31	0	0
8	25747644	.	T	G	10	9	19	0	1	20	0	0
8	25747993	.	G	A	0	11	11	0	9	20	0	0
8	25748047	.	G	A	0	15	15	0	7	22	0	0
8	25748147	.	C	T	6	7	13	0	0	13	0	0
8	25748185	.	T	C	15	8	23	0	0	23	0	0
8	25748244	.	G	A	8	7	15	0	1	16	0	0
8	25748283	.	G	T	6	4	10	0	1	11	0	0
8	25748329	.	A	T	9	5	14	0	0	14	0	0
8	25748330	.	T	A	9	4	13	0	1	14	0	0
8	25748562	.	T	A	10	10	20	0	0	20	0	0
8	25748779	.	G	A	3	2	5	0	0	5	0	0
8	25761657	.	A	G	3	0	3	0	2	5	0	0
8	25761791	.	A	T	6	7	13	0	0	13	0	0
8	25761792	.	C	A	6	6	12	0	1	13	0	0
8	25761886	.	T	C	4	11	15	0	0	15	0	0
8	25764192	.	T	C	27	27	54	0	1	55	0	0
8	25765640	.	T	A	6	9	15	0	1	16	0	0
8	25765647	.	G	A	2	5	7	0	9	16	0	0
8	25765788	.	G	A	2	15	17	0	15	32	0	0
8	25765794	.	G	A	14	15	29	0	2	31	0	0
8	25766098	.	G	A	18	10	28	0	0	28	0	0
8	25766131	.	T	C	15	15	30	0	0	30	0	0
8	25766188	.	A	C	8	19	27	0	0	27	0	0
8	25812075	.	T	C	15	6	21	0	1	22	0	0
8	25812113	.	G	A	14	8	22	0	0	22	0	0
8	25812324	.	A	G	21	16	37	0	2	39	0	0
8	25813740	.	A	G	21	21	42	0	0	42	0	0
8	25813904	.	A	G	13	18	31	0	0	31	0	0
8	25813937	.	G	T	20	13	33	0	2	35	0	0
8	25813987	.	G	A	20	17	37	0	1	38	0	0
8	25814003	.	C	T	1	18	19	0	20	39	0	0
8	25816811	.	T	A	18	19	37	0	4	41	0	0
8	25816916	.	G	T	24	16	40	0	0	40	0	0
8	25816917	.	C	G	23	16	39	0	0	39	0	0
8	25819057	.	T	A	12	8	20	0	0	20	0	0
8	25819095	.	A	T	10	8	18	0	0	18	0	0
8	25819196	.	G	A	3	5	8	0	0	8	0	0
8	25819248	.	G	A	3	3	6	0	0	6	0	0
8	25819349	.	A	G	3	9	12	0	0	12	0	0
8	25819430	.	A	T	12	8	20	0	0	20	0	0
8	25819434	.	C	G	13	8	21	0	1	22	0	0
8	25819478	.	G	A	11	10	21	0	1	22	0	0
8	25819548	.	C	G	12	9	21	0	1	22	0	0
8	25821088	.	T	G	14	6	20	0	1	21	0	0
8	25821140	.	G	A	11	11	22	0	0	22	0	0
8	25845780	.	C	T	19	17	36	0	2	38	0	0
8	25845830	.	T	C	18	20	38	0	3	41	0	0
8	25845864	.	A	G	17	20	37	0	2	39	0	0
8	25867198	.	G	A	2	2	4	0	0	4	0	0
8	25867203	.	C	G	2	2	4	0	0	4	0	0
8	25892732	.	C	G	10	0	10	0	9	19	0	0
8	25892736	.	A	C	11	8	19	0	1	20	0	0
8	25892857	.	C	T	9	5	14	0	1	15	0	0
8	25892895	.	T	C	3	4	7	0	1	8	0	0
8	25893173	.	C	A	2	6	8	0	0	8	0	0
8	25893610	.	C	G	6	10	16	0	0	16	0	0
8	25893862	.	C	T	5	5	10	0	1	11	0	0
8	25893937	.	C	T	3	9	12	0	2	14	0	0
8	25894108	.	C	T	10	5	15	0	0	15	0	0
8	25894222	.	G	A	2	7	9	0	8	17	0	0
8	25894300	.	C	T	9	9	18	0	3	21	0	0
8	25897145	.	T	A	15	10	25	0	0	25	0	0
8	25897287	.	C	T	10	6	16	0	0	16	0	0
8	25897489	.	G	A	5	3	8	0	1	9	0	0
8	25897694	.	C	T	2	4	6	0	0	6	0	0
8	25897861	.	G	A	1	5	6	0	0	6	0	0
8	25902319	.	C	T	23	24	47	0	2	49	0	0
8	25905524	.	T	A	18	18	36	0	2	38	0	0
8	25905744	.	T	G	21	15	36	0	2	38	0	0
8	25905919	.	T	C	3	5	8	0	0	8	0	0
8	25913795	.	A	C	3	7	10	0	0	10	0	0
8	25925497	.	G	A	7	3	10	1	0	11	0	0
8	25927472	.	C	T	2	7	9	0	0	9	0	0
8	25927496	.	G	A	1	8	9	0	4	13	0	0
8	25927539	.	C	A	7	5	12	0	0	12	0	0
8	25940273	.	A	G	6	3	9	0	2	11	0	0
8	25944419	.	A	G	8	0	8	0	9	17	0	0
8	25950577	.	G	A	13	12	25	0	2	27	0	0
8	25950707	.	G	C	14	15	29	0	0	29	0	0
8	25950803	.	G	A	3	16	19	0	14	33	0	0
8	25950877	.	C	T	16	23	39	0	0	39	0	0
8	25950999	.	G	A	4	20	24	0	21	45	0	0
8	25951090	.	A	G	17	18	35	0	0	35	0	0
8	25951162	.	G	A	4	14	18	0	10	28	0	0
8	25951194	.	A	T	9	8	17	0	1	18	0	0
8	25951197	.	G	A	9	7	16	0	0	16	0	0
8	25951324	.	A	C	13	4	17	0	1	18	0	0
8	25951366	.	C	T	19	10	29	0	2	31	0	0
8	25951417	.	A	T	21	13	34	0	0	34	0	0
8	25951437	.	A	C	18	13	31	0	0	31	0	0
8	25951473	.	A	T	19	10	29	0	2	31	0	0
8	25951517	.	C	T	17	13	30	0	3	33	0	0
8	25951804	.	A	G	9	4	13	0	0	13	0	0
8	25951806	.	A	T	9	3	12	0	1	13	0	0
8	25963223	.	A	C	15	6	21	0	1	22	0	0
8	25964397	.	A	C	13	15	28	0	0	29	1	0
8	25964398	.	T	C	12	15	27	0	1	28	0	0
8	25964468	.	A	G	8	1	9	0	18	27	0	0
8	25964489	.	A	G	7	1	8	0	25	33	0	0
8	25969833	.	A	G	17	1	18	0	6	24	0	0
8	25969845	.	A	G	19	4	23	0	1	24	0	0
8	25970772	.	A	G	11	8	19	0	1	20	0	0
8	26008088	.	G	A	0	3	3	0	3	6	0	0
8	26008246	.	G	C	1	6	7	0	0	7	0	0
8	26009241	.	C	T	4	3	7	0	0	7	0	0
8	26009290	.	C	T	6	2	8	0	0	8	0	0
8	26019348	.	T	G	3	1	4	0	6	10	0	0
8	26019711	.	A	G	3	2	5	0	1	6	0	0
8	26026772	.	C	T	2	4	6	0	1	7	0	0
8	26026787	.	C	T	5	4	9	0	0	9	0	0
8	26030223	.	C	T	9	6	15	0	0	15	0	0
8	26030226	.	G	A	10	6	16	0	0	16	0	0
8	26030808	.	C	A	3	3	6	0	0	6	0	0
8	26030852	.	A	G	3	5	8	0	0	8	0	0
8	26034654	.	A	G	10	14	24	0	2	26	0	0
8	26038309	.	G	A	16	13	29	0	0	29	0	0
8	26046168	.	G	C	0	14	14	0	12	26	0	0
8	26056935	.	T	C	15	23	38	0	3	41	0	0
8	26056970	.	T	C	16	19	35	0	4	39	0	0
8	26056990	.	T	C	21	22	43	0	3	46	0	0
8	26057014	.	T	C	25	22	47	0	5	52	0	0
8	26057130	.	T	C	27	12	39	0	3	42	0	0
8	26059867	.	T	A	4	3	7	0	0	7	0	0
8	26059897	.	A	T	4	2	6	0	1	7	0	0
8	26066234	.	C	T	6	9	15	0	0	15	0	0
8	26073777	.	G	A	4	4	8	0	0	8	0	0
8	26075413	.	T	C	10	4	14	0	1	15	0	0
8	26075518	.	C	T	4	8	12	0	1	13	0	0
8	26078879	.	T	G	10	3	13	0	0	13	0	0
8	26078898	.	C	A	6	6	12	0	0	12	0	0
8	26091570	.	G	A	8	8	16	0	0	16	0	0
8	26091586	.	G	A	2	4	6	0	6	12	0	0
8	26091845	.	A	G	15	0	15	0	12	27	0	0
8	26091939	.	G	A	1	14	15	0	12	27	0	0
8	26092176	.	T	A	14	6	20	0	2	22	0	0
8	26093660	.	G	A	10	9	19	0	1	20	0	0
8	26097321	.	C	T	24	25	49	0	0	49	0	0
8	26097399	.	T	C	21	17	38	0	2	40	0	0
8	26097744	.	G	T	2	9	11	0	8	19	0	0
8	26097749	.	C	T	8	8	16	0	0	16	0	0
8	26097881	.	T	C	7	4	11	0	1	12	0	0
8	26097966	.	C	T	6	7	13	0	1	14	0	0
8	26126672	.	T	C	1	3	4	0	0	4	0	0
8	26127119	.	A	G	5	2	7	0	1	8	0	0
8	26127179	.	C	A	4	2	6	0	0	6	0	0
8	26166320	.	C	T	4	5	9	0	1	10	0	0
8	26166467	.	T	C	3	4	7	0	0	7	0	0
8	26177197	.	A	G	3	5	8	0	0	8	0	0
8	26179738	.	T	C	2	8	10	0	0	10	0	0
8	26189447	.	T	G	4	2	6	0	2	8	0	0
8	26190452	.	G	A	6	2	8	0	1	9	0	0
8	26192708	.	G	A	0	11	11	0	14	25	0	0
8	26203148	.	C	T	7	3	10	0	0	10	0	0
8	26203553	.	A	G	8	1	9	0	10	19	0	0
8	26205537	.	C	T	6	5	11	0	0	11	0	0
8	26210178	.	G	A	12	9	21	0	1	22	0	0
8	26210523	.	A	T	7	5	12	0	0	12	0	0
8	26230116	.	T	A	5	3	8	0	0	8	0	0
8	26230167	.	G	T	5	3	8	0	0	8	0	0
8	26233192	.	C	T	4	2	6	0	0	6	0	0
8	26233424	.	T	C	4	2	6	0	0	6	0	0
8	26233430	.	G	A	0	2	2	0	4	6	0	0
8	26235195	.	T	C	5	2	7	0	0	7	0	0
8	26235198	.	A	G	5	2	7	0	0	7	0	0
8	26235323	.	T	C	5	2	7	0	0	7	0	0
8	26235471	.	A	G	4	4	8	0	0	8	0	0
8	26235554	.	C	T	12	3	15	0	0	15	0	0
8	26235560	.	T	G	11	4	15	0	0	15	0	0
8	26240047	.	T	G	10	3	13	0	0	13	0	0
8	26240346	.	G	A	1	2	3	0	3	6	0	0
8	26240348	.	A	T	3	2	5	0	0	5	0	0
8	26293930	.	C	T	14	13	27	0	3	30	0	0
8	26317376	.	T	C	18	14	32	0	3	35	0	0
8	26321296	.	C	T	15	19	34	0	0	34	0	0
8	26321359	.	G	A	17	18	35	0	1	36	0	0
8	26323458	.	A	T	17	15	32	0	1	33	0	0
8	26323511	.	T	A	16	7	23	0	1	24	0	0
8	26324575	.	G	C	7	6	13	0	1	14	0	0
8	26324584	.	A	T	8	6	14	0	0	14	0	0
8	26324620	.	C	T	11	11	22	0	0	22	0	0
8	26324691	.	C	A	8	5	13	0	1	15	1	0
8	26324773	.	T	C	7	9	16	0	0	16	0	0
8	26324905	.	A	G	14	9	23	0	1	24	0	0
8	26325332	.	T	A	28	20	48	0	1	49	0	0
8	26325333	.	A	T	27	20	47	0	1	48	0	0
8	26325680	.	G	A	2	16	18	0	23	41	0	0
8	26325888	.	G	A	2	23	25	0	15	40	0	0
8	26330006	.	G	A	17	13	30	0	0	30	0	0
8	26330190	.	T	C	8	22	30	0	0	30	0	0
8	26330352	.	T	A	7	12	19	0	3	22	0	0
8	26330545	.	C	T	16	10	26	0	0	26	0	0
8	26330666	.	T	C	15	10	25	0	2	27	0	0
8	26357826	.	A	G	19	18	37	0	1	38	0	0
8	26360974	.	G	T	15	14	29	0	1	30	0	0
8	26361294	.	G	A	15	15	30	0	2	32	0	0
8	26367891	.	T	G	24	19	43	0	2	45	0	0
8	26368019	.	C	T	22	22	44	3	2	49	0	0
8	26368025	.	C	T	28	18	46	3	1	50	0	0
8	26368171	.	T	C	30	28	58	1	1	60	0	0
8	26368356	.	G	A	1	15	16	0	11	27	0	0
8	26369055	.	C	T	0	4	4	0	1	5	0	0
8	26376818	.	A	T	1	1	2	0	1	3	0	0
8	26386608	.	T	C	1	1	2	0	3	5	0	0
8	26387889	.	A	G	2	2	4	0	0	4	0	0
8	26396707	.	A	C	1	2	3	0	0	3	0	0
8	26410472	.	G	C	10	5	15	0	0	15	0	0
8	26417276	.	C	T	3	3	6	0	0	6	0	0
8	26426163	.	T	C	9	11	20	0	0	20	0	0
8	26426478	.	G	A	9	10	19	0	1	20	0	0
8	26426487	.	G	A	11	7	18	0	0	18	0	0
8	26426596	.	T	G	5	5	10	0	1	11	0	0
8	26426771	.	C	T	7	5	12	0	0	12	0	0
8	26427081	.	C	T	10	3	13	0	1	14	0	0
8	26427137	.	A	T	6	4	10	0	0	10	0	0
8	26432701	.	C	T	5	4	9	0	0	9	0	0
8	26432720	.	A	T	4	4	8	0	0	8	0	0
8	26433541	.	T	C	6	3	9	0	0	9	0	0
8	26433849	.	A	G	4	6	10	0	0	10	0	0
8	26435187	.	G	A	3	3	6	0	3	9	0	0
8	26436664	.	C	T	6	4	10	0	1	11	0	0
8	26444701	.	T	C	4	2	6	0	0	6	0	0
8	26444741	.	T	C	4	2	6	0	0	6	0	0
8	26444877	.	C	T	3	4	7	0	1	8	0	0
8	26444892	.	T	A	4	2	6	0	1	7	0	0
8	26445037	.	T	C	7	7	14	0	0	14	0	0
8	26445119	.	A	G	4	8	12	0	0	12	0	0
8	26445166	.	G	A	1	9	10	0	6	16	0	0
8	26449319	.	C	A	5	2	7	0	0	7	0	0
8	26449667	.	C	G	2	2	4	0	0	4	0	0
8	26522190	.	T	C	2	4	6	0	0	6	0	0
8	26522260	.	C	G	1	5	6	0	0	6	0	0
8	26561087	.	T	C	1	7	8	0	1	9	0	0
8	26565265	.	T	G	5	0	5	0	5	10	0	0
8	26565293	.	A	C	7	4	11	0	2	13	0	0
8	26565503	.	C	A	3	3	6	0	0	6	0	0
8	26571179	.	C	G	3	3	6	0	0	6	0	0
8	26571193	.	G	T	4	3	7	0	1	8	0	0
8	26572845	.	G	A	0	2	2	0	3	5	0	0
8	26572943	.	T	C	2	3	5	0	0	5	0	0
8	26573009	.	T	C	4	8	12	0	2	14	0	0
8	26573030	.	G	A	3	7	10	0	7	17	0	0
8	26573243	.	T	C	2	2	4	0	0	4	0	0
8	26573275	.	A	C	2	3	5	0	0	5	0	0
8	26573365	.	T	C	4	4	8	0	0	8	0	0
8	26573454	.	G	A	0	8	8	0	4	12	0	0
8	26573519	.	T	C	6	6	12	0	0	12	0	0
8	26573622	.	G	A	3	4	7	0	0	7	0	0
8	26586558	.	G	A	13	11	24	0	0	24	0	0
8	26586634	.	A	C	9	10	19	0	1	20	0	0
8	26586900	.	G	T	13	17	30	0	1	31	0	0
8	26587137	.	C	G	10	5	15	0	0	15	0	0
8	26587164	.	G	A	8	6	14	0	0	14	0	0
8	26587323	.	G	A	11	8	19	0	0	19	0	0
8	26587380	.	G	A	9	10	19	0	0	19	0	0
8	26587447	.	C	T	0	6	6	0	12	18	0	0
8	26589400	.	A	G	8	8	16	3	0	19	0	0
8	26591336	.	G	A	3	2	5	0	0	5	0	0
8	26607064	.	A	C	1	0	1	0	2	3	0	0
8	26609109	.	T	C	2	4	6	0	0	6	0	0
8	26609170	.	C	G	6	7	13	0	0	13	0	0
8	26702033	.	C	T	1	3	4	0	1	5	0	0
8	26709876	.	A	T	8	4	12	0	0	12	0	0
8	26709940	.	C	T	5	4	9	0	1	10	0	0
8	26714641	.	G	T	1	2	3	0	0	3	0	0
8	26716404	.	C	T	4	3	7	0	0	7	0	0
8	26731764	.	A	C	12	11	23	0	1	24	0	0
8	26731866	.	T	G	14	4	18	0	0	18	0	0
8	26746173	.	C	T	16	7	23	1	0	24	0	0
8	26792738	.	T	A	9	5	14	0	1	15	0	0
8	26792849	.	A	G	20	6	26	0	0	26	0	0
8	26830994	.	T	A	1	2	3	0	0	3	0	0
8	26838478	.	T	G	2	0	2	0	4	6	0	0
8	26838547	.	C	T	4	6	10	0	0	10	0	0
8	26860061	.	C	A	17	5	22	0	0	22	0	0
8	26860064	.	A	T	16	5	21	0	2	23	0	0
8	26860307	.	A	G	11	8	19	0	1	20	0	0
8	26860359	.	G	T	9	9	18	0	1	19	0	0
8	26860430	.	C	T	5	13	18	0	0	18	0	0
8	26860493	.	A	C	7	10	17	0	1	18	0	0
8	26860511	.	T	C	11	9	20	0	2	22	0	0
8	26860600	.	G	T	8	9	17	0	0	17	0	0
8	26860778	.	T	C	6	5	11	0	0	11	0	0
8	26860779	.	G	A	6	5	11	0	0	11	0	0
8	26860909	.	T	C	7	9	16	0	1	17	0	0
8	26861145	.	A	G	14	16	30	0	2	32	0	0
8	26861248	.	G	T	17	13	30	0	0	30	0	0
8	26861434	.	G	A	11	9	20	0	0	20	0	0
8	26861653	.	T	C	7	9	16	0	0	16	0	0
8	26861760	.	C	A	6	9	15	0	3	18	0	0
8	26862002	.	A	C	17	16	33	0	1	34	0	0
8	26862526	.	C	A	12	13	25	0	0	25	0	0
8	26863804	.	C	A	13	13	26	0	1	27	0	0
8	26864121	.	A	G	14	11	25	0	0	25	0	0
8	26864150	.	G	C	14	8	22	0	1	23	0	0
8	26864195	.	G	C	12	12	24	0	2	26	0	0
8	26868418	.	T	C	17	20	37	1	1	39	0	0
8	26881205	.	T	G	26	1	27	0	26	54	1	0
8	26884298	.	T	C	26	18	44	0	2	47	1	0
8	26884313	.	A	G	22	26	48	0	1	49	0	0
8	26884619	.	C	T	29	34	63	0	3	66	0	0
8	26884767	.	C	T	21	35	56	0	0	56	0	0
8	26884903	.	T	A	14	24	38	0	1	39	0	0
8	26885382	.	C	A	26	23	49	0	2	51	0	0
8	26886025	.	C	T	24	16	40	0	1	41	0	0
8	26886177	.	T	C	17	27	44	0	1	45	0	0
8	26886259	.	A	G	19	21	40	0	1	42	1	0
8	26886399	.	C	G	30	15	45	0	0	45	0	0
8	26886667	.	T	A	34	24	58	0	3	62	1	0
8	26886766	.	T	C	23	22	45	0	4	49	0	0
8	26886972	.	A	T	16	23	39	0	0	39	0	0
8	26887013	.	T	C	14	20	34	0	0	34	0	0
8	26887122	.	A	C	17	11	28	0	0	28	0	0
8	26887240	.	G	A	3	5	8	0	3	11	0	0
8	26925889	.	T	A	1	2	3	0	0	3	0	0
8	27361846	.	G	A	9	6	15	0	0	15	0	0
8	27362288	.	C	G	7	9	16	0	0	16	0	0
8	27515239	.	T	C	10	8	18	0	0	18	0	0
8	27623973	.	A	G	25	3	28	0	11	39	0	0
8	27624026	.	T	A	30	14	44	0	0	44	0	0
8	27624027	.	T	C	27	14	41	0	3	44	0	0
8	27813611	.	C	A	27	13	40	0	1	42	1	0
8	27816560	.	C	A	22	28	50	0	7	57	0	0
8	27816680	.	C	T	14	19	33	0	2	35	0	0
8	27858407	.	C	T	1	2	3	0	0	3	0	0
8	28066077	.	T	A	9	8	17	0	0	17	0	0
8	28066167	.	G	A	11	10	21	0	1	22	0	0
8	28066168	.	C	A	11	10	21	0	1	22	0	0
8	28066291	.	G	T	0	11	11	0	10	21	0	0
8	28224987	.	G	A	15	16	31	0	1	32	0	0
8	28229971	.	C	T	16	15	31	0	3	34	0	0
8	28232496	.	G	A	11	7	18	0	1	19	0	0
8	28232512	.	G	T	8	9	17	0	1	18	0	0
8	28232557	.	T	A	14	9	23	0	3	26	0	0
8	28232745	.	G	T	20	11	31	0	1	32	0	0
8	28232812	.	G	T	12	13	25	0	0	30	5	0
8	28243579	.	C	T	4	6	10	0	0	10	0	0
8	28243707	.	C	G	3	3	6	0	0	6	0	0
8	28243830	.	T	G	5	3	8	0	0	8	0	0
8	28244063	.	C	T	3	3	6	0	0	6	0	0
8	28244076	.	C	T	3	3	6	0	0	6	0	0
8	28244116	.	G	A	6	5	11	0	0	11	0	0
8	28244193	.	G	A	6	5	11	0	0	11	0	0
8	28244267	.	C	A	3	3	6	0	0	6	0	0
8	28248692	.	G	T	5	3	8	0	0	8	0	0
8	28251839	.	C	T	4	2	6	0	0	6	0	0
8	28256577	.	T	C	3	4	7	0	0	7	0	0
8	28256649	.	A	C	5	0	5	0	6	11	0	0
8	28268062	.	G	T	1	4	5	0	0	5	0	0
8	28313256	.	G	A	18	17	35	0	1	36	0	0
8	28315258	.	A	G	12	17	29	0	0	29	0	0
8	28315301	.	T	C	13	0	13	0	20	33	0	0
8	28315378	.	A	G	8	15	23	0	1	24	0	0
8	28315424	.	C	G	11	15	26	0	0	26	0	0
8	28315436	.	G	T	8	14	22	0	0	22	0	0
8	28315481	.	A	G	6	20	26	0	0	26	0	0
8	28315694	.	A	G	7	11	18	0	2	20	0	0
8	28315699	.	A	G	9	9	18	0	1	19	0	0
8	28317748	.	A	T	11	11	22	0	0	22	0	0
8	28323403	.	C	A	1	12	13	0	14	27	0	0
8	28323442	.	A	G	16	11	27	0	0	27	0	0
8	28346143	.	A	G	2	2	4	0	0	4	0	0
8	28346146	.	C	T	2	3	5	0	0	5	0	0
8	28346284	.	G	A	4	7	11	0	0	11	0	0
8	28346569	.	A	G	8	9	17	0	2	19	0	0
8	28346656	.	A	G	5	12	17	0	0	17	0	0
8	28346659	.	G	C	5	11	16	0	0	17	1	0
8	28346701	.	A	C	5	8	13	0	0	13	0	0
8	28351147	.	T	A	6	3	9	0	0	9	0	0
8	28351678	.	T	C	6	8	14	0	1	15	0	0
8	28351679	.	C	T	6	9	15	0	0	15	0	0
8	28356317	.	A	G	5	11	16	0	0	16	0	0
8	28358501	.	C	A	9	13	22	0	1	23	0	0
8	28359559	.	T	C	10	14	24	0	1	25	0	0
8	28364854	.	G	A	3	12	15	0	17	32	0	0
8	28364923	.	T	A	8	24	32	0	0	32	0	0
8	28365119	.	C	T	6	10	16	0	0	16	0	0
8	28365328	.	A	T	8	7	15	0	0	15	0	0
8	28365361	.	C	T	7	7	14	0	0	14	0	0
8	28365479	.	C	T	2	4	6	0	0	6	0	0
8	28379249	.	G	A	0	5	5	0	5	10	0	0
8	28379375	.	T	A	6	4	10	0	0	10	0	0
8	28383189	.	G	A	5	7	12	0	0	12	0	0
8	28399129	.	G	A	5	8	13	0	0	13	0	0
8	28399297	.	T	A	3	4	7	0	0	7	0	0
8	28399580	.	T	A	7	7	14	0	0	14	0	0
8	28399625	.	A	C	7	12	19	0	0	19	0	0
8	28399672	.	A	G	7	10	17	0	1	18	0	0
8	28400338	.	G	T	3	11	14	0	0	14	0	0
8	28401003	.	C	A	7	8	15	0	2	17	0	0
8	28404364	.	C	T	3	3	6	0	0	6	0	0
8	28406442	.	T	A	2	2	4	0	2	6	0	0
8	28406481	.	G	A	3	5	8	0	0	8	0	0
8	28406502	.	G	A	3	2	5	0	2	7	0	0
8	28449176	.	A	G	6	5	11	0	0	11	0	0
8	28457220	.	C	T	6	5	11	0	0	11	0	0
8	28463137	.	C	T	6	5	11	0	0	11	0	0
8	28463373	.	A	T	2	4	6	0	0	6	0	0
8	28463551	.	T	G	2	0	2	0	7	9	0	0
8	28463587	.	T	C	2	4	6	0	0	6	0	0
8	28463785	.	A	T	4	5	9	0	1	10	0	0
8	28464556	.	C	T	5	3	8	0	0	8	0	0
8	28465184	.	G	A	3	4	7	0	1	8	0	0
8	28527921	.	G	A	0	3	3	0	10	13	0	0
8	28528277	.	A	T	11	9	20	0	3	23	0	0
8	28532304	.	C	T	10	16	26	0	0	26	0	0
8	28532490	.	C	T	9	15	24	0	0	24	0	0
8	28532715	.	C	T	8	15	23	0	0	23	0	0
8	28594221	.	G	A	3	2	5	0	1	6	0	0
8	28594395	.	C	T	2	7	9	0	0	9	0	0
8	28654571	.	G	A	3	2	5	0	1	6	0	0
8	28654619	.	A	G	1	3	4	0	0	4	0	0
8	28724810	.	C	T	5	4	9	0	0	9	0	0
8	28726907	.	C	G	4	7	11	0	0	11	0	0
8	28726914	.	G	A	7	4	11	0	0	11	0	0
8	28727168	.	T	C	2	2	4	0	0	4	0	0
8	28727282	.	T	A	2	3	5	0	0	5	0	0
8	28727396	.	A	G	0	4	4	0	1	5	0	0
8	28727546	.	G	T	0	5	5	0	4	9	0	0
8	28727828	.	G	T	3	3	6	0	0	6	0	0
8	28727972	.	A	G	4	0	4	0	4	8	0	0
8	28868425	.	G	A	8	8	16	0	1	17	0	0
8	28900870	.	G	T	1	8	9	0	11	20	0	0
8	28901170	.	C	A	7	10	17	0	1	18	0	0
8	28982606	.	G	A	12	16	28	0	1	29	0	0
8	29267122	.	A	C	20	15	35	2	1	38	0	0
8	29267218	.	C	T	19	18	37	0	0	37	0	0
8	29267269	.	T	C	20	8	28	0	3	31	0	0
8	29285661	.	C	T	22	17	39	0	0	39	0	0
8	29427918	.	G	A	4	15	19	1	11	31	0	0
8	29428042	.	C	A	13	22	35	0	2	37	0	0
8	29574985	.	C	A	24	19	43	0	0	43	0	0
8	29587232	.	C	T	21	18	39	0	0	39	0	0
8	29587262	.	C	A	20	18	38	0	1	39	0	0
8	29587500	.	C	A	17	15	32	0	1	34	1	0
8	29587651	.	C	T	14	12	26	0	3	29	0	0
8	29636170	.	A	G	4	0	4	0	5	9	0	0
8	29636210	.	A	G	4	0	4	0	4	8	0	0
8	29636980	.	C	T	1	5	6	0	0	6	0	0
8	29637189	.	T	G	5	2	7	0	0	7	0	0
8	29640595	.	G	A	0	3	3	0	5	8	0	0
8	29644791	.	G	A	4	2	6	0	0	6	0	0
8	29710722	.	G	A	5	4	9	0	0	9	0	0
8	29710752	.	C	T	2	6	8	0	0	8	0	0
8	29710891	.	C	T	2	2	4	0	0	4	0	0
8	29719306	.	C	T	2	2	4	0	0	4	0	0
8	29749265	.	G	A	6	2	8	0	0	8	0	0
8	29758468	.	T	C	9	5	14	0	0	14	0	0
8	29758522	.	G	A	1	7	8	1	8	17	0	0
8	29759705	.	C	T	4	6	10	0	0	10	0	0
8	29760924	.	C	A	5	7	12	0	0	12	0	0
8	29763390	.	G	C	7	8	15	0	0	15	0	0
8	29763480	.	C	T	3	9	12	0	0	12	0	0
8	29763633	.	C	G	7	0	7	0	4	11	0	0
8	29763822	.	A	G	13	0	13	0	6	19	0	0
8	29764695	.	G	T	2	3	5	0	0	5	0	0
8	29764761	.	T	C	2	2	4	0	0	4	0	0
8	29764968	.	T	C	9	4	13	0	1	14	0	0
8	29765178	.	C	T	3	4	7	0	0	7	0	0
8	29765264	.	A	C	3	2	5	0	0	5	0	0
8	29765395	.	G	C	2	4	6	0	0	6	0	0
8	29765413	.	T	C	2	4	6	0	1	7	0	0
8	29766164	.	G	A	1	8	9	0	0	9	0	0
8	29766204	.	G	A	1	7	8	0	2	10	0	0
8	29766576	.	G	T	1	4	5	0	0	5	0	0
8	29770185	.	C	T	14	7	21	0	0	21	0	0
8	29770207	.	G	A	21	12	33	0	0	33	0	0
8	29770371	.	T	A	38	19	57	0	2	59	0	0
8	29770511	.	C	T	24	34	58	0	1	59	0	0
8	29770775	.	A	T	20	26	46	0	1	47	0	0
8	29771053	.	A	G	18	19	37	0	1	38	0	0
8	29771173	.	G	A	21	9	30	0	2	32	0	0
8	29771336	.	T	C	9	0	9	0	9	18	0	0
8	29771516	.	C	A	4	3	7	0	0	7	0	0
8	29771718	.	T	C	1	2	3	0	1	4	0	0
8	29771938	.	C	T	0	2	2	0	8	10	0	0
8	29772309	.	A	G	14	11	25	2	3	30	0	0
8	29772349	.	G	C	0	0	0	3	2	15	10	0
8	29772910	.	G	T	7	7	14	0	0	14	0	0
8	29772933	.	C	T	2	10	12	0	10	22	0	0
8	29773127	.	T	A	16	13	29	0	0	29	0	0
8	29773329	.	C	A	13	11	24	0	0	24	0	0
8	29774258	.	C	T	20	21	41	0	2	43	0	0
8	29774263	.	C	A	19	23	42	0	1	43	0	0
8	29774309	.	A	T	15	16	31	0	4	35	0	0
8	29774428	.	T	A	16	14	30	0	0	30	0	0
8	29774528	.	C	T	1	19	20	0	16	36	0	0
8	29774747	.	A	T	5	4	9	0	1	10	0	0
8	29774827	.	C	T	2	11	13	0	13	26	0	0
8	29775340	.	A	T	16	14	30	0	0	30	0	0
8	29775342	.	T	A	17	14	31	0	0	31	0	0
8	29787265	.	C	T	2	10	12	0	13	25	0	0
8	29793782	.	A	G	12	11	23	0	1	24	0	0
8	29799168	.	C	T	1	20	21	0	17	38	0	0
8	29799360	.	G	A	17	6	23	0	1	24	0	0
8	29799627	.	G	A	21	17	38	0	1	39	0	0
8	29801150	.	C	G	20	18	38	0	0	38	0	0
8	29801291	.	C	T	18	12	30	0	0	30	0	0
8	29819317	.	G	A	13	5	18	0	0	18	0	0
8	29819431	.	G	A	10	7	17	0	0	17	0	0
8	29819581	.	A	G	4	13	17	0	2	19	0	0
8	29819729	.	G	T	13	12	25	0	2	27	0	0
8	29822022	.	A	C	1	0	1	0	2	3	0	0
8	29865886	.	C	T	2	2	4	0	0	4	0	0
8	29871800	.	T	C	3	2	5	0	0	5	0	0
8	29899117	.	G	A	6	2	8	0	0	8	0	0
8	29899373	.	G	A	5	4	9	0	1	10	0	0
8	29904949	.	G	T	2	2	4	0	0	4	0	0
8	29907764	.	C	T	2	1	3	0	1	4	0	0
8	29914361	.	C	T	2	2	4	0	0	4	0	0
8	29925713	.	G	A	1	4	5	0	0	5	0	0
8	29926484	.	C	T	1	5	6	0	0	6	0	0
8	29926972	.	A	T	2	5	7	0	0	7	0	0
8	29926989	.	A	G	1	5	6	0	0	6	0	0
8	29930690	.	G	A	7	4	11	0	0	11	0	0
8	29986293	.	G	A	1	5	6	0	0	6	0	0
8	30016948	.	C	T	4	4	8	0	0	8	0	0
8	30021416	.	A	G	4	0	4	0	4	8	0	0
8	30021816	.	G	A	0	2	2	0	2	4	0	0
8	30022126	.	G	C	1	2	3	0	0	3	0	0
8	30025143	.	T	A	2	2	4	0	0	4	0	0
8	30025145	.	G	A	0	2	2	0	2	4	0	0
8	30038883	.	G	A	6	2	8	0	1	9	0	0
8	30047585	.	G	A	1	4	5	0	0	5	0	0
8	30047586	.	C	T	1	4	5	0	0	5	0	0
8	30062679	.	A	G	6	3	9	0	0	9	0	0
8	30063320	.	T	C	2	8	10	0	1	11	0	0
8	30159420	.	C	T	6	3	9	0	0	9	0	0
8	30159560	.	A	C	5	0	5	0	14	19	0	0
8	30284187	.	A	C	1	0	1	0	2	3	0	0
8	30330667	.	C	T	3	4	7	0	0	7	0	0
8	30340681	.	G	A	1	4	5	0	0	5	0	0
8	30358354	.	G	A	4	2	6	0	0	6	0	0
8	30359873	.	C	A	1	7	8	0	0	8	0	0
8	30368320	.	G	T	5	2	7	0	0	7	0	0
8	30426211	.	C	A	6	13	19	0	1	20	0	0
8	30449074	.	G	A	7	5	12	0	0	12	0	0
8	30501584	.	A	C	3	2	5	0	0	5	0	0
8	30501601	.	T	A	3	2	5	0	0	5	0	0
8	30501850	.	T	C	3	2	5	0	0	5	0	0
8	30502138	.	G	A	1	3	4	0	5	9	0	0
8	30546140	.	C	T	4	8	12	0	1	13	0	0
8	30560867	.	C	T	3	8	11	0	0	11	0	0
8	30570175	.	T	C	3	4	7	0	0	7	0	0
8	30570193	.	G	A	0	4	4	0	0	5	1	0
8	30575850	.	G	A	7	5	12	0	0	12	0	0
8	30585283	.	C	T	9	6	15	0	0	15	0	0
8	30591991	.	G	T	3	4	7	0	0	7	0	0
8	30593567	.	G	A	7	4	11	0	1	12	0	0
8	30600565	.	C	T	4	12	16	0	2	18	0	0
8	30600606	.	T	A	10	15	25	0	1	26	0	0
8	30623106	.	T	C	6	3	9	0	0	9	0	0
8	30623379	.	G	A	6	5	11	0	2	13	0	0
8	30624247	.	G	A	4	14	18	0	0	18	0	0
8	30631057	.	C	T	7	4	11	0	0	11	0	0
8	30661270	.	C	T	4	12	16	0	1	17	0	0
8	30661565	.	A	G	8	0	8	0	11	19	0	0
8	30661645	.	G	A	6	12	18	0	0	18	0	0
8	30661762	.	A	G	1	0	1	0	7	8	0	0
8	30662343	.	G	C	2	3	5	0	0	5	0	0
8	30662488	.	T	A	11	6	17	0	0	17	0	0
8	30662505	.	A	T	7	9	16	0	0	16	0	0
8	30662627	.	A	T	2	3	5	0	0	5	0	0
8	30730983	.	A	C	6	5	11	0	0	12	1	0
8	30731178	.	G	A	6	4	10	0	0	11	1	0
8	30731187	.	A	G	4	4	8	0	0	8	0	0
8	30731791	.	T	A	2	4	6	0	0	6	0	0
8	30735082	.	T	A	8	10	18	0	0	18	0	0
8	30735085	.	A	G	8	9	17	0	0	17	0	0
8	30741991	.	C	G	4	9	13	0	0	13	0	0
8	30742022	.	C	A	1	5	6	0	10	16	0	0
8	30742075	.	C	T	7	9	16	0	0	16	0	0
8	30742182	.	T	C	1	2	3	0	0	3	0	0
8	30743345	.	A	G	8	10	18	0	1	19	0	0
8	30744468	.	G	A	0	4	4	0	4	8	0	0
8	30745437	.	A	G	3	4	7	0	0	7	0	0
8	30745463	.	T	C	2	5	7	0	1	8	0	0
8	30746092	.	A	T	1	4	5	0	0	5	0	0
8	30758752	.	C	T	2	3	5	0	0	5	0	0
8	30765042	.	T	C	2	4	6	0	0	6	0	0
8	30921546	.	G	T	6	6	12	0	0	12	0	0
8	30925834	.	C	T	2	3	5	0	0	5	0	0
8	30928624	.	G	A	5	7	12	0	0	12	0	0
8	30929267	.	A	G	3	0	3	0	6	9	0	0
8	30929958	.	T	A	19	20	39	1	1	41	0	0
8	30930764	.	C	A	22	27	49	0	0	49	0	0
8	30940027	.	T	A	13	14	27	0	2	29	0	0
8	30940072	.	T	G	16	11	27	0	1	28	0	0
8	30949969	.	C	T	17	10	27	0	1	28	0	0
8	30950057	.	G	A	9	9	18	0	1	19	0	0
8	30951623	.	G	A	14	6	20	0	1	21	0	0
8	30953292	.	T	C	8	0	8	0	4	12	0	0
8	30953444	.	C	T	1	4	5	0	10	15	0	0
8	30960906	.	G	C	3	0	3	0	4	7	0	0
8	30960975	.	G	A	4	2	6	0	1	7	0	0
8	30962897	.	C	T	0	6	6	0	8	14	0	0
8	30963943	.	G	A	7	6	13	0	0	13	0	0
8	30979363	.	T	C	5	5	10	0	0	10	0	0
8	31008426	.	G	A	0	9	9	0	13	22	0	0
8	31012948	.	A	C	20	7	27	0	0	27	0	0
8	31012993	.	C	T	11	18	29	0	3	32	0	0
8	31013176	.	A	T	13	9	22	0	0	23	1	0
8	31013220	.	A	G	11	9	20	0	0	20	0	0
8	31029026	.	C	T	2	2	4	0	0	4	0	0
8	31029316	.	T	A	3	1	4	0	1	5	0	0
8	31030717	.	A	C	1	6	7	0	0	7	0	0
8	31030914	.	A	T	13	13	26	0	1	27	0	0
8	31031068	.	A	G	10	6	16	0	0	16	0	0
8	31031069	.	A	T	10	6	16	0	0	16	0	0
8	31031269	.	T	G	6	5	11	0	0	11	0	0
8	31031272	.	T	C	6	4	10	0	0	10	0	0
8	31031307	.	C	G	4	3	7	0	0	7	0	0
8	31031481	.	C	G	1	4	5	0	0	5	0	0
8	31031535	.	G	A	2	5	7	0	0	7	0	0
8	31031603	.	A	T	9	12	21	0	1	22	0	0
8	31031740	.	A	G	26	18	44	0	1	45	0	0
8	31031993	.	G	A	23	15	38	0	1	39	0	0
8	31032379	.	C	T	13	13	26	0	2	28	0	0
8	31033861	.	A	T	24	14	38	0	0	38	0	0
8	31034924	.	A	G	16	12	28	0	4	32	0	0
8	31036057	.	G	A	17	16	33	0	2	35	0	0
8	31036126	.	G	A	20	12	32	0	0	32	0	0
8	31037403	.	C	T	7	12	19	0	0	19	0	0
8	31038890	.	C	T	16	11	27	0	1	28	0	0
8	31040157	.	G	A	16	7	23	0	2	25	0	0
8	31040211	.	A	G	16	9	25	0	0	25	0	0
8	31040765	.	T	C	15	10	25	0	0	25	0	0
8	31040861	.	G	A	8	10	18	0	0	18	0	0
8	31040973	.	T	C	3	0	3	0	11	14	0	0
8	31041221	.	A	G	12	12	24	0	3	27	0	0
8	31041287	.	C	T	1	13	14	0	9	23	0	0
8	31044577	.	A	C	6	7	13	0	1	14	0	0
8	31044604	.	C	T	3	6	9	0	0	9	0	0
8	31045010	.	A	C	7	0	7	0	8	15	0	0
8	31045790	.	A	G	5	3	8	0	1	9	0	0
8	31046698	.	A	G	10	13	23	0	3	26	0	0
8	31051157	.	C	T	3	3	6	1	0	7	0	0
8	31119730	.	A	G	13	18	31	0	1	32	0	0
8	31119865	.	T	C	17	17	34	0	1	35	0	0
8	31119909	.	T	G	15	2	17	0	18	36	1	0
8	31123029	.	T	C	12	18	30	0	2	32	0	0
8	31131079	.	G	A	16	24	40	0	0	40	0	0
8	31131277	.	A	G	20	25	45	0	2	47	0	0
8	31131394	.	A	C	20	24	44	0	0	44	0	0
8	31142074	.	G	A	36	18	54	0	12	66	0	0
8	31146748	.	G	A	27	23	50	0	3	54	1	0
8	31146913	.	G	A	22	23	45	0	2	47	0	0
8	31147380	.	T	G	18	22	40	0	0	40	0	0
8	31147526	.	G	A	20	30	50	0	2	52	0	0
8	31249080	.	A	C	8	10	18	0	2	20	0	0
8	31249365	.	G	A	16	15	31	0	7	38	0	0
8	31249605	.	A	G	11	21	32	0	2	34	0	0
8	31249881	.	T	A	12	20	32	0	0	32	0	0
8	31249941	.	T	A	13	12	25	0	1	26	0	0
8	31250032	.	A	G	17	0	17	3	13	33	0	0
8	31250183	.	C	A	17	16	33	0	1	34	0	0
8	31250823	.	G	A	19	16	35	0	2	37	0	0
8	31251129	.	G	A	18	15	33	0	2	35	0	0
8	31251282	.	A	C	14	20	34	0	2	36	0	0
8	31253582	.	C	T	21	16	37	0	0	37	0	0
8	31253722	.	T	C	11	11	22	0	1	23	0	0
8	31253729	.	T	A	11	7	18	0	0	18	0	0
8	31254163	.	G	A	18	16	34	0	2	36	0	0
8	31254219	.	T	C	7	12	19	0	0	19	0	0
8	31254281	.	G	T	3	3	6	0	1	7	0	0
8	31367747	.	T	C	4	3	7	0	0	7	0	0
8	31368010	.	G	A	13	24	37	0	1	38	0	0
8	31368279	.	T	G	8	9	17	0	0	17	0	0
8	31368524	.	C	T	9	14	23	0	1	24	0	0
8	31368889	.	C	T	10	12	22	0	0	22	0	0
8	31369071	.	G	C	11	12	23	0	1	24	0	0
8	31375400	.	C	T	7	7	14	0	0	14	0	0
8	31379542	.	C	T	6	17	23	0	19	42	0	0
8	31381731	.	T	A	15	14	29	0	2	31	0	0
8	31387695	.	A	G	10	6	16	0	1	17	0	0
8	31387833	.	C	T	1	9	10	0	3	13	0	0
8	31393220	.	G	A	6	6	12	0	0	12	0	0
8	31393424	.	C	T	0	5	5	0	4	9	0	0
8	31393451	.	G	T	4	3	7	0	1	8	0	0
8	31395532	.	T	G	6	6	12	0	1	13	0	0
8	31395749	.	C	G	5	3	8	0	1	9	0	0
8	31395894	.	A	C	5	5	10	0	1	11	0	0
8	31406847	.	G	C	7	1	8	0	7	15	0	0
8	31407153	.	C	T	18	13	31	0	0	31	0	0
8	31410872	.	C	T	7	6	13	0	0	13	0	0
8	31410887	.	G	A	7	5	12	0	0	12	0	0
8	31411089	.	C	T	0	8	8	0	5	13	0	0
8	31411176	.	T	G	7	7	14	0	0	14	0	0
8	31411569	.	A	C	10	0	10	0	7	17	0	0
8	31411638	.	G	T	8	10	18	0	2	20	0	0
8	31411858	.	A	G	4	6	10	0	1	11	0	0
8	31437611	.	C	T	25	19	44	0	2	46	0	0
8	31437671	.	T	C	18	26	44	0	4	48	0	0
8	31441724	.	G	T	18	21	39	0	2	41	0	0
8	31441733	.	C	A	24	19	43	0	2	45	0	0
8	31441814	.	G	A	21	28	49	0	3	52	0	0
8	31442595	.	G	A	21	13	34	0	0	34	0	0
8	31442648	.	C	T	25	19	44	0	1	45	0	0
8	31442835	.	T	A	0	38	38	0	0	38	0	0
8	31443023	.	A	C	27	21	48	1	9	58	0	0
8	31696085	.	C	T	0	2	2	0	1	3	0	0
8	31705267	.	G	A	23	21	44	0	0	44	0	0
8	31710941	.	G	A	8	12	20	0	0	20	0	0
8	31711411	.	T	C	21	1	22	0	8	30	0	0
8	31719077	.	T	C	13	16	29	0	1	30	0	0
8	31730762	.	C	A	12	21	33	0	1	34	0	0
8	31730771	.	C	T	13	15	28	0	2	30	0	0
8	31730801	.	C	G	12	12	24	0	2	26	0	0
8	31730813	.	A	C	12	18	30	0	3	33	0	0
8	31756865	.	T	C	27	20	47	0	1	48	0	0
8	31756940	.	T	C	24	20	44	0	1	45	0	0
8	31756946	.	T	C	24	22	46	0	0	46	0	0
8	31764858	.	G	A	21	23	44	0	1	45	0	0
8	31765077	.	C	T	27	29	56	0	1	57	0	0
8	31818022	.	G	A	3	14	17	0	20	37	0	0
8	31818083	.	A	T	11	18	29	0	0	29	0	0
8	31818349	.	A	C	10	10	20	0	1	21	0	0
8	31818371	.	A	G	11	8	19	0	1	20	0	0
8	31818549	.	C	T	10	8	18	0	1	19	0	0
8	31818745	.	C	T	10	14	24	0	0	24	0	0
8	31850976	.	G	T	25	18	43	0	1	44	0	0
8	31851270	.	G	A	18	16	34	0	2	36	0	0
8	31851594	.	T	C	24	21	45	0	1	46	0	0
8	31861425	.	A	G	27	13	40	0	0	40	0	0
8	31861580	.	G	A	20	13	33	0	2	35	0	0
8	31861615	.	A	C	10	23	33	0	2	35	0	0
8	31861742	.	G	A	18	18	36	0	2	38	0	0
8	31861746	.	C	T	21	18	39	0	1	40	0	0
8	31862179	.	A	G	21	14	35	0	0	35	0	0
8	31862312	.	G	A	1	27	28	0	15	43	0	0
8	31887859	.	G	T	1	3	4	0	0	4	0	0
8	31888723	.	C	T	4	2	6	0	0	6	0	0
8	31891726	.	A	G	2	3	5	0	0	5	0	0
8	31898671	.	A	G	1	2	3	0	0	3	0	0
8	31901760	.	C	T	2	2	4	0	1	5	0	0
8	31901925	.	G	A	13	7	20	0	2	22	0	0
8	31906927	.	G	A	21	21	42	0	1	43	0	0
8	31919451	.	G	T	10	12	22	0	2	24	0	0
8	31919526	.	C	A	15	17	32	1	1	34	0	0
8	31941746	.	C	A	11	5	16	0	1	17	0	0
8	31942099	.	C	T	11	10	21	0	1	22	0	0
8	31942174	.	G	A	1	14	15	0	11	26	0	0
8	31942771	.	C	T	7	6	13	0	1	14	0	0
8	31943276	.	G	A	4	2	6	0	0	6	0	0
8	31943301	.	T	G	1	2	3	0	0	4	1	0
8	32028856	.	G	T	5	4	9	0	0	9	0	0
8	32028921	.	T	A	5	2	7	0	0	7	0	0
8	32029217	.	C	T	3	2	5	0	0	5	0	0
8	32029258	.	T	C	2	3	5	0	2	7	0	0
8	32029267	.	G	A	3	4	7	0	0	7	0	0
8	32029573	.	T	C	3	0	3	0	2	5	0	0
8	32029699	.	T	C	1	0	1	0	2	3	0	0
8	32030771	.	T	G	7	5	12	0	0	12	0	0
8	32030837	.	T	A	1	7	8	0	0	8	0	0
8	32129255	.	T	C	5	4	9	0	1	10	0	0
8	32191744	.	G	A	5	2	7	0	1	8	0	0
8	32247877	.	G	A	8	4	12	0	1	13	0	0
8	32270327	.	G	T	3	6	9	0	0	9	0	0
8	32270345	.	T	C	4	0	4	0	3	7	0	0
8	32278309	.	G	C	4	2	6	0	1	7	0	0
8	32403079	.	G	A	2	3	5	0	0	5	0	0
8	32482851	.	C	T	18	9	27	0	0	27	0	0
8	32483536	.	C	T	13	12	25	0	4	29	0	0
8	32483905	.	G	C	16	15	31	0	0	31	0	0
8	32486956	.	C	T	2	10	12	0	19	31	0	0
8	32497629	.	G	T	16	13	29	0	0	29	0	0
8	32501541	.	A	G	5	5	10	0	0	10	0	0
8	32502932	.	C	T	5	5	10	0	0	10	0	0
8	32503968	.	C	T	7	3	10	0	0	10	0	0
8	32506175	.	G	T	2	3	5	0	2	7	0	0
8	32506183	.	A	G	4	2	6	0	0	6	0	0
8	32516233	.	T	C	3	3	6	0	0	6	0	0
8	32516240	.	G	A	3	3	6	0	1	7	0	0
8	32516331	.	C	T	3	2	5	1	1	7	0	0
8	32516557	.	T	C	16	13	29	0	0	29	0	0
8	32516629	.	A	C	10	10	20	0	0	20	0	0
8	32577794	.	G	A	6	10	16	0	1	17	0	0
8	32598954	.	A	G	6	12	18	1	1	20	0	0
8	32599413	.	T	C	10	5	15	0	1	16	0	0
8	32599586	.	C	T	5	7	12	0	0	12	0	0
8	32914694	.	C	T	20	11	31	0	0	31	0	0
8	32914782	.	T	A	10	19	29	0	0	29	0	0
8	32914813	.	A	T	9	17	26	0	0	26	0	0
8	32914853	.	C	T	10	7	17	0	0	17	0	0
8	32949287	.	C	T	0	8	8	0	9	17	0	0
8	33084515	.	A	G	22	15	37	0	2	39	0	0
8	33133616	.	G	A	1	3	4	0	1	5	0	0
8	33154612	.	T	C	1	0	1	0	3	4	0	0
8	33261068	.	G	T	3	3	6	0	0	6	0	0
8	33285546	.	C	T	3	3	6	0	0	6	0	0
8	33896326	.	A	T	17	14	31	2	0	33	0	0
8	33896585	.	C	T	26	16	42	0	2	44	0	0
8	33896902	.	G	A	18	23	41	0	1	42	0	0
8	33896922	.	G	A	17	24	41	0	2	43	0	0
8	33897266	.	T	C	24	1	25	0	26	51	0	0
8	33897274	.	C	T	2	19	21	0	30	51	0	0
8	33910008	.	G	A	30	25	55	3	3	61	0	0
8	33910017	.	G	A	25	36	61	3	2	66	0	0
8	33924284	.	A	G	18	33	51	0	1	52	0	0
8	33924432	.	C	T	4	33	37	0	20	57	0	0
8	34051719	.	G	A	18	26	44	0	0	44	0	0
8	34051850	.	G	A	20	11	31	0	1	32	0	0
8	34051930	.	T	G	22	13	35	0	2	37	0	0
8	34342146	.	G	A	17	14	31	0	0	31	0	0
8	34342214	.	A	T	14	8	22	0	3	25	0	0
8	34342462	.	A	G	12	8	20	5	1	26	0	0
8	34345285	.	G	A	14	17	31	0	2	33	0	0
8	34345372	.	T	C	16	15	31	0	0	31	0	0
8	34345390	.	A	G	12	18	30	0	0	30	0	0
8	34345583	.	A	G	13	11	24	0	1	25	0	0
8	34347281	.	T	C	14	18	32	0	2	34	0	0
8	34348958	.	A	C	9	3	12	0	0	12	0	0
8	34376264	.	G	A	11	8	19	0	0	19	0	0
8	34376728	.	G	A	6	10	16	0	0	16	0	0
8	34390998	.	C	T	0	6	6	0	10	16	0	0
8	34394570	.	G	A	7	9	16	0	0	16	0	0
8	34397046	.	C	T	8	6	14	0	0	14	0	0
8	35357789	.	G	A	3	4	7	0	0	7	0	0
8	35580986	.	C	T	5	2	7	0	0	7	0	0
8	35759213	.	G	C	4	6	10	0	1	11	0	0
8	35759363	.	T	G	4	2	6	0	0	6	0	0
8	35759402	.	C	T	6	2	8	0	0	8	0	0
8	35759444	.	C	T	5	6	11	0	0	11	0	0
8	35759726	.	C	T	3	3	6	0	0	6	0	0
8	35760423	.	C	T	2	4	6	0	0	6	0	0
8	35809975	.	T	A	1	2	3	0	0	3	0	0
8	35810115	.	T	C	2	1	3	0	1	4	0	0
8	35960416	.	C	A	1	3	4	0	0	4	0	0
8	36058504	.	G	T	2	2	4	0	0	4	0	0
8	36058800	.	T	A	2	2	4	0	1	5	0	0
8	36058873	.	T	A	3	2	5	0	0	5	0	0
8	36058882	.	A	C	2	2	4	0	1	5	0	0
8	36059373	.	C	G	0	2	2	0	0	2	0	0
8	36110488	.	A	G	1	2	3	0	0	3	0	0
8	36468040	.	T	A	2	2	4	0	1	5	0	0
8	36468046	.	C	T	2	1	3	0	0	3	0	0
8	36468769	.	A	T	4	2	6	0	0	6	0	0
8	36473141	.	G	T	6	2	8	0	0	8	0	0
8	36473144	.	A	G	6	2	8	0	0	8	0	0
8	36473361	.	A	T	1	8	9	0	0	9	0	0
8	36474411	.	A	G	3	9	12	0	0	12	0	0
8	36504059	.	A	G	5	0	5	0	3	8	0	0
8	36504089	.	T	C	3	4	7	0	0	7	0	0
8	36504185	.	T	C	3	2	5	0	0	5	0	0
8	36504282	.	C	T	3	4	7	0	1	8	0	0
8	36504314	.	C	T	2	3	5	0	0	5	0	0
8	36504422	.	T	A	4	2	6	0	0	6	0	0
8	36504620	.	A	G	3	2	5	0	0	5	0	0
8	36507260	.	T	G	7	5	12	0	0	12	0	0
8	36507344	.	C	T	1	3	4	0	1	5	0	0
8	36507449	.	T	C	8	3	11	0	0	11	0	0
8	36507470	.	C	T	5	5	10	0	1	11	0	0
8	36507764	.	G	A	8	5	13	0	0	13	0	0
8	36512804	.	G	A	1	4	5	0	2	7	0	0
8	36512888	.	G	T	1	2	3	0	0	3	0	0
8	36512981	.	A	C	5	1	6	0	1	7	0	0
8	36512982	.	T	C	5	2	7	0	0	7	0	0
8	36515721	.	A	G	1	8	9	0	0	9	0	0
8	36515779	.	G	A	1	8	9	0	3	12	0	0
8	36560180	.	C	T	27	12	39	0	1	40	0	0
8	36561942	.	A	T	25	8	33	0	2	35	0	0
8	36562262	.	T	C	25	10	35	0	1	36	0	0
8	36562293	.	C	T	19	13	32	0	0	32	0	0
8	36562451	.	A	G	22	1	23	0	14	37	0	0
8	36564005	.	A	G	25	9	34	0	1	35	0	0
8	36564746	.	C	T	3	8	11	0	5	16	0	0
8	36566125	.	C	T	23	18	41	0	2	43	0	0
8	36566167	.	G	A	25	19	44	0	0	44	0	0
8	36566182	.	T	C	25	14	39	0	1	40	0	0
8	36567283	.	C	T	28	12	40	0	3	43	0	0
8	36568561	.	A	G	20	13	33	0	0	33	0	0
8	36568755	.	T	C	19	7	26	0	0	26	0	0
8	36569810	.	T	C	11	5	16	0	1	17	0	0
8	36569924	.	C	A	12	8	20	0	0	20	0	0
8	36569925	.	T	A	12	8	20	0	0	20	0	0
8	36569968	.	A	C	14	9	23	0	0	23	0	0
8	36569990	.	A	G	15	7	22	0	0	22	0	0
8	36570602	.	A	G	2	4	6	0	0	6	0	0
8	36570624	.	T	C	2	3	5	0	0	5	0	0
8	36570947	.	C	T	4	2	6	0	0	6	0	0
8	36571018	.	A	C	3	3	6	0	0	6	0	0
8	36573472	.	T	C	6	4	10	0	1	11	0	0
8	36573727	.	T	C	8	3	11	0	0	11	0	0
8	36573742	.	C	T	7	3	10	0	2	12	0	0
8	36573796	.	C	T	4	2	6	0	2	8	0	0
8	36573808	.	A	T	6	2	8	0	0	8	0	0
8	36575325	.	T	C	4	4	8	0	0	8	0	0
8	36577083	.	T	C	6	8	14	0	0	14	0	0
8	36577143	.	C	T	3	3	6	0	0	6	0	0
8	36577158	.	T	C	2	3	5	0	0	5	0	0
8	36577368	.	T	A	1	3	4	0	0	4	0	0
8	36577404	.	T	A	2	2	4	0	0	4	0	0
8	36578796	.	T	C	4	3	7	0	0	7	0	0
8	36578813	.	C	T	3	4	7	0	0	7	0	0
8	36583834	.	T	C	8	10	18	0	1	19	0	0
8	36587934	.	A	G	12	8	20	0	2	22	0	0
8	36587936	.	A	G	13	1	14	0	8	22	0	0
8	36587970	.	C	A	17	10	27	0	0	27	0	0
8	36587981	.	G	T	16	10	26	0	0	26	0	0
8	36588124	.	G	A	19	13	32	0	0	32	0	0
8	36589197	.	C	T	7	6	13	0	0	13	0	0
8	36589260	.	T	A	6	5	11	0	0	11	0	0
8	36591985	.	C	T	1	6	7	0	0	7	0	0
8	36592018	.	A	G	3	6	9	0	0	9	0	0
8	36592021	.	C	A	0	7	7	0	3	10	0	0
8	36592159	.	A	G	7	2	9	0	0	9	0	0
8	36592160	.	A	G	7	1	8	0	1	9	0	0
8	36592297	.	G	A	3	7	10	0	2	12	0	0
8	36592374	.	A	G	7	14	21	1	0	22	0	0
8	36594354	.	T	C	9	0	9	0	8	17	0	0
8	36594481	.	T	G	10	9	19	0	1	20	0	0
8	36594509	.	G	A	9	10	19	0	1	20	0	0
8	36598441	.	C	T	1	9	10	0	4	14	0	0
8	36602459	.	C	T	9	19	28	0	0	28	0	0
8	36617635	.	C	G	8	12	20	0	0	20	0	0
8	36617669	.	A	G	14	10	24	0	0	24	0	0
8	36617728	.	G	A	9	13	22	0	1	23	0	0
8	36617954	.	C	T	8	11	19	0	0	19	0	0
8	36621943	.	T	C	1	2	3	0	0	3	0	0
8	36743518	.	G	A	0	2	2	0	1	3	0	0
8	36743554	.	C	T	3	2	5	0	0	5	0	0
8	36746770	.	T	A	3	2	5	0	0	5	0	0
8	36746826	.	T	A	4	3	7	0	0	7	0	0
8	36750336	.	A	G	2	0	2	0	3	5	0	0
8	36781593	.	G	A	0	4	4	0	10	14	0	0
8	36781596	.	A	G	8	0	8	0	6	14	0	0
8	36783396	.	C	T	3	8	11	0	1	12	0	0
8	36785572	.	A	C	6	4	10	0	0	10	0	0
8	36785599	.	T	C	6	4	10	0	1	11	0	0
8	36803687	.	G	A	14	13	27	0	0	27	0	0
8	36803717	.	G	A	1	19	20	0	10	30	0	0
8	36803850	.	T	C	19	15	34	0	1	35	0	0
8	36951346	.	C	T	20	14	34	0	0	34	0	0
8	36951481	.	C	T	23	16	39	0	3	42	0	0
8	36951610	.	T	C	20	10	30	0	0	30	0	0
8	36952015	.	A	G	24	4	28	0	32	60	0	0
8	36953884	.	A	G	13	9	22	0	1	23	0	0
8	36953947	.	C	T	17	12	29	0	1	30	0	0
8	36953950	.	G	C	19	13	32	0	0	32	0	0
8	36956254	.	C	T	13	26	39	0	3	42	0	0
8	36956269	.	T	C	15	30	45	0	3	48	0	0
8	36959694	.	C	T	14	10	24	0	1	25	0	0
8	36959915	.	T	A	22	13	35	0	0	35	0	0
8	36961895	.	C	A	26	19	45	0	3	48	0	0
8	36964126	.	G	A	17	19	36	0	0	36	0	0
8	36969205	.	T	C	24	16	40	0	2	42	0	0
8	36974328	.	C	T	23	31	54	0	2	56	0	0
8	36974514	.	C	T	26	29	55	0	7	62	0	0
8	36975826	.	A	G	23	14	37	0	0	37	0	0
8	36975928	.	T	C	11	17	28	1	1	30	0	0
8	36976089	.	T	C	11	9	20	0	1	21	0	0
8	36976247	.	A	C	1	1	2	0	0	2	0	0
8	36976255	.	T	G	1	2	3	0	0	3	0	0
8	36976288	.	T	A	4	3	7	0	0	7	0	0
8	36976319	.	T	A	4	3	7	0	0	7	0	0
8	36976352	.	G	T	1	7	8	0	5	13	0	0
8	36976388	.	A	T	8	12	20	0	1	21	0	0
8	36976432	.	T	A	15	15	30	0	0	30	0	0
8	36976557	.	G	A	14	21	35	0	2	37	0	0
8	36976836	.	C	A	16	18	34	0	2	36	0	0
8	36977178	.	A	G	15	24	39	0	0	39	0	0
8	36977199	.	C	A	12	18	30	0	2	32	0	0
8	36977520	.	G	A	22	19	41	0	3	44	0	0
8	36977848	.	T	C	9	13	22	0	0	22	0	0
8	36983676	.	A	T	14	6	20	0	0	20	0	0
8	36983963	.	C	G	8	3	11	0	0	11	0	0
8	37007868	.	A	G	9	7	16	0	0	16	0	0
8	37009605	.	C	T	8	5	13	0	0	13	0	0
8	37009674	.	C	G	8	0	8	0	4	12	0	0
8	37010662	.	T	C	8	9	17	0	2	19	0	0
8	37012762	.	T	A	8	7	15	0	1	16	0	0
8	37012825	.	C	T	5	17	22	0	0	22	0	0
8	37012872	.	C	G	9	9	18	0	0	18	0	0
8	37013093	.	A	G	14	8	22	0	0	22	0	0
8	37013255	.	T	C	8	7	15	0	1	16	0	0
8	37013282	.	T	C	6	7	13	0	0	13	0	0
8	37014582	.	T	C	11	14	25	0	2	27	0	0
8	37016584	.	G	T	1	17	18	0	17	35	0	0
8	37016616	.	C	T	22	16	38	0	0	38	0	0
8	37016638	.	A	G	18	18	36	0	0	36	0	0
8	37016784	.	G	A	1	12	13	0	15	28	0	0
8	37016790	.	T	C	16	12	28	0	0	28	0	0
8	37017149	.	G	A	22	11	33	1	0	34	0	0
8	37017159	.	C	T	24	12	36	1	0	37	0	0
8	37018904	.	A	G	13	0	13	0	22	35	0	0
8	37019048	.	G	A	14	22	36	0	0	36	0	0
8	37019062	.	C	A	17	19	36	0	1	37	0	0
8	37025576	.	A	T	15	17	32	0	1	33	0	0
8	37025614	.	T	A	18	17	35	0	3	38	0	0
8	37025633	.	A	G	15	1	16	0	22	38	0	0
8	37025896	.	T	C	5	8	13	0	0	13	0	0
8	37026130	.	G	A	17	9	26	0	1	27	0	0
8	37033321	.	T	C	1	2	3	0	0	3	0	0
8	37033374	.	G	C	2	1	3	0	3	6	0	0
8	37035631	.	T	A	1	4	5	0	0	5	0	0
8	37035640	.	T	C	1	0	1	0	4	5	0	0
8	37060595	.	A	C	14	9	23	0	1	24	0	0
8	37060640	.	A	G	12	6	18	0	0	18	0	0
8	37068600	.	T	G	1	2	3	0	1	4	0	0
8	37075113	.	T	C	2	4	6	0	0	6	0	0
8	37075172	.	A	G	1	4	5	0	0	5	0	0
8	37075179	.	A	G	1	4	5	0	0	5	0	0
8	37075209	.	A	T	4	4	8	0	0	8	0	0
8	37075536	.	A	G	3	7	10	0	0	10	0	0
8	37075583	.	T	C	2	2	4	0	0	4	0	0
8	37075875	.	T	C	1	2	3	0	0	3	0	0
8	37082927	.	A	G	2	4	6	0	0	6	0	0
8	37086959	.	C	T	2	5	7	0	0	7	0	0
8	37101346	.	T	C	4	3	7	0	0	7	0	0
8	37101370	.	G	C	4	3	7	0	0	7	0	0
8	37229473	.	G	A	2	2	4	0	0	4	0	0
8	37232122	.	C	T	1	11	12	0	5	17	0	0
8	37232189	.	A	C	9	0	9	0	3	12	0	0
8	37232442	.	A	C	8	2	10	0	15	25	0	0
8	37232487	.	A	C	13	20	33	0	2	35	0	0
8	37239141	.	C	T	0	7	7	0	7	14	0	0
8	37241078	.	A	G	9	8	17	0	0	17	0	0
8	37242367	.	T	G	3	2	5	0	1	6	0	0
8	37242374	.	A	T	5	2	7	0	0	7	0	0
8	37242438	.	T	C	4	2	6	0	0	6	0	0
8	37249727	.	C	T	1	7	8	0	11	19	0	0
8	37249732	.	A	T	10	7	17	0	0	17	0	0
8	37280726	.	C	T	6	9	15	0	3	18	0	0
8	37280858	.	C	T	14	8	22	0	0	22	0	0
8	37281109	.	T	C	10	35	45	1	3	49	0	0
8	37282486	.	A	C	23	19	42	0	0	42	0	0
8	37282487	.	G	T	22	19	41	0	0	41	0	0
8	37282610	.	G	A	27	17	44	0	0	44	0	0
8	37282752	.	C	T	23	19	42	0	1	43	0	0
8	37282866	.	T	G	15	23	38	0	0	38	0	0
8	37282950	.	T	G	12	17	29	0	0	29	0	0
8	37282976	.	G	A	17	12	29	0	1	30	0	0
8	37283177	.	T	A	4	3	7	1	0	8	0	0
8	37283487	.	A	C	13	7	20	0	0	20	0	0
8	37283536	.	G	A	13	12	25	0	0	25	0	0
8	37283986	.	A	G	3	3	6	0	0	6	0	0
8	37284018	.	A	T	1	4	5	0	0	5	0	0
8	37284046	.	T	C	4	0	4	0	7	11	0	0
8	37294918	.	C	T	1	19	20	0	21	41	0	0
8	37294923	.	G	A	16	17	33	0	9	42	0	0
8	37297524	.	C	T	24	23	47	0	2	49	0	0
8	37303891	.	G	A	14	13	27	0	0	27	0	0
8	37305515	.	G	C	13	6	19	0	1	20	0	0
8	37306114	.	A	G	14	11	25	0	0	25	0	0
8	37311888	.	T	A	17	8	25	0	1	26	0	0
8	38505804	.	T	C	5	2	7	0	0	7	0	0
8	39849422	.	T	G	0	5	5	0	1	6	0	0
8	40217948	.	G	A	3	5	8	0	0	8	0	0
8	40218288	.	C	T	6	7	13	0	0	13	0	0
8	40218290	.	C	T	5	7	12	0	1	13	0	0
8	40234640	.	C	T	9	4	13	0	0	13	0	0
8	40234830	.	A	G	5	7	12	1	0	13	0	0
8	40234831	.	T	A	5	7	12	1	0	13	0	0
8	40235244	.	C	T	3	2	5	0	0	5	0	0
8	40235281	.	G	A	8	4	12	0	0	12	0	0
8	40235348	.	G	C	6	3	9	0	0	9	0	0
8	40236132	.	A	G	5	3	8	0	0	8	0	0
8	40236148	.	A	G	1	6	7	0	0	7	0	0
8	40236448	.	C	A	4	2	6	0	0	6	0	0
8	40236453	.	A	T	4	2	6	0	0	6	0	0
8	40237799	.	C	A	1	3	4	1	0	5	0	0
8	40237906	.	C	T	4	6	10	0	1	11	0	0
8	40238375	.	T	A	2	3	5	0	0	5	0	0
8	40240922	.	C	G	6	9	15	0	0	15	0	0
8	40241441	.	A	G	20	7	27	8	0	35	0	0
8	40241446	.	A	G	18	7	25	8	1	34	0	0
8	40241640	.	A	T	22	7	29	5	1	35	0	0
8	40241681	.	A	G	30	13	43	0	0	43	0	0
8	40241695	.	T	A	30	10	40	0	1	41	0	0
8	40242103	.	G	A	14	17	31	0	0	31	0	0
8	40242453	.	G	A	11	11	22	0	1	23	0	0
8	40243052	.	G	C	14	18	32	0	0	32	0	0
8	40243148	.	T	C	21	16	37	0	1	38	0	0
8	40248373	.	T	G	16	21	37	0	1	38	0	0
8	40248673	.	T	C	17	23	40	0	2	42	0	0
8	40248976	.	G	T	16	19	35	0	1	36	0	0
8	40251444	.	T	G	16	25	41	0	0	41	0	0
8	40251834	.	C	A	11	8	19	0	0	19	0	0
8	40252508	.	C	T	0	24	24	0	9	33	0	0
8	40254366	.	A	G	8	18	26	0	0	26	0	0
8	40254375	.	T	G	9	19	28	0	2	30	0	0
8	40270856	.	G	A	17	22	39	0	1	41	1	0
8	40325709	.	G	T	13	3	16	0	0	16	0	0
8	40326039	.	A	G	13	15	28	0	5	33	0	0
8	40326128	.	C	T	14	16	30	0	1	31	0	0
8	40326736	.	A	G	5	9	14	0	0	14	0	0
8	40327227	.	A	G	6	7	13	0	0	13	0	0
8	40427540	.	T	C	5	2	7	0	0	7	0	0
8	40428012	.	T	G	2	4	6	0	0	6	0	0
8	40428015	.	A	C	2	4	6	0	0	6	0	0
8	40428287	.	C	A	2	2	4	0	0	4	0	0
8	40428717	.	A	T	2	3	5	0	0	5	0	0
8	40429846	.	G	A	3	2	5	0	0	5	0	0
8	40430038	.	C	A	3	5	8	1	2	11	0	0
8	40430293	.	C	T	0	5	5	0	5	10	0	0
8	40430322	.	A	G	2	6	8	0	1	9	0	0
8	40430562	.	T	G	2	5	7	1	0	8	0	0
8	40430664	.	G	A	7	5	12	0	1	13	0	0
8	40430771	.	A	G	4	8	12	0	0	12	0	0
8	40430799	.	G	T	6	9	15	0	0	15	0	0
8	40430902	.	T	A	4	6	10	0	0	10	0	0
8	40430934	.	A	G	8	7	15	0	1	16	0	0
8	40431269	.	C	T	0	2	2	0	7	9	0	0
8	40433849	.	G	T	4	2	6	0	0	6	0	0
8	40437882	.	T	C	1	2	3	0	0	3	0	0
8	40631823	.	C	T	8	9	17	0	0	17	0	0
8	40631862	.	C	T	7	10	17	0	0	17	0	0
8	40632014	.	T	C	10	10	20	0	1	21	0	0
8	40632313	.	C	G	4	7	11	0	0	11	0	0
8	40632411	.	A	T	5	2	7	0	1	8	0	0
8	40632758	.	A	C	9	10	19	0	0	19	0	0
8	40632793	.	A	T	7	5	12	0	1	13	0	0
8	40633172	.	G	C	6	4	10	0	0	10	0	0
8	40644840	.	C	T	8	9	17	0	0	17	0	0
8	40644876	.	T	G	12	9	21	0	0	21	0	0
8	40645084	.	T	C	9	9	18	0	0	18	0	0
8	40645269	.	C	T	8	3	11	0	1	12	0	0
8	40645890	.	A	G	3	10	13	0	0	13	0	0
8	40646154	.	C	T	7	9	16	0	0	16	0	0
8	41186338	.	G	A	4	2	6	0	1	7	0	0
8	41186455	.	A	C	2	6	8	0	0	8	0	0
8	41194542	.	C	G	2	3	5	0	0	5	0	0
8	41201863	.	C	T	0	4	4	0	9	13	0	0
8	41206801	.	C	G	3	3	6	0	0	6	0	0
8	41235767	.	G	T	5	4	9	0	0	9	0	0
8	41235780	.	A	C	6	3	9	0	1	10	0	0
8	41238110	.	G	A	2	10	12	0	3	15	0	0
8	41239494	.	G	A	3	7	10	0	1	11	0	0
8	41239500	.	T	C	4	8	12	0	0	12	0	0
8	41240949	.	T	C	5	8	13	0	2	15	0	0
8	41249879	.	A	G	9	12	21	0	0	21	0	0
8	41249882	.	T	C	8	10	18	0	2	20	0	0
8	41249942	.	T	C	12	10	22	0	0	22	0	0
8	41255346	.	C	T	9	8	17	0	0	17	0	0
8	41255439	.	G	A	11	14	25	0	0	25	0	0
8	41255554	.	C	T	9	10	19	0	1	20	0	0
8	41255573	.	T	C	8	12	20	0	1	21	0	0
8	41255750	.	G	A	2	5	7	0	1	8	0	0
8	41260534	.	C	T	15	17	32	0	2	34	0	0
8	41260634	.	A	G	25	21	46	0	1	47	0	0
8	41260668	.	A	G	23	20	43	0	1	45	1	0
8	41260823	.	G	C	24	16	40	0	0	40	0	0
8	41260877	.	A	G	33	20	53	0	2	55	0	0
8	41260880	.	T	C	33	4	37	0	17	54	0	0
8	41260923	.	T	A	39	20	59	0	1	60	0	0
8	41260985	.	G	A	31	19	50	0	0	50	0	0
8	41261178	.	T	C	15	23	38	0	3	41	0	0
8	41261190	.	A	G	18	23	41	0	3	44	0	0
8	41261294	.	A	G	25	17	42	0	2	45	1	0
8	41263005	.	A	G	28	24	52	0	1	53	0	0
8	41263085	.	G	A	30	26	56	0	0	56	0	0
8	41263206	.	A	G	31	16	47	1	3	51	0	0
8	41263220	.	T	C	31	23	54	1	1	56	0	0
8	41264447	.	A	T	28	16	44	0	9	53	0	0
8	41264549	.	C	G	33	24	57	0	0	57	0	0
8	41264786	.	A	C	36	21	57	1	2	61	1	0
8	41264788	.	T	A	35	18	53	1	6	61	1	0
8	41265180	.	T	C	27	26	53	0	3	56	0	0
8	41265264	.	G	A	24	25	49	0	3	52	0	0
8	41265549	.	T	C	24	21	45	0	1	46	0	0
8	41266567	.	T	C	23	21	44	0	1	45	0	0
8	41266573	.	A	T	20	22	42	0	0	43	1	0
8	41267976	.	C	T	29	16	45	0	1	46	0	0
8	41273680	.	C	T	17	19	36	0	1	37	0	0
8	41274561	.	T	C	3	3	6	0	0	6	0	0
8	41274617	.	G	A	5	5	10	0	0	10	0	0
8	41462497	.	A	G	2	0	2	0	9	11	0	0
8	41468868	.	C	T	6	3	9	0	1	10	0	0
8	41474547	.	T	C	4	6	10	0	0	10	0	0
8	41474556	.	G	A	5	9	14	0	1	15	0	0
8	41475236	.	T	C	5	7	12	0	0	12	0	0
8	41482466	.	C	T	7	10	17	0	1	18	0	0
8	41484219	.	G	A	5	5	10	0	0	10	0	0
8	41485132	.	A	G	5	3	8	0	1	9	0	0
8	41485204	.	T	A	2	9	11	0	0	11	0	0
8	41485993	.	A	G	5	4	9	0	0	9	0	0
8	41488641	.	C	G	2	7	9	0	7	16	0	0
8	41493936	.	C	G	5	10	15	0	0	15	0	0
8	41493994	.	T	C	6	3	9	0	0	9	0	0
8	41502731	.	T	C	4	0	4	0	9	13	0	0
8	41533605	.	T	C	13	8	21	0	1	22	0	0
8	41533738	.	A	T	8	13	21	0	1	22	0	0
8	42075668	.	A	T	11	8	19	0	1	20	0	0
8	42075701	.	A	G	10	9	19	0	1	20	0	0
8	42834091	.	C	G	9	6	15	1	0	16	0	0
8	42834146	.	T	C	16	10	26	0	1	27	0	0
8	43455875	.	G	A	7	7	14	0	0	14	0	0
8	44211479	.	C	A	1	3	4	0	0	4	0	0
8	44211831	.	G	A	6	2	8	0	0	8	0	0
8	44213470	.	T	G	2	3	5	0	1	6	0	0
8	44213729	.	C	T	5	5	10	0	0	10	0	0
8	44296292	.	C	T	0	5	5	0	3	8	0	0
8	44296595	.	A	C	3	0	3	0	8	11	0	0
8	44296672	.	G	A	6	6	12	0	0	12	0	0
8	44296985	.	G	A	5	4	9	0	0	9	0	0
8	44297174	.	A	C	2	5	7	0	0	7	0	0
8	44297555	.	A	G	3	4	7	0	0	7	0	0
8	44297609	.	G	A	4	5	9	0	0	9	0	0
8	44297822	.	T	C	4	3	7	1	0	8	0	0
8	44298787	.	C	T	0	3	3	0	6	9	0	0
8	44298814	.	G	T	5	3	8	0	0	8	0	0
8	44446256	.	G	A	2	3	5	0	0	5	0	0
8	44599938	.	C	T	12	7	19	0	1	20	0	0
8	44602132	.	G	A	14	12	26	0	1	27	0	0
8	44602264	.	A	G	5	14	19	0	0	20	1	0
8	44602353	.	G	C	8	0	8	0	7	15	0	0
8	44602357	.	T	C	9	7	16	0	0	16	0	0
8	44604588	.	C	T	1	8	9	0	6	15	0	0
8	44618024	.	C	T	2	5	7	0	0	7	0	0
8	44618065	.	G	A	0	2	2	0	4	6	0	0
8	44669550	.	T	C	9	9	18	0	0	18	0	0
8	44671767	.	T	C	8	10	18	0	0	18	0	0
8	44677544	.	C	T	10	8	18	0	0	18	0	0
8	44677613	.	T	C	12	10	22	0	0	22	0	0
8	44694956	.	G	A	0	8	8	0	8	16	0	0
8	44695043	.	A	C	5	14	19	0	0	19	0	0
8	44695140	.	A	C	6	10	16	0	1	17	0	0
8	44695230	.	A	T	16	15	31	0	1	32	0	0
8	44714384	.	C	T	20	7	27	0	0	27	0	0
8	44726070	.	C	A	4	5	9	0	1	10	0	0
8	44730536	.	G	A	0	7	7	0	13	20	0	0
8	44737591	.	A	T	2	12	14	1	1	16	0	0
8	44737646	.	C	A	2	13	15	1	1	17	0	0
8	44894337	.	G	T	7	2	9	0	1	10	0	0
8	44894575	.	T	A	1	6	7	0	0	7	0	0
8	44894604	.	C	T	2	10	12	0	0	12	0	0
8	44894631	.	G	C	7	12	19	0	0	19	0	0
8	44897853	.	C	A	0	12	12	0	11	23	0	0
8	44921272	.	C	A	6	7	13	0	0	13	0	0
8	44921346	.	G	A	3	3	6	0	0	6	0	0
8	44921821	.	A	G	4	4	8	0	1	9	0	0
8	44923267	.	G	A	8	3	11	0	0	11	0	0
8	44923700	.	T	C	3	0	3	0	5	8	0	0
8	44926824	.	G	A	0	2	2	0	2	4	0	0
8	44927901	.	T	C	2	3	5	0	1	6	0	0
8	44959583	.	C	T	4	3	7	0	0	7	0	0
8	44959589	.	A	G	4	4	8	0	0	8	0	0
8	44975939	.	G	C	1	3	4	0	0	4	0	0
8	44976047	.	G	T	5	2	7	0	0	7	0	0
8	44976197	.	T	C	3	4	7	0	1	8	0	0
8	45293782	.	A	G	3	0	3	0	6	9	0	0
8	45298603	.	G	A	10	13	23	0	1	24	0	0
8	45298943	.	G	C	10	13	23	0	2	25	0	0
8	45304210	.	T	C	12	5	17	0	1	18	0	0
8	45308963	.	A	C	14	16	30	0	1	31	0	0
8	45311761	.	T	G	17	12	29	0	0	29	0	0
8	45312231	.	G	C	3	11	14	0	17	31	0	0
8	45312285	.	C	A	10	14	24	0	1	25	0	0
8	45313023	.	A	C	9	18	27	0	1	28	0	0
8	45315444	.	T	C	13	20	33	0	0	33	0	0
8	45317898	.	A	T	13	18	31	0	6	37	0	0
8	45317976	.	G	A	3	12	15	0	18	34	1	0
8	45318124	.	C	T	16	18	34	0	2	36	0	0
8	45319659	.	A	G	22	0	22	0	21	43	0	0
8	45325269	.	G	C	26	18	44	0	2	46	0	0
8	45328278	.	T	A	6	7	13	0	3	16	0	0
8	45361816	.	A	G	12	18	30	0	0	30	0	0
8	45365789	.	T	C	12	15	27	0	1	28	0	0
8	45374151	.	A	T	13	13	26	0	5	31	0	0
8	45374477	.	A	G	5	4	9	0	0	9	0	0
8	45374665	.	T	A	15	14	29	0	0	29	0	0
8	45374884	.	T	G	14	14	28	0	1	29	0	0
8	45374966	.	G	T	10	3	13	0	0	13	0	0
8	45374970	.	A	G	9	3	12	0	0	12	0	0
8	45381427	.	T	A	10	5	15	1	0	16	0	0
8	45381488	.	C	A	6	2	8	0	0	8	0	0
8	45381555	.	T	C	3	3	6	0	2	8	0	0
8	45381570	.	C	T	6	3	9	0	1	10	0	0
8	45381596	.	G	T	0	3	3	0	3	6	0	0
8	45381862	.	G	A	1	3	4	0	13	17	0	0
8	45381919	.	G	A	1	3	4	0	7	11	0	0
8	45382012	.	G	A	0	2	2	0	4	6	0	0
8	45384366	.	C	T	1	2	3	0	0	3	0	0
8	45384375	.	C	T	1	2	3	0	0	3	0	0
8	45385546	.	T	A	3	2	5	0	0	5	0	0
8	45385586	.	A	G	3	0	3	0	5	8	0	0
8	45392034	.	G	A	0	4	4	0	8	12	0	0
8	45395024	.	C	A	12	3	15	0	0	15	0	0
8	45395114	.	T	A	5	8	13	0	0	13	0	0
8	45395127	.	C	T	4	8	12	0	1	13	0	0
8	45395234	.	T	G	1	2	3	0	1	4	0	0
8	45395357	.	C	T	1	3	4	0	0	4	0	0
8	45395452	.	T	G	1	5	6	0	0	6	0	0
8	45396028	.	T	C	10	1	11	0	5	16	0	0
8	45427189	.	C	A	28	23	51	0	3	54	0	0
8	45428039	.	C	T	26	21	47	0	0	47	0	0
8	45430757	.	G	A	23	32	55	0	1	56	0	0
8	45755040	.	T	C	1	2	3	0	0	3	0	0
8	45755185	.	T	C	2	6	8	0	1	9	0	0
8	45755212	.	G	T	3	3	6	0	0	6	0	0
8	45755513	.	G	A	3	5	8	0	0	8	0	0
8	45755577	.	G	A	6	8	14	0	0	14	0	0
8	45755816	.	T	C	38	26	64	0	1	65	0	0
8	45755973	.	C	G	36	35	71	0	1	72	0	0
8	45756191	.	A	G	34	41	75	0	2	77	0	0
8	45756206	.	G	A	35	38	73	0	5	78	0	0
8	45760071	.	A	C	13	0	13	0	8	21	0	0
8	45762619	.	A	G	1	2	3	0	0	3	0	0
8	45763562	.	G	A	12	14	26	2	2	30	0	0
8	45763991	.	A	G	20	11	31	0	1	32	0	0
8	45764006	.	G	C	12	20	32	0	0	32	0	0
8	45764118	.	C	T	2	20	22	0	23	45	0	0
8	45764562	.	T	C	4	5	9	0	0	9	0	0
8	45764684	.	T	C	21	0	21	0	6	27	0	0
8	45764697	.	T	C	15	8	23	0	0	23	0	0
8	45764939	.	G	A	29	18	47	0	0	47	0	0
8	45764988	.	A	T	24	26	50	1	2	53	0	0
8	45765023	.	T	A	25	24	49	6	4	59	0	0
8	45765024	.	T	A	24	24	48	6	6	60	0	0
8	45765305	.	G	A	31	27	58	0	2	60	0	0
8	45772915	.	C	A	23	17	40	0	1	41	0	0
8	45774471	.	C	T	1	16	17	0	16	33	0	0
8	45775047	.	C	T	17	16	33	0	4	37	0	0
8	45775068	.	A	T	18	15	33	0	1	34	0	0
8	45775304	.	G	A	11	16	27	0	1	28	0	0
8	45775319	.	G	T	12	12	24	0	2	26	0	0
8	45779729	.	A	C	14	16	30	0	0	30	0	0
8	45786186	.	C	T	2	11	13	0	12	25	0	0
8	45786528	.	A	G	14	10	24	0	5	29	0	0
8	45786615	.	A	G	16	8	24	0	1	25	0	0
8	45787137	.	A	G	12	20	32	0	0	32	0	0
8	45788941	.	T	G	15	15	30	0	1	31	0	0
8	45797305	.	G	A	14	16	30	0	0	30	0	0
8	45834759	.	C	T	10	8	18	0	1	19	0	0
8	45834940	.	G	A	10	9	19	0	0	19	0	0
8	45838228	.	C	T	10	10	20	0	2	22	0	0
8	45838370	.	A	G	1	2	3	0	0	3	0	0
8	45838449	.	G	A	1	2	3	0	0	3	0	0
8	45853101	.	T	C	1	3	4	0	0	4	0	0
8	45853288	.	A	C	6	4	10	0	0	10	0	0
8	45853344	.	T	A	4	4	8	0	0	8	0	0
8	45853626	.	G	A	6	3	9	0	1	10	0	0
8	45864652	.	G	C	9	8	17	0	2	19	0	0
8	45870914	.	C	A	2	4	6	0	3	9	0	0
8	45871782	.	A	G	7	7	14	0	1	15	0	0
8	45875627	.	A	G	4	3	7	0	0	7	0	0
8	45875696	.	T	G	1	7	8	0	0	8	0	0
8	45879493	.	T	C	6	0	6	0	4	10	0	0
8	45880167	.	C	T	5	5	10	0	1	11	0	0
8	45896997	.	T	C	5	0	5	0	3	8	0	0
8	45907117	.	C	T	2	4	6	0	0	6	0	0
8	45939398	.	A	G	5	2	7	0	0	7	0	0
8	45939648	.	C	G	3	2	5	1	1	10	3	0
8	45944896	.	T	A	12	15	27	0	0	27	0	0
8	45944983	.	G	A	7	11	18	0	0	18	0	0
8	45945024	.	C	T	4	6	10	0	0	10	0	0
8	45951974	.	G	A	1	5	6	0	2	8	0	0
8	45952152	.	A	T	4	4	8	0	0	8	0	0
8	45952281	.	C	T	6	4	10	0	0	10	0	0
8	45952352	.	G	C	6	5	11	0	0	11	0	0
8	45952437	.	G	A	0	6	6	0	4	10	0	0
8	45952461	.	G	A	0	4	4	0	4	8	0	0
8	45952492	.	C	A	2	5	7	0	0	7	0	0
8	45961998	.	C	A	1	1	2	0	0	2	0	0
8	45965528	.	G	T	2	2	4	0	0	4	0	0
8	45965749	.	G	A	1	2	3	0	0	3	0	0
8	45968711	.	G	A	2	2	4	0	0	4	0	0
8	45976911	.	G	A	1	3	4	0	0	4	0	0
8	46025326	.	A	G	2	2	4	0	0	4	0	0
8	46077850	.	T	A	6	7	13	0	0	13	0	0
8	46078168	.	C	A	5	4	9	0	0	9	0	0
8	46078241	.	A	T	5	10	15	0	0	15	0	0
8	46078264	.	A	T	8	6	14	0	0	14	0	0
8	46078287	.	A	G	4	7	11	0	2	13	0	0
8	46078342	.	C	G	7	5	12	0	0	12	0	0
8	46089052	.	T	C	9	21	30	0	2	32	0	0
8	46094790	.	G	A	12	10	22	0	1	23	0	0
8	46123717	.	G	A	11	7	18	0	1	19	0	0
8	46123731	.	G	A	6	12	18	0	1	19	0	0
8	46125509	.	G	A	8	3	11	0	1	12	0	0
8	46132662	.	G	C	9	0	9	0	4	13	0	0
8	46160929	.	A	G	3	4	7	0	0	7	0	0
8	46188003	.	A	G	9	9	18	0	0	18	0	0
8	46233638	.	G	T	5	5	10	0	0	10	0	0
8	46258216	.	A	G	8	10	18	0	2	20	0	0
8	46265147	.	G	A	7	6	13	0	1	14	0	0
8	46265180	.	C	A	0	3	3	0	10	13	0	0
8	46286410	.	T	C	6	5	11	0	1	12	0	0
8	46286443	.	G	A	5	7	12	0	0	12	0	0
8	46289245	.	C	T	7	4	11	0	0	11	0	0
8	46294285	.	C	T	8	4	12	0	0	12	0	0
8	46294443	.	A	G	4	6	10	0	0	10	0	0
8	46296796	.	G	A	7	7	14	0	1	15	0	0
8	46296830	.	A	G	7	4	11	0	0	11	0	0
8	46296851	.	T	C	6	3	9	0	0	9	0	0
8	46310717	.	G	A	6	6	12	0	1	13	0	0
8	46311000	.	G	A	5	6	11	0	0	11	0	0
8	46317199	.	G	A	11	4	15	0	0	15	0	0
8	46327404	.	A	G	4	9	13	0	1	14	0	0
8	46328214	.	T	C	2	8	10	0	0	10	0	0
8	46328217	.	T	C	1	8	9	0	0	9	0	0
8	46333639	.	A	T	3	4	7	0	0	7	0	0
8	46337310	.	A	G	7	4	11	0	0	11	0	0
8	46340777	.	A	G	5	0	5	0	4	9	0	0
8	46346713	.	C	T	7	4	11	0	0	11	0	0
8	46346837	.	T	C	5	8	13	0	1	14	0	0
8	46346857	.	T	C	8	5	13	0	2	15	0	0
8	46346949	.	G	T	0	2	2	0	5	7	0	0
8	46347099	.	A	T	12	5	17	0	1	18	0	0
8	46347147	.	C	T	7	5	12	0	0	12	0	0
8	46347355	.	T	C	1	2	3	0	0	3	0	0
8	46348145	.	G	T	8	3	11	0	1	12	0	0
8	46356282	.	G	A	2	4	6	0	0	6	0	0
8	46359860	.	C	T	0	3	3	0	4	7	0	0
8	46362082	.	G	A	4	7	11	0	0	11	0	0
8	46362083	.	G	T	5	7	12	0	0	12	0	0
8	46362293	.	G	A	3	4	7	0	0	7	0	0
8	46382884	.	C	T	1	8	9	0	5	14	0	0
8	46395887	.	C	T	2	3	5	0	0	5	0	0
8	46396047	.	T	G	6	3	9	0	0	9	0	0
8	46402449	.	G	A	2	4	6	0	0	6	0	0
8	46430907	.	G	C	14	10	24	0	0	24	0	0
8	46431134	.	A	G	11	11	22	0	0	22	0	0
8	46431240	.	A	C	9	14	23	0	1	24	0	0
8	46431247	.	A	T	8	17	25	0	1	26	0	0
8	46431298	.	A	G	13	16	29	0	0	29	0	0
8	46431329	.	T	A	13	10	23	0	1	24	0	0
8	46431403	.	T	G	4	9	13	0	1	14	0	0
8	46431408	.	G	A	5	10	15	0	0	15	0	0
8	46431453	.	A	T	9	14	23	0	1	24	0	0
8	46431620	.	C	T	10	9	19	0	1	20	0	0
8	46431631	.	G	C	9	10	19	0	0	19	0	0
8	46431680	.	G	C	9	9	18	0	0	18	0	0
8	46431684	.	C	T	7	11	18	0	1	19	0	0
8	46433538	.	T	C	8	13	21	0	2	23	0	0
8	46433554	.	G	C	8	12	20	0	1	21	0	0
8	46433637	.	T	C	6	7	13	0	1	14	0	0
8	46433659	.	A	T	6	5	11	0	0	11	0	0
8	46433693	.	T	C	10	5	15	0	1	16	0	0
8	46433712	.	T	A	13	5	18	0	0	18	0	0
8	46499385	.	T	A	1	3	4	0	0	4	0	0
8	46499645	.	T	C	1	2	3	0	0	3	0	0
8	46499934	.	C	T	1	2	3	0	0	3	0	0
8	46853005	.	A	T	13	18	31	0	3	34	0	0
8	46853015	.	A	T	14	15	29	0	3	32	0	0
8	46855313	.	G	A	13	14	27	0	0	27	0	0
8	46881326	.	G	T	13	9	22	0	1	23	0	0
8	46883677	.	T	A	16	8	24	0	0	24	0	0
8	46894269	.	G	A	3	3	6	0	0	6	0	0
8	46894318	.	A	G	1	3	4	0	1	5	0	0
8	46894337	.	A	T	1	3	4	0	0	4	0	0
8	47145008	.	A	G	40	40	80	0	1	81	0	0
8	47147333	.	A	T	29	32	61	0	3	64	0	0
8	47149394	.	A	G	32	30	62	0	4	66	0	0
8	47159514	.	G	A	8	3	11	0	0	11	0	0
8	47159557	.	C	A	6	6	12	0	0	12	0	0
8	47163244	.	G	A	6	3	9	0	1	10	0	0
8	47163283	.	G	A	6	6	12	0	0	12	0	0
8	47178393	.	T	A	7	11	18	0	0	18	0	0
8	47775365	.	A	G	1	4	5	0	0	5	0	0
8	47834998	.	G	A	5	5	10	0	0	10	0	0
8	47835146	.	T	C	5	8	13	0	0	13	0	0
8	47835148	.	C	T	5	7	12	0	1	13	0	0
8	47835307	.	A	T	7	7	14	0	0	14	0	0
8	47835337	.	A	G	7	5	12	0	0	12	0	0
8	47843557	.	T	A	5	5	10	0	2	12	0	0
8	47843962	.	A	T	1	6	7	0	0	7	0	0
8	47844022	.	A	G	2	6	8	0	0	8	0	0
8	47844423	.	T	C	1	0	1	0	3	4	0	0
8	47911031	.	C	G	14	0	14	0	12	26	0	0
8	47917304	.	C	T	14	16	30	0	1	31	0	0
8	47927814	.	C	T	4	9	13	0	1	14	0	0
8	47928187	.	T	A	17	10	27	0	0	27	0	0
8	47932409	.	C	T	17	9	26	0	1	27	0	0
8	47932442	.	G	A	11	14	25	0	0	25	0	0
8	47937152	.	T	C	20	14	34	0	1	35	0	0
8	47937156	.	A	G	17	0	17	0	16	33	0	0
8	47937263	.	T	C	16	18	34	0	1	35	0	0
8	47946517	.	T	C	17	8	25	0	3	28	0	0
8	47946674	.	G	A	11	8	19	0	1	20	0	0
8	47946753	.	C	T	19	7	26	0	0	26	0	0
8	47946776	.	T	C	15	14	29	0	1	30	0	0
8	47946833	.	A	G	14	21	35	0	0	35	0	0
8	47946846	.	A	G	13	21	34	0	0	34	0	0
8	47947052	.	A	C	5	7	12	0	2	14	0	0
8	47947297	.	C	T	11	12	23	0	1	24	0	0
8	47947341	.	C	A	11	10	21	0	1	22	0	0
8	47947649	.	T	A	16	10	26	0	1	28	1	0
8	47947772	.	A	G	11	2	13	0	9	22	0	0
8	47947996	.	T	G	16	7	23	1	1	25	0	0
8	47948102	.	T	A	20	14	34	0	1	35	0	0
8	47948602	.	G	A	1	9	10	0	18	28	0	0
8	47948820	.	A	C	9	6	15	0	0	15	0	0
8	47948866	.	C	A	3	5	8	0	1	9	0	0
8	48093139	.	T	C	1	3	4	0	0	4	0	0
8	48492133	.	G	A	1	2	3	0	0	3	0	0
8	48492139	.	G	A	1	2	3	0	0	3	0	0
8	48493130	.	G	A	0	3	3	0	1	4	0	0
8	48494896	.	G	A	1	2	3	0	1	4	0	0
8	48603788	.	G	C	0	11	11	0	10	21	0	0
8	48603978	.	T	A	5	5	10	0	0	10	0	0
8	48604114	.	T	A	8	4	12	0	0	12	0	0
8	48629526	.	C	A	4	2	6	0	0	6	0	0
8	48629668	.	G	A	12	4	16	0	1	17	0	0
8	48629797	.	C	A	12	5	17	0	0	17	0	0
8	48629946	.	A	T	12	10	22	0	1	23	0	0
8	48629969	.	T	C	11	0	11	0	9	20	0	0
8	48630017	.	A	G	10	4	14	0	0	14	0	0
8	48642496	.	A	G	10	8	18	0	0	18	0	0
8	48646053	.	A	G	5	5	10	0	1	11	0	0
8	48646089	.	G	A	5	7	12	0	0	12	0	0
8	48649106	.	A	C	7	8	15	0	0	15	0	0
8	48656268	.	C	A	3	7	10	0	1	11	0	0
8	48658790	.	T	G	4	2	6	0	0	6	0	0
8	48660930	.	G	A	8	4	12	0	1	13	0	0
8	48801480	.	G	A	2	6	8	2	19	29	0	0
8	48801508	.	C	T	7	23	30	0	0	30	0	0
8	48801553	.	C	T	15	8	23	0	4	27	0	0
8	48809531	.	C	G	10	8	18	0	0	18	0	0
8	48809570	.	G	A	5	9	14	0	1	15	0	0
8	48809587	.	T	G	5	6	11	0	0	11	0	0
8	48809678	.	A	C	5	12	17	0	0	17	0	0
8	48816412	.	C	G	3	3	6	0	0	6	0	0
8	48816438	.	T	G	2	2	4	0	0	4	0	0
8	48816447	.	C	T	0	2	2	0	1	3	0	0
8	48823767	.	G	A	1	2	3	0	0	3	0	0
8	48823768	.	A	T	1	2	3	0	0	3	0	0
8	48823807	.	A	G	2	2	4	0	0	4	0	0
8	48836142	.	T	C	3	0	3	0	2	5	0	0
8	48836148	.	G	A	2	2	4	0	0	4	0	0
8	48845003	.	C	T	1	2	3	0	0	3	0	0
8	48958468	.	C	T	1	3	4	0	0	4	0	0
8	48958637	.	A	G	8	12	20	0	0	20	0	0
8	48958822	.	C	T	8	8	16	0	0	16	0	0
8	48959047	.	G	A	3	9	12	0	0	12	0	0
8	48965853	.	C	G	4	3	7	0	0	7	0	0
8	48966016	.	A	C	2	3	5	0	3	8	0	0
8	48966140	.	C	G	3	6	9	0	1	10	0	0
8	48991948	.	C	T	7	5	12	0	0	12	0	0
8	49002116	.	A	G	2	0	2	0	5	7	0	0
8	49003785	.	A	G	9	0	9	0	5	14	0	0
8	49009822	.	C	A	10	7	17	0	0	17	0	0
8	49009829	.	C	T	8	11	19	0	0	19	0	0
8	49009917	.	T	C	8	11	19	0	0	19	0	0
8	49021126	.	C	T	5	7	12	0	2	14	0	0
8	49034320	.	A	G	2	7	9	0	0	9	0	0
8	49067335	.	A	T	4	2	6	0	0	6	0	0
8	49067370	.	A	T	6	2	8	0	0	8	0	0
8	49071207	.	T	A	1	2	3	0	0	3	0	0
8	49071212	.	A	C	1	3	4	0	0	4	0	0
8	49071247	.	T	A	2	4	6	0	0	6	0	0
8	49071293	.	A	T	2	3	5	0	0	5	0	0
8	49075512	.	G	A	4	7	11	0	0	11	0	0
8	49075536	.	G	A	0	5	5	0	6	11	0	0
8	49078792	.	G	A	3	6	9	0	6	15	0	0
8	49078817	.	C	T	6	2	8	0	1	9	0	0
8	49078827	.	A	C	4	2	6	0	0	6	0	0
8	49092063	.	T	A	5	9	14	0	1	15	0	0
8	49092108	.	C	T	9	14	23	0	0	23	0	0
8	49092129	.	C	T	10	11	21	0	0	21	0	0
8	49096541	.	G	T	10	4	14	1	0	15	0	0
8	49108347	.	A	T	19	11	30	0	2	32	0	0
8	49170190	.	T	A	2	9	11	0	0	11	0	0
8	49170366	.	T	A	37	35	72	0	2	74	0	0
8	49172338	.	A	G	44	27	71	0	1	72	0	0
8	49310830	.	C	T	8	8	16	0	0	16	0	0
8	49310928	.	T	C	4	7	11	0	1	12	0	0
8	49311090	.	C	T	17	17	34	0	0	34	0	0
8	49311355	.	T	C	18	22	40	0	5	45	0	0
8	49311396	.	C	A	18	20	38	0	2	40	0	0
8	49311398	.	G	C	18	19	37	0	1	38	0	0
8	49345116	.	C	T	20	17	37	0	0	37	0	0
8	49345191	.	T	C	17	24	41	0	1	42	0	0
8	49345212	.	G	T	21	18	39	0	0	39	0	0
8	49345272	.	A	G	18	19	37	0	0	37	0	0
8	49404152	.	G	T	15	17	32	0	4	36	0	0
8	49404262	.	C	T	25	33	58	1	2	61	0	0
8	49404502	.	C	T	38	25	63	2	3	68	0	0
8	49404928	.	C	T	31	37	68	0	0	68	0	0
8	49405214	.	G	C	2	2	4	0	0	4	0	0
8	49405248	.	A	G	1	2	3	0	0	3	0	0
8	49406062	.	G	C	1	2	3	2	1	6	0	0
8	49413417	.	G	T	43	36	79	0	4	83	0	0
8	49413444	.	G	A	33	34	67	0	9	76	0	0
8	49413459	.	G	A	34	33	67	0	6	73	0	0
8	49415718	.	G	C	28	28	56	0	3	59	0	0
8	49435964	.	C	G	16	8	24	0	1	25	0	0
8	49443191	.	A	G	11	0	11	0	13	24	0	0
8	49447458	.	A	T	2	2	4	0	0	4	0	0
8	49447519	.	G	A	3	6	9	0	0	9	0	0
8	49447574	.	T	G	3	7	10	0	2	12	0	0
8	49447657	.	C	A	5	6	11	0	0	12	1	0
8	49710686	.	G	A	4	13	17	0	0	17	0	0
8	49722313	.	T	C	10	7	17	0	0	17	0	0
8	49728659	.	T	A	12	10	22	0	1	23	0	0
8	49735647	.	C	G	2	2	4	0	0	4	0	0
8	49739225	.	T	C	1	2	3	0	0	3	0	0
8	49745727	.	T	G	6	4	10	0	0	10	0	0
8	49746224	.	T	C	10	15	25	1	0	26	0	0
8	49746256	.	G	A	13	12	25	0	3	28	0	0
8	49746440	.	T	C	25	25	50	0	3	53	0	0
8	49746456	.	T	G	25	27	52	1	3	56	0	0
8	49755801	.	A	C	24	23	47	0	0	47	0	0
8	49755867	.	A	T	21	18	39	0	3	42	0	0
8	49756121	.	A	T	16	17	33	0	3	36	0	0
8	49759453	.	A	G	19	22	41	0	2	43	0	0
8	49766440	.	G	A	3	2	5	0	1	6	0	0
8	49766454	.	T	A	5	2	7	0	0	7	0	0
8	49768918	.	C	T	0	1	1	0	0	1	0	0
8	49768925	.	G	A	1	2	3	0	0	3	0	0
8	49769213	.	T	A	2	2	4	0	0	4	0	0
8	49769496	.	G	A	3	4	7	0	0	7	0	0
8	49778672	.	T	G	17	15	32	0	2	34	0	0
8	49845392	.	A	G	17	13	30	0	1	31	0	0
8	49850230	.	C	T	6	8	14	0	0	14	0	0
8	49851155	.	C	G	11	10	21	0	0	21	0	0
8	49860718	.	C	T	11	15	26	0	0	26	0	0
8	49864103	.	T	C	21	14	35	0	0	35	0	0
8	49864124	.	G	A	17	18	35	0	4	39	0	0
8	49864212	.	C	T	19	14	33	0	1	34	0	0
8	49864232	.	G	A	17	13	30	0	1	31	0	0
8	49864402	.	C	T	13	13	26	0	0	26	0	0
8	49864655	.	G	T	14	10	24	0	0	24	0	0
8	49865070	.	G	A	9	5	14	0	0	14	0	0
8	49865099	.	T	G	12	3	15	0	1	16	0	0
8	49865124	.	C	T	10	5	15	0	0	15	0	0
8	49899474	.	G	A	10	9	19	0	0	19	0	0
8	49899528	.	G	A	6	6	12	0	0	12	0	0
8	49899621	.	G	A	7	10	17	0	0	17	0	0
8	49901127	.	T	C	2	0	2	0	7	9	0	0
8	49908585	.	C	T	1	3	4	0	5	9	0	0
8	49908677	.	C	T	1	4	5	0	5	10	0	0
8	49908719	.	C	T	0	3	3	0	6	9	0	0
8	49908789	.	G	T	9	7	16	0	0	16	0	0
8	49908792	.	G	A	6	8	14	0	1	15	0	0
8	49908841	.	C	T	5	5	10	0	0	10	0	0
8	49911143	.	G	A	6	10	16	0	2	18	0	0
8	49912557	.	G	A	9	5	14	0	0	14	0	0
8	49912682	.	G	A	11	5	16	0	3	19	0	0
8	49925662	.	G	T	2	4	6	0	0	6	0	0
8	49925719	.	C	T	4	2	6	0	0	6	0	0
8	49936586	.	G	T	0	4	4	0	2	6	0	0
8	49941098	.	A	T	1	4	5	0	0	5	0	0
8	49947483	.	C	T	11	8	19	0	0	19	0	0
8	49949798	.	C	T	4	6	10	0	0	10	0	0
8	49952260	.	C	T	6	14	20	0	1	21	0	0
8	49969037	.	C	T	3	4	7	0	1	8	0	0
8	49975189	.	C	A	5	3	8	0	0	8	0	0
8	49989214	.	A	C	2	4	6	0	0	6	0	0
8	49991438	.	A	G	8	7	15	0	0	15	0	0
8	49993381	.	A	C	3	4	7	1	0	8	0	0
8	49996176	.	T	C	3	4	7	0	2	9	0	0
8	50000859	.	C	A	5	5	10	0	0	10	0	0
8	50012607	.	G	A	4	8	12	0	0	12	0	0
8	50151797	.	C	T	3	7	10	0	0	10	0	0
8	50156805	.	G	A	8	8	16	0	0	16	0	0
8	50159305	.	C	T	5	5	10	0	0	10	0	0
8	50159515	.	A	G	5	5	10	0	0	10	0	0
8	50163398	.	A	G	8	0	8	0	10	18	0	0
8	50170889	.	T	C	7	10	17	0	0	17	0	0
8	50179868	.	T	A	2	8	10	0	0	10	0	0
8	50179944	.	T	G	6	4	10	0	1	11	0	0
8	50493190	.	T	C	1	2	3	0	1	4	0	0
8	50501360	.	A	G	3	3	6	0	1	7	0	0
8	50501462	.	C	T	5	4	9	0	0	9	0	0
8	50501839	.	G	A	2	2	4	0	0	4	0	0
8	50501981	.	C	T	2	4	6	0	0	6	0	0
8	50502062	.	C	T	5	3	8	0	0	8	0	0
8	50520253	.	G	T	2	4	6	0	0	6	0	0
8	50522089	.	A	G	3	2	5	0	0	5	0	0
8	50522613	.	A	G	3	4	7	0	0	7	0	0
8	50812321	.	G	A	10	6	16	0	0	16	0	0
8	50818102	.	G	T	6	4	10	0	0	10	0	0
8	50818180	.	C	T	7	5	12	0	0	12	0	0
8	50837390	.	T	C	1	2	3	0	0	3	0	0
8	50837603	.	C	T	1	3	4	0	0	4	0	0
8	50837684	.	G	C	2	7	9	0	1	10	0	0
8	50837731	.	A	G	3	3	6	0	0	6	0	0
8	50838854	.	G	A	4	4	8	0	0	8	0	0
8	50845104	.	T	C	3	6	9	0	1	10	0	0
8	50849973	.	C	T	3	8	11	0	2	13	0	0
8	50851915	.	A	T	3	2	5	0	0	5	0	0
8	50949903	.	A	G	24	0	24	0	19	43	0	0
8	51247891	.	G	C	4	4	8	0	0	8	0	0
8	51309145	.	T	G	10	19	29	0	5	34	0	0
8	51309311	.	A	G	16	15	31	0	1	32	0	0
8	51314087	.	G	A	12	22	34	0	2	36	0	0
8	51320547	.	C	T	15	14	29	0	5	34	0	0
8	51320652	.	C	T	5	9	14	2	0	16	0	0
8	51325510	.	T	G	16	12	28	0	1	29	0	0
8	51330776	.	T	C	12	13	25	0	3	28	0	0
8	51330836	.	A	T	8	9	17	0	0	17	0	0
8	51351155	.	T	A	7	2	9	0	1	10	0	0
8	51351200	.	A	T	5	13	18	0	1	19	0	0
8	51352480	.	A	G	16	14	30	0	0	30	0	0
8	51352525	.	A	T	13	16	29	1	0	30	0	0
8	51358769	.	G	A	17	11	28	0	2	30	0	0
8	51364515	.	T	C	10	8	18	0	0	18	0	0
8	51364644	.	C	A	1	9	10	0	19	29	0	0
8	51364665	.	T	C	15	10	25	0	1	26	0	0
8	51364696	.	C	G	12	9	21	0	2	23	0	0
8	51364713	.	C	A	0	7	7	0	12	19	0	0
8	51367178	.	A	T	14	8	22	0	1	23	0	0
8	51367206	.	C	T	13	7	20	0	3	23	0	0
8	51367217	.	C	T	9	14	23	0	2	25	0	0
8	51367267	.	A	T	11	10	21	0	0	21	0	0
8	51375405	.	T	G	18	15	33	0	1	34	0	0
8	51379609	.	G	A	12	18	30	0	0	30	0	0
8	51379699	.	G	A	19	8	27	0	1	28	0	0
8	51379741	.	A	T	10	12	22	0	1	23	0	0
8	51379747	.	G	A	10	12	22	0	1	23	0	0
8	51383765	.	C	T	13	12	25	0	1	26	0	0
8	51431321	.	T	A	7	5	12	0	1	13	0	0
8	51431396	.	C	T	1	5	6	0	5	11	0	0
8	51431477	.	G	A	3	4	7	0	0	7	0	0
8	51431526	.	A	T	1	4	5	0	0	5	0	0
8	51431561	.	A	G	3	3	6	0	0	6	0	0
8	51431573	.	A	T	4	6	10	0	0	10	0	0
8	51431670	.	A	G	3	3	6	0	0	6	0	0
8	51431805	.	T	A	4	4	8	0	0	8	0	0
8	51433088	.	C	T	2	5	7	0	0	7	0	0
8	51433494	.	T	C	9	2	11	0	0	11	0	0
8	51433569	.	G	A	2	2	4	0	0	4	0	0
8	51433604	.	C	T	0	3	3	0	2	5	0	0
8	51434081	.	A	G	2	5	7	0	1	8	0	0
8	51434289	.	C	T	3	3	6	0	0	6	0	0
8	51434330	.	C	A	1	4	5	0	2	7	0	0
8	51434357	.	C	G	4	5	9	0	0	9	0	0
8	51434386	.	G	C	4	3	7	0	0	7	0	0
8	51437323	.	A	G	3	6	9	0	0	9	0	0
8	51481945	.	G	A	2	7	9	1	0	10	0	0
8	51482050	.	A	G	4	5	9	0	1	10	0	0
8	51485224	.	C	T	2	3	5	0	0	5	0	0
8	51573385	.	C	T	1	4	5	0	0	5	0	0
8	51573406	.	A	T	1	3	4	0	0	4	0	0
8	51573439	.	T	C	1	2	3	0	0	3	0	0
8	51573441	.	T	C	1	2	3	0	0	3	0	0
8	51576856	.	C	T	0	5	5	0	1	6	0	0
8	51576887	.	C	T	0	4	4	0	3	7	0	0
8	51576925	.	C	T	1	3	4	0	3	7	0	0
8	51579224	.	C	G	0	8	8	0	3	11	0	0
8	51579225	.	G	A	3	8	11	0	0	11	0	0
8	51589375	.	A	G	2	2	4	0	0	4	0	0
8	51589429	.	G	A	1	3	4	0	1	5	0	0
8	51594642	.	A	C	4	0	4	0	5	9	0	0
8	51594678	.	C	T	5	2	7	0	0	7	0	0
8	51599096	.	A	G	1	4	5	0	0	5	0	0
8	51634935	.	T	C	5	0	5	0	4	9	0	0
8	51635673	.	A	C	2	0	2	0	3	5	0	0
8	51635691	.	T	G	1	4	5	0	0	5	0	0
8	51635844	.	G	A	2	5	7	0	0	7	0	0
8	51635913	.	T	C	2	3	5	0	1	6	0	0
8	51710753	.	C	T	3	2	5	0	1	6	0	0
8	51716391	.	T	C	1	4	5	0	0	5	0	0
8	51716502	.	A	G	1	0	1	0	3	4	0	0
8	51718619	.	T	C	3	2	5	0	0	5	0	0
8	51721300	.	C	T	3	2	5	0	0	5	0	0
8	51723249	.	A	G	4	4	8	4	0	12	0	0
8	51723320	.	A	G	2	13	15	5	0	20	0	0
8	51723713	.	C	A	3	4	7	0	0	7	0	0
8	51723957	.	T	C	6	3	9	0	0	9	0	0
8	51723984	.	A	T	4	5	9	0	0	9	0	0
8	51724029	.	T	G	5	5	10	0	0	10	0	0
8	51724067	.	C	T	9	3	12	0	1	13	0	0
8	51724288	.	G	A	3	4	7	0	0	7	0	0
8	51724371	.	A	T	1	3	4	0	0	4	0	0
8	51724748	.	G	T	0	1	1	0	3	6	2	0
8	51724928	.	G	T	2	4	6	0	0	6	0	0
8	51724974	.	G	A	1	5	6	0	0	6	0	0
8	51725237	.	C	G	7	1	8	1	0	9	0	0
8	51725241	.	G	T	7	2	9	1	0	10	0	0
8	51726260	.	C	G	2	4	6	0	0	6	0	0
8	52226378	.	A	C	1	4	5	0	0	5	0	0
8	52230004	.	A	C	5	0	5	0	3	8	0	0
8	52284108	.	G	A	2	2	4	0	0	4	0	0
8	52292515	.	T	C	11	4	15	0	1	16	0	0
8	52296833	.	T	G	8	2	10	0	0	10	0	0
8	52296834	.	T	G	8	2	10	0	0	10	0	0
8	52297608	.	A	G	3	6	9	0	0	9	0	0
8	52297790	.	T	A	5	2	7	0	0	7	0	0
8	52314602	.	G	A	2	3	5	0	0	5	0	0
8	52314637	.	G	T	1	8	9	0	8	17	0	0
8	52322189	.	C	G	5	0	5	0	8	13	0	0
8	52324918	.	A	G	7	8	15	0	1	16	0	0
8	52334574	.	G	A	1	2	3	0	0	3	0	0
8	52336870	.	T	C	9	9	18	0	0	18	0	0
8	52342586	.	A	C	9	12	21	0	1	23	1	0
8	52345733	.	T	C	10	9	19	0	0	19	0	0
8	52345751	.	T	C	13	12	25	0	0	25	0	0
8	52345915	.	T	C	12	7	19	0	1	20	0	0
8	52346035	.	T	C	4	7	11	0	1	12	0	0
8	52346072	.	A	T	4	2	6	0	0	6	0	0
8	52346111	.	A	C	3	4	7	0	1	8	0	0
8	52347460	.	C	T	6	12	18	0	0	18	0	0
8	52347694	.	A	G	0	0	0	0	6	6	0	0
8	52347714	.	A	G	6	4	10	0	1	11	0	0
8	52347772	.	A	G	7	6	13	0	2	15	0	0
8	52348575	.	A	G	7	4	11	1	0	12	0	0
8	52348576	.	A	G	7	4	11	1	0	12	0	0
8	52348622	.	A	G	4	9	13	1	0	14	0	0
8	52348685	.	T	C	10	4	14	0	1	15	0	0
8	52349080	.	T	G	8	4	12	0	0	12	0	0
8	52349986	.	A	G	6	2	8	0	1	9	0	0
8	52350101	.	A	G	10	0	10	1	5	17	1	0
8	52350146	.	A	G	9	0	9	0	9	18	0	0
8	52350251	.	A	G	7	10	17	0	1	18	0	0
8	52350322	.	T	G	1	4	5	0	0	5	0	0
8	52408619	.	G	A	29	21	50	0	1	51	0	0
8	52411451	.	T	C	22	19	41	0	1	42	0	0
8	52412982	.	A	G	22	18	40	1	0	41	0	0
8	52412985	.	C	G	20	17	37	1	1	39	0	0
8	52453432	.	A	C	3	3	6	0	0	6	0	0
8	52453862	.	T	A	8	8	16	0	0	16	0	0
8	52455588	.	A	G	8	7	15	0	0	15	0	0
8	52455610	.	A	G	6	9	15	0	0	15	0	0
8	52455638	.	C	G	7	6	13	0	0	13	0	0
8	52463828	.	T	A	4	5	9	0	0	9	0	0
8	52463855	.	C	T	0	2	2	0	2	4	0	0
8	52472930	.	C	G	5	9	14	1	2	17	0	0
8	52472955	.	C	T	0	7	7	1	10	18	0	0
8	52472997	.	T	C	2	5	7	0	0	7	0	0
8	52491586	.	G	A	11	13	24	0	0	24	0	0
8	52509568	.	C	A	7	5	12	0	0	12	0	0
8	52509624	.	G	A	2	8	10	0	0	10	0	0
8	52509762	.	A	T	6	5	11	0	1	12	0	0
8	52509949	.	A	T	4	1	5	0	0	5	0	0
8	52509959	.	C	T	4	3	7	0	0	7	0	0
8	52510020	.	G	T	1	2	3	0	0	3	0	0
8	52510088	.	C	T	2	5	7	0	0	7	0	0
8	52510222	.	C	T	2	7	9	0	0	9	0	0
8	52510243	.	T	C	1	6	7	0	0	7	0	0
8	52521261	.	T	C	5	2	7	0	1	8	0	0
8	52521280	.	T	G	5	3	8	0	1	9	0	0
8	52521310	.	T	A	2	7	9	0	0	9	0	0
8	52521415	.	A	T	5	6	11	0	0	11	0	0
8	52521802	.	A	T	7	4	11	0	1	12	0	0
8	52521832	.	T	G	5	0	5	0	6	11	0	0
8	52524436	.	A	T	13	11	24	0	0	24	0	0
8	52527359	.	C	G	3	3	6	0	1	7	0	0
8	52527391	.	A	T	3	4	7	0	1	8	0	0
8	52527486	.	G	A	3	6	9	0	0	9	0	0
8	52527547	.	A	C	6	7	13	0	2	15	0	0
8	52528717	.	A	G	4	16	20	0	0	20	0	0
8	52528855	.	A	G	7	0	7	0	2	9	0	0
8	52528856	.	C	G	5	3	8	0	0	8	0	0
8	52529169	.	A	G	8	6	14	0	0	14	0	0
8	52529206	.	T	C	8	7	15	0	0	15	0	0
8	52529397	.	A	G	11	6	17	0	0	17	0	0
8	52534158	.	A	G	1	4	5	0	0	5	0	0
8	52537984	.	A	G	8	0	8	0	5	13	0	0
8	52538042	.	A	T	4	4	8	0	1	9	0	0
8	52543717	.	C	A	2	10	12	0	1	13	0	0
8	52547038	.	T	G	13	11	24	0	0	24	0	0
8	52547091	.	T	C	10	6	16	0	0	16	0	0
8	52547356	.	A	G	9	7	16	0	1	17	0	0
8	52547522	.	C	T	3	6	9	0	0	9	0	0
8	52547523	.	G	A	1	5	6	0	3	9	0	0
8	52547569	.	T	A	4	5	9	0	0	9	0	0
8	52547664	.	A	C	4	6	10	0	0	10	0	0
8	52547677	.	C	T	3	6	9	0	0	9	0	0
8	52547706	.	A	T	3	8	11	0	0	12	1	0
8	52547727	.	G	C	2	10	12	0	1	13	0	0
8	52547787	.	T	A	3	3	6	0	0	6	0	0
8	52550462	.	A	G	4	4	8	0	0	8	0	0
8	52550502	.	T	A	2	5	7	0	0	7	0	0
8	52553193	.	A	T	8	6	14	0	2	16	0	0
8	52553197	.	A	G	9	7	16	0	1	17	0	0
8	52554679	.	T	C	10	0	10	0	7	17	0	0
8	52554937	.	T	G	7	5	12	0	0	12	0	0
8	52554983	.	C	T	7	5	12	0	1	13	0	0
8	52555018	.	T	G	6	12	18	0	0	18	0	0
8	52555050	.	G	A	7	14	21	0	1	22	0	0
8	52555077	.	C	G	7	15	22	0	0	22	0	0
8	52555112	.	G	T	2	11	13	0	1	14	0	0
8	52555137	.	G	A	3	10	13	0	0	13	0	0
8	52557454	.	G	T	3	7	10	0	0	10	0	0
8	52562746	.	C	T	6	5	11	0	0	11	0	0
8	52564816	.	T	C	9	6	15	0	0	15	0	0
8	52564922	.	C	T	7	8	15	0	0	15	0	0
8	52565319	.	T	C	3	2	5	0	1	6	0	0
8	52571198	.	T	C	2	5	7	0	0	7	0	0
8	52575981	.	G	A	3	5	8	0	0	8	0	0
8	52576003	.	A	G	2	7	9	0	0	9	0	0
8	52576054	.	C	T	0	5	5	0	3	8	0	0
8	52580094	.	A	G	5	7	12	0	1	13	0	0
8	52580169	.	A	G	6	10	16	0	0	16	0	0
8	52580196	.	A	T	5	6	11	0	0	11	0	0
8	52586799	.	T	C	2	0	2	0	5	7	0	0
8	52588540	.	G	A	6	2	8	0	0	8	0	0
8	52624026	.	C	T	1	2	3	0	0	3	0	0
8	52628004	.	G	A	0	3	3	0	1	4	0	0
8	52628063	.	T	C	2	3	5	0	0	5	0	0
8	52628101	.	C	G	2	3	5	0	0	5	0	0
8	52628114	.	T	C	1	2	3	0	0	3	0	0
8	52630358	.	G	A	1	1	2	0	1	3	0	0
8	52630366	.	A	G	1	0	1	0	1	2	0	0
8	52637608	.	G	A	1	2	3	0	0	3	0	0
8	52646441	.	T	C	2	2	4	0	0	4	0	0
8	52815213	.	T	C	1	3	4	0	0	4	0	0
8	52824680	.	T	C	1	2	3	0	0	3	0	0
8	53069348	.	G	A	1	6	7	0	0	7	0	0
8	53069447	.	G	C	0	2	2	0	1	3	0	0
8	53082186	.	G	C	5	7	12	0	1	13	0	0
8	53087090	.	C	T	6	3	9	0	0	9	0	0
8	53087121	.	C	A	4	3	7	0	0	7	0	0
8	53089843	.	G	A	0	5	5	0	3	8	0	0
8	53095146	.	G	A	12	9	21	0	0	21	0	0
8	53095179	.	A	G	9	7	16	0	3	19	0	0
8	53150421	.	G	A	7	2	9	1	1	11	0	0
8	53150446	.	T	C	3	1	4	0	5	9	0	0
8	53150708	.	T	C	7	3	10	0	0	10	0	0
8	53398556	.	A	G	5	5	10	0	0	10	0	0
8	53398564	.	A	G	5	6	11	0	0	11	0	0
8	53596850	.	C	G	1	0	1	0	3	4	0	0
8	53639832	.	A	T	2	2	4	0	2	6	0	0
8	53664327	.	T	C	5	8	13	0	0	13	0	0
8	53751413	.	G	A	8	3	11	0	0	11	0	0
8	53752762	.	C	T	1	5	6	0	4	10	0	0
8	53756168	.	C	T	3	4	7	0	0	7	0	0
8	53759687	.	T	C	1	0	1	0	4	5	0	0
8	53767767	.	G	A	1	5	6	0	0	6	0	0
8	53769634	.	C	T	1	4	5	0	5	10	0	0
8	53794163	.	T	A	11	15	26	0	1	27	0	0
8	53794250	.	T	C	21	14	35	0	1	36	0	0
8	53794943	.	T	G	11	9	20	0	2	22	0	0
8	53795006	.	C	T	16	11	27	0	0	27	0	0
8	53795162	.	A	G	12	8	20	0	1	21	0	0
8	53795249	.	G	A	8	11	19	0	1	20	0	0
8	53795411	.	T	C	10	9	19	0	1	20	0	0
8	53795602	.	T	A	12	21	33	0	1	34	0	0
8	53795636	.	A	T	9	20	29	0	0	29	0	0
8	53795640	.	A	G	9	21	30	0	1	31	0	0
8	53795684	.	T	C	7	1	8	0	12	20	0	0
8	53795692	.	G	A	7	10	17	0	0	17	0	0
8	53795892	.	G	T	15	24	39	0	2	41	0	0
8	53796620	.	G	A	4	9	13	0	2	15	0	0
8	53796657	.	C	T	7	3	10	0	1	11	0	0
8	53796833	.	T	C	9	4	13	0	2	15	0	0
8	53797040	.	A	G	14	12	26	0	2	28	0	0
8	53797118	.	G	T	11	14	25	0	0	25	0	0
8	53797265	.	C	T	10	9	19	0	0	19	0	0
8	53797451	.	C	T	0	9	9	0	10	19	0	0
8	53797741	.	T	G	8	10	18	0	0	18	0	0
8	53797802	.	A	C	8	7	15	0	1	16	0	0
8	53798130	.	A	G	11	9	20	0	0	20	0	0
8	53798168	.	A	G	13	7	20	0	1	21	0	0
8	53798321	.	T	A	3	12	15	0	3	19	1	0
8	53798333	.	G	A	7	12	19	0	0	19	0	0
8	53798450	.	T	G	9	18	27	0	0	27	0	0
8	53798864	.	A	G	7	18	25	0	0	25	0	0
8	53798981	.	C	T	0	7	7	0	11	18	0	0
8	53799017	.	A	G	8	8	16	0	1	17	0	0
8	53799491	.	T	A	5	4	9	0	2	11	0	0
8	53799521	.	G	A	9	6	15	0	1	16	0	0
8	53800064	.	A	G	5	13	18	0	0	18	0	0
8	53803121	.	G	T	2	15	17	0	0	17	0	0
8	53803139	.	A	T	4	12	16	0	0	16	0	0
8	53803376	.	T	C	9	10	19	0	5	24	0	0
8	53848556	.	C	T	2	2	4	0	0	4	0	0
8	53849352	.	C	T	2	2	4	0	0	4	0	0
8	53851453	.	C	T	0	4	4	0	3	7	0	0
8	53866884	.	C	T	4	5	9	0	0	9	0	0
8	53867228	.	A	G	2	4	6	0	0	6	0	0
8	53876632	.	C	T	4	9	13	0	0	13	0	0
8	53876716	.	G	A	3	10	13	0	0	13	0	0
8	53918323	.	A	T	3	4	7	0	0	7	0	0
8	53918472	.	T	C	9	7	16	0	0	16	0	0
8	53918600	.	T	A	4	6	10	0	0	10	0	0
8	53918664	.	C	T	7	6	13	0	1	14	0	0
8	53918730	.	T	C	5	6	11	0	1	12	0	0
8	53918790	.	G	T	7	7	14	0	0	14	0	0
8	53919124	.	C	A	4	7	11	0	0	11	0	0
8	53921722	.	A	G	8	4	12	0	0	12	0	0
8	53921779	.	G	A	10	13	23	0	0	23	0	0
8	53921797	.	A	G	11	15	26	0	0	26	0	0
8	53921815	.	A	G	14	17	31	0	0	31	0	0
8	53922034	.	A	G	2	10	12	0	0	12	0	0
8	53940977	.	T	C	5	5	10	0	0	10	0	0
8	53942440	.	T	C	3	8	11	0	0	11	0	0
8	53948412	.	C	T	6	9	15	0	0	15	0	0
8	53948434	.	G	A	9	4	13	0	2	15	0	0
8	53948501	.	T	C	7	10	17	0	1	18	0	0
8	53949706	.	G	A	17	17	34	0	1	35	0	0
8	53950181	.	T	C	13	0	13	0	14	27	0	0
8	53953420	.	C	G	10	8	18	0	0	18	0	0
8	53956476	.	T	G	10	8	18	0	1	19	0	0
8	53956530	.	T	G	8	15	23	0	0	23	0	0
8	53959378	.	T	C	13	18	31	0	0	31	0	0
8	53984570	.	C	T	0	5	5	0	1	6	0	0
8	54013347	.	A	T	14	10	24	0	0	24	0	0
8	54013556	.	T	A	19	6	25	0	1	26	0	0
8	54013594	.	G	T	7	9	16	0	4	20	0	0
8	54128964	.	A	G	12	1	13	0	11	24	0	0
8	54129735	.	G	A	1	14	15	0	18	33	0	0
8	54129767	.	G	A	11	19	30	0	2	32	0	0
8	54129774	.	T	C	14	20	34	0	0	34	0	0
8	54129867	.	A	C	16	9	25	0	1	26	0	0
8	54130103	.	T	G	5	4	9	0	1	10	0	0
8	54130203	.	T	G	6	7	13	0	0	13	0	0
8	54130249	.	T	C	11	3	14	0	1	15	0	0
8	54130253	.	G	A	11	5	16	0	0	16	0	0
8	54130346	.	A	G	4	0	4	0	7	11	0	0
8	54131889	.	T	G	9	7	16	0	2	19	1	0
8	54132024	.	C	G	11	9	20	0	0	20	0	0
8	54132044	.	C	T	8	7	15	0	2	17	0	0
8	54132084	.	C	G	6	8	14	0	0	14	0	0
8	54132248	.	T	A	7	2	9	2	0	11	0	0
8	54132531	.	A	G	1	2	3	0	0	3	0	0
8	54133376	.	A	G	10	18	28	0	1	29	0	0
8	54133403	.	A	T	10	8	18	0	0	18	0	0
8	54133450	.	G	A	9	6	15	0	0	15	0	0
8	54133522	.	G	A	7	13	20	0	1	21	0	0
8	54135717	.	T	C	5	2	7	0	0	7	0	0
8	54137658	.	T	C	8	4	12	0	0	12	0	0
8	54137805	.	T	G	9	3	12	0	0	12	0	0
8	54142752	.	C	T	6	6	12	0	0	12	0	0
8	54142959	.	A	G	6	4	10	0	0	10	0	0
8	54147056	.	T	C	7	5	12	0	0	12	0	0
8	54155012	.	C	A	13	9	22	0	0	23	1	0
8	54202655	.	C	T	15	9	24	0	0	24	0	0
8	54203198	.	A	G	14	10	24	0	0	24	0	0
8	54208231	.	A	G	14	14	28	0	0	28	0	0
8	54208282	.	C	T	11	8	19	0	1	20	0	0
8	54208572	.	C	T	13	21	34	0	2	36	0	0
8	54210066	.	G	A	16	18	34	0	1	35	0	0
8	54210081	.	C	T	15	19	34	0	1	36	1	0
8	54213074	.	G	A	5	11	16	0	1	17	0	0
8	54213461	.	A	G	3	5	8	0	0	8	0	0
8	54213462	.	C	T	3	5	8	0	0	8	0	0
8	54220876	.	T	A	14	20	34	0	0	34	0	0
8	54221065	.	A	T	26	19	45	1	2	49	1	0
8	54221243	.	T	C	22	0	22	0	19	41	0	0
8	54221573	.	T	C	19	3	22	0	15	37	0	0
8	54221812	.	G	C	31	25	56	0	0	57	1	0
8	54221927	.	C	T	27	23	50	0	0	50	0	0
8	54221966	.	G	A	27	21	48	0	1	49	0	0
9	10268	.	C	A	1	2	3	0	0	3	0	0
9	10296	.	C	A	0	2	2	0	1	3	0	0
9	11863	.	C	A	3	2	5	0	0	5	0	0
9	24528	.	C	T	19	18	37	0	0	37	0	0
9	37058	.	G	A	18	15	33	0	2	35	0	0
9	37199	.	G	A	17	24	41	0	1	42	0	0
9	37830	.	C	T	1	16	17	0	18	35	0	0
9	52064	.	G	C	14	7	21	4	1	26	0	0
9	54479	.	C	T	12	21	33	0	0	33	0	0
9	62205	.	C	G	17	0	17	0	2	24	5	0
9	62336	.	T	C	16	20	36	0	1	37	0	0
9	62351	.	A	G	16	14	30	0	4	34	0	0
9	62528	.	T	G	19	15	34	0	4	38	0	0
9	63313	.	G	A	17	17	34	0	2	36	0	0
9	63418	.	G	A	12	16	28	0	1	29	0	0
9	63532	.	G	A	15	14	29	0	1	30	0	0
9	63604	.	G	A	8	14	22	0	0	22	0	0
9	64739	.	C	A	0	5	5	0	8	13	0	0
9	70215	.	G	T	4	2	6	0	0	6	0	0
9	71641	.	A	G	2	0	2	0	3	5	0	0
9	75570	.	C	A	3	4	7	0	2	9	0	0
9	78365	.	A	G	3	4	7	0	0	7	0	0
9	78506	.	T	C	3	2	5	0	0	5	0	0
9	82627	.	G	A	1	4	5	0	1	6	0	0
9	82903	.	C	G	2	0	2	0	2	4	0	0
9	83092	.	C	T	4	8	12	0	0	12	0	0
9	83116	.	A	G	7	7	14	0	1	15	0	0
9	83133	.	G	C	8	6	14	0	0	14	0	0
9	83347	.	A	G	7	3	10	0	1	11	0	0
9	83365	.	A	C	5	4	9	0	2	11	0	0
9	83629	.	G	A	0	2	2	0	5	7	0	0
9	84216	.	G	A	8	6	14	0	0	14	0	0
9	84247	.	A	G	3	0	3	0	3	6	0	0
9	84293	.	A	G	4	5	9	0	0	9	0	0
9	84487	.	A	G	7	4	11	0	0	11	0	0
9	84515	.	G	A	0	5	5	0	4	9	0	0
9	84617	.	A	T	6	6	12	0	0	12	0	0
9	84814	.	A	G	4	0	4	0	7	11	0	0
9	85318	.	T	C	8	4	12	0	0	12	0	0
9	85846	.	A	G	3	4	7	0	0	7	0	0
9	86089	.	A	G	8	6	14	0	0	14	0	0
9	86107	.	C	G	10	8	18	0	0	18	0	0
9	86439	.	T	C	2	6	8	0	3	11	0	0
9	86462	.	G	T	4	8	12	0	0	12	0	0
9	86719	.	T	C	7	5	12	0	1	13	0	0
9	86767	.	T	C	3	9	12	0	1	13	0	0
9	86830	.	T	C	7	6	13	1	0	14	0	0
9	89407	.	C	T	8	10	18	0	1	19	0	0
9	90189	.	A	G	8	8	16	0	5	21	0	0
9	90507	.	G	C	0	8	8	0	6	14	0	0
9	94276	.	T	C	12	13	25	0	1	26	0	0
9	97312	.	G	A	1	5	6	0	0	6	0	0
9	97348	.	G	A	2	4	6	0	0	6	0	0
9	98451	.	G	A	2	3	5	0	0	5	0	0
9	104840	.	G	A	10	7	17	0	2	19	0	0
9	104862	.	T	G	9	6	15	0	0	15	0	0
9	105091	.	C	T	0	5	5	0	17	22	0	0
9	134835	.	C	T	0	3	3	0	2	5	0	0
9	134945	.	C	T	1	6	7	0	6	13	0	0
9	134949	.	C	T	0	6	6	0	6	12	0	0
9	134999	.	C	T	0	7	7	0	6	13	0	0
9	135149	.	C	T	1	4	5	0	2	7	0	0
9	135151	.	G	T	2	4	6	0	1	7	0	0
9	135532	.	G	T	1	5	6	0	0	6	0	0
9	145209	.	A	G	3	3	6	0	1	7	0	0
9	145214	.	C	T	4	4	8	0	0	8	0	0
9	147357	.	A	G	5	5	10	0	1	11	0	0
9	148333	.	G	A	1	8	9	1	5	15	0	0
9	148339	.	A	G	4	7	11	1	1	13	0	0
9	149078	.	G	A	1	9	10	0	9	19	0	0
9	149215	.	C	A	10	14	24	0	1	25	0	0
9	149251	.	A	T	16	9	25	0	0	25	0	0
9	153001	.	C	T	8	12	20	0	0	20	0	0
9	168754	.	T	C	6	1	7	0	4	11	0	0
9	168848	.	T	C	7	3	10	0	0	10	0	0
9	168918	.	A	G	8	4	12	0	0	12	0	0
9	168971	.	T	C	4	0	4	0	5	9	0	0
9	169072	.	T	A	11	4	15	0	0	15	0	0
9	169806	.	G	C	22	1	23	0	9	32	0	0
9	170845	.	G	T	15	15	30	0	0	30	0	0
9	170945	.	G	A	19	9	28	0	0	28	0	0
9	172661	.	C	T	10	18	28	0	1	29	0	0
9	180245	.	G	A	15	19	34	0	1	35	0	0
9	209444	.	T	A	2	4	6	0	0	6	0	0
9	225220	.	T	A	16	11	27	0	0	27	0	0
9	225257	.	C	T	13	7	20	0	2	22	0	0
9	225362	.	T	C	11	12	23	0	2	25	0	0
9	225371	.	T	C	10	15	25	0	1	26	0	0
9	225599	.	C	T	11	8	19	0	2	21	0	0
9	225656	.	C	T	11	10	21	0	1	22	0	0
9	226168	.	C	T	8	9	17	0	0	17	0	0
9	227072	.	C	T	10	7	17	0	0	17	0	0
9	233295	.	A	G	9	0	9	0	10	19	0	0
9	233922	.	C	T	6	8	14	0	1	15	0	0
9	234328	.	G	A	14	11	25	0	2	27	0	0
9	235262	.	G	T	2	8	10	0	8	18	0	0
9	235365	.	T	A	12	11	23	0	0	23	0	0
9	235567	.	C	G	11	8	19	0	2	21	0	0
9	253264	.	T	C	16	1	17	0	23	40	0	0
9	254484	.	A	G	39	21	60	0	5	65	0	0
9	257890	.	A	T	34	20	54	0	4	58	0	0
9	257926	.	G	C	30	1	31	0	29	60	0	0
9	262487	.	A	G	22	30	52	0	3	55	0	0
9	262511	.	C	T	4	29	33	0	23	56	0	0
9	266053	.	T	C	20	10	30	0	1	31	0	0
9	266227	.	T	C	16	38	54	0	0	54	0	0
9	266255	.	C	T	18	35	53	0	2	55	0	0
9	266445	.	G	C	30	25	55	0	1	56	0	0
9	266572	.	T	C	24	0	24	0	28	52	0	0
9	266721	.	A	G	19	16	35	0	0	35	0	0
9	266802	.	A	C	23	23	46	0	1	47	0	0
9	266910	.	G	A	24	21	45	0	0	45	0	0
9	267081	.	A	G	30	29	59	0	0	59	0	0
9	267290	.	G	A	27	36	63	0	0	63	0	0
9	275474	.	G	A	29	30	59	0	4	63	0	0
9	276059	.	A	G	23	30	53	1	2	56	0	0
9	278150	.	A	G	32	27	59	0	1	60	0	0
9	278174	.	G	A	32	23	55	0	5	60	0	0
9	282686	.	C	T	28	21	49	0	2	51	0	0
9	282737	.	T	C	28	1	29	0	28	57	0	0
9	296052	.	G	A	25	30	55	0	2	57	0	0
9	296177	.	T	A	41	24	65	0	2	67	0	0
9	296181	.	T	C	39	1	40	0	24	64	0	0
9	299247	.	C	T	4	2	6	1	0	7	0	0
9	301535	.	A	T	8	4	12	0	0	12	0	0
9	302720	.	T	C	6	10	16	0	0	16	0	0
9	303032	.	C	G	5	8	13	0	0	13	0	0
9	303061	.	T	C	1	0	1	0	11	12	0	0
9	303070	.	T	C	3	9	12	0	1	13	0	0
9	303288	.	C	T	2	9	11	0	4	15	0	0
9	323588	.	A	G	2	6	8	0	1	9	0	0
9	323762	.	T	C	10	5	15	0	0	15	0	0
9	323861	.	C	T	2	2	4	0	0	4	0	0
9	323893	.	C	T	3	2	5	0	0	5	0	0
9	323904	.	G	T	2	2	4	0	0	4	0	0
9	327880	.	G	T	1	2	3	0	0	3	0	0
9	331672	.	C	T	3	3	6	0	2	8	0	0
9	331771	.	G	T	5	2	7	0	0	7	0	0
9	332777	.	A	T	3	3	6	0	0	6	0	0
9	332779	.	A	T	3	3	6	0	0	6	0	0
9	335985	.	A	G	3	0	3	1	4	8	0	0
9	336776	.	G	T	7	4	11	0	0	11	0	0
9	336852	.	A	T	5	5	10	0	0	10	0	0
9	336863	.	A	G	6	0	6	0	4	10	0	0
9	339332	.	T	C	6	9	15	0	0	15	0	0
9	340075	.	T	C	9	4	13	0	0	13	0	0
9	340076	.	A	T	9	4	13	0	0	13	0	0
9	340170	.	T	C	4	5	9	0	0	9	0	0
9	340193	.	C	G	2	1	3	0	1	4	0	0
9	350715	.	T	C	1	2	3	0	1	4	0	0
9	355324	.	A	G	6	4	10	0	0	10	0	0
9	355348	.	G	A	7	5	12	0	0	12	0	0
9	355411	.	A	C	4	4	8	0	1	9	0	0
9	358679	.	C	G	2	6	8	0	2	10	0	0
9	358737	.	T	A	8	3	11	0	0	11	0	0
9	360846	.	G	A	3	2	5	0	0	5	0	0
9	360894	.	A	G	3	6	9	0	0	9	0	0
9	362906	.	G	T	3	3	6	0	0	6	0	0
9	427848	.	A	G	2	0	2	0	5	7	0	0
9	428788	.	T	C	2	3	5	0	0	5	0	0
9	429277	.	A	T	6	7	13	0	0	13	0	0
9	430071	.	T	C	8	10	18	0	1	19	0	0
9	430125	.	G	T	0	7	7	0	6	13	0	0
9	431089	.	C	T	2	4	6	0	1	7	0	0
9	431137	.	C	T	1	5	6	0	1	7	0	0
9	448665	.	A	G	2	3	5	0	1	6	0	0
9	448668	.	C	G	3	3	6	0	0	6	0	0
9	453764	.	G	A	3	3	6	0	0	6	0	0
9	458995	.	T	A	13	13	26	0	2	28	0	0
9	459042	.	A	T	10	11	21	0	0	21	0	0
9	459754	.	C	T	11	9	20	0	2	22	0	0
9	459755	.	T	C	11	0	11	0	11	22	0	0
9	462959	.	T	G	16	3	19	0	2	21	0	0
9	463005	.	A	C	13	10	23	0	0	23	0	0
9	463010	.	T	C	13	1	14	0	10	24	0	0
9	468064	.	A	G	4	3	7	2	0	9	0	0
9	468067	.	A	G	5	3	8	2	0	10	0	0
9	504375	.	G	A	0	4	4	0	1	5	0	0
9	511884	.	C	T	6	3	9	0	0	9	0	0
9	511935	.	C	A	3	7	10	0	0	10	0	0
9	511947	.	C	T	9	3	12	0	0	12	0	0
9	525826	.	C	T	5	4	9	0	0	9	0	0
9	527777	.	T	C	1	3	4	0	0	4	0	0
9	527867	.	A	T	6	3	9	0	0	9	0	0
9	527969	.	G	A	0	5	5	0	4	9	0	0
9	528114	.	A	G	4	2	6	0	0	6	0	0
9	528540	.	A	T	4	2	6	0	0	6	0	0
9	528545	.	G	A	0	1	1	0	5	6	0	0
9	528762	.	G	T	4	2	6	0	0	6	0	0
9	529147	.	C	T	3	3	6	0	1	7	0	0
9	529930	.	G	A	2	4	6	0	0	6	0	0
9	581074	.	T	G	1	0	1	0	3	4	0	0
9	585887	.	A	G	7	12	19	0	0	19	0	0
9	588454	.	A	G	9	9	18	0	1	19	0	0
9	588456	.	C	T	9	10	19	0	0	19	0	0
9	596596	.	G	A	4	8	12	0	2	14	0	0
9	597342	.	C	T	9	7	16	0	1	17	0	0
9	598720	.	A	G	5	10	15	0	1	16	0	0
9	598795	.	A	G	10	13	23	0	2	25	0	0
9	598819	.	G	A	9	11	20	0	2	22	0	0
9	600609	.	G	A	2	8	10	0	0	10	0	0
9	606784	.	T	A	8	3	11	0	0	11	0	0
9	606838	.	A	G	8	5	13	0	0	13	0	0
9	607208	.	G	A	5	2	7	0	0	7	0	0
9	608623	.	C	T	5	9	14	0	0	14	0	0
9	609055	.	C	T	2	4	6	0	0	6	0	0
9	611470	.	G	C	7	5	12	0	0	12	0	0
9	612636	.	G	A	6	7	13	0	0	13	0	0
9	619328	.	G	A	4	6	10	0	0	10	0	0
9	627648	.	C	A	1	5	6	0	2	8	0	0
9	701575	.	A	T	8	5	13	0	0	13	0	0
9	707741	.	G	A	1	2	3	0	0	3	0	0
9	707742	.	T	C	1	2	3	0	0	3	0	0
9	707996	.	C	T	3	18	21	0	14	35	0	0
9	717840	.	G	A	11	12	23	0	0	23	0	0
9	717849	.	T	C	11	13	24	0	0	24	0	0
9	719729	.	G	A	10	10	20	0	0	20	0	0
9	721472	.	C	T	2	9	11	0	16	27	0	0
9	721822	.	T	A	7	10	17	0	1	18	0	0
9	721829	.	A	G	6	10	16	0	0	16	0	0
9	721916	.	C	A	15	5	20	0	0	20	0	0
9	722965	.	A	G	13	10	23	0	1	24	0	0
9	723004	.	G	A	19	11	30	0	0	30	0	0
9	723044	.	C	T	14	5	19	0	1	20	0	0
9	723425	.	T	C	10	0	10	0	6	16	0	0
9	723428	.	T	A	9	5	14	0	2	16	0	0
9	724532	.	G	A	10	4	14	0	0	14	0	0
9	724616	.	G	A	13	4	17	0	1	19	1	0
9	726870	.	A	G	7	4	11	0	0	11	0	0
9	728531	.	C	A	1	3	4	0	5	9	0	0
9	729672	.	A	G	5	5	10	0	0	10	0	0
9	730515	.	C	T	9	7	16	0	0	16	0	0
9	730539	.	C	A	10	6	16	0	0	16	0	0
9	731356	.	G	A	9	4	13	0	0	13	0	0
9	732191	.	C	T	0	8	8	0	9	17	0	0
9	732218	.	G	A	7	12	19	0	1	20	0	0
9	734643	.	T	G	9	8	17	1	0	18	0	0
9	735860	.	A	G	9	5	14	0	0	14	0	0
9	737461	.	C	A	0	5	5	0	9	14	0	0
9	737462	.	G	T	8	5	13	0	1	14	0	0
9	740907	.	C	T	6	5	11	0	0	11	0	0
9	746006	.	A	G	7	4	11	0	1	12	0	0
9	746071	.	T	C	10	9	19	0	1	20	0	0
9	748018	.	T	C	11	6	17	0	2	19	0	0
9	781983	.	G	C	1	4	5	0	0	5	0	0
9	784574	.	C	T	2	3	5	0	0	5	0	0
9	785083	.	T	C	1	2	3	0	0	3	0	0
9	1188237	.	G	T	4	2	6	0	1	7	0	0
9	1197101	.	C	T	1	2	3	0	0	3	0	0
9	1197111	.	C	T	1	1	2	0	1	3	0	0
9	1236252	.	C	T	3	2	5	0	0	5	0	0
9	1236396	.	A	G	1	3	4	0	0	4	0	0
9	1251672	.	T	G	8	6	14	0	1	15	0	0
9	1271934	.	T	C	2	5	7	0	2	9	0	0
9	1282509	.	C	T	3	4	7	0	1	8	0	0
9	1285758	.	A	G	3	2	5	0	6	11	0	0
9	1293974	.	C	T	2	5	7	0	1	8	0	0
9	1296937	.	G	A	0	6	6	0	4	10	0	0
9	1296985	.	T	C	4	3	7	0	0	7	0	0
9	1297000	.	G	A	3	2	5	0	0	5	0	0
9	1371363	.	A	G	5	5	10	0	0	10	0	0
9	1577542	.	C	A	9	23	32	1	0	33	0	0
9	2334127	.	T	A	5	2	7	0	0	7	0	0
9	2334164	.	C	T	17	19	36	2	1	39	0	0
9	2336682	.	A	G	29	0	29	0	28	57	0	0
9	2337291	.	C	T	21	26	47	0	1	48	0	0
9	2340561	.	G	A	28	21	49	1	4	54	0	0
9	2340564	.	G	A	30	20	50	1	3	54	0	0
9	2340618	.	C	T	27	28	55	0	3	58	0	0
9	2340776	.	C	T	34	35	69	0	4	73	0	0
9	2341035	.	T	C	18	13	31	0	2	33	0	0
9	2349345	.	G	A	0	2	2	0	6	8	0	0
9	2351661	.	C	T	7	3	10	0	0	10	0	0
9	2351723	.	G	C	3	5	8	0	2	10	0	0
9	2351795	.	C	G	3	4	7	0	0	7	0	0
9	2365092	.	T	C	2	3	5	0	0	5	0	0
9	2365125	.	T	C	2	3	5	0	0	5	0	0
9	2404624	.	A	C	12	9	21	0	0	21	0	0
9	2421012	.	T	A	7	10	17	0	0	17	0	0
9	2423092	.	C	A	5	10	15	0	0	15	0	0
9	2423119	.	C	T	10	8	18	0	3	21	0	0
9	2452697	.	T	C	15	23	38	1	3	42	0	0
9	2510549	.	C	T	1	2	3	0	0	3	0	0
9	2511029	.	A	C	2	1	3	0	2	5	0	0
9	2511038	.	A	T	3	2	5	0	1	6	0	0
9	2511344	.	C	A	5	2	7	0	0	7	0	0
9	2526676	.	C	T	3	3	6	0	1	7	0	0
9	2536809	.	C	T	1	2	3	0	0	3	0	0
9	2546266	.	T	C	1	3	4	0	0	4	0	0
9	2555591	.	A	G	3	3	6	0	0	6	0	0
9	2555631	.	G	A	3	2	5	0	0	5	0	0
9	2555975	.	T	G	6	2	8	0	0	8	0	0
9	2556068	.	A	T	4	3	7	0	0	7	0	0
9	2556177	.	A	T	4	2	6	0	0	6	0	0
9	2556277	.	A	G	1	4	5	0	0	5	0	0
9	2556339	.	T	C	3	3	6	0	0	6	0	0
9	2556415	.	T	A	3	3	6	0	0	6	0	0
9	2556516	.	A	T	4	5	9	0	0	9	0	0
9	2556683	.	C	T	5	3	8	0	0	8	0	0
9	2557844	.	T	A	1	2	3	0	0	3	0	0
9	2558355	.	G	T	3	3	6	0	0	6	0	0
9	2559177	.	C	T	4	4	8	0	0	8	0	0
9	2559204	.	C	T	6	5	11	0	0	11	0	0
9	2559640	.	A	T	2	3	5	0	0	5	0	0
9	2559792	.	G	A	2	3	5	0	0	5	0	0
9	2560691	.	T	C	2	8	10	0	0	10	0	0
9	2560712	.	T	A	1	10	11	0	0	11	0	0
9	2561162	.	T	G	1	3	4	0	0	4	0	0
9	2561225	.	T	A	7	3	10	0	0	10	0	0
9	2561254	.	C	T	0	8	8	0	4	12	0	0
9	2561604	.	C	T	15	16	31	0	2	33	0	0
9	2561632	.	A	T	12	19	31	0	0	31	0	0
9	2564178	.	C	A	23	12	35	0	1	36	0	0
9	2564699	.	A	G	18	12	30	0	1	31	0	0
9	2564788	.	A	T	16	16	32	0	1	33	0	0
9	2567323	.	G	A	15	17	32	0	1	33	0	0
9	2568670	.	T	A	23	10	33	0	1	34	0	0
9	2568768	.	G	T	27	15	42	0	2	44	0	0
9	2568777	.	C	T	16	29	45	0	0	45	0	0
9	2569372	.	T	G	9	12	21	0	0	21	0	0
9	2572316	.	G	A	16	17	33	0	1	34	0	0
9	2574159	.	T	C	4	4	8	0	1	9	0	0
9	2574225	.	T	C	13	11	24	0	0	24	0	0
9	2574227	.	A	G	13	11	24	0	0	24	0	0
9	2576099	.	T	C	14	9	23	0	1	24	0	0
9	2579867	.	C	T	8	11	19	0	0	19	0	0
9	2582003	.	G	A	11	9	20	0	0	20	0	0
9	2592246	.	C	T	7	14	21	0	0	21	0	0
9	2592933	.	T	C	12	13	25	0	0	25	0	0
9	2592984	.	C	A	1	10	11	0	7	18	0	0
9	2888808	.	C	T	2	2	4	0	0	4	0	0
9	2896864	.	C	A	2	2	4	0	0	4	0	0
9	2908158	.	G	A	1	2	3	0	0	3	0	0
9	2908811	.	A	G	2	4	6	0	0	6	0	0
9	2925844	.	C	T	0	3	3	0	3	6	0	0
9	2932399	.	G	A	2	2	4	0	1	5	0	0
9	2949273	.	G	A	6	3	9	0	1	10	0	0
9	2949640	.	T	C	4	4	8	0	0	8	0	0
9	2954224	.	T	C	2	3	5	0	0	5	0	0
9	2966295	.	A	T	3	4	7	0	0	7	0	0
9	2983516	.	T	G	1	3	4	0	0	4	0	0
9	2983542	.	T	G	1	2	3	0	0	3	0	0
9	3122188	.	T	C	2	2	4	0	0	4	0	0
9	3122203	.	C	T	2	2	4	0	0	4	0	0
9	3135171	.	T	C	14	0	14	0	20	34	0	0
9	3135794	.	A	G	17	18	35	0	1	36	0	0
9	3135809	.	A	G	13	16	29	0	1	30	0	0
9	3136107	.	C	T	4	14	18	0	9	27	0	0
9	3149541	.	T	C	12	11	23	0	1	24	0	0
9	3149661	.	C	T	11	9	20	0	3	23	0	0
9	3170116	.	G	A	1	3	4	0	0	4	0	0
9	3209143	.	T	C	6	2	8	0	0	8	0	0
9	3228214	.	C	T	10	6	16	0	0	16	0	0
9	3231242	.	C	T	9	7	16	0	0	16	0	0
9	3231378	.	C	A	0	17	17	0	0	17	0	0
9	3231396	.	C	G	10	11	21	0	2	23	0	0
9	3231675	.	C	T	3	4	7	0	0	7	0	0
9	3231746	.	C	A	2	4	6	0	0	6	0	0
9	3231778	.	G	T	0	5	5	0	1	6	0	0
9	3231795	.	T	C	2	5	7	0	0	7	0	0
9	3231978	.	C	A	2	2	4	0	0	4	0	0
9	3232180	.	T	A	7	5	12	0	0	12	0	0
9	3232198	.	C	T	6	6	12	0	1	13	0	0
9	3232523	.	T	G	5	8	13	0	0	13	0	0
9	3232607	.	T	A	6	9	15	0	0	15	0	0
9	3232672	.	C	T	2	6	8	0	2	10	0	0
9	3232763	.	T	C	5	3	8	0	0	8	0	0
9	3232808	.	A	T	4	2	6	0	0	6	0	0
9	3232818	.	T	G	4	0	4	0	3	7	0	0
9	3232949	.	A	G	1	3	4	0	0	4	0	0
9	3284007	.	G	C	1	11	12	0	12	24	0	0
9	3286386	.	G	A	11	11	22	0	0	22	0	0
9	3313920	.	G	T	11	12	23	0	0	23	0	0
9	3388974	.	C	T	13	6	19	0	4	23	0	0
9	3389545	.	G	A	12	9	21	0	0	21	0	0
9	3389921	.	A	G	15	2	17	0	14	31	0	0
9	3390035	.	G	A	14	15	29	0	1	30	0	0
9	3397558	.	G	A	4	2	6	0	1	7	0	0
9	3397648	.	A	C	5	7	12	0	0	12	0	0
9	3398243	.	T	A	4	12	16	0	1	17	0	0
9	3398247	.	G	A	4	12	16	0	1	17	0	0
9	3398328	.	C	A	1	11	12	0	11	23	0	0
9	3398354	.	T	C	8	1	9	0	14	23	0	0
9	3400331	.	A	G	8	5	13	0	0	13	0	0
9	3400361	.	G	A	4	5	9	0	0	9	0	0
9	3429722	.	A	T	7	3	10	0	0	10	0	0
9	3429733	.	C	T	6	3	9	0	0	9	0	0
9	3448768	.	T	C	7	2	9	0	0	9	0	0
9	3448810	.	G	C	6	2	8	0	0	8	0	0
9	3455742	.	G	A	4	3	7	0	1	8	0	0
9	3456590	.	C	T	7	5	12	0	0	12	0	0
9	3457321	.	T	C	5	3	8	0	0	8	0	0
9	3457410	.	G	A	1	3	4	0	3	7	0	0
9	3463198	.	T	C	9	4	13	0	0	13	0	0
9	3463212	.	G	A	1	5	6	0	4	10	0	0
9	3463247	.	C	A	2	6	8	0	0	8	0	0
9	3464229	.	G	T	0	4	4	0	2	6	0	0
9	3465279	.	G	A	5	8	13	0	0	13	0	0
9	3465285	.	T	C	6	8	14	0	0	14	0	0
9	3466114	.	G	A	0	4	4	0	6	10	0	0
9	3471076	.	C	T	6	8	14	0	0	14	0	0
9	3471077	.	A	G	6	8	14	0	0	14	0	0
9	3473361	.	T	A	7	10	17	0	1	18	0	0
9	3474856	.	T	C	5	7	12	0	1	13	0	0
9	3477113	.	T	G	3	7	10	0	0	10	0	0
9	3480057	.	A	G	11	14	25	0	0	25	0	0
9	3480076	.	C	T	10	12	22	0	0	22	0	0
9	3483164	.	T	C	11	6	17	0	0	17	0	0
9	3485822	.	G	A	0	5	5	0	4	9	0	0
9	3485867	.	A	T	4	4	8	0	0	8	0	0
9	3485868	.	T	C	4	4	8	0	0	8	0	0
9	3486134	.	T	G	4	6	10	0	0	10	0	0
9	3486220	.	C	T	2	4	6	0	0	6	0	0
9	3486223	.	C	T	2	4	6	0	0	6	0	0
9	3491044	.	A	G	3	2	5	0	0	5	0	0
9	3504403	.	G	C	1	2	3	0	0	3	0	0
9	3519291	.	T	C	4	4	8	0	0	8	0	0
9	3519886	.	G	C	2	4	6	0	0	6	0	0
9	3524394	.	G	T	1	2	3	0	0	3	0	0
9	3532562	.	C	A	3	2	5	0	0	5	0	0
9	3534748	.	G	A	1	5	6	0	0	6	0	0
9	3569470	.	C	A	13	7	20	0	0	20	0	0
9	3605652	.	C	T	12	15	27	0	0	27	0	0
9	3605682	.	A	G	17	0	17	0	13	30	0	0
9	3608867	.	T	A	14	7	21	0	1	22	0	0
9	3621980	.	T	C	9	13	22	0	0	22	0	0
9	3627189	.	T	C	16	14	30	0	1	31	0	0
9	3630017	.	T	C	16	0	16	0	12	28	0	0
9	3635791	.	G	A	11	5	16	0	0	16	0	0
9	3653187	.	G	C	7	9	16	0	0	16	0	0
9	3666541	.	A	C	5	7	12	0	3	15	0	0
9	3666601	.	A	T	5	9	14	0	0	14	0	0
9	3666666	.	T	C	4	16	20	0	0	20	0	0
9	3666947	.	G	A	9	3	12	0	0	12	0	0
9	3666948	.	T	C	6	0	6	0	6	12	0	0
9	3667136	.	G	A	7	10	17	0	0	17	0	0
9	3667338	.	T	A	14	7	21	0	1	22	0	0
9	3667377	.	C	A	8	5	13	0	0	13	0	0
9	3667398	.	C	A	5	5	10	0	0	10	0	0
9	3667572	.	A	C	2	2	4	0	0	4	0	0
9	3667575	.	T	C	2	2	4	0	0	4	0	0
9	3668198	.	A	C	6	5	11	0	0	11	0	0
9	3668199	.	G	C	5	5	10	0	1	11	0	0
9	3755708	.	G	A	2	2	4	0	1	5	0	0
9	3807524	.	A	G	1	3	4	0	1	5	0	0
9	3825065	.	A	G	2	2	4	0	0	4	0	0
9	3900878	.	T	A	3	4	7	0	0	7	0	0
9	3901007	.	A	T	7	3	10	0	2	12	0	0
9	3901081	.	C	T	9	6	15	0	0	15	0	0
9	3901187	.	T	A	6	8	14	1	0	15	0	0
9	3905921	.	G	A	9	5	14	0	1	15	0	0
9	3907834	.	C	G	4	6	10	0	1	11	0	0
9	3928332	.	C	A	7	7	14	0	0	14	0	0
9	3932238	.	T	G	7	5	12	0	0	12	0	0
9	3997209	.	G	C	2	0	2	0	3	5	0	0
9	4000799	.	G	A	4	3	7	0	0	7	0	0
9	4032809	.	T	C	2	2	4	0	0	4	0	0
9	4254304	.	T	C	4	7	11	0	1	12	0	0
9	4266699	.	C	T	3	2	5	0	0	5	0	0
9	4267062	.	T	C	8	5	13	0	1	14	0	0
9	4267072	.	T	C	9	5	14	0	0	14	0	0
9	4267101	.	C	G	11	7	18	0	0	18	0	0
9	4272316	.	T	C	3	10	13	0	0	13	0	0
9	4277125	.	C	T	6	7	13	0	0	13	0	0
9	4282581	.	G	A	1	12	13	0	5	18	0	0
9	4310069	.	C	T	9	7	16	0	2	18	0	0
9	4310096	.	G	A	8	10	18	0	0	18	0	0
9	4323147	.	C	T	8	8	16	0	0	16	0	0
9	4323249	.	C	T	5	10	15	0	1	16	0	0
9	4332223	.	C	T	13	12	25	0	0	25	0	0
9	4333299	.	C	T	11	12	23	0	4	27	0	0
9	4336543	.	A	G	9	9	18	0	0	18	0	0
9	4336585	.	T	C	9	12	21	0	0	21	0	0
9	4344553	.	C	T	15	12	27	0	0	27	0	0
9	5042784	.	A	G	5	6	11	0	0	11	0	0
9	5044370	.	G	T	2	6	8	0	0	8	0	0
9	5045284	.	C	G	0	4	4	0	5	10	1	0
9	5345770	.	G	A	5	3	8	0	0	8	0	0
9	5345827	.	C	T	1	2	3	0	3	6	0	0
9	5346148	.	A	G	3	2	5	0	0	5	0	0
9	5346374	.	C	G	0	3	3	0	4	7	0	0
9	5908920	.	T	A	1	4	5	0	0	5	0	0
9	5911943	.	G	A	3	5	8	0	0	8	0	0
9	6009282	.	C	T	31	13	44	0	4	48	0	0
9	6083012	.	G	A	5	10	15	0	21	36	0	0
9	6083026	.	C	T	15	17	32	0	2	34	0	0
9	6083113	.	C	T	11	20	31	0	1	32	0	0
9	6083169	.	C	T	16	10	26	0	0	26	0	0
9	6083226	.	C	G	15	0	15	0	5	20	0	0
9	6083262	.	G	C	3	11	14	0	0	14	0	0
9	6083401	.	G	A	19	15	34	0	4	38	0	0
9	6109544	.	A	G	20	9	29	0	1	30	0	0
9	6118842	.	G	A	6	2	8	0	0	8	0	0
9	6123441	.	G	A	26	17	43	1	0	44	0	0
9	6123490	.	G	T	19	15	34	0	0	34	0	0
9	6123742	.	A	C	12	22	34	0	0	34	0	0
9	6123857	.	C	T	12	7	19	0	0	19	0	0
9	6124057	.	G	A	2	9	11	0	9	20	0	0
9	6124100	.	T	C	11	9	20	0	1	21	0	0
9	6124201	.	G	A	0	9	9	0	11	20	0	0
9	6124393	.	C	T	11	5	16	0	1	17	0	0
9	6124478	.	G	A	14	10	24	0	0	24	0	0
9	6124759	.	T	A	11	19	30	0	4	34	0	0
9	6124761	.	T	G	22	11	33	0	1	34	0	0
9	6124884	.	T	C	12	7	19	0	2	21	0	0
9	6125346	.	T	A	4	4	8	0	3	11	0	0
9	6125427	.	G	C	5	3	8	0	1	9	0	0
9	6125501	.	A	C	3	5	8	0	1	9	0	0
9	6125707	.	T	C	4	5	9	0	0	9	0	0
9	6125732	.	C	T	9	4	13	0	0	13	0	0
9	6125859	.	T	A	11	10	21	0	1	22	0	0
9	6126074	.	T	A	17	12	29	0	1	30	0	0
9	6126288	.	A	C	15	12	27	0	1	28	0	0
9	6126410	.	G	A	19	18	37	1	0	39	1	0
9	6126469	.	G	A	12	13	25	0	1	26	0	0
9	6126781	.	T	G	14	16	30	0	0	30	0	0
9	6126900	.	C	T	9	7	16	0	0	16	0	0
9	6126911	.	C	A	7	8	15	0	1	16	0	0
9	6127075	.	G	A	2	24	26	0	25	51	0	0
9	6127346	.	C	A	16	6	22	0	2	25	1	0
9	6127357	.	C	T	15	12	27	0	2	29	0	0
9	6130147	.	C	T	0	5	5	0	2	7	0	0
9	6130179	.	C	T	0	3	3	0	3	6	0	0
9	6256165	.	C	T	6	6	12	0	0	12	0	0
9	6256184	.	C	T	4	6	10	0	0	10	0	0
9	6256349	.	A	T	3	3	6	0	0	6	0	0
9	6256541	.	G	A	0	6	6	0	6	12	0	0
9	6362976	.	G	A	10	11	21	0	0	21	0	0
9	6395548	.	T	C	4	1	5	0	3	9	1	0
9	6395713	.	G	A	16	7	23	0	1	24	0	0
9	6395792	.	T	A	9	5	14	0	0	14	0	0
9	6395937	.	T	G	0	6	6	0	0	7	1	0
9	6395957	.	C	T	4	4	8	0	1	9	0	0
9	6396181	.	G	A	9	13	22	0	0	22	0	0
9	6396235	.	A	G	4	13	17	0	1	18	0	0
9	6396242	.	G	A	3	14	17	0	1	18	0	0
9	6396477	.	A	G	8	14	22	0	0	22	0	0
9	6399592	.	C	T	2	4	6	0	14	20	0	0
9	6399610	.	A	G	16	6	22	0	1	23	0	0
9	6399762	.	C	T	7	6	13	0	0	13	0	0
9	6399784	.	A	G	8	6	14	0	0	14	0	0
9	6399949	.	A	G	8	7	15	0	1	16	0	0
9	6400191	.	G	A	4	5	9	0	1	10	0	0
9	6400240	.	C	T	2	4	6	0	2	8	0	0
9	6400251	.	G	A	3	4	7	0	0	7	0	0
9	6415385	.	G	A	9	5	14	0	2	16	0	0
9	7067476	.	C	T	3	1	4	1	0	5	0	0
9	7093825	.	T	C	1	3	4	0	0	4	0	0
9	7094141	.	T	C	8	7	15	0	1	16	0	0
9	7094225	.	T	C	14	0	14	0	5	19	0	0
9	7094898	.	T	C	7	16	23	0	0	23	0	0
9	7244947	.	T	C	5	2	7	0	0	7	0	0
9	7244950	.	T	C	1	6	7	0	0	7	0	0
9	7287022	.	A	G	1	5	6	0	0	6	0	0
9	8114242	.	T	C	12	6	18	0	0	18	0	0
9	8120971	.	C	T	14	8	22	0	2	24	0	0
9	8121041	.	C	T	14	7	21	0	0	21	0	0
9	8121128	.	C	T	16	11	27	0	0	27	0	0
9	8121855	.	G	T	12	17	29	0	0	29	0	0
9	8121939	.	G	T	13	11	24	0	0	24	0	0
9	8122095	.	A	T	15	16	31	0	0	31	0	0
9	8429899	.	A	G	19	12	31	0	4	35	0	0
9	8430558	.	A	C	8	8	16	0	2	18	0	0
9	8430739	.	T	C	2	9	11	0	0	11	0	0
9	8430787	.	A	G	5	12	17	0	0	17	0	0
9	8430831	.	C	T	1	4	5	0	4	9	0	0
9	8431031	.	A	G	24	10	34	0	0	34	0	0
9	8431214	.	C	T	1	14	15	0	11	26	0	0
9	8431256	.	G	A	11	14	25	0	1	26	0	0
9	8431408	.	T	A	12	9	21	0	1	22	0	0
9	8431428	.	C	G	11	9	20	0	1	21	0	0
9	8431450	.	A	G	10	11	21	0	1	22	0	0
9	8431714	.	G	T	9	8	17	0	1	18	0	0
9	8431772	.	C	T	15	12	27	0	0	27	0	0
9	8431814	.	A	G	15	11	26	1	0	27	0	0
9	8431837	.	T	C	14	12	26	1	2	29	0	0
9	8431854	.	T	C	12	12	24	1	1	26	0	0
9	8431894	.	A	G	11	14	25	0	1	26	0	0
9	8431998	.	A	C	6	0	6	0	7	13	0	0
9	8432695	.	C	T	14	7	21	0	0	21	0	0
9	8432768	.	A	T	17	12	29	0	1	30	0	0
9	8432802	.	T	C	13	0	13	0	12	25	0	0
9	8432996	.	G	A	17	17	34	0	0	34	0	0
9	8433189	.	C	T	17	9	26	0	1	27	0	0
9	8450740	.	G	A	15	12	27	0	0	27	0	0
9	8450788	.	G	A	8	8	16	0	0	16	0	0
9	8451386	.	C	T	1	6	7	0	8	15	0	0
9	8451540	.	C	T	13	12	25	0	3	28	0	0
9	8452339	.	C	T	8	7	15	0	1	16	0	0
9	8452465	.	G	A	5	5	10	0	1	11	0	0
9	8452546	.	A	G	9	7	16	0	0	16	0	0
9	8452627	.	G	A	8	11	19	0	0	19	0	0
9	8452695	.	C	T	13	10	23	0	0	23	0	0
9	8452705	.	G	A	15	10	25	0	1	26	0	0
9	8453035	.	G	A	8	5	13	0	0	13	0	0
9	8877807	.	C	T	2	3	5	0	0	5	0	0
9	8888388	.	A	G	6	3	9	0	0	9	0	0
9	8898196	.	G	A	1	7	8	0	4	12	0	0
9	8898403	.	T	C	4	1	5	0	1	6	0	0
9	8898903	.	C	A	7	7	14	0	0	14	0	0
9	8899665	.	C	T	13	12	25	0	0	25	0	0
9	8899704	.	C	T	10	15	25	0	1	26	0	0
9	8914657	.	G	C	14	11	25	0	0	25	0	0
9	8923188	.	A	T	7	8	15	0	0	15	0	0
9	8929848	.	G	T	6	11	17	0	1	18	0	0
9	8929905	.	G	A	1	7	8	0	7	15	0	0
9	8964977	.	C	T	2	2	4	0	0	4	0	0
9	8967442	.	G	A	10	16	26	0	1	27	0	0
9	8967459	.	C	T	19	9	28	0	0	28	0	0
9	8971713	.	G	A	22	16	38	0	2	40	0	0
9	8971984	.	T	G	16	1	17	0	16	33	0	0
9	8971995	.	A	C	13	14	27	0	2	29	0	0
9	8972429	.	T	A	15	17	32	0	0	32	0	0
9	8973227	.	T	C	3	2	5	0	0	5	0	0
9	8973379	.	T	G	3	4	7	0	1	8	0	0
9	8973627	.	C	A	4	5	9	0	0	9	0	0
9	8973629	.	G	A	4	5	9	0	0	9	0	0
9	8974152	.	G	A	5	5	10	0	0	10	0	0
9	8979068	.	A	T	4	4	8	0	0	8	0	0
9	9112417	.	G	T	8	5	13	0	0	13	0	0
9	9112933	.	C	A	8	6	14	0	0	14	0	0
9	9113008	.	A	G	6	12	18	0	0	18	0	0
9	9116101	.	C	T	8	3	11	0	1	12	0	0
9	9116890	.	C	T	11	7	18	0	1	19	0	0
9	9118363	.	A	C	12	14	26	0	1	27	0	0
9	9118602	.	G	A	10	5	15	0	2	17	0	0
9	9118695	.	C	T	8	9	17	0	1	18	0	0
9	9118991	.	C	T	17	12	29	0	1	30	0	0
9	9118994	.	C	T	14	13	27	0	1	28	0	0
9	9119546	.	A	G	4	6	10	0	0	10	0	0
9	9119671	.	G	C	9	4	13	0	2	15	0	0
9	9119755	.	G	T	11	5	16	0	2	18	0	0
9	9119771	.	T	A	8	6	14	0	0	14	0	0
9	9119830	.	A	T	9	4	13	0	0	13	0	0
9	9119877	.	G	A	5	10	15	0	0	15	0	0
9	9119937	.	G	A	4	7	11	0	0	11	0	0
9	9119987	.	T	C	6	3	9	0	0	9	0	0
9	9120271	.	T	C	7	6	13	0	3	16	0	0
9	9120517	.	A	T	7	8	15	0	0	15	0	0
9	9120847	.	G	A	7	10	17	0	1	18	0	0
9	9121242	.	T	C	10	12	22	0	1	23	0	0
9	9121382	.	G	A	9	5	14	0	1	15	0	0
9	9183874	.	C	T	13	10	23	0	0	23	0	0
9	9183969	.	T	A	23	13	36	0	0	36	0	0
9	9184092	.	G	A	20	8	28	0	2	30	0	0
9	9184177	.	G	A	11	18	29	0	3	32	0	0
9	9184397	.	G	A	16	12	28	0	0	28	0	0
9	9184536	.	T	C	12	12	24	0	1	25	0	0
9	9184566	.	G	A	17	13	30	0	0	30	0	0
9	9184593	.	T	C	18	13	31	0	1	32	0	0
9	9193044	.	A	C	24	21	45	0	0	45	0	0
9	9195964	.	C	T	22	23	45	2	1	48	0	0
9	9198139	.	A	G	10	22	32	0	0	32	0	0
9	9198202	.	A	C	14	22	36	0	2	38	0	0
9	9198208	.	G	A	14	20	34	0	2	36	0	0
9	9206612	.	C	G	19	22	41	0	0	41	0	0
9	9208714	.	C	A	16	13	29	2	2	33	0	0
9	9208759	.	A	T	15	13	28	0	4	32	0	0
9	9225717	.	C	T	17	15	32	0	0	32	0	0
9	9238577	.	G	A	8	28	36	0	1	37	0	0
9	9238583	.	G	A	9	22	31	0	3	34	0	0
9	9322733	.	G	A	10	8	18	0	1	19	0	0
9	9322782	.	C	G	2	7	9	0	10	19	0	0
9	9322795	.	A	G	12	11	23	0	0	23	0	0
9	9327588	.	G	A	7	3	10	0	1	11	0	0
9	9327705	.	C	T	9	10	19	0	1	20	0	0
9	9342835	.	T	A	7	10	17	0	0	17	0	0
9	9342892	.	C	T	6	11	17	0	0	17	0	0
9	9342994	.	A	G	4	12	16	0	0	16	0	0
9	9345134	.	G	A	7	8	15	0	0	15	0	0
9	9345748	.	G	T	3	10	13	0	0	13	0	0
9	9345751	.	C	T	2	8	10	0	2	12	0	0
9	9561577	.	C	T	5	2	7	0	0	7	0	0
9	9561852	.	A	G	2	3	5	0	0	5	0	0
9	9578598	.	G	T	20	14	34	0	1	35	0	0
9	9578936	.	T	G	25	16	41	3	3	47	0	0
9	9579027	.	C	A	17	29	46	0	3	49	0	0
9	9579033	.	T	C	27	0	27	0	20	47	0	0
9	9579076	.	G	C	10	21	31	0	0	31	0	0
9	9579165	.	C	T	23	16	39	0	3	42	0	0
9	9579297	.	G	C	13	19	32	0	0	32	0	0
9	9580103	.	G	A	15	19	34	0	1	35	0	0
9	9592779	.	C	A	17	15	32	0	1	33	0	0
9	9671134	.	G	T	12	9	21	0	1	22	0	0
9	9671208	.	G	A	22	13	35	0	0	35	0	0
9	9719301	.	C	T	4	4	8	0	0	8	0	0
9	9719311	.	T	A	5	4	9	0	0	9	0	0
9	9719349	.	G	A	3	4	7	0	0	7	0	0
9	9719409	.	A	T	4	2	6	0	0	6	0	0
9	9719495	.	G	T	4	2	6	0	0	6	0	0
9	9720323	.	G	A	2	5	7	0	0	7	0	0
9	9720471	.	T	C	2	0	2	0	3	5	0	0
9	9731574	.	T	C	3	0	3	0	2	5	0	0
9	9736317	.	G	T	13	5	18	0	1	19	0	0
9	9736406	.	C	A	8	12	20	0	1	21	0	0
9	9736436	.	G	T	12	9	21	0	0	21	0	0
9	9736605	.	C	G	6	4	10	0	0	10	0	0
9	9736684	.	C	T	0	7	7	0	3	10	0	0
9	9736689	.	A	C	2	9	11	0	0	11	0	0
9	9736727	.	A	G	4	3	7	0	1	9	1	0
9	9736815	.	T	A	6	7	13	0	0	13	0	0
9	9736870	.	T	G	8	3	11	0	0	11	0	0
9	9736918	.	G	C	6	6	12	0	0	12	0	0
9	9737060	.	T	G	6	10	16	0	0	16	0	0
9	9737219	.	C	G	11	4	15	0	0	15	0	0
9	9737248	.	G	A	7	6	13	0	0	13	0	0
9	9737432	.	A	T	10	13	23	0	1	24	0	0
9	9737437	.	T	C	10	0	10	0	14	24	0	0
9	9738137	.	T	A	6	2	8	0	0	8	0	0
9	9738158	.	T	G	5	2	7	0	0	7	0	0
9	9738304	.	C	T	0	6	6	0	7	13	0	0
9	9738325	.	A	T	11	6	17	0	0	17	0	0
9	9738357	.	T	C	11	0	11	0	8	19	0	0
9	9738449	.	C	T	11	8	19	0	0	19	0	0
9	9738450	.	T	A	11	8	19	0	0	19	0	0
9	9738629	.	C	T	0	4	4	0	5	9	0	0
9	9738671	.	C	A	8	3	11	0	0	11	0	0
9	9738707	.	G	A	12	5	17	0	0	17	0	0
9	9738739	.	A	G	7	10	17	0	3	20	0	0
9	9738758	.	T	A	7	8	15	0	2	17	0	0
9	9738783	.	A	T	14	1	15	0	1	16	0	0
9	9739135	.	T	C	2	5	7	0	0	7	0	0
9	9743579	.	T	A	10	5	15	0	0	15	0	0
9	9842067	.	G	T	5	7	12	0	1	13	0	0
9	9930038	.	T	C	5	5	10	0	0	10	0	0
9	9930414	.	G	T	0	2	2	0	2	4	0	0
9	9930415	.	G	C	2	2	4	0	0	4	0	0
9	9930554	.	G	C	1	2	3	0	0	3	0	0
9	9941440	.	G	A	4	3	7	0	1	8	0	0
9	9941518	.	G	C	0	3	3	0	2	5	0	0
9	9947425	.	G	A	4	2	6	0	1	7	0	0
9	9948145	.	C	T	4	2	6	0	1	7	0	0
9	9950013	.	C	T	1	2	3	0	0	3	0	0
9	9953683	.	T	A	1	3	4	0	1	5	0	0
9	9955408	.	T	A	2	2	4	0	1	5	0	0
9	9960885	.	G	A	4	2	6	0	0	6	0	0
9	9960896	.	C	A	0	2	2	0	4	6	0	0
9	10014875	.	C	A	10	7	17	0	0	17	0	0
9	10014972	.	G	A	1	4	5	0	3	8	0	0
9	10043130	.	T	C	9	5	14	1	1	16	0	0
9	10043201	.	C	G	12	5	17	0	0	17	0	0
9	10043217	.	T	A	8	9	17	0	1	18	0	0
9	10043343	.	C	G	9	0	9	0	5	14	0	0
9	10043415	.	C	T	10	9	19	0	0	19	0	0
9	10051935	.	T	A	9	9	18	0	1	19	0	0
9	10066442	.	G	A	2	4	6	0	0	6	0	0
9	10138338	.	G	A	8	8	16	0	0	16	0	0
9	10153091	.	C	T	6	4	10	0	0	10	0	0
9	10153342	.	T	A	4	4	8	0	0	8	0	0
9	10153590	.	A	C	10	6	16	0	1	17	0	0
9	10153606	.	A	G	7	10	17	0	0	17	0	0
9	10153689	.	G	C	11	9	20	0	1	21	0	0
9	10153705	.	A	T	16	9	25	0	0	25	0	0
9	10154013	.	G	T	12	12	24	0	2	26	0	0
9	10154014	.	C	T	11	13	24	0	1	25	0	0
9	10154138	.	T	C	5	3	8	0	0	8	0	0
9	10154195	.	A	T	3	3	6	0	0	6	0	0
9	10154344	.	T	A	3	5	8	0	1	9	0	0
9	10154608	.	T	A	2	3	5	0	0	5	0	0
9	10156145	.	C	A	11	13	24	0	0	24	0	0
9	10157397	.	G	A	7	4	11	0	0	11	0	0
9	10168945	.	C	T	4	4	8	0	8	16	0	0
9	10175770	.	C	G	1	7	8	0	8	16	0	0
9	10175785	.	A	G	9	9	18	0	1	19	0	0
9	10175812	.	G	A	8	6	14	0	0	14	0	0
9	10183289	.	C	T	5	4	9	0	0	9	0	0
9	10195092	.	C	T	6	4	10	0	1	11	0	0
9	10195384	.	C	G	4	4	8	0	0	8	0	0
9	10195417	.	G	A	5	2	7	0	2	9	0	0
9	10195488	.	T	A	1	3	4	0	0	4	0	0
9	10199946	.	G	A	4	8	12	0	0	12	0	0
9	10199954	.	G	A	4	8	12	0	1	13	0	0
9	11034891	.	A	T	2	2	4	1	0	5	0	0
9	11532306	.	A	G	13	9	22	0	1	23	0	0
9	11532307	.	C	A	11	8	19	0	4	23	0	0
9	11532589	.	T	C	9	3	12	0	1	13	0	0
9	11532682	.	T	C	6	10	16	0	8	24	0	0
9	11532775	.	A	G	12	9	21	0	0	21	0	0
9	11532826	.	T	C	9	9	18	0	1	19	0	0
9	11628073	.	T	C	2	0	2	0	2	4	0	0
9	11906956	.	A	G	12	16	28	0	0	28	0	0
9	11907424	.	C	T	2	12	14	0	11	25	0	0
9	11907445	.	C	T	11	13	24	0	0	24	0	0
9	11907469	.	T	A	8	14	22	0	1	23	0	0
9	11907497	.	G	A	12	8	20	0	1	21	0	0
9	11907603	.	T	C	7	0	7	0	13	20	0	0
9	11908200	.	A	T	10	5	15	0	1	16	0	0
9	11908394	.	A	T	11	6	17	0	0	17	0	0
9	11908453	.	T	C	9	5	14	0	1	15	0	0
9	11908548	.	A	C	12	8	20	0	0	20	0	0
9	11908900	.	T	C	11	9	20	0	1	21	0	0
9	11909097	.	C	T	5	5	10	0	0	10	0	0
9	11909176	.	T	A	8	5	13	0	2	15	0	0
9	11909275	.	C	T	0	11	11	0	2	13	0	0
9	11909318	.	A	C	7	10	17	0	3	20	0	0
9	11909575	.	A	G	7	7	14	0	0	14	0	0
9	12263245	.	T	A	3	2	5	0	2	7	0	0
9	12265446	.	G	A	7	2	9	0	0	9	0	0
9	12269871	.	C	T	6	5	11	0	2	13	0	0
9	12269901	.	T	A	4	4	8	0	0	8	0	0
9	12655704	.	T	C	1	3	4	0	0	4	0	0
9	12664466	.	T	G	5	6	11	0	0	11	0	0
9	12664727	.	G	A	3	4	7	0	0	7	0	0
9	12664760	.	A	G	2	6	8	0	0	8	0	0
9	12667512	.	T	C	2	5	7	0	0	7	0	0
9	12667694	.	A	G	4	5	9	0	1	10	0	0
9	12667695	.	A	G	4	6	10	0	0	10	0	0
9	12669566	.	G	A	3	2	5	0	0	5	0	0
9	12671929	.	G	A	4	4	8	0	1	9	0	0
9	12671942	.	A	G	4	3	7	0	1	8	0	0
9	12676882	.	G	A	3	2	5	0	0	5	0	0
9	12676918	.	A	G	3	2	5	0	0	5	0	0
9	12680766	.	G	C	1	0	1	0	4	5	0	0
9	12680805	.	C	T	1	2	3	0	0	3	0	0
9	12682735	.	C	G	4	5	9	0	0	9	0	0
9	12682810	.	G	A	3	2	5	0	1	6	0	0
9	12682816	.	G	A	3	3	6	0	1	7	0	0
9	12690600	.	T	C	2	3	5	0	0	5	0	0
9	12690609	.	A	G	1	5	6	0	0	6	0	0
9	12690759	.	T	A	1	2	3	0	1	4	0	0
9	12693123	.	C	T	4	5	9	0	0	9	0	0
9	12693313	.	C	T	2	6	8	0	2	10	0	0
9	12693333	.	A	G	4	8	12	0	0	12	0	0
9	12849903	.	T	C	2	3	5	0	0	5	0	0
9	12865859	.	C	T	1	5	6	0	0	6	0	0
9	12868364	.	G	A	1	2	3	0	0	3	0	0
9	12868386	.	T	C	1	0	1	0	4	5	0	0
9	12868421	.	T	C	3	0	3	0	2	5	0	0
9	12871592	.	T	A	5	4	9	0	0	9	0	0
9	12875060	.	C	T	1	3	4	0	0	4	0	0
9	12920964	.	C	G	5	2	7	0	1	8	0	0
9	12921030	.	C	T	2	3	5	0	0	5	0	0
9	12921877	.	A	G	1	2	3	0	0	3	0	0
9	12925345	.	G	C	5	4	9	0	0	9	0	0
9	12925942	.	G	A	2	4	6	0	0	6	0	0
9	12932114	.	C	T	7	3	10	0	0	10	0	0
9	12932313	.	A	G	3	4	7	0	0	7	0	0
9	12940167	.	T	G	3	3	6	0	0	6	0	0
9	12942653	.	C	A	3	2	5	0	0	5	0	0
9	12942667	.	A	T	1	1	2	0	0	2	0	0
9	12943830	.	T	A	1	4	5	0	0	5	0	0
9	12943832	.	G	A	1	4	5	0	0	5	0	0
9	12943941	.	G	C	3	4	7	0	0	7	0	0
9	12944058	.	G	A	6	2	8	0	0	8	0	0
9	12944401	.	A	G	2	3	5	0	0	5	0	0
9	12944409	.	C	A	2	3	5	0	0	5	0	0
9	12944511	.	T	G	4	5	9	0	0	9	0	0
9	12944546	.	G	C	4	5	9	0	0	9	0	0
9	12944994	.	A	G	2	5	7	0	0	7	0	0
9	12945054	.	G	A	2	2	4	0	0	4	0	0
9	12945253	.	A	G	4	4	8	0	0	8	0	0
9	12945273	.	G	A	3	5	8	0	0	8	0	0
9	12945298	.	G	C	5	5	10	0	0	10	0	0
9	12945384	.	G	T	4	3	7	0	1	8	0	0
9	12945508	.	G	A	6	2	8	0	0	8	0	0
9	12945720	.	T	G	3	2	5	0	0	5	0	0
9	12946435	.	G	A	5	3	8	0	0	8	0	0
9	12946468	.	T	A	3	4	7	0	0	7	0	0
9	12946824	.	A	G	4	5	9	0	0	9	0	0
9	12946914	.	G	A	1	2	3	0	0	3	0	0
9	12947217	.	A	G	3	6	9	0	1	10	0	0
9	12947414	.	G	A	5	5	10	0	0	10	0	0
9	12947529	.	A	G	4	7	11	0	1	12	0	0
9	12947649	.	A	T	4	4	8	0	0	8	0	0
9	12947902	.	G	C	0	4	4	0	2	6	0	0
9	12948021	.	G	A	2	6	8	0	1	9	0	0
9	12948133	.	G	A	3	2	5	0	0	5	0	0
9	12948144	.	A	G	2	4	6	0	1	7	0	0
9	12948410	.	G	C	1	2	3	0	1	4	0	0
9	12948656	.	A	G	6	7	13	0	0	13	0	0
9	12948753	.	G	C	5	4	9	0	2	11	0	0
9	12948859	.	A	C	6	5	11	0	0	11	0	0
9	12951236	.	A	C	3	3	6	0	1	7	0	0
9	12951293	.	G	A	1	7	8	0	7	15	0	0
9	12953638	.	G	A	2	5	7	0	0	7	0	0
9	12953810	.	T	C	4	2	6	0	0	6	0	0
9	13031387	.	T	C	5	2	7	0	0	7	0	0
9	13106452	.	A	C	10	10	20	0	1	21	0	0
9	13106541	.	C	T	10	6	16	0	0	16	0	0
9	13106802	.	T	C	5	12	17	0	1	18	0	0
9	13107003	.	T	C	6	10	16	0	0	16	0	0
9	13107399	.	G	T	8	12	20	0	0	21	1	0
9	13107423	.	A	G	5	13	18	0	1	19	0	0
9	13107633	.	A	G	7	7	14	0	2	16	0	0
9	13110916	.	T	A	11	11	22	1	0	23	0	0
9	13111014	.	T	C	7	11	18	0	0	18	0	0
9	13820234	.	C	T	4	14	18	1	9	28	0	0
9	13839737	.	C	T	1	15	16	0	3	19	0	0
9	13852711	.	C	T	0	7	7	0	4	11	0	0
9	13853023	.	A	G	1	2	3	0	0	3	0	0
9	14023493	.	T	A	6	10	16	0	2	18	0	0
9	14023856	.	A	G	8	15	23	0	0	23	0	0
9	14024067	.	T	C	7	3	10	0	0	10	0	0
9	14027792	.	G	C	0	6	6	0	5	11	0	0
9	14027874	.	T	A	8	12	20	0	0	20	0	0
9	14027889	.	A	G	10	9	19	0	2	21	0	0
9	14028057	.	A	T	13	8	21	0	0	21	0	0
9	14028114	.	T	C	9	10	19	0	1	20	0	0
9	14037508	.	C	G	7	9	16	0	0	16	0	0
9	14037569	.	T	C	9	11	20	0	0	20	0	0
9	14038110	.	C	T	4	2	6	0	0	6	0	0
9	14038118	.	A	T	4	1	5	0	0	5	0	0
9	14040972	.	T	C	6	5	11	0	0	11	0	0
9	14112631	.	C	T	2	3	5	0	0	5	0	0
9	14112784	.	T	A	4	2	6	0	1	7	0	0
9	14113289	.	A	G	7	4	11	0	0	11	0	0
9	14113290	.	T	C	7	4	11	0	0	11	0	0
9	14136851	.	T	C	3	7	10	0	0	10	0	0
9	14152272	.	C	T	4	4	8	0	2	10	0	0
9	14171851	.	C	A	5	6	11	0	0	11	0	0
9	14172240	.	A	C	1	2	3	0	0	3	0	0
9	14191113	.	G	C	2	3	5	0	0	5	0	0
9	14195210	.	G	A	0	4	4	0	5	9	0	0
9	14195262	.	G	A	0	5	5	0	6	11	0	0
9	14195700	.	A	G	5	0	5	0	8	13	0	0
9	14196150	.	A	G	2	2	4	0	0	4	0	0
9	14196513	.	G	A	3	3	6	0	0	6	0	0
9	14196665	.	G	C	2	2	4	0	0	4	0	0
9	14196666	.	G	A	2	2	4	0	0	4	0	0
9	14196763	.	A	C	2	4	6	0	0	6	0	0
9	14196978	.	A	T	2	4	6	0	0	6	0	0
9	14197063	.	A	G	4	7	11	0	0	11	0	0
9	14227053	.	C	T	1	2	3	0	0	4	1	0
9	14367775	.	C	T	2	9	11	0	0	11	0	0
9	14367837	.	T	G	4	6	10	0	2	12	0	0
9	14367878	.	C	T	15	11	26	0	1	27	0	0
9	14368350	.	T	C	6	7	13	0	0	13	0	0
9	14368378	.	A	T	8	8	16	0	0	16	0	0
9	14368432	.	T	C	9	0	9	0	5	14	0	0
9	14368527	.	A	G	7	3	10	0	2	12	0	0
9	14368676	.	A	G	9	5	14	0	1	15	0	0
9	14368788	.	T	C	12	8	20	4	1	25	0	0
9	14368892	.	C	T	10	7	17	0	0	17	0	0
9	14368988	.	G	A	17	8	25	0	1	26	0	0
9	14369084	.	G	A	14	9	23	0	0	23	0	0
9	14369150	.	T	A	12	15	27	0	4	31	0	0
9	14381060	.	G	A	10	15	25	0	0	25	0	0
9	14381116	.	G	A	7	16	23	0	0	23	0	0
9	14381240	.	A	C	11	6	17	0	1	18	0	0
9	14411677	.	C	A	14	13	27	0	0	27	0	0
9	14433931	.	A	T	15	6	21	1	2	24	0	0
9	14442341	.	A	G	9	11	20	0	1	21	0	0
9	14443133	.	G	T	10	6	16	0	1	17	0	0
9	14443229	.	G	A	7	9	16	0	0	16	0	0
9	14443247	.	T	A	4	7	11	0	0	11	0	0
9	14446405	.	A	T	8	7	15	0	1	16	0	0
9	14446421	.	T	C	7	0	7	0	10	17	0	0
9	14469989	.	C	T	0	7	7	0	12	19	0	0
9	14469995	.	T	C	13	5	18	0	1	19	0	0
9	14504485	.	C	A	10	4	14	0	2	16	0	0
9	14504685	.	T	A	6	9	15	0	0	15	0	0
9	15363530	.	T	C	2	2	4	0	0	4	0	0
9	16127776	.	T	C	2	0	2	0	2	4	0	0
9	16128102	.	C	T	5	3	8	0	0	8	0	0
9	16128736	.	C	T	1	3	4	0	0	4	0	0
9	16128742	.	T	A	1	3	4	0	0	4	0	0
9	16132709	.	C	A	4	2	6	0	0	6	0	0
9	16151321	.	C	T	2	2	4	0	0	4	0	0
9	16156597	.	A	G	3	2	5	0	0	5	0	0
9	16241711	.	G	A	4	2	6	0	0	6	0	0
9	16535990	.	T	C	4	2	6	0	0	6	0	0
9	16547926	.	A	C	3	2	5	0	1	6	0	0
9	16581214	.	A	G	4	4	8	0	1	9	0	0
9	18278322	.	A	G	11	12	23	0	0	23	0	0
9	18278324	.	A	G	5	16	21	0	1	22	0	0
9	19406355	.	T	C	3	1	4	0	0	4	0	0
9	19407587	.	G	T	2	2	4	0	0	4	0	0
9	20174927	.	T	C	17	0	17	0	17	34	0	0
9	20174954	.	T	C	14	0	14	0	15	29	0	0
9	24189198	.	A	G	2	14	16	0	0	16	0	0
9	24189407	.	A	G	27	11	38	0	1	39	0	0
9	25837206	.	A	T	4	2	6	0	0	6	0	0
9	28344445	.	C	T	6	2	8	1	1	10	0	0
9	29034857	.	T	C	4	2	6	0	0	6	0	0
9	30107428	.	C	T	6	4	10	1	0	11	0	0
9	30107439	.	T	A	5	4	9	1	0	10	0	0
9	30764537	.	G	A	10	6	16	0	0	16	0	0
9	30783376	.	A	T	6	4	10	0	0	10	0	0
9	30783533	.	A	C	1	2	3	0	1	4	0	0
9	30783661	.	A	G	6	2	8	0	0	8	0	0
9	30783887	.	A	C	2	2	4	0	1	5	0	0
9	30806101	.	C	T	0	3	3	0	7	10	0	0
9	30806428	.	G	A	8	6	14	0	1	15	0	0
9	30806662	.	T	G	9	3	12	0	0	12	0	0
9	30807944	.	C	T	7	6	13	0	1	14	0	0
9	31042584	.	T	C	26	24	50	1	0	51	0	0
9	31062301	.	A	G	28	16	44	0	1	45	0	0
9	31214307	.	T	G	4	7	11	0	1	12	0	0
9	31214442	.	A	C	5	5	10	0	1	11	0	0
9	31248923	.	C	T	9	12	21	0	1	22	0	0
9	31258832	.	G	A	10	8	18	0	0	18	0	0
9	31268856	.	G	T	5	5	10	0	0	10	0	0
9	31274993	.	T	C	10	0	10	5	11	26	0	0
9	31276912	.	C	T	15	22	37	0	0	37	0	0
9	31286319	.	T	A	5	2	7	0	0	7	0	0
9	31510724	.	T	A	6	3	9	0	0	9	0	0
9	31518804	.	C	T	5	2	7	0	1	8	0	0
9	31524405	.	G	A	2	2	4	0	0	4	0	0
9	31524406	.	T	C	1	2	3	0	1	4	0	0
9	31524633	.	G	T	4	6	10	0	0	10	0	0
9	31524956	.	C	A	9	2	11	0	1	12	0	0
9	31556806	.	T	C	3	2	5	0	0	5	0	0
9	31595634	.	C	T	21	13	34	0	3	37	0	0
9	31604943	.	G	A	15	13	28	0	0	28	0	0
9	31605235	.	A	G	14	16	30	0	0	30	0	0
9	31605260	.	T	C	13	0	13	0	21	34	0	0
9	31605281	.	C	A	1	18	19	0	13	32	0	0
9	31606333	.	C	T	15	13	28	0	1	29	0	0
9	31612184	.	C	T	2	7	9	0	0	9	0	0
9	31617687	.	A	G	15	11	26	0	0	26	0	0
9	31619998	.	A	G	7	9	16	0	3	19	0	0
9	31639107	.	C	T	3	8	11	0	13	24	0	0
9	31715887	.	A	G	13	7	20	0	1	21	0	0
9	31716932	.	G	A	7	8	15	0	1	16	0	0
9	31735673	.	A	G	10	6	16	0	1	17	0	0
9	31735676	.	A	C	11	9	20	0	0	20	0	0
9	31736102	.	G	A	9	8	17	0	0	17	0	0
9	33411227	.	C	A	14	10	24	0	0	24	0	0
9	33411228	.	A	G	14	10	24	0	0	24	0	0
9	33788653	.	G	A	1	2	3	0	4	7	0	0
9	33861813	.	A	T	4	3	7	0	1	8	0	0
9	34112936	.	A	T	4	5	9	0	0	9	0	0
9	34112981	.	T	C	3	8	11	0	0	11	0	0
9	34113140	.	G	A	3	3	6	0	0	6	0	0
9	34116933	.	A	G	4	2	6	0	0	6	0	0
9	34117293	.	A	C	8	8	16	0	2	18	0	0
9	34117471	.	C	G	2	6	8	0	0	8	0	0
9	34119936	.	A	G	5	4	9	0	0	9	0	0
9	34120207	.	T	A	3	3	6	0	0	6	0	0
9	34120542	.	A	G	4	2	6	0	0	6	0	0
9	34120732	.	C	T	1	3	4	0	1	5	0	0
9	34154428	.	A	C	3	3	6	0	0	6	0	0
9	34154515	.	T	C	4	2	6	0	0	6	0	0
9	34161833	.	C	T	5	5	10	0	0	10	0	0
9	34162264	.	A	T	2	4	6	0	0	6	0	0
9	34174561	.	C	T	13	11	24	0	1	25	0	0
9	34174682	.	G	A	10	9	19	0	0	19	0	0
9	34179700	.	G	T	6	7	13	0	2	15	0	0
9	34179782	.	C	T	2	12	14	0	4	18	0	0
9	34189270	.	C	T	8	8	16	0	0	16	0	0
9	34189378	.	C	T	8	12	20	0	7	27	0	0
9	34189435	.	C	A	10	12	22	0	0	22	0	0
9	34189571	.	C	A	9	12	21	0	0	21	0	0
9	34191603	.	G	A	10	11	21	0	0	21	0	0
9	34200253	.	T	C	11	8	19	0	0	19	0	0
9	34201249	.	C	T	3	6	9	0	0	9	0	0
9	34204487	.	G	A	5	7	12	0	1	13	0	0
9	34204490	.	A	G	5	7	12	0	0	12	0	0
9	34212456	.	G	A	11	8	19	0	0	19	0	0
9	34218953	.	A	G	5	5	10	0	0	10	0	0
9	34225055	.	A	G	14	14	28	0	3	31	0	0
9	34225250	.	T	C	30	28	58	0	0	58	0	0
9	34225316	.	G	C	16	29	45	0	0	45	0	0
9	34226955	.	C	A	17	18	35	0	0	35	0	0
9	34226960	.	A	C	18	18	36	0	1	37	0	0
9	34227195	.	G	T	12	9	21	0	0	21	0	0
9	34227405	.	G	A	1	2	3	0	0	3	0	0
9	34227409	.	G	T	0	2	2	0	1	3	0	0
9	34232632	.	G	A	7	5	12	0	0	12	0	0
9	34232672	.	T	C	3	8	11	0	0	11	0	0
9	34232718	.	G	T	3	6	9	0	0	9	0	0
9	34238825	.	T	A	6	6	12	0	1	13	0	0
9	34239119	.	T	C	4	4	8	0	0	8	0	0
9	34242433	.	T	C	3	8	11	0	1	12	0	0
9	34242935	.	T	G	6	1	7	0	7	14	0	0
9	34242953	.	G	T	8	5	13	0	0	13	0	0
9	34243019	.	A	G	7	0	7	0	5	12	0	0
9	34243122	.	G	C	7	9	16	0	1	17	0	0
9	34243196	.	C	G	6	10	16	0	2	18	0	0
9	34243310	.	A	G	7	8	15	0	0	15	0	0
9	34243352	.	C	T	8	7	15	0	1	16	0	0
9	34243549	.	A	G	4	0	4	0	4	8	0	0
9	34243681	.	C	T	6	14	20	0	0	20	0	0
9	34243701	.	C	G	6	12	18	0	0	18	0	0
9	34243775	.	T	C	3	3	6	0	0	6	0	0
9	34246564	.	A	G	8	10	18	0	0	18	0	0
9	34246762	.	G	A	5	7	12	0	2	14	0	0
9	34247035	.	A	T	29	0	29	1	1	39	8	0
9	34247042	.	G	A	28	10	38	1	1	40	0	0
9	34247145	.	A	T	19	13	32	0	2	34	0	0
9	34247356	.	G	A	15	12	27	0	0	27	0	0
9	34251632	.	G	A	14	14	28	0	3	31	0	0
9	34251635	.	C	A	3	14	17	0	15	32	0	0
9	34251707	.	C	G	16	8	24	0	1	25	0	0
9	34254325	.	C	T	14	12	26	0	0	26	0	0
9	34254600	.	G	A	9	6	15	0	3	18	0	0
9	34254678	.	A	G	6	10	16	0	0	16	0	0
9	34254685	.	G	A	7	10	17	0	0	17	0	0
9	34254851	.	A	G	10	7	17	0	0	17	0	0
9	34254875	.	T	C	15	6	21	0	0	21	0	0
9	34256016	.	A	C	8	8	16	0	2	18	0	0
9	34257954	.	T	A	9	6	15	0	1	16	0	0
9	34258106	.	C	T	15	13	28	0	1	29	0	0
9	34258580	.	C	T	0	6	6	0	12	18	0	0
9	34258642	.	G	A	11	7	18	0	0	18	0	0
9	34259343	.	G	A	7	7	14	0	0	14	0	0
9	34259406	.	T	A	7	12	19	0	1	20	0	0
9	34259418	.	T	A	13	13	26	0	0	26	0	0
9	34260164	.	C	T	9	5	14	0	0	14	0	0
9	34277333	.	A	G	3	4	7	0	0	7	0	0
9	34334173	.	T	G	18	0	18	0	11	29	0	0
9	34334323	.	C	T	6	7	13	0	0	13	0	0
9	34335327	.	G	T	2	10	12	0	10	22	0	0
9	34335510	.	G	T	7	8	15	0	0	16	1	0
9	34342238	.	C	T	5	6	11	0	0	11	0	0
9	34343912	.	T	C	9	8	17	0	2	19	0	0
9	34343983	.	A	G	12	9	21	0	3	24	0	0
9	34344039	.	C	T	11	8	19	0	3	22	0	0
9	34346443	.	T	C	6	14	20	0	0	20	0	0
9	34349889	.	G	A	4	10	14	0	0	14	0	0
9	34349967	.	C	T	3	3	6	0	0	6	0	0
9	34350372	.	A	T	3	4	7	0	0	7	0	0
9	34351273	.	T	G	7	3	10	0	0	10	0	0
9	34351277	.	T	C	6	3	9	0	2	11	0	0
9	34351416	.	A	C	7	4	11	0	1	12	0	0
9	34351811	.	A	G	5	3	8	0	0	8	0	0
9	34351916	.	C	T	7	4	11	0	1	12	0	0
9	34380320	.	C	T	7	4	11	0	0	11	0	0
9	34380457	.	A	G	14	21	35	0	0	35	0	0
9	34382946	.	A	C	16	24	40	0	1	41	0	0
9	34382994	.	G	A	1	17	18	0	11	29	0	0
9	34383041	.	C	A	6	12	18	0	3	21	0	0
9	34385012	.	C	T	15	11	26	0	1	27	0	0
9	34385364	.	G	T	10	22	32	0	1	33	0	0
9	34385421	.	A	C	12	24	36	0	1	37	0	0
9	34388784	.	T	G	21	11	32	3	1	36	0	0
9	34388798	.	T	G	22	0	22	3	13	38	0	0
9	34388882	.	G	A	18	10	28	0	0	28	0	0
9	34388969	.	A	G	3	4	7	0	2	9	0	0
9	34389317	.	T	A	14	13	27	0	0	27	0	0
9	34389379	.	C	T	16	18	34	0	0	34	0	0
9	34389457	.	C	A	10	22	32	0	0	32	0	0
9	34389602	.	A	G	15	0	15	0	21	36	0	0
9	34389734	.	G	C	1	10	11	0	12	23	0	0
9	34397935	.	C	T	5	2	7	0	0	7	0	0
9	34399402	.	T	C	4	2	6	0	1	7	0	0
9	34401101	.	A	G	4	0	4	0	2	6	0	0
9	34407893	.	C	A	2	6	8	0	0	8	0	0
9	34409431	.	A	G	4	3	7	0	0	7	0	0
9	34409578	.	G	A	7	3	10	0	3	13	0	0
9	34410237	.	T	C	8	3	11	0	0	11	0	0
9	34412701	.	G	C	1	5	6	0	8	14	0	0
9	34415308	.	T	C	11	11	22	0	0	22	0	0
9	34425996	.	G	A	8	11	19	0	1	20	0	0
9	34426783	.	T	G	3	4	7	0	0	7	0	0
9	34426809	.	T	G	4	2	6	0	0	6	0	0
9	34426897	.	A	G	2	0	2	0	2	4	0	0
9	34427760	.	A	G	3	3	6	0	0	6	0	0
9	34427761	.	A	G	3	3	6	0	0	6	0	0
9	34435063	.	A	T	5	4	9	0	1	10	0	0
9	34437712	.	G	A	7	4	11	0	0	11	0	0
9	34437858	.	T	G	9	0	9	0	3	12	0	0
9	34438523	.	A	G	3	0	3	0	2	5	0	0
9	34438607	.	C	A	6	2	8	0	0	8	0	0
9	34438861	.	T	G	10	3	13	0	0	13	0	0
9	34442987	.	C	T	9	8	17	0	0	17	0	0
9	34449246	.	C	A	8	5	13	0	0	13	0	0
9	34451168	.	C	A	2	2	4	0	0	4	0	0
9	34452052	.	C	A	5	6	11	0	0	11	0	0
9	34452057	.	G	A	0	5	5	0	8	13	0	0
9	34461340	.	A	G	8	0	8	0	12	20	0	0
9	34466229	.	G	A	0	5	5	0	14	19	0	0
9	34470776	.	T	C	17	8	25	0	1	27	1	0
9	34472180	.	C	T	8	9	17	0	0	17	0	0
9	34474434	.	G	T	7	14	21	0	0	21	0	0
9	34474529	.	A	G	7	0	7	0	6	13	0	0
9	34484859	.	T	A	4	4	8	0	1	9	0	0
9	34484949	.	T	C	6	7	13	0	1	14	0	0
9	34484959	.	T	C	6	6	12	0	0	12	0	0
9	34484997	.	A	T	2	8	10	0	0	10	0	0
9	34485036	.	T	C	1	5	6	0	0	6	0	0
9	34485105	.	G	T	3	4	7	0	0	7	0	0
9	34485123	.	T	C	3	5	8	0	0	8	0	0
9	34485168	.	C	T	0	5	5	0	8	13	0	0
9	34488459	.	T	C	3	0	3	0	2	5	0	0
9	34490692	.	A	G	4	3	7	0	1	8	0	0
9	34494893	.	G	A	1	3	4	0	0	4	0	0
9	34647415	.	A	G	13	0	13	0	23	36	0	0
9	34647427	.	A	C	15	19	34	0	0	34	0	0
9	34866579	.	T	G	17	11	28	0	2	30	0	0
9	34866684	.	T	A	6	8	14	1	2	17	0	0
9	34866888	.	C	T	11	15	26	0	0	26	0	0
9	34867007	.	C	A	3	20	23	0	15	38	0	0
9	34867015	.	T	C	14	1	15	0	22	37	0	0
9	34869699	.	A	G	20	26	46	0	1	47	0	0
9	34869813	.	G	A	18	13	31	0	0	31	0	0
9	34869945	.	G	A	18	18	36	0	1	37	0	0
9	34871796	.	G	C	24	15	39	0	0	39	0	0
9	34877074	.	C	T	4	2	6	0	0	6	0	0
9	34877285	.	G	A	2	4	6	0	0	6	0	0
9	34877315	.	G	A	4	4	8	0	0	8	0	0
9	34878209	.	C	T	4	3	7	0	0	7	0	0
9	34878338	.	T	A	1	2	3	0	0	3	0	0
9	34880471	.	T	C	2	3	5	0	0	5	0	0
9	34880623	.	C	T	0	5	5	0	3	8	0	0
9	34880634	.	G	A	4	5	9	0	0	9	0	0
9	34903218	.	T	G	28	26	54	0	0	54	0	0
9	34906337	.	C	G	38	26	64	0	1	65	0	0
9	34912626	.	A	T	23	20	43	1	1	45	0	0
9	34912695	.	T	C	16	1	17	0	31	48	0	0
9	34912895	.	T	A	19	23	42	0	2	44	0	0
9	34920395	.	G	A	4	5	9	0	0	9	0	0
9	34922670	.	C	T	1	5	6	0	5	11	0	0
9	34922898	.	A	G	4	3	7	0	0	7	0	0
9	34937099	.	G	A	4	2	6	0	0	6	0	0
9	34937145	.	C	G	6	2	8	0	0	8	0	0
9	34937154	.	A	T	5	2	7	0	0	7	0	0
9	34938795	.	C	T	5	7	12	0	1	13	0	0
9	34939336	.	A	G	12	14	26	0	0	26	0	0
9	34939800	.	T	C	10	12	22	0	0	22	0	0
9	34967565	.	A	G	6	8	14	0	0	14	0	0
9	34967647	.	C	T	2	6	8	0	0	8	0	0
9	34967649	.	C	T	2	6	8	0	0	8	0	0
9	34967733	.	A	G	5	6	11	0	0	11	0	0
9	34967743	.	A	C	6	5	11	0	0	11	0	0
9	35014847	.	C	G	3	3	6	0	0	6	0	0
9	35022050	.	A	G	4	5	9	0	0	9	0	0
9	35024459	.	G	C	0	7	7	0	5	12	0	0
9	35026736	.	T	A	25	31	56	0	1	57	0	0
9	35026941	.	T	C	36	29	65	0	4	69	0	0
9	35027262	.	A	G	45	24	69	0	4	73	0	0
9	35027309	.	T	C	38	2	40	0	27	67	0	0
9	35027333	.	A	G	39	19	58	0	3	61	0	0
9	35027365	.	G	T	35	23	58	0	7	65	0	0
9	35027371	.	G	T	38	27	65	0	3	70	2	0
9	35027402	.	G	A	38	34	72	0	0	72	0	0
9	35027549	.	T	G	30	30	60	0	2	62	0	0
9	35027705	.	G	A	19	10	29	0	3	38	6	0
9	35028086	.	T	C	34	7	41	0	38	79	0	0
9	35028282	.	T	C	36	8	44	0	41	85	0	0
9	35030977	.	G	A	46	22	68	1	2	71	0	0
9	35032640	.	A	G	33	32	65	0	1	66	0	0
9	35032643	.	A	G	33	31	64	0	2	66	0	0
9	35033347	.	C	T	34	27	61	0	6	67	0	0
9	35039175	.	T	C	32	27	59	1	1	61	0	0
9	35048839	.	G	C	31	37	68	0	1	69	0	0
9	35048840	.	A	C	30	37	67	0	3	70	0	0
9	35170671	.	G	A	11	13	24	0	0	24	0	0
9	35176030	.	A	G	25	21	46	0	0	46	0	0
9	35228165	.	G	A	14	14	28	0	2	30	0	0
9	35230740	.	G	A	14	11	25	0	1	26	0	0
9	35254679	.	G	A	13	10	23	0	0	23	0	0
9	35266330	.	C	T	2	16	18	1	7	26	0	0
9	35296835	.	C	T	18	10	28	0	0	28	0	0
9	35836674	.	T	G	11	9	20	0	0	20	0	0
9	35836721	.	T	A	7	8	15	0	0	15	0	0
9	35837194	.	C	G	11	0	11	0	10	21	0	0
9	35837404	.	C	A	7	12	19	0	1	20	0	0
9	35838477	.	T	A	7	18	25	0	4	29	0	0
9	35840713	.	G	A	10	8	18	0	0	18	0	0
9	35840782	.	T	C	8	8	16	0	0	16	0	0
9	35841279	.	G	T	4	7	11	0	0	11	0	0
9	35841282	.	A	G	4	7	11	0	0	11	0	0
9	35841663	.	G	T	14	11	25	0	0	25	0	0
9	35841879	.	T	A	15	9	24	0	1	25	0	0
9	35841994	.	A	G	5	2	7	0	0	7	0	0
9	35842164	.	T	A	11	6	17	0	0	17	0	0
9	35842209	.	G	T	4	9	13	0	1	14	0	0
9	35843866	.	C	T	3	2	5	0	0	5	0	0
9	35844003	.	A	T	1	2	3	0	0	3	0	0
9	35860982	.	G	A	8	10	18	0	1	19	0	0
9	35860983	.	A	T	8	10	18	0	1	19	0	0
9	35862184	.	A	T	9	16	25	0	1	26	0	0
9	35862299	.	G	A	17	19	36	0	6	42	0	0
9	35863132	.	C	T	22	22	44	0	1	45	0	0
9	35863555	.	T	C	21	16	37	0	0	37	0	0
9	35863603	.	T	C	23	15	38	0	0	38	0	0
9	35863798	.	C	T	23	22	45	0	0	45	0	0
9	35863968	.	A	T	13	18	31	0	3	34	0	0
9	35864155	.	A	T	15	11	26	0	0	26	0	0
9	35864210	.	C	T	11	5	16	0	0	16	0	0
9	35864266	.	C	A	9	10	19	0	2	21	0	0
9	35864277	.	C	T	9	13	22	0	0	22	0	0
9	35864356	.	A	G	5	4	9	0	0	9	0	0
9	35864486	.	C	T	5	3	8	0	0	8	0	0
9	35864565	.	A	G	8	7	15	0	0	15	0	0
9	35864598	.	C	T	9	7	16	0	1	17	0	0
9	35865073	.	C	T	16	13	29	0	1	30	0	0
9	35865162	.	G	T	15	9	24	0	0	24	0	0
9	35865270	.	C	G	15	10	25	0	3	28	0	0
9	35872942	.	G	A	2	2	4	0	1	5	0	0
9	35872993	.	A	T	2	4	6	0	0	6	0	0
9	35901598	.	G	C	4	4	8	0	0	8	0	0
9	35901654	.	T	A	10	9	19	0	1	20	0	0
9	35906533	.	C	A	5	3	8	0	0	8	0	0
9	35907553	.	C	T	5	3	8	0	0	8	0	0
9	35909794	.	T	C	6	2	8	0	0	8	0	0
9	35910390	.	C	G	4	16	20	0	1	21	0	0
9	35910672	.	T	C	5	11	16	0	0	16	0	0
9	35912447	.	A	T	3	5	8	0	0	8	0	0
9	35912459	.	G	A	7	3	10	0	0	10	0	0
9	35912661	.	G	C	4	5	9	0	0	9	0	0
9	35915327	.	C	A	5	11	16	0	0	16	0	0
9	35915548	.	C	T	4	11	15	0	0	15	0	0
9	35915557	.	G	A	1	11	12	0	3	15	0	0
9	35916518	.	T	G	8	20	28	0	0	28	0	0
9	35916786	.	G	A	11	11	22	0	0	22	0	0
9	35922046	.	T	G	8	19	27	1	0	28	0	0
9	35922115	.	T	C	6	10	16	0	2	18	0	0
9	36375155	.	G	A	2	6	8	0	0	8	0	0
9	36388100	.	T	C	2	2	4	0	0	4	0	0
9	36393805	.	C	T	3	4	7	0	0	7	0	0
9	36395397	.	A	T	1	4	5	0	0	5	0	0
9	36395421	.	T	C	1	4	5	0	0	5	0	0
9	36426844	.	G	C	2	3	5	0	0	5	0	0
9	36444249	.	C	T	4	2	6	0	0	6	0	0
9	36485181	.	T	A	3	5	8	0	0	8	0	0
9	36487835	.	T	C	2	2	4	0	0	4	0	0
9	36500551	.	G	A	1	2	3	0	1	4	0	0
9	36500841	.	T	C	1	5	6	0	0	6	0	0
9	36540309	.	C	T	3	2	5	0	0	5	0	0
9	36540330	.	T	C	5	2	7	0	0	7	0	0
9	36555951	.	C	T	4	7	11	0	0	11	0	0
9	36559940	.	C	T	5	6	11	0	0	11	0	0
9	36577315	.	T	C	6	3	9	0	0	9	0	0
9	36580205	.	A	G	5	10	15	0	0	15	0	0
9	36585992	.	G	A	0	5	5	0	4	9	0	0
9	36595278	.	G	A	3	2	5	1	0	6	0	0
9	36595536	.	G	A	4	2	6	0	0	6	0	0
9	36610121	.	A	G	6	0	6	0	3	9	0	0
9	36610139	.	C	T	6	2	8	0	0	8	0	0
9	36610163	.	T	C	5	3	8	0	1	9	0	0
9	36610202	.	C	T	7	3	10	0	0	10	0	0
9	36613178	.	C	T	1	3	4	0	0	4	0	0
9	36613202	.	C	T	3	3	6	0	0	6	0	0
9	36656011	.	A	G	5	5	10	0	1	11	0	0
9	36659702	.	T	G	3	8	11	0	0	11	0	0
9	36896761	.	C	A	0	3	3	0	2	5	0	0
9	36896791	.	C	T	2	5	7	0	0	7	0	0
9	36898724	.	C	T	7	13	20	1	1	22	0	0
9	36899065	.	C	T	1	8	9	0	15	24	0	0
9	36972858	.	A	G	1	0	1	0	2	3	0	0
9	36972936	.	T	C	2	2	4	0	1	5	0	0
9	36973147	.	T	C	1	4	5	0	0	5	0	0
9	36973898	.	A	G	2	3	5	0	0	5	0	0
9	36974460	.	C	T	1	2	3	0	0	3	0	0
9	37275202	.	C	T	1	2	3	0	0	3	0	0
9	37291431	.	G	T	2	3	5	0	0	5	0	0
9	37371515	.	A	T	8	6	14	1	0	15	0	0
9	37387230	.	T	C	8	4	12	0	1	13	0	0
9	37387233	.	T	C	9	4	13	0	0	13	0	0
9	37390314	.	C	T	6	6	12	0	0	12	0	0
9	37416605	.	C	T	7	8	15	0	0	15	0	0
9	37416617	.	C	T	6	8	14	0	0	14	0	0
9	37431935	.	G	A	2	8	10	0	7	17	0	0
9	37451609	.	T	G	11	6	17	0	0	17	0	0
9	37451809	.	A	G	10	11	21	0	0	21	0	0
9	37452012	.	A	T	17	4	21	0	2	23	0	0
9	37452223	.	C	T	7	8	15	0	2	17	0	0
9	37452432	.	G	A	5	14	19	0	0	19	0	0
9	37452499	.	T	G	9	6	15	0	1	16	0	0
9	37452515	.	G	T	9	7	16	0	0	16	0	0
9	37452616	.	T	G	15	10	25	0	1	26	0	0
9	37452819	.	G	C	10	5	15	0	0	15	0	0
9	37452862	.	T	C	9	7	16	0	0	16	0	0
9	37452924	.	C	G	8	10	18	0	0	18	0	0
9	37492798	.	G	A	4	6	10	0	2	12	0	0
9	37492807	.	A	G	4	8	12	0	0	12	0	0
9	37508255	.	T	C	1	2	3	0	0	3	0	0
9	37549795	.	G	C	1	0	1	0	5	6	0	0
9	37573890	.	C	G	1	4	5	0	0	5	0	0
9	37754913	.	G	A	3	2	5	0	0	5	0	0
9	37771849	.	A	G	1	5	6	0	0	6	0	0
9	37815520	.	A	T	2	5	7	0	0	7	0	0
9	37815548	.	A	G	1	0	1	0	7	8	0	0
9	37839770	.	G	A	0	3	3	0	5	8	0	0
9	37839778	.	A	T	4	1	5	0	1	6	0	0
9	37840024	.	G	T	5	3	8	0	0	8	0	0
9	37850559	.	T	A	6	7	13	0	1	14	0	0
9	37850574	.	A	G	7	0	7	0	6	13	0	0
9	37853970	.	A	C	10	5	15	0	0	15	0	0
9	37856541	.	C	T	6	15	21	0	0	21	0	0
9	37856895	.	T	A	6	6	12	0	2	14	0	0
9	37859807	.	G	T	7	14	21	1	2	25	1	0
9	37859881	.	T	G	19	9	28	0	1	29	0	0
9	37860116	.	T	C	6	2	8	1	0	9	0	0
9	37861490	.	A	T	2	6	8	0	0	8	0	0
9	37861560	.	A	G	3	0	3	0	3	6	0	0
9	37861763	.	G	T	2	3	5	0	0	5	0	0
9	37861834	.	G	A	7	3	10	0	0	10	0	0
9	37861844	.	G	A	2	8	10	0	0	10	0	0
9	37862121	.	A	G	2	1	3	0	4	7	0	0
9	37862124	.	C	T	2	3	5	0	0	5	0	0
9	37941602	.	C	T	5	4	9	1	1	11	0	0
9	38021242	.	C	T	2	3	5	0	0	5	0	0
9	38021291	.	A	T	5	3	8	0	0	8	0	0
9	38021487	.	T	C	1	0	1	0	2	3	0	0
9	38030001	.	T	G	16	11	27	3	3	33	0	0
9	38030131	.	A	T	17	8	25	0	2	27	0	0
9	38030366	.	A	T	5	9	14	0	1	15	0	0
9	38030485	.	A	T	6	10	16	0	0	16	0	0
9	38030503	.	C	T	0	9	9	0	8	17	0	0
9	38030574	.	G	A	9	8	17	0	0	17	0	0
9	38033363	.	T	C	19	0	19	0	7	26	0	0
9	38033578	.	A	G	16	13	29	0	0	29	0	0
9	38042752	.	G	A	11	6	17	0	0	17	0	0
9	38043476	.	T	C	4	7	11	0	0	11	0	0
9	38057075	.	A	G	6	9	15	0	0	15	0	0
9	38058608	.	T	C	4	5	9	0	0	9	0	0
9	38059042	.	C	T	5	8	13	0	0	13	0	0
9	38061311	.	G	A	12	8	20	0	0	20	0	0
9	38061525	.	G	T	1	7	8	0	10	18	0	0
9	38061699	.	T	C	13	5	18	0	1	19	0	0
9	38061788	.	T	C	14	10	24	0	2	26	0	0
9	38063688	.	C	A	9	8	17	0	1	18	0	0
9	38063689	.	C	A	9	9	18	0	0	18	0	0
9	38064165	.	A	T	4	7	11	0	0	11	0	0
9	38064268	.	T	C	6	6	12	0	0	12	0	0
9	38064420	.	T	G	10	5	15	0	0	15	0	0
9	38064421	.	C	A	10	5	15	0	0	15	0	0
9	38064672	.	A	C	8	8	16	0	0	16	0	0
9	38074140	.	A	T	6	4	10	0	0	10	0	0
9	38129312	.	C	G	7	6	13	0	0	13	0	0
9	38129632	.	A	G	5	0	5	0	3	8	0	0
9	38140963	.	C	A	0	2	2	0	1	3	0	0
9	38161842	.	C	T	2	3	5	0	0	5	0	0
9	38161975	.	T	G	1	5	6	0	0	6	0	0
9	38167875	.	T	C	4	5	9	0	0	9	0	0
9	38168065	.	G	A	0	4	4	0	4	8	0	0
9	38205480	.	G	T	0	7	7	0	4	11	0	0
9	38207964	.	G	A	9	8	17	0	1	18	0	0
9	38238917	.	G	A	0	12	12	0	12	24	0	0
9	38251409	.	T	C	11	5	16	0	3	19	0	0
9	38266131	.	T	C	7	4	11	0	2	13	0	0
9	38269630	.	A	G	6	8	14	0	0	14	0	0
9	38273171	.	G	A	21	21	42	0	1	43	0	0
9	38273264	.	T	A	23	14	37	0	0	37	0	0
9	38276558	.	T	G	10	1	11	0	9	20	0	0
9	38277513	.	A	G	16	11	27	0	0	27	0	0
9	38278121	.	A	G	22	9	31	0	0	31	0	0
9	38278289	.	C	T	15	12	27	0	2	29	0	0
9	38278301	.	T	C	18	13	31	0	1	32	0	0
9	38278337	.	T	C	18	11	29	0	0	29	0	0
9	38283647	.	G	A	21	12	33	0	2	35	0	0
9	38283659	.	C	T	24	12	36	0	3	39	0	0
9	38284317	.	A	G	19	0	19	0	13	32	0	0
9	38285598	.	A	G	17	21	38	0	3	41	0	0
9	38286823	.	G	A	18	12	30	0	1	31	0	0
9	38290165	.	C	T	16	10	26	0	0	26	0	0
9	38290210	.	A	G	13	11	24	0	0	24	0	0
9	38290220	.	T	G	15	0	15	0	13	28	0	0
9	38290245	.	C	T	18	12	30	0	0	30	0	0
9	38290517	.	A	C	8	7	15	0	2	17	0	0
9	38290530	.	A	T	10	8	18	1	2	21	0	0
9	38290561	.	C	T	8	7	15	2	0	17	0	0
9	38290777	.	G	T	2	10	12	0	19	32	1	0
9	38290959	.	A	C	20	17	37	0	1	38	0	0
9	38291439	.	G	T	20	12	32	0	2	34	0	0
9	38291616	.	C	T	15	9	24	0	1	25	0	0
9	38291737	.	C	A	4	5	9	0	2	11	0	0
9	38315128	.	T	G	5	8	13	0	1	14	0	0
9	38315827	.	C	G	7	4	11	0	0	11	0	0
9	38316758	.	G	A	3	5	8	0	0	8	0	0
9	38316769	.	T	C	3	5	8	0	0	8	0	0
9	38348458	.	G	A	3	5	8	0	0	8	0	0
9	38351016	.	T	C	5	4	9	0	2	11	0	0
9	38353794	.	T	C	14	6	20	0	1	21	0	0
9	38354000	.	T	C	14	11	25	0	2	27	0	0
9	38354224	.	A	G	13	7	20	0	0	20	0	0
9	38354689	.	G	A	8	12	20	0	0	20	0	0
9	38359027	.	A	C	11	1	12	0	6	18	0	0
9	38359737	.	G	A	9	5	14	0	0	14	0	0
9	38360102	.	C	T	0	6	6	0	8	14	0	0
9	38362354	.	G	A	14	8	22	0	0	22	0	0
9	38362380	.	C	T	8	6	14	0	0	14	0	0
9	38365213	.	T	C	4	0	4	0	4	8	0	0
9	38366653	.	T	C	6	5	11	0	0	11	0	0
9	38366656	.	C	A	0	6	6	0	5	11	0	0
9	38366826	.	A	G	4	6	10	0	0	10	0	0
9	38366883	.	C	G	4	3	7	0	0	7	0	0
9	38368055	.	A	G	10	5	15	0	0	15	0	0
9	38372264	.	C	T	3	4	7	0	0	7	0	0
9	38376129	.	A	T	1	6	7	0	0	7	0	0
9	38377858	.	G	A	3	2	5	0	0	5	0	0
9	38386066	.	A	G	3	0	3	0	5	8	0	0
9	38386205	.	C	T	3	9	12	0	0	12	0	0
9	38386615	.	C	A	3	3	6	0	1	7	0	0
9	38388017	.	G	A	1	2	3	0	0	3	0	0
9	38388492	.	C	T	6	5	11	0	0	11	0	0
9	38388493	.	C	T	4	5	9	0	2	11	0	0
9	38388703	.	T	C	6	7	13	0	1	14	0	0
9	38389026	.	T	A	7	7	14	0	0	14	0	0
9	38389194	.	C	T	5	7	12	0	1	13	0	0
9	38389263	.	T	A	3	6	9	0	1	10	0	0
9	38389603	.	A	G	9	2	11	0	5	16	0	0
9	38389616	.	C	T	11	7	18	0	0	18	0	0
9	38389644	.	A	T	10	7	17	0	1	18	0	0
9	38389722	.	G	T	5	5	10	0	0	10	0	0
9	38389746	.	T	C	6	6	12	0	0	12	0	0
9	38389886	.	C	T	10	8	18	0	0	18	0	0
9	38390973	.	A	G	1	2	3	0	0	3	0	0
9	38390976	.	G	A	1	2	3	0	0	3	0	0
9	38392045	.	T	G	3	2	5	0	0	5	0	0
9	38392097	.	T	C	2	4	6	0	0	6	0	0
9	38392326	.	C	A	3	2	5	0	0	5	0	0
9	38393080	.	G	C	1	3	4	0	0	4	0	0
9	38396699	.	G	C	1	2	3	0	1	4	0	0
9	38397214	.	T	C	3	2	5	0	0	5	0	0
9	38397263	.	A	G	2	3	5	0	0	5	0	0
9	38399389	.	T	C	3	4	7	0	0	7	0	0
9	38400053	.	A	T	2	2	4	0	0	4	0	0
9	38400073	.	T	C	1	3	4	0	0	4	0	0
9	38400232	.	T	A	3	2	5	0	1	6	0	0
9	38400233	.	T	C	3	3	6	0	0	6	0	0
9	38405238	.	A	G	7	3	10	0	0	10	0	0
9	38405271	.	G	C	5	3	8	0	0	8	0	0
9	38413298	.	C	T	7	9	16	0	0	16	0	0
9	38418864	.	T	C	5	3	8	0	0	8	0	0
9	38428554	.	C	G	4	2	6	1	0	7	0	0
9	38429624	.	G	T	10	6	16	0	0	16	0	0
9	38429647	.	A	G	12	1	13	0	4	17	0	0
9	38429894	.	A	T	6	4	10	1	0	11	0	0
9	38457917	.	T	C	4	4	8	0	0	8	0	0
9	38458204	.	A	C	5	6	11	0	0	11	0	0
9	38458220	.	T	A	5	6	11	0	1	12	0	0
9	38458369	.	A	C	4	3	7	0	0	7	0	0
9	38458530	.	A	C	3	2	5	0	0	5	0	0
9	38458629	.	A	G	3	4	7	0	0	7	0	0
9	38458687	.	C	T	1	2	3	0	0	3	0	0
9	38458759	.	A	G	1	0	1	0	3	4	0	0
9	38458825	.	C	T	4	3	7	0	0	7	0	0
9	38458999	.	T	A	3	4	7	0	1	8	0	0
9	38459282	.	G	A	2	2	4	0	0	4	0	0
9	38459558	.	G	A	2	3	5	0	1	6	0	0
9	38462702	.	G	A	1	3	4	0	0	4	0	0
9	38465631	.	T	A	1	4	5	0	2	7	0	0
9	38466332	.	T	G	2	3	5	0	0	5	0	0
9	38470376	.	C	T	5	4	9	0	0	9	0	0
9	38470665	.	T	G	4	4	8	0	1	9	0	0
9	38473937	.	T	C	4	4	8	0	0	8	0	0
9	38473973	.	C	T	5	2	7	0	0	7	0	0
9	38476650	.	A	C	4	2	6	0	2	8	0	0
9	38476748	.	G	A	3	3	6	0	0	6	0	0
9	38476780	.	G	C	3	2	5	0	0	5	0	0
9	38478252	.	A	G	2	3	5	0	0	5	0	0
9	38478643	.	A	T	1	7	8	0	0	8	0	0
9	38479579	.	A	G	3	0	3	0	8	11	0	0
9	38495985	.	C	T	4	5	9	0	0	9	0	0
9	38497393	.	C	T	1	4	5	0	0	5	0	0
9	38502640	.	A	G	3	6	9	0	0	9	0	0
9	38502683	.	A	T	2	3	5	0	0	5	0	0
9	38502734	.	T	A	4	3	7	0	0	7	0	0
9	38506389	.	T	A	2	3	5	0	0	5	0	0
9	38510004	.	C	A	4	2	6	0	0	6	0	0
9	38525107	.	A	C	4	2	6	0	0	6	0	0
9	38525125	.	T	C	4	2	6	0	0	6	0	0
9	38530916	.	G	A	2	2	4	0	0	4	0	0
9	38537286	.	G	A	1	5	6	0	2	8	0	0
9	38542189	.	A	G	1	0	1	0	2	3	0	0
9	38542201	.	T	C	2	2	4	0	0	4	0	0
9	38542252	.	C	T	2	4	6	0	0	6	0	0
9	38550889	.	T	C	1	8	9	0	0	9	0	0
9	38550910	.	T	C	2	9	11	0	0	11	0	0
9	38600006	.	G	A	0	4	4	0	3	7	0	0
9	38603338	.	A	T	16	16	32	0	0	32	0	0
9	38603742	.	T	C	17	11	28	0	1	29	0	0
9	38620058	.	C	T	13	8	21	0	1	22	0	0
9	38620308	.	C	A	5	6	11	0	0	11	0	0
9	38620673	.	A	G	22	14	36	0	0	36	0	0
9	38624628	.	T	C	3	5	8	0	0	8	0	0
9	38624629	.	C	T	3	5	8	0	0	8	0	0
9	38629997	.	T	A	6	6	12	0	0	12	0	0
9	38634508	.	A	G	4	2	6	0	0	6	0	0
9	38635435	.	G	A	3	7	10	0	0	10	0	0
9	38635564	.	G	A	2	4	6	0	0	6	0	0
9	38635623	.	A	G	5	2	7	0	0	7	0	0
9	38636152	.	A	G	10	0	10	0	7	17	0	0
9	38636170	.	A	G	10	7	17	0	0	17	0	0
9	38636413	.	G	T	0	6	6	0	5	11	0	0
9	38636722	.	T	C	9	6	15	0	2	17	0	0
9	38636797	.	T	C	7	7	14	0	0	14	0	0
9	38637072	.	G	T	1	2	3	0	0	3	0	0
9	38637872	.	T	C	3	4	7	0	1	8	0	0
9	38637879	.	A	C	3	2	5	0	0	5	0	0
9	38638197	.	C	T	6	4	10	0	0	10	0	0
9	38638452	.	A	T	6	9	15	0	0	15	0	0
9	38638461	.	C	G	7	9	16	0	0	16	0	0
9	38638492	.	A	G	7	0	7	0	7	14	0	0
9	38638518	.	T	C	7	12	19	0	1	20	0	0
9	38638743	.	T	C	11	10	21	0	0	21	0	0
9	38638862	.	C	T	9	4	13	0	0	13	0	0
9	38638863	.	C	A	10	4	14	0	0	14	0	0
9	38638970	.	G	A	3	5	8	0	2	10	0	0
9	38639799	.	T	C	2	10	12	0	0	12	0	0
9	38639846	.	C	T	2	9	11	0	0	11	0	0
9	38639907	.	A	C	4	2	6	0	0	6	0	0
9	38639999	.	C	T	6	7	13	0	0	13	0	0
9	38640114	.	T	A	8	5	13	0	0	13	0	0
9	38640186	.	T	C	3	9	12	0	1	13	0	0
9	38640193	.	T	C	4	8	12	0	2	14	0	0
9	38640598	.	A	G	4	1	5	0	3	8	0	0
9	38640773	.	A	T	3	2	5	0	0	5	0	0
9	38641111	.	C	T	3	4	7	0	0	7	0	0
9	38692935	.	T	C	2	2	4	0	0	4	0	0
9	38706282	.	G	C	1	2	3	0	0	3	0	0
9	38706894	.	T	A	1	3	4	0	0	4	0	0
9	38707187	.	C	T	1	2	3	0	0	3	0	0
9	38763027	.	T	C	3	1	4	0	0	4	0	0
9	38763034	.	T	A	3	2	5	0	0	5	0	0
9	38764749	.	T	C	3	3	6	0	0	6	0	0
9	38764752	.	A	G	3	3	6	0	0	6	0	0
9	38765179	.	A	G	2	0	2	0	3	5	0	0
9	38948420	.	C	T	16	15	31	1	1	33	0	0
9	38958358	.	C	A	2	7	9	0	0	9	0	0
9	38962017	.	A	C	18	24	42	0	0	42	0	0
9	38962081	.	T	G	18	19	37	0	0	37	0	0
9	40928284	.	T	C	10	0	10	0	5	15	0	0
9	40930319	.	T	C	7	4	11	0	0	11	0	0
9	40930354	.	T	C	6	4	10	0	0	10	0	0
9	41479980	.	A	G	3	3	6	0	0	6	0	0
9	41481134	.	A	G	3	3	6	0	0	6	0	0
9	41481147	.	A	G	3	2	5	0	0	5	0	0
9	41680441	.	A	G	12	4	16	0	3	19	0	0
9	42360743	.	C	G	12	5	17	0	1	18	0	0
9	42360893	.	C	T	1	10	11	0	4	15	0	0
9	42360899	.	G	A	3	9	12	0	0	12	0	0
9	42372354	.	T	A	1	5	6	0	0	6	0	0
9	42418425	.	T	C	6	7	13	0	0	13	0	0
9	42418463	.	C	A	1	5	6	0	0	6	0	0
9	42421027	.	G	A	3	2	5	0	0	5	0	0
9	42421044	.	G	T	3	3	6	0	0	6	0	0
9	42421232	.	T	A	3	2	5	0	0	5	0	0
9	42421390	.	G	T	1	2	3	1	0	4	0	0
9	42421404	.	A	G	1	2	3	0	0	3	0	0
9	42430358	.	A	G	1	3	4	0	0	4	0	0
9	42430359	.	T	C	1	3	4	0	0	4	0	0
9	42644892	.	A	G	14	0	14	0	9	23	0	0
9	42649583	.	A	G	3	3	6	1	1	8	0	0
9	42649636	.	T	A	3	4	7	0	0	7	0	0
9	42649653	.	T	C	1	4	5	0	0	5	0	0
9	42649739	.	C	T	9	5	14	0	0	14	0	0
9	42649743	.	A	G	9	5	14	0	0	14	0	0
9	42649923	.	A	G	7	6	13	0	0	13	0	0
9	42653737	.	T	C	3	2	5	0	0	5	0	0
9	42657418	.	A	T	3	2	5	0	0	5	0	0
9	42658401	.	G	C	2	4	6	0	0	6	0	0
9	42658788	.	A	G	2	2	4	0	0	4	0	0
9	42660036	.	T	C	3	5	8	0	0	8	0	0
9	42671131	.	T	A	3	2	5	0	0	5	0	0
9	43082373	.	A	T	2	3	5	0	0	5	0	0
9	43082398	.	A	G	1	2	3	0	0	3	0	0
9	43082541	.	A	C	2	0	2	0	0	2	0	0
9	43082717	.	T	G	1	4	5	0	1	6	0	0
9	43085369	.	G	T	5	3	8	0	0	8	0	0
9	43085471	.	G	C	3	7	10	0	0	10	0	0
9	43085527	.	A	T	5	3	8	0	0	8	0	0
9	43085728	.	A	C	5	6	11	0	0	11	0	0
9	43085879	.	C	T	6	2	8	0	0	8	0	0
9	43085949	.	A	C	6	4	10	0	0	10	0	0
9	43088841	.	C	A	3	2	5	0	1	6	0	0
9	43088870	.	T	A	2	4	6	0	2	8	0	0
9	43088884	.	G	A	3	6	9	0	1	10	0	0
9	43088910	.	A	T	4	3	7	0	0	7	0	0
9	43088984	.	A	G	3	7	10	0	0	10	0	0
9	43089038	.	C	G	4	3	7	0	1	8	0	0
9	43107318	.	A	T	2	3	5	0	0	5	0	0
9	43107351	.	T	C	1	4	5	0	0	5	0	0
9	43110640	.	G	T	2	3	5	0	0	5	0	0
9	43113730	.	A	G	1	2	3	0	0	3	0	0
9	43116589	.	C	A	3	3	6	0	1	7	0	0
9	43127145	.	T	C	1	0	1	0	2	3	0	0
9	43150018	.	T	A	7	6	13	0	1	14	0	0
9	43150278	.	T	G	8	9	17	0	0	17	0	0
9	43150604	.	A	G	17	21	38	3	2	43	0	0
9	43150817	.	C	T	1	26	27	0	16	43	0	0
9	43153287	.	C	T	9	15	24	0	3	27	0	0
9	43154841	.	C	T	13	17	30	0	0	30	0	0
9	43175527	.	C	T	0	16	16	0	13	29	0	0
9	43202097	.	T	C	6	0	6	0	18	24	0	0
9	43207727	.	G	A	5	14	19	0	0	19	0	0
9	43243265	.	A	C	15	3	18	0	0	18	0	0
9	43243266	.	T	C	15	3	18	0	0	18	0	0
9	43261951	.	T	A	9	10	19	0	4	23	0	0
9	43287748	.	G	A	10	7	17	0	0	17	0	0
9	43375122	.	G	A	7	2	9	0	2	11	0	0
9	43552687	.	A	C	11	5	16	1	0	17	0	0
9	43553036	.	G	T	8	14	22	0	0	22	0	0
9	43559501	.	A	C	9	7	16	0	0	16	0	0
9	43612482	.	T	G	5	6	11	0	0	11	0	0
9	43617899	.	A	G	5	10	15	0	1	16	0	0
9	43617962	.	A	G	8	10	18	0	0	18	0	0
9	43630057	.	C	T	2	2	4	0	3	7	0	0
9	43630216	.	G	C	2	3	5	0	0	5	0	0
9	44097854	.	C	T	0	3	3	0	5	8	0	0
9	44109260	.	A	G	2	3	5	0	0	5	0	0
9	44109589	.	T	C	6	0	6	0	3	9	0	0
9	44109595	.	T	C	6	0	6	0	3	9	0	0
9	44249852	.	T	C	1	4	5	0	0	5	0	0
9	44249897	.	C	T	2	3	5	0	0	5	0	0
9	44292285	.	A	C	32	1	33	0	17	50	0	0
9	44292737	.	T	C	28	28	56	0	0	56	0	0
9	44292909	.	C	T	2	41	43	0	20	63	0	0
9	44293488	.	C	T	29	29	58	0	4	62	0	0
9	44294792	.	A	G	17	11	28	0	1	29	0	0
9	44391339	.	T	G	1	2	3	0	0	3	0	0
9	44391395	.	G	A	5	3	8	0	0	8	0	0
9	44391507	.	G	C	2	2	4	0	0	4	0	0
9	44400091	.	T	G	2	3	5	0	0	5	0	0
9	44400580	.	G	A	7	6	13	0	0	13	0	0
9	44400706	.	C	A	5	4	9	0	0	9	0	0
9	44411647	.	A	G	3	4	7	0	0	7	0	0
9	44411652	.	C	A	4	4	8	0	1	9	0	0
9	44411828	.	A	C	4	6	10	0	0	10	0	0
9	44419652	.	T	A	7	3	10	0	1	11	0	0
9	44419793	.	C	A	3	6	9	0	0	9	0	0
9	44431157	.	C	G	6	2	8	0	0	8	0	0
9	44443998	.	T	C	26	13	39	0	0	39	0	0
9	44469318	.	A	G	19	0	19	1	22	42	0	0
9	44488578	.	T	A	6	9	15	0	0	15	0	0
9	44488620	.	G	A	6	8	14	0	1	15	0	0
9	44489843	.	G	A	1	5	6	0	3	9	0	0
9	44489844	.	T	A	4	5	9	0	0	9	0	0
9	44498332	.	T	C	11	12	23	0	0	23	0	0
9	44509181	.	G	A	7	11	18	0	4	22	0	0
9	44511218	.	C	T	5	8	13	0	0	13	0	0
9	44515937	.	G	A	8	6	14	0	0	14	0	0
9	44526546	.	G	A	11	9	20	0	1	21	0	0
9	44641974	.	A	T	8	16	24	0	1	25	0	0
9	44642017	.	G	A	7	15	22	0	1	23	0	0
9	44642057	.	T	C	11	1	12	0	16	28	0	0
9	44961222	.	G	T	5	2	7	0	0	7	0	0
9	44965663	.	T	C	3	2	5	0	0	5	0	0
9	45504357	.	A	C	5	3	8	0	0	8	0	0
9	45504485	.	A	G	11	3	14	0	0	14	0	0
9	45523256	.	T	C	9	3	12	0	0	12	0	0
9	45523262	.	C	T	10	3	13	0	1	14	0	0
9	45536096	.	A	G	6	7	13	0	0	13	0	0
9	45541036	.	C	A	7	8	15	0	1	16	0	0
9	45541239	.	G	A	4	10	14	0	0	14	0	0
9	45551078	.	A	T	18	18	36	0	0	36	0	0
9	45551368	.	T	A	2	8	10	0	0	10	0	0
9	45552338	.	T	G	8	8	16	0	1	17	0	0
9	45552364	.	G	A	1	6	7	0	7	14	0	0
9	45552386	.	C	G	9	8	17	0	2	19	0	0
9	45552567	.	G	A	1	13	14	0	16	30	0	0
9	45552806	.	G	A	2	10	12	0	8	20	0	0
9	45552881	.	T	C	14	16	30	0	0	30	0	0
9	45552924	.	C	A	11	15	26	0	0	26	0	0
9	45552957	.	C	T	12	13	25	0	1	26	0	0
9	45623346	.	C	T	6	3	9	0	2	11	0	0
9	45623446	.	A	G	7	6	13	0	0	13	0	0
9	45688986	.	C	T	1	3	4	0	0	4	0	0
9	45934131	.	A	G	6	5	11	0	0	11	0	0
9	45945935	.	A	C	8	8	16	0	2	18	0	0
9	45968318	.	A	G	5	6	11	0	0	11	0	0
9	45969254	.	C	T	2	9	11	0	3	14	0	0
9	45969386	.	G	A	5	17	22	0	0	22	0	0
9	45990874	.	C	T	2	8	10	0	5	15	0	0
9	46029269	.	G	T	7	10	17	0	3	20	0	0
9	46039567	.	T	C	8	3	11	0	3	14	0	0
9	46409427	.	C	T	0	5	5	0	4	9	0	0
9	46409442	.	A	G	1	4	5	0	0	5	0	0
9	46409589	.	T	A	1	3	4	0	0	4	0	0
9	46525673	.	A	G	7	9	16	0	0	16	0	0
9	46598134	.	T	C	2	8	10	0	0	10	0	0
9	46603999	.	A	G	4	0	4	0	7	11	0	0
9	46604068	.	A	G	2	0	2	0	5	7	0	0
9	46604930	.	C	T	6	5	11	0	0	11	0	0
9	46650764	.	T	C	9	5	14	0	2	16	0	0
9	46656990	.	G	C	0	7	7	0	2	9	0	0
9	46657128	.	T	C	6	3	9	0	0	9	0	0
9	46667831	.	A	T	4	4	8	0	1	9	0	0
9	46671108	.	G	A	1	6	7	0	6	13	0	0
9	46671174	.	C	T	1	7	8	0	0	8	0	0
9	46672436	.	G	A	4	9	13	0	1	14	0	0
9	46676385	.	C	T	5	5	10	0	1	11	0	0
9	46676393	.	C	G	5	5	10	0	0	10	0	0
9	46678159	.	A	C	6	11	17	0	0	17	0	0
9	46678196	.	C	T	2	11	13	0	0	13	0	0
9	46678255	.	T	C	4	7	11	0	1	12	0	0
9	46678279	.	A	T	4	8	12	0	1	13	0	0
9	46683760	.	C	A	8	7	15	0	0	15	0	0
9	46683861	.	A	C	8	14	22	0	1	24	1	0
9	46684000	.	A	C	2	4	6	0	1	7	0	0
9	46684356	.	A	C	3	3	6	0	0	6	0	0
9	46692261	.	T	G	11	23	34	0	2	36	0	0
9	46745653	.	A	G	6	4	10	0	2	12	0	0
9	46784333	.	G	A	3	5	8	0	1	9	0	0
9	46799102	.	T	C	9	6	15	0	1	16	0	0
9	46821464	.	C	T	9	13	22	0	1	23	0	0
9	46821685	.	A	G	6	3	9	0	0	9	0	0
9	46821803	.	A	C	1	7	8	0	0	8	0	0
9	46821810	.	C	G	1	6	7	0	0	7	0	0
9	46821853	.	G	A	4	6	10	0	0	10	0	0
9	46821855	.	G	T	4	5	9	0	1	10	0	0
9	46821905	.	A	G	6	9	15	0	1	16	0	0
9	46821916	.	A	T	7	7	14	0	2	16	0	0
9	46822002	.	T	C	8	4	12	3	2	17	0	0
9	46822079	.	C	T	12	8	20	0	0	20	0	0
9	46822120	.	C	T	1	7	8	0	10	19	1	0
9	46822144	.	T	C	9	8	17	0	1	18	0	0
9	46822417	.	C	T	1	2	3	0	7	10	0	0
9	46823198	.	C	T	14	21	35	0	1	36	0	0
9	46823325	.	G	A	7	18	25	0	1	26	0	0
9	46823366	.	T	C	9	19	28	1	1	30	0	0
9	46823524	.	A	G	10	16	26	0	2	28	0	0
9	46824110	.	A	G	12	11	23	0	0	23	0	0
9	46824160	.	T	A	6	12	18	0	1	19	0	0
9	46825094	.	A	T	5	6	11	0	1	12	0	0
9	47436078	.	C	T	6	12	18	0	0	18	0	0
9	47436338	.	G	C	5	4	9	0	0	9	0	0
9	47465670	.	G	C	6	6	12	0	0	12	0	0
9	47502512	.	C	A	1	2	3	0	1	4	0	0
9	47502645	.	T	C	2	0	2	0	6	8	0	0
9	48039626	.	A	G	2	2	4	0	0	4	0	0
9	48054753	.	G	A	34	19	53	0	1	54	0	0
9	48060592	.	G	C	27	16	43	0	1	44	0	0
9	48060631	.	G	A	20	16	36	0	1	37	0	0
9	48076978	.	T	C	29	18	47	0	0	47	0	0
9	48123595	.	C	T	2	4	6	0	0	6	0	0
9	48127200	.	G	A	5	3	8	0	1	9	0	0
9	48127889	.	G	T	5	2	7	0	0	7	0	0
9	48129019	.	G	C	4	9	13	0	0	13	0	0
9	48129157	.	T	C	2	10	12	0	0	12	0	0
9	48131637	.	T	A	1	3	4	0	1	5	0	0
9	48131814	.	A	T	5	5	10	0	0	10	0	0
9	48131824	.	T	G	6	5	11	0	0	11	0	0
9	48131971	.	C	G	3	6	9	0	0	9	0	0
9	48132127	.	C	T	6	7	13	0	0	13	0	0
9	48132245	.	A	T	3	7	10	0	0	10	0	0
9	48132336	.	C	T	2	3	5	0	6	11	0	0
9	48132363	.	C	T	4	7	11	0	0	11	0	0
9	48132381	.	T	G	4	8	12	0	0	12	0	0
9	48132406	.	G	A	2	8	10	0	0	10	0	0
9	48132531	.	G	A	7	4	11	0	0	11	0	0
9	48132592	.	G	T	6	10	16	0	2	18	0	0
9	48132966	.	T	G	1	6	7	0	0	7	0	0
9	48133056	.	C	T	3	4	7	0	5	12	0	0
9	48133105	.	G	T	4	11	15	0	0	15	0	0
9	48133644	.	C	T	5	4	9	0	1	10	0	0
9	48133731	.	A	T	5	8	13	0	0	13	0	0
9	48133791	.	G	C	2	5	7	0	0	7	0	0
9	48133802	.	A	T	3	4	7	0	0	7	0	0
9	48133868	.	C	A	5	9	14	0	0	14	0	0
9	48134174	.	A	G	7	6	13	0	0	13	0	0
9	48134468	.	C	T	9	17	26	0	0	26	0	0
9	48134499	.	C	A	8	16	24	0	2	26	0	0
9	48134568	.	G	A	8	4	12	0	5	17	0	0
9	48178424	.	C	T	0	4	4	0	1	5	0	0
9	48178990	.	C	T	0	3	3	0	4	7	0	0
9	48184172	.	C	T	2	5	7	0	0	7	0	0
9	48189322	.	A	T	9	4	13	0	0	13	0	0
9	48189403	.	C	G	0	4	4	0	1	5	0	0
9	48208270	.	A	T	6	5	11	0	0	11	0	0
9	48214092	.	C	G	2	2	4	0	0	4	0	0
9	48214112	.	G	A	4	4	8	0	0	8	0	0
9	48225779	.	T	C	3	3	6	0	0	6	0	0
9	48225782	.	C	T	3	3	6	0	0	6	0	0
9	48230669	.	C	T	4	3	7	0	0	7	0	0
9	48230714	.	C	A	5	2	7	0	0	7	0	0
9	48230723	.	C	T	3	2	5	0	0	5	0	0
9	48232673	.	C	T	2	2	4	0	0	4	0	0
9	48239975	.	C	T	5	3	8	0	0	8	0	0
9	48241967	.	G	A	2	3	5	0	0	5	0	0
9	48241985	.	T	A	2	3	5	0	0	5	0	0
9	48243390	.	C	T	2	3	5	0	1	6	0	0
9	48247002	.	T	A	1	3	4	0	0	4	0	0
9	48247050	.	G	A	2	2	4	0	0	4	0	0
9	48252167	.	C	T	4	2	6	0	0	6	0	0
9	48261089	.	T	C	1	2	3	0	0	3	0	0
9	48266149	.	A	C	3	3	6	0	1	7	0	0
9	48266227	.	A	G	4	0	4	0	3	7	0	0
9	48284901	.	T	C	9	3	12	0	1	13	0	0
9	48284917	.	C	A	2	4	6	0	8	14	0	0
9	48284972	.	T	C	8	7	15	0	0	15	0	0
9	48285019	.	G	A	6	7	13	0	0	13	0	0
9	48286702	.	G	A	5	9	14	0	0	14	0	0
9	48292277	.	C	A	2	7	9	0	9	18	0	0
9	48293492	.	T	C	3	3	6	0	0	6	0	0
9	48295210	.	G	A	10	5	15	0	2	17	0	0
9	48295211	.	T	G	12	5	17	0	0	17	0	0
9	48387299	.	T	C	5	6	11	0	0	11	0	0
9	48389871	.	C	T	1	7	8	0	5	13	0	0
9	48390855	.	G	A	4	6	10	0	0	10	0	0
9	48392077	.	G	A	11	5	16	0	1	17	0	0
9	48397409	.	G	A	4	7	11	0	0	11	0	0
9	48397526	.	G	A	3	10	13	0	0	13	0	0
9	48407314	.	A	C	2	0	2	0	5	7	0	0
9	48541204	.	C	T	1	2	3	0	0	3	0	0
9	48598916	.	A	G	1	2	3	0	0	3	0	0
9	48606157	.	T	C	3	2	5	0	0	5	0	0
9	48606235	.	C	T	1	3	4	0	0	4	0	0
9	48609172	.	A	G	1	2	3	0	0	3	0	0
9	48650859	.	C	T	1	2	3	0	0	3	0	0
9	48653675	.	A	G	1	3	4	0	0	4	0	0
9	48653759	.	T	C	2	2	4	0	0	4	0	0
9	48665419	.	A	T	1	3	4	0	0	4	0	0
9	48666890	.	A	G	5	2	7	0	0	7	0	0
9	48668834	.	C	G	5	6	11	0	1	12	0	0
9	48669326	.	G	T	3	2	5	0	0	5	0	0
9	48670316	.	C	T	2	2	4	0	1	5	0	0
9	48670395	.	A	C	4	3	7	0	0	7	0	0
9	48670454	.	T	G	6	4	10	0	0	10	0	0
9	48670747	.	T	G	2	0	2	1	5	8	0	0
9	48670748	.	T	C	2	5	7	1	0	8	0	0
9	48671167	.	A	C	1	3	4	0	0	4	0	0
9	48671485	.	A	G	2	0	2	0	2	4	0	0
9	48706302	.	C	T	2	3	5	0	0	5	0	0
9	48706305	.	C	T	2	3	5	0	1	6	0	0
9	48721172	.	A	G	1	2	3	0	0	3	0	0
9	48815862	.	A	T	3	3	6	0	0	6	0	0
9	48870578	.	T	C	13	1	14	0	11	25	0	0
9	48870593	.	A	T	9	14	23	0	2	25	0	0
9	48870627	.	T	A	6	13	19	0	0	19	0	0
9	48870680	.	A	G	10	4	14	0	0	14	0	0
9	48871080	.	G	C	4	10	14	0	0	14	0	0
9	48871495	.	T	G	2	2	4	0	0	4	0	0
9	48871610	.	A	T	6	3	9	1	0	10	0	0
9	48872688	.	A	T	4	3	7	0	0	7	0	0
9	48872694	.	A	G	4	3	7	0	0	7	0	0
9	48872890	.	C	A	16	4	20	1	1	22	0	0
9	48872924	.	A	G	18	10	28	1	0	29	0	0
9	48872926	.	C	T	0	8	8	1	19	28	0	0
9	48873302	.	T	C	5	2	7	0	0	7	0	0
9	48873371	.	A	G	4	2	6	1	2	9	0	0
9	48873522	.	C	G	5	2	7	0	0	7	0	0
9	48874562	.	G	A	9	8	17	1	1	19	0	0
9	48874577	.	G	A	9	7	16	1	0	17	0	0
9	48874728	.	T	C	12	3	15	1	0	16	0	0
9	48875171	.	C	T	2	3	5	0	0	5	0	0
9	48875208	.	C	G	1	2	3	0	0	3	0	0
9	48875218	.	G	T	3	2	5	0	0	5	0	0
9	48875510	.	T	C	4	5	9	0	0	9	0	0
9	48875516	.	G	A	5	4	9	0	0	9	0	0
9	48875674	.	A	G	1	5	6	0	1	7	0	0
9	48876158	.	C	A	2	6	8	0	0	8	0	0
9	48876188	.	T	C	1	3	4	0	1	5	0	0
9	48876199	.	T	C	1	2	3	0	1	4	0	0
9	48876544	.	C	T	5	6	11	0	0	11	0	0
9	48876587	.	A	G	9	5	14	1	0	15	0	0
9	48877005	.	A	C	1	2	3	0	0	3	0	0
9	48877348	.	A	G	2	5	7	0	0	7	0	0
9	48881118	.	G	A	2	4	6	0	0	6	0	0
9	50189103	.	G	A	0	2	2	0	1	3	0	0
9	50194781	.	C	T	2	2	4	0	0	4	0	0
9	50194812	.	G	A	0	2	2	0	2	4	0	0
9	50194987	.	T	C	1	2	3	0	0	3	0	0
9	50195615	.	G	A	2	3	5	0	0	5	0	0
9	50195968	.	C	T	2	5	7	0	0	7	0	0
9	50749627	.	C	T	3	2	5	0	1	6	0	0
9	50749639	.	C	T	3	2	5	0	0	5	0	0
9	50750269	.	G	A	0	2	2	0	1	3	0	0
9	50751505	.	T	C	3	3	6	0	0	6	0	0
9	50752418	.	G	A	1	2	3	0	0	3	0	0
9	50754222	.	G	C	2	2	4	0	0	4	0	0
9	50754234	.	G	A	2	2	4	0	0	4	0	0
9	50754316	.	C	G	2	2	4	0	0	4	0	0
9	50754860	.	C	T	4	3	7	0	0	7	0	0
9	51292956	.	A	G	22	20	42	0	0	42	0	0
9	51302422	.	A	G	23	27	50	0	5	55	0	0
9	51307238	.	T	C	20	21	41	0	1	42	0	0
9	51307387	.	G	T	20	13	33	0	1	34	0	0
9	51317030	.	T	C	22	1	23	0	18	41	0	0
9	51340645	.	A	G	14	11	25	1	0	26	0	0
9	51345386	.	C	A	13	15	28	0	2	30	0	0
9	51804640	.	A	C	11	8	19	0	0	19	0	0
9	51996246	.	C	T	1	2	3	0	6	9	0	0
9	51996280	.	T	A	8	5	13	0	0	13	0	0
9	51996281	.	G	A	7	5	12	0	1	13	0	0
9	51996444	.	T	G	10	9	19	0	1	20	0	0
9	51996868	.	T	A	3	5	8	0	0	8	0	0
9	51996974	.	C	T	2	9	11	0	0	11	0	0
9	51998330	.	T	C	5	2	7	1	1	9	0	0
9	51998495	.	A	C	3	0	3	0	4	7	0	0
9	51998547	.	C	T	5	2	7	0	0	7	0	0
9	51998648	.	C	T	6	7	13	0	1	14	0	0
9	51998784	.	T	G	8	3	11	0	0	12	1	0
9	51998841	.	G	T	11	4	15	0	0	15	0	0
9	51998866	.	A	T	14	5	19	0	0	19	0	0
9	51999815	.	T	C	7	6	13	0	0	13	0	0
9	51999842	.	C	G	5	10	15	0	0	15	0	0
9	51999855	.	T	G	6	12	18	0	0	18	0	0
9	51999885	.	C	T	9	12	21	0	1	22	0	0
9	51999924	.	T	A	5	6	11	0	2	13	0	0
9	52000032	.	C	T	0	8	8	0	7	15	0	0
9	52000127	.	C	G	12	4	16	0	0	16	0	0
9	52000139	.	G	A	10	4	14	0	0	14	0	0
9	52000164	.	G	A	8	3	11	0	0	11	0	0
9	52000293	.	T	C	10	0	10	0	7	17	0	0
9	52000335	.	A	T	12	9	21	0	2	23	0	0
9	52000623	.	C	T	2	5	7	0	3	10	0	0
9	52000827	.	T	A	5	4	9	0	1	10	0	0
9	52000869	.	G	C	5	0	5	0	3	8	0	0
9	52021296	.	T	C	2	4	6	0	0	6	0	0
9	52037940	.	G	T	7	6	13	0	0	13	0	0
9	52045280	.	A	G	4	2	6	0	1	7	0	0
9	52057315	.	A	G	4	3	7	0	1	8	0	0
9	52057708	.	C	T	6	8	14	0	0	14	0	0
9	52062698	.	T	C	4	5	9	0	0	9	0	0
9	52062710	.	T	G	4	2	6	0	0	6	0	0
9	52100750	.	T	C	5	8	13	0	1	14	0	0
9	52157214	.	C	G	3	2	5	0	0	5	0	0
9	52157216	.	T	C	2	0	2	0	2	4	0	0
9	52378682	.	C	T	16	9	25	0	1	26	0	0
9	52378697	.	A	G	17	14	31	0	1	32	0	0
9	52378832	.	T	A	24	18	42	1	5	48	0	0
9	52428661	.	A	G	3	0	3	0	3	6	0	0
9	52433132	.	T	C	1	5	6	0	1	7	0	0
9	52433174	.	A	C	1	2	3	0	0	3	0	0
9	52435100	.	G	A	1	4	5	0	0	5	0	0
9	52435112	.	C	T	2	4	6	0	0	6	0	0
9	52479739	.	T	C	1	3	4	0	0	4	0	0
9	52479815	.	C	T	1	5	6	0	0	6	0	0
9	52479822	.	C	G	0	5	5	0	1	6	0	0
9	52479901	.	C	T	7	7	14	0	0	14	0	0
9	52487535	.	T	C	3	0	3	1	5	9	0	0
9	52489838	.	C	A	2	5	7	0	0	7	0	0
9	52489899	.	T	C	3	0	3	0	2	5	0	0
9	52490250	.	C	T	0	2	2	0	1	3	0	0
9	52490254	.	G	T	1	2	3	0	0	3	0	0
9	52490526	.	C	T	2	2	4	0	0	4	0	0
9	52490533	.	G	A	2	1	3	0	0	3	0	0
9	52492705	.	A	G	9	17	26	0	0	26	0	0
9	52492853	.	C	G	5	1	6	0	3	9	0	0
9	52493059	.	A	T	15	6	21	0	0	21	0	0
9	52493231	.	A	T	6	12	18	0	2	20	0	0
9	52539290	.	G	A	2	9	11	0	17	28	0	0
9	52539453	.	C	T	13	18	31	0	1	32	0	0
9	52539629	.	C	T	13	5	18	0	0	18	0	0
9	52564578	.	T	C	5	0	5	0	3	8	0	0
9	52564622	.	T	C	4	4	8	0	0	8	0	0
9	52572555	.	C	T	7	5	12	0	0	12	0	0
9	52572573	.	G	A	7	4	11	0	2	13	0	0
9	52572609	.	C	G	7	4	11	0	1	12	0	0
9	52574737	.	C	G	7	6	13	0	1	14	0	0
9	52577701	.	A	G	3	3	6	0	1	7	0	0
9	52577760	.	C	T	4	4	8	0	0	8	0	0
9	52581925	.	C	T	2	2	4	1	0	5	0	0
9	52583872	.	G	A	3	4	7	1	0	8	0	0
9	52594558	.	G	C	2	4	6	0	2	8	0	0
9	52594594	.	C	T	3	4	7	0	0	7	0	0
9	52594600	.	G	A	2	4	6	0	0	6	0	0
9	52595710	.	C	T	4	2	6	0	1	7	0	0
9	52608615	.	G	T	1	2	3	0	0	3	0	0
9	52609133	.	A	T	5	2	7	0	0	7	0	0
9	52609157	.	C	T	3	6	9	0	0	9	0	0
9	52629113	.	C	T	10	18	28	0	2	30	0	0
9	52629119	.	C	T	22	8	30	0	0	30	0	0
9	52629155	.	T	C	5	24	29	0	0	29	0	0
9	52631620	.	G	A	20	5	25	0	1	26	0	0
9	52633151	.	C	T	10	5	15	0	0	15	0	0
9	52633184	.	C	G	10	6	16	0	0	16	0	0
9	52635271	.	C	A	13	4	17	0	0	17	0	0
9	52642012	.	G	A	10	8	18	0	0	18	0	0
9	52645687	.	C	T	0	5	5	0	11	16	0	0
9	52649704	.	C	T	1	7	8	0	2	10	0	0
9	52649794	.	A	G	6	2	8	0	1	9	0	0
9	52649941	.	G	A	9	7	16	0	0	16	0	0
9	52651985	.	T	C	9	9	18	0	0	18	0	0
9	52652015	.	A	G	7	5	12	0	0	12	0	0
9	52729148	.	G	A	1	5	6	0	0	6	0	0
9	53276550	.	A	C	6	6	12	0	0	12	0	0
9	53276681	.	G	A	0	3	3	0	8	11	0	0
9	53276976	.	C	T	7	6	13	0	0	13	0	0
9	53276978	.	A	G	6	7	13	0	0	13	0	0
9	53277068	.	C	G	9	0	9	0	6	15	0	0
9	53277131	.	A	T	9	11	20	0	0	20	0	0
9	53277453	.	G	A	1	8	9	0	6	15	0	0
9	53277493	.	A	T	3	7	10	0	0	10	0	0
9	53535896	.	G	A	4	3	7	0	0	7	0	0
9	53707485	.	G	C	5	3	8	0	0	8	0	0
9	53707638	.	G	C	2	5	7	0	2	9	0	0
9	53707653	.	A	T	4	4	8	0	0	8	0	0
9	53707761	.	A	G	4	6	10	0	0	10	0	0
9	53707798	.	C	T	7	2	9	0	0	9	0	0
9	53707995	.	C	T	8	7	15	0	0	15	0	0
9	53708037	.	G	A	8	7	15	0	0	15	0	0
9	53708055	.	T	C	8	6	14	0	1	15	0	0
9	53708316	.	G	A	0	8	8	0	5	13	0	0
9	53709003	.	C	T	12	5	17	0	1	18	0	0
9	53709184	.	T	C	10	6	16	0	2	18	0	0
9	53709365	.	C	T	5	13	18	0	0	18	0	0
9	53715525	.	G	A	7	6	13	0	4	17	0	0
9	53719342	.	T	C	9	16	25	0	0	25	0	0
9	53843404	.	C	T	16	8	24	0	0	24	0	0
9	53843590	.	A	T	10	7	17	0	0	17	0	0
9	53843737	.	T	C	6	0	6	0	5	11	0	0
9	53843813	.	G	A	8	4	12	0	0	12	0	0
9	53843909	.	C	T	0	4	4	0	10	14	0	0
9	53844188	.	T	C	6	0	6	0	10	16	0	0
9	53845537	.	A	G	10	9	19	0	2	21	0	0
9	53849389	.	T	C	9	0	9	0	5	14	0	0
9	53849440	.	G	A	10	4	14	0	1	15	0	0
9	53851676	.	C	T	8	4	12	0	1	13	0	0
9	53853662	.	G	C	9	0	9	0	4	13	0	0
9	53864227	.	A	C	9	3	12	0	0	12	0	0
9	53867508	.	A	G	7	10	17	0	0	17	0	0
9	53867511	.	A	G	7	10	17	0	0	17	0	0
9	53869247	.	G	A	11	4	15	0	2	17	0	0
9	53869344	.	T	C	14	9	23	0	0	23	0	0
9	53882893	.	C	A	0	7	7	0	5	12	0	0
9	53890327	.	C	A	2	5	7	0	0	7	0	0
9	53890345	.	G	T	3	3	6	0	0	6	0	0
9	53896187	.	C	T	3	4	7	0	6	13	0	0
9	53909815	.	C	A	0	3	3	0	6	9	0	0
9	53914095	.	C	G	2	3	5	0	2	7	0	0
9	53914116	.	G	A	4	2	6	0	2	8	0	0
9	54001213	.	G	A	1	3	4	0	0	4	0	0
9	54105713	.	T	C	14	8	22	0	0	22	0	0
9	54112469	.	T	C	7	10	17	0	1	18	0	0
9	54112526	.	T	A	2	14	16	0	0	16	0	0
9	54112571	.	A	G	4	9	13	0	1	14	0	0
9	54113324	.	C	T	3	5	8	0	0	8	0	0
9	54113954	.	C	T	3	9	12	0	1	13	0	0
9	54114050	.	A	G	6	0	6	0	8	14	0	0
9	54114242	.	T	G	5	0	5	0	10	15	0	0
9	54230898	.	G	A	3	2	5	0	0	5	0	0
9	54239528	.	T	C	5	5	10	0	1	11	0	0
9	54245010	.	T	A	7	6	13	0	0	13	0	0
9	54247334	.	A	G	7	7	14	0	0	14	0	0
9	54247336	.	T	C	7	7	14	0	0	14	0	0
9	54255362	.	C	G	6	5	11	0	0	11	0	0
9	54256221	.	C	G	8	6	14	0	1	15	0	0
9	54256286	.	C	A	9	5	14	0	0	14	0	0
9	54263996	.	C	T	5	6	11	0	2	13	0	0
9	54264236	.	T	C	7	7	14	0	1	15	0	0
9	54264245	.	T	C	7	8	15	0	0	15	0	0
9	54264272	.	C	T	10	8	18	0	1	19	0	0
9	54264299	.	C	A	11	8	19	0	1	20	0	0
9	54270324	.	C	T	4	6	10	0	1	11	0	0
9	54270348	.	T	A	4	6	10	0	0	10	0	0
9	54273514	.	G	T	9	3	12	0	1	13	0	0
9	54273797	.	C	T	3	8	11	0	0	11	0	0
9	54329537	.	T	C	4	10	14	0	1	15	0	0
9	54329593	.	C	A	0	7	7	0	5	12	0	0
9	54329644	.	T	C	2	5	7	0	0	7	0	0
9	54331562	.	G	A	1	4	5	0	0	5	0	0
9	54331768	.	G	A	7	2	9	0	0	9	0	0
9	54335139	.	A	G	3	7	10	0	0	10	0	0
9	54335197	.	C	T	3	4	7	0	0	7	0	0
9	54336738	.	A	G	2	5	7	0	0	7	0	0
9	54340140	.	C	T	2	5	7	0	0	7	0	0
9	54340248	.	G	A	2	6	8	0	0	8	0	0
9	54340317	.	T	A	1	3	4	0	0	4	0	0
9	54345372	.	G	A	3	2	5	0	0	5	0	0
9	54349735	.	G	C	4	3	7	0	0	7	0	0
9	54417949	.	A	T	6	4	10	0	0	10	0	0
9	54418577	.	G	T	0	8	8	0	5	13	0	0
9	54418687	.	T	C	4	5	9	0	0	9	0	0
9	54654494	.	G	A	0	2	2	0	1	3	0	0
9	54671451	.	C	T	2	2	4	0	0	4	0	0
9	54671597	.	A	G	1	2	3	0	0	3	0	0
9	54696118	.	G	A	8	8	16	0	0	16	0	0
9	54696137	.	T	C	6	7	13	0	0	13	0	0
9	54711020	.	G	T	9	11	20	0	0	20	0	0
9	54711496	.	C	A	7	3	10	1	0	11	0	0
9	54712704	.	A	G	15	7	22	0	1	23	0	0
9	54712745	.	T	C	15	17	32	0	4	36	0	0
9	54712751	.	C	T	17	18	35	0	1	36	0	0
9	54712917	.	A	T	11	9	20	0	2	22	0	0
9	54712945	.	G	A	9	6	15	0	1	16	0	0
9	54712985	.	A	C	11	12	23	0	0	23	0	0
9	54715157	.	T	C	8	7	15	0	1	16	0	0
9	54716349	.	G	A	6	14	20	0	1	21	0	0
9	54716542	.	A	G	2	3	5	0	0	5	0	0
9	54719218	.	T	G	2	2	4	0	0	4	0	0
9	54725256	.	G	A	2	4	6	0	0	6	0	0
9	54725631	.	C	T	5	6	11	0	1	12	0	0
9	54728780	.	A	G	1	7	8	0	0	8	0	0
9	54728822	.	C	G	3	2	5	0	0	5	0	0
9	54728827	.	C	T	2	1	3	0	1	4	0	0
9	54730650	.	G	C	5	8	13	0	0	13	0	0
9	54734620	.	G	C	5	3	8	0	0	8	0	0
9	54736456	.	A	G	8	3	11	0	0	11	0	0
9	54738987	.	C	T	3	7	10	0	0	10	0	0
9	54739015	.	A	T	6	6	12	0	0	12	0	0
9	54739105	.	A	G	4	0	4	0	2	6	0	0
9	54739181	.	C	G	2	2	4	0	0	4	0	0
9	54739182	.	C	A	2	2	4	0	0	4	0	0
9	54751753	.	T	C	2	5	7	0	0	7	0	0
9	54763880	.	C	A	12	9	21	0	0	21	0	0
9	54763977	.	T	A	9	6	15	0	4	19	0	0
9	54764102	.	C	T	8	9	17	0	1	18	0	0
9	54764143	.	G	A	14	6	20	0	1	21	0	0
9	54764349	.	G	A	14	7	21	0	0	21	0	0
9	54769705	.	T	C	12	0	12	0	18	30	0	0
9	54770768	.	G	A	8	9	17	0	2	19	0	0
9	54770792	.	A	G	6	9	15	0	1	16	0	0
9	54775967	.	A	G	7	8	15	0	0	15	0	0
9	54775995	.	G	A	6	8	14	0	0	14	0	0
9	54776055	.	T	C	5	0	5	0	6	11	0	0
9	54776075	.	G	A	11	7	18	0	0	18	0	0
9	55382313	.	A	G	4	4	8	0	2	10	0	0
9	55382350	.	T	C	4	2	6	0	1	7	0	0
9	55382368	.	A	G	4	4	8	0	1	9	0	0
9	55382620	.	G	C	0	3	3	0	6	9	0	0
9	55382662	.	A	G	2	1	3	0	2	5	0	0
9	55392811	.	A	G	4	0	4	0	7	11	0	0
9	55392913	.	C	T	3	2	5	0	0	5	0	0
9	55413245	.	A	G	4	0	4	0	6	10	0	0
9	55413395	.	C	A	5	9	14	0	0	14	0	0
9	55413485	.	C	A	5	9	14	0	0	14	0	0
9	55413677	.	C	T	6	9	15	0	0	15	0	0
9	55417665	.	A	G	3	0	3	0	9	12	0	0
9	55418025	.	G	A	0	7	7	0	12	19	0	0
9	55418067	.	C	T	3	12	15	0	0	15	0	0
9	55418095	.	A	G	5	11	16	0	1	17	0	0
9	55583020	.	T	C	2	0	2	0	2	4	0	0
9	55585545	.	G	A	1	3	4	0	0	4	0	0
9	55585548	.	G	A	1	3	4	0	0	4	0	0
9	55730341	.	G	A	2	6	8	0	0	8	0	0
9	55736311	.	G	A	1	3	4	0	0	4	0	0
9	55748586	.	T	C	4	2	6	1	0	7	0	0
9	55748631	.	T	C	2	0	2	0	8	10	0	0
9	55748855	.	C	A	2	3	5	0	1	6	0	0
9	55749040	.	A	G	6	4	10	0	0	10	0	0
9	55749108	.	T	C	2	2	4	0	0	4	0	0
9	55749194	.	C	T	1	4	5	0	3	8	0	0
9	55749940	.	A	C	1	2	3	0	0	3	0	0
9	55750255	.	C	G	1	7	8	0	10	18	0	0
9	55750306	.	C	T	8	5	13	0	1	14	0	0
9	55750357	.	A	C	3	0	3	0	6	9	0	0
9	55750367	.	G	A	3	5	8	0	0	8	0	0
9	55750405	.	T	A	1	3	4	0	0	4	0	0
9	55750407	.	A	T	1	3	4	0	0	4	0	0
9	55750470	.	G	A	1	3	4	0	0	4	0	0
9	55750490	.	C	T	2	3	5	0	0	5	0	0
9	55750517	.	A	G	3	3	6	0	0	6	0	0
9	55750543	.	C	T	3	1	4	0	1	5	0	0
9	55750649	.	G	C	6	7	13	0	0	13	0	0
9	55750756	.	C	T	12	6	18	1	2	21	0	0
9	55750792	.	C	T	1	7	8	0	10	18	0	0
9	55751091	.	G	A	4	6	10	0	2	12	0	0
9	55756519	.	A	T	9	8	17	0	1	18	0	0
9	55756582	.	T	A	4	12	16	0	1	17	0	0
9	55771721	.	G	C	4	6	10	0	1	11	0	0
9	55771841	.	C	T	3	5	8	0	0	8	0	0
9	55784001	.	C	T	1	5	6	0	5	11	0	0
9	55784148	.	C	T	5	5	10	0	0	10	0	0
9	55784256	.	G	T	3	4	7	0	1	8	0	0
9	55857228	.	A	C	4	4	8	0	0	8	0	0
9	55857271	.	C	A	2	4	6	0	0	6	0	0
9	55860096	.	G	A	0	3	3	0	4	7	0	0
9	55860127	.	C	T	4	4	8	0	0	8	0	0
9	55860460	.	C	T	4	2	6	0	1	7	0	0
9	55870475	.	G	A	1	7	8	2	5	15	0	0
9	55870562	.	C	A	8	7	15	0	0	15	0	0
9	55874397	.	A	C	7	7	14	0	0	14	0	0
9	55874434	.	T	A	0	5	5	2	0	7	0	0
9	55874548	.	A	T	4	7	11	0	1	12	0	0
9	55896168	.	T	C	2	0	2	0	3	5	0	0
9	55896258	.	A	G	3	3	6	0	0	6	0	0
9	55896288	.	C	G	4	4	8	0	0	8	0	0
9	55929910	.	T	C	2	0	2	0	4	6	0	0
9	56141050	.	G	A	0	2	2	0	1	3	0	0
9	56203553	.	G	A	0	2	2	0	3	5	0	0
9	56205051	.	G	A	0	2	2	0	3	5	0	0
9	56225740	.	T	A	8	15	23	0	0	23	0	0
9	56225849	.	A	G	9	9	18	0	0	18	0	0
9	56230655	.	A	G	34	34	68	0	2	70	0	0
9	56230676	.	G	T	32	38	70	0	3	73	0	0
9	56231322	.	T	C	33	37	70	0	5	75	0	0
9	56231325	.	A	G	37	37	74	0	2	76	0	0
9	56232551	.	T	G	1	2	3	0	0	3	0	0
9	56232588	.	C	G	8	5	13	0	0	13	0	0
9	56235538	.	C	T	6	9	15	0	2	17	0	0
9	56237883	.	T	C	6	11	17	0	0	17	0	0
9	56244635	.	G	T	3	5	8	3	1	12	0	0
9	56251467	.	C	T	0	2	2	0	4	6	0	0
9	56255687	.	G	A	4	3	7	0	0	7	0	0
9	56350968	.	C	T	2	8	10	0	5	15	0	0
9	56351059	.	C	T	16	7	23	0	2	25	0	0
9	56353479	.	G	A	10	15	25	0	0	25	0	0
9	56363292	.	T	A	5	12	17	0	2	19	0	0
9	56369168	.	G	T	10	12	22	0	2	24	0	0
9	56369252	.	G	A	11	17	28	0	2	31	1	0
9	56369319	.	C	A	14	6	20	0	3	23	0	0
9	56389303	.	A	G	14	8	22	0	0	22	0	0
9	56449563	.	C	T	1	3	4	0	0	4	0	0
9	56451647	.	A	G	2	2	4	0	0	4	0	0
9	56456064	.	C	T	1	8	9	1	0	10	0	0
9	56456065	.	G	C	0	8	8	1	1	10	0	0
9	56457107	.	C	T	2	2	4	0	0	4	0	0
9	56457309	.	A	T	9	5	14	0	2	16	0	0
