contig	position	variantID	refAllele	altAllele	refCount	altCount	totalCount	lowMAPQDepth	lowBaseQDepth	rawDepth	otherBases	improperPairs
1	6698	.	G	A	11	14	25	0	2	27	0	0
1	6746	.	T	C	27	3	30	0	33	63	0	0
1	10093	.	C	T	36	36	72	0	1	73	0	0
1	14083	.	G	A	0	5	5	0	4	9	0	0
1	15050	.	G	A	1	4	5	0	10	15	0	0
1	15772	.	G	A	0	5	5	0	9	14	0	0
1	15828	.	G	A	1	5	6	0	6	12	0	0
1	16072	.	C	T	4	3	7	0	1	8	0	0
1	32450	.	T	C	8	13	21	0	0	21	0	0
1	33036	.	C	T	17	6	23	0	0	23	0	0
1	38106	.	C	T	9	11	20	0	3	23	0	0
1	38814	.	G	A	3	17	20	0	15	35	0	0
1	39620	.	C	A	0	6	6	0	3	9	0	0
1	39621	.	G	C	2	6	8	0	1	9	0	0
1	39717	.	T	G	4	8	12	0	2	14	0	0
1	40409	.	T	C	8	5	13	0	0	13	0	0
1	41287	.	C	T	0	5	5	0	6	11	0	0
1	41560	.	G	A	5	8	13	0	0	13	0	0
1	42590	.	G	A	5	2	7	0	1	8	0	0
1	42662	.	G	A	2	4	6	0	0	6	0	0
1	62771	.	G	A	9	10	19	0	0	19	0	0
1	62838	.	C	T	6	9	15	0	2	17	0	0
1	141333	.	C	T	1	4	5	0	0	5	0	0
1	153527	.	A	G	7	4	11	0	1	12	0	0
1	154104	.	G	C	4	6	10	0	0	10	0	0
1	154113	.	G	A	4	7	11	0	0	11	0	0
1	154140	.	C	A	0	8	8	0	4	12	0	0
1	160229	.	G	A	4	5	9	0	0	9	0	0
1	176642	.	C	T	15	16	31	0	3	34	0	0
1	176774	.	C	T	11	12	23	6	1	30	0	0
1	181717	.	T	C	21	14	35	0	2	37	0	0
1	181754	.	C	T	19	21	40	0	1	41	0	0
1	181763	.	A	G	19	20	39	0	2	41	0	0
1	185057	.	G	A	1	2	3	0	0	3	0	0
1	185126	.	G	A	7	3	10	0	1	11	0	0
1	185191	.	C	T	2	5	7	0	0	7	0	0
1	186389	.	C	T	8	5	13	0	1	14	0	0
1	186864	.	G	A	4	4	8	0	0	8	0	0
1	191914	.	C	G	8	5	13	0	0	13	0	0
1	208262	.	G	A	5	2	7	0	0	7	0	0
1	208265	.	G	A	6	2	8	0	0	8	0	0
1	208471	.	T	C	12	13	25	0	2	27	0	0
1	208564	.	T	C	10	6	16	0	1	17	0	0
1	208570	.	T	C	4	11	15	0	2	17	0	0
1	209063	.	T	C	6	13	19	0	0	19	0	0
1	212162	.	G	A	3	11	14	0	0	14	0	0
1	213203	.	G	C	21	0	21	0	18	39	0	0
1	218551	.	C	T	3	4	7	0	0	7	0	0
1	218775	.	G	A	5	4	9	0	1	10	0	0
1	219437	.	C	T	3	2	5	0	0	5	0	0
1	221781	.	C	G	5	6	11	0	0	11	0	0
1	222797	.	C	T	3	6	9	0	1	10	0	0
1	222800	.	C	T	7	2	9	0	0	9	0	0
1	225044	.	G	A	0	6	6	0	8	14	0	0
1	225083	.	C	T	4	5	9	0	1	10	0	0
1	442456	.	T	C	4	4	8	1	1	10	0	0
1	474321	.	A	G	8	3	11	0	0	11	0	0
1	474465	.	C	T	11	2	13	0	2	15	0	0
1	474473	.	A	G	11	3	14	0	1	15	0	0
1	477001	.	C	T	0	3	3	0	8	11	0	0
1	477013	.	G	T	9	2	11	0	0	11	0	0
1	477046	.	G	A	7	2	9	0	0	9	0	0
1	477070	.	C	T	0	5	5	0	5	10	0	0
1	477109	.	C	T	0	4	4	0	5	9	0	0
1	477817	.	C	T	4	4	8	0	0	8	0	0
1	477823	.	G	C	4	4	8	0	1	9	0	0
1	477951	.	C	T	3	6	9	0	0	9	0	0
1	479906	.	G	A	1	7	8	0	0	8	0	0
1	479909	.	C	T	0	7	7	0	1	8	0	0
1	479986	.	A	G	3	4	7	0	1	8	0	0
1	483862	.	A	T	1	4	5	0	1	6	0	0
1	483873	.	C	T	1	4	5	0	1	6	0	0
1	484094	.	G	A	4	4	8	0	0	8	0	0
1	486475	.	G	C	2	6	8	0	0	8	0	0
1	486775	.	T	C	2	5	7	0	0	7	0	0
1	488390	.	G	A	3	2	5	0	0	5	0	0
1	492141	.	T	C	1	5	6	0	0	6	0	0
1	492231	.	C	A	1	5	6	0	0	6	0	0
1	494246	.	A	T	5	3	8	0	1	9	0	0
1	494369	.	C	T	8	4	12	0	1	13	0	0
1	496303	.	A	G	8	6	14	0	0	14	0	0
1	496305	.	A	C	9	6	15	0	0	15	0	0
1	496760	.	A	G	2	0	2	0	9	11	0	0
1	497054	.	G	A	4	5	9	0	0	9	0	0
1	499220	.	A	G	5	10	15	0	0	15	0	0
1	501303	.	G	A	0	6	6	0	3	9	0	0
1	501381	.	T	A	6	6	12	0	0	12	0	0
1	502079	.	C	A	9	10	19	0	0	19	0	0
1	503900	.	C	T	9	11	20	0	0	20	0	0
1	504073	.	A	G	9	1	10	0	6	16	0	0
1	504663	.	C	G	12	5	17	0	0	17	0	0
1	504696	.	A	G	10	0	10	0	9	19	0	0
1	504947	.	G	T	5	7	12	0	0	12	0	0
1	504948	.	A	T	8	5	13	0	0	13	0	0
1	505178	.	G	A	8	7	15	0	0	15	0	0
1	505260	.	A	G	8	1	9	0	8	17	0	0
1	505298	.	C	T	14	8	22	0	0	22	0	0
1	505499	.	C	G	1	4	5	0	0	5	0	0
1	509387	.	A	G	3	6	9	0	0	9	0	0
1	509718	.	T	A	4	2	6	0	1	7	0	0
1	509769	.	G	T	4	4	8	0	1	9	0	0
1	511957	.	G	A	5	5	10	0	0	10	0	0
1	511968	.	A	T	5	6	11	0	0	11	0	0
1	512127	.	C	T	3	2	5	0	0	5	0	0
1	514114	.	G	A	0	3	3	0	6	9	0	0
1	514202	.	C	T	10	7	17	0	0	17	0	0
1	515549	.	G	A	6	2	8	0	1	9	0	0
1	515575	.	G	C	4	5	9	0	1	10	0	0
1	517515	.	C	T	13	10	23	0	2	25	0	0
1	517697	.	T	C	1	2	3	0	0	3	0	0
1	517699	.	A	G	2	0	2	0	2	4	0	0
1	517733	.	C	T	1	3	4	0	0	4	0	0
1	524806	.	G	A	11	7	18	0	2	20	0	0
1	524828	.	C	T	11	5	16	0	1	17	0	0
1	528522	.	G	A	1	15	16	0	11	27	0	0
1	528552	.	A	C	18	7	25	0	1	26	0	0
1	530497	.	T	A	10	7	17	0	0	17	0	0
1	546198	.	C	T	1	2	3	0	0	3	0	0
1	552692	.	A	G	1	2	3	0	0	3	0	0
1	586161	.	G	A	2	6	8	0	10	18	0	0
1	586165	.	C	T	9	6	15	0	0	16	1	0
1	586765	.	C	T	7	7	14	0	0	14	0	0
1	587200	.	G	T	15	12	27	0	0	27	0	0
1	589044	.	A	T	18	9	27	0	1	28	0	0
1	589056	.	C	T	17	9	26	0	3	29	0	0
1	589115	.	G	A	3	13	16	0	13	29	0	0
1	594664	.	C	G	6	5	11	0	0	11	0	0
1	601873	.	C	T	5	6	11	0	0	11	0	0
1	601882	.	G	A	5	5	10	0	2	12	0	0
1	601954	.	C	T	7	4	11	0	1	12	0	0
1	603292	.	A	G	8	13	21	0	1	22	0	0
1	606128	.	A	C	7	8	15	0	3	18	0	0
1	610722	.	T	C	8	10	18	0	1	19	0	0
1	611267	.	T	C	37	21	58	0	1	59	0	0
1	614568	.	C	G	0	18	18	1	12	31	0	0
1	617950	.	C	T	4	24	28	0	29	57	0	0
1	618190	.	A	C	32	2	34	0	25	59	0	0
1	618210	.	G	A	30	24	54	0	4	58	0	0
1	618277	.	A	G	25	34	59	0	1	60	0	0
1	618434	.	C	T	32	34	66	0	1	67	0	0
1	618760	.	C	T	0	8	8	0	14	22	0	0
1	618776	.	C	A	12	15	27	0	1	28	0	0
1	618826	.	C	T	23	11	34	0	0	34	0	0
1	618918	.	A	T	15	42	57	0	1	58	0	0
1	618932	.	A	G	15	44	59	0	4	63	0	0
1	619450	.	G	A	18	19	37	0	5	42	0	0
1	619471	.	G	A	0	25	25	0	2	27	0	0
1	619679	.	T	A	18	12	30	0	1	31	0	0
1	619703	.	C	T	2	15	17	0	18	35	0	0
1	619764	.	C	T	32	11	43	1	1	45	0	0
1	620244	.	A	T	32	30	62	0	9	71	0	0
1	620314	.	G	A	36	21	57	0	3	60	0	0
1	620516	.	A	T	29	34	63	0	0	63	0	0
1	620517	.	T	G	30	34	64	0	1	65	0	0
1	621027	.	C	T	2	22	24	0	27	51	0	0
1	621063	.	T	A	17	32	49	0	0	49	0	0
1	621069	.	G	A	15	30	45	0	0	45	0	0
1	621102	.	A	T	24	18	42	0	1	43	0	0
1	621141	.	T	A	17	29	46	1	0	47	0	0
1	621283	.	C	T	4	21	25	0	28	53	0	0
1	621336	.	G	A	28	31	59	0	9	68	0	0
1	621389	.	C	T	37	29	66	0	3	69	0	0
1	621440	.	C	T	30	27	57	0	6	63	0	0
1	626601	.	G	A	30	29	59	0	1	60	0	0
1	629610	.	G	A	24	28	52	0	1	53	0	0
1	629619	.	A	G	27	25	52	0	2	54	0	0
1	634882	.	T	C	38	20	58	1	2	61	0	0
1	634933	.	T	C	44	9	53	1	2	63	7	0
1	638431	.	C	T	5	31	36	0	25	61	0	0
1	658722	.	C	A	0	2	2	0	1	3	0	0
1	660412	.	T	A	1	2	3	0	0	3	0	0
1	675186	.	C	T	1	2	3	0	0	3	0	0
1	692140	.	C	T	1	2	3	0	1	4	0	0
1	692162	.	G	T	2	2	4	0	0	4	0	0
1	692299	.	A	G	4	2	6	0	0	6	0	0
1	692338	.	A	G	2	2	4	0	0	4	0	0
1	714405	.	C	T	1	4	5	0	1	6	0	0
1	5357405	.	T	C	9	23	32	0	2	34	0	0
1	6166479	.	G	T	1	8	9	0	10	19	0	0
1	6210567	.	C	T	7	2	9	0	1	10	0	0
1	6225945	.	G	A	4	3	7	0	0	7	0	0
1	6226084	.	A	G	1	3	4	0	0	4	0	0
1	6226388	.	A	G	4	0	4	0	5	9	0	0
1	6231058	.	G	A	0	2	2	0	4	6	0	0
1	6234077	.	A	G	3	3	6	0	0	6	0	0
1	6236844	.	A	G	1	0	1	0	6	7	0	0
1	6238639	.	C	T	5	3	8	0	0	8	0	0
1	6241379	.	G	T	0	10	10	0	5	15	0	0
1	6241427	.	T	G	10	6	16	0	0	16	0	0
1	6243549	.	A	G	4	0	4	0	6	10	0	0
1	6243620	.	T	C	4	4	8	0	0	8	0	0
1	6243626	.	A	C	2	5	7	0	0	7	0	0
1	6244044	.	C	T	2	2	4	0	0	4	0	0
1	6244279	.	A	T	7	4	11	0	0	11	0	0
1	6244281	.	G	C	6	4	10	0	1	11	0	0
1	6247104	.	C	T	4	12	16	0	0	16	0	0
1	6247156	.	G	T	4	6	10	0	1	11	0	0
1	6248059	.	C	T	3	2	5	0	0	5	0	0
1	6252887	.	T	C	4	3	7	0	1	8	0	0
1	6261447	.	A	G	3	2	5	0	0	5	0	0
1	6262800	.	G	C	1	3	4	0	6	10	0	0
1	6262918	.	C	T	1	4	5	0	0	5	0	0
1	6264973	.	C	A	3	9	12	0	0	12	0	0
1	6266294	.	C	T	6	4	10	0	0	10	0	0
1	6327785	.	C	T	3	4	7	1	0	8	0	0
1	6359952	.	G	A	6	5	11	0	0	11	0	0
1	6365673	.	A	G	10	3	13	0	0	13	0	0
1	6365711	.	T	G	8	8	16	0	1	17	0	0
1	6365793	.	A	C	2	5	7	0	0	7	0	0
1	6366000	.	T	A	4	4	8	0	0	8	0	0
1	6366024	.	A	C	4	3	7	0	1	8	0	0
1	6404145	.	G	C	3	6	9	0	0	9	0	0
1	6404205	.	A	T	8	5	13	0	0	13	0	0
1	6404250	.	G	A	5	7	12	0	0	12	0	0
1	6404659	.	G	A	7	4	11	0	1	12	0	0
1	6405057	.	A	G	4	2	6	0	0	6	0	0
1	6429260	.	C	T	0	7	7	0	4	11	0	0
1	6429548	.	T	C	1	1	2	0	3	5	0	0
1	6494181	.	G	A	5	2	7	0	1	8	0	0
1	6494215	.	T	G	4	2	6	0	0	6	0	0
1	6884625	.	C	A	4	2	6	0	0	6	0	0
1	6887969	.	G	T	3	2	5	0	0	5	0	0
1	6924578	.	C	T	5	3	8	0	0	8	0	0
1	6924761	.	G	A	0	6	6	0	5	11	0	0
1	6924858	.	G	C	5	2	7	0	0	7	0	0
1	7447427	.	C	A	2	3	5	0	0	5	0	0
1	7447436	.	T	C	2	3	5	0	0	5	0	0
1	7447613	.	C	T	1	4	5	0	0	5	0	0
1	7518644	.	C	T	29	22	51	0	4	55	0	0
1	7523258	.	A	C	19	21	40	0	1	41	0	0
1	7523264	.	C	T	19	21	40	0	2	42	0	0
1	7526839	.	G	A	14	22	36	0	2	38	0	0
1	7528289	.	G	C	1	24	25	0	23	48	0	0
1	7530123	.	C	T	22	26	48	0	2	50	0	0
1	7538461	.	T	C	2	3	5	0	0	5	0	0
1	7538822	.	C	T	25	20	45	0	0	45	0	0
1	7538971	.	T	C	25	20	45	0	2	47	0	0
1	7539000	.	C	A	20	13	33	0	4	37	0	0
1	7539053	.	G	C	18	15	33	0	1	34	0	0
1	7539074	.	A	C	17	7	24	0	1	26	1	0
1	7557132	.	C	T	3	4	7	0	0	7	0	0
1	7560705	.	T	A	16	12	28	3	3	34	0	0
1	7632221	.	C	T	3	3	6	0	0	6	0	0
1	7634807	.	G	A	4	2	6	0	0	6	0	0
1	7662275	.	T	C	24	16	40	0	0	40	0	0
1	7662628	.	G	A	21	17	38	0	1	39	0	0
1	7662880	.	A	T	16	20	36	0	2	38	0	0
1	7662949	.	C	T	23	25	48	0	1	49	0	0
1	7668211	.	A	G	16	21	37	0	0	37	0	0
1	7668298	.	C	T	18	16	34	1	1	36	0	0
1	7673070	.	C	T	23	18	41	0	5	46	0	0
1	7673129	.	C	A	18	21	39	0	3	42	0	0
1	7682912	.	A	C	9	8	17	0	0	17	0	0
1	7682923	.	A	G	8	6	14	0	0	14	0	0
1	7682949	.	G	A	3	8	11	0	2	13	0	0
1	7853375	.	T	G	7	7	14	0	0	14	0	0
1	7853399	.	G	A	7	6	13	0	0	13	0	0
1	7853465	.	C	A	4	7	11	1	1	13	0	0
1	7859852	.	G	A	3	6	9	0	0	9	0	0
1	7859874	.	G	A	2	4	6	0	0	6	0	0
1	7864579	.	A	G	2	3	5	0	0	5	0	0
1	7864780	.	A	G	3	6	9	0	0	9	0	0
1	7872256	.	C	T	0	3	3	0	5	8	0	0
1	7875073	.	C	T	0	3	3	0	3	6	0	0
1	7889423	.	G	T	1	3	4	0	1	5	0	0
1	7889426	.	A	G	2	3	5	0	0	5	0	0
1	7894186	.	C	T	4	3	7	0	1	8	0	0
1	8022503	.	T	A	12	10	22	0	1	23	0	0
1	8022505	.	T	C	13	10	23	0	1	24	0	0
1	8022817	.	T	A	16	13	29	0	0	29	0	0
1	8023471	.	A	T	8	12	20	0	2	22	0	0
1	8023490	.	A	C	7	14	21	0	0	21	0	0
1	8023559	.	A	T	20	10	30	0	1	31	0	0
1	8023587	.	A	G	9	18	27	0	0	27	0	0
1	8023639	.	C	A	13	16	29	2	2	33	0	0
1	8023658	.	A	T	17	8	25	2	1	28	0	0
1	8023730	.	C	T	14	15	29	0	3	32	0	0
1	8026148	.	T	G	12	18	30	0	3	33	0	0
1	8026404	.	T	A	20	19	39	0	0	39	0	0
1	8026415	.	C	T	0	19	19	0	21	40	0	0
1	8026478	.	T	C	18	0	18	0	18	36	0	0
1	8026975	.	T	C	18	12	30	0	0	30	0	0
1	8028177	.	T	A	10	16	26	0	0	26	0	0
1	8028696	.	G	T	17	15	32	0	4	36	0	0
1	8028912	.	G	C	19	13	32	0	0	32	0	0
1	8028925	.	C	A	10	18	28	0	0	28	0	0
1	8028979	.	G	A	7	12	19	0	0	19	0	0
1	8029002	.	T	A	7	9	16	0	1	17	0	0
1	8032956	.	G	C	22	16	38	0	1	39	0	0
1	8032986	.	A	G	9	22	31	0	0	32	1	0
1	8049495	.	C	T	0	13	13	0	10	23	0	0
1	8051513	.	G	A	12	14	26	0	2	28	0	0
1	8051528	.	C	T	3	11	14	0	16	30	0	0
1	8055927	.	T	C	6	0	6	0	7	13	0	0
1	8128710	.	G	A	1	2	3	0	0	3	0	0
1	8134220	.	G	A	2	3	5	0	0	5	0	0
1	8134780	.	C	G	0	2	2	0	2	4	0	0
1	8162990	.	G	A	3	2	5	0	0	5	0	0
1	8165609	.	C	T	9	6	15	0	0	15	0	0
1	8165769	.	T	A	4	3	7	0	0	7	0	0
1	8165802	.	C	T	5	2	7	0	0	7	0	0
1	8165937	.	G	A	5	4	9	0	1	10	0	0
1	8165947	.	C	T	5	5	10	0	1	11	0	0
1	8166788	.	A	T	6	6	12	0	1	13	0	0
1	8166992	.	A	G	5	11	16	0	0	16	0	0
1	8167319	.	A	G	2	4	6	0	0	6	0	0
1	8167383	.	G	A	10	6	16	0	0	16	0	0
1	8167526	.	C	T	11	11	22	0	0	22	0	0
1	8167668	.	G	A	11	10	21	0	0	21	0	0
1	8169262	.	C	T	11	11	22	0	0	22	0	0
1	8169268	.	C	T	10	9	19	0	3	22	0	0
1	8169361	.	G	A	14	6	20	0	1	21	0	0
1	8189518	.	G	T	8	11	19	0	1	20	0	0
1	8336380	.	C	T	1	2	3	0	0	3	0	0
1	8403299	.	G	A	0	4	4	0	6	10	0	0
1	8403331	.	C	T	5	5	10	0	1	11	0	0
1	8403409	.	C	T	4	2	6	0	0	6	0	0
1	8417896	.	T	C	17	26	43	0	1	44	0	0
1	8418184	.	C	T	1	5	6	0	0	6	0	0
1	8422521	.	A	G	19	33	52	0	2	54	0	0
1	8424735	.	G	A	24	21	45	0	0	45	0	0
1	8524315	.	G	A	3	4	7	0	0	7	0	0
1	8527007	.	G	A	4	5	9	0	1	10	0	0
1	8527205	.	G	T	3	7	10	0	1	11	0	0
1	8530234	.	G	T	0	2	2	0	2	4	0	0
1	8531505	.	T	C	5	7	12	0	0	12	0	0
1	8531665	.	C	A	2	3	5	0	0	5	0	0
1	8531852	.	G	A	1	2	3	0	1	4	0	0
1	8544483	.	G	A	3	5	8	0	0	8	0	0
1	8547320	.	G	A	3	4	7	0	0	7	0	0
1	8547321	.	C	T	3	4	7	0	0	7	0	0
1	8550003	.	T	C	1	4	5	0	0	5	0	0
1	8550062	.	A	G	6	4	10	0	1	11	0	0
1	8550143	.	T	C	2	0	2	0	5	7	0	0
1	8550146	.	T	C	2	5	7	0	0	7	0	0
1	8557075	.	G	A	3	4	7	0	0	7	0	0
1	8557159	.	T	A	6	4	10	0	0	10	0	0
1	8559271	.	T	C	1	0	1	0	10	11	0	0
1	8560237	.	C	T	1	4	5	0	0	5	0	0
1	8560289	.	C	T	7	3	10	0	0	10	0	0
1	8560408	.	T	C	3	7	10	0	1	11	0	0
1	8562005	.	G	C	4	4	8	0	2	10	0	0
1	8563792	.	G	A	4	4	8	0	0	8	0	0
1	8566188	.	T	G	5	5	10	0	0	10	0	0
1	8566467	.	G	A	5	5	10	0	0	10	0	0
1	8566485	.	T	C	11	5	16	0	0	16	0	0
1	8601971	.	A	T	13	6	19	0	0	19	0	0
1	8601990	.	A	T	18	7	25	0	1	26	0	0
1	8606561	.	C	T	5	11	16	0	1	17	0	0
1	8606632	.	C	T	10	18	28	0	1	29	0	0
1	8606767	.	G	A	9	13	22	1	0	23	0	0
1	8607547	.	C	T	3	15	18	0	0	18	0	0
1	8607556	.	T	C	3	17	20	0	0	20	0	0
1	8608300	.	C	T	6	8	14	0	1	15	0	0
1	8610548	.	C	A	7	3	10	0	0	10	0	0
1	8638537	.	T	G	2	2	4	0	0	4	0	0
1	8639883	.	G	A	1	2	3	0	0	3	0	0
1	8642800	.	C	T	4	7	11	0	1	12	0	0
1	8642824	.	A	T	3	5	8	0	1	9	0	0
1	8642938	.	A	G	5	8	13	0	0	13	0	0
1	8642953	.	C	T	4	7	11	0	1	12	0	0
1	8643112	.	G	C	6	4	10	0	1	11	0	0
1	8643661	.	T	A	1	2	3	0	0	3	0	0
1	8646224	.	C	T	4	2	6	0	0	6	0	0
1	8646229	.	A	G	6	2	8	0	0	8	0	0
1	8646265	.	C	T	3	4	7	0	0	7	0	0
1	8649726	.	A	G	45	36	81	2	1	84	0	0
1	8649865	.	C	T	31	44	75	1	2	78	0	0
1	8649988	.	A	G	34	34	68	0	6	74	0	0
1	8649994	.	A	T	36	36	72	0	4	76	0	0
1	8650317	.	G	A	34	37	71	0	4	75	0	0
1	8650371	.	C	T	33	38	71	0	2	73	0	0
1	8651036	.	G	A	30	43	73	0	1	74	0	0
1	8651060	.	T	C	46	27	73	0	2	75	0	0
1	8651576	.	G	A	27	47	74	2	1	77	0	0
1	8652655	.	C	T	0	2	2	0	3	5	0	0
1	8662553	.	G	A	21	30	51	0	1	52	0	0
1	8663048	.	G	A	4	27	31	0	19	50	0	0
1	8663195	.	T	G	24	18	42	0	2	44	0	0
1	8663295	.	T	C	24	27	51	0	2	53	0	0
1	8667377	.	G	A	31	13	44	0	2	46	0	0
1	8667606	.	C	T	29	23	52	0	1	53	0	0
1	8668166	.	T	C	25	24	49	0	5	54	0	0
1	8668238	.	G	T	24	27	51	0	2	53	0	0
1	8669543	.	A	G	9	13	22	0	1	23	0	0
1	8669669	.	A	G	15	6	21	0	0	21	0	0
1	8669673	.	A	G	14	7	21	0	0	21	0	0
1	8669717	.	T	G	11	16	27	0	1	28	0	0
1	8669718	.	T	C	9	17	26	0	1	27	0	0
1	8669753	.	T	A	16	15	31	0	0	31	0	0
1	8669847	.	G	T	29	20	49	0	0	49	0	0
1	8670031	.	T	C	20	40	60	0	5	65	0	0
1	8670032	.	G	T	6	18	24	0	41	65	0	0
1	8670402	.	G	A	17	11	28	0	0	28	0	0
1	8694404	.	G	A	18	14	32	0	0	32	0	0
1	8698765	.	T	C	26	21	47	0	0	47	0	0
1	8698799	.	C	T	19	22	41	0	0	41	0	0
1	8698834	.	T	A	25	20	45	0	0	45	0	0
1	8701548	.	A	G	25	1	26	0	19	45	0	0
1	8701623	.	C	T	26	27	53	0	3	56	0	0
1	8701747	.	G	A	30	14	44	1	0	45	0	0
1	8702158	.	G	A	24	7	31	4	3	38	0	0
1	8702325	.	G	T	18	19	37	0	0	37	0	0
1	8763824	.	A	G	2	2	4	0	0	4	0	0
1	8764123	.	C	T	6	9	15	0	0	15	0	0
1	8764612	.	T	C	4	0	4	0	6	10	0	0
1	8764661	.	T	A	12	9	21	0	0	21	0	0
1	8764729	.	C	T	18	12	30	1	0	31	0	0
1	8764760	.	G	A	16	10	26	0	0	26	0	0
1	8764811	.	C	T	0	4	4	0	12	16	0	0
1	8764812	.	G	A	12	4	16	0	0	16	0	0
1	8765315	.	A	G	24	16	40	0	0	40	0	0
1	8765422	.	G	A	20	9	29	0	1	30	0	0
1	8765713	.	A	C	20	16	36	0	3	39	0	0
1	8765724	.	A	G	25	18	43	0	1	44	0	0
1	8766267	.	T	C	16	0	16	0	15	31	0	0
1	8766453	.	C	T	11	26	37	0	1	38	0	0
1	8766471	.	C	T	0	24	24	0	11	35	0	0
1	8766501	.	C	T	14	16	30	0	0	30	0	0
1	8766693	.	G	A	16	12	28	0	0	28	0	0
1	8767002	.	C	T	14	9	23	0	2	25	0	0
1	8767080	.	G	A	20	13	33	0	0	33	0	0
1	8767155	.	C	T	13	12	25	0	1	26	0	0
1	8767185	.	T	C	13	12	25	0	2	27	0	0
1	8767260	.	T	C	11	10	21	0	0	21	0	0
1	8767395	.	A	G	6	7	13	0	1	14	0	0
1	8767536	.	T	C	8	1	9	0	11	20	0	0
1	8767629	.	G	A	11	15	26	0	1	27	0	0
1	8767725	.	T	C	9	13	22	0	1	23	0	0
1	8768307	.	A	G	11	7	18	0	1	19	0	0
1	8770773	.	G	A	12	8	20	0	1	21	0	0
1	8771020	.	T	G	17	7	24	0	3	27	0	0
1	8773269	.	T	C	15	8	23	0	0	23	0	0
1	8773320	.	G	A	18	6	24	0	0	24	0	0
1	8773383	.	A	G	12	8	20	0	1	21	0	0
1	8776497	.	A	G	7	10	17	0	2	19	0	0
1	8810701	.	T	G	9	5	14	0	1	15	0	0
1	8810986	.	T	C	4	0	4	0	7	11	0	0
1	8917623	.	C	T	11	6	17	0	1	18	0	0
1	8974576	.	C	T	3	5	8	0	0	8	0	0
1	8974695	.	A	T	7	9	16	0	0	16	0	0
1	8975096	.	C	T	2	7	9	0	1	10	0	0
1	9004942	.	T	C	16	18	34	0	2	36	0	0
1	9044745	.	C	T	25	15	40	0	0	40	0	0
1	9051092	.	T	C	23	14	37	0	1	38	0	0
1	9056045	.	T	G	14	16	30	0	2	32	0	0
1	9056886	.	T	C	22	22	44	0	0	44	0	0
1	9064611	.	T	C	7	6	13	0	0	13	0	0
1	9064791	.	C	A	4	8	12	0	1	13	0	0
1	9064864	.	T	C	8	4	12	0	0	12	0	0
1	9064885	.	C	A	8	3	11	0	0	11	0	0
1	9074440	.	T	C	14	24	38	0	4	42	0	0
1	9118497	.	T	A	12	23	35	0	1	36	0	0
1	9123262	.	A	G	15	21	36	2	0	38	0	0
1	9214635	.	C	T	1	3	4	0	0	4	0	0
1	9262077	.	A	G	7	16	23	0	0	24	1	0
1	9262080	.	A	G	6	17	23	0	1	24	0	0
1	9265578	.	T	C	12	7	19	0	1	20	0	0
1	9270198	.	T	C	8	7	15	0	1	16	0	0
1	9270885	.	G	A	4	7	11	0	2	13	0	0
1	9273347	.	A	G	6	12	18	0	0	18	0	0
1	9273947	.	G	C	7	6	13	0	1	14	0	0
1	9276360	.	T	C	17	0	17	0	10	27	0	0
1	9276420	.	C	T	9	4	13	0	0	13	0	0
1	9277858	.	T	C	13	11	24	0	1	25	0	0
1	9278150	.	G	A	16	7	23	0	0	23	0	0
1	9290500	.	G	T	9	5	14	0	0	14	0	0
1	9293041	.	C	T	6	8	14	0	2	16	0	0
1	9293117	.	G	A	1	7	8	0	16	24	0	0
1	9293156	.	G	A	13	10	23	0	1	24	0	0
1	9293185	.	T	C	12	12	24	0	1	25	0	0
1	9293215	.	G	A	13	13	26	0	0	26	0	0
1	9293495	.	A	G	8	12	20	0	0	20	0	0
1	9293580	.	C	T	8	8	16	0	0	16	0	0
1	9293740	.	T	C	5	6	11	0	0	11	0	0
1	9293889	.	C	A	5	2	7	0	0	7	0	0
1	9474416	.	C	G	1	2	3	0	0	3	0	0
1	9474418	.	C	A	1	2	3	0	0	3	0	0
1	9499764	.	C	T	7	8	15	0	0	15	0	0
1	9500312	.	A	T	6	4	10	0	0	10	0	0
1	9500508	.	C	A	2	3	5	1	0	6	0	0
1	9500735	.	T	C	4	2	6	0	1	7	0	0
1	9500835	.	A	G	5	11	16	0	1	17	0	0
1	9500947	.	G	T	9	6	15	0	0	15	0	0
1	9500984	.	A	T	5	3	8	0	0	8	0	0
1	9501011	.	T	C	4	2	6	0	1	7	0	0
1	9501229	.	C	T	15	10	25	0	1	26	0	0
1	9501231	.	G	A	11	11	22	0	1	23	0	0
1	9501365	.	T	C	13	0	13	0	11	24	0	0
1	9501394	.	T	A	12	11	23	0	0	23	0	0
1	9508752	.	T	A	11	13	24	0	2	26	0	0
1	9510571	.	A	G	4	7	11	0	0	11	0	0
1	9510574	.	G	A	3	7	10	0	1	11	0	0
1	9512342	.	C	T	9	8	17	0	1	18	0	0
1	9516905	.	A	C	10	7	17	0	1	18	0	0
1	9517048	.	A	G	9	11	20	0	1	21	0	0
1	9517102	.	G	A	7	7	14	0	0	14	0	0
1	9519935	.	G	A	8	4	12	0	0	12	0	0
1	9520435	.	G	A	1	8	9	0	1	10	0	0
1	9523283	.	C	T	1	11	12	0	6	18	0	0
1	9527076	.	T	A	4	10	14	0	0	14	0	0
1	9527108	.	T	C	8	4	12	0	0	12	0	0
1	9527119	.	T	C	7	0	7	0	4	11	0	0
1	9557242	.	G	T	0	3	3	0	2	5	0	0
1	9557456	.	T	C	6	8	14	0	0	14	0	0
1	9618201	.	C	T	2	5	7	1	1	9	0	0
1	9618241	.	A	G	5	6	11	2	1	14	0	0
1	9708694	.	T	C	1	3	4	0	0	4	0	0
1	9708707	.	T	C	2	3	5	0	0	5	0	0
1	9708747	.	C	A	4	2	6	0	1	7	0	0
1	9709280	.	G	A	6	5	11	0	0	11	0	0
1	9709340	.	C	T	6	5	11	0	0	11	0	0
1	9709500	.	G	A	3	5	8	0	1	9	0	0
1	9710759	.	C	T	9	4	13	0	1	14	0	0
1	9710853	.	T	C	10	5	15	0	0	15	0	0
1	9711158	.	G	A	4	4	8	0	2	10	0	0
1	9711161	.	G	A	5	5	10	0	0	10	0	0
1	9711405	.	T	A	4	4	8	0	0	8	0	0
1	9711740	.	G	C	4	3	7	0	0	7	0	0
1	9711956	.	A	G	9	3	12	1	0	13	0	0
1	9712111	.	G	A	0	8	8	0	7	15	0	0
1	9712253	.	T	A	3	6	9	0	0	9	0	0
1	9712266	.	G	T	2	3	5	0	0	5	0	0
1	9740989	.	T	A	2	2	4	0	0	4	0	0
1	9741123	.	G	A	1	7	8	0	0	8	0	0
1	9793219	.	C	T	4	3	7	0	0	7	0	0
1	9793220	.	T	C	4	3	7	0	0	7	0	0
1	9793286	.	C	T	2	4	6	0	1	7	0	0
1	9808324	.	A	G	2	7	9	0	0	9	0	0
1	9808345	.	T	A	3	6	9	0	0	9	0	0
1	9808365	.	C	T	4	5	9	0	0	9	0	0
1	9856270	.	T	C	4	3	7	0	0	7	0	0
1	9856276	.	C	G	3	3	6	0	0	6	0	0
1	9858447	.	C	T	1	3	4	0	2	6	0	0
1	9858451	.	G	A	1	3	4	0	0	4	0	0
1	9873485	.	G	A	2	3	5	0	0	5	0	0
1	9873538	.	G	A	4	2	6	0	0	6	0	0
1	9873607	.	A	T	4	4	8	0	4	12	0	0
1	9873616	.	T	C	5	1	6	0	8	14	0	0
1	9873787	.	G	A	10	4	14	0	0	14	0	0
1	9877375	.	A	C	3	2	5	0	0	5	0	0
1	9877426	.	C	T	1	4	5	0	2	7	0	0
1	9880387	.	A	G	4	8	12	0	0	12	0	0
1	9914250	.	T	C	3	3	6	0	0	6	0	0
1	9920359	.	G	A	6	2	8	0	0	8	0	0
1	9920631	.	G	A	6	3	9	0	0	9	0	0
1	10667832	.	C	T	0	4	4	1	3	8	0	0
1	10667856	.	A	G	3	3	6	0	0	6	0	0
1	10667879	.	G	A	2	3	5	0	0	5	0	0
1	10675585	.	A	T	5	3	8	0	0	8	0	0
1	10680513	.	A	G	2	3	5	0	0	5	0	0
1	10680518	.	C	T	0	1	1	0	5	6	0	0
1	10683868	.	A	T	19	16	35	0	0	35	0	0
1	10683955	.	A	G	24	21	45	0	1	46	0	0
1	10683974	.	A	C	22	21	43	0	2	45	0	0
1	10684037	.	A	G	22	2	24	0	16	40	0	0
1	10684105	.	G	A	5	24	29	0	22	51	0	0
1	10688731	.	T	G	15	0	15	0	18	33	0	0
1	10692078	.	T	C	14	15	29	1	1	31	0	0
1	10692090	.	G	A	17	15	32	0	0	32	0	0
1	10736181	.	G	A	33	30	63	0	4	67	0	0
1	10738509	.	T	C	27	41	68	0	1	69	0	0
1	10738535	.	G	A	30	40	70	0	1	71	0	0
1	10738568	.	A	G	34	4	38	0	30	68	0	0
1	10738863	.	C	A	32	30	62	0	5	67	0	0
1	10841254	.	T	C	12	12	24	0	2	26	0	0
1	10841275	.	T	C	13	15	28	0	0	28	0	0
1	10841356	.	G	A	7	10	17	2	0	19	0	0
1	10885266	.	T	A	7	4	11	0	1	12	0	0
1	10897373	.	A	G	1	4	5	0	0	5	0	0
1	10901304	.	A	G	2	4	6	0	0	6	0	0
1	10901325	.	G	A	2	4	6	0	0	6	0	0
1	10914197	.	A	G	1	4	5	0	0	5	0	0
1	10930409	.	C	T	1	2	3	0	0	3	0	0
1	10950594	.	C	T	0	5	5	0	1	6	0	0
1	11017023	.	G	A	1	4	5	0	0	5	0	0
1	11125149	.	C	T	1	2	3	0	5	8	0	0
1	11125177	.	C	T	3	2	5	0	1	6	0	0
1	11125195	.	C	T	2	4	6	0	0	6	0	0
1	11125237	.	G	A	5	3	8	0	0	8	0	0
1	11125249	.	A	C	5	5	10	0	2	12	0	0
1	11127938	.	G	A	5	7	12	0	0	12	0	0
1	11128515	.	C	A	0	3	3	1	5	9	0	0
1	11130713	.	G	A	3	5	8	0	0	8	0	0
1	11132905	.	C	T	0	3	3	0	2	5	0	0
1	11136648	.	G	A	2	3	5	0	0	5	0	0
1	11139245	.	C	G	4	2	6	0	0	6	0	0
1	11141082	.	C	T	4	3	7	0	0	7	0	0
1	11144295	.	T	C	3	3	6	0	2	8	0	0
1	11150984	.	G	A	3	2	5	0	1	6	0	0
1	11155084	.	A	T	2	5	7	0	0	7	0	0
1	11180740	.	C	T	4	2	6	0	0	6	0	0
1	11194724	.	C	T	0	3	3	0	3	6	0	0
1	11267625	.	G	A	2	3	5	0	1	6	0	0
1	11275073	.	A	G	9	4	13	0	0	13	0	0
1	11280839	.	C	A	4	2	6	0	0	6	0	0
1	11280856	.	G	A	1	4	5	0	0	5	0	0
1	11364423	.	G	A	2	4	6	0	0	6	0	0
1	11364435	.	T	A	2	2	4	0	0	4	0	0
1	11671059	.	A	G	6	3	9	0	0	9	0	0
1	11671355	.	C	A	9	6	15	0	0	15	0	0
1	11671527	.	G	A	7	6	13	0	0	13	0	0
1	11671580	.	C	T	6	7	13	0	0	13	0	0
1	11671651	.	A	C	4	2	6	0	0	6	0	0
1	11783388	.	T	C	15	26	41	0	1	42	0	0
1	11783504	.	T	C	29	16	45	0	2	47	0	0
1	11783650	.	T	C	31	21	52	0	0	52	0	0
1	11784609	.	T	C	26	14	40	0	5	45	0	0
1	11784679	.	T	C	18	30	48	0	1	49	0	0
1	11864857	.	T	C	4	2	6	0	0	6	0	0
1	11903808	.	A	T	1	7	8	0	0	8	0	0
1	15254249	.	A	G	7	0	7	0	6	13	0	0
1	15255336	.	A	G	8	8	16	0	0	16	0	0
1	15255338	.	A	G	9	7	16	0	0	16	0	0
1	17522801	.	A	G	21	6	27	0	2	29	0	0
1	17524473	.	G	A	2	1	3	1	2	6	0	0
1	19742745	.	C	T	2	2	4	0	0	4	0	0
1	19762901	.	C	T	3	5	8	0	1	9	0	0
1	19785208	.	A	C	5	2	7	0	1	8	0	0
1	19815977	.	T	C	7	6	13	0	0	13	0	0
1	19862011	.	G	A	1	6	7	0	0	7	0	0
1	19862012	.	C	A	1	6	7	0	0	7	0	0
1	19866347	.	C	T	6	3	9	0	0	9	0	0
1	19868099	.	G	T	7	3	10	0	1	11	0	0
1	19869748	.	G	A	5	5	10	0	0	10	0	0
1	19869750	.	A	C	4	5	9	0	1	10	0	0
1	19872148	.	C	T	5	3	8	0	0	8	0	0
1	19872269	.	C	T	6	5	11	0	2	13	0	0
1	19874550	.	G	A	5	6	11	0	0	11	0	0
1	19879890	.	A	T	2	4	6	0	0	6	0	0
1	19882538	.	C	A	7	2	9	0	0	9	0	0
1	19882923	.	C	T	3	3	6	0	0	6	0	0
1	19886159	.	A	C	2	5	7	0	0	7	0	0
1	19886292	.	T	A	4	7	11	0	0	11	0	0
1	19886323	.	G	A	2	3	5	0	1	6	0	0
1	19886333	.	A	T	2	2	4	0	0	4	0	0
1	19936259	.	G	T	3	12	15	0	14	29	0	0
1	19936298	.	G	A	14	9	23	0	0	23	0	0
1	19936358	.	T	C	14	14	28	0	0	28	0	0
1	19936418	.	T	A	11	14	25	0	0	25	0	0
1	19936511	.	T	C	13	15	28	0	0	28	0	0
1	19936682	.	C	T	6	10	16	0	0	16	0	0
1	19937090	.	A	G	9	0	9	0	15	24	0	0
1	19950478	.	A	T	15	16	31	1	0	32	0	0
1	19955634	.	A	G	14	12	26	0	2	28	0	0
1	19955706	.	C	T	16	8	24	0	1	25	0	0
1	19966416	.	C	T	23	8	31	0	1	32	0	0
1	19978049	.	A	G	10	0	10	0	8	18	0	0
1	19984448	.	C	T	24	10	34	0	1	35	0	0
1	19988952	.	C	G	17	22	39	0	2	41	0	0
1	19989008	.	T	G	21	17	38	0	2	40	0	0
1	19989023	.	G	A	0	17	17	0	22	39	0	0
1	20063843	.	C	A	0	3	3	0	1	4	0	0
1	20065156	.	A	G	3	2	5	0	0	5	0	0
1	20068075	.	A	C	4	3	7	0	0	7	0	0
1	20068092	.	T	A	4	2	6	0	0	6	0	0
1	20092616	.	T	A	6	13	19	0	0	19	0	0
1	20094234	.	G	A	8	12	20	0	1	21	0	0
1	20094327	.	G	T	7	6	13	0	1	14	0	0
1	20095274	.	A	G	11	8	19	0	1	20	0	0
1	20106546	.	G	A	1	3	4	2	0	6	0	0
1	20112454	.	C	T	6	8	14	10	0	24	0	0
1	20112574	.	C	T	1	2	3	19	0	22	0	0
1	20112598	.	A	G	5	2	7	9	0	16	0	0
1	20117629	.	T	C	7	6	13	0	0	13	0	0
1	20129652	.	T	C	10	9	19	0	0	19	0	0
1	20138674	.	C	A	6	4	10	0	0	10	0	0
1	20138713	.	A	C	4	5	9	0	0	9	0	0
1	20138901	.	A	G	7	4	11	0	1	12	0	0
1	20139488	.	T	C	7	5	12	1	0	13	0	0
1	20139522	.	A	G	8	2	10	1	0	11	0	0
1	20139551	.	G	A	9	11	20	0	0	20	0	0
1	20139566	.	A	G	6	13	19	0	0	19	0	0
1	20139636	.	A	C	9	7	16	0	1	18	1	0
1	20139658	.	T	A	11	8	19	0	0	19	0	0
1	20139792	.	C	T	9	3	12	1	0	13	0	0
1	20139815	.	T	C	9	8	17	0	0	17	0	0
1	20139962	.	A	T	18	12	30	0	1	31	0	0
1	20140042	.	G	T	0	15	15	0	6	21	0	0
1	20140048	.	A	T	5	15	20	0	0	20	0	0
1	20140120	.	C	T	7	9	16	0	1	17	0	0
1	20140133	.	T	C	7	6	13	0	0	13	0	0
1	20140200	.	C	T	15	9	24	0	0	24	0	0
1	20140363	.	T	G	10	8	18	0	0	18	0	0
1	20140419	.	G	A	10	7	17	0	0	17	0	0
1	20140445	.	T	C	8	7	15	0	0	15	0	0
1	20140951	.	G	A	2	15	17	0	16	33	0	0
1	20140952	.	G	A	19	14	33	0	1	34	0	0
1	20141070	.	C	A	9	8	17	0	0	17	0	0
1	20141106	.	A	G	12	5	17	0	1	18	0	0
1	20141218	.	T	G	14	4	18	0	1	19	0	0
1	20141232	.	T	A	12	6	18	0	0	18	0	0
1	20141253	.	G	A	14	5	19	0	2	21	0	0
1	20141310	.	G	A	17	8	25	0	2	27	0	0
1	20141378	.	C	G	12	0	12	0	20	32	0	0
1	20141411	.	A	T	11	15	26	0	0	26	0	0
1	20141572	.	G	A	0	9	9	1	4	14	0	0
1	20141611	.	T	C	6	8	14	1	0	15	0	0
1	20141661	.	A	C	4	11	15	0	0	15	0	0
1	20141834	.	G	C	4	3	7	0	1	8	0	0
1	20147248	.	T	A	3	6	9	0	0	9	0	0
1	20160882	.	T	A	20	13	33	0	0	33	0	0
1	20166536	.	C	A	17	10	27	0	2	29	0	0
1	20166600	.	A	G	9	14	23	0	0	23	0	0
1	20173954	.	A	G	9	4	13	0	0	13	0	0
1	20194118	.	C	T	9	9	18	0	0	18	0	0
1	20212239	.	G	A	14	7	21	1	1	23	0	0
1	20212284	.	C	T	9	13	22	0	1	23	0	0
1	20212362	.	G	A	13	8	21	0	0	21	0	0
1	20221498	.	G	A	7	7	14	0	0	14	0	0
1	20270080	.	G	A	5	7	12	0	0	12	0	0
1	20270486	.	A	T	3	9	12	0	2	14	0	0
1	20270779	.	G	A	11	16	27	0	0	27	0	0
1	20557447	.	G	A	12	16	28	0	3	31	0	0
1	20557625	.	A	C	10	0	10	0	16	26	0	0
1	20557650	.	C	T	4	11	15	0	2	17	0	0
1	20557938	.	C	T	7	3	10	0	1	11	0	0
1	20558143	.	T	C	8	16	24	0	2	26	0	0
1	20558594	.	C	A	1	5	6	0	2	8	0	0
1	20558888	.	C	A	8	5	13	0	0	13	0	0
1	20559010	.	A	G	8	4	12	0	0	12	0	0
1	20559093	.	A	G	3	7	10	0	0	10	0	0
1	20559321	.	T	C	8	1	9	0	13	22	0	0
1	20559324	.	T	A	7	13	20	0	0	20	0	0
1	20559538	.	G	A	11	8	19	0	2	21	0	0
1	20559830	.	G	A	8	7	15	0	1	16	0	0
1	20559902	.	A	G	10	4	14	0	0	14	0	0
1	20564770	.	T	G	7	17	24	0	0	24	0	0
1	20581101	.	A	G	8	5	13	0	1	14	0	0
1	20581454	.	A	G	4	7	11	0	0	11	0	0
1	20581502	.	A	G	4	6	10	0	0	10	0	0
1	20581665	.	A	G	3	5	8	0	0	8	0	0
1	20678674	.	G	C	20	23	43	0	1	44	0	0
1	20694916	.	G	A	2	29	31	0	23	54	0	0
1	20694955	.	A	G	20	31	51	0	2	55	2	0
1	20695073	.	G	A	2	28	30	0	21	51	0	0
1	20700473	.	T	C	43	27	70	0	3	73	0	0
1	20700524	.	G	A	5	42	47	0	25	72	0	0
1	20704896	.	T	C	23	24	47	0	3	50	0	0
1	20705237	.	C	T	25	21	46	0	2	48	0	0
1	20705863	.	A	G	25	22	47	2	1	50	0	0
1	20866886	.	C	T	12	11	23	0	2	25	0	0
1	20866996	.	T	G	25	28	53	0	1	54	0	0
1	20867057	.	A	T	29	31	60	0	2	64	2	0
1	20867092	.	C	T	35	25	60	0	0	60	0	0
1	20867185	.	A	T	30	22	52	0	2	55	1	0
1	20867186	.	G	T	22	24	46	0	4	51	1	0
1	20867321	.	C	T	6	28	34	0	23	57	0	0
1	20867345	.	C	T	32	21	53	0	1	54	0	0
1	20867359	.	C	T	33	20	53	0	1	54	0	0
1	20867623	.	T	C	34	35	69	0	1	70	0	0
1	20867968	.	T	G	42	27	69	1	2	72	0	0
1	20868165	.	C	G	43	26	69	0	0	69	0	0
1	20868242	.	T	A	30	37	67	0	6	73	0	0
1	20868258	.	T	A	42	28	70	0	1	71	0	0
1	20868301	.	A	G	41	31	72	0	2	74	0	0
1	20868309	.	C	G	36	34	70	0	5	75	0	0
1	20868338	.	G	T	36	31	67	0	4	71	0	0
1	20868504	.	T	C	30	37	67	0	0	67	0	0
1	20868530	.	C	T	31	28	59	0	1	60	0	0
1	20868546	.	G	A	34	20	54	0	4	58	0	0
1	20868684	.	A	T	39	34	73	1	5	79	0	0
1	20868802	.	T	G	49	9	58	3	1	63	1	0
1	20868825	.	G	A	44	14	58	0	2	60	0	0
1	20868850	.	G	A	39	20	59	0	3	62	0	0
1	20868927	.	A	G	38	26	64	0	1	65	0	0
1	20868953	.	C	T	3	25	28	0	36	64	0	0
1	20869064	.	T	A	12	13	25	0	2	27	0	0
1	20870387	.	T	C	31	16	47	1	1	49	0	0
1	20870632	.	T	C	28	17	45	7	4	56	0	0
1	20870846	.	C	T	27	31	58	2	3	63	0	0
1	20871144	.	C	G	31	33	64	0	2	66	0	0
1	20886924	.	G	A	36	33	69	0	2	71	0	0
1	20886936	.	G	A	42	31	73	0	0	73	0	0
1	20910967	.	A	G	27	34	61	0	9	70	0	0
1	20911171	.	G	T	29	50	79	0	10	90	1	0
1	20916898	.	G	A	5	5	10	0	0	10	0	0
1	20916928	.	T	A	5	7	12	0	0	12	0	0
1	20925532	.	G	A	9	9	18	0	0	18	0	0
1	20925544	.	G	T	11	8	19	0	1	20	0	0
1	20925896	.	A	G	2	5	7	0	0	7	0	0
1	20932137	.	T	A	7	7	14	0	0	14	0	0
1	20932138	.	C	T	7	6	13	0	1	14	0	0
1	20941573	.	G	A	2	6	8	0	0	8	0	0
1	20946897	.	A	G	4	7	11	0	1	12	0	0
1	20956239	.	G	A	8	6	14	0	0	14	0	0
1	20959028	.	T	C	6	2	8	1	0	9	0	0
1	20970002	.	T	A	4	5	9	0	0	9	0	0
1	20970109	.	G	T	5	7	12	0	1	13	0	0
1	20970202	.	G	A	6	11	17	0	0	17	0	0
1	21138623	.	T	C	3	2	5	0	0	5	0	0
1	21139142	.	G	A	2	5	7	0	0	7	0	0
1	21139355	.	G	A	5	2	7	0	0	7	0	0
1	21139367	.	G	A	5	2	7	0	0	7	0	0
1	21139456	.	G	C	6	8	14	0	0	14	0	0
1	21141701	.	A	G	5	11	16	0	0	16	0	0
1	21141894	.	C	T	0	4	4	0	10	14	0	0
1	21141930	.	T	G	7	5	12	0	0	12	0	0
1	21141999	.	G	A	11	9	20	0	1	21	0	0
1	21146729	.	C	G	0	7	7	0	5	12	0	0
1	21151784	.	A	G	3	5	8	0	0	8	0	0
1	21159366	.	T	C	1	0	1	0	5	6	0	0
1	21159908	.	T	C	2	3	5	0	0	5	0	0
1	21160853	.	G	A	2	4	6	0	0	6	0	0
1	21163422	.	C	T	2	3	5	0	1	6	0	0
1	21286996	.	G	A	1	2	3	0	1	4	0	0
1	21309424	.	G	T	5	3	8	0	0	8	0	0
1	21309461	.	A	T	11	7	18	0	0	18	0	0
1	21312067	.	A	G	9	9	18	0	0	18	0	0
1	21312112	.	C	T	12	18	30	0	1	31	0	0
1	21313861	.	T	A	2	4	6	0	0	6	0	0
1	21333205	.	C	G	2	23	25	0	19	44	0	0
1	21333223	.	A	T	22	12	34	0	4	38	0	0
1	21333337	.	G	C	25	18	43	1	1	45	0	0
1	21344500	.	G	A	25	16	41	1	2	44	0	0
1	21344518	.	C	G	2	12	14	1	32	47	0	0
1	21346015	.	T	C	24	19	43	0	2	45	0	0
1	21346051	.	C	T	27	11	38	0	1	39	0	0
1	21368014	.	C	A	21	26	47	0	3	50	0	0
1	21368074	.	C	A	24	24	48	0	0	48	0	0
1	21368206	.	G	T	12	19	31	0	0	31	0	0
1	21423307	.	C	T	5	8	13	0	2	15	0	0
1	21423756	.	A	G	16	11	27	0	1	28	0	0
1	21423765	.	C	A	13	19	32	0	1	33	0	0
1	21449804	.	A	G	9	7	16	0	0	16	0	0
1	21483684	.	G	A	5	3	8	0	0	8	0	0
1	21500209	.	T	A	3	7	10	0	0	10	0	0
1	21500451	.	G	T	2	6	8	0	0	8	0	0
1	21513826	.	G	A	8	5	13	0	0	13	0	0
1	21514069	.	G	A	6	6	12	0	0	12	0	0
1	21515903	.	G	T	2	7	9	0	1	10	0	0
1	21516249	.	C	G	2	6	8	0	0	8	0	0
1	21522358	.	G	A	3	3	6	0	1	7	0	0
1	21527348	.	C	A	6	5	11	0	0	11	0	0
1	21529374	.	G	A	4	5	9	0	0	9	0	0
1	21532624	.	C	T	2	3	5	0	0	5	0	0
1	21537546	.	T	A	6	3	9	0	0	9	0	0
1	21537554	.	G	A	5	5	10	0	0	10	0	0
1	21538635	.	G	A	2	3	5	0	0	5	0	0
1	21576919	.	G	A	2	2	4	0	0	4	0	0
1	21579242	.	T	G	2	3	5	0	0	5	0	0
1	21581680	.	T	C	3	0	3	0	3	6	0	0
1	21610564	.	T	C	3	4	7	0	0	7	0	0
1	21610651	.	A	G	2	2	4	0	0	4	0	0
1	21611848	.	A	G	4	2	6	0	0	6	0	0
1	21612127	.	C	T	6	3	9	0	1	10	0	0
1	21612153	.	T	G	3	4	7	0	1	8	0	0
1	21612400	.	G	A	5	5	10	0	0	10	0	0
1	21612418	.	G	C	7	4	11	0	0	11	0	0
1	21648641	.	G	A	4	5	9	0	0	9	0	0
1	21769410	.	G	A	0	2	2	0	1	3	0	0
1	21894251	.	C	T	2	2	4	0	0	4	0	0
1	21944599	.	C	G	3	3	6	0	1	7	0	0
1	21944731	.	C	T	4	6	10	0	1	11	0	0
1	21945383	.	C	A	4	5	9	0	0	9	0	0
1	22217780	.	T	C	1	2	3	0	0	3	0	0
1	22236735	.	T	G	8	4	12	0	1	13	0	0
1	22236891	.	A	T	7	8	15	0	0	15	0	0
1	22236990	.	G	A	9	5	14	0	0	14	0	0
1	22245624	.	A	G	3	4	7	0	0	7	0	0
1	22245630	.	C	T	1	3	4	0	2	6	0	0
1	22389122	.	C	T	8	3	11	0	0	11	0	0
1	22389246	.	C	T	1	8	9	0	8	17	0	0
1	22389264	.	T	A	8	11	19	0	2	21	0	0
1	22389395	.	T	C	9	15	24	0	1	25	0	0
1	22401851	.	A	G	6	10	16	0	2	18	0	0
1	22412005	.	G	A	12	7	19	0	1	20	0	0
1	22484539	.	G	A	6	2	8	0	0	8	0	0
1	22484544	.	C	A	3	5	8	0	0	8	0	0
1	22490565	.	C	T	1	5	6	0	7	13	0	0
1	22490795	.	C	T	2	5	7	1	6	14	0	0
1	22511863	.	C	T	6	4	10	0	0	10	0	0
1	22511909	.	A	G	4	4	8	0	0	8	0	0
1	22511922	.	G	A	5	5	10	0	0	10	0	0
1	22511963	.	T	A	2	6	8	0	0	8	0	0
1	22543084	.	A	G	2	2	4	0	0	4	0	0
1	22543549	.	T	C	1	2	3	0	0	3	0	0
1	22647772	.	T	C	2	2	4	0	6	10	0	0
1	22648037	.	T	A	23	32	55	2	1	58	0	0
1	22648038	.	A	C	22	32	54	2	2	58	0	0
1	22651348	.	C	A	3	21	24	0	25	49	0	0
1	22651700	.	T	C	2	1	3	0	0	3	0	0
1	22651710	.	T	A	3	1	4	0	1	5	0	0
1	22651744	.	A	C	3	2	5	0	0	5	0	0
1	22651934	.	T	A	38	19	57	0	0	57	0	0
1	22652028	.	C	T	1	6	7	0	0	7	0	0
1	22664294	.	A	C	2	2	4	0	1	5	0	0
1	22664924	.	A	T	3	4	7	0	0	7	0	0
1	22713000	.	A	T	1	4	5	0	0	5	0	0
1	22713010	.	A	T	1	4	5	0	0	5	0	0
1	22713058	.	C	T	0	3	3	0	2	5	0	0
1	22713513	.	C	T	1	2	3	0	0	3	0	0
1	22713525	.	G	A	1	2	3	0	0	3	0	0
1	22713974	.	G	A	4	5	9	0	0	9	0	0
1	22737072	.	G	A	3	3	6	0	0	6	0	0
1	22770608	.	A	T	16	12	28	0	0	28	0	0
1	22770723	.	C	T	8	5	13	0	1	14	0	0
1	22771305	.	T	G	13	13	26	0	0	27	1	0
1	22771437	.	G	A	9	7	16	0	1	17	0	0
1	22771677	.	C	T	2	3	5	0	8	13	0	0
1	22771911	.	A	T	9	13	22	0	0	22	0	0
1	22771936	.	C	T	13	9	22	0	1	23	0	0
1	22771952	.	A	T	14	13	27	0	0	27	0	0
1	22772213	.	C	A	8	4	12	0	0	12	0	0
1	22772308	.	C	T	7	13	20	0	2	22	0	0
1	22772711	.	G	A	12	11	23	0	4	27	0	0
1	22777201	.	G	A	9	7	16	0	0	16	0	0
1	22777862	.	A	C	7	7	14	0	2	16	0	0
1	22803001	.	A	T	5	5	10	0	1	11	0	0
1	22805615	.	C	T	7	9	16	0	0	16	0	0
1	22805630	.	G	C	7	8	15	0	0	15	0	0
1	22805750	.	T	A	2	3	5	0	1	6	0	0
1	22805766	.	C	T	2	3	5	0	0	5	0	0
1	22806089	.	C	T	23	13	36	0	0	36	0	0
1	22806108	.	A	G	17	21	38	2	0	40	0	0
1	22806166	.	G	A	8	3	11	1	0	12	0	0
1	22806254	.	T	C	7	8	15	0	0	15	0	0
1	22806643	.	C	A	13	13	26	0	1	27	0	0
1	22806825	.	C	T	1	6	7	0	14	21	0	0
1	22806917	.	C	A	5	3	8	0	0	8	0	0
1	22806936	.	C	T	1	6	7	0	6	13	0	0
1	22806980	.	G	A	9	6	15	0	0	15	0	0
1	22807043	.	G	A	8	6	14	0	0	14	0	0
1	22807110	.	T	C	15	1	16	0	8	24	0	0
1	22807169	.	A	G	14	7	21	0	2	23	0	0
1	22807238	.	G	A	12	10	22	0	0	22	0	0
1	22807275	.	C	G	15	6	21	0	1	22	0	0
1	22807304	.	C	G	12	10	22	0	3	25	0	0
1	22807321	.	G	A	12	11	23	0	2	25	0	0
1	22807632	.	C	T	9	10	19	1	1	21	0	0
1	22807639	.	G	A	8	11	19	1	0	20	0	0
1	22807744	.	G	T	5	8	13	0	1	14	0	0
1	22808009	.	G	T	7	10	17	0	1	18	0	0
1	22808149	.	T	A	4	12	16	0	1	17	0	0
1	22808181	.	T	C	11	0	11	0	6	17	0	0
1	22808264	.	T	G	13	9	22	0	0	22	0	0
1	22808296	.	A	T	6	6	12	0	1	15	2	0
1	22808301	.	C	G	1	5	6	0	7	13	0	0
1	22808384	.	C	T	0	12	12	0	4	16	0	0
1	22808444	.	G	A	9	3	12	0	1	13	0	0
1	22808665	.	C	T	9	7	16	0	0	16	0	0
1	22814910	.	A	G	9	12	21	0	2	23	0	0
1	22829325	.	G	A	7	8	15	0	1	16	0	0
1	22851380	.	T	C	12	4	16	0	0	17	1	0
1	22851422	.	T	A	1	6	7	0	0	7	0	0
1	22851828	.	A	T	13	9	22	0	0	22	0	0
1	22856087	.	C	T	5	9	14	0	0	14	0	0
1	22857979	.	C	T	15	9	24	0	0	24	0	0
1	22857995	.	A	G	9	13	22	0	1	23	0	0
1	22858194	.	G	A	14	20	34	0	0	34	0	0
1	22858275	.	T	C	18	23	41	0	0	41	0	0
1	22858397	.	G	A	19	22	41	0	7	48	0	0
1	22858478	.	G	A	30	18	48	0	2	50	0	0
1	22861253	.	G	A	23	20	43	0	1	44	0	0
1	22861267	.	G	A	20	15	35	0	1	36	0	0
1	22864011	.	C	T	9	7	16	0	1	17	0	0
1	22943748	.	G	A	11	9	20	0	0	20	0	0
1	22944056	.	C	T	1	27	28	0	17	45	0	0
1	22944068	.	C	T	31	18	49	0	1	50	0	0
1	22944386	.	A	C	28	23	51	0	2	53	0	0
1	22945054	.	T	C	18	27	45	0	1	46	0	0
1	22945173	.	T	G	14	23	37	0	1	38	0	0
1	22945190	.	G	T	14	23	37	0	1	38	0	0
1	22945444	.	G	A	22	25	47	0	1	48	0	0
1	22945519	.	C	T	23	13	36	0	8	44	0	0
1	22945888	.	G	C	19	0	19	0	29	48	0	0
1	22945903	.	T	C	19	26	45	0	0	45	0	0
1	22946108	.	C	T	15	26	41	0	2	43	0	0
1	22956429	.	C	T	3	20	23	0	23	46	0	0
1	22966877	.	C	A	15	15	30	0	3	33	0	0
1	22987960	.	A	G	16	14	30	0	0	30	0	0
1	22992058	.	G	A	13	19	32	0	2	34	0	0
1	22996606	.	G	A	24	8	32	0	0	32	0	0
1	23072224	.	G	A	10	16	26	0	1	27	0	0
1	23072278	.	G	A	12	13	25	0	0	25	0	0
1	23072304	.	G	T	15	8	23	0	1	24	0	0
1	23072461	.	G	A	8	13	21	0	1	22	0	0
1	23072533	.	G	A	15	9	24	0	0	24	0	0
1	23072683	.	T	C	11	0	11	0	15	26	0	0
1	23072746	.	T	A	10	10	20	0	0	20	0	0
1	23094638	.	C	T	13	15	28	0	4	32	0	0
1	23094677	.	G	A	14	18	32	0	1	33	0	0
1	23110816	.	T	C	13	9	22	0	0	22	0	0
1	23188523	.	T	A	1	3	4	0	0	4	0	0
1	23212203	.	G	A	1	1	2	0	1	3	0	0
1	23251104	.	C	T	5	7	12	0	0	12	0	0
1	23251338	.	T	C	4	3	7	0	0	7	0	0
1	23254712	.	G	A	2	3	5	0	0	5	0	0
1	23258049	.	C	T	3	3	6	0	2	8	0	0
1	23259276	.	T	C	5	3	8	0	0	8	0	0
1	23261829	.	C	T	0	4	4	0	5	9	0	0
1	23261838	.	A	G	6	4	10	0	0	10	0	0
1	23265590	.	C	T	2	4	6	0	1	7	0	0
1	23265710	.	C	A	4	3	7	0	0	7	0	0
1	23265711	.	C	T	0	3	3	0	4	7	0	0
1	23267414	.	G	A	1	4	5	0	0	5	0	0
1	23267433	.	T	G	1	4	5	0	0	5	0	0
1	23267612	.	G	T	5	2	7	0	0	7	0	0
1	23268471	.	G	A	2	6	8	0	0	8	0	0
1	23270968	.	A	C	1	3	4	0	0	4	0	0
1	23271013	.	G	T	2	3	5	0	0	5	0	0
1	23271345	.	G	A	29	39	68	0	0	68	0	0
1	23271500	.	G	A	28	38	66	0	3	69	0	0
1	23271608	.	G	A	39	28	67	0	5	72	0	0
1	23271612	.	T	A	0	3	3	0	1	4	0	0
1	23271770	.	T	G	26	25	51	0	2	53	0	0
1	23274345	.	T	C	2	2	4	0	0	4	0	0
1	23274820	.	G	A	12	14	26	0	1	27	0	0
1	23275228	.	C	G	14	9	23	0	0	23	0	0
1	23277619	.	A	G	13	1	14	0	15	29	0	0
1	23283819	.	G	A	2	2	4	0	1	5	0	0
1	23283864	.	G	A	4	3	7	0	0	7	0	0
1	23283878	.	C	T	4	3	7	0	0	7	0	0
1	23287163	.	T	C	4	4	8	0	0	8	0	0
1	23294478	.	C	A	1	2	3	0	0	3	0	0
1	23298043	.	T	C	2	2	4	0	0	4	0	0
1	23298642	.	A	T	2	7	9	0	0	9	0	0
1	23298892	.	A	G	5	6	11	0	0	11	0	0
1	23298921	.	G	A	6	4	10	0	0	10	0	0
1	23301687	.	A	T	3	7	10	0	0	10	0	0
1	23301873	.	G	T	6	4	10	0	0	10	0	0
1	23308208	.	A	C	5	4	9	0	0	9	0	0
1	23311750	.	G	A	3	4	7	0	0	7	0	0
1	23311756	.	T	A	4	3	7	0	0	7	0	0
1	23311908	.	C	A	3	6	9	0	1	10	0	0
1	23323181	.	G	C	1	2	3	0	0	3	0	0
1	23323601	.	A	T	0	7	7	0	0	7	0	0
1	23372804	.	G	A	1	3	4	0	0	4	0	0
1	23373384	.	G	C	0	3	3	0	2	5	0	0
1	23377854	.	T	G	2	2	4	0	0	4	0	0
1	23378261	.	A	G	1	3	4	0	0	4	0	0
1	23378263	.	T	C	1	3	4	0	0	4	0	0
1	23388325	.	C	T	2	2	4	0	0	4	0	0
1	23390453	.	C	T	2	3	5	0	0	5	0	0
1	23506660	.	C	A	11	7	18	0	0	18	0	0
1	23506711	.	A	T	6	8	14	0	6	20	0	0
1	23506787	.	A	T	19	10	29	0	0	29	0	0
1	23506865	.	C	A	18	10	28	0	0	28	0	0
1	23508009	.	G	T	20	16	36	0	3	39	0	0
1	23526644	.	T	C	13	17	30	1	4	35	0	0
1	23528066	.	C	T	12	8	20	0	0	20	0	0
1	23530438	.	C	T	15	9	24	0	0	24	0	0
1	23535880	.	C	T	0	12	12	0	11	23	0	0
1	23536012	.	T	C	9	11	20	0	0	20	0	0
1	23536222	.	T	A	12	12	24	0	0	24	0	0
1	23573582	.	C	T	10	5	15	5	1	21	0	0
1	23573823	.	A	T	9	8	17	0	0	17	0	0
1	23574977	.	C	T	0	4	4	0	2	6	0	0
1	23578362	.	C	G	0	4	4	0	4	8	0	0
1	23578839	.	A	C	3	2	5	0	0	5	0	0
1	23579714	.	C	T	0	2	2	0	3	5	0	0
1	23579819	.	C	G	3	2	5	0	0	5	0	0
1	23579980	.	G	T	2	3	5	0	0	5	0	0
1	23580196	.	G	A	5	3	8	0	0	8	0	0
1	23580554	.	T	C	4	2	6	0	0	6	0	0
1	23580681	.	C	T	1	3	4	0	0	4	0	0
1	23581960	.	T	G	5	3	8	0	0	8	0	0
1	23582189	.	G	T	1	5	6	0	0	6	0	0
1	23585275	.	C	T	5	3	8	0	0	8	0	0
1	23585338	.	G	A	1	2	3	0	0	3	0	0
1	23585802	.	C	A	0	4	4	1	4	9	0	0
1	23586025	.	C	T	0	5	5	0	3	8	0	0
1	23586133	.	A	G	7	5	12	0	1	13	0	0
1	23586581	.	G	A	7	6	13	0	0	13	0	0
1	23586780	.	C	T	0	5	5	0	6	11	0	0
1	23873516	.	T	C	3	4	7	0	0	7	0	0
1	23874044	.	T	C	3	2	5	0	0	5	0	0
1	23889648	.	A	G	4	6	10	0	0	10	0	0
1	23909090	.	A	G	13	13	26	0	2	28	0	0
1	23909748	.	A	T	9	5	14	0	0	14	0	0
1	23920983	.	C	T	1	7	8	0	10	18	0	0
1	23921071	.	A	T	11	6	17	0	1	18	0	0
1	23921284	.	T	C	8	15	23	0	0	23	0	0
1	23921302	.	C	A	13	9	22	0	0	22	0	0
1	23921564	.	T	A	3	7	10	0	0	10	0	0
1	23921793	.	A	C	3	2	5	0	2	7	0	0
1	23936154	.	C	T	7	7	14	0	0	14	0	0
1	23943726	.	G	A	6	7	13	0	1	14	0	0
1	23945132	.	T	A	3	3	6	0	0	6	0	0
1	23947833	.	A	C	5	0	5	0	4	9	0	0
1	23947881	.	T	A	2	6	8	0	0	8	0	0
1	24045920	.	G	T	4	3	7	0	1	8	0	0
1	24076890	.	A	G	9	15	24	0	0	24	0	0
1	24077274	.	A	G	11	0	11	0	17	28	0	0
1	24077791	.	G	A	1	19	20	0	8	28	0	0
1	24077902	.	A	G	1	6	7	0	0	7	0	0
1	24079262	.	A	T	1	4	5	0	1	6	0	0
1	24092454	.	G	A	2	2	4	0	0	4	0	0
1	24157228	.	A	C	2	2	4	0	0	4	0	0
1	24163638	.	G	A	3	2	5	0	0	5	0	0
1	24213106	.	G	A	4	3	7	0	1	8	0	0
1	24213284	.	C	T	2	2	4	0	0	4	0	0
1	24228199	.	T	C	1	6	7	0	0	7	0	0
1	24263635	.	A	T	4	3	7	0	0	7	0	0
1	24357931	.	C	T	37	32	69	0	2	71	0	0
1	24501314	.	C	G	1	3	4	0	0	4	0	0
1	24520759	.	T	C	2	3	5	0	0	5	0	0
1	24523415	.	T	C	3	2	5	0	0	5	0	0
1	24540619	.	C	T	4	3	7	0	0	7	0	0
1	24540785	.	A	G	5	5	10	0	1	11	0	0
1	24540959	.	A	G	4	7	11	0	0	11	0	0
1	24557100	.	A	G	2	3	5	0	0	5	0	0
1	24557510	.	G	A	8	6	14	0	2	16	0	0
1	24871075	.	A	G	10	11	21	0	0	21	0	0
1	24871079	.	A	G	10	10	20	0	2	22	0	0
1	24879994	.	C	T	13	8	21	0	0	21	0	0
1	24902745	.	T	C	9	0	9	1	9	19	0	0
1	24908001	.	T	C	12	1	13	0	7	20	0	0
1	25143988	.	G	T	1	2	3	0	0	3	0	0
1	25144330	.	A	C	3	4	7	0	0	7	0	0
1	25181244	.	C	T	1	2	3	0	0	3	0	0
1	25216208	.	C	T	2	2	4	0	0	4	0	0
1	25281601	.	A	C	9	3	12	0	0	12	0	0
1	25296797	.	C	T	6	12	18	0	0	18	0	0
1	25296831	.	C	T	9	9	18	0	1	19	0	0
1	25305290	.	A	T	8	13	21	0	1	22	0	0
1	25305446	.	T	G	14	0	14	0	10	24	0	0
1	25310899	.	C	A	8	8	16	0	0	16	0	0
1	25310912	.	T	A	8	7	15	0	1	16	0	0
1	25313056	.	C	T	19	6	25	0	0	25	0	0
1	25313261	.	T	C	11	11	22	0	1	23	0	0
1	25313300	.	G	A	4	13	17	0	17	34	0	0
1	25322704	.	T	A	2	3	5	0	1	6	0	0
1	25322892	.	G	A	2	3	5	0	0	5	0	0
1	25322961	.	A	G	3	3	6	0	0	6	0	0
1	25322982	.	G	A	3	3	6	0	1	7	0	0
1	25327222	.	G	A	4	3	7	0	0	7	0	0
1	25340218	.	G	C	4	4	8	0	0	8	0	0
1	25340311	.	G	A	4	6	10	0	1	11	0	0
1	25399574	.	G	A	5	4	9	0	0	9	0	0
1	25399634	.	G	A	6	3	9	0	0	9	0	0
1	25400247	.	C	T	1	5	6	0	0	6	0	0
1	25400814	.	T	A	3	3	6	0	0	6	0	0
1	25400842	.	A	T	5	3	8	0	0	8	0	0
1	25400873	.	G	A	2	3	5	0	1	6	0	0
1	25401158	.	T	C	2	0	2	0	4	6	0	0
1	25401362	.	T	C	6	0	6	0	3	9	0	0
1	25402203	.	C	T	1	6	7	0	3	10	0	0
1	25402229	.	T	C	1	9	10	0	0	10	0	0
1	25403244	.	G	C	7	3	10	0	0	10	0	0
1	25419775	.	G	A	1	2	3	0	1	4	0	0
1	25419911	.	T	G	8	5	13	0	0	13	0	0
1	25419936	.	A	G	10	5	15	0	1	16	0	0
1	25419962	.	G	A	7	7	14	0	1	15	0	0
1	25419973	.	T	G	7	8	15	0	1	16	0	0
1	25438705	.	G	A	2	2	4	0	1	5	0	0
1	25626739	.	G	C	2	3	5	0	0	5	0	0
1	25654976	.	C	T	4	12	16	0	0	16	0	0
1	25660719	.	C	T	4	4	8	0	1	9	0	0
1	25738158	.	T	A	2	2	4	0	0	4	0	0
1	25741901	.	A	G	1	2	3	0	0	3	0	0
1	25742951	.	C	T	2	2	4	0	0	4	0	0
1	25798863	.	G	C	8	12	20	0	0	20	0	0
1	25798983	.	A	C	4	2	6	0	0	6	0	0
1	25811411	.	T	C	18	7	25	0	1	26	0	0
1	25812658	.	C	T	6	13	19	0	0	19	0	0
1	25863511	.	G	A	10	10	20	0	1	21	0	0
1	25863638	.	A	T	6	8	14	0	2	16	0	0
1	25918405	.	C	T	4	5	9	0	0	9	0	0
1	26044934	.	G	T	3	4	7	0	0	7	0	0
1	26046323	.	A	G	5	4	9	0	0	9	0	0
1	26046950	.	T	A	10	15	25	0	0	25	0	0
1	26046996	.	A	T	8	13	21	0	1	22	0	0
1	26063007	.	G	T	12	6	18	0	2	20	0	0
1	26063030	.	G	A	14	4	18	0	0	18	0	0
1	26096055	.	T	A	3	3	6	0	0	6	0	0
1	26096270	.	C	T	1	3	4	0	0	4	0	0
1	26096522	.	G	T	7	7	14	0	0	14	0	0
1	26108487	.	C	T	2	3	5	0	0	5	0	0
1	26109464	.	T	C	2	2	4	0	0	4	0	0
1	26109479	.	T	C	2	3	5	0	0	5	0	0
1	26127339	.	A	G	10	10	20	0	1	21	0	0
1	26127856	.	A	T	13	7	20	0	1	21	0	0
1	26252033	.	C	T	0	2	2	0	3	5	0	0
1	26252308	.	G	C	4	3	7	0	0	7	0	0
1	26252323	.	A	T	3	4	7	0	1	8	0	0
1	26252754	.	T	C	4	2	6	0	0	6	0	0
1	26252814	.	C	T	3	4	7	0	0	7	0	0
1	26252931	.	A	T	6	5	11	0	0	11	0	0
1	26375218	.	C	T	11	5	16	0	1	17	0	0
1	26375404	.	C	A	4	6	10	0	0	10	0	0
1	26376176	.	G	A	7	9	16	0	0	16	0	0
1	26376327	.	C	T	9	4	13	0	0	13	0	0
1	26376816	.	A	T	11	4	15	0	1	16	0	0
1	26382809	.	A	T	20	7	27	0	1	28	0	0
1	26383281	.	G	T	1	12	13	0	7	20	0	0
1	26383466	.	G	A	6	4	10	0	0	10	0	0
1	26384629	.	C	T	4	7	11	0	0	11	0	0
1	26384638	.	G	A	4	6	10	0	1	11	0	0
1	26384682	.	G	A	2	6	8	0	0	8	0	0
1	26384721	.	A	G	2	6	8	0	0	8	0	0
1	26384774	.	C	T	4	3	7	0	0	7	0	0
1	26384779	.	C	A	4	3	7	0	0	7	0	0
1	26384892	.	A	G	1	2	3	0	0	3	0	0
1	26385006	.	G	T	3	3	6	0	0	6	0	0
1	26385222	.	C	G	7	7	14	0	1	15	0	0
1	26385939	.	A	G	8	4	12	0	2	14	0	0
1	26391649	.	C	T	0	2	2	0	3	5	0	0
1	26391698	.	A	G	2	2	4	0	0	4	0	0
1	26392422	.	G	A	2	10	12	1	0	13	0	0
1	26394436	.	A	C	6	0	6	0	6	12	0	0
1	26445032	.	C	A	5	14	19	0	0	19	0	0
1	26463488	.	T	G	4	0	4	0	3	7	0	0
1	26463671	.	T	A	8	8	16	0	1	17	0	0
1	26463692	.	C	T	11	10	21	0	0	21	0	0
1	26463779	.	T	A	1	6	7	0	0	7	0	0
1	26463878	.	C	A	5	4	9	0	0	9	0	0
1	26463931	.	A	T	5	6	11	0	0	11	0	0
1	26464175	.	G	A	6	2	8	0	0	8	0	0
1	26464259	.	C	T	2	4	6	0	0	6	0	0
1	26464353	.	A	G	9	8	17	0	1	18	0	0
1	26464446	.	G	A	13	10	23	0	0	23	0	0
1	26464758	.	T	A	14	7	21	0	1	22	0	0
1	26465041	.	G	T	11	9	20	0	0	20	0	0
1	26465047	.	A	C	12	8	20	0	2	22	0	0
1	26465224	.	T	A	15	4	19	0	1	20	0	0
1	26467125	.	T	A	3	11	14	0	1	15	0	0
1	26467243	.	G	A	3	6	9	0	0	9	0	0
1	26473634	.	G	A	9	4	13	0	2	15	0	0
1	26473790	.	C	T	5	8	13	0	0	13	0	0
1	26480970	.	G	C	1	9	10	0	4	14	0	0
1	26489854	.	G	A	8	7	15	0	1	16	0	0
1	26498400	.	C	T	10	14	24	0	0	24	0	0
1	26498657	.	G	A	1	14	15	0	14	29	0	0
1	26504998	.	G	A	11	15	26	0	0	26	0	0
1	26505282	.	T	C	10	19	29	0	1	30	0	0
1	26505291	.	C	T	13	21	34	0	1	35	0	0
1	26507356	.	G	A	8	14	22	0	0	22	0	0
1	26507392	.	T	A	10	8	18	0	0	18	0	0
1	26507582	.	G	A	10	10	20	0	1	21	0	0
1	26507764	.	A	G	12	0	12	0	8	20	0	0
1	26638053	.	G	C	4	2	6	0	0	6	0	0
1	26827519	.	G	A	2	9	11	0	0	11	0	0
1	26881374	.	A	G	2	2	4	0	0	4	0	0
1	27207986	.	A	G	4	0	4	0	6	10	0	0
1	27209628	.	A	C	3	10	13	0	0	13	0	0
1	27209904	.	T	G	5	8	13	0	0	13	0	0
1	27210057	.	T	C	3	3	6	0	1	7	0	0
1	27210073	.	T	C	5	3	8	0	0	8	0	0
1	27210231	.	C	T	4	7	11	0	0	11	0	0
1	27210578	.	G	A	3	4	7	0	0	7	0	0
1	27210929	.	C	T	7	11	18	0	1	19	0	0
1	27809162	.	T	C	7	11	18	0	0	18	0	0
1	27826090	.	C	A	11	6	17	0	1	18	0	0
1	27826198	.	C	T	9	14	23	0	0	23	0	0
1	27826651	.	T	C	15	21	36	0	0	36	0	0
1	27842373	.	G	A	0	15	15	0	15	30	0	0
1	27860743	.	T	A	7	5	12	0	1	13	0	0
1	27893097	.	T	C	9	7	16	0	1	17	0	0
1	27893550	.	T	A	5	3	8	0	0	8	0	0
1	27993191	.	A	G	10	1	11	0	14	25	0	0
1	28018821	.	C	T	15	15	30	0	0	30	0	0
1	28018988	.	T	A	5	6	11	0	0	11	0	0
1	28035590	.	T	C	11	4	15	0	0	15	0	0
1	28035786	.	C	T	7	7	14	0	1	15	0	0
1	28036159	.	A	C	7	7	14	0	0	14	0	0
1	28046218	.	T	C	11	13	24	0	2	26	0	0
1	28046224	.	A	G	10	0	10	0	14	24	0	0
1	28046717	.	T	A	5	2	7	0	1	8	0	0
1	28067976	.	T	A	3	2	5	0	0	5	0	0
1	28391882	.	C	G	11	4	15	0	0	15	0	0
1	28391914	.	C	T	0	3	3	0	10	13	0	0
1	28422569	.	C	T	13	9	22	0	0	22	0	0
1	28724010	.	G	T	4	4	8	0	1	9	0	0
1	28788272	.	G	A	9	4	13	0	0	13	0	0
1	28808541	.	T	C	6	5	11	0	0	11	0	0
1	28809127	.	A	C	6	0	6	0	5	11	0	0
1	28833827	.	A	C	2	2	4	0	0	4	0	0
1	28834209	.	A	T	1	3	4	0	1	5	0	0
1	28834592	.	A	G	1	4	5	0	0	5	0	0
1	28847677	.	C	T	1	10	11	0	12	23	0	0
1	28899350	.	G	A	4	6	10	0	0	10	0	0
1	28899483	.	G	A	2	6	8	0	0	8	0	0
1	28899530	.	T	C	1	4	5	0	0	5	0	0
1	28900661	.	A	G	3	4	7	0	0	7	0	0
1	28965095	.	G	A	27	19	46	0	0	46	0	0
1	28979080	.	A	C	24	0	24	0	18	42	0	0
1	28979161	.	G	C	19	2	21	0	21	42	0	0
1	28986486	.	C	T	25	18	43	0	1	44	0	0
1	29045226	.	G	A	27	20	47	0	1	48	0	0
1	29141070	.	G	A	2	3	5	0	0	5	0	0
1	29162674	.	G	A	1	4	5	0	6	11	0	0
1	29174928	.	G	A	1	2	3	4	0	7	0	0
1	29178897	.	C	T	6	7	13	0	1	14	0	0
1	29201933	.	G	C	12	8	20	1	0	21	0	0
1	29202110	.	T	C	5	7	12	0	2	14	0	0
1	29202368	.	G	A	3	3	6	0	0	6	0	0
1	29202379	.	A	G	2	0	2	0	3	5	0	0
1	29202618	.	G	T	2	3	5	0	0	5	0	0
1	29211619	.	T	A	4	13	17	0	0	17	0	0
1	29211636	.	T	C	18	3	21	0	0	21	0	0
1	29211895	.	T	A	4	8	12	0	0	12	0	0
1	29212165	.	T	C	6	8	14	0	0	14	0	0
1	29213107	.	A	G	3	0	3	0	12	15	0	0
1	29227642	.	T	A	6	8	14	0	0	14	0	0
1	29227770	.	C	T	3	4	7	0	0	7	0	0
1	29227880	.	G	T	5	5	10	0	0	10	0	0
1	29228261	.	A	G	6	0	6	0	5	11	0	0
1	29228390	.	A	T	4	5	9	0	0	9	0	0
1	29268675	.	A	T	1	2	3	0	0	3	0	0
1	29270493	.	G	C	1	2	3	0	1	4	0	0
1	29282145	.	C	T	7	9	16	0	1	17	0	0
1	29282836	.	C	T	6	6	12	0	1	13	0	0
1	29389601	.	C	T	4	7	11	0	0	11	0	0
1	29389975	.	T	C	4	6	10	0	0	10	0	0
1	29389987	.	C	T	7	4	11	0	1	12	0	0
1	29653090	.	C	T	1	2	3	0	1	4	0	0
1	29653338	.	C	A	3	2	5	0	1	6	0	0
1	29664468	.	A	G	4	4	8	0	1	9	0	0
1	29664473	.	C	G	3	5	8	0	0	8	0	0
1	29687175	.	A	C	5	6	11	0	0	11	0	0
1	29718827	.	A	C	6	5	11	0	0	11	0	0
1	29731965	.	T	G	6	12	18	0	0	18	0	0
1	29732217	.	C	T	9	5	14	0	0	14	0	0
1	29732256	.	T	C	2	7	9	0	1	10	0	0
1	29751594	.	T	G	2	4	6	0	0	6	0	0
1	29752319	.	T	C	5	9	14	0	2	16	0	0
1	29752421	.	A	G	7	7	14	0	1	15	0	0
1	29754673	.	A	G	8	11	19	0	1	20	0	0
1	29754963	.	G	A	4	11	15	0	0	15	0	0
1	29754981	.	A	G	4	10	14	0	2	16	0	0
1	29757083	.	G	A	1	4	5	0	0	5	0	0
1	29758042	.	G	A	8	12	20	0	0	20	0	0
1	29770360	.	T	A	11	10	21	0	0	21	0	0
1	29772024	.	T	C	14	10	24	0	0	24	0	0
1	29772391	.	A	G	8	10	18	0	0	18	0	0
1	29772615	.	T	C	12	10	22	0	1	23	0	0
1	29772741	.	C	T	13	16	29	0	0	29	0	0
1	29775664	.	C	A	11	9	20	0	2	22	0	0
1	29779300	.	G	C	12	8	20	0	1	21	0	0
1	29779402	.	G	A	0	14	14	0	8	22	0	0
1	29781462	.	G	A	13	15	28	0	1	29	0	0
1	29781597	.	A	T	8	11	19	0	0	19	0	0
1	29786570	.	G	A	12	8	20	0	1	21	0	0
1	29786659	.	T	G	11	0	11	0	12	23	0	0
1	29786704	.	A	G	15	8	23	0	1	24	0	0
1	29787397	.	G	A	13	6	19	0	1	20	0	0
1	29789889	.	C	T	8	10	18	0	0	18	0	0
1	29790030	.	A	T	8	10	18	0	1	19	0	0
1	29795692	.	G	A	12	18	30	0	0	30	0	0
1	29797191	.	T	C	6	12	18	0	0	18	0	0
1	29797344	.	G	T	13	14	27	0	1	28	0	0
1	29797345	.	A	T	12	13	25	0	2	27	0	0
1	29797387	.	A	C	4	10	14	0	1	16	1	0
1	29797699	.	T	G	3	5	8	0	0	8	0	0
1	29798203	.	A	G	20	7	27	0	0	27	0	0
1	29798262	.	T	C	11	7	18	0	0	18	0	0
1	29798324	.	G	T	0	7	7	0	15	22	0	0
1	29798340	.	G	A	1	6	7	0	19	26	0	0
1	29804658	.	A	T	11	7	18	0	3	21	0	0
1	29804682	.	A	G	11	10	21	0	0	21	0	0
1	29805251	.	C	T	16	14	30	0	0	30	0	0
1	29806547	.	C	T	15	19	34	0	0	34	0	0
1	29813246	.	C	A	18	15	33	0	1	34	0	0
1	29813276	.	C	T	15	20	35	0	0	35	0	0
1	29817451	.	C	A	23	12	35	0	4	39	0	0
1	29820831	.	C	T	23	19	42	0	1	43	0	0
1	29823603	.	T	C	11	17	28	0	0	28	0	0
1	29823690	.	T	A	27	14	41	0	1	43	1	0
1	29823701	.	A	G	21	15	36	0	5	41	0	0
1	29858258	.	A	T	3	2	5	0	0	5	0	0
1	29860326	.	T	A	4	3	7	0	0	7	0	0
1	29862155	.	A	C	9	7	16	0	0	16	0	0
1	29872653	.	T	G	4	0	4	0	11	15	0	0
1	29891910	.	C	A	4	5	9	0	0	9	0	0
1	29891937	.	C	T	2	2	4	0	0	4	0	0
1	29896769	.	A	C	4	6	10	0	0	10	0	0
1	29900692	.	G	A	5	5	10	0	0	10	0	0
1	29900931	.	A	G	4	0	4	0	5	9	0	0
1	29908013	.	A	G	6	4	10	0	0	10	0	0
1	29909502	.	C	T	2	6	8	0	1	9	0	0
1	29916178	.	G	A	9	9	18	0	0	18	0	0
1	29952918	.	A	T	3	2	5	0	0	5	0	0
1	29953239	.	G	T	1	4	5	0	12	17	0	0
1	29953433	.	A	T	6	4	10	0	0	10	0	0
1	29953616	.	A	T	2	3	5	0	0	5	0	0
1	29954795	.	A	C	6	7	13	0	0	13	0	0
1	29954844	.	T	C	6	11	17	0	0	17	0	0
1	29954972	.	C	T	8	11	19	0	1	20	0	0
1	29955006	.	G	A	10	6	16	0	1	17	0	0
1	29955171	.	G	A	11	11	22	0	0	22	0	0
1	29955179	.	A	G	11	13	24	0	1	25	0	0
1	29955228	.	C	T	11	10	21	0	0	21	0	0
1	29955249	.	A	G	8	10	18	0	0	18	0	0
1	30038844	.	A	C	11	7	18	0	1	19	0	0
1	30039302	.	T	A	6	2	8	0	0	8	0	0
1	30103483	.	C	A	6	6	12	0	0	12	0	0
1	30118166	.	C	T	5	7	12	0	0	12	0	0
1	30180924	.	G	A	10	3	13	0	1	14	0	0
1	30180929	.	T	A	10	3	13	0	0	13	0	0
1	30183309	.	C	G	5	5	10	0	0	10	0	0
1	30212461	.	G	A	11	6	17	0	2	19	0	0
1	30212793	.	G	A	5	7	12	0	0	12	0	0
1	30250557	.	T	C	6	10	16	0	1	17	0	0
1	30255365	.	G	A	12	7	19	0	1	20	0	0
1	30255458	.	A	C	10	14	24	0	1	25	0	0
1	30270683	.	T	C	9	7	16	1	1	18	0	0
1	30282841	.	G	T	8	5	13	0	0	13	0	0
1	30343967	.	T	G	9	11	20	0	0	20	0	0
1	30344842	.	A	G	9	4	13	0	0	13	0	0
1	30345026	.	T	C	6	9	15	0	1	16	0	0
1	30345029	.	C	T	7	10	17	0	0	17	0	0
1	30345075	.	G	T	10	6	16	0	1	17	0	0
1	30345131	.	C	T	0	6	6	0	9	15	0	0
1	30345239	.	G	C	2	2	4	0	0	4	0	0
1	30345243	.	T	C	3	1	4	0	1	5	0	0
1	30345465	.	T	G	1	2	3	0	0	3	0	0
1	30345485	.	A	C	1	2	3	0	0	3	0	0
1	30345635	.	T	G	4	9	13	0	1	14	0	0
1	30345669	.	T	G	14	8	22	0	0	22	0	0
1	30346042	.	G	A	13	8	21	0	0	21	0	0
1	30346112	.	T	C	10	6	16	0	0	16	0	0
1	30346124	.	T	A	9	4	13	0	0	13	0	0
1	30346233	.	G	A	6	6	12	0	0	12	0	0
1	30346377	.	G	A	11	5	16	1	1	18	0	0
1	30346385	.	G	A	6	9	15	1	1	17	0	0
1	30346432	.	T	G	6	4	10	0	0	10	0	0
1	30346456	.	G	A	6	4	10	0	0	10	0	0
1	30346845	.	G	T	8	9	17	0	0	17	0	0
1	30346906	.	C	A	6	9	15	0	0	15	0	0
1	30346977	.	C	A	11	10	21	0	0	21	0	0
1	30347027	.	C	A	12	12	24	0	0	24	0	0
1	30347043	.	T	C	12	0	12	0	12	24	0	0
1	30347586	.	C	T	14	4	18	0	0	18	0	0
1	30366800	.	T	A	11	9	20	0	1	21	0	0
1	30439970	.	C	T	1	2	3	0	0	3	0	0
1	30441057	.	G	A	6	3	9	0	0	9	0	0
1	30453617	.	A	G	5	2	7	0	0	7	0	0
1	30540065	.	G	A	1	3	4	0	0	4	0	0
1	30540535	.	C	T	4	6	10	0	0	10	0	0
1	30557628	.	G	T	3	5	8	0	0	8	0	0
1	30568183	.	C	T	1	2	3	0	1	4	0	0
1	30585537	.	T	C	5	3	8	0	1	9	0	0
1	30585552	.	G	T	8	4	12	0	0	12	0	0
1	30589258	.	C	A	14	7	21	0	2	23	0	0
1	30641038	.	T	C	5	5	10	0	0	10	0	0
1	30641077	.	C	A	0	5	5	0	3	8	0	0
1	30688453	.	G	A	6	3	9	0	0	9	0	0
1	30688606	.	C	T	2	3	5	0	4	9	0	0
1	30688802	.	G	A	8	3	11	0	0	11	0	0
1	30688901	.	G	A	5	8	13	0	1	14	0	0
1	30688924	.	G	T	9	2	11	0	0	11	0	0
1	30718394	.	T	C	2	0	2	0	5	7	0	0
1	30718538	.	C	G	10	13	23	0	0	23	0	0
1	30718567	.	A	C	8	0	8	0	15	23	0	0
1	30955972	.	C	A	5	2	7	0	0	7	0	0
1	31036587	.	G	T	2	3	5	0	0	5	0	0
1	31060005	.	C	A	1	3	4	0	1	5	0	0
1	31063923	.	T	C	2	6	8	0	0	8	0	0
1	31063928	.	G	A	2	5	7	0	1	8	0	0
1	31064519	.	G	A	1	4	5	0	0	5	0	0
1	31072589	.	C	T	4	2	6	0	0	6	0	0
1	31072604	.	A	C	2	2	4	0	0	4	0	0
1	31072863	.	A	G	3	3	6	0	0	6	0	0
1	31075158	.	C	T	1	7	8	0	8	16	0	0
1	31079822	.	C	T	4	2	6	0	0	6	0	0
1	31083169	.	C	T	0	6	6	0	4	10	0	0
1	31083271	.	G	A	4	8	12	0	1	13	0	0
1	31085882	.	C	T	7	4	11	0	0	11	0	0
1	31088744	.	C	T	2	4	6	0	0	6	0	0
1	31090873	.	G	A	4	7	11	0	1	12	0	0
1	31091120	.	A	G	2	2	4	0	1	5	0	0
1	31091313	.	T	C	2	4	6	0	0	6	0	0
1	31091473	.	C	T	4	4	8	0	0	8	0	0
1	31091616	.	C	T	6	4	10	0	0	10	0	0
1	31091995	.	T	A	3	4	7	0	0	7	0	0
1	31102857	.	G	A	1	6	7	0	0	7	0	0
1	31102986	.	C	T	6	3	9	0	1	10	0	0
1	31103311	.	A	G	2	5	7	0	0	7	0	0
1	31103427	.	C	A	0	2	2	0	1	3	0	0
1	31104012	.	G	C	4	0	4	0	3	7	0	0
1	31104069	.	T	C	4	4	8	0	0	8	0	0
1	31112466	.	G	C	6	13	19	0	0	19	0	0
1	31112468	.	G	A	7	12	19	0	1	20	0	0
1	31117686	.	G	A	29	20	49	0	4	53	0	0
1	31117695	.	T	C	27	25	52	0	4	56	0	0
1	31119296	.	C	T	28	26	54	0	2	56	0	0
1	31122596	.	G	A	30	27	57	0	3	60	0	0
1	31130005	.	T	C	27	16	43	0	1	44	0	0
1	31130028	.	T	C	26	15	41	0	1	42	0	0
1	31130094	.	G	A	5	20	25	0	19	44	0	0
1	31130176	.	T	C	4	8	12	0	1	13	0	0
1	31135604	.	T	A	1	2	3	0	1	4	0	0
1	31136477	.	A	G	8	7	15	0	0	15	0	0
1	31146286	.	G	A	1	2	3	0	0	3	0	0
1	31349556	.	G	A	1	2	3	0	0	3	0	0
1	31349728	.	G	A	2	4	6	0	0	6	0	0
1	31374780	.	A	T	18	13	31	0	0	31	0	0
1	31386255	.	T	C	11	18	29	0	0	30	1	0
1	31423014	.	C	T	2	20	22	0	15	37	0	0
1	31423099	.	G	T	24	15	39	0	2	41	0	0
1	31428150	.	G	A	15	7	22	0	2	24	0	0
1	31430665	.	A	G	6	12	18	0	0	18	0	0
1	31445770	.	A	G	8	9	17	0	1	18	0	0
1	31445874	.	T	A	8	10	18	0	2	20	0	0
1	31472033	.	A	G	6	12	18	0	2	20	0	0
1	31657604	.	T	C	12	7	19	0	1	20	0	0
1	31660214	.	T	G	6	0	6	0	5	11	0	0
1	31660952	.	A	G	2	0	2	0	7	9	0	0
1	31661165	.	T	C	3	2	5	0	0	5	0	0
1	31664892	.	C	T	5	7	12	0	0	12	0	0
1	31667491	.	C	T	4	3	7	0	0	7	0	0
1	31671721	.	C	T	6	2	8	0	1	9	0	0
1	31671746	.	C	A	5	6	11	0	0	11	0	0
1	31671958	.	G	A	0	8	8	0	6	14	0	0
1	31690131	.	G	A	1	4	5	0	0	5	0	0
1	31709574	.	A	G	2	2	4	0	0	4	0	0
1	31793920	.	A	G	5	0	5	1	4	10	0	0
1	31793998	.	A	G	3	6	9	2	0	11	0	0
1	31797459	.	G	A	3	8	11	0	0	11	0	0
1	31797503	.	G	A	1	3	4	0	3	7	0	0
1	31797597	.	G	A	4	4	8	0	0	8	0	0
1	31798794	.	T	C	1	3	4	0	0	4	0	0
1	31798821	.	C	T	2	5	7	0	0	7	0	0
1	31809302	.	G	A	3	6	9	0	0	9	0	0
1	31809332	.	G	A	8	6	14	0	0	14	0	0
1	31809496	.	G	A	11	7	18	0	0	18	0	0
1	31813229	.	A	G	8	8	16	0	0	16	0	0
1	31813283	.	A	G	11	11	22	0	1	23	0	0
1	31818237	.	G	A	8	5	13	0	0	13	0	0
1	31856632	.	A	G	6	7	13	0	1	14	0	0
1	31865172	.	G	A	4	6	10	0	3	13	0	0
1	31865387	.	G	A	14	11	25	0	1	26	0	0
1	31866684	.	G	A	11	10	21	0	1	22	0	0
1	31867264	.	T	A	17	10	27	0	2	29	0	0
1	31867314	.	C	T	18	8	26	0	0	26	0	0
1	31867449	.	C	T	17	13	30	0	0	30	0	0
1	31867589	.	G	A	6	5	11	0	0	11	0	0
1	31943042	.	T	G	17	0	17	0	9	26	0	0
1	32385347	.	T	C	5	2	7	0	0	7	0	0
1	33281948	.	A	G	2	5	7	0	0	7	0	0
1	33327900	.	C	T	1	2	3	0	0	3	0	0
1	33328378	.	T	C	1	3	4	0	0	4	0	0
1	33331648	.	C	T	1	3	4	0	0	4	0	0
1	33355834	.	T	G	2	2	4	0	0	4	0	0
1	33356259	.	A	T	4	3	7	0	0	7	0	0
1	33356268	.	G	A	2	2	4	0	2	6	0	0
1	33356398	.	T	C	2	3	5	0	0	5	0	0
1	33356430	.	A	G	5	4	9	0	0	9	0	0
1	33374063	.	C	G	5	6	11	0	1	12	0	0
1	33375913	.	C	T	7	2	9	0	0	9	0	0
1	33376141	.	T	C	8	5	13	0	0	13	0	0
1	33376142	.	T	A	8	5	13	0	0	13	0	0
1	33384062	.	G	A	13	10	23	0	4	27	0	0
1	33449334	.	C	A	9	9	18	0	1	19	0	0
1	33457733	.	C	T	12	12	24	0	0	24	0	0
1	33484129	.	C	G	11	10	21	0	1	22	0	0
1	33484288	.	T	C	13	9	22	0	1	23	0	0
1	33484293	.	C	A	13	8	21	0	1	22	0	0
1	33484404	.	C	T	11	7	18	0	0	18	0	0
1	33484652	.	T	C	18	15	33	0	1	34	0	0
1	33485692	.	A	G	8	0	8	0	13	21	0	0
1	33548262	.	A	T	1	2	3	1	1	5	0	0
1	33556056	.	G	A	6	10	16	0	0	16	0	0
1	33561520	.	A	G	10	0	10	0	13	23	0	0
1	33561544	.	C	T	11	12	23	0	0	23	0	0
1	33568153	.	A	T	14	11	25	0	0	25	0	0
1	33568211	.	A	G	7	0	7	0	6	13	0	0
1	33568260	.	A	C	5	5	10	0	0	10	0	0
1	33568266	.	G	A	5	4	9	0	0	9	0	0
1	33568303	.	G	A	0	4	4	0	9	13	0	0
1	33568454	.	G	T	8	11	19	0	0	19	0	0
1	33568520	.	G	A	10	6	16	0	2	18	0	0
1	33568836	.	T	G	0	13	13	0	0	13	0	0
1	33568976	.	G	T	0	13	13	0	10	23	0	0
1	33569143	.	G	A	3	3	6	0	0	6	0	0
1	33634326	.	C	T	2	2	4	0	0	4	0	0
1	33634356	.	C	T	2	3	5	0	1	6	0	0
1	33634380	.	G	T	2	3	5	0	0	5	0	0
1	33654170	.	G	A	4	6	10	0	0	10	0	0
1	33655585	.	C	T	6	2	8	0	0	8	0	0
1	33656317	.	A	T	7	3	10	0	2	12	0	0
1	33656560	.	C	G	1	6	7	0	1	8	0	0
1	33656831	.	G	A	4	8	12	0	0	12	0	0
1	33656900	.	T	G	2	5	7	0	0	7	0	0
1	33657793	.	A	G	2	2	4	0	1	5	0	0
1	33657904	.	G	A	2	7	9	0	11	20	0	0
1	33658030	.	G	A	0	7	7	0	4	11	0	0
1	33658065	.	T	G	8	6	14	0	0	14	0	0
1	33658852	.	C	A	2	8	10	0	0	10	0	0
1	33658945	.	C	T	5	5	10	0	1	11	0	0
1	33658971	.	C	T	7	5	12	0	0	12	0	0
1	33659374	.	C	T	1	4	5	0	0	5	0	0
1	33686477	.	G	A	9	9	18	0	0	18	0	0
1	33686513	.	G	T	8	8	16	0	1	17	0	0
1	33687177	.	A	T	5	12	17	0	1	18	0	0
1	33693919	.	C	A	4	3	7	0	0	7	0	0
1	33694165	.	A	T	5	8	13	0	0	14	1	0
1	33694198	.	T	A	7	6	13	0	0	13	0	0
1	33694327	.	C	T	5	5	10	0	0	10	0	0
1	33694357	.	T	A	3	8	11	0	0	11	0	0
1	33694517	.	T	A	4	2	6	0	0	6	0	0
1	33698327	.	C	A	2	2	4	0	0	4	0	0
1	33701368	.	C	T	6	2	8	0	0	8	0	0
1	33701445	.	C	T	2	2	4	0	0	4	0	0
1	33722341	.	T	G	1	2	3	0	0	3	0	0
1	33969170	.	C	G	14	8	22	0	1	23	0	0
1	33969389	.	A	T	5	4	9	0	0	9	0	0
1	34043394	.	T	C	8	10	18	0	1	19	0	0
1	34134691	.	G	A	1	14	15	0	17	32	0	0
1	34137711	.	T	C	7	13	20	0	0	20	0	0
1	34137741	.	T	C	4	9	13	0	0	13	0	0
1	34137768	.	A	C	8	11	19	0	1	20	0	0
1	34176504	.	C	T	9	7	16	0	2	18	0	0
1	34176808	.	A	T	8	11	19	0	1	20	0	0
1	34182333	.	C	T	13	17	30	0	1	31	0	0
1	34199906	.	G	T	15	22	37	0	0	37	0	0
1	34199913	.	C	T	13	27	40	0	0	40	0	0
1	34232407	.	A	G	5	6	11	0	0	11	0	0
1	34232514	.	G	A	7	8	15	0	0	15	0	0
1	34232551	.	A	C	9	8	17	0	0	17	0	0
1	34232744	.	T	A	10	15	25	0	0	25	0	0
1	34232761	.	A	G	8	15	23	0	2	25	0	0
1	34232879	.	T	C	14	13	27	0	1	28	0	0
1	34232929	.	C	T	6	7	13	0	1	14	0	0
1	34232931	.	G	A	9	6	15	0	1	16	0	0
1	34233096	.	C	A	16	4	20	0	0	20	0	0
1	34233145	.	G	T	13	7	20	0	0	20	0	0
1	34233198	.	C	A	5	8	13	0	1	14	0	0
1	34233238	.	A	G	6	3	9	0	1	10	0	0
1	34233301	.	A	G	10	0	10	0	6	16	0	0
1	34233312	.	A	G	13	4	17	0	2	19	0	0
1	34243700	.	G	A	0	7	7	0	5	12	0	0
1	34243701	.	T	A	7	5	12	0	0	12	0	0
1	34245018	.	T	C	4	4	8	0	0	8	0	0
1	34251744	.	C	T	1	5	6	0	0	6	0	0
1	34258077	.	C	A	2	8	10	0	2	12	0	0
1	34258971	.	C	T	5	3	8	0	0	8	0	0
1	34259098	.	C	A	4	2	6	0	1	7	0	0
1	34259411	.	A	T	5	4	9	0	0	9	0	0
1	34259452	.	T	A	8	6	14	0	2	16	0	0
1	34259863	.	T	G	7	8	15	1	0	16	0	0
1	34260100	.	C	T	1	2	3	0	0	3	0	0
1	34260583	.	G	T	3	2	5	0	0	5	0	0
1	34260853	.	T	A	5	8	13	0	0	13	0	0
1	34260887	.	A	T	4	8	12	0	0	12	0	0
1	34261025	.	A	C	13	4	17	0	0	17	0	0
1	34261030	.	G	A	13	4	17	0	0	17	0	0
1	34261230	.	A	T	12	8	20	0	0	20	0	0
1	34261358	.	A	G	13	0	13	0	13	26	0	0
1	34261393	.	G	A	1	11	12	2	11	25	0	0
1	34261654	.	T	C	4	4	8	0	0	8	0	0
1	34296606	.	A	T	16	17	33	0	2	35	0	0
1	34297112	.	C	A	8	14	22	0	0	22	0	0
1	34297135	.	C	T	13	8	21	0	3	24	0	0
1	34540552	.	C	G	4	0	4	0	6	10	0	0
1	34540564	.	G	A	0	7	7	0	6	13	0	0
1	34540606	.	G	A	7	4	11	0	1	12	0	0
1	34540639	.	A	G	4	4	8	0	0	8	0	0
1	34540714	.	G	A	0	3	3	0	5	8	0	0
1	34540750	.	G	T	3	2	5	0	0	5	0	0
1	34555559	.	C	T	4	5	9	0	0	9	0	0
1	34556148	.	T	A	3	4	7	0	0	7	0	0
1	34556241	.	A	C	5	4	9	0	0	9	0	0
1	34607543	.	C	T	1	2	3	0	0	3	0	0
1	34679431	.	A	G	2	3	5	0	0	5	0	0
1	34683238	.	T	G	2	3	5	0	0	5	0	0
1	34684962	.	G	A	2	3	5	0	0	5	0	0
1	34685529	.	C	G	11	3	14	0	0	14	0	0
1	34688988	.	C	T	7	2	9	0	0	9	0	0
1	34689001	.	T	C	10	4	14	0	0	14	0	0
1	34693831	.	C	T	12	6	18	0	0	18	0	0
1	34695423	.	G	A	17	13	30	0	0	30	0	0
1	34695476	.	G	A	16	19	35	0	0	35	0	0
1	34696017	.	G	A	12	8	20	0	0	20	0	0
1	34703048	.	T	A	11	9	20	0	0	20	0	0
1	34703272	.	A	G	8	13	21	0	2	23	0	0
1	34706526	.	G	A	12	3	15	0	0	15	0	0
1	34707958	.	T	C	10	6	16	1	1	18	0	0
1	34708145	.	C	T	4	18	22	0	29	51	0	0
1	34712097	.	A	G	35	26	61	0	5	66	0	0
1	34806975	.	A	T	4	2	6	0	0	6	0	0
1	35212086	.	A	G	4	4	8	1	0	9	0	0
1	35232521	.	A	C	3	3	6	0	0	6	0	0
1	35232834	.	C	A	5	3	8	0	0	8	0	0
1	35475728	.	G	A	2	4	6	0	0	6	0	0
1	35475879	.	G	A	1	5	6	0	0	6	0	0
1	35476056	.	A	G	3	0	3	0	5	8	0	0
1	35476118	.	G	T	4	3	7	0	0	7	0	0
1	35479501	.	A	G	2	0	2	0	3	5	0	0
1	35481777	.	G	A	4	3	7	0	0	7	0	0
1	35482482	.	G	A	2	5	7	1	2	10	0	0
1	35482485	.	C	T	2	5	7	1	0	8	0	0
1	35484358	.	C	T	8	7	15	0	0	15	0	0
1	35484931	.	T	C	3	3	6	0	1	7	0	0
1	35484977	.	A	T	4	4	8	0	1	9	0	0
1	35485056	.	G	A	11	6	17	0	0	17	0	0
1	35485105	.	G	A	0	9	9	0	7	16	0	0
1	35485175	.	A	C	5	4	9	0	0	9	0	0
1	35485263	.	C	A	3	5	8	0	0	8	0	0
1	35485289	.	C	T	5	2	7	0	0	7	0	0
1	35485378	.	C	T	8	9	17	0	0	17	0	0
1	35488211	.	A	T	6	2	8	0	0	8	0	0
1	35586563	.	C	T	2	6	8	0	1	9	0	0
1	35586579	.	C	A	2	5	7	0	2	9	0	0
1	35597542	.	A	G	5	6	11	0	0	11	0	0
1	35607830	.	G	A	5	5	10	0	1	11	0	0
1	35608041	.	G	A	1	7	8	0	13	21	0	0
1	35608308	.	C	T	4	3	7	0	1	8	0	0
1	35608405	.	G	A	2	4	6	0	2	8	0	0
1	35608619	.	T	C	3	2	5	0	0	5	0	0
1	35608821	.	G	A	5	4	9	0	0	9	0	0
1	35608826	.	G	T	4	4	8	0	1	9	0	0
1	35609431	.	T	C	5	2	7	0	0	7	0	0
1	35609474	.	G	A	3	6	9	0	0	9	0	0
1	35791037	.	C	T	1	2	3	0	0	3	0	0
1	35793852	.	T	C	4	4	8	0	0	8	0	0
1	35810172	.	C	A	6	4	10	0	1	11	0	0
1	35811779	.	C	A	4	7	11	0	0	11	0	0
1	35811854	.	C	T	6	9	15	0	0	15	0	0
1	35812128	.	T	C	6	9	15	0	1	16	0	0
1	35812155	.	T	C	8	15	23	0	0	23	0	0
1	35815706	.	A	C	5	4	9	0	0	9	0	0
1	35834307	.	T	A	4	3	7	0	0	7	0	0
1	35834554	.	G	T	1	6	7	0	0	7	0	0
1	35834712	.	A	C	1	3	4	0	0	4	0	0
1	35835125	.	T	G	7	0	7	0	7	14	0	0
1	35835237	.	G	A	0	7	7	0	13	20	0	0
1	35835371	.	A	C	13	9	22	0	2	24	0	0
1	35835502	.	C	T	7	6	13	0	0	13	0	0
1	35897407	.	G	C	1	4	5	0	0	5	0	0
1	35897408	.	C	T	1	4	5	0	0	5	0	0
1	35898075	.	G	A	2	2	4	0	0	4	0	0
1	35908404	.	T	A	2	6	8	0	0	8	0	0
1	35908447	.	C	T	0	3	3	0	5	8	0	0
1	35915825	.	C	A	0	2	2	0	3	5	0	0
1	35915853	.	A	T	2	4	6	0	0	6	0	0
1	35949969	.	C	A	4	8	12	0	0	12	0	0
1	35950082	.	T	G	6	7	13	0	0	13	0	0
1	35950100	.	T	G	7	3	10	0	0	10	0	0
1	35956508	.	C	G	8	6	14	0	0	14	0	0
1	35956549	.	C	T	9	7	16	0	2	18	0	0
1	35959826	.	T	C	10	10	20	0	1	21	0	0
1	35962990	.	C	T	9	6	15	0	0	15	0	0
1	35963306	.	G	A	1	7	8	0	12	20	0	0
1	35963822	.	C	T	10	6	16	0	1	17	0	0
1	35969716	.	G	A	15	5	20	0	1	21	0	0
1	35969836	.	G	C	11	7	18	0	2	20	0	0
1	35969878	.	C	T	8	15	23	0	0	23	0	0
1	36018610	.	T	A	7	8	15	0	0	15	0	0
1	36018706	.	A	C	2	4	6	0	1	7	0	0
1	36018707	.	G	A	0	5	5	0	0	6	1	0
1	36018817	.	T	C	6	0	6	0	13	19	0	0
1	36019227	.	C	T	11	8	19	2	1	22	0	0
1	36019361	.	T	C	17	0	17	0	14	31	0	0
1	36019416	.	G	T	19	14	33	0	1	35	1	0
1	36020092	.	A	T	10	8	18	0	0	18	0	0
1	36020097	.	A	C	12	3	15	0	0	15	0	0
1	36020154	.	T	C	8	11	19	0	0	19	0	0
1	36020492	.	T	G	11	9	20	0	2	22	0	0
1	36020642	.	T	A	8	9	17	0	2	19	0	0
1	36021110	.	G	A	6	14	20	0	0	20	0	0
1	36021158	.	C	G	8	11	19	0	1	20	0	0
1	36021399	.	A	G	17	22	39	0	1	40	0	0
1	36036829	.	G	A	5	8	13	0	0	13	0	0
1	36057147	.	G	A	7	13	20	0	0	20	0	0
1	36057303	.	A	G	10	10	20	1	0	21	0	0
1	36057306	.	C	T	8	10	18	1	1	20	0	0
1	36078513	.	G	A	8	5	13	0	0	13	0	0
1	36104830	.	C	T	1	6	7	0	4	11	0	0
1	36105018	.	A	C	6	0	6	0	11	18	1	0
1	36105117	.	C	T	2	13	15	0	12	27	0	0
1	36119094	.	C	T	0	6	6	0	7	13	0	0
1	36119106	.	A	G	6	6	12	0	1	13	0	0
1	36194799	.	G	T	2	14	16	0	17	33	0	0
1	36194942	.	G	A	1	3	4	0	0	4	0	0
1	36200014	.	C	T	18	11	29	0	1	30	0	0
1	36438671	.	T	A	15	16	31	0	1	32	0	0
1	36438882	.	T	A	24	15	39	0	2	41	0	0
1	36439186	.	T	A	14	8	22	0	3	25	0	0
1	36439204	.	G	T	11	11	22	0	1	23	0	0
1	36439248	.	G	A	15	9	24	0	0	24	0	0
1	36439380	.	G	T	16	15	31	0	0	31	0	0
1	36440048	.	G	A	8	2	10	0	0	10	0	0
1	36701999	.	C	T	7	3	10	0	0	10	0	0
1	36722161	.	G	A	1	2	3	0	1	4	0	0
1	36722559	.	A	G	5	0	5	0	6	11	0	0
1	36725468	.	T	C	1	5	6	0	0	6	0	0
1	36735123	.	C	T	5	7	12	0	0	12	0	0
1	36735144	.	G	A	7	5	12	0	0	12	0	0
1	36738004	.	C	T	1	2	3	0	0	3	0	0
1	36738217	.	T	G	2	3	5	0	0	5	0	0
1	36738356	.	C	T	4	3	7	0	0	7	0	0
1	36738574	.	C	A	4	6	10	0	2	12	0	0
1	36738595	.	A	T	3	8	11	0	1	12	0	0
1	36738747	.	T	A	5	3	8	0	0	8	0	0
1	36738810	.	C	T	7	5	12	0	0	12	0	0
1	36739086	.	A	T	5	3	8	0	0	8	0	0
1	36739104	.	C	T	6	3	9	0	1	10	0	0
1	36739124	.	G	A	0	3	3	0	6	9	0	0
1	36739899	.	G	A	1	2	3	0	0	3	0	0
1	36740359	.	C	A	3	3	6	0	0	6	0	0
1	36740365	.	T	G	3	1	4	0	1	5	0	0
1	36740439	.	T	C	3	3	6	0	0	6	0	0
1	36740468	.	T	A	2	4	6	0	0	6	0	0
1	36740961	.	G	T	0	9	9	0	5	14	0	0
1	36740995	.	G	C	4	9	13	0	0	13	0	0
1	36741087	.	T	A	8	9	17	0	1	18	0	0
1	36741110	.	G	T	9	13	22	1	0	23	0	0
1	36741149	.	A	C	10	4	14	1	0	15	0	0
1	36741396	.	T	G	5	4	9	1	0	10	0	0
1	36741422	.	A	C	4	3	7	1	0	8	0	0
1	36741493	.	A	G	8	2	10	0	1	11	0	0
1	36741499	.	T	A	8	2	10	0	2	12	0	0
1	36741537	.	A	C	6	2	8	0	0	8	0	0
1	36741581	.	C	T	5	4	9	1	0	10	0	0
1	36741642	.	T	C	5	3	8	1	0	9	0	0
1	36741761	.	A	T	7	4	11	0	0	11	0	0
1	36741796	.	T	G	5	4	9	0	1	10	0	0
1	36741863	.	A	C	5	3	8	0	1	9	0	0
1	36742100	.	T	C	5	0	5	0	1	6	0	0
1	36755165	.	G	T	4	5	9	0	0	9	0	0
1	36755407	.	T	A	1	5	6	0	0	6	0	0
1	36755693	.	G	A	2	3	5	0	0	5	0	0
1	36761757	.	A	G	3	3	6	0	0	6	0	0
1	36763332	.	C	T	1	6	7	0	1	8	0	0
1	36763718	.	T	G	3	3	6	0	0	6	0	0
1	36768983	.	C	T	4	2	6	0	0	6	0	0
1	36769270	.	G	A	1	4	5	0	0	5	0	0
1	36769288	.	C	T	0	7	7	0	1	8	0	0
1	36770482	.	T	G	2	4	6	0	0	6	0	0
1	36771622	.	A	C	3	6	9	0	0	9	0	0
1	36836343	.	C	T	1	3	4	0	0	4	0	0
1	36841058	.	G	A	3	4	7	0	0	7	0	0
1	36856283	.	C	T	2	4	6	0	0	6	0	0
1	36887811	.	C	A	4	6	10	0	1	11	0	0
1	36903175	.	T	A	7	6	13	0	2	15	0	0
1	36911491	.	A	C	4	7	11	0	1	12	0	0
1	36911647	.	A	T	3	3	6	0	0	6	0	0
1	36911932	.	C	G	2	3	5	0	0	5	0	0
1	36912176	.	G	A	1	4	5	0	0	5	0	0
1	36935559	.	T	C	4	3	7	0	1	8	0	0
1	36938228	.	T	G	7	8	15	0	0	15	0	0
1	36963429	.	T	A	9	5	14	0	1	15	0	0
1	36969133	.	C	T	11	7	18	0	0	18	0	0
1	37083319	.	G	A	6	2	8	0	0	8	0	0
1	37083463	.	G	A	6	6	12	0	1	13	0	0
1	37083706	.	C	T	0	5	5	0	8	13	0	0
1	37083817	.	C	T	1	7	8	0	6	14	0	0
1	37083876	.	G	A	8	4	12	0	1	13	0	0
1	37083879	.	C	T	6	8	14	0	0	14	0	0
1	37084087	.	T	C	5	1	6	0	3	9	0	0
1	37087670	.	G	A	9	4	13	0	0	13	0	0
1	37087725	.	G	C	6	9	15	0	0	15	0	0
1	37195895	.	T	A	1	2	3	0	0	3	0	0
1	37195941	.	T	A	5	8	13	0	0	13	0	0
1	37195950	.	G	A	5	8	13	0	0	13	0	0
1	37196220	.	T	A	5	15	20	0	0	20	0	0
1	37196228	.	A	G	14	4	18	0	1	19	0	0
1	37212301	.	T	A	9	12	21	0	2	23	0	0
1	37212331	.	C	T	10	8	18	0	1	19	0	0
1	37284382	.	C	T	11	7	18	0	1	19	0	0
1	37287291	.	A	T	12	6	18	0	1	19	0	0
1	37287294	.	G	A	15	8	23	0	0	23	0	0
1	37291884	.	A	C	12	10	22	0	0	22	0	0
1	37304354	.	C	A	20	13	33	0	1	34	0	0
1	37304439	.	C	T	12	14	26	0	0	26	0	0
1	37304494	.	T	A	21	9	30	0	1	31	0	0
1	37304510	.	T	G	25	8	33	0	0	33	0	0
1	37304536	.	G	A	20	6	26	0	1	27	0	0
1	37304873	.	A	T	5	5	10	0	1	11	0	0
1	37304929	.	G	A	5	6	11	0	5	16	0	0
1	37305148	.	C	T	2	6	8	0	0	8	0	0
1	37305225	.	A	G	4	4	8	0	0	8	0	0
1	37305236	.	A	G	1	5	6	0	0	6	0	0
1	37306726	.	G	T	2	17	19	0	15	35	1	0
1	37306913	.	T	A	9	15	24	0	0	24	0	0
1	37306942	.	A	C	10	15	25	0	1	26	0	0
1	37339689	.	T	C	3	7	10	0	0	10	0	0
1	37339817	.	G	T	2	3	5	0	0	5	0	0
1	37344832	.	T	C	4	6	10	0	1	11	0	0
1	37353355	.	C	T	10	7	17	0	0	17	0	0
1	37355591	.	G	A	6	11	17	0	0	17	0	0
1	37355606	.	C	T	11	6	17	0	1	18	0	0
1	37359071	.	C	T	9	4	13	0	0	13	0	0
1	37359221	.	G	C	5	6	11	0	0	11	0	0
1	37359352	.	A	G	7	8	15	0	1	16	0	0
1	37361554	.	A	G	10	8	18	1	0	19	0	0
1	37361759	.	C	T	12	6	18	0	0	19	1	0
1	37399434	.	T	C	1	3	4	0	0	4	0	0
1	37399749	.	A	G	1	0	1	0	2	3	0	0
1	37411160	.	C	T	1	2	3	0	0	3	0	0
1	37417925	.	C	T	1	3	4	0	0	4	0	0
1	37417961	.	G	A	2	3	5	0	0	5	0	0
1	37752326	.	T	C	5	2	7	0	1	8	0	0
1	37752392	.	A	G	6	0	6	0	14	20	0	0
1	37752478	.	G	C	2	9	11	0	0	11	0	0
1	38125431	.	C	A	12	11	23	0	0	23	0	0
1	38125684	.	T	C	15	13	28	0	0	28	0	0
1	38131058	.	C	T	16	14	30	0	1	31	0	0
1	38131073	.	T	C	15	17	32	0	0	32	0	0
1	38131094	.	G	A	14	14	28	0	1	29	0	0
1	38131288	.	G	A	19	10	29	0	1	30	0	0
1	38131360	.	G	A	19	27	46	0	0	46	0	0
1	38131486	.	G	A	21	9	30	0	2	32	0	0
1	38132103	.	T	A	4	2	6	0	2	8	0	0
1	38132105	.	G	A	4	3	7	0	1	8	0	0
1	38142998	.	G	T	9	6	15	0	0	15	0	0
1	38146192	.	G	T	7	10	17	0	0	17	0	0
1	38150605	.	A	C	8	10	18	0	0	18	0	0
1	38163017	.	C	T	14	10	24	0	2	26	0	0
1	38163132	.	G	A	14	16	30	0	1	31	0	0
1	38166009	.	G	C	7	8	15	0	0	15	0	0
1	38166268	.	A	C	20	10	30	0	0	30	0	0
1	38166429	.	T	C	21	10	31	0	2	33	0	0
1	38166431	.	T	G	21	12	33	0	0	33	0	0
1	38166520	.	A	G	8	15	23	0	1	24	0	0
1	38169771	.	T	A	16	6	22	0	0	22	0	0
1	38169972	.	T	G	19	10	29	1	0	30	0	0
1	38170553	.	G	A	20	15	35	0	2	37	0	0
1	38346065	.	T	C	1	4	5	0	0	5	0	0
1	38346162	.	C	T	0	7	7	3	6	16	0	0
1	38346578	.	G	T	6	3	9	0	2	11	0	0
1	38346649	.	C	T	0	4	4	0	5	9	0	0
1	38346739	.	G	A	4	5	9	0	0	9	0	0
1	38354049	.	G	A	3	6	9	0	0	9	0	0
1	38374317	.	G	A	2	2	4	0	0	4	0	0
1	38416352	.	G	C	3	3	6	0	0	6	0	0
1	38416477	.	G	A	5	5	10	0	0	10	0	0
1	38416536	.	A	G	3	2	5	0	0	5	0	0
1	38417229	.	G	A	3	3	6	0	0	6	0	0
1	38417268	.	A	T	7	6	13	0	0	13	0	0
1	38417531	.	G	T	2	6	8	0	0	8	0	0
1	38417571	.	G	T	4	5	9	0	0	10	1	0
1	38417588	.	T	G	3	4	7	0	0	7	0	0
1	38417617	.	A	T	4	3	7	0	0	7	0	0
1	38417625	.	A	T	1	4	5	0	0	5	0	0
1	38417680	.	T	A	3	2	5	0	0	5	0	0
1	38417757	.	G	A	3	6	9	0	0	9	0	0
1	38417758	.	T	C	3	6	9	0	0	9	0	0
1	38418087	.	C	T	3	5	8	0	0	8	0	0
1	38466714	.	G	A	3	4	7	0	0	7	0	0
1	38538149	.	A	G	1	4	5	0	0	5	0	0
1	38538154	.	A	G	1	4	5	0	0	5	0	0
1	38649340	.	A	G	33	30	63	0	2	65	0	0
1	38649947	.	G	A	38	27	65	0	5	70	0	0
1	38650132	.	G	T	31	30	61	0	2	63	0	0
1	38650298	.	G	A	21	35	56	1	4	61	0	0
1	38650382	.	G	C	36	23	59	0	10	69	0	0
1	38650467	.	A	G	35	35	70	0	2	72	0	0
1	38650510	.	G	C	40	35	75	0	2	77	0	0
1	38650516	.	T	C	40	39	79	0	1	80	0	0
1	38650545	.	T	C	42	38	80	0	1	81	0	0
1	38651361	.	C	T	27	19	46	0	2	48	0	0
1	38651370	.	G	A	26	19	45	0	3	48	0	0
1	38651469	.	C	A	27	26	53	0	1	54	0	0
1	38651822	.	G	A	10	14	24	0	0	24	0	0
1	38655522	.	C	T	3	33	36	3	32	71	0	0
1	38657689	.	G	A	41	31	72	0	1	73	0	0
1	38660240	.	T	C	41	0	41	0	28	69	0	0
1	38660252	.	A	G	39	28	67	0	1	68	0	0
1	38660369	.	G	A	43	28	71	0	1	72	0	0
1	38709351	.	A	C	20	0	20	1	19	40	0	0
1	38709381	.	G	C	20	13	33	4	0	37	0	0
1	38709480	.	G	A	9	18	27	0	1	28	0	0
1	38709535	.	T	A	16	8	24	0	0	24	0	0
1	38784551	.	A	T	10	11	21	0	0	21	0	0
1	38787039	.	C	T	15	8	23	0	1	24	0	0
1	38791569	.	C	T	10	15	25	0	1	26	0	0
1	38793983	.	G	A	10	11	21	0	0	21	0	0
1	38797663	.	A	C	11	20	31	0	1	32	0	0
1	38799513	.	G	A	18	17	35	0	1	36	0	0
1	38799585	.	A	G	13	11	24	0	1	25	0	0
1	38799588	.	T	A	12	11	23	0	1	24	0	0
1	38802537	.	G	A	18	9	27	0	0	27	0	0
1	38802703	.	A	G	17	13	30	0	0	30	0	0
1	38802718	.	G	A	14	16	30	0	1	31	0	0
1	38802747	.	A	G	14	1	15	0	11	26	0	0
1	38803033	.	T	C	5	4	9	0	2	11	0	0
1	38803042	.	A	C	7	2	9	0	1	10	0	0
1	38803127	.	C	T	11	9	20	2	0	22	0	0
1	38803154	.	T	A	12	8	20	0	2	22	0	0
1	38803205	.	A	T	12	7	19	0	0	19	0	0
1	38803404	.	A	G	16	10	26	0	1	27	0	0
1	38805128	.	G	T	13	3	16	0	1	17	0	0
1	38805135	.	C	T	13	3	16	0	0	16	0	0
1	38805439	.	G	A	9	13	22	0	1	23	0	0
1	38805450	.	A	G	13	13	26	0	0	26	0	0
1	38805506	.	G	A	15	14	29	0	1	30	0	0
1	38807255	.	G	C	18	10	28	0	0	28	0	0
1	38808259	.	C	A	11	17	28	0	0	28	0	0
1	38808379	.	C	T	0	15	15	0	8	23	0	0
1	38808723	.	T	A	12	12	24	0	1	25	0	0
1	38810061	.	T	G	9	8	17	0	2	19	0	0
1	38820219	.	G	A	0	5	5	0	11	16	0	0
1	38822092	.	A	T	4	3	7	0	1	8	0	0
1	38851111	.	C	T	0	6	6	0	1	7	0	0
1	39388332	.	A	C	4	5	9	0	0	9	0	0
1	39388363	.	C	T	5	2	7	0	0	7	0	0
1	39482532	.	C	T	7	5	12	0	0	12	0	0
1	39639723	.	C	T	11	5	16	0	1	17	0	0
1	39680758	.	G	A	2	6	8	0	3	11	0	0
1	39680794	.	C	A	4	6	10	0	0	10	0	0
1	39700498	.	T	C	9	11	20	0	0	20	0	0
1	39732544	.	C	T	9	10	19	0	1	20	0	0
1	39735491	.	T	C	15	14	29	0	0	29	0	0
1	39770416	.	C	T	10	14	24	0	0	24	0	0
1	39771429	.	T	A	19	10	29	0	0	29	0	0
1	39772010	.	T	C	10	19	29	0	0	29	0	0
1	39772042	.	A	G	16	10	26	0	0	26	0	0
1	39772135	.	C	A	21	14	35	0	0	35	0	0
1	39772225	.	C	T	21	17	38	0	1	39	0	0
1	39774096	.	C	T	14	13	27	0	1	28	0	0
1	39774225	.	C	T	15	16	31	0	1	32	0	0
1	39774363	.	G	A	15	12	27	0	3	30	0	0
1	39774618	.	A	G	19	13	32	0	1	34	1	0
1	39774690	.	A	G	4	17	21	0	1	22	0	0
1	39774727	.	C	A	9	12	21	0	0	21	0	0
1	39774891	.	C	T	24	12	36	0	2	38	0	0
1	39774915	.	G	A	11	19	30	0	4	34	0	0
1	39775089	.	C	T	18	13	31	0	0	31	0	0
1	39775131	.	C	T	15	13	28	0	3	31	0	0
1	39775227	.	C	T	10	14	24	0	2	26	0	0
1	39776356	.	A	C	15	20	35	0	6	41	0	0
1	39777089	.	G	A	11	19	30	0	3	33	0	0
1	39777836	.	G	A	1	11	12	0	14	26	0	0
1	39777975	.	A	T	13	13	26	0	0	26	0	0
1	39778047	.	A	G	15	0	15	0	15	30	0	0
1	39778075	.	T	G	17	13	30	0	0	30	0	0
1	39778332	.	G	C	18	21	39	0	1	40	0	0
1	39778661	.	G	A	10	11	21	0	0	21	0	0
1	39778663	.	G	A	11	11	22	0	0	22	0	0
1	39778949	.	G	C	18	18	36	0	0	36	0	0
1	39779225	.	G	C	10	11	21	0	0	21	0	0
1	39869860	.	T	A	2	2	4	0	0	4	0	0
1	39869917	.	T	A	3	5	8	0	0	8	0	0
1	39869974	.	G	A	2	5	7	0	0	7	0	0
1	39870008	.	T	C	1	3	4	0	0	4	0	0
1	39879560	.	T	C	2	2	4	0	0	4	0	0
1	39882899	.	A	G	5	2	7	0	1	8	0	0
1	39882906	.	T	A	2	6	8	0	0	8	0	0
1	39883259	.	C	G	1	4	5	0	3	8	0	0
1	39895792	.	G	A	4	2	6	0	0	6	0	0
1	39899477	.	G	C	15	20	35	0	0	35	0	0
1	39899494	.	A	G	21	16	37	0	1	38	0	0
1	39899663	.	G	A	26	18	44	0	5	49	0	0
1	39900056	.	G	A	22	27	49	0	1	50	0	0
1	39900129	.	G	A	29	18	47	0	0	47	0	0
1	39900137	.	G	T	26	18	44	0	2	46	0	0
1	39900360	.	G	A	19	14	33	0	0	33	0	0
1	39900432	.	C	T	2	21	23	0	13	36	0	0
1	39900750	.	C	T	2	12	14	0	18	32	0	0
1	39901269	.	G	A	7	5	12	0	0	12	0	0
1	39901378	.	T	A	14	10	24	0	0	24	0	0
1	39901500	.	T	C	11	8	19	0	2	21	0	0
1	39901501	.	G	A	13	8	21	0	0	21	0	0
1	39901729	.	T	C	16	0	16	0	24	40	0	0
1	39907291	.	A	C	7	11	18	0	0	18	0	0
1	39907492	.	T	C	22	0	22	0	16	38	0	0
1	39907611	.	C	T	2	4	6	0	4	10	0	0
1	39908047	.	G	A	16	19	35	0	2	37	0	0
1	39908680	.	C	T	18	8	26	0	0	26	0	0
1	39908854	.	A	G	17	19	36	0	1	37	0	0
1	39908881	.	C	T	13	20	33	0	0	33	0	0
1	39908926	.	A	G	12	13	25	0	1	26	0	0
1	39909003	.	A	T	21	14	35	0	2	37	0	0
1	39909247	.	A	T	20	19	39	0	3	42	0	0
1	39909274	.	A	T	17	18	35	0	9	44	0	0
1	39977098	.	G	A	6	2	8	6	0	14	0	0
1	39981794	.	A	G	3	6	9	0	0	9	0	0
1	39995100	.	C	T	11	10	21	0	0	21	0	0
1	39998875	.	G	A	13	15	28	0	3	31	0	0
1	40001853	.	A	T	18	11	29	0	5	34	0	0
1	40001873	.	C	A	14	10	24	0	3	27	0	0
1	40002113	.	G	A	13	11	24	0	1	25	0	0
1	40002148	.	C	G	16	10	26	0	2	28	0	0
1	40008905	.	T	C	21	17	38	0	1	39	0	0
1	40008906	.	G	A	21	17	38	0	1	39	0	0
1	40009227	.	T	A	15	19	34	0	0	34	0	0
1	40009258	.	C	T	14	11	25	0	1	26	0	0
1	40009291	.	A	G	15	9	24	0	1	25	0	0
1	40009382	.	G	A	14	11	25	0	0	25	0	0
1	40009526	.	T	C	5	6	11	0	0	11	0	0
1	40009625	.	T	C	9	4	13	0	1	14	0	0
1	40009671	.	C	A	6	9	15	0	1	16	0	0
1	40009697	.	C	T	6	7	13	0	0	13	0	0
1	40015189	.	A	G	10	8	18	0	0	18	0	0
1	40015219	.	C	T	13	9	22	0	0	22	0	0
1	40015265	.	C	T	1	11	12	0	14	26	0	0
1	40015553	.	A	G	7	8	15	0	2	17	0	0
1	40015697	.	A	G	7	9	16	0	2	18	0	0
1	40023692	.	T	C	7	11	18	0	0	18	0	0
1	40024882	.	T	G	8	0	8	0	5	13	0	0
1	40027564	.	C	A	4	3	7	0	0	7	0	0
1	40028208	.	C	A	9	7	16	0	0	16	0	0
1	40028424	.	C	T	10	8	18	0	0	18	0	0
1	40028508	.	C	T	10	4	14	0	2	16	0	0
1	40028568	.	G	T	10	7	17	0	0	17	0	0
1	40028613	.	G	A	6	10	16	0	0	16	0	0
1	40028637	.	C	T	7	6	13	0	1	14	0	0
1	40028680	.	G	A	4	7	11	0	0	11	0	0
1	40041528	.	C	T	9	6	15	0	0	15	0	0
1	40042241	.	G	A	6	4	10	0	1	11	0	0
1	40044175	.	G	C	2	7	9	0	0	9	0	0
1	40044562	.	G	A	8	10	18	0	0	18	0	0
1	40044578	.	C	T	11	6	17	0	0	17	0	0
1	40046859	.	G	A	9	4	13	0	0	13	0	0
1	40047070	.	T	A	10	8	18	0	0	18	0	0
1	40051918	.	T	C	8	10	18	1	1	20	0	0
1	40051923	.	G	C	8	12	20	1	0	21	0	0
1	40051988	.	G	C	1	5	6	0	17	23	0	0
1	40052033	.	A	G	9	10	19	0	3	22	0	0
1	40052066	.	G	C	11	10	21	0	1	22	0	0
1	40052083	.	G	A	13	8	21	0	1	22	0	0
1	40052481	.	A	C	7	8	15	0	2	17	0	0
1	40052550	.	A	C	6	6	12	0	0	12	0	0
1	40052562	.	A	G	3	5	8	0	0	8	0	0
1	40057483	.	C	T	5	3	8	0	0	8	0	0
1	40057805	.	C	T	7	7	14	1	0	16	1	0
1	40060968	.	A	C	1	7	8	0	2	10	0	0
1	40060992	.	C	T	0	6	6	0	2	8	0	0
1	40061061	.	C	T	2	5	7	0	6	13	0	0
1	40061169	.	G	A	7	3	10	0	0	10	0	0
1	40062593	.	T	G	5	2	7	0	1	8	0	0
1	40066299	.	G	A	4	6	10	0	1	11	0	0
1	40095794	.	T	A	2	2	4	0	0	4	0	0
1	40095799	.	C	T	2	3	5	0	0	5	0	0
1	40107874	.	T	G	8	13	21	0	0	21	0	0
1	40107961	.	C	T	7	8	15	0	0	15	0	0
1	40111679	.	C	G	15	19	34	0	1	35	0	0
1	40111702	.	T	G	19	15	34	0	0	34	0	0
1	40111737	.	A	C	16	14	30	0	2	32	0	0
1	40111738	.	G	A	18	14	32	0	1	33	0	0
1	40111776	.	C	T	6	14	20	0	1	21	0	0
1	40111918	.	C	T	10	11	21	0	0	21	0	0
1	40112206	.	T	C	8	4	12	0	6	18	0	0
1	40112347	.	C	T	7	3	10	0	0	10	0	0
1	40112410	.	C	T	6	5	11	0	3	14	0	0
1	40112760	.	T	A	11	4	15	0	0	15	0	0
1	40112822	.	A	T	9	14	23	1	0	24	0	0
1	40112837	.	C	T	14	10	24	1	0	25	0	0
1	40112869	.	C	T	16	15	31	1	0	32	0	0
1	40112879	.	A	G	14	12	26	1	1	28	0	0
1	40112938	.	G	C	4	7	11	0	0	11	0	0
1	40113008	.	A	T	1	2	3	0	0	3	0	0
1	40113486	.	A	G	2	2	4	0	0	4	0	0
1	40113833	.	T	C	1	2	3	0	0	3	0	0
1	40114070	.	G	A	2	3	5	0	0	5	0	0
1	40114155	.	T	A	1	5	6	1	0	7	0	0
1	40114326	.	C	T	3	2	5	0	0	5	0	0
1	40115065	.	T	C	1	4	5	0	0	5	0	0
1	40116747	.	G	A	7	9	16	0	0	16	0	0
1	40116946	.	C	T	2	4	6	0	7	13	0	0
1	40117345	.	G	A	18	10	28	0	4	32	0	0
1	40117792	.	C	T	9	6	15	0	1	16	0	0
1	40123964	.	C	T	1	11	12	0	10	22	0	0
1	40126279	.	T	C	5	9	14	0	3	17	0	0
1	40126281	.	T	G	8	9	17	0	0	17	0	0
1	40132692	.	G	C	3	5	8	0	0	8	0	0
1	40210865	.	G	T	16	18	34	0	1	35	0	0
1	40211048	.	C	T	1	7	8	0	9	17	0	0
1	40211065	.	T	C	7	4	11	0	0	11	0	0
1	40211217	.	A	C	11	12	23	0	0	23	0	0
1	40211465	.	T	C	12	1	13	0	12	25	0	0
1	40211645	.	C	G	0	14	14	0	11	25	0	0
1	40212065	.	C	T	11	17	28	0	0	28	0	0
1	40212084	.	C	A	3	12	15	0	17	32	0	0
1	40212305	.	C	T	16	15	31	0	3	34	0	0
1	40221359	.	A	G	9	9	18	0	3	21	0	0
1	40221458	.	A	T	10	10	20	0	0	20	0	0
1	40226289	.	G	A	11	11	22	0	0	22	0	0
1	40226292	.	G	C	11	10	21	0	0	21	0	0
1	40227029	.	T	G	11	9	20	0	1	21	0	0
1	40242922	.	C	A	4	5	9	0	0	9	0	0
1	40248173	.	C	T	6	5	11	0	0	11	0	0
1	40248383	.	C	T	5	6	11	0	0	11	0	0
1	40252219	.	T	A	13	11	24	0	1	25	0	0
1	40257631	.	C	T	14	4	18	0	0	18	0	0
1	40257751	.	C	T	8	7	15	0	0	15	0	0
1	40257834	.	T	G	6	0	6	0	6	12	0	0
1	40263675	.	C	A	2	10	12	0	0	12	0	0
1	40266618	.	C	T	22	36	58	0	0	58	0	0
1	40270054	.	C	T	28	28	56	1	1	58	0	0
1	40270094	.	G	A	2	28	30	1	29	60	0	0
1	40270095	.	G	A	31	27	58	1	2	61	0	0
1	40336234	.	C	G	5	5	10	0	0	10	0	0
1	40336372	.	T	A	5	2	7	0	0	7	0	0
1	40336396	.	A	C	4	0	4	0	5	9	0	0
1	40336789	.	G	A	2	7	9	0	0	9	0	0
1	40337314	.	C	T	11	8	19	0	2	21	0	0
1	40337464	.	C	A	2	4	6	0	9	15	0	0
1	40340571	.	C	T	9	8	17	0	2	19	0	0
1	40340598	.	C	T	7	9	16	0	0	16	0	0
1	40410608	.	C	T	1	2	3	0	8	11	0	0
1	40410839	.	A	T	14	9	23	0	1	24	0	0
1	40410908	.	C	T	7	7	14	0	2	16	0	0
1	40411091	.	T	A	9	8	17	0	1	18	0	0
1	40411928	.	T	C	6	5	11	0	1	12	0	0
1	40567094	.	G	A	15	11	26	0	3	29	0	0
1	40568601	.	G	A	9	10	19	0	1	20	0	0
1	40568707	.	A	G	13	1	14	0	10	24	0	0
1	40568883	.	G	A	1	15	16	0	19	35	0	0
1	40568990	.	A	G	21	10	31	0	1	32	0	0
1	40569153	.	C	T	14	4	18	0	0	18	0	0
1	40569168	.	C	T	13	4	17	0	0	17	0	0
1	40569231	.	G	A	15	5	20	0	0	20	0	0
1	40569295	.	A	T	10	6	16	0	1	17	0	0
1	40569386	.	T	A	13	7	20	5	0	25	0	0
1	40569466	.	A	T	17	15	32	0	0	32	0	0
1	40569538	.	G	A	12	9	21	0	1	22	0	0
1	40569548	.	T	C	9	10	19	0	2	21	0	0
1	40573703	.	G	T	20	21	41	0	4	45	0	0
1	40590967	.	T	G	19	23	42	0	1	43	0	0
1	40591262	.	T	C	27	22	49	0	1	50	0	0
1	40591272	.	T	C	28	21	49	0	1	50	0	0
1	40594373	.	C	T	25	21	46	0	0	46	0	0
1	40594415	.	C	T	1	21	22	0	19	41	0	0
1	40594517	.	T	C	28	0	28	1	17	46	0	0
1	40594526	.	G	A	22	15	37	1	3	41	0	0
1	40597332	.	A	C	17	1	18	0	30	48	0	0
1	40600992	.	A	T	15	14	29	0	2	31	0	0
1	40601547	.	G	A	12	20	32	0	2	34	0	0
1	40601595	.	G	C	11	1	12	0	16	28	0	0
1	40618861	.	C	T	14	6	20	0	0	20	0	0
1	40627291	.	G	A	10	9	19	0	1	20	0	0
1	40638246	.	A	T	5	8	13	0	0	13	0	0
1	40795213	.	C	A	2	6	8	0	1	9	0	0
1	40795231	.	A	T	6	4	10	0	0	10	0	0
1	40796779	.	G	T	5	7	12	0	0	12	0	0
1	40796791	.	G	A	5	3	8	0	0	8	0	0
1	40796942	.	C	T	1	2	3	0	0	3	0	0
1	40796977	.	C	T	2	1	3	0	0	3	0	0
1	40796985	.	A	T	2	2	4	0	0	4	0	0
1	40798953	.	A	G	1	2	3	0	0	3	0	0
1	40911073	.	C	T	0	2	2	0	3	5	0	0
1	40992716	.	T	A	7	5	12	0	0	12	0	0
1	40992823	.	A	G	3	10	13	0	1	14	0	0
1	40992878	.	C	G	7	6	13	0	1	14	0	0
1	40993349	.	C	T	2	9	11	0	17	28	0	0
1	40993714	.	G	A	9	6	15	0	0	15	0	0
1	40994068	.	T	A	1	3	4	0	0	4	0	0
1	41131608	.	C	T	16	14	30	0	1	31	0	0
1	41133944	.	G	A	8	8	16	0	2	18	0	0
1	41136245	.	T	C	13	13	26	0	1	27	0	0
1	41138638	.	A	G	7	15	22	0	1	23	0	0
1	41138641	.	C	T	15	9	24	0	0	24	0	0
1	41140465	.	T	C	14	14	28	0	0	28	0	0
1	41140640	.	C	T	13	13	26	0	0	26	0	0
1	41215289	.	T	A	8	9	17	0	1	18	0	0
1	41215312	.	T	G	10	13	23	0	0	23	0	0
1	41215547	.	G	A	15	8	23	0	0	23	0	0
1	41215746	.	T	A	12	11	23	0	2	25	0	0
1	41215868	.	T	G	8	8	16	0	0	16	0	0
1	41215869	.	G	T	9	7	16	0	0	16	0	0
1	41215949	.	T	C	14	4	18	0	0	18	0	0
1	41215998	.	T	C	6	6	12	1	0	13	0	0
1	41222341	.	T	C	11	3	14	0	0	14	0	0
1	41230927	.	C	T	6	9	15	0	0	15	0	0
1	41294719	.	A	G	14	11	25	0	2	27	0	0
1	41294760	.	T	C	12	9	21	0	0	21	0	0
1	41294790	.	G	T	9	8	17	0	0	17	0	0
1	41297453	.	C	T	2	9	11	0	11	22	0	0
1	41297495	.	G	A	14	10	24	0	1	25	0	0
1	41297561	.	C	T	19	5	24	0	1	25	0	0
1	41297564	.	A	T	5	18	23	0	1	24	0	0
1	41300133	.	C	T	9	11	20	0	0	20	0	0
1	41309208	.	C	G	9	7	16	0	1	17	0	0
1	41312210	.	G	A	11	13	24	0	0	24	0	0
1	41318203	.	T	G	8	4	12	2	2	16	0	0
1	41320781	.	A	G	11	5	16	0	1	17	0	0
1	41324327	.	C	T	0	5	5	0	11	16	0	0
1	41324444	.	C	T	1	10	11	0	4	15	0	0
1	41327484	.	A	T	6	9	15	0	0	15	0	0
1	41330394	.	G	A	3	6	9	0	0	9	0	0
1	41330594	.	G	C	9	7	16	0	0	16	0	0
1	41331692	.	G	A	8	8	16	0	0	16	0	0
1	41332989	.	T	C	6	0	6	0	5	11	0	0
1	41333034	.	G	A	4	4	8	0	0	8	0	0
1	41333503	.	A	G	7	6	13	0	1	14	0	0
1	41335135	.	G	A	8	4	12	0	1	13	0	0
1	41335147	.	T	A	7	4	11	0	0	11	0	0
1	41335270	.	G	A	2	8	10	0	0	10	0	0
1	41337314	.	G	A	3	7	10	0	0	10	0	0
1	41339963	.	C	T	0	5	5	0	6	11	0	0
1	41340128	.	C	G	3	6	9	0	1	10	0	0
1	41340133	.	T	G	3	6	9	0	1	10	0	0
1	41360074	.	A	G	6	5	11	0	2	13	0	0
1	41374028	.	G	T	1	4	5	0	0	5	0	0
1	41470524	.	T	C	15	27	42	0	1	43	0	0
1	41471529	.	T	C	23	21	44	0	3	47	0	0
1	41487459	.	C	A	4	3	7	0	0	7	0	0
1	41487474	.	C	T	3	4	7	0	0	7	0	0
1	41488030	.	T	C	2	6	8	0	0	8	0	0
1	41488643	.	A	C	4	5	9	0	0	9	0	0
1	41489068	.	C	T	3	3	6	0	1	7	0	0
1	41489274	.	G	C	2	2	4	0	0	4	0	0
1	41489343	.	G	A	4	3	7	0	0	7	0	0
1	41489433	.	C	T	1	4	5	0	0	5	0	0
1	41512895	.	C	T	6	3	9	0	2	11	0	0
1	41513332	.	G	A	6	2	8	0	0	8	0	0
1	41513497	.	G	A	8	8	16	0	1	17	0	0
1	41530370	.	C	T	3	5	8	0	1	9	0	0
1	41596148	.	A	T	2	3	5	0	0	5	0	0
1	41596182	.	A	G	5	3	8	0	0	8	0	0
1	41596199	.	A	G	5	3	8	0	1	9	0	0
1	41596291	.	C	T	3	6	9	0	0	9	0	0
1	41596420	.	A	C	1	3	4	0	0	4	0	0
1	41600339	.	T	C	1	2	3	0	0	3	0	0
1	41600533	.	A	G	4	5	9	0	0	9	0	0
1	41604931	.	C	G	7	0	7	0	3	10	0	0
1	41604934	.	C	G	7	0	7	0	4	11	0	0
1	41604985	.	G	A	0	5	5	0	5	10	0	0
1	41605011	.	T	C	1	4	5	0	1	6	0	0
1	41605149	.	T	C	6	3	9	0	0	9	0	0
1	41605203	.	C	T	6	6	12	0	0	12	0	0
1	41609835	.	C	T	2	5	7	0	0	7	0	0
1	41609961	.	C	A	2	2	4	0	0	4	0	0
1	41615874	.	C	T	8	6	14	0	0	14	0	0
1	41615904	.	T	C	5	7	12	0	0	12	0	0
1	41615949	.	T	C	6	11	17	0	0	17	0	0
1	41616081	.	T	G	4	8	12	0	0	12	0	0
1	41616186	.	A	C	5	7	12	0	1	13	0	0
1	41616867	.	T	A	3	2	5	0	0	5	0	0
1	41616902	.	A	T	4	2	6	0	0	6	0	0
1	41690506	.	C	T	12	12	24	0	1	25	0	0
1	41730609	.	C	T	23	14	37	0	1	38	0	0
1	41730669	.	G	A	17	10	27	0	1	28	0	0
1	41744103	.	C	T	13	13	26	0	1	27	0	0
1	41755157	.	C	T	17	15	32	0	2	34	0	0
1	41755158	.	A	T	17	16	33	0	1	34	0	0
1	41755195	.	C	T	16	16	32	1	0	33	0	0
1	41770847	.	T	A	14	12	26	0	0	27	1	0
1	41770872	.	T	C	16	12	28	0	1	29	0	0
1	41770959	.	T	C	8	13	21	0	0	21	0	0
1	41817556	.	G	A	5	4	9	0	0	9	0	0
1	41817574	.	T	C	7	3	10	0	0	10	0	0
1	41817678	.	C	T	4	7	11	0	0	11	0	0
1	41849293	.	A	G	7	11	18	0	2	20	0	0
1	41849310	.	A	G	11	19	30	0	0	30	0	0
1	41865471	.	C	T	27	22	49	0	4	53	0	0
1	41958356	.	C	T	4	3	7	0	0	7	0	0
1	41982429	.	G	T	2	2	4	0	0	4	0	0
1	42375005	.	C	A	16	8	24	0	1	25	0	0
1	42375071	.	C	T	17	19	36	0	1	37	0	0
1	42386349	.	T	C	15	8	23	0	0	23	0	0
1	42386364	.	C	A	13	6	19	0	3	22	0	0
1	42386430	.	T	C	10	8	18	0	1	19	0	0
1	42386436	.	T	C	8	6	14	0	2	16	0	0
1	42391172	.	T	C	9	7	16	0	2	18	0	0
1	42391194	.	T	C	10	10	20	0	0	20	0	0
1	42391214	.	G	A	10	8	18	0	0	18	0	0
1	42776652	.	T	C	21	14	35	0	4	39	0	0
1	42776787	.	C	T	4	13	17	0	22	39	0	0
1	42776806	.	A	T	25	14	39	0	2	41	0	0
1	42776853	.	T	C	26	21	47	0	1	48	0	0
1	42776906	.	A	G	22	13	35	0	1	36	0	0
1	42777116	.	G	A	22	16	38	0	2	40	0	0
1	42777146	.	C	G	2	11	13	0	21	34	0	0
1	42777383	.	A	G	24	8	32	0	4	36	0	0
1	42777593	.	T	G	18	17	35	0	0	35	0	0
1	42777674	.	G	A	11	14	25	0	0	25	0	0
1	42882955	.	C	T	14	6	20	0	0	20	0	0
1	43023630	.	G	A	20	12	32	0	1	33	0	0
1	43034947	.	C	T	23	21	44	0	1	45	0	0
1	43035178	.	T	C	13	21	34	0	1	35	0	0
1	43035546	.	T	A	5	13	18	0	3	21	0	0
1	44228705	.	C	T	1	3	4	0	1	5	0	0
1	45095019	.	T	C	5	4	9	1	0	10	0	0
1	45570224	.	T	A	2	10	12	0	1	13	0	0
1	45743264	.	A	G	2	2	4	0	0	4	0	0
1	45833539	.	A	G	4	2	6	1	2	9	0	0
1	45833542	.	A	G	4	3	7	1	0	8	0	0
1	45834404	.	A	G	4	2	6	1	0	7	0	0
1	45834490	.	A	G	7	2	9	0	0	9	0	0
1	47120514	.	A	T	6	5	11	0	0	11	0	0
1	47120622	.	G	C	7	12	19	1	1	21	0	0
1	47120627	.	C	T	6	16	22	1	0	23	0	0
1	47391412	.	T	A	15	1	16	0	2	18	0	0
1	47391416	.	A	C	11	2	13	0	4	18	1	0
1	47398117	.	G	A	0	10	10	0	9	19	0	0
1	47405160	.	G	A	9	10	19	0	0	19	0	0
1	47405202	.	A	C	6	11	17	0	4	22	1	0
1	47406177	.	A	T	3	5	8	0	1	9	0	0
1	47406936	.	G	A	17	19	36	0	1	37	0	0
1	47407541	.	C	T	21	9	30	0	1	31	0	0
1	47407601	.	C	T	11	10	21	0	0	21	0	0
1	47407607	.	T	C	11	11	22	0	0	22	0	0
1	47408802	.	C	T	9	14	23	0	0	23	0	0
1	47409873	.	C	A	7	11	18	0	1	19	0	0
1	47410043	.	G	A	2	7	9	0	10	19	0	0
1	47505064	.	T	A	5	7	12	0	0	12	0	0
1	47505251	.	A	G	2	9	11	0	0	11	0	0
1	47505260	.	G	T	0	8	8	0	1	9	0	0
1	47510820	.	G	A	2	6	8	0	0	8	0	0
1	47679641	.	G	A	4	2	6	0	0	6	0	0
1	47679722	.	T	C	4	2	6	0	0	6	0	0
1	47679833	.	C	T	2	2	4	0	0	4	0	0
1	47681445	.	T	C	1	2	3	0	0	3	0	0
1	47682069	.	C	T	4	4	8	0	0	8	0	0
1	47682924	.	G	C	6	3	9	0	1	10	0	0
1	47683862	.	G	A	1	3	4	0	3	7	0	0
1	47683909	.	T	C	1	2	3	0	0	3	0	0
1	47684031	.	A	G	2	2	4	0	0	4	0	0
1	47684228	.	A	T	3	2	5	0	0	5	0	0
1	47684279	.	G	A	0	2	2	0	3	5	0	0
1	47685414	.	A	G	1	2	3	0	1	4	0	0
1	47686089	.	G	A	5	5	10	0	0	10	0	0
1	47686101	.	T	A	5	6	11	0	0	11	0	0
1	47686593	.	A	G	2	3	5	0	1	6	0	0
1	47686681	.	A	C	5	4	9	0	0	9	0	0
1	47703023	.	A	T	5	2	7	0	1	8	0	0
1	47703048	.	A	G	6	3	9	0	0	9	0	0
1	47703347	.	T	A	3	6	9	0	0	9	0	0
1	47703654	.	C	T	4	8	12	0	1	13	0	0
1	47716051	.	G	A	9	4	13	0	0	13	0	0
1	47716558	.	A	G	5	5	10	0	0	10	0	0
1	47771715	.	C	A	3	7	10	0	0	10	0	0
1	47969835	.	G	A	2	2	4	0	0	4	0	0
1	48379832	.	T	A	3	3	6	0	0	6	0	0
1	48424342	.	A	G	2	2	4	0	0	4	0	0
1	48452518	.	C	T	1	3	4	0	0	4	0	0
1	48452524	.	G	A	0	4	4	0	1	5	0	0
1	48458352	.	A	G	0	0	0	0	6	6	0	0
1	48458382	.	C	A	4	3	7	0	0	7	0	0
1	48470316	.	G	A	1	4	5	0	0	5	0	0
1	48486543	.	A	G	3	3	6	1	0	7	0	0
1	48486803	.	C	T	5	4	9	0	0	9	0	0
1	48487358	.	A	C	1	3	4	0	0	4	0	0
1	48487370	.	T	A	2	3	5	0	0	5	0	0
1	48487729	.	T	A	1	3	4	0	0	4	0	0
1	48488243	.	T	G	2	3	5	0	1	6	0	0
1	48488362	.	T	A	4	6	10	0	0	10	0	0
1	48488377	.	G	A	0	4	4	0	6	10	0	0
1	48488398	.	C	T	5	4	9	0	0	9	0	0
1	48488436	.	C	T	8	3	11	0	0	11	0	0
1	48488496	.	C	T	1	6	7	0	0	7	0	0
1	48488619	.	A	C	3	3	6	0	0	6	0	0
1	48488898	.	A	T	1	6	7	0	0	7	0	0
1	48489474	.	A	G	1	3	4	0	0	4	0	0
1	48581662	.	T	C	2	2	4	0	0	4	0	0
1	48581796	.	T	C	1	0	1	0	3	4	0	0
1	48581816	.	G	A	3	2	5	0	0	5	0	0
1	48581919	.	C	T	2	6	8	0	1	9	0	0
1	48582091	.	T	C	1	4	5	0	0	5	0	0
1	48582102	.	T	C	2	3	5	0	0	5	0	0
1	48583844	.	G	C	5	2	7	0	2	9	0	0
1	48587725	.	T	A	8	6	14	0	1	15	0	0
1	48600877	.	T	C	1	0	1	0	4	5	0	0
1	48607301	.	T	C	4	4	8	0	0	8	0	0
1	48607361	.	A	G	5	3	8	0	0	8	0	0
1	48921983	.	G	A	4	3	7	0	0	7	0	0
1	48922154	.	A	G	1	2	3	0	0	3	0	0
1	48922158	.	T	G	1	4	5	0	0	5	0	0
1	49271317	.	G	A	21	33	54	2	3	59	0	0
1	49289663	.	G	A	3	30	33	0	31	64	0	0
1	49293733	.	C	T	24	35	59	0	4	63	0	0
1	49293808	.	T	C	22	28	50	0	6	56	0	0
1	49293891	.	G	A	33	17	50	0	1	51	0	0
1	49293956	.	G	T	21	24	45	0	1	46	0	0
1	49293965	.	G	A	29	21	50	0	1	51	0	0
1	49294003	.	G	A	27	11	38	3	4	45	0	0
1	49294146	.	G	A	0	2	2	0	9	11	0	0
1	49294654	.	G	A	20	10	30	0	1	31	0	0
1	49294686	.	A	G	14	15	29	0	3	32	0	0
1	49294727	.	G	C	19	13	32	0	0	32	0	0
1	49294765	.	T	C	17	18	35	0	2	37	0	0
1	49374392	.	A	G	5	5	10	0	1	11	0	0
1	49379904	.	T	C	4	1	5	0	2	7	0	0
1	49382031	.	G	A	3	4	7	0	0	7	0	0
1	49409520	.	G	A	5	12	17	0	0	17	0	0
1	49418122	.	T	C	4	8	12	0	0	12	0	0
1	49418156	.	T	C	6	7	13	0	1	14	0	0
1	49418197	.	A	T	4	2	6	0	0	6	0	0
1	49420637	.	G	A	3	5	8	0	2	10	0	0
1	49420658	.	A	G	3	8	11	0	0	11	0	0
1	49423200	.	G	A	2	4	6	1	1	8	0	0
1	49425668	.	C	T	4	9	13	0	0	13	0	0
1	49425737	.	C	T	7	6	13	0	0	13	0	0
1	49427972	.	G	C	0	6	6	0	8	14	0	0
1	49429878	.	G	A	2	6	8	0	15	23	0	0
1	49429917	.	C	A	14	4	18	0	1	19	0	0
1	49429944	.	T	A	7	10	17	0	0	17	0	0
1	49435086	.	A	G	6	4	10	0	0	10	0	0
1	49447558	.	A	T	1	7	8	0	0	8	0	0
1	49447611	.	A	G	3	5	8	0	0	8	0	0
1	49453465	.	C	G	4	3	7	0	0	7	0	0
1	49453910	.	C	T	4	2	6	0	0	6	0	0
1	49457751	.	G	A	3	6	9	0	0	9	0	0
1	49461033	.	C	A	2	5	7	0	0	7	0	0
1	49461225	.	A	G	6	2	8	0	0	8	0	0
1	49465079	.	G	A	0	4	4	0	1	5	0	0
1	49466190	.	G	A	3	3	6	0	0	6	0	0
1	49473716	.	G	T	8	12	20	0	1	21	0	0
1	49473970	.	G	C	5	6	11	0	0	11	0	0
1	49474079	.	G	A	0	6	6	0	11	17	0	0
1	49474993	.	T	C	8	6	14	0	1	15	0	0
1	49474995	.	C	T	7	7	14	0	1	15	0	0
1	49475714	.	C	T	7	3	10	0	1	11	0	0
1	49475769	.	A	C	7	4	11	0	0	11	0	0
1	49480825	.	T	G	6	4	10	0	0	10	0	0
1	49481546	.	T	A	9	16	25	0	2	27	0	0
1	49481567	.	T	G	9	16	25	0	2	27	0	0
1	49481649	.	T	C	12	12	24	0	2	26	0	0
1	49481787	.	A	G	17	16	33	0	1	34	0	0
1	49481866	.	T	G	15	15	30	0	2	32	0	0
1	49481886	.	A	T	15	10	25	0	1	26	0	0
1	49482742	.	C	T	9	11	20	0	0	20	0	0
1	49482755	.	C	T	11	14	25	0	0	25	0	0
1	49482984	.	T	A	8	5	13	0	1	14	0	0
1	49483217	.	C	G	1	2	3	0	0	3	0	0
1	49483270	.	C	T	8	10	18	0	2	20	0	0
1	49483300	.	A	G	9	9	18	0	1	19	0	0
1	49483679	.	G	A	14	13	27	0	2	29	0	0
1	49483721	.	T	G	17	15	32	0	1	33	0	0
1	49483901	.	T	A	23	18	41	0	1	42	0	0
1	49484002	.	A	T	15	25	40	0	4	44	0	0
1	49484096	.	G	T	26	22	48	0	2	50	0	0
1	49484146	.	G	A	22	20	42	0	1	43	0	0
1	49492396	.	G	A	15	16	31	0	0	31	0	0
1	49497590	.	T	G	4	9	13	0	0	13	0	0
1	49606724	.	A	G	2	2	4	0	0	4	0	0
1	49606801	.	A	G	4	2	6	0	0	6	0	0
1	49607102	.	A	T	6	4	10	0	0	11	1	0
1	49607156	.	T	G	3	3	6	0	0	6	0	0
1	49607370	.	G	A	2	3	5	0	0	5	0	0
1	49607490	.	A	C	1	3	4	0	0	4	0	0
1	49607806	.	A	G	3	2	5	0	0	5	0	0
1	49607835	.	A	T	3	4	7	0	0	7	0	0
1	49607861	.	A	G	3	8	11	0	0	11	0	0
1	49607940	.	G	T	7	3	10	0	0	10	0	0
1	49608014	.	T	C	4	5	9	0	0	9	0	0
1	49608027	.	T	C	2	0	2	0	4	6	0	0
1	49608754	.	C	A	2	4	6	0	0	6	0	0
1	49608784	.	A	C	2	2	4	0	0	4	0	0
1	49608803	.	C	T	1	2	3	0	0	3	0	0
1	49609011	.	C	T	12	5	17	0	0	17	0	0
1	49609024	.	C	T	1	5	6	0	9	15	0	0
1	49609065	.	A	G	7	4	11	0	0	11	0	0
1	49609113	.	G	C	5	0	5	0	3	8	0	0
1	49609191	.	G	A	3	2	5	0	1	6	0	0
1	49609247	.	G	A	4	6	10	0	0	10	0	0
1	49613880	.	C	T	7	5	12	0	0	12	0	0
1	49622992	.	T	C	7	6	13	0	0	13	0	0
1	49625706	.	A	G	2	5	7	0	0	7	0	0
1	49626456	.	C	T	4	7	11	0	1	12	0	0
1	49626514	.	A	G	6	6	12	0	0	12	0	0
1	49627769	.	C	A	1	4	5	0	0	5	0	0
1	49633402	.	T	G	2	5	7	0	0	7	0	0
1	49633426	.	C	A	1	5	6	0	0	6	0	0
1	49648546	.	G	A	4	4	8	0	1	9	0	0
1	49648979	.	G	T	3	2	5	0	0	5	0	0
1	49648996	.	A	T	2	2	4	0	0	4	0	0
1	49649030	.	C	T	0	4	4	0	1	5	0	0
1	49649047	.	T	C	1	3	4	0	0	4	0	0
1	49693244	.	T	C	4	3	7	0	0	7	0	0
1	49694765	.	T	A	4	1	5	0	1	6	0	0
1	49694773	.	T	C	4	2	6	0	0	6	0	0
1	49696076	.	G	A	8	3	11	0	1	12	0	0
1	49814732	.	C	T	13	18	31	0	0	31	0	0
1	49814844	.	C	T	11	14	25	0	1	26	0	0
1	49869672	.	G	A	20	17	37	0	0	37	0	0
1	49902787	.	C	T	4	7	11	0	0	11	0	0
1	49909911	.	A	C	10	7	17	0	1	18	0	0
1	49912827	.	A	G	10	13	23	0	0	23	0	0
1	49912990	.	T	C	6	7	13	0	0	13	0	0
1	49913062	.	A	G	5	19	24	0	1	25	0	0
1	49915208	.	G	A	11	12	23	0	0	23	0	0
1	49915278	.	G	C	4	8	12	0	0	12	0	0
1	49918779	.	T	C	5	10	15	0	0	15	0	0
1	50164729	.	T	C	5	6	11	0	0	11	0	0
1	50178612	.	T	C	10	13	23	0	0	23	0	0
1	50178643	.	A	G	16	0	16	0	13	29	0	0
1	50178921	.	T	C	11	15	26	0	0	26	0	0
1	50178963	.	G	A	11	8	19	0	0	19	0	0
1	50178988	.	A	G	6	2	8	0	11	19	0	0
1	50187511	.	C	T	9	8	17	0	1	18	0	0
1	50187688	.	A	G	11	8	19	0	0	19	0	0
1	50187733	.	A	T	9	8	17	0	0	17	0	0
1	50198792	.	T	C	7	3	10	0	0	10	0	0
1	50265198	.	T	C	7	0	7	0	5	12	0	0
1	50270154	.	G	A	7	7	14	0	0	14	0	0
1	50270166	.	A	G	8	5	13	0	1	14	0	0
1	50270234	.	C	G	4	4	8	0	0	8	0	0
1	50270241	.	T	A	3	4	7	0	0	7	0	0
1	50270280	.	A	G	5	6	11	0	0	11	0	0
1	50272240	.	T	A	6	7	13	0	0	13	0	0
1	50273133	.	G	A	2	8	10	0	0	10	0	0
1	50273295	.	G	A	7	4	11	0	0	11	0	0
1	50284907	.	A	G	2	7	9	0	0	9	0	0
1	50303960	.	C	T	20	8	28	0	1	29	0	0
1	50317687	.	G	A	2	4	6	0	15	21	0	0
1	50317723	.	A	C	20	6	26	0	1	27	0	0
1	50393160	.	C	G	2	5	7	0	1	8	0	0
1	50393232	.	G	T	2	2	4	0	0	4	0	0
1	50414777	.	G	T	2	2	4	0	0	4	0	0
1	50414779	.	A	G	2	2	4	0	0	4	0	0
1	50437827	.	C	T	2	3	5	0	0	5	0	0
1	50438210	.	G	C	2	0	2	0	2	4	0	0
1	50487649	.	G	T	13	9	22	0	0	22	0	0
1	50487895	.	T	C	4	0	4	0	5	9	0	0
1	50487938	.	A	C	7	1	8	0	1	9	0	0
1	50503237	.	G	A	7	5	12	0	0	12	0	0
1	50519961	.	T	C	5	5	10	0	0	10	0	0
1	50524745	.	G	A	3	5	8	0	0	8	0	0
1	50554362	.	A	C	4	2	6	0	0	6	0	0
1	50554597	.	C	T	5	2	7	0	0	7	0	0
1	50582183	.	G	A	2	4	6	0	0	6	0	0
1	50594217	.	T	C	16	17	33	0	1	34	0	0
1	50594239	.	T	A	19	19	38	0	0	38	0	0
1	50594318	.	T	G	5	12	17	0	1	18	0	0
1	50594346	.	A	G	5	13	18	0	1	19	0	0
1	50594771	.	C	A	10	9	19	0	0	19	0	0
1	50594777	.	C	T	11	10	21	0	0	21	0	0
1	50595288	.	T	C	6	1	7	0	17	25	1	0
1	50595387	.	C	T	18	13	31	0	0	31	0	0
1	50595530	.	A	G	10	6	16	0	0	16	0	0
1	50595809	.	T	A	8	22	30	0	0	30	0	0
1	50596694	.	A	G	9	16	25	0	1	26	0	0
1	50596748	.	G	T	6	24	30	0	1	31	0	0
1	50598793	.	C	T	1	17	18	0	15	33	0	0
1	50598872	.	A	G	12	16	28	0	2	30	0	0
1	50608232	.	T	C	11	20	31	0	2	33	0	0
1	50608373	.	G	A	16	14	30	0	1	31	0	0
1	50608505	.	T	C	7	13	20	0	0	20	0	0
1	50608584	.	G	A	11	18	29	0	0	29	0	0
1	50608691	.	A	T	7	14	21	0	0	21	0	0
1	50608692	.	T	C	7	14	21	0	0	21	0	0
1	50610919	.	T	A	10	10	20	0	1	21	0	0
1	50646922	.	G	A	0	7	7	0	6	13	0	0
1	50651760	.	C	T	4	8	12	0	1	13	0	0
1	50652102	.	G	A	7	4	11	0	0	11	0	0
1	50656594	.	T	C	7	10	17	0	1	18	0	0
1	50657063	.	T	G	4	9	13	0	0	13	0	0
1	50657093	.	T	C	5	6	11	0	1	12	0	0
1	50659858	.	G	A	0	5	5	0	5	10	0	0
1	50666916	.	C	T	6	6	12	0	0	12	0	0
1	50666985	.	T	A	4	6	10	0	0	10	0	0
1	50668883	.	C	T	12	7	19	0	0	19	0	0
1	50668915	.	C	T	11	7	18	0	0	18	0	0
1	50670799	.	T	C	4	4	8	0	1	9	0	0
1	50673407	.	T	C	3	8	11	0	1	12	0	0
1	50688682	.	A	T	5	4	9	0	1	10	0	0
1	50691194	.	G	C	0	5	5	0	4	9	0	0
1	50694993	.	T	C	15	11	26	0	0	26	0	0
1	50694994	.	G	T	14	11	25	0	1	26	0	0
1	50698089	.	G	A	4	6	10	0	0	10	0	0
1	50702736	.	C	T	13	8	21	0	0	21	0	0
1	50703007	.	A	G	9	5	14	0	0	14	0	0
1	50795374	.	G	C	3	4	7	0	0	7	0	0
1	50796098	.	T	A	1	2	3	0	0	3	0	0
1	50799728	.	A	T	3	4	7	0	2	9	0	0
1	50803109	.	C	T	0	3	3	0	2	5	0	0
1	50805372	.	G	A	2	2	4	0	0	4	0	0
1	50805460	.	G	A	3	2	5	0	0	5	0	0
1	50808576	.	C	T	1	2	3	0	0	3	0	0
1	50813208	.	A	T	1	3	4	0	0	4	0	0
1	50848106	.	A	G	6	6	12	0	0	12	0	0
1	50848115	.	A	G	6	7	13	0	1	14	0	0
1	50848484	.	C	T	17	7	24	0	1	25	0	0
1	50848504	.	C	T	16	7	23	0	4	27	0	0
1	50848532	.	G	A	15	6	21	0	4	25	0	0
1	50848595	.	T	C	16	7	23	1	8	32	0	0
1	50848609	.	A	C	23	7	30	0	3	33	0	0
1	50848647	.	C	T	2	13	15	0	23	38	0	0
1	50848659	.	A	G	20	12	32	0	0	32	0	0
1	50848815	.	A	G	11	16	27	0	3	30	0	0
1	50848911	.	A	G	10	12	22	0	2	24	0	0
1	50848961	.	C	T	16	13	29	0	2	31	0	0
1	50849055	.	T	C	17	0	17	0	19	36	0	0
1	50849078	.	A	T	16	14	30	0	0	30	0	0
1	50849125	.	T	C	21	17	38	0	3	41	0	0
1	50849163	.	A	G	18	18	36	0	2	38	0	0
1	50849173	.	C	T	18	9	27	0	4	31	0	0
1	50849282	.	A	G	10	13	23	0	1	24	0	0
1	50849331	.	G	A	7	16	23	0	0	23	0	0
1	50849456	.	G	A	12	13	25	0	0	25	0	0
1	50849670	.	A	T	13	6	19	0	0	19	0	0
1	50849697	.	T	C	15	0	15	0	5	20	0	0
1	50849705	.	C	G	13	5	18	0	0	18	0	0
1	50849938	.	T	A	18	11	29	0	0	29	0	0
1	50849942	.	G	A	18	11	29	0	1	30	0	0
1	50850170	.	C	T	13	9	22	0	1	23	0	0
1	50858891	.	A	T	6	2	8	0	1	9	0	0
1	50928918	.	A	G	1	0	1	0	3	4	0	0
1	50929137	.	C	T	3	1	4	0	1	5	0	0
1	50969073	.	A	C	9	26	35	0	0	35	0	0
1	50969081	.	T	C	8	29	37	0	0	37	0	0
1	50969209	.	G	A	24	13	37	0	1	38	0	0
1	50976985	.	A	T	1	4	5	0	0	5	0	0
1	50977008	.	C	A	1	5	6	0	0	6	0	0
1	50977072	.	C	A	11	9	20	0	1	21	0	0
1	50979925	.	T	C	36	27	63	1	3	67	0	0
1	50983906	.	T	C	43	28	71	0	5	76	0	0
1	50986092	.	T	C	43	31	74	0	9	83	0	0
1	50986110	.	A	G	46	35	81	0	3	84	0	0
1	50986197	.	C	A	28	35	63	0	5	68	0	0
1	50987507	.	A	C	40	41	81	0	1	82	0	0
1	50987742	.	C	A	37	36	73	0	1	74	0	0
1	50990593	.	A	G	33	3	36	1	27	64	0	0
1	50990605	.	G	A	28	24	52	1	4	57	0	0
1	50990709	.	T	C	29	22	51	1	3	57	2	0
1	51010416	.	C	T	1	6	7	0	0	7	0	0
1	51012651	.	G	A	1	4	5	0	0	5	0	0
1	51012662	.	A	G	1	3	4	0	0	4	0	0
1	51015594	.	T	A	2	2	4	0	0	4	0	0
1	51021497	.	T	G	5	1	6	0	1	7	0	0
1	51021529	.	C	A	4	3	7	0	0	7	0	0
1	51021591	.	C	A	2	6	8	0	0	8	0	0
1	51021701	.	A	G	5	8	13	0	0	13	0	0
1	51021731	.	G	A	6	4	10	0	0	11	1	0
1	51023877	.	C	T	8	4	12	0	0	12	0	0
1	51024992	.	A	G	5	5	10	0	0	10	0	0
1	51031234	.	G	A	5	5	10	0	0	10	0	0
1	51031476	.	A	G	7	5	12	0	1	13	0	0
1	51040428	.	T	C	28	21	49	0	3	52	0	0
1	51041255	.	T	G	17	1	18	0	16	34	0	0
1	51042228	.	G	A	0	4	4	0	11	15	0	0
1	51042230	.	G	C	11	3	14	0	1	15	0	0
1	51053333	.	G	C	8	3	11	0	0	11	0	0
1	51055896	.	G	C	7	3	10	0	0	10	0	0
1	51056715	.	G	A	5	2	7	0	0	7	0	0
1	51056766	.	C	A	0	5	5	0	4	9	0	0
1	51072911	.	A	C	1	3	4	0	0	4	0	0
1	51073083	.	A	C	2	3	5	0	0	5	0	0
1	51073118	.	T	C	2	2	4	0	1	5	0	0
1	51105513	.	G	A	1	5	6	0	0	6	0	0
1	51110048	.	A	G	1	3	4	0	0	4	0	0
1	51192069	.	C	T	9	7	16	0	1	17	0	0
1	51192074	.	C	A	10	9	19	0	1	20	0	0
1	51193701	.	G	T	0	6	6	0	5	11	0	0
1	51196071	.	G	C	3	6	9	0	0	9	0	0
1	51196095	.	G	A	7	6	13	0	0	13	0	0
1	51196161	.	C	T	7	5	12	0	1	13	0	0
1	51196203	.	T	C	5	2	7	0	1	8	0	0
1	51196233	.	T	C	5	3	8	0	0	8	0	0
1	51196435	.	T	G	5	4	9	0	0	9	0	0
1	51196563	.	A	C	5	4	9	0	0	9	0	0
1	51196863	.	G	A	0	6	6	0	6	12	0	0
1	51197082	.	G	A	6	2	8	0	0	8	0	0
1	51197171	.	C	T	4	2	6	0	0	6	0	0
1	51197193	.	G	T	4	3	7	0	0	7	0	0
1	51197316	.	A	G	8	4	12	0	1	13	0	0
1	51197434	.	C	T	5	5	10	0	0	10	0	0
1	51207210	.	A	C	6	9	15	0	1	16	0	0
1	51210562	.	T	C	10	9	19	0	0	19	0	0
1	51211052	.	A	G	11	10	21	0	1	22	0	0
1	51215290	.	G	A	5	2	7	0	0	7	0	0
1	51215441	.	T	C	2	0	2	0	4	6	0	0
1	51217048	.	C	A	3	3	6	0	0	6	0	0
1	51217063	.	C	A	0	4	4	0	4	8	0	0
1	51217822	.	T	C	5	5	10	0	0	10	0	0
1	51217888	.	A	C	6	5	11	0	0	11	0	0
1	51221347	.	A	G	10	0	10	0	8	18	0	0
1	51221349	.	A	T	11	8	19	0	0	19	0	0
1	51229355	.	C	T	2	5	7	0	1	8	0	0
1	51229464	.	C	G	3	6	9	0	0	9	0	0
1	51229471	.	C	T	0	5	5	0	3	8	0	0
1	51230275	.	T	C	7	3	10	0	0	10	0	0
1	51230277	.	C	G	5	5	10	0	0	10	0	0
1	51230324	.	G	A	4	8	12	0	0	12	0	0
1	51230328	.	C	A	3	8	11	0	1	12	0	0
1	51230404	.	A	G	1	4	5	0	1	6	0	0
1	51230957	.	C	A	0	7	7	0	10	18	1	0
1	51231225	.	A	T	3	3	6	0	0	6	0	0
1	51231228	.	G	T	4	3	7	0	0	7	0	0
1	51233996	.	C	T	0	3	3	0	6	9	0	0
1	51242401	.	G	T	9	3	12	0	0	12	0	0
1	51244814	.	C	T	12	6	18	2	0	20	0	0
1	51246693	.	T	C	3	5	8	0	0	8	0	0
1	51258598	.	A	G	4	6	10	0	0	10	0	0
1	51262273	.	G	A	2	10	12	0	0	12	0	0
1	51263352	.	C	T	3	5	8	0	0	8	0	0
1	51263367	.	C	G	4	5	9	0	0	9	0	0
1	51264192	.	T	A	4	4	8	0	0	9	1	0
1	51264198	.	A	G	4	3	7	0	0	7	0	0
1	51264981	.	G	T	4	2	6	0	0	6	0	0
1	51266226	.	G	A	2	2	4	0	0	4	0	0
1	51349146	.	G	A	0	7	7	0	3	10	0	0
1	51355086	.	G	A	3	6	9	0	0	9	0	0
1	51360980	.	C	T	5	7	12	0	1	13	0	0
1	51365630	.	T	C	5	3	8	0	0	8	0	0
1	51365639	.	T	C	5	2	7	0	0	7	0	0
1	51365672	.	C	T	3	3	6	0	0	6	0	0
1	51365696	.	G	A	0	2	2	0	2	4	0	0
1	51368758	.	T	G	3	6	9	0	0	9	0	0
1	51368776	.	C	A	3	5	8	0	0	8	0	0
1	51369612	.	A	G	6	7	13	0	1	14	0	0
1	51371165	.	T	C	5	8	13	0	0	13	0	0
1	51371166	.	A	C	4	8	12	0	0	12	0	0
1	51372625	.	C	T	7	4	11	0	0	11	0	0
1	51372688	.	C	T	6	5	11	0	0	11	0	0
1	51374087	.	G	A	4	3	7	0	0	7	0	0
1	51374844	.	C	T	8	8	16	0	0	16	0	0
1	51374905	.	A	G	5	10	15	0	0	15	0	0
1	51374976	.	G	A	10	7	17	0	0	17	0	0
1	51375006	.	C	G	11	6	17	0	0	17	0	0
1	51375149	.	T	C	3	6	9	0	0	9	0	0
1	51375170	.	A	T	2	8	10	0	3	13	0	0
1	51377708	.	C	A	7	7	14	0	1	15	0	0
1	51377781	.	A	C	8	11	19	0	1	20	0	0
1	51386764	.	C	G	6	6	12	0	2	14	0	0
1	51395366	.	G	T	4	2	6	0	0	6	0	0
1	51395384	.	A	G	3	2	5	0	1	6	0	0
1	51397595	.	C	T	7	7	14	0	0	14	0	0
1	51397596	.	A	C	6	7	13	0	1	14	0	0
1	51397646	.	C	T	9	8	17	0	0	17	0	0
1	51397677	.	G	A	10	4	14	0	1	15	0	0
1	51397713	.	C	A	9	6	15	0	0	15	0	0
1	51397730	.	T	C	7	9	16	0	2	18	0	0
1	51398024	.	C	T	7	11	18	0	0	18	0	0
1	51398373	.	T	C	6	7	13	0	0	13	0	0
1	51400205	.	T	C	9	7	16	0	0	16	0	0
1	51403499	.	C	A	7	8	15	0	0	15	0	0
1	51403544	.	G	C	11	8	19	0	0	19	0	0
1	51403562	.	C	T	14	9	23	0	0	23	0	0
1	51403599	.	T	A	14	7	21	0	0	21	0	0
1	51403756	.	T	A	9	8	17	0	0	17	0	0
1	51403763	.	C	A	7	6	13	0	0	13	0	0
1	51403995	.	A	T	1	2	3	0	0	3	0	0
1	51404181	.	T	A	1	3	4	0	0	4	0	0
1	51405039	.	T	A	8	3	11	0	0	11	0	0
1	51405153	.	T	C	4	3	7	0	0	7	0	0
1	51405253	.	T	A	3	6	9	0	0	9	0	0
1	51405721	.	G	A	1	4	5	0	0	5	0	0
1	51405986	.	G	T	9	6	15	0	1	16	0	0
1	51406191	.	G	A	1	3	4	0	9	13	0	0
1	51406288	.	C	T	12	15	27	0	1	28	0	0
1	51406358	.	A	C	4	6	10	0	1	11	0	0
1	51406371	.	T	G	3	6	9	0	0	9	0	0
1	51406425	.	A	C	3	3	6	0	0	6	0	0
1	51406450	.	G	A	4	2	6	0	0	6	0	0
1	51416963	.	C	T	9	13	22	0	0	22	0	0
1	51424779	.	A	T	12	10	22	0	2	24	0	0
1	51424813	.	G	A	2	13	15	0	8	23	0	0
1	51424937	.	T	A	4	6	10	0	1	13	2	0
1	51425296	.	G	A	4	12	16	0	0	16	0	0
1	51425476	.	T	A	5	6	11	0	0	11	0	0
1	51426521	.	G	T	2	2	4	0	0	4	0	0
1	51426956	.	T	C	1	2	3	0	0	3	0	0
1	51427231	.	A	G	17	0	17	0	17	34	0	0
1	51427671	.	G	T	16	5	21	0	2	23	0	0
1	51427981	.	T	C	5	13	18	0	0	18	0	0
1	51444718	.	G	A	6	5	11	0	3	14	0	0
1	51445120	.	A	T	11	8	19	0	1	20	0	0
1	51445140	.	T	G	8	5	13	0	1	15	1	0
1	51445217	.	A	T	8	5	13	0	0	13	0	0
1	51445628	.	A	G	13	8	21	0	1	22	0	0
1	51446129	.	T	A	4	5	9	0	0	9	0	0
1	51446195	.	T	C	6	0	6	0	7	13	0	0
1	51446230	.	T	A	3	5	8	0	0	8	0	0
1	51446287	.	C	T	3	7	10	0	1	11	0	0
1	51446451	.	C	T	4	9	13	0	0	13	0	0
1	51446671	.	A	T	2	3	5	0	0	5	0	0
1	51447506	.	T	C	4	5	9	0	0	9	0	0
1	51447573	.	C	T	10	7	17	0	0	17	0	0
1	51447680	.	T	A	9	5	14	0	0	14	0	0
1	51447693	.	G	T	8	5	13	0	0	13	0	0
1	51447728	.	C	T	2	3	5	0	0	5	0	0
1	51447884	.	T	G	2	3	5	0	0	5	0	0
1	51448105	.	A	G	2	2	4	0	0	4	0	0
1	51448367	.	A	G	6	4	10	0	0	10	0	0
1	51448485	.	C	T	10	10	20	0	0	20	0	0
1	51448603	.	C	A	6	8	14	0	1	15	0	0
1	51448635	.	T	C	7	6	13	0	1	14	0	0
1	51448696	.	C	A	7	3	10	0	1	11	0	0
1	51448807	.	C	T	1	5	6	0	0	6	0	0
1	51448810	.	C	T	1	5	6	0	0	6	0	0
1	51449354	.	G	A	1	4	5	0	1	6	0	0
1	51449543	.	G	A	4	3	7	0	0	7	0	0
1	51449556	.	G	A	4	3	7	0	0	7	0	0
1	51449673	.	G	C	5	5	10	0	0	10	0	0
1	51449720	.	G	A	6	5	11	0	1	12	0	0
1	51449895	.	T	C	6	6	12	0	0	12	0	0
1	51450018	.	C	T	1	3	4	0	5	9	0	0
1	51450713	.	G	A	12	5	17	0	0	17	0	0
1	51558008	.	T	C	13	14	27	0	1	28	0	0
1	51558036	.	G	A	16	14	30	0	1	31	0	0
1	51558354	.	T	A	18	13	31	2	3	36	0	0
1	51558463	.	G	A	32	13	45	0	1	46	0	0
1	51558604	.	C	T	23	21	44	1	2	47	0	0
1	51558730	.	G	T	21	18	39	0	1	40	0	0
1	51558903	.	A	C	22	17	39	0	2	41	0	0
1	51559060	.	C	G	20	30	50	0	6	56	0	0
1	51562800	.	A	G	15	27	42	0	3	45	0	0
1	51567367	.	A	G	28	15	43	0	4	47	0	0
1	51591352	.	A	G	29	26	55	0	1	56	0	0
1	51594068	.	A	C	9	10	19	0	0	19	0	0
1	51594447	.	A	G	21	15	36	0	1	37	0	0
1	51594453	.	A	G	22	15	37	0	2	39	0	0
1	51594485	.	A	C	18	12	30	0	2	32	0	0
1	51594883	.	C	T	3	15	18	0	25	43	0	0
1	51609002	.	A	T	15	13	28	0	1	29	0	0
1	51612371	.	G	T	16	19	35	0	2	37	0	0
1	51612408	.	C	G	20	16	36	0	0	36	0	0
1	51615110	.	T	C	13	0	13	0	23	36	0	0
1	51615436	.	G	T	1	6	7	0	1	8	0	0
1	51703824	.	C	T	3	8	11	0	0	11	0	0
1	51703863	.	T	C	7	0	7	0	12	19	0	0
1	51709481	.	G	A	10	7	17	0	0	17	0	0
1	51713077	.	G	A	6	5	11	0	0	11	0	0
1	51713468	.	C	T	10	3	13	0	0	13	0	0
1	51719005	.	G	A	3	2	5	0	0	5	0	0
1	51719037	.	A	C	3	1	4	0	4	8	0	0
1	51721923	.	T	G	24	15	39	0	0	39	0	0
1	51723093	.	T	G	22	1	23	1	21	45	0	0
1	51723440	.	T	C	28	20	48	0	1	49	0	0
1	51723461	.	A	T	24	20	44	0	2	46	0	0
1	51726524	.	C	T	25	27	52	0	4	56	0	0
1	51727432	.	C	A	29	21	50	0	0	50	0	0
1	51729506	.	C	T	29	13	42	0	0	42	0	0
1	51729572	.	A	G	22	0	22	0	18	40	0	0
1	51729605	.	G	A	17	12	29	0	0	29	0	0
1	51729608	.	G	T	18	9	27	0	1	28	0	0
1	51729750	.	C	A	11	15	26	0	2	28	0	0
1	51733129	.	T	A	8	9	17	0	0	17	0	0
1	51733284	.	T	A	14	12	26	0	1	27	0	0
1	51734087	.	T	C	14	15	29	0	5	34	0	0
1	51734449	.	C	T	1	14	15	0	22	37	0	0
1	51869166	.	A	T	1	2	3	0	0	3	0	0
1	51896185	.	A	G	1	0	1	0	5	6	0	0
1	51903897	.	A	T	3	5	8	0	0	8	0	0
1	51903903	.	A	T	3	3	6	0	0	6	0	0
1	51960576	.	G	C	8	8	16	0	0	16	0	0
1	51960615	.	T	C	7	10	17	0	2	19	0	0
1	51961020	.	T	C	9	13	22	0	1	23	0	0
1	52073807	.	C	G	19	23	42	0	0	42	0	0
1	52150974	.	A	G	14	9	23	0	0	23	0	0
1	52152043	.	A	G	3	4	7	0	0	7	0	0
1	52152121	.	A	G	8	6	14	0	1	15	0	0
1	52152131	.	A	G	8	8	16	0	1	17	0	0
1	52152165	.	A	G	13	4	17	0	1	18	0	0
1	52452275	.	G	T	5	5	10	0	2	12	0	0
1	52452332	.	C	T	9	10	19	0	0	19	0	0
1	52455908	.	G	A	11	8	19	0	1	20	0	0
1	52455960	.	C	T	8	12	20	0	0	20	0	0
1	52456002	.	G	A	7	11	18	0	1	19	0	0
1	52460737	.	C	T	12	9	21	0	0	21	0	0
1	52460739	.	T	C	12	9	21	0	0	21	0	0
1	52460906	.	T	C	9	4	13	1	0	14	0	0
1	52460944	.	G	T	9	4	13	1	0	15	1	0
1	52465412	.	C	T	3	5	8	0	0	8	0	0
1	52466623	.	A	T	2	6	8	0	0	8	0	0
1	52469726	.	C	T	4	3	7	0	0	7	0	0
1	52469771	.	T	C	6	4	10	0	0	10	0	0
1	52474010	.	C	T	3	6	9	0	0	9	0	0
1	52478600	.	A	T	2	3	5	0	0	5	0	0
1	52482703	.	G	A	2	4	6	0	2	8	0	0
1	52482720	.	G	A	2	3	5	0	0	5	0	0
1	52482756	.	C	T	6	3	9	0	0	9	0	0
1	52485177	.	G	A	1	5	6	0	1	7	0	0
1	52485216	.	T	C	5	5	10	0	0	10	0	0
1	52486125	.	T	C	6	3	9	0	0	9	0	0
1	52486198	.	A	G	7	0	7	0	11	18	0	0
1	52486209	.	A	G	6	11	17	0	1	18	0	0
1	52486716	.	A	G	1	0	1	0	5	6	0	0
1	52486772	.	C	G	3	4	7	0	0	7	0	0
1	52486829	.	A	G	6	2	8	0	0	8	0	0
1	52489974	.	G	A	0	3	3	0	8	11	0	0
1	52493757	.	A	G	1	3	4	0	0	4	0	0
1	52495004	.	T	A	3	2	5	2	0	7	0	0
1	52495082	.	C	G	1	4	5	4	0	9	0	0
1	52495088	.	G	A	1	3	4	5	0	9	0	0
1	52497885	.	C	T	2	2	4	0	0	4	0	0
1	52501213	.	A	C	3	0	3	0	5	8	0	0
1	52501794	.	T	C	1	3	4	0	0	4	0	0
1	52501800	.	G	A	1	2	3	0	0	3	0	0
1	52535913	.	G	A	2	2	4	0	0	4	0	0
1	52536561	.	A	G	3	2	5	0	0	5	0	0
1	52560607	.	G	A	0	7	7	0	6	13	0	0
1	52574973	.	G	A	1	5	6	0	0	6	0	0
1	52577777	.	G	A	5	10	15	0	2	17	0	0
1	52595043	.	C	A	7	2	9	0	0	9	0	0
1	52595160	.	C	A	5	5	10	0	0	10	0	0
1	52598538	.	C	T	5	5	10	0	0	10	0	0
1	52598549	.	A	G	4	5	9	0	0	9	0	0
1	52599152	.	G	C	6	6	12	0	0	12	0	0
1	52599189	.	G	A	1	7	8	0	5	13	0	0
1	52599557	.	C	T	4	4	8	0	0	8	0	0
1	52603345	.	T	C	6	9	15	0	0	15	0	0
1	52609221	.	G	A	5	9	14	0	0	14	0	0
1	52609347	.	C	T	10	4	14	0	0	14	0	0
1	52609392	.	C	T	10	3	13	0	0	13	0	0
1	52609654	.	T	G	6	0	6	0	5	11	0	0
1	52610546	.	C	G	5	0	5	0	4	9	0	0
1	52611963	.	A	G	10	6	16	0	0	16	0	0
1	52612987	.	T	C	10	12	22	0	0	22	0	0
1	52614253	.	C	T	7	7	14	0	0	14	0	0
1	52614926	.	T	A	8	10	18	0	0	19	1	0
1	52615031	.	C	T	6	11	17	0	1	18	0	0
1	52618138	.	G	A	1	11	12	0	15	27	0	0
1	52618168	.	G	A	1	5	6	0	20	26	0	0
1	52618204	.	T	C	15	9	24	0	1	25	0	0
1	52621542	.	C	T	14	10	24	0	0	24	0	0
1	52621545	.	C	T	14	10	24	0	1	25	0	0
1	52623591	.	G	A	11	15	26	0	0	26	0	0
1	52623681	.	G	A	9	15	24	0	2	26	0	0
1	52623783	.	C	T	13	19	32	0	0	32	0	0
1	52625807	.	C	T	5	7	12	1	1	14	0	0
1	52626360	.	T	A	6	17	23	0	1	24	0	0
1	52626704	.	A	G	6	4	10	0	0	10	0	0
1	52626782	.	A	T	6	8	14	0	0	14	0	0
1	52626790	.	C	T	4	10	14	0	0	14	0	0
1	52626857	.	A	G	4	0	4	0	5	9	0	0
1	52626865	.	C	T	7	3	10	0	0	10	0	0
1	52626998	.	A	T	5	11	16	0	0	16	0	0
1	52627007	.	T	G	4	10	14	0	1	15	0	0
1	52627044	.	T	G	8	7	15	0	0	15	0	0
1	52627290	.	C	T	12	5	17	6	0	23	0	0
1	52627301	.	T	C	9	6	15	6	2	23	0	0
1	52627568	.	A	T	29	10	39	0	0	39	0	0
1	52627697	.	T	G	18	11	29	0	0	29	0	0
1	52628178	.	G	A	0	6	6	0	9	15	0	0
1	52628205	.	T	C	8	4	12	0	0	12	0	0
1	52628322	.	A	T	4	4	8	0	1	9	0	0
1	52635625	.	C	G	1	2	3	0	0	3	0	0
1	52659498	.	A	G	1	4	5	0	0	5	0	0
1	52673392	.	T	C	5	3	8	0	0	8	0	0
1	52673398	.	A	G	8	0	8	0	3	11	0	0
1	52673464	.	A	T	7	5	12	0	0	12	0	0
1	52676405	.	A	G	15	5	20	0	0	20	0	0
1	52679960	.	G	A	6	7	13	0	0	13	0	0
1	52680016	.	C	T	6	9	15	0	0	15	0	0
1	52682847	.	C	T	11	15	26	0	0	26	0	0
1	52682850	.	T	C	11	15	26	0	1	27	0	0
1	52685145	.	A	C	8	6	14	0	0	14	0	0
1	52688223	.	G	A	0	5	5	0	13	18	0	0
1	52688274	.	G	A	15	7	22	0	1	23	0	0
1	52688355	.	C	T	14	9	23	0	2	25	0	0
1	52698955	.	C	T	18	10	28	1	1	30	0	0
1	52764873	.	G	T	6	3	9	0	4	13	0	0
1	52765120	.	T	A	8	11	19	0	1	20	0	0
1	52773239	.	G	A	14	13	27	0	0	27	0	0
1	52780566	.	C	T	10	13	23	0	0	23	0	0
1	52782090	.	C	T	15	20	35	0	1	36	0	0
1	52784483	.	C	A	10	13	23	0	0	23	0	0
1	52784527	.	C	T	2	8	10	0	10	20	0	0
1	52784600	.	G	A	13	6	19	0	1	20	0	0
1	52784624	.	T	A	13	5	18	0	1	19	0	0
1	52784679	.	G	C	8	5	13	0	0	13	0	0
1	52784702	.	G	A	8	8	16	0	3	19	0	0
1	52792557	.	A	T	17	10	27	0	0	27	0	0
1	52792564	.	A	T	13	11	24	0	0	24	0	0
1	52792613	.	C	A	16	6	22	1	0	23	0	0
1	52794568	.	T	C	9	11	20	0	2	22	0	0
1	52796142	.	T	C	13	9	22	0	1	23	0	0
1	52796148	.	A	G	12	10	22	0	2	24	0	0
1	52796844	.	T	G	12	9	21	0	0	21	0	0
1	52796850	.	C	T	9	10	19	0	1	20	0	0
1	52797110	.	C	T	9	7	16	0	0	16	0	0
1	52797239	.	C	T	6	7	13	0	1	14	0	0
1	52798991	.	T	C	10	13	23	0	1	24	0	0
1	52798994	.	C	T	9	11	20	0	2	22	0	0
1	52800088	.	A	C	12	10	22	0	0	22	0	0
1	52811937	.	A	T	16	5	21	0	0	21	0	0
1	52811940	.	C	T	14	5	19	0	0	19	0	0
1	52812162	.	G	A	12	14	26	0	0	26	0	0
1	52816085	.	G	A	16	7	23	0	2	25	0	0
1	52816438	.	C	T	16	15	31	0	0	31	0	0
1	52816740	.	A	T	17	12	29	0	2	31	0	0
1	52816749	.	G	A	0	14	14	0	16	30	0	0
1	52817949	.	C	G	15	14	29	0	0	29	0	0
1	52817988	.	C	T	14	16	30	0	3	33	0	0
1	52820489	.	C	T	15	17	32	0	4	36	0	0
1	53007848	.	G	A	1	11	12	0	6	18	0	0
1	53025666	.	C	T	9	14	23	0	0	23	0	0
1	53025708	.	C	G	9	16	25	0	1	26	0	0
1	53025711	.	C	T	10	14	24	0	0	24	0	0
1	53061153	.	C	G	16	12	28	0	0	28	0	0
1	53065587	.	G	A	0	11	11	0	11	22	0	0
1	53065611	.	G	T	7	9	16	0	0	16	0	0
1	53099687	.	A	G	13	13	26	0	0	26	0	0
1	53099735	.	C	A	14	8	22	0	0	22	0	0
1	53132842	.	G	C	7	12	19	0	2	21	0	0
1	53156413	.	C	T	11	12	23	0	2	25	0	0
1	53166056	.	G	T	20	13	33	0	2	35	0	0
1	53166094	.	A	G	18	17	35	0	0	35	0	0
1	53185877	.	A	C	13	18	31	0	1	32	0	0
1	53185906	.	T	C	15	13	28	0	3	31	0	0
1	53193288	.	C	T	16	11	27	0	0	27	0	0
1	53198739	.	C	A	17	10	27	0	0	27	0	0
1	53201918	.	G	A	1	17	18	0	18	36	0	0
1	53235011	.	T	C	2	2	4	0	0	4	0	0
1	53269670	.	A	C	6	14	20	0	2	22	0	0
1	53293269	.	G	A	0	3	3	0	3	6	0	0
1	53296672	.	C	T	1	2	3	0	0	3	0	0
1	53296710	.	C	T	1	3	4	0	0	4	0	0
1	53296818	.	A	G	1	5	6	1	0	7	0	0
1	53334424	.	T	G	14	8	22	0	2	24	0	0
1	53334460	.	C	T	10	15	25	0	0	25	0	0
1	53338602	.	T	C	10	11	21	0	1	22	0	0
1	53338623	.	C	T	13	13	26	0	0	26	0	0
1	53341634	.	A	G	6	13	19	1	0	20	0	0
1	53343124	.	G	A	11	9	20	0	1	21	0	0
1	53343530	.	T	C	15	12	27	0	0	27	0	0
1	53344250	.	T	A	8	9	17	0	0	17	0	0
1	53344259	.	T	A	9	7	16	0	1	17	0	0
1	53348848	.	T	C	16	19	35	0	0	35	0	0
1	53348878	.	A	G	20	16	36	0	0	36	0	0
1	53348920	.	A	G	11	14	25	0	2	27	0	0
1	53350703	.	T	C	10	13	23	0	0	23	0	0
1	53359002	.	C	T	12	19	31	0	0	31	0	0
1	53359867	.	T	G	11	9	20	0	2	22	0	0
1	53359876	.	A	G	14	0	14	0	9	23	0	0
1	53360243	.	C	A	16	12	28	0	2	30	0	0
1	53360308	.	G	A	19	13	32	0	0	32	0	0
1	53360342	.	C	T	15	13	28	0	0	28	0	0
1	53360369	.	C	T	14	12	26	0	1	27	0	0
1	53360474	.	G	T	14	27	41	0	1	42	0	0
1	53360821	.	G	A	3	10	13	0	9	22	0	0
1	53360871	.	G	A	3	7	10	0	1	11	0	0
1	53364929	.	A	G	7	20	27	0	2	29	0	0
1	53364948	.	C	A	9	18	27	0	1	28	0	0
1	53378728	.	G	A	0	7	7	0	5	12	0	0
1	53380062	.	T	C	5	5	10	0	0	10	0	0
1	53381877	.	T	C	11	11	22	0	0	22	0	0
1	53385017	.	G	A	0	6	6	0	13	19	0	0
1	53387673	.	C	T	3	4	7	0	1	8	0	0
1	53387829	.	C	T	6	12	18	0	0	18	0	0
1	53387954	.	A	G	11	5	16	0	1	17	0	0
1	53388053	.	G	A	2	13	15	0	11	26	0	0
1	53388309	.	G	C	19	13	32	0	0	32	0	0
1	53388367	.	T	A	8	12	20	0	2	22	0	0
1	53388540	.	T	A	12	9	21	0	2	23	0	0
1	53391669	.	A	C	10	15	25	0	1	26	0	0
1	53391760	.	G	A	8	5	13	1	1	15	0	0
1	53391916	.	C	T	6	3	9	0	0	9	0	0
1	53392064	.	T	C	4	0	4	0	11	15	0	0
1	53393510	.	C	T	0	2	2	0	3	5	0	0
1	53394120	.	G	C	2	0	2	0	3	5	0	0
1	53394148	.	A	G	4	4	8	0	0	8	0	0
1	53394200	.	T	A	2	2	4	0	0	4	0	0
1	53394826	.	T	C	2	3	5	0	1	6	0	0
1	53395627	.	T	C	9	3	12	0	1	13	0	0
1	53395828	.	G	A	13	13	26	0	1	27	0	0
1	53401794	.	T	C	10	9	19	0	0	19	0	0
1	53491678	.	A	C	3	5	8	1	0	9	0	0
1	53491799	.	T	G	6	5	11	0	1	12	0	0
1	53501909	.	C	G	9	16	25	0	0	25	0	0
1	53501918	.	G	A	8	16	24	0	0	24	0	0
1	53568515	.	G	T	8	15	23	0	0	23	0	0
1	53568846	.	A	T	8	13	21	0	0	21	0	0
1	53570142	.	T	C	3	13	16	0	1	17	0	0
1	53572772	.	T	A	3	5	8	0	0	9	1	0
1	53575478	.	C	A	8	7	15	0	0	15	0	0
1	53579023	.	A	G	8	5	13	0	3	16	0	0
1	53581312	.	G	A	7	10	17	0	0	18	1	0
1	53581492	.	G	A	4	7	11	0	0	11	0	0
1	53584411	.	C	A	6	7	13	0	0	13	0	0
1	53585575	.	A	C	2	0	2	0	4	6	0	0
1	53585593	.	A	G	2	3	5	0	1	6	0	0
1	53586376	.	C	T	0	2	2	0	4	6	0	0
1	53593004	.	G	T	4	5	9	0	0	9	0	0
1	53594734	.	T	C	3	7	10	0	0	10	0	0
1	53595753	.	G	A	3	4	7	0	3	10	0	0
1	53595881	.	C	G	4	3	7	0	0	7	0	0
1	53597404	.	G	A	4	7	11	0	0	11	0	0
1	53599421	.	A	G	4	7	11	0	0	11	0	0
1	53599881	.	A	T	4	6	10	0	0	10	0	0
1	53601789	.	C	T	1	3	4	0	0	4	0	0
1	53601819	.	T	C	1	0	1	0	4	5	0	0
1	53604461	.	A	T	2	2	4	0	0	4	0	0
1	53605233	.	G	A	7	4	11	0	0	11	0	0
1	53605290	.	G	A	1	2	3	0	1	4	0	0
1	53605622	.	G	T	2	4	6	0	1	7	0	0
1	53605808	.	C	T	1	4	5	0	1	6	0	0
1	53611019	.	T	C	3	6	9	0	0	9	0	0
1	53659267	.	A	C	6	13	19	0	1	20	0	0
1	53661577	.	T	G	8	11	19	0	0	19	0	0
1	53663391	.	G	A	9	9	18	0	1	19	0	0
1	53663478	.	G	T	7	9	16	0	0	16	0	0
1	53663487	.	C	T	7	8	15	0	0	15	0	0
1	53664677	.	C	G	9	7	16	0	1	17	0	0
1	53665339	.	C	T	9	6	15	0	1	16	0	0
1	53666888	.	A	G	9	7	16	0	0	16	0	0
1	53666936	.	A	G	4	6	10	0	1	11	0	0
1	53666993	.	T	G	4	9	13	0	1	14	0	0
1	53667026	.	A	T	8	13	21	0	0	21	0	0
1	53667080	.	T	C	7	11	18	0	0	18	0	0
1	53668926	.	C	A	9	9	18	0	1	19	0	0
1	53671009	.	A	G	5	7	12	0	0	12	0	0
1	53673609	.	C	T	1	9	10	0	10	20	0	0
1	53674825	.	G	A	4	8	12	0	0	12	0	0
1	53676679	.	C	T	1	5	6	0	7	13	0	0
1	53676715	.	G	A	6	5	11	0	0	11	0	0
1	53676727	.	G	C	5	4	9	0	0	9	0	0
1	53677131	.	C	T	6	4	10	0	0	10	0	0
1	53680473	.	A	G	3	4	7	0	0	7	0	0
1	53684632	.	A	G	8	7	15	0	1	16	0	0
1	53684729	.	C	T	8	7	15	1	0	16	0	0
1	53703149	.	G	A	19	16	35	1	2	38	0	0
1	53704485	.	C	A	31	25	56	0	0	56	0	0
1	53704530	.	A	G	25	23	48	0	2	50	0	0
1	53707177	.	G	C	14	0	14	0	21	35	0	0
1	53709762	.	C	T	13	14	27	0	0	27	0	0
1	53709858	.	A	T	18	14	32	0	1	33	0	0
1	53709882	.	G	A	22	10	32	0	0	32	0	0
1	53714586	.	A	G	13	13	26	0	3	29	0	0
1	53714727	.	C	A	30	19	49	0	1	50	0	0
1	53714733	.	C	T	30	19	49	0	3	52	0	0
1	53714790	.	T	A	14	33	47	0	0	47	0	0
1	53715083	.	G	A	4	4	8	0	0	8	0	0
1	53717050	.	T	C	4	3	7	0	0	7	0	0
1	53718264	.	G	A	2	2	4	0	0	4	0	0
1	53724724	.	T	A	6	5	11	0	0	11	0	0
1	53724775	.	G	A	0	6	6	0	7	13	0	0
1	53726457	.	G	A	9	6	15	0	0	15	0	0
1	53727755	.	C	T	5	6	11	0	0	11	0	0
1	53735245	.	C	T	12	5	17	2	0	19	0	0
1	53735702	.	T	G	15	11	26	0	0	26	0	0
1	53735712	.	G	A	16	8	24	0	1	25	0	0
1	53735977	.	G	C	19	0	19	0	21	40	0	0
1	53737199	.	G	A	18	14	32	1	1	34	0	0
1	53739397	.	G	A	19	11	30	0	3	33	0	0
1	53756723	.	C	T	2	14	16	0	19	35	0	0
1	53866033	.	T	A	2	3	5	0	0	5	0	0
1	53866041	.	T	C	2	3	5	0	0	5	0	0
1	53866075	.	C	T	3	6	9	0	0	9	0	0
1	53866223	.	A	T	3	3	6	0	0	6	0	0
1	53866319	.	C	T	1	11	12	0	8	20	0	0
1	53868941	.	A	G	3	8	11	0	0	11	0	0
1	53871383	.	A	G	5	5	10	0	0	11	1	0
1	53872061	.	C	T	7	9	16	0	3	19	0	0
1	53872067	.	T	C	9	0	9	0	9	18	0	0
1	53873154	.	A	G	5	10	15	0	0	15	0	0
1	53873277	.	A	C	5	1	6	0	0	6	0	0
1	53873278	.	C	T	4	1	5	0	1	6	0	0
1	53880610	.	T	C	3	4	7	0	0	7	0	0
1	53912148	.	A	G	2	3	5	0	0	5	0	0
1	53912418	.	G	T	6	2	8	0	1	9	0	0
1	53912637	.	A	G	5	5	10	0	0	10	0	0
1	53912670	.	A	G	4	2	6	0	0	6	0	0
1	53914976	.	A	G	8	4	12	0	0	12	0	0
1	53914977	.	T	A	8	4	12	0	0	12	0	0
1	53918671	.	C	T	1	2	3	0	1	4	0	0
1	53919219	.	C	G	4	2	6	0	0	6	0	0
1	53921783	.	T	C	2	3	5	0	1	6	0	0
1	53921786	.	G	A	3	3	6	0	0	6	0	0
1	53921894	.	T	C	4	2	6	0	0	6	0	0
1	53923793	.	A	G	2	0	2	0	3	5	0	0
1	53923883	.	A	T	2	4	6	0	0	6	0	0
1	53923910	.	C	T	3	2	5	0	1	6	0	0
1	53930468	.	T	C	3	5	8	0	1	9	0	0
1	53934495	.	C	A	6	4	10	0	0	10	0	0
1	54206955	.	T	C	1	4	5	0	1	6	0	0
1	54209203	.	T	C	3	6	9	0	0	9	0	0
1	54219453	.	A	C	7	3	10	0	0	10	0	0
1	54219462	.	A	G	6	0	6	0	3	9	0	0
1	54220446	.	G	A	3	7	10	0	5	15	0	0
1	54221930	.	T	C	4	6	10	5	0	15	0	0
1	54221936	.	T	C	4	6	10	5	0	15	0	0
1	54230190	.	G	A	1	3	4	0	4	8	0	0
1	54244041	.	T	C	8	3	11	0	0	11	0	0
1	54244432	.	T	C	8	7	15	0	0	15	0	0
1	54255786	.	A	G	10	13	23	0	4	27	0	0
1	54255804	.	G	C	0	14	14	0	17	31	0	0
1	54255822	.	C	T	15	11	26	0	1	27	0	0
1	54264832	.	G	A	1	9	10	0	25	35	0	0
1	54264835	.	G	T	25	8	33	0	2	35	0	0
1	54271276	.	A	G	12	0	12	0	13	25	0	0
1	54271282	.	C	T	12	12	24	0	0	24	0	0
1	54273753	.	A	G	7	0	7	0	16	23	0	0
1	54273824	.	A	G	8	12	20	0	1	21	0	0
1	54274038	.	G	C	16	13	29	0	2	31	0	0
1	54274049	.	G	A	11	15	26	0	1	27	0	0
1	54274125	.	T	C	13	9	22	0	0	22	0	0
1	54274143	.	T	A	12	8	20	0	1	21	0	0
1	54274500	.	C	T	4	4	8	0	0	8	0	0
1	54274509	.	A	T	4	8	12	0	0	12	0	0
1	54274611	.	T	G	8	4	12	0	0	12	0	0
1	54274725	.	G	A	4	4	8	0	1	9	0	0
1	54274841	.	C	A	1	2	3	0	0	3	0	0
1	54282280	.	A	G	2	2	4	0	0	4	0	0
1	54282281	.	C	T	0	1	1	0	3	4	0	0
1	54282318	.	G	A	1	2	3	0	0	3	0	0
1	54614517	.	C	T	1	2	3	0	0	3	0	0
1	54617093	.	A	C	2	2	4	0	0	4	0	0
1	54618763	.	G	A	2	2	4	0	0	4	0	0
1	54674086	.	C	T	4	5	9	0	0	9	0	0
1	54674255	.	A	G	10	12	22	0	0	22	0	0
1	54674384	.	G	T	14	14	28	0	0	28	0	0
1	54674388	.	A	G	14	14	28	0	0	28	0	0
1	54677238	.	A	G	5	0	5	0	15	20	0	0
1	54677415	.	C	G	16	15	31	0	1	32	0	0
1	54677616	.	C	T	15	22	37	0	4	41	0	0
1	54677752	.	C	T	17	23	40	1	1	42	0	0
1	54677757	.	A	G	17	24	41	1	1	43	0	0
1	54677805	.	T	C	14	23	37	1	2	40	0	0
1	54677907	.	T	C	17	19	36	0	1	37	0	0
1	54677928	.	T	C	19	17	36	0	2	38	0	0
1	54677958	.	T	C	11	23	34	0	0	34	0	0
1	54677981	.	T	C	16	20	36	0	0	36	0	0
1	54678030	.	C	T	27	16	43	0	1	44	0	0
1	54678036	.	T	C	26	14	40	0	5	45	0	0
1	54678144	.	T	A	18	17	35	0	2	37	0	0
1	54679715	.	T	C	20	16	36	0	2	38	0	0
1	54683743	.	C	T	8	6	14	0	0	14	0	0
1	54685500	.	G	A	9	6	15	0	0	15	0	0
1	54685742	.	A	G	5	0	5	0	10	15	0	0
1	54687523	.	T	C	4	3	7	0	0	7	0	0
1	54687598	.	A	G	2	3	5	0	0	5	0	0
1	54687715	.	C	A	9	7	16	1	0	17	0	0
1	54687747	.	T	C	5	9	14	1	0	15	0	0
1	54687821	.	C	G	8	3	11	4	0	15	0	0
1	54687830	.	A	G	8	5	13	4	0	17	0	0
1	54689359	.	A	G	7	0	7	0	10	17	0	0
1	54693613	.	C	T	9	9	18	0	0	18	0	0
1	54693968	.	T	G	3	3	6	0	1	7	0	0
1	54701186	.	C	T	12	15	27	0	0	27	0	0
1	54701201	.	C	G	5	14	19	0	8	27	0	0
1	54701338	.	G	A	10	10	20	0	0	20	0	0
1	54701782	.	C	T	1	10	11	0	4	15	0	0
1	54703400	.	G	A	4	11	15	0	0	15	0	0
1	54703424	.	A	C	10	11	21	0	2	23	0	0
1	54703469	.	C	T	0	13	13	0	15	28	0	0
1	54707719	.	T	C	6	13	19	0	0	19	0	0
1	54707846	.	A	G	33	25	58	0	3	61	0	0
1	54707885	.	C	G	2	19	21	0	36	57	0	0
1	54707894	.	T	G	39	20	59	0	0	59	0	0
1	54707937	.	A	G	46	13	59	0	2	61	0	0
1	54708057	.	C	G	1	26	27	0	36	63	0	0
1	54708096	.	C	G	2	31	33	0	25	58	0	0
1	54708098	.	G	T	25	29	54	0	3	57	0	0
1	54708191	.	C	A	31	27	58	0	1	59	0	0
1	54708281	.	A	T	27	37	64	0	1	65	0	0
1	54708301	.	A	C	27	29	56	0	0	56	0	0
1	54708317	.	C	T	25	28	53	0	1	54	0	0
1	54708365	.	T	C	34	26	60	0	1	61	0	0
1	54708416	.	T	G	25	18	43	0	1	45	1	0
1	54708636	.	T	C	13	18	31	0	3	34	0	0
1	54708773	.	A	C	16	18	34	0	2	36	0	0
1	54708781	.	A	G	16	20	36	0	0	36	0	0
1	54708946	.	T	C	9	14	23	0	0	23	0	0
1	54709239	.	A	T	16	29	45	0	1	46	0	0
1	54709334	.	G	A	20	31	51	0	0	51	0	0
1	54709456	.	G	A	28	31	59	0	4	63	0	0
1	54711853	.	G	A	43	24	67	0	3	70	0	0
1	54714955	.	G	A	32	31	63	0	5	68	0	0
1	54715009	.	T	C	30	2	32	0	36	68	0	0
1	54715027	.	T	C	36	2	38	0	28	66	0	0
1	54715155	.	G	T	24	38	62	0	3	65	0	0
1	54715183	.	A	G	23	34	57	0	5	62	0	0
1	54726184	.	G	A	1	3	4	0	0	4	0	0
1	54731849	.	T	G	1	3	4	0	0	4	0	0
1	54737684	.	A	G	4	0	4	0	9	13	0	0
1	54737747	.	C	T	6	2	8	0	0	8	0	0
1	54737768	.	C	A	6	4	10	0	0	10	0	0
1	54747729	.	A	G	2	0	2	0	2	4	0	0
1	54747786	.	A	C	4	4	8	0	0	8	0	0
1	54747993	.	T	G	3	4	7	0	0	7	0	0
1	54750500	.	G	A	0	7	7	0	3	10	0	0
1	54753047	.	G	A	3	9	12	0	1	13	0	0
1	54753095	.	T	G	3	0	3	0	7	10	0	0
1	54753101	.	T	C	3	6	9	0	1	10	0	0
1	54753167	.	A	G	8	4	12	0	0	12	0	0
1	54753366	.	A	G	12	18	30	0	0	30	0	0
1	54753401	.	A	T	14	14	28	0	0	28	0	0
1	54753445	.	T	A	12	15	27	0	0	27	0	0
1	54753490	.	C	T	9	13	22	1	0	23	0	0
1	54753623	.	T	G	2	3	5	0	0	5	0	0
1	54753654	.	A	C	2	3	5	0	0	5	0	0
1	54753694	.	A	G	1	4	5	0	0	5	0	0
1	54753731	.	A	G	1	3	4	0	0	4	0	0
1	54753915	.	T	C	5	6	11	0	2	13	0	0
1	54754709	.	C	T	10	7	17	0	2	19	0	0
1	54754744	.	C	T	3	11	14	0	2	17	1	0
1	54754754	.	T	C	6	9	15	0	0	15	0	0
1	54754795	.	T	C	3	11	14	0	1	15	0	0
1	54754799	.	G	A	1	12	13	0	2	15	0	0
1	54754834	.	C	T	6	10	16	0	0	16	0	0
1	54754839	.	C	T	8	10	18	0	1	19	0	0
1	54758581	.	T	C	2	1	3	0	9	12	0	0
1	54758634	.	T	C	11	5	16	0	2	18	0	0
1	54758783	.	T	G	11	21	32	0	0	32	0	0
1	54758877	.	C	A	1	10	11	0	26	37	0	0
1	54758975	.	T	C	23	6	29	0	2	31	0	0
1	54759028	.	A	G	19	9	28	1	3	32	0	0
1	54762997	.	G	T	24	13	37	0	2	39	0	0
1	54763133	.	T	C	6	5	11	0	1	12	0	0
1	54763182	.	A	G	15	8	23	0	0	23	0	0
1	54895010	.	C	T	5	6	11	0	1	12	0	0
1	54898489	.	A	T	10	7	17	0	1	18	0	0
1	54900783	.	C	T	10	9	19	0	1	20	0	0
1	54906069	.	T	C	7	14	21	0	1	22	0	0
1	54906081	.	A	C	8	15	23	0	1	24	0	0
1	54906452	.	T	C	7	8	15	0	1	16	0	0
1	54906476	.	G	C	0	13	13	0	6	19	0	0
1	54906619	.	T	A	3	14	17	0	1	18	0	0
1	54906662	.	T	C	7	7	14	0	0	14	0	0
1	54906820	.	T	C	11	7	18	0	0	18	0	0
1	54907043	.	G	T	4	12	16	0	0	16	0	0
1	54907534	.	T	C	10	8	18	0	0	18	0	0
1	54907585	.	G	C	19	7	26	0	0	26	0	0
1	54907622	.	T	C	14	8	22	0	0	22	0	0
1	54907693	.	G	T	7	4	11	0	0	11	0	0
1	54907733	.	T	A	4	2	6	0	1	7	0	0
1	54907744	.	G	A	3	2	5	0	1	6	0	0
1	54911551	.	A	T	3	4	7	0	0	7	0	0
1	54911619	.	T	C	6	3	9	0	0	9	0	0
1	54927198	.	T	C	22	19	41	0	0	41	0	0
1	54929078	.	C	T	27	25	52	0	1	53	0	0
1	54929256	.	T	C	15	9	24	0	0	24	0	0
1	54929373	.	C	G	4	4	8	0	2	10	0	0
1	54929450	.	A	G	6	10	16	0	0	16	0	0
1	54929575	.	C	T	9	12	21	0	0	21	0	0
1	54929647	.	A	C	8	11	19	0	4	23	0	0
1	54929681	.	C	A	14	12	26	0	1	27	0	0
1	54929733	.	T	G	11	13	24	0	1	25	0	0
1	54929985	.	C	T	14	10	24	0	1	25	0	0
1	54930376	.	C	G	2	5	7	0	0	7	0	0
1	54930439	.	T	A	4	10	14	0	0	14	0	0
1	54930930	.	T	G	11	13	24	0	1	25	0	0
1	54931380	.	A	C	15	9	24	0	1	25	0	0
1	54931487	.	G	T	0	22	22	0	16	38	0	0
1	54936235	.	G	T	13	18	31	0	2	33	0	0
1	54936351	.	G	A	2	5	7	0	0	7	0	0
1	54936381	.	C	A	1	5	6	0	1	7	0	0
1	54936471	.	T	C	17	19	36	0	1	37	0	0
1	54936472	.	G	A	17	19	36	0	1	37	0	0
1	54938208	.	C	T	0	16	16	0	10	26	0	0
1	54938261	.	C	T	0	21	21	1	6	28	0	0
1	54939536	.	A	T	10	26	36	0	1	37	0	0
1	54939563	.	C	G	11	16	27	0	2	29	0	0
1	54939709	.	T	G	13	18	31	0	1	32	0	0
1	54941036	.	G	A	13	17	30	0	0	30	0	0
1	54942609	.	C	T	1	18	19	0	5	24	0	0
1	54944372	.	T	A	9	14	23	0	1	24	0	0
1	54944882	.	A	G	5	10	15	0	1	16	0	0
1	54945039	.	A	G	6	11	17	0	0	17	0	0
1	54945066	.	G	T	6	8	14	0	1	15	0	0
1	54945105	.	C	T	0	2	2	0	4	6	0	0
1	54945108	.	T	C	3	0	3	0	2	5	0	0
1	54945144	.	A	G	4	4	8	0	0	8	0	0
1	54945150	.	C	A	0	6	6	0	3	9	0	0
1	54945195	.	A	C	3	7	10	0	0	10	0	0
1	54947495	.	T	C	2	8	10	2	0	12	0	0
1	54947527	.	G	A	2	7	9	2	0	11	0	0
1	54948145	.	T	C	17	9	26	0	1	27	0	0
1	54950379	.	G	C	22	14	36	0	1	37	0	0
1	54950410	.	T	C	21	14	35	0	1	36	0	0
1	54950534	.	T	C	13	10	23	0	2	25	0	0
1	54950685	.	A	G	15	9	24	0	2	26	0	0
1	54950689	.	C	A	15	9	24	0	3	27	0	0
1	54950747	.	C	T	10	7	17	0	1	18	0	0
1	54950801	.	A	G	9	7	16	0	0	16	0	0
1	54955234	.	A	G	9	15	24	0	3	27	0	0
1	54958123	.	A	G	11	3	14	0	1	15	0	0
1	54958146	.	T	A	11	4	15	0	0	15	0	0
1	54958211	.	C	T	7	5	12	0	1	13	0	0
1	54958242	.	T	A	9	4	13	0	1	14	0	0
1	54958278	.	T	A	10	5	15	1	0	16	0	0
1	54960368	.	T	G	11	4	15	0	2	17	0	0
1	54960431	.	G	T	14	22	36	0	3	39	0	0
1	54960438	.	G	A	13	23	36	0	0	36	0	0
1	54960596	.	T	A	12	6	18	0	3	21	0	0
1	54962466	.	A	G	24	12	36	0	0	36	0	0
1	54963251	.	C	T	24	10	34	0	2	36	0	0
1	54964682	.	C	T	1	14	15	0	18	33	0	0
1	54964685	.	T	C	13	0	13	0	19	32	0	0
1	54964724	.	A	G	16	14	30	0	3	33	0	0
1	54964799	.	C	T	12	13	25	0	0	25	0	0
1	54974403	.	T	G	8	2	10	1	0	11	0	0
1	54974500	.	T	A	5	11	16	0	1	17	0	0
1	54974538	.	A	G	4	11	15	0	0	15	0	0
1	54974558	.	C	T	5	10	15	0	0	15	0	0
1	54974791	.	A	T	8	11	19	0	0	19	0	0
1	54974810	.	G	T	7	10	17	0	1	18	0	0
1	54975051	.	G	T	17	12	29	0	5	35	1	0
1	54975553	.	T	C	10	0	10	0	16	26	0	0
1	54975658	.	A	G	14	5	19	0	0	19	0	0
1	54975762	.	A	T	12	6	18	1	1	20	0	0
1	54975884	.	A	G	14	11	25	0	1	26	0	0
1	54976026	.	T	A	4	16	20	0	0	20	0	0
1	54976035	.	T	A	4	15	19	0	1	20	0	0
1	54976104	.	G	A	4	10	14	0	0	14	0	0
1	54976178	.	T	C	10	3	13	1	9	23	0	0
1	54976249	.	T	A	18	13	31	0	0	31	0	0
1	54976256	.	C	T	18	14	32	0	2	34	0	0
1	54976353	.	A	G	16	15	31	1	0	32	0	0
1	54976731	.	C	T	4	6	10	0	1	11	0	0
1	54976732	.	A	G	4	5	9	0	2	11	0	0
1	54976827	.	T	C	2	6	8	0	0	8	0	0
1	54976835	.	C	T	3	6	9	0	0	9	0	0
1	54977000	.	A	G	10	5	15	1	0	16	0	0
1	54977057	.	A	G	9	6	15	0	2	17	0	0
1	54977308	.	C	A	7	2	9	0	0	9	0	0
1	54977329	.	A	G	10	3	13	0	0	13	0	0
1	54977426	.	T	C	10	3	13	0	0	13	0	0
1	54977452	.	T	A	10	3	13	0	0	13	0	0
1	54977697	.	G	A	10	11	21	0	0	21	0	0
1	54977719	.	T	A	9	9	18	0	0	18	0	0
1	54977781	.	A	G	10	5	15	0	0	15	0	0
1	54977842	.	C	A	4	6	10	0	0	10	0	0
1	54977929	.	G	A	15	5	20	0	0	20	0	0
1	54977945	.	T	C	14	4	18	0	1	19	0	0
1	54977976	.	A	G	15	6	21	0	1	22	0	0
1	54978010	.	A	C	10	0	10	0	8	18	0	0
1	54978022	.	T	G	8	10	18	0	0	18	0	0
1	54978049	.	A	G	5	11	16	0	0	16	0	0
1	54978058	.	C	A	7	8	15	0	0	15	0	0
1	54978260	.	G	A	9	9	18	0	1	19	0	0
1	54978405	.	C	A	12	5	17	0	0	17	0	0
1	54978408	.	C	T	11	4	15	0	0	15	0	0
1	54978478	.	T	C	3	5	8	0	0	8	0	0
1	54981571	.	C	T	0	11	11	0	7	18	0	0
1	54985341	.	T	C	11	0	11	0	9	20	0	0
1	54986910	.	T	C	14	0	14	0	17	31	0	0
1	54988190	.	T	A	7	13	20	0	0	20	0	0
1	54997275	.	T	C	14	0	14	0	11	25	0	0
1	54997327	.	T	C	6	11	17	0	0	17	0	0
1	54997382	.	A	T	13	10	23	0	0	23	0	0
1	54997422	.	G	C	13	11	24	0	0	24	0	0
1	54997652	.	T	G	1	5	6	0	1	7	0	0
1	55007759	.	T	C	4	6	10	0	1	11	0	0
1	55007820	.	A	C	3	7	10	0	0	10	0	0
1	55008286	.	G	A	11	14	25	0	1	26	0	0
1	55008331	.	A	T	11	10	21	0	1	22	0	0
1	55008594	.	A	T	8	12	20	0	2	22	0	0
1	55008772	.	T	C	14	16	30	0	2	32	0	0
1	55009649	.	G	A	3	4	7	0	0	7	0	0
1	55009728	.	T	A	7	4	11	0	0	11	0	0
1	55009734	.	T	C	7	2	9	0	0	9	0	0
1	55010914	.	A	T	6	7	13	0	0	13	0	0
1	55011112	.	A	T	1	7	8	0	0	8	0	0
1	55011117	.	T	C	1	6	7	0	0	7	0	0
1	55011232	.	A	G	3	2	5	0	0	5	0	0
1	55011473	.	G	A	7	6	13	0	0	13	0	0
1	55011539	.	A	T	10	3	13	0	0	13	0	0
1	55011603	.	G	A	5	9	14	0	0	14	0	0
1	55013828	.	A	G	2	5	7	0	1	8	0	0
1	55013968	.	G	C	2	2	4	0	1	5	0	0
1	55015819	.	A	T	3	5	8	0	1	9	0	0
1	55015846	.	A	G	3	5	8	0	1	9	0	0
1	55018936	.	T	C	1	2	3	0	0	3	0	0
1	55021862	.	A	T	5	2	7	0	0	8	1	0
1	55021886	.	G	A	5	2	7	0	0	7	0	0
1	55021952	.	G	A	5	2	7	0	1	8	0	0
1	55022075	.	T	C	2	0	2	0	9	11	0	0
1	55022162	.	T	A	4	2	6	0	1	7	0	0
1	55025467	.	T	C	2	2	4	0	0	4	0	0
1	55032777	.	C	T	6	3	9	0	0	9	0	0
1	55038249	.	A	G	2	5	7	0	0	7	0	0
1	55046053	.	A	G	1	4	5	0	0	5	0	0
1	55046061	.	T	C	1	3	4	0	0	4	0	0
1	55046461	.	G	T	5	2	7	0	0	7	0	0
1	55048008	.	A	T	1	3	4	0	0	4	0	0
1	55048053	.	T	C	2	2	4	0	0	4	0	0
1	55048414	.	G	A	2	1	3	0	1	4	0	0
1	55055284	.	G	A	1	2	3	0	0	3	0	0
1	55056342	.	C	A	0	2	2	0	1	3	0	0
1	55058792	.	G	A	1	2	3	0	0	3	0	0
1	55068901	.	T	A	2	2	4	0	0	4	0	0
1	55068909	.	T	C	2	1	3	0	0	3	0	0
1	55080832	.	A	G	4	2	6	0	0	6	0	0
1	55080840	.	A	G	4	0	4	0	4	8	0	0
1	55080905	.	A	G	4	7	11	0	0	11	0	0
1	55084656	.	T	G	3	2	5	0	0	5	0	0
1	55085830	.	A	T	3	7	10	0	0	10	0	0
1	55088805	.	A	T	8	2	10	0	2	12	0	0
1	55088807	.	A	T	9	4	13	0	0	13	0	0
1	55088871	.	A	G	1	0	1	0	6	7	0	0
1	55089078	.	T	A	6	3	9	0	0	9	0	0
1	55089175	.	C	T	3	2	5	0	0	5	0	0
1	55089253	.	C	A	6	2	8	0	0	8	0	0
1	55089378	.	G	T	7	7	14	0	2	17	1	0
1	55089384	.	T	A	6	8	14	0	2	16	0	0
1	55095331	.	T	C	11	2	13	0	0	13	0	0
1	55099139	.	T	C	8	10	18	0	1	19	0	0
1	55099160	.	G	T	1	7	8	0	14	22	0	0
1	55099772	.	C	T	6	8	14	0	0	14	0	0
1	55099952	.	C	T	12	9	21	0	0	21	0	0
1	55100286	.	G	T	18	13	31	0	1	32	0	0
1	55100397	.	G	C	9	14	23	0	2	25	0	0
1	55100422	.	T	A	10	6	16	0	2	18	0	0
1	55101322	.	G	T	8	18	26	0	1	27	0	0
1	55101358	.	C	T	14	15	29	0	0	29	0	0
1	55101376	.	C	T	16	15	31	0	0	31	0	0
1	55101409	.	C	A	18	13	31	0	2	33	0	0
1	55101445	.	C	G	12	12	24	0	1	25	0	0
1	55103163	.	A	C	15	12	27	0	0	27	0	0
1	55105688	.	T	G	9	0	9	1	19	29	0	0
1	55126635	.	G	A	8	11	19	0	0	19	0	0
1	55161257	.	A	G	4	5	9	0	0	9	0	0
1	55161467	.	C	G	5	5	10	0	1	11	0	0
1	55162449	.	A	G	4	10	14	0	1	15	0	0
1	55166477	.	G	A	2	3	5	1	0	6	0	0
1	55166531	.	T	A	3	2	5	0	0	5	0	0
1	55166533	.	C	T	0	2	2	0	3	5	0	0
1	55169260	.	G	A	2	5	7	0	0	7	0	0
1	55169384	.	G	T	8	6	14	0	0	14	0	0
1	55169789	.	A	T	13	18	31	0	0	31	0	0
1	55170189	.	C	A	8	7	15	0	1	16	0	0
1	55170972	.	T	C	6	2	8	3	4	15	0	0
1	55171003	.	A	T	3	5	8	1	0	9	0	0
1	55171249	.	G	A	10	10	20	0	0	20	0	0
1	55173006	.	T	A	14	15	29	0	2	31	0	0
1	55177339	.	C	T	7	12	19	0	0	19	0	0
1	55177447	.	C	T	12	6	18	0	0	18	0	0
1	55180268	.	T	G	8	7	15	0	0	15	0	0
1	55182699	.	A	C	7	7	14	0	0	14	0	0
1	55182808	.	C	T	9	10	19	0	0	19	0	0
1	55182964	.	T	C	6	10	16	0	0	16	0	0
1	55183041	.	C	T	12	8	20	0	1	21	0	0
1	55191256	.	A	T	8	6	14	0	1	15	0	0
1	55191467	.	C	T	2	14	16	0	15	31	0	0
1	55191559	.	G	A	15	14	29	0	0	29	0	0
1	55191675	.	A	G	18	20	38	0	1	39	0	0
1	55195273	.	G	A	7	10	17	0	0	17	0	0
1	55195997	.	A	T	14	13	27	0	0	27	0	0
1	55197685	.	G	A	15	9	24	0	0	24	0	0
1	55218563	.	G	A	9	7	16	0	0	16	0	0
1	55223001	.	A	C	3	0	3	0	6	9	0	0
1	55226063	.	T	C	4	0	4	0	3	7	0	0
1	55228550	.	G	T	3	4	7	0	0	7	0	0
1	55228562	.	C	G	0	3	3	0	2	5	0	0
1	55229456	.	A	G	2	4	6	0	0	6	0	0
1	55229531	.	T	A	5	4	9	0	0	9	0	0
1	55229812	.	G	A	5	9	14	0	0	14	0	0
1	55230561	.	C	T	2	2	4	0	0	4	0	0
1	55234077	.	C	T	7	9	16	0	0	16	0	0
1	55234125	.	C	T	6	7	13	0	1	14	0	0
1	55234147	.	G	A	6	9	15	0	0	15	0	0
1	55235177	.	G	A	3	4	7	0	0	7	0	0
1	55235203	.	T	C	3	5	8	0	0	8	0	0
1	55236266	.	A	G	2	7	9	0	0	9	0	0
1	55264135	.	T	C	4	5	9	0	0	9	0	0
1	55264187	.	G	C	3	9	12	0	1	13	0	0
1	55264191	.	A	C	2	9	11	0	0	11	0	0
1	55745816	.	C	T	3	2	5	0	1	6	0	0
1	55745880	.	T	A	2	2	4	0	0	4	0	0
1	55745917	.	C	A	1	3	4	0	0	4	0	0
1	55746029	.	G	T	1	3	4	0	1	5	0	0
1	55746071	.	C	T	0	2	2	0	3	5	0	0
1	55746651	.	A	T	1	1	2	0	1	3	0	0
1	55748412	.	T	A	1	3	4	0	0	4	0	0
1	55748529	.	T	C	1	2	3	0	0	3	0	0
1	55748544	.	G	A	1	2	3	0	0	3	0	0
1	55776909	.	A	C	12	12	24	0	1	28	3	0
1	55785527	.	C	A	0	32	32	0	28	61	1	0
1	55785654	.	C	T	12	26	38	1	0	39	0	0
1	55787088	.	C	T	0	2	2	0	1	3	0	0
1	55789456	.	C	T	2	4	6	0	0	6	0	0
1	55789504	.	A	C	2	0	2	0	5	7	0	0
1	55797936	.	A	C	3	0	3	0	4	7	0	0
1	55817728	.	C	T	2	4	6	0	0	6	0	0
1	55818073	.	T	C	3	6	9	0	0	9	0	0
1	55818218	.	A	T	2	4	6	0	0	6	0	0
1	55818319	.	T	C	3	4	7	0	0	7	0	0
1	55833139	.	G	C	4	3	7	0	0	7	0	0
1	55833185	.	G	A	4	5	9	0	1	10	0	0
1	55833276	.	C	T	4	4	8	0	0	8	0	0
1	55833281	.	C	T	4	4	8	0	0	8	0	0
1	55839011	.	C	G	4	6	10	0	0	10	0	0
1	55839132	.	G	C	2	6	8	0	0	8	0	0
1	55839282	.	A	C	6	6	12	0	0	12	0	0
1	55843902	.	C	T	17	19	36	0	1	37	0	0
1	55843968	.	G	A	17	18	35	0	2	37	0	0
1	55844044	.	T	A	19	17	36	0	1	37	0	0
1	55844401	.	A	G	25	22	47	0	0	47	0	0
1	55853320	.	G	A	8	15	23	0	0	23	0	0
1	55872892	.	C	G	16	23	39	0	0	39	0	0
1	55873073	.	C	T	15	14	29	0	2	31	0	0
1	55878400	.	C	T	1	3	4	0	6	10	0	0
1	55878496	.	T	C	4	0	4	0	7	11	0	0
1	55878624	.	T	A	2	3	5	0	1	6	0	0
1	55878626	.	A	C	3	3	6	0	0	6	0	0
1	55885148	.	C	T	2	6	8	0	11	19	0	0
1	55888583	.	C	A	5	3	8	0	0	8	0	0
1	55888632	.	T	C	5	0	5	1	5	11	0	0
1	55888654	.	C	T	6	7	13	0	0	14	1	0
1	55888690	.	A	G	5	7	12	0	0	12	0	0
1	55888693	.	T	A	3	7	10	0	1	11	0	0
1	55888906	.	T	A	6	3	9	0	0	9	0	0
1	56217450	.	G	T	6	3	9	0	4	13	0	0
1	56217510	.	A	G	25	20	45	0	2	47	0	0
1	56217925	.	G	A	36	35	71	0	9	80	0	0
1	56218141	.	A	G	36	37	73	0	5	78	0	0
1	56218189	.	C	T	3	33	36	0	40	76	0	0
1	56218360	.	G	C	36	3	39	0	35	74	0	0
1	56223902	.	T	G	2	6	8	0	1	9	0	0
1	56424791	.	C	T	1	12	13	0	5	18	0	0
1	56424794	.	T	C	4	0	4	0	12	16	0	0
1	56425843	.	T	C	7	0	7	0	9	16	0	0
1	56425864	.	C	T	6	10	16	0	1	17	0	0
1	56428320	.	G	A	10	10	20	0	0	20	0	0
1	57278215	.	G	C	8	8	16	0	1	17	0	0
1	57278405	.	A	T	5	4	9	0	0	9	0	0
1	57278452	.	C	T	5	2	7	0	0	7	0	0
1	57278525	.	A	G	2	3	5	0	0	5	0	0
1	57278610	.	T	G	5	2	7	0	1	8	0	0
1	57278669	.	A	G	1	4	5	0	0	5	0	0
1	57278690	.	G	A	2	3	5	0	2	7	0	0
1	57278753	.	T	C	3	6	9	0	0	9	0	0
1	57278783	.	T	C	1	8	9	0	0	9	0	0
1	57278915	.	G	A	9	9	18	0	0	18	0	0
1	57278979	.	G	A	6	5	11	0	0	11	0	0
1	57279073	.	T	C	5	0	5	0	6	11	0	0
1	57280108	.	G	A	10	5	15	0	0	15	0	0
1	57280184	.	G	T	8	4	12	0	0	12	0	0
1	57280292	.	T	C	4	4	8	0	0	8	0	0
1	57280454	.	A	T	8	7	15	0	0	15	0	0
1	57280502	.	T	C	7	3	10	0	2	12	0	0
1	57288560	.	C	G	2	0	2	0	2	4	0	0
1	57332495	.	A	T	6	2	8	0	1	10	1	0
1	57332657	.	G	A	1	5	6	0	4	10	0	0
1	57332699	.	G	A	0	2	2	0	3	5	0	0
1	57332744	.	C	T	4	4	8	0	0	8	0	0
1	57333094	.	G	A	0	6	6	0	6	12	0	0
1	57337050	.	A	G	4	10	14	0	0	14	0	0
1	57337107	.	T	C	1	2	3	0	0	3	0	0
1	57337110	.	C	T	1	2	3	0	0	3	0	0
1	57338143	.	C	T	4	5	9	0	0	9	0	0
1	57338226	.	G	A	2	7	9	0	6	15	0	0
1	57340049	.	T	C	9	10	19	0	1	20	0	0
1	57340108	.	C	T	15	6	21	0	0	21	0	0
1	57340164	.	T	A	8	3	11	0	0	11	0	0
1	57354456	.	C	T	1	2	3	0	0	3	0	0
1	57363331	.	A	C	2	2	4	0	0	4	0	0
1	57371562	.	C	T	1	2	3	0	0	3	0	0
1	58013308	.	C	A	7	6	13	0	0	13	0	0
1	58013309	.	A	G	7	6	13	0	0	13	0	0
1	58014867	.	T	C	6	5	11	0	0	11	0	0
1	58014933	.	T	C	5	0	5	0	9	14	0	0
1	58015053	.	A	G	7	8	15	0	1	16	0	0
1	58015448	.	G	T	8	7	15	0	0	15	0	0
1	58015580	.	T	C	5	0	5	0	11	16	0	0
1	58015604	.	C	T	3	6	9	0	0	9	0	0
1	58017698	.	T	A	3	4	7	0	0	7	0	0
1	58017733	.	T	C	6	0	6	0	3	9	0	0
1	58020740	.	C	G	2	6	8	0	3	11	0	0
1	58020767	.	T	C	6	0	6	0	6	12	0	0
1	58020829	.	A	G	4	2	6	0	0	6	0	0
1	58020842	.	A	G	4	4	8	0	0	8	0	0
1	58023900	.	G	A	3	3	6	0	0	6	0	0
1	58023960	.	T	A	7	5	12	0	0	12	0	0
1	58036300	.	G	T	4	7	11	0	0	11	0	0
1	58036348	.	A	C	2	9	11	0	0	11	0	0
1	58036450	.	G	A	8	6	14	0	0	14	0	0
1	58036478	.	C	A	6	4	10	0	0	10	0	0
1	58048903	.	C	T	2	2	4	0	0	4	0	0
1	58048913	.	A	G	1	0	1	0	2	3	0	0
1	58092700	.	T	A	12	6	18	0	0	18	0	0
1	58092750	.	G	A	0	7	7	0	16	23	0	0
1	58092795	.	A	T	8	8	16	0	0	16	0	0
1	58092820	.	C	G	6	10	16	0	0	16	0	0
1	58092836	.	T	C	8	8	16	0	1	17	0	0
1	58094708	.	C	T	15	6	21	0	0	21	0	0
1	58094744	.	A	G	18	5	23	0	0	23	0	0
1	58094775	.	A	G	7	5	12	0	6	18	0	0
1	58095111	.	C	T	3	8	11	0	1	12	0	0
1	58095116	.	G	C	4	7	11	0	0	11	0	0
1	58098105	.	A	C	10	11	21	0	0	21	0	0
1	58098137	.	T	A	11	8	19	0	2	21	0	0
1	58102932	.	T	G	9	12	21	0	1	22	0	0
1	58357850	.	T	A	2	6	8	4	1	13	0	0
1	58446213	.	G	T	1	4	5	0	0	5	0	0
1	58545734	.	C	G	5	2	7	0	0	7	0	0
1	58545752	.	A	T	6	3	9	0	0	9	0	0
1	58547747	.	C	T	1	2	3	0	5	8	0	0
1	58552996	.	A	G	1	2	3	0	1	4	0	0
1	58569961	.	T	C	1	3	4	0	0	4	0	0
1	58573353	.	T	A	1	2	3	0	1	4	0	0
1	58573382	.	C	T	0	1	1	0	2	3	0	0
1	58593457	.	G	T	4	2	6	0	0	6	0	0
1	58593490	.	C	G	3	4	7	0	0	7	0	0
1	58593494	.	T	A	3	4	7	0	0	7	0	0
1	58593685	.	A	C	3	2	5	0	0	5	0	0
1	58593699	.	A	G	3	3	6	0	0	6	0	0
1	58593833	.	C	A	4	4	8	0	0	8	0	0
1	58593835	.	T	C	4	4	8	0	0	8	0	0
1	58593912	.	C	T	2	3	5	0	0	5	0	0
1	58593976	.	G	A	3	5	8	0	0	8	0	0
1	58594470	.	T	C	2	7	9	0	0	9	0	0
1	58594541	.	T	C	1	4	5	0	0	5	0	0
1	58594611	.	T	G	4	4	8	0	1	9	0	0
1	58595018	.	C	T	11	10	21	0	1	22	0	0
1	58595198	.	A	G	6	9	15	0	2	17	0	0
1	58598607	.	T	G	4	7	11	0	1	12	0	0
1	58598663	.	G	T	5	6	11	0	0	11	0	0
1	58598802	.	T	C	5	0	5	0	9	14	0	0
1	58605969	.	C	G	6	2	8	0	1	9	0	0
1	58605997	.	A	G	5	3	8	1	0	9	0	0
1	58606376	.	A	G	2	0	2	0	2	4	0	0
1	58606381	.	T	C	2	2	4	0	0	4	0	0
1	58610453	.	G	A	1	3	4	0	1	5	0	0
1	58612243	.	T	G	4	5	9	0	2	11	0	0
1	58612247	.	A	G	4	3	7	0	2	9	0	0
1	58612519	.	T	C	2	2	4	0	0	4	0	0
1	58612726	.	G	A	1	6	7	0	4	11	0	0
1	58612762	.	A	G	8	3	11	0	0	11	0	0
1	58612915	.	A	T	4	4	8	0	0	8	0	0
1	58613091	.	A	C	1	2	3	0	0	3	0	0
1	58617870	.	C	T	1	3	4	1	0	5	0	0
1	58618220	.	C	A	1	4	5	1	0	6	0	0
1	58628604	.	A	C	2	2	4	2	0	6	0	0
1	58628607	.	T	A	2	2	4	2	0	6	0	0
1	58631350	.	C	T	3	4	7	0	1	8	0	0
1	58631374	.	A	G	3	3	6	0	1	7	0	0
1	58631509	.	A	G	2	6	8	0	0	8	0	0
1	58631559	.	A	T	1	7	8	0	0	8	0	0
1	58631894	.	C	T	4	2	6	0	0	6	0	0
1	58677909	.	A	C	5	6	11	0	0	11	0	0
1	58677949	.	A	C	3	7	10	0	0	10	0	0
1	58677993	.	A	G	4	9	13	3	0	16	0	0
1	58678017	.	T	C	3	7	10	3	0	13	0	0
1	58678077	.	T	A	11	4	15	1	0	16	0	0
1	58680432	.	T	A	9	16	25	0	1	26	0	0
1	58680499	.	C	A	9	15	24	0	1	25	0	0
1	58680517	.	T	C	15	10	25	0	1	26	0	0
1	58680553	.	C	A	11	6	17	0	2	20	1	0
1	58680566	.	T	C	12	8	20	0	1	21	0	0
1	58680591	.	C	T	14	6	20	0	0	20	0	0
1	58680792	.	T	C	7	15	22	0	2	24	0	0
1	58680879	.	G	A	0	19	19	1	16	36	0	0
1	58681095	.	A	G	7	13	20	0	0	20	0	0
1	58681278	.	A	C	15	9	24	0	0	24	0	0
1	58681419	.	A	T	5	17	22	0	0	28	6	0
1	58762955	.	T	C	17	0	17	0	14	31	0	0
1	58762985	.	T	G	15	15	30	0	0	30	0	0
1	58766341	.	G	A	12	10	22	0	1	23	0	0
1	58846938	.	A	G	2	3	5	0	2	7	0	0
1	58850500	.	T	G	4	4	8	0	0	8	0	0
1	58850525	.	T	A	5	5	10	0	0	11	1	0
1	58850562	.	C	T	5	4	9	0	0	9	0	0
1	58867543	.	G	A	2	5	7	0	0	7	0	0
1	58982147	.	G	A	0	7	7	0	9	16	0	0
1	58982195	.	C	G	7	5	12	0	0	12	0	0
1	58984239	.	G	T	7	6	13	0	0	13	0	0
1	58984368	.	G	A	1	8	9	0	4	13	0	0
1	58984478	.	T	C	6	8	14	0	0	14	0	0
1	58984640	.	C	T	8	5	13	0	2	15	0	0
1	58985530	.	G	A	11	12	23	0	1	24	0	0
1	58985579	.	T	G	8	11	19	0	0	19	0	0
1	58985730	.	C	A	8	6	14	0	0	14	0	0
1	58991269	.	C	A	2	2	4	0	0	4	0	0
1	58991278	.	T	C	2	2	4	0	0	4	0	0
1	58992846	.	C	T	1	6	7	0	0	7	0	0
1	58994452	.	T	C	1	2	3	0	0	3	0	0
1	58998061	.	T	G	5	0	5	0	5	10	0	0
1	58999960	.	T	A	6	7	13	0	0	13	0	0
1	59009732	.	A	G	22	0	22	0	20	42	0	0
1	59010618	.	G	A	21	25	46	0	1	47	0	0
1	59018886	.	C	T	1	3	4	0	6	10	0	0
1	59019006	.	C	G	3	5	8	0	0	8	0	0
1	59019084	.	T	A	6	9	15	0	0	15	0	0
1	59019093	.	A	G	6	9	15	0	0	15	0	0
1	59062665	.	T	C	26	29	55	0	3	58	0	0
1	59065889	.	G	A	4	13	17	0	20	37	0	0
1	59140881	.	C	G	1	2	3	0	0	3	0	0
1	59140886	.	A	G	1	2	3	0	0	3	0	0
1	59141415	.	C	A	6	5	11	0	0	11	0	0
1	59141550	.	T	C	2	3	5	0	0	5	0	0
1	59141556	.	G	C	3	3	6	0	0	6	0	0
1	59142891	.	A	G	10	0	10	0	12	22	0	0
1	59143499	.	T	A	2	5	7	0	0	7	0	0
1	59143503	.	A	G	2	3	5	0	0	5	0	0
1	59147468	.	C	G	3	0	3	0	11	14	0	0
1	59148260	.	T	C	5	6	11	0	0	11	0	0
1	59148341	.	T	C	6	6	12	0	0	12	0	0
1	59149117	.	C	T	9	15	24	0	2	26	0	0
1	59149968	.	T	C	14	18	32	0	1	33	0	0
1	59150450	.	A	G	8	10	18	0	0	18	0	0
1	59150482	.	G	T	10	10	20	0	0	20	0	0
1	59150518	.	T	C	9	12	21	0	1	22	0	0
1	59150559	.	T	G	7	18	25	0	1	26	0	0
1	59150583	.	T	A	5	14	19	0	1	20	0	0
1	59150683	.	T	C	6	20	26	0	1	27	0	0
1	59150737	.	T	C	7	13	20	0	0	20	0	0
1	59150762	.	G	T	11	12	23	0	0	23	0	0
1	59150781	.	T	C	10	15	25	0	0	25	0	0
1	59154592	.	T	C	8	13	21	0	3	24	0	0
1	59156827	.	T	G	9	7	16	0	1	17	0	0
1	59157536	.	T	C	6	10	16	0	1	17	0	0
1	59157856	.	T	A	8	16	24	0	2	26	0	0
1	59157888	.	T	C	6	18	24	0	1	25	0	0
1	59157977	.	A	C	13	18	31	0	4	35	0	0
1	59158035	.	C	A	15	16	31	0	0	32	1	0
1	59158062	.	A	T	14	15	29	0	2	31	0	0
1	59158070	.	G	A	15	12	27	0	2	29	0	0
1	59172876	.	A	G	22	9	31	0	4	35	0	0
1	59172900	.	A	G	25	12	37	0	1	38	0	0
1	59172969	.	G	A	15	16	31	0	2	33	0	0
1	59173358	.	G	T	18	14	32	0	2	34	0	0
1	59173563	.	C	T	22	11	33	0	0	33	0	0
1	59173701	.	G	T	23	9	32	0	2	34	0	0
1	59173758	.	A	G	13	15	28	0	1	29	0	0
1	59173866	.	T	G	11	13	24	0	8	32	0	0
1	59173896	.	T	C	12	2	14	0	16	30	0	0
1	59174387	.	A	G	17	13	30	0	0	30	0	0
1	59174408	.	G	A	12	13	25	0	0	25	0	0
1	59174492	.	T	G	14	9	23	0	1	24	0	0
1	59174525	.	A	C	13	15	28	0	1	29	0	0
1	59174576	.	C	T	10	8	18	0	0	18	0	0
1	59174645	.	G	A	16	12	28	0	1	29	0	0
1	59174797	.	A	C	21	10	31	0	1	32	0	0
1	59174962	.	T	C	22	16	38	0	1	39	0	0
1	59175511	.	T	C	12	12	24	0	1	25	0	0
1	59175572	.	A	G	9	13	22	0	0	22	0	0
1	59175626	.	G	A	10	15	25	0	1	26	0	0
1	59175635	.	G	A	12	17	29	0	0	29	0	0
1	59175740	.	G	T	15	9	24	0	0	24	0	0
1	59175983	.	T	C	11	9	20	0	2	22	0	0
1	59175989	.	A	G	12	11	23	0	2	25	0	0
1	59176636	.	C	T	12	9	21	0	1	22	0	0
1	59176887	.	G	T	16	12	28	0	0	28	0	0
1	59176935	.	A	C	13	0	13	0	9	22	0	0
1	59218594	.	A	G	9	8	17	1	4	22	0	0
1	59226049	.	T	C	13	29	42	0	7	49	0	0
1	59226052	.	A	G	19	27	46	0	1	47	0	0
1	59228311	.	G	A	35	22	57	0	4	61	0	0
1	59228322	.	C	T	38	26	64	0	1	65	0	0
1	59228569	.	A	C	22	0	22	0	28	50	0	0
1	59229211	.	G	A	3	7	10	0	1	11	0	0
1	59232206	.	A	G	18	17	35	0	1	36	0	0
1	59232358	.	T	G	1	6	7	0	0	7	0	0
1	59232509	.	G	A	15	21	36	0	4	40	0	0
1	59235016	.	T	G	15	25	40	0	2	42	0	0
1	59237932	.	G	A	1	3	4	0	0	4	0	0
1	59237935	.	T	C	1	3	4	0	0	4	0	0
1	59238381	.	G	T	1	2	3	0	0	3	0	0
1	59244312	.	A	G	12	9	21	0	0	21	0	0
1	59244635	.	A	T	17	13	30	0	2	32	0	0
1	59244916	.	T	A	35	17	52	2	3	57	0	0
1	59244928	.	C	T	33	23	56	2	2	60	0	0
1	59245142	.	C	G	32	26	58	0	1	59	0	0
1	59245658	.	G	A	15	20	35	0	0	35	0	0
1	59245873	.	T	C	19	16	35	0	0	35	0	0
1	59245900	.	C	T	20	16	36	0	2	38	0	0
1	59246189	.	T	C	19	2	21	0	20	41	0	0
1	59246318	.	A	G	3	1	4	0	1	5	0	0
1	59246320	.	G	A	2	2	4	0	0	4	0	0
1	59247893	.	T	G	20	15	35	0	0	35	0	0
1	59247944	.	C	T	20	15	35	0	0	35	0	0
1	59248138	.	T	A	15	17	32	0	0	32	0	0
1	59251658	.	C	G	15	16	31	1	1	33	0	0
1	59251839	.	T	C	17	0	17	0	17	34	0	0
1	59293937	.	T	C	2	6	8	0	0	8	0	0
1	59293966	.	A	G	5	4	9	0	0	9	0	0
1	59297464	.	T	G	1	4	5	0	0	5	0	0
1	59297557	.	T	G	2	4	6	0	0	6	0	0
1	59298261	.	T	G	3	4	7	0	0	7	0	0
1	59302210	.	G	A	0	9	9	0	10	19	0	0
1	59302276	.	C	T	7	4	11	0	1	12	0	0
1	59302372	.	T	G	8	7	15	0	1	16	0	0
1	59302614	.	A	T	1	2	3	0	0	3	0	0
1	59302619	.	A	T	1	2	3	0	0	3	0	0
1	59302813	.	C	A	2	2	4	0	0	4	0	0
1	59303024	.	C	A	5	4	9	0	0	9	0	0
1	59303220	.	T	G	1	3	4	0	0	4	0	0
1	59305047	.	C	T	1	2	3	0	12	16	1	0
1	59305116	.	T	C	6	0	6	0	3	9	0	0
1	59309451	.	C	T	0	2	2	0	3	5	0	0
1	59309452	.	G	T	3	2	5	0	0	5	0	0
1	59309988	.	A	G	1	4	5	0	1	6	0	0
1	59312211	.	C	A	1	2	3	0	1	4	0	0
1	59314966	.	A	G	12	12	24	0	0	24	0	0
1	59318886	.	A	G	8	0	8	0	10	18	0	0
1	59320111	.	C	T	15	17	32	0	0	32	0	0
1	59321447	.	A	G	9	0	9	0	24	33	0	0
1	59324067	.	T	C	11	19	30	0	2	32	0	0
1	59328110	.	T	G	2	0	2	1	4	7	0	0
1	59328287	.	C	T	6	6	12	0	0	12	0	0
1	59328486	.	C	T	2	7	9	0	0	9	0	0
1	59330135	.	T	C	5	4	9	0	0	9	0	0
1	59330169	.	C	T	5	3	8	0	0	8	0	0
1	59406628	.	C	T	1	4	5	0	0	5	0	0
1	59409455	.	A	G	1	4	5	0	0	5	0	0
1	59419102	.	T	G	1	2	3	0	0	3	0	0
1	59542739	.	A	T	3	7	10	0	0	10	0	0
1	59562375	.	A	G	2	6	8	0	0	8	0	0
1	59563012	.	G	C	1	5	6	0	0	6	0	0
10	18509	.	A	G	5	4	9	0	1	10	0	0
10	18533	.	T	C	6	8	14	0	0	14	0	0
10	19217	.	G	A	5	6	11	0	0	11	0	0
10	22333	.	C	G	9	7	16	0	1	17	0	0
10	22507	.	A	G	9	7	16	1	1	18	0	0
10	22543	.	T	A	6	2	8	0	1	9	0	0
10	22554	.	A	T	5	2	7	0	0	7	0	0
10	24014	.	G	A	7	4	11	0	0	11	0	0
10	24733	.	G	A	6	11	17	0	2	19	0	0
10	27787	.	G	T	1	4	5	0	4	9	0	0
10	32978	.	T	C	4	0	4	0	7	11	0	0
10	32998	.	G	T	9	7	16	0	0	16	0	0
10	33237	.	T	C	4	10	14	0	0	14	0	0
10	33287	.	G	C	5	9	14	0	0	14	0	0
10	33441	.	A	G	7	15	22	0	4	26	0	0
10	33630	.	A	G	8	6	14	0	0	14	0	0
10	33634	.	G	T	8	5	13	0	1	14	0	0
10	33665	.	T	C	4	5	9	0	2	11	0	0
10	33986	.	G	T	6	7	13	1	0	14	0	0
10	34028	.	C	T	5	9	14	0	0	14	0	0
10	34071	.	C	T	1	3	4	0	3	7	0	0
10	34206	.	A	C	4	5	9	0	0	9	0	0
10	34233	.	G	A	4	3	7	0	0	7	0	0
10	34302	.	G	T	2	6	8	0	0	8	0	0
10	34325	.	C	T	1	6	7	0	5	12	0	0
10	34725	.	G	A	13	8	21	0	0	21	0	0
10	34727	.	A	T	12	9	21	0	0	21	0	0
10	34839	.	G	C	7	11	18	0	1	19	0	0
10	38922	.	A	G	7	9	16	0	1	17	0	0
10	38924	.	A	G	7	9	16	0	1	17	0	0
10	53815	.	T	C	8	5	13	0	0	13	0	0
10	53816	.	G	A	8	5	13	0	0	13	0	0
10	53930	.	T	G	8	7	15	0	1	16	0	0
10	55594	.	G	A	5	11	16	0	0	16	0	0
10	55627	.	C	T	0	10	10	0	6	16	0	0
10	62459	.	A	C	15	0	15	0	16	31	0	0
10	62468	.	C	G	18	16	34	0	1	35	0	0
10	63587	.	A	G	20	21	41	0	3	44	0	0
10	64855	.	G	A	15	20	35	0	0	35	0	0
10	65086	.	A	G	11	10	21	0	1	22	0	0
10	67063	.	T	C	8	14	22	0	1	23	0	0
10	72381	.	A	G	10	10	20	0	0	20	0	0
10	78461	.	G	C	0	15	15	0	19	34	0	0
10	81285	.	C	T	20	11	31	0	1	32	0	0
10	81348	.	C	T	16	15	31	0	2	33	0	0
10	81508	.	A	G	15	1	16	0	10	26	0	0
10	82025	.	A	G	6	5	11	1	0	12	0	0
10	82336	.	A	G	24	11	35	0	0	35	0	0
10	83401	.	G	A	10	5	15	0	0	15	0	0
10	85353	.	A	G	9	4	13	0	1	14	0	0
10	85404	.	G	A	8	5	13	0	1	14	0	0
10	85419	.	C	T	1	4	5	0	8	13	0	0
10	85571	.	G	C	8	15	23	0	0	23	0	0
10	85585	.	C	T	12	13	25	0	2	27	0	0
10	85927	.	A	G	11	12	23	0	0	23	0	0
10	85948	.	G	C	11	10	21	0	2	23	0	0
10	87353	.	G	A	8	5	13	0	1	14	0	0
10	87417	.	G	A	12	6	18	0	1	19	0	0
10	87426	.	T	C	15	6	21	0	0	21	0	0
10	87606	.	G	A	12	10	22	0	0	22	0	0
10	89893	.	T	C	4	0	4	0	5	9	0	0
10	94983	.	G	A	6	4	10	0	1	11	0	0
10	95022	.	C	T	1	3	4	1	5	10	0	0
10	99045	.	G	T	6	5	11	0	0	11	0	0
10	104062	.	T	G	2	3	5	0	0	5	0	0
10	110895	.	G	A	1	8	9	0	0	9	0	0
10	114066	.	A	G	6	12	18	0	2	20	0	0
10	115088	.	G	A	6	20	26	0	1	27	0	0
10	115136	.	T	C	9	17	26	1	1	28	0	0
10	115578	.	T	C	4	11	15	0	0	15	0	0
10	115773	.	A	G	2	6	8	1	0	9	0	0
10	115820	.	T	C	3	9	12	1	0	13	0	0
10	115967	.	A	G	2	0	2	0	5	7	0	0
10	115982	.	T	C	2	2	4	0	0	4	0	0
10	134809	.	G	A	20	17	37	0	2	39	0	0
10	188357	.	A	C	19	8	27	0	0	27	0	0
10	188366	.	A	G	16	6	22	0	0	22	0	0
10	193726	.	A	G	20	19	39	0	1	40	0	0
10	193853	.	G	A	22	7	29	0	2	31	0	0
10	194316	.	A	G	16	15	31	0	1	32	0	0
10	195321	.	T	C	14	17	31	0	2	33	0	0
10	195327	.	T	C	12	15	27	0	2	29	0	0
10	196054	.	C	T	11	8	19	0	1	20	0	0
10	196307	.	C	T	8	10	18	0	3	21	0	0
10	196342	.	C	G	7	8	15	0	0	15	0	0
10	196670	.	G	A	16	13	29	0	1	30	0	0
10	196693	.	T	A	16	14	30	0	0	30	0	0
10	196773	.	T	C	4	2	6	0	0	6	0	0
10	196782	.	C	A	2	2	4	0	1	5	0	0
10	207258	.	C	T	17	6	23	0	0	23	0	0
10	207259	.	C	A	1	6	7	0	16	23	0	0
10	207992	.	T	C	15	1	16	0	13	29	0	0
10	207994	.	T	C	15	2	17	0	12	29	0	0
10	208034	.	A	T	10	18	28	0	1	29	0	0
10	210568	.	A	G	12	9	21	0	0	21	0	0
10	210598	.	T	C	15	6	21	1	0	22	0	0
10	210667	.	G	A	13	7	20	0	0	20	0	0
10	210669	.	G	A	12	7	19	0	1	20	0	0
10	216122	.	T	C	13	8	21	0	0	21	0	0
10	286788	.	T	C	10	0	10	0	13	23	0	0
10	292655	.	C	T	2	6	8	0	9	17	0	0
10	292667	.	A	G	6	11	17	0	0	17	0	0
10	294113	.	G	A	11	9	20	0	0	20	0	0
10	294653	.	A	G	11	13	24	0	2	26	0	0
10	295070	.	A	G	8	6	14	0	1	15	0	0
10	295202	.	T	C	18	9	27	0	0	27	0	0
10	296617	.	C	T	1	10	11	0	19	30	0	0
10	297823	.	C	T	7	9	16	0	1	17	0	0
10	307976	.	G	T	14	10	24	0	0	24	0	0
10	307985	.	T	C	11	0	11	0	11	22	0	0
10	308288	.	T	C	13	3	16	0	2	18	0	0
10	311901	.	A	G	3	4	7	0	0	7	0	0
10	313332	.	T	C	5	4	9	0	2	11	0	0
10	320142	.	C	A	1	3	4	0	0	4	0	0
10	416421	.	A	T	2	6	8	0	1	9	0	0
10	416646	.	C	A	1	2	3	0	0	3	0	0
10	416789	.	G	T	0	3	3	0	1	4	0	0
10	428621	.	G	A	2	3	5	0	0	5	0	0
10	428684	.	C	T	1	2	3	0	1	4	0	0
10	431607	.	T	A	3	3	6	0	1	7	0	0
10	431608	.	T	C	3	4	7	0	0	7	0	0
10	474834	.	T	C	16	20	36	0	1	37	0	0
10	474896	.	T	C	17	17	34	0	0	34	0	0
10	478304	.	T	G	20	22	42	0	1	43	0	0
10	478388	.	G	A	4	26	30	0	9	39	0	0
10	478508	.	T	C	19	23	42	0	1	43	0	0
10	478661	.	C	T	25	20	45	0	2	47	0	0
10	478724	.	G	A	24	28	52	0	0	52	0	0
10	478742	.	C	T	22	25	47	0	0	47	0	0
10	479063	.	A	G	19	18	37	0	2	39	0	0
10	482335	.	G	A	27	13	40	1	0	41	0	0
10	482371	.	T	G	18	19	37	1	3	41	0	0
10	486146	.	G	A	21	18	39	0	2	41	0	0
10	486153	.	T	C	20	19	39	0	2	41	0	0
10	500114	.	A	G	19	1	20	0	21	41	0	0
10	500168	.	G	A	3	25	28	0	15	43	0	0
10	500423	.	A	G	22	0	22	0	28	50	0	0
10	500473	.	T	C	16	28	44	0	2	46	0	0
10	501833	.	C	T	19	23	42	0	4	46	0	0
10	501899	.	G	C	32	20	52	0	0	52	0	0
10	505282	.	A	G	12	21	33	0	1	34	0	0
10	505316	.	G	A	1	22	23	0	19	42	0	0
10	573789	.	T	A	10	5	15	0	1	16	0	0
10	573806	.	G	A	7	6	13	0	2	15	0	0
10	576060	.	A	G	6	6	12	0	0	12	0	0
10	577791	.	G	C	5	13	18	0	0	18	0	0
10	580088	.	G	T	1	13	14	0	21	35	0	0
10	580092	.	G	A	18	12	30	0	2	32	0	0
10	586563	.	C	A	13	9	22	0	0	22	0	0
10	589487	.	G	A	9	8	17	0	1	18	0	0
10	589875	.	T	C	5	3	8	0	0	8	0	0
10	590087	.	A	G	1	4	5	0	0	5	0	0
10	590273	.	A	C	10	9	19	0	2	21	0	0
10	590314	.	G	A	1	6	7	0	10	17	0	0
10	590956	.	A	T	5	3	8	1	0	10	1	0
10	590957	.	A	G	4	4	8	1	0	9	0	0
10	590997	.	C	T	5	2	7	2	0	9	0	0
10	591017	.	T	C	7	10	17	1	0	18	0	0
10	591219	.	T	G	4	0	4	0	6	10	0	0
10	591220	.	C	T	4	5	9	0	0	9	0	0
10	591434	.	G	A	3	7	10	0	0	10	0	0
10	591476	.	A	G	5	0	5	0	11	16	0	0
10	591634	.	T	G	9	8	17	0	0	17	0	0
10	600448	.	T	C	7	12	19	0	1	20	0	0
10	600450	.	T	C	8	12	20	0	1	21	0	0
10	600584	.	G	A	10	11	21	0	0	21	0	0
10	608795	.	A	G	3	6	9	0	1	10	0	0
10	609654	.	C	T	3	2	5	0	0	5	0	0
10	617784	.	G	A	1	4	5	0	0	5	0	0
10	1052692	.	A	G	6	0	6	0	5	11	0	0
10	1056227	.	A	G	7	4	11	0	1	12	0	0
10	1056409	.	A	G	6	10	16	0	0	16	0	0
10	1056460	.	T	C	8	6	14	0	0	14	0	0
10	1076251	.	T	C	8	5	13	0	0	13	0	0
10	1082985	.	T	G	2	5	7	0	0	7	0	0
10	1083030	.	T	A	1	3	4	0	0	4	0	0
10	1084628	.	A	G	2	5	7	0	0	7	0	0
10	1105953	.	C	T	11	13	24	0	0	24	0	0
10	1107460	.	C	T	18	12	30	0	0	30	0	0
10	1150511	.	T	A	3	4	7	0	0	7	0	0
10	1150520	.	G	C	4	3	7	0	0	7	0	0
10	1190547	.	T	C	1	0	1	0	2	3	0	0
10	1190592	.	G	A	1	2	3	0	0	3	0	0
10	1217238	.	C	T	1	1	2	0	1	3	0	0
10	1217294	.	C	T	0	0	0	0	3	3	0	0
10	1436596	.	C	G	1	13	14	0	12	26	0	0
10	1450286	.	G	A	15	7	22	0	1	23	0	0
10	1515816	.	C	T	8	6	14	0	0	14	0	0
10	1519606	.	T	G	2	6	8	2	0	10	0	0
10	1541411	.	G	A	5	13	18	0	1	19	0	0
10	1541492	.	C	T	5	13	18	0	0	18	0	0
10	1543805	.	C	G	1	10	11	0	2	13	0	0
10	1543848	.	G	C	3	0	3	0	7	10	0	0
10	1549013	.	C	A	0	9	9	0	2	11	0	0
10	1549088	.	C	T	0	15	15	0	3	18	0	0
10	1549409	.	T	C	2	0	2	0	6	8	0	0
10	1549494	.	G	A	4	12	16	0	0	16	0	0
10	1549532	.	A	G	6	3	9	0	0	9	0	0
10	1549714	.	G	A	3	10	13	0	0	13	0	0
10	1552767	.	G	A	6	2	8	0	0	8	0	0
10	1597396	.	G	A	15	4	19	0	1	20	0	0
10	1599468	.	C	T	3	3	6	0	0	6	0	0
10	1603967	.	T	C	4	4	8	0	0	8	0	0
10	1619723	.	G	A	4	2	6	0	0	6	0	0
10	1626579	.	T	A	1	2	3	0	0	3	0	0
10	1626597	.	A	G	1	3	4	0	0	4	0	0
10	1648044	.	T	C	13	13	26	0	1	27	0	0
10	1649691	.	T	C	18	6	24	0	0	24	0	0
10	1652260	.	G	C	2	8	10	1	4	15	0	0
10	1656257	.	C	T	9	6	15	0	2	17	0	0
10	1658184	.	T	C	9	12	21	0	1	22	0	0
10	1663101	.	T	C	12	15	27	0	0	27	0	0
10	1665572	.	A	G	15	0	15	0	11	26	0	0
10	1666525	.	G	A	3	8	11	1	12	24	0	0
10	1668159	.	C	T	17	15	32	0	0	32	0	0
10	1671442	.	A	T	12	16	28	0	2	30	0	0
10	1674291	.	C	T	16	12	28	0	1	29	0	0
10	1681712	.	A	T	10	6	16	0	0	16	0	0
10	1684563	.	T	G	2	11	13	0	1	14	0	0
10	1684742	.	A	G	2	2	4	0	0	4	0	0
10	1687078	.	C	T	2	3	5	0	0	5	0	0
10	1687094	.	C	T	2	4	6	0	0	6	0	0
10	1687547	.	C	T	29	16	45	0	3	48	0	0
10	1694456	.	T	A	17	10	27	2	1	30	0	0
10	1708197	.	T	A	20	15	35	0	0	35	0	0
10	1708230	.	T	C	23	17	40	0	1	41	0	0
10	1708239	.	A	T	20	21	41	0	0	41	0	0
10	1708412	.	A	T	33	24	57	0	3	60	0	0
10	1709165	.	T	A	33	24	57	0	1	58	0	0
10	1709331	.	T	G	28	28	56	0	2	58	0	0
10	1709731	.	G	A	24	36	60	0	1	61	0	0
10	1709783	.	G	A	32	27	59	0	4	63	0	0
10	1709836	.	T	G	24	23	47	0	4	51	0	0
10	1709855	.	C	T	28	21	49	0	2	51	0	0
10	1709871	.	G	A	30	20	50	0	0	50	0	0
10	1710270	.	A	G	29	24	53	1	1	55	0	0
10	1710358	.	C	T	24	17	41	0	5	46	0	0
10	1711061	.	T	C	25	1	26	0	20	46	0	0
10	1711136	.	T	C	30	28	58	0	1	59	0	0
10	1711188	.	T	A	21	26	47	0	4	51	0	0
10	1711211	.	C	T	22	22	44	0	3	47	0	0
10	1711711	.	G	A	28	21	49	0	2	51	0	0
10	1711780	.	C	T	5	20	25	0	19	44	0	0
10	1712091	.	G	A	17	11	28	5	2	35	0	0
10	1712100	.	T	A	20	11	31	1	1	33	0	0
10	1712306	.	G	A	12	35	47	0	0	47	0	0
10	1712316	.	C	T	7	34	41	0	1	42	0	0
10	1712457	.	C	A	25	11	36	12	0	48	0	0
10	1712468	.	G	A	26	4	30	12	2	44	0	0
10	1712658	.	G	A	26	22	48	0	3	51	0	0
10	1712757	.	A	G	22	27	49	0	2	51	0	0
10	1712899	.	A	T	28	28	56	0	2	59	1	0
10	1712964	.	T	G	66	1	67	0	1	69	1	0
10	1713418	.	T	C	22	27	49	0	8	57	0	0
10	1718294	.	C	A	32	21	53	0	3	56	0	0
10	1745541	.	A	T	2	5	7	0	0	7	0	0
10	1745738	.	T	A	9	4	13	0	1	14	0	0
10	1776112	.	G	A	2	5	7	0	0	7	0	0
10	1782662	.	C	T	5	4	9	0	0	9	0	0
10	1782953	.	C	T	1	2	3	0	4	7	0	0
10	1782968	.	C	G	3	4	7	0	0	7	0	0
10	1798869	.	T	G	2	4	6	0	0	6	0	0
10	1866818	.	G	A	12	6	18	0	0	19	1	0
10	1869266	.	G	A	14	12	26	0	0	26	0	0
10	1869313	.	G	T	8	17	25	0	2	27	0	0
10	1869328	.	C	T	8	15	23	0	1	24	0	0
10	1871634	.	G	T	1	15	16	0	12	28	0	0
10	1880470	.	A	G	12	16	28	0	1	29	0	0
10	1880734	.	C	T	10	8	18	0	0	18	0	0
10	1885891	.	A	C	14	9	23	0	3	26	0	0
10	1886113	.	G	A	0	12	12	0	11	23	0	0
10	1886119	.	T	G	15	11	26	0	0	26	0	0
10	1886182	.	C	T	9	15	24	0	0	24	0	0
10	1886265	.	C	G	13	12	25	0	0	25	0	0
10	1886587	.	T	C	17	10	27	0	0	27	0	0
10	1886590	.	T	A	16	12	28	0	1	29	0	0
10	1886764	.	T	C	19	13	32	0	1	33	0	0
10	1887238	.	C	T	14	16	30	0	0	30	0	0
10	1887364	.	C	T	12	17	29	0	3	32	0	0
10	1887496	.	A	G	14	0	14	0	11	25	0	0
10	1887811	.	A	G	24	15	39	0	0	39	0	0
10	1888135	.	G	C	19	19	38	0	1	39	0	0
10	1888222	.	C	T	15	15	30	0	1	31	0	0
10	1888225	.	G	A	16	17	33	0	0	33	0	0
10	1888303	.	C	T	20	15	35	0	1	36	0	0
10	1888414	.	T	C	19	18	37	0	2	39	0	0
10	1888438	.	C	T	23	22	45	0	3	48	0	0
10	1888487	.	T	C	25	23	48	0	1	49	0	0
10	1888515	.	C	T	24	21	45	0	0	45	0	0
10	1888824	.	C	T	15	18	33	0	0	33	0	0
10	1888893	.	C	T	13	18	31	0	0	31	0	0
10	1889171	.	G	T	25	24	49	0	1	50	0	0
10	1889179	.	A	G	22	2	24	0	25	49	0	0
10	1889255	.	C	T	20	9	29	1	1	32	1	0
10	1889296	.	C	T	18	10	28	0	1	29	0	0
10	1889882	.	A	C	15	22	37	0	3	40	0	0
10	1890313	.	A	G	23	26	49	0	2	51	0	0
10	1890949	.	T	C	29	13	42	0	0	42	0	0
10	1890961	.	G	A	26	16	42	0	1	43	0	0
10	1891018	.	G	A	2	22	24	0	28	52	0	0
10	1891660	.	G	C	19	17	36	0	3	39	0	0
10	1891724	.	G	C	27	26	53	0	1	54	0	0
10	1892516	.	G	A	16	21	37	0	0	37	0	0
10	2234379	.	C	T	10	11	21	1	1	23	0	0
10	2255014	.	T	C	6	12	18	0	0	18	0	0
10	2261897	.	A	T	7	5	12	0	0	12	0	0
10	2261921	.	G	C	8	5	13	0	0	13	0	0
10	2283925	.	C	T	10	9	19	0	0	19	0	0
10	2283976	.	T	C	10	6	16	0	1	17	0	0
10	2292380	.	G	T	17	6	23	0	0	23	0	0
10	2294325	.	G	A	15	11	26	0	0	26	0	0
10	2328740	.	C	A	13	9	22	0	0	22	0	0
10	2339274	.	C	T	15	4	19	1	0	20	0	0
10	2354973	.	C	A	12	13	25	0	0	25	0	0
10	2367762	.	C	T	12	10	22	0	0	22	0	0
10	2393715	.	G	A	12	10	22	0	4	26	0	0
10	2393763	.	G	C	17	13	30	0	1	31	0	0
10	2504174	.	G	T	16	20	36	0	1	37	0	0
10	2504210	.	C	T	1	18	19	0	18	37	0	0
10	2506081	.	G	A	26	23	49	0	3	52	0	0
10	2510397	.	C	G	1	19	20	0	18	38	0	0
10	2515351	.	T	G	18	19	37	0	2	39	0	0
10	2515447	.	T	C	17	0	17	0	21	38	0	0
10	2526413	.	A	G	16	25	41	0	2	43	0	0
10	2547663	.	A	G	2	3	5	0	0	5	0	0
10	2575204	.	A	G	11	0	11	0	18	29	0	0
10	2575369	.	T	C	18	11	29	0	0	29	0	0
10	2666387	.	A	G	4	0	4	0	4	8	0	0
10	2681622	.	C	T	6	4	10	0	0	10	0	0
10	2681771	.	G	A	8	10	18	0	1	19	0	0
10	2681800	.	C	T	2	11	13	0	7	20	0	0
10	2704653	.	C	T	10	4	14	0	0	14	0	0
10	2704752	.	G	T	3	9	12	0	0	12	0	0
10	2759276	.	G	A	9	11	20	0	3	23	0	0
10	2759329	.	T	G	12	13	25	0	2	27	0	0
10	2759381	.	G	C	16	15	31	0	0	31	0	0
10	2759391	.	A	T	14	15	29	0	1	30	0	0
10	2772036	.	G	A	13	10	23	0	1	24	0	0
10	2772057	.	G	A	12	7	19	0	2	21	0	0
10	2778444	.	G	A	17	7	24	0	0	24	0	0
10	2782761	.	G	A	8	9	17	0	1	18	0	0
10	2788649	.	A	T	13	9	22	0	1	23	0	0
10	2850675	.	A	G	8	0	8	0	7	15	0	0
10	2888166	.	C	A	6	10	16	0	0	16	0	0
10	2891905	.	G	A	10	6	16	0	0	16	0	0
10	2894148	.	G	C	8	7	15	0	0	15	0	0
10	2894193	.	T	G	3	0	3	0	5	8	0	0
10	2894545	.	C	T	9	10	19	0	0	19	0	0
10	2897110	.	A	C	9	8	17	0	1	18	0	0
10	2897720	.	T	A	7	15	22	0	0	22	0	0
10	2897817	.	T	G	6	0	6	0	8	14	0	0
10	2897897	.	A	G	4	4	8	0	0	8	0	0
10	2897911	.	G	T	4	3	7	0	0	7	0	0
10	2898087	.	T	C	1	3	4	0	0	4	0	0
10	2898269	.	C	T	0	3	3	0	2	5	0	0
10	2899143	.	T	G	1	0	1	0	2	3	0	0
10	2899238	.	A	G	1	4	5	0	0	5	0	0
10	2899345	.	A	G	5	2	7	0	0	7	0	0
10	2899399	.	C	T	2	2	4	0	1	5	0	0
10	2899425	.	G	C	0	3	3	0	2	5	0	0
10	2899436	.	C	T	2	3	5	0	0	5	0	0
10	2899496	.	T	A	1	2	3	0	0	3	0	0
10	2899675	.	A	G	3	3	6	0	0	6	0	0
10	2902681	.	A	C	3	4	7	0	0	7	0	0
10	2904581	.	T	C	3	4	7	0	0	7	0	0
10	2904794	.	C	T	1	5	6	0	0	6	0	0
10	2906893	.	T	C	2	2	4	0	0	4	0	0
10	2907353	.	A	G	2	1	3	0	0	3	0	0
10	2907362	.	T	C	2	2	4	0	0	4	0	0
10	2909135	.	G	A	2	2	4	0	0	4	0	0
10	2910591	.	G	T	2	2	4	0	0	4	0	0
10	2915399	.	G	A	7	6	13	0	0	13	0	0
10	2915412	.	A	G	8	10	18	0	0	18	0	0
10	2915462	.	G	A	1	6	7	0	6	13	0	0
10	2915495	.	C	T	3	5	8	0	0	8	0	0
10	2916931	.	A	T	4	4	8	0	0	8	0	0
10	2920032	.	C	T	5	4	9	0	0	9	0	0
10	2921236	.	T	C	2	9	11	0	0	11	0	0
10	2981073	.	C	T	7	4	11	0	0	11	0	0
10	2983307	.	G	A	3	3	6	0	0	6	0	0
10	2983662	.	G	A	0	4	4	0	3	7	0	0
10	2983715	.	C	T	4	3	7	0	0	7	0	0
10	2983736	.	A	G	4	2	6	0	0	6	0	0
10	2984035	.	T	C	2	2	4	0	0	4	0	0
10	2984171	.	A	T	3	2	5	0	0	5	0	0
10	2984435	.	C	T	5	2	7	0	0	7	0	0
10	2984557	.	T	C	3	5	8	0	0	8	0	0
10	2984819	.	G	C	0	3	3	0	4	7	0	0
10	2984902	.	T	C	4	2	6	0	0	6	0	0
10	2984945	.	G	A	0	3	3	0	3	6	0	0
10	2985032	.	G	T	0	4	4	0	6	10	0	0
10	2987020	.	A	G	3	0	3	0	7	10	0	0
10	3007051	.	A	C	9	4	13	0	0	13	0	0
10	3016263	.	T	C	8	7	15	0	0	15	0	0
10	3024637	.	C	G	9	11	20	0	0	20	0	0
10	3024706	.	C	T	5	10	15	0	2	17	0	0
10	3026264	.	A	C	13	10	23	0	1	24	0	0
10	3026376	.	A	G	9	15	24	0	1	25	0	0
10	3026484	.	G	A	0	4	4	0	5	9	0	0
10	3026521	.	A	C	3	5	8	0	0	8	0	0
10	3031760	.	A	G	7	7	14	0	0	14	0	0
10	3032072	.	C	T	2	4	6	0	4	10	0	0
10	3032353	.	T	A	5	4	9	0	0	9	0	0
10	3033231	.	G	A	4	4	8	0	0	8	0	0
10	3033247	.	A	G	4	3	7	0	0	7	0	0
10	3308482	.	G	A	0	11	11	0	13	24	0	0
10	3311737	.	T	G	12	7	19	0	2	21	0	0
10	3311800	.	A	G	11	0	11	0	13	24	0	0
10	3311845	.	G	A	11	8	19	0	1	20	0	0
10	3314596	.	T	C	8	19	27	0	0	27	0	0
10	3317976	.	G	A	1	10	11	0	9	20	0	0
10	3318005	.	G	C	1	13	14	0	6	20	0	0
10	3318060	.	G	A	4	8	12	0	0	12	0	0
10	3318358	.	G	T	4	3	7	0	0	7	0	0
10	3318454	.	G	A	9	3	12	0	1	13	0	0
10	3319873	.	A	G	11	0	11	0	11	22	0	0
10	3319890	.	G	T	1	10	11	0	11	22	0	0
10	3319938	.	C	T	15	12	27	0	0	27	0	0
10	3320007	.	C	G	8	13	21	0	0	21	0	0
10	3320015	.	T	C	7	11	18	0	1	19	0	0
10	3320151	.	A	G	17	19	36	0	2	38	0	0
10	3320194	.	G	A	17	14	31	0	1	32	0	0
10	3320229	.	G	A	10	17	27	0	1	28	0	0
10	3320287	.	T	G	19	7	26	0	3	29	0	0
10	3320465	.	C	G	15	12	27	0	2	29	0	0
10	3320495	.	A	T	14	17	31	0	2	34	1	0
10	3320506	.	C	T	17	13	30	0	2	32	0	0
10	3320705	.	G	A	18	11	29	0	1	30	0	0
10	3320776	.	C	T	14	15	29	0	1	30	0	0
10	3320850	.	C	T	17	10	27	0	2	29	0	0
10	3321040	.	A	G	17	7	24	0	1	25	0	0
10	3321041	.	A	G	4	18	22	0	2	24	0	0
10	3321416	.	T	G	9	13	22	0	3	25	0	0
10	3322194	.	A	G	19	1	20	0	7	27	0	0
10	3336838	.	C	T	2	6	8	0	0	8	0	0
10	3336846	.	T	A	4	9	13	0	0	13	0	0
10	3341412	.	C	T	10	9	19	0	0	19	0	0
10	3353607	.	C	T	9	9	18	0	0	18	0	0
10	3353622	.	A	G	10	9	19	0	0	19	0	0
10	3354048	.	A	G	11	12	23	0	1	24	0	0
10	3358897	.	A	T	9	14	23	0	4	27	0	0
10	3364772	.	A	T	8	7	15	0	0	15	0	0
10	3365063	.	C	T	0	8	8	1	9	18	0	0
10	3365312	.	T	C	3	7	10	0	2	12	0	0
10	3365726	.	A	C	23	0	23	1	1	25	0	0
10	3365834	.	A	T	10	11	21	0	1	22	0	0
10	3366095	.	C	T	1	12	13	0	14	27	0	0
10	3366199	.	C	T	2	9	11	0	8	19	0	0
10	3370680	.	G	A	4	5	9	0	1	10	0	0
10	3371866	.	G	A	6	4	10	0	0	10	0	0
10	3377087	.	G	A	6	5	11	0	0	11	0	0
10	3379107	.	T	C	1	0	1	0	4	5	0	0
10	3381744	.	A	G	3	5	8	0	0	8	0	0
10	3388200	.	T	G	5	12	17	0	0	17	0	0
10	3400351	.	A	T	4	2	6	0	2	8	0	0
10	3408009	.	G	A	1	3	4	0	0	4	0	0
10	3416152	.	T	C	1	2	3	0	0	3	0	0
10	3420097	.	A	T	21	20	41	0	0	41	0	0
10	3426363	.	G	A	14	24	38	0	6	44	0	0
10	3428230	.	G	C	5	8	13	0	0	13	0	0
10	3430894	.	C	G	5	5	10	0	0	10	0	0
10	3434883	.	C	T	5	4	9	0	0	9	0	0
10	3435321	.	T	A	7	10	17	0	0	17	0	0
10	3436370	.	C	T	8	4	12	0	0	12	0	0
10	3438991	.	T	C	8	8	16	0	1	17	0	0
10	3439018	.	A	G	9	5	14	0	0	14	0	0
10	3441973	.	T	C	8	5	13	0	0	13	0	0
10	3442030	.	T	C	6	4	10	0	0	10	0	0
10	3445818	.	C	T	8	6	14	0	1	15	0	0
10	3450861	.	A	G	5	10	15	0	0	15	0	0
10	3451091	.	G	A	3	5	8	0	1	9	0	0
10	3451429	.	G	A	0	8	8	0	14	22	0	0
10	3451672	.	A	G	4	7	11	0	0	11	0	0
10	3451688	.	C	T	5	5	10	0	0	10	0	0
10	3451848	.	G	A	1	4	5	0	5	10	0	0
10	3451864	.	C	T	3	8	11	0	0	11	0	0
10	3452124	.	A	G	9	6	15	0	2	17	0	0
10	3452183	.	G	A	3	6	9	0	1	10	0	0
10	3452185	.	T	A	3	7	10	0	0	10	0	0
10	3884831	.	G	A	0	4	4	0	7	11	0	0
10	3884936	.	G	A	2	8	10	0	0	10	0	0
10	3884957	.	G	A	9	3	12	0	0	12	0	0
10	3885050	.	C	T	2	8	10	0	0	10	0	0
10	3942996	.	T	A	6	7	13	0	0	13	0	0
10	3943026	.	A	G	9	0	9	0	3	12	0	0
10	3969027	.	G	T	0	3	3	0	3	6	0	0
10	3969491	.	G	T	3	9	12	0	0	12	0	0
10	3969887	.	C	T	2	5	7	0	0	7	0	0
10	3979870	.	G	A	9	4	13	0	2	15	0	0
10	3979876	.	C	A	9	5	14	0	1	15	0	0
10	3987505	.	T	C	7	6	13	0	0	13	0	0
10	4010300	.	A	G	6	3	9	0	0	9	0	0
10	4010345	.	G	T	0	4	4	0	11	15	0	0
10	4016017	.	G	A	5	5	10	0	1	11	0	0
10	4024798	.	G	A	6	3	9	0	0	9	0	0
10	4026443	.	T	G	3	0	3	0	5	8	0	0
10	4029455	.	C	T	9	11	20	0	0	20	0	0
10	4029507	.	T	C	8	8	16	0	0	16	0	0
10	4029634	.	A	G	8	7	15	0	1	16	0	0
10	4030349	.	C	T	5	6	11	0	1	12	0	0
10	4030352	.	C	A	6	6	12	0	0	12	0	0
10	4032623	.	C	T	8	5	13	0	0	13	0	0
10	4037287	.	G	A	6	3	9	0	0	9	0	0
10	4038772	.	G	A	9	12	21	0	1	22	0	0
10	4038898	.	A	G	15	9	24	0	0	24	0	0
10	4039123	.	C	T	14	15	29	0	2	31	0	0
10	4039129	.	C	T	15	15	30	0	1	31	0	0
10	4060322	.	T	C	4	8	12	0	1	13	0	0
10	4067500	.	T	G	5	2	7	0	0	7	0	0
10	4073792	.	C	T	5	3	8	0	1	9	0	0
10	4240887	.	T	C	21	11	32	0	0	32	0	0
10	4240899	.	C	T	20	11	31	0	1	32	0	0
10	4279800	.	A	G	3	6	9	0	1	10	0	0
10	4290174	.	T	A	2	2	4	0	0	4	0	0
10	4291002	.	G	T	1	3	4	0	0	4	0	0
10	4314971	.	G	T	4	3	7	0	1	8	0	0
10	4370791	.	G	A	4	2	6	0	0	6	0	0
10	4501609	.	C	T	17	6	23	0	1	24	0	0
10	4501733	.	G	A	11	10	21	0	1	22	0	0
10	4501817	.	A	G	12	7	19	0	0	19	0	0
10	4503291	.	G	T	14	7	21	0	0	21	0	0
10	4503736	.	C	T	9	10	19	0	1	20	0	0
10	4503901	.	C	G	14	6	20	0	2	22	0	0
10	4505886	.	T	A	13	13	26	0	1	27	0	0
10	4505887	.	T	A	13	14	27	0	0	27	0	0
10	4508492	.	T	A	16	9	25	0	0	25	0	0
10	4508518	.	G	T	0	8	8	0	18	26	0	0
10	4808047	.	G	A	4	3	7	0	0	7	0	0
10	4808105	.	A	G	3	2	5	0	0	5	0	0
10	4808241	.	A	C	2	2	4	0	0	4	0	0
10	4808266	.	G	A	3	3	6	0	0	6	0	0
10	4808473	.	A	T	3	4	7	0	0	7	0	0
10	4808498	.	T	C	4	5	9	0	0	9	0	0
10	4888387	.	C	A	5	8	13	0	0	13	0	0
10	4888457	.	A	G	11	6	17	0	0	17	0	0
10	4888582	.	A	G	5	0	5	0	6	11	0	0
10	4888666	.	A	G	8	0	8	0	10	18	0	0
10	4888808	.	C	T	4	5	9	0	1	10	0	0
10	4888832	.	G	A	1	4	5	0	7	12	0	0
10	4888988	.	T	C	4	7	11	0	0	11	0	0
10	4889119	.	A	T	5	6	11	0	0	11	0	0
10	4889159	.	C	A	1	6	7	0	2	9	0	0
10	4889228	.	C	T	4	4	8	0	0	8	0	0
10	4889248	.	T	C	5	5	10	0	0	10	0	0
10	4889302	.	C	A	7	7	14	0	0	14	0	0
10	4889704	.	A	G	12	12	24	0	1	25	0	0
10	4889923	.	A	G	7	0	7	0	7	14	0	0
10	4890027	.	C	T	4	2	6	0	0	6	0	0
10	4890082	.	G	C	8	4	12	0	0	12	0	0
10	4896742	.	G	A	6	13	19	0	0	19	0	0
10	4896766	.	G	A	7	11	18	0	0	18	0	0
10	4940895	.	A	G	6	8	14	0	0	14	0	0
10	4941113	.	A	G	4	6	10	0	0	10	0	0
10	4941342	.	G	C	8	7	15	0	0	15	0	0
10	4941421	.	T	G	8	3	11	0	0	11	0	0
10	4950824	.	G	T	13	5	18	0	0	18	0	0
10	4956906	.	C	T	9	9	18	0	0	18	0	0
10	4956966	.	G	A	9	12	21	0	0	21	0	0
10	4966683	.	G	A	1	12	13	0	21	34	0	0
10	4968900	.	G	C	12	8	20	0	1	21	0	0
10	4969014	.	T	A	4	8	12	0	0	12	0	0
10	4969036	.	T	G	2	0	2	0	8	10	0	0
10	4969069	.	C	A	3	3	6	0	0	6	0	0
10	5000719	.	C	T	1	13	14	2	11	27	0	0
10	5000753	.	C	T	3	14	17	0	14	31	0	0
10	5004215	.	C	T	5	4	9	0	3	12	0	0
10	5010287	.	G	A	28	19	47	0	1	48	0	0
10	5010344	.	T	G	30	21	51	0	0	51	0	0
10	5010407	.	G	A	21	25	46	0	2	48	0	0
10	5016797	.	G	A	24	31	55	0	1	56	0	0
10	5016917	.	C	G	25	30	55	0	2	57	0	0
10	5016922	.	A	G	27	23	50	0	5	55	0	0
10	5020320	.	G	A	38	24	62	0	3	65	0	0
10	5020326	.	T	C	26	38	64	0	2	66	0	0
10	5024410	.	C	T	31	26	57	0	3	60	0	0
10	5025848	.	C	A	12	8	20	0	1	21	0	0
10	5026058	.	C	T	14	8	22	0	0	22	0	0
10	5028877	.	A	G	13	11	24	0	1	25	0	0
10	5031869	.	T	C	10	13	23	0	0	23	0	0
10	5036521	.	G	A	1	7	8	0	8	16	0	0
10	5036522	.	A	G	9	7	16	0	0	16	0	0
10	5036729	.	C	T	7	8	15	0	1	16	0	0
10	5036881	.	A	G	6	3	9	0	2	11	0	0
10	5037119	.	T	A	12	5	17	0	0	17	0	0
10	5037147	.	C	T	3	7	10	0	0	10	0	0
10	5037181	.	T	G	8	4	12	0	0	12	0	0
10	5037372	.	A	T	14	5	19	0	0	19	0	0
10	5042034	.	A	C	1	4	5	0	0	5	0	0
10	5042113	.	C	T	7	8	15	0	0	15	0	0
10	5042217	.	A	G	6	6	12	0	0	12	0	0
10	5042239	.	G	A	3	5	8	0	1	9	0	0
10	5042469	.	G	A	13	8	21	0	0	21	0	0
10	5047452	.	A	G	10	7	17	1	1	19	0	0
10	5053518	.	C	G	4	3	7	0	0	7	0	0
10	5053556	.	T	C	4	4	8	0	0	8	0	0
10	5058715	.	C	T	1	4	5	0	12	17	0	0
10	5092764	.	T	C	2	6	8	3	0	11	0	0
10	5092772	.	A	G	1	5	6	4	0	10	0	0
10	5093157	.	T	C	6	6	12	3	0	15	0	0
10	5093222	.	A	G	12	11	23	0	0	23	0	0
10	5093240	.	C	A	7	7	14	0	0	15	1	0
10	5093274	.	A	G	3	3	6	0	0	6	0	0
10	5094649	.	C	A	2	8	10	0	0	10	0	0
10	5094778	.	G	T	7	8	15	0	0	15	0	0
10	5097478	.	G	A	5	5	10	0	2	12	0	0
10	5097520	.	A	G	6	3	9	0	1	10	0	0
10	5110656	.	T	C	14	7	21	0	1	22	0	0
10	5110761	.	A	G	7	4	11	0	0	11	0	0
10	5110777	.	G	A	6	4	10	0	1	11	0	0
10	5113791	.	G	T	2	3	5	0	0	5	0	0
10	5113812	.	C	A	0	4	4	0	2	6	0	0
10	5114117	.	A	C	5	2	7	0	0	7	0	0
10	5119482	.	G	A	1	3	4	0	0	4	0	0
10	5124214	.	A	T	5	3	8	0	0	8	0	0
10	5124374	.	C	T	3	4	7	0	0	7	0	0
10	5124609	.	G	T	4	4	8	0	0	8	0	0
10	5124612	.	A	G	4	4	8	0	0	8	0	0
10	5124969	.	T	C	7	4	11	0	0	11	0	0
10	5126927	.	T	G	2	7	9	0	0	9	0	0
10	5131318	.	A	G	3	2	5	0	0	5	0	0
10	5203569	.	G	A	13	13	26	0	0	26	0	0
10	5216204	.	T	C	6	13	19	0	4	23	0	0
10	5216249	.	A	G	15	15	30	0	0	30	0	0
10	5220608	.	C	T	13	18	31	0	0	31	0	0
10	5220835	.	G	A	1	4	5	0	9	14	0	0
10	5220940	.	T	A	11	16	27	0	0	27	0	0
10	5220992	.	C	T	11	10	21	0	1	22	0	0
10	5220997	.	C	A	10	10	20	0	2	22	0	0
10	5221039	.	G	A	15	11	26	0	1	27	0	0
10	5221238	.	C	A	7	11	18	0	0	18	0	0
10	5221292	.	C	A	12	7	19	0	0	19	0	0
10	5221297	.	T	G	12	7	19	0	1	20	0	0
10	5221336	.	G	C	10	8	18	0	0	18	0	0
10	5237199	.	C	A	2	2	4	0	0	4	0	0
10	5239838	.	G	A	0	5	5	0	4	9	0	0
10	5245143	.	G	A	1	7	8	0	5	13	0	0
10	5248247	.	T	C	8	4	12	0	0	12	0	0
10	5257980	.	C	T	4	2	6	0	0	6	0	0
10	5258914	.	T	A	12	8	20	0	0	20	0	0
10	5264280	.	A	G	8	7	15	0	1	16	0	0
10	5264310	.	G	A	6	6	12	0	2	14	0	0
10	5264458	.	G	A	9	4	13	0	1	14	0	0
10	5264534	.	C	A	7	3	10	0	1	11	0	0
10	5265002	.	C	G	2	2	4	0	0	4	0	0
10	5414339	.	C	T	5	2	7	0	1	8	0	0
10	5417669	.	T	A	2	6	8	0	0	8	0	0
10	5417841	.	A	C	5	2	7	0	0	7	0	0
10	5418509	.	A	G	8	5	13	0	1	14	0	0
10	5418569	.	C	T	8	8	16	0	0	16	0	0
10	5429905	.	G	A	0	5	5	0	7	12	0	0
10	5432576	.	T	C	8	4	12	0	0	12	0	0
10	5461988	.	C	A	6	10	16	0	0	16	0	0
10	5461994	.	T	A	6	9	15	0	0	15	0	0
10	5475206	.	G	C	10	7	17	0	0	17	0	0
10	5475214	.	T	G	9	6	15	0	1	16	0	0
10	5475406	.	A	T	1	3	4	0	0	4	0	0
10	5475436	.	A	G	6	2	8	0	0	8	0	0
10	5475526	.	T	C	3	5	8	0	0	8	0	0
10	5534179	.	T	A	3	6	9	0	0	9	0	0
10	5534369	.	T	A	3	4	7	0	0	7	0	0
10	5534483	.	T	C	4	4	8	0	0	8	0	0
10	5534487	.	C	T	0	4	4	0	4	8	0	0
10	5534527	.	G	T	10	4	14	0	0	14	0	0
10	5534539	.	G	A	10	3	13	0	0	13	0	0
10	5534611	.	C	T	5	8	13	1	0	14	0	0
10	5534612	.	A	G	5	8	13	1	0	14	0	0
10	5534646	.	A	G	8	9	17	0	0	17	0	0
10	5534878	.	C	T	10	9	19	0	0	19	0	0
10	5534946	.	A	G	16	7	23	0	0	23	0	0
10	5534950	.	A	T	13	6	19	0	2	21	0	0
10	5535359	.	A	T	7	6	13	0	0	13	0	0
10	5535368	.	T	A	6	4	10	0	1	11	0	0
10	5535436	.	C	T	4	6	10	0	0	10	0	0
10	5535445	.	T	C	4	7	11	0	0	11	0	0
10	5535483	.	A	T	10	9	19	0	0	19	0	0
10	5535540	.	T	G	4	16	20	0	3	24	1	0
10	5535561	.	T	A	5	16	21	0	0	21	0	0
10	5536182	.	A	C	1	2	3	0	0	3	0	0
10	5536256	.	G	A	3	2	5	0	0	5	0	0
10	5536534	.	T	A	5	4	9	0	0	9	0	0
10	5536831	.	G	T	4	2	6	0	0	6	0	0
10	5537048	.	G	T	3	4	7	0	0	7	0	0
10	5538302	.	T	G	7	5	12	0	2	14	0	0
10	5542152	.	T	C	8	7	15	0	0	15	0	0
10	5545438	.	C	T	13	7	20	0	1	21	0	0
10	5545465	.	T	C	14	5	19	0	0	19	0	0
10	5568128	.	G	T	7	6	13	0	0	13	0	0
10	5568155	.	T	G	7	7	14	0	0	14	0	0
10	5568212	.	G	A	10	5	15	0	1	16	0	0
10	5568319	.	A	C	11	7	18	0	1	19	0	0
10	5568329	.	A	G	11	9	20	0	1	21	0	0
10	5667605	.	C	T	5	6	11	0	1	12	0	0
10	5667676	.	C	A	3	3	6	0	0	6	0	0
10	5667687	.	C	G	2	2	4	0	0	4	0	0
10	5667792	.	G	A	1	4	5	0	0	5	0	0
10	5667813	.	T	A	3	5	8	0	0	8	0	0
10	5668103	.	C	T	8	4	12	0	2	14	0	0
10	5668135	.	G	A	10	4	14	0	1	15	0	0
10	5668218	.	G	C	7	9	16	0	1	17	0	0
10	5676520	.	T	A	2	3	5	0	0	5	0	0
10	5683981	.	G	T	1	2	3	0	0	3	0	0
10	5689607	.	A	G	5	2	7	0	0	7	0	0
10	5724020	.	T	C	16	11	27	0	2	29	0	0
10	5724095	.	T	C	28	18	46	0	1	47	0	0
10	5737757	.	G	A	25	16	41	0	0	41	0	0
10	5744934	.	C	T	28	13	41	0	1	42	0	0
10	5745015	.	C	A	26	16	42	0	1	44	1	0
10	5745290	.	T	C	22	19	41	2	1	44	0	0
10	5745299	.	C	T	18	21	39	2	4	45	0	0
10	5760455	.	T	C	24	18	42	0	0	42	0	0
10	5760461	.	A	G	25	18	43	0	2	45	0	0
10	5766958	.	A	G	23	27	50	0	2	52	0	0
10	5769541	.	G	T	27	29	56	0	0	56	0	0
10	5772568	.	A	G	24	31	55	0	3	58	0	0
10	5782337	.	C	T	27	29	56	0	5	61	0	0
10	5788755	.	A	C	6	6	12	0	0	12	0	0
10	5788806	.	G	A	5	10	15	0	1	16	0	0
10	5788877	.	G	A	2	5	7	0	0	7	0	0
10	5789155	.	G	T	6	6	12	0	0	12	0	0
10	5789415	.	A	G	3	2	5	0	0	5	0	0
10	5789417	.	G	C	3	2	5	0	0	5	0	0
10	5789995	.	C	T	6	4	10	0	0	10	0	0
10	5790001	.	C	A	2	3	5	0	0	5	0	0
10	5790080	.	A	G	8	12	20	0	1	21	0	0
10	5790097	.	G	A	8	8	16	1	0	17	0	0
10	5790210	.	C	T	6	16	22	0	0	22	0	0
10	5790278	.	G	T	10	5	15	1	1	17	0	0
10	5790570	.	A	C	8	6	14	0	1	15	0	0
10	5790640	.	T	G	3	5	8	0	1	9	0	0
10	5790866	.	A	C	5	8	13	0	1	14	0	0
10	5790913	.	A	C	7	6	13	0	0	13	0	0
10	5790922	.	C	A	7	5	12	0	0	12	0	0
10	5790956	.	C	G	1	8	9	0	10	19	0	0
10	5791030	.	A	G	13	10	23	0	0	23	0	0
10	5791044	.	C	T	2	11	13	0	11	24	0	0
10	5791184	.	G	A	9	10	19	0	0	19	0	0
10	5791224	.	C	G	8	9	17	0	1	18	0	0
10	5791238	.	A	G	8	8	16	0	0	16	0	0
10	5791377	.	A	T	9	13	22	0	0	22	0	0
10	5791387	.	G	A	10	12	22	0	1	23	0	0
10	5791417	.	C	T	0	13	13	0	9	22	0	0
10	5792512	.	A	T	8	7	15	0	1	16	0	0
10	5792533	.	A	T	7	6	13	0	1	14	0	0
10	5792573	.	G	A	8	4	12	0	0	12	0	0
10	5792584	.	A	G	9	4	13	0	0	13	0	0
10	5792615	.	A	G	7	4	11	0	0	11	0	0
10	5792667	.	G	A	11	6	17	0	0	17	0	0
10	5792722	.	T	C	7	0	7	0	8	15	0	0
10	5792757	.	A	G	3	4	7	0	2	9	0	0
10	5792845	.	T	C	4	3	7	0	1	8	0	0
10	5793197	.	G	A	3	3	6	0	0	6	0	0
10	5793376	.	G	A	3	3	6	0	0	6	0	0
10	5793863	.	A	G	5	6	11	0	0	11	0	0
10	5793961	.	A	G	5	4	9	0	0	9	0	0
10	5794423	.	C	G	6	5	11	0	0	11	0	0
10	5796929	.	C	T	0	5	5	0	3	8	0	0
10	5804114	.	C	A	2	3	5	0	0	5	0	0
10	5810895	.	A	G	3	7	10	0	0	10	0	0
10	5810940	.	A	G	5	6	11	0	0	11	0	0
10	5813696	.	A	G	6	5	11	0	0	11	0	0
10	5828645	.	A	G	8	9	17	0	1	18	0	0
10	5828660	.	A	G	10	10	20	0	0	20	0	0
10	5828704	.	C	A	1	16	17	0	8	25	0	0
10	5828840	.	A	G	6	5	11	0	0	11	0	0
10	5828945	.	A	G	10	12	22	0	0	22	0	0
10	5834171	.	C	T	8	12	20	0	0	20	0	0
10	5834242	.	G	A	7	5	12	0	0	12	0	0
10	5837337	.	G	A	6	3	9	0	0	9	0	0
10	5844718	.	G	A	10	4	14	0	0	14	0	0
10	5844763	.	A	G	2	4	6	0	0	6	0	0
10	5847731	.	A	T	4	4	8	0	0	8	0	0
10	5847821	.	G	T	11	6	17	0	1	18	0	0
10	6016242	.	G	A	8	7	15	0	3	18	0	0
10	6016545	.	G	T	6	5	11	0	0	11	0	0
10	6023750	.	A	G	4	7	11	0	2	13	0	0
10	6023946	.	T	C	6	12	18	0	0	18	0	0
10	6023958	.	G	A	6	12	18	0	1	19	0	0
10	6024159	.	A	T	11	4	15	0	0	15	0	0
10	6024248	.	G	C	2	8	10	0	0	10	0	0
10	6032880	.	A	G	6	0	6	0	7	13	0	0
10	6032886	.	G	A	7	5	12	0	0	12	0	0
10	6033452	.	T	C	5	3	8	0	0	8	0	0
10	6033469	.	A	C	5	4	9	0	0	9	0	0
10	6033612	.	G	A	0	11	11	0	8	19	0	0
10	6033627	.	A	T	6	13	19	0	0	19	0	0
10	6034194	.	A	T	4	11	15	0	0	15	0	0
10	6260380	.	T	A	2	3	5	0	1	6	0	0
10	6263593	.	G	A	3	5	8	0	0	8	0	0
10	6265475	.	A	G	2	5	7	0	1	8	0	0
10	6267255	.	C	T	2	4	6	0	0	6	0	0
10	6275517	.	G	A	4	8	12	0	0	12	0	0
10	6275577	.	C	T	6	7	13	0	0	13	0	0
10	6278202	.	A	G	2	9	11	0	1	12	0	0
10	6280939	.	G	A	1	6	7	0	4	11	0	0
10	6280948	.	G	A	0	7	7	0	3	10	0	0
10	6281946	.	A	G	8	0	8	0	5	13	0	0
10	6301828	.	C	T	12	5	17	0	0	17	0	0
10	6301930	.	C	T	15	7	22	0	0	22	0	0
10	6312954	.	A	T	7	6	13	0	2	15	0	0
10	6313643	.	C	T	6	2	8	0	0	8	0	0
10	6348571	.	C	A	13	6	19	2	0	21	0	0
10	6372501	.	C	T	10	8	18	0	1	19	0	0
10	6372864	.	A	T	7	4	11	0	0	11	0	0
10	6372865	.	T	C	6	4	10	0	1	11	0	0
10	6372915	.	G	A	7	5	12	0	0	12	0	0
10	6372964	.	T	C	9	3	12	0	1	14	1	0
10	6373003	.	T	C	7	3	10	0	1	11	0	0
10	6373079	.	C	G	3	4	7	0	0	7	0	0
10	6373332	.	A	T	3	4	7	0	0	7	0	0
10	6373336	.	C	G	5	3	8	0	0	8	0	0
10	6373378	.	A	C	6	5	11	0	0	11	0	0
10	6373472	.	T	A	5	3	8	0	0	8	0	0
10	6373522	.	A	G	4	3	7	0	0	9	2	0
10	6373524	.	A	G	4	5	9	0	0	9	0	0
10	6373681	.	A	G	14	1	15	0	1	16	0	0
10	6374017	.	A	G	12	5	17	0	0	17	0	0
10	6374041	.	A	T	8	8	16	0	0	16	0	0
10	6374068	.	G	T	7	7	14	0	0	14	0	0
10	6374235	.	T	C	11	11	22	0	1	23	0	0
10	6374279	.	G	A	0	16	16	0	15	31	0	0
10	6374352	.	C	T	14	12	26	0	1	27	0	0
10	6374484	.	A	G	11	6	17	0	0	17	0	0
10	6374486	.	A	G	9	7	16	0	1	17	0	0
10	6400182	.	A	C	2	2	4	0	0	4	0	0
10	6401577	.	A	C	2	3	5	0	0	5	0	0
10	6401765	.	T	C	4	4	8	0	2	10	0	0
10	6401884	.	T	A	3	3	6	0	0	6	0	0
10	6402213	.	T	A	10	4	14	0	1	15	0	0
10	6402593	.	G	A	1	3	4	0	1	5	0	0
10	6402694	.	T	A	7	3	10	0	0	10	0	0
10	6402742	.	C	G	4	2	6	0	0	7	1	0
10	6404230	.	T	A	1	2	3	0	0	3	0	0
10	6404272	.	G	A	0	2	2	0	4	6	0	0
10	6404312	.	A	T	5	2	7	0	0	7	0	0
10	6404331	.	A	G	3	2	5	0	0	5	0	0
10	6404764	.	G	C	4	5	9	0	0	9	0	0
10	6404899	.	G	T	2	3	5	0	0	5	0	0
10	6404900	.	G	T	2	3	5	0	0	5	0	0
10	6405251	.	G	C	3	3	6	0	1	7	0	0
10	6405275	.	A	T	3	5	8	0	0	8	0	0
10	6405321	.	A	G	5	4	9	0	0	9	0	0
10	6406142	.	T	A	4	4	8	0	0	8	0	0
10	6406221	.	A	G	1	2	3	0	0	3	0	0
10	6406344	.	C	G	1	0	1	0	2	3	0	0
10	6406359	.	T	G	1	3	4	0	0	4	0	0
10	6406404	.	C	A	1	2	3	0	0	3	0	0
10	6407408	.	T	C	3	3	6	0	0	6	0	0
10	6407449	.	C	T	3	5	8	0	0	8	0	0
10	6407475	.	G	A	0	5	5	0	5	10	0	0
10	6407559	.	A	T	5	6	11	0	1	12	0	0
10	6407605	.	C	A	6	3	9	1	0	10	0	0
10	6407649	.	C	T	3	2	5	1	0	6	0	0
10	6407787	.	A	G	5	3	8	0	0	8	0	0
10	6407833	.	T	C	3	4	7	0	0	7	0	0
10	6407871	.	A	G	4	4	8	0	3	11	0	0
10	6407904	.	C	T	5	9	14	1	0	15	0	0
10	6408634	.	A	G	2	3	5	2	0	7	0	0
10	6408639	.	T	G	1	2	3	2	0	5	0	0
10	6408955	.	T	G	8	0	8	0	6	14	0	0
10	6408986	.	A	G	8	3	11	0	0	11	0	0
10	6409095	.	G	A	0	7	7	0	6	13	0	0
10	6409120	.	G	A	5	7	12	0	0	12	0	0
10	6409145	.	G	C	3	6	9	0	1	10	0	0
10	6409267	.	C	A	4	6	10	0	0	10	0	0
10	6409379	.	A	G	6	4	10	0	0	10	0	0
10	6409506	.	A	G	4	7	11	0	0	11	0	0
10	6473544	.	T	C	11	13	24	0	0	24	0	0
10	6473685	.	T	C	14	5	19	0	0	19	0	0
10	6473704	.	C	G	15	8	23	0	0	23	0	0
10	6473851	.	A	G	12	8	20	0	1	21	0	0
10	6473862	.	C	T	2	7	9	0	13	22	0	0
10	6473908	.	A	G	8	9	17	0	1	18	0	0
10	6473996	.	T	C	7	13	20	0	0	20	0	0
10	6474057	.	T	A	8	14	22	0	1	23	0	0
10	6479444	.	T	C	8	0	8	0	16	24	0	0
10	6479471	.	C	T	2	14	16	0	11	27	0	0
10	6510756	.	T	C	20	28	48	0	2	50	0	0
10	6510786	.	T	G	26	24	50	0	2	52	0	0
10	6510825	.	T	C	30	28	58	0	3	61	0	0
10	6517593	.	T	A	26	27	53	0	1	54	0	0
10	6517663	.	A	G	19	1	20	0	23	43	0	0
10	6517726	.	C	T	16	24	40	0	5	45	0	0
10	6517959	.	A	G	19	10	29	0	0	29	0	0
10	6522267	.	A	T	4	6	10	0	0	10	0	0
10	6531297	.	T	C	8	8	16	0	0	16	0	0
10	6533850	.	T	A	6	7	13	0	1	14	0	0
10	6546851	.	A	G	5	4	9	0	0	9	0	0
10	6546929	.	C	A	0	5	5	0	4	9	0	0
10	6549360	.	C	T	4	5	9	0	0	9	0	0
10	6566670	.	C	T	1	6	7	0	0	7	0	0
10	6578252	.	T	C	3	5	8	0	0	8	0	0
10	6582700	.	T	G	2	2	4	0	1	5	0	0
10	6587088	.	T	A	3	3	6	0	1	7	0	0
10	6781239	.	G	A	4	3	7	0	0	7	0	0
10	6781278	.	T	A	7	5	12	1	0	13	0	0
10	6781286	.	G	T	8	3	11	1	1	13	0	0
10	6781362	.	G	A	16	6	22	0	0	22	0	0
10	6781372	.	T	A	16	11	27	0	0	27	0	0
10	6781450	.	T	C	18	10	28	0	1	29	0	0
10	6781506	.	A	T	13	8	21	0	2	23	0	0
10	6781664	.	A	T	14	11	25	0	3	28	0	0
10	6781742	.	G	T	4	7	11	0	1	12	0	0
10	6781786	.	A	T	4	10	14	0	0	14	0	0
10	6781867	.	C	A	10	5	15	0	1	16	0	0
10	6781903	.	T	G	10	8	18	0	0	18	0	0
10	6781918	.	A	T	7	4	11	0	3	14	0	0
10	6782020	.	G	C	5	8	13	0	1	14	0	0
10	6782036	.	T	C	6	2	8	0	5	13	0	0
10	6782220	.	A	G	8	5	13	3	0	16	0	0
10	6782267	.	T	A	8	7	15	4	0	19	0	0
10	6782279	.	A	C	5	9	14	3	0	18	1	0
10	6782454	.	C	G	8	19	27	0	0	27	0	0
10	6782489	.	T	G	8	12	20	0	2	22	0	0
10	6782624	.	A	G	15	20	35	0	1	36	0	0
10	6782636	.	T	A	15	21	36	0	3	39	0	0
10	6782664	.	A	G	16	20	36	0	1	37	0	0
10	6786326	.	C	T	3	26	29	0	20	49	0	0
10	6786564	.	A	G	9	21	30	0	0	30	0	0
10	6804756	.	T	C	7	1	8	0	13	21	0	0
10	6824761	.	A	C	6	11	17	0	0	17	0	0
10	6824845	.	A	T	14	15	29	0	0	29	0	0
10	6824877	.	T	G	12	10	22	0	0	22	0	0
10	6831298	.	C	T	1	15	16	0	6	22	0	0
10	6831446	.	T	C	5	6	11	0	0	11	0	0
10	6834065	.	A	T	6	8	14	0	0	14	0	0
10	6834341	.	G	A	12	12	24	0	0	24	0	0
10	6834380	.	C	A	3	9	12	1	10	23	0	0
10	6846904	.	A	G	7	5	12	0	0	12	0	0
10	6851184	.	C	A	3	5	8	0	0	8	0	0
10	6916854	.	A	G	3	6	9	0	0	9	0	0
10	6918127	.	A	T	1	3	4	0	0	4	0	0
10	6918128	.	T	C	1	3	4	0	0	4	0	0
10	6925193	.	G	T	1	1	2	0	1	3	0	0
10	6928025	.	T	C	1	3	4	0	0	4	0	0
10	7210001	.	G	A	1	27	28	0	25	53	0	0
10	7221810	.	A	G	25	14	39	0	0	39	0	0
10	7222213	.	T	C	28	25	53	0	2	55	0	0
10	7224964	.	A	G	26	24	50	0	1	51	0	0
10	7231728	.	T	C	27	24	51	0	0	51	0	0
10	7231821	.	T	A	21	22	43	0	3	46	0	0
10	7231964	.	G	C	21	21	42	0	0	42	0	0
10	7232043	.	T	A	17	18	35	0	0	35	0	0
10	7232058	.	G	T	1	21	22	0	16	38	0	0
10	7232104	.	A	T	19	15	34	0	3	37	0	0
10	7232309	.	C	T	9	6	15	3	0	18	0	0
10	7232416	.	T	C	15	14	29	0	3	32	0	0
10	7232420	.	T	C	15	15	30	0	1	31	0	0
10	7233038	.	T	C	25	14	39	0	1	40	0	0
10	7233218	.	A	G	27	22	49	0	3	52	0	0
10	7233440	.	A	T	32	29	61	0	0	61	0	0
10	7233457	.	C	G	33	26	59	0	2	61	0	0
10	7233518	.	T	C	23	20	43	0	2	45	0	0
10	7233854	.	A	T	16	15	31	0	1	32	0	0
10	7233939	.	C	T	7	5	12	0	0	12	0	0
10	7259591	.	C	T	1	2	3	0	0	3	0	0
10	7284182	.	T	A	6	7	13	0	0	14	1	0
10	7284403	.	C	T	5	4	9	0	0	9	0	0
10	7284520	.	A	G	12	9	21	0	0	21	0	0
10	7284556	.	T	A	9	8	17	1	2	20	0	0
10	7284629	.	T	C	4	10	14	0	0	14	0	0
10	7311979	.	G	A	8	8	16	2	1	19	0	0
10	7311997	.	T	G	9	4	13	2	0	15	0	0
10	7312057	.	A	G	8	7	15	0	1	16	0	0
10	7347192	.	C	A	0	2	2	0	3	5	0	0
10	7483649	.	G	C	4	0	4	0	5	9	0	0
10	7483671	.	A	G	5	4	9	0	1	10	0	0
10	7493909	.	C	T	3	2	5	0	0	5	0	0
10	7494356	.	A	T	3	4	7	0	1	8	0	0
10	7500025	.	A	G	6	4	10	0	0	10	0	0
10	7500033	.	A	G	4	4	8	0	0	8	0	0
10	7500099	.	G	A	1	3	4	0	0	4	0	0
10	7500101	.	T	A	2	3	5	0	0	5	0	0
10	7508077	.	T	C	1	2	3	0	0	3	0	0
10	7512278	.	C	G	0	2	2	0	1	3	0	0
10	7512359	.	G	C	3	2	5	0	1	6	0	0
10	7519459	.	G	T	3	2	5	0	0	5	0	0
10	7531128	.	G	A	1	2	3	0	0	3	0	0
10	7564294	.	C	T	9	14	23	0	3	26	0	0
10	7593246	.	A	T	9	17	26	0	0	26	0	0
10	7593349	.	C	A	20	18	38	0	1	39	0	0
10	7617113	.	A	T	24	39	63	0	1	64	0	0
10	7617126	.	T	C	28	34	62	0	0	62	0	0
10	7617242	.	G	A	33	25	58	0	1	59	0	0
10	7617327	.	A	C	20	24	44	1	7	52	0	0
10	7617350	.	A	T	21	28	49	0	11	60	0	0
10	7617636	.	A	G	22	0	22	0	21	43	0	0
10	7624140	.	T	C	1	0	1	0	3	4	0	0
10	7629453	.	T	C	3	3	6	0	0	6	0	0
10	7640501	.	C	T	19	25	44	0	2	46	0	0
10	7640676	.	G	A	17	15	32	0	1	33	0	0
10	7653581	.	C	G	0	3	3	0	2	5	0	0
10	7653663	.	C	T	0	2	2	0	1	3	0	0
10	7653750	.	T	C	3	0	3	0	5	8	0	0
10	7659575	.	C	A	0	4	4	0	3	7	0	0
10	7671301	.	C	A	7	2	9	0	0	9	0	0
10	7671368	.	T	C	5	6	11	0	0	11	0	0
10	7671425	.	G	A	7	6	13	0	3	16	0	0
10	7672832	.	A	C	7	8	15	0	0	15	0	0
10	7672853	.	G	A	10	10	20	0	1	21	0	0
10	7673774	.	G	A	5	2	7	0	0	7	0	0
10	7673819	.	C	G	4	6	10	0	0	10	0	0
10	7673849	.	A	G	3	5	8	0	0	8	0	0
10	7674079	.	T	G	9	5	14	0	0	14	0	0
10	7674136	.	C	T	1	1	2	0	2	4	0	0
10	7674429	.	C	T	3	3	6	0	0	6	0	0
10	7674471	.	A	G	5	4	9	0	0	9	0	0
10	7674506	.	A	G	5	10	15	0	0	15	0	0
10	7678121	.	T	C	14	17	31	0	0	31	0	0
10	7678154	.	C	T	1	13	14	0	7	21	0	0
10	7678525	.	C	T	1	8	9	0	14	23	0	0
10	7696900	.	G	A	8	5	13	1	1	15	0	0
10	7700564	.	T	G	7	6	13	0	0	13	0	0
10	7700615	.	A	G	6	14	20	0	1	21	0	0
10	7700676	.	G	A	9	15	24	1	1	26	0	0
10	7701852	.	A	C	8	0	8	0	11	19	0	0
10	7704413	.	A	G	3	5	8	0	1	9	0	0
10	7704436	.	G	A	0	3	3	0	4	7	0	0
10	7704484	.	C	A	7	5	12	0	0	12	0	0
10	7704490	.	G	A	6	4	10	0	0	10	0	0
10	7704548	.	C	T	6	3	9	0	0	9	0	0
10	7709761	.	T	C	15	11	26	0	1	27	0	0
10	7709975	.	A	G	10	7	17	0	0	17	0	0
10	7709978	.	T	C	8	7	15	0	2	17	0	0
10	7712180	.	T	A	7	11	18	0	0	18	0	0
10	7712206	.	G	A	11	10	21	0	0	21	0	0
10	7712228	.	C	T	12	9	21	0	0	21	0	0
10	7713924	.	A	G	6	0	6	0	10	16	0	0
10	7721459	.	A	G	12	12	24	0	1	25	0	0
10	7721746	.	G	A	5	13	18	0	1	19	0	0
10	7722595	.	A	G	5	6	11	0	2	13	0	0
10	7722752	.	G	C	0	1	1	0	2	3	0	0
10	7722797	.	T	A	1	2	3	0	0	3	0	0
10	7722936	.	C	T	2	4	6	0	0	6	0	0
10	7723004	.	T	C	6	3	9	0	1	10	0	0
10	7723157	.	A	G	7	11	18	0	1	19	0	0
10	7723218	.	T	C	2	11	13	0	1	14	0	0
10	7723275	.	C	A	5	15	20	0	0	20	0	0
10	7723337	.	C	G	6	8	14	0	0	14	0	0
10	7727393	.	T	C	3	3	6	0	0	6	0	0
10	7727505	.	T	A	4	2	6	0	0	6	0	0
10	7727598	.	A	T	2	7	9	0	0	9	0	0
10	7727704	.	T	A	8	9	17	0	0	17	0	0
10	7734401	.	G	A	5	7	12	0	0	12	0	0
10	7734465	.	C	T	9	8	17	0	0	17	0	0
10	7770111	.	G	A	1	2	3	0	1	4	0	0
10	7771634	.	T	A	4	3	7	0	0	7	0	0
10	7771769	.	C	T	4	4	8	0	0	8	0	0
10	7771778	.	G	A	4	3	7	0	1	8	0	0
10	7772012	.	T	G	5	4	9	0	0	9	0	0
10	7772272	.	C	T	5	4	9	0	0	9	0	0
10	7772394	.	C	T	0	3	3	0	2	5	0	0
10	7810461	.	A	T	20	21	41	0	0	41	0	0
10	7810565	.	G	A	17	24	41	0	1	42	0	0
10	7811062	.	T	A	7	6	13	0	0	13	0	0
10	7811075	.	T	C	4	5	9	0	0	9	0	0
10	7811935	.	A	G	25	19	44	0	0	44	0	0
10	7815118	.	G	A	16	17	33	0	0	33	0	0
10	7815187	.	G	A	25	10	35	0	2	37	0	0
10	7831879	.	C	T	17	13	30	0	3	33	0	0
10	7843465	.	A	G	7	4	11	0	0	11	0	0
10	7843594	.	G	T	4	5	9	0	1	10	0	0
10	7850682	.	T	G	6	2	8	0	0	8	0	0
10	7901065	.	T	G	2	3	5	0	0	5	0	0
10	7901202	.	T	A	6	2	8	0	0	8	0	0
10	7902045	.	T	G	6	6	12	0	1	13	0	0
10	7909269	.	C	A	8	6	14	0	0	14	0	0
10	7909665	.	T	A	1	2	3	0	0	3	0	0
10	7916836	.	A	C	7	8	15	0	0	15	0	0
10	7916930	.	C	A	8	9	17	0	1	18	0	0
10	7917036	.	A	T	10	13	23	0	0	23	0	0
10	7917114	.	T	C	10	23	33	0	0	33	0	0
10	7917411	.	C	A	0	12	12	0	8	20	0	0
10	7917483	.	C	A	3	9	12	0	0	12	0	0
10	7917551	.	A	G	12	13	25	1	2	28	0	0
10	7917592	.	T	C	9	17	26	0	1	27	0	0
10	7917686	.	T	C	15	15	30	0	6	36	0	0
10	7917690	.	A	T	16	18	34	0	3	37	0	0
10	7920910	.	T	G	19	17	36	0	0	36	0	0
10	7920913	.	C	T	21	14	35	0	2	37	0	0
10	7922210	.	G	T	14	14	28	0	1	29	0	0
10	7922294	.	C	A	7	18	25	0	0	25	0	0
10	7926899	.	A	G	22	17	39	0	1	40	0	0
10	7929647	.	T	C	13	0	13	0	6	19	0	0
10	7936283	.	T	G	11	18	29	0	1	30	0	0
10	7938629	.	C	T	13	18	31	0	3	34	0	0
10	7938659	.	A	G	11	15	26	0	2	28	0	0
10	7938683	.	T	C	10	18	28	0	1	29	0	0
10	7959655	.	T	A	10	10	20	0	1	21	0	0
10	7968160	.	G	T	7	5	12	0	0	12	0	0
10	7968274	.	G	T	9	6	15	0	1	16	0	0
10	7984677	.	A	T	29	23	52	0	2	54	0	0
10	7986217	.	T	C	16	22	38	0	3	41	0	0
10	7986307	.	C	T	1	17	18	0	37	55	0	0
10	7986432	.	C	T	3	21	24	0	29	53	0	0
10	7989162	.	T	G	4	7	11	0	0	11	0	0
10	7989237	.	G	A	10	4	14	0	0	14	0	0
10	7989287	.	G	A	9	11	20	0	0	20	0	0
10	7989348	.	C	T	9	9	18	0	0	18	0	0
10	7989576	.	C	T	8	10	18	0	1	19	0	0
10	7992197	.	T	C	10	14	24	0	0	24	0	0
10	7996021	.	G	A	8	10	18	0	0	18	0	0
10	8001365	.	A	G	8	8	16	0	0	16	0	0
10	8005785	.	T	A	10	8	18	0	0	18	0	0
10	8005845	.	C	A	1	9	10	0	9	19	0	0
10	8009996	.	A	C	6	7	13	0	1	14	0	0
10	8010064	.	A	G	4	4	8	0	0	8	0	0
10	8010252	.	T	C	3	5	8	0	0	8	0	0
10	8010272	.	T	A	4	6	10	0	1	11	0	0
10	8033234	.	T	C	4	6	10	0	0	10	0	0
10	8033259	.	C	T	7	5	12	0	0	12	0	0
10	8033328	.	A	G	7	5	12	0	0	12	0	0
10	8033332	.	T	A	8	5	13	0	0	13	0	0
10	8036409	.	T	C	1	2	3	0	0	3	0	0
10	8036428	.	G	T	0	2	2	0	1	3	0	0
10	8036884	.	C	T	0	5	5	0	3	8	0	0
10	8036913	.	G	A	6	3	9	1	0	10	0	0
10	8037752	.	T	C	3	5	8	0	0	8	0	0
10	8037797	.	T	C	3	4	7	0	0	7	0	0
10	8040536	.	T	C	3	4	7	0	0	7	0	0
10	8091212	.	G	A	17	27	44	0	2	46	0	0
10	8097929	.	C	G	17	9	26	0	2	28	0	0
10	8160813	.	T	G	7	5	12	0	1	13	0	0
10	8160888	.	G	A	4	4	8	0	2	10	0	0
10	8160891	.	T	C	7	0	7	0	4	11	0	0
10	8161027	.	A	G	4	3	7	0	0	7	0	0
10	8161028	.	G	A	4	3	7	0	0	7	0	0
10	8170269	.	A	G	2	5	7	0	0	7	0	0
10	8170468	.	C	A	0	3	3	0	2	5	0	0
10	8175123	.	T	C	2	3	5	0	0	5	0	0
10	8175164	.	C	A	4	3	7	0	0	7	0	0
10	8177559	.	C	T	1	4	5	0	9	14	0	0
10	8177748	.	A	G	3	6	9	0	0	9	0	0
10	8188485	.	C	T	1	4	5	0	5	10	0	0
10	8188503	.	G	A	5	3	8	0	0	8	0	0
10	8190589	.	T	C	4	2	6	0	0	6	0	0
10	8194893	.	G	A	4	6	10	0	0	10	0	0
10	8202517	.	C	T	6	5	11	0	1	12	0	0
10	8202523	.	C	T	7	5	12	0	1	13	0	0
10	8208610	.	G	A	5	2	7	0	0	7	0	0
10	8228235	.	T	C	3	2	5	0	0	6	1	0
10	8233255	.	C	T	2	2	4	0	1	5	0	0
10	8235946	.	A	G	6	0	6	0	3	9	0	0
10	8236048	.	T	C	1	3	4	0	0	4	0	0
10	8236775	.	T	C	3	6	9	0	1	10	0	0
10	8265917	.	A	T	5	6	11	0	0	11	0	0
10	8265922	.	T	C	4	4	8	0	0	8	0	0
10	8265968	.	C	T	2	4	6	0	0	6	0	0
10	8265970	.	G	A	1	4	5	0	0	5	0	0
10	8266248	.	C	T	1	16	17	0	20	37	0	0
10	8266383	.	A	G	9	22	31	0	0	31	0	0
10	8269224	.	G	A	16	26	42	0	1	43	0	0
10	8269377	.	G	A	12	16	28	0	1	29	0	0
10	8269439	.	C	T	0	2	2	0	4	6	0	0
10	8269459	.	T	C	3	4	7	0	1	8	0	0
10	8278160	.	T	C	13	20	33	0	1	34	0	0
10	8278214	.	A	G	8	14	22	0	2	24	0	0
10	8282705	.	T	A	7	6	13	0	2	15	0	0
10	8295026	.	C	T	0	7	7	0	11	18	0	0
10	8295196	.	T	G	12	15	27	0	0	27	0	0
10	8295295	.	C	A	0	5	5	0	9	14	0	0
10	8299143	.	G	C	1	2	3	0	0	3	0	0
10	8335312	.	C	T	3	2	5	0	2	7	0	0
10	8335315	.	T	C	3	4	7	0	0	7	0	0
10	8335402	.	A	G	4	4	8	0	1	9	0	0
10	8357833	.	G	A	4	3	7	0	0	7	0	0
10	8358022	.	C	T	1	2	3	0	0	3	0	0
10	8358373	.	A	T	5	3	8	0	0	8	0	0
10	8412603	.	G	T	2	2	4	0	0	4	0	0
10	8418768	.	C	A	4	2	6	0	0	6	0	0
10	8434574	.	G	A	2	2	4	0	0	4	0	0
10	8450742	.	G	T	0	2	2	0	5	7	0	0
10	8466538	.	T	C	10	5	15	0	1	16	0	0
10	8466562	.	G	A	4	5	9	0	2	11	0	0
10	8537986	.	T	C	2	3	5	0	0	5	0	0
10	8575927	.	A	C	6	3	9	0	0	9	0	0
10	8575951	.	T	C	4	3	7	0	0	7	0	0
10	8629373	.	T	C	10	10	20	0	1	21	0	0
10	8629496	.	T	C	6	2	8	0	2	11	1	0
10	8630102	.	C	T	19	11	30	0	0	30	0	0
10	8630428	.	A	G	15	9	24	0	1	25	0	0
10	8630527	.	G	A	12	9	21	0	0	21	0	0
10	8630585	.	A	G	8	0	8	0	9	17	0	0
10	8630631	.	T	C	9	9	18	0	1	19	0	0
10	8630690	.	G	A	12	7	19	0	2	21	0	0
10	8630702	.	T	C	8	8	16	0	1	17	0	0
10	8630808	.	G	A	3	6	9	0	2	11	0	0
10	8631103	.	G	A	0	6	6	0	3	9	0	0
10	8631135	.	A	G	8	6	14	0	0	14	0	0
10	8631201	.	A	G	7	7	14	0	0	14	0	0
10	8670121	.	A	C	17	9	26	0	2	28	0	0
10	8670139	.	G	A	18	8	26	0	0	26	0	0
10	8672510	.	A	G	13	24	37	0	1	38	0	0
10	8672519	.	T	C	12	24	36	0	1	37	0	0
10	8672672	.	C	G	12	18	30	0	0	30	0	0
10	8672707	.	A	T	15	22	37	0	0	37	0	0
10	8684939	.	T	G	1	2	3	0	0	3	0	0
10	8684951	.	T	C	1	2	3	0	0	3	0	0
10	8767686	.	T	C	1	3	4	0	0	4	0	0
10	8767689	.	C	T	1	3	4	0	0	4	0	0
10	8819572	.	C	A	6	2	8	0	0	8	0	0
10	8819632	.	A	G	3	2	5	0	0	5	0	0
10	8825313	.	A	G	2	4	6	0	0	6	0	0
10	8829791	.	T	C	3	3	6	0	0	6	0	0
10	8835208	.	G	A	0	7	7	0	4	11	0	0
10	8835269	.	C	T	4	1	5	0	1	6	0	0
10	8835272	.	A	T	4	2	6	0	0	6	0	0
10	8840343	.	A	G	5	4	9	0	0	9	0	0
10	8950108	.	A	G	4	5	9	0	1	10	0	0
10	8952601	.	A	G	4	2	6	0	1	7	0	0
10	8969130	.	T	C	1	2	3	0	0	3	0	0
10	8970757	.	T	C	3	5	8	0	0	8	0	0
10	8970802	.	T	C	4	5	9	0	0	9	0	0
10	8976450	.	T	C	1	3	4	0	0	4	0	0
10	9006634	.	T	C	11	6	17	0	1	18	0	0
10	9097555	.	T	C	1	1	2	0	0	2	0	0
10	9159424	.	T	A	5	6	11	0	0	11	0	0
10	9169479	.	C	T	4	8	12	0	0	12	0	0
10	9169613	.	C	T	6	8	14	0	1	15	0	0
10	9177363	.	T	C	7	11	18	0	1	19	0	0
10	9181508	.	T	A	4	6	10	0	1	11	0	0
10	9184326	.	T	A	7	5	12	0	0	12	0	0
10	9184327	.	A	C	6	6	12	0	0	12	0	0
10	9184533	.	C	T	7	8	15	0	1	16	0	0
10	9205502	.	G	T	2	4	6	0	0	6	0	0
10	9205505	.	A	T	2	4	6	0	0	6	0	0
10	9219645	.	G	A	0	5	5	0	1	6	0	0
10	9222601	.	A	T	4	2	6	0	0	6	0	0
10	9234007	.	G	A	0	2	2	0	4	6	0	0
10	9234032	.	G	A	4	4	8	0	0	8	0	0
10	9234056	.	T	A	4	3	7	0	0	7	0	0
10	9234371	.	T	C	4	2	6	0	0	6	0	0
10	9234529	.	G	A	2	3	5	0	0	5	0	0
10	9234626	.	T	G	2	5	7	0	0	7	0	0
10	9234742	.	G	A	1	4	5	0	5	10	0	0
10	9235180	.	G	T	0	4	4	0	3	7	0	0
10	9235184	.	G	A	1	4	5	0	2	7	0	0
10	9235217	.	A	T	2	3	5	0	0	5	0	0
10	9268737	.	C	A	1	3	4	0	0	4	0	0
10	9268746	.	A	T	2	2	4	0	0	4	0	0
10	9305219	.	A	G	2	3	5	0	0	5	0	0
10	9305246	.	T	C	3	0	3	0	4	7	0	0
10	9305305	.	C	T	4	4	8	0	0	8	0	0
10	9305433	.	A	G	5	15	20	0	0	20	0	0
10	9305465	.	T	C	6	0	6	0	8	14	0	0
10	9308092	.	G	A	6	7	13	0	1	14	0	0
10	9308133	.	G	A	6	6	12	0	0	12	0	0
10	9334097	.	T	G	4	2	6	0	0	6	0	0
10	9346253	.	T	A	4	4	8	0	0	8	0	0
10	9347928	.	C	G	6	0	6	0	6	12	0	0
10	9361037	.	C	T	6	7	13	0	1	14	0	0
10	9361891	.	G	A	8	4	12	0	0	12	0	0
10	9361924	.	G	C	7	7	14	0	1	15	0	0
10	9370121	.	A	T	9	4	13	0	0	13	0	0
10	9370210	.	T	A	6	7	13	0	2	15	0	0
10	9370755	.	A	G	5	5	10	0	2	12	0	0
10	9388783	.	G	A	4	2	6	0	0	6	0	0
10	9388921	.	A	G	2	4	6	0	1	7	0	0
10	9390746	.	T	C	4	2	6	0	0	6	0	0
10	9390767	.	T	C	6	3	9	0	0	9	0	0
10	9394247	.	A	C	2	4	6	0	0	6	0	0
10	9395012	.	C	T	1	4	5	0	0	5	0	0
10	9595693	.	C	T	8	3	11	0	0	11	0	0
10	9601620	.	T	C	1	3	4	0	0	4	0	0
10	9601670	.	A	C	2	5	7	0	0	7	0	0
10	9601679	.	C	G	2	4	6	0	1	7	0	0
10	9610388	.	A	C	4	7	11	0	0	11	0	0
10	9618271	.	T	G	3	4	7	0	1	8	0	0
10	9618313	.	T	G	3	4	7	0	0	7	0	0
10	9618348	.	A	C	4	4	8	0	0	8	0	0
10	9628988	.	A	G	5	5	10	0	0	10	0	0
10	9629193	.	G	A	0	4	4	0	8	12	0	0
10	9629268	.	G	T	1	5	6	0	4	10	0	0
10	9629301	.	A	G	7	0	7	0	9	16	0	0
10	9629314	.	A	G	7	9	16	0	0	16	0	0
10	9632265	.	G	A	0	9	9	0	12	21	0	0
10	9632336	.	A	G	8	0	8	0	10	18	0	0
10	9642674	.	T	A	5	9	14	0	0	14	0	0
10	9642717	.	T	C	5	4	9	0	0	9	0	0
10	9644669	.	T	C	1	5	6	5	0	11	0	0
10	9701905	.	C	T	12	13	25	0	0	25	0	0
10	9704514	.	A	T	7	13	20	0	1	21	0	0
10	9714771	.	T	C	12	12	24	0	0	24	0	0
10	9714819	.	A	G	13	16	29	0	0	29	0	0
10	9781509	.	G	A	18	20	38	0	1	39	0	0
10	9784087	.	C	T	15	18	33	0	1	35	1	0
10	9800719	.	G	T	20	23	43	1	0	44	0	0
10	9802771	.	T	C	16	16	32	0	1	33	0	0
10	9806731	.	A	G	12	0	12	0	18	30	0	0
10	9807014	.	T	G	15	8	23	0	2	25	0	0
10	9807203	.	G	A	22	15	37	0	0	37	0	0
10	9837024	.	G	T	1	5	6	0	0	6	0	0
10	9837027	.	T	C	2	5	7	0	0	7	0	0
10	9837100	.	T	C	1	3	4	0	0	4	0	0
10	9846240	.	A	G	20	14	34	0	4	38	0	0
10	9846261	.	G	A	17	16	33	0	0	33	0	0
10	9856390	.	T	C	5	0	5	0	14	19	0	0
10	9856416	.	A	G	8	8	16	0	1	17	0	0
10	9895348	.	G	A	11	10	21	0	0	21	0	0
10	9899302	.	G	A	12	7	19	0	0	19	0	0
10	10210583	.	C	T	9	6	15	0	1	16	0	0
10	10254730	.	C	T	7	8	15	0	3	18	0	0
10	10254751	.	A	C	10	6	16	0	1	17	0	0
10	10254787	.	A	G	10	0	10	0	8	18	0	0
10	10254922	.	A	G	4	5	9	0	0	9	0	0
10	10261887	.	G	C	8	18	26	0	0	26	0	0
10	10261893	.	C	A	9	19	28	0	1	29	0	0
10	10262013	.	T	C	9	7	16	0	1	17	0	0
10	10262157	.	A	G	3	5	8	0	0	8	0	0
10	10269930	.	T	C	9	11	20	0	0	20	0	0
10	10317392	.	A	T	5	8	13	0	0	13	0	0
10	10325451	.	T	C	8	4	12	0	1	13	0	0
10	10325493	.	G	A	0	10	10	0	3	13	0	0
10	10380074	.	G	A	2	5	7	0	0	7	0	0
10	10492990	.	T	C	2	6	8	0	0	8	0	0
10	10564376	.	A	G	3	2	5	0	0	5	0	0
10	10564587	.	G	T	5	3	8	0	0	8	0	0
10	10636799	.	C	A	8	5	13	0	1	14	0	0
10	10636896	.	G	A	0	12	12	0	10	22	0	0
10	10636946	.	A	G	15	8	23	0	2	25	0	0
10	10739153	.	C	A	2	4	6	0	0	6	0	0
10	10758410	.	G	A	8	5	13	0	0	13	0	0
10	10764601	.	T	C	5	5	10	0	0	10	0	0
10	10775374	.	A	T	10	5	15	0	0	15	0	0
10	10780483	.	T	C	18	10	28	0	1	29	0	0
10	10782513	.	G	A	12	17	29	0	1	30	0	0
10	10861011	.	A	G	3	4	7	0	0	7	0	0
10	10861504	.	G	A	3	3	6	0	0	6	0	0
10	10862232	.	C	G	4	3	7	0	0	7	0	0
10	10880167	.	A	T	1	2	3	0	0	3	0	0
10	10880188	.	T	C	1	2	3	0	0	3	0	0
10	10880659	.	C	T	7	3	10	0	0	10	0	0
10	10880791	.	T	A	2	5	7	0	0	7	0	0
10	10930143	.	G	A	2	8	10	0	1	11	0	0
10	10930188	.	G	A	5	5	10	0	0	10	0	0
10	10935396	.	C	T	2	3	5	0	0	5	0	0
10	10935661	.	G	A	3	2	5	0	1	6	0	0
10	10935974	.	C	T	0	2	2	0	2	4	0	0
10	10937841	.	G	A	5	3	8	0	0	8	0	0
10	10937960	.	T	A	3	2	5	0	1	6	0	0
10	10938668	.	C	A	6	4	10	0	0	10	0	0
10	10938725	.	G	T	5	2	7	0	0	7	0	0
10	10946557	.	A	G	1	3	4	0	0	4	0	0
10	10951029	.	G	A	3	2	5	0	0	5	0	0
10	10960763	.	A	G	2	2	4	0	0	4	0	0
10	10987263	.	T	C	7	5	12	0	0	12	0	0
10	10997286	.	A	G	3	6	9	0	0	9	0	0
10	10997404	.	A	G	1	3	4	0	0	4	0	0
10	10997585	.	C	T	3	3	6	0	0	6	0	0
10	10997618	.	C	T	3	5	8	0	0	8	0	0
10	10997671	.	T	G	2	0	2	0	4	6	0	0
10	10997711	.	T	C	2	3	5	0	0	5	0	0
10	11001720	.	T	C	5	4	9	0	0	9	0	0
10	11001867	.	A	G	3	8	11	0	0	11	0	0
10	11001883	.	T	A	2	7	9	0	0	9	0	0
10	11001967	.	T	G	5	8	13	0	0	13	0	0
10	11001968	.	A	G	5	8	13	0	0	13	0	0
10	11002005	.	T	A	5	7	12	1	1	14	0	0
10	11003904	.	G	T	5	9	14	0	2	16	0	0
10	11003911	.	G	A	5	11	16	0	0	16	0	0
10	11146445	.	A	G	6	6	12	0	0	12	0	0
10	11146585	.	A	T	10	7	17	0	0	18	1	0
10	11166798	.	G	A	4	6	10	0	0	10	0	0
10	11174413	.	G	A	5	3	8	0	1	9	0	0
10	11178600	.	C	A	7	7	14	0	0	14	0	0
10	11183242	.	A	G	4	11	15	0	0	15	0	0
10	11265395	.	G	C	11	10	21	0	0	21	0	0
10	11267530	.	C	A	6	6	12	0	0	12	0	0
10	11282194	.	A	G	3	5	8	0	0	8	0	0
10	11282362	.	A	G	2	2	4	1	0	5	0	0
10	11282373	.	C	T	3	2	5	0	0	5	0	0
10	11286830	.	C	T	12	9	21	0	1	22	0	0
10	11287343	.	A	G	8	0	8	0	7	15	0	0
10	11298651	.	G	A	4	3	7	0	0	7	0	0
10	11298652	.	A	C	4	3	7	0	0	7	0	0
10	11298852	.	G	A	6	7	13	0	1	14	0	0
10	11298864	.	A	G	5	9	14	0	0	14	0	0
10	11298955	.	T	C	5	2	7	0	0	7	0	0
10	11298975	.	C	T	6	2	8	0	0	8	0	0
10	11309859	.	C	G	4	0	4	0	4	8	0	0
10	11310041	.	G	A	3	7	10	0	0	10	0	0
10	11310500	.	G	A	5	4	9	0	0	9	0	0
10	11310501	.	C	A	5	4	9	0	0	9	0	0
10	11310618	.	A	C	8	5	13	0	1	14	0	0
10	11310648	.	G	A	4	7	11	0	0	11	0	0
10	11310682	.	G	A	2	3	5	0	0	5	0	0
10	11311700	.	T	C	2	2	4	0	1	5	0	0
10	11312270	.	T	G	1	3	4	0	0	4	0	0
10	11320087	.	A	C	1	3	4	0	0	4	0	0
10	11322985	.	T	C	11	4	15	0	0	15	0	0
10	11323032	.	G	A	11	7	18	0	0	18	0	0
10	11324988	.	A	G	1	2	3	0	0	3	0	0
10	11327444	.	G	T	4	2	6	0	1	7	0	0
10	11327449	.	A	T	4	2	6	0	1	7	0	0
10	11327604	.	T	C	10	7	17	0	1	18	0	0
10	11327657	.	C	T	5	6	11	0	1	12	0	0
10	11327674	.	G	A	8	7	15	0	0	15	0	0
10	11331922	.	C	T	1	5	6	0	6	12	0	0
10	11332206	.	A	G	6	5	11	0	0	11	0	0
10	11333030	.	A	C	1	3	4	0	0	4	0	0
10	11334397	.	T	C	3	2	5	0	4	9	0	0
10	11334415	.	C	A	0	4	4	0	2	6	0	0
10	11334547	.	A	G	1	2	3	0	0	3	0	0
10	11339235	.	G	A	11	10	21	0	0	21	0	0
10	11339319	.	C	T	0	7	7	0	13	20	0	0
10	11347906	.	G	T	3	7	10	0	1	11	0	0
10	11347909	.	A	G	4	7	11	0	0	11	0	0
10	11347961	.	G	T	5	10	15	0	0	15	0	0
10	11348147	.	C	T	0	6	6	0	4	10	0	0
10	11362275	.	C	T	22	19	41	0	0	41	0	0
10	11398168	.	T	G	9	0	9	0	5	14	0	0
10	11399574	.	C	T	6	6	12	0	0	12	0	0
10	11403954	.	T	C	5	5	10	0	0	10	0	0
10	11501181	.	C	A	1	4	5	0	0	5	0	0
10	11773751	.	T	C	9	6	15	0	0	15	0	0
10	11779259	.	G	A	6	5	11	0	0	11	0	0
10	11790947	.	T	C	9	8	17	0	1	18	0	0
10	11805601	.	T	C	9	8	17	0	0	17	0	0
10	11809444	.	A	G	11	6	17	0	0	17	0	0
10	11838927	.	C	T	1	16	17	0	9	26	0	0
10	12517216	.	T	C	3	5	8	0	0	8	0	0
10	12517338	.	C	T	3	6	9	0	1	10	0	0
10	12609109	.	C	T	2	4	6	0	0	6	0	0
10	12616330	.	T	G	4	3	7	0	0	7	0	0
10	12616396	.	A	G	4	3	7	0	0	7	0	0
10	12693314	.	A	G	2	0	2	0	4	6	0	0
10	12720969	.	C	T	4	4	8	0	0	8	0	0
10	13000879	.	A	G	4	3	7	0	0	7	0	0
10	13000889	.	A	T	3	2	5	0	0	5	0	0
10	13037686	.	A	G	2	0	2	0	4	6	0	0
10	13038022	.	T	C	6	5	11	0	0	11	0	0
10	13038025	.	A	C	6	5	11	0	0	11	0	0
10	13063542	.	G	T	1	4	5	0	0	5	0	0
10	13063611	.	A	T	3	12	15	0	0	15	0	0
10	13063921	.	C	T	2	6	8	0	1	9	0	0
10	13238028	.	A	G	8	9	17	0	3	20	0	0
10	13238055	.	G	T	7	13	20	0	1	21	0	0
10	13283594	.	C	T	11	13	24	0	1	25	0	0
10	13283729	.	C	T	9	9	18	0	0	18	0	0
10	13283741	.	G	A	1	9	10	0	6	17	1	0
10	13283792	.	T	C	5	7	12	0	0	12	0	0
10	13283891	.	G	A	1	10	11	0	9	20	0	0
10	13286430	.	C	T	10	12	22	0	2	24	0	0
10	13286472	.	T	C	8	12	20	0	2	22	0	0
10	13286677	.	A	G	3	3	6	0	0	6	0	0
10	13286951	.	C	G	6	2	8	0	0	8	0	0
10	13287031	.	A	C	9	3	12	0	0	12	0	0
10	13287133	.	C	T	2	2	4	0	0	4	0	0
10	13460494	.	A	C	2	8	10	0	1	11	0	0
10	13460671	.	G	A	14	7	21	0	0	21	0	0
10	13460745	.	C	A	2	14	16	0	17	33	0	0
10	13460940	.	A	T	12	19	31	0	1	32	0	0
10	13461080	.	T	C	22	0	22	0	16	38	0	0
10	13461150	.	G	A	13	19	32	0	1	33	0	0
10	13476010	.	A	G	18	18	36	0	1	37	0	0
10	13529270	.	T	C	18	8	26	0	0	26	0	0
10	13536790	.	T	C	8	0	8	0	7	15	0	0
10	14421522	.	G	A	1	3	4	0	0	4	0	0
10	14470434	.	C	T	2	3	5	0	0	5	0	0
10	14488324	.	A	C	1	0	1	0	3	4	0	0
10	14491139	.	C	T	11	11	22	0	0	22	0	0
10	14493798	.	T	C	6	12	18	0	0	18	0	0
10	14493819	.	A	T	7	9	16	0	0	16	0	0
10	14493878	.	G	T	1	11	12	0	8	20	0	0
10	14493967	.	G	C	1	13	14	0	12	26	0	0
10	14494083	.	A	G	2	6	8	0	1	9	0	0
10	14530181	.	G	A	3	7	10	0	0	10	0	0
10	14533337	.	G	A	6	5	11	0	0	11	0	0
10	14533352	.	A	G	4	5	9	0	2	11	0	0
10	14542886	.	A	G	9	5	14	0	3	17	0	0
10	14542962	.	G	A	3	7	10	0	0	10	0	0
10	14543044	.	A	T	16	9	25	0	3	28	0	0
10	14543256	.	A	C	12	9	21	0	1	22	0	0
10	14543259	.	G	T	12	8	20	0	0	20	0	0
10	14543307	.	C	T	18	10	28	0	0	28	0	0
10	14545572	.	A	G	14	15	29	0	0	29	0	0
10	14556379	.	G	A	4	5	9	0	1	10	0	0
10	14556634	.	T	G	2	2	4	0	0	4	0	0
10	14556691	.	A	G	1	3	4	0	1	5	0	0
10	14871409	.	T	A	8	15	23	0	0	23	0	0
10	14871412	.	T	A	7	13	20	0	2	22	0	0
10	14871768	.	A	G	11	19	30	1	0	31	0	0
10	14871801	.	A	C	13	16	29	0	3	32	0	0
10	14872258	.	T	G	3	4	7	0	1	8	0	0
10	14872703	.	G	A	14	14	28	0	0	28	0	0
10	14920777	.	G	A	15	5	20	0	1	21	0	0
10	14921086	.	A	C	13	0	13	0	15	28	0	0
10	14929560	.	G	A	13	18	31	0	3	34	0	0
10	15066019	.	T	C	1	3	4	0	0	4	0	0
10	15436724	.	T	C	1	2	3	0	0	3	0	0
10	16061731	.	T	C	7	0	7	1	4	12	0	0
10	16307210	.	C	T	7	4	11	1	1	13	0	0
10	16475967	.	T	C	4	2	6	0	1	7	0	0
10	16476488	.	T	C	2	2	4	0	0	4	0	0
10	16477575	.	T	C	2	2	4	0	0	4	0	0
10	17174513	.	A	G	6	2	8	0	0	8	0	0
10	17924133	.	A	T	1	2	3	0	0	3	0	0
10	17924546	.	A	G	19	16	35	0	3	38	0	0
10	17924547	.	A	G	30	8	38	0	0	38	0	0
10	17924606	.	A	G	16	7	23	0	1	24	0	0
10	17945513	.	A	G	31	9	40	2	1	43	0	0
10	18463152	.	C	T	5	3	8	0	0	8	0	0
10	18467846	.	A	C	3	2	5	0	0	5	0	0
10	18887819	.	A	G	11	9	20	0	2	22	0	0
10	18906617	.	C	A	4	11	15	0	11	26	0	0
10	18906618	.	A	G	9	11	20	0	6	26	0	0
10	18911166	.	A	G	10	7	17	0	0	17	0	0
10	18927910	.	C	T	13	11	24	0	0	24	0	0
10	18930403	.	T	C	12	16	28	0	1	29	0	0
10	18934147	.	T	C	6	4	10	0	0	10	0	0
10	18934215	.	C	A	6	12	18	0	1	19	0	0
10	18934291	.	T	C	9	16	25	0	0	25	0	0
10	18934323	.	A	C	7	9	16	0	1	17	0	0
10	18934499	.	C	T	6	6	12	0	1	13	0	0
10	18934530	.	A	G	10	6	16	0	0	16	0	0
10	18934590	.	A	C	13	10	23	0	0	23	0	0
10	18934634	.	G	T	11	16	27	0	0	27	0	0
10	18934683	.	T	C	18	17	35	0	1	36	0	0
10	18934821	.	A	C	9	12	21	0	1	22	0	0
10	18935112	.	A	G	5	1	6	0	1	7	0	0
10	18935118	.	G	T	8	3	11	0	0	11	0	0
10	18935246	.	T	C	23	12	35	0	0	35	0	0
10	18935316	.	C	T	16	15	31	0	1	32	0	0
10	18935413	.	C	T	8	18	26	0	0	26	0	0
10	18935430	.	A	T	9	13	22	0	2	24	0	0
10	18935874	.	T	A	3	3	6	0	1	7	0	0
10	18970673	.	C	T	20	7	27	0	1	28	0	0
10	18973079	.	C	T	9	11	20	0	1	21	0	0
10	18973124	.	A	G	15	0	15	0	10	25	0	0
10	18977233	.	G	A	1	10	11	0	19	30	0	0
10	18992413	.	T	C	41	18	59	0	0	59	0	0
10	18999895	.	C	T	2	2	4	0	0	4	0	0
10	18999972	.	A	G	2	2	4	0	0	4	0	0
10	19005905	.	A	G	2	2	4	0	0	4	0	0
10	19005965	.	A	C	1	4	5	0	0	5	0	0
10	19005983	.	A	G	1	2	3	0	0	3	0	0
10	19006076	.	G	T	1	1	2	0	1	3	0	0
10	19017316	.	C	T	5	6	11	0	0	11	0	0
10	19020475	.	A	G	4	5	9	0	0	9	0	0
10	19020956	.	A	C	1	2	3	0	0	3	0	0
10	19021032	.	C	A	6	3	9	0	1	10	0	0
10	19021075	.	G	A	5	4	9	0	2	11	0	0
10	19021192	.	A	G	3	3	6	1	0	7	0	0
10	19090481	.	T	C	1	3	4	0	0	4	0	0
10	19339859	.	C	G	10	6	16	0	1	17	0	0
10	19554673	.	A	T	16	27	43	0	0	43	0	0
10	19562120	.	C	T	32	31	63	0	0	63	0	0
10	19564401	.	G	A	22	33	55	0	2	57	0	0
10	19565771	.	T	C	23	24	47	1	0	48	0	0
10	19565988	.	G	C	30	24	54	0	1	55	0	0
10	19566400	.	T	A	8	13	21	0	2	23	0	0
10	19566445	.	T	C	8	5	13	0	0	13	0	0
10	19798468	.	T	C	4	12	16	1	1	18	0	0
10	20075544	.	A	G	1	0	1	0	6	7	0	0
10	20080671	.	C	T	5	7	12	0	0	12	0	0
10	20082011	.	T	G	3	6	9	0	0	9	0	0
10	20082038	.	C	T	2	8	10	0	0	10	0	0
10	20083053	.	C	T	4	11	15	1	0	16	0	0
10	20083140	.	A	G	5	7	12	0	2	14	0	0
10	20085200	.	A	C	2	2	4	0	0	4	0	0
10	20087260	.	A	G	5	7	12	0	0	12	0	0
10	20087263	.	C	T	5	7	12	0	0	12	0	0
10	20087388	.	T	C	6	5	11	0	0	11	0	0
10	20093329	.	G	A	0	8	8	0	6	14	0	0
10	20099528	.	T	A	4	0	4	0	15	19	0	0
10	20100205	.	C	T	8	12	20	0	0	20	0	0
10	20100234	.	C	T	10	8	18	0	0	18	0	0
10	20100269	.	A	C	11	14	25	1	0	26	0	0
10	20103242	.	G	T	3	2	5	0	0	5	0	0
10	20103359	.	C	T	5	4	9	1	0	10	0	0
10	20103392	.	A	G	3	4	7	0	0	7	0	0
10	20103639	.	A	G	2	6	8	0	0	8	0	0
10	20105210	.	T	C	17	15	32	0	0	32	0	0
10	20128245	.	A	C	6	24	30	0	3	33	0	0
10	20128640	.	G	A	1	11	12	0	19	31	0	0
10	20128643	.	T	A	19	13	32	0	2	34	0	0
10	20131937	.	G	A	8	23	31	0	0	31	0	0
10	20132529	.	T	A	1	2	3	0	0	3	0	0
10	20136107	.	T	C	16	18	34	0	3	37	0	0
10	20137862	.	A	G	13	12	25	0	0	25	0	0
10	20140951	.	T	C	1	3	4	0	0	4	0	0
10	20141059	.	A	G	4	0	4	0	4	8	0	0
10	20143822	.	T	A	1	6	7	0	0	7	0	0
10	20143850	.	T	A	2	8	10	1	2	13	0	0
10	20146535	.	C	T	24	14	38	0	2	40	0	0
10	20147452	.	A	G	9	0	9	0	8	17	0	0
10	20158976	.	T	A	2	3	5	0	0	5	0	0
10	20215064	.	G	T	8	14	22	0	2	24	0	0
10	20218342	.	C	G	19	13	32	0	2	34	0	0
10	20233964	.	A	G	24	1	25	0	21	46	0	0
10	20234074	.	C	T	22	22	44	0	4	48	0	0
10	20256640	.	C	G	2	3	5	0	0	6	1	0
10	20276868	.	T	G	1	2	3	0	0	3	0	0
10	20276898	.	A	G	1	3	4	0	0	4	0	0
10	20276904	.	G	A	1	3	4	0	1	5	0	0
10	20287251	.	C	A	0	5	5	0	5	10	0	0
10	20338998	.	G	C	5	3	8	0	1	9	0	0
10	20351579	.	G	T	3	3	6	0	0	6	0	0
10	20351846	.	T	A	3	3	6	0	0	6	0	0
10	20351930	.	T	C	2	4	6	0	0	6	0	0
10	20351975	.	C	T	2	6	8	0	0	8	0	0
10	20354622	.	A	T	7	2	9	0	1	10	0	0
10	20368862	.	T	A	15	14	29	0	5	34	0	0
10	20368883	.	C	T	12	15	27	0	0	27	0	0
10	20371402	.	A	T	12	11	23	0	2	25	0	0
10	20371419	.	A	C	13	16	29	0	1	30	0	0
10	20371478	.	C	A	16	11	27	0	0	27	0	0
10	20371675	.	A	T	19	8	27	0	0	27	0	0
10	20392836	.	T	A	1	4	5	0	0	5	0	0
10	20392903	.	G	A	5	2	7	0	0	7	0	0
10	20393172	.	C	T	4	3	7	0	0	7	0	0
10	20395629	.	T	C	4	6	10	0	2	12	0	0
10	20398930	.	T	C	6	10	16	0	0	16	0	0
10	20401360	.	C	A	3	3	6	0	0	6	0	0
10	20401418	.	T	C	3	3	6	0	1	7	0	0
10	20401613	.	C	A	4	3	7	0	0	7	0	0
10	20401649	.	G	T	4	3	7	0	0	7	0	0
10	20401813	.	A	G	2	2	4	0	1	5	0	0
10	20468843	.	T	A	12	16	28	0	0	28	0	0
10	20468952	.	G	A	16	10	26	0	0	26	0	0
10	20469878	.	G	C	13	14	27	0	2	29	0	0
10	20472614	.	C	T	13	8	21	0	0	21	0	0
10	20472926	.	T	C	27	14	41	0	3	44	0	0
10	20473147	.	C	G	1	19	20	0	13	33	0	0
10	20473366	.	C	T	9	11	20	0	0	20	0	0
10	20473409	.	G	A	11	14	25	0	0	25	0	0
10	20473517	.	G	T	11	18	29	0	1	30	0	0
10	20481653	.	C	T	1	7	8	0	12	20	0	0
10	20481656	.	G	A	11	8	19	0	2	21	0	0
10	20505261	.	G	A	3	2	5	0	0	5	0	0
10	20505467	.	T	C	2	0	2	0	14	16	0	0
10	20505679	.	T	G	2	4	6	0	0	6	0	0
10	20521939	.	C	T	6	7	13	0	1	14	0	0
10	20527553	.	G	A	4	3	7	0	0	7	0	0
10	20527639	.	G	A	8	5	13	0	1	14	0	0
10	20527736	.	C	T	1	9	10	0	10	20	0	0
10	20527837	.	C	A	3	10	13	0	7	20	0	0
10	20529450	.	T	C	7	0	7	0	12	19	0	0
10	20532762	.	C	T	1	6	7	0	6	13	0	0
10	20543294	.	T	C	3	0	3	0	8	11	0	0
10	20543336	.	G	A	7	10	17	0	1	18	0	0
10	20546530	.	G	A	14	13	27	0	0	27	0	0
10	20546548	.	C	T	10	9	19	0	3	22	0	0
10	20558156	.	G	C	12	14	26	0	2	28	0	0
10	20558270	.	G	A	12	16	28	0	1	29	0	0
10	20558300	.	G	C	11	0	11	0	15	26	0	0
10	20562894	.	C	T	12	14	26	0	1	27	0	0
10	20565260	.	C	T	2	9	11	0	15	26	0	0
10	20583799	.	C	T	6	5	11	0	0	11	0	0
10	20586463	.	A	T	6	7	13	0	0	13	0	0
10	20586604	.	A	G	9	10	19	0	0	19	0	0
10	20586613	.	A	T	10	9	19	0	0	19	0	0
10	20590317	.	T	C	12	13	25	0	0	25	0	0
10	20590372	.	T	A	15	11	26	0	3	29	0	0
10	20590436	.	A	C	18	17	35	0	1	36	0	0
10	20590461	.	G	T	18	18	36	0	3	39	0	0
10	20590547	.	T	C	11	17	28	0	0	28	0	0
10	20590569	.	C	T	12	20	32	0	0	32	0	0
10	20591833	.	G	A	1	10	11	0	16	27	0	0
10	20592420	.	C	T	15	12	27	0	2	29	0	0
10	20592598	.	G	T	13	9	22	0	0	22	0	0
10	20598177	.	C	A	11	12	23	0	0	23	0	0
10	20598267	.	A	G	17	4	21	0	1	22	0	0
10	20598270	.	G	A	18	3	21	2	0	23	0	0
10	20604548	.	A	G	17	9	26	0	0	26	0	0
10	20604555	.	T	C	16	12	28	0	1	29	0	0
10	20604703	.	G	T	11	14	25	1	0	26	0	0
10	20605171	.	A	T	12	19	31	0	0	31	0	0
10	20605610	.	C	A	1	2	3	0	0	3	0	0
10	20636027	.	C	T	18	15	33	0	0	33	0	0
10	20636168	.	A	T	16	15	31	0	0	31	0	0
10	20636177	.	G	T	15	12	27	0	0	27	0	0
10	20636273	.	T	C	15	0	15	0	18	33	0	0
10	20636346	.	T	C	8	14	22	2	1	25	0	0
10	20636479	.	T	C	3	10	13	0	2	15	0	0
10	20636542	.	G	A	8	9	17	0	1	18	0	0
10	20636600	.	T	C	2	0	2	0	4	6	0	0
10	20696429	.	G	A	4	4	8	0	0	8	0	0
10	20696449	.	A	G	4	3	7	0	0	7	0	0
10	20920664	.	A	G	13	12	25	0	1	26	0	0
10	20971685	.	A	G	15	18	33	0	0	33	0	0
10	21043902	.	G	A	13	11	24	0	0	24	0	0
10	21044064	.	G	A	11	11	22	0	1	23	0	0
10	21044286	.	A	G	7	8	15	0	0	15	0	0
10	21044316	.	A	G	6	11	17	0	0	17	0	0
10	21044337	.	T	C	9	0	9	0	8	17	0	0
10	21044361	.	A	T	9	9	18	0	1	19	0	0
10	21044385	.	G	T	9	11	20	0	0	20	0	0
10	21045123	.	A	T	15	12	27	0	0	27	0	0
10	21045126	.	T	C	13	0	13	0	10	23	0	0
10	21046033	.	C	T	7	10	17	0	0	17	0	0
10	21046442	.	G	A	14	7	21	0	1	22	0	0
10	21046493	.	T	C	16	6	22	0	0	22	0	0
10	21053520	.	G	C	8	4	12	0	2	14	0	0
10	21436810	.	T	C	7	12	19	0	1	20	0	0
10	21437255	.	A	G	11	0	11	0	8	19	0	0
10	21442229	.	T	C	15	13	28	0	0	28	0	0
10	21443135	.	G	A	1	13	14	0	9	23	0	0
10	21443193	.	T	G	12	14	26	0	2	29	1	0
10	21443347	.	T	A	2	3	5	0	0	5	0	0
10	21452340	.	T	C	16	10	26	0	0	26	0	0
10	21452376	.	G	A	1	9	10	0	17	27	0	0
10	21452403	.	G	A	19	9	28	0	0	28	0	0
10	21459017	.	G	A	1	12	13	0	12	25	0	0
10	21459439	.	G	A	18	21	39	0	2	41	0	0
10	21462612	.	T	C	18	21	39	0	0	39	0	0
10	21470192	.	G	A	0	10	10	0	15	25	0	0
10	21471710	.	C	T	1	4	5	0	0	5	0	0
10	21473791	.	A	G	1	2	3	0	0	3	0	0
10	21474532	.	G	A	0	2	2	0	2	4	0	0
10	21523624	.	A	C	11	4	15	0	0	15	0	0
10	21524679	.	G	A	7	11	18	0	1	19	0	0
10	21524682	.	G	A	9	11	20	0	0	20	0	0
10	21524919	.	C	G	12	0	12	0	7	19	0	0
10	21525243	.	A	G	9	8	17	0	0	17	0	0
10	21525276	.	T	A	7	10	17	0	0	17	0	0
10	21559809	.	G	T	0	2	2	0	1	3	0	0
10	21560051	.	G	A	2	2	4	1	0	5	0	0
10	21560828	.	A	C	1	3	4	0	0	4	0	0
10	21564230	.	A	G	2	2	4	0	0	4	0	0
10	21579312	.	C	A	12	2	14	1	0	15	0	0
10	21579320	.	T	A	12	2	14	0	0	14	0	0
10	21588067	.	T	C	3	4	7	0	1	8	0	0
10	21588085	.	G	A	0	2	2	0	5	7	0	0
10	21646033	.	C	T	32	25	57	1	0	58	0	0
10	21646621	.	C	T	34	28	62	0	2	64	0	0
10	21646668	.	T	A	32	29	61	0	2	63	0	0
10	21646797	.	C	T	29	25	54	0	0	54	0	0
10	21646802	.	A	G	28	24	52	0	0	52	0	0
10	21646844	.	A	G	23	26	49	0	1	50	0	0
10	21647241	.	T	G	25	27	52	0	1	53	0	0
10	21647291	.	G	A	3	28	31	0	27	58	0	0
10	21647691	.	G	A	31	29	60	0	1	61	0	0
10	21651052	.	C	G	5	2	7	0	0	7	0	0
10	21651348	.	A	G	4	2	6	0	0	6	0	0
10	21651889	.	G	T	5	4	9	0	0	9	0	0
10	21652148	.	C	A	1	6	7	0	0	7	0	0
10	21658567	.	G	A	6	5	11	0	0	11	0	0
10	21660949	.	C	A	5	2	7	1	0	8	0	0
10	21660951	.	C	G	5	2	7	1	0	8	0	0
10	21662695	.	A	C	1	2	3	4	0	7	0	0
10	21662853	.	A	C	1	2	3	0	0	3	0	0
10	21669235	.	G	A	2	2	4	0	0	4	0	0
10	21677720	.	G	A	3	2	5	2	0	7	0	0
10	21677746	.	C	T	3	5	8	0	0	8	0	0
10	21679442	.	T	C	6	5	11	7	0	18	0	0
10	21679497	.	C	A	9	6	15	0	0	15	0	0
10	21701576	.	T	C	5	4	9	0	0	9	0	0
10	21702390	.	C	T	2	2	4	1	0	5	0	0
10	21702397	.	C	T	3	2	5	1	0	6	0	0
10	21702953	.	G	T	5	3	8	0	0	8	0	0
10	21702955	.	A	T	4	3	7	0	0	7	0	0
10	21715872	.	G	C	3	3	6	0	0	6	0	0
10	21715889	.	A	G	3	2	5	0	0	5	0	0
10	21718557	.	C	T	1	3	4	1	0	5	0	0
10	21718614	.	T	C	2	6	8	0	0	8	0	0
10	21718647	.	A	G	2	0	2	0	5	7	0	0
10	21718691	.	G	A	2	3	5	2	0	7	0	0
10	21718980	.	A	T	1	2	3	0	0	3	0	0
10	21719004	.	A	C	2	5	7	0	1	8	0	0
10	21719038	.	A	G	2	4	6	0	1	7	0	0
10	21719065	.	A	T	2	5	7	0	0	7	0	0
10	21719115	.	A	G	2	0	2	0	3	5	0	0
10	21719125	.	G	A	3	3	6	0	0	6	0	0
10	21719919	.	T	C	1	3	4	0	1	5	0	0
10	21720798	.	T	C	3	3	6	0	0	6	0	0
10	21720833	.	A	G	2	3	5	0	0	5	0	0
10	21720867	.	G	A	2	4	6	0	5	11	0	0
10	21723014	.	C	A	3	2	5	5	0	10	0	0
10	21723023	.	G	A	0	2	2	5	4	11	0	0
10	21723092	.	A	T	6	3	9	0	0	9	0	0
10	21723263	.	C	A	3	3	6	0	0	6	0	0
10	21723293	.	C	T	4	4	8	0	0	8	0	0
10	21723536	.	A	G	3	0	3	0	5	8	0	0
10	21723656	.	C	T	4	5	9	1	0	10	0	0
10	21723674	.	G	A	5	4	9	1	0	11	1	0
10	21723801	.	T	A	1	2	3	0	0	3	0	0
10	21723810	.	A	G	2	0	2	0	2	4	0	0
10	21723878	.	C	T	3	3	6	0	0	6	0	0
10	21723887	.	A	G	2	0	2	0	5	7	0	0
10	21723932	.	T	A	3	6	9	0	0	9	0	0
10	21723962	.	T	C	4	4	8	0	0	8	0	0
10	21724004	.	A	T	4	2	6	0	0	6	0	0
10	21724052	.	C	A	3	2	5	0	0	5	0	0
10	21724095	.	A	T	4	2	6	0	0	7	1	0
10	21724118	.	A	G	2	2	4	0	0	4	0	0
10	21729191	.	T	C	4	2	6	0	0	6	0	0
10	21732003	.	T	C	1	3	4	4	0	8	0	0
10	21761109	.	G	A	4	3	7	8	0	15	0	0
10	21776931	.	G	T	1	6	7	0	10	17	0	0
10	21777599	.	T	A	6	2	8	0	1	9	0	0
10	21777687	.	A	G	2	6	8	0	0	8	0	0
10	21777741	.	T	C	5	4	9	0	0	9	0	0
10	21777744	.	T	C	5	5	10	0	0	10	0	0
10	21778194	.	C	T	6	1	7	0	0	7	0	0
10	21778201	.	T	G	6	2	8	0	0	8	0	0
10	21778980	.	C	T	8	7	15	6	1	22	0	0
10	21780342	.	C	T	1	4	5	0	0	5	0	0
10	21780366	.	A	G	4	7	11	4	0	15	0	0
10	21781308	.	A	G	8	1	9	7	17	33	0	0
10	21781524	.	C	G	26	11	37	0	1	38	0	0
10	21781677	.	G	A	2	12	14	1	8	23	0	0
10	21781710	.	T	C	27	8	35	0	0	35	0	0
10	21781722	.	G	C	18	11	29	0	0	35	6	0
10	21783215	.	T	A	1	2	3	1	0	4	0	0
10	21783252	.	C	T	9	14	23	0	0	23	0	0
10	21783727	.	C	A	12	12	24	0	0	25	1	0
10	21783733	.	T	C	11	14	25	0	1	26	0	0
10	21784071	.	T	C	14	11	25	0	0	25	0	0
10	21784130	.	G	T	4	10	14	0	16	30	0	0
10	21784132	.	C	T	17	9	26	0	2	28	0	0
10	21784186	.	A	G	23	16	39	0	0	39	0	0
10	21784756	.	C	T	19	5	24	5	0	29	0	0
10	21784759	.	T	C	19	5	24	5	0	29	0	0
10	21785677	.	C	T	14	5	19	3	1	23	0	0
10	21786705	.	G	A	9	7	16	0	0	16	0	0
10	21786713	.	G	A	10	6	16	0	1	17	0	0
10	21786792	.	C	A	15	5	20	0	0	20	0	0
10	21786817	.	G	A	16	8	24	0	1	25	0	0
10	21786832	.	C	T	19	11	30	0	0	30	0	0
10	21786934	.	G	T	6	7	13	0	4	17	0	0
10	21787255	.	A	T	4	6	10	0	0	10	0	0
10	21787943	.	T	A	4	9	13	0	0	13	0	0
10	21788022	.	A	G	7	8	15	0	1	16	0	0
10	21788038	.	T	C	7	11	18	0	1	19	0	0
10	21788695	.	C	A	5	3	8	16	0	24	0	0
10	21790076	.	A	C	17	17	34	0	0	34	0	0
10	21790121	.	C	A	14	16	30	0	1	32	1	0
10	21790137	.	G	A	15	16	31	0	0	31	0	0
10	21790295	.	A	T	6	3	9	0	0	9	0	0
10	21790323	.	G	A	5	4	9	0	0	9	0	0
10	21790648	.	T	C	9	11	20	0	0	20	0	0
10	21790769	.	A	G	7	0	7	0	18	25	0	0
10	21790775	.	A	C	3	20	23	0	2	25	0	0
10	21790934	.	T	C	12	9	21	0	1	22	0	0
10	21791090	.	G	A	8	11	19	0	1	20	0	0
10	21791375	.	G	A	10	15	25	0	1	26	0	0
10	21791552	.	G	T	4	5	9	1	1	11	0	0
10	21794285	.	G	A	3	10	13	0	1	14	0	0
10	21794410	.	T	A	4	7	11	0	1	12	0	0
10	21794598	.	A	C	2	12	14	0	0	14	0	0
10	21794797	.	A	C	3	5	8	0	0	8	0	0
10	21794800	.	A	T	3	4	7	0	1	8	0	0
10	21795065	.	C	T	3	4	7	0	0	7	0	0
10	21795190	.	T	A	5	8	13	0	0	13	0	0
10	21795216	.	G	C	3	5	8	9	0	17	0	0
10	21795337	.	C	T	4	3	7	12	0	19	0	0
10	21795412	.	A	T	3	3	6	9	0	15	0	0
10	21795655	.	A	T	10	4	14	2	0	16	0	0
10	21795887	.	C	T	7	3	10	0	0	10	0	0
10	21797207	.	G	C	16	7	23	0	0	23	0	0
10	21797247	.	C	A	13	7	20	0	0	20	0	0
10	21797266	.	C	T	11	4	15	0	0	15	0	0
10	21797282	.	A	G	8	4	12	0	0	12	0	0
10	21797769	.	T	G	6	3	9	0	0	9	0	0
10	21798029	.	T	C	7	2	9	0	0	9	0	0
10	21798215	.	C	A	7	9	16	0	0	16	0	0
10	21798348	.	A	T	6	4	10	0	1	11	0	0
10	21798372	.	G	A	9	3	12	0	2	14	0	0
10	21799320	.	A	C	5	2	7	14	0	21	0	0
10	21799343	.	T	A	9	3	12	4	1	17	0	0
10	21799374	.	T	A	15	4	19	0	2	21	0	0
10	21799584	.	T	C	4	2	6	4	0	10	0	0
10	21801256	.	C	G	5	11	16	0	1	17	0	0
10	21801267	.	C	T	5	13	18	0	1	19	0	0
10	21801339	.	T	G	19	0	19	0	11	30	0	0
10	21801352	.	T	C	22	12	34	0	1	35	0	0
10	21801573	.	C	T	8	14	22	0	0	22	0	0
10	21801590	.	A	C	6	7	13	0	0	13	0	0
10	21801611	.	G	T	8	6	14	0	0	14	0	0
10	21801718	.	G	A	2	12	14	0	17	31	0	0
10	21801856	.	C	T	14	8	22	0	0	22	0	0
10	21802057	.	A	G	8	7	15	0	4	19	0	0
10	21802086	.	A	G	12	9	21	0	1	22	0	0
10	21802291	.	C	T	13	14	27	0	1	28	0	0
10	21802326	.	C	A	18	13	31	0	2	33	0	0
10	21802355	.	C	A	20	15	35	0	0	35	0	0
10	21802380	.	G	A	1	12	13	0	18	31	0	0
10	21802530	.	A	T	10	4	14	0	0	14	0	0
10	21802539	.	C	T	9	4	13	0	0	13	0	0
10	21802566	.	T	C	12	6	18	0	0	18	0	0
10	21802661	.	C	T	16	8	24	0	1	25	0	0
10	21802959	.	T	C	14	13	27	19	1	47	0	0
10	21802989	.	T	C	19	14	33	10	1	44	0	0
10	21803004	.	G	A	24	8	32	7	2	41	0	0
10	21803031	.	G	A	22	6	28	7	0	35	0	0
10	21804785	.	G	T	1	14	15	0	7	22	0	0
10	21804786	.	G	T	7	15	22	0	0	22	0	0
10	21805019	.	A	T	5	4	9	0	0	9	0	0
10	21805020	.	A	C	5	4	9	0	0	9	0	0
10	21805085	.	A	C	7	3	10	0	0	10	0	0
10	21805090	.	G	A	8	5	13	0	0	13	0	0
10	21805251	.	T	G	7	9	16	0	0	16	0	0
10	21805447	.	G	A	9	10	19	0	0	19	0	0
10	21805762	.	C	T	9	11	20	0	1	21	0	0
10	21805870	.	A	G	4	0	4	0	5	9	0	0
10	21805942	.	G	T	0	3	3	0	2	5	0	0
10	21806060	.	G	A	8	7	15	0	0	15	0	0
10	21806789	.	G	A	11	13	24	0	1	25	0	0
10	21808897	.	G	A	1	3	4	0	6	10	0	0
10	21808946	.	G	A	3	2	5	0	0	5	0	0
10	21809253	.	C	A	2	3	5	0	0	5	0	0
10	21809314	.	A	G	1	5	6	0	0	6	0	0
10	21818522	.	C	T	44	40	84	0	4	88	0	0
10	21818595	.	T	G	29	40	69	0	1	70	0	0
10	21818762	.	A	C	28	25	53	1	2	56	0	0
10	21818916	.	C	T	32	26	58	0	1	59	0	0
10	21819019	.	G	A	3	28	31	0	24	55	0	0
10	21819038	.	C	A	26	30	56	0	2	58	0	0
10	21819105	.	G	T	21	31	52	0	2	54	0	0
10	21819214	.	G	C	35	24	59	0	2	61	0	0
10	21819523	.	T	A	33	29	62	0	2	64	0	0
10	21819577	.	C	T	31	33	64	0	6	70	0	0
10	21819653	.	T	C	36	38	74	0	6	80	0	0
10	21819772	.	T	C	28	37	65	0	3	68	0	0
10	21819966	.	A	T	6	2	8	0	0	8	0	0
10	21915584	.	G	A	1	2	3	0	0	3	0	0
10	21915590	.	G	A	0	2	2	0	0	2	0	0
10	21944029	.	G	T	4	2	6	0	1	7	0	0
10	21944199	.	T	G	2	2	4	0	0	4	0	0
10	21944214	.	G	A	2	3	5	0	0	5	0	0
10	21944728	.	A	G	2	3	5	0	0	5	0	0
10	21944789	.	C	T	1	3	4	0	0	4	0	0
10	21947257	.	T	G	1	2	3	0	0	3	0	0
10	22012534	.	G	A	9	5	14	0	0	14	0	0
10	22030798	.	C	T	24	26	50	0	2	52	0	0
10	22030881	.	A	T	11	21	32	0	0	32	0	0
10	22031375	.	A	C	23	15	38	0	2	40	0	0
10	22031493	.	G	A	30	17	47	0	2	49	0	0
10	22031572	.	A	G	18	29	47	0	0	47	0	0
10	22031635	.	A	G	15	18	33	0	1	34	0	0
10	22031666	.	A	G	7	20	27	0	1	28	0	0
10	22031755	.	T	C	15	14	29	0	0	29	0	0
10	22031759	.	T	C	15	13	28	0	1	29	0	0
10	22035638	.	A	G	9	6	15	0	0	15	0	0
10	22036235	.	T	A	11	9	20	0	0	20	0	0
10	22041529	.	G	A	12	13	25	0	1	26	0	0
10	22041717	.	T	C	7	10	17	0	2	19	0	0
10	22044699	.	G	A	8	5	13	0	0	13	0	0
10	22044921	.	T	G	3	3	6	0	0	6	0	0
10	22044982	.	C	T	4	6	10	0	0	10	0	0
10	22045014	.	G	T	3	5	8	0	1	9	0	0
10	22054257	.	T	C	2	2	4	0	2	6	0	0
10	22134695	.	G	A	3	3	6	0	0	6	0	0
10	22163002	.	G	T	8	5	13	0	0	13	0	0
10	22381984	.	A	T	9	8	17	0	0	17	0	0
10	22382167	.	G	A	1	6	7	0	14	21	0	0
10	22382427	.	T	C	9	12	21	0	1	22	0	0
10	22471425	.	C	A	12	6	18	3	2	23	0	0
10	22475679	.	C	A	16	9	25	0	0	25	0	0
10	22475799	.	G	A	2	19	21	0	17	38	0	0
10	22476535	.	C	T	16	14	30	0	1	31	0	0
10	22477229	.	A	G	12	18	30	0	3	33	0	0
10	22477610	.	A	G	8	1	9	0	11	20	0	0
10	22477661	.	C	T	11	14	25	0	1	26	0	0
10	22477880	.	A	G	25	0	25	0	19	44	0	0
10	22510354	.	C	A	2	7	9	0	0	9	0	0
10	22510362	.	G	A	1	7	8	0	0	8	0	0
10	22510493	.	A	G	3	5	8	1	0	9	0	0
10	22510508	.	A	G	3	3	6	1	0	7	0	0
10	22510577	.	C	A	14	7	21	0	2	23	0	0
10	22516643	.	C	G	5	15	20	0	0	20	0	0
10	22516710	.	G	A	15	9	24	0	0	24	0	0
10	22516876	.	A	T	5	3	8	0	1	9	0	0
10	22516903	.	A	G	6	2	8	0	0	8	0	0
10	22516957	.	T	C	2	4	6	0	0	6	0	0
10	22518237	.	G	A	1	20	21	0	11	32	0	0
10	22518267	.	T	A	18	17	35	0	1	36	0	0
10	22519465	.	A	G	14	8	22	0	1	23	0	0
10	22525652	.	G	A	13	9	22	0	0	22	0	0
10	22528077	.	C	T	6	10	16	0	2	18	0	0
10	22530043	.	C	T	4	4	8	0	0	8	0	0
10	22530058	.	A	C	6	5	11	0	0	11	0	0
10	22530136	.	A	G	8	0	8	0	7	15	0	0
10	22530812	.	T	C	8	12	20	0	0	21	1	0
10	22531003	.	T	A	12	3	15	0	1	16	0	0
10	22531105	.	A	T	5	3	8	0	0	8	0	0
10	22531179	.	A	G	6	5	11	0	0	11	0	0
10	22531472	.	T	C	5	8	13	0	0	13	0	0
10	22531906	.	A	C	11	12	23	0	1	24	0	0
10	22531912	.	G	A	9	11	20	0	0	20	0	0
10	22532133	.	G	T	8	10	18	0	3	21	0	0
10	22532316	.	G	A	10	9	19	0	0	19	0	0
10	22532347	.	C	T	21	8	29	0	0	29	0	0
10	22532547	.	T	A	13	15	28	0	0	28	0	0
10	22532610	.	A	T	10	18	28	0	0	28	0	0
10	22532817	.	C	G	12	17	29	0	1	30	0	0
10	22604984	.	G	A	0	3	3	0	2	5	0	0
10	22605394	.	T	A	2	3	5	0	0	5	0	0
10	22605561	.	C	A	2	2	4	0	0	4	0	0
10	22745285	.	T	C	5	7	12	0	0	12	0	0
10	22745661	.	C	T	6	12	18	0	1	19	0	0
10	22747289	.	G	C	1	9	10	0	11	21	0	0
10	22747913	.	T	C	6	8	14	0	0	14	0	0
10	22748442	.	G	T	2	6	8	0	1	9	0	0
10	22748504	.	G	A	3	4	7	0	0	7	0	0
10	22748834	.	A	G	2	9	11	0	1	12	0	0
10	22748964	.	G	C	9	5	14	0	1	15	0	0
10	22749466	.	T	C	8	6	14	0	0	14	0	0
10	22749623	.	C	T	8	8	16	0	0	16	0	0
10	22749681	.	G	A	6	7	13	0	0	13	0	0
10	22749824	.	A	C	3	5	8	0	0	8	0	0
10	22751095	.	G	A	7	12	19	0	0	19	0	0
10	22753455	.	G	A	8	8	16	0	1	17	0	0
10	22753883	.	A	C	8	4	12	0	0	12	0	0
10	22755164	.	C	T	7	8	15	0	2	17	0	0
10	22758016	.	G	A	12	9	21	0	0	21	0	0
10	22758094	.	A	G	6	0	6	0	12	18	0	0
10	22758303	.	A	G	5	7	12	0	1	13	0	0
10	22758481	.	A	G	8	0	8	0	8	16	0	0
10	22760658	.	A	C	8	4	12	0	0	12	0	0
10	22786128	.	T	A	5	7	12	0	1	13	0	0
10	22786227	.	C	T	5	3	8	0	0	8	0	0
10	22791610	.	T	G	1	2	3	0	0	3	0	0
10	22791880	.	A	G	1	2	3	0	0	3	0	0
10	22791951	.	G	T	1	2	3	0	0	3	0	0
10	22792038	.	G	A	1	2	3	0	0	3	0	0
10	22811358	.	C	A	1	6	7	0	2	9	0	0
10	22811406	.	T	C	5	0	5	0	7	12	0	0
10	22811621	.	A	C	11	0	11	0	11	22	0	0
10	22812500	.	A	T	2	7	9	0	1	10	0	0
10	22814750	.	G	A	9	7	16	0	0	16	0	0
10	22828380	.	C	A	3	2	5	0	0	5	0	0
10	22828381	.	A	G	3	2	5	0	0	5	0	0
10	22831410	.	T	A	2	2	4	0	0	4	0	0
10	22838530	.	C	T	4	32	36	0	34	70	0	0
10	22841955	.	G	T	31	25	56	0	11	67	0	0
10	22845293	.	C	T	3	35	38	0	30	68	0	0
10	22854917	.	A	G	9	6	15	0	1	16	0	0
10	22855708	.	G	A	6	4	10	0	0	10	0	0
10	22856192	.	G	C	10	3	13	0	0	13	0	0
10	22856201	.	T	C	9	3	12	0	1	13	0	0
10	22861945	.	T	G	4	2	6	0	0	6	0	0
10	22861947	.	A	G	3	2	5	0	1	6	0	0
10	22893992	.	A	G	16	9	25	0	1	26	0	0
10	22894100	.	G	A	8	7	15	0	2	17	0	0
10	22895312	.	T	C	8	9	17	0	0	17	0	0
10	22895327	.	T	C	9	8	17	0	0	17	0	0
10	22896782	.	C	A	10	8	18	0	1	19	0	0
10	22896950	.	C	T	13	7	20	0	1	21	0	0
10	22896959	.	G	A	0	8	8	0	13	21	0	0
10	22897187	.	C	T	12	6	18	0	0	18	0	0
10	22906434	.	C	T	11	8	19	0	0	19	0	0
10	22906587	.	T	C	5	8	13	0	0	13	0	0
10	22906844	.	C	T	9	8	17	0	1	18	0	0
10	22906916	.	A	T	7	13	20	0	0	20	0	0
10	22912547	.	C	T	4	6	10	0	1	11	0	0
10	22915875	.	A	G	4	3	7	0	0	7	0	0
10	22915897	.	G	A	5	5	10	0	0	10	0	0
10	22915914	.	C	A	4	5	9	0	0	9	0	0
10	22916324	.	A	G	23	21	44	3	7	54	0	0
10	22916339	.	A	G	26	16	42	3	2	47	0	0
10	22916422	.	A	C	28	29	57	0	0	57	0	0
10	22916426	.	T	A	23	28	51	0	1	52	0	0
10	22916664	.	C	T	25	24	49	0	5	55	1	0
10	22916730	.	A	G	27	35	62	0	3	66	1	0
10	22918164	.	T	C	33	19	52	0	3	55	0	0
10	22918190	.	C	T	24	9	33	0	0	33	0	0
10	22918214	.	T	G	9	5	14	0	0	14	0	0
10	22922089	.	A	G	3	0	3	0	6	9	0	0
10	22924978	.	A	C	5	13	18	0	0	18	0	0
10	22925049	.	G	A	1	9	10	0	9	19	0	0
10	22925326	.	G	A	5	5	10	0	1	11	0	0
10	22925851	.	T	C	4	3	7	0	0	7	0	0
10	22925983	.	A	C	5	6	11	0	0	11	0	0
10	22955718	.	A	G	1	5	6	0	0	6	0	0
10	23024405	.	T	C	23	23	46	0	0	46	0	0
10	23024660	.	A	G	28	26	54	0	4	58	0	0
10	23024708	.	T	C	27	22	49	0	2	51	0	0
10	23024762	.	A	G	29	19	48	0	2	50	0	0
10	23060740	.	G	A	7	9	16	0	3	19	0	0
10	23061326	.	G	A	1	6	7	0	5	12	0	0
10	23065777	.	T	C	10	11	21	0	1	22	0	0
10	23068553	.	G	T	13	9	22	0	0	22	0	0
10	23068630	.	A	G	9	16	25	0	0	25	0	0
10	23068907	.	T	G	4	11	15	0	0	15	0	0
10	23068962	.	A	G	5	9	14	0	1	15	0	0
10	23068963	.	C	T	5	10	15	0	0	15	0	0
10	23069120	.	T	C	5	5	10	1	0	11	0	0
10	23069253	.	T	C	1	5	6	0	0	6	0	0
10	23071322	.	G	A	4	3	7	0	2	9	0	0
10	23071524	.	G	T	5	9	14	0	0	14	0	0
10	23071619	.	A	G	10	8	18	0	0	18	0	0
10	23071697	.	G	A	4	8	12	0	0	12	0	0
10	23071705	.	G	C	5	6	11	0	0	11	0	0
10	23076290	.	A	G	2	2	4	0	0	4	0	0
10	23076327	.	G	A	3	3	6	0	0	6	0	0
10	23099799	.	C	A	0	2	2	0	2	4	0	0
10	23103379	.	T	A	1	2	3	0	0	3	0	0
10	23105487	.	A	G	1	2	3	0	0	3	0	0
10	23107716	.	T	C	1	2	3	0	0	3	0	0
10	23114696	.	T	G	2	2	4	0	1	5	0	0
10	23114726	.	A	C	2	2	4	0	0	4	0	0
10	23116081	.	T	C	1	2	3	0	0	3	0	0
10	23116090	.	G	A	1	2	3	0	0	3	0	0
10	23122855	.	T	C	4	3	7	0	0	7	0	0
10	23125011	.	A	G	1	0	1	0	4	5	0	0
10	23126558	.	T	C	2	5	7	0	0	7	0	0
10	23129422	.	G	A	0	2	2	0	1	3	0	0
10	23131977	.	C	A	3	3	6	0	1	7	0	0
10	23139410	.	A	G	2	0	2	0	2	4	0	0
10	23139485	.	A	G	3	2	5	0	1	6	0	0
10	23220533	.	A	G	16	9	25	0	6	31	0	0
10	23275265	.	G	A	8	9	17	1	0	18	0	0
10	23358248	.	C	T	0	13	13	0	17	30	0	0
10	24325590	.	C	T	19	30	49	0	1	50	0	0
10	24334999	.	T	G	25	20	45	1	3	50	1	0
10	24373647	.	C	T	1	4	5	0	0	5	0	0
10	24373657	.	A	C	0	4	4	0	0	4	0	0
10	24374832	.	G	A	2	3	5	0	0	5	0	0
10	24422052	.	C	T	19	12	31	0	2	33	0	0
10	24422070	.	T	A	25	12	37	0	1	38	0	0
10	24422236	.	C	T	19	13	32	0	2	34	0	0
10	24425257	.	A	G	15	12	27	0	0	27	0	0
10	24426924	.	A	G	11	14	25	0	0	25	0	0
10	24427010	.	G	C	8	11	19	0	1	20	0	0
10	24429262	.	C	T	2	7	9	0	2	11	0	0
10	24429282	.	A	C	1	9	10	0	3	13	0	0
10	24429342	.	T	C	8	5	13	0	0	13	0	0
10	24429386	.	C	T	6	5	11	0	0	11	0	0
10	24431719	.	A	T	15	12	27	0	0	27	0	0
10	24431795	.	T	C	7	5	12	0	0	12	0	0
10	24431807	.	C	T	8	5	13	0	0	13	0	0
10	24437128	.	A	G	15	19	34	0	0	34	0	0
10	24441916	.	C	T	17	17	34	0	2	36	0	0
10	24442466	.	C	T	3	6	9	0	0	9	0	0
10	24442490	.	A	G	2	0	2	0	5	7	0	0
10	24563892	.	T	G	6	13	19	0	0	19	0	0
10	24564935	.	C	A	13	13	26	0	1	27	0	0
10	24565137	.	G	A	1	25	26	0	14	40	0	0
10	24565139	.	A	T	16	23	39	0	2	41	0	0
10	24566124	.	T	C	11	7	18	0	0	18	0	0
10	24600128	.	A	G	17	16	33	0	2	35	0	0
10	24609175	.	G	A	15	19	34	0	0	34	0	0
10	24614636	.	A	G	5	0	5	0	17	22	0	0
10	24614707	.	A	G	8	12	20	0	2	22	0	0
10	24614709	.	T	G	8	13	21	0	1	22	0	0
10	24616839	.	C	A	19	8	27	0	1	28	0	0
10	24616944	.	T	C	16	7	23	1	0	24	0	0
10	24617156	.	G	A	10	18	28	0	1	29	0	0
10	24617621	.	G	C	2	12	14	0	9	23	0	0
10	24617624	.	G	A	10	12	22	0	1	23	0	0
10	24621354	.	A	G	17	21	38	0	0	38	0	0
10	24621534	.	T	A	14	23	37	0	1	38	0	0
10	24621722	.	C	G	7	8	15	0	2	17	0	0
10	24621730	.	A	T	8	7	15	0	1	16	0	0
10	24621757	.	T	A	9	10	19	0	0	19	0	0
10	24650192	.	A	G	6	3	9	0	0	9	0	0
10	24652174	.	A	T	10	7	17	0	1	18	0	0
10	24654142	.	A	C	12	2	14	0	11	25	0	0
10	24654319	.	A	C	10	14	24	0	0	24	0	0
10	24654376	.	G	T	10	11	21	0	1	22	0	0
10	24654906	.	T	C	12	0	12	0	8	20	0	0
10	24659382	.	T	C	4	4	8	0	0	8	0	0
10	24659420	.	C	T	4	2	6	0	2	8	0	0
10	24659433	.	G	A	5	5	10	0	0	10	0	0
10	24659511	.	C	T	2	5	7	0	0	7	0	0
10	24660629	.	T	A	6	4	10	0	0	10	0	0
10	24662393	.	G	A	7	3	10	0	0	10	0	0
10	24677091	.	T	G	1	0	1	0	2	3	0	0
10	24678130	.	T	G	2	3	5	0	0	5	0	0
10	24710172	.	T	C	4	2	6	0	0	6	0	0
10	24710599	.	A	C	4	4	8	0	1	9	0	0
10	24710977	.	G	A	10	9	19	0	0	19	0	0
10	24721585	.	G	A	1	3	4	0	0	4	0	0
10	24724151	.	T	G	3	3	6	0	0	6	0	0
10	24725357	.	G	A	2	4	6	0	0	6	0	0
10	24725358	.	A	C	2	4	6	0	0	6	0	0
10	24725871	.	C	A	5	7	12	0	1	13	0	0
10	24726211	.	T	A	5	6	11	0	0	11	0	0
10	24726264	.	G	A	5	5	10	0	0	10	0	0
10	24726302	.	A	G	6	6	12	0	0	12	0	0
10	24726453	.	G	A	4	2	6	0	0	6	0	0
10	24726659	.	T	C	4	2	6	0	0	6	0	0
10	24727127	.	A	G	4	2	6	0	0	6	0	0
10	24753217	.	G	A	2	3	5	0	0	5	0	0
10	24753343	.	G	A	4	2	6	0	0	6	0	0
10	24762377	.	G	A	2	2	4	0	0	4	0	0
10	24762402	.	C	A	4	3	7	0	0	7	0	0
10	24762462	.	T	C	6	0	6	0	5	11	0	0
10	24762543	.	G	A	8	6	14	0	0	14	0	0
10	24762553	.	G	A	7	5	12	0	0	12	0	0
10	24762723	.	A	G	6	4	10	0	0	10	0	0
10	24762774	.	T	G	5	6	11	0	1	12	0	0
10	25035588	.	G	T	2	2	4	0	0	4	0	0
10	25035589	.	G	A	2	2	4	0	0	4	0	0
10	25068718	.	G	A	3	4	7	0	0	7	0	0
10	25068973	.	C	T	2	4	6	0	0	6	0	0
10	25131015	.	A	G	4	2	6	0	0	6	0	0
10	25141616	.	A	G	1	3	4	0	0	4	0	0
10	25146942	.	T	A	3	2	5	0	0	5	0	0
10	25150635	.	A	T	3	2	5	0	0	5	0	0
10	25152552	.	A	C	2	2	4	0	0	4	0	0
10	25153942	.	A	G	1	3	4	0	0	4	0	0
10	25201327	.	T	A	2	2	4	0	0	4	0	0
10	25205354	.	A	C	9	11	20	0	0	20	0	0
10	25205893	.	A	G	6	0	6	0	7	13	0	0
10	25209612	.	G	A	8	6	14	0	2	16	0	0
10	25210125	.	C	A	11	14	25	0	1	26	0	0
10	25214627	.	C	T	3	3	6	0	0	6	0	0
10	25214648	.	G	T	0	3	3	0	3	6	0	0
10	25222392	.	G	T	13	11	24	0	0	24	0	0
10	25250373	.	C	T	12	7	19	0	0	19	0	0
10	25252474	.	C	T	15	7	22	0	1	23	0	0
10	25262150	.	T	A	17	16	33	0	0	33	0	0
10	25262279	.	C	T	14	14	28	0	0	28	0	0
10	25262336	.	C	T	14	13	27	0	1	28	0	0
10	25268882	.	T	A	4	2	6	0	0	6	0	0
10	25269245	.	C	T	17	11	28	0	3	31	0	0
10	25269310	.	G	T	12	23	35	0	1	36	0	0
10	25269325	.	T	G	17	23	40	0	3	43	0	0
10	25269492	.	A	G	18	0	18	1	20	39	0	0
10	25269742	.	C	T	16	30	46	1	1	48	0	0
10	25269747	.	T	A	28	14	42	1	3	46	0	0
10	25269946	.	G	A	0	30	30	1	22	53	0	0
10	25269998	.	G	T	4	10	14	6	45	65	0	0
10	25270096	.	T	C	22	15	37	0	2	39	0	0
10	25270432	.	A	G	13	13	26	0	1	27	0	0
10	25270471	.	A	G	12	15	27	0	0	27	0	0
10	25270803	.	A	T	18	19	37	0	0	37	0	0
10	25270958	.	C	T	7	18	25	0	0	25	0	0
10	25271323	.	A	G	17	9	26	0	1	27	0	0
10	25312733	.	T	G	11	6	17	0	0	17	0	0
10	25312879	.	T	A	7	4	11	0	0	11	0	0
10	25328680	.	A	T	3	6	9	0	0	9	0	0
10	25328686	.	A	G	3	8	11	0	0	11	0	0
10	25329811	.	C	A	3	20	23	0	28	51	0	0
10	25330646	.	G	A	21	20	41	0	1	42	0	0
10	25336271	.	A	G	14	28	42	0	0	42	0	0
10	25338585	.	C	G	13	22	35	0	0	35	0	0
10	25338762	.	G	A	18	23	41	0	0	41	0	0
10	25342976	.	G	A	1	4	5	0	0	5	0	0
10	25368169	.	A	G	2	3	5	0	0	5	0	0
10	25374165	.	A	G	4	3	7	0	0	7	0	0
10	25381257	.	C	T	2	2	4	0	0	4	0	0
10	25381304	.	G	A	0	2	2	0	1	3	0	0
10	25381742	.	G	T	0	2	2	0	3	5	0	0
10	25381873	.	G	T	1	3	4	0	0	4	0	0
10	25384133	.	A	G	1	2	3	0	0	3	0	0
10	25403139	.	G	A	1	4	5	0	0	5	0	0
10	25403280	.	C	G	0	7	7	0	4	11	0	0
10	25403402	.	C	T	0	8	8	1	4	13	0	0
10	25410276	.	T	C	4	0	4	0	11	15	0	0
10	25410288	.	A	G	4	13	17	0	0	17	0	0
10	25435194	.	A	G	3	3	6	0	0	6	0	0
10	25436452	.	A	G	2	2	4	0	0	4	0	0
10	25436557	.	C	T	0	4	4	0	1	5	0	0
10	25525853	.	G	A	6	3	9	0	1	10	0	0
10	25573218	.	A	G	14	8	22	0	1	23	0	0
10	25573333	.	G	A	15	7	22	0	1	23	0	0
10	25573365	.	C	A	14	7	21	0	0	21	0	0
10	25574159	.	T	C	13	10	23	0	0	23	0	0
10	25574181	.	C	T	1	11	12	0	10	22	0	0
10	25574316	.	A	G	7	10	17	0	0	18	1	0
10	25577082	.	T	A	3	10	13	0	1	14	0	0
10	25577088	.	A	G	5	10	15	0	1	16	0	0
10	25580119	.	A	T	5	12	17	0	0	17	0	0
10	25580370	.	T	C	4	5	9	0	0	9	0	0
10	25582029	.	A	G	11	7	18	0	0	18	0	0
10	25582074	.	G	T	12	16	28	0	0	28	0	0
10	25582656	.	C	T	8	15	23	0	0	23	0	0
10	25582920	.	T	C	4	7	11	0	1	12	0	0
10	25583160	.	C	A	4	3	7	0	1	8	0	0
10	25585179	.	A	G	1	8	9	0	0	9	0	0
10	25600712	.	A	G	6	5	11	0	1	12	0	0
10	25601711	.	A	G	5	12	17	0	0	17	0	0
10	25601719	.	G	A	6	11	17	0	0	17	0	0
10	25601799	.	T	C	8	4	12	0	1	13	0	0
10	25608132	.	T	C	5	5	10	0	1	11	0	0
10	25608133	.	C	T	4	6	10	0	1	11	0	0
10	25612581	.	G	C	4	3	7	0	0	7	0	0
10	25615597	.	A	G	8	5	13	0	1	14	0	0
10	25620847	.	C	T	3	5	8	0	1	9	0	0
10	25620868	.	A	T	4	4	8	0	2	10	0	0
10	25623600	.	C	T	4	6	10	0	0	10	0	0
10	25625001	.	C	T	2	6	8	0	0	8	0	0
10	25625266	.	C	T	5	8	13	0	0	13	0	0
10	25657307	.	A	T	7	6	13	0	0	13	0	0
10	25694920	.	G	A	41	31	72	0	3	75	0	0
10	25697655	.	A	G	21	32	53	0	1	54	0	0
10	25697715	.	G	C	21	21	42	0	0	42	0	0
10	25700984	.	G	A	1	3	4	0	0	4	0	0
10	25701659	.	G	C	9	13	22	0	2	24	0	0
10	25701673	.	T	A	13	14	27	0	2	29	0	0
10	25701781	.	T	C	3	5	8	0	1	9	0	0
10	25704345	.	C	T	10	7	17	0	2	19	0	0
10	25706228	.	G	A	4	5	9	0	1	10	0	0
10	25712724	.	C	T	0	3	3	0	4	7	0	0
10	25712820	.	G	A	4	5	9	0	0	9	0	0
10	25829724	.	C	T	0	4	4	0	1	5	0	0
10	25830373	.	A	G	6	11	17	0	1	18	0	0
10	25830544	.	T	G	4	14	18	0	0	18	0	0
10	25830687	.	A	G	7	7	14	0	0	14	0	0
10	25830723	.	T	G	5	6	11	0	0	11	0	0
10	25837613	.	A	G	2	10	12	0	1	13	0	0
10	25840993	.	C	T	1	5	6	0	0	6	0	0
10	25841020	.	G	A	1	6	7	0	0	7	0	0
10	25841059	.	T	C	2	6	8	0	0	8	0	0
10	25841242	.	G	A	1	4	5	0	0	5	0	0
10	25948190	.	A	T	8	21	29	0	2	31	0	0
10	25960676	.	A	C	15	10	25	0	0	25	0	0
10	25960718	.	T	C	13	9	22	0	0	22	0	0
10	25960728	.	G	T	10	12	22	0	0	22	0	0
10	25961348	.	T	C	3	4	7	0	0	7	0	0
10	25961355	.	C	A	3	6	9	0	0	9	0	0
10	25961396	.	T	C	3	9	12	0	0	12	0	0
10	25961397	.	T	A	3	9	12	0	0	12	0	0
10	25961454	.	G	C	5	8	13	0	0	13	0	0
10	25961510	.	A	C	8	18	26	0	0	26	0	0
10	25961778	.	A	G	6	7	13	0	1	14	0	0
10	25961933	.	C	T	4	2	6	0	0	7	1	0
10	25983400	.	T	C	1	2	3	0	0	3	0	0
10	25986358	.	A	C	2	2	4	0	0	4	0	0
10	25986499	.	T	C	4	4	8	0	0	8	0	0
10	25986721	.	G	A	1	2	3	0	0	3	0	0
10	25987021	.	G	A	2	2	4	0	0	4	0	0
10	25987195	.	T	A	1	2	3	0	0	3	0	0
10	25987204	.	A	C	2	2	4	0	0	4	0	0
10	25987363	.	G	C	2	4	6	0	0	6	0	0
10	26019471	.	A	G	3	0	3	0	7	10	0	0
10	26071350	.	C	G	2	2	4	0	1	5	0	0
10	26074323	.	A	G	3	3	6	0	0	6	0	0
10	26078012	.	T	C	1	4	5	0	0	5	0	0
10	26078031	.	T	C	2	3	5	0	1	6	0	0
10	26084139	.	T	G	4	0	4	0	5	9	0	0
10	26084177	.	C	T	2	5	7	0	0	7	0	0
10	26089188	.	G	A	1	7	8	0	5	13	0	0
10	26089224	.	C	T	8	8	16	0	0	16	0	0
10	26089230	.	T	C	7	7	14	0	0	14	0	0
10	26098663	.	C	T	5	3	8	0	0	8	0	0
10	26100228	.	C	T	3	7	10	0	0	10	0	0
10	26100935	.	A	G	2	2	4	0	1	5	0	0
10	26100952	.	A	G	3	3	6	0	0	6	0	0
10	26106098	.	A	G	3	5	8	0	0	8	0	0
10	26107881	.	A	G	6	0	6	0	2	8	0	0
10	26107888	.	G	A	5	2	7	0	0	7	0	0
10	26111451	.	T	C	2	3	5	0	0	6	1	0
10	26111487	.	T	C	7	7	14	0	0	14	0	0
10	26111631	.	T	C	1	6	7	0	0	7	0	0
10	26113095	.	C	G	4	4	8	0	0	8	0	0
10	26113114	.	T	A	3	5	8	0	0	8	0	0
10	26113134	.	T	C	7	2	9	0	0	9	0	0
10	26113370	.	G	A	8	5	13	0	0	13	0	0
10	26113931	.	C	T	7	10	17	0	0	17	0	0
10	26114472	.	G	C	0	2	2	0	1	3	0	0
10	26114474	.	T	C	1	2	3	0	1	4	0	0
10	26114508	.	A	T	2	2	4	0	0	4	0	0
10	26114509	.	C	T	2	2	4	0	0	4	0	0
10	26114668	.	C	A	2	3	5	0	1	6	0	0
10	26114894	.	A	T	6	4	10	0	0	10	0	0
10	26114922	.	A	C	2	5	7	0	0	7	0	0
10	26114952	.	A	T	1	6	7	0	0	7	0	0
10	26115080	.	G	C	2	4	6	0	1	7	0	0
10	26118717	.	G	C	3	4	7	0	0	7	0	0
10	26121535	.	T	C	5	7	12	0	0	12	0	0
10	26123308	.	A	C	4	7	11	0	2	13	0	0
10	26123649	.	A	T	9	12	21	0	0	21	0	0
10	26123667	.	A	C	9	11	20	0	0	20	0	0
10	26126639	.	C	G	3	13	16	0	0	16	0	0
10	26126643	.	T	C	4	11	15	0	2	17	0	0
10	26126995	.	A	T	6	12	18	0	2	20	0	0
10	26127054	.	G	A	9	7	16	0	0	16	0	0
10	26127075	.	T	C	7	7	14	0	0	14	0	0
10	26127291	.	T	C	14	12	26	0	1	27	0	0
10	26127479	.	C	A	5	9	14	0	0	14	0	0
10	26127484	.	C	T	5	7	12	0	0	12	0	0
10	26127643	.	G	A	12	11	23	0	1	24	0	0
10	26127731	.	C	T	5	4	9	0	0	9	0	0
10	26127968	.	G	T	6	4	10	0	0	10	0	0
10	26131166	.	G	A	9	9	18	0	0	18	0	0
10	26131195	.	C	T	0	9	9	0	12	21	0	0
10	26131551	.	C	G	23	12	35	0	1	36	0	0
10	26131622	.	T	C	16	0	16	0	13	29	0	0
10	26131653	.	C	T	14	15	29	0	1	30	0	0
10	26131717	.	A	T	15	11	26	0	1	27	0	0
10	26131719	.	T	C	15	10	25	0	2	27	0	0
10	26131806	.	A	T	9	4	13	0	0	13	0	0
10	26131989	.	C	T	9	5	14	0	0	14	0	0
10	26132084	.	G	T	11	7	18	0	0	18	0	0
10	26132159	.	T	A	3	3	6	0	0	6	0	0
10	26132356	.	A	G	4	7	11	0	0	11	0	0
10	26132437	.	A	T	18	11	29	0	0	29	0	0
10	26132553	.	A	G	18	22	40	0	2	42	0	0
10	26132630	.	C	A	2	18	20	0	14	34	0	0
10	26139304	.	G	A	27	19	46	0	2	48	0	0
10	26139352	.	A	T	15	19	34	0	3	37	0	0
10	26141198	.	C	T	16	8	24	0	1	25	0	0
10	26144153	.	T	G	24	14	38	0	2	40	0	0
10	26144180	.	A	G	24	13	37	0	0	37	0	0
10	26144243	.	A	G	17	16	33	0	2	35	0	0
10	26144249	.	C	A	15	19	34	0	1	35	0	0
10	26150862	.	A	G	17	9	26	0	1	27	0	0
10	26155871	.	T	G	20	29	49	0	3	52	0	0
10	26163911	.	G	A	2	2	4	0	0	4	0	0
10	26204834	.	C	A	3	3	6	0	2	9	1	0
10	26204886	.	A	T	5	10	15	0	1	16	0	0
10	26204897	.	G	C	6	10	16	0	0	16	0	0
10	26205057	.	A	T	5	5	10	0	0	10	0	0
10	26205169	.	G	A	5	4	9	0	1	10	0	0
10	26205176	.	A	T	5	3	8	0	1	9	0	0
10	26205206	.	A	T	7	4	11	0	0	11	0	0
10	26205602	.	T	G	3	4	7	0	0	7	0	0
10	26205715	.	G	A	2	4	6	0	0	6	0	0
10	26205805	.	A	T	6	10	16	0	0	16	0	0
10	26205909	.	C	A	2	7	9	0	0	9	0	0
10	26206101	.	T	C	11	0	11	0	10	21	0	0
10	26206371	.	A	G	9	7	16	0	0	16	0	0
10	26206509	.	C	T	0	6	6	0	11	17	0	0
10	26209385	.	C	T	12	10	22	0	0	22	0	0
10	26209400	.	C	T	11	12	23	0	0	23	0	0
10	26225398	.	T	C	9	0	9	0	5	14	0	0
10	26269180	.	C	G	2	1	3	0	0	3	0	0
10	26269186	.	A	G	2	2	4	0	0	4	0	0
10	26269728	.	G	A	3	2	5	0	0	5	0	0
10	26270388	.	C	A	5	8	13	0	1	14	0	0
10	26271018	.	G	C	5	0	5	0	12	17	0	0
10	26271159	.	G	T	3	5	8	0	1	9	0	0
10	26271168	.	G	A	4	3	7	0	0	7	0	0
10	26271357	.	C	A	2	3	5	0	0	5	0	0
10	26271855	.	T	C	1	5	6	0	0	6	0	0
10	26272338	.	C	G	0	3	3	0	4	7	0	0
10	26272842	.	G	A	2	2	4	0	1	5	0	0
10	26273046	.	T	C	3	0	3	0	7	10	0	0
10	26273076	.	T	A	3	6	9	0	0	9	0	0
10	26273094	.	G	A	3	4	7	0	0	7	0	0
10	26273139	.	C	T	2	4	6	0	0	6	0	0
10	26273521	.	C	G	1	4	5	0	4	9	0	0
10	26273557	.	T	C	5	5	10	0	0	10	0	0
10	26274166	.	G	A	3	2	5	0	0	5	0	0
10	26274180	.	T	A	1	3	4	0	3	7	0	0
10	26279124	.	G	A	3	4	7	0	0	7	0	0
10	26279417	.	C	T	1	4	5	0	0	5	0	0
10	26279620	.	T	C	5	3	8	0	0	8	0	0
10	26287742	.	A	G	3	4	7	0	0	7	0	0
10	26297325	.	C	T	0	2	2	0	1	3	0	0
10	26297358	.	T	A	2	2	4	0	0	4	0	0
10	26302705	.	C	T	0	2	2	0	4	6	0	0
10	26305394	.	G	A	1	2	3	0	0	3	0	0
10	26409161	.	C	G	0	3	3	0	1	4	0	0
10	26409167	.	A	G	1	4	5	0	0	5	0	0
10	26409356	.	G	A	3	4	7	0	0	7	0	0
10	26409362	.	C	T	2	2	4	0	1	5	0	0
10	26508351	.	G	A	1	1	2	0	0	2	0	0
10	26508361	.	G	A	1	2	3	0	0	3	0	0
10	26508775	.	A	C	6	0	6	0	4	10	0	0
10	26512284	.	A	G	3	5	8	0	0	8	0	0
10	26517207	.	A	T	12	8	20	0	2	22	0	0
10	26517214	.	C	T	11	11	22	0	0	22	0	0
10	26517557	.	C	A	12	7	19	0	0	19	0	0
10	26517569	.	G	C	1	7	8	0	15	23	0	0
10	26522813	.	G	A	4	11	15	0	7	22	0	0
10	26536177	.	C	T	19	15	34	0	0	34	0	0
10	26536231	.	A	G	11	0	11	0	14	25	0	0
10	26543567	.	A	G	13	19	32	0	1	33	0	0
10	26544599	.	G	A	11	16	27	0	2	29	0	0
10	26544626	.	C	A	9	19	28	0	0	28	0	0
10	26547356	.	C	T	16	14	30	0	1	31	0	0
10	26551197	.	T	C	19	25	44	0	3	47	0	0
10	26551242	.	A	G	25	25	50	0	2	52	0	0
10	26553007	.	T	A	19	11	30	0	20	52	2	0
10	26560166	.	T	C	38	20	58	0	4	62	0	0
10	26560260	.	C	T	33	27	60	0	4	64	0	0
10	26565704	.	T	C	35	31	66	0	4	70	0	0
10	26565760	.	G	A	5	32	37	0	28	65	0	0
10	26566054	.	G	C	4	20	24	0	23	47	0	0
10	26566267	.	T	C	27	29	56	0	1	57	0	0
10	26566354	.	A	T	14	23	37	0	1	38	0	0
10	26566369	.	A	T	17	16	33	0	1	34	0	0
10	26566715	.	T	A	11	6	17	0	1	18	0	0
10	26566749	.	G	A	18	8	26	0	1	27	0	0
10	26566785	.	T	A	21	10	31	0	2	33	0	0
10	26566787	.	A	T	23	10	33	0	0	33	0	0
10	26566855	.	A	G	20	0	20	0	16	36	0	0
10	26566970	.	T	G	22	0	22	0	19	41	0	0
10	26567238	.	A	G	22	27	49	0	2	51	0	0
10	26567337	.	C	T	13	37	50	0	3	53	0	0
10	26567376	.	C	G	14	31	45	0	1	46	0	0
10	26567500	.	C	T	18	27	45	0	0	45	0	0
10	26567656	.	G	C	15	13	28	0	1	29	0	0
10	26567810	.	C	T	12	14	26	0	1	27	0	0
10	26567889	.	T	A	15	9	24	0	2	26	0	0
10	26567958	.	T	A	14	11	25	0	2	27	0	0
10	26568154	.	A	T	19	9	28	0	0	29	1	0
10	26568166	.	C	T	17	6	23	0	1	24	0	0
10	26568239	.	C	T	8	6	14	0	0	14	0	0
10	26568429	.	A	C	27	22	49	0	0	49	0	0
10	26568498	.	T	C	24	28	52	0	1	53	0	0
10	26568523	.	G	T	23	23	46	0	0	46	0	0
10	26568726	.	A	G	19	23	42	0	1	44	1	0
10	26569098	.	A	G	16	0	16	0	16	32	0	0
10	26569099	.	A	C	16	16	32	0	0	32	0	0
10	26569248	.	C	A	13	12	25	0	0	26	1	0
10	26578528	.	T	C	10	13	23	0	0	23	0	0
10	26583978	.	C	G	16	11	27	0	0	27	0	0
10	26596020	.	T	A	26	22	48	0	1	49	0	0
10	26596075	.	C	T	25	19	44	1	2	47	0	0
10	26596080	.	T	C	25	18	43	1	0	44	0	0
10	26656135	.	A	C	12	10	22	0	3	25	0	0
10	26933176	.	G	T	6	5	11	0	0	11	0	0
10	26944511	.	C	T	2	4	6	0	1	7	0	0
10	26944522	.	T	G	3	3	6	0	1	7	0	0
10	26945269	.	G	A	1	4	5	0	1	6	0	0
10	26945274	.	A	C	2	4	6	0	0	6	0	0
10	26950644	.	T	C	3	6	9	0	0	9	0	0
10	26950662	.	A	G	4	5	9	0	1	10	0	0
10	26950702	.	T	C	5	7	12	0	0	12	0	0
10	26958093	.	A	G	5	5	10	0	0	10	0	0
10	26958150	.	G	C	3	8	11	0	0	11	0	0
10	26958491	.	C	A	8	6	14	0	0	14	0	0
10	26958587	.	T	A	4	4	8	0	0	8	0	0
10	26958609	.	G	A	1	5	6	0	1	7	0	0
10	26958666	.	G	C	4	3	7	0	0	7	0	0
10	26958928	.	A	G	4	0	4	0	7	11	0	0
10	26959523	.	T	G	3	2	5	0	0	5	0	0
10	26959528	.	T	C	3	2	5	0	0	5	0	0
10	26959894	.	C	A	2	1	3	0	2	5	0	0
10	26960281	.	A	G	8	2	10	0	1	11	0	0
10	26960333	.	T	A	3	5	8	0	0	8	0	0
10	26962406	.	T	C	5	6	11	0	0	11	0	0
10	26965971	.	G	A	3	6	9	0	0	9	0	0
10	26972152	.	T	C	4	8	12	0	3	15	0	0
10	26972392	.	A	T	5	5	10	0	0	10	0	0
10	26972429	.	A	T	2	3	5	0	0	5	0	0
10	26972877	.	C	G	6	6	12	0	0	12	0	0
10	26973334	.	C	T	5	10	15	0	1	16	0	0
10	26973340	.	C	T	5	10	15	0	0	15	0	0
10	26973406	.	C	T	8	10	18	0	0	18	0	0
10	26977154	.	G	A	9	14	23	0	0	23	0	0
10	26978169	.	C	G	10	15	25	0	0	25	0	0
10	26982258	.	G	A	3	3	6	0	0	6	0	0
10	26982262	.	A	G	3	1	4	0	1	5	0	0
10	26982455	.	C	T	6	3	9	0	0	9	0	0
10	26982565	.	G	A	5	2	7	0	0	7	0	0
10	26982572	.	C	G	6	2	8	0	0	8	0	0
10	26982670	.	G	A	6	3	9	0	0	9	0	0
10	26982828	.	G	A	6	5	11	0	0	11	0	0
10	26983012	.	A	T	2	4	6	0	0	6	0	0
10	26983020	.	T	C	3	5	8	0	0	8	0	0
10	26983766	.	T	C	6	4	10	0	0	10	0	0
10	26985153	.	G	A	3	2	5	0	0	5	0	0
10	26987399	.	T	C	16	1	17	0	11	28	0	0
10	26989543	.	T	C	12	12	24	0	0	24	0	0
10	26989828	.	A	T	14	12	26	1	0	27	0	0
10	26989843	.	A	T	13	10	23	0	0	23	0	0
10	26990140	.	C	G	12	5	17	0	1	18	0	0
10	26991487	.	T	C	14	11	25	0	0	25	0	0
10	26991785	.	C	G	4	4	8	0	0	8	0	0
10	26991875	.	A	T	7	6	13	0	0	13	0	0
10	26991876	.	C	G	7	5	12	0	1	13	0	0
10	26991914	.	A	T	6	11	17	0	0	17	0	0
10	26991984	.	G	C	7	11	18	0	1	19	0	0
10	26991990	.	T	C	7	3	10	0	10	20	0	0
10	26997077	.	C	A	17	12	29	0	0	29	0	0
10	26997139	.	G	T	13	7	20	0	2	22	0	0
10	26997294	.	T	A	3	4	7	0	2	9	0	0
10	26999165	.	T	C	10	0	10	0	13	23	0	0
10	26999341	.	C	T	14	16	30	0	1	31	0	0
10	26999407	.	A	T	9	8	17	0	0	17	0	0
10	26999414	.	A	G	7	7	14	0	0	14	0	0
10	27006512	.	T	A	12	14	26	0	1	27	0	0
10	27006721	.	T	C	28	19	47	0	5	52	0	0
10	27046400	.	T	A	19	24	43	0	0	43	0	0
10	27052736	.	T	C	1	3	4	0	0	4	0	0
10	27053149	.	C	G	2	3	5	0	0	5	0	0
10	27057605	.	G	A	1	3	4	0	0	4	0	0
10	27058341	.	C	A	8	10	18	0	0	18	0	0
10	27058740	.	C	A	1	3	4	0	0	4	0	0
10	27058756	.	A	T	1	2	3	0	0	3	0	0
10	27091840	.	C	T	3	3	6	0	0	6	0	0
10	27092509	.	G	T	6	2	8	0	0	8	0	0
10	27096235	.	C	A	1	2	3	0	0	3	0	0
10	27133380	.	A	G	2	4	6	0	0	6	0	0
10	27183328	.	T	G	15	12	27	0	0	27	0	0
10	27183418	.	C	T	17	10	27	0	0	27	0	0
10	27183735	.	C	T	1	19	20	0	11	31	0	0
10	27184069	.	G	A	17	21	38	0	4	42	0	0
10	27184237	.	A	G	18	17	35	0	2	37	0	0
10	27184456	.	A	G	11	13	24	0	0	24	0	0
10	27184600	.	G	A	13	9	22	0	1	23	0	0
10	27184678	.	C	T	0	6	6	4	14	24	0	0
10	27184729	.	C	T	17	8	25	0	1	26	0	0
10	27184843	.	G	A	21	13	34	0	0	34	0	0
10	27184864	.	T	C	16	0	16	0	18	34	0	0
10	27184891	.	T	A	17	11	28	0	2	31	1	0
10	27184905	.	C	T	0	20	20	0	10	31	1	0
10	27185134	.	A	G	21	17	38	0	1	39	0	0
10	27190002	.	C	T	19	14	33	1	1	35	0	0
10	27190762	.	C	T	9	10	19	0	0	19	0	0
10	27196623	.	C	T	2	6	8	0	22	30	0	0
10	27196699	.	G	T	15	12	27	0	4	31	0	0
10	27196704	.	C	T	3	8	11	0	22	33	0	0
10	27223120	.	A	T	8	9	17	0	0	17	0	0
10	27223522	.	G	A	3	3	6	0	1	7	0	0
10	27608655	.	G	A	6	2	8	0	0	8	0	0
10	27738467	.	C	T	3	6	9	0	0	9	0	0
10	27738601	.	C	A	2	2	4	0	0	4	0	0
10	27738672	.	A	T	2	2	4	0	0	4	0	0
10	27978002	.	A	T	4	4	8	0	1	9	0	0
10	27978121	.	C	A	1	3	4	0	2	6	0	0
10	27988440	.	A	G	2	4	6	0	0	6	0	0
10	28019885	.	T	G	1	2	3	0	0	3	0	0
10	28026923	.	C	T	2	2	4	0	1	5	0	0
10	28028711	.	T	C	2	2	4	0	0	4	0	0
10	28030710	.	C	T	0	6	6	0	8	14	0	0
10	28030729	.	T	C	6	0	6	0	7	13	0	0
10	28030753	.	A	G	11	5	16	0	1	17	0	0
10	28030843	.	C	T	9	11	20	0	0	20	0	0
10	28036119	.	G	A	9	11	20	0	1	21	0	0
10	28037735	.	C	T	9	13	22	0	1	23	0	0
10	28037759	.	C	T	11	12	23	0	1	24	0	0
10	28038167	.	G	A	9	8	17	0	0	17	0	0
10	28039040	.	C	T	9	9	18	0	3	21	0	0
10	28040705	.	G	T	13	12	25	0	0	25	0	0
10	28041152	.	T	A	7	7	14	0	6	20	0	0
10	28041218	.	G	C	13	11	24	0	1	25	0	0
10	28043421	.	T	C	5	5	10	0	1	11	0	0
10	28043454	.	T	G	7	6	13	0	0	13	0	0
10	28043490	.	G	A	7	9	16	0	3	19	0	0
10	28046081	.	G	A	4	2	6	0	0	6	0	0
10	28046578	.	C	A	5	4	9	0	1	10	0	0
10	28056815	.	G	T	2	4	6	0	5	11	0	0
10	28057010	.	A	G	11	12	23	0	1	24	0	0
10	28057286	.	A	G	4	7	11	0	1	12	0	0
10	28057364	.	T	C	9	0	9	0	8	17	0	0
10	28063928	.	G	A	9	6	15	0	0	15	0	0
10	28066605	.	T	G	5	2	7	0	1	8	0	0
10	28111185	.	G	A	4	7	11	0	0	11	0	0
10	28111203	.	A	G	4	5	9	0	2	11	0	0
10	28161671	.	C	G	1	2	3	0	0	3	0	0
10	28161902	.	C	T	2	2	4	0	0	4	0	0
10	28161965	.	A	T	1	2	3	0	0	3	0	0
10	28162146	.	G	A	0	2	2	0	3	5	0	0
10	28163002	.	T	A	2	4	6	0	0	6	0	0
10	28165150	.	T	A	2	3	5	0	1	6	0	0
10	28165212	.	T	C	4	6	10	0	0	10	0	0
10	28168295	.	C	G	6	4	10	0	1	11	0	0
10	28169061	.	G	A	3	3	6	0	0	6	0	0
10	28172354	.	C	T	0	7	7	0	6	13	0	0
10	28172501	.	T	G	5	3	8	0	0	8	0	0
10	28172672	.	A	C	7	6	13	0	0	13	0	0
10	28189165	.	A	G	4	10	14	0	0	14	0	0
10	28308418	.	G	T	1	2	3	0	2	5	0	0
10	28308419	.	T	G	2	3	5	0	0	5	0	0
10	28308522	.	G	A	5	4	9	0	0	9	0	0
10	28308710	.	A	T	2	3	5	0	0	5	0	0
10	28308865	.	A	T	1	2	3	0	1	4	0	0
10	28311161	.	A	G	18	16	34	0	0	34	0	0
10	28315096	.	A	G	25	20	45	0	1	46	0	0
10	28315396	.	A	G	21	22	43	0	2	45	0	0
10	28315421	.	C	G	22	17	39	1	2	42	0	0
10	28319441	.	A	G	23	13	36	0	1	37	0	0
10	28320654	.	G	C	11	2	13	0	16	29	0	0
10	28321051	.	G	A	25	17	42	0	2	44	0	0
10	28323325	.	A	T	12	19	31	0	2	33	0	0
10	28328174	.	T	C	19	21	40	0	0	40	0	0
10	28328219	.	A	G	23	18	41	0	2	43	0	0
10	28328231	.	A	G	23	21	44	0	4	48	0	0
10	28332868	.	T	C	14	14	28	0	2	30	0	0
10	28334806	.	G	A	21	17	38	0	3	41	0	0
10	28339621	.	C	T	19	16	35	0	1	36	0	0
10	28349266	.	G	A	18	17	35	0	1	36	0	0
10	28350055	.	G	A	14	11	25	0	2	27	0	0
10	28350959	.	T	A	14	9	23	0	1	24	0	0
10	28351616	.	C	T	18	21	39	0	1	40	0	0
10	28355728	.	A	G	24	19	43	0	0	43	0	0
10	28371198	.	G	A	12	7	19	0	0	19	0	0
10	28371284	.	G	A	12	14	26	0	0	26	0	0
10	28371407	.	C	T	0	18	18	0	14	32	0	0
10	28376814	.	T	C	8	0	8	0	16	24	0	0
10	28376895	.	C	T	11	11	22	0	0	22	0	0
10	28470322	.	A	G	4	3	7	0	0	7	0	0
10	28477749	.	G	A	2	4	6	0	0	6	0	0
10	28483319	.	C	T	6	5	11	0	0	11	0	0
10	28483440	.	G	T	6	6	12	0	0	12	0	0
10	28483585	.	T	C	6	4	10	0	0	10	0	0
10	28483631	.	C	T	2	4	6	0	5	11	0	0
10	28483673	.	C	T	5	2	7	0	0	7	0	0
10	28587609	.	G	C	3	4	7	0	0	7	0	0
10	28587703	.	C	T	5	3	8	0	0	8	0	0
10	28589859	.	C	T	2	8	10	0	0	10	0	0
10	28672479	.	T	C	4	3	7	0	0	7	0	0
10	28672488	.	G	A	6	4	10	0	1	11	0	0
10	28690910	.	G	A	0	9	9	1	9	19	0	0
10	28690959	.	A	T	8	8	16	0	1	17	0	0
10	28691007	.	C	T	6	8	14	0	0	14	0	0
10	28691024	.	C	T	10	5	15	0	1	16	0	0
10	28695869	.	T	A	7	5	12	0	7	19	0	0
10	28723769	.	A	T	12	5	17	1	0	18	0	0
10	28723805	.	G	A	0	9	9	1	5	15	0	0
10	28724220	.	G	A	11	5	16	0	0	16	0	0
10	28730249	.	C	T	10	4	14	0	1	15	0	0
10	28730437	.	G	T	11	6	17	0	0	17	0	0
10	28730446	.	A	C	5	11	16	0	0	16	0	0
10	28730503	.	G	A	7	6	13	0	0	13	0	0
10	28730738	.	C	T	6	5	11	0	0	11	0	0
10	28730800	.	A	T	5	0	5	0	1	8	2	0
10	28730869	.	C	T	5	6	11	0	1	12	0	0
10	28730880	.	T	A	8	8	16	0	0	16	0	0
10	28730913	.	G	A	11	13	24	0	1	25	0	0
10	28731001	.	C	T	16	11	27	0	0	27	0	0
10	28731072	.	C	T	9	11	20	0	0	20	0	0
10	28731155	.	A	T	8	5	13	0	3	16	0	0
10	28731289	.	T	C	13	6	19	0	0	19	0	0
10	28731372	.	G	A	1	10	11	0	6	17	0	0
10	28732003	.	C	A	12	14	26	0	1	27	0	0
10	28732366	.	A	G	10	14	24	0	1	25	0	0
10	28732601	.	C	T	0	13	13	0	15	28	0	0
10	28732785	.	T	C	15	15	30	0	1	31	0	0
10	28733067	.	G	T	18	16	34	0	1	35	0	0
10	28733132	.	T	A	13	24	37	0	1	38	0	0
10	28737345	.	C	T	17	11	28	1	1	31	1	0
10	28743800	.	T	A	18	12	30	0	0	30	0	0
10	28745583	.	G	A	17	8	25	0	2	27	0	0
10	28748996	.	G	A	10	12	22	0	1	23	0	0
10	28835566	.	C	A	8	6	14	0	0	14	0	0
10	28835635	.	C	G	13	6	19	0	1	20	0	0
10	28835655	.	G	A	11	9	20	0	1	21	0	0
10	28835701	.	A	T	11	10	21	0	1	22	0	0
10	29166502	.	A	G	10	10	20	0	0	20	0	0
10	29185863	.	T	A	25	14	39	0	1	40	0	0
10	29187908	.	C	T	17	15	32	1	2	35	0	0
10	29201671	.	C	T	8	7	15	1	1	17	0	0
10	29205655	.	A	T	17	15	32	0	1	33	0	0
10	29223795	.	T	C	2	3	5	0	0	5	0	0
10	29224484	.	G	A	12	17	29	0	3	32	0	0
10	29224598	.	A	T	21	17	38	0	0	38	0	0
10	29224651	.	C	A	20	8	28	0	1	29	0	0
10	29225032	.	A	G	9	0	9	0	9	18	0	0
10	29265596	.	A	G	24	0	24	0	18	42	0	0
10	29265599	.	T	A	26	15	41	0	1	42	0	0
10	29266279	.	C	A	20	20	40	0	1	41	0	0
10	29266376	.	C	T	15	22	37	0	2	39	0	0
10	29270225	.	C	T	2	3	5	0	0	5	0	0
10	29271915	.	C	T	10	8	18	0	1	19	0	0
10	29572857	.	C	T	12	10	22	0	0	22	0	0
10	29578478	.	C	T	16	15	31	0	0	31	0	0
10	29578756	.	G	T	15	11	26	0	0	26	0	0
10	29661332	.	G	A	14	16	30	0	2	32	0	0
10	29661410	.	C	T	11	9	20	0	0	20	0	0
10	29661419	.	C	G	11	0	11	0	10	21	0	0
10	29678256	.	A	G	15	0	15	0	19	34	0	0
10	29678313	.	G	A	9	12	21	0	1	22	0	0
10	29736736	.	T	C	10	0	10	0	10	20	0	0
10	29736746	.	C	T	1	12	13	0	8	21	0	0
10	29736895	.	T	A	6	9	15	0	0	15	0	0
10	29738555	.	C	T	6	7	13	0	0	13	0	0
10	29742625	.	C	T	0	13	13	0	9	22	0	0
10	29742656	.	C	T	12	10	22	0	1	23	0	0
10	29742795	.	T	C	13	13	26	0	1	27	0	0
10	29751328	.	G	A	10	11	21	0	1	22	0	0
10	29751407	.	T	C	7	4	11	0	1	12	0	0
10	29761405	.	C	T	12	9	21	0	0	21	0	0
10	29761761	.	A	T	7	5	12	0	0	12	0	0
10	29761767	.	G	A	5	5	10	0	2	12	0	0
10	29762935	.	G	A	8	12	20	0	3	23	0	0
10	29762947	.	G	A	10	14	24	0	1	25	0	0
10	29763146	.	A	G	10	10	20	0	1	21	0	0
10	29766072	.	C	G	8	9	17	0	0	17	0	0
10	29766841	.	C	T	7	3	10	0	1	11	0	0
10	29768405	.	G	T	8	10	18	0	0	18	0	0
10	29770277	.	C	T	5	9	14	0	0	14	0	0
10	29770329	.	G	T	2	2	4	0	0	4	0	0
10	29770388	.	G	C	3	2	5	0	0	5	0	0
10	29778433	.	T	C	5	7	12	0	0	12	0	0
10	29782137	.	G	A	10	7	17	1	0	18	0	0
10	29782273	.	A	G	6	0	6	0	11	17	0	0
10	29788229	.	G	T	6	11	17	1	0	18	0	0
10	29815697	.	A	C	3	0	3	0	6	9	0	0
10	29815802	.	A	G	24	14	38	0	0	38	0	0
10	29816113	.	T	C	24	22	46	0	0	46	0	0
10	29816290	.	T	A	23	36	59	0	0	59	0	0
10	29816439	.	A	T	12	23	35	0	4	39	0	0
10	29816904	.	C	T	27	34	61	0	6	68	1	0
10	29817111	.	C	T	35	37	72	0	1	73	0	0
10	29817207	.	C	T	35	31	66	0	0	66	0	0
10	29817416	.	A	T	25	19	44	0	0	44	0	0
10	29820414	.	G	C	5	3	8	0	0	8	0	0
10	29820495	.	G	A	3	3	6	0	0	6	0	0
10	29823484	.	G	A	10	10	20	0	1	21	0	0
10	29824248	.	C	T	15	5	20	0	0	20	0	0
10	29824262	.	C	T	14	4	18	0	1	19	0	0
10	29831556	.	G	A	5	3	8	0	0	8	0	0
10	29851722	.	C	T	36	31	67	0	5	72	0	0
10	29852317	.	G	A	42	33	75	0	3	78	0	0
10	29852476	.	A	G	43	6	49	0	34	83	0	0
10	29852485	.	A	G	41	4	45	0	33	78	0	0
10	29860419	.	T	C	2	2	4	0	0	4	0	0
10	29892283	.	C	T	0	2	2	0	1	3	0	0
10	29892478	.	C	T	3	2	5	0	0	5	0	0
10	29963638	.	G	A	3	6	9	0	0	9	0	0
10	30576004	.	T	C	13	12	25	0	1	26	0	0
10	30576061	.	G	A	7	14	21	0	1	22	0	0
10	30618313	.	T	A	9	8	17	0	2	19	0	0
10	30618429	.	A	T	15	16	31	0	0	31	0	0
10	30623408	.	G	A	13	12	25	0	0	25	0	0
10	30624615	.	C	T	2	10	12	0	6	18	0	0
10	30691387	.	T	A	8	3	11	0	0	11	0	0
10	31020810	.	A	G	6	8	14	0	1	15	0	0
10	31021505	.	T	C	10	11	21	0	1	22	0	0
10	31021550	.	G	A	7	13	20	0	0	20	0	0
10	31021553	.	G	A	12	7	19	0	2	21	0	0
10	31021611	.	C	T	11	11	22	0	1	23	0	0
10	31021676	.	G	A	13	7	20	0	1	21	0	0
10	31023520	.	A	G	14	17	31	0	1	32	0	0
10	31032043	.	T	C	11	7	18	0	1	19	0	0
10	31034999	.	C	T	0	14	14	0	6	20	0	0
10	31035129	.	C	T	15	7	22	0	1	23	0	0
10	31035147	.	C	T	15	14	29	0	1	30	0	0
10	31040834	.	G	A	7	7	14	1	0	15	0	0
10	31066888	.	C	T	0	9	9	1	9	19	0	0
10	31562922	.	T	G	1	7	8	0	1	9	0	0
10	31563045	.	T	A	1	2	3	0	0	3	0	0
10	31624750	.	G	A	5	2	7	0	1	8	0	0
10	31628397	.	C	T	4	5	9	0	0	9	0	0
10	31628406	.	C	T	4	5	9	0	0	9	0	0
10	31628481	.	T	C	9	4	13	0	0	13	0	0
10	31632313	.	G	C	5	3	8	0	0	8	0	0
10	31632643	.	C	T	6	2	8	0	0	8	0	0
10	31632691	.	G	A	4	7	11	0	0	11	0	0
10	31632758	.	A	T	3	6	9	0	0	9	0	0
10	31632829	.	A	G	6	6	12	0	0	12	0	0
10	31633077	.	A	C	6	7	13	0	1	14	0	0
10	31633640	.	G	A	6	3	9	0	1	10	0	0
10	31633669	.	C	T	4	5	9	0	0	9	0	0
10	31725404	.	C	T	3	5	8	0	0	8	0	0
10	31725697	.	C	T	8	3	11	0	0	11	0	0
10	31725736	.	T	C	5	4	9	0	0	9	0	0
10	31725879	.	A	C	0	4	4	0	4	8	0	0
10	31726330	.	C	T	1	2	3	0	0	3	0	0
10	31738616	.	A	G	11	4	15	0	1	16	0	0
10	31738752	.	T	A	9	4	13	0	1	14	0	0
10	31739181	.	G	T	29	26	55	0	1	56	0	0
10	31739346	.	G	T	30	33	63	0	4	67	0	0
10	31751941	.	C	T	34	30	64	0	0	64	0	0
10	31757307	.	C	T	29	29	58	0	0	58	0	0
10	31772041	.	G	A	27	21	48	0	7	55	0	0
10	31782605	.	C	T	20	19	39	0	1	40	0	0
10	31800313	.	A	G	11	14	25	0	0	25	0	0
10	32037794	.	T	A	5	4	9	0	0	9	0	0
10	32062738	.	C	T	3	3	6	0	0	6	0	0
10	32062978	.	C	T	1	3	4	0	0	4	0	0
10	32063752	.	G	A	7	4	11	0	0	11	0	0
10	32064222	.	A	T	3	4	7	0	0	7	0	0
10	32069657	.	G	A	0	6	6	0	3	9	0	0
10	32071029	.	G	A	7	6	13	0	1	14	0	0
10	32122840	.	T	A	3	3	6	0	0	6	0	0
10	32265193	.	T	A	4	3	7	0	0	7	0	0
10	32265199	.	G	A	4	3	7	0	0	7	0	0
10	32383514	.	G	A	7	5	12	1	0	13	0	0
10	32398296	.	T	A	3	3	6	0	0	6	0	0
10	32413438	.	T	C	2	7	9	0	0	9	0	0
10	32413463	.	C	T	3	8	11	0	0	11	0	0
10	32413484	.	T	C	3	0	3	0	9	12	0	0
10	32463473	.	A	G	3	5	8	0	0	8	0	0
10	32494030	.	C	T	0	4	4	0	4	8	0	0
10	32494136	.	A	G	2	3	5	0	1	6	0	0
10	32561338	.	G	A	4	10	14	0	1	15	0	0
10	32561427	.	A	C	9	14	23	0	1	24	0	0
10	32561437	.	T	A	10	12	22	0	0	22	0	0
10	32561564	.	A	C	10	12	22	0	0	22	0	0
10	32561575	.	C	T	10	12	22	0	0	22	0	0
10	32561817	.	G	A	1	9	10	0	10	21	1	0
10	32561820	.	G	T	11	7	18	0	1	19	0	0
10	32562267	.	C	T	16	12	28	0	0	28	0	0
10	32577486	.	G	A	17	11	28	1	0	29	0	0
10	32577489	.	A	G	15	12	27	1	1	29	0	0
10	32577522	.	C	T	14	10	24	0	3	27	0	0
10	32577549	.	T	C	16	13	29	0	1	30	0	0
10	32577621	.	G	A	14	12	26	0	0	26	0	0
10	32857382	.	T	C	16	0	16	2	8	26	0	0
10	32857386	.	C	T	6	19	25	2	0	27	0	0
10	32857419	.	T	C	14	0	14	0	13	27	0	0
10	32858132	.	T	C	11	0	11	1	14	26	0	0
10	32939486	.	A	G	1	7	8	0	0	8	0	0
10	34565402	.	G	A	6	5	11	0	0	11	0	0
10	34572353	.	T	C	8	4	12	0	1	13	0	0
10	34580604	.	G	A	5	8	13	0	1	14	0	0
10	34580622	.	C	T	9	8	17	0	1	18	0	0
10	34588881	.	C	T	9	19	28	0	0	28	0	0
10	34651069	.	A	G	15	0	15	0	6	21	0	0
10	34661821	.	T	C	17	7	24	0	0	24	0	0
10	34661857	.	A	G	12	7	19	0	1	20	0	0
10	34662013	.	T	C	8	7	15	0	1	16	0	0
10	34662024	.	T	G	9	9	18	0	0	18	0	0
10	34662349	.	C	T	4	12	16	0	0	16	0	0
10	34662437	.	C	T	11	8	19	0	1	20	0	0
10	34662481	.	A	T	12	13	25	0	0	25	0	0
10	34664906	.	G	A	8	16	24	1	0	25	0	0
10	34673597	.	C	T	18	12	30	0	3	33	0	0
10	34676094	.	A	G	13	0	13	0	15	28	0	0
10	34676266	.	G	T	18	13	31	0	1	32	0	0
10	34677539	.	T	C	11	10	21	0	2	23	0	0
10	34677569	.	C	T	9	10	19	0	3	22	0	0
10	34677673	.	T	C	8	17	25	0	0	25	0	0
10	34699238	.	C	T	16	11	27	0	1	28	0	0
10	34701434	.	A	C	12	18	30	0	1	31	0	0
10	34703802	.	A	G	7	0	7	0	15	22	0	0
10	34707546	.	A	T	11	15	26	0	1	27	0	0
10	34709708	.	G	C	20	8	28	0	1	29	0	0
10	34709940	.	C	T	12	15	27	0	0	27	0	0
10	34724906	.	C	T	22	13	35	0	0	35	0	0
10	34729552	.	G	A	23	15	38	0	2	40	0	0
10	34729693	.	C	T	19	17	36	0	0	36	0	0
10	34733566	.	A	G	32	14	46	0	1	47	0	0
10	34733578	.	A	G	34	4	38	0	14	52	0	0
10	34733661	.	C	T	17	19	36	0	5	41	0	0
10	34733883	.	A	T	16	19	35	0	3	38	0	0
10	34734568	.	G	T	0	17	17	0	16	33	0	0
10	34734590	.	A	G	18	19	37	0	1	38	0	0
10	34734785	.	G	T	15	15	30	5	2	37	0	0
10	34737686	.	A	G	19	18	37	0	2	39	0	0
10	34738125	.	T	C	25	24	49	0	2	51	0	0
10	34741649	.	T	A	25	27	52	0	1	53	0	0
10	34743910	.	G	A	23	19	42	0	2	44	0	0
10	34754660	.	C	T	24	21	45	0	1	46	0	0
10	34756936	.	A	C	17	16	33	0	5	39	1	0
10	34772168	.	A	G	17	10	27	0	0	27	0	0
10	34813299	.	T	C	15	4	19	0	1	20	0	0
10	34867259	.	T	C	9	0	9	0	11	20	0	0
10	34867466	.	C	T	16	11	27	0	2	29	0	0
10	34958760	.	A	T	15	15	30	0	0	31	1	0
10	34961149	.	C	A	13	16	29	0	1	30	0	0
10	34976620	.	G	C	3	2	5	0	0	5	0	0
10	34984836	.	A	G	10	16	26	0	0	26	0	0
10	34984923	.	T	C	9	12	21	0	4	25	0	0
10	34984931	.	C	A	1	14	15	0	13	28	0	0
10	34989149	.	T	C	11	0	11	0	5	16	0	0
10	34998281	.	G	C	11	13	24	0	0	24	0	0
10	35002400	.	C	A	7	9	16	0	1	17	0	0
10	35006358	.	T	C	6	7	13	0	0	13	0	0
10	35006504	.	C	A	7	7	14	0	0	14	0	0
10	35008963	.	C	T	3	8	11	0	1	12	0	0
10	35011325	.	C	T	7	5	12	0	0	12	0	0
10	35011337	.	A	G	5	9	14	0	0	14	0	0
10	35011482	.	G	A	1	2	3	0	2	5	0	0
10	35012184	.	C	T	1	6	7	0	9	16	0	0
10	35029172	.	G	A	4	11	15	0	0	15	0	0
10	35032814	.	T	C	8	5	13	0	0	13	0	0
10	35033900	.	G	A	4	5	9	0	0	9	0	0
10	35035754	.	G	A	3	5	8	0	0	8	0	0
10	35035757	.	T	G	5	3	8	0	0	8	0	0
10	35046093	.	C	T	5	4	9	0	0	9	0	0
10	35059868	.	G	A	2	2	4	0	0	4	0	0
10	35059880	.	G	C	2	2	4	0	0	4	0	0
10	35103155	.	A	G	5	10	15	0	0	15	0	0
10	35220214	.	C	T	2	3	5	0	0	5	0	0
10	35220292	.	A	G	3	3	6	0	0	6	0	0
10	35236801	.	T	G	2	3	5	0	0	5	0	0
10	35236909	.	C	T	0	2	2	0	1	3	0	0
10	35241646	.	A	T	7	10	17	0	0	17	0	0
10	35242113	.	C	G	7	7	14	0	0	14	0	0
10	35245939	.	T	A	9	6	15	0	0	15	0	0
10	35245951	.	C	T	10	5	15	0	0	15	0	0
10	35247905	.	G	A	4	2	6	0	1	7	0	0
10	35247980	.	G	C	3	0	3	0	4	7	0	0
10	35248433	.	G	A	7	5	12	0	0	12	0	0
10	35265206	.	T	A	4	4	8	0	0	8	0	0
10	35265234	.	C	T	2	3	5	0	0	5	0	0
10	35266720	.	G	A	0	3	3	0	7	10	0	0
10	35267852	.	A	G	1	2	3	0	0	3	0	0
10	35281335	.	C	T	5	8	13	0	1	14	0	0
10	35281388	.	T	C	2	7	9	0	0	9	0	0
10	35292112	.	G	A	0	14	14	0	3	17	0	0
10	35298732	.	A	G	10	10	20	0	0	20	0	0
10	35300764	.	C	T	11	10	21	0	0	21	0	0
10	35302425	.	T	C	15	12	27	0	1	28	0	0
10	35304002	.	G	A	14	10	24	0	1	25	0	0
10	35307579	.	C	T	20	11	31	0	1	32	0	0
10	35312021	.	A	C	15	14	29	0	4	33	0	0
10	35312143	.	A	G	7	0	7	0	6	13	0	0
10	35314868	.	G	T	1	2	3	0	0	3	0	0
10	35523120	.	G	A	3	2	5	0	1	6	0	0
10	35538879	.	T	A	18	11	29	0	0	29	0	0
10	35539607	.	A	G	17	22	39	0	1	40	0	0
10	35539631	.	G	A	20	16	36	0	1	37	0	0
10	35540422	.	T	A	22	19	41	0	4	45	0	0
10	35540603	.	C	T	18	20	38	0	5	43	0	0
10	35540675	.	T	G	20	17	37	0	0	37	0	0
10	35540705	.	T	A	23	16	39	0	3	42	0	0
10	35540732	.	T	G	20	18	38	0	2	40	0	0
10	35540847	.	T	G	12	15	27	0	0	27	0	0
10	35541245	.	T	C	12	8	20	0	0	20	0	0
10	35541290	.	A	G	13	15	28	0	0	28	0	0
10	35541735	.	C	T	4	6	10	0	1	11	0	0
10	35541760	.	C	T	2	5	7	0	3	10	0	0
10	35554345	.	G	T	0	3	3	0	5	8	0	0
10	35560733	.	A	G	3	4	7	0	0	7	0	0
10	35573836	.	C	T	4	5	9	0	0	9	0	0
10	35579500	.	C	A	6	5	11	0	0	11	0	0
10	35579598	.	T	C	4	2	6	0	1	7	0	0
10	35579756	.	C	T	1	5	6	0	0	6	0	0
10	35579781	.	C	G	2	2	4	0	0	4	0	0
10	35579883	.	C	G	5	6	11	0	0	11	0	0
10	35579985	.	C	T	5	2	7	0	1	8	0	0
10	35580002	.	A	C	5	2	7	0	0	7	0	0
10	35584806	.	T	G	13	11	24	0	2	26	0	0
10	35584815	.	A	G	12	10	22	0	0	22	0	0
10	35584855	.	T	A	5	7	12	0	1	13	0	0
10	35585057	.	A	T	4	6	10	0	0	10	0	0
10	35585195	.	G	A	3	7	10	0	2	12	0	0
10	35585197	.	A	G	6	5	11	0	1	12	0	0
10	35585257	.	C	T	11	5	16	0	2	18	0	0
10	35585284	.	C	T	2	4	6	0	9	15	0	0
10	35592817	.	A	G	2	4	6	0	1	7	0	0
10	35592830	.	G	A	2	5	7	0	2	9	0	0
10	35595335	.	C	T	9	6	15	0	0	15	0	0
10	35595669	.	T	A	4	10	14	0	0	14	0	0
10	35602535	.	G	T	2	5	7	0	0	7	0	0
10	35602678	.	G	A	3	4	7	0	0	7	0	0
10	35602756	.	T	C	3	7	10	0	0	10	0	0
10	35603212	.	A	G	5	3	8	0	0	8	0	0
10	35607283	.	T	A	8	5	13	0	0	13	0	0
10	35609468	.	T	C	4	3	7	0	1	8	0	0
10	35609501	.	T	C	4	0	4	0	5	9	0	0
10	35609808	.	G	A	3	3	6	0	0	6	0	0
10	35611227	.	G	T	4	5	9	0	1	10	0	0
10	35611367	.	G	A	6	3	9	0	0	9	0	0
10	35611436	.	C	T	7	3	10	0	0	10	0	0
10	35611843	.	C	A	2	2	4	0	0	4	0	0
10	35654268	.	C	T	6	8	14	0	0	14	0	0
10	35664426	.	A	G	3	3	6	0	0	6	0	0
10	35664481	.	C	T	4	2	6	0	0	6	0	0
10	35664495	.	C	T	3	2	5	0	1	6	0	0
10	35664527	.	T	C	5	4	9	0	0	9	0	0
10	36443018	.	T	C	12	13	25	0	0	25	0	0
10	36443541	.	T	C	14	17	31	0	2	33	0	0
10	36443676	.	G	A	1	14	15	0	11	26	0	0
10	36443714	.	G	A	4	16	20	0	2	22	0	0
10	36443818	.	T	G	7	0	7	0	15	22	0	0
10	36451615	.	T	C	27	16	43	0	1	44	0	0
10	36451661	.	G	A	28	19	47	0	0	47	0	0
10	36454567	.	C	A	17	17	34	0	0	34	0	0
10	36454649	.	A	G	19	0	19	0	23	42	0	0
10	36454650	.	C	A	20	17	37	0	5	42	0	0
10	36454902	.	G	T	26	12	38	0	1	39	0	0
10	36455146	.	C	T	23	13	36	0	0	36	0	0
10	36455215	.	T	C	14	15	29	0	0	29	0	0
10	36455229	.	C	G	13	14	27	0	2	29	0	0
10	36455344	.	A	G	17	18	35	0	0	35	0	0
10	36455847	.	G	A	0	6	6	0	5	11	0	0
10	36476481	.	C	T	1	18	19	0	12	31	0	0
10	36476529	.	C	T	10	14	24	0	0	24	0	0
10	36476639	.	C	T	1	11	12	0	14	26	0	0
10	36476717	.	A	G	11	13	24	0	5	29	0	0
10	36476834	.	G	A	20	15	35	0	0	35	0	0
10	36476852	.	A	G	16	14	30	0	0	30	0	0
10	36476922	.	C	T	14	15	29	0	0	29	0	0
10	36481915	.	A	C	7	16	23	0	1	24	0	0
10	36482588	.	G	A	8	14	22	0	0	22	0	0
10	36487530	.	G	A	9	15	24	0	0	24	0	0
10	36489882	.	A	G	10	8	18	0	0	18	0	0
10	36489893	.	A	G	9	10	19	0	1	20	0	0
10	36494336	.	G	A	5	7	12	0	0	12	0	0
10	36495580	.	T	G	6	9	15	0	0	15	0	0
10	36496544	.	A	G	10	10	20	0	0	21	1	0
10	36496595	.	G	A	8	7	15	0	0	15	0	0
10	36498246	.	G	A	12	5	17	0	0	17	0	0
10	36498379	.	C	T	0	5	5	0	14	19	0	0
10	36498397	.	G	A	8	7	15	0	0	15	0	0
10	36500581	.	C	T	3	4	7	0	2	9	0	0
10	36500674	.	G	A	10	6	16	0	0	16	0	0
10	36504163	.	C	T	0	2	2	0	7	9	0	0
10	36506103	.	G	A	4	7	11	0	0	11	0	0
10	36506630	.	T	A	6	4	10	0	0	10	0	0
10	36518643	.	C	T	5	7	12	0	0	12	0	0
10	36519788	.	T	C	5	8	13	0	1	14	0	0
10	36520003	.	C	T	0	6	6	0	5	11	0	0
10	36520024	.	C	A	6	5	11	0	0	11	0	0
10	36520711	.	G	A	5	10	15	0	0	15	0	0
10	36520945	.	A	G	4	7	11	0	2	13	0	0
10	36522602	.	A	C	5	0	5	0	3	8	0	0
10	36522713	.	A	C	3	0	3	0	3	6	0	0
10	36523826	.	G	A	5	7	12	0	1	13	0	0
10	36528549	.	A	G	5	6	11	0	0	11	0	0
10	36558839	.	A	G	14	15	29	0	1	30	0	0
10	36558895	.	G	A	17	14	31	0	0	31	0	0
10	36570469	.	A	G	20	17	37	0	3	40	0	0
10	36572622	.	G	A	14	19	33	0	1	34	0	0
10	36572640	.	C	A	0	14	14	0	22	36	0	0
10	36572814	.	A	T	14	12	26	0	0	26	0	0
10	36575980	.	G	A	7	12	19	0	1	20	0	0
10	36575992	.	C	T	13	9	22	0	0	22	0	0
10	36584462	.	T	C	7	9	16	0	1	17	0	0
10	36613095	.	T	C	14	4	18	0	0	18	0	0
10	36613145	.	G	T	7	10	17	0	2	19	0	0
10	36613164	.	C	T	1	11	12	0	5	17	0	0
10	36613276	.	C	T	12	11	23	0	0	23	0	0
10	36615367	.	G	A	6	11	17	0	0	17	0	0
10	36615907	.	C	A	12	5	17	0	2	19	0	0
10	36618435	.	C	T	0	9	9	0	15	24	0	0
10	36618787	.	C	T	15	16	31	0	0	31	0	0
10	36625258	.	C	A	0	6	6	0	15	21	0	0
10	36625534	.	G	A	7	11	18	0	1	19	0	0
10	36625602	.	C	G	12	9	21	0	0	21	0	0
10	36625761	.	T	A	8	11	19	0	2	21	0	0
10	36626201	.	C	T	10	4	14	0	2	16	0	0
10	36627009	.	G	C	6	6	12	0	0	12	0	0
10	36627209	.	A	G	3	7	10	0	2	12	0	0
10	36627210	.	C	T	0	8	8	0	4	12	0	0
10	36627314	.	C	T	9	4	13	1	0	14	0	0
10	36627327	.	T	C	8	3	11	1	0	12	0	0
10	36627390	.	A	G	9	7	16	0	0	16	0	0
10	36627414	.	C	A	7	6	13	0	1	14	0	0
10	36627517	.	C	T	6	8	14	1	3	18	0	0
10	36627571	.	C	A	8	6	14	1	0	15	0	0
10	36627820	.	C	T	6	4	10	0	3	13	0	0
10	36628009	.	C	A	5	3	8	0	0	8	0	0
10	36628012	.	G	A	5	3	8	0	0	8	0	0
10	36628569	.	C	T	0	9	9	0	5	14	0	0
10	36628626	.	G	A	4	7	11	0	1	12	0	0
10	36628804	.	G	T	5	5	10	0	0	10	0	0
10	36662718	.	A	G	1	3	4	0	0	4	0	0
10	36665829	.	C	T	2	2	4	0	0	4	0	0
10	36670106	.	T	C	5	3	8	0	0	8	0	0
10	36673237	.	G	T	3	4	7	0	0	7	0	0
10	36679379	.	T	A	3	3	6	0	0	6	0	0
10	36679800	.	G	A	1	2	3	0	0	3	0	0
10	36688455	.	C	T	10	3	13	0	1	14	0	0
10	36689850	.	G	T	5	11	16	0	0	16	0	0
10	36689893	.	A	G	11	7	18	0	0	18	0	0
10	36691372	.	C	A	2	12	14	0	11	25	0	0
10	36695781	.	G	C	15	17	32	0	0	32	0	0
10	36695785	.	C	T	14	15	29	0	1	30	0	0
10	36704842	.	A	G	13	18	31	4	0	35	0	0
10	36706217	.	T	A	18	21	39	0	1	40	0	0
10	36708401	.	A	G	16	0	16	0	28	44	0	0
10	36708453	.	C	T	17	18	35	0	0	35	0	0
10	36710559	.	A	C	13	15	28	0	4	32	0	0
10	36710599	.	C	T	18	16	34	0	0	34	0	0
10	36710871	.	G	A	1	23	24	0	15	39	0	0
10	36710893	.	G	T	2	14	16	0	18	34	0	0
10	36711260	.	T	A	2	4	6	0	0	6	0	0
10	36711329	.	T	A	7	14	21	0	0	21	0	0
10	36711613	.	C	T	9	8	17	0	0	17	0	0
10	36752664	.	G	T	1	1	2	0	2	4	0	0
10	36768070	.	C	T	1	3	4	0	0	4	0	0
10	36774144	.	G	A	1	2	3	0	0	3	0	0
10	36774379	.	T	A	6	3	9	0	2	11	0	0
10	36778293	.	C	T	7	4	11	0	0	11	0	0
10	36778302	.	C	A	8	3	11	0	0	11	0	0
10	36796083	.	A	G	2	2	4	0	0	4	0	0
10	36800465	.	G	A	7	11	18	0	0	18	0	0
10	36800518	.	C	T	5	12	17	0	1	18	0	0
10	36800600	.	G	A	7	9	16	0	0	16	0	0
10	36800642	.	A	G	8	8	16	0	2	18	0	0
10	36807986	.	G	A	6	11	17	0	1	18	0	0
10	36808032	.	G	A	8	9	17	0	1	18	0	0
10	36811815	.	A	G	5	6	11	0	1	12	0	0
10	36812214	.	A	C	13	11	24	0	1	25	0	0
10	36814912	.	G	A	7	11	18	0	1	19	0	0
10	36815330	.	T	C	7	1	8	0	5	13	0	0
10	36817197	.	A	C	6	4	10	0	0	10	0	0
10	36817355	.	C	T	1	7	8	0	6	14	0	0
10	36817530	.	C	T	10	8	18	0	0	18	0	0
10	36817940	.	T	C	8	10	18	0	0	18	0	0
10	36817979	.	T	G	6	11	17	0	0	17	0	0
10	36819664	.	G	T	9	8	17	0	1	18	0	0
10	36819671	.	C	T	11	7	18	0	0	18	0	0
10	36820601	.	C	T	3	7	10	0	9	19	0	0
10	36820611	.	A	G	12	5	17	0	2	19	0	0
10	36820664	.	C	T	13	4	17	0	0	17	0	0
10	36820688	.	C	G	2	8	10	0	10	20	0	0
10	36820736	.	G	A	6	13	19	0	1	20	0	0
10	36820769	.	T	A	8	14	22	0	2	24	0	0
10	36820892	.	G	A	6	7	13	0	1	14	0	0
10	36825650	.	C	T	1	5	6	0	2	8	0	0
10	36825818	.	T	C	3	7	10	0	1	11	0	0
10	36825880	.	G	A	6	7	13	0	0	13	0	0
10	36828227	.	T	C	4	7	11	0	0	11	0	0
10	36828295	.	G	T	7	4	11	0	0	11	0	0
10	36828469	.	T	C	6	0	6	1	6	13	0	0
10	36828475	.	C	T	6	8	14	1	1	16	0	0
10	36835641	.	A	T	3	4	7	0	1	8	0	0
10	36835740	.	G	A	8	8	16	0	0	16	0	0
10	36838768	.	C	T	9	3	12	0	0	12	0	0
10	36841230	.	G	T	6	8	14	0	1	15	0	0
10	36843114	.	C	G	9	8	17	0	0	17	0	0
10	36848872	.	G	A	6	5	11	0	2	13	0	0
10	36848938	.	A	G	12	6	18	0	1	19	0	0
10	36850674	.	C	T	1	5	6	0	9	15	0	0
10	36850752	.	A	G	11	5	16	0	0	16	0	0
10	36852643	.	G	A	4	4	8	0	0	8	0	0
10	36867407	.	T	C	3	6	9	0	1	10	0	0
10	36876162	.	A	C	6	0	6	0	5	11	0	0
10	36878340	.	G	T	5	5	10	0	0	10	0	0
10	36878362	.	C	A	4	6	10	0	1	11	0	0
10	36878568	.	C	T	9	7	16	0	0	16	0	0
10	36878638	.	T	C	10	0	10	0	11	21	0	0
10	36927345	.	A	T	2	5	7	0	0	7	0	0
10	36927349	.	C	T	0	6	6	0	2	8	0	0
10	36950935	.	A	T	5	3	8	0	0	8	0	0
10	36951044	.	A	T	3	10	13	0	0	13	0	0
10	36951076	.	G	C	3	9	12	0	0	12	0	0
10	36951223	.	A	C	3	8	11	0	0	11	0	0
10	36951378	.	A	G	3	4	7	0	0	7	0	0
10	36951582	.	C	G	10	7	17	0	0	17	0	0
10	36951660	.	T	A	4	11	15	1	2	18	0	0
10	36963158	.	T	A	9	2	11	0	0	11	0	0
10	36963456	.	G	A	4	4	8	0	2	10	0	0
10	36967206	.	T	C	18	12	30	0	2	32	0	0
10	36969510	.	T	C	8	7	15	0	1	16	0	0
10	36969519	.	A	G	10	4	14	0	2	16	0	0
10	36974901	.	G	A	7	11	18	0	1	19	0	0
10	36976271	.	C	T	1	9	10	0	6	16	0	0
10	36976318	.	G	A	9	6	15	0	0	15	0	0
10	36987831	.	T	G	8	6	14	0	0	14	0	0
10	36999951	.	A	G	8	5	13	0	0	13	0	0
10	37007508	.	G	C	6	11	17	0	0	17	0	0
10	37011570	.	G	T	5	6	11	0	1	12	0	0
10	37014392	.	C	T	5	3	8	0	2	10	0	0
10	37016252	.	T	G	5	3	8	0	0	8	0	0
10	37016308	.	G	A	6	3	9	0	0	9	0	0
10	37022463	.	G	A	9	8	17	0	0	17	0	0
10	37024367	.	T	C	2	0	2	0	3	5	0	0
10	37028670	.	A	G	7	8	15	0	0	15	0	0
10	37070050	.	T	C	3	4	7	0	0	7	0	0
10	37070412	.	T	C	3	3	6	0	1	7	0	0
10	37070656	.	A	T	6	3	9	0	0	9	0	0
10	37126295	.	C	T	3	8	11	0	0	11	0	0
10	37126307	.	C	T	4	7	11	0	0	11	0	0
10	37137549	.	G	A	1	5	6	0	21	27	0	0
10	37145178	.	G	A	15	11	26	0	0	26	0	0
10	37152081	.	G	A	23	19	42	0	0	42	0	0
10	37152105	.	A	G	25	4	29	0	19	48	0	0
10	37163252	.	C	A	15	17	32	0	2	34	0	0
10	37167151	.	G	C	7	6	13	0	0	13	0	0
10	37227524	.	C	T	14	14	28	0	0	28	0	0
10	37234093	.	A	G	3	0	3	0	12	15	0	0
10	37236672	.	T	G	8	0	8	0	9	17	0	0
10	37236857	.	A	G	9	0	9	0	5	14	0	0
10	37239229	.	G	A	11	12	23	0	1	24	0	0
10	37252054	.	G	A	1	8	9	0	6	15	0	0
10	37253986	.	A	G	9	10	19	0	4	23	0	0
10	37296515	.	G	A	0	2	2	0	3	5	0	0
10	37296561	.	G	A	0	5	5	0	3	8	0	0
10	37304334	.	T	C	2	2	4	0	0	4	0	0
10	37309892	.	G	A	5	5	10	0	0	10	0	0
10	37312110	.	C	T	1	3	4	0	0	4	0	0
10	37334291	.	G	T	6	7	13	0	0	13	0	0
10	37360284	.	C	T	2	4	6	0	1	7	0	0
10	37360308	.	G	A	2	6	8	0	0	8	0	0
10	37360344	.	G	A	0	5	5	0	3	8	0	0
10	37361681	.	G	A	0	6	6	0	9	15	0	0
10	37367451	.	T	C	5	7	12	0	0	12	0	0
10	37367481	.	C	T	7	3	10	0	1	11	0	0
10	37373858	.	C	T	2	6	8	0	0	8	0	0
10	37373873	.	G	A	0	5	5	0	5	10	0	0
10	37378252	.	A	T	2	9	11	0	0	11	0	0
10	37380414	.	C	T	4	5	9	0	0	9	0	0
10	37380660	.	C	T	6	2	8	0	0	8	0	0
10	37384943	.	G	A	1	4	5	0	1	6	0	0
10	37385317	.	T	C	3	2	5	0	0	5	0	0
10	37389654	.	G	A	1	4	5	0	4	9	0	0
10	37394478	.	G	A	5	9	14	0	0	14	0	0
10	37394486	.	G	A	4	6	10	0	3	13	0	0
10	37394535	.	C	T	6	5	11	0	1	12	0	0
10	37394809	.	A	G	2	2	4	0	1	5	0	0
10	37764473	.	C	T	15	9	24	0	1	25	0	0
10	37779765	.	A	C	12	8	20	0	1	21	0	0
10	37779778	.	T	A	12	8	20	0	0	20	0	0
10	37783114	.	A	G	15	11	26	0	0	26	0	0
10	37783179	.	A	G	16	0	16	0	14	30	0	0
10	37783323	.	A	G	14	6	20	0	1	21	0	0
10	37783575	.	C	A	3	3	6	0	0	6	0	0
10	37783669	.	C	A	7	3	10	0	0	10	0	0
10	37992653	.	C	T	4	5	9	0	0	9	0	0
10	37992839	.	A	T	8	3	11	0	1	12	0	0
10	37994630	.	C	T	11	3	14	0	0	14	0	0
10	37997567	.	C	G	4	3	7	0	0	7	0	0
10	38000082	.	C	G	7	5	12	0	0	12	0	0
10	38000084	.	G	T	0	7	7	0	5	12	0	0
10	38003011	.	A	G	16	6	22	0	0	22	0	0
10	38006849	.	G	C	0	2	2	0	1	3	0	0
10	38006855	.	G	A	0	2	2	0	1	3	0	0
10	38040372	.	A	G	11	6	17	0	0	17	0	0
10	38040378	.	A	G	6	10	16	0	2	18	0	0
10	38074570	.	G	T	6	5	11	1	3	15	0	0
10	38149713	.	C	A	0	4	4	0	3	7	0	0
10	38149715	.	A	G	3	4	7	0	0	7	0	0
10	38170737	.	G	A	11	3	14	0	0	14	0	0
10	38171149	.	G	C	7	1	8	0	4	12	0	0
10	38171196	.	G	A	8	5	13	0	1	14	0	0
10	38171207	.	C	A	5	12	17	0	1	18	0	0
10	38171356	.	A	T	9	13	22	0	0	22	0	0
10	38171490	.	T	A	12	6	18	0	0	18	0	0
10	38173383	.	C	A	2	11	13	0	19	32	0	0
10	38177999	.	C	T	0	9	9	0	15	24	0	0
10	38178357	.	G	A	7	15	22	0	0	22	0	0
10	38180732	.	A	T	12	8	20	0	0	20	0	0
10	38189023	.	T	C	1	0	1	0	4	5	0	0
10	38199097	.	G	A	3	8	11	0	0	11	0	0
10	38199169	.	T	C	9	5	14	0	0	14	0	0
10	38201513	.	G	A	7	8	15	0	0	15	0	0
10	38205149	.	T	C	7	0	7	0	11	18	0	0
10	38211810	.	C	G	6	13	19	0	0	19	0	0
10	38218990	.	C	T	1	3	4	0	2	6	0	0
10	38231165	.	C	T	0	6	6	0	8	14	0	0
10	38235957	.	G	C	5	6	11	0	0	11	0	0
10	38243543	.	G	A	8	8	16	0	0	16	0	0
10	38257295	.	G	A	4	6	10	0	3	13	0	0
10	38257509	.	C	G	1	5	6	0	6	12	0	0
10	38257558	.	C	T	5	6	11	0	0	11	0	0
10	38257870	.	T	C	14	12	26	0	0	26	0	0
10	38258729	.	C	G	14	15	29	0	1	30	0	0
10	38259033	.	C	T	5	10	15	0	1	16	0	0
10	38259034	.	A	G	5	10	15	0	1	16	0	0
10	38259204	.	G	A	7	5	12	0	1	13	0	0
10	38259217	.	A	G	7	4	11	0	1	12	0	0
10	38259268	.	G	C	6	9	15	4	0	19	0	0
10	38259276	.	A	G	8	7	15	4	2	21	0	0
10	38259339	.	A	T	5	5	10	1	0	11	0	0
10	38259449	.	A	C	8	0	8	0	6	14	0	0
10	38259451	.	A	G	8	6	14	0	0	14	0	0
10	38259900	.	T	C	10	0	10	0	9	19	0	0
10	38260002	.	G	A	8	5	13	0	1	14	0	0
10	38260210	.	T	A	16	12	28	0	0	28	0	0
10	38260626	.	A	T	15	10	25	0	3	28	0	0
10	38261085	.	T	G	3	7	10	0	0	10	0	0
10	38261453	.	G	A	6	10	16	0	0	16	0	0
10	38261485	.	C	T	9	7	16	0	2	18	0	0
10	38261495	.	T	G	9	8	17	0	1	18	0	0
10	38261638	.	G	A	4	2	6	0	1	7	0	0
10	38261696	.	C	T	3	6	9	0	1	10	0	0
10	38665994	.	C	T	19	22	41	0	1	42	0	0
10	38666063	.	T	C	22	13	35	0	0	35	0	0
10	38686126	.	T	C	19	14	33	0	3	36	0	0
10	38695152	.	A	C	33	15	48	0	2	50	0	0
10	38695656	.	A	G	11	9	20	0	0	20	0	0
10	38695877	.	C	T	8	11	19	0	0	19	0	0
10	38695888	.	C	T	6	10	16	0	0	16	0	0
10	38712403	.	A	G	1	0	1	0	4	5	0	0
10	38712431	.	C	T	1	2	3	0	0	3	0	0
10	38712508	.	C	T	1	3	4	0	0	4	0	0
10	38723443	.	T	G	1	0	1	0	2	3	0	0
10	38723452	.	G	A	0	2	2	0	2	4	0	0
10	38726441	.	C	T	2	2	4	0	0	4	0	0
10	38775780	.	C	G	10	4	14	0	1	15	0	0
10	38885821	.	T	C	5	6	11	0	2	13	0	0
10	38891454	.	C	A	11	5	16	0	0	16	0	0
10	38922043	.	G	A	2	11	13	0	7	20	0	0
10	38924557	.	C	T	11	13	24	0	1	25	0	0
10	38924560	.	T	C	10	15	25	0	1	26	0	0
10	38934391	.	A	G	10	8	18	0	0	18	0	0
10	38940232	.	A	G	8	6	14	0	2	16	0	0
10	38943265	.	C	G	12	12	24	0	2	26	0	0
10	38950115	.	T	C	9	9	18	0	0	18	0	0
10	38950430	.	G	A	0	9	9	0	19	28	0	0
10	38950484	.	A	G	14	13	27	0	3	30	0	0
10	38950538	.	T	C	18	14	32	0	2	34	0	0
10	38954126	.	C	T	15	16	31	0	3	34	0	0
10	38954141	.	T	C	16	13	29	0	2	31	0	0
10	38954798	.	T	C	19	7	26	0	0	26	0	0
10	38954801	.	C	T	17	9	26	0	2	28	0	0
10	38957061	.	T	C	21	12	33	0	1	34	0	0
10	38957127	.	G	A	2	13	15	0	21	36	0	0
10	38957193	.	C	T	20	16	36	0	0	36	0	0
10	38957748	.	A	C	19	13	32	0	0	32	0	0
10	38957754	.	A	C	17	13	30	0	1	31	0	0
10	38969552	.	A	C	29	12	41	0	1	42	0	0
10	38969598	.	A	C	28	18	46	0	1	47	0	0
10	38969629	.	C	T	25	21	46	0	1	47	0	0
10	38969685	.	A	G	27	20	47	0	2	49	0	0
10	38969778	.	C	T	24	16	40	0	0	40	0	0
10	39011484	.	C	T	21	11	32	0	1	33	0	0
10	39086981	.	G	A	24	32	56	0	0	56	0	0
10	39087391	.	A	G	29	0	29	1	30	60	0	0
10	39087625	.	T	A	23	30	53	0	0	53	0	0
10	39087659	.	T	A	22	20	42	0	0	42	0	0
10	39091684	.	C	A	8	4	12	0	0	12	0	0
10	39091792	.	A	G	5	0	5	0	12	17	0	0
10	39102672	.	G	C	4	9	13	0	0	13	0	0
10	39102776	.	T	C	6	5	11	0	1	12	0	0
10	39110452	.	G	C	7	5	12	0	0	12	0	0
10	39115595	.	G	T	2	7	9	0	1	10	0	0
10	39115596	.	T	C	3	7	10	0	0	10	0	0
10	39120132	.	T	C	5	12	17	0	0	17	0	0
10	39130460	.	C	T	38	34	72	0	4	76	0	0
10	39140465	.	A	G	6	7	13	0	0	13	0	0
10	39140741	.	T	C	9	6	15	0	0	15	0	0
10	39152038	.	A	G	4	2	6	0	0	6	0	0
10	39153470	.	G	A	5	5	10	0	0	10	0	0
10	39153494	.	A	G	8	5	13	0	0	13	0	0
10	39153599	.	T	A	7	6	13	0	0	13	0	0
10	39153805	.	T	C	2	3	5	0	0	5	0	0
10	39170798	.	A	C	3	5	8	0	0	8	0	0
10	39175139	.	T	C	3	11	14	0	0	14	0	0
10	39175418	.	T	C	4	3	7	0	0	7	0	0
10	39175452	.	C	T	4	5	9	0	0	9	0	0
10	39175475	.	G	A	1	4	5	0	4	9	0	0
10	39177751	.	C	A	2	3	5	0	0	5	0	0
10	39177816	.	T	C	2	4	6	0	0	6	0	0
10	39179439	.	G	A	2	5	7	0	0	7	0	0
10	39179525	.	G	A	6	3	9	0	0	9	0	0
10	39179565	.	C	T	5	5	10	0	0	10	0	0
10	39179918	.	G	A	3	1	4	0	0	4	0	0
10	39179925	.	T	A	4	2	6	0	0	6	0	0
10	39179992	.	G	C	7	5	12	0	0	12	0	0
10	39180864	.	C	T	2	2	4	2	1	7	0	0
10	39180884	.	A	G	3	1	4	0	3	7	0	0
10	39180912	.	T	C	5	4	9	0	1	10	0	0
10	39181040	.	G	T	7	3	10	0	0	10	0	0
10	39181257	.	T	A	3	3	6	1	1	8	0	0
10	39181274	.	C	T	3	2	5	1	0	6	0	0
10	39181417	.	G	T	8	6	14	0	0	14	0	0
10	39181424	.	T	C	8	6	14	0	1	15	0	0
10	39182173	.	A	G	7	12	19	0	1	20	0	0
10	39182310	.	C	A	8	6	14	0	0	14	0	0
10	39182342	.	A	T	7	7	14	0	0	14	0	0
10	39182401	.	C	A	6	10	16	0	1	17	0	0
10	39182497	.	C	T	7	6	13	0	1	14	0	0
10	39182602	.	G	A	1	6	7	0	4	11	0	0
10	39182640	.	T	A	3	4	7	0	1	8	0	0
10	39182703	.	T	G	1	0	1	0	4	5	0	0
10	39182877	.	G	A	1	3	4	0	1	5	0	0
10	39199639	.	G	A	1	7	8	0	9	17	0	0
10	39205021	.	C	T	7	5	12	0	0	12	0	0
10	39205256	.	C	G	8	9	17	0	0	17	0	0
10	39207104	.	C	A	5	3	8	0	0	8	0	0
10	39207114	.	C	A	6	2	8	0	0	8	0	0
10	39207397	.	T	A	2	3	5	0	0	5	0	0
10	39212932	.	G	A	4	3	7	0	1	8	0	0
10	39216625	.	C	T	9	10	19	0	0	19	0	0
10	39219390	.	T	C	12	12	24	0	1	25	0	0
10	39219540	.	T	A	20	11	31	0	2	33	0	0
10	39222134	.	A	C	19	18	37	0	0	37	0	0
10	39222182	.	A	G	20	14	34	0	0	34	0	0
10	39225504	.	A	C	14	15	29	0	0	29	0	0
10	39225555	.	T	C	21	12	33	0	4	37	0	0
10	39231387	.	G	A	23	21	44	0	3	47	0	0
10	39253861	.	G	T	1	2	3	0	0	3	0	0
10	39253879	.	T	G	2	2	4	0	0	4	0	0
10	39265717	.	C	T	2	4	6	0	1	7	0	0
10	39265733	.	C	T	3	3	6	0	0	6	0	0
10	39265766	.	G	A	3	2	5	0	0	5	0	0
10	39265954	.	G	A	2	5	7	0	0	7	0	0
10	39266422	.	C	T	3	6	9	0	0	9	0	0
10	39266669	.	A	C	3	3	6	0	0	6	0	0
10	39266702	.	A	G	5	0	5	0	4	9	0	0
10	39266862	.	T	C	1	3	4	0	0	4	0	0
10	39277087	.	C	G	2	2	4	0	1	5	0	0
10	39284032	.	A	G	3	3	6	0	1	7	0	0
10	39284092	.	T	G	5	0	5	0	5	10	0	0
10	39284104	.	C	G	2	0	2	0	4	6	0	0
10	39285246	.	A	G	3	4	7	0	0	7	0	0
10	39285288	.	T	C	2	5	7	0	0	7	0	0
10	39286967	.	C	T	3	5	8	0	1	9	0	0
10	39287100	.	C	T	3	4	7	0	1	8	0	0
10	39289006	.	A	G	3	0	3	1	6	10	0	0
10	39289036	.	A	C	3	6	9	0	0	9	0	0
10	39292583	.	A	C	2	3	5	0	0	5	0	0
10	39293335	.	T	C	6	6	12	0	0	12	0	0
10	39293358	.	G	A	6	4	10	0	0	10	0	0
10	39294248	.	T	G	4	3	7	0	0	7	0	0
10	39294258	.	G	A	4	2	6	0	0	6	0	0
10	39294285	.	A	G	1	2	3	0	0	3	0	0
10	39306817	.	T	C	1	4	5	0	0	5	0	0
10	39476639	.	A	G	4	5	9	0	0	9	0	0
10	39904774	.	G	A	2	6	8	0	7	15	0	0
10	39904780	.	C	T	7	5	12	0	0	12	0	0
10	39904851	.	A	T	5	3	8	0	0	8	0	0
10	39904915	.	A	G	9	12	21	0	0	21	0	0
10	39904966	.	T	C	5	3	8	0	1	9	0	0
10	39905085	.	A	T	3	5	8	0	1	9	0	0
10	39905089	.	T	G	3	6	9	0	0	9	0	0
10	39953483	.	T	A	6	3	9	0	0	9	0	0
10	39953575	.	A	G	4	1	5	0	0	5	0	0
10	39953581	.	C	T	4	2	6	0	0	6	0	0
10	39953689	.	T	C	7	4	11	0	1	12	0	0
10	40086093	.	A	G	3	3	6	0	0	6	0	0
10	40086099	.	G	A	4	3	7	0	0	7	0	0
10	40089829	.	C	A	7	6	13	0	0	13	0	0
10	40089838	.	C	T	7	5	12	0	0	12	0	0
10	40089941	.	T	C	10	4	14	0	0	14	0	0
10	40109378	.	C	T	6	8	14	0	1	15	0	0
10	40109439	.	G	A	1	4	5	0	15	20	0	0
10	40110115	.	A	C	5	3	8	0	0	8	0	0
10	40110226	.	T	C	4	2	6	0	0	6	0	0
10	40110243	.	A	T	3	3	6	0	0	6	0	0
10	40110397	.	A	G	5	5	10	0	0	10	0	0
10	40110599	.	G	A	0	2	2	0	4	6	0	0
10	40110616	.	G	T	5	3	8	0	0	8	0	0
10	40110666	.	T	A	2	4	6	0	0	6	0	0
10	40110768	.	A	G	2	4	6	0	0	6	0	0
10	40110853	.	A	T	7	1	8	0	0	8	0	0
10	40111610	.	C	T	7	5	12	0	0	12	0	0
10	40111666	.	G	C	5	5	10	0	1	11	0	0
10	40111706	.	A	G	3	8	11	0	0	11	0	0
10	40111732	.	C	T	2	9	11	0	1	12	0	0
10	40111904	.	G	T	1	4	5	0	0	5	0	0
10	40112096	.	C	A	8	4	12	0	0	12	0	0
10	40112121	.	A	G	8	6	14	0	0	14	0	0
10	40112157	.	G	A	9	4	13	0	0	13	0	0
10	40112159	.	T	A	8	5	13	0	0	13	0	0
10	40112347	.	A	T	8	4	12	0	0	12	0	0
10	40112476	.	T	A	4	6	10	0	1	11	0	0
10	40112638	.	C	T	6	3	9	0	0	9	0	0
10	40112708	.	A	G	2	3	5	0	1	6	0	0
10	40112769	.	T	G	3	3	6	0	0	6	0	0
10	40112802	.	T	G	2	2	4	0	1	5	0	0
10	40112834	.	G	A	6	3	9	0	1	10	0	0
10	40113113	.	C	G	3	3	6	0	2	8	0	0
10	40113161	.	C	A	2	6	8	0	3	11	0	0
10	40113197	.	G	A	0	9	9	0	9	18	0	0
10	40113408	.	A	G	11	7	18	0	0	18	0	0
10	40113446	.	T	C	9	4	13	0	0	13	0	0
10	40113508	.	A	T	3	2	5	0	1	6	0	0
10	40236068	.	A	G	11	0	11	1	24	36	0	0
10	40262052	.	T	C	10	5	15	0	0	15	0	0
10	40262338	.	T	C	9	3	12	0	0	12	0	0
10	40262347	.	A	G	8	0	8	0	4	12	0	0
10	40266160	.	A	G	7	5	12	0	1	13	0	0
10	40274411	.	G	A	5	10	15	0	0	15	0	0
10	40274541	.	G	A	1	15	16	0	11	27	0	0
10	40274626	.	C	T	5	6	11	0	2	13	0	0
10	40275158	.	G	A	0	3	3	0	5	8	0	0
10	40275225	.	G	A	4	2	6	0	0	6	0	0
10	40290969	.	G	A	3	2	5	0	2	7	0	0
10	40296645	.	T	C	6	5	11	0	1	12	0	0
10	40296841	.	G	A	1	6	7	0	6	13	0	0
10	40296896	.	C	T	4	9	13	0	0	13	0	0
10	40303924	.	G	C	4	10	14	0	0	14	0	0
10	40303980	.	A	G	4	2	6	0	0	6	0	0
10	40307622	.	C	T	4	4	8	0	0	8	0	0
10	40311286	.	G	T	0	6	6	0	6	12	0	0
10	40314175	.	A	C	12	10	22	0	1	23	0	0
10	40314177	.	A	C	11	11	22	0	1	23	0	0
10	40314296	.	C	A	3	2	5	0	0	5	0	0
10	40314350	.	A	G	1	7	8	0	0	8	0	0
10	40314361	.	A	C	3	6	9	0	0	9	0	0
10	40314405	.	G	A	3	1	4	0	0	4	0	0
10	40314407	.	G	T	6	1	7	0	0	7	0	0
10	40316791	.	G	T	0	2	2	0	2	4	0	0
10	40317095	.	G	T	6	8	14	0	2	16	0	0
10	40317190	.	T	G	8	2	10	0	0	10	0	0
10	40317192	.	G	T	8	2	10	0	0	10	0	0
10	40317285	.	A	T	4	8	12	0	0	12	0	0
10	40317323	.	A	G	1	0	1	0	4	5	0	0
10	40317341	.	A	G	1	3	4	0	0	4	0	0
10	40822252	.	C	T	0	11	11	0	8	19	0	0
10	40825192	.	T	C	19	15	34	0	0	34	0	0
10	40826436	.	A	G	10	8	18	0	0	18	0	0
10	40826494	.	A	G	10	12	22	0	0	22	0	0
10	40826516	.	A	G	14	13	27	0	0	27	0	0
10	40826589	.	C	T	24	10	34	0	1	35	0	0
10	40826590	.	A	G	23	10	33	0	1	34	0	0
10	40859336	.	T	A	1	3	4	0	0	4	0	0
10	40859338	.	A	G	1	3	4	0	0	4	0	0
10	40859503	.	G	A	2	5	7	0	0	7	0	0
10	40859512	.	C	T	1	3	4	0	0	4	0	0
10	40859601	.	T	C	4	0	4	0	6	10	0	0
10	40859633	.	C	T	3	2	5	0	0	5	0	0
10	40859647	.	A	C	4	3	7	0	0	7	0	0
10	40859722	.	A	G	8	3	11	0	0	11	0	0
10	40859885	.	A	G	6	5	11	0	0	11	0	0
10	40859968	.	T	C	8	6	14	0	2	16	0	0
10	40861563	.	C	A	7	6	13	0	0	13	0	0
10	40861650	.	G	A	4	8	12	0	1	13	0	0
10	40861701	.	G	T	2	8	10	0	0	10	0	0
10	40866244	.	T	C	4	0	4	0	7	11	0	0
10	40872771	.	G	A	1	2	3	0	0	3	0	0
10	40872816	.	A	G	2	4	6	0	0	6	0	0
10	40877124	.	A	G	1	4	5	0	0	5	0	0
10	41608269	.	T	A	1	11	12	1	0	13	0	0
10	41837425	.	G	C	12	12	24	0	1	25	0	0
10	41837486	.	T	C	10	12	22	0	1	23	0	0
10	41837528	.	A	G	5	8	13	0	0	13	0	0
10	41841119	.	G	A	16	12	28	1	2	31	0	0
10	41841209	.	C	G	12	9	21	0	1	22	0	0
10	41843743	.	C	A	2	6	8	0	3	11	0	0
10	41846770	.	A	G	4	12	16	0	0	16	0	0
10	41865722	.	G	A	4	11	15	0	0	15	0	0
10	41879500	.	A	G	6	5	11	0	0	11	0	0
10	41879509	.	T	A	5	3	8	0	1	9	0	0
10	41894792	.	T	C	4	3	7	0	0	7	0	0
10	41902817	.	A	G	5	2	7	0	0	7	0	0
10	41914189	.	C	G	4	5	9	0	1	10	0	0
10	41920720	.	A	G	3	2	5	0	0	5	0	0
10	41920994	.	A	G	4	2	6	0	0	6	0	0
10	41939700	.	A	G	2	2	4	0	0	4	0	0
10	41951235	.	C	T	3	6	9	0	0	9	0	0
10	41951272	.	G	A	0	3	3	0	2	5	0	0
10	41954644	.	T	A	2	3	5	0	0	5	0	0
10	41959280	.	A	G	3	4	7	0	1	8	0	0
10	41959325	.	C	A	3	3	6	0	0	6	0	0
10	41959597	.	T	C	1	3	4	0	1	5	0	0
10	41959919	.	T	C	3	2	5	0	1	6	0	0
10	41983482	.	A	C	6	8	14	0	0	14	0	0
10	41983494	.	T	C	4	0	4	0	11	15	0	0
10	41983798	.	A	C	4	3	7	0	0	7	0	0
10	41983800	.	T	G	4	3	7	0	0	7	0	0
10	41983961	.	C	A	1	4	5	0	0	5	0	0
10	41984251	.	G	A	3	3	6	0	0	6	0	0
10	41985911	.	G	A	6	3	9	0	1	10	0	0
10	41995252	.	C	T	3	4	7	0	0	7	0	0
10	41995506	.	G	C	4	4	8	0	1	9	0	0
10	41995555	.	C	T	4	7	11	0	0	11	0	0
10	41995573	.	C	T	3	6	9	0	0	9	0	0
10	41995624	.	A	G	4	4	8	0	0	8	0	0
10	41995644	.	A	T	2	5	7	0	0	7	0	0
10	41995678	.	A	G	3	5	8	0	0	8	0	0
10	41996150	.	G	C	3	3	6	0	1	7	0	0
10	41996153	.	A	G	3	0	3	0	4	7	0	0
10	42002429	.	G	A	2	3	5	0	6	11	0	0
10	42002903	.	C	T	4	3	7	0	1	8	0	0
10	42006930	.	C	A	6	4	10	0	1	11	0	0
10	42006943	.	A	G	6	3	9	0	0	9	0	0
10	42007836	.	G	T	7	3	10	0	0	10	0	0
10	42010719	.	A	T	3	3	6	0	0	6	0	0
10	42010915	.	C	G	5	2	7	0	1	8	0	0
10	42011197	.	G	A	0	3	3	0	6	9	0	0
10	42011245	.	C	T	7	6	13	0	0	13	0	0
10	42011293	.	G	A	9	4	13	0	0	13	0	0
10	42019966	.	A	C	6	5	11	0	0	11	0	0
10	42020285	.	G	A	5	8	13	0	0	13	0	0
10	42020422	.	C	T	2	8	10	0	1	11	0	0
10	42020565	.	C	T	10	12	22	0	0	22	0	0
10	42020684	.	A	G	8	1	9	0	14	23	0	0
10	42021194	.	A	G	1	3	4	0	2	6	0	0
10	42021611	.	C	A	13	4	17	0	0	17	0	0
10	42022014	.	C	G	7	10	17	0	1	18	0	0
10	42030956	.	C	T	6	7	13	0	1	14	0	0
10	42031279	.	C	T	1	2	3	0	7	10	0	0
10	42044337	.	C	T	6	6	12	0	0	12	0	0
10	42044409	.	A	G	11	16	27	1	1	29	0	0
10	42044497	.	A	G	13	12	25	0	0	25	0	0
10	42044745	.	T	G	7	4	11	0	0	11	0	0
10	42044746	.	C	T	7	4	11	0	0	11	0	0
10	42044809	.	T	A	14	15	29	0	1	30	0	0
10	42044859	.	G	A	15	7	22	0	1	23	0	0
10	42045041	.	G	C	12	14	26	0	0	26	0	0
10	42045076	.	A	T	10	4	14	0	0	14	0	0
10	42045370	.	G	A	5	5	10	0	1	11	0	0
10	42045534	.	A	T	3	2	5	0	1	6	0	0
10	42046689	.	A	C	2	1	3	0	1	4	0	0
10	42047224	.	T	C	3	3	6	0	0	6	0	0
10	42047246	.	A	G	4	2	6	0	0	6	0	0
10	42047389	.	C	T	0	3	3	0	5	8	0	0
10	42048557	.	G	A	4	2	6	0	0	6	0	0
10	42056780	.	C	T	1	3	4	0	1	5	0	0
10	42060157	.	G	A	5	3	8	0	0	8	0	0
10	42089403	.	C	T	0	3	3	0	2	5	0	0
10	42089421	.	A	T	2	3	5	0	0	5	0	0
10	42089968	.	T	A	1	2	3	0	1	4	0	0
10	42104361	.	T	G	4	7	11	0	0	11	0	0
10	42104371	.	C	T	0	6	6	0	3	9	0	0
10	42105921	.	C	T	10	5	15	0	0	15	0	0
10	42111610	.	A	T	8	4	12	0	0	12	0	0
10	42111669	.	C	A	7	11	18	0	1	19	0	0
10	42111673	.	G	A	8	11	19	0	0	19	0	0
10	42111895	.	G	A	3	2	5	0	0	5	0	0
10	42112062	.	T	A	5	3	8	0	1	9	0	0
10	42112075	.	T	C	5	0	5	0	5	10	0	0
10	42112227	.	G	T	6	10	16	0	0	16	0	0
10	42114366	.	G	A	7	8	15	0	0	15	0	0
10	42119810	.	C	T	4	5	9	0	0	9	0	0
10	42128886	.	A	G	7	10	17	1	0	18	0	0
10	42128898	.	C	T	6	8	14	1	0	15	0	0
10	42134893	.	G	A	0	2	2	0	1	3	0	0
10	42134931	.	A	G	2	2	4	0	0	4	0	0
10	42135153	.	A	G	6	3	9	0	0	9	0	0
10	42135472	.	A	G	5	7	12	0	0	12	0	0
10	42135505	.	G	A	4	5	9	0	0	9	0	0
10	42135986	.	T	C	2	0	2	0	2	4	0	0
10	42136570	.	A	G	3	3	6	0	1	7	0	0
10	42136576	.	G	A	4	3	7	0	0	7	0	0
10	42137050	.	G	C	4	4	8	0	0	8	0	0
10	42137847	.	G	T	2	2	4	0	0	4	0	0
10	42138380	.	T	C	5	0	5	0	6	11	0	0
10	42140224	.	A	T	5	8	13	0	0	13	0	0
10	42141528	.	A	G	3	5	8	0	0	8	0	0
10	42196374	.	C	T	0	1	1	0	8	9	0	0
10	42196404	.	T	C	5	0	5	0	5	10	0	0
10	42196524	.	A	G	5	5	10	0	0	10	0	0
10	42199981	.	C	T	5	4	9	0	0	9	0	0
10	42237263	.	C	T	1	5	6	0	4	10	0	0
10	42378334	.	A	T	35	31	66	0	2	68	0	0
10	42462955	.	C	A	1	2	3	0	0	3	0	0
10	42462976	.	T	A	1	2	3	0	1	4	0	0
10	42463564	.	G	A	0	3	3	0	3	6	0	0
10	42463797	.	T	G	2	4	6	0	0	6	0	0
10	42463805	.	T	C	2	4	6	0	0	6	0	0
10	42501067	.	A	G	8	4	12	0	0	12	0	0
10	42501175	.	T	A	7	6	13	0	0	13	0	0
10	42501365	.	A	G	13	18	31	0	2	33	0	0
10	42505845	.	T	C	11	13	24	0	3	27	0	0
10	42507081	.	T	C	2	10	12	0	1	13	0	0
10	42507120	.	T	C	4	9	13	0	1	14	0	0
10	42507141	.	A	G	6	11	17	0	0	17	0	0
10	42519641	.	C	T	7	17	24	0	0	24	0	0
10	42522016	.	T	C	17	11	28	0	1	29	0	0
10	42526213	.	C	T	19	18	37	0	2	39	0	0
10	42531713	.	C	T	21	25	46	0	1	47	0	0
10	42539630	.	C	T	34	35	69	0	2	71	0	0
10	42539849	.	C	T	20	29	49	0	2	51	0	0
10	42539955	.	T	C	16	18	34	0	0	34	0	0
10	42540132	.	A	T	18	15	33	0	1	34	0	0
10	42540172	.	A	C	13	18	31	0	1	32	0	0
10	42540726	.	A	G	6	3	9	0	0	9	0	0
10	42542568	.	A	C	5	5	10	0	0	10	0	0
10	42542660	.	A	C	5	2	7	0	0	7	0	0
10	42548171	.	T	G	6	0	6	0	11	17	0	0
10	42548210	.	A	T	3	6	9	0	1	10	0	0
10	42548213	.	A	G	4	0	4	0	6	10	0	0
10	42550828	.	C	T	8	4	12	0	0	12	0	0
10	42555543	.	G	A	0	3	3	0	2	5	0	0
10	42555728	.	G	A	0	2	2	0	4	6	0	0
10	42555732	.	G	T	4	2	6	0	0	6	0	0
10	42631045	.	T	C	1	2	3	0	0	3	0	0
10	42636352	.	T	C	6	4	10	0	1	11	0	0
10	42636382	.	C	T	1	3	4	0	0	4	0	0
10	42652166	.	A	G	3	2	5	0	0	5	0	0
10	42652463	.	C	T	4	2	6	0	0	6	0	0
10	42656885	.	A	G	1	4	5	0	0	6	1	0
10	42659358	.	C	T	3	2	5	0	0	5	0	0
10	42691349	.	T	C	7	9	16	0	1	17	0	0
10	42694471	.	A	G	8	0	8	0	16	24	0	0
10	42694477	.	T	C	10	13	23	0	2	25	0	0
10	42694552	.	C	A	15	8	23	0	1	24	0	0
10	42694573	.	A	G	13	0	13	0	10	23	0	0
10	42700932	.	C	T	14	8	22	0	1	23	0	0
10	42701006	.	C	T	10	11	21	0	2	23	0	0
10	42701027	.	C	G	13	14	27	0	0	27	0	0
10	42701051	.	T	C	14	14	28	0	0	28	0	0
10	42701129	.	A	G	10	0	10	0	17	27	0	0
10	42701216	.	C	T	4	13	17	0	0	17	0	0
10	42701317	.	A	G	8	0	8	0	10	18	0	0
10	42704661	.	G	T	5	18	23	0	1	24	0	0
10	42704671	.	G	A	5	11	16	0	5	21	0	0
10	42704848	.	T	C	8	9	17	0	2	19	0	0
10	42704988	.	T	C	8	8	16	0	0	16	0	0
10	42708084	.	A	G	3	10	13	1	0	14	0	0
10	42715679	.	C	T	31	14	45	1	5	51	0	0
10	42715688	.	T	C	35	7	42	1	6	50	1	0
10	42715853	.	C	T	26	18	44	0	0	44	0	0
10	42733678	.	A	G	4	8	12	0	1	13	0	0
10	42738094	.	A	G	5	5	10	0	1	11	0	0
10	42738095	.	C	T	6	5	11	0	0	11	0	0
10	42738176	.	T	C	8	6	14	0	0	14	0	0
10	42738343	.	A	G	4	3	7	0	0	7	0	0
10	42738344	.	A	G	5	2	7	0	0	7	0	0
10	42738400	.	A	G	6	4	10	0	0	10	0	0
10	42738626	.	T	A	3	9	12	0	0	12	0	0
10	42738671	.	C	T	2	7	9	0	1	10	0	0
10	42739589	.	G	A	10	11	21	0	0	21	0	0
10	42739593	.	T	C	11	11	22	0	0	22	0	0
10	42739709	.	T	A	6	0	6	0	11	17	0	0
10	42739995	.	T	A	9	3	12	1	0	13	0	0
10	42740002	.	G	A	9	2	11	1	0	12	0	0
10	42740111	.	G	A	1	9	10	0	7	17	0	0
10	42741417	.	T	A	27	15	42	0	2	44	0	0
10	42741469	.	T	A	24	19	43	0	0	43	0	0
10	42741519	.	G	T	32	14	46	0	0	47	1	0
10	42741661	.	C	A	2	9	11	1	35	47	0	0
10	42741840	.	T	A	26	26	52	0	3	55	0	0
10	42741872	.	A	G	21	23	44	0	2	46	0	0
10	42741938	.	A	C	10	0	10	0	19	29	0	0
10	42742058	.	T	C	3	0	3	0	7	10	0	0
10	42742319	.	A	T	7	10	17	0	0	17	0	0
10	42742600	.	C	T	15	8	23	0	0	23	0	0
10	42742744	.	C	A	13	8	21	5	1	27	0	0
10	42743036	.	C	T	5	2	7	0	0	7	0	0
10	42744585	.	C	T	14	5	19	0	1	20	0	0
10	42744598	.	C	A	14	6	20	0	1	21	0	0
10	42744705	.	A	T	6	13	19	0	1	20	0	0
10	42744720	.	G	C	8	12	20	0	0	20	0	0
10	42744831	.	T	G	10	11	21	3	2	26	0	0
10	42744912	.	C	A	13	12	25	0	0	25	0	0
10	42744951	.	G	C	13	13	26	0	0	26	0	0
10	42744970	.	T	A	13	8	21	0	0	21	0	0
10	42745018	.	T	A	6	5	11	0	0	11	0	0
10	42745147	.	A	G	9	10	19	0	0	19	0	0
10	42745151	.	C	T	7	10	17	0	0	17	0	0
10	42767123	.	G	A	16	17	33	0	2	35	0	0
10	42767252	.	C	T	1	15	16	0	16	32	0	0
10	42771558	.	A	T	10	9	19	0	0	19	0	0
10	42876420	.	A	G	1	2	3	0	1	4	0	0
10	42876967	.	T	C	1	3	4	0	0	4	0	0
10	42881300	.	C	A	1	2	3	0	2	5	0	0
10	42902618	.	T	C	2	3	5	0	0	5	0	0
10	42902666	.	G	A	1	5	6	0	0	6	0	0
10	42902792	.	T	C	3	5	8	0	0	8	0	0
10	42903629	.	G	A	1	2	3	0	1	4	0	0
10	42903745	.	T	C	6	2	8	0	0	8	0	0
10	42930776	.	T	C	10	1	11	0	11	22	0	0
10	42930781	.	T	C	10	0	10	0	12	22	0	0
10	42930814	.	T	C	13	10	23	0	0	23	0	0
10	42930828	.	T	C	9	13	22	0	0	22	0	0
10	42930933	.	T	C	3	12	15	0	0	15	0	0
10	42931315	.	T	A	8	4	12	0	0	12	0	0
10	42935346	.	C	T	1	8	9	0	7	16	0	0
10	42949713	.	A	G	6	9	15	0	0	15	0	0
10	42992977	.	T	C	5	1	6	0	13	19	0	0
10	43047704	.	T	A	3	3	6	0	0	6	0	0
10	43057598	.	C	T	2	3	5	0	1	6	0	0
10	43071017	.	A	T	2	4	6	1	0	8	1	0
10	43072843	.	A	G	4	5	9	0	0	9	0	0
10	43117721	.	A	G	3	4	7	0	1	8	0	0
10	43117724	.	C	T	4	4	8	0	0	8	0	0
10	43126941	.	T	A	2	4	6	0	0	6	0	0
10	43126994	.	T	C	4	5	9	0	1	10	0	0
10	43127066	.	T	G	2	0	2	0	3	5	0	0
10	43149237	.	A	G	5	0	5	0	4	9	0	0
10	43151516	.	G	A	2	3	5	0	3	8	0	0
10	43157401	.	C	G	6	4	10	0	0	10	0	0
10	43204351	.	A	G	1	0	1	0	4	5	0	0
10	43225179	.	G	A	1	3	4	0	0	4	0	0
10	43231072	.	G	T	1	2	3	0	4	7	0	0
10	43231139	.	G	A	3	2	5	0	1	6	0	0
10	43231264	.	A	G	1	2	3	0	0	3	0	0
10	43231525	.	C	T	2	2	4	0	0	4	0	0
10	43232048	.	G	A	3	3	6	0	0	6	0	0
10	43232291	.	T	A	0	7	7	0	0	7	0	0
10	43232315	.	A	C	2	4	6	0	1	7	0	0
10	43232340	.	C	T	3	3	6	0	1	7	0	0
10	43232434	.	A	T	3	2	5	0	0	5	0	0
10	43232452	.	T	C	1	2	3	0	0	3	0	0
10	43232470	.	G	C	2	3	5	0	0	5	0	0
10	43259766	.	C	T	2	3	5	2	0	7	0	0
10	43290759	.	C	T	6	7	13	0	0	13	0	0
10	43294835	.	G	T	2	2	4	0	1	5	0	0
10	43365046	.	A	G	13	10	23	0	1	24	0	0
10	43372035	.	A	G	11	5	16	0	1	17	0	0
10	43372466	.	C	T	10	7	17	0	0	17	0	0
10	43375468	.	G	A	9	11	20	0	1	21	0	0
10	43545284	.	A	C	4	7	11	0	0	11	0	0
10	43545288	.	C	T	5	7	12	0	0	12	0	0
10	43545434	.	G	C	10	9	19	0	0	19	0	0
10	43545475	.	A	C	8	6	14	0	1	15	0	0
10	43545577	.	C	A	1	6	7	0	6	13	0	0
10	43545681	.	C	T	2	9	11	0	2	13	0	0
10	43545747	.	A	G	5	6	11	0	1	12	0	0
10	43545757	.	C	T	0	4	4	0	8	12	0	0
10	43546058	.	T	C	6	2	8	0	0	8	0	0
10	43546062	.	C	T	3	5	8	0	0	8	0	0
10	43546802	.	G	T	9	6	15	0	1	16	0	0
10	43547008	.	G	A	8	3	11	0	0	11	0	0
10	43547024	.	G	A	8	2	10	0	1	11	0	0
10	43547190	.	A	G	5	5	10	0	0	10	0	0
10	43547194	.	T	A	6	6	12	0	0	12	0	0
10	43547905	.	G	A	2	4	6	1	0	7	0	0
10	43547937	.	A	G	5	4	9	1	0	10	0	0
10	43548194	.	C	A	5	2	7	0	0	7	0	0
10	43548195	.	C	A	4	2	6	0	1	7	0	0
10	43548301	.	A	G	9	4	13	0	1	14	0	0
10	43548495	.	C	T	7	3	10	0	1	11	0	0
10	43548517	.	G	A	7	3	10	0	1	11	0	0
10	43548632	.	G	A	7	3	10	0	0	10	0	0
10	43548671	.	T	C	2	0	2	0	4	6	0	0
10	43549062	.	G	T	3	10	13	0	0	13	0	0
10	43549308	.	C	A	0	5	5	3	6	14	0	0
10	43549393	.	C	T	8	3	11	0	2	13	0	0
10	43549403	.	T	C	6	5	11	0	1	12	0	0
10	43549502	.	A	C	7	0	7	0	7	14	0	0
10	43549559	.	G	C	2	3	5	0	0	5	0	0
10	43549734	.	A	C	4	4	8	0	1	9	0	0
10	43549744	.	T	A	4	5	9	0	1	10	0	0
10	43549782	.	G	A	6	9	15	0	0	15	0	0
10	43549798	.	G	A	6	8	14	0	0	14	0	0
10	43549991	.	G	T	3	3	6	0	0	6	0	0
10	43550123	.	G	A	1	4	5	0	0	5	0	0
10	43550156	.	G	C	2	4	6	0	0	6	0	0
10	43611596	.	T	A	0	4	4	0	1	5	0	0
10	43709042	.	A	T	3	3	6	0	0	6	0	0
10	43709204	.	A	G	15	16	31	0	0	31	0	0
10	43711059	.	T	A	24	9	33	0	0	33	0	0
10	43715981	.	G	A	17	15	32	0	1	33	0	0
10	43721415	.	C	T	15	11	26	0	1	27	0	0
10	43761719	.	T	A	5	2	7	0	0	7	0	0
10	43761755	.	A	G	6	2	8	0	0	8	0	0
10	43762021	.	C	T	5	3	8	0	0	8	0	0
10	43762142	.	C	T	1	7	8	0	3	11	0	0
10	43762519	.	A	G	8	7	15	0	0	15	0	0
10	43762654	.	A	G	9	7	16	0	0	16	0	0
10	43762717	.	A	G	12	8	20	0	0	20	0	0
10	43762755	.	A	C	6	5	11	1	0	12	0	0
10	43765291	.	G	C	4	4	8	0	0	8	0	0
10	43766688	.	T	G	5	5	10	0	0	10	0	0
10	43766733	.	G	A	8	3	11	0	1	12	0	0
10	43766817	.	A	C	5	0	5	0	6	11	0	0
10	43771142	.	C	T	3	4	7	0	0	7	0	0
10	43771238	.	G	A	5	4	9	0	0	9	0	0
10	43771302	.	G	A	2	3	5	0	0	5	0	0
10	43863792	.	T	G	2	2	4	0	0	4	0	0
10	43865118	.	G	A	1	2	3	0	0	3	0	0
10	43865127	.	T	G	1	2	3	0	0	3	0	0
10	43895588	.	G	A	1	2	3	0	0	3	0	0
10	43928632	.	C	A	1	4	5	0	1	6	0	0
10	43936313	.	A	T	15	17	32	0	3	35	0	0
10	43937850	.	A	G	18	20	38	0	0	38	0	0
10	43950092	.	T	G	14	10	24	0	1	25	0	0
10	43958439	.	A	C	12	17	29	0	0	29	0	0
10	43964021	.	C	A	1	2	3	0	5	8	0	0
10	43999511	.	T	C	5	6	11	0	0	11	0	0
10	44010073	.	C	T	0	7	7	0	6	13	0	0
10	44011744	.	A	G	2	9	11	1	1	13	0	0
10	44057415	.	C	A	8	3	11	0	7	18	0	0
10	44134118	.	A	G	11	0	11	0	16	27	0	0
10	44137259	.	G	A	1	12	13	0	10	23	0	0
10	44155446	.	G	C	1	12	13	0	14	27	0	0
10	44176257	.	C	T	13	16	29	0	1	30	0	0
10	44180320	.	C	T	23	16	39	0	1	40	0	0
10	44189322	.	G	T	10	21	31	0	0	31	0	0
10	44297245	.	G	T	15	10	25	0	1	26	0	0
10	44314569	.	C	T	9	14	23	0	0	23	0	0
10	44314579	.	A	G	13	10	23	0	0	23	0	0
10	44320823	.	G	C	9	7	16	0	0	16	0	0
10	44337487	.	C	G	8	7	15	0	0	15	0	0
10	44337652	.	G	T	10	3	13	0	0	13	0	0
10	44337710	.	G	A	8	4	12	0	1	13	0	0
10	44340944	.	C	T	10	7	17	0	0	17	0	0
10	44345005	.	C	T	1	6	7	0	5	12	0	0
10	44353914	.	G	A	4	4	8	0	1	10	1	0
10	44354053	.	G	C	2	6	8	0	0	8	0	0
10	44354718	.	T	C	2	1	3	0	5	8	0	0
10	44354736	.	A	C	6	3	9	0	0	9	0	0
10	44363242	.	G	T	10	12	22	0	0	22	0	0
10	44364604	.	A	T	10	6	16	0	0	16	0	0
10	44364610	.	C	T	7	10	17	0	1	18	0	0
10	44371710	.	G	T	1	16	17	0	11	28	0	0
10	44373367	.	T	C	2	2	4	0	1	5	0	0
10	44375785	.	G	A	0	5	5	0	2	7	0	0
10	44377942	.	G	C	6	8	14	1	2	17	0	0
10	44409402	.	C	G	5	3	8	0	1	9	0	0
10	44410082	.	C	T	8	3	11	0	0	11	0	0
10	44410088	.	G	A	3	8	11	0	0	11	0	0
10	44410241	.	G	A	7	3	10	0	1	11	0	0
10	44410975	.	T	C	3	10	13	0	2	15	0	0
10	44437145	.	T	C	16	17	33	0	1	34	0	0
10	44465477	.	C	T	0	4	4	0	5	9	0	0
10	44466844	.	G	A	4	3	7	0	1	8	0	0
10	44503882	.	G	A	13	8	21	0	0	21	0	0
10	44506313	.	C	T	1	8	9	0	5	14	0	0
10	44513232	.	T	C	4	2	6	0	0	6	0	0
10	44513270	.	T	C	4	0	4	0	4	8	0	0
10	44513307	.	T	C	6	4	10	0	1	11	0	0
10	44513402	.	T	C	5	0	5	0	4	9	0	0
10	44513421	.	C	T	0	5	5	0	5	10	0	0
10	44515911	.	G	C	3	2	5	0	1	6	0	0
10	44515927	.	T	C	5	2	7	0	0	7	0	0
10	44516001	.	C	T	2	5	7	0	4	11	0	0
10	44516270	.	G	T	4	5	9	0	0	9	0	0
10	44516535	.	A	T	1	3	4	0	0	4	0	0
10	44516559	.	T	C	3	0	3	0	4	7	0	0
10	44516907	.	G	T	2	4	6	0	0	6	0	0
10	44516908	.	T	C	2	0	2	0	4	6	0	0
10	44516955	.	C	T	3	5	8	0	0	8	0	0
10	44517170	.	C	T	0	4	4	0	2	6	0	0
10	44640688	.	A	C	18	15	33	0	3	36	0	0
10	44640700	.	C	T	21	12	33	0	1	34	0	0
10	44640832	.	G	A	12	16	28	0	1	29	0	0
10	44640843	.	T	C	11	11	22	0	1	23	0	0
10	44640873	.	G	A	11	7	18	0	0	18	0	0
10	44640965	.	G	A	13	15	28	0	1	29	0	0
10	44641025	.	G	A	7	18	25	0	1	26	0	0
10	44648115	.	G	T	0	8	8	0	7	15	0	0
10	44648627	.	C	T	9	10	19	0	0	19	0	0
10	44648746	.	T	A	10	9	19	0	0	19	0	0
10	44650913	.	G	A	1	18	19	0	17	36	0	0
10	44652510	.	C	T	13	17	30	0	1	31	0	0
10	44652561	.	G	A	0	15	15	0	15	30	0	0
10	44656821	.	C	G	13	11	24	0	1	25	0	0
10	44656905	.	G	A	19	14	33	0	0	33	0	0
10	44663025	.	C	T	20	17	37	0	1	38	0	0
10	44663082	.	A	G	21	17	38	0	2	40	0	0
10	44663109	.	A	G	28	14	42	0	0	42	0	0
10	44665345	.	G	T	2	17	19	0	13	32	0	0
10	44665536	.	A	T	17	17	34	0	0	34	0	0
10	44665620	.	C	T	15	18	33	0	0	33	0	0
10	44669263	.	G	A	9	13	22	0	1	23	0	0
10	44669497	.	A	G	17	8	25	0	0	25	0	0
10	44669779	.	A	G	11	0	11	0	15	26	0	0
10	44669825	.	T	G	18	12	30	0	0	30	0	0
10	44669937	.	G	A	7	3	10	0	1	11	0	0
10	44670437	.	A	G	14	7	21	0	0	21	0	0
10	44670894	.	C	T	11	10	21	0	1	22	0	0
10	44670923	.	T	C	5	10	15	0	0	15	0	0
10	44671818	.	A	C	11	17	28	0	0	28	0	0
10	44672009	.	T	A	19	27	46	0	4	50	0	0
10	44672036	.	T	A	28	20	48	0	0	49	1	0
10	44692308	.	A	T	14	14	28	0	0	28	0	0
10	44692314	.	C	A	14	16	30	0	4	34	0	0
10	44693523	.	T	G	44	3	47	2	26	75	0	0
10	44693556	.	C	T	21	16	37	17	4	58	0	0
10	44693769	.	C	T	38	19	57	35	20	112	0	0
10	44693799	.	T	C	31	7	38	58	6	102	0	0
10	44693868	.	G	A	37	6	43	22	3	68	0	0
10	44694081	.	G	A	29	7	36	51	0	87	0	0
10	44694096	.	A	G	26	13	39	38	2	79	0	0
10	44694354	.	G	A	38	17	55	20	3	78	0	0
10	44700044	.	T	G	1	2	3	0	0	3	0	0
10	44700063	.	G	C	0	2	2	0	2	4	0	0
10	44718644	.	T	C	1	3	4	0	0	4	0	0
10	44718649	.	A	T	0	4	4	0	0	4	0	0
10	44738221	.	G	A	1	2	3	0	5	8	0	0
10	44738290	.	C	T	3	3	6	0	0	6	0	0
10	44899055	.	G	T	1	2	3	0	0	3	0	0
10	44900198	.	C	G	3	2	5	0	0	5	0	0
10	44905224	.	A	G	17	7	24	0	0	24	0	0
10	44914623	.	A	G	14	0	14	0	9	23	0	0
10	44914685	.	G	T	4	12	16	0	2	18	0	0
10	44914761	.	T	A	4	7	11	0	0	11	0	0
10	44917613	.	T	A	1	2	3	0	0	3	0	0
10	44940952	.	G	T	0	4	4	0	3	7	0	0
10	44941051	.	C	T	4	2	6	0	0	6	0	0
10	44941408	.	G	A	4	4	8	0	0	8	0	0
10	44941825	.	G	C	0	2	2	0	1	3	0	0
10	44979593	.	A	T	4	3	7	0	0	7	0	0
10	44979712	.	A	G	4	2	6	0	0	6	0	0
10	44979767	.	A	G	3	6	9	0	0	9	0	0
10	44979792	.	T	C	7	4	11	0	0	11	0	0
10	44980391	.	C	T	3	11	14	0	0	14	0	0
10	44980913	.	C	T	11	14	25	0	1	26	0	0
10	44989378	.	C	T	22	22	44	0	2	46	0	0
10	44989384	.	T	C	22	22	44	0	1	45	0	0
10	44990917	.	C	T	27	29	56	0	3	60	1	0
10	45055879	.	G	A	6	13	19	0	0	19	0	0
10	45055948	.	G	A	16	10	26	0	0	26	0	0
10	45059822	.	C	T	4	6	10	0	0	10	0	0
10	45064957	.	C	T	14	13	27	0	0	27	0	0
10	45085679	.	C	T	11	7	18	0	1	19	0	0
10	45089826	.	A	G	14	0	14	0	8	22	0	0
10	45099498	.	T	C	9	13	22	0	0	22	0	0
10	45099522	.	T	C	11	13	24	0	2	26	0	0
10	45101543	.	G	A	1	8	9	0	3	12	0	0
10	45103519	.	C	T	12	11	23	0	1	24	0	0
10	45105244	.	T	C	10	13	23	0	1	24	0	0
10	45148260	.	C	A	2	6	8	0	0	8	0	0
10	45152444	.	C	A	1	6	7	0	0	7	0	0
10	45160904	.	C	A	1	2	3	0	2	5	0	0
10	45160907	.	C	T	3	2	5	0	0	5	0	0
10	45175496	.	G	A	3	2	5	0	0	5	0	0
10	45179688	.	A	C	4	3	7	0	1	8	0	0
10	45180294	.	C	T	8	7	15	0	0	15	0	0
10	45180335	.	C	T	6	3	9	0	2	11	0	0
10	45187450	.	T	C	5	3	8	0	1	9	0	0
10	45189611	.	C	G	1	2	3	0	0	3	0	0
10	45190629	.	C	T	5	7	12	0	0	12	0	0
10	45203109	.	T	C	18	6	24	0	0	24	0	0
10	45203154	.	A	G	7	6	13	0	1	14	0	0
10	45203271	.	T	A	6	4	10	0	0	10	0	0
10	45203385	.	T	A	4	2	6	0	0	6	0	0
10	45203645	.	A	G	2	5	7	0	0	7	0	0
10	45203700	.	A	C	4	6	10	0	0	10	0	0
10	45203704	.	T	G	3	5	8	0	1	9	0	0
10	45203793	.	G	A	0	4	4	0	6	10	0	0
10	45203856	.	G	A	5	3	8	0	0	8	0	0
10	45204024	.	A	G	5	3	8	0	0	8	0	0
10	45204029	.	A	T	4	4	8	0	1	9	0	0
10	45204185	.	T	C	3	4	7	0	0	7	0	0
10	45204218	.	A	G	5	0	5	0	6	11	0	0
10	45204527	.	A	G	1	2	3	0	0	3	0	0
10	45204611	.	A	G	3	1	4	0	0	4	0	0
10	45204621	.	T	C	4	2	6	0	0	6	0	0
10	45204719	.	A	G	1	2	3	0	0	3	0	0
10	45205166	.	A	C	10	6	16	0	0	16	0	0
10	45205175	.	A	G	7	0	7	0	5	12	0	0
10	45205226	.	A	G	12	0	12	0	10	22	0	0
10	45205237	.	C	G	14	0	14	0	11	25	0	0
10	45205284	.	A	C	9	6	15	0	1	16	0	0
10	45205400	.	C	A	3	3	6	0	0	6	0	0
10	45205506	.	A	C	5	5	10	0	0	10	0	0
10	45205518	.	T	G	6	5	11	0	0	11	0	0
10	45205757	.	C	A	3	4	7	0	0	7	0	0
10	45205758	.	A	G	3	4	7	0	0	7	0	0
10	45206103	.	C	G	1	6	7	0	0	8	1	0
10	45206289	.	G	C	6	0	6	0	8	14	0	0
10	45206450	.	T	C	2	0	2	0	9	11	0	0
10	45206478	.	G	T	13	3	16	0	2	18	0	0
10	45208153	.	A	G	1	6	7	0	0	7	0	0
10	45208875	.	G	A	7	6	13	0	1	14	0	0
10	45208899	.	C	A	8	5	13	0	2	15	0	0
10	45213798	.	C	T	0	9	9	0	6	15	0	0
10	45229624	.	C	A	1	5	6	0	0	6	0	0
10	45248527	.	A	C	7	16	23	0	1	24	0	0
10	45248548	.	T	A	12	14	26	0	0	26	0	0
10	45248638	.	G	A	9	11	20	0	3	23	0	0
10	45313560	.	C	T	13	12	25	0	0	25	0	0
10	45313623	.	G	A	1	13	14	0	7	21	0	0
10	45313671	.	C	T	10	8	18	0	1	19	0	0
10	45322668	.	A	G	14	0	14	0	11	25	0	0
10	45325302	.	G	A	1	10	11	0	8	19	0	0
10	45334688	.	C	T	9	5	14	0	4	18	0	0
10	45336565	.	T	C	15	15	30	0	4	34	0	0
10	45340105	.	G	T	0	7	7	0	8	15	0	0
10	45340625	.	A	C	2	3	5	10	1	16	0	0
10	45340654	.	A	G	3	7	10	5	1	16	0	0
10	45340835	.	G	C	13	7	20	0	0	20	0	0
10	45340930	.	G	T	10	6	16	0	0	16	0	0
10	45341210	.	T	A	6	5	11	0	1	12	0	0
10	45341403	.	A	G	6	6	12	0	0	12	0	0
10	45341410	.	A	G	8	0	8	0	4	12	0	0
10	45341452	.	T	G	6	2	8	0	4	12	0	0
10	45341537	.	A	C	10	9	19	0	0	19	0	0
10	45341546	.	A	C	8	10	18	0	0	18	0	0
10	45341572	.	G	C	0	12	12	0	10	22	0	0
10	45341596	.	C	T	9	13	22	0	0	22	0	0
10	45341762	.	A	T	5	7	12	0	1	13	0	0
10	45349924	.	G	A	40	45	85	0	0	85	0	0
10	45351037	.	C	T	38	44	82	1	2	85	0	0
10	45352231	.	C	T	8	19	27	0	2	29	0	0
10	45375714	.	G	T	13	10	23	0	3	26	0	0
10	45375732	.	C	T	15	10	25	0	0	25	0	0
11	28627	.	C	T	1	5	6	0	0	6	0	0
11	126334	.	G	A	25	19	44	0	1	45	0	0
11	126595	.	A	T	24	19	43	0	2	45	0	0
11	127139	.	G	A	15	27	42	1	2	45	0	0
11	158688	.	C	T	2	3	5	0	0	5	0	0
11	185396	.	C	T	0	3	3	0	4	7	0	0
11	185624	.	T	A	14	13	27	0	1	28	0	0
11	185678	.	G	A	11	14	25	0	1	26	0	0
11	185775	.	C	T	0	13	13	0	15	28	0	0
11	185890	.	A	G	11	21	32	0	2	34	0	0
11	185902	.	A	G	15	17	32	0	1	33	0	0
11	186235	.	G	A	11	17	28	0	0	28	0	0
11	186526	.	A	T	5	4	9	0	0	9	0	0
11	186745	.	G	T	6	16	22	0	1	23	0	0
11	186798	.	T	G	10	12	22	0	0	22	0	0
11	186939	.	A	G	10	28	38	0	2	40	0	0
11	187022	.	C	A	13	19	32	0	0	32	0	0
11	187104	.	T	A	18	16	34	0	4	38	0	0
11	187399	.	A	C	14	14	28	0	1	29	0	0
11	221929	.	T	C	14	0	14	0	17	31	0	0
11	222488	.	C	G	6	8	14	0	0	14	0	0
11	222722	.	C	T	0	13	13	0	9	22	0	0
11	222729	.	C	T	1	10	11	0	11	22	0	0
11	222776	.	C	T	7	13	20	0	0	20	0	0
11	222787	.	A	G	8	13	21	0	0	21	0	0
11	223101	.	G	A	9	9	18	0	2	20	0	0
11	223319	.	G	A	9	8	17	0	2	19	0	0
11	223806	.	A	G	14	13	27	0	0	27	0	0
11	233672	.	A	T	12	13	25	0	3	28	0	0
11	233674	.	G	A	13	14	27	0	1	28	0	0
11	236437	.	C	T	11	7	18	0	1	19	0	0
11	236515	.	T	C	8	6	14	0	2	16	0	0
11	236551	.	G	A	14	8	22	0	0	22	0	0
11	260909	.	G	A	12	3	15	1	2	18	0	0
11	265097	.	T	G	22	17	39	0	0	39	0	0
11	265404	.	G	A	22	22	44	0	1	45	0	0
11	265497	.	C	T	3	16	19	0	20	39	0	0
11	265506	.	G	C	21	15	36	0	0	36	0	0
11	268887	.	G	A	18	20	38	0	0	38	0	0
11	270090	.	A	G	16	14	30	0	1	31	0	0
11	281887	.	A	T	4	2	6	1	0	7	0	0
11	281961	.	A	G	1	4	5	0	0	5	0	0
11	282193	.	T	G	6	8	14	0	1	15	0	0
11	282279	.	A	T	6	12	18	0	0	18	0	0
11	282546	.	G	T	3	10	13	0	1	14	0	0
11	282553	.	A	G	4	10	14	0	1	15	0	0
11	282602	.	T	G	7	7	14	0	0	14	0	0
11	284424	.	G	T	10	10	20	0	2	22	0	0
11	296453	.	T	A	6	5	11	0	1	12	0	0
11	322076	.	G	A	0	7	7	0	7	14	0	0
11	539573	.	A	C	1	7	8	0	2	10	0	0
11	675382	.	G	C	26	23	49	1	1	51	0	0
11	676856	.	T	C	31	25	56	0	6	62	0	0
11	677100	.	A	G	19	11	30	0	1	31	0	0
11	677264	.	T	C	34	20	54	0	9	63	0	0
11	677341	.	T	C	31	15	46	0	6	52	0	0
11	682905	.	C	T	25	24	49	0	4	53	0	0
11	682926	.	A	G	26	23	49	0	3	52	0	0
11	682943	.	G	A	23	21	44	0	2	46	0	0
11	687501	.	G	A	30	21	51	1	1	53	0	0
11	718214	.	G	A	8	12	20	0	0	20	0	0
11	718404	.	A	C	4	8	12	0	0	12	0	0
11	718454	.	A	G	5	8	13	1	0	14	0	0
11	762445	.	A	G	12	13	25	0	6	31	0	0
11	779785	.	C	A	11	7	18	0	0	18	0	0
11	779863	.	T	A	4	8	12	0	0	12	0	0
11	780405	.	T	A	7	3	10	0	0	10	0	0
11	813667	.	A	G	4	3	7	0	1	8	0	0
11	813851	.	T	C	3	0	3	0	7	10	0	0
11	1083008	.	G	A	5	3	8	0	0	8	0	0
11	1083017	.	T	A	5	4	9	0	0	9	0	0
11	1095064	.	G	A	15	12	27	0	1	28	0	0
11	1099702	.	G	T	8	11	19	0	0	19	0	0
11	1128896	.	G	A	3	2	5	0	0	5	0	0
11	1148869	.	G	A	22	21	43	0	0	43	0	0
11	1148889	.	G	A	19	19	38	0	0	38	0	0
11	1149105	.	C	T	23	22	45	0	1	46	0	0
11	1149593	.	A	G	42	10	52	2	3	57	0	0
11	1149812	.	C	T	9	26	35	1	37	73	0	0
11	1163295	.	C	T	41	27	68	0	2	70	0	0
11	1165993	.	G	A	36	26	62	0	0	62	0	0
11	1166326	.	G	C	25	5	30	0	30	60	0	0
11	1177389	.	C	A	4	26	30	0	30	60	0	0
11	1183007	.	G	A	23	21	44	0	1	45	0	0
11	1183602	.	C	T	0	19	19	0	32	51	0	0
11	1183739	.	G	T	22	25	47	0	2	49	0	0
11	1198390	.	G	C	26	29	55	0	1	56	0	0
11	1198419	.	G	A	25	30	55	0	4	59	0	0
11	1198450	.	G	A	26	28	54	0	1	55	0	0
11	1198507	.	G	T	28	27	55	0	5	60	0	0
11	1203619	.	G	A	27	16	43	0	4	47	0	0
11	1221865	.	A	G	31	28	59	0	0	59	0	0
11	1222025	.	T	G	30	29	59	0	1	60	0	0
11	1339419	.	C	T	1	8	9	0	7	16	0	0
11	1341402	.	C	T	1	3	4	0	5	9	0	0
11	1342778	.	G	A	7	9	16	0	0	16	0	0
11	1342826	.	A	G	10	7	17	0	0	17	0	0
11	1348596	.	A	G	6	12	18	0	0	18	0	0
11	1348821	.	A	C	7	8	15	0	0	15	0	0
11	1351542	.	C	T	1	4	5	0	10	15	0	0
11	1351563	.	T	G	11	4	15	0	0	15	0	0
11	1351611	.	A	G	9	5	14	0	0	14	0	0
11	1356637	.	A	G	6	7	13	0	0	13	0	0
11	1356640	.	A	G	6	8	14	0	0	14	0	0
11	1359391	.	G	T	5	5	10	0	0	10	0	0
11	1365078	.	T	C	3	4	7	0	0	7	0	0
11	1366830	.	T	C	3	2	5	0	0	5	0	0
11	1368265	.	G	A	3	3	6	0	1	7	0	0
11	1389850	.	C	T	0	2	2	0	5	7	0	0
11	1396343	.	T	C	14	16	30	0	1	31	0	0
11	1403797	.	T	C	7	0	7	0	5	12	0	0
11	1403821	.	A	C	5	4	9	0	0	9	0	0
11	1403921	.	A	C	3	2	5	0	1	6	0	0
11	1403969	.	G	A	2	3	5	0	0	5	0	0
11	1404031	.	A	C	1	5	6	0	0	6	0	0
11	1404165	.	C	T	3	5	8	0	0	8	0	0
11	1404481	.	C	A	3	5	8	0	1	9	0	0
11	1404640	.	T	C	4	0	4	0	10	14	0	0
11	1404642	.	A	G	4	10	14	0	0	14	0	0
11	1406012	.	T	C	2	5	7	0	0	7	0	0
11	1408791	.	G	T	8	6	14	0	1	15	0	0
11	1408802	.	G	T	9	8	17	0	0	17	0	0
11	1409157	.	T	C	3	2	5	0	0	5	0	0
11	1409162	.	G	A	3	2	5	0	1	6	0	0
11	1427981	.	T	C	9	0	9	0	11	20	0	0
11	1435736	.	A	G	9	4	13	0	1	14	0	0
11	1467114	.	T	C	16	0	16	0	11	27	0	0
11	1467130	.	C	A	1	11	12	0	18	30	0	0
11	1469842	.	C	T	9	7	16	0	1	17	0	0
11	1469859	.	A	G	10	9	19	0	0	19	0	0
11	1469895	.	A	G	12	9	21	0	1	22	0	0
11	1470503	.	G	A	12	8	20	0	1	21	0	0
11	1470535	.	G	C	11	6	17	0	0	17	0	0
11	1470574	.	T	C	7	10	17	0	0	17	0	0
11	1474629	.	C	T	7	5	12	0	1	13	0	0
11	1512626	.	A	G	5	4	9	0	0	9	0	0
11	1512660	.	A	T	4	10	14	0	0	14	0	0
11	1512684	.	A	T	2	6	8	0	0	8	0	0
11	1512947	.	T	C	8	5	13	0	0	13	0	0
11	1512950	.	A	C	8	5	13	0	0	13	0	0
11	1517289	.	C	A	6	3	9	0	0	9	0	0
11	1520436	.	A	G	4	2	6	0	0	6	0	0
11	1520693	.	G	A	1	2	3	0	0	3	0	0
11	1522194	.	C	G	23	0	23	0	14	37	0	0
11	1522205	.	G	T	24	11	35	0	2	37	0	0
11	1522291	.	T	C	11	22	33	0	1	34	0	0
11	1523846	.	T	C	8	7	15	0	0	15	0	0
11	1523912	.	T	C	4	3	7	0	0	7	0	0
11	1524079	.	T	C	7	6	13	0	0	13	0	0
11	1524108	.	C	T	10	8	18	0	0	18	0	0
11	1525081	.	G	C	14	7	21	0	0	21	0	0
11	1525389	.	G	T	23	24	47	1	1	49	0	0
11	1525416	.	T	A	22	26	48	1	0	49	0	0
11	1526749	.	A	G	23	20	43	0	2	45	0	0
11	1529260	.	A	G	19	19	38	0	0	38	0	0
11	1529526	.	G	A	17	16	33	0	1	34	0	0
11	1529743	.	G	A	19	7	26	0	0	26	0	0
11	1529789	.	A	C	19	9	28	0	0	28	0	0
11	1529796	.	A	T	20	8	28	0	0	28	0	0
11	1529838	.	A	G	15	12	27	0	0	27	0	0
11	1529852	.	A	G	19	7	26	0	0	26	0	0
11	1530027	.	G	A	9	8	17	0	0	17	0	0
11	1530295	.	A	C	11	20	31	0	1	32	0	0
11	1530363	.	A	G	18	18	36	0	2	38	0	0
11	1530489	.	A	G	10	0	10	0	19	29	0	0
11	1530541	.	A	G	18	15	33	0	2	35	0	0
11	1530584	.	G	A	2	11	13	0	17	30	0	0
11	1530593	.	G	T	16	12	28	0	2	30	0	0
11	1530642	.	G	A	12	8	20	0	1	21	0	0
11	1535427	.	C	A	5	6	11	0	0	11	0	0
11	1535471	.	T	C	8	4	12	0	0	12	0	0
11	1535877	.	G	A	2	3	5	0	0	5	0	0
11	1542605	.	A	G	8	0	8	0	6	14	0	0
11	1543974	.	A	G	9	8	17	0	0	17	0	0
11	1545883	.	A	C	3	4	7	0	0	7	0	0
11	1628608	.	A	T	3	3	6	0	1	7	0	0
11	1628698	.	T	C	2	4	6	0	0	6	0	0
11	1628742	.	G	T	0	4	4	0	2	6	0	0
11	1689708	.	T	C	4	2	6	0	0	6	0	0
11	1701929	.	C	T	8	5	13	0	0	13	0	0
11	1718046	.	A	G	3	2	5	0	0	5	0	0
11	1725861	.	G	A	5	4	9	0	0	9	0	0
11	1728633	.	G	C	0	6	6	0	3	9	0	0
11	1732124	.	T	C	3	4	7	0	0	7	0	0
11	1741883	.	C	T	7	6	13	0	1	14	0	0
11	1742003	.	C	T	5	4	9	0	0	9	0	0
11	1745796	.	T	G	6	0	6	0	5	11	0	0
11	1745850	.	C	A	3	5	8	0	0	8	0	0
11	1746156	.	T	C	2	4	6	0	0	6	0	0
11	1751589	.	T	A	6	6	12	0	3	15	0	0
11	1754419	.	G	C	4	8	12	0	0	12	0	0
11	1764225	.	C	T	6	5	11	0	0	11	0	0
11	1764237	.	T	A	6	5	11	0	0	11	0	0
11	1764291	.	C	T	6	6	12	0	0	12	0	0
11	1764381	.	C	T	3	7	10	0	0	10	0	0
11	1764415	.	A	G	6	4	10	0	2	12	0	0
11	1764731	.	C	T	8	9	17	0	0	17	0	0
11	1764776	.	T	C	11	8	19	0	0	19	0	0
11	1767448	.	A	G	8	7	15	0	0	15	0	0
11	1769188	.	A	G	4	0	4	0	6	10	0	0
11	1769218	.	C	A	4	2	6	0	1	7	0	0
11	1771294	.	T	C	2	4	6	0	0	6	0	0
11	1771741	.	C	A	4	8	12	0	0	12	0	0
11	1773801	.	C	T	5	4	9	0	0	9	0	0
11	1776672	.	G	A	8	6	14	0	2	16	0	0
11	1786312	.	C	T	3	6	9	0	0	9	0	0
11	1793477	.	A	C	6	5	11	0	0	11	0	0
11	1799763	.	G	A	1	14	15	0	8	23	0	0
11	1799778	.	C	T	10	12	22	0	2	24	0	0
11	1799838	.	C	T	12	7	19	0	0	19	0	0
11	1805726	.	G	T	1	5	6	0	6	12	0	0
11	1805810	.	T	C	10	9	19	0	0	19	0	0
11	1810104	.	C	T	16	14	30	0	1	31	0	0
11	1812288	.	A	G	7	0	7	0	9	16	0	0
11	1812951	.	T	A	8	11	19	0	1	20	0	0
11	1812961	.	C	T	14	8	22	0	0	22	0	0
11	1813240	.	A	G	10	20	30	0	1	31	0	0
11	1815978	.	C	T	18	11	29	0	0	29	0	0
11	1818005	.	C	T	8	12	20	0	0	20	0	0
11	1823329	.	T	G	11	0	11	0	12	23	0	0
11	1829952	.	C	T	4	11	15	0	1	16	0	0
11	1830621	.	T	C	15	10	25	0	0	25	0	0
11	1834124	.	T	C	16	9	25	0	0	25	0	0
11	1836100	.	C	A	14	16	30	0	0	30	0	0
11	1836995	.	C	G	12	0	12	0	18	30	0	0
11	1838725	.	G	C	1	20	21	0	13	34	0	0
11	1841961	.	G	C	13	11	24	0	2	26	0	0
11	1843339	.	G	T	17	15	32	0	3	35	0	0
11	1843771	.	C	A	16	16	32	0	0	32	0	0
11	1863846	.	T	G	15	19	34	0	2	36	0	0
11	1864095	.	C	A	21	15	36	0	0	36	0	0
11	1864216	.	C	T	7	12	19	0	1	20	0	0
11	1903467	.	A	G	2	2	4	0	0	4	0	0
11	1916315	.	T	A	1	2	3	0	0	3	0	0
11	1917395	.	C	T	2	2	4	0	0	4	0	0
11	1917396	.	T	A	2	2	4	0	0	4	0	0
11	1918046	.	G	A	0	2	2	0	4	6	0	0
11	1918503	.	A	C	3	2	5	0	0	5	0	0
11	1918750	.	A	C	1	2	3	0	0	3	0	0
11	1919054	.	T	G	4	0	4	0	5	9	0	0
11	1919963	.	T	G	1	0	1	0	2	3	0	0
11	1920009	.	C	T	1	3	4	0	2	6	0	0
11	1920069	.	A	T	1	2	3	0	0	3	0	0
11	1945034	.	T	A	12	10	22	0	1	23	0	0
11	1945036	.	C	T	13	10	23	0	0	23	0	0
11	1945229	.	C	T	8	13	21	0	0	21	0	0
11	1947965	.	A	G	9	7	16	0	0	16	0	0
11	1948373	.	A	T	7	6	13	0	0	13	0	0
11	1967076	.	C	A	9	8	17	0	0	17	0	0
11	1967111	.	T	A	9	8	17	0	0	17	0	0
11	1967187	.	T	C	8	9	17	0	0	17	0	0
11	2112487	.	A	T	1	2	3	0	0	3	0	0
11	2112554	.	A	G	1	2	3	0	0	3	0	0
11	2122832	.	A	C	3	2	5	0	0	5	0	0
11	2122833	.	T	A	2	3	5	0	0	5	0	0
11	2123581	.	C	T	2	2	4	0	1	5	0	0
11	2217572	.	T	C	1	3	4	0	1	5	0	0
11	2240120	.	A	C	12	5	17	0	1	18	0	0
11	2244445	.	A	G	4	3	7	0	0	7	0	0
11	2249884	.	A	G	35	30	65	0	2	67	0	0
11	2249920	.	C	T	32	33	65	0	0	65	0	0
11	2255025	.	T	G	8	7	15	0	1	16	0	0
11	2255027	.	T	G	8	7	15	0	1	16	0	0
11	2263484	.	T	G	3	6	9	0	0	9	0	0
11	2290246	.	T	C	8	6	14	0	0	14	0	0
11	2292997	.	G	A	4	7	11	0	0	11	0	0
11	2458371	.	T	G	4	4	8	0	0	8	0	0
11	2462623	.	T	C	1	1	2	0	1	3	0	0
11	2462625	.	C	A	1	2	3	0	0	3	0	0
11	2462659	.	C	T	2	2	4	0	0	4	0	0
11	2506878	.	C	T	4	6	10	0	0	10	0	0
11	2507001	.	G	A	1	6	7	0	4	11	0	0
11	2507529	.	C	G	6	9	15	0	0	15	0	0
11	2507539	.	C	T	10	5	15	0	1	16	0	0
11	2541797	.	T	C	7	4	11	0	0	11	0	0
11	2542391	.	C	T	9	4	13	0	1	14	0	0
11	2543188	.	A	C	3	0	3	0	4	7	0	0
11	2545012	.	C	T	0	4	4	0	6	10	0	0
11	2545018	.	A	G	4	6	10	0	0	10	0	0
11	2545462	.	C	G	2	5	7	0	1	8	0	0
11	2545487	.	G	A	4	5	9	0	0	9	0	0
11	2566191	.	C	T	2	6	8	0	0	8	0	0
11	2571562	.	T	A	7	3	10	0	1	11	0	0
11	2571635	.	A	G	5	9	14	0	0	14	0	0
11	2571685	.	C	A	5	3	8	0	0	8	0	0
11	2571686	.	A	T	4	3	7	0	1	8	0	0
11	2576843	.	T	C	7	0	7	0	8	15	0	0
11	2576876	.	C	T	6	4	10	0	1	11	0	0
11	2584328	.	C	T	1	4	5	0	5	10	0	0
11	2585371	.	T	C	4	5	9	0	1	10	0	0
11	2587205	.	T	C	5	4	9	0	0	9	0	0
11	2587664	.	T	C	4	0	4	0	7	11	0	0
11	2587928	.	A	T	4	9	13	0	0	13	0	0
11	2593620	.	T	A	3	6	9	0	0	9	0	0
11	2593645	.	T	G	5	4	9	0	0	9	0	0
11	2593659	.	A	T	3	4	7	0	0	7	0	0
11	2597009	.	G	A	2	4	6	0	0	6	0	0
11	2600746	.	A	G	3	2	5	0	0	5	0	0
11	2601114	.	T	A	5	3	8	0	0	8	0	0
11	2601147	.	C	T	4	3	7	0	0	7	0	0
11	2601414	.	C	T	1	3	4	0	0	4	0	0
11	2601792	.	C	T	2	4	6	0	0	6	0	0
11	2601803	.	A	G	1	4	5	0	1	6	0	0
11	2603052	.	C	T	1	5	6	0	0	6	0	0
11	2603073	.	G	T	3	5	8	0	0	8	0	0
11	2605763	.	G	A	1	6	7	0	4	11	0	0
11	2609385	.	A	T	4	4	8	0	0	8	0	0
11	2615742	.	T	C	2	6	8	0	1	9	0	0
11	2616956	.	T	C	4	9	13	0	1	14	0	0
11	2617031	.	T	A	15	12	27	1	2	30	0	0
11	2617072	.	A	G	14	7	21	1	1	23	0	0
11	2618072	.	T	A	8	4	12	0	1	13	0	0
11	2618073	.	G	A	9	4	13	0	0	13	0	0
11	2618114	.	C	A	6	4	10	0	0	10	0	0
11	2618653	.	C	A	10	6	16	2	0	18	0	0
11	2619054	.	T	G	5	11	16	0	0	16	0	0
11	2619089	.	G	A	4	16	20	0	1	21	0	0
11	2619129	.	C	A	8	14	22	0	1	23	0	0
11	2619515	.	T	A	8	11	19	0	1	20	0	0
11	2619538	.	T	A	8	10	18	0	0	18	0	0
11	2619588	.	G	C	11	1	12	0	10	22	0	0
11	2621839	.	G	A	8	12	20	0	3	23	0	0
11	2625178	.	G	A	11	11	22	0	0	22	0	0
11	2625224	.	T	A	14	8	22	0	0	22	0	0
11	2625247	.	T	C	8	8	16	0	1	17	0	0
11	2628038	.	T	G	10	7	17	0	1	18	0	0
11	2650018	.	T	G	10	8	18	0	0	18	0	0
11	2655888	.	G	C	5	13	18	0	0	18	0	0
11	2655957	.	G	C	0	5	5	0	8	13	0	0
11	2656062	.	C	G	11	3	14	0	0	14	0	0
11	2656158	.	T	C	2	5	7	0	0	7	0	0
11	2656830	.	T	C	5	5	10	0	0	10	0	0
11	2660045	.	A	G	4	5	9	0	0	9	0	0
11	2660602	.	T	C	12	6	18	0	0	18	0	0
11	2660809	.	G	A	1	12	13	0	5	18	0	0
11	2664585	.	A	C	5	10	15	0	5	20	0	0
11	2665236	.	T	A	7	7	14	0	3	17	0	0
11	2673624	.	T	C	6	15	21	0	0	21	0	0
11	2675447	.	C	A	13	11	24	0	0	24	0	0
11	2675454	.	A	C	11	11	22	0	1	23	0	0
11	2677377	.	G	C	14	12	26	0	0	26	0	0
11	2677404	.	G	A	0	14	14	0	14	28	0	0
11	2677428	.	A	G	10	10	20	0	2	22	0	0
11	2677440	.	C	T	11	10	21	0	0	21	0	0
11	2677538	.	C	T	6	13	19	0	0	19	0	0
11	2678064	.	G	A	16	13	29	0	1	30	0	0
11	2678088	.	G	A	15	12	27	0	0	27	0	0
11	2680570	.	G	A	1	6	7	0	5	12	0	0
11	2680747	.	C	T	5	7	12	0	3	15	0	0
11	2680797	.	G	C	6	5	11	0	0	11	0	0
11	2681121	.	C	A	4	3	7	0	0	7	0	0
11	2681133	.	T	A	4	3	7	0	0	7	0	0
11	2681338	.	A	G	3	5	8	0	0	8	0	0
11	2681359	.	A	G	6	4	10	0	0	10	0	0
11	2681432	.	A	G	7	5	12	0	1	13	0	0
11	2681738	.	A	G	5	3	8	0	0	8	0	0
11	2681885	.	T	G	4	3	7	0	2	10	1	0
11	2682257	.	T	A	1	2	3	0	0	3	0	0
11	2682310	.	G	T	3	2	5	0	0	5	0	0
11	2682313	.	G	T	3	3	6	0	0	6	0	0
11	2682361	.	T	C	4	5	9	0	0	9	0	0
11	2682414	.	A	G	2	3	5	0	1	6	0	0
11	2682441	.	A	T	1	7	8	0	0	8	0	0
11	2682470	.	A	T	3	9	12	0	1	13	0	0
11	2682483	.	T	C	10	3	13	0	0	13	0	0
11	2682551	.	C	T	3	3	6	0	0	6	0	0
11	2682555	.	A	T	3	3	6	0	0	6	0	0
11	2682644	.	A	T	6	4	10	0	1	11	0	0
11	2682664	.	T	A	4	7	11	0	0	11	0	0
11	2682693	.	A	C	6	8	14	0	0	14	0	0
11	2683509	.	T	C	5	21	26	2	1	29	0	0
11	2687421	.	C	T	12	7	19	0	3	22	0	0
11	2687472	.	C	T	8	10	18	0	3	21	0	0
11	2687526	.	G	A	9	10	19	0	1	20	0	0
11	2687550	.	A	C	13	9	22	0	2	24	0	0
11	2688119	.	G	A	6	12	18	0	0	18	0	0
11	2688582	.	A	C	1	7	8	0	0	8	0	0
11	2688916	.	G	C	4	13	17	0	0	17	0	0
11	2689336	.	G	A	7	5	12	0	0	12	0	0
11	2689337	.	G	A	6	4	10	0	1	11	0	0
11	2690080	.	A	G	4	5	9	0	0	9	0	0
11	2690233	.	G	T	7	7	14	0	0	14	0	0
11	2690303	.	G	C	7	6	13	0	1	14	0	0
11	2690445	.	G	T	8	10	18	0	1	19	0	0
11	2690499	.	C	T	3	5	8	0	0	8	0	0
11	2690564	.	G	T	6	4	10	0	0	10	0	0
11	2690612	.	A	C	8	5	13	0	0	13	0	0
11	2690675	.	G	T	7	0	7	0	0	7	0	0
11	2690869	.	C	A	3	2	5	0	0	5	0	0
11	2690873	.	G	A	1	2	3	0	2	5	0	0
11	2691642	.	C	T	2	3	5	0	0	5	0	0
11	2702718	.	T	C	14	9	23	0	0	23	0	0
11	2702766	.	C	T	11	7	18	0	0	18	0	0
11	2702808	.	T	C	7	11	18	0	0	18	0	0
11	2705206	.	C	T	12	11	23	0	1	24	0	0
11	2705215	.	G	T	1	11	12	0	13	25	0	0
11	2705273	.	A	G	5	0	5	0	10	15	0	0
11	2705325	.	G	A	13	5	18	0	0	18	0	0
11	2705355	.	T	A	10	6	16	0	1	17	0	0
11	2706517	.	T	G	9	8	17	0	0	17	0	0
11	2706734	.	T	C	10	6	16	0	1	17	0	0
11	2706838	.	A	G	11	7	18	0	1	19	0	0
11	2706988	.	C	A	2	7	9	0	0	9	0	0
11	2710611	.	A	T	8	13	21	0	1	22	0	0
11	2710642	.	G	A	10	4	14	0	1	15	0	0
11	2710770	.	A	T	5	8	13	0	0	13	0	0
11	2730177	.	C	T	8	9	17	0	0	17	0	0
11	2743631	.	A	G	5	0	5	0	10	15	0	0
11	2743661	.	C	T	10	8	18	0	0	18	0	0
11	2745110	.	A	T	10	8	18	1	0	19	0	0
11	2745128	.	C	T	11	10	21	1	1	23	0	0
11	2755120	.	A	T	7	10	17	0	1	18	0	0
11	2756250	.	C	T	8	7	15	0	0	15	0	0
11	2757582	.	T	C	11	11	22	0	0	22	0	0
11	2758204	.	C	T	13	14	27	0	1	28	0	0
11	2758737	.	T	A	1	2	3	0	1	4	0	0
11	2759003	.	C	A	6	3	9	7	0	16	0	0
11	2759007	.	C	T	6	3	9	6	0	15	0	0
11	2759043	.	A	T	6	7	13	1	0	14	0	0
11	2759461	.	T	C	8	3	11	4	0	15	0	0
11	2759475	.	G	T	8	4	12	6	0	18	0	0
11	2759498	.	G	A	8	5	13	11	0	24	0	0
11	2759541	.	C	A	2	3	5	13	0	18	0	0
11	2759635	.	A	C	5	3	8	0	0	8	0	0
11	2759833	.	G	A	1	15	16	0	14	30	0	0
11	2759843	.	G	A	1	17	18	0	15	33	0	0
11	2759901	.	T	G	13	11	24	0	1	25	0	0
11	2759903	.	A	T	12	12	24	0	1	25	0	0
11	2759938	.	A	G	11	6	17	0	1	18	0	0
11	2805410	.	C	A	16	18	34	0	0	34	0	0
11	2809744	.	C	T	16	16	32	0	0	32	0	0
11	2809777	.	A	G	24	0	24	0	13	37	0	0
11	2809804	.	A	G	24	21	45	0	2	47	0	0
11	2813856	.	G	C	15	27	42	0	1	43	0	0
11	2815790	.	C	G	30	20	50	0	2	52	0	0
11	2815845	.	C	T	24	25	49	0	2	51	0	0
11	2820876	.	T	G	24	21	45	0	1	46	0	0
11	2820900	.	A	C	20	19	39	0	5	44	0	0
11	2821427	.	T	C	17	18	35	0	2	37	0	0
11	2821430	.	C	G	16	1	17	0	21	38	0	0
11	2826184	.	T	C	24	19	43	1	3	47	0	0
11	2826338	.	G	T	17	22	39	0	1	40	0	0
11	2826485	.	C	A	15	10	25	0	1	26	0	0
11	2828174	.	A	G	16	20	36	0	2	38	0	0
11	2828276	.	C	A	11	14	25	0	1	26	0	0
11	2828388	.	G	A	12	15	27	0	0	27	0	0
11	2855507	.	A	G	2	2	4	0	0	4	0	0
11	2918023	.	A	T	3	3	6	0	0	6	0	0
11	2920211	.	T	A	2	2	4	0	0	4	0	0
11	2920219	.	T	A	3	1	4	0	1	5	0	0
11	2922443	.	A	G	2	2	4	0	0	4	0	0
11	2930652	.	G	A	2	2	4	0	0	4	0	0
11	2963209	.	A	T	3	3	6	0	0	6	0	0
11	2963218	.	C	T	4	3	7	0	0	7	0	0
11	2968279	.	C	A	2	3	5	0	0	5	0	0
11	2968410	.	A	G	2	3	5	1	0	6	0	0
11	3086100	.	G	A	1	4	5	0	4	9	0	0
11	3122886	.	A	T	7	5	12	0	0	12	0	0
11	3148157	.	C	A	7	3	10	1	1	12	0	0
11	3170359	.	A	G	1	0	1	0	4	5	0	0
11	3172677	.	G	A	1	7	8	0	9	17	0	0
11	3195739	.	G	T	0	6	6	0	5	11	0	0
11	3195757	.	A	C	5	7	12	0	0	12	0	0
11	3212009	.	T	C	4	4	8	0	0	8	0	0
11	3217970	.	C	T	2	7	9	0	0	9	0	0
11	3221014	.	C	T	3	7	10	0	1	11	0	0
11	3222083	.	A	G	3	4	7	0	0	7	0	0
11	3222192	.	T	C	2	4	6	0	0	6	0	0
11	3227302	.	A	T	5	6	11	0	0	11	0	0
11	3227343	.	G	A	4	3	7	0	0	7	0	0
11	3227451	.	C	T	4	2	6	0	0	6	0	0
11	3230284	.	G	A	5	5	10	0	0	10	0	0
11	3230820	.	G	A	0	2	2	0	5	7	0	0
11	3232905	.	C	G	2	3	5	0	0	5	0	0
11	3235543	.	C	T	5	6	11	0	0	11	0	0
11	3238484	.	A	G	5	7	12	0	0	12	0	0
11	3238651	.	C	T	4	11	15	0	0	15	0	0
11	3238720	.	T	C	3	8	11	0	1	12	0	0
11	3240457	.	G	A	0	13	13	0	9	22	0	0
11	3243124	.	A	G	5	0	5	0	11	16	0	0
11	3246120	.	A	G	6	6	12	0	0	12	0	0
11	3246133	.	A	G	8	9	17	0	0	17	0	0
11	3246590	.	A	C	3	3	6	11	0	17	0	0
11	3249253	.	C	T	3	5	8	0	0	8	0	0
11	3249346	.	C	T	7	5	12	0	0	12	0	0
11	3249370	.	A	G	5	1	6	0	2	8	0	0
11	3317226	.	T	C	12	7	19	0	0	19	0	0
11	3317229	.	G	T	11	8	19	0	0	19	0	0
11	3317389	.	A	T	9	15	24	0	0	24	0	0
11	3323377	.	G	T	11	4	15	0	1	16	0	0
11	3327451	.	G	A	7	3	10	0	0	10	0	0
11	3333841	.	T	C	4	5	9	0	0	9	0	0
11	3333854	.	A	G	5	5	10	0	0	10	0	0
11	3336700	.	T	G	20	30	50	0	2	52	0	0
11	3336793	.	C	T	29	34	63	0	3	66	0	0
11	3337038	.	A	G	37	31	68	0	5	73	0	0
11	3337253	.	A	G	32	36	68	0	0	68	0	0
11	3337256	.	T	C	34	1	35	0	34	69	0	0
11	3337481	.	T	G	29	25	54	0	3	57	0	0
11	3337482	.	A	T	29	25	54	0	3	57	0	0
11	3337718	.	G	C	25	23	48	0	1	49	0	0
11	3338060	.	C	G	25	20	45	0	0	45	0	0
11	3338144	.	T	C	37	24	61	0	1	62	0	0
11	3338288	.	T	A	47	13	60	0	1	61	0	0
11	3338299	.	T	G	39	16	55	0	1	56	0	0
11	3338420	.	A	T	30	32	62	0	4	66	0	0
11	3338431	.	C	T	3	31	34	0	29	63	0	0
11	3338491	.	G	A	25	29	54	0	4	58	0	0
11	3338514	.	C	A	35	31	66	0	0	66	0	0
11	3338618	.	T	C	36	26	62	0	0	62	0	0
11	3338638	.	A	G	32	24	56	0	5	61	0	0
11	3338933	.	A	G	26	32	58	0	5	63	0	0
11	3339098	.	T	C	33	3	36	0	24	60	0	0
11	3339152	.	C	T	28	27	55	0	1	56	0	0
11	3341296	.	G	A	33	29	62	0	0	62	0	0
11	3345952	.	T	C	3	2	5	0	0	5	0	0
11	3346128	.	T	G	5	4	9	0	0	9	0	0
11	3346456	.	C	T	1	2	3	0	0	3	0	0
11	3347717	.	T	C	3	0	3	0	3	6	0	0
11	3347727	.	T	C	3	0	3	0	3	6	0	0
11	3348004	.	T	G	2	6	8	0	1	9	0	0
11	3351300	.	A	G	6	2	8	0	0	8	0	0
11	3351331	.	A	C	5	2	7	0	0	7	0	0
11	3367924	.	G	C	10	8	18	0	1	19	0	0
11	3367937	.	T	C	11	6	17	0	0	17	0	0
11	3369843	.	G	A	2	5	7	0	2	9	0	0
11	3373418	.	A	G	7	13	20	0	0	20	0	0
11	3373448	.	G	A	10	8	18	0	2	20	0	0
11	3373996	.	C	T	1	10	11	0	10	21	0	0
11	3377127	.	T	C	5	0	5	0	6	11	0	0
11	3379999	.	G	T	8	8	16	0	0	16	0	0
11	3380012	.	C	G	9	6	15	0	0	15	0	0
11	3380135	.	A	G	5	7	12	0	0	12	0	0
11	3381261	.	C	A	5	7	12	0	2	14	0	0
11	3395069	.	G	A	16	14	30	0	1	31	0	0
11	3395070	.	A	T	17	15	32	0	0	32	0	0
11	3395303	.	G	A	19	11	30	0	1	31	0	0
11	3395324	.	C	T	18	17	35	0	1	36	0	0
11	3395501	.	A	G	14	16	30	0	0	30	0	0
11	3398738	.	A	C	14	1	15	0	13	28	0	0
11	3401899	.	C	A	11	11	22	0	1	23	0	0
11	3422086	.	T	C	5	4	9	0	0	9	0	0
11	3423390	.	G	A	10	7	17	0	0	17	0	0
11	3423411	.	A	G	7	6	13	0	0	13	0	0
11	3425175	.	G	A	5	13	18	0	2	20	0	0
11	3425579	.	C	T	12	13	25	0	3	28	0	0
11	3494891	.	A	G	18	7	25	0	1	26	0	0
11	3494930	.	T	A	5	8	13	0	1	14	0	0
11	3514154	.	T	C	1	3	4	0	0	4	0	0
11	3520694	.	C	A	3	2	5	0	0	5	0	0
11	3523724	.	A	G	4	14	18	0	2	20	0	0
11	3523826	.	G	A	10	5	15	0	2	17	0	0
11	3523976	.	A	C	8	1	9	0	10	19	0	0
11	3523991	.	C	T	9	10	19	0	0	19	0	0
11	3524064	.	G	T	7	11	18	0	1	19	0	0
11	3524111	.	G	A	9	13	22	0	0	22	0	0
11	3524121	.	A	G	12	13	25	0	0	25	0	0
11	3524236	.	C	T	17	6	23	0	0	23	0	0
11	3524397	.	T	C	9	14	23	0	0	23	0	0
11	3524462	.	C	T	7	12	19	0	0	19	0	0
11	3524541	.	A	T	11	9	20	0	0	20	0	0
11	3524724	.	T	A	4	11	15	0	0	15	0	0
11	3524849	.	G	A	7	16	23	0	0	23	0	0
11	3526521	.	A	G	11	11	22	0	1	23	0	0
11	3526605	.	C	G	17	17	34	0	0	34	0	0
11	3528320	.	A	T	23	9	32	0	0	32	0	0
11	3530791	.	C	G	11	10	21	0	0	21	0	0
11	3532836	.	A	G	7	3	10	0	0	10	0	0
11	3533330	.	T	C	6	0	6	0	6	12	0	0
11	3533345	.	T	C	7	0	7	0	8	15	0	0
11	3535326	.	A	G	14	8	22	0	1	23	0	0
11	3535397	.	A	G	9	8	17	0	0	17	0	0
11	3535431	.	T	C	5	6	11	0	0	11	0	0
11	3535434	.	A	G	6	5	11	0	0	11	0	0
11	3550448	.	A	G	7	3	10	0	0	10	0	0
11	3550454	.	T	A	6	5	11	0	2	13	0	0
11	3550588	.	T	C	14	0	14	0	16	30	0	0
11	3551309	.	A	G	32	18	50	0	1	51	0	0
11	3551944	.	G	A	26	23	49	0	2	51	0	0
11	3563124	.	G	A	1	4	5	0	0	5	0	0
11	3579430	.	T	A	2	3	5	0	0	5	0	0
11	3593309	.	T	C	2	5	7	0	1	8	0	0
11	3593490	.	A	C	9	7	16	0	0	16	0	0
11	3593748	.	A	G	8	12	20	0	0	20	0	0
11	3593988	.	G	T	5	15	20	0	2	22	0	0
11	3594217	.	G	T	10	13	23	0	1	24	0	0
11	3594277	.	T	G	12	10	22	0	0	22	0	0
11	3594321	.	T	C	9	0	9	0	8	17	0	0
11	3594327	.	T	A	8	7	15	0	0	15	0	0
11	3594366	.	A	G	3	13	16	0	2	18	0	0
11	3594419	.	A	G	4	10	14	0	3	17	0	0
11	3594452	.	T	G	5	4	9	3	7	19	0	0
11	3595140	.	A	C	5	0	5	0	6	11	0	0
11	3595308	.	G	A	6	6	12	0	0	12	0	0
11	3595579	.	A	G	11	16	27	0	0	27	0	0
11	3602382	.	T	C	9	10	19	0	1	20	0	0
11	3603392	.	A	G	3	8	11	0	0	11	0	0
11	3603434	.	T	C	2	8	10	0	1	11	0	0
11	3604729	.	T	G	5	8	13	0	0	13	0	0
11	3604732	.	C	G	0	7	7	0	7	14	0	0
11	3606897	.	C	T	11	9	20	0	0	20	0	0
11	3606914	.	T	C	13	0	13	0	12	25	0	0
11	3606957	.	C	T	12	13	25	0	1	26	0	0
11	3608704	.	A	C	12	4	16	0	0	16	0	0
11	3609427	.	A	G	8	4	12	0	0	12	0	0
11	3609448	.	A	T	9	5	14	0	0	14	0	0
11	3630875	.	G	A	2	2	4	0	0	4	0	0
11	3631100	.	A	G	2	4	6	0	0	6	0	0
11	3632643	.	C	T	4	4	8	0	0	8	0	0
11	3848283	.	G	A	12	13	25	0	1	26	0	0
11	3848323	.	C	T	1	9	10	0	15	25	0	0
11	3848656	.	C	T	10	13	23	0	0	23	0	0
11	3860159	.	A	T	4	4	8	0	1	9	0	0
11	3893635	.	C	T	24	9	33	0	0	33	0	0
11	3893636	.	T	G	21	9	30	0	2	32	0	0
11	3893918	.	G	A	22	17	39	0	3	42	0	0
11	3893928	.	G	C	21	15	36	0	2	38	0	0
11	3894023	.	T	C	11	27	38	0	1	39	0	0
11	3898730	.	C	A	2	18	20	0	18	38	0	0
11	3898736	.	A	G	17	17	34	0	0	34	0	0
11	3899066	.	C	A	1	21	22	0	14	37	1	0
11	3899117	.	G	A	14	17	31	0	0	31	0	0
11	3901733	.	C	G	3	20	23	0	21	44	0	0
11	3904469	.	A	G	11	24	35	0	2	37	0	0
11	3904517	.	C	G	1	26	27	0	13	40	0	0
11	3904564	.	C	T	21	25	46	0	0	46	0	0
11	3904666	.	A	G	18	25	43	0	0	43	0	0
11	3904674	.	T	G	18	24	42	0	1	43	0	0
11	3905928	.	A	G	10	19	29	0	2	31	0	0
11	3917723	.	A	G	13	12	25	0	2	27	0	0
11	3921491	.	A	G	20	14	34	0	1	35	0	0
11	3921563	.	T	A	17	19	36	0	0	36	0	0
11	3922983	.	G	A	6	16	22	0	1	23	0	0
11	3925822	.	T	C	10	0	10	0	8	18	0	0
11	3925906	.	A	G	13	9	22	0	2	24	0	0
11	3925939	.	T	C	12	7	19	0	0	19	0	0
11	3928044	.	A	T	9	6	15	0	2	17	0	0
11	3928168	.	T	C	11	11	22	0	1	23	0	0
11	3931773	.	C	T	18	8	26	0	1	27	0	0
11	3933807	.	G	A	7	9	16	0	1	17	0	0
11	3933956	.	A	G	8	4	12	0	0	12	0	0
11	3934190	.	A	G	14	13	27	0	1	28	0	0
11	3934319	.	T	G	9	9	18	0	1	19	0	0
11	3936378	.	T	A	9	7	16	0	0	16	0	0
11	3938816	.	G	A	8	5	13	0	0	13	0	0
11	3939291	.	C	G	0	11	11	0	8	19	0	0
11	3941180	.	C	T	4	7	11	0	2	13	0	0
11	3952936	.	T	C	7	0	7	0	10	17	0	0
11	3963388	.	C	T	7	4	11	0	0	11	0	0
11	3963581	.	C	T	4	4	8	0	0	8	0	0
11	3963608	.	G	T	2	6	8	0	1	9	0	0
11	3963639	.	T	A	3	6	9	0	0	9	0	0
11	3964193	.	T	A	6	5	11	0	1	12	0	0
11	3965837	.	G	A	8	13	21	0	0	21	0	0
11	3965867	.	C	T	7	8	15	0	1	16	0	0
11	3965984	.	T	A	9	6	15	0	3	18	0	0
11	3966360	.	G	C	0	8	8	0	5	13	0	0
11	3967408	.	A	G	3	0	3	0	6	9	0	0
11	3967445	.	A	G	6	6	12	0	1	13	0	0
11	3968866	.	T	C	5	8	13	0	0	13	0	0
11	3968877	.	G	A	6	6	12	0	1	13	0	0
11	3968915	.	T	G	5	5	10	0	1	11	0	0
11	3970703	.	T	A	1	2	3	0	0	3	0	0
11	3993452	.	G	A	0	3	3	0	6	9	0	0
11	3994901	.	C	A	2	2	4	0	0	5	1	0
11	3995459	.	G	A	4	2	6	0	0	6	0	0
11	3995479	.	G	T	1	2	3	0	0	3	0	0
11	3997023	.	T	C	2	0	2	0	4	6	0	0
11	3997029	.	C	A	0	5	5	0	2	7	0	0
11	4004042	.	G	C	2	5	7	0	0	7	0	0
11	4006924	.	C	T	0	4	4	0	2	6	0	0
11	4006956	.	C	T	1	4	5	0	1	6	0	0
11	4010895	.	C	T	5	7	12	0	0	12	0	0
11	4014428	.	A	T	1	2	3	0	1	4	0	0
11	4014458	.	A	G	6	4	10	0	0	10	0	0
11	4014634	.	A	G	4	3	7	0	0	7	0	0
11	4014737	.	C	T	1	2	3	0	0	3	0	0
11	4023804	.	G	A	1	3	4	0	0	4	0	0
11	4023813	.	T	G	1	2	3	0	0	3	0	0
11	4026308	.	C	T	12	7	19	0	0	19	0	0
11	4113825	.	G	A	1	12	13	0	8	21	0	0
11	4128836	.	A	T	12	24	36	0	0	36	0	0
11	4129261	.	T	C	1	3	4	0	0	4	0	0
11	4131300	.	A	T	7	5	12	0	0	12	0	0
11	4131423	.	T	A	12	9	21	0	0	21	0	0
11	4132110	.	G	T	13	7	20	0	0	20	0	0
11	4132296	.	A	C	26	24	50	0	1	51	0	0
11	4132378	.	G	C	12	8	20	1	0	21	0	0
11	4132440	.	A	G	7	14	21	0	0	21	0	0
11	4132599	.	T	C	11	3	14	0	1	15	0	0
11	4205612	.	T	A	2	4	6	0	0	6	0	0
11	4209004	.	T	C	3	9	12	0	2	14	0	0
11	4219556	.	A	C	2	6	8	0	0	8	0	0
11	4786972	.	G	A	1	2	3	3	0	6	0	0
11	4954023	.	A	C	0	2	2	0	1	3	0	0
11	5923138	.	T	G	5	0	5	0	12	17	0	0
11	10670439	.	T	C	32	15	47	1	7	55	0	0
11	10672087	.	T	C	35	10	45	0	3	48	0	0
11	11126751	.	C	T	7	7	14	0	0	14	0	0
11	11126781	.	G	A	0	7	7	0	7	14	0	0
11	11141647	.	A	G	6	0	6	0	10	16	0	0
11	11141779	.	G	A	5	7	12	0	1	13	0	0
11	11148954	.	T	A	6	9	15	0	0	15	0	0
11	11148961	.	A	T	6	7	13	0	1	14	0	0
11	11154884	.	A	T	6	6	12	0	0	12	0	0
11	11155148	.	T	G	5	8	13	0	0	13	0	0
11	11157255	.	C	A	10	9	19	0	0	19	0	0
11	11159916	.	A	G	10	5	15	0	0	15	0	0
11	11161603	.	T	A	8	6	14	1	1	16	0	0
11	11161929	.	A	G	10	0	10	0	11	21	0	0
11	11171320	.	T	G	10	11	21	0	2	23	0	0
11	11171351	.	A	G	13	8	21	0	0	21	0	0
11	11171613	.	C	T	6	6	12	0	0	12	0	0
11	11177387	.	T	C	16	16	32	0	0	32	0	0
11	11177406	.	C	T	18	16	34	0	1	35	0	0
11	11177436	.	T	C	22	15	37	0	0	37	0	0
11	11177481	.	A	G	12	8	20	0	1	21	0	0
11	11181955	.	G	A	1	15	16	0	10	26	0	0
11	11181978	.	C	T	12	16	28	0	0	28	0	0
11	11182072	.	C	T	11	14	25	0	0	25	0	0
11	11184707	.	C	T	16	17	33	0	0	33	0	0
11	11184743	.	A	C	16	15	31	0	3	34	0	0
11	11184818	.	T	C	13	16	29	0	2	31	0	0
11	11185053	.	G	A	17	10	27	0	1	28	0	0
11	11185074	.	G	C	15	10	25	0	1	26	0	0
11	11185175	.	G	C	17	5	22	0	2	24	0	0
11	11186248	.	G	C	10	11	21	0	1	22	0	0
11	11191840	.	C	T	19	16	35	0	4	39	0	0
11	11191845	.	C	T	19	17	36	0	4	40	0	0
11	11191995	.	T	C	23	18	41	0	0	41	0	0
11	11192053	.	C	T	8	24	32	0	0	32	0	0
11	11192170	.	T	A	12	8	20	0	1	21	0	0
11	11192276	.	G	A	15	16	31	0	1	32	0	0
11	11192342	.	T	G	9	10	19	0	0	19	0	0
11	11192724	.	T	C	16	11	27	0	0	27	0	0
11	11193030	.	C	T	5	4	9	0	0	9	0	0
11	11274615	.	A	T	20	14	34	0	2	36	0	0
11	11278338	.	T	C	1	0	1	0	3	4	0	0
11	11314887	.	A	G	2	2	4	0	0	4	0	0
11	11324286	.	T	G	10	10	20	0	1	21	0	0
11	11324295	.	T	G	9	10	19	0	0	19	0	0
11	11325486	.	G	A	11	9	20	0	0	20	0	0
11	11326502	.	A	G	6	20	26	0	0	26	0	0
11	11326671	.	G	A	10	17	27	0	1	28	0	0
11	11326968	.	C	A	1	9	10	0	8	18	0	0
11	11332856	.	T	C	2	6	8	0	0	8	0	0
11	11332986	.	A	G	3	4	7	0	0	7	0	0
11	11332990	.	T	A	2	2	4	0	2	6	0	0
11	11333116	.	C	A	5	4	9	0	0	9	0	0
11	11333135	.	C	T	4	2	6	0	0	6	0	0
11	11333661	.	T	G	4	5	9	0	0	9	0	0
11	11333670	.	T	G	3	4	7	0	0	7	0	0
11	11468756	.	T	G	11	12	23	0	2	25	0	0
11	11469128	.	C	T	11	10	21	0	4	25	0	0
11	11469143	.	C	T	14	10	24	0	0	24	0	0
11	11469203	.	G	A	14	10	24	0	0	24	0	0
11	11469215	.	C	T	11	10	21	2	1	24	0	0
11	11469632	.	G	A	8	11	19	2	1	22	0	0
11	11469968	.	C	T	10	6	16	0	0	16	0	0
11	11470678	.	A	C	7	12	19	0	1	20	0	0
11	11470994	.	T	C	9	8	17	0	1	18	0	0
11	11471147	.	C	A	12	6	18	0	1	19	0	0
11	11471434	.	T	A	6	9	15	0	0	15	0	0
11	11516279	.	T	C	1	0	1	0	7	8	0	0
11	11597374	.	A	G	6	12	18	0	1	19	0	0
11	11597679	.	G	C	7	15	22	0	1	24	1	0
11	11597985	.	A	T	9	8	17	0	0	17	0	0
11	11598692	.	C	A	26	18	44	0	1	45	0	0
11	11602628	.	G	A	6	10	16	0	1	17	0	0
11	11607492	.	G	A	12	14	26	0	0	26	0	0
11	11607498	.	C	G	12	14	26	0	2	28	0	0
11	11607705	.	C	T	12	15	27	0	0	27	0	0
11	11612715	.	G	A	15	6	21	0	0	21	0	0
11	11612758	.	A	G	8	9	17	0	2	19	0	0
11	11612773	.	C	T	8	8	16	0	0	16	0	0
11	11614914	.	A	T	15	5	20	0	0	20	0	0
11	11614927	.	T	A	12	3	15	0	2	17	0	0
11	11616542	.	G	A	14	6	20	0	0	20	0	0
11	11619931	.	A	G	13	9	22	0	0	22	0	0
11	11624909	.	C	T	12	10	22	0	0	22	0	0
11	11624939	.	T	C	11	9	20	0	1	21	0	0
11	11625066	.	C	G	7	13	20	0	0	20	0	0
11	11625169	.	C	G	7	21	28	0	1	29	0	0
11	11759425	.	G	A	3	2	5	0	0	5	0	0
11	11770452	.	T	C	1	2	3	0	0	3	0	0
11	11780496	.	A	G	2	4	6	0	0	6	0	0
11	11780737	.	A	T	3	5	8	0	0	8	0	0
11	11780816	.	A	T	2	3	5	0	0	5	0	0
11	11780863	.	A	G	3	0	3	0	5	8	0	0
11	11780935	.	T	C	2	5	7	0	1	8	0	0
11	11781172	.	C	T	1	2	3	0	0	3	0	0
11	11871042	.	A	C	4	3	7	0	0	7	0	0
11	11871049	.	C	T	0	4	4	0	3	7	0	0
11	11911622	.	T	C	1	0	1	0	4	5	0	0
11	11918607	.	A	C	4	2	6	0	1	7	0	0
11	11928205	.	C	T	4	3	7	0	1	8	0	0
11	11929594	.	G	T	3	4	7	0	0	7	0	0
11	11932967	.	C	T	0	3	3	0	1	4	0	0
11	11933117	.	G	A	1	2	3	0	0	3	0	0
11	11933558	.	G	A	2	3	5	0	0	5	0	0
11	11946298	.	C	A	0	2	2	0	5	7	0	0
11	11946519	.	C	T	0	3	3	0	4	7	0	0
11	11946561	.	A	G	2	2	4	0	0	4	0	0
11	11956394	.	T	C	2	2	4	0	0	4	0	0
11	11978749	.	T	C	1	2	3	0	0	3	0	0
11	11978750	.	G	A	1	2	3	0	0	3	0	0
11	11983710	.	T	C	8	1	9	0	8	17	0	0
11	11983713	.	A	C	8	9	17	0	0	17	0	0
11	11983748	.	A	C	6	0	6	0	4	10	0	0
11	11983789	.	G	T	7	5	12	0	0	12	0	0
11	11983827	.	C	T	5	3	8	0	0	8	0	0
11	11983868	.	C	T	1	3	4	0	4	8	0	0
11	11983937	.	T	C	5	4	9	0	0	9	0	0
11	11984120	.	A	G	1	3	4	0	1	5	0	0
11	11984227	.	G	A	1	5	6	0	0	6	0	0
11	11984666	.	A	G	12	8	20	0	0	20	0	0
11	12004040	.	T	C	11	5	16	0	0	16	0	0
11	12004277	.	A	G	8	7	15	0	0	15	0	0
11	12004304	.	G	T	6	7	13	0	0	13	0	0
11	12016650	.	G	A	17	12	29	0	3	32	0	0
11	12050039	.	T	C	9	8	17	0	1	18	0	0
11	12050265	.	A	G	3	12	15	0	0	15	0	0
11	12050291	.	G	A	3	10	13	0	0	13	0	0
11	12051505	.	G	T	10	11	21	0	0	21	0	0
11	12091534	.	T	C	1	3	4	0	0	4	0	0
11	12096578	.	C	T	4	5	9	0	1	10	0	0
11	12096593	.	G	A	4	6	10	0	1	11	0	0
11	12108486	.	T	C	10	9	19	0	0	19	0	0
11	12108725	.	G	A	10	9	19	0	1	20	0	0
11	12108822	.	C	A	6	8	14	0	1	15	0	0
11	12130708	.	A	G	16	15	31	0	1	32	0	0
11	12131044	.	T	G	14	14	28	0	1	29	0	0
11	12136025	.	A	C	8	0	8	0	15	23	0	0
11	12141467	.	T	C	8	6	14	0	0	14	0	0
11	12141482	.	A	G	8	7	15	0	0	15	0	0
11	12146303	.	G	A	7	5	12	0	1	13	0	0
11	12152056	.	G	T	8	4	12	0	0	12	0	0
11	12720049	.	T	A	26	18	44	0	1	45	0	0
11	12727504	.	A	G	14	32	46	0	2	48	0	0
11	12727685	.	T	C	17	15	32	0	1	33	0	0
11	12727879	.	A	C	9	6	15	0	0	15	0	0
11	12728195	.	T	G	8	11	19	0	0	19	0	0
11	12728249	.	C	T	3	11	14	0	0	14	0	0
11	12732505	.	A	T	8	6	14	0	1	15	0	0
11	12732556	.	G	C	2	4	6	0	0	6	0	0
11	12732696	.	T	A	3	3	6	0	0	6	0	0
11	12732950	.	G	T	4	3	7	0	1	8	0	0
11	12732975	.	T	A	3	3	6	0	1	7	0	0
11	12733004	.	C	T	3	5	8	0	1	9	0	0
11	12733142	.	T	C	7	2	9	0	0	9	0	0
11	12733278	.	G	C	3	3	6	0	0	6	0	0
11	12733443	.	T	A	5	4	9	0	0	9	0	0
11	12733502	.	C	T	4	3	7	0	0	7	0	0
11	12733741	.	C	T	3	6	9	0	2	11	0	0
11	12733743	.	G	A	3	6	9	0	2	11	0	0
11	12733892	.	T	G	3	5	8	0	0	8	0	0
11	12733965	.	C	T	4	3	7	0	0	7	0	0
11	12734072	.	G	A	3	3	6	0	1	7	0	0
11	12738852	.	A	T	2	3	5	0	0	5	0	0
11	12752161	.	A	T	1	3	4	0	0	4	0	0
11	12759409	.	G	A	3	7	10	0	0	10	0	0
11	12759728	.	G	T	8	12	20	0	0	20	0	0
11	12759737	.	C	T	9	11	20	0	0	20	0	0
11	12767964	.	A	G	9	0	9	0	10	19	0	0
11	12768221	.	C	T	9	14	23	0	2	25	0	0
11	12768299	.	C	T	9	8	17	0	0	17	0	0
11	12768351	.	A	G	8	9	17	0	1	18	0	0
11	12768394	.	A	C	6	4	10	0	0	10	0	0
11	12768480	.	C	T	4	3	7	0	0	7	0	0
11	12782503	.	G	A	5	5	10	0	0	10	0	0
11	12782524	.	A	C	3	5	8	1	0	9	0	0
11	12782593	.	T	C	7	0	7	0	7	14	0	0
11	12784355	.	T	A	1	3	4	0	0	4	0	0
11	12784635	.	G	T	4	3	7	0	0	7	0	0
11	12790168	.	T	C	1	4	5	0	0	5	0	0
11	12795711	.	T	C	5	4	9	0	0	9	0	0
11	12800822	.	G	A	2	3	5	0	0	5	0	0
11	12800823	.	C	G	2	3	5	0	0	5	0	0
11	12800869	.	C	T	4	2	6	0	0	6	0	0
11	12814794	.	C	G	1	0	1	0	3	4	0	0
11	12814833	.	T	G	1	0	1	0	4	5	0	0
11	12814837	.	C	A	4	2	6	0	0	6	0	0
11	12833895	.	A	G	1	0	1	0	3	4	0	0
11	12834937	.	A	G	2	3	5	0	0	5	0	0
11	12845101	.	T	A	2	5	7	0	0	7	0	0
11	12845150	.	T	C	1	4	5	0	0	5	0	0
11	12845160	.	G	A	0	4	4	0	1	5	0	0
11	12860900	.	G	A	3	6	9	0	0	9	0	0
11	12861196	.	A	G	5	2	7	0	1	8	0	0
11	12869192	.	G	T	0	13	13	0	6	19	0	0
11	12869309	.	T	C	5	4	9	0	0	9	0	0
11	12869409	.	C	A	8	8	16	0	0	16	0	0
11	12869414	.	C	T	8	8	16	0	0	16	0	0
11	12987786	.	G	A	3	2	5	0	0	5	0	0
11	12987798	.	A	C	2	2	4	0	1	5	0	0
11	12987870	.	G	T	3	2	5	0	0	5	0	0
11	12988038	.	G	A	6	4	10	0	1	11	0	0
11	13055470	.	G	A	18	24	42	0	6	48	0	0
11	13055694	.	C	A	9	3	12	0	2	14	0	0
11	13055748	.	T	C	1	2	3	0	1	4	0	0
11	13062201	.	C	G	7	13	20	0	0	20	0	0
11	13067750	.	A	T	8	6	14	0	2	16	0	0
11	13071855	.	C	T	7	12	19	0	0	19	0	0
11	13071920	.	A	G	9	5	14	0	0	14	0	0
11	13074127	.	T	C	7	9	16	0	1	17	0	0
11	13082107	.	C	T	10	7	17	0	0	17	0	0
11	13085294	.	G	A	8	16	24	0	1	25	0	0
11	13094199	.	C	T	19	7	26	0	0	26	0	0
11	13094247	.	A	G	11	7	18	0	4	22	0	0
11	13094368	.	T	A	8	5	13	0	0	13	0	0
11	13094473	.	A	T	12	15	27	0	2	29	0	0
11	13094668	.	C	A	18	17	35	0	1	36	0	0
11	13094678	.	T	C	15	14	29	0	3	32	0	0
11	13094778	.	T	C	11	17	28	1	3	32	0	0
11	13094938	.	G	T	20	26	46	0	1	47	0	0
11	13095049	.	G	A	14	23	37	0	4	41	0	0
11	13101333	.	C	T	17	10	27	0	1	28	0	0
11	13101378	.	A	G	11	9	20	0	2	22	0	0
11	13104057	.	C	A	2	12	14	0	7	21	0	0
11	13182850	.	C	T	2	4	6	0	0	6	0	0
11	13185970	.	C	T	1	2	3	0	0	3	0	0
11	13188425	.	G	C	3	3	6	0	0	6	0	0
11	13188669	.	C	T	4	2	6	0	0	6	0	0
11	13189339	.	G	T	4	4	8	0	0	8	0	0
11	13208755	.	T	A	49	28	77	0	5	82	0	0
11	13208839	.	C	G	33	45	78	0	0	78	0	0
11	13209085	.	G	C	36	35	71	0	5	76	0	0
11	13209391	.	C	T	39	39	78	0	2	80	0	0
11	13210650	.	A	C	40	29	69	0	3	72	0	0
11	13210667	.	C	T	35	35	70	0	2	72	0	0
11	13210897	.	A	T	45	25	70	0	1	71	0	0
11	13210906	.	C	T	26	42	68	0	1	69	0	0
11	13212186	.	A	T	38	38	76	0	6	82	0	0
11	13212306	.	C	T	33	40	73	0	1	74	0	0
11	13280445	.	T	C	11	7	18	0	1	19	0	0
11	13281122	.	T	C	18	10	28	0	0	28	0	0
11	13281243	.	C	A	10	3	13	0	1	14	0	0
11	13281331	.	A	T	10	8	18	0	1	19	0	0
11	13281398	.	G	C	5	4	9	0	1	10	0	0
11	13281653	.	C	T	17	14	31	0	1	32	0	0
11	13281979	.	A	G	4	10	14	0	0	14	0	0
11	13282130	.	T	C	14	6	20	1	0	21	0	0
11	13282201	.	G	T	9	5	14	2	0	17	1	0
11	13282210	.	T	A	7	6	13	2	0	16	1	0
11	13282267	.	T	C	1	0	1	0	9	10	0	0
11	13282660	.	C	T	13	8	21	0	1	22	0	0
11	13282881	.	T	C	4	8	12	0	0	12	0	0
11	13282883	.	A	G	3	7	10	0	2	12	0	0
11	13283156	.	T	A	15	10	25	0	0	25	0	0
11	13283181	.	C	T	10	10	20	0	3	23	0	0
11	13283220	.	C	G	0	17	17	0	8	25	0	0
11	13283243	.	T	C	7	0	7	0	18	25	0	0
11	13283368	.	C	A	13	11	24	0	1	25	0	0
11	13283403	.	T	G	10	11	21	0	0	21	0	0
11	13283447	.	G	A	12	10	22	0	1	23	0	0
11	13283476	.	C	T	12	9	21	0	1	22	0	0
11	13283634	.	C	T	8	7	15	0	0	15	0	0
11	13292012	.	C	T	9	10	19	0	0	19	0	0
11	13292027	.	A	T	7	8	15	0	0	15	0	0
11	13292084	.	A	G	5	14	19	0	1	20	0	0
11	13292105	.	C	T	1	15	16	0	8	24	0	0
11	13292462	.	C	T	16	11	27	0	0	27	0	0
11	13292576	.	C	T	1	16	17	0	14	31	0	0
11	13297711	.	T	C	8	6	14	0	0	14	0	0
11	13304426	.	G	A	10	4	14	0	0	14	0	0
11	13305949	.	G	A	9	10	19	0	0	19	0	0
11	13306186	.	C	T	7	7	14	0	0	14	0	0
11	13313163	.	G	A	8	5	13	0	0	13	0	0
11	13313208	.	C	T	6	5	11	0	1	12	0	0
11	13313524	.	G	A	10	8	18	0	0	18	0	0
11	13341403	.	G	C	2	3	5	0	0	5	0	0
11	13424515	.	A	G	2	2	4	0	0	4	0	0
11	13445944	.	A	T	2	7	9	0	1	10	0	0
11	13446023	.	C	T	3	6	9	0	0	9	0	0
11	13480158	.	G	A	0	2	2	0	3	5	0	0
11	13485112	.	C	T	2	5	7	0	0	7	0	0
11	13485140	.	A	G	6	0	6	0	4	10	0	0
11	13503730	.	A	G	3	2	5	0	0	5	0	0
11	13530399	.	A	C	4	5	9	0	0	9	0	0
11	13530498	.	G	A	6	5	11	0	0	11	0	0
11	13531730	.	C	T	6	5	11	0	0	11	0	0
11	13531954	.	C	T	12	5	17	0	0	17	0	0
11	13532763	.	C	T	2	8	10	0	0	10	0	0
11	13533072	.	A	G	13	4	17	0	0	17	0	0
11	13533094	.	T	G	5	14	19	0	0	19	0	0
11	13533124	.	G	A	14	7	21	0	0	21	0	0
11	13533429	.	G	T	5	7	12	0	0	12	0	0
11	13636198	.	C	T	3	7	10	0	0	10	0	0
11	13636239	.	T	C	5	6	11	0	0	11	0	0
11	13639185	.	C	G	7	4	11	0	0	11	0	0
11	13697910	.	T	C	1	3	4	0	0	4	0	0
11	14014617	.	T	C	2	2	4	0	0	4	0	0
11	14015532	.	G	A	0	2	2	0	1	3	0	0
11	14017627	.	C	A	4	3	7	0	0	7	0	0
11	14062157	.	T	G	3	3	6	0	0	6	0	0
11	14062908	.	A	G	7	7	14	0	2	16	0	0
11	14062972	.	G	A	3	3	6	0	0	6	0	0
11	14063185	.	C	T	2	2	4	0	1	5	0	0
11	14063191	.	G	C	3	1	4	0	0	4	0	0
11	14064036	.	T	C	3	2	5	0	1	6	0	0
11	14064229	.	T	C	1	2	3	0	0	3	0	0
11	14064419	.	A	G	4	2	6	0	0	6	0	0
11	14064454	.	A	G	3	3	6	0	0	6	0	0
11	14073311	.	T	C	3	9	12	0	0	12	0	0
11	14073338	.	C	T	8	3	11	0	0	11	0	0
11	14073503	.	G	A	10	5	15	0	0	15	0	0
11	14073560	.	T	A	8	6	14	0	0	14	0	0
11	14073730	.	G	T	8	10	18	0	0	18	0	0
11	14074125	.	T	C	2	9	11	0	0	11	0	0
11	14074174	.	T	C	5	9	14	0	1	15	0	0
11	14074245	.	T	C	5	9	14	0	0	14	0	0
11	14074397	.	A	G	6	4	10	0	1	11	0	0
11	14074584	.	T	G	1	3	4	0	2	7	1	0
11	14074628	.	T	A	5	2	7	0	0	7	0	0
11	14074951	.	C	T	6	5	11	0	1	12	0	0
11	14074952	.	A	T	7	5	12	0	0	12	0	0
11	14075147	.	G	A	7	9	16	0	0	16	0	0
11	14075302	.	A	G	12	8	20	0	0	20	0	0
11	14101497	.	A	T	10	6	16	0	0	16	0	0
11	14101521	.	A	T	11	4	15	0	0	15	0	0
11	14101597	.	G	A	4	4	8	0	0	8	0	0
11	14101765	.	T	C	3	3	6	0	0	6	0	0
11	14101770	.	T	C	3	4	7	0	0	7	0	0
11	14102018	.	C	T	3	4	7	0	0	7	0	0
11	14104721	.	T	C	1	2	3	0	1	4	0	0
11	14112328	.	A	G	3	4	7	0	0	7	0	0
11	14143452	.	C	A	5	7	12	0	1	13	0	0
11	14148179	.	A	G	19	7	26	0	1	27	0	0
11	14148341	.	T	A	15	17	32	1	2	35	0	0
11	14149964	.	T	C	17	16	33	0	2	35	0	0
11	14159425	.	C	T	25	23	48	0	1	49	0	0
11	14159513	.	A	G	18	19	37	0	1	38	0	0
11	14159555	.	A	G	23	22	45	0	1	46	0	0
11	14159622	.	T	C	23	14	37	0	1	38	0	0
11	14159979	.	T	C	23	14	37	0	6	43	0	0
11	14160131	.	A	G	11	26	37	0	4	41	0	0
11	14160464	.	A	C	11	1	12	0	29	41	0	0
11	14160475	.	A	C	14	0	14	0	26	40	0	0
11	14160941	.	C	A	12	7	19	0	1	20	0	0
11	14161073	.	A	G	24	9	33	0	1	34	0	0
11	14161077	.	C	A	23	7	30	0	4	34	0	0
11	14161291	.	A	T	11	18	29	1	0	30	0	0
11	14161304	.	A	G	10	16	26	1	1	28	0	0
11	14249012	.	A	G	7	10	17	0	0	17	0	0
11	14266826	.	G	T	1	9	10	0	16	26	0	0
11	14267075	.	T	C	16	10	26	0	0	26	0	0
11	14267076	.	G	A	16	10	26	0	1	27	0	0
11	14267236	.	A	G	4	0	4	0	10	14	0	0
11	14267239	.	C	G	4	9	13	0	0	13	0	0
11	14288800	.	C	T	1	3	4	0	0	4	0	0
11	14312384	.	T	C	2	2	4	0	0	4	0	0
11	14318207	.	T	A	8	5	13	0	0	13	0	0
11	14338454	.	C	G	3	6	9	0	1	10	0	0
11	14431519	.	G	C	2	6	8	0	0	8	0	0
11	14431661	.	G	A	5	2	7	0	0	7	0	0
11	14431750	.	A	G	3	0	3	0	2	5	0	0
11	14432169	.	C	A	3	4	7	0	0	7	0	0
11	14640155	.	A	G	5	3	8	0	0	8	0	0
11	14676340	.	T	C	10	11	21	0	2	23	0	0
11	14676365	.	G	T	8	9	17	0	0	17	0	0
11	14676604	.	A	T	2	5	7	0	1	8	0	0
11	14955592	.	A	G	3	9	12	0	0	12	0	0
11	14955897	.	A	G	3	3	6	0	0	6	0	0
11	14956525	.	A	G	8	2	10	0	3	13	0	0
11	14957155	.	A	T	13	16	29	0	0	29	0	0
11	15000991	.	C	A	15	18	33	0	2	35	0	0
11	15834110	.	T	G	8	5	13	0	0	13	0	0
11	15834311	.	C	T	8	6	14	0	0	14	0	0
11	15834318	.	T	G	6	7	13	0	1	14	0	0
11	15834436	.	T	A	3	5	8	0	1	9	0	0
11	15850735	.	C	T	7	4	11	0	0	11	0	0
11	15874809	.	C	A	0	6	6	0	7	13	0	0
11	15874820	.	A	G	7	6	13	0	0	13	0	0
11	15874882	.	C	T	3	5	8	0	0	8	0	0
11	15875008	.	G	A	3	4	7	0	1	8	0	0
11	15878458	.	T	C	4	3	7	0	0	7	0	0
11	15888117	.	G	C	0	4	4	0	5	9	0	0
11	15894885	.	G	A	1	5	6	0	4	10	0	0
11	15915274	.	G	T	3	5	8	0	0	8	0	0
11	16006030	.	C	T	4	2	6	0	0	6	0	0
11	16012829	.	G	T	12	13	25	0	1	26	0	0
11	16045589	.	C	T	2	2	4	0	0	4	0	0
11	16095020	.	T	C	6	8	14	0	0	14	0	0
11	16095042	.	C	G	5	11	16	0	0	16	0	0
11	16099700	.	G	A	7	10	17	0	0	17	0	0
11	16104175	.	T	C	5	9	14	0	0	14	0	0
11	16115692	.	C	T	8	9	17	0	0	17	0	0
11	16143740	.	G	A	24	20	44	0	0	44	0	0
11	16143781	.	T	C	14	17	31	2	0	33	0	0
11	16153368	.	G	A	2	8	10	0	14	24	0	0
11	16158555	.	G	A	15	15	30	0	1	31	0	0
11	16159101	.	C	T	11	11	22	0	0	22	0	0
11	16159316	.	C	T	6	9	15	0	0	15	0	0
11	16159875	.	T	C	15	5	20	0	0	20	0	0
11	16159903	.	C	T	14	9	23	0	0	23	0	0
11	16159926	.	C	T	12	10	22	0	0	22	0	0
11	16160074	.	C	T	9	16	25	0	0	25	0	0
11	16165233	.	A	G	8	15	23	0	1	24	0	0
11	16165395	.	G	A	12	9	21	0	0	21	0	0
11	16177158	.	G	A	0	2	2	0	1	3	0	0
11	16179830	.	T	A	27	15	42	0	2	44	0	0
11	16179882	.	T	A	21	22	43	2	2	47	0	0
11	16184865	.	A	T	24	25	49	0	1	50	0	0
11	16192224	.	G	A	23	22	45	0	0	45	0	0
11	16214941	.	G	A	19	20	39	0	0	40	1	0
11	16238173	.	C	T	4	6	10	0	0	10	0	0
11	16329929	.	T	C	4	4	8	0	0	8	0	0
11	16330300	.	C	A	4	9	13	0	0	13	0	0
11	16330585	.	A	G	7	9	16	0	0	16	0	0
11	16330686	.	T	G	8	5	13	0	0	13	0	0
11	16330720	.	G	A	12	7	19	0	1	20	0	0
11	16331089	.	G	C	1	2	3	0	0	3	0	0
11	16331143	.	T	A	2	3	5	0	1	6	0	0
11	16331219	.	T	C	5	5	10	0	0	10	0	0
11	16331268	.	G	A	2	2	4	0	0	4	0	0
11	16331308	.	G	A	1	4	5	0	0	5	0	0
11	16331312	.	A	C	2	4	6	0	0	6	0	0
11	16331363	.	A	G	6	7	13	0	0	13	0	0
11	16331375	.	G	T	8	6	14	0	0	14	0	0
11	16331414	.	G	A	7	5	12	0	2	14	0	0
11	16331531	.	T	G	4	6	10	0	0	10	0	0
11	16331660	.	A	G	1	2	3	0	0	3	0	0
11	16331666	.	C	A	1	2	3	0	0	3	0	0
11	16331853	.	C	A	2	2	4	0	0	4	0	0
11	16331901	.	A	G	1	3	4	0	0	4	0	0
11	16331940	.	T	C	1	3	4	0	0	4	0	0
11	16332040	.	G	T	2	4	6	0	0	6	0	0
11	16332407	.	T	A	2	2	4	0	0	4	0	0
11	16583916	.	A	G	1	0	1	0	2	3	0	0
11	16583988	.	T	C	4	5	9	0	0	9	0	0
11	16584222	.	T	C	5	3	8	0	1	9	0	0
11	16584470	.	A	T	4	4	8	0	0	8	0	0
11	16585422	.	A	T	2	4	6	0	0	6	0	0
11	16585484	.	G	A	5	2	7	0	0	7	0	0
11	16585755	.	T	A	1	2	3	0	0	3	0	0
11	16585775	.	C	G	3	2	5	0	0	5	0	0
11	16585807	.	C	A	3	4	7	0	0	7	0	0
11	16586272	.	A	T	3	3	6	0	0	6	0	0
11	16586326	.	T	C	2	7	9	0	0	9	0	0
11	16586337	.	T	A	2	5	7	0	0	7	0	0
11	16586711	.	G	T	6	3	9	0	0	9	0	0
11	16586722	.	A	G	6	2	8	0	1	9	0	0
11	16587457	.	C	T	3	4	7	0	0	7	0	0
11	16849896	.	G	A	2	6	8	0	0	8	0	0
11	17512289	.	T	C	10	7	17	0	3	20	0	0
11	17512667	.	A	T	2	2	4	0	0	4	0	0
11	17513083	.	C	G	4	4	8	0	0	8	0	0
11	17513424	.	T	A	5	4	9	0	0	9	0	0
11	17597224	.	G	A	4	4	8	0	0	8	0	0
11	17597225	.	T	G	4	4	8	0	0	8	0	0
11	17597424	.	G	A	1	2	3	0	0	3	0	0
11	17597541	.	G	A	2	7	9	0	0	9	0	0
11	17597564	.	T	C	2	0	2	0	7	9	0	0
11	17608441	.	G	A	1	5	6	0	2	8	0	0
11	17713672	.	T	C	5	6	11	0	0	11	0	0
11	17713785	.	A	G	6	5	11	0	0	11	0	0
11	17713928	.	G	T	4	3	7	0	0	7	0	0
11	17726813	.	G	A	2	2	4	0	0	4	0	0
11	17738121	.	C	T	2	3	5	0	0	5	0	0
11	17738274	.	T	C	2	2	4	0	1	5	0	0
11	17757623	.	G	T	16	8	24	0	1	25	0	0
11	17757624	.	A	G	16	8	24	0	0	24	0	0
11	17757772	.	G	A	10	10	20	0	1	21	0	0
11	17763904	.	C	T	9	10	19	0	1	20	0	0
11	17763928	.	C	T	10	11	21	0	2	23	0	0
11	17765182	.	C	A	8	5	13	0	0	13	0	0
11	17765281	.	T	C	20	0	20	0	14	34	0	0
11	17765293	.	C	T	18	15	33	0	0	33	0	0
11	17765489	.	G	A	9	12	21	0	1	22	0	0
11	17765618	.	T	C	8	2	10	0	7	17	0	0
11	17769200	.	C	T	12	6	18	0	1	19	0	0
11	17769236	.	T	C	14	0	14	0	7	21	0	0
11	17769238	.	C	T	14	5	19	0	2	21	0	0
11	17769711	.	C	T	7	12	19	0	1	20	0	0
11	17770627	.	T	C	10	5	15	0	1	16	0	0
11	17771185	.	T	C	7	3	10	0	0	10	0	0
11	17778618	.	T	G	4	4	8	0	1	9	0	0
11	17778639	.	C	T	0	6	6	0	6	12	0	0
11	17778819	.	G	A	4	6	10	0	0	10	0	0
11	17779028	.	T	G	2	3	5	0	0	5	0	0
11	17779159	.	A	G	4	8	12	0	0	12	0	0
11	17779231	.	G	A	5	8	13	0	2	15	0	0
11	17779316	.	A	G	8	9	17	0	0	17	0	0
11	17779402	.	A	G	6	6	12	0	1	13	0	0
11	17779599	.	A	C	4	0	4	0	6	10	0	0
11	17782529	.	A	C	7	0	7	0	12	19	0	0
11	17782669	.	G	C	8	8	16	0	0	16	0	0
11	17782817	.	G	A	5	7	12	0	1	13	0	0
11	17782832	.	C	T	6	10	16	0	0	16	0	0
11	17785428	.	T	C	17	19	36	0	0	36	0	0
11	17789104	.	C	T	1	11	12	0	14	26	0	0
11	17789243	.	G	A	13	12	25	0	2	27	0	0
11	17797072	.	T	C	6	0	6	0	8	14	0	0
11	17959752	.	G	C	1	3	4	0	0	4	0	0
11	17984405	.	G	A	0	5	5	0	6	11	0	0
11	17987007	.	A	G	3	4	7	0	0	7	0	0
11	17987038	.	A	T	3	4	7	0	0	7	0	0
11	17994323	.	G	A	1	4	5	0	2	7	0	0
11	18010235	.	G	A	8	7	15	1	0	16	0	0
11	18205868	.	A	C	3	7	10	0	0	10	0	0
11	18216527	.	G	T	4	3	7	0	1	8	0	0
11	18216643	.	G	A	11	6	17	0	1	18	0	0
11	18216767	.	C	T	5	7	12	0	0	12	0	0
11	18223337	.	C	T	9	8	17	0	1	18	0	0
11	18223365	.	T	C	9	8	17	0	0	17	0	0
11	18223383	.	C	T	9	4	13	0	0	13	0	0
11	18223485	.	G	A	6	6	12	0	1	13	0	0
11	18237862	.	G	A	13	8	21	0	1	22	0	0
11	18238076	.	C	T	10	10	20	0	1	21	0	0
11	18238171	.	T	C	13	11	24	0	2	26	0	0
11	18243966	.	A	G	9	8	17	0	1	18	0	0
11	18244388	.	T	C	3	7	10	0	4	14	0	0
11	18271303	.	G	A	11	6	17	0	1	18	0	0
11	18277370	.	C	T	0	4	4	0	5	9	0	0
11	18277388	.	G	A	6	4	10	0	0	10	0	0
11	18282952	.	G	C	3	6	9	2	0	11	0	0
11	18283126	.	C	T	6	4	10	0	2	12	0	0
11	18283211	.	C	T	3	7	10	0	0	10	0	0
11	18283268	.	T	C	4	8	12	0	0	12	0	0
11	18283525	.	T	C	9	0	9	0	9	18	0	0
11	18287283	.	A	T	7	4	11	0	0	11	0	0
11	18287316	.	G	A	7	9	16	0	1	17	0	0
11	18287378	.	C	T	2	10	12	0	7	19	0	0
11	18287506	.	A	G	8	7	15	0	1	16	0	0
11	18287687	.	T	A	9	4	13	0	0	13	0	0
11	18287779	.	G	A	5	7	12	0	1	13	0	0
11	18287895	.	T	G	6	10	16	0	1	17	0	0
11	18287940	.	A	T	11	8	19	0	0	19	0	0
11	18288212	.	T	C	12	5	17	0	1	18	0	0
11	18288275	.	C	A	0	13	13	0	7	20	0	0
11	18288347	.	G	A	9	9	18	0	0	18	0	0
11	18289356	.	C	T	10	8	18	0	0	18	0	0
11	18290095	.	G	A	9	9	18	0	0	18	0	0
11	18291853	.	T	A	13	14	27	0	1	28	0	0
11	18291943	.	C	T	10	6	16	0	0	16	0	0
11	18292595	.	C	T	0	12	12	0	5	17	0	0
11	18292675	.	C	T	5	9	14	0	2	16	0	0
11	18294857	.	A	G	8	9	17	0	0	17	0	0
11	18294911	.	A	G	11	4	15	0	2	17	0	0
11	18295057	.	T	C	9	10	19	0	0	19	0	0
11	18304255	.	T	A	13	7	20	0	0	20	0	0
11	18305804	.	C	G	7	7	14	0	0	14	0	0
11	18309570	.	T	C	8	3	11	0	1	12	0	0
11	18315955	.	C	T	3	6	9	0	3	12	0	0
11	18315988	.	T	A	6	6	12	0	1	13	0	0
11	18345272	.	C	A	1	2	3	0	0	3	0	0
11	18345288	.	C	T	2	2	4	0	0	4	0	0
11	18345390	.	C	A	4	3	7	0	1	8	0	0
11	18345563	.	C	T	2	5	7	0	0	7	0	0
11	18346002	.	T	C	6	3	9	0	0	9	0	0
11	18346827	.	C	T	0	3	3	0	2	5	0	0
11	18347424	.	T	C	3	0	3	0	5	8	0	0
11	18348039	.	C	A	1	2	3	0	0	3	0	0
11	18353060	.	C	T	4	2	6	0	0	6	0	0
11	18397310	.	A	T	1	2	3	0	0	3	0	0
11	18397705	.	A	T	2	2	4	0	0	4	0	0
11	18397706	.	T	C	2	2	4	0	0	4	0	0
11	18397744	.	T	C	2	3	5	0	0	5	0	0
11	18398555	.	T	G	2	2	4	0	0	4	0	0
11	18398578	.	T	G	4	2	6	0	0	6	0	0
11	18398741	.	T	C	4	2	6	0	0	6	0	0
11	18398751	.	T	C	1	6	7	0	0	7	0	0
11	18398800	.	T	C	2	4	6	0	0	6	0	0
11	18398809	.	T	C	5	2	7	0	0	7	0	0
11	18467986	.	G	C	1	2	3	0	0	3	0	0
11	18535112	.	T	C	3	4	7	0	1	8	0	0
11	18536769	.	G	A	18	9	27	0	0	27	0	0
11	18536800	.	C	T	2	11	13	0	11	24	0	0
11	18536864	.	G	T	11	10	21	0	1	22	0	0
11	18536866	.	G	A	10	9	19	0	2	21	0	0
11	18537244	.	G	A	12	8	20	0	1	21	0	0
11	18537447	.	T	C	9	6	15	0	0	15	0	0
11	18537636	.	T	A	11	11	22	0	0	22	0	0
11	18537649	.	G	A	12	12	24	0	1	25	0	0
11	18538122	.	A	T	14	9	23	0	0	23	0	0
11	18538336	.	A	C	13	0	13	0	17	30	0	0
11	18538362	.	T	C	11	0	11	0	15	26	0	0
11	18538910	.	C	T	8	9	17	0	0	17	0	0
11	18539155	.	G	C	7	7	14	0	1	15	0	0
11	18539616	.	C	A	8	6	14	0	1	15	0	0
11	18541017	.	T	A	4	3	7	0	0	7	0	0
11	18542168	.	T	C	5	11	16	0	3	19	0	0
11	18542585	.	A	G	5	9	14	0	2	16	0	0
11	18542691	.	C	T	4	2	6	0	0	6	0	0
11	18543543	.	T	A	9	7	16	0	2	18	0	0
11	18543558	.	T	C	11	0	11	0	10	21	0	0
11	18543870	.	A	G	3	6	9	0	1	10	0	0
11	18546276	.	T	A	2	2	4	0	0	4	0	0
11	18546357	.	T	A	5	5	10	0	1	11	0	0
11	18547125	.	A	G	12	17	29	0	0	29	0	0
11	18551089	.	G	A	5	9	14	1	1	16	0	0
11	18551120	.	C	T	0	10	10	0	10	20	0	0
11	18561674	.	C	T	11	4	15	0	0	15	0	0
11	18561792	.	T	C	15	0	15	0	6	21	0	0
11	18562059	.	T	G	8	11	19	0	0	19	0	0
11	18562132	.	G	T	4	7	11	0	0	11	0	0
11	18562213	.	A	T	5	2	7	0	0	7	0	0
11	18562303	.	T	C	5	2	7	0	0	7	0	0
11	18562420	.	G	T	6	7	13	0	0	13	0	0
11	18562448	.	T	C	5	0	5	0	7	12	0	0
11	18562655	.	T	C	7	0	7	0	6	13	0	0
11	18562730	.	G	T	12	6	18	0	3	21	0	0
11	18569158	.	A	T	4	17	21	0	0	21	0	0
11	18569298	.	G	A	6	7	13	0	1	14	0	0
11	18569379	.	A	G	9	13	22	0	0	22	0	0
11	18572364	.	T	C	13	0	13	0	16	29	0	0
11	18572586	.	C	T	12	14	26	1	0	27	0	0
11	18572640	.	T	G	12	12	24	0	0	24	0	0
11	18572648	.	G	A	12	14	26	1	1	28	0	0
11	18575031	.	G	C	9	8	17	0	0	17	0	0
11	18575148	.	C	T	9	5	14	0	3	17	0	0
11	18575299	.	A	G	8	8	16	0	0	16	0	0
11	18577262	.	T	C	8	8	16	0	0	16	0	0
11	18577787	.	A	G	9	10	19	0	0	19	0	0
11	18579868	.	G	A	9	13	22	0	1	23	0	0
11	18579912	.	A	G	8	11	19	0	0	19	0	0
11	18580170	.	T	C	2	0	2	0	6	8	0	0
11	18586264	.	T	C	9	0	9	0	4	13	0	0
11	18586445	.	T	C	6	4	10	0	0	10	0	0
11	18586759	.	A	G	16	8	24	0	1	25	0	0
11	18587719	.	T	G	5	4	9	0	0	9	0	0
11	18589439	.	C	T	5	4	9	0	1	10	0	0
11	18678321	.	T	C	3	4	7	0	0	7	0	0
11	18678344	.	T	G	3	4	7	0	0	7	0	0
11	18681086	.	C	G	4	4	8	0	0	8	0	0
11	18681103	.	G	A	0	5	5	0	2	7	0	0
11	18681382	.	A	G	4	0	4	0	4	8	0	0
11	18681631	.	G	T	0	5	5	0	6	11	0	0
11	18682694	.	A	G	7	5	12	0	0	12	0	0
11	18682826	.	T	C	8	4	12	0	0	12	0	0
11	18686477	.	A	C	3	10	13	0	1	14	0	0
11	18686492	.	G	A	5	8	13	0	3	16	0	0
11	18686513	.	C	T	4	13	17	0	1	18	0	0
11	18686528	.	T	C	8	10	18	0	0	18	0	0
11	18688956	.	T	C	8	5	13	0	3	16	0	0
11	18694013	.	C	T	12	8	20	0	1	21	0	0
11	18697817	.	T	G	6	8	14	0	1	15	0	0
11	18698526	.	G	A	4	5	9	0	0	9	0	0
11	18698687	.	A	T	2	4	6	0	0	6	0	0
11	18699104	.	T	C	10	6	16	0	1	17	0	0
11	18704378	.	G	C	6	1	7	0	3	10	0	0
11	18704383	.	T	A	7	5	12	0	1	13	0	0
11	18704500	.	G	A	12	14	26	0	3	29	0	0
11	18704620	.	C	T	1	16	17	0	20	37	0	0
11	18705108	.	A	G	27	14	41	0	1	42	0	0
11	18784949	.	A	T	4	11	15	0	1	16	0	0
11	18784975	.	C	A	6	15	21	0	0	21	0	0
11	18785019	.	G	A	8	14	22	0	0	22	0	0
11	18785022	.	G	A	9	14	23	0	0	23	0	0
11	18785159	.	G	T	19	12	31	0	3	34	0	0
11	18785214	.	T	C	15	27	42	0	1	43	0	0
11	18785309	.	G	A	9	17	26	0	1	27	0	0
11	18785410	.	G	A	8	10	18	0	1	19	0	0
11	18785421	.	A	G	8	8	16	0	0	16	0	0
11	18785854	.	A	G	12	9	21	0	2	23	0	0
11	18786085	.	A	T	10	13	23	0	0	23	0	0
11	18794073	.	T	A	10	12	22	0	1	23	0	0
11	18794157	.	C	A	1	15	16	0	10	26	0	0
11	18794329	.	A	G	10	11	21	0	2	23	0	0
11	18794627	.	T	A	10	11	21	0	1	22	0	0
11	18799832	.	A	T	15	10	25	0	0	25	0	0
11	18799841	.	C	G	14	11	25	0	0	25	0	0
11	18802570	.	T	C	3	3	6	0	0	6	0	0
11	18802879	.	A	G	3	3	6	0	1	7	0	0
11	18803095	.	C	T	0	2	2	0	7	9	0	0
11	18803621	.	A	G	9	5	14	0	0	14	0	0
11	18806030	.	A	G	3	3	6	0	0	6	0	0
11	18814495	.	G	C	5	2	7	0	0	7	0	0
11	18814506	.	T	G	3	2	5	0	0	5	0	0
11	18816398	.	C	T	2	2	4	0	0	4	0	0
11	18819145	.	G	A	1	3	4	0	0	4	0	0
11	19013597	.	C	T	17	8	25	0	0	25	0	0
11	19041518	.	G	A	11	3	14	0	0	14	0	0
11	19041647	.	T	G	11	4	15	0	1	16	0	0
11	19041852	.	C	T	8	5	13	0	1	14	0	0
11	19042092	.	T	C	18	14	32	0	0	32	0	0
11	19042212	.	T	C	14	8	22	0	1	23	0	0
11	19068394	.	C	T	23	19	42	0	1	43	0	0
11	19072566	.	A	T	28	26	54	0	0	54	0	0
11	19072608	.	T	A	26	21	47	0	3	50	0	0
11	19072695	.	G	A	19	19	38	0	1	39	0	0
11	19072728	.	G	A	0	18	18	0	17	35	0	0
11	19084820	.	C	T	9	11	20	0	1	21	0	0
11	19089286	.	A	G	29	20	49	0	1	50	0	0
11	19089362	.	A	G	32	34	66	0	3	69	0	0
11	19089368	.	C	T	33	34	67	0	1	68	0	0
11	19089608	.	G	A	3	30	33	0	23	56	0	0
11	19089724	.	T	C	20	26	46	0	2	48	0	0
11	19089839	.	G	A	1	20	21	0	14	35	0	0
11	19090203	.	G	A	0	15	15	0	20	35	0	0
11	19090455	.	C	T	29	12	41	0	2	43	0	0
11	19090597	.	A	G	21	17	38	0	1	39	0	0
11	19370801	.	C	T	6	6	12	0	1	13	0	0
11	19370862	.	G	C	8	6	14	0	0	14	0	0
11	19370866	.	C	T	10	6	16	0	0	16	0	0
11	19371054	.	A	G	6	4	10	0	0	10	0	0
11	19434043	.	G	C	19	9	28	0	1	29	0	0
11	19456859	.	G	T	5	3	8	1	0	9	0	0
11	19462920	.	C	T	11	8	19	0	0	19	0	0
11	19464813	.	A	G	8	10	18	0	5	23	0	0
11	19464957	.	C	G	11	0	11	0	14	25	0	0
11	19465149	.	T	C	18	16	34	0	1	35	0	0
11	19465174	.	C	T	17	16	33	0	2	35	0	0
11	19465269	.	T	C	24	9	33	0	0	33	0	0
11	19465302	.	A	T	17	13	30	0	2	32	0	0
11	19465428	.	C	T	17	12	29	0	0	29	0	0
11	19467673	.	G	A	14	14	28	1	0	29	0	0
11	19467792	.	G	A	1	18	19	0	24	43	0	0
11	19468147	.	C	T	21	14	35	0	1	37	1	0
11	19468330	.	A	G	13	0	13	0	17	30	0	0
11	19502433	.	C	T	25	22	47	0	1	48	0	0
11	19505967	.	T	C	27	21	48	0	0	48	0	0
11	19506260	.	C	T	15	10	25	0	0	25	0	0
11	19512285	.	T	C	1	3	4	0	0	4	0	0
11	19512430	.	C	T	0	5	5	0	3	8	0	0
11	19513529	.	A	T	4	3	7	0	0	7	0	0
11	19515190	.	G	T	3	3	6	0	0	6	0	0
11	19515275	.	C	T	2	1	3	0	1	4	0	0
11	19522962	.	G	C	2	2	4	0	0	4	0	0
11	19523324	.	G	T	1	2	3	0	0	3	0	0
11	19604223	.	A	C	9	10	19	0	0	19	0	0
11	19611215	.	C	T	2	7	9	0	0	9	0	0
11	19624552	.	C	T	2	3	5	0	0	5	0	0
11	19624616	.	A	T	2	5	7	0	0	7	0	0
11	19624686	.	T	C	6	3	9	0	0	9	0	0
11	19624730	.	T	G	6	7	13	0	1	14	0	0
11	19625524	.	C	T	3	9	12	0	25	37	0	0
11	19625535	.	C	T	25	9	34	0	1	35	0	0
11	19625673	.	A	T	11	8	19	0	1	21	1	0
11	19625732	.	A	G	13	8	21	0	1	22	0	0
11	19625804	.	C	T	8	9	17	0	0	17	0	0
11	19625840	.	G	T	4	7	11	0	0	12	1	0
11	19626209	.	A	G	3	3	6	0	1	7	0	0
11	19626216	.	G	T	3	4	7	0	0	7	0	0
11	19626274	.	A	G	3	1	4	0	0	4	0	0
11	19626393	.	A	G	1	3	4	0	0	4	0	0
11	19626536	.	T	A	8	7	15	0	0	15	0	0
11	19626556	.	A	G	9	5	14	0	0	14	0	0
11	19626841	.	G	C	1	1	2	0	1	3	0	0
11	19626848	.	T	G	1	2	3	0	0	3	0	0
11	19627157	.	T	A	6	12	18	0	0	18	0	0
11	19627169	.	A	T	6	13	19	0	2	21	0	0
11	19627277	.	A	T	10	8	18	0	0	18	0	0
11	19627344	.	A	G	2	4	6	0	0	6	0	0
11	19632882	.	A	G	5	3	8	0	0	8	0	0
11	19639122	.	A	G	7	7	14	0	0	14	0	0
11	19639197	.	C	T	1	9	10	0	7	17	0	0
11	19644104	.	T	C	4	0	4	0	6	10	0	0
11	19729925	.	G	A	2	5	7	0	0	7	0	0
11	19729965	.	T	A	1	2	3	0	0	3	0	0
11	19730001	.	A	C	5	0	5	0	8	13	0	0
11	19733136	.	T	C	3	7	10	0	0	10	0	0
11	19733388	.	A	G	7	7	14	0	0	14	0	0
11	19736959	.	G	A	7	4	11	0	0	11	0	0
11	19743060	.	C	T	3	5	8	0	1	9	0	0
11	19836147	.	T	C	3	7	10	0	0	10	0	0
11	19876948	.	A	G	2	2	4	0	0	4	0	0
11	19883758	.	G	A	3	5	8	0	0	8	0	0
11	19950899	.	C	T	2	3	5	0	0	5	0	0
11	19999131	.	T	C	6	6	12	0	0	12	0	0
11	20017793	.	A	G	14	5	19	0	1	20	0	0
11	20017802	.	A	G	5	13	18	0	1	19	0	0
11	20036591	.	G	A	10	18	28	0	0	28	0	0
11	20039868	.	G	C	4	8	12	0	1	13	0	0
11	20039877	.	G	A	4	8	12	0	1	13	0	0
11	20040014	.	T	A	2	6	8	0	0	8	0	0
11	20040145	.	T	G	11	0	11	0	11	22	0	0
11	20057875	.	G	A	3	6	9	0	0	9	0	0
11	20057936	.	A	T	2	4	6	0	0	6	0	0
11	20058882	.	C	A	4	3	7	0	0	7	0	0
11	20058915	.	C	T	1	4	5	0	0	5	0	0
11	20371248	.	A	G	9	0	9	0	12	21	0	0
11	20636107	.	C	A	9	8	17	0	0	17	0	0
11	20657517	.	A	C	7	7	14	1	0	15	0	0
11	20657574	.	G	C	7	6	13	0	2	15	0	0
11	20657661	.	T	C	8	10	18	0	1	19	0	0
11	20787999	.	C	T	10	11	21	0	2	23	0	0
11	20788014	.	G	A	3	11	14	0	12	26	0	0
11	20794150	.	T	C	10	19	29	0	1	30	0	0
11	20815757	.	A	G	15	1	16	0	19	35	0	0
11	20826358	.	T	C	10	12	22	0	2	24	0	0
11	20979901	.	A	C	3	7	10	0	0	10	0	0
11	21026744	.	T	C	1	0	1	0	3	4	0	0
11	21154727	.	G	A	1	2	3	0	0	3	0	0
11	21154747	.	A	T	2	3	5	0	0	5	0	0
11	21154786	.	A	C	5	2	7	0	0	7	0	0
11	21155290	.	G	A	8	10	18	0	1	19	0	0
11	21155829	.	A	G	5	10	15	0	0	15	0	0
11	21156085	.	T	G	2	3	5	0	2	8	1	0
11	21156278	.	G	A	7	10	17	0	0	17	0	0
11	21156372	.	G	A	11	3	14	0	0	14	0	0
11	21158423	.	C	A	0	10	10	0	8	18	0	0
11	21158774	.	A	G	8	8	16	0	0	16	0	0
11	21173971	.	T	C	6	4	10	0	3	13	0	0
11	21217518	.	T	C	8	3	11	0	0	11	0	0
11	21217542	.	T	C	5	6	11	0	0	11	0	0
11	21217986	.	A	G	3	6	9	0	0	9	0	0
11	21217994	.	G	A	2	6	8	0	0	8	0	0
11	21259665	.	T	A	5	2	7	0	0	7	0	0
11	21259968	.	A	G	5	2	7	0	0	7	0	0
11	21260060	.	C	T	2	2	4	0	0	4	0	0
11	21260213	.	G	A	2	2	4	0	0	4	0	0
11	21260546	.	G	A	2	2	4	0	0	4	0	0
11	21260676	.	C	T	10	5	15	0	0	15	0	0
11	21261031	.	T	C	5	3	8	0	0	8	0	0
11	21261546	.	A	G	3	2	5	0	0	5	0	0
11	21261558	.	T	C	3	4	7	0	0	7	0	0
11	21262085	.	T	C	2	2	4	0	0	4	0	0
11	21266802	.	T	C	2	2	4	0	0	4	0	0
11	21266841	.	T	A	3	2	5	0	0	5	0	0
11	21266902	.	G	T	1	2	3	0	0	3	0	0
11	21267380	.	C	A	4	4	8	0	0	8	0	0
11	21278950	.	T	A	10	16	26	0	1	27	0	0
11	21279025	.	G	A	17	10	27	0	1	28	0	0
11	21279144	.	A	T	16	17	33	0	3	36	0	0
11	21279225	.	G	A	10	18	28	0	2	30	0	0
11	21279261	.	A	G	9	12	21	0	0	21	0	0
11	21279827	.	T	C	1	4	5	0	0	5	0	0
11	21279861	.	T	G	2	8	10	0	0	10	0	0
11	21279885	.	A	G	6	11	17	0	1	18	0	0
11	21279921	.	A	C	7	16	23	0	0	23	0	0
11	21279959	.	C	T	11	9	20	0	1	21	0	0
11	21280003	.	T	C	12	8	20	0	1	21	0	0
11	21280149	.	G	T	15	7	22	0	2	24	0	0
11	21280236	.	C	A	6	16	22	0	0	23	1	0
11	21280284	.	T	A	10	11	21	0	0	21	0	0
11	21280347	.	C	T	9	9	18	0	1	19	0	0
11	21280349	.	G	A	9	10	19	0	0	19	0	0
11	21280504	.	A	C	11	8	19	0	2	21	0	0
11	21280555	.	A	T	3	5	8	0	0	8	0	0
11	21280636	.	T	A	1	3	4	0	1	5	0	0
11	21280638	.	A	T	2	3	5	0	0	5	0	0
11	21280690	.	T	C	7	6	13	0	0	13	0	0
11	21280801	.	T	A	11	11	22	0	0	22	0	0
11	21280808	.	T	C	10	12	22	0	1	23	0	0
11	21280848	.	T	A	11	11	22	0	1	23	0	0
11	21280864	.	A	G	12	15	27	0	0	27	0	0
11	21280926	.	T	C	7	10	17	0	1	18	0	0
11	21280974	.	G	A	10	11	21	0	1	22	0	0
11	21281017	.	A	T	5	3	8	0	2	10	0	0
11	21281087	.	C	T	15	15	30	0	0	30	0	0
11	21281138	.	G	A	14	20	34	0	1	35	0	0
11	21281148	.	G	A	13	22	35	0	1	36	0	0
11	21281219	.	G	A	17	16	33	0	1	34	0	0
11	21281240	.	G	C	15	11	26	0	0	26	0	0
11	21281269	.	T	C	8	9	17	0	0	17	0	0
11	21281311	.	A	T	9	11	20	0	0	20	0	0
11	21281328	.	C	T	9	10	19	0	0	19	0	0
11	21281599	.	T	C	13	9	22	0	2	24	0	0
11	21281657	.	T	C	23	9	32	0	0	32	0	0
11	21281658	.	T	C	25	8	33	0	0	33	0	0
11	21281774	.	T	C	3	10	13	0	0	13	0	0
11	21281798	.	T	C	5	5	10	0	2	12	0	0
11	21281888	.	G	A	3	9	12	0	0	12	0	0
11	21281916	.	A	G	8	5	13	0	1	14	0	0
11	21282355	.	G	A	9	9	18	0	1	19	0	0
11	21282414	.	G	A	10	17	27	0	0	27	0	0
11	21282424	.	C	G	8	17	25	0	0	25	0	0
11	21282500	.	C	A	17	5	22	0	0	22	0	0
11	21282571	.	G	A	6	12	18	0	4	22	0	0
11	21282747	.	T	C	9	11	20	0	0	20	0	0
11	21284382	.	G	A	15	8	23	0	0	23	0	0
11	21284400	.	A	T	15	9	24	0	0	24	0	0
11	21284588	.	A	G	10	15	25	0	0	25	0	0
11	21284701	.	A	C	17	0	17	0	19	36	0	0
11	21284733	.	C	T	13	19	32	0	1	33	0	0
11	21303983	.	C	A	0	4	4	0	3	7	0	0
11	21304125	.	A	C	2	0	2	0	3	5	0	0
11	21304394	.	A	C	1	0	1	0	2	3	0	0
11	21304397	.	C	T	1	2	3	0	0	3	0	0
11	21323564	.	A	G	9	14	23	0	1	24	0	0
11	21352744	.	G	C	12	7	19	0	0	19	0	0
11	21352773	.	A	T	10	12	22	0	0	22	0	0
11	21363054	.	G	T	2	2	4	0	0	4	0	0
11	21363171	.	C	T	4	2	6	0	0	6	0	0
11	21363229	.	T	C	6	3	9	0	0	9	0	0
11	21363249	.	C	A	6	3	9	0	0	9	0	0
11	21363271	.	A	C	5	5	10	0	0	10	0	0
11	21363298	.	T	C	2	0	2	0	5	7	0	0
11	21363377	.	C	T	0	3	3	0	2	5	0	0
11	21363693	.	A	T	1	1	2	0	1	3	0	0
11	21407073	.	C	A	2	14	16	0	6	22	0	0
11	21407091	.	T	C	10	0	10	0	11	21	0	0
11	21407540	.	A	G	10	3	13	0	0	13	0	0
11	21407843	.	C	T	9	8	17	0	0	17	0	0
11	21407862	.	A	T	8	5	13	0	1	14	0	0
11	21407895	.	C	G	5	8	13	0	0	13	0	0
11	21407901	.	T	C	6	8	14	0	0	14	0	0
11	21408041	.	G	A	10	6	16	0	0	16	0	0
11	21408103	.	G	T	4	2	6	0	0	6	0	0
11	21408201	.	T	A	12	10	22	0	1	23	0	0
11	21408202	.	T	C	13	10	23	0	0	23	0	0
11	21408242	.	C	T	12	6	18	0	0	18	0	0
11	21408423	.	T	A	8	4	12	0	1	13	0	0
11	21408525	.	A	G	4	5	9	0	0	9	0	0
11	21408862	.	A	G	3	3	6	0	0	6	0	0
11	21408962	.	C	T	3	4	7	0	1	8	0	0
11	21409037	.	A	T	3	3	6	0	1	7	0	0
11	21409236	.	A	T	7	7	14	0	0	14	0	0
11	21409251	.	A	G	6	7	13	0	0	13	0	0
11	21409331	.	A	G	8	5	13	0	0	13	0	0
11	21409690	.	A	G	11	10	21	0	0	21	0	0
11	21409981	.	C	A	10	10	20	0	1	21	0	0
11	21410009	.	A	G	10	7	17	0	2	19	0	0
11	21410542	.	T	C	7	0	7	0	21	28	0	0
11	21410584	.	G	A	12	16	28	0	1	29	0	0
11	21413929	.	C	T	15	9	24	0	0	24	0	0
11	21414067	.	T	C	11	0	11	0	14	25	0	0
11	21419325	.	G	A	11	9	20	0	2	22	0	0
11	21419637	.	A	C	14	13	27	0	1	28	0	0
11	21443950	.	A	G	2	2	4	0	4	8	0	0
11	21457875	.	C	T	6	10	16	0	0	16	0	0
11	21583088	.	G	C	4	0	4	0	11	15	0	0
11	21583210	.	T	C	1	0	1	0	2	3	0	0
11	21593910	.	G	A	4	5	9	0	0	9	0	0
11	21594552	.	G	A	2	2	4	0	0	4	0	0
11	21594803	.	C	T	3	2	5	0	0	5	0	0
11	21595189	.	G	A	3	3	6	0	0	6	0	0
11	21595191	.	G	A	0	3	3	0	3	6	0	0
11	21595307	.	G	A	2	5	7	0	0	7	0	0
11	21595615	.	G	A	2	6	8	0	1	9	0	0
11	21595819	.	T	C	1	1	2	0	0	2	0	0
11	21595839	.	A	G	1	2	3	0	0	3	0	0
11	21595949	.	A	G	2	2	4	0	0	4	0	0
11	21595981	.	A	T	5	4	9	0	1	10	0	0
11	21596459	.	T	C	1	5	6	0	0	6	0	0
11	21596492	.	A	G	3	0	3	0	5	8	0	0
11	21596629	.	T	C	3	2	5	0	0	5	0	0
11	21596652	.	G	A	1	1	2	0	1	3	0	0
11	21596931	.	C	T	4	6	10	0	0	10	0	0
11	21597055	.	T	G	10	8	18	0	1	19	0	0
11	21597107	.	A	G	6	6	12	0	0	12	0	0
11	21597154	.	T	C	8	5	13	0	2	15	0	0
11	21597165	.	C	T	9	5	14	0	0	14	0	0
11	21597261	.	C	T	5	4	9	0	0	9	0	0
11	21597393	.	T	C	1	3	4	1	0	5	0	0
11	21597659	.	T	C	4	5	9	0	0	9	0	0
11	21597676	.	C	A	3	5	8	0	0	8	0	0
11	21597702	.	A	G	1	5	6	0	0	6	0	0
11	21598002	.	T	C	5	6	11	0	0	11	0	0
11	21598036	.	T	C	4	4	8	0	2	10	0	0
11	21910569	.	T	C	4	3	7	0	0	7	0	0
11	21962831	.	A	G	10	9	19	0	1	20	0	0
11	22042586	.	A	G	8	0	8	0	6	14	0	0
11	22070621	.	C	T	9	4	13	0	0	13	0	0
11	22087185	.	A	G	8	0	8	0	8	16	0	0
11	22089476	.	A	C	2	7	9	0	2	11	0	0
11	22089477	.	T	A	3	8	11	0	0	11	0	0
11	22089575	.	T	C	7	6	13	0	0	13	0	0
11	22089697	.	C	T	4	4	8	0	0	8	0	0
11	22089738	.	C	T	5	3	8	0	2	10	0	0
11	22090203	.	C	T	7	2	9	0	0	9	0	0
11	22090277	.	G	T	5	6	11	0	0	11	0	0
11	22090352	.	A	G	4	0	4	0	4	8	0	0
11	22090445	.	C	G	6	3	9	0	0	9	0	0
11	22090903	.	C	T	6	3	9	0	1	10	0	0
11	22092105	.	C	T	16	7	23	0	1	24	0	0
11	22092181	.	A	T	14	8	22	0	1	23	0	0
11	22092689	.	T	A	15	5	20	0	1	21	0	0
11	22093848	.	A	C	12	9	21	0	2	23	0	0
11	22094072	.	T	C	6	9	15	0	0	15	0	0
11	22288932	.	A	G	2	2	4	0	0	4	0	0
11	22363756	.	A	T	3	5	8	0	1	9	0	0
11	22363994	.	T	G	9	10	19	0	1	20	0	0
11	22364128	.	A	T	7	6	13	0	1	14	0	0
11	22364140	.	T	A	6	7	13	0	0	13	0	0
11	22364228	.	G	A	8	4	12	0	0	12	0	0
11	22364359	.	A	G	4	7	11	0	1	12	0	0
11	22364416	.	A	G	5	3	8	0	1	9	0	0
11	22364502	.	C	A	0	13	13	0	11	24	0	0
11	22364558	.	T	C	6	11	17	0	0	17	0	0
11	22366703	.	C	T	2	10	12	0	7	19	0	0
11	22366709	.	G	T	6	9	15	0	1	16	0	0
11	22366841	.	T	C	13	13	26	0	1	27	0	0
11	22367200	.	A	T	14	14	28	0	1	29	0	0
11	22367251	.	A	G	17	9	26	0	2	28	0	0
11	22369922	.	G	A	9	8	17	0	2	19	0	0
11	22370049	.	G	A	14	8	22	0	0	22	0	0
11	22374626	.	T	C	17	10	27	0	1	28	0	0
11	22374871	.	G	A	7	6	13	0	2	15	0	0
11	22375072	.	T	C	2	8	10	0	0	10	0	0
11	22490731	.	A	G	12	0	12	2	9	23	0	0
11	22495182	.	T	C	10	10	20	0	1	21	0	0
11	22552208	.	C	T	18	8	26	0	0	26	0	0
11	22560018	.	T	C	16	13	29	0	0	29	0	0
11	22571657	.	G	A	13	18	31	1	0	32	0	0
11	22571733	.	T	C	10	11	21	0	0	21	0	0
11	22578767	.	G	A	2	11	13	0	21	34	0	0
11	22578779	.	C	A	20	15	35	0	0	35	0	0
11	22582243	.	G	C	8	9	17	0	1	18	0	0
11	22582634	.	C	A	12	9	21	0	0	21	0	0
11	22582891	.	G	A	6	3	9	0	0	9	0	0
11	22583139	.	G	T	8	9	17	0	0	17	0	0
11	22583150	.	G	A	3	10	13	0	7	20	0	0
11	22583372	.	C	G	8	5	13	1	4	18	0	0
11	22583424	.	G	T	19	11	30	0	1	31	0	0
11	22583514	.	G	A	12	15	27	0	0	27	0	0
11	22583656	.	T	G	14	10	24	0	0	24	0	0
11	22583665	.	G	T	10	9	19	0	2	21	0	0
11	22583701	.	A	C	4	8	12	0	1	13	0	0
11	22583759	.	T	C	6	4	10	0	0	10	0	0
11	22583858	.	C	A	15	7	22	0	1	23	0	0
11	22583884	.	G	T	16	10	26	0	0	26	0	0
11	22583974	.	T	C	12	18	30	0	1	31	0	0
11	22583984	.	T	C	11	16	27	0	1	28	0	0
11	22584173	.	G	A	8	10	18	0	0	18	0	0
11	22584229	.	T	C	8	9	17	0	0	17	0	0
11	22584417	.	A	C	10	5	15	0	0	15	0	0
11	22623334	.	T	A	5	5	10	0	0	10	0	0
11	22623421	.	C	G	1	0	1	0	4	5	0	0
11	22624467	.	C	T	3	2	5	0	0	5	0	0
11	22624536	.	A	G	8	4	12	0	0	12	0	0
11	22624556	.	G	C	6	3	9	0	0	9	0	0
11	22630168	.	G	A	6	2	8	0	0	8	0	0
11	22630190	.	T	A	4	2	6	0	0	6	0	0
11	22630303	.	G	A	1	2	3	0	3	6	0	0
11	22891251	.	T	C	8	9	17	0	0	17	0	0
11	22891305	.	C	G	17	10	27	2	1	30	0	0
11	22891477	.	G	A	16	14	30	0	2	32	0	0
11	22891490	.	A	C	17	16	33	0	1	34	0	0
11	22891574	.	G	A	20	6	26	0	4	30	0	0
11	22891575	.	T	C	14	0	14	0	16	30	0	0
11	22891692	.	C	T	0	26	26	0	18	44	0	0
11	22891890	.	C	A	20	12	32	0	0	32	0	0
11	22891979	.	A	T	16	9	25	0	0	25	0	0
11	22892092	.	G	A	11	16	27	0	0	27	0	0
11	22892534	.	G	A	22	9	31	0	1	32	0	0
11	22905743	.	T	G	26	9	35	0	0	35	0	0
11	22911841	.	C	G	11	16	27	0	3	30	0	0
11	22915951	.	T	A	9	6	15	0	0	15	0	0
11	22915952	.	T	A	9	6	15	0	0	15	0	0
11	22916528	.	G	T	22	6	28	0	0	28	0	0
11	22916573	.	G	T	11	5	16	0	0	16	0	0
11	22916576	.	A	G	10	3	13	0	0	13	0	0
11	22921048	.	T	G	32	19	51	0	6	57	0	0
11	22921124	.	G	T	31	26	57	0	3	60	0	0
11	22921568	.	G	C	34	18	52	0	0	52	0	0
11	22921800	.	T	G	29	25	54	0	1	55	0	0
11	22921865	.	T	C	29	0	29	0	22	51	0	0
11	22921960	.	T	C	22	20	42	0	0	42	0	0
11	22921969	.	G	A	18	21	39	0	2	41	0	0
11	22922075	.	A	G	31	24	55	0	1	56	0	0
11	22922114	.	A	T	38	16	54	0	0	55	1	0
11	22922251	.	C	T	26	25	51	0	1	52	0	0
11	22922266	.	A	G	28	22	50	0	0	50	0	0
11	22922290	.	A	G	26	21	47	0	1	48	0	0
11	22922309	.	T	A	31	15	46	0	0	46	0	0
11	22922333	.	A	T	29	20	49	0	0	49	0	0
11	22922355	.	A	T	27	18	45	0	0	45	0	0
11	22922392	.	G	C	27	18	45	0	0	45	0	0
11	22922405	.	G	A	23	16	39	0	3	42	0	0
11	22922645	.	G	A	25	22	47	0	3	50	0	0
11	22922668	.	T	C	27	24	51	0	1	52	0	0
11	22922762	.	T	A	26	17	43	0	3	46	0	0
11	22922784	.	G	A	21	26	47	0	0	47	0	0
11	22922841	.	C	A	28	16	44	1	1	46	0	0
11	22922909	.	A	T	29	18	47	0	0	47	0	0
11	22923168	.	G	A	22	20	42	0	0	42	0	0
11	22923613	.	T	C	31	1	32	0	20	52	0	0
11	22924449	.	C	T	16	12	28	0	0	28	0	0
11	22924505	.	A	C	12	6	18	0	0	18	0	0
11	22924650	.	A	C	10	14	24	0	1	25	0	0
11	22924746	.	C	T	1	18	19	0	8	27	0	0
11	22925048	.	G	A	13	12	25	0	2	27	0	0
11	22925266	.	G	A	28	22	50	0	2	52	0	0
11	22925370	.	A	G	25	22	47	0	4	51	0	0
11	22925901	.	G	A	26	17	43	0	0	43	0	0
11	22925902	.	A	C	24	16	40	0	3	43	0	0
11	22925966	.	A	T	28	19	47	0	0	48	1	0
11	22926309	.	T	C	10	5	15	0	0	15	0	0
11	22969056	.	T	C	19	0	19	0	24	43	0	0
11	22969098	.	C	G	19	20	39	0	0	39	0	0
11	22970283	.	G	A	25	21	46	0	0	46	0	0
11	22995813	.	A	G	12	17	29	0	2	31	0	0
11	22997294	.	C	A	0	12	12	0	14	26	0	0
11	22997402	.	C	T	2	13	15	0	11	26	0	0
11	22997467	.	A	C	15	11	26	0	0	26	0	0
11	23080447	.	C	T	10	18	28	0	0	28	0	0
11	23080639	.	C	T	2	10	12	0	11	23	0	0
11	23080910	.	C	T	13	11	24	0	1	25	0	0
11	23343842	.	A	T	9	10	19	0	1	20	0	0
11	23344109	.	G	A	7	4	11	0	1	12	0	0
11	23344143	.	C	A	5	10	15	0	0	15	0	0
11	23344348	.	C	T	0	8	8	0	9	17	0	0
11	23344608	.	A	C	13	8	21	0	0	21	0	0
11	23345040	.	G	A	7	11	18	0	0	18	0	0
11	23347640	.	T	G	4	5	9	0	7	16	0	0
11	23352639	.	T	G	11	5	16	0	2	18	0	0
11	23365025	.	A	G	6	6	12	0	0	12	0	0
11	23365237	.	A	T	9	4	13	0	1	14	0	0
11	23377379	.	A	G	10	7	17	0	1	18	0	0
11	23377418	.	A	C	9	1	10	0	7	17	0	0
11	23379110	.	T	C	4	3	7	0	2	9	0	0
11	23379332	.	T	G	8	6	14	0	1	15	0	0
11	23403889	.	T	G	6	3	9	0	0	9	0	0
11	23422470	.	C	T	8	5	13	0	0	13	0	0
11	23595538	.	G	T	4	4	8	0	0	8	0	0
11	23595766	.	C	A	7	8	15	0	0	15	0	0
11	23595942	.	C	T	10	6	16	0	0	16	0	0
11	23596240	.	A	G	5	7	12	0	0	12	0	0
11	23596333	.	T	C	4	6	10	0	0	10	0	0
11	23596918	.	T	C	7	4	11	0	0	11	0	0
11	23597098	.	T	C	5	3	8	0	1	9	0	0
11	23597099	.	A	T	6	3	9	0	0	9	0	0
11	23597248	.	T	A	6	3	9	0	0	9	0	0
11	23597356	.	A	C	4	5	9	0	1	10	0	0
11	23597480	.	A	C	5	0	5	0	5	10	0	0
11	23597522	.	C	T	0	8	8	0	6	14	0	0
11	23597537	.	T	C	5	0	5	0	7	12	0	0
11	23597589	.	C	T	0	5	5	0	6	11	0	0
11	23604921	.	T	C	8	5	13	0	0	13	0	0
11	23604954	.	A	G	2	5	7	0	1	8	0	0
11	23606964	.	A	T	8	6	14	0	0	14	0	0
11	23609617	.	T	G	5	8	13	0	1	14	0	0
11	23609702	.	T	C	3	2	5	0	0	5	0	0
11	23612380	.	T	G	8	3	11	0	0	11	0	0
11	23664043	.	A	G	12	4	16	0	0	16	0	0
11	23682048	.	C	A	2	4	6	0	0	6	0	0
11	23686426	.	G	A	3	2	5	0	0	5	0	0
11	23821530	.	C	T	4	3	7	0	1	8	0	0
11	23825482	.	A	C	5	5	10	0	0	10	0	0
11	23825496	.	G	A	5	6	11	0	0	11	0	0
11	23825610	.	T	C	4	7	11	0	1	12	0	0
11	23828245	.	A	G	12	7	19	0	2	21	0	0
11	23834797	.	C	A	4	10	14	0	0	14	0	0
11	23838200	.	G	A	4	3	7	0	8	15	0	0
11	23842292	.	C	T	9	14	23	0	1	24	0	0
11	23842789	.	A	G	8	13	21	0	1	22	0	0
11	23843015	.	C	T	8	8	16	0	0	16	0	0
11	23843072	.	T	A	13	9	22	0	5	27	0	0
11	23843117	.	A	T	16	13	29	0	2	31	0	0
11	23845323	.	C	T	13	21	34	0	2	36	0	0
11	23845329	.	C	A	22	14	36	0	2	38	0	0
11	23856440	.	A	G	9	11	20	0	1	21	0	0
11	23856499	.	A	G	12	0	12	0	11	23	0	0
11	23879521	.	C	T	17	17	34	0	0	34	0	0
11	23879654	.	C	A	27	16	43	0	1	44	0	0
11	23879938	.	C	T	18	11	29	0	2	31	0	0
11	23880429	.	A	T	25	3	28	0	1	29	0	0
11	23880486	.	G	T	8	10	18	0	1	19	0	0
11	23880631	.	G	T	11	11	22	1	0	23	0	0
11	23880698	.	C	T	16	14	30	0	1	31	0	0
11	23880878	.	T	A	10	7	17	0	0	17	0	0
11	23880941	.	C	T	9	11	20	0	2	22	0	0
11	23881054	.	C	T	10	8	18	0	0	18	0	0
11	23881070	.	C	T	11	8	19	0	0	19	0	0
11	23881101	.	G	A	10	6	16	0	0	16	0	0
11	23881131	.	G	C	12	5	17	0	0	17	0	0
11	23881152	.	G	A	0	6	6	0	12	18	0	0
11	23881238	.	A	T	7	7	14	0	0	14	0	0
11	23881247	.	A	T	6	5	11	0	0	11	0	0
11	23881719	.	T	A	1	3	4	0	1	5	0	0
11	23881770	.	G	A	3	4	7	0	0	7	0	0
11	23881784	.	G	A	5	2	7	0	0	7	0	0
11	23881866	.	A	G	5	13	18	0	1	19	0	0
11	23881897	.	G	A	0	4	4	0	14	18	0	0
11	23881913	.	G	T	15	5	20	0	0	20	0	0
11	23882438	.	A	G	12	12	24	0	1	25	0	0
11	23882525	.	T	C	15	11	26	0	0	26	0	0
11	23882572	.	A	T	14	10	24	0	2	26	0	0
11	23882747	.	C	T	26	9	35	0	0	35	0	0
11	23882748	.	C	T	27	9	36	0	0	36	0	0
11	23883147	.	C	T	1	2	3	0	0	3	0	0
11	23883149	.	G	C	2	2	4	0	0	4	0	0
11	23883302	.	G	A	14	9	23	0	0	23	0	0
11	23883340	.	C	T	8	15	23	0	1	24	0	0
11	23883466	.	C	G	16	22	38	0	0	38	0	0
11	23883725	.	G	A	14	10	24	0	0	24	0	0
11	23883747	.	C	T	14	17	31	0	0	31	0	0
11	23883810	.	T	A	9	15	24	0	2	26	0	0
11	23884416	.	G	A	20	23	43	0	1	44	0	0
11	23884742	.	G	A	9	6	15	0	1	16	0	0
11	23933059	.	C	T	13	10	23	0	0	23	0	0
11	23933206	.	C	T	12	11	23	1	1	25	0	0
11	23966779	.	A	G	3	7	10	0	0	10	0	0
11	23970126	.	G	A	11	9	20	0	1	21	0	0
11	23979519	.	C	T	16	20	36	0	1	37	0	0
11	23987655	.	C	T	8	10	18	0	0	18	0	0
11	24055409	.	A	G	7	3	10	0	0	10	0	0
11	24339459	.	C	T	10	18	28	0	0	28	0	0
11	24340251	.	T	C	3	6	9	0	0	9	0	0
11	24340299	.	C	G	5	0	5	0	5	10	0	0
11	24340745	.	T	A	9	8	17	0	1	19	1	0
11	24340807	.	A	G	14	7	21	0	0	21	0	0
11	24341085	.	T	A	10	14	24	0	0	24	0	0
11	24343437	.	C	A	15	23	38	0	1	39	0	0
11	24343458	.	A	G	14	14	28	0	0	28	0	0
11	24344284	.	C	T	24	21	45	0	3	48	0	0
11	24344490	.	G	A	24	22	46	0	1	47	0	0
11	24344902	.	A	C	15	22	37	0	1	39	1	0
11	24344983	.	T	G	11	14	25	0	1	26	0	0
11	24345221	.	C	T	11	10	21	0	1	22	0	0
11	24348553	.	C	G	8	8	16	0	0	16	0	0
11	24349265	.	A	C	10	11	21	0	1	22	0	0
11	24360891	.	C	G	2	8	10	0	0	10	0	0
11	24360924	.	A	G	5	10	15	0	1	16	0	0
11	24360966	.	A	G	8	10	18	0	0	18	0	0
11	24361207	.	T	G	6	8	14	0	0	14	0	0
11	24379360	.	C	T	5	4	9	0	0	9	0	0
11	24379384	.	G	A	7	5	12	0	0	12	0	0
11	24382547	.	C	T	2	4	6	0	6	13	1	0
11	24382604	.	T	C	9	4	13	0	0	13	0	0
11	24430323	.	T	A	1	5	6	0	1	7	0	0
11	24431934	.	T	C	1	3	4	0	0	4	0	0
11	24466237	.	C	A	1	5	6	0	5	11	0	0
11	24471280	.	G	C	6	6	12	0	0	12	0	0
11	24471483	.	G	A	11	6	17	0	0	17	0	0
11	24471518	.	C	T	0	14	14	0	4	18	0	0
11	24471540	.	G	A	12	3	15	0	1	16	0	0
11	24472145	.	T	A	7	6	13	0	0	13	0	0
11	24474384	.	G	A	10	8	18	0	0	18	0	0
11	24476587	.	C	T	4	7	11	0	0	11	0	0
11	24478940	.	G	A	3	6	9	0	0	9	0	0
11	24643194	.	G	A	0	5	5	0	6	11	0	0
11	24643337	.	T	G	8	10	18	0	1	19	0	0
11	24645757	.	T	C	9	4	13	0	0	13	0	0
11	24645880	.	T	C	4	4	8	0	1	9	0	0
11	24645890	.	A	G	5	5	10	0	0	10	0	0
11	24658335	.	T	C	10	8	18	0	0	18	0	0
11	24662830	.	T	A	6	9	15	0	0	15	0	0
11	24662859	.	T	A	7	11	18	0	0	18	0	0
11	24663349	.	C	G	4	3	7	0	1	8	0	0
11	24672154	.	G	T	2	3	5	0	0	5	0	0
11	24672193	.	G	T	1	2	3	0	0	3	0	0
11	24672571	.	C	T	0	2	2	0	3	5	0	0
11	24672607	.	A	G	1	3	4	0	0	4	0	0
11	24759153	.	A	G	1	5	6	0	1	7	0	0
11	24774937	.	T	C	3	3	6	0	0	6	0	0
11	24786415	.	G	A	1	5	6	0	7	13	0	0
11	24786466	.	T	A	10	19	29	0	1	30	0	0
11	24792102	.	T	A	23	11	34	0	0	34	0	0
11	24792460	.	T	C	18	28	46	0	2	48	0	0
11	24796820	.	T	G	17	3	20	1	28	49	0	0
11	24799433	.	T	G	2	8	10	0	1	11	0	0
11	24804565	.	A	T	20	20	40	0	1	41	0	0
11	24805106	.	A	C	16	11	27	0	2	29	0	0
11	24807966	.	A	G	17	11	28	0	4	32	0	0
11	24809738	.	C	T	26	18	44	0	0	44	0	0
11	24813128	.	C	T	13	21	34	0	0	34	0	0
11	24813378	.	C	T	15	14	29	0	2	31	0	0
11	24813500	.	C	A	12	11	23	0	2	25	0	0
11	24813810	.	A	G	13	15	28	0	1	29	0	0
11	24813855	.	C	T	18	20	38	0	2	40	0	0
11	24814014	.	A	G	17	10	27	0	1	28	0	0
11	24817198	.	G	A	7	3	10	0	0	10	0	0
11	24817207	.	C	T	6	3	9	0	0	9	0	0
11	24819667	.	C	T	15	17	32	0	2	35	1	0
11	24825435	.	A	C	12	11	23	0	0	23	0	0
11	24831674	.	T	C	6	8	14	0	0	14	0	0
11	24833382	.	G	A	9	7	16	0	2	18	0	0
11	24833591	.	C	T	7	8	15	0	0	15	0	0
11	24836384	.	C	T	19	17	36	0	0	36	0	0
11	24836409	.	C	T	12	17	29	0	0	29	0	0
11	24843219	.	C	T	11	8	19	0	0	19	0	0
11	24848221	.	T	A	18	15	33	0	0	33	0	0
11	24850428	.	A	G	11	12	23	1	1	25	0	0
11	24856391	.	C	T	5	2	7	0	2	9	0	0
11	24856526	.	C	A	4	3	7	0	0	7	0	0
11	24858813	.	C	T	3	6	9	0	1	10	0	0
11	24858840	.	A	G	4	2	6	0	0	6	0	0
11	24865281	.	A	G	5	6	11	0	1	12	0	0
11	24869046	.	G	A	8	9	17	0	0	17	0	0
11	24869124	.	G	A	7	6	13	0	0	13	0	0
11	24876382	.	A	T	1	4	5	0	0	5	0	0
11	24882864	.	G	A	16	23	39	0	3	42	0	0
11	24884840	.	G	C	22	9	31	1	0	32	0	0
11	24884967	.	C	T	18	13	31	0	5	36	0	0
11	24885128	.	C	T	19	12	31	0	2	33	0	0
11	24885282	.	T	C	13	10	23	0	0	23	0	0
11	24885332	.	C	T	8	11	19	0	0	19	0	0
11	24885357	.	A	T	9	8	17	0	0	17	0	0
11	24885384	.	C	T	5	12	17	0	0	17	0	0
11	24885610	.	G	A	0	3	3	0	4	7	0	0
11	24885734	.	T	C	3	3	6	0	0	6	0	0
11	24885738	.	A	G	3	3	6	0	0	6	0	0
11	24885810	.	A	C	3	9	12	0	0	12	0	0
11	24885928	.	C	T	18	10	28	0	0	28	0	0
11	24885937	.	C	T	18	11	29	0	0	29	0	0
11	24886273	.	G	A	0	21	21	0	17	38	0	0
11	24886429	.	A	G	1	0	1	0	5	6	0	0
11	24886499	.	T	A	3	2	5	0	0	5	0	0
11	24886602	.	G	T	1	8	9	0	12	21	0	0
11	24886686	.	G	T	15	4	19	0	0	19	0	0
11	24886739	.	G	T	22	8	30	0	0	30	0	0
11	24886754	.	G	A	22	9	31	0	0	31	0	0
11	24887501	.	C	T	17	12	29	0	0	29	0	0
11	24887523	.	A	G	18	4	22	0	2	24	0	0
11	24887803	.	A	C	21	12	33	0	4	37	0	0
11	24888186	.	C	T	2	2	4	0	0	4	0	0
11	24888272	.	C	T	12	4	16	0	0	16	0	0
11	24901897	.	C	T	23	27	50	0	2	52	0	0
11	24904588	.	T	C	27	22	49	0	4	53	0	0
11	24905477	.	C	T	31	16	47	0	1	48	0	0
11	24905526	.	G	T	28	16	44	0	1	45	0	0
11	24905541	.	C	T	32	14	46	0	0	46	0	0
11	24905574	.	G	A	34	12	46	0	0	46	0	0
11	24905576	.	C	A	32	12	44	0	1	45	0	0
11	24905632	.	T	G	20	26	46	0	0	46	0	0
11	24905692	.	G	A	3	24	27	0	18	45	0	0
11	24905742	.	C	T	18	23	41	0	4	45	0	0
11	24905748	.	A	G	21	24	45	0	0	45	0	0
11	24905803	.	G	A	23	12	35	0	4	39	0	0
11	24905985	.	G	T	7	14	21	0	0	21	0	0
11	24906069	.	C	T	11	15	26	0	0	26	0	0
11	24906125	.	A	G	10	15	25	0	1	26	0	0
11	24906128	.	T	A	10	13	23	0	2	25	0	0
11	24906177	.	G	T	13	9	22	1	0	23	0	0
11	24906178	.	G	A	12	9	21	1	0	22	0	0
11	24966224	.	C	T	5	4	9	0	1	10	0	0
11	24966245	.	T	C	4	6	10	0	1	11	0	0
11	24966311	.	C	T	5	12	17	0	0	17	0	0
11	24966841	.	G	A	0	6	6	0	10	17	1	0
11	24966981	.	A	G	6	2	8	0	0	8	0	0
11	24972320	.	A	T	11	9	20	0	2	22	0	0
11	24973655	.	T	C	5	5	10	0	0	10	0	0
11	24975594	.	G	T	6	8	14	0	0	14	0	0
11	24975714	.	C	T	8	8	16	0	0	16	0	0
11	24975735	.	C	T	7	8	15	0	0	15	0	0
11	24975855	.	C	T	8	8	16	0	0	16	0	0
11	24975903	.	C	T	6	2	8	0	0	8	0	0
11	24975911	.	A	C	3	6	9	0	0	9	0	0
11	24980714	.	A	C	7	7	14	0	0	14	0	0
11	24987085	.	T	C	7	9	16	0	2	18	0	0
11	24987226	.	C	T	6	7	13	0	0	13	0	0
11	24992445	.	T	A	6	12	18	0	0	18	0	0
11	24992522	.	T	G	2	1	3	0	9	15	3	0
11	24992899	.	C	A	7	7	14	0	0	14	0	0
11	25031497	.	A	T	14	13	27	0	2	29	0	0
11	25040729	.	A	G	6	12	18	0	1	19	0	0
11	25040857	.	C	T	17	12	29	0	2	31	0	0
11	25041190	.	A	T	10	8	18	0	2	20	0	0
11	25041464	.	T	C	7	12	19	0	0	19	0	0
11	25041737	.	T	A	5	3	8	0	0	8	0	0
11	25046686	.	C	G	2	2	4	0	0	4	0	0
11	25048860	.	G	A	0	2	2	0	5	7	0	0
11	25050617	.	G	A	3	4	7	0	1	8	0	0
11	25050621	.	G	C	5	4	9	0	0	9	0	0
11	25053094	.	C	A	2	6	8	0	0	8	0	0
11	25053236	.	C	T	6	4	10	0	0	10	0	0
11	25053820	.	G	A	4	4	8	0	1	9	0	0
11	25062552	.	A	G	3	2	5	0	1	6	0	0
11	25101665	.	C	T	25	26	51	0	0	51	0	0
11	25138995	.	G	T	19	20	39	0	4	43	0	0
11	25167856	.	T	C	7	3	10	0	0	10	0	0
11	25167980	.	G	A	7	2	9	0	0	9	0	0
11	25260136	.	G	T	6	10	16	0	1	17	0	0
11	25260187	.	C	T	13	21	34	0	1	35	0	0
11	25260206	.	T	A	23	8	31	0	2	33	0	0
11	25261665	.	C	T	12	11	23	0	0	23	0	0
11	25261753	.	G	A	1	10	11	0	16	27	0	0
11	25265777	.	G	A	2	10	12	0	7	19	0	0
11	25265867	.	A	T	15	15	30	0	1	31	0	0
11	25265950	.	T	C	13	12	25	0	0	25	0	0
11	25265980	.	A	G	13	8	21	0	1	22	0	0
11	25303803	.	C	T	11	19	30	0	0	30	0	0
11	25306445	.	G	A	14	14	28	0	1	29	0	0
11	25307009	.	C	T	18	14	32	0	3	35	0	0
11	25307234	.	G	A	18	11	29	0	3	32	0	0
11	25307345	.	T	C	17	16	33	0	3	36	0	0
11	25310329	.	G	C	12	15	27	0	0	27	0	0
11	25310777	.	T	G	15	8	23	0	2	25	0	0
11	25311268	.	C	G	15	1	16	1	1	22	4	0
11	25313916	.	C	T	1	4	5	1	3	9	0	0
11	25314551	.	G	A	7	4	11	1	4	16	0	0
11	25314910	.	C	T	9	6	15	0	1	16	0	0
11	25315658	.	T	C	15	10	25	0	0	25	0	0
11	25315701	.	T	A	12	10	22	0	1	23	0	0
11	25315762	.	A	C	13	10	23	0	1	24	0	0
11	25315828	.	A	G	10	10	20	0	0	20	0	0
11	25315894	.	G	A	11	9	20	0	1	21	0	0
11	25316150	.	G	A	11	9	20	0	4	24	0	0
11	25316216	.	T	C	14	15	29	0	1	30	0	0
11	25316351	.	T	A	18	9	27	0	1	28	0	0
11	25316368	.	G	C	16	13	29	0	0	29	0	0
11	25316963	.	G	T	8	14	22	0	2	24	0	0
11	25317362	.	T	C	7	0	7	0	6	13	0	0
11	25317607	.	C	G	10	13	23	0	0	23	0	0
11	25317676	.	T	C	7	10	17	0	1	18	0	0
11	25317875	.	G	A	10	10	20	0	1	21	0	0
11	25318295	.	G	A	12	5	17	0	0	17	0	0
11	25324377	.	T	A	6	6	12	0	0	12	0	0
11	25335896	.	G	A	2	3	5	0	0	5	0	0
11	25383221	.	C	T	3	4	7	0	0	7	0	0
11	25383350	.	C	G	3	2	5	0	0	5	0	0
11	25383839	.	G	A	6	4	10	0	0	10	0	0
11	25383995	.	A	T	1	2	3	0	0	3	0	0
11	25384098	.	C	T	2	2	4	0	0	4	0	0
11	25384132	.	C	T	3	2	5	0	1	6	0	0
11	25384137	.	C	T	3	2	5	0	0	5	0	0
11	25403830	.	A	T	2	5	7	0	1	8	0	0
11	25408022	.	G	T	9	11	20	0	0	20	0	0
11	25414940	.	A	G	1	2	3	0	0	3	0	0
11	25415202	.	A	G	1	3	4	0	0	4	0	0
11	25436961	.	T	A	9	7	16	0	0	16	0	0
11	25437080	.	C	T	7	15	22	0	1	23	0	0
11	25437299	.	C	T	17	11	28	0	1	29	0	0
11	25437417	.	C	T	5	15	20	1	0	21	0	0
11	25437501	.	C	T	7	13	20	2	6	28	0	0
11	25437684	.	G	A	10	13	23	0	2	25	0	0
11	25437866	.	T	G	5	10	15	1	0	16	0	0
11	25437901	.	G	A	10	9	19	1	2	22	0	0
11	25439860	.	G	T	18	15	33	0	0	33	0	0
11	25440511	.	G	A	12	12	24	0	2	26	0	0
11	25441009	.	G	A	11	7	18	0	0	18	0	0
11	25441979	.	T	A	8	14	22	0	1	23	0	0
11	25442057	.	A	C	5	0	5	0	12	17	0	0
11	25442096	.	C	T	10	6	16	0	2	18	0	0
11	25442147	.	G	T	6	14	20	0	0	20	0	0
11	25442313	.	A	G	12	17	29	0	1	30	0	0
11	25442424	.	A	G	4	10	14	0	0	14	0	0
11	25442457	.	G	T	3	9	12	0	0	12	0	0
11	25447276	.	A	G	9	6	15	0	1	16	0	0
11	25447279	.	T	C	8	1	9	0	10	19	0	0
11	25449899	.	C	T	1	6	7	0	7	14	0	0
11	25450113	.	G	A	14	6	20	0	0	20	0	0
11	25450155	.	T	C	7	4	11	0	0	11	0	0
11	25453188	.	C	A	8	3	11	0	1	12	0	0
11	25453201	.	C	T	5	5	10	0	1	11	0	0
11	25453344	.	G	T	14	7	21	0	0	21	0	0
11	25453650	.	C	G	5	3	8	0	0	8	0	0
11	25453652	.	G	A	3	5	8	0	0	8	0	0
11	25456514	.	C	T	0	5	5	0	5	10	0	0
11	25459346	.	C	A	0	4	4	0	6	10	0	0
11	25487521	.	T	C	2	8	10	0	0	10	0	0
11	25490257	.	G	A	7	4	11	0	0	11	0	0
11	25499577	.	A	C	7	10	17	0	0	17	0	0
11	25500587	.	C	T	9	12	21	0	0	21	0	0
11	25500843	.	A	G	5	0	5	0	6	11	0	0
11	25501962	.	C	T	7	13	20	0	0	20	0	0
11	25502058	.	C	T	4	10	14	0	3	17	0	0
11	25502319	.	T	C	6	6	12	0	0	12	0	0
11	25502350	.	A	T	1	2	3	0	0	3	0	0
11	25510648	.	A	G	3	4	7	0	0	7	0	0
11	25517506	.	T	G	2	2	4	0	0	4	0	0
11	25519352	.	C	T	1	2	3	0	0	3	0	0
11	25519463	.	G	A	1	2	3	0	0	3	0	0
11	25519481	.	G	A	3	2	5	0	0	5	0	0
11	25539857	.	T	G	1	4	5	0	0	5	0	0
11	25540580	.	G	C	3	3	6	0	0	6	0	0
11	25542399	.	G	A	5	4	9	0	0	9	0	0
11	25542906	.	A	G	5	11	16	0	0	16	0	0
11	25548043	.	G	T	0	5	5	0	10	15	0	0
11	25548172	.	G	A	2	7	9	0	0	9	0	0
11	25548190	.	C	T	2	4	6	0	0	6	0	0
11	25548305	.	A	C	4	4	8	0	0	8	0	0
11	25549953	.	C	G	9	6	15	0	0	15	0	0
11	25560159	.	A	T	5	6	11	0	2	13	0	0
11	25564003	.	C	T	2	2	4	0	0	4	0	0
11	25565876	.	T	A	2	3	5	0	0	5	0	0
11	25565892	.	T	C	2	5	7	0	0	7	0	0
11	25575100	.	T	C	11	5	16	0	0	16	0	0
11	25575565	.	T	C	3	5	8	0	0	8	0	0
11	25575566	.	T	C	3	5	8	0	0	8	0	0
11	25601695	.	C	A	6	9	15	0	0	15	0	0
11	25612719	.	A	G	13	1	14	0	12	26	0	0
11	25612824	.	C	T	14	11	25	0	2	27	0	0
11	25615018	.	C	A	4	3	7	0	1	8	0	0
11	25615049	.	G	A	3	4	7	0	1	8	0	0
11	25615946	.	A	T	4	6	10	0	0	10	0	0
11	25616465	.	A	C	5	3	8	0	0	8	0	0
11	25616642	.	T	C	2	13	15	0	0	15	0	0
11	25616679	.	T	A	10	8	18	0	0	18	0	0
11	25616691	.	A	G	8	0	8	0	9	17	0	0
11	25616719	.	G	A	8	4	12	0	0	12	0	0
11	25617023	.	T	A	10	4	14	0	0	14	0	0
11	25617027	.	C	A	9	4	13	0	1	14	0	0
11	25617096	.	T	C	3	6	9	0	0	9	0	0
11	25617118	.	A	G	2	7	9	0	1	10	0	0
11	25617382	.	G	A	6	1	7	0	1	8	0	0
11	25617389	.	C	T	6	4	10	0	1	11	0	0
11	25617497	.	G	A	7	8	15	1	2	18	0	0
11	25617900	.	C	T	4	6	10	0	1	11	0	0
11	25618037	.	T	C	7	5	12	0	0	12	0	0
11	25618094	.	G	A	0	5	5	0	6	11	0	0
11	25618127	.	T	C	5	7	12	0	0	12	0	0
11	25618297	.	A	C	1	5	6	0	0	6	0	0
11	25626510	.	C	A	3	2	5	0	0	5	0	0
11	25629968	.	C	T	1	3	4	0	0	4	0	0
11	25630391	.	G	A	5	3	8	0	0	8	0	0
11	25630852	.	C	G	7	3	10	0	0	10	0	0
11	25630905	.	T	A	1	2	3	0	0	3	0	0
11	25631050	.	T	G	3	0	3	0	7	10	0	0
11	25631317	.	G	A	2	2	4	0	0	4	0	0
11	25631434	.	A	T	1	2	3	0	0	3	0	0
11	25631435	.	A	T	1	2	3	0	0	3	0	0
11	25663961	.	C	T	4	6	10	0	0	10	0	0
11	25668264	.	G	A	2	3	5	0	1	6	0	0
11	25668578	.	C	T	2	5	7	0	1	8	0	0
11	25668729	.	C	A	1	4	5	0	0	5	0	0
11	25671502	.	A	G	2	4	6	0	0	6	0	0
11	25671523	.	C	T	2	5	7	0	0	7	0	0
11	25675599	.	A	G	2	4	6	0	0	6	0	0
11	25678397	.	T	C	5	6	11	0	0	11	0	0
11	25678596	.	T	A	4	2	6	0	0	6	0	0
11	25678793	.	C	T	4	2	6	0	1	7	0	0
11	25681350	.	T	G	5	3	8	0	1	9	0	0
11	25681351	.	T	A	6	3	9	0	0	9	0	0
11	25681594	.	C	T	8	8	16	0	3	19	0	0
11	25681602	.	C	A	7	6	13	0	3	16	0	0
11	25681809	.	C	G	8	4	12	0	1	13	0	0
11	25682883	.	G	A	1	6	7	0	12	19	0	0
11	25684396	.	C	T	16	11	27	0	0	27	0	0
11	25684562	.	C	A	9	8	17	0	0	17	0	0
11	25686079	.	T	A	12	12	24	0	1	25	0	0
11	25689233	.	G	C	11	8	19	0	1	20	0	0
11	25689561	.	T	A	4	6	10	0	0	10	0	0
11	25693863	.	A	C	2	3	5	0	0	5	0	0
11	25695409	.	T	C	6	2	8	0	0	8	0	0
11	25695436	.	G	A	5	4	9	0	0	9	0	0
11	25695565	.	T	C	6	5	11	0	0	11	0	0
11	25695577	.	C	T	6	6	12	0	0	12	0	0
11	25695625	.	A	G	4	7	11	0	1	12	0	0
11	25695724	.	C	A	6	7	13	0	3	16	0	0
11	25695733	.	C	T	9	7	16	0	0	16	0	0
11	25695760	.	G	A	2	7	9	0	11	20	0	0
11	25695871	.	G	A	5	3	8	0	0	8	0	0
11	25698776	.	G	C	5	4	9	0	0	9	0	0
11	25699346	.	C	T	3	1	4	0	1	5	0	0
11	25699505	.	C	A	6	8	14	0	0	14	0	0
11	25702397	.	C	T	4	11	15	0	1	16	0	0
11	25705225	.	C	T	13	6	19	0	1	20	0	0
11	25707869	.	G	T	0	6	6	0	9	15	0	0
11	25708008	.	A	G	4	4	8	0	1	9	0	0
11	25708678	.	G	C	3	5	8	0	1	9	0	0
11	25712952	.	T	G	4	9	13	0	0	13	0	0
11	25713124	.	T	A	4	8	12	0	0	12	0	0
11	25713526	.	A	G	11	6	17	0	0	17	0	0
11	25713683	.	G	A	9	9	18	0	2	20	0	0
11	25713820	.	T	C	5	14	19	0	0	19	0	0
11	25714441	.	C	A	7	11	18	0	1	19	0	0
11	25718054	.	C	T	1	12	13	0	17	30	0	0
11	25718179	.	C	T	11	17	28	0	0	28	0	0
11	25718194	.	C	T	17	10	27	0	0	27	0	0
11	25721865	.	C	T	9	16	25	0	2	27	0	0
11	25723425	.	C	T	1	10	11	0	10	21	0	0
11	25723434	.	G	A	8	10	18	0	1	19	0	0
11	25726412	.	G	A	5	7	12	0	0	12	0	0
11	25726770	.	C	A	0	9	9	0	10	19	0	0
11	25729268	.	C	T	1	5	6	0	7	13	0	0
11	25730224	.	G	T	5	5	10	0	0	10	0	0
11	25730390	.	A	G	6	6	12	0	0	12	0	0
11	25730391	.	G	C	6	6	12	0	0	12	0	0
11	25730440	.	G	T	3	5	8	0	0	8	0	0
11	25730463	.	A	C	2	4	6	1	0	7	0	0
11	25733497	.	C	T	9	6	15	0	0	15	0	0
11	25733509	.	C	T	5	10	15	0	0	15	0	0
11	25736707	.	A	T	3	5	8	0	0	8	0	0
11	25740827	.	G	A	1	5	6	0	2	8	0	0
11	25743116	.	C	T	6	6	12	0	0	12	0	0
11	25743465	.	G	A	0	8	8	0	10	18	0	0
11	25749736	.	G	A	16	15	31	0	0	31	0	0
11	25749826	.	A	C	14	17	31	0	2	33	0	0
11	25750003	.	G	A	9	5	14	0	0	14	0	0
11	25750008	.	A	G	8	4	12	0	0	12	0	0
11	25783118	.	C	T	1	8	9	0	8	17	0	0
11	25783353	.	T	A	4	5	9	0	1	10	0	0
11	25783435	.	T	G	13	5	18	0	0	18	0	0
11	25789218	.	A	G	5	9	14	0	1	15	0	0
11	25791044	.	C	A	0	5	5	0	4	9	0	0
11	25791065	.	A	T	4	3	7	0	1	8	0	0
11	25866443	.	A	T	9	8	17	0	1	18	0	0
11	25868801	.	C	T	10	12	22	0	1	23	0	0
11	25871408	.	G	A	12	9	21	0	0	21	0	0
11	25887514	.	G	A	14	19	33	0	3	36	0	0
11	25893627	.	C	T	15	12	27	0	0	27	0	0
11	25893943	.	A	G	18	11	29	0	1	30	0	0
11	26180292	.	C	T	2	19	21	0	18	39	0	0
11	26180338	.	A	G	1	2	3	0	1	4	0	0
11	26190876	.	C	A	2	6	8	0	1	9	0	0
11	26191029	.	G	A	5	6	11	0	0	11	0	0
11	26191901	.	A	T	9	6	15	0	0	15	0	0
11	26192852	.	C	T	8	4	12	0	0	12	0	0
11	26193377	.	C	T	1	7	8	0	10	18	0	0
11	26193721	.	T	G	4	7	11	0	1	12	0	0
11	26194289	.	C	A	7	11	18	0	1	19	0	0
11	26194838	.	C	T	10	9	19	0	0	19	0	0
11	26194843	.	G	T	9	10	19	0	0	19	0	0
11	26194873	.	T	C	8	8	16	0	0	16	0	0
11	26195300	.	T	C	4	7	11	0	0	11	0	0
11	26195411	.	T	A	8	3	11	0	0	12	1	0
11	26196073	.	A	T	5	2	7	0	0	7	0	0
11	26197496	.	C	T	0	2	2	0	6	8	0	0
11	26229464	.	C	A	17	11	28	0	1	29	0	0
11	26229587	.	T	C	9	2	11	0	2	13	0	0
11	26229809	.	T	C	9	15	24	0	1	25	0	0
11	26230302	.	G	A	7	8	15	0	0	15	0	0
11	26230756	.	T	G	6	8	14	0	0	14	0	0
11	26230847	.	C	T	13	6	19	2	1	22	0	0
11	26230972	.	A	G	9	11	20	0	0	20	0	0
11	26232658	.	C	G	3	2	5	0	4	9	0	0
11	26233522	.	A	T	5	5	10	0	0	10	0	0
11	26239092	.	A	G	7	13	20	0	1	21	0	0
11	26242650	.	G	T	11	14	25	0	1	26	0	0
11	26311763	.	C	T	0	4	4	0	11	15	0	0
11	26363534	.	G	A	2	5	7	0	0	7	0	0
11	26366806	.	G	A	0	2	2	0	3	5	0	0
11	26370720	.	A	T	4	2	6	0	0	6	0	0
11	26370780	.	A	G	2	6	8	0	1	9	0	0
11	26370804	.	G	A	3	4	7	0	0	7	0	0
11	26371212	.	G	T	5	3	8	0	0	8	0	0
11	26371216	.	C	T	4	4	8	0	0	8	0	0
11	26373647	.	C	T	0	2	2	0	1	3	0	0
11	26373798	.	T	C	1	1	2	0	3	5	0	0
11	26373912	.	C	T	4	2	6	0	0	6	0	0
11	26375500	.	A	T	4	2	6	0	0	6	0	0
11	26376034	.	G	T	8	7	15	0	0	15	0	0
11	26380197	.	C	A	3	6	9	0	0	9	0	0
11	26380800	.	A	T	3	8	11	0	0	11	0	0
11	26380812	.	C	T	4	8	12	0	0	12	0	0
11	26380938	.	G	A	10	6	16	0	1	17	0	0
11	26380977	.	G	A	12	5	17	0	1	18	0	0
11	26381100	.	C	T	6	9	15	0	0	15	0	0
11	26381145	.	C	T	5	5	10	0	0	10	0	0
11	26381313	.	T	A	5	5	10	0	1	11	0	0
11	26382578	.	T	A	9	4	13	0	0	13	0	0
11	26382756	.	T	C	14	12	26	0	0	26	0	0
11	26383068	.	C	T	5	4	9	0	0	9	0	0
11	26383120	.	T	C	4	3	7	0	0	7	0	0
11	26390309	.	T	C	7	6	13	0	1	14	0	0
11	26391453	.	A	G	13	3	16	0	1	17	0	0
11	26396076	.	G	A	0	9	9	0	2	11	0	0
11	26396408	.	T	C	12	8	20	0	0	20	0	0
11	26398057	.	T	A	9	11	20	0	0	20	0	0
11	26398081	.	A	T	12	11	23	0	0	23	0	0
11	26400782	.	G	C	4	7	11	0	0	11	0	0
11	26400817	.	G	T	8	7	15	0	0	15	0	0
11	26400841	.	T	C	9	5	14	0	0	14	0	0
11	26400916	.	C	T	18	14	32	0	0	32	0	0
11	26401179	.	G	A	3	3	6	0	0	6	0	0
11	26401248	.	G	T	4	4	8	0	1	9	0	0
11	26401413	.	C	T	8	5	13	0	0	13	0	0
11	26476212	.	C	A	0	2	2	1	1	4	0	0
11	26505727	.	T	C	1	2	3	0	0	3	0	0
11	26523792	.	A	C	3	2	5	0	0	5	0	0
11	26539382	.	A	G	1	4	5	0	0	5	0	0
11	26540496	.	T	C	2	4	6	0	0	6	0	0
11	26545685	.	G	A	5	2	7	0	0	7	0	0
11	26545746	.	A	G	5	2	7	0	0	7	0	0
11	26545779	.	A	G	5	2	7	0	0	7	0	0
11	26545819	.	A	G	7	3	10	1	2	13	0	0
11	26551165	.	G	A	0	4	4	0	3	7	0	0
11	26562035	.	G	A	8	4	12	0	0	12	0	0
11	26562042	.	T	C	7	3	10	0	1	11	0	0
11	26562132	.	C	A	8	6	14	0	0	14	0	0
11	26568729	.	T	A	1	2	3	0	0	3	0	0
11	26610919	.	C	A	29	29	58	0	0	58	0	0
11	26614389	.	T	C	28	39	67	2	1	71	1	0
11	26614487	.	G	T	20	36	56	0	1	57	0	0
11	26614649	.	A	G	36	0	36	0	20	56	0	0
11	26614713	.	C	A	28	16	44	0	2	46	0	0
11	26614718	.	G	A	5	13	18	0	26	44	0	0
11	26614755	.	C	A	17	14	31	0	0	31	0	0
11	26614910	.	C	T	16	22	38	0	0	38	0	0
11	26615112	.	T	G	20	16	36	0	3	39	0	0
11	26615201	.	A	G	27	22	49	0	2	51	0	0
11	26615425	.	T	C	12	23	35	0	1	36	0	0
11	26683250	.	C	T	7	2	9	0	2	11	0	0
11	26683596	.	G	C	8	3	11	0	0	11	0	0
11	26695901	.	A	G	6	4	10	0	1	11	0	0
11	26705105	.	T	C	17	6	23	0	1	24	0	0
11	26705111	.	G	A	18	6	24	0	0	24	0	0
11	26705239	.	C	A	13	17	30	0	0	30	0	0
11	26705540	.	G	A	6	7	13	0	1	14	0	0
11	26705738	.	G	T	15	13	28	0	0	28	0	0
11	26705851	.	C	A	2	11	13	0	5	18	0	0
11	26705898	.	T	C	10	7	17	0	1	18	0	0
11	26706015	.	G	A	18	9	27	5	0	32	0	0
11	26706124	.	A	T	16	6	22	0	1	23	0	0
11	26706522	.	A	G	11	10	21	0	0	21	0	0
11	26706789	.	C	T	16	9	25	0	1	26	0	0
11	26706862	.	A	C	18	12	30	0	2	32	0	0
11	26707110	.	T	C	16	14	30	0	2	32	0	0
11	26707152	.	A	C	11	0	11	0	14	25	0	0
11	26707162	.	G	A	10	10	20	0	3	23	0	0
11	26707325	.	T	C	16	1	17	0	23	40	0	0
11	26707367	.	C	A	3	11	14	0	25	39	0	0
11	26714379	.	C	T	13	14	27	0	2	29	0	0
11	26715590	.	C	T	15	11	26	0	4	30	0	0
11	26722167	.	A	G	17	8	25	0	0	25	0	0
11	26722247	.	A	G	9	13	22	0	1	23	0	0
11	26739994	.	T	G	12	19	31	0	1	32	0	0
11	26740022	.	T	C	8	17	25	0	3	28	0	0
11	26740223	.	C	T	10	9	19	0	0	19	0	0
11	26740279	.	G	T	14	9	23	0	0	23	0	0
11	26740697	.	T	A	9	11	20	0	0	20	0	0
11	26740784	.	A	G	9	6	15	0	0	15	0	0
11	26741797	.	G	A	6	10	16	0	1	17	0	0
11	26741869	.	G	A	12	7	19	0	0	19	0	0
11	26961994	.	A	G	4	5	9	0	0	9	0	0
11	27156849	.	T	C	8	5	13	0	2	15	0	0
11	27195745	.	A	T	11	4	15	0	1	16	0	0
11	27197268	.	T	C	7	4	11	0	1	12	0	0
11	27197299	.	T	C	3	6	9	0	2	11	0	0
11	27197358	.	T	G	6	5	11	0	0	11	0	0
11	27197359	.	T	G	6	5	11	0	0	11	0	0
11	27197395	.	G	A	7	2	9	0	0	9	0	0
11	27367192	.	G	A	0	2	2	0	1	3	0	0
11	27487296	.	T	C	1	7	8	0	0	8	0	0
11	27487346	.	T	C	3	3	6	0	0	6	0	0
11	27487411	.	A	G	10	6	16	0	0	16	0	0
11	27487557	.	G	T	10	6	16	0	0	16	0	0
11	27487862	.	T	C	5	3	8	0	1	9	0	0
11	27488085	.	T	C	6	3	9	0	1	10	0	0
11	27488312	.	C	T	4	5	9	0	1	10	0	0
11	27488369	.	G	C	9	11	20	0	0	20	0	0
11	27488600	.	T	C	8	7	15	0	1	16	0	0
11	27495512	.	G	A	4	3	7	0	0	7	0	0
11	27499016	.	G	T	5	3	8	0	0	8	0	0
11	27500686	.	T	C	5	6	11	0	0	11	0	0
11	27512077	.	G	A	1	2	3	0	0	3	0	0
11	27516861	.	C	T	0	6	6	0	6	12	0	0
11	27516891	.	C	T	0	3	3	0	6	9	0	0
11	27517157	.	G	A	5	5	10	0	1	11	0	0
11	27517168	.	T	C	3	5	8	0	2	10	0	0
11	27517671	.	C	T	4	3	7	0	0	7	0	0
11	27521559	.	C	T	4	4	8	0	0	8	0	0
11	27526278	.	A	G	5	4	9	0	0	9	0	0
11	27644826	.	A	G	3	9	12	0	1	13	0	0
11	27645316	.	T	C	2	2	4	0	1	5	0	0
11	27645617	.	T	G	6	10	16	0	1	17	0	0
11	27645740	.	A	T	8	6	14	0	0	14	0	0
11	27645764	.	A	T	4	7	11	0	0	11	0	0
11	27645935	.	C	T	5	3	8	0	0	8	0	0
11	27646115	.	G	T	3	5	8	0	1	9	0	0
11	27646210	.	G	C	7	5	12	0	0	12	0	0
11	27646298	.	A	G	12	10	22	0	1	23	0	0
11	27646681	.	C	T	11	9	20	0	0	20	0	0
11	27649329	.	A	G	11	12	23	0	0	23	0	0
11	27649343	.	A	G	11	13	24	0	1	25	0	0
11	27649454	.	G	A	17	14	31	0	2	33	0	0
11	27652623	.	C	T	2	8	10	0	12	22	0	0
11	27652641	.	G	A	17	11	28	0	0	28	0	0
11	27655732	.	A	G	13	10	23	0	0	23	0	0
11	27655774	.	C	T	0	13	13	0	11	24	0	0
11	27655855	.	T	A	19	13	32	0	0	32	0	0
11	27673289	.	C	T	14	11	25	0	0	25	0	0
11	27679924	.	A	G	6	5	11	0	1	12	0	0
11	27705215	.	T	A	5	7	12	0	0	13	1	0
11	27705660	.	C	A	15	8	23	0	1	24	0	0
11	27705762	.	C	T	9	11	20	0	1	21	0	0
11	27706060	.	G	A	15	9	24	0	0	24	0	0
11	27706441	.	T	C	5	0	5	0	9	14	0	0
11	27710443	.	C	T	15	11	26	1	0	27	0	0
11	27713527	.	C	T	1	9	10	0	11	21	0	0
11	27713663	.	C	T	12	5	17	0	2	19	0	0
11	27718971	.	G	A	10	9	19	0	1	20	0	0
11	27718989	.	G	A	12	11	23	0	0	23	0	0
11	27719203	.	A	G	9	14	23	0	1	24	0	0
11	27719350	.	G	T	11	8	19	0	0	19	0	0
11	27721515	.	T	G	6	7	13	0	3	16	0	0
11	27725145	.	T	G	11	11	22	0	0	22	0	0
11	27727550	.	C	T	0	4	4	0	18	22	0	0
11	27727592	.	G	A	11	7	18	0	1	19	0	0
11	27727631	.	A	G	9	11	20	0	0	20	0	0
11	27738118	.	A	G	8	13	21	0	1	22	0	0
11	27743644	.	C	A	1	4	5	0	0	5	0	0
11	27743924	.	G	A	2	4	6	0	0	6	0	0
11	27744111	.	A	G	3	2	5	0	1	6	0	0
11	27744151	.	T	C	2	6	8	0	0	8	0	0
11	27745922	.	G	T	1	2	3	0	0	3	0	0
11	27746047	.	C	T	2	5	7	0	0	7	0	0
11	27746121	.	C	T	2	2	4	0	1	5	0	0
11	27746123	.	G	A	2	3	5	0	0	5	0	0
11	27750813	.	C	T	2	4	6	0	0	6	0	0
11	27817597	.	T	G	2	4	6	0	0	6	0	0
11	27817636	.	C	G	0	5	5	0	2	7	0	0
11	27817767	.	G	A	1	3	4	0	0	4	0	0
11	27818188	.	G	C	3	4	7	0	0	7	0	0
11	27818239	.	T	C	8	7	15	0	0	15	0	0
11	27818343	.	G	C	6	5	11	0	0	11	0	0
11	27818393	.	C	G	5	3	8	0	0	8	0	0
11	27818521	.	C	A	7	6	13	0	0	13	0	0
11	27818722	.	T	C	11	14	25	1	1	27	0	0
11	27820698	.	C	G	8	7	15	0	1	16	0	0
11	27820992	.	C	T	1	4	5	0	9	14	0	0
11	27821715	.	A	C	5	1	6	0	3	9	0	0
11	27827057	.	A	T	5	6	11	0	0	11	0	0
11	27828950	.	T	A	8	7	15	0	0	15	0	0
11	27829089	.	C	T	1	6	7	0	16	23	0	0
11	27829157	.	T	C	17	15	32	0	0	32	0	0
11	27829201	.	A	G	13	15	28	0	1	29	0	0
11	27829222	.	C	T	0	19	19	0	12	31	0	0
11	27829264	.	G	A	10	21	31	0	0	31	0	0
11	27829402	.	A	G	5	3	8	0	0	8	0	0
11	27829555	.	G	A	8	6	14	0	0	14	0	0
11	27829592	.	A	G	11	7	18	0	0	18	0	0
11	27829700	.	T	C	20	0	20	0	7	28	1	0
11	27829702	.	T	C	19	7	26	0	1	27	0	0
11	27834947	.	T	C	14	0	14	0	7	21	0	0
11	27835372	.	C	A	19	10	29	0	1	30	0	0
11	27838670	.	C	T	17	12	29	0	1	30	0	0
11	27840160	.	A	G	13	12	25	0	0	25	0	0
11	27842815	.	G	A	11	12	23	0	0	23	0	0
11	27843024	.	A	G	12	10	22	0	2	24	0	0
11	27845701	.	A	G	9	10	19	0	2	21	0	0
11	27847409	.	C	T	13	14	27	0	2	29	0	0
11	27857379	.	A	G	6	3	9	0	0	9	0	0
11	27861878	.	A	T	6	8	14	0	0	14	0	0
11	27864719	.	T	C	7	14	21	0	0	21	0	0
11	27864720	.	G	T	6	13	19	0	1	20	0	0
11	27864782	.	C	A	1	10	11	1	7	19	0	0
11	27864809	.	T	G	8	14	22	1	0	23	0	0
11	27866144	.	G	T	9	6	15	1	0	16	0	0
11	27866392	.	T	C	3	10	13	0	1	14	0	0
11	27867140	.	T	G	8	5	13	0	0	13	0	0
11	27874042	.	T	C	15	1	16	0	16	32	0	0
11	27896518	.	C	A	1	18	19	0	13	32	0	0
11	27989362	.	A	C	3	4	7	0	0	7	0	0
11	28002151	.	T	A	2	6	8	0	0	8	0	0
11	28005344	.	C	T	4	7	11	0	0	11	0	0
11	28009832	.	A	G	9	0	9	0	12	21	0	0
11	28009874	.	C	T	5	8	13	0	0	13	0	0
11	28009889	.	T	C	5	6	11	0	0	11	0	0
11	28010115	.	A	T	2	2	4	1	1	6	0	0
11	28110207	.	T	G	2	2	4	0	0	4	0	0
11	28110275	.	A	G	1	2	3	0	0	3	0	0
11	28110276	.	A	G	1	2	3	0	0	3	0	0
11	28123076	.	C	A	1	2	3	0	0	3	0	0
11	28123099	.	C	T	1	2	3	0	0	3	0	0
11	28123238	.	T	A	3	3	6	0	0	6	0	0
11	28124712	.	T	A	3	2	5	0	0	5	0	0
11	28124715	.	C	A	3	2	5	0	0	5	0	0
11	28310864	.	A	T	5	2	7	0	0	7	0	0
11	28310870	.	A	C	5	2	7	0	0	7	0	0
11	28310933	.	T	G	7	8	15	0	0	15	0	0
11	28311065	.	G	A	7	4	11	0	0	11	0	0
11	28311228	.	A	C	8	8	16	0	0	16	0	0
11	28362294	.	A	C	9	5	14	0	0	14	0	0
11	28366380	.	G	A	0	2	2	0	5	7	0	0
11	28366617	.	T	A	4	5	9	0	0	9	0	0
11	28400163	.	C	T	10	8	18	0	1	19	0	0
11	28419351	.	G	A	0	3	3	0	5	8	0	0
11	28419651	.	C	T	12	9	21	1	2	24	0	0
11	28419658	.	C	T	11	8	19	1	2	22	0	0
11	28420264	.	T	G	8	0	8	0	7	15	0	0
11	28420602	.	T	C	4	6	10	0	0	10	0	0
11	28420880	.	T	C	5	6	11	0	0	11	0	0
11	28421115	.	T	G	6	9	15	0	0	15	0	0
11	28422071	.	G	A	4	3	7	0	0	7	0	0
11	28422160	.	A	C	4	7	11	0	1	12	0	0
11	28422263	.	T	C	12	9	21	0	1	22	0	0
11	28422273	.	C	T	9	9	18	0	1	19	0	0
11	28422662	.	C	A	14	7	21	0	0	21	0	0
11	28422929	.	T	G	6	1	7	0	11	18	0	0
11	28423061	.	C	T	8	11	19	0	0	19	0	0
11	28423064	.	T	A	8	10	18	0	1	19	0	0
11	28423137	.	A	G	2	0	2	0	11	13	0	0
11	28423325	.	C	T	9	9	18	0	0	18	0	0
11	28423628	.	A	T	8	8	16	0	1	17	0	0
11	28424012	.	C	T	3	4	7	0	1	8	0	0
11	28478026	.	T	C	8	9	17	2	0	19	0	0
11	28513792	.	A	G	6	9	15	0	0	15	0	0
11	28513960	.	T	C	7	7	14	0	1	15	0	0
11	28514058	.	G	T	7	7	14	0	0	14	0	0
11	28514089	.	T	C	6	7	13	0	0	13	0	0
11	28514747	.	A	T	4	6	10	0	0	10	0	0
11	28514803	.	T	C	7	7	14	0	1	15	0	0
11	28590985	.	G	C	3	2	5	0	0	5	0	0
11	28597526	.	G	A	2	2	4	0	0	4	0	0
11	28643064	.	G	T	16	12	28	0	2	30	0	0
11	28643141	.	G	A	26	17	43	0	0	43	0	0
11	28643155	.	G	A	23	15	38	0	0	38	0	0
11	28661028	.	A	G	15	24	39	0	2	41	0	0
11	28911158	.	T	C	23	16	39	0	1	40	0	0
11	29331609	.	T	C	7	6	13	0	0	13	0	0
11	29331695	.	A	G	6	7	13	0	0	13	0	0
11	29331854	.	T	C	7	7	14	0	1	15	0	0
11	29331915	.	T	A	7	5	12	0	0	12	0	0
11	29332357	.	A	G	6	2	8	0	0	8	0	0
11	29332600	.	A	G	3	12	15	0	0	15	0	0
11	29333423	.	C	A	0	7	7	0	3	10	0	0
11	29333665	.	C	A	2	3	5	0	0	5	0	0
11	29334116	.	T	C	3	3	6	0	0	6	0	0
11	29334646	.	G	A	1	6	7	0	0	7	0	0
11	29334683	.	T	C	1	7	8	0	0	8	0	0
11	29334705	.	A	T	1	5	6	0	0	6	0	0
11	29335390	.	T	A	4	2	6	0	0	6	0	0
11	29335597	.	T	G	3	2	5	0	0	5	0	0
11	29335661	.	G	T	2	3	5	0	1	6	0	0
11	29335717	.	C	T	0	2	2	0	2	4	0	0
11	29347758	.	A	G	4	2	6	0	1	7	0	0
11	29347794	.	A	G	5	2	7	1	0	8	0	0
11	29389152	.	T	C	2	4	6	0	0	6	0	0
11	29389153	.	G	A	2	4	6	0	0	6	0	0
11	29471249	.	C	T	1	3	4	0	0	4	0	0
11	29540347	.	T	G	3	4	7	0	0	7	0	0
11	29540366	.	G	A	1	2	3	0	0	3	0	0
11	29551879	.	C	A	3	3	6	0	1	7	0	0
11	29575177	.	T	A	15	9	24	1	2	27	0	0
11	29575390	.	G	A	16	14	30	0	2	32	0	0
11	29575736	.	C	A	20	17	37	0	0	37	0	0
11	29575964	.	G	A	15	12	27	0	0	27	0	0
11	29576022	.	A	C	14	10	24	0	2	26	0	0
11	29576213	.	G	T	15	4	19	0	0	19	0	0
11	29576643	.	C	T	6	4	10	0	0	10	0	0
11	29576654	.	T	G	4	4	8	0	0	8	0	0
11	29577230	.	C	T	22	6	28	0	1	29	0	0
11	29577566	.	C	T	5	17	22	0	0	22	0	0
11	29577598	.	T	C	8	0	8	0	19	27	0	0
11	29577651	.	A	T	18	7	25	0	0	25	0	0
11	29577762	.	C	A	10	11	21	0	2	23	0	0
11	29577849	.	T	A	11	16	27	0	0	27	0	0
11	29577861	.	T	A	11	16	27	0	0	27	0	0
11	29577890	.	G	A	11	10	21	1	0	22	0	0
11	29577927	.	T	G	7	7	14	0	1	15	0	0
11	29577958	.	T	A	4	3	7	0	2	9	0	0
11	29577965	.	T	A	7	4	11	0	0	11	0	0
11	29578070	.	C	T	1	14	15	0	12	27	0	0
11	29578091	.	C	T	14	8	22	0	1	23	0	0
11	29578133	.	T	C	15	1	16	0	6	22	0	0
11	29578139	.	A	G	14	6	20	0	2	22	0	0
11	29578217	.	G	T	20	8	28	0	0	28	0	0
11	29578265	.	G	A	15	10	25	0	2	27	0	0
11	29581774	.	T	C	17	1	18	0	13	31	0	0
11	29581828	.	A	G	16	16	32	0	3	35	0	0
11	29584517	.	G	A	11	15	26	0	2	28	0	0
11	29587885	.	A	G	16	16	32	0	2	34	0	0
11	29587963	.	C	T	16	12	28	0	1	29	0	0
11	29589186	.	T	A	20	10	30	0	1	31	0	0
11	29589370	.	C	T	12	12	24	0	6	30	0	0
11	29593372	.	T	C	10	12	22	0	1	23	0	0
11	29596227	.	A	G	10	9	19	0	2	21	0	0
11	29612576	.	A	G	11	8	19	0	0	19	0	0
11	29614074	.	T	C	11	0	11	0	9	20	0	0
11	29614086	.	T	C	8	11	19	0	3	22	0	0
11	29614556	.	T	C	9	12	21	1	2	25	1	0
11	29614569	.	T	C	9	12	21	1	0	22	0	0
11	29614592	.	G	A	12	9	21	1	0	22	0	0
11	29617672	.	G	A	11	11	22	0	0	23	1	0
11	29617749	.	T	G	11	8	19	0	0	19	0	0
11	29618162	.	G	A	14	11	25	0	0	25	0	0
11	29623647	.	T	C	15	5	20	0	0	20	0	0
11	29624186	.	T	C	10	0	10	0	9	19	0	0
11	29626180	.	G	A	9	13	22	0	1	23	0	0
11	29637556	.	T	C	6	7	13	0	1	14	0	0
11	29650797	.	G	C	1	3	4	0	0	4	0	0
11	29652586	.	C	A	2	2	4	0	0	4	0	0
11	29652838	.	T	C	27	21	48	0	1	49	0	0
11	29655418	.	C	T	28	30	58	0	0	58	0	0
11	29685445	.	T	C	3	3	6	0	0	6	0	0
11	29756928	.	T	A	1	3	4	0	0	4	0	0
11	29757258	.	T	C	6	3	9	0	1	10	0	0
11	29760659	.	A	G	12	6	18	0	1	20	1	0
11	29760674	.	A	G	16	5	21	0	1	22	0	0
11	29762946	.	G	A	14	12	26	0	0	26	0	0
11	29917881	.	A	T	7	3	10	0	0	10	0	0
11	29918070	.	T	C	1	3	4	2	0	6	0	0
11	29918168	.	T	C	4	5	9	0	0	9	0	0
11	30147877	.	G	A	3	6	9	0	0	9	0	0
11	30149775	.	C	A	2	2	4	0	2	6	0	0
11	30201723	.	A	G	8	11	19	0	1	20	0	0
11	30205707	.	C	A	10	10	20	0	1	21	0	0
11	30219477	.	G	A	0	14	14	0	15	29	0	0
11	30219663	.	T	C	21	17	38	0	0	38	0	0
11	30221173	.	A	G	21	0	21	0	19	40	0	0
11	30221188	.	A	G	18	17	35	0	1	36	0	0
11	30222912	.	T	C	11	19	30	0	1	31	0	0
11	30222942	.	G	A	7	20	27	0	2	29	0	0
11	30222963	.	G	A	2	22	24	0	9	33	0	0
11	30366944	.	G	A	2	2	4	0	1	5	0	0
11	30642164	.	A	G	5	5	10	0	0	10	0	0
11	31024887	.	A	G	17	8	25	0	0	25	0	0
11	31668751	.	A	G	1	5	6	0	1	7	0	0
11	31668752	.	A	G	2	3	5	0	1	6	0	0
11	33846497	.	T	C	6	5	11	0	0	11	0	0
11	33846519	.	T	C	6	5	11	0	1	12	0	0
11	33997556	.	T	C	3	2	5	0	0	5	0	0
11	34779198	.	T	C	1	3	4	0	0	4	0	0
11	34780333	.	G	A	6	6	12	0	1	13	0	0
11	34824331	.	G	A	15	12	27	0	0	27	0	0
11	34856424	.	A	G	14	6	20	0	1	21	0	0
11	34859637	.	C	T	6	7	13	0	0	13	0	0
11	34899393	.	A	G	13	6	19	2	1	22	0	0
11	34900464	.	C	T	5	15	20	0	0	20	0	0
11	34900516	.	A	G	11	9	20	0	1	21	0	0
11	34900521	.	C	T	12	9	21	0	0	21	0	0
11	34907287	.	G	C	8	12	20	0	2	22	0	0
11	34907537	.	A	G	7	0	7	0	6	13	0	0
11	34907682	.	A	G	5	6	11	0	0	11	0	0
11	34907726	.	T	A	12	4	16	0	0	16	0	0
11	34907794	.	T	C	7	3	10	0	1	11	0	0
11	34907876	.	T	A	9	10	19	0	1	20	0	0
11	34908165	.	C	T	7	6	13	0	1	14	0	0
11	34908187	.	G	C	6	7	13	0	0	13	0	0
11	34908201	.	C	T	6	7	13	0	1	14	0	0
11	34908431	.	G	A	10	15	25	0	1	26	0	0
11	34908448	.	T	A	14	13	27	0	1	28	0	0
11	34908516	.	C	A	6	12	18	0	4	22	0	0
11	34908545	.	A	T	5	7	12	0	1	13	0	0
11	34908597	.	T	C	5	10	15	0	1	16	0	0
11	34908854	.	T	G	2	5	7	0	0	7	0	0
11	34909268	.	T	A	18	8	26	0	4	30	0	0
11	34909288	.	G	T	0	17	17	0	8	25	0	0
11	34909353	.	C	A	11	10	21	1	0	22	0	0
11	34909560	.	T	C	2	2	4	0	1	5	0	0
11	34909618	.	A	G	7	9	16	0	0	16	0	0
11	34909868	.	C	T	10	9	19	0	1	20	0	0
11	34909916	.	C	T	12	10	22	0	1	23	0	0
11	34909997	.	G	T	15	6	21	0	0	21	0	0
11	34910349	.	C	T	16	16	32	0	0	32	0	0
11	34910468	.	T	C	8	17	25	0	2	27	0	0
11	34910487	.	T	C	10	14	24	0	1	25	0	0
11	34910503	.	C	T	10	16	26	0	1	27	0	0
11	34910644	.	C	T	4	6	10	0	1	11	0	0
11	34910654	.	C	T	6	8	14	0	1	15	0	0
11	34910867	.	T	A	17	7	24	0	1	25	0	0
11	34910897	.	A	G	13	14	27	1	1	29	0	0
11	34911229	.	G	A	18	11	29	1	0	30	0	0
11	34911445	.	A	G	20	17	37	0	0	37	0	0
11	34911451	.	T	A	20	16	36	0	2	38	0	0
11	34912481	.	G	A	26	13	39	0	0	39	0	0
11	34912616	.	G	A	30	13	43	0	1	44	0	0
11	34912850	.	G	A	22	14	36	2	0	38	0	0
11	34913101	.	C	A	17	11	28	0	0	28	0	0
11	34913454	.	G	A	7	5	12	0	1	13	0	0
11	34913611	.	T	A	0	2	2	0	2	4	0	0
11	34914190	.	G	A	23	14	37	1	0	38	0	0
11	35019847	.	C	T	12	8	20	0	1	21	0	0
11	35034669	.	G	A	18	15	33	0	0	33	0	0
11	35038124	.	G	C	0	12	12	0	7	20	1	0
11	36158316	.	A	C	2	2	4	0	0	4	0	0
11	36158379	.	A	C	11	10	21	0	1	22	0	0
11	36158839	.	G	T	8	10	18	0	0	18	0	0
11	36180612	.	C	T	11	10	21	0	0	21	0	0
11	36180666	.	C	T	7	6	13	0	1	14	0	0
11	36180774	.	A	G	7	8	15	0	1	16	0	0
11	36180775	.	T	C	8	8	16	0	0	16	0	0
11	36180831	.	G	T	1	9	10	0	9	19	0	0
11	36180876	.	C	A	10	6	16	0	0	16	0	0
11	36205992	.	C	T	13	6	19	0	0	19	0	0
11	36206090	.	C	T	11	7	18	0	0	18	0	0
11	36208199	.	G	A	9	17	26	0	0	26	0	0
11	36208328	.	G	A	2	10	12	0	10	22	0	0
11	36214517	.	C	T	17	25	42	0	0	42	0	0
11	36214601	.	G	A	2	20	22	0	20	42	0	0
11	36214815	.	G	A	2	14	16	0	15	31	0	0
11	36215346	.	G	A	15	10	25	0	1	26	0	0
11	36215459	.	A	G	7	3	10	0	0	10	0	0
11	36215584	.	G	C	4	5	9	0	0	9	0	0
11	36224767	.	G	A	4	3	7	0	0	7	0	0
11	36224780	.	T	C	2	0	2	0	3	5	0	0
11	36227568	.	C	A	2	2	4	0	1	5	0	0
11	36227589	.	C	G	1	2	3	0	2	5	0	0
11	36228093	.	G	A	1	4	5	0	0	5	0	0
11	36230065	.	A	T	2	5	7	0	0	7	0	0
11	36231440	.	A	C	2	5	7	0	0	7	0	0
11	36237094	.	C	T	6	4	10	0	0	10	0	0
11	36254679	.	T	C	2	3	5	0	1	6	0	0
11	36254683	.	T	C	4	3	7	0	0	7	0	0
11	36258658	.	T	C	1	2	3	0	0	3	0	0
11	36258951	.	A	G	7	9	16	0	1	17	0	0
11	36263954	.	A	G	14	9	23	0	0	23	0	0
11	36269682	.	G	A	7	11	18	0	1	19	0	0
11	36269768	.	A	G	20	9	29	0	2	31	0	0
11	36281881	.	A	G	8	10	18	0	0	18	0	0
11	36281939	.	T	G	5	11	16	0	2	18	0	0
11	36281943	.	G	A	5	13	18	0	0	18	0	0
11	36282081	.	A	T	3	8	11	0	1	12	0	0
11	36282259	.	A	T	2	2	4	0	0	4	0	0
11	36282361	.	A	C	4	12	16	0	0	16	0	0
11	36283433	.	C	A	3	4	7	0	0	7	0	0
11	36293926	.	G	A	4	5	9	0	1	10	0	0
11	36297796	.	G	A	4	2	6	0	1	7	0	0
11	36297804	.	G	A	3	4	7	0	0	7	0	0
11	36302088	.	T	C	4	4	8	0	0	8	0	0
11	36343167	.	G	C	7	18	25	0	3	28	0	0
11	36346572	.	A	T	12	13	25	0	1	26	0	0
11	36347775	.	C	T	13	11	24	0	0	24	0	0
11	36355387	.	C	T	3	4	7	0	0	7	0	0
11	36372685	.	A	G	3	2	5	0	0	5	0	0
11	36372889	.	G	A	2	6	8	0	0	8	0	0
11	36489428	.	A	T	1	6	7	0	0	7	0	0
11	36689068	.	T	C	3	4	7	0	0	7	0	0
11	36689254	.	C	T	0	2	2	0	6	8	0	0
11	36689328	.	G	C	6	5	11	0	0	11	0	0
11	36689344	.	A	G	6	6	12	0	0	12	0	0
11	36689372	.	T	G	5	5	10	0	0	10	0	0
11	36689426	.	T	C	4	3	7	0	0	7	0	0
11	36691478	.	T	C	2	0	2	0	3	5	0	0
11	36691538	.	T	A	5	4	9	0	1	10	0	0
11	36695076	.	A	G	2	3	5	0	0	5	0	0
11	36708660	.	A	T	1	1	2	0	1	3	0	0
11	36708662	.	G	T	1	1	2	0	1	3	0	0
11	36729478	.	T	A	1	3	4	0	0	4	0	0
11	36756636	.	A	T	4	2	6	0	0	6	0	0
11	36765351	.	G	A	4	4	8	0	2	10	0	0
11	36765485	.	A	C	1	0	1	0	5	6	0	0
11	36788061	.	T	A	1	2	3	0	0	3	0	0
11	36788071	.	G	T	1	1	2	0	0	2	0	0
11	36788527	.	T	A	9	9	18	0	0	18	0	0
11	36793616	.	A	C	10	7	17	0	1	18	0	0
11	36793730	.	T	G	14	10	24	0	0	24	0	0
11	36793760	.	A	C	13	8	21	0	1	22	0	0
11	36795564	.	G	T	11	8	19	0	0	19	0	0
11	36810576	.	A	G	13	10	23	1	0	24	0	0
11	36816163	.	T	C	8	11	19	0	0	19	0	0
11	36816171	.	T	C	4	13	17	0	1	18	0	0
11	36818832	.	G	T	8	5	13	0	0	13	0	0
11	36838854	.	A	C	4	0	4	0	5	9	0	0
11	36847101	.	T	C	6	8	14	0	0	16	2	0
11	36852890	.	G	A	4	3	7	0	0	7	0	0
11	36865554	.	A	G	5	3	8	0	0	8	0	0
11	36865581	.	C	T	5	6	11	0	0	11	0	0
11	36989853	.	T	A	3	7	10	0	1	11	0	0
11	36995476	.	C	T	6	11	17	0	0	17	0	0
11	36995542	.	T	C	6	7	13	0	0	13	0	0
11	37002607	.	C	T	8	11	19	0	1	20	0	0
11	37002616	.	G	A	8	11	19	0	2	21	0	0
11	37004565	.	G	A	2	3	5	0	0	5	0	0
11	37015968	.	T	C	8	8	16	0	1	17	0	0
11	37020807	.	G	T	7	7	14	0	1	15	0	0
11	37023776	.	T	C	7	11	18	0	0	18	0	0
11	37031950	.	C	T	3	13	16	0	0	16	0	0
11	37032250	.	A	G	3	5	8	2	0	10	0	0
11	37032391	.	A	G	1	4	5	0	0	5	0	0
11	37032474	.	A	G	5	3	8	0	0	8	0	0
11	37032784	.	A	G	13	4	17	0	0	17	0	0
11	37032880	.	G	T	4	4	8	0	1	9	0	0
11	37033356	.	G	T	7	3	10	0	1	11	0	0
11	37033431	.	G	A	1	3	4	0	0	4	0	0
11	37033446	.	A	C	1	2	3	0	0	3	0	0
11	37033516	.	G	A	2	4	6	0	0	6	0	0
11	37033552	.	A	G	4	0	4	0	6	10	0	0
11	37033603	.	T	A	2	11	13	1	0	14	0	0
11	37033676	.	C	T	4	11	15	0	0	15	0	0
11	37033767	.	C	T	4	2	6	0	1	7	0	0
11	37033813	.	C	G	4	8	12	0	0	12	0	0
11	37033846	.	G	C	2	9	11	0	0	11	0	0
11	37033855	.	T	A	2	8	10	0	0	10	0	0
11	37033900	.	A	T	1	3	4	0	0	4	0	0
11	37035069	.	A	C	4	5	9	0	2	11	0	0
11	37035176	.	A	T	4	3	7	0	1	8	0	0
11	37049651	.	A	G	2	3	5	0	1	6	0	0
11	37070083	.	T	C	2	5	7	0	0	7	0	0
11	37070284	.	G	T	5	4	9	0	2	11	0	0
11	37074983	.	A	G	4	5	9	0	0	9	0	0
11	37084157	.	T	C	3	7	10	0	1	11	0	0
11	37088913	.	T	C	5	3	8	0	0	8	0	0
11	37088934	.	G	A	3	3	6	0	0	6	0	0
11	37100972	.	C	T	1	2	3	1	0	4	0	0
11	37109243	.	A	G	3	2	5	0	0	5	0	0
11	37144704	.	C	T	7	7	14	0	0	14	0	0
11	37152410	.	T	G	9	0	9	0	9	18	0	0
11	37152812	.	G	C	10	13	23	0	0	23	0	0
11	37153681	.	C	T	6	9	15	0	0	15	0	0
11	37155215	.	A	G	11	0	11	0	11	22	0	0
11	37155247	.	A	T	11	9	20	0	2	23	1	0
11	37155394	.	A	G	13	9	22	0	4	26	0	0
11	37158818	.	T	C	21	19	40	0	3	43	0	0
11	37158932	.	A	T	21	15	36	0	0	36	0	0
11	37158947	.	C	A	20	13	33	0	1	35	1	0
11	37159289	.	T	A	16	14	30	0	2	32	0	0
11	37159517	.	T	A	12	12	24	1	0	25	0	0
11	37159961	.	A	T	10	12	22	0	1	23	0	0
11	37159977	.	A	T	13	9	22	0	1	23	0	0
11	37160052	.	T	A	12	15	27	0	0	27	0	0
11	37162183	.	A	G	18	8	26	0	0	26	0	0
11	37162529	.	G	A	21	12	33	0	0	33	0	0
11	37162563	.	C	A	18	11	29	0	2	31	0	0
11	37162564	.	A	T	17	11	28	0	3	31	0	0
11	37162657	.	C	A	20	15	35	0	1	36	0	0
11	37162666	.	G	T	19	11	30	0	1	31	0	0
11	37163760	.	T	C	12	14	26	0	0	26	0	0
11	37163997	.	T	A	10	14	24	0	0	24	0	0
11	37164456	.	G	A	10	9	19	0	0	19	0	0
11	37167402	.	A	G	12	0	12	0	9	21	0	0
11	37167603	.	A	G	12	10	22	0	0	22	0	0
11	37167669	.	C	T	16	12	28	0	1	29	0	0
11	37167699	.	A	T	16	8	24	0	1	25	0	0
11	37167834	.	T	C	14	12	26	0	0	26	0	0
11	37168039	.	A	T	10	8	18	0	0	18	0	0
11	37170109	.	T	C	8	4	12	0	1	13	0	0
11	37170409	.	A	G	27	0	27	0	17	44	0	0
11	37273059	.	G	A	0	2	2	0	1	3	0	0
11	37297678	.	C	T	17	9	26	1	0	27	0	0
11	37297681	.	A	G	16	8	24	1	1	27	1	0
11	37297811	.	A	T	18	18	36	2	1	39	0	0
11	37298499	.	C	T	18	14	32	0	0	32	0	0
11	37298569	.	A	G	20	18	38	0	1	39	0	0
11	37298755	.	G	A	15	12	27	0	0	27	0	0
11	37298882	.	G	A	22	8	30	0	0	30	0	0
11	37299378	.	A	T	16	11	27	0	1	28	0	0
11	37313177	.	C	T	10	7	17	0	9	26	0	0
11	37313397	.	T	G	0	1	1	0	12	13	0	0
11	37315716	.	G	C	11	15	26	0	2	28	0	0
11	37337444	.	G	A	4	3	7	0	0	7	0	0
11	37337450	.	C	G	2	2	4	0	1	5	0	0
11	37352035	.	A	C	2	7	9	0	1	10	0	0
11	37352044	.	C	T	2	8	10	0	0	10	0	0
11	37373266	.	T	G	2	7	9	0	0	9	0	0
11	37425317	.	C	T	6	4	10	0	0	10	0	0
11	37431710	.	G	T	1	3	4	0	0	4	0	0
11	37431953	.	C	T	30	19	49	0	4	53	0	0
11	37434533	.	A	G	20	16	36	0	1	37	0	0
11	37440957	.	A	C	28	25	53	0	1	54	0	0
11	37440990	.	A	G	26	25	51	0	3	54	0	0
11	37441021	.	G	A	28	30	58	0	1	60	1	0
11	37441053	.	C	G	2	23	25	0	25	50	0	0
11	37441086	.	A	G	25	21	46	0	3	49	0	0
11	37441257	.	T	G	19	32	51	0	3	54	0	0
11	37442134	.	G	A	22	16	38	0	1	39	0	0
11	37442671	.	G	A	22	13	35	0	2	37	0	0
11	37442752	.	C	G	11	21	32	0	1	33	0	0
11	37442772	.	G	T	13	24	37	0	2	39	0	0
11	37445219	.	A	G	18	19	37	0	2	39	0	0
11	37445327	.	G	A	27	16	43	0	1	44	0	0
11	37445502	.	T	C	21	1	22	0	20	42	0	0
11	37445680	.	C	T	17	16	33	0	2	35	0	0
11	37445774	.	G	A	17	10	27	0	1	28	0	0
11	37447402	.	T	G	11	12	23	0	1	24	0	0
11	37447595	.	C	G	0	11	11	0	11	22	0	0
11	37448374	.	G	A	16	15	31	0	0	31	0	0
11	37448396	.	T	C	14	19	33	0	0	33	0	0
11	37448894	.	G	A	6	9	15	0	2	17	0	0
11	37449089	.	C	T	1	5	6	0	10	16	0	0
11	37449415	.	T	A	15	9	24	0	1	25	0	0
11	37449428	.	T	G	11	8	19	0	1	20	0	0
11	37449599	.	C	T	14	6	20	0	0	20	0	0
11	37450073	.	A	T	11	6	17	0	1	18	0	0
11	37450082	.	G	A	12	7	19	0	0	19	0	0
11	37450166	.	C	T	10	4	14	0	0	14	0	0
11	37450847	.	C	T	1	9	10	0	10	20	0	0
11	37451120	.	G	A	15	10	25	0	2	27	0	0
11	37451201	.	C	T	12	11	23	0	2	25	0	0
11	37548462	.	T	G	13	13	26	0	2	28	0	0
11	37548492	.	A	G	11	10	21	0	1	22	0	0
11	37548618	.	A	T	13	9	22	0	4	26	0	0
11	37548646	.	A	G	9	6	15	0	1	16	0	0
11	37613515	.	G	A	29	24	53	0	0	53	0	0
11	37613572	.	C	T	17	27	44	0	2	46	0	0
11	37613633	.	G	A	2	31	33	0	18	51	0	0
11	37613641	.	A	G	29	19	48	0	1	49	0	0
11	37616372	.	T	A	20	24	44	0	3	47	0	0
11	37622121	.	G	T	14	23	37	0	2	39	0	0
11	37628230	.	C	T	39	25	64	0	1	65	0	0
11	37628595	.	T	C	13	20	33	0	0	33	0	0
11	37628816	.	T	C	16	19	35	0	0	35	0	0
11	37628831	.	C	T	17	20	37	0	1	38	0	0
11	37628863	.	T	A	18	21	39	0	1	40	0	0
11	37629046	.	G	A	19	22	41	0	0	41	0	0
11	37708992	.	A	C	5	3	8	0	0	8	0	0
11	37708997	.	T	A	5	3	8	0	0	8	0	0
11	37709033	.	A	G	5	3	8	0	1	9	0	0
11	37709119	.	C	T	5	4	9	1	0	10	0	0
11	37709133	.	G	A	7	4	11	1	0	12	0	0
11	37709222	.	C	T	8	3	11	0	1	12	0	0
11	37709359	.	C	T	8	6	14	0	1	15	0	0
11	37711582	.	T	C	5	4	9	0	0	9	0	0
11	37717543	.	C	T	0	6	6	0	8	14	0	0
11	37717702	.	G	T	2	8	10	0	0	10	0	0
11	37720622	.	C	A	14	14	28	0	5	33	0	0
11	37720658	.	G	A	13	24	37	0	3	40	0	0
11	37720671	.	A	G	11	23	34	0	0	34	0	0
11	37722445	.	G	A	15	26	41	0	0	41	0	0
11	37813620	.	C	T	3	3	6	0	0	6	0	0
11	37813808	.	T	C	1	3	4	0	0	4	0	0
11	37829740	.	C	T	4	3	7	0	0	7	0	0
11	37829859	.	A	C	7	3	10	0	0	10	0	0
11	37831034	.	T	C	4	3	7	0	0	7	0	0
11	37831346	.	G	A	0	3	3	0	0	3	0	0
11	37848832	.	A	T	4	7	11	0	0	11	0	0
11	37849053	.	T	A	7	7	14	0	1	15	0	0
11	37854047	.	T	G	6	3	9	0	0	9	0	0
11	37868358	.	C	T	5	7	12	0	0	12	0	0
11	38033189	.	A	G	4	3	7	0	0	7	0	0
11	38033370	.	A	T	3	5	8	0	0	8	0	0
11	38033520	.	A	G	4	3	7	0	1	8	0	0
11	38048821	.	G	A	6	5	11	0	1	12	0	0
11	38048836	.	G	A	4	5	9	0	1	10	0	0
11	38048875	.	C	A	7	5	12	0	0	12	0	0
11	38055477	.	G	A	5	2	7	0	0	7	0	0
11	38055627	.	C	T	1	11	12	0	5	17	0	0
11	38083026	.	T	C	6	3	9	0	1	10	0	0
11	38332405	.	T	A	17	10	27	0	0	28	1	0
11	38375925	.	C	G	14	0	14	0	12	26	0	0
11	38393213	.	G	A	0	11	11	0	8	19	0	0
11	38413037	.	G	A	16	11	27	0	0	27	0	0
11	38477102	.	C	T	2	4	6	0	3	9	0	0
11	38477156	.	A	C	2	3	5	0	0	5	0	0
11	38477219	.	G	A	2	2	4	0	0	4	0	0
11	38477252	.	C	T	0	2	2	0	2	4	0	0
11	38480362	.	G	A	1	4	5	0	0	5	0	0
11	38480665	.	A	G	2	2	4	0	1	5	0	0
11	38505453	.	T	C	3	5	8	0	1	9	0	0
11	38505781	.	A	G	5	7	12	0	1	13	0	0
11	38506401	.	A	T	5	3	8	0	1	9	0	0
11	38506404	.	A	T	3	6	9	0	0	9	0	0
11	38506571	.	A	C	2	2	4	0	0	4	0	0
11	38506627	.	A	T	2	3	5	0	0	5	0	0
11	38506790	.	A	T	1	4	5	0	0	5	0	0
11	38506794	.	T	C	2	2	4	0	1	5	0	0
11	38507217	.	A	C	2	3	5	0	0	5	0	0
11	38507918	.	A	G	1	5	6	0	0	6	0	0
11	38508416	.	T	C	1	4	5	0	1	6	0	0
11	38508728	.	C	T	6	2	8	0	0	8	0	0
11	38509205	.	G	A	6	9	15	0	0	15	0	0
11	38509219	.	T	C	6	9	15	0	0	15	0	0
11	38509736	.	C	T	2	3	5	0	0	5	0	0
11	38509901	.	A	C	6	3	9	0	1	10	0	0
11	38509922	.	G	A	4	5	9	0	0	9	0	0
11	38540288	.	C	A	8	4	12	0	1	13	0	0
11	38540870	.	G	A	20	21	41	0	0	41	0	0
11	38541063	.	T	A	15	28	43	0	0	43	0	0
11	38541100	.	A	C	15	23	38	0	0	38	0	0
11	38541371	.	T	C	21	0	21	0	27	48	0	0
11	38541401	.	C	G	18	22	40	0	2	42	0	0
11	38541484	.	A	G	24	15	39	5	1	45	0	0
11	38541708	.	A	C	12	18	30	0	2	32	0	0
11	38542003	.	G	A	20	25	45	0	3	48	0	0
11	38542088	.	A	T	21	18	39	0	0	39	0	0
11	38542171	.	G	T	28	12	40	0	0	40	0	0
11	38542218	.	G	A	18	21	39	0	0	39	0	0
11	38542305	.	C	T	29	19	48	0	0	48	0	0
11	38542308	.	G	A	29	17	46	0	0	46	0	0
11	38542655	.	T	C	20	3	23	0	27	50	0	0
11	38545826	.	G	T	23	25	48	0	4	54	2	0
11	38545874	.	C	G	2	34	36	0	23	59	0	0
11	38807879	.	G	A	2	10	12	0	11	23	0	0
11	38808113	.	C	T	9	8	17	0	1	18	0	0
11	38846046	.	C	T	14	9	23	0	1	24	0	0
11	38846301	.	T	G	14	0	14	0	15	29	0	0
11	38846316	.	T	A	16	13	29	0	0	29	0	0
11	38850244	.	G	A	0	9	9	0	17	26	0	0
11	38853397	.	A	T	10	10	20	0	0	20	0	0
11	38853511	.	A	G	12	15	27	0	0	27	0	0
11	38868012	.	G	T	17	12	29	0	1	30	0	0
11	38874937	.	G	A	21	16	37	0	3	40	0	0
11	38875221	.	A	G	15	14	29	0	1	30	0	0
11	38875283	.	A	T	14	13	27	0	1	28	0	0
11	38875352	.	G	A	16	20	36	0	0	36	0	0
11	38875397	.	T	G	18	15	33	0	0	33	0	0
11	38875484	.	A	C	9	15	24	0	0	24	0	0
11	38875498	.	C	A	19	9	28	0	0	28	0	0
11	38875660	.	T	C	14	15	29	0	0	29	0	0
11	38875897	.	T	C	2	3	5	0	0	5	0	0
11	38875912	.	A	G	1	2	3	0	0	3	0	0
11	39013892	.	T	A	4	2	6	0	0	6	0	0
11	39014428	.	T	C	2	0	2	0	4	6	0	0
11	39014431	.	G	T	2	4	6	0	0	6	0	0
11	39014553	.	G	A	23	15	38	0	0	38	0	0
11	39044451	.	T	A	10	9	19	0	1	20	0	0
11	39076138	.	C	T	0	3	3	0	4	7	0	0
11	39107156	.	C	T	12	10	22	0	0	22	0	0
11	39109555	.	C	T	3	12	15	0	0	15	0	0
11	39110046	.	C	T	9	12	21	0	0	21	0	0
11	39112035	.	A	G	10	6	16	0	0	16	0	0
11	39112068	.	C	T	9	4	13	0	0	13	0	0
11	39114346	.	G	A	2	2	4	0	0	4	0	0
11	39115165	.	G	T	1	3	4	0	0	4	0	0
11	39118639	.	G	A	1	3	4	0	0	4	0	0
11	39135393	.	C	T	28	23	51	0	3	54	0	0
11	39141527	.	A	G	23	23	46	0	6	52	0	0
11	39141732	.	T	G	8	12	20	0	3	23	0	0
11	39141924	.	G	T	13	8	21	0	1	22	0	0
11	39147065	.	T	C	14	24	38	0	3	41	0	0
11	39147085	.	C	T	14	19	33	0	0	33	0	0
11	39147387	.	T	C	15	18	33	0	1	35	1	0
11	39147445	.	G	C	19	18	37	0	1	38	0	0
11	39147857	.	G	C	7	12	19	0	5	24	0	0
11	39147905	.	C	A	17	12	29	0	1	30	0	0
11	39147906	.	A	T	17	12	29	0	1	30	0	0
11	39147989	.	T	C	27	14	41	2	6	49	0	0
11	39148015	.	C	T	15	18	33	1	4	38	0	0
11	39168255	.	C	G	1	3	4	0	0	4	0	0
11	39877711	.	C	T	7	16	23	0	0	23	0	0
11	39878200	.	A	G	10	0	10	0	12	22	0	0
11	39878442	.	A	C	17	12	29	0	4	33	0	0
11	39878503	.	C	A	9	11	20	0	1	21	0	0
11	39878515	.	G	T	1	10	11	0	12	23	0	0
11	39878558	.	A	C	15	11	26	0	2	28	0	0
11	39878740	.	G	A	21	17	38	0	1	39	0	0
11	39878788	.	T	A	14	14	28	0	0	28	0	0
11	39878882	.	A	T	11	8	19	0	0	19	0	0
11	39878980	.	C	T	11	15	26	0	0	26	0	0
11	39879009	.	C	G	10	9	19	0	0	19	0	0
11	39879242	.	C	A	18	11	29	0	2	31	0	0
11	39879316	.	A	G	16	7	23	0	3	26	0	0
11	39888410	.	T	A	17	7	24	0	3	27	0	0
11	39905164	.	C	T	22	14	36	0	1	37	0	0
11	39906110	.	C	T	14	14	28	0	1	29	0	0
11	39907021	.	C	G	24	16	40	0	3	43	0	0
11	39907585	.	G	A	12	23	35	0	1	36	0	0
11	39907618	.	C	G	18	16	34	0	0	34	0	0
11	39908020	.	T	G	28	11	39	0	1	40	0	0
11	39916450	.	G	A	24	12	36	0	1	37	0	0
11	39922402	.	G	A	3	19	22	0	28	50	0	0
11	39922407	.	G	A	29	17	46	0	1	47	0	0
11	39922714	.	A	C	20	11	31	0	2	33	0	0
11	39923551	.	T	A	23	18	41	0	0	41	0	0
11	39923653	.	C	T	17	18	35	0	2	37	0	0
11	39924083	.	A	T	23	18	41	0	1	42	0	0
11	39924235	.	G	C	16	8	24	2	1	27	0	0
11	39924243	.	G	T	16	8	24	2	0	26	0	0
11	39924341	.	C	G	13	19	32	0	2	35	1	0
11	39924358	.	T	C	12	19	31	0	2	33	0	0
11	39924413	.	G	A	22	21	43	0	1	44	0	0
11	39924639	.	C	T	30	17	47	0	1	48	0	0
11	39924652	.	C	T	14	31	45	0	3	48	0	0
11	39924711	.	A	T	18	24	42	0	1	43	0	0
11	39924736	.	A	G	23	20	43	0	0	43	0	0
11	39924783	.	T	A	19	17	36	0	2	38	0	0
11	39924784	.	A	T	22	16	38	0	1	39	0	0
11	39924929	.	G	A	18	15	33	0	3	36	0	0
11	39924946	.	C	T	20	16	36	0	2	38	0	0
11	39924989	.	G	T	19	19	38	0	0	38	0	0
11	39924999	.	C	T	15	21	36	0	3	39	0	0
11	39925225	.	C	A	18	23	41	0	3	44	0	0
11	39925458	.	G	A	24	16	40	0	1	41	0	0
11	39925529	.	C	T	21	19	40	0	0	40	0	0
11	39926041	.	C	T	22	19	41	0	0	41	0	0
11	39926216	.	A	G	18	8	26	0	3	29	0	0
11	39941661	.	A	G	15	0	15	0	16	31	0	0
11	39949703	.	C	T	11	10	21	0	1	22	0	0
11	39954026	.	T	G	12	6	18	0	0	18	0	0
11	39954319	.	G	A	1	5	6	0	11	17	0	0
11	39969082	.	A	T	6	13	19	0	0	19	0	0
11	39969102	.	C	T	7	10	17	0	0	17	0	0
11	39969123	.	T	A	5	10	15	0	0	15	0	0
11	39969260	.	A	C	4	5	9	0	0	9	0	0
11	39976568	.	G	T	5	8	13	0	0	13	0	0
11	39985311	.	A	G	3	9	12	0	1	13	0	0
11	39986402	.	T	C	7	5	12	0	0	12	0	0
11	39992283	.	T	C	2	5	7	0	0	7	0	0
11	39998695	.	T	G	14	5	19	0	0	19	0	0
11	39998697	.	T	G	14	1	15	0	4	19	0	0
11	40002096	.	A	T	3	7	10	0	0	10	0	0
11	40002228	.	T	G	8	11	19	0	0	19	0	0
11	40004643	.	G	A	5	3	8	0	3	11	0	0
11	40004887	.	C	A	7	7	14	0	0	14	0	0
11	40009040	.	T	C	8	3	11	0	0	11	0	0
11	40009094	.	A	G	11	7	18	0	0	18	0	0
11	40014079	.	A	G	16	10	26	0	0	26	0	0
11	40014346	.	G	A	8	5	13	0	0	13	0	0
11	40014961	.	G	A	9	5	14	0	0	14	0	0
11	40015113	.	G	A	9	5	14	0	0	14	0	0
11	40015380	.	C	G	7	6	13	0	0	13	0	0
11	40015529	.	T	C	8	4	12	0	0	12	0	0
11	40015537	.	G	A	7	5	12	0	1	13	0	0
11	40015696	.	C	T	4	7	11	0	0	11	0	0
11	40015797	.	A	G	2	3	5	0	1	6	0	0
11	40015849	.	A	C	4	5	9	0	0	9	0	0
11	40016032	.	A	G	7	8	15	3	1	19	0	0
11	40016477	.	T	C	4	5	9	0	0	9	0	0
11	40016524	.	G	A	0	3	3	1	9	13	0	0
11	40016528	.	T	C	9	3	12	1	0	13	0	0
11	40016649	.	A	C	7	5	12	0	0	12	0	0
11	40017183	.	G	T	14	5	19	0	0	19	0	0
11	40017290	.	G	C	5	2	7	1	2	10	0	0
11	40017333	.	A	T	7	7	14	0	0	14	0	0
11	40017501	.	A	T	8	5	13	0	1	14	0	0
11	40017504	.	T	A	9	5	14	0	1	15	0	0
11	40017604	.	T	C	8	8	16	0	0	16	0	0
11	40017698	.	T	C	3	6	9	0	1	10	0	0
11	40017829	.	A	G	5	3	8	0	0	8	0	0
11	40017865	.	T	A	5	4	9	0	0	9	0	0
11	40017885	.	G	A	5	5	10	0	0	10	0	0
11	40017949	.	A	T	7	4	11	0	1	12	0	0
11	40017994	.	T	C	11	6	17	0	1	18	0	0
11	40018042	.	T	C	16	13	29	0	0	29	0	0
11	40018633	.	G	A	8	6	14	0	1	15	0	0
11	40018668	.	A	T	9	6	15	0	0	15	0	0
11	40018799	.	G	T	0	8	8	0	4	12	0	0
11	40019040	.	C	T	5	2	7	1	0	8	0	0
11	40019076	.	G	A	4	5	9	0	0	9	0	0
11	40019078	.	A	G	3	0	3	0	6	9	0	0
11	40019232	.	C	T	3	3	6	1	0	7	0	0
11	40019276	.	A	C	6	7	13	0	0	13	0	0
11	40019278	.	T	A	7	7	14	0	0	14	0	0
11	40019411	.	C	T	12	3	15	2	1	18	0	0
11	40020303	.	A	G	13	5	18	0	0	18	0	0
11	40020304	.	G	C	13	5	18	0	0	18	0	0
11	40020354	.	T	C	9	4	13	0	0	13	0	0
11	40020683	.	G	T	11	5	16	0	1	17	0	0
11	40020928	.	G	A	11	8	19	0	0	19	0	0
11	40020950	.	A	G	8	5	13	1	0	14	0	0
11	40048508	.	T	C	2	2	4	0	0	4	0	0
11	40644440	.	G	T	2	4	6	0	0	6	0	0
11	40647099	.	T	C	3	0	3	0	2	5	0	0
11	40647123	.	A	C	2	4	6	0	1	7	0	0
11	40655819	.	T	C	10	19	29	0	1	30	0	0
11	40658079	.	A	C	18	15	33	0	2	35	0	0
11	40658091	.	A	T	13	11	24	0	4	28	0	0
11	40658154	.	C	G	20	0	20	0	12	32	0	0
11	40658232	.	C	T	8	12	20	0	0	20	0	0
11	40658352	.	G	A	0	5	5	0	15	20	0	0
11	40658455	.	T	C	10	9	19	0	2	21	0	0
11	40661378	.	T	C	12	16	28	0	1	29	0	0
11	40665545	.	T	C	17	10	27	0	2	29	0	0
11	40665602	.	G	T	0	10	10	0	18	28	0	0
11	40673797	.	C	T	13	10	23	0	0	23	0	0
11	40673877	.	A	G	14	7	21	0	1	22	0	0
11	40677891	.	A	T	25	20	45	0	3	48	0	0
11	40677967	.	T	C	46	16	62	0	3	65	0	0
11	40678385	.	T	G	32	31	63	0	1	64	0	0
11	40678445	.	A	C	29	0	29	1	30	60	0	0
11	40680890	.	A	G	27	35	62	0	5	67	0	0
11	40831754	.	A	G	12	0	12	0	8	20	0	0
11	40840238	.	T	C	11	9	20	0	0	20	0	0
11	40840407	.	T	C	9	7	16	0	3	19	0	0
11	40843208	.	T	C	10	11	21	0	1	23	1	0
11	40843814	.	T	C	6	10	16	0	0	16	0	0
11	40844085	.	T	G	6	4	10	0	0	10	0	0
11	40844094	.	C	T	7	3	10	0	0	10	0	0
11	40844162	.	T	C	13	5	18	1	0	19	0	0
11	40844195	.	A	T	7	7	14	1	4	19	0	0
11	40845117	.	T	C	4	5	9	0	2	11	0	0
11	40845515	.	T	C	4	3	7	0	0	7	0	0
11	41066765	.	T	G	12	10	22	0	0	22	0	0
11	41066871	.	C	T	14	11	25	0	0	25	0	0
11	41066888	.	C	T	13	16	29	0	0	29	0	0
11	41066950	.	A	G	9	13	22	0	2	24	0	0
11	41067275	.	G	A	6	8	14	0	0	14	0	0
11	41067430	.	A	T	1	12	13	0	0	13	0	0
11	41067442	.	C	T	1	13	14	0	0	14	0	0
11	41078522	.	C	A	5	4	9	0	0	9	0	0
11	41078578	.	A	T	4	6	10	0	0	10	0	0
11	41078762	.	A	T	18	18	36	0	2	38	0	0
11	41084325	.	T	G	27	12	39	0	2	41	0	0
11	41089631	.	G	T	11	5	16	0	0	16	0	0
11	41089641	.	T	C	10	5	15	0	0	15	0	0
11	41090478	.	A	C	3	5	8	0	0	8	0	0
11	41090479	.	A	C	3	5	8	0	0	8	0	0
11	41101666	.	A	G	16	9	25	0	2	27	0	0
11	41101760	.	A	T	6	5	11	0	0	11	0	0
11	41101800	.	T	A	3	6	9	0	0	9	0	0
11	41101866	.	C	T	5	11	16	0	0	16	0	0
11	41102013	.	A	G	7	1	8	0	6	14	0	0
11	41102026	.	T	C	8	6	14	0	0	14	0	0
11	41102205	.	A	G	5	9	14	0	0	14	0	0
11	41104549	.	A	G	6	6	12	0	1	13	0	0
11	41104934	.	G	A	7	6	13	0	0	13	0	0
11	41104954	.	C	T	8	7	15	0	0	15	0	0
11	41105030	.	G	A	2	5	7	0	5	12	0	0
11	41111301	.	A	G	11	6	17	0	2	19	0	0
11	41111334	.	T	C	9	9	18	0	0	18	0	0
11	41111370	.	C	T	8	9	17	0	1	18	0	0
11	41111422	.	A	G	4	8	12	0	1	13	0	0
11	41111431	.	A	C	3	7	10	0	0	10	0	0
11	41111603	.	T	A	2	3	5	0	0	5	0	0
11	41111735	.	G	A	3	3	6	0	0	6	0	0
11	41113389	.	T	C	6	3	9	0	0	9	0	0
11	41114055	.	C	T	1	3	4	0	3	7	0	0
11	41114090	.	G	T	5	6	11	0	1	12	0	0
11	41114186	.	A	C	3	7	10	0	0	10	0	0
11	41122665	.	T	C	12	0	12	0	8	20	0	0
11	41132195	.	A	G	18	9	27	0	1	28	0	0
11	41216315	.	C	T	0	2	2	0	1	3	0	0
11	41216455	.	T	C	2	0	2	0	5	7	0	0
11	41216505	.	G	C	3	15	18	0	0	18	0	0
11	41220596	.	G	A	10	18	28	0	0	28	0	0
11	41220613	.	C	T	1	15	16	0	9	25	0	0
11	41220683	.	T	A	7	17	24	0	0	24	0	0
11	41222940	.	A	G	18	10	28	0	0	28	0	0
11	41244604	.	T	G	4	5	9	0	0	9	0	0
11	41244709	.	G	A	1	5	6	0	6	12	0	0
11	41284921	.	C	T	10	7	17	0	0	17	0	0
11	41306035	.	G	A	0	5	5	0	7	12	0	0
11	41307691	.	T	C	16	11	27	0	0	27	0	0
11	41307733	.	A	G	14	9	23	0	4	27	0	0
11	41307844	.	T	C	9	10	19	0	2	21	0	0
11	41363778	.	G	A	0	8	8	0	10	18	0	0
11	41372906	.	G	T	0	5	5	0	3	8	0	0
11	41375027	.	C	G	6	2	8	0	0	8	0	0
11	41459981	.	G	C	1	31	32	0	19	51	0	0
11	41461417	.	C	G	20	25	45	0	2	47	0	0
11	41463534	.	C	G	12	34	46	3	1	50	0	0
11	41468791	.	C	T	13	29	42	2	0	44	0	0
11	41473980	.	G	T	13	9	22	0	0	22	0	0
11	41474041	.	T	A	7	3	10	0	0	11	1	0
11	41474042	.	G	T	7	3	10	0	1	11	0	0
11	41474507	.	A	T	2	2	4	0	0	4	0	0
11	41660756	.	G	A	1	12	13	0	4	17	0	0
11	41669291	.	C	T	5	7	12	0	0	12	0	0
11	41672337	.	T	C	6	10	16	0	1	17	0	0
11	41699744	.	A	C	7	15	22	0	1	23	0	0
11	41699856	.	C	G	6	5	11	0	1	12	0	0
11	41838930	.	T	A	6	3	9	0	0	9	0	0
11	41838933	.	C	A	7	3	10	0	0	10	0	0
11	41838991	.	T	G	7	0	7	0	5	12	0	0
11	41838999	.	G	T	6	6	12	0	0	12	0	0
11	41840493	.	T	C	7	6	13	0	0	13	0	0
11	41844192	.	C	A	10	9	19	1	0	20	0	0
11	41844342	.	T	C	13	8	21	1	2	24	0	0
11	41844396	.	A	G	7	0	7	0	5	12	0	0
11	41845916	.	C	T	5	2	7	0	0	7	0	0
11	41849977	.	C	T	2	7	9	0	11	20	0	0
11	41850058	.	A	G	8	3	11	0	0	11	0	0
11	41850559	.	G	A	5	4	9	0	0	9	0	0
11	41850565	.	G	A	5	3	8	0	0	8	0	0
11	41853840	.	T	A	1	3	4	0	0	4	0	0
11	41859255	.	T	G	1	2	3	0	0	3	0	0
11	41859761	.	C	T	1	3	4	0	0	4	0	0
11	41938546	.	A	G	6	13	19	0	0	19	0	0
11	41938594	.	G	A	4	10	14	0	0	14	0	0
11	41940293	.	G	A	6	2	8	0	0	8	0	0
11	41942440	.	T	C	2	7	9	0	0	9	0	0
11	41946225	.	A	G	5	4	9	0	2	11	0	0
11	41948344	.	C	T	5	4	9	0	1	10	0	0
11	41952555	.	C	T	4	6	10	0	0	10	0	0
11	41958013	.	C	T	4	14	18	0	0	18	0	0
11	41958058	.	C	T	3	10	13	0	1	14	0	0
11	41958278	.	A	T	9	10	19	0	0	19	0	0
11	41958317	.	T	C	11	8	19	0	0	19	0	0
11	41960058	.	A	C	11	12	23	0	1	25	1	0
11	41960059	.	C	T	12	13	25	0	0	25	0	0
11	41960101	.	A	G	12	18	30	0	0	30	0	0
11	41960111	.	C	T	13	17	30	0	0	30	0	0
11	41982546	.	G	A	0	4	4	0	5	9	0	0
11	42128615	.	A	C	1	6	7	0	0	7	0	0
11	42131413	.	T	C	1	0	1	0	5	6	0	0
11	42134733	.	C	G	7	5	12	0	0	12	0	0
11	42161766	.	C	T	0	3	3	0	2	5	0	0
11	42161775	.	G	A	2	2	4	0	0	4	0	0
11	42181764	.	T	A	1	5	6	0	0	6	0	0
11	42181779	.	A	G	1	6	7	0	0	7	0	0
11	42218661	.	T	G	1	2	3	0	0	3	0	0
11	42218688	.	A	C	1	3	4	0	1	5	0	0
11	42305868	.	C	A	0	7	7	0	8	16	1	0
11	42306017	.	G	A	7	8	15	0	2	17	0	0
11	42306049	.	T	C	4	0	4	1	9	14	0	0
11	42306627	.	C	T	1	8	9	0	5	14	0	0
11	42306928	.	A	T	15	13	28	1	1	30	0	0
11	42307147	.	T	A	16	14	30	0	1	31	0	0
11	42307400	.	A	T	12	11	23	0	1	24	0	0
11	42307671	.	G	A	10	14	24	0	0	24	0	0
11	42315414	.	A	C	13	1	14	0	7	21	0	0
11	42319340	.	C	T	14	11	25	0	1	26	0	0
11	42319372	.	C	A	10	7	17	0	0	17	0	0
11	42325535	.	C	T	11	11	22	0	0	22	0	0
11	42327184	.	G	T	8	14	22	0	2	25	1	0
11	42341009	.	G	A	17	11	28	0	1	29	0	0
11	42350581	.	G	A	14	13	27	0	0	27	0	0
11	42350847	.	C	T	8	16	24	0	0	24	0	0
11	42355806	.	C	T	11	12	23	0	0	23	0	0
11	42363236	.	G	A	10	9	19	0	0	19	0	0
11	42417409	.	T	C	6	6	12	0	0	12	0	0
11	42417479	.	T	G	7	8	15	0	0	16	1	0
11	42417628	.	A	C	3	14	17	1	0	18	0	0
11	42417691	.	G	A	8	9	17	0	1	18	0	0
11	42417956	.	C	T	0	8	8	0	7	15	0	0
11	42418042	.	G	A	8	4	12	0	0	12	0	0
11	42418246	.	C	T	11	5	16	0	1	17	0	0
11	42418268	.	A	G	12	9	21	0	1	22	0	0
11	42418310	.	A	T	8	9	17	0	0	17	0	0
11	42436709	.	C	T	2	3	5	0	0	5	0	0
11	42456169	.	G	A	2	5	7	0	0	7	0	0
11	42457249	.	G	A	0	6	6	0	4	10	0	0
11	42457328	.	A	C	5	4	9	0	2	11	0	0
11	42458272	.	A	G	2	0	2	0	3	5	0	0
11	42458330	.	A	G	2	3	5	0	0	5	0	0
11	42458446	.	A	G	6	2	8	0	0	8	0	0
11	42458475	.	A	T	5	3	8	0	0	8	0	0
11	42458482	.	A	G	5	3	8	0	0	8	0	0
11	42458544	.	T	A	2	4	6	0	0	6	0	0
11	42459543	.	G	A	1	2	3	0	0	3	0	0
11	42500584	.	C	G	2	2	4	1	0	5	0	0
11	42500592	.	T	C	2	2	4	0	0	4	0	0
11	42500643	.	A	T	2	3	5	0	0	5	0	0
11	42500905	.	G	A	1	4	5	0	0	5	0	0
11	42501390	.	A	G	2	0	2	0	5	7	0	0
11	42501982	.	T	G	4	3	7	0	1	8	0	0
11	42502164	.	C	T	1	2	3	0	0	3	0	0
11	42502203	.	T	C	1	2	3	0	0	3	0	0
11	42502261	.	T	C	2	2	4	0	0	4	0	0
11	42502349	.	A	G	3	0	3	0	3	6	0	0
11	42502394	.	T	A	0	2	2	0	1	3	0	0
11	42502395	.	G	A	1	2	3	0	0	3	0	0
11	42506576	.	T	A	6	7	13	0	0	13	0	0
11	42522147	.	C	G	1	3	4	0	8	12	0	0
11	42522162	.	A	T	7	7	14	0	0	14	0	0
11	42522270	.	G	A	3	3	6	0	0	6	0	0
11	42525232	.	T	A	4	4	8	0	1	9	0	0
11	42525289	.	C	A	1	4	5	0	1	6	0	0
11	42525300	.	C	T	3	2	5	0	0	5	0	0
11	42532465	.	C	T	0	3	3	1	3	7	0	0
11	42532485	.	C	T	0	4	4	5	1	10	0	0
11	42532660	.	T	G	8	13	21	0	1	22	0	0
11	42532763	.	T	G	1	2	3	4	0	7	0	0
11	42532886	.	T	A	4	7	11	0	0	11	0	0
11	42532943	.	C	T	9	5	14	0	1	15	0	0
11	42533125	.	C	T	4	13	17	0	0	17	0	0
11	42533318	.	G	A	15	8	23	0	1	24	0	0
11	42533321	.	T	G	15	8	23	0	0	23	0	0
11	42539476	.	G	A	17	7	24	0	1	25	0	0
11	42557693	.	A	G	38	24	62	0	2	64	0	0
11	42560439	.	G	A	22	35	57	0	2	59	0	0
11	42560475	.	C	T	24	36	60	0	5	65	0	0
11	42600818	.	G	T	0	4	4	0	6	10	0	0
11	42600867	.	A	T	8	5	13	0	0	13	0	0
11	42603999	.	A	G	5	2	7	0	0	7	0	0
11	42604033	.	C	T	5	2	7	0	0	7	0	0
11	42605462	.	T	C	2	7	9	0	1	10	0	0
11	42608627	.	A	G	4	7	11	0	2	13	0	0
11	42615091	.	A	T	9	8	17	0	0	17	0	0
11	42618675	.	A	G	11	1	12	0	8	20	0	0
11	42618720	.	A	G	12	5	17	0	1	18	0	0
11	42711047	.	A	G	2	0	2	0	2	4	0	0
11	42712033	.	C	T	3	2	5	0	0	5	0	0
11	42719046	.	G	A	2	2	4	0	0	4	0	0
11	42720791	.	G	A	3	2	5	0	0	5	0	0
11	42730657	.	A	G	20	16	36	0	1	37	0	0
11	42730931	.	C	T	19	16	35	0	1	36	0	0
11	42731172	.	G	C	16	9	25	0	2	27	0	0
11	42731173	.	G	T	17	9	26	0	1	27	0	0
11	42766088	.	T	C	3	5	8	0	1	9	0	0
11	42771442	.	G	A	5	3	8	0	2	10	0	0
11	42783955	.	G	C	3	4	7	0	0	7	0	0
11	42783985	.	G	A	1	3	4	0	0	4	0	0
11	42793640	.	T	A	9	6	15	0	0	15	0	0
11	42801451	.	A	T	2	12	14	0	2	17	1	0
11	42801508	.	T	A	5	9	14	0	1	15	0	0
11	42801547	.	C	T	7	9	16	0	0	16	0	0
11	42808988	.	C	T	9	7	16	0	1	17	0	0
11	42809233	.	A	G	9	5	14	0	1	15	0	0
11	42809345	.	T	C	7	8	15	0	1	16	0	0
11	42809558	.	A	G	7	7	14	0	0	14	0	0
11	42809717	.	G	A	0	5	5	0	7	12	0	0
11	42811938	.	G	A	1	4	5	0	6	11	0	0
11	42815207	.	C	A	6	4	10	0	0	10	0	0
11	42815261	.	G	A	2	4	6	0	1	7	0	0
11	42815684	.	A	G	1	3	4	0	0	4	0	0
11	42815695	.	T	A	1	3	4	0	0	4	0	0
11	42815753	.	G	A	1	3	4	0	0	4	0	0
11	42816152	.	G	A	0	4	4	0	8	12	0	0
11	42816189	.	G	A	9	6	15	0	1	16	0	0
11	42816208	.	A	T	9	9	18	0	0	18	0	0
11	42816811	.	A	C	4	4	8	0	1	9	0	0
11	42816841	.	G	T	2	3	5	0	0	5	0	0
11	42816886	.	C	T	2	2	4	0	0	4	0	0
11	42816897	.	T	C	2	3	5	0	0	5	0	0
11	42817067	.	A	G	3	5	8	0	0	8	0	0
11	42817075	.	T	G	3	0	3	0	5	8	0	0
11	42817459	.	A	T	13	5	18	0	0	18	0	0
11	42817476	.	G	C	1	2	3	0	13	16	0	0
11	42817598	.	A	G	3	0	3	0	5	8	0	0
11	42912098	.	T	C	1	4	5	0	1	6	0	0
11	42912126	.	A	G	1	4	5	0	0	5	0	0
11	42912784	.	A	G	6	5	11	0	0	11	0	0
11	42912791	.	G	A	6	4	10	0	0	10	0	0
11	42912837	.	T	A	5	4	9	0	0	9	0	0
11	42913020	.	A	G	1	2	3	0	0	3	0	0
11	42913021	.	C	T	0	2	2	0	1	3	0	0
11	42915022	.	T	A	3	4	7	0	0	7	0	0
11	42915665	.	G	A	3	3	6	0	0	6	0	0
11	42916373	.	G	A	1	2	3	0	0	3	0	0
11	42916516	.	G	C	2	2	4	0	0	4	0	0
11	42916577	.	A	T	2	3	5	0	0	5	0	0
11	42916595	.	G	A	1	3	4	0	0	4	0	0
11	42933019	.	A	G	3	2	5	0	0	5	0	0
11	42933432	.	C	T	1	4	5	0	0	5	0	0
11	42933696	.	A	G	5	8	13	0	2	15	0	0
11	42933703	.	T	C	6	8	14	0	1	15	0	0
11	42933780	.	G	A	8	11	19	0	0	19	0	0
11	42939803	.	T	C	12	4	16	0	0	16	0	0
11	42940748	.	C	T	7	2	9	0	0	9	0	0
11	42942921	.	C	T	1	7	8	0	3	11	0	0
11	42942930	.	G	A	3	6	9	0	1	10	0	0
11	43386430	.	T	C	1	8	9	0	0	9	0	0
11	43470332	.	T	C	10	4	14	0	1	15	0	0
11	44328905	.	A	G	10	15	25	0	1	26	0	0
11	44328956	.	T	C	12	16	28	0	2	30	0	0
11	44329050	.	A	G	14	17	31	0	0	31	0	0
11	44329172	.	C	T	15	14	29	0	2	31	0	0
11	44334935	.	T	A	17	19	36	0	1	37	0	0
11	44335201	.	A	T	3	3	6	0	1	7	0	0
11	44340272	.	T	A	1	3	4	0	0	4	0	0
11	44358817	.	G	T	1	5	6	0	13	19	0	0
11	44361689	.	C	G	7	4	11	0	0	11	0	0
11	44361701	.	C	T	8	6	14	0	0	14	0	0
11	44400918	.	G	A	5	5	10	0	0	10	0	0
11	44400960	.	G	T	8	5	13	0	0	13	0	0
11	44401057	.	C	A	8	12	20	0	0	20	0	0
11	44401275	.	G	A	10	15	25	0	1	26	0	0
11	44401437	.	G	A	6	6	12	0	2	14	0	0
11	44403378	.	C	G	5	6	11	0	1	12	0	0
11	44468838	.	G	A	11	8	19	0	0	19	0	0
11	44468842	.	T	C	11	6	17	0	1	18	0	0
11	44522995	.	A	G	4	4	8	0	0	8	0	0
11	44606844	.	G	T	4	5	9	0	1	10	0	0
11	44607019	.	T	A	12	6	18	0	1	19	0	0
11	44607052	.	G	A	15	9	24	0	1	25	0	0
11	44612357	.	A	G	11	7	18	0	1	19	0	0
11	44619132	.	A	T	10	6	16	0	0	16	0	0
11	44622594	.	C	T	4	6	10	0	0	10	0	0
11	44624723	.	A	C	4	4	8	0	0	8	0	0
11	44633294	.	T	C	10	5	15	1	0	16	0	0
11	44635020	.	G	A	1	2	3	0	0	3	0	0
11	44637569	.	T	A	3	4	7	0	1	8	0	0
11	44637950	.	A	G	26	27	53	1	4	58	0	0
11	44643882	.	C	T	26	20	46	0	2	48	0	0
11	44647227	.	A	C	27	0	27	0	24	51	0	0
11	44647269	.	T	G	15	16	31	0	0	31	0	0
11	44723130	.	C	G	17	10	27	0	0	27	0	0
11	44723353	.	G	A	2	24	26	0	22	48	0	0
11	44723374	.	T	C	24	22	46	0	0	46	0	0
11	44723416	.	T	G	20	0	20	0	21	41	0	0
11	44723653	.	T	G	19	18	37	0	2	39	0	0
11	44723746	.	A	G	20	28	48	0	3	51	0	0
11	44725596	.	C	T	22	22	44	0	0	44	0	0
11	44725926	.	G	A	3	18	21	0	28	49	0	0
11	44838743	.	G	A	2	13	15	0	10	25	0	0
11	44843706	.	A	G	6	0	6	0	10	16	0	0
11	44852248	.	A	G	14	0	14	0	8	22	0	0
11	44852285	.	C	A	10	8	18	0	0	19	1	0
11	44852732	.	G	A	0	6	6	0	4	10	0	0
11	44852756	.	A	T	6	6	12	0	0	12	0	0
11	44852771	.	T	A	7	8	15	0	0	15	0	0
11	44852988	.	T	A	9	5	14	0	0	14	0	0
11	44853021	.	G	C	3	7	10	0	0	10	0	0
11	44853126	.	C	A	12	5	17	0	0	17	0	0
11	44853172	.	C	A	7	5	12	0	0	12	0	0
11	44853325	.	T	C	2	5	7	0	0	7	0	0
11	44853908	.	A	T	8	14	22	0	1	23	0	0
11	44854335	.	T	C	2	3	5	0	0	5	0	0
11	44854894	.	T	G	13	16	29	0	1	30	0	0
11	44854918	.	G	A	1	18	19	0	17	36	0	0
11	44854996	.	T	C	15	12	27	0	1	28	0	0
11	44855027	.	G	A	0	16	16	0	14	30	0	0
11	44880288	.	A	G	14	10	24	0	2	26	0	0
11	44880291	.	T	A	11	14	25	0	1	26	0	0
11	44880332	.	G	A	18	12	30	0	0	30	0	0
11	44880345	.	C	G	11	18	29	0	0	29	0	0
11	44887200	.	G	A	14	18	32	0	1	33	0	0
11	44887224	.	T	C	30	0	30	0	13	43	0	0
11	44887612	.	G	T	24	18	42	0	0	42	0	0
11	44891507	.	G	A	16	29	45	0	0	45	0	0
11	44892859	.	T	A	27	18	45	0	1	46	0	0
11	44892883	.	G	A	24	14	38	0	1	39	0	0
11	44892943	.	G	A	21	13	34	0	0	34	0	0
11	44892979	.	T	A	20	17	37	0	1	38	0	0
11	44894409	.	T	C	18	0	18	2	15	35	0	0
11	44897584	.	C	T	17	20	37	0	1	38	0	0
11	44897647	.	A	C	11	17	28	0	1	29	0	0
11	44901315	.	C	T	1	8	9	0	10	19	0	0
11	44901373	.	C	A	28	30	58	0	1	59	0	0
11	44906468	.	A	G	7	2	9	0	0	9	0	0
11	44910758	.	T	G	18	17	35	0	2	37	0	0
11	44912485	.	C	A	2	8	10	0	12	22	0	0
11	44912992	.	C	T	1	14	15	0	12	27	0	0
11	44913176	.	C	A	2	12	14	0	18	32	0	0
11	44914943	.	G	C	9	19	28	0	0	28	0	0
11	44921573	.	T	C	15	0	15	0	13	28	0	0
11	44922524	.	T	G	12	5	17	0	0	17	0	0
11	44927159	.	C	A	15	5	20	0	0	20	0	0
11	44927833	.	G	T	10	14	24	0	1	25	0	0
11	44935375	.	A	G	5	8	13	0	0	13	0	0
11	44945621	.	T	G	1	3	4	0	0	4	0	0
11	44945623	.	T	G	1	3	4	0	0	4	0	0
11	44953608	.	C	T	8	5	13	0	0	13	0	0
11	44953620	.	C	T	7	6	13	0	1	14	0	0
11	44960620	.	G	A	8	7	15	0	0	15	0	0
11	45094773	.	C	T	2	3	5	0	0	5	0	0
11	45097342	.	C	A	3	2	5	0	0	5	0	0
11	45097652	.	G	A	2	7	9	1	0	10	0	0
11	45098121	.	A	C	1	5	6	0	0	6	0	0
11	45100902	.	C	G	5	3	8	1	0	9	0	0
11	45120665	.	C	T	3	5	8	0	0	8	0	0
11	45126730	.	C	A	3	5	8	0	0	8	0	0
11	45126772	.	G	A	5	3	8	0	1	9	0	0
11	45126985	.	A	G	4	6	10	0	0	10	0	0
11	45127029	.	C	T	4	2	6	0	0	6	0	0
11	45127191	.	G	A	8	10	18	0	0	18	0	0
11	45127335	.	C	T	1	10	11	0	8	19	0	0
11	45127374	.	G	A	9	11	20	0	0	20	0	0
11	45129287	.	G	A	5	4	9	0	0	9	0	0
11	45130676	.	A	G	6	4	10	1	0	11	0	0
11	45130874	.	C	A	1	7	8	0	7	15	0	0
11	45131119	.	C	T	7	2	9	0	1	10	0	0
11	45138758	.	G	T	4	8	12	0	0	12	0	0
11	45139844	.	A	G	4	2	6	0	0	6	0	0
11	45140116	.	C	G	7	8	15	0	1	16	0	0
11	45141286	.	T	C	6	17	23	0	0	23	0	0
11	45147865	.	G	C	4	7	11	0	0	11	0	0
11	45156079	.	C	T	1	3	4	0	0	4	0	0
11	45156102	.	T	C	1	1	2	0	0	2	0	0
11	45161950	.	T	C	12	0	12	0	18	30	0	0
11	45162241	.	A	T	16	4	20	0	0	20	0	0
11	45162416	.	T	C	20	0	20	0	21	41	0	0
11	45167709	.	G	A	10	11	21	0	1	22	0	0
11	45171032	.	G	C	11	7	18	8	0	26	0	0
11	45174921	.	G	A	3	2	5	0	0	5	0	0
11	45176018	.	G	A	2	2	4	0	0	4	0	0
11	45176036	.	T	A	1	2	3	0	0	3	0	0
11	45223968	.	G	A	0	6	6	0	4	10	0	0
11	45227110	.	C	T	3	2	5	0	1	6	0	0
11	45233971	.	G	A	1	2	3	0	5	8	0	0
11	45234021	.	G	A	0	3	3	0	3	6	0	0
11	45234045	.	G	C	1	2	3	0	1	4	0	0
11	45237529	.	T	G	2	6	8	0	0	8	0	0
11	45240568	.	C	T	2	2	4	0	0	4	0	0
11	45242450	.	C	T	7	6	13	0	1	14	0	0
11	45242912	.	T	C	11	10	21	0	0	21	0	0
11	45245862	.	G	A	2	5	7	0	0	7	0	0
11	45247267	.	C	T	0	2	2	0	3	5	0	0
11	45257659	.	C	T	7	9	16	1	0	17	0	0
11	45262079	.	C	T	14	13	27	0	0	27	0	0
11	45262138	.	C	G	11	0	11	0	7	18	0	0
11	45262155	.	T	C	8	6	14	0	2	16	0	0
11	45262186	.	G	A	1	8	9	0	9	18	0	0
11	45262379	.	G	T	8	8	16	1	2	19	0	0
11	45265828	.	C	T	11	10	21	0	0	21	0	0
11	45269752	.	T	C	18	13	31	0	2	33	0	0
11	45272686	.	G	A	0	5	5	0	5	10	0	0
11	45287575	.	G	A	5	10	15	0	0	15	0	0
11	45290463	.	A	G	11	5	16	0	1	17	0	0
11	45290884	.	C	T	8	9	17	0	0	17	0	0
11	45291926	.	G	A	8	11	19	0	1	20	0	0
11	45292918	.	G	A	0	8	8	0	14	22	0	0
11	45299717	.	A	C	1	2	3	0	0	3	0	0
11	45299734	.	A	G	1	0	1	0	3	4	0	0
11	45327030	.	G	A	5	5	10	0	1	11	0	0
11	45327056	.	T	C	3	5	8	0	1	9	0	0
11	45327272	.	T	C	1	4	5	0	1	6	0	0
11	45327456	.	C	T	3	4	7	0	1	8	0	0
11	45327493	.	T	G	2	7	9	0	0	9	0	0
11	45327609	.	T	C	6	4	10	0	1	11	0	0
11	45327922	.	C	G	6	5	11	0	0	11	0	0
11	45327997	.	A	G	6	3	9	0	0	9	0	0
11	45328046	.	C	T	3	4	7	0	0	7	0	0
11	45328494	.	T	C	4	3	7	0	0	7	0	0
11	45342589	.	C	A	5	3	8	0	0	8	0	0
11	45342592	.	G	A	4	3	7	0	0	7	0	0
11	45342625	.	C	T	2	2	4	0	0	4	0	0
11	45342757	.	A	G	2	7	9	0	0	9	0	0
11	45342823	.	G	A	7	2	9	0	1	10	0	0
11	45342861	.	A	C	3	7	10	0	0	10	0	0
11	45342924	.	T	C	3	4	7	0	0	7	0	0
11	45343033	.	A	G	3	7	10	0	1	11	0	0
11	45343045	.	C	G	6	3	9	0	0	9	0	0
11	45343231	.	T	A	3	4	7	0	1	8	0	0
11	45343264	.	A	T	5	6	11	0	0	11	0	0
11	45344090	.	C	T	4	3	7	0	0	7	0	0
11	45348465	.	G	A	4	4	8	0	0	8	0	0
11	45355022	.	C	G	10	10	20	0	0	20	0	0
11	45355473	.	C	T	0	14	14	0	20	34	0	0
11	45355730	.	C	T	7	11	18	2	9	29	0	0
11	45356041	.	T	A	5	4	9	0	4	14	1	0
11	45356042	.	G	A	9	5	14	0	3	17	0	0
11	45356114	.	G	A	8	13	21	0	5	26	0	0
11	45356660	.	C	T	2	11	13	0	17	30	0	0
11	45362172	.	A	T	14	12	26	0	1	27	0	0
11	45363073	.	G	A	9	10	19	0	0	19	0	0
11	45366754	.	T	C	8	0	8	0	9	17	0	0
11	45366798	.	T	A	4	8	12	0	1	13	0	0
11	45370529	.	G	A	6	4	10	0	0	10	0	0
11	45371868	.	A	G	8	4	12	0	0	12	0	0
11	45372043	.	C	T	0	7	7	0	9	16	0	0
11	45372246	.	C	T	0	3	3	0	3	6	0	0
11	45389599	.	C	G	3	4	7	0	0	7	0	0
11	45389601	.	C	T	3	4	7	0	0	7	0	0
11	45389809	.	T	C	4	4	8	0	0	8	0	0
11	45389922	.	G	A	10	10	20	0	0	20	0	0
11	45389932	.	A	T	12	8	20	0	1	21	0	0
11	45391727	.	T	C	19	8	27	0	2	29	0	0
11	45391788	.	C	T	13	12	25	0	0	25	0	0
11	45393520	.	A	C	9	6	15	0	45	60	0	0
11	45393522	.	A	C	10	2	12	0	47	59	0	0
11	45395572	.	G	A	2	26	28	1	21	50	0	0
11	45397372	.	C	T	17	33	50	1	1	52	0	0
11	45398744	.	A	G	33	31	64	1	2	67	0	0
11	45398804	.	T	C	39	28	67	0	2	69	0	0
11	45399389	.	A	G	31	35	66	0	3	69	0	0
11	45399491	.	C	T	23	26	49	1	4	54	0	0
11	45399799	.	G	T	11	14	25	0	1	26	0	0
11	45399925	.	C	T	13	16	29	0	2	31	0	0
11	45399985	.	G	T	3	21	24	0	12	36	0	0
11	45402945	.	G	A	12	17	29	0	0	29	0	0
11	45403525	.	G	A	18	9	27	0	0	27	0	0
11	45403733	.	G	A	24	10	34	0	0	34	0	0
11	45403800	.	T	A	26	8	34	0	1	35	0	0
11	45403854	.	G	A	27	12	39	0	2	41	0	0
11	45407215	.	G	A	19	18	37	0	0	37	0	0
11	45419948	.	C	G	1	9	10	0	22	32	0	0
11	45429190	.	A	T	4	2	6	0	0	6	0	0
11	45439842	.	G	A	0	4	4	0	7	11	0	0
11	45452373	.	C	T	8	7	15	0	0	15	0	0
11	45452786	.	G	A	0	5	5	0	8	13	0	0
11	45453713	.	T	C	2	3	5	0	0	5	0	0
11	45456290	.	G	A	10	5	15	0	0	15	0	0
11	45460271	.	G	A	0	12	12	0	13	25	0	0
11	45461498	.	G	A	0	12	12	0	10	23	1	0
11	45463352	.	T	C	17	8	25	0	0	25	0	0
11	45463730	.	G	A	1	16	17	0	13	30	0	0
11	45463835	.	G	T	14	10	24	0	0	24	0	0
11	45463979	.	T	A	13	6	19	0	1	20	0	0
11	45464041	.	T	C	6	4	10	0	0	10	0	0
11	45464188	.	G	C	4	5	9	0	0	9	0	0
11	45464673	.	C	T	9	5	14	1	1	16	0	0
11	45464762	.	A	T	14	5	19	0	0	19	0	0
11	45464835	.	G	A	7	6	13	0	0	13	0	0
11	45465080	.	T	A	7	10	17	0	2	19	0	0
11	45468956	.	C	A	2	4	6	0	1	7	0	0
11	45468959	.	G	A	4	4	8	0	0	8	0	0
11	45469097	.	T	C	4	2	6	0	0	6	0	0
11	45469273	.	A	G	5	4	9	0	2	11	0	0
11	45469689	.	C	T	4	3	7	0	0	7	0	0
11	45469766	.	A	G	3	3	6	0	0	6	0	0
11	45469829	.	C	T	3	3	6	0	1	7	0	0
11	45469839	.	T	C	2	1	3	0	3	6	0	0
11	45469914	.	G	T	2	4	6	0	0	6	0	0
11	45470277	.	C	T	4	11	15	0	8	23	0	0
12	456290	.	A	G	4	2	6	0	0	6	0	0
12	457769	.	C	T	1	5	6	0	2	8	0	0
12	465732	.	G	A	2	14	16	0	15	31	0	0
12	466174	.	T	A	11	10	21	0	0	21	0	0
12	466221	.	G	C	18	13	31	0	0	31	0	0
12	497201	.	C	T	17	12	29	0	1	30	0	0
12	499855	.	C	T	9	16	25	0	0	25	0	0
12	499865	.	C	T	8	14	22	0	2	24	0	0
12	502221	.	C	T	23	12	35	0	1	36	0	0
12	503308	.	G	A	13	17	30	0	0	30	0	0
12	516845	.	C	T	25	15	40	0	1	41	0	0
12	518107	.	T	C	18	21	39	0	0	39	0	0
12	527402	.	A	C	19	16	35	0	1	36	0	0
12	527693	.	T	G	16	14	30	0	2	33	1	0
12	527712	.	T	C	13	12	25	0	2	27	0	0
12	532019	.	C	G	6	4	10	0	0	10	0	0
12	532054	.	C	G	5	3	8	0	0	8	0	0
12	533607	.	T	C	5	4	9	0	1	10	0	0
12	533657	.	C	T	3	2	5	0	0	5	0	0
12	533948	.	C	T	2	2	4	0	0	4	0	0
12	534252	.	A	T	4	4	8	0	0	8	0	0
12	534258	.	C	G	3	4	7	0	0	7	0	0
12	534297	.	A	G	2	5	7	0	0	7	0	0
12	534642	.	C	T	3	3	6	0	0	6	0	0
12	540114	.	G	A	1	2	3	0	0	3	0	0
12	549605	.	T	C	9	0	9	0	7	16	0	0
12	550387	.	G	T	12	11	23	1	0	24	0	0
12	550513	.	T	A	23	7	30	0	0	30	0	0
12	550516	.	C	T	3	7	10	0	21	31	0	0
12	550973	.	T	C	17	13	30	0	0	30	0	0
12	550985	.	T	C	16	2	18	0	11	29	0	0
12	551098	.	A	G	20	16	36	0	0	36	0	0
12	551192	.	A	G	17	9	26	0	0	26	0	0
12	551372	.	C	T	17	17	34	0	2	36	0	0
12	551398	.	C	T	12	13	25	0	6	31	0	0
12	551549	.	T	C	23	0	23	0	15	38	0	0
12	551892	.	T	C	17	0	17	0	26	43	0	0
12	551927	.	A	G	21	21	42	0	1	43	0	0
12	554210	.	T	C	18	1	19	0	18	37	0	0
12	558142	.	A	C	14	15	29	0	1	30	0	0
12	561350	.	G	T	2	1	3	0	2	5	0	0
12	562200	.	C	T	4	3	7	0	0	7	0	0
12	562203	.	C	T	0	3	3	0	3	6	0	0
12	564552	.	C	T	0	6	6	0	8	14	0	0
12	564553	.	G	A	8	6	14	0	0	14	0	0
12	565571	.	C	G	10	7	17	0	1	18	0	0
12	566983	.	A	G	7	4	11	0	0	11	0	0
12	567012	.	T	C	5	0	5	0	6	11	0	0
12	568872	.	G	A	5	2	7	0	0	7	0	0
12	571873	.	T	C	5	3	8	0	0	8	0	0
12	571933	.	T	C	5	0	5	0	7	12	0	0
12	573390	.	G	A	3	6	9	0	0	9	0	0
12	573414	.	C	T	2	7	9	0	0	9	0	0
12	573431	.	G	A	3	7	10	0	0	10	0	0
12	573456	.	A	G	3	6	9	0	0	9	0	0
12	576271	.	C	T	1	3	4	0	0	4	0	0
12	577838	.	A	C	5	3	8	0	0	8	0	0
12	582786	.	G	A	3	2	5	0	0	5	0	0
12	582795	.	G	A	3	2	5	0	0	5	0	0
12	592777	.	G	A	2	5	7	0	0	7	0	0
12	599429	.	G	A	3	4	7	0	2	9	0	0
12	600798	.	A	G	3	2	5	0	0	5	0	0
12	602294	.	A	C	2	6	8	0	0	8	0	0
12	602782	.	C	T	3	5	8	0	0	8	0	0
12	602803	.	T	A	4	4	8	0	0	8	0	0
12	604256	.	G	T	3	4	7	0	0	7	0	0
12	604359	.	G	A	2	2	4	0	0	4	0	0
12	608708	.	A	G	1	2	3	0	0	3	0	0
12	611278	.	T	C	3	0	3	0	2	5	0	0
12	611305	.	T	A	3	2	5	0	1	6	0	0
12	617914	.	A	G	1	2	3	0	0	3	0	0
12	626988	.	A	G	1	2	3	0	0	3	0	0
12	627064	.	C	T	2	2	4	0	0	4	0	0
12	632298	.	C	T	4	5	9	0	0	9	0	0
12	634241	.	A	G	7	3	10	0	0	10	0	0
12	634292	.	C	T	0	7	7	0	11	18	0	0
12	645760	.	T	C	3	4	7	0	0	7	0	0
12	663142	.	C	T	2	2	4	0	0	4	0	0
12	726557	.	G	A	1	2	3	0	1	4	0	0
12	735104	.	T	G	3	2	5	0	0	5	0	0
12	740558	.	C	T	1	2	3	0	0	3	0	0
12	742809	.	G	T	0	3	3	0	2	5	0	0
12	755141	.	A	G	3	2	5	0	0	5	0	0
12	760750	.	C	T	3	3	6	0	0	6	0	0
12	781433	.	T	A	2	3	5	0	0	5	0	0
12	847787	.	T	C	14	14	28	0	1	29	0	0
12	848846	.	T	C	24	0	24	0	22	46	0	0
12	850303	.	T	C	30	15	45	0	1	46	0	0
12	906722	.	A	G	9	15	24	0	1	25	0	0
12	907584	.	G	A	7	8	15	0	1	16	0	0
12	910704	.	T	C	11	2	13	0	10	23	0	0
12	911042	.	C	T	1	10	11	0	6	17	0	0
12	911162	.	G	C	10	10	20	0	0	20	0	0
12	911180	.	A	C	8	8	16	0	1	17	0	0
12	912274	.	G	C	16	17	33	0	1	34	0	0
12	927844	.	G	C	12	12	24	0	0	24	0	0
12	927853	.	G	A	11	11	22	0	0	22	0	0
12	931371	.	G	A	8	4	12	0	1	13	0	0
12	931410	.	C	A	1	9	10	0	7	17	0	0
12	931437	.	A	G	6	9	15	0	0	15	0	0
12	932092	.	G	T	10	6	16	0	0	16	0	0
12	943314	.	C	T	0	6	6	0	12	18	0	0
12	964877	.	T	C	13	0	13	0	15	28	0	0
12	964888	.	T	G	15	15	30	0	0	30	0	0
12	972975	.	C	T	0	8	8	0	15	23	0	0
12	976154	.	C	G	2	11	13	0	5	18	0	0
12	979718	.	G	A	8	13	21	0	0	21	0	0
12	982870	.	A	T	2	2	4	0	0	4	0	0
12	983176	.	T	A	8	9	17	0	0	17	0	0
12	983222	.	G	A	5	4	9	0	1	10	0	0
12	983340	.	C	T	4	13	17	0	0	17	0	0
12	986792	.	T	G	8	6	14	0	0	14	0	0
12	986834	.	A	G	9	11	20	0	0	20	0	0
12	989974	.	G	C	6	2	8	0	0	8	0	0
12	992819	.	C	T	5	2	7	0	0	7	0	0
12	993237	.	C	G	6	5	11	0	0	11	0	0
12	997320	.	G	A	3	5	8	0	0	8	0	0
12	997834	.	T	C	6	6	12	0	0	12	0	0
12	997849	.	T	C	8	4	12	0	0	12	0	0
12	997909	.	A	G	5	6	11	0	0	11	0	0
12	997917	.	G	A	4	7	11	0	0	11	0	0
12	999517	.	T	C	6	0	6	0	6	12	0	0
12	999579	.	C	G	4	7	11	0	2	13	0	0
12	1014495	.	C	G	1	2	3	0	0	3	0	0
12	1014553	.	C	T	0	8	8	0	3	11	0	0
12	1014668	.	A	G	8	4	12	0	1	13	0	0
12	1015197	.	C	T	0	6	6	0	6	12	0	0
12	1015845	.	G	A	5	15	20	0	1	21	0	0
12	1019123	.	C	T	1	7	8	0	4	12	0	0
12	1019243	.	G	T	5	12	17	0	0	17	0	0
12	1019311	.	C	G	8	5	13	0	0	13	0	0
12	1019503	.	G	A	3	6	9	0	0	9	0	0
12	1021152	.	G	A	4	7	11	0	0	11	0	0
12	1021194	.	G	A	3	3	6	0	0	6	0	0
12	1021200	.	C	T	0	3	3	0	3	6	0	0
12	1030048	.	A	G	3	8	11	0	0	11	0	0
12	1078346	.	T	G	1	0	1	0	1	2	0	0
12	1078371	.	C	G	0	4	4	0	0	4	0	0
12	1206154	.	T	C	24	17	41	0	2	43	0	0
12	1388107	.	G	A	2	2	4	0	0	4	0	0
12	1398661	.	T	A	15	14	29	0	0	29	0	0
12	1556396	.	G	A	1	3	4	0	0	4	0	0
12	1556963	.	T	A	3	2	5	0	0	5	0	0
12	1557164	.	A	C	5	0	5	0	3	8	0	0
12	1950141	.	C	A	10	9	19	0	0	19	0	0
12	2457411	.	G	A	4	3	7	0	0	7	0	0
12	2457441	.	A	T	1	4	5	0	1	6	0	0
12	2485624	.	G	C	1	4	5	0	0	5	0	0
12	2488237	.	C	T	5	3	8	0	0	8	0	0
12	2488542	.	C	G	5	5	10	0	1	11	0	0
12	2488938	.	G	A	6	2	8	0	0	8	0	0
12	2492299	.	A	G	4	7	11	0	1	12	0	0
12	2492423	.	G	T	0	8	8	0	2	10	0	0
12	2505557	.	T	G	14	16	30	0	5	35	0	0
12	2505614	.	G	A	18	15	33	0	1	34	0	0
12	2505921	.	G	C	19	0	19	0	21	40	0	0
12	2506007	.	A	G	21	3	24	3	1	28	0	0
12	2506027	.	G	A	18	9	27	3	1	31	0	0
12	2507295	.	G	A	8	13	21	0	0	21	0	0
12	2507585	.	C	T	2	9	11	0	15	26	0	0
12	2507988	.	T	C	11	0	11	0	13	24	0	0
12	2508051	.	T	C	9	0	9	0	10	19	0	0
12	2509851	.	C	G	12	8	20	0	0	20	0	0
12	2514396	.	G	T	3	7	10	0	0	10	0	0
12	2514434	.	G	T	3	8	11	0	0	11	0	0
12	2516187	.	T	C	8	0	8	0	5	13	0	0
12	2518125	.	T	C	7	0	7	0	9	16	0	0
12	2518220	.	G	A	4	11	15	0	0	15	0	0
12	2741366	.	C	A	1	2	3	0	0	3	0	0
12	2741768	.	G	A	1	2	3	0	0	3	0	0
12	2743327	.	G	T	1	4	5	0	0	5	0	0
12	2743350	.	A	C	1	3	4	0	0	4	0	0
12	2743988	.	A	C	6	3	9	0	0	9	0	0
12	2744279	.	G	T	1	2	3	0	1	4	0	0
12	2744291	.	A	T	1	3	4	0	0	4	0	0
12	2821373	.	G	A	0	3	3	0	3	6	0	0
12	2829919	.	G	C	1	3	4	0	0	4	0	0
12	2833422	.	C	G	5	5	10	0	0	10	0	0
12	2833488	.	C	A	10	3	13	0	0	13	0	0
12	2834053	.	A	G	5	1	6	0	3	9	0	0
12	2840152	.	G	A	2	4	6	0	0	6	0	0
12	2843700	.	C	G	7	0	7	0	7	14	0	0
12	2845677	.	G	A	5	5	10	0	2	12	0	0
12	2845700	.	T	C	3	4	7	0	2	9	0	0
12	2846146	.	G	T	1	5	6	0	6	12	0	0
12	2846164	.	G	C	3	7	10	0	0	10	0	0
12	2846215	.	G	A	2	7	9	0	0	9	0	0
12	2848162	.	C	T	7	6	13	0	1	14	0	0
12	2849970	.	A	G	1	6	7	0	1	8	0	0
12	2850096	.	C	T	6	2	8	0	0	8	0	0
12	2850532	.	T	C	2	5	7	0	0	7	0	0
12	2850569	.	T	C	1	6	7	0	1	8	0	0
12	2850623	.	G	A	6	4	10	0	0	10	0	0
12	2850637	.	G	A	6	2	8	0	0	8	0	0
12	2856829	.	A	G	2	5	7	0	1	8	0	0
12	2856901	.	G	C	3	3	6	0	0	6	0	0
12	2869439	.	C	G	3	4	7	0	0	7	0	0
12	2869468	.	T	G	6	2	8	0	0	8	0	0
12	2870708	.	G	A	6	5	11	0	0	11	0	0
12	2870733	.	G	A	0	9	9	0	12	21	0	0
12	2893006	.	G	A	1	11	12	0	7	19	0	0
12	2895248	.	T	C	18	16	34	0	1	35	0	0
12	2895264	.	G	T	2	20	22	0	11	33	0	0
12	2895344	.	G	A	1	4	5	0	11	16	0	0
12	2895389	.	T	G	6	8	14	0	1	15	0	0
12	2895463	.	A	G	7	5	12	0	0	12	0	0
12	2895716	.	C	T	7	4	11	0	0	11	0	0
12	2895751	.	C	A	6	2	8	0	0	8	0	0
12	2993557	.	A	C	6	5	11	1	0	12	0	0
12	2995996	.	G	T	3	3	6	0	0	6	0	0
12	2996070	.	A	G	6	0	6	0	4	10	0	0
12	3001893	.	A	C	2	8	10	0	2	12	0	0
12	3003904	.	T	C	5	4	9	0	0	9	0	0
12	3006358	.	C	T	2	4	6	0	0	6	0	0
12	3019681	.	A	G	1	3	4	0	1	5	0	0
12	3019698	.	A	T	3	3	6	0	0	6	0	0
12	3022947	.	C	A	23	28	51	0	1	52	0	0
12	3033166	.	G	A	24	19	43	1	0	44	0	0
12	3033199	.	A	G	20	1	21	1	24	46	0	0
12	3033357	.	T	C	24	32	56	0	2	58	0	0
12	3033360	.	A	C	26	32	58	0	0	58	0	0
12	3038920	.	G	A	3	29	32	0	21	53	0	0
12	3038929	.	A	G	27	2	29	0	21	50	0	0
12	3039078	.	G	C	0	18	18	0	25	43	0	0
12	3039210	.	C	T	25	22	47	0	2	49	0	0
12	3039283	.	T	A	8	24	32	0	3	35	0	0
12	3039311	.	T	C	9	19	28	0	1	29	0	0
12	3039321	.	A	G	5	16	21	0	3	24	0	0
12	3039423	.	G	A	1	11	12	0	15	27	0	0
12	3039522	.	T	C	21	20	41	0	0	41	0	0
12	3039652	.	T	C	24	32	56	0	0	56	0	0
12	3039682	.	A	C	24	27	51	0	0	51	0	0
12	3039738	.	A	T	32	9	41	0	1	42	0	0
12	3039940	.	A	G	17	22	39	0	1	40	0	0
12	3040158	.	A	T	24	13	37	0	0	37	0	0
12	3040178	.	T	C	24	9	33	0	0	33	0	0
12	3040329	.	A	G	20	21	41	1	3	45	0	0
12	3040370	.	G	A	3	20	23	0	12	35	0	0
12	3040819	.	T	A	14	18	32	0	0	32	0	0
12	3041087	.	C	A	13	6	19	0	2	21	0	0
12	3041088	.	G	T	4	5	9	0	13	22	0	0
12	3041179	.	T	A	19	11	30	0	0	30	0	0
12	3041390	.	A	T	19	20	39	0	4	43	0	0
12	3041497	.	G	A	1	14	15	0	16	31	0	0
12	3041587	.	A	T	20	16	36	0	4	41	1	0
12	3041606	.	A	T	26	19	45	0	0	45	0	0
12	3041721	.	G	A	3	15	18	0	30	48	0	0
12	3041871	.	C	T	19	22	41	0	9	50	0	0
12	3041905	.	C	A	15	20	35	0	1	36	0	0
12	3049366	.	G	C	3	3	6	0	0	6	0	0
12	3059630	.	G	T	6	2	8	0	0	8	0	0
12	3059634	.	G	C	6	2	8	0	0	8	0	0
12	3059668	.	G	T	3	4	7	0	0	7	0	0
12	3059691	.	C	T	2	4	6	0	0	6	0	0
12	3059979	.	C	A	2	3	5	0	0	6	1	0
12	3060003	.	C	T	3	5	8	0	0	8	0	0
12	3060156	.	A	G	5	2	7	0	0	7	0	0
12	3060441	.	G	A	3	2	5	0	0	5	0	0
12	3061103	.	T	C	3	4	7	0	0	7	0	0
12	3072985	.	A	G	6	6	12	0	1	13	0	0
12	3077032	.	A	T	6	3	9	0	0	9	0	0
12	3077042	.	A	T	7	3	10	0	0	10	0	0
12	3077223	.	T	C	3	4	7	0	0	7	0	0
12	3077257	.	C	T	3	5	8	0	0	8	0	0
12	3077261	.	C	G	3	5	8	0	0	8	0	0
12	3096074	.	C	T	3	2	5	0	0	5	0	0
12	3271553	.	G	A	9	8	17	0	1	18	0	0
12	3271873	.	A	T	1	6	7	0	0	7	0	0
12	3287912	.	G	A	4	3	7	0	0	7	0	0
12	3452712	.	C	T	0	3	3	0	2	5	0	0
12	3574348	.	G	A	7	19	26	0	0	26	0	0
12	3574398	.	C	G	3	17	20	0	0	20	0	0
12	3574489	.	G	A	3	3	6	0	0	6	0	0
12	3714621	.	T	C	6	5	11	0	0	11	0	0
12	3714627	.	T	C	5	5	10	0	0	10	0	0
12	3714731	.	T	C	6	4	10	0	0	10	0	0
12	3714746	.	C	T	6	3	9	0	0	9	0	0
12	3714934	.	T	C	11	12	23	0	0	23	0	0
12	3714977	.	T	C	2	0	2	0	15	17	0	0
12	3715201	.	T	C	4	2	6	0	0	6	0	0
12	3715292	.	T	G	11	3	14	0	0	14	0	0
12	3715327	.	C	A	10	4	14	0	0	14	0	0
12	3715329	.	C	G	10	4	14	0	0	14	0	0
12	3716621	.	G	C	9	8	17	0	0	17	0	0
12	3719297	.	T	G	8	10	18	0	1	19	0	0
12	3719312	.	T	C	9	0	9	0	14	23	0	0
12	3721941	.	A	G	4	7	11	0	0	11	0	0
12	3723786	.	C	G	10	11	21	0	0	21	0	0
12	3723963	.	G	A	0	6	6	0	7	13	0	0
12	3731590	.	G	A	0	7	7	0	8	15	0	0
12	3731602	.	C	A	12	6	18	0	0	18	0	0
12	3740724	.	T	A	14	15	29	0	1	30	0	0
12	3740735	.	A	T	15	17	32	0	1	33	0	0
12	3740784	.	C	T	22	12	34	0	0	34	0	0
12	3740803	.	G	A	20	14	34	0	0	34	0	0
12	3747652	.	G	C	15	17	32	0	2	34	0	0
12	3749505	.	C	T	2	13	15	0	12	27	0	0
12	3753166	.	C	T	1	11	12	0	16	28	0	0
12	3756229	.	G	T	11	8	19	0	1	20	0	0
12	3756237	.	C	T	12	10	22	0	0	22	0	0
12	3756303	.	C	T	2	10	12	0	15	27	0	0
12	3767321	.	G	T	8	10	18	0	0	18	0	0
12	3770991	.	G	A	5	7	12	0	0	12	0	0
12	3789469	.	T	C	8	4	12	0	0	12	0	0
12	3789772	.	T	G	13	8	21	0	4	25	0	0
12	3791925	.	C	A	4	7	11	0	0	11	0	0
12	3921813	.	G	A	1	3	4	0	0	4	0	0
12	4960546	.	A	G	2	0	2	0	5	7	0	0
12	4960784	.	A	G	2	2	4	0	0	4	0	0
12	4960959	.	A	G	3	6	9	0	0	9	0	0
12	4962027	.	A	G	4	5	9	0	0	9	0	0
12	6235283	.	C	T	1	3	4	0	0	4	0	0
12	6235315	.	T	C	2	3	5	0	0	5	0	0
12	6235333	.	G	C	2	2	4	0	0	4	0	0
12	6448548	.	G	A	1	2	3	0	1	4	0	0
12	6449243	.	T	C	6	3	9	0	0	9	0	0
12	6451410	.	C	G	2	3	5	0	0	5	0	0
12	6543350	.	G	A	3	2	5	0	0	5	0	0
12	6543458	.	C	G	4	5	9	0	0	9	0	0
12	6547163	.	C	T	1	7	8	0	8	16	0	0
12	6547214	.	A	G	6	9	15	0	0	15	0	0
12	6549689	.	A	G	3	5	8	0	0	8	0	0
12	6576130	.	A	T	3	6	9	0	0	9	0	0
12	6587222	.	T	C	5	0	5	0	3	8	0	0
12	6658822	.	G	A	1	4	5	0	0	5	0	0
12	6713949	.	G	A	6	5	11	0	0	11	0	0
12	6742562	.	A	G	4	2	6	0	0	6	0	0
12	6756394	.	G	C	4	4	8	0	0	8	0	0
12	6767735	.	G	A	1	2	3	0	3	6	0	0
12	6805953	.	A	G	4	5	9	0	0	9	0	0
12	7193865	.	C	T	5	2	7	0	0	7	0	0
12	7193874	.	A	G	6	2	8	0	0	8	0	0
12	7194410	.	A	G	7	9	16	0	0	16	0	0
12	7194505	.	T	C	9	13	22	0	0	22	0	0
12	7194522	.	T	C	10	12	22	0	1	23	0	0
12	7194587	.	G	A	7	9	16	0	0	16	0	0
12	7194677	.	G	C	2	6	8	0	0	8	0	0
12	7194843	.	C	A	7	6	13	0	0	13	0	0
12	7195081	.	G	T	16	7	23	0	0	23	0	0
12	7195139	.	A	T	14	9	23	1	2	26	0	0
12	7195192	.	G	T	4	31	35	2	1	38	0	0
12	7195365	.	T	C	12	15	27	0	1	28	0	0
12	7195454	.	T	A	9	12	21	0	0	21	0	0
12	7195524	.	G	T	11	8	19	1	0	20	0	0
12	7195588	.	G	A	13	7	20	4	1	25	0	0
12	7195600	.	T	C	9	12	21	0	1	22	0	0
12	7195676	.	C	T	0	5	5	0	11	16	0	0
12	7195816	.	C	A	7	6	13	0	1	14	0	0
12	7195888	.	T	C	3	5	8	0	0	8	0	0
12	7195942	.	C	T	3	3	6	0	0	6	0	0
12	7195951	.	T	C	3	0	3	0	3	6	0	0
12	7196059	.	G	A	12	9	21	0	2	23	0	0
12	7196114	.	G	A	14	9	23	0	0	23	0	0
12	7196125	.	A	G	6	13	19	0	2	21	0	0
12	7196175	.	G	A	12	9	21	0	0	21	0	0
12	7196201	.	G	A	10	8	18	0	1	19	0	0
12	7196249	.	G	T	6	7	13	0	0	13	0	0
12	7196456	.	A	G	4	3	7	0	0	7	0	0
12	7197407	.	T	C	6	5	11	0	0	11	0	0
12	7197768	.	G	A	1	5	6	0	1	7	0	0
12	7198135	.	T	A	10	8	18	0	1	19	0	0
12	7198215	.	C	A	6	4	10	0	0	10	0	0
12	7198255	.	T	A	5	4	9	0	0	9	0	0
12	7198409	.	G	A	2	8	10	0	0	10	0	0
12	7198625	.	C	A	5	5	10	0	0	10	0	0
12	7198882	.	G	A	8	6	14	0	0	14	0	0
12	7199447	.	C	T	7	5	12	0	1	13	0	0
12	7223665	.	C	T	3	12	15	0	0	15	0	0
12	7234790	.	G	A	11	4	15	0	0	15	0	0
12	7235030	.	G	A	7	11	18	0	1	19	0	0
12	7254324	.	A	T	5	7	12	0	1	13	0	0
12	7254352	.	G	C	4	8	12	0	0	12	0	0
12	7263657	.	G	T	0	3	3	0	3	6	0	0
12	7263665	.	G	T	0	4	4	0	2	6	0	0
12	7268489	.	T	A	2	2	4	0	0	4	0	0
12	7269266	.	G	A	4	2	6	0	0	6	0	0
12	7269673	.	G	A	2	8	10	0	2	12	0	0
12	7271805	.	A	C	5	7	12	0	1	13	0	0
12	7271895	.	A	G	9	5	14	0	0	14	0	0
12	7275695	.	T	C	8	6	14	0	0	14	0	0
12	7280160	.	G	T	9	3	12	0	0	12	0	0
12	7491712	.	A	G	5	2	7	0	0	7	0	0
12	7504066	.	C	T	8	9	17	0	0	17	0	0
12	7507047	.	C	T	15	16	31	0	0	31	0	0
12	7512637	.	T	C	17	15	32	1	2	35	0	0
12	7512641	.	T	A	15	17	32	1	2	35	0	0
12	7512675	.	G	A	16	12	28	1	0	29	0	0
12	7512682	.	A	G	13	11	24	1	2	27	0	0
12	7512921	.	A	G	18	12	30	0	0	30	0	0
12	7512965	.	C	A	13	11	24	0	0	24	0	0
12	7513106	.	C	A	15	11	26	1	0	27	0	0
12	7513446	.	T	A	20	20	40	0	2	42	0	0
12	7513480	.	C	T	23	10	33	0	1	34	0	0
12	7513555	.	G	A	26	9	35	0	2	37	0	0
12	7513637	.	G	A	21	11	32	0	3	35	0	0
12	7513658	.	C	T	20	14	34	0	0	35	1	0
12	7513685	.	C	A	23	10	33	0	0	33	0	0
12	7610969	.	T	C	2	4	6	0	0	6	0	0
12	7611286	.	T	C	1	4	5	0	0	5	0	0
12	7612106	.	T	C	4	10	14	0	1	15	0	0
12	7612223	.	T	C	3	5	8	0	0	8	0	0
12	10125546	.	A	G	7	6	13	0	0	13	0	0
12	10125573	.	A	G	4	8	12	0	0	12	0	0
12	10609714	.	A	G	1	2	3	0	0	3	0	0
12	11389082	.	T	C	11	4	15	0	2	17	0	0
12	11389226	.	T	C	13	2	15	0	0	15	0	0
12	11389229	.	T	C	10	4	14	0	1	15	0	0
12	11390306	.	T	C	10	9	19	0	0	19	0	0
12	11390365	.	T	C	10	6	16	0	1	17	0	0
12	13473278	.	A	G	4	3	7	0	1	8	0	0
12	13473302	.	A	G	4	0	4	0	4	8	0	0
12	13473314	.	A	G	5	3	8	0	0	8	0	0
12	13473422	.	A	G	6	2	8	0	0	8	0	0
12	13473690	.	A	G	10	10	20	0	3	23	0	0
12	13473693	.	A	G	12	0	12	0	10	22	0	0
12	13474461	.	A	G	12	4	16	0	1	17	0	0
12	13475225	.	A	G	13	7	20	0	1	21	0	0
12	16407127	.	T	C	1	5	6	0	0	6	0	0
12	18690957	.	G	A	2	4	6	0	1	7	0	0
12	18692675	.	T	C	4	13	17	0	0	17	0	0
12	18694220	.	A	C	9	4	13	0	1	14	0	0
12	18698557	.	C	T	2	4	6	0	0	6	0	0
12	18701608	.	C	T	5	6	11	0	0	11	0	0
12	18713926	.	C	T	5	7	12	0	1	13	0	0
12	18714000	.	C	T	12	11	23	0	0	23	0	0
12	18716985	.	C	T	11	6	17	0	0	17	0	0
12	18717085	.	A	G	8	9	17	0	0	17	0	0
12	18779450	.	T	A	7	13	20	1	1	22	0	0
12	18779648	.	T	C	12	7	19	0	1	20	0	0
12	18782541	.	G	A	9	6	15	0	1	16	0	0
12	18782763	.	G	A	10	11	21	0	0	21	0	0
12	18786773	.	T	C	12	7	19	0	0	19	0	0
12	18786917	.	T	C	9	5	14	0	2	16	0	0
12	18787009	.	G	A	9	7	16	0	1	17	0	0
12	18787205	.	C	T	6	2	8	0	1	9	0	0
12	18794289	.	A	G	1	3	4	0	0	4	0	0
12	18913895	.	A	T	11	1	12	0	1	13	0	0
12	18913906	.	A	G	9	4	13	0	1	14	0	0
12	18913938	.	A	G	9	4	13	0	1	14	0	0
12	18943463	.	C	T	5	2	7	0	1	8	0	0
12	19317745	.	G	A	28	16	44	0	4	48	0	0
12	19317791	.	G	A	30	22	52	1	1	54	0	0
12	19317875	.	G	A	25	19	44	0	0	44	0	0
12	19317930	.	G	T	4	16	20	0	19	39	0	0
12	19318157	.	T	C	24	11	35	0	0	35	0	0
12	19318158	.	G	A	22	9	31	0	4	35	0	0
12	19318194	.	G	C	20	9	29	0	1	30	0	0
12	19318210	.	T	C	17	10	27	0	3	30	0	0
12	19318441	.	A	T	4	6	10	0	0	10	0	0
12	19318475	.	G	A	5	3	8	0	0	8	0	0
12	19318487	.	C	A	2	4	6	0	0	6	0	0
12	19318539	.	G	A	3	13	16	0	0	16	0	0
12	19318615	.	A	T	13	9	22	0	2	24	0	0
12	19318823	.	A	G	8	0	8	0	10	18	0	0
12	19318855	.	C	T	13	16	29	0	0	29	0	0
12	19319085	.	T	G	2	4	6	0	0	6	0	0
12	19319105	.	C	T	3	4	7	0	0	7	0	0
12	19319123	.	A	C	5	2	7	0	1	8	0	0
12	19320741	.	G	A	9	5	14	0	0	14	0	0
12	19320778	.	G	A	8	6	14	0	1	15	0	0
12	19320821	.	C	A	3	5	8	0	1	9	0	0
12	19323174	.	A	C	4	2	6	0	2	8	0	0
12	19333787	.	G	T	3	2	5	0	0	5	0	0
12	19337850	.	G	A	7	9	16	0	1	17	0	0
12	19338003	.	G	T	6	6	12	0	0	12	0	0
12	19338032	.	T	A	5	9	14	0	1	15	0	0
12	19338060	.	C	A	4	7	11	0	0	11	0	0
12	19338127	.	G	C	4	2	6	0	0	6	0	0
12	19338280	.	G	A	3	9	12	0	0	12	0	0
12	19338387	.	T	G	9	7	16	0	1	17	0	0
12	19338935	.	T	C	2	2	4	0	0	4	0	0
12	19339403	.	C	A	6	4	10	0	0	10	0	0
12	19339490	.	T	A	6	4	10	0	0	10	0	0
12	19339492	.	C	T	6	4	10	0	0	10	0	0
12	19341869	.	G	A	21	14	35	0	0	35	0	0
12	19348622	.	A	G	19	25	44	0	1	45	0	0
12	19348678	.	T	C	13	31	44	0	1	45	0	0
12	19353091	.	C	T	18	21	39	0	1	40	0	0
12	19353174	.	C	T	17	11	28	0	1	29	0	0
12	19353203	.	A	C	20	8	28	0	0	28	0	0
12	19353513	.	A	G	12	12	24	1	2	27	0	0
12	19353622	.	A	T	16	12	28	0	0	29	1	0
12	19362426	.	T	C	10	8	18	0	2	20	0	0
12	19362500	.	C	T	8	5	13	0	0	13	0	0
12	19362624	.	A	G	6	9	15	0	1	16	0	0
12	19369292	.	G	A	17	12	29	0	0	29	0	0
12	19369414	.	A	G	11	11	22	0	1	23	0	0
12	19371801	.	A	G	11	0	11	0	12	23	0	0
12	19373175	.	G	A	11	8	19	0	1	20	0	0
12	19375729	.	T	C	5	16	21	0	1	22	0	0
12	19375741	.	C	T	5	15	20	0	1	21	0	0
12	19379564	.	G	C	0	12	12	0	15	27	0	0
12	19379642	.	C	T	11	6	17	0	1	18	0	0
12	19380120	.	A	G	10	7	17	0	0	17	0	0
12	19383137	.	A	G	10	9	19	0	0	19	0	0
12	19383139	.	T	C	7	9	16	0	0	16	0	0
12	19383217	.	T	C	9	8	17	0	1	18	0	0
12	19383242	.	T	A	7	6	13	0	1	14	0	0
12	19383260	.	A	T	6	6	12	0	1	13	0	0
12	19383417	.	T	C	9	11	20	0	2	22	0	0
12	19383539	.	C	T	8	5	13	0	2	15	0	0
12	19383843	.	G	A	6	3	9	0	1	10	0	0
12	19385072	.	G	A	8	10	18	0	0	18	0	0
12	19385287	.	T	C	4	6	10	0	1	11	0	0
12	19385664	.	C	T	4	8	12	0	0	12	0	0
12	19393795	.	A	G	4	2	6	0	0	6	0	0
12	19393845	.	T	G	1	0	1	0	3	4	0	0
12	19393863	.	A	G	1	2	3	0	0	3	0	0
12	19408489	.	A	T	1	2	3	0	0	3	0	0
12	19408503	.	A	G	1	3	4	0	0	4	0	0
12	19408650	.	G	T	0	2	2	0	6	8	0	0
12	19412850	.	C	T	4	5	9	0	0	9	0	0
12	19419880	.	C	T	1	5	6	0	1	7	0	0
12	19422112	.	C	T	1	2	3	0	1	4	0	0
12	19422124	.	G	A	1	4	5	0	0	5	0	0
12	19422271	.	T	C	4	7	11	0	0	11	0	0
12	19422319	.	T	C	6	4	10	0	0	10	0	0
12	19422410	.	G	A	2	5	7	0	8	15	0	0
12	19430068	.	G	A	1	6	7	0	7	14	0	0
12	19433953	.	T	C	6	4	10	0	0	10	0	0
12	19637039	.	T	G	9	7	16	0	4	20	0	0
12	19658488	.	G	T	5	3	8	0	1	9	0	0
12	19658505	.	T	C	7	2	9	0	2	11	0	0
12	19658587	.	A	G	1	4	5	0	0	5	0	0
12	19658626	.	C	T	3	6	9	0	0	9	0	0
12	19658691	.	A	G	7	0	7	0	10	17	0	0
12	19658735	.	A	T	6	9	15	0	0	15	0	0
12	19658836	.	G	A	11	6	17	0	0	17	0	0
12	19792566	.	T	C	7	6	13	0	1	14	0	0
12	19792945	.	C	G	11	8	19	0	2	21	0	0
12	19792970	.	G	A	17	8	25	0	0	25	0	0
12	19793001	.	G	A	24	7	31	0	1	32	0	0
12	19793039	.	T	A	20	7	27	0	1	28	0	0
12	19793470	.	C	G	14	16	30	0	0	30	0	0
12	19793534	.	T	A	19	19	38	0	1	39	0	0
12	19793657	.	G	A	24	9	33	0	0	33	0	0
12	19793693	.	A	G	17	6	23	0	0	23	0	0
12	19865090	.	T	C	13	0	13	0	15	28	0	0
12	19865347	.	C	T	14	16	30	0	2	32	0	0
12	19865567	.	G	A	6	10	16	0	2	18	0	0
12	19866983	.	A	G	6	3	9	0	0	9	0	0
12	19907100	.	A	T	5	2	7	0	0	7	0	0
12	19931421	.	T	C	4	7	11	0	0	11	0	0
12	19931653	.	T	A	4	2	6	0	0	6	0	0
12	19932122	.	C	A	3	2	5	0	1	7	1	0
12	19932195	.	A	T	2	4	6	0	1	7	0	0
12	19959088	.	C	A	1	2	3	0	0	3	0	0
12	19967552	.	A	G	3	3	6	0	0	6	0	0
12	19967554	.	A	G	3	3	6	0	0	6	0	0
12	19970187	.	T	C	2	3	5	0	0	5	0	0
12	19970250	.	G	A	1	4	5	0	0	5	0	0
12	19973531	.	A	G	2	0	2	0	4	6	0	0
12	19973564	.	T	C	2	3	5	0	0	5	0	0
12	19973939	.	A	G	1	1	2	0	3	5	0	0
12	19973942	.	A	G	1	3	4	0	0	4	0	0
12	19974092	.	G	A	2	11	13	0	2	15	0	0
12	19974196	.	G	A	3	5	8	0	0	8	0	0
12	19992114	.	T	A	3	3	6	0	0	6	0	0
12	19992192	.	A	T	1	3	4	0	0	4	0	0
12	20018682	.	A	T	1	5	6	0	0	6	0	0
12	20025633	.	C	T	5	2	7	0	1	8	0	0
12	20026573	.	T	G	3	8	11	0	0	11	0	0
12	20026597	.	G	A	5	7	12	0	0	12	0	0
12	20029667	.	T	C	8	4	12	0	1	13	0	0
12	20029874	.	C	T	5	2	7	0	1	8	0	0
12	20034735	.	T	C	11	5	16	0	1	17	0	0
12	20034744	.	T	C	11	6	17	0	0	17	0	0
12	20036061	.	T	G	7	1	8	0	5	13	0	0
12	20036100	.	C	T	7	2	9	0	1	10	0	0
12	20036106	.	A	G	6	3	9	0	0	9	0	0
12	20040321	.	C	A	4	6	10	0	0	10	0	0
12	20043897	.	G	C	8	6	14	0	0	14	0	0
12	20043971	.	C	T	3	6	9	0	0	9	0	0
12	20044661	.	C	T	2	8	10	0	0	10	0	0
12	20044684	.	T	A	2	5	7	0	1	8	0	0
12	20044989	.	C	G	1	2	3	0	0	3	0	0
12	20045067	.	G	T	0	2	2	0	5	7	0	0
12	20045068	.	T	C	5	2	7	0	0	7	0	0
12	20099085	.	A	G	13	9	22	0	1	23	0	0
12	20099478	.	A	G	14	18	32	0	0	32	0	0
12	20099657	.	T	C	9	13	22	1	0	23	0	0
12	20099708	.	T	A	13	14	27	0	0	27	0	0
12	20100109	.	A	G	16	17	33	0	0	33	0	0
12	20100169	.	A	G	16	24	40	0	2	42	0	0
12	20100190	.	T	C	11	0	11	0	24	35	0	0
12	20100391	.	G	A	21	21	42	0	1	43	0	0
12	20122600	.	G	C	10	7	17	0	0	17	0	0
12	20122709	.	A	T	13	5	18	0	1	19	0	0
12	20122785	.	T	C	12	16	28	0	0	28	0	0
12	20123320	.	G	A	8	7	15	0	1	16	0	0
12	20123881	.	A	C	9	9	18	0	1	19	0	0
12	20125561	.	A	G	10	0	10	0	6	17	1	0
12	20145111	.	A	C	10	7	17	0	3	20	0	0
12	20147049	.	G	A	14	3	17	0	1	18	0	0
12	20147218	.	G	C	19	11	30	0	1	31	0	0
12	20147229	.	A	G	19	6	25	0	1	26	0	0
12	20147260	.	G	A	21	7	28	0	0	28	0	0
12	20147428	.	G	A	15	15	30	0	1	31	0	0
12	20147486	.	A	G	12	0	12	0	18	30	0	0
12	20147504	.	T	C	16	12	28	0	1	29	0	0
12	20147564	.	A	T	8	10	18	0	5	23	0	0
12	20156045	.	T	C	1	2	3	0	0	3	0	0
12	20156168	.	G	A	0	4	4	0	1	5	0	0
12	20156177	.	G	A	2	3	5	0	0	5	0	0
12	20227766	.	C	T	0	4	4	0	2	6	0	0
12	20231828	.	T	C	2	2	4	0	0	4	0	0
12	20241687	.	C	T	3	2	5	0	0	5	0	0
12	20251213	.	T	C	3	2	5	0	0	5	0	0
12	20263906	.	G	A	1	2	3	0	0	3	0	0
12	20263933	.	G	A	3	2	5	0	0	5	0	0
12	20263948	.	C	A	1	2	3	0	2	5	0	0
12	20336821	.	A	G	1	2	3	0	0	3	0	0
12	20379356	.	A	C	2	2	4	0	0	4	0	0
12	20379586	.	G	C	6	9	15	0	0	15	0	0
12	20380050	.	C	G	9	14	23	0	1	24	0	0
12	20396459	.	T	A	17	8	25	0	0	25	0	0
12	20406815	.	T	C	13	1	14	0	8	22	0	0
12	20406818	.	G	A	15	7	22	0	0	22	0	0
12	20407789	.	A	G	15	5	20	0	0	20	0	0
12	20409495	.	G	T	7	5	12	0	2	14	0	0
12	20409523	.	A	G	11	10	21	0	0	21	0	0
12	20409585	.	G	C	3	0	3	0	7	10	0	0
12	20409600	.	A	G	3	6	9	0	0	9	0	0
12	20409680	.	T	A	7	10	17	0	2	19	0	0
12	20478367	.	T	C	2	3	5	0	0	5	0	0
12	20478509	.	G	A	3	4	7	0	3	10	0	0
12	20605682	.	C	T	2	10	12	0	1	13	0	0
12	20607308	.	C	T	5	6	11	0	0	11	0	0
12	20607417	.	C	T	7	3	10	0	0	10	0	0
12	20607515	.	G	A	6	6	12	0	1	13	0	0
12	20608370	.	T	A	8	12	20	0	0	20	0	0
12	20608397	.	G	A	7	13	20	0	1	21	0	0
12	20608518	.	C	T	8	6	14	0	1	15	0	0
12	20639413	.	T	A	5	3	8	0	0	8	0	0
12	20639423	.	A	T	8	0	8	0	1	9	0	0
12	20651441	.	G	A	1	2	3	0	0	3	0	0
12	20651602	.	G	A	1	2	3	0	0	3	0	0
12	20652626	.	A	T	4	2	6	0	0	6	0	0
12	20652771	.	G	T	1	3	4	0	0	4	0	0
12	20653244	.	A	T	4	4	8	0	0	8	0	0
12	20653301	.	T	C	7	0	7	0	6	13	0	0
12	20658037	.	T	C	6	8	14	0	0	14	0	0
12	20676252	.	C	T	9	3	12	0	0	12	0	0
12	20677092	.	G	T	5	2	7	0	0	7	0	0
12	20677125	.	T	C	1	5	6	0	0	6	0	0
12	20677184	.	A	T	11	3	14	0	0	14	0	0
12	20677202	.	C	A	9	4	13	0	1	14	0	0
12	20677706	.	T	A	3	3	6	0	0	6	0	0
12	20677745	.	T	A	2	2	4	0	0	4	0	0
12	20766473	.	A	C	2	2	4	0	0	4	0	0
12	20772675	.	C	G	3	0	3	0	2	5	0	0
12	20777733	.	C	T	1	4	5	0	0	5	0	0
12	21298583	.	G	A	3	2	5	0	0	5	0	0
12	21539855	.	T	C	17	20	37	0	0	37	0	0
12	21549172	.	G	A	9	13	22	2	7	31	0	0
12	21687757	.	T	C	15	10	25	0	3	28	0	0
12	21799194	.	G	T	8	3	11	0	0	11	0	0
12	21818634	.	C	T	2	3	5	0	0	5	0	0
12	21823489	.	G	A	2	4	6	0	0	6	0	0
12	21823522	.	C	T	8	4	12	0	0	12	0	0
12	22237404	.	C	T	1	2	3	0	5	8	0	0
12	22310722	.	T	C	1	4	5	0	0	5	0	0
12	22311500	.	G	A	3	2	5	0	1	6	0	0
12	22339573	.	A	G	2	2	4	0	1	5	0	0
12	22348410	.	G	A	2	2	4	0	0	4	0	0
12	22373296	.	A	G	1	4	5	0	0	5	0	0
12	22378798	.	A	G	1	3	4	0	0	4	0	0
12	22378802	.	C	T	0	2	2	0	2	4	0	0
12	22379066	.	C	T	1	2	3	0	0	3	0	0
12	22379174	.	C	T	0	2	2	0	1	3	0	0
12	22379189	.	T	C	1	0	1	0	3	4	0	0
12	22396412	.	G	T	2	4	6	0	0	6	0	0
12	22404144	.	A	C	3	6	9	0	0	9	0	0
12	22407867	.	G	C	2	5	7	0	0	7	0	0
12	22407920	.	G	A	5	6	11	0	0	11	0	0
12	22409332	.	G	A	5	3	8	0	3	11	0	0
12	22410014	.	C	T	5	7	12	0	0	12	0	0
12	22410077	.	G	T	4	7	11	0	0	11	0	0
12	22412290	.	T	C	5	7	12	0	0	12	0	0
12	22412630	.	A	G	7	5	12	0	0	12	0	0
12	22415825	.	A	G	4	6	10	0	0	10	0	0
12	22415880	.	T	C	1	5	6	0	0	6	0	0
12	22418297	.	T	C	9	11	20	0	0	20	0	0
12	22420645	.	A	G	8	6	14	0	1	15	0	0
12	22420669	.	T	C	11	9	20	0	1	21	0	0
12	22431304	.	G	A	8	9	17	0	1	18	0	0
12	22433246	.	G	A	0	2	2	0	9	11	0	0
12	22435203	.	T	C	8	12	20	0	1	21	0	0
12	22437160	.	T	C	8	7	15	0	0	15	0	0
12	22444470	.	C	T	6	6	12	0	0	12	0	0
12	22444613	.	A	T	7	6	13	0	0	13	0	0
12	22450848	.	T	C	2	4	6	0	2	8	0	0
12	22451304	.	T	C	7	5	12	0	2	14	0	0
12	22451811	.	A	G	2	16	18	0	1	19	0	0
12	22456934	.	A	G	9	9	18	0	0	18	0	0
12	22460101	.	C	G	10	7	17	0	0	17	0	0
12	22460316	.	G	T	4	11	15	0	1	16	0	0
12	22462021	.	C	G	0	12	12	0	9	21	0	0
12	22467995	.	C	T	5	10	15	0	1	16	0	0
12	22468075	.	G	A	5	3	8	0	1	9	0	0
12	22468118	.	A	T	4	5	9	0	0	9	0	0
12	22468286	.	C	G	1	7	8	0	1	9	0	0
12	22470282	.	T	C	5	9	14	0	0	14	0	0
12	22470303	.	T	C	4	6	10	0	0	10	0	0
12	22471139	.	G	A	8	8	16	0	0	16	0	0
12	22473380	.	C	G	6	6	12	1	0	13	0	0
12	22473434	.	T	C	7	6	13	1	1	15	0	0
12	22473640	.	A	G	2	3	5	0	0	5	0	0
12	22473736	.	G	A	9	7	16	0	0	16	0	0
12	22480599	.	A	G	5	12	17	0	0	17	0	0
12	22480610	.	A	G	6	8	14	0	2	16	0	0
12	22480850	.	T	C	6	9	15	0	1	16	0	0
12	22480862	.	T	C	7	7	14	0	2	16	0	0
12	22480955	.	C	A	10	5	15	0	0	15	0	0
12	22481012	.	C	T	10	3	13	0	0	13	0	0
12	22487415	.	T	C	8	7	15	0	3	18	0	0
12	22487472	.	T	C	7	0	7	0	8	15	0	0
12	22528869	.	G	A	19	13	32	0	0	32	0	0
12	22529407	.	C	T	18	22	40	0	1	41	0	0
12	22529456	.	T	G	10	27	37	0	5	42	0	0
12	22529457	.	A	C	10	31	41	0	1	42	0	0
12	22529560	.	T	A	30	25	55	0	1	56	0	0
12	22529655	.	C	G	19	22	41	0	1	42	0	0
12	22530053	.	A	G	10	13	23	0	2	25	0	0
12	22530056	.	G	A	9	14	23	0	2	25	0	0
12	22530352	.	G	A	18	24	42	0	2	44	0	0
12	22530362	.	C	T	1	23	24	0	23	47	0	0
12	22530849	.	C	G	15	16	31	0	0	31	0	0
12	22531212	.	T	A	15	17	32	0	1	33	0	0
12	22531505	.	A	T	16	10	26	0	1	27	0	0
12	22531929	.	T	A	16	22	38	0	1	39	0	0
12	22532594	.	C	T	29	14	43	0	9	52	0	0
12	22532595	.	G	A	19	30	49	0	4	53	0	0
12	22533054	.	G	A	16	20	36	0	1	37	0	0
12	22533806	.	C	T	1	13	14	0	24	38	0	0
12	22533908	.	G	A	21	10	31	0	0	31	0	0
12	22534383	.	A	G	20	15	35	0	1	37	1	0
12	22534389	.	T	C	22	0	22	0	17	39	0	0
12	22535197	.	A	G	18	24	42	0	3	45	0	0
12	22535380	.	C	T	0	15	15	0	9	24	0	0
12	22535498	.	T	C	15	16	31	0	0	31	0	0
12	22535546	.	A	T	25	15	40	0	2	42	0	0
12	22535567	.	T	C	28	13	41	0	1	42	0	0
12	22535631	.	T	G	17	17	34	0	0	34	0	0
12	22536188	.	C	T	2	14	16	0	16	32	0	0
12	22536609	.	T	G	25	20	45	0	1	46	0	0
12	22536621	.	G	C	28	22	50	0	0	50	0	0
12	22536969	.	C	T	19	12	31	0	2	33	0	0
12	22561889	.	A	C	5	7	12	0	1	13	0	0
12	22562509	.	T	C	9	6	15	0	0	15	0	0
12	22562581	.	T	C	5	9	14	0	0	14	0	0
12	22562808	.	C	T	3	3	6	0	0	6	0	0
12	22562906	.	G	A	4	4	8	0	2	10	0	0
12	22563882	.	T	C	9	7	16	0	0	16	0	0
12	22565015	.	T	C	6	3	9	0	0	9	0	0
12	22565764	.	A	G	3	2	5	0	3	8	0	0
12	22565857	.	G	T	8	2	10	0	2	12	0	0
12	22565860	.	C	T	7	4	11	0	0	11	0	0
12	22566413	.	A	G	4	9	13	0	0	13	0	0
12	22566434	.	A	T	4	9	13	0	1	14	0	0
12	22570814	.	T	C	11	19	30	0	4	34	0	0
12	22571368	.	G	C	6	6	12	0	0	12	0	0
12	22571628	.	G	A	11	3	14	0	0	14	0	0
12	22572199	.	C	G	16	17	33	0	0	33	0	0
12	22572287	.	A	C	20	12	32	0	1	33	0	0
12	22572367	.	C	T	10	16	26	0	1	27	0	0
12	22572585	.	G	A	15	20	35	0	0	35	0	0
12	22572650	.	T	C	13	6	19	0	1	20	0	0
12	22572660	.	G	A	12	9	21	0	0	21	0	0
12	22572756	.	C	T	8	13	21	0	1	22	0	0
12	22572814	.	A	G	6	0	6	0	8	14	0	0
12	22572937	.	C	T	11	14	25	4	0	29	0	0
12	22573080	.	T	A	16	10	26	0	0	26	0	0
12	22573185	.	G	A	3	3	6	0	0	6	0	0
12	22628775	.	A	C	7	4	11	0	1	12	0	0
12	22628829	.	T	C	3	5	8	0	0	8	0	0
12	22628983	.	G	A	3	4	7	0	0	7	0	0
12	22630471	.	G	A	5	4	9	1	0	10	0	0
12	22634783	.	T	C	3	3	6	0	0	6	0	0
12	22634817	.	C	T	4	2	6	0	0	6	0	0
12	22634834	.	C	T	2	2	4	0	2	6	0	0
12	22640923	.	T	C	5	3	8	0	0	8	0	0
12	22643876	.	T	C	6	4	10	0	1	11	0	0
12	22644208	.	T	C	2	2	4	0	0	4	0	0
12	22644406	.	C	T	4	5	9	0	0	9	0	0
12	22644429	.	T	C	2	3	5	0	0	5	0	0
12	22644687	.	T	G	8	9	17	0	0	17	0	0
12	22644800	.	G	A	2	3	5	0	1	6	0	0
12	22648423	.	A	T	1	2	3	0	0	3	0	0
12	22652631	.	C	T	4	2	6	0	0	6	0	0
12	22656921	.	T	A	2	2	4	0	0	4	0	0
12	22656939	.	G	A	2	2	4	0	0	4	0	0
12	22668050	.	T	G	1	1	2	0	1	3	0	0
12	22670217	.	A	T	4	5	9	0	0	9	0	0
12	22680352	.	C	A	4	8	12	0	0	12	0	0
12	22774261	.	C	T	6	5	11	0	0	11	0	0
12	22774439	.	A	G	7	7	14	0	0	14	0	0
12	22774778	.	C	T	10	8	18	0	0	18	0	0
12	22774793	.	C	T	10	5	15	0	0	15	0	0
12	22785874	.	G	A	0	7	7	0	10	17	0	0
12	22800097	.	A	G	11	18	29	0	0	29	0	0
12	22803813	.	C	T	13	8	21	0	0	21	0	0
12	22809614	.	C	T	18	7	25	0	0	25	0	0
12	22814990	.	T	C	13	13	26	0	1	27	0	0
12	22815097	.	T	C	12	8	20	0	0	20	0	0
12	22815203	.	G	A	13	9	22	0	1	23	0	0
12	22815365	.	C	T	16	8	24	0	0	24	0	0
12	22815724	.	G	T	9	10	19	0	0	19	0	0
12	22815767	.	A	T	8	10	18	0	0	18	0	0
12	22895639	.	C	T	2	2	4	0	1	5	0	0
12	22907660	.	T	A	2	2	4	0	0	4	0	0
12	22907997	.	C	T	3	4	7	0	0	7	0	0
12	22915400	.	A	G	2	5	7	0	0	7	0	0
12	22915433	.	T	C	2	4	6	0	0	6	0	0
12	22932087	.	C	T	14	8	22	0	0	22	0	0
12	22932090	.	G	C	14	8	22	0	0	22	0	0
12	22932674	.	T	A	10	10	20	0	0	20	0	0
12	22932675	.	A	T	11	9	20	0	1	21	0	0
12	22932852	.	G	T	1	8	9	0	12	21	0	0
12	22932875	.	G	T	15	11	26	0	0	26	0	0
12	22962211	.	A	T	5	4	9	0	0	9	0	0
12	22962781	.	G	A	5	5	10	0	2	12	0	0
12	22962864	.	G	A	2	5	7	0	0	7	0	0
12	22963141	.	G	C	2	5	7	0	0	7	0	0
12	22963242	.	G	A	2	5	7	0	0	7	0	0
12	22963308	.	C	T	0	5	5	0	1	6	0	0
12	22963309	.	G	A	1	5	6	0	0	6	0	0
12	22991383	.	C	T	0	2	2	0	1	3	0	0
12	23001466	.	G	A	2	3	5	0	0	5	0	0
12	23008540	.	C	A	4	7	11	0	1	12	0	0
12	23009215	.	G	A	6	6	12	0	0	12	0	0
12	23385168	.	G	A	18	11	29	0	0	29	0	0
12	23389675	.	G	A	16	14	30	0	0	30	0	0
12	23400392	.	C	T	30	12	42	0	1	43	0	0
12	23411287	.	C	T	19	17	36	0	1	37	0	0
12	23415347	.	C	T	23	13	36	0	0	36	0	0
12	23415370	.	C	T	21	22	43	0	0	43	0	0
12	23415662	.	G	A	25	11	36	0	0	36	0	0
12	23415672	.	C	A	11	27	38	0	0	38	0	0
12	23429619	.	G	A	5	3	8	0	0	8	0	0
12	23429685	.	C	T	3	4	7	0	1	8	0	0
12	23665201	.	A	T	3	3	6	0	0	6	0	0
12	23665224	.	T	C	1	4	5	0	0	5	0	0
12	23665465	.	A	G	1	0	1	0	3	4	0	0
12	23674165	.	A	T	2	4	6	0	0	6	0	0
12	23784266	.	C	A	5	1	6	0	1	7	0	0
12	23786890	.	T	G	4	3	7	0	0	7	0	0
12	23787904	.	A	T	3	4	7	0	0	7	0	0
12	23789838	.	A	C	5	5	10	0	1	11	0	0
12	23793990	.	A	T	3	5	8	0	0	8	0	0
12	23794148	.	A	T	4	4	8	0	0	8	0	0
12	23794595	.	T	G	2	3	5	0	0	5	0	0
12	23794600	.	G	A	0	3	3	0	2	5	0	0
12	23794826	.	A	G	2	2	4	0	0	4	0	0
12	23794884	.	G	A	1	4	5	0	0	5	0	0
12	23795221	.	C	G	0	6	6	0	0	6	0	0
12	23795226	.	G	A	3	3	6	0	0	6	0	0
12	23925093	.	A	G	8	7	15	0	0	15	0	0
12	23991524	.	A	T	5	3	8	0	2	10	0	0
12	23995751	.	G	A	2	3	5	0	1	6	0	0
12	24005973	.	C	T	5	3	8	0	0	8	0	0
12	24007733	.	A	C	4	2	6	0	0	6	0	0
12	24014992	.	T	G	2	0	2	0	2	4	0	0
12	24018336	.	A	G	5	6	11	0	0	11	0	0
12	24022843	.	T	C	4	5	9	0	0	9	0	0
12	24023704	.	T	A	3	3	6	0	1	7	0	0
12	24023895	.	A	G	3	2	5	0	0	5	0	0
12	24024816	.	A	G	1	3	4	0	0	4	0	0
12	24027041	.	G	A	1	6	7	0	0	7	0	0
12	24030454	.	C	T	6	3	9	0	0	9	0	0
12	24030458	.	G	A	4	6	10	0	0	10	0	0
12	24034771	.	C	T	4	4	8	0	0	8	0	0
12	24041169	.	A	G	3	0	3	0	7	10	0	0
12	24041253	.	G	T	5	2	7	0	1	8	0	0
12	24041254	.	T	A	6	2	8	0	0	8	0	0
12	24041367	.	A	T	12	6	18	0	0	18	0	0
12	24041600	.	A	G	1	0	1	0	4	5	0	0
12	24043909	.	C	T	6	12	18	0	0	18	0	0
12	24043942	.	C	T	12	8	20	0	0	20	0	0
12	24051944	.	T	G	2	3	5	0	0	5	0	0
12	24052196	.	A	G	3	3	6	0	0	6	0	0
12	24052303	.	T	A	3	3	6	0	1	7	0	0
12	24052684	.	G	A	4	8	12	0	1	13	0	0
12	24056484	.	A	T	5	4	9	0	0	9	0	0
12	24056500	.	G	T	4	2	6	0	0	6	0	0
12	24056539	.	G	A	5	3	8	0	0	8	0	0
12	24056716	.	G	T	3	2	5	0	0	5	0	0
12	24057167	.	C	G	6	5	11	0	0	11	0	0
12	24057198	.	G	T	6	4	10	0	0	10	0	0
12	24057368	.	G	A	7	4	11	0	0	11	0	0
12	24060008	.	A	G	7	7	14	0	0	14	0	0
12	24061312	.	G	T	1	3	4	0	5	9	0	0
12	24070858	.	C	T	3	3	6	0	0	6	0	0
12	24342518	.	T	A	10	17	27	0	0	27	0	0
12	24342556	.	T	C	7	17	24	0	0	24	0	0
12	24345427	.	C	A	12	11	23	0	0	23	0	0
12	24345832	.	G	A	2	22	24	0	18	42	0	0
12	24447515	.	G	A	1	6	7	0	14	21	0	0
12	24465454	.	C	T	18	12	30	0	2	32	0	0
12	24465466	.	T	C	20	13	33	0	1	34	0	0
12	24465565	.	T	C	26	20	46	0	0	46	0	0
12	24465712	.	T	C	25	19	44	0	0	44	0	0
12	24465875	.	A	C	15	19	34	0	4	39	1	0
12	24484083	.	A	C	12	28	40	0	0	40	0	0
12	24484084	.	C	T	12	28	40	0	1	41	0	0
12	24484131	.	G	T	21	22	43	0	1	44	0	0
12	24484134	.	C	T	21	25	46	0	1	47	0	0
12	24484215	.	T	C	16	18	34	0	0	34	0	0
12	24562338	.	C	T	5	5	10	0	1	11	0	0
12	24562365	.	A	G	7	0	7	0	4	11	0	0
12	24562410	.	A	G	3	2	5	0	0	5	0	0
12	24606963	.	C	T	32	25	57	1	0	58	0	0
12	24607140	.	G	A	2	33	35	0	32	67	0	0
12	24607215	.	G	A	36	23	59	0	4	63	0	0
12	24635925	.	A	G	31	1	32	0	29	61	0	0
12	24636261	.	C	A	26	16	42	0	8	50	0	0
12	24636746	.	A	G	24	25	49	0	2	51	0	0
12	24636997	.	T	G	21	16	37	1	3	41	0	0
12	24637148	.	G	T	3	2	5	0	0	5	0	0
12	24796653	.	G	A	4	4	8	0	0	8	0	0
12	24796734	.	C	A	3	6	9	0	0	9	0	0
12	24797128	.	A	T	13	8	21	0	1	22	0	0
12	24797351	.	C	T	11	12	23	0	0	23	0	0
12	24797541	.	G	A	12	11	23	0	0	23	0	0
12	24797603	.	T	C	7	9	16	0	3	19	0	0
12	24797908	.	C	T	8	5	13	0	1	14	0	0
12	24797999	.	G	C	9	6	15	0	1	16	0	0
12	24798235	.	A	G	8	9	17	0	1	18	0	0
12	24798237	.	T	G	7	10	17	0	0	17	0	0
12	24798358	.	A	G	7	11	18	0	1	19	0	0
12	24811369	.	G	A	11	9	20	0	1	21	0	0
12	24811423	.	G	A	8	7	15	0	0	15	0	0
12	24811489	.	A	G	8	4	12	0	0	12	0	0
12	24832098	.	G	A	12	7	19	0	0	19	0	0
12	24842119	.	A	G	18	10	28	0	1	29	0	0
12	24842267	.	T	G	14	17	31	0	2	33	0	0
12	24842597	.	C	T	0	5	5	0	4	9	0	0
12	24843292	.	C	T	1	13	14	0	15	29	0	0
12	24848651	.	C	T	2	9	11	0	0	11	0	0
12	24848678	.	A	G	3	7	10	0	0	10	0	0
12	24848687	.	A	G	3	9	12	0	0	12	0	0
12	24848765	.	T	C	7	13	20	0	0	20	0	0
12	24857033	.	G	A	14	10	24	0	0	24	0	0
12	24904842	.	T	C	5	10	15	0	0	15	0	0
12	24906126	.	G	C	2	2	4	0	0	4	0	0
12	24910116	.	C	G	4	6	10	0	0	10	0	0
12	24910492	.	A	C	2	5	7	0	0	7	0	0
12	24910546	.	T	A	3	10	13	0	0	13	0	0
12	24913442	.	C	G	5	8	13	0	1	14	0	0
12	24913535	.	G	C	5	3	8	0	0	8	0	0
12	25094201	.	T	C	5	6	11	0	2	13	0	0
12	25094300	.	T	C	11	5	16	0	1	17	0	0
12	25094359	.	T	C	3	11	14	0	0	14	0	0
12	25094520	.	T	C	8	5	13	0	0	13	0	0
12	25210216	.	T	C	5	2	7	0	0	7	0	0
12	25483527	.	T	G	1	0	1	0	3	4	0	0
12	25768836	.	T	C	8	3	11	0	4	15	0	0
12	25829168	.	A	G	1	7	8	0	0	8	0	0
12	28072821	.	C	G	18	12	30	0	1	31	0	0
12	28948117	.	T	C	1	6	7	0	0	7	0	0
12	28949067	.	A	G	9	9	18	0	2	20	0	0
12	28949112	.	C	A	13	10	23	0	2	25	0	0
12	28950009	.	T	C	4	0	4	0	10	14	0	0
12	28950678	.	G	T	7	6	13	0	0	13	0	0
12	28951019	.	C	T	2	5	7	0	2	9	0	0
12	28952139	.	T	C	9	12	21	0	0	21	0	0
12	28955614	.	T	C	1	0	1	0	6	7	0	0
12	28956566	.	T	C	3	6	9	0	1	10	0	0
12	28956615	.	A	G	2	9	11	0	0	11	0	0
12	28958631	.	A	G	1	2	3	0	0	3	0	0
12	28959267	.	T	A	2	2	4	0	0	4	0	0
12	28959298	.	C	T	3	2	5	0	0	5	0	0
12	28960284	.	T	C	5	4	9	0	0	9	0	0
12	28960321	.	G	A	3	1	4	0	4	8	0	0
12	28960357	.	G	A	0	3	3	0	4	7	0	0
12	28960441	.	C	T	1	2	3	0	0	3	0	0
12	29054940	.	A	G	4	2	6	0	0	6	0	0
12	29054941	.	A	G	2	3	5	0	1	6	0	0
12	29055068	.	A	T	3	5	8	0	0	8	0	0
12	29063312	.	C	T	16	10	26	0	0	26	0	0
12	29063346	.	G	A	16	11	27	0	1	28	0	0
12	29084032	.	T	C	16	15	31	0	1	32	0	0
12	29102585	.	T	C	11	11	22	0	3	25	0	0
12	29103004	.	T	C	5	4	9	0	1	10	0	0
12	29103041	.	T	A	7	5	12	0	0	12	0	0
12	29173678	.	C	G	5	5	10	0	1	11	0	0
12	29173712	.	T	C	4	3	7	0	1	8	0	0
12	29207473	.	G	A	0	3	3	0	6	9	0	0
12	29207533	.	T	C	2	6	8	0	0	8	0	0
12	29207590	.	G	A	0	9	9	0	4	13	0	0
12	29207683	.	G	T	10	13	23	0	1	25	1	0
12	29208099	.	T	G	6	13	19	0	1	20	0	0
12	29209834	.	G	A	3	3	6	0	2	8	0	0
12	29209840	.	A	T	4	4	8	0	0	8	0	0
12	29209947	.	T	G	1	3	4	0	0	4	0	0
12	29210371	.	C	A	9	8	17	0	0	17	0	0
12	29210435	.	C	G	13	4	17	0	0	17	0	0
12	29210600	.	C	T	12	7	19	0	0	19	0	0
12	29210719	.	T	A	12	12	24	0	0	24	0	0
12	29210873	.	T	A	8	4	12	0	0	12	0	0
12	29210917	.	T	C	7	5	12	0	1	13	0	0
12	29211082	.	G	A	2	5	7	0	1	8	0	0
12	29211195	.	T	A	11	11	22	0	1	23	0	0
12	29211232	.	G	A	0	12	12	0	10	22	0	0
12	29211289	.	T	A	12	13	25	0	0	25	0	0
12	29211292	.	A	G	10	13	23	0	1	24	0	0
12	29223498	.	A	G	6	3	9	0	1	10	0	0
12	29223921	.	G	A	5	3	8	0	0	8	0	0
12	29223969	.	A	T	3	4	7	0	0	7	0	0
12	29224065	.	G	A	2	2	4	0	0	4	0	0
12	29224836	.	A	T	1	3	4	0	0	4	0	0
12	29226152	.	T	C	8	2	10	0	1	11	0	0
12	29226573	.	A	T	3	2	5	0	0	5	0	0
12	29226752	.	T	A	4	3	7	0	0	7	0	0
12	29226876	.	C	A	2	3	5	0	1	6	0	0
12	29227044	.	G	A	4	2	6	0	0	6	0	0
12	29227350	.	G	T	1	3	4	0	0	4	0	0
12	29229047	.	G	C	1	2	3	0	0	3	0	0
12	29229299	.	A	G	2	2	4	0	0	4	0	0
12	29233284	.	C	T	3	4	7	0	1	8	0	0
12	29240142	.	T	A	2	2	4	0	0	4	0	0
12	29241126	.	T	G	1	3	4	0	1	5	0	0
12	29244329	.	G	A	1	2	3	0	2	5	0	0
12	29244332	.	C	T	4	1	5	0	0	5	0	0
12	29251251	.	T	C	5	7	12	0	0	12	0	0
12	29251385	.	A	G	4	5	9	0	0	9	0	0
12	29251408	.	T	C	5	5	10	0	0	10	0	0
12	29258629	.	G	T	2	3	5	0	0	5	0	0
12	29262564	.	A	G	2	0	2	0	3	5	0	0
12	29266917	.	T	C	8	9	17	0	0	17	0	0
12	29269689	.	G	A	5	5	10	0	1	11	0	0
12	29269695	.	A	G	4	0	4	0	5	9	0	0
12	29269726	.	C	G	4	4	8	0	0	8	0	0
12	29269770	.	G	T	0	8	8	0	5	13	0	0
12	29269774	.	T	G	5	7	12	0	0	12	0	0
12	29351320	.	A	G	15	14	29	0	3	32	0	0
12	29351810	.	A	G	21	14	35	0	1	36	0	0
12	29358277	.	T	C	14	12	26	1	0	27	0	0
12	29358370	.	G	C	16	0	16	0	13	30	1	0
12	29358384	.	A	G	20	6	26	0	0	26	0	0
12	29358418	.	A	G	11	7	18	0	0	18	0	0
12	29624017	.	G	A	17	22	39	0	0	39	0	0
12	29624272	.	C	A	8	6	14	0	0	14	0	0
12	29624611	.	T	C	5	0	5	0	10	15	0	0
12	29764201	.	C	T	5	3	8	0	1	9	0	0
12	29764222	.	G	T	1	3	4	0	2	6	0	0
12	29801179	.	T	C	6	4	10	0	1	11	0	0
12	29806358	.	C	G	2	0	2	0	9	11	0	0
12	29843460	.	A	G	11	15	26	0	0	26	0	0
12	29844434	.	T	C	8	10	18	0	1	19	0	0
12	29873273	.	C	G	16	12	28	1	1	30	0	0
12	29921114	.	T	G	12	13	25	0	1	26	0	0
12	29947132	.	A	G	10	13	23	0	0	23	0	0
12	29947147	.	C	A	10	14	24	0	0	24	0	0
12	29957074	.	C	T	15	9	24	0	1	25	0	0
12	29957164	.	C	T	11	10	21	0	0	21	0	0
12	29965655	.	G	A	10	8	18	0	0	18	0	0
12	29965724	.	G	A	8	9	17	0	0	17	0	0
12	29965928	.	C	T	5	10	15	0	1	16	0	0
12	29965967	.	G	A	9	8	17	0	1	18	0	0
12	29966039	.	T	C	9	8	17	0	1	18	0	0
12	29966048	.	T	C	8	0	8	0	11	19	0	0
12	29968087	.	T	C	12	0	12	0	19	31	0	0
12	29973800	.	G	A	7	6	13	0	1	14	0	0
12	29973852	.	A	C	4	0	4	0	10	14	0	0
12	29976936	.	G	A	10	5	15	0	0	15	0	0
12	29976978	.	T	C	9	13	22	0	0	22	0	0
12	30031290	.	C	A	5	3	8	0	0	8	0	0
12	30031293	.	T	C	2	5	7	0	1	8	0	0
12	30031336	.	T	C	6	4	10	0	1	11	0	0
12	30031338	.	G	A	7	4	11	0	0	11	0	0
12	30031677	.	T	C	6	8	14	0	0	14	0	0
12	30031680	.	T	C	6	8	14	0	0	14	0	0
12	30129351	.	C	T	3	8	11	0	1	12	0	0
12	30153676	.	G	A	0	3	3	0	5	8	0	0
12	30153772	.	T	C	5	6	11	0	1	12	0	0
12	30156449	.	T	C	8	7	15	0	0	15	0	0
12	30156540	.	G	A	0	5	5	0	7	12	0	0
12	30192526	.	A	T	9	9	18	0	1	19	0	0
12	30200741	.	C	T	19	9	28	0	0	28	0	0
12	30207912	.	G	A	12	7	19	1	1	21	0	0
12	30208905	.	T	C	4	8	12	0	1	13	0	0
12	30211165	.	T	A	8	13	21	0	0	21	0	0
12	30216034	.	C	A	5	3	8	0	0	8	0	0
12	30216248	.	C	T	8	7	15	0	1	16	0	0
12	30216436	.	T	C	4	7	11	0	0	11	0	0
12	30216693	.	C	T	3	2	5	0	1	6	0	0
12	30216697	.	G	A	0	3	3	0	2	6	1	0
12	30217423	.	T	C	2	3	5	0	1	6	0	0
12	30217705	.	G	A	0	7	7	0	10	17	0	0
12	30217747	.	C	T	8	5	13	0	0	13	0	0
12	30217782	.	T	G	6	2	8	0	0	8	0	0
12	30217783	.	C	A	2	6	8	0	0	8	0	0
12	30217893	.	C	A	2	6	8	0	0	8	0	0
12	30217898	.	T	A	2	6	8	0	0	8	0	0
12	30217966	.	G	A	4	2	6	0	1	7	0	0
12	30217986	.	C	T	4	3	7	0	1	8	0	0
12	30218135	.	C	A	7	4	11	0	0	11	0	0
12	30218150	.	G	A	7	6	13	0	0	13	0	0
12	30218173	.	C	T	10	7	17	0	0	17	0	0
12	30219306	.	A	T	14	12	26	0	5	31	0	0
12	30219687	.	T	A	6	6	12	2	0	14	0	0
12	30219694	.	A	T	5	6	11	2	0	13	0	0
12	30219739	.	G	A	6	3	9	0	0	9	0	0
12	30219804	.	C	T	9	10	19	2	1	22	0	0
12	30292463	.	A	G	1	0	1	0	6	7	0	0
12	30299073	.	C	T	2	6	8	0	0	8	0	0
12	30302941	.	A	T	3	14	17	0	0	17	0	0
12	30303081	.	C	A	2	4	6	0	0	6	0	0
12	30304883	.	C	T	4	6	10	0	0	10	0	0
12	30304909	.	A	G	9	3	12	0	0	12	0	0
12	30305983	.	T	C	4	13	17	0	0	17	0	0
12	30307010	.	C	T	3	7	10	0	1	11	0	0
12	30372463	.	G	A	0	6	6	0	5	11	0	0
12	30372763	.	G	A	5	5	10	0	0	10	0	0
12	30373026	.	T	C	3	2	5	0	0	5	0	0
12	30382341	.	C	T	5	12	17	0	0	17	0	0
12	30383960	.	G	A	0	10	10	0	4	14	0	0
12	30385562	.	C	T	7	7	14	0	0	14	0	0
12	30391136	.	G	A	5	7	12	0	2	14	0	0
12	30418108	.	T	C	14	9	23	0	0	23	0	0
12	30418513	.	C	G	9	9	18	0	2	20	0	0
12	30419123	.	A	T	6	7	13	0	4	17	0	0
12	30419134	.	C	A	5	9	14	0	1	15	0	0
12	30419260	.	T	G	12	8	20	0	1	21	0	0
12	30419646	.	T	C	8	10	18	0	0	18	0	0
12	30419655	.	T	C	8	7	15	0	1	16	0	0
12	30419695	.	T	C	4	8	12	0	0	12	0	0
12	30419727	.	A	G	2	8	10	0	0	10	0	0
12	30442406	.	C	A	7	11	18	0	0	18	0	0
12	30442783	.	G	A	7	9	16	0	0	16	0	0
12	30443462	.	T	C	8	6	14	0	2	16	0	0
12	30459404	.	G	A	2	4	6	0	0	6	0	0
12	30460333	.	C	A	6	3	9	0	0	9	0	0
12	30461218	.	G	A	4	3	7	0	0	7	0	0
12	30467573	.	G	A	2	3	5	0	0	5	0	0
12	30467666	.	G	T	1	2	3	0	0	3	0	0
12	30475008	.	A	G	3	2	5	0	0	5	0	0
12	30569921	.	G	A	3	2	5	0	0	5	0	0
12	30706173	.	T	A	9	10	19	0	0	19	0	0
12	30706176	.	T	C	9	9	18	0	1	19	0	0
12	30712031	.	T	G	3	2	5	0	0	5	0	0
12	30712099	.	T	A	4	3	7	0	0	7	0	0
12	30744049	.	G	A	3	2	5	0	0	5	0	0
12	30744091	.	C	T	0	2	2	0	1	3	0	0
12	30788993	.	G	A	4	3	7	0	2	9	0	0
12	30793107	.	C	T	6	3	9	0	0	9	0	0
12	30796306	.	C	T	6	6	12	0	1	13	0	0
12	30796322	.	C	A	8	6	14	0	0	14	0	0
12	30796345	.	C	T	7	5	12	0	0	12	0	0
12	30798079	.	G	A	7	5	12	0	2	14	0	0
12	30798085	.	A	T	7	6	13	0	1	14	0	0
12	30800128	.	G	A	3	6	9	0	0	9	0	0
12	30803166	.	G	A	0	9	9	0	9	18	0	0
12	30803196	.	T	C	8	12	20	0	0	20	0	0
12	30803629	.	A	G	5	7	12	0	1	13	0	0
12	30805335	.	T	C	6	3	9	0	0	9	0	0
12	30805455	.	C	T	7	5	12	1	0	13	0	0
12	30806928	.	G	T	1	12	13	0	6	19	0	0
12	30807038	.	A	G	12	9	21	0	1	22	0	0
12	30807245	.	A	G	2	8	10	0	0	10	0	0
12	30807290	.	A	G	3	3	6	0	0	6	0	0
12	30807330	.	T	A	7	6	13	0	0	13	0	0
12	30807458	.	C	T	8	5	13	0	1	14	0	0
12	30807494	.	G	A	7	12	19	0	2	21	0	0
12	30807504	.	A	C	7	13	20	0	1	21	0	0
12	30807714	.	A	G	8	3	11	0	0	11	0	0
12	30808094	.	C	T	5	6	11	0	0	11	0	0
12	30808150	.	T	A	11	7	18	0	0	18	0	0
12	30808342	.	A	T	4	3	7	0	0	7	0	0
12	30808531	.	G	C	6	10	16	0	0	16	0	0
12	30808766	.	C	T	6	5	11	0	0	11	0	0
12	30808812	.	A	G	4	0	4	0	3	7	0	0
12	30808817	.	T	G	2	3	5	0	0	5	0	0
12	30979815	.	A	C	13	7	20	0	3	23	0	0
12	30979907	.	T	A	9	6	15	0	2	17	0	0
12	30980566	.	G	A	28	24	52	0	2	54	0	0
12	30981795	.	G	A	22	25	47	0	2	49	0	0
12	30986452	.	G	A	21	28	49	1	2	53	1	0
12	31102981	.	A	G	13	11	24	0	1	25	0	0
12	31435977	.	T	A	9	7	16	1	2	19	0	0
12	31438056	.	G	T	10	6	16	0	1	17	0	0
12	31438352	.	A	T	6	6	12	0	0	12	0	0
12	31438440	.	C	A	1	2	3	0	1	4	0	0
12	31509602	.	A	T	8	2	10	0	0	10	0	0
12	31516068	.	T	C	7	4	11	0	1	12	0	0
12	31516149	.	T	C	7	5	12	0	0	12	0	0
12	31520603	.	T	C	5	4	9	0	0	9	0	0
12	31520814	.	T	A	3	2	5	0	0	5	0	0
12	31520850	.	C	T	4	4	8	0	0	8	0	0
12	31523203	.	T	C	6	4	10	0	0	10	0	0
12	31531950	.	T	G	11	10	21	0	0	21	0	0
12	31532342	.	A	C	10	7	17	0	0	18	1	0
12	31532371	.	G	A	1	3	4	0	9	13	0	0
12	31532397	.	G	C	8	3	11	0	0	11	0	0
12	31532577	.	T	C	6	4	10	0	0	10	0	0
12	31532638	.	A	C	10	3	13	0	1	14	0	0
12	31532715	.	T	C	5	5	10	0	0	10	0	0
12	31533898	.	A	G	4	3	7	0	2	9	0	0
12	31616643	.	T	C	1	2	3	0	0	3	0	0
12	31629611	.	C	T	4	2	6	0	0	6	0	0
12	31630829	.	G	A	0	3	3	1	6	10	0	0
12	31631082	.	T	C	2	2	4	0	0	4	0	0
12	31664770	.	T	A	3	3	6	0	0	6	0	0
12	31664846	.	A	T	7	6	13	0	0	13	0	0
12	31665007	.	G	A	2	2	4	0	0	4	0	0
12	31665096	.	G	A	1	3	4	0	1	5	0	0
12	31665247	.	A	G	2	2	4	0	0	4	0	0
12	31665351	.	C	T	2	2	4	0	0	4	0	0
12	31665704	.	G	T	2	2	4	0	0	4	0	0
12	31689567	.	T	A	4	4	8	0	0	8	0	0
12	31694713	.	C	T	2	3	5	0	0	5	0	0
12	31704077	.	A	C	5	2	7	0	0	7	0	0
12	31704458	.	G	A	0	2	2	0	2	4	0	0
12	31704548	.	T	C	3	2	5	0	0	5	0	0
12	31708082	.	G	A	5	3	8	0	1	9	0	0
12	31708125	.	C	A	6	3	9	0	0	9	0	0
12	31709902	.	G	A	5	2	7	0	0	7	0	0
12	31720799	.	C	T	19	9	28	0	2	30	0	0
12	31721486	.	G	A	8	5	13	0	0	13	0	0
12	31722593	.	G	T	14	10	24	0	4	28	0	0
12	31722811	.	G	T	16	14	30	0	2	32	0	0
12	31722875	.	A	C	17	1	18	0	23	41	0	0
12	31724245	.	A	C	28	21	49	0	2	51	0	0
12	31724252	.	C	T	28	23	51	0	1	52	0	0
12	31729236	.	G	A	12	18	30	0	1	31	0	0
12	31729441	.	A	C	8	10	18	0	0	18	0	0
12	31729455	.	G	T	7	11	18	0	1	19	0	0
12	31740733	.	T	C	9	7	16	0	2	18	0	0
12	31740822	.	C	T	10	11	21	0	0	21	0	0
12	31741463	.	C	T	7	16	23	0	0	23	0	0
12	31743995	.	C	T	12	10	22	0	1	23	0	0
12	31753752	.	C	T	11	7	18	0	1	19	0	0
12	31753755	.	C	T	11	8	19	0	1	20	0	0
12	31764523	.	T	C	16	12	28	0	3	31	0	0
12	31764526	.	C	A	17	14	31	0	2	33	0	0
12	31765407	.	G	A	16	8	24	0	0	24	0	0
12	31765485	.	G	A	21	7	28	0	0	28	0	0
12	31765517	.	T	C	14	7	21	0	0	21	0	0
12	31765540	.	T	G	14	8	22	0	0	22	0	0
12	31783185	.	G	A	7	3	10	0	0	10	0	0
12	31785314	.	C	T	6	2	8	0	0	8	0	0
12	31785545	.	G	A	4	4	8	0	0	8	0	0
12	31787394	.	G	C	4	3	7	0	0	7	0	0
12	31789799	.	C	T	18	11	29	0	0	29	0	0
12	31794655	.	G	A	9	15	24	0	2	26	0	0
12	31911406	.	A	G	10	3	13	0	1	14	0	0
12	32039443	.	C	T	2	8	10	0	7	17	0	0
12	32039527	.	A	G	14	8	22	0	0	22	0	0
12	32039546	.	G	A	15	8	23	0	2	25	0	0
12	32039635	.	A	C	17	13	30	0	0	30	0	0
12	32039678	.	C	T	16	26	42	0	1	43	0	0
12	32039937	.	G	A	18	16	34	0	3	37	0	0
12	32039958	.	T	C	22	0	22	0	15	37	0	0
12	32040093	.	G	A	22	18	40	0	1	41	0	0
12	32045155	.	G	A	20	14	34	1	1	36	0	0
12	32045212	.	T	C	12	0	12	0	21	33	0	0
12	32051434	.	C	A	14	17	31	0	2	33	0	0
12	32051488	.	G	A	22	12	34	0	0	34	0	0
12	32066061	.	C	A	14	13	27	0	1	28	0	0
12	32078197	.	A	G	2	2	4	0	1	5	0	0
12	32103163	.	G	A	2	3	5	0	0	5	0	0
12	32115149	.	G	A	2	4	6	0	1	7	0	0
12	32125405	.	G	A	1	2	3	0	0	3	0	0
12	32159335	.	A	G	4	5	9	0	1	10	0	0
12	32159384	.	A	T	4	7	11	0	0	11	0	0
12	32160839	.	A	G	17	10	27	0	0	27	0	0
12	32160971	.	T	C	9	13	22	0	1	23	0	0
12	32161043	.	T	C	12	17	29	0	0	29	0	0
12	32162360	.	T	C	11	10	21	1	0	22	0	0
12	32162411	.	T	A	17	5	22	0	1	23	0	0
12	32186277	.	C	T	1	1	2	0	1	3	0	0
12	32318618	.	T	A	3	3	6	0	0	6	0	0
12	32349569	.	G	A	6	5	11	0	0	11	0	0
12	32360081	.	T	C	3	5	8	0	0	8	0	0
12	32360201	.	C	A	10	5	15	0	1	16	0	0
12	32369172	.	G	A	0	5	5	0	5	10	0	0
12	32373490	.	C	T	5	3	8	0	0	8	0	0
12	32373637	.	G	A	8	7	15	0	0	15	0	0
12	32373844	.	T	C	3	9	12	0	1	13	0	0
12	32374015	.	G	A	5	3	8	0	1	9	0	0
12	32374048	.	G	A	2	3	5	0	4	9	0	0
12	32389036	.	T	A	3	4	7	0	0	7	0	0
12	32389692	.	C	T	4	3	7	0	0	7	0	0
12	32389713	.	G	T	3	2	5	0	0	5	0	0
12	32976148	.	T	C	16	16	32	0	1	33	0	0
12	33151402	.	G	A	3	16	19	0	31	50	0	0
12	33151453	.	C	T	22	26	48	0	2	50	0	0
12	33245427	.	G	A	16	14	30	0	1	31	0	0
12	33246010	.	A	T	11	15	26	0	1	28	1	0
12	33247295	.	T	C	21	17	38	0	0	38	0	0
12	33247611	.	T	A	11	15	26	0	0	26	0	0
12	33248025	.	G	A	1	15	16	0	26	42	0	0
12	33248193	.	C	A	22	17	39	0	2	41	0	0
12	33248343	.	G	A	1	13	14	0	18	32	0	0
12	33320944	.	C	T	19	16	35	0	0	35	0	0
12	33329791	.	C	G	19	21	40	0	1	41	0	0
12	33331496	.	C	A	18	20	38	0	5	43	0	0
12	33331523	.	T	C	19	14	33	0	2	35	0	0
12	33331541	.	A	C	8	6	14	0	19	33	0	0
12	33331691	.	T	G	17	18	35	0	1	36	0	0
12	33331724	.	C	T	17	17	34	0	0	34	0	0
12	33335714	.	A	C	18	25	43	0	0	43	0	0
12	33335739	.	C	T	13	23	36	0	3	39	0	0
12	33335770	.	G	A	3	12	15	0	17	32	0	0
12	33335904	.	T	G	20	12	32	0	2	34	0	0
12	33335949	.	C	T	9	18	27	0	1	28	0	0
12	33336044	.	T	G	24	0	24	0	30	54	0	0
12	33336073	.	G	A	4	24	28	0	19	47	0	0
12	33336203	.	G	A	17	24	41	3	1	46	1	0
12	33336271	.	G	A	1	10	11	2	17	30	0	0
12	33351441	.	T	A	7	3	10	0	0	10	0	0
12	33352595	.	C	T	8	8	16	1	0	17	0	0
12	33352601	.	C	T	9	6	15	0	0	15	0	0
12	33352709	.	A	G	4	4	8	0	0	8	0	0
12	33352742	.	G	A	3	4	7	0	0	7	0	0
12	33352838	.	C	T	1	3	4	0	2	6	0	0
12	33352862	.	C	T	5	2	7	0	0	7	0	0
12	33352993	.	T	C	1	4	5	0	0	5	0	0
12	33354265	.	A	G	2	2	4	0	1	5	0	0
12	33354286	.	G	A	5	4	9	0	1	10	0	0
12	33359588	.	T	C	8	0	8	0	12	20	0	0
12	33372076	.	T	C	1	3	4	0	0	4	0	0
12	33384524	.	C	T	2	2	4	0	0	4	0	0
12	33384590	.	T	C	3	2	5	0	1	6	0	0
12	33395904	.	G	A	9	11	20	0	1	21	0	0
12	33411222	.	T	C	2	4	6	0	1	7	0	0
12	33411239	.	A	C	3	6	9	0	1	10	0	0
12	33411566	.	G	C	3	5	8	0	1	9	0	0
12	33411584	.	C	T	4	6	10	0	0	10	0	0
12	33411695	.	C	T	12	10	22	0	1	23	0	0
12	33420467	.	C	A	11	14	25	0	0	25	0	0
12	33420482	.	T	C	14	13	27	0	0	27	0	0
12	33422446	.	T	C	6	18	24	0	0	24	0	0
12	33422723	.	T	C	6	11	17	0	0	17	0	0
12	33428209	.	A	G	7	8	15	0	0	15	0	0
12	33428311	.	A	G	3	7	10	0	3	13	0	0
12	33428636	.	T	C	4	11	15	0	0	15	0	0
12	33434946	.	G	A	14	14	28	0	0	28	0	0
12	33434970	.	C	G	22	10	32	0	0	32	0	0
12	33435048	.	C	T	6	11	17	0	0	17	0	0
12	33435834	.	A	G	7	10	17	0	0	17	0	0
12	33437562	.	A	G	9	9	18	0	2	20	0	0
12	33437882	.	G	A	0	14	14	0	18	32	0	0
12	33438250	.	G	A	2	16	18	0	11	29	0	0
12	33439860	.	C	A	11	14	25	0	0	25	0	0
12	33440022	.	C	T	10	21	31	0	0	31	0	0
12	33440025	.	T	C	9	18	27	0	2	29	0	0
12	33440135	.	A	G	21	9	30	0	0	30	0	0
12	33440146	.	A	G	17	0	17	0	13	30	0	0
12	33440200	.	C	T	11	14	25	0	1	26	0	0
12	33442578	.	C	T	6	21	27	0	2	29	0	0
12	33442675	.	G	A	15	10	25	0	0	25	0	0
12	33442924	.	G	A	12	9	21	0	1	22	0	0
12	33444839	.	T	C	18	18	36	0	1	37	0	0
12	33448124	.	T	A	27	23	50	0	2	52	0	0
12	33448253	.	C	T	23	4	27	0	2	29	0	0
12	33448411	.	C	T	6	6	12	0	0	12	0	0
12	33448418	.	C	G	4	4	8	0	1	9	0	0
12	33448528	.	C	G	2	4	6	0	1	7	0	0
12	33449047	.	G	A	13	11	24	0	3	27	0	0
12	33449229	.	T	A	15	19	34	0	0	34	0	0
12	33449902	.	T	A	14	8	22	0	1	24	1	0
12	33449924	.	A	G	18	0	18	0	9	27	0	0
12	33450194	.	G	A	4	13	17	0	25	42	0	0
12	33450332	.	T	C	16	12	28	1	0	29	0	0
12	33450368	.	T	A	8	10	18	0	1	19	0	0
12	33450429	.	G	A	3	3	6	0	0	6	0	0
12	33456652	.	T	A	4	4	8	0	1	9	0	0
12	33460859	.	A	G	3	8	11	0	0	11	0	0
12	33460960	.	T	C	2	5	7	0	1	8	0	0
12	33461576	.	G	A	0	8	8	0	4	12	0	0
12	33467556	.	A	C	4	7	11	0	1	12	0	0
12	33469083	.	T	C	4	9	13	0	0	13	0	0
12	33472148	.	A	T	10	6	16	0	0	16	0	0
12	33473481	.	G	A	1	7	8	0	13	21	0	0
12	33473486	.	C	T	12	8	20	0	1	21	0	0
12	33473678	.	A	C	2	7	9	0	0	9	0	0
12	33473806	.	C	A	11	8	19	0	0	19	0	0
12	33473844	.	C	T	3	10	13	0	0	13	0	0
12	33473874	.	A	T	6	5	11	0	0	11	0	0
12	33484859	.	A	G	1	0	1	0	3	4	0	0
12	33536754	.	A	G	4	3	7	0	0	7	0	0
12	33536881	.	A	G	2	3	5	0	0	5	0	0
12	33552253	.	A	T	4	5	9	0	0	10	1	0
12	33553959	.	C	G	4	5	9	0	0	9	0	0
12	33554124	.	C	T	2	2	4	0	0	4	0	0
12	33561661	.	C	A	7	3	10	0	1	11	0	0
12	33561662	.	C	T	7	4	11	0	0	11	0	0
12	33564894	.	T	C	4	3	7	0	0	7	0	0
12	33568017	.	A	G	3	11	14	0	0	14	0	0
12	33570318	.	G	A	8	14	22	0	2	24	0	0
12	33572799	.	C	T	9	7	16	0	0	16	0	0
12	33573002	.	G	T	7	5	12	0	0	12	0	0
12	33574748	.	G	A	9	12	21	0	0	21	0	0
12	33574787	.	C	T	6	7	13	0	0	13	0	0
12	33579159	.	C	T	2	10	12	0	4	16	0	0
12	33602776	.	C	T	12	8	20	0	0	20	0	0
12	33603386	.	G	T	3	6	9	0	0	9	0	0
12	33603611	.	C	T	9	14	23	0	0	23	0	0
12	33604298	.	A	G	6	9	15	1	1	17	0	0
12	33604364	.	C	A	3	2	5	0	0	5	0	0
12	33604445	.	G	A	1	3	4	0	1	5	0	0
12	33604491	.	A	C	1	2	3	0	0	3	0	0
12	33605727	.	C	G	5	5	10	0	0	10	0	0
12	33605732	.	T	C	5	6	11	0	0	11	0	0
12	33605948	.	C	T	1	3	4	0	0	4	0	0
12	33606087	.	C	T	0	5	5	0	3	8	0	0
12	33606114	.	A	G	4	3	7	0	0	7	0	0
12	33606148	.	A	G	2	5	7	0	0	7	0	0
12	33609323	.	T	G	6	7	13	0	0	13	0	0
12	33609377	.	C	G	3	2	5	0	0	5	0	0
12	33618002	.	C	T	1	3	4	0	5	9	0	0
12	33628828	.	G	T	6	5	11	0	0	11	0	0
12	33629704	.	G	T	4	3	7	0	1	8	0	0
12	33629725	.	G	T	1	1	2	0	1	3	0	0
12	33629797	.	G	A	3	6	9	0	0	9	0	0
12	33637937	.	C	T	0	4	4	0	3	7	0	0
12	33642872	.	C	T	8	3	11	0	0	11	0	0
12	33646001	.	T	C	2	2	4	0	0	4	0	0
12	33738927	.	T	G	3	9	12	0	0	12	0	0
12	33738956	.	A	C	2	6	8	0	0	8	0	0
12	33743789	.	A	G	3	2	5	0	0	5	0	0
12	33748709	.	C	T	1	3	4	0	1	5	0	0
12	33751980	.	G	A	1	3	4	0	0	4	0	0
12	33759154	.	G	A	2	2	4	0	0	4	0	0
12	33759244	.	C	T	0	4	4	0	4	8	0	0
12	33761985	.	C	G	1	3	4	0	5	9	0	0
12	33762173	.	G	T	3	2	5	0	0	5	0	0
12	33762191	.	G	A	1	4	5	0	0	5	0	0
12	33768206	.	G	A	2	2	4	0	0	4	0	0
12	33788820	.	A	G	3	4	7	0	0	7	0	0
12	33788935	.	A	T	2	3	5	0	0	5	0	0
12	33807357	.	C	T	4	3	7	0	0	7	0	0
12	33807438	.	G	A	1	2	3	0	0	3	0	0
12	33812809	.	C	A	0	2	2	0	2	4	0	0
12	33813071	.	G	A	3	5	8	0	0	8	0	0
12	33813260	.	A	T	2	4	6	0	0	6	0	0
12	33813871	.	C	T	1	3	4	0	0	4	0	0
12	33817399	.	A	T	13	7	20	0	1	21	0	0
12	33818654	.	A	G	13	9	22	0	0	22	0	0
12	33818743	.	C	T	9	3	12	0	0	12	0	0
12	33818925	.	C	T	1	2	3	0	0	3	0	0
12	33818950	.	T	C	0	2	2	0	0	2	0	0
12	33832148	.	A	G	4	3	7	0	2	9	0	0
12	33832286	.	G	A	6	8	14	0	1	15	0	0
12	33832501	.	G	A	9	3	12	0	0	12	0	0
12	33832529	.	G	A	5	7	12	0	0	12	0	0
12	33832747	.	A	T	5	6	11	0	0	11	0	0
12	33832952	.	T	G	4	8	12	0	0	12	0	0
12	33832985	.	G	A	2	6	8	0	0	8	0	0
12	33833033	.	A	G	4	4	8	0	0	8	0	0
12	33833129	.	C	G	0	2	2	0	2	4	0	0
12	33837421	.	A	T	4	2	6	0	1	7	0	0
12	33894589	.	C	A	4	5	9	0	0	9	0	0
12	33912518	.	G	C	0	4	4	0	6	10	0	0
12	33912635	.	T	C	2	11	13	0	0	13	0	0
12	33912656	.	C	T	3	12	15	0	0	15	0	0
12	33912758	.	C	A	2	4	6	0	2	8	0	0
12	33912946	.	C	A	5	11	16	0	0	16	0	0
12	33912982	.	G	T	5	10	15	0	2	17	0	0
12	33913000	.	G	A	6	5	11	0	1	12	0	0
12	33913154	.	G	A	5	6	11	0	2	13	0	0
12	33913578	.	G	A	0	4	4	0	5	9	0	0
12	33913698	.	T	A	5	9	14	0	0	14	0	0
12	33913705	.	T	C	4	8	12	0	0	12	0	0
12	33913759	.	G	A	6	4	10	1	0	11	0	0
12	33913805	.	C	A	6	6	12	1	0	13	0	0
12	33913964	.	T	G	8	5	13	0	1	14	0	0
12	33914967	.	A	C	3	3	6	0	0	6	0	0
12	33919640	.	T	A	16	12	28	0	0	28	0	0
12	33919851	.	C	T	13	14	27	0	0	28	1	0
12	33919964	.	C	A	4	4	8	0	0	8	0	0
12	33920483	.	G	A	12	6	18	0	0	18	0	0
12	33920627	.	T	C	10	7	17	0	0	17	0	0
12	33920693	.	G	T	12	15	27	0	0	27	0	0
12	33920826	.	T	C	18	13	31	0	0	31	0	0
12	33933495	.	A	G	11	0	11	0	13	24	0	0
12	33933979	.	C	T	15	23	38	0	3	41	0	0
12	33934082	.	G	A	1	15	16	0	24	40	0	0
12	33934099	.	G	A	3	16	19	0	29	48	0	0
12	33934768	.	G	T	25	18	43	0	0	43	0	0
12	33935010	.	C	A	14	15	29	0	0	29	0	0
12	33935019	.	G	T	1	15	16	0	13	29	0	0
12	33966470	.	G	A	3	7	10	0	0	10	0	0
12	33966499	.	C	T	0	10	10	0	9	19	0	0
12	33966886	.	A	G	25	18	43	0	0	43	0	0
12	33967897	.	A	C	2	7	9	0	0	9	0	0
12	33967918	.	A	G	5	6	11	0	0	11	0	0
12	33967968	.	T	G	8	16	24	0	0	24	0	0
12	33968027	.	T	A	13	22	35	1	2	38	0	0
12	33968073	.	T	A	18	28	46	1	1	48	0	0
12	33968145	.	C	T	22	16	38	0	0	38	0	0
12	33968419	.	C	A	1	24	25	0	25	50	0	0
12	33971461	.	T	C	15	14	29	0	1	30	0	0
12	33972294	.	G	T	32	14	46	0	1	47	0	0
12	33975228	.	A	T	5	3	8	0	1	9	0	0
12	33982344	.	C	T	2	3	5	0	0	5	0	0
12	33988266	.	C	T	1	4	5	0	0	5	0	0
12	33988623	.	G	C	5	2	7	0	0	7	0	0
12	33991622	.	T	C	19	9	28	0	1	29	0	0
12	33992199	.	G	C	14	0	14	0	18	32	0	0
12	33992208	.	A	C	13	8	21	0	8	29	0	0
12	33992376	.	A	G	12	10	22	0	0	22	0	0
12	33992418	.	G	T	23	20	43	0	0	43	0	0
12	33992813	.	C	A	21	24	45	0	1	46	0	0
12	33993008	.	T	A	26	17	43	7	0	50	0	0
12	33997285	.	C	T	18	17	35	0	2	37	0	0
12	33997303	.	T	A	19	18	37	0	0	37	0	0
12	34179962	.	C	T	5	9	14	1	1	16	0	0
12	34187335	.	C	T	14	8	22	0	0	22	0	0
12	34187341	.	G	T	0	7	7	0	15	22	0	0
12	34192762	.	C	T	3	8	11	0	1	12	0	0
12	34192816	.	T	G	2	0	2	0	3	5	0	0
12	34216726	.	C	G	0	5	5	0	3	8	0	0
12	34219622	.	G	A	4	3	7	0	0	7	0	0
12	34251815	.	G	A	5	7	12	0	0	12	0	0
12	34251818	.	G	A	4	6	10	0	2	12	0	0
12	34275648	.	C	T	3	3	6	0	0	6	0	0
12	34276004	.	T	C	4	4	8	0	0	8	0	0
12	34276025	.	C	T	4	6	10	0	0	10	0	0
12	34276956	.	G	A	1	3	4	0	0	4	0	0
12	34277081	.	C	G	1	2	3	0	0	3	0	0
12	34397054	.	T	C	0	2	2	0	1	3	0	0
12	34416237	.	G	A	2	2	4	0	0	4	0	0
12	34416239	.	G	A	2	2	4	0	0	4	0	0
12	34427449	.	T	C	3	3	6	0	0	6	0	0
12	34434681	.	T	A	2	5	7	0	0	7	0	0
12	34563459	.	G	T	6	2	8	1	0	13	4	0
12	34563469	.	T	C	7	4	11	1	0	12	0	0
12	34564123	.	A	G	6	8	14	0	0	14	0	0
12	34564322	.	T	G	8	2	10	0	0	10	0	0
12	34564343	.	C	T	7	3	10	0	2	12	0	0
12	34564416	.	A	G	3	6	9	0	0	9	0	0
12	34564904	.	A	T	8	3	11	0	1	12	0	0
12	34565200	.	A	C	5	6	11	0	0	11	0	0
12	34565223	.	T	C	6	6	12	0	0	12	0	0
12	34565311	.	C	T	2	5	7	0	0	7	0	0
12	34565354	.	C	G	4	8	12	0	1	13	0	0
12	34565504	.	A	G	5	6	11	0	0	11	0	0
12	34566022	.	C	T	8	7	15	0	0	15	0	0
12	34566547	.	T	A	3	4	7	0	0	7	0	0
12	34568320	.	A	C	2	7	9	0	0	9	0	0
12	34568321	.	C	A	2	7	9	0	0	9	0	0
12	34568383	.	T	C	3	3	6	0	0	6	0	0
12	34574380	.	T	C	3	3	6	0	0	6	0	0
12	34574416	.	T	A	1	3	4	0	0	4	0	0
12	34580552	.	A	G	6	4	10	0	0	10	0	0
12	34581049	.	C	T	6	4	10	0	0	10	0	0
12	34581051	.	C	T	4	4	8	0	1	9	0	0
12	34583025	.	C	A	0	3	3	0	5	8	0	0
12	34597779	.	C	T	1	4	5	0	4	9	0	0
12	34606935	.	C	A	6	2	8	0	0	8	0	0
12	34607242	.	G	T	2	3	5	0	0	5	0	0
12	34607278	.	G	A	3	3	6	0	0	6	0	0
12	34609979	.	A	T	3	3	6	0	2	8	0	0
12	34609981	.	G	T	3	5	8	0	0	8	0	0
12	34615708	.	G	T	1	2	3	0	1	4	0	0
12	34617041	.	C	T	2	3	5	0	0	5	0	0
12	34617647	.	C	A	4	2	6	0	0	6	0	0
12	34638672	.	G	T	2	5	7	0	0	7	0	0
12	34638681	.	T	C	2	0	2	0	5	7	0	0
12	34638714	.	C	T	2	5	7	0	0	7	0	0
12	34732862	.	A	T	2	4	6	0	0	6	0	0
12	34763958	.	A	T	1	2	3	0	0	3	0	0
12	34810681	.	G	A	0	3	3	0	2	5	0	0
12	34810833	.	A	G	5	5	10	0	1	11	0	0
12	34819657	.	A	C	2	2	4	0	0	4	0	0
12	34820046	.	A	G	5	2	7	0	0	7	0	0
12	34820065	.	C	T	4	2	6	0	0	6	0	0
12	34820521	.	G	C	1	7	8	0	0	8	0	0
12	34820760	.	C	T	2	2	4	0	0	4	0	0
12	34821051	.	C	T	3	5	8	0	0	8	0	0
12	34821820	.	A	G	1	3	4	0	0	4	0	0
12	34821824	.	A	G	2	0	2	0	2	4	0	0
12	34825187	.	T	C	2	3	5	0	0	5	0	0
12	34830709	.	C	T	3	3	6	0	0	6	0	0
12	34834887	.	G	T	5	2	7	0	2	9	0	0
12	34837395	.	G	A	0	2	2	0	7	9	0	0
12	34840207	.	T	G	2	5	7	0	0	7	0	0
12	34840421	.	C	T	6	5	11	0	0	11	0	0
12	34841852	.	C	T	7	4	11	0	1	12	0	0
12	34841897	.	C	G	6	4	10	0	0	10	0	0
12	34841996	.	A	G	4	0	4	0	3	7	0	0
12	34842308	.	G	A	0	3	3	0	0	3	0	0
12	34845615	.	C	A	2	3	5	0	0	5	0	0
12	34845669	.	T	G	5	5	10	0	0	10	0	0
12	34845942	.	A	G	9	4	13	0	0	13	0	0
12	34846091	.	G	A	2	10	12	0	2	14	0	0
12	34846577	.	A	G	4	3	7	0	0	7	0	0
12	34846753	.	T	C	3	4	7	0	1	8	0	0
12	34847077	.	T	G	5	5	10	0	0	10	0	0
12	34847091	.	T	A	3	3	6	0	0	6	0	0
12	34847137	.	T	C	6	2	8	0	0	8	0	0
12	34847139	.	G	T	6	2	8	0	0	8	0	0
12	34847211	.	G	A	3	4	7	0	0	7	0	0
12	34847234	.	A	T	7	2	9	0	0	9	0	0
12	34847247	.	T	C	4	9	13	0	0	13	0	0
12	34847977	.	A	G	9	10	19	0	0	19	0	0
12	34858581	.	C	T	2	2	4	0	0	4	0	0
12	34869519	.	G	A	0	2	2	0	1	3	0	0
12	34876420	.	G	A	4	4	8	0	1	9	0	0
12	34876827	.	A	G	8	5	13	0	1	14	0	0
12	34876837	.	G	A	4	8	12	0	3	15	0	0
12	34877048	.	T	A	10	7	17	0	1	18	0	0
12	34877064	.	G	A	8	6	14	0	0	14	0	0
12	34883556	.	A	C	3	9	12	0	0	12	0	0
12	34883557	.	G	A	3	9	12	0	0	12	0	0
12	34883640	.	G	A	5	5	10	0	1	11	0	0
12	34884018	.	T	C	7	6	13	0	1	14	0	0
12	34884062	.	T	A	6	3	9	0	0	9	0	0
12	34884446	.	C	T	0	2	2	0	7	9	0	0
12	34891681	.	C	T	12	14	26	0	1	27	0	0
12	34891780	.	G	A	0	7	7	0	8	15	0	0
12	34892087	.	C	A	10	5	15	0	0	15	0	0
12	34892089	.	C	T	10	4	14	0	1	15	0	0
12	34892590	.	T	A	8	7	15	0	0	15	0	0
12	34953641	.	G	T	0	17	17	0	13	30	0	0
12	35008681	.	A	G	26	24	50	0	2	52	0	0
12	35012040	.	C	T	22	19	41	0	7	48	0	0
12	35012127	.	T	C	27	17	44	0	0	44	0	0
12	35018127	.	C	T	13	25	38	0	1	39	0	0
12	35046821	.	A	G	14	25	39	0	4	43	0	0
12	35046875	.	C	T	13	10	23	0	1	24	0	0
12	35046900	.	G	A	14	12	26	0	0	26	0	0
12	35046928	.	T	C	15	16	31	0	0	31	0	0
12	35046956	.	T	G	18	12	30	0	1	31	0	0
12	35046965	.	G	T	16	12	28	0	1	29	0	0
12	35047014	.	A	G	11	12	23	0	3	26	0	0
12	35051250	.	A	G	16	7	23	0	0	23	0	0
12	35099430	.	G	A	0	2	2	0	0	2	0	0
12	35099509	.	C	T	0	4	4	0	2	6	0	0
12	35099601	.	C	T	1	2	3	0	0	3	0	0
12	35099805	.	G	A	3	2	5	0	0	5	0	0
12	35103405	.	A	G	6	5	11	0	0	11	0	0
12	35103606	.	T	C	4	0	4	0	12	16	0	0
12	35103665	.	C	T	2	4	6	0	0	6	0	0
12	35103710	.	G	C	3	8	11	0	0	11	0	0
12	35105596	.	G	C	5	7	12	0	0	12	0	0
12	35146537	.	G	A	2	11	13	0	9	23	1	0
12	35149868	.	G	A	13	9	22	0	0	22	0	0
12	35158344	.	C	T	13	12	25	0	4	29	0	0
12	35167333	.	A	G	11	17	28	0	3	31	0	0
12	35178914	.	G	A	19	17	36	0	1	37	0	0
12	35189264	.	G	T	16	14	30	0	1	31	0	0
12	35189295	.	C	T	23	10	33	0	0	33	0	0
12	35189306	.	A	G	23	10	33	0	2	35	0	0
12	35189402	.	A	G	19	0	19	0	18	37	0	0
12	35189471	.	T	A	14	28	42	0	3	45	0	0
12	35191080	.	A	T	22	21	43	1	1	45	0	0
12	35191856	.	C	T	18	15	33	0	2	35	0	0
12	35203251	.	G	T	1	5	6	0	8	14	0	0
12	35270573	.	G	A	0	5	5	0	4	9	0	0
12	35316791	.	C	A	3	2	5	0	2	7	0	0
12	35317147	.	G	A	3	6	9	0	1	10	0	0
12	35317222	.	A	G	7	10	17	0	0	17	0	0
12	35317294	.	A	G	10	0	10	0	7	17	0	0
12	35317520	.	C	A	15	4	19	1	0	20	0	0
12	35317609	.	C	T	7	5	12	0	0	12	0	0
12	35317654	.	C	T	5	3	8	0	0	8	0	0
12	35325591	.	G	T	8	3	11	0	0	11	0	0
12	35325618	.	C	A	5	5	10	0	1	11	0	0
12	35325811	.	C	T	7	3	10	0	0	10	0	0
12	35328139	.	C	T	7	13	20	0	2	22	0	0
12	35330107	.	C	T	5	4	9	0	0	9	0	0
12	35332283	.	T	A	7	7	14	0	1	15	0	0
12	35339212	.	A	G	10	5	15	0	0	15	0	0
12	35339263	.	A	T	8	11	19	0	0	19	0	0
12	35339395	.	C	T	4	4	8	0	0	8	0	0
12	35346498	.	G	A	21	28	49	0	2	51	0	0
12	35346597	.	A	T	30	27	57	0	3	60	0	0
12	35346842	.	T	C	26	10	36	0	3	39	0	0
12	35346873	.	C	T	29	23	52	0	1	53	0	0
12	35347002	.	A	T	22	20	42	0	2	44	0	0
12	35347078	.	G	A	25	30	55	0	3	58	0	0
12	35347084	.	C	T	4	26	30	0	30	60	0	0
12	35347318	.	C	T	32	18	50	0	4	54	0	0
12	35347485	.	T	G	32	18	50	0	2	52	0	0
12	35347795	.	C	T	0	12	12	0	10	22	0	0
12	35347951	.	A	G	25	25	50	0	0	50	0	0
12	35350686	.	G	A	29	21	50	0	3	53	0	0
12	35351392	.	G	T	26	20	46	2	1	49	0	0
12	35381729	.	T	C	15	1	16	0	26	42	0	0
12	35386919	.	A	G	19	18	37	0	1	38	0	0
12	35543736	.	T	G	3	13	16	0	2	18	0	0
12	35543971	.	T	G	9	11	20	0	0	20	0	0
12	35544320	.	T	G	7	10	17	0	0	17	0	0
12	35544460	.	A	G	9	9	18	0	0	18	0	0
12	35544596	.	C	A	5	7	12	0	1	13	0	0
12	35544968	.	A	G	19	11	30	0	1	31	0	0
12	35551120	.	G	A	5	7	12	0	0	12	0	0
12	35556821	.	G	C	6	5	11	0	0	11	0	0
12	35559614	.	T	G	7	9	16	0	0	16	0	0
12	35568231	.	G	A	13	10	23	0	2	25	0	0
12	35568249	.	C	T	1	11	12	0	16	28	0	0
12	35568270	.	T	A	11	15	26	0	1	27	0	0
12	35568303	.	C	G	10	13	23	0	4	27	0	0
12	35568691	.	A	G	13	9	22	0	0	22	0	0
12	35568787	.	G	A	12	5	17	0	0	17	0	0
12	35568793	.	A	G	12	5	17	0	0	17	0	0
12	35574179	.	T	C	6	0	6	0	10	16	0	0
12	35574180	.	C	G	6	10	16	0	0	16	0	0
12	35593188	.	C	T	12	28	40	0	0	40	0	0
12	35593469	.	T	A	10	9	19	0	0	19	0	0
12	35593729	.	A	G	11	0	11	0	6	17	0	0
12	35594069	.	T	A	15	18	33	0	0	33	0	0
12	35594154	.	C	T	16	12	28	0	1	29	0	0
12	35594169	.	C	T	16	10	26	0	1	27	0	0
12	35594436	.	C	T	15	12	27	0	1	28	0	0
12	35594474	.	A	G	20	11	31	0	1	32	0	0
12	35594495	.	G	A	1	10	11	0	19	30	0	0
12	35594512	.	T	C	23	10	33	0	0	33	0	0
12	35594541	.	C	A	20	13	33	0	0	33	0	0
12	35594605	.	C	T	16	13	29	0	2	31	0	0
12	35594623	.	T	A	14	11	25	0	1	26	0	0
12	35674952	.	G	A	11	16	27	0	1	28	0	0
12	35689209	.	C	T	20	19	39	0	0	39	0	0
12	35689210	.	A	G	18	19	37	0	2	39	0	0
12	35704426	.	G	T	31	17	48	0	3	51	0	0
12	35704435	.	G	T	32	18	50	0	2	52	0	0
12	35704735	.	A	G	12	20	32	0	1	33	0	0
12	35704852	.	G	A	18	19	37	0	1	38	0	0
12	35704921	.	A	C	22	14	36	0	0	36	0	0
12	35704996	.	T	G	25	19	44	0	3	47	0	0
12	35705131	.	C	T	25	12	37	0	4	41	0	0
12	35705140	.	A	C	22	0	22	0	16	38	0	0
12	35705224	.	A	G	19	16	35	0	1	36	0	0
12	35705252	.	T	G	21	20	41	0	0	41	0	0
12	35705323	.	G	A	19	11	30	0	0	30	0	0
12	35705367	.	C	T	2	19	21	0	21	42	0	0
12	35705565	.	C	T	2	14	16	0	13	29	0	0
12	35705606	.	A	T	13	14	27	0	1	28	0	0
12	35705661	.	T	C	15	19	34	0	1	35	0	0
12	35705926	.	C	T	22	25	47	0	5	52	0	0
12	35706091	.	C	T	17	9	26	0	1	27	0	0
12	35706124	.	A	G	17	11	28	0	0	28	0	0
12	35706253	.	A	T	10	23	33	0	2	35	0	0
12	35706304	.	A	G	18	18	36	0	1	37	0	0
12	35706524	.	G	A	15	19	34	0	1	35	0	0
12	35706568	.	C	T	18	21	39	0	3	42	0	0
12	35706859	.	C	T	1	21	22	0	15	37	0	0
12	35706970	.	G	T	12	22	34	0	1	35	0	0
12	35707155	.	C	T	20	12	32	0	1	34	1	0
12	35707171	.	T	C	21	11	32	0	0	32	0	0
12	35707225	.	G	A	16	13	29	0	2	31	0	0
12	35707537	.	A	G	14	7	21	0	1	22	0	0
12	35707636	.	G	A	11	9	20	0	1	21	0	0
12	35707660	.	A	C	9	6	15	0	1	16	0	0
12	35707747	.	A	G	15	7	22	0	0	22	0	0
12	35707963	.	T	C	19	0	19	0	14	33	0	0
12	35707987	.	G	A	22	14	36	0	1	37	0	0
12	35708139	.	T	G	7	22	29	0	4	33	0	0
12	35708235	.	A	G	24	17	41	0	1	42	0	0
12	35708272	.	C	T	25	8	33	0	4	37	0	0
12	35708950	.	G	A	11	18	29	0	1	30	0	0
12	35709007	.	G	A	15	14	29	0	1	30	0	0
12	35709028	.	A	G	15	12	27	0	4	31	0	0
12	35710837	.	T	C	9	15	24	0	0	24	0	0
12	35715339	.	A	G	9	12	21	0	0	21	0	0
12	35716116	.	T	G	14	5	19	0	0	19	0	0
12	35740605	.	G	T	14	6	20	0	0	20	0	0
12	35837354	.	C	T	0	5	5	0	5	10	0	0
12	35837425	.	T	A	6	9	15	0	0	15	0	0
12	35837468	.	C	A	4	4	8	0	1	9	0	0
12	35837499	.	G	C	8	4	12	0	0	12	0	0
12	35837503	.	T	G	9	4	13	0	0	13	0	0
12	35837629	.	T	A	7	3	10	0	0	10	0	0
12	35837751	.	G	A	8	3	11	0	2	13	0	0
12	35838672	.	C	A	0	2	2	0	4	6	0	0
12	35838978	.	A	G	7	3	10	0	0	10	0	0
12	35839063	.	A	T	2	8	10	0	0	10	0	0
12	35839090	.	C	T	0	5	5	0	6	11	0	0
12	35839159	.	C	T	5	9	14	0	0	14	0	0
12	35839165	.	C	G	5	9	14	0	0	14	0	0
12	35839261	.	C	A	12	8	20	0	0	20	0	0
12	35839680	.	G	A	7	6	13	0	0	13	0	0
12	35839879	.	C	A	2	9	11	0	11	22	0	0
12	35839919	.	C	G	1	4	5	0	12	17	0	0
12	35839942	.	C	T	9	2	11	0	1	12	0	0
12	35840003	.	T	C	9	0	9	0	3	12	0	0
12	35840008	.	C	A	9	3	12	0	0	12	0	0
12	35840483	.	G	A	3	3	6	0	0	6	0	0
12	35840543	.	A	C	6	5	11	0	0	11	0	0
12	35840717	.	A	G	4	7	11	0	0	11	0	0
12	35841438	.	G	A	2	6	8	0	0	8	0	0
12	35841457	.	G	A	4	5	9	0	1	10	0	0
12	35847493	.	A	T	10	9	19	0	0	19	0	0
12	35847535	.	T	C	11	8	19	0	0	19	0	0
12	35847538	.	C	T	10	8	18	0	0	18	0	0
12	35853678	.	A	G	7	8	15	0	0	15	0	0
12	35853693	.	T	C	9	6	15	0	0	15	0	0
12	35853732	.	C	A	6	5	11	0	0	11	0	0
12	35864581	.	T	A	2	2	4	0	0	4	0	0
12	35865689	.	C	T	6	4	10	0	0	10	0	0
12	35867935	.	G	A	4	5	9	0	1	10	0	0
12	35870659	.	C	G	2	3	5	0	0	5	0	0
12	35873397	.	G	T	4	2	6	0	0	6	0	0
12	35875707	.	A	G	7	5	12	0	0	12	0	0
12	35875766	.	A	G	6	4	10	0	0	10	0	0
12	35963575	.	T	C	13	11	24	0	1	25	0	0
12	35967239	.	T	C	6	10	16	0	0	16	0	0
12	35976771	.	C	A	7	10	17	0	1	18	0	0
12	35980632	.	T	C	2	2	4	0	0	4	0	0
12	35980817	.	T	A	3	2	5	0	0	5	0	0
12	35980917	.	T	G	2	3	5	0	0	5	0	0
12	35981206	.	T	C	5	1	6	0	6	12	0	0
12	35981260	.	T	A	3	7	10	0	0	10	0	0
12	35981303	.	T	G	3	2	5	0	0	5	0	0
12	35981304	.	G	C	3	2	5	0	0	5	0	0
12	35981478	.	A	G	2	7	9	0	0	9	0	0
12	35981627	.	C	T	5	8	13	0	0	13	0	0
12	35981713	.	C	T	0	6	6	1	6	13	0	0
12	35981795	.	T	A	4	12	16	0	0	16	0	0
12	35981832	.	A	G	3	8	11	0	1	12	0	0
12	35988544	.	A	G	3	10	13	0	0	13	0	0
12	35988553	.	G	A	3	6	9	0	1	10	0	0
12	36135764	.	C	T	11	8	19	0	0	19	0	0
12	36158056	.	A	C	21	20	41	0	1	42	0	0
12	36158098	.	G	C	20	19	39	0	1	40	0	0
12	36158099	.	T	C	21	18	39	0	1	40	0	0
12	36158225	.	T	C	10	16	26	0	1	27	0	0
12	36158349	.	G	A	1	15	16	0	15	31	0	0
12	36158538	.	C	T	6	6	12	0	0	12	0	0
12	36159597	.	C	G	5	7	12	0	0	12	0	0
12	36413894	.	G	T	3	3	6	0	0	6	0	0
12	36413937	.	A	T	10	6	16	0	0	16	0	0
12	36416669	.	T	C	2	8	10	0	0	10	0	0
12	36416675	.	T	C	3	8	11	0	0	11	0	0
12	36420141	.	T	C	1	5	6	0	0	6	0	0
12	36420420	.	G	A	3	4	7	0	0	7	0	0
12	36422537	.	A	G	4	5	9	0	0	9	0	0
12	36422555	.	G	A	4	3	7	0	1	8	0	0
12	36422573	.	T	C	3	5	8	0	0	8	0	0
12	36424613	.	G	A	9	4	13	0	0	13	0	0
12	36424618	.	G	A	5	9	14	0	0	14	0	0
12	36452452	.	T	A	3	3	6	0	0	6	0	0
12	36462038	.	G	A	1	3	4	0	1	5	0	0
12	36739440	.	C	T	2	2	4	0	0	4	0	0
12	36891583	.	C	T	5	4	9	0	0	9	0	0
12	36895025	.	A	G	5	9	14	0	1	15	0	0
12	36895057	.	T	C	4	8	12	0	2	14	0	0
12	36895067	.	G	A	6	7	13	0	0	13	0	0
12	36952744	.	C	T	6	6	12	0	0	12	0	0
12	36960197	.	T	C	4	4	8	0	0	8	0	0
12	36960200	.	A	T	4	4	8	0	0	8	0	0
12	37003282	.	C	T	2	3	5	0	0	5	0	0
12	37003291	.	A	G	2	3	5	0	0	5	0	0
12	37003460	.	T	C	1	2	3	0	0	3	0	0
12	37003739	.	G	C	1	2	3	0	0	3	0	0
12	37004290	.	A	C	1	3	4	0	0	4	0	0
12	37004295	.	C	T	1	3	4	0	0	4	0	0
12	37004759	.	G	T	1	3	4	0	0	4	0	0
12	37005350	.	T	C	1	5	6	0	0	6	0	0
12	37408833	.	T	C	4	2	6	0	0	6	0	0
12	38556562	.	G	T	2	2	4	0	0	4	0	0
12	38561258	.	C	A	11	6	17	0	0	17	0	0
12	38651219	.	G	A	0	2	2	0	3	5	0	0
12	38676664	.	C	T	3	2	5	0	0	5	0	0
12	38687907	.	T	A	3	2	5	0	0	5	0	0
12	38687951	.	C	G	4	2	6	0	0	6	0	0
12	38687957	.	G	T	4	1	5	0	0	5	0	0
12	38771055	.	T	A	1	2	3	0	0	3	0	0
12	38771061	.	C	T	0	2	2	0	0	2	0	0
12	38782119	.	A	T	5	3	8	0	0	8	0	0
12	38787618	.	A	G	3	5	8	0	1	9	0	0
12	38787696	.	A	G	3	4	7	0	0	7	0	0
12	38802875	.	T	C	11	5	16	0	0	16	0	0
12	38803168	.	A	G	3	3	6	0	1	7	0	0
12	38803377	.	G	A	0	5	5	0	9	14	0	0
12	38803411	.	A	G	10	0	10	0	10	20	0	0
12	38803649	.	G	C	2	2	4	0	0	4	0	0
12	38804005	.	G	T	1	3	4	0	0	4	0	0
12	38804027	.	A	G	3	2	5	0	0	5	0	0
12	38809283	.	C	T	4	2	6	0	0	6	0	0
12	38819727	.	C	T	4	4	8	0	0	8	0	0
12	38821575	.	T	C	1	4	5	0	0	5	0	0
12	38825944	.	G	T	2	2	4	0	0	4	0	0
12	38842158	.	G	A	3	4	7	0	0	7	0	0
12	38843587	.	A	G	11	4	15	0	1	16	0	0
12	38850889	.	C	T	7	5	12	0	0	12	0	0
12	39744954	.	G	C	2	8	10	0	9	19	0	0
12	40206716	.	G	A	0	6	6	1	9	16	0	0
12	40348899	.	G	T	0	2	2	0	5	7	0	0
12	40478325	.	A	C	6	5	11	0	0	11	0	0
12	40502531	.	G	A	1	3	4	0	2	6	0	0
12	40518088	.	C	T	14	12	26	0	0	26	0	0
12	40518094	.	T	C	12	12	24	0	0	24	0	0
12	40518217	.	C	T	3	2	5	0	0	5	0	0
12	40518237	.	A	C	4	1	5	0	1	6	0	0
12	41437046	.	G	A	7	15	22	0	0	22	0	0
12	41455861	.	T	C	6	7	13	0	0	13	0	0
12	41461030	.	C	T	14	15	29	1	1	31	0	0
12	41461051	.	C	T	8	15	23	1	1	25	0	0
12	41466801	.	C	G	18	3	21	0	11	32	0	0
12	41467003	.	C	T	19	15	34	0	0	34	0	0
12	41467207	.	C	A	12	9	21	0	1	22	0	0
12	41525833	.	C	T	12	14	26	0	1	27	0	0
12	41528206	.	C	T	20	17	37	0	0	37	0	0
12	41528230	.	A	T	15	14	29	0	3	32	0	0
12	41535830	.	G	A	1	15	16	0	16	32	0	0
12	41535844	.	C	T	16	15	31	0	0	31	0	0
12	41535886	.	A	C	13	15	28	0	1	29	0	0
12	41535898	.	C	T	11	14	25	0	2	27	0	0
12	41535937	.	T	A	15	11	26	0	1	28	1	0
12	41539059	.	G	A	18	15	33	0	0	33	0	0
12	41539161	.	C	T	21	23	44	0	1	45	0	0
12	41539464	.	G	A	22	13	35	0	0	35	0	0
12	41549214	.	G	A	1	19	20	0	10	30	0	0
12	41549386	.	G	A	15	23	38	0	0	38	0	0
12	41549404	.	C	G	22	14	36	0	1	37	0	0
12	41549434	.	C	G	24	19	43	1	0	44	0	0
12	41549443	.	A	G	23	1	24	1	21	46	0	0
12	41580940	.	G	T	7	3	10	0	0	10	0	0
12	41581092	.	A	G	10	9	19	0	0	19	0	0
12	41584666	.	G	A	11	6	17	0	1	18	0	0
12	41584755	.	C	T	12	20	32	0	1	33	0	0
12	41589789	.	T	G	14	20	34	0	0	35	1	0
12	41593093	.	T	A	18	18	36	0	2	38	0	0
12	41606683	.	T	C	10	0	10	0	13	23	0	0
12	41606686	.	G	T	10	11	21	0	1	22	0	0
12	41618820	.	G	A	11	14	25	0	0	25	0	0
12	41618846	.	A	C	4	0	4	0	11	15	0	0
12	41631703	.	A	T	3	6	9	0	0	9	0	0
12	41631964	.	C	G	16	9	25	0	0	25	0	0
12	41632117	.	A	G	14	28	42	0	1	43	0	0
12	41643214	.	C	T	13	14	27	0	0	27	0	0
12	41643217	.	G	A	11	15	26	0	1	27	0	0
12	41647273	.	T	C	17	6	23	0	2	25	0	0
12	41653155	.	C	T	14	8	22	0	2	24	0	0
12	41653678	.	A	G	17	13	30	0	0	30	0	0
12	41656554	.	G	A	17	7	24	0	0	24	0	0
12	41698040	.	A	T	17	22	39	0	6	45	0	0
12	41698070	.	T	A	23	23	46	0	1	47	0	0
12	41702044	.	A	C	22	30	52	1	5	58	0	0
12	41723165	.	A	T	5	7	12	0	1	13	0	0
12	41723482	.	G	A	4	10	14	0	0	14	0	0
12	41723608	.	T	A	18	8	26	0	2	28	0	0
12	41732013	.	C	T	2	8	10	0	6	16	0	0
12	41735790	.	T	C	7	6	13	0	1	14	0	0
12	41739297	.	G	T	6	14	20	0	1	21	0	0
12	42369668	.	G	T	8	7	15	0	1	16	0	0
12	42378970	.	T	C	19	14	33	0	0	33	0	0
12	42405143	.	G	T	1	2	3	0	0	3	0	0
12	42405160	.	C	A	2	2	4	0	0	4	0	0
12	42406178	.	C	T	4	3	7	0	0	7	0	0
12	42577252	.	G	T	14	8	22	0	1	27	4	0
12	42577492	.	T	G	16	7	23	0	1	24	0	0
12	42578024	.	G	A	1	5	6	0	12	18	0	0
12	42578127	.	T	A	16	12	28	0	0	28	0	0
12	42578505	.	A	T	14	21	35	0	4	39	0	0
12	42578698	.	A	G	3	0	3	0	9	12	0	0
12	42578996	.	T	A	10	11	21	1	1	23	0	0
12	44072398	.	C	T	1	2	3	0	0	3	0	0
12	45662366	.	C	G	1	6	7	1	1	9	0	0
12	46603529	.	C	T	2	2	4	0	0	4	0	0
12	46608710	.	G	A	3	10	13	0	0	13	0	0
12	46608849	.	A	T	10	3	13	0	0	13	0	0
12	46608946	.	C	G	5	8	13	0	0	13	0	0
12	46616449	.	C	T	6	9	15	0	2	17	0	0
12	46620187	.	A	G	9	6	15	0	0	15	0	0
12	46620220	.	T	C	9	8	17	0	0	17	0	0
12	46624466	.	C	T	2	8	10	0	1	11	0	0
12	46629160	.	G	C	3	5	8	0	0	8	0	0
12	46629215	.	A	T	6	6	12	0	0	12	0	0
12	46629345	.	A	G	10	6	16	0	1	17	0	0
12	46630805	.	C	T	7	6	13	0	1	14	0	0
12	46631267	.	G	T	3	6	9	0	0	9	0	0
12	46631329	.	T	A	2	3	5	0	0	5	0	0
12	46631454	.	G	A	1	7	8	0	0	8	0	0
12	46688007	.	C	T	9	8	17	0	0	17	0	0
12	46688078	.	C	T	8	10	18	0	0	18	0	0
12	46688224	.	T	C	10	12	22	0	0	22	0	0
12	46693103	.	C	T	14	7	21	0	0	21	0	0
12	46695674	.	A	G	2	4	6	0	0	6	0	0
12	46696895	.	T	C	1	2	3	0	0	3	0	0
12	46696908	.	G	A	0	3	3	0	1	4	0	0
12	46698280	.	G	T	0	8	8	0	4	12	0	0
12	46698283	.	T	A	3	7	10	0	0	10	0	0
12	46699492	.	A	G	6	0	6	0	6	12	0	0
12	46699624	.	C	T	10	6	16	0	0	16	0	0
12	46733790	.	G	A	1	18	19	0	14	33	0	0
12	46737278	.	T	C	15	22	37	0	0	37	0	0
12	46738259	.	A	T	22	0	22	1	1	24	0	0
12	46738288	.	C	A	7	13	20	1	0	21	0	0
12	46738325	.	T	G	5	1	6	0	7	13	0	0
12	46835828	.	A	T	2	2	4	0	0	4	0	0
12	46837879	.	G	A	2	2	4	0	0	4	0	0
12	46837904	.	T	G	2	4	6	0	0	6	0	0
12	46848643	.	G	T	8	8	16	0	0	16	0	0
12	46848652	.	C	T	7	8	15	0	1	16	0	0
12	46852982	.	C	T	8	5	13	0	0	13	0	0
12	46852988	.	T	C	4	6	10	0	1	11	0	0
12	46855065	.	A	G	15	0	15	0	9	24	0	0
12	46855074	.	C	T	15	9	24	0	0	24	0	0
12	46867324	.	C	T	14	12	26	6	1	33	0	0
12	46872795	.	T	C	3	5	8	3	0	11	0	0
12	46872815	.	A	G	4	0	4	0	6	10	0	0
12	46915362	.	C	T	10	3	13	0	0	13	0	0
12	46915452	.	T	C	11	6	17	0	0	17	0	0
12	46930650	.	A	G	4	4	8	0	0	8	0	0
12	46937292	.	A	C	9	5	14	1	0	15	0	0
12	46937351	.	T	C	8	8	16	0	0	16	0	0
12	46937422	.	A	T	6	6	12	0	1	13	0	0
12	46950892	.	A	C	2	4	6	0	0	6	0	0
12	46950966	.	T	C	1	0	1	0	9	10	0	0
12	46950976	.	G	T	1	8	9	0	0	9	0	0
12	46956898	.	C	T	0	6	6	0	11	17	0	0
12	46956916	.	G	A	11	5	16	0	0	16	0	0
12	46956985	.	C	T	2	5	7	0	0	7	0	0
12	46957012	.	C	T	1	7	8	0	1	9	0	0
12	46959885	.	T	G	3	8	11	0	0	11	0	0
12	46959935	.	T	C	7	6	13	0	1	14	0	0
12	46960595	.	G	C	11	7	18	0	2	20	0	0
12	46960596	.	T	A	11	7	18	0	2	20	0	0
12	46967967	.	C	T	18	14	32	0	0	32	0	0
12	46969482	.	T	C	16	17	33	0	1	34	0	0
12	46969488	.	G	A	1	19	20	0	14	34	0	0
12	46969557	.	C	T	16	14	30	0	0	30	0	0
12	46969602	.	T	C	21	16	37	0	1	38	0	0
12	46975549	.	T	G	18	18	36	0	0	36	0	0
12	46976075	.	A	G	17	12	29	0	2	31	0	0
12	46985337	.	A	C	10	17	27	0	2	29	0	0
12	46985461	.	C	T	18	15	33	0	0	33	0	0
12	46985509	.	C	A	11	13	24	0	1	25	0	0
12	46985540	.	T	A	12	16	28	0	1	29	0	0
12	46985648	.	G	A	7	8	15	0	1	16	0	0
12	46985666	.	T	C	13	5	18	0	0	18	0	0
12	46985691	.	A	T	10	2	12	0	3	15	0	0
12	46985740	.	T	A	11	3	14	0	1	15	0	0
12	46985749	.	T	G	9	3	12	0	0	12	0	0
12	46985884	.	G	T	17	8	25	0	1	26	0	0
12	46985886	.	C	A	18	8	26	0	0	26	0	0
12	47044878	.	A	T	12	24	36	0	0	36	0	0
12	47044890	.	C	A	9	23	32	0	1	33	0	0
12	47044920	.	G	A	0	16	16	1	8	25	0	0
12	47044952	.	G	A	17	11	28	1	0	29	0	0
12	47051363	.	A	G	13	14	27	0	2	29	0	0
12	47051481	.	C	T	21	17	38	0	2	40	0	0
12	47055396	.	T	A	17	18	35	0	2	37	0	0
12	47055513	.	T	C	21	7	28	0	1	29	0	0
12	47055546	.	C	T	13	11	24	0	1	25	0	0
12	47062488	.	C	T	14	11	25	0	1	26	0	0
12	47062513	.	C	A	19	11	30	0	0	30	0	0
12	47062548	.	T	C	18	9	27	0	1	28	0	0
12	47064466	.	G	A	19	16	35	0	0	35	0	0
12	47064654	.	C	T	14	18	32	0	1	33	0	0
12	47064657	.	G	C	14	17	31	0	2	33	0	0
12	47064864	.	G	T	18	9	27	0	0	27	0	0
12	47064888	.	G	A	15	12	27	1	0	28	0	0
12	47068624	.	C	T	17	18	35	0	1	36	0	0
12	47068720	.	C	A	11	11	22	0	1	23	0	0
12	47092536	.	A	C	5	2	7	0	0	7	0	0
12	47092563	.	T	C	3	4	7	0	0	7	0	0
12	47100378	.	G	A	0	3	3	0	2	5	0	0
12	47100396	.	G	A	0	4	4	0	2	6	0	0
12	47102770	.	T	C	2	3	5	0	0	5	0	0
12	47199750	.	C	G	9	3	12	1	0	13	0	0
12	47206404	.	C	G	2	0	2	0	5	7	0	0
12	47210442	.	C	G	10	6	16	0	0	16	0	0
12	47216354	.	T	C	3	8	11	0	1	12	0	0
12	47216390	.	A	T	6	5	11	0	0	11	0	0
12	47218135	.	G	T	0	4	4	0	1	5	0	0
12	47218183	.	G	A	0	2	2	0	2	4	0	0
12	47218210	.	C	T	3	3	6	0	0	6	0	0
12	47218252	.	G	A	6	5	11	0	0	11	0	0
12	47225058	.	C	T	4	3	7	0	1	8	0	0
12	47233215	.	C	A	3	7	10	0	0	10	0	0
12	47233520	.	T	A	8	10	18	0	0	18	0	0
12	47241639	.	T	C	10	13	23	0	0	23	0	0
12	47247816	.	C	T	12	12	24	0	0	24	0	0
12	47247858	.	C	T	11	13	24	0	1	25	0	0
12	47248184	.	G	A	1	9	10	0	7	17	0	0
12	47251230	.	T	C	4	8	12	0	2	14	0	0
12	47251242	.	C	T	7	5	12	0	0	12	0	0
12	47257184	.	G	C	8	5	13	1	1	15	0	0
12	47258306	.	G	C	0	7	7	0	11	18	0	0
12	47262385	.	A	T	10	9	19	0	0	19	0	0
12	47262817	.	C	T	6	15	21	0	0	21	0	0
12	47263246	.	C	T	11	9	20	0	0	20	0	0
12	47263258	.	G	C	0	12	12	0	8	20	0	0
12	47267408	.	C	T	6	14	20	0	2	22	0	0
12	47270288	.	C	T	18	8	26	0	0	26	0	0
12	47275118	.	T	A	23	10	33	0	3	36	0	0
12	47275326	.	C	G	13	8	21	0	2	23	0	0
12	47276192	.	C	T	12	12	24	0	0	24	0	0
12	47282131	.	G	A	1	20	21	0	7	28	0	0
12	47282137	.	G	A	7	18	25	0	1	26	0	0
12	47283506	.	C	T	12	13	25	0	0	25	0	0
12	47283514	.	A	G	12	14	26	0	1	27	0	0
12	47283544	.	G	C	9	10	19	0	0	19	0	0
12	47291529	.	G	C	1	10	11	0	20	31	0	0
12	47291685	.	G	A	14	20	34	0	1	35	0	0
12	47296608	.	T	A	16	18	34	0	0	34	0	0
12	47302810	.	G	A	10	15	25	0	0	25	0	0
12	47480947	.	A	C	11	0	11	0	29	40	0	0
12	47641659	.	C	T	0	8	8	11	23	42	0	0
12	47644855	.	C	A	2	5	7	30	1	38	0	0
12	47645851	.	G	A	25	17	42	0	1	43	0	0
12	47646485	.	G	A	17	11	28	0	2	30	0	0
12	47727305	.	C	T	0	2	2	0	2	4	0	0
12	47732236	.	G	A	2	2	4	0	1	5	0	0
12	47732302	.	A	C	1	4	5	0	0	5	0	0
12	47734429	.	C	T	1	3	4	0	0	4	0	0
12	47780293	.	C	T	1	3	4	0	2	6	0	0
12	47781034	.	C	T	2	5	7	0	1	8	0	0
12	47782583	.	G	A	3	4	7	0	0	7	0	0
12	47788524	.	T	C	2	3	5	0	0	5	0	0
12	47788534	.	T	C	3	4	7	0	0	7	0	0
12	47793774	.	C	T	0	2	2	0	2	4	0	0
12	47793805	.	G	C	0	2	2	0	1	3	0	0
12	47802633	.	C	T	2	2	4	0	0	4	0	0
12	47807917	.	C	G	2	0	2	0	3	5	0	0
12	47808289	.	C	A	1	3	4	0	1	5	0	0
12	47830328	.	T	C	4	4	8	0	0	8	0	0
12	47835355	.	G	A	0	4	4	0	6	10	0	0
12	47838894	.	G	A	4	5	9	1	0	10	0	0
12	47838942	.	C	T	2	2	4	1	0	5	0	0
12	47842232	.	T	C	9	4	13	0	0	13	0	0
12	47847414	.	G	C	8	3	11	0	0	11	0	0
12	47847543	.	C	T	1	4	5	0	2	7	0	0
12	47847892	.	G	A	1	3	4	0	3	7	0	0
12	47857113	.	C	T	5	4	9	0	0	9	0	0
12	47857125	.	T	C	4	6	10	0	0	10	0	0
12	47860342	.	T	C	4	2	6	0	0	6	0	0
12	47860351	.	C	T	5	1	6	0	0	6	0	0
12	47862172	.	G	C	1	2	3	0	1	4	0	0
12	47918804	.	G	A	1	5	6	0	3	9	0	0
12	47918826	.	C	A	4	3	7	0	1	8	0	0
12	47919665	.	C	T	7	5	12	0	0	12	0	0
12	47925952	.	A	G	4	0	4	0	5	9	0	0
12	47928722	.	C	A	2	2	4	1	0	5	0	0
12	47967867	.	C	T	0	4	4	0	7	11	0	0
12	47967868	.	G	A	7	4	11	0	0	11	0	0
12	47967906	.	C	A	3	5	8	0	0	8	0	0
12	47992776	.	G	A	1	2	3	0	0	3	0	0
12	48094293	.	G	T	6	9	15	0	0	15	0	0
12	48094308	.	G	A	5	8	13	0	0	13	0	0
12	48094399	.	A	T	3	8	11	0	0	11	0	0
12	48118981	.	G	A	1	3	4	0	0	5	1	0
12	48119153	.	T	G	2	5	7	0	0	7	0	0
12	48119855	.	C	T	0	3	3	0	3	6	0	0
12	48119934	.	C	T	1	2	3	0	0	3	0	0
12	48119941	.	A	G	2	1	3	0	1	4	0	0
12	48120110	.	T	C	1	2	3	0	0	3	0	0
12	48121455	.	A	T	1	2	3	0	0	3	0	0
12	48122232	.	C	T	1	2	3	0	0	3	0	0
12	48133239	.	G	A	8	6	14	0	0	14	0	0
12	48137949	.	G	A	7	3	10	0	0	10	0	0
12	48138307	.	A	G	7	4	11	0	0	11	0	0
12	48143336	.	G	A	6	8	14	0	0	14	0	0
12	48143427	.	C	T	4	3	7	0	2	9	0	0
12	48146371	.	C	T	3	5	8	0	0	8	0	0
12	48146395	.	G	T	4	3	7	0	0	7	0	0
12	48146841	.	C	T	2	5	7	0	9	16	0	0
12	48146880	.	C	T	1	5	6	0	2	8	0	0
12	48156327	.	C	T	0	7	7	0	2	9	0	0
12	48157055	.	C	T	1	2	3	0	4	7	0	0
12	48157135	.	G	A	8	5	13	0	1	14	0	0
12	48162177	.	C	A	6	5	11	0	1	12	0	0
12	48162237	.	G	A	3	4	7	0	0	7	0	0
12	48162291	.	T	A	8	5	13	0	1	14	0	0
12	48168094	.	G	A	4	10	14	0	0	14	0	0
12	48216789	.	A	T	3	5	8	0	0	8	0	0
12	48220624	.	C	G	5	8	13	0	1	14	0	0
12	48228265	.	A	C	5	6	11	0	1	12	0	0
12	48231039	.	G	A	1	3	4	0	7	11	0	0
12	48231108	.	G	T	4	6	10	0	0	10	0	0
12	48239927	.	C	T	4	4	8	0	0	8	0	0
12	48319235	.	A	T	7	7	14	0	0	14	0	0
12	48327550	.	T	G	2	7	9	0	0	9	0	0
12	48340578	.	G	A	12	7	19	0	0	19	0	0
12	48341936	.	G	A	1	6	7	0	8	15	0	0
12	48346807	.	C	T	2	6	8	0	1	9	0	0
12	48349836	.	C	T	2	14	16	0	8	24	0	0
12	48367360	.	C	T	1	7	8	0	11	19	0	0
12	48367442	.	T	G	13	17	30	0	1	31	0	0
12	48399590	.	T	C	3	2	5	0	1	6	0	0
12	48401980	.	G	T	7	2	9	0	0	9	0	0
12	48404465	.	C	A	4	4	8	0	0	8	0	0
12	48419281	.	G	C	4	9	13	0	0	13	0	0
12	48419359	.	T	G	5	5	10	0	0	10	0	0
12	48419420	.	A	G	5	4	9	0	0	9	0	0
12	48419683	.	A	T	1	2	3	0	0	3	0	0
12	48419867	.	C	T	1	5	6	0	6	12	0	0
12	48419921	.	T	C	5	6	11	0	0	11	0	0
12	48419936	.	T	C	6	0	6	0	8	14	0	0
12	48420640	.	A	G	7	6	13	0	0	13	0	0
12	48432078	.	C	T	0	12	12	0	14	26	0	0
12	48432716	.	G	T	11	14	25	0	0	25	0	0
12	48445813	.	G	A	3	3	6	0	0	6	0	0
12	48512050	.	G	T	11	9	20	0	2	22	0	0
12	48678396	.	G	A	1	6	7	0	10	17	0	0
12	48680163	.	A	T	4	7	11	0	0	11	0	0
12	48681658	.	T	C	5	11	16	0	0	16	0	0
12	48681663	.	G	A	2	5	7	0	12	19	0	0
12	48681826	.	A	T	10	6	16	0	0	16	0	0
12	48681827	.	T	A	9	6	15	0	1	16	0	0
12	48681942	.	A	T	7	4	11	0	0	11	0	0
12	48682419	.	A	G	6	4	10	0	0	10	0	0
12	48682629	.	T	G	3	7	10	0	0	10	0	0
12	48789038	.	T	C	3	5	8	0	0	8	0	0
12	48789831	.	C	T	2	11	13	0	0	13	0	0
12	48790891	.	G	A	0	2	2	0	4	6	0	0
12	48795544	.	C	T	5	2	7	0	0	7	0	0
12	48796831	.	C	T	3	7	10	0	0	10	0	0
12	48796933	.	G	A	0	4	4	0	12	16	0	0
12	48799261	.	C	T	3	11	14	0	0	14	0	0
12	48799268	.	G	A	11	4	15	0	1	16	0	0
12	48810338	.	C	T	20	12	32	1	0	33	0	0
12	48810690	.	C	T	6	5	11	0	0	11	0	0
12	48810879	.	C	T	5	5	10	0	0	10	0	0
12	48810960	.	G	A	0	6	6	0	10	16	0	0
12	48816218	.	A	G	7	0	7	0	14	21	0	0
12	48826364	.	C	T	12	23	35	0	1	36	0	0
12	48828350	.	C	T	10	10	20	0	1	21	0	0
12	48828356	.	C	G	9	11	20	0	0	20	0	0
12	48828461	.	C	T	9	13	22	0	0	22	0	0
12	48830367	.	T	G	12	0	12	0	6	18	0	0
12	48832417	.	C	A	13	6	19	0	1	20	0	0
12	48833090	.	T	C	12	15	27	0	0	27	0	0
12	48833165	.	C	T	19	12	31	0	0	31	0	0
12	48835113	.	C	T	14	14	28	0	0	28	0	0
12	48836141	.	T	C	14	13	27	0	1	28	0	0
12	48836348	.	A	G	10	4	14	0	1	15	0	0
12	48836482	.	G	A	16	8	24	0	0	24	0	0
12	48836576	.	A	G	8	0	8	0	8	16	0	0
12	48836627	.	T	C	1	4	5	0	0	5	0	0
12	48976104	.	A	G	3	1	4	0	1	5	0	0
13	10935	.	C	T	5	6	11	0	1	12	0	0
13	11043	.	G	C	11	8	19	0	0	19	0	0
13	12252	.	C	G	5	15	20	0	2	22	0	0
13	40594	.	A	G	1	4	5	0	0	5	0	0
13	40622	.	C	G	2	2	4	0	0	4	0	0
13	40868	.	A	T	2	5	7	0	1	8	0	0
13	40965	.	T	G	5	8	13	0	1	14	0	0
13	41161	.	C	T	0	11	11	0	8	19	0	0
13	41529	.	A	G	2	5	7	0	0	7	0	0
13	41896	.	C	T	0	2	2	0	2	4	0	0
13	42080	.	T	C	4	0	4	0	6	10	0	0
13	42123	.	C	T	3	5	8	0	0	8	0	0
13	42182	.	C	G	1	5	6	0	0	6	0	0
13	42771	.	C	T	4	5	9	0	0	9	0	0
13	46625	.	T	C	8	1	9	0	18	27	0	0
13	46637	.	G	A	9	18	27	0	0	27	0	0
13	49070	.	T	G	11	13	24	0	0	24	0	0
13	83970	.	C	T	0	4	4	0	6	10	0	0
13	111572	.	G	A	1	4	5	0	5	10	0	0
13	111804	.	C	T	12	4	16	0	2	18	0	0
13	113197	.	C	G	13	5	18	1	4	23	0	0
13	113203	.	C	G	11	8	19	1	5	25	0	0
13	214111	.	C	G	16	12	28	0	0	28	0	0
13	216562	.	A	G	14	10	24	0	3	27	0	0
13	217848	.	A	C	18	16	34	0	0	34	0	0
13	220842	.	T	C	15	0	15	0	21	36	0	0
13	220874	.	T	A	16	22	38	0	4	42	0	0
13	221131	.	C	A	16	19	35	0	1	36	0	0
13	221478	.	G	C	22	19	41	0	0	41	0	0
13	226047	.	G	C	1	2	3	0	0	3	0	0
13	237954	.	T	C	28	21	49	0	0	49	0	0
13	269861	.	C	T	0	5	5	0	4	9	0	0
13	270083	.	G	A	13	12	25	0	1	26	0	0
13	270110	.	C	T	1	10	11	0	16	27	0	0
13	271736	.	G	A	8	9	17	0	0	17	0	0
13	271802	.	A	G	4	7	11	0	0	11	0	0
13	280692	.	T	C	9	6	15	0	0	15	0	0
13	281330	.	T	C	32	25	57	2	1	60	0	0
13	281405	.	T	G	30	0	30	0	26	56	0	0
13	321752	.	C	T	0	8	8	0	10	18	0	0
13	322033	.	G	A	12	5	17	0	0	17	0	0
13	325797	.	G	A	6	5	11	0	0	11	0	0
13	329835	.	G	C	8	5	13	4	2	19	0	0
13	329876	.	C	T	9	8	17	0	2	19	0	0
13	329922	.	G	A	4	6	10	0	0	10	0	0
13	343336	.	G	T	8	6	14	0	0	14	0	0
13	343363	.	T	C	4	0	4	0	12	16	0	0
13	343510	.	C	T	0	8	8	0	4	12	0	0
13	343567	.	G	T	1	5	6	0	0	6	0	0
13	353503	.	C	A	3	2	5	0	0	5	0	0
13	353686	.	C	T	6	7	13	0	0	13	0	0
13	353728	.	A	C	4	0	4	0	6	10	0	0
13	353755	.	A	G	5	9	14	0	1	15	0	0
13	356834	.	C	G	0	9	9	0	7	16	0	0
13	357664	.	G	C	5	1	6	0	4	10	0	0
13	360461	.	C	T	0	2	2	0	5	7	0	0
13	364549	.	A	G	1	3	4	0	1	5	0	0
13	377238	.	T	C	1	2	3	0	0	3	0	0
13	421350	.	G	T	2	18	20	0	22	42	0	0
13	422990	.	T	C	19	21	40	0	0	40	0	0
13	425044	.	G	C	17	12	29	0	4	33	0	0
13	428646	.	G	A	12	18	30	0	2	32	0	0
13	428766	.	C	T	13	22	35	1	1	37	0	0
13	428841	.	C	T	26	10	36	0	0	36	0	0
13	429087	.	C	T	24	15	39	0	2	41	0	0
13	429144	.	A	G	26	0	26	0	16	42	0	0
13	429429	.	A	G	16	0	16	0	21	37	0	0
13	429514	.	C	T	10	10	20	0	0	20	0	0
13	429846	.	C	A	25	12	37	0	1	38	0	0
13	433939	.	C	T	1	4	5	0	0	5	0	0
13	450040	.	C	T	1	7	8	0	12	20	0	0
13	450101	.	C	T	13	8	21	0	1	22	0	0
13	452598	.	C	A	14	14	28	0	0	28	0	0
13	452615	.	G	T	14	14	28	0	1	29	0	0
13	454846	.	C	A	1	8	9	0	12	21	0	0
13	454919	.	A	G	5	12	17	0	0	17	0	0
13	455473	.	G	A	5	11	16	0	0	16	0	0
13	456637	.	G	A	11	13	24	0	0	24	0	0
13	458513	.	G	A	5	7	12	0	0	12	0	0
13	460740	.	T	C	6	0	6	0	12	18	0	0
13	460821	.	C	T	1	9	10	0	15	25	0	0
13	460845	.	C	T	17	11	28	0	1	29	0	0
13	460875	.	G	A	15	11	26	0	0	26	0	0
13	462042	.	C	A	0	8	8	0	11	19	0	0
13	462347	.	C	T	5	7	12	0	0	12	0	0
13	462368	.	G	A	4	10	14	0	1	15	0	0
13	462904	.	T	G	12	6	18	0	3	21	0	0
13	463687	.	C	T	13	6	19	0	1	20	0	0
13	465196	.	G	A	11	4	15	1	1	17	0	0
13	465329	.	T	A	8	10	18	0	2	20	0	0
13	465535	.	C	T	1	7	8	0	8	16	0	0
13	465538	.	C	A	2	7	9	0	6	15	0	0
13	465607	.	G	A	11	7	18	0	1	19	0	0
13	465734	.	A	G	7	10	17	0	0	17	0	0
13	466475	.	G	A	4	11	15	0	1	16	0	0
13	467509	.	G	A	12	8	20	0	0	20	0	0
13	468054	.	G	A	2	6	8	0	6	14	0	0
13	468090	.	G	A	6	7	13	0	0	13	0	0
13	472757	.	C	G	9	7	16	0	0	16	0	0
13	472759	.	G	A	7	8	15	0	1	16	0	0
13	473448	.	G	A	2	7	9	0	0	9	0	0
13	473466	.	T	G	3	7	10	0	0	10	0	0
13	478386	.	C	T	5	6	11	0	0	11	0	0
13	478485	.	G	A	5	9	14	0	0	14	0	0
13	483021	.	A	G	8	16	24	0	4	28	0	0
13	489773	.	T	C	14	7	21	0	1	22	0	0
13	490479	.	C	G	14	0	14	0	10	24	0	0
13	514385	.	C	T	25	16	41	0	0	41	0	0
13	514664	.	G	A	6	7	13	0	1	14	0	0
13	514790	.	T	A	5	5	10	0	0	10	0	0
13	517163	.	G	T	8	10	18	0	0	19	1	0
13	518113	.	T	C	4	1	5	0	10	15	0	0
13	518915	.	G	A	7	2	9	0	1	10	0	0
13	522036	.	G	T	7	9	16	0	0	16	0	0
13	526943	.	G	A	4	4	8	0	0	8	0	0
13	527832	.	C	T	5	7	12	0	0	12	0	0
13	529348	.	T	C	8	0	8	0	7	15	0	0
13	533133	.	T	A	1	2	3	0	0	3	0	0
13	541556	.	G	A	2	4	6	0	0	6	0	0
13	541557	.	C	T	2	4	6	0	0	6	0	0
13	543275	.	T	C	1	4	5	0	0	5	0	0
13	545531	.	C	A	3	3	6	0	0	6	0	0
13	555325	.	C	T	20	23	43	0	1	44	0	0
13	555326	.	G	A	23	18	41	0	0	41	0	0
13	556397	.	T	C	10	18	28	0	0	28	0	0
13	556398	.	T	C	10	18	28	0	0	28	0	0
13	556572	.	A	G	14	12	26	0	1	27	0	0
13	556601	.	A	T	10	14	24	0	1	25	0	0
13	556658	.	C	A	8	12	20	0	0	20	0	0
13	556729	.	G	T	15	15	30	0	0	30	0	0
13	561575	.	T	A	17	10	27	0	2	29	0	0
13	561587	.	A	T	11	16	27	0	1	28	0	0
13	562966	.	C	T	1	11	12	0	7	19	0	0
13	563089	.	G	A	15	9	24	0	0	24	0	0
13	563116	.	G	A	14	9	23	0	1	24	0	0
13	565622	.	C	T	1	10	11	0	9	20	0	0
13	565641	.	T	C	11	0	11	0	13	24	0	0
13	565660	.	G	A	12	10	22	0	2	24	0	0
13	566019	.	G	A	10	6	16	0	0	16	0	0
13	566046	.	G	A	8	13	21	0	0	21	0	0
13	566569	.	G	A	13	17	30	0	2	32	0	0
13	566604	.	T	C	12	0	12	0	19	31	0	0
13	575046	.	T	C	14	0	14	0	16	30	0	0
13	586283	.	C	A	0	13	13	0	9	22	0	0
13	587902	.	A	G	4	8	12	0	1	13	0	0
13	592473	.	G	A	9	5	14	0	1	15	0	0
13	615213	.	C	T	1	11	12	0	8	20	0	0
13	638303	.	C	A	7	9	16	0	0	16	0	0
13	638362	.	C	T	4	3	7	0	1	8	0	0
13	638447	.	C	T	1	2	3	0	2	5	0	0
13	652693	.	G	A	0	3	3	0	4	7	0	0
13	654791	.	G	A	3	5	8	0	1	9	0	0
13	658429	.	G	T	3	7	10	0	3	13	0	0
13	658800	.	G	A	1	3	4	0	2	6	0	0
13	658872	.	C	T	2	9	11	0	2	13	0	0
13	660254	.	C	T	1	3	4	0	1	5	0	0
13	660535	.	C	T	4	4	8	0	0	8	0	0
13	662595	.	G	C	7	3	10	0	0	10	0	0
13	662635	.	C	A	2	4	6	0	0	6	0	0
13	662673	.	C	T	5	2	7	0	0	7	0	0
13	662727	.	G	A	5	3	8	0	0	8	0	0
13	663330	.	A	T	6	3	9	0	1	10	0	0
13	663532	.	T	A	2	6	8	0	0	8	0	0
13	663573	.	G	A	2	11	13	0	6	19	0	0
13	663791	.	A	T	1	6	7	0	0	7	0	0
13	663920	.	A	T	12	6	18	0	0	18	0	0
13	664012	.	G	A	1	4	5	0	0	5	0	0
13	664139	.	C	T	4	3	7	0	0	7	0	0
13	664143	.	C	T	4	3	7	0	0	7	0	0
13	664196	.	A	G	1	0	1	0	7	8	0	0
13	664307	.	G	A	1	4	5	0	0	5	0	0
13	675139	.	C	A	4	9	13	0	0	13	0	0
13	677282	.	G	A	0	3	3	0	9	12	0	0
13	688200	.	G	A	0	2	2	0	1	3	0	0
13	696860	.	A	G	2	0	2	0	3	5	0	0
13	703552	.	C	A	3	1	4	0	1	5	0	0
13	703579	.	T	C	2	2	4	0	0	4	0	0
13	706679	.	C	G	4	3	7	0	0	7	0	0
13	706687	.	C	A	4	3	7	0	0	7	0	0
13	709009	.	G	T	1	4	5	0	0	5	0	0
13	710042	.	C	T	10	5	15	0	0	15	0	0
13	714117	.	C	G	4	11	15	0	0	15	0	0
13	718183	.	T	C	9	8	17	0	1	18	0	0
13	719316	.	C	T	8	7	15	0	1	16	0	0
13	719334	.	C	G	8	7	15	0	1	16	0	0
13	721290	.	C	T	11	5	16	0	1	17	0	0
13	721332	.	G	A	15	15	30	0	0	30	0	0
13	721617	.	C	T	13	12	25	0	0	25	0	0
13	724194	.	A	G	4	3	7	0	0	7	0	0
13	724249	.	C	T	1	2	3	0	0	3	0	0
13	733557	.	A	G	1	2	3	0	1	4	0	0
13	748105	.	T	C	5	3	8	0	0	8	0	0
13	748129	.	G	T	0	3	3	0	7	10	0	0
13	751102	.	G	A	4	3	7	0	1	8	0	0
13	751302	.	C	T	3	11	14	0	0	14	0	0
13	755685	.	T	A	3	4	7	0	0	7	0	0
13	760241	.	G	T	6	9	15	0	1	16	0	0
13	760298	.	C	T	7	5	12	0	0	12	0	0
13	760472	.	C	A	4	6	10	0	0	10	0	0
13	761063	.	T	C	6	4	10	0	0	10	0	0
13	761135	.	C	T	6	6	12	0	0	12	0	0
13	761228	.	A	T	3	4	7	0	1	8	0	0
13	762321	.	T	C	4	9	13	0	1	14	0	0
13	762322	.	G	A	4	9	13	0	1	14	0	0
13	763754	.	G	T	0	3	3	0	7	10	0	0
13	763775	.	A	C	5	4	9	0	0	9	0	0
13	773866	.	T	C	2	3	5	0	0	5	0	0
13	785074	.	T	G	11	9	20	0	0	20	0	0
13	793529	.	G	C	0	8	8	0	10	18	0	0
13	793631	.	C	T	10	6	16	0	2	18	0	0
13	802925	.	C	T	11	7	18	0	0	18	0	0
13	808361	.	A	G	6	4	10	0	0	10	0	0
13	808461	.	G	A	6	10	16	0	0	16	0	0
13	808530	.	A	C	11	8	19	0	1	20	0	0
13	808638	.	G	A	9	10	19	0	1	20	0	0
13	808648	.	G	A	11	8	19	0	1	20	0	0
13	808713	.	G	A	1	9	10	0	0	10	0	0
13	809286	.	G	A	0	2	2	0	1	3	0	0
13	809369	.	G	T	4	5	9	0	0	9	0	0
13	809615	.	G	T	4	5	9	0	0	9	0	0
13	809620	.	T	C	5	4	9	0	0	9	0	0
13	809992	.	C	T	7	9	16	0	0	16	0	0
13	810008	.	G	C	9	7	16	0	0	16	0	0
13	810158	.	A	G	3	0	3	0	7	10	0	0
13	810726	.	C	T	3	3	6	0	0	6	0	0
13	813868	.	T	C	7	3	10	0	1	11	0	0
13	814038	.	G	A	9	7	16	0	2	18	0	0
13	814191	.	G	C	4	8	12	0	0	12	0	0
13	814290	.	G	C	6	8	14	0	1	15	0	0
13	814459	.	G	A	5	9	14	0	0	14	0	0
13	814501	.	T	C	3	3	6	0	1	7	0	0
13	814719	.	G	A	16	8	24	0	0	24	0	0
13	817238	.	G	A	6	4	10	0	1	11	0	0
13	821506	.	A	G	4	5	9	0	1	10	0	0
13	826134	.	A	G	27	19	46	0	3	49	0	0
13	854419	.	G	A	6	8	14	0	0	14	0	0
13	854458	.	T	C	8	9	17	0	2	19	0	0
13	854588	.	A	C	10	0	10	0	11	21	0	0
13	854627	.	G	A	9	10	19	0	1	20	0	0
13	866428	.	G	A	2	2	4	0	0	4	0	0
13	912171	.	A	G	14	16	30	0	5	35	0	0
13	912212	.	C	T	10	23	33	0	0	33	0	0
13	950859	.	T	C	14	19	33	0	1	34	0	0
13	957336	.	A	C	22	15	37	0	3	40	0	0
13	977619	.	A	G	16	14	30	0	3	33	0	0
13	1016261	.	T	G	2	0	2	0	2	4	0	0
13	1016262	.	C	T	2	2	4	0	0	4	0	0
13	1090246	.	T	C	7	4	11	0	0	11	0	0
13	1095173	.	T	C	6	5	11	0	1	12	0	0
13	1096496	.	G	A	0	7	7	0	7	14	0	0
13	1096803	.	G	A	2	3	5	0	0	5	0	0
13	1107013	.	C	T	29	22	51	0	2	53	0	0
13	1115091	.	C	T	32	36	68	0	4	72	0	0
13	1115106	.	C	T	31	31	62	0	7	69	0	0
13	1120353	.	C	T	18	1	19	2	5	51	25	0
13	1125197	.	C	T	1	10	11	0	1	12	0	0
13	1125199	.	C	A	2	9	11	0	1	12	0	0
13	1125292	.	T	A	15	5	20	0	0	20	0	0
13	1125331	.	G	C	18	10	28	0	1	29	0	0
13	1125410	.	T	C	13	0	13	0	19	32	0	0
13	1129255	.	G	C	12	12	24	0	0	24	0	0
13	1129261	.	T	C	11	12	23	0	2	25	0	0
13	1129902	.	T	C	17	16	33	0	0	33	0	0
13	1135581	.	G	A	3	9	12	0	2	14	0	0
13	1135584	.	A	C	2	12	14	0	2	16	0	0
13	1138282	.	T	G	6	0	6	0	7	13	0	0
13	1139908	.	A	C	7	12	19	0	0	19	0	0
13	1140590	.	T	C	3	5	8	0	1	9	0	0
13	1140591	.	G	T	1	3	4	0	5	9	0	0
13	1140659	.	C	G	2	4	6	0	0	6	0	0
13	1140987	.	G	T	8	3	11	0	0	11	0	0
13	1140992	.	C	T	6	3	9	0	0	9	0	0
13	1142775	.	G	C	11	3	14	0	1	15	0	0
13	1142839	.	C	A	2	7	9	0	9	18	0	0
13	1142841	.	T	A	11	7	18	0	1	19	0	0
13	1142918	.	G	A	21	10	31	0	5	36	0	0
13	1146062	.	A	G	17	22	39	0	2	41	0	0
13	1146101	.	C	T	20	23	43	0	5	48	0	0
13	1149953	.	T	C	24	0	24	0	18	42	0	0
13	1167932	.	A	C	5	6	11	0	0	11	0	0
13	1167984	.	A	G	4	7	11	0	0	11	0	0
13	1168567	.	A	T	2	2	4	0	1	5	0	0
13	1168871	.	T	C	5	3	8	0	0	8	0	0
13	1168905	.	T	C	6	2	8	0	0	8	0	0
13	1169280	.	A	G	4	2	6	0	0	6	0	0
13	1169539	.	T	C	3	8	11	0	0	11	0	0
13	1169695	.	G	A	4	4	8	0	0	8	0	0
13	1170418	.	T	G	5	0	5	0	6	11	0	0
13	1197080	.	T	C	2	1	3	0	0	3	0	0
13	1197086	.	T	C	2	2	4	0	0	4	0	0
13	1197218	.	G	A	2	5	7	0	0	7	0	0
13	1197242	.	G	A	3	2	5	0	0	5	0	0
13	1205370	.	A	T	2	2	4	0	0	4	0	0
13	1205375	.	C	G	2	2	4	0	0	4	0	0
13	1205618	.	A	G	5	5	10	0	0	10	0	0
13	1205798	.	A	G	2	0	2	0	7	9	0	0
13	1208354	.	C	T	2	2	4	0	0	4	0	0
13	1208813	.	T	A	6	2	8	0	2	10	0	0
13	1307133	.	A	G	0	2	2	0	1	3	0	0
13	1374455	.	T	C	11	6	17	0	0	17	0	0
13	1374773	.	T	C	5	10	15	0	0	15	0	0
13	1382002	.	C	A	6	7	13	0	0	13	0	0
13	1382019	.	C	T	8	7	15	0	3	18	0	0
13	1382148	.	G	C	0	8	8	1	3	12	0	0
13	1382152	.	G	T	0	2	2	1	8	11	0	0
13	1394582	.	G	C	2	3	5	0	0	5	0	0
13	1394938	.	G	A	1	5	6	0	3	9	0	0
13	1394941	.	G	A	4	4	8	0	1	9	0	0
13	1394978	.	A	G	9	3	12	0	1	13	0	0
13	1415315	.	C	G	1	13	14	0	9	23	0	0
13	1415511	.	A	T	10	10	20	0	1	21	0	0
13	1416074	.	C	A	7	11	18	0	1	19	0	0
13	1416098	.	G	A	9	9	18	0	1	19	0	0
13	1418932	.	G	A	6	7	13	0	0	13	0	0
13	1421302	.	T	C	5	1	6	0	6	12	0	0
13	1421341	.	T	C	2	0	2	0	8	10	0	0
13	1422111	.	G	A	7	5	12	0	0	12	0	0
13	1423520	.	G	A	8	4	12	0	1	14	1	0
13	1423568	.	G	A	8	6	14	0	1	15	0	0
13	1425462	.	T	G	4	5	9	0	1	10	0	0
13	1430246	.	T	A	2	5	7	0	0	7	0	0
13	1515796	.	C	T	3	2	5	0	1	6	0	0
13	1532751	.	C	T	3	4	7	0	0	7	0	0
13	1536945	.	C	T	4	4	8	0	0	8	0	0
13	1538689	.	T	A	6	9	15	0	0	15	0	0
13	1539079	.	G	C	9	8	17	0	0	17	0	0
13	1540688	.	C	T	7	13	20	0	0	20	0	0
13	1540707	.	C	A	4	12	16	0	2	18	0	0
13	1540974	.	C	G	6	10	16	0	1	17	0	0
13	1542540	.	C	T	5	6	11	0	0	11	0	0
13	1542630	.	T	C	6	13	19	0	2	21	0	0
13	1542763	.	G	T	6	8	14	0	0	14	0	0
13	1543833	.	A	C	4	4	8	0	0	8	0	0
13	1577695	.	T	C	9	14	23	0	0	23	0	0
13	1577716	.	A	G	14	7	21	0	2	23	0	0
13	1577746	.	A	T	9	15	24	0	1	25	0	0
13	1577755	.	A	G	16	7	23	0	1	24	0	0
13	1577896	.	G	A	11	8	19	0	0	19	0	0
13	1577904	.	C	T	9	7	16	0	1	17	0	0
13	1577997	.	T	A	11	12	23	0	0	23	0	0
13	1585125	.	G	A	6	8	14	0	2	16	0	0
13	1585203	.	C	T	11	9	20	0	0	20	0	0
13	1585679	.	G	A	6	9	15	0	0	15	0	0
13	1588052	.	A	G	13	0	13	0	15	28	0	0
13	1588073	.	T	C	13	11	24	0	0	24	0	0
13	1590235	.	G	A	2	4	6	0	8	14	0	0
13	1590321	.	G	C	10	3	13	0	0	13	0	0
13	1592342	.	G	A	14	7	21	0	0	21	0	0
13	1592362	.	G	A	15	7	22	0	1	23	0	0
13	1592401	.	A	G	10	15	25	0	1	26	0	0
13	1592710	.	A	G	12	0	12	0	18	30	0	0
13	1595642	.	G	A	1	7	8	0	9	17	0	0
13	1595749	.	T	C	5	14	19	0	1	20	0	0
13	1595898	.	A	G	7	5	12	0	3	15	0	0
13	1595938	.	A	G	10	6	16	0	0	16	0	0
13	1599692	.	A	G	15	13	28	0	1	29	0	0
13	1599825	.	G	T	1	13	14	0	11	25	0	0
13	1600001	.	G	T	3	5	8	0	1	9	0	0
13	1600264	.	T	A	15	11	26	0	0	26	0	0
13	1600582	.	G	T	1	15	16	0	14	30	0	0
13	1627605	.	G	A	19	8	27	0	1	28	0	0
13	1632106	.	G	A	11	11	22	0	1	23	0	0
13	1634479	.	A	G	20	18	38	1	0	39	0	0
13	1641762	.	C	T	14	16	30	0	0	30	0	0
13	1641827	.	A	G	11	17	28	0	1	29	0	0
13	1643933	.	C	T	16	22	38	0	0	38	0	0
13	1648470	.	G	A	15	15	30	0	1	31	0	0
13	1649725	.	C	T	13	11	24	0	0	24	0	0
13	1650683	.	A	G	13	19	32	0	0	32	0	0
13	1650938	.	G	C	10	23	33	0	1	34	0	0
13	1651706	.	A	G	25	0	25	0	17	42	0	0
13	1651727	.	C	T	27	13	40	0	1	41	0	0
13	1655426	.	T	C	19	18	37	0	1	38	0	0
13	1655767	.	T	C	13	16	29	0	0	29	0	0
13	1655905	.	G	A	12	12	24	0	1	26	1	0
13	1661740	.	A	G	13	18	31	0	1	32	0	0
13	1666388	.	A	G	9	1	10	0	15	25	0	0
13	1666412	.	A	G	11	0	11	0	18	29	0	0
13	1666451	.	T	C	8	19	27	0	1	28	0	0
13	1667865	.	T	A	23	19	42	0	1	43	0	0
13	1676895	.	G	A	2	19	21	0	19	40	0	0
13	1677009	.	G	T	0	12	12	0	15	27	0	0
13	1677859	.	G	T	11	16	27	0	0	27	0	0
13	1677913	.	C	T	17	14	31	0	0	31	0	0
13	1677958	.	A	G	12	0	12	0	19	31	0	0
13	1682856	.	T	C	13	8	21	0	0	21	0	0
13	1682910	.	C	G	19	0	19	0	11	30	0	0
13	1682928	.	C	G	19	10	29	0	0	29	0	0
13	1685150	.	G	C	19	24	43	1	0	44	0	0
13	1685192	.	A	T	24	27	51	0	1	52	0	0
13	1691983	.	T	A	22	19	41	0	0	41	0	0
13	1693284	.	G	A	2	16	18	0	21	39	0	0
13	1693312	.	C	A	28	19	47	0	0	47	0	0
13	1693386	.	C	T	17	18	35	0	0	35	0	0
13	1693392	.	C	T	19	17	36	0	1	37	0	0
13	1694395	.	C	A	12	17	29	0	1	30	0	0
13	1694417	.	C	A	12	19	31	0	0	31	0	0
13	1707294	.	T	C	27	21	48	0	0	48	0	0
13	1719777	.	G	A	2	29	31	0	23	54	0	0
13	1981596	.	G	A	4	8	12	0	0	12	0	0
13	2254607	.	A	T	1	3	4	0	0	4	0	0
13	2254638	.	T	C	3	2	5	0	0	5	0	0
13	2254751	.	T	A	1	3	4	0	0	4	0	0
13	2254753	.	G	C	2	0	2	0	3	5	0	0
13	2262104	.	G	A	1	2	3	0	0	3	0	0
13	2262191	.	G	A	4	3	7	0	0	7	0	0
13	2263308	.	C	G	5	3	8	0	1	9	0	0
13	2273835	.	G	A	3	4	7	0	0	7	0	0
13	2357927	.	A	G	10	7	17	0	1	18	0	0
13	2370529	.	G	T	0	17	17	0	9	26	0	0
13	2370556	.	G	T	1	21	22	0	5	27	0	0
13	2384958	.	A	G	11	12	23	0	1	24	0	0
13	2385812	.	G	A	18	13	31	0	0	31	0	0
13	2391803	.	A	G	23	0	23	0	13	36	0	0
13	2391818	.	A	G	18	14	32	0	5	37	0	0
13	2391964	.	G	C	12	11	23	0	1	24	0	0
13	2391965	.	A	T	12	12	24	0	0	24	0	0
13	2392342	.	G	A	2	4	6	0	1	7	0	0
13	2392397	.	G	A	5	7	12	0	1	13	0	0
13	2392459	.	A	G	7	0	7	0	9	16	0	0
13	2414234	.	C	T	3	7	10	0	0	10	0	0
13	2416172	.	T	C	5	5	10	0	1	11	0	0
13	2416401	.	A	T	1	4	5	0	1	6	0	0
13	2416580	.	T	A	1	3	4	0	0	4	0	0
13	2416764	.	A	T	3	4	7	0	0	7	0	0
13	2416807	.	A	G	2	5	7	0	0	7	0	0
13	2416987	.	A	G	1	2	3	0	1	4	0	0
13	2417060	.	G	A	5	5	10	1	0	11	0	0
13	2417235	.	C	T	3	2	5	0	0	5	0	0
13	2417251	.	C	T	2	2	4	0	1	5	0	0
13	2427026	.	G	A	4	2	6	0	1	7	0	0
13	2427174	.	C	T	13	10	23	0	1	24	0	0
13	2427175	.	T	G	12	11	23	0	1	24	0	0
13	2427251	.	T	A	3	3	6	0	0	6	0	0
13	2427331	.	T	C	6	5	11	0	0	11	0	0
13	2427446	.	G	C	3	9	12	0	0	12	0	0
13	2427450	.	G	A	4	11	15	0	0	15	0	0
13	2427702	.	T	C	21	3	24	0	19	43	0	0
13	2436227	.	T	A	30	19	49	0	1	50	0	0
13	2439886	.	C	T	26	18	44	0	4	48	0	0
13	2453231	.	C	G	3	0	3	0	3	6	0	0
13	2460907	.	T	A	2	3	5	0	0	5	0	0
13	2460971	.	T	C	6	3	9	0	0	9	0	0
13	2463337	.	C	T	0	2	2	0	1	3	0	0
13	2463397	.	G	A	3	2	5	0	1	6	0	0
13	2464062	.	T	C	2	5	7	0	0	7	0	0
13	2468052	.	G	T	9	8	17	0	0	17	0	0
13	2468070	.	G	A	12	10	22	0	0	22	0	0
13	2468112	.	G	A	10	7	17	0	0	17	0	0
13	2471791	.	A	G	5	7	12	0	1	13	0	0
13	2471821	.	G	A	6	10	16	0	0	16	0	0
13	2473319	.	T	G	3	0	3	0	6	9	0	0
13	2473424	.	T	C	5	5	10	0	0	10	0	0
13	2477812	.	C	T	7	9	16	0	0	16	0	0
13	2478271	.	G	A	7	3	10	0	0	10	0	0
13	2480657	.	G	A	3	2	5	0	1	6	0	0
13	2480678	.	T	C	4	2	6	0	0	6	0	0
13	2483101	.	A	G	3	0	3	0	5	8	0	0
13	2483134	.	A	G	5	7	12	0	0	12	0	0
13	2483989	.	C	T	3	3	6	0	0	6	0	0
13	2485928	.	C	T	8	5	13	0	1	14	0	0
13	2492930	.	G	A	1	2	3	0	1	4	0	0
13	2495872	.	C	T	10	4	14	0	1	16	1	0
13	2496334	.	C	T	8	9	17	0	0	17	0	0
13	2496496	.	T	A	5	11	16	0	0	16	0	0
13	2520778	.	G	A	15	15	30	0	0	30	0	0
13	2520834	.	C	T	14	6	20	0	1	21	0	0
13	2746311	.	A	C	18	15	33	0	1	34	0	0
13	2764899	.	C	T	8	10	18	0	0	18	0	0
13	2819432	.	C	T	23	13	36	0	2	38	0	0
13	2827605	.	G	T	11	18	29	0	0	29	0	0
13	2827670	.	C	T	15	5	20	0	1	21	0	0
13	2827773	.	A	G	9	3	12	0	0	12	0	0
13	2827808	.	A	G	0	8	8	0	0	8	0	0
13	2827832	.	G	T	22	8	30	0	0	30	0	0
13	2827844	.	T	C	20	8	28	1	1	30	0	0
13	2827867	.	A	G	6	15	21	1	1	23	0	0
13	2827918	.	A	T	3	5	8	1	0	9	0	0
13	2874928	.	A	C	4	2	6	0	0	6	0	0
13	2875626	.	G	T	3	2	5	0	0	5	0	0
13	2877721	.	A	G	2	5	7	0	1	8	0	0
13	2879201	.	A	G	3	2	5	0	1	6	0	0
13	2882422	.	T	C	7	3	10	0	0	10	0	0
13	2882614	.	A	G	4	5	9	0	0	9	0	0
13	2882632	.	C	T	3	5	8	0	1	9	0	0
13	2889282	.	A	C	1	2	3	0	3	6	0	0
13	2899483	.	G	A	7	3	10	0	0	10	0	0
13	2901620	.	G	A	7	4	11	0	0	11	0	0
13	2901630	.	C	A	7	5	12	0	0	12	0	0
13	2913822	.	C	T	12	12	24	0	1	25	0	0
13	2927676	.	C	T	1	9	10	0	16	26	0	0
13	2927832	.	T	A	10	12	22	0	8	30	0	0
13	2932666	.	G	C	8	6	14	0	0	14	0	0
13	2938391	.	T	C	3	4	7	0	1	8	0	0
13	2946665	.	T	A	6	5	11	0	0	11	0	0
13	3109186	.	C	A	2	7	9	0	0	9	0	0
13	3125577	.	A	G	8	5	13	0	0	13	0	0
13	3154901	.	T	A	3	3	6	0	0	6	0	0
13	3154956	.	G	C	5	5	10	0	0	10	0	0
13	3155196	.	T	A	2	5	7	0	0	7	0	0
13	3263932	.	T	C	5	0	5	0	7	12	0	0
13	3263990	.	G	A	6	2	8	0	1	9	0	0
13	3264012	.	G	A	5	5	10	0	0	10	0	0
13	3264063	.	G	C	6	0	6	0	8	14	0	0
13	3264467	.	C	A	3	3	6	0	1	7	0	0
13	3269340	.	G	A	11	9	20	0	0	20	0	0
13	3270110	.	C	T	1	6	7	0	6	13	0	0
13	3272706	.	C	A	0	4	4	0	5	9	0	0
13	3272735	.	G	C	6	5	11	0	0	11	0	0
13	3275094	.	T	C	3	0	3	0	5	8	0	0
13	3278079	.	A	G	3	3	6	1	0	7	0	0
13	3279525	.	A	G	5	5	10	0	1	11	0	0
13	3279591	.	G	A	5	9	14	0	0	14	0	0
13	3284747	.	G	A	6	3	9	0	0	9	0	0
13	3284780	.	C	T	0	6	6	0	4	10	0	0
13	3287096	.	C	T	1	6	7	0	7	14	0	0
13	3287268	.	C	A	6	6	12	0	0	12	0	0
13	3289120	.	T	C	2	4	6	0	0	6	0	0
13	3289513	.	T	C	8	5	13	0	0	13	0	0
13	3299562	.	G	A	4	5	9	0	1	10	0	0
13	3302783	.	G	T	3	4	7	0	0	7	0	0
13	3313102	.	G	A	2	3	5	0	0	5	0	0
13	3321859	.	C	T	2	8	10	0	0	10	0	0
13	3322054	.	C	T	4	3	7	0	0	7	0	0
13	3354930	.	C	T	9	4	13	0	0	13	0	0
13	3357683	.	C	T	0	6	6	0	2	8	0	0
13	3420158	.	G	T	1	3	4	0	0	4	0	0
13	3423584	.	A	T	6	3	9	0	0	9	0	0
13	3423585	.	T	G	6	3	9	0	0	9	0	0
13	3474211	.	G	C	5	0	5	0	4	9	0	0
13	3474261	.	A	C	2	3	5	0	0	5	0	0
13	3474304	.	C	T	4	1	5	0	0	5	0	0
13	3474310	.	C	T	0	2	2	0	5	7	0	0
13	3474346	.	G	A	9	4	13	0	0	13	0	0
13	3474361	.	G	A	9	6	15	0	0	15	0	0
13	3826346	.	G	A	0	5	5	0	2	7	0	0
13	3826354	.	A	T	2	4	6	0	0	6	0	0
13	3832618	.	A	C	2	4	6	0	1	7	0	0
13	3843687	.	G	A	0	2	2	0	1	3	0	0
13	3874427	.	A	G	5	5	10	0	1	11	0	0
13	3874618	.	T	C	9	11	20	0	0	20	0	0
13	3874815	.	T	C	7	0	7	0	7	14	0	0
13	3874831	.	T	C	8	5	13	0	0	13	0	0
13	3874903	.	C	A	0	2	2	0	9	11	0	0
13	3874909	.	G	A	9	1	10	0	0	10	0	0
13	3874983	.	A	G	5	4	9	0	0	9	0	0
13	3875113	.	C	G	5	9	14	0	1	15	0	0
13	3881204	.	T	C	5	5	10	0	1	11	0	0
13	3881208	.	G	T	4	6	10	0	0	10	0	0
13	3881269	.	C	G	11	6	17	0	1	18	0	0
13	3885350	.	A	C	3	6	9	0	1	10	0	0
13	3885359	.	G	T	2	7	9	0	0	9	0	0
13	3915908	.	A	G	6	4	10	0	2	12	0	0
13	3916150	.	A	G	13	14	27	0	4	31	0	0
13	3916198	.	A	G	17	10	27	0	0	27	0	0
13	3916377	.	G	A	13	11	24	0	2	26	0	0
13	3919020	.	T	C	19	0	19	0	19	38	0	0
13	3919057	.	A	C	18	17	35	0	0	35	0	0
13	3919136	.	A	T	19	8	27	0	0	27	0	0
13	3919167	.	A	G	19	13	32	0	1	33	0	0
13	3919555	.	T	C	17	15	32	0	2	34	0	0
13	3919632	.	A	G	14	19	33	0	0	33	0	0
13	3919672	.	T	G	14	16	30	0	0	30	0	0
13	3919686	.	G	A	16	18	34	0	1	35	0	0
13	3920759	.	C	T	0	15	15	0	10	25	0	0
13	3922791	.	T	C	14	11	25	0	1	26	0	0
13	3927916	.	T	C	11	11	22	0	3	25	0	0
13	3927931	.	T	C	14	10	24	0	0	24	0	0
13	3936482	.	C	G	15	22	37	0	0	37	0	0
13	3938574	.	C	A	14	10	24	0	1	25	0	0
13	3938619	.	C	A	19	14	33	0	1	34	0	0
13	3942055	.	G	A	0	9	9	0	19	28	0	0
13	3949847	.	G	A	8	11	19	0	1	20	0	0
13	3949978	.	T	G	11	2	13	0	15	28	0	0
13	3950007	.	G	A	18	9	27	0	0	28	1	0
13	3950074	.	A	T	13	12	25	0	0	25	0	0
13	3950181	.	T	C	21	13	34	0	0	34	0	0
13	3950497	.	G	T	10	8	18	0	0	18	0	0
13	3950669	.	T	A	9	7	16	0	1	17	0	0
13	3954611	.	C	T	9	8	17	0	0	17	0	0
13	3958895	.	C	T	13	5	18	0	0	18	0	0
13	3962569	.	C	T	3	4	7	0	1	8	0	0
13	3962845	.	C	T	3	7	10	0	2	12	0	0
13	3965966	.	G	A	9	10	19	0	0	19	0	0
13	3982429	.	A	G	3	4	7	0	0	7	0	0
13	3982711	.	C	T	3	4	7	0	0	7	0	0
13	3983112	.	G	C	4	2	6	0	1	7	0	0
13	3983754	.	A	C	2	0	2	0	3	5	0	0
13	4000625	.	A	G	2	5	7	0	0	7	0	0
13	4018624	.	A	T	3	3	6	0	0	6	0	0
13	4084284	.	G	A	2	3	5	0	0	5	0	0
13	4213240	.	G	A	5	2	7	0	1	8	0	0
13	4213291	.	A	C	5	3	8	0	0	8	0	0
13	4213300	.	C	T	6	6	12	0	1	13	0	0
13	4213804	.	G	A	9	5	14	0	0	14	0	0
13	4226664	.	C	A	14	12	26	0	3	29	0	0
13	4231438	.	T	A	12	8	20	0	2	22	0	0
13	4231819	.	G	A	12	9	21	0	1	22	0	0
13	4231869	.	A	G	10	10	20	0	2	22	0	0
13	4231899	.	A	G	5	12	17	0	3	20	0	0
13	4232051	.	G	A	4	4	8	0	0	8	0	0
13	4232054	.	A	T	4	4	8	0	0	8	0	0
13	4232171	.	C	T	17	14	31	0	2	33	0	0
13	4232280	.	T	C	29	14	43	0	1	44	0	0
13	4232284	.	T	C	29	14	43	0	3	46	0	0
13	4232324	.	T	G	22	15	37	0	0	37	0	0
13	4232358	.	A	T	24	13	37	0	0	37	0	0
13	4232396	.	G	A	24	8	32	2	2	36	0	0
13	4232400	.	A	T	24	5	29	2	1	32	0	0
13	4232718	.	G	A	8	5	13	0	2	15	0	0
13	4233030	.	C	T	1	17	18	0	23	41	0	0
13	4233033	.	G	A	18	22	40	0	0	40	0	0
13	4233167	.	T	A	15	16	31	0	1	32	0	0
13	4233361	.	G	T	10	11	21	0	1	23	1	0
13	4233365	.	G	A	11	11	22	0	0	22	0	0
13	4233625	.	T	A	11	12	23	0	2	25	0	0
13	4233779	.	G	A	17	14	31	0	3	34	0	0
13	4233889	.	G	A	10	7	17	0	0	17	0	0
13	4233911	.	G	C	10	10	20	0	0	20	0	0
13	4233952	.	T	G	11	14	25	0	1	26	0	0
13	4234337	.	G	A	18	15	33	0	0	33	0	0
13	4234349	.	G	T	15	19	34	0	2	36	0	0
13	4234655	.	G	A	27	15	42	0	2	44	0	0
13	4251236	.	G	A	4	14	18	0	1	19	0	0
13	4256617	.	A	G	11	17	28	0	1	29	0	0
13	4307752	.	A	G	10	9	19	0	0	19	0	0
13	4307782	.	C	T	14	12	26	0	0	26	0	0
13	4307934	.	T	C	18	16	34	0	1	35	0	0
13	4308269	.	G	A	9	12	21	0	0	21	0	0
13	4308841	.	T	G	11	12	23	0	1	24	0	0
13	4309166	.	T	G	12	14	26	0	0	26	0	0
13	4310247	.	G	A	9	19	28	0	0	28	0	0
13	4310440	.	G	C	18	0	18	0	20	38	0	0
13	4310511	.	C	T	1	15	16	0	22	38	0	0
13	4310565	.	G	A	22	18	40	0	0	40	0	0
13	4310568	.	A	T	20	22	42	0	0	42	0	0
13	4310610	.	C	T	20	15	35	0	0	35	0	0
13	4311081	.	T	C	12	16	28	0	1	29	0	0
13	4311578	.	T	C	20	0	20	0	14	35	1	0
13	4311699	.	G	T	18	16	34	0	1	35	0	0
13	4311912	.	C	T	14	7	21	0	1	22	0	0
13	4317628	.	C	T	0	8	8	0	7	15	0	0
13	4317721	.	T	C	9	10	19	0	1	20	0	0
13	4320905	.	T	C	7	9	16	0	4	20	0	0
13	4321153	.	T	C	12	9	21	0	3	24	0	0
13	4321382	.	C	T	5	5	10	0	1	11	0	0
13	4321507	.	A	C	11	0	11	0	13	24	0	0
13	4321741	.	T	G	11	5	16	0	0	16	0	0
13	4325167	.	G	C	4	1	5	0	8	13	0	0
13	4330240	.	G	A	8	5	13	0	0	13	0	0
13	4330282	.	A	T	5	8	13	0	2	15	0	0
13	4332807	.	G	A	8	3	11	0	1	12	0	0
13	4335370	.	T	G	1	2	3	0	0	3	0	0
13	4339382	.	C	T	4	7	11	0	0	11	0	0
13	4343183	.	C	T	1	6	7	0	8	15	0	0
13	4343216	.	A	T	11	7	18	0	0	18	0	0
13	4343221	.	T	A	11	7	18	0	0	18	0	0
13	4343490	.	G	A	12	7	19	0	1	20	0	0
13	4343931	.	G	A	6	6	12	1	1	14	0	0
13	4344100	.	C	G	7	6	13	0	0	13	0	0
13	4344159	.	C	G	6	6	12	0	0	12	0	0
13	4344800	.	T	C	10	11	21	0	0	21	0	0
13	4347474	.	T	G	4	5	9	0	0	9	0	0
13	4347531	.	T	C	4	5	9	0	0	9	0	0
13	4347627	.	C	A	2	6	8	0	1	9	0	0
13	4349830	.	G	T	1	7	8	0	0	8	0	0
13	4350442	.	A	G	5	3	8	0	0	8	0	0
13	4352724	.	C	T	6	5	11	0	0	11	0	0
13	4354424	.	G	T	8	5	13	0	0	13	0	0
13	4354457	.	A	G	4	5	9	0	1	10	0	0
13	4354596	.	T	A	1	2	3	0	0	3	0	0
13	4354644	.	T	C	5	3	8	0	0	8	0	0
13	4354649	.	T	C	3	0	3	0	4	7	0	0
13	4360778	.	G	A	2	4	6	0	0	6	0	0
13	4361838	.	A	C	1	4	5	0	0	5	0	0
13	4361847	.	A	G	5	2	7	0	0	7	0	0
13	4364680	.	A	G	2	4	6	0	0	6	0	0
13	4364700	.	C	T	3	3	6	0	0	6	0	0
13	4364916	.	A	G	5	2	7	0	0	7	0	0
13	4366180	.	C	A	1	5	6	0	0	6	0	0
13	4366431	.	T	A	2	3	5	0	0	5	0	0
13	4366627	.	C	G	1	5	6	0	0	6	0	0
13	4366807	.	A	G	1	2	3	0	0	3	0	0
13	4366813	.	C	A	1	2	3	0	0	3	0	0
13	4366911	.	C	T	2	4	6	0	0	6	0	0
13	4368536	.	T	C	4	10	14	0	0	14	0	0
13	4398802	.	A	G	9	1	10	0	11	21	0	0
13	4399345	.	A	G	2	3	5	0	0	5	0	0
13	4399667	.	G	A	3	6	9	0	2	11	0	0
13	4399702	.	G	A	4	4	8	0	1	9	0	0
13	4399786	.	T	C	8	7	15	0	0	15	0	0
13	4399909	.	T	G	1	2	3	0	0	3	0	0
13	4400462	.	A	C	6	2	8	3	1	12	0	0
13	4400464	.	C	G	6	3	9	3	0	12	0	0
13	4400550	.	T	G	1	2	3	0	0	3	0	0
13	4406090	.	T	A	11	15	26	0	0	26	0	0
13	4406816	.	T	C	22	7	29	0	2	31	0	0
13	4406937	.	T	A	9	3	12	0	1	13	0	0
13	4418489	.	C	A	1	2	3	0	0	3	0	0
13	4505143	.	T	C	3	2	5	0	0	5	0	0
13	4544101	.	G	A	3	6	9	0	0	9	0	0
13	4600689	.	A	G	2	4	6	0	0	6	0	0
13	4602243	.	G	A	3	4	7	0	1	8	0	0
13	4608152	.	T	C	7	6	13	0	0	13	0	0
13	4611061	.	C	T	2	6	8	0	0	8	0	0
13	4615169	.	T	C	3	3	6	0	0	6	0	0
13	4663444	.	A	G	6	4	10	0	1	11	0	0
13	4664226	.	A	G	3	3	6	0	0	6	0	0
13	4713152	.	G	C	11	10	21	0	0	21	0	0
13	4713193	.	C	G	4	11	15	0	0	15	0	0
13	4713310	.	A	T	5	5	10	0	0	10	0	0
13	4713373	.	T	A	7	7	14	0	1	15	0	0
13	4713478	.	G	A	8	7	15	0	0	15	0	0
13	4722236	.	A	G	0	2	2	0	0	2	0	0
13	4728970	.	G	A	2	2	4	0	0	4	0	0
13	4729051	.	C	A	1	4	5	0	0	5	0	0
13	4872079	.	G	A	8	17	25	0	0	25	0	0
13	4872121	.	C	T	21	8	29	0	1	30	0	0
13	4888273	.	G	A	1	12	13	0	12	25	0	0
13	4899623	.	A	G	16	9	25	0	0	25	0	0
13	4945804	.	C	T	16	9	25	0	0	25	0	0
13	4948345	.	G	A	22	11	33	0	1	34	0	0
13	4968421	.	A	G	17	11	28	0	0	28	0	0
13	4968583	.	T	A	19	9	28	0	0	29	1	0
13	4968727	.	G	A	11	6	17	0	2	19	0	0
13	4968890	.	T	C	13	14	27	0	0	27	0	0
13	4968931	.	T	A	15	16	31	0	1	32	0	0
13	4973556	.	T	A	5	3	8	0	0	8	0	0
13	4978680	.	A	G	12	11	23	1	3	27	0	0
13	4978885	.	T	C	15	11	26	0	1	27	0	0
13	4978887	.	C	A	16	10	26	0	2	28	0	0
13	4979190	.	T	C	8	15	23	0	3	26	0	0
13	4979339	.	C	T	9	9	18	0	1	19	0	0
13	4979420	.	T	C	11	11	22	0	1	23	0	0
13	4979471	.	T	C	9	10	19	0	2	21	0	0
13	4979607	.	G	T	11	14	25	0	2	27	0	0
13	4979754	.	A	G	10	15	25	0	1	26	0	0
13	4979799	.	T	C	6	0	6	0	12	18	0	0
13	4981965	.	A	T	10	4	14	0	0	14	0	0
13	4982061	.	T	G	5	3	8	0	4	12	0	0
13	4982284	.	G	A	7	11	18	0	0	18	0	0
13	4983110	.	A	T	6	6	12	0	0	12	0	0
13	4983113	.	C	A	0	6	6	0	7	13	0	0
13	4986095	.	A	G	4	6	10	0	0	10	0	0
13	4986298	.	T	A	8	5	13	0	1	14	0	0
13	4987659	.	C	A	1	3	4	0	3	7	0	0
13	5000490	.	G	A	0	8	8	0	13	21	0	0
13	5000560	.	A	G	9	7	16	0	0	16	0	0
13	5004996	.	C	T	26	24	50	0	0	50	0	0
13	5013671	.	A	G	10	39	49	0	7	56	0	0
13	5016700	.	G	A	18	23	41	0	4	45	0	0
13	5016758	.	G	C	22	22	44	0	1	45	0	0
13	5017657	.	A	C	27	24	51	0	0	51	0	0
13	5017680	.	G	A	27	29	56	0	3	59	0	0
13	5017699	.	G	A	24	31	55	0	2	57	0	0
13	5026131	.	C	T	30	30	60	0	3	63	0	0
13	5028224	.	T	G	21	46	67	0	4	71	0	0
13	5028407	.	G	A	36	26	62	0	2	64	0	0
13	5028414	.	T	C	33	25	58	0	5	63	0	0
13	5028499	.	A	T	25	34	59	1	2	62	0	0
13	5028711	.	C	T	26	27	53	0	2	55	0	0
13	5028912	.	C	T	15	19	34	0	0	34	0	0
13	5028954	.	C	A	3	2	5	0	0	5	0	0
13	5031370	.	G	A	2	2	4	0	0	4	0	0
13	5048306	.	A	G	3	6	9	0	0	9	0	0
13	5062193	.	A	G	3	1	4	0	0	4	0	0
13	5062200	.	C	A	1	2	3	0	0	3	0	0
13	5246113	.	G	A	1	2	3	0	0	3	0	0
13	5246188	.	T	C	1	2	3	0	0	3	0	0
13	5247076	.	T	C	1	2	3	0	0	3	0	0
13	5251298	.	A	T	2	3	5	0	0	5	0	0
13	5251366	.	G	T	2	2	4	0	0	4	0	0
13	5251540	.	T	C	1	3	4	0	0	4	0	0
13	5251774	.	G	A	1	2	3	0	0	3	0	0
13	5870703	.	C	G	4	5	9	0	1	10	0	0
13	5871084	.	C	A	4	7	11	0	0	11	0	0
13	5871321	.	G	A	3	5	8	0	0	8	0	0
13	5871340	.	G	C	2	5	7	0	1	8	0	0
13	5871445	.	G	A	5	5	10	0	1	11	0	0
13	5871757	.	C	G	5	3	8	0	0	8	0	0
13	5871834	.	C	T	0	2	2	0	2	4	0	0
13	5871928	.	G	A	5	4	9	0	0	9	0	0
13	5871967	.	A	G	5	5	10	2	0	12	0	0
13	5872300	.	G	A	5	3	8	0	0	8	0	0
13	5872717	.	A	G	13	9	22	0	0	22	0	0
13	5897408	.	G	A	7	6	13	1	0	14	0	0
13	5936945	.	T	G	6	9	15	0	1	16	0	0
13	5959654	.	T	C	6	9	15	0	0	15	0	0
13	5978865	.	T	C	14	15	29	0	0	29	0	0
13	5988012	.	G	T	6	3	9	1	0	10	0	0
13	6089989	.	C	A	7	2	9	0	0	9	0	0
13	6091985	.	T	C	4	2	6	0	0	6	0	0
13	6092064	.	G	A	2	2	4	0	0	4	0	0
13	6092065	.	A	C	2	2	4	0	0	4	0	0
13	6092108	.	C	G	3	2	5	0	0	5	0	0
13	6119843	.	A	G	3	3	6	0	0	6	0	0
13	6119865	.	C	T	1	2	3	0	1	4	0	0
13	6125154	.	T	C	6	6	12	0	0	12	0	0
13	6125207	.	A	T	4	5	9	0	0	9	0	0
13	6125217	.	G	A	0	4	4	0	3	7	0	0
13	6189925	.	T	G	10	0	10	0	8	18	0	0
13	6191523	.	C	A	10	13	23	0	0	23	0	0
13	6192433	.	C	A	14	6	20	0	0	20	0	0
13	6194867	.	T	A	5	15	20	0	0	20	0	0
13	6195055	.	A	T	8	10	18	0	1	19	0	0
13	6199336	.	G	A	2	5	7	0	4	12	1	0
13	6199375	.	T	C	8	8	16	0	0	16	0	0
13	6204583	.	G	A	12	13	25	0	0	25	0	0
13	6204957	.	T	C	9	8	17	0	1	18	0	0
13	6205311	.	G	A	6	3	9	0	1	10	0	0
13	6226012	.	G	C	5	7	12	0	0	12	0	0
13	6233482	.	A	C	3	7	10	0	0	10	0	0
13	6236772	.	G	A	6	7	13	0	1	14	0	0
13	6236796	.	C	T	9	7	16	0	0	16	0	0
13	6236901	.	G	A	15	9	24	0	0	24	0	0
13	6238204	.	G	A	7	10	17	0	2	19	0	0
13	6238466	.	T	C	11	23	34	0	0	34	0	0
13	6238658	.	G	T	1	10	11	0	12	23	0	0
13	6238762	.	A	G	6	6	12	0	0	12	0	0
13	6238883	.	A	G	14	7	21	0	1	22	0	0
13	6238972	.	G	A	7	7	14	0	2	16	0	0
13	6239031	.	C	T	4	6	10	0	1	11	0	0
13	6239091	.	A	T	4	5	9	0	0	9	0	0
13	6239112	.	A	G	7	6	13	0	0	13	0	0
13	6259409	.	T	G	6	2	8	0	0	8	0	0
13	6259600	.	T	A	1	4	5	0	0	5	0	0
13	6259813	.	C	T	1	2	3	0	2	5	0	0
13	6271263	.	C	T	4	4	8	0	0	8	0	0
13	6271490	.	T	C	5	5	10	0	0	10	0	0
13	6279243	.	T	C	4	6	10	0	0	10	0	0
13	6279412	.	C	A	3	2	5	0	0	5	0	0
13	7049278	.	C	T	8	3	11	0	0	11	0	0
13	7049352	.	A	T	3	4	7	0	0	7	0	0
13	7049357	.	G	A	1	3	4	0	2	6	0	0
13	7061659	.	T	C	4	2	6	0	0	6	0	0
13	7062963	.	T	G	1	3	4	0	1	5	0	0
13	7063602	.	C	G	4	10	14	0	1	15	0	0
13	7063644	.	C	T	11	4	15	0	0	15	0	0
13	7063757	.	C	G	6	5	11	0	0	11	0	0
13	7109218	.	A	G	1	4	5	0	0	5	0	0
13	7144456	.	T	C	1	4	5	0	1	6	0	0
13	7144459	.	T	G	2	0	2	0	5	7	0	0
13	7148075	.	G	A	0	6	6	0	6	12	0	0
13	7184389	.	G	T	2	3	5	0	0	5	0	0
13	7184446	.	G	A	2	3	5	0	0	5	0	0
13	7243048	.	G	A	0	11	11	0	2	13	0	0
13	7304696	.	A	C	5	3	8	0	0	8	0	0
13	7304711	.	T	C	1	4	5	0	0	5	0	0
13	7305601	.	G	A	2	2	4	0	6	10	0	0
13	7305625	.	T	A	6	3	9	0	0	9	0	0
13	7305637	.	T	A	4	3	7	0	1	8	0	0
13	7305715	.	A	G	9	5	14	0	0	14	0	0
13	7305861	.	T	C	4	2	6	0	0	6	0	0
13	7306731	.	T	C	1	5	6	0	0	6	0	0
13	7306738	.	C	T	1	5	6	0	0	6	0	0
13	7306994	.	T	A	7	4	11	0	0	11	0	0
13	7307082	.	A	G	2	4	6	0	0	6	0	0
13	7307087	.	T	C	1	5	6	0	0	6	0	0
13	7307382	.	A	C	4	4	8	0	2	10	0	0
13	7307512	.	T	C	5	4	9	0	0	9	0	0
13	7307701	.	T	C	3	4	7	1	0	8	0	0
13	7308279	.	T	C	3	6	9	0	0	9	0	0
13	7309141	.	T	C	2	5	7	0	0	7	0	0
13	7310628	.	A	C	10	5	15	0	0	15	0	0
13	7310986	.	C	T	3	4	7	0	0	7	0	0
13	7311089	.	C	T	2	5	7	0	0	7	0	0
13	7311101	.	G	A	5	4	9	0	0	9	0	0
13	7311133	.	C	T	8	4	12	0	0	12	0	0
13	7311154	.	T	G	9	0	9	0	4	13	0	0
13	7311218	.	A	G	4	4	8	0	0	8	0	0
13	7311263	.	G	A	1	4	5	0	5	10	0	0
13	7311420	.	C	A	9	6	15	0	1	16	0	0
13	7311476	.	C	T	12	6	18	0	0	18	0	0
13	7311849	.	C	T	7	8	15	0	1	16	0	0
13	7311986	.	A	C	15	12	27	0	0	27	0	0
13	7312015	.	T	A	16	12	28	0	0	28	0	0
13	7312201	.	T	A	8	10	18	0	0	18	0	0
13	7312225	.	G	C	8	11	19	0	1	20	0	0
13	7312372	.	G	T	13	6	19	0	0	19	0	0
13	7312585	.	T	C	12	10	22	0	0	22	0	0
13	7312675	.	C	T	9	7	16	0	1	17	0	0
13	7312713	.	T	A	12	5	17	0	1	18	0	0
13	7312991	.	T	C	10	8	18	0	0	18	0	0
13	7313020	.	G	A	0	7	7	0	9	17	1	0
13	7313066	.	T	G	11	12	23	0	0	23	0	0
13	7313304	.	A	G	10	5	15	0	0	15	0	0
13	7313418	.	G	C	8	4	12	0	0	12	0	0
13	7313641	.	C	A	15	8	23	0	0	23	0	0
13	7313827	.	C	T	12	11	23	0	2	25	0	0
13	7314049	.	T	C	10	5	15	1	1	17	0	0
13	7314080	.	G	A	8	9	17	1	0	18	0	0
13	7314300	.	T	C	13	7	20	0	0	20	0	0
13	7314823	.	C	T	12	9	21	0	3	24	0	0
13	7314856	.	G	A	10	8	18	0	5	23	0	0
13	7314859	.	C	A	10	10	20	0	2	22	0	0
13	7315015	.	C	T	16	17	33	0	0	33	0	0
13	7315098	.	T	C	20	13	33	0	1	34	0	0
13	7315234	.	A	G	16	15	31	0	0	31	0	0
13	7315424	.	G	A	0	9	9	0	21	30	0	0
13	7315597	.	A	G	12	0	12	0	11	23	0	0
13	7316157	.	G	T	12	11	23	0	2	25	0	0
13	7316207	.	C	T	11	6	17	1	0	18	0	0
13	7316453	.	G	T	6	3	9	0	0	9	0	0
13	7316484	.	A	T	8	3	11	0	0	11	0	0
13	7322456	.	T	A	11	4	15	0	2	17	0	0
13	7322524	.	C	T	15	11	26	0	1	27	0	0
13	7339931	.	G	C	2	4	6	0	11	17	0	0
13	7340123	.	G	A	4	4	8	0	0	8	0	0
13	7340136	.	A	G	2	0	2	0	3	5	0	0
13	7346864	.	A	G	24	6	30	0	0	30	0	0
13	7347125	.	G	A	6	2	8	0	0	8	0	0
13	7557062	.	T	G	4	2	6	0	0	6	0	0
13	7687756	.	G	A	6	4	10	1	1	12	0	0
13	7687786	.	T	C	3	8	11	1	1	13	0	0
13	7689546	.	C	A	5	11	16	0	0	16	0	0
13	7690025	.	G	A	6	5	11	0	0	11	0	0
13	7690033	.	T	A	5	5	10	0	1	11	0	0
13	7690060	.	G	A	6	4	10	0	1	11	0	0
13	7690124	.	G	A	5	4	9	0	1	10	0	0
13	7693225	.	T	A	2	3	5	0	1	6	0	0
13	7693615	.	A	C	4	2	6	0	0	6	0	0
13	7693648	.	A	T	3	6	9	0	0	9	0	0
13	7693681	.	C	T	4	6	10	0	0	10	0	0
13	7698480	.	C	T	4	5	9	0	0	9	0	0
13	7698537	.	T	C	4	5	9	0	1	10	0	0
13	7703468	.	T	C	3	5	8	0	0	8	0	0
13	7703470	.	A	T	3	5	8	0	0	8	0	0
13	7721296	.	T	C	1	4	5	0	0	5	0	0
13	7721329	.	C	T	1	4	5	0	0	5	0	0
13	7725965	.	C	T	6	12	18	0	1	19	0	0
13	7728958	.	C	T	7	6	13	0	0	13	0	0
13	7737101	.	G	A	1	3	4	0	7	11	0	0
13	7744319	.	A	G	7	10	17	0	0	17	0	0
13	7744443	.	G	A	14	13	27	0	3	30	0	0
13	7745463	.	C	G	5	9	14	0	1	15	0	0
13	7745544	.	C	T	9	13	22	0	0	22	0	0
13	7745705	.	G	A	9	8	17	0	0	17	0	0
13	7745814	.	C	A	6	5	11	0	0	11	0	0
13	7745866	.	A	G	9	0	9	0	7	16	0	0
13	7747299	.	A	G	6	3	9	0	0	9	0	0
13	7747513	.	C	G	3	8	11	0	0	11	0	0
13	7747738	.	T	C	6	14	20	0	2	22	0	0
13	7747760	.	T	C	5	17	22	0	1	23	0	0
13	7748021	.	G	T	6	4	10	0	1	11	0	0
13	7748424	.	T	C	9	12	21	0	0	21	0	0
13	7748497	.	T	G	6	4	10	0	0	10	0	0
13	7748533	.	T	G	9	6	15	0	3	18	0	0
13	7748794	.	G	A	2	9	11	0	15	26	0	0
13	7748882	.	A	T	12	10	22	0	1	23	0	0
13	7748995	.	T	A	2	11	13	0	1	14	0	0
13	7749000	.	G	C	3	12	15	0	0	15	0	0
13	7755764	.	A	C	18	0	18	0	28	46	0	0
13	7755875	.	T	C	24	0	24	0	20	44	0	0
13	7759403	.	T	C	26	23	49	0	0	49	0	0
13	7763810	.	A	G	21	19	40	0	1	41	0	0
13	7766936	.	C	T	1	14	15	0	20	35	0	0
13	7767013	.	C	T	1	4	5	0	0	5	0	0
13	8142558	.	A	G	5	4	9	0	0	9	0	0
13	8152765	.	C	T	0	3	3	0	1	4	0	0
13	8152771	.	T	C	1	2	3	0	0	3	0	0
13	8152928	.	C	G	1	2	3	0	0	3	0	0
13	8170474	.	G	A	1	3	4	0	0	4	0	0
13	8256864	.	G	A	2	2	4	0	0	4	0	0
13	8277667	.	A	G	2	3	5	0	0	5	0	0
13	8277991	.	T	C	2	0	2	0	2	4	0	0
13	8281619	.	C	A	2	7	9	0	0	9	0	0
13	8281655	.	A	C	3	5	8	0	0	8	0	0
13	8285559	.	G	A	8	7	15	0	1	16	0	0
13	8290860	.	A	C	5	3	8	0	1	9	0	0
13	8293709	.	C	T	3	5	8	0	0	8	0	0
13	8294201	.	C	T	0	2	2	0	3	5	0	0
13	8294222	.	A	T	2	3	5	0	0	5	0	0
13	8296499	.	G	A	3	3	6	0	1	7	0	0
13	8296742	.	G	A	3	4	7	0	0	7	0	0
13	8320785	.	G	A	3	3	6	0	0	6	0	0
13	8326274	.	T	C	3	7	10	0	1	11	0	0
13	8333500	.	C	T	4	4	8	0	0	8	0	0
13	8333942	.	G	A	4	2	6	0	0	6	0	0
13	8340182	.	G	T	1	2	3	0	0	3	0	0
13	8340367	.	G	A	4	3	7	0	0	7	0	0
13	8340376	.	C	T	5	3	8	0	0	8	0	0
13	8343336	.	A	G	3	3	6	0	0	6	0	0
13	8347708	.	C	T	1	3	4	0	0	4	0	0
13	8348133	.	T	C	2	0	2	0	3	5	0	0
13	8348158	.	G	A	2	3	5	0	0	5	0	0
13	8348268	.	T	C	3	0	3	0	2	5	0	0
13	8348837	.	T	C	2	3	5	0	0	5	0	0
13	8352663	.	A	T	1	2	3	0	0	3	0	0
13	8352727	.	G	A	2	3	5	0	1	6	0	0
13	8375857	.	T	C	3	0	3	0	9	12	0	0
13	8375932	.	A	T	15	17	32	0	1	33	0	0
13	8375935	.	C	A	16	18	34	0	1	35	0	0
13	8375981	.	A	G	23	22	45	0	2	47	0	0
13	8376064	.	A	G	17	16	33	0	1	34	0	0
13	8376077	.	C	G	16	17	33	0	1	34	0	0
13	8376184	.	C	T	7	11	18	0	0	18	0	0
13	8376187	.	G	A	8	12	20	0	0	20	0	0
13	8376301	.	A	T	5	10	15	0	1	16	0	0
13	8376317	.	T	A	6	13	19	0	1	20	0	0
13	8376355	.	C	T	7	10	17	0	2	19	0	0
13	8376613	.	T	G	9	5	14	0	0	14	0	0
13	8376675	.	C	A	1	5	6	0	9	15	0	0
13	8376845	.	A	G	14	15	29	0	0	29	0	0
13	8376882	.	C	T	0	11	11	0	10	21	0	0
13	8376896	.	T	C	9	10	19	0	0	19	0	0
13	8376972	.	G	A	4	3	7	1	0	8	0	0
13	8377056	.	A	T	1	2	3	0	0	3	0	0
13	8377058	.	A	G	1	2	3	0	0	3	0	0
13	8377327	.	A	G	4	6	10	0	0	10	0	0
13	8377334	.	A	G	4	7	11	0	0	11	0	0
13	8377606	.	A	G	2	3	5	0	0	5	0	0
13	8377624	.	C	T	1	4	5	0	0	5	0	0
13	8378018	.	A	C	1	4	5	0	1	6	0	0
13	8378170	.	T	A	2	3	5	0	0	5	0	0
13	8378354	.	A	G	7	5	12	0	0	12	0	0
13	8378400	.	T	C	5	3	8	0	0	8	0	0
13	8378511	.	A	T	5	4	9	0	0	9	0	0
13	8378519	.	A	G	5	3	8	0	0	8	0	0
13	8378588	.	C	A	0	10	10	0	8	18	0	0
13	8378601	.	T	C	4	7	11	0	0	11	0	0
13	8378635	.	T	G	3	4	7	0	1	8	0	0
13	8378698	.	C	A	1	4	5	0	0	5	0	0
13	8378738	.	T	C	2	3	5	0	0	5	0	0
13	8378779	.	T	C	3	0	3	0	3	6	0	0
13	8378839	.	C	T	4	2	6	0	0	6	0	0
13	8378840	.	T	G	4	1	5	0	1	6	0	0
13	8379420	.	G	T	5	4	9	0	1	10	0	0
13	8379447	.	A	G	4	8	12	0	0	12	0	0
13	8380477	.	T	C	5	9	14	0	0	14	0	0
13	8380824	.	G	A	3	4	7	0	0	7	0	0
13	8380870	.	T	C	2	0	2	0	7	9	0	0
13	8380894	.	A	G	2	7	9	0	0	9	0	0
13	8381003	.	C	T	1	8	9	0	0	9	0	0
13	8381142	.	A	T	2	3	5	0	0	5	0	0
13	8381285	.	C	T	2	6	8	0	0	8	0	0
13	8381666	.	C	A	5	4	9	0	0	9	0	0
13	8381706	.	G	A	5	4	9	0	1	10	0	0
13	8383716	.	C	T	1	5	6	0	0	6	0	0
13	8386207	.	T	G	5	3	8	0	1	9	0	0
13	8388747	.	A	C	4	2	6	0	0	6	0	0
13	8388748	.	C	T	4	2	6	0	0	6	0	0
13	8415962	.	T	G	4	3	7	0	0	7	0	0
13	8446055	.	C	T	0	3	3	1	1	5	0	0
13	8453507	.	T	A	2	3	5	1	0	6	0	0
13	8465007	.	G	T	2	3	5	0	0	5	0	0
13	8600160	.	T	A	2	3	5	0	0	5	0	0
13	8600487	.	T	C	0	1	1	0	2	3	0	0
13	8600654	.	A	T	1	3	4	0	1	5	0	0
13	8600706	.	G	T	1	5	6	0	0	6	0	0
13	8601011	.	A	G	3	2	5	0	0	5	0	0
13	8601035	.	A	T	2	2	4	0	0	4	0	0
13	8605000	.	T	A	5	7	12	0	0	12	0	0
13	8605059	.	T	C	3	4	7	0	0	7	0	0
13	8605088	.	T	C	2	3	5	0	0	5	0	0
13	8621262	.	T	C	2	7	9	0	0	9	0	0
13	8621325	.	C	T	2	4	6	0	1	7	0	0
13	8621808	.	C	G	9	3	12	0	0	12	0	0
13	8621955	.	T	C	8	6	14	0	0	14	0	0
13	8622003	.	A	C	7	7	14	0	0	14	0	0
13	8622084	.	A	G	7	6	13	0	0	13	0	0
13	8622382	.	G	A	3	7	10	0	1	11	0	0
13	8623343	.	T	A	2	2	4	0	0	4	0	0
13	8623348	.	A	G	2	2	4	0	1	5	0	0
13	8623387	.	T	C	1	6	7	0	0	7	0	0
13	8623483	.	A	G	5	0	5	0	12	17	0	0
13	8623517	.	A	C	6	8	14	0	1	15	0	0
13	8623521	.	G	C	6	8	14	0	0	14	0	0
13	8623659	.	A	C	3	3	6	0	1	7	0	0
13	8623806	.	T	C	4	2	6	0	0	6	0	0
13	8623836	.	C	T	5	2	7	0	0	7	0	0
13	8623950	.	G	A	0	2	2	0	2	4	0	0
13	8624542	.	G	A	3	3	6	0	1	7	0	0
13	8624996	.	T	C	4	2	6	0	0	6	0	0
13	8625050	.	A	G	3	0	3	0	4	7	0	0
13	8625102	.	T	C	7	6	13	0	0	13	0	0
13	8625106	.	T	A	8	6	14	0	0	14	0	0
13	8625167	.	T	C	8	6	14	0	1	15	0	0
13	8625911	.	C	T	1	3	4	0	1	5	0	0
13	8625917	.	T	A	2	3	5	0	0	5	0	0
13	8626521	.	G	C	8	5	13	0	0	13	0	0
13	8626645	.	T	A	3	4	7	0	0	7	0	0
13	8626786	.	G	A	1	6	7	0	6	13	0	0
13	8626841	.	C	T	7	6	13	0	0	13	0	0
13	8627626	.	G	A	1	8	9	0	8	17	0	0
13	8627634	.	T	A	11	7	18	0	0	18	0	0
13	8627677	.	G	A	12	12	24	0	1	25	0	0
13	8627819	.	T	C	2	6	8	0	0	8	0	0
13	8683992	.	A	G	2	3	5	0	0	5	0	0
13	8684402	.	G	A	4	2	6	0	0	6	0	0
13	8684403	.	A	G	4	2	6	0	0	6	0	0
13	8685176	.	C	T	6	9	15	0	0	15	0	0
13	8685217	.	A	T	3	3	6	0	0	6	0	0
13	8685272	.	C	T	1	4	5	0	0	5	0	0
13	8685542	.	G	A	4	9	13	0	1	14	0	0
13	8685622	.	T	C	5	6	11	0	0	11	0	0
13	8692368	.	C	T	0	7	7	0	12	19	0	0
13	8692776	.	T	G	13	15	28	0	1	29	0	0
13	8692827	.	T	G	6	5	11	0	0	11	0	0
13	8732264	.	G	A	1	2	3	0	0	3	0	0
13	8738794	.	C	A	1	1	2	0	1	3	0	0
13	8755678	.	A	C	1	4	5	0	0	5	0	0
13	8755727	.	G	A	1	3	4	0	0	4	0	0
13	8777682	.	C	T	14	8	22	0	1	23	0	0
13	8777701	.	G	A	14	10	24	0	1	25	0	0
13	8778501	.	G	T	36	23	59	8	3	70	0	0
13	8781222	.	T	C	4	4	8	0	0	8	0	0
13	8782424	.	A	T	5	3	8	0	0	8	0	0
13	8901899	.	G	A	2	2	4	0	0	4	0	0
13	8920313	.	C	T	2	2	4	0	0	4	0	0
13	8926240	.	A	T	2	3	5	0	0	5	0	0
13	8932784	.	A	G	3	0	3	0	3	6	0	0
13	8933559	.	T	C	1	2	3	0	0	3	0	0
13	8937373	.	G	A	4	2	6	0	0	6	0	0
13	8945700	.	T	C	4	5	9	0	0	9	0	0
13	8947046	.	G	A	5	2	7	0	0	7	0	0
13	8947095	.	C	T	5	3	8	0	1	9	0	0
13	8950686	.	G	A	6	7	13	0	0	13	0	0
13	8950783	.	C	G	8	5	13	0	1	14	0	0
13	8951327	.	C	A	2	3	5	0	0	5	0	0
13	8951332	.	T	A	2	3	5	0	0	5	0	0
13	9299796	.	A	G	3	2	5	0	0	5	0	0
13	9299881	.	C	G	2	5	7	0	0	7	0	0
13	9300177	.	A	G	10	6	16	0	2	18	0	0
13	9300204	.	G	A	11	7	18	0	0	18	0	0
13	9300224	.	C	T	0	5	5	0	10	15	0	0
13	9300239	.	G	T	7	3	10	0	0	10	0	0
13	9307646	.	T	C	10	11	21	0	1	22	0	0
13	9311156	.	C	A	13	13	26	0	1	27	0	0
13	9313806	.	C	T	2	14	16	0	16	32	0	0
13	9313858	.	A	T	29	24	53	0	2	55	0	0
13	9313975	.	T	C	32	28	60	0	4	64	0	0
13	9314024	.	C	A	33	30	63	0	2	65	0	0
13	9314040	.	T	A	33	28	61	0	3	65	1	0
13	9314238	.	G	A	38	23	61	0	2	63	0	0
13	9314338	.	C	T	44	27	71	0	1	72	0	0
13	9314532	.	T	C	38	4	42	0	32	74	0	0
13	9314580	.	A	T	38	30	68	0	4	72	0	0
13	9314620	.	C	T	41	30	71	0	2	73	0	0
13	9314630	.	C	T	4	30	34	0	39	73	0	0
13	9314710	.	G	A	44	27	71	0	3	74	0	0
13	9315004	.	C	T	39	38	77	0	3	80	0	0
13	9315019	.	T	C	34	30	64	0	6	70	0	0
13	9315045	.	C	G	30	37	67	0	6	73	0	0
13	9315384	.	G	A	39	42	81	0	2	83	0	0
13	9315406	.	A	G	36	35	71	0	9	80	0	0
13	9315424	.	G	A	36	33	69	0	3	72	0	0
13	9315686	.	C	T	11	36	47	0	38	85	0	0
13	9315730	.	A	G	42	29	71	0	15	86	0	0
13	9317915	.	T	C	59	30	89	0	1	90	0	0
13	9317945	.	C	T	55	38	93	0	2	95	0	0
13	9318003	.	C	T	10	44	54	0	39	93	0	0
13	9318116	.	T	C	58	28	86	0	2	88	0	0
13	9318125	.	C	T	60	31	91	0	7	98	0	0
13	9318263	.	C	T	42	45	87	0	7	94	0	0
13	9318446	.	T	C	45	43	88	0	7	95	0	0
13	9318521	.	A	G	44	39	83	0	0	83	0	0
13	9340019	.	C	T	2	5	7	0	1	8	0	0
13	9340609	.	C	A	1	11	12	0	6	18	0	0
13	9343329	.	T	C	11	14	25	0	1	26	0	0
13	9345182	.	A	C	11	10	21	0	0	21	0	0
13	9356123	.	G	T	14	7	21	0	2	23	0	0
13	9358449	.	C	T	8	11	19	0	1	20	0	0
13	9358457	.	T	G	7	14	21	0	2	23	0	0
13	9361825	.	T	C	11	9	20	0	2	22	0	0
13	9367562	.	T	A	18	9	27	0	1	28	0	0
13	9373337	.	G	A	2	2	4	0	0	4	0	0
13	9373385	.	G	T	2	2	4	0	0	4	0	0
13	9373703	.	G	A	1	4	5	0	0	5	0	0
13	9375081	.	C	T	2	3	5	0	1	6	0	0
13	9375797	.	A	C	4	3	7	0	0	7	0	0
13	9375860	.	G	C	4	2	6	0	0	6	0	0
13	9375954	.	A	T	4	2	6	0	0	6	0	0
13	9375990	.	A	G	2	2	4	0	0	4	0	0
13	9376045	.	A	G	4	2	6	0	0	6	0	0
13	9384590	.	A	G	3	6	9	0	0	9	0	0
13	9384839	.	A	G	5	3	8	0	0	8	0	0
13	9384877	.	T	A	5	2	7	0	1	8	0	0
13	9384935	.	A	G	4	3	7	0	0	7	0	0
13	9385060	.	C	T	3	1	4	0	1	5	0	0
13	9385127	.	G	T	0	3	3	0	3	6	0	0
13	9385129	.	G	A	0	3	3	0	3	6	0	0
13	9385304	.	A	T	3	4	7	0	0	7	0	0
13	9385561	.	G	A	5	3	8	0	1	9	0	0
13	9392020	.	G	A	1	4	5	0	0	5	0	0
13	9392047	.	G	A	1	5	6	0	0	6	0	0
13	9392068	.	A	G	3	3	6	0	0	6	0	0
13	9392260	.	G	A	0	2	2	0	2	4	0	0
13	9394684	.	A	T	2	10	12	0	0	12	0	0
13	9394716	.	A	G	2	8	10	0	0	10	0	0
13	9395458	.	G	T	5	3	8	0	0	8	0	0
13	9550887	.	A	G	1	0	1	0	3	4	0	0
13	9554392	.	C	T	2	2	4	0	0	4	0	0
13	9554410	.	T	C	1	3	4	0	0	4	0	0
13	9554761	.	T	C	2	3	5	0	0	5	0	0
13	9554825	.	T	G	4	2	6	0	0	6	0	0
13	9554828	.	T	C	4	2	6	0	0	6	0	0
13	9554956	.	T	C	5	6	11	0	0	11	0	0
13	9555516	.	A	C	1	3	4	0	0	4	0	0
13	9556178	.	C	T	2	4	6	0	0	6	0	0
13	9556194	.	T	C	2	4	6	0	0	6	0	0
13	9556218	.	C	A	1	2	3	0	0	3	0	0
13	9556252	.	T	C	2	2	4	0	0	4	0	0
13	9556322	.	A	G	2	0	2	0	3	5	0	0
13	9556426	.	C	T	3	3	6	0	2	8	0	0
13	9556535	.	T	C	3	3	6	0	0	6	0	0
13	9556734	.	C	G	4	3	7	0	0	7	0	0
13	9557638	.	T	A	7	3	10	0	0	10	0	0
13	9557917	.	G	C	5	2	7	0	0	7	0	0
13	9559476	.	T	A	1	3	4	0	0	4	0	0
13	9559527	.	A	C	6	7	13	0	1	14	0	0
13	9559542	.	A	G	8	0	8	0	10	18	0	0
13	9560897	.	T	C	5	5	10	0	1	11	0	0
13	9565065	.	G	A	2	6	8	0	11	19	0	0
13	9568821	.	C	T	2	4	6	0	0	6	0	0
13	9568857	.	G	A	0	5	5	0	2	7	0	0
13	9568861	.	T	C	2	8	10	0	0	10	0	0
13	9570532	.	A	T	2	9	11	0	0	11	0	0
13	9570598	.	A	G	6	7	13	0	0	13	0	0
13	9570967	.	A	G	2	6	8	0	0	8	0	0
13	9571695	.	C	T	4	7	11	0	0	11	0	0
13	9571949	.	T	C	10	4	14	0	1	15	0	0
13	9571972	.	G	A	12	3	15	0	1	16	0	0
13	9572036	.	G	A	7	3	10	0	0	10	0	0
13	9623933	.	A	G	1	0	1	0	3	4	0	0
13	9623945	.	A	G	2	3	5	0	0	5	0	0
13	9623980	.	T	C	4	2	6	0	0	6	0	0
13	9725467	.	T	C	3	3	6	0	0	6	0	0
13	9755527	.	C	G	3	2	5	0	0	5	0	0
13	9755552	.	C	T	2	4	6	0	0	6	0	0
13	9755583	.	G	A	3	3	6	0	0	6	0	0
13	9759974	.	A	G	4	2	6	0	0	6	0	0
13	9760013	.	A	G	2	0	2	0	4	6	0	0
13	9760021	.	A	G	2	3	5	0	1	6	0	0
13	9760061	.	T	A	2	3	5	0	0	5	0	0
13	9760378	.	A	G	2	2	4	0	0	4	0	0
13	9760617	.	G	T	1	4	5	0	0	5	0	0
13	9760636	.	C	A	2	2	4	0	1	5	0	0
13	9819497	.	A	G	0	2	2	0	1	3	0	0
13	9819599	.	C	T	2	2	4	0	0	4	0	0
13	9819974	.	G	A	1	2	3	0	0	3	0	0
13	9828568	.	A	T	3	4	7	0	0	7	0	0
13	9828572	.	G	A	1	4	5	0	4	9	0	0
13	9828933	.	G	T	8	7	15	0	0	15	0	0
13	9829007	.	A	G	4	5	9	0	1	10	0	0
13	9829013	.	C	T	3	8	11	0	1	12	0	0
13	9829232	.	T	C	5	5	10	0	0	10	0	0
13	9829252	.	T	A	3	4	7	0	0	7	0	0
13	9829274	.	C	A	2	6	8	0	0	8	0	0
13	9829289	.	T	C	3	6	9	0	0	9	0	0
13	9829406	.	A	C	1	4	5	0	0	5	0	0
13	9829408	.	G	A	1	4	5	0	0	5	0	0
13	9829855	.	C	T	3	5	8	0	1	9	0	0
13	9830417	.	C	A	1	3	4	0	0	4	0	0
13	9830518	.	A	T	4	6	10	0	1	11	0	0
13	9830521	.	A	C	4	5	9	0	0	9	0	0
13	9831056	.	G	C	1	5	6	0	0	6	0	0
13	9831116	.	A	G	5	6	11	0	0	11	0	0
13	9836485	.	A	T	3	3	6	0	0	6	0	0
13	9839813	.	G	A	3	6	9	0	0	9	0	0
13	9840152	.	G	A	7	8	15	0	0	15	0	0
13	9841702	.	T	A	9	16	25	0	0	25	0	0
13	9844527	.	A	G	19	2	21	0	22	43	0	0
13	9844746	.	T	C	13	28	41	0	1	42	0	0
13	9855508	.	G	T	9	6	15	0	0	15	0	0
13	9855874	.	G	A	16	12	28	0	0	28	0	0
13	9856143	.	G	A	5	10	15	0	1	16	0	0
13	9856192	.	A	G	4	9	13	0	1	14	0	0
13	9856493	.	A	T	18	17	35	0	2	37	0	0
13	9856816	.	G	A	16	8	24	0	1	25	0	0
13	9866857	.	G	A	9	15	24	0	0	24	0	0
13	9901330	.	T	G	4	2	6	0	0	6	0	0
13	9901467	.	A	G	3	0	3	0	3	6	0	0
13	9901473	.	T	A	3	2	5	0	0	5	0	0
13	9924978	.	C	T	2	2	4	0	0	4	0	0
13	9924993	.	G	C	2	3	5	0	0	5	0	0
13	9925017	.	T	G	2	2	4	0	1	5	0	0
13	9927615	.	T	A	1	3	4	0	0	4	0	0
13	9999459	.	G	A	3	2	5	0	0	5	0	0
13	10004064	.	A	G	3	4	7	0	0	7	0	0
13	10895731	.	T	G	16	10	26	0	1	27	0	0
13	10906719	.	G	A	16	17	33	0	0	33	0	0
13	10906817	.	T	C	19	7	26	0	0	26	0	0
13	10910423	.	G	T	0	11	11	0	16	27	0	0
13	10922497	.	T	G	4	5	9	0	0	9	0	0
13	10922536	.	C	T	5	4	9	0	0	9	0	0
13	10922568	.	T	C	7	1	8	0	1	9	0	0
13	10922613	.	A	T	5	4	9	0	1	10	0	0
13	10922660	.	G	A	5	3	8	0	0	8	0	0
13	10970732	.	G	T	4	6	10	0	0	10	0	0
13	10975980	.	G	A	1	2	3	0	0	3	0	0
13	10976428	.	T	C	1	2	3	0	0	3	0	0
13	10976431	.	A	G	1	2	3	0	0	3	0	0
13	10978512	.	A	T	1	3	4	0	0	4	0	0
13	10978526	.	C	T	2	3	5	0	0	5	0	0
13	10981896	.	T	A	5	2	7	0	0	7	0	0
13	10982404	.	C	T	8	11	19	0	1	20	0	0
13	10982444	.	G	A	10	11	21	0	2	23	0	0
13	10982472	.	T	G	11	10	21	0	1	22	0	0
13	10982739	.	A	T	13	7	20	0	0	20	0	0
13	10982741	.	A	C	13	7	20	0	0	20	0	0
13	10982791	.	C	A	11	6	17	0	0	17	0	0
13	10982803	.	T	C	8	3	11	0	4	15	0	0
13	10982966	.	A	T	13	14	27	0	0	27	0	0
13	10983139	.	C	T	4	4	8	0	0	8	0	0
13	10983231	.	G	A	3	2	5	0	1	6	0	0
13	10983421	.	C	A	14	10	24	0	0	24	0	0
13	10983482	.	T	A	16	7	23	0	1	24	0	0
13	10983788	.	T	C	17	11	28	0	2	30	0	0
13	10984205	.	G	A	24	16	40	0	0	40	0	0
13	10990959	.	G	A	2	10	12	0	1	13	0	0
13	10990973	.	T	C	2	0	2	0	13	15	0	0
13	10994107	.	A	G	10	13	23	0	1	24	0	0
13	10997566	.	A	G	10	9	19	0	3	22	0	0
13	11001998	.	A	G	15	10	25	0	1	26	0	0
13	11002013	.	A	C	15	0	15	0	13	28	0	0
13	11002052	.	A	G	14	11	25	0	1	26	0	0
13	11002234	.	C	T	2	9	11	0	17	28	0	0
13	11002247	.	G	A	14	9	23	0	2	25	0	0
13	11002541	.	A	G	13	6	19	0	1	20	0	0
13	11002697	.	A	G	9	14	23	0	1	24	0	0
13	11002778	.	T	C	14	16	30	0	0	30	0	0
13	11002922	.	C	T	8	9	17	0	1	18	0	0
13	11002970	.	T	C	5	10	15	0	0	15	0	0
13	11003297	.	C	T	3	13	16	0	10	26	0	0
13	11007087	.	G	A	8	12	20	0	2	22	0	0
13	11012312	.	G	T	9	7	16	1	0	17	0	0
13	11012349	.	C	T	10	4	14	0	0	14	0	0
13	11012469	.	T	C	8	10	18	0	2	20	0	0
13	11020257	.	C	T	2	6	8	0	1	9	0	0
13	11029585	.	G	T	10	5	15	0	0	15	0	0
13	11035307	.	G	A	6	1	7	0	0	7	0	0
13	11035313	.	C	T	1	2	3	0	5	8	0	0
13	11073409	.	T	G	2	3	5	0	0	5	0	0
13	11077921	.	G	A	3	4	7	0	0	7	0	0
13	11119837	.	A	G	7	3	10	0	0	10	0	0
13	11166435	.	G	A	4	5	9	0	0	9	0	0
13	11166467	.	A	G	3	5	8	0	0	8	0	0
13	11175605	.	G	A	5	2	7	0	0	7	0	0
13	11184784	.	G	A	12	9	21	0	1	22	0	0
13	11233520	.	G	C	10	9	19	0	1	20	0	0
13	11441080	.	T	A	21	16	37	0	2	40	1	0
13	11442090	.	A	T	16	23	39	0	0	39	0	0
13	11443457	.	T	A	20	27	47	0	3	50	0	0
13	11443881	.	C	T	23	20	43	0	0	43	0	0
13	11444022	.	A	T	14	22	36	0	0	36	0	0
13	11444263	.	G	A	1	22	23	0	16	39	0	0
13	11444295	.	C	T	24	24	48	0	1	49	0	0
13	11444801	.	T	A	12	10	22	0	3	25	0	0
13	11489965	.	T	C	10	14	24	0	0	24	0	0
13	11489999	.	C	A	11	13	24	0	1	25	0	0
13	11490035	.	A	G	13	12	25	0	0	25	0	0
13	11490065	.	G	A	10	13	23	0	1	24	0	0
13	11490084	.	G	A	11	13	24	0	0	24	0	0
13	11490214	.	A	C	2	7	9	0	0	9	0	0
13	11490300	.	G	T	2	5	7	0	0	7	0	0
13	11490626	.	G	A	15	7	22	1	0	23	0	0
13	11500299	.	T	C	13	0	13	0	17	30	0	0
13	11503682	.	G	A	12	9	21	0	1	22	0	0
13	11536901	.	T	A	13	14	27	0	0	27	0	0
13	11550734	.	G	T	1	9	10	0	4	14	0	0
13	11550741	.	T	C	4	7	11	0	0	11	0	0
13	11675148	.	G	A	7	2	9	0	0	9	0	0
13	11675270	.	G	A	5	2	7	0	0	7	0	0
13	11675343	.	C	G	4	4	8	0	0	8	0	0
13	11675378	.	T	C	1	4	5	0	1	6	0	0
13	11675464	.	A	G	3	4	7	0	0	7	0	0
13	11675584	.	C	T	4	4	8	0	1	9	0	0
13	11675855	.	T	G	5	2	7	0	0	7	0	0
13	11676403	.	C	T	5	5	10	0	0	10	0	0
13	11676694	.	G	A	4	2	6	0	0	6	0	0
13	11676787	.	A	C	5	0	5	0	4	9	0	0
13	11678501	.	G	C	4	1	5	0	1	6	0	0
13	11679375	.	A	T	2	3	5	0	0	5	0	0
13	11679401	.	T	C	1	0	1	0	3	4	0	0
13	11739900	.	A	G	2	2	4	0	0	4	0	0
13	11746459	.	C	A	16	15	31	0	1	32	0	0
13	11751402	.	G	A	14	14	28	0	3	31	0	0
13	11767651	.	T	C	7	5	12	0	1	13	0	0
13	11767768	.	A	G	10	6	16	0	1	17	0	0
13	11775095	.	G	A	7	4	11	0	0	11	0	0
13	11781751	.	C	T	3	2	5	0	8	13	0	0
13	11781769	.	A	G	6	2	8	0	0	8	0	0
13	11791391	.	A	G	1	2	3	0	0	3	0	0
13	11791499	.	A	G	2	3	5	0	0	5	0	0
13	11797431	.	C	T	3	2	5	0	1	6	0	0
13	11829109	.	C	A	3	4	7	0	0	7	0	0
13	11829112	.	T	A	3	5	8	0	0	8	0	0
13	11829158	.	T	A	6	8	14	0	0	14	0	0
13	11836187	.	C	T	6	7	13	0	0	13	0	0
13	11852302	.	C	T	3	5	8	0	1	9	0	0
13	11860525	.	T	C	5	6	11	0	0	11	0	0
13	11869049	.	G	T	9	4	13	0	0	13	0	0
13	11869127	.	C	T	10	5	15	0	0	15	0	0
13	11869143	.	T	C	7	5	12	0	2	14	0	0
13	11869219	.	G	T	6	3	9	0	0	9	0	0
13	11869220	.	G	T	6	3	9	0	0	9	0	0
13	11869357	.	G	T	7	4	11	0	0	11	0	0
13	11869539	.	T	C	6	6	12	0	1	13	0	0
13	11876698	.	T	G	8	4	12	0	0	12	0	0
13	11876841	.	G	A	7	4	11	0	1	12	0	0
13	11876850	.	G	A	5	5	10	0	1	11	0	0
13	11911904	.	A	G	13	11	24	0	0	24	0	0
13	11921543	.	T	C	4	7	11	0	0	11	0	0
13	11923834	.	G	C	12	9	21	0	0	21	0	0
13	11926692	.	C	G	8	5	13	0	0	14	1	0
13	11927341	.	C	G	8	7	15	0	0	15	0	0
13	11927347	.	T	A	8	6	14	0	0	14	0	0
13	11927491	.	T	C	8	7	15	0	0	15	0	0
13	11927603	.	A	G	4	4	8	0	0	8	0	0
13	11927829	.	A	T	5	4	9	0	2	11	0	0
13	11927830	.	T	G	6	5	11	0	0	11	0	0
13	11964159	.	G	C	1	3	4	0	0	4	0	0
13	11966316	.	A	G	6	3	9	0	0	9	0	0
13	11967334	.	T	A	3	3	6	0	0	10	4	0
13	11977394	.	A	T	2	8	10	0	0	10	0	0
13	11984768	.	A	C	8	8	16	0	1	17	0	0
13	11989357	.	T	C	22	11	33	1	1	35	0	0
13	11989468	.	A	C	18	11	29	1	1	31	0	0
13	11989554	.	A	G	20	13	33	0	0	33	0	0
13	11989629	.	C	T	21	14	35	0	0	35	0	0
13	11989633	.	T	C	21	10	31	0	0	31	0	0
13	11989698	.	C	T	15	12	27	0	2	29	0	0
13	11990118	.	G	A	25	13	38	0	0	38	0	0
13	11990175	.	T	C	18	1	19	0	13	32	0	0
13	11990294	.	A	G	14	16	30	0	0	30	0	0
13	11990329	.	T	G	14	15	29	0	1	30	0	0
13	11990389	.	G	T	15	17	32	0	0	32	0	0
13	11993451	.	A	T	11	16	27	0	0	27	0	0
13	12000699	.	T	C	9	5	14	0	1	15	0	0
13	12000700	.	G	C	8	4	12	0	2	14	0	0
13	12000906	.	T	A	19	8	27	0	0	27	0	0
13	12001110	.	T	C	18	9	27	0	2	29	0	0
13	12001254	.	A	G	15	10	25	0	0	25	0	0
13	12003230	.	A	G	6	6	12	0	0	12	0	0
13	12003905	.	T	C	10	0	10	0	6	16	0	0
13	12005588	.	C	T	0	11	11	0	10	21	0	0
13	12005656	.	T	A	7	3	10	0	1	11	0	0
13	12005705	.	G	T	7	4	11	0	1	12	0	0
13	12005710	.	A	T	5	4	9	0	1	10	0	0
13	12005859	.	T	A	13	7	20	0	0	20	0	0
13	12010610	.	G	A	2	2	4	0	0	4	0	0
13	12016719	.	A	T	2	1	3	0	0	3	0	0
13	12016722	.	T	C	2	0	2	0	2	4	0	0
13	12045797	.	A	T	11	6	17	0	0	17	0	0
13	12087528	.	G	A	1	12	13	0	16	29	0	0
13	12088223	.	C	G	18	15	33	0	1	34	0	0
13	12088255	.	A	G	14	14	28	0	0	28	0	0
13	12088327	.	A	G	9	11	20	0	1	21	0	0
13	12088406	.	T	C	13	8	21	0	1	22	0	0
13	12141929	.	A	G	3	8	11	0	1	12	0	0
13	12142001	.	G	A	4	11	15	0	0	15	0	0
13	12142007	.	T	C	3	10	13	0	1	14	0	0
13	12142204	.	G	A	4	4	8	0	0	8	0	0
13	12150892	.	C	T	8	5	13	0	0	13	0	0
13	12183498	.	G	A	1	3	4	0	3	7	0	0
13	12183918	.	C	A	7	6	13	0	0	13	0	0
13	12201923	.	C	G	6	6	12	0	0	12	0	0
13	12202096	.	A	T	5	9	14	0	0	14	0	0
13	12202331	.	T	A	4	3	7	0	0	7	0	0
13	12207170	.	A	T	2	8	10	0	0	10	0	0
13	12207583	.	G	T	3	2	5	0	1	6	0	0
13	12207591	.	A	T	5	3	8	0	0	8	0	0
13	12207656	.	C	T	6	4	10	0	0	10	0	0
13	12300026	.	C	T	1	1	2	0	1	3	0	0
13	12300502	.	G	A	3	2	5	0	0	5	0	0
13	12329553	.	C	T	4	7	11	0	0	11	0	0
13	12370737	.	T	A	5	11	16	0	3	19	0	0
13	12370839	.	A	G	5	6	11	0	0	11	0	0
13	12370952	.	T	A	5	4	9	0	0	9	0	0
13	12371039	.	A	T	3	2	5	0	1	6	0	0
13	12371290	.	G	T	3	3	6	0	0	6	0	0
13	12371317	.	A	C	3	4	7	0	0	7	0	0
13	12371529	.	T	C	7	4	11	1	0	12	0	0
13	12371541	.	T	C	9	3	12	0	1	13	0	0
13	12371623	.	C	T	7	2	9	0	0	9	0	0
13	12371630	.	T	C	5	2	7	0	0	7	0	0
13	12372247	.	T	C	6	2	8	0	1	9	0	0
13	12372501	.	C	A	3	6	9	0	0	9	0	0
13	12372552	.	C	A	6	5	11	0	0	11	0	0
13	12372596	.	C	G	10	11	21	0	0	21	0	0
13	12372609	.	C	G	9	11	20	0	0	20	0	0
13	12372777	.	A	G	9	6	15	0	0	15	0	0
13	12373033	.	A	G	10	0	10	0	6	16	0	0
13	12373059	.	T	C	8	7	15	0	0	15	0	0
13	12373093	.	A	T	9	5	14	0	2	16	0	0
13	12373126	.	T	G	11	6	17	1	0	18	0	0
13	12373153	.	T	C	6	4	10	1	0	11	0	0
13	12373262	.	C	T	7	8	15	0	0	15	0	0
13	12373274	.	A	T	6	8	14	0	0	14	0	0
13	12373430	.	T	A	9	4	13	1	1	15	0	0
13	12373460	.	A	G	6	6	12	0	0	12	0	0
13	12373514	.	A	G	8	7	15	0	1	16	0	0
13	12373572	.	C	T	4	5	9	0	3	12	0	0
13	12373679	.	T	C	3	5	8	0	0	8	0	0
13	12374414	.	A	G	6	8	14	0	0	14	0	0
13	12374585	.	T	G	7	4	11	0	0	11	0	0
13	12374710	.	A	G	6	0	6	0	7	13	0	0
13	12374771	.	A	G	8	8	16	0	1	17	0	0
13	12374775	.	T	G	9	8	17	0	0	17	0	0
13	12374901	.	C	A	8	6	14	0	0	14	0	0
13	12374910	.	G	A	0	7	7	0	9	16	0	0
13	12374954	.	A	C	5	8	13	0	1	14	0	0
13	12375198	.	A	G	10	13	23	0	2	25	0	0
13	12375348	.	C	A	4	6	10	0	0	10	0	0
13	12375389	.	A	G	8	4	12	0	1	13	0	0
13	12378142	.	G	T	2	3	5	0	0	5	0	0
13	12378315	.	T	A	5	2	7	0	0	7	0	0
13	12378356	.	T	G	6	8	14	0	1	15	0	0
13	12378407	.	T	C	7	10	17	0	0	17	0	0
13	12385182	.	A	G	10	8	18	0	0	18	0	0
13	12385538	.	G	T	8	10	18	0	2	20	0	0
13	12387658	.	G	A	10	8	18	0	0	18	0	0
13	12395906	.	A	G	2	4	6	0	0	6	0	0
13	12395987	.	T	C	3	2	5	0	0	5	0	0
13	12419652	.	A	T	2	6	8	0	0	8	0	0
13	12419673	.	G	A	2	5	7	0	0	7	0	0
13	12419787	.	C	T	2	7	9	0	0	9	0	0
13	12426645	.	C	G	6	4	10	0	2	12	0	0
13	12428776	.	A	C	4	6	10	0	0	10	0	0
13	12441437	.	A	G	1	4	5	0	0	5	0	0
13	12443656	.	C	T	2	4	6	0	0	6	0	0
13	12443951	.	C	T	4	2	6	0	0	6	0	0
13	12444218	.	A	T	6	6	12	0	0	12	0	0
13	12447952	.	T	C	4	5	9	0	0	9	0	0
13	12447961	.	A	C	4	3	7	0	0	7	0	0
13	12450980	.	G	T	3	4	7	0	0	7	0	0
13	12479382	.	C	A	5	3	8	0	1	9	0	0
13	12479490	.	G	A	10	12	22	0	0	22	0	0
13	12482650	.	A	C	13	11	24	0	1	25	0	0
13	12485035	.	G	A	18	13	31	0	0	31	0	0
13	12489232	.	G	A	3	4	7	0	1	8	0	0
13	12489553	.	T	A	1	4	5	0	0	5	0	0
13	12494069	.	C	T	3	5	8	0	1	9	0	0
13	12494400	.	T	C	4	0	4	0	5	9	0	0
13	12494485	.	A	T	5	5	10	0	0	10	0	0
13	12632260	.	A	G	10	0	10	0	11	21	0	0
13	12632946	.	T	A	6	6	12	0	0	12	0	0
13	12632967	.	T	C	5	5	10	0	0	10	0	0
13	12633014	.	C	G	4	5	9	0	0	9	0	0
13	12665126	.	A	G	2	4	6	2	0	8	0	0
13	12665152	.	T	C	4	2	6	0	0	6	0	0
13	12665328	.	C	A	7	3	10	0	0	10	0	0
13	12665411	.	T	A	4	3	7	0	0	7	0	0
13	12665546	.	T	C	5	10	15	0	2	17	0	0
13	12665699	.	T	C	7	4	11	0	1	12	0	0
13	12665704	.	T	C	8	3	11	0	0	11	0	0
13	12665745	.	T	C	3	6	9	0	0	9	0	0
13	12665859	.	A	T	4	2	6	0	0	6	0	0
13	12665863	.	C	T	1	2	3	0	4	7	0	0
13	12665945	.	A	C	4	6	10	0	0	10	0	0
13	12665963	.	A	G	2	7	9	0	0	9	0	0
13	12665990	.	C	A	4	4	8	0	1	9	0	0
13	12666017	.	T	C	6	0	6	0	6	12	0	0
13	12666183	.	G	A	6	5	11	0	0	11	0	0
13	12666362	.	A	G	11	7	18	0	0	18	0	0
13	12681150	.	T	C	3	3	6	0	0	6	0	0
13	12739359	.	A	T	2	4	6	0	1	7	0	0
13	12739444	.	G	T	7	5	12	0	1	13	0	0
13	12739555	.	A	G	7	5	12	0	2	14	0	0
13	12739630	.	C	G	8	1	9	0	7	16	0	0
13	12739894	.	T	A	9	8	17	0	1	18	0	0
13	12740113	.	A	T	12	9	21	0	1	22	0	0
13	12740263	.	T	G	9	1	10	0	12	22	0	0
13	12740566	.	A	G	11	7	18	0	0	18	0	0
13	12740599	.	C	T	11	9	20	0	2	22	0	0
13	12740674	.	G	A	10	6	16	0	0	16	0	0
13	12740782	.	C	T	11	10	21	0	1	22	0	0
13	12740794	.	G	A	1	9	10	0	12	22	0	0
13	12740971	.	T	G	11	8	19	0	0	19	0	0
13	12762350	.	G	A	7	6	13	0	0	13	0	0
13	12762978	.	C	T	6	3	9	0	0	9	0	0
13	12765738	.	T	G	8	4	12	0	1	13	0	0
13	12778091	.	C	T	3	5	8	0	1	9	0	0
13	12778547	.	C	T	1	2	3	0	1	4	0	0
13	12816082	.	A	C	1	2	3	0	0	3	0	0
13	12831758	.	T	A	2	3	5	0	0	5	0	0
13	12834071	.	G	A	1	4	5	0	6	11	0	0
13	12840945	.	G	T	2	3	5	0	0	5	0	0
13	12847720	.	C	T	3	2	5	0	0	5	0	0
13	12861337	.	G	T	2	4	6	0	7	13	0	0
13	12865902	.	T	G	1	3	4	0	0	4	0	0
13	12868447	.	T	C	4	4	8	0	0	8	0	0
13	12874147	.	C	T	7	6	13	0	0	13	0	0
13	12874972	.	G	A	4	4	8	0	2	10	0	0
13	12875014	.	A	G	6	0	6	0	6	12	0	0
13	12875022	.	A	C	6	6	12	0	1	13	0	0
13	12883634	.	C	T	4	5	9	0	0	9	0	0
13	12883652	.	C	T	5	6	11	0	0	11	0	0
13	12883703	.	G	A	6	8	14	0	0	14	0	0
13	12899383	.	C	T	8	6	14	0	1	15	0	0
13	12899413	.	A	C	5	6	11	0	2	13	0	0
13	12902958	.	C	T	10	10	20	0	0	20	0	0
13	12904675	.	G	C	9	12	21	0	0	21	0	0
13	12904726	.	G	A	13	11	24	0	2	26	0	0
13	12904744	.	G	T	12	11	23	0	0	23	0	0
13	12904840	.	C	A	7	14	21	0	1	22	0	0
13	12911146	.	A	C	10	12	22	0	3	25	0	0
13	12911384	.	G	A	0	4	4	0	6	10	0	0
13	12916079	.	A	C	11	5	16	0	2	18	0	0
13	12916199	.	A	G	7	9	16	0	0	16	0	0
13	12917382	.	C	T	7	8	15	0	1	16	0	0
13	12918191	.	T	C	8	11	19	0	0	19	0	0
13	12918194	.	T	C	7	9	16	0	1	17	0	0
13	12919196	.	C	T	6	5	11	0	0	11	0	0
13	12920645	.	A	C	10	6	16	0	0	16	0	0
13	12920651	.	A	T	9	6	15	0	1	16	0	0
13	12940138	.	C	T	8	15	23	0	3	26	0	0
13	12943630	.	G	A	12	12	24	0	0	24	0	0
13	12949674	.	T	G	14	6	20	0	0	20	0	0
13	12955278	.	T	C	10	12	22	0	0	22	0	0
13	12955413	.	C	T	10	5	15	0	0	15	0	0
13	12955615	.	T	C	15	10	25	0	0	25	0	0
13	12957817	.	G	A	18	16	34	0	0	34	0	0
13	12961126	.	T	A	18	16	34	0	6	40	0	0
13	12961141	.	C	T	21	13	34	0	0	34	0	0
13	12962979	.	G	A	1	11	12	0	13	25	0	0
13	12967432	.	G	C	12	19	31	0	0	31	0	0
13	12967438	.	C	T	13	16	29	0	0	29	0	0
13	12970797	.	C	T	13	8	21	0	1	22	0	0
13	12971757	.	A	C	12	22	34	0	0	34	0	0
13	12971763	.	A	G	11	1	12	0	23	35	0	0
13	12971856	.	G	A	20	14	34	0	0	34	0	0
13	12974602	.	A	G	19	13	32	0	1	33	0	0
13	12985114	.	C	T	15	15	30	0	0	30	0	0
13	12985193	.	T	A	15	15	30	0	3	33	0	0
13	12985376	.	G	A	0	21	21	0	10	31	0	0
13	12985822	.	T	G	10	3	13	1	0	14	0	0
13	12994364	.	A	G	5	8	13	0	2	15	0	0
13	12994395	.	A	G	7	9	16	0	0	16	0	0
13	12994738	.	A	T	11	10	21	0	2	23	0	0
13	12994801	.	A	G	10	6	16	0	0	16	0	0
13	12994802	.	G	T	10	4	14	0	2	16	0	0
13	12997966	.	A	G	5	6	11	0	0	11	0	0
13	12999701	.	G	T	3	5	8	0	1	9	0	0
13	13008910	.	C	T	5	4	9	0	0	9	0	0
13	13008939	.	C	T	6	5	11	0	1	12	0	0
13	13012030	.	G	C	1	5	6	0	0	6	0	0
13	13019148	.	C	T	2	3	5	0	0	5	0	0
13	13019277	.	C	G	5	6	11	0	0	11	0	0
13	13026801	.	A	G	3	2	5	0	0	5	0	0
13	13052481	.	A	C	7	7	14	1	1	16	0	0
13	13052741	.	C	T	4	4	8	0	0	8	0	0
13	13052882	.	G	A	0	5	5	0	7	12	0	0
13	13074974	.	T	G	5	0	5	0	6	11	0	0
13	13075034	.	T	C	11	15	26	0	0	26	0	0
13	13091046	.	C	A	6	9	15	0	4	19	0	0
13	13091079	.	T	C	9	9	18	0	2	20	0	0
13	13094050	.	T	A	8	7	15	0	0	15	0	0
13	13213678	.	A	G	6	4	10	0	0	10	0	0
13	13214412	.	G	A	7	15	22	0	2	24	0	0
13	13214462	.	T	A	10	11	21	1	0	22	0	0
13	13215474	.	C	T	3	2	5	0	0	5	0	0
13	13215984	.	T	C	1	4	5	0	0	5	0	0
13	13216251	.	G	A	6	7	13	0	0	13	0	0
13	13216381	.	T	A	4	6	10	0	0	10	0	0
13	13216424	.	T	C	3	0	3	0	4	7	0	0
13	13216964	.	A	G	1	3	4	0	0	4	0	0
13	13216968	.	T	G	1	4	5	0	0	5	0	0
13	13221482	.	C	T	1	4	5	0	0	5	0	0
13	13230049	.	G	A	3	3	6	0	0	6	0	0
13	13681883	.	T	C	4	4	8	0	0	8	0	0
13	13693742	.	C	T	3	2	5	0	0	5	0	0
13	13693781	.	A	T	18	12	30	0	1	31	0	0
13	13697957	.	G	A	2	15	17	0	21	38	0	0
13	13698411	.	T	C	27	14	41	0	2	43	0	0
13	13698433	.	T	C	22	14	36	0	2	38	0	0
13	13700335	.	A	C	13	8	21	0	1	22	0	0
13	13704011	.	T	G	22	12	34	0	1	35	0	0
13	13713106	.	C	G	20	19	39	0	0	39	0	0
13	13724919	.	T	A	16	10	26	0	1	27	0	0
13	13737474	.	G	C	31	16	47	0	3	50	0	0
13	13737514	.	A	G	37	1	38	0	15	53	0	0
13	13737524	.	G	A	41	18	59	0	1	60	0	0
13	13737612	.	G	C	5	20	25	0	34	59	0	0
13	13771020	.	G	A	6	3	9	0	0	9	0	0
13	13796754	.	A	C	14	10	24	0	1	25	0	0
13	13824580	.	A	G	8	8	16	0	0	16	0	0
13	13882099	.	T	C	8	5	13	0	0	13	0	0
13	13882367	.	A	C	5	10	15	0	0	15	0	0
13	13913140	.	G	C	2	10	12	0	11	23	0	0
13	13917991	.	C	T	16	8	24	0	2	26	0	0
13	13930392	.	G	A	2	2	4	0	0	4	0	0
13	13933605	.	G	T	3	7	10	0	0	10	0	0
13	13938461	.	G	A	0	2	2	0	5	7	0	0
13	13943234	.	A	T	3	2	5	0	0	5	0	0
13	13943238	.	C	A	2	1	3	0	1	4	0	0
13	13943959	.	T	C	5	8	13	0	0	13	0	0
13	13943983	.	A	G	4	10	14	0	1	15	0	0
13	13982700	.	A	G	5	3	8	0	0	8	0	0
13	13997101	.	C	T	4	4	8	0	0	8	0	0
13	13997299	.	C	T	2	10	12	0	2	14	0	0
13	13997446	.	G	T	0	3	3	0	3	6	0	0
13	13997481	.	T	C	4	4	8	0	0	8	0	0
13	13997829	.	G	A	3	3	6	0	1	7	0	0
13	13999037	.	A	T	5	4	9	0	0	9	0	0
13	13999082	.	G	A	5	4	9	0	0	9	0	0
13	14002979	.	G	T	2	3	5	0	0	5	0	0
13	14003099	.	A	G	7	3	10	0	0	10	0	0
13	14004161	.	T	C	7	4	11	0	1	12	0	0
13	14004276	.	C	T	3	3	6	0	0	6	0	0
13	14023838	.	G	A	0	3	3	0	4	7	0	0
13	14070868	.	C	T	6	6	12	0	0	12	0	0
13	14087004	.	A	G	5	0	5	0	11	16	0	0
13	14092489	.	C	T	13	13	26	0	0	26	0	0
13	14092573	.	G	A	14	12	26	0	1	27	0	0
13	14094441	.	G	A	6	10	16	0	1	18	1	0
13	14098156	.	T	C	5	6	11	0	2	13	0	0
13	14104076	.	T	C	8	13	21	0	1	22	0	0
13	14137061	.	C	T	11	8	19	0	0	19	0	0
13	14181750	.	C	T	9	12	21	0	2	23	0	0
13	14181952	.	T	C	9	11	20	0	2	22	0	0
13	14190780	.	C	T	1	15	16	0	20	36	0	0
13	14191033	.	T	C	11	19	30	0	0	30	0	0
13	14191045	.	G	C	8	17	25	0	0	25	0	0
13	14191528	.	A	G	17	10	27	0	0	27	0	0
13	14191553	.	A	G	20	4	24	0	0	24	0	0
13	14191724	.	G	A	14	8	22	0	2	24	0	0
13	14191769	.	T	C	21	14	35	0	4	39	0	0
13	14191797	.	A	G	21	13	34	0	1	35	0	0
13	14192110	.	T	C	16	10	26	0	0	26	0	0
13	14192131	.	G	A	14	9	23	0	0	23	0	0
13	14192178	.	A	T	14	9	23	0	0	23	0	0
13	14192414	.	A	G	7	6	13	0	1	14	0	0
13	14192448	.	A	C	7	4	11	0	0	11	0	0
13	14192506	.	G	A	8	7	15	1	0	16	0	0
13	14192511	.	A	T	7	8	15	1	0	16	0	0
13	14192561	.	G	T	7	8	15	0	0	15	0	0
13	14194055	.	C	G	11	7	18	0	2	20	0	0
13	14194109	.	C	G	7	12	19	0	0	19	0	0
13	14194110	.	C	A	7	12	19	0	0	19	0	0
13	14194484	.	C	T	12	14	26	0	1	27	0	0
13	14194571	.	G	A	13	7	20	0	1	21	0	0
13	14194573	.	C	A	15	7	22	0	0	22	0	0
13	14194611	.	T	G	11	13	24	0	2	26	0	0
13	14194660	.	G	A	8	13	21	0	0	21	0	0
13	14194904	.	T	C	12	11	23	0	0	23	0	0
13	14199190	.	A	G	14	24	38	0	5	43	0	0
13	14220900	.	G	A	9	16	25	0	0	25	0	0
13	14251280	.	C	T	0	13	13	0	12	25	0	0
13	14487445	.	T	C	8	0	8	0	11	19	0	0
13	14902500	.	C	A	8	3	11	0	0	11	0	0
13	14902507	.	T	C	8	3	11	0	0	11	0	0
13	14902546	.	C	T	10	10	20	0	0	20	0	0
13	14902702	.	G	A	9	8	17	0	0	17	0	0
13	14906587	.	G	C	8	9	17	0	0	17	0	0
13	14906614	.	G	A	11	11	22	0	0	22	0	0
13	14906754	.	A	G	7	6	13	0	1	14	0	0
13	14908880	.	A	G	5	9	14	0	0	14	0	0
13	14908903	.	T	C	9	8	17	0	0	17	0	0
13	14915618	.	A	T	2	2	4	0	0	4	0	0
13	14915669	.	G	A	1	2	3	0	0	3	0	0
13	15141803	.	A	T	7	4	11	0	0	11	0	0
13	15191053	.	T	C	2	3	5	0	0	5	0	0
13	15194509	.	A	G	3	5	8	0	0	8	0	0
13	15194555	.	C	T	4	3	7	0	0	7	0	0
13	15194711	.	T	C	3	2	5	0	0	5	0	0
13	15210469	.	C	A	3	3	6	0	0	6	0	0
13	15210557	.	C	T	4	4	8	0	0	8	0	0
13	15211952	.	T	C	3	2	5	0	0	5	0	0
13	15212460	.	G	C	1	2	3	0	2	5	0	0
13	15212962	.	T	A	2	3	5	0	0	5	0	0
13	15213130	.	A	T	2	2	4	0	1	5	0	0
13	15215789	.	A	T	15	21	36	0	1	38	1	0
13	15580864	.	T	A	32	13	45	0	1	46	0	0
13	15580879	.	T	G	26	0	26	0	17	43	0	0
13	15580948	.	G	T	20	8	28	0	1	29	0	0
13	15647444	.	A	G	17	14	31	0	0	31	0	0
13	15657987	.	A	G	29	25	54	0	3	57	0	0
13	15668124	.	A	T	8	10	18	0	0	18	0	0
13	15696717	.	T	G	1	2	3	0	0	3	0	0
13	15762320	.	A	C	3	2	5	0	1	6	0	0
13	15762515	.	T	C	10	7	17	0	0	17	0	0
13	15763046	.	G	T	7	0	7	0	1	8	0	0
13	15763061	.	G	T	4	5	9	0	0	9	0	0
13	15763139	.	C	T	1	3	4	0	5	9	0	0
13	15763233	.	T	C	5	0	5	0	7	12	0	0
13	15763273	.	T	C	2	4	6	0	0	6	0	0
13	15763733	.	T	C	6	6	12	0	0	12	0	0
13	15778124	.	T	C	4	0	4	0	7	11	0	0
13	15778128	.	C	T	4	6	10	0	0	10	0	0
13	15800977	.	T	G	3	8	11	0	0	11	0	0
13	15801705	.	T	A	7	11	18	0	0	18	0	0
13	15801726	.	T	C	5	9	14	0	1	15	0	0
13	15814429	.	A	G	4	2	6	5	0	11	0	0
13	15814724	.	T	A	3	2	5	0	0	5	0	0
13	15816637	.	G	A	21	17	38	0	4	42	0	0
13	15848817	.	A	G	24	23	47	0	2	49	0	0
13	15849541	.	T	C	33	22	55	0	0	55	0	0
13	15869322	.	A	G	21	17	38	1	1	40	0	0
13	15872256	.	A	G	24	25	49	0	4	53	0	0
13	15880940	.	T	G	29	30	59	0	0	59	0	0
13	15882860	.	A	C	30	22	52	1	1	54	0	0
13	15897090	.	C	T	4	2	6	0	0	6	0	0
13	15897108	.	A	G	4	4	8	0	0	8	0	0
13	15897141	.	A	G	2	4	6	0	1	7	0	0
13	15929049	.	A	G	4	4	8	0	0	8	0	0
13	15929121	.	C	A	1	3	4	0	8	12	0	0
13	15929182	.	G	A	5	5	10	3	0	13	0	0
13	15929197	.	A	T	3	3	6	3	2	11	0	0
13	15929308	.	C	A	6	9	15	0	0	16	1	0
13	15958748	.	C	A	3	2	5	0	0	5	0	0
13	15958754	.	G	C	1	2	3	0	0	3	0	0
13	15958963	.	G	A	2	3	5	0	0	5	0	0
13	16186182	.	G	A	6	8	14	0	0	14	0	0
13	16186209	.	T	C	7	0	7	0	5	12	0	0
13	16191517	.	A	T	10	4	14	0	1	15	0	0
13	16191580	.	A	G	11	9	20	0	2	22	0	0
13	16191635	.	A	T	10	7	17	0	0	17	0	0
13	16300670	.	T	C	3	8	11	0	0	11	0	0
13	16311465	.	A	G	6	5	11	0	0	11	0	0
13	16313525	.	G	C	10	5	15	0	0	15	0	0
13	16326333	.	G	T	3	2	5	0	0	5	0	0
13	16413293	.	C	T	6	6	12	0	1	13	0	0
13	16413366	.	T	C	5	8	13	0	0	13	0	0
13	16420480	.	T	A	7	10	17	0	1	18	0	0
13	16420799	.	A	G	7	5	12	0	0	12	0	0
13	16425241	.	C	T	7	5	12	0	0	12	0	0
13	16425350	.	T	C	4	7	11	0	2	13	0	0
13	16428604	.	T	C	5	6	11	0	3	14	0	0
13	16436353	.	C	T	12	9	21	0	0	21	0	0
13	16436524	.	A	G	3	6	9	0	4	13	0	0
13	16436686	.	C	T	7	6	13	0	0	13	0	0
13	16436786	.	T	C	9	7	16	0	0	16	0	0
13	16448511	.	G	A	0	6	6	0	3	9	0	0
13	16474382	.	A	G	5	0	5	0	10	15	0	0
13	16479914	.	T	A	7	9	16	0	0	16	0	0
13	16496254	.	T	C	9	9	18	0	0	18	0	0
13	16496770	.	T	A	15	5	20	0	1	21	0	0
13	16522322	.	A	T	13	10	23	0	1	24	0	0
13	16522533	.	C	G	6	7	13	0	0	13	0	0
13	16522880	.	C	T	9	14	23	0	1	24	0	0
13	16759638	.	A	G	6	10	16	0	0	16	0	0
13	16809610	.	T	C	12	14	26	0	1	27	0	0
13	16852953	.	G	A	9	15	24	0	1	25	0	0
13	16855387	.	C	A	12	12	24	0	0	24	0	0
13	16856045	.	T	A	14	21	35	0	0	35	0	0
13	16871830	.	A	C	16	13	29	0	1	30	0	0
13	16876825	.	C	T	15	16	31	0	1	32	0	0
13	16878895	.	A	C	21	19	40	0	5	45	0	0
13	16886040	.	C	T	23	13	36	0	0	36	0	0
13	16886068	.	C	T	21	11	32	0	1	33	0	0
13	17702657	.	C	T	14	7	21	0	0	21	0	0
13	17702802	.	C	T	7	12	19	0	1	20	0	0
13	17703097	.	A	G	9	0	9	0	6	15	0	0
13	17703308	.	G	A	8	11	19	0	0	19	0	0
13	17703453	.	T	A	15	8	23	0	0	23	0	0
13	17703454	.	C	A	15	8	23	0	0	23	0	0
13	17703548	.	C	T	12	9	21	0	0	21	0	0
13	17703557	.	G	C	1	9	10	0	11	21	0	0
13	17705633	.	C	T	7	10	17	0	0	17	0	0
13	17705669	.	C	T	9	9	18	0	2	20	0	0
13	17705681	.	C	T	13	11	24	0	0	24	0	0
13	17714510	.	G	T	25	21	46	0	2	48	0	0
13	17714530	.	C	A	22	22	44	0	1	45	0	0
13	17714881	.	C	T	24	15	39	0	9	48	0	0
13	17714905	.	T	C	20	22	42	0	3	45	0	0
13	17752932	.	A	T	9	7	16	0	0	16	0	0
13	17752993	.	C	A	4	2	6	0	0	6	0	0
13	17754275	.	G	T	6	4	10	0	1	11	0	0
13	17754466	.	C	T	1	2	3	0	0	3	0	0
13	17754571	.	C	G	9	4	13	0	1	14	0	0
13	17755618	.	T	C	8	9	17	0	2	19	0	0
13	17755743	.	G	A	9	5	14	0	0	14	0	0
13	17755898	.	G	A	12	5	17	0	0	17	0	0
13	17755980	.	G	A	5	7	12	0	0	12	0	0
13	17758102	.	T	C	2	3	5	0	0	5	0	0
13	17800661	.	T	C	7	0	7	0	6	13	0	0
13	17943175	.	G	T	5	3	8	0	0	8	0	0
13	18011130	.	T	G	3	4	7	0	0	7	0	0
13	18011158	.	G	T	7	5	12	0	0	12	0	0
13	18019724	.	T	C	2	4	6	0	0	6	0	0
13	18019758	.	C	T	0	5	5	0	2	7	0	0
13	18019786	.	C	T	1	2	3	0	4	7	0	0
13	18032872	.	C	T	0	5	5	0	10	15	0	0
13	18032941	.	A	G	7	7	14	0	0	14	0	0
13	18032960	.	G	A	7	6	13	0	0	13	0	0
13	18033053	.	A	G	2	3	5	0	0	5	0	0
13	18033405	.	T	C	3	2	5	0	2	7	0	0
13	18038643	.	G	A	3	4	7	0	0	7	0	0
13	18064397	.	G	A	3	2	5	0	0	5	0	0
13	18069031	.	A	G	5	3	8	0	0	8	0	0
13	18069311	.	C	A	0	4	4	0	3	7	0	0
13	18069338	.	C	A	4	3	7	0	0	7	0	0
13	18073433	.	A	G	8	16	24	0	0	24	0	0
13	18073460	.	C	T	17	6	23	0	0	23	0	0
13	18073557	.	C	A	10	4	14	0	1	15	0	0
13	18073706	.	G	A	13	10	23	0	1	24	0	0
13	18076710	.	T	G	12	9	21	0	1	22	0	0
13	18076722	.	G	T	10	11	21	0	2	23	0	0
13	18076818	.	G	A	10	18	28	0	0	28	0	0
13	18077056	.	G	T	15	14	29	0	2	31	0	0
13	18077116	.	G	A	14	16	30	0	0	30	0	0
13	18077206	.	C	T	18	10	28	0	1	29	0	0
13	18083210	.	G	T	13	13	26	0	2	28	0	0
13	18083415	.	G	A	14	8	22	0	1	23	0	0
13	18087918	.	G	A	9	11	20	0	0	20	0	0
13	18088276	.	T	G	13	7	20	0	1	21	0	0
13	18088283	.	C	T	2	14	16	0	6	22	0	0
13	18092062	.	G	T	10	8	18	0	0	18	0	0
13	18102984	.	A	G	6	7	13	0	0	13	0	0
13	18104881	.	C	T	2	8	10	0	9	19	0	0
13	18104890	.	C	T	10	5	15	0	0	15	0	0
13	18105007	.	A	G	5	6	11	2	1	14	0	0
13	18105023	.	T	G	4	9	13	2	1	16	0	0
13	18105136	.	C	A	1	8	9	1	6	16	0	0
13	18105175	.	G	A	5	4	9	1	0	10	0	0
13	18105382	.	A	G	10	5	15	0	1	16	0	0
13	18109897	.	T	C	3	0	3	0	4	7	0	0
13	18110003	.	T	C	8	0	8	0	13	21	0	0
13	18110284	.	C	T	2	5	7	0	7	14	0	0
13	18113387	.	G	T	5	4	9	0	0	9	0	0
13	18114994	.	A	G	8	8	16	0	1	17	0	0
13	18119378	.	C	G	7	9	16	0	0	16	0	0
13	18119488	.	T	C	8	5	13	0	0	13	0	0
13	18119489	.	C	T	7	5	12	0	1	13	0	0
13	18179151	.	C	A	4	3	7	0	0	7	0	0
13	18179500	.	G	C	4	5	9	0	1	10	0	0
13	18179733	.	T	A	17	7	24	0	0	24	0	0
13	18195926	.	G	A	4	6	10	0	0	10	0	0
13	18274914	.	A	C	6	5	11	0	0	11	0	0
13	18275033	.	C	T	2	5	7	0	1	8	0	0
13	18275036	.	G	A	1	5	6	0	3	9	0	0
13	18275167	.	A	T	4	5	9	0	0	9	0	0
13	18275320	.	G	A	3	10	13	0	0	13	0	0
13	18275674	.	T	C	1	2	3	0	0	3	0	0
13	18275686	.	A	G	1	0	1	0	3	4	0	0
13	18275801	.	C	A	6	2	8	0	0	8	0	0
13	18275935	.	T	C	7	5	12	0	0	12	0	0
13	18276074	.	A	C	9	4	13	0	0	13	0	0
13	18276338	.	G	T	0	5	5	0	4	9	0	0
13	18276387	.	T	G	3	5	8	0	0	8	0	0
13	18276559	.	G	C	8	8	16	0	1	17	0	0
13	18276820	.	C	G	5	5	10	0	0	10	0	0
13	18277078	.	A	G	8	6	14	0	0	14	0	0
13	18277090	.	G	T	0	5	5	0	6	11	0	0
13	18282953	.	G	A	3	4	7	0	0	7	0	0
13	18295212	.	C	T	7	6	13	0	1	14	0	0
13	18295423	.	G	A	0	5	5	0	6	11	0	0
13	18295468	.	C	T	8	12	20	0	0	20	0	0
13	18295608	.	G	A	1	4	5	0	8	13	0	0
13	18295680	.	T	C	8	6	14	0	0	14	0	0
13	18321156	.	T	C	17	5	22	0	1	24	1	0
13	18323464	.	A	G	8	15	23	0	0	23	0	0
13	18323595	.	G	A	1	10	11	0	23	34	0	0
13	18323653	.	A	G	14	0	14	0	13	27	0	0
13	18323787	.	T	A	15	13	28	0	2	30	0	0
13	18358680	.	G	A	17	13	30	0	0	30	0	0
13	18358890	.	G	C	12	22	34	0	0	34	0	0
13	18359112	.	G	C	7	22	29	0	0	29	0	0
13	18359176	.	C	A	19	8	27	0	1	28	0	0
13	18359202	.	C	T	14	6	20	0	2	22	0	0
13	18359507	.	A	T	9	10	19	1	1	21	0	0
13	18359551	.	T	C	6	5	11	0	0	11	0	0
13	18359554	.	A	G	6	5	11	0	0	11	0	0
13	18371186	.	A	C	7	2	9	0	0	9	0	0
13	18375465	.	C	A	7	8	15	0	4	19	0	0
13	18375512	.	T	A	16	10	26	0	2	28	0	0
13	18379281	.	A	T	3	6	9	0	1	10	0	0
13	18382192	.	T	C	4	11	15	0	1	16	0	0
13	18385497	.	C	T	7	10	17	0	0	17	0	0
13	18385749	.	G	A	0	3	3	0	4	7	0	0
13	18394755	.	T	A	13	13	26	0	2	28	0	0
13	18397416	.	G	C	4	9	13	0	1	14	0	0
13	18401308	.	C	T	5	4	9	0	1	10	0	0
13	18409776	.	T	A	6	6	12	0	1	13	0	0
13	18410799	.	G	C	0	3	3	0	4	7	0	0
13	18418390	.	C	T	6	8	14	0	1	15	0	0
13	18418528	.	G	A	10	11	21	0	1	22	0	0
13	18428103	.	A	G	13	12	25	0	0	25	0	0
13	18431301	.	C	T	3	16	19	0	0	19	0	0
13	18431430	.	C	T	9	9	18	0	0	18	0	0
13	18434075	.	A	G	3	0	3	0	4	7	0	0
13	18434085	.	C	T	3	4	7	0	0	7	0	0
13	18434150	.	T	C	3	4	7	0	0	7	0	0
13	18434229	.	A	T	1	3	4	0	0	4	0	0
13	18434427	.	C	T	4	9	13	0	0	13	0	0
13	18434519	.	C	A	6	10	16	0	0	16	0	0
13	18434520	.	G	C	1	10	11	0	6	17	0	0
13	18434570	.	C	G	14	5	19	0	1	20	0	0
13	18434794	.	C	A	3	7	10	0	0	10	0	0
13	18434902	.	C	T	5	8	13	0	1	14	0	0
13	18434957	.	G	A	4	5	9	0	0	9	0	0
13	18434962	.	A	G	4	3	7	0	0	7	0	0
13	18435036	.	C	A	1	3	4	0	0	4	0	0
13	18498805	.	T	G	2	2	4	0	0	4	0	0
13	18498809	.	G	A	2	2	4	0	0	4	0	0
13	18499773	.	A	T	1	3	4	0	0	4	0	0
13	18503647	.	C	T	0	2	2	0	2	4	0	0
13	18507715	.	A	C	17	14	31	0	0	31	0	0
13	18509592	.	G	A	0	13	13	0	23	36	0	0
13	18510033	.	C	G	17	0	17	0	12	29	0	0
13	18510204	.	T	C	23	13	36	0	1	37	0	0
13	18510324	.	A	G	21	15	36	1	2	39	0	0
13	18511023	.	C	T	10	12	22	0	0	22	0	0
13	18511140	.	A	G	18	0	18	0	9	27	0	0
13	18511637	.	A	C	9	10	19	0	4	23	0	0
13	18512082	.	C	G	12	13	25	0	0	25	0	0
13	18629629	.	T	A	1	2	3	0	0	3	0	0
13	18663103	.	G	A	8	2	10	0	0	10	0	0
13	18663156	.	G	A	1	8	9	0	4	13	0	0
13	18669200	.	G	T	11	12	23	0	0	23	0	0
13	18678392	.	G	A	15	4	19	0	0	19	0	0
13	18680027	.	G	A	10	16	26	0	3	29	0	0
13	18685673	.	G	A	12	14	26	1	0	27	0	0
13	18689043	.	C	T	13	23	36	0	2	38	0	0
13	18801566	.	G	A	7	8	15	0	0	15	0	0
13	18801615	.	G	A	6	8	14	0	0	14	0	0
13	19304688	.	A	G	22	18	40	0	1	41	0	0
13	19316930	.	G	C	11	8	19	0	0	19	0	0
13	19317016	.	T	A	5	8	13	0	0	13	0	0
13	19317018	.	C	G	5	7	12	0	1	13	0	0
13	19317051	.	T	G	3	4	7	0	1	8	0	0
13	19317499	.	G	C	5	4	9	0	1	10	0	0
13	19610625	.	C	T	0	2	2	0	3	5	0	0
13	19610772	.	C	T	0	5	5	0	3	8	0	0
13	19627150	.	A	G	4	3	7	0	0	7	0	0
13	19629032	.	G	T	2	5	7	0	0	7	0	0
13	19629266	.	C	G	6	8	14	0	0	14	0	0
13	19639198	.	A	G	2	4	6	0	0	6	0	0
13	19639205	.	G	A	2	5	7	0	0	7	0	0
13	19639238	.	T	C	3	6	9	0	0	9	0	0
13	19639256	.	T	C	3	0	3	0	8	11	0	0
13	19639557	.	G	A	4	2	6	0	1	7	0	0
13	19768396	.	G	T	9	11	20	1	2	23	0	0
13	19799192	.	A	G	8	8	16	0	0	16	0	0
13	19799467	.	G	A	12	11	23	0	2	25	0	0
13	19799611	.	C	A	1	10	11	0	9	20	0	0
13	19799623	.	T	C	7	9	16	0	1	17	0	0
13	19799646	.	C	A	1	6	7	0	10	17	0	0
13	19884720	.	C	T	2	4	6	0	0	6	0	0
13	20022306	.	G	A	1	4	5	0	2	7	0	0
13	20028119	.	T	C	3	3	6	0	0	6	0	0
13	20038622	.	G	A	2	3	5	0	0	5	0	0
13	20053641	.	C	T	2	6	8	0	0	8	0	0
13	20221901	.	A	G	1	2	3	0	0	3	0	0
13	20278009	.	A	T	3	4	7	0	0	7	0	0
13	20392670	.	G	C	9	0	9	0	12	21	0	0
13	20392704	.	G	A	12	8	20	0	0	20	0	0
13	20392714	.	G	T	14	6	20	0	2	22	0	0
13	20392752	.	G	A	24	8	32	0	0	32	0	0
13	20392788	.	A	G	23	8	31	0	4	35	0	0
13	20401263	.	C	A	1	19	20	0	16	36	0	0
13	20401267	.	T	C	17	13	30	0	5	35	0	0
13	20401392	.	C	T	19	15	34	0	1	35	0	0
13	20425191	.	A	G	16	11	27	0	0	27	0	0
13	20425396	.	C	T	0	13	13	0	12	25	0	0
13	20518608	.	A	T	13	16	29	0	0	29	0	0
13	20518620	.	C	T	1	18	19	0	11	30	0	0
13	20518757	.	G	A	11	12	23	0	1	24	0	0
13	21638541	.	G	A	2	2	4	0	0	4	0	0
13	21638634	.	C	T	1	4	5	0	2	7	0	0
13	21639011	.	G	C	6	3	9	0	0	9	0	0
13	21674509	.	T	C	1	4	5	0	0	5	0	0
13	21677621	.	T	C	4	3	7	0	0	7	0	0
13	21677961	.	G	A	8	3	11	0	0	11	0	0
13	21680844	.	A	T	5	2	7	0	0	7	0	0
13	21683057	.	A	C	3	5	8	0	0	8	0	0
13	21683546	.	C	T	13	12	25	1	0	26	0	0
13	21683636	.	G	A	14	13	27	0	2	29	0	0
13	21683762	.	C	T	0	8	8	0	17	25	0	0
13	21683928	.	G	A	15	18	33	0	3	36	0	0
13	21689883	.	T	G	6	5	11	0	0	11	0	0
13	21689982	.	G	A	6	3	9	0	0	9	0	0
13	21690053	.	T	A	4	6	10	0	0	10	0	0
13	21690055	.	A	G	7	4	11	0	0	11	0	0
13	21690104	.	C	T	0	6	6	0	8	14	0	0
13	21690229	.	A	C	9	4	13	0	0	13	0	0
13	21690507	.	T	A	8	11	19	0	0	19	0	0
13	21690877	.	A	C	13	0	13	1	7	21	0	0
13	21691386	.	G	A	7	4	11	0	0	11	0	0
13	21691609	.	C	T	4	4	8	0	2	10	0	0
13	21691671	.	G	A	3	5	8	0	1	9	0	0
13	21691695	.	T	A	5	3	8	0	0	8	0	0
13	21691787	.	C	G	9	8	17	0	0	17	0	0
13	21691843	.	G	A	6	10	16	0	0	16	0	0
13	21691935	.	A	G	2	9	11	0	0	11	0	0
13	21692084	.	T	A	5	6	11	0	1	12	0	0
13	21692085	.	C	A	6	5	11	0	1	12	0	0
13	21692328	.	C	A	10	6	16	0	0	16	0	0
13	21692338	.	C	T	11	7	18	0	0	18	0	0
13	21712507	.	G	A	18	15	33	0	0	33	0	0
13	21712526	.	G	A	18	15	33	0	1	34	0	0
13	21712755	.	G	C	11	21	32	0	1	33	0	0
13	21716581	.	T	C	10	15	25	0	0	25	0	0
13	21722470	.	G	A	14	15	29	0	1	30	0	0
13	21723323	.	G	A	16	11	27	0	0	27	0	0
13	21723514	.	G	C	17	8	25	0	1	26	0	0
13	21725457	.	T	A	9	4	13	0	2	15	0	0
13	21725526	.	T	C	10	12	22	0	1	23	0	0
13	21727796	.	T	A	11	13	24	0	2	26	0	0
13	21735278	.	C	T	4	12	16	0	0	16	0	0
13	21739036	.	A	T	4	5	9	0	0	9	0	0
13	21798922	.	C	T	5	2	7	0	0	7	0	0
13	21799051	.	A	T	3	2	5	0	0	5	0	0
13	21804229	.	G	A	0	3	3	0	5	8	0	0
13	21807982	.	G	A	2	3	5	0	0	5	0	0
13	21810659	.	G	A	0	2	2	0	3	5	0	0
13	21818449	.	G	A	2	4	6	0	1	7	0	0
13	21818472	.	C	A	4	4	8	0	1	9	0	0
13	21818616	.	G	A	3	1	4	0	2	6	0	0
13	21818812	.	C	T	5	3	8	0	0	8	0	0
13	21819538	.	C	T	2	3	5	0	0	5	0	0
13	21819629	.	A	T	7	5	12	0	1	13	0	0
13	21819791	.	A	T	2	2	4	0	0	4	0	0
13	21819997	.	G	A	1	3	4	1	0	5	0	0
13	21820802	.	A	T	7	6	13	0	1	14	0	0
13	21826203	.	G	T	7	11	18	0	0	18	0	0
13	21826470	.	G	A	0	6	6	0	5	11	0	0
13	21851617	.	C	T	9	3	12	0	0	12	0	0
13	21852008	.	G	A	0	10	10	0	6	16	0	0
13	21855829	.	G	A	6	6	12	0	3	15	0	0
13	21856576	.	A	T	11	10	21	0	1	22	0	0
13	21856741	.	G	A	10	6	16	0	1	17	0	0
13	21856849	.	G	A	5	7	12	0	5	17	0	0
13	21860027	.	T	A	5	7	12	0	2	14	0	0
13	21860111	.	G	A	4	7	11	0	0	11	0	0
13	21861775	.	A	C	13	10	23	0	0	23	0	0
13	21861777	.	G	A	12	10	22	0	0	22	0	0
13	21862288	.	T	A	11	6	17	0	1	18	0	0
13	21866052	.	C	T	10	9	19	0	0	19	0	0
13	21866324	.	C	T	14	10	24	0	0	24	0	0
13	21866357	.	A	C	7	13	20	0	3	23	0	0
13	21870319	.	G	C	9	10	19	0	0	19	0	0
13	21870323	.	T	C	9	9	18	0	1	19	0	0
13	21870374	.	G	A	1	14	15	0	19	34	0	0
13	21870467	.	G	C	1	15	16	0	18	34	0	0
13	21870575	.	A	G	19	1	20	0	22	42	0	0
13	21870608	.	A	T	18	16	34	0	0	34	0	0
13	21870629	.	C	T	17	15	32	0	2	34	0	0
13	21874107	.	C	T	18	11	29	0	2	31	0	0
13	21874128	.	G	T	15	16	31	0	0	31	0	0
13	21874149	.	G	T	1	15	16	0	17	33	0	0
13	21884298	.	C	T	17	8	25	0	0	25	0	0
13	21884407	.	T	C	11	14	25	0	0	25	0	0
13	21884408	.	C	T	11	14	25	0	0	25	0	0
13	21884467	.	C	T	11	14	25	0	0	25	0	0
13	21884979	.	T	C	11	11	22	0	0	22	0	0
13	21884980	.	C	T	10	11	21	0	1	22	0	0
13	21885250	.	C	T	21	14	35	0	1	36	0	0
13	21888285	.	T	A	4	8	12	0	1	13	0	0
13	21888292	.	A	T	5	8	13	0	0	13	0	0
13	21888330	.	A	C	2	7	9	0	0	9	0	0
13	21888331	.	A	T	2	7	9	0	0	9	0	0
13	21919830	.	A	T	3	5	8	0	0	8	0	0
13	21919855	.	A	G	5	0	5	0	3	8	0	0
13	21974290	.	G	T	0	13	13	0	6	19	0	0
13	22039657	.	C	T	2	5	7	0	0	7	0	0
13	22064575	.	C	G	2	6	8	0	0	8	0	0
13	22064592	.	G	A	4	3	7	0	1	8	0	0
13	22065089	.	G	A	7	2	9	0	2	11	0	0
13	22065148	.	G	A	1	5	6	0	5	11	0	0
13	22065406	.	G	A	4	3	7	0	0	7	0	0
13	22065793	.	A	G	2	0	2	0	10	12	0	0
13	22065904	.	T	G	1	8	9	0	1	10	0	0
13	22084034	.	C	T	6	9	15	0	0	15	0	0
13	22087988	.	C	T	6	22	28	0	0	28	0	0
13	22088061	.	T	G	8	0	8	0	12	20	0	0
13	22088105	.	G	A	3	15	18	0	0	18	0	0
13	22094800	.	T	C	9	8	17	0	0	17	0	0
13	22094871	.	T	G	9	15	24	0	0	24	0	0
13	22095340	.	C	T	5	18	23	0	0	23	0	0
13	22095589	.	G	A	3	8	11	0	0	11	0	0
13	22095594	.	T	A	3	9	12	0	0	12	0	0
13	22113569	.	C	T	0	2	2	0	1	3	0	0
13	22119935	.	T	C	20	14	34	2	1	37	0	0
13	22206667	.	A	T	22	23	45	0	0	45	0	0
13	22238209	.	T	C	19	17	36	0	2	38	0	0
13	22238233	.	G	A	23	15	38	0	2	40	0	0
13	22241027	.	G	A	22	24	46	0	4	50	0	0
13	22241123	.	G	T	2	7	9	0	29	39	1	0
13	22241374	.	A	C	23	15	38	0	2	40	0	0
13	22241482	.	G	C	10	16	26	0	2	28	0	0
13	22241648	.	T	G	21	19	40	0	4	44	0	0
13	22241821	.	T	C	27	14	41	0	2	43	0	0
13	22242394	.	C	G	22	25	47	0	1	48	0	0
13	22242837	.	T	G	19	20	39	0	1	40	0	0
13	22303944	.	T	G	2	3	5	0	1	6	0	0
13	22316792	.	A	G	12	0	12	0	11	23	0	0
13	22317136	.	A	T	5	6	11	0	2	13	0	0
13	22317347	.	A	G	10	11	21	0	1	22	0	0
13	22328560	.	G	A	4	7	11	0	2	13	0	0
13	22328575	.	C	T	3	10	13	0	1	14	0	0
13	22340444	.	C	T	7	11	18	0	0	18	0	0
13	22340456	.	G	A	6	12	18	0	2	20	0	0
13	22347506	.	C	T	8	10	18	0	0	18	0	0
13	22351910	.	A	G	8	13	21	0	0	21	0	0
13	22355859	.	T	C	7	10	17	0	0	17	0	0
13	22357105	.	C	A	15	15	30	0	0	30	0	0
13	22357236	.	T	G	15	5	20	0	0	20	0	0
13	22357823	.	C	T	10	10	20	0	0	20	0	0
13	22358021	.	A	G	10	10	20	0	2	22	0	0
13	22358174	.	G	A	1	11	12	0	11	23	0	0
13	22361332	.	G	A	10	17	27	0	0	27	0	0
13	22361718	.	A	C	9	13	22	0	0	22	0	0
13	22364908	.	T	C	8	16	24	0	0	24	0	0
13	22365016	.	C	T	17	19	36	0	0	36	0	0
13	22365404	.	C	T	11	15	26	0	0	26	0	0
13	22365461	.	A	G	17	14	31	0	2	33	0	0
13	22367600	.	C	A	17	19	36	0	3	39	0	0
13	22369295	.	T	C	8	11	19	0	2	21	0	0
13	22372075	.	T	C	22	15	37	0	0	37	0	0
13	22372154	.	T	C	21	18	39	0	1	40	0	0
13	22372175	.	A	G	19	18	37	0	1	38	0	0
13	22372205	.	A	G	19	23	42	0	1	43	0	0
13	22372737	.	C	T	7	7	14	0	1	15	0	0
13	22373241	.	G	A	1	17	18	0	12	30	0	0
13	22373336	.	C	A	12	8	20	0	2	22	0	0
13	22373753	.	G	A	10	4	14	1	0	15	0	0
13	22373931	.	C	T	4	5	9	0	0	9	0	0
13	22373940	.	A	G	3	6	9	0	1	10	0	0
13	22555865	.	C	A	5	5	10	0	0	10	0	0
13	22592991	.	G	T	1	3	4	0	0	4	0	0
13	22618320	.	A	G	3	0	3	0	2	5	0	0
13	22618393	.	T	A	5	2	7	0	0	7	0	0
13	22618452	.	T	A	1	1	2	0	0	2	0	0
13	22620302	.	C	G	4	4	8	0	1	9	0	0
13	22621127	.	A	T	1	2	3	0	0	3	0	0
13	22621940	.	C	T	1	3	4	0	0	4	0	0
13	22659195	.	C	G	8	0	8	0	28	36	0	0
13	22672354	.	A	T	25	24	49	1	1	51	0	0
13	22672791	.	C	G	9	11	20	0	0	20	0	0
13	22672952	.	G	A	7	7	14	0	0	14	0	0
13	22673006	.	A	C	7	6	13	0	0	13	0	0
13	22673068	.	A	T	3	8	11	0	2	14	1	0
13	22679306	.	G	A	1	2	3	0	0	3	0	0
13	22679537	.	C	G	2	3	5	0	0	5	0	0
13	22679837	.	G	A	3	3	6	0	0	6	0	0
13	22683416	.	A	T	4	4	8	0	0	8	0	0
13	22694363	.	C	T	3	2	5	0	0	5	0	0
13	22719813	.	G	T	3	2	5	0	1	6	0	0
13	22719820	.	T	A	4	2	6	0	0	6	0	0
13	22724123	.	T	A	2	2	4	0	0	4	0	0
13	22725613	.	C	T	3	4	7	0	0	7	0	0
13	22728705	.	G	T	2	2	4	0	1	5	0	0
13	22735063	.	T	C	6	6	12	0	0	12	0	0
13	22735139	.	A	G	7	5	12	0	2	14	0	0
13	22742791	.	G	A	10	15	25	0	0	25	0	0
13	22744359	.	A	G	7	10	17	0	0	17	0	0
13	22867888	.	G	A	0	8	8	0	10	18	0	0
13	22867910	.	A	G	9	10	19	0	0	19	0	0
13	22867953	.	G	T	13	9	22	0	0	22	0	0
13	22868017	.	G	A	11	3	14	0	0	14	0	0
13	22871900	.	C	A	3	3	6	0	2	8	0	0
13	22871989	.	A	G	4	4	8	0	0	8	0	0
13	22872433	.	A	G	1	2	3	0	0	3	0	0
13	22872519	.	T	A	1	2	3	0	0	3	0	0
13	22872538	.	C	T	2	3	5	0	0	5	0	0
13	22876576	.	T	C	5	0	5	0	8	13	0	0
13	22876623	.	G	A	8	9	17	0	0	17	0	0
13	22876678	.	A	T	4	5	9	0	0	9	0	0
13	22877076	.	C	T	16	11	27	0	2	29	0	0
13	22877130	.	G	T	15	16	31	0	0	31	0	0
13	22878754	.	G	A	19	20	39	0	2	41	0	0
13	22879149	.	A	T	14	13	27	0	0	27	0	0
13	22890835	.	A	C	24	0	24	0	18	42	0	0
13	22898042	.	A	G	20	18	38	0	0	38	0	0
13	22900733	.	G	A	15	20	35	0	0	35	0	0
13	22900742	.	A	T	16	19	35	0	1	36	0	0
13	22902882	.	A	C	7	9	16	0	0	16	0	0
13	22902987	.	G	A	20	11	31	0	0	31	0	0
13	22965005	.	T	G	2	3	5	0	0	5	0	0
13	22965018	.	A	T	1	3	4	0	0	4	0	0
13	22965064	.	T	A	1	2	3	0	0	3	0	0
13	22970816	.	T	G	1	2	3	0	0	3	0	0
13	22973314	.	A	G	30	24	54	0	4	58	0	0
13	22973348	.	A	G	31	20	51	0	3	54	0	0
13	22973531	.	T	C	23	0	23	0	24	47	0	0
13	22973895	.	A	G	27	14	41	0	2	43	0	0
13	22974033	.	A	G	26	21	47	0	0	47	0	0
13	22974108	.	C	T	29	24	53	0	1	54	0	0
13	22976067	.	C	A	17	23	40	0	1	41	0	0
13	22976070	.	G	A	18	20	38	0	0	38	0	0
13	22976383	.	T	C	17	0	17	0	18	35	0	0
13	22977283	.	G	A	33	21	54	0	2	56	0	0
13	22977319	.	A	G	28	22	50	0	0	50	0	0
13	22977343	.	A	G	26	20	46	0	1	47	0	0
13	22978059	.	T	C	22	1	23	0	19	42	0	0
13	22978062	.	G	A	23	18	41	0	1	42	0	0
13	22983106	.	A	G	21	9	30	0	2	32	0	0
13	22983109	.	A	G	24	10	34	0	0	34	0	0
13	23002697	.	G	A	10	12	22	0	0	22	0	0
13	23007677	.	A	G	11	9	20	0	1	21	0	0
13	23007811	.	T	C	2	2	4	0	0	4	0	0
13	23042321	.	A	G	2	3	5	0	0	5	0	0
13	23042676	.	A	G	8	8	16	0	0	16	0	0
13	23042745	.	G	A	6	13	19	0	1	20	0	0
13	23042929	.	G	T	6	2	8	0	2	10	0	0
13	23043112	.	T	C	5	2	7	0	0	7	0	0
13	23043117	.	A	G	5	2	7	0	1	8	0	0
13	23045229	.	G	A	4	3	7	0	0	7	0	0
13	23058975	.	G	A	2	3	5	0	5	10	0	0
13	23064735	.	T	C	11	4	15	0	0	15	0	0
13	23070895	.	T	C	10	6	16	0	2	18	0	0
13	23070994	.	A	G	5	2	7	0	0	7	0	0
13	23084177	.	C	G	18	19	37	0	0	37	0	0
13	23084841	.	G	C	7	20	27	0	1	28	0	0
13	23090190	.	A	C	18	18	36	0	3	39	0	0
13	23094356	.	T	C	12	0	12	0	22	34	0	0
13	23094895	.	G	T	20	19	39	0	0	39	0	0
13	23128675	.	A	G	3	0	3	0	3	6	0	0
13	23128685	.	A	G	3	3	6	0	1	7	0	0
13	23169247	.	C	A	4	2	6	0	0	6	0	0
13	23169809	.	C	T	6	5	11	0	0	11	0	0
13	23170025	.	C	G	3	3	6	0	0	6	0	0
13	23196207	.	C	T	9	10	19	0	3	22	0	0
13	23201307	.	T	A	9	8	17	0	0	17	0	0
13	23204849	.	A	C	11	8	19	0	0	19	0	0
13	23211195	.	A	T	7	6	13	0	1	14	0	0
13	23212821	.	A	G	9	8	17	0	0	17	0	0
13	23222899	.	A	T	6	7	13	0	0	13	0	0
13	23223122	.	A	G	6	6	12	0	1	13	0	0
13	23223422	.	G	A	11	6	17	0	1	18	0	0
13	23223428	.	C	T	11	4	15	0	2	18	1	0
13	23223469	.	T	A	5	4	9	0	0	9	0	0
13	23223486	.	C	T	2	4	6	0	1	7	0	0
13	23223567	.	C	T	4	7	11	0	0	11	0	0
13	23223572	.	C	T	3	8	11	0	0	11	0	0
13	23223675	.	C	A	2	5	7	0	0	7	0	0
13	23223875	.	C	A	7	7	14	0	0	14	0	0
13	23224087	.	G	A	12	6	18	0	0	18	0	0
13	23224113	.	A	T	7	6	13	0	0	13	0	0
13	23224360	.	A	G	4	8	12	0	0	12	0	0
13	23224363	.	T	G	4	8	12	0	0	12	0	0
13	23224427	.	C	T	5	3	8	0	0	8	0	0
13	23224470	.	G	A	7	4	11	0	0	11	0	0
13	23224605	.	G	T	13	10	23	0	1	24	0	0
13	23224727	.	C	T	10	8	18	0	0	18	0	0
13	23224735	.	A	G	8	8	16	0	0	16	0	0
13	23224821	.	T	A	12	12	24	0	2	26	0	0
13	23224860	.	T	A	17	8	25	0	0	25	0	0
13	23225541	.	T	C	12	7	19	0	0	19	0	0
13	23225776	.	T	A	10	14	24	0	0	24	0	0
13	23226114	.	G	A	0	4	4	0	16	20	0	0
13	23226213	.	A	C	4	6	10	0	0	10	0	0
13	23234869	.	A	G	2	2	4	0	0	4	0	0
13	23314904	.	T	G	16	7	23	0	0	23	0	0
13	23382393	.	G	A	14	16	30	0	0	30	0	0
13	23382572	.	T	C	13	22	35	0	0	35	0	0
13	23387252	.	T	C	3	9	12	0	2	14	0	0
13	23499434	.	G	T	1	2	3	0	0	3	0	0
13	23669773	.	C	T	16	8	24	0	2	26	0	0
13	23669870	.	T	G	10	6	16	0	2	19	1	0
13	23669916	.	C	A	12	8	20	0	0	20	0	0
13	23675183	.	C	T	12	16	28	0	0	28	0	0
13	23675510	.	T	C	11	7	18	0	1	19	0	0
13	23675892	.	G	C	1	8	9	0	10	19	0	0
13	23676856	.	G	A	1	15	16	0	14	30	0	0
13	23676913	.	C	A	11	10	21	0	1	22	0	0
13	23678001	.	G	A	2	10	12	0	12	24	0	0
13	23679546	.	G	A	1	10	11	0	15	26	0	0
13	23679888	.	G	A	4	11	15	0	0	15	0	0
13	23685075	.	G	A	3	4	7	0	0	7	0	0
13	23685301	.	G	A	13	10	23	0	0	23	0	0
13	23685361	.	T	G	12	0	12	0	10	22	0	0
13	23692515	.	C	T	16	11	27	0	1	28	0	0
13	23692572	.	C	T	18	16	34	0	2	36	0	0
13	23703048	.	G	C	16	10	26	0	1	27	0	0
13	23703053	.	T	C	15	11	26	0	1	27	0	0
13	23709532	.	C	T	12	18	30	0	0	30	0	0
13	23709562	.	T	C	11	21	32	0	1	33	0	0
13	23709592	.	A	G	15	20	35	0	1	36	0	0
13	23711937	.	G	A	21	17	38	1	5	44	0	0
13	23728490	.	T	A	6	4	10	0	0	10	0	0
13	23730801	.	G	A	11	6	17	0	1	18	0	0
13	23731944	.	C	A	4	3	7	0	1	8	0	0
13	23731988	.	T	A	2	8	10	0	0	10	0	0
13	23843742	.	C	T	5	2	7	0	0	7	0	0
13	23876610	.	A	G	7	0	7	0	5	12	0	0
13	23876697	.	T	C	8	7	15	0	0	15	0	0
13	23876784	.	C	T	8	10	18	0	0	18	0	0
13	23876865	.	C	T	10	4	14	0	1	15	0	0
13	23882377	.	A	G	4	8	12	0	0	12	0	0
13	23882615	.	T	C	8	5	13	0	0	13	0	0
13	23882629	.	T	C	8	4	12	0	0	12	0	0
13	23882686	.	C	T	5	4	9	0	0	9	0	0
13	23898045	.	T	G	13	28	41	0	0	41	0	0
13	23901334	.	C	T	14	9	23	0	0	23	0	0
13	23901349	.	T	C	14	8	22	0	1	23	0	0
13	23901502	.	A	G	8	9	17	0	0	17	0	0
13	23901555	.	A	G	7	0	7	0	9	16	0	0
13	23901570	.	T	C	7	4	11	0	1	12	0	0
13	23920791	.	A	G	15	10	25	0	1	26	0	0
13	23931192	.	T	C	7	0	7	0	13	20	0	0
13	23932450	.	G	A	2	4	6	0	0	6	0	0
13	23940708	.	T	C	12	0	12	0	10	22	0	0
13	23940754	.	C	A	12	7	19	0	0	19	0	0
13	23943040	.	T	G	10	3	13	0	0	13	0	0
13	23990189	.	C	A	2	6	8	0	0	8	0	0
13	23999129	.	G	A	11	8	19	0	0	19	0	0
13	23999264	.	G	C	5	4	9	0	1	10	0	0
13	23999274	.	T	A	7	5	12	0	0	12	0	0
13	24002850	.	T	C	3	3	6	0	0	6	0	0
13	24010630	.	C	T	3	3	6	0	0	6	0	0
13	24010663	.	A	G	2	3	5	0	0	5	0	0
13	24014578	.	T	C	7	4	11	0	0	11	0	0
13	24023036	.	G	T	8	7	15	0	0	15	0	0
13	24033958	.	G	T	1	11	12	0	5	17	0	0
13	24034092	.	T	G	5	7	12	0	0	12	0	0
13	24034158	.	A	G	5	11	16	0	0	16	0	0
13	24034206	.	A	G	6	8	14	0	0	14	0	0
13	24034215	.	G	A	5	7	12	0	2	14	0	0
13	24045342	.	C	T	7	6	13	0	1	14	0	0
13	24046953	.	G	A	0	7	7	0	8	15	0	0
13	24056221	.	C	T	8	14	22	0	1	23	0	0
13	24068790	.	C	T	0	16	16	0	6	22	0	0
13	24069624	.	C	A	11	8	19	0	1	20	0	0
13	24069902	.	A	T	9	13	22	0	1	23	0	0
13	24070730	.	C	T	9	8	17	0	3	20	0	0
13	24096437	.	G	T	9	10	19	0	1	20	0	0
13	24233035	.	T	G	1	2	3	0	0	3	0	0
13	24234815	.	C	A	2	4	6	0	0	6	0	0
13	24262773	.	T	A	3	2	5	0	1	6	0	0
13	24266756	.	G	C	2	3	5	0	1	6	0	0
13	24276128	.	T	A	4	1	5	0	1	6	0	0
13	24276551	.	G	A	0	2	2	0	1	3	0	0
13	24292398	.	G	A	3	4	7	0	0	7	0	0
13	24292419	.	G	A	5	2	7	0	0	7	0	0
13	24292796	.	T	A	9	12	21	0	0	21	0	0
13	24292800	.	A	T	11	11	22	0	1	23	0	0
13	24292866	.	C	A	3	12	15	0	14	29	0	0
13	24293162	.	C	A	16	13	29	0	1	30	0	0
13	24293218	.	T	A	21	17	38	0	0	38	0	0
13	24293220	.	G	C	21	17	38	0	0	38	0	0
13	24293448	.	A	G	15	24	39	0	1	40	0	0
13	24293465	.	C	T	3	22	25	0	13	38	0	0
13	24293615	.	G	A	14	19	33	0	4	37	0	0
13	24293691	.	G	A	12	18	30	0	0	30	0	0
13	24293698	.	C	T	19	9	28	0	0	28	0	0
13	24293940	.	G	A	11	10	21	0	2	23	0	0
13	24294046	.	A	G	11	11	22	0	1	23	0	0
13	24296013	.	C	T	10	4	14	0	1	15	0	0
13	24296215	.	C	T	0	5	5	0	1	6	0	0
13	24296430	.	C	A	4	3	7	0	0	7	0	0
13	24303667	.	C	A	11	14	25	0	2	27	0	0
13	24305975	.	T	G	18	13	31	0	0	31	0	0
13	24309321	.	A	T	11	14	25	0	2	27	0	0
13	24372095	.	G	T	4	3	7	0	0	7	0	0
13	24372197	.	C	T	5	5	10	0	0	10	0	0
13	24372629	.	T	C	1	4	5	0	0	5	0	0
13	24372943	.	C	T	4	7	11	0	0	11	0	0
13	24373003	.	G	A	8	4	12	0	1	13	0	0
13	24373081	.	A	G	6	5	11	0	1	12	0	0
13	24378740	.	C	T	6	7	13	0	0	13	0	0
13	24378833	.	C	A	0	4	4	0	4	8	0	0
13	24378834	.	G	T	3	5	8	0	0	8	0	0
13	24378897	.	A	C	4	3	7	0	0	7	0	0
13	24378978	.	A	T	3	3	6	0	0	6	0	0
13	24379015	.	A	G	6	3	9	0	0	9	0	0
13	24381336	.	A	T	4	3	7	0	0	7	0	0
13	24381451	.	A	G	2	2	4	0	0	4	0	0
13	24382510	.	C	A	2	4	6	0	1	7	0	0
13	24382539	.	T	C	4	2	6	0	0	6	0	0
13	24382578	.	G	A	4	3	7	0	0	7	0	0
13	24383589	.	T	G	1	4	5	0	0	5	0	0
13	24384282	.	G	C	5	4	9	0	1	10	0	0
13	24384425	.	A	T	6	6	12	0	0	12	0	0
13	24384807	.	G	A	3	6	9	0	0	9	0	0
13	24387484	.	G	T	9	12	21	0	0	21	0	0
13	24395371	.	A	G	5	5	10	0	2	12	0	0
13	24395373	.	G	A	7	6	13	0	0	13	0	0
13	24402490	.	G	A	0	13	13	0	15	28	0	0
13	24402560	.	T	C	8	15	23	0	0	23	0	0
13	24411553	.	T	C	19	8	27	0	1	28	0	0
13	24423602	.	C	T	0	3	3	0	3	6	0	0
13	24424014	.	C	T	9	6	15	0	0	15	0	0
13	24424260	.	A	T	2	2	4	0	1	5	0	0
13	24424290	.	G	A	4	3	7	0	0	7	0	0
13	24424724	.	T	C	4	3	7	0	3	10	0	0
13	24424875	.	C	A	4	4	8	0	0	8	0	0
13	24425019	.	G	A	2	4	6	0	0	6	0	0
13	24425112	.	T	C	2	0	2	0	4	6	0	0
13	24425133	.	G	A	1	4	5	0	0	5	0	0
13	24425812	.	C	T	1	3	4	0	0	4	0	0
13	24425833	.	C	T	2	2	4	0	1	5	0	0
13	24429008	.	G	A	2	2	4	0	0	4	0	0
13	24431365	.	T	G	2	10	12	0	0	12	0	0
13	24431784	.	T	G	14	24	38	0	2	40	0	0
13	24432162	.	G	C	13	12	25	0	2	27	0	0
13	24432212	.	T	C	16	1	17	0	9	26	0	0
13	24432350	.	C	T	3	16	19	0	18	37	0	0
13	24436054	.	G	A	18	14	32	0	1	33	0	0
13	24437225	.	G	A	10	13	23	0	1	24	0	0
13	24447364	.	G	C	14	12	26	0	0	26	0	0
13	24519762	.	T	C	3	4	7	0	0	7	0	0
13	24519911	.	G	A	3	6	9	0	2	11	0	0
13	24519921	.	G	T	1	7	8	0	3	11	0	0
13	24520311	.	C	T	2	2	4	0	0	4	0	0
13	24521173	.	C	A	3	3	6	0	0	6	0	0
13	24521927	.	G	A	8	2	10	0	0	10	0	0
13	24522570	.	G	T	3	7	10	0	0	10	0	0
13	24523321	.	G	A	6	6	12	0	0	12	0	0
13	24523425	.	A	G	7	4	11	0	0	11	0	0
13	24524206	.	G	A	2	5	7	1	0	8	0	0
13	24579187	.	A	T	13	25	38	0	1	39	0	0
13	24580372	.	G	A	15	20	35	1	3	39	0	0
13	24580411	.	G	A	18	20	38	1	3	42	0	0
13	24580441	.	A	G	19	1	20	0	19	39	0	0
13	24580705	.	C	T	12	17	29	0	3	32	0	0
13	24580869	.	T	C	14	17	31	0	3	34	0	0
13	24580941	.	T	C	17	16	33	0	3	36	0	0
13	24581274	.	G	A	22	17	39	0	0	39	0	0
13	24581316	.	C	A	18	23	41	0	0	41	0	0
13	24581334	.	G	C	20	17	37	0	3	40	0	0
13	24581358	.	T	C	21	17	38	0	0	38	0	0
13	24581748	.	A	C	18	7	25	0	1	26	0	0
13	24581798	.	T	A	9	12	21	0	0	21	0	0
13	24581840	.	T	G	14	13	27	0	0	27	0	0
13	24581854	.	C	T	17	14	31	0	0	31	0	0
13	24581982	.	G	A	1	13	14	0	14	28	0	0
13	24582047	.	A	G	13	12	25	0	0	25	0	0
13	24582110	.	C	T	8	11	19	0	0	19	0	0
13	24582122	.	T	C	4	9	13	0	0	13	0	0
13	24582211	.	C	T	2	4	6	0	0	6	0	0
13	24662313	.	G	C	4	3	7	0	0	7	0	0
13	24662329	.	G	A	1	5	6	0	2	8	0	0
13	24663222	.	G	C	0	4	4	0	4	8	0	0
13	24663414	.	C	A	2	4	6	0	0	6	0	0
13	24663456	.	A	G	1	3	4	0	0	4	0	0
13	24663498	.	C	T	4	3	7	0	0	7	0	0
13	24663504	.	C	A	3	4	7	0	0	7	0	0
13	24663901	.	A	G	1	4	5	0	0	5	0	0
13	24664144	.	T	A	2	2	4	0	0	4	0	0
13	24665869	.	C	T	3	3	6	0	0	6	0	0
13	24702092	.	C	T	11	5	16	0	1	17	0	0
13	24702114	.	T	C	8	7	15	0	0	15	0	0
13	24702275	.	C	T	1	5	6	0	0	6	0	0
13	24702383	.	G	A	10	9	19	0	1	20	0	0
13	24702415	.	T	C	8	9	17	0	0	17	0	0
13	24702743	.	C	T	6	5	11	0	0	11	0	0
13	24702822	.	A	C	9	9	18	0	0	18	0	0
13	24702883	.	A	T	16	10	26	0	1	27	0	0
13	24702974	.	T	C	11	8	19	0	1	20	0	0
13	24702996	.	G	A	8	12	20	0	0	20	0	0
13	24703319	.	C	T	3	4	7	0	0	7	0	0
13	24703325	.	A	T	3	4	7	0	0	7	0	0
13	24703354	.	C	A	5	2	7	0	0	7	0	0
13	24703362	.	C	A	2	2	4	0	1	5	0	0
13	24703473	.	G	T	6	3	9	0	1	10	0	0
13	24703490	.	G	A	3	2	5	0	3	8	0	0
13	24704032	.	A	G	6	3	9	0	0	9	0	0
13	24704102	.	C	A	3	12	15	0	0	15	0	0
13	24704191	.	A	T	8	7	15	0	1	16	0	0
13	24714914	.	A	T	4	12	16	0	0	16	0	0
13	24716363	.	T	C	4	6	10	0	0	10	0	0
13	24716375	.	A	T	6	9	15	0	0	15	0	0
13	24740703	.	C	A	2	2	4	0	0	4	0	0
13	24742835	.	G	A	2	3	5	0	0	5	0	0
13	24742836	.	T	A	2	3	5	0	0	5	0	0
13	24745169	.	A	G	3	2	5	0	0	5	0	0
13	24745188	.	A	C	2	2	4	0	0	4	0	0
13	24781605	.	T	C	9	14	23	0	2	25	0	0
13	24785591	.	C	A	19	9	28	0	1	29	0	0
13	24804224	.	G	C	4	7	11	0	0	11	0	0
13	24804321	.	T	C	8	8	16	0	0	16	0	0
13	24804386	.	T	C	7	4	11	3	1	15	0	0
13	24804387	.	C	T	1	4	5	3	7	15	0	0
13	24804765	.	C	T	8	8	16	0	1	17	0	0
13	24804804	.	A	G	6	6	12	0	0	12	0	0
13	24805068	.	A	C	7	3	10	0	0	10	0	0
13	24805148	.	A	C	6	3	9	0	0	9	0	0
13	24806423	.	T	C	7	0	7	0	6	13	0	0
13	24810459	.	G	A	5	3	8	0	0	8	0	0
13	24825902	.	G	T	2	5	7	0	0	7	0	0
13	24826248	.	C	A	0	2	2	0	4	6	0	0
13	24826349	.	G	A	3	5	8	0	0	8	0	0
13	24826382	.	G	A	5	7	12	0	0	12	0	0
13	24826389	.	T	C	7	0	7	0	7	14	0	0
13	24834358	.	A	G	23	11	34	0	2	36	0	0
13	24837246	.	T	C	7	5	12	0	0	12	0	0
13	24837253	.	T	A	8	5	13	0	0	13	0	0
13	24837392	.	A	G	18	9	27	0	1	28	0	0
13	24837407	.	T	A	14	10	24	0	1	25	0	0
13	24871485	.	C	T	13	14	27	0	3	30	0	0
13	24872733	.	G	A	6	11	17	0	0	17	0	0
13	24873141	.	C	A	2	11	13	0	14	27	0	0
13	24873186	.	A	T	6	10	16	0	2	18	0	0
13	24873267	.	G	A	13	13	26	0	0	26	0	0
13	24873480	.	A	G	12	16	28	0	1	29	0	0
13	24873579	.	C	T	8	12	20	0	1	21	0	0
13	24873597	.	G	T	10	13	23	0	0	23	0	0
13	24873990	.	A	G	15	15	30	0	1	31	0	0
13	24873995	.	T	G	14	14	28	0	0	28	0	0
13	24874837	.	A	G	10	10	20	0	0	20	0	0
13	24874894	.	T	A	13	11	24	0	0	24	0	0
13	24874934	.	A	G	13	10	23	0	0	23	0	0
13	24877934	.	C	A	7	7	14	0	3	17	0	0
13	24905815	.	G	A	6	9	15	0	0	15	0	0
13	24906196	.	A	T	7	5	12	0	0	12	0	0
13	24919010	.	C	A	6	2	8	0	0	8	0	0
13	24919317	.	C	T	7	4	11	0	0	11	0	0
13	24919969	.	A	T	5	3	8	1	0	9	0	0
13	24920098	.	C	T	15	9	24	0	1	25	0	0
13	24986203	.	G	A	11	11	22	0	1	23	0	0
13	24986238	.	G	T	15	7	22	0	2	24	0	0
13	25204643	.	C	T	3	2	5	0	0	5	0	0
13	25204905	.	T	C	3	2	5	0	0	5	0	0
13	25207064	.	G	C	2	4	6	0	0	6	0	0
13	25207068	.	C	T	2	5	7	0	0	7	0	0
13	25207368	.	A	G	4	4	8	0	0	8	0	0
13	25208276	.	A	G	1	3	4	0	0	4	0	0
13	25208484	.	T	G	2	3	5	0	0	5	0	0
13	25208501	.	G	T	2	2	4	0	0	4	0	0
13	25208545	.	T	A	2	2	4	0	0	4	0	0
13	25208675	.	T	C	1	2	3	0	0	3	0	0
13	25221190	.	G	C	2	3	5	0	0	5	0	0
13	25229573	.	G	A	4	2	6	0	0	6	0	0
13	25229576	.	C	T	4	2	6	0	1	7	0	0
13	25242602	.	C	T	3	4	7	0	0	7	0	0
13	25242626	.	C	A	0	5	5	0	4	9	0	0
13	25251849	.	G	A	1	3	4	0	0	4	0	0
13	25284281	.	G	C	2	3	5	0	1	6	0	0
13	25284312	.	A	C	3	0	3	0	5	8	0	0
13	25364846	.	T	A	5	7	12	0	0	12	0	0
13	25364915	.	A	T	4	8	12	0	3	15	0	0
13	25366749	.	T	A	6	9	15	0	0	15	0	0
13	25369165	.	C	T	14	10	24	0	0	24	0	0
13	25369449	.	C	T	9	6	15	0	0	15	0	0
13	25371436	.	A	G	5	16	21	0	2	23	0	0
13	25372806	.	G	A	15	19	34	0	1	35	0	0
13	25378590	.	G	A	0	14	14	0	15	29	0	0
13	25378924	.	T	G	6	8	14	1	1	16	0	0
13	25379263	.	A	T	18	10	28	0	2	30	0	0
13	25379304	.	A	G	10	0	10	0	18	28	0	0
13	25379352	.	A	C	11	7	18	0	0	18	0	0
13	25379459	.	C	T	1	6	7	0	0	7	0	0
13	25383915	.	C	T	5	15	20	0	1	21	0	0
13	25384145	.	A	G	8	8	16	0	4	20	0	0
13	25384223	.	A	G	14	5	19	0	2	21	0	0
13	25386904	.	C	T	7	12	19	0	1	20	0	0
13	25388389	.	G	A	8	8	16	0	1	17	0	0
13	25388644	.	T	C	6	4	10	0	0	10	0	0
13	25388658	.	T	A	8	5	13	0	0	13	0	0
13	25388708	.	G	T	6	6	12	0	0	12	0	0
13	25403606	.	G	A	4	2	6	0	0	6	0	0
13	25428952	.	C	G	10	13	23	0	1	24	0	0
13	25429048	.	T	A	8	9	17	0	0	17	0	0
13	25429079	.	C	T	9	7	16	0	0	16	0	0
13	25429145	.	G	A	8	5	13	0	1	14	0	0
13	25436336	.	A	T	9	9	18	0	0	18	0	0
13	25436360	.	A	T	10	3	13	0	1	14	0	0
13	25449688	.	A	C	2	3	5	0	0	5	0	0
13	25449867	.	C	A	1	5	6	0	0	6	0	0
13	25472735	.	G	A	15	11	26	0	2	28	0	0
13	25472756	.	T	C	12	13	25	0	2	27	0	0
13	25472859	.	G	A	14	21	35	0	1	36	0	0
13	25473039	.	C	T	26	14	40	0	2	42	0	0
13	25473325	.	G	A	22	18	40	0	1	41	0	0
13	25475889	.	C	T	23	14	37	0	0	37	0	0
13	25475904	.	A	G	20	15	35	0	2	37	0	0
13	25477249	.	G	A	12	15	27	0	0	27	0	0
13	25478749	.	A	T	1	3	4	1	1	6	0	0
13	25484638	.	G	T	18	17	35	0	0	35	0	0
13	25492923	.	A	T	9	13	22	0	0	22	0	0
13	25492992	.	C	G	8	8	16	0	3	19	0	0
13	25497320	.	A	G	16	0	16	0	12	28	0	0
13	25497575	.	T	C	13	11	24	0	1	25	0	0
13	25497581	.	C	T	12	10	22	0	1	23	0	0
13	25497700	.	G	C	14	13	27	0	0	27	0	0
13	25497880	.	T	C	5	8	13	0	2	15	0	0
13	25516135	.	A	G	5	2	7	1	4	12	0	0
13	25516204	.	T	C	7	9	16	0	2	18	0	0
13	25519063	.	G	A	1	6	7	0	10	17	0	0
13	25523608	.	C	T	13	7	20	0	1	21	0	0
13	25523629	.	T	C	11	11	22	0	1	23	0	0
13	25523677	.	G	A	1	14	15	0	13	28	0	0
13	25530063	.	C	T	8	8	16	0	1	17	0	0
13	25532352	.	C	T	22	9	31	0	1	32	0	0
13	25532509	.	T	A	18	12	30	0	0	30	0	0
13	25532574	.	C	A	17	14	31	0	3	34	0	0
13	25532706	.	T	C	5	8	13	0	0	13	0	0
13	25533175	.	T	C	13	18	31	0	1	32	0	0
13	25533233	.	G	A	15	15	30	0	1	31	0	0
13	25533258	.	T	A	17	13	30	0	0	30	0	0
13	25533657	.	C	G	17	0	17	0	10	27	0	0
13	25534165	.	T	C	8	12	20	0	0	20	0	0
13	25534407	.	C	T	13	9	22	0	0	22	0	0
13	25540157	.	C	T	4	3	7	0	0	7	0	0
13	25549516	.	A	G	4	0	4	0	11	15	0	0
13	25551781	.	C	A	10	8	18	0	0	18	0	0
13	25551865	.	T	C	13	12	25	0	1	26	0	0
13	25552219	.	T	C	8	7	15	0	2	17	0	0
13	25559610	.	G	A	8	10	18	0	1	19	0	0
13	25560416	.	C	T	6	4	10	0	0	10	0	0
13	25563221	.	C	A	3	4	7	0	1	8	0	0
13	25565379	.	T	C	8	12	20	0	1	21	0	0
13	25566057	.	G	A	0	2	2	0	4	6	0	0
13	25566205	.	A	T	5	4	9	0	0	9	0	0
13	25566222	.	C	T	6	3	9	0	0	9	0	0
13	25569865	.	A	G	6	9	15	0	0	15	0	0
13	25569874	.	A	G	7	11	18	0	0	18	0	0
13	25569940	.	A	C	9	5	14	0	0	14	0	0
13	25570008	.	T	C	3	2	5	0	0	5	0	0
13	25570104	.	C	T	5	8	13	0	0	13	0	0
13	25570108	.	T	A	4	8	12	0	1	13	0	0
13	25570427	.	T	A	10	12	22	0	0	23	1	0
13	25570561	.	A	C	7	10	17	0	0	17	0	0
13	25570715	.	C	T	11	3	14	0	0	14	0	0
13	25571113	.	A	T	1	5	6	0	0	6	0	0
13	25571274	.	C	T	16	8	24	0	0	24	0	0
13	25573189	.	G	A	4	6	10	0	0	10	0	0
13	25573386	.	T	C	6	2	8	0	0	8	0	0
13	25573397	.	C	T	6	3	9	0	0	9	0	0
13	25575396	.	C	T	11	11	22	0	1	23	0	0
13	25575411	.	A	C	11	13	24	0	0	24	0	0
13	25575453	.	G	A	14	8	22	0	0	22	0	0
13	25581121	.	T	C	7	5	12	0	0	12	0	0
13	25586448	.	G	A	8	5	13	0	0	13	0	0
13	25589241	.	G	A	12	9	21	0	1	22	0	0
13	25590777	.	G	A	2	6	8	0	0	8	0	0
13	25591065	.	A	G	1	2	3	0	0	3	0	0
13	25592669	.	A	G	2	2	4	0	0	4	0	0
13	25593832	.	T	C	4	3	7	0	0	7	0	0
13	25594377	.	T	C	3	2	5	0	0	5	0	0
13	25724747	.	G	A	4	11	15	0	0	15	0	0
13	25726378	.	C	G	3	3	6	0	0	6	0	0
13	25728453	.	A	C	7	3	10	0	0	10	0	0
13	25728606	.	A	T	6	4	10	0	0	10	0	0
13	25728738	.	A	C	3	2	5	0	1	6	0	0
13	25728747	.	A	G	3	5	8	0	0	8	0	0
13	25728836	.	T	C	3	6	9	0	0	9	0	0
13	25729440	.	G	A	5	6	11	0	0	11	0	0
13	25730774	.	C	T	3	2	5	0	0	5	0	0
13	25733340	.	C	T	2	4	6	0	0	6	0	0
13	25735671	.	G	A	3	6	9	0	0	9	0	0
13	25763187	.	A	T	1	2	3	0	0	3	0	0
13	25824616	.	T	A	8	9	17	0	0	17	0	0
13	25824718	.	C	T	7	15	22	0	3	25	0	0
13	25825016	.	G	A	11	20	31	0	0	31	0	0
13	25825263	.	A	T	6	3	9	0	0	9	0	0
13	25826362	.	T	C	20	0	20	0	10	30	0	0
13	25827129	.	T	G	15	14	29	0	1	30	0	0
13	25827421	.	G	A	13	14	27	0	4	31	0	0
13	25846994	.	C	A	5	6	11	0	1	12	0	0
13	25847136	.	T	A	9	4	13	0	1	14	0	0
13	25847144	.	G	T	10	3	13	0	0	13	0	0
13	25847176	.	G	A	6	2	8	0	2	10	0	0
13	25847226	.	T	G	4	4	8	0	1	9	0	0
13	25847297	.	T	A	8	2	10	0	0	10	0	0
13	25849234	.	T	G	5	5	10	0	0	10	0	0
13	25849294	.	T	G	2	2	4	0	1	5	0	0
13	25850874	.	G	A	2	7	9	0	0	9	0	0
13	25851321	.	G	A	1	4	5	0	0	5	0	0
13	25851332	.	T	A	1	4	5	0	0	5	0	0
13	25851883	.	G	A	2	2	4	0	0	4	0	0
13	25852558	.	T	A	4	2	6	0	0	6	0	0
13	26692974	.	T	C	1	1	2	0	1	3	0	0
13	26699790	.	G	A	1	2	3	0	0	3	0	0
13	26787190	.	C	T	4	2	6	0	0	6	0	0
13	26796325	.	A	T	1	4	5	0	2	7	0	0
13	27000394	.	C	T	3	7	10	0	6	16	0	0
13	27035860	.	A	G	0	2	2	0	1	3	0	0
13	27036582	.	T	C	15	0	15	0	7	22	0	0
13	27036660	.	T	C	3	10	13	0	1	14	0	0
13	27036766	.	G	A	7	9	16	0	1	17	0	0
13	27036847	.	C	T	5	9	14	0	0	14	0	0
13	27036898	.	T	C	15	10	25	0	3	28	0	0
13	27037942	.	A	G	15	8	23	0	0	23	0	0
13	27107520	.	C	T	15	12	27	2	1	30	0	0
13	27189877	.	A	T	17	15	32	0	0	32	0	0
13	27189898	.	C	T	14	15	29	0	0	29	0	0
13	27201525	.	A	G	12	1	13	0	11	24	0	0
13	27201552	.	G	A	7	10	17	0	0	17	0	0
13	27201606	.	T	C	5	11	16	0	1	17	0	0
13	27204440	.	T	A	17	21	38	0	0	38	0	0
13	27207707	.	G	T	11	13	24	0	1	25	0	0
13	27209754	.	T	C	15	9	24	0	2	26	0	0
13	27209852	.	T	C	16	13	29	0	0	29	0	0
13	27227407	.	C	A	6	5	11	0	2	13	0	0
13	27227449	.	A	G	11	6	17	0	0	17	0	0
13	27277579	.	C	T	2	4	6	0	0	6	0	0
13	27277695	.	A	C	3	4	7	0	0	7	0	0
13	27277711	.	C	A	2	4	6	0	0	6	0	0
13	27278224	.	G	A	0	3	3	0	1	4	0	0
13	27293764	.	A	G	2	2	4	0	0	4	0	0
13	27295280	.	T	C	1	5	6	0	1	7	0	0
13	27295910	.	G	T	2	3	5	0	0	5	0	0
13	27295926	.	C	G	3	3	6	0	0	6	0	0
13	27296415	.	T	A	3	3	6	0	1	7	0	0
13	27309080	.	C	T	5	12	17	0	0	17	0	0
13	27309128	.	T	G	4	0	4	0	10	14	0	0
13	27309143	.	C	T	8	7	15	0	1	16	0	0
13	27313025	.	T	A	4	2	6	0	0	6	0	0
13	27313044	.	A	C	2	5	7	0	0	7	0	0
13	27313066	.	G	T	7	6	13	0	0	13	0	0
13	27313236	.	A	G	5	10	15	1	0	16	0	0
13	27313258	.	G	T	7	5	12	0	1	13	0	0
13	27313310	.	T	A	5	8	13	0	0	13	0	0
13	27316688	.	T	A	3	5	8	0	0	8	0	0
13	27316778	.	G	T	3	3	6	0	0	6	0	0
13	27317026	.	C	T	24	24	48	0	2	50	0	0
13	27317499	.	C	T	38	24	62	0	2	64	0	0
13	27320574	.	T	C	22	43	65	0	1	66	0	0
13	27320583	.	C	T	21	41	62	0	1	63	0	0
13	27320628	.	T	A	37	24	61	0	4	65	0	0
13	27320849	.	T	C	28	26	54	0	3	57	0	0
13	27320996	.	G	A	6	24	30	0	37	67	0	0
13	27321271	.	G	A	2	24	26	0	35	61	0	0
13	27323970	.	G	A	3	33	36	0	33	69	0	0
13	27379718	.	T	C	4	3	7	0	0	7	0	0
13	27632915	.	C	T	3	15	18	0	17	35	0	0
13	27633628	.	G	A	20	16	36	0	0	36	0	0
13	27633833	.	A	G	13	12	25	0	3	28	0	0
13	27633906	.	A	G	20	19	39	0	3	42	0	0
13	27634324	.	T	C	20	20	40	0	0	40	0	0
13	27634634	.	A	G	26	16	42	0	0	42	0	0
13	27634670	.	G	T	19	26	45	0	2	47	0	0
13	27634678	.	G	T	17	27	44	0	0	45	1	0
13	27634726	.	T	C	8	2	10	0	33	43	0	0
13	27634903	.	A	G	19	26	45	0	1	46	0	0
13	27641472	.	T	C	23	19	42	0	0	42	0	0
13	27650537	.	G	A	27	13	40	0	1	41	0	0
13	27653458	.	C	A	1	13	14	0	17	31	0	0
13	27668056	.	G	T	23	20	43	2	4	49	0	0
13	27674408	.	C	T	16	16	32	0	0	32	0	0
13	27677945	.	C	T	0	13	13	0	6	19	0	0
13	27685233	.	G	A	13	7	20	0	2	23	1	0
13	27686259	.	C	T	22	15	37	0	0	37	0	0
13	27686405	.	G	A	25	22	47	0	0	47	0	0
13	27770575	.	T	C	16	6	22	0	1	23	0	0
13	27771607	.	T	G	8	0	8	0	13	21	0	0
13	27776846	.	A	G	13	6	19	0	0	19	0	0
13	27782086	.	C	A	3	10	13	0	0	13	0	0
13	27782192	.	A	T	4	2	6	0	0	6	0	0
13	27782193	.	G	A	3	2	5	0	0	5	0	0
13	27782402	.	A	T	10	3	13	0	0	13	0	0
13	27782449	.	T	G	4	2	6	0	0	6	0	0
13	27782480	.	G	A	2	2	4	0	1	5	0	0
13	27901949	.	C	T	1	3	4	0	0	4	0	0
13	27951827	.	G	A	1	8	9	0	11	20	0	0
13	27951883	.	A	G	10	0	10	0	17	27	0	0
13	27951989	.	A	C	14	9	23	0	1	24	0	0
13	27952156	.	C	T	17	18	35	0	1	36	0	0
13	27952207	.	G	A	16	15	31	0	0	31	0	0
13	27952330	.	G	T	13	19	32	0	3	35	0	0
13	27952414	.	A	G	18	17	35	0	1	36	0	0
13	27952441	.	G	T	16	21	37	0	1	38	0	0
13	27963912	.	T	C	15	18	33	0	3	36	0	0
13	28009302	.	G	A	1	18	19	0	14	33	0	0
13	28010183	.	G	A	28	26	54	0	5	59	0	0
13	28010572	.	C	A	24	21	45	0	3	48	0	0
13	28062552	.	T	G	19	17	36	1	3	40	0	0
13	28176651	.	T	C	17	18	35	0	2	37	0	0
13	28306325	.	A	G	1	4	5	0	0	5	0	0
13	28501360	.	C	T	2	4	6	0	0	6	0	0
13	28513036	.	T	C	2	5	7	0	1	8	0	0
13	28513240	.	G	A	5	4	9	0	1	10	0	0
13	28561304	.	T	A	3	3	6	0	2	8	0	0
13	28596162	.	C	A	7	4	11	0	0	11	0	0
13	28596429	.	C	T	1	2	3	0	0	3	0	0
13	28618147	.	A	G	2	3	5	0	0	5	0	0
13	28618625	.	T	C	3	3	6	0	0	6	0	0
13	28642825	.	C	A	2	11	13	0	0	13	0	0
13	28643087	.	C	T	4	5	9	0	2	11	0	0
13	28649848	.	A	C	11	6	17	0	2	19	0	0
13	28650239	.	A	T	11	12	23	0	0	23	0	0
13	28650349	.	A	T	13	6	19	0	1	20	0	0
13	28651214	.	C	A	2	17	19	3	28	50	0	0
13	28651365	.	A	G	17	26	43	0	1	44	0	0
13	28668942	.	G	C	12	9	21	0	1	22	0	0
13	28676034	.	G	A	9	8	17	0	0	17	0	0
13	28676083	.	A	C	9	7	16	0	3	19	0	0
13	28676134	.	G	C	4	13	17	0	0	17	0	0
13	28676241	.	A	G	8	8	16	0	0	16	0	0
13	28676358	.	G	A	11	5	16	0	0	16	0	0
13	28678176	.	C	G	12	11	23	0	0	23	0	0
13	28680634	.	T	A	8	12	20	0	2	22	0	0
13	28680847	.	T	A	5	4	9	0	0	9	0	0
13	28680879	.	T	C	5	4	9	0	2	11	0	0
13	28694384	.	C	A	8	5	13	0	0	13	0	0
13	28694390	.	C	T	9	4	13	0	0	13	0	0
13	28694447	.	G	A	9	5	14	0	0	14	0	0
13	28694664	.	T	C	3	4	7	0	0	7	0	0
13	28741042	.	A	T	12	26	38	0	2	40	0	0
13	28743835	.	C	T	21	16	37	0	1	38	0	0
13	28744061	.	C	A	5	6	11	0	0	11	0	0
13	28744159	.	G	A	3	8	11	0	0	11	0	0
13	28744495	.	G	A	3	18	21	0	11	33	1	0
13	28744690	.	C	T	19	11	30	0	1	31	0	0
13	28744775	.	C	T	10	12	22	0	2	24	0	0
13	28744976	.	C	T	4	4	8	0	0	8	0	0
13	28745188	.	G	A	15	16	31	0	0	31	0	0
13	28745899	.	A	G	13	7	20	0	1	21	0	0
13	28745934	.	C	A	9	6	15	0	2	17	0	0
13	28745963	.	C	T	8	9	17	0	1	18	0	0
13	28746033	.	G	A	9	13	22	0	1	23	0	0
13	28746083	.	T	C	1	4	5	0	1	6	0	0
13	28754545	.	T	C	3	3	6	0	0	6	0	0
13	28765352	.	T	C	1	5	6	0	1	7	0	0
13	28786409	.	G	A	6	7	13	0	2	15	0	0
13	28827315	.	T	A	15	5	20	0	1	21	0	0
13	28848209	.	C	G	18	16	34	3	1	38	0	0
13	28848220	.	G	A	19	21	40	3	1	44	0	0
13	28848473	.	C	T	23	17	40	0	3	43	0	0
13	28866413	.	A	T	29	24	53	0	2	55	0	0
13	28866485	.	A	G	19	25	44	0	0	44	0	0
13	28866553	.	A	G	25	27	52	0	5	57	0	0
13	28866810	.	G	A	27	22	49	0	3	52	0	0
13	28867071	.	G	T	25	29	54	0	2	56	0	0
13	28867159	.	G	A	3	22	25	0	29	54	0	0
13	28867367	.	C	T	30	25	55	0	3	58	0	0
13	28870698	.	A	T	25	34	59	0	1	60	0	0
13	28870917	.	T	C	37	33	70	0	2	72	0	0
13	28871055	.	T	C	31	24	55	0	0	55	0	0
13	28901463	.	T	A	21	27	48	0	2	51	1	0
13	28901957	.	A	G	9	15	24	0	2	26	0	0
13	28901996	.	T	C	15	15	30	0	1	31	0	0
13	28902169	.	C	T	21	14	35	0	0	35	0	0
13	28902170	.	C	G	20	13	33	0	3	36	0	0
13	28902215	.	T	C	23	7	30	0	1	31	0	0
13	29201030	.	T	G	1	5	6	0	0	6	0	0
13	29208776	.	C	T	2	2	4	0	1	5	0	0
13	29226842	.	T	C	1	3	4	0	0	4	0	0
13	29292193	.	C	T	7	2	9	0	0	9	0	0
13	29295742	.	G	A	2	3	5	0	0	5	0	0
13	29296096	.	G	C	2	8	10	0	0	10	0	0
13	29298856	.	G	T	0	7	7	0	7	14	0	0
13	29341522	.	C	T	9	9	18	0	1	19	0	0
13	29347034	.	A	G	3	6	9	0	0	9	0	0
13	29347156	.	G	A	1	3	4	0	4	8	0	0
13	29347170	.	G	A	6	3	9	0	0	9	0	0
13	29347745	.	A	C	7	9	16	0	1	17	0	0
13	29374153	.	G	A	0	14	14	0	5	19	0	0
13	29374165	.	G	A	5	13	18	0	0	18	0	0
13	29381011	.	C	T	12	11	23	0	0	23	0	0
13	29385831	.	G	A	19	9	28	0	1	29	0	0
13	29392261	.	G	A	13	8	21	0	1	22	0	0
13	29395207	.	C	A	12	12	24	0	4	28	0	0
13	29395236	.	C	T	14	16	30	0	0	30	0	0
13	29402681	.	A	C	11	10	21	0	0	21	0	0
13	29403953	.	A	C	14	6	20	0	1	21	0	0
13	29404003	.	G	A	9	9	18	0	0	18	0	0
13	29404323	.	G	T	12	18	30	0	3	33	0	0
13	29404576	.	A	G	17	17	34	0	1	35	0	0
13	29404633	.	C	T	11	20	31	0	0	31	0	0
13	29404660	.	T	G	14	1	15	0	20	35	0	0
13	29407196	.	C	T	8	6	14	0	0	14	0	0
13	29407397	.	C	A	0	3	3	0	6	9	0	0
13	29407802	.	T	G	13	13	26	0	0	26	0	0
13	29407896	.	A	G	3	9	12	0	0	12	0	0
13	29408009	.	G	T	1	3	4	0	1	5	0	0
13	29408052	.	G	T	5	6	11	0	1	12	0	0
13	29408192	.	T	A	8	12	20	0	1	21	0	0
13	29408226	.	T	C	12	4	16	0	0	16	0	0
13	29408499	.	G	A	12	13	25	1	0	26	0	0
13	29408530	.	C	T	9	7	16	1	0	17	0	0
13	29408677	.	T	A	15	14	29	0	1	30	0	0
13	29409265	.	C	T	1	7	8	0	10	18	0	0
13	29409530	.	G	A	11	14	25	0	1	26	0	0
13	29409558	.	G	A	10	13	23	0	0	23	0	0
13	29411895	.	T	G	7	10	17	0	1	18	0	0
13	29412299	.	G	A	10	16	26	0	1	27	0	0
13	29412379	.	G	T	11	11	22	0	1	23	0	0
13	29414482	.	A	T	10	11	21	0	0	21	0	0
13	29414509	.	G	A	8	16	24	0	1	25	0	0
13	29414546	.	A	G	17	7	24	0	1	25	0	0
13	29415184	.	A	T	11	18	29	0	1	30	0	0
13	29416798	.	A	T	15	17	32	0	1	33	0	0
13	29417091	.	G	A	7	10	17	1	0	18	0	0
13	29417792	.	T	C	13	9	22	0	0	22	0	0
13	29417814	.	G	A	11	8	19	0	1	20	0	0
13	29419508	.	G	A	6	5	11	0	0	11	0	0
13	29420849	.	A	T	13	7	20	0	0	20	0	0
13	29422112	.	G	A	1	2	3	0	0	3	0	0
13	29422499	.	C	G	0	9	9	0	5	14	0	0
13	29422511	.	T	A	10	5	15	0	0	15	0	0
13	29450479	.	T	C	6	6	12	0	1	13	0	0
13	29455199	.	C	T	5	3	8	0	1	9	0	0
13	29455573	.	A	G	7	5	12	0	1	13	0	0
13	29481766	.	T	C	1	2	3	0	0	3	0	0
13	29802607	.	C	A	8	12	20	0	0	20	0	0
13	29802633	.	A	G	6	6	12	0	0	12	0	0
13	29803253	.	C	T	8	9	17	0	1	18	0	0
13	29803801	.	G	A	4	7	11	0	1	12	0	0
13	29803832	.	T	C	4	3	7	1	1	9	0	0
13	29804075	.	T	C	2	5	7	0	1	8	0	0
13	29804183	.	T	C	5	2	7	0	0	7	0	0
13	31877381	.	T	G	3	3	6	0	1	7	0	0
13	31925599	.	C	T	2	2	4	0	0	4	0	0
13	31925701	.	A	G	3	4	7	0	0	7	0	0
13	31933666	.	A	G	6	5	11	0	0	11	0	0
13	31933684	.	G	A	7	3	10	0	1	11	0	0
13	31935288	.	C	T	2	4	6	0	1	7	0	0
13	31936053	.	C	G	2	4	6	0	0	6	0	0
13	31936074	.	A	T	2	4	6	0	0	6	0	0
13	31936488	.	T	A	3	2	5	0	0	5	0	0
13	31936700	.	G	T	5	5	10	0	0	10	0	0
13	31936707	.	T	A	4	5	9	0	0	9	0	0
13	31938234	.	T	A	1	2	3	0	1	4	0	0
13	32150021	.	T	C	3	4	7	0	1	8	0	0
13	32150038	.	G	A	1	4	5	0	5	10	0	0
13	32150081	.	C	A	3	5	8	0	1	9	0	0
13	32150245	.	A	C	1	2	3	0	1	4	0	0
13	32446184	.	T	A	1	2	3	0	0	3	0	0
13	32446278	.	G	A	6	8	14	0	0	14	0	0
13	32452658	.	C	T	2	4	6	0	0	6	0	0
13	32452924	.	G	T	4	2	6	0	1	7	0	0
13	32452949	.	T	G	4	4	8	0	1	9	0	0
13	32453227	.	G	T	1	2	3	0	0	3	0	0
13	32454381	.	A	T	7	13	20	0	1	21	0	0
13	32454565	.	T	A	6	7	13	0	3	16	0	0
13	32455739	.	C	A	15	9	24	0	2	26	0	0
13	32455943	.	A	G	9	6	15	0	1	16	0	0
13	32456312	.	C	G	6	5	11	0	0	11	0	0
13	32456350	.	G	A	4	5	9	0	1	10	0	0
13	32456624	.	C	T	1	2	3	0	0	3	0	0
13	32575859	.	T	G	2	6	8	0	1	9	0	0
13	32576154	.	G	A	2	6	8	0	0	8	0	0
13	32576178	.	T	C	3	0	3	0	4	7	0	0
13	32576310	.	T	C	3	5	8	0	0	8	0	0
13	32576760	.	C	A	0	2	2	0	5	7	0	0
13	32577087	.	A	G	2	3	5	0	0	5	0	0
13	32583915	.	G	A	7	5	12	0	0	12	0	0
13	32583930	.	A	G	7	3	10	0	0	10	0	0
13	32588892	.	A	G	7	4	11	0	0	11	0	0
13	32591702	.	C	T	3	3	6	0	0	6	0	0
13	32592973	.	C	T	3	3	6	0	0	6	0	0
13	32593009	.	T	C	3	0	3	0	5	8	0	0
13	32595257	.	C	T	5	7	12	0	1	13	0	0
13	32635712	.	T	A	2	2	4	0	0	4	0	0
13	32638668	.	C	T	7	11	18	0	0	18	0	0
13	32638670	.	T	C	7	11	18	0	0	18	0	0
13	32638991	.	T	C	9	12	21	0	0	21	0	0
13	32640975	.	C	A	6	7	13	0	1	14	0	0
13	32641165	.	G	A	3	5	8	0	0	8	0	0
13	32641215	.	A	G	3	4	7	0	0	7	0	0
13	32641767	.	T	G	2	2	4	0	0	4	0	0
13	32641979	.	C	T	3	2	5	0	0	5	0	0
13	32642012	.	A	C	2	3	5	0	0	5	0	0
13	32642047	.	G	C	3	3	6	0	0	6	0	0
13	32642050	.	G	C	3	3	6	0	0	6	0	0
13	32642185	.	A	G	4	4	8	0	0	8	0	0
13	32642215	.	A	G	8	3	11	0	0	11	0	0
13	32642284	.	C	A	2	6	8	0	0	8	0	0
13	32642369	.	T	C	2	6	8	0	0	8	0	0
13	32642410	.	G	T	4	7	11	0	1	12	0	0
13	32642488	.	A	G	10	6	16	0	0	16	0	0
13	32642528	.	A	T	13	7	20	0	2	22	0	0
13	32642568	.	A	T	11	7	18	0	1	19	0	0
13	32642618	.	T	A	5	5	10	0	0	10	0	0
13	32642684	.	T	C	6	0	6	0	2	8	0	0
13	32642690	.	T	C	5	2	7	0	0	7	0	0
13	32643073	.	A	G	3	3	6	0	0	6	0	0
13	32643143	.	G	A	3	2	5	0	0	5	0	0
13	32643326	.	G	A	5	3	8	0	0	8	0	0
13	32643414	.	A	T	4	3	7	0	0	7	0	0
13	32643696	.	T	G	9	4	13	0	0	13	0	0
13	32643840	.	A	G	3	5	8	0	1	9	0	0
13	32643891	.	G	A	3	2	5	0	0	5	0	0
13	32644377	.	G	A	3	2	5	0	0	5	0	0
13	32644863	.	T	C	3	3	6	0	2	8	0	0
13	32665008	.	A	C	3	2	5	0	0	5	0	0
13	32665035	.	G	A	3	2	5	0	0	5	0	0
13	32726095	.	G	T	7	3	10	0	0	10	0	0
13	32726099	.	G	A	7	3	10	0	0	10	0	0
13	32726152	.	G	C	5	2	7	0	1	8	0	0
13	32754282	.	C	T	3	2	5	0	0	5	0	0
13	32794413	.	T	C	5	10	15	0	0	15	0	0
13	32794925	.	T	C	8	6	14	0	0	14	0	0
13	32795072	.	A	G	6	0	6	0	9	15	0	0
13	32795387	.	T	C	8	8	16	0	0	16	0	0
13	32795882	.	A	C	3	3	6	0	0	6	0	0
13	32807491	.	C	T	6	4	10	0	0	10	0	0
13	32812521	.	C	G	2	5	7	0	0	7	0	0
13	32815765	.	C	T	3	6	9	0	0	9	0	0
13	32825086	.	C	T	10	10	20	0	0	20	0	0
13	32825143	.	A	C	16	0	16	0	7	23	0	0
13	32825149	.	T	C	16	0	16	0	9	25	0	0
13	32827410	.	T	C	7	12	19	0	0	19	0	0
13	32827754	.	A	G	7	13	20	0	1	21	0	0
13	32833326	.	T	C	15	12	27	0	0	27	0	0
13	32833359	.	A	G	13	10	23	0	1	24	0	0
13	32833364	.	A	C	13	10	23	0	0	23	0	0
13	32838217	.	T	C	7	5	12	0	3	15	0	0
13	32838241	.	C	A	9	10	19	0	0	19	0	0
13	32838254	.	C	T	5	11	16	0	0	16	0	0
13	32838276	.	T	A	5	14	19	0	1	20	0	0
13	32838468	.	A	G	18	9	27	0	1	28	0	0
13	32838507	.	T	A	21	6	27	0	1	28	0	0
13	32841314	.	A	G	6	6	12	0	0	12	0	0
13	32841377	.	C	T	4	6	10	0	0	10	0	0
13	32844487	.	C	G	3	5	8	0	0	8	0	0
13	32844777	.	C	T	1	9	10	0	4	14	0	0
13	32899241	.	G	C	4	7	11	0	0	11	0	0
13	32902212	.	G	T	4	4	8	0	1	9	0	0
13	32902243	.	C	T	0	4	4	0	3	7	0	0
13	32902545	.	G	A	1	6	7	0	0	7	0	0
13	32906139	.	T	A	1	2	3	0	0	3	0	0
13	32993962	.	C	T	0	8	8	0	10	18	0	0
13	32994526	.	T	C	16	14	30	0	1	31	0	0
13	32994565	.	T	A	6	11	17	0	1	18	0	0
13	32994697	.	G	T	10	10	20	0	0	20	0	0
13	32994736	.	A	G	10	7	17	0	1	18	0	0
13	32994841	.	A	G	14	13	27	0	0	27	0	0
13	32997196	.	A	T	4	5	9	0	0	9	0	0
13	32997224	.	C	A	3	13	16	0	0	16	0	0
13	32997260	.	T	C	3	11	14	0	1	15	0	0
13	32997424	.	G	T	9	9	18	2	1	21	0	0
13	32997517	.	T	A	10	12	22	3	0	25	0	0
13	33000574	.	C	T	0	15	15	0	8	23	0	0
13	33000586	.	T	C	4	16	20	0	1	21	0	0
13	33005284	.	T	C	9	24	33	0	1	34	0	0
13	33005346	.	G	A	12	30	42	0	1	43	0	0
13	33007766	.	C	T	11	25	36	0	2	38	0	0
13	33020054	.	T	C	5	1	6	0	2	8	0	0
13	33021814	.	G	T	5	7	12	0	0	12	0	0
13	33024580	.	G	T	4	3	7	0	0	7	0	0
13	33024599	.	C	A	6	4	10	0	0	10	0	0
13	33024743	.	A	C	10	11	21	0	0	22	1	0
13	33024789	.	G	C	24	19	43	0	0	43	0	0
13	33029576	.	A	T	20	17	37	0	1	38	0	0
13	33029594	.	G	A	0	16	16	0	23	39	0	0
13	33029624	.	G	T	2	11	13	0	22	35	0	0
13	33031915	.	A	G	23	19	42	0	1	43	0	0
13	33033330	.	C	T	22	27	49	0	3	52	0	0
13	33033354	.	A	G	23	27	50	0	0	50	0	0
13	33033658	.	G	C	22	0	22	0	0	22	0	0
13	33033688	.	T	C	22	25	47	0	0	47	0	0
13	33040461	.	G	T	1	5	6	0	0	6	0	0
13	33040814	.	C	G	1	3	4	0	0	4	0	0
13	33048095	.	T	C	6	5	11	0	1	12	0	0
13	33048096	.	G	A	6	6	12	0	0	12	0	0
13	33054598	.	T	C	10	3	13	0	0	13	0	0
13	33054706	.	G	A	5	5	10	0	0	10	0	0
13	33059179	.	C	T	17	14	31	0	0	31	0	0
13	33059257	.	T	C	16	10	26	0	2	28	0	0
13	33059260	.	A	G	16	11	27	0	0	27	0	0
13	33062352	.	G	C	7	14	21	0	1	22	0	0
13	33062367	.	C	T	8	15	23	0	0	23	0	0
13	33065614	.	A	C	9	9	18	0	0	18	0	0
13	33077094	.	C	T	4	2	6	0	0	6	0	0
13	33078885	.	C	A	0	3	3	0	2	5	0	0
13	33079270	.	A	G	2	3	5	0	0	5	0	0
13	33081822	.	G	T	6	3	9	0	0	9	0	0
13	33083248	.	A	T	3	4	7	0	0	7	0	0
13	33083275	.	C	T	2	2	4	0	0	4	0	0
13	33089068	.	A	G	4	4	8	0	0	8	0	0
13	33089092	.	A	G	3	3	6	0	0	6	0	0
13	33089123	.	T	A	2	2	4	0	0	4	0	0
13	33092111	.	A	T	1	2	3	0	0	3	0	0
13	33093724	.	G	T	3	2	5	0	0	5	0	0
13	33099304	.	T	C	3	2	5	0	0	5	0	0
13	33101558	.	G	A	1	2	3	0	0	3	0	0
13	33101725	.	C	G	2	2	4	0	0	4	0	0
13	33122141	.	T	C	4	5	9	0	0	9	0	0
13	33122276	.	T	A	7	7	14	0	2	16	0	0
13	33122312	.	C	A	8	8	16	0	0	16	0	0
13	33122429	.	C	G	7	10	17	0	1	18	0	0
13	33122519	.	T	C	6	13	19	0	1	20	0	0
13	33122541	.	G	T	5	16	21	0	0	21	0	0
13	33122554	.	A	T	7	14	21	0	0	21	0	0
13	33122847	.	T	G	5	0	5	0	12	17	0	0
13	33122853	.	C	A	4	12	16	0	1	17	0	0
13	33122986	.	A	G	6	0	6	0	11	17	0	0
13	33174533	.	G	A	4	5	9	0	1	10	0	0
13	33174645	.	G	A	5	5	10	0	0	10	0	0
13	33174681	.	G	A	4	4	8	0	0	8	0	0
13	33174865	.	T	G	7	5	12	0	0	12	0	0
13	33175097	.	A	C	4	7	11	0	0	11	0	0
13	33175126	.	C	A	8	6	14	0	0	14	0	0
13	33175190	.	A	G	7	9	16	0	0	16	0	0
13	33175202	.	T	C	5	0	5	0	10	15	0	0
13	33177425	.	G	T	8	9	17	0	2	19	0	0
13	33177682	.	C	G	0	11	11	0	8	19	0	0
13	33190239	.	G	C	4	0	4	0	6	10	0	0
13	33192619	.	C	A	5	6	11	0	0	11	0	0
13	33194490	.	A	C	2	3	5	0	0	5	0	0
13	33194527	.	G	C	5	3	8	0	0	8	0	0
13	33194854	.	A	T	2	5	7	0	0	7	0	0
13	33195500	.	T	G	4	5	9	0	0	9	0	0
13	33195529	.	T	C	3	6	9	0	0	9	0	0
13	33196426	.	A	T	2	3	5	0	0	5	0	0
13	33196441	.	A	C	2	3	5	0	0	5	0	0
13	33196534	.	T	C	1	3	4	0	0	4	0	0
13	33196656	.	A	G	5	6	11	0	0	11	0	0
13	33196698	.	A	G	5	7	12	0	0	12	0	0
13	33196730	.	G	A	2	4	6	0	0	6	0	0
13	33197897	.	C	T	5	5	10	0	0	10	0	0
13	33197959	.	G	C	6	3	9	0	1	10	0	0
13	33200070	.	T	C	4	6	10	0	1	11	0	0
13	33200103	.	A	G	3	3	6	0	0	6	0	0
13	33200115	.	G	C	3	3	6	0	0	6	0	0
13	33211397	.	T	A	7	8	15	0	0	15	0	0
13	33211445	.	A	T	5	5	10	0	0	10	0	0
13	33214664	.	C	T	1	9	10	0	9	19	0	0
13	33214706	.	C	T	14	11	25	0	1	26	0	0
13	33214709	.	T	C	15	12	27	0	1	28	0	0
13	33216341	.	G	A	15	13	28	0	1	29	0	0
13	33218214	.	C	T	10	5	15	0	1	16	0	0
13	33219988	.	C	A	0	5	5	0	9	14	0	0
13	33220164	.	A	G	8	10	18	0	0	18	0	0
13	33222342	.	C	A	2	4	6	0	8	14	0	0
13	33222396	.	G	A	6	5	11	0	3	14	0	0
13	33224742	.	G	T	11	7	18	0	1	19	0	0
13	33224932	.	C	T	0	5	5	0	9	14	0	0
13	33225029	.	G	A	12	4	16	0	0	16	0	0
13	33229502	.	T	G	6	3	9	0	1	10	0	0
13	33229739	.	T	C	13	10	23	0	1	24	0	0
13	33229753	.	C	T	13	9	22	0	1	23	0	0
13	33230024	.	A	T	18	22	40	0	2	42	0	0
13	33230163	.	G	C	20	18	38	0	0	38	0	0
13	33230177	.	G	A	15	17	32	0	0	32	0	0
13	33230253	.	C	T	13	12	25	0	3	28	0	0
13	33230436	.	C	A	5	15	20	0	1	21	0	0
13	33230518	.	T	C	10	1	11	0	15	26	0	0
13	33234522	.	C	T	1	15	16	0	20	36	0	0
13	33234866	.	T	C	16	12	28	0	1	29	0	0
13	33236111	.	T	C	15	13	28	0	2	30	0	0
13	33236482	.	G	T	18	12	30	0	0	30	0	0
13	33236691	.	A	G	18	8	26	0	0	26	0	0
13	33239219	.	G	A	15	12	27	0	2	29	0	0
13	33242878	.	C	T	13	14	27	0	1	28	0	0
13	33246227	.	T	A	6	14	20	0	0	20	0	0
13	33246249	.	T	A	7	20	27	0	0	27	0	0
13	33248351	.	C	T	4	9	13	0	0	13	0	0
13	33248677	.	T	A	8	8	16	0	2	18	0	0
13	33250992	.	T	A	13	13	26	0	0	26	0	0
13	33251058	.	C	G	9	1	10	0	10	20	0	0
13	33261198	.	A	G	17	13	30	0	1	31	0	0
13	33261228	.	C	T	19	21	40	0	0	40	0	0
13	33261303	.	A	T	17	30	47	0	1	48	0	0
13	33261326	.	A	T	18	30	48	0	2	50	0	0
13	33261340	.	C	T	21	28	49	0	2	51	0	0
13	33261389	.	T	G	23	19	42	0	3	45	0	0
13	33261577	.	C	G	22	19	41	0	3	44	0	0
13	33261620	.	T	C	22	14	36	0	3	39	0	0
13	33261637	.	G	T	20	5	25	0	2	30	3	0
13	33262044	.	C	A	26	33	59	0	0	59	0	0
13	33262721	.	A	T	18	17	35	0	0	35	0	0
13	33262749	.	A	C	19	12	31	0	1	32	0	0
13	33262909	.	G	T	21	18	39	0	2	41	0	0
13	33262944	.	C	G	22	20	42	0	0	42	0	0
13	33263503	.	G	T	19	13	32	0	0	32	0	0
13	33263809	.	A	T	21	6	27	0	0	27	0	0
13	33263985	.	C	A	13	18	31	0	0	31	0	0
13	33264001	.	G	A	13	18	31	0	1	32	0	0
13	33264315	.	T	C	20	26	46	0	2	48	0	0
13	33264318	.	C	T	22	26	48	0	3	51	0	0
13	33264470	.	A	G	19	27	46	0	1	47	0	0
13	33264483	.	T	A	20	21	41	0	1	42	0	0
13	33264635	.	A	T	12	15	27	0	0	27	0	0
13	33264772	.	A	T	11	19	30	0	2	32	0	0
13	33265128	.	T	C	19	0	19	0	20	39	0	0
13	33265210	.	T	G	19	22	41	0	0	41	0	0
13	33265323	.	A	C	21	20	41	0	1	42	0	0
13	33265364	.	G	T	24	23	47	0	0	47	0	0
13	33267095	.	T	C	30	16	46	0	2	48	0	0
13	33268757	.	A	T	8	7	15	0	0	15	0	0
13	33268791	.	T	C	4	6	10	0	0	10	0	0
13	33273081	.	C	A	5	4	9	0	0	9	0	0
13	33273106	.	C	T	5	2	7	0	0	7	0	0
13	33276048	.	T	C	4	5	9	0	0	9	0	0
13	33276106	.	T	C	5	3	8	0	1	9	0	0
13	33281138	.	G	T	0	5	5	0	6	11	0	0
13	33281218	.	G	A	0	5	5	0	2	7	0	0
13	33282130	.	G	A	4	7	11	0	1	12	0	0
13	33282227	.	G	A	6	5	11	0	0	11	0	0
13	33282236	.	A	G	6	4	10	0	1	11	0	0
13	33293037	.	A	G	4	7	11	0	0	11	0	0
13	33293608	.	C	A	4	3	7	0	0	7	0	0
13	33293639	.	G	A	0	4	4	0	2	6	0	0
13	33294207	.	C	T	4	6	10	0	0	10	0	0
13	33295894	.	T	A	3	4	7	0	0	7	0	0
13	33310614	.	C	T	2	4	6	0	0	6	0	0
13	33313037	.	T	C	5	3	8	0	0	8	0	0
13	33313066	.	C	A	4	2	6	0	1	7	0	0
13	33314821	.	T	G	1	4	5	0	0	5	0	0
13	33314840	.	A	T	1	6	7	0	0	7	0	0
13	33314863	.	T	C	1	6	7	0	0	7	0	0
13	33314946	.	T	C	4	7	11	0	0	11	0	0
13	33315112	.	C	G	3	8	11	0	0	11	0	0
13	33316844	.	C	T	6	3	9	0	0	9	0	0
13	33317022	.	T	C	1	4	5	0	1	6	0	0
13	33368512	.	A	T	2	3	5	0	0	5	0	0
13	33368531	.	C	T	2	4	6	0	0	6	0	0
13	33368577	.	C	G	2	3	5	0	0	5	0	0
13	33381160	.	C	T	3	3	6	0	0	6	0	0
13	33394476	.	A	C	23	19	42	0	0	42	0	0
13	33394887	.	G	A	20	17	37	0	0	37	0	0
13	33394976	.	T	C	23	16	39	0	0	39	0	0
13	33395174	.	C	G	12	18	30	0	1	31	0	0
13	33395256	.	T	G	8	11	19	0	0	19	0	0
13	33396026	.	A	C	7	0	7	0	5	12	0	0
13	33396343	.	C	T	2	6	8	0	17	25	0	0
13	33398365	.	C	T	16	18	34	0	2	36	0	0
13	33398498	.	G	A	20	5	25	0	1	26	0	0
13	33411068	.	C	T	1	3	4	0	0	4	0	0
13	33411082	.	G	A	1	2	3	0	0	3	0	0
13	33445279	.	G	A	1	3	4	0	0	4	0	0
13	33445288	.	C	T	1	3	4	0	1	5	0	0
13	33447700	.	T	A	1	2	3	0	0	3	0	0
13	33612347	.	C	T	9	3	12	0	0	12	0	0
13	33619849	.	A	G	6	8	14	0	0	14	0	0
13	33625095	.	T	C	2	6	8	0	0	8	0	0
13	33631381	.	T	A	2	5	7	0	0	7	0	0
13	33631832	.	C	A	3	2	5	0	0	5	0	0
13	33633271	.	T	A	3	7	10	0	1	11	0	0
13	33633344	.	G	A	6	2	8	0	0	8	0	0
13	33636034	.	A	G	8	8	16	0	0	16	0	0
13	33636548	.	T	C	7	1	8	0	6	14	0	0
13	33636597	.	G	A	7	5	12	0	0	12	0	0
13	33645567	.	C	T	7	5	12	0	1	13	0	0
13	33645892	.	C	T	1	3	4	0	0	4	0	0
13	33646123	.	T	A	10	5	15	1	0	16	0	0
13	33646132	.	A	T	9	4	13	1	3	17	0	0
13	33646224	.	C	T	4	5	9	0	0	9	0	0
13	33646285	.	G	A	6	4	10	0	0	10	0	0
13	33649184	.	T	G	8	4	12	0	0	12	0	0
13	33652588	.	A	G	6	7	13	0	0	13	0	0
13	33656297	.	A	C	1	3	4	0	1	5	0	0
13	33665516	.	C	A	3	2	5	0	0	5	0	0
13	33665860	.	A	T	2	3	5	0	0	5	0	0
13	33665888	.	G	A	2	3	5	0	0	5	0	0
13	33665898	.	G	A	2	3	5	0	0	5	0	0
13	33682023	.	C	T	8	17	25	0	2	27	0	0
13	33682052	.	T	C	13	19	32	0	3	35	0	0
13	33682068	.	A	C	16	27	43	0	2	45	0	0
13	33682216	.	C	T	13	14	27	1	0	28	0	0
13	33682217	.	A	T	12	14	26	1	1	28	0	0
13	33682379	.	C	A	11	9	20	0	0	20	0	0
13	33682601	.	T	A	2	2	4	0	1	5	0	0
13	33682731	.	G	A	20	26	46	0	1	47	0	0
13	33683824	.	A	C	24	32	56	0	4	60	0	0
13	33683829	.	A	T	24	32	56	0	1	57	0	0
13	33813428	.	A	C	12	10	22	0	0	22	0	0
13	33813452	.	T	G	13	13	26	0	0	26	0	0
13	33813792	.	C	T	12	5	17	0	0	17	0	0
13	33814644	.	A	C	10	3	13	0	0	13	0	0
13	33814647	.	T	A	9	3	12	0	1	13	0	0
13	33814773	.	C	T	10	14	24	0	4	28	0	0
13	33815863	.	C	A	11	11	22	0	0	22	0	0
13	33815992	.	C	T	14	6	20	0	0	20	0	0
13	33816200	.	C	T	6	4	10	0	1	11	0	0
13	33816231	.	T	G	4	6	10	0	0	10	0	0
13	33816442	.	C	T	7	5	12	0	0	12	0	0
13	33816509	.	A	G	9	5	14	0	0	14	0	0
13	33816518	.	T	C	11	4	15	0	0	15	0	0
13	33968506	.	T	C	12	9	21	0	0	21	0	0
13	34483567	.	G	A	1	11	12	0	20	32	0	0
13	34488737	.	T	G	14	14	28	0	1	29	0	0
13	34519607	.	T	A	15	22	37	0	0	37	0	0
13	34556374	.	C	A	14	16	30	0	6	36	0	0
13	34689840	.	G	T	9	3	12	0	0	12	0	0
13	34697636	.	T	G	4	6	10	0	0	10	0	0
13	34703994	.	T	C	4	6	10	0	0	10	0	0
13	34746145	.	A	T	5	4	9	0	0	9	0	0
13	34746422	.	T	C	2	2	4	0	0	4	0	0
13	34746660	.	A	G	4	4	8	0	1	9	0	0
13	34746671	.	G	A	6	5	11	0	0	11	0	0
13	34746752	.	A	G	4	0	4	0	5	9	0	0
13	34746847	.	A	G	1	4	5	0	1	6	0	0
13	34747058	.	G	A	4	4	8	0	0	8	0	0
13	34747137	.	G	A	1	3	4	0	3	7	0	0
13	34747160	.	A	C	4	2	6	0	0	6	0	0
13	34747617	.	A	G	2	2	4	0	2	6	0	0
13	34747734	.	A	G	7	0	7	0	5	12	0	0
13	34747916	.	A	C	5	4	9	0	0	9	0	0
13	34748086	.	G	T	4	6	10	0	0	10	0	0
13	34748199	.	C	A	4	3	7	0	0	7	0	0
13	34748362	.	C	T	5	7	12	0	0	12	0	0
13	34748479	.	A	G	6	6	12	0	1	13	0	0
13	34748516	.	C	T	6	4	10	0	1	11	0	0
13	34748791	.	G	T	4	2	6	0	2	8	0	0
13	34748959	.	A	T	3	4	7	1	0	8	0	0
13	34748990	.	T	A	2	3	5	1	0	6	0	0
13	34749079	.	G	T	5	2	7	0	0	7	0	0
13	34749142	.	G	T	2	2	4	0	1	5	0	0
13	34749279	.	G	A	3	3	6	0	0	6	0	0
13	34749616	.	C	T	9	2	11	0	1	12	0	0
13	34749743	.	G	T	8	6	14	0	1	15	0	0
13	34749751	.	C	T	8	5	13	0	0	13	0	0
13	34749819	.	C	T	10	5	15	0	0	15	0	0
13	34749833	.	A	G	10	4	14	0	2	16	0	0
13	34749936	.	T	A	6	6	12	0	0	12	0	0
13	34750212	.	A	T	1	2	3	0	1	4	0	0
13	34765346	.	T	G	4	2	6	0	0	6	0	0
13	34765531	.	T	A	4	2	6	0	0	6	0	0
13	34765556	.	C	T	3	2	5	0	0	5	0	0
13	34765639	.	G	A	1	5	6	0	0	6	0	0
13	34765690	.	A	G	2	6	8	0	1	9	0	0
13	34765780	.	T	G	4	3	7	0	1	8	0	0
13	34771824	.	T	C	1	3	4	0	0	4	0	0
13	34792975	.	A	G	3	5	8	0	0	8	0	0
13	34793014	.	G	A	2	2	4	0	0	4	0	0
13	35042138	.	C	T	22	23	45	0	1	46	0	0
13	35042237	.	G	A	20	24	44	0	2	46	0	0
13	35042279	.	G	A	26	23	49	0	2	51	0	0
13	35042354	.	G	T	23	11	34	0	0	34	0	0
13	35049461	.	A	G	12	11	23	0	1	24	0	0
13	35051624	.	C	T	2	17	19	0	14	33	0	0
13	35051786	.	T	C	16	23	39	0	0	39	0	0
13	35051880	.	G	A	11	6	17	0	1	18	0	0
13	35478781	.	T	A	3	2	5	0	0	5	0	0
13	35510945	.	T	C	2	4	6	0	2	8	0	0
13	35511074	.	A	G	4	4	8	0	0	8	0	0
13	35527647	.	G	T	8	7	15	0	0	15	0	0
13	35715365	.	G	A	1	2	3	0	1	4	0	0
13	35717473	.	T	A	1	2	3	0	0	3	0	0
13	35718577	.	T	A	3	4	7	0	0	7	0	0
13	35718883	.	G	T	1	2	3	0	0	3	0	0
13	35719007	.	A	C	4	4	8	0	0	8	0	0
13	35722421	.	A	G	3	2	5	0	0	5	0	0
13	35722703	.	G	A	1	2	3	0	0	3	0	0
13	35723419	.	T	A	1	4	5	0	2	7	0	0
13	35723453	.	G	A	1	8	9	0	0	9	0	0
13	35724324	.	T	G	1	0	1	0	2	3	0	0
13	35724337	.	A	G	1	2	3	0	0	3	0	0
13	35726735	.	G	C	4	3	7	0	0	7	0	0
13	35728714	.	A	G	1	2	3	0	1	4	0	0
13	35744584	.	C	T	1	1	2	0	0	2	0	0
13	35745657	.	T	C	13	11	24	0	1	25	0	0
13	35746343	.	A	G	13	1	14	0	15	29	0	0
13	35746637	.	C	T	12	12	24	0	1	25	0	0
13	35746838	.	T	C	7	11	18	0	1	19	0	0
13	35747177	.	T	G	11	21	32	0	0	32	0	0
13	35747690	.	A	G	16	1	17	0	20	37	0	0
13	35747918	.	T	C	26	29	55	0	1	56	0	0
13	35747954	.	T	C	26	21	47	0	0	47	0	0
13	35748096	.	C	G	20	0	20	0	16	36	0	0
13	35748249	.	G	A	10	9	19	0	1	20	0	0
13	35748319	.	T	C	17	8	25	0	1	26	0	0
13	35748566	.	C	T	3	2	5	0	0	5	0	0
13	35751047	.	T	C	5	7	12	0	1	13	0	0
13	35751211	.	T	C	11	6	17	0	0	17	0	0
13	35753242	.	G	A	12	8	20	0	0	20	0	0
13	35756029	.	G	T	9	11	20	0	0	20	0	0
13	35757338	.	T	G	7	8	15	0	1	16	0	0
13	35758093	.	T	C	4	0	4	0	9	13	0	0
13	35758111	.	G	T	3	7	10	0	1	11	0	0
13	35759904	.	G	A	13	8	21	0	0	21	0	0
13	35773076	.	G	A	1	3	4	0	0	4	0	0
13	35775384	.	G	T	1	2	3	0	0	3	0	0
13	35787771	.	T	A	5	2	7	0	0	7	0	0
13	35788222	.	G	A	12	6	18	0	0	18	0	0
13	35788302	.	A	C	11	10	21	0	1	22	0	0
13	35788313	.	T	C	12	10	22	0	1	23	0	0
13	35788507	.	G	A	12	19	31	0	0	31	0	0
13	35788562	.	C	G	3	12	15	0	14	29	0	0
13	35791419	.	C	G	23	8	31	0	0	31	0	0
13	35791539	.	G	A	7	9	16	0	3	19	0	0
13	35796882	.	C	T	7	10	17	0	1	18	0	0
13	35796894	.	G	A	7	11	18	0	0	18	0	0
13	35796924	.	C	T	0	15	15	0	4	19	0	0
13	35798915	.	A	G	4	11	15	0	0	15	0	0
13	35798960	.	T	C	5	10	15	0	0	15	0	0
13	35798966	.	G	C	3	10	13	0	0	13	0	0
13	35799146	.	G	A	6	11	17	0	0	17	0	0
13	35799194	.	C	T	5	14	19	0	0	19	0	0
13	35799230	.	A	G	3	11	14	0	0	14	0	0
13	35801258	.	G	A	7	8	15	0	0	15	0	0
13	35801452	.	A	G	10	12	22	0	0	22	0	0
13	35801473	.	A	G	7	14	21	0	1	22	0	0
13	35801501	.	T	C	4	0	4	0	13	17	0	0
13	35808949	.	T	C	9	4	13	0	1	14	0	0
13	35811400	.	A	G	8	6	14	0	0	14	0	0
13	35811852	.	C	G	6	10	16	0	1	17	0	0
13	35811907	.	A	G	7	5	12	0	0	12	0	0
13	35813549	.	A	G	5	6	11	0	0	11	0	0
13	35813666	.	C	T	0	10	10	0	11	21	0	0
13	35814762	.	A	T	3	10	13	0	0	13	0	0
13	35844912	.	A	G	6	5	11	0	1	12	0	0
13	35856539	.	G	T	10	18	28	0	0	28	0	0
13	35856826	.	T	C	8	15	23	0	0	23	0	0
13	35866351	.	T	C	5	9	14	0	0	14	0	0
13	35866381	.	A	G	7	11	18	0	0	18	0	0
13	35872207	.	C	T	8	10	18	0	2	20	0	0
13	35872373	.	T	C	9	6	15	0	0	16	1	0
13	35872385	.	C	A	8	6	14	0	1	15	0	0
13	35872493	.	T	A	8	6	14	0	0	14	0	0
13	35872495	.	C	A	8	6	14	0	0	14	0	0
13	35883450	.	T	C	2	2	4	0	0	4	0	0
13	35888614	.	G	A	2	3	5	0	0	5	0	0
13	35905136	.	G	A	4	2	6	0	0	6	0	0
13	35905265	.	A	G	3	5	8	0	0	8	0	0
13	35905334	.	C	T	0	4	4	0	7	11	0	0
13	35907171	.	A	C	4	3	7	0	0	7	0	0
13	35925668	.	T	A	3	3	6	0	0	6	0	0
13	35925671	.	G	T	3	3	6	0	0	6	0	0
13	35950431	.	A	G	4	3	7	0	0	7	0	0
13	35950440	.	C	T	6	3	9	0	0	9	0	0
13	35950720	.	G	A	7	10	17	0	3	20	0	0
13	35950753	.	C	A	8	15	23	0	1	24	0	0
13	35953558	.	G	A	7	6	13	0	1	14	0	0
13	36039938	.	G	A	23	18	41	0	2	43	0	0
13	36040061	.	G	T	17	10	27	0	5	32	0	0
13	36040127	.	A	T	31	17	48	0	2	50	0	0
13	36040278	.	T	C	20	0	20	0	25	45	0	0
13	36040473	.	A	C	4	5	9	0	0	9	0	0
13	36040611	.	C	T	1	11	12	3	6	21	0	0
13	36040635	.	C	A	12	14	26	3	3	32	0	0
13	36042020	.	T	A	22	17	39	0	5	44	0	0
13	36042057	.	C	T	24	15	39	0	1	40	0	0
13	36042091	.	G	C	21	17	38	0	0	38	0	0
13	36043781	.	T	A	17	19	36	0	0	36	0	0
13	36043796	.	T	C	17	0	17	0	19	37	1	0
13	36043820	.	T	C	18	0	18	0	20	38	0	0
13	36045705	.	G	A	22	14	36	0	1	37	0	0
13	36048931	.	A	G	13	9	22	0	1	23	0	0
13	36048981	.	C	T	23	13	36	0	2	38	0	0
13	36054962	.	T	C	13	16	29	0	1	30	0	0
13	36057124	.	C	T	9	9	18	1	2	21	0	0
13	36060640	.	G	A	15	14	29	0	3	32	0	0
13	36060679	.	T	G	14	12	26	0	3	29	0	0
13	36062661	.	T	A	6	16	22	0	0	22	0	0
13	36067938	.	A	G	8	5	13	0	1	14	0	0
13	36072451	.	C	T	1	7	8	0	6	14	0	0
13	36074085	.	T	C	8	0	8	0	14	22	0	0
13	36074176	.	G	A	6	3	9	0	1	10	0	0
13	36083861	.	G	A	5	10	15	0	0	15	0	0
13	36084169	.	C	G	10	6	16	0	0	16	0	0
13	36086313	.	G	T	7	4	11	0	0	11	0	0
13	36086415	.	G	A	7	7	14	0	1	15	0	0
13	36088851	.	A	G	12	4	16	0	0	16	0	0
13	36098899	.	C	A	4	4	8	0	0	8	0	0
13	36102706	.	C	T	0	8	8	0	8	16	0	0
13	36103492	.	G	A	7	5	12	0	0	12	0	0
13	36103688	.	A	G	3	4	7	0	0	7	0	0
13	36103985	.	C	A	1	2	3	0	3	6	0	0
13	36104207	.	G	A	4	4	8	0	0	8	0	0
13	36104209	.	T	C	2	0	2	0	6	8	0	0
13	36129728	.	G	T	1	3	4	0	0	4	0	0
13	36134326	.	C	G	6	2	8	0	0	8	0	0
13	36135416	.	A	G	1	4	5	0	1	6	0	0
13	36136669	.	C	G	1	12	13	0	13	26	0	0
13	36146596	.	G	A	18	17	35	0	1	36	0	0
13	36151407	.	G	C	8	9	17	0	1	18	0	0
13	36151462	.	G	A	10	10	20	0	3	23	0	0
13	36151635	.	T	C	10	15	25	0	0	25	0	0
13	36151636	.	C	T	10	15	25	0	0	25	0	0
13	36151894	.	G	C	15	14	29	0	2	31	0	0
13	36151929	.	C	T	20	12	32	0	2	34	0	0
13	36152364	.	T	C	23	21	44	0	2	46	0	0
13	36152402	.	C	T	26	25	51	0	1	52	0	0
13	36152415	.	A	G	19	28	47	0	2	49	0	0
13	36152440	.	T	G	15	1	16	0	27	43	0	0
13	36152700	.	T	A	20	14	34	0	0	34	0	0
13	36152733	.	A	G	14	18	32	0	1	33	0	0
13	36152778	.	A	G	17	15	32	0	1	33	0	0
13	36152795	.	A	C	13	12	25	0	3	28	0	0
13	36152874	.	C	T	9	3	12	0	0	12	0	0
13	36153313	.	T	C	15	14	29	0	1	30	0	0
13	36153382	.	C	T	20	9	29	0	0	29	0	0
13	36168770	.	C	T	9	6	15	0	1	16	0	0
13	36168836	.	G	A	3	2	5	0	2	7	0	0
13	36168861	.	G	T	8	3	11	0	0	11	0	0
13	36179661	.	G	C	5	4	9	0	0	9	0	0
13	36179838	.	C	T	4	6	10	0	0	10	0	0
13	36179844	.	A	T	4	9	13	0	0	13	0	0
13	36223870	.	G	T	1	4	5	0	0	5	0	0
13	36263596	.	T	C	2	4	6	0	0	6	0	0
13	36263671	.	A	T	3	2	5	0	0	5	0	0
13	36264100	.	T	C	2	5	7	0	0	7	0	0
13	36264292	.	T	C	3	2	5	0	0	5	0	0
13	36312103	.	C	G	4	2	6	0	0	6	0	0
13	36312193	.	G	T	11	11	22	0	0	22	0	0
13	36312497	.	C	T	0	3	3	0	12	15	0	0
13	36312682	.	G	A	10	5	15	0	1	16	0	0
13	36322099	.	C	T	0	11	11	0	8	19	0	0
13	36322133	.	A	G	9	19	28	0	1	29	0	0
13	36330642	.	G	A	10	4	14	0	1	15	0	0
13	36335033	.	G	A	8	4	12	0	1	13	0	0
13	36335057	.	A	G	8	5	13	0	0	13	0	0
13	36338262	.	A	G	3	6	9	0	0	9	0	0
13	36349674	.	G	A	7	3	10	1	0	11	0	0
13	36409233	.	A	T	4	4	8	0	0	8	0	0
13	36409246	.	C	T	3	3	6	0	1	7	0	0
13	36409522	.	T	C	7	1	8	0	9	17	0	0
13	36409691	.	A	G	4	6	10	0	0	10	0	0
13	36410339	.	T	C	7	6	13	0	5	18	0	0
13	36410671	.	T	C	5	5	10	0	0	10	0	0
13	36418648	.	G	T	8	7	15	0	0	15	0	0
13	36418735	.	A	T	6	5	11	0	0	11	0	0
13	36424414	.	G	A	4	8	12	0	0	12	0	0
13	36438831	.	C	T	8	3	11	0	2	13	0	0
13	36450109	.	C	T	4	9	13	0	1	14	0	0
13	36452721	.	T	C	10	0	10	0	11	21	0	0
13	36452977	.	A	G	9	8	17	0	1	18	0	0
13	36461642	.	T	C	6	1	7	0	9	16	0	0
13	36465595	.	C	T	4	7	11	0	0	11	0	0
13	36465604	.	A	G	3	6	9	0	0	9	0	0
13	36466321	.	C	G	2	6	8	0	0	8	0	0
13	36467504	.	G	A	5	2	7	0	0	7	0	0
13	36467558	.	G	A	3	9	12	0	0	12	0	0
13	36471262	.	A	G	6	8	14	0	0	14	0	0
13	36481823	.	C	T	5	2	7	0	1	8	0	0
13	36484865	.	A	G	2	7	9	0	0	9	0	0
13	36606576	.	A	G	6	5	11	0	0	11	0	0
13	37076269	.	T	C	8	8	16	0	1	17	0	0
13	37076281	.	T	C	17	6	23	0	0	23	0	0
13	37076337	.	T	C	13	5	18	0	0	18	0	0
13	37421594	.	G	A	6	4	10	0	12	22	0	0
13	37421625	.	T	A	10	3	13	0	2	15	0	0
13	37421642	.	C	A	10	3	13	0	1	14	0	0
13	38304824	.	A	G	6	8	14	0	1	15	0	0
13	38446709	.	A	G	11	1	12	0	20	32	0	0
13	38466196	.	G	A	16	12	28	0	1	29	0	0
13	38466247	.	C	T	14	12	26	0	0	26	0	0
13	38466343	.	T	C	15	10	25	0	0	25	0	0
13	38566611	.	A	G	14	0	14	0	19	33	0	0
13	38583699	.	C	A	25	20	45	0	1	46	0	0
13	38583714	.	A	G	19	19	38	0	2	40	0	0
13	38593559	.	A	G	24	21	45	0	0	45	0	0
13	38593574	.	A	T	23	27	50	0	0	50	0	0
13	38621607	.	G	T	2	2	4	0	0	4	0	0
13	38622184	.	C	T	1	11	12	0	6	18	0	0
13	38666128	.	G	A	16	20	36	0	0	36	0	0
13	38825356	.	G	A	0	2	2	0	1	3	0	0
13	38850031	.	G	A	1	2	3	0	0	3	0	0
13	39111051	.	G	A	2	3	5	0	0	5	0	0
13	39112210	.	C	T	2	3	5	1	0	6	0	0
13	39112211	.	A	G	2	3	5	1	0	6	0	0
13	39112434	.	C	T	3	4	7	0	0	7	0	0
13	39112612	.	G	A	1	2	3	0	4	7	0	0
13	39112664	.	T	C	1	5	6	0	0	6	0	0
13	39113101	.	G	T	1	3	4	0	1	5	0	0
13	39114474	.	G	T	4	3	7	0	0	7	0	0
13	39115454	.	A	T	3	2	5	0	1	6	0	0
13	39214527	.	A	G	5	3	8	0	2	10	0	0
13	39214557	.	G	A	6	4	10	0	0	10	0	0
13	39217377	.	C	T	5	10	15	0	1	16	0	0
13	39217506	.	C	T	8	4	12	0	0	12	0	0
13	39217657	.	C	T	6	7	13	0	2	15	0	0
13	39217887	.	T	G	10	0	10	0	5	15	0	0
13	39218060	.	T	C	5	8	13	0	1	14	0	0
13	39218097	.	A	G	7	6	13	0	2	15	0	0
13	39218133	.	C	A	7	3	10	0	0	10	0	0
13	39218292	.	C	T	6	5	11	0	0	11	0	0
13	39218602	.	A	G	14	0	14	0	11	25	0	0
13	39218706	.	T	C	6	9	15	0	1	16	0	0
13	39218843	.	G	A	2	13	15	0	10	25	0	0
13	39221960	.	T	C	11	11	22	0	2	24	0	0
13	39223774	.	A	G	13	6	19	0	0	19	0	0
13	39224003	.	C	T	10	12	22	0	0	22	0	0
13	39226666	.	T	C	10	17	27	1	0	28	0	0
13	39227275	.	G	A	1	9	10	0	18	28	0	0
13	39259356	.	A	G	1	2	3	0	0	3	0	0
13	39264005	.	A	G	4	2	6	0	0	6	0	0
13	39268057	.	T	C	5	2	7	0	0	7	0	0
13	39270032	.	A	T	4	5	9	0	0	9	0	0
13	39270178	.	A	G	1	5	6	0	0	6	0	0
13	39277927	.	G	T	0	2	2	0	2	4	0	0
13	39292392	.	T	C	2	2	4	0	0	4	0	0
13	39293300	.	T	A	4	3	7	0	0	7	0	0
13	39293304	.	A	C	3	3	6	0	1	7	0	0
13	39293338	.	T	A	3	4	7	0	0	7	0	0
13	39298967	.	A	T	3	2	5	0	0	5	0	0
13	39303122	.	T	C	4	2	6	0	1	7	0	0
13	39303161	.	A	C	4	2	6	0	0	6	0	0
13	39304213	.	A	G	4	2	6	0	0	6	0	0
13	39657068	.	A	G	8	5	13	0	2	15	0	0
13	39657156	.	T	G	2	6	8	0	0	8	0	0
13	39657285	.	T	C	4	5	9	0	0	9	0	0
13	39657625	.	A	C	8	7	15	0	1	16	0	0
13	39657652	.	A	G	7	6	13	0	2	15	0	0
13	40335087	.	T	G	9	9	18	0	1	19	0	0
13	40335135	.	T	G	8	0	8	0	9	17	0	0
13	40344258	.	C	T	10	11	21	0	0	21	0	0
13	40344303	.	G	A	1	7	8	0	10	18	0	0
13	40351869	.	G	A	13	15	28	0	1	29	0	0
13	40351914	.	G	A	0	15	15	0	13	28	0	0
13	40351953	.	C	T	10	7	17	0	2	19	0	0
13	40352345	.	C	T	5	11	16	0	2	18	0	0
13	40352349	.	C	G	7	11	18	0	0	18	0	0
13	40352415	.	T	G	8	15	23	0	1	24	0	0
13	40352476	.	A	G	13	8	21	0	0	21	0	0
13	40352830	.	A	G	16	6	22	0	0	22	0	0
13	40353512	.	G	T	13	12	25	0	0	25	0	0
13	40353736	.	A	C	12	5	17	0	1	18	0	0
13	40354235	.	C	T	4	3	7	0	0	7	0	0
13	40445253	.	C	T	34	19	53	1	3	57	0	0
13	40463048	.	T	A	9	7	16	0	0	16	0	0
13	40463116	.	C	T	3	4	7	0	0	7	0	0
13	40463242	.	T	G	2	3	5	0	0	5	0	0
13	40463310	.	C	A	2	5	7	0	0	7	0	0
13	40463732	.	C	T	2	7	9	0	11	20	0	0
13	40463784	.	G	C	7	0	7	0	10	17	0	0
13	40481324	.	A	T	14	8	22	0	0	22	0	0
13	40482568	.	T	A	8	9	17	0	0	17	0	0
13	40486656	.	G	A	7	6	13	0	0	13	0	0
13	40497631	.	G	A	7	10	17	0	0	17	0	0
13	40497802	.	A	G	12	7	19	0	0	19	0	0
13	40497928	.	C	T	6	6	12	0	1	13	0	0
13	40498129	.	C	G	0	7	7	0	5	12	0	0
13	40498267	.	A	G	9	7	16	0	0	16	0	0
13	40498294	.	G	A	7	8	15	0	1	16	0	0
13	40498630	.	G	A	6	7	13	0	0	13	0	0
13	40498759	.	G	A	4	5	9	0	0	9	0	0
13	40714418	.	C	T	2	2	4	0	0	4	0	0
13	40714660	.	T	C	2	2	4	0	0	4	0	0
13	40746915	.	T	A	3	2	5	0	0	5	0	0
13	40746930	.	C	A	0	2	2	0	3	5	0	0
13	40746971	.	G	T	2	3	5	0	2	7	0	0
13	40747151	.	T	C	3	3	6	0	1	7	0	0
13	40747256	.	T	A	7	5	12	0	0	12	0	0
13	40747274	.	T	C	6	0	6	0	7	13	0	0
13	40747337	.	T	A	11	5	16	0	0	16	0	0
13	40747397	.	C	A	9	6	15	0	0	15	0	0
13	40747398	.	C	A	9	6	15	0	0	15	0	0
13	40747467	.	C	T	0	3	3	0	1	4	0	0
13	40747607	.	G	T	6	4	10	0	0	10	0	0
13	40747791	.	G	C	3	3	6	0	0	6	0	0
13	40747839	.	T	C	4	2	6	0	0	6	0	0
13	40747841	.	T	C	4	0	4	0	2	6	0	0
13	40748074	.	A	G	5	5	10	0	0	10	0	0
13	40748246	.	A	C	8	10	18	0	0	18	0	0
13	40748248	.	C	A	6	10	16	0	1	17	0	0
13	40748310	.	T	G	6	7	13	0	1	14	0	0
13	40748356	.	G	T	9	5	14	0	0	14	0	0
13	40748408	.	C	T	4	5	9	0	0	9	0	0
13	40748431	.	G	A	3	6	9	0	0	9	0	0
13	40748582	.	G	A	3	2	5	0	0	5	0	0
13	40748620	.	C	T	3	3	6	0	0	6	0	0
13	40748621	.	T	A	2	3	5	0	0	5	0	0
13	40748999	.	A	C	4	4	8	0	0	8	0	0
13	40749082	.	T	C	3	2	5	0	0	5	0	0
13	40749104	.	T	C	4	2	6	0	0	6	0	0
13	40749191	.	A	G	1	2	3	0	0	3	0	0
13	40749445	.	G	A	4	4	8	0	0	8	0	0
13	40749577	.	G	A	6	10	16	0	1	17	0	0
13	40754367	.	T	G	9	7	16	0	0	16	0	0
13	40754433	.	A	T	7	9	16	0	1	17	0	0
13	40754441	.	G	T	6	7	13	0	0	13	0	0
13	40955042	.	T	C	1	4	5	0	0	5	0	0
13	41125475	.	C	T	4	8	12	0	0	12	0	0
13	41125652	.	C	T	2	4	6	0	1	7	0	0
13	41125766	.	A	G	8	9	17	0	0	17	0	0
13	41128286	.	G	A	9	11	20	0	0	20	0	0
13	41214782	.	A	G	4	2	6	0	0	6	0	0
13	41214812	.	G	A	5	5	10	0	0	10	0	0
13	41214863	.	G	A	8	6	14	0	1	15	0	0
13	41222908	.	G	A	2	5	7	0	0	7	0	0
13	41249277	.	T	C	3	4	7	1	0	8	0	0
13	41279989	.	G	A	4	4	8	0	0	8	0	0
13	41288990	.	A	G	3	6	9	0	0	9	0	0
13	41289189	.	T	C	1	6	7	0	1	8	0	0
13	41306803	.	G	T	3	4	7	0	1	8	0	0
13	41320070	.	G	C	4	4	8	0	0	8	0	0
13	41546577	.	G	T	3	2	5	0	0	5	0	0
13	41910428	.	G	A	7	4	11	0	0	11	0	0
13	41911090	.	G	A	29	12	41	0	0	41	0	0
13	41911092	.	C	A	12	28	40	0	0	41	1	0
13	41911265	.	G	A	10	13	23	0	0	23	0	0
13	41911276	.	T	C	6	16	22	0	1	23	0	0
13	41911402	.	T	A	22	7	29	1	0	30	0	0
13	41911597	.	G	T	21	7	28	0	0	28	0	0
13	41911771	.	A	G	17	4	21	0	0	21	0	0
13	41911788	.	C	T	11	4	15	0	1	17	1	0
13	41911932	.	A	G	8	15	23	0	1	24	0	0
13	41915604	.	A	G	16	23	39	0	2	41	0	0
13	41917003	.	C	A	9	7	16	0	0	16	0	0
13	41940198	.	G	A	0	2	2	0	4	6	0	0
13	41944446	.	T	G	8	4	12	0	0	12	0	0
13	41944479	.	G	A	2	4	6	1	0	7	0	0
13	41944815	.	C	A	0	6	6	0	5	11	0	0
13	41945455	.	C	T	7	7	14	0	1	15	0	0
13	41945464	.	C	T	0	5	5	0	8	13	0	0
13	41945632	.	C	T	1	4	5	0	8	13	0	0
13	41945737	.	A	G	8	3	11	0	0	11	0	0
13	41945762	.	T	A	5	4	9	0	0	9	0	0
13	41947874	.	C	T	4	3	7	0	0	7	0	0
13	41947882	.	C	T	0	3	3	0	5	8	0	0
13	42015495	.	T	C	3	3	6	0	0	6	0	0
13	42015954	.	T	A	4	1	5	0	1	6	0	0
13	42018012	.	C	T	7	6	13	0	1	14	0	0
13	42018048	.	A	G	7	0	7	0	5	12	0	0
13	42018175	.	A	C	2	2	4	0	0	4	0	0
13	42018304	.	A	T	4	2	6	0	0	6	0	0
13	42018394	.	T	C	1	3	4	0	0	4	0	0
13	42018558	.	G	A	0	2	2	0	2	4	0	0
13	42018734	.	G	T	6	4	10	0	0	10	0	0
13	42049465	.	A	C	4	5	9	0	0	9	0	0
13	42066135	.	T	C	4	0	4	0	7	11	0	0
13	42142194	.	C	A	8	16	24	0	0	24	0	0
13	42142296	.	T	C	11	5	16	0	0	16	0	0
13	42142854	.	G	A	15	6	21	0	2	23	0	0
13	42143118	.	G	A	0	4	4	0	11	15	0	0
13	42143285	.	A	T	13	10	23	0	1	24	0	0
13	42143294	.	T	G	11	13	24	0	2	26	0	0
13	42143572	.	T	A	1	3	4	0	0	4	0	0
13	42309890	.	C	A	2	3	5	0	1	6	0	0
13	42319544	.	G	A	8	9	17	0	0	17	0	0
13	42320084	.	G	C	5	5	10	0	0	10	0	0
13	42321191	.	C	T	8	6	14	0	1	15	0	0
13	42321831	.	G	A	3	3	6	0	1	7	0	0
13	42349499	.	C	T	5	5	10	0	0	10	0	0
13	42349683	.	C	T	8	4	12	0	0	12	0	0
13	42361795	.	A	G	19	10	29	0	2	31	0	0
13	42365043	.	A	G	12	13	25	0	0	25	0	0
13	42365121	.	T	C	13	12	25	0	0	25	0	0
13	42365139	.	T	C	11	0	11	0	13	24	0	0
13	42365374	.	C	T	9	19	28	0	1	29	0	0
13	42400391	.	T	A	17	7	24	0	0	24	0	0
13	42400473	.	C	T	9	15	24	0	2	26	0	0
13	42407519	.	C	T	7	10	17	0	1	18	0	0
13	42407526	.	A	G	7	10	17	0	0	17	0	0
13	42407618	.	A	C	7	6	13	0	0	13	0	0
13	42414459	.	A	G	11	5	16	0	0	16	0	0
13	42431007	.	A	G	4	6	10	0	0	10	0	0
13	42443487	.	T	C	5	6	11	0	0	11	0	0
13	42443517	.	T	C	8	7	15	0	0	15	0	0
13	42467430	.	T	C	9	9	18	0	1	19	0	0
13	42471886	.	A	C	9	8	17	0	0	17	0	0
13	42481169	.	T	C	8	6	14	0	0	14	0	0
13	42481256	.	A	G	8	14	22	0	0	22	0	0
13	42481267	.	G	A	7	12	19	0	0	19	0	0
13	42481306	.	T	C	8	11	19	0	0	19	0	0
13	42481512	.	A	G	9	13	22	0	0	22	0	0
13	42481538	.	A	G	10	17	27	0	0	27	0	0
13	42481575	.	T	C	11	12	23	0	3	26	0	0
13	42481599	.	A	G	9	11	20	0	1	21	0	0
13	42483050	.	A	G	10	16	26	1	1	28	0	0
13	42483082	.	A	G	9	14	23	1	1	25	0	0
13	42483089	.	T	C	9	15	24	1	1	26	0	0
13	42488440	.	C	T	9	5	14	0	1	15	0	0
13	42490778	.	T	C	11	5	16	0	0	16	0	0
13	42491448	.	C	T	2	4	6	0	4	10	0	0
13	42500370	.	A	G	6	2	8	0	0	8	0	0
13	42500513	.	A	T	7	4	11	0	0	12	1	0
13	42502659	.	T	A	6	3	9	0	0	9	0	0
13	42502713	.	T	C	3	7	10	0	0	10	0	0
13	42516915	.	C	G	0	6	6	0	8	14	0	0
13	42517113	.	C	T	6	5	11	0	0	11	0	0
13	42517188	.	G	A	3	2	5	0	0	5	0	0
13	42521407	.	T	C	3	0	3	0	4	7	0	0
13	42523723	.	A	T	5	11	16	0	0	16	0	0
13	42523951	.	A	G	5	12	17	0	0	17	0	0
13	42523969	.	G	C	4	5	9	0	2	11	0	0
13	42523987	.	T	C	3	4	7	0	0	7	0	0
13	42524107	.	C	T	4	4	8	0	0	8	0	0
13	42526316	.	C	T	0	7	7	0	7	14	0	0
13	42526376	.	C	T	4	4	8	0	0	8	0	0
13	42536843	.	T	C	4	2	6	0	0	6	0	0
13	42604301	.	A	C	1	3	4	0	0	4	0	0
13	42604325	.	C	T	2	3	5	0	0	5	0	0
13	42606862	.	T	G	1	5	6	0	0	6	0	0
13	42607276	.	C	G	4	3	7	0	0	7	0	0
13	42610900	.	C	T	2	4	6	0	0	6	0	0
13	42610961	.	A	T	3	4	7	0	0	7	0	0
13	42611019	.	T	C	2	5	7	0	0	7	0	0
13	42611117	.	G	C	1	4	5	0	1	6	0	0
13	42614968	.	G	T	0	2	2	0	2	4	0	0
13	42615073	.	T	G	5	5	10	0	0	10	0	0
13	42615094	.	G	A	4	5	9	0	0	9	0	0
13	42616301	.	A	C	2	2	4	0	0	4	0	0
13	42616527	.	C	A	3	2	5	0	0	5	0	0
13	42616563	.	T	C	1	3	4	0	2	6	0	0
13	42617552	.	C	T	1	2	3	0	0	3	0	0
13	42622006	.	C	T	7	3	10	0	0	10	0	0
13	42622013	.	C	T	8	1	9	0	1	10	0	0
13	42626622	.	C	T	1	3	4	0	5	9	0	0
13	42630536	.	C	T	0	2	2	0	1	3	0	0
13	42632966	.	A	G	5	6	11	0	0	11	0	0
13	42672885	.	T	G	5	7	12	0	0	12	0	0
13	42676262	.	T	A	10	12	22	0	0	22	0	0
13	42681759	.	G	T	5	6	11	0	0	11	0	0
13	42681856	.	T	G	10	12	22	0	0	22	0	0
13	42682033	.	T	A	9	13	22	1	0	23	0	0
13	42686420	.	G	T	4	6	10	0	0	10	0	0
13	42691482	.	G	T	2	7	9	0	0	9	0	0
13	42693030	.	G	A	6	6	12	0	0	12	0	0
13	42698930	.	A	T	7	9	16	0	0	16	0	0
13	42702811	.	T	G	5	5	10	0	1	11	0	0
13	42702835	.	T	C	5	7	12	0	1	13	0	0
13	42721011	.	G	A	3	7	10	0	1	11	0	0
13	42726908	.	T	C	1	2	3	0	0	3	0	0
13	42727448	.	T	G	1	2	3	0	0	3	0	0
13	43125335	.	G	T	1	2	3	0	0	3	0	0
13	43131829	.	A	G	1	5	6	0	0	6	0	0
13	43194272	.	C	T	2	1	3	0	0	3	0	0
13	43212717	.	A	G	2	1	3	0	2	5	0	0
13	43223679	.	G	A	7	11	18	0	0	18	0	0
13	43223722	.	T	G	17	16	33	0	1	34	0	0
13	43225093	.	C	T	16	16	32	0	2	34	0	0
13	43225201	.	T	C	15	0	15	0	13	28	0	0
13	43226423	.	T	A	20	18	38	0	3	41	0	0
13	43226429	.	C	T	1	14	15	0	23	38	0	0
13	43229872	.	A	C	22	16	38	0	1	39	0	0
13	43229923	.	G	A	25	14	39	0	0	39	0	0
13	43237237	.	T	C	12	11	23	0	0	23	0	0
13	43237255	.	A	C	9	0	9	0	11	20	0	0
13	43238513	.	C	A	19	17	36	0	1	37	0	0
13	44308161	.	T	C	6	0	6	0	6	12	0	0
13	44340254	.	C	T	4	8	12	0	0	12	0	0
13	44355466	.	C	A	3	4	7	0	0	7	0	0
13	44362302	.	T	C	4	0	4	0	4	8	0	0
13	44498566	.	T	C	3	3	6	0	0	6	0	0
13	44498613	.	T	A	3	2	5	0	0	5	0	0
13	44629358	.	C	T	2	2	4	0	0	4	0	0
13	44629360	.	G	A	1	2	3	0	0	3	0	0
13	44702469	.	T	C	16	2	18	0	12	30	0	0
13	44715290	.	G	A	17	15	32	0	3	35	0	0
13	44738328	.	G	A	17	18	35	0	1	36	0	0
13	44767765	.	T	C	14	7	21	0	1	22	0	0
13	44772073	.	A	G	12	5	17	0	0	17	0	0
13	44775714	.	G	A	5	4	9	0	0	9	0	0
13	44775895	.	C	T	0	10	10	0	6	16	0	0
13	44779071	.	A	G	6	7	13	0	1	14	0	0
13	44779083	.	A	G	9	9	18	0	1	19	0	0
13	44779107	.	C	T	8	9	17	0	0	17	0	0
13	44782267	.	T	C	9	6	15	0	0	15	0	0
13	44788358	.	G	A	4	3	7	0	0	7	0	0
13	44788361	.	T	A	4	3	7	0	0	7	0	0
13	44808582	.	A	C	23	0	23	0	14	37	0	0
13	44808632	.	A	G	17	13	30	0	0	30	0	0
13	44832437	.	T	A	1	3	4	0	0	4	0	0
13	44832508	.	A	C	1	3	4	0	0	4	0	0
13	44841248	.	T	C	2	3	5	0	0	5	0	0
13	44842810	.	G	T	8	4	12	0	0	12	0	0
13	44857163	.	T	C	2	2	4	8	2	14	0	0
13	44869386	.	G	T	6	4	10	0	2	12	0	0
13	44888282	.	C	T	7	12	19	0	0	19	0	0
13	44888358	.	T	A	8	3	11	0	0	11	0	0
13	44888363	.	A	T	9	2	11	0	0	11	0	0
13	45010064	.	A	G	11	9	20	1	1	22	0	0
13	45012835	.	A	T	18	30	48	1	0	49	0	0
13	45015355	.	A	T	27	19	46	0	3	49	0	0
13	45015443	.	T	C	19	27	46	0	2	48	0	0
13	45015503	.	T	C	15	23	38	0	1	39	0	0
13	45018600	.	A	G	32	39	71	0	14	85	0	0
13	45018732	.	G	A	31	43	74	0	14	88	0	0
13	45019001	.	A	C	28	1	29	0	40	69	0	0
13	45432170	.	A	G	21	9	30	0	0	30	0	0
13	45434952	.	T	G	17	20	37	0	2	39	0	0
13	45436554	.	A	G	16	13	29	0	2	31	0	0
13	45436561	.	G	T	14	19	33	0	2	35	0	0
13	45468567	.	A	T	14	46	60	3	2	65	0	0
13	45468827	.	G	C	31	0	31	0	33	64	0	0
13	45470601	.	A	G	26	27	53	2	3	58	0	0
13	45470815	.	A	T	24	24	48	0	0	48	0	0
13	45470926	.	G	C	15	17	32	0	3	35	0	0
13	45470983	.	A	G	10	11	21	0	1	22	0	0
13	45471052	.	A	G	5	15	20	0	1	21	0	0
13	45471086	.	T	A	19	5	24	0	1	25	0	0
13	45471243	.	G	A	21	25	46	0	1	47	0	0
13	45471367	.	A	T	29	15	44	0	0	44	0	0
13	45471475	.	C	A	20	13	33	0	1	34	0	0
13	45471669	.	C	T	35	24	59	0	2	61	0	0
13	45471888	.	C	T	0	19	19	0	20	39	0	0
13	45472124	.	T	G	10	10	20	0	0	20	0	0
13	45472215	.	G	C	28	26	54	0	1	55	0	0
13	45472653	.	G	A	37	27	64	0	2	66	0	0
13	45472924	.	G	A	54	35	89	0	3	92	0	0
13	45472954	.	G	A	55	32	87	0	1	88	0	0
13	45476360	.	A	C	22	10	32	0	0	32	0	0
13	45476711	.	C	T	22	14	36	0	2	38	0	0
13	45476731	.	A	T	15	20	35	0	5	40	0	0
13	45481475	.	G	A	16	17	33	0	0	33	0	0
13	45481703	.	G	T	8	9	17	0	0	17	0	0
13	45481740	.	A	G	7	3	10	0	0	10	0	0
13	45481792	.	A	G	2	3	5	0	1	6	0	0
13	45494912	.	G	C	18	15	33	0	2	35	0	0
13	45495227	.	C	A	24	19	43	0	1	44	0	0
13	45524500	.	T	C	11	13	24	0	0	24	0	0
13	45553072	.	G	A	9	15	24	0	0	24	0	0
13	45553168	.	G	A	17	4	21	0	0	21	0	0
13	45565508	.	C	T	16	11	27	0	0	27	0	0
13	45565637	.	G	A	16	13	29	0	1	30	0	0
13	45565646	.	G	A	1	16	17	0	14	31	0	0
13	45570300	.	A	C	10	5	15	0	1	16	0	0
13	45624693	.	G	T	2	2	4	0	0	4	0	0
13	45644646	.	G	A	2	2	4	0	0	4	0	0
13	45645118	.	G	C	2	0	2	0	1	3	0	0
13	45794475	.	C	T	3	4	7	0	0	7	0	0
13	45991772	.	T	C	17	33	50	0	1	51	0	0
13	45991801	.	C	T	18	25	43	0	4	47	0	0
13	45999530	.	G	A	2	17	19	0	16	35	0	0
13	45999723	.	C	T	19	11	30	0	6	36	0	0
13	46000060	.	G	A	0	2	2	1	3	6	0	0
13	46179340	.	C	T	37	28	65	0	2	67	0	0
13	46179387	.	C	T	37	28	65	0	2	67	0	0
13	46179392	.	G	A	35	28	63	0	3	66	0	0
13	46179806	.	T	A	29	31	60	0	1	61	0	0
13	46179814	.	A	G	26	31	57	0	1	58	0	0
13	46298734	.	G	A	5	6	11	0	1	12	0	0
13	46299812	.	C	T	0	8	8	0	5	13	0	0
13	46299827	.	A	G	5	8	13	0	0	13	0	0
13	46299873	.	T	A	3	3	6	0	0	6	0	0
13	46299875	.	T	G	3	3	6	0	0	6	0	0
13	46299934	.	G	A	5	3	8	0	0	8	0	0
13	46300224	.	T	A	4	4	8	0	0	8	0	0
13	46300247	.	A	T	3	4	7	0	1	8	0	0
13	46300259	.	T	G	4	6	10	0	0	10	0	0
13	46300421	.	C	T	12	8	20	0	0	20	0	0
13	46300450	.	C	T	8	4	12	0	0	12	0	0
13	46300694	.	T	A	9	6	15	0	1	16	0	0
13	46300737	.	G	A	14	15	29	0	0	29	0	0
13	46321988	.	C	T	0	2	2	0	3	5	0	0
13	46343432	.	T	C	4	1	5	0	8	13	0	0
13	46343471	.	G	A	3	3	6	0	0	6	0	0
13	46346306	.	G	A	8	5	13	0	0	13	0	0
13	46356661	.	G	T	2	3	5	0	0	5	0	0
13	46384311	.	A	G	3	2	5	1	1	7	0	0
13	46520845	.	T	C	2	3	5	0	0	5	0	0
13	46520924	.	T	C	6	7	13	0	0	13	0	0
13	46521542	.	C	T	0	4	4	0	5	9	0	0
13	46521633	.	G	A	7	9	16	0	2	18	0	0
13	46521664	.	C	A	10	6	16	0	1	17	0	0
13	46521762	.	T	A	7	7	14	0	2	16	0	0
13	46674815	.	A	G	1	2	3	0	1	4	0	0
13	46686936	.	T	C	4	3	7	1	3	11	0	0
13	46687008	.	C	G	5	5	10	0	0	10	0	0
13	46687037	.	G	T	6	5	11	1	0	12	0	0
13	46687086	.	G	A	3	3	6	1	0	7	0	0
13	46718745	.	A	G	2	5	7	0	0	7	0	0
13	46718871	.	A	C	11	6	17	0	0	17	0	0
13	46718930	.	T	C	11	7	18	0	0	18	0	0
13	46771366	.	A	C	5	13	18	0	0	18	0	0
13	46793193	.	G	A	0	6	6	0	3	9	0	0
13	46795515	.	G	A	3	18	21	0	14	35	0	0
13	46804112	.	G	A	3	4	7	0	0	7	0	0
13	46812107	.	C	T	2	3	5	0	0	5	0	0
13	46831698	.	C	T	1	5	6	0	4	10	0	0
13	46832084	.	A	G	3	5	8	1	0	9	0	0
13	46832104	.	A	G	2	2	4	1	1	6	0	0
13	46832471	.	A	C	11	6	17	0	0	17	0	0
13	46832724	.	C	A	2	5	7	0	11	18	0	0
13	46832981	.	A	T	3	4	7	1	0	8	0	0
13	46833050	.	C	G	6	8	14	0	0	14	0	0
13	46833064	.	C	T	5	7	12	0	0	12	0	0
13	46833197	.	A	G	3	5	8	0	0	8	0	0
13	46834005	.	T	C	6	2	8	0	0	8	0	0
13	46834020	.	T	C	4	4	8	0	0	8	0	0
13	46834054	.	T	C	2	6	8	0	0	8	0	0
13	46834112	.	A	G	2	2	4	0	1	5	0	0
13	46834124	.	A	G	2	2	4	0	0	4	0	0
13	46834414	.	T	C	5	3	8	0	0	8	0	0
13	46834415	.	T	C	4	4	8	0	0	8	0	0
13	46834504	.	G	A	1	3	4	0	0	4	0	0
13	46834550	.	G	A	2	2	4	0	0	4	0	0
13	46834860	.	T	A	5	6	11	0	0	11	0	0
13	46835270	.	C	G	4	5	9	0	0	9	0	0
13	46835304	.	C	T	5	9	14	0	0	14	0	0
13	46835344	.	C	T	7	7	14	0	0	14	0	0
13	46844205	.	G	A	4	7	11	0	2	13	0	0
13	46857629	.	A	T	7	8	15	0	1	16	0	0
13	46860158	.	T	C	1	0	1	0	3	4	0	0
13	46864873	.	C	A	0	6	6	0	4	10	0	0
13	46929067	.	G	T	0	2	2	0	2	4	0	0
13	46937002	.	T	C	0	2	2	0	1	3	0	0
13	46988299	.	C	T	10	11	21	0	0	21	0	0
13	46988390	.	T	C	18	0	18	0	14	32	0	0
13	46988457	.	C	A	2	16	18	0	15	33	0	0
13	46988561	.	A	G	13	16	29	0	1	30	0	0
13	46988588	.	A	G	12	19	31	0	0	31	0	0
13	46988638	.	T	G	13	24	37	0	0	37	0	0
13	46989607	.	C	T	2	12	14	0	26	40	0	0
13	47007223	.	C	A	3	4	7	0	0	7	0	0
13	47030514	.	A	G	3	3	6	0	0	6	0	0
13	47030991	.	T	C	5	3	8	0	0	8	0	0
13	47031092	.	T	C	3	2	5	0	0	5	0	0
13	47045212	.	G	T	2	2	4	0	0	4	0	0
13	47099738	.	C	T	2	3	5	0	0	5	0	0
13	47099900	.	A	T	5	7	12	0	1	13	0	0
13	47100347	.	C	T	3	4	7	0	0	7	0	0
13	47120091	.	T	C	3	2	5	0	0	5	0	0
13	47127266	.	T	C	1	5	6	0	0	6	0	0
13	47130927	.	A	G	6	0	6	0	5	11	0	0
13	47135882	.	C	T	5	4	9	1	0	10	0	0
13	47135885	.	G	A	0	4	4	1	5	10	0	0
13	47146860	.	C	T	3	4	7	0	1	8	0	0
13	47449795	.	A	G	3	3	6	0	0	6	0	0
13	47556049	.	G	C	2	3	5	0	0	5	0	0
13	47632363	.	T	C	2	2	4	0	0	4	0	0
13	47658070	.	C	T	1	2	3	0	0	3	0	0
13	47683807	.	T	C	3	2	5	0	0	5	0	0
13	47684293	.	T	C	2	4	6	0	0	6	0	0
13	47686970	.	C	T	1	2	3	0	0	3	0	0
13	47687088	.	G	A	5	5	10	0	0	10	0	0
13	47689136	.	T	C	3	3	6	0	1	7	0	0
13	47689220	.	C	T	1	3	4	0	0	4	0	0
13	47689564	.	A	G	1	2	3	0	0	3	0	0
13	47690269	.	A	T	4	5	9	0	0	9	0	0
13	47690300	.	A	T	1	7	8	0	0	8	0	0
13	47690329	.	T	A	1	8	9	0	0	9	0	0
13	47690766	.	T	C	3	1	4	0	0	4	0	0
13	47690779	.	G	A	0	2	2	0	4	6	0	0
13	47690826	.	A	G	4	2	6	0	0	6	0	0
13	47714064	.	T	C	2	6	8	0	0	8	0	0
13	47723765	.	C	T	6	5	11	0	0	11	0	0
13	47827308	.	C	T	3	4	7	0	0	7	0	0
13	47831531	.	T	C	2	4	6	0	0	6	0	0
13	47834276	.	C	A	5	6	11	0	1	13	1	0
13	47835638	.	G	T	4	3	7	0	0	7	0	0
13	47838024	.	G	A	7	6	13	0	2	15	0	0
13	47838052	.	G	A	0	12	12	0	7	19	0	0
13	47838650	.	G	C	3	6	9	0	1	10	0	0
13	47839071	.	C	T	5	10	15	0	0	15	0	0
13	47839119	.	A	T	4	10	14	0	0	14	0	0
13	48358753	.	C	A	1	2	3	0	0	3	0	0
13	48533161	.	A	G	5	1	6	0	1	7	0	0
13	48533227	.	T	C	1	2	3	0	2	5	0	0
13	48549008	.	C	T	4	2	6	0	0	6	0	0
13	48748637	.	A	G	1	5	6	0	0	6	0	0
13	48755122	.	T	C	12	10	22	0	0	22	0	0
13	48760628	.	C	T	1	2	3	0	1	4	0	0
13	48760634	.	G	T	1	2	3	0	0	3	0	0
13	48766270	.	C	T	6	6	12	0	0	12	0	0
13	49125153	.	A	G	1	2	3	0	0	3	0	0
13	49125165	.	T	C	1	2	3	0	0	3	0	0
13	49125243	.	C	T	0	2	2	0	2	4	0	0
13	49153904	.	T	C	4	7	11	0	0	11	0	0
13	49153938	.	G	A	7	4	11	0	1	12	0	0
13	49154048	.	G	A	11	5	16	0	2	18	0	0
13	49154631	.	T	C	13	0	13	0	12	25	0	0
13	49158734	.	G	A	8	6	14	0	0	14	0	0
13	49167185	.	T	G	12	7	19	0	1	20	0	0
13	49167195	.	C	T	11	6	17	0	0	17	0	0
13	49169071	.	A	T	7	11	18	0	1	19	0	0
13	49169121	.	G	C	9	7	16	0	0	16	0	0
13	49169455	.	C	A	1	5	6	0	4	10	0	0
13	49176036	.	T	C	1	2	3	0	0	3	0	0
13	49176144	.	C	T	6	3	9	0	0	9	0	0
13	49176171	.	T	C	3	2	5	0	0	5	0	0
13	49443721	.	C	T	16	33	49	0	2	51	0	0
13	49443868	.	T	C	27	1	28	0	28	56	0	0
13	49444090	.	C	T	23	22	45	0	2	47	0	0
13	49444177	.	C	A	2	27	29	0	22	51	0	0
13	49444224	.	G	A	24	21	45	0	0	45	0	0
13	49444446	.	C	A	15	18	33	0	0	33	0	0
13	49543145	.	A	T	1	2	3	0	1	4	0	0
13	49544509	.	C	T	0	6	6	0	3	9	0	0
13	49544833	.	C	T	13	26	39	0	2	41	0	0
13	49544873	.	T	A	14	26	40	0	1	41	0	0
13	49544973	.	G	T	19	18	37	0	1	38	0	0
13	49545039	.	A	G	25	19	44	1	2	47	0	0
13	49583976	.	A	G	17	23	40	0	3	43	0	0
13	49585341	.	T	A	24	14	38	0	2	40	0	0
13	49585344	.	A	T	24	15	39	0	1	40	0	0
13	49585384	.	T	G	10	7	17	0	0	17	0	0
13	49597297	.	C	T	1	10	11	0	5	16	0	0
13	49599521	.	G	A	6	7	13	0	0	13	0	0
13	49605897	.	T	C	7	0	7	0	3	10	0	0
13	49605904	.	A	G	7	3	10	0	0	10	0	0
13	49608888	.	T	C	2	4	6	0	1	7	0	0
13	49609056	.	T	C	4	0	4	0	4	8	0	0
13	49609268	.	C	T	5	2	7	0	1	8	0	0
13	49612336	.	C	T	4	4	8	0	2	10	0	0
13	49633362	.	G	T	3	10	13	0	1	14	0	0
13	49636115	.	G	T	5	6	11	0	2	13	0	0
13	49636240	.	C	T	5	2	7	0	1	8	0	0
13	49638771	.	A	G	4	3	7	1	0	8	0	0
13	49642805	.	G	T	4	4	8	0	0	8	0	0
13	49652927	.	C	T	3	3	6	0	0	6	0	0
13	49655691	.	C	T	4	7	11	0	0	11	0	0
13	49655695	.	C	T	5	7	12	0	0	12	0	0
13	49660026	.	A	G	1	4	5	0	0	5	0	0
13	49666565	.	T	C	4	6	10	0	0	10	0	0
13	49707868	.	A	T	3	4	7	0	0	7	0	0
13	49727448	.	A	G	4	6	10	0	1	11	0	0
13	49727463	.	T	G	3	4	7	0	0	7	0	0
13	49765806	.	C	T	4	4	8	0	0	8	0	0
13	49765815	.	G	T	1	3	4	0	3	7	0	0
13	49765896	.	T	C	5	6	11	0	0	11	0	0
13	49766022	.	T	C	9	7	16	0	0	16	0	0
13	49766268	.	G	A	1	5	6	0	8	14	0	0
13	49767539	.	A	G	12	6	18	0	1	19	0	0
13	49767570	.	G	A	12	5	17	0	1	18	0	0
13	49767736	.	T	G	7	7	14	0	1	15	0	0
13	49767806	.	T	A	3	6	9	0	1	10	0	0
13	49767807	.	G	T	3	7	10	0	0	10	0	0
13	49767953	.	T	A	3	9	12	0	0	12	0	0
13	49768095	.	A	G	11	8	19	0	0	19	0	0
13	49768207	.	C	T	12	5	17	0	0	17	0	0
13	49768401	.	C	T	11	10	21	0	0	21	0	0
13	49768402	.	A	C	10	9	19	0	2	21	0	0
13	49768592	.	A	T	5	2	7	0	3	10	0	0
13	49768646	.	A	G	6	5	11	0	0	11	0	0
13	49769060	.	C	T	9	9	18	0	2	20	0	0
13	49769141	.	G	C	6	11	17	0	1	18	0	0
13	49769274	.	G	A	0	3	3	0	3	6	0	0
13	49774893	.	G	T	3	2	5	0	0	5	0	0
13	49775075	.	T	G	4	4	8	0	1	9	0	0
13	49785412	.	C	T	5	5	10	0	1	12	1	0
13	49785417	.	T	C	4	7	11	0	2	13	0	0
13	49785455	.	C	G	6	3	9	0	0	9	0	0
13	49785456	.	A	G	6	3	9	0	0	9	0	0
13	49786114	.	A	G	8	12	20	0	1	21	0	0
13	49788102	.	A	T	4	8	12	0	1	13	0	0
13	49802010	.	C	A	7	4	11	0	0	11	0	0
13	49802025	.	T	G	4	4	8	0	1	9	0	0
13	49818982	.	A	G	9	11	20	0	0	20	0	0
13	49819001	.	C	A	0	13	13	0	7	20	0	0
13	49819019	.	A	G	7	12	19	0	1	20	0	0
13	49898458	.	G	T	6	3	9	0	0	9	0	0
13	49904236	.	T	C	7	4	11	0	0	11	0	0
13	49907480	.	A	G	5	7	12	0	2	14	0	0
13	49915484	.	C	A	4	2	6	0	0	6	0	0
13	49915580	.	A	G	8	3	11	0	0	11	0	0
13	49917748	.	T	C	8	5	13	0	0	13	0	0
13	49922904	.	A	G	4	6	10	0	0	10	0	0
13	49922970	.	C	T	0	4	4	0	7	11	0	0
13	49923176	.	T	C	5	4	9	0	0	9	0	0
13	49923678	.	C	A	6	5	11	0	1	12	0	0
13	49940894	.	C	A	5	3	8	0	0	8	0	0
13	49940936	.	C	T	0	3	3	0	3	6	0	0
13	50169004	.	C	T	13	10	23	1	3	27	0	0
13	50670846	.	A	T	11	6	17	0	2	19	0	0
13	50670911	.	G	C	12	9	21	1	1	23	0	0
13	50672297	.	T	C	7	0	7	0	11	18	0	0
13	50712066	.	G	T	4	9	13	0	0	13	0	0
13	50712093	.	T	C	2	5	7	0	1	8	0	0
13	50712125	.	A	G	4	7	11	0	0	11	0	0
13	50714876	.	T	G	3	3	6	0	0	6	0	0
13	50715024	.	G	C	3	3	6	0	0	6	0	0
13	50715121	.	A	G	1	8	9	0	1	10	0	0
13	50715123	.	T	A	1	9	10	0	0	10	0	0
13	50715205	.	A	G	4	8	12	0	0	12	0	0
13	50715615	.	T	C	7	0	7	0	6	13	0	0
13	50731324	.	C	T	3	4	7	0	0	7	0	0
13	51140665	.	A	G	20	12	32	0	4	36	0	0
13	51140782	.	A	G	26	12	38	0	1	39	0	0
13	51145614	.	T	G	37	10	47	1	3	51	0	0
13	51147152	.	G	A	27	14	41	0	0	41	0	0
13	51147164	.	A	G	27	12	39	0	0	39	0	0
13	51162561	.	A	G	20	6	26	0	0	26	0	0
13	51162579	.	T	G	18	5	23	0	0	23	0	0
13	51169874	.	C	G	16	13	29	1	1	31	0	0
13	51445956	.	G	A	0	3	3	0	1	4	0	0
13	51446019	.	G	A	1	3	4	0	0	4	0	0
13	51503093	.	T	A	6	2	8	0	0	8	0	0
13	51503141	.	G	A	4	2	6	0	0	6	0	0
13	51503524	.	G	A	7	3	10	0	1	11	0	0
13	51517001	.	G	A	5	2	7	0	0	7	0	0
13	51520086	.	C	T	3	2	5	0	0	5	0	0
13	51527065	.	A	T	2	2	4	0	0	4	0	0
13	51580096	.	G	T	1	10	11	0	8	19	0	0
13	51580105	.	T	C	9	11	20	0	0	20	0	0
13	51582341	.	T	A	1	3	4	0	0	4	0	0
13	51582507	.	T	G	5	2	7	0	0	7	0	0
13	51583019	.	C	A	10	7	17	0	1	18	0	0
13	51583043	.	T	C	12	7	19	0	0	19	0	0
13	51583130	.	A	G	10	0	10	0	12	22	0	0
13	51719661	.	G	C	13	9	22	0	1	23	0	0
13	51719767	.	A	C	7	15	22	0	1	23	0	0
13	51719850	.	G	A	0	10	10	0	11	21	0	0
13	51720057	.	T	C	5	3	8	0	0	8	0	0
13	51720126	.	C	A	6	12	18	0	1	19	0	0
13	51720291	.	A	G	15	0	15	0	12	27	0	0
13	51720993	.	G	C	1	9	10	0	10	20	0	0
13	51721143	.	T	C	8	14	22	0	0	22	0	0
13	51728782	.	C	G	10	8	18	0	0	18	0	0
13	51728902	.	A	C	7	8	15	0	0	15	0	0
13	51728937	.	A	G	11	10	21	0	2	23	0	0
13	51853916	.	C	G	2	2	4	0	0	4	0	0
13	51853950	.	A	T	3	2	5	0	0	5	0	0
13	51854014	.	T	C	3	2	5	0	0	5	0	0
13	51872081	.	C	T	6	2	8	0	0	8	0	0
13	51881119	.	G	A	1	3	4	0	3	7	0	0
13	51893777	.	A	T	15	6	21	0	2	23	0	0
13	51893807	.	C	T	16	7	23	0	0	23	0	0
13	51894204	.	C	T	20	11	31	2	3	36	0	0
13	51894215	.	A	G	22	13	35	2	2	39	0	0
13	51894264	.	C	T	1	8	9	1	32	42	0	0
13	51898991	.	C	G	23	11	34	0	2	36	0	0
13	51899138	.	C	T	3	15	18	0	15	33	0	0
13	51899707	.	C	T	18	10	28	0	0	28	0	0
13	51903040	.	A	G	9	6	15	14	0	29	0	0
13	51909851	.	G	T	5	2	7	0	1	8	0	0
13	51909876	.	A	G	6	3	9	0	0	9	0	0
13	51950882	.	G	A	3	4	7	0	0	7	0	0
13	51951038	.	T	C	3	1	4	0	3	7	0	0
13	51956414	.	T	C	4	10	14	0	0	14	0	0
13	51956418	.	G	A	6	12	18	0	0	18	0	0
13	51956482	.	C	G	13	8	21	0	0	21	0	0
13	51961780	.	T	C	9	9	18	0	0	18	0	0
13	51962017	.	G	T	11	6	17	1	0	18	0	0
13	51962211	.	C	T	14	7	21	0	0	21	0	0
13	51962754	.	G	A	2	7	9	0	10	19	0	0
13	51962802	.	G	A	10	5	15	0	0	15	0	0
13	51962836	.	A	G	5	2	7	0	0	10	3	0
13	51962892	.	C	A	12	10	22	0	0	22	0	0
13	51962961	.	C	G	10	10	20	0	1	21	0	0
13	51963383	.	C	T	8	7	15	0	1	16	0	0
13	51967129	.	C	T	0	2	2	0	4	6	0	0
13	51967149	.	T	C	4	0	4	0	4	8	0	0
13	51969086	.	G	C	3	5	8	0	0	8	0	0
13	51969156	.	G	A	2	2	4	0	0	4	0	0
13	51969219	.	A	G	2	4	6	0	0	6	0	0
13	51972910	.	C	T	1	2	3	0	2	5	0	0
13	52010605	.	G	A	0	2	2	0	3	5	0	0
13	52013739	.	T	C	6	4	10	0	0	10	0	0
13	52013766	.	C	T	5	2	7	0	0	7	0	0
13	52013908	.	T	A	5	2	7	0	0	7	0	0
13	52014050	.	C	T	5	2	7	0	1	8	0	0
13	52088918	.	T	A	3	2	5	0	0	5	0	0
14	548928	.	C	T	2	3	5	0	0	5	0	0
14	557761	.	A	G	1	2	3	0	0	3	0	0
14	565193	.	T	G	3	3	6	0	0	6	0	0
14	565260	.	A	T	2	4	6	0	0	6	0	0
14	565350	.	G	C	5	2	7	0	0	7	0	0
14	565354	.	T	A	6	2	8	0	0	8	0	0
14	567500	.	C	T	1	2	3	0	0	3	0	0
14	606255	.	A	G	7	13	20	0	3	23	0	0
14	616648	.	G	A	9	10	19	0	1	20	0	0
14	684179	.	G	A	19	24	43	0	0	43	0	0
14	696618	.	C	T	1	2	3	0	0	3	0	0
14	699317	.	G	A	1	2	3	0	0	3	0	0
14	699496	.	A	C	2	5	7	0	0	7	0	0
14	699646	.	C	T	1	4	5	0	4	9	0	0
14	712170	.	T	G	1	3	4	0	0	4	0	0
14	712194	.	G	A	4	4	8	0	0	8	0	0
14	712205	.	G	C	0	4	4	0	5	9	0	0
14	715123	.	G	C	5	7	12	0	0	12	0	0
14	715126	.	T	C	5	7	12	0	0	12	0	0
14	715201	.	C	T	4	8	12	0	1	13	0	0
14	715207	.	A	G	5	0	5	0	8	13	0	0
14	716714	.	C	T	3	3	6	0	0	6	0	0
14	717845	.	G	A	0	6	6	0	8	14	0	0
14	717927	.	G	A	4	6	10	0	3	13	0	0
14	718194	.	A	C	7	4	11	0	0	11	0	0
14	719447	.	A	G	5	8	13	0	0	13	0	0
14	719926	.	A	G	2	8	10	0	0	10	0	0
14	723539	.	T	C	8	6	14	0	0	14	0	0
14	723542	.	T	C	8	6	14	0	0	14	0	0
14	729870	.	G	T	0	6	6	0	1	7	0	0
14	757514	.	C	T	1	2	3	0	0	3	0	0
14	757534	.	G	T	3	2	5	0	0	5	0	0
14	757716	.	T	G	2	2	4	0	1	5	0	0
14	757817	.	A	T	2	3	5	0	0	5	0	0
14	790989	.	C	T	3	3	6	0	0	6	0	0
14	791067	.	C	G	6	0	6	0	5	11	0	0
14	791636	.	T	C	4	6	10	0	0	10	0	0
14	791696	.	T	A	6	4	10	0	0	10	0	0
14	791707	.	T	A	3	4	7	0	2	10	1	0
14	791913	.	A	T	3	2	5	0	0	5	0	0
14	791989	.	G	T	6	6	12	0	0	12	0	0
14	792133	.	C	A	5	3	8	0	0	8	0	0
14	792173	.	C	A	6	5	11	0	0	11	0	0
14	792499	.	C	G	1	0	1	0	7	8	0	0
14	792536	.	A	C	4	7	11	0	0	11	0	0
14	863418	.	T	A	1	4	5	0	0	5	0	0
14	863767	.	A	G	11	6	17	0	1	18	0	0
14	863807	.	A	T	16	8	24	0	1	25	0	0
14	863868	.	G	T	13	7	20	0	1	21	0	0
14	868838	.	G	A	12	17	29	0	1	30	0	0
14	868855	.	A	G	9	16	25	0	0	25	0	0
14	914602	.	G	C	2	1	3	0	1	4	0	0
14	919604	.	C	G	1	2	3	0	0	3	0	0
14	933257	.	G	A	0	2	2	0	1	3	0	0
14	937399	.	A	T	2	3	5	0	0	5	0	0
14	937749	.	G	C	1	3	4	0	0	4	0	0
14	937768	.	G	A	2	3	5	0	0	5	0	0
14	937789	.	T	A	2	4	6	0	1	7	0	0
14	937849	.	A	C	3	9	12	0	1	13	0	0
14	937937	.	C	T	0	3	3	0	7	10	0	0
14	937941	.	C	T	2	2	4	0	7	11	0	0
14	938290	.	C	A	2	2	4	0	0	4	0	0
14	938292	.	A	G	2	2	4	0	0	4	0	0
14	938441	.	T	G	1	2	3	0	0	3	0	0
14	938683	.	C	T	0	4	4	0	2	6	0	0
14	938688	.	T	C	2	4	6	0	0	6	0	0
14	938744	.	A	G	0	2	2	0	1	3	0	0
14	938939	.	T	A	3	2	5	2	0	7	0	0
14	939805	.	C	T	0	4	4	0	1	5	0	0
14	939813	.	T	C	1	4	5	0	0	5	0	0
14	940745	.	C	T	1	2	3	0	0	3	0	0
14	941345	.	G	C	2	3	5	0	0	5	0	0
14	941408	.	C	G	4	4	8	0	1	9	0	0
14	942140	.	T	A	1	3	4	0	0	4	0	0
14	942141	.	A	T	2	3	5	0	0	5	0	0
14	942337	.	T	C	2	0	2	0	5	7	0	0
14	942378	.	G	A	2	5	7	0	0	7	0	0
14	944384	.	G	A	1	3	4	0	0	4	0	0
14	944393	.	C	G	0	3	3	0	1	4	0	0
14	947412	.	T	C	2	4	6	0	1	7	0	0
14	994353	.	G	T	0	2	2	0	3	5	0	0
14	994413	.	C	T	5	5	10	0	0	10	0	0
14	994437	.	T	C	7	3	10	0	1	11	0	0
14	997203	.	A	G	5	5	10	0	0	10	0	0
14	997603	.	T	C	1	5	6	0	0	6	0	0
14	997853	.	C	T	2	3	5	0	0	5	0	0
14	1077094	.	T	C	1	0	1	0	3	4	0	0
14	1077097	.	T	C	1	2	3	0	1	4	0	0
14	1119141	.	C	T	5	5	10	0	1	11	0	0
14	1119225	.	C	T	5	5	10	0	2	12	0	0
14	1119423	.	A	G	6	1	7	0	6	13	0	0
14	1119432	.	T	C	7	6	13	0	2	15	0	0
14	1119993	.	T	C	4	7	11	0	0	11	0	0
14	1120017	.	T	C	7	6	13	0	0	13	0	0
14	1120072	.	C	A	12	6	18	0	0	18	0	0
14	1120154	.	T	C	3	12	15	0	1	16	0	0
14	1120178	.	C	T	7	10	17	0	0	17	0	0
14	1120196	.	T	G	8	0	8	0	7	15	0	0
14	1120236	.	C	T	6	4	10	0	0	10	0	0
14	1120364	.	T	A	1	5	6	0	1	7	0	0
14	1120452	.	G	T	0	2	2	0	2	4	0	0
14	1120598	.	T	C	3	3	6	0	0	6	0	0
14	1121029	.	A	G	3	7	10	0	0	10	0	0
14	1121297	.	T	G	4	4	8	0	0	8	0	0
14	1121303	.	G	C	4	4	8	0	0	8	0	0
14	1121413	.	C	T	2	2	4	0	0	4	0	0
14	1124602	.	C	G	6	9	15	0	1	16	0	0
14	1127693	.	G	A	5	10	15	0	1	16	0	0
14	1128800	.	C	G	14	6	20	0	1	21	0	0
14	1128836	.	A	C	10	4	14	0	0	14	0	0
14	1138611	.	C	A	13	9	22	0	0	22	0	0
14	1138626	.	G	A	2	10	12	0	12	24	0	0
14	1139509	.	C	T	12	7	19	0	0	19	0	0
14	1142796	.	G	A	0	5	5	0	7	12	0	0
14	1146630	.	G	A	6	8	14	0	0	14	0	0
14	1150594	.	A	G	10	12	22	0	1	23	0	0
14	1152544	.	C	A	16	12	28	0	1	29	0	0
14	1153665	.	T	C	11	9	20	0	0	20	0	0
14	1153830	.	T	A	8	9	17	0	1	18	0	0
14	1159869	.	A	G	15	2	17	0	7	24	0	0
14	1160333	.	C	T	5	5	10	1	2	13	0	0
14	1160427	.	T	G	9	9	18	0	0	18	0	0
14	1171023	.	T	C	10	8	18	0	0	18	0	0
14	1171052	.	T	A	9	10	19	0	3	22	0	0
14	1171081	.	T	A	11	9	20	0	1	21	0	0
14	1192448	.	G	A	3	8	11	0	2	13	0	0
14	1194090	.	C	T	1	9	10	0	7	17	0	0
14	1194133	.	G	A	5	6	11	0	2	13	0	0
14	1194154	.	C	T	0	6	6	0	7	13	0	0
14	1196568	.	C	G	6	8	14	0	0	14	0	0
14	1196658	.	T	G	5	5	10	0	0	10	0	0
14	1200460	.	T	G	8	5	13	0	1	14	0	0
14	1200545	.	G	T	9	6	15	0	0	15	0	0
14	1200842	.	A	C	2	3	5	0	0	5	0	0
14	1203713	.	A	G	21	17	38	0	2	40	0	0
14	1203770	.	G	T	19	21	40	0	2	42	0	0
14	1204197	.	A	T	14	21	35	0	3	38	0	0
14	1204299	.	G	A	19	11	30	0	1	31	0	0
14	1225227	.	C	T	2	7	9	0	10	19	0	0
14	1947442	.	G	T	6	2	8	0	0	8	0	0
14	1947457	.	G	A	6	2	8	0	1	9	0	0
14	1952803	.	C	T	4	2	6	9	0	15	0	0
14	1956470	.	C	T	9	3	12	0	1	13	0	0
14	1957767	.	C	T	0	3	3	0	2	5	0	0
14	1962066	.	G	A	1	2	3	0	0	3	0	0
14	2120926	.	A	T	1	5	6	0	1	7	0	0
14	2189879	.	G	T	3	3	6	0	0	6	0	0
14	2191034	.	G	A	4	1	5	1	1	7	0	0
14	2203092	.	T	C	2	4	6	0	0	6	0	0
14	2205282	.	G	A	1	3	4	0	0	4	0	0
14	2205444	.	T	C	2	7	9	0	0	9	0	0
14	2205456	.	G	A	2	6	8	0	0	8	0	0
14	2205747	.	A	G	1	3	4	0	0	4	0	0
14	2208732	.	C	T	3	2	5	0	0	5	0	0
14	2212826	.	C	A	2	7	9	0	3	12	0	0
14	2213043	.	C	A	3	3	6	0	0	6	0	0
14	2220068	.	A	G	3	2	5	0	0	5	0	0
14	2220101	.	C	T	3	4	7	0	0	7	0	0
14	2262917	.	A	G	2	2	4	0	0	4	0	0
14	2264144	.	C	T	2	4	6	0	0	6	0	0
14	2264174	.	A	T	1	2	3	0	0	3	0	0
14	2266081	.	A	T	1	3	4	0	0	4	0	0
14	2266082	.	G	A	1	3	4	0	0	4	0	0
14	2351565	.	A	T	3	14	17	3	0	20	0	0
14	2351566	.	G	T	3	14	17	3	0	20	0	0
14	2352280	.	T	G	6	9	15	3	1	19	0	0
14	2356447	.	G	A	5	2	7	9	0	16	0	0
14	2356450	.	G	A	5	2	7	9	0	16	0	0
14	2360116	.	T	A	9	15	24	3	1	28	0	0
14	2384096	.	T	G	9	4	13	0	1	14	0	0
14	3451164	.	C	A	13	5	18	0	0	18	0	0
14	3451169	.	T	C	12	4	16	0	1	17	0	0
14	3576058	.	A	T	9	21	30	3	5	44	6	0
14	4193335	.	A	G	0	2	2	0	0	2	0	0
14	4193501	.	T	C	4	2	6	0	1	7	0	0
14	4212233	.	G	A	1	5	6	0	0	6	0	0
14	4292163	.	A	G	7	3	10	0	1	11	0	0
14	4810824	.	A	G	2	0	2	0	6	8	0	0
14	4813124	.	A	G	4	2	6	0	0	6	0	0
14	4813280	.	A	G	7	0	7	0	5	12	0	0
14	6332872	.	T	C	9	6	15	1	0	17	1	0
14	6333022	.	T	C	6	4	10	0	0	10	0	0
14	6624558	.	A	G	19	0	19	0	14	33	0	0
14	6624562	.	A	G	18	0	18	0	12	31	1	0
14	6624621	.	A	G	9	23	32	0	0	32	0	0
14	6625002	.	A	C	36	9	45	6	3	54	0	0
14	6625521	.	G	C	21	29	50	2	5	57	0	0
14	6625794	.	A	G	4	17	21	0	1	22	0	0
14	6625805	.	A	G	20	10	30	1	0	31	0	0
14	7170558	.	T	C	4	11	15	0	0	15	0	0
14	7170559	.	T	C	2	12	14	0	1	15	0	0
14	7916052	.	A	G	4	2	6	0	0	6	0	0
14	7916066	.	A	G	3	2	5	0	0	5	0	0
14	7917641	.	A	G	6	0	6	0	6	12	0	0
14	8495668	.	A	T	3	3	6	1	0	7	0	0
14	8496257	.	A	G	2	2	4	1	0	5	0	0
14	8569537	.	A	G	4	1	5	0	0	5	0	0
14	8569554	.	A	G	3	4	7	0	0	7	0	0
14	8572084	.	A	G	8	3	11	0	0	11	0	0
14	8770425	.	A	G	6	2	8	0	0	8	0	0
14	8770436	.	A	C	7	5	12	0	0	12	0	0
14	8770589	.	C	T	1	7	8	0	1	9	0	0
14	8770931	.	T	A	2	2	4	0	0	4	0	0
14	8806587	.	A	C	5	0	5	0	3	8	0	0
14	8806590	.	A	G	5	2	7	0	0	7	0	0
14	8806680	.	T	C	11	7	18	0	1	19	0	0
14	8806722	.	A	G	13	7	20	0	0	20	0	0
14	8806730	.	G	T	13	6	19	0	1	20	0	0
14	8809693	.	A	G	12	11	23	1	4	28	0	0
14	8816113	.	T	C	5	3	8	0	0	8	0	0
14	8816135	.	A	T	6	3	9	0	1	10	0	0
14	8816194	.	C	T	6	7	13	0	0	13	0	0
14	8816261	.	G	A	11	3	14	0	0	14	0	0
14	8816283	.	T	G	9	6	15	0	2	17	0	0
14	8816339	.	A	G	6	9	15	0	0	15	0	0
14	8816457	.	A	G	4	7	11	0	0	11	0	0
14	8816482	.	A	T	6	7	13	0	0	13	0	0
14	8816695	.	C	G	3	5	8	0	0	8	0	0
14	8816755	.	A	C	8	1	9	0	5	14	0	0
14	8816782	.	G	A	11	7	18	0	1	19	0	0
14	8816848	.	A	G	7	11	18	2	0	20	0	0
14	8816877	.	C	A	0	5	5	2	8	15	0	0
14	8821677	.	G	A	5	9	14	0	1	15	0	0
14	8830236	.	G	T	6	9	15	0	3	18	0	0
14	8830302	.	C	T	1	11	12	0	10	22	0	0
14	8832736	.	A	C	7	8	15	0	1	16	0	0
14	8836160	.	G	A	4	11	15	0	0	15	0	0
14	8836298	.	T	C	12	6	18	0	0	18	0	0
14	8839175	.	T	C	7	0	7	0	3	10	0	0
14	8841352	.	A	T	7	16	23	0	4	27	0	0
14	8844045	.	G	A	8	4	12	0	0	12	0	0
14	8849119	.	T	C	5	4	9	0	0	9	0	0
14	8849344	.	A	G	1	2	3	0	0	3	0	0
14	8860702	.	G	A	1	6	7	0	0	7	0	0
14	8862221	.	G	T	5	3	8	0	1	9	0	0
14	8868956	.	C	T	0	4	4	0	3	7	0	0
14	8870967	.	C	G	2	5	7	0	0	7	0	0
14	8882437	.	T	C	2	0	2	0	6	8	0	0
14	8882464	.	C	T	5	4	9	0	0	9	0	0
14	8947464	.	A	T	8	12	20	0	2	22	0	0
14	8947497	.	C	A	14	14	28	0	0	28	0	0
14	8951108	.	A	G	5	0	5	0	7	12	0	0
14	8982390	.	C	T	16	14	30	0	0	30	0	0
14	8991718	.	A	T	14	13	27	0	2	29	0	0
14	8991823	.	T	C	16	11	27	0	0	27	0	0
14	9001411	.	G	A	12	13	25	0	0	25	0	0
14	9001426	.	C	T	12	16	28	0	0	28	0	0
14	9001752	.	C	G	11	0	11	0	10	21	0	0
14	9001875	.	T	C	9	15	24	0	3	27	0	0
14	9034114	.	A	G	3	6	9	0	0	9	0	0
14	9034128	.	T	G	2	8	10	0	0	10	0	0
14	9034161	.	C	T	2	6	8	0	1	9	0	0
14	9034307	.	G	A	7	5	12	0	1	13	0	0
14	9034430	.	T	C	10	8	18	0	0	18	0	0
14	9034544	.	T	C	6	0	6	0	9	15	0	0
14	9034591	.	G	T	7	3	10	0	0	10	0	0
14	9034701	.	C	T	0	10	10	0	8	18	0	0
14	9034742	.	C	T	9	6	15	0	2	17	0	0
14	9034743	.	T	C	10	0	10	0	7	17	0	0
14	9034932	.	A	G	13	6	19	0	0	19	0	0
14	9035051	.	C	G	10	6	16	0	1	17	0	0
14	9035100	.	C	T	6	9	15	0	1	16	0	0
14	9035110	.	C	T	0	7	7	0	10	17	0	0
14	9035175	.	G	A	6	6	12	0	0	12	0	0
14	9035249	.	G	T	2	6	8	0	2	10	0	0
14	9035337	.	A	C	2	2	4	0	0	4	0	0
14	9035541	.	C	T	0	2	2	0	1	3	0	0
14	9035740	.	A	G	6	7	13	0	0	13	0	0
14	9035786	.	C	G	5	5	10	0	0	10	0	0
14	9035866	.	A	G	9	4	13	0	0	13	0	0
14	9035873	.	T	C	8	4	12	0	1	13	0	0
14	9036219	.	A	T	2	9	11	0	0	11	0	0
14	9036255	.	T	C	2	3	5	0	0	5	0	0
14	9036480	.	C	T	5	5	10	0	0	10	0	0
14	9036624	.	C	T	2	5	7	0	2	9	0	0
14	9040928	.	C	A	13	11	24	0	0	24	0	0
14	9050440	.	G	C	11	0	11	0	10	21	0	0
14	9142412	.	A	T	7	5	12	0	1	13	0	0
14	9142602	.	A	T	20	19	39	0	1	40	0	0
14	9142795	.	T	C	17	16	33	0	0	33	0	0
14	9142893	.	T	C	22	0	22	0	17	39	0	0
14	9142911	.	T	C	19	0	19	0	15	34	0	0
14	9142952	.	C	T	1	13	14	0	13	27	0	0
14	9143081	.	G	C	31	0	31	0	17	48	0	0
14	9143150	.	A	C	22	0	22	2	13	37	0	0
14	9143179	.	C	T	1	10	11	4	25	40	0	0
14	9143427	.	A	T	17	19	36	0	2	38	0	0
14	9143446	.	T	C	13	0	13	0	17	30	0	0
14	9143878	.	T	C	22	23	45	2	1	48	0	0
14	9144099	.	T	C	20	18	38	0	2	40	0	0
14	9144191	.	A	G	19	12	31	1	2	34	0	0
14	9144248	.	A	G	15	9	24	0	0	24	0	0
14	9144361	.	A	G	8	6	14	0	0	14	0	0
14	9144658	.	A	G	5	13	18	0	0	18	0	0
14	9145050	.	G	A	21	18	39	1	2	42	0	0
14	9157880	.	T	A	20	14	34	1	1	36	0	0
14	9158367	.	A	G	19	11	30	1	0	31	0	0
14	9159845	.	A	G	13	22	35	1	1	37	0	0
14	9159860	.	G	C	10	0	10	1	24	35	0	0
14	9163286	.	G	A	18	24	42	0	2	44	0	0
14	9173909	.	C	T	19	20	39	0	3	42	0	0
14	9177619	.	G	A	23	22	45	0	0	45	0	0
14	9344247	.	G	A	8	5	13	0	0	13	0	0
14	9344250	.	C	T	6	4	10	0	2	12	0	0
14	9344366	.	T	G	7	10	17	0	1	18	0	0
14	9405178	.	A	G	1	2	3	0	0	3	0	0
14	9405570	.	T	A	4	5	9	0	0	9	0	0
14	9405571	.	G	C	4	5	9	0	0	9	0	0
14	9405760	.	T	C	6	2	8	0	0	8	0	0
14	9405927	.	C	T	3	4	7	0	1	9	1	0
14	9405940	.	A	C	3	5	8	0	1	9	0	0
14	9406070	.	A	G	2	3	5	0	0	5	0	0
14	9406320	.	T	C	7	0	7	0	13	20	0	0
14	9406453	.	A	T	6	7	13	0	0	13	0	0
14	9406485	.	A	G	7	11	18	0	0	18	0	0
14	9406509	.	T	C	8	9	17	0	1	18	0	0
14	9406607	.	T	C	12	7	19	0	0	19	0	0
14	9406773	.	T	A	3	6	9	0	1	10	0	0
14	9406791	.	A	G	3	10	13	0	0	13	0	0
14	9407074	.	A	T	6	5	11	0	0	11	0	0
14	9407707	.	C	T	5	7	12	0	1	13	0	0
14	9407763	.	A	G	7	9	16	0	0	16	0	0
14	9407791	.	G	A	3	5	8	0	0	8	0	0
14	9408019	.	C	T	4	3	7	0	0	7	0	0
14	9408260	.	C	G	7	10	17	0	0	17	0	0
14	9408320	.	T	G	5	13	18	0	1	19	0	0
14	9420810	.	G	A	6	8	14	0	0	14	0	0
14	9420871	.	C	A	5	4	9	0	0	9	0	0
14	9421583	.	A	G	2	4	6	0	0	6	0	0
14	9421608	.	C	A	2	3	5	0	1	6	0	0
14	9421644	.	C	T	2	2	4	0	1	5	0	0
14	9469615	.	A	G	3	4	7	0	0	7	0	0
14	9475490	.	G	C	4	4	8	0	0	8	0	0
14	9475716	.	A	T	0	2	2	0	0	2	0	0
14	9475717	.	G	T	1	2	3	0	0	3	0	0
14	9481518	.	C	T	6	8	14	0	0	14	0	0
14	9481554	.	G	A	6	10	16	0	0	16	0	0
14	9481647	.	C	A	3	9	12	0	0	12	0	0
14	9481924	.	C	T	5	4	9	0	0	9	0	0
14	9481926	.	G	T	5	3	8	0	1	9	0	0
14	9482062	.	A	G	2	4	6	0	0	6	0	0
14	9485121	.	A	T	9	7	16	0	1	17	0	0
14	9485366	.	T	A	6	11	17	0	0	17	0	0
14	9494939	.	A	G	9	0	9	0	9	18	0	0
14	9495107	.	G	A	1	12	13	0	9	22	0	0
14	9498163	.	C	T	14	6	20	0	0	20	0	0
14	9498308	.	G	A	4	2	6	0	0	6	0	0
14	9498570	.	C	T	5	7	12	0	0	12	0	0
14	9498728	.	A	T	5	3	8	0	0	8	0	0
14	9498841	.	C	G	9	6	15	0	0	15	0	0
14	9498879	.	T	A	13	7	20	0	0	20	0	0
14	9499048	.	G	T	4	7	11	0	0	11	0	0
14	9508186	.	T	C	2	3	5	0	0	5	0	0
14	9508272	.	G	C	2	2	4	0	0	4	0	0
14	9516565	.	C	T	1	2	3	0	2	5	0	0
14	9521905	.	A	C	5	0	5	0	3	8	0	0
14	9581982	.	G	A	2	2	4	0	0	4	0	0
14	9583914	.	T	C	6	5	11	0	0	11	0	0
14	9584592	.	C	T	4	2	6	0	0	6	0	0
14	9584653	.	C	T	1	3	4	0	0	4	0	0
14	9584685	.	T	C	2	2	4	0	0	4	0	0
14	9587639	.	A	G	2	5	7	0	0	7	0	0
14	9587796	.	G	C	3	2	5	0	0	5	0	0
14	9588102	.	T	A	1	2	3	0	0	3	0	0
14	9588210	.	G	A	0	2	2	0	2	4	0	0
14	9588221	.	G	C	1	3	4	0	0	4	0	0
14	9589627	.	C	T	1	3	4	0	1	5	0	0
14	9589719	.	G	A	3	3	6	0	2	8	0	0
14	9589731	.	G	T	2	3	5	0	3	8	0	0
14	9590879	.	G	A	4	2	6	0	0	6	0	0
14	9590909	.	A	G	3	2	5	0	0	5	0	0
14	9593273	.	T	A	1	1	2	0	1	3	0	0
14	9593505	.	A	G	20	17	37	0	3	40	0	0
14	9593610	.	T	A	17	15	32	0	0	32	0	0
14	9593622	.	A	T	12	15	27	0	1	28	0	0
14	9593974	.	C	T	25	8	33	0	2	35	0	0
14	9594466	.	G	A	7	12	19	0	1	20	0	0
14	9594577	.	C	T	13	9	22	0	0	22	0	0
14	9594578	.	A	G	13	8	21	0	1	22	0	0
14	9594623	.	C	T	15	7	22	0	1	23	0	0
14	9594677	.	G	C	12	7	19	0	1	20	0	0
14	9595086	.	A	C	17	9	26	0	1	27	0	0
14	9595119	.	G	A	11	19	30	0	0	30	0	0
14	9595330	.	T	C	15	9	24	0	0	24	0	0
14	9595401	.	A	G	7	5	12	0	0	12	0	0
14	9595493	.	G	T	8	10	18	0	0	18	0	0
14	9595528	.	T	C	9	5	14	0	0	14	0	0
14	9595593	.	T	G	5	7	12	0	2	14	0	0
14	9595890	.	C	T	11	13	24	0	0	24	0	0
14	9595992	.	C	A	17	11	28	0	2	30	0	0
14	9596338	.	C	T	16	12	28	0	0	28	0	0
14	9622931	.	G	A	1	2	3	0	0	3	0	0
14	9647821	.	G	A	1	2	3	0	0	3	0	0
14	9647824	.	A	G	1	2	3	0	0	3	0	0
14	9651354	.	C	T	0	2	2	0	1	3	0	0
14	9653431	.	A	G	1	2	3	0	0	3	0	0
14	9717978	.	C	A	0	7	7	0	6	13	0	0
14	9739987	.	G	T	6	7	13	0	0	13	0	0
14	9821794	.	C	T	0	5	5	1	2	8	0	0
14	10321808	.	G	A	2	4	6	0	0	6	0	0
14	10321809	.	G	A	2	4	6	0	0	6	0	0
14	10339032	.	G	A	3	2	5	0	0	5	0	0
14	10339081	.	T	G	6	4	10	0	0	10	0	0
14	10339325	.	T	G	1	1	2	0	0	2	0	0
14	10339333	.	T	G	1	2	3	0	0	3	0	0
14	10339768	.	G	A	12	17	29	0	0	29	0	0
14	10339883	.	A	C	15	17	32	0	0	32	0	0
14	10339943	.	A	G	16	8	24	0	1	25	0	0
14	10340068	.	G	A	11	14	25	0	1	26	0	0
14	10340096	.	G	A	11	13	24	0	1	25	0	0
14	10340189	.	T	A	11	9	20	0	1	21	0	0
14	10340193	.	C	G	13	8	21	0	0	21	0	0
14	10340250	.	A	T	14	5	19	0	0	19	0	0
14	10340288	.	C	A	11	8	19	0	1	20	0	0
14	10340358	.	G	A	10	8	18	0	1	19	0	0
14	10340606	.	A	G	18	10	28	0	2	30	0	0
14	10340642	.	T	A	18	6	24	0	2	26	0	0
14	10340840	.	C	A	14	16	30	0	1	31	0	0
14	10341076	.	T	C	10	3	13	1	0	14	0	0
14	10341237	.	A	T	4	8	12	0	0	12	0	0
14	10341293	.	C	T	5	3	8	0	0	8	0	0
14	10341586	.	C	T	2	5	7	0	16	23	0	0
14	10341627	.	A	T	16	6	22	0	0	22	0	0
14	10341690	.	G	T	11	9	20	0	0	20	0	0
14	10341703	.	T	C	11	0	11	0	10	21	0	0
14	10341966	.	A	C	9	9	18	0	1	19	0	0
14	10342246	.	G	T	7	6	13	0	0	13	0	0
14	10342379	.	A	C	12	0	12	0	10	22	0	0
14	10342570	.	G	A	7	10	17	0	0	17	0	0
14	10342591	.	C	A	0	14	14	0	9	23	0	0
14	10342726	.	A	G	9	7	16	0	0	16	0	0
14	10342926	.	G	A	12	5	17	0	0	17	0	0
14	10342929	.	T	A	13	3	16	0	0	16	0	0
14	10342971	.	G	T	16	6	22	0	0	22	0	0
14	10343112	.	C	T	5	10	15	0	0	15	0	0
14	10343180	.	T	A	4	2	6	0	0	6	0	0
14	10343210	.	A	T	4	3	7	0	0	7	0	0
14	10343232	.	T	C	4	2	6	0	0	6	0	0
14	10343678	.	A	T	8	7	15	0	0	15	0	0
14	10343686	.	T	C	7	0	7	0	7	14	0	0
14	10343866	.	G	A	7	9	16	0	0	16	0	0
14	10344032	.	A	C	9	5	14	0	0	14	0	0
14	10344075	.	C	A	10	5	15	0	0	15	0	0
14	10344218	.	G	A	4	7	11	0	1	12	0	0
14	10344451	.	C	T	12	6	18	0	0	18	0	0
14	10348091	.	T	C	6	10	16	0	2	18	0	0
14	10356522	.	A	G	12	11	23	0	3	26	0	0
14	10356817	.	A	C	7	0	7	0	4	11	0	0
14	10356826	.	G	C	7	4	11	0	0	11	0	0
14	10365369	.	A	T	8	3	11	0	1	12	0	0
14	10365510	.	T	C	6	12	18	0	0	18	0	0
14	10379652	.	G	A	6	4	10	0	0	10	0	0
14	10384529	.	C	T	3	2	5	0	0	5	0	0
14	10384607	.	T	A	3	3	6	0	0	6	0	0
14	10987761	.	C	A	3	6	9	0	1	10	0	0
14	11002504	.	T	C	4	7	11	0	0	11	0	0
14	11022903	.	T	A	4	7	11	0	1	12	0	0
14	11048599	.	A	G	9	3	12	0	0	12	0	0
14	11050650	.	C	T	6	5	11	0	0	11	0	0
14	11053934	.	G	C	7	3	10	0	0	10	0	0
14	11069560	.	C	T	5	9	14	0	0	14	0	0
14	11069593	.	C	T	7	8	15	0	0	15	0	0
14	11069774	.	G	A	5	6	11	0	0	11	0	0
14	11234718	.	G	A	6	4	10	0	0	10	0	0
14	11261691	.	C	T	9	10	19	0	0	19	0	0
14	11261718	.	T	C	9	9	18	0	0	18	0	0
14	11262084	.	T	C	9	5	14	0	0	14	0	0
14	11262733	.	C	T	4	11	15	0	2	17	0	0
14	11262765	.	C	A	6	4	10	0	4	14	0	0
14	11263084	.	C	G	5	9	14	0	1	15	0	0
14	11263096	.	C	A	8	6	14	0	0	14	0	0
14	11263147	.	G	A	1	6	7	0	3	10	0	0
14	11263479	.	T	A	10	4	14	0	0	14	0	0
14	11263899	.	A	G	7	0	7	1	5	13	0	0
14	11264058	.	C	T	3	5	8	0	1	9	0	0
14	11264726	.	A	T	7	11	18	1	0	20	1	0
14	11265310	.	A	G	5	7	12	0	1	13	0	0
14	11265312	.	T	C	8	7	15	0	0	15	0	0
14	11265516	.	T	A	3	2	5	3	0	8	0	0
14	11265567	.	C	T	7	9	16	0	0	16	0	0
14	11265966	.	A	G	1	5	6	0	0	6	0	0
14	11266644	.	A	T	7	7	14	1	0	15	0	0
14	11267900	.	A	T	12	15	27	0	1	28	0	0
14	11268145	.	G	A	3	3	6	0	0	6	0	0
14	11290986	.	T	C	8	6	14	0	3	17	0	0
14	11299563	.	G	A	1	4	5	0	3	8	0	0
14	11300058	.	T	C	7	8	15	0	1	16	0	0
14	11300154	.	G	A	5	5	10	0	0	10	0	0
14	11300179	.	T	G	7	4	11	0	1	12	0	0
14	11300238	.	G	A	8	8	16	0	0	16	0	0
14	11300298	.	C	T	10	7	17	0	1	18	0	0
14	11301027	.	G	A	13	14	27	0	1	28	0	0
14	11301069	.	A	G	15	0	15	0	13	28	0	0
14	11302190	.	C	A	4	9	13	0	0	13	0	0
14	11302392	.	G	A	1	5	6	0	1	7	0	0
14	11302427	.	T	G	2	0	2	0	7	9	0	0
14	11302492	.	G	A	5	3	8	0	0	8	0	0
14	11302518	.	A	G	5	2	7	0	0	7	0	0
14	11302565	.	T	A	1	3	4	0	0	4	0	0
14	11303025	.	A	G	2	0	2	0	5	7	0	0
14	11303231	.	T	C	1	3	4	0	1	5	0	0
14	11303819	.	T	G	2	4	6	0	0	6	0	0
14	11397740	.	G	C	1	3	4	0	0	4	0	0
14	12021308	.	C	G	3	3	6	0	1	7	0	0
14	12021366	.	T	C	6	4	10	0	0	10	0	0
14	12021550	.	T	C	2	2	4	0	0	4	0	0
14	12021610	.	T	G	3	2	5	0	0	5	0	0
14	12021926	.	A	T	8	8	16	0	0	16	0	0
14	12022056	.	C	T	9	8	17	0	0	17	0	0
14	12036538	.	C	G	6	12	18	0	0	18	0	0
14	12036731	.	A	G	7	7	14	0	1	15	0	0
14	12036768	.	A	C	6	0	6	0	8	14	0	0
14	12050577	.	T	C	1	4	5	0	0	5	0	0
14	12050868	.	A	C	1	0	1	0	4	5	0	0
14	12069754	.	C	T	15	20	35	0	0	35	0	0
14	12071446	.	A	G	11	10	21	0	0	21	0	0
14	12077109	.	C	T	4	2	6	0	0	6	0	0
14	12085165	.	T	C	7	8	15	0	1	16	0	0
14	12085267	.	G	A	8	9	17	0	1	18	0	0
14	12089512	.	G	T	8	5	13	0	1	14	0	0
14	12099566	.	G	T	4	9	13	0	2	15	0	0
14	12099605	.	T	G	3	5	8	0	1	9	0	0
14	12106603	.	G	A	6	2	8	0	0	8	0	0
14	12110493	.	A	G	2	2	4	0	0	4	0	0
14	12111019	.	C	T	1	3	4	0	0	4	0	0
14	12111298	.	A	T	1	2	3	0	0	3	0	0
14	12111299	.	C	T	1	2	3	0	0	3	0	0
14	12157456	.	C	T	22	13	35	0	2	37	0	0
14	12159384	.	C	G	26	18	44	0	0	44	0	0
14	12162692	.	C	T	20	23	43	0	1	44	0	0
14	12162731	.	A	C	17	24	41	0	1	42	0	0
14	12164364	.	C	A	34	29	63	0	1	64	0	0
14	12166656	.	A	G	19	24	43	0	2	45	0	0
14	12166956	.	C	T	21	23	44	0	0	44	0	0
14	12166974	.	A	G	21	25	46	0	0	46	0	0
14	12167321	.	T	A	26	12	38	0	0	38	0	0
14	12167615	.	G	A	0	7	7	0	13	20	0	0
14	12174484	.	T	G	1	3	4	0	0	4	0	0
14	12174503	.	A	G	2	2	4	0	0	4	0	0
14	12175436	.	T	G	1	2	3	0	0	3	0	0
14	12175448	.	A	T	1	2	3	0	0	3	0	0
14	12175914	.	A	G	1	2	3	0	0	3	0	0
14	12179114	.	T	C	5	5	10	0	1	11	0	0
14	12179124	.	T	A	3	5	8	0	0	8	0	0
14	12189019	.	T	C	5	6	11	0	0	11	0	0
14	12189856	.	C	T	7	8	15	0	0	15	0	0
14	12191579	.	T	A	9	7	16	0	0	16	0	0
14	12195119	.	T	A	7	6	13	0	0	13	0	0
14	12205329	.	T	C	7	5	12	0	0	12	0	0
14	12205521	.	C	T	12	3	15	0	0	18	3	0
14	12370570	.	A	G	3	2	5	0	0	5	0	0
14	12428324	.	G	T	8	12	20	0	1	21	0	0
14	12429901	.	A	G	5	8	13	0	1	14	0	0
14	12430793	.	G	A	2	5	7	0	4	12	1	0
14	12436937	.	T	C	6	5	11	0	0	11	0	0
14	12452477	.	C	T	10	6	16	0	1	17	0	0
14	12452516	.	G	A	0	10	10	0	14	24	0	0
14	12465519	.	C	A	14	11	25	0	0	25	0	0
14	12472233	.	C	T	14	12	26	0	0	26	0	0
14	12473599	.	T	A	8	2	10	0	4	14	0	0
14	12473932	.	T	C	7	14	21	0	0	21	0	0
14	12473992	.	A	T	5	5	10	0	1	11	0	0
14	12474159	.	T	C	9	5	14	0	0	14	0	0
14	12481591	.	C	T	4	3	7	0	0	7	0	0
14	12481600	.	T	C	2	2	4	0	0	4	0	0
14	12486294	.	C	T	6	4	10	0	1	11	0	0
14	12535403	.	T	G	22	18	40	0	2	42	0	0
14	12535568	.	A	G	28	7	35	1	1	37	0	0
14	12535581	.	A	T	29	6	35	1	3	39	0	0
14	12535622	.	G	T	18	13	31	0	5	36	0	0
14	12535775	.	G	T	6	9	15	0	0	15	0	0
14	12535901	.	A	G	1	8	9	0	1	10	0	0
14	12536229	.	G	A	12	20	32	0	0	32	0	0
14	12536420	.	T	G	16	20	36	0	4	41	1	0
14	12554812	.	T	C	7	24	31	0	0	31	0	0
14	12635951	.	T	C	7	4	11	0	0	11	0	0
14	12636012	.	A	T	3	5	8	0	0	8	0	0
14	12837079	.	A	G	10	12	22	0	0	22	0	0
14	12837120	.	G	A	8	6	14	0	0	14	0	0
14	12837130	.	A	C	7	0	7	0	4	12	1	0
14	13524092	.	A	G	5	8	13	0	0	13	0	0
14	13525082	.	A	G	4	7	11	0	0	11	0	0
14	14225233	.	C	G	15	7	22	0	0	22	0	0
14	14315233	.	C	T	7	7	14	0	0	14	0	0
14	14502450	.	C	T	8	12	20	0	1	21	0	0
14	14502708	.	T	C	15	9	24	0	0	24	0	0
14	14502846	.	C	T	12	15	27	0	2	29	0	0
14	14502885	.	C	T	18	11	29	0	0	29	0	0
14	14532450	.	T	C	16	24	40	0	0	40	0	0
14	14532696	.	T	G	26	10	36	0	2	38	0	0
14	14532831	.	A	G	8	10	18	0	0	18	0	0
14	14534219	.	G	A	10	11	21	0	1	22	0	0
14	14566166	.	C	T	7	5	12	0	2	14	0	0
14	14582432	.	A	G	10	7	17	0	0	17	0	0
14	14593109	.	T	C	6	3	9	0	0	9	0	0
14	14593175	.	T	C	5	12	17	0	0	17	0	0
14	14593624	.	A	G	10	7	17	0	0	17	0	0
14	14593889	.	G	A	9	9	18	0	1	19	0	0
14	14594453	.	C	T	6	9	15	0	1	16	0	0
14	14595535	.	A	G	5	3	8	0	0	8	0	0
14	14595695	.	A	C	6	6	12	0	0	12	0	0
14	14595734	.	C	G	3	7	10	0	0	10	0	0
14	14596121	.	T	G	5	3	8	0	0	8	0	0
14	14596176	.	T	C	4	2	6	0	1	7	0	0
14	14604317	.	G	A	7	5	12	0	1	13	0	0
14	14617666	.	G	A	0	3	3	0	2	5	0	0
14	14646949	.	T	A	1	2	3	0	0	3	0	0
14	14659027	.	A	C	2	3	5	0	0	5	0	0
14	14659032	.	T	C	2	0	2	0	3	5	0	0
14	14662597	.	A	T	28	21	49	0	4	53	0	0
14	14662606	.	A	G	29	19	48	0	3	51	0	0
14	14662663	.	C	T	23	22	45	0	2	47	0	0
14	14662684	.	C	T	19	19	38	0	1	39	0	0
14	14664974	.	T	C	12	9	21	0	0	21	0	0
14	14664998	.	G	A	12	11	23	0	0	23	0	0
14	14665175	.	T	C	12	9	21	0	0	21	0	0
14	14665229	.	A	G	10	8	18	0	1	19	0	0
14	14665270	.	T	G	3	8	11	0	1	12	0	0
14	14666173	.	A	T	7	5	12	0	1	13	0	0
14	14690710	.	G	T	16	15	31	5	0	36	0	0
14	14690831	.	C	A	9	12	21	39	0	60	0	0
14	14690837	.	G	A	8	10	18	44	0	62	0	0
14	14694930	.	A	G	23	26	49	0	2	51	0	0
14	14695136	.	A	G	13	28	41	0	0	41	0	0
14	14695181	.	A	G	18	22	40	0	2	42	0	0
14	14695428	.	C	T	2	8	10	6	21	37	0	0
14	14695864	.	T	C	15	0	15	0	25	40	0	0
14	14722530	.	A	T	7	5	12	0	0	13	1	0
14	14722556	.	T	C	8	4	12	0	0	12	0	0
14	14723381	.	A	T	8	5	13	0	0	13	0	0
14	14723410	.	G	T	8	5	13	0	2	15	0	0
14	14724026	.	C	T	4	2	6	0	1	7	0	0
14	14724951	.	G	A	22	27	49	0	2	51	0	0
14	14724953	.	A	G	27	24	51	0	4	55	0	0
14	14724987	.	G	A	24	34	58	0	0	58	0	0
14	14725132	.	A	T	25	16	41	0	5	46	0	0
14	14725314	.	G	A	24	39	63	0	1	64	0	0
14	14728192	.	G	T	18	15	33	25	1	59	0	0
14	14729069	.	G	A	33	24	57	1	2	60	0	0
14	14739116	.	T	C	10	14	24	0	0	24	0	0
14	14837681	.	A	G	1	2	3	0	0	3	0	0
14	14837693	.	T	C	4	2	6	0	1	7	0	0
14	14844346	.	A	C	5	2	7	0	0	7	0	0
14	14844529	.	A	G	4	3	7	0	0	7	0	0
14	14844658	.	T	G	4	6	10	0	0	10	0	0
14	14845532	.	G	A	0	4	4	0	5	9	0	0
14	14845912	.	C	T	1	2	3	0	0	3	0	0
14	14852142	.	T	A	7	3	10	0	0	10	0	0
14	14854654	.	G	A	0	2	2	0	4	6	0	0
14	14855017	.	T	C	8	9	17	0	0	17	0	0
14	14855057	.	C	T	8	6	14	0	0	14	0	0
14	14855139	.	T	A	12	3	15	0	0	15	0	0
14	14855561	.	C	T	6	3	9	0	0	9	0	0
14	15064962	.	A	G	2	0	2	0	6	8	0	0
14	15071502	.	C	T	3	3	6	0	0	6	0	0
14	15086220	.	G	A	7	7	14	0	0	14	0	0
14	15087088	.	C	T	1	2	3	0	0	3	0	0
14	15087121	.	T	C	1	0	1	0	3	4	0	0
14	15099780	.	T	C	5	4	9	0	1	10	0	0
14	15154624	.	T	C	1	5	6	0	0	6	0	0
14	15155901	.	A	G	7	0	7	0	3	10	0	0
14	15155955	.	T	G	2	2	4	0	2	6	0	0
14	15662731	.	G	A	4	3	7	0	0	7	0	0
14	15662836	.	A	T	4	5	9	0	0	9	0	0
14	15663014	.	C	T	9	6	15	0	0	15	0	0
14	15663053	.	T	A	9	2	11	0	2	13	0	0
14	15663237	.	T	C	3	4	7	0	1	8	0	0
14	15663718	.	T	C	9	3	12	0	1	13	0	0
14	15663730	.	C	G	8	5	13	0	0	13	0	0
14	15663766	.	T	A	4	3	7	0	0	7	0	0
14	15664251	.	T	A	9	11	20	0	0	21	1	0
14	15664263	.	T	C	8	8	16	0	3	19	0	0
14	15664843	.	A	G	3	2	5	0	1	6	0	0
14	15677790	.	C	T	0	4	4	0	7	11	0	0
14	15677831	.	G	A	2	5	7	0	0	7	0	0
14	15677882	.	C	T	1	4	5	0	2	7	0	0
14	15677907	.	A	G	2	5	7	0	0	7	0	0
14	15677931	.	T	C	3	3	6	0	1	7	0	0
14	15678111	.	A	G	2	3	5	0	1	6	0	0
14	15678291	.	A	G	8	5	13	0	0	13	0	0
14	15678362	.	G	A	9	4	13	0	0	13	0	0
14	15678444	.	A	G	6	6	12	0	1	13	0	0
14	15678447	.	A	T	6	7	13	0	0	13	0	0
14	15760375	.	A	C	4	2	6	0	0	6	0	0
14	15801784	.	T	C	5	5	10	0	0	10	0	0
14	15812577	.	A	G	7	5	12	0	0	12	0	0
14	15812685	.	C	T	6	3	9	0	0	9	0	0
14	15812732	.	A	C	4	2	6	0	1	7	0	0
14	15813702	.	G	T	7	2	9	0	0	9	0	0
14	15813792	.	C	T	2	2	4	0	0	4	0	0
14	15813801	.	A	T	1	2	3	0	0	3	0	0
14	15814770	.	C	T	5	3	8	0	0	8	0	0
14	15972435	.	C	A	11	1	12	0	3	15	0	0
14	15972597	.	G	A	2	4	6	0	0	6	0	0
14	15972666	.	G	A	4	3	7	0	0	7	0	0
14	15973920	.	G	A	7	5	12	0	0	12	0	0
14	15973981	.	C	A	4	7	11	0	0	11	0	0
14	15974188	.	T	A	3	2	5	0	0	5	0	0
14	15974232	.	G	A	1	4	5	0	1	6	0	0
14	15974313	.	A	G	3	7	10	0	0	10	0	0
14	15980828	.	T	A	1	7	8	1	2	11	0	0
14	16042530	.	C	A	4	6	10	0	0	10	0	0
14	16072889	.	G	C	3	2	5	0	0	5	0	0
14	16084339	.	C	T	8	5	13	0	1	14	0	0
14	16090261	.	C	T	9	8	17	0	1	18	0	0
14	16090764	.	T	C	15	11	26	0	2	28	0	0
14	16090939	.	A	C	13	7	20	0	0	20	0	0
14	16091586	.	T	A	6	11	17	0	5	22	0	0
14	16091709	.	T	G	5	6	11	0	0	11	0	0
14	16091765	.	T	C	4	6	10	0	0	10	0	0
14	16093926	.	G	T	2	2	4	0	4	8	0	0
14	16093983	.	G	A	25	23	48	0	0	48	0	0
14	16095683	.	A	G	13	17	30	0	0	30	0	0
14	16097204	.	T	A	11	9	20	0	2	22	0	0
14	16115353	.	A	G	20	13	33	0	0	33	0	0
14	16122866	.	T	C	26	21	47	0	0	47	0	0
14	16122913	.	G	A	3	14	17	0	22	39	0	0
14	16127308	.	C	T	3	2	5	0	1	6	0	0
14	16127346	.	G	T	6	5	11	0	1	12	0	0
14	16127362	.	C	A	1	4	5	0	7	12	0	0
14	16145112	.	T	A	1	7	8	0	1	9	0	0
14	16178079	.	A	G	5	2	7	0	0	7	0	0
14	16208059	.	T	G	3	5	8	0	1	9	0	0
14	16383692	.	G	C	1	3	4	0	0	4	0	0
14	16383780	.	T	C	2	2	4	0	0	4	0	0
14	16383784	.	T	C	2	3	5	0	0	5	0	0
14	16389655	.	C	T	3	3	6	0	0	6	0	0
14	16403111	.	T	C	1	2	3	0	0	3	0	0
14	16435150	.	G	A	25	26	51	1	0	52	0	0
14	16484577	.	G	A	5	3	8	0	1	9	0	0
14	16484713	.	A	G	4	6	10	0	0	10	0	0
14	16484763	.	C	T	0	8	8	0	4	12	0	0
14	16485222	.	C	T	1	6	7	0	8	15	0	0
14	16606649	.	C	A	0	10	10	0	10	20	0	0
14	16754060	.	C	T	0	9	9	0	5	14	0	0
14	16754192	.	A	C	4	4	8	0	0	8	0	0
14	16769067	.	A	G	10	25	35	0	0	35	0	0
14	16769109	.	T	C	17	19	36	0	3	39	0	0
14	16769189	.	C	T	15	12	27	0	2	29	0	0
14	16769246	.	C	T	21	15	36	0	0	36	0	0
14	16769478	.	A	G	25	4	29	0	1	30	0	0
14	16769550	.	A	G	16	1	17	0	15	32	0	0
14	16770338	.	T	A	12	17	29	0	3	32	0	0
14	16770646	.	C	A	18	19	37	0	1	38	0	0
14	16770847	.	C	T	12	18	30	0	0	30	0	0
14	16770959	.	T	A	11	14	25	0	0	25	0	0
14	16771265	.	A	T	8	5	13	0	0	13	0	0
14	16771339	.	T	C	5	6	11	0	0	11	0	0
14	16771340	.	A	G	4	0	4	0	7	11	0	0
14	16777673	.	T	C	3	0	3	0	2	5	0	0
14	16777677	.	A	C	2	2	4	0	0	4	0	0
14	16777708	.	T	C	2	2	4	0	0	4	0	0
14	16778086	.	G	A	5	3	8	0	0	8	0	0
14	16790722	.	A	T	2	3	5	0	0	5	0	0
14	16796636	.	A	G	1	2	3	0	0	3	0	0
14	16801732	.	C	A	0	2	2	0	3	5	0	0
14	16805337	.	C	T	2	1	3	0	1	4	0	0
14	16805352	.	G	A	2	2	4	0	1	5	0	0
14	16907721	.	C	T	4	5	9	0	2	11	0	0
14	16947242	.	G	A	7	14	21	0	0	21	0	0
14	16968227	.	T	C	6	6	12	0	0	12	0	0
14	16968260	.	C	T	6	7	13	0	0	13	0	0
14	16968302	.	T	C	5	7	12	0	1	13	0	0
14	16996869	.	T	C	3	10	13	0	1	14	0	0
14	16996870	.	G	A	3	11	14	0	0	14	0	0
14	17003333	.	G	A	10	12	22	0	3	25	0	0
14	17003628	.	G	A	9	8	17	0	0	17	0	0
14	17016521	.	G	A	16	13	29	0	1	30	0	0
14	17016650	.	C	T	11	9	20	0	0	20	0	0
14	17025176	.	C	A	11	3	14	0	0	14	0	0
14	17025200	.	G	A	8	3	11	0	0	11	0	0
14	17025353	.	G	C	1	2	3	0	0	3	0	0
14	17025388	.	A	T	3	4	7	0	0	7	0	0
14	17025472	.	T	A	7	8	15	0	0	15	0	0
14	17025538	.	A	G	11	2	13	0	0	13	0	0
14	17025539	.	A	G	9	4	13	0	0	13	0	0
14	17025807	.	T	C	8	7	15	0	0	15	0	0
14	17025960	.	A	T	4	12	16	0	1	17	0	0
14	17026103	.	G	A	7	4	11	0	1	12	0	0
14	17026534	.	G	A	12	5	17	0	0	17	0	0
14	17026550	.	C	T	9	6	15	0	0	15	0	0
14	17026724	.	T	C	12	20	32	0	0	32	0	0
14	17026840	.	T	C	2	7	9	0	0	9	0	0
14	17152335	.	T	C	3	1	4	0	1	5	0	0
14	17197240	.	A	C	13	8	21	0	2	23	0	0
14	17198928	.	A	G	18	11	29	0	0	29	0	0
14	17198953	.	G	A	14	9	23	0	1	24	0	0
14	17198988	.	T	G	10	14	24	0	0	24	0	0
14	17199349	.	C	T	15	17	32	0	0	32	0	0
14	17199990	.	A	G	20	25	45	0	0	45	0	0
14	17200159	.	C	T	13	11	24	0	2	26	0	0
14	17200174	.	G	T	2	13	15	0	15	30	0	0
14	17200407	.	C	A	8	13	21	0	0	21	0	0
14	17200482	.	T	C	5	14	19	0	1	20	0	0
14	17200653	.	A	C	14	8	22	0	1	23	0	0
14	17230601	.	A	G	5	4	9	1	1	11	0	0
14	17233541	.	C	T	13	13	26	0	0	26	0	0
14	17240569	.	G	T	10	7	17	0	0	17	0	0
14	17240587	.	A	G	10	5	15	0	0	15	0	0
14	17266013	.	A	T	12	9	21	0	0	21	0	0
14	17275609	.	T	A	9	7	16	0	0	16	0	0
14	17275708	.	C	G	6	4	10	0	0	10	0	0
14	17278972	.	C	T	8	7	15	0	1	16	0	0
14	17279197	.	G	A	5	9	14	0	1	15	0	0
14	17279305	.	T	C	7	4	11	0	2	13	0	0
14	17281713	.	G	A	4	9	13	0	1	14	0	0
14	17281727	.	C	G	6	11	17	0	0	18	1	0
14	17281818	.	T	C	3	7	10	0	2	12	0	0
14	17281831	.	G	A	7	7	14	0	1	15	0	0
14	17282058	.	G	A	8	9	17	0	1	18	0	0
14	17282061	.	C	T	7	9	16	0	0	16	0	0
14	17282095	.	C	G	9	8	17	0	0	17	0	0
14	17282100	.	C	T	2	10	12	0	6	18	0	0
14	17282160	.	C	T	6	5	11	0	0	11	0	0
14	17347911	.	T	C	1	3	4	0	0	4	0	0
14	17347920	.	G	A	0	3	3	0	1	4	0	0
14	17349069	.	G	C	4	3	7	0	1	8	0	0
14	17349104	.	G	T	3	3	6	0	0	6	0	0
14	17349171	.	T	G	7	3	10	0	0	10	0	0
14	17349464	.	T	C	8	5	13	0	0	13	0	0
14	17349472	.	C	T	6	4	10	0	1	11	0	0
14	17349757	.	C	T	4	5	9	0	0	9	0	0
14	17443629	.	A	C	2	2	4	0	0	4	0	0
14	17568072	.	T	A	6	2	8	0	1	9	0	0
14	17572743	.	T	C	7	6	13	0	0	13	0	0
14	17575834	.	C	G	14	18	32	0	0	32	0	0
14	17575868	.	G	A	15	15	30	0	3	33	0	0
14	17575872	.	C	T	14	19	33	0	1	34	0	0
14	17575926	.	T	A	1	2	3	0	0	3	0	0
14	17580662	.	G	A	7	9	16	0	0	16	0	0
14	17580917	.	G	A	26	23	49	0	1	50	0	0
14	17580922	.	C	A	26	23	49	0	1	50	0	0
14	17581036	.	C	A	17	17	34	0	2	36	0	0
14	17586527	.	A	G	21	17	38	0	5	43	0	0
14	17586693	.	G	A	21	26	47	0	1	48	0	0
14	17588131	.	G	T	15	15	30	0	0	30	0	0
14	17593654	.	T	A	5	4	9	0	1	10	0	0
14	17593685	.	G	C	9	5	14	0	1	15	0	0
14	17593767	.	A	T	13	11	24	1	0	25	0	0
14	17593783	.	T	A	14	12	26	1	2	29	0	0
14	17593803	.	A	T	15	8	23	0	2	25	0	0
14	17593823	.	A	T	15	8	23	0	1	24	0	0
14	17593992	.	T	A	5	13	18	0	1	19	0	0
14	17594137	.	G	A	6	4	10	0	2	12	0	0
14	17594556	.	C	T	6	13	19	0	0	19	0	0
14	17595063	.	G	A	4	4	8	0	0	8	0	0
14	17595264	.	T	A	8	11	19	0	0	19	0	0
14	18667559	.	T	C	13	12	25	0	0	25	0	0
14	18667852	.	T	C	15	13	28	0	2	30	0	0
14	18668731	.	A	G	6	3	9	0	0	9	0	0
14	18669481	.	C	A	21	14	35	0	3	38	0	0
14	18670446	.	C	T	16	18	34	0	1	35	0	0
14	18670582	.	T	A	11	15	26	0	3	29	0	0
14	18670665	.	A	G	13	9	22	0	1	23	0	0
14	18671011	.	A	T	10	11	21	0	0	21	0	0
14	18672233	.	G	A	12	4	16	0	1	17	0	0
14	18672491	.	C	T	11	11	22	0	2	24	0	0
14	19258995	.	C	T	9	8	17	0	0	17	0	0
14	19259292	.	A	G	9	12	21	0	0	21	0	0
14	19259608	.	A	C	4	2	6	0	7	13	0	0
14	19259614	.	T	C	4	0	4	0	8	12	0	0
14	19260261	.	A	G	7	17	24	0	3	27	0	0
14	19261044	.	C	T	19	12	31	1	2	34	0	0
14	20159151	.	T	C	11	16	27	0	0	27	0	0
14	20188941	.	G	A	1	13	14	0	10	24	0	0
14	20189180	.	T	C	17	14	31	0	0	31	0	0
14	20189188	.	G	A	15	14	29	0	1	30	0	0
14	20190023	.	A	C	8	9	17	0	0	17	0	0
14	20190297	.	C	G	21	16	37	0	0	37	0	0
14	20190494	.	G	T	1	13	14	0	18	32	0	0
14	20190532	.	G	A	22	11	33	0	0	33	0	0
14	20342750	.	C	T	3	5	8	0	2	10	0	0
14	20694640	.	A	C	2	2	4	0	0	4	0	0
14	20695409	.	A	C	4	3	7	0	2	9	0	0
14	20728633	.	A	G	8	2	10	0	1	11	0	0
14	20730907	.	T	A	5	6	11	1	1	13	0	0
14	20730958	.	A	T	7	5	12	0	4	16	0	0
14	20731633	.	A	T	2	6	8	0	1	9	0	0
14	20731656	.	T	A	5	6	11	0	0	11	0	0
14	20731675	.	A	T	6	7	13	0	0	13	0	0
14	20731756	.	G	A	3	3	6	0	0	6	0	0
14	20731797	.	C	T	2	5	7	0	0	7	0	0
14	20731904	.	T	C	3	5	8	0	0	8	0	0
14	20732426	.	T	C	3	3	6	0	0	6	0	0
14	20732457	.	T	C	2	2	4	0	0	4	0	0
14	20732546	.	G	C	4	7	11	0	0	11	0	0
14	20732793	.	A	T	4	2	6	0	2	8	0	0
14	20733016	.	A	G	2	2	4	0	0	4	0	0
14	20733081	.	A	G	3	2	5	0	1	6	0	0
14	20733168	.	A	G	2	0	2	0	1	3	0	0
14	20734309	.	C	A	5	2	7	0	1	8	0	0
14	20734310	.	C	T	6	2	8	0	0	8	0	0
14	20734823	.	A	G	2	2	4	0	0	4	0	0
14	20734827	.	G	A	2	2	4	0	0	4	0	0
14	20735388	.	T	G	10	12	22	0	2	24	0	0
14	20735481	.	T	C	16	13	29	0	0	29	0	0
14	20735525	.	T	A	11	9	20	0	1	21	0	0
14	20735585	.	G	T	5	3	8	0	0	8	0	0
14	20735626	.	G	T	6	7	13	0	1	14	0	0
14	20735841	.	A	G	5	0	5	0	11	16	0	0
14	20736251	.	A	G	5	15	20	0	1	21	0	0
14	20869833	.	G	A	1	3	4	0	0	4	0	0
14	20869866	.	C	A	1	4	5	0	0	5	0	0
14	20869943	.	T	C	2	1	3	0	5	8	0	0
14	20869949	.	G	A	2	5	7	0	0	7	0	0
14	20870257	.	A	G	5	12	17	0	0	17	0	0
14	20870321	.	G	T	4	7	11	0	0	11	0	0
14	20879947	.	T	G	3	6	9	0	0	9	0	0
14	20881464	.	C	A	2	2	4	0	0	4	0	0
14	20881493	.	C	T	1	4	5	0	0	5	0	0
14	20891728	.	T	A	1	3	4	0	0	4	0	0
14	20896049	.	T	G	5	0	5	0	8	13	0	0
14	20896058	.	C	T	5	7	12	0	0	12	0	0
14	20898373	.	G	T	2	4	6	0	0	6	0	0
14	20929935	.	G	A	0	3	3	0	1	4	0	0
14	20929944	.	A	G	1	2	3	0	0	3	0	0
14	20966505	.	A	G	2	0	2	0	4	6	0	0
14	20966529	.	A	C	3	2	5	0	0	5	0	0
14	20973364	.	T	C	2	5	7	0	1	8	0	0
14	20988121	.	T	C	2	3	5	0	1	6	0	0
14	20988209	.	T	C	4	2	6	0	0	6	0	0
14	20994005	.	T	C	2	2	4	0	0	4	0	0
14	20994047	.	A	G	4	0	4	0	3	7	0	0
14	20994051	.	G	A	0	3	3	0	4	7	0	0
14	20994167	.	C	T	5	2	7	0	1	8	0	0
14	20994695	.	G	A	2	7	9	0	0	9	0	0
14	20994967	.	T	C	1	4	5	0	0	5	0	0
14	20996393	.	C	T	2	9	11	0	0	11	0	0
14	20996394	.	A	T	2	8	10	0	1	11	0	0
14	21000095	.	A	G	7	2	9	0	0	9	0	0
14	21000170	.	C	G	5	6	11	1	1	13	0	0
14	21000193	.	T	C	6	3	9	0	4	13	0	0
14	21000375	.	A	G	1	0	1	0	4	5	0	0
14	21067455	.	G	A	1	7	8	0	0	8	0	0
14	21067935	.	A	G	8	7	15	0	1	16	0	0
14	21067938	.	T	C	10	6	16	0	0	16	0	0
14	21071965	.	T	C	9	5	14	0	2	16	0	0
14	21072037	.	G	A	9	13	22	0	0	22	0	0
14	21072729	.	A	G	13	17	30	0	1	31	0	0
14	21072792	.	C	T	8	14	22	0	0	22	0	0
14	21072834	.	C	T	9	7	16	0	0	16	0	0
14	21072852	.	G	A	8	6	14	0	1	15	0	0
14	21078274	.	G	A	1	2	3	0	1	4	0	0
14	21078277	.	T	C	1	3	4	0	0	4	0	0
14	21079937	.	G	C	6	0	6	0	9	15	0	0
14	21079991	.	A	T	6	6	12	0	0	12	0	0
14	21087521	.	C	A	6	2	8	0	0	8	0	0
14	21090848	.	A	C	8	0	8	0	9	17	0	0
14	21098305	.	A	G	9	7	16	0	1	17	0	0
14	21098316	.	A	C	6	6	12	0	0	12	0	0
14	21124321	.	T	C	4	5	9	0	0	9	0	0
14	21124469	.	A	G	1	2	3	0	1	4	0	0
14	21129362	.	T	G	10	10	20	0	3	23	0	0
14	21129629	.	G	T	11	19	30	0	1	31	0	0
14	21132180	.	G	A	12	10	22	0	0	22	0	0
14	21159943	.	T	G	8	0	8	0	15	23	0	0
14	21159949	.	A	T	10	17	27	0	0	27	0	0
14	21183865	.	G	A	15	19	34	0	0	34	0	0
14	21183910	.	A	G	17	10	27	0	1	28	0	0
14	21187563	.	C	T	15	14	29	0	0	29	0	0
14	21187631	.	C	T	12	17	29	0	1	30	0	0
14	21195795	.	C	T	14	21	35	0	1	36	0	0
14	21198328	.	A	C	20	26	46	0	3	49	0	0
14	21198349	.	T	A	12	19	31	0	4	35	0	0
14	21198391	.	A	C	11	13	24	0	4	28	0	0
14	21198403	.	T	C	14	14	28	0	4	32	0	0
14	21198689	.	T	A	9	14	23	0	0	24	1	0
14	21198818	.	C	T	12	15	27	0	0	27	0	0
14	21199092	.	G	T	7	5	12	1	0	13	0	0
14	21199184	.	A	T	12	4	16	0	0	16	0	0
14	21204542	.	G	A	5	4	9	0	1	10	0	0
14	21204553	.	T	A	4	4	8	0	0	8	0	0
14	21204814	.	T	A	5	8	13	0	0	13	0	0
14	21205297	.	T	C	5	3	8	0	0	8	0	0
14	21205429	.	T	C	14	0	14	0	19	33	0	0
14	21205471	.	G	A	15	19	34	0	1	35	0	0
14	21205623	.	G	T	12	15	27	0	1	29	1	0
14	21211802	.	A	C	9	11	20	0	1	21	0	0
14	21211859	.	T	A	3	15	18	0	0	18	0	0
14	21219450	.	A	G	5	7	12	0	0	12	0	0
14	21236686	.	C	T	4	5	9	0	0	9	0	0
14	21237952	.	A	G	2	3	5	0	0	5	0	0
14	21237963	.	T	C	2	2	4	0	0	4	0	0
14	21238759	.	T	C	16	3	19	0	6	25	0	0
14	21238782	.	T	A	15	13	28	0	0	28	0	0
14	21241695	.	G	A	1	17	18	0	12	30	0	0
14	21241870	.	T	A	8	3	11	0	1	12	0	0
14	21241899	.	A	G	6	4	10	0	0	10	0	0
14	21242082	.	T	A	5	4	9	1	0	10	0	0
14	21242148	.	C	T	4	3	7	0	0	7	0	0
14	21245142	.	C	T	3	2	5	0	1	6	0	0
14	21245315	.	G	T	1	2	3	0	0	3	0	0
14	21245545	.	G	A	0	2	2	0	1	3	0	0
14	21245657	.	A	C	4	2	6	0	0	6	0	0
14	21332964	.	G	A	24	32	56	0	4	60	0	0
14	21333795	.	G	A	40	32	72	0	0	72	0	0
14	21333867	.	C	A	13	32	45	0	33	78	0	0
14	21333957	.	G	A	51	45	96	0	3	99	0	0
14	21334257	.	G	T	38	36	74	0	2	76	0	0
14	21334338	.	A	G	32	43	75	0	3	78	0	0
14	21334840	.	G	C	42	39	81	0	13	94	0	0
14	21334968	.	G	A	33	33	66	0	0	66	0	0
14	21334985	.	G	T	29	29	58	0	5	63	0	0
14	21597044	.	A	G	24	11	35	0	1	36	0	0
14	21597140	.	C	A	27	23	50	0	3	53	0	0
14	21597264	.	G	A	18	16	34	0	0	34	0	0
14	21597363	.	A	G	23	14	37	0	1	38	0	0
14	21597425	.	G	A	9	4	13	0	5	18	0	0
14	21597451	.	T	C	9	4	13	0	0	13	0	0
14	21597469	.	T	C	7	3	10	0	1	11	0	0
14	21597671	.	T	C	15	6	21	0	0	21	0	0
14	21597730	.	C	T	21	16	37	0	2	39	0	0
14	21597755	.	T	A	16	15	31	1	1	33	0	0
14	21597814	.	C	T	19	18	37	1	1	39	0	0
14	21598035	.	C	T	15	14	29	0	6	35	0	0
14	21598354	.	T	C	21	0	21	0	9	30	0	0
14	21598372	.	G	A	21	10	31	0	0	31	0	0
14	21598402	.	C	A	21	10	31	0	1	32	0	0
14	21598488	.	C	T	18	13	31	0	1	32	0	0
14	21598724	.	T	G	16	22	38	0	3	41	0	0
14	21598831	.	G	T	24	24	48	0	3	51	0	0
14	21603294	.	G	C	28	22	50	0	2	52	0	0
14	21603335	.	A	G	24	28	52	1	3	56	0	0
14	21609707	.	A	G	24	23	47	0	1	48	0	0
14	21609733	.	A	G	27	27	54	0	0	54	0	0
14	21616066	.	T	C	15	9	24	2	1	27	0	0
14	21617939	.	G	A	22	15	37	0	2	39	0	0
14	21617947	.	G	C	22	14	36	0	1	37	0	0
14	21623128	.	A	T	8	7	15	0	0	15	0	0
14	21623324	.	C	T	5	6	11	0	0	11	0	0
14	21630153	.	A	G	9	21	30	0	1	31	0	0
14	21636953	.	G	A	13	12	25	0	1	26	0	0
14	21636965	.	A	G	12	14	26	0	2	28	0	0
14	21639583	.	A	G	11	5	16	0	1	17	0	0
14	21643647	.	T	A	10	8	18	0	1	19	0	0
14	21646054	.	C	T	15	5	20	0	1	21	0	0
14	21646110	.	G	A	19	9	28	0	0	28	0	0
14	21652399	.	G	T	4	4	8	0	0	8	0	0
14	21652864	.	C	T	9	7	16	0	0	16	0	0
14	21654600	.	G	A	7	9	16	0	1	17	0	0
14	21654748	.	G	C	5	8	13	0	0	13	0	0
14	21654808	.	A	G	4	8	12	0	0	12	0	0
14	21655177	.	T	C	3	4	7	0	0	7	0	0
14	21655274	.	A	G	7	2	9	0	2	11	0	0
14	21655284	.	T	A	6	2	8	0	2	10	0	0
14	21655533	.	T	C	5	7	12	0	1	13	0	0
14	21656452	.	C	G	1	5	6	0	0	6	0	0
14	21660213	.	T	C	4	6	10	0	0	10	0	0
14	21660484	.	A	G	9	8	17	0	2	19	0	0
14	21685744	.	T	G	6	2	8	0	0	8	0	0
14	21689852	.	C	T	35	23	58	0	1	59	0	0
14	21693251	.	G	A	41	24	65	0	5	70	0	0
14	21693584	.	T	G	24	31	55	0	4	59	0	0
14	21733828	.	T	C	2	2	4	0	1	5	0	0
14	21745784	.	G	A	3	6	9	0	0	9	0	0
14	21745871	.	C	A	1	3	4	0	1	5	0	0
14	21745879	.	A	T	1	4	5	0	0	5	0	0
14	21745917	.	G	C	4	4	8	0	0	8	0	0
14	21746148	.	T	C	2	3	5	0	0	5	0	0
14	21746226	.	T	G	3	3	6	0	0	6	0	0
14	21759501	.	C	T	1	2	3	0	0	3	0	0
14	21766410	.	C	T	8	7	15	0	0	15	0	0
14	21766428	.	A	G	9	6	15	0	0	15	0	0
14	21768244	.	G	A	1	4	5	0	5	10	0	0
14	21768418	.	G	A	3	3	6	0	0	6	0	0
14	21770666	.	C	G	6	3	9	0	0	9	0	0
14	21771915	.	G	A	5	8	13	0	0	13	0	0
14	21772412	.	C	T	5	6	11	0	0	11	0	0
14	21779102	.	C	T	8	7	15	1	0	16	0	0
14	21779141	.	G	A	2	7	9	4	5	18	0	0
14	21779241	.	G	A	10	8	18	0	1	19	0	0
14	21779551	.	A	G	5	2	7	0	0	7	0	0
14	21779633	.	T	C	2	3	5	0	0	5	0	0
14	21779975	.	C	A	3	4	7	0	1	8	0	0
14	21779977	.	G	A	5	4	9	0	0	9	0	0
14	21780155	.	C	G	9	5	14	0	1	15	0	0
14	21780206	.	A	G	10	9	19	0	0	19	0	0
14	21780274	.	A	C	1	5	6	0	0	6	0	0
14	21780321	.	T	C	4	5	9	0	0	9	0	0
14	21790748	.	C	T	14	10	24	0	0	24	0	0
14	21801383	.	G	A	12	11	23	0	2	25	0	0
14	21804912	.	T	C	11	9	20	1	0	21	0	0
14	21806190	.	C	T	10	19	29	0	1	30	0	0
14	21806196	.	G	C	2	16	18	0	10	28	0	0
14	21813696	.	G	A	19	14	33	0	0	33	0	0
14	21816388	.	T	C	14	9	23	0	0	23	0	0
14	21821229	.	G	T	3	5	8	0	0	8	0	0
14	21834912	.	C	T	10	15	25	0	1	26	0	0
14	21838379	.	T	C	12	18	30	5	1	36	0	0
14	21840858	.	A	G	11	0	11	0	11	22	0	0
14	21842804	.	T	C	23	22	45	0	5	50	0	0
14	21843726	.	G	A	1	14	15	1	18	34	0	0
14	21844187	.	T	A	24	8	32	0	1	33	0	0
14	21844486	.	C	T	5	6	11	0	0	11	0	0
14	21924048	.	G	A	4	3	7	0	0	7	0	0
14	21924273	.	A	G	3	4	7	0	0	7	0	0
14	21924382	.	A	G	3	5	8	0	0	8	0	0
14	21999177	.	C	T	3	3	6	0	0	6	0	0
14	22012883	.	G	A	3	2	5	0	0	5	0	0
14	22104906	.	T	C	11	10	21	0	3	24	0	0
14	22104948	.	G	A	16	12	28	0	2	30	0	0
14	22106056	.	T	A	2	3	5	0	0	5	0	0
14	22108215	.	C	T	12	16	28	0	1	29	0	0
14	22109640	.	A	T	1	2	3	0	0	3	0	0
14	22118117	.	A	C	1	2	3	0	0	3	0	0
14	22132510	.	A	T	14	19	33	0	0	33	0	0
14	22132536	.	A	T	20	17	37	0	1	38	0	0
14	22134069	.	G	A	21	24	45	0	2	47	0	0
14	22139160	.	T	C	27	23	50	0	3	53	0	0
14	22139194	.	C	T	26	30	56	0	0	56	0	0
14	22139254	.	G	A	34	23	57	0	2	60	1	0
14	22139308	.	C	T	19	37	56	0	2	58	0	0
14	22139358	.	G	A	38	23	61	0	0	61	0	0
14	22139392	.	G	T	28	27	55	0	3	59	1	0
14	22139668	.	G	A	3	29	32	0	24	56	0	0
14	22139816	.	G	A	4	20	24	0	24	48	0	0
14	22140150	.	G	A	3	3	6	0	0	6	0	0
14	22140158	.	T	C	2	3	5	0	1	6	0	0
14	22140417	.	T	C	5	6	11	0	1	12	0	0
14	22140542	.	G	A	7	8	15	0	0	15	0	0
14	22151827	.	A	T	9	11	20	0	1	21	0	0
14	22151913	.	C	T	11	16	27	0	1	28	0	0
14	22151958	.	T	A	18	11	29	0	1	30	0	0
14	22151966	.	A	C	15	11	26	0	0	26	0	0
14	22152004	.	T	G	8	5	13	0	0	13	0	0
14	22172138	.	C	T	20	20	40	0	0	40	0	0
14	22249344	.	G	A	30	16	46	0	3	49	0	0
14	22254184	.	T	C	22	29	51	0	3	54	0	0
14	22272340	.	G	A	22	26	48	0	1	49	0	0
14	22272351	.	G	A	21	26	47	0	1	48	0	0
14	22272749	.	A	G	27	0	27	0	23	50	0	0
14	22367615	.	A	G	2	3	5	0	0	5	0	0
14	22370333	.	C	A	0	2	2	0	2	4	0	0
14	22397468	.	G	C	2	2	4	0	0	4	0	0
14	22397491	.	C	T	1	2	3	0	0	3	0	0
14	22397671	.	C	T	3	3	6	0	0	6	0	0
14	22400502	.	C	T	2	4	6	0	0	6	0	0
14	22416536	.	C	T	3	2	5	0	1	6	0	0
14	22418345	.	C	T	3	3	6	0	1	7	0	0
14	22418350	.	T	C	3	4	7	0	0	7	0	0
14	22418588	.	T	G	5	2	7	0	0	7	0	0
14	22420565	.	T	C	2	5	7	0	0	7	0	0
14	22420588	.	C	T	3	4	7	0	1	8	0	0
14	22420624	.	T	C	7	3	10	0	1	11	0	0
14	22420941	.	G	A	5	3	8	0	0	8	0	0
14	22421001	.	G	T	1	5	6	0	2	8	0	0
14	22426797	.	G	A	3	8	11	0	1	12	0	0
14	22426800	.	G	A	1	10	11	0	3	14	0	0
14	22426836	.	C	T	4	7	11	0	0	11	0	0
14	22431765	.	G	A	6	4	10	0	0	10	0	0
14	22432004	.	G	A	0	3	3	0	8	11	0	0
14	22437413	.	G	T	6	8	14	0	2	16	0	0
14	22438924	.	A	G	7	6	13	0	0	13	0	0
14	22439183	.	C	G	4	9	13	0	2	15	0	0
14	22439210	.	G	T	4	3	7	0	3	10	0	0
14	22439258	.	G	T	2	4	6	0	0	6	0	0
14	22439455	.	A	T	2	2	4	0	0	4	0	0
14	22439516	.	A	G	2	4	6	0	0	6	0	0
14	22439725	.	T	A	1	4	5	0	0	5	0	0
14	22439864	.	C	T	6	2	8	0	0	8	0	0
14	22439955	.	T	A	2	3	5	0	1	6	0	0
14	22440022	.	A	G	3	2	5	0	0	5	0	0
14	22440047	.	C	T	4	2	6	0	0	6	0	0
14	22440115	.	A	G	1	0	1	0	4	5	0	0
14	22440918	.	G	A	1	3	4	1	0	5	0	0
14	22441000	.	G	C	1	5	6	0	0	6	0	0
14	22441057	.	T	C	3	5	8	0	0	8	0	0
14	22441110	.	G	A	2	6	8	0	0	8	0	0
14	22441210	.	A	T	5	2	7	1	0	8	0	0
14	22441581	.	C	A	9	3	12	0	1	13	0	0
14	22441730	.	A	G	4	6	10	0	0	10	0	0
14	22441793	.	G	A	0	3	3	0	6	9	0	0
14	22441873	.	T	C	3	2	5	0	0	5	0	0
14	22470213	.	T	C	2	4	6	0	0	6	0	0
14	22478380	.	C	T	5	2	7	0	0	7	0	0
14	22479381	.	T	A	3	2	5	0	0	5	0	0
14	22492160	.	T	A	1	2	3	0	0	3	0	0
14	22499368	.	A	G	2	2	4	0	0	4	0	0
14	22509528	.	T	C	3	3	6	0	0	6	0	0
14	22523476	.	A	G	5	7	12	0	0	12	0	0
14	22523608	.	C	A	3	3	6	0	1	7	0	0
14	22591868	.	C	T	1	2	3	0	0	3	0	0
14	22689737	.	A	G	5	1	6	0	5	11	0	0
14	22689869	.	C	A	3	5	8	0	0	8	0	0
14	22696456	.	C	T	4	3	7	1	0	8	0	0
14	22696522	.	T	C	7	5	12	0	1	13	0	0
14	22699771	.	C	A	7	5	12	0	0	12	0	0
14	22708325	.	A	G	5	4	9	0	1	10	0	0
14	22708446	.	C	T	2	4	6	0	0	6	0	0
14	23405034	.	G	A	3	10	13	0	0	13	0	0
14	23411619	.	C	G	8	0	8	0	8	16	0	0
14	23455989	.	G	A	9	12	21	0	1	22	0	0
14	23463681	.	G	A	1	5	6	0	6	12	0	0
14	23463708	.	A	G	5	5	10	0	0	10	0	0
14	23463717	.	A	G	5	0	5	0	4	9	0	0
14	23463760	.	C	A	4	6	10	0	1	11	0	0
14	23478997	.	G	C	8	8	16	0	0	16	0	0
14	23968319	.	A	G	7	3	10	0	1	11	0	0
14	24097523	.	C	T	14	19	33	0	1	34	0	0
14	24097686	.	A	G	15	8	23	0	1	24	0	0
14	24097734	.	G	A	16	12	28	0	3	31	0	0
14	24098408	.	C	G	6	7	13	0	0	13	0	0
14	24098912	.	C	T	1	13	14	0	12	26	0	0
14	24108731	.	G	A	18	12	30	0	1	31	0	0
14	24108983	.	G	A	16	14	30	0	1	31	0	0
14	24109031	.	A	G	19	13	32	0	0	32	0	0
14	24109067	.	G	C	22	2	24	0	14	38	0	0
14	24109184	.	G	A	19	19	38	0	0	38	0	0
14	24109355	.	C	G	14	19	33	0	2	35	0	0
14	24109451	.	A	G	9	12	21	0	1	22	0	0
14	24109706	.	T	G	18	19	37	0	2	39	0	0
14	24110689	.	C	A	10	10	20	0	0	20	0	0
14	24215187	.	C	G	10	12	22	0	1	23	0	0
14	24215231	.	G	A	7	12	19	0	0	19	0	0
14	24217550	.	C	T	4	4	8	0	0	8	0	0
14	24220467	.	A	G	13	0	13	0	19	32	0	0
14	24220659	.	A	C	2	5	7	0	0	7	0	0
14	24221090	.	C	T	8	0	8	0	2	14	4	0
14	24221356	.	G	A	1	14	15	0	10	25	0	0
14	24241329	.	T	C	1	2	3	0	0	3	0	0
14	24248495	.	T	G	5	4	9	2	0	11	0	0
14	24248575	.	C	T	2	4	6	0	1	7	0	0
14	24268222	.	G	T	4	5	9	0	0	9	0	0
14	24268262	.	A	G	5	7	12	0	4	16	0	0
14	24268332	.	A	C	3	0	3	0	8	11	0	0
14	24268505	.	G	A	4	3	7	0	0	7	0	0
14	24268712	.	C	T	1	9	10	0	14	24	0	0
14	24274575	.	C	T	14	10	24	0	1	25	0	0
14	24274783	.	G	A	9	5	14	0	2	16	0	0
14	24276634	.	C	T	9	11	20	0	0	20	0	0
14	24278144	.	C	G	25	21	46	0	1	47	0	0
14	24278162	.	C	G	27	22	49	0	1	50	0	0
14	24278831	.	T	C	23	17	40	1	4	45	0	0
14	24278882	.	C	A	12	22	34	0	0	34	0	0
14	24278917	.	G	A	17	20	37	0	1	38	0	0
14	24279126	.	A	G	27	22	49	0	1	50	0	0
14	24279148	.	G	A	37	16	53	1	0	54	0	0
14	24279305	.	A	T	5	8	13	0	0	13	0	0
14	24279326	.	A	C	6	6	12	0	1	13	0	0
14	24279367	.	A	T	14	5	19	0	0	19	0	0
14	24279383	.	T	A	16	3	19	0	0	20	1	0
14	24279682	.	T	C	7	19	26	0	0	26	0	0
14	24279701	.	C	G	10	10	20	0	2	22	0	0
14	24280452	.	T	C	15	8	23	0	0	23	0	0
14	24280517	.	A	C	14	12	26	0	0	26	0	0
14	24280842	.	T	C	11	24	35	0	0	35	0	0
14	24280904	.	T	G	19	13	32	0	1	33	0	0
14	24280918	.	T	G	19	18	37	0	1	38	0	0
14	24280975	.	A	G	12	17	29	0	1	30	0	0
14	24281118	.	T	A	21	23	44	0	0	44	0	0
14	24281149	.	A	C	15	24	39	0	0	39	0	0
14	24281292	.	T	C	24	20	44	0	0	44	0	0
14	24283609	.	G	A	12	10	22	2	2	26	0	0
14	24284089	.	T	C	6	8	14	0	0	14	0	0
14	24288567	.	G	A	3	5	8	0	0	8	0	0
14	24301658	.	G	A	0	4	4	0	7	11	0	0
14	24301750	.	G	T	12	10	22	0	1	23	0	0
14	24301946	.	C	A	11	5	16	0	0	16	0	0
14	24302052	.	T	C	7	5	12	0	0	12	0	0
14	24302089	.	A	T	6	4	10	0	0	10	0	0
14	24302137	.	C	T	4	8	12	0	0	12	0	0
14	24302177	.	A	T	7	7	14	0	0	14	0	0
14	24302214	.	T	C	8	3	11	0	0	11	0	0
14	24302236	.	A	C	4	6	10	0	0	10	0	0
14	24302280	.	G	T	7	4	11	0	0	11	0	0
14	24302363	.	T	A	3	8	11	0	1	12	0	0
14	24302428	.	T	C	2	3	5	0	2	7	0	0
14	24302439	.	G	A	5	3	8	0	0	8	0	0
14	24302560	.	G	A	11	6	17	0	0	17	0	0
14	24302766	.	T	G	3	8	11	0	0	11	0	0
14	24302825	.	T	C	7	3	10	0	0	10	0	0
14	24302920	.	C	T	4	5	9	0	1	10	0	0
14	24303205	.	T	A	9	8	17	1	0	18	0	0
14	24303217	.	G	A	7	8	15	1	0	16	0	0
14	24303465	.	G	T	2	12	14	0	10	24	0	0
14	24303523	.	G	T	9	13	22	0	0	22	0	0
14	24303660	.	T	C	8	5	13	0	1	14	0	0
14	24303665	.	C	A	8	6	14	0	0	14	0	0
14	24303786	.	A	T	6	5	11	0	0	11	0	0
14	24303851	.	C	A	4	5	9	1	0	10	0	0
14	24303873	.	C	A	3	7	10	0	1	11	0	0
14	24304271	.	T	A	6	10	16	0	0	16	0	0
14	24304298	.	A	C	8	14	22	0	0	22	0	0
14	24304518	.	T	C	3	12	15	0	0	15	0	0
14	24304753	.	T	C	6	6	12	0	0	12	0	0
14	24317226	.	G	A	33	21	54	0	3	57	0	0
14	24317301	.	G	T	30	26	56	0	2	58	0	0
14	24317751	.	C	A	1	18	19	0	25	44	0	0
14	24318041	.	A	T	31	18	49	0	0	49	0	0
14	24318102	.	A	T	21	29	50	0	2	52	0	0
14	24318160	.	T	G	22	14	36	0	1	37	0	0
14	24318196	.	G	A	20	13	33	0	2	35	0	0
14	24318232	.	G	C	26	13	39	0	4	43	0	0
14	24318335	.	G	T	23	16	39	0	0	39	0	0
14	24318631	.	C	T	19	26	45	0	0	45	0	0
14	24318652	.	G	A	23	25	48	0	1	49	0	0
14	24318709	.	A	T	25	24	49	0	0	49	0	0
14	24318723	.	T	C	25	23	48	0	2	50	0	0
14	24369500	.	C	T	21	11	32	0	0	32	0	0
14	24369578	.	A	G	27	19	46	0	3	49	0	0
14	24376787	.	G	A	34	18	52	0	3	55	0	0
14	24391397	.	G	A	14	13	27	0	0	27	0	0
14	24406609	.	C	G	1	17	18	0	16	34	0	0
14	24410450	.	A	C	14	15	29	0	0	29	0	0
14	24410553	.	C	A	13	15	28	0	0	28	0	0
14	24497739	.	T	C	2	3	5	0	0	5	0	0
14	24497832	.	G	T	3	5	8	0	2	11	1	0
14	24497868	.	T	C	2	0	2	0	7	9	0	0
14	24512823	.	G	A	6	5	11	0	0	11	0	0
14	24536966	.	A	G	7	8	15	0	2	17	0	0
14	24541797	.	T	C	1	3	4	0	0	4	0	0
14	24544362	.	A	T	1	2	3	0	0	3	0	0
14	24582280	.	T	A	2	2	4	0	0	4	0	0
14	24588316	.	G	A	2	4	6	0	0	6	0	0
14	24588332	.	A	G	1	2	3	0	0	3	0	0
14	24840805	.	T	C	3	2	5	0	0	5	0	0
14	24840837	.	C	A	2	3	5	0	1	6	0	0
14	24841001	.	C	T	3	5	8	0	0	8	0	0
14	24852639	.	T	C	8	3	11	0	0	11	0	0
14	24853036	.	A	G	3	4	7	0	1	8	0	0
14	24853292	.	A	G	5	2	7	0	0	7	0	0
14	24867270	.	T	C	10	4	14	0	0	14	0	0
14	24973441	.	A	T	13	8	21	0	0	21	0	0
14	24985474	.	T	C	8	16	24	0	1	25	0	0
14	24985478	.	C	T	10	16	26	0	0	26	0	0
14	24985582	.	C	A	7	13	20	0	0	20	0	0
14	24987643	.	G	T	25	12	37	0	3	40	0	0
14	24990428	.	G	T	21	12	33	2	4	39	0	0
14	24994819	.	G	A	0	12	12	0	14	26	0	0
14	24997850	.	G	A	0	9	9	0	11	20	0	0
14	24997910	.	C	T	8	8	16	0	0	16	0	0
14	24997911	.	C	T	8	7	15	0	1	16	0	0
14	24997954	.	C	A	11	9	20	0	0	20	0	0
14	24998019	.	A	T	14	13	27	0	1	28	0	0
14	24998076	.	A	G	12	1	13	0	18	31	0	0
14	24998345	.	C	A	9	12	21	0	1	22	0	0
14	24998359	.	C	A	16	8	24	0	0	24	0	0
14	24998430	.	G	A	3	19	22	0	15	37	0	0
14	24998737	.	A	C	13	16	29	0	2	31	0	0
14	24998765	.	A	T	15	11	26	0	2	28	0	0
14	24999546	.	T	A	20	19	39	0	1	40	0	0
14	24999573	.	A	G	19	1	20	0	20	40	0	0
14	24999722	.	T	C	20	10	30	0	2	32	0	0
14	25000492	.	A	T	14	10	24	0	1	25	0	0
14	25063607	.	G	T	7	4	11	0	1	12	0	0
14	25066002	.	C	A	3	17	20	0	18	38	0	0
14	25066722	.	T	A	22	12	34	0	1	35	0	0
14	25067471	.	C	T	11	13	24	0	0	24	0	0
14	25067665	.	C	T	19	14	33	0	0	33	0	0
14	25067700	.	C	A	16	11	27	0	0	27	0	0
14	25067857	.	G	A	21	10	31	0	0	31	0	0
14	25067862	.	A	C	20	9	29	0	1	30	0	0
14	25067984	.	C	T	20	11	31	0	0	31	0	0
14	25068007	.	G	C	19	11	30	0	0	30	0	0
14	25068206	.	G	T	17	16	33	0	0	33	0	0
14	25068215	.	T	G	20	17	37	0	0	37	0	0
14	25071338	.	C	T	4	16	20	0	16	36	0	0
14	25072307	.	G	T	25	13	38	0	0	38	0	0
14	25072351	.	C	T	22	12	34	0	3	37	0	0
14	25072447	.	A	G	15	19	34	0	0	34	0	0
14	25072468	.	C	T	18	19	37	0	0	37	0	0
14	25072489	.	T	G	18	18	36	0	2	38	0	0
14	25072662	.	T	C	12	0	12	0	18	30	0	0
14	25072737	.	C	T	5	10	15	0	0	15	0	0
14	25073178	.	C	G	2	15	17	0	12	29	0	0
14	25073412	.	G	A	10	16	26	0	0	26	0	0
14	25073511	.	C	T	11	12	23	0	0	23	0	0
14	25075173	.	G	A	6	7	13	0	1	14	0	0
14	25076578	.	G	A	4	3	7	0	0	7	0	0
14	25080035	.	A	G	21	15	36	0	0	36	0	0
14	25080687	.	C	G	21	11	32	0	2	34	0	0
14	25090999	.	T	G	22	15	37	0	2	39	0	0
14	25091063	.	A	G	11	24	35	0	1	36	0	0
14	25091467	.	C	T	16	15	31	0	2	33	0	0
14	25091840	.	C	T	12	12	24	0	2	26	0	0
14	25095719	.	G	A	7	5	12	0	0	12	0	0
14	25101126	.	A	G	2	2	4	0	0	4	0	0
14	25102028	.	C	G	1	3	4	0	0	4	0	0
14	25102162	.	A	G	1	2	3	1	0	4	0	0
14	25134219	.	T	A	1	2	3	0	0	3	0	0
14	25199830	.	G	T	1	2	3	0	0	3	0	0
14	25199866	.	G	A	2	3	5	0	0	5	0	0
14	25200174	.	A	G	1	2	3	0	0	3	0	0
14	25467064	.	C	T	7	4	11	0	0	11	0	0
14	25480138	.	A	G	6	0	6	0	4	10	0	0
14	25480219	.	C	T	8	5	13	0	0	13	0	0
14	25483989	.	T	C	12	10	22	0	0	22	0	0
14	25495423	.	A	G	13	7	20	0	1	21	0	0
14	25498423	.	T	C	7	10	17	0	0	17	0	0
14	25498805	.	G	A	8	4	12	0	0	12	0	0
14	25498821	.	C	G	7	5	12	0	0	12	0	0
14	25498891	.	A	T	2	3	5	0	0	5	0	0
14	25498930	.	A	G	2	2	4	0	0	4	0	0
14	25498932	.	A	T	1	2	3	0	0	3	0	0
14	25499602	.	A	G	8	4	12	0	0	12	0	0
14	25499651	.	G	A	5	4	9	1	0	10	0	0
14	25499974	.	C	T	3	2	5	0	0	5	0	0
14	25500093	.	A	T	8	9	17	0	0	17	0	0
14	25500110	.	G	A	0	8	8	0	7	15	0	0
14	25500594	.	T	A	8	3	11	0	2	13	0	0
14	25501405	.	C	T	8	5	13	0	0	13	0	0
14	25501581	.	T	C	4	10	14	0	1	15	0	0
14	25501740	.	T	G	4	6	10	0	0	10	0	0
14	25501851	.	T	G	13	11	24	0	1	25	0	0
14	25502142	.	T	C	9	7	16	0	1	17	0	0
14	25510803	.	A	G	1	4	5	0	1	6	0	0
14	25534862	.	G	T	11	9	20	0	1	21	0	0
14	25535003	.	C	T	1	9	10	0	1	11	0	0
14	25535005	.	T	C	1	9	10	0	0	10	0	0
14	25535067	.	A	T	4	12	16	0	0	16	0	0
14	25535167	.	T	G	4	17	21	1	1	23	0	0
14	25535607	.	G	A	18	24	42	0	1	43	0	0
14	25535706	.	G	T	20	28	48	0	1	49	0	0
14	25535742	.	T	A	22	15	37	2	1	40	0	0
14	25535768	.	G	T	23	7	30	4	0	34	0	0
14	25535820	.	C	T	1	6	7	0	15	22	0	0
14	25535836	.	G	A	11	5	16	0	2	18	0	0
14	25535926	.	C	A	7	3	10	0	0	10	0	0
14	25535947	.	A	T	2	4	6	0	0	6	0	0
14	25536132	.	T	C	20	11	31	1	1	33	0	0
14	25536148	.	G	A	15	13	28	1	0	29	0	0
14	25536187	.	G	T	18	5	23	0	2	25	0	0
14	25536531	.	T	G	23	13	36	0	1	37	0	0
14	25536577	.	G	C	22	20	42	0	1	43	0	0
14	25536619	.	A	G	21	18	39	0	2	41	0	0
14	25536657	.	A	C	23	17	40	0	2	42	0	0
14	25536770	.	A	T	29	11	40	0	1	41	0	0
14	25536782	.	C	T	2	10	12	0	26	38	0	0
14	25537019	.	C	A	14	18	32	0	1	33	0	0
14	25537068	.	G	A	13	15	28	0	0	28	0	0
14	25537136	.	T	C	22	19	41	0	1	42	0	0
14	25537145	.	G	A	20	20	40	0	2	42	0	0
14	25537189	.	A	T	17	21	38	0	2	40	0	0
14	25537200	.	C	T	18	22	40	0	2	42	0	0
14	25537307	.	A	T	18	11	29	0	0	29	0	0
14	25537332	.	T	A	16	11	27	0	1	28	0	0
14	25537345	.	A	G	16	12	28	0	0	28	0	0
14	25537405	.	A	G	17	15	32	0	0	32	0	0
14	25537700	.	C	T	3	20	23	0	10	33	0	0
14	25537975	.	G	T	20	15	35	0	0	35	0	0
14	25538121	.	T	C	23	17	40	0	2	42	0	0
14	25538355	.	A	T	17	15	32	0	2	35	1	0
14	25538364	.	A	C	16	17	33	0	1	34	0	0
14	25538433	.	T	A	7	14	21	0	2	23	0	0
14	25538490	.	T	C	6	5	11	0	0	11	0	0
14	25538497	.	C	A	3	4	7	0	3	10	0	0
14	25538618	.	T	A	14	14	28	0	1	29	0	0
14	25539423	.	C	T	1	18	19	0	16	35	0	0
14	25591182	.	C	T	1	5	6	0	11	17	0	0
14	25817556	.	T	C	3	8	11	0	1	12	0	0
14	25874600	.	G	A	9	7	16	0	0	16	0	0
14	25885793	.	G	C	1	15	16	0	9	25	0	0
14	25904733	.	C	T	8	7	15	0	2	17	0	0
14	25904739	.	C	T	11	8	19	0	0	19	0	0
14	25904781	.	C	T	11	7	18	0	1	19	0	0
14	25904811	.	C	T	11	11	22	0	0	22	0	0
14	25904868	.	C	T	9	17	26	0	1	27	0	0
14	25905091	.	C	T	11	9	20	0	0	20	0	0
14	25905281	.	A	G	5	2	7	0	1	8	0	0
14	25905868	.	A	G	5	11	16	0	0	16	0	0
14	25905869	.	A	G	6	9	15	0	1	16	0	0
14	25906074	.	A	G	6	6	12	0	1	13	0	0
14	25906079	.	G	A	6	6	12	0	0	12	0	0
14	25906572	.	G	A	7	2	9	0	1	10	0	0
14	25906652	.	G	T	13	7	20	0	2	22	0	0
14	25906727	.	A	G	10	11	21	0	1	22	0	0
14	25907006	.	T	C	7	7	14	0	1	15	0	0
14	25907143	.	A	G	8	0	8	0	9	17	0	0
14	25907541	.	C	T	8	5	13	0	0	13	0	0
14	25907578	.	T	A	5	6	11	0	0	11	0	0
14	25907737	.	T	C	6	7	13	0	0	13	0	0
14	25907893	.	G	A	0	6	6	0	11	17	0	0
14	25908021	.	T	A	5	4	9	0	0	9	0	0
14	25908113	.	A	C	3	2	5	0	0	5	0	0
14	25908659	.	G	C	3	6	9	0	1	10	0	0
14	25908680	.	A	T	7	4	11	0	0	11	0	0
14	25908753	.	A	C	6	10	16	0	0	16	0	0
14	25908802	.	A	C	16	12	28	0	0	28	0	0
14	25908843	.	A	T	16	13	29	0	0	29	0	0
14	25908901	.	C	T	19	12	31	0	1	32	0	0
14	25908984	.	T	G	9	6	15	0	0	15	0	0
14	25909103	.	C	A	6	5	11	0	1	12	0	0
14	25909567	.	T	C	2	9	11	0	0	11	0	0
14	25909582	.	T	C	1	8	9	0	0	9	0	0
14	25909736	.	G	A	7	3	10	0	1	11	0	0
14	25910037	.	T	A	16	12	28	0	1	29	0	0
14	25910186	.	C	A	10	3	13	0	0	13	0	0
14	25910296	.	A	G	7	8	15	0	0	15	0	0
14	25910314	.	A	T	8	9	17	0	1	18	0	0
14	25910414	.	C	G	14	10	24	0	0	24	0	0
14	25910636	.	G	C	14	9	23	0	0	23	0	0
14	25910715	.	T	C	8	13	21	0	1	22	0	0
14	25910747	.	C	T	10	17	27	0	0	27	0	0
14	25910825	.	A	C	12	13	25	0	2	27	0	0
14	25910834	.	T	A	15	14	29	0	1	30	0	0
14	25911097	.	C	T	16	16	32	0	0	32	0	0
14	25911098	.	G	A	16	16	32	0	0	32	0	0
14	25923510	.	C	G	4	2	6	0	0	6	0	0
14	25924369	.	T	A	5	9	14	0	2	16	0	0
14	25924429	.	C	T	1	5	6	0	5	11	0	0
14	25924661	.	T	C	9	3	12	0	0	12	0	0
14	25924868	.	A	T	3	4	7	0	0	7	0	0
14	25924931	.	G	A	3	9	12	0	0	12	0	0
14	25925028	.	G	A	8	4	12	0	0	12	0	0
14	25925552	.	C	A	2	3	5	0	1	6	0	0
14	25925600	.	C	T	4	6	10	0	1	11	0	0
14	25925973	.	T	A	16	3	19	0	0	19	0	0
14	25926048	.	C	T	1	11	12	0	6	18	0	0
14	25926134	.	G	A	18	15	33	0	0	33	0	0
14	25926195	.	G	A	16	12	28	0	0	28	0	0
14	25926276	.	G	A	22	10	32	0	0	32	0	0
14	25932650	.	C	A	13	9	22	0	1	23	0	0
14	25935090	.	G	T	16	17	33	0	1	34	0	0
14	25939231	.	T	G	1	3	4	0	0	4	0	0
14	25939622	.	G	A	23	7	30	0	1	31	0	0
14	25942653	.	G	A	10	8	18	0	1	19	0	0
14	25985004	.	A	C	3	2	5	0	0	5	0	0
14	25985005	.	G	A	3	2	5	0	0	5	0	0
14	25985448	.	A	C	13	15	28	0	0	28	0	0
14	25986978	.	G	C	4	5	9	0	0	9	0	0
14	25987017	.	A	T	5	4	9	0	0	9	0	0
14	25993160	.	G	A	7	9	16	0	1	17	0	0
14	25994540	.	A	T	4	4	8	0	0	8	0	0
14	25997985	.	A	G	1	6	7	0	1	8	0	0
14	26002310	.	T	C	4	10	14	0	0	14	0	0
14	26002514	.	G	C	5	6	11	0	0	11	0	0
14	26008943	.	A	G	7	0	7	0	6	13	0	0
14	26008951	.	G	A	0	6	6	0	7	13	0	0
14	26009136	.	A	G	7	8	15	0	2	17	0	0
14	26009147	.	C	G	10	9	19	0	0	19	0	0
14	26009201	.	T	C	2	5	7	0	0	7	0	0
14	26009202	.	C	T	2	4	6	0	1	7	0	0
14	26009267	.	G	A	0	6	6	0	5	11	0	0
14	26011975	.	C	T	6	3	9	0	0	9	0	0
14	26011987	.	G	A	0	8	8	0	3	11	0	0
14	26012017	.	G	A	6	9	15	0	1	16	0	0
14	26012026	.	A	G	6	1	7	0	8	15	0	0
14	26065818	.	T	G	4	5	9	1	0	10	0	0
14	26065860	.	C	T	4	4	8	1	0	9	0	0
14	26066617	.	A	G	6	11	17	0	0	17	0	0
14	26067757	.	T	A	2	5	7	0	0	7	0	0
14	26067797	.	A	T	2	3	5	0	0	5	0	0
14	26067798	.	A	G	2	3	5	0	0	5	0	0
14	26103439	.	A	T	3	2	5	0	0	5	0	0
14	26103547	.	T	A	8	14	22	0	1	23	0	0
14	26104350	.	C	A	0	18	18	0	13	31	0	0
14	26104442	.	C	T	16	18	34	0	1	35	0	0
14	26104503	.	C	T	11	18	29	0	2	31	0	0
14	26104614	.	A	C	8	13	21	0	1	22	0	0
14	26104674	.	A	T	8	6	14	0	0	14	0	0
14	26104679	.	A	C	8	0	8	0	6	14	0	0
14	26104710	.	G	T	9	10	19	0	0	19	0	0
14	26104762	.	G	A	9	7	16	0	0	16	0	0
14	26104775	.	T	A	7	6	13	0	0	13	0	0
14	26104801	.	C	A	6	8	14	0	0	14	0	0
14	26104854	.	C	T	6	6	12	0	0	12	0	0
14	26105053	.	C	T	14	8	22	4	1	27	0	0
14	26105086	.	A	C	9	14	23	4	0	27	0	0
14	26105221	.	A	G	12	3	15	0	0	15	0	0
14	26106231	.	G	T	11	17	28	0	2	30	0	0
14	26106493	.	C	T	9	17	26	0	0	26	0	0
14	26106697	.	C	T	2	14	16	0	19	35	0	0
14	26108958	.	T	G	13	20	33	0	2	35	0	0
14	26109353	.	T	G	17	12	29	0	1	30	0	0
14	26109356	.	G	A	17	13	30	0	0	30	0	0
14	26111237	.	T	C	9	10	19	0	0	19	0	0
14	26114037	.	A	T	12	15	27	0	1	28	0	0
14	26114044	.	A	C	11	16	27	0	1	28	0	0
14	26114277	.	G	A	21	16	37	0	0	37	0	0
14	26114286	.	T	C	15	1	16	0	19	35	0	0
14	26127373	.	G	A	11	15	26	0	0	26	0	0
14	26127561	.	G	A	18	14	32	0	0	32	0	0
14	26127736	.	G	A	9	12	21	0	0	21	0	0
14	26127754	.	T	A	9	11	20	0	1	21	0	0
14	26127845	.	C	T	16	8	24	0	0	24	0	0
14	26127856	.	G	A	14	6	20	0	2	22	0	0
14	26135471	.	G	A	7	7	14	0	1	15	0	0
14	26147181	.	A	G	13	14	27	0	1	28	0	0
14	26147418	.	A	G	10	7	17	0	1	18	0	0
14	26149915	.	G	T	14	14	28	0	1	29	0	0
14	26152751	.	C	T	5	12	17	0	1	18	0	0
14	26153474	.	T	C	3	8	11	0	0	11	0	0
14	26153604	.	A	G	5	4	9	0	0	9	0	0
14	26153903	.	G	A	7	9	16	0	1	17	0	0
14	26154376	.	C	T	1	8	9	0	10	19	0	0
14	26154385	.	G	T	8	13	21	0	0	21	0	0
14	26154533	.	G	A	5	5	10	0	0	10	0	0
14	26154623	.	T	C	8	0	8	0	7	15	0	0
14	26155267	.	T	C	3	0	3	0	6	9	0	0
14	26155435	.	T	G	3	6	9	0	1	10	0	0
14	26156156	.	G	A	6	4	10	0	0	10	0	0
14	26157519	.	G	A	5	3	8	0	0	8	0	0
14	26163156	.	T	C	4	0	4	0	9	13	0	0
14	26165027	.	A	G	8	7	15	0	0	15	0	0
14	26165223	.	G	A	7	5	12	0	1	13	0	0
14	26168133	.	A	T	8	8	16	0	1	17	0	0
14	26169027	.	C	A	4	4	8	0	1	9	0	0
14	26169255	.	G	A	4	6	10	0	0	10	0	0
14	26169477	.	C	A	1	4	5	0	4	9	0	0
14	26169722	.	C	T	0	6	6	0	6	12	0	0
14	26169856	.	C	T	4	6	10	0	0	10	0	0
14	26170737	.	A	G	6	6	12	0	0	12	0	0
14	26170768	.	C	T	0	3	3	0	5	8	0	0
14	26170875	.	T	A	3	2	5	0	0	5	0	0
14	26170884	.	C	G	2	3	5	0	0	5	0	0
14	26171412	.	G	A	2	2	4	0	0	4	0	0
14	26171673	.	G	A	2	4	6	0	0	6	0	0
14	26177050	.	T	G	3	6	9	0	0	10	1	0
14	26224807	.	T	G	8	4	12	0	0	12	0	0
14	26227681	.	G	A	2	3	5	0	0	5	0	0
14	26227791	.	A	C	5	3	8	0	0	8	0	0
14	26376434	.	G	A	1	6	7	0	0	7	0	0
14	26376464	.	C	A	2	3	5	0	0	5	0	0
14	26376473	.	T	A	4	2	6	0	1	7	0	0
14	26376642	.	C	T	0	3	3	0	2	5	0	0
14	26376804	.	A	G	2	2	4	0	0	4	0	0
14	26404803	.	C	T	11	9	20	0	0	20	0	0
14	26404830	.	C	A	7	10	17	0	1	18	0	0
14	26405027	.	G	A	5	12	17	0	0	17	0	0
14	26405205	.	A	G	3	5	8	0	0	8	0	0
14	26405330	.	C	T	6	2	8	0	0	8	0	0
14	26413771	.	C	T	19	12	31	0	0	31	0	0
14	26414115	.	C	A	20	18	38	0	0	38	0	0
14	26414157	.	C	T	19	12	31	0	0	31	0	0
14	26414692	.	C	T	19	12	31	0	1	32	0	0
14	26718586	.	A	G	6	5	11	0	0	11	0	0
14	26718592	.	A	G	4	0	4	0	9	13	0	0
14	27281038	.	C	G	20	18	38	0	0	38	0	0
14	27281182	.	T	C	17	10	27	0	2	29	0	0
14	27281407	.	T	C	11	0	11	0	8	19	0	0
14	27281529	.	A	G	6	6	12	0	0	12	0	0
14	27281665	.	G	A	4	10	14	0	1	15	0	0
14	27288491	.	C	T	12	11	23	0	1	24	0	0
14	27288737	.	T	G	14	11	25	0	0	25	0	0
14	27288832	.	A	G	12	8	20	0	0	20	0	0
14	27998933	.	T	A	20	15	35	0	2	37	0	0
14	28001490	.	G	A	24	26	50	0	1	51	0	0
14	28282150	.	G	A	1	9	10	0	9	19	0	0
14	28282192	.	A	G	9	0	9	0	10	19	0	0
14	28282528	.	A	G	10	11	21	0	1	22	0	0
14	28351739	.	C	T	13	13	26	0	1	27	0	0
14	28351745	.	G	A	14	13	27	0	0	27	0	0
14	28351793	.	C	T	16	13	29	0	0	29	0	0
14	28385289	.	C	T	14	8	22	0	1	23	0	0
14	28385564	.	G	A	8	13	21	0	0	21	0	0
14	28428967	.	T	C	1	2	3	0	0	3	0	0
14	28437306	.	A	G	6	2	8	0	0	8	0	0
14	28437309	.	T	C	5	2	7	0	0	7	0	0
14	28438975	.	G	A	10	3	13	0	1	14	0	0
14	28443175	.	C	T	11	13	24	0	2	26	0	0
14	28448925	.	T	C	13	14	27	0	1	28	0	0
14	28449193	.	A	C	9	20	29	0	1	30	0	0
14	28452247	.	C	T	14	14	28	0	1	29	0	0
14	28452270	.	T	C	13	9	22	0	1	23	0	0
14	28454613	.	A	T	21	16	37	0	1	38	0	0
14	28458110	.	T	C	14	15	29	0	0	29	0	0
14	28458175	.	G	A	14	10	24	0	2	26	0	0
14	28458199	.	T	C	9	12	21	0	3	24	0	0
14	28458345	.	G	A	1	16	17	0	9	26	0	0
14	28458533	.	G	A	16	8	24	0	0	24	0	0
14	28458656	.	A	T	11	20	31	0	1	32	0	0
14	28458980	.	C	G	5	2	7	0	1	8	0	0
14	28459275	.	A	C	18	8	26	0	3	29	0	0
14	28459292	.	G	C	0	9	9	0	13	22	0	0
14	28459324	.	T	A	10	12	22	0	0	22	0	0
14	28459664	.	A	G	7	5	12	0	0	12	0	0
14	28463860	.	T	A	6	3	9	0	0	9	0	0
14	28464821	.	C	T	3	6	9	0	0	9	0	0
14	28464889	.	A	G	3	4	7	0	1	9	1	0
14	28464895	.	T	A	5	6	11	0	0	11	0	0
14	28473556	.	C	T	11	6	17	0	0	17	0	0
14	28476860	.	G	A	0	4	4	0	8	12	0	0
14	28476977	.	C	T	5	6	11	0	0	11	0	0
14	28477115	.	A	G	7	11	18	0	2	20	0	0
14	28477384	.	C	T	14	6	20	0	0	20	0	0
14	28477400	.	A	G	15	0	15	0	10	25	0	0
14	28492934	.	A	G	5	0	5	0	12	17	0	0
14	28492940	.	A	G	6	0	6	0	14	20	0	0
14	28493222	.	T	C	8	3	11	0	0	11	0	0
14	28497349	.	C	T	4	5	9	0	0	9	0	0
14	28497472	.	A	G	5	0	5	0	10	15	0	0
14	28497490	.	C	T	7	12	19	0	0	19	0	0
14	28497705	.	C	T	8	6	14	0	0	14	0	0
14	28501311	.	T	C	7	5	12	0	1	13	0	0
14	28501798	.	C	T	9	7	16	0	0	16	0	0
14	28502502	.	G	A	11	10	21	0	0	21	0	0
14	28502783	.	C	T	7	9	16	0	0	16	0	0
14	28504579	.	A	G	13	11	24	0	0	24	0	0
14	28507764	.	C	T	6	14	20	0	0	20	0	0
14	28512717	.	C	T	16	9	25	0	0	25	0	0
14	28514094	.	T	C	7	11	18	0	0	18	0	0
14	28514289	.	G	C	6	12	18	0	2	20	0	0
14	28514295	.	C	T	6	12	18	0	0	18	0	0
14	28514328	.	C	G	4	8	12	0	0	12	0	0
14	28520068	.	C	T	11	18	29	0	1	30	0	0
14	28520213	.	T	C	10	14	24	0	1	25	0	0
14	28525002	.	A	C	7	9	16	0	1	17	0	0
14	28525367	.	G	A	10	15	25	0	0	25	0	0
14	28525731	.	T	A	3	4	7	0	0	7	0	0
14	28526081	.	G	A	10	18	28	0	1	29	0	0
14	28526110	.	A	G	19	5	24	0	1	25	0	0
14	28526281	.	A	G	10	0	10	0	10	20	0	0
14	28526797	.	C	T	12	15	27	0	0	27	0	0
14	28526815	.	G	T	11	15	26	0	1	27	0	0
14	28526950	.	T	C	6	13	19	0	1	20	0	0
14	28527130	.	T	G	8	13	21	0	0	21	0	0
14	29609369	.	G	T	6	10	16	0	1	17	0	0
14	29987714	.	C	G	1	2	3	0	0	3	0	0
14	29987736	.	A	T	1	2	3	0	0	3	0	0
14	30107693	.	C	T	0	3	3	0	1	4	0	0
14	30107703	.	T	C	1	2	3	0	0	3	0	0
14	30107800	.	C	A	2	2	4	0	0	4	0	0
14	30107820	.	T	A	2	3	5	0	0	5	0	0
14	30157004	.	T	G	8	4	12	0	0	12	0	0
14	30157030	.	A	T	2	7	9	0	1	10	0	0
14	30158365	.	A	G	1	1	2	0	1	3	0	0
14	30158555	.	C	T	3	4	7	0	0	7	0	0
14	30159105	.	T	C	3	3	6	0	0	6	0	0
14	30163273	.	A	G	2	2	4	0	0	4	0	0
14	30164041	.	C	T	1	4	5	0	0	5	0	0
14	30172211	.	T	G	1	3	4	0	1	5	0	0
14	30180250	.	G	A	3	2	5	0	0	5	0	0
14	30183828	.	T	C	2	3	5	0	0	5	0	0
14	30195121	.	C	T	2	2	4	0	0	4	0	0
14	30198376	.	A	C	1	3	4	0	0	4	0	0
14	30272965	.	C	A	5	4	9	0	1	10	0	0
14	30274051	.	A	T	2	5	7	0	1	8	0	0
14	30274274	.	T	A	4	2	6	0	0	6	0	0
14	30274282	.	A	T	5	3	8	0	0	8	0	0
14	30276246	.	G	A	5	3	8	0	0	8	0	0
14	30276294	.	A	G	7	3	10	0	0	10	0	0
14	30277652	.	G	A	0	6	6	0	3	9	0	0
14	30342409	.	G	A	2	2	4	0	0	4	0	0
14	30356063	.	C	T	1	2	3	0	1	4	0	0
14	30360991	.	G	A	3	4	7	0	1	8	0	0
14	30362959	.	T	C	2	2	4	0	0	4	0	0
14	30369174	.	G	A	2	3	5	0	0	5	0	0
14	30369448	.	A	T	2	4	6	0	0	6	0	0
14	30369675	.	G	A	5	3	8	0	0	8	0	0
14	30398672	.	C	T	7	8	15	0	0	15	0	0
14	30401100	.	C	T	6	9	15	0	1	16	0	0
14	30403813	.	A	G	9	3	12	0	0	12	0	0
14	30403830	.	G	A	7	11	18	0	0	18	0	0
14	30407638	.	C	A	10	9	19	0	0	19	0	0
14	30410882	.	G	A	0	9	9	0	6	15	0	0
14	30411292	.	T	C	12	13	25	0	1	26	0	0
14	30411739	.	C	T	2	2	4	0	0	4	0	0
14	30411774	.	G	A	3	2	5	0	1	6	0	0
14	30424213	.	C	A	3	2	5	1	0	6	0	0
14	30424560	.	C	G	1	4	5	0	0	5	0	0
14	30427682	.	T	C	2	4	6	0	0	6	0	0
14	30427688	.	A	G	4	3	7	0	0	7	0	0
14	30427780	.	C	A	6	2	8	0	0	8	0	0
14	30427834	.	G	A	5	6	11	0	0	11	0	0
14	30428031	.	C	T	4	4	8	0	0	8	0	0
14	30428193	.	G	T	6	4	10	0	1	11	0	0
14	30435578	.	G	A	6	5	11	0	1	12	0	0
14	30452156	.	C	T	2	1	3	0	2	5	0	0
14	30456463	.	C	T	1	6	7	0	8	15	0	0
14	30460630	.	G	A	10	10	20	0	1	21	0	0
14	30488546	.	A	T	1	3	4	0	0	4	0	0
14	30551452	.	A	T	8	5	13	0	1	14	0	0
14	30551488	.	C	T	5	6	11	0	2	13	0	0
14	30551712	.	G	T	7	22	29	0	0	29	0	0
14	30551775	.	C	T	1	9	10	2	20	32	0	0
14	30551790	.	G	A	22	6	28	2	1	31	0	0
14	30569108	.	G	A	2	11	13	0	21	34	0	0
14	30580844	.	C	T	5	3	8	0	0	8	0	0
14	30580906	.	A	G	3	4	7	0	0	7	0	0
14	30581910	.	A	G	5	5	10	0	0	10	0	0
14	30587717	.	A	G	4	5	9	0	2	11	0	0
14	30588022	.	C	A	5	3	8	0	0	8	0	0
14	30613469	.	C	A	16	11	27	0	2	30	1	0
14	30620229	.	G	C	10	5	15	0	3	18	0	0
14	30637866	.	T	C	26	0	26	0	18	44	0	0
14	30637907	.	G	A	28	20	48	0	0	48	0	0
14	30638071	.	G	A	29	18	47	0	1	48	0	0
14	30638087	.	G	A	25	18	43	0	3	46	0	0
14	30638336	.	C	T	17	25	42	0	1	43	0	0
14	30638599	.	G	A	26	18	44	0	0	44	0	0
14	30642513	.	A	G	16	20	36	0	1	37	0	0
14	30642529	.	A	T	17	18	35	0	1	36	0	0
14	30642757	.	T	G	29	25	54	0	1	55	0	0
14	30670618	.	C	T	2	6	8	2	0	10	0	0
14	30670653	.	C	G	0	2	2	2	2	6	0	0
14	30670887	.	C	T	0	2	2	0	1	3	0	0
14	30713964	.	T	C	19	24	43	0	1	44	0	0
14	30720354	.	C	T	3	11	14	0	10	24	0	0
14	30720372	.	T	G	14	9	23	0	0	23	0	0
14	30720399	.	C	T	1	12	13	0	10	23	0	0
14	30731046	.	T	C	12	12	24	0	0	24	0	0
14	30731174	.	C	T	15	9	24	0	2	26	0	0
14	30731565	.	T	C	10	11	21	0	0	21	0	0
14	30731577	.	A	G	11	13	24	0	1	25	0	0
14	30731747	.	A	T	10	3	13	0	0	13	0	0
14	30732136	.	C	G	12	15	27	0	0	27	0	0
14	30732828	.	T	G	17	6	23	0	1	24	0	0
14	30732899	.	C	T	6	9	15	0	3	18	0	0
14	30733008	.	C	T	17	12	29	0	1	30	0	0
14	30733164	.	G	A	24	10	34	0	4	38	0	0
14	30733279	.	C	A	13	15	28	0	0	28	0	0
14	30733411	.	A	G	13	15	28	0	0	28	0	0
14	30733685	.	G	A	20	12	32	0	1	33	0	0
14	30733689	.	G	A	19	10	29	0	2	31	0	0
14	30733779	.	G	A	0	11	11	0	11	22	0	0
14	30733783	.	C	A	12	11	23	0	0	23	0	0
14	30733964	.	C	T	22	15	37	0	0	37	0	0
14	30734183	.	C	T	17	17	34	0	1	35	0	0
14	30734215	.	A	T	18	14	32	0	0	32	0	0
14	30734221	.	A	G	16	0	16	0	16	32	0	0
14	30734295	.	A	G	11	22	33	1	5	39	0	0
14	30734347	.	A	G	15	20	35	0	2	37	0	0
14	30734389	.	A	T	10	16	26	0	3	29	0	0
14	30734390	.	T	A	12	14	26	0	3	29	0	0
14	30734516	.	T	C	22	20	42	0	2	44	0	0
14	30741945	.	A	T	1	2	3	0	2	5	0	0
14	30742071	.	G	A	6	2	8	0	0	8	0	0
14	30757309	.	C	T	5	7	12	0	2	14	0	0
14	30759357	.	A	G	3	4	7	0	0	7	0	0
14	30759358	.	C	A	3	4	7	0	0	7	0	0
14	30791109	.	C	T	5	6	11	0	0	11	0	0
14	30791127	.	C	T	4	5	9	0	0	9	0	0
14	30792931	.	A	T	1	5	6	0	0	6	0	0
14	30793046	.	G	A	4	3	7	0	0	7	0	0
14	30793161	.	C	T	2	2	4	0	0	4	0	0
14	30793465	.	G	T	3	4	7	0	0	7	0	0
14	30793941	.	A	C	2	4	6	0	0	6	0	0
14	30794061	.	A	T	2	3	5	0	0	5	0	0
14	30794571	.	A	G	0	2	2	0	1	3	0	0
14	30800528	.	T	C	8	10	18	0	2	20	0	0
14	30800809	.	A	C	38	29	67	0	0	68	1	0
14	30801329	.	G	A	16	15	31	0	0	31	0	0
14	30801379	.	G	A	11	16	27	0	0	27	0	0
14	30801389	.	A	G	10	16	26	0	0	26	0	0
14	30801451	.	G	C	9	14	23	0	0	23	0	0
14	30802953	.	G	A	2	4	6	0	0	6	0	0
14	30803394	.	G	T	2	3	5	0	1	6	0	0
14	30803537	.	G	A	2	2	4	0	0	4	0	0
14	30803794	.	C	G	2	3	5	0	0	5	0	0
14	30805051	.	G	T	1	4	5	1	0	6	0	0
14	30807966	.	G	T	3	1	4	0	1	5	0	0
14	30807999	.	A	T	3	2	5	0	0	5	0	0
14	30808008	.	G	T	1	2	3	0	0	3	0	0
14	30854710	.	A	T	20	19	39	0	2	41	0	0
14	30854742	.	A	C	18	17	35	1	2	38	0	0
14	30854828	.	A	G	3	8	11	0	2	13	0	0
14	30855218	.	A	G	20	23	43	0	1	44	0	0
14	30855303	.	C	T	0	14	14	0	18	32	0	0
14	30855649	.	C	A	27	12	39	0	2	41	0	0
14	30855767	.	G	T	22	18	40	0	1	41	0	0
14	30855824	.	T	A	10	29	39	0	2	41	0	0
14	30876425	.	A	G	11	16	27	0	1	28	0	0
14	30876670	.	A	T	8	13	21	0	1	22	0	0
14	30878226	.	T	G	5	2	7	0	0	7	0	0
14	30878800	.	A	C	2	4	6	0	0	6	0	0
14	30879932	.	T	A	3	3	6	0	0	6	0	0
14	30880035	.	G	A	2	3	5	0	1	6	0	0
14	30880091	.	A	C	5	5	10	0	0	10	0	0
14	30880477	.	C	T	0	5	5	0	4	9	0	0
14	30880497	.	C	T	4	4	8	0	0	8	0	0
14	30880532	.	A	G	4	7	11	0	0	11	0	0
14	30880534	.	A	G	7	4	11	0	0	11	0	0
14	30880586	.	A	G	8	5	13	0	0	13	0	0
14	30880587	.	T	G	7	5	12	0	0	12	0	0
14	30880817	.	A	G	10	7	17	0	1	18	0	0
14	30880980	.	T	C	3	0	3	0	9	12	0	0
14	30881073	.	A	T	8	4	12	0	1	13	0	0
14	30881162	.	C	G	4	2	6	0	0	6	0	0
14	30881337	.	C	T	1	11	12	0	12	24	0	0
14	30883084	.	G	T	6	5	11	0	0	11	0	0
14	30883321	.	G	A	6	2	8	0	0	8	0	0
14	30885387	.	G	T	2	5	7	0	1	8	0	0
14	30886547	.	A	T	3	5	8	0	1	9	0	0
14	30886625	.	C	A	0	2	2	0	3	5	0	0
14	30886637	.	G	A	4	2	6	0	0	6	0	0
14	30886888	.	C	T	0	2	2	0	2	4	0	0
14	30891330	.	G	A	4	2	6	0	0	6	0	0
14	30891369	.	T	G	2	3	5	0	0	5	0	0
14	30891543	.	C	T	2	3	5	0	0	5	0	0
14	30912058	.	T	C	8	7	15	0	0	15	0	0
14	30912925	.	C	T	5	3	8	0	0	8	0	0
14	30912967	.	C	T	4	4	8	0	0	8	0	0
14	30912993	.	T	C	5	6	11	0	0	11	0	0
14	30913330	.	T	C	5	6	11	0	0	11	0	0
14	30913423	.	G	A	4	3	7	0	0	7	0	0
14	30914894	.	C	T	3	2	5	0	0	5	0	0
14	30914895	.	T	A	2	2	4	0	1	5	0	0
14	30915103	.	A	G	6	8	14	0	0	15	1	0
14	30915268	.	C	T	4	3	7	0	0	7	0	0
14	30915417	.	A	T	3	5	8	0	1	9	0	0
14	30915466	.	G	A	1	6	7	0	4	11	0	0
14	30915608	.	T	A	4	5	9	0	0	9	0	0
14	30916902	.	G	A	4	3	7	0	0	7	0	0
14	30925570	.	A	C	9	0	9	0	7	16	0	0
14	30927430	.	G	A	5	10	15	0	1	16	0	0
14	30929684	.	G	A	6	8	14	0	0	14	0	0
14	30929846	.	T	A	3	9	12	0	1	13	0	0
14	30929861	.	C	T	5	3	8	0	0	8	0	0
14	30967975	.	T	G	4	4	8	0	1	9	0	0
14	30970827	.	G	C	2	3	5	0	0	5	0	0
14	30970834	.	A	C	3	2	5	0	0	5	0	0
14	30970895	.	C	T	3	3	6	0	0	6	0	0
14	30975479	.	G	T	18	20	38	0	1	39	0	0
14	30978661	.	T	C	18	12	30	0	0	30	0	0
14	30982468	.	A	G	10	23	33	0	0	33	0	0
14	30987167	.	G	T	15	12	27	0	1	28	0	0
14	30987702	.	T	A	19	12	31	0	0	31	0	0
14	30987930	.	G	A	16	17	33	0	4	37	0	0
14	30987985	.	A	G	17	20	37	0	0	37	0	0
14	30988280	.	T	C	15	0	15	0	14	29	0	0
14	30988494	.	G	A	18	9	27	0	1	28	0	0
14	30988707	.	T	G	11	10	21	0	0	21	0	0
14	30988756	.	G	T	3	8	11	0	2	13	0	0
14	30990436	.	C	A	15	11	26	0	1	27	0	0
14	30991272	.	C	T	2	6	8	0	20	28	0	0
14	30991311	.	A	G	10	15	25	0	0	25	0	0
14	30992515	.	A	T	2	8	10	0	0	11	1	0
14	30992593	.	A	G	10	4	14	1	0	15	0	0
14	31006241	.	G	A	4	2	6	0	0	6	0	0
14	31014047	.	G	A	15	21	36	0	1	37	0	0
14	31014113	.	T	A	21	11	32	0	0	32	0	0
14	31024014	.	G	A	13	10	23	0	2	25	0	0
14	31024077	.	C	A	9	10	19	0	1	20	0	0
14	31060036	.	A	C	6	7	13	0	0	13	0	0
14	31060078	.	A	G	4	10	14	0	1	15	0	0
14	31060079	.	G	A	3	10	13	0	2	15	0	0
14	31082249	.	C	T	8	5	13	0	0	13	0	0
14	31082474	.	G	T	4	2	6	0	1	7	0	0
14	31082537	.	C	T	2	3	5	0	0	5	0	0
14	31082569	.	C	T	6	2	8	0	1	9	0	0
14	31082717	.	G	A	6	3	9	0	0	9	0	0
14	31082745	.	A	T	10	5	15	0	0	15	0	0
14	31082857	.	C	T	13	6	19	0	0	19	0	0
14	31083206	.	C	A	9	9	18	0	2	20	0	0
14	31083227	.	G	A	8	10	18	0	0	18	0	0
14	31083242	.	C	A	0	8	8	0	7	15	0	0
14	31087509	.	A	C	3	3	6	0	1	7	0	0
14	31087513	.	A	C	5	3	8	0	0	8	0	0
14	31090259	.	C	T	1	3	4	0	1	5	0	0
14	31090935	.	C	T	7	4	11	0	1	12	0	0
14	31091175	.	C	T	1	2	3	0	0	3	0	0
14	31091264	.	C	T	0	5	5	0	3	8	0	0
14	31091757	.	A	G	6	7	13	0	0	13	0	0
14	31092404	.	G	A	3	3	6	0	1	7	0	0
14	31177633	.	A	G	9	7	16	0	1	17	0	0
14	31177651	.	G	A	6	8	14	0	0	14	0	0
14	31177744	.	T	C	5	0	5	0	12	17	0	0
14	31299168	.	C	G	3	4	7	0	0	7	0	0
14	31474255	.	A	G	2	0	2	0	3	5	0	0
14	31474338	.	A	G	2	2	4	0	0	4	0	0
14	31474700	.	G	T	1	4	5	0	0	5	0	0
14	31474816	.	G	A	1	3	4	0	0	4	0	0
14	31474833	.	A	G	1	2	3	0	0	3	0	0
14	31478444	.	A	T	2	7	9	0	0	9	0	0
14	31479169	.	A	T	1	2	3	1	0	4	0	0
14	31493317	.	C	T	12	7	19	0	0	19	0	0
14	31497559	.	C	T	4	11	15	0	2	17	0	0
14	31498368	.	C	G	8	0	8	0	9	17	0	0
14	31498392	.	G	A	0	7	7	0	13	20	0	0
14	31507444	.	G	A	12	4	16	0	0	16	0	0
14	31510055	.	G	A	0	10	10	0	14	24	0	0
14	31514394	.	G	A	0	7	7	0	16	23	0	0
14	31516765	.	A	T	14	3	17	0	2	19	0	0
14	31518812	.	T	A	10	7	17	0	1	18	0	0
14	31519018	.	A	C	7	9	16	0	0	16	0	0
14	31519213	.	C	T	9	9	18	0	1	19	0	0
14	31519616	.	A	T	1	2	3	0	0	3	0	0
14	31519777	.	T	A	6	9	15	1	0	16	0	0
14	31520371	.	A	T	3	3	6	0	0	6	0	0
14	31520590	.	A	G	5	0	5	0	7	12	0	0
14	31520626	.	A	T	6	2	8	0	1	9	0	0
14	31520750	.	T	C	4	5	9	0	0	9	0	0
14	31521346	.	T	A	3	3	6	0	0	6	0	0
14	31530046	.	C	T	7	9	16	0	0	16	0	0
14	31530171	.	G	T	9	9	18	0	0	18	0	0
14	31530186	.	A	G	10	8	18	0	0	18	0	0
14	31530421	.	G	A	14	13	27	0	1	28	0	0
14	31530439	.	G	A	15	8	23	0	3	26	0	0
14	31541122	.	A	T	17	15	32	0	1	33	0	0
14	31541318	.	C	T	19	18	37	0	0	37	0	0
14	31544922	.	A	T	8	15	23	0	2	25	0	0
14	31544947	.	C	T	10	11	21	0	0	21	0	0
14	31545272	.	C	T	8	5	13	0	0	13	0	0
14	31545433	.	A	T	7	8	15	0	0	15	0	0
14	31545794	.	A	G	17	3	20	0	1	21	0	0
14	31545795	.	G	A	18	4	22	0	0	22	0	0
14	31545902	.	T	A	14	9	23	0	1	24	0	0
14	31545919	.	A	T	14	7	21	0	0	21	0	0
14	31546107	.	T	G	13	0	13	0	11	24	0	0
14	31546137	.	T	A	14	11	25	0	0	25	0	0
14	31546320	.	C	T	9	8	17	0	0	17	0	0
14	31551477	.	G	A	4	12	16	0	0	16	0	0
14	31556308	.	G	A	14	10	24	0	1	25	0	0
14	31556326	.	T	C	19	0	19	0	13	32	0	0
14	31556371	.	A	G	10	10	20	0	1	21	0	0
14	31559062	.	A	G	14	6	20	0	1	21	0	0
14	31562713	.	G	A	12	12	24	0	1	25	0	0
14	31601268	.	G	T	3	3	6	0	0	6	0	0
14	31601312	.	T	C	3	4	7	0	0	7	0	0
14	31601330	.	G	A	3	4	7	0	0	7	0	0
14	31603320	.	G	A	3	3	6	0	0	6	0	0
14	31607859	.	A	T	4	5	9	0	0	9	0	0
14	31607860	.	G	A	4	5	9	0	0	9	0	0
14	31608037	.	G	T	4	3	7	0	0	7	0	0
14	31608076	.	G	T	4	6	10	0	0	10	0	0
14	31615629	.	G	A	5	5	10	0	0	11	1	0
14	31615658	.	C	T	8	6	14	0	0	14	0	0
14	31616139	.	G	T	12	15	27	0	1	28	0	0
14	31616151	.	C	T	9	17	26	0	0	26	0	0
14	31635358	.	T	C	8	8	16	0	0	16	0	0
14	31636382	.	T	C	11	9	20	0	1	21	0	0
14	31636502	.	T	G	10	10	20	0	2	22	0	0
14	31641799	.	G	A	2	12	14	0	16	30	0	0
14	31641847	.	A	G	10	11	21	0	2	23	0	0
14	31641886	.	G	A	1	13	14	0	7	21	0	0
14	31641962	.	A	G	5	10	15	0	0	15	0	0
14	31642991	.	C	T	1	7	8	0	0	8	0	0
14	31643177	.	G	A	4	5	9	0	0	9	0	0
14	31643437	.	C	T	3	6	9	0	0	9	0	0
14	31643843	.	A	G	13	0	13	0	7	20	0	0
14	31643849	.	A	G	14	5	19	0	1	20	0	0
14	31644291	.	C	T	13	11	24	0	2	26	0	0
14	31644520	.	T	G	10	9	19	0	1	20	0	0
14	31644643	.	A	G	8	0	8	4	4	16	0	0
14	31644813	.	G	C	7	7	14	0	0	14	0	0
14	31644859	.	T	A	9	8	17	0	0	17	0	0
14	31645022	.	C	T	14	6	20	0	0	20	0	0
14	31645450	.	C	T	5	2	7	0	1	8	0	0
14	31645473	.	C	G	2	5	7	0	1	8	0	0
14	31646016	.	T	A	3	2	5	0	1	6	0	0
14	31646121	.	G	A	6	11	17	0	0	17	0	0
14	31646224	.	G	A	10	15	25	0	0	25	0	0
14	31646275	.	C	A	13	6	19	1	1	21	0	0
14	31646443	.	A	C	1	1	2	0	1	3	0	0
14	31646746	.	G	T	1	3	4	0	8	12	0	0
14	31646793	.	C	T	11	3	14	0	0	14	0	0
14	31646869	.	A	G	5	5	10	1	0	11	0	0
14	31647217	.	A	G	5	7	12	0	1	13	0	0
14	31647730	.	T	C	6	13	19	0	1	20	0	0
14	31647829	.	C	A	5	8	13	0	1	14	0	0
14	31667011	.	G	A	0	2	2	0	1	3	0	0
14	31668646	.	G	A	7	11	18	0	0	18	0	0
14	31668719	.	C	T	1	9	10	0	8	18	0	0
14	31668758	.	G	A	11	15	26	1	0	27	0	0
14	31669376	.	T	G	6	5	11	0	0	11	0	0
14	31669377	.	G	T	5	4	9	0	2	11	0	0
14	31669466	.	C	G	10	6	16	0	0	16	0	0
14	31669488	.	A	G	11	10	21	0	1	22	0	0
14	31669551	.	T	C	10	9	19	0	1	20	0	0
14	31669558	.	C	A	7	11	18	0	1	19	0	0
14	31669907	.	A	T	9	8	17	0	0	17	0	0
14	31670364	.	G	A	2	5	7	0	0	7	0	0
14	31670800	.	T	A	8	12	20	0	0	20	0	0
14	31670831	.	T	G	5	11	16	0	0	16	0	0
14	31673856	.	A	C	2	0	2	0	7	9	0	0
14	31677036	.	A	T	10	5	15	0	0	15	0	0
14	31677655	.	C	T	8	11	19	0	0	19	0	0
14	31779785	.	C	T	3	3	6	0	0	6	0	0
14	31780273	.	G	T	1	4	5	0	7	12	0	0
14	31780398	.	T	A	4	2	6	0	0	6	0	0
14	31799878	.	G	A	3	4	7	0	0	7	0	0
14	31799879	.	A	T	3	4	7	0	0	7	0	0
14	31800090	.	T	C	6	5	11	0	1	12	0	0
14	31800175	.	G	T	9	7	16	0	0	16	0	0
14	31800206	.	T	A	5	7	12	0	1	13	0	0
14	31800870	.	C	G	5	9	14	0	0	14	0	0
14	31801454	.	C	T	1	6	7	0	9	16	0	0
14	31801715	.	A	G	11	6	17	0	1	18	0	0
14	31802067	.	A	T	9	11	20	0	1	21	0	0
14	31802156	.	T	C	3	6	9	0	0	9	0	0
14	31803148	.	A	G	3	7	10	0	0	10	0	0
14	31806317	.	C	T	4	7	11	0	0	11	0	0
14	31806744	.	G	A	8	2	10	0	1	11	0	0
14	31820008	.	T	A	3	6	9	0	0	9	0	0
14	31822530	.	A	G	7	9	16	0	0	16	0	0
14	31822578	.	C	A	2	10	12	0	14	26	0	0
14	31822694	.	C	T	14	6	20	0	2	22	0	0
14	31822751	.	A	G	2	11	13	0	0	13	0	0
14	31860525	.	C	T	22	23	45	2	5	52	0	0
14	31861179	.	A	G	16	10	26	0	1	28	1	0
14	31881728	.	A	G	2	8	10	0	0	10	0	0
14	31882101	.	G	T	3	3	6	0	0	6	0	0
14	31882252	.	C	A	2	4	6	0	0	6	0	0
14	31882268	.	C	A	2	5	7	0	0	7	0	0
14	31882339	.	G	T	1	2	3	0	5	8	0	0
14	31882340	.	C	T	5	2	7	0	0	7	0	0
14	31882422	.	T	C	3	3	6	0	0	6	0	0
14	31882481	.	A	G	2	0	2	0	3	5	0	0
14	31882587	.	T	C	2	3	5	0	0	5	0	0
14	31882656	.	C	T	4	2	6	0	0	6	0	0
14	31882672	.	G	T	3	6	9	0	0	9	0	0
14	31882709	.	A	T	8	2	10	0	1	11	0	0
14	31882714	.	A	T	8	4	12	0	0	12	0	0
14	31882802	.	C	T	6	3	9	0	0	9	0	0
14	31882840	.	A	G	3	0	3	0	5	8	0	0
14	31883475	.	A	T	3	3	6	0	0	6	0	0
14	31883519	.	G	C	0	4	4	0	2	6	0	0
14	31883735	.	G	A	0	3	3	0	5	8	0	0
14	31890748	.	T	C	7	0	7	0	7	14	0	0
14	31890757	.	C	G	0	5	5	0	7	12	0	0
14	31890817	.	G	A	7	9	16	0	1	17	0	0
14	31890874	.	G	A	6	6	12	0	0	12	0	0
14	31936927	.	G	A	5	8	13	0	0	13	0	0
14	31936928	.	A	G	4	8	12	0	1	13	0	0
14	31936994	.	T	C	5	6	11	0	1	12	0	0
14	31973439	.	C	T	7	5	12	0	0	12	0	0
14	32011929	.	C	G	2	13	15	0	14	29	0	0
14	32013167	.	C	A	0	7	7	0	9	16	0	0
14	32023213	.	T	C	7	9	16	0	0	16	0	0
14	32025381	.	T	C	4	6	10	3	0	13	0	0
14	32025466	.	T	G	4	4	8	0	0	8	0	0
14	32057595	.	T	C	2	2	4	0	1	5	0	0
14	32184469	.	C	T	13	17	30	0	0	30	0	0
14	32184927	.	C	A	22	18	40	0	0	40	0	0
14	32184937	.	C	T	18	19	37	0	1	38	0	0
14	32185036	.	C	A	1	13	14	0	21	35	0	0
14	32185374	.	C	T	22	9	31	0	0	31	0	0
14	32254770	.	C	T	3	4	7	0	0	7	0	0
14	32255124	.	C	T	4	4	8	0	1	9	0	0
14	32443572	.	A	C	8	16	24	0	2	26	0	0
14	32443727	.	C	T	0	12	12	0	9	21	0	0
14	32443811	.	A	C	8	16	24	0	0	24	0	0
14	32444064	.	C	G	11	16	27	0	0	27	0	0
14	32444114	.	C	G	13	15	28	0	0	28	0	0
14	32444379	.	T	C	3	7	10	0	2	12	0	0
14	32444392	.	C	T	9	5	14	0	0	14	0	0
14	32444496	.	G	T	12	9	21	0	0	21	0	0
14	32444651	.	G	A	5	17	22	0	1	23	0	0
14	32444878	.	C	A	11	11	22	0	1	23	0	0
14	32455602	.	T	C	8	0	8	0	7	15	0	0
14	32461224	.	G	A	6	6	12	0	1	13	0	0
14	32475280	.	G	A	5	8	13	0	3	16	0	0
14	32475417	.	T	C	7	7	14	0	1	15	0	0
14	32477810	.	T	C	7	0	7	0	11	18	0	0
14	32479378	.	G	A	6	7	13	0	0	13	0	0
14	32486708	.	T	A	4	4	8	0	0	8	0	0
14	32491026	.	G	A	2	2	4	0	0	4	0	0
14	32515783	.	C	T	4	3	7	0	1	8	0	0
14	32518852	.	G	A	6	4	10	0	0	10	0	0
14	32518873	.	C	T	3	7	10	0	0	10	0	0
14	32520711	.	A	T	3	3	6	0	0	6	0	0
14	32524195	.	C	T	6	5	11	0	2	13	0	0
14	32525127	.	G	A	5	3	8	0	0	8	0	0
14	32526271	.	C	T	5	6	11	0	1	12	0	0
14	32526370	.	G	A	3	7	10	0	0	10	0	0
14	32526563	.	A	G	5	9	14	0	0	14	0	0
14	32526677	.	A	G	9	5	14	0	1	15	0	0
14	32534834	.	G	A	10	3	13	0	1	14	0	0
14	32549257	.	G	A	8	4	12	0	0	12	0	0
14	32549305	.	G	A	4	4	8	0	0	8	0	0
14	32631370	.	T	C	4	5	9	0	0	9	0	0
14	32631384	.	C	T	1	5	6	0	5	11	0	0
14	32952148	.	C	T	2	5	7	0	0	7	0	0
14	32952180	.	T	A	3	3	6	0	0	6	0	0
14	32952467	.	C	T	8	6	14	0	0	14	0	0
14	32952493	.	G	A	7	7	14	0	3	17	0	0
14	32952606	.	C	T	1	5	6	0	3	9	0	0
14	32952665	.	C	T	0	9	9	1	5	15	0	0
14	32952825	.	C	T	0	8	8	0	6	14	0	0
14	32952857	.	T	A	4	5	9	0	0	9	0	0
14	32953035	.	T	C	5	3	8	0	0	8	0	0
14	32984047	.	G	A	4	2	6	0	0	6	0	0
14	32984128	.	C	A	4	2	6	0	1	7	0	0
14	32984139	.	A	C	3	4	7	0	0	7	0	0
14	32984239	.	G	A	8	3	11	0	0	11	0	0
14	32984574	.	T	C	3	5	8	0	0	8	0	0
14	32984675	.	A	T	1	2	3	0	1	4	0	0
14	32984958	.	A	C	2	2	4	0	1	5	0	0
14	32985012	.	T	C	3	5	8	0	0	8	0	0
14	32985277	.	A	G	1	2	3	0	0	3	0	0
14	32994966	.	G	A	3	3	6	0	0	6	0	0
14	32995014	.	C	T	0	2	2	0	1	3	0	0
14	33068654	.	C	T	0	3	3	0	1	4	0	0
14	33071522	.	A	G	14	15	29	0	9	38	0	0
14	33071814	.	G	A	19	23	42	0	1	43	0	0
14	33073954	.	G	A	15	20	35	0	2	37	0	0
14	33120461	.	G	A	18	16	34	0	3	37	0	0
14	33120875	.	A	G	27	15	42	0	0	42	0	0
14	33177681	.	A	G	10	14	24	0	1	25	0	0
14	33177949	.	G	C	13	0	13	0	15	28	0	0
14	33220247	.	T	C	2	3	5	0	0	5	0	0
14	33221266	.	T	G	3	3	6	0	0	6	0	0
14	33237933	.	T	A	1	3	4	0	0	4	0	0
14	33268115	.	T	G	3	5	8	0	0	8	0	0
14	33268211	.	T	A	10	4	14	0	1	15	0	0
14	33268219	.	A	G	4	11	15	0	1	16	0	0
14	33268254	.	C	A	3	12	15	0	0	15	0	0
14	33268297	.	T	C	6	10	16	0	1	17	0	0
14	33268330	.	C	A	8	6	14	0	2	16	0	0
14	33268388	.	A	G	8	0	8	0	7	15	0	0
14	33280738	.	C	T	2	4	6	0	0	6	0	0
14	33280818	.	C	T	18	18	36	0	1	37	0	0
14	33281240	.	T	A	35	20	55	0	0	55	0	0
14	33281690	.	A	G	23	6	29	0	1	31	1	0
14	33281777	.	C	T	3	13	16	0	18	34	0	0
14	33281816	.	C	T	1	22	23	0	16	39	0	0
14	33281856	.	T	A	22	20	42	0	1	43	0	0
14	33281964	.	T	C	27	12	39	1	1	41	0	0
14	33282050	.	C	T	25	19	44	0	3	47	0	0
14	33288448	.	A	G	29	32	61	0	7	68	0	0
14	33297882	.	A	T	11	10	21	0	0	21	0	0
14	33298098	.	C	A	19	9	28	0	1	29	0	0
14	33298397	.	T	C	6	5	11	0	0	11	0	0
14	33298436	.	C	T	10	5	15	0	2	17	0	0
14	33298637	.	C	T	25	22	47	0	1	48	0	0
14	33302229	.	C	A	1	2	3	0	0	3	0	0
14	33302331	.	G	A	3	4	7	1	0	8	0	0
14	33302416	.	A	T	2	3	5	0	0	5	0	0
14	33302468	.	C	G	3	3	6	0	0	6	0	0
14	33302745	.	T	C	11	6	17	0	1	18	0	0
14	33306505	.	C	T	24	23	47	0	0	47	0	0
14	33307831	.	C	T	28	32	60	0	1	61	0	0
14	33308039	.	A	G	33	24	57	0	0	57	0	0
14	33308120	.	G	A	31	26	57	0	2	59	0	0
14	33330644	.	T	A	1	2	3	0	0	3	0	0
14	33333741	.	A	G	30	41	71	2	3	76	0	0
14	33333986	.	G	A	20	17	37	0	2	39	0	0
14	33339472	.	T	C	3	3	6	0	0	6	0	0
14	33339761	.	G	C	4	5	9	0	0	9	0	0
14	33339791	.	G	T	2	6	8	0	1	9	0	0
14	33339895	.	G	A	6	2	8	0	1	9	0	0
14	33340099	.	C	T	5	5	10	0	1	11	0	0
14	33414060	.	G	C	1	6	7	0	2	9	0	0
14	33414105	.	T	A	18	15	33	0	0	33	0	0
14	33414590	.	G	A	15	7	22	0	0	22	0	0
14	33414596	.	C	T	15	7	22	0	0	22	0	0
14	33415063	.	G	T	6	3	9	0	0	9	0	0
14	33415120	.	G	C	1	5	6	0	0	6	0	0
14	33415185	.	G	A	1	2	3	0	6	9	0	0
14	33419714	.	G	A	22	15	37	0	0	37	0	0
14	33423037	.	C	T	8	9	17	0	0	17	0	0
14	33424626	.	T	C	21	10	31	0	1	32	0	0
14	33424869	.	C	T	26	16	42	0	1	43	0	0
14	33424931	.	T	C	25	23	48	0	1	49	0	0
14	33425013	.	C	T	3	17	20	0	8	28	0	0
14	33427885	.	C	G	4	2	6	0	0	6	0	0
14	33431448	.	T	C	1	7	8	0	0	8	0	0
14	33431674	.	G	A	4	6	10	0	2	12	0	0
14	33431815	.	A	C	5	10	15	0	2	17	0	0
14	33431823	.	C	A	5	9	14	0	0	14	0	0
14	33432060	.	C	T	5	5	10	0	1	11	0	0
14	33432078	.	G	A	1	5	6	0	7	13	0	0
14	33432594	.	T	G	6	0	6	0	7	13	0	0
14	33433489	.	G	A	1	2	3	0	0	3	0	0
14	33433589	.	C	G	1	3	4	0	0	4	0	0
14	33433626	.	A	G	1	3	4	0	0	4	0	0
14	33433669	.	G	A	6	2	8	0	0	8	0	0
14	33434018	.	A	T	7	4	11	1	0	12	0	0
14	33434076	.	A	T	6	4	10	0	0	10	0	0
14	33435384	.	G	A	9	3	12	0	1	13	0	0
14	33435415	.	A	G	4	1	5	1	6	12	0	0
14	33435460	.	G	T	8	4	12	1	1	14	0	0
14	33435598	.	C	T	4	8	12	0	1	13	0	0
14	33436514	.	G	A	17	11	28	0	1	29	0	0
14	33437009	.	G	T	22	11	33	0	1	34	0	0
14	33437056	.	C	A	19	15	34	0	2	36	0	0
14	33441928	.	C	T	22	25	47	0	1	48	0	0
14	33442006	.	A	G	27	29	56	0	3	59	0	0
14	33442069	.	C	T	18	32	50	0	1	51	0	0
14	33454561	.	T	C	36	0	36	0	20	57	1	0
14	33454570	.	C	T	2	20	22	0	34	56	0	0
14	33469026	.	C	A	21	18	39	0	5	44	0	0
14	33469094	.	T	A	28	19	47	0	3	50	0	0
14	33469177	.	C	A	27	18	45	0	0	45	0	0
14	33469180	.	A	G	25	1	26	0	19	45	0	0
14	33469241	.	A	G	20	1	21	0	10	31	0	0
14	33469268	.	A	G	11	17	28	0	1	29	0	0
14	33469356	.	C	T	7	2	9	0	0	9	0	0
14	33469636	.	A	G	5	7	12	0	2	14	0	0
14	33474119	.	C	A	5	6	11	0	0	11	0	0
14	33474168	.	G	A	4	6	10	0	0	10	0	0
14	33474745	.	T	C	12	0	12	0	6	18	0	0
14	33474762	.	G	C	11	5	16	0	0	16	0	0
14	33474869	.	A	C	10	0	10	0	10	20	0	0
14	33475273	.	G	C	8	3	11	0	0	11	0	0
14	33475445	.	A	C	5	6	11	0	0	11	0	0
14	33475767	.	C	T	10	3	13	0	0	13	0	0
14	33486539	.	A	C	11	6	17	0	4	21	0	0
14	33486543	.	C	G	12	10	22	0	1	23	0	0
14	33487022	.	A	T	8	6	14	0	1	15	0	0
14	33497008	.	C	T	13	9	22	0	1	23	0	0
14	33498960	.	G	A	13	7	20	0	0	20	0	0
14	33499239	.	A	T	9	10	19	0	0	19	0	0
14	33501772	.	C	A	11	11	22	0	1	23	0	0
14	33504633	.	C	A	8	6	14	0	2	16	0	0
14	33505055	.	G	C	9	12	21	0	1	22	0	0
14	33507743	.	C	T	23	8	31	0	0	31	0	0
14	33515983	.	C	T	7	9	16	0	0	16	0	0
14	33516015	.	G	A	9	9	18	0	1	19	0	0
14	33516131	.	A	G	9	9	18	0	2	20	0	0
14	33516218	.	G	C	3	0	3	0	4	7	0	0
14	33516237	.	C	T	2	6	8	0	1	9	0	0
14	33516314	.	A	G	7	5	12	0	0	12	0	0
14	33516371	.	T	G	6	4	10	0	1	11	0	0
14	33516374	.	T	C	5	0	5	0	4	9	0	0
14	33516603	.	T	C	5	0	5	0	7	12	0	0
14	33516619	.	A	G	5	6	11	0	0	11	0	0
14	33516706	.	T	C	4	0	4	0	4	8	0	0
14	33516839	.	A	T	2	8	10	0	1	11	0	0
14	33516843	.	T	A	5	7	12	0	0	12	0	0
14	33516905	.	G	A	2	3	5	0	0	5	0	0
14	33517203	.	A	C	7	3	10	0	0	10	0	0
14	33517333	.	T	C	4	4	8	0	0	8	0	0
14	33517334	.	T	A	4	4	8	0	0	8	0	0
14	33517439	.	T	C	5	4	9	0	0	9	0	0
14	33517457	.	C	T	5	4	9	0	1	10	0	0
14	33517746	.	C	T	7	4	11	0	0	11	0	0
14	33518128	.	C	T	5	6	11	0	1	12	0	0
14	33518164	.	C	G	6	5	11	0	0	11	0	0
14	33518254	.	G	A	6	6	12	0	0	12	0	0
14	33518323	.	G	A	6	4	10	0	0	10	0	0
14	33518341	.	G	A	6	5	11	0	0	11	0	0
14	33518461	.	A	G	3	3	6	0	0	6	0	0
14	33518551	.	T	G	5	3	8	0	0	8	0	0
14	33518679	.	A	G	2	4	6	0	1	7	0	0
14	33518722	.	A	G	8	7	15	0	0	15	0	0
14	33525236	.	C	T	6	10	16	0	0	16	0	0
14	33525250	.	A	T	8	9	17	0	0	17	0	0
14	33549786	.	G	A	9	9	18	0	1	19	0	0
14	33554764	.	C	T	15	6	21	0	0	21	0	0
14	33564916	.	C	T	17	16	33	0	4	37	0	0
14	33564994	.	A	G	15	15	30	0	1	31	0	0
14	33565054	.	C	A	13	14	27	0	0	27	0	0
14	33565209	.	C	T	13	11	24	0	0	24	0	0
14	33565794	.	A	C	10	4	14	0	0	14	0	0
14	33566052	.	G	T	7	3	10	0	0	10	0	0
14	33566515	.	G	A	1	7	8	0	21	29	0	0
14	33566542	.	A	T	11	17	28	0	0	28	0	0
14	33566578	.	G	C	14	10	24	0	3	27	0	0
14	33566613	.	G	A	15	7	22	0	1	23	0	0
14	33566617	.	C	T	9	14	23	0	0	23	0	0
14	33566651	.	A	G	11	7	18	0	0	18	0	0
14	33566744	.	G	T	13	15	28	0	1	29	0	0
14	33566945	.	C	T	21	10	31	0	2	33	0	0
14	33567023	.	T	A	10	5	15	0	0	15	0	0
14	33567024	.	T	A	10	5	15	0	1	16	0	0
14	33567085	.	A	G	7	6	13	0	0	13	0	0
14	33605821	.	G	T	1	3	4	0	1	5	0	0
14	33723199	.	G	A	0	3	3	0	1	4	0	0
14	33754549	.	G	A	12	16	28	0	1	29	0	0
14	33754581	.	C	T	17	11	28	0	1	29	0	0
14	33754587	.	C	T	16	13	29	0	0	29	0	0
14	33754710	.	T	G	23	12	35	0	3	38	0	0
14	33755677	.	C	A	22	19	41	0	0	41	0	0
14	33755810	.	A	C	40	15	55	0	3	58	0	0
14	33755813	.	C	A	30	24	54	0	3	57	0	0
14	33755847	.	T	C	29	24	53	0	2	55	0	0
14	33756950	.	G	A	16	24	40	0	0	40	0	0
14	33757152	.	A	C	29	17	46	0	0	46	0	0
14	33826267	.	A	T	6	5	11	0	2	13	0	0
14	33826491	.	T	G	7	5	12	0	0	12	0	0
14	33826580	.	T	A	2	9	11	0	1	12	0	0
14	33826655	.	T	G	8	6	14	0	0	14	0	0
14	33826682	.	G	A	5	5	10	0	1	11	0	0
14	33826707	.	C	T	0	9	9	0	6	15	0	0
14	33826767	.	T	A	11	4	15	1	1	17	0	0
14	33826827	.	C	T	5	4	9	0	0	9	0	0
14	33827434	.	T	C	3	2	5	0	0	5	0	0
14	33827532	.	T	C	4	8	12	0	1	13	0	0
14	33827698	.	A	T	9	9	18	0	0	18	0	0
14	33827732	.	C	A	10	13	23	0	0	23	0	0
14	33827771	.	G	A	8	15	23	0	1	24	0	0
14	33827791	.	A	T	12	9	21	0	1	22	0	0
14	33827869	.	C	A	9	7	16	0	1	17	0	0
14	33827903	.	C	T	0	6	6	0	13	19	0	0
14	33827940	.	C	A	8	6	14	0	0	14	0	0
14	33827966	.	T	A	6	6	12	0	0	12	0	0
14	33828086	.	G	T	4	2	6	0	0	6	0	0
14	33828422	.	C	T	5	5	10	0	2	12	0	0
14	33828707	.	C	T	15	8	23	1	0	24	0	0
14	33828919	.	A	G	4	5	9	0	0	9	0	0
14	33829143	.	C	T	1	12	13	0	15	28	0	0
14	33830689	.	G	A	12	15	27	0	0	27	0	0
14	33835840	.	G	A	8	8	16	0	0	16	0	0
14	33835891	.	C	T	8	4	12	0	0	12	0	0
14	33838587	.	T	C	6	2	8	0	0	8	0	0
14	33838779	.	T	G	7	7	14	0	0	14	0	0
14	33838806	.	C	G	7	8	15	0	1	16	0	0
14	33842968	.	G	A	7	8	15	0	1	16	0	0
14	33843449	.	A	T	5	3	8	0	1	9	0	0
14	33847307	.	C	T	0	6	6	0	4	10	0	0
14	33848540	.	C	A	6	8	14	0	1	15	0	0
14	33848593	.	C	T	7	11	18	0	0	18	0	0
14	33850298	.	C	T	1	8	9	0	5	14	0	0
14	33850358	.	T	A	8	6	14	0	1	15	0	0
14	33860183	.	G	C	2	2	4	0	1	5	0	0
14	33860250	.	T	A	16	10	26	0	0	26	0	0
14	33860262	.	C	T	2	18	20	0	11	31	0	0
14	33860372	.	T	C	23	19	42	0	3	45	0	0
14	33860567	.	C	A	23	28	51	0	0	51	0	0
14	33864388	.	G	A	26	16	42	0	1	43	0	0
14	33865764	.	C	T	20	19	39	0	1	40	0	0
14	33865954	.	C	T	20	18	38	0	5	43	0	0
14	33866024	.	T	C	31	17	48	0	0	48	0	0
14	33872095	.	G	C	6	6	12	0	1	13	0	0
14	33883119	.	G	A	0	4	4	0	12	16	0	0
14	33883120	.	A	C	12	4	16	0	0	16	0	0
14	33883167	.	A	C	11	3	14	0	1	15	0	0
14	33883191	.	T	A	5	7	12	0	2	14	0	0
14	33889544	.	T	C	6	10	16	0	0	16	0	0
14	33891711	.	G	A	1	15	16	0	24	40	0	0
14	33892126	.	A	T	10	16	26	0	0	26	0	0
14	33892501	.	C	T	16	9	25	0	0	25	0	0
14	33893406	.	G	A	5	7	12	0	0	12	0	0
14	33894793	.	A	C	8	4	12	0	0	12	0	0
14	33894794	.	G	T	7	4	11	0	0	11	0	0
14	33899786	.	G	A	14	15	29	0	0	29	0	0
14	33899912	.	C	A	3	28	31	0	13	44	0	0
14	33900150	.	A	C	15	13	28	0	2	30	0	0
14	33900155	.	T	C	16	1	17	0	13	30	0	0
14	33900229	.	C	A	6	15	21	0	0	21	0	0
14	33900278	.	A	C	8	4	12	0	2	14	0	0
14	33900289	.	C	T	9	9	18	0	0	18	0	0
14	33900561	.	T	A	20	10	30	0	1	31	0	0
14	33900575	.	A	T	8	22	30	0	2	32	0	0
14	33900611	.	G	A	13	22	35	0	1	36	0	0
14	33900663	.	T	A	26	15	41	0	5	46	0	0
14	33900955	.	A	T	10	17	27	0	1	28	0	0
14	33901129	.	C	T	18	10	28	3	2	33	0	0
14	33901267	.	C	A	18	6	24	0	0	24	0	0
14	33901293	.	A	C	14	10	24	0	1	25	0	0
14	33901445	.	T	G	9	5	14	0	0	14	0	0
14	33901704	.	G	A	21	10	31	1	0	32	0	0
14	33901766	.	G	C	23	9	32	0	1	33	0	0
14	33901790	.	C	G	0	8	8	0	26	34	0	0
14	33901807	.	A	G	23	7	30	0	0	30	0	0
14	33901865	.	C	A	22	14	36	0	2	38	0	0
14	33901907	.	G	A	17	14	31	0	0	31	0	0
14	33901946	.	A	T	22	10	32	0	0	32	0	0
14	33901957	.	C	A	12	20	32	0	0	32	0	0
14	33901993	.	G	A	18	12	30	0	1	31	0	0
14	33902094	.	G	A	19	19	38	0	0	38	0	0
14	33903090	.	G	A	15	14	29	0	0	29	0	0
14	33909978	.	C	T	9	11	20	0	3	23	0	0
14	33916050	.	A	G	17	13	30	0	1	31	0	0
14	33916539	.	G	A	15	16	31	0	0	31	0	0
14	33936378	.	T	A	17	19	36	0	2	38	0	0
14	33936502	.	A	G	12	8	20	0	0	20	0	0
14	33941266	.	G	A	4	10	14	0	0	14	0	0
14	33941274	.	T	C	3	8	11	0	0	11	0	0
14	33941436	.	C	T	0	3	3	0	4	7	0	0
14	33941519	.	G	A	10	6	16	0	0	16	0	0
14	33943652	.	G	A	5	5	10	0	0	10	0	0
14	33945059	.	T	G	3	4	7	0	0	7	0	0
14	33945214	.	C	A	3	2	5	0	0	5	0	0
14	33945228	.	C	G	2	2	4	0	1	5	0	0
14	33945340	.	T	A	3	2	5	0	1	6	0	0
14	33983966	.	G	A	29	30	59	0	0	59	0	0
14	33984308	.	A	T	10	9	19	0	3	25	3	0
14	33984436	.	A	T	6	5	11	0	0	11	0	0
14	33984610	.	A	G	25	28	53	0	1	54	0	0
14	33987455	.	T	A	18	18	36	0	1	37	0	0
14	33989580	.	G	A	21	22	43	0	2	45	0	0
14	33991784	.	G	A	23	17	40	1	2	43	0	0
14	33991799	.	G	T	23	13	36	1	4	41	0	0
14	33997606	.	G	A	21	14	35	0	0	35	0	0
14	33997681	.	G	A	14	19	33	0	1	34	0	0
14	33997861	.	A	G	14	14	28	0	0	28	0	0
14	33997873	.	G	A	16	16	32	0	3	35	0	0
14	33998078	.	G	A	20	23	43	0	1	44	0	0
14	33998090	.	A	G	27	20	47	1	1	49	0	0
14	34002325	.	G	A	16	16	32	0	3	35	0	0
14	34002571	.	T	A	23	15	38	0	2	40	0	0
14	34013110	.	A	G	14	12	26	0	0	26	0	0
14	34044318	.	C	T	3	13	16	0	25	41	0	0
14	34064401	.	G	A	9	6	15	0	0	15	0	0
14	34065115	.	A	T	13	7	20	0	2	22	0	0
14	34065244	.	A	G	9	9	18	0	0	18	0	0
14	34065442	.	A	G	11	11	22	0	1	23	0	0
14	34065586	.	G	A	12	4	16	0	1	17	0	0
14	34065596	.	T	G	12	5	17	0	0	17	0	0
14	34065785	.	G	A	8	6	14	0	1	15	0	0
14	34068458	.	C	T	13	8	21	0	1	22	0	0
14	34068760	.	G	A	10	22	32	0	0	32	0	0
14	34075094	.	T	G	12	0	12	0	15	27	0	0
14	34077401	.	C	A	14	18	32	0	0	32	0	0
14	34082694	.	T	A	14	11	25	0	2	27	0	0
14	34089508	.	A	G	18	1	19	0	17	36	0	0
14	34089559	.	C	A	14	15	29	0	4	33	0	0
14	34089597	.	T	C	14	7	21	0	0	21	0	0
14	34089636	.	A	G	13	0	13	0	12	25	0	0
14	34089653	.	G	A	15	14	29	0	0	29	0	0
14	34089676	.	C	T	12	17	29	0	1	30	0	0
14	34089707	.	T	C	15	14	29	0	0	29	0	0
14	34090034	.	A	T	9	9	18	0	1	19	0	0
14	34090093	.	A	C	15	10	25	0	0	25	0	0
14	34090169	.	T	C	7	10	17	0	0	17	0	0
14	34090228	.	G	A	11	6	17	0	2	19	0	0
14	34090248	.	C	G	13	8	21	0	0	21	0	0
14	34090315	.	T	G	12	11	23	0	0	23	0	0
14	34090342	.	G	A	13	7	20	0	0	20	0	0
14	34090647	.	G	A	0	13	13	0	14	27	0	0
14	34091123	.	G	T	4	9	13	0	0	13	0	0
14	34091238	.	C	A	14	6	20	0	2	22	0	0
14	34091423	.	C	T	15	8	23	0	0	23	0	0
14	34091461	.	G	T	12	5	17	0	1	18	0	0
14	34091717	.	T	G	11	16	27	0	0	27	0	0
14	34091787	.	T	A	11	14	25	0	0	25	0	0
14	34092369	.	C	T	10	20	30	0	2	32	0	0
14	34092507	.	T	G	9	15	24	0	0	24	0	0
14	34125961	.	C	A	5	3	8	0	1	9	0	0
14	34126061	.	T	A	6	2	8	0	0	8	0	0
14	34126353	.	A	T	20	23	43	0	0	43	0	0
14	34128023	.	C	T	5	3	8	0	0	8	0	0
14	34128066	.	T	A	2	2	4	0	0	4	0	0
14	34128223	.	C	A	3	2	5	0	0	6	1	0
14	34128399	.	A	C	12	13	25	0	3	28	0	0
14	34128477	.	A	C	22	3	25	0	13	38	0	0
14	34128528	.	C	T	17	16	33	0	1	34	0	0
14	34128744	.	G	A	13	16	29	0	0	29	0	0
14	34128796	.	G	T	16	8	24	0	0	24	0	0
14	34128799	.	C	T	1	13	14	0	8	22	0	0
14	34129092	.	C	T	0	18	18	0	7	25	0	0
14	34129433	.	T	G	17	9	26	0	1	27	0	0
14	34129502	.	G	T	11	20	31	0	2	33	0	0
14	34129644	.	T	A	3	12	15	0	1	16	0	0
14	34129724	.	C	T	8	13	21	0	0	21	0	0
14	34129780	.	T	C	11	4	15	0	1	16	0	0
14	34129878	.	A	G	9	8	17	0	1	18	0	0
14	34129937	.	G	A	9	11	20	0	0	20	0	0
14	34129946	.	G	A	9	7	16	0	0	16	0	0
14	34130042	.	A	G	1	4	5	4	0	9	0	0
14	34130170	.	C	T	0	5	5	1	2	8	0	0
14	34130171	.	A	G	5	2	7	1	0	8	0	0
14	34130397	.	C	T	8	4	12	0	0	12	0	0
14	34130458	.	G	A	8	5	13	0	0	13	0	0
14	34130548	.	G	A	2	2	4	0	0	4	0	0
14	34130690	.	C	T	8	4	12	0	1	13	0	0
14	34131056	.	T	C	15	16	31	0	0	31	0	0
14	34139713	.	G	A	8	10	18	0	0	18	0	0
14	34154746	.	C	T	2	6	8	0	13	21	0	0
14	34180461	.	A	G	7	5	12	0	1	13	0	0
14	34180491	.	G	A	8	5	13	0	1	14	0	0
14	34180530	.	T	C	10	0	10	0	6	16	0	0
14	34180557	.	T	G	11	6	17	0	0	17	0	0
14	34191157	.	G	A	7	7	14	0	0	14	0	0
14	34194564	.	A	G	12	11	23	0	0	23	0	0
14	34195879	.	C	T	1	7	8	0	15	23	0	0
14	34210820	.	G	A	2	9	11	0	0	11	0	0
14	34210874	.	C	A	0	8	8	0	6	14	0	0
14	34210898	.	C	T	6	5	11	0	0	11	0	0
14	34240844	.	G	A	7	5	12	0	0	12	0	0
14	34240889	.	C	T	5	7	12	0	0	12	0	0
14	34486720	.	A	G	12	0	12	0	11	23	0	0
14	34487972	.	C	T	34	46	80	0	2	82	0	0
14	34488456	.	T	C	8	21	29	0	2	31	0	0
14	34488687	.	C	A	26	7	33	0	1	34	0	0
14	34488843	.	C	A	19	5	24	0	0	24	0	0
14	34488929	.	C	T	6	2	8	0	0	8	0	0
14	34550829	.	C	T	5	4	9	0	0	9	0	0
14	34553445	.	C	T	4	3	7	0	1	8	0	0
14	34553502	.	A	G	2	3	5	0	0	5	0	0
14	34553535	.	G	A	2	3	5	0	2	7	0	0
14	34556758	.	C	T	6	10	16	0	0	16	0	0
14	34556986	.	C	T	6	5	11	0	0	11	0	0
14	34635347	.	T	C	3	0	3	0	3	6	0	0
14	34637134	.	A	T	4	6	10	0	1	11	0	0
14	34648339	.	C	A	1	3	4	0	0	4	0	0
14	34657047	.	G	A	2	2	4	0	0	4	0	0
14	34658139	.	G	T	5	3	8	0	0	8	0	0
14	34672611	.	C	T	3	8	11	0	1	12	0	0
14	34712839	.	G	A	2	3	5	0	0	5	0	0
14	34790404	.	A	G	2	3	5	0	0	5	0	0
14	34790533	.	A	T	2	4	6	0	0	6	0	0
14	34791125	.	G	T	0	3	3	0	1	4	0	0
14	34791301	.	T	C	4	2	6	0	0	6	0	0
14	34791645	.	T	C	1	4	5	0	0	5	0	0
14	34791664	.	C	G	1	5	6	0	0	6	0	0
14	34794940	.	A	T	3	3	6	0	0	6	0	0
14	34797681	.	G	T	7	6	13	0	0	13	0	0
14	34797711	.	T	C	7	7	14	0	1	15	0	0
14	34797810	.	C	A	7	4	11	1	0	12	0	0
14	34797908	.	T	C	1	4	5	0	1	6	0	0
14	34797972	.	C	T	4	4	8	0	0	8	0	0
14	34798095	.	T	A	4	3	7	0	0	7	0	0
14	34825761	.	A	G	1	5	6	0	0	6	0	0
14	34826502	.	T	A	3	5	8	0	0	8	0	0
14	34826951	.	T	A	1	6	7	0	1	8	0	0
14	34828113	.	G	T	6	3	9	0	0	9	0	0
14	34830026	.	T	C	2	2	4	0	0	4	0	0
14	35003880	.	C	T	9	8	17	0	2	19	0	0
14	35008665	.	C	T	4	14	18	0	0	18	0	0
14	35008780	.	T	A	7	9	16	0	0	16	0	0
14	35008804	.	T	C	8	4	12	0	0	12	0	0
14	35008885	.	G	A	6	6	12	0	0	12	0	0
14	35008887	.	C	A	6	6	12	0	0	12	0	0
14	35009182	.	T	A	5	5	10	0	0	10	0	0
14	35009651	.	T	C	19	14	33	0	1	34	0	0
14	35009652	.	G	T	19	14	33	0	2	35	0	0
14	35009736	.	A	T	8	8	16	0	2	18	0	0
14	35009739	.	A	G	9	7	16	0	1	17	0	0
14	35009989	.	G	A	1	3	4	0	8	12	0	0
14	35010026	.	A	T	16	9	25	0	2	27	0	0
14	35010230	.	C	T	14	11	25	0	0	25	0	0
14	35010236	.	A	T	17	10	27	0	0	27	0	0
14	35010936	.	T	A	5	5	10	0	0	10	0	0
14	35011140	.	G	A	7	3	10	0	2	12	0	0
14	35011174	.	C	T	10	5	15	0	0	15	0	0
14	35011301	.	C	T	12	6	18	0	1	19	0	0
14	35011398	.	G	T	5	5	10	0	0	10	0	0
14	35011570	.	C	T	11	15	26	0	3	29	0	0
14	35011857	.	G	A	13	11	24	0	0	24	0	0
14	35011944	.	G	A	10	9	19	0	1	20	0	0
14	35024387	.	G	A	0	3	3	0	6	9	0	0
14	35025428	.	C	T	5	4	9	0	2	11	0	0
14	35046007	.	T	C	5	6	11	0	0	11	0	0
14	35167676	.	T	G	4	3	7	0	0	7	0	0
14	35167736	.	T	C	3	4	7	0	0	7	0	0
14	35227429	.	A	G	4	5	9	0	0	9	0	0
14	35227456	.	C	T	4	6	10	0	0	10	0	0
14	35376046	.	C	A	4	5	9	0	1	10	0	0
14	35377283	.	C	A	4	8	12	0	0	12	0	0
14	35377651	.	C	T	3	3	6	0	0	6	0	0
14	35377690	.	T	C	4	3	7	0	1	8	0	0
14	35387769	.	G	A	4	2	6	0	0	6	0	0
14	35393022	.	G	A	3	2	5	0	0	5	0	0
14	35405767	.	A	C	1	3	4	0	0	4	0	0
14	35405776	.	C	T	1	2	3	0	0	3	0	0
14	35406431	.	A	G	1	2	3	0	0	3	0	0
14	35406432	.	A	C	1	2	3	0	0	3	0	0
14	35406716	.	C	A	1	3	4	0	0	4	0	0
14	35406911	.	C	T	3	7	10	0	1	11	0	0
14	35406930	.	C	G	3	8	11	0	0	11	0	0
14	35406953	.	T	C	4	3	7	0	0	7	0	0
14	35407463	.	A	C	2	5	7	0	1	8	0	0
14	35407789	.	T	A	1	4	5	0	0	5	0	0
14	35407835	.	A	G	2	4	6	0	0	6	0	0
14	35409510	.	A	G	6	2	8	0	0	8	0	0
14	35409635	.	G	C	3	0	3	0	4	7	0	0
14	35409643	.	A	G	4	3	7	0	0	7	0	0
14	35409689	.	G	A	2	3	5	0	0	5	0	0
14	35409784	.	T	G	7	7	14	0	0	14	0	0
14	35409838	.	A	T	6	7	13	0	0	13	0	0
14	35409903	.	A	T	7	4	11	0	1	12	0	0
14	35409940	.	G	T	3	3	6	0	0	6	0	0
14	35409944	.	C	A	3	3	6	0	0	7	1	0
14	35410583	.	G	A	8	4	12	0	0	12	0	0
14	35410992	.	G	A	7	9	16	0	2	18	0	0
14	35411076	.	C	T	9	8	17	0	3	20	0	0
14	35422383	.	G	A	2	2	4	0	0	4	0	0
14	35478466	.	G	A	0	3	3	0	2	5	0	0
14	35484206	.	C	T	2	5	7	0	0	7	0	0
14	35484215	.	G	A	1	4	5	0	1	6	0	0
14	35484242	.	G	A	2	3	5	0	0	5	0	0
14	35500249	.	G	T	9	9	18	0	0	18	0	0
14	35500300	.	A	C	9	0	9	0	5	14	0	0
14	35505312	.	C	A	2	9	11	0	8	19	0	0
14	35505376	.	C	A	4	9	13	0	0	13	0	0
14	35567785	.	T	C	2	2	4	0	0	4	0	0
14	35571296	.	G	A	2	4	6	0	0	6	0	0
14	35571631	.	G	A	3	2	5	0	1	6	0	0
14	35692149	.	A	G	16	23	39	0	0	39	0	0
14	35699039	.	G	A	26	15	41	0	1	42	0	0
14	35699109	.	C	A	23	16	39	0	2	41	0	0
14	35715815	.	T	C	24	19	43	0	1	44	0	0
14	35719354	.	G	A	17	19	36	1	0	37	0	0
14	35731558	.	C	T	28	29	57	0	1	58	0	0
14	35732110	.	C	T	15	6	21	0	0	21	0	0
14	35780186	.	G	A	3	24	27	0	27	54	0	0
14	35780249	.	G	A	23	19	42	0	2	44	0	0
14	35796120	.	C	T	17	20	37	0	1	38	0	0
14	35797645	.	T	A	22	17	39	1	2	43	1	0
14	35797654	.	G	A	4	22	26	1	18	45	0	0
14	35799400	.	G	A	22	20	42	0	1	43	0	0
14	35799409	.	C	T	20	19	39	0	1	40	0	0
14	35800228	.	T	C	28	17	45	0	1	46	0	0
14	35804592	.	T	C	29	23	52	0	2	54	0	0
14	35804688	.	G	A	28	28	56	0	0	56	0	0
14	35804833	.	A	G	27	26	53	2	0	55	0	0
14	35811971	.	C	T	34	30	64	0	4	68	0	0
14	35812355	.	G	A	27	25	52	0	1	54	1	0
14	35812718	.	C	A	26	15	41	0	1	42	0	0
14	35813114	.	A	T	9	6	15	0	0	15	0	0
14	35813121	.	T	A	2	15	17	0	3	20	0	0
14	35813367	.	C	A	26	25	51	0	0	51	0	0
14	35813384	.	G	A	3	31	34	0	22	56	0	0
14	35813407	.	C	T	32	26	58	0	2	61	1	0
14	35813424	.	C	T	32	24	56	0	1	57	0	0
14	35813479	.	T	A	31	18	49	0	1	50	0	0
14	35895983	.	G	A	3	2	5	1	0	6	0	0
14	35896005	.	T	C	1	2	3	1	0	4	0	0
14	35896106	.	A	G	5	4	9	0	1	10	0	0
14	35897751	.	A	T	2	3	5	0	1	6	0	0
14	35900037	.	C	T	3	4	7	0	0	7	0	0
14	35906345	.	C	A	1	6	7	0	0	7	0	0
14	36220744	.	G	T	1	2	3	0	1	4	0	0
14	36226425	.	A	G	1	0	1	0	1	2	0	0
14	36226435	.	C	T	1	1	2	0	1	3	0	0
14	36226685	.	G	A	0	3	3	0	1	4	0	0
14	36229211	.	T	A	3	2	5	0	0	5	0	0
14	36229415	.	C	T	2	2	4	0	0	4	0	0
14	36246854	.	C	T	18	19	37	0	2	39	0	0
14	36259377	.	G	A	0	14	14	0	13	27	0	0
14	36267395	.	C	A	16	20	36	0	2	38	0	0
14	36268152	.	C	T	12	11	23	0	1	24	0	0
14	36268339	.	C	T	12	19	31	0	0	31	0	0
14	36268426	.	T	C	9	11	20	0	0	20	0	0
14	36329402	.	G	T	1	3	4	0	0	4	0	0
14	36329508	.	G	T	1	2	3	0	0	3	0	0
14	36329525	.	G	A	1	2	3	0	0	3	0	0
14	36332574	.	G	T	2	2	4	0	0	4	0	0
14	36348793	.	A	G	4	10	14	0	0	14	0	0
14	36348878	.	G	A	11	28	39	0	1	40	0	0
14	36349387	.	A	T	35	32	67	0	7	74	0	0
14	36349409	.	A	G	38	27	65	0	11	76	0	0
14	36349607	.	C	G	9	34	43	0	36	79	0	0
14	36350639	.	G	T	35	28	63	0	3	66	0	0
14	36350669	.	T	C	34	0	34	0	32	66	0	0
14	36350917	.	A	T	41	23	64	0	5	69	0	0
14	36350932	.	T	A	39	24	63	0	3	66	0	0
14	36350980	.	T	C	38	3	41	1	32	74	0	0
14	36351004	.	C	T	31	45	76	1	1	79	1	0
14	36351064	.	G	A	53	22	75	0	1	76	0	0
14	36351143	.	A	G	48	27	75	0	3	78	0	0
14	36351148	.	C	T	47	25	72	0	3	75	0	0
14	36351209	.	G	A	45	21	66	0	0	66	0	0
14	36351217	.	A	G	42	22	64	0	1	65	0	0
14	36351350	.	C	T	39	28	67	0	2	69	0	0
14	36352148	.	T	C	28	5	33	0	36	69	0	0
14	36352265	.	G	A	48	41	89	0	3	93	1	0
14	36363689	.	G	A	38	32	70	0	4	74	0	0
14	36428665	.	T	G	3	2	5	0	0	5	0	0
14	36430603	.	G	T	3	8	11	0	0	11	0	0
14	36433568	.	T	C	4	0	4	0	10	14	0	0
14	36434258	.	C	T	8	4	12	0	0	12	0	0
14	36437217	.	C	A	5	6	11	0	0	11	0	0
14	36437234	.	G	C	5	4	9	0	0	9	0	0
14	36497529	.	T	C	2	5	7	0	0	7	0	0
14	36497589	.	A	G	3	0	3	0	5	8	0	0
14	36497659	.	C	T	10	5	15	0	0	15	0	0
14	36633786	.	T	G	5	2	7	0	0	7	0	0
14	36638417	.	C	T	4	7	11	0	0	11	0	0
14	36642177	.	G	A	4	6	10	0	0	10	0	0
14	36660823	.	A	C	2	4	6	0	0	6	0	0
14	36676112	.	T	G	5	5	10	0	1	11	0	0
14	36676187	.	A	T	4	3	7	0	0	7	0	0
14	36681650	.	G	A	8	3	11	0	0	11	0	0
14	36700371	.	T	C	5	4	9	0	1	10	0	0
14	36700380	.	T	C	7	3	10	0	0	10	0	0
14	36708609	.	T	C	5	4	9	0	0	9	0	0
14	36708741	.	T	C	4	8	12	0	1	13	0	0
14	36708909	.	A	G	6	6	12	0	0	12	0	0
14	36713653	.	A	G	2	0	2	0	6	8	0	0
14	36717107	.	T	C	4	5	9	0	0	9	0	0
14	36717230	.	T	C	9	5	14	0	1	15	0	0
14	36717315	.	A	G	8	0	8	0	7	15	0	0
14	36717320	.	A	G	9	8	17	0	0	17	0	0
14	36717629	.	T	C	2	2	4	0	1	5	0	0
14	36717689	.	C	T	1	7	8	0	0	8	0	0
14	36717800	.	G	A	3	4	7	0	0	7	0	0
14	36720770	.	C	T	10	7	17	0	1	18	0	0
14	36721102	.	T	A	9	8	17	0	1	19	1	0
14	36721153	.	G	A	12	5	17	0	0	17	0	0
14	36721175	.	C	G	9	7	16	0	0	16	0	0
14	36721229	.	G	A	7	9	16	0	0	16	0	0
14	36721379	.	G	C	5	10	15	0	1	16	0	0
14	36721437	.	G	A	1	7	8	0	5	13	0	0
14	36721497	.	C	G	4	11	15	0	1	16	0	0
14	36721564	.	G	A	5	3	8	0	0	8	0	0
14	36721599	.	C	A	4	2	6	0	0	6	0	0
14	36721675	.	T	C	5	4	9	0	1	10	0	0
14	36721676	.	G	A	5	5	10	0	0	10	0	0
14	36721724	.	T	A	4	7	11	0	0	11	0	0
14	36721730	.	T	A	5	6	11	0	0	11	0	0
14	36722015	.	C	T	4	9	13	0	0	13	0	0
14	36722095	.	T	C	11	9	20	0	0	20	0	0
14	36722140	.	C	A	6	4	10	0	0	10	0	0
14	36722364	.	C	T	8	12	20	0	0	20	0	0
14	36722405	.	G	A	8	11	19	0	1	20	0	0
14	36722568	.	A	T	9	9	18	0	2	20	0	0
14	36722601	.	T	G	7	1	8	0	8	16	0	0
14	36722904	.	G	A	0	3	3	0	10	13	0	0
14	36723134	.	A	T	5	7	12	0	0	12	0	0
14	36723213	.	G	A	8	7	15	0	0	15	0	0
14	36723270	.	A	G	8	0	8	0	5	13	0	0
14	36723276	.	T	C	8	5	13	0	2	15	0	0
14	36723326	.	C	T	11	7	18	0	0	18	0	0
14	36723402	.	C	G	10	6	16	0	0	16	0	0
14	36723690	.	C	G	6	8	14	0	0	14	0	0
14	36723694	.	C	A	6	9	15	0	1	16	0	0
14	36752477	.	T	C	5	3	8	0	0	8	0	0
14	36758413	.	A	C	3	0	3	0	3	6	0	0
14	36758452	.	T	C	4	6	10	0	1	11	0	0
14	36761340	.	A	C	7	0	7	0	3	10	0	0
14	36761663	.	C	T	3	4	7	0	0	7	0	0
14	36763060	.	A	G	3	3	6	0	0	6	0	0
14	36763156	.	A	T	2	4	6	0	1	7	0	0
14	36763191	.	A	T	5	6	11	0	0	11	0	0
14	36763225	.	A	G	6	8	14	0	0	14	0	0
14	36765662	.	G	A	7	3	10	0	1	11	0	0
14	36765721	.	C	T	11	5	16	0	0	16	0	0
14	36766273	.	A	T	12	14	26	0	0	26	0	0
14	36766394	.	A	C	8	8	16	0	0	16	0	0
14	36766624	.	T	A	7	16	23	0	0	23	0	0
14	36777121	.	A	G	25	12	37	0	0	37	0	0
14	36803100	.	G	T	14	15	29	0	0	29	0	0
14	36803178	.	G	A	15	10	25	0	1	26	0	0
14	36863407	.	T	C	5	0	5	0	5	10	0	0
14	37553282	.	C	A	9	12	21	0	0	21	0	0
14	37553438	.	C	T	6	8	14	0	0	14	0	0
14	37553480	.	G	A	7	3	10	0	0	10	0	0
14	37553618	.	T	C	7	8	15	0	1	16	0	0
14	37556752	.	T	A	10	10	20	0	1	21	0	0
14	38656976	.	A	C	1	7	8	0	1	9	0	0
14	38659002	.	G	A	2	3	5	0	0	5	0	0
14	38663969	.	A	C	2	3	5	0	0	5	0	0
14	38663972	.	C	T	3	3	6	0	0	6	0	0
14	38668543	.	G	C	0	4	4	0	7	11	0	0
14	38668546	.	T	C	7	3	10	0	0	10	0	0
14	38668782	.	C	A	5	5	10	0	0	10	0	0
14	38668815	.	C	T	5	6	11	0	0	11	0	0
14	38668863	.	T	C	3	5	8	0	0	8	0	0
14	38669487	.	A	G	3	2	5	0	1	6	0	0
14	38669562	.	G	T	0	4	4	0	3	7	0	0
14	38672310	.	A	G	5	0	5	0	9	14	0	0
14	38672521	.	G	T	4	10	14	0	0	14	0	0
14	38678070	.	C	T	3	4	7	0	1	8	0	0
14	38688730	.	G	A	4	6	10	0	0	10	0	0
14	38688793	.	A	C	6	5	11	0	0	11	0	0
14	38688794	.	A	T	8	2	10	0	1	11	0	0
14	38688829	.	G	C	3	9	12	0	0	12	0	0
14	38689174	.	G	A	5	4	9	0	0	9	0	0
14	38689332	.	A	G	6	7	13	0	0	13	0	0
14	38689409	.	A	C	2	6	8	0	0	8	0	0
14	38689428	.	G	C	3	4	7	0	0	7	0	0
14	38763334	.	A	C	21	11	32	0	1	33	0	0
14	38763381	.	G	A	12	18	30	0	2	32	0	0
14	38763394	.	G	A	21	11	32	0	0	33	1	0
14	38783272	.	T	C	17	13	30	1	3	34	0	0
14	38796156	.	C	G	9	5	14	0	1	15	0	0
14	38799419	.	G	A	4	2	6	0	0	6	0	0
14	38802662	.	G	T	7	3	10	0	0	10	0	0
14	38802884	.	C	T	5	7	12	0	0	12	0	0
14	38802904	.	A	T	6	10	16	0	0	16	0	0
14	38802960	.	G	A	7	6	13	0	0	13	0	0
14	38802967	.	T	G	5	7	12	0	0	12	0	0
14	38803085	.	G	A	6	4	10	0	1	11	0	0
14	38803088	.	C	T	1	5	6	0	5	11	0	0
14	38806916	.	G	T	6	6	12	0	0	12	0	0
14	38809512	.	C	T	5	4	9	1	0	10	0	0
14	38809528	.	T	C	3	2	5	1	0	6	0	0
14	38818494	.	G	A	1	2	3	0	0	3	0	0
14	38845762	.	T	C	13	17	30	0	1	31	0	0
14	38845912	.	A	G	34	20	54	0	4	58	0	0
14	38846587	.	A	T	38	22	60	1	0	61	0	0
14	38847235	.	A	G	16	12	28	0	1	29	0	0
14	38847497	.	A	G	2	0	2	0	8	10	0	0
14	38849729	.	C	T	28	22	50	0	3	53	0	0
14	38849946	.	A	C	29	26	55	0	5	60	0	0
14	38853821	.	C	T	1	4	5	0	0	5	0	0
14	38862589	.	A	G	5	6	11	0	0	11	0	0
14	38862598	.	A	G	7	4	11	0	1	12	0	0
14	38865589	.	C	T	3	5	8	0	0	8	0	0
14	38869753	.	G	A	4	5	9	1	1	11	0	0
14	38872410	.	C	T	8	8	16	0	0	16	0	0
14	38872454	.	T	C	4	5	9	0	0	9	0	0
14	38875289	.	C	T	1	2	3	0	0	3	0	0
14	38878552	.	T	C	8	7	15	0	1	16	0	0
14	38881266	.	G	T	8	8	16	2	1	19	0	0
14	38881281	.	T	A	9	5	14	2	0	16	0	0
14	38882982	.	T	C	1	3	4	0	0	4	0	0
14	38937085	.	T	C	4	0	4	0	3	7	0	0
14	38937099	.	T	C	4	3	7	0	0	7	0	0
14	38937305	.	C	T	2	4	6	0	1	7	0	0
14	38941498	.	A	G	4	3	7	0	0	7	0	0
14	38946708	.	A	G	2	4	6	0	0	6	0	0
14	38946732	.	G	A	3	3	6	0	0	6	0	0
14	39002433	.	G	C	5	5	10	0	0	10	0	0
14	39002555	.	C	T	1	2	3	0	1	4	0	0
14	39002562	.	C	T	2	1	3	0	1	4	0	0
14	39002698	.	C	A	6	5	11	0	0	11	0	0
14	39002739	.	G	C	8	0	8	0	6	14	0	0
14	39002752	.	A	G	8	3	11	0	0	11	0	0
14	39002820	.	A	T	10	7	17	0	1	18	0	0
14	39002883	.	A	G	11	11	22	0	0	22	0	0
14	39003039	.	T	G	5	10	15	0	0	15	0	0
14	39074245	.	G	A	5	2	7	0	0	7	0	0
14	39258889	.	T	C	3	2	5	0	0	5	0	0
14	39458488	.	C	T	4	5	9	0	1	10	0	0
14	39608615	.	A	G	2	0	2	0	5	7	0	0
14	39953174	.	C	T	7	7	14	0	0	14	0	0
14	39953208	.	G	T	0	8	8	0	8	16	0	0
14	39953291	.	G	A	2	7	9	1	0	10	0	0
14	39953337	.	T	A	6	3	9	0	0	9	0	0
14	39953578	.	A	G	4	4	8	0	0	8	0	0
14	39954169	.	C	T	5	5	10	0	1	11	0	0
14	39954272	.	A	G	5	7	12	0	0	12	0	0
14	39954356	.	T	C	6	5	11	0	0	11	0	0
14	39954423	.	A	T	2	4	6	0	0	6	0	0
14	39954513	.	C	T	1	3	4	0	0	4	0	0
14	39954572	.	C	T	3	5	8	0	0	8	0	0
14	39954716	.	A	G	4	3	7	0	0	7	0	0
14	39954789	.	C	T	3	6	9	0	0	9	0	0
14	39954835	.	G	A	4	4	8	0	0	8	0	0
14	39954963	.	C	T	3	7	10	0	0	10	0	0
14	39955231	.	T	A	2	4	6	0	0	6	0	0
14	39955448	.	C	T	5	7	12	0	1	13	0	0
14	39955457	.	C	A	6	6	12	0	0	12	0	0
14	39955612	.	A	T	4	5	9	0	0	9	0	0
14	39955646	.	T	C	5	2	7	2	0	9	0	0
14	39955772	.	T	A	5	7	12	0	1	13	0	0
14	39955823	.	T	C	10	8	18	0	0	18	0	0
14	39956075	.	G	A	8	8	16	0	2	18	0	0
14	39956380	.	T	C	5	6	11	0	1	12	0	0
14	39956426	.	G	A	2	7	9	0	0	9	0	0
14	39956690	.	A	C	4	3	7	0	0	7	0	0
14	39956804	.	G	T	6	5	11	0	0	11	0	0
14	39956825	.	T	C	5	4	9	0	0	9	0	0
14	39957077	.	C	G	4	11	15	0	0	15	0	0
14	40303348	.	A	T	12	14	26	0	0	26	0	0
14	40303366	.	C	T	11	10	21	0	1	22	0	0
14	40303795	.	T	C	17	3	20	0	1	21	0	0
14	40304488	.	C	G	3	10	13	1	15	29	0	0
14	40305230	.	G	A	23	10	33	0	0	33	0	0
14	40305287	.	C	A	1	27	28	0	17	45	0	0
14	40305635	.	C	T	3	23	26	0	22	48	0	0
14	40305659	.	C	T	3	18	21	0	18	39	0	0
14	40387603	.	C	T	16	19	35	0	1	36	0	0
14	40387627	.	G	A	17	14	31	0	1	32	0	0
14	40388107	.	A	G	18	17	35	0	1	36	0	0
14	40388185	.	A	G	19	11	30	0	1	31	0	0
14	40388440	.	G	A	20	17	37	0	1	38	0	0
14	40388460	.	T	G	16	18	34	0	2	36	0	0
14	40388629	.	T	C	9	17	26	0	0	26	0	0
14	40389145	.	C	G	13	10	23	0	3	26	0	0
14	40389789	.	A	T	12	8	20	0	0	20	0	0
14	40389823	.	T	A	14	10	24	0	1	25	0	0
14	40389978	.	C	T	8	8	16	0	0	16	0	0
14	40389988	.	T	A	10	10	20	0	1	21	0	0
14	40390192	.	T	G	5	4	9	0	0	9	0	0
14	40390587	.	G	T	9	5	14	0	0	14	0	0
14	40747262	.	T	A	2	3	5	0	0	5	0	0
14	40852670	.	A	T	11	5	16	0	0	16	0	0
14	40852732	.	T	C	13	13	26	0	0	26	0	0
14	40853268	.	C	G	18	9	27	0	0	27	0	0
14	40857654	.	T	G	11	11	22	0	2	24	0	0
14	40857711	.	G	A	13	11	24	0	3	27	0	0
14	40857881	.	T	C	17	11	28	0	1	29	0	0
14	40857977	.	C	T	12	16	28	0	0	28	0	0
14	40859179	.	A	G	13	0	13	0	14	27	0	0
14	40860291	.	T	A	15	20	35	0	0	35	0	0
14	40860354	.	C	T	22	21	43	0	1	44	0	0
14	40863062	.	A	G	19	18	37	0	2	39	0	0
14	40863161	.	T	C	17	16	33	0	0	33	0	0
14	40863176	.	A	G	20	17	37	0	1	38	0	0
14	40869331	.	C	A	17	21	38	0	1	39	0	0
14	40869895	.	T	C	17	17	34	0	0	34	0	0
14	40874026	.	G	T	2	3	5	0	0	5	0	0
14	40929383	.	C	T	1	3	4	0	1	5	0	0
14	41262520	.	G	A	2	2	4	0	0	4	0	0
14	41276516	.	T	A	4	7	11	0	1	12	0	0
14	41276608	.	G	A	7	7	14	1	1	16	0	0
14	41277391	.	A	T	4	15	19	0	0	19	0	0
14	41277424	.	C	A	3	16	19	0	0	19	0	0
14	41277556	.	A	G	28	21	49	0	2	51	0	0
14	41277624	.	A	T	28	26	54	0	0	54	0	0
14	41278238	.	T	A	23	21	44	2	1	47	0	0
14	41278255	.	A	G	20	19	39	2	0	41	0	0
14	41278386	.	C	T	34	10	44	0	0	44	0	0
14	41278658	.	T	G	15	12	27	0	1	28	0	0
14	41278754	.	C	G	5	10	15	0	0	15	0	0
14	41279133	.	C	T	15	16	31	2	0	33	0	0
14	41279214	.	C	T	19	18	37	3	2	42	0	0
14	41279277	.	G	C	25	20	45	0	2	47	0	0
14	41279479	.	T	A	14	7	21	0	1	22	0	0
14	41279527	.	C	T	1	21	22	0	9	31	0	0
14	41279542	.	C	A	3	11	14	0	24	38	0	0
14	41279624	.	G	A	26	13	39	2	1	43	1	0
14	41279974	.	T	G	17	19	36	0	0	36	0	0
14	41279977	.	G	T	17	19	36	0	0	36	0	0
14	41280013	.	G	A	12	22	34	0	0	34	0	0
14	41280149	.	G	A	24	24	48	0	4	52	0	0
14	41280228	.	A	G	28	14	42	0	5	47	0	0
14	41280517	.	G	C	23	22	45	0	0	45	0	0
14	41318507	.	C	T	4	5	9	0	0	9	0	0
14	41333519	.	A	G	5	4	9	0	0	9	0	0
14	41339309	.	T	C	3	2	5	0	0	5	0	0
14	41339820	.	G	C	5	4	9	0	0	9	0	0
14	41339972	.	G	A	0	5	5	0	3	8	0	0
14	41340042	.	A	C	2	2	4	0	1	5	0	0
14	41340054	.	T	A	3	3	6	0	1	7	0	0
14	41340081	.	A	T	5	3	8	0	1	9	0	0
14	41340172	.	A	C	3	2	5	0	1	6	0	0
14	41340231	.	G	A	3	3	6	0	0	6	0	0
14	41361985	.	C	T	2	6	8	0	12	20	0	0
14	41362007	.	G	A	18	7	25	0	2	27	0	0
14	41362060	.	C	T	14	6	20	0	0	20	0	0
14	41366823	.	G	A	16	16	32	0	0	32	0	0
14	41366889	.	C	A	14	16	30	0	2	32	0	0
14	41385823	.	G	A	12	15	27	0	1	28	0	0
14	41385895	.	C	T	1	14	15	0	12	27	0	0
14	41414242	.	C	A	6	2	8	0	0	8	0	0
14	41414483	.	C	A	2	1	3	0	2	5	0	0
14	41414857	.	C	T	3	6	9	0	0	9	0	0
14	41428500	.	C	T	12	8	20	0	1	21	0	0
14	41435662	.	C	T	10	4	14	0	0	14	0	0
14	41436773	.	T	A	8	12	20	0	0	20	0	0
14	41436943	.	C	T	9	4	13	0	0	13	0	0
14	41438005	.	G	A	6	5	11	0	0	11	0	0
14	41466483	.	T	A	5	3	8	0	0	8	0	0
14	41466522	.	G	A	7	9	16	0	0	16	0	0
14	41466922	.	T	A	20	13	33	0	0	33	0	0
14	41467152	.	T	C	19	15	34	0	3	37	0	0
14	41467155	.	C	T	15	18	33	0	3	36	0	0
14	41467356	.	C	G	13	15	28	1	0	29	0	0
14	41469662	.	C	A	6	4	10	0	0	10	0	0
14	41469761	.	G	T	1	2	3	0	0	3	0	0
14	41469925	.	T	A	4	4	8	0	0	8	0	0
14	41469935	.	C	T	5	3	8	0	0	8	0	0
14	41470032	.	C	T	0	7	7	0	2	9	0	0
14	41470037	.	A	T	3	6	9	0	0	9	0	0
14	41507244	.	G	C	1	4	5	0	0	5	0	0
14	41510859	.	A	G	0	4	4	0	0	4	0	0
14	41510862	.	G	T	2	3	5	0	0	5	0	0
14	41513529	.	C	G	2	2	4	1	0	5	0	0
14	41513544	.	G	C	1	2	3	1	0	4	0	0
14	44824713	.	A	G	4	2	6	0	0	6	0	0
14	45294104	.	A	G	12	0	12	0	9	21	0	0
14	45295547	.	A	G	4	5	9	0	0	9	0	0
14	45327791	.	G	A	0	5	5	0	9	14	0	0
14	45327811	.	C	A	11	3	14	0	0	14	0	0
14	45327826	.	C	T	10	3	13	0	0	13	0	0
14	45332635	.	T	C	3	8	11	0	0	11	0	0
14	45334843	.	T	A	5	5	10	0	0	10	0	0
14	45334912	.	T	G	10	3	13	0	0	13	0	0
14	45335027	.	C	T	6	11	17	0	0	17	0	0
14	45335175	.	G	A	14	10	24	0	1	25	0	0
14	45335283	.	A	G	14	10	24	0	1	25	0	0
14	45340258	.	A	T	18	17	35	0	0	35	0	0
14	45340358	.	G	A	12	9	21	0	2	23	0	0
14	45340620	.	G	C	5	1	6	0	6	12	0	0
14	45340758	.	C	G	13	10	23	2	0	25	0	0
14	45340916	.	C	T	18	11	29	0	1	30	0	0
14	45340988	.	C	T	17	5	22	0	3	25	0	0
14	45341011	.	G	T	11	12	23	0	0	23	0	0
14	45341061	.	T	C	11	16	27	0	2	29	0	0
14	45341107	.	T	C	10	10	20	0	2	22	0	0
14	45341115	.	G	A	10	11	21	0	0	21	0	0
14	45341288	.	A	C	11	0	11	0	7	18	0	0
14	45341442	.	A	C	16	16	32	0	1	33	0	0
14	45341645	.	T	C	11	6	17	0	4	22	1	0
14	45341762	.	T	C	9	20	29	0	6	35	0	0
14	45341949	.	G	T	9	7	16	0	3	19	0	0
14	45341958	.	T	G	10	8	18	0	2	20	0	0
14	45342250	.	A	C	19	7	26	0	0	26	0	0
14	45342266	.	A	T	15	10	25	0	1	26	0	0
14	45342385	.	C	T	15	12	27	0	0	27	0	0
14	45342431	.	G	T	17	9	26	0	0	26	0	0
14	45342981	.	G	T	12	8	20	0	0	20	0	0
14	45343283	.	A	G	11	10	21	0	0	21	0	0
14	45343297	.	G	C	13	9	22	0	1	23	0	0
14	45343370	.	G	A	17	12	29	0	2	31	0	0
14	45343400	.	C	G	2	19	21	0	13	34	0	0
14	45343409	.	C	T	14	16	30	0	5	35	0	0
14	45346148	.	A	G	14	15	29	0	0	29	0	0
14	45346184	.	C	T	1	14	15	0	20	35	0	0
14	45346257	.	A	G	17	14	31	0	1	32	0	0
14	45346465	.	A	T	12	12	24	0	0	25	1	0
14	45365573	.	G	C	10	0	10	0	13	23	0	0
14	45365684	.	G	A	10	15	25	0	1	26	0	0
14	45367166	.	C	T	7	8	15	0	0	15	0	0
14	45367557	.	A	G	2	6	8	0	1	9	0	0
14	45367757	.	A	G	14	10	24	0	0	24	0	0
14	45422577	.	A	T	2	3	5	0	0	5	0	0
14	45435437	.	C	T	5	3	8	0	1	9	0	0
14	45435444	.	G	A	7	4	11	0	0	11	0	0
14	45435592	.	T	C	3	3	6	0	0	6	0	0
14	45435731	.	G	A	6	3	9	0	1	10	0	0
14	45435766	.	A	T	6	2	8	0	0	8	0	0
14	45435822	.	C	A	6	4	10	0	0	10	0	0
14	45435832	.	T	A	8	5	13	0	0	13	0	0
14	45436018	.	C	T	3	4	7	0	2	9	0	0
14	45442998	.	A	G	4	3	7	0	1	8	0	0
14	45472337	.	T	C	17	17	34	0	0	34	0	0
14	45482108	.	A	G	9	1	10	0	8	18	0	0
14	45506353	.	G	A	2	2	4	0	0	4	0	0
14	45515059	.	C	T	3	5	8	0	0	8	0	0
14	45515255	.	A	T	18	24	42	0	0	42	0	0
14	45530665	.	T	C	6	4	10	0	4	14	0	0
14	45534043	.	T	G	5	5	10	0	1	11	0	0
14	45534178	.	A	G	9	13	22	0	0	22	0	0
14	45534256	.	A	G	9	13	22	0	1	23	0	0
14	45534262	.	C	T	0	12	12	0	9	21	0	0
14	45542357	.	T	A	12	7	19	0	1	20	0	0
14	45548614	.	G	A	6	6	12	0	1	13	0	0
14	45549643	.	A	T	10	9	19	0	0	19	0	0
14	45552410	.	A	G	2	3	5	0	0	5	0	0
14	45552452	.	G	A	2	2	4	0	0	4	0	0
14	45553642	.	T	A	1	2	3	0	0	3	0	0
14	45553885	.	T	C	2	3	5	0	0	5	0	0
14	45554089	.	A	C	2	2	4	0	0	4	0	0
14	45554374	.	A	T	4	2	6	0	0	6	0	0
14	45555063	.	G	A	1	1	2	0	1	3	0	0
14	45555686	.	G	C	3	2	5	0	0	5	0	0
14	45565914	.	G	T	8	4	12	0	0	12	0	0
14	45565915	.	A	T	8	4	12	0	0	12	0	0
14	45568736	.	G	T	9	11	20	0	0	20	0	0
14	45570967	.	G	A	12	14	26	0	2	28	0	0
14	45571124	.	A	T	7	14	21	0	0	21	0	0
14	45571501	.	G	A	6	11	17	0	1	18	0	0
14	45571593	.	C	T	13	8	21	1	1	23	0	0
14	45571679	.	T	C	6	7	13	0	0	13	0	0
14	45575139	.	G	A	7	2	9	0	0	9	0	0
14	45575336	.	A	G	12	9	21	0	2	23	0	0
14	45575495	.	T	C	13	10	23	1	0	24	0	0
14	45581382	.	T	C	15	12	27	0	0	27	0	0
14	45582312	.	C	A	3	10	13	0	15	28	0	0
14	45582314	.	T	A	14	10	24	0	2	26	0	0
14	45584078	.	T	C	8	0	8	0	9	17	0	0
14	45584312	.	T	C	6	6	12	0	0	12	0	0
14	45586237	.	G	A	11	13	24	0	0	24	0	0
14	45590653	.	T	A	4	8	12	0	1	13	0	0
14	45592634	.	T	C	14	7	21	0	1	22	0	0
14	45594741	.	C	T	6	5	11	1	0	12	0	0
14	45594753	.	T	C	5	6	11	0	0	11	0	0
14	45594792	.	G	C	10	0	10	0	6	16	0	0
14	45600354	.	T	G	2	2	4	0	1	5	0	0
14	45600360	.	C	T	4	2	6	0	0	6	0	0
14	45603820	.	T	G	5	2	7	0	0	7	0	0
14	45603828	.	C	A	2	2	4	0	6	10	0	0
14	45603976	.	G	A	6	2	8	0	0	8	0	0
14	45604392	.	C	T	2	6	8	0	12	20	0	0
14	45608886	.	A	G	12	11	23	0	0	23	0	0
14	45614526	.	C	G	4	0	4	0	9	13	0	0
14	45631345	.	C	T	4	11	15	0	7	22	0	0
14	45631716	.	C	T	15	22	37	0	0	37	0	0
14	45631768	.	G	T	22	23	45	0	5	50	0	0
14	45632834	.	A	C	25	39	64	0	3	67	0	0
14	45632967	.	T	C	18	1	19	0	29	48	0	0
14	45634860	.	A	T	34	44	78	0	2	80	0	0
14	45634960	.	C	T	9	25	34	1	17	52	0	0
14	45635333	.	C	T	8	44	52	0	35	87	0	0
14	45635767	.	T	C	39	42	81	1	9	91	0	0
14	45636078	.	A	G	39	3	42	2	3	47	0	0
14	45636657	.	A	G	52	11	63	1	6	70	0	0
14	45636701	.	G	A	46	14	60	0	0	60	0	0
14	45636800	.	A	G	36	18	54	2	16	72	0	0
14	45637058	.	C	G	25	23	48	0	1	49	0	0
14	45637103	.	A	C	24	2	26	0	26	52	0	0
14	45637200	.	C	T	33	39	72	0	4	76	0	0
14	45637201	.	T	A	33	40	73	0	3	76	0	0
14	45637382	.	A	G	34	26	60	0	0	60	0	0
14	45637545	.	T	G	17	21	38	0	7	45	0	0
14	45637702	.	C	T	47	19	66	0	4	70	0	0
14	45637804	.	G	T	25	33	58	14	5	77	0	0
14	45638280	.	G	C	21	42	63	0	3	66	0	0
14	45638509	.	C	T	16	23	39	0	2	41	0	0
14	45638562	.	T	G	28	17	45	0	0	45	0	0
14	45638563	.	T	A	28	16	44	0	1	45	0	0
14	45789693	.	C	A	1	3	4	0	1	5	0	0
14	45789697	.	A	C	0	3	3	0	1	4	0	0
14	45789912	.	T	G	2	3	5	0	0	5	0	0
14	45790155	.	G	A	3	2	5	0	0	5	0	0
14	45790275	.	A	C	8	0	8	0	4	12	0	0
14	45925763	.	A	G	3	3	6	0	1	7	0	0
14	45925764	.	A	G	3	3	6	0	1	7	0	0
14	45925917	.	G	C	0	3	3	0	5	8	0	0
14	45925992	.	A	C	4	6	10	0	1	11	0	0
14	45926910	.	C	T	2	4	6	0	0	6	0	0
14	45927130	.	T	G	2	0	2	0	3	5	0	0
14	45927364	.	G	A	1	3	4	0	1	5	0	0
14	45927624	.	T	A	7	3	10	0	0	10	0	0
14	45927849	.	C	T	5	5	10	0	1	11	0	0
14	45927861	.	T	C	6	5	11	0	0	11	0	0
14	45928224	.	A	T	2	3	5	0	0	5	0	0
14	45928241	.	G	A	3	4	7	0	0	7	0	0
14	45928333	.	T	G	1	2	3	0	0	3	0	0
14	45928370	.	C	A	3	3	6	0	0	6	0	0
14	45928622	.	A	G	7	4	11	0	1	12	0	0
14	45928790	.	G	A	2	2	4	0	0	4	0	0
14	45928803	.	A	C	2	3	5	0	0	5	0	0
14	45928853	.	T	G	5	2	7	0	0	7	0	0
14	45929100	.	A	T	5	2	7	0	1	8	0	0
14	45929409	.	C	T	6	7	13	0	0	13	0	0
14	45929729	.	A	T	5	2	7	0	0	7	0	0
14	45929748	.	A	G	6	2	8	0	0	8	0	0
14	45929974	.	T	C	1	4	5	0	0	5	0	0
14	45930135	.	T	C	3	7	10	0	0	10	0	0
14	45930196	.	A	C	4	5	9	0	1	10	0	0
14	45930399	.	C	T	3	4	7	0	1	8	0	0
14	45930508	.	A	G	6	6	12	0	0	12	0	0
14	45930515	.	G	A	6	7	13	0	0	13	0	0
14	45930572	.	A	G	4	4	8	0	0	8	0	0
14	45930573	.	T	G	4	4	8	0	0	8	0	0
14	45930669	.	A	G	5	4	9	0	0	9	0	0
14	45930684	.	A	G	5	4	9	0	0	9	0	0
14	45930735	.	T	G	5	4	9	0	0	11	2	0
14	45931079	.	C	G	5	5	10	0	0	10	0	0
14	45931194	.	G	T	8	9	17	0	1	18	0	0
14	45931504	.	C	G	4	8	12	0	0	12	0	0
14	45931637	.	C	T	5	9	14	0	0	14	0	0
14	45931899	.	C	T	9	6	15	0	0	15	0	0
14	45932128	.	T	G	5	3	8	0	0	8	0	0
14	46007306	.	A	G	11	11	22	0	1	23	0	0
14	46007321	.	G	A	8	12	20	0	0	20	0	0
14	46009611	.	G	A	15	9	24	0	1	25	0	0
14	46009683	.	A	T	4	15	19	0	2	21	0	0
14	46010711	.	C	T	11	9	20	0	0	20	0	0
14	46010909	.	T	C	13	8	21	0	0	21	0	0
14	46012960	.	T	C	6	11	17	0	0	17	0	0
14	46013121	.	A	T	9	13	22	0	0	22	0	0
14	46013402	.	C	T	21	7	28	0	1	29	0	0
14	46015888	.	C	A	21	13	34	0	3	37	0	0
14	46016107	.	A	G	15	16	31	0	1	32	0	0
14	46017969	.	G	A	16	13	29	0	0	29	0	0
14	46018029	.	C	T	22	17	39	0	1	40	0	0
14	46018548	.	A	G	7	19	26	1	0	27	0	0
14	46028548	.	G	C	1	11	12	0	6	18	0	0
14	46037489	.	T	C	11	10	21	0	0	21	0	0
14	46039751	.	T	C	12	4	16	0	0	16	0	0
14	46039904	.	C	G	6	0	6	0	5	11	0	0
14	46040318	.	T	C	5	4	9	0	0	9	0	0
14	46041298	.	T	A	3	2	5	0	0	5	0	0
14	46041763	.	T	G	3	2	5	0	0	5	0	0
14	46041800	.	C	T	4	5	9	0	0	9	0	0
14	46041861	.	A	T	8	10	18	0	0	18	0	0
14	46048396	.	A	G	3	5	8	0	0	8	0	0
14	46048644	.	C	T	1	8	9	0	10	19	0	0
14	46048704	.	C	G	1	11	12	0	9	21	0	0
14	46048875	.	T	C	15	14	29	0	3	32	0	0
14	46052172	.	T	A	11	10	21	0	0	21	0	0
14	46052244	.	G	T	8	7	15	0	1	16	0	0
14	46067317	.	A	T	8	9	17	0	0	17	0	0
14	46075015	.	T	C	1	4	5	0	0	5	0	0
14	46075016	.	T	C	2	2	4	0	1	5	0	0
14	46075085	.	T	C	1	2	3	0	0	3	0	0
14	46075640	.	A	C	5	5	10	0	0	10	0	0
14	46076846	.	C	A	2	2	4	0	0	4	0	0
14	46077637	.	T	C	1	4	5	0	0	5	0	0
14	46077677	.	T	C	3	2	5	0	0	5	0	0
14	46082069	.	C	T	2	2	4	0	0	4	0	0
14	46082211	.	A	G	3	4	7	0	0	7	0	0
14	46088595	.	T	A	3	2	5	0	0	5	0	0
14	46088921	.	A	G	6	5	11	0	1	12	0	0
14	46089176	.	C	T	7	7	14	0	1	15	0	0
14	46089297	.	A	C	4	3	7	0	0	7	0	0
14	46089433	.	T	G	6	10	16	0	1	17	0	0
14	46089515	.	T	C	7	2	9	0	0	9	0	0
14	46089532	.	T	C	6	2	8	0	1	9	0	0
14	46089667	.	T	C	3	0	3	0	4	7	0	0
14	46089717	.	T	C	3	4	7	0	0	7	0	0
14	46090636	.	A	G	2	4	6	0	0	6	0	0
14	46090653	.	T	A	2	4	6	0	0	6	0	0
14	46090694	.	A	C	2	2	4	0	0	4	0	0
14	46090698	.	T	A	2	2	4	0	0	4	0	0
14	46091627	.	T	C	9	6	15	0	0	15	0	0
14	46094922	.	C	T	8	9	17	0	3	20	0	0
14	46095043	.	A	G	24	16	40	0	1	41	0	0
14	46095058	.	A	G	29	12	41	0	0	42	1	0
14	46095108	.	A	G	24	26	50	0	1	51	0	0
14	46104150	.	C	T	32	17	49	0	8	57	0	0
14	46104222	.	C	T	2	22	24	0	25	49	0	0
14	46104935	.	G	A	35	17	52	0	1	53	0	0
14	46113296	.	T	G	22	15	37	0	2	39	0	0
14	46113309	.	C	G	0	12	12	0	18	30	0	0
14	46114929	.	G	A	12	14	26	0	1	27	0	0
14	46116576	.	A	G	21	20	41	0	1	42	0	0
14	46117279	.	G	T	7	6	13	0	1	14	0	0
14	46118878	.	T	A	2	4	6	0	0	6	0	0
14	46128948	.	A	C	6	3	9	0	1	10	0	0
14	46129955	.	C	A	4	6	10	0	0	10	0	0
14	46133678	.	A	C	6	4	10	0	0	10	0	0
14	46134040	.	A	G	7	0	7	0	5	12	0	0
14	46140707	.	C	G	13	5	18	0	1	19	0	0
14	46140812	.	C	A	10	6	16	0	0	16	0	0
14	46146715	.	G	A	10	9	19	0	0	19	0	0
14	46146730	.	G	A	9	7	16	0	0	16	0	0
14	46154358	.	C	A	7	14	21	0	0	21	0	0
14	46154713	.	A	G	8	10	18	0	0	18	0	0
14	46154899	.	A	C	8	4	12	0	1	13	0	0
14	46154966	.	T	A	4	3	7	0	0	7	0	0
14	46154969	.	T	A	5	3	8	0	0	8	0	0
14	46177609	.	T	C	1	4	5	0	0	5	0	0
14	46177722	.	T	C	1	2	3	0	0	3	0	0
14	46177875	.	C	A	1	4	5	0	0	5	0	0
14	46182797	.	C	A	4	5	9	0	0	9	0	0
14	46182803	.	T	C	4	5	9	0	0	9	0	0
14	46182853	.	T	A	5	2	7	0	0	7	0	0
14	46182994	.	C	T	1	2	3	0	0	3	0	0
14	46183140	.	C	T	1	3	4	0	0	4	0	0
14	46183171	.	A	G	1	5	6	0	0	6	0	0
14	46183365	.	C	T	5	4	9	0	1	10	0	0
14	46183535	.	A	G	5	5	10	0	0	10	0	0
14	46183767	.	C	T	7	11	18	0	0	18	0	0
14	46183902	.	C	A	4	3	7	1	1	9	0	0
14	46184155	.	T	C	2	2	4	0	0	4	0	0
14	46184458	.	A	T	2	2	4	0	0	4	0	0
14	46184482	.	T	A	2	2	4	0	0	5	1	0
14	46184509	.	G	C	1	2	3	0	0	3	0	0
14	46184738	.	A	T	2	2	4	1	1	6	0	0
14	46184794	.	A	T	1	3	4	0	0	4	0	0
14	46185575	.	A	T	2	8	10	0	0	10	0	0
14	46186746	.	G	A	0	3	3	0	6	9	0	0
14	46186827	.	A	G	9	1	10	0	7	17	0	0
14	46187365	.	A	G	6	3	9	0	0	9	0	0
14	46187603	.	C	A	1	5	6	1	0	7	0	0
14	46187730	.	G	A	6	4	10	0	1	11	0	0
14	46187855	.	G	A	5	6	11	0	0	11	0	0
14	46187879	.	C	T	2	5	7	0	2	9	0	0
14	46188390	.	T	C	5	2	7	1	0	8	0	0
14	46188526	.	C	T	6	2	8	0	1	9	0	0
14	46188578	.	C	T	6	13	19	0	0	19	0	0
14	46188601	.	C	T	9	12	21	0	0	21	0	0
14	46188620	.	A	G	11	1	12	0	10	22	0	0
14	46188688	.	C	T	10	13	23	0	1	24	0	0
14	46188770	.	C	T	8	11	19	0	0	19	0	0
14	46200128	.	G	A	8	7	15	0	1	16	0	0
14	46200244	.	A	C	10	7	17	0	0	17	0	0
14	46206075	.	T	C	13	0	13	0	9	22	0	0
14	46206112	.	G	T	14	11	25	0	1	26	0	0
14	46208725	.	T	C	8	19	27	0	2	29	0	0
14	46211002	.	G	T	3	2	5	0	0	5	0	0
14	46211055	.	T	A	1	2	3	0	0	3	0	0
14	46211094	.	A	G	2	3	5	0	0	5	0	0
14	46213473	.	G	T	12	14	26	0	1	27	0	0
14	46216767	.	T	A	1	6	7	0	1	8	0	0
14	46216802	.	C	T	1	6	7	0	0	7	0	0
14	46216824	.	A	G	2	7	9	0	0	9	0	0
14	46216844	.	C	G	1	6	7	0	0	7	0	0
14	46219360	.	G	A	0	3	3	0	2	5	0	0
14	46219586	.	G	A	3	2	5	0	0	5	0	0
14	46346893	.	C	T	12	23	35	0	0	35	0	0
14	46350249	.	T	C	13	13	26	0	0	26	0	0
14	46352097	.	T	A	16	15	31	0	2	33	0	0
14	46352433	.	T	C	11	7	18	0	1	19	0	0
14	46352736	.	T	A	1	8	9	0	0	9	0	0
14	46377461	.	T	C	2	3	5	0	0	5	0	0
14	46382221	.	T	C	1	7	8	0	0	8	0	0
14	46385588	.	A	T	7	5	12	0	0	12	0	0
14	46385597	.	G	A	7	5	12	0	0	12	0	0
14	46385910	.	T	A	7	6	13	0	0	13	0	0
14	46385928	.	T	C	6	0	6	0	7	13	0	0
14	46386796	.	A	C	3	7	10	0	0	10	0	0
14	46386823	.	A	G	5	7	12	0	0	12	0	0
14	46388171	.	C	A	0	5	5	1	8	14	0	0
14	46388187	.	G	T	8	5	13	1	0	14	0	0
14	46392152	.	G	A	4	3	7	0	0	7	0	0
14	46394922	.	G	A	1	2	3	0	0	3	0	0
14	46395108	.	G	A	2	3	5	0	0	5	0	0
14	46395172	.	T	C	1	0	1	0	2	3	0	0
14	46395311	.	A	G	2	2	4	0	0	4	0	0
14	46395353	.	C	T	3	5	8	0	1	9	0	0
14	46441977	.	A	C	1	2	3	0	0	3	0	0
14	46456501	.	T	G	15	16	31	0	2	33	0	0
14	46456698	.	C	T	4	17	21	0	18	39	0	0
14	46456989	.	C	T	17	18	35	0	0	35	0	0
14	46457009	.	T	G	24	12	36	0	1	37	0	0
14	46457242	.	T	A	3	4	7	0	0	7	0	0
14	46457303	.	G	A	5	5	10	0	1	11	0	0
14	46457308	.	A	T	6	6	12	0	0	12	0	0
14	46457700	.	A	G	12	3	15	0	0	15	0	0
14	46457724	.	G	T	11	3	14	0	1	15	0	0
14	46457893	.	T	C	15	7	22	0	0	22	0	0
14	46458185	.	T	G	1	2	3	0	0	3	0	0
14	46458338	.	C	G	6	8	14	0	0	14	0	0
14	46458357	.	A	G	8	9	17	0	0	17	0	0
14	46458777	.	T	A	7	11	18	0	0	18	0	0
14	46459189	.	A	G	12	5	17	0	2	19	0	0
14	46459191	.	A	T	12	7	19	0	0	19	0	0
14	46459269	.	G	A	7	5	12	0	0	12	0	0
14	46462070	.	A	T	12	7	19	0	5	24	0	0
14	46475676	.	A	G	10	8	18	0	0	18	0	0
14	46475835	.	A	C	8	8	16	0	1	17	0	0
14	46475837	.	C	T	10	8	18	0	0	18	0	0
14	46480406	.	A	G	5	5	10	0	0	10	0	0
14	46492089	.	A	G	9	11	20	0	0	20	0	0
14	46494939	.	A	G	6	5	11	0	0	11	0	0
14	46494948	.	T	C	8	0	8	0	6	14	0	0
14	46495047	.	G	A	8	7	15	0	0	15	0	0
14	46498508	.	A	C	10	13	23	0	2	25	0	0
14	46503589	.	A	C	3	0	3	0	11	14	0	0
14	46532469	.	C	G	4	3	7	19	0	26	0	0
14	46616460	.	C	G	0	5	5	0	6	11	0	0
14	46630139	.	T	C	2	2	4	0	0	4	0	0
14	46630227	.	C	G	3	3	6	0	0	6	0	0
14	46630421	.	T	A	1	2	3	0	0	3	0	0
14	46630797	.	C	T	2	4	6	0	3	9	0	0
14	46633927	.	G	A	1	2	3	0	0	3	0	0
14	46634078	.	A	G	4	2	6	0	0	6	0	0
14	46634081	.	T	C	4	2	6	0	0	6	0	0
14	46634141	.	T	C	5	3	8	0	1	9	0	0
14	46634269	.	T	C	8	12	20	0	0	20	0	0
14	46636310	.	G	A	10	12	22	0	1	23	0	0
14	46638308	.	C	T	4	2	6	0	0	6	0	0
14	46643203	.	G	A	3	5	8	0	0	8	0	0
14	46643502	.	A	T	3	4	7	0	1	8	0	0
14	46648252	.	A	G	1	2	3	0	0	3	0	0
14	46648273	.	C	T	2	2	4	0	0	4	0	0
14	46651453	.	G	A	4	4	8	0	0	8	0	0
14	46651498	.	C	G	1	4	5	0	0	5	0	0
14	46668440	.	C	T	2	5	7	0	0	7	0	0
14	46679197	.	T	A	2	3	5	0	0	5	0	0
14	46679259	.	A	G	2	3	5	0	0	5	0	0
14	46679263	.	C	T	2	3	5	0	0	5	0	0
14	46679304	.	A	G	5	3	8	0	0	8	0	0
14	46679307	.	A	T	5	3	8	0	0	8	0	0
14	46679348	.	C	T	9	5	14	0	0	14	0	0
14	46679375	.	C	T	7	3	10	0	1	11	0	0
14	46679902	.	A	C	20	2	22	4	1	27	0	0
14	46679912	.	G	A	19	5	24	3	0	27	0	0
14	46680043	.	T	C	12	4	16	2	0	18	0	0
14	46680170	.	T	C	11	5	16	0	1	17	0	0
14	46680176	.	C	G	8	6	14	0	1	15	0	0
14	46680210	.	G	T	8	4	12	0	0	12	0	0
14	46680226	.	C	A	9	6	15	0	0	15	0	0
14	46680694	.	A	T	5	2	7	0	0	7	0	0
14	46680857	.	A	T	1	3	4	0	1	5	0	0
14	46680864	.	T	G	1	5	6	0	0	6	0	0
14	46680900	.	T	C	9	0	9	0	10	19	0	0
14	46681005	.	A	C	5	7	12	0	0	12	0	0
14	46681020	.	T	A	5	6	11	0	0	11	0	0
14	46681194	.	C	T	1	3	4	0	0	4	0	0
14	46681316	.	A	T	6	9	15	0	2	17	0	0
14	46681709	.	T	A	6	6	12	0	0	12	0	0
14	46682295	.	G	A	7	5	12	0	0	12	0	0
14	46682303	.	C	T	8	9	17	0	1	18	0	0
14	46682480	.	T	C	7	0	7	0	8	15	0	0
14	46682654	.	T	A	11	7	18	0	0	18	0	0
14	46682705	.	C	T	9	4	13	0	0	13	0	0
14	46682877	.	T	G	10	5	15	0	0	15	0	0
14	46683271	.	A	G	1	2	3	0	0	3	0	0
14	46683273	.	A	T	1	2	3	0	0	3	0	0
14	46683354	.	A	G	2	3	5	0	0	5	0	0
14	46683366	.	A	G	2	3	5	0	0	5	0	0
14	46683419	.	A	G	3	3	6	0	0	6	0	0
14	46683431	.	C	T	2	3	5	0	0	5	0	0
14	46683572	.	A	C	8	8	16	0	0	16	0	0
14	46683581	.	T	C	11	3	14	0	0	14	0	0
14	46683660	.	A	C	2	2	4	0	0	4	0	0
14	46684195	.	A	C	5	9	14	0	1	15	0	0
14	46684227	.	T	C	8	13	21	0	0	21	0	0
14	46684294	.	T	C	12	0	12	0	10	22	0	0
14	46684531	.	C	T	3	4	7	0	0	7	0	0
14	46684584	.	T	A	2	5	7	0	0	7	0	0
14	46684687	.	T	C	11	11	22	0	0	22	0	0
14	46684726	.	T	G	11	13	24	0	1	25	0	0
14	46684800	.	T	G	9	16	25	0	0	25	0	0
14	46876929	.	G	T	5	2	7	0	0	7	0	0
14	47003696	.	G	T	14	13	27	2	0	29	0	0
14	47003908	.	C	T	0	17	17	0	25	42	0	0
14	47003958	.	T	A	24	17	41	0	0	41	0	0
14	47004674	.	G	A	17	21	38	0	1	39	0	0
14	47004734	.	G	A	17	16	33	0	0	33	0	0
14	47027767	.	G	A	28	17	45	1	1	47	0	0
14	47096209	.	T	C	19	0	19	0	8	27	0	0
14	47131260	.	G	A	15	8	23	0	1	24	0	0
14	47142032	.	C	T	8	7	15	1	1	17	0	0
14	47783338	.	T	G	14	10	24	0	0	24	0	0
14	47783460	.	C	T	11	7	18	0	0	18	0	0
14	47784169	.	G	T	18	20	38	0	0	38	0	0
14	47784462	.	T	G	21	24	45	0	1	46	0	0
14	47784476	.	T	G	25	22	47	0	3	50	0	0
14	47790112	.	C	T	2	21	23	0	28	51	0	0
14	47790121	.	T	C	28	0	28	0	25	53	0	0
14	47795018	.	C	A	15	16	31	0	1	32	0	0
14	47795171	.	G	A	21	17	38	0	1	39	0	0
14	47797490	.	T	C	13	20	33	0	2	35	0	0
14	47797496	.	G	A	12	21	33	0	2	35	0	0
14	47797541	.	C	T	10	30	40	0	0	40	0	0
14	47815495	.	A	G	10	7	17	0	1	18	0	0
14	47819244	.	C	T	13	9	22	0	1	23	0	0
14	47819416	.	T	G	11	13	24	0	0	24	0	0
14	47819471	.	G	A	12	11	23	0	2	25	0	0
14	47822159	.	T	C	15	0	15	0	8	23	0	0
14	47822210	.	G	A	7	10	17	0	0	17	0	0
14	47823110	.	A	G	6	8	14	0	0	14	0	0
14	47829162	.	T	C	6	20	26	0	2	28	0	0
14	47832307	.	A	G	13	15	28	0	2	30	0	0
14	47832319	.	G	A	17	13	30	0	0	30	0	0
14	47833871	.	G	C	18	11	29	0	0	29	0	0
14	47838641	.	A	G	10	6	16	0	1	17	0	0
14	47882878	.	T	A	4	4	8	0	4	12	0	0
14	48308651	.	C	T	3	6	9	0	2	11	0	0
14	48326884	.	G	A	2	5	7	0	0	7	0	0
14	48580555	.	G	A	1	5	6	0	1	7	0	0
14	48735265	.	T	A	2	2	4	0	0	4	0	0
14	48735778	.	C	T	3	2	5	0	1	6	0	0
14	48735790	.	T	A	4	2	6	0	0	6	0	0
14	48737067	.	A	G	1	2	3	0	0	3	0	0
14	48737078	.	C	T	1	2	3	0	0	3	0	0
14	48737687	.	A	C	1	4	5	0	0	5	0	0
14	48737913	.	G	A	1	1	2	0	1	3	0	0
14	48737914	.	A	G	1	2	3	0	0	3	0	0
14	48738100	.	T	A	2	2	4	0	0	4	0	0
14	48738101	.	A	G	2	2	4	0	0	4	0	0
14	48738254	.	G	A	1	3	4	0	0	4	0	0
14	48738295	.	G	C	2	2	4	0	0	4	0	0
14	48739310	.	C	T	1	2	3	0	0	3	0	0
14	48739311	.	A	G	1	2	3	0	0	3	0	0
14	48741129	.	C	A	1	4	5	0	0	5	0	0
14	48741140	.	A	T	1	3	4	0	0	4	0	0
14	48767585	.	G	C	3	2	5	0	1	6	0	0
14	48767628	.	G	A	3	5	8	0	0	8	0	0
14	48775635	.	G	T	2	4	6	0	0	6	0	0
14	48775674	.	G	T	1	3	4	0	0	4	0	0
14	48775680	.	G	A	1	2	3	0	0	3	0	0
14	48781160	.	C	G	4	3	7	0	0	7	0	0
14	48781237	.	C	T	0	4	4	0	1	5	0	0
14	48781425	.	A	G	1	2	3	0	0	3	0	0
14	48781534	.	A	G	1	5	6	0	0	6	0	0
14	48781832	.	C	T	2	4	6	0	0	6	0	0
14	48932470	.	T	A	20	22	42	0	0	42	0	0
14	48932712	.	G	A	11	11	22	0	0	22	0	0
14	48932880	.	A	T	31	10	41	0	0	42	1	0
14	48932970	.	T	A	19	20	39	0	1	40	0	0
14	48933224	.	A	G	27	18	45	0	0	46	1	0
14	48933273	.	C	A	25	17	42	4	0	47	1	0
14	48933361	.	T	A	27	13	40	0	2	42	0	0
14	48933513	.	T	C	14	8	22	1	2	25	0	0
14	48933575	.	A	G	14	8	22	2	3	27	0	0
14	48933958	.	T	C	30	12	42	5	0	47	0	0
14	48934025	.	G	A	27	15	42	0	3	45	0	0
14	48934052	.	G	A	24	18	42	0	2	44	0	0
14	48934253	.	G	A	14	12	26	0	0	26	0	0
14	48934276	.	G	A	14	7	21	0	0	21	0	0
14	48934547	.	A	T	25	18	43	0	1	44	0	0
14	48934577	.	G	T	26	27	53	0	0	53	0	0
14	48934630	.	C	G	34	14	48	0	2	50	0	0
14	48934639	.	T	C	43	0	43	0	7	50	0	0
14	48934701	.	T	C	31	23	54	0	2	56	0	0
14	48934719	.	T	G	28	23	51	0	1	52	0	0
14	48934829	.	T	A	16	26	42	0	2	44	0	0
14	48945057	.	T	C	4	5	9	0	0	9	0	0
14	48945253	.	C	T	0	4	4	0	2	6	0	0
14	48952623	.	G	A	3	3	6	0	0	6	0	0
14	48960464	.	C	T	0	2	2	0	2	4	0	0
14	48960842	.	C	T	1	3	4	0	0	4	0	0
14	48964697	.	T	C	17	11	28	0	1	29	0	0
14	48982481	.	G	A	1	1	2	0	1	3	0	0
14	48986944	.	C	T	5	2	7	0	1	8	0	0
14	48987031	.	C	T	4	3	7	0	0	7	0	0
14	48995443	.	G	A	4	3	7	0	1	8	0	0
14	48995473	.	C	T	4	7	11	0	0	11	0	0
14	48995551	.	C	G	1	3	4	0	0	4	0	0
14	48995894	.	C	A	3	3	6	0	1	7	0	0
14	48997367	.	G	A	2	2	4	0	2	6	0	0
14	48997811	.	A	G	3	4	7	0	1	8	0	0
14	49005328	.	T	A	7	3	10	0	0	10	0	0
14	49005367	.	T	A	4	2	6	0	0	6	0	0
14	49005427	.	G	A	0	2	2	0	1	3	0	0
14	49005446	.	C	A	1	2	3	0	0	3	0	0
14	49005564	.	C	A	3	5	8	0	0	8	0	0
14	49005610	.	G	T	3	2	5	0	0	5	0	0
14	49007729	.	G	A	2	6	8	0	0	8	0	0
14	49007756	.	G	A	1	4	5	0	3	8	0	0
14	49007825	.	C	T	6	5	11	0	0	11	0	0
14	49009923	.	A	G	3	0	3	0	7	10	0	0
14	49015393	.	C	T	5	3	8	0	1	9	0	0
14	49022002	.	C	T	8	11	19	0	1	20	0	0
14	49022071	.	A	G	9	0	9	0	6	15	0	0
14	49022145	.	A	G	6	0	6	0	8	14	0	0
14	49022191	.	G	T	7	8	15	0	2	17	0	0
14	49022238	.	G	A	0	9	9	0	5	14	0	0
14	49022290	.	G	T	3	13	16	0	3	19	0	0
14	49028477	.	T	A	5	4	9	0	1	10	0	0
14	49028593	.	T	C	8	4	12	0	1	13	0	0
14	49029025	.	C	T	3	4	7	0	0	7	0	0
14	49029026	.	A	G	3	4	7	0	0	7	0	0
14	49029269	.	C	G	3	5	8	0	0	8	0	0
14	49029477	.	G	A	1	4	5	0	0	5	0	0
14	49029992	.	C	T	1	7	8	0	0	8	0	0
14	49030348	.	A	G	1	3	4	0	0	4	0	0
14	49030378	.	A	G	1	3	4	0	0	4	0	0
14	49030844	.	G	A	1	4	5	0	0	5	0	0
14	49031214	.	T	G	2	3	5	0	1	6	0	0
14	49031569	.	A	G	3	7	10	0	1	11	0	0
14	49040574	.	G	A	4	8	12	0	1	13	0	0
14	49040773	.	G	A	7	6	13	2	1	16	0	0
14	49047525	.	T	G	14	17	31	0	0	31	0	0
14	49050397	.	T	G	15	14	29	0	1	30	0	0
14	49053391	.	G	A	8	10	18	0	1	19	0	0
14	49053402	.	C	G	7	8	15	0	0	15	0	0
14	49054446	.	T	C	12	0	12	0	10	23	1	0
14	49054449	.	G	A	11	10	21	0	0	21	0	0
14	49057246	.	G	A	9	13	22	0	2	24	0	0
14	49057273	.	C	G	8	18	26	0	0	26	0	0
14	49057297	.	A	G	10	15	25	0	1	26	0	0
14	49078766	.	A	C	3	6	9	0	1	10	0	0
14	49079160	.	T	A	1	1	2	0	1	3	0	0
14	49079354	.	T	C	3	2	5	0	0	5	0	0
14	49086021	.	G	A	7	3	10	0	1	11	0	0
14	49089956	.	T	C	9	0	9	0	7	16	0	0
14	49091420	.	G	A	5	7	12	0	0	12	0	0
14	49119048	.	G	T	9	24	33	0	0	33	0	0
14	49119062	.	G	A	27	16	43	0	3	46	0	0
14	49119192	.	T	A	33	26	59	1	0	60	0	0
14	49119218	.	C	A	29	28	57	1	1	59	0	0
14	49119321	.	A	C	20	36	56	1	3	60	0	0
14	49119484	.	T	A	28	18	46	0	4	50	0	0
14	49119656	.	G	A	32	2	34	2	20	56	0	0
14	49126924	.	G	A	15	16	31	0	2	33	0	0
14	49133139	.	A	G	14	18	32	0	0	32	0	0
14	49136065	.	G	A	0	13	13	0	16	29	0	0
14	49136245	.	G	A	2	16	18	0	19	37	0	0
14	49136483	.	C	T	21	17	38	0	4	42	0	0
14	49136551	.	T	G	17	1	18	0	5	23	0	0
14	49136838	.	A	T	12	10	22	0	0	22	0	0
14	49136909	.	C	T	12	9	21	6	0	27	0	0
14	49153665	.	C	T	4	3	7	0	0	7	0	0
14	49153681	.	T	C	3	4	7	0	0	7	0	0
14	49154087	.	A	T	6	8	14	0	2	16	0	0
14	49161148	.	T	C	8	3	11	0	0	11	0	0
14	49166289	.	C	T	4	3	7	0	0	7	0	0
14	49172185	.	A	T	6	4	10	0	0	10	0	0
14	49172331	.	C	T	1	4	5	0	0	5	0	0
14	49173199	.	T	C	1	3	4	0	0	4	0	0
14	49173424	.	T	C	6	3	9	0	1	10	0	0
14	49173550	.	A	G	2	2	4	0	0	4	0	0
14	49173619	.	C	T	5	5	10	0	1	11	0	0
14	49173658	.	G	T	1	3	4	0	3	7	0	0
14	49173778	.	C	T	2	2	4	1	0	5	0	0
14	49173791	.	A	T	5	2	7	1	0	8	0	0
14	49175256	.	T	C	8	7	15	0	0	15	0	0
14	49175303	.	T	C	7	6	13	0	0	13	0	0
14	49175579	.	T	C	4	2	6	0	0	6	0	0
14	49175591	.	C	T	3	4	7	0	0	7	0	0
14	49182980	.	T	G	6	4	10	0	1	11	0	0
14	49183104	.	C	G	1	5	6	0	0	6	0	0
14	49183198	.	C	T	3	4	7	0	1	8	0	0
14	49195504	.	C	T	6	4	10	0	0	10	0	0
14	49196757	.	A	T	5	8	13	0	0	13	0	0
14	49196784	.	C	T	5	7	12	0	1	13	0	0
14	49199004	.	A	T	8	4	12	0	0	12	0	0
14	49202111	.	C	G	4	5	9	0	1	10	0	0
14	49203905	.	T	C	11	5	16	0	0	16	0	0
14	49204136	.	G	A	0	10	10	0	5	15	0	0
14	49206876	.	G	C	5	3	8	0	0	8	0	0
14	49206879	.	C	T	4	3	7	0	0	8	1	0
14	49206948	.	G	A	5	4	9	0	0	9	0	0
14	49209983	.	C	T	8	11	19	0	0	19	0	0
14	49210055	.	T	C	10	6	16	0	0	16	0	0
14	49210075	.	C	A	8	7	15	0	1	16	0	0
14	49210231	.	A	G	2	10	12	0	0	12	0	0
14	49210349	.	G	A	7	7	14	1	1	16	0	0
14	49210391	.	C	A	10	8	18	0	0	18	0	0
14	49210867	.	G	T	5	6	11	0	0	11	0	0
14	49210955	.	A	G	10	8	18	0	1	19	0	0
14	49211001	.	A	G	3	9	12	0	1	13	0	0
14	49211045	.	T	C	7	4	11	0	0	11	0	0
14	49211229	.	C	T	2	2	4	0	1	5	0	0
14	49211269	.	A	G	4	5	9	0	0	9	0	0
14	49211285	.	G	T	4	5	9	0	1	10	0	0
14	49211975	.	A	G	5	4	9	0	0	9	0	0
14	49212183	.	A	G	3	3	6	1	0	7	0	0
14	49212184	.	A	G	2	4	6	1	0	7	0	0
14	49212350	.	C	T	7	6	13	0	0	13	0	0
14	49212395	.	T	C	8	5	13	0	1	14	0	0
14	49212439	.	A	G	5	2	7	0	0	7	0	0
14	49212501	.	A	G	4	2	6	0	0	6	0	0
14	49212505	.	A	G	5	2	7	0	0	7	0	0
14	49212612	.	T	C	4	5	9	0	0	9	0	0
14	49212838	.	C	T	1	7	8	0	0	8	0	0
14	49212867	.	A	C	2	7	9	0	1	10	0	0
14	49213140	.	T	G	11	9	20	0	0	20	0	0
14	49213178	.	C	T	7	6	13	0	1	14	0	0
14	49213250	.	C	T	3	8	11	0	0	11	0	0
14	49213315	.	C	A	1	2	3	0	0	3	0	0
14	49213770	.	G	A	8	8	16	1	0	17	0	0
14	49213836	.	G	A	8	5	13	0	0	13	0	0
14	49214158	.	G	A	9	3	12	0	0	12	0	0
14	49214168	.	T	C	7	4	11	0	0	11	0	0
14	49214392	.	G	A	1	2	3	0	0	3	0	0
14	49224844	.	G	A	1	12	13	0	14	27	0	0
14	49224886	.	C	T	12	16	28	1	0	29	0	0
14	49231804	.	A	G	12	12	24	0	0	24	0	0
14	49231813	.	C	T	11	11	22	0	1	23	0	0
14	49231903	.	C	G	10	13	23	0	1	24	0	0
14	49236476	.	A	G	16	13	29	0	0	29	0	0
14	49237917	.	A	G	11	9	20	1	2	23	0	0
14	49244425	.	A	G	19	1	20	0	20	40	0	0
14	49244728	.	A	G	13	15	28	0	0	28	0	0
14	49244740	.	A	T	16	12	28	0	0	28	0	0
14	49245035	.	C	A	16	4	20	2	1	23	0	0
14	49245190	.	C	G	11	10	21	0	0	21	0	0
14	49266819	.	G	C	1	3	4	0	0	4	0	0
14	49266825	.	C	A	0	2	2	0	1	3	0	0
14	49337563	.	G	A	1	9	10	0	0	10	0	0
14	49430817	.	A	G	10	16	26	0	0	26	0	0
14	49430844	.	A	G	21	10	31	0	1	32	0	0
14	49430862	.	A	G	26	0	26	1	8	35	0	0
14	49432340	.	A	G	5	9	14	0	2	16	0	0
14	49489290	.	C	T	12	19	31	8	8	47	0	0
14	49489306	.	C	T	26	8	34	2	11	47	0	0
14	49734011	.	C	G	4	7	11	0	0	11	0	0
14	49738310	.	G	A	0	10	10	0	4	14	0	0
14	49738424	.	C	T	7	12	19	0	0	19	0	0
14	49750311	.	C	T	7	12	19	0	0	19	0	0
14	49757069	.	G	T	3	6	9	0	0	9	0	0
14	49757320	.	A	G	4	6	10	0	0	10	0	0
14	49757330	.	A	G	5	0	5	0	5	10	0	0
14	49761799	.	G	A	6	6	12	0	0	12	0	0
14	50974979	.	T	C	2	2	4	0	1	5	0	0
14	52517870	.	A	G	6	7	13	0	1	14	0	0
14	52517891	.	A	G	16	2	18	0	0	18	0	0
14	52518002	.	A	G	2	16	18	0	1	19	0	0
14	52574497	.	C	A	3	1	4	1	0	5	0	0
14	52575054	.	T	C	9	5	14	0	0	14	0	0
14	52576139	.	C	T	11	15	26	3	13	42	0	0
14	52576142	.	C	T	11	19	30	3	9	42	0	0
15	784368	.	G	C	3	5	8	0	0	8	0	0
15	827198	.	C	A	0	2	2	0	0	2	0	0
15	827212	.	A	G	2	1	3	0	0	3	0	0
15	893426	.	A	G	3	0	3	2	4	9	0	0
15	894804	.	G	A	0	3	3	4	2	9	0	0
15	895651	.	T	C	1	2	3	1	0	4	0	0
15	1026323	.	A	G	1	2	3	0	0	3	0	0
15	1026440	.	G	C	2	3	5	0	0	5	0	0
15	1026462	.	G	A	2	2	4	0	0	4	0	0
15	1026488	.	T	C	1	2	3	0	0	3	0	0
15	1029484	.	C	T	2	2	4	0	0	4	0	0
15	1033435	.	A	T	8	4	12	0	0	12	0	0
15	1033564	.	G	T	3	4	7	0	0	7	0	0
15	1033588	.	T	C	5	0	5	0	4	9	0	0
15	1033632	.	G	A	6	5	11	0	0	11	0	0
15	1033853	.	A	G	1	4	5	0	1	6	0	0
15	1033955	.	C	T	0	3	3	0	5	8	0	0
15	1036614	.	C	T	6	4	10	0	0	10	0	0
15	1036677	.	C	T	0	4	4	0	5	9	0	0
15	1036825	.	T	C	3	5	8	0	0	8	0	0
15	1148129	.	A	G	4	4	8	0	0	8	0	0
15	1167171	.	C	T	14	3	17	0	0	17	0	0
15	1167183	.	C	T	12	3	15	1	1	17	0	0
15	1168999	.	A	G	1	3	4	0	0	4	0	0
15	1173016	.	A	G	11	0	11	0	8	19	0	0
15	1173067	.	C	T	9	4	13	0	0	13	0	0
15	1173542	.	C	T	13	5	18	0	0	18	0	0
15	1176447	.	G	A	0	4	4	0	7	11	0	0
15	1178927	.	C	A	3	8	11	0	1	12	0	0
15	1181477	.	G	T	1	3	4	0	1	5	0	0
15	1181480	.	C	T	0	3	3	0	2	5	0	0
15	1183984	.	C	T	0	5	5	0	4	9	0	0
15	1186181	.	A	G	4	5	9	0	0	9	0	0
15	1186202	.	C	T	0	6	6	0	5	11	0	0
15	1189664	.	C	T	20	10	30	0	0	30	0	0
15	1191750	.	A	G	14	15	29	0	1	30	0	0
15	1191792	.	G	A	3	9	12	0	10	22	0	0
15	1191822	.	A	G	12	0	12	0	9	21	0	0
15	1194590	.	A	G	13	5	18	0	2	20	0	0
15	1194670	.	G	A	20	6	26	0	2	28	0	0
15	1194739	.	G	T	10	5	15	0	1	16	0	0
15	1204917	.	T	C	6	4	10	0	0	10	0	0
15	1204941	.	T	C	4	4	8	0	0	8	0	0
15	1209060	.	G	A	1	3	4	0	7	11	0	0
15	1682187	.	T	C	1	3	4	0	1	5	0	0
15	1682211	.	T	C	1	4	5	0	0	5	0	0
15	1727616	.	G	A	5	3	8	0	0	8	0	0
15	1730619	.	G	A	8	6	14	0	0	14	0	0
15	1730643	.	A	G	6	10	16	0	0	16	0	0
15	1733125	.	G	C	2	3	5	0	1	6	0	0
15	1749973	.	G	C	2	3	5	0	0	5	0	0
15	1749984	.	A	T	1	5	6	0	0	6	0	0
15	1753501	.	A	G	5	4	9	0	0	9	0	0
15	1756009	.	G	A	3	7	10	0	1	11	0	0
15	1758037	.	C	T	3	5	8	0	0	8	0	0
15	1758675	.	T	C	6	0	6	0	6	12	0	0
15	1766675	.	C	T	9	11	20	0	1	21	0	0
15	1774489	.	G	A	1	6	7	0	16	23	0	0
15	1777913	.	C	A	8	6	14	0	1	15	0	0
15	1782156	.	T	C	13	9	22	0	0	22	0	0
15	1801583	.	G	A	1	2	3	0	1	4	0	0
15	1828401	.	C	T	9	5	14	0	0	14	0	0
15	1830323	.	A	G	12	11	23	0	2	25	0	0
15	1847246	.	C	G	7	6	13	0	0	13	0	0
15	1847358	.	A	G	9	14	23	0	1	24	0	0
15	1847432	.	A	C	9	9	18	0	2	20	0	0
15	1847588	.	A	T	5	9	14	0	0	14	0	0
15	1847693	.	A	G	10	12	22	0	0	22	0	0
15	1847908	.	A	C	11	13	24	0	0	24	0	0
15	1847951	.	G	A	6	10	16	0	2	18	0	0
15	1848188	.	T	C	7	0	7	0	8	15	0	0
15	1848202	.	G	T	4	6	10	0	0	10	0	0
15	1848279	.	T	C	1	4	5	0	0	5	0	0
15	1850540	.	A	C	4	0	4	0	7	11	0	0
15	1853010	.	A	C	6	13	19	0	0	19	0	0
15	1853028	.	G	A	4	13	17	0	0	17	0	0
15	1858625	.	A	G	5	6	11	0	1	12	0	0
15	1858638	.	C	G	5	6	11	0	0	11	0	0
15	1858914	.	G	C	11	0	11	0	11	22	0	0
15	1859013	.	G	A	5	7	12	0	1	13	0	0
15	1862024	.	C	T	1	6	7	0	4	11	0	0
15	1869631	.	A	T	6	5	11	0	2	13	0	0
15	1871188	.	A	G	11	5	16	0	0	16	0	0
15	1871197	.	T	C	10	6	16	0	0	16	0	0
15	1871245	.	A	G	10	5	15	0	0	15	0	0
15	1871248	.	G	A	10	5	15	0	0	15	0	0
15	1893276	.	C	T	15	10	25	0	1	26	0	0
15	1893293	.	C	G	18	7	25	0	0	25	0	0
15	1893323	.	G	A	1	9	10	0	18	28	0	0
15	1893356	.	A	G	13	0	13	0	14	27	0	0
15	1895469	.	G	A	20	7	27	0	1	28	0	0
15	1895505	.	G	C	17	8	25	0	0	25	0	0
15	1897576	.	T	C	19	11	30	0	2	32	0	0
15	1897928	.	T	A	2	2	4	0	0	4	0	0
15	1898384	.	T	C	4	2	6	0	0	6	0	0
15	1899203	.	G	A	0	3	3	3	3	9	0	0
15	1899217	.	A	T	3	4	7	3	0	10	0	0
15	1899304	.	A	C	3	5	8	0	0	8	0	0
15	1899331	.	T	G	4	4	8	1	0	9	0	0
15	1899878	.	T	C	7	11	18	0	0	18	0	0
15	1902259	.	A	G	6	7	13	0	0	13	0	0
15	1905364	.	T	G	5	9	14	0	0	14	0	0
15	2182569	.	G	A	10	5	15	0	0	15	0	0
15	2182752	.	G	C	10	10	20	0	0	20	0	0
15	2182848	.	C	T	5	7	12	0	1	13	0	0
15	2188261	.	G	T	0	9	9	0	0	9	0	0
15	2413865	.	A	T	5	2	7	0	0	7	0	0
15	2413970	.	T	G	2	0	2	0	3	5	0	0
15	2414003	.	C	T	3	2	5	0	0	5	0	0
15	2414081	.	G	C	4	2	6	0	0	6	0	0
15	2414140	.	T	A	5	3	8	0	0	8	0	0
15	2414160	.	C	T	4	3	7	0	0	7	0	0
15	2414177	.	G	A	3	3	6	0	0	6	0	0
15	2414219	.	A	G	6	2	8	0	0	8	0	0
15	2414269	.	A	G	5	3	8	0	0	8	0	0
15	2414276	.	A	G	1	6	7	0	1	8	0	0
15	2421773	.	T	C	4	3	7	0	0	7	0	0
15	2421775	.	T	C	4	3	7	0	0	7	0	0
15	2423175	.	T	C	6	5	11	0	0	11	0	0
15	2435805	.	C	T	1	3	4	0	0	4	0	0
15	2435850	.	G	A	4	3	7	0	0	7	0	0
15	2444024	.	C	T	3	4	7	0	0	7	0	0
15	2447416	.	C	T	6	2	8	0	0	8	0	0
15	2451348	.	G	A	4	7	11	0	0	11	0	0
15	2451358	.	C	G	5	0	5	0	8	13	0	0
15	2458640	.	A	G	9	0	9	0	8	17	0	0
15	2458641	.	G	T	9	8	17	0	0	17	0	0
15	2458691	.	C	T	3	8	11	0	0	11	0	0
15	2459656	.	A	G	7	6	13	0	1	14	0	0
15	2459773	.	G	A	6	8	14	0	0	14	0	0
15	2459903	.	A	G	6	3	9	0	1	10	0	0
15	2459963	.	C	T	5	2	7	0	0	7	0	0
15	2463308	.	T	C	11	10	21	0	0	21	0	0
15	2463309	.	G	C	11	10	21	0	0	21	0	0
15	2485111	.	T	C	3	4	7	0	0	7	0	0
15	2502741	.	C	T	1	2	3	0	0	3	0	0
15	2502812	.	C	A	5	2	7	0	0	7	0	0
15	2507763	.	G	A	1	3	4	0	0	4	0	0
15	2515421	.	C	T	8	11	19	0	0	19	0	0
15	2524401	.	C	T	8	3	11	0	0	11	0	0
15	2524684	.	T	C	9	5	14	0	0	14	0	0
15	2527072	.	T	C	10	12	22	0	0	22	0	0
15	2527105	.	G	A	11	3	14	0	0	14	0	0
15	2533340	.	A	G	9	5	14	0	1	15	0	0
15	2533397	.	A	G	7	7	14	0	2	16	0	0
15	2533468	.	C	G	6	7	13	0	0	13	0	0
15	2534772	.	T	G	3	0	3	0	4	7	0	0
15	2537852	.	G	A	3	3	6	0	0	6	0	0
15	2538060	.	A	G	5	3	8	0	0	8	0	0
15	2539821	.	G	A	5	2	7	0	1	8	0	0
15	2539958	.	C	A	3	3	6	0	0	6	0	0
15	2543388	.	G	T	2	15	17	0	0	17	0	0
15	2543476	.	C	T	6	3	9	0	0	9	0	0
15	2543478	.	T	C	4	3	7	0	2	9	0	0
15	2543675	.	A	G	2	3	5	0	0	5	0	0
15	2560436	.	A	G	6	6	12	0	2	14	0	0
15	2560484	.	C	T	3	4	7	0	3	10	0	0
15	2560694	.	G	A	7	8	15	0	0	15	0	0
15	2572481	.	C	T	8	10	18	0	0	18	0	0
15	2572910	.	G	A	1	6	7	0	6	13	0	0
15	2578043	.	C	A	6	7	13	0	1	14	0	0
15	2590559	.	A	T	2	2	4	0	0	4	0	0
15	2590856	.	C	T	0	5	5	0	2	7	0	0
15	2593089	.	C	T	3	2	5	0	0	5	0	0
15	2593092	.	T	C	3	3	6	0	0	6	0	0
15	2656891	.	T	C	1	3	4	0	1	5	0	0
15	2656894	.	T	C	1	0	1	0	4	5	0	0
15	2657130	.	C	T	4	3	7	0	0	7	0	0
15	2727995	.	A	G	1	2	3	0	0	3	0	0
15	2728221	.	C	T	4	7	11	0	17	28	0	0
15	2728330	.	A	G	19	11	30	0	2	32	0	0
15	2728573	.	C	T	17	14	31	0	0	31	0	0
15	2728641	.	A	C	10	10	20	0	1	21	0	0
15	2728652	.	C	T	10	11	21	1	1	23	0	0
15	2728678	.	G	A	6	12	18	1	0	19	0	0
15	2728806	.	T	G	12	14	26	0	0	26	0	0
15	2728880	.	C	T	1	12	13	0	9	22	0	0
15	2729057	.	G	C	13	3	16	0	0	16	0	0
15	2729512	.	T	C	8	0	8	0	7	15	0	0
15	2729515	.	T	C	3	0	3	0	9	12	0	0
15	2729962	.	A	T	1	4	5	0	0	5	0	0
15	2729971	.	T	C	3	3	6	0	1	7	0	0
15	2730168	.	T	C	14	5	19	0	1	20	0	0
15	2730242	.	T	C	2	4	6	0	0	6	0	0
15	2730243	.	T	C	2	4	6	0	0	6	0	0
15	2730358	.	T	C	10	5	15	0	0	15	0	0
15	2730364	.	G	C	6	9	15	0	1	16	0	0
15	2730533	.	T	C	10	14	24	0	0	24	0	0
15	2730536	.	G	C	9	0	9	0	14	23	0	0
15	2730794	.	T	G	1	4	5	0	0	5	0	0
15	2730798	.	T	G	1	5	6	0	1	7	0	0
15	2730927	.	C	T	1	11	12	0	13	25	0	0
15	2739915	.	G	C	10	16	26	0	2	28	0	0
15	2742070	.	A	T	7	9	16	0	2	18	0	0
15	2744699	.	G	A	8	10	18	0	1	19	0	0
15	2746309	.	A	G	8	7	15	0	0	15	0	0
15	2746467	.	A	G	3	13	16	0	0	16	0	0
15	2747650	.	C	T	3	11	14	0	0	14	0	0
15	2747686	.	A	G	4	7	11	0	2	13	0	0
15	2750638	.	G	T	8	13	21	0	0	21	0	0
15	2750671	.	A	G	10	17	27	0	0	27	0	0
15	2750716	.	G	T	13	10	23	0	0	23	0	0
15	2779387	.	T	G	2	3	5	0	0	5	0	0
15	2851511	.	A	G	2	5	7	0	0	7	0	0
15	2851550	.	G	A	5	4	9	0	0	9	0	0
15	2851569	.	A	C	4	4	8	0	0	8	0	0
15	2851854	.	T	C	3	0	3	1	3	7	0	0
15	2851862	.	T	C	2	0	2	1	3	6	0	0
15	2851934	.	A	G	2	5	7	0	1	8	0	0
15	2851936	.	C	A	2	6	8	0	0	8	0	0
15	2852074	.	A	G	2	2	4	0	0	4	0	0
15	2852436	.	T	C	5	5	10	0	1	11	0	0
15	2855289	.	T	C	3	6	9	0	1	10	0	0
15	2855303	.	G	A	5	7	12	0	0	12	0	0
15	2855334	.	T	A	5	5	10	0	0	10	0	0
15	2857425	.	A	G	5	2	7	0	0	7	0	0
15	2863891	.	T	A	2	2	4	0	0	4	0	0
15	2871007	.	T	C	4	4	8	0	0	8	0	0
15	2875501	.	A	T	2	6	8	0	2	10	0	0
15	2876720	.	T	C	2	4	6	0	0	6	0	0
15	2876938	.	A	G	4	6	10	0	1	11	0	0
15	2876956	.	G	T	0	4	4	0	5	9	0	0
15	2933810	.	G	A	2	2	4	0	0	4	0	0
15	2988126	.	T	A	13	6	19	0	0	19	0	0
15	2988136	.	T	G	14	9	23	0	1	24	0	0
15	2988414	.	C	A	10	13	23	0	1	24	0	0
15	2988420	.	C	T	1	15	16	0	10	26	0	0
15	2989361	.	T	G	12	6	18	0	0	18	0	0
15	2994265	.	C	T	4	10	14	0	14	28	0	0
15	2994309	.	T	G	11	17	28	0	1	30	1	0
15	2995080	.	T	C	13	10	23	0	0	23	0	0
15	2999008	.	C	T	17	11	28	0	2	30	0	0
15	2999113	.	C	A	1	7	8	0	17	25	0	0
15	2999209	.	G	A	10	16	26	0	0	26	0	0
15	3000194	.	T	C	15	9	24	0	1	25	0	0
15	3000311	.	C	T	12	10	22	1	1	24	0	0
15	3000347	.	T	C	9	0	9	3	7	19	0	0
15	3000472	.	C	A	16	12	28	0	1	29	0	0
15	3003682	.	T	C	9	0	9	0	6	15	0	0
15	3005511	.	C	T	10	10	20	0	1	21	0	0
15	3005538	.	G	A	7	8	15	0	0	15	0	0
15	3005556	.	C	A	2	8	10	0	9	19	0	0
15	3005578	.	A	G	8	6	14	0	3	17	0	0
15	3009497	.	T	A	10	15	25	0	0	25	0	0
15	3011241	.	C	T	1	9	10	0	15	25	0	0
15	3020470	.	G	A	8	9	17	0	0	17	0	0
15	3020475	.	G	A	8	9	17	0	0	17	0	0
15	3020598	.	T	A	7	10	17	0	0	17	0	0
15	3024971	.	G	T	4	10	14	0	1	15	0	0
15	3027378	.	T	C	8	0	8	0	9	17	0	0
15	3037393	.	T	C	11	0	11	0	11	22	0	0
15	3125280	.	A	T	3	8	11	0	0	11	0	0
15	3134816	.	T	G	3	0	3	0	4	7	0	0
15	3138704	.	A	G	7	4	11	0	2	13	0	0
15	3138744	.	C	T	10	6	16	0	0	16	0	0
15	3138794	.	T	C	6	2	8	0	0	8	0	0
15	3144060	.	C	T	3	6	9	0	1	10	0	0
15	3146653	.	A	G	5	0	5	0	9	14	0	0
15	3154785	.	C	T	9	5	14	0	2	16	0	0
15	3154872	.	C	A	2	9	11	0	1	12	0	0
15	3156844	.	T	C	5	9	14	0	0	14	0	0
15	3156847	.	T	A	6	10	16	0	0	16	0	0
15	3161195	.	A	G	6	4	10	0	0	10	0	0
15	3187392	.	G	A	3	3	6	0	0	6	0	0
15	3188868	.	C	T	5	2	7	0	0	7	0	0
15	3190432	.	C	G	6	4	10	0	0	10	0	0
15	3191981	.	A	T	0	3	3	0	1	4	0	0
15	3375384	.	C	T	2	4	6	0	0	6	0	0
15	3375493	.	G	A	8	4	12	0	0	12	0	0
15	3376559	.	T	C	3	2	5	0	0	5	0	0
15	3376570	.	G	A	2	2	4	0	0	4	0	0
15	3376837	.	T	C	5	9	14	1	2	17	0	0
15	3376850	.	T	G	6	10	16	2	1	19	0	0
15	3377050	.	C	G	13	4	17	0	4	22	1	0
15	3377205	.	A	C	1	5	6	0	0	6	0	0
15	3377453	.	G	A	0	2	2	0	1	3	0	0
15	3377539	.	T	G	3	4	7	0	0	7	0	0
15	3377562	.	A	C	1	3	4	0	0	4	0	0
15	3377727	.	T	G	7	3	10	0	0	10	0	0
15	3378164	.	A	C	3	3	6	0	0	6	0	0
15	3378189	.	C	T	4	4	8	0	0	8	0	0
15	3378547	.	G	T	1	3	4	0	0	4	0	0
15	3456168	.	A	G	6	5	11	0	1	12	0	0
15	3456169	.	C	T	6	5	11	0	1	12	0	0
15	3456306	.	T	A	5	7	12	0	0	12	0	0
15	3456353	.	G	A	4	8	12	0	0	12	0	0
15	3477016	.	C	T	2	3	5	0	3	8	0	0
15	3494111	.	G	A	3	3	6	0	0	6	0	0
15	3494132	.	A	G	5	3	8	0	0	8	0	0
15	3503008	.	A	T	3	3	6	0	0	6	0	0
15	3529573	.	T	G	2	2	4	0	1	5	0	0
15	3531036	.	G	C	12	7	19	0	0	19	0	0
15	3534556	.	G	A	4	10	14	0	0	14	0	0
15	3534558	.	T	G	3	10	13	0	0	13	0	0
15	3539111	.	G	T	1	6	7	0	0	7	0	0
15	3539174	.	G	A	14	5	19	0	0	19	0	0
15	3651308	.	C	G	9	7	16	0	0	16	0	0
15	3651359	.	T	C	5	6	11	0	0	11	0	0
15	3674852	.	G	C	1	2	3	0	0	3	0	0
15	3674856	.	A	T	2	2	4	0	0	4	0	0
15	3675018	.	T	C	2	3	5	0	0	5	0	0
15	3676818	.	A	G	1	6	7	0	0	7	0	0
15	3680515	.	T	C	2	5	7	0	0	7	0	0
15	3685012	.	T	C	4	5	9	0	1	10	0	0
15	3686983	.	T	A	1	2	3	0	0	3	0	0
15	3688748	.	A	G	3	2	5	0	0	5	0	0
15	3734944	.	C	A	7	3	10	0	0	10	0	0
15	3734950	.	G	A	6	4	10	0	1	11	0	0
15	3735134	.	C	G	0	2	2	0	5	7	0	0
15	3735338	.	T	C	3	0	3	0	5	8	0	0
15	3735521	.	C	G	1	3	4	0	0	4	0	0
15	3735548	.	T	G	1	3	4	0	0	4	0	0
15	3777899	.	G	A	1	2	3	1	1	5	0	0
15	3781667	.	C	T	5	2	7	0	0	7	0	0
15	3781671	.	C	A	5	2	7	0	0	7	0	0
15	3825454	.	A	G	2	4	6	0	0	6	0	0
15	3827690	.	T	C	1	2	3	0	0	3	0	0
15	3900035	.	T	C	1	2	3	0	0	3	0	0
15	3900258	.	A	G	1	3	4	0	0	4	0	0
15	3900322	.	A	C	3	4	7	0	0	7	0	0
15	3917355	.	A	T	2	4	6	0	0	6	0	0
15	3920793	.	C	G	2	2	4	0	0	4	0	0
15	3921218	.	C	T	2	3	5	0	0	5	0	0
15	3921247	.	G	A	0	4	4	0	2	6	0	0
15	3922718	.	T	C	6	3	9	0	0	9	0	0
15	3922752	.	C	A	2	2	4	0	2	6	0	0
15	3922776	.	A	G	2	2	4	0	0	4	0	0
15	3923135	.	A	G	4	0	4	0	4	8	0	0
15	3923193	.	A	G	4	4	8	0	0	8	0	0
15	3924312	.	A	T	4	2	6	0	0	6	0	0
15	3924349	.	C	G	3	3	6	0	0	6	0	0
15	3924381	.	T	C	5	5	10	0	0	10	0	0
15	3924600	.	T	G	2	2	4	0	0	4	0	0
15	3924601	.	T	G	2	2	4	0	0	4	0	0
15	4105164	.	C	T	1	4	5	0	8	13	0	0
15	4105168	.	T	G	9	4	13	0	0	13	0	0
15	4105235	.	T	C	7	5	12	0	1	13	0	0
15	4111649	.	T	C	5	2	7	0	0	8	1	0
15	4112123	.	A	T	5	6	11	0	0	11	0	0
15	4112132	.	T	C	5	6	11	0	0	11	0	0
15	4119284	.	A	G	7	10	17	0	1	18	0	0
15	4119323	.	G	A	8	6	14	0	0	14	0	0
15	4119329	.	A	G	7	6	13	0	0	13	0	0
15	4119464	.	G	A	3	2	5	0	1	6	0	0
15	4172470	.	A	G	12	12	24	0	0	24	0	0
15	4180093	.	C	A	1	11	12	0	10	22	0	0
15	4182667	.	T	C	11	0	11	0	15	26	0	0
15	4182718	.	A	G	15	8	23	0	0	23	0	0
15	4202222	.	G	A	5	5	10	0	0	10	0	0
15	4202300	.	T	C	5	5	10	0	1	11	0	0
15	4210264	.	C	G	5	9	14	0	0	14	0	0
15	4210315	.	G	A	6	6	12	0	2	14	0	0
15	4214109	.	A	G	6	7	13	0	1	14	0	0
15	4214139	.	T	C	4	11	15	0	3	18	0	0
15	4214178	.	C	T	2	13	15	0	8	23	0	0
15	4214223	.	A	G	13	8	21	0	0	21	0	0
15	4314014	.	C	A	5	7	12	0	0	12	0	0
15	4353353	.	C	T	19	34	53	0	0	53	0	0
15	4353858	.	C	T	32	21	53	0	6	59	0	0
15	4354071	.	G	A	36	39	75	0	0	75	0	0
15	4354082	.	G	A	30	38	68	0	0	68	0	0
15	4367594	.	T	C	35	26	61	0	1	62	0	0
15	4376110	.	C	T	4	29	33	0	30	63	0	0
15	4422128	.	G	T	5	2	7	0	0	7	0	0
15	4422496	.	A	G	1	3	4	0	1	5	0	0
15	4422580	.	A	G	2	4	6	0	0	6	0	0
15	4426474	.	C	T	9	4	13	0	0	13	0	0
15	4445081	.	A	G	2	5	7	0	0	7	0	0
15	4445225	.	C	T	2	2	4	0	0	4	0	0
15	4475630	.	A	C	3	4	7	1	0	8	0	0
15	4528309	.	G	A	4	3	7	0	1	8	0	0
15	4553776	.	C	T	2	2	4	0	0	4	0	0
15	4585517	.	T	C	8	0	8	1	10	19	0	0
15	4585771	.	T	A	8	14	22	0	0	22	0	0
15	4586190	.	C	G	1	18	19	0	20	39	0	0
15	4586235	.	A	G	16	14	30	0	3	33	0	0
15	4586299	.	G	T	12	3	15	0	2	17	0	0
15	4632798	.	C	A	2	2	4	0	1	5	0	0
15	4633700	.	C	G	33	1	34	0	28	63	1	0
15	4634063	.	C	T	27	24	51	0	1	52	0	0
15	4634196	.	T	C	22	20	42	0	0	42	0	0
15	4634354	.	A	G	20	26	46	0	3	49	0	0
15	4634454	.	A	G	29	23	52	0	0	52	0	0
15	4634627	.	A	G	19	20	39	0	0	39	0	0
15	4634698	.	C	A	25	12	37	1	0	38	0	0
15	4635055	.	G	A	3	24	27	0	24	51	0	0
15	4635073	.	T	C	23	27	50	0	5	55	0	0
15	4635179	.	C	A	22	28	50	0	1	51	0	0
15	4635387	.	C	T	24	11	35	1	5	41	0	0
15	4635517	.	G	A	19	13	32	0	1	33	0	0
15	4635573	.	C	T	24	10	34	0	1	35	0	0
15	4635730	.	G	A	11	4	15	0	0	15	0	0
15	4969267	.	T	C	5	2	7	0	1	8	0	0
15	4969331	.	C	T	2	2	4	0	0	4	0	0
15	4969522	.	C	G	2	5	7	0	0	7	0	0
15	4969558	.	C	T	1	5	6	0	0	6	0	0
15	4976152	.	A	C	2	2	4	0	1	5	0	0
15	4981675	.	G	T	5	3	8	0	0	8	0	0
15	4982502	.	G	T	1	2	3	0	0	3	0	0
15	4982614	.	T	C	3	7	10	0	0	10	0	0
15	4982828	.	A	T	3	6	9	0	0	9	0	0
15	4983533	.	A	T	5	3	8	0	0	8	0	0
15	4983708	.	A	T	4	3	7	0	0	7	0	0
15	4983781	.	T	C	5	5	10	0	0	10	0	0
15	4984740	.	T	C	4	7	11	0	3	14	0	0
15	4984759	.	T	C	5	7	12	0	1	13	0	0
15	4985002	.	A	T	1	2	3	0	1	4	0	0
15	4991716	.	T	C	12	28	40	0	1	41	0	0
15	4991722	.	A	G	10	0	10	0	27	37	0	0
15	4995166	.	A	G	11	20	31	0	0	31	0	0
15	4999347	.	G	C	12	10	22	0	1	23	0	0
15	4999572	.	G	C	16	20	36	0	0	36	0	0
15	5073848	.	A	G	3	0	3	0	3	6	0	0
15	5074033	.	G	A	3	3	6	0	1	7	0	0
15	5074298	.	T	C	1	2	3	0	0	3	0	0
15	5074372	.	G	A	6	4	10	0	0	10	0	0
15	5074539	.	G	T	2	2	4	0	0	4	0	0
15	5074873	.	A	G	4	5	9	0	0	9	0	0
15	5074947	.	A	G	8	3	11	0	0	11	0	0
15	5116217	.	A	G	3	3	6	0	1	7	0	0
15	5116298	.	C	T	4	3	7	0	0	7	0	0
15	5116335	.	T	C	5	5	10	0	0	10	0	0
15	5133457	.	G	A	6	4	10	0	0	10	0	0
15	5133469	.	C	T	6	2	8	0	0	8	0	0
15	5140578	.	A	G	5	3	8	0	0	8	0	0
15	5140807	.	G	A	1	2	3	0	0	3	0	0
15	5140882	.	G	A	4	2	6	0	0	6	0	0
15	5140936	.	C	A	1	4	5	0	1	6	0	0
15	5140939	.	G	A	3	5	8	0	0	8	0	0
15	5142205	.	C	T	5	6	11	0	0	11	0	0
15	5144775	.	T	C	6	4	10	0	1	11	0	0
15	5144805	.	A	C	6	6	12	0	1	13	0	0
15	5144931	.	G	A	8	5	13	0	0	13	0	0
15	5145104	.	C	A	1	5	6	0	0	6	0	0
15	5145137	.	A	C	3	4	7	0	1	8	0	0
15	5147722	.	T	C	10	4	14	0	2	16	0	0
15	5147723	.	A	T	11	5	16	0	0	16	0	0
15	5147843	.	C	T	7	3	10	0	0	10	0	0
15	5147910	.	G	A	5	3	8	0	0	8	0	0
15	5148519	.	T	A	1	2	3	0	0	3	0	0
15	5148562	.	G	A	2	2	4	0	0	4	0	0
15	5403687	.	A	C	16	8	24	0	2	26	0	0
15	5406334	.	A	G	11	10	21	0	2	23	0	0
15	5412406	.	C	T	10	10	20	0	1	21	0	0
15	5467178	.	T	G	11	11	22	0	0	22	0	0
15	5467289	.	C	T	0	6	6	0	10	17	1	0
15	5495159	.	C	A	0	2	2	0	1	3	0	0
15	5563346	.	G	A	2	2	4	0	0	4	0	0
15	5566987	.	T	C	2	2	4	0	0	4	0	0
15	5567026	.	G	A	2	2	4	0	0	4	0	0
15	5570744	.	G	T	2	3	5	0	0	5	0	0
15	5570777	.	C	T	0	3	3	0	2	5	0	0
15	5570807	.	G	A	2	3	5	0	0	5	0	0
15	5603091	.	C	G	1	2	3	0	0	3	0	0
15	5603112	.	C	T	0	2	2	0	2	4	0	0
15	5648119	.	G	A	2	5	7	0	0	7	0	0
15	5650755	.	G	A	6	2	8	0	0	8	0	0
15	5650758	.	T	G	6	2	8	0	0	8	0	0
15	5660306	.	G	C	4	2	6	0	0	6	0	0
15	5672179	.	G	A	3	2	5	0	0	5	0	0
15	5672181	.	A	G	3	2	5	0	0	5	0	0
15	5688762	.	T	C	1	1	2	0	2	4	0	0
15	5708366	.	A	G	3	1	4	0	0	4	0	0
15	5708375	.	C	T	3	2	5	0	0	5	0	0
15	5711053	.	A	G	1	2	3	0	0	3	0	0
15	5719484	.	A	G	2	4	6	0	0	6	0	0
15	5720513	.	T	C	1	2	3	0	0	3	0	0
15	5723734	.	C	A	9	3	12	0	0	12	0	0
15	5723938	.	T	G	15	10	25	0	1	26	0	0
15	5723980	.	C	G	2	14	16	0	14	30	0	0
15	5726178	.	T	A	12	8	20	0	1	21	0	0
15	5728461	.	A	G	13	7	20	0	0	20	0	0
15	5738967	.	A	G	12	11	23	0	0	23	0	0
15	5829662	.	A	C	3	0	3	0	7	10	0	0
15	5829922	.	C	T	1	7	8	0	0	8	0	0
15	5830106	.	G	T	6	6	12	0	0	12	0	0
15	5830218	.	T	C	1	6	7	0	1	8	0	0
15	5830443	.	T	G	6	9	15	0	0	15	0	0
15	5830492	.	C	T	0	3	3	0	3	6	0	0
15	5830513	.	C	T	6	5	11	0	1	12	0	0
15	5830655	.	C	T	1	2	3	0	4	7	0	0
15	5830691	.	T	C	2	3	5	0	1	6	0	0
15	5830696	.	C	T	0	2	2	0	5	7	0	0
15	5830740	.	G	T	4	6	10	0	0	10	0	0
15	5831004	.	G	A	8	6	14	0	0	14	0	0
15	5831199	.	G	A	11	4	15	0	0	15	0	0
15	5831388	.	C	T	1	3	4	0	0	4	0	0
15	5831405	.	T	C	5	3	8	0	0	8	0	0
15	5836499	.	G	A	5	4	9	0	2	11	0	0
15	5836532	.	C	T	5	5	10	0	0	10	0	0
15	5836542	.	C	T	5	3	8	0	1	9	0	0
15	5836610	.	G	T	5	2	7	0	0	7	0	0
15	5837181	.	T	C	3	1	4	0	5	9	0	0
15	5853119	.	A	T	2	4	6	0	0	6	0	0
15	5857224	.	A	G	5	6	11	0	0	11	0	0
15	5862571	.	C	T	2	3	5	0	1	6	0	0
15	5862639	.	A	T	5	5	10	0	1	11	0	0
15	5865261	.	A	G	2	6	8	0	1	9	0	0
15	5865476	.	T	C	6	4	10	0	0	10	0	0
15	5865482	.	A	C	3	0	3	0	6	9	0	0
15	5868536	.	A	T	2	3	5	0	0	5	0	0
15	5870890	.	G	A	4	7	11	0	0	11	0	0
15	5882062	.	A	G	3	2	5	0	0	5	0	0
15	5892333	.	C	A	3	3	6	0	0	6	0	0
15	5898511	.	T	A	10	3	13	0	0	13	0	0
15	5898856	.	A	G	18	17	35	0	1	36	0	0
15	5898920	.	A	C	16	12	28	1	1	30	0	0
15	5899083	.	C	T	0	28	28	0	16	44	0	0
15	5899113	.	G	A	1	34	35	0	1	38	2	0
15	5899237	.	C	A	1	7	8	0	11	19	0	0
15	5899277	.	A	G	3	7	10	0	4	14	0	0
15	5904761	.	T	C	20	13	33	0	2	35	0	0
15	5914994	.	G	A	0	19	19	0	21	40	0	0
15	5916387	.	C	A	12	20	32	0	3	35	0	0
15	5916389	.	G	C	12	23	35	0	0	35	0	0
15	5916442	.	G	A	13	10	23	0	0	23	0	0
15	5916570	.	C	T	5	2	7	0	0	7	0	0
15	5946318	.	G	A	1	2	3	0	0	3	0	0
15	6139624	.	G	C	11	7	18	0	2	20	0	0
15	6139800	.	G	A	15	18	33	0	2	35	0	0
15	6139803	.	C	T	14	18	32	0	2	34	0	0
15	6154439	.	T	A	19	20	39	0	0	39	0	0
15	6161235	.	A	G	10	13	23	0	1	24	0	0
15	6161789	.	A	G	7	16	23	0	0	23	0	0
15	6161804	.	C	T	1	12	13	0	8	21	0	0
15	6174544	.	T	G	8	19	27	0	0	27	0	0
15	6186503	.	A	G	9	8	17	0	0	17	0	0
15	6217600	.	A	G	7	3	10	0	0	10	0	0
15	6957221	.	C	G	5	7	12	0	1	13	0	0
15	8437030	.	A	G	2	3	5	0	1	6	0	0
15	8442793	.	T	G	3	5	8	0	0	8	0	0
15	8485104	.	T	G	1	2	3	0	0	3	0	0
15	8485185	.	T	C	4	5	9	0	0	9	0	0
15	8485191	.	T	C	4	5	9	0	0	9	0	0
15	8604835	.	A	C	4	16	20	2	0	22	0	0
15	8605259	.	C	A	13	8	21	0	0	21	0	0
15	8605318	.	G	A	15	7	22	0	0	22	0	0
15	8605452	.	C	A	7	10	17	0	0	17	0	0
15	8605838	.	T	A	12	11	23	0	1	24	0	0
15	8605839	.	A	T	11	12	23	0	1	24	0	0
15	8605972	.	T	A	11	12	23	1	0	24	0	0
15	8606207	.	A	T	7	7	14	0	0	14	0	0
15	8606224	.	G	A	5	8	13	0	0	13	0	0
15	8606256	.	A	C	6	9	15	0	0	15	0	0
15	8606464	.	A	G	11	8	19	0	0	19	0	0
15	8606501	.	G	A	7	13	20	0	0	20	0	0
15	8606507	.	G	A	7	12	19	0	0	19	0	0
15	8606555	.	C	T	8	10	18	0	0	18	0	0
15	8606601	.	A	C	8	11	19	0	0	19	0	0
15	8606619	.	A	G	9	11	20	0	1	21	0	0
15	8606733	.	T	C	11	7	18	0	0	18	0	0
15	8606739	.	A	T	11	8	19	0	0	19	0	0
15	8606799	.	T	G	6	5	11	0	5	16	0	0
15	8606872	.	C	A	12	9	21	0	0	21	0	0
15	8606897	.	T	C	9	4	13	0	0	13	0	0
15	8606940	.	T	G	6	10	16	0	1	17	0	0
15	8606943	.	T	G	7	10	17	0	1	18	0	0
15	8607025	.	T	A	11	13	24	0	0	24	0	0
15	8607182	.	T	A	12	14	26	0	0	26	0	0
15	8607365	.	G	T	10	11	21	0	15	36	0	0
15	8607846	.	T	A	18	13	31	0	2	33	0	0
15	8661671	.	C	T	9	8	17	0	0	17	0	0
15	8663798	.	A	G	4	3	7	0	0	7	0	0
15	8665414	.	G	A	7	5	12	0	0	12	0	0
15	8665459	.	C	T	0	4	4	0	4	8	0	0
15	8665481	.	G	A	4	3	7	0	0	7	0	0
15	8665506	.	A	G	4	4	8	0	1	9	0	0
15	8797850	.	T	C	29	23	52	0	8	60	0	0
15	8799141	.	T	A	23	17	40	0	0	40	0	0
15	8799462	.	T	A	18	19	37	4	0	41	0	0
15	8799713	.	G	A	19	28	47	0	4	51	0	0
15	8799730	.	T	G	19	1	20	0	36	56	0	0
15	8799831	.	T	C	7	21	28	0	2	30	0	0
15	8799856	.	G	A	10	13	23	0	1	24	0	0
15	8799872	.	C	A	12	12	24	0	0	24	0	0
15	8799892	.	C	T	18	9	27	0	0	27	0	0
15	8799916	.	T	C	15	8	23	0	5	28	0	0
15	8813971	.	G	A	6	2	8	0	0	8	0	0
15	8814378	.	G	C	1	2	3	0	0	3	0	0
15	8856248	.	C	T	0	3	3	0	3	6	0	0
15	8856283	.	G	T	5	7	12	0	0	12	0	0
15	8856293	.	C	T	9	7	16	0	1	17	0	0
15	8990820	.	G	A	1	3	4	0	0	4	0	0
15	8992716	.	T	C	2	3	5	0	0	5	0	0
15	8992752	.	A	T	2	2	4	0	0	4	0	0
15	9011092	.	A	G	3	5	8	0	1	9	0	0
15	9020621	.	C	T	6	5	11	0	0	11	0	0
15	9022711	.	A	G	3	4	7	0	0	7	0	0
15	9022736	.	C	T	1	3	4	0	1	5	0	0
15	9234102	.	A	C	14	15	29	0	1	30	0	0
15	9234114	.	A	G	17	19	36	0	1	37	0	0
15	9234156	.	A	C	23	20	43	0	0	43	0	0
15	9234634	.	A	T	25	18	43	0	0	43	0	0
15	9234885	.	A	G	32	34	66	0	1	67	0	0
15	9234960	.	C	T	35	30	65	0	0	65	0	0
15	9234972	.	T	C	38	27	65	0	3	68	0	0
15	9235081	.	C	G	41	27	68	0	6	74	0	0
15	9235128	.	A	C	37	35	72	0	0	72	0	0
15	9235254	.	A	G	29	29	58	0	3	61	0	0
15	9235319	.	C	T	34	27	61	0	2	63	0	0
15	9235461	.	T	G	45	12	57	0	5	62	0	0
15	9238101	.	G	A	37	33	70	0	5	75	0	0
15	9249293	.	G	A	33	34	67	0	3	70	0	0
15	9249344	.	C	T	30	38	68	0	1	69	0	0
15	9249346	.	A	G	31	37	68	0	2	70	0	0
15	9272219	.	G	T	25	11	36	12	0	48	0	0
15	9315612	.	C	A	5	3	8	0	0	8	0	0
15	9319051	.	T	C	12	0	12	0	8	20	0	0
15	9367812	.	G	A	10	6	16	0	0	16	0	0
15	9367842	.	T	C	6	10	16	0	0	16	0	0
15	9368757	.	G	A	7	8	15	0	0	15	0	0
15	9368834	.	A	G	10	12	22	1	1	24	0	0
15	9369114	.	T	C	12	8	20	0	2	22	0	0
15	9369293	.	T	A	5	6	11	0	0	11	0	0
15	9369571	.	A	T	6	9	15	0	0	15	0	0
15	9369610	.	A	T	8	5	13	0	1	14	0	0
15	9369651	.	G	C	8	14	22	0	0	22	0	0
15	9369689	.	G	A	9	11	20	0	1	21	0	0
15	9369733	.	C	T	8	9	17	0	2	19	0	0
15	9369737	.	C	G	12	9	21	0	0	21	0	0
15	9370068	.	G	A	8	4	12	0	0	12	0	0
15	9370096	.	T	C	10	6	16	0	1	17	0	0
15	9370115	.	G	A	5	11	16	0	0	16	0	0
15	9370131	.	C	T	8	9	17	0	1	18	0	0
15	9370429	.	A	C	2	4	6	0	1	7	0	0
15	9370477	.	A	G	7	3	10	0	0	10	0	0
15	9370534	.	T	A	6	6	12	0	0	12	0	0
15	9370553	.	C	T	5	8	13	0	1	14	0	0
15	9370919	.	G	T	10	6	16	0	2	18	0	0
15	9370967	.	T	C	10	0	10	0	9	19	0	0
15	9371303	.	G	A	14	6	20	0	0	20	0	0
15	9371564	.	A	G	15	8	23	0	1	24	0	0
15	9371657	.	T	C	8	5	13	0	0	13	0	0
15	9371678	.	A	G	7	7	14	0	0	14	0	0
15	9372053	.	T	C	10	6	16	0	0	16	0	0
15	9372281	.	C	T	10	2	12	0	2	14	0	0
15	9372356	.	T	A	10	7	17	0	1	18	0	0
15	9372500	.	G	A	6	12	18	0	0	18	0	0
15	9372539	.	G	A	10	4	14	0	0	14	0	0
15	9372730	.	G	A	5	7	12	0	0	12	0	0
15	9372929	.	C	T	6	6	12	0	2	14	0	0
15	9373205	.	G	A	1	4	5	0	0	5	0	0
15	9373698	.	T	C	6	5	11	0	1	12	0	0
15	9373801	.	C	T	5	4	9	0	0	9	0	0
15	9373901	.	G	T	2	4	6	0	0	6	0	0
15	9373967	.	A	G	2	2	4	0	0	4	0	0
15	9374174	.	T	C	3	3	6	0	1	7	0	0
15	9374363	.	G	A	3	7	10	0	0	10	0	0
15	9374527	.	G	T	4	5	9	0	0	9	0	0
15	9374627	.	A	T	2	6	8	0	0	8	0	0
15	9374860	.	A	T	6	6	12	0	0	12	0	0
15	9374894	.	T	C	2	4	6	0	1	7	0	0
15	9375002	.	G	T	4	6	10	0	0	10	0	0
15	9375542	.	C	T	8	2	10	0	1	11	0	0
15	9375767	.	C	G	4	4	8	0	0	8	0	0
15	9375773	.	A	G	3	4	7	0	0	7	0	0
15	9377192	.	A	G	4	9	13	0	0	13	0	0
15	9378090	.	A	T	6	5	11	0	0	11	0	0
15	9379394	.	C	T	1	1	2	0	1	3	0	0
15	9379485	.	T	C	4	3	7	0	0	7	0	0
15	9379868	.	A	G	5	5	10	0	0	10	0	0
15	9380048	.	G	T	3	3	6	0	0	6	0	0
15	9380804	.	C	T	0	3	3	0	1	4	0	0
15	9381047	.	G	A	1	2	3	0	0	3	0	0
15	9381389	.	T	C	1	2	3	0	0	3	0	0
15	9382214	.	T	A	3	2	5	0	0	5	0	0
15	9382293	.	G	T	6	4	10	0	0	10	0	0
15	9389731	.	G	A	1	3	4	0	0	4	0	0
15	9389826	.	T	C	2	3	5	0	0	5	0	0
15	9390073	.	A	T	1	3	4	0	0	4	0	0
15	9445175	.	A	G	1	2	3	0	0	3	0	0
15	9445444	.	A	T	3	4	7	0	0	7	0	0
15	9445574	.	A	T	2	2	4	0	0	4	0	0
15	9459460	.	C	T	4	2	6	0	0	6	0	0
15	9466627	.	A	G	5	2	7	0	0	7	0	0
15	9466908	.	A	G	5	2	7	0	0	7	0	0
15	9519539	.	A	G	2	2	4	0	0	4	0	0
15	9592945	.	T	A	1	3	4	0	0	4	0	0
15	9608617	.	A	G	1	4	5	0	0	5	0	0
15	9613343	.	G	T	3	5	8	0	0	8	0	0
15	9617134	.	T	C	3	0	3	0	3	6	0	0
15	10001851	.	A	G	12	10	22	0	0	22	0	0
15	10002281	.	G	A	12	8	20	0	0	20	0	0
15	10002317	.	G	A	10	5	15	0	0	15	0	0
15	10003274	.	C	T	7	16	23	0	0	23	0	0
15	10003357	.	G	A	4	11	15	0	1	16	0	0
15	10003379	.	G	A	5	9	14	0	0	14	0	0
15	10003647	.	C	T	0	10	10	0	10	20	0	0
15	10003767	.	C	T	0	8	8	0	6	14	0	0
15	10025010	.	T	C	8	12	20	0	0	20	0	0
15	10025185	.	A	G	7	11	18	0	1	19	0	0
15	10025508	.	A	G	6	6	12	0	0	12	0	0
15	10025601	.	G	C	6	0	6	0	9	15	0	0
15	10025688	.	G	A	7	7	14	0	1	15	0	0
15	10025760	.	T	G	6	6	12	0	0	12	0	0
15	10025949	.	C	T	2	13	15	0	0	15	0	0
15	10027257	.	T	C	6	9	15	0	0	15	0	0
15	10027296	.	A	G	2	10	12	0	0	12	0	0
15	10039622	.	T	C	4	8	12	0	0	12	0	0
15	10039643	.	T	C	7	8	15	0	0	15	0	0
15	10039775	.	A	G	8	6	14	0	0	14	0	0
15	10065534	.	T	A	10	2	12	0	1	13	0	0
15	10065645	.	A	G	5	4	9	0	1	10	0	0
15	10065663	.	A	G	8	5	13	0	0	13	0	0
15	10065735	.	G	A	3	5	8	0	2	10	0	0
15	10065786	.	T	C	7	0	7	0	9	16	0	0
15	10065843	.	T	G	6	7	13	0	1	14	0	0
15	10065846	.	A	G	6	6	12	0	1	13	0	0
15	10066074	.	G	A	6	5	11	0	0	11	0	0
15	10066080	.	G	A	4	5	9	0	0	9	0	0
15	10066287	.	A	G	4	2	6	0	0	6	0	0
15	10081882	.	G	A	3	2	5	0	0	5	0	0
15	10081902	.	G	A	4	2	6	0	1	7	0	0
15	10081966	.	G	A	2	6	8	0	0	8	0	0
15	10088507	.	G	A	8	5	13	0	1	14	0	0
15	10088588	.	C	T	5	8	13	0	0	13	0	0
15	10107512	.	C	T	2	8	10	0	0	10	0	0
15	10107545	.	C	G	0	5	5	0	3	8	0	0
15	10109991	.	G	A	2	6	8	0	0	8	0	0
15	10114779	.	G	A	4	8	12	0	0	12	0	0
15	10114788	.	A	G	4	7	11	0	0	11	0	0
15	10114932	.	C	T	8	3	11	1	1	13	0	0
15	10267720	.	C	T	0	3	3	0	1	4	0	0
15	10340978	.	G	C	5	3	8	0	0	8	0	0
15	10341020	.	A	G	4	4	8	0	0	8	0	0
15	10341041	.	G	A	3	2	5	0	0	5	0	0
15	10455261	.	C	A	4	2	6	0	0	6	0	0
15	10455411	.	G	A	5	4	9	0	1	10	0	0
15	11668065	.	A	G	5	3	8	0	0	8	0	0
15	11668633	.	C	T	6	7	13	0	0	13	0	0
15	11670283	.	A	C	7	5	12	0	0	12	0	0
15	11681447	.	A	G	6	3	9	0	1	10	0	0
15	11690967	.	T	C	6	5	11	0	0	11	0	0
15	11691008	.	T	G	4	0	4	0	6	10	0	0
15	11757580	.	T	A	18	11	29	0	2	32	1	0
15	11874021	.	A	G	3	0	3	0	3	6	0	0
15	11874022	.	A	T	3	3	6	0	0	6	0	0
15	11953682	.	C	T	1	2	3	0	0	3	0	0
15	11954487	.	A	G	2	2	4	0	0	4	0	0
15	11954787	.	G	A	1	5	6	0	0	6	0	0
15	12096078	.	C	T	15	5	20	0	0	20	0	0
15	12098649	.	C	A	8	8	16	0	1	17	0	0
15	12101952	.	G	A	8	13	21	0	1	22	0	0
15	12103781	.	G	T	11	12	23	0	0	23	0	0
15	12104338	.	C	T	1	6	7	0	16	23	0	0
15	12105681	.	A	G	10	12	22	0	0	22	0	0
15	12105687	.	T	C	11	12	23	0	0	23	0	0
15	12110547	.	A	G	6	4	10	0	1	11	0	0
15	12110785	.	G	A	2	3	5	0	0	5	0	0
15	12111076	.	A	G	5	4	9	0	0	9	0	0
15	12111160	.	C	A	7	6	13	0	0	13	0	0
15	12112902	.	A	T	5	8	13	0	2	15	0	0
15	12112941	.	T	C	7	3	10	0	1	11	0	0
15	12117601	.	T	A	4	3	7	0	2	9	0	0
15	12118661	.	C	T	0	7	7	0	4	11	0	0
15	12118786	.	G	A	10	8	18	0	1	19	0	0
15	12118838	.	T	C	8	7	15	0	1	16	0	0
15	12121443	.	G	A	10	7	17	0	0	17	0	0
15	12123722	.	G	A	5	4	9	0	0	9	0	0
15	12206686	.	G	A	4	3	7	1	0	8	0	0
15	12293289	.	G	A	21	17	38	1	1	40	0	0
15	12319008	.	C	A	22	23	45	0	0	45	0	0
15	12500814	.	T	C	22	10	32	0	1	33	0	0
15	12521382	.	T	G	12	16	28	1	2	31	0	0
15	12521405	.	T	G	11	16	27	1	2	30	0	0
15	12521472	.	G	A	18	21	39	0	1	40	0	0
15	12521506	.	A	G	17	21	38	0	2	40	0	0
15	12521680	.	A	C	20	31	51	0	0	51	0	0
15	12521745	.	A	G	16	19	35	0	1	36	0	0
15	12521964	.	A	T	10	11	21	0	3	24	0	0
15	12522031	.	A	T	10	12	22	0	0	22	0	0
15	12522094	.	A	T	9	15	24	0	1	25	0	0
15	12522104	.	T	C	11	17	28	0	0	28	0	0
15	12522132	.	T	G	13	14	27	0	3	30	0	0
15	12522179	.	A	G	13	16	29	0	0	29	0	0
15	12522353	.	T	A	21	13	34	0	0	34	0	0
15	12522514	.	G	A	14	17	31	0	1	32	0	0
15	12522673	.	A	G	17	14	31	0	2	34	1	0
15	12522736	.	C	G	18	13	31	0	2	33	0	0
15	12526620	.	G	T	20	27	47	0	2	49	0	0
15	12526623	.	G	T	15	28	43	0	4	47	0	0
15	12545614	.	G	T	14	17	31	0	1	32	0	0
15	14598708	.	C	T	1	11	12	0	0	12	0	0
15	15445767	.	T	C	3	0	3	0	11	14	0	0
15	15445876	.	T	C	3	2	5	0	1	6	0	0
15	15445899	.	T	C	3	6	9	0	1	10	0	0
15	15886461	.	A	T	3	15	18	0	1	19	0	0
15	16406604	.	G	T	11	3	14	0	1	15	0	0
15	16407139	.	A	T	2	2	4	0	0	4	0	0
15	16937179	.	T	C	7	16	23	0	0	23	0	0
15	16937203	.	T	C	14	13	27	0	1	28	0	0
15	16937375	.	T	C	13	4	17	0	0	17	0	0
15	16937688	.	T	C	10	5	15	0	1	16	0	0
15	17124283	.	A	G	11	7	18	0	1	19	0	0
15	17487277	.	A	G	8	5	13	0	0	13	0	0
15	17487544	.	A	G	16	8	24	0	2	26	0	0
15	17487561	.	A	G	19	6	25	0	0	25	0	0
15	17866447	.	C	A	6	3	9	0	0	9	0	0
15	19139092	.	T	G	9	1	10	0	19	29	0	0
15	20939497	.	A	G	4	2	6	0	0	6	0	0
15	20941492	.	T	A	4	2	6	0	0	6	0	0
15	23188799	.	T	C	3	2	5	0	0	5	0	0
15	23640678	.	A	C	3	1	4	0	33	37	0	0
15	23818405	.	T	C	12	6	18	0	0	18	0	0
15	24736413	.	A	G	3	5	8	0	0	8	0	0
15	25485275	.	A	G	5	4	9	0	1	10	0	0
15	25485278	.	A	G	3	4	7	0	0	7	0	0
15	25592720	.	T	C	3	11	14	0	1	15	0	0
15	25592838	.	T	C	7	5	12	0	1	13	0	0
15	25595702	.	T	C	17	6	23	0	0	23	0	0
15	26400693	.	T	G	1	0	1	0	6	7	0	0
15	26400704	.	T	G	2	0	2	0	3	6	1	0
15	27353222	.	T	C	3	3	6	0	2	8	0	0
15	27703806	.	A	T	16	0	16	0	5	21	0	0
15	28079317	.	T	C	5	5	10	0	0	10	0	0
15	28375527	.	A	T	1	2	3	0	0	3	0	0
15	28539591	.	A	G	12	4	16	0	1	17	0	0
15	28539607	.	A	G	9	5	14	0	4	18	0	0
15	28763392	.	C	A	20	8	28	1	6	35	0	0
15	30425704	.	T	C	5	5	10	0	2	12	0	0
15	30838498	.	G	A	1	8	9	0	2	11	0	0
15	30838501	.	A	G	7	4	11	0	3	14	0	0
15	31866649	.	C	T	5	5	10	0	0	10	0	0
15	31877363	.	C	T	6	9	15	0	0	15	0	0
15	31881825	.	G	A	7	5	12	0	2	14	0	0
15	31881873	.	G	A	1	5	6	0	8	14	0	0
15	31881954	.	T	C	8	13	21	0	0	21	0	0
15	31882044	.	A	G	7	9	16	0	0	16	0	0
15	31882167	.	G	A	2	5	7	0	0	7	0	0
15	31882176	.	A	G	3	6	9	0	0	9	0	0
15	31882269	.	G	A	3	8	11	0	0	11	0	0
15	31882272	.	A	G	3	7	10	0	1	11	0	0
15	31882342	.	C	T	10	8	18	0	1	19	0	0
15	31884219	.	A	C	2	7	9	0	0	9	0	0
15	31889005	.	T	G	7	6	13	0	0	13	0	0
15	31889086	.	A	G	3	8	11	0	1	12	0	0
15	31889332	.	C	T	12	7	19	0	0	19	0	0
15	31890902	.	T	G	7	11	18	0	0	18	0	0
15	31893536	.	A	C	8	11	19	0	0	19	0	0
15	31893599	.	C	T	9	12	21	0	1	22	0	0
15	31895248	.	A	G	7	0	7	0	13	20	0	0
15	31897844	.	T	G	4	0	4	0	13	17	0	0
15	31905040	.	G	A	14	12	26	0	0	26	0	0
15	31905097	.	A	G	11	11	22	0	2	24	0	0
15	31909454	.	A	C	11	6	17	0	3	20	0	0
15	32193624	.	A	C	1	4	5	0	0	5	0	0
15	32193676	.	C	T	1	3	4	0	0	4	0	0
15	32193892	.	G	T	0	4	4	0	2	6	0	0
15	32193922	.	A	T	3	6	9	0	0	9	0	0
15	32193967	.	T	C	2	4	6	0	0	6	0	0
15	32193975	.	A	G	1	3	4	0	0	4	0	0
15	32194031	.	C	T	1	2	3	0	0	3	0	0
15	32194048	.	T	C	1	2	3	0	0	3	0	0
15	32194286	.	G	A	1	2	3	0	0	3	0	0
15	32194342	.	C	A	2	2	4	0	1	5	0	0
15	32194630	.	C	A	2	2	4	0	0	4	0	0
15	32194945	.	C	A	3	2	5	0	0	5	0	0
15	32195020	.	C	T	2	4	6	0	0	6	0	0
15	32195395	.	T	C	3	3	6	0	0	6	0	0
15	32195432	.	G	A	3	7	10	0	0	10	0	0
15	32195521	.	T	C	6	4	10	0	0	10	0	0
15	32195718	.	G	A	5	2	7	0	0	7	0	0
15	32195729	.	A	G	2	4	6	0	0	6	0	0
15	32196093	.	G	A	0	3	3	0	3	6	0	0
15	32196363	.	A	T	2	3	5	0	0	5	0	0
15	32196539	.	G	C	1	2	3	0	1	4	0	0
15	32197313	.	T	A	1	2	3	0	0	3	0	0
15	32249188	.	G	A	23	17	40	0	0	40	0	0
15	32259056	.	G	A	7	15	22	0	2	24	0	0
15	32261461	.	G	C	1	13	14	1	15	30	0	0
15	32261464	.	T	C	15	14	29	1	2	32	0	0
15	32265889	.	T	C	15	14	29	0	0	29	0	0
15	32266557	.	A	T	9	10	19	0	0	19	0	0
15	32266921	.	G	A	2	11	13	0	11	24	0	0
15	32267078	.	A	G	4	7	11	0	0	11	0	0
15	32267120	.	C	A	3	2	5	0	0	5	0	0
15	32350061	.	A	G	14	5	19	22	0	41	0	0
15	32350116	.	G	T	11	13	24	0	0	24	0	0
15	32350515	.	A	G	13	12	25	0	1	26	0	0
15	32350517	.	A	G	17	8	25	0	0	25	0	0
15	32350762	.	A	G	16	6	22	0	2	24	0	0
15	32351183	.	A	G	6	8	14	0	0	14	0	0
15	32887739	.	A	G	13	0	13	0	9	22	0	0
15	32887799	.	A	G	5	4	9	1	0	10	0	0
15	32887858	.	A	G	9	7	16	0	0	16	0	0
15	33169901	.	C	G	1	0	1	0	1	2	0	0
15	33853701	.	C	T	5	3	8	1	2	11	0	0
15	33864152	.	A	G	5	6	11	0	2	13	0	0
15	33864266	.	G	A	6	2	8	0	0	8	0	0
15	33864585	.	G	A	4	3	7	0	0	7	0	0
15	33891825	.	G	A	28	22	50	0	0	50	0	0
15	33891826	.	G	A	29	22	51	0	0	51	0	0
15	33891869	.	G	T	27	19	46	1	3	50	0	0
15	33896117	.	G	T	24	24	48	0	1	49	0	0
15	33896177	.	T	C	17	37	54	0	1	55	0	0
15	33896213	.	T	C	25	1	26	0	30	56	0	0
15	33896303	.	T	A	28	33	61	0	3	64	0	0
15	33896306	.	A	G	33	25	58	0	6	64	0	0
15	33896832	.	T	C	21	19	40	0	3	43	0	0
15	33899556	.	C	G	20	14	34	0	1	35	0	0
15	33899808	.	T	A	16	33	49	0	3	52	0	0
15	33902388	.	C	G	5	13	18	0	20	38	0	0
15	33910546	.	G	C	25	23	48	0	1	50	1	0
15	33925764	.	G	A	1	3	4	0	0	4	0	0
15	33970841	.	A	G	23	0	23	0	20	43	0	0
15	33970854	.	C	T	20	21	41	0	1	42	0	0
15	33970907	.	C	T	21	17	38	0	6	44	0	0
15	33971097	.	G	C	17	23	40	0	2	42	0	0
15	33977716	.	A	T	21	13	34	0	0	34	0	0
15	33977760	.	A	G	14	0	14	0	23	37	0	0
15	33977942	.	A	C	8	9	17	0	0	17	0	0
15	34074558	.	C	T	5	2	7	0	1	8	0	0
15	34174532	.	T	A	17	10	27	0	0	27	0	0
15	34174568	.	T	A	14	9	23	0	2	25	0	0
15	34174635	.	T	C	7	6	13	0	1	14	0	0
15	34175101	.	T	C	16	18	34	0	0	34	0	0
15	34175426	.	T	A	8	16	24	0	1	25	0	0
15	34175718	.	G	A	8	5	13	0	0	13	0	0
15	34175917	.	C	T	5	9	14	1	0	15	0	0
15	34175929	.	C	T	12	7	19	0	1	20	0	0
15	34176203	.	A	T	15	5	20	0	1	21	0	0
15	34176214	.	C	T	6	13	19	0	0	19	0	0
15	34176336	.	G	T	4	2	6	0	0	6	0	0
15	34176379	.	A	C	16	7	23	0	0	23	0	0
15	34176841	.	A	T	9	10	19	0	0	19	0	0
15	34176993	.	G	A	10	5	15	0	0	15	0	0
15	34182135	.	G	A	15	8	23	0	0	23	0	0
15	34186690	.	A	T	12	14	26	0	0	26	0	0
15	34189452	.	G	A	12	13	25	0	1	26	0	0
15	34212903	.	G	A	2	4	6	0	0	6	0	0
15	34213962	.	G	A	3	1	4	1	1	6	0	0
15	34215835	.	A	T	4	2	6	0	0	6	0	0
15	34223260	.	A	G	3	4	7	0	0	7	0	0
15	34239165	.	C	T	3	3	6	0	0	6	0	0
15	34239191	.	C	T	2	2	4	0	0	4	0	0
15	34334858	.	G	T	2	2	4	0	0	4	0	0
15	34335044	.	T	A	1	3	4	0	0	4	0	0
15	34335147	.	G	A	1	2	3	0	0	3	0	0
15	34335272	.	C	T	4	6	10	0	0	10	0	0
15	34365162	.	C	T	2	1	3	0	1	4	0	0
15	34367541	.	C	T	1	4	5	0	0	5	0	0
15	34534245	.	C	G	3	3	6	0	0	6	0	0
15	34534265	.	C	T	2	4	6	0	0	6	0	0
15	34558428	.	G	A	6	7	13	0	0	13	0	0
15	34558438	.	G	T	4	4	8	0	0	8	0	0
15	34573337	.	C	T	5	4	9	0	0	9	0	0
15	34573343	.	A	G	5	4	9	0	0	9	0	0
15	34573437	.	G	A	3	3	6	0	0	6	0	0
15	34573454	.	A	C	6	4	10	0	0	10	0	0
15	34573597	.	A	T	1	6	7	0	0	7	0	0
15	34573664	.	G	T	7	2	9	0	0	9	0	0
15	34574116	.	G	A	7	9	16	0	0	16	0	0
15	34577749	.	G	A	7	7	14	0	0	14	0	0
15	34585286	.	C	A	5	2	7	0	0	7	0	0
15	34586304	.	A	G	2	6	8	0	0	8	0	0
15	34590674	.	A	C	1	2	3	0	0	3	0	0
15	34618456	.	T	G	9	8	17	0	1	18	0	0
15	34618669	.	A	T	15	16	31	0	0	31	0	0
15	34618906	.	C	A	14	9	23	0	1	24	0	0
15	34618948	.	T	G	14	16	30	0	1	31	0	0
15	34618958	.	G	A	15	17	32	0	1	33	0	0
15	34621868	.	G	A	12	15	27	0	2	29	0	0
15	34621875	.	G	A	16	13	29	0	0	29	0	0
15	34627792	.	T	A	13	11	24	0	2	26	0	0
15	34627874	.	T	C	21	11	32	0	1	33	0	0
15	34635321	.	C	A	4	13	17	0	0	17	0	0
15	34635336	.	A	C	7	0	7	0	9	16	0	0
15	34637582	.	C	T	0	12	12	0	19	31	0	0
15	34638847	.	C	T	3	14	17	0	13	30	0	0
15	34641252	.	G	C	5	0	5	0	9	14	0	0
15	34641276	.	G	A	9	7	16	0	0	16	0	0
15	34641300	.	G	A	11	6	17	0	0	17	0	0
15	34641384	.	G	A	11	14	25	0	1	26	0	0
15	34657370	.	C	T	11	5	16	0	2	18	0	0
15	34657919	.	T	A	10	11	21	0	1	22	0	0
15	35102653	.	G	A	1	3	4	1	0	5	0	0
15	35102954	.	T	C	1	2	3	1	0	4	0	0
15	35102957	.	G	T	1	2	3	1	0	4	0	0
15	35115699	.	A	G	2	3	5	5	0	10	0	0
15	35117682	.	T	C	1	2	3	5	0	8	0	0
15	35157052	.	T	A	4	9	13	0	0	13	0	0
15	35157054	.	G	A	4	8	12	0	1	13	0	0
15	35158661	.	T	G	15	8	23	0	0	23	0	0
15	35163492	.	T	G	9	7	16	0	0	16	0	0
15	35187682	.	C	T	0	6	6	0	5	11	0	0
15	35212147	.	C	G	0	5	5	0	6	11	0	0
15	35212177	.	G	A	5	6	11	0	0	11	0	0
15	35212318	.	A	T	3	8	11	0	2	13	0	0
15	35212386	.	T	C	2	3	5	0	0	5	0	0
15	35212418	.	G	C	2	3	5	0	1	6	0	0
15	35214784	.	T	A	11	5	16	0	0	16	0	0
15	35214859	.	A	C	11	0	11	0	7	18	0	0
15	35214901	.	G	A	14	6	20	0	0	20	0	0
15	35217424	.	G	A	3	10	13	0	0	13	0	0
15	35217475	.	T	C	7	9	16	0	0	16	0	0
15	35217487	.	C	A	0	8	8	0	8	16	0	0
15	35221304	.	A	T	6	11	17	0	2	19	0	0
15	35224269	.	G	C	9	9	18	0	2	20	0	0
15	35227221	.	A	T	13	5	18	0	0	18	0	0
15	35247678	.	A	T	18	22	40	0	3	43	0	0
15	35247687	.	A	G	20	19	39	0	1	40	0	0
15	35247729	.	A	G	16	21	37	0	1	38	0	0
15	35247762	.	T	C	18	22	40	0	1	41	0	0
15	35709983	.	G	A	1	5	6	0	4	10	0	0
15	35709988	.	C	T	5	4	9	0	0	9	0	0
15	35718398	.	A	C	8	7	15	0	0	15	0	0
15	35737680	.	T	C	12	8	20	0	1	21	0	0
15	35760664	.	C	T	6	9	15	0	1	16	0	0
15	35760970	.	G	A	10	4	14	0	0	14	0	0
15	35761024	.	T	C	10	3	13	0	1	14	0	0
15	35761027	.	A	G	11	2	13	0	1	14	0	0
15	35761126	.	G	A	0	10	10	0	6	16	0	0
15	35761225	.	G	A	14	11	25	0	0	25	0	0
15	35761516	.	T	C	8	6	14	0	0	14	0	0
15	35889139	.	G	A	1	2	3	0	0	3	0	0
15	35889474	.	G	A	3	2	5	0	1	6	0	0
15	35889826	.	C	T	3	2	5	0	0	5	0	0
15	35889865	.	A	G	3	3	6	0	0	6	0	0
15	35890046	.	G	A	1	4	5	0	0	5	0	0
15	35890148	.	C	T	4	2	6	0	0	6	0	0
15	35891203	.	A	T	2	3	5	0	0	5	0	0
15	35891639	.	T	A	3	2	5	0	0	5	0	0
15	35892879	.	T	C	4	2	6	0	1	7	0	0
15	35926361	.	C	G	2	2	4	0	0	4	0	0
15	35926711	.	G	C	1	2	3	0	0	3	0	0
15	35926754	.	A	G	2	2	4	0	0	4	0	0
15	35927516	.	C	T	1	3	4	0	2	6	0	0
15	35929004	.	C	A	1	2	3	0	0	3	0	0
15	37457660	.	G	A	5	2	7	0	1	8	0	0
15	37459369	.	T	C	5	4	9	0	0	9	0	0
15	37459443	.	T	C	2	5	7	0	1	8	0	0
15	37459979	.	T	C	9	5	14	0	0	14	0	0
15	37459988	.	T	C	5	1	6	0	5	11	0	0
15	37460201	.	T	C	1	0	1	0	2	3	0	0
15	37460405	.	T	C	2	3	5	0	0	5	0	0
15	37561828	.	A	G	4	3	7	0	0	7	0	0
15	37561838	.	A	G	1	5	6	0	0	6	0	0
15	38202095	.	T	C	1	2	3	0	0	3	0	0
15	38221243	.	C	A	15	12	27	0	1	28	0	0
15	38221279	.	T	C	16	14	30	0	0	30	0	0
15	38221433	.	A	C	16	6	22	0	0	22	0	0
15	38223632	.	C	T	14	8	22	0	0	22	0	0
15	38223672	.	T	A	6	13	19	0	1	20	0	0
15	38223685	.	C	G	7	10	17	0	2	19	0	0
15	38239605	.	G	A	11	17	28	1	0	29	0	0
15	38239641	.	C	T	7	13	20	0	0	20	0	0
15	38239692	.	C	A	6	8	14	0	1	15	0	0
15	38254283	.	A	G	5	9	14	0	1	15	0	0
15	38258644	.	A	G	13	0	13	0	16	29	0	0
15	38268705	.	T	A	11	11	22	0	1	23	0	0
15	38282687	.	T	C	15	19	34	1	1	36	0	0
15	38287983	.	G	A	21	18	39	1	1	41	0	0
15	38287995	.	A	G	20	15	35	1	2	38	0	0
15	38288104	.	A	C	15	12	27	0	0	27	0	0
15	38289831	.	A	G	9	18	27	0	3	30	0	0
15	38295122	.	T	C	12	25	37	0	2	39	0	0
15	38295158	.	T	C	13	18	31	0	3	34	0	0
15	38295347	.	G	A	13	20	33	0	1	34	0	0
15	38295485	.	C	G	18	13	31	0	1	32	0	0
15	38295545	.	C	T	12	9	21	0	0	21	0	0
15	38295679	.	C	A	7	6	13	0	2	15	0	0
15	38295771	.	G	A	11	10	21	0	0	21	0	0
15	38296305	.	A	G	15	16	31	0	0	31	0	0
15	38296377	.	A	G	9	11	20	0	2	22	0	0
15	38296449	.	T	C	14	9	23	0	3	26	0	0
15	38296885	.	A	G	16	0	16	0	11	27	0	0
15	38296900	.	T	A	18	14	32	0	0	32	0	0
15	38297071	.	T	C	20	10	30	0	2	32	0	0
15	38297214	.	C	T	18	21	39	0	1	40	0	0
15	38297364	.	C	T	20	16	36	0	0	36	0	0
15	38297372	.	A	G	16	17	33	0	1	34	0	0
15	38859746	.	C	T	3	6	9	0	0	9	0	0
15	38859753	.	A	C	3	5	8	0	1	9	0	0
15	38892060	.	T	C	12	5	17	0	0	17	0	0
15	39102316	.	C	G	13	17	30	0	1	31	0	0
15	39123012	.	T	C	7	8	15	0	1	16	0	0
15	39140568	.	G	A	2	12	14	0	14	28	0	0
15	39141498	.	A	G	9	11	20	0	2	22	0	0
15	39190103	.	T	G	9	0	9	0	20	29	0	0
15	39207024	.	T	A	15	26	41	0	4	45	0	0
15	39208087	.	G	A	3	18	21	0	12	33	0	0
15	39210450	.	G	A	3	13	16	0	18	34	0	0
15	39223884	.	A	T	17	18	35	0	3	38	0	0
15	39223980	.	T	G	21	21	42	0	1	43	0	0
15	39226661	.	A	T	20	18	38	0	0	38	0	0
15	39228113	.	A	T	23	21	44	0	1	45	0	0
15	39228120	.	A	C	24	19	43	0	4	47	0	0
15	39228174	.	A	G	26	14	40	0	0	40	0	0
15	39281843	.	T	G	7	10	17	0	0	17	0	0
15	39281875	.	A	C	8	11	19	0	1	20	0	0
15	39282007	.	G	C	10	0	10	0	13	23	0	0
15	39282070	.	A	G	14	9	23	0	1	24	0	0
15	39296706	.	A	G	13	13	26	0	0	26	0	0
15	39296751	.	C	T	2	10	12	0	13	25	0	0
15	39296790	.	C	T	1	5	6	0	10	16	0	0
15	39296841	.	A	G	1	5	6	0	0	6	0	0
15	39296982	.	T	C	10	14	24	0	1	25	0	0
15	39296997	.	T	C	13	8	21	0	1	22	0	0
15	39297051	.	G	A	13	13	26	0	1	27	0	0
15	39305598	.	G	A	7	10	17	0	0	17	0	0
15	39312461	.	G	A	9	4	13	0	0	13	0	0
15	39326908	.	A	T	6	6	12	0	0	12	0	0
15	39326914	.	T	C	7	0	7	0	5	12	0	0
15	39345641	.	G	A	9	9	18	0	1	19	0	0
15	39354759	.	A	T	3	4	7	0	0	7	0	0
15	39368952	.	A	C	2	3	5	0	0	5	0	0
15	39387308	.	T	G	1	6	7	0	1	8	0	0
15	39387311	.	A	G	2	3	5	0	1	6	0	0
15	39558928	.	A	C	9	4	13	0	0	13	0	0
15	39558991	.	T	A	9	7	16	0	0	16	0	0
15	39559006	.	G	A	6	5	11	0	0	11	0	0
15	39559045	.	A	G	3	5	8	0	1	9	0	0
15	39977506	.	C	T	8	3	11	0	0	11	0	0
15	39994313	.	T	C	11	16	27	0	3	30	0	0
15	40002242	.	C	T	11	10	21	0	1	22	0	0
15	40002319	.	C	T	15	18	33	0	1	34	0	0
15	40002325	.	C	T	17	16	33	0	3	36	0	0
15	40002561	.	T	A	9	14	23	0	0	23	0	0
15	40004742	.	C	G	5	9	14	0	2	16	0	0
15	40004820	.	G	A	2	3	5	0	0	5	0	0
15	40005318	.	T	A	3	6	9	0	0	9	0	0
15	40005342	.	A	T	3	8	11	0	0	11	0	0
15	40005527	.	T	A	24	6	30	0	0	30	0	0
15	40006090	.	A	C	4	7	11	0	2	13	0	0
15	40006136	.	T	C	9	7	16	0	0	16	0	0
15	40008449	.	C	T	40	12	52	0	3	55	0	0
15	40008454	.	C	A	40	10	50	0	4	54	0	0
15	40008537	.	G	T	1	31	32	0	29	61	0	0
15	40008544	.	C	A	26	33	59	0	1	60	0	0
15	40017144	.	A	G	36	31	67	0	1	68	0	0
15	40018500	.	T	C	25	41	66	2	3	71	0	0
15	40027138	.	C	T	29	41	70	0	5	75	0	0
15	40027194	.	A	T	31	40	71	0	4	75	0	0
15	40027279	.	T	C	50	29	79	0	2	81	0	0
15	40027484	.	T	G	29	2	31	0	33	64	0	0
15	40027540	.	A	C	24	38	62	0	1	63	0	0
15	40028457	.	T	G	39	26	65	1	2	68	0	0
15	40028568	.	G	A	36	27	63	0	2	65	0	0
15	40028574	.	A	G	33	31	64	0	4	68	0	0
15	40130431	.	A	G	4	3	7	0	0	7	0	0
15	40130631	.	A	G	14	4	18	0	2	20	0	0
15	40162827	.	C	T	0	6	6	0	6	12	0	0
15	40217611	.	T	C	2	5	7	0	0	7	0	0
15	40217615	.	T	C	3	3	6	0	0	6	0	0
15	40218798	.	T	C	2	2	4	0	0	4	0	0
15	41170484	.	T	C	16	7	23	0	2	25	0	0
15	41210670	.	T	G	9	4	13	0	1	14	0	0
15	41210721	.	G	A	8	8	16	0	0	16	0	0
15	41210739	.	A	G	8	6	14	0	0	14	0	0
15	41211365	.	C	T	2	9	11	0	0	11	0	0
15	41224507	.	C	T	7	7	14	0	0	14	0	0
15	41227123	.	C	T	4	9	13	0	0	13	0	0
15	41234895	.	G	A	7	8	15	0	0	15	0	0
15	41238388	.	G	C	2	5	7	0	0	7	0	0
15	41238764	.	T	A	3	2	5	0	0	5	0	0
15	41249853	.	A	T	1	3	4	0	0	4	0	0
15	41253052	.	G	A	1	2	3	0	0	3	0	0
15	41259318	.	G	A	1	2	3	0	0	3	0	0
15	41280789	.	G	A	0	2	2	0	1	3	0	0
15	41280806	.	G	A	0	2	2	0	1	3	0	0
15	41291418	.	T	C	1	3	4	0	0	4	0	0
15	41291419	.	T	C	1	3	4	0	0	4	0	0
15	41291776	.	T	C	1	6	7	0	0	7	0	0
15	41291779	.	T	C	4	4	8	0	0	8	0	0
15	41291832	.	T	C	2	2	4	0	2	6	0	0
15	41292003	.	G	A	9	4	13	0	2	15	0	0
15	41292134	.	G	A	5	2	7	0	0	7	0	0
15	41294625	.	T	C	9	4	13	0	2	15	0	0
15	41296953	.	A	G	8	4	12	0	1	13	0	0
15	41298822	.	C	T	1	2	3	0	1	4	0	0
15	41298937	.	T	A	2	2	4	0	0	4	0	0
15	41299073	.	G	A	4	5	9	0	0	9	0	0
15	41299096	.	T	C	4	4	8	0	0	8	0	0
15	41299108	.	C	T	4	4	8	0	0	8	0	0
15	41302523	.	A	G	5	2	7	0	1	8	0	0
15	41303339	.	T	C	4	2	6	0	0	6	0	0
15	41303747	.	G	A	4	5	9	0	0	9	0	0
15	41303773	.	A	C	3	3	6	0	0	6	0	0
15	41303839	.	A	G	6	5	11	0	0	11	0	0
15	41303846	.	G	A	6	5	11	0	0	11	0	0
15	41303886	.	A	T	8	3	11	0	0	11	0	0
15	41305888	.	C	A	0	3	3	0	4	7	0	0
15	41310284	.	T	C	3	3	6	0	0	6	0	0
15	41310303	.	T	C	2	6	8	0	0	8	0	0
15	41310330	.	A	T	2	4	6	0	0	6	0	0
15	41310338	.	T	C	2	3	5	0	1	6	0	0
15	41311253	.	A	T	7	3	10	0	1	11	0	0
15	41311271	.	G	A	8	2	10	0	0	10	0	0
15	41555709	.	C	T	1	2	3	0	0	3	0	0
15	41555711	.	C	T	1	2	3	0	0	3	0	0
15	41582541	.	T	C	2	2	4	0	0	4	0	0
15	41617230	.	G	A	0	2	2	0	3	5	0	0
15	41620305	.	C	T	1	3	4	0	0	4	0	0
15	41657648	.	G	A	0	2	2	0	3	5	0	0
15	41664144	.	T	A	2	4	6	0	0	6	0	0
15	41664145	.	A	C	2	3	5	0	1	6	0	0
15	41676929	.	G	A	8	6	14	0	1	15	0	0
15	41676968	.	A	T	6	4	10	0	0	10	0	0
15	41677058	.	C	T	4	3	7	0	0	7	0	0
15	41677130	.	G	A	8	2	10	0	1	11	0	0
15	41677699	.	G	C	2	3	5	0	0	5	0	0
15	41683071	.	G	A	2	2	4	0	0	4	0	0
15	41689823	.	T	A	1	2	3	0	0	3	0	0
15	41694132	.	C	T	9	5	14	0	1	15	0	0
15	41694183	.	A	G	5	2	7	0	0	7	0	0
15	41694230	.	A	C	4	3	7	0	0	7	0	0
15	41694316	.	T	A	1	2	3	0	0	3	0	0
15	41694398	.	T	A	1	3	4	0	1	5	0	0
15	41694617	.	A	T	7	5	12	0	0	12	0	0
15	41694894	.	T	A	3	4	7	0	1	8	0	0
15	41695120	.	T	C	4	2	6	0	0	6	0	0
15	41695179	.	T	A	2	4	6	0	1	7	0	0
15	41695270	.	A	T	4	5	9	0	0	9	0	0
15	41695274	.	C	T	4	5	9	0	0	9	0	0
15	41695429	.	G	A	9	7	16	0	1	17	0	0
15	41695481	.	A	T	3	6	9	0	0	9	0	0
15	41695549	.	G	A	5	2	7	0	0	7	0	0
15	41695554	.	C	T	5	3	8	0	0	8	0	0
15	41695590	.	G	T	8	4	12	0	0	12	0	0
15	41695682	.	A	G	1	3	4	0	0	4	0	0
15	41695683	.	C	T	1	3	4	0	0	4	0	0
15	41695725	.	T	C	3	4	7	0	0	7	0	0
15	41695901	.	A	T	7	3	10	0	1	11	0	0
15	41696500	.	G	A	6	2	8	0	0	8	0	0
15	41696804	.	C	A	0	2	2	0	2	4	0	0
15	41696925	.	C	T	3	2	5	0	0	5	0	0
15	41696926	.	A	G	3	2	5	0	0	5	0	0
15	41697124	.	A	C	3	2	5	0	0	5	0	0
15	41697130	.	T	A	2	2	4	0	1	5	0	0
15	41697161	.	C	T	0	3	3	0	3	6	0	0
15	41697691	.	C	T	3	3	6	0	1	7	0	0
15	41697869	.	C	T	0	2	2	0	3	5	0	0
15	41698108	.	C	T	0	3	3	0	6	9	0	0
15	41698703	.	G	C	4	0	4	0	7	11	0	0
15	41698850	.	T	C	7	4	11	0	2	13	0	0
15	41700377	.	T	C	2	0	2	0	3	5	0	0
15	41700394	.	A	T	2	2	4	0	0	4	0	0
15	41768169	.	G	A	3	3	6	0	0	6	0	0
15	41769077	.	T	C	2	2	4	0	0	4	0	0
15	41769338	.	A	C	2	2	4	0	0	4	0	0
15	41769669	.	T	C	2	3	5	1	0	6	0	0
15	41807100	.	A	G	2	3	5	0	1	6	0	0
15	41807165	.	T	A	2	3	5	0	0	5	0	0
15	41843134	.	T	A	3	3	6	0	0	6	0	0
15	41843144	.	C	T	3	3	6	0	1	7	0	0
15	41845038	.	G	C	7	7	14	0	0	14	0	0
15	41845059	.	A	C	6	7	13	0	0	13	0	0
15	41845121	.	G	A	10	8	18	0	0	18	0	0
15	41845253	.	A	T	7	8	15	0	0	15	0	0
15	41948270	.	T	A	1	2	3	0	2	5	0	0
15	41948276	.	A	C	1	2	3	0	0	3	0	0
15	41948842	.	G	A	3	4	7	0	1	8	0	0
15	41948886	.	T	C	7	2	9	0	0	9	0	0
15	41948904	.	A	G	5	2	7	0	0	7	0	0
15	41949220	.	G	A	2	4	6	0	0	6	0	0
15	41949224	.	T	C	3	3	6	0	2	8	0	0
15	41949258	.	T	G	6	4	10	1	0	11	0	0
15	41949294	.	G	C	5	7	12	1	0	13	0	0
15	41949334	.	A	C	4	8	12	0	0	12	0	0
15	41949500	.	C	T	6	4	10	0	0	10	0	0
15	41949697	.	G	A	2	2	4	0	1	5	0	0
15	41949769	.	G	T	4	6	10	0	0	10	0	0
15	41949786	.	T	C	5	5	10	0	0	10	0	0
15	41949827	.	A	G	6	3	9	0	0	9	0	0
15	41950548	.	G	A	1	4	5	0	0	5	0	0
15	41950802	.	G	A	4	2	6	0	0	6	0	0
15	41951048	.	T	G	4	3	7	0	0	7	0	0
15	41951091	.	A	G	6	6	12	0	0	12	0	0
15	41954412	.	G	A	2	2	4	0	0	4	0	0
15	41960443	.	A	G	6	3	9	0	0	9	0	0
15	41972616	.	G	A	1	2	3	0	0	3	0	0
15	41972628	.	A	G	2	2	4	0	0	4	0	0
15	41972676	.	G	T	3	2	5	0	0	5	0	0
15	41973165	.	C	T	3	3	6	0	1	7	0	0
15	42027444	.	G	A	1	2	3	0	0	3	0	0
15	42265070	.	G	C	15	10	25	0	1	26	0	0
15	42265197	.	G	A	23	22	45	0	1	46	0	0
15	42267390	.	C	T	1	16	17	0	16	33	0	0
15	42272452	.	C	A	13	22	35	0	2	37	0	0
15	42278997	.	G	A	13	12	25	0	0	25	0	0
15	42279535	.	A	G	11	19	30	0	0	30	0	0
15	42280719	.	T	C	11	17	28	0	0	28	0	0
15	42296654	.	A	G	16	0	16	0	15	31	0	0
15	42296717	.	T	G	10	1	11	0	15	26	0	0
15	42296753	.	C	T	6	11	17	0	0	17	0	0
15	42297751	.	T	C	16	16	32	0	2	34	0	0
15	42302915	.	A	G	8	12	20	0	1	21	0	0
15	42302990	.	A	G	11	13	24	0	1	25	0	0
15	42303020	.	A	T	12	11	23	0	0	23	0	0
15	42304851	.	C	T	8	7	15	0	0	15	0	0
15	42317072	.	T	A	7	11	18	0	0	18	0	0
15	42317277	.	C	G	2	4	6	0	0	6	0	0
15	42344847	.	C	T	4	4	8	0	0	8	0	0
15	42344874	.	C	G	6	4	10	0	0	10	0	0
15	42346196	.	T	C	12	6	18	0	1	19	0	0
15	42346260	.	T	A	11	8	19	0	0	19	0	0
15	42346584	.	C	T	5	5	10	0	1	11	0	0
15	42346593	.	T	C	3	8	11	0	0	11	0	0
15	42346627	.	G	T	2	7	9	0	0	9	0	0
15	42346841	.	T	C	8	6	14	0	0	14	0	0
15	42346955	.	G	A	1	3	4	0	9	13	0	0
15	42347053	.	T	C	5	2	7	0	0	7	0	0
15	42758927	.	T	C	4	0	4	0	8	12	0	0
15	42758946	.	T	C	7	4	11	0	0	11	0	0
15	42920246	.	T	G	7	3	10	0	0	10	0	0
15	42933283	.	C	T	3	4	7	0	2	9	0	0
15	42933343	.	G	A	0	6	6	0	4	10	0	0
15	42947514	.	C	T	5	4	9	0	0	9	0	0
15	42947664	.	C	G	6	3	9	0	0	9	0	0
15	42947700	.	C	A	6	4	10	0	0	10	0	0
15	42953018	.	T	C	10	4	14	0	0	14	0	0
15	42953036	.	T	C	10	3	13	0	0	13	0	0
15	42958539	.	C	T	8	4	12	0	1	13	0	0
15	42958548	.	T	C	5	3	8	0	0	8	0	0
15	42958677	.	C	T	10	5	15	0	0	15	0	0
15	43216326	.	G	T	13	5	18	0	0	18	0	0
15	43216350	.	A	G	9	3	12	0	2	14	0	0
15	43237625	.	G	T	12	15	27	0	1	28	0	0
15	43241989	.	A	C	2	2	4	0	0	4	0	0
15	43242006	.	G	A	4	2	6	0	0	6	0	0
15	43245362	.	A	G	15	26	41	0	2	43	0	0
15	43245371	.	T	A	19	26	45	0	0	45	0	0
15	43257039	.	T	C	17	19	36	0	1	37	0	0
15	43260531	.	G	A	14	12	26	0	0	26	0	0
15	43260609	.	A	G	12	16	28	0	0	28	0	0
15	43268484	.	T	A	12	12	24	0	0	24	0	0
15	43287431	.	G	A	2	7	9	0	0	9	0	0
15	43312689	.	T	C	3	4	7	0	0	7	0	0
15	43398335	.	A	C	5	5	10	0	1	11	0	0
15	43457873	.	T	A	6	6	12	0	0	12	0	0
15	43480486	.	T	A	7	6	13	0	0	13	0	0
15	43480543	.	T	C	6	5	11	0	0	11	0	0
15	43487794	.	C	T	6	10	16	0	0	16	0	0
15	43488094	.	C	T	13	11	24	0	0	24	0	0
15	43489679	.	T	C	13	10	23	0	1	24	0	0
15	43509743	.	A	G	12	1	13	0	9	22	0	0
15	43509816	.	T	C	21	9	30	0	0	30	0	0
15	43509864	.	T	C	13	4	17	0	1	18	0	0
15	43510116	.	A	C	3	6	9	1	0	10	0	0
15	43510448	.	A	T	5	10	15	0	2	17	0	0
15	43510452	.	T	G	6	9	15	0	1	16	0	0
15	43604190	.	G	A	1	1	2	0	0	2	0	0
15	43604224	.	G	A	2	3	5	0	1	6	0	0
15	43604903	.	C	G	8	4	12	0	1	13	0	0
15	43604928	.	A	G	8	3	11	0	0	11	0	0
15	43604988	.	G	C	3	3	6	0	0	6	0	0
15	43605309	.	G	T	0	2	2	0	2	4	0	0
15	43605337	.	G	A	3	3	6	0	0	6	0	0
15	43605483	.	C	T	0	6	6	0	4	10	0	0
15	43605503	.	G	C	3	7	10	0	1	11	0	0
15	43605538	.	C	T	1	6	7	0	6	13	0	0
15	43605544	.	G	A	5	8	13	0	0	13	0	0
15	43620173	.	C	T	2	3	5	0	0	5	0	0
15	43651693	.	G	A	4	5	9	0	0	9	0	0
15	43656259	.	T	C	3	2	5	0	0	5	0	0
15	43656274	.	C	G	4	3	7	0	0	7	0	0
15	43656334	.	T	C	2	0	2	0	2	4	0	0
15	43656352	.	G	A	3	2	5	0	0	5	0	0
15	43656519	.	G	T	3	4	7	0	0	7	0	0
15	43656619	.	C	T	6	5	11	0	0	11	0	0
15	43656832	.	T	C	4	0	4	0	4	8	0	0
15	43657018	.	T	A	5	2	7	0	1	8	0	0
15	43662920	.	C	T	5	4	9	0	1	10	0	0
15	43662995	.	G	A	1	2	3	0	0	3	0	0
15	43663499	.	G	C	4	2	6	0	0	6	0	0
15	43663649	.	C	T	2	3	5	0	0	5	0	0
15	43917471	.	C	T	1	4	5	0	0	5	0	0
15	43931714	.	C	T	1	7	8	0	0	8	0	0
15	43938527	.	C	T	1	6	7	0	1	8	0	0
15	43969899	.	A	G	1	2	3	1	0	4	0	0
15	43977952	.	C	T	4	1	5	0	0	6	1	0
15	43982517	.	T	C	4	2	6	0	0	6	0	0
15	43982862	.	A	G	5	3	8	0	0	8	0	0
15	43982925	.	T	C	3	3	6	0	1	7	0	0
15	43984470	.	T	C	6	3	9	0	0	9	0	0
15	43984513	.	G	A	5	5	10	0	0	10	0	0
15	43988716	.	C	T	2	2	4	0	0	4	0	0
15	43988767	.	G	T	3	3	6	0	0	6	0	0
15	44030299	.	C	T	1	2	3	0	0	3	0	0
15	44062437	.	C	T	2	2	4	0	0	4	0	0
15	44072776	.	T	C	4	0	4	1	8	13	0	0
15	44074653	.	A	G	14	11	25	0	1	26	0	0
15	44075125	.	C	T	1	11	12	0	10	22	0	0
15	44077766	.	A	T	15	12	27	0	3	30	0	0
15	44098604	.	T	A	2	2	4	7	0	11	0	0
15	44140324	.	T	G	4	0	4	0	4	8	0	0
15	44140360	.	G	A	4	5	9	0	1	10	0	0
15	44140583	.	C	T	4	3	7	0	0	7	0	0
15	44140716	.	C	T	3	5	8	0	0	8	0	0
15	44140780	.	A	G	6	3	9	0	0	9	0	0
15	44140991	.	T	C	1	3	4	0	0	4	0	0
15	44141560	.	C	T	2	2	4	0	0	4	0	0
15	44209147	.	T	G	2	2	4	3	0	7	0	0
15	44255212	.	A	C	7	5	12	0	0	12	0	0
15	44255467	.	C	T	4	3	7	0	0	7	0	0
15	44255473	.	T	C	4	3	7	0	0	7	0	0
15	44255503	.	A	T	3	4	7	0	0	7	0	0
15	44283812	.	A	G	2	2	4	0	0	4	0	0
15	44290546	.	C	T	2	2	4	0	0	4	0	0
15	44295044	.	G	A	3	2	5	0	0	5	0	0
15	44295262	.	A	G	3	0	3	0	8	11	0	0
15	44323436	.	G	A	2	6	8	0	3	11	0	0
15	44323442	.	G	A	7	5	12	0	0	12	0	0
15	44336923	.	A	T	2	3	5	0	2	7	0	0
15	44340093	.	C	T	3	3	6	0	0	6	0	0
15	44344283	.	G	A	0	4	4	0	5	9	0	0
15	44345243	.	T	A	3	5	8	0	0	8	0	0
15	44370890	.	C	A	8	10	18	0	1	19	0	0
15	44371076	.	C	T	13	18	31	0	2	33	0	0
15	44371289	.	C	T	7	13	20	0	0	20	0	0
15	44371484	.	T	C	6	12	18	0	0	18	0	0
15	44371550	.	G	A	9	7	16	0	1	17	0	0
15	44384767	.	T	C	9	12	21	0	0	21	0	0
15	44385021	.	G	A	17	8	25	0	1	26	0	0
15	44385117	.	T	C	16	3	19	0	1	20	0	0
15	44385126	.	C	T	16	3	19	0	0	19	0	0
15	44399204	.	C	T	20	7	27	0	0	27	0	0
15	44445243	.	C	T	5	5	10	0	1	11	0	0
15	44447906	.	C	T	6	5	11	0	0	11	0	0
15	44462839	.	C	T	3	3	6	0	0	6	0	0
15	44465352	.	G	A	3	4	7	0	1	8	0	0
15	44472844	.	G	A	1	2	3	0	2	5	0	0
15	44474741	.	G	A	1	3	4	0	0	4	0	0
15	44474826	.	A	G	1	1	2	0	1	3	0	0
15	44474849	.	C	T	1	2	3	0	1	4	0	0
15	44475197	.	G	A	0	2	2	0	5	7	0	0
15	44475356	.	G	A	2	3	5	0	0	5	0	0
15	44475398	.	C	T	4	3	7	0	3	10	0	0
15	44475995	.	G	A	2	2	4	0	0	4	0	0
15	44476035	.	C	G	2	2	4	0	1	5	0	0
15	44499445	.	A	G	16	15	31	0	1	32	0	0
15	44499653	.	T	A	19	20	39	0	1	40	0	0
15	44499730	.	C	T	18	15	33	0	0	33	0	0
15	44534976	.	G	A	13	13	26	0	1	27	0	0
15	44733135	.	G	A	15	12	27	0	0	27	0	0
15	44733157	.	A	G	16	7	23	0	0	23	0	0
15	44755727	.	G	A	7	6	13	0	0	13	0	0
15	45027401	.	G	A	4	4	8	0	1	9	0	0
15	45034764	.	C	T	0	3	3	0	6	9	0	0
15	45044554	.	G	A	2	4	6	0	0	6	0	0
15	45048200	.	G	A	3	5	8	0	0	8	0	0
15	45056409	.	G	T	1	2	3	0	0	4	1	0
15	45056530	.	G	A	8	6	14	0	0	14	0	0
15	46662011	.	G	T	23	8	31	2	5	38	0	0
15	46687973	.	A	T	8	9	17	0	0	17	0	0
15	46691114	.	G	T	7	10	17	0	0	17	0	0
15	46691249	.	G	A	4	3	7	0	0	7	0	0
15	46699268	.	G	A	6	6	12	0	0	12	0	0
15	46699487	.	A	G	8	4	12	0	0	12	0	0
15	46704595	.	T	C	5	6	11	0	1	12	0	0
15	46704623	.	G	A	7	5	12	0	0	12	0	0
15	46718528	.	T	G	1	5	6	0	0	6	0	0
15	46727382	.	G	A	3	3	6	0	1	7	0	0
15	46727571	.	G	A	4	3	7	0	0	7	0	0
15	46736165	.	A	C	1	0	1	0	2	3	0	0
15	47029331	.	G	A	2	4	6	0	1	7	0	0
15	47031476	.	T	C	4	4	8	0	0	8	0	0
15	47031503	.	T	A	7	3	10	0	0	10	0	0
15	47044434	.	G	T	1	4	5	0	3	8	0	0
15	47063638	.	C	T	2	5	7	0	0	7	0	0
15	47100599	.	C	T	1	7	8	0	13	21	0	0
15	47107256	.	A	G	9	11	20	0	0	20	0	0
15	47111163	.	T	C	8	6	14	0	1	15	0	0
15	47115252	.	G	A	13	9	22	0	1	23	0	0
15	47336295	.	G	A	9	12	21	0	0	21	0	0
15	47338768	.	C	A	3	2	5	0	0	5	0	0
15	47386982	.	T	A	21	19	40	2	2	44	0	0
15	47410231	.	C	A	17	13	30	0	0	30	0	0
15	47418607	.	G	A	1	12	13	0	15	28	0	0
15	47418627	.	G	A	18	16	34	0	0	34	0	0
15	47419090	.	G	A	3	17	20	0	22	42	0	0
15	47419096	.	C	T	21	22	43	0	2	45	0	0
15	47419240	.	C	T	21	23	44	0	0	44	0	0
15	47419394	.	C	T	25	17	42	0	0	42	0	0
15	47419395	.	A	T	23	17	40	0	2	42	0	0
15	47420838	.	T	A	33	14	47	0	1	48	0	0
15	47421203	.	T	C	11	4	15	0	1	16	0	0
15	47421329	.	A	G	11	12	23	0	1	24	0	0
15	47421669	.	C	T	15	15	30	0	1	31	0	0
15	47421675	.	G	C	16	14	30	0	0	30	0	0
15	47447266	.	T	C	1	1	2	0	0	2	0	0
15	47447280	.	C	T	0	2	2	0	1	3	0	0
15	47452895	.	C	A	1	6	7	0	0	7	0	0
15	47453288	.	C	G	1	4	5	0	0	5	0	0
15	47453734	.	T	G	4	4	8	0	0	8	0	0
15	47453857	.	C	T	1	2	3	0	0	3	0	0
15	47454144	.	G	C	1	3	4	0	0	4	0	0
15	47454161	.	G	T	1	3	4	0	0	4	0	0
15	47455030	.	A	G	2	3	5	0	0	5	0	0
15	47830783	.	C	T	3	2	5	0	0	5	0	0
15	47830973	.	C	A	6	5	11	0	0	11	0	0
15	47831096	.	C	T	8	6	14	0	1	15	0	0
15	47831195	.	G	C	10	8	18	0	0	18	0	0
15	47831249	.	C	T	4	7	11	0	0	11	0	0
15	47831265	.	T	A	3	4	7	0	0	7	0	0
15	47831495	.	C	G	14	10	24	1	0	25	0	0
15	47831511	.	C	T	0	9	9	0	14	23	0	0
15	47831565	.	C	A	13	10	23	0	0	23	0	0
15	47831731	.	T	G	4	10	14	0	0	14	0	0
15	47831765	.	G	A	1	5	6	0	0	6	0	0
15	47831983	.	G	A	1	4	5	0	0	5	0	0
15	47831992	.	A	T	1	4	5	0	1	6	0	0
15	47832424	.	T	G	3	4	7	0	0	7	0	0
15	47832930	.	C	T	10	7	17	0	0	17	0	0
15	47832931	.	C	T	1	7	8	0	10	18	0	0
15	47833083	.	G	A	6	12	18	0	0	18	0	0
15	47833392	.	G	A	9	13	22	0	0	22	0	0
15	47833395	.	C	T	1	12	13	0	8	21	0	0
15	47833436	.	C	T	1	8	9	0	12	21	0	0
15	47833493	.	C	T	1	3	4	0	10	14	0	0
15	47833662	.	C	T	12	5	17	0	1	18	0	0
15	47833814	.	C	T	6	2	8	0	0	8	0	0
15	47833875	.	A	G	3	7	10	0	0	10	0	0
15	47834327	.	C	G	7	11	18	0	0	18	0	0
15	47834487	.	C	T	0	6	6	0	4	10	0	0
15	47834559	.	G	A	4	9	13	0	0	13	0	0
15	47839080	.	G	A	6	3	9	0	0	10	1	0
15	47845908	.	A	G	14	18	32	0	0	32	0	0
15	47847180	.	T	C	13	0	13	0	19	32	0	0
15	47847373	.	G	A	16	17	33	0	1	34	0	0
15	47848495	.	C	T	24	15	39	0	4	43	0	0
15	47851205	.	T	A	25	31	56	0	0	56	0	0
15	47851455	.	T	G	29	34	63	0	2	65	0	0
15	47851486	.	G	A	29	31	60	0	0	60	0	0
15	47851522	.	C	T	2	27	29	0	29	58	0	0
15	47851751	.	A	G	33	19	52	0	2	54	0	0
15	47851828	.	G	A	28	20	48	0	1	49	0	0
15	47851978	.	C	T	12	6	18	0	1	19	0	0
15	47851979	.	A	G	11	7	18	0	1	19	0	0
15	47852049	.	G	T	20	10	30	0	0	30	0	0
15	47855085	.	A	G	32	19	51	2	1	54	0	0
15	47856418	.	T	C	52	24	76	4	6	86	0	0
15	47860443	.	C	T	0	18	18	0	12	30	0	0
16	815859	.	C	T	6	6	12	0	2	14	0	0
16	815967	.	G	A	12	15	27	0	0	27	0	0
16	816096	.	A	G	10	12	22	0	1	23	0	0
16	817431	.	T	C	13	9	22	1	1	24	0	0
16	1199273	.	C	T	1	5	6	0	1	7	0	0
16	1199324	.	C	T	3	9	12	0	2	14	0	0
16	1199357	.	T	C	8	9	17	0	0	17	0	0
16	1199740	.	A	G	3	8	11	0	1	12	0	0
16	1199741	.	C	T	3	9	12	0	0	12	0	0
16	1204061	.	G	A	2	2	4	0	5	9	0	0
16	1205135	.	G	A	8	5	13	0	0	13	0	0
16	1207124	.	C	T	9	10	19	0	0	19	0	0
16	1207149	.	T	A	6	7	13	0	0	13	0	0
16	1207227	.	G	A	8	14	22	0	0	22	0	0
16	1207948	.	C	G	9	6	15	0	0	15	0	0
16	1209528	.	C	T	8	8	16	0	0	16	0	0
16	1209587	.	G	A	0	6	6	0	0	6	0	0
16	1209597	.	A	C	1	3	4	0	0	4	0	0
16	1209985	.	T	G	8	4	12	0	0	12	0	0
16	1210280	.	G	A	8	9	17	0	2	19	0	0
16	1210403	.	C	T	11	15	26	0	0	26	0	0
16	1210880	.	A	C	2	1	3	0	12	15	0	0
16	1229718	.	C	T	11	9	20	1	0	21	0	0
16	1230470	.	C	T	9	5	14	0	0	14	0	0
16	1234138	.	A	T	9	11	20	0	0	20	0	0
16	1239500	.	T	C	14	13	27	0	0	27	0	0
16	1269517	.	G	C	1	1	2	0	1	3	0	0
16	1269800	.	T	C	2	2	4	0	0	4	0	0
16	1334452	.	C	T	14	11	25	0	0	25	0	0
16	1354513	.	A	G	8	11	19	0	0	19	0	0
16	1355316	.	A	T	18	9	27	0	1	28	0	0
16	1355720	.	T	C	19	16	35	0	0	35	0	0
16	1359119	.	T	C	21	9	30	0	1	31	0	0
16	1362410	.	C	A	1	2	3	0	0	3	0	0
16	1397025	.	A	G	1	2	3	0	0	3	0	0
16	1397801	.	G	A	1	3	4	0	0	4	0	0
16	1397817	.	T	C	3	4	7	0	0	7	0	0
16	1398295	.	C	G	1	3	4	0	0	4	0	0
16	1398319	.	A	T	2	4	6	0	0	6	0	0
16	1398447	.	G	A	5	3	8	0	0	8	0	0
16	1467075	.	G	A	1	2	3	0	0	3	0	0
16	1469503	.	T	C	1	0	1	0	2	3	0	0
16	1476606	.	T	C	2	2	4	0	0	4	0	0
16	1523892	.	A	G	7	5	12	0	0	12	0	0
16	1523911	.	G	C	8	0	8	0	10	18	0	0
16	1549920	.	A	G	3	5	8	0	0	8	0	0
16	1551146	.	T	G	8	12	20	0	1	21	0	0
16	1569758	.	A	G	6	6	12	0	0	12	0	0
16	1572508	.	C	T	9	8	17	0	1	18	0	0
16	1573203	.	G	A	3	8	11	0	0	11	0	0
16	1573215	.	C	T	4	7	11	0	1	12	0	0
16	1573259	.	T	G	6	2	8	1	0	9	0	0
16	1577676	.	G	A	9	5	14	0	0	14	0	0
16	1602584	.	G	C	2	2	4	0	0	4	0	0
16	1618707	.	C	T	0	3	3	0	2	5	0	0
16	1618722	.	G	A	3	3	6	0	0	6	0	0
16	1884215	.	C	T	8	8	16	0	1	17	0	0
16	1884218	.	C	T	8	9	17	0	0	17	0	0
16	1906682	.	C	A	11	9	20	0	0	20	0	0
16	1996533	.	A	G	3	10	13	0	0	13	0	0
16	1996569	.	A	C	2	13	15	0	0	15	0	0
16	1996577	.	C	T	2	10	12	0	1	13	0	0
16	2009844	.	T	G	9	10	19	0	2	21	0	0
16	2009949	.	A	G	17	8	25	0	0	25	0	0
16	2043021	.	C	T	12	7	19	0	0	19	0	0
16	2043122	.	G	C	1	7	8	0	9	17	0	0
16	2071535	.	G	A	1	8	9	0	9	18	0	0
16	2102037	.	T	C	9	8	17	0	0	17	0	0
16	2102101	.	A	G	5	3	8	0	0	8	0	0
16	2102189	.	A	T	1	2	3	0	0	3	0	0
16	2102349	.	C	T	3	2	5	0	1	6	0	0
16	2102468	.	A	T	8	4	12	0	0	12	0	0
16	2102683	.	C	T	0	2	2	0	1	3	0	0
16	2102743	.	A	T	3	2	5	0	3	8	0	0
16	2103052	.	C	T	19	8	27	0	1	28	0	0
16	2103058	.	G	T	18	7	25	0	0	25	0	0
16	2103088	.	G	A	2	7	9	0	14	23	0	0
16	2103167	.	C	T	7	4	11	0	0	11	0	0
16	2103209	.	C	T	10	4	14	0	0	14	0	0
16	2103241	.	T	A	10	5	15	0	1	16	0	0
16	2103268	.	A	T	11	8	19	0	0	19	0	0
16	2103307	.	T	C	12	9	21	0	0	21	0	0
16	2103714	.	A	T	4	4	8	0	0	8	0	0
16	2103783	.	A	T	1	3	4	0	1	5	0	0
16	2104130	.	A	G	5	2	7	0	0	7	0	0
16	2104181	.	T	A	3	3	6	0	0	6	0	0
16	2104312	.	A	C	6	9	15	0	0	15	0	0
16	2104400	.	T	C	14	8	22	0	0	22	0	0
16	2104597	.	T	C	24	18	42	0	2	44	0	0
16	2104604	.	A	G	24	2	26	0	19	45	0	0
16	2353020	.	C	A	3	2	5	0	0	5	0	0
16	2353023	.	T	C	4	2	6	0	0	6	0	0
16	2353191	.	C	A	3	6	9	0	0	9	0	0
16	2360324	.	C	T	3	2	5	0	0	5	0	0
16	2365716	.	G	A	7	3	10	0	1	11	0	0
16	2368422	.	T	C	3	0	3	0	4	7	0	0
16	2373689	.	T	C	3	4	7	0	3	10	0	0
16	2380735	.	G	A	7	3	10	0	0	10	0	0
16	2382011	.	G	T	3	2	5	0	0	5	0	0
16	2388306	.	T	A	6	5	11	0	0	11	0	0
16	2388309	.	A	T	5	5	10	0	0	10	0	0
16	2472263	.	G	A	13	10	23	0	0	23	0	0
16	2472284	.	T	C	13	7	20	0	0	20	0	0
16	2484064	.	C	T	5	15	20	0	13	33	0	0
16	2485904	.	G	A	10	15	25	0	0	25	0	0
16	2494323	.	T	C	8	0	8	0	15	23	0	0
16	2495649	.	G	C	10	13	23	0	0	23	0	0
16	2517184	.	G	T	12	7	19	0	0	19	0	0
16	2519056	.	T	C	9	8	17	0	0	17	0	0
16	2519071	.	T	C	8	7	15	0	0	15	0	0
16	2525891	.	A	G	8	8	16	0	1	17	0	0
16	2526035	.	C	T	14	7	21	0	1	22	0	0
16	2528209	.	A	G	11	7	18	0	0	18	0	0
16	2539405	.	G	A	4	4	8	0	0	8	0	0
16	2540235	.	G	A	7	6	13	0	2	15	0	0
16	2542782	.	G	C	8	9	17	0	0	17	0	0
16	2545290	.	C	T	10	5	15	0	0	15	0	0
16	2557990	.	A	G	11	8	19	0	2	21	0	0
16	2558252	.	G	C	8	5	13	0	0	13	0	0
16	2558549	.	G	A	2	4	6	0	1	7	0	0
16	2567316	.	A	G	12	1	13	0	10	23	0	0
16	2568847	.	G	A	1	13	14	0	15	29	0	0
16	2574963	.	C	T	7	7	14	0	1	15	0	0
16	2577717	.	T	A	8	3	11	0	3	14	0	0
16	2578771	.	G	A	0	11	11	0	10	21	0	0
16	2580255	.	T	A	14	8	22	0	1	23	0	0
16	2580340	.	G	A	3	4	7	0	1	8	0	0
16	2640406	.	G	A	2	2	4	0	2	6	0	0
16	2647072	.	C	T	2	3	5	0	0	5	0	0
16	2807453	.	A	T	6	5	11	0	0	11	0	0
16	2807474	.	C	T	0	4	4	0	5	9	0	0
16	2822493	.	T	C	1	3	4	0	0	4	0	0
16	2822496	.	G	T	1	3	4	0	0	4	0	0
16	2824645	.	G	C	1	2	3	0	0	3	0	0
16	2825870	.	A	G	6	4	10	0	0	10	0	0
16	2829139	.	T	C	1	3	4	0	0	4	0	0
16	2833409	.	G	C	2	3	5	0	0	5	0	0
16	2843739	.	A	C	1	2	3	0	0	3	0	0
16	2905275	.	G	T	0	2	2	0	1	3	0	0
16	2905302	.	C	T	1	3	4	0	0	4	0	0
16	2912551	.	A	G	1	3	4	0	0	4	0	0
16	2948873	.	G	C	0	2	2	0	1	3	0	0
16	3017891	.	T	C	2	3	5	0	0	5	0	0
16	3075265	.	G	A	0	3	3	0	1	4	0	0
16	3089158	.	C	T	3	2	5	0	0	5	0	0
16	3091279	.	A	C	1	5	6	0	0	6	0	0
16	3091288	.	G	A	1	4	5	0	0	5	0	0
16	3095897	.	T	C	2	4	6	0	1	7	0	0
16	3096160	.	C	G	2	5	7	0	1	8	0	0
16	3096166	.	T	C	2	7	9	0	0	9	0	0
16	3096319	.	T	C	6	3	9	0	0	9	0	0
16	3096384	.	C	T	1	5	6	0	0	6	0	0
16	3096420	.	T	C	4	2	6	0	0	6	0	0
16	3096516	.	G	A	5	5	10	0	0	10	0	0
16	3463895	.	A	G	14	8	22	0	1	23	0	0
16	3470212	.	G	A	9	8	17	0	1	18	0	0
16	3470332	.	A	G	8	10	18	0	0	18	0	0
16	3499306	.	G	A	13	5	18	0	0	18	0	0
16	3499423	.	A	C	2	0	2	0	12	14	0	0
16	3523597	.	T	A	4	6	10	0	0	10	0	0
16	3531599	.	A	G	3	10	13	0	1	14	0	0
16	3548551	.	T	C	3	0	3	0	6	9	0	0
16	3576790	.	A	G	4	2	6	1	0	7	0	0
16	4059568	.	C	T	5	6	11	0	0	11	0	0
16	4067675	.	C	T	2	2	4	0	0	4	0	0
16	4067897	.	C	A	7	5	12	0	0	12	0	0
16	4070156	.	G	A	0	3	3	0	4	7	0	0
16	4071284	.	G	T	1	3	4	0	8	12	0	0
16	4103494	.	G	A	1	4	5	0	0	5	0	0
16	4105539	.	C	A	4	2	6	0	0	6	0	0
16	4110155	.	C	A	3	4	7	0	0	7	0	0
16	4115198	.	C	T	3	4	7	0	1	8	0	0
16	4115237	.	A	G	5	2	7	0	0	7	0	0
16	4124384	.	C	T	2	3	5	0	0	5	0	0
16	4126464	.	C	T	4	10	14	0	0	14	0	0
16	4126903	.	C	A	4	7	11	0	1	12	0	0
16	4126927	.	C	T	5	3	8	0	1	9	0	0
16	4128322	.	C	T	3	3	6	0	1	7	0	0
16	4131062	.	T	C	5	3	8	0	0	8	0	0
16	4138416	.	G	A	3	5	8	0	0	8	0	0
16	4138638	.	G	A	3	5	8	0	0	8	0	0
16	4138776	.	C	T	4	2	6	0	0	6	0	0
16	4158384	.	A	G	2	0	2	0	3	5	0	0
16	4160307	.	G	A	4	7	11	0	1	12	0	0
16	4163503	.	C	T	4	9	13	0	3	16	0	0
16	4163671	.	A	G	4	0	4	0	4	8	0	0
16	4168036	.	T	A	10	9	19	4	0	23	0	0
16	4168139	.	A	G	7	4	11	0	1	12	0	0
16	4168488	.	A	C	1	2	3	0	0	3	0	0
16	4168816	.	C	A	1	2	3	0	0	3	0	0
16	4190052	.	A	T	2	4	6	0	0	6	0	0
16	4190091	.	T	A	5	4	9	0	0	9	0	0
16	4190094	.	C	A	5	3	8	0	1	9	0	0
16	4190477	.	T	C	3	4	7	0	0	7	0	0
16	4190525	.	G	T	4	2	6	0	0	6	0	0
16	4197130	.	T	A	4	4	8	0	0	8	0	0
16	4200749	.	G	T	13	6	19	1	0	20	0	0
16	4201948	.	C	G	9	9	18	0	0	18	0	0
16	4202038	.	C	T	9	10	19	0	2	21	0	0
16	4202128	.	A	G	10	8	18	0	1	20	1	0
16	4287757	.	C	G	4	5	9	0	0	9	0	0
16	4287783	.	C	T	3	4	7	0	0	7	0	0
16	4287936	.	C	T	0	3	3	0	3	6	0	0
16	4287961	.	G	A	3	4	7	0	0	7	0	0
16	4288656	.	T	A	3	5	8	0	1	9	0	0
16	4293419	.	G	T	2	2	4	0	0	4	0	0
16	4317343	.	A	T	6	2	8	0	0	8	0	0
16	4317365	.	G	A	1	4	5	0	0	5	0	0
16	4513775	.	A	G	2	5	7	0	0	7	0	0
16	4513876	.	A	T	4	7	11	0	1	12	0	0
16	4513901	.	T	C	3	12	15	0	0	15	0	0
16	4513920	.	C	G	4	10	14	0	0	14	0	0
16	4514086	.	G	A	7	3	10	0	0	10	0	0
16	4514114	.	T	C	3	0	3	0	6	9	0	0
16	4514467	.	A	T	11	3	14	1	0	15	0	0
16	4514592	.	A	C	6	6	12	0	0	12	0	0
16	4514594	.	T	A	6	6	12	0	0	12	0	0
16	4514633	.	T	C	8	5	13	0	0	13	0	0
16	4514666	.	T	C	5	0	5	0	6	11	0	0
16	4514746	.	T	C	4	0	4	0	4	8	0	0
16	4515614	.	G	T	4	4	8	0	0	8	0	0
16	4515660	.	C	T	1	2	3	0	4	7	0	0
16	4516529	.	T	C	1	5	6	0	0	6	0	0
16	4516687	.	A	G	1	2	3	0	0	3	0	0
16	4517456	.	C	T	5	2	7	0	0	7	0	0
16	4517477	.	G	A	8	5	13	0	0	13	0	0
16	4517606	.	A	G	10	11	21	0	0	21	0	0
16	4517704	.	C	T	8	5	13	0	1	14	0	0
16	4531629	.	G	A	3	4	7	0	0	7	0	0
16	4531827	.	A	G	7	3	10	0	2	12	0	0
16	4533768	.	T	C	12	11	23	0	0	23	0	0
16	4538422	.	A	G	8	5	13	0	1	14	0	0
16	4540864	.	G	C	4	7	11	0	1	12	0	0
16	4541022	.	A	C	6	11	17	0	1	18	0	0
16	4541061	.	T	G	6	7	13	0	4	17	0	0
16	4541085	.	T	C	9	7	16	1	2	19	0	0
16	4541146	.	G	A	7	3	10	1	0	11	0	0
16	4541233	.	T	C	7	7	14	0	0	14	0	0
16	4541250	.	C	T	6	9	15	0	0	15	0	0
16	4541281	.	A	T	3	6	9	1	0	10	0	0
16	4541931	.	A	C	5	2	7	0	7	14	0	0
16	4541936	.	G	C	6	8	14	0	1	15	0	0
16	4542252	.	A	G	3	2	5	0	0	5	0	0
16	4542518	.	C	T	1	17	18	1	11	30	0	0
16	4545454	.	T	C	11	16	27	1	0	28	0	0
16	4546606	.	A	C	9	0	9	0	15	24	0	0
16	4546651	.	G	A	5	15	20	0	1	21	0	0
16	4573450	.	G	T	5	4	9	0	0	9	0	0
16	4573458	.	C	T	5	3	8	0	0	8	0	0
16	4573556	.	A	T	10	11	21	0	3	24	0	0
16	4573588	.	A	G	9	7	16	0	2	18	0	0
16	4583847	.	A	T	7	3	10	0	2	12	0	0
16	4583864	.	A	G	5	3	8	0	1	9	0	0
16	4587184	.	C	T	3	4	7	1	0	8	0	0
16	4587187	.	G	A	3	4	7	1	0	8	0	0
16	4591911	.	T	C	6	0	6	0	3	9	0	0
16	4594818	.	A	G	4	3	7	0	0	7	0	0
16	4615993	.	C	A	13	5	18	0	0	18	0	0
16	4616071	.	A	T	9	8	17	0	2	19	0	0
16	4619598	.	A	T	11	9	20	0	3	23	0	0
16	4619614	.	A	G	6	8	14	0	2	17	1	0
16	4628953	.	T	C	2	8	10	0	0	10	0	0
16	4630127	.	G	T	3	9	12	0	1	13	0	0
16	4630143	.	C	T	2	7	9	0	2	11	0	0
16	4638149	.	C	A	1	2	3	0	0	3	0	0
16	4638150	.	A	G	1	2	3	0	0	3	0	0
16	4640522	.	A	C	2	4	6	0	0	6	0	0
16	4695108	.	A	C	1	2	3	0	0	3	0	0
16	4695172	.	G	C	0	6	6	0	8	14	0	0
16	4695323	.	A	C	5	3	8	0	0	8	0	0
16	4695368	.	T	A	6	4	10	0	0	10	0	0
16	4695530	.	A	G	7	7	14	0	0	14	0	0
16	4697566	.	C	G	5	5	10	0	0	10	0	0
16	4697821	.	G	A	8	4	12	0	1	13	0	0
16	4697829	.	C	G	7	5	12	0	0	12	0	0
16	4700766	.	T	C	5	5	10	0	1	11	0	0
16	4707211	.	G	T	0	4	4	0	5	9	0	0
16	4707381	.	A	T	2	2	4	0	0	4	0	0
16	4707480	.	G	A	4	3	7	0	0	7	0	0
16	4711553	.	T	C	1	3	4	0	1	5	0	0
16	4711574	.	A	T	2	2	4	0	1	5	0	0
16	4711613	.	G	A	2	3	5	0	0	5	0	0
16	4711616	.	T	C	2	0	2	0	4	6	0	0
16	4715556	.	C	T	1	2	3	0	1	4	0	0
16	4719294	.	G	A	2	2	4	0	0	4	0	0
16	4755816	.	A	T	5	8	13	0	0	13	0	0
16	4759113	.	G	A	2	8	10	0	0	10	0	0
16	4761133	.	T	C	7	0	7	0	8	15	0	0
16	4770378	.	A	T	2	2	4	0	0	4	0	0
16	4784020	.	T	C	3	5	8	0	0	8	0	0
16	4835220	.	T	G	1	2	3	0	0	3	0	0
16	4842203	.	T	A	7	10	17	0	1	18	0	0
16	4842308	.	A	G	3	10	13	0	4	17	0	0
16	4858779	.	G	T	1	8	9	0	7	16	0	0
16	4860516	.	A	G	11	8	19	0	0	19	0	0
16	4867445	.	C	T	17	9	26	0	0	26	0	0
16	4867487	.	C	T	18	14	32	0	2	34	0	0
16	4869973	.	G	A	13	10	23	0	0	23	0	0
16	4870180	.	C	T	12	6	18	0	1	19	0	0
16	4872260	.	C	T	10	9	19	0	0	19	0	0
16	4872281	.	G	A	10	9	19	0	0	19	0	0
16	4872320	.	G	A	9	4	13	0	4	17	0	0
16	4872453	.	C	T	12	13	25	0	1	26	0	0
16	4875417	.	C	T	5	5	10	0	2	12	0	0
16	4876470	.	C	T	9	6	15	0	1	16	0	0
16	4879768	.	T	C	15	7	22	0	0	22	0	0
16	4882206	.	C	T	15	7	22	0	1	23	0	0
16	4882491	.	C	T	12	12	24	0	1	25	0	0
16	4882492	.	G	A	3	12	15	0	11	26	0	0
16	4885458	.	T	A	14	13	27	0	1	28	0	0
16	4895423	.	T	C	14	15	29	0	1	30	0	0
16	4913262	.	T	C	1	2	3	0	0	3	0	0
16	4913307	.	C	G	1	2	3	0	0	3	0	0
16	5025494	.	G	A	11	13	24	0	1	25	0	0
16	5105221	.	G	A	19	17	36	0	0	36	0	0
16	5145459	.	T	C	10	15	25	0	1	26	0	0
16	5145599	.	C	A	13	23	36	0	1	37	0	0
16	5145622	.	G	A	16	18	34	0	0	34	0	0
16	5149298	.	T	C	12	18	30	0	2	32	0	0
16	5153956	.	T	C	28	17	45	0	1	46	0	0
16	5156563	.	G	A	3	13	16	0	9	25	0	0
16	5159283	.	A	G	13	19	32	0	1	33	0	0
16	5159289	.	C	T	14	19	33	0	0	33	0	0
16	5159328	.	T	C	11	13	24	0	0	24	0	0
16	5163275	.	T	C	11	6	17	0	0	17	0	0
16	5164569	.	C	T	11	8	19	0	0	19	0	0
16	5166015	.	G	A	0	15	15	0	15	30	0	0
16	5166030	.	C	T	14	15	29	0	1	30	0	0
16	5166288	.	G	A	12	20	32	0	1	33	0	0
16	5166332	.	T	A	14	23	37	0	0	37	0	0
16	5166351	.	T	C	16	24	40	0	4	44	0	0
16	5166546	.	G	A	21	10	31	0	0	31	0	0
16	5166719	.	A	G	8	9	17	0	1	18	0	0
16	5166805	.	A	G	14	0	14	0	14	28	0	0
16	5166889	.	G	T	18	12	30	0	1	31	0	0
16	5166977	.	G	T	16	8	24	0	1	25	0	0
16	5167030	.	G	A	18	9	27	0	0	27	0	0
16	5167249	.	A	C	12	6	18	0	0	18	0	0
16	5167257	.	A	G	7	11	18	0	1	19	0	0
16	5187795	.	G	A	15	6	21	0	2	23	0	0
16	5188029	.	A	C	8	8	16	0	0	16	0	0
16	5190168	.	C	T	8	7	15	0	1	16	0	0
16	5190210	.	C	T	6	10	16	0	0	16	0	0
16	5190590	.	A	G	11	10	21	0	0	21	0	0
16	5193353	.	C	T	8	7	15	0	2	17	0	0
16	5193539	.	G	A	12	7	19	0	1	20	0	0
16	5193605	.	T	G	10	3	13	0	0	13	0	0
16	5193621	.	A	C	6	0	6	0	3	9	0	0
16	5193644	.	G	A	6	7	13	0	0	13	0	0
16	5193884	.	C	A	5	3	8	0	0	8	0	0
16	5196377	.	C	T	10	10	20	0	0	20	0	0
16	5196630	.	C	T	11	10	21	0	1	22	0	0
16	5199264	.	A	G	4	2	6	0	0	6	0	0
16	5199381	.	C	T	5	6	11	0	0	11	0	0
16	5199399	.	C	T	5	4	9	0	0	9	0	0
16	5199476	.	C	T	8	8	16	0	1	17	0	0
16	5199503	.	C	T	9	6	15	0	1	16	0	0
16	5205146	.	G	A	1	12	13	0	5	18	0	0
16	5216548	.	G	A	11	15	26	1	0	27	0	0
16	5216707	.	G	C	5	14	19	0	0	19	0	0
16	5221680	.	A	C	7	5	12	0	0	12	0	0
16	5221888	.	T	C	10	17	27	0	0	27	0	0
16	5223355	.	G	A	8	14	22	0	0	22	0	0
16	5223375	.	A	G	9	16	25	0	0	25	0	0
16	5223454	.	C	T	7	10	17	0	3	20	0	0
16	5223470	.	G	A	8	11	19	0	1	20	0	0
16	5223740	.	C	T	11	5	16	0	0	16	0	0
16	5224328	.	A	G	13	15	28	0	0	28	0	0
16	5230627	.	G	A	3	11	14	0	7	21	0	0
16	5230782	.	A	T	3	10	13	0	0	13	0	0
16	5251783	.	G	A	1	3	4	0	0	4	0	0
16	5459926	.	T	C	0	2	2	0	0	2	0	0
16	5463942	.	A	G	3	2	5	0	0	5	0	0
16	5475116	.	C	T	1	2	3	0	0	3	0	0
16	5475143	.	G	A	3	2	5	0	0	5	0	0
16	5475530	.	C	T	3	4	7	0	0	7	0	0
16	5493285	.	A	G	1	2	3	0	0	3	0	0
16	5601579	.	T	C	3	2	5	0	0	5	0	0
16	5601611	.	A	G	3	2	5	0	0	5	0	0
16	5604846	.	T	C	1	2	3	0	0	3	0	0
16	5612617	.	A	T	4	11	15	0	2	18	1	0
16	5612631	.	A	T	8	11	19	0	1	20	0	0
16	5620883	.	C	T	5	7	12	0	2	14	0	0
16	5623099	.	T	C	5	7	12	0	1	13	0	0
16	5623120	.	T	C	5	10	15	0	0	15	0	0
16	5624209	.	C	T	10	3	13	0	0	13	0	0
16	5624467	.	C	T	4	11	15	0	0	15	0	0
16	5633881	.	C	T	6	7	13	0	0	13	0	0
16	5636292	.	T	G	5	0	5	0	5	10	0	0
16	5636328	.	T	G	6	0	6	0	5	11	0	0
16	5678085	.	A	C	7	4	11	0	0	11	0	0
16	5678244	.	A	G	6	4	10	0	0	10	0	0
16	5693445	.	G	A	11	7	18	0	1	19	0	0
16	5693532	.	T	C	9	11	20	0	0	20	0	0
16	5697114	.	C	T	12	7	19	0	0	19	0	0
16	5700055	.	G	A	0	11	11	0	7	18	0	0
16	5700058	.	T	C	6	11	17	0	0	17	0	0
16	5700402	.	A	G	11	23	34	0	3	37	0	0
16	5700534	.	C	T	11	13	24	0	2	26	0	0
16	5700689	.	G	A	1	7	8	0	10	18	0	0
16	5702807	.	C	T	10	9	19	0	1	20	0	0
16	5702891	.	T	G	8	13	21	0	0	21	0	0
16	5702906	.	T	C	10	15	25	0	0	25	0	0
16	5702948	.	C	T	12	14	26	0	1	27	0	0
16	5705811	.	G	T	2	10	12	0	15	27	0	0
16	5708077	.	C	A	16	14	30	0	2	32	0	0
16	5708175	.	C	T	9	19	28	0	1	29	0	0
16	5708181	.	G	A	9	17	26	0	2	28	0	0
16	5710369	.	C	T	18	5	23	0	1	24	0	0
16	5710483	.	G	A	1	8	9	0	10	19	0	0
16	5710582	.	G	T	6	12	18	0	0	18	0	0
16	5776245	.	T	C	24	15	39	0	0	39	0	0
16	5778882	.	A	G	20	12	32	0	1	33	0	0
16	5778913	.	T	C	21	11	32	0	2	34	0	0
16	5786977	.	G	A	3	7	10	0	0	10	0	0
16	5786989	.	C	T	0	4	4	0	7	11	0	0
16	5787396	.	A	G	4	1	5	0	4	9	0	0
16	5787399	.	T	A	5	5	10	0	0	10	0	0
16	5787436	.	C	A	7	3	10	0	0	10	0	0
16	5787562	.	G	A	9	6	15	0	1	16	0	0
16	5787670	.	A	G	4	5	9	0	0	9	0	0
16	5787671	.	G	C	5	4	9	0	0	9	0	0
16	5787911	.	T	G	5	6	11	0	1	12	0	0
16	5788163	.	T	A	5	3	8	0	0	8	0	0
16	5788716	.	C	T	0	2	2	0	6	8	0	0
16	5789124	.	C	A	3	8	11	0	9	20	0	0
16	5789340	.	G	C	12	1	13	0	13	26	0	0
16	5795721	.	C	T	0	15	15	0	5	20	0	0
16	5800670	.	C	T	1	12	13	0	6	19	0	0
16	5806440	.	G	A	7	5	12	0	0	12	0	0
16	5806578	.	G	T	3	2	5	0	1	7	1	0
16	5808868	.	G	T	11	4	15	0	1	16	0	0
16	5808931	.	G	A	5	11	16	0	0	16	0	0
16	5812610	.	C	T	0	5	5	0	3	8	0	0
16	5812624	.	G	T	6	4	10	0	0	10	0	0
16	5812703	.	G	A	3	9	12	0	0	12	0	0
16	5819970	.	T	A	3	7	10	0	1	11	0	0
16	5820045	.	C	T	10	5	15	0	0	15	0	0
16	5873756	.	G	A	1	2	3	0	0	3	0	0
16	6101565	.	C	T	3	2	5	0	0	5	0	0
16	6182755	.	C	T	16	26	42	0	0	42	0	0
16	6191514	.	A	G	33	29	62	0	5	67	0	0
16	6191526	.	G	C	39	28	67	0	1	68	0	0
16	6191622	.	C	G	36	31	67	1	1	69	0	0
16	6192811	.	A	G	26	36	62	0	1	63	0	0
16	6197593	.	G	A	29	24	53	0	0	53	0	0
16	6205657	.	G	T	29	16	45	0	0	45	0	0
16	6356766	.	A	G	5	6	11	0	0	11	0	0
16	6356823	.	T	A	2	4	6	0	0	6	0	0
16	6356850	.	T	C	2	2	4	0	0	4	0	0
16	6362221	.	A	T	4	2	6	0	1	7	0	0
16	6387037	.	G	A	14	25	39	0	3	42	0	0
16	6387121	.	G	A	28	25	53	0	1	54	0	0
16	6387143	.	A	C	28	3	31	0	25	56	0	0
16	6387157	.	A	C	34	25	59	0	2	61	0	0
16	6395740	.	T	A	1	5	6	0	0	6	0	0
16	6405013	.	C	G	0	3	3	0	1	4	0	0
16	6635289	.	T	C	7	2	9	0	0	9	0	0
16	6648735	.	C	T	3	2	5	0	1	6	0	0
16	6648795	.	T	C	3	2	5	0	0	5	0	0
16	6648935	.	T	G	2	2	4	0	1	5	0	0
16	6648937	.	C	T	3	2	5	0	0	5	0	0
16	6649671	.	T	C	3	2	5	0	0	5	0	0
16	6649730	.	A	T	2	3	5	0	1	6	0	0
16	6649785	.	G	A	0	4	4	0	6	10	0	0
16	6650049	.	T	C	5	4	9	0	0	9	0	0
16	6650087	.	C	T	4	4	8	0	0	8	0	0
16	6650097	.	C	T	4	5	9	0	1	10	0	0
16	6650394	.	T	C	5	5	10	0	1	11	0	0
16	6650415	.	T	C	3	6	9	0	1	10	0	0
16	6650631	.	C	A	5	7	12	0	1	13	0	0
16	6650793	.	T	A	5	7	12	0	0	12	0	0
16	6650800	.	G	T	8	5	13	0	1	14	0	0
16	6650889	.	G	T	1	5	6	0	7	13	0	0
16	6650931	.	C	T	9	7	16	0	1	17	0	0
16	6651049	.	T	C	4	6	10	0	0	10	0	0
16	6653508	.	C	A	5	2	7	0	0	7	0	0
16	6653587	.	T	A	5	3	8	0	1	9	0	0
16	6653875	.	G	T	2	7	9	0	0	9	0	0
16	6653883	.	A	G	1	7	8	0	0	8	0	0
16	6654152	.	T	C	3	2	5	0	0	5	0	0
16	6733509	.	G	T	3	2	5	0	0	5	0	0
16	6733567	.	G	A	2	3	5	0	0	5	0	0
16	6735149	.	C	T	2	2	4	0	0	4	0	0
16	6745636	.	T	C	4	2	6	1	0	7	0	0
16	6746003	.	C	T	3	2	5	0	0	5	0	0
16	6746038	.	C	A	2	5	7	0	0	7	0	0
16	6747256	.	G	T	1	6	7	0	0	7	0	0
16	6757321	.	T	C	4	3	7	0	0	7	0	0
16	6763017	.	A	T	3	4	7	0	0	7	0	0
16	6766761	.	C	T	4	3	7	0	0	7	0	0
16	6770411	.	A	G	2	0	2	0	7	9	0	0
16	6770441	.	A	G	3	3	6	0	0	6	0	0
16	6770455	.	G	A	3	3	6	0	0	6	0	0
16	6771841	.	T	C	5	6	11	0	0	11	0	0
16	6779823	.	C	T	3	4	7	0	0	7	0	0
16	6784866	.	C	T	5	6	11	0	0	11	0	0
16	6787491	.	G	A	1	5	6	0	5	11	0	0
16	6787801	.	A	G	8	0	8	0	5	13	0	0
16	6790964	.	C	T	6	6	12	0	0	12	0	0
16	6790978	.	C	T	3	5	8	0	0	8	0	0
16	6792044	.	C	T	6	3	9	0	0	9	0	0
16	6792059	.	C	G	5	3	8	0	0	8	0	0
16	6800043	.	G	A	0	2	2	0	8	10	0	0
16	6800127	.	A	G	5	0	5	0	6	11	0	0
16	6800383	.	G	A	3	4	7	0	0	7	0	0
16	6803410	.	C	T	4	2	6	0	1	7	0	0
16	6803429	.	T	C	12	3	15	0	1	16	0	0
16	6803650	.	A	T	18	18	36	4	2	42	0	0
16	6803725	.	T	C	24	20	44	0	1	45	0	0
16	6803887	.	A	G	26	17	43	0	1	44	0	0
16	6820746	.	G	C	9	10	19	0	0	19	0	0
16	6821214	.	G	A	3	9	12	0	0	12	0	0
16	6821423	.	A	G	8	9	17	0	1	18	0	0
16	6821465	.	C	T	2	8	10	0	10	20	0	0
16	6822014	.	G	A	10	19	29	0	0	29	0	0
16	6864716	.	T	C	3	4	7	0	0	7	0	0
16	6864838	.	G	A	0	7	7	0	4	11	0	0
16	6903350	.	T	A	4	2	6	0	1	7	0	0
16	6903599	.	G	A	3	2	5	0	0	5	0	0
16	6917125	.	G	A	8	2	10	0	0	10	0	0
16	6917242	.	G	T	7	6	13	0	0	13	0	0
16	6920023	.	T	C	3	2	5	0	0	5	0	0
16	6920026	.	G	A	1	2	3	0	3	6	0	0
16	6920250	.	G	A	6	3	9	0	1	10	0	0
16	6923646	.	A	T	3	6	9	0	2	11	0	0
16	6923836	.	A	G	11	6	17	0	2	19	0	0
16	6923879	.	G	A	4	5	9	0	0	9	0	0
16	6929670	.	C	A	4	5	9	0	1	10	0	0
16	6929671	.	A	T	4	6	10	0	0	10	0	0
16	6929812	.	C	T	9	4	13	0	0	13	0	0
16	6929832	.	G	A	10	5	15	0	0	15	0	0
16	6929860	.	G	A	8	7	15	0	1	16	0	0
16	6932735	.	A	T	3	5	8	0	0	8	0	0
16	6932886	.	A	T	1	4	5	0	0	5	0	0
16	6937584	.	T	C	1	0	1	0	3	4	0	0
16	6943820	.	T	C	1	2	3	0	0	3	0	0
16	6944713	.	G	T	4	5	9	0	0	9	0	0
16	6944720	.	A	G	5	7	12	0	1	13	0	0
16	6944766	.	T	C	13	13	26	0	0	26	0	0
16	6955048	.	G	A	13	20	33	0	1	34	0	0
16	6955368	.	A	G	11	10	21	0	0	21	0	0
16	7202241	.	T	A	1	4	5	0	0	5	0	0
16	7202699	.	T	C	2	3	5	0	0	5	0	0
16	7202712	.	G	A	4	4	8	0	0	8	0	0
16	7202757	.	C	T	5	2	7	0	0	7	0	0
16	7202758	.	T	A	5	2	7	0	0	7	0	0
16	7208249	.	C	T	0	2	2	0	5	7	0	0
16	7208484	.	C	T	2	3	5	0	0	5	0	0
16	7208630	.	T	C	4	3	7	0	0	7	0	0
16	7212428	.	A	G	1	3	4	0	0	4	0	0
16	7212449	.	G	A	2	2	4	0	0	4	0	0
16	7212520	.	G	A	4	2	6	0	0	6	0	0
16	7217013	.	A	G	6	8	14	0	0	14	0	0
16	7217052	.	G	T	9	8	17	0	0	17	0	0
16	7220142	.	A	G	10	10	20	0	1	21	0	0
16	7220225	.	C	T	0	13	13	0	6	19	0	0
16	7221846	.	C	T	1	5	6	0	10	16	0	0
16	7226998	.	G	A	7	6	13	0	4	17	0	0
16	7239374	.	A	C	4	11	15	0	0	15	0	0
16	7242677	.	C	T	4	5	9	0	0	9	0	0
16	7242729	.	A	T	7	4	11	0	2	13	0	0
16	7242735	.	T	A	8	2	10	0	1	11	0	0
16	7242790	.	A	G	8	3	11	0	0	11	0	0
16	7242821	.	A	T	12	5	17	0	1	18	0	0
16	7242878	.	A	G	8	14	22	0	0	22	0	0
16	7242961	.	A	G	14	7	21	0	0	21	0	0
16	7250782	.	A	T	10	11	21	0	0	21	0	0
16	7252871	.	T	C	7	24	31	0	0	31	0	0
16	7254778	.	G	A	2	25	27	0	20	47	0	0
16	7259719	.	T	C	11	11	22	0	2	24	0	0
16	7259853	.	A	G	2	3	5	0	0	5	0	0
16	7259869	.	T	A	3	4	7	0	0	7	0	0
16	7259900	.	A	G	4	3	7	0	1	8	0	0
16	7259956	.	A	T	7	15	22	0	0	22	0	0
16	7259957	.	G	A	7	15	22	0	0	22	0	0
16	7260262	.	G	A	3	7	10	0	0	10	0	0
16	7260280	.	T	A	3	6	9	0	0	9	0	0
16	7315229	.	G	C	1	3	4	0	1	5	0	0
16	7315654	.	A	T	3	4	7	0	1	8	0	0
16	7315933	.	G	A	2	2	4	0	0	4	0	0
16	7316083	.	G	A	6	6	12	0	1	13	0	0
16	7316409	.	G	A	6	4	10	0	0	10	0	0
16	7376588	.	T	G	1	2	3	0	0	3	0	0
16	7376589	.	T	C	1	2	3	0	0	3	0	0
16	7376900	.	A	G	3	7	10	0	0	10	0	0
16	7379161	.	T	A	1	1	2	0	1	3	0	0
16	7385807	.	C	T	6	3	9	0	1	10	0	0
16	7415215	.	G	A	12	10	22	0	0	22	0	0
16	7415254	.	T	A	14	8	22	0	2	24	0	0
16	7415423	.	C	A	11	12	23	0	0	23	0	0
16	7415435	.	G	A	13	10	23	0	0	23	0	0
16	7415542	.	A	T	6	17	23	0	4	27	0	0
16	7415559	.	C	A	8	19	27	0	1	28	0	0
16	7415761	.	G	A	12	12	24	0	0	24	0	0
16	7415793	.	G	A	11	8	19	0	1	20	0	0
16	7416236	.	C	T	6	10	16	0	0	16	0	0
16	7416320	.	C	T	9	5	14	0	0	14	0	0
16	7416352	.	T	A	5	5	10	0	0	10	0	0
16	7416478	.	G	A	1	2	3	0	0	3	0	0
16	7621002	.	T	G	1	3	4	0	0	4	0	0
16	7626589	.	T	C	20	13	33	0	3	36	0	0
16	7630612	.	T	C	22	14	36	0	2	38	0	0
16	7635527	.	C	T	23	20	43	0	2	45	0	0
16	7635721	.	T	A	16	22	38	0	3	41	0	0
16	7638734	.	T	A	20	10	30	0	0	30	0	0
16	7638788	.	T	C	24	11	35	0	0	35	0	0
16	7638815	.	A	T	26	15	41	0	2	43	0	0
16	7638828	.	A	G	28	0	28	0	14	42	0	0
16	7638866	.	A	T	25	15	40	0	1	41	0	0
16	7638979	.	C	T	23	26	49	0	1	50	0	0
16	7638984	.	C	A	23	21	44	0	5	49	0	0
16	7639085	.	A	C	15	28	43	0	0	43	0	0
16	7639100	.	T	A	15	26	41	0	1	42	0	0
16	7639125	.	A	G	33	17	50	0	0	50	0	0
16	7639401	.	A	C	28	29	57	0	3	60	0	0
16	7639527	.	C	T	23	15	38	0	1	39	0	0
16	7639534	.	G	C	3	17	20	0	21	41	0	0
16	7639621	.	C	T	15	20	35	0	2	37	0	0
16	7639643	.	A	T	14	20	34	0	1	35	0	0
16	7639684	.	A	G	10	18	28	0	0	28	0	0
16	7639774	.	T	A	14	17	31	0	1	32	0	0
16	7639856	.	T	C	14	22	36	0	2	39	1	0
16	7640116	.	A	G	24	17	41	0	2	43	0	0
16	7640127	.	G	A	1	18	19	0	25	44	0	0
16	7640390	.	C	T	28	10	38	0	0	38	0	0
16	7640410	.	A	G	27	12	39	0	2	41	0	0
16	7640425	.	T	A	23	20	43	0	0	43	0	0
16	7640757	.	T	A	13	19	32	0	0	32	0	0
16	7640999	.	G	T	2	2	4	0	0	5	1	0
16	7673160	.	A	T	2	2	4	0	0	4	0	0
16	7673175	.	C	G	2	2	4	0	0	4	0	0
16	7705796	.	T	C	2	2	4	0	0	4	0	0
16	7711556	.	C	A	6	10	16	0	1	17	0	0
16	7716184	.	C	G	7	4	11	0	0	11	0	0
16	7728408	.	C	T	6	9	15	0	0	15	0	0
16	7743598	.	T	A	2	3	5	0	0	5	0	0
16	7743687	.	A	G	2	3	5	0	0	5	0	0
16	7745027	.	C	A	1	4	5	0	0	5	0	0
16	7745053	.	C	G	2	5	7	0	0	7	0	0
16	7746193	.	G	A	2	3	5	0	0	5	0	0
16	7746947	.	G	A	1	4	5	0	0	5	0	0
16	7748211	.	G	A	4	3	7	0	0	7	0	0
16	7748364	.	G	A	2	5	7	0	0	7	0	0
16	7758386	.	C	T	3	3	6	0	0	6	0	0
16	7792786	.	C	T	5	4	9	0	0	9	0	0
16	7803023	.	T	C	4	8	12	0	0	12	0	0
16	7803200	.	C	G	2	5	7	0	0	7	0	0
16	7803206	.	C	T	2	5	7	0	0	7	0	0
16	7803298	.	T	C	4	8	12	0	0	12	0	0
16	7803340	.	T	C	3	6	9	0	1	10	0	0
16	7803560	.	A	G	9	5	14	0	1	15	0	0
16	7803627	.	T	A	10	6	16	0	0	16	0	0
16	7803765	.	C	G	5	6	11	0	0	11	0	0
16	7803782	.	C	A	1	6	7	0	5	12	0	0
16	7803825	.	A	T	7	4	11	0	0	11	0	0
16	7803859	.	A	C	4	3	7	0	0	7	0	0
16	7803905	.	G	C	4	0	4	0	4	8	0	0
16	7803923	.	T	A	6	5	11	0	2	13	0	0
16	7803971	.	T	A	6	5	11	0	0	11	0	0
16	7804081	.	T	A	4	4	8	0	0	8	0	0
16	7804269	.	A	T	6	7	13	0	0	13	0	0
16	7804270	.	C	T	6	7	13	0	0	13	0	0
16	7804355	.	C	G	4	5	9	0	0	9	0	0
16	7804391	.	T	C	5	0	5	0	5	10	0	0
16	7804458	.	A	C	5	6	11	0	0	11	0	0
16	7804569	.	C	A	6	5	11	0	0	11	0	0
16	7804588	.	C	A	6	5	11	0	1	12	0	0
16	7804990	.	A	C	1	2	3	0	0	3	0	0
16	7805423	.	C	T	1	4	5	0	1	6	0	0
16	7805524	.	C	A	1	5	6	0	4	10	0	0
16	7821241	.	C	T	13	4	17	0	0	17	0	0
16	7821244	.	G	A	12	4	16	0	0	16	0	0
16	7828792	.	G	T	5	8	13	0	1	14	0	0
16	7976359	.	T	A	3	2	5	0	0	5	0	0
16	7985896	.	T	A	10	5	15	0	0	15	0	0
16	7999368	.	A	G	2	8	10	0	0	10	0	0
16	7999499	.	C	A	3	2	5	0	0	5	0	0
16	8001064	.	C	A	1	3	4	0	0	4	0	0
16	8040833	.	C	G	6	3	9	0	1	10	0	0
16	8041234	.	G	A	0	7	7	0	5	12	0	0
16	8041261	.	T	A	6	5	11	0	0	11	0	0
16	8051941	.	T	C	14	0	14	0	11	25	0	0
16	8052033	.	T	C	10	13	23	0	1	24	0	0
16	8052049	.	G	A	10	14	24	0	1	25	0	0
16	8052145	.	C	A	15	20	35	0	0	35	0	0
16	8052537	.	C	T	12	11	23	0	2	25	0	0
16	8052606	.	T	C	11	0	11	0	7	18	0	0
16	8052651	.	T	C	12	12	24	0	1	25	0	0
16	8052673	.	G	C	12	0	12	0	17	29	0	0
16	8052747	.	A	G	11	10	21	0	1	22	0	0
16	8052831	.	T	A	10	10	20	0	0	20	0	0
16	8052866	.	C	A	0	4	4	4	6	14	0	0
16	8052883	.	T	C	6	3	9	10	1	20	0	0
16	8052909	.	T	A	6	4	10	10	0	20	0	0
16	8052982	.	T	C	12	7	19	1	2	22	0	0
16	8053206	.	T	G	7	7	14	0	2	16	0	0
16	8053403	.	C	T	12	13	25	0	0	25	0	0
16	8053485	.	C	T	16	9	25	0	2	27	0	0
16	8053716	.	A	G	19	14	33	0	3	36	0	0
16	8053717	.	T	C	18	16	34	0	2	36	0	0
16	8054260	.	T	G	3	5	8	0	0	8	0	0
16	8054290	.	C	T	2	7	9	0	1	10	0	0
16	8054389	.	C	T	1	9	10	0	9	19	0	0
16	8054434	.	T	C	10	1	11	0	13	24	0	0
16	8055037	.	A	G	12	9	21	0	0	21	0	0
16	8059585	.	T	C	13	9	22	0	0	22	0	0
16	8066237	.	A	C	9	8	17	0	0	17	0	0
16	8066318	.	A	G	17	13	30	0	0	30	0	0
16	8119672	.	G	A	12	10	22	0	1	23	0	0
16	8119976	.	A	G	18	13	31	0	1	32	0	0
16	8120033	.	G	A	12	18	30	0	0	30	0	0
16	8120171	.	C	T	12	9	21	0	2	23	0	0
16	8139585	.	G	A	6	5	11	0	0	11	0	0
16	8139752	.	A	T	4	5	9	0	1	10	0	0
16	8139786	.	T	C	6	6	12	0	0	12	0	0
16	8160484	.	T	C	5	9	14	0	1	15	0	0
16	8160589	.	T	C	5	5	10	0	1	11	0	0
16	8161330	.	C	T	4	3	7	0	0	7	0	0
16	8161555	.	C	T	6	3	9	0	2	11	0	0
16	8161573	.	C	A	5	3	8	0	1	9	0	0
16	8161591	.	G	A	5	5	10	0	0	10	0	0
16	8161708	.	G	A	0	9	9	0	7	16	0	0
16	8161875	.	C	T	2	6	8	0	0	8	0	0
16	8162024	.	G	A	0	2	2	0	1	3	0	0
16	8162046	.	G	A	0	2	2	0	2	4	0	0
16	8299123	.	T	A	8	6	14	0	0	14	0	0
16	8299302	.	G	A	2	4	6	0	1	7	0	0
16	8299308	.	T	A	3	5	8	0	0	8	0	0
16	8299462	.	G	C	1	2	3	0	0	3	0	0
16	8299480	.	T	A	2	2	4	0	0	4	0	0
16	8299793	.	T	A	7	3	10	1	0	11	0	0
16	8299794	.	G	A	7	3	10	1	0	11	0	0
16	8300218	.	T	A	6	2	8	0	0	8	0	0
16	8300225	.	C	T	0	2	2	0	6	8	0	0
16	8300255	.	G	A	7	3	10	0	0	10	0	0
16	8300269	.	T	C	5	2	7	0	0	7	0	0
16	8300823	.	T	A	3	3	6	0	0	6	0	0
16	8300895	.	C	G	3	3	6	0	0	6	0	0
16	8300928	.	T	C	2	5	7	0	0	7	0	0
16	8323386	.	T	C	7	4	11	0	0	11	0	0
16	8339352	.	G	C	1	0	1	0	4	5	0	0
16	8342675	.	C	T	1	6	7	0	0	7	0	0
16	8530992	.	A	T	2	2	4	0	0	4	0	0
16	8531299	.	C	T	1	3	4	0	0	4	0	0
16	8532240	.	G	C	1	2	3	0	0	3	0	0
16	8532430	.	G	T	1	3	4	0	0	4	0	0
16	8535966	.	C	T	1	3	4	0	1	5	0	0
16	8539523	.	C	T	5	6	11	0	0	11	0	0
16	8539885	.	C	A	2	3	5	0	0	5	0	0
16	8540033	.	G	A	2	3	5	0	0	5	0	0
16	8540664	.	G	T	3	3	6	0	0	6	0	0
16	8552018	.	C	T	1	3	4	0	0	4	0	0
16	8578996	.	G	A	3	3	6	0	2	8	0	0
16	8752017	.	T	A	14	21	35	0	2	37	0	0
16	8752091	.	A	G	23	20	43	0	1	44	0	0
16	8752223	.	C	T	11	14	25	0	0	25	0	0
16	8752316	.	G	T	14	17	31	0	0	31	0	0
16	8752334	.	C	T	3	20	23	0	12	35	0	0
16	8759975	.	G	A	25	20	45	0	0	45	0	0
16	8771091	.	A	G	4	5	9	0	0	9	0	0
16	8788386	.	T	C	15	6	21	0	0	21	0	0
16	8788446	.	A	G	8	19	27	0	0	27	0	0
16	8788629	.	T	C	12	0	12	1	10	23	0	0
16	8788659	.	G	C	14	8	22	1	1	24	0	0
16	8816122	.	G	A	9	12	21	0	3	24	0	0
16	8818958	.	T	C	6	8	14	0	4	18	0	0
16	8819113	.	T	C	11	9	20	0	0	20	0	0
16	8834219	.	G	T	8	12	20	0	0	20	0	0
16	8844580	.	A	G	8	19	27	1	0	28	0	0
16	8844586	.	C	A	6	18	24	1	1	26	0	0
16	8845738	.	T	G	10	12	22	0	1	23	0	0
16	8847272	.	T	C	13	10	23	0	0	23	0	0
16	8862269	.	G	A	6	10	16	0	0	16	0	0
16	9267406	.	G	A	1	2	3	0	0	3	0	0
16	9276020	.	C	T	10	11	21	0	0	21	0	0
16	9281534	.	G	A	7	6	13	0	1	14	0	0
16	9282707	.	C	T	4	7	11	0	0	11	0	0
16	9286997	.	G	A	4	8	12	0	0	12	0	0
16	9297728	.	C	T	9	4	13	0	3	16	0	0
16	9297889	.	C	T	5	9	14	0	0	14	0	0
16	9299700	.	C	T	6	6	12	0	0	12	0	0
16	9306247	.	A	G	4	3	7	0	1	8	0	0
16	9313279	.	G	A	5	3	8	0	0	8	0	0
16	9313294	.	T	C	4	6	10	0	0	10	0	0
16	9348891	.	C	T	5	6	11	0	0	11	0	0
16	9383456	.	T	A	7	3	10	0	0	10	0	0
16	9409013	.	C	A	4	2	6	0	1	7	0	0
16	9409286	.	T	A	2	2	4	0	1	5	0	0
16	9409321	.	A	T	3	2	5	0	0	5	0	0
16	9410978	.	C	G	4	4	8	0	0	8	0	0
16	9411058	.	C	T	1	2	3	0	1	4	0	0
16	9411737	.	T	G	2	3	5	0	0	5	0	0
16	9411749	.	G	A	3	4	7	0	0	7	0	0
16	9411962	.	G	A	4	5	9	0	0	9	0	0
16	9411965	.	G	A	4	3	7	0	1	8	0	0
16	9412024	.	A	T	4	2	6	0	0	6	0	0
16	9412125	.	A	G	6	3	9	0	0	9	0	0
16	9412302	.	C	T	8	5	13	0	0	13	0	0
16	9412401	.	C	T	6	3	9	0	0	9	0	0
16	9415134	.	A	G	1	2	3	0	0	3	0	0
16	9415176	.	A	G	4	3	7	0	0	7	0	0
16	9415697	.	T	C	4	5	9	0	0	9	0	0
16	9415793	.	C	T	2	4	6	0	0	6	0	0
16	9420003	.	G	A	10	9	19	0	0	19	0	0
16	9433766	.	T	A	2	4	6	0	0	6	0	0
16	9434086	.	A	C	3	2	5	0	2	7	0	0
16	9437789	.	G	A	8	9	17	0	0	17	0	0
16	9444111	.	T	C	4	2	6	0	0	6	0	0
16	9444117	.	C	T	4	3	7	0	0	7	0	0
16	9446996	.	T	C	3	5	8	0	0	8	0	0
16	9593865	.	A	C	3	6	9	0	0	9	0	0
16	9596127	.	C	T	3	12	15	0	0	15	0	0
16	9602508	.	C	T	12	9	21	0	1	22	0	0
16	9602523	.	G	A	13	10	23	0	1	24	0	0
16	9602643	.	T	C	7	14	21	0	2	23	0	0
16	9602672	.	A	G	10	11	21	0	1	22	0	0
16	9605436	.	A	T	15	5	20	0	2	22	0	0
16	9605619	.	T	C	5	8	13	0	0	13	0	0
16	9605728	.	G	C	6	3	9	0	0	9	0	0
16	9605823	.	A	T	3	10	13	0	0	13	0	0
16	9605850	.	A	G	5	10	15	0	0	15	0	0
16	9605947	.	A	G	3	13	16	0	1	17	0	0
16	9605982	.	C	A	8	11	19	0	0	19	0	0
16	9606011	.	G	T	6	6	12	0	2	14	0	0
16	9606024	.	C	T	6	6	12	0	1	13	0	0
16	9606048	.	G	A	2	4	6	0	0	6	0	0
16	9714080	.	G	A	12	4	16	0	0	16	0	0
16	9714483	.	A	G	5	7	12	0	0	12	0	0
16	9724575	.	T	C	4	2	6	0	1	7	0	0
16	9745489	.	T	A	8	6	14	0	0	14	0	0
16	9748874	.	C	G	7	3	10	0	0	10	0	0
16	9751612	.	A	G	3	0	3	0	6	9	0	0
16	9752273	.	T	C	6	4	10	0	1	11	0	0
16	9752999	.	A	G	3	5	8	0	0	8	0	0
16	9753005	.	C	G	4	6	10	0	0	10	0	0
16	9753083	.	A	T	5	3	8	0	1	9	0	0
16	9755612	.	C	T	5	8	13	0	0	13	0	0
16	9755647	.	T	C	4	12	16	0	1	17	0	0
16	9758414	.	T	G	7	6	13	0	0	13	0	0
16	9758452	.	A	T	6	5	11	0	0	11	0	0
16	9758561	.	T	C	2	2	4	0	0	4	0	0
16	9758944	.	G	A	0	8	8	0	10	18	0	0
16	9758956	.	A	G	7	8	15	0	0	15	0	0
16	9759605	.	A	T	2	11	13	0	2	15	0	0
16	9759698	.	A	C	8	12	20	0	0	20	0	0
16	9759820	.	T	A	7	9	16	0	0	16	0	0
16	9759842	.	A	G	7	7	14	0	0	14	0	0
16	9759914	.	A	G	5	5	10	0	0	10	0	0
16	9760006	.	C	T	5	6	11	0	0	11	0	0
16	9760083	.	T	C	12	13	25	0	0	25	0	0
16	9760085	.	C	A	12	13	25	0	0	25	0	0
16	9760248	.	T	C	7	13	20	0	0	20	0	0
16	9760597	.	A	G	2	1	3	0	3	6	0	0
16	9760894	.	A	T	6	6	12	0	0	12	0	0
16	9761339	.	A	C	5	4	9	0	2	11	0	0
16	9766586	.	A	C	13	10	23	0	0	23	0	0
16	9766774	.	T	C	9	13	22	0	2	24	0	0
16	9769846	.	C	T	9	8	17	0	1	18	0	0
16	9771283	.	C	G	22	13	35	0	2	37	0	0
16	9771284	.	T	C	22	13	35	0	2	37	0	0
16	9774187	.	G	A	13	19	32	0	1	33	0	0
16	9774357	.	G	A	22	18	40	0	1	41	0	0
16	9774381	.	G	A	17	24	41	0	0	41	0	0
16	9777497	.	T	C	21	15	36	0	0	36	0	0
16	9777589	.	A	T	11	11	22	0	1	23	0	0
16	9777716	.	A	G	7	5	12	0	0	12	0	0
16	9777829	.	T	C	2	5	7	0	0	7	0	0
16	9777857	.	T	C	2	2	4	0	0	4	0	0
16	9781031	.	T	C	22	14	36	0	4	40	0	0
16	9785990	.	G	A	12	21	33	0	0	33	0	0
16	9787891	.	T	G	20	25	45	0	0	45	0	0
16	9788447	.	T	C	4	10	14	0	0	14	0	0
16	9788486	.	G	A	9	14	23	0	0	23	0	0
16	9788672	.	G	A	9	6	15	0	1	16	0	0
16	9788758	.	T	A	6	3	9	0	0	9	0	0
16	9788929	.	T	G	6	5	11	0	0	11	0	0
16	9789007	.	A	T	11	11	22	0	0	22	0	0
16	9789015	.	C	G	13	8	21	0	0	22	1	0
16	9789048	.	G	T	8	9	17	0	0	17	0	0
16	9789063	.	A	C	6	12	18	0	4	22	0	0
16	9789097	.	C	T	15	5	20	0	0	20	0	0
16	9789225	.	A	C	11	6	17	0	1	18	0	0
16	9789371	.	C	G	7	1	8	0	6	14	0	0
16	9789513	.	C	G	18	10	28	0	2	30	0	0
16	9789984	.	T	C	8	11	19	0	0	19	0	0
16	9791087	.	A	C	3	1	4	0	0	4	0	0
16	9791111	.	T	G	4	2	6	0	0	6	0	0
16	9793981	.	A	T	2	8	10	0	1	11	0	0
16	9796921	.	T	C	2	0	2	0	3	5	0	0
16	9797128	.	A	C	3	0	3	0	5	8	0	0
16	9807425	.	C	A	1	2	3	0	0	3	0	0
16	9807475	.	C	T	1	2	3	0	0	3	0	0
16	9811450	.	G	A	1	3	4	0	0	4	0	0
16	9811675	.	G	A	1	4	5	0	0	5	0	0
16	9833794	.	T	A	20	21	41	0	0	41	0	0
16	9833887	.	T	A	22	20	42	1	3	46	0	0
16	9833974	.	G	A	29	22	51	0	1	52	0	0
16	9834135	.	A	C	19	15	34	0	2	36	0	0
16	9834271	.	C	T	14	14	28	2	1	31	0	0
16	9834491	.	T	A	15	10	25	0	1	26	0	0
16	9834518	.	T	G	16	16	32	0	1	33	0	0
16	9834541	.	G	A	18	19	37	0	3	40	0	0
16	9834595	.	A	T	19	18	37	0	1	39	1	0
16	9834748	.	G	C	18	12	30	0	1	31	0	0
16	9834802	.	C	A	11	14	25	0	0	25	0	0
16	9834850	.	A	G	11	20	31	0	0	31	0	0
16	9834960	.	G	A	19	23	42	0	0	42	0	0
16	9835062	.	G	A	19	1	20	0	22	42	0	0
16	9835250	.	C	G	28	17	45	0	0	45	0	0
16	9847149	.	G	A	19	13	32	0	1	33	0	0
16	9847182	.	T	C	13	21	34	0	2	36	0	0
16	9978438	.	G	A	29	24	53	1	0	54	0	0
16	10027167	.	G	C	3	0	3	0	3	6	0	0
16	10038806	.	A	T	1	3	4	0	0	4	0	0
16	10055519	.	T	A	1	2	3	0	0	3	0	0
16	10055745	.	C	A	3	3	6	0	0	6	0	0
16	10066164	.	A	G	6	6	12	0	0	12	0	0
16	10068168	.	C	T	6	7	13	0	0	13	0	0
16	10071730	.	G	A	6	11	17	0	1	18	0	0
16	10097362	.	T	C	1	0	1	0	4	5	0	0
16	10199585	.	C	T	5	2	7	0	0	7	0	0
16	10210470	.	T	G	3	2	5	0	0	5	0	0
16	10213523	.	A	T	1	2	3	0	0	3	0	0
16	10213529	.	A	G	1	2	3	0	0	3	0	0
16	10217223	.	G	A	1	2	3	0	0	3	0	0
16	10217301	.	A	G	1	3	4	0	0	4	0	0
16	10217306	.	C	A	1	2	3	0	0	3	0	0
16	10264672	.	G	C	1	2	3	0	0	3	0	0
16	10279330	.	C	T	1	2	3	0	0	3	0	0
16	10279536	.	G	A	1	2	3	0	0	3	0	0
16	10283438	.	C	A	4	3	7	0	0	7	0	0
16	10284480	.	T	A	3	3	6	0	0	6	0	0
16	10284486	.	T	A	3	2	5	0	0	5	0	0
16	10284582	.	A	T	2	3	5	0	0	5	0	0
16	10284593	.	T	A	0	5	5	0	0	5	0	0
16	10287699	.	A	G	3	3	6	0	0	6	0	0
16	10287996	.	G	A	9	3	12	0	0	12	0	0
16	10288022	.	C	A	8	4	12	0	0	12	0	0
16	10288121	.	C	T	2	3	5	0	0	5	0	0
16	10288230	.	A	G	10	10	20	0	1	21	0	0
16	10288260	.	C	T	4	12	16	0	2	18	0	0
16	10288784	.	C	A	2	10	12	0	0	12	0	0
16	10288827	.	T	A	7	3	10	0	0	10	0	0
16	10288882	.	T	A	4	6	10	0	0	10	0	0
16	10288951	.	G	A	2	4	6	0	0	6	0	0
16	10288998	.	G	A	1	4	5	0	0	5	0	0
16	10289049	.	C	A	3	5	8	0	0	8	0	0
16	10300046	.	C	T	9	3	12	0	0	12	0	0
16	10300466	.	G	T	4	3	7	0	0	7	0	0
16	10300493	.	A	G	6	5	11	0	0	11	0	0
16	10323903	.	C	T	17	11	28	0	0	28	0	0
16	10325870	.	C	T	21	22	43	0	2	45	0	0
16	10326092	.	C	T	27	14	41	0	3	44	0	0
16	10326347	.	T	G	20	1	21	0	24	45	0	0
16	10337398	.	G	T	0	2	2	0	2	4	0	0
16	10338418	.	T	A	9	3	12	0	0	12	0	0
16	10339887	.	C	A	4	3	7	0	0	7	0	0
16	10341816	.	A	C	6	6	12	0	0	12	0	0
16	10342169	.	C	T	4	5	9	0	0	9	0	0
16	10345223	.	T	C	4	4	8	0	1	9	0	0
16	10345595	.	A	G	12	8	20	0	1	21	0	0
16	10345720	.	A	G	8	10	18	0	1	19	0	0
16	10346329	.	T	C	8	10	18	0	0	18	0	0
16	10346444	.	T	G	6	9	15	0	2	17	0	0
16	10360911	.	T	C	8	10	18	0	1	19	0	0
16	10360935	.	T	C	8	10	18	0	1	19	0	0
16	10360971	.	C	T	12	6	18	0	1	19	0	0
16	10364706	.	T	C	12	12	24	0	2	26	0	0
16	10366768	.	C	T	15	16	31	1	1	33	0	0
16	10367171	.	G	A	15	12	27	0	4	31	0	0
16	10367475	.	C	A	21	18	39	0	3	42	0	0
16	10367499	.	C	T	19	17	36	0	1	37	0	0
16	10367674	.	C	T	18	17	35	0	0	35	0	0
16	10367894	.	A	C	13	13	26	0	3	29	0	0
16	10367961	.	C	T	9	17	26	0	0	26	0	0
16	10368002	.	T	A	10	12	22	0	2	24	0	0
16	10368086	.	A	T	9	13	22	0	4	26	0	0
16	10368098	.	T	C	13	15	28	0	0	28	0	0
16	10368200	.	C	T	17	6	23	0	0	23	0	0
16	10368219	.	T	G	9	14	23	0	0	23	0	0
16	10368352	.	T	G	13	11	24	0	0	24	0	0
16	10368407	.	A	G	7	7	14	0	1	15	0	0
16	10368408	.	C	A	7	7	14	0	0	14	0	0
16	10368452	.	T	A	8	21	29	0	1	30	0	0
16	10368564	.	G	C	12	8	20	0	1	21	0	0
16	10368594	.	C	A	15	10	25	0	0	25	0	0
16	10368713	.	G	T	12	9	21	0	1	22	0	0
16	10368801	.	C	T	7	9	16	0	0	16	0	0
16	10368820	.	C	A	10	10	20	0	0	20	0	0
16	10369068	.	C	T	10	8	18	0	0	18	0	0
16	10369168	.	C	G	7	10	17	0	1	18	0	0
16	10369266	.	G	A	18	14	32	0	0	32	0	0
16	10397944	.	G	A	1	1	2	0	1	3	0	0
16	10413724	.	A	C	4	3	7	0	0	7	0	0
16	10413726	.	G	T	3	4	7	0	0	7	0	0
16	10413777	.	T	A	2	5	7	0	0	7	0	0
16	10413957	.	T	C	5	7	12	0	0	12	0	0
16	10417124	.	G	C	12	12	24	0	0	24	0	0
16	10425937	.	G	T	4	5	9	0	0	9	0	0
16	10426088	.	A	G	6	5	11	0	0	11	0	0
16	10426327	.	C	T	3	5	8	0	0	8	0	0
16	10426522	.	C	A	3	4	7	0	0	7	0	0
16	10426525	.	G	A	0	4	4	0	3	7	0	0
16	10426762	.	G	A	1	3	4	0	8	12	0	0
16	10427022	.	A	G	3	1	4	0	0	4	0	0
16	10427656	.	G	A	1	2	3	0	5	8	0	0
16	10427786	.	T	G	3	6	9	0	0	9	0	0
16	10427964	.	A	C	3	9	12	0	0	12	0	0
16	10431931	.	G	A	0	4	4	0	8	12	0	0
16	10431994	.	G	A	4	10	14	0	2	16	0	0
16	10432113	.	G	A	2	3	5	0	0	5	0	0
16	10432114	.	G	T	2	3	5	0	0	5	0	0
16	10434856	.	G	T	6	5	11	0	0	11	0	0
16	10438833	.	G	A	5	3	8	0	1	9	0	0
16	10439910	.	G	A	0	8	8	0	6	14	0	0
16	10444018	.	G	A	7	3	10	0	3	13	0	0
16	10447409	.	A	G	5	5	10	0	0	10	0	0
16	10447923	.	C	A	2	2	4	0	0	4	0	0
16	10454950	.	G	A	0	8	8	0	10	18	0	0
16	10458749	.	A	G	5	5	10	0	0	10	0	0
16	10461712	.	A	T	12	7	19	0	1	20	0	0
16	10464571	.	C	T	9	9	18	0	1	19	0	0
16	10475645	.	C	T	9	10	19	0	0	19	0	0
16	10475646	.	A	G	9	10	19	0	0	19	0	0
16	10477836	.	C	T	1	11	12	0	9	21	0	0
16	10481305	.	T	C	18	1	19	0	13	32	0	0
16	10481425	.	C	T	17	15	32	0	1	33	0	0
16	10481488	.	C	T	1	17	18	0	11	29	0	0
16	10489410	.	G	A	10	10	20	0	2	22	0	0
16	10502065	.	A	G	11	14	25	0	1	26	0	0
16	10502169	.	G	A	15	8	23	0	0	23	0	0
16	10504444	.	C	A	19	14	33	0	2	35	0	0
16	10506411	.	C	T	12	14	26	0	1	27	0	0
16	10557948	.	C	T	4	3	7	0	1	8	0	0
16	10617265	.	T	C	4	6	10	0	0	10	0	0
16	10620018	.	G	A	2	7	9	0	9	18	0	0
16	10620100	.	A	T	8	9	17	0	1	18	0	0
16	10620213	.	C	T	4	4	8	0	1	9	0	0
16	10633656	.	C	T	7	4	11	0	0	11	0	0
16	10633690	.	C	A	9	6	15	0	1	16	0	0
16	10634271	.	C	T	10	10	20	1	2	23	0	0
16	10634289	.	T	G	12	11	23	0	0	23	0	0
16	10634650	.	T	C	1	2	3	0	0	3	0	0
16	10635179	.	T	A	1	7	8	0	0	8	0	0
16	10635338	.	A	T	8	12	20	0	0	20	0	0
16	10635401	.	T	G	11	15	26	0	0	26	0	0
16	10635532	.	T	C	11	6	17	0	0	17	0	0
16	10635551	.	A	C	8	9	17	0	2	19	0	0
16	10635838	.	T	C	6	8	14	0	2	16	0	0
16	10635942	.	A	G	5	9	14	0	0	14	0	0
16	10636168	.	C	T	9	11	20	0	0	20	0	0
16	10636241	.	T	G	1	8	9	0	1	10	0	0
16	10636252	.	A	T	1	6	7	0	0	7	0	0
16	10636418	.	T	C	4	3	7	0	0	7	0	0
16	10636698	.	T	A	9	6	15	0	0	15	0	0
16	10636882	.	C	T	10	7	17	0	1	18	0	0
16	10637192	.	G	A	2	12	14	0	8	22	0	0
16	10637259	.	A	G	13	13	26	0	1	27	0	0
16	10637329	.	C	A	10	12	22	0	0	22	0	0
16	10637379	.	T	A	14	9	23	0	1	24	0	0
16	10637705	.	A	C	5	2	7	1	0	8	0	0
16	10731333	.	C	T	7	5	12	0	0	12	0	0
16	10731388	.	G	C	4	5	9	0	0	9	0	0
16	10731571	.	A	T	5	7	12	0	0	12	0	0
16	10731648	.	T	C	6	2	8	0	4	12	0	0
16	10731717	.	C	G	6	3	9	0	0	9	0	0
16	10731819	.	T	G	1	4	5	0	0	5	0	0
16	10731968	.	A	C	1	2	3	0	0	3	0	0
16	10732051	.	A	G	2	0	2	0	3	5	0	0
16	10732053	.	A	T	2	3	5	0	0	5	0	0
16	10732140	.	G	A	4	4	8	0	0	8	0	0
16	10733662	.	A	G	4	3	7	0	0	7	0	0
16	10733751	.	A	G	3	4	7	0	0	7	0	0
16	10733829	.	G	C	2	4	6	0	1	7	0	0
16	10734032	.	A	C	5	3	8	0	1	9	0	0
16	10734190	.	T	C	3	4	7	1	1	9	0	0
16	10776922	.	A	C	37	22	59	0	0	59	0	0
16	10777025	.	G	A	10	5	15	0	0	15	0	0
16	10795647	.	T	C	35	27	62	0	3	65	0	0
16	10798995	.	A	T	26	33	59	0	4	63	0	0
16	10799155	.	T	C	31	27	58	0	3	61	0	0
16	10801127	.	T	C	36	27	63	1	3	67	0	0
16	10801517	.	T	C	31	36	67	0	1	68	0	0
16	10801682	.	C	T	36	22	58	0	3	61	0	0
16	10801772	.	C	T	32	25	57	1	1	59	0	0
16	10804843	.	T	C	29	34	63	0	2	65	0	0
16	10804862	.	A	T	31	34	65	0	2	67	0	0
16	10804878	.	C	T	29	33	62	0	1	63	0	0
16	10807360	.	T	A	30	28	58	0	2	60	0	0
16	10807486	.	C	T	37	34	71	0	1	72	0	0
16	10813138	.	A	C	47	41	88	0	1	89	0	0
16	10813372	.	C	T	44	35	79	0	2	81	0	0
16	10815877	.	T	C	47	29	76	0	2	78	0	0
16	10820157	.	G	A	6	28	34	1	41	76	0	0
16	10820215	.	A	T	39	30	69	0	3	72	0	0
16	10820224	.	T	A	39	32	71	0	2	73	0	0
16	10820803	.	C	T	33	26	59	1	11	71	0	0
16	10820866	.	A	G	15	15	30	0	3	33	0	0
16	10829458	.	T	C	16	0	16	0	10	26	0	0
16	10829569	.	A	T	17	6	23	1	1	25	0	0
16	10829633	.	A	T	14	8	22	0	0	22	0	0
16	10829635	.	A	C	12	7	19	0	2	21	0	0
16	10829703	.	T	C	6	3	9	0	4	13	0	0
16	10829968	.	T	G	18	7	25	0	1	26	0	0
16	10830013	.	T	G	14	5	19	0	1	20	0	0
16	10830145	.	T	G	10	9	19	0	0	19	0	0
16	10830147	.	T	A	9	9	18	0	0	18	0	0
16	10830309	.	T	A	10	3	13	0	0	13	0	0
16	10830625	.	G	C	12	8	20	0	0	20	0	0
16	10832217	.	C	T	8	7	15	0	0	15	0	0
16	10833900	.	C	G	5	6	11	0	0	11	0	0
16	10833987	.	G	A	13	8	21	0	1	22	0	0
16	10841193	.	T	C	14	7	21	0	0	21	0	0
16	10841612	.	T	C	11	5	16	0	2	18	0	0
16	10843402	.	A	G	14	0	14	0	10	24	0	0
16	10846654	.	A	G	25	11	36	0	0	36	0	0
16	10855924	.	A	G	9	8	17	0	4	21	0	0
16	10856130	.	A	G	14	7	21	0	0	21	0	0
16	10856235	.	C	G	11	9	20	0	1	21	0	0
16	10856406	.	A	T	5	4	9	0	1	10	0	0
16	10858656	.	A	G	10	11	21	0	1	22	0	0
16	10859434	.	C	T	25	18	43	0	2	45	0	0
16	10859435	.	T	C	26	18	44	0	1	45	0	0
16	10859857	.	T	C	24	16	40	0	2	42	0	0
16	10861956	.	A	G	21	14	35	0	2	37	0	0
16	10861971	.	T	A	21	12	33	0	0	33	0	0
16	10862331	.	C	G	16	5	21	0	2	23	0	0
16	10862627	.	G	A	4	17	21	1	25	47	0	0
16	10862762	.	C	T	21	14	35	0	0	35	0	0
16	10862773	.	T	C	21	13	34	0	1	35	0	0
16	10919019	.	G	A	2	2	4	0	0	4	0	0
16	10919104	.	A	G	5	1	6	0	3	9	0	0
16	10919317	.	C	T	3	5	8	0	3	11	0	0
16	10919482	.	C	A	2	4	6	0	0	6	0	0
16	10972092	.	A	G	2	4	6	0	1	7	0	0
16	10979825	.	C	A	3	2	5	0	0	5	0	0
16	10979967	.	C	G	2	0	2	0	2	4	0	0
16	10987970	.	A	C	7	3	10	0	1	11	0	0
16	10988366	.	T	C	3	3	6	0	0	6	0	0
16	10989286	.	A	G	3	0	3	0	3	6	0	0
16	10989287	.	C	T	3	3	6	0	0	6	0	0
16	10989372	.	T	C	3	2	5	0	0	5	0	0
16	10990445	.	T	A	3	3	6	0	0	6	0	0
16	10990578	.	A	T	2	6	8	0	0	8	0	0
16	10990633	.	A	G	2	3	5	0	1	6	0	0
16	10990915	.	T	A	3	3	6	0	0	7	1	0
16	10990940	.	C	A	9	6	15	0	0	15	0	0
16	11029931	.	G	C	3	2	5	0	0	5	0	0
16	11030141	.	C	A	2	4	6	0	0	6	0	0
16	11134774	.	T	G	3	4	7	0	1	8	0	0
16	11134959	.	G	C	4	7	11	0	1	12	0	0
16	11134962	.	T	C	5	6	11	0	0	11	0	0
16	11135511	.	C	T	5	11	16	0	0	16	0	0
16	11135814	.	T	C	3	4	7	0	0	7	0	0
16	11135820	.	G	A	4	4	8	0	0	8	0	0
16	11135904	.	G	A	8	6	14	0	0	14	0	0
16	11137612	.	C	A	1	8	9	0	2	11	0	0
16	11137720	.	G	A	13	2	15	0	1	16	0	0
16	11137738	.	T	C	10	5	15	0	0	15	0	0
16	11137873	.	T	C	4	7	11	0	0	11	0	0
16	11137912	.	A	G	3	0	3	0	12	15	0	0
16	11138021	.	C	T	9	11	20	0	1	21	0	0
16	11138081	.	C	T	7	8	15	0	0	15	0	0
16	11139022	.	C	T	5	7	12	0	0	12	0	0
16	11139031	.	A	C	4	4	8	0	2	10	0	0
16	11139076	.	T	A	2	4	6	0	0	6	0	0
16	11140004	.	G	A	8	9	17	0	0	17	0	0
16	11140095	.	A	C	2	0	2	0	2	7	3	0
16	11140248	.	T	C	6	5	11	0	1	12	0	0
16	11140569	.	A	G	7	5	12	0	1	13	0	0
16	11140820	.	G	C	6	3	9	0	0	9	0	0
16	11140894	.	A	G	8	4	12	0	1	13	0	0
16	11140933	.	A	T	10	4	14	0	1	15	0	0
16	11140993	.	A	G	1	3	4	0	1	5	0	0
16	11141200	.	C	T	8	3	11	0	0	11	0	0
16	11141430	.	G	A	5	4	9	0	0	9	0	0
16	11141776	.	C	G	8	4	12	0	1	13	0	0
16	11141836	.	G	A	12	6	18	0	0	18	0	0
16	11141908	.	G	A	1	4	5	0	4	9	0	0
16	11142032	.	A	T	8	5	13	0	0	13	0	0
16	11142428	.	A	G	7	5	12	0	0	12	0	0
16	11142451	.	A	C	7	3	10	0	0	10	0	0
16	11166806	.	C	T	9	5	14	0	0	14	0	0
16	11166851	.	G	A	15	7	22	0	0	22	0	0
16	11166857	.	A	T	14	10	24	0	0	24	0	0
16	11166908	.	G	A	8	12	20	0	1	21	0	0
16	11167260	.	C	T	6	7	13	0	0	13	0	0
16	11167436	.	G	A	7	5	12	0	0	12	0	0
16	11167461	.	G	A	8	4	12	0	0	12	0	0
16	11167512	.	A	G	7	0	7	0	10	17	0	0
16	11167586	.	T	G	4	5	9	0	0	9	0	0
16	11167908	.	T	C	10	8	18	0	0	18	0	0
16	11168205	.	A	G	12	9	21	0	1	22	0	0
16	11168817	.	A	C	8	14	22	0	1	23	0	0
16	11168831	.	T	C	8	15	23	0	2	25	0	0
16	11168922	.	T	A	10	7	17	0	0	17	0	0
16	11169325	.	C	A	10	13	23	0	0	23	0	0
16	11169438	.	C	A	12	12	24	0	1	25	0	0
16	11169447	.	A	G	12	14	26	0	0	26	0	0
16	11169843	.	T	A	17	8	25	0	1	26	0	0
16	11170152	.	C	G	11	10	21	0	0	21	0	0
16	11170202	.	C	T	13	9	22	0	0	22	0	0
16	11170334	.	C	T	7	6	13	0	1	14	0	0
16	11189286	.	A	G	12	1	13	0	23	36	0	0
16	11190369	.	G	A	2	15	17	0	17	34	0	0
16	11193643	.	A	G	14	21	35	1	4	40	0	0
16	11193652	.	A	G	13	0	13	1	25	39	0	0
16	11199190	.	A	G	12	0	12	0	15	27	0	0
16	11199293	.	T	C	18	25	43	0	1	44	0	0
16	11199460	.	G	A	3	17	20	0	28	48	0	0
16	11199533	.	C	T	25	25	50	0	2	52	0	0
16	11206313	.	A	C	25	19	44	0	3	47	0	0
16	11206316	.	C	T	28	18	46	0	1	47	0	0
16	11212111	.	C	A	28	25	53	0	4	57	0	0
16	11212260	.	C	A	20	12	32	0	0	32	0	0
16	11212438	.	A	G	22	0	22	0	20	42	0	0
16	11215022	.	G	T	15	13	28	0	0	28	0	0
16	11215162	.	T	C	20	21	41	0	1	42	0	0
16	11215163	.	T	C	20	21	41	0	1	42	0	0
16	11215504	.	C	T	25	20	45	0	5	50	0	0
16	11221153	.	A	C	17	22	39	0	0	39	0	0
16	11221667	.	A	G	17	15	32	0	0	32	0	0
16	11222031	.	T	A	18	9	27	1	4	32	0	0
16	11222139	.	G	A	15	19	34	0	1	35	0	0
16	11222738	.	G	A	0	15	15	0	14	29	0	0
16	11227526	.	T	G	5	6	11	0	0	11	0	0
16	11227537	.	G	A	6	5	11	0	0	11	0	0
16	11227611	.	G	A	3	3	6	0	0	6	0	0
16	11228358	.	C	A	0	5	5	0	8	13	0	0
16	11228424	.	G	A	5	5	10	0	0	10	0	0
16	11229095	.	A	G	5	4	9	0	0	9	0	0
16	11229458	.	C	T	1	3	4	0	0	4	0	0
16	11229499	.	C	T	2	3	5	0	0	5	0	0
16	11229594	.	T	C	2	2	4	0	0	4	0	0
16	11229689	.	C	T	4	3	7	0	0	7	0	0
16	11231348	.	G	A	3	3	6	0	0	6	0	0
16	11231621	.	T	A	4	5	9	0	0	9	0	0
16	11231644	.	C	A	5	7	12	0	0	12	0	0
16	11235636	.	A	G	2	2	4	0	1	5	0	0
16	11235640	.	G	A	2	2	4	0	1	5	0	0
16	11241078	.	A	G	5	2	7	0	0	7	0	0
16	11266016	.	T	G	14	17	31	0	1	32	0	0
16	11276019	.	A	T	22	26	48	0	0	48	0	0
16	11290903	.	T	A	12	10	22	0	0	22	0	0
16	11290975	.	A	C	7	16	23	0	0	23	0	0
16	11291799	.	T	C	16	15	31	0	1	32	0	0
16	11291803	.	G	A	16	12	28	0	2	30	0	0
16	11313462	.	A	G	1	7	8	0	0	8	0	0
16	11313588	.	T	C	4	2	6	0	0	6	0	0
16	11313612	.	C	T	4	3	7	0	0	7	0	0
16	11314570	.	T	C	3	4	7	0	0	7	0	0
16	11318376	.	G	A	1	2	3	0	1	4	0	0
16	11344446	.	G	A	0	2	2	0	2	4	0	0
16	11344457	.	T	C	2	3	5	0	0	5	0	0
16	11483951	.	C	T	6	3	9	0	0	9	0	0
16	11486258	.	G	A	0	2	2	0	7	9	0	0
16	11486381	.	G	A	4	10	14	0	1	15	0	0
16	11506075	.	C	T	6	5	11	0	1	12	0	0
16	11506128	.	G	A	0	6	6	0	9	15	0	0
16	11530746	.	T	G	6	10	16	0	0	16	0	0
16	11531018	.	A	G	11	6	17	0	0	17	0	0
16	11533864	.	T	C	7	8	15	0	1	16	0	0
16	11773932	.	T	C	9	0	9	0	8	17	0	0
16	11774345	.	G	A	16	8	24	0	1	25	0	0
16	11774355	.	C	T	1	8	9	0	15	24	0	0
16	11774398	.	T	C	12	7	19	0	1	20	0	0
16	11774456	.	G	A	7	9	16	0	0	16	0	0
16	11774532	.	T	C	2	7	9	0	0	9	0	0
16	11774948	.	T	A	15	13	28	0	2	30	0	0
16	11775084	.	G	A	8	2	10	0	3	14	1	0
16	11775085	.	G	A	11	2	13	0	1	14	0	0
16	11775200	.	A	G	8	13	21	0	1	22	0	0
16	11775279	.	T	C	10	8	18	0	0	18	0	0
16	11775485	.	G	A	14	10	24	0	0	24	0	0
16	11775683	.	T	C	14	22	36	0	0	36	0	0
16	11778275	.	C	T	1	10	11	0	13	24	0	0
16	11778542	.	A	G	8	7	15	0	1	16	0	0
16	11965486	.	T	C	1	2	3	0	0	3	0	0
16	11974658	.	G	A	15	19	34	0	1	35	0	0
16	11974703	.	G	A	14	12	26	0	0	26	0	0
16	11978028	.	A	G	17	14	31	0	0	31	0	0
16	11978045	.	G	A	19	17	36	0	1	37	0	0
16	11978094	.	A	C	20	16	36	0	0	36	0	0
16	11979590	.	T	C	15	11	26	0	0	26	0	0
16	11982269	.	G	A	21	13	34	0	0	34	0	0
16	11982323	.	G	A	16	15	31	0	1	32	0	0
16	11982507	.	T	A	24	17	41	0	0	41	0	0
16	11985606	.	C	T	13	9	22	0	1	23	0	0
16	12006561	.	T	C	1	2	3	0	0	3	0	0
16	12060324	.	C	T	0	2	2	0	2	4	0	0
16	12065410	.	A	G	18	11	29	1	1	31	0	0
16	12073577	.	G	A	12	8	20	0	1	21	0	0
16	12076492	.	A	G	12	12	24	0	0	24	0	0
16	12078916	.	A	G	13	8	21	0	0	21	0	0
16	12078976	.	C	T	13	7	20	0	0	20	0	0
16	12078982	.	C	T	12	6	18	0	0	18	0	0
16	12083632	.	A	G	2	4	6	0	0	6	0	0
16	12092428	.	A	G	9	9	18	0	0	18	0	0
16	12095043	.	G	A	6	4	10	0	0	10	0	0
16	12095103	.	T	C	6	6	12	0	0	12	0	0
16	12097241	.	T	C	6	7	13	0	0	13	0	0
16	12097292	.	G	T	6	11	17	0	0	17	0	0
16	12102947	.	C	A	29	25	54	0	0	54	0	0
16	12103263	.	A	T	29	34	63	0	2	65	0	0
16	12103292	.	A	T	29	29	58	0	2	61	1	0
16	12103344	.	A	G	28	30	58	0	1	59	0	0
16	12103421	.	T	A	27	31	58	0	1	59	0	0
16	12103530	.	G	A	32	24	56	0	3	59	0	0
16	12103873	.	C	T	4	35	39	0	31	70	0	0
16	12103881	.	G	A	34	32	66	0	0	66	0	0
16	12103934	.	C	T	27	36	63	0	2	65	0	0
16	12103941	.	A	G	25	35	60	0	2	62	0	0
16	12104042	.	C	T	32	31	63	0	2	65	0	0
16	12104043	.	A	T	32	31	63	0	1	64	0	0
16	12104083	.	C	T	34	33	67	3	3	73	0	0
16	12104231	.	C	G	26	22	48	0	2	50	0	0
16	12104350	.	T	C	26	24	50	1	2	53	0	0
16	12104384	.	C	T	32	24	56	1	0	57	0	0
16	12104388	.	T	C	27	21	48	1	6	55	0	0
16	12104509	.	G	A	24	26	50	6	4	60	0	0
16	12104601	.	G	A	37	22	59	1	1	61	0	0
16	12104665	.	A	G	37	23	60	4	3	67	0	0
16	12104794	.	C	T	24	12	36	3	1	40	0	0
16	12104813	.	A	T	34	8	42	1	5	48	0	0
16	12104943	.	A	T	36	15	51	0	0	51	0	0
16	12104944	.	T	G	35	14	49	0	2	51	0	0
16	12105196	.	C	A	32	13	45	0	2	47	0	0
16	12105206	.	A	G	32	17	49	0	1	50	0	0
16	12105443	.	A	T	11	6	17	2	0	19	0	0
16	12105689	.	C	T	3	29	32	0	18	50	0	0
16	12105796	.	C	T	6	30	36	0	24	60	0	0
16	12105854	.	A	G	38	25	63	0	0	63	0	0
16	12108607	.	G	A	26	27	53	0	1	54	0	0
16	12108622	.	A	G	31	27	58	0	2	60	0	0
16	12114975	.	G	A	31	30	61	0	2	63	0	0
16	12118207	.	G	A	25	23	48	0	2	50	0	0
16	12118210	.	C	T	28	23	51	0	2	53	0	0
16	12126930	.	C	G	1	19	20	0	25	46	1	0
16	12135754	.	G	A	21	21	42	0	2	44	0	0
16	12138940	.	A	G	31	26	57	0	1	58	0	0
16	12138964	.	G	T	30	31	61	0	4	65	0	0
16	12138991	.	T	C	28	1	29	0	33	62	0	0
16	12150403	.	A	G	23	23	46	0	0	46	0	0
16	12150415	.	T	C	27	0	27	0	20	47	0	0
16	12150457	.	A	G	23	24	47	0	1	48	0	0
16	12150460	.	C	T	23	23	46	0	2	48	0	0
16	12162370	.	A	C	17	0	17	0	25	42	0	0
16	12173361	.	G	C	15	18	33	0	0	33	0	0
16	12173406	.	A	G	21	13	34	0	4	38	0	0
16	12174949	.	G	T	3	3	6	0	0	6	0	0
16	12175007	.	A	T	1	4	5	0	0	5	0	0
16	12175281	.	G	A	5	4	9	0	0	9	0	0
16	12185322	.	C	A	1	5	6	0	2	8	0	0
16	12243571	.	C	T	33	27	60	0	4	64	0	0
16	12245691	.	G	A	35	24	59	0	9	68	0	0
16	12245760	.	T	C	35	32	67	0	2	69	0	0
16	12245954	.	C	T	28	34	62	0	6	68	0	0
16	12259023	.	T	C	20	18	38	0	4	42	0	0
16	12259072	.	C	T	19	17	36	0	1	37	0	0
16	12263047	.	C	T	2	25	27	0	15	42	0	0
16	12263223	.	A	G	22	24	46	0	0	46	0	0
16	12263358	.	C	T	0	31	31	0	23	54	0	0
16	12263385	.	G	A	10	25	35	0	5	40	0	0
16	12264912	.	A	T	26	19	45	0	2	47	0	0
16	12264999	.	T	C	19	1	20	0	17	37	0	0
16	12265237	.	A	G	14	17	31	0	1	32	0	0
16	12266130	.	C	A	0	12	12	0	10	22	0	0
16	12266137	.	A	T	9	11	20	0	0	20	0	0
16	12273636	.	G	A	3	16	19	0	30	49	0	0
16	12273653	.	A	G	32	14	46	0	0	46	0	0
16	12286460	.	A	T	9	4	13	0	0	13	0	0
16	12294273	.	G	A	9	3	12	0	1	13	0	0
16	12335406	.	C	T	0	2	2	0	4	6	0	0
16	12346071	.	G	A	4	2	6	0	1	7	0	0
16	12347591	.	A	G	3	3	6	0	0	6	0	0
16	12347703	.	T	C	1	0	1	0	3	4	0	0
16	12356458	.	G	A	4	2	6	0	0	6	0	0
16	12356494	.	T	C	3	2	5	0	0	5	0	0
16	12367100	.	A	G	3	4	7	0	0	7	0	0
16	12367103	.	G	A	2	4	6	0	1	7	0	0
16	12477825	.	G	A	2	2	4	0	0	4	0	0
16	12477853	.	G	T	3	2	5	0	0	5	0	0
16	12478239	.	C	T	4	2	6	0	0	6	0	0
16	12478240	.	C	T	4	2	6	0	0	6	0	0
16	12478550	.	G	A	3	4	7	0	0	7	0	0
16	12478565	.	G	A	2	2	4	0	0	4	0	0
16	12478727	.	G	A	3	4	7	0	0	7	0	0
16	12478772	.	T	C	4	0	4	0	5	9	0	0
16	12478856	.	G	A	1	5	6	0	0	6	0	0
16	12632593	.	G	C	8	5	13	0	0	13	0	0
16	12632664	.	T	C	9	5	14	0	0	14	0	0
16	12636347	.	T	C	10	7	17	0	1	18	0	0
16	12636546	.	T	C	6	6	12	0	0	12	0	0
16	12637271	.	G	A	6	6	12	0	0	12	0	0
16	12637284	.	T	C	6	4	10	0	0	10	0	0
16	12637503	.	A	G	6	3	9	0	1	10	0	0
16	12637504	.	A	G	5	4	9	0	1	10	0	0
16	12637552	.	A	T	4	6	10	0	0	11	1	0
16	12637681	.	T	G	3	4	7	0	2	9	0	0
16	12637779	.	C	T	15	9	24	0	0	24	0	0
16	12637822	.	T	C	12	6	18	0	0	18	0	0
16	12637824	.	G	A	0	6	6	0	11	17	0	0
16	12638502	.	C	T	2	2	4	0	0	4	0	0
16	12638527	.	C	A	3	4	7	0	0	7	0	0
16	12638612	.	C	G	6	2	8	0	0	8	0	0
16	12638622	.	A	G	6	2	8	0	0	8	0	0
16	12639125	.	A	T	6	6	12	1	1	14	0	0
16	12639184	.	C	G	8	9	17	1	0	18	0	0
16	12639285	.	T	A	4	5	9	0	3	13	1	0
16	12639291	.	C	T	7	7	14	0	1	15	0	0
16	12639320	.	C	G	7	8	15	0	0	15	0	0
16	12639488	.	G	A	6	5	11	0	0	11	0	0
16	12674720	.	A	G	1	6	7	1	0	8	0	0
16	12730380	.	A	G	14	7	21	0	0	21	0	0
16	12730412	.	G	A	23	13	36	0	1	37	0	0
16	12730707	.	A	G	7	10	17	0	2	19	0	0
16	12738324	.	G	A	13	7	20	0	1	21	0	0
16	12743927	.	G	A	1	13	14	0	8	22	0	0
16	12744270	.	T	C	1	2	3	0	0	3	0	0
16	12748058	.	A	G	4	1	5	0	23	28	0	0
16	12748568	.	T	C	16	12	28	0	4	32	0	0
16	12748944	.	A	G	28	8	36	0	1	37	0	0
16	12754621	.	A	G	17	0	17	0	23	40	0	0
16	12754849	.	T	C	21	18	39	0	2	41	0	0
16	12754858	.	G	T	2	19	21	0	19	40	0	0
16	12755011	.	G	A	21	17	38	0	1	39	0	0
16	12756051	.	G	T	20	12	32	0	1	33	0	0
16	12764143	.	T	A	2	3	5	0	1	6	0	0
16	12764221	.	G	A	3	2	5	0	0	5	0	0
16	12773492	.	G	A	3	2	5	0	0	5	0	0
16	12794028	.	A	G	5	5	10	0	0	10	0	0
16	12794075	.	C	G	4	4	8	0	2	10	0	0
16	12807129	.	C	G	2	7	9	0	0	9	0	0
16	12812496	.	T	C	4	4	8	0	0	8	0	0
16	12816160	.	A	G	12	12	24	0	0	24	0	0
16	12816745	.	A	C	11	13	24	0	0	24	0	0
16	12816975	.	G	A	6	16	22	0	0	22	0	0
16	12821106	.	C	T	12	22	34	0	2	36	0	0
16	12821221	.	G	A	19	10	29	0	3	32	0	0
16	12821370	.	A	T	14	10	24	0	0	24	0	0
16	12821371	.	G	A	14	10	24	0	0	24	0	0
16	12821497	.	T	C	20	18	38	0	0	38	0	0
16	12821620	.	T	C	10	3	13	0	2	15	0	0
16	12882543	.	A	G	21	24	45	0	1	46	0	0
16	12882612	.	C	T	1	21	22	1	22	45	0	0
16	12883126	.	G	A	25	19	44	1	2	47	0	0
16	12883484	.	G	C	12	15	27	0	1	28	0	0
16	12883618	.	C	T	16	18	34	0	1	35	0	0
16	12884054	.	A	T	24	19	43	0	1	45	1	0
16	12884510	.	A	T	8	22	30	0	1	31	0	0
16	12963109	.	A	G	5	3	8	0	0	8	0	0
16	12963274	.	A	T	9	6	15	0	0	15	0	0
16	12963368	.	G	A	12	8	20	0	0	20	0	0
16	12963384	.	C	T	1	9	10	0	13	23	0	0
16	12963405	.	A	G	18	8	26	0	0	26	0	0
16	12963696	.	T	G	20	26	46	0	5	51	0	0
16	12967855	.	G	A	15	16	31	0	0	31	0	0
16	12981637	.	G	A	16	12	28	0	2	30	0	0
16	12984488	.	C	G	19	14	33	0	0	33	0	0
16	13023601	.	A	G	6	4	10	0	0	10	0	0
16	13033243	.	G	A	2	4	6	0	0	6	0	0
16	13109726	.	T	C	1	7	8	0	0	8	0	0
16	13180389	.	T	C	1	5	6	0	0	6	0	0
16	13281423	.	A	C	2	3	5	0	0	5	0	0
16	13307711	.	G	A	3	3	6	0	0	6	0	0
16	13307840	.	C	T	0	2	2	0	2	4	0	0
16	13568966	.	T	C	2	0	2	0	3	5	0	0
16	13569205	.	A	T	1	3	4	0	0	4	0	0
16	13569232	.	C	T	1	4	5	0	2	7	0	0
16	13599957	.	G	A	9	10	19	0	2	21	0	0
16	13600680	.	A	C	16	16	32	1	0	33	0	0
16	13601026	.	T	C	9	15	24	0	0	24	0	0
16	13601254	.	G	C	4	6	10	0	0	10	0	0
16	13601961	.	T	A	8	16	24	0	0	24	0	0
16	13601965	.	G	A	8	17	25	0	0	25	0	0
16	13602164	.	T	C	12	9	21	0	1	22	0	0
16	13602454	.	T	A	11	10	21	0	1	22	0	0
16	13602488	.	T	C	7	10	17	0	0	17	0	0
16	13602697	.	A	G	14	6	20	0	1	21	0	0
16	13602800	.	T	A	13	11	24	0	0	24	0	0
16	13602922	.	A	G	6	5	11	0	0	11	0	0
16	13603375	.	C	T	15	13	28	0	0	28	0	0
16	13606896	.	A	T	7	11	18	0	0	18	0	0
16	13606977	.	G	A	10	11	21	0	1	22	0	0
16	13610726	.	T	A	20	16	36	0	5	41	0	0
16	13610882	.	G	A	16	16	32	0	1	33	0	0
16	13610966	.	A	G	18	13	31	0	0	31	0	0
16	13611035	.	G	A	16	15	31	0	2	33	0	0
16	13612999	.	T	A	12	16	28	0	1	29	0	0
16	13613104	.	T	C	7	10	17	0	0	17	0	0
16	13617023	.	C	T	1	9	10	0	12	22	0	0
16	13617152	.	C	T	8	8	16	0	0	16	0	0
16	13617291	.	G	A	13	7	20	0	0	20	0	0
16	13617329	.	T	G	10	8	18	0	0	18	0	0
16	13617767	.	G	T	4	3	7	0	0	7	0	0
16	13618170	.	A	G	14	10	24	1	1	26	0	0
16	13618172	.	C	G	11	14	25	1	1	27	0	0
16	13618374	.	A	T	11	17	28	0	1	29	0	0
16	13618644	.	T	A	15	12	27	0	0	27	0	0
16	13619319	.	T	A	7	8	15	0	0	15	0	0
16	13619436	.	A	G	15	8	23	0	2	25	0	0
16	13619448	.	T	C	12	7	19	0	4	23	0	0
16	13619509	.	G	T	5	17	22	0	0	22	0	0
16	13620333	.	C	T	3	5	8	0	0	8	0	0
16	13621056	.	G	A	5	5	10	0	1	11	0	0
16	13621605	.	A	G	9	9	18	0	1	19	0	0
16	13621752	.	G	A	6	7	13	0	0	13	0	0
16	13622643	.	A	T	3	5	8	0	0	8	0	0
16	13623641	.	A	C	2	2	4	0	0	4	0	0
16	13636760	.	G	A	24	30	54	0	0	54	0	0
16	13643969	.	C	A	23	13	36	0	0	36	0	0
16	13644509	.	A	T	19	23	42	0	2	44	0	0
16	13644781	.	T	A	15	8	23	0	2	25	0	0
16	13645076	.	A	T	18	15	33	0	2	35	0	0
16	13645242	.	G	C	17	15	32	0	1	33	0	0
16	13645318	.	T	G	21	13	34	0	1	35	0	0
16	13645419	.	T	A	11	11	22	0	0	22	0	0
16	13645610	.	T	C	13	0	13	4	15	32	0	0
16	13673143	.	T	C	5	5	10	0	3	13	0	0
16	13673660	.	T	A	2	2	4	0	0	4	0	0
16	13673734	.	A	C	5	3	8	0	0	8	0	0
16	13679037	.	A	G	3	4	7	0	0	7	0	0
16	13680290	.	G	T	1	3	4	0	0	4	0	0
16	13680357	.	T	G	3	3	6	0	0	6	0	0
16	13680585	.	A	G	2	9	11	0	1	12	0	0
16	13701482	.	C	T	14	16	30	0	0	30	0	0
16	13701599	.	A	G	3	10	13	0	1	14	0	0
16	13706061	.	G	A	8	6	14	1	1	16	0	0
16	13706207	.	G	C	6	11	17	0	1	18	0	0
16	13706714	.	G	T	4	2	6	0	0	6	0	0
16	13721408	.	C	T	17	10	27	0	0	27	0	0
16	13721420	.	G	A	11	12	23	0	0	23	0	0
16	13729810	.	C	T	19	12	31	0	2	33	0	0
16	13741584	.	C	T	13	14	27	0	1	28	0	0
16	13743117	.	T	C	10	1	11	1	13	25	0	0
16	13743198	.	G	T	18	16	34	0	2	36	0	0
16	13743327	.	C	T	2	17	19	0	11	30	0	0
16	13743345	.	T	C	10	16	26	0	1	27	0	0
16	13743405	.	G	T	7	15	22	0	2	24	0	0
16	13780375	.	G	A	15	15	30	1	0	31	0	0
16	13780415	.	T	A	17	18	35	1	1	37	0	0
16	13789765	.	G	A	16	16	32	0	0	32	0	0
16	13810372	.	G	A	1	2	3	0	0	3	0	0
16	13810636	.	T	A	1	4	5	0	0	5	0	0
16	13818640	.	T	A	5	2	7	0	0	7	0	0
16	13818644	.	G	A	5	2	7	0	0	7	0	0
16	13819008	.	T	C	2	4	6	0	0	6	0	0
16	13826195	.	C	T	5	11	16	0	0	16	0	0
16	13841360	.	T	A	9	8	17	0	0	17	0	0
16	13845368	.	G	A	3	10	13	0	12	25	0	0
16	13845846	.	A	G	8	4	12	0	0	12	0	0
16	13855142	.	T	C	21	17	38	0	0	38	0	0
16	13855472	.	T	C	12	12	24	0	3	27	0	0
16	13855482	.	T	A	12	14	26	0	0	26	0	0
16	13856554	.	T	C	1	3	4	0	0	4	0	0
16	13870508	.	A	C	11	8	19	0	0	19	0	0
16	13870517	.	A	G	8	9	17	0	0	17	0	0
16	13870685	.	A	C	4	5	9	0	0	9	0	0
16	13870857	.	T	A	5	5	10	0	1	11	0	0
16	13875934	.	A	T	2	4	6	0	0	6	0	0
16	13875968	.	G	A	3	4	7	0	0	7	0	0
16	13876657	.	T	A	1	2	3	0	0	3	0	0
16	13877174	.	T	C	1	2	3	0	0	3	0	0
16	13881078	.	T	C	1	6	7	0	0	7	0	0
16	13883980	.	A	C	17	5	22	0	1	23	0	0
16	14010794	.	C	T	5	7	12	0	1	13	0	0
16	14016057	.	T	C	8	6	14	0	0	14	0	0
16	14021817	.	G	T	6	15	21	0	1	22	0	0
16	14021886	.	C	T	13	9	22	0	1	23	0	0
16	14021907	.	T	A	13	11	24	0	1	25	0	0
16	14022035	.	A	C	12	12	24	0	1	25	0	0
16	14022445	.	T	C	9	9	18	0	2	20	0	0
16	14022585	.	C	A	2	8	10	0	1	11	0	0
16	14022697	.	T	A	9	4	13	0	0	13	0	0
16	14022765	.	G	T	4	2	6	0	0	6	0	0
16	14022766	.	T	A	5	2	7	0	0	7	0	0
16	14022975	.	G	T	1	4	5	0	1	6	0	0
16	14022976	.	T	A	1	4	5	0	1	6	0	0
16	14029359	.	A	C	14	15	29	0	1	30	0	0
16	14039604	.	T	C	17	11	28	0	0	28	0	0
16	14039616	.	A	C	14	13	27	0	0	27	0	0
16	14051150	.	G	C	20	23	43	0	2	45	0	0
16	14051249	.	T	C	22	18	40	0	5	45	0	0
16	14051329	.	A	T	21	22	43	0	2	45	0	0
16	14051339	.	A	C	21	20	41	0	5	46	0	0
16	14052681	.	A	G	21	23	44	0	3	47	0	0
16	14055071	.	A	T	7	8	15	0	0	15	0	0
16	14094219	.	A	G	8	3	11	0	0	11	0	0
16	14094222	.	C	A	8	3	11	0	0	11	0	0
16	14094364	.	A	C	5	4	9	0	1	10	0	0
16	14094422	.	C	G	11	9	20	0	1	22	1	0
16	14094601	.	G	A	11	14	25	0	0	25	0	0
16	14094604	.	T	A	11	13	24	0	0	24	0	0
16	14094640	.	G	T	11	8	19	0	0	19	0	0
16	14094668	.	T	A	9	4	13	0	1	14	0	0
16	14094801	.	C	T	15	3	18	0	2	20	0	0
16	14094806	.	G	A	20	4	24	0	0	24	0	0
16	14095097	.	C	T	0	4	4	0	6	10	0	0
16	14095126	.	T	A	9	4	13	1	0	14	0	0
16	14095176	.	A	T	12	4	16	0	0	16	0	0
16	14095183	.	G	C	11	3	14	0	0	14	0	0
16	14095279	.	C	A	11	10	21	1	0	22	0	0
16	14095397	.	A	C	19	12	31	0	1	32	0	0
16	14095563	.	A	C	15	0	15	0	8	23	0	0
16	14098014	.	C	T	14	12	26	0	1	27	0	0
16	14101832	.	G	A	10	12	22	0	0	22	0	0
16	14101864	.	T	C	9	13	22	0	4	26	0	0
16	14126267	.	C	T	15	19	34	0	0	34	0	0
16	14126294	.	T	C	9	18	27	0	5	32	0	0
16	14133317	.	G	A	15	13	28	0	3	31	0	0
16	14133521	.	G	A	18	10	28	0	1	29	0	0
16	14133547	.	G	T	12	11	23	0	2	25	0	0
16	14133721	.	C	T	9	13	22	1	2	25	0	0
16	14133734	.	A	C	14	12	26	1	0	27	0	0
16	14133874	.	C	T	7	10	17	0	0	17	0	0
16	14133910	.	C	G	5	8	13	0	2	15	0	0
16	14134020	.	C	T	0	13	13	0	9	22	0	0
16	14134116	.	A	T	14	10	24	0	1	25	0	0
16	14154105	.	A	G	6	10	16	0	0	16	0	0
16	14154150	.	T	G	7	7	14	0	2	16	0	0
16	14154240	.	T	A	9	11	20	0	0	20	0	0
16	14154324	.	T	C	15	0	15	0	13	28	0	0
16	14154708	.	G	A	12	7	19	0	1	20	0	0
16	14155364	.	T	C	15	9	24	0	0	24	0	0
16	14155605	.	T	A	9	14	23	0	1	24	0	0
16	14155997	.	A	T	6	10	16	0	0	16	0	0
16	14156157	.	T	C	5	6	11	0	2	13	0	0
16	14156177	.	G	A	4	9	13	0	0	13	0	0
16	14156518	.	T	A	4	3	7	0	0	7	0	0
16	14156775	.	C	A	1	9	10	0	3	13	0	0
16	14156865	.	A	G	2	5	7	0	0	7	0	0
16	14157055	.	C	T	5	7	12	0	0	12	0	0
16	14157112	.	C	T	9	5	14	0	0	14	0	0
16	14157316	.	A	G	9	12	21	0	0	21	0	0
16	14157390	.	G	A	10	9	19	0	0	19	0	0
16	14157447	.	T	A	11	9	20	0	1	21	0	0
16	14157448	.	A	T	11	8	19	0	2	21	0	0
16	14158490	.	G	A	6	8	14	0	0	14	0	0
16	14158619	.	G	A	5	5	10	1	1	12	0	0
16	14158655	.	T	C	8	7	15	0	0	15	0	0
16	14158666	.	T	G	6	6	12	0	1	13	0	0
16	14158738	.	T	C	3	1	4	0	7	11	0	0
16	14167362	.	A	G	3	7	10	0	1	11	0	0
16	14167383	.	A	G	4	6	10	0	1	11	0	0
16	14167480	.	T	C	5	3	8	1	0	9	0	0
16	14202192	.	A	C	13	8	21	0	1	22	0	0
16	14202197	.	T	A	12	9	21	0	0	21	0	0
16	14206289	.	G	A	6	4	10	0	0	10	0	0
16	14209195	.	G	A	8	18	26	0	1	27	0	0
16	14209348	.	T	C	7	21	28	0	0	28	0	0
16	14210949	.	A	C	7	12	19	0	1	20	0	0
16	14212079	.	G	C	3	8	11	0	8	20	1	0
16	14214534	.	G	A	10	8	18	0	0	18	0	0
16	14214543	.	A	G	10	6	16	0	1	17	0	0
16	14214643	.	A	T	7	7	14	0	3	17	0	0
16	14215565	.	C	G	4	2	6	0	0	6	0	0
16	14216708	.	T	A	4	4	8	0	0	8	0	0
16	14216726	.	A	G	4	3	7	0	0	7	0	0
16	14216766	.	G	A	0	2	2	0	3	5	0	0
16	14220429	.	T	C	3	5	8	0	0	8	0	0
16	14223252	.	C	T	6	3	9	0	0	9	0	0
16	14224041	.	T	G	8	5	13	0	0	13	0	0
16	14226046	.	G	A	1	3	4	0	5	9	0	0
16	14227913	.	C	T	8	5	13	0	0	13	0	0
16	14228668	.	A	G	6	5	11	0	1	12	0	0
16	14229729	.	A	G	2	4	6	0	3	9	0	0
16	14230222	.	A	G	2	4	6	0	1	7	0	0
16	14230373	.	T	C	6	7	13	1	0	14	0	0
16	14231135	.	G	A	0	4	4	0	6	10	0	0
16	14231138	.	C	T	6	4	10	0	0	10	0	0
16	14231207	.	T	A	2	3	5	0	0	5	0	0
16	14231730	.	G	A	7	12	19	0	1	20	0	0
16	14242688	.	C	T	0	15	15	0	9	24	0	0
16	14266614	.	A	G	6	0	6	0	3	9	0	0
16	14269906	.	G	A	1	4	5	0	0	5	0	0
16	14269975	.	C	T	2	2	4	0	0	4	0	0
16	14278173	.	C	T	3	7	10	0	0	10	0	0
16	14416520	.	C	T	5	2	7	0	0	7	0	0
16	14416599	.	C	T	10	6	16	0	0	16	0	0
16	14416622	.	C	T	9	6	15	0	1	16	0	0
16	14582288	.	C	A	2	2	4	0	0	4	0	0
16	14588390	.	T	C	2	7	9	0	0	9	0	0
16	14588430	.	A	G	1	10	11	0	1	12	0	0
16	14588705	.	C	T	3	12	15	0	1	16	0	0
16	14597927	.	A	C	10	4	14	0	0	14	0	0
16	14602380	.	C	G	8	3	11	0	1	12	0	0
16	14627207	.	T	C	6	7	13	0	0	13	0	0
16	14627294	.	G	A	7	8	15	0	1	16	0	0
16	14638413	.	G	A	8	4	12	0	0	12	0	0
16	14638476	.	C	T	6	8	14	0	0	14	0	0
16	14671098	.	A	T	10	4	14	0	0	14	0	0
16	14671099	.	A	T	9	4	13	0	1	14	0	0
16	14674718	.	T	G	2	9	11	0	0	11	0	0
16	14674855	.	A	G	1	5	6	0	1	7	0	0
16	14674924	.	A	G	4	3	7	0	0	7	0	0
16	14674930	.	A	G	0	5	5	0	1	6	0	0
16	14675101	.	T	A	9	4	13	0	0	13	0	0
16	14675175	.	C	T	5	7	12	0	1	13	0	0
16	14675373	.	A	C	6	11	17	0	0	17	0	0
16	14675413	.	G	T	0	6	6	0	4	10	0	0
16	14675513	.	A	C	4	4	8	0	1	9	0	0
16	14675572	.	G	A	4	13	17	0	0	17	0	0
16	14675658	.	A	G	7	8	15	0	0	15	0	0
16	14675697	.	A	T	7	8	15	0	0	15	0	0
16	14675780	.	A	G	5	2	7	0	0	7	0	0
16	14710495	.	T	A	2	4	6	0	0	6	0	0
16	14724012	.	A	G	3	3	6	0	0	6	0	0
16	14801567	.	A	G	4	0	4	0	4	8	0	0
16	14809414	.	G	A	0	5	5	0	2	7	0	0
16	14812572	.	C	T	1	4	5	0	1	6	0	0
16	14817095	.	G	A	1	4	5	0	0	5	0	0
16	14819125	.	A	G	1	0	1	0	3	4	0	0
16	14823853	.	T	C	2	4	6	0	1	7	0	0
16	14865602	.	G	T	5	8	13	0	1	14	0	0
16	14901812	.	C	T	8	9	17	0	0	17	0	0
16	14903581	.	A	C	3	3	6	0	0	6	0	0
16	14933154	.	A	G	1	0	1	0	5	6	0	0
16	14973968	.	A	T	4	10	14	0	1	15	0	0
16	14973989	.	A	T	5	11	16	0	0	16	0	0
16	15031839	.	C	T	4	8	12	1	0	13	0	0
16	15034906	.	C	T	6	8	14	0	0	14	0	0
16	15048338	.	G	A	0	8	8	0	14	22	0	0
16	15048561	.	G	T	15	9	24	0	0	24	0	0
16	15048737	.	A	T	2	3	5	0	0	5	0	0
16	15050367	.	C	A	18	12	30	0	1	31	0	0
16	15140987	.	G	A	0	5	5	0	3	8	0	0
16	15165153	.	A	G	2	2	4	0	0	4	0	0
16	15184543	.	C	T	0	3	3	0	4	7	0	0
16	15943424	.	C	T	8	9	17	0	1	18	0	0
16	15944980	.	A	T	9	9	18	0	1	19	0	0
16	15956855	.	C	A	4	5	9	0	2	11	0	0
16	15958358	.	T	C	7	12	19	0	1	20	0	0
16	15958715	.	T	C	7	0	7	0	9	16	0	0
16	16042986	.	T	C	15	11	26	0	0	26	0	0
16	16078951	.	A	G	6	4	10	0	1	11	0	0
16	16081095	.	C	G	1	4	5	0	9	14	0	0
16	16081104	.	T	A	6	5	11	0	1	12	0	0
16	16165179	.	T	A	25	25	50	0	3	53	0	0
16	16165361	.	A	G	44	33	77	0	1	78	0	0
16	16165418	.	C	T	35	38	73	0	1	74	0	0
16	16165725	.	A	C	45	31	76	0	0	76	0	0
16	16210469	.	T	A	6	5	11	0	0	11	0	0
16	16212520	.	A	G	8	6	14	0	0	14	0	0
16	16233410	.	A	G	7	7	14	0	0	14	0	0
16	16233520	.	C	T	9	10	19	1	0	20	0	0
16	16233538	.	A	T	7	13	20	1	0	21	0	0
16	16234309	.	C	A	1	6	7	0	9	16	0	0
16	16234840	.	A	T	10	8	18	0	0	18	0	0
16	16253948	.	T	A	2	3	5	0	0	5	0	0
16	16266437	.	A	G	2	3	5	0	0	5	0	0
16	16266593	.	C	T	7	5	12	0	0	12	0	0
16	16266645	.	A	G	5	3	8	0	1	9	0	0
16	16266653	.	A	T	6	3	9	0	1	10	0	0
16	16266774	.	A	G	2	4	6	0	0	6	0	0
16	16266844	.	C	T	4	3	7	0	0	7	0	0
16	16267013	.	T	A	2	2	4	0	0	4	0	0
16	16267033	.	C	G	2	2	4	0	0	4	0	0
16	16267067	.	G	T	2	2	4	0	0	4	0	0
16	16267073	.	A	G	2	2	4	0	0	4	0	0
16	16267189	.	A	G	6	7	13	0	1	14	0	0
16	16267355	.	T	C	7	5	12	1	0	13	0	0
16	16267602	.	A	T	2	3	5	0	0	5	0	0
16	16267631	.	G	A	7	2	9	0	0	9	0	0
16	16267814	.	C	G	6	4	10	0	0	10	0	0
16	16267823	.	T	C	7	4	11	0	0	11	0	0
16	16267895	.	G	A	0	12	12	0	1	13	0	0
16	16267903	.	A	G	6	3	9	0	0	9	0	0
16	16268037	.	A	T	3	5	8	0	0	8	0	0
16	16268205	.	A	T	4	5	9	0	0	9	0	0
16	16268208	.	G	A	0	4	4	0	4	8	0	0
16	16268263	.	A	G	4	2	6	0	0	6	0	0
16	16268284	.	C	T	4	3	7	0	0	7	0	0
16	16268334	.	G	A	3	3	6	0	0	6	0	0
16	16268851	.	T	A	3	4	7	0	0	7	0	0
16	16268956	.	G	C	6	5	11	0	0	11	0	0
16	16268970	.	C	T	7	5	12	0	0	12	0	0
16	16269089	.	A	G	2	3	5	0	1	6	0	0
16	16269118	.	C	T	5	6	11	0	0	11	0	0
16	16269285	.	G	A	6	5	11	0	0	11	0	0
16	16269502	.	C	T	4	4	8	0	0	8	0	0
16	16269508	.	C	T	4	2	6	0	0	6	0	0
16	16269593	.	G	C	6	5	11	0	0	11	0	0
16	16269690	.	G	A	0	7	7	0	3	10	0	0
16	16269724	.	G	A	7	8	15	0	0	15	0	0
16	16269926	.	G	C	8	9	17	0	0	17	0	0
16	16269964	.	T	C	8	6	14	0	0	14	0	0
16	16270163	.	C	A	8	4	12	0	0	12	0	0
16	16270326	.	G	A	2	8	10	0	0	10	0	0
16	16270358	.	A	G	5	10	15	0	0	15	0	0
16	16270361	.	T	C	5	8	13	0	1	14	0	0
16	16270424	.	T	C	3	3	6	0	0	6	0	0
16	16270448	.	T	G	2	0	2	0	6	9	1	0
16	16271683	.	G	A	4	5	9	0	0	9	0	0
16	16271695	.	A	G	5	3	8	0	0	8	0	0
16	16275288	.	T	C	5	2	7	0	0	7	0	0
16	16276678	.	G	A	8	3	11	0	0	11	0	0
16	16276938	.	T	C	6	5	11	0	0	11	0	0
16	16277689	.	A	G	9	5	14	0	0	14	0	0
16	16277728	.	G	A	8	6	14	0	0	14	0	0
16	16277810	.	G	A	7	4	11	0	1	12	0	0
16	16277954	.	G	A	2	13	15	0	0	15	0	0
16	16278013	.	A	T	4	8	12	0	0	12	0	0
16	16278043	.	T	C	7	3	10	0	2	12	0	0
16	16278172	.	G	T	1	10	11	0	8	19	0	0
16	16278356	.	C	A	7	3	10	0	0	10	0	0
16	16278447	.	C	T	1	0	1	0	2	3	0	0
16	16281479	.	A	C	12	10	22	0	0	22	0	0
16	16281740	.	A	C	9	5	14	0	0	14	0	0
16	16281869	.	T	A	15	8	23	0	0	23	0	0
16	16284057	.	T	C	8	11	19	0	0	19	0	0
16	16284159	.	G	A	0	8	8	0	22	30	0	0
16	16284192	.	C	A	19	10	29	0	2	31	0	0
16	16289121	.	C	T	11	11	22	0	1	23	0	0
16	16297057	.	G	A	12	19	31	0	1	32	0	0
16	16302166	.	T	C	9	13	22	0	1	23	0	0
16	16302247	.	A	T	12	8	20	0	0	20	0	0
16	16302371	.	A	C	10	6	16	0	0	16	0	0
16	16302426	.	T	A	18	9	27	0	0	27	0	0
16	16302477	.	G	A	0	12	12	0	14	26	0	0
16	16302835	.	T	C	12	3	15	0	0	15	0	0
16	16303025	.	C	T	14	16	30	0	0	30	0	0
16	16303065	.	A	G	9	14	23	0	0	23	0	0
16	16303086	.	T	A	10	10	20	0	0	20	0	0
16	16303163	.	G	A	0	9	9	0	5	14	0	0
16	16303196	.	A	G	6	0	6	0	11	17	0	0
16	16303293	.	T	G	8	9	17	0	0	17	0	0
16	16547388	.	C	T	6	8	14	0	0	14	0	0
16	16553899	.	C	T	7	7	14	0	0	14	0	0
16	16555157	.	T	A	2	3	5	0	0	5	0	0
16	16555611	.	A	G	10	12	22	1	1	24	0	0
16	16555975	.	T	A	8	5	13	0	0	13	0	0
16	16565963	.	G	C	15	14	29	0	0	29	0	0
16	16565998	.	C	T	15	17	32	0	0	32	0	0
16	16566182	.	T	C	14	16	30	0	0	30	0	0
16	16566402	.	G	A	13	11	24	0	1	25	0	0
16	16569047	.	G	A	13	10	23	0	0	23	0	0
16	16569578	.	C	G	14	9	23	0	0	23	0	0
16	16574168	.	T	C	8	9	17	0	0	17	0	0
16	16586232	.	C	T	16	13	29	0	6	35	0	0
16	16586290	.	G	A	12	14	26	1	0	27	0	0
16	16589462	.	G	A	10	10	20	0	0	20	0	0
16	16589552	.	G	A	4	5	9	0	1	10	0	0
16	16590715	.	T	C	8	7	15	0	1	16	0	0
16	16598146	.	T	C	5	2	7	0	0	7	0	0
16	16598232	.	C	T	0	2	2	0	5	7	0	0
16	16598430	.	C	T	0	2	2	0	2	4	0	0
16	16603651	.	T	A	4	2	6	0	0	6	0	0
16	16849326	.	C	T	8	3	11	0	0	11	0	0
16	16849374	.	G	C	11	5	16	0	0	16	0	0
16	16849404	.	T	A	7	3	10	0	0	10	0	0
16	16877130	.	G	T	1	2	3	0	1	4	0	0
16	16887296	.	G	A	0	5	5	0	5	10	0	0
16	16887359	.	C	T	6	3	9	0	0	9	0	0
16	16887371	.	T	C	5	4	9	0	0	9	0	0
16	16902013	.	G	A	4	2	6	0	0	6	0	0
16	16906094	.	A	G	1	5	6	0	0	6	0	0
16	16906124	.	G	A	2	4	6	0	0	6	0	0
16	16908487	.	C	T	7	11	18	0	2	20	0	0
16	16908586	.	G	A	3	6	9	0	0	9	0	0
16	16912252	.	T	G	8	9	17	0	0	17	0	0
16	16913102	.	G	A	9	8	17	0	0	17	0	0
16	16914252	.	A	G	9	4	13	0	0	13	0	0
16	16916699	.	G	A	7	5	12	0	1	13	0	0
16	16916893	.	C	T	5	9	14	0	2	16	0	0
16	16916955	.	A	G	7	0	7	0	7	14	0	0
16	16920457	.	A	G	8	8	16	0	0	16	0	0
16	16920823	.	G	A	7	6	13	0	0	13	0	0
16	16921134	.	G	A	3	10	13	0	2	15	0	0
16	16923651	.	A	G	8	8	16	0	1	17	0	0
16	16939024	.	A	G	1	0	1	0	14	15	0	0
16	16939030	.	A	C	3	1	4	0	10	14	0	0
16	16939266	.	T	C	1	8	9	0	0	9	0	0
16	16940768	.	A	G	11	0	11	0	6	17	0	0
16	16941121	.	G	A	0	6	6	0	9	15	0	0
16	16941237	.	G	A	3	13	16	0	11	27	0	0
16	16941270	.	G	A	0	11	11	0	11	22	0	0
16	16941343	.	G	A	11	8	19	0	1	20	0	0
16	16941361	.	T	C	11	10	21	0	1	22	0	0
16	16941394	.	C	T	10	10	20	0	1	21	0	0
16	16941741	.	C	T	14	6	20	0	1	21	0	0
16	16941979	.	C	A	8	5	13	0	0	13	0	0
16	16942001	.	G	A	0	5	5	0	7	12	0	0
16	16942097	.	C	T	4	3	7	0	0	7	0	0
16	16942130	.	C	A	7	5	12	0	0	12	0	0
16	16942200	.	C	T	9	6	15	0	1	16	0	0
16	16942293	.	T	A	9	8	17	0	1	18	0	0
16	16942302	.	A	G	15	2	17	0	2	19	0	0
16	16942332	.	G	A	11	6	17	0	1	18	0	0
16	16942867	.	A	G	12	12	24	0	1	25	0	0
16	16942906	.	C	G	13	9	22	3	0	25	0	0
16	16942953	.	A	G	13	11	24	3	0	27	0	0
16	16943258	.	C	A	12	4	16	0	1	17	0	0
16	16943348	.	C	A	9	13	22	0	0	22	0	0
16	16943388	.	T	A	12	8	20	0	0	20	0	0
16	16943651	.	A	T	12	6	18	0	1	19	0	0
16	16944023	.	G	T	10	13	23	0	0	23	0	0
16	16944066	.	T	C	4	10	14	0	0	14	0	0
16	16944142	.	A	T	7	13	20	0	0	20	0	0
16	16944150	.	T	C	6	13	19	0	1	20	0	0
16	16944884	.	A	G	12	5	17	0	2	19	0	0
16	16945261	.	A	G	3	8	11	0	0	11	0	0
16	16945328	.	G	A	9	11	20	0	1	21	0	0
16	16945365	.	T	G	14	8	22	0	0	22	0	0
16	17072320	.	A	C	1	3	4	0	0	4	0	0
16	17120136	.	C	T	13	13	26	1	0	27	0	0
16	17122132	.	C	A	2	5	7	0	11	18	0	0
16	17136980	.	T	G	13	7	20	0	1	21	0	0
16	17137031	.	A	G	14	6	20	0	0	20	0	0
16	17151833	.	C	T	7	3	10	0	0	10	0	0
16	17151836	.	A	T	6	3	9	0	0	9	0	0
16	17161709	.	T	A	7	15	22	0	0	23	1	0
16	17161739	.	G	A	10	15	25	0	0	25	0	0
16	17161877	.	A	G	11	14	25	0	1	26	0	0
16	17162411	.	A	C	13	10	23	0	0	23	0	0
16	17195343	.	A	G	2	3	5	0	0	5	0	0
16	17235486	.	A	G	4	5	9	0	1	10	0	0
16	17235730	.	A	G	5	2	7	0	0	7	0	0
16	17238475	.	T	A	3	3	6	0	1	7	0	0
16	17238490	.	A	G	5	3	8	0	0	8	0	0
16	17238757	.	A	T	4	4	8	0	0	8	0	0
16	17247089	.	A	G	5	2	7	0	0	7	0	0
16	17247509	.	T	C	3	3	6	0	0	6	0	0
16	17249377	.	G	A	4	5	9	0	0	9	0	0
16	17249427	.	T	C	2	3	5	0	0	5	0	0
16	17250859	.	A	C	3	5	8	0	0	8	0	0
16	17251254	.	G	A	2	2	4	0	1	5	0	0
16	17251255	.	G	T	3	2	5	0	0	5	0	0
16	17252774	.	G	T	12	10	22	0	0	22	0	0
16	17253161	.	A	G	3	14	17	0	1	18	0	0
16	17253189	.	T	A	7	15	22	0	1	23	0	0
16	17253223	.	A	G	5	9	14	0	0	14	0	0
16	17253274	.	T	C	7	8	15	0	0	15	0	0
16	17256120	.	C	T	4	5	9	0	0	9	0	0
16	17256165	.	G	A	2	2	4	0	0	4	0	0
16	17302526	.	T	C	8	6	14	0	0	14	0	0
16	17302821	.	A	G	13	10	23	0	0	23	0	0
16	17305597	.	C	T	8	10	18	0	0	18	0	0
16	17305620	.	A	G	9	8	17	0	0	17	0	0
16	17311420	.	A	G	3	7	10	0	0	10	0	0
16	17428759	.	T	C	9	7	16	0	0	16	0	0
16	17465977	.	T	A	10	8	18	0	1	19	0	0
16	17466205	.	T	A	8	4	12	0	0	12	0	0
16	17466443	.	A	G	1	2	3	0	0	3	0	0
16	17467011	.	G	A	12	4	16	0	1	17	0	0
16	17467021	.	C	T	10	3	13	0	0	13	0	0
16	17467287	.	T	G	10	6	16	0	0	17	1	0
16	17467361	.	G	A	0	7	7	0	3	10	0	0
16	17549176	.	G	T	2	4	6	0	1	7	0	0
16	17550211	.	T	A	5	2	7	0	0	7	0	0
16	17560763	.	T	G	4	3	7	0	0	7	0	0
16	17581687	.	G	A	8	4	12	0	0	12	0	0
16	17585924	.	C	G	9	11	20	0	0	20	0	0
16	17586674	.	T	C	6	2	8	0	0	8	0	0
16	17639989	.	T	A	8	7	15	0	0	15	0	0
16	17640297	.	G	A	8	4	12	0	0	12	0	0
16	17646269	.	T	C	13	9	22	0	1	23	0	0
16	18142759	.	C	T	9	4	13	1	0	14	0	0
16	18142765	.	A	G	9	4	13	0	0	13	0	0
16	18552492	.	C	T	9	11	20	0	1	21	0	0
16	18960387	.	G	C	1	4	5	0	0	5	0	0
16	18960414	.	A	G	1	3	4	0	0	4	0	0
16	19100141	.	C	T	7	5	12	0	0	12	0	0
16	19100144	.	T	A	8	3	11	0	1	12	0	0
16	19124404	.	T	C	12	6	18	1	0	19	0	0
16	19124452	.	A	G	6	4	10	1	0	11	0	0
16	19131349	.	G	A	10	6	16	0	0	16	0	0
16	19141362	.	T	A	3	2	5	0	0	5	0	0
16	19143578	.	T	C	6	2	8	0	0	8	0	0
16	19145102	.	C	T	6	4	10	0	2	12	0	0
16	19150643	.	A	T	11	5	16	0	1	17	0	0
16	19150678	.	C	T	10	5	15	0	0	15	0	0
16	19150814	.	T	A	4	4	8	0	1	9	0	0
16	19150973	.	A	G	4	4	8	0	0	8	0	0
16	19151174	.	C	A	3	10	13	0	0	13	0	0
16	19151187	.	T	G	3	11	14	0	0	14	0	0
16	19151336	.	C	A	3	2	5	0	0	5	0	0
16	19151355	.	G	C	3	2	5	0	1	6	0	0
16	19151534	.	T	C	4	3	7	0	0	7	0	0
16	19537565	.	G	A	0	3	3	0	2	5	0	0
16	19537925	.	C	T	3	5	8	0	0	8	0	0
16	19538162	.	T	C	5	5	10	0	0	10	0	0
16	19538712	.	C	G	8	0	8	0	6	14	0	0
16	19538840	.	G	A	5	2	7	0	2	9	0	0
16	19538982	.	T	A	10	3	13	0	0	13	0	0
16	19539574	.	C	A	3	5	8	0	0	8	0	0
16	19681279	.	A	G	1	2	3	0	0	3	0	0
16	19732856	.	A	T	2	2	4	0	0	4	0	0
16	19732903	.	G	A	2	2	4	0	0	4	0	0
16	19840867	.	A	G	17	11	28	0	0	28	0	0
16	19841082	.	C	G	1	14	15	0	28	43	0	0
16	19841135	.	C	T	20	11	31	1	0	32	0	0
16	19841213	.	G	A	14	18	32	0	1	33	0	0
16	19841215	.	C	T	13	15	28	0	5	33	0	0
16	19841290	.	A	T	8	9	17	0	1	18	0	0
16	19841358	.	C	T	14	4	18	0	0	18	0	0
16	19841502	.	A	T	5	8	13	0	0	13	0	0
16	19841591	.	A	G	13	9	22	0	0	22	0	0
16	19841720	.	A	G	7	8	15	0	2	17	0	0
16	19841786	.	A	T	8	8	16	0	0	16	0	0
16	19841890	.	G	A	9	6	15	0	0	15	0	0
16	19841922	.	G	A	10	6	16	0	0	16	0	0
16	19842493	.	G	A	8	12	20	0	0	20	0	0
16	19842530	.	A	G	1	5	6	0	4	10	0	0
16	19843053	.	G	T	19	16	35	0	0	35	0	0
16	19843056	.	G	T	16	18	34	0	0	34	0	0
16	19850746	.	G	A	25	18	43	0	2	45	0	0
16	19853074	.	G	A	28	18	46	0	3	49	0	0
16	19853098	.	C	T	27	19	46	0	3	49	0	0
16	19853125	.	A	T	27	21	48	0	2	50	0	0
16	19853230	.	A	C	26	10	36	0	0	36	0	0
16	19854886	.	C	T	0	15	15	0	9	24	0	0
16	19861475	.	G	A	13	13	26	0	0	26	0	0
16	20134015	.	A	G	1	3	4	0	0	4	0	0
16	20140877	.	T	G	8	5	13	0	0	13	0	0
16	20148369	.	C	T	8	6	14	1	1	16	0	0
16	20151309	.	C	T	10	13	23	0	0	23	0	0
16	20151397	.	C	T	15	8	23	0	0	23	0	0
16	20151460	.	C	T	8	4	12	0	0	12	0	0
16	20151770	.	A	G	10	6	16	0	2	18	0	0
16	20151991	.	G	A	10	6	16	0	1	17	0	0
16	20152106	.	A	T	9	10	19	0	0	19	0	0
16	20152128	.	G	A	0	7	7	0	8	15	0	0
16	20152203	.	A	G	3	0	3	0	8	11	0	0
16	20152250	.	T	C	5	7	12	0	0	12	0	0
16	20152476	.	C	A	4	4	8	0	1	9	0	0
16	20178298	.	A	C	4	2	6	0	0	6	0	0
16	20193788	.	A	G	3	3	6	0	0	6	0	0
16	20193973	.	T	C	1	2	3	0	0	3	0	0
16	20229712	.	T	C	2	4	6	0	0	6	0	0
16	20235411	.	A	G	1	2	3	0	0	3	0	0
16	20238498	.	C	T	1	2	3	0	0	3	0	0
16	20238564	.	G	A	1	5	6	0	0	6	0	0
16	20266055	.	T	C	2	2	4	0	0	4	0	0
16	20266106	.	T	C	1	3	4	0	0	4	0	0
16	20266202	.	T	C	5	5	10	0	0	10	0	0
16	20266215	.	G	T	6	5	11	0	0	11	0	0
16	20266799	.	A	C	7	4	11	0	1	12	0	0
16	20268470	.	C	T	2	5	7	0	2	9	0	0
16	20271756	.	A	G	3	4	7	0	0	7	0	0
16	20276193	.	T	A	6	2	8	0	1	9	0	0
16	20289453	.	A	G	6	5	11	0	1	12	0	0
16	20289511	.	T	C	1	6	7	0	0	7	0	0
16	20289537	.	T	C	1	5	6	0	0	6	0	0
16	20291223	.	G	C	3	2	5	0	0	5	0	0
16	20292156	.	T	C	3	6	9	0	0	9	0	0
16	20318550	.	G	A	5	7	12	0	0	12	0	0
16	20324891	.	A	G	15	11	26	0	0	26	0	0
16	20328092	.	C	T	0	8	8	0	8	16	0	0
16	20371350	.	A	G	9	7	16	1	1	18	0	0
16	20402034	.	A	C	10	0	10	0	15	25	0	0
16	20402139	.	G	T	7	14	21	0	0	21	0	0
16	20402193	.	C	T	0	11	11	0	8	19	0	0
16	20402199	.	A	G	8	11	19	0	1	20	0	0
16	20403022	.	C	A	1	10	11	0	6	17	0	0
16	20435444	.	C	T	7	6	13	0	1	14	0	0
16	20492447	.	G	T	8	4	12	0	1	13	0	0
16	20492604	.	C	T	14	7	21	0	0	21	0	0
16	20496764	.	A	G	1	2	3	0	0	3	0	0
16	20497297	.	A	C	1	6	7	0	0	7	0	0
16	20512387	.	G	C	4	9	13	0	0	13	0	0
16	20512408	.	A	C	4	7	11	0	0	11	0	0
16	20512661	.	T	C	4	12	16	0	2	18	0	0
16	20513103	.	T	G	12	1	13	0	7	20	0	0
16	20514738	.	G	A	4	7	11	0	0	11	0	0
16	20530242	.	G	A	1	3	4	0	0	4	0	0
16	20530274	.	T	G	1	2	3	0	0	3	0	0
16	20531705	.	C	T	2	3	5	0	0	5	0	0
16	20540040	.	G	A	3	2	5	0	1	6	0	0
16	20792982	.	T	A	12	19	31	0	2	33	0	0
16	20806487	.	C	T	23	22	45	0	2	47	0	0
16	20806747	.	A	G	19	24	43	0	1	44	0	0
16	20822708	.	T	G	27	19	46	0	0	46	0	0
16	20826703	.	G	A	19	25	44	0	2	46	0	0
16	20836206	.	C	T	23	23	46	0	0	46	0	0
16	20836870	.	G	A	25	21	46	0	0	46	0	0
16	20855636	.	C	T	20	18	38	0	2	40	0	0
16	20874252	.	T	C	17	12	29	0	0	29	0	0
16	20889292	.	G	A	3	5	8	0	0	8	0	0
16	20889486	.	T	A	1	3	4	0	0	4	0	0
16	21038585	.	A	T	4	3	7	0	1	8	0	0
16	21038697	.	A	C	4	6	10	0	0	10	0	0
16	21038801	.	T	A	9	13	22	0	0	23	1	0
16	21038832	.	T	A	9	14	23	0	0	23	0	0
16	21038924	.	G	A	9	6	15	0	0	15	0	0
16	21039939	.	G	C	5	7	12	0	0	12	0	0
16	21144811	.	C	G	2	2	4	0	0	4	0	0
16	21180758	.	T	C	2	0	2	0	3	5	0	0
16	21341328	.	A	G	1	0	1	0	6	7	0	0
16	21417168	.	C	G	2	4	6	0	0	6	0	0
16	21442772	.	A	T	1	4	5	0	0	5	0	0
16	21443695	.	G	A	1	2	3	0	0	3	0	0
16	21443712	.	G	T	1	2	3	0	1	4	0	0
16	21444560	.	T	G	1	5	6	0	0	6	0	0
16	21444572	.	T	G	1	4	5	0	0	5	0	0
16	21446155	.	T	G	1	2	3	0	0	3	0	0
16	21548456	.	C	T	4	4	8	0	1	9	0	0
16	21548547	.	G	A	10	5	15	0	0	15	0	0
16	21548556	.	G	A	10	6	16	0	0	16	0	0
16	21548625	.	G	T	5	3	8	0	0	8	0	0
16	21548776	.	C	T	9	3	12	0	1	13	0	0
16	21548881	.	T	C	9	4	13	0	0	13	0	0
16	21548891	.	A	T	9	3	12	0	0	12	0	0
16	21549022	.	C	T	0	8	8	0	9	17	0	0
16	21549520	.	C	T	0	9	9	0	9	18	0	0
16	21549539	.	A	C	7	6	13	0	1	14	0	0
16	21549600	.	T	A	9	7	16	0	1	17	0	0
16	21549822	.	T	A	5	4	9	0	1	10	0	0
16	21549924	.	C	T	4	6	10	0	1	11	0	0
16	21550058	.	G	C	3	3	6	0	2	8	0	0
16	21550124	.	G	A	5	3	8	0	0	8	0	0
16	21550318	.	C	T	5	4	9	0	0	9	0	0
16	21551743	.	C	T	5	7	12	0	0	12	0	0
16	21551749	.	T	G	7	3	10	0	0	10	0	0
16	21551928	.	T	C	2	1	3	0	1	4	0	0
16	21551929	.	C	A	2	2	4	0	0	4	0	0
16	21552107	.	G	T	4	3	7	0	0	7	0	0
16	21553079	.	C	T	4	4	8	0	0	8	0	0
16	21554846	.	C	T	4	7	11	0	0	11	0	0
16	21570198	.	C	T	0	3	3	0	3	6	0	0
16	21578987	.	T	C	1	2	3	0	0	3	0	0
16	21651780	.	T	C	6	0	6	0	8	14	0	0
16	21652059	.	T	A	10	16	26	0	0	26	0	0
16	21655336	.	C	T	11	10	21	0	0	21	0	0
16	21655611	.	G	A	14	13	27	0	0	27	0	0
16	21663023	.	G	A	8	7	15	0	1	16	0	0
16	21665403	.	G	C	11	9	20	0	0	20	0	0
16	21665605	.	G	T	11	9	20	0	0	20	0	0
16	21689469	.	C	T	1	6	7	0	3	10	0	0
16	21691065	.	T	G	5	7	12	0	0	12	0	0
16	21691101	.	T	C	4	6	10	0	0	10	0	0
16	21711829	.	G	A	2	4	6	0	0	6	0	0
16	21711873	.	G	C	1	4	5	0	3	8	0	0
16	21711882	.	T	C	3	3	6	0	1	7	0	0
16	21734574	.	A	G	4	4	8	0	0	8	0	0
16	21738666	.	A	T	9	26	35	0	0	35	0	0
16	21739233	.	G	A	19	18	37	0	1	38	0	0
16	21763843	.	G	A	20	17	37	1	2	40	0	0
16	21769044	.	G	A	21	17	38	0	0	38	0	0
16	21777508	.	G	C	10	0	10	0	10	20	0	0
16	21780023	.	G	A	2	8	10	0	0	10	0	0
16	21782076	.	C	A	4	6	10	0	0	10	0	0
16	21892068	.	G	A	4	3	7	0	0	7	0	0
16	21892173	.	G	A	6	5	11	0	0	11	0	0
16	21892304	.	T	C	13	0	13	0	8	21	0	0
16	21892312	.	C	A	17	6	23	0	0	23	0	0
16	21898159	.	T	A	7	6	13	0	0	13	0	0
16	21898267	.	A	T	6	9	15	0	0	15	0	0
16	21898279	.	C	T	8	7	15	0	1	16	0	0
16	21899211	.	C	T	8	6	14	0	2	16	0	0
16	21899384	.	C	G	1	6	7	0	8	15	0	0
16	21900294	.	A	G	8	12	20	0	1	21	0	0
16	21900333	.	C	A	2	13	15	0	13	28	0	0
16	21901015	.	G	A	2	3	5	0	0	5	0	0
16	21902949	.	G	A	4	8	12	0	1	13	0	0
16	21903803	.	A	G	8	9	17	0	0	17	0	0
16	21903845	.	C	T	6	4	10	0	1	11	0	0
16	21903911	.	C	A	0	8	8	0	6	14	0	0
16	21904091	.	G	A	7	8	15	0	0	15	0	0
16	21905681	.	A	G	6	4	10	0	0	10	0	0
16	21905814	.	G	A	14	13	27	0	0	27	0	0
16	21906282	.	A	C	8	0	8	0	13	21	0	0
16	21907744	.	A	G	3	4	7	0	0	7	0	0
16	21908428	.	T	C	6	0	6	0	5	11	0	0
16	21908775	.	T	C	2	5	7	0	0	7	0	0
16	21908890	.	A	G	3	5	8	0	0	8	0	0
16	21909747	.	A	T	6	5	11	0	0	11	0	0
16	21912063	.	G	T	8	5	13	0	0	13	0	0
16	21912064	.	C	G	8	4	12	0	1	13	0	0
16	21912189	.	A	G	11	6	17	0	0	17	0	0
16	21912963	.	C	A	2	5	7	0	0	7	0	0
16	21913069	.	T	A	5	4	9	0	0	9	0	0
16	21913091	.	T	A	1	3	4	0	0	4	0	0
16	21917148	.	A	C	2	6	8	0	0	8	0	0
16	21921453	.	T	G	3	3	6	0	0	6	0	0
16	21921615	.	A	C	2	3	5	0	1	6	0	0
16	21921778	.	T	C	1	3	4	0	0	4	0	0
16	21922155	.	C	T	2	2	4	0	0	4	0	0
16	21922245	.	T	G	3	3	6	0	1	7	0	0
16	21922356	.	A	T	2	2	4	0	0	4	0	0
16	21922479	.	A	T	1	2	3	0	1	4	0	0
16	21922497	.	A	G	2	0	2	0	3	5	0	0
16	21925257	.	A	G	2	2	4	0	0	4	0	0
16	21928360	.	G	A	1	5	6	0	0	6	0	0
16	21933946	.	G	A	0	3	3	0	2	5	0	0
16	21937712	.	T	C	4	5	9	0	0	9	0	0
16	21937834	.	C	G	3	2	5	0	0	5	0	0
16	21937991	.	G	T	0	4	4	0	1	5	0	0
16	22217835	.	T	C	8	0	8	0	5	13	0	0
16	22218117	.	A	G	2	3	5	0	0	5	0	0
16	22218355	.	C	A	2	8	10	0	0	10	0	0
16	22218451	.	A	G	1	5	6	0	0	6	0	0
16	22224698	.	A	G	4	3	7	0	0	7	0	0
16	22224707	.	C	G	4	3	7	0	0	7	0	0
16	22225094	.	C	T	10	5	15	0	0	15	0	0
16	22245156	.	A	G	4	3	7	1	0	8	0	0
16	22345652	.	T	G	6	4	10	0	0	10	0	0
16	22351659	.	A	G	2	0	2	1	4	7	0	0
16	22354677	.	A	G	5	4	9	0	1	10	0	0
16	22358841	.	T	A	9	6	15	0	0	15	0	0
16	22358944	.	A	T	6	11	17	0	1	18	0	0
16	22358947	.	T	A	8	13	21	0	0	21	0	0
16	22360552	.	G	A	11	8	19	0	0	19	0	0
16	22360577	.	G	A	11	4	15	0	1	16	0	0
16	22361101	.	T	C	9	7	16	0	1	17	0	0
16	22363956	.	G	A	16	4	20	0	0	20	0	0
16	22363957	.	G	A	14	4	18	0	1	19	0	0
16	22364064	.	C	T	16	10	26	0	2	28	0	0
16	22364067	.	T	G	18	8	26	0	2	28	0	0
16	22364241	.	A	C	20	15	35	1	1	37	0	0
16	22364501	.	A	C	9	3	12	0	1	13	0	0
16	22365562	.	C	G	5	3	8	0	0	8	0	0
16	22365638	.	C	T	10	4	14	0	0	14	0	0
16	22365646	.	G	T	10	4	14	0	0	14	0	0
16	22368962	.	T	A	20	8	28	0	7	35	0	0
16	22377603	.	A	G	1	2	3	0	1	4	0	0
16	22600222	.	A	C	1	2	3	0	0	3	0	0
16	22649862	.	T	G	6	7	13	0	0	13	0	0
16	22659905	.	A	G	7	11	18	0	0	18	0	0
16	22660094	.	C	A	13	10	23	0	1	24	0	0
16	22673219	.	C	T	12	17	29	0	0	29	0	0
16	22673234	.	C	T	12	14	26	0	0	26	0	0
16	22673528	.	C	G	14	12	26	0	0	26	0	0
16	22673804	.	G	T	12	8	20	0	0	20	0	0
16	22673817	.	G	T	13	8	21	0	1	22	0	0
16	22674181	.	A	C	5	5	10	0	0	10	0	0
16	22674317	.	A	G	12	6	18	0	2	20	0	0
16	22674427	.	C	T	9	12	21	0	1	22	0	0
16	22674490	.	G	A	3	6	9	0	0	9	0	0
16	22675081	.	T	A	6	8	14	0	1	15	0	0
16	22675110	.	A	T	8	7	15	0	1	17	1	0
16	22675253	.	C	T	7	6	13	0	0	13	0	0
16	22675310	.	T	A	5	10	15	0	0	15	0	0
16	22675367	.	C	A	8	7	15	0	1	16	0	0
16	22675418	.	T	C	12	5	17	0	0	17	0	0
16	22675574	.	T	C	13	10	23	0	0	23	0	0
16	22675663	.	T	C	15	7	22	0	1	23	0	0
16	22675795	.	G	A	1	3	4	0	5	9	0	0
16	22676478	.	G	C	5	2	7	0	0	7	0	0
16	22676527	.	C	T	7	3	10	0	0	10	0	0
16	22676589	.	G	T	11	8	19	1	1	21	0	0
16	22676671	.	T	A	12	11	23	0	0	23	0	0
16	22677037	.	C	A	12	6	18	0	1	19	0	0
16	22677086	.	G	A	20	8	28	0	1	29	0	0
16	22677206	.	C	A	13	11	24	0	0	24	0	0
16	22677276	.	A	G	20	8	28	0	0	28	0	0
16	22750244	.	A	T	9	8	17	0	1	18	0	0
16	22750263	.	A	T	11	11	22	0	0	22	0	0
16	22750460	.	T	C	16	0	16	0	15	31	0	0
16	22750483	.	T	C	15	18	33	0	1	34	0	0
16	22750506	.	A	G	17	14	31	0	1	32	0	0
16	22750754	.	G	A	15	7	22	0	0	22	0	0
16	22750839	.	A	G	10	7	17	0	0	17	0	0
16	22751212	.	A	T	3	4	7	0	0	7	0	0
16	22751655	.	T	C	10	4	14	0	1	15	0	0
16	22751656	.	T	C	11	0	11	0	5	16	0	0
16	22752154	.	G	A	24	21	45	0	0	45	0	0
16	22752572	.	A	C	6	14	20	0	3	23	0	0
16	22752624	.	C	T	0	6	6	0	8	14	0	0
16	22752829	.	C	A	4	10	14	0	0	14	0	0
16	22753574	.	C	T	1	15	16	2	29	47	0	0
16	22753583	.	T	C	25	0	25	2	19	46	0	0
16	22753626	.	C	T	27	13	40	2	1	43	0	0
16	22753631	.	C	T	21	16	37	0	2	39	0	0
16	22753744	.	G	C	20	0	20	0	18	38	0	0
16	22754238	.	A	G	12	9	21	0	0	21	0	0
16	22757742	.	G	A	16	13	29	0	1	30	0	0
16	22757795	.	T	C	17	15	32	0	0	32	0	0
16	22757887	.	T	C	11	13	24	0	1	25	0	0
16	22757946	.	T	C	10	0	10	2	11	23	0	0
16	22764803	.	C	T	17	14	31	0	1	32	0	0
16	22764857	.	A	T	10	15	25	0	0	25	0	0
16	22767597	.	A	G	9	13	22	0	0	22	0	0
16	22767603	.	C	T	1	11	12	0	8	20	0	0
16	22767646	.	G	A	7	10	17	0	0	17	0	0
16	22767732	.	A	G	13	11	24	0	0	24	0	0
16	22767796	.	C	G	5	12	17	0	0	17	0	0
16	22782175	.	G	T	1	3	4	0	0	4	0	0
16	22782784	.	T	C	7	12	19	0	0	19	0	0
16	22787455	.	T	C	4	10	14	0	1	15	0	0
16	22789640	.	A	G	16	20	36	0	1	38	1	0
16	23282886	.	T	C	5	2	7	0	0	7	0	0
16	23960890	.	G	C	5	2	7	0	0	7	0	0
16	23963257	.	G	A	26	18	44	0	1	46	1	0
16	23963315	.	G	T	19	24	43	0	1	44	0	0
16	23963421	.	G	T	10	10	20	0	1	21	0	0
16	23963431	.	G	A	8	8	16	0	1	17	0	0
16	23973477	.	G	A	36	26	62	0	1	63	0	0
16	23973501	.	A	G	29	23	52	0	4	56	0	0
16	24030488	.	T	A	2	7	9	0	0	9	0	0
16	24056406	.	T	G	7	5	12	0	0	12	0	0
16	24056497	.	C	T	9	4	13	0	0	13	0	0
16	24058712	.	G	A	5	3	8	0	0	8	0	0
16	24135465	.	T	C	9	1	10	0	5	15	0	0
16	24135547	.	T	C	6	0	6	0	10	16	0	0
16	24190496	.	A	G	8	3	11	0	0	11	0	0
16	24190626	.	C	T	6	2	8	0	0	8	0	0
16	24190674	.	C	T	2	3	5	0	0	5	0	0
16	24191468	.	T	C	25	32	57	0	2	60	1	0
16	24191564	.	G	A	34	30	64	0	2	66	0	0
16	24194217	.	A	C	35	27	62	0	4	66	0	0
16	24261548	.	T	C	32	2	34	0	21	55	0	0
16	24261594	.	C	G	32	13	45	1	0	46	0	0
16	24517824	.	G	A	17	18	35	0	1	36	0	0
16	24552032	.	G	A	3	2	5	0	0	6	1	0
16	24552801	.	A	G	5	7	12	0	1	13	0	0
16	24552931	.	G	T	3	4	7	0	0	7	0	0
16	24553018	.	G	T	6	5	11	0	0	11	0	0
16	24553082	.	T	A	3	8	11	0	0	11	0	0
16	24553141	.	T	A	2	6	8	0	0	8	0	0
16	24553633	.	A	G	2	6	8	0	1	9	0	0
16	24553663	.	T	G	4	5	9	0	0	9	0	0
16	24553861	.	T	C	4	2	6	0	0	6	0	0
16	24553884	.	T	C	3	0	3	0	4	7	0	0
16	24554438	.	T	A	6	9	15	0	1	16	0	0
16	24554475	.	A	G	6	10	16	0	2	18	0	0
16	24590950	.	T	A	13	14	27	0	0	27	0	0
16	24590999	.	A	G	15	12	27	0	0	27	0	0
16	24591010	.	G	A	14	12	26	0	1	27	0	0
16	24591036	.	T	C	10	9	19	0	2	21	0	0
16	24591207	.	T	G	10	10	20	0	2	22	0	0
16	24591287	.	C	T	2	11	13	0	8	21	0	0
16	24591330	.	A	G	15	15	30	0	0	30	0	0
16	24591360	.	G	A	11	10	21	0	0	21	0	0
16	24591379	.	C	T	9	5	14	0	2	16	0	0
16	24591410	.	G	A	5	7	12	0	0	12	0	0
16	24591422	.	C	A	7	7	14	0	0	14	0	0
16	24591693	.	G	C	29	19	48	0	1	49	0	0
16	24591751	.	C	T	23	15	38	0	3	41	0	0
16	24596192	.	C	T	21	11	32	3	1	36	0	0
16	24601285	.	A	C	1	3	4	0	0	4	0	0
16	24601306	.	C	T	1	4	5	1	0	6	0	0
16	24601380	.	T	C	2	10	12	1	0	13	0	0
16	24611053	.	T	C	3	0	3	0	4	7	0	0
16	24632231	.	C	T	13	12	25	1	0	26	0	0
16	24632329	.	T	A	16	10	26	0	1	27	0	0
16	24639396	.	G	A	11	12	23	0	2	25	0	0
16	24642327	.	T	C	11	18	29	0	1	30	0	0
16	24645240	.	C	T	12	7	19	0	0	19	0	0
16	24645448	.	C	G	7	6	13	0	2	15	0	0
16	24645476	.	A	T	7	10	17	0	0	17	0	0
16	24646000	.	A	T	1	4	5	0	0	5	0	0
16	24646620	.	T	C	2	6	8	0	2	10	0	0
16	24658633	.	T	G	1	2	3	1	0	4	0	0
16	24729093	.	G	C	6	3	9	0	1	10	0	0
16	24732829	.	A	G	7	0	7	0	11	18	0	0
16	24732869	.	G	T	11	7	18	0	0	18	0	0
16	24739223	.	C	T	1	2	3	0	0	3	0	0
16	24740807	.	A	T	1	2	3	0	0	3	0	0
16	24740810	.	C	G	1	2	3	0	0	3	0	0
16	24819613	.	C	T	0	3	3	0	2	5	0	0
16	24819620	.	T	C	1	4	5	0	0	5	0	0
16	24826215	.	T	C	1	0	1	0	2	3	0	0
16	24826221	.	A	G	1	2	3	0	0	3	0	0
16	24913074	.	G	A	1	3	4	0	0	4	0	0
16	24915998	.	T	G	1	3	4	0	0	4	0	0
16	24916004	.	T	C	1	2	3	0	0	3	0	0
16	24978275	.	C	G	7	4	11	0	0	11	0	0
16	24989482	.	C	T	1	2	3	0	0	3	0	0
16	24990312	.	T	G	5	4	9	0	0	9	0	0
16	24990603	.	G	A	7	3	10	0	1	11	0	0
16	24990672	.	C	T	2	7	9	0	0	9	0	0
16	24991164	.	G	T	0	8	8	0	7	15	0	0
16	24991225	.	C	G	7	5	12	0	0	12	0	0
16	24991239	.	G	A	0	4	4	0	6	10	0	0
16	24991333	.	T	C	7	6	13	0	1	14	0	0
16	24991391	.	T	C	6	8	14	0	1	15	0	0
16	24991593	.	A	T	2	6	8	0	0	8	0	0
16	24991636	.	G	A	1	3	4	0	0	4	0	0
16	24991637	.	C	T	1	3	4	0	0	4	0	0
16	24991695	.	T	G	3	2	5	0	0	5	0	0
16	24991741	.	T	C	3	3	6	1	0	7	0	0
16	24991919	.	T	A	4	5	9	0	0	9	0	0
16	24992017	.	A	C	3	4	7	0	0	7	0	0
16	24992080	.	A	G	2	2	4	0	0	4	0	0
16	25012003	.	T	A	1	5	6	0	1	7	0	0
16	25012031	.	G	T	4	8	12	0	0	12	0	0
16	25012045	.	A	C	5	9	14	0	1	15	0	0
16	25012123	.	T	C	8	3	11	0	0	11	0	0
16	25012143	.	T	A	8	4	12	0	1	13	0	0
16	25012935	.	T	A	1	6	7	0	1	8	0	0
16	25029841	.	G	C	4	6	10	0	0	10	0	0
16	25030191	.	T	A	1	5	6	0	3	9	0	0
16	25030333	.	C	T	3	2	5	0	0	5	0	0
16	25030338	.	G	A	3	2	5	0	1	6	0	0
16	25030541	.	G	A	5	5	10	0	0	10	0	0
16	25030623	.	A	G	5	4	9	0	0	9	0	0
16	25030685	.	A	G	8	6	14	0	0	14	0	0
16	25030732	.	C	G	9	6	15	0	0	15	0	0
16	25030848	.	G	A	2	13	15	0	1	16	0	0
16	25030956	.	A	C	4	3	7	0	2	9	0	0
16	25030981	.	G	T	4	6	10	0	0	10	0	0
16	25031019	.	C	A	4	7	11	0	0	11	0	0
16	25031185	.	C	A	3	6	9	0	1	10	0	0
16	25031211	.	C	A	7	6	13	0	0	13	0	0
16	25031220	.	C	T	7	5	12	0	0	12	0	0
16	25031250	.	G	A	4	4	8	0	1	9	0	0
16	25031261	.	C	G	7	4	11	0	0	11	0	0
16	25031322	.	C	T	7	3	10	0	0	10	0	0
16	25031359	.	T	A	7	6	13	0	0	13	0	0
16	25031400	.	T	C	9	6	15	0	0	15	0	0
16	25031414	.	C	A	7	8	15	0	0	15	0	0
16	25031435	.	G	C	6	9	15	0	0	15	0	0
16	25031458	.	A	C	5	10	15	0	0	15	0	0
16	25031628	.	C	A	4	5	9	0	0	9	0	0
16	25031712	.	T	G	7	5	12	0	1	13	0	0
16	25031785	.	G	A	2	7	9	0	0	9	0	0
16	25031811	.	T	C	2	6	8	0	1	9	0	0
16	25031884	.	G	A	4	1	5	0	1	6	0	0
16	25032733	.	G	C	5	7	12	0	1	13	0	0
16	25033071	.	G	A	7	14	21	0	1	22	0	0
16	25033306	.	C	T	4	11	15	0	0	15	0	0
16	25033319	.	C	T	7	11	18	0	1	19	0	0
16	25033423	.	A	T	10	6	16	0	1	17	0	0
16	25033659	.	C	A	12	4	16	0	0	16	0	0
16	25033809	.	G	A	10	7	17	0	1	18	0	0
16	25033953	.	G	A	7	6	13	0	0	13	0	0
16	25033983	.	T	A	6	9	15	0	0	15	0	0
16	25034115	.	A	G	4	4	8	0	1	9	0	0
16	25034187	.	C	A	7	5	12	0	0	12	0	0
16	25034223	.	A	C	12	9	21	0	0	21	0	0
16	25034683	.	A	T	5	14	19	0	1	20	0	0
16	25034715	.	C	T	9	18	27	0	0	27	0	0
16	25034766	.	G	A	14	17	31	0	0	31	0	0
16	25035024	.	T	G	6	0	6	0	12	18	0	0
16	25035129	.	A	G	7	17	24	0	1	25	0	0
16	25035169	.	G	T	11	16	27	0	0	27	0	0
16	25035471	.	A	G	9	8	17	0	1	18	0	0
16	25035906	.	A	T	6	12	18	0	2	20	0	0
16	25036217	.	C	T	6	13	19	0	1	20	0	0
16	25038011	.	T	C	14	13	27	0	1	28	0	0
16	25038185	.	A	T	7	12	19	0	1	21	1	0
16	25066960	.	C	T	4	4	8	0	0	8	0	0
16	25070393	.	A	C	4	7	11	0	0	11	0	0
16	25070693	.	A	G	6	9	15	0	0	15	0	0
16	25070990	.	A	C	7	6	13	0	1	14	0	0
16	25071231	.	T	G	12	5	17	0	0	17	0	0
16	25071329	.	T	G	7	0	7	0	10	17	0	0
16	25071443	.	A	C	9	11	20	0	1	21	0	0
16	25071518	.	C	A	12	8	20	0	0	20	0	0
16	25071533	.	A	G	11	6	17	0	0	17	0	0
16	25071614	.	C	T	11	6	17	0	0	17	0	0
16	25072355	.	G	A	5	4	9	0	0	9	0	0
16	25076704	.	A	G	7	6	13	0	0	13	0	0
16	25076831	.	T	A	2	5	7	0	0	7	0	0
16	25077410	.	G	A	1	5	6	0	6	12	0	0
16	25077608	.	C	T	6	3	9	0	0	9	0	0
16	25078715	.	A	G	6	5	11	0	1	12	0	0
16	25078815	.	G	C	3	8	11	0	1	12	0	0
16	25078907	.	T	A	5	4	9	0	0	9	0	0
16	25079407	.	A	C	2	2	4	1	2	7	0	0
16	25080042	.	G	T	1	3	4	0	0	4	0	0
16	25080207	.	C	T	1	4	5	0	0	5	0	0
16	25080236	.	G	T	4	4	8	0	0	8	0	0
16	25080252	.	A	T	4	4	8	0	0	8	0	0
16	25080367	.	G	A	4	3	7	0	0	7	0	0
16	25104196	.	A	G	17	13	30	0	0	30	0	0
16	25104226	.	A	G	17	14	31	0	1	32	0	0
16	25104595	.	C	T	14	10	24	0	0	24	0	0
16	25104899	.	T	G	8	17	25	0	0	25	0	0
16	25104970	.	T	C	5	16	21	0	0	21	0	0
16	25111665	.	C	A	6	4	10	0	0	10	0	0
16	25111794	.	G	A	4	6	10	0	0	10	0	0
16	25111899	.	G	A	9	4	13	0	0	13	0	0
16	25111920	.	G	A	2	6	8	0	8	16	0	0
16	25112001	.	A	G	5	10	15	0	0	15	0	0
16	25112316	.	G	A	6	5	11	0	0	11	0	0
16	25118688	.	G	A	1	6	7	0	1	8	0	0
16	25118733	.	A	G	2	5	7	0	0	7	0	0
16	25118847	.	T	C	1	2	3	0	1	4	0	0
16	25119126	.	C	T	3	6	9	0	0	9	0	0
16	25119142	.	A	C	3	5	8	0	0	8	0	0
16	25119501	.	T	A	1	2	3	0	0	3	0	0
16	25119537	.	C	T	5	2	7	0	0	7	0	0
16	25119660	.	C	A	2	4	6	0	0	6	0	0
16	25119690	.	C	T	3	2	5	0	0	5	0	0
16	25119813	.	C	T	5	4	9	0	0	9	0	0
16	25121209	.	G	A	0	4	4	0	3	7	0	0
16	25121363	.	T	C	3	11	14	0	0	14	0	0
16	25121423	.	T	C	2	7	9	0	1	10	0	0
16	25121694	.	T	C	7	8	15	0	1	16	0	0
16	25121812	.	T	A	8	13	21	0	0	21	0	0
16	25121851	.	G	A	7	10	17	0	1	18	0	0
16	25121878	.	G	A	6	5	11	0	3	14	0	0
16	25121970	.	C	T	8	4	12	0	0	12	0	0
16	25122240	.	C	T	5	2	7	0	0	7	0	0
16	25122387	.	C	T	8	5	13	0	0	13	0	0
16	25122503	.	C	T	11	13	24	0	0	24	0	0
16	25122528	.	C	A	5	15	20	0	1	21	0	0
16	25122770	.	T	A	9	3	12	0	0	12	0	0
16	25123058	.	A	G	2	10	12	0	0	12	0	0
16	25123061	.	A	G	9	3	12	0	1	13	0	0
16	25123221	.	C	A	2	5	7	0	0	7	0	0
16	25123247	.	G	T	5	5	10	0	0	10	0	0
16	25123294	.	T	G	8	0	8	0	8	16	0	0
16	25123382	.	G	T	5	7	12	0	0	12	0	0
16	25123505	.	A	T	0	3	3	0	0	3	0	0
16	25123884	.	C	G	5	3	8	0	0	8	0	0
16	25124500	.	G	A	2	3	5	0	1	6	0	0
16	25124763	.	A	T	7	3	10	0	0	10	0	0
16	25142302	.	G	A	1	3	4	0	2	6	0	0
16	25142500	.	G	A	1	6	7	0	6	13	0	0
16	25146107	.	A	T	4	2	6	0	0	6	0	0
16	25148515	.	C	T	4	3	7	0	0	7	0	0
16	25148565	.	G	A	1	7	8	0	4	12	0	0
16	25148725	.	C	T	6	5	11	0	2	13	0	0
16	25148748	.	G	A	1	4	5	0	4	9	0	0
16	25149191	.	G	A	3	4	7	0	0	7	0	0
16	25149228	.	C	T	2	8	10	0	0	10	0	0
16	25149254	.	G	T	4	8	12	0	1	13	0	0
16	25149294	.	T	A	5	9	14	0	1	15	0	0
16	25149433	.	C	T	5	5	10	0	0	10	0	0
16	25149474	.	C	T	5	5	10	0	1	11	0	0
16	25149563	.	T	G	5	2	7	0	0	7	0	0
16	25149654	.	T	C	4	7	11	0	1	12	0	0
16	25149797	.	C	G	7	6	13	0	0	13	0	0
16	25149819	.	T	C	5	5	10	0	1	11	0	0
16	25149889	.	A	G	3	5	8	0	3	11	0	0
16	25149939	.	G	A	3	5	8	0	1	9	0	0
16	25149954	.	C	G	3	4	7	0	0	7	0	0
16	25149992	.	A	C	2	3	5	0	1	6	0	0
16	25150307	.	T	G	3	0	3	0	5	8	0	0
16	25150464	.	G	C	0	6	6	0	7	13	0	0
16	25150641	.	C	T	4	4	8	0	1	9	0	0
16	25151012	.	T	C	8	7	15	0	0	15	0	0
16	25151059	.	G	A	0	10	10	0	4	14	0	0
16	25151079	.	A	G	1	0	1	0	9	10	0	0
16	25151419	.	G	A	5	7	12	0	0	12	0	0
16	25151456	.	G	A	3	6	9	0	0	9	0	0
16	25151512	.	G	C	5	3	8	0	0	8	0	0
16	25151554	.	G	T	5	2	7	0	1	8	0	0
16	25154115	.	C	T	8	3	11	0	0	11	0	0
16	25154180	.	T	C	3	7	10	0	0	10	0	0
16	25157440	.	A	C	4	6	10	0	1	11	0	0
16	25160922	.	A	T	4	4	8	0	0	8	0	0
16	25161292	.	A	G	7	6	13	0	0	13	0	0
16	25161693	.	G	A	9	6	15	0	1	16	0	0
16	25161739	.	T	C	11	10	21	0	0	21	0	0
16	25161873	.	G	A	3	11	14	0	10	24	0	0
16	25162163	.	G	T	2	3	5	0	0	5	0	0
16	25162320	.	T	A	2	2	4	0	1	5	0	0
16	25162514	.	G	A	1	6	7	0	5	12	0	0
16	25162516	.	T	C	6	6	12	0	0	12	0	0
16	25164326	.	C	A	11	7	18	0	0	18	0	0
16	25168548	.	G	A	8	12	20	0	0	20	0	0
16	25169003	.	A	G	10	9	19	0	0	19	0	0
16	25169501	.	T	A	2	3	5	0	0	5	0	0
16	25176780	.	C	A	2	4	6	0	0	6	0	0
16	25232084	.	T	G	1	2	3	0	1	4	0	0
16	25232085	.	G	T	2	2	4	0	0	4	0	0
16	25232712	.	C	T	1	3	4	0	5	9	0	0
16	25232967	.	G	A	4	3	7	0	1	8	0	0
16	25233226	.	T	C	1	2	3	0	0	3	0	0
16	25233230	.	T	G	1	2	3	0	0	3	0	0
16	25259477	.	T	A	3	3	6	0	0	6	0	0
16	25269825	.	C	G	4	7	11	0	1	12	0	0
16	25272148	.	G	T	1	4	5	0	0	5	0	0
16	25272149	.	A	G	1	4	5	0	0	5	0	0
16	25275909	.	A	C	5	13	18	0	1	19	0	0
16	25275984	.	C	T	1	21	22	0	12	34	0	0
16	25276281	.	G	A	13	16	29	0	0	29	0	0
16	25276387	.	T	A	6	16	22	0	0	22	0	0
16	25285506	.	G	A	15	22	37	0	1	38	0	0
16	25285507	.	G	A	16	23	39	0	0	39	0	0
16	25308516	.	C	T	4	2	6	0	0	6	0	0
16	25311000	.	T	C	5	5	10	0	0	10	0	0
16	25311038	.	A	T	2	7	9	0	0	9	0	0
16	25311394	.	G	A	6	2	8	0	0	8	0	0
16	25311711	.	G	T	2	3	5	0	1	6	0	0
16	25311714	.	G	A	2	4	6	0	0	6	0	0
16	25311772	.	G	A	9	5	14	0	0	14	0	0
16	25314682	.	C	T	6	9	15	0	0	15	0	0
16	25327730	.	C	T	8	9	17	0	0	17	0	0
16	25334326	.	A	G	12	10	22	0	2	24	0	0
16	25334333	.	G	A	10	12	22	0	1	23	0	0
16	25344035	.	T	C	2	3	5	0	0	5	0	0
16	25344133	.	A	G	6	4	10	0	0	10	0	0
16	25348038	.	T	C	1	2	3	0	0	3	0	0
16	25348683	.	T	C	5	3	8	0	0	8	0	0
16	25349279	.	T	C	4	4	8	0	1	9	0	0
16	25349581	.	G	T	3	4	7	0	1	8	0	0
16	25353019	.	C	T	3	3	6	0	0	6	0	0
16	25354336	.	G	A	2	5	7	0	1	8	0	0
16	25354502	.	A	T	1	2	3	0	0	3	0	0
16	25356717	.	A	C	2	2	4	0	0	4	0	0
16	25357980	.	T	A	3	5	8	0	0	8	0	0
16	25357989	.	C	T	3	5	8	0	0	8	0	0
16	25360557	.	T	A	7	6	13	0	1	14	0	0
16	25360605	.	C	A	5	6	11	0	1	12	0	0
16	25373900	.	A	C	4	7	11	0	0	11	0	0
16	25373924	.	G	A	3	7	10	0	0	10	0	0
16	25374135	.	G	A	6	6	12	0	0	12	0	0
16	25374139	.	T	A	6	5	11	0	1	12	0	0
16	25374275	.	T	C	2	7	9	0	0	9	0	0
16	25374365	.	T	C	3	4	7	0	0	7	0	0
16	25374417	.	C	T	1	5	6	0	6	12	0	0
16	25374507	.	T	C	8	0	8	0	4	12	0	0
16	25374508	.	T	G	7	4	11	0	1	12	0	0
16	25374648	.	G	A	9	5	14	0	0	14	0	0
16	25375019	.	T	C	10	0	10	0	8	18	0	0
16	25376046	.	T	A	11	8	19	0	0	19	0	0
16	25376286	.	A	G	2	4	6	0	1	7	0	0
16	25376307	.	A	C	2	2	4	0	0	4	0	0
16	25376586	.	A	G	4	3	7	0	0	7	0	0
16	25376700	.	A	G	5	6	11	0	0	11	0	0
16	25376808	.	T	C	3	4	7	0	0	7	0	0
16	25388899	.	G	A	10	8	18	0	0	18	0	0
16	25389061	.	C	T	1	8	9	0	9	18	0	0
16	25389424	.	G	A	20	8	28	0	0	28	0	0
16	25389425	.	C	A	19	8	27	0	0	27	0	0
16	25391411	.	A	G	9	7	16	0	0	16	0	0
16	25393277	.	G	T	10	11	21	0	0	21	0	0
16	25395154	.	G	T	6	3	9	0	1	10	0	0
16	25395700	.	A	T	4	3	7	0	0	7	0	0
16	25395702	.	G	T	5	3	8	0	0	8	0	0
16	25399585	.	A	T	2	8	10	0	0	10	0	0
16	25399588	.	A	T	2	8	10	0	0	10	0	0
16	25407294	.	T	C	3	4	7	0	0	7	0	0
16	25407426	.	A	T	2	2	4	0	1	5	0	0
16	25407532	.	A	C	3	4	7	0	0	7	0	0
16	25445746	.	G	A	12	9	21	0	0	21	0	0
16	25454790	.	C	T	6	10	16	0	0	16	0	0
16	25454829	.	G	T	1	8	9	0	4	13	0	0
16	25463401	.	C	A	9	8	17	0	1	18	0	0
16	25470975	.	A	G	8	9	17	0	0	17	0	0
16	25477398	.	G	C	0	5	5	0	11	16	0	0
16	25477428	.	G	A	9	5	14	0	0	14	0	0
16	25477736	.	A	G	4	2	6	0	0	6	0	0
16	25487346	.	T	C	4	4	8	0	0	8	0	0
16	25487720	.	A	G	13	5	18	0	2	20	0	0
16	25504192	.	G	C	13	13	26	0	0	26	0	0
16	25504337	.	G	A	18	6	24	0	1	25	0	0
16	25504425	.	G	T	21	5	26	0	0	26	0	0
16	25504467	.	G	A	18	6	24	0	0	24	0	0
16	25504537	.	T	C	15	2	17	0	19	36	0	0
16	25504792	.	G	C	35	18	53	0	2	55	0	0
16	25504900	.	G	A	31	19	50	0	0	50	0	0
16	25507643	.	T	A	1	7	8	0	0	8	0	0
16	25507696	.	T	C	5	3	8	0	0	8	0	0
16	25527520	.	C	T	18	14	32	0	0	32	0	0
16	25527541	.	T	G	15	14	29	0	0	29	0	0
16	25555775	.	G	A	15	13	28	0	0	28	0	0
16	25558135	.	C	T	9	7	16	0	2	18	0	0
16	25558595	.	C	T	15	10	25	0	1	26	0	0
16	25559842	.	G	A	4	7	11	0	2	13	0	0
16	25559886	.	T	A	4	8	12	0	0	12	0	0
16	25560184	.	A	G	10	6	16	0	0	16	0	0
16	25561795	.	C	A	8	9	17	0	1	18	0	0
16	25593973	.	G	A	5	4	9	0	0	9	0	0
16	25594415	.	C	T	9	6	15	0	0	15	0	0
16	25597613	.	C	T	2	3	5	0	5	10	0	0
16	25642663	.	G	A	11	16	27	0	1	28	0	0
16	25643452	.	T	A	3	8	11	0	0	11	0	0
16	25644357	.	C	A	6	6	12	0	1	13	0	0
16	25673880	.	T	C	9	8	17	0	0	17	0	0
16	25683018	.	T	C	9	4	13	0	1	14	0	0
16	25698449	.	A	C	4	7	11	0	0	11	0	0
16	25811469	.	T	A	2	1	3	0	0	3	0	0
16	25811472	.	C	T	2	2	4	0	0	4	0	0
16	26046772	.	A	G	10	10	20	0	0	20	0	0
16	26074459	.	G	T	12	10	22	0	2	24	0	0
16	26141395	.	C	A	9	4	13	0	0	13	0	0
16	26141396	.	T	C	9	0	9	0	4	13	0	0
16	26141694	.	T	A	10	3	13	0	1	14	0	0
16	26141748	.	T	C	6	2	8	0	2	10	0	0
16	26141968	.	A	G	7	3	10	0	0	10	0	0
16	26141994	.	T	C	3	5	8	0	0	8	0	0
16	26142105	.	C	T	5	7	12	0	0	12	0	0
16	26142209	.	C	T	3	5	8	0	1	9	0	0
16	26142218	.	G	A	2	4	6	0	1	7	0	0
16	26142311	.	A	C	13	4	17	1	1	19	0	0
16	26142405	.	A	G	1	8	9	0	0	9	0	0
16	26142773	.	G	A	6	10	16	0	1	17	0	0
16	26142779	.	C	T	7	10	17	0	0	17	0	0
16	26143082	.	A	G	3	2	5	0	1	6	0	0
16	26143371	.	T	G	7	10	17	0	0	17	0	0
16	26143538	.	C	T	6	8	14	0	0	14	0	0
16	26146174	.	G	A	9	9	18	0	1	19	0	0
16	26146736	.	G	A	9	11	20	0	0	20	0	0
16	26169515	.	T	G	7	6	13	0	0	13	0	0
16	26170400	.	A	G	2	5	7	0	1	8	0	0
16	26170412	.	G	A	4	4	8	0	0	8	0	0
16	26186178	.	C	A	4	7	11	0	0	11	0	0
16	26186187	.	G	C	4	0	4	0	6	10	0	0
16	26188312	.	C	T	1	6	7	0	0	7	0	0
16	26232369	.	G	T	5	2	7	0	1	8	0	0
16	26234761	.	A	C	4	4	8	0	0	8	0	0
16	26236200	.	A	C	2	4	6	0	0	6	0	0
16	26236208	.	G	C	2	4	6	0	0	6	0	0
16	26236263	.	G	A	4	4	8	0	0	8	0	0
16	26236664	.	C	A	2	2	4	0	0	4	0	0
16	26236813	.	G	C	2	3	5	0	1	6	0	0
16	26237501	.	A	T	5	3	8	0	0	8	0	0
16	26237564	.	T	A	4	4	8	0	1	9	0	0
16	26378553	.	T	A	4	3	7	0	0	7	0	0
16	26378655	.	T	C	6	0	6	0	5	11	0	0
16	26378665	.	G	T	6	6	12	0	0	12	0	0
16	26378706	.	G	T	4	4	8	0	0	8	0	0
16	26378729	.	A	G	1	2	3	0	0	3	0	0
16	26379247	.	T	A	2	5	7	0	0	7	0	0
16	26379249	.	T	A	2	5	7	0	0	7	0	0
16	26380784	.	C	T	1	7	8	0	13	21	0	0
16	26380866	.	G	A	4	6	10	0	3	13	0	0
16	26381192	.	T	G	16	5	21	0	1	22	0	0
16	26381271	.	C	T	12	12	24	0	0	24	0	0
16	26381344	.	T	G	14	8	22	0	1	23	0	0
16	26381463	.	C	T	3	20	23	0	15	38	0	0
16	26381538	.	T	A	14	4	18	0	1	19	0	0
16	26381768	.	C	T	1	9	10	0	11	21	0	0
16	26382084	.	T	C	9	12	21	0	1	22	0	0
16	26382225	.	A	T	18	18	36	0	1	37	0	0
16	26382243	.	G	A	19	15	34	0	2	36	0	0
16	26382308	.	T	C	18	13	31	0	1	32	0	0
16	26382453	.	T	C	15	0	15	0	8	23	0	0
16	26382585	.	A	G	6	8	14	0	0	14	0	0
16	26382942	.	T	C	14	13	27	0	1	28	0	0
16	26383016	.	C	T	1	16	17	0	24	41	0	0
16	26384188	.	C	G	13	12	25	0	0	25	0	0
16	26384417	.	G	A	15	10	25	0	1	26	0	0
16	26386817	.	T	C	11	5	16	0	2	18	0	0
16	26388840	.	A	G	8	12	20	0	1	21	0	0
16	26391447	.	A	G	6	10	16	0	0	16	0	0
16	26391450	.	C	T	6	10	16	0	0	16	0	0
16	26391970	.	C	A	0	13	13	0	9	22	0	0
16	26393459	.	G	T	11	4	15	0	0	15	0	0
16	26396381	.	A	C	7	7	14	0	0	14	0	0
16	26398268	.	C	T	0	3	3	0	5	8	0	0
16	26398488	.	G	A	5	3	8	0	1	9	0	0
16	26399488	.	C	T	1	7	8	0	4	12	0	0
16	26404077	.	A	G	4	3	7	0	0	7	0	0
16	26408819	.	G	A	4	7	11	0	0	11	0	0
16	26408847	.	C	T	6	7	13	0	0	13	0	0
16	26410903	.	G	A	9	4	13	0	0	13	0	0
16	26413746	.	T	C	3	0	3	0	10	13	0	0
16	26420512	.	C	G	2	7	9	0	0	9	0	0
16	26424248	.	C	T	3	3	6	0	1	7	0	0
16	26426186	.	T	G	5	3	8	0	0	8	0	0
16	26426225	.	T	A	4	5	9	0	0	9	0	0
16	26428591	.	G	C	3	1	4	0	0	4	0	0
16	26428600	.	G	A	3	2	5	0	1	6	0	0
16	26431539	.	A	C	4	5	9	0	0	9	0	0
16	26431590	.	G	T	1	2	3	0	0	3	0	0
16	26431974	.	C	A	3	3	6	0	0	6	0	0
16	26435405	.	C	A	5	3	8	0	0	8	0	0
16	26435424	.	A	G	5	3	8	0	1	9	0	0
16	26435467	.	G	A	5	2	7	0	1	8	0	0
16	26437225	.	C	T	1	5	6	0	2	8	0	0
16	26437254	.	A	C	3	6	9	0	0	9	0	0
16	26437307	.	C	A	1	4	5	0	4	10	1	0
16	26437452	.	A	T	4	5	9	0	0	9	0	0
16	26439610	.	A	T	2	5	7	0	1	8	0	0
16	26439860	.	T	C	7	5	12	0	1	13	0	0
16	26441624	.	A	T	4	6	10	0	0	10	0	0
16	26443976	.	C	T	5	5	10	0	1	11	0	0
16	26444976	.	T	A	6	3	9	0	0	9	0	0
16	26445676	.	A	G	6	0	6	0	3	9	0	0
16	26445990	.	G	A	1	2	3	0	1	4	0	0
16	26446163	.	T	A	2	2	4	0	0	4	0	0
16	26475138	.	C	T	1	3	4	0	0	4	0	0
16	26479285	.	G	T	3	2	5	0	0	5	0	0
16	26479307	.	A	G	3	2	5	0	0	5	0	0
16	26483276	.	A	G	2	2	4	0	0	4	0	0
16	26483510	.	T	A	3	2	5	0	0	5	0	0
16	26483511	.	C	T	3	2	5	0	0	5	0	0
16	26510997	.	G	A	3	4	7	0	0	7	0	0
16	26513182	.	G	A	1	3	4	0	0	4	0	0
16	26516813	.	G	C	8	7	15	0	2	17	0	0
16	26517226	.	G	A	3	2	5	0	0	5	0	0
16	26517227	.	T	G	3	2	5	0	0	5	0	0
16	26519040	.	G	A	1	2	3	0	0	3	0	0
16	26521433	.	G	A	1	4	5	0	0	5	0	0
16	26523927	.	C	T	3	2	5	0	0	5	0	0
16	26524016	.	G	T	1	2	3	0	0	3	0	0
16	26524032	.	T	C	1	2	3	0	0	3	0	0
16	26525860	.	A	C	4	4	8	0	0	8	0	0
16	26536987	.	C	T	1	2	3	0	2	5	0	0
16	26600209	.	A	G	1	2	3	0	0	3	0	0
16	26612488	.	T	C	6	5	11	0	1	12	0	0
16	26620151	.	G	T	0	9	9	0	10	19	0	0
16	26643598	.	G	C	11	6	17	0	0	17	0	0
16	26643769	.	A	T	2	5	7	0	0	7	0	0
16	26689955	.	T	C	8	9	17	0	0	17	0	0
16	26690971	.	C	A	3	2	5	0	0	5	0	0
16	26691145	.	T	A	4	4	8	0	0	8	0	0
16	26691151	.	A	T	4	4	8	0	0	8	0	0
16	26691185	.	G	A	8	3	11	0	2	13	0	0
16	26691240	.	G	A	8	5	13	0	2	15	0	0
16	26691295	.	G	A	1	3	4	0	4	8	0	0
16	26691301	.	C	A	3	3	6	0	0	6	0	0
16	26691491	.	C	T	3	4	7	0	1	8	0	0
16	26691622	.	G	A	7	4	11	0	0	11	0	0
16	26691646	.	T	C	4	3	7	0	1	8	0	0
16	26691832	.	A	T	6	8	14	0	0	14	0	0
16	26691880	.	C	T	9	8	17	0	0	17	0	0
16	26694669	.	C	T	6	5	11	0	0	11	0	0
16	26696120	.	G	C	3	3	6	0	0	6	0	0
16	26696759	.	T	G	7	5	12	0	0	12	0	0
16	26696816	.	A	T	3	2	5	0	0	5	0	0
16	26698589	.	G	A	8	3	11	0	0	11	0	0
16	26702745	.	T	C	12	14	26	0	1	27	0	0
16	26702786	.	G	A	1	10	11	0	11	22	0	0
16	26702870	.	T	C	12	9	21	0	0	21	0	0
16	26703111	.	T	C	8	11	19	0	0	19	0	0
16	26706584	.	G	A	9	4	13	0	1	14	0	0
16	26706820	.	C	T	8	7	15	0	1	16	0	0
16	26710900	.	C	A	14	17	31	0	0	31	0	0
16	26710954	.	A	T	13	10	23	0	0	23	0	0
16	26710957	.	G	A	13	9	22	0	1	23	0	0
16	26713964	.	G	T	14	14	28	0	0	28	0	0
16	26717457	.	C	A	3	4	7	0	0	7	0	0
16	26766475	.	C	T	8	6	14	0	2	16	0	0
16	26766508	.	A	T	9	9	18	0	0	18	0	0
16	26766807	.	A	G	3	4	7	0	0	7	0	0
16	26766878	.	A	T	5	7	12	0	1	13	0	0
16	26768949	.	C	G	2	4	6	0	0	6	0	0
16	26816852	.	G	T	8	11	19	0	0	19	0	0
16	26817069	.	C	T	1	9	10	0	5	15	0	0
16	26817178	.	T	A	8	9	17	0	0	17	0	0
16	26817304	.	T	C	10	0	10	0	11	21	0	0
16	26817358	.	C	T	14	8	22	0	0	22	0	0
16	26817556	.	T	C	11	0	11	0	9	20	0	0
16	26817631	.	C	T	1	7	8	0	5	13	0	0
16	26817754	.	C	T	1	13	14	0	6	20	0	0
16	26817823	.	A	T	4	9	13	0	0	13	0	0
16	26817898	.	G	A	7	5	12	0	0	12	0	0
16	26817922	.	T	C	7	0	7	0	8	15	0	0
16	26818213	.	A	T	2	5	7	0	0	7	0	0
16	26818666	.	A	C	9	5	14	0	0	14	0	0
16	26850833	.	C	T	5	5	10	0	0	10	0	0
16	26850845	.	T	C	4	6	10	0	2	12	0	0
16	26850870	.	G	A	5	8	13	0	0	13	0	0
16	26850885	.	C	T	4	10	14	0	0	14	0	0
16	26851161	.	C	T	0	3	3	0	7	10	0	0
16	26851191	.	C	T	6	8	14	0	0	14	0	0
16	26855674	.	A	G	4	12	16	0	0	16	0	0
16	26855833	.	C	A	0	15	15	0	8	23	0	0
16	26855859	.	C	A	0	16	16	0	12	28	0	0
16	26855909	.	A	G	7	5	12	0	0	12	0	0
16	26863622	.	T	C	5	5	10	0	0	10	0	0
16	26994588	.	C	T	11	5	16	0	0	16	0	0
16	27025096	.	T	C	7	15	22	0	0	22	0	0
16	27061912	.	A	C	8	12	20	0	1	21	0	0
16	27064864	.	A	G	9	5	14	0	1	15	0	0
16	27069608	.	A	G	8	0	8	0	13	21	0	0
16	27080221	.	T	C	10	5	15	0	1	16	0	0
16	27100222	.	T	C	11	7	18	0	1	19	0	0
16	27127959	.	G	A	18	17	35	0	0	35	0	0
16	27136541	.	A	G	21	17	38	0	0	38	0	0
16	27138391	.	C	G	21	19	40	0	0	40	0	0
16	27148691	.	C	T	12	11	23	0	1	24	0	0
16	27148861	.	G	T	13	7	20	0	2	22	0	0
16	27158753	.	T	C	14	13	27	0	0	27	0	0
16	27159111	.	A	G	11	7	18	0	2	20	0	0
16	27159205	.	T	C	15	0	15	0	12	27	0	0
16	27161327	.	A	T	16	6	22	0	0	22	0	0
16	27166174	.	A	G	9	6	15	0	0	15	0	0
16	27166205	.	A	G	13	7	20	0	1	21	0	0
16	27166277	.	G	A	16	21	37	0	2	39	0	0
16	27169664	.	A	T	19	16	35	0	1	36	0	0
16	27170170	.	G	A	16	13	29	0	2	31	0	0
16	27222820	.	A	G	1	3	4	0	0	4	0	0
16	27222985	.	A	T	2	4	6	0	0	6	0	0
16	27224450	.	G	C	22	15	37	1	4	42	0	0
16	27225215	.	C	A	15	15	30	1	0	31	0	0
16	27231416	.	C	T	19	24	43	0	2	45	0	0
16	27345418	.	C	T	5	8	13	0	1	14	0	0
16	27346195	.	T	C	7	11	18	0	2	20	0	0
16	27367624	.	A	G	14	5	19	1	1	21	0	0
16	27367834	.	A	C	6	1	7	0	15	22	0	0
16	27368086	.	T	C	5	6	11	0	1	12	0	0
16	27368168	.	A	G	10	1	11	0	10	21	0	0
16	27368290	.	G	A	0	10	10	0	15	25	0	0
16	27369057	.	T	C	1	8	9	0	0	9	0	0
16	27392680	.	C	T	1	2	3	0	0	3	0	0
16	27417415	.	C	A	4	4	8	0	0	8	0	0
16	27417907	.	T	C	15	0	15	0	11	26	0	0
16	27427109	.	T	C	10	11	21	0	2	23	0	0
16	27427919	.	A	G	13	15	28	0	1	29	0	0
16	27428048	.	G	A	8	14	22	0	1	23	0	0
16	27430189	.	G	A	12	11	23	0	1	24	0	0
16	27508505	.	G	A	4	3	7	0	0	7	0	0
16	27513694	.	T	C	7	5	12	0	0	12	0	0
16	27522744	.	T	C	5	3	8	0	0	8	0	0
16	27524890	.	A	T	9	4	13	0	0	13	0	0
16	27524893	.	A	T	9	5	14	0	0	14	0	0
16	27529856	.	G	A	2	3	5	0	0	5	0	0
16	27533600	.	A	G	7	4	11	0	0	11	0	0
16	27533654	.	G	C	4	3	7	0	0	7	0	0
16	27533729	.	T	C	2	0	2	0	6	8	0	0
16	27536757	.	C	T	0	4	4	0	6	10	0	0
16	27539330	.	A	C	6	4	10	0	0	10	0	0
16	27539462	.	G	T	4	7	11	0	0	11	0	0
16	27542395	.	A	G	5	2	7	0	0	7	0	0
16	27542452	.	C	G	4	2	6	0	0	6	0	0
16	27543577	.	G	T	1	6	7	0	12	19	0	0
16	27548076	.	A	G	10	6	16	0	1	17	0	0
16	27554909	.	C	G	17	8	25	0	0	25	0	0
16	27555010	.	T	C	20	10	30	0	0	30	0	0
16	27555011	.	A	C	20	10	30	0	0	30	0	0
16	27555069	.	C	T	19	23	42	0	0	42	0	0
16	27555175	.	T	C	10	11	21	0	2	23	0	0
16	27555221	.	C	T	10	14	24	0	0	24	0	0
16	27569881	.	A	G	3	2	5	0	0	5	0	0
16	27571147	.	A	T	4	3	7	0	1	8	0	0
16	27578193	.	A	G	2	2	4	0	0	4	0	0
16	27578607	.	T	A	2	4	6	0	1	7	0	0
16	27608469	.	T	C	2	2	4	0	0	4	0	0
16	27615050	.	T	A	2	5	7	0	0	7	0	0
16	27615203	.	A	G	13	19	32	0	1	33	0	0
16	27621830	.	T	G	8	15	23	0	0	23	0	0
16	27621869	.	A	G	6	16	22	0	1	23	0	0
16	27626228	.	G	A	25	24	49	0	2	51	0	0
16	27626240	.	A	G	27	26	53	0	3	56	0	0
16	27628860	.	A	T	14	15	29	0	1	30	0	0
16	27629052	.	C	T	19	23	42	0	1	43	0	0
16	27629187	.	A	G	21	14	35	0	2	37	0	0
16	27629455	.	T	G	26	20	46	0	0	46	0	0
16	27629639	.	C	A	27	23	50	0	1	51	0	0
16	27629798	.	A	T	23	16	39	0	1	40	0	0
16	27630087	.	C	T	4	24	28	0	25	53	0	0
16	27630209	.	T	C	24	21	45	0	3	48	0	0
16	27630399	.	G	T	22	25	47	0	2	49	0	0
16	27630663	.	G	A	19	20	39	0	1	40	0	0
16	27630785	.	G	A	20	19	39	0	2	41	0	0
16	27630998	.	T	C	11	0	11	0	19	30	0	0
16	27631229	.	A	T	17	13	30	0	1	31	0	0
16	27631585	.	T	A	15	20	35	0	1	36	0	0
16	27631690	.	T	G	20	15	35	0	1	37	1	0
16	27631741	.	C	A	17	11	28	0	1	29	0	0
16	27631751	.	T	A	13	12	25	0	2	27	0	0
16	27632153	.	C	T	15	10	25	0	0	25	0	0
16	27632189	.	G	A	14	8	22	0	3	25	0	0
16	27632228	.	C	T	13	13	26	0	1	27	0	0
16	27632289	.	C	T	11	12	23	0	1	24	0	0
16	27632520	.	A	T	19	12	31	0	0	31	0	0
16	27632705	.	G	A	12	17	29	0	2	31	0	0
16	27632879	.	T	C	19	12	31	0	0	31	0	0
16	27632880	.	G	A	19	12	31	0	0	31	0	0
16	27632934	.	T	C	6	8	14	0	0	14	0	0
16	27633392	.	C	T	4	22	26	0	13	39	0	0
16	27633812	.	C	T	15	12	27	0	4	31	0	0
16	27633839	.	T	C	16	1	17	0	13	30	0	0
16	27633940	.	C	G	8	11	19	0	2	21	0	0
16	27633950	.	G	T	7	14	21	0	0	21	0	0
16	27634003	.	G	A	8	15	23	0	0	23	0	0
16	27640955	.	C	A	0	10	10	2	18	30	0	0
16	27660271	.	A	G	10	3	13	0	0	13	0	0
16	27660321	.	G	A	9	4	13	0	0	13	0	0
16	27660441	.	T	C	3	2	5	0	0	5	0	0
16	27660566	.	T	C	3	3	6	0	0	6	0	0
16	27660567	.	T	C	3	0	3	0	3	6	0	0
16	27660658	.	A	T	3	8	11	0	2	13	0	0
16	27660750	.	C	T	0	8	8	0	5	13	0	0
16	27660868	.	A	G	2	3	5	0	2	7	0	0
16	27660934	.	C	T	6	14	20	0	0	20	0	0
16	27661074	.	A	T	12	5	17	0	0	17	0	0
16	27667213	.	G	A	9	3	12	0	0	12	0	0
16	27669912	.	T	C	3	1	4	0	2	6	0	0
16	27669917	.	T	G	2	4	6	0	0	6	0	0
16	27669993	.	G	C	9	10	19	0	0	19	0	0
16	27670010	.	A	T	6	6	12	0	0	12	0	0
16	27674156	.	A	G	1	3	4	0	0	4	0	0
16	27675865	.	A	C	1	4	5	0	1	6	0	0
16	27675950	.	G	A	3	5	8	0	1	9	0	0
16	27676008	.	G	A	2	6	8	0	0	8	0	0
16	27735648	.	A	G	3	2	5	0	0	5	0	0
16	27736717	.	A	T	1	2	3	0	0	3	0	0
16	27736767	.	C	T	1	3	4	0	0	4	0	0
16	27998813	.	A	T	2	3	5	0	1	6	0	0
16	28112951	.	C	A	2	2	4	0	1	5	0	0
16	28264350	.	C	T	3	4	7	0	0	7	0	0
16	28276383	.	T	C	10	11	21	0	2	23	0	0
16	28277340	.	C	G	15	12	27	0	0	27	0	0
16	28278360	.	T	C	5	4	9	0	2	11	0	0
16	28280057	.	T	C	8	4	12	0	0	12	0	0
16	28305482	.	G	T	10	5	15	0	1	16	0	0
16	28370465	.	C	T	14	16	30	0	3	33	0	0
16	28370513	.	G	C	16	13	29	0	2	31	0	0
16	28370566	.	A	C	14	7	21	0	1	22	0	0
16	28370703	.	A	G	4	3	7	0	1	8	0	0
16	28370872	.	T	A	1	4	5	0	1	6	0	0
16	28371138	.	T	C	4	8	12	0	0	12	0	0
16	28371148	.	A	G	3	8	11	0	1	12	0	0
16	28512653	.	C	T	1	3	4	0	1	5	0	0
16	28547195	.	A	T	6	2	8	0	1	10	1	0
16	28554272	.	C	T	4	6	10	0	2	12	0	0
16	28557842	.	A	G	3	0	3	0	5	8	0	0
16	28557889	.	G	A	1	4	5	0	0	5	0	0
16	28557909	.	G	A	0	1	1	0	4	5	0	0
16	28573328	.	G	C	0	11	11	0	8	19	0	0
16	28573634	.	C	T	15	7	22	0	0	22	0	0
16	28573871	.	A	C	14	6	20	0	0	20	0	0
16	28573957	.	T	A	9	5	14	0	0	14	0	0
16	28574403	.	C	T	8	4	12	0	0	12	0	0
16	28574465	.	G	A	0	7	7	0	8	15	0	0
16	28574531	.	T	G	10	6	16	0	1	17	0	0
16	28574664	.	G	A	4	7	11	0	1	12	0	0
16	28580818	.	A	G	12	9	21	0	0	21	0	0
16	28580884	.	T	C	14	8	22	0	0	22	0	0
16	28591186	.	T	A	14	13	27	0	2	29	0	0
16	28591277	.	A	G	9	23	32	0	2	34	0	0
16	28591353	.	A	C	6	10	16	0	0	16	0	0
16	28591385	.	C	G	8	5	13	0	3	16	0	0
16	28591459	.	G	A	0	15	15	0	11	26	0	0
16	28593394	.	G	A	8	3	11	0	0	11	0	0
16	28593403	.	G	A	10	3	13	0	0	13	0	0
16	28593430	.	G	A	7	5	12	0	2	14	0	0
16	28593502	.	G	A	6	3	9	0	1	10	0	0
16	28593802	.	T	C	7	8	15	0	0	15	0	0
16	28593867	.	T	C	9	0	9	0	6	15	0	0
16	28593952	.	T	C	10	4	14	0	1	15	0	0
16	28598955	.	T	A	6	2	8	0	0	8	0	0
16	28599150	.	C	T	19	21	40	0	0	40	0	0
16	28602433	.	C	A	1	4	5	0	0	5	0	0
16	28602514	.	A	G	4	4	8	0	0	8	0	0
16	28603202	.	A	G	3	1	4	0	3	7	0	0
16	28603465	.	C	T	1	5	6	0	0	6	0	0
16	28603485	.	C	T	1	5	6	0	0	6	0	0
16	28603517	.	T	A	3	2	5	0	0	5	0	0
16	28620777	.	A	G	1	7	8	0	1	9	0	0
16	28622321	.	G	A	2	5	7	0	1	8	0	0
16	28624580	.	T	C	3	3	6	0	1	7	0	0
16	28624646	.	C	T	10	6	16	0	0	16	0	0
16	28624648	.	G	C	0	6	6	0	10	16	0	0
16	28626474	.	T	C	4	3	7	0	0	7	0	0
16	28626743	.	A	G	3	5	8	0	1	9	0	0
16	28627005	.	C	T	5	5	10	0	1	11	0	0
16	28627127	.	C	T	5	2	7	0	0	7	0	0
16	28627178	.	A	G	4	2	6	0	0	6	0	0
16	28627467	.	C	T	4	3	7	0	0	7	0	0
16	28627485	.	C	T	3	4	7	0	1	8	0	0
16	28627507	.	G	A	3	4	7	0	0	7	0	0
16	28627520	.	G	A	3	4	7	0	0	7	0	0
16	28629504	.	C	T	6	9	15	0	0	15	0	0
16	28632525	.	C	T	8	9	17	0	0	17	0	0
16	28634954	.	G	A	3	7	10	0	1	11	0	0
16	28650049	.	T	G	1	2	3	0	0	3	0	0
16	28650111	.	G	A	3	5	8	0	0	8	0	0
16	28663361	.	C	T	0	2	2	0	3	5	0	0
16	28663405	.	A	G	2	2	4	0	0	4	0	0
16	28665520	.	C	T	0	1	1	0	2	3	0	0
16	28665543	.	T	C	2	0	2	0	2	4	0	0
16	28665912	.	G	T	2	3	5	0	0	5	0	0
16	28665925	.	C	T	2	4	6	0	2	8	0	0
16	28665984	.	T	G	1	5	6	0	0	6	0	0
16	28666079	.	C	A	3	2	5	0	0	5	0	0
16	28667189	.	C	A	2	3	5	0	0	5	0	0
16	28667313	.	A	G	5	6	11	0	0	11	0	0
16	28842438	.	C	T	35	18	53	0	2	55	0	0
16	28846595	.	G	T	27	14	41	0	3	44	0	0
16	28846647	.	G	T	21	18	39	0	2	41	0	0
16	28846761	.	T	C	16	23	39	0	2	41	0	0
16	28855946	.	C	G	22	15	37	0	2	39	0	0
16	28856026	.	G	A	21	33	54	0	1	55	0	0
16	28856034	.	G	A	19	31	50	0	0	50	0	0
16	28882792	.	T	A	1	3	4	0	0	4	0	0
16	28965773	.	C	T	2	2	4	0	0	4	0	0
16	28971390	.	C	T	2	9	11	0	0	11	0	0
16	28983689	.	G	A	1	3	4	0	0	4	0	0
16	28983897	.	G	A	1	5	6	0	0	6	0	0
16	28983936	.	T	C	2	5	7	0	0	7	0	0
16	28983939	.	C	T	2	5	7	0	0	7	0	0
16	28986722	.	A	G	5	3	8	0	0	8	0	0
16	28986728	.	C	T	6	3	9	0	0	9	0	0
16	29003349	.	C	T	4	3	7	0	0	7	0	0
16	29010125	.	C	T	2	6	8	0	0	8	0	0
16	29010293	.	T	G	6	0	6	0	3	9	0	0
16	29010819	.	A	G	5	4	9	0	0	9	0	0
16	29012933	.	G	T	1	5	6	0	11	17	0	0
16	29012961	.	C	T	7	4	11	0	1	12	0	0
16	29012992	.	A	G	4	0	4	0	7	11	0	0
16	29013039	.	C	G	6	8	14	0	0	14	0	0
16	29013188	.	C	T	2	5	7	0	0	7	0	0
16	29013327	.	C	A	3	7	10	0	1	11	0	0
16	29013377	.	C	T	7	8	15	0	0	15	0	0
16	29014091	.	A	T	3	7	10	0	1	11	0	0
16	29014109	.	T	C	5	7	12	0	0	12	0	0
16	29016904	.	T	C	6	7	13	0	0	13	0	0
16	29017221	.	T	C	6	4	10	0	0	10	0	0
16	29019039	.	G	A	5	11	16	0	3	19	0	0
16	29020482	.	G	T	8	19	27	0	0	27	0	0
16	29022955	.	C	A	9	3	12	0	0	12	0	0
16	29022963	.	A	G	9	4	13	0	0	13	0	0
16	29023266	.	A	T	6	4	10	0	1	11	0	0
16	29024280	.	T	G	5	0	5	0	6	11	0	0
16	29024405	.	C	T	2	4	6	0	0	6	0	0
16	29024409	.	C	T	2	5	7	0	0	7	0	0
16	29027541	.	T	C	4	5	9	0	0	9	0	0
16	29029296	.	T	C	6	2	8	0	1	9	0	0
16	29029444	.	G	A	2	4	6	0	0	6	0	0
16	29050827	.	C	T	1	3	4	0	0	4	0	0
16	29050911	.	C	T	3	2	5	0	0	5	0	0
16	29050983	.	A	G	1	2	3	0	0	3	0	0
16	29051095	.	A	T	1	3	4	0	0	4	0	0
16	29051102	.	G	A	1	2	3	0	0	3	0	0
16	29052030	.	C	T	8	7	15	0	0	15	0	0
16	29052096	.	G	T	1	5	6	0	5	11	0	0
16	29052120	.	A	G	5	5	10	0	0	10	0	0
16	29052137	.	A	G	3	6	9	0	0	9	0	0
16	29052156	.	A	G	4	6	10	0	0	10	0	0
16	29052245	.	G	T	2	2	4	0	0	4	0	0
16	29052653	.	A	T	10	5	15	0	0	15	0	0
16	29052914	.	G	A	7	5	12	0	0	12	0	0
16	29052991	.	C	T	7	7	14	0	0	14	0	0
16	29053045	.	T	A	5	6	11	0	0	11	0	0
16	29053166	.	A	G	2	2	4	0	0	4	0	0
16	29053781	.	A	T	5	11	16	0	1	17	0	0
16	29053798	.	C	G	5	0	5	0	14	19	0	0
16	29073539	.	C	T	13	7	20	0	4	24	0	0
16	29073621	.	T	A	8	4	12	0	0	12	0	0
16	29074254	.	G	A	24	27	51	0	2	53	0	0
16	29074535	.	A	G	12	16	28	0	1	29	0	0
16	29074688	.	A	G	20	17	37	0	1	38	0	0
16	29075222	.	T	A	18	7	25	0	1	26	0	0
16	29075343	.	G	A	24	11	35	0	1	36	0	0
16	29075674	.	C	A	15	17	32	1	1	36	2	0
16	29075757	.	A	G	17	13	30	0	0	30	0	0
16	29075870	.	G	T	17	14	31	0	1	33	1	0
16	29075959	.	C	T	15	6	21	0	0	21	0	0
16	29076009	.	T	A	16	11	27	0	1	28	0	0
16	29076019	.	A	C	17	12	29	0	0	31	2	0
16	29076407	.	C	T	3	16	19	0	28	47	0	0
16	29076575	.	C	G	2	15	17	0	26	43	0	0
16	29076633	.	G	A	25	23	48	0	1	50	1	0
16	29076669	.	A	G	25	23	48	0	2	50	0	0
16	29076678	.	T	C	24	0	24	0	23	47	0	0
16	29091699	.	T	C	20	23	43	0	0	43	0	0
16	29111066	.	T	C	9	0	9	0	17	26	0	0
16	29146310	.	A	G	21	13	34	0	0	34	0	0
16	29146623	.	G	A	7	15	22	0	0	22	0	0
16	29146646	.	A	G	9	15	24	0	1	25	0	0
16	29194443	.	A	G	16	15	31	0	0	31	0	0
16	29222033	.	T	C	15	20	35	0	0	35	0	0
16	29222167	.	G	A	12	18	30	0	0	30	0	0
16	29225752	.	A	G	1	3	4	0	0	4	0	0
16	29225763	.	A	G	1	4	5	0	0	5	0	0
16	29225902	.	G	C	5	14	19	0	1	20	0	0
16	29226151	.	C	T	5	7	12	0	0	12	0	0
16	29226538	.	G	T	2	4	6	0	0	6	0	0
16	29226566	.	T	C	5	3	8	0	0	8	0	0
16	29266115	.	G	A	4	2	6	0	0	6	0	0
16	29266140	.	A	C	4	3	7	0	0	7	0	0
16	29305685	.	A	G	3	4	7	0	0	7	0	0
16	29306111	.	C	T	3	10	13	0	0	13	0	0
16	29306983	.	T	C	9	4	13	0	0	13	0	0
16	29307100	.	G	C	7	3	10	0	0	10	0	0
16	29310150	.	T	A	3	6	9	0	0	9	0	0
16	29310206	.	A	G	9	2	11	0	0	11	0	0
16	29310213	.	C	A	9	2	11	0	0	11	0	0
16	29310281	.	C	G	15	8	23	0	1	24	0	0
16	29310530	.	C	A	25	8	33	0	2	35	0	0
16	29311367	.	C	A	19	7	26	0	2	28	0	0
16	29311381	.	G	A	17	7	24	0	4	28	0	0
16	29311489	.	A	G	10	16	26	0	1	27	0	0
16	29313766	.	G	A	17	4	21	0	1	22	0	0
16	29314147	.	C	A	23	10	33	0	1	34	0	0
16	29320647	.	A	G	17	11	28	0	0	28	0	0
16	29320777	.	G	A	13	8	21	0	0	21	0	0
16	29320897	.	T	A	15	5	20	0	0	20	0	0
16	29320966	.	G	C	19	0	19	0	6	25	0	0
16	29321310	.	C	T	17	8	25	0	0	25	0	0
16	29323247	.	A	T	14	9	23	0	0	23	0	0
16	29323865	.	G	A	13	7	20	0	2	22	0	0
16	29324825	.	G	T	10	4	14	0	0	14	0	0
16	29324828	.	T	C	9	4	13	0	2	15	0	0
16	29330712	.	A	G	9	4	13	0	0	13	0	0
16	29380846	.	C	G	4	7	11	0	0	11	0	0
16	29380991	.	C	T	3	2	5	0	0	5	0	0
16	29381076	.	A	C	1	2	3	0	0	3	0	0
16	29381369	.	G	A	1	1	2	0	1	3	0	0
16	29383834	.	A	C	3	2	5	0	0	5	0	0
16	29384090	.	T	C	2	12	14	0	0	14	0	0
16	29384099	.	T	A	1	11	12	0	0	12	0	0
16	29384139	.	G	A	1	8	9	0	0	9	0	0
16	29384182	.	C	T	2	2	4	0	0	4	0	0
16	29384187	.	T	C	2	2	4	0	0	4	0	0
16	29408060	.	T	C	23	22	45	0	1	46	0	0
16	29408172	.	T	A	28	43	71	0	0	71	0	0
16	29408926	.	A	T	24	14	38	0	3	41	0	0
16	29409181	.	T	A	1	2	3	0	0	3	0	0
16	29409476	.	T	C	36	21	57	0	1	58	0	0
16	29409480	.	T	C	32	20	52	0	3	55	0	0
16	29409533	.	T	G	23	18	41	2	0	43	0	0
16	29409544	.	T	C	21	18	39	2	0	41	0	0
16	29409732	.	T	G	24	24	48	0	1	49	0	0
16	29409876	.	T	C	25	10	35	0	4	39	0	0
16	29409918	.	T	G	20	17	37	0	1	38	0	0
16	29410032	.	A	G	20	17	37	0	1	38	0	0
16	29410033	.	G	A	22	16	38	0	0	38	0	0
16	29410107	.	A	C	28	31	59	0	1	60	0	0
16	29410129	.	C	T	34	26	60	0	1	61	0	0
16	29410251	.	T	A	22	15	37	0	1	38	0	0
16	29410418	.	C	T	4	29	33	0	21	54	0	0
16	29410425	.	A	G	22	33	55	0	0	55	0	0
16	29410679	.	T	G	20	21	41	0	1	42	0	0
16	29410921	.	G	A	25	25	50	0	0	50	0	0
16	29411196	.	A	G	30	25	55	0	0	55	0	0
16	29411436	.	G	C	28	26	54	0	0	54	0	0
16	29411646	.	G	A	15	17	32	0	2	34	0	0
16	29411741	.	T	A	18	12	30	0	1	31	0	0
16	29411830	.	T	G	5	7	12	0	0	12	0	0
16	29412074	.	T	A	13	15	28	0	0	28	0	0
16	29412264	.	T	A	6	2	8	0	0	8	0	0
16	29413166	.	C	T	27	20	47	0	0	47	0	0
16	29424985	.	T	A	12	13	25	0	1	26	0	0
16	29431617	.	A	G	16	17	33	1	0	34	0	0
16	29456906	.	G	T	4	4	8	0	0	8	0	0
16	29457158	.	A	G	13	6	19	0	0	19	0	0
16	29457320	.	T	C	11	0	11	0	9	20	0	0
16	29457819	.	C	T	1	7	8	0	4	12	0	0
16	29457866	.	A	G	7	6	13	0	0	13	0	0
16	29458226	.	C	G	12	13	25	0	0	25	0	0
16	29458388	.	T	C	12	0	12	0	10	22	0	0
16	29458403	.	A	G	9	8	17	0	2	19	0	0
16	29458616	.	C	G	0	2	2	0	2	4	0	0
16	29458619	.	A	G	2	2	4	0	0	4	0	0
16	29461000	.	T	A	7	9	16	0	0	16	0	0
16	30268660	.	A	G	6	9	15	0	2	17	0	0
16	30423212	.	T	C	6	2	8	0	2	11	1	0
16	30423224	.	T	C	4	0	4	0	4	8	0	0
16	30521244	.	C	A	2	2	4	0	0	4	0	0
16	31454656	.	A	G	1	3	4	0	0	4	0	0
16	31515218	.	G	A	2	3	5	0	0	5	0	0
16	31516398	.	A	G	2	3	5	0	0	5	0	0
16	31516536	.	T	C	2	2	4	0	0	4	0	0
16	31602170	.	A	G	3	8	11	0	0	11	0	0
16	31608012	.	A	G	8	6	14	0	0	14	0	0
16	31608101	.	C	T	0	5	5	0	4	9	0	0
16	31608967	.	G	T	8	6	14	0	0	14	0	0
16	31609241	.	C	T	1	7	8	0	6	14	0	0
16	31610375	.	C	T	10	8	18	0	0	18	0	0
16	31613619	.	A	G	4	6	10	0	0	10	0	0
16	31614272	.	C	G	7	8	15	0	0	15	0	0
16	31614918	.	G	A	3	10	13	0	0	13	0	0
16	31615114	.	G	A	9	11	20	0	1	21	0	0
16	31728192	.	A	G	2	3	5	0	0	5	0	0
16	31728258	.	A	G	2	2	4	0	1	5	0	0
16	31728261	.	T	A	4	2	6	0	0	6	0	0
16	31729717	.	C	G	3	2	5	0	0	5	0	0
16	31762960	.	C	T	18	11	29	0	0	29	0	0
16	31763316	.	T	C	20	10	30	0	0	30	0	0
16	31763318	.	C	T	18	10	28	0	0	28	0	0
16	31763668	.	C	G	12	12	24	2	2	28	0	0
16	31763743	.	T	A	24	18	42	0	4	46	0	0
16	31763751	.	A	C	20	20	40	0	1	41	0	0
16	31763785	.	G	A	15	22	37	0	1	38	0	0
16	31763786	.	C	A	14	23	37	0	0	37	0	0
16	31763880	.	A	G	17	16	33	0	2	35	0	0
16	31764987	.	C	T	16	11	27	0	1	28	0	0
16	31766937	.	T	A	15	7	22	0	1	24	1	0
16	31767116	.	T	C	8	0	8	0	19	27	0	0
16	31767152	.	A	G	15	14	29	0	0	29	0	0
16	31767163	.	G	A	14	13	27	0	1	28	0	0
16	31767191	.	T	C	14	10	24	0	1	25	0	0
16	31768343	.	C	G	15	11	26	0	1	27	0	0
16	31768394	.	T	C	13	8	21	0	1	22	0	0
16	31768436	.	T	C	9	20	29	0	3	32	0	0
16	31769317	.	G	A	24	13	37	0	1	38	0	0
16	31769395	.	A	G	12	19	31	0	0	31	0	0
16	31769428	.	G	A	15	9	24	0	0	24	0	0
16	31770050	.	T	C	12	0	12	0	10	22	0	0
16	31776125	.	C	T	9	8	17	0	1	18	0	0
16	31780108	.	C	T	1	17	18	0	6	24	0	0
16	31782938	.	C	T	7	6	13	0	0	13	0	0
16	31789327	.	C	T	12	8	20	0	1	21	0	0
16	31790262	.	C	T	12	12	24	0	1	25	0	0
16	31810156	.	C	T	2	2	4	0	0	4	0	0
16	31815638	.	C	T	15	14	29	0	0	29	0	0
16	31815878	.	G	A	12	8	20	0	0	20	0	0
16	31816205	.	C	T	14	3	17	0	0	17	0	0
16	31816336	.	C	T	0	8	8	0	7	15	0	0
16	31816596	.	C	T	14	19	33	0	1	34	0	0
16	31827642	.	T	A	20	14	34	0	0	34	0	0
16	31827703	.	C	T	19	23	42	0	4	46	0	0
16	31832606	.	A	G	24	1	25	0	32	57	0	0
16	31834825	.	T	C	1	2	3	0	0	3	0	0
16	31853932	.	T	A	9	3	12	0	5	17	0	0
16	31854325	.	C	A	11	9	20	0	0	20	0	0
16	31855271	.	T	C	15	8	23	0	0	23	0	0
16	31855327	.	G	A	14	7	21	0	0	21	0	0
16	31855351	.	G	C	12	13	25	0	0	25	0	0
16	31855575	.	C	T	15	10	25	0	2	27	0	0
16	31855576	.	C	T	16	11	27	0	0	27	0	0
16	31855814	.	T	G	13	1	14	0	10	24	0	0
16	31856239	.	A	G	7	5	12	0	1	13	0	0
16	31856276	.	G	A	0	8	8	0	11	19	0	0
16	31858536	.	A	C	2	4	6	0	14	20	0	0
16	31858539	.	A	C	5	2	7	0	13	20	0	0
16	31859227	.	T	C	14	22	36	0	0	36	0	0
16	31859341	.	C	T	23	23	46	0	1	47	0	0
16	31859371	.	T	C	20	22	42	1	2	45	0	0
16	31859416	.	T	C	12	31	43	1	3	48	1	0
16	31859686	.	G	A	10	11	21	0	0	21	0	0
16	31868443	.	G	A	13	16	29	0	0	29	0	0
16	31904398	.	G	A	2	2	4	0	0	4	0	0
16	31922892	.	A	G	28	30	58	0	0	58	0	0
16	31923083	.	G	A	35	29	64	0	1	65	0	0
16	31923435	.	A	G	40	17	57	0	3	60	0	0
16	31924485	.	T	C	17	28	45	1	0	46	0	0
16	31924501	.	A	C	17	26	43	1	2	46	0	0
16	31924749	.	C	A	1	2	3	0	0	3	0	0
16	31924754	.	G	C	1	2	3	0	0	3	0	0
16	31924816	.	C	A	1	2	3	0	0	3	0	0
16	31924836	.	A	T	1	2	3	0	0	3	0	0
16	31925035	.	A	G	1	2	3	0	0	3	0	0
16	31925263	.	A	G	6	3	9	0	0	9	0	0
16	31925727	.	G	A	5	4	9	0	0	9	0	0
16	31926853	.	A	G	2	2	4	0	0	4	0	0
16	31927369	.	C	A	1	2	3	0	0	3	0	0
16	31928874	.	T	G	3	0	3	0	1	4	0	0
16	31928878	.	T	C	2	3	5	0	0	5	0	0
16	31930546	.	A	G	2	2	4	0	0	4	0	0
16	31942663	.	C	A	3	2	5	0	0	5	0	0
16	31946327	.	A	G	2	0	2	0	5	7	0	0
16	31946857	.	T	C	3	1	4	0	2	6	0	0
16	31946983	.	A	G	4	4	8	1	0	9	0	0
16	31951694	.	G	C	4	6	10	0	0	10	0	0
16	31952252	.	G	C	3	3	6	0	0	6	0	0
16	31955226	.	C	G	1	4	5	0	1	6	0	0
16	31958514	.	C	T	4	2	6	0	1	7	0	0
16	31958957	.	G	T	4	5	9	0	1	10	0	0
16	31959098	.	G	A	3	3	6	0	3	9	0	0
16	31959156	.	G	A	4	3	7	0	0	7	0	0
16	31959179	.	T	G	4	1	5	0	1	6	0	0
16	31959225	.	G	A	4	3	7	0	0	7	0	0
16	31959231	.	A	T	4	2	6	0	1	7	0	0
16	31959277	.	A	T	2	3	5	0	1	6	0	0
16	31959845	.	A	G	2	0	2	0	3	5	0	0
16	31960037	.	G	A	1	5	6	0	4	10	0	0
16	31960064	.	G	C	4	4	8	0	0	8	0	0
16	31960145	.	C	T	4	6	10	0	1	11	0	0
16	31960152	.	C	T	3	8	11	0	1	12	0	0
16	32009736	.	A	T	9	5	14	0	1	15	0	0
16	32011649	.	C	T	15	6	21	0	1	22	0	0
16	32011673	.	A	G	10	8	18	0	1	19	0	0
16	32013272	.	G	A	10	9	19	0	0	19	0	0
16	32013861	.	G	A	4	4	8	0	1	9	0	0
16	32013891	.	G	A	3	3	6	0	0	6	0	0
16	32014627	.	T	A	6	4	10	0	0	10	0	0
16	32014633	.	A	T	6	4	10	0	0	10	0	0
16	32018590	.	C	T	3	5	8	0	1	9	0	0
16	32019695	.	G	A	7	8	15	0	1	16	0	0
16	32021999	.	C	T	4	6	10	0	1	11	0	0
16	32023124	.	T	A	8	7	15	0	0	15	0	0
16	32025648	.	T	A	9	8	17	0	0	17	0	0
16	32025978	.	G	A	11	7	18	0	2	20	0	0
16	32025987	.	T	A	12	9	21	0	1	22	0	0
16	32026063	.	G	A	1	5	6	1	13	20	0	0
16	32026105	.	T	A	7	10	17	0	0	17	0	0
16	32026154	.	T	G	3	2	5	0	0	5	0	0
16	32052004	.	T	G	15	11	26	0	0	26	0	0
16	32052283	.	T	A	13	7	20	0	1	21	0	0
16	32052307	.	T	C	7	13	20	0	1	21	0	0
16	32052328	.	T	A	6	10	16	0	2	18	0	0
16	32052404	.	G	T	3	10	13	0	9	22	0	0
16	32055726	.	T	G	10	9	19	0	0	19	0	0
16	32057809	.	T	C	5	5	10	0	0	10	0	0
16	32057853	.	G	A	1	7	8	0	9	17	0	0
16	32060021	.	G	A	2	14	16	0	17	33	0	0
16	32060121	.	G	T	8	10	18	0	1	19	0	0
16	32060130	.	C	A	6	10	16	0	3	19	0	0
16	32063433	.	C	T	19	8	27	0	0	27	0	0
16	32066465	.	T	C	6	6	12	0	0	12	0	0
16	32067316	.	A	C	8	6	14	0	0	14	0	0
16	32068332	.	G	A	10	16	26	0	2	28	0	0
16	32068452	.	C	A	16	13	29	0	0	29	0	0
16	32068503	.	T	C	15	12	27	0	2	29	0	0
16	32068824	.	G	C	6	9	15	0	0	15	0	0
16	32069310	.	T	A	15	19	34	0	2	36	0	0
16	32069653	.	A	G	19	14	33	0	1	34	0	0
16	32070489	.	A	G	13	0	13	0	15	28	0	0
16	32070570	.	C	T	13	16	29	0	1	30	0	0
16	32070981	.	G	C	15	17	32	0	0	32	0	0
16	32071965	.	G	C	12	11	23	0	0	23	0	0
16	32071997	.	C	A	12	12	24	0	2	26	0	0
16	32072334	.	A	G	15	17	32	0	3	35	0	0
16	32073301	.	A	C	22	21	43	0	3	46	0	0
16	32073507	.	A	C	26	24	50	0	0	50	0	0
16	32073555	.	A	G	28	26	54	0	3	57	0	0
16	32073760	.	G	A	27	17	44	0	0	44	0	0
16	32074041	.	G	A	21	19	40	0	1	41	0	0
16	32074257	.	A	G	17	1	18	0	20	38	0	0
16	32074293	.	T	A	19	25	44	0	0	44	0	0
16	32074294	.	A	G	20	24	44	0	1	45	0	0
16	32080069	.	G	T	0	8	8	0	10	18	0	0
16	32080099	.	G	A	3	3	6	0	0	6	0	0
16	32080196	.	T	C	2	7	9	0	1	10	0	0
16	32080206	.	T	C	2	9	11	0	0	11	0	0
16	32080306	.	T	A	9	3	12	0	1	13	0	0
16	32080508	.	T	A	14	9	23	0	0	23	0	0
16	32082397	.	T	C	14	12	26	0	2	28	0	0
16	32082589	.	G	A	11	18	29	0	0	29	0	0
16	32082597	.	G	A	11	17	28	0	0	28	0	0
16	32082642	.	G	A	7	12	19	0	0	19	0	0
16	32085319	.	T	A	11	7	18	0	1	19	0	0
16	32085631	.	A	G	12	7	19	0	0	19	0	0
16	32085778	.	A	C	9	3	12	0	0	12	0	0
16	32086136	.	C	T	7	10	17	0	0	17	0	0
16	32088580	.	T	A	10	5	15	0	2	17	0	0
16	32090349	.	C	T	12	10	22	0	1	23	0	0
16	32110659	.	A	G	14	11	25	0	0	25	0	0
16	32111246	.	G	T	20	11	31	0	0	31	0	0
16	32113155	.	G	A	11	18	29	0	0	29	0	0
16	32113218	.	G	A	13	12	25	1	1	27	0	0
16	32116790	.	A	T	12	14	26	0	2	28	0	0
16	32117345	.	T	A	9	15	24	0	13	37	0	0
16	32119581	.	C	A	10	13	23	0	1	24	0	0
16	32119618	.	C	T	6	10	16	0	2	18	0	0
16	32119895	.	G	T	14	14	28	0	2	30	0	0
16	32120138	.	G	T	11	10	21	0	0	21	0	0
16	32120141	.	T	C	9	0	9	0	12	21	0	0
16	32120173	.	G	A	13	8	21	1	0	22	0	0
16	32120204	.	G	T	12	5	17	1	7	25	0	0
16	32120279	.	A	C	16	11	27	0	1	28	0	0
16	32128259	.	T	A	7	5	12	0	1	13	0	0
16	32140378	.	C	T	4	4	8	0	0	8	0	0
16	32140638	.	G	C	4	6	10	0	1	11	0	0
16	32140977	.	C	T	5	9	14	0	0	14	0	0
16	32140999	.	A	G	3	7	10	0	0	10	0	0
16	32141036	.	G	A	5	4	9	0	0	10	1	0
16	32141058	.	A	G	8	3	11	0	0	11	0	0
16	32141075	.	G	A	10	6	16	0	0	16	0	0
16	32141544	.	A	G	13	0	13	0	10	23	0	0
16	32141565	.	A	C	12	5	17	0	2	19	0	0
16	32141604	.	A	T	8	4	12	0	1	13	0	0
16	32144337	.	T	C	9	9	18	0	0	18	0	0
16	32144377	.	T	C	5	5	10	0	4	14	0	0
16	32144854	.	G	T	2	6	8	0	5	13	0	0
16	32144989	.	T	C	7	4	11	0	0	11	0	0
16	32145160	.	T	A	7	4	11	1	0	12	0	0
16	32145636	.	A	G	8	8	16	0	2	18	0	0
16	32145885	.	A	G	2	2	4	0	0	4	0	0
16	32197969	.	C	T	11	15	26	0	0	26	0	0
16	32241591	.	C	T	2	6	8	0	0	8	0	0
16	32252878	.	A	G	4	5	9	0	0	9	0	0
16	32257179	.	T	A	2	5	7	0	0	7	0	0
16	32267128	.	G	A	11	4	15	0	2	17	0	0
16	32267203	.	G	A	0	11	11	0	9	20	0	0
16	32273066	.	G	T	9	7	16	0	2	18	0	0
16	32273192	.	G	A	1	12	13	0	7	20	0	0
16	32274935	.	G	A	9	5	14	0	0	14	0	0
16	32275601	.	T	A	4	5	9	0	0	9	0	0
16	32275628	.	A	T	7	7	14	0	1	15	0	0
16	32561581	.	T	A	2	4	6	0	0	6	0	0
16	33735481	.	G	A	6	5	11	0	1	12	0	0
16	33735503	.	C	T	6	5	11	0	0	11	0	0
16	33735814	.	G	A	1	2	3	0	3	6	0	0
16	33735817	.	T	A	1	3	4	0	1	5	0	0
16	33902151	.	C	T	6	4	10	0	0	10	0	0
16	33905018	.	C	T	7	3	10	0	1	11	0	0
16	33909384	.	G	A	1	7	8	0	4	12	0	0
16	33910029	.	C	T	4	2	6	0	0	6	0	0
16	33910305	.	G	A	2	2	4	0	0	4	0	0
16	33919623	.	G	A	6	7	13	0	1	14	0	0
16	33923421	.	G	T	3	2	5	1	0	6	0	0
16	33923448	.	G	T	4	9	13	1	1	15	0	0
16	33923514	.	G	A	5	7	12	0	1	13	0	0
16	33925132	.	G	C	7	7	14	0	1	15	0	0
16	33925356	.	G	A	1	5	6	0	3	9	0	0
16	33925565	.	T	G	1	6	7	0	0	7	0	0
16	33926074	.	C	T	5	2	7	0	0	7	0	0
16	33933213	.	C	T	9	8	17	0	0	17	0	0
16	33933496	.	G	C	5	8	13	0	1	14	0	0
16	33933498	.	C	T	8	6	14	0	0	14	0	0
16	33933732	.	G	A	1	10	11	0	7	18	0	0
16	33939824	.	T	C	8	6	14	0	0	14	0	0
16	33939859	.	C	T	6	3	9	0	1	10	0	0
16	33940098	.	G	A	2	4	6	0	0	6	0	0
16	33940122	.	G	A	3	5	8	0	0	8	0	0
16	33940364	.	A	G	11	0	11	0	12	23	0	0
16	33940379	.	T	A	9	10	19	0	1	20	0	0
16	33953652	.	T	A	5	6	11	0	0	11	0	0
16	33953968	.	C	T	14	8	22	0	0	22	0	0
16	33964788	.	G	T	9	4	13	0	0	13	0	0
16	33971993	.	G	A	1	10	11	0	13	24	0	0
16	33972008	.	G	A	13	10	23	0	1	24	0	0
16	33972037	.	A	C	11	13	24	0	0	24	0	0
16	33972067	.	A	G	11	10	21	0	2	23	0	0
16	33972193	.	G	A	0	14	14	2	15	31	0	0
16	33972242	.	G	T	22	13	35	5	1	42	1	0
16	33972249	.	C	T	16	14	30	4	1	35	0	0
16	33972454	.	C	T	10	13	23	0	0	23	0	0
16	33979746	.	A	T	6	11	17	0	0	17	0	0
16	33981439	.	C	T	9	4	13	0	1	14	0	0
16	33981873	.	A	G	12	0	12	0	13	25	0	0
16	33983784	.	T	G	12	5	17	0	0	17	0	0
16	33983904	.	C	T	6	8	14	0	0	14	0	0
16	33984178	.	C	T	8	6	14	0	2	16	0	0
16	33984190	.	C	T	8	7	15	0	2	17	0	0
16	33985050	.	G	T	2	15	17	0	12	29	0	0
16	33985362	.	C	T	17	12	29	0	2	31	0	0
16	33986452	.	T	G	19	11	30	0	3	33	0	0
16	33987912	.	A	G	2	5	7	0	1	8	0	0
16	33987913	.	A	T	2	6	8	0	0	8	0	0
16	33988021	.	C	T	1	3	4	0	0	4	0	0
16	33988069	.	C	A	2	5	7	0	0	7	0	0
16	33989606	.	G	T	0	4	4	0	2	6	0	0
16	33989933	.	G	A	0	2	2	0	1	3	0	0
16	33992678	.	A	C	2	2	4	0	0	4	0	0
16	33992707	.	C	T	2	2	4	0	0	4	0	0
16	33994640	.	G	A	0	4	4	0	3	7	0	0
16	33996739	.	C	T	2	6	8	0	0	8	0	0
16	34004562	.	G	A	0	8	8	0	8	16	0	0
16	34004595	.	T	C	10	9	19	0	1	20	0	0
16	34004862	.	C	T	6	6	12	0	0	12	0	0
16	34005290	.	C	T	4	8	12	0	1	13	0	0
16	34005415	.	C	T	5	3	8	0	0	8	0	0
16	34005500	.	C	A	5	4	9	0	0	9	0	0
16	34005669	.	C	T	5	9	14	0	0	14	0	0
16	34005686	.	C	T	10	6	16	0	1	17	0	0
16	34005812	.	T	A	5	4	9	0	0	9	0	0
16	34005858	.	A	G	3	2	5	0	0	5	0	0
16	34006051	.	G	A	2	2	4	0	0	4	0	0
16	34053917	.	A	G	2	2	4	0	0	4	0	0
16	34054141	.	A	G	1	3	4	0	1	5	0	0
16	34054171	.	A	G	4	2	6	0	0	6	0	0
16	34054464	.	C	A	5	5	10	0	0	10	0	0
16	34054515	.	A	G	4	3	7	0	0	7	0	0
16	34054519	.	C	T	4	2	6	0	0	6	0	0
16	34054778	.	G	A	2	3	5	0	0	5	0	0
16	34054786	.	T	G	2	2	4	0	1	5	0	0
16	34054837	.	A	C	2	2	4	0	0	4	0	0
16	34055965	.	A	T	2	2	4	0	0	4	0	0
16	34055966	.	T	G	2	2	4	0	0	4	0	0
16	34056204	.	T	A	2	2	4	0	0	4	0	0
16	34172916	.	G	A	5	3	8	0	0	8	0	0
16	34173000	.	T	C	4	7	11	0	0	11	0	0
16	34185906	.	A	T	5	4	9	0	1	10	0	0
16	34193926	.	C	T	5	3	8	0	0	8	0	0
16	34193984	.	A	G	2	3	5	0	0	5	0	0
16	34194826	.	A	G	2	3	5	0	1	6	0	0
16	34200704	.	C	T	27	14	41	0	0	41	0	0
16	34201023	.	A	G	10	22	32	0	0	32	0	0
16	34208582	.	T	C	17	0	17	0	21	38	0	0
16	34208696	.	A	G	17	21	38	0	2	40	0	0
16	34212477	.	A	G	12	15	27	0	1	28	0	0
16	34212516	.	A	G	13	13	26	0	1	27	0	0
16	34212565	.	G	A	17	15	32	0	4	36	0	0
16	34212567	.	G	C	19	14	33	0	1	34	0	0
16	34212630	.	T	C	29	1	30	0	26	56	0	0
16	34212676	.	G	C	17	2	19	0	16	35	0	0
16	34222439	.	T	G	22	21	43	0	2	45	0	0
16	34225173	.	T	C	18	18	36	0	2	38	0	0
16	34225392	.	A	G	18	12	30	0	0	30	0	0
16	34225472	.	G	A	16	20	36	0	0	36	0	0
16	34267938	.	C	T	1	18	19	0	12	31	0	0
16	34267991	.	G	C	19	18	37	0	0	37	0	0
16	34321568	.	A	T	5	9	14	0	0	14	0	0
16	34322346	.	G	A	14	10	24	0	0	24	0	0
16	34322372	.	C	T	2	8	10	0	15	25	0	0
16	34331489	.	A	G	8	9	17	0	0	17	0	0
16	34337976	.	A	T	12	11	23	0	1	24	0	0
16	34338475	.	A	G	20	13	33	0	0	33	0	0
16	34339168	.	A	C	13	11	24	0	2	26	0	0
16	34339432	.	A	T	21	7	28	0	1	29	0	0
16	34339693	.	C	T	7	9	16	0	1	17	0	0
16	34339808	.	A	G	10	8	18	0	1	19	0	0
16	34339857	.	T	G	6	8	14	1	2	17	0	0
16	34340179	.	A	T	13	11	24	0	0	24	0	0
16	34340311	.	T	C	8	0	8	0	13	21	0	0
16	34340397	.	A	C	15	12	27	0	0	27	0	0
16	34340520	.	G	T	11	9	20	0	2	22	0	0
16	34340538	.	C	T	7	11	18	0	1	19	0	0
16	34340965	.	C	T	10	4	14	0	1	15	0	0
16	34340967	.	A	G	9	4	13	0	0	13	0	0
16	34341012	.	C	T	7	7	14	0	0	14	0	0
16	34341021	.	C	T	7	6	13	0	1	14	0	0
16	34341080	.	T	C	3	7	10	0	1	11	0	0
16	34342182	.	T	C	10	9	19	0	1	20	0	0
16	34342541	.	C	T	6	5	11	0	1	12	0	0
16	34342542	.	A	G	7	4	11	0	1	12	0	0
16	34461347	.	A	T	2	3	5	0	0	5	0	0
16	34463337	.	G	A	3	3	6	0	0	6	0	0
16	34473533	.	G	C	2	5	7	0	0	7	0	0
16	34477745	.	C	G	0	2	2	0	3	5	0	0
16	34477754	.	G	T	3	2	5	0	0	5	0	0
16	34477794	.	T	C	2	3	5	0	0	5	0	0
16	34497755	.	T	A	7	4	11	0	2	13	0	0
16	34497992	.	T	A	4	10	14	0	1	15	0	0
16	34498734	.	A	G	11	0	11	1	6	19	1	0
16	34498785	.	G	C	15	6	21	1	1	23	0	0
16	34498787	.	A	G	16	6	22	1	0	23	0	0
16	34498872	.	A	G	9	5	14	0	1	15	0	0
16	34500007	.	C	T	3	9	12	0	1	13	0	0
16	34500167	.	A	G	7	3	10	0	0	10	0	0
16	34500542	.	G	C	10	13	23	0	1	24	0	0
16	34500840	.	T	G	10	9	19	0	1	20	0	0
16	34500899	.	G	A	15	12	27	0	1	28	0	0
16	34501136	.	C	T	6	7	13	0	0	13	0	0
16	34501137	.	A	G	6	7	13	0	0	13	0	0
16	34501380	.	C	T	6	8	14	0	0	14	0	0
16	34501794	.	G	A	8	5	13	0	1	14	0	0
16	34525621	.	C	A	45	38	83	0	5	88	0	0
16	34526092	.	C	G	35	30	65	0	2	67	0	0
16	34526093	.	A	C	23	27	50	0	17	67	0	0
16	34526926	.	A	T	20	39	59	0	11	71	1	0
16	34527183	.	C	T	2	4	6	0	2	8	0	0
16	34532205	.	G	A	3	19	22	0	14	36	0	0
16	34532635	.	T	C	6	9	15	0	1	16	0	0
16	34532720	.	C	G	12	6	18	0	0	18	0	0
16	34532799	.	G	A	2	16	18	0	11	29	0	0
16	34930635	.	A	G	6	15	21	0	1	22	0	0
16	34930719	.	C	T	0	7	7	0	11	18	0	0
16	34948262	.	C	T	15	14	29	0	1	30	0	0
16	34953166	.	C	T	8	17	25	0	0	25	0	0
16	34975908	.	A	G	15	15	30	0	2	32	0	0
16	34989800	.	C	T	0	13	13	0	8	21	0	0
16	34993814	.	T	C	13	0	13	0	12	25	0	0
16	35023920	.	C	T	14	6	20	0	1	21	0	0
16	35023934	.	T	C	11	8	19	0	1	20	0	0
16	35023967	.	T	A	10	9	19	0	3	22	0	0
16	35043863	.	C	T	13	8	21	0	1	22	0	0
16	35053907	.	C	G	5	6	11	0	0	11	0	0
16	35329655	.	G	A	8	9	17	0	0	17	0	0
16	35366094	.	A	C	4	2	6	0	0	6	0	0
16	35366154	.	T	A	3	2	5	0	0	5	0	0
16	35376598	.	G	T	2	2	4	0	0	4	0	0
16	35376825	.	C	T	2	7	9	0	0	9	0	0
16	35376832	.	G	T	2	7	9	0	0	9	0	0
16	35411363	.	T	C	15	21	36	0	0	36	0	0
16	35414455	.	A	G	19	10	29	0	1	30	0	0
16	35414470	.	T	C	18	13	31	0	1	32	0	0
16	35415609	.	C	A	0	2	2	0	1	3	0	0
16	35415610	.	A	G	1	2	3	0	0	3	0	0
16	35415710	.	A	G	17	9	26	0	0	26	0	0
16	35415872	.	G	A	25	11	36	0	0	36	0	0
16	35416158	.	C	T	14	18	32	0	2	34	0	0
16	35418744	.	T	C	19	1	20	0	10	30	0	0
16	35418792	.	T	C	15	0	15	0	15	30	0	0
16	35418804	.	G	A	14	13	27	0	4	31	0	0
16	35420600	.	T	C	13	1	14	0	14	28	0	0
16	35422323	.	A	G	6	12	18	0	1	19	0	0
16	35423651	.	A	G	17	9	26	0	1	27	0	0
16	35423985	.	C	T	12	12	24	0	0	24	0	0
16	35424003	.	A	T	10	7	17	0	0	17	0	0
16	35426998	.	T	C	9	0	9	0	16	25	0	0
16	35535353	.	T	G	11	16	27	0	1	29	1	0
16	35536480	.	G	A	14	15	29	2	5	36	0	0
16	35536574	.	C	A	10	7	17	0	1	18	0	0
16	35536576	.	G	A	1	8	9	0	10	19	0	0
16	35536739	.	C	T	9	14	23	0	1	24	0	0
16	35536960	.	T	C	10	5	15	0	0	15	0	0
16	35537153	.	G	A	8	9	17	0	0	17	0	0
16	35556275	.	C	A	3	2	5	0	2	7	0	0
16	35560022	.	G	A	3	6	9	0	0	9	0	0
16	35560134	.	A	G	6	4	10	0	0	10	0	0
16	35572630	.	G	A	3	2	5	0	0	5	0	0
16	35661979	.	A	G	6	5	11	0	0	11	0	0
16	35661995	.	T	C	4	6	10	0	0	10	0	0
16	35662031	.	T	C	5	7	12	0	0	12	0	0
16	35718538	.	A	G	6	8	14	0	1	15	0	0
16	35729045	.	C	T	8	11	19	0	1	20	0	0
16	35743809	.	A	G	8	8	16	0	1	17	0	0
16	35750548	.	T	C	14	9	23	0	1	24	0	0
16	35750647	.	T	G	19	14	33	0	0	33	0	0
16	35750648	.	G	C	20	13	33	0	1	34	0	0
16	35750714	.	T	A	16	14	30	0	4	34	0	0
16	35762009	.	C	A	13	13	26	0	1	27	0	0
16	35762010	.	A	C	13	14	27	0	0	27	0	0
16	35764580	.	C	T	9	12	21	0	0	21	0	0
16	35772762	.	C	T	16	8	24	1	1	26	0	0
16	35772933	.	T	C	10	9	19	0	1	20	0	0
16	35773005	.	A	G	10	12	22	0	0	22	0	0
16	35975033	.	A	T	1	2	3	0	0	3	0	0
16	36041247	.	G	A	15	13	28	0	1	29	0	0
16	36046966	.	G	A	4	3	7	9	0	16	0	0
16	36075312	.	T	C	3	3	6	0	0	6	0	0
16	36075345	.	T	C	4	4	8	0	0	8	0	0
16	36075471	.	G	A	8	6	14	0	0	14	0	0
16	36075478	.	T	A	7	5	12	0	0	12	0	0
16	36075677	.	C	A	8	13	21	0	0	21	0	0
16	36076082	.	G	A	6	9	15	0	0	15	0	0
16	36080364	.	C	T	18	12	30	0	1	31	0	0
16	36080376	.	A	C	15	14	29	0	1	30	0	0
16	36087550	.	A	C	6	0	6	0	6	12	0	0
16	36118070	.	T	C	11	0	11	0	9	20	0	0
16	36118166	.	T	C	2	0	2	0	5	7	0	0
16	36150674	.	A	G	21	9	30	0	1	31	0	0
16	36150707	.	C	T	17	11	28	0	1	29	0	0
16	36150949	.	C	T	17	16	33	0	2	35	0	0
16	36150964	.	C	T	23	19	42	0	0	42	0	0
16	36151000	.	C	A	24	15	39	0	0	39	0	0
16	36159928	.	T	C	17	11	28	0	3	31	0	0
16	36162013	.	C	T	6	16	22	0	2	24	0	0
16	36162201	.	A	G	10	8	18	0	1	19	0	0
16	36162584	.	G	C	0	12	12	0	14	26	0	0
16	36162650	.	T	C	17	7	24	0	0	24	0	0
16	36162727	.	A	G	13	8	21	0	0	21	0	0
16	36162754	.	A	G	11	10	21	0	0	21	0	0
16	36163005	.	G	A	8	10	18	0	1	19	0	0
16	36163006	.	A	C	8	10	18	0	1	19	0	0
16	36168251	.	C	T	4	7	11	0	0	11	0	0
16	36168317	.	G	C	5	3	8	0	0	8	0	0
16	36168450	.	A	T	4	2	6	0	1	7	0	0
16	36168510	.	A	T	4	3	7	0	0	7	0	0
16	36168729	.	T	C	1	0	1	0	2	3	0	0
16	36168747	.	T	C	2	2	4	0	1	5	0	0
16	36168787	.	T	A	4	6	10	0	0	10	0	0
16	36169057	.	T	G	1	2	3	0	3	6	0	0
16	36169150	.	T	C	3	4	7	0	0	7	0	0
16	36169568	.	G	T	6	5	11	0	1	12	0	0
16	36169868	.	A	C	4	1	5	0	6	11	0	0
16	36171552	.	A	G	1	4	5	0	1	6	0	0
16	36172961	.	A	G	3	6	9	0	2	11	0	0
16	36172982	.	C	T	8	8	16	0	0	16	0	0
16	36173406	.	A	T	4	11	15	0	1	16	0	0
16	36180540	.	G	A	2	6	8	0	0	8	0	0
16	36180591	.	A	G	2	4	6	0	0	6	0	0
16	36180753	.	A	G	5	3	8	0	0	8	0	0
16	36180810	.	T	A	2	6	8	0	0	8	0	0
16	36183047	.	A	G	10	4	14	0	0	14	0	0
16	36184666	.	T	C	3	0	3	0	4	7	0	0
16	36185315	.	G	A	4	5	9	0	2	11	0	0
16	36189865	.	G	A	2	4	6	0	1	7	0	0
16	36196571	.	T	C	0	0	0	0	6	6	0	0
16	36721560	.	A	T	6	5	11	0	1	12	0	0
16	36721589	.	T	G	8	3	11	0	1	12	0	0
16	36724010	.	C	G	0	10	10	0	16	26	0	0
16	36729322	.	A	T	8	8	16	0	1	17	0	0
16	36729352	.	G	T	9	6	15	0	1	17	1	0
16	36729373	.	A	G	9	5	14	0	0	14	0	0
16	36731307	.	A	G	7	10	17	0	0	17	0	0
16	36735751	.	T	C	8	9	17	0	3	20	0	0
16	36735760	.	T	C	7	0	7	0	13	20	0	0
16	36741148	.	T	C	7	4	11	0	0	11	0	0
16	36743328	.	G	A	4	7	11	0	0	11	0	0
16	36743351	.	G	A	4	8	12	0	0	12	0	0
16	36743757	.	T	C	5	3	8	0	0	8	0	0
16	36743787	.	A	G	5	6	11	0	0	11	0	0
16	36745973	.	C	T	1	10	11	0	6	17	0	0
16	36746103	.	C	T	3	4	7	0	0	7	0	0
16	36746466	.	G	A	5	7	12	0	0	12	0	0
16	36746484	.	A	G	8	7	15	0	0	15	0	0
16	36748214	.	T	G	2	7	9	0	1	10	0	0
16	36748366	.	T	C	6	0	6	0	12	18	0	0
16	36749242	.	T	G	4	0	4	0	3	7	0	0
16	36751227	.	C	A	2	3	5	0	0	5	0	0
16	36751361	.	G	A	1	5	6	0	3	9	0	0
16	36751410	.	C	T	2	4	6	0	0	6	0	0
16	36751413	.	C	G	2	4	6	0	0	6	0	0
16	36752254	.	A	G	5	2	7	0	0	7	0	0
16	36752278	.	T	C	5	4	9	0	0	9	0	0
16	36759812	.	A	G	2	0	2	1	4	7	0	0
16	36759834	.	T	C	2	4	6	0	0	6	0	0
16	36759908	.	A	T	5	7	12	1	0	13	0	0
16	36759937	.	A	G	1	3	4	0	3	7	0	0
16	36766180	.	T	G	15	9	24	0	0	24	0	0
16	36766467	.	G	T	12	9	21	0	2	23	0	0
16	36906757	.	A	G	7	9	16	0	0	16	0	0
16	36906805	.	C	T	6	3	9	0	1	10	0	0
16	36908630	.	C	T	9	6	15	0	0	15	0	0
16	36908844	.	C	A	15	7	22	0	1	23	0	0
16	36911214	.	C	A	8	10	18	0	0	18	0	0
16	36911257	.	A	G	7	0	7	0	7	14	0	0
16	36914935	.	T	C	12	4	16	0	0	16	0	0
16	36918992	.	G	A	13	6	19	0	0	19	0	0
16	36923298	.	C	T	7	5	12	0	0	12	0	0
16	36925462	.	G	A	1	8	9	0	14	23	0	0
16	36926775	.	C	A	12	7	19	0	0	19	0	0
16	36926779	.	A	C	14	7	21	0	0	21	0	0
16	36928169	.	A	T	12	9	21	0	0	21	0	0
16	36928179	.	A	C	11	13	24	0	2	26	0	0
16	36928429	.	A	G	18	13	31	0	2	33	0	0
16	36931728	.	T	C	12	17	29	0	1	30	0	0
16	36931822	.	T	C	8	4	12	1	1	14	0	0
16	36934191	.	T	A	4	9	13	0	0	13	0	0
16	36934340	.	C	A	1	4	5	0	3	8	0	0
16	36934398	.	G	C	4	5	9	1	1	11	0	0
16	36939973	.	T	C	3	0	3	1	15	19	0	0
16	36939982	.	A	G	5	14	19	1	0	20	0	0
16	36940045	.	C	T	8	6	14	0	0	14	0	0
16	36941706	.	T	C	8	8	16	0	0	16	0	0
16	36941790	.	T	C	9	6	15	0	0	15	0	0
16	36941961	.	T	C	6	0	6	0	17	23	0	0
16	36942068	.	C	A	9	9	18	0	0	18	0	0
16	36945182	.	T	G	13	5	18	0	0	18	0	0
16	36945288	.	G	A	11	9	20	0	2	22	0	0
16	36945564	.	T	C	8	6	14	0	0	14	0	0
16	36945566	.	T	A	8	6	14	0	0	14	0	0
16	36975141	.	G	A	12	10	22	0	1	23	0	0
16	36975146	.	C	T	1	9	10	0	14	24	0	0
16	36975183	.	G	C	12	10	22	0	3	25	0	0
16	36975318	.	T	A	9	8	17	0	0	17	0	0
16	36976721	.	A	G	11	8	19	0	1	20	0	0
16	36977268	.	G	A	3	2	5	0	0	5	0	0
16	36977289	.	C	T	3	3	6	0	0	6	0	0
16	36977387	.	A	G	8	3	11	0	0	11	0	0
16	36979518	.	G	A	10	10	20	0	1	21	0	0
16	36979521	.	A	G	12	10	22	0	0	22	0	0
16	37167442	.	G	C	2	14	16	0	1	17	0	0
16	37167545	.	T	A	1	4	5	0	0	5	0	0
16	37167784	.	C	G	7	6	13	0	0	13	0	0
16	37167968	.	G	A	3	9	12	0	0	12	0	0
16	37306905	.	G	A	9	9	18	0	0	18	0	0
16	37323594	.	A	C	12	12	24	0	0	24	0	0
16	37470964	.	T	C	6	6	12	0	0	12	0	0
16	37520597	.	T	C	9	6	15	0	0	15	0	0
16	37520679	.	T	A	5	5	10	0	0	10	0	0
16	37521130	.	A	G	10	6	16	0	0	16	0	0
16	37521301	.	G	C	0	3	3	0	11	14	0	0
16	37543114	.	T	C	4	6	10	0	0	10	0	0
16	37543137	.	A	C	5	7	12	0	1	13	0	0
16	37552348	.	A	C	9	5	14	0	0	14	0	0
16	37552966	.	G	A	11	8	19	0	1	20	0	0
16	37554821	.	C	T	14	8	22	0	0	22	0	0
16	37563601	.	G	A	7	11	18	0	0	18	0	0
16	37563643	.	T	G	14	0	14	0	13	27	0	0
16	37565676	.	C	G	10	8	18	0	0	18	0	0
16	37593444	.	G	A	17	15	32	0	1	33	0	0
16	37596645	.	C	T	14	12	26	0	1	27	0	0
16	37596669	.	G	A	17	13	30	0	1	31	0	0
16	37602947	.	A	G	2	2	4	0	0	4	0	0
16	37602954	.	G	C	2	2	4	0	0	4	0	0
16	37614071	.	A	G	13	14	27	0	1	28	0	0
16	37617219	.	A	G	14	0	14	0	23	37	0	0
16	37617304	.	A	G	27	0	27	0	15	42	0	0
16	37617738	.	T	C	31	18	49	0	2	51	0	0
16	37627218	.	T	G	16	9	25	0	3	28	0	0
16	37627762	.	G	A	1	17	18	0	18	36	0	0
16	37627997	.	T	G	24	26	50	0	0	50	0	0
16	37947944	.	C	T	2	4	6	0	0	6	0	0
16	37948061	.	A	G	8	5	13	0	0	13	0	0
16	37948199	.	C	T	2	3	5	0	0	5	0	0
16	37948205	.	T	C	3	1	4	0	1	5	0	0
16	37948256	.	G	T	2	3	5	0	0	5	0	0
16	37948425	.	A	G	13	8	21	0	0	21	0	0
16	37948426	.	G	T	13	8	21	0	0	21	0	0
16	37948624	.	G	A	8	8	16	0	0	16	0	0
16	37948625	.	G	A	7	8	15	0	1	16	0	0
16	37964057	.	A	G	9	6	15	0	0	15	0	0
16	38017710	.	G	C	4	4	8	0	0	8	0	0
16	38017722	.	A	G	4	3	7	0	0	7	0	0
16	38017747	.	C	A	2	3	5	0	0	5	0	0
16	38017846	.	A	G	0	2	2	0	1	3	0	0
16	38017876	.	A	C	2	2	4	0	0	4	0	0
16	38017922	.	A	G	1	2	3	0	0	3	0	0
16	38017933	.	T	G	1	2	3	0	0	3	0	0
16	38018015	.	A	G	3	2	5	0	0	5	0	0
16	38018482	.	G	T	3	2	5	0	1	6	0	0
16	38018786	.	G	A	2	2	4	0	2	6	0	0
16	38019134	.	C	T	3	3	6	0	0	6	0	0
16	38019814	.	G	A	4	3	7	0	0	7	0	0
16	38031373	.	A	G	2	4	6	0	1	7	0	0
16	38064790	.	T	G	1	6	7	0	1	8	0	0
16	38064909	.	C	G	1	3	4	0	0	4	0	0
16	38067822	.	G	A	3	3	6	0	0	6	0	0
16	38067856	.	G	A	5	6	11	0	0	11	0	0
16	38067881	.	G	A	5	5	10	0	0	10	0	0
16	38119696	.	T	A	3	3	6	0	0	6	0	0
16	38119973	.	C	T	3	5	8	0	0	8	0	0
16	38121528	.	G	A	2	6	8	0	9	17	0	0
16	38121981	.	C	T	6	6	12	0	0	12	0	0
16	38124907	.	T	G	6	0	6	0	7	13	0	0
16	38125202	.	T	A	3	8	11	0	0	11	0	0
16	38125293	.	G	C	5	5	10	0	1	11	0	0
16	38125299	.	G	C	4	5	9	0	1	10	0	0
16	38125370	.	C	T	4	7	11	0	0	11	0	0
16	38125650	.	T	C	5	3	8	0	0	8	0	0
16	38125662	.	A	G	6	3	9	0	1	10	0	0
16	38127708	.	T	A	8	5	13	0	1	14	0	0
16	38129427	.	T	A	8	4	12	0	1	13	0	0
16	38129496	.	T	C	7	6	13	0	0	13	0	0
16	38129689	.	T	C	10	6	16	0	0	16	0	0
16	38130661	.	T	C	5	9	14	0	0	14	0	0
16	38131803	.	G	A	5	9	14	0	0	14	0	0
16	38131813	.	C	A	5	11	16	0	0	16	0	0
16	38132166	.	C	T	9	10	19	0	0	19	0	0
16	38132438	.	A	G	5	5	10	0	0	10	0	0
16	38132537	.	T	A	7	4	11	0	1	12	0	0
16	38133170	.	G	C	8	8	16	0	0	16	0	0
16	38133696	.	A	T	14	11	25	0	1	26	0	0
16	38133732	.	C	G	14	8	22	0	1	23	0	0
16	38133804	.	C	T	13	10	23	0	0	23	0	0
16	38133903	.	A	G	11	12	23	0	1	24	0	0
16	38134152	.	A	G	11	7	18	0	1	19	0	0
16	38134215	.	G	A	13	5	18	0	4	22	0	0
16	38134302	.	C	T	6	10	16	0	0	16	0	0
16	38134428	.	C	A	9	6	15	0	1	16	0	0
16	38134467	.	G	A	6	8	14	0	0	14	0	0
16	38134515	.	C	T	11	8	19	0	1	20	0	0
16	38134653	.	A	G	7	0	7	0	6	13	0	0
16	38134676	.	C	A	9	7	16	0	0	16	0	0
16	38134710	.	T	A	9	10	19	0	1	20	0	0
16	38134875	.	G	A	8	3	11	0	0	11	0	0
16	38134908	.	A	T	4	6	10	0	0	10	0	0
16	38135166	.	C	A	14	7	21	0	2	24	1	0
16	38135555	.	A	T	1	2	3	0	0	3	0	0
16	38135591	.	G	T	3	7	10	0	0	10	0	0
16	38135740	.	T	C	6	4	10	0	0	10	0	0
16	38135763	.	A	G	6	4	10	0	0	10	0	0
16	38135953	.	A	T	8	4	12	0	0	12	0	0
16	38136317	.	G	A	13	8	21	0	0	21	0	0
16	38139760	.	C	T	1	2	3	0	0	3	0	0
16	38141992	.	C	A	3	2	5	0	0	5	0	0
16	38143118	.	C	T	1	5	6	0	0	6	0	0
16	38143121	.	A	G	1	0	1	0	6	7	0	0
16	38148116	.	T	C	2	3	5	0	0	5	0	0
16	38154236	.	A	G	1	2	3	0	2	5	0	0
16	38159759	.	T	A	0	3	3	0	2	5	0	0
16	38159817	.	C	A	10	8	18	0	1	19	0	0
16	38167511	.	C	T	10	7	17	0	0	17	0	0
16	38167734	.	T	C	6	2	8	0	0	8	0	0
16	38167904	.	A	G	13	0	13	0	12	25	0	0
16	38168045	.	A	C	5	0	5	0	14	19	0	0
16	38168049	.	T	G	2	0	2	0	13	15	0	0
16	38188955	.	G	A	0	9	9	0	12	21	0	0
16	38191645	.	C	T	9	7	16	0	0	16	0	0
16	38193969	.	A	G	9	6	15	0	1	16	0	0
16	38194017	.	T	C	6	7	13	0	0	13	0	0
16	38198125	.	C	A	6	13	19	0	0	19	0	0
16	38198418	.	T	G	7	13	20	0	0	20	0	0
16	38198648	.	G	A	10	7	17	0	1	18	0	0
16	38198836	.	A	T	13	10	23	0	0	23	0	0
16	38199369	.	T	A	5	4	9	0	0	9	0	0
16	38251932	.	T	C	4	3	7	0	0	7	0	0
16	38266188	.	T	A	2	3	5	0	0	5	0	0
16	38266523	.	T	C	2	2	4	0	0	4	0	0
16	38312238	.	G	A	1	3	4	0	0	4	0	0
16	38312277	.	C	T	1	4	5	0	0	5	0	0
16	38312956	.	G	A	2	2	4	0	0	4	0	0
16	38313144	.	C	A	5	1	6	0	0	7	1	0
16	38313176	.	G	T	2	2	4	0	0	4	0	0
16	38320394	.	C	T	1	2	3	0	3	6	0	0
16	38342023	.	A	T	4	3	7	0	0	7	0	0
16	38351061	.	T	A	5	5	10	0	0	10	0	0
16	38354134	.	A	G	7	7	14	0	0	14	0	0
16	38556912	.	G	A	4	7	11	0	1	12	0	0
16	38556922	.	C	G	2	7	9	0	7	16	0	0
16	38557876	.	G	C	21	0	21	0	25	46	0	0
16	38590735	.	A	C	24	22	46	0	3	49	0	0
16	38626434	.	T	C	15	19	34	0	2	36	0	0
16	38663163	.	G	A	0	25	25	0	15	40	0	0
16	38729548	.	G	A	8	6	14	0	0	14	0	0
16	38940811	.	T	G	19	19	38	0	1	39	0	0
16	39154953	.	G	A	18	10	28	0	0	28	0	0
16	39160445	.	C	T	30	26	56	0	2	58	0	0
16	39160458	.	A	C	27	26	53	0	3	56	0	0
16	39162786	.	C	T	28	30	58	0	2	60	0	0
16	39164213	.	G	A	27	24	51	1	3	55	0	0
16	39166299	.	G	T	25	28	53	0	2	55	0	0
16	39166422	.	G	A	6	26	32	0	18	50	0	0
16	39166591	.	G	A	21	22	43	0	2	45	0	0
16	39185271	.	T	G	1	4	5	0	0	5	0	0
16	39185580	.	G	A	15	12	27	0	1	28	0	0
16	39190767	.	T	G	14	16	30	0	0	30	0	0
16	39194303	.	A	G	11	11	22	0	0	22	0	0
16	39196850	.	A	C	8	6	14	0	0	14	0	0
16	39196890	.	A	C	7	5	12	0	1	13	0	0
16	39196956	.	A	G	2	4	6	0	0	6	0	0
16	39213237	.	G	A	0	3	3	0	9	12	0	0
16	39213314	.	G	A	4	6	10	0	0	10	0	0
16	39213792	.	T	C	7	6	13	0	0	13	0	0
16	39233028	.	C	T	1	4	5	0	0	5	0	0
16	39238437	.	A	C	2	0	2	0	4	6	0	0
16	39238539	.	A	T	3	3	6	0	0	6	0	0
16	39238547	.	A	T	3	3	6	0	0	6	0	0
16	39245587	.	C	A	14	14	28	0	1	29	0	0
16	39249184	.	A	G	3	5	8	0	2	10	0	0
16	39249965	.	C	T	5	2	7	0	0	7	0	0
16	39250574	.	G	A	7	3	10	0	0	10	0	0
16	39253200	.	G	A	3	3	6	0	0	6	0	0
16	39256291	.	A	G	5	2	7	0	0	7	0	0
16	39267151	.	T	C	1	6	7	0	0	7	0	0
16	39267164	.	T	A	1	6	7	0	0	7	0	0
16	39271394	.	G	C	4	4	8	0	0	8	0	0
16	39271438	.	A	G	5	2	7	0	0	7	0	0
16	39287126	.	G	T	7	3	10	0	1	11	0	0
16	39297336	.	C	A	4	4	8	0	0	8	0	0
16	39297344	.	A	T	4	5	9	0	0	9	0	0
16	39297378	.	C	T	2	6	8	0	1	9	0	0
16	39325121	.	G	A	1	6	7	0	0	7	0	0
16	39325189	.	G	A	2	2	4	0	0	4	0	0
16	39362147	.	C	A	6	4	10	0	1	11	0	0
16	39362312	.	G	T	1	9	10	0	1	11	0	0
16	39372345	.	G	A	7	5	12	0	0	12	0	0
16	39372372	.	T	C	4	7	11	0	0	11	0	0
16	39372735	.	G	C	1	7	8	0	8	16	0	0
16	39372780	.	C	A	13	8	21	0	2	23	0	0
16	39382047	.	C	G	12	10	22	0	2	24	0	0
16	39382226	.	G	A	5	6	11	0	1	12	0	0
16	39385755	.	T	C	16	0	16	0	14	30	0	0
16	39386920	.	C	T	2	12	14	0	18	32	0	0
16	39393370	.	A	G	20	19	39	0	1	40	0	0
16	39394581	.	A	G	16	16	32	0	2	34	0	0
16	39396983	.	C	T	2	17	19	1	18	38	0	0
16	39413496	.	T	C	12	6	18	0	0	18	0	0
16	39413514	.	C	T	9	15	24	0	0	24	0	0
16	39505447	.	C	T	1	4	5	0	1	6	0	0
16	39532994	.	A	G	1	2	3	0	0	3	0	0
16	39533013	.	C	T	1	2	3	0	0	3	0	0
16	39742484	.	A	G	4	5	9	0	0	9	0	0
16	39830006	.	C	T	1	7	8	0	3	11	0	0
16	39901274	.	G	A	2	6	8	0	0	8	0	0
16	40026573	.	A	G	6	0	6	0	6	12	0	0
16	40031649	.	A	G	6	5	11	0	0	11	0	0
16	40066964	.	C	T	3	6	9	0	0	9	0	0
16	40338325	.	G	A	1	2	3	0	1	4	0	0
16	40340844	.	C	A	5	4	9	0	0	9	0	0
16	40340847	.	A	G	5	0	5	0	4	9	0	0
16	40343482	.	A	G	2	2	4	0	1	5	0	0
16	40343750	.	C	T	3	2	5	0	0	5	0	0
16	40346614	.	A	C	1	2	3	0	1	4	0	0
16	40347546	.	T	A	2	4	6	0	1	7	0	0
16	40426284	.	T	C	4	4	8	0	1	9	0	0
16	40426302	.	C	T	3	5	8	0	1	9	0	0
16	40426488	.	T	G	3	2	5	0	0	5	0	0
16	40426503	.	A	G	4	2	6	0	0	6	0	0
16	40495482	.	C	T	1	8	9	0	7	16	0	0
16	40508911	.	A	G	1	0	1	0	2	3	0	0
16	40517326	.	C	T	3	2	5	0	1	6	0	0
16	40517551	.	C	T	2	2	4	0	0	4	0	0
16	40527785	.	G	T	0	2	2	0	3	5	0	0
16	40530380	.	G	A	1	2	3	0	0	3	0	0
16	40541345	.	A	G	1	2	3	0	0	3	0	0
16	40563811	.	G	A	4	4	8	0	0	8	0	0
16	40569123	.	C	T	4	6	10	0	0	10	0	0
16	40569264	.	T	C	10	12	22	0	0	22	0	0
16	40569285	.	T	C	11	11	22	0	1	23	0	0
16	40569480	.	C	G	3	6	9	0	0	9	0	0
16	40569558	.	A	C	4	4	8	0	0	8	0	0
16	40569701	.	T	G	4	7	11	0	0	11	0	0
16	40594146	.	G	A	8	6	14	0	2	16	0	0
16	40594224	.	A	G	7	4	11	0	0	11	0	0
16	40594302	.	A	G	1	4	5	0	0	5	0	0
16	40594311	.	T	C	2	0	2	0	3	5	0	0
16	40594353	.	T	C	2	1	3	0	5	8	0	0
16	40594590	.	G	C	11	0	11	0	8	19	0	0
16	40597763	.	T	C	4	7	11	0	0	11	0	0
16	40604971	.	A	G	5	2	7	0	0	7	0	0
16	40604977	.	C	A	5	1	6	0	0	6	0	0
16	40606678	.	G	A	2	2	4	0	1	5	0	0
16	40606844	.	T	A	7	5	12	0	0	12	0	0
16	40606883	.	G	A	6	3	9	0	0	9	0	0
16	40607351	.	T	A	9	4	13	0	1	14	0	0
16	40607436	.	C	T	5	4	9	0	1	10	0	0
16	40609954	.	T	G	5	6	11	0	0	11	0	0
16	40610018	.	G	C	4	8	12	0	1	13	0	0
16	40616864	.	G	A	1	2	3	0	2	5	0	0
16	40616923	.	A	G	3	2	5	0	0	5	0	0
16	40616983	.	T	G	4	3	7	0	0	7	0	0
16	40619466	.	A	G	2	2	4	0	1	5	0	0
16	40619514	.	C	G	6	5	11	0	0	11	0	0
16	40619531	.	G	T	8	6	14	0	1	15	0	0
16	40622663	.	G	A	3	6	9	0	0	9	0	0
16	40622799	.	G	A	3	7	10	0	0	10	0	0
16	40625168	.	G	A	2	7	9	0	2	11	0	0
16	40625267	.	A	G	4	3	7	0	0	7	0	0
16	40632736	.	T	C	5	6	11	0	0	11	0	0
16	40632952	.	C	T	0	2	2	0	4	6	0	0
16	40633036	.	C	T	4	2	6	0	0	6	0	0
16	40633120	.	C	T	6	3	9	0	0	9	0	0
16	40633270	.	A	G	1	3	4	0	0	4	0	0
16	40633285	.	G	A	1	3	4	0	0	4	0	0
16	40633323	.	T	C	2	0	2	0	3	5	0	0
16	40633384	.	C	T	5	3	8	0	0	8	0	0
16	40633846	.	C	T	5	4	9	0	0	9	0	0
16	40634820	.	A	G	1	3	4	0	0	4	0	0
16	40634885	.	A	G	5	3	8	0	0	8	0	0
16	40639762	.	G	A	1	7	8	0	0	8	0	0
16	40672801	.	G	A	3	2	5	0	0	5	0	0
16	40673981	.	C	T	0	4	4	0	4	8	0	0
16	40694058	.	T	C	1	0	1	0	4	5	0	0
16	40694217	.	C	G	5	2	7	0	0	7	0	0
16	40954538	.	C	T	8	9	17	0	0	17	0	0
16	40954695	.	A	G	5	0	5	0	7	12	0	0
16	40954941	.	C	G	6	0	6	0	10	16	0	0
16	40954983	.	A	C	9	8	17	0	0	17	0	0
16	40992277	.	C	A	3	2	5	0	0	5	0	0
16	40992340	.	T	C	3	0	3	0	5	8	0	0
16	40992349	.	G	A	3	6	9	0	0	9	0	0
16	40992376	.	C	T	2	6	8	0	0	8	0	0
16	40992466	.	A	G	6	10	16	0	0	16	0	0
16	40992490	.	A	G	6	10	16	0	0	16	0	0
16	40992529	.	G	A	5	2	7	0	1	8	0	0
16	41003665	.	T	C	2	0	2	0	2	4	0	0
16	41004016	.	A	G	1	3	4	0	0	4	0	0
16	41023341	.	A	G	8	11	19	0	0	19	0	0
16	41023367	.	G	A	12	6	18	0	0	18	0	0
16	41023620	.	G	A	15	6	21	0	0	21	0	0
16	41023689	.	C	A	12	16	28	0	0	28	0	0
16	41026725	.	G	C	12	2	14	3	0	18	1	0
16	41026735	.	G	A	13	2	15	2	0	17	0	0
16	41028360	.	T	G	11	0	11	0	14	25	0	0
16	41029588	.	G	A	0	3	3	0	3	6	0	0
16	41029836	.	A	G	5	5	10	0	1	11	0	0
16	41029866	.	G	T	6	4	10	0	1	11	0	0
16	41029981	.	T	C	2	4	6	0	0	6	0	0
16	41030017	.	A	C	5	8	13	0	0	13	0	0
16	41030492	.	A	C	6	4	10	0	1	11	0	0
16	41030493	.	G	T	6	5	11	0	0	11	0	0
16	41059568	.	T	G	1	3	4	0	0	4	0	0
16	41059569	.	T	C	1	3	4	0	0	4	0	0
16	41059775	.	T	C	1	2	3	0	0	3	0	0
16	41077120	.	A	C	1	3	4	0	0	4	0	0
16	41085123	.	A	G	1	1	2	0	2	4	0	0
16	41088990	.	C	T	7	3	10	0	0	10	0	0
16	41089038	.	A	G	4	0	4	0	6	10	0	0
16	41089284	.	G	T	0	2	2	0	1	3	0	0
16	41095985	.	C	T	2	4	6	0	0	6	0	0
16	41098207	.	A	G	5	0	5	0	6	11	0	0
16	41100602	.	G	A	0	3	3	0	2	5	0	0
16	41112571	.	T	C	4	4	8	0	0	8	0	0
16	41112572	.	G	A	4	4	8	0	0	8	0	0
16	41112915	.	A	T	8	8	16	0	0	16	0	0
16	41112916	.	C	T	1	7	8	0	8	16	0	0
16	41113134	.	G	A	9	12	21	0	1	22	0	0
16	41113347	.	A	G	14	11	25	0	2	27	0	0
16	41113434	.	A	T	6	20	26	0	2	28	0	0
16	41113449	.	A	G	8	17	25	0	0	25	0	0
16	41113676	.	T	G	8	10	18	0	0	18	0	0
16	41113698	.	A	T	5	7	12	0	0	12	0	0
16	41113755	.	C	T	11	10	21	0	1	22	0	0
16	41114575	.	A	T	3	10	13	0	0	13	0	0
16	41114779	.	G	A	8	10	18	0	0	18	0	0
16	41114890	.	C	T	7	6	13	0	0	13	0	0
16	41114976	.	G	T	8	10	18	0	0	18	0	0
16	41115997	.	A	T	12	9	21	0	1	22	0	0
16	41115998	.	C	T	3	10	13	0	9	22	0	0
16	41116339	.	A	G	10	9	19	0	1	20	0	0
16	41116367	.	G	A	13	9	22	0	1	23	0	0
16	41116613	.	G	C	8	12	20	0	1	21	0	0
16	41116671	.	C	T	13	7	20	0	3	23	0	0
16	41116843	.	A	G	11	9	20	0	0	20	0	0
16	41116873	.	C	A	10	13	23	0	0	23	0	0
16	41117041	.	C	T	6	11	17	0	1	18	0	0
16	41118743	.	C	T	3	4	7	0	0	7	0	0
16	41119347	.	T	C	2	5	7	0	1	8	0	0
16	41120922	.	A	G	4	3	7	0	0	7	0	0
16	41120943	.	G	T	2	6	8	0	0	8	0	0
16	41121601	.	A	C	3	0	3	0	3	6	0	0
16	41123134	.	G	A	2	2	4	0	0	4	0	0
16	41127542	.	C	T	3	2	5	0	0	5	0	0
16	41131471	.	G	A	6	5	11	0	0	11	0	0
16	41345674	.	A	T	9	6	15	0	0	15	0	0
16	41346007	.	C	A	0	7	7	0	9	16	0	0
16	41353140	.	G	A	7	6	13	0	0	13	0	0
16	41353224	.	A	G	12	7	19	0	0	19	0	0
16	41354452	.	G	A	6	14	20	0	0	20	0	0
16	41393773	.	C	T	12	9	21	0	0	21	0	0
16	41413984	.	G	A	9	14	23	0	0	23	0	0
16	41439672	.	A	G	7	9	16	0	0	16	0	0
16	41468848	.	T	G	3	7	10	0	0	10	0	0
16	41469008	.	G	A	5	5	10	0	0	10	0	0
16	41469029	.	C	A	2	7	9	0	0	9	0	0
16	41469130	.	T	A	5	2	7	0	0	7	0	0
16	41469329	.	G	A	5	3	8	0	0	8	0	0
16	41469390	.	A	C	6	5	11	0	0	11	0	0
16	41469508	.	G	C	1	2	3	0	1	4	0	0
16	41469868	.	A	T	1	2	3	0	0	3	0	0
16	41470188	.	T	G	1	2	3	0	1	4	0	0
16	41471881	.	C	T	1	4	5	0	2	7	0	0
16	41473020	.	C	T	0	3	3	0	1	4	0	0
16	41585743	.	C	T	0	6	6	0	3	9	0	0
16	41589214	.	A	G	10	6	16	0	0	16	0	0
16	41599917	.	C	T	11	7	18	0	0	18	0	0
16	41601658	.	T	C	3	2	5	0	1	6	0	0
16	41620163	.	T	C	3	7	10	0	0	10	0	0
16	41621428	.	G	A	7	5	12	0	0	12	0	0
16	41622460	.	A	C	4	0	4	0	4	8	0	0
16	41637931	.	G	A	3	4	7	0	1	8	0	0
16	41646081	.	C	T	4	4	8	0	1	9	0	0
16	41671122	.	T	G	1	2	3	0	0	3	0	0
16	41680741	.	A	T	1	2	3	0	0	3	0	0
16	41691462	.	C	T	2	3	5	0	0	5	0	0
16	41691555	.	C	A	0	3	3	0	4	7	0	0
16	41700919	.	G	A	2	2	4	0	0	4	0	0
16	41703632	.	G	T	1	3	4	0	0	4	0	0
16	41703703	.	C	T	1	2	3	0	1	4	0	0
16	41712506	.	A	G	3	2	5	0	0	5	0	0
16	41717479	.	G	A	16	9	25	0	0	25	0	0
16	41717482	.	A	G	16	10	26	0	0	26	0	0
16	41717666	.	G	A	2	13	15	0	17	32	0	0
16	41720533	.	G	T	15	9	24	0	1	26	1	0
16	41720536	.	T	G	15	8	23	0	3	26	0	0
16	41720587	.	T	C	13	16	29	0	1	30	0	0
16	41723228	.	T	G	16	1	17	0	25	42	0	0
16	41723280	.	A	G	10	0	10	0	25	35	0	0
16	41723778	.	C	G	11	0	11	0	12	23	0	0
16	41725215	.	T	C	15	8	23	0	2	25	0	0
16	41725238	.	T	C	14	7	21	0	1	22	0	0
16	41727162	.	T	G	18	15	33	0	0	33	0	0
16	41727376	.	C	A	17	14	31	0	1	32	0	0
16	41730407	.	G	A	17	15	32	1	1	34	0	0
16	41730625	.	C	G	24	12	36	0	1	37	0	0
16	41731928	.	A	T	6	11	17	0	0	17	0	0
16	41731929	.	C	A	5	9	14	0	2	16	0	0
16	41732009	.	G	T	11	12	23	1	0	24	0	0
16	41732031	.	G	T	0	4	4	1	14	19	0	0
16	41732067	.	T	C	8	7	15	0	2	17	0	0
16	41732158	.	C	A	4	8	12	0	1	13	0	0
16	41732166	.	C	T	2	9	11	0	1	12	0	0
16	41732262	.	T	C	9	8	17	0	1	18	0	0
16	41732295	.	G	T	11	9	20	0	0	20	0	0
16	41732343	.	C	T	12	6	18	0	0	18	0	0
16	41740704	.	A	T	4	7	11	0	0	11	0	0
16	41740924	.	A	G	1	2	3	0	4	7	0	0
16	41741457	.	G	A	3	2	5	0	0	5	0	0
16	41742460	.	T	C	1	3	4	0	0	4	0	0
16	41742481	.	C	T	2	3	5	0	0	5	0	0
16	41762484	.	C	T	2	2	4	0	0	4	0	0
16	41762516	.	T	A	1	3	4	0	0	4	0	0
16	41794900	.	C	A	1	13	14	0	8	22	0	0
16	41801525	.	G	T	25	14	39	0	2	41	0	0
16	41873717	.	T	A	14	17	31	0	0	31	0	0
16	41873797	.	G	A	14	11	25	0	0	25	0	0
16	41873992	.	C	T	5	8	13	0	1	14	0	0
16	41874039	.	G	C	9	10	19	0	1	20	0	0
16	41891572	.	C	T	20	17	37	0	1	38	0	0
16	41891662	.	A	C	15	15	30	0	1	31	0	0
16	41896361	.	G	A	17	15	32	0	2	34	0	0
16	41897244	.	A	G	11	10	21	0	0	21	0	0
16	41897332	.	A	G	12	13	25	0	1	26	0	0
16	41897347	.	G	A	14	16	30	0	0	30	0	0
16	41897375	.	A	T	20	18	38	0	2	40	0	0
16	41897452	.	C	A	15	12	27	1	0	28	0	0
16	41897599	.	A	T	7	7	14	2	0	16	0	0
16	41903475	.	A	T	11	5	16	0	0	16	0	0
16	41903686	.	G	A	16	7	23	0	2	25	0	0
16	41903770	.	T	C	12	8	20	0	0	20	0	0
16	41903801	.	T	G	7	9	16	0	2	18	0	0
16	41903957	.	T	C	11	7	18	0	0	18	0	0
16	41904121	.	T	G	7	9	16	0	0	16	0	0
16	41904209	.	T	C	9	10	19	0	0	19	0	0
16	41904261	.	G	A	15	7	22	0	0	22	0	0
16	41904430	.	C	A	11	16	27	0	1	28	0	0
16	41904440	.	C	A	0	17	17	0	9	26	0	0
16	41904615	.	T	C	11	0	11	0	15	26	0	0
16	41904650	.	G	A	16	6	22	0	0	22	0	0
16	41904680	.	A	T	12	2	14	3	1	18	0	0
16	41904879	.	A	T	1	6	7	0	1	8	0	0
16	41904961	.	A	G	12	7	19	0	1	20	0	0
16	41905631	.	A	G	12	9	21	0	2	23	0	0
16	41905666	.	A	G	8	9	17	0	0	17	0	0
16	41905682	.	G	T	11	11	22	0	0	22	0	0
16	41905720	.	T	A	10	4	14	0	2	16	0	0
16	41905807	.	G	C	13	10	23	0	1	24	0	0
16	41912225	.	G	A	14	14	28	0	2	30	0	0
16	41916819	.	A	G	18	14	32	0	1	33	0	0
16	41925227	.	G	C	20	1	21	0	22	43	0	0
16	41929993	.	T	G	14	10	24	0	1	25	0	0
16	41933222	.	A	C	14	7	21	0	1	22	0	0
16	41933411	.	G	A	6	9	15	0	2	17	0	0
16	42072207	.	T	A	21	14	35	2	0	37	0	0
16	42072719	.	A	C	28	14	42	0	3	45	0	0
16	42073086	.	A	G	9	5	14	0	1	15	0	0
16	42073488	.	T	C	20	2	22	0	17	39	0	0
16	42083039	.	G	A	14	14	28	0	1	29	0	0
16	42091814	.	A	G	15	23	38	0	0	38	0	0
16	42151633	.	T	C	9	4	13	0	0	13	0	0
16	42161402	.	C	G	0	2	2	0	1	3	0	0
16	42177840	.	C	T	2	2	4	0	0	4	0	0
16	42178012	.	A	G	11	5	16	2	0	18	0	0
16	42179879	.	C	A	14	11	25	0	0	25	0	0
16	42180079	.	A	G	11	15	26	0	1	27	0	0
16	42180271	.	G	A	23	6	29	0	0	29	0	0
16	42186022	.	G	A	7	8	15	0	0	15	0	0
16	42186043	.	A	T	4	6	10	0	0	10	0	0
16	42186063	.	A	G	2	3	5	0	0	5	0	0
16	42193225	.	T	C	2	2	4	0	0	4	0	0
16	42193256	.	C	T	4	3	7	1	1	9	0	0
16	42207600	.	A	G	1	3	4	0	0	4	0	0
16	42238055	.	G	T	2	4	6	0	1	7	0	0
16	42238095	.	G	A	2	2	4	0	0	4	0	0
16	42322636	.	A	C	27	1	28	2	56	86	0	0
16	42423606	.	G	T	4	6	10	0	6	16	0	0
16	42424189	.	G	A	13	16	29	0	1	30	0	0
16	42424405	.	G	A	17	13	30	0	0	30	0	0
16	42428454	.	T	C	13	12	25	0	3	28	0	0
16	42428472	.	C	T	12	13	25	0	1	26	0	0
16	42440999	.	T	C	16	7	23	0	0	23	0	0
16	42443875	.	A	G	10	8	18	0	2	20	0	0
16	42443965	.	G	A	9	11	20	0	1	21	0	0
16	42454027	.	G	C	6	6	12	0	0	12	0	0
16	42459378	.	T	C	3	5	8	0	0	8	0	0
16	42472082	.	A	C	2	3	5	0	0	5	0	0
16	42472146	.	G	T	1	2	3	0	0	3	0	0
16	42472229	.	T	C	2	3	5	0	0	5	0	0
16	42472388	.	C	T	4	3	7	0	0	7	0	0
16	42472715	.	C	T	5	3	8	0	0	8	0	0
16	42482275	.	T	C	7	12	19	0	1	20	0	0
16	42482378	.	T	C	7	11	18	0	2	20	0	0
16	42482418	.	A	T	11	8	19	0	3	22	0	0
16	42487947	.	A	G	8	17	25	0	5	30	0	0
16	42490255	.	C	T	13	10	23	0	2	25	0	0
16	42490264	.	T	C	14	8	22	0	1	23	0	0
16	42493796	.	G	C	2	10	12	0	15	27	0	0
16	42493900	.	A	T	5	8	13	1	0	14	0	0
16	42494084	.	G	A	0	2	2	0	7	9	0	0
16	42667643	.	C	T	5	8	13	0	0	13	0	0
16	42668565	.	T	C	5	3	8	0	0	8	0	0
16	42673164	.	G	A	1	3	4	0	4	8	0	0
16	42673487	.	A	T	5	2	7	0	0	7	0	0
16	42678537	.	G	A	0	7	7	0	4	11	0	0
16	42678686	.	A	T	4	3	7	0	0	7	0	0
16	42678919	.	T	C	2	2	4	0	1	5	0	0
16	42679327	.	G	C	1	3	4	0	3	7	0	0
16	42681270	.	G	C	3	2	5	0	2	7	0	0
16	42683409	.	A	G	3	0	3	0	6	9	0	0
16	42710695	.	C	G	0	1	1	0	2	3	0	0
16	42829855	.	C	A	5	7	12	0	0	12	0	0
16	42833084	.	T	C	8	14	22	0	0	22	0	0
16	42840237	.	A	G	15	13	28	0	0	28	0	0
16	42843128	.	G	A	7	3	10	0	0	10	0	0
16	42898555	.	A	G	2	3	5	0	1	6	0	0
16	42900259	.	A	C	1	2	3	0	1	4	0	0
16	42900500	.	G	A	1	5	6	0	0	6	0	0
16	42938926	.	A	T	6	6	12	0	1	13	0	0
16	42938927	.	G	T	7	6	13	0	0	13	0	0
16	42938995	.	A	G	1	7	8	0	0	8	0	0
16	42939124	.	T	A	4	2	6	0	0	6	0	0
16	42939343	.	C	T	0	7	7	0	17	24	0	0
16	42939443	.	A	C	13	0	13	0	7	20	0	0
16	42939607	.	C	T	12	10	22	0	1	23	0	0
16	42939675	.	G	C	13	12	25	0	0	25	0	0
16	42939841	.	T	C	3	6	9	0	0	9	0	0
16	42939993	.	A	C	1	2	3	0	0	3	0	0
16	42940062	.	A	C	5	4	9	0	1	10	0	0
16	42940490	.	T	C	4	4	8	1	1	10	0	0
16	42940836	.	A	C	3	2	5	0	0	5	0	0
16	42941189	.	C	A	8	5	13	0	1	14	0	0
16	42941405	.	A	T	7	5	12	0	1	13	0	0
16	42949149	.	G	A	5	5	10	0	1	11	0	0
16	42949254	.	T	C	3	0	3	0	10	13	0	0
16	42951909	.	C	T	5	3	8	0	1	9	0	0
16	42992888	.	A	G	4	2	6	0	0	6	0	0
16	42992892	.	G	C	5	2	7	0	0	7	0	0
16	42992968	.	G	A	3	2	5	0	0	5	0	0
16	43001124	.	A	T	8	7	15	0	1	16	0	0
16	43001148	.	G	A	8	7	15	0	1	16	0	0
16	43001290	.	A	C	8	3	11	0	0	11	0	0
16	43001368	.	T	G	9	12	21	0	1	22	0	0
16	43011187	.	T	C	6	6	12	0	0	12	0	0
16	43011223	.	C	T	1	3	4	0	8	12	0	0
16	43015484	.	A	G	31	35	66	0	4	70	0	0
16	43026164	.	G	T	3	7	10	0	0	10	0	0
16	43026189	.	A	C	2	4	6	0	1	7	0	0
16	43026201	.	G	T	2	4	6	0	0	6	0	0
16	43028153	.	T	A	2	5	7	0	0	7	0	0
16	43028156	.	G	A	2	4	6	0	1	7	0	0
16	43028452	.	T	C	8	8	16	0	1	17	0	0
16	43031834	.	C	G	14	5	19	0	0	19	0	0
16	43039176	.	G	T	2	6	8	0	0	8	0	0
16	43039305	.	T	C	4	5	9	0	0	9	0	0
16	43041295	.	T	C	5	0	5	0	5	10	0	0
16	43041301	.	C	T	0	5	5	0	5	10	0	0
16	43126347	.	G	T	1	2	3	0	0	3	0	0
16	43126513	.	T	A	3	2	5	0	0	5	0	0
16	43130296	.	C	T	5	8	13	0	0	13	0	0
16	43149454	.	A	C	1	2	3	0	0	3	0	0
16	43153076	.	C	A	9	6	15	0	1	16	0	0
16	43153537	.	C	A	7	12	19	0	0	19	0	0
16	43158681	.	C	T	10	12	22	2	0	24	0	0
16	43211396	.	T	C	12	19	31	0	0	31	0	0
16	43227950	.	T	C	5	0	5	0	6	11	0	0
16	43228017	.	T	A	4	4	8	0	0	8	0	0
16	43228055	.	C	T	10	4	14	0	0	14	0	0
16	43228406	.	T	C	3	0	3	0	5	8	0	0
16	43228531	.	G	T	1	3	4	0	0	4	0	0
16	43228567	.	A	G	3	2	5	0	0	5	0	0
16	43228796	.	C	T	0	10	10	0	10	20	0	0
16	43228847	.	G	T	8	4	12	0	0	12	0	0
16	43228942	.	C	T	4	4	8	0	1	9	0	0
16	43228945	.	T	C	5	4	9	0	0	9	0	0
16	43229315	.	T	C	8	0	8	0	8	16	0	0
16	43229396	.	T	C	7	6	13	0	0	13	0	0
16	43229443	.	T	G	9	5	14	0	2	16	0	0
16	43229610	.	C	G	1	5	6	0	9	16	1	0
16	43229612	.	T	C	10	6	16	0	0	16	0	0
16	43229961	.	T	A	4	5	9	0	0	9	0	0
16	43230258	.	T	C	8	6	14	0	2	16	0	0
16	43230296	.	A	G	9	10	19	0	0	19	0	0
16	43230435	.	T	C	8	0	8	0	13	21	0	0
16	43230527	.	A	G	5	7	12	0	0	12	0	0
16	43230540	.	G	T	3	7	10	0	1	11	0	0
16	43230771	.	A	G	3	6	9	0	0	9	0	0
16	43232412	.	G	A	4	3	7	0	0	7	0	0
16	43233420	.	C	T	4	4	8	0	0	8	0	0
16	43238243	.	A	T	14	13	27	0	1	28	0	0
16	43240141	.	C	T	11	10	21	0	0	21	0	0
16	43255499	.	G	A	17	9	26	0	0	26	0	0
16	43256440	.	A	T	16	14	30	0	1	31	0	0
16	43263617	.	G	T	3	14	17	0	12	29	0	0
16	43269922	.	C	T	20	23	43	0	0	43	0	0
16	43283941	.	C	T	13	9	22	0	0	22	0	0
16	43284313	.	G	A	24	16	40	0	1	41	0	0
16	43284429	.	C	T	19	20	39	0	1	40	0	0
16	43291872	.	T	C	2	5	7	0	1	8	0	0
16	43297195	.	G	C	5	3	8	0	0	8	0	0
16	43300053	.	A	G	3	9	12	0	3	15	0	0
16	43300083	.	C	T	0	14	14	0	4	18	0	0
16	43301905	.	T	G	6	11	17	0	0	17	0	0
16	43303873	.	T	C	7	7	14	0	0	14	0	0
16	43303912	.	A	G	7	6	13	0	1	14	0	0
16	43303921	.	C	T	7	6	13	0	0	13	0	0
16	43303948	.	T	C	5	7	12	0	0	12	0	0
16	43306721	.	T	C	14	18	32	0	1	33	0	0
16	43306995	.	A	G	5	11	16	0	2	18	0	0
16	43309443	.	A	G	7	10	17	2	0	19	0	0
16	43309498	.	T	C	9	1	10	0	11	21	0	0
16	43321432	.	G	T	4	2	6	0	1	7	0	0
16	43323712	.	G	A	4	3	7	0	0	7	0	0
16	43336453	.	C	T	1	3	4	0	0	4	0	0
16	43336681	.	A	G	3	8	11	0	0	11	0	0
16	43336855	.	G	A	8	12	20	1	1	22	0	0
16	43341256	.	C	T	2	12	14	0	23	37	0	0
16	43345237	.	C	A	13	8	21	0	0	21	0	0
16	43348362	.	T	A	7	2	9	0	1	10	0	0
16	43349183	.	C	T	6	13	19	0	1	20	0	0
16	43349315	.	G	A	4	6	10	0	1	12	1	0
16	43349624	.	C	T	8	8	16	0	0	16	0	0
16	43349639	.	T	C	7	7	14	0	0	14	0	0
16	43350236	.	T	C	1	6	7	1	0	8	0	0
16	43368574	.	T	A	8	7	15	0	1	16	0	0
16	43368669	.	G	T	5	7	12	0	0	12	0	0
16	43375493	.	G	A	1	6	7	0	6	13	0	0
16	43375550	.	A	G	10	7	17	0	0	17	0	0
16	43379430	.	T	A	10	6	16	0	0	16	0	0
16	43385317	.	A	G	3	0	3	0	4	7	0	0
16	43389752	.	T	C	4	7	11	0	0	11	0	0
16	43389797	.	T	C	4	12	16	0	0	16	0	0
16	43391618	.	G	A	8	17	25	0	2	27	0	0
16	43412097	.	T	C	1	3	4	0	0	4	0	0
16	43413013	.	C	A	7	3	10	0	0	10	0	0
16	43413176	.	A	C	2	2	4	0	0	4	0	0
16	43517526	.	C	T	2	23	25	1	27	53	0	0
16	43707397	.	A	G	10	13	23	0	2	25	0	0
16	43742277	.	A	T	6	12	18	0	0	18	0	0
16	43766106	.	T	C	3	2	5	0	0	5	0	0
16	43766129	.	A	G	3	2	5	0	0	5	0	0
16	43771669	.	A	T	7	2	9	0	0	9	0	0
16	43804352	.	A	G	3	0	3	0	5	8	0	0
16	43804361	.	C	T	3	4	7	0	0	7	0	0
16	43818954	.	A	G	3	3	6	0	0	6	0	0
16	43819623	.	A	G	9	10	19	0	1	20	0	0
16	43819934	.	A	G	9	10	19	0	2	21	0	0
16	43820317	.	A	G	16	19	35	0	0	35	0	0
16	43820405	.	G	A	14	16	30	0	0	30	0	0
16	43820453	.	C	T	20	14	34	0	2	36	0	0
16	43820654	.	T	C	25	10	35	0	2	37	0	0
16	43820655	.	G	A	25	11	36	0	1	37	0	0
16	43820777	.	G	A	15	12	27	0	0	27	0	0
16	43821047	.	G	A	14	14	28	0	1	29	0	0
16	43821146	.	G	A	15	12	27	0	1	28	0	0
16	43821170	.	T	G	18	16	34	0	2	36	0	0
16	43821455	.	C	T	11	14	25	0	1	26	0	0
16	43821734	.	G	T	13	15	28	0	1	29	0	0
16	43822025	.	T	C	12	9	21	0	1	22	0	0
16	43822343	.	T	G	10	11	21	0	1	22	0	0
16	43822794	.	G	T	10	11	21	0	1	22	0	0
16	43920381	.	C	T	18	10	28	0	0	28	0	0
16	43971245	.	T	C	19	5	24	0	1	25	0	0
16	43971248	.	G	A	19	6	25	0	0	25	0	0
16	44349687	.	T	C	21	0	21	0	20	41	0	0
16	44349766	.	A	G	18	26	44	0	1	45	0	0
16	44349830	.	A	G	13	24	37	0	0	37	0	0
16	44379120	.	A	G	18	13	31	0	1	32	0	0
16	44379168	.	T	C	19	22	41	0	0	41	0	0
16	44379219	.	T	A	24	14	38	0	1	39	0	0
16	44460348	.	C	T	0	14	14	0	11	25	0	0
16	44462580	.	T	A	11	13	24	0	0	24	0	0
16	44490752	.	G	A	18	11	29	0	1	30	0	0
16	44509758	.	G	A	16	16	32	0	0	32	0	0
16	44509821	.	C	T	15	14	29	0	4	33	0	0
16	44509842	.	T	C	11	0	11	0	23	34	0	0
16	44509923	.	C	T	11	7	18	0	0	18	0	0
16	44510055	.	C	A	16	11	27	0	2	29	0	0
16	44512583	.	C	T	1	11	12	1	14	27	0	0
16	44512625	.	A	T	16	9	25	1	0	26	0	0
16	44512685	.	G	C	21	11	32	0	0	32	0	0
16	44512706	.	G	A	21	11	32	0	0	32	0	0
16	44512733	.	A	G	13	10	23	0	0	23	0	0
16	44512936	.	T	C	13	1	14	0	13	27	0	0
16	44557612	.	T	C	17	0	17	0	7	24	0	0
16	44588071	.	G	A	5	9	14	0	0	14	0	0
16	44588173	.	G	A	7	6	13	0	0	13	0	0
16	44588182	.	A	T	7	5	12	0	1	13	0	0
16	44588236	.	T	C	7	9	16	0	1	17	0	0
16	44665348	.	C	T	0	14	14	0	8	22	0	0
16	44665358	.	A	G	6	16	22	0	0	22	0	0
16	44668083	.	G	A	12	10	22	0	0	22	0	0
16	44669333	.	A	G	15	12	27	0	0	27	0	0
16	44672368	.	C	T	14	14	28	0	0	28	0	0
16	44672389	.	A	C	12	12	24	0	0	24	0	0
16	44673395	.	C	G	9	6	15	0	0	15	0	0
16	44673442	.	A	C	6	0	6	0	5	11	0	0
16	44673734	.	C	A	16	14	30	0	1	31	0	0
16	44673748	.	T	C	11	0	11	0	13	24	0	0
16	44673769	.	A	G	10	8	18	0	1	19	0	0
16	44679990	.	G	A	1	5	6	0	0	6	0	0
16	44788444	.	A	C	12	0	12	0	11	23	0	0
16	44788736	.	G	T	6	7	13	0	4	17	0	0
16	44790834	.	G	A	13	13	26	0	0	26	0	0
16	44790945	.	T	G	12	8	20	0	0	20	0	0
16	44791071	.	A	G	10	3	13	0	0	13	0	0
16	44793179	.	T	G	7	6	13	0	0	13	0	0
16	44793213	.	A	G	4	9	13	0	0	13	0	0
16	44793526	.	T	C	4	3	7	0	0	7	0	0
16	44804145	.	C	T	8	5	13	0	1	14	0	0
16	44804154	.	T	C	5	1	6	0	5	11	0	0
16	44813134	.	A	G	5	6	11	0	0	11	0	0
16	44819365	.	T	C	4	2	6	0	0	6	0	0
16	44819383	.	G	A	4	6	10	0	0	10	0	0
16	44877275	.	T	A	3	3	6	0	1	7	0	0
16	44881979	.	C	T	2	3	5	0	0	5	0	0
16	44884701	.	A	G	10	5	15	0	0	15	0	0
16	44888458	.	T	G	9	9	18	0	0	18	0	0
16	44888473	.	G	A	11	8	19	0	1	20	0	0
16	44892957	.	T	C	5	6	11	0	0	11	0	0
16	44893131	.	C	T	5	3	8	0	9	17	0	0
16	44893137	.	C	G	6	12	18	0	0	18	0	0
16	44896883	.	T	C	6	0	6	0	17	23	0	0
16	44900266	.	A	C	3	2	5	0	0	5	0	0
16	44920028	.	T	C	1	2	3	0	0	3	0	0
16	44983870	.	A	T	3	3	6	0	0	6	0	0
16	44984214	.	C	T	4	8	12	0	0	12	0	0
16	44984532	.	A	T	4	6	10	0	0	10	0	0
16	44985222	.	A	G	1	2	3	0	0	3	0	0
16	44985225	.	G	A	1	2	3	0	0	3	0	0
16	44986810	.	A	T	4	12	16	0	1	17	0	0
16	44989142	.	T	A	3	11	14	0	1	15	0	0
16	44991350	.	A	G	5	5	10	0	2	12	0	0
16	44995388	.	T	A	5	7	12	0	1	13	0	0
16	44995448	.	A	G	3	8	11	0	1	12	0	0
16	44995484	.	C	T	0	10	10	0	3	13	0	0
16	45001639	.	T	C	3	13	16	0	0	16	0	0
16	45001660	.	T	A	4	12	16	0	0	16	0	0
16	45001768	.	A	T	4	6	10	0	0	10	0	0
16	45019606	.	A	T	5	6	11	0	0	11	0	0
16	45019768	.	C	G	17	16	33	0	0	33	0	0
16	45019868	.	A	G	20	12	32	0	0	32	0	0
16	45034336	.	G	A	13	13	26	0	0	26	0	0
16	45036921	.	T	A	10	7	17	0	0	17	0	0
16	45038877	.	G	C	12	1	13	0	6	19	0	0
16	45038895	.	G	A	12	8	20	0	0	20	0	0
16	45041694	.	G	A	16	8	24	0	3	27	0	0
16	45041736	.	A	G	14	7	21	0	3	24	0	0
16	45041772	.	T	C	10	10	20	0	0	20	0	0
16	45042174	.	G	A	7	7	14	0	0	14	0	0
16	45044709	.	T	G	27	24	51	0	2	53	0	0
16	45044710	.	A	T	27	25	52	0	1	53	0	0
16	45044858	.	T	C	36	4	40	1	31	72	0	0
16	45044910	.	T	C	49	47	96	0	1	97	0	0
16	45044952	.	T	A	48	49	97	0	4	101	0	0
16	45054004	.	A	G	40	37	77	0	3	80	0	0
16	45080561	.	A	G	2	2	4	0	0	4	0	0
16	45080602	.	T	C	1	4	5	0	0	5	0	0
16	45080608	.	G	A	0	4	4	0	0	4	0	0
16	45080719	.	G	T	2	6	8	0	1	9	0	0
16	45080720	.	A	G	2	6	8	0	1	9	0	0
16	45088196	.	A	C	3	2	5	0	0	5	0	0
16	45094330	.	A	G	5	4	9	0	0	9	0	0
16	45094355	.	A	G	6	5	11	0	0	11	0	0
16	45094399	.	A	G	5	9	14	0	0	14	0	0
16	45094423	.	A	G	3	12	15	0	0	15	0	0
16	45094523	.	A	G	4	12	16	1	0	17	0	0
16	45202703	.	G	A	15	11	26	0	0	26	0	0
16	45202795	.	A	G	18	10	28	0	0	28	0	0
16	45202798	.	A	G	19	8	27	0	2	29	0	0
16	45202926	.	A	G	14	13	27	0	3	30	0	0
16	45202962	.	T	A	14	8	22	0	0	22	0	0
16	45203076	.	C	A	19	5	24	0	1	25	0	0
16	45209294	.	A	G	18	13	31	0	0	31	0	0
16	45209300	.	A	G	17	12	29	0	2	31	0	0
16	45209787	.	T	A	25	5	30	0	0	30	0	0
16	45225374	.	G	A	22	6	28	0	1	29	0	0
16	45225381	.	C	A	21	7	28	0	1	29	0	0
16	45307031	.	G	A	1	2	3	0	1	4	0	0
16	45357369	.	A	T	2	2	4	0	0	4	0	0
16	45364428	.	C	T	0	2	2	0	1	3	0	0
16	45364438	.	T	A	1	2	3	0	0	3	0	0
16	45368093	.	A	G	4	6	10	0	0	10	0	0
16	45368111	.	T	C	4	6	10	0	1	11	0	0
16	45368144	.	A	G	4	5	9	0	1	10	0	0
16	45368181	.	G	C	4	6	10	0	0	10	0	0
16	45368228	.	G	A	7	2	9	0	0	9	0	0
16	45368237	.	G	A	7	3	10	0	0	10	0	0
16	45393784	.	G	A	2	4	6	0	0	6	0	0
16	45393829	.	G	A	1	2	3	0	0	3	0	0
16	45393861	.	G	A	2	2	4	0	0	4	0	0
16	45433976	.	T	G	2	0	2	0	4	6	0	0
16	45436486	.	C	T	3	3	6	0	0	6	0	0
16	45436883	.	T	C	2	6	8	0	0	8	0	0
16	45440521	.	G	T	0	9	9	0	10	19	0	0
16	45440539	.	G	A	9	8	17	0	0	17	0	0
16	45456167	.	G	A	6	3	9	0	0	9	0	0
16	45456240	.	T	C	7	5	12	0	0	12	0	0
16	45456241	.	G	A	7	5	12	0	0	12	0	0
16	45506776	.	G	A	4	5	9	1	0	10	0	0
16	45572115	.	C	T	3	6	9	0	0	9	0	0
16	45572473	.	C	T	6	4	10	0	0	10	0	0
16	45572730	.	A	C	1	7	8	0	0	8	0	0
16	45572754	.	G	T	1	5	6	0	1	7	0	0
16	45572854	.	T	C	3	4	7	0	0	7	0	0
16	45572877	.	G	A	4	3	7	0	0	7	0	0
16	45573037	.	T	A	2	3	5	0	1	6	0	0
16	45573038	.	T	A	3	3	6	0	0	6	0	0
16	45573088	.	C	T	3	4	7	0	0	7	0	0
16	45573090	.	T	C	3	4	7	0	0	7	0	0
16	45573228	.	A	G	4	4	8	0	0	8	0	0
16	45573251	.	T	A	5	7	12	0	0	12	0	0
16	45590081	.	A	C	1	2	3	0	13	16	0	0
16	45614043	.	A	G	8	2	10	0	5	15	0	0
16	45625065	.	G	A	13	11	24	0	1	25	0	0
16	45627066	.	T	G	9	12	21	0	1	22	0	0
16	45627081	.	T	C	7	12	19	0	0	19	0	0
16	45627258	.	C	T	10	11	21	0	0	21	0	0
16	45627297	.	G	A	0	10	10	0	8	18	0	0
16	45627363	.	A	G	15	11	26	0	1	27	0	0
16	45627378	.	G	A	13	11	24	0	0	24	0	0
16	45630207	.	G	C	1	11	12	0	11	23	0	0
16	45686536	.	C	T	7	15	22	0	0	22	0	0
16	45686586	.	C	T	8	7	15	0	1	16	0	0
16	45686998	.	T	A	6	5	11	0	1	12	0	0
16	45687065	.	G	A	10	3	13	0	1	14	0	0
16	45687076	.	A	G	9	0	9	0	3	12	0	0
16	45687199	.	G	A	2	6	8	0	5	13	0	0
16	45687202	.	A	T	6	6	12	0	0	12	0	0
16	45687299	.	C	T	7	12	19	0	1	20	0	0
16	45687718	.	A	G	2	0	2	0	7	9	0	0
16	45687766	.	T	G	4	6	10	0	1	11	0	0
16	45687896	.	T	G	6	11	17	0	1	18	0	0
16	45688005	.	T	C	10	6	16	0	0	16	0	0
16	45688171	.	C	T	11	7	18	0	0	18	0	0
16	45688228	.	G	A	0	4	4	0	6	10	0	0
16	45688323	.	G	T	8	6	14	0	1	15	0	0
16	45688431	.	T	A	16	11	27	0	1	28	0	0
16	45688662	.	T	C	16	8	24	0	2	26	0	0
16	45688814	.	C	T	15	8	23	0	2	25	0	0
16	45689411	.	T	A	24	7	31	0	0	31	0	0
16	45689435	.	A	G	17	7	24	0	4	28	0	0
16	45689476	.	T	A	20	16	36	0	5	41	0	0
16	45689484	.	G	T	22	17	39	0	1	40	0	0
16	45689835	.	T	C	12	14	26	0	0	26	0	0
16	45689898	.	A	T	21	13	34	0	1	35	0	0
16	45690148	.	A	T	12	5	17	0	1	18	0	0
16	45690296	.	T	C	13	15	28	0	2	30	0	0
16	45693611	.	G	A	9	12	21	0	0	21	0	0
16	45697007	.	T	C	11	10	21	0	0	21	0	0
16	45701289	.	G	A	11	3	14	0	0	14	0	0
16	45708377	.	T	A	11	13	24	0	2	26	0	0
16	45709001	.	G	T	0	13	13	0	16	29	0	0
16	45710316	.	T	A	16	19	35	0	3	38	0	0
16	45710337	.	T	C	17	20	37	0	0	37	0	0
16	45710536	.	C	T	7	5	12	0	0	12	0	0
16	45710691	.	A	G	23	10	33	0	2	35	0	0
16	45711077	.	C	T	4	19	23	0	14	37	0	0
16	45711117	.	A	G	10	15	25	0	4	29	0	0
16	45712455	.	A	G	11	17	28	0	0	28	0	0
16	45713631	.	A	G	13	28	41	0	0	41	0	0
16	45713661	.	A	G	13	0	13	0	21	34	0	0
16	45725844	.	A	G	17	17	34	1	1	36	0	0
16	45726665	.	T	A	22	19	41	0	1	42	0	0
16	45726677	.	A	G	20	20	40	0	0	40	0	0
16	45733990	.	G	A	0	12	12	0	23	35	0	0
16	45763476	.	G	A	1	16	17	0	14	31	0	0
16	45765813	.	C	T	22	20	42	0	1	43	0	0
16	45782233	.	C	G	19	19	38	0	0	38	0	0
16	45782244	.	C	G	17	22	39	0	1	40	0	0
16	45929436	.	A	G	26	0	26	0	23	49	0	0
16	45971160	.	A	C	2	5	7	0	0	7	0	0
16	45981322	.	C	A	4	4	8	0	0	8	0	0
16	45982020	.	A	C	2	2	4	0	1	5	0	0
16	46001108	.	T	G	1	2	3	0	0	3	0	0
16	46041889	.	T	G	1	3	4	0	0	4	0	0
16	46042159	.	T	C	2	3	5	0	0	5	0	0
16	46042171	.	G	A	1	2	3	0	1	4	0	0
16	46069113	.	C	T	6	4	10	0	0	10	0	0
16	46072733	.	C	T	2	3	5	0	1	6	0	0
16	46072745	.	A	C	2	4	6	0	1	7	0	0
16	46081352	.	A	G	4	5	9	0	0	9	0	0
16	46081353	.	A	C	4	4	8	0	1	9	0	0
16	46081656	.	A	G	1	3	4	0	0	4	0	0
16	46086280	.	A	G	6	4	10	0	1	11	0	0
16	46086333	.	G	A	12	6	18	0	1	19	0	0
16	46086357	.	A	G	16	7	23	0	0	23	0	0
16	46086373	.	T	A	14	9	23	0	1	24	0	0
16	46086484	.	A	T	15	11	26	0	0	26	0	0
16	46086538	.	G	A	0	5	5	0	11	16	0	0
16	46086719	.	G	T	6	2	8	0	0	8	0	0
16	46087257	.	G	A	8	7	15	0	0	15	0	0
16	46087290	.	T	A	8	6	14	0	0	14	0	0
16	46087414	.	G	A	0	3	3	0	5	8	0	0
16	46087459	.	T	C	6	3	9	0	0	9	0	0
16	46087583	.	C	A	1	4	5	0	0	5	0	0
16	46087945	.	T	A	7	9	16	0	1	17	0	0
16	46087951	.	T	A	7	9	16	0	1	17	0	0
16	46088298	.	G	A	3	2	5	0	0	5	0	0
16	46088372	.	T	C	2	2	4	0	0	4	0	0
16	46088652	.	C	T	6	8	14	0	0	14	0	0
16	46088711	.	T	G	12	5	17	0	0	17	0	0
16	46088837	.	C	T	14	7	21	0	0	21	0	0
16	46089485	.	A	G	9	10	19	0	1	20	0	0
16	46089490	.	T	A	9	12	21	0	0	21	0	0
16	46089809	.	C	T	1	9	10	0	16	26	0	0
16	46089867	.	G	A	17	10	27	0	0	27	0	0
16	46089979	.	T	A	16	7	23	0	0	23	0	0
16	46090056	.	C	G	15	12	27	0	0	27	0	0
16	46090070	.	T	C	13	12	25	0	0	25	0	0
16	46090157	.	G	A	8	4	12	0	1	13	0	0
16	46090186	.	C	T	9	4	13	0	0	13	0	0
16	46090296	.	G	A	4	6	10	0	0	10	0	0
16	46090310	.	G	A	3	5	8	0	0	8	0	0
16	46090447	.	A	G	15	10	25	0	0	25	0	0
16	46090629	.	G	T	6	10	16	0	0	16	0	0
16	46090640	.	A	G	9	10	19	0	0	19	0	0
16	46090713	.	T	C	8	0	8	0	13	21	0	0
16	46090731	.	T	G	8	11	19	0	1	20	0	0
16	46090749	.	G	C	7	10	17	0	0	17	0	0
16	46091068	.	T	C	5	2	7	0	0	7	0	0
16	46091116	.	A	G	7	6	13	0	0	13	0	0
16	46091247	.	T	C	3	2	5	0	1	6	0	0
16	46091273	.	A	G	2	5	7	0	1	8	0	0
16	46091314	.	T	C	3	8	11	0	1	12	0	0
16	46093332	.	A	T	6	9	15	0	0	15	0	0
16	46093580	.	G	T	13	6	19	0	1	20	0	0
16	46093685	.	T	C	12	2	14	0	6	20	0	0
16	46097033	.	A	C	11	1	12	0	7	19	0	0
16	46097111	.	G	A	15	9	24	0	1	25	0	0
16	46097239	.	G	A	14	9	23	0	0	23	0	0
16	46097268	.	A	G	12	8	20	0	2	22	0	0
16	46172471	.	C	A	27	17	44	0	3	47	0	0
16	46179734	.	T	C	30	26	56	0	2	58	0	0
16	46185307	.	A	G	25	25	50	0	0	50	0	0
16	46185349	.	G	C	1	18	19	0	30	49	0	0
16	46187505	.	T	C	32	16	48	0	0	48	0	0
16	46196245	.	C	T	24	26	50	0	1	51	0	0
16	46196287	.	T	C	25	30	55	0	3	58	0	0
16	46196347	.	T	A	17	30	47	0	2	49	0	0
16	46196536	.	T	C	18	13	31	0	3	34	0	0
16	46197266	.	G	A	4	29	33	0	32	65	0	0
16	46197308	.	A	G	43	4	47	0	26	73	0	0
16	46197313	.	T	G	48	25	73	0	2	75	0	0
16	46197343	.	C	T	47	28	75	0	2	77	0	0
16	46197358	.	A	G	27	4	31	1	46	78	0	0
16	46197442	.	G	A	40	23	63	0	9	72	0	0
16	46197490	.	G	A	39	11	50	0	9	59	0	0
16	46197955	.	T	G	35	25	60	1	3	64	0	0
16	46197988	.	A	T	28	23	51	1	3	55	0	0
16	46197999	.	A	C	30	23	53	1	1	55	0	0
16	46198166	.	T	A	31	16	47	0	1	48	0	0
16	46198167	.	T	G	30	17	47	0	0	47	0	0
16	46198208	.	C	T	20	29	49	0	7	56	0	0
16	46198222	.	T	A	23	29	52	0	2	54	0	0
16	46198319	.	G	T	32	30	62	0	1	63	0	0
16	46198322	.	C	T	28	33	61	0	3	64	0	0
16	46198380	.	C	A	28	30	58	0	0	58	0	0
16	46198406	.	A	G	32	23	55	0	1	56	0	0
16	46198430	.	A	G	28	3	31	0	24	55	0	0
16	46198451	.	A	C	26	25	51	0	2	53	0	0
16	46198486	.	A	C	20	26	46	0	1	48	1	0
16	46198641	.	C	T	15	10	25	0	3	28	0	0
16	46198658	.	T	A	12	9	21	0	1	22	0	0
16	46199364	.	C	T	20	36	56	0	1	57	0	0
16	46199471	.	C	A	29	33	62	0	3	65	0	0
16	46199492	.	C	A	31	31	62	0	5	68	1	0
16	46200063	.	T	C	24	26	50	0	5	55	0	0
16	46200165	.	C	A	26	17	43	0	0	43	0	0
16	46200409	.	T	C	32	25	57	0	1	58	0	0
16	46200510	.	G	T	27	29	56	0	1	57	0	0
16	46200560	.	G	C	42	24	66	0	2	68	0	0
16	46200578	.	G	A	44	22	66	0	5	71	0	0
16	46200655	.	G	A	8	35	43	0	24	67	0	0
16	46200678	.	A	T	32	30	62	0	5	67	0	0
16	46200787	.	T	C	34	19	53	0	1	55	1	0
16	46200907	.	T	C	19	25	44	0	2	46	0	0
16	46200958	.	C	A	25	25	50	0	0	50	0	0
16	46201121	.	T	G	28	22	50	1	5	56	0	0
16	46201155	.	A	G	43	9	52	1	1	55	1	0
16	46201157	.	T	A	44	9	53	1	0	54	0	0
16	46201254	.	A	T	37	23	60	1	0	61	0	0
16	46201525	.	T	C	30	25	55	0	0	55	0	0
16	46201559	.	A	T	40	23	63	0	1	64	0	0
16	46201583	.	A	G	42	21	63	0	1	64	0	0
16	46201599	.	T	C	35	24	59	0	1	60	0	0
16	46201943	.	T	A	30	21	51	0	3	54	0	0
16	46202287	.	G	A	36	25	61	0	0	61	0	0
16	46202423	.	C	A	15	13	28	0	3	31	0	0
16	46209196	.	A	C	11	5	16	0	0	16	0	0
16	46209231	.	T	C	9	5	14	0	0	14	0	0
16	46326446	.	G	A	1	1	2	0	1	3	0	0
16	46326451	.	T	A	1	2	3	0	0	3	0	0
16	46398536	.	A	C	9	0	9	0	2	11	0	0
16	46398567	.	C	G	5	8	13	1	0	14	0	0
16	46398595	.	T	A	5	4	9	1	1	11	0	0
16	46398609	.	G	T	7	3	10	1	0	11	0	0
16	46399080	.	G	A	5	3	8	0	1	9	0	0
16	46399240	.	T	A	1	2	3	0	0	3	0	0
16	46399242	.	G	T	1	2	3	0	0	3	0	0
16	46399542	.	G	T	1	4	5	0	0	5	0	0
16	46399623	.	C	G	3	6	9	0	1	10	0	0
16	46399680	.	C	G	3	3	6	0	0	6	0	0
16	46399709	.	C	A	5	2	7	0	0	7	0	0
16	46399788	.	G	A	5	10	15	0	0	15	0	0
16	46400404	.	A	G	2	2	4	1	0	5	0	0
16	46400551	.	A	C	1	2	3	0	0	3	0	0
16	46400553	.	T	A	1	2	3	0	0	3	0	0
16	46400723	.	C	A	1	5	6	1	0	7	0	0
16	46401030	.	A	T	3	5	8	0	0	8	0	0
16	46401210	.	T	C	3	4	7	0	0	7	0	0
16	46401284	.	G	A	1	4	5	0	0	5	0	0
16	46401350	.	T	G	3	6	9	0	0	9	0	0
16	46401576	.	A	G	4	13	17	0	0	17	0	0
16	46401584	.	T	A	3	12	15	2	0	17	0	0
16	46401617	.	A	T	5	7	12	2	0	14	0	0
16	46401805	.	G	A	6	10	16	0	0	16	0	0
16	46401945	.	A	T	6	4	10	0	1	11	0	0
16	46402049	.	C	A	7	13	20	0	0	20	0	0
16	46402130	.	A	G	7	9	16	0	0	16	0	0
16	46402167	.	G	C	5	7	12	0	0	12	0	0
16	46415769	.	T	G	5	9	14	0	0	14	0	0
16	46423028	.	G	C	11	6	17	0	2	19	0	0
16	46423378	.	G	A	13	6	19	0	4	23	0	0
16	46423477	.	G	A	13	10	23	0	1	24	0	0
16	46423636	.	G	A	10	8	18	0	1	19	0	0
16	46423663	.	A	G	10	7	17	0	2	19	0	0
16	46423675	.	T	C	8	10	18	0	1	19	0	0
16	46423705	.	G	A	10	15	25	0	0	25	0	0
16	46423793	.	C	T	14	11	25	0	1	26	0	0
16	46423805	.	T	C	13	12	25	0	0	25	0	0
16	46428381	.	C	T	3	8	11	0	0	11	0	0
16	46428430	.	A	G	7	5	12	1	0	13	0	0
16	46428448	.	A	G	10	6	16	1	0	17	0	0
16	46430421	.	T	C	2	8	10	0	0	10	0	0
16	46430447	.	C	G	3	9	12	0	0	12	0	0
16	46430618	.	A	T	1	5	6	0	0	6	0	0
16	46430635	.	C	A	3	4	7	0	1	8	0	0
16	46430678	.	T	C	10	9	19	0	2	21	0	0
16	46434021	.	A	T	14	14	28	1	0	29	0	0
16	46453207	.	G	A	0	4	4	0	5	9	0	0
16	46463730	.	C	A	10	4	14	0	0	14	0	0
16	46463979	.	A	G	3	5	8	0	0	8	0	0
16	46464028	.	A	C	4	6	10	0	0	10	0	0
16	46464030	.	G	A	4	6	10	0	0	10	0	0
16	46464090	.	A	C	3	10	13	0	0	13	0	0
16	46464132	.	T	A	1	7	8	0	0	8	0	0
16	46464148	.	T	G	2	8	10	0	0	10	0	0
16	46464219	.	G	A	7	5	12	5	0	17	0	0
16	46464345	.	C	A	5	12	17	1	0	18	0	0
16	46464423	.	A	G	5	3	8	0	3	11	0	0
16	46492885	.	T	C	2	4	6	0	0	6	0	0
16	46493014	.	G	C	13	5	18	0	0	18	0	0
16	46495214	.	A	C	7	12	19	0	1	20	0	0
16	46495334	.	T	C	11	8	19	0	2	21	0	0
16	46495697	.	C	T	10	6	16	0	1	17	0	0
16	46495798	.	T	A	11	6	17	0	0	17	0	0
16	46495811	.	G	A	9	5	14	0	1	15	0	0
16	46495934	.	C	T	10	9	19	0	0	19	0	0
16	46495967	.	T	A	10	9	19	0	0	19	0	0
16	46495973	.	G	A	10	10	20	0	0	20	0	0
16	46518484	.	G	T	19	10	29	0	1	30	0	0
16	46519918	.	G	T	16	18	34	0	1	35	0	0
16	46519934	.	T	C	20	0	20	0	17	37	0	0
16	46521257	.	A	C	5	2	7	0	0	7	0	0
16	46521259	.	A	G	5	2	7	0	0	7	0	0
16	46521455	.	G	A	12	5	17	0	0	17	0	0
16	46521473	.	C	T	8	6	14	0	1	15	0	0
16	46521655	.	A	T	10	9	19	0	0	19	0	0
16	46524751	.	G	A	9	8	17	0	0	17	0	0
16	46597917	.	G	T	1	3	4	0	0	4	0	0
16	46597939	.	T	G	1	2	3	0	0	3	0	0
16	46598534	.	C	A	1	2	3	0	0	3	0	0
16	46598620	.	G	C	2	0	2	0	3	5	0	0
16	46598634	.	C	T	0	2	2	0	2	4	0	0
16	46669372	.	C	T	14	20	34	0	1	35	0	0
16	46672203	.	C	T	32	21	53	0	4	57	0	0
16	46673322	.	A	G	25	20	45	0	1	46	0	0
16	46675583	.	A	G	19	1	20	0	28	48	0	0
16	46680792	.	G	A	10	10	20	0	0	20	0	0
16	46680793	.	A	T	10	9	19	0	1	20	0	0
16	46681041	.	G	A	6	6	12	0	0	12	0	0
16	46681057	.	G	A	5	5	10	0	0	10	0	0
16	46686003	.	C	T	10	8	18	0	2	20	0	0
16	46690948	.	G	A	0	4	4	0	14	18	0	0
16	46691033	.	G	C	11	3	14	0	1	15	0	0
16	46691090	.	C	T	11	4	15	0	0	15	0	0
16	46691095	.	A	T	9	4	13	0	0	13	0	0
16	46760985	.	G	A	5	3	8	0	0	8	0	0
16	46765812	.	C	G	2	4	6	0	1	7	0	0
16	46996688	.	C	T	3	3	6	0	0	6	0	0
16	46997129	.	G	A	0	3	3	0	2	5	0	0
16	46997207	.	G	A	0	4	4	0	3	7	0	0
16	46997210	.	T	G	3	5	8	0	0	8	0	0
16	46997301	.	G	A	0	3	3	0	3	6	0	0
16	47010050	.	G	T	4	2	6	0	0	6	0	0
16	47037522	.	C	A	4	5	9	0	0	9	0	0
16	47064792	.	C	T	3	2	5	0	0	5	0	0
16	47078694	.	A	G	2	3	5	0	0	5	0	0
16	47139663	.	C	G	7	4	11	0	1	12	0	0
16	47143367	.	C	T	4	8	12	0	0	12	0	0
16	47147338	.	T	A	6	2	8	0	0	8	0	0
16	47155603	.	C	A	4	5	9	0	1	10	0	0
16	47166502	.	C	T	2	4	6	1	1	8	0	0
16	47172327	.	G	A	2	8	10	0	0	10	0	0
16	47207696	.	G	T	2	5	7	0	1	8	0	0
16	47212178	.	C	T	11	9	20	0	1	21	0	0
16	47212235	.	T	C	16	8	24	0	2	26	0	0
16	47212262	.	T	C	16	12	28	0	1	29	0	0
16	47213103	.	T	G	12	7	19	0	0	19	0	0
16	47213952	.	T	C	11	16	27	0	1	28	0	0
16	47220058	.	A	G	13	7	20	0	1	21	0	0
16	47220091	.	C	T	11	7	18	0	0	18	0	0
16	47220423	.	G	A	5	4	9	0	2	11	0	0
16	47282195	.	C	T	0	3	3	0	4	7	0	0
16	47295624	.	T	C	4	2	6	0	0	6	0	0
16	47295864	.	G	T	1	2	3	0	0	3	0	0
16	47295870	.	A	G	2	2	4	0	0	4	0	0
16	47369950	.	C	G	1	5	6	0	0	6	0	0
16	47390849	.	A	C	19	0	19	0	12	31	0	0
16	47390924	.	G	A	29	22	51	0	1	52	0	0
16	47394576	.	T	C	1	2	3	0	0	3	0	0
16	47407678	.	G	A	25	11	36	0	3	39	0	0
16	47412094	.	T	C	11	19	30	0	2	32	0	0
16	47414715	.	G	C	7	0	7	0	12	19	0	0
16	47446694	.	A	G	3	5	8	0	2	10	0	0
16	47449938	.	A	G	3	2	5	0	0	5	0	0
16	47449968	.	C	T	2	4	6	2	0	8	0	0
16	47449978	.	T	C	2	5	7	2	0	9	0	0
16	47461930	.	T	C	2	3	5	0	0	5	0	0
16	47536388	.	C	A	4	4	8	0	0	8	0	0
16	48310177	.	G	T	10	10	20	0	0	20	0	0
16	48333845	.	G	A	8	18	26	0	0	26	0	0
16	48400548	.	A	G	21	5	26	1	2	29	0	0
16	48409352	.	T	A	12	5	17	0	1	18	0	0
16	48413440	.	C	A	21	22	43	0	1	44	0	0
16	48413512	.	T	C	21	16	37	0	2	39	0	0
16	48413518	.	A	G	21	18	39	0	1	40	0	0
16	48415976	.	A	G	14	18	32	0	0	32	0	0
16	48416125	.	A	G	20	13	33	0	0	33	0	0
16	48420833	.	T	C	10	15	25	0	0	25	0	0
16	48420875	.	T	G	12	13	25	0	4	29	0	0
16	48421111	.	C	A	19	8	27	0	1	28	0	0
16	48421120	.	G	A	20	9	29	0	0	29	0	0
16	48423129	.	G	A	15	16	31	0	1	32	0	0
16	48425249	.	T	C	16	20	36	0	0	36	0	0
16	48425361	.	C	T	21	15	36	0	0	36	0	0
16	48425409	.	A	G	24	8	32	0	2	34	0	0
16	48426900	.	T	C	16	7	23	0	7	30	0	0
16	48426912	.	T	C	19	15	34	0	0	34	0	0
16	48427232	.	G	C	15	11	26	0	0	26	0	0
16	48428029	.	T	G	6	11	17	0	1	18	0	0
16	48562620	.	G	C	6	6	12	0	0	12	0	0
16	48562641	.	G	A	6	7	13	0	0	13	0	0
16	48562683	.	T	G	5	7	12	0	0	12	0	0
16	48565712	.	T	C	5	6	11	0	0	11	0	0
16	48572669	.	T	G	5	0	5	0	5	10	0	0
16	48617256	.	G	A	4	3	7	0	0	7	0	0
16	48631134	.	A	G	5	0	5	0	4	9	0	0
16	48640819	.	G	A	0	4	4	0	2	6	0	0
16	48642999	.	C	T	0	2	2	0	1	3	0	0
16	48645550	.	T	A	1	6	7	0	0	8	1	0
16	48645716	.	A	G	3	3	6	0	0	6	0	0
16	48647903	.	C	T	2	4	6	0	0	6	0	0
16	48654744	.	C	T	1	2	3	0	0	3	0	0
16	48674032	.	A	G	2	2	4	0	0	4	0	0
16	48694375	.	G	T	0	3	3	0	4	7	0	0
16	48702313	.	T	A	1	3	4	0	0	4	0	0
16	48705431	.	A	G	3	3	6	0	0	6	0	0
16	48718921	.	C	A	10	5	15	0	2	17	0	0
16	48719014	.	T	G	5	0	5	0	5	10	0	0
16	48724002	.	G	A	10	8	18	0	0	18	0	0
16	48724702	.	A	G	13	0	13	0	13	26	0	0
16	48729892	.	T	C	5	5	10	0	2	12	0	0
16	48729898	.	T	C	4	6	10	0	3	13	0	0
16	48734083	.	C	T	6	8	14	0	0	14	0	0
16	48734182	.	C	A	6	5	11	0	1	12	0	0
16	48734183	.	A	C	6	6	12	0	0	12	0	0
16	48736054	.	A	T	4	5	9	0	0	9	0	0
16	48736081	.	A	T	7	7	14	0	1	15	0	0
16	48736173	.	A	G	10	0	10	0	6	16	0	0
16	48736197	.	G	T	1	7	8	0	9	17	0	0
16	48738688	.	C	G	5	6	11	0	1	12	0	0
16	48740686	.	C	T	9	11	20	0	0	20	0	0
16	48740787	.	A	G	9	10	19	0	2	21	0	0
16	48740799	.	C	T	10	12	22	0	0	22	0	0
16	48740833	.	C	T	13	7	20	0	1	21	0	0
16	48746356	.	T	C	8	7	15	0	0	15	0	0
16	48746364	.	A	G	7	5	12	0	0	12	0	0
16	48746661	.	A	G	2	5	7	0	0	7	0	0
16	48746695	.	T	G	5	5	10	0	0	10	0	0
16	48746783	.	A	T	6	2	8	0	0	8	0	0
16	48880946	.	T	C	2	2	4	0	0	4	0	0
16	49092586	.	T	C	4	6	10	0	0	10	0	0
16	49092814	.	G	A	1	7	8	0	4	12	0	0
16	49093177	.	A	G	2	5	7	0	1	8	0	0
16	49093456	.	A	G	8	0	8	0	7	15	0	0
16	49093519	.	T	C	8	3	11	0	0	11	0	0
16	49093802	.	T	C	8	4	12	0	0	12	0	0
16	49094074	.	T	C	4	3	7	0	1	8	0	0
16	49094428	.	A	C	5	10	15	0	0	15	0	0
16	49094545	.	T	C	5	8	13	0	0	13	0	0
16	49094563	.	A	G	5	9	14	0	0	14	0	0
16	49101761	.	A	C	7	4	11	0	0	11	0	0
16	49101764	.	T	C	7	4	11	0	0	11	0	0
16	49101833	.	G	A	1	6	7	0	7	14	0	0
16	49152252	.	A	G	6	9	15	1	0	16	0	0
16	49494432	.	G	A	6	4	10	0	0	10	0	0
16	49601851	.	C	A	5	6	11	0	2	13	0	0
16	49601927	.	T	A	4	2	6	0	0	6	0	0
16	49602080	.	T	C	1	3	4	0	0	4	0	0
16	49602096	.	A	T	2	2	4	0	1	5	0	0
16	49602143	.	C	G	5	0	5	0	10	15	0	0
16	49604533	.	T	C	5	2	7	0	0	7	0	0
16	49604680	.	T	C	5	4	9	0	0	9	0	0
16	49604710	.	A	G	7	0	7	0	5	12	0	0
16	49612936	.	G	A	2	4	6	0	3	10	1	0
16	49661388	.	A	G	4	1	5	0	4	9	0	0
16	49746618	.	A	G	4	2	6	0	0	6	0	0
16	49746626	.	A	G	3	2	5	0	0	5	0	0
16	50065048	.	A	G	20	1	21	1	17	39	0	0
16	50075551	.	C	T	22	29	51	0	2	53	0	0
16	50075605	.	T	A	23	8	31	0	4	35	0	0
16	50075929	.	A	C	11	15	26	0	2	28	0	0
16	50076029	.	C	T	15	17	32	0	1	33	0	0
16	50089431	.	C	A	1	2	3	0	0	3	0	0
16	50089599	.	T	A	22	11	33	5	0	38	0	0
16	50100455	.	C	T	20	11	31	1	3	35	0	0
16	50101946	.	A	G	15	9	24	0	1	25	0	0
16	50103878	.	G	A	0	12	12	0	20	32	0	0
16	50106063	.	C	T	26	10	36	0	0	36	0	0
16	50106645	.	A	G	21	11	32	0	1	33	0	0
16	50108878	.	C	G	9	8	17	0	1	18	0	0
16	50108888	.	C	T	9	5	14	0	1	15	0	0
16	50109017	.	C	T	14	7	21	0	0	21	0	0
16	50109386	.	T	A	10	10	20	0	1	21	0	0
16	50109434	.	G	A	18	7	25	0	2	27	0	0
16	50109595	.	T	C	16	9	25	0	3	28	0	0
16	50109795	.	T	C	24	15	39	0	1	40	0	0
16	50110125	.	G	A	0	12	12	0	10	22	0	0
16	50110277	.	C	T	22	11	33	0	1	34	0	0
16	50110671	.	A	G	18	16	34	0	1	35	0	0
16	50110899	.	T	C	13	10	23	0	0	24	1	0
16	50214904	.	G	T	8	3	11	0	0	11	0	0
16	50215016	.	T	C	14	12	26	0	0	26	0	0
16	50215017	.	G	C	13	12	25	0	1	26	0	0
16	50215058	.	C	T	17	15	32	0	0	32	0	0
16	50215068	.	T	C	18	13	31	0	0	31	0	0
16	50215112	.	C	T	11	12	23	0	0	23	0	0
16	50215171	.	G	A	14	18	32	0	1	33	0	0
16	50215222	.	A	C	24	19	43	0	1	44	0	0
16	50215734	.	T	C	20	18	38	0	1	39	0	0
16	50218386	.	T	C	20	0	20	0	15	35	0	0
16	50218401	.	A	G	22	9	31	0	2	33	0	0
16	50218470	.	T	A	16	14	30	0	3	33	0	0
16	50229213	.	T	G	2	5	7	0	0	7	0	0
16	50773405	.	G	A	8	4	12	0	1	13	0	0
16	50803247	.	G	A	7	7	14	0	2	16	0	0
16	50824069	.	C	A	13	9	22	0	0	23	1	0
16	50824090	.	C	T	14	10	24	0	1	25	0	0
16	50824469	.	A	C	2	5	7	0	0	7	0	0
16	51002287	.	G	A	6	5	11	0	1	12	0	0
16	51006177	.	A	G	1	2	3	0	0	3	0	0
16	51022256	.	C	T	0	2	2	0	4	6	0	0
16	51089469	.	G	A	4	10	14	0	0	14	0	0
16	51089547	.	A	T	2	5	7	0	0	7	0	0
16	51089556	.	A	G	2	5	7	0	1	8	0	0
16	51094706	.	G	A	1	3	4	0	0	4	0	0
16	51094724	.	G	A	2	2	4	0	0	4	0	0
16	51129917	.	G	A	2	2	4	0	1	5	0	0
16	51183892	.	A	T	6	4	10	0	0	10	0	0
16	51370110	.	T	C	2	0	2	0	2	4	0	0
16	51370114	.	T	C	1	1	2	0	1	3	0	0
16	51371894	.	G	C	5	2	7	0	0	7	0	0
16	51371936	.	G	A	4	3	7	0	0	7	0	0
16	51372164	.	G	A	2	3	5	0	0	5	0	0
16	51372456	.	G	A	1	3	4	0	0	4	0	0
16	51885808	.	G	A	26	31	57	3	5	65	0	0
16	51885855	.	A	T	40	32	72	3	4	79	0	0
16	51888929	.	C	T	27	30	57	0	0	57	0	0
16	51941865	.	T	C	5	0	5	0	9	14	0	0
16	51941885	.	C	G	5	7	12	0	1	13	0	0
16	51942108	.	G	A	11	3	14	0	0	14	0	0
16	51942155	.	G	A	7	3	10	0	0	10	0	0
16	51942375	.	T	C	9	3	12	0	0	12	0	0
16	51942442	.	T	C	5	3	8	0	0	8	0	0
16	51950726	.	C	A	15	31	46	0	0	46	0	0
16	51950754	.	C	T	13	34	47	0	2	49	0	0
16	51950814	.	A	T	38	0	38	0	1	39	0	0
16	51950877	.	G	C	19	26	45	0	2	47	0	0
16	51951690	.	T	C	4	24	28	0	0	28	0	0
16	51951691	.	T	C	7	21	28	0	1	29	0	0
16	51952002	.	T	G	7	19	26	0	2	28	0	0
16	51952023	.	A	T	8	22	30	0	3	33	0	0
16	51952063	.	A	C	9	20	29	0	1	30	0	0
16	51952817	.	C	T	6	3	9	0	0	9	0	0
16	51952826	.	C	A	4	6	10	0	1	11	0	0
16	51953009	.	G	A	24	19	43	0	2	45	0	0
16	51953048	.	T	C	17	35	52	0	0	52	0	0
16	51953057	.	T	A	16	35	51	0	0	51	0	0
16	51953189	.	G	T	27	20	47	0	1	48	0	0
16	51954683	.	C	T	1	31	32	0	16	48	0	0
16	51955675	.	G	A	22	22	44	0	3	47	0	0
16	51955696	.	G	A	24	23	47	0	1	48	0	0
16	51962068	.	A	G	21	22	43	0	3	46	0	0
16	51962089	.	C	T	27	21	48	0	1	49	0	0
16	51966774	.	C	G	17	17	34	0	2	36	0	0
16	54356904	.	C	A	3	3	6	0	1	7	0	0
16	54467236	.	T	G	1	2	3	0	0	3	0	0
16	54467260	.	C	G	1	1	2	0	1	3	0	0
16	54474858	.	A	G	6	5	11	0	1	12	0	0
16	54475037	.	G	A	4	6	10	0	1	12	1	0
16	54475064	.	G	A	6	3	9	0	0	9	0	0
16	54478053	.	A	G	7	8	15	0	1	16	0	0
16	54479732	.	G	A	13	6	19	0	0	19	0	0
16	54498049	.	G	A	8	11	19	0	1	20	0	0
16	54570431	.	C	T	4	4	8	0	0	8	0	0
16	54571035	.	G	A	9	8	17	0	0	17	0	0
16	54571483	.	T	A	12	8	20	1	1	22	0	0
16	54571484	.	G	T	13	8	21	1	0	22	0	0
16	54574177	.	T	C	3	8	11	0	1	12	0	0
16	54574237	.	T	G	12	12	24	0	0	24	0	0
16	54574282	.	C	G	15	11	26	0	1	27	0	0
16	54580999	.	T	C	11	8	19	0	2	21	0	0
16	54583177	.	C	T	16	9	25	0	0	25	0	0
16	54584670	.	C	T	14	8	22	0	0	22	0	0
16	54585729	.	G	C	0	8	8	0	15	23	0	0
16	54586574	.	C	G	9	5	14	0	0	14	0	0
16	54590177	.	C	T	5	9	14	0	0	14	0	0
16	54590219	.	A	G	14	1	15	0	9	24	0	0
16	54590594	.	C	T	17	18	35	0	2	37	0	0
16	54592503	.	T	C	10	20	30	0	2	32	0	0
16	54593401	.	A	G	16	13	29	0	1	30	0	0
16	54594047	.	A	C	25	12	37	1	8	47	1	0
16	54594413	.	C	T	17	17	34	0	1	35	0	0
16	54594421	.	A	G	14	16	30	0	4	34	0	0
16	54594511	.	A	G	8	2	10	0	16	26	0	0
16	54594598	.	T	A	9	16	25	0	1	26	0	0
16	54594605	.	T	C	10	17	27	0	0	27	0	0
16	54636042	.	T	C	1	0	1	0	3	4	0	0
16	54636973	.	T	G	1	4	5	0	0	5	0	0
16	54637009	.	A	G	1	3	4	0	0	4	0	0
16	54637993	.	T	C	1	0	1	0	3	4	0	0
16	54678390	.	A	G	2	0	2	0	4	6	0	0
16	54678703	.	T	C	1	4	5	0	0	5	0	0
16	54679790	.	T	C	1	2	3	0	0	3	0	0
16	54780864	.	G	A	1	14	15	0	12	27	0	0
16	54782542	.	G	A	2	18	20	0	15	35	0	0
16	54785573	.	C	G	24	18	42	0	0	42	0	0
16	54785894	.	A	G	4	10	14	0	1	15	0	0
16	54787578	.	G	A	5	8	13	0	0	13	0	0
16	54787725	.	C	T	4	18	22	0	24	46	0	0
16	54794760	.	G	A	3	5	8	23	0	31	0	0
16	54795732	.	A	G	10	11	21	0	0	21	0	0
16	54795735	.	G	A	10	9	19	0	1	20	0	0
16	54806967	.	C	A	3	2	5	0	2	7	0	0
16	54809855	.	C	T	2	2	4	0	0	4	0	0
16	54809957	.	G	A	1	3	4	0	0	4	0	0
17	69894	.	A	G	15	9	24	0	0	24	0	0
17	70497	.	G	C	13	4	17	0	0	17	0	0
17	70668	.	A	G	3	0	3	0	3	6	0	0
17	70693	.	A	G	4	3	7	0	0	7	0	0
17	70933	.	C	G	5	4	9	0	0	9	0	0
17	70970	.	A	G	5	5	10	0	0	10	0	0
17	71012	.	A	T	7	4	11	0	1	12	0	0
17	132695	.	G	A	2	4	6	0	0	6	0	0
17	132932	.	A	C	4	5	9	0	0	9	0	0
17	133001	.	C	G	4	3	7	0	2	9	0	0
17	133232	.	G	A	0	5	5	0	3	8	0	0
17	136304	.	A	G	18	17	35	0	2	37	0	0
17	136599	.	G	A	12	18	30	0	1	31	0	0
17	199664	.	G	A	1	2	3	0	0	3	0	0
17	200191	.	G	A	3	5	8	0	0	8	0	0
17	338188	.	C	A	4	6	10	0	1	11	0	0
17	338367	.	G	A	0	3	3	0	10	13	0	0
17	338443	.	A	C	5	8	13	0	0	13	0	0
17	338449	.	G	T	6	8	14	0	0	14	0	0
17	346672	.	A	C	5	5	10	0	0	10	0	0
17	402167	.	A	T	7	3	10	0	1	11	0	0
17	585963	.	G	A	1	7	8	0	0	8	0	0
17	600039	.	A	T	9	6	15	0	0	15	0	0
17	601550	.	A	G	3	7	10	0	0	10	0	0
17	604796	.	A	G	3	2	5	0	1	6	0	0
17	604853	.	G	A	2	8	10	0	0	10	0	0
17	604934	.	T	G	7	5	12	0	0	12	0	0
17	604955	.	A	G	7	4	11	0	0	11	0	0
17	605332	.	G	A	5	5	10	0	0	10	0	0
17	605512	.	G	A	6	4	10	0	0	10	0	0
17	634685	.	T	G	3	5	8	0	0	8	0	0
17	635311	.	C	T	7	4	11	0	0	11	0	0
17	635319	.	G	A	7	4	11	0	2	13	0	0
17	636178	.	C	T	6	3	9	0	1	10	0	0
17	643535	.	A	G	2	0	2	0	4	6	0	0
17	645486	.	T	C	4	5	9	0	0	9	0	0
17	660617	.	C	A	5	19	24	0	17	41	0	0
17	681127	.	G	A	25	14	39	0	0	39	0	0
17	734235	.	T	C	14	0	14	0	16	30	0	0
17	734244	.	T	C	16	16	32	0	0	32	0	0
17	734492	.	T	C	4	1	5	0	10	15	0	0
17	735297	.	C	G	2	5	7	2	4	13	0	0
17	735472	.	G	A	8	7	15	0	2	17	0	0
17	735511	.	T	C	5	0	5	0	8	13	0	0
17	735520	.	G	A	2	5	7	0	1	8	0	0
17	742225	.	C	T	5	6	11	0	0	11	0	0
17	742274	.	A	T	8	5	13	0	0	13	0	0
17	743576	.	T	A	16	9	25	0	2	27	0	0
17	743851	.	C	A	21	14	35	0	1	36	0	0
17	814735	.	G	T	4	2	6	0	0	6	0	0
17	860186	.	T	C	6	0	6	0	10	16	0	0
17	860339	.	G	A	13	13	26	0	0	26	0	0
17	860451	.	C	G	5	7	12	0	1	13	0	0
17	860501	.	G	A	10	15	25	0	0	25	0	0
17	860645	.	C	T	2	10	12	0	6	18	0	0
17	860704	.	G	A	5	13	18	0	2	20	0	0
17	860852	.	A	G	6	8	14	0	2	16	0	0
17	861065	.	G	A	3	3	6	0	1	7	0	0
17	867178	.	T	G	8	4	12	0	0	12	0	0
17	867190	.	T	C	7	5	12	0	1	13	0	0
17	867896	.	G	T	8	5	13	0	0	13	0	0
17	921371	.	C	T	2	15	17	3	14	34	0	0
17	923611	.	A	G	26	15	41	0	1	42	0	0
17	927187	.	A	G	22	13	35	0	1	36	0	0
17	931976	.	G	T	18	9	27	0	0	27	0	0
17	932270	.	G	A	16	7	23	0	0	23	0	0
17	932357	.	G	A	14	7	21	0	1	22	0	0
17	932759	.	A	G	10	7	17	0	1	18	0	0
17	932789	.	G	C	11	8	19	0	1	20	0	0
17	932858	.	C	A	2	12	14	0	15	29	0	0
17	932969	.	C	T	0	8	8	1	18	27	0	0
17	933002	.	A	G	17	8	25	1	1	27	0	0
17	936056	.	C	T	17	11	28	0	0	28	0	0
17	936203	.	G	A	12	15	27	0	0	27	0	0
17	937642	.	A	G	11	12	23	0	0	23	0	0
17	937725	.	G	A	22	6	28	0	0	28	0	0
17	937738	.	T	C	21	6	27	0	1	28	0	0
17	939749	.	A	G	13	15	28	0	0	28	0	0
17	939806	.	C	T	9	6	15	0	0	15	0	0
17	940742	.	C	T	10	11	21	0	1	22	0	0
17	945731	.	T	C	24	12	36	0	1	37	0	0
17	945812	.	C	T	3	18	21	0	17	38	0	0
17	945836	.	G	T	20	14	34	0	0	34	0	0
17	973958	.	A	G	6	11	17	0	0	17	0	0
17	974775	.	C	T	10	7	17	0	0	17	0	0
17	974838	.	G	T	14	12	26	0	0	26	0	0
17	1122515	.	G	A	4	2	6	0	0	6	0	0
17	1122530	.	T	G	2	3	5	0	0	5	0	0
17	1144445	.	T	A	5	3	8	1	0	9	0	0
17	1159904	.	G	T	1	2	3	0	2	5	0	0
17	1174853	.	C	T	2	4	6	0	0	6	0	0
17	1256708	.	A	G	4	3	7	0	0	7	0	0
17	1256747	.	C	T	3	6	9	0	0	9	0	0
17	1258380	.	C	T	2	9	11	0	0	11	0	0
17	1351572	.	T	C	2	6	8	0	1	9	0	0
17	1355243	.	T	G	5	2	7	0	0	7	0	0
17	1355561	.	A	T	3	2	5	0	0	5	0	0
17	1355562	.	C	T	3	2	5	0	0	5	0	0
17	1355621	.	T	A	6	3	9	0	0	9	0	0
17	1360292	.	G	T	1	6	7	1	5	13	0	0
17	1362172	.	C	T	5	7	12	1	1	14	0	0
17	1362295	.	G	T	0	3	3	0	4	7	0	0
17	1527642	.	T	C	1	2	3	0	0	3	0	0
17	1527669	.	T	G	2	2	4	0	0	4	0	0
17	1528411	.	A	T	4	3	7	0	0	7	0	0
17	1545059	.	A	C	1	3	4	0	1	5	0	0
17	1585515	.	T	C	4	2	6	0	0	6	0	0
17	1591201	.	T	C	2	3	5	0	0	5	0	0
17	1591245	.	A	G	2	3	5	0	0	5	0	0
17	1605946	.	T	C	2	5	7	0	0	7	0	0
17	2063925	.	A	G	27	26	53	0	1	54	0	0
17	2091858	.	G	A	3	14	17	2	20	39	0	0
17	2095454	.	T	C	17	25	42	0	1	43	0	0
17	2095525	.	A	G	14	0	14	0	38	52	0	0
17	2109014	.	C	T	2	13	15	0	4	19	0	0
17	2110588	.	G	A	19	10	29	1	0	30	0	0
17	2110642	.	C	G	19	12	31	1	1	33	0	0
17	2110657	.	T	C	17	0	17	0	14	31	0	0
17	2115464	.	A	T	18	14	32	0	0	32	0	0
17	2121955	.	T	A	17	19	36	0	0	36	0	0
17	2122175	.	A	G	19	18	37	0	0	37	0	0
17	2122252	.	C	T	18	21	39	0	0	39	0	0
17	2226867	.	T	C	4	6	10	0	0	10	0	0
17	2226876	.	T	C	4	6	10	0	0	10	0	0
17	2226906	.	A	T	7	5	12	0	0	12	0	0
17	2226957	.	A	G	7	4	11	0	1	12	0	0
17	2231353	.	C	T	3	6	9	0	0	9	0	0
17	2231359	.	G	A	3	3	6	0	0	6	0	0
17	2231392	.	G	A	0	2	2	0	3	5	0	0
17	2231485	.	T	C	6	6	12	0	0	12	0	0
17	2231608	.	T	C	5	2	7	0	0	7	0	0
17	2231611	.	T	A	5	2	7	0	0	7	0	0
17	2236279	.	G	A	4	2	6	0	0	6	0	0
17	2236285	.	C	T	5	1	6	0	1	7	0	0
17	2239799	.	C	G	4	3	7	1	1	9	0	0
17	2260582	.	G	A	5	3	8	1	0	9	0	0
17	2366396	.	A	G	2	12	14	0	0	14	0	0
17	2369970	.	C	T	1	8	9	0	0	9	0	0
17	2421926	.	T	C	1	0	1	0	4	5	0	0
17	2479620	.	C	A	12	6	18	0	0	18	0	0
17	2498487	.	T	C	7	10	17	0	0	17	0	0
17	2498572	.	C	T	8	7	15	0	0	15	0	0
17	2498573	.	C	G	8	7	15	0	0	15	0	0
17	2498615	.	C	G	7	11	18	0	0	18	0	0
17	2696756	.	C	G	5	2	7	1	1	9	0	0
17	2698205	.	A	T	1	2	3	0	0	3	0	0
17	2698362	.	G	C	1	3	4	0	0	4	0	0
17	2698366	.	C	T	1	3	4	0	0	4	0	0
17	2704135	.	G	T	5	2	7	0	0	7	0	0
17	2721265	.	C	T	1	7	8	0	0	8	0	0
17	2765386	.	T	C	1	3	4	0	0	4	0	0
17	2765641	.	C	T	2	2	4	0	0	4	0	0
17	2902704	.	C	A	5	3	8	0	0	8	0	0
17	2902815	.	G	T	5	7	12	0	1	13	0	0
17	2902880	.	A	G	7	7	14	0	0	15	1	0
17	2902911	.	T	G	5	4	9	0	0	9	0	0
17	2905136	.	C	T	4	2	6	1	0	7	0	0
17	2905873	.	G	A	1	2	3	0	0	3	0	0
17	2905919	.	G	A	2	2	4	0	0	4	0	0
17	2906277	.	T	G	2	2	4	0	0	4	0	0
17	2906314	.	G	A	1	2	3	0	0	3	0	0
17	2945170	.	T	A	1	2	3	0	0	3	0	0
17	3183403	.	C	G	1	4	5	0	0	5	0	0
17	3183532	.	G	A	4	3	7	0	0	7	0	0
17	3183694	.	A	G	2	2	4	0	1	5	0	0
17	3183970	.	A	G	3	5	8	0	0	8	0	0
17	3184246	.	G	A	4	4	8	0	0	8	0	0
17	3184594	.	G	A	2	2	4	0	0	4	0	0
17	3189669	.	G	A	2	2	4	0	0	4	0	0
17	3189916	.	G	A	1	2	3	0	0	3	0	0
17	3446847	.	T	C	6	11	17	0	2	19	0	0
17	3514131	.	C	T	7	5	12	0	0	12	0	0
17	3566811	.	A	G	6	8	14	0	0	14	0	0
17	3566844	.	T	A	6	11	17	0	0	17	0	0
17	3569047	.	T	C	9	5	14	0	0	14	0	0
17	3569050	.	A	C	10	6	16	0	0	16	0	0
17	3569264	.	A	C	4	13	17	0	1	18	0	0
17	3841153	.	A	G	14	11	25	1	0	26	0	0
17	3854290	.	C	T	15	16	31	0	0	31	0	0
17	3855436	.	T	C	14	0	14	0	16	30	0	0
17	3855697	.	C	T	2	9	11	0	22	33	0	0
17	3860794	.	C	G	14	6	20	0	1	21	0	0
17	3860797	.	T	C	13	0	13	0	8	21	0	0
17	3860857	.	C	T	2	14	16	0	12	28	0	0
17	3866424	.	A	T	11	14	25	0	0	25	0	0
17	3868759	.	A	C	12	0	12	0	6	19	1	0
17	3868765	.	T	C	14	0	14	0	9	23	0	0
17	3904966	.	A	T	9	10	19	0	0	19	0	0
17	3905005	.	T	C	7	0	7	0	7	14	0	0
17	3905008	.	G	A	7	6	13	0	1	14	0	0
17	3970905	.	C	T	0	7	7	0	6	13	0	0
17	3986153	.	G	A	10	8	18	0	0	18	0	0
17	3986204	.	A	G	7	6	13	0	0	13	0	0
17	3993854	.	A	G	3	0	3	0	7	10	0	0
17	3993866	.	A	G	6	0	6	0	6	12	0	0
17	4009449	.	T	C	8	5	13	0	0	13	0	0
17	4017133	.	A	C	1	2	3	0	0	3	0	0
17	4239560	.	G	A	0	1	1	0	0	1	0	0
17	4239567	.	T	A	2	2	4	0	0	4	0	0
17	4239711	.	A	G	12	14	26	0	0	26	0	0
17	4239975	.	C	T	8	7	15	0	2	17	0	0
17	4240034	.	A	T	10	13	23	0	0	23	0	0
17	4240188	.	G	T	9	13	22	0	1	23	0	0
17	4297551	.	A	C	31	18	49	0	1	50	0	0
17	4297600	.	T	C	29	13	42	0	2	44	0	0
17	4297608	.	G	T	28	14	42	0	3	45	0	0
17	4297649	.	T	A	20	11	31	0	1	32	0	0
17	4297669	.	A	C	21	11	32	0	1	33	0	0
17	4298287	.	A	G	20	29	49	0	1	50	0	0
17	4298306	.	T	G	22	28	50	0	0	50	0	0
17	4298764	.	C	A	9	8	17	0	0	17	0	0
17	4299030	.	C	G	20	26	46	0	2	48	0	0
17	4304841	.	G	A	32	34	66	1	1	68	0	0
17	4307164	.	G	A	34	20	54	0	1	55	0	0
17	4307242	.	T	C	23	1	24	1	29	54	0	0
17	4317738	.	G	A	30	24	54	0	1	55	0	0
17	4368900	.	T	A	4	3	7	0	0	7	0	0
17	4368935	.	A	T	8	5	13	0	0	13	0	0
17	4369064	.	A	G	3	5	8	0	1	9	0	0
17	4369166	.	C	G	3	6	9	0	0	9	0	0
17	4369304	.	T	C	5	5	10	0	1	11	0	0
17	4369379	.	G	T	4	7	11	0	0	11	0	0
17	4378210	.	G	A	2	6	8	1	0	9	0	0
17	4635479	.	G	C	0	2	2	0	2	4	0	0
17	4702341	.	A	G	2	0	2	0	2	4	0	0
17	4702346	.	C	T	2	2	4	0	0	4	0	0
17	5061184	.	G	C	7	8	15	0	0	15	0	0
17	5071257	.	G	A	8	13	21	0	0	21	0	0
17	5079084	.	T	C	21	10	31	0	2	33	0	0
17	5081406	.	A	C	11	13	24	1	0	25	0	0
17	5081445	.	G	A	1	10	11	0	16	27	0	0
17	5084892	.	G	A	10	14	24	0	0	24	0	0
17	5090829	.	G	A	1	17	18	0	17	35	0	0
17	5094355	.	T	C	21	22	43	0	2	45	0	0
17	5101234	.	A	G	18	1	19	0	16	35	0	0
17	5105828	.	T	C	5	3	8	0	0	8	0	0
17	5215192	.	T	G	7	8	15	0	0	15	0	0
17	5217050	.	T	C	6	0	6	0	7	13	0	0
17	5239046	.	C	T	0	6	6	0	5	11	0	0
17	5599082	.	C	T	1	3	4	0	0	4	0	0
17	5599449	.	A	C	2	4	6	0	0	6	0	0
17	5599563	.	T	C	1	0	1	0	3	4	0	0
17	5602339	.	C	G	0	4	4	0	2	6	0	0
17	5605973	.	G	A	4	4	8	0	0	8	0	0
17	5606080	.	T	C	2	2	4	0	0	4	0	0
17	5606443	.	G	A	2	3	5	0	0	5	0	0
17	5663122	.	A	G	2	2	4	0	0	4	0	0
17	5756664	.	T	C	2	0	2	0	8	10	0	0
17	5766286	.	A	C	2	3	5	0	0	5	0	0
17	5768681	.	A	T	3	5	8	0	0	8	0	0
17	5768712	.	A	G	1	4	5	0	0	5	0	0
17	5768722	.	C	T	2	3	5	0	0	5	0	0
17	5768756	.	T	C	2	0	2	0	5	7	0	0
17	5769127	.	T	A	6	6	12	0	0	12	0	0
17	5769140	.	T	A	4	6	10	0	0	10	0	0
17	5816030	.	C	G	2	3	5	0	0	5	0	0
17	5816815	.	A	C	1	4	5	0	0	5	0	0
17	5817015	.	G	A	3	2	5	0	0	5	0	0
17	5817167	.	T	C	2	2	4	0	0	4	0	0
17	5817651	.	A	G	3	2	5	0	0	5	0	0
17	5818501	.	G	T	1	3	4	0	0	4	0	0
17	5820170	.	C	T	6	2	8	0	0	8	0	0
17	5820173	.	C	T	2	6	8	0	0	8	0	0
17	5821130	.	C	T	4	3	7	0	2	9	0	0
17	5821476	.	G	A	5	9	14	0	0	14	0	0
17	5895865	.	G	A	0	7	7	0	11	18	0	0
17	5896025	.	G	A	17	16	33	0	0	33	0	0
17	5896210	.	G	T	11	11	22	0	2	24	0	0
17	5916287	.	T	C	11	18	29	0	0	29	0	0
17	5916392	.	A	G	16	15	31	0	1	32	0	0
17	5926722	.	T	C	20	24	44	0	0	44	0	0
17	5926729	.	A	G	26	20	46	0	0	46	0	0
17	5926981	.	A	T	12	13	25	0	0	25	0	0
17	5927085	.	C	A	9	12	21	0	0	21	0	0
17	5927101	.	T	C	6	6	12	0	3	15	0	0
17	5927172	.	G	A	4	3	7	0	0	7	0	0
17	5932003	.	C	A	1	2	3	0	0	3	0	0
17	6016487	.	A	T	1	2	3	0	0	3	0	0
17	6079976	.	A	T	3	3	6	0	1	7	0	0
17	6080000	.	A	C	1	2	3	0	0	3	0	0
17	6080026	.	G	A	1	2	3	0	0	3	0	0
17	6088559	.	C	T	1	2	3	0	0	3	0	0
17	6100980	.	G	A	1	3	4	0	0	4	0	0
17	6279806	.	C	A	11	11	22	0	2	24	0	0
17	6279876	.	G	T	1	22	23	0	14	37	0	0
17	6394301	.	C	T	0	8	8	0	8	16	0	0
17	6394744	.	C	T	7	7	14	0	0	14	0	0
17	6395381	.	G	C	11	11	22	0	0	22	0	0
17	6395560	.	T	C	13	0	13	0	12	25	0	0
17	6395971	.	G	T	6	2	8	0	0	8	0	0
17	6396090	.	G	A	6	8	14	0	0	14	0	0
17	6396349	.	T	C	7	2	9	0	1	10	0	0
17	6396474	.	A	T	7	5	12	0	1	13	0	0
17	6396513	.	A	G	6	5	11	0	0	11	0	0
17	6396759	.	G	T	5	0	5	0	2	7	0	0
17	6396764	.	T	C	5	2	7	0	0	7	0	0
17	6397618	.	C	T	4	6	10	0	1	11	0	0
17	6397654	.	A	T	6	3	9	0	1	10	0	0
17	6397883	.	G	A	8	11	19	1	2	22	0	0
17	6397926	.	C	A	8	8	16	0	0	16	0	0
17	6398456	.	G	C	3	5	8	0	0	8	0	0
17	6398570	.	G	A	7	3	10	0	0	10	0	0
17	6398621	.	G	A	3	7	10	0	0	10	0	0
17	6398704	.	G	T	2	7	9	0	0	9	0	0
17	6398916	.	C	G	4	4	8	0	0	8	0	0
17	6398949	.	G	A	5	4	9	0	0	9	0	0
17	6398956	.	G	A	3	4	7	0	1	8	0	0
17	6438226	.	C	T	3	4	7	0	1	8	0	0
17	6438387	.	T	C	2	2	4	0	0	5	1	0
17	6438630	.	T	A	6	7	13	0	0	13	0	0
17	6444514	.	T	A	9	7	16	0	1	17	0	0
17	6447234	.	A	G	6	9	15	0	1	16	0	0
17	6447418	.	G	T	4	5	9	0	2	11	0	0
17	6449404	.	C	T	0	6	6	0	4	10	0	0
17	6451511	.	G	A	4	4	8	0	0	8	0	0
17	6451687	.	A	G	6	3	9	0	0	9	0	0
17	6451702	.	A	G	7	6	13	0	1	14	0	0
17	6452854	.	C	T	3	4	7	0	0	7	0	0
17	6452857	.	T	C	3	4	7	0	0	7	0	0
17	6460449	.	A	C	5	3	8	0	0	8	0	0
17	6462023	.	A	T	10	4	14	0	0	14	0	0
17	6462228	.	G	A	2	7	9	0	1	10	0	0
17	6469798	.	C	T	1	2	3	0	0	3	0	0
17	6472902	.	C	T	2	2	4	0	0	4	0	0
17	6472911	.	G	A	3	2	5	0	0	5	0	0
17	6491338	.	A	C	2	2	4	0	0	4	0	0
17	6544615	.	T	C	3	2	5	0	0	5	0	0
17	6552999	.	T	G	3	2	5	0	0	5	0	0
17	6715755	.	T	A	36	29	65	0	1	66	0	0
17	6716412	.	G	T	36	33	69	0	2	71	0	0
17	6716472	.	G	A	36	36	72	0	4	76	0	0
17	6730114	.	G	A	41	33	74	0	5	79	0	0
17	6737970	.	C	A	3	30	33	0	32	65	0	0
17	6738212	.	C	A	1	10	11	0	10	21	0	0
17	6754428	.	C	T	1	12	13	0	8	21	0	0
17	6754437	.	T	C	8	11	19	0	0	19	0	0
17	6758867	.	T	G	12	20	32	0	0	32	0	0
17	6808406	.	A	G	4	7	11	0	0	11	0	0
17	6808413	.	T	C	0	7	7	0	0	7	0	0
17	6918982	.	G	A	0	3	3	0	2	5	0	0
17	7775813	.	G	A	1	3	4	0	0	4	0	0
17	7776723	.	T	C	1	2	3	0	0	3	0	0
17	7778162	.	A	C	1	4	5	0	0	5	0	0
17	7778280	.	C	T	1	2	3	0	0	3	0	0
17	7778700	.	C	T	4	3	7	0	0	7	0	0
17	7778710	.	A	G	2	4	6	0	0	6	0	0
17	7779464	.	A	G	1	3	4	0	0	4	0	0
17	7779609	.	T	A	1	2	3	0	0	3	0	0
17	7779617	.	A	G	1	2	3	0	0	3	0	0
17	7781458	.	T	A	1	2	3	0	0	3	0	0
17	7781648	.	A	C	6	4	10	0	0	10	0	0
17	7783451	.	G	T	2	2	4	0	0	4	0	0
17	7802799	.	A	G	6	5	11	0	0	11	0	0
17	7818872	.	T	A	2	5	7	0	0	7	0	0
17	7844994	.	G	A	5	7	12	0	0	12	0	0
17	7845364	.	G	C	17	13	30	0	1	31	0	0
17	7845412	.	T	C	15	15	30	0	0	30	0	0
17	7845566	.	C	T	10	18	28	1	1	30	0	0
17	7861124	.	C	T	17	16	33	0	2	35	0	0
17	7868632	.	G	A	32	18	50	0	1	51	0	0
17	7879348	.	T	C	24	17	41	0	1	42	0	0
17	7882941	.	G	A	18	12	30	0	1	31	0	0
17	7882998	.	G	A	11	14	25	0	0	25	0	0
17	7885662	.	A	G	16	20	36	1	0	37	0	0
17	7894976	.	T	A	15	22	37	0	1	38	0	0
17	7895023	.	G	A	20	19	39	0	6	45	0	0
17	7896356	.	C	T	2	18	20	0	22	42	0	0
17	7896390	.	C	T	3	11	14	0	18	32	0	0
17	7896478	.	C	T	22	17	39	0	0	39	0	0
17	7901137	.	C	T	26	13	39	0	1	40	0	0
17	7906568	.	G	T	18	13	31	0	0	31	0	0
17	7906610	.	C	T	11	11	22	0	2	24	0	0
17	7906612	.	G	A	14	10	24	0	0	24	0	0
17	7906646	.	T	A	12	13	25	0	0	25	0	0
17	7907851	.	C	T	12	12	24	0	0	24	0	0
17	7917997	.	G	A	12	17	29	0	0	29	0	0
17	7926040	.	G	A	11	13	24	0	1	25	0	0
17	7926076	.	C	T	10	7	17	0	2	19	0	0
17	7928263	.	A	G	17	7	24	0	0	24	0	0
17	7928600	.	C	A	0	9	9	0	13	22	0	0
17	7931737	.	G	A	9	6	15	0	0	15	0	0
17	7942122	.	G	A	11	7	18	0	1	19	0	0
17	7942127	.	T	C	10	6	16	0	4	20	0	0
17	7942191	.	T	G	11	9	20	0	1	21	0	0
17	7942366	.	T	G	9	10	19	0	4	23	0	0
17	7945421	.	C	G	12	9	21	0	1	22	0	0
17	7945485	.	A	G	8	12	20	1	1	22	0	0
17	7949042	.	G	A	12	6	18	0	0	18	0	0
17	7949066	.	G	A	9	9	18	0	0	18	0	0
17	7950372	.	C	T	11	8	19	0	0	19	0	0
17	7963202	.	G	C	7	5	12	0	0	12	0	0
17	7963236	.	G	A	5	4	9	0	0	9	0	0
17	7963282	.	G	A	7	6	13	0	0	13	0	0
17	7963294	.	G	A	7	7	14	0	0	14	0	0
17	7974804	.	T	C	13	6	19	0	2	21	0	0
17	7977746	.	A	T	2	3	5	0	0	5	0	0
17	7977806	.	C	T	5	5	10	0	0	10	0	0
17	7978112	.	T	G	3	6	9	0	1	10	0	0
17	7978533	.	G	A	7	3	10	0	1	11	0	0
17	7981566	.	C	T	8	7	15	0	0	15	0	0
17	7983068	.	A	G	10	4	14	0	0	14	0	0
17	7984355	.	G	A	5	5	10	0	0	10	0	0
17	7985543	.	A	G	3	5	8	0	0	8	0	0
17	7986359	.	T	C	9	6	15	0	0	15	0	0
17	7991338	.	G	A	12	6	18	0	0	18	0	0
17	7999827	.	G	T	4	7	11	0	1	12	0	0
17	8000049	.	T	C	5	7	12	0	0	12	0	0
17	8000122	.	C	A	4	7	11	0	1	12	0	0
17	8002895	.	G	T	7	8	15	0	0	15	0	0
17	8002928	.	C	G	10	8	18	0	1	19	0	0
17	8002978	.	G	A	7	7	14	0	0	14	0	0
17	8003009	.	G	A	3	7	10	0	0	10	0	0
17	8003027	.	T	C	3	6	9	0	1	10	0	0
17	8006696	.	T	C	8	5	13	0	0	13	0	0
17	8015404	.	G	A	7	5	12	0	0	12	0	0
17	8022572	.	A	T	5	2	7	0	0	7	0	0
17	8022605	.	G	A	2	6	8	0	0	8	0	0
17	8024283	.	A	T	7	3	10	0	0	10	0	0
17	8024338	.	C	T	11	5	16	0	0	16	0	0
17	8024551	.	G	A	6	7	13	0	1	14	0	0
17	8032895	.	C	T	4	6	10	0	3	13	0	0
17	8041978	.	C	T	7	8	15	0	0	15	0	0
17	8042148	.	G	A	5	6	11	0	0	11	0	0
17	8044522	.	C	T	0	2	2	0	1	3	0	0
17	8046950	.	A	C	2	4	6	0	1	7	0	0
17	8048934	.	A	G	2	3	5	0	0	5	0	0
17	8052456	.	G	A	1	5	6	0	0	6	0	0
17	8052666	.	G	A	1	3	4	0	1	5	0	0
17	8052960	.	T	C	3	7	10	0	0	10	0	0
17	8054868	.	A	T	5	7	12	0	1	13	0	0
17	8054938	.	A	G	11	5	16	0	0	16	0	0
17	8056251	.	A	T	5	3	8	0	0	8	0	0
17	8060057	.	G	A	2	3	5	0	0	5	0	0
17	8060288	.	T	C	5	2	7	0	0	7	0	0
17	8071643	.	G	A	1	2	3	0	0	3	0	0
17	8074715	.	C	T	1	3	4	0	0	4	0	0
17	8074871	.	A	T	2	3	5	0	0	5	0	0
17	8086622	.	G	A	5	4	9	0	0	9	0	0
17	8094875	.	A	T	3	2	5	0	0	5	0	0
17	8109529	.	G	A	3	2	5	0	0	5	0	0
17	8109535	.	A	G	4	2	6	0	0	6	0	0
17	8178864	.	T	C	1	2	3	0	0	3	0	0
17	8178878	.	G	A	1	2	3	0	0	3	0	0
17	8184435	.	A	G	12	0	12	1	11	24	0	0
17	8188963	.	G	T	0	11	11	0	8	19	0	0
17	8191475	.	A	G	15	8	23	0	1	24	0	0
17	8197141	.	G	A	14	14	28	0	2	30	0	0
17	8197569	.	C	A	10	12	22	0	0	22	0	0
17	8199812	.	C	T	14	7	21	0	2	23	0	0
17	8199824	.	G	A	9	16	25	0	0	25	0	0
17	8199896	.	T	C	8	9	17	0	0	17	0	0
17	8202712	.	G	A	2	14	16	0	16	32	0	0
17	8202742	.	G	A	2	12	14	0	22	36	0	0
17	8202778	.	T	C	30	13	43	0	0	43	0	0
17	8203468	.	G	A	22	15	37	0	2	39	0	0
17	8203498	.	G	A	19	13	32	0	5	37	0	0
17	8204086	.	G	C	15	11	26	0	1	27	0	0
17	8204087	.	C	T	15	10	25	0	1	26	0	0
17	8204248	.	A	G	9	0	9	0	20	29	0	0
17	8204533	.	C	T	12	23	35	0	3	38	0	0
17	8204755	.	A	G	14	26	40	0	3	43	0	0
17	8204818	.	A	G	24	16	40	0	1	41	0	0
17	8204935	.	T	C	18	27	45	0	3	48	0	0
17	8204962	.	C	T	13	30	43	0	3	46	0	0
17	8205697	.	A	G	19	25	44	0	1	45	0	0
17	8209315	.	T	C	11	12	23	1	1	25	0	0
17	8209327	.	C	T	10	14	24	1	0	25	0	0
17	8209837	.	T	A	10	20	30	0	0	30	0	0
17	8209931	.	C	A	13	12	25	0	1	26	0	0
17	8209944	.	A	G	10	14	24	0	2	26	0	0
17	8210203	.	G	A	13	9	22	0	0	22	0	0
17	8210242	.	C	T	19	9	28	0	1	29	0	0
17	8210411	.	A	G	7	11	18	0	0	18	0	0
17	8210466	.	A	G	8	0	8	0	11	19	0	0
17	8229964	.	C	T	7	2	9	0	1	10	0	0
17	8245790	.	C	A	0	6	6	0	3	9	0	0
17	8246281	.	G	A	1	3	4	0	1	5	0	0
17	8246329	.	T	C	2	4	6	0	0	6	0	0
17	8246341	.	A	G	3	5	8	0	0	8	0	0
17	8248987	.	A	G	4	5	9	0	0	9	0	0
17	8249153	.	A	T	8	4	12	0	1	13	0	0
17	8253267	.	A	G	4	4	8	0	0	8	0	0
17	8253455	.	T	A	2	2	4	0	0	4	0	0
17	8261565	.	G	A	5	3	8	0	0	8	0	0
17	8261762	.	C	T	9	2	11	0	0	11	0	0
17	8261769	.	G	A	10	4	14	0	0	14	0	0
17	8261864	.	A	T	5	3	8	0	0	8	0	0
17	8265406	.	G	A	1	2	3	0	0	3	0	0
17	8272459	.	T	C	2	3	5	0	0	5	0	0
17	8286764	.	C	T	8	3	11	0	0	11	0	0
17	8286877	.	A	G	4	1	5	0	1	6	0	0
17	8286879	.	C	A	4	1	5	0	1	6	0	0
17	8287050	.	T	C	2	2	4	0	0	4	0	0
17	8287082	.	A	C	3	4	7	0	0	7	0	0
17	8421172	.	G	A	1	3	4	0	0	4	0	0
17	8442775	.	G	A	1	4	5	0	0	5	0	0
17	8498844	.	A	T	4	4	8	1	0	9	0	0
17	8498845	.	A	T	4	4	8	1	0	9	0	0
17	8502883	.	G	A	15	8	23	0	2	25	0	0
17	8502934	.	A	G	10	8	18	0	2	20	0	0
17	8514511	.	G	A	6	5	11	0	0	11	0	0
17	8514634	.	G	A	2	6	8	0	0	8	0	0
17	8514648	.	A	G	1	6	7	0	1	8	0	0
17	8515117	.	G	T	3	4	7	0	1	8	0	0
17	8515222	.	C	A	7	6	13	0	1	14	0	0
17	8515462	.	A	G	9	5	14	0	0	14	0	0
17	8518938	.	T	C	6	0	6	0	6	12	0	0
17	8562462	.	G	A	5	3	8	0	0	8	0	0
17	8562551	.	G	C	4	0	4	0	5	9	0	0
17	8562560	.	T	A	4	6	10	0	0	10	0	0
17	8562749	.	T	C	3	0	3	0	4	7	0	0
17	8570141	.	T	C	3	4	7	0	0	7	0	0
17	8597174	.	T	A	10	10	20	0	2	22	0	0
17	8597702	.	A	T	19	13	32	0	2	34	0	0
17	8597871	.	T	C	22	7	29	0	1	30	0	0
17	8597965	.	T	A	28	13	41	0	0	41	0	0
17	8611580	.	G	A	28	12	40	0	1	41	0	0
17	8623396	.	G	A	16	20	36	0	2	38	0	0
17	8623456	.	T	C	25	20	45	0	0	45	0	0
17	8692684	.	A	G	3	2	5	0	0	5	0	0
17	8727630	.	C	A	3	3	6	0	0	6	0	0
17	8754388	.	C	T	3	3	6	1	0	7	0	0
17	8760808	.	C	A	4	2	6	0	0	6	0	0
17	8762239	.	A	G	3	4	7	0	0	7	0	0
17	8772413	.	C	A	3	2	5	0	0	5	0	0
17	8772416	.	T	C	0	4	4	0	0	4	0	0
17	8772665	.	C	T	1	2	3	0	0	3	0	0
17	8772776	.	C	T	3	4	7	0	0	7	0	0
17	8772800	.	G	A	3	4	7	0	0	7	0	0
17	8782396	.	C	T	1	4	5	0	0	5	0	0
17	8784682	.	T	C	4	4	8	0	0	8	0	0
17	8784742	.	G	A	0	9	9	0	4	13	0	0
17	8785801	.	T	C	2	4	6	0	0	6	0	0
17	8785804	.	T	C	2	4	6	0	0	6	0	0
17	8791468	.	A	G	5	3	8	0	0	8	0	0
17	8791573	.	A	T	6	4	10	0	0	10	0	0
17	8791841	.	T	G	2	2	4	0	1	5	0	0
17	8791863	.	C	T	3	2	5	0	0	5	0	0
17	8927638	.	A	G	12	14	26	0	3	29	0	0
17	8927641	.	A	G	13	13	26	0	1	27	0	0
17	8934223	.	G	A	23	7	30	0	0	30	0	0
17	8934307	.	C	T	15	13	28	0	0	28	0	0
17	8937918	.	G	A	14	8	22	0	1	23	0	0
17	8937954	.	G	A	15	9	24	0	2	26	0	0
17	8938023	.	C	T	19	10	29	0	2	31	0	0
17	8938249	.	T	C	11	18	29	0	0	29	0	0
17	8938269	.	G	A	22	10	32	0	1	33	0	0
17	8938305	.	T	A	11	19	30	0	1	31	0	0
17	8941309	.	T	C	12	10	22	1	1	24	0	0
17	8941320	.	C	T	11	10	21	1	0	22	0	0
17	8951606	.	C	G	1	9	10	0	17	28	1	0
17	8951644	.	C	T	1	17	18	0	8	26	0	0
17	8951655	.	T	C	9	16	25	0	1	26	0	0
17	8951867	.	C	T	2	17	19	0	13	32	0	0
17	8964520	.	G	A	13	14	27	0	2	29	0	0
17	8969278	.	A	G	12	15	27	0	1	28	0	0
17	8969296	.	G	A	13	15	28	0	1	29	0	0
17	9018124	.	C	T	3	5	8	0	0	8	0	0
17	9018199	.	G	C	5	2	7	0	0	7	0	0
17	9040167	.	C	T	6	3	9	0	0	9	0	0
17	9041364	.	C	T	3	13	16	0	1	17	0	0
17	9041409	.	A	T	3	9	12	0	0	12	0	0
17	9041419	.	C	T	4	8	12	0	0	12	0	0
17	9041460	.	A	G	6	9	15	0	0	15	0	0
17	9041916	.	C	G	5	0	5	0	6	11	0	0
17	9042223	.	A	G	3	6	9	0	0	9	0	0
17	9042447	.	C	T	11	7	18	0	0	18	0	0
17	9042608	.	G	C	12	10	22	0	0	22	0	0
17	9042652	.	T	C	3	10	13	0	0	13	0	0
17	9143323	.	G	A	12	8	20	0	0	20	0	0
17	9157385	.	A	G	10	4	14	1	1	16	0	0
17	9225184	.	G	A	1	17	18	0	15	33	0	0
17	9225223	.	A	G	9	14	23	0	4	27	0	0
17	9248656	.	A	G	6	0	6	1	11	18	0	0
17	9253504	.	A	T	9	14	23	0	0	23	0	0
17	9253705	.	T	C	8	9	17	0	3	20	0	0
17	9254269	.	T	A	10	8	18	0	0	18	0	0
17	9255196	.	G	A	0	11	11	0	9	20	0	0
17	9255547	.	G	C	17	15	32	0	1	33	0	0
17	9255703	.	C	T	11	11	22	0	0	22	0	0
17	9266298	.	C	T	11	18	29	0	0	29	0	0
17	9266501	.	G	T	2	16	18	0	8	26	0	0
17	9501615	.	G	A	0	4	4	0	9	13	0	0
17	9601121	.	G	C	8	8	16	1	0	17	0	0
17	9601133	.	C	T	9	6	15	1	0	16	0	0
17	9847212	.	C	T	10	11	21	0	0	21	0	0
17	9847215	.	C	T	8	10	18	0	3	21	0	0
17	9884342	.	A	G	4	8	12	0	1	13	0	0
17	9888958	.	C	G	15	11	26	0	0	26	0	0
17	9889127	.	T	A	13	5	18	0	10	28	0	0
17	9889223	.	C	T	12	12	24	0	3	27	0	0
17	9889313	.	T	A	11	14	25	0	1	26	0	0
17	9889427	.	G	A	9	12	21	0	1	22	0	0
17	9889728	.	A	T	8	6	14	0	1	15	0	0
17	9889745	.	A	G	12	0	12	0	7	19	0	0
17	9916134	.	G	A	1	3	4	0	0	4	0	0
17	9944725	.	A	G	3	3	6	0	0	6	0	0
17	9944848	.	T	A	9	3	12	0	0	12	0	0
17	9944996	.	G	T	1	3	4	0	0	4	0	0
17	9944999	.	G	A	2	3	5	0	0	5	0	0
17	9945176	.	T	A	6	5	11	0	1	12	0	0
17	9945178	.	T	G	7	5	12	0	0	12	0	0
17	9951885	.	G	A	1	4	5	0	0	5	0	0
17	9952033	.	C	T	1	4	5	0	9	14	0	0
17	9955952	.	C	T	5	3	8	0	0	8	0	0
17	9957913	.	T	A	10	7	17	0	1	18	0	0
17	9962399	.	C	A	10	9	19	0	0	19	0	0
17	9963519	.	G	A	4	3	7	0	0	7	0	0
17	9964437	.	A	T	4	4	8	0	0	8	0	0
17	9964912	.	G	A	2	5	7	0	0	7	0	0
17	9964944	.	C	A	4	3	7	0	0	7	0	0
17	9965344	.	T	A	3	3	6	0	0	6	0	0
17	9967566	.	G	A	4	2	6	0	0	6	0	0
17	9975334	.	C	G	1	2	3	0	0	3	0	0
17	10143808	.	A	G	3	6	9	0	0	9	0	0
17	10765766	.	A	G	2	1	3	0	0	3	0	0
17	10765773	.	A	G	3	3	6	0	0	6	0	0
17	11378906	.	T	A	3	2	5	0	0	5	0	0
17	11716754	.	A	G	2	3	5	0	0	5	0	0
17	12021802	.	C	T	2	2	4	1	0	5	0	0
17	12021813	.	C	T	0	3	3	0	2	5	0	0
17	12058522	.	G	T	0	8	8	0	8	16	0	0
17	12060478	.	G	A	0	5	5	0	5	10	0	0
17	12060545	.	C	T	4	5	9	0	2	11	0	0
17	12060587	.	A	G	7	5	12	0	1	13	0	0
17	12060627	.	C	T	10	3	13	0	0	13	0	0
17	12060631	.	G	A	2	10	12	0	2	14	0	0
17	12060799	.	A	G	3	9	12	0	0	12	0	0
17	12068675	.	G	C	9	11	20	0	0	20	0	0
17	12072890	.	C	T	7	6	13	0	0	13	0	0
17	12072977	.	T	C	5	10	15	0	1	16	0	0
17	12088799	.	G	A	0	6	6	0	5	11	0	0
17	12089069	.	G	C	3	6	9	0	0	9	0	0
17	12134673	.	T	G	4	5	9	0	0	9	0	0
17	12134693	.	C	A	6	3	9	0	1	10	0	0
17	12134709	.	C	T	6	6	12	0	1	13	0	0
17	12135206	.	G	A	4	5	9	0	0	9	0	0
17	12135322	.	A	T	3	3	6	0	0	6	0	0
17	12221788	.	C	A	1	2	3	0	2	5	0	0
17	12222226	.	A	G	10	7	17	0	0	17	0	0
17	12222235	.	G	T	8	7	15	0	0	15	0	0
17	12223514	.	G	A	12	11	23	0	0	23	0	0
17	12223743	.	G	A	15	10	25	0	0	25	0	0
17	12223883	.	C	G	7	6	13	0	0	13	0	0
17	12223884	.	T	A	6	6	12	0	1	13	0	0
17	12223971	.	G	A	7	7	14	0	0	14	0	0
17	12223989	.	C	A	0	5	5	0	7	12	0	0
17	12224976	.	G	A	11	8	19	0	1	20	0	0
17	12225070	.	G	A	10	10	20	0	0	20	0	0
17	12225271	.	G	A	6	9	15	0	0	15	0	0
17	12225292	.	C	T	1	12	13	0	6	19	0	0
17	12225418	.	T	G	6	5	11	0	0	11	0	0
17	12225756	.	C	A	3	3	6	0	1	7	0	0
17	12225843	.	T	G	6	5	11	0	0	11	0	0
17	12225867	.	C	T	0	5	5	0	9	14	0	0
17	12226404	.	C	T	8	6	14	0	0	14	0	0
17	12226594	.	G	A	5	7	12	0	0	12	0	0
17	12227034	.	C	T	0	2	2	0	3	5	0	0
17	12227778	.	T	A	6	3	9	0	0	9	0	0
17	12227780	.	C	G	0	2	2	0	7	9	0	0
17	12227909	.	G	A	4	3	7	0	0	7	0	0
17	12228177	.	G	A	4	2	6	0	0	6	0	0
17	12228304	.	C	T	5	4	9	0	0	9	0	0
17	12229800	.	G	T	3	3	6	1	0	7	0	0
17	12235791	.	A	G	7	4	11	0	0	11	0	0
17	12236457	.	G	T	7	3	10	0	0	10	0	0
17	12236460	.	G	A	3	7	10	0	0	10	0	0
17	12236571	.	G	A	3	4	7	0	0	7	0	0
17	12237333	.	G	A	2	3	5	0	2	7	0	0
17	12249880	.	C	T	3	6	9	0	0	9	0	0
17	12249882	.	A	T	2	6	8	0	0	8	0	0
17	12298106	.	G	T	31	20	51	0	4	55	0	0
17	12302409	.	G	A	40	34	74	0	0	74	0	0
17	12302496	.	C	T	47	38	85	4	1	90	0	0
17	12408447	.	C	T	9	9	18	0	0	18	0	0
17	12408454	.	G	C	9	8	17	0	1	18	0	0
17	12418130	.	C	A	5	9	14	0	0	14	0	0
17	12422810	.	A	G	4	0	4	0	7	11	0	0
17	12422850	.	T	A	5	3	8	0	0	8	0	0
17	12658472	.	G	A	3	3	6	0	0	6	0	0
17	12700653	.	A	G	30	30	60	0	1	61	0	0
17	12702780	.	C	T	19	12	31	0	1	32	0	0
17	12702801	.	A	G	20	0	20	0	13	33	0	0
17	12702831	.	C	A	16	18	34	0	1	35	0	0
17	12708404	.	C	A	1	5	6	0	0	6	0	0
17	12709244	.	T	G	5	9	14	0	0	14	0	0
17	12737483	.	G	A	0	3	3	0	7	10	0	0
17	12737580	.	A	G	2	2	4	0	0	4	0	0
17	12737586	.	T	G	2	0	2	0	2	4	0	0
17	12737629	.	A	T	4	8	12	0	0	12	0	0
17	12742971	.	A	G	7	6	13	0	0	13	0	0
17	12742974	.	C	T	7	5	12	0	0	12	0	0
17	12747827	.	C	T	4	4	8	0	0	8	0	0
17	12753717	.	A	C	0	3	3	0	0	3	0	0
17	12753792	.	G	A	8	7	15	0	4	19	0	0
17	12753823	.	A	G	13	3	16	0	1	17	0	0
17	12753916	.	T	A	9	6	15	0	1	16	0	0
17	12753940	.	A	T	9	6	15	0	1	16	0	0
17	12754071	.	A	G	11	8	19	0	2	21	0	0
17	12754158	.	A	T	5	8	13	0	0	14	1	0
17	12754198	.	A	T	6	6	12	0	0	12	0	0
17	12758823	.	T	C	10	7	17	0	0	17	0	0
17	12759072	.	G	A	12	11	23	0	0	23	0	0
17	12759135	.	C	T	16	5	21	0	0	21	0	0
17	12761221	.	G	C	12	5	17	0	0	17	0	0
17	12764004	.	C	T	1	10	11	0	16	27	0	0
17	12764090	.	G	T	20	6	26	0	0	26	0	0
17	12764244	.	A	T	7	5	12	0	2	14	0	0
17	12764247	.	G	T	7	5	12	0	1	13	0	0
17	12767696	.	A	T	8	5	13	0	0	13	0	0
17	12785737	.	T	C	5	3	8	0	0	8	0	0
17	12797241	.	C	G	2	8	10	0	1	11	0	0
17	12797280	.	C	T	1	7	8	0	1	9	0	0
17	12799132	.	C	T	9	10	19	0	0	19	0	0
17	12806340	.	C	G	8	8	16	0	0	16	0	0
17	12806360	.	C	T	9	10	19	0	0	19	0	0
17	12806381	.	T	C	7	7	14	0	0	14	0	0
17	12809332	.	T	C	5	5	10	0	0	10	0	0
17	12811215	.	C	T	2	6	8	0	0	8	0	0
17	12812661	.	C	T	4	6	10	0	0	10	0	0
17	12818580	.	T	C	6	6	12	0	1	13	0	0
17	12818664	.	A	G	8	8	16	0	0	16	0	0
17	12818718	.	C	A	7	9	16	0	1	17	0	0
17	12825732	.	C	T	7	10	17	0	0	17	0	0
17	12825741	.	G	A	1	10	11	0	8	19	0	0
17	12851473	.	T	G	14	6	20	0	0	20	0	0
17	12851518	.	G	A	1	5	6	0	12	18	0	0
17	12851831	.	T	G	9	8	17	0	2	19	0	0
17	12858173	.	C	T	12	7	19	0	1	20	0	0
17	12858658	.	G	C	14	12	26	0	3	29	0	0
17	12858765	.	A	G	17	11	28	0	1	29	0	0
17	12865807	.	C	T	11	18	29	0	0	29	0	0
17	12867975	.	G	A	12	15	27	0	1	28	0	0
17	12881532	.	G	A	11	15	26	0	0	26	0	0
17	12881590	.	G	A	2	12	14	0	11	25	0	0
17	12922410	.	A	T	15	10	25	0	0	25	0	0
17	12922678	.	A	G	5	7	12	0	2	14	0	0
17	12923028	.	A	G	16	13	29	0	0	29	0	0
17	12923303	.	A	G	12	0	12	0	9	21	0	0
17	12958744	.	G	A	12	6	18	0	1	19	0	0
17	12963487	.	A	C	12	0	12	0	21	33	0	0
17	12963571	.	G	A	20	16	36	0	0	36	0	0
17	12965499	.	A	G	12	12	24	0	3	27	0	0
17	12971471	.	G	A	1	3	4	0	0	4	0	0
17	12972906	.	T	G	1	3	4	0	0	4	0	0
17	12977682	.	T	C	3	0	3	0	5	8	0	0
17	13005936	.	T	C	2	4	6	0	0	6	0	0
17	13006784	.	G	A	1	2	3	0	0	3	0	0
17	13007209	.	G	T	2	2	4	0	0	4	0	0
17	13007214	.	T	C	2	2	4	0	0	4	0	0
17	13013109	.	T	C	6	5	11	0	0	11	0	0
17	13019988	.	T	A	16	16	32	0	1	33	0	0
17	13020090	.	G	A	14	13	27	0	2	29	0	0
17	13020187	.	A	C	14	9	23	0	0	23	0	0
17	13020472	.	T	C	4	14	18	0	1	19	0	0
17	13020476	.	T	A	5	13	18	0	2	20	0	0
17	13020601	.	C	T	0	13	13	0	6	19	0	0
17	13020733	.	C	G	8	11	19	1	1	21	0	0
17	13023022	.	G	A	11	18	29	0	0	29	0	0
17	13023289	.	T	C	20	6	26	0	0	26	0	0
17	13023407	.	A	C	10	18	28	0	1	29	0	0
17	13026599	.	A	T	5	5	10	0	0	10	0	0
17	13032557	.	A	G	8	1	9	0	11	21	1	0
17	13032558	.	A	G	7	12	19	0	1	20	0	0
17	13045540	.	G	T	5	7	12	0	0	12	0	0
17	13045559	.	A	C	6	6	12	0	0	13	1	0
17	13045794	.	T	A	8	3	11	0	2	13	0	0
17	13045882	.	A	T	9	5	14	0	0	14	0	0
17	13045980	.	T	C	3	6	9	0	0	9	0	0
17	13046058	.	T	G	10	6	16	0	1	17	0	0
17	13046099	.	G	A	10	7	17	0	0	17	0	0
17	13052081	.	C	T	1	10	11	0	13	24	0	0
17	13057986	.	T	A	13	6	19	0	1	20	0	0
17	13058349	.	T	A	11	8	19	0	1	20	0	0
17	13058354	.	G	A	10	10	20	0	0	20	0	0
17	13061715	.	G	A	9	10	19	0	0	19	0	0
17	13061726	.	G	T	9	12	21	0	0	21	0	0
17	13061839	.	T	C	14	0	14	0	8	22	0	0
17	13061849	.	C	G	12	9	21	0	0	21	0	0
17	13064531	.	C	T	11	13	24	0	0	24	0	0
17	13066963	.	T	A	11	9	20	0	2	22	0	0
17	13067015	.	G	C	10	9	19	0	2	21	0	0
17	13067018	.	C	T	1	11	12	0	11	23	0	0
17	13068561	.	G	A	9	9	18	0	0	18	0	0
17	13070504	.	T	C	9	10	19	0	0	19	0	0
17	13071678	.	T	A	6	7	13	0	0	13	0	0
17	13091660	.	T	G	4	3	7	0	0	7	0	0
17	13094135	.	G	A	7	8	15	0	0	15	0	0
17	13097239	.	C	T	1	5	6	0	0	6	0	0
17	13102057	.	A	G	20	17	37	0	0	37	0	0
17	13107061	.	A	G	13	1	14	0	15	29	0	0
17	13108626	.	G	T	12	25	37	0	3	40	0	0
17	13109010	.	A	G	20	19	39	0	4	43	0	0
17	13109042	.	T	C	25	12	37	4	0	41	0	0
17	13109097	.	A	T	11	14	25	1	2	28	0	0
17	13109409	.	C	T	22	18	40	0	1	41	0	0
17	13109793	.	A	C	5	13	18	0	0	18	0	0
17	13109818	.	T	C	11	12	23	0	0	23	0	0
17	13109910	.	A	G	12	0	12	1	13	26	0	0
17	13109928	.	G	T	1	16	17	1	15	33	0	0
17	13109990	.	T	A	14	10	24	0	4	28	0	0
17	13110003	.	C	G	13	13	26	0	0	26	0	0
17	13110043	.	C	T	5	8	13	0	2	15	0	0
17	15633379	.	T	C	6	16	22	0	1	23	0	0
17	15633530	.	C	T	4	2	6	0	0	6	0	0
17	15633721	.	T	C	10	5	15	0	0	15	0	0
17	15965667	.	G	A	0	2	2	0	0	2	0	0
17	15965675	.	C	T	1	1	2	0	0	2	0	0
17	16193128	.	T	C	4	2	6	0	0	6	0	0
17	16230106	.	C	T	1	7	8	0	0	8	0	0
17	16280297	.	G	A	0	2	2	0	8	10	0	0
17	16280299	.	G	A	8	2	10	0	0	10	0	0
17	17811653	.	T	C	7	2	9	0	0	9	0	0
17	18179927	.	T	C	11	5	16	1	4	21	0	0
17	19420197	.	C	T	10	10	20	0	0	20	0	0
17	19420434	.	C	T	2	4	6	0	3	9	0	0
17	19420563	.	T	G	9	12	21	0	0	21	0	0
17	19421109	.	C	G	11	7	18	0	1	19	0	0
17	19421248	.	T	G	7	7	14	0	1	15	0	0
17	19421636	.	T	C	9	0	9	0	13	22	0	0
17	19421667	.	A	G	4	11	15	0	0	15	0	0
17	19421948	.	C	T	5	8	13	0	0	13	0	0
17	19421955	.	A	T	6	10	16	0	0	16	0	0
17	19422452	.	C	T	1	4	5	0	5	10	0	0
17	19423145	.	C	T	8	2	10	0	0	10	0	0
17	19423334	.	C	T	5	6	11	0	0	11	0	0
17	19423375	.	A	T	5	4	9	0	0	9	0	0
17	19423713	.	G	A	7	6	13	0	1	14	0	0
17	19429290	.	T	C	3	2	5	0	7	12	0	0
17	19431175	.	C	A	1	10	11	0	10	21	0	0
17	19431439	.	C	T	2	6	8	0	4	12	0	0
17	19431481	.	G	A	8	7	15	0	1	16	0	0
17	19431718	.	G	A	10	9	19	0	1	20	0	0
17	19440149	.	T	G	5	6	11	0	0	11	0	0
17	19440233	.	C	T	1	7	8	0	7	15	0	0
17	19440460	.	T	C	4	0	4	0	7	11	0	0
17	19440492	.	G	A	9	6	15	0	0	15	0	0
17	19440500	.	T	G	7	7	14	0	2	16	0	0
17	19443394	.	A	G	7	4	11	0	0	11	0	0
17	19446034	.	C	G	1	2	3	0	0	3	0	0
17	19446105	.	A	G	5	5	10	0	0	10	0	0
17	19448648	.	G	A	3	4	7	0	0	7	0	0
17	19448684	.	G	T	4	4	8	0	0	8	0	0
17	19451644	.	G	A	4	2	6	0	0	6	0	0
17	19451650	.	A	G	4	4	8	0	0	8	0	0
17	19451892	.	C	A	1	7	8	0	6	14	0	0
17	19452120	.	G	T	1	4	5	0	0	5	0	0
17	19452235	.	C	T	7	3	10	0	0	10	0	0
17	19454422	.	C	G	1	6	7	0	8	15	0	0
17	19454434	.	T	A	8	6	14	0	0	14	0	0
17	19454467	.	G	A	7	6	13	0	0	13	0	0
17	19454491	.	A	G	8	4	12	0	0	12	0	0
17	19454791	.	C	T	2	7	9	0	0	9	0	0
17	19454806	.	A	G	1	7	8	0	1	9	0	0
17	19455080	.	C	T	0	4	4	0	4	8	0	0
17	19455358	.	G	C	2	3	5	0	0	5	0	0
17	19455386	.	C	G	1	3	4	0	0	4	0	0
17	19459837	.	T	A	6	4	10	0	0	10	0	0
17	19460026	.	T	C	5	3	8	0	0	8	0	0
17	19460095	.	G	A	3	3	6	0	0	6	0	0
17	19460274	.	T	G	3	3	6	0	0	6	0	0
17	19460278	.	C	G	3	3	6	0	0	6	0	0
17	19499276	.	A	T	5	3	8	0	0	8	0	0
17	19499281	.	G	C	3	3	6	0	0	6	0	0
17	19502407	.	T	C	4	5	9	0	0	9	0	0
17	19506474	.	C	T	5	4	9	0	0	9	0	0
17	19506934	.	G	A	0	4	4	0	2	6	0	0
17	19506943	.	A	C	2	5	7	0	0	7	0	0
17	19510714	.	G	A	3	3	6	0	0	6	0	0
17	19607610	.	C	A	4	13	17	0	0	17	0	0
17	19607654	.	A	T	5	10	15	0	3	18	0	0
17	19607835	.	T	A	9	4	13	0	1	14	0	0
17	19608363	.	A	G	2	2	4	0	0	4	0	0
17	19608365	.	G	T	2	2	4	0	0	4	0	0
17	19608741	.	A	G	4	2	6	0	0	6	0	0
17	19609013	.	C	T	1	4	5	1	7	13	0	0
17	19609276	.	C	T	4	2	6	0	1	7	0	0
17	19609286	.	T	A	3	3	6	0	0	6	0	0
17	19609705	.	T	C	4	4	8	0	0	8	0	0
17	19692573	.	A	C	15	15	30	0	0	30	0	0
17	19715899	.	T	C	22	21	43	0	2	45	0	0
17	19755102	.	C	T	5	2	7	0	0	7	0	0
17	19755158	.	C	G	0	5	5	0	1	6	0	0
17	19756186	.	C	A	1	2	3	0	2	5	0	0
17	19756277	.	A	G	1	3	4	0	0	4	0	0
17	19756282	.	G	T	0	3	3	0	0	4	1	0
17	19756332	.	C	G	2	2	4	0	0	4	0	0
17	19757276	.	G	T	1	2	3	0	0	3	0	0
17	19757284	.	T	C	0	1	1	0	1	2	0	0
17	19757408	.	G	A	3	3	6	0	0	6	0	0
17	19757450	.	G	T	1	3	4	0	0	4	0	0
17	19757456	.	C	T	1	3	4	0	0	4	0	0
17	19813514	.	A	T	1	1	2	0	4	6	0	0
17	19826797	.	C	T	0	3	3	0	4	7	0	0
17	19826800	.	T	G	2	3	5	0	2	7	0	0
17	19831910	.	G	C	3	2	5	0	0	5	0	0
17	19831968	.	T	C	4	5	9	0	0	9	0	0
17	19831980	.	A	T	3	5	8	0	0	8	0	0
17	19832895	.	T	C	2	2	4	0	0	4	0	0
17	19833222	.	A	G	3	3	6	0	0	6	0	0
17	19833918	.	G	A	3	2	5	0	0	5	0	0
17	19834134	.	G	A	3	5	8	0	0	8	0	0
17	20147693	.	A	G	2	3	5	0	0	5	0	0
17	20147756	.	A	C	2	2	4	0	0	4	0	0
17	20147804	.	C	A	2	2	4	0	0	4	0	0
17	20148867	.	G	A	3	2	5	0	1	6	0	0
17	20149668	.	G	A	1	2	3	0	0	3	0	0
17	20161885	.	A	G	2	3	5	0	0	5	0	0
17	20184820	.	G	T	2	2	4	0	0	4	0	0
17	20188929	.	C	T	0	9	9	0	6	15	0	0
17	20189047	.	A	T	3	13	16	0	1	17	0	0
17	20191569	.	T	C	5	0	5	0	7	12	0	0
17	20191941	.	A	G	9	5	14	0	1	15	0	0
17	20191956	.	A	G	4	8	12	0	2	14	0	0
17	20196770	.	G	A	7	2	9	0	0	9	0	0
17	20196784	.	C	T	6	2	8	0	0	8	0	0
17	20198764	.	G	T	5	2	7	0	1	8	0	0
17	20202365	.	C	G	0	5	5	0	6	11	0	0
17	20202391	.	G	A	9	5	14	0	0	14	0	0
17	20206941	.	T	A	4	2	6	0	0	6	0	0
17	20215498	.	G	A	3	6	9	0	0	9	0	0
17	20215570	.	A	C	5	0	5	0	5	10	0	0
17	20215739	.	T	C	5	6	11	0	1	12	0	0
17	20218318	.	T	C	2	0	2	0	4	6	0	0
17	20235494	.	G	A	3	6	9	0	0	9	0	0
17	20243035	.	A	G	19	3	22	0	26	48	0	0
17	20243375	.	C	A	25	24	49	0	3	52	0	0
17	20243564	.	G	A	16	8	24	0	0	24	0	0
17	20243611	.	G	A	13	13	26	0	1	27	0	0
17	20248398	.	A	G	25	19	44	0	1	45	0	0
17	20248455	.	A	T	23	20	43	0	0	43	0	0
17	20248479	.	T	C	27	19	46	0	2	48	0	0
17	20248500	.	C	G	2	18	20	0	23	44	1	0
17	20248705	.	T	C	24	0	24	0	15	39	0	0
17	20251987	.	T	C	11	16	27	0	2	29	0	0
17	20256603	.	A	C	19	11	30	0	2	32	0	0
17	20256669	.	A	G	14	19	33	0	0	33	0	0
17	20256894	.	T	C	17	15	32	0	0	32	0	0
17	20256921	.	A	G	16	12	28	0	0	28	0	0
17	20256948	.	G	C	17	0	17	0	9	26	0	0
17	20259679	.	A	C	6	9	15	0	2	17	0	0
17	20264097	.	C	T	14	17	31	0	1	32	0	0
17	20268379	.	G	A	13	14	27	0	1	28	0	0
17	20268442	.	C	T	14	15	29	0	2	31	0	0
17	20287338	.	C	T	9	15	24	0	0	24	0	0
17	20321569	.	G	A	2	8	10	0	1	11	0	0
17	20321730	.	C	T	7	5	12	1	0	14	1	0
17	20324012	.	T	C	7	7	14	0	0	14	0	0
17	20324036	.	C	T	2	8	10	0	8	18	0	0
17	20324051	.	A	G	10	9	19	0	0	19	0	0
17	20324084	.	T	C	14	1	15	0	8	23	0	0
17	20324114	.	C	T	1	12	13	0	13	26	0	0
17	20324144	.	G	A	15	9	24	0	0	24	0	0
17	20326784	.	C	T	0	7	7	0	3	10	0	0
17	20330433	.	T	G	4	6	10	0	0	10	0	0
17	20336983	.	G	A	5	5	10	0	1	11	0	0
17	20354894	.	G	T	2	3	5	0	0	5	0	0
17	20372205	.	C	A	1	6	7	0	0	7	0	0
17	20380992	.	G	A	2	5	7	0	0	7	0	0
17	20429758	.	G	A	3	5	8	0	1	9	0	0
17	20429980	.	A	G	5	5	10	0	1	11	0	0
17	20429983	.	C	T	0	6	6	0	5	11	0	0
17	20515281	.	G	A	0	2	2	0	2	4	0	0
17	20515348	.	A	G	4	2	6	0	0	6	0	0
17	20518101	.	T	G	2	2	4	0	0	4	0	0
17	20518389	.	A	G	2	0	2	0	2	4	0	0
17	20577585	.	C	A	7	4	11	0	0	11	0	0
17	20577656	.	A	G	4	2	6	0	0	6	0	0
17	20585362	.	T	C	5	19	24	0	0	24	0	0
17	20587321	.	A	C	7	4	11	0	0	11	0	0
17	20587947	.	T	A	2	2	4	0	0	4	0	0
17	20605277	.	C	T	4	3	7	0	0	7	0	0
17	20639824	.	C	T	1	2	3	0	0	3	0	0
17	20654140	.	G	A	3	5	8	0	1	9	0	0
17	20655086	.	T	A	2	5	7	0	0	7	0	0
17	20674063	.	C	T	3	2	5	0	1	6	0	0
17	20674755	.	A	T	3	3	6	0	0	6	0	0
17	20674794	.	C	T	5	11	16	0	3	19	0	0
17	20674889	.	T	A	9	19	28	0	1	29	0	0
17	20684685	.	A	T	24	14	38	0	3	41	0	0
17	20695604	.	G	A	11	12	23	0	1	24	0	0
17	20695941	.	C	A	2	10	12	0	10	23	1	0
17	20701602	.	A	G	19	30	49	0	3	52	0	0
17	20701999	.	G	A	20	20	40	0	1	41	0	0
17	20702030	.	C	T	2	15	17	0	21	38	0	0
17	20702056	.	G	A	17	18	35	0	1	36	0	0
17	20719067	.	G	C	13	24	37	0	0	37	0	0
17	20719232	.	A	G	9	11	20	0	0	20	0	0
17	20719248	.	C	T	7	8	15	0	0	15	0	0
17	20719746	.	G	T	15	7	22	0	0	23	1	0
17	20720046	.	C	T	3	12	15	0	15	30	0	0
17	20720121	.	G	T	23	11	34	0	0	34	0	0
17	20720334	.	C	T	17	14	31	0	1	32	0	0
17	20720581	.	G	A	18	18	36	0	2	38	0	0
17	20720739	.	G	T	16	13	29	0	3	32	0	0
17	20721597	.	A	G	9	9	18	0	0	18	0	0
17	20722113	.	C	A	14	9	23	0	0	23	0	0
17	20722389	.	A	G	11	10	21	0	1	22	0	0
17	20722955	.	A	G	14	10	24	0	1	25	0	0
17	20723081	.	A	T	12	8	20	0	0	20	0	0
17	20723407	.	A	G	12	10	22	0	1	23	0	0
17	20724187	.	A	T	11	5	16	0	1	17	0	0
17	20724318	.	C	T	16	6	22	0	1	23	0	0
17	20724675	.	A	G	17	20	37	0	1	38	0	0
17	20725107	.	G	A	13	10	23	0	1	24	0	0
17	20725296	.	T	C	14	18	32	0	1	33	0	0
17	20725474	.	A	C	10	9	19	0	2	21	0	0
17	20725554	.	G	A	12	10	22	0	0	22	0	0
17	20729433	.	C	T	10	9	19	0	0	19	0	0
17	20731031	.	G	A	5	9	14	0	0	14	0	0
17	20734207	.	G	A	10	4	14	0	0	14	0	0
17	20763022	.	C	T	0	14	14	0	10	24	0	0
17	20770456	.	G	A	9	5	14	0	0	14	0	0
17	20772115	.	C	T	10	8	18	0	0	18	0	0
17	20772383	.	A	G	4	11	15	0	0	15	0	0
17	20782062	.	G	A	12	3	15	0	0	15	0	0
17	20784676	.	G	A	8	8	16	0	1	17	0	0
17	20784718	.	G	A	12	8	20	2	1	23	0	0
17	20795953	.	G	A	16	5	21	0	1	22	0	0
17	20795992	.	G	A	9	12	21	0	0	21	0	0
17	20796115	.	C	T	1	5	6	0	7	13	0	0
17	20806988	.	C	T	10	11	21	0	0	21	0	0
17	20849868	.	C	T	1	2	3	0	6	9	0	0
17	20897389	.	G	A	1	4	5	1	0	6	0	0
17	20924745	.	C	T	3	4	7	0	0	7	0	0
17	20926037	.	A	C	1	2	3	0	0	3	0	0
17	20926046	.	T	C	1	2	3	0	0	3	0	0
17	20928860	.	G	A	2	2	4	0	0	4	0	0
17	20963653	.	T	C	17	17	34	0	3	37	0	0
17	20963664	.	T	C	19	15	34	0	0	34	0	0
17	20964611	.	G	A	11	9	20	0	2	22	0	0
17	20964669	.	A	G	13	11	24	0	0	24	0	0
17	20964978	.	A	G	12	18	30	0	0	30	0	0
17	20965143	.	G	A	18	17	35	0	3	38	0	0
17	20965182	.	C	T	2	14	16	0	23	39	0	0
17	20965194	.	G	T	20	19	39	0	0	39	0	0
17	20965295	.	T	G	27	20	47	1	4	52	0	0
17	20978673	.	A	G	24	19	43	0	0	43	0	0
17	20978822	.	A	G	8	9	17	4	0	21	0	0
17	20978823	.	G	A	8	8	16	4	2	22	0	0
17	20978972	.	G	A	15	16	31	0	1	32	0	0
17	20979056	.	A	T	10	12	22	0	1	23	0	0
17	21102352	.	T	A	10	5	15	0	1	16	0	0
17	21102367	.	G	A	7	13	20	0	0	20	0	0
17	21104883	.	A	G	4	5	9	0	1	10	0	0
17	21120781	.	G	A	8	10	18	0	2	20	0	0
17	21123435	.	G	A	4	4	8	0	2	10	0	0
17	21123537	.	T	C	1	5	6	0	0	6	0	0
17	21126551	.	A	G	1	3	4	0	3	7	0	0
17	21139672	.	C	G	3	4	7	0	0	7	0	0
17	21141630	.	G	A	5	4	9	0	0	9	0	0
17	21147021	.	C	T	5	7	12	0	0	12	0	0
17	21151945	.	C	A	8	3	11	0	0	11	0	0
17	21151996	.	C	T	3	4	7	0	1	8	0	0
17	21152038	.	T	C	2	5	7	0	0	7	0	0
17	21152059	.	T	A	4	3	7	0	0	7	0	0
17	21152094	.	A	G	5	6	11	0	0	11	0	0
17	21152106	.	G	A	7	5	12	0	0	12	0	0
17	21152145	.	A	C	2	5	7	1	1	9	0	0
17	21154957	.	C	A	8	5	13	0	0	13	0	0
17	21155425	.	C	A	8	5	13	0	0	13	0	0
17	21155817	.	T	C	13	7	20	0	0	20	0	0
17	21156140	.	G	T	10	4	14	0	4	18	0	0
17	21156162	.	A	G	20	5	25	0	0	25	0	0
17	21156207	.	A	C	23	6	29	0	0	29	0	0
17	21156220	.	C	T	22	6	28	0	1	29	0	0
17	21156265	.	T	A	13	5	18	0	0	18	0	0
17	21156342	.	C	T	6	2	8	0	0	8	0	0
17	21156352	.	C	T	4	2	6	0	0	6	0	0
17	21156720	.	A	C	12	4	16	0	1	17	0	0
17	21156808	.	A	T	8	7	15	0	0	15	0	0
17	21156922	.	G	A	1	2	3	0	0	3	0	0
17	21158098	.	C	T	1	2	3	0	0	3	0	0
17	21158231	.	T	A	4	2	6	0	0	6	0	0
17	21158291	.	A	T	6	9	15	0	0	15	0	0
17	21158549	.	T	G	4	2	6	0	0	6	0	0
17	21158629	.	C	G	6	6	12	0	0	12	0	0
17	21160083	.	G	A	7	8	15	0	1	16	0	0
17	21160107	.	G	A	10	7	17	0	0	17	0	0
17	21162573	.	T	C	4	7	11	0	1	12	0	0
17	21198633	.	C	T	5	8	13	0	1	14	0	0
17	21245326	.	A	G	10	12	22	0	0	22	0	0
17	21245410	.	T	C	13	0	13	0	9	22	0	0
17	21251211	.	G	A	11	4	15	0	1	16	0	0
17	21372616	.	C	T	0	12	12	0	20	32	0	0
17	21372810	.	G	T	26	21	47	0	1	48	0	0
17	21373062	.	G	A	22	24	46	0	2	48	0	0
17	21373105	.	C	G	2	24	26	0	21	47	0	0
17	21377133	.	G	A	19	17	36	0	0	36	0	0
17	21396399	.	A	G	16	18	34	0	1	36	1	0
17	21396444	.	A	G	18	17	35	0	1	36	0	0
17	21396462	.	A	G	16	21	37	0	2	39	0	0
17	21433074	.	G	A	6	3	9	0	0	9	0	0
17	21433396	.	C	T	1	4	5	0	1	6	0	0
17	21433425	.	A	G	1	2	3	0	0	3	0	0
17	21433680	.	C	A	5	3	8	0	1	9	0	0
17	21441404	.	A	G	1	3	4	0	0	4	0	0
17	21547643	.	A	G	5	2	7	0	1	8	0	0
17	21547779	.	A	G	5	5	10	0	0	10	0	0
17	21550216	.	T	C	5	4	9	0	1	10	0	0
17	21560738	.	A	G	1	4	5	0	0	5	0	0
17	21560763	.	T	C	1	3	4	0	0	4	0	0
17	21562276	.	G	A	1	2	3	0	0	3	0	0
17	21562932	.	A	G	1	2	3	0	0	3	0	0
17	21563193	.	G	A	4	2	6	0	0	6	0	0
17	21607781	.	C	T	3	4	7	0	1	8	0	0
17	21617536	.	T	C	5	14	19	0	0	19	0	0
17	21617586	.	C	T	7	4	11	0	1	12	0	0
17	21617588	.	A	T	5	7	12	0	0	12	0	0
17	21791668	.	T	C	7	0	7	0	7	14	0	0
17	21817431	.	C	T	3	2	5	0	0	5	0	0
17	21817552	.	G	C	4	7	11	0	1	12	0	0
17	21818245	.	C	T	8	8	16	0	1	17	0	0
17	21818266	.	T	C	10	8	18	0	0	18	0	0
17	21820366	.	C	T	10	7	17	0	1	18	0	0
17	21820378	.	C	T	12	4	16	0	1	17	0	0
17	21820583	.	G	A	7	9	16	0	1	17	0	0
17	21820657	.	C	A	9	9	18	0	2	20	0	0
17	21820744	.	A	T	8	9	17	0	0	17	0	0
17	21820772	.	A	G	8	11	19	0	0	19	0	0
17	21820879	.	C	T	18	10	28	0	0	28	0	0
17	21821381	.	A	G	6	6	12	0	1	13	0	0
17	21821405	.	T	C	7	5	12	0	1	13	0	0
17	21821627	.	C	T	5	5	10	0	0	10	0	0
17	21821653	.	T	C	5	4	9	0	0	10	1	0
17	21821856	.	C	T	7	6	13	0	0	13	0	0
17	21821958	.	C	T	5	8	13	0	0	13	0	0
17	21904009	.	G	A	3	16	19	0	14	33	0	0
17	21905752	.	A	C	10	12	22	7	2	31	0	0
17	21911999	.	T	C	30	18	48	0	0	48	0	0
17	21912381	.	T	C	20	7	27	0	0	27	0	0
17	21912489	.	T	C	13	15	28	0	0	28	0	0
17	21912517	.	T	C	18	10	28	0	2	30	0	0
17	21912554	.	G	T	15	9	24	0	0	24	0	0
17	21912597	.	C	A	9	5	14	0	4	18	0	0
17	21912622	.	C	A	12	4	16	0	1	17	0	0
17	21912676	.	A	T	9	13	22	0	0	22	0	0
17	21912708	.	T	A	11	16	27	0	0	27	0	0
17	21912797	.	T	C	9	5	14	0	0	14	0	0
17	21912874	.	A	G	15	12	27	0	0	28	1	0
17	21912890	.	G	T	18	10	28	0	0	28	0	0
17	21919346	.	T	C	3	2	5	0	0	5	0	0
17	21919541	.	C	G	2	2	4	0	0	4	0	0
17	21919655	.	G	A	5	3	8	0	0	8	0	0
17	21919706	.	G	C	3	2	5	0	0	5	0	0
17	21935871	.	T	C	4	6	10	0	1	11	0	0
17	21954957	.	C	T	6	6	12	0	0	12	0	0
17	21955115	.	T	C	9	9	18	0	0	18	0	0
17	21958945	.	A	G	4	0	4	0	7	11	0	0
17	21959338	.	C	T	1	2	3	0	1	4	0	0
17	21959342	.	A	T	2	2	4	0	0	4	0	0
17	21975525	.	G	A	0	8	8	0	14	22	0	0
17	21975528	.	C	G	14	7	21	0	1	22	0	0
17	22003274	.	A	G	2	2	4	0	0	4	0	0
17	22003417	.	C	T	0	3	3	0	1	4	0	0
17	22006612	.	C	T	0	2	2	0	2	4	0	0
17	22032345	.	T	A	8	6	14	0	0	14	0	0
17	22032679	.	A	C	3	7	10	0	0	10	0	0
17	22033020	.	G	A	12	5	17	0	0	17	0	0
17	22035770	.	T	C	13	0	13	0	10	24	1	0
17	22035945	.	C	T	0	11	11	0	8	19	0	0
17	22036427	.	C	T	6	10	16	0	1	17	0	0
17	22036460	.	C	A	8	8	16	0	1	17	0	0
17	22036602	.	A	C	13	0	13	0	7	20	0	0
17	22036659	.	G	T	8	5	13	0	0	13	0	0
17	22036686	.	A	G	11	6	17	0	0	17	0	0
17	22036896	.	G	A	8	6	14	0	0	14	0	0
17	22037014	.	G	A	8	7	15	0	0	15	0	0
17	22044272	.	T	C	7	2	9	0	7	16	0	0
17	22047883	.	C	T	0	12	12	0	14	26	0	0
17	22051176	.	A	G	7	7	14	0	2	16	0	0
17	22052074	.	G	A	15	9	24	0	0	24	0	0
17	22058188	.	C	T	12	9	21	0	1	22	0	0
17	22062275	.	C	T	16	15	31	0	1	32	0	0
17	22063318	.	T	C	8	5	13	0	1	14	0	0
17	22072375	.	G	A	7	3	10	0	0	10	0	0
17	22072485	.	C	G	4	2	6	0	0	6	0	0
17	22072673	.	A	C	5	4	9	0	0	9	0	0
17	22074703	.	C	T	3	3	6	0	0	6	0	0
17	22074970	.	A	G	3	4	7	0	0	7	0	0
17	22090897	.	T	G	9	0	9	0	5	14	0	0
17	22091044	.	T	G	5	3	8	0	0	8	0	0
17	22091067	.	G	A	5	4	9	0	0	9	0	0
17	22091118	.	T	A	6	3	9	0	0	9	0	0
17	22091120	.	A	T	4	5	9	0	0	9	0	0
17	22108065	.	G	A	10	8	18	0	1	19	0	0
17	22108207	.	A	T	7	7	14	0	0	14	0	0
17	22111379	.	T	G	7	9	16	0	0	16	0	0
17	22111386	.	T	C	7	0	7	0	7	14	0	0
17	22111610	.	G	A	6	6	12	0	0	12	0	0
17	22113050	.	T	C	4	10	14	0	1	15	0	0
17	22381310	.	T	G	2	10	12	0	2	14	0	0
17	22381658	.	C	G	4	0	4	0	4	8	0	0
17	22382652	.	G	A	0	7	7	0	5	12	0	0
17	22382726	.	C	T	10	5	15	0	0	15	0	0
17	22382885	.	A	G	16	1	17	0	12	29	0	0
17	22471649	.	G	A	1	15	16	0	11	27	0	0
17	22489033	.	A	C	12	9	21	0	1	22	0	0
17	22489072	.	G	C	1	8	9	0	9	18	0	0
17	22500507	.	C	A	10	13	23	0	1	24	0	0
17	22500600	.	G	A	8	16	24	0	1	25	0	0
17	22500627	.	C	T	10	18	28	0	0	28	0	0
17	22500898	.	T	G	15	0	15	0	13	28	0	0
17	22500937	.	G	A	1	10	11	0	15	26	0	0
17	22500972	.	A	C	10	12	22	0	2	24	0	0
17	22501063	.	G	A	2	12	14	0	10	24	0	0
17	22501193	.	C	T	2	3	5	1	2	8	0	0
17	22501309	.	G	A	15	7	22	0	1	23	0	0
17	22501353	.	G	A	9	15	24	0	1	25	0	0
17	22501447	.	T	A	11	12	23	0	1	24	0	0
17	22501490	.	T	C	11	17	28	0	0	28	0	0
17	22501493	.	C	A	10	14	24	0	2	26	0	0
17	22501547	.	C	A	8	19	27	0	2	29	0	0
17	22501645	.	G	T	8	10	18	0	2	20	0	0
17	22501858	.	C	T	8	7	15	0	1	16	0	0
17	22582313	.	C	T	13	19	32	0	2	34	0	0
17	22584847	.	G	A	16	22	38	0	1	39	0	0
17	22585264	.	T	A	27	15	42	0	2	44	0	0
17	22585273	.	C	T	17	24	41	0	1	42	0	0
17	22585337	.	T	A	25	10	35	0	1	36	0	0
17	22587561	.	G	A	1	2	3	0	0	3	0	0
17	22618097	.	G	A	1	4	5	0	2	7	0	0
17	22618542	.	G	C	3	2	5	0	0	5	0	0
17	22618815	.	C	T	2	2	4	0	0	4	0	0
17	22618833	.	C	T	2	2	4	0	0	4	0	0
17	22619244	.	T	G	4	0	4	0	8	12	0	0
17	22619289	.	C	T	7	4	11	0	0	11	0	0
17	22621032	.	C	T	4	2	6	0	1	7	0	0
17	22621065	.	C	T	4	3	7	0	1	8	0	0
17	22623030	.	T	A	3	4	7	0	0	7	0	0
17	22624418	.	G	A	1	3	4	0	0	4	0	0
17	22626857	.	G	A	4	2	6	0	0	6	0	0
17	22627169	.	G	A	0	3	3	0	9	12	0	0
17	22630058	.	A	G	3	2	5	0	0	5	0	0
17	22630437	.	G	A	5	2	7	0	0	7	0	0
17	22632033	.	T	C	8	7	15	0	1	16	0	0
17	22632128	.	C	T	8	8	16	0	0	16	0	0
17	22633908	.	A	G	4	2	6	0	0	6	0	0
17	22635334	.	G	A	6	3	9	0	0	9	0	0
17	22635346	.	C	T	4	5	9	0	0	9	0	0
17	22637335	.	C	A	4	5	9	0	0	9	0	0
17	22646828	.	A	T	12	5	17	0	0	17	0	0
17	22646861	.	T	C	3	11	14	0	0	14	0	0
17	22647001	.	C	T	10	10	20	0	0	20	0	0
17	22648087	.	T	C	4	3	7	0	0	7	0	0
17	22649721	.	G	A	1	10	11	0	9	20	0	0
17	22649838	.	C	T	5	10	15	1	1	17	0	0
17	22650505	.	G	T	0	6	6	0	8	14	0	0
17	22650586	.	C	T	8	9	17	0	0	17	0	0
17	22650641	.	C	A	12	8	20	0	0	20	0	0
17	22650760	.	C	T	4	10	14	0	0	14	0	0
17	22650979	.	C	T	4	5	9	0	1	10	0	0
17	22651351	.	C	T	7	12	19	0	1	20	0	0
17	22651375	.	T	C	10	12	22	0	0	22	0	0
17	22652799	.	T	A	12	14	26	0	0	26	0	0
17	22652825	.	G	T	13	13	26	0	0	26	0	0
17	22653491	.	C	T	10	10	20	0	2	22	0	0
17	22653710	.	C	T	9	10	19	0	0	19	0	0
17	22654096	.	C	T	13	11	24	1	0	25	0	0
17	22658245	.	A	G	13	6	19	0	2	21	0	0
17	22659176	.	G	T	1	5	6	0	7	13	0	0
17	22659206	.	G	A	4	5	9	0	0	9	0	0
17	22659957	.	A	G	11	0	11	0	9	20	0	0
17	22662759	.	T	C	9	11	20	0	0	20	0	0
17	22669012	.	G	A	3	8	11	0	17	28	0	0
17	22669060	.	C	T	15	21	36	0	0	36	0	0
17	22669511	.	A	C	10	10	20	0	1	21	0	0
17	22687408	.	C	A	5	10	15	0	1	16	0	0
17	22687409	.	C	G	6	10	16	0	0	16	0	0
17	22687451	.	T	C	12	7	19	0	3	22	0	0
17	22687500	.	T	G	12	5	17	0	1	18	0	0
17	22687558	.	T	A	16	12	28	0	0	28	0	0
17	22687561	.	G	A	16	14	30	0	0	30	0	0
17	22687729	.	T	C	20	18	38	0	3	41	0	0
17	22687842	.	T	A	17	17	34	0	1	35	0	0
17	22713696	.	C	T	16	12	28	0	4	32	0	0
17	22723479	.	T	C	17	12	29	0	0	29	0	0
17	22723515	.	C	T	15	15	30	0	3	33	0	0
17	22729079	.	T	C	14	12	26	0	0	26	0	0
17	22729772	.	T	A	10	18	28	0	3	31	0	0
17	22729796	.	G	A	3	20	23	0	10	33	0	0
17	22729886	.	C	T	10	10	20	0	0	20	0	0
17	22738350	.	G	A	9	11	20	0	1	21	0	0
17	22741044	.	C	T	11	8	19	0	1	20	0	0
17	22741070	.	G	A	2	7	9	0	7	16	0	0
17	22741096	.	A	T	4	6	10	0	0	10	0	0
17	22741437	.	A	T	12	9	21	0	0	21	0	0
17	22782653	.	G	A	0	10	10	0	3	13	0	0
17	22918230	.	G	A	4	2	6	1	0	7	0	0
17	22918258	.	A	G	4	3	7	0	0	7	0	0
17	22937684	.	A	T	4	5	9	0	1	10	0	0
17	22944875	.	A	G	5	4	9	0	2	11	0	0
17	22944887	.	A	G	9	4	13	0	0	13	0	0
17	23103224	.	T	A	4	2	6	0	0	6	0	0
17	23114422	.	C	T	1	3	4	0	0	4	0	0
17	23185251	.	G	A	0	5	5	0	1	6	0	0
17	23185253	.	G	A	0	5	5	0	1	6	0	0
17	23193047	.	G	A	2	5	7	0	0	7	0	0
17	23194040	.	T	C	5	4	9	0	1	10	0	0
17	23200509	.	G	A	4	2	6	0	0	6	0	0
17	23200630	.	G	T	1	3	4	0	1	5	0	0
17	23200637	.	T	A	1	3	4	0	0	4	0	0
17	23200949	.	A	C	5	4	9	0	0	9	0	0
17	23201147	.	A	G	1	6	7	1	0	8	0	0
17	23215411	.	T	C	6	9	15	0	0	15	0	0
17	23215612	.	G	A	3	3	6	0	0	6	0	0
17	23215678	.	A	T	6	5	11	0	0	11	0	0
17	23216461	.	C	T	7	5	12	0	0	12	0	0
17	23220627	.	A	G	11	5	16	0	1	17	0	0
17	23220698	.	T	A	10	11	21	0	2	23	0	0
17	23222460	.	C	G	9	10	19	0	0	19	0	0
17	23223166	.	C	G	11	18	29	0	0	29	0	0
17	23224626	.	C	T	6	19	25	0	1	26	0	0
17	23224680	.	G	A	12	14	26	0	1	27	0	0
17	23224743	.	A	G	19	0	19	0	14	33	0	0
17	23224800	.	G	A	16	10	26	0	0	26	0	0
17	23226667	.	C	T	11	15	26	0	1	27	0	0
17	23231130	.	C	T	17	13	30	0	1	31	0	0
17	23258050	.	C	T	2	3	5	0	0	5	0	0
17	23300837	.	C	G	11	4	15	0	0	15	0	0
17	23300879	.	G	A	15	7	22	0	0	22	0	0
17	23300888	.	T	C	16	7	23	0	0	23	0	0
17	23301102	.	C	T	10	6	16	0	2	18	0	0
17	23301303	.	G	A	18	21	39	0	3	42	0	0
17	23301372	.	C	T	23	13	36	0	2	38	0	0
17	23301390	.	G	A	0	19	19	0	19	38	0	0
17	23301433	.	G	T	15	22	37	0	0	37	0	0
17	23301484	.	G	A	19	18	37	0	2	39	0	0
17	23301799	.	A	G	5	8	13	0	0	13	0	0
17	23434216	.	G	A	8	15	23	0	1	24	0	0
17	23434264	.	A	G	9	9	18	0	1	19	0	0
17	23434389	.	T	C	13	0	13	0	8	21	0	0
17	23437102	.	A	G	7	5	12	0	0	12	0	0
17	23437629	.	C	A	6	3	9	1	0	10	0	0
17	23437641	.	A	G	5	4	9	0	1	10	0	0
17	23437677	.	C	G	5	8	13	0	0	13	0	0
17	23441680	.	C	T	5	10	15	0	0	15	0	0
17	23441698	.	A	G	8	6	14	0	1	15	0	0
17	23444362	.	G	C	2	9	11	0	0	11	0	0
17	23444415	.	A	G	12	4	16	0	0	16	0	0
17	23446653	.	T	G	4	2	6	0	6	12	0	0
17	23446668	.	C	T	0	2	2	0	9	11	0	0
17	23542264	.	T	A	2	2	4	0	0	4	0	0
17	23542322	.	C	A	5	3	8	0	0	8	0	0
17	23542616	.	A	G	4	8	12	0	0	12	0	0
17	23542662	.	C	T	4	4	8	0	0	8	0	0
17	23542677	.	G	A	4	4	8	0	0	8	0	0
17	23542752	.	A	G	5	3	8	0	0	8	0	0
17	23542770	.	A	G	5	5	10	0	0	10	0	0
17	23542890	.	C	G	7	5	12	0	0	12	0	0
17	23543088	.	C	T	3	4	7	0	0	7	0	0
17	23549293	.	A	G	4	0	4	0	3	7	0	0
17	23549710	.	G	T	4	5	9	0	0	9	0	0
17	23551512	.	T	C	3	4	7	0	1	8	0	0
17	23551536	.	C	T	5	3	8	0	0	8	0	0
17	23554980	.	T	C	10	7	17	0	0	17	0	0
17	23555032	.	T	C	6	9	15	0	0	15	0	0
17	23555150	.	C	T	7	8	15	0	0	15	0	0
17	23555278	.	A	T	5	7	12	0	0	12	0	0
17	23555403	.	A	T	6	13	19	0	1	20	0	0
17	23574682	.	G	A	5	6	11	0	0	11	0	0
17	23575413	.	A	G	10	4	14	0	0	14	0	0
17	23656034	.	A	C	20	2	22	0	31	53	0	0
17	23656112	.	C	T	3	27	30	0	19	49	0	0
17	23659853	.	C	T	27	22	49	0	1	50	0	0
17	23711065	.	A	T	2	4	6	0	0	6	0	0
17	23711184	.	A	T	10	3	13	0	1	14	0	0
17	23711421	.	A	C	9	10	19	0	1	20	0	0
17	23711775	.	C	T	1	12	13	0	11	24	0	0
17	23722882	.	A	T	6	10	16	0	0	16	0	0
17	23727637	.	G	T	10	8	18	0	0	18	0	0
17	23757541	.	G	A	0	4	4	0	7	11	0	0
17	23762847	.	G	A	0	8	8	0	2	10	0	0
17	23763176	.	T	C	4	3	7	0	0	7	0	0
17	23811260	.	G	C	0	3	3	0	4	7	0	0
17	23820614	.	A	G	6	4	10	0	0	10	0	0
17	23821410	.	C	T	6	5	11	0	0	11	0	0
17	23822235	.	G	T	2	6	8	0	1	10	1	0
17	23822323	.	G	A	2	6	8	0	1	9	0	0
17	23822438	.	T	A	1	2	3	0	0	3	0	0
17	23822749	.	C	T	6	4	10	0	0	10	0	0
17	23822856	.	G	A	2	11	13	0	0	13	0	0
17	23823650	.	G	A	6	4	10	0	1	11	0	0
17	23824244	.	C	T	11	3	14	0	2	16	0	0
17	23824504	.	A	G	2	10	12	0	0	12	0	0
17	23824794	.	A	G	3	4	7	0	1	8	0	0
17	23894359	.	G	A	8	5	13	0	0	13	0	0
17	23894378	.	C	T	6	3	9	0	1	10	0	0
17	23929692	.	A	G	9	0	9	0	9	18	0	0
17	23937626	.	T	G	8	17	25	1	0	26	0	0
17	23940102	.	C	A	15	18	33	0	3	36	0	0
17	23948365	.	A	G	23	13	36	0	1	37	0	0
17	23948396	.	C	T	26	9	35	0	1	36	0	0
17	23952672	.	G	C	16	28	44	0	0	44	0	0
17	23954987	.	C	G	2	2	4	0	0	4	0	0
17	23956882	.	G	A	4	9	13	0	1	14	0	0
17	23956925	.	G	A	0	9	9	0	5	14	0	0
17	23964637	.	T	C	2	2	4	0	0	4	0	0
17	23964690	.	T	A	6	5	11	0	0	11	0	0
17	23964719	.	A	G	5	2	7	0	0	7	0	0
17	23964732	.	T	C	2	2	4	0	1	5	0	0
17	23965241	.	G	T	7	8	15	0	0	15	0	0
17	23965283	.	T	A	10	6	16	0	0	16	0	0
17	23965475	.	G	C	3	8	11	0	0	11	0	0
17	23965983	.	C	A	2	4	6	0	0	6	0	0
17	23986153	.	A	G	13	0	13	0	10	23	0	0
17	23986585	.	T	C	13	13	26	0	1	27	0	0
17	24080609	.	T	A	1	2	3	0	0	3	0	0
17	24080615	.	T	G	1	0	1	0	2	3	0	0
17	24111050	.	G	T	2	3	5	0	0	5	0	0
17	24111400	.	G	A	0	4	4	0	9	13	0	0
17	24177150	.	T	C	10	8	18	0	0	18	0	0
17	24178449	.	G	C	8	7	15	0	0	15	0	0
17	24182184	.	T	A	6	11	17	0	2	19	0	0
17	24186029	.	C	T	10	6	16	0	0	16	0	0
17	24186042	.	T	C	8	5	13	0	1	14	0	0
17	24222649	.	G	A	15	9	24	0	0	24	0	0
17	24222730	.	T	A	12	11	23	0	2	25	0	0
17	24222752	.	A	T	11	9	20	0	2	22	0	0
17	24222771	.	G	T	13	13	26	0	0	26	0	0
17	24247670	.	G	T	5	10	15	0	0	15	0	0
17	24254467	.	G	A	0	7	7	0	6	13	0	0
17	24268278	.	G	A	13	12	25	0	0	25	0	0
17	24313974	.	T	A	6	2	8	0	0	8	0	0
17	24314068	.	G	A	3	8	11	0	0	11	0	0
17	24314331	.	A	G	16	7	23	0	2	25	0	0
17	24314468	.	A	T	5	4	9	0	1	10	0	0
17	24314986	.	G	A	1	9	10	0	7	17	0	0
17	24319071	.	A	C	7	6	13	0	0	13	0	0
17	24339217	.	G	T	2	2	4	0	0	4	0	0
17	24395936	.	C	T	3	2	5	0	0	5	0	0
17	24439623	.	T	A	1	3	4	0	1	5	0	0
17	24440579	.	G	A	5	4	9	0	2	11	0	0
17	24442526	.	G	A	2	15	17	0	9	26	0	0
17	24442888	.	C	T	8	11	19	0	0	19	0	0
17	24443182	.	G	C	5	5	10	0	0	10	0	0
17	24444239	.	T	G	4	8	12	0	0	12	0	0
17	24452168	.	A	G	13	10	23	0	2	25	0	0
17	24463526	.	G	A	9	10	19	1	1	21	0	0
17	24464939	.	A	C	10	19	29	0	1	30	0	0
17	24464987	.	A	T	14	9	23	0	1	24	0	0
17	24469255	.	G	A	9	8	17	0	0	17	0	0
17	24469752	.	A	C	15	19	34	0	0	34	0	0
17	24470146	.	C	A	12	15	27	0	1	28	0	0
17	24470875	.	G	T	0	2	2	0	2	4	0	0
17	24480111	.	T	C	6	6	12	0	0	12	0	0
17	24484184	.	T	A	5	4	9	0	1	10	0	0
17	24484202	.	G	T	7	3	10	0	1	11	0	0
17	24487410	.	A	T	5	7	12	0	1	13	0	0
17	24493076	.	G	A	5	6	11	0	0	11	0	0
17	24493276	.	G	T	6	6	12	0	0	12	0	0
17	24537442	.	G	T	5	3	8	0	0	8	0	0
17	24537450	.	T	A	6	3	9	0	0	9	0	0
17	24550311	.	G	A	4	2	6	0	0	6	0	0
17	24550541	.	G	A	5	7	12	0	0	12	0	0
17	24551263	.	C	T	7	10	17	0	0	17	0	0
17	24553786	.	G	A	6	5	11	0	0	11	0	0
17	24576885	.	G	A	3	9	12	0	1	13	0	0
17	24579134	.	A	C	2	0	2	0	5	7	0	0
17	24579158	.	T	C	2	4	6	0	0	6	0	0
17	24579251	.	G	A	8	3	11	0	0	11	0	0
17	24579293	.	T	C	6	8	14	0	0	14	0	0
17	24579422	.	G	A	6	9	15	0	1	16	0	0
17	24579518	.	T	C	2	4	6	0	0	6	0	0
17	24579519	.	A	C	2	4	6	0	0	6	0	0
17	24579587	.	A	G	4	5	9	0	0	9	0	0
17	24579687	.	G	A	1	4	5	0	0	5	0	0
17	24579696	.	A	G	1	5	6	0	0	6	0	0
17	24580083	.	A	C	6	5	11	0	0	11	0	0
17	24580112	.	C	T	5	3	8	0	0	8	0	0
17	24597770	.	C	T	5	2	7	0	0	7	0	0
17	24597853	.	T	C	4	3	7	0	0	7	0	0
17	24598741	.	A	G	4	4	8	0	0	8	0	0
17	24599488	.	C	G	2	3	5	0	0	5	0	0
17	24599746	.	C	A	3	3	6	0	0	6	0	0
17	24600150	.	A	C	6	3	9	0	0	9	0	0
17	24600595	.	G	A	1	4	5	0	9	14	0	0
17	24600976	.	G	A	9	6	15	0	0	15	0	0
17	24601072	.	G	A	0	3	3	0	4	7	0	0
17	24601579	.	T	A	9	7	16	0	0	16	0	0
17	24601654	.	A	C	5	3	8	0	9	17	0	0
17	24601924	.	C	T	7	7	14	0	0	14	0	0
17	24604619	.	G	T	0	6	6	0	6	12	0	0
17	24612661	.	G	T	7	5	12	0	0	12	0	0
17	24612726	.	A	G	9	9	18	0	0	18	0	0
17	24614468	.	C	T	23	30	53	0	1	54	0	0
17	24615181	.	C	T	3	4	7	0	1	8	0	0
17	24615205	.	A	G	10	12	22	0	0	22	0	0
17	24617888	.	C	A	7	20	27	0	2	29	0	0
17	24618912	.	C	T	3	12	15	0	2	17	0	0
17	24618945	.	C	T	3	13	16	0	0	16	0	0
17	24619650	.	A	G	3	3	6	0	0	6	0	0
17	24619672	.	C	T	5	1	6	0	0	6	0	0
17	24619693	.	A	G	1	0	1	0	7	8	0	0
17	24622623	.	G	T	7	13	20	0	1	21	0	0
17	24622644	.	G	A	11	15	26	0	1	27	0	0
17	24623952	.	G	T	5	6	11	1	0	12	0	0
17	24624477	.	G	C	2	5	7	0	0	7	0	0
17	24624646	.	A	G	2	4	6	0	0	6	0	0
17	24626513	.	T	G	1	2	3	0	0	3	0	0
17	24631128	.	T	C	2	2	4	0	1	5	0	0
17	24631156	.	C	T	2	2	4	0	0	4	0	0
17	24640959	.	A	T	7	11	18	0	0	18	0	0
17	24641085	.	G	A	7	12	19	0	2	21	0	0
17	24643614	.	C	T	8	5	13	0	1	14	0	0
17	24643617	.	C	T	6	8	14	0	0	14	0	0
17	24644783	.	G	A	6	4	10	0	0	10	0	0
17	24652987	.	C	T	9	9	18	0	1	19	0	0
17	24653089	.	C	T	4	7	11	2	1	14	0	0
17	24684811	.	T	G	3	1	4	0	0	4	0	0
17	24684844	.	T	G	10	10	20	0	0	20	0	0
17	24685850	.	C	T	18	8	26	0	2	28	0	0
17	24686352	.	C	T	4	8	12	0	1	13	0	0
17	24686443	.	A	T	3	5	8	0	0	8	0	0
17	24686511	.	G	A	2	4	6	0	0	6	0	0
17	24687392	.	C	A	4	5	9	0	0	9	0	0
17	24687602	.	G	C	3	4	7	0	0	7	0	0
17	24690050	.	G	A	0	6	6	0	6	12	0	0
17	24690119	.	C	T	7	9	16	0	0	16	0	0
17	24690615	.	G	A	8	4	12	0	1	13	0	0
17	24691987	.	C	T	8	5	13	0	1	14	0	0
17	24692030	.	A	C	5	5	10	0	0	10	0	0
17	24693207	.	T	C	11	5	16	0	0	16	0	0
17	24694145	.	A	G	5	11	16	0	0	16	0	0
17	24694877	.	C	G	2	2	4	0	0	4	0	0
17	24695683	.	T	A	3	5	8	0	0	8	0	0
17	24695743	.	G	A	6	6	12	0	0	12	0	0
17	24695815	.	G	C	9	0	9	0	9	18	0	0
17	24695968	.	G	C	5	10	15	0	0	15	0	0
17	24696047	.	G	T	13	13	26	0	1	27	0	0
17	24696142	.	A	C	7	9	16	0	0	16	0	0
17	24696274	.	T	C	6	5	11	0	0	11	0	0
17	24696658	.	C	A	13	7	20	0	2	22	0	0
17	24696716	.	A	G	11	6	17	0	2	19	0	0
17	24699483	.	G	A	11	8	19	0	1	20	0	0
17	24701263	.	G	T	1	1	2	0	0	2	0	0
17	24701496	.	C	T	2	3	5	0	0	5	0	0
17	24701767	.	T	C	5	7	12	0	0	12	0	0
17	24701793	.	C	G	0	5	5	0	5	10	0	0
17	24702981	.	T	C	6	5	11	0	0	11	0	0
17	24709204	.	C	T	20	15	35	0	1	36	0	0
17	24709292	.	T	C	15	0	15	0	8	23	0	0
17	24709443	.	T	G	12	12	24	0	2	26	0	0
17	24712929	.	C	T	8	5	13	0	1	14	0	0
17	24712985	.	C	T	3	14	17	0	10	27	0	0
17	24715189	.	A	G	8	12	20	0	1	21	0	0
17	24720907	.	T	C	6	18	24	0	1	25	0	0
17	24720964	.	G	C	10	17	27	0	1	28	0	0
17	24721345	.	G	A	8	16	24	0	3	27	0	0
17	24721378	.	C	A	8	13	21	0	1	22	0	0
17	24721384	.	G	A	8	9	17	0	5	22	0	0
17	24721462	.	G	A	0	10	10	0	17	27	0	0
17	24722402	.	C	T	10	10	20	1	0	21	0	0
17	24722441	.	A	G	8	9	17	2	1	20	0	0
17	24725877	.	C	A	22	16	38	0	1	39	0	0
17	24726035	.	A	T	18	17	35	0	2	37	0	0
17	24726134	.	A	G	9	0	9	0	16	25	0	0
17	24726239	.	G	T	13	14	27	0	0	27	0	0
17	24726276	.	A	G	12	12	24	0	1	25	0	0
17	24726533	.	T	A	7	11	18	0	2	20	0	0
17	24726585	.	C	T	14	12	26	0	1	27	0	0
17	24726613	.	G	A	16	8	24	0	2	26	0	0
17	24726637	.	A	G	10	10	20	0	0	20	0	0
17	24726737	.	T	C	16	9	25	0	1	26	0	0
17	24726753	.	G	A	16	8	24	0	2	26	0	0
17	24726996	.	A	G	7	8	15	0	0	15	0	0
17	24727037	.	C	T	6	11	17	0	1	18	0	0
17	24727130	.	T	G	8	0	8	0	7	15	0	0
17	24727186	.	C	G	5	6	11	0	0	11	0	0
17	24747328	.	A	C	13	8	21	0	1	22	0	0
17	24747412	.	C	T	8	4	12	0	1	13	0	0
17	24747485	.	C	T	7	9	16	0	0	16	0	0
17	24757422	.	T	G	8	0	8	0	11	19	0	0
17	24757443	.	G	A	0	6	6	0	9	15	0	0
17	24757572	.	G	C	8	11	19	0	0	19	0	0
17	24757587	.	G	A	0	9	9	0	7	16	0	0
17	24775642	.	A	G	5	6	11	0	1	12	0	0
17	24787248	.	G	A	4	6	10	0	1	11	0	0
17	24787519	.	G	A	1	8	9	0	0	9	0	0
17	24787736	.	C	A	2	8	10	0	0	10	0	0
17	24787774	.	A	T	2	8	10	0	0	10	0	0
17	24820044	.	C	T	1	6	7	0	0	7	0	0
17	24820134	.	T	C	2	5	7	0	0	7	0	0
17	24820136	.	G	C	2	5	7	0	0	7	0	0
17	24820621	.	G	T	7	3	10	0	0	10	0	0
17	24820683	.	T	A	5	5	10	0	0	10	0	0
17	24821697	.	T	C	12	7	19	0	0	19	0	0
17	24821720	.	G	A	10	5	15	0	0	15	0	0
17	24834743	.	C	T	10	12	22	0	0	22	0	0
17	24835158	.	A	T	6	10	16	0	0	16	0	0
17	24835251	.	G	C	9	5	14	0	1	15	0	0
17	24835547	.	A	T	5	3	8	0	1	9	0	0
17	24855867	.	T	G	5	2	7	0	0	7	0	0
17	24856019	.	G	A	22	9	31	0	2	33	0	0
17	24856088	.	C	G	11	12	23	0	2	25	0	0
17	24856648	.	G	T	10	7	17	0	0	17	0	0
17	24858939	.	A	C	8	0	8	0	8	16	0	0
17	24861176	.	C	T	1	19	20	0	9	29	0	0
17	24861252	.	G	A	14	13	27	0	0	27	0	0
17	24863929	.	C	G	15	12	27	0	0	27	0	0
17	24866585	.	G	T	12	9	21	0	2	23	0	0
17	24869963	.	G	A	6	3	9	0	0	9	0	0
17	24869990	.	T	A	5	2	7	0	1	8	0	0
17	24872642	.	G	A	5	8	13	0	0	13	0	0
17	24872714	.	T	A	2	3	5	0	0	5	0	0
17	24874327	.	C	A	2	3	5	0	0	5	0	0
17	24874858	.	C	T	3	4	7	0	0	7	0	0
17	24880613	.	G	A	3	6	9	0	0	9	0	0
17	24884394	.	A	G	2	3	5	0	0	5	0	0
17	24887118	.	T	C	3	3	6	0	0	6	0	0
17	24889365	.	C	A	0	2	2	0	3	5	0	0
17	24926357	.	A	G	2	3	5	0	0	5	0	0
17	24932994	.	T	A	3	4	7	0	0	7	0	0
17	24936070	.	T	C	3	4	7	0	0	7	0	0
17	25104984	.	T	A	4	10	14	0	0	14	0	0
17	25105119	.	C	T	3	7	10	0	0	10	0	0
17	25125612	.	T	C	7	10	17	0	0	17	0	0
17	25140974	.	C	T	7	8	15	0	0	15	0	0
17	25155779	.	C	T	4	6	10	0	0	10	0	0
17	25155836	.	G	A	5	5	10	0	0	10	0	0
17	25167454	.	C	A	6	5	11	0	0	11	0	0
17	25167709	.	G	A	7	4	11	0	0	11	0	0
17	25173643	.	A	G	7	0	7	0	5	12	0	0
17	25173803	.	T	C	7	5	12	0	1	13	0	0
17	25173899	.	A	T	6	7	13	0	1	14	0	0
17	25174031	.	C	A	2	2	4	0	0	4	0	0
17	25174152	.	C	A	4	3	7	0	0	7	0	0
17	25174222	.	C	A	5	2	7	0	0	7	0	0
17	25174324	.	C	G	3	4	7	0	0	7	0	0
17	25174425	.	G	T	0	5	5	0	5	10	0	0
17	25174557	.	A	G	2	1	3	0	0	3	0	0
17	25175072	.	C	T	1	6	7	0	1	8	0	0
17	25175100	.	T	A	3	6	9	0	0	9	0	0
17	25175134	.	T	C	3	4	7	0	0	7	0	0
17	25175326	.	A	C	2	2	4	0	0	4	0	0
17	25187798	.	C	T	2	3	5	0	0	5	0	0
17	25189002	.	T	G	2	2	4	0	0	4	0	0
17	25191343	.	C	T	4	3	7	0	1	8	0	0
17	25191422	.	C	A	4	2	6	0	0	6	0	0
17	25192133	.	C	T	2	4	6	0	0	6	0	0
17	25192139	.	T	C	0	6	6	0	0	6	0	0
17	25192169	.	A	G	1	0	1	0	3	4	0	0
17	25192202	.	A	T	2	4	6	0	0	6	0	0
17	25224548	.	C	A	1	4	5	0	0	5	0	0
17	25231848	.	C	G	1	0	1	0	3	4	0	0
17	25254376	.	A	G	2	0	2	0	3	5	0	0
17	25256567	.	A	G	5	3	8	0	0	8	0	0
17	25289571	.	C	A	16	18	34	0	0	34	0	0
17	25289889	.	C	T	9	9	18	0	1	19	0	0
17	25289905	.	A	G	9	11	20	1	0	21	0	0
17	25289930	.	A	T	12	11	23	0	1	24	0	0
17	25289955	.	C	T	11	12	23	0	1	24	0	0
17	25290396	.	C	T	16	12	28	0	0	28	0	0
17	25290481	.	G	A	1	19	20	0	10	30	0	0
17	25290657	.	C	T	16	13	29	0	0	29	0	0
17	25291068	.	A	G	13	0	13	0	15	28	0	0
17	25297908	.	C	T	3	3	6	0	0	6	0	0
17	25298003	.	T	G	3	3	6	0	0	6	0	0
17	25301622	.	C	T	2	5	7	0	0	7	0	0
17	25302715	.	C	T	7	2	9	0	0	9	0	0
17	25302891	.	G	A	4	3	7	0	1	8	0	0
17	25302909	.	G	A	5	6	11	0	2	13	0	0
17	25303189	.	C	T	0	4	4	0	2	6	0	0
17	25306107	.	G	A	5	5	10	0	0	10	0	0
17	25311113	.	A	T	2	2	4	0	3	7	0	0
17	25313198	.	A	G	3	2	5	0	0	5	0	0
17	25313378	.	A	G	3	2	5	0	0	5	0	0
17	25316214	.	A	G	3	2	5	0	0	5	0	0
17	25331176	.	G	A	1	2	3	0	1	4	0	0
17	25331217	.	G	C	3	2	5	0	0	5	0	0
17	25331219	.	A	C	3	2	5	0	0	5	0	0
17	25336507	.	T	C	1	3	4	0	1	5	0	0
17	25337466	.	C	T	3	2	5	0	0	5	0	0
17	25339779	.	G	A	3	2	5	0	0	5	0	0
17	25342003	.	T	A	0	3	3	0	1	4	0	0
17	25392813	.	C	A	4	4	8	1	1	10	0	0
17	25393034	.	A	C	10	9	19	0	0	19	0	0
17	25405006	.	C	T	1	10	11	0	1	12	0	0
17	25405015	.	G	C	1	10	11	0	0	11	0	0
17	25418707	.	T	G	7	1	8	0	2	10	0	0
17	25418727	.	C	A	2	6	8	0	0	8	0	0
17	25420042	.	A	C	1	2	3	0	0	3	0	0
17	25420065	.	T	C	3	2	5	0	0	5	0	0
17	25420151	.	A	G	5	7	12	0	1	13	0	0
17	25420937	.	C	T	7	7	14	0	0	14	0	0
17	25424205	.	C	A	6	7	13	0	0	13	0	0
17	25424239	.	C	T	5	3	8	1	0	9	0	0
17	25424330	.	T	A	8	12	20	0	0	20	0	0
17	25424331	.	C	A	8	12	20	0	0	20	0	0
17	25424568	.	A	G	10	6	16	0	2	18	0	0
17	25424597	.	C	T	12	6	18	0	0	18	0	0
17	25424664	.	G	A	9	6	15	0	3	18	0	0
17	25424770	.	G	A	1	4	5	0	3	8	0	0
17	25424771	.	A	G	4	4	8	0	0	8	0	0
17	25425081	.	G	T	3	6	9	0	0	9	0	0
17	25425094	.	A	G	2	7	9	0	0	9	0	0
17	25425146	.	T	A	5	5	10	0	1	11	0	0
17	25428842	.	A	C	1	6	7	0	0	7	0	0
17	25428936	.	A	T	3	2	5	0	0	5	0	0
17	25431447	.	C	T	4	5	9	0	1	10	0	0
17	25431492	.	G	A	4	4	8	0	0	8	0	0
17	25431493	.	A	T	4	4	8	0	0	8	0	0
17	25434250	.	G	T	16	20	36	0	0	36	0	0
17	25435992	.	A	G	34	17	51	0	3	54	0	0
17	25436073	.	T	C	20	32	52	1	1	55	1	0
17	25436591	.	A	T	19	24	43	1	1	45	0	0
17	25437384	.	A	G	23	0	23	0	20	43	0	0
17	25439909	.	G	A	21	25	46	0	0	46	0	0
17	25439949	.	C	T	16	18	34	2	3	39	0	0
17	25439950	.	C	A	20	17	37	2	1	40	0	0
17	25444580	.	T	A	8	5	13	0	1	14	0	0
17	25474195	.	A	G	7	3	10	0	0	10	0	0
17	25474261	.	C	T	8	5	13	0	1	14	0	0
17	25475601	.	C	T	8	6	14	0	0	14	0	0
17	25478710	.	A	G	4	5	9	0	0	9	0	0
17	25478896	.	C	T	8	3	11	0	0	11	0	0
17	25478897	.	T	G	8	3	11	0	0	11	0	0
17	25479147	.	T	A	9	4	13	0	0	13	0	0
17	25479151	.	A	C	6	3	9	0	1	10	0	0
17	25479200	.	T	C	6	3	9	0	0	9	0	0
17	25479240	.	C	T	4	3	7	0	0	7	0	0
17	25479594	.	T	A	6	8	14	0	0	14	0	0
17	25479640	.	A	G	8	12	20	0	0	20	0	0
17	25479792	.	G	A	17	7	24	1	0	26	1	0
17	25479874	.	T	A	13	10	23	0	0	23	0	0
17	25479920	.	A	G	8	7	15	0	1	16	0	0
17	25549056	.	T	C	1	4	5	0	0	5	0	0
17	25549372	.	G	T	0	6	6	0	3	9	0	0
17	25549497	.	T	A	1	2	3	0	0	3	0	0
17	25549833	.	A	G	1	4	5	0	0	5	0	0
17	25550271	.	G	A	2	6	8	0	0	8	0	0
17	25550449	.	G	A	3	6	9	0	2	11	0	0
17	25550450	.	G	A	4	6	10	0	1	11	0	0
17	25559162	.	A	T	6	6	12	0	0	12	0	0
17	25559491	.	A	G	9	5	14	0	0	14	0	0
17	25562160	.	A	G	5	7	12	0	0	12	0	0
17	25562198	.	G	T	5	9	14	0	1	15	0	0
17	25563524	.	T	A	6	9	15	0	2	17	0	0
17	25563542	.	G	A	8	6	14	0	1	15	0	0
17	25563667	.	C	T	0	3	3	0	7	10	0	0
17	25563738	.	G	A	5	2	7	0	1	8	0	0
17	25563843	.	A	T	6	5	11	0	0	11	0	0
17	25564794	.	C	G	3	2	5	0	0	5	0	0
17	25565040	.	C	T	2	6	8	0	0	8	0	0
17	25565058	.	G	A	2	6	8	0	1	9	0	0
17	25565267	.	A	G	1	2	3	0	0	3	0	0
17	25565938	.	G	T	1	3	4	0	0	4	0	0
17	25567927	.	G	C	4	1	5	0	2	7	0	0
17	25567936	.	G	T	0	2	2	0	4	7	1	0
17	25568222	.	C	T	1	2	3	0	0	3	0	0
17	25575804	.	A	T	1	2	3	0	0	3	0	0
17	25585596	.	C	T	1	3	4	0	0	4	0	0
17	25585750	.	G	T	6	7	13	0	0	13	0	0
17	25585755	.	A	C	7	7	14	0	0	14	0	0
17	25585926	.	G	A	4	6	10	0	0	10	0	0
17	25590202	.	T	A	4	7	11	0	0	11	0	0
17	25590388	.	A	G	5	0	5	0	6	11	0	0
17	25593557	.	G	A	10	3	13	0	1	14	0	0
17	25593566	.	A	G	9	5	14	0	0	14	0	0
17	25593705	.	G	A	0	8	8	0	4	12	0	0
17	25593909	.	A	G	6	5	11	0	0	11	0	0
17	25593945	.	G	A	1	7	8	0	5	13	0	0
17	25594390	.	C	A	4	7	11	0	0	11	0	0
17	25595611	.	A	G	6	0	6	0	9	15	0	0
17	25595618	.	G	A	7	9	16	0	0	16	0	0
17	25595653	.	G	A	0	5	5	0	6	11	0	0
17	25595674	.	G	A	6	5	11	0	0	11	0	0
17	25595697	.	G	A	4	6	10	0	1	11	0	0
17	25595731	.	T	C	5	6	11	0	0	11	0	0
17	25596801	.	C	T	6	6	12	0	1	13	0	0
17	25600129	.	A	C	7	8	15	0	0	15	0	0
17	25600571	.	G	A	5	7	12	0	1	13	0	0
17	25602744	.	C	T	9	3	12	0	0	12	0	0
17	25606154	.	G	A	3	11	14	0	15	29	0	0
17	25606161	.	C	T	15	13	28	0	0	28	0	0
17	25606421	.	T	A	8	10	18	0	1	19	0	0
17	25610895	.	G	T	8	6	14	0	1	15	0	0
17	25610975	.	C	T	0	4	4	0	9	13	0	0
17	25610989	.	C	T	7	4	11	0	0	11	0	0
17	25611067	.	A	C	12	11	23	0	0	23	0	0
17	25611091	.	C	A	1	10	11	0	10	21	0	0
17	25612941	.	G	C	12	7	19	0	1	20	0	0
17	25612978	.	G	A	9	8	17	0	2	19	0	0
17	25615493	.	A	G	6	7	13	0	0	13	0	0
17	25615609	.	T	A	9	5	14	0	0	14	0	0
17	25615894	.	A	G	5	7	12	0	0	12	0	0
17	25616374	.	C	T	4	7	11	0	0	11	0	0
17	25617760	.	G	T	4	5	9	0	0	9	0	0
17	25617950	.	G	T	6	10	16	0	0	16	0	0
17	25617967	.	T	A	8	9	17	0	2	19	0	0
17	25618850	.	G	T	8	8	16	0	3	19	0	0
17	25618961	.	C	A	5	6	11	0	1	12	0	0
17	25621178	.	C	T	4	4	8	0	1	9	0	0
17	25623841	.	A	T	2	5	7	0	0	7	0	0
17	25625764	.	A	G	6	5	11	0	0	11	0	0
17	25630550	.	C	T	3	6	9	0	0	9	0	0
17	25636167	.	G	A	20	20	40	0	1	41	0	0
17	25636381	.	C	T	2	28	30	0	33	63	0	0
17	25636412	.	A	G	29	26	55	0	7	62	0	0
17	25636539	.	T	C	29	6	35	0	33	68	0	0
17	25636594	.	C	T	8	41	49	0	31	80	0	0
17	25636679	.	C	T	2	31	33	0	33	66	0	0
17	25637106	.	A	C	37	29	66	0	3	70	1	0
17	25637676	.	T	C	31	4	35	0	32	67	0	0
17	25640476	.	G	A	34	25	59	0	2	61	0	0
17	25738385	.	C	A	2	4	6	0	0	6	0	0
17	25765026	.	G	A	2	5	7	0	0	7	0	0
17	25777365	.	A	G	1	2	3	0	1	4	0	0
17	25825708	.	C	T	0	2	2	0	2	4	0	0
17	25825718	.	T	C	2	2	4	0	0	4	0	0
17	25844203	.	A	C	2	4	6	0	0	6	0	0
17	25858362	.	A	G	5	4	9	0	0	9	0	0
17	25861552	.	G	T	0	6	6	0	2	8	0	0
17	25861682	.	T	G	2	6	8	0	0	8	0	0
17	25861766	.	A	C	1	2	3	0	1	4	0	0
17	25871375	.	G	A	0	6	6	0	4	10	0	0
17	25873224	.	G	A	3	4	7	0	1	8	0	0
17	25877526	.	A	G	5	6	11	0	0	11	0	0
17	25877694	.	G	A	0	4	4	0	2	6	0	0
17	25878173	.	A	G	5	3	8	0	0	8	0	0
17	25884610	.	T	C	1	2	3	0	0	3	0	0
17	25884620	.	G	T	2	2	4	0	0	4	0	0
17	25884851	.	T	C	2	2	4	0	1	5	0	0
17	25885012	.	T	G	3	3	6	0	1	7	0	0
17	25885103	.	A	G	4	0	4	0	4	8	0	0
17	25885155	.	T	G	4	5	9	0	2	11	0	0
17	25885163	.	G	A	4	6	10	0	0	10	0	0
17	25885415	.	T	A	8	6	14	0	2	16	0	0
17	25885418	.	C	G	8	8	16	0	0	16	0	0
17	26208866	.	T	C	9	5	14	0	1	15	0	0
17	26285347	.	A	G	4	0	4	0	7	11	0	0
17	26285350	.	G	T	6	5	11	0	0	11	0	0
17	26298967	.	C	T	6	9	15	0	1	16	0	0
17	26325286	.	C	T	1	4	5	0	1	6	0	0
17	26335000	.	G	A	3	5	8	0	2	10	0	0
17	26346175	.	T	A	11	8	19	0	0	19	0	0
17	26362130	.	G	A	8	8	16	0	1	17	0	0
17	26362500	.	C	T	5	4	9	0	0	9	0	0
17	26362512	.	A	C	4	5	9	0	0	9	0	0
17	26362539	.	C	T	2	3	5	0	0	5	0	0
17	26362741	.	C	T	6	2	8	0	0	8	0	0
17	26363187	.	T	G	1	2	3	0	1	4	0	0
17	26477743	.	A	C	10	2	12	0	2	14	0	0
17	26477747	.	T	A	9	3	12	0	2	14	0	0
17	26477795	.	A	C	7	5	12	0	0	12	0	0
17	26477857	.	T	C	10	7	17	0	0	17	0	0
17	26477860	.	C	T	11	7	18	0	0	18	0	0
17	26478023	.	T	C	12	5	17	0	1	18	0	0
17	26478403	.	T	G	4	7	11	0	4	15	0	0
17	26478592	.	A	G	6	16	22	0	1	23	0	0
17	26478818	.	T	C	11	0	11	0	9	20	0	0
17	26478952	.	G	A	9	5	14	0	1	15	0	0
17	26478986	.	A	G	10	5	15	0	1	16	0	0
17	26479063	.	A	G	5	4	9	2	0	11	0	0
17	26479145	.	T	C	10	9	19	0	1	20	0	0
17	26479960	.	C	T	5	2	7	0	0	7	0	0
17	26480421	.	A	G	9	4	13	0	1	14	0	0
17	26480423	.	T	C	10	3	13	0	1	14	0	0
17	26480622	.	A	T	11	7	18	0	0	18	0	0
17	26480683	.	A	G	3	5	8	0	0	8	0	0
17	26480926	.	T	G	9	4	13	0	0	13	0	0
17	26502013	.	A	G	5	6	11	0	1	12	0	0
17	26502107	.	G	A	5	6	11	0	0	11	0	0
17	26507294	.	G	A	6	6	12	0	0	12	0	0
17	26516748	.	G	C	1	6	7	0	0	7	0	0
17	26516878	.	G	A	2	7	9	0	1	10	0	0
17	26517310	.	A	C	4	0	4	0	3	7	0	0
17	26517366	.	G	A	6	4	10	0	0	10	0	0
17	26519364	.	A	G	4	3	7	0	1	8	0	0
17	26519475	.	T	C	2	0	2	0	3	5	0	0
17	26519681	.	C	T	10	10	20	0	2	22	0	0
17	26519823	.	T	C	7	0	7	0	3	10	0	0
17	26520153	.	G	A	5	4	9	0	0	9	0	0
17	26537477	.	A	T	2	2	4	0	1	5	0	0
17	26537529	.	C	T	4	2	6	0	0	6	0	0
17	26537805	.	A	T	3	4	7	0	0	7	0	0
17	26577293	.	T	C	13	9	22	0	0	22	0	0
17	26585135	.	G	T	8	9	17	0	1	18	0	0
17	26585163	.	A	T	8	5	13	0	2	15	0	0
17	26585298	.	G	T	1	5	6	0	8	14	0	0
17	26585316	.	C	T	5	6	11	0	0	11	0	0
17	26585646	.	C	T	18	9	27	0	0	27	0	0
17	26585727	.	C	T	8	11	19	0	0	19	0	0
17	26585748	.	A	G	12	0	12	0	9	21	0	0
17	26585763	.	T	A	12	12	24	0	1	25	0	0
17	26590001	.	T	G	11	8	19	0	0	19	0	0
17	26590054	.	C	T	9	9	18	0	1	19	0	0
17	26590091	.	C	T	11	7	18	0	0	18	0	0
17	26590650	.	G	T	6	5	11	0	1	12	0	0
17	26594931	.	C	T	14	10	24	0	3	27	0	0
17	26594968	.	G	C	11	13	24	0	0	24	0	0
17	26599208	.	C	T	2	8	10	0	8	18	0	0
17	26600555	.	T	A	4	6	10	0	0	10	0	0
17	26600639	.	G	A	10	9	19	0	0	19	0	0
17	26600667	.	C	T	13	12	25	0	0	25	0	0
17	26600785	.	G	A	11	9	20	0	0	20	0	0
17	26600881	.	G	A	11	7	18	0	1	19	0	0
17	26603369	.	A	T	9	8	17	0	0	17	0	0
17	26604572	.	A	G	2	7	9	0	0	9	0	0
17	26604751	.	G	C	7	8	15	0	2	17	0	0
17	26604758	.	C	T	9	8	17	0	2	19	0	0
17	26604801	.	C	A	12	10	22	0	0	22	0	0
17	26612007	.	G	T	3	3	6	0	0	6	0	0
17	26630909	.	C	T	15	11	26	0	0	26	0	0
17	26639659	.	C	T	19	16	35	0	1	36	0	0
17	26642775	.	C	A	14	10	24	0	0	24	0	0
17	26642817	.	T	G	17	1	18	0	12	30	0	0
17	26642818	.	T	C	16	13	29	0	1	30	0	0
17	26657852	.	T	C	14	15	29	1	0	30	0	0
17	26662347	.	C	T	12	14	26	0	0	26	0	0
17	26683466	.	T	C	19	11	30	1	3	34	0	0
17	26683526	.	C	T	26	7	33	1	0	34	0	0
17	26689753	.	G	A	16	18	34	0	9	43	0	0
17	26689768	.	C	A	31	13	44	0	2	46	0	0
17	26689792	.	C	A	11	22	33	0	5	38	0	0
17	26690112	.	T	A	19	13	32	0	0	32	0	0
17	26690250	.	C	T	4	9	13	1	0	14	0	0
17	26690478	.	C	T	15	8	23	0	0	23	0	0
17	26690558	.	G	A	2	17	19	0	12	31	0	0
17	26714009	.	C	T	39	26	65	0	1	66	0	0
17	26734345	.	C	T	2	2	4	0	0	4	0	0
17	26735735	.	T	C	3	3	6	0	0	6	0	0
17	26741227	.	C	T	2	3	5	0	0	5	0	0
17	26741254	.	T	C	1	5	6	0	0	6	0	0
17	26744174	.	G	A	3	5	8	0	0	8	0	0
17	26744207	.	G	C	5	3	8	0	0	8	0	0
17	26744706	.	T	C	2	2	4	0	0	4	0	0
17	26744748	.	T	A	3	2	5	0	0	5	0	0
17	26744862	.	G	A	2	2	4	0	0	4	0	0
17	26744981	.	C	T	5	3	8	0	0	8	0	0
17	26745106	.	T	C	3	4	7	0	0	7	0	0
17	26745110	.	C	T	2	5	7	0	0	7	0	0
17	26747348	.	A	G	4	4	8	0	0	8	0	0
17	26749836	.	G	A	1	2	3	0	0	3	0	0
17	26749881	.	T	A	2	2	4	0	0	4	0	0
17	26771084	.	G	A	2	4	6	0	0	6	0	0
17	26810380	.	C	T	23	21	44	0	1	45	0	0
17	26813285	.	T	C	7	17	24	2	6	32	0	0
17	26831861	.	G	A	5	6	11	0	0	11	0	0
17	26832713	.	C	T	6	6	12	0	0	12	0	0
17	26832738	.	A	G	9	7	16	0	0	16	0	0
17	26846203	.	C	T	10	10	20	0	1	21	0	0
17	26846650	.	G	A	11	3	14	0	3	17	0	0
17	26846707	.	G	A	0	6	6	0	6	12	0	0
17	26846901	.	T	G	7	9	16	0	0	16	0	0
17	26879854	.	A	C	8	19	27	0	1	28	0	0
17	26879869	.	A	G	12	15	27	0	1	28	0	0
17	26879893	.	A	G	23	17	40	0	2	42	0	0
17	26880107	.	G	A	21	14	35	0	1	36	0	0
17	26880231	.	T	C	26	19	45	0	1	46	0	0
17	26880424	.	T	C	28	24	52	0	1	53	0	0
17	26880692	.	T	C	17	16	33	1	1	35	0	0
17	26880703	.	T	C	16	5	21	1	1	23	0	0
17	26880926	.	T	C	28	1	29	0	14	43	0	0
17	26880964	.	A	G	21	29	50	0	0	50	0	0
17	26881131	.	T	A	24	16	40	0	0	40	0	0
17	26881354	.	A	G	24	20	44	1	1	46	0	0
17	26881777	.	A	G	21	21	42	2	3	48	1	0
17	26911747	.	A	G	20	24	44	0	2	46	0	0
17	26924308	.	C	T	1	8	9	0	3	12	0	0
17	26926548	.	G	A	3	3	6	0	1	7	0	0
17	26928994	.	C	T	7	2	9	0	0	9	0	0
17	26929029	.	G	A	3	2	5	0	0	5	0	0
17	26929577	.	C	A	4	6	10	0	0	10	0	0
17	26929649	.	A	G	10	5	15	0	0	15	0	0
17	26929654	.	T	A	5	9	14	0	1	15	0	0
17	26929776	.	C	T	3	9	12	0	0	12	0	0
17	26929893	.	G	A	5	13	18	0	0	18	0	0
17	26933223	.	A	G	5	5	10	0	1	11	0	0
17	26933328	.	C	T	3	11	14	0	0	14	0	0
17	26934417	.	C	T	0	10	10	0	5	15	0	0
17	26935160	.	C	T	6	5	11	0	3	14	0	0
17	26935254	.	G	T	10	5	15	0	1	16	0	0
17	26935274	.	G	T	13	9	22	0	0	22	0	0
17	26985158	.	G	A	1	9	10	0	18	28	0	0
17	26985544	.	T	A	11	7	18	0	0	18	0	0
17	26985561	.	T	G	12	0	12	0	6	18	0	0
17	26985586	.	C	T	11	9	20	0	0	20	0	0
17	26985638	.	T	G	6	9	15	0	0	15	0	0
17	26985656	.	T	A	4	10	14	0	1	15	0	0
17	26985692	.	G	T	6	9	15	0	0	15	0	0
17	27064523	.	T	A	7	10	17	0	0	17	0	0
17	27064725	.	T	C	8	7	15	0	0	15	0	0
17	27064840	.	G	C	1	5	6	0	7	13	0	0
17	27152597	.	T	C	7	5	12	0	0	12	0	0
17	27154580	.	C	A	13	9	22	0	0	22	0	0
17	27154695	.	A	G	12	5	17	0	1	18	0	0
17	27158692	.	C	T	9	7	16	0	0	16	0	0
17	27160846	.	C	T	8	9	17	0	0	17	0	0
17	27160912	.	G	A	10	5	15	0	2	17	0	0
17	27162479	.	C	T	8	11	19	0	0	19	0	0
17	27163266	.	T	C	6	5	11	0	0	11	0	0
17	27164497	.	T	C	9	6	15	0	0	15	0	0
17	27164530	.	C	T	9	9	18	0	2	20	0	0
17	27166221	.	T	C	8	6	14	0	1	15	0	0
17	27166257	.	T	C	7	5	12	0	1	13	0	0
17	27166521	.	C	T	9	8	17	0	1	18	0	0
17	27168957	.	G	T	1	10	11	0	8	19	0	0
17	27169783	.	A	C	8	10	18	0	0	18	0	0
17	27170017	.	G	A	2	9	11	0	5	17	1	0
17	27170153	.	A	T	8	4	12	0	0	12	0	0
17	27170390	.	G	T	2	2	4	0	1	5	0	0
17	27170516	.	G	A	0	10	10	0	9	19	0	0
17	27170549	.	G	A	3	9	12	0	0	12	0	0
17	27170605	.	T	G	4	10	14	0	0	14	0	0
17	27170678	.	C	A	11	6	17	0	1	18	0	0
17	27170730	.	T	G	6	4	10	0	1	11	0	0
17	27170746	.	A	T	4	5	9	0	0	9	0	0
17	27176640	.	G	A	13	5	18	0	3	21	0	0
17	27176871	.	G	A	7	10	17	0	1	18	0	0
17	27176967	.	G	C	13	8	21	0	0	21	0	0
17	27176991	.	C	T	9	11	20	0	2	22	0	0
17	27177064	.	C	T	8	8	16	0	1	17	0	0
17	27177083	.	G	A	3	11	14	0	7	21	0	0
17	27177251	.	A	G	6	7	13	0	0	13	0	0
17	27177302	.	A	G	4	0	4	0	9	13	0	0
17	27177776	.	G	T	8	5	13	0	0	13	0	0
17	27177808	.	G	T	9	5	14	1	0	15	0	0
17	27177864	.	C	T	7	4	11	0	1	12	0	0
17	27177934	.	A	G	2	1	3	0	0	3	0	0
17	27177945	.	G	T	4	7	11	1	1	13	0	0
17	27178024	.	T	A	13	6	19	0	0	19	0	0
17	27178088	.	T	A	7	5	12	0	1	13	0	0
17	27178191	.	G	A	4	7	11	0	0	11	0	0
17	27178232	.	A	G	10	3	13	0	0	13	0	0
17	27178254	.	C	A	3	7	10	0	0	10	0	0
17	27178273	.	G	T	8	4	12	0	0	12	0	0
17	27178296	.	G	A	2	8	10	0	6	16	0	0
17	27178356	.	T	A	10	6	16	0	3	19	0	0
17	27178383	.	C	G	7	9	16	0	1	17	0	0
17	27178401	.	C	T	11	6	17	0	1	18	0	0
17	27178557	.	C	T	3	11	14	0	1	15	0	0
17	27178638	.	C	G	9	6	15	0	0	15	0	0
17	27178730	.	C	A	8	6	14	0	0	14	0	0
17	27178870	.	T	C	10	5	15	0	1	16	0	0
17	27179189	.	A	G	13	3	16	0	0	16	0	0
17	27179203	.	G	T	1	3	4	0	9	13	0	0
17	27179434	.	G	T	5	5	10	0	2	12	0	0
17	27179645	.	G	A	2	3	5	0	0	5	0	0
17	27179848	.	A	G	7	6	13	0	0	13	0	0
17	27180407	.	T	A	8	4	12	0	1	13	0	0
17	27180447	.	A	T	4	5	9	0	0	9	0	0
17	27181021	.	T	C	5	11	16	0	1	17	0	0
17	27181048	.	C	G	3	15	18	0	0	18	0	0
17	27181129	.	G	A	10	13	23	0	1	24	0	0
17	27181130	.	G	A	10	14	24	0	0	24	0	0
17	27181257	.	A	C	12	8	20	0	0	20	0	0
17	27181323	.	A	G	13	0	13	0	8	21	0	0
17	27181411	.	A	G	7	0	7	0	5	12	0	0
17	27181427	.	C	T	8	7	15	0	0	15	0	0
17	27181463	.	A	G	1	0	1	0	7	8	0	0
17	27181481	.	A	G	3	4	7	0	0	7	0	0
17	27181680	.	C	T	3	4	7	0	0	7	0	0
17	27181829	.	A	G	9	6	15	0	0	15	0	0
17	27182006	.	G	T	17	4	21	0	1	22	0	0
17	27182039	.	T	C	18	10	28	0	0	28	0	0
17	27182114	.	A	G	5	10	15	0	0	15	0	0
17	27182146	.	C	T	5	12	17	0	0	17	0	0
17	27182331	.	T	G	4	5	9	0	0	9	0	0
17	27182340	.	C	T	5	6	11	0	0	11	0	0
17	27182449	.	G	T	6	10	16	0	0	16	0	0
17	27182484	.	T	C	9	13	22	0	1	23	0	0
17	27182645	.	G	T	20	15	35	0	0	35	0	0
17	27182649	.	A	G	20	17	37	0	0	37	0	0
17	27182769	.	A	G	9	7	16	0	0	16	0	0
17	27182894	.	T	C	12	9	21	0	0	21	0	0
17	27182925	.	A	T	9	8	17	0	1	18	0	0
17	27182979	.	C	T	5	13	18	0	0	18	0	0
17	27190731	.	C	G	2	3	5	0	0	5	0	0
17	27190732	.	C	T	2	2	4	0	1	5	0	0
17	27191528	.	C	T	2	4	6	0	0	6	0	0
17	27192698	.	C	T	3	2	5	0	0	5	0	0
17	27192756	.	G	C	2	3	5	0	0	5	0	0
17	27194087	.	G	A	2	2	4	0	0	4	0	0
17	27194168	.	A	G	2	6	8	0	0	8	0	0
17	27194183	.	A	G	3	5	8	0	0	8	0	0
17	27194669	.	C	T	3	5	8	0	0	8	0	0
17	27194867	.	A	G	3	3	6	0	0	6	0	0
17	27235566	.	C	A	0	2	2	0	2	4	0	0
17	27235581	.	A	T	2	2	4	0	0	4	0	0
17	27272913	.	T	C	12	7	19	0	1	20	0	0
17	27273013	.	C	T	9	6	15	0	0	15	0	0
17	27401038	.	A	T	8	3	11	0	7	18	0	0
17	27408386	.	A	G	12	9	21	0	0	21	0	0
17	27408472	.	C	T	12	9	21	0	3	24	0	0
17	27408523	.	G	T	8	6	14	0	2	16	0	0
17	27408531	.	T	A	5	6	11	0	3	14	0	0
17	27408592	.	C	A	1	6	7	0	0	7	0	0
17	27408836	.	T	G	6	16	22	0	2	24	0	0
17	27408889	.	T	C	12	14	26	0	0	26	0	0
17	27413564	.	T	C	12	10	22	0	1	23	0	0
17	27413705	.	T	C	8	12	20	0	2	22	0	0
17	27414035	.	G	A	6	4	10	0	0	10	0	0
17	27414098	.	C	A	3	12	15	0	0	16	1	0
17	27414203	.	G	A	10	13	23	0	1	24	0	0
17	27414215	.	C	T	1	11	12	0	15	27	0	0
17	27414367	.	A	G	12	16	28	0	0	28	0	0
17	27414658	.	T	C	10	14	24	0	1	25	0	0
17	27414701	.	A	G	7	17	24	0	1	25	0	0
17	27414791	.	A	G	7	7	14	0	2	16	0	0
17	27414815	.	G	A	12	6	18	0	0	18	0	0
17	27415010	.	C	T	0	12	12	0	12	24	0	0
17	27723800	.	G	T	19	16	35	0	2	37	0	0
17	27807455	.	T	C	22	23	45	0	1	46	0	0
17	27808335	.	A	G	19	14	33	0	2	35	0	0
17	27808686	.	G	A	5	8	13	0	0	13	0	0
17	27808700	.	G	A	7	9	16	0	0	16	0	0
17	27808987	.	G	T	1	24	25	0	24	49	0	0
17	27809548	.	T	A	23	9	32	0	1	33	0	0
17	27809631	.	G	T	0	10	10	0	9	19	0	0
17	27809779	.	C	A	27	19	46	0	1	47	0	0
17	27809885	.	A	G	26	21	47	0	2	49	0	0
17	27811199	.	T	A	8	3	11	0	0	11	0	0
17	27811209	.	A	G	11	6	17	0	0	17	0	0
17	27811277	.	C	G	10	3	13	0	0	13	0	0
17	27812292	.	T	A	1	2	3	0	0	3	0	0
17	27812525	.	A	C	19	9	28	0	0	28	0	0
17	27812562	.	G	A	2	12	14	0	14	28	0	0
17	27812702	.	A	T	8	8	16	0	2	18	0	0
17	27812885	.	C	T	3	2	5	0	0	5	0	0
17	27813221	.	C	T	16	8	24	0	0	24	0	0
17	27813222	.	A	G	15	7	22	0	2	24	0	0
17	27813549	.	C	G	8	3	11	0	1	12	0	0
17	27813553	.	C	G	8	3	11	0	1	12	0	0
17	28005908	.	T	C	2	2	4	0	1	5	0	0
17	28049663	.	A	T	6	4	10	0	0	10	0	0
17	28049804	.	G	T	6	10	16	0	1	17	0	0
17	28050500	.	T	A	6	11	17	0	1	18	0	0
17	28050530	.	A	G	9	13	22	0	2	24	0	0
17	28050954	.	G	A	8	9	17	0	0	17	0	0
17	28051073	.	C	T	9	7	16	0	0	17	1	0
17	28051129	.	G	A	9	3	12	0	1	13	0	0
17	28051222	.	C	T	8	3	11	0	0	11	0	0
17	28051247	.	T	A	8	4	12	0	0	12	0	0
17	28051465	.	T	C	10	4	14	0	0	14	0	0
17	28051504	.	G	T	7	7	14	0	0	14	0	0
17	28051605	.	A	G	9	5	14	0	0	14	0	0
17	28051739	.	A	G	10	13	23	0	0	23	0	0
17	28052322	.	C	A	7	8	15	0	0	15	0	0
17	28067389	.	C	T	11	19	30	0	2	32	0	0
17	28067472	.	A	C	15	11	26	0	2	28	0	0
17	28067618	.	A	G	5	11	16	0	0	16	0	0
17	28067856	.	C	T	11	10	21	0	2	23	0	0
17	28068083	.	T	C	12	10	22	0	0	22	0	0
17	28068087	.	G	T	11	10	21	0	1	22	0	0
17	28068168	.	G	A	5	7	12	0	1	13	0	0
17	28068262	.	T	G	8	0	8	0	13	21	0	0
17	28068276	.	C	T	10	14	24	0	0	24	0	0
17	28068507	.	A	G	7	10	17	0	1	18	0	0
17	28068514	.	T	C	8	10	18	0	1	19	0	0
17	28068916	.	C	T	7	10	17	0	1	18	0	0
17	28069170	.	G	A	15	16	31	0	1	32	0	0
17	28069341	.	G	T	11	8	19	0	2	21	0	0
17	28069342	.	T	C	13	8	21	0	0	21	0	0
17	28069645	.	G	T	20	7	27	0	1	28	0	0
17	28069716	.	G	C	15	18	33	0	0	33	0	0
17	28069787	.	G	A	2	16	18	0	13	31	0	0
17	28070078	.	G	C	17	10	27	0	0	27	0	0
17	28070167	.	C	T	8	7	15	0	1	16	0	0
17	28070284	.	G	A	7	6	13	0	1	14	0	0
17	28070286	.	A	C	9	6	15	0	0	15	0	0
17	28070481	.	T	A	17	12	29	0	0	29	0	0
17	28070600	.	C	A	17	13	30	0	0	30	0	0
17	28070840	.	G	A	11	7	18	0	0	18	0	0
17	28070879	.	T	G	6	6	12	0	0	12	0	0
17	28070897	.	T	A	3	3	6	0	0	6	0	0
17	28071194	.	C	T	10	3	13	0	0	13	0	0
17	28071260	.	A	G	15	9	24	0	2	26	0	0
17	28084592	.	C	T	7	7	14	0	0	14	0	0
17	28084733	.	T	C	18	15	33	5	2	40	0	0
17	28084869	.	A	C	20	13	33	0	2	35	0	0
17	28084996	.	A	T	19	15	34	0	0	34	0	0
17	28097235	.	G	A	18	11	29	0	0	29	0	0
17	28097672	.	T	C	16	14	30	0	2	32	0	0
17	28100095	.	A	C	1	2	3	0	0	3	0	0
17	28100598	.	C	T	1	11	12	0	21	33	0	0
17	28166980	.	C	T	4	2	6	0	1	7	0	0
17	28167235	.	T	C	4	0	4	0	3	7	0	0
17	28167439	.	G	A	12	4	16	0	0	16	0	0
17	28167856	.	G	A	1	4	5	0	1	6	0	0
17	28168054	.	A	G	4	3	7	0	0	7	0	0
17	28168363	.	G	A	4	3	7	0	0	7	0	0
17	28168366	.	G	A	5	3	8	0	0	8	0	0
17	28197957	.	G	A	2	2	4	0	0	4	0	0
17	28340549	.	C	T	3	3	6	0	1	8	1	0
17	28408024	.	A	C	6	5	11	0	0	11	0	0
17	28423698	.	T	C	3	5	8	0	0	8	0	0
17	28433043	.	A	G	9	7	16	0	2	18	0	0
17	28440296	.	T	C	4	6	10	0	1	11	0	0
17	28461857	.	G	A	1	7	8	0	13	21	0	0
17	28466228	.	T	C	6	6	12	0	2	14	0	0
17	28466273	.	C	T	8	8	16	0	1	17	0	0
17	28497878	.	T	C	9	10	19	0	0	19	0	0
17	28560736	.	T	C	9	10	19	0	2	21	0	0
17	28563725	.	G	A	16	10	26	0	0	26	0	0
17	28610717	.	A	C	2	3	5	0	0	5	0	0
17	28629768	.	G	A	0	2	2	0	2	4	0	0
17	28629831	.	C	T	3	4	7	0	1	8	0	0
17	28638740	.	A	G	3	4	7	0	0	7	0	0
17	28638806	.	T	C	3	2	5	0	0	5	0	0
17	28639037	.	G	A	1	4	5	0	0	5	0	0
17	28639290	.	T	C	2	2	4	0	1	5	0	0
17	28639333	.	T	G	1	2	3	0	0	3	0	0
17	28640690	.	G	T	6	4	10	0	0	10	0	0
17	28642352	.	C	T	3	2	5	0	0	5	0	0
17	28643635	.	C	T	4	3	7	0	1	8	0	0
17	28657421	.	G	T	5	6	11	0	0	11	0	0
17	28661628	.	C	G	7	0	7	0	5	12	0	0
17	28661931	.	G	T	0	5	5	0	3	8	0	0
17	28666381	.	C	T	5	5	10	0	0	10	0	0
17	28668465	.	T	C	6	5	11	0	1	12	0	0
17	28668627	.	C	T	2	5	7	0	1	8	0	0
17	28670428	.	C	T	7	5	12	1	0	13	0	0
17	28675202	.	G	A	3	2	5	0	0	5	0	0
17	28680051	.	C	T	9	8	17	0	0	17	0	0
17	28680258	.	C	T	10	8	18	0	0	18	0	0
17	28680634	.	G	A	11	8	19	0	0	19	0	0
17	28695753	.	C	T	14	12	26	0	0	26	0	0
17	28701100	.	G	A	8	5	13	0	1	14	0	0
17	28707268	.	T	A	11	13	24	0	2	26	0	0
17	28724530	.	A	G	5	0	5	0	14	19	0	0
17	28724539	.	A	T	6	15	21	0	0	21	0	0
17	28724833	.	T	C	14	15	29	0	1	30	0	0
17	28725346	.	A	G	16	0	16	0	10	26	0	0
17	28730705	.	C	T	12	11	23	0	0	23	0	0
17	28738387	.	C	T	6	7	13	0	2	15	0	0
17	28738675	.	A	G	11	0	11	0	6	17	0	0
17	28741442	.	G	A	11	12	23	1	1	25	0	0
17	28741467	.	G	A	0	11	11	1	10	22	0	0
17	28741540	.	A	G	11	0	11	0	11	22	0	0
17	28741752	.	C	T	16	8	24	0	2	26	0	0
17	28741934	.	C	T	8	9	17	0	0	17	0	0
17	28742263	.	G	C	13	11	24	0	1	25	0	0
17	28742385	.	T	A	11	8	19	0	2	21	0	0
17	28742505	.	T	G	20	11	31	0	2	33	0	0
17	28742559	.	C	T	14	16	30	0	3	33	0	0
17	28742681	.	C	T	3	7	10	0	0	10	0	0
17	28742755	.	C	A	3	2	5	0	0	5	0	0
17	28761734	.	A	G	1	2	3	0	0	3	0	0
17	28771228	.	T	A	5	10	15	0	1	16	0	0
17	28778186	.	C	T	6	13	19	0	0	19	0	0
17	28784090	.	G	T	12	10	22	0	0	22	0	0
17	28785010	.	G	A	9	9	18	0	1	19	0	0
17	28786873	.	G	A	10	9	19	0	0	19	0	0
17	28789014	.	C	T	1	11	12	0	10	22	0	0
17	28939316	.	T	C	4	7	11	0	0	11	0	0
17	28948905	.	G	A	4	5	9	0	0	9	0	0
17	28968461	.	T	C	18	13	31	0	0	31	0	0
17	29227594	.	G	A	3	2	5	0	0	5	0	0
17	29227600	.	G	A	3	2	5	0	0	5	0	0
17	29227691	.	T	A	3	2	5	0	1	6	0	0
17	29228114	.	G	A	3	3	6	0	1	7	0	0
17	29228222	.	A	G	3	2	5	0	0	5	0	0
17	29251810	.	G	C	5	11	16	0	0	16	0	0
17	29252043	.	C	T	2	6	8	0	0	8	0	0
17	29252122	.	C	A	5	2	7	0	0	7	0	0
17	29252218	.	C	T	8	2	10	0	0	10	0	0
17	29252254	.	C	T	9	6	15	0	0	15	0	0
17	29252295	.	T	C	3	10	13	0	0	13	0	0
17	29252308	.	T	G	3	5	8	0	0	8	0	0
17	29252352	.	C	T	4	4	8	0	0	8	0	0
17	29252665	.	G	C	3	5	8	0	0	8	0	0
17	29252754	.	C	G	0	5	5	0	4	9	0	0
17	29270021	.	C	T	6	9	15	0	0	15	0	0
17	29270939	.	C	T	0	5	5	0	6	11	0	0
17	29276615	.	T	G	2	2	4	0	0	4	0	0
17	29282893	.	A	T	10	4	14	0	1	15	0	0
17	29282901	.	C	A	10	4	14	0	1	15	0	0
17	29283096	.	T	C	2	2	4	0	0	4	0	0
17	29283126	.	T	A	2	5	7	0	0	7	0	0
17	29283380	.	T	A	5	8	13	0	0	13	0	0
17	29283723	.	A	T	5	2	7	1	1	9	0	0
17	29283866	.	T	C	5	8	13	0	0	13	0	0
17	29283902	.	G	A	7	11	18	0	0	18	0	0
17	29283920	.	A	C	8	0	8	0	12	20	0	0
17	29283943	.	A	G	7	16	23	0	1	24	0	0
17	29283962	.	A	G	7	12	19	0	1	20	0	0
17	29288057	.	G	T	5	6	11	0	0	11	0	0
17	29288718	.	A	G	16	11	27	0	0	27	0	0
17	29298224	.	A	G	12	5	17	0	0	17	0	0
17	29300641	.	A	T	5	7	12	0	0	12	0	0
17	29300650	.	A	G	5	7	12	0	0	12	0	0
17	29301058	.	G	C	5	3	8	0	0	8	0	0
17	29306749	.	C	A	7	6	13	0	0	13	0	0
17	29308706	.	G	A	10	8	18	0	0	18	0	0
17	29309024	.	G	A	6	7	13	0	0	13	0	0
17	29310200	.	T	C	1	6	7	0	0	7	0	0
17	29310347	.	C	T	1	3	4	0	2	6	0	0
17	29310353	.	C	G	1	3	4	0	4	8	0	0
17	29311761	.	A	G	8	4	12	0	0	12	0	0
17	29334520	.	T	A	9	19	28	0	4	32	0	0
17	29335645	.	G	A	14	4	18	0	0	18	0	0
17	29339149	.	T	G	14	15	29	0	0	29	0	0
17	29341079	.	C	T	13	12	25	0	2	27	0	0
17	29341118	.	C	T	14	18	32	0	0	32	0	0
17	29341597	.	T	C	14	13	27	0	1	28	0	0
17	29342904	.	G	A	0	3	3	0	7	10	0	0
17	29342947	.	C	T	6	8	14	0	1	15	0	0
17	29343143	.	T	C	8	13	21	0	0	21	0	0
17	29343153	.	G	A	9	15	24	0	1	25	0	0
17	29343358	.	A	G	13	12	25	0	1	26	0	0
17	29343494	.	A	G	3	11	14	0	1	15	0	0
17	29345725	.	T	G	10	14	24	0	2	26	0	0
17	29349739	.	G	A	0	10	10	0	9	19	0	0
17	29364518	.	G	A	17	13	30	0	0	30	0	0
17	29364713	.	C	T	8	12	20	0	0	20	0	0
17	29367320	.	T	C	16	20	36	0	0	36	0	0
17	29369029	.	C	T	17	19	36	0	1	37	0	0
17	29369072	.	T	C	12	18	30	0	0	30	0	0
17	29369114	.	T	C	16	13	29	0	0	29	0	0
17	29369213	.	T	G	17	12	29	0	1	30	0	0
17	29369414	.	G	A	10	15	25	0	0	25	0	0
17	29369612	.	A	G	14	22	36	0	0	36	0	0
17	29369713	.	A	C	20	14	34	0	3	37	0	0
17	29369748	.	C	T	19	19	38	0	2	40	0	0
17	29369780	.	C	A	8	14	22	0	4	26	0	0
17	29370260	.	T	A	11	4	15	0	1	16	0	0
17	29798098	.	A	G	6	13	19	0	0	19	0	0
17	29798312	.	C	A	3	15	18	0	11	30	1	0
17	29804291	.	G	C	9	19	28	0	2	30	0	0
17	29841590	.	A	T	16	11	27	0	3	30	0	0
17	29877079	.	C	T	0	7	7	0	6	13	0	0
17	29877094	.	A	G	7	7	14	0	0	14	0	0
17	30384099	.	T	G	1	0	1	0	3	4	0	0
17	30395433	.	A	G	1	3	4	0	0	4	0	0
17	30395453	.	G	A	1	3	4	0	0	4	0	0
17	30397078	.	C	T	1	2	3	0	1	4	0	0
17	30409655	.	C	G	1	2	3	0	0	3	0	0
17	30411205	.	C	T	5	6	11	0	0	11	0	0
17	30411208	.	A	G	5	5	10	0	0	10	0	0
17	30411474	.	C	T	2	4	6	0	0	6	0	0
17	30411498	.	C	T	2	2	4	0	0	4	0	0
17	30458569	.	C	T	3	7	10	0	0	10	0	0
17	30459602	.	C	A	4	4	8	0	0	8	0	0
17	30460216	.	T	C	2	2	4	0	0	4	0	0
17	30460217	.	G	C	2	1	3	0	1	4	0	0
17	30464806	.	A	T	9	10	19	0	0	19	0	0
17	30466186	.	G	A	7	3	10	0	0	10	0	0
17	30466395	.	T	C	5	3	8	0	0	8	0	0
17	30468428	.	C	T	13	5	18	0	1	19	0	0
17	30468730	.	G	T	4	2	6	0	0	6	0	0
17	30469200	.	C	A	3	3	6	0	0	6	0	0
17	30469364	.	T	C	1	5	6	0	0	6	0	0
17	30470034	.	C	T	1	4	5	0	0	5	0	0
17	30474161	.	A	G	2	6	8	0	0	8	0	0
17	30474226	.	A	G	1	3	4	0	0	4	0	0
17	30476939	.	C	A	0	3	3	0	11	14	0	0
17	30476978	.	A	G	6	4	10	0	0	10	0	0
17	30478808	.	A	G	2	4	6	0	0	6	0	0
17	30478897	.	G	A	8	6	14	0	0	14	0	0
17	30478943	.	A	G	4	6	10	0	0	10	0	0
17	30479161	.	A	G	5	3	8	0	0	8	0	0
17	30479359	.	T	C	2	6	8	0	0	8	0	0
17	30479647	.	T	C	3	9	12	0	1	13	0	0
17	30486671	.	T	C	13	0	13	0	10	23	0	0
17	30486971	.	G	A	7	9	16	0	0	16	0	0
17	30487040	.	G	A	9	5	14	0	0	14	0	0
17	30487094	.	G	C	5	8	13	0	1	14	0	0
17	30492999	.	A	C	4	0	4	0	7	11	0	0
17	30493290	.	T	C	5	4	9	0	0	9	0	0
17	30493770	.	T	C	2	0	2	0	8	10	0	0
17	30494073	.	T	G	12	7	19	0	1	20	0	0
17	30496317	.	C	T	5	2	7	0	0	7	0	0
17	30498084	.	C	T	7	6	13	0	0	13	0	0
17	30503154	.	T	C	2	2	4	0	0	4	0	0
17	30505439	.	T	C	3	0	3	0	4	7	0	0
17	30505493	.	T	C	3	3	6	0	0	6	0	0
17	30506673	.	A	C	3	5	8	0	0	8	0	0
17	30580877	.	T	C	4	5	9	0	0	9	0	0
17	30583641	.	A	T	6	3	9	0	0	9	0	0
17	30584081	.	C	T	2	4	6	0	1	7	0	0
17	30584232	.	C	A	2	2	4	0	0	4	0	0
17	30584301	.	T	C	3	3	6	0	0	6	0	0
17	30584338	.	C	A	3	3	6	0	1	7	0	0
17	30584341	.	G	A	0	3	3	0	4	7	0	0
17	30584869	.	A	T	2	6	8	0	0	8	0	0
17	30585020	.	G	C	5	2	7	0	0	7	0	0
17	30585604	.	C	T	6	7	13	0	1	14	0	0
17	30585682	.	A	T	2	8	10	0	0	10	0	0
17	30586485	.	C	T	4	5	9	0	0	9	0	0
17	30587288	.	T	C	3	4	7	0	0	7	0	0
17	30587324	.	T	G	4	0	4	0	10	14	0	0
17	30587325	.	A	G	4	9	13	0	1	14	0	0
17	30589166	.	T	C	10	6	16	0	0	16	0	0
17	30589379	.	A	G	2	7	9	0	0	9	0	0
17	30590020	.	A	G	8	5	13	0	0	13	0	0
17	30590271	.	G	T	6	7	13	0	0	13	0	0
17	30590273	.	C	G	7	7	14	0	0	14	0	0
17	30590325	.	C	T	4	10	14	0	0	14	0	0
17	30590367	.	G	A	7	3	10	0	0	10	0	0
17	30590838	.	T	C	8	6	14	0	0	14	0	0
17	30590842	.	C	A	8	5	13	0	0	13	0	0
17	30749304	.	C	A	5	5	10	0	0	11	1	0
17	30816937	.	T	C	1	2	3	0	1	4	0	0
17	30817044	.	G	A	1	2	3	0	1	4	0	0
17	30817119	.	T	A	2	4	6	0	0	6	0	0
17	30817170	.	A	G	3	2	5	0	0	5	0	0
17	30853988	.	T	C	3	3	6	0	0	6	0	0
17	30853989	.	C	T	3	3	6	0	0	6	0	0
17	30857288	.	A	G	11	11	22	0	1	23	0	0
17	30857431	.	A	T	8	3	11	0	0	11	0	0
17	30857433	.	A	T	7	3	10	0	0	10	0	0
17	30858809	.	C	T	2	17	19	0	16	35	0	0
17	30860630	.	G	T	22	10	32	0	0	32	0	0
17	30862909	.	A	G	16	12	28	0	0	28	0	0
17	30901130	.	T	C	3	2	5	0	1	6	0	0
17	30912562	.	C	A	11	8	19	0	1	20	0	0
17	30936802	.	C	T	0	11	11	0	13	24	0	0
17	30979170	.	T	C	4	11	15	0	0	15	0	0
17	30979208	.	T	C	5	7	12	0	1	13	0	0
17	30979339	.	T	C	11	6	17	0	0	17	0	0
17	30979391	.	T	C	10	0	10	0	14	24	0	0
17	30979446	.	T	C	13	6	19	0	0	19	0	0
17	30979465	.	T	C	2	6	8	0	0	8	0	0
17	30979518	.	G	A	4	4	8	0	1	9	0	0
17	30980336	.	A	G	7	8	15	0	1	16	0	0
17	30986665	.	T	C	13	12	25	0	1	26	0	0
17	30986712	.	G	T	13	11	24	0	0	24	0	0
17	30992178	.	T	C	7	9	16	0	0	16	0	0
17	30995008	.	G	A	13	7	20	0	0	20	0	0
17	31014189	.	G	A	9	9	18	0	0	18	0	0
17	31014192	.	T	C	8	8	16	0	1	17	0	0
17	31021588	.	A	G	13	12	25	0	0	25	0	0
17	31058673	.	T	A	7	7	14	0	0	14	0	0
17	31058772	.	G	A	10	12	22	0	0	22	0	0
17	31058780	.	G	C	10	10	20	0	0	20	0	0
17	31058807	.	C	A	8	6	14	0	2	16	0	0
17	31195800	.	G	T	1	10	11	0	10	21	0	0
17	31195824	.	T	C	8	14	22	0	1	23	0	0
17	31198945	.	C	T	7	7	14	0	0	14	0	0
17	31199717	.	G	A	1	13	14	0	6	20	0	0
17	31200222	.	T	C	13	8	21	0	0	21	0	0
17	31200247	.	C	A	11	8	19	0	0	19	0	0
17	31200394	.	G	C	6	10	16	0	2	18	0	0
17	31200475	.	A	T	8	11	19	0	2	21	0	0
17	31200481	.	C	T	9	11	20	0	2	22	0	0
17	31200621	.	C	T	3	6	9	0	0	9	0	0
17	31201207	.	C	T	9	11	20	0	0	20	0	0
17	31201348	.	A	G	10	0	10	0	12	22	0	0
17	31201523	.	A	T	15	10	25	0	1	26	0	0
17	31201894	.	A	C	9	9	18	0	1	19	0	0
17	31201954	.	A	G	13	27	40	0	0	40	0	0
17	31205217	.	A	G	3	2	5	0	0	5	0	0
17	31205360	.	G	A	2	3	5	0	0	5	0	0
17	31205375	.	T	A	2	3	5	0	0	5	0	0
17	31205563	.	G	T	3	3	6	0	0	6	0	0
17	31205579	.	G	A	6	5	11	0	0	11	0	0
17	31205600	.	T	C	6	0	6	0	4	10	0	0
17	31205614	.	G	A	7	3	10	0	0	10	0	0
17	31205775	.	T	C	2	3	5	0	0	5	0	0
17	31205826	.	A	G	2	3	5	0	0	5	0	0
17	31205841	.	G	A	2	3	5	0	0	5	0	0
17	31205865	.	G	A	2	3	5	0	0	5	0	0
17	31210366	.	T	C	1	3	4	0	0	4	0	0
17	31212043	.	A	G	6	3	9	0	0	9	0	0
17	31212357	.	T	C	3	0	3	0	3	6	0	0
17	31214459	.	A	T	10	3	13	0	0	13	0	0
17	31214665	.	G	C	7	0	7	0	6	13	0	0
17	31217113	.	T	A	12	7	19	0	0	19	0	0
17	31219140	.	C	T	3	10	13	0	5	18	0	0
17	31219208	.	T	C	10	0	10	0	9	19	0	0
17	31222505	.	A	T	20	14	34	0	2	36	0	0
17	31228767	.	G	C	15	11	26	0	1	27	0	0
17	31228801	.	C	T	14	7	21	0	0	21	0	0
17	31228837	.	G	A	2	7	9	0	14	23	0	0
17	31228900	.	T	C	11	4	15	0	0	15	0	0
17	31277169	.	A	T	10	6	16	0	1	17	0	0
17	31277443	.	A	G	15	13	28	0	2	30	0	0
17	31277758	.	A	T	3	4	7	0	1	8	0	0
17	31277820	.	C	A	3	7	10	0	1	11	0	0
17	31277855	.	G	A	7	11	18	0	4	22	0	0
17	31277987	.	T	C	14	0	14	0	10	24	0	0
17	31278022	.	G	A	12	10	22	0	2	24	0	0
17	31278433	.	C	A	19	11	30	0	1	31	0	0
17	31283510	.	C	G	1	11	12	0	9	21	0	0
17	31286221	.	G	A	17	6	23	0	0	23	0	0
17	31297284	.	G	A	14	13	27	0	2	29	0	0
17	31297746	.	C	T	0	7	7	0	4	11	0	0
17	31297768	.	G	T	3	9	12	0	0	12	0	0
17	31297791	.	C	T	3	10	13	0	0	13	0	0
17	31298042	.	A	C	13	4	17	0	1	19	1	0
17	31298055	.	T	C	13	4	17	0	1	18	0	0
17	31298349	.	C	T	0	10	10	0	4	14	0	0
17	31307837	.	A	G	3	4	7	0	1	8	0	0
17	31307882	.	T	C	3	4	7	0	0	7	0	0
17	31346575	.	A	G	1	1	2	0	0	2	0	0
17	31346582	.	T	C	2	2	4	0	0	4	0	0
17	31346653	.	C	T	5	14	19	0	0	19	0	0
17	31346695	.	A	G	8	5	13	0	0	13	0	0
17	31346712	.	G	A	9	6	15	0	0	15	0	0
17	31346840	.	A	G	10	9	19	0	2	21	0	0
17	31347029	.	T	A	16	11	27	0	0	27	0	0
17	31347046	.	T	G	14	10	24	0	1	25	0	0
17	31347193	.	A	C	16	12	28	0	1	29	0	0
17	31347254	.	A	G	11	12	23	0	2	25	0	0
17	31347344	.	C	G	16	9	25	0	1	26	0	0
17	31355841	.	C	T	10	18	28	0	2	30	0	0
17	31357531	.	C	T	16	14	30	0	2	32	0	0
17	31360631	.	T	C	8	19	27	0	1	28	0	0
17	31360786	.	G	A	15	6	21	0	1	22	0	0
17	31360804	.	C	T	20	10	30	0	0	30	0	0
17	31360854	.	G	A	13	13	26	0	0	26	0	0
17	31376521	.	T	C	1	4	5	0	0	5	0	0
17	31376532	.	C	T	1	3	4	0	0	4	0	0
17	31376560	.	C	A	1	3	4	0	1	5	0	0
17	31385102	.	A	T	1	4	5	0	0	5	0	0
17	31385111	.	G	T	0	4	4	0	1	5	0	0
17	31392984	.	C	T	2	3	5	0	0	5	0	0
17	31393730	.	A	T	2	5	7	0	0	7	0	0
17	31393786	.	T	C	5	3	8	0	0	8	0	0
17	31393962	.	A	T	1	3	4	0	0	4	0	0
17	31401208	.	T	G	3	2	5	0	0	5	0	0
17	31426293	.	G	A	2	2	4	0	0	4	0	0
17	31535967	.	A	G	1	2	3	0	0	3	0	0
17	31545776	.	C	G	0	6	6	0	5	11	0	0
17	31545911	.	C	G	2	3	5	0	0	5	0	0
17	31545935	.	A	G	2	3	5	0	0	5	0	0
17	31546169	.	G	A	12	7	19	0	0	19	0	0
17	31548807	.	G	A	1	7	8	0	0	8	0	0
17	31554588	.	C	T	2	2	4	0	0	4	0	0
17	31561806	.	T	C	3	0	3	0	2	5	0	0
17	31565642	.	G	A	2	1	3	0	1	4	0	0
17	31579657	.	C	A	2	2	4	1	0	5	0	0
17	31587839	.	G	T	0	2	2	0	1	3	0	0
17	31587857	.	T	G	0	0	0	0	4	4	0	0
17	31589210	.	A	T	1	2	3	0	0	3	0	0
17	31589288	.	T	C	2	2	4	0	0	4	0	0
17	31589970	.	A	C	2	2	4	0	0	4	0	0
17	31590984	.	G	A	3	3	6	0	0	6	0	0
17	31590986	.	A	G	3	3	6	0	0	6	0	0
17	31606944	.	A	C	5	2	7	0	0	7	0	0
17	31611592	.	C	A	6	2	8	0	0	8	0	0
17	31611601	.	T	C	6	0	6	0	3	9	0	0
17	31611947	.	T	C	10	6	16	0	0	16	0	0
17	31612019	.	A	G	6	7	13	0	0	13	0	0
17	31612027	.	A	G	6	0	6	0	5	11	0	0
17	31616799	.	T	C	10	17	27	0	1	28	0	0
17	31618624	.	C	T	16	13	29	0	1	30	0	0
17	31618636	.	T	C	14	16	30	0	1	31	0	0
17	31618953	.	T	C	16	18	34	0	0	34	0	0
17	31618962	.	A	G	17	17	34	0	0	34	0	0
17	31621894	.	C	T	9	6	15	0	0	15	0	0
17	31621921	.	C	A	11	9	20	0	0	20	0	0
17	31622024	.	C	A	7	10	17	0	0	17	0	0
17	31622083	.	A	C	10	11	21	0	3	24	0	0
17	31622123	.	C	A	13	7	20	0	1	21	0	0
17	31622233	.	T	A	8	6	14	0	0	14	0	0
17	31622367	.	A	G	13	7	20	0	1	21	0	0
17	31622662	.	C	T	5	5	10	0	1	11	0	0
17	31622690	.	A	C	3	2	5	0	0	5	0	0
17	31623191	.	C	T	1	2	3	0	0	3	0	0
17	31623588	.	A	G	4	5	9	0	0	9	0	0
17	31623635	.	C	T	7	6	13	0	0	13	0	0
17	31623646	.	A	G	8	6	14	0	0	14	0	0
17	31623829	.	G	C	13	4	17	0	0	17	0	0
17	31624119	.	A	T	1	7	8	0	0	8	0	0
17	31624604	.	A	G	11	6	17	0	0	17	0	0
17	31624652	.	C	T	0	9	9	0	12	21	0	0
17	31624682	.	A	G	10	8	18	0	1	19	0	0
17	31624716	.	T	A	12	9	21	0	3	24	0	0
17	31628812	.	C	A	1	5	6	0	13	19	0	0
17	31628953	.	G	T	9	10	19	0	0	19	0	0
17	31632288	.	T	C	6	5	11	0	0	11	0	0
17	31632330	.	A	G	11	5	16	0	1	17	0	0
17	31632751	.	C	T	7	10	17	0	2	19	0	0
17	31633027	.	A	G	11	9	20	0	1	21	0	0
17	31633186	.	C	T	14	16	30	0	2	32	0	0
17	31639014	.	C	T	2	10	12	0	11	23	0	0
17	31639721	.	T	C	10	7	17	0	0	17	0	0
17	31697158	.	A	G	1	4	5	0	0	5	0	0
17	31699931	.	A	G	3	2	5	0	0	5	0	0
17	31700087	.	T	C	3	4	7	0	0	7	0	0
17	31704848	.	G	A	1	3	4	0	0	4	0	0
17	31704999	.	G	A	6	3	9	0	0	9	0	0
17	31711974	.	G	T	3	2	5	0	0	5	0	0
17	31718997	.	A	T	4	4	8	0	0	8	0	0
17	31721451	.	G	A	0	5	5	0	5	10	0	0
17	31739475	.	C	T	14	12	26	0	0	26	0	0
17	31743088	.	T	C	10	8	18	0	0	18	0	0
17	31743419	.	T	C	7	6	13	0	0	13	0	0
17	31744553	.	G	A	3	10	13	0	14	27	0	0
17	31745597	.	C	A	12	5	17	0	1	18	0	0
17	31746341	.	T	A	8	17	25	0	1	26	0	0
17	31746553	.	T	C	12	9	21	0	1	22	0	0
17	31746833	.	G	A	17	10	27	0	1	28	0	0
17	31795914	.	A	C	6	0	6	1	10	17	0	0
17	31795921	.	T	G	6	0	6	1	7	14	0	0
17	31796240	.	C	T	7	12	19	0	2	21	0	0
17	31796481	.	T	G	15	4	19	0	0	19	0	0
17	31796576	.	G	A	8	8	16	0	0	16	0	0
17	31796821	.	T	A	6	7	13	0	1	14	0	0
17	31805929	.	A	C	2	2	4	0	0	4	0	0
17	31806005	.	T	A	3	2	5	0	0	5	0	0
17	31806099	.	C	G	1	2	3	0	1	4	0	0
17	31806710	.	T	C	3	6	9	0	0	9	0	0
17	31806994	.	T	A	3	9	12	0	2	14	0	0
17	31807063	.	G	A	5	11	16	0	1	17	0	0
17	31807085	.	G	A	2	8	10	0	0	10	0	0
17	31812415	.	A	G	2	3	5	0	0	5	0	0
17	31816422	.	T	C	3	3	6	0	0	6	0	0
17	31820605	.	T	C	7	10	17	0	1	18	0	0
17	31935226	.	C	T	6	4	10	0	1	11	0	0
17	31935384	.	G	T	0	5	5	0	4	9	0	0
17	31935486	.	C	T	2	4	6	0	0	6	0	0
17	31935568	.	C	T	3	3	6	0	0	6	0	0
17	31935889	.	A	G	3	5	8	0	0	8	0	0
17	32305578	.	T	C	1	2	3	0	0	3	0	0
17	32315116	.	G	A	0	2	2	0	1	3	0	0
17	32332491	.	C	G	1	2	3	0	0	3	0	0
17	32334034	.	G	A	1	2	3	0	0	3	0	0
17	32366387	.	A	G	4	6	10	0	1	11	0	0
17	32366543	.	A	G	4	5	9	0	0	9	0	0
17	32367193	.	A	G	2	3	5	0	0	5	0	0
17	32367238	.	A	C	2	6	8	0	0	8	0	0
17	32500495	.	G	A	29	18	47	0	8	55	0	0
17	32503110	.	G	A	1	38	39	1	31	71	0	0
17	32516973	.	T	C	40	25	65	0	4	69	0	0
17	32524654	.	C	T	29	25	54	0	1	55	0	0
17	32524706	.	A	G	50	11	61	0	0	61	0	0
17	32524851	.	T	G	31	34	65	0	5	70	0	0
17	32532015	.	C	A	5	6	11	0	0	11	0	0
17	32532056	.	A	G	4	4	8	0	1	9	0	0
17	32532062	.	A	C	3	3	6	0	0	6	0	0
17	32532099	.	G	A	1	5	6	0	0	6	0	0
17	32535870	.	C	A	2	5	7	0	0	7	0	0
17	32536067	.	G	C	6	7	13	0	0	13	0	0
17	32538638	.	A	G	1	3	4	0	1	5	0	0
17	32542518	.	A	C	4	5	9	0	0	9	0	0
17	32542884	.	C	T	2	6	8	0	0	8	0	0
17	32547618	.	C	G	1	3	4	0	0	4	0	0
17	32549402	.	T	C	3	2	5	0	0	5	0	0
17	32549416	.	G	A	2	2	4	0	1	5	0	0
17	32549725	.	C	G	2	4	6	0	0	6	0	0
17	32623004	.	T	G	16	1	17	0	19	36	0	0
17	32623009	.	T	G	15	19	34	0	0	34	0	0
17	32624451	.	C	T	20	6	26	0	1	27	0	0
17	32624460	.	T	C	17	8	25	0	1	26	0	0
17	32624653	.	A	C	13	19	32	0	1	33	0	0
17	32624668	.	A	T	13	19	32	0	2	34	0	0
17	32624707	.	T	C	17	12	29	0	0	29	0	0
17	32624725	.	C	T	19	12	31	0	1	32	0	0
17	32624910	.	T	C	12	18	30	0	0	30	0	0
17	32624916	.	A	T	13	16	29	0	1	30	0	0
17	32631400	.	C	T	7	3	10	0	1	11	0	0
17	32631513	.	A	T	12	6	18	0	1	19	0	0
17	32631533	.	A	G	9	9	18	0	0	18	0	0
17	32631560	.	G	T	6	17	23	0	0	23	0	0
17	32631603	.	C	G	4	19	23	0	1	24	0	0
17	32634254	.	C	T	8	7	15	0	3	19	1	0
17	32636025	.	A	T	8	6	14	0	2	16	0	0
17	32636179	.	T	C	5	0	5	0	9	14	0	0
17	32659097	.	T	C	3	2	5	1	0	6	0	0
17	32659114	.	T	A	3	2	5	1	0	6	0	0
17	34969759	.	G	T	0	2	2	0	1	3	0	0
17	35248121	.	T	A	4	12	16	1	0	17	0	0
17	35249847	.	A	G	1	7	8	0	0	8	0	0
17	35589606	.	A	C	1	1	2	0	1	3	0	0
17	35589624	.	A	G	1	2	3	0	0	3	0	0
17	36867298	.	C	T	3	10	13	0	22	35	0	0
17	36867355	.	T	C	22	10	32	0	0	32	0	0
17	36867450	.	T	C	5	10	15	0	0	15	0	0
17	36867471	.	G	A	5	13	18	0	0	18	0	0
17	36867558	.	T	C	15	0	15	0	10	25	0	0
17	36867568	.	A	G	15	9	24	0	1	25	0	0
17	36867738	.	T	C	14	1	15	0	12	27	0	0
17	36867915	.	A	G	24	20	44	0	2	46	0	0
17	36867945	.	T	C	19	1	20	0	21	41	0	0
17	36867951	.	A	G	19	19	38	0	2	40	0	0
17	36872564	.	C	T	1	10	11	0	17	28	0	0
17	36884529	.	A	G	14	15	29	0	4	33	0	0
17	36896480	.	C	T	17	16	33	0	0	33	0	0
17	36899746	.	A	T	20	13	33	0	1	34	0	0
17	36899760	.	T	A	23	15	38	0	0	38	0	0
17	36899853	.	T	C	20	27	47	0	1	48	0	0
17	36905905	.	A	G	28	22	50	0	0	50	0	0
17	36905998	.	A	G	26	27	53	0	0	53	0	0
17	36906007	.	G	C	24	1	25	0	29	54	0	0
17	36909904	.	C	T	4	24	28	0	21	49	0	0
17	36911113	.	T	C	34	2	36	0	30	66	0	0
17	36914689	.	C	T	3	24	27	0	15	42	0	0
17	36915353	.	A	G	16	16	32	0	1	33	0	0
17	36929111	.	T	C	26	23	49	0	1	50	0	0
17	36929198	.	C	T	26	18	44	0	1	45	0	0
17	36937975	.	G	A	16	12	28	0	2	30	0	0
17	36938035	.	C	T	14	10	24	0	0	24	0	0
17	36938761	.	T	A	20	8	28	0	1	29	0	0
17	36938819	.	G	A	15	9	24	0	2	26	0	0
17	36938979	.	A	G	8	6	14	0	1	15	0	0
17	36939029	.	A	G	11	8	19	0	0	19	0	0
17	36939064	.	A	G	10	9	19	0	0	19	0	0
17	36939400	.	T	A	5	7	12	0	0	12	0	0
17	36939493	.	G	A	14	5	19	0	0	19	0	0
17	36939574	.	A	G	13	10	23	0	0	23	0	0
17	36939698	.	G	C	13	6	19	0	1	20	0	0
17	36939736	.	C	T	12	13	25	0	2	27	0	0
17	36939973	.	T	G	3	3	6	0	0	6	0	0
17	36940074	.	T	C	12	4	16	0	0	16	0	0
17	36940424	.	C	A	6	10	16	0	0	16	0	0
17	36940451	.	G	A	3	6	9	0	1	10	0	0
17	36940974	.	T	G	7	8	15	1	1	17	0	0
17	36940977	.	T	C	9	8	17	1	1	19	0	0
17	36941065	.	C	T	12	7	19	0	2	21	0	0
17	36941121	.	A	C	14	9	23	0	0	23	0	0
17	36941291	.	C	T	1	10	11	0	8	19	0	0
17	36941352	.	G	A	7	7	14	0	0	14	0	0
17	36941523	.	A	G	4	7	11	1	2	14	0	0
17	36941675	.	G	A	1	4	5	0	1	6	0	0
17	36941788	.	G	T	6	7	13	0	2	15	0	0
17	36941812	.	G	A	8	8	16	0	0	16	0	0
17	36947137	.	T	C	5	7	12	0	0	12	0	0
17	36947218	.	G	A	10	4	14	0	0	14	0	0
17	36951602	.	C	A	2	12	14	0	2	16	0	0
17	36956946	.	A	G	7	6	13	0	0	13	0	0
17	36956993	.	C	T	0	4	4	0	4	8	0	0
17	36957029	.	T	C	10	5	15	0	0	15	0	0
17	36962179	.	G	A	4	7	11	0	1	12	0	0
17	36970705	.	A	G	6	4	10	0	1	11	0	0
17	36970937	.	T	C	4	10	14	0	0	14	0	0
17	37013465	.	A	G	9	12	21	0	0	21	0	0
17	37070262	.	G	C	13	8	21	0	1	22	0	0
17	37070310	.	G	A	8	10	18	0	1	19	0	0
17	37070497	.	T	C	25	1	26	0	7	33	0	0
17	37070550	.	C	G	14	11	25	0	2	27	0	0
17	37073530	.	G	A	16	14	30	0	0	30	0	0
17	37076276	.	C	A	1	13	14	0	18	32	0	0
17	37086637	.	A	T	21	23	44	0	2	46	0	0
17	37086670	.	C	T	3	21	24	0	20	44	0	0
17	37088463	.	T	C	22	2	24	1	14	39	0	0
17	37088514	.	G	A	26	14	40	1	3	44	0	0
17	37134165	.	G	T	20	13	33	0	2	35	0	0
17	37143651	.	A	G	16	13	29	0	0	29	0	0
17	37143669	.	C	G	15	16	31	0	0	31	0	0
17	37156496	.	G	T	12	14	26	0	0	26	0	0
17	37156512	.	T	A	10	11	21	0	0	21	0	0
17	37162624	.	C	T	4	3	7	0	0	7	0	0
17	37162878	.	A	G	2	4	6	0	1	7	0	0
17	37162953	.	A	T	1	2	3	0	0	3	0	0
17	37163059	.	A	G	2	3	5	0	0	5	0	0
17	37163291	.	A	G	1	6	7	0	0	7	0	0
17	37163699	.	A	G	3	6	9	0	1	10	0	0
17	37163858	.	A	G	6	7	13	0	0	13	0	0
17	37164035	.	G	A	4	3	7	0	0	7	0	0
17	37164122	.	A	T	3	5	8	0	0	8	0	0
17	37164182	.	A	G	6	3	9	0	0	9	0	0
17	37164353	.	G	A	3	6	9	0	0	9	0	0
17	37164354	.	C	T	3	6	9	0	0	9	0	0
17	37164403	.	G	A	7	4	11	0	1	12	0	0
17	37164414	.	C	T	8	2	10	0	0	10	0	0
17	37165320	.	G	A	2	2	4	0	0	4	0	0
17	37165483	.	C	G	5	6	11	0	0	11	0	0
17	37165516	.	C	T	1	5	6	0	0	6	0	0
17	37165529	.	T	C	0	4	4	0	0	4	0	0
17	37165684	.	A	G	3	2	5	0	0	5	0	0
17	37165734	.	A	T	2	3	5	0	0	5	0	0
17	37172290	.	T	C	1	2	3	0	0	3	0	0
17	37183710	.	G	A	3	3	6	0	1	7	0	0
17	37194995	.	C	T	3	4	7	0	0	7	0	0
17	37195040	.	G	A	5	2	7	0	0	7	0	0
17	37204273	.	A	C	5	2	7	0	1	8	0	0
17	37204417	.	G	A	20	15	35	0	0	35	0	0
17	37204484	.	T	C	16	0	16	0	13	29	0	0
17	37210305	.	C	T	3	18	21	0	21	42	0	0
17	37212127	.	A	G	15	16	31	0	0	31	0	0
17	37212154	.	T	C	16	13	29	0	1	30	0	0
17	37212485	.	T	A	18	15	33	0	3	36	0	0
17	37212592	.	T	G	24	16	40	0	0	40	0	0
17	37212616	.	G	T	19	15	34	0	0	34	0	0
17	37212634	.	C	T	20	14	34	0	0	34	0	0
17	37212725	.	T	C	15	19	34	0	1	35	0	0
17	37212757	.	T	C	20	19	39	0	1	40	0	0
17	37212832	.	G	A	16	16	32	0	2	34	0	0
17	37213231	.	C	T	14	17	31	0	0	31	0	0
17	37213416	.	G	T	9	13	22	0	1	23	0	0
17	37213677	.	T	C	8	17	25	0	0	25	0	0
17	37213887	.	G	A	20	11	31	0	2	33	0	0
17	37213900	.	C	A	19	11	30	0	1	31	0	0
17	37213928	.	T	C	16	13	29	0	1	30	0	0
17	37213999	.	A	G	20	16	36	0	0	36	0	0
17	37214022	.	C	T	19	18	37	0	0	37	0	0
17	37220101	.	T	G	3	0	3	0	6	9	0	0
17	37220104	.	A	G	3	0	3	0	6	9	0	0
17	37220317	.	T	C	3	4	7	0	0	7	0	0
17	37220515	.	A	G	3	0	3	0	3	6	0	0
17	37220566	.	C	A	1	4	5	0	0	5	0	0
17	37220647	.	A	C	1	5	6	0	0	6	0	0
17	37228020	.	C	A	9	10	19	0	0	19	0	0
17	37230903	.	T	C	6	5	11	0	1	12	0	0
17	37230921	.	G	A	5	6	11	0	0	11	0	0
17	37230939	.	T	C	4	6	10	0	0	10	0	0
17	37231271	.	C	G	7	4	11	0	2	13	0	0
17	37234489	.	T	C	11	7	18	0	0	18	0	0
17	37237230	.	T	C	9	15	24	0	0	24	0	0
17	37239402	.	T	G	5	6	11	0	0	11	0	0
17	37239981	.	C	T	12	12	24	0	2	26	0	0
17	37240088	.	T	C	16	10	26	0	2	28	0	0
17	37241661	.	A	G	20	14	34	0	2	36	0	0
17	37241676	.	T	G	17	1	18	0	13	31	0	0
17	37241700	.	C	T	12	12	24	0	0	24	0	0
17	37252299	.	T	A	11	8	19	0	0	19	0	0
17	37252352	.	G	A	11	9	20	0	0	20	0	0
17	37252374	.	G	T	0	11	11	0	11	22	0	0
17	37252441	.	A	T	7	9	16	0	1	17	0	0
17	37252716	.	G	A	1	6	7	0	7	14	0	0
17	37253742	.	G	A	0	3	3	0	5	8	0	0
17	37253832	.	C	G	7	0	7	0	6	13	0	0
17	37254017	.	T	C	9	5	14	0	0	14	0	0
17	37263068	.	T	C	8	11	19	0	0	19	0	0
17	37263101	.	T	G	9	0	9	0	9	18	0	0
17	37263230	.	C	A	7	8	15	0	1	16	0	0
17	37267740	.	A	G	7	0	7	0	7	14	0	0
17	37268036	.	A	G	5	6	11	0	0	11	0	0
17	37268063	.	A	G	5	7	12	0	1	13	0	0
17	37273585	.	C	T	5	5	10	0	0	10	0	0
17	37277915	.	T	C	8	5	13	0	0	13	0	0
17	37277993	.	T	A	7	3	10	0	0	10	0	0
17	37280857	.	A	C	4	7	11	0	0	11	0	0
17	37280860	.	A	G	4	7	11	0	0	11	0	0
17	37280950	.	A	T	6	2	8	0	1	9	0	0
17	37280974	.	C	T	7	2	9	0	0	9	0	0
17	37281303	.	A	C	9	5	14	0	2	16	0	0
17	37281309	.	G	A	10	5	15	0	1	16	0	0
17	37291158	.	T	A	5	2	7	0	0	7	0	0
17	37291436	.	C	G	3	5	8	0	0	8	0	0
17	37291447	.	G	A	3	4	7	0	0	7	0	0
17	37291504	.	T	C	2	3	5	0	0	5	0	0
17	37311507	.	A	G	5	4	9	0	0	9	0	0
17	37316713	.	C	T	4	5	9	0	0	9	0	0
17	37316719	.	C	T	4	4	8	0	0	8	0	0
17	37316889	.	A	G	3	0	3	0	7	10	0	0
17	37317028	.	T	A	5	7	12	0	0	12	0	0
17	37317165	.	A	G	6	6	12	0	0	12	0	0
17	37317171	.	A	T	5	6	11	0	0	11	0	0
17	37317507	.	T	C	11	7	18	0	0	18	0	0
17	37317636	.	G	A	8	15	23	0	1	24	0	0
17	37317756	.	A	G	12	9	21	0	1	22	0	0
17	37317809	.	T	C	5	7	12	0	2	14	0	0
17	37317885	.	A	C	4	4	8	0	0	8	0	0
17	37317922	.	G	A	3	5	8	0	3	11	0	0
17	37317945	.	A	G	3	7	10	0	0	10	0	0
17	37318011	.	A	G	4	8	12	0	0	12	0	0
17	37320150	.	C	G	9	5	14	0	1	15	0	0
17	37320153	.	T	C	11	5	16	0	0	16	0	0
17	37323060	.	T	G	4	0	4	0	12	16	0	0
17	37323168	.	G	A	1	13	14	0	15	29	0	0
17	37323303	.	C	T	5	4	9	0	0	9	0	0
17	37323306	.	T	C	5	5	10	0	0	10	0	0
17	37350660	.	T	C	5	9	14	0	2	16	0	0
17	37350708	.	C	T	6	16	22	0	0	22	0	0
17	37352961	.	C	A	12	12	24	0	0	24	0	0
17	37353043	.	T	C	7	9	16	0	0	16	0	0
17	37360975	.	C	G	4	0	4	0	8	12	0	0
17	37361173	.	G	A	5	6	11	0	0	11	0	0
17	37361233	.	C	T	7	11	18	0	1	19	0	0
17	37361556	.	T	A	8	5	13	0	2	15	0	0
17	37361605	.	G	A	1	5	6	0	7	13	0	0
17	37362139	.	C	G	6	10	16	0	0	16	0	0
17	37362153	.	G	T	7	11	18	0	0	18	0	0
17	37362181	.	C	T	8	8	16	0	0	16	0	0
17	37362198	.	C	T	6	6	12	0	0	12	0	0
17	37362249	.	G	A	8	4	12	0	0	12	0	0
17	37362258	.	T	A	9	4	13	0	0	13	0	0
17	37362298	.	C	G	10	3	13	0	0	13	0	0
17	37362380	.	C	A	3	3	6	2	0	8	0	0
17	37362506	.	T	C	2	8	10	0	0	10	0	0
17	37362574	.	T	A	3	12	15	0	1	16	0	0
17	37362851	.	A	T	2	6	8	0	0	8	0	0
17	37362876	.	T	C	1	6	7	0	0	7	0	0
17	37363115	.	T	C	1	4	5	0	0	5	0	0
17	37363309	.	C	G	7	6	13	0	0	13	0	0
17	37363406	.	G	C	3	3	6	1	0	7	0	0
17	37363479	.	G	A	1	2	3	1	0	4	0	0
17	37363737	.	A	C	1	2	3	0	0	3	0	0
17	37363802	.	T	A	4	4	8	0	0	9	1	0
17	37363809	.	C	T	3	4	7	0	2	9	0	0
17	37363885	.	A	G	0	4	4	0	1	5	0	0
17	37363888	.	A	G	1	0	1	0	4	5	0	0
17	37363959	.	A	T	5	6	11	0	2	13	0	0
17	37364009	.	A	G	4	0	4	0	6	10	0	0
17	37364061	.	G	T	6	10	16	0	0	16	0	0
17	37364517	.	C	T	11	4	15	0	0	15	0	0
17	37364533	.	T	C	7	6	13	0	1	14	0	0
17	37364620	.	C	T	9	14	23	0	0	23	0	0
17	37364676	.	A	C	6	5	11	0	1	12	0	0
17	37365020	.	A	G	8	7	15	0	2	17	0	0
17	37385920	.	T	A	1	5	6	0	0	6	0	0
17	37386115	.	A	T	3	2	5	0	0	5	0	0
17	37388782	.	G	A	2	4	6	0	0	6	0	0
17	37446789	.	A	C	14	1	15	0	7	22	0	0
17	38887156	.	C	T	4	6	10	0	1	11	0	0
17	38887271	.	T	G	8	14	22	0	0	22	0	0
17	38927932	.	T	C	4	4	8	0	0	8	0	0
17	38928073	.	A	T	9	6	15	0	0	15	0	0
17	38928447	.	T	C	4	0	4	0	5	9	0	0
17	38928775	.	C	T	3	3	6	0	0	6	0	0
17	38928947	.	A	T	5	6	11	0	1	12	0	0
17	38929142	.	T	G	10	6	16	0	0	16	0	0
17	38929437	.	C	T	12	9	21	0	0	21	0	0
17	38941109	.	C	T	0	6	6	0	4	10	0	0
17	38941193	.	T	C	5	6	11	0	0	11	0	0
17	38941286	.	G	A	9	10	19	0	0	19	0	0
17	38946619	.	G	A	8	3	11	0	1	12	0	0
17	39184067	.	G	A	3	5	8	0	1	9	0	0
17	39184073	.	G	A	3	5	8	0	0	8	0	0
17	39184321	.	G	C	4	3	7	0	0	7	0	0
17	39184823	.	T	C	3	5	8	0	0	8	0	0
17	39697690	.	T	C	12	7	19	0	0	19	0	0
17	39703380	.	C	A	7	6	13	0	0	13	0	0
17	39707421	.	C	T	5	6	11	0	0	11	0	0
17	39717616	.	T	C	10	7	17	0	0	17	0	0
17	39717645	.	A	G	9	0	9	0	12	21	0	0
17	39720791	.	T	C	16	11	27	0	1	28	0	0
17	39728239	.	C	T	15	14	29	0	3	32	0	0
17	39728261	.	G	T	22	12	34	0	1	35	0	0
17	39728423	.	T	A	9	14	23	0	0	23	0	0
17	39729014	.	G	A	21	8	29	0	2	31	0	0
17	39732512	.	C	T	16	18	34	0	1	35	0	0
17	39732573	.	C	A	11	12	23	0	0	23	0	0
17	39732584	.	G	A	15	8	23	0	0	23	0	0
17	39736088	.	T	A	14	12	26	0	0	26	0	0
17	39736103	.	G	A	10	12	22	0	1	23	0	0
17	39736130	.	T	C	16	9	25	0	1	26	0	0
17	39748300	.	A	T	2	4	6	0	0	6	0	0
17	39842643	.	A	G	1	6	7	0	0	7	0	0
17	39862536	.	C	G	7	11	18	0	1	19	0	0
17	39863633	.	C	T	9	15	24	0	0	24	0	0
17	40223456	.	G	A	6	5	11	0	0	11	0	0
17	40223457	.	G	A	6	5	11	0	0	11	0	0
17	40397668	.	G	C	4	2	6	0	0	6	0	0
17	40860266	.	C	T	2	2	4	0	0	4	0	0
17	40879510	.	A	G	6	7	13	0	0	13	0	0
17	40879822	.	C	T	2	6	8	0	0	8	0	0
17	40879823	.	C	T	2	3	5	0	3	8	0	0
17	40880042	.	G	A	4	8	12	0	0	12	0	0
17	40883361	.	T	A	2	5	7	0	0	7	0	0
17	40883596	.	C	T	4	4	8	0	0	8	0	0
17	40884249	.	C	A	3	5	8	0	0	8	0	0
17	40887272	.	T	C	6	10	16	0	0	16	0	0
17	40887285	.	G	T	11	5	16	0	1	17	0	0
17	40888907	.	A	C	4	4	8	0	1	9	0	0
17	40888909	.	G	C	4	5	9	0	0	9	0	0
17	40889613	.	C	A	7	4	11	0	0	11	0	0
17	40889697	.	A	G	6	5	11	0	2	13	0	0
17	40890056	.	C	T	1	7	8	1	0	9	0	0
17	40890107	.	G	T	2	5	7	0	1	8	0	0
17	40890396	.	C	T	6	11	17	0	0	17	0	0
17	40890433	.	G	A	5	6	11	0	2	13	0	0
17	40890443	.	C	T	4	8	12	0	0	12	0	0
17	40893919	.	A	T	6	5	11	0	0	11	0	0
17	40899449	.	A	G	2	5	7	0	1	9	1	0
17	40899489	.	A	C	5	2	7	0	0	7	0	0
17	40899880	.	C	T	2	3	5	0	0	5	0	0
17	40900354	.	C	T	3	4	7	0	0	7	0	0
17	40900414	.	T	C	2	5	7	0	0	7	0	0
17	40900415	.	G	A	2	5	7	0	0	7	0	0
17	40900686	.	T	G	5	6	11	0	1	12	0	0
17	40901389	.	A	G	4	3	7	0	0	7	0	0
17	40901695	.	G	C	8	9	17	0	1	19	1	0
17	40901712	.	C	G	7	8	15	0	1	16	0	0
17	40901752	.	G	A	6	8	14	0	1	15	0	0
17	40901799	.	A	C	5	7	12	0	0	12	0	0
17	40901804	.	A	T	4	6	10	0	1	11	0	0
17	40902005	.	C	A	3	2	5	0	5	10	0	0
17	40902065	.	G	A	2	5	7	0	0	7	0	0
17	40902180	.	G	C	3	13	16	0	0	16	0	0
17	40902598	.	G	A	9	7	16	0	0	16	0	0
17	40902629	.	A	T	7	8	15	0	0	15	0	0
17	40902657	.	A	C	8	6	14	0	1	15	0	0
17	40902830	.	A	T	9	3	12	0	0	12	0	0
17	40932270	.	G	A	3	4	7	0	0	7	0	0
17	40932307	.	A	G	3	5	8	0	0	8	0	0
17	40955683	.	T	C	1	0	1	0	4	5	0	0
17	40955783	.	C	A	2	2	4	0	0	4	0	0
17	40990061	.	T	A	21	14	35	0	0	35	0	0
17	40990097	.	T	A	24	13	37	0	0	37	0	0
17	40999460	.	A	G	16	10	26	0	1	27	0	0
17	40999697	.	C	G	5	4	9	0	2	11	0	0
17	40999700	.	C	A	5	6	11	0	0	11	0	0
17	40999732	.	A	G	5	5	10	0	0	10	0	0
17	41084623	.	C	T	8	7	15	0	1	16	0	0
17	41084670	.	T	C	11	9	20	0	1	21	0	0
17	41092465	.	C	T	10	6	16	0	1	17	0	0
17	41121783	.	C	G	6	7	13	0	0	13	0	0
17	41220064	.	T	A	5	13	18	0	2	20	0	0
17	41254741	.	C	T	8	6	14	0	1	15	0	0
17	41264045	.	T	A	6	9	15	0	1	16	0	0
17	41264054	.	G	A	8	6	14	0	1	15	0	0
17	41264165	.	C	A	1	2	3	0	0	3	0	0
17	41314040	.	G	T	1	16	17	0	16	33	0	0
17	41314097	.	T	C	14	12	26	0	2	28	0	0
17	41314471	.	G	A	7	15	22	0	2	24	0	0
17	41314501	.	A	G	7	5	12	1	1	14	0	0
17	41317234	.	A	G	8	0	8	0	9	17	0	0
17	41317494	.	G	A	11	14	25	0	0	25	0	0
17	41317999	.	G	A	13	11	24	1	3	28	0	0
17	41318310	.	A	G	12	8	20	0	0	20	0	0
17	41318392	.	G	A	3	3	6	0	0	6	0	0
17	41464090	.	G	A	1	8	9	0	9	18	0	0
17	41465504	.	A	C	6	7	13	0	0	13	0	0
17	41475863	.	T	C	11	11	22	0	0	22	0	0
17	41476104	.	T	C	11	0	11	0	17	28	0	0
17	41476161	.	A	G	16	15	31	0	6	37	0	0
17	41476279	.	G	A	17	13	30	0	1	31	0	0
17	41476298	.	T	A	18	10	28	0	1	29	0	0
17	41476833	.	T	C	7	6	13	0	0	13	0	0
17	41476906	.	A	C	8	0	8	0	8	16	0	0
17	41476917	.	C	T	0	6	6	0	10	16	0	0
17	41476970	.	T	C	11	5	16	0	0	16	0	0
17	41476994	.	G	A	9	5	14	0	2	16	0	0
17	41477007	.	C	T	1	6	7	0	10	17	0	0
17	41477157	.	T	C	10	4	14	0	1	15	0	0
17	41477324	.	G	A	10	8	18	0	0	18	0	0
17	41488489	.	G	T	2	2	4	0	1	5	0	0
17	41558269	.	G	C	10	5	15	0	1	16	0	0
17	41571328	.	T	A	13	5	18	0	0	18	0	0
17	41583555	.	C	G	0	8	8	0	5	13	0	0
17	41583747	.	G	T	18	7	25	0	2	28	1	0
17	41583768	.	T	C	7	0	7	0	17	24	0	0
17	41583786	.	A	G	6	17	23	0	1	24	0	0
17	41592172	.	A	C	11	12	23	0	0	23	0	0
17	41601633	.	G	A	11	8	19	0	0	19	0	0
17	41601916	.	G	A	8	7	15	0	0	15	0	0
17	41602081	.	T	C	6	3	9	0	1	10	0	0
17	41610991	.	G	A	5	5	10	0	0	10	0	0
17	41630729	.	A	G	10	2	12	0	1	13	0	0
17	41630736	.	C	T	10	2	12	0	0	12	0	0
17	41631083	.	C	A	0	3	3	0	2	5	0	0
17	41635632	.	T	C	3	0	3	0	3	6	0	0
17	41635635	.	T	C	3	0	3	0	3	6	0	0
17	41639674	.	A	G	2	10	12	0	0	12	0	0
17	41639675	.	G	A	2	9	11	0	1	12	0	0
17	41659641	.	C	T	0	7	7	0	3	10	0	0
17	41666581	.	G	A	4	3	7	0	0	7	0	0
17	41667069	.	G	A	9	11	20	0	0	20	0	0
17	41667109	.	C	T	0	9	9	0	6	15	0	0
17	41669288	.	G	A	3	6	9	0	1	10	0	0
17	41669406	.	A	G	4	5	9	0	0	9	0	0
17	41673488	.	C	T	4	3	7	0	0	7	0	0
17	41673513	.	G	A	3	2	5	0	0	5	0	0
17	41675511	.	T	C	2	3	5	0	0	5	0	0
17	41685644	.	G	A	7	6	13	0	0	13	0	0
17	41992262	.	T	G	2	0	2	0	8	10	0	0
17	41994768	.	G	T	1	5	6	0	1	7	0	0
17	42027915	.	C	T	10	5	15	0	0	15	0	0
17	42030083	.	A	G	11	0	11	0	7	18	0	0
17	42032119	.	T	C	10	7	17	0	0	17	0	0
17	42096960	.	C	G	0	3	3	0	3	6	0	0
17	42566360	.	A	T	1	2	3	0	0	3	0	0
17	42871419	.	G	T	27	12	39	0	1	40	0	0
17	43013675	.	G	A	34	36	70	0	1	71	0	0
17	43017672	.	C	T	16	17	33	0	0	33	0	0
17	43017687	.	G	A	17	18	35	0	1	36	0	0
17	43017830	.	A	G	14	7	21	0	0	21	0	0
17	43017863	.	A	C	18	11	29	0	0	29	0	0
17	43018037	.	G	A	1	14	15	0	18	33	0	0
17	43018124	.	A	G	23	0	23	0	13	36	0	0
17	43018273	.	G	A	14	17	31	0	1	32	0	0
17	43018382	.	T	G	16	13	29	0	3	32	0	0
17	43018502	.	T	A	22	18	40	0	0	40	0	0
17	43018549	.	C	G	17	15	32	0	5	37	0	0
17	43018638	.	A	T	20	13	33	0	1	35	1	0
17	43018815	.	A	G	16	14	30	0	1	31	0	0
17	43018899	.	T	A	15	19	34	0	0	34	0	0
17	43030696	.	T	C	4	4	8	0	1	9	0	0
17	43030737	.	T	G	8	8	16	0	2	18	0	0
17	43030828	.	G	A	11	3	14	2	0	16	0	0
17	43031495	.	G	A	9	13	22	0	1	23	0	0
17	43033177	.	G	A	17	12	29	0	2	31	0	0
17	43035798	.	T	C	18	21	39	0	1	40	0	0
17	43035996	.	G	T	12	11	23	0	2	25	0	0
17	43036025	.	A	G	9	11	20	0	0	20	0	0
17	43036055	.	T	C	8	8	16	0	0	16	0	0
17	43040422	.	T	A	2	8	10	0	0	10	0	0
17	43075560	.	G	T	3	4	7	0	1	8	0	0
17	43075561	.	G	A	4	4	8	0	0	8	0	0
17	43077265	.	G	T	2	3	5	0	0	5	0	0
17	43077327	.	C	T	5	4	9	0	0	9	0	0
17	43082871	.	G	A	4	4	8	0	0	8	0	0
17	43082976	.	A	T	7	8	15	0	1	16	0	0
17	43087252	.	A	T	2	2	4	0	0	4	0	0
17	43104590	.	T	A	3	5	8	0	0	8	0	0
17	43146508	.	C	T	1	3	4	0	0	4	0	0
17	43158663	.	A	G	2	2	4	0	1	5	0	0
17	43158669	.	C	A	1	3	4	0	0	4	0	0
17	43169143	.	G	A	3	2	5	0	0	5	0	0
17	43171229	.	T	C	3	3	6	0	0	6	0	0
17	43220058	.	G	A	5	3	8	0	0	8	0	0
17	43286920	.	C	T	2	7	9	0	0	9	0	0
17	43287129	.	C	T	0	5	5	0	3	8	0	0
17	43297465	.	T	C	1	5	6	0	0	6	0	0
17	43297561	.	T	G	4	4	8	0	2	10	0	0
17	43297946	.	G	C	11	24	35	0	1	36	0	0
17	43298011	.	G	A	20	14	34	0	2	36	0	0
17	43298068	.	G	A	17	15	32	0	1	33	0	0
17	43302492	.	G	A	14	20	34	0	2	36	0	0
17	43309095	.	A	G	19	14	33	0	1	34	0	0
17	43309164	.	C	T	1	15	16	0	13	29	0	0
17	43315085	.	C	T	15	14	29	0	0	29	0	0
17	43348986	.	T	C	10	14	24	0	1	25	0	0
17	43391434	.	G	T	7	11	18	0	2	20	0	0
17	43391442	.	C	T	8	11	19	0	2	21	0	0
17	43436782	.	T	C	26	0	26	0	21	47	0	0
17	43437305	.	G	C	30	23	53	1	1	55	0	0
17	43437365	.	C	G	29	24	53	0	1	54	0	0
17	43439720	.	G	T	28	18	46	2	3	51	0	0
17	43441575	.	A	T	16	19	35	1	4	40	0	0
17	43453507	.	T	C	19	21	40	0	2	42	0	0
17	43453531	.	G	A	13	20	33	0	2	35	0	0
17	43456825	.	C	T	14	23	37	0	2	39	0	0
17	43456900	.	G	A	18	11	29	0	0	29	0	0
17	43456921	.	T	C	15	15	30	0	0	30	0	0
17	43461181	.	G	A	21	6	27	0	0	27	0	0
17	43469204	.	A	C	6	16	22	0	0	22	0	0
17	43469377	.	G	A	9	8	17	0	0	17	0	0
17	43473913	.	T	C	12	7	19	0	1	20	0	0
17	43475577	.	G	A	1	13	14	0	6	20	0	0
17	43475619	.	A	G	7	0	7	0	11	18	0	0
17	43475691	.	T	A	3	2	5	0	0	5	0	0
17	43476046	.	C	T	6	6	12	0	0	12	0	0
17	43476137	.	T	A	6	8	14	0	0	14	0	0
17	43491218	.	T	C	6	8	14	0	1	15	0	0
17	43497404	.	A	T	4	8	12	0	1	13	0	0
17	43513109	.	G	A	11	11	22	0	0	22	0	0
17	43516464	.	T	A	8	6	14	0	1	15	0	0
17	43516502	.	G	T	5	7	12	0	1	13	0	0
17	43516506	.	A	C	6	9	15	0	0	15	0	0
17	43516548	.	A	G	12	11	23	0	0	23	0	0
17	43516579	.	T	C	10	0	10	0	10	20	0	0
17	43520103	.	G	A	2	3	5	0	0	5	0	0
17	43520136	.	G	A	3	2	5	0	0	5	0	0
17	43520158	.	A	G	3	2	5	0	0	5	0	0
17	43529446	.	G	A	2	3	5	0	0	5	0	0
17	43537865	.	C	T	9	4	13	0	1	14	0	0
17	43538018	.	A	C	10	6	16	0	0	16	0	0
17	43538035	.	C	T	2	7	9	0	7	16	0	0
17	43538081	.	G	A	4	5	9	0	1	10	0	0
17	43538097	.	C	T	7	3	10	0	0	10	0	0
17	43538209	.	C	T	11	4	15	0	3	18	0	0
17	43547945	.	A	G	5	7	12	0	0	12	0	0
17	43551547	.	G	T	7	8	15	0	0	16	1	0
17	43551835	.	A	G	5	7	12	0	1	13	0	0
17	43551841	.	G	C	6	9	15	0	0	15	0	0
17	43558275	.	T	A	3	11	14	1	0	15	0	0
17	43565638	.	G	T	8	2	10	0	1	11	0	0
17	43565680	.	A	T	9	7	16	1	2	19	0	0
17	43565697	.	C	A	10	8	18	1	0	19	0	0
17	43575504	.	C	T	1	2	3	1	2	6	0	0
17	43575521	.	A	T	2	2	4	1	2	7	0	0
17	43575545	.	C	A	2	4	6	0	0	6	0	0
17	43575585	.	C	A	8	3	11	0	0	11	0	0
17	43575782	.	C	T	5	3	8	0	0	8	0	0
17	43575956	.	C	T	4	6	10	0	0	10	0	0
17	43576550	.	A	G	4	5	9	0	0	9	0	0
17	43576551	.	G	A	4	4	8	0	1	9	0	0
17	43576657	.	G	A	3	4	7	0	0	7	0	0
17	43584364	.	A	G	2	5	7	0	0	7	0	0
17	43594806	.	T	C	3	2	5	0	0	5	0	0
17	43611873	.	C	T	2	3	5	0	0	5	0	0
17	43612302	.	G	A	3	2	5	0	0	5	0	0
17	43623173	.	T	C	2	2	4	0	0	4	0	0
17	43623744	.	T	G	8	6	14	0	0	14	0	0
17	43623955	.	G	T	5	2	7	0	0	7	0	0
17	43629223	.	C	T	7	3	10	0	0	10	0	0
17	43629295	.	C	T	1	7	8	0	0	8	0	0
17	43629319	.	C	A	3	5	8	0	0	8	0	0
17	43629342	.	T	C	6	8	14	0	0	14	0	0
17	43629388	.	G	T	4	9	13	0	0	13	0	0
17	43629550	.	T	A	3	5	8	0	1	9	0	0
17	43629622	.	C	T	1	6	7	0	0	7	0	0
17	43629673	.	G	A	3	4	7	0	1	8	0	0
17	43629682	.	G	A	5	4	9	0	1	10	0	0
17	43660232	.	G	A	10	11	21	0	0	21	0	0
17	43660779	.	T	C	8	4	12	0	1	13	0	0
17	43661106	.	T	G	5	3	8	0	0	8	0	0
17	43663611	.	T	G	2	6	8	0	0	8	0	0
17	43663789	.	A	C	8	14	22	0	0	22	0	0
17	43663870	.	G	A	19	23	42	0	0	42	0	0
17	43664128	.	G	C	16	14	30	0	1	31	0	0
17	43664580	.	A	G	17	13	30	0	0	30	0	0
17	43664605	.	G	A	17	5	22	0	2	24	0	0
17	43708546	.	C	T	12	7	19	0	0	19	0	0
17	43708563	.	A	G	12	5	17	0	1	18	0	0
17	43708608	.	C	T	11	14	25	0	0	25	0	0
17	43708649	.	T	C	13	7	20	0	0	20	0	0
17	43711557	.	C	T	1	9	10	0	4	14	0	0
17	43715607	.	C	T	5	5	10	0	0	10	0	0
17	43715851	.	T	C	6	12	18	0	0	18	0	0
17	43716633	.	C	T	4	5	9	0	0	9	0	0
17	43716648	.	T	A	5	6	11	0	0	11	0	0
17	43717878	.	G	T	5	5	10	0	0	10	0	0
17	43851013	.	A	G	9	16	25	0	0	25	0	0
17	43853538	.	G	A	21	10	31	0	0	31	0	0
17	43853767	.	A	G	16	14	30	1	1	32	0	0
17	43853778	.	C	T	0	15	15	1	17	33	0	0
17	43854007	.	G	A	7	18	25	0	1	26	0	0
17	43854010	.	T	G	19	7	26	0	1	27	0	0
17	43856232	.	T	C	11	9	20	0	1	21	0	0
17	43859282	.	T	C	14	7	21	0	0	21	0	0
17	43863609	.	A	C	17	18	35	0	1	36	0	0
17	43863655	.	G	C	6	8	14	0	1	15	0	0
17	43863656	.	C	T	6	8	14	0	1	15	0	0
17	43879205	.	T	C	1	2	3	0	0	3	0	0
17	43883634	.	C	T	2	2	4	0	0	4	0	0
17	43919853	.	T	C	1	3	4	0	0	4	0	0
17	43926650	.	C	A	14	7	21	0	1	22	0	0
17	43946901	.	C	T	11	8	19	0	0	19	0	0
17	43951868	.	G	T	13	10	23	0	1	24	0	0
17	43952984	.	C	T	10	7	17	0	0	17	0	0
17	43953000	.	G	A	1	6	7	0	11	18	0	0
17	43954926	.	A	C	8	11	19	0	0	19	0	0
17	43987048	.	A	G	12	19	31	0	0	31	0	0
17	43990704	.	A	G	2	0	2	0	5	7	0	0
17	43996483	.	G	A	22	21	43	0	3	46	0	0
17	43996485	.	G	A	23	22	45	0	1	46	0	0
17	43996620	.	A	T	19	27	46	0	2	48	0	0
17	43996667	.	G	A	14	20	34	0	1	35	0	0
17	44001540	.	A	G	18	24	42	0	0	42	0	0
17	44001584	.	T	C	20	14	34	0	4	38	0	0
17	44002032	.	A	T	9	7	16	0	1	17	0	0
17	44006756	.	T	A	5	2	7	0	0	7	0	0
17	44007351	.	T	C	6	2	8	0	0	8	0	0
17	44030764	.	T	A	4	11	15	0	0	15	0	0
17	44030906	.	C	T	1	3	4	0	0	4	0	0
17	44030943	.	C	T	3	6	9	0	0	9	0	0
17	44046144	.	G	A	5	3	8	0	1	9	0	0
17	44413925	.	C	T	8	8	16	0	1	17	0	0
17	44413980	.	G	A	8	3	11	0	1	12	0	0
17	44414030	.	A	G	13	6	19	0	0	19	0	0
17	44420201	.	G	A	9	9	18	0	0	18	0	0
17	44420406	.	T	C	5	9	14	0	0	14	0	0
17	44420602	.	G	A	6	5	11	0	0	11	0	0
17	44422527	.	G	T	3	8	11	0	0	11	0	0
17	44422729	.	C	T	0	4	4	0	5	9	0	0
17	44425950	.	A	C	8	6	14	0	0	14	0	0
17	44430544	.	A	G	4	7	11	0	0	11	0	0
17	44430586	.	C	T	0	3	3	0	3	6	0	0
17	44441101	.	C	T	4	3	7	0	0	7	0	0
17	44443759	.	A	T	2	4	6	0	0	6	0	0
17	44443984	.	G	A	2	3	5	0	0	5	0	0
17	44444127	.	C	T	4	3	7	0	0	7	0	0
17	44444246	.	G	T	2	5	7	0	0	7	0	0
17	44444396	.	G	A	0	3	3	0	4	7	0	0
17	44453771	.	G	A	0	4	4	0	1	5	0	0
17	44463892	.	A	G	7	7	14	0	0	14	0	0
17	44463903	.	G	T	10	5	15	0	1	16	0	0
17	44473954	.	G	C	10	6	16	0	1	17	0	0
17	44474284	.	G	A	8	3	11	0	1	12	0	0
17	44474392	.	A	G	13	8	21	0	0	21	0	0
17	44474445	.	C	A	7	12	19	0	1	20	0	0
17	44474541	.	C	T	5	9	14	1	0	15	0	0
17	44474547	.	T	A	11	4	15	1	0	16	0	0
17	44474658	.	A	G	2	0	2	0	10	12	0	0
17	44475047	.	T	G	11	6	17	0	1	18	0	0
17	44475093	.	C	G	11	9	20	0	0	20	0	0
17	44475940	.	C	G	6	9	15	0	0	15	0	0
17	44476075	.	G	T	8	7	15	0	0	15	0	0
17	44502836	.	A	G	2	8	10	0	0	10	0	0
17	44542577	.	A	G	4	3	7	0	1	8	0	0
17	44542598	.	G	C	4	4	8	0	0	8	0	0
17	44542712	.	G	C	2	4	6	0	0	6	0	0
17	44584863	.	G	A	3	3	6	0	0	6	0	0
17	44756390	.	G	A	0	8	8	0	14	22	0	0
17	44756986	.	C	T	4	8	12	0	0	12	0	0
17	44758025	.	A	T	3	4	7	0	1	8	0	0
17	44758078	.	T	C	6	5	11	0	0	11	0	0
17	44760273	.	T	G	6	0	6	0	7	13	0	0
17	44760544	.	C	A	11	5	16	0	2	18	0	0
17	44760618	.	C	T	6	10	16	0	0	16	0	0
17	44760774	.	C	T	7	6	13	0	1	14	0	0
17	44760858	.	A	G	5	9	14	0	0	14	0	0
17	44761011	.	A	G	5	2	7	0	0	7	0	0
17	44761349	.	G	A	4	3	7	0	0	7	0	0
17	44761356	.	G	T	5	2	7	0	1	8	0	0
17	44761504	.	T	C	3	2	5	0	0	5	0	0
17	44761542	.	T	A	3	2	5	0	0	5	0	0
17	44768321	.	T	C	1	4	5	0	0	5	0	0
17	44768622	.	A	G	2	5	7	0	0	7	0	0
17	44768804	.	A	G	3	2	5	0	0	5	0	0
17	44769039	.	T	A	3	5	8	0	0	8	0	0
17	44769379	.	A	G	2	5	7	0	0	7	0	0
17	44770850	.	A	G	4	6	10	0	0	10	0	0
17	44771236	.	C	G	9	5	14	0	0	14	0	0
17	44771353	.	A	C	8	4	12	0	2	14	0	0
17	44775971	.	C	T	8	8	16	0	1	17	0	0
17	44776034	.	T	A	7	4	11	0	0	11	0	0
17	44833808	.	G	A	8	6	14	0	0	14	0	0
17	44833992	.	T	A	9	6	15	0	0	15	0	0
17	44848443	.	G	A	0	3	3	0	3	6	0	0
17	44857662	.	C	T	4	4	8	0	0	8	0	0
17	44862308	.	G	C	9	7	16	0	0	16	0	0
17	44865421	.	G	A	2	5	7	0	3	10	0	0
17	44870978	.	G	A	0	8	8	0	6	14	0	0
17	44871033	.	A	T	6	7	13	0	0	13	0	0
17	44873988	.	C	T	11	17	28	0	0	28	0	0
17	44878504	.	G	T	12	13	25	0	0	25	0	0
17	44884774	.	C	T	3	6	9	0	0	9	0	0
17	44884997	.	C	T	8	5	13	0	1	14	0	0
17	44899562	.	G	A	1	6	7	0	13	20	0	0
17	44911803	.	A	G	10	10	20	0	2	22	0	0
17	44921955	.	G	A	2	5	7	0	8	15	0	0
17	44921992	.	A	G	10	1	11	0	9	20	0	0
17	44922442	.	C	T	14	8	22	0	2	24	0	0
17	44922685	.	G	T	10	12	22	0	2	24	0	0
17	44922743	.	G	A	6	13	19	0	1	20	0	0
17	44922788	.	C	A	5	14	19	0	2	21	0	0
17	44922819	.	A	T	6	12	18	0	0	18	0	0
17	44922866	.	C	T	11	10	21	0	2	23	0	0
17	44923053	.	C	T	2	7	9	0	0	9	0	0
17	44923083	.	T	A	3	8	11	0	0	11	0	0
17	44923322	.	T	A	3	6	9	0	1	10	0	0
17	44923345	.	T	C	7	6	13	0	1	14	0	0
17	44923389	.	G	A	5	4	9	0	0	9	0	0
17	44923624	.	A	G	2	3	5	0	1	6	0	0
17	44923631	.	G	T	0	3	3	0	2	5	0	0
17	44962056	.	G	A	12	9	21	0	1	22	0	0
17	44962502	.	A	T	4	4	8	0	0	8	0	0
17	44962507	.	A	G	4	5	9	0	0	9	0	0
17	44962693	.	T	C	13	6	19	0	1	20	0	0
17	44962799	.	A	G	2	3	5	0	0	5	0	0
17	44967819	.	G	A	16	10	26	0	2	28	0	0
17	44968095	.	C	T	17	12	29	0	0	29	0	0
17	44980976	.	T	G	3	2	5	0	0	5	0	0
17	44981154	.	G	A	4	4	8	0	0	8	0	0
17	44981175	.	T	C	5	4	9	0	1	10	0	0
17	44981636	.	G	A	8	8	16	0	0	16	0	0
17	44981689	.	A	G	6	4	10	0	0	10	0	0
17	44981693	.	C	G	5	3	8	0	0	8	0	0
17	44998615	.	C	G	9	5	14	0	0	14	0	0
17	45002540	.	C	A	4	8	12	0	0	12	0	0
17	45002782	.	T	G	6	3	9	0	1	10	0	0
17	45002812	.	G	A	7	3	10	0	0	10	0	0
17	45004738	.	T	C	5	3	8	0	1	9	0	0
17	45004771	.	C	T	0	4	4	0	6	10	0	0
17	45004833	.	T	C	4	4	8	0	0	8	0	0
17	45007013	.	C	T	3	3	6	0	2	8	0	0
17	45007209	.	T	C	3	2	5	0	0	5	0	0
17	45010097	.	T	C	2	2	4	0	0	4	0	0
17	45010190	.	A	C	7	10	17	0	1	18	0	0
17	45010337	.	C	T	5	11	16	0	0	16	0	0
17	45010338	.	T	A	5	11	16	0	0	16	0	0
17	45018030	.	C	T	10	6	16	0	0	16	0	0
17	45018207	.	A	G	6	7	13	0	2	15	0	0
17	45026534	.	T	C	2	1	3	0	0	3	0	0
17	45026544	.	C	G	2	2	4	0	0	4	0	0
17	45028213	.	G	C	5	3	8	0	0	8	0	0
17	45028248	.	G	A	3	3	6	0	0	6	0	0
17	45030734	.	T	A	1	2	3	0	0	3	0	0
17	45030754	.	C	A	1	2	3	0	0	3	0	0
17	45073467	.	T	A	2	3	5	0	1	6	0	0
17	45073490	.	C	A	0	4	4	0	5	9	0	0
17	45076111	.	A	G	22	18	40	0	0	40	0	0
17	45082331	.	T	G	13	13	26	0	2	28	0	0
17	45082406	.	A	G	11	12	23	0	0	23	0	0
17	45082466	.	C	A	0	15	15	0	13	28	0	0
17	45085085	.	G	A	14	13	27	0	1	28	0	0
17	45085100	.	C	T	16	15	31	0	0	31	0	0
17	45093134	.	G	T	16	20	36	0	0	36	0	0
17	45093155	.	G	A	23	12	35	0	0	35	0	0
17	45099042	.	G	T	6	14	20	0	4	24	0	0
17	45099141	.	C	A	6	11	17	0	0	17	0	0
17	45104575	.	A	G	4	2	6	0	0	6	0	0
17	45138048	.	C	G	7	11	18	0	0	18	0	0
17	45138255	.	C	A	0	7	7	0	8	15	0	0
17	45138329	.	A	C	15	10	25	0	0	25	0	0
17	45138391	.	G	T	11	8	19	0	3	22	0	0
17	45138446	.	C	T	1	2	3	0	6	9	0	0
17	45138591	.	T	C	7	2	9	0	0	9	0	0
17	45139503	.	C	A	15	12	27	0	4	31	0	0
17	45139506	.	G	T	17	13	30	0	2	32	0	0
17	45139609	.	T	A	4	9	13	0	1	14	0	0
17	45139750	.	C	T	11	11	22	0	1	23	0	0
17	45139805	.	A	T	10	11	21	0	0	21	0	0
17	45139879	.	C	T	11	15	26	0	0	26	0	0
17	45139881	.	G	A	10	15	25	0	0	25	0	0
17	45140376	.	A	T	3	5	8	0	0	8	0	0
17	45145056	.	A	G	6	11	17	0	0	17	0	0
17	45145065	.	T	C	6	0	6	0	9	15	0	0
17	45145143	.	T	C	8	1	9	0	9	18	0	0
17	45148190	.	G	T	12	8	20	0	3	23	0	0
17	45148302	.	T	A	11	6	17	0	1	18	0	0
17	45148303	.	A	G	11	6	17	0	0	17	0	0
17	45216125	.	C	T	5	4	9	0	0	9	0	0
17	45216312	.	C	T	1	4	5	0	10	15	0	0
17	45216388	.	G	A	4	4	8	0	1	9	0	0
17	45216612	.	G	A	6	7	13	0	0	13	0	0
17	45232856	.	C	T	7	3	10	0	2	12	0	0
17	45232993	.	T	A	4	8	12	0	0	12	0	0
17	45233056	.	T	A	6	3	9	0	0	9	0	0
17	45233125	.	T	A	6	2	8	0	0	8	0	0
17	45233134	.	C	T	3	3	6	0	0	6	0	0
17	45234663	.	T	A	8	7	15	0	1	16	0	0
17	45234816	.	G	C	5	4	9	0	0	9	0	0
17	45235138	.	G	A	5	6	11	0	0	11	0	0
17	45235370	.	C	A	11	13	24	0	1	25	0	0
17	45235379	.	A	T	9	10	19	0	0	19	0	0
17	45238851	.	G	A	6	4	10	0	0	10	0	0
17	45247199	.	A	G	12	8	20	0	0	20	0	0
17	45254339	.	C	T	4	11	15	0	0	15	0	0
17	45259821	.	A	C	1	2	3	0	0	3	0	0
17	45259859	.	A	G	2	3	5	0	0	5	0	0
17	45295673	.	C	T	1	2	3	0	0	3	0	0
17	45297950	.	A	G	3	2	5	0	0	5	0	0
17	45302088	.	T	C	2	3	5	0	0	5	0	0
17	45302128	.	A	T	1	3	4	0	0	4	0	0
17	45348585	.	T	A	3	2	5	0	0	5	0	0
17	45348616	.	T	C	2	2	4	0	0	4	0	0
17	45348824	.	T	C	1	2	3	0	0	3	0	0
17	45349667	.	A	C	1	4	5	0	0	5	0	0
17	45350315	.	C	A	0	3	3	0	3	6	0	0
17	45357141	.	C	T	0	4	4	0	2	6	0	0
17	45362027	.	G	A	2	3	5	0	0	5	0	0
17	45362270	.	T	C	1	3	4	0	0	4	0	0
17	45362352	.	G	A	2	3	5	0	0	5	0	0
17	45362632	.	C	T	1	2	3	0	0	3	0	0
17	45363203	.	C	A	1	2	3	0	0	3	0	0
17	45363206	.	A	C	1	2	3	0	0	3	0	0
17	45364244	.	G	T	1	2	3	0	0	3	0	0
17	45365906	.	T	A	1	2	3	0	0	3	0	0
17	45366757	.	A	G	2	2	4	0	0	4	0	0
17	45366795	.	G	A	1	2	3	0	0	3	0	0
17	45379448	.	G	A	1	1	2	0	0	2	0	0
17	45379454	.	A	G	1	1	2	0	0	2	0	0
17	45379768	.	C	T	1	2	3	0	0	3	0	0
17	45386775	.	A	G	1	3	4	0	0	4	0	0
17	45401946	.	A	T	2	2	4	0	0	4	0	0
17	45401949	.	C	A	0	3	3	0	0	3	0	0
17	45402422	.	A	G	1	3	4	0	0	4	0	0
17	45455329	.	C	T	3	4	7	0	0	7	0	0
17	45455365	.	C	T	4	3	7	0	0	7	0	0
17	45455398	.	A	T	3	5	8	0	0	8	0	0
17	45472781	.	G	A	1	3	4	0	0	4	0	0
17	45479017	.	C	A	2	2	4	0	0	4	0	0
17	45532532	.	T	A	22	16	38	0	2	40	0	0
17	45532637	.	A	T	16	23	39	0	2	41	0	0
17	45646604	.	T	C	1	2	3	0	0	3	0	0
17	45732589	.	A	G	10	8	18	0	2	20	0	0
17	45732601	.	G	A	9	7	16	0	0	16	0	0
17	45732765	.	A	T	5	12	17	0	3	20	0	0
17	45732785	.	T	C	19	8	27	0	1	28	0	0
17	45732802	.	G	T	22	10	32	0	0	32	0	0
17	45733537	.	A	G	8	3	11	0	2	13	0	0
17	45733752	.	G	A	7	7	14	0	0	14	0	0
17	45734170	.	A	G	12	8	20	2	0	22	0	0
17	45744138	.	C	T	5	7	12	0	0	12	0	0
17	45748014	.	A	G	5	0	5	0	12	17	0	0
17	45748701	.	T	A	6	6	12	0	1	13	0	0
17	45751385	.	C	T	11	6	17	0	0	17	0	0
17	45756547	.	C	T	10	9	19	0	1	20	0	0
17	45759087	.	C	T	8	9	17	0	0	17	0	0
17	45762487	.	G	A	7	8	15	0	0	15	0	0
17	45765222	.	C	T	12	6	18	0	0	18	0	0
17	45774378	.	G	A	0	3	3	0	5	8	0	0
17	45774425	.	C	A	3	2	5	0	0	5	0	0
17	45774524	.	A	T	1	2	3	0	0	3	0	0
17	45987358	.	G	A	2	4	6	0	0	6	0	0
17	45987507	.	T	A	1	2	3	0	0	3	0	0
17	45987591	.	G	A	0	2	2	0	3	5	0	0
17	45987629	.	A	T	1	2	3	0	0	3	0	0
17	45987788	.	T	C	1	4	5	0	0	5	0	0
17	45988265	.	A	C	1	2	3	0	0	3	0	0
17	45988446	.	G	A	0	2	2	0	1	3	0	0
17	45988864	.	C	T	4	4	8	0	0	8	0	0
17	45989032	.	G	T	1	3	4	0	0	4	0	0
17	46387174	.	A	T	4	2	6	0	0	6	0	0
17	46387253	.	G	T	1	8	9	0	5	14	0	0
17	46387490	.	C	T	6	5	11	0	0	11	0	0
17	46387499	.	A	G	7	6	13	0	0	13	0	0
17	46457321	.	G	C	23	17	40	0	1	41	0	0
17	46457326	.	C	A	1	18	19	0	21	40	0	0
17	46852217	.	T	C	5	2	7	8	0	15	0	0
17	46852240	.	A	G	1	8	9	12	0	21	0	0
17	47117073	.	A	G	4	0	4	0	5	9	0	0
17	47134996	.	C	T	3	6	9	0	1	10	0	0
17	47135071	.	G	T	2	3	5	0	0	5	0	0
17	47137921	.	G	A	4	7	11	0	1	12	0	0
17	47137937	.	G	T	6	6	12	0	1	13	0	0
17	47162217	.	A	G	4	3	7	0	0	7	0	0
17	47169612	.	A	T	4	3	7	0	0	7	0	0
17	47169660	.	G	C	0	5	5	0	5	10	0	0
17	47175456	.	G	A	7	11	18	0	0	18	0	0
17	47175569	.	G	A	9	6	15	0	0	15	0	0
17	47188932	.	C	T	1	8	9	0	9	18	0	0
17	47188984	.	G	A	9	5	14	0	0	14	0	0
17	47189003	.	A	G	8	4	12	0	0	12	0	0
17	47189129	.	C	A	4	5	9	0	0	9	0	0
17	47189221	.	C	T	7	9	16	0	1	17	0	0
17	47189243	.	T	C	8	11	19	0	1	20	0	0
17	47189258	.	G	T	6	10	16	0	2	18	0	0
17	47189684	.	G	A	9	12	21	0	1	22	0	0
17	47189790	.	A	G	7	3	10	0	1	11	0	0
17	47189810	.	C	T	0	2	2	0	7	9	0	0
17	47189919	.	G	T	7	9	16	0	0	16	0	0
17	47189937	.	T	A	8	9	17	0	0	17	0	0
17	47190032	.	C	T	5	13	18	0	0	18	0	0
17	47190045	.	C	A	1	4	5	0	11	18	2	0
17	47190118	.	A	G	7	3	10	1	1	12	0	0
17	47190149	.	G	C	6	3	9	1	0	10	0	0
17	47190492	.	G	A	4	5	9	0	0	9	0	0
17	47190892	.	T	C	4	0	4	0	3	7	0	0
17	47190904	.	G	A	4	3	7	0	0	7	0	0
17	47190967	.	T	G	6	5	11	0	0	11	0	0
17	47191101	.	A	G	8	3	11	0	1	12	0	0
17	47191186	.	T	A	5	6	11	0	0	11	0	0
17	47191795	.	C	A	2	2	4	0	0	4	0	0
17	47191842	.	T	C	2	6	8	0	0	8	0	0
17	47191854	.	T	C	6	0	6	0	3	9	0	0
17	47191891	.	T	C	1	6	7	0	0	7	0	0
17	47192009	.	T	C	1	0	1	0	3	4	0	0
17	47192178	.	C	T	3	5	8	0	1	9	0	0
17	47192755	.	C	T	4	7	11	0	0	11	0	0
17	47193180	.	T	A	4	8	12	0	1	13	0	0
17	47193200	.	A	G	5	6	11	0	0	11	0	0
17	47193313	.	T	C	7	5	12	0	3	15	0	0
17	47193359	.	T	G	7	8	15	0	1	16	0	0
17	47193651	.	A	G	14	8	22	0	0	22	0	0
17	47193692	.	C	T	12	9	21	0	0	21	0	0
17	47193857	.	T	C	11	0	11	0	9	20	0	0
17	47193872	.	C	T	11	4	15	0	1	16	0	0
17	47193941	.	T	G	6	6	12	0	1	13	0	0
17	47193995	.	T	C	8	7	15	0	0	15	0	0
17	47196179	.	G	C	6	8	14	0	2	16	0	0
17	47196584	.	T	G	6	5	11	0	2	13	0	0
17	47196587	.	G	A	6	3	9	0	3	12	0	0
17	47219192	.	C	T	7	5	12	0	0	12	0	0
17	47220767	.	T	C	5	2	7	0	0	7	0	0
17	47220857	.	C	A	3	15	18	0	0	18	0	0
17	47220868	.	A	G	3	14	17	0	1	18	0	0
17	47232377	.	A	G	2	4	6	0	1	7	0	0
17	47240344	.	C	G	6	3	9	0	0	9	0	0
17	48736815	.	C	T	0	2	2	0	1	3	0	0
17	48736885	.	T	G	3	2	5	0	0	5	0	0
17	48740476	.	T	C	1	0	1	0	2	3	0	0
17	48740485	.	G	A	1	2	3	0	0	3	0	0
17	48831725	.	C	T	5	2	7	0	0	7	0	0
17	48850380	.	C	A	3	3	6	1	1	8	0	0
17	48854737	.	A	T	3	2	5	0	0	5	0	0
17	48862694	.	C	T	2	3	5	0	0	5	0	0
17	48867219	.	C	T	2	2	4	0	1	5	0	0
17	48867263	.	A	T	1	3	4	0	3	7	0	0
17	48867269	.	A	G	3	0	3	0	5	8	0	0
17	48867503	.	A	G	5	1	6	0	4	10	0	0
17	48867505	.	A	T	6	4	10	0	0	10	0	0
17	48883751	.	A	G	3	2	5	0	0	5	0	0
17	48906437	.	G	C	6	10	16	0	1	17	0	0
17	48908803	.	C	T	1	5	6	0	13	19	0	0
17	48911097	.	T	G	3	16	19	1	0	20	0	0
17	48915387	.	A	T	4	15	19	0	1	20	0	0
17	48928852	.	T	A	2	2	4	0	0	4	0	0
17	49003651	.	A	G	12	6	18	0	0	18	0	0
17	49006619	.	A	T	3	5	8	0	0	8	0	0
17	49008376	.	A	G	5	10	15	0	4	19	0	0
17	49010727	.	T	C	10	6	16	0	3	19	0	0
17	49011627	.	T	C	6	16	22	0	0	22	0	0
17	49014085	.	A	G	10	9	19	0	1	20	0	0
17	49014663	.	G	T	1	13	14	0	13	27	0	0
17	49018023	.	G	A	2	9	11	0	20	31	0	0
17	49018107	.	C	T	13	17	30	0	0	30	0	0
17	49018113	.	A	T	11	18	29	0	0	29	0	0
17	49018164	.	A	C	20	13	33	0	1	34	0	0
17	49018508	.	C	G	14	13	27	0	1	28	0	0
17	49018899	.	C	T	14	13	27	0	2	29	0	0
17	49018935	.	A	C	13	22	35	0	2	37	0	0
17	49019101	.	T	C	11	18	29	0	1	30	0	0
17	49019288	.	A	C	18	13	31	0	1	32	0	0
17	49019299	.	A	T	16	13	29	0	3	32	0	0
17	49019380	.	G	A	2	13	15	0	11	26	0	0
17	49096409	.	G	A	1	2	3	0	0	3	0	0
17	49096934	.	A	G	2	2	4	0	1	5	0	0
17	49105246	.	T	A	3	2	5	0	0	5	0	0
17	49137269	.	G	T	4	2	6	0	0	6	0	0
17	49137355	.	G	A	0	2	2	0	2	4	0	0
17	49199317	.	C	G	5	0	5	0	7	12	0	0
17	49208766	.	C	T	9	2	11	0	0	11	0	0
17	49208775	.	A	T	8	2	10	0	0	10	0	0
17	49212630	.	G	C	0	7	7	0	12	19	0	0
17	49217106	.	T	A	6	7	13	0	0	13	0	0
17	49217209	.	G	A	0	7	7	0	3	10	0	0
17	49217507	.	C	T	6	9	15	0	0	15	0	0
17	49217577	.	C	T	5	4	9	0	0	9	0	0
17	49217658	.	G	T	5	4	9	0	1	10	0	0
17	49217703	.	C	A	3	5	8	0	0	8	0	0
17	49217887	.	A	G	8	4	12	0	0	12	0	0
17	49281668	.	C	T	5	2	7	0	0	7	0	0
17	49288214	.	T	C	4	2	6	0	0	6	0	0
17	49304987	.	T	C	1	3	4	0	1	5	0	0
17	49304996	.	T	A	1	2	3	0	0	3	0	0
17	49315259	.	G	A	1	3	4	0	1	5	0	0
17	49377316	.	A	T	1	2	3	0	0	3	0	0
17	49416327	.	T	C	9	13	22	0	0	22	0	0
17	49416396	.	G	T	10	9	19	0	1	20	0	0
17	49418225	.	G	A	8	8	16	0	0	16	0	0
17	49418765	.	G	A	11	8	19	0	0	19	0	0
17	49418792	.	C	T	7	6	13	0	0	13	0	0
17	49418940	.	T	A	3	3	6	0	0	6	0	0
17	49419182	.	T	A	7	5	12	0	0	12	0	0
17	49419188	.	C	T	6	5	11	0	0	11	0	0
17	49419247	.	T	C	4	3	7	0	0	7	0	0
17	49419491	.	A	G	4	4	8	0	0	8	0	0
17	49419590	.	T	C	7	7	14	0	0	14	0	0
17	49419761	.	G	T	6	10	16	0	0	16	0	0
17	49419887	.	C	T	0	4	4	0	6	10	0	0
17	49419954	.	C	T	7	5	12	0	1	13	0	0
17	49420049	.	T	G	7	8	15	0	1	17	1	0
17	49420454	.	A	T	3	6	9	0	0	9	0	0
17	49420565	.	A	C	6	0	6	0	7	13	0	0
17	49420655	.	A	C	5	2	7	0	0	7	0	0
17	49420677	.	G	A	6	4	10	0	0	10	0	0
17	49420727	.	C	A	0	4	4	0	6	10	0	0
17	49420954	.	G	T	3	4	7	0	0	7	0	0
17	49421117	.	A	G	4	3	7	0	0	7	0	0
17	49425030	.	G	A	4	2	6	0	0	6	0	0
17	49425090	.	A	G	1	3	4	0	0	4	0	0
17	49429844	.	T	C	6	6	12	0	0	12	0	0
17	49481635	.	C	G	9	10	19	0	0	19	0	0
17	49481638	.	T	C	10	0	10	0	7	17	0	0
17	49485275	.	A	C	11	6	17	0	1	18	0	0
17	49503569	.	G	T	5	7	12	1	1	14	0	0
17	49503632	.	G	A	3	7	10	1	0	11	0	0
17	49503647	.	C	T	3	6	9	0	0	9	0	0
17	49503940	.	G	A	7	7	14	0	0	14	0	0
17	49504033	.	A	T	9	7	16	0	0	16	0	0
17	49507155	.	C	T	11	7	18	0	1	19	0	0
17	49509606	.	G	A	6	9	15	0	0	15	0	0
17	49518977	.	C	T	4	8	12	0	1	13	0	0
17	49519061	.	C	T	5	8	13	0	0	13	0	0
17	49519070	.	T	A	8	5	13	0	1	14	0	0
17	49522248	.	G	A	10	11	21	0	3	24	0	0
17	49526584	.	T	C	13	14	27	0	0	27	0	0
17	49526839	.	A	G	6	2	8	0	0	8	0	0
17	49526977	.	A	T	10	5	15	0	1	16	0	0
17	49527099	.	T	G	4	4	8	0	0	8	0	0
17	49527115	.	T	C	6	6	12	0	0	12	0	0
17	49527357	.	A	T	4	5	9	0	0	9	0	0
17	49528082	.	C	G	12	7	19	0	1	20	0	0
17	49631878	.	A	T	2	4	6	0	0	6	0	0
17	49631901	.	G	C	2	2	4	0	0	4	0	0
17	49632140	.	G	A	3	2	5	0	0	5	0	0
17	49632191	.	A	G	2	3	5	0	1	6	0	0
17	49632693	.	C	A	2	3	5	0	0	5	0	0
17	49632825	.	A	G	5	3	8	0	0	8	0	0
17	49636810	.	T	C	5	1	6	0	6	12	0	0
17	49641136	.	A	G	2	3	5	0	0	5	0	0
17	49641698	.	T	C	7	3	10	0	0	10	0	0
17	49785930	.	G	T	2	3	5	0	0	5	0	0
17	49786285	.	C	T	0	2	2	0	3	5	0	0
17	49786303	.	C	T	3	3	6	0	0	6	0	0
17	49983202	.	A	T	9	9	18	0	0	18	0	0
17	49983273	.	C	T	22	22	44	0	3	47	0	0
17	49983315	.	C	T	32	18	50	0	4	54	0	0
17	49992629	.	G	A	28	33	61	0	2	63	0	0
17	49998171	.	T	C	19	16	35	0	0	35	0	0
17	49998221	.	G	A	19	10	29	0	2	31	0	0
17	49998658	.	G	A	6	6	12	0	0	12	0	0
17	49998734	.	G	A	19	19	38	0	1	39	0	0
17	49998804	.	C	A	22	27	49	0	0	49	0	0
17	49999037	.	G	T	23	25	48	0	2	50	0	0
17	50002381	.	A	G	28	27	55	0	5	60	0	0
17	50007340	.	G	A	20	22	42	0	0	42	0	0
17	50009829	.	T	C	17	2	19	0	28	47	0	0
17	50009832	.	T	A	16	27	43	0	4	47	0	0
17	50010078	.	T	C	21	29	50	0	2	52	0	0
17	50010087	.	C	A	1	27	28	0	24	53	1	0
17	50082779	.	T	G	1	5	6	0	0	6	0	0
17	50097129	.	G	A	7	6	13	0	0	13	0	0
17	50097181	.	C	T	4	3	7	0	0	7	0	0
17	50097195	.	C	T	4	4	8	0	0	8	0	0
17	50099985	.	A	C	5	8	13	0	0	13	0	0
17	50100027	.	C	T	4	6	10	0	0	10	0	0
17	50101438	.	C	A	6	10	16	0	0	16	0	0
17	50107391	.	G	A	6	5	11	0	0	11	0	0
17	50107394	.	C	A	4	5	9	0	2	11	0	0
17	50110215	.	C	T	3	8	11	1	1	13	0	0
17	50110391	.	G	T	3	7	10	0	0	10	0	0
17	50110461	.	G	A	4	10	14	0	1	15	0	0
17	50110479	.	C	G	3	9	12	0	0	12	0	0
17	50110574	.	A	G	2	0	2	0	2	4	0	0
17	50110613	.	C	T	3	3	6	0	0	6	0	0
17	50110787	.	G	A	2	3	5	0	0	5	0	0
17	50110893	.	G	A	2	2	4	0	0	4	0	0
17	50111406	.	G	A	5	7	12	0	0	12	0	0
17	50111497	.	A	G	2	0	2	0	4	6	0	0
17	50111680	.	A	T	2	2	4	0	0	4	0	0
17	50111722	.	C	A	1	3	4	0	0	4	0	0
17	50112054	.	T	A	1	3	4	0	0	4	0	0
17	50113141	.	G	A	7	3	10	0	0	10	0	0
17	50113148	.	C	T	4	7	11	0	0	11	0	0
17	50113196	.	G	A	0	6	6	0	6	12	0	0
17	50113336	.	C	T	1	3	4	0	4	8	0	0
17	50113404	.	C	T	3	2	5	0	0	5	0	0
17	50141759	.	A	T	8	11	19	0	1	20	0	0
17	50141766	.	T	A	12	8	20	0	0	20	0	0
17	50141806	.	A	G	11	0	11	0	15	26	0	0
17	50141904	.	A	T	11	9	20	0	0	20	0	0
17	50172581	.	T	G	12	11	23	0	1	24	0	0
17	50176483	.	G	A	13	10	23	0	2	25	0	0
17	50176519	.	C	A	15	13	28	0	0	28	0	0
17	50180672	.	C	T	15	15	30	1	2	33	0	0
17	50185665	.	T	A	12	12	24	0	1	25	0	0
17	50185841	.	A	T	16	8	24	0	0	24	0	0
17	50185930	.	T	C	17	7	24	0	1	25	0	0
17	50185964	.	G	A	2	7	9	0	16	25	0	0
17	50186011	.	G	A	1	12	13	0	8	21	0	0
17	50186097	.	G	A	12	10	22	0	1	23	0	0
17	50186148	.	C	G	7	0	7	0	0	10	3	0
17	50219720	.	G	A	2	5	7	0	1	8	0	0
17	50229135	.	A	C	11	20	31	0	0	31	0	0
17	50229301	.	G	T	19	16	35	0	1	36	0	0
17	50229718	.	A	G	14	19	33	0	1	34	0	0
17	50245400	.	G	A	3	5	8	0	0	8	0	0
17	50245580	.	G	A	16	13	29	0	1	30	0	0
17	50245673	.	T	C	18	23	41	0	1	42	0	0
17	50245715	.	C	G	18	24	42	0	2	44	0	0
17	50245772	.	C	T	17	19	36	0	1	37	0	0
17	50247886	.	T	C	14	0	14	0	27	41	0	0
17	50272729	.	G	A	8	5	13	0	0	13	0	0
17	50275229	.	C	A	12	11	23	0	1	24	0	0
17	50278271	.	G	A	15	7	22	0	0	22	0	0
17	50278808	.	C	T	19	15	34	0	1	35	0	0
17	50278884	.	C	A	9	6	15	0	1	16	0	0
17	50284899	.	T	A	19	17	36	0	1	37	0	0
17	50285009	.	A	T	11	13	24	0	1	25	0	0
17	50285052	.	C	T	11	6	17	0	2	19	0	0
17	50285221	.	A	T	6	10	16	0	0	16	0	0
17	50285401	.	A	C	13	0	13	0	0	13	0	0
17	50391769	.	C	G	3	4	7	0	0	7	0	0
17	50391801	.	T	C	4	3	7	0	0	7	0	0
17	50404824	.	A	T	1	3	4	0	0	4	0	0
17	50405682	.	C	T	1	2	3	0	0	3	0	0
17	50415378	.	C	A	6	4	10	0	1	11	0	0
17	50415722	.	C	T	1	2	3	0	0	3	0	0
17	50415805	.	C	A	3	3	6	1	0	7	0	0
17	50415806	.	G	A	3	3	6	1	0	7	0	0
17	50415844	.	C	T	4	4	8	0	0	8	0	0
17	50415858	.	A	G	6	3	9	0	1	10	0	0
17	50415948	.	G	A	5	2	7	0	0	7	0	0
17	50416079	.	T	C	1	2	3	0	0	3	0	0
17	50416392	.	T	C	2	6	8	0	0	8	0	0
17	50416414	.	T	A	2	4	6	0	1	7	0	0
17	50416456	.	C	T	2	2	4	0	0	4	0	0
17	50416525	.	A	G	3	2	5	0	0	5	0	0
17	50416660	.	T	G	4	3	7	0	0	7	0	0
17	50416814	.	G	A	1	4	5	0	1	6	0	0
17	50417310	.	T	C	3	5	8	0	0	8	0	0
17	50417324	.	G	A	5	2	7	0	0	7	0	0
17	50417534	.	C	T	3	8	11	0	0	11	0	0
17	50417537	.	C	T	7	3	10	0	1	11	0	0
17	50424555	.	A	T	1	5	6	0	0	6	0	0
17	50424556	.	A	T	1	5	6	0	0	6	0	0
17	50424596	.	A	T	4	5	9	0	0	9	0	0
17	50424662	.	A	G	4	7	11	1	0	12	0	0
17	50424663	.	A	G	4	7	11	1	0	12	0	0
17	50424697	.	A	G	6	3	9	1	0	10	0	0
17	50425321	.	C	T	6	5	11	0	0	11	0	0
17	50425854	.	C	T	1	3	4	0	3	7	0	0
17	50425858	.	T	A	3	3	6	0	0	6	0	0
17	50426043	.	T	C	2	2	4	0	0	4	0	0
17	50426092	.	C	T	2	4	6	0	0	6	0	0
17	50426275	.	A	G	1	5	6	0	0	6	0	0
17	50426644	.	C	T	2	2	4	0	0	4	0	0
17	50426776	.	C	A	0	2	2	0	5	7	0	0
17	50430607	.	C	A	4	3	7	0	0	7	0	0
17	50430614	.	G	A	6	2	8	0	0	8	0	0
17	50436183	.	G	T	2	3	5	0	0	5	0	0
17	50449961	.	C	T	0	3	3	0	2	5	0	0
17	50450240	.	C	A	0	2	2	0	3	5	0	0
17	50461380	.	T	C	5	3	8	0	1	9	0	0
17	50461443	.	G	A	1	4	5	0	0	5	0	0
17	50461512	.	C	A	0	4	4	0	4	8	0	0
17	50461560	.	C	T	3	3	6	0	1	7	0	0
17	50461638	.	T	A	4	3	7	0	0	7	0	0
17	50656237	.	A	C	6	3	9	0	0	9	0	0
17	50656312	.	A	G	1	3	4	0	0	4	0	0
17	50656925	.	G	A	3	3	6	0	0	6	0	0
17	50657014	.	A	G	2	3	5	0	0	5	0	0
17	50657255	.	A	G	4	3	7	0	0	7	0	0
17	50657321	.	T	C	3	6	9	0	0	9	0	0
17	50657663	.	G	A	6	3	9	0	0	9	0	0
17	50657829	.	T	C	9	5	14	0	1	15	0	0
17	50664473	.	A	C	3	7	10	0	0	10	0	0
17	50679790	.	C	T	5	4	9	0	0	9	0	0
17	50679791	.	T	A	4	4	8	0	1	9	0	0
17	50682945	.	C	T	3	6	9	0	1	10	0	0
17	50688480	.	T	C	5	11	16	0	0	16	0	0
17	50689755	.	G	A	1	3	4	1	3	8	0	0
17	50689787	.	T	A	3	4	7	0	0	7	0	0
17	50689811	.	A	C	4	4	8	0	0	8	0	0
17	50689842	.	A	G	4	5	9	0	0	9	0	0
17	50772395	.	G	A	1	2	3	0	0	3	0	0
17	50772419	.	A	T	1	2	3	0	0	3	0	0
17	50785539	.	T	C	2	3	5	0	0	5	0	0
17	50833086	.	T	C	5	3	8	0	1	9	0	0
17	50839928	.	C	T	9	9	18	0	1	19	0	0
17	51206396	.	G	A	6	8	14	0	0	14	0	0
17	51206825	.	T	C	13	0	13	0	11	24	0	0
17	51206851	.	T	C	16	6	22	0	2	24	0	0
17	51206951	.	T	A	12	6	18	0	1	19	0	0
17	51207200	.	G	C	11	9	20	0	0	20	0	0
17	51209442	.	G	A	10	16	26	0	1	27	0	0
17	51213963	.	C	T	10	10	20	0	1	21	0	0
17	51214185	.	C	T	10	7	17	0	0	17	0	0
17	51214302	.	C	T	6	6	12	0	0	12	0	0
17	51218418	.	G	A	9	3	12	0	0	12	0	0
17	51224484	.	G	A	0	8	8	0	3	11	0	0
17	51226592	.	G	A	6	3	9	0	0	9	0	0
17	51226879	.	C	T	3	7	10	0	1	11	0	0
17	51228936	.	G	A	7	3	10	0	0	10	0	0
17	51229206	.	C	T	5	3	8	0	0	8	0	0
17	51229413	.	T	C	1	2	3	0	0	3	0	0
17	51231538	.	T	C	9	6	15	0	1	16	0	0
17	51231629	.	T	C	5	7	12	0	2	14	0	0
17	51231633	.	T	C	8	5	13	0	0	13	0	0
17	51231706	.	G	A	2	3	5	0	0	5	0	0
17	51231756	.	T	C	3	2	5	0	0	5	0	0
17	51231818	.	T	C	3	2	5	0	0	5	0	0
17	51231980	.	T	C	4	9	13	0	0	13	0	0
17	51232329	.	C	T	4	3	7	0	1	8	0	0
17	51232360	.	C	A	2	3	5	0	0	5	0	0
17	51232547	.	T	C	5	5	10	0	0	10	0	0
17	51232759	.	C	T	0	17	17	0	19	36	0	0
17	51234540	.	A	C	5	1	6	1	11	18	0	0
17	51241185	.	G	A	8	7	15	0	2	17	0	0
17	51241203	.	C	T	7	4	11	0	2	13	0	0
17	51253952	.	A	G	12	10	22	0	0	22	0	0
17	51256927	.	C	T	2	8	10	0	7	17	0	0
17	51256933	.	C	G	8	8	16	0	1	17	0	0
17	51257013	.	A	G	8	11	19	0	1	20	0	0
17	51260362	.	G	C	7	6	13	0	2	15	0	0
17	51303112	.	C	T	11	9	20	0	1	21	0	0
17	51303130	.	G	A	0	12	12	0	11	23	0	0
17	51303241	.	G	A	14	14	28	0	1	29	0	0
17	51305422	.	A	T	6	11	17	0	1	19	1	0
17	51305458	.	G	C	8	7	15	0	2	17	0	0
17	51307706	.	G	A	7	9	16	0	0	16	0	0
17	51313948	.	C	T	1	4	5	0	0	5	0	0
17	51313994	.	C	T	1	3	4	0	0	4	0	0
17	51314002	.	G	C	1	1	2	0	1	3	0	0
17	51682501	.	T	A	3	2	5	0	0	5	0	0
17	51690559	.	T	C	3	4	7	0	0	7	0	0
17	51690562	.	A	G	3	0	3	0	4	7	0	0
17	51693914	.	T	G	4	3	7	0	0	7	0	0
17	51708541	.	G	A	1	2	3	0	4	7	0	0
17	51711040	.	A	G	5	6	11	0	0	11	0	0
17	51711184	.	C	A	6	7	13	0	0	13	0	0
17	51711194	.	C	A	8	5	13	0	0	13	0	0
17	51711268	.	G	A	1	2	3	0	6	9	0	0
17	51720064	.	G	C	2	2	4	0	0	4	0	0
17	51720421	.	A	G	2	3	5	0	0	5	0	0
17	51720445	.	A	G	1	4	5	0	0	5	0	0
17	51720615	.	T	C	1	4	5	0	0	5	0	0
17	51743916	.	A	G	3	5	8	0	1	9	0	0
17	51749051	.	G	T	7	8	15	0	0	15	0	0
17	51749545	.	G	T	1	10	11	0	8	19	0	0
17	51752790	.	A	G	7	7	14	0	2	16	0	0
17	51753138	.	T	G	12	15	27	0	1	28	0	0
17	51757010	.	G	A	17	15	32	0	2	34	0	0
17	51757380	.	T	G	4	7	11	0	0	11	0	0
17	51757387	.	A	T	3	6	9	0	0	9	0	0
17	51777099	.	C	T	3	2	5	0	0	5	0	0
17	51780881	.	T	A	3	2	5	0	0	5	0	0
17	51780896	.	C	G	3	3	6	0	0	6	0	0
17	51784141	.	G	A	1	1	2	0	1	3	0	0
17	51784216	.	A	G	5	2	7	0	0	7	0	0
17	51788735	.	C	T	2	2	4	0	0	4	0	0
17	51788754	.	G	A	0	3	3	0	3	6	0	0
17	51788772	.	T	G	3	5	8	0	0	8	0	0
17	51788933	.	A	G	3	8	11	0	0	11	0	0
17	51789032	.	G	A	4	2	6	0	0	6	0	0
17	51789038	.	T	C	4	2	6	0	0	6	0	0
17	51789069	.	T	C	6	1	7	0	1	8	0	0
17	51789079	.	T	G	3	0	3	0	4	8	1	0
17	51789314	.	T	A	2	2	4	0	2	6	0	0
17	51789426	.	G	T	5	3	8	0	2	10	0	0
17	51796888	.	G	A	2	6	8	0	0	8	0	0
17	51797145	.	A	G	3	3	6	0	0	6	0	0
17	51797223	.	G	A	3	3	6	0	0	6	0	0
17	51797333	.	A	G	6	3	9	0	0	9	0	0
17	51797782	.	C	T	8	13	21	0	1	22	0	0
17	51797788	.	T	A	7	10	17	0	5	22	0	0
17	51797863	.	G	A	13	5	18	0	1	19	0	0
17	51804037	.	G	A	5	3	8	0	1	9	0	0
17	51805764	.	T	G	8	4	12	0	0	12	0	0
17	51805976	.	G	A	4	5	9	0	0	9	0	0
17	51806043	.	C	T	1	3	4	0	5	9	0	0
17	51807494	.	G	A	6	3	9	0	0	9	0	0
17	51807539	.	T	A	6	4	10	0	0	10	0	0
17	51807545	.	G	A	7	3	10	0	1	11	0	0
17	51808019	.	A	C	5	3	8	0	0	8	0	0
17	51815206	.	C	G	3	7	10	0	0	10	0	0
17	51823012	.	G	C	8	0	8	0	6	14	0	0
17	51823040	.	T	C	6	0	6	0	6	12	0	0
17	51823068	.	T	C	9	6	15	0	0	15	0	0
17	51823152	.	A	G	8	9	17	0	0	17	0	0
17	51823568	.	G	A	18	7	25	1	2	28	0	0
17	51823617	.	G	T	18	5	23	0	1	24	0	0
17	51823989	.	G	T	16	4	20	1	0	21	0	0
17	51824046	.	C	T	14	6	20	0	0	20	0	0
17	51824306	.	T	C	7	7	14	1	0	15	0	0
17	51824318	.	A	T	6	3	9	1	1	11	0	0
17	51824510	.	T	C	3	3	6	0	1	7	0	0
17	51824790	.	T	C	5	7	12	0	0	12	0	0
17	51824792	.	T	C	9	4	13	0	0	13	0	0
17	51825138	.	C	T	0	15	15	0	9	24	0	0
17	51825161	.	T	C	5	10	15	0	0	15	0	0
17	51825205	.	T	G	6	8	14	0	1	15	0	0
17	51825225	.	T	C	8	7	15	0	1	16	0	0
17	51825421	.	T	G	6	10	16	0	1	17	0	0
17	51825455	.	A	G	8	13	21	0	1	22	0	0
17	51825576	.	A	C	12	0	12	0	11	23	0	0
17	51825813	.	T	A	13	10	23	0	0	23	0	0
17	51825969	.	A	T	15	9	24	0	2	26	0	0
17	51826025	.	G	T	9	7	16	0	3	19	0	0
17	51826035	.	C	T	13	7	20	0	2	22	0	0
17	51826062	.	G	T	12	9	21	0	5	26	0	0
17	51826088	.	A	G	11	13	24	0	2	26	0	0
17	51826149	.	A	C	15	0	15	0	13	28	0	0
17	51826172	.	T	C	13	0	13	1	13	27	0	0
17	51826236	.	T	C	10	16	26	1	0	27	0	0
17	51832999	.	G	A	9	4	13	0	0	13	0	0
17	52036863	.	G	A	2	1	3	0	1	4	0	0
17	52059149	.	T	C	1	0	1	0	4	5	0	0
17	52063114	.	G	T	2	3	5	0	0	5	0	0
17	52063172	.	T	C	2	4	6	0	0	6	0	0
17	52070251	.	T	A	1	3	4	0	0	4	0	0
17	52359040	.	G	T	0	2	2	0	1	3	0	0
17	52385529	.	A	G	1	5	6	0	0	6	0	0
17	52385779	.	C	T	3	3	6	0	0	6	0	0
17	52632185	.	T	C	2	12	14	0	0	14	0	0
17	52840328	.	A	C	32	26	58	0	1	59	0	0
17	52856614	.	T	C	32	21	53	0	3	56	0	0
17	52919954	.	C	T	22	34	56	0	2	58	0	0
17	52920291	.	A	T	15	22	37	0	2	39	0	0
17	52920588	.	A	G	20	0	20	0	20	40	0	0
17	52940864	.	C	T	1	5	6	0	5	11	0	0
17	52940880	.	T	C	7	2	9	0	0	9	0	0
17	52941467	.	G	A	2	3	5	0	0	5	0	0
17	53364109	.	T	C	1	6	7	0	1	8	0	0
17	53364111	.	T	C	1	7	8	0	0	8	0	0
18	1689	.	A	C	16	10	26	0	0	26	0	0
18	1983	.	T	C	9	5	14	0	1	15	0	0
18	2725	.	G	A	18	6	24	0	1	25	0	0
18	11295	.	A	G	9	5	14	0	2	16	0	0
18	17639	.	G	A	11	12	23	0	2	25	0	0
18	17786	.	G	A	21	8	29	0	1	30	0	0
18	17795	.	G	A	21	8	29	0	0	29	0	0
18	18606	.	T	A	16	9	25	1	1	27	0	0
18	18731	.	A	G	11	11	22	0	2	24	0	0
18	22746	.	A	G	15	9	24	0	0	24	0	0
18	22891	.	G	A	18	8	26	0	0	26	0	0
18	54600	.	C	T	2	8	10	0	1	11	0	0
18	55219	.	C	A	2	4	6	0	0	6	0	0
18	58631	.	C	T	2	2	4	0	0	4	0	0
18	73510	.	G	T	1	2	3	0	0	3	0	0
18	73543	.	T	A	5	2	7	0	0	7	0	0
18	73714	.	C	G	8	6	14	0	1	15	0	0
18	73740	.	A	C	9	1	10	0	5	15	0	0
18	74788	.	C	T	1	3	4	0	12	16	0	0
18	74866	.	C	T	9	7	16	0	3	19	0	0
18	74994	.	A	G	4	5	9	0	0	9	0	0
18	82705	.	C	T	6	7	13	0	2	15	0	0
18	97588	.	C	T	11	9	20	0	1	21	0	0
18	97762	.	G	A	4	4	8	0	1	9	0	0
18	97789	.	C	T	5	12	17	0	0	17	0	0
18	98622	.	G	A	9	13	22	0	0	22	0	0
18	100483	.	A	G	9	1	10	1	24	35	0	0
18	100944	.	G	A	1	17	18	0	20	38	0	0
18	102350	.	T	G	13	0	13	0	19	32	0	0
18	102353	.	A	G	13	18	31	0	1	32	0	0
18	103101	.	G	C	0	9	9	0	8	17	0	0
18	104405	.	G	A	0	9	9	0	18	27	0	0
18	106814	.	T	C	8	11	19	0	0	19	0	0
18	107015	.	T	C	15	10	25	0	1	26	0	0
18	107135	.	A	T	8	25	33	0	0	33	0	0
18	107345	.	A	G	19	0	19	0	25	44	0	0
18	114089	.	A	C	8	12	20	0	1	21	0	0
18	114425	.	C	T	3	2	5	0	0	5	0	0
18	114713	.	A	T	11	13	24	0	2	27	1	0
18	117788	.	G	A	10	18	28	0	3	31	0	0
18	118729	.	G	A	9	14	23	0	0	23	0	0
18	118912	.	G	A	9	8	17	0	0	17	0	0
18	123917	.	T	C	9	9	18	0	0	18	0	0
18	127438	.	G	A	7	4	11	0	0	11	0	0
18	127444	.	A	G	5	4	9	0	0	9	0	0
18	127513	.	A	G	1	3	4	0	0	4	0	0
18	127678	.	A	G	2	3	5	0	0	5	0	0
18	130779	.	T	A	8	8	16	0	0	16	0	0
18	131065	.	T	C	7	0	7	0	4	11	0	0
18	131092	.	C	T	0	3	3	0	8	11	0	0
18	132605	.	A	G	2	2	4	0	0	4	0	0
18	135852	.	T	A	5	6	11	0	1	12	0	0
18	137781	.	A	G	4	2	6	0	0	6	0	0
18	144447	.	G	A	7	7	14	0	2	16	0	0
18	146940	.	C	A	9	5	14	0	0	14	0	0
18	148197	.	A	G	7	6	13	0	0	13	0	0
18	148200	.	A	G	8	6	14	0	0	14	0	0
18	173660	.	C	T	14	11	25	0	2	27	0	0
18	173694	.	C	T	11	11	22	0	1	23	0	0
18	173903	.	C	A	12	17	29	0	0	29	0	0
18	184917	.	T	C	14	12	26	0	1	27	0	0
18	193689	.	A	C	12	14	26	0	0	26	0	0
18	193982	.	C	T	13	10	23	0	0	23	0	0
18	194006	.	A	G	12	0	12	0	12	24	0	0
18	194078	.	C	T	15	15	30	0	2	32	0	0
18	194162	.	G	C	1	16	17	0	25	42	0	0
18	194318	.	A	G	11	7	18	0	1	20	1	0
18	194460	.	C	G	4	7	11	0	0	11	0	0
18	194464	.	C	T	3	8	11	0	0	11	0	0
18	194799	.	T	C	5	2	7	0	1	8	0	0
18	204678	.	A	C	6	2	8	0	0	8	0	0
18	204742	.	G	A	13	10	23	0	0	23	0	0
18	204828	.	G	A	13	20	33	0	0	33	0	0
18	204866	.	T	A	9	23	32	0	7	39	0	0
18	204980	.	C	T	16	16	32	0	2	34	0	0
18	204982	.	G	A	17	17	34	0	0	34	0	0
18	205095	.	C	T	2	30	32	0	12	44	0	0
18	205105	.	A	G	15	28	43	0	0	43	0	0
18	205152	.	G	A	30	15	45	0	1	46	0	0
18	205179	.	G	A	21	24	45	0	2	47	0	0
18	207172	.	T	C	18	13	31	0	0	31	0	0
18	207184	.	G	A	17	15	32	0	2	34	0	0
18	207314	.	T	A	11	10	21	0	0	21	0	0
18	209114	.	G	A	11	16	27	0	1	28	0	0
18	209118	.	A	G	13	18	31	0	0	31	0	0
18	209321	.	T	G	12	19	31	0	0	31	0	0
18	209382	.	A	G	16	14	30	0	2	32	0	0
18	210385	.	T	A	24	20	44	0	3	47	0	0
18	210899	.	T	A	1	4	5	0	0	5	0	0
18	211101	.	G	A	14	6	20	0	0	20	0	0
18	211186	.	T	A	20	15	35	0	2	37	0	0
18	211304	.	T	C	17	1	18	0	12	30	0	0
18	211346	.	C	T	2	5	7	0	15	22	0	0
18	211380	.	G	A	21	9	30	0	0	30	0	0
18	211399	.	T	C	25	8	33	0	1	34	0	0
18	211438	.	T	A	19	8	27	0	0	27	0	0
18	211469	.	C	A	24	7	31	0	0	31	0	0
18	211483	.	A	T	26	5	31	0	1	32	0	0
18	211605	.	A	G	8	14	22	0	0	22	0	0
18	211610	.	T	C	7	0	7	0	15	22	0	0
18	211812	.	T	A	9	7	16	0	1	17	0	0
18	212305	.	A	G	27	21	48	0	0	48	0	0
18	214688	.	A	G	14	17	31	0	0	31	0	0
18	214717	.	T	C	18	18	36	0	0	36	0	0
18	216775	.	G	A	13	12	25	0	1	26	0	0
18	216779	.	G	A	12	14	26	0	1	27	0	0
18	220144	.	G	A	19	13	32	0	2	34	0	0
18	222448	.	T	C	14	0	14	0	16	30	0	0
18	334275	.	C	T	1	5	6	0	0	6	0	0
18	334298	.	T	C	4	3	7	0	1	8	0	0
18	334361	.	T	C	8	2	10	0	1	11	0	0
18	334649	.	T	C	11	3	14	0	0	14	0	0
18	334983	.	A	C	6	2	8	0	0	8	0	0
18	336586	.	T	C	13	12	25	1	2	28	0	0
18	493387	.	C	T	4	3	7	0	1	8	0	0
18	494247	.	G	A	3	2	5	0	0	5	0	0
18	494554	.	G	T	2	1	3	0	1	4	0	0
18	507687	.	G	A	0	5	5	0	3	8	0	0
18	573798	.	C	T	4	3	7	0	0	7	0	0
18	577515	.	G	A	0	6	6	0	10	16	0	0
18	580961	.	G	A	0	5	5	0	6	11	0	0
18	581075	.	G	A	1	4	5	0	5	10	0	0
18	586067	.	A	G	4	0	4	0	4	8	0	0
18	600337	.	C	T	5	3	8	0	1	9	0	0
18	609280	.	G	A	1	5	6	0	0	6	0	0
18	609399	.	A	G	4	3	7	0	0	7	0	0
18	609877	.	G	A	12	6	18	0	0	18	0	0
18	609935	.	G	A	3	10	13	0	11	24	0	0
18	610126	.	A	T	9	5	14	0	1	15	0	0
18	610148	.	A	T	9	5	14	0	0	14	0	0
18	610184	.	G	T	6	3	9	0	1	10	0	0
18	610187	.	G	T	5	5	10	0	0	10	0	0
18	610291	.	T	C	5	3	8	0	0	8	0	0
18	610631	.	T	A	5	4	9	0	0	9	0	0
18	642918	.	T	C	19	9	28	1	1	30	0	0
18	643164	.	C	T	16	9	25	0	1	26	0	0
18	643517	.	C	T	18	15	33	0	0	33	0	0
18	660616	.	A	G	4	4	8	0	0	8	0	0
18	660846	.	C	A	6	2	8	0	0	8	0	0
18	789974	.	T	A	17	10	27	0	1	28	0	0
18	790247	.	T	C	9	15	24	0	2	26	0	0
18	790301	.	T	A	12	16	28	0	2	30	0	0
18	790451	.	T	G	13	2	15	0	19	34	0	0
18	790962	.	T	G	10	10	20	0	4	24	0	0
18	791069	.	A	G	10	0	10	0	7	17	0	0
18	791076	.	G	C	11	7	18	0	0	18	0	0
18	791137	.	T	A	13	9	22	0	1	23	0	0
18	791171	.	G	C	11	7	18	0	0	18	0	0
18	791246	.	G	A	12	9	21	0	0	21	0	0
18	791348	.	T	A	4	8	12	0	0	12	0	0
18	791350	.	T	A	3	8	11	0	0	11	0	0
18	791449	.	T	G	4	5	9	0	0	9	0	0
18	809012	.	G	T	23	18	41	0	0	41	0	0
18	824270	.	T	C	1	2	3	0	0	3	0	0
18	824994	.	G	A	1	3	4	0	0	4	0	0
18	824998	.	C	T	1	4	5	0	0	5	0	0
18	825078	.	A	T	4	4	8	0	0	8	0	0
18	825420	.	G	A	2	4	6	0	0	6	0	0
18	826116	.	G	A	3	3	6	0	0	6	0	0
18	826190	.	A	T	3	8	11	0	0	11	0	0
18	826574	.	C	T	2	3	5	0	0	5	0	0
18	827232	.	G	A	1	2	3	0	0	3	0	0
18	888440	.	G	A	17	10	27	0	1	28	0	0
18	891534	.	C	A	14	6	20	2	1	23	0	0
18	891586	.	G	A	17	13	30	2	3	35	0	0
18	911036	.	C	A	10	9	19	0	0	19	0	0
18	911076	.	A	G	27	1	28	0	22	50	0	0
18	925088	.	C	T	40	29	69	0	5	74	0	0
18	925100	.	A	C	43	22	65	0	6	71	0	0
18	933299	.	G	A	39	33	72	0	4	76	0	0
18	936728	.	C	T	47	32	79	0	0	79	0	0
18	939430	.	C	T	25	39	64	0	3	67	0	0
18	951004	.	A	T	32	41	73	1	0	74	0	0
18	951005	.	T	C	32	39	71	1	2	74	0	0
18	955705	.	A	G	1	3	4	0	0	4	0	0
18	964525	.	G	A	1	3	4	0	0	4	0	0
18	1005687	.	T	A	1	4	5	0	0	5	0	0
18	1005703	.	A	T	1	2	3	0	0	3	0	0
18	1151536	.	C	A	2	2	4	0	0	4	0	0
18	1158399	.	G	A	1	3	4	0	1	5	0	0
18	1158437	.	T	C	1	2	3	0	0	3	0	0
18	1161085	.	A	G	7	10	17	0	1	18	0	0
18	1161750	.	A	G	36	22	58	0	5	63	0	0
18	1173819	.	G	A	21	31	52	0	1	53	0	0
18	1173856	.	G	A	22	32	54	0	0	54	0	0
18	1173898	.	A	G	26	26	52	0	2	54	0	0
18	1249955	.	T	A	2	2	4	0	0	4	0	0
18	1250869	.	G	A	1	1	2	0	1	3	0	0
18	1292040	.	C	G	4	2	6	0	1	7	0	0
18	1292100	.	C	T	0	8	8	0	5	13	0	0
18	1292164	.	G	A	10	6	16	0	0	16	0	0
18	1292668	.	T	C	9	0	9	0	13	22	0	0
18	1293182	.	G	A	7	11	18	0	0	18	0	0
18	1363189	.	G	A	3	3	6	0	1	7	0	0
18	1391653	.	A	G	5	4	9	0	1	10	0	0
18	1391674	.	T	C	5	0	5	0	5	10	0	0
18	2173451	.	T	C	2	2	4	0	0	4	0	0
18	2190731	.	G	A	0	7	7	0	6	13	0	0
18	2197638	.	A	C	13	8	21	0	1	22	0	0
18	2204386	.	T	C	1	3	4	0	0	4	0	0
18	2205302	.	T	A	4	3	7	0	0	7	0	0
18	2208642	.	A	C	6	2	8	0	1	9	0	0
18	2210570	.	C	T	7	7	14	0	0	14	0	0
18	2211091	.	T	C	11	5	16	0	1	17	0	0
18	2215557	.	C	T	5	2	7	0	0	7	0	0
18	2219142	.	C	A	2	2	4	0	0	4	0	0
18	2225632	.	C	T	10	15	25	2	0	27	0	0
18	2225661	.	C	T	11	14	25	2	2	29	0	0
18	2377645	.	T	C	11	0	11	0	8	19	0	0
18	2377860	.	G	A	13	5	18	0	2	20	0	0
18	2378273	.	T	C	1	3	4	4	0	8	0	0
18	2378495	.	T	A	6	7	13	0	1	14	0	0
18	2378510	.	C	A	3	6	9	0	1	10	0	0
18	2378619	.	T	G	8	6	14	0	0	14	0	0
18	2378625	.	G	T	8	4	12	0	1	13	0	0
18	2378687	.	A	C	8	9	17	0	0	17	0	0
18	2378713	.	T	G	8	5	13	0	2	15	0	0
18	2378722	.	C	T	0	9	9	0	7	16	0	0
18	2379073	.	G	A	2	4	6	0	1	7	0	0
18	2408681	.	C	A	10	7	17	0	0	17	0	0
18	2408886	.	G	A	4	13	17	0	0	17	0	0
18	2412660	.	T	C	6	13	19	0	1	20	0	0
18	2412726	.	G	C	17	6	23	0	0	23	0	0
18	2441690	.	T	C	4	5	9	0	0	9	0	0
18	2443977	.	A	T	3	3	6	0	0	7	1	0
18	2443998	.	C	T	4	2	6	0	0	6	0	0
18	2533358	.	T	C	5	2	7	0	0	7	0	0
18	2533391	.	C	A	7	4	11	0	0	11	0	0
18	2548878	.	G	A	9	4	13	0	1	14	0	0
18	2603485	.	C	A	1	2	3	0	0	3	0	0
18	2603521	.	T	C	1	3	4	0	0	4	0	0
18	2603522	.	T	C	2	3	5	0	0	5	0	0
18	2603576	.	T	G	6	6	12	0	0	12	0	0
18	2603786	.	A	G	2	8	10	0	0	10	0	0
18	2612259	.	A	G	5	7	12	0	0	12	0	0
18	2612293	.	A	G	9	3	12	0	0	12	0	0
18	2619228	.	A	G	4	6	10	0	1	11	0	0
18	2629229	.	T	C	7	1	8	0	7	15	0	0
18	2629272	.	G	C	9	3	12	0	0	12	0	0
18	2629347	.	A	G	5	5	10	0	0	10	0	0
18	2629415	.	C	T	6	2	8	0	0	8	0	0
18	2631290	.	A	G	5	5	10	0	0	10	0	0
18	2634309	.	T	G	6	7	13	0	1	14	0	0
18	2668603	.	G	A	4	7	11	0	0	11	0	0
18	2681965	.	G	A	4	6	10	0	0	10	0	0
18	2682182	.	C	T	0	12	12	0	11	23	0	0
18	2682203	.	A	T	10	10	20	0	1	21	0	0
18	2682610	.	T	C	8	10	18	0	1	19	0	0
18	2682683	.	C	T	14	13	27	0	2	29	0	0
18	2682700	.	T	C	17	8	25	1	0	26	0	0
18	2682982	.	T	C	3	4	7	1	0	8	0	0
18	2683322	.	T	G	7	6	13	0	1	14	0	0
18	2683365	.	G	T	2	5	7	0	2	9	0	0
18	2683985	.	T	C	2	4	6	0	0	6	0	0
18	2684456	.	T	C	2	5	7	0	0	7	0	0
18	2684458	.	A	G	2	5	7	0	0	7	0	0
18	2684731	.	A	C	2	4	6	0	0	6	0	0
18	2684750	.	G	A	2	1	3	0	0	3	0	0
18	2684872	.	A	G	7	12	19	0	3	22	0	0
18	2684889	.	A	T	10	11	21	0	2	23	0	0
18	2685138	.	C	T	0	6	6	0	7	13	0	0
18	2685162	.	T	C	13	0	13	0	8	21	0	0
18	2685263	.	A	G	16	16	32	0	0	32	0	0
18	2685297	.	A	G	12	16	28	0	0	28	0	0
18	2685312	.	G	A	11	12	23	0	1	24	0	0
18	2685348	.	C	T	0	6	6	0	9	15	0	0
18	2687992	.	C	T	11	8	19	0	0	19	0	0
18	2692381	.	A	C	12	8	20	0	0	20	0	0
18	2702458	.	G	A	12	12	24	0	0	24	0	0
18	2702524	.	C	T	10	12	22	0	2	24	0	0
18	2702536	.	A	G	10	10	20	0	3	23	0	0
18	2702569	.	C	T	2	12	14	0	10	24	0	0
18	2702888	.	T	C	16	0	16	0	10	26	0	0
18	2702976	.	A	C	13	6	19	0	1	20	0	0
18	2703120	.	A	G	8	6	14	1	0	15	0	0
18	2707108	.	G	A	7	11	18	0	0	18	0	0
18	2708467	.	G	A	7	7	14	0	0	14	0	0
18	2708505	.	C	T	6	7	13	0	0	13	0	0
18	2709356	.	T	C	7	10	17	0	0	17	0	0
18	2709395	.	G	A	3	11	14	0	1	15	0	0
18	2710216	.	A	G	3	8	11	0	0	11	0	0
18	2710231	.	T	C	1	0	1	0	9	10	0	0
18	2711894	.	C	G	1	10	11	0	8	19	0	0
18	2713199	.	C	T	13	10	23	1	0	24	0	0
18	2721518	.	T	C	8	3	11	0	1	12	0	0
18	2721565	.	A	G	6	11	17	0	0	17	0	0
18	2727714	.	G	A	6	6	12	0	0	12	0	0
18	2902985	.	A	G	18	0	18	0	14	32	0	0
18	2934856	.	A	G	7	8	15	0	0	15	0	0
18	2935243	.	G	C	13	7	20	0	0	20	0	0
18	2935265	.	A	T	13	8	21	0	1	22	0	0
18	2935480	.	C	T	12	18	30	0	0	30	0	0
18	3006843	.	C	T	7	8	15	0	0	15	0	0
18	3039440	.	A	G	28	28	56	0	3	59	0	0
18	3049752	.	T	G	18	18	36	0	4	40	0	0
18	3049756	.	A	G	19	16	35	0	2	37	0	0
18	3078582	.	C	T	11	3	14	0	0	14	0	0
18	3084660	.	G	C	7	2	9	0	0	9	0	0
18	3084698	.	G	A	2	6	8	0	0	8	0	0
18	3087662	.	G	A	2	4	6	0	0	6	0	0
18	3087695	.	T	G	2	3	5	0	0	5	0	0
18	3087704	.	T	A	2	4	6	0	0	6	0	0
18	3087776	.	G	A	11	3	14	0	0	14	0	0
18	3089906	.	T	C	3	3	6	0	0	6	0	0
18	3097003	.	A	G	2	3	5	0	0	5	0	0
18	3097057	.	A	C	1	7	8	0	1	9	0	0
18	3097058	.	C	T	1	7	8	0	1	9	0	0
18	3140800	.	G	A	0	3	3	0	6	9	0	0
18	3142685	.	A	G	9	5	14	0	0	14	0	0
18	3144677	.	G	A	2	10	12	0	12	24	0	0
18	3144742	.	A	T	10	12	22	0	0	22	0	0
18	3158739	.	A	G	13	10	23	0	1	24	0	0
18	3158776	.	G	A	12	8	20	0	0	20	0	0
18	3159140	.	C	A	5	6	11	0	0	11	0	0
18	3159193	.	G	A	8	3	11	0	0	11	0	0
18	3159865	.	T	C	3	7	10	0	1	12	1	0
18	3159965	.	A	T	7	6	13	0	0	13	0	0
18	3160218	.	C	T	1	6	7	1	11	19	0	0
18	3160308	.	A	G	6	8	14	0	1	15	0	0
18	3160354	.	C	T	1	8	9	0	3	12	0	0
18	3160406	.	T	C	4	0	4	0	6	10	0	0
18	3160422	.	A	G	3	5	8	0	1	9	0	0
18	3259736	.	C	T	23	22	45	0	3	48	0	0
18	3259807	.	C	A	18	21	39	3	4	46	0	0
18	3259847	.	C	T	26	22	48	0	1	49	0	0
18	3265657	.	T	C	18	13	31	1	0	32	0	0
18	3276085	.	G	C	16	22	38	0	2	40	0	0
18	3276187	.	A	G	19	3	22	0	13	35	0	0
18	3283882	.	T	C	20	20	40	0	0	40	0	0
18	3323557	.	A	G	6	0	6	0	4	10	0	0
18	3327571	.	G	A	0	8	8	0	7	15	0	0
18	3334609	.	C	T	13	6	19	0	0	19	0	0
18	3339152	.	G	C	10	4	14	0	1	15	0	0
18	3345052	.	T	A	13	5	18	0	1	19	0	0
18	3345093	.	A	G	12	0	12	0	6	18	0	0
18	3345141	.	T	A	7	10	17	0	1	18	0	0
18	3349011	.	T	C	7	10	17	0	0	17	0	0
18	3371534	.	G	A	2	1	3	0	0	3	0	0
18	3371543	.	C	T	2	0	2	0	2	4	0	0
18	3371661	.	T	C	3	0	3	0	2	5	0	0
18	3371664	.	A	C	3	2	5	0	0	5	0	0
18	3405672	.	G	T	1	2	3	0	0	3	0	0
18	3536868	.	A	T	11	14	25	0	0	25	0	0
18	3536937	.	T	C	9	12	21	0	0	21	0	0
18	3539989	.	C	T	1	12	13	0	10	23	0	0
18	3540027	.	C	T	13	10	23	0	1	24	0	0
18	3556542	.	A	G	10	14	24	0	0	24	0	0
18	3556626	.	C	T	1	9	10	0	9	19	0	0
18	3556935	.	C	T	7	5	12	0	1	13	0	0
18	3557043	.	A	T	7	5	12	0	0	12	0	0
18	3562608	.	A	G	7	3	10	0	0	10	0	0
18	3569275	.	C	T	0	9	9	0	8	17	0	0
18	3572547	.	G	A	7	10	17	0	2	19	0	0
18	3572878	.	T	C	8	6	14	0	0	14	0	0
18	3575938	.	C	A	4	8	12	1	0	13	0	0
18	3576104	.	C	T	12	9	21	0	4	25	0	0
18	3617759	.	C	T	4	4	8	0	0	8	0	0
18	3618015	.	C	G	8	4	12	0	0	12	0	0
18	3635132	.	G	A	2	5	7	0	0	7	0	0
18	3635419	.	A	G	0	3	3	0	0	3	0	0
18	3635443	.	C	G	3	1	4	0	1	5	0	0
18	3643791	.	T	C	2	2	4	0	0	4	0	0
18	5167604	.	A	G	28	8	36	0	2	38	0	0
18	5167607	.	A	G	27	7	34	0	4	38	0	0
18	5170069	.	A	G	17	1	18	0	30	48	0	0
18	5234937	.	C	A	3	17	20	0	18	38	0	0
18	5234990	.	T	G	12	23	35	0	0	35	0	0
18	5235033	.	C	T	10	21	31	1	2	34	0	0
18	5242329	.	G	A	15	15	30	0	1	31	0	0
18	5243234	.	A	G	12	16	28	0	0	28	0	0
18	5243255	.	T	C	10	14	24	0	1	25	0	0
18	5244986	.	G	A	6	4	10	0	0	10	0	0
18	5245615	.	G	A	3	2	5	0	0	5	0	0
18	5245806	.	T	C	15	18	33	0	3	36	0	0
18	5245818	.	C	T	0	23	23	0	13	37	1	0
18	5308441	.	T	G	12	9	21	0	1	22	0	0
18	5310018	.	A	G	7	6	13	2	0	15	0	0
18	5316537	.	A	G	4	2	6	0	0	6	0	0
18	5318833	.	G	A	2	2	4	0	0	4	0	0
18	5375143	.	A	G	10	14	24	0	1	25	0	0
18	5378093	.	C	A	0	12	12	0	14	26	0	0
18	5455161	.	C	T	7	4	11	0	0	11	0	0
18	5455347	.	G	T	0	6	6	0	4	10	0	0
18	5456940	.	G	A	0	1	1	0	3	4	0	0
18	5491697	.	G	A	22	16	38	0	0	38	0	0
18	5494980	.	A	G	15	25	40	0	0	40	0	0
18	5495903	.	T	C	13	17	30	0	2	32	0	0
18	5506578	.	C	T	15	36	51	0	2	53	0	0
18	5509426	.	G	C	16	15	31	0	0	31	0	0
18	5514321	.	T	G	8	10	18	0	0	18	0	0
18	5514544	.	T	A	11	4	15	0	0	15	0	0
18	5514678	.	G	A	1	5	6	0	11	17	0	0
18	5516320	.	C	T	7	4	11	0	2	13	0	0
18	5518108	.	C	T	7	13	20	0	1	21	0	0
18	5518128	.	T	C	12	13	25	0	0	25	0	0
18	5518749	.	T	C	3	10	13	0	1	14	0	0
18	5518809	.	T	G	8	4	12	0	0	12	0	0
18	5519119	.	A	G	6	3	9	0	0	9	0	0
18	5519269	.	T	C	6	7	13	0	1	14	0	0
18	5519534	.	T	A	3	3	6	0	0	6	0	0
18	5519622	.	G	A	0	3	3	0	5	8	0	0
18	5531611	.	A	T	1	7	8	1	0	9	0	0
18	5533186	.	A	C	4	0	4	0	7	11	0	0
18	5534295	.	T	C	3	0	3	0	6	9	0	0
18	5535203	.	C	T	0	3	3	0	3	6	0	0
18	5535243	.	G	A	2	2	4	0	0	4	0	0
18	5537129	.	G	C	2	2	4	0	0	4	0	0
18	5537138	.	C	T	2	3	5	0	0	5	0	0
18	5537171	.	A	C	3	0	3	0	5	8	0	0
18	5537255	.	T	C	3	3	6	0	0	6	0	0
18	5537530	.	A	G	4	3	7	0	0	7	0	0
18	5539488	.	T	C	6	0	6	0	8	14	0	0
18	5539517	.	T	C	7	0	7	0	7	14	0	0
18	5624614	.	A	G	5	6	11	0	1	13	1	0
18	5624654	.	T	A	9	5	14	0	1	15	0	0
18	5626583	.	G	A	8	9	17	0	1	18	0	0
18	5626661	.	A	C	5	4	9	0	0	9	0	0
18	5692205	.	A	G	22	20	42	0	0	42	0	0
18	5692222	.	A	T	22	20	42	0	1	43	0	0
18	7099981	.	A	G	3	2	5	0	0	5	0	0
18	7393639	.	T	C	1	6	7	0	0	7	0	0
18	7571412	.	A	G	2	2	4	0	0	4	0	0
18	7571628	.	C	T	2	6	8	0	0	8	0	0
18	7571776	.	A	G	0	3	3	0	0	3	0	0
18	7664238	.	C	T	4	2	6	0	0	6	0	0
18	9637220	.	C	G	1	1	2	0	1	3	0	0
18	9637224	.	G	T	1	1	2	0	1	3	0	0
18	10693077	.	G	A	1	5	6	0	1	7	0	0
18	10693085	.	T	A	1	6	7	0	0	7	0	0
18	10693123	.	C	T	1	2	3	0	0	3	0	0
18	10693155	.	T	A	2	2	4	0	0	4	0	0
18	10693322	.	A	T	7	5	12	0	1	13	0	0
18	10698083	.	T	C	7	8	15	0	0	15	0	0
18	10698161	.	T	G	9	10	19	0	0	19	0	0
18	10698215	.	T	C	15	7	22	0	0	22	0	0
18	10703669	.	A	G	5	4	9	0	1	10	0	0
18	10708346	.	G	A	4	4	8	1	0	9	0	0
18	10709870	.	C	A	10	3	13	0	0	13	0	0
18	10709876	.	C	A	9	3	12	0	0	12	0	0
18	10713310	.	T	C	3	2	5	0	0	5	0	0
18	10820428	.	A	C	14	8	22	0	0	22	0	0
18	10825951	.	A	G	15	11	26	0	2	28	0	0
18	10840094	.	C	A	12	11	23	0	0	23	0	0
18	10840722	.	C	G	12	8	20	0	1	21	0	0
18	10846601	.	T	C	21	21	42	0	1	43	0	0
18	10847743	.	C	T	19	14	33	0	1	34	0	0
18	10847872	.	A	G	13	14	27	0	2	29	0	0
18	10867181	.	A	C	9	16	25	0	0	25	0	0
18	10870806	.	T	C	17	14	31	0	0	31	0	0
18	10877499	.	G	A	11	13	24	0	0	24	0	0
18	10879495	.	G	A	13	13	26	0	0	26	0	0
18	10887826	.	A	G	11	8	19	0	1	20	0	0
18	10888245	.	A	C	11	12	23	0	0	23	0	0
18	10888551	.	T	C	11	15	26	0	2	28	0	0
18	10888836	.	T	C	19	18	37	0	0	38	1	0
18	10889049	.	C	G	13	0	13	0	11	24	0	0
18	10889880	.	G	A	2	5	7	0	14	21	0	0
18	10889901	.	T	A	11	7	18	0	0	18	0	0
18	10889951	.	G	A	9	9	18	0	0	18	0	0
18	10890432	.	G	A	11	16	27	0	0	27	0	0
18	10921408	.	A	T	15	12	27	0	2	29	0	0
18	10921630	.	A	T	17	10	27	0	0	27	0	0
18	10921734	.	T	C	7	13	20	0	0	20	0	0
18	10921791	.	T	C	10	14	24	0	1	25	0	0
18	10921855	.	T	C	8	10	18	1	0	19	0	0
18	10921857	.	G	A	0	10	10	1	7	18	0	0
18	10921927	.	C	T	10	10	20	0	0	20	0	0
18	11016209	.	G	A	4	5	9	0	1	10	0	0
18	11184522	.	G	A	1	3	4	0	1	5	0	0
18	11506946	.	T	C	3	3	6	0	0	6	0	0
18	11507253	.	T	G	9	8	17	0	0	17	0	0
18	11507263	.	G	A	8	9	17	0	1	18	0	0
18	11515830	.	C	T	8	8	16	0	0	16	0	0
18	11537535	.	T	C	3	12	15	0	1	16	0	0
18	11537703	.	T	G	5	0	5	0	9	14	0	0
18	11541046	.	A	G	6	4	10	0	0	10	0	0
18	11558187	.	G	A	1	2	3	0	0	3	0	0
18	11558197	.	T	C	1	2	3	0	0	3	0	0
18	11558540	.	A	G	2	1	3	0	1	4	0	0
18	11859121	.	C	T	1	2	3	0	0	3	0	0
18	11862896	.	G	T	6	2	8	0	0	8	0	0
18	11878643	.	G	C	0	3	3	0	5	8	0	0
18	11878673	.	C	G	3	4	7	0	0	7	0	0
18	12058480	.	T	A	7	8	15	0	0	15	0	0
18	12105432	.	T	C	5	7	12	0	0	12	0	0
18	12105548	.	G	A	0	5	5	0	4	9	0	0
18	12111431	.	A	C	9	5	14	0	0	14	0	0
18	12111625	.	A	G	14	5	19	0	0	19	0	0
18	12111628	.	A	T	14	5	19	0	0	19	0	0
18	12111772	.	A	C	5	2	7	0	0	7	0	0
18	12111784	.	G	T	5	3	8	0	0	8	0	0
18	12111925	.	G	A	7	6	13	0	1	14	0	0
18	12112105	.	T	C	5	13	18	0	1	19	0	0
18	12112153	.	T	C	12	7	19	0	0	19	0	0
18	12112219	.	C	T	6	8	14	0	1	15	0	0
18	12112246	.	A	G	7	1	8	0	10	18	0	0
18	12112726	.	C	T	9	5	14	0	1	15	0	0
18	12112750	.	G	A	6	7	13	0	0	13	0	0
18	12113515	.	C	A	13	8	21	0	2	23	0	0
18	12113516	.	C	T	15	9	24	0	0	24	0	0
18	12148050	.	T	G	6	0	6	0	6	12	0	0
18	12148056	.	C	T	6	5	11	0	0	11	0	0
18	12171277	.	C	T	5	7	12	0	0	12	0	0
18	12196939	.	G	A	1	4	5	0	7	12	0	0
18	12207046	.	A	G	9	10	19	0	1	20	0	0
18	12207070	.	C	A	9	10	19	0	0	19	0	0
18	12214299	.	A	G	10	11	21	0	0	21	0	0
18	12228217	.	C	A	9	7	16	0	0	16	0	0
18	12228758	.	C	T	11	4	15	0	0	15	0	0
18	12229120	.	A	T	6	4	10	0	0	10	0	0
18	12229223	.	A	C	7	5	12	0	0	12	0	0
18	12229245	.	C	T	5	4	9	0	1	10	0	0
18	12236126	.	T	A	2	3	5	0	0	5	0	0
18	12236351	.	C	T	8	9	17	0	0	17	0	0
18	12238082	.	G	A	7	5	12	0	0	12	0	0
18	12240681	.	C	T	10	6	16	0	1	17	0	0
18	12240740	.	G	C	8	7	15	0	0	15	0	0
18	12242967	.	C	T	2	8	10	0	10	20	0	0
18	12244667	.	G	A	5	2	7	0	0	7	0	0
18	12245468	.	A	G	6	2	8	0	0	8	0	0
18	12245525	.	A	G	2	4	6	0	0	6	0	0
18	12245576	.	A	G	1	3	4	0	0	4	0	0
18	12249400	.	G	A	4	8	12	0	0	12	0	0
18	12250727	.	G	A	6	5	11	0	0	11	0	0
18	12251352	.	G	A	5	2	7	0	0	7	0	0
18	12254248	.	G	A	1	2	3	0	0	3	0	0
18	12254398	.	A	G	5	4	9	0	0	9	0	0
18	12254409	.	G	A	5	5	10	0	0	10	0	0
18	12254905	.	G	A	5	2	7	0	0	7	0	0
18	12255012	.	T	C	3	5	8	0	0	8	0	0
18	12256444	.	G	A	2	5	7	0	0	7	0	0
18	12256716	.	T	C	2	3	5	0	1	6	0	0
18	12261161	.	A	G	3	3	6	0	0	6	0	0
18	12264032	.	A	G	5	3	8	0	0	8	0	0
18	12264059	.	C	T	1	5	6	0	3	9	0	0
18	12264077	.	C	T	0	4	4	0	5	9	0	0
18	12264097	.	G	A	4	2	6	0	1	7	0	0
18	12276945	.	G	A	6	2	8	0	0	8	0	0
18	12277052	.	A	G	16	11	27	0	1	28	0	0
18	12277206	.	G	C	12	20	32	1	4	37	0	0
18	12277490	.	G	A	31	14	45	0	1	46	0	0
18	12280269	.	C	T	25	26	51	0	0	51	0	0
18	12292017	.	G	A	19	19	38	0	1	39	0	0
18	12364876	.	G	A	3	3	6	0	0	6	0	0
18	12366097	.	G	T	6	8	14	0	0	14	0	0
18	12366171	.	C	G	2	3	5	0	1	6	0	0
18	12366855	.	A	T	4	2	6	0	0	6	0	0
18	12370573	.	T	G	4	3	7	0	1	8	0	0
18	12374168	.	A	G	5	4	9	0	0	9	0	0
18	12374497	.	C	T	1	3	4	0	4	8	0	0
18	12374521	.	A	G	3	3	6	0	0	6	0	0
18	12385129	.	G	A	4	3	7	0	0	7	0	0
18	12406385	.	G	A	3	3	6	0	0	6	0	0
18	12409705	.	A	T	4	2	6	0	0	6	0	0
18	12416623	.	C	T	5	4	9	0	0	9	0	0
18	12416908	.	G	A	1	4	5	0	0	5	0	0
18	12417035	.	T	G	2	2	4	0	0	4	0	0
18	12417903	.	G	C	2	2	4	0	0	4	0	0
18	12418207	.	G	A	2	5	7	0	0	7	0	0
18	12418349	.	G	A	2	2	4	0	0	4	0	0
18	12451778	.	G	A	4	2	6	0	0	6	0	0
18	12451819	.	G	A	2	2	4	0	0	4	0	0
18	12464794	.	C	T	1	5	6	0	5	11	0	0
18	12464867	.	C	A	6	7	13	0	1	14	0	0
18	12465290	.	G	A	12	15	27	0	2	29	0	0
18	12465316	.	C	T	13	11	24	0	4	28	0	0
18	12467834	.	G	C	15	0	15	1	18	35	1	0
18	12470013	.	G	T	16	7	23	0	2	25	0	0
18	12470136	.	G	A	14	15	29	0	0	29	0	0
18	12470148	.	A	G	13	13	26	0	0	26	0	0
18	12470211	.	C	T	3	13	16	0	9	25	0	0
18	12471210	.	T	C	8	4	12	0	0	12	0	0
18	12471225	.	G	A	6	7	13	0	1	14	0	0
18	12495185	.	C	T	16	8	24	0	0	24	0	0
18	12611569	.	T	C	5	4	9	0	0	9	0	0
18	12612031	.	C	T	0	6	6	0	6	12	0	0
18	12612160	.	A	G	7	10	17	0	1	18	0	0
18	12653846	.	G	C	6	8	14	0	0	14	0	0
18	12659197	.	C	T	9	10	19	0	1	20	0	0
18	12659226	.	C	T	5	5	10	0	0	10	0	0
18	12776727	.	C	T	8	6	14	0	0	14	0	0
18	14772522	.	G	A	5	6	11	0	0	11	0	0
18	14772747	.	C	T	1	6	7	0	6	13	0	0
18	14772889	.	A	G	6	7	13	0	0	13	0	0
18	14773050	.	C	T	10	11	21	0	1	22	0	0
18	14773068	.	G	T	9	12	21	0	1	22	0	0
18	14774568	.	T	C	13	0	13	0	9	22	0	0
18	14774646	.	C	G	13	3	16	0	0	16	0	0
18	14779213	.	C	T	6	11	17	0	0	17	0	0
18	14780581	.	G	A	5	6	11	0	2	13	0	0
18	14825239	.	G	A	4	5	9	1	0	10	0	0
18	14836678	.	C	T	5	4	9	0	0	9	0	0
18	14845585	.	T	A	1	3	4	0	0	4	0	0
18	14845591	.	C	T	1	2	3	0	0	3	0	0
18	14866506	.	G	A	8	6	14	0	0	14	0	0
18	14866508	.	C	T	8	6	14	0	0	14	0	0
18	14867144	.	A	C	4	0	4	0	6	10	0	0
18	14867153	.	C	T	4	4	8	0	0	8	0	0
18	14871133	.	C	T	3	5	8	0	0	8	0	0
18	14871145	.	A	G	3	5	8	0	0	8	0	0
18	14878691	.	C	G	0	2	2	0	4	6	0	0
18	14878790	.	A	G	3	3	6	0	0	6	0	0
18	14886129	.	C	T	3	3	6	0	2	8	0	0
18	14891794	.	T	C	2	3	5	0	0	5	0	0
18	14896331	.	T	C	3	0	3	0	6	9	0	0
18	14901176	.	G	A	3	4	7	0	0	7	0	0
18	14901283	.	T	A	1	2	3	0	0	3	0	0
18	14909768	.	G	A	15	6	21	0	0	21	0	0
18	14909831	.	A	T	11	7	18	0	0	18	0	0
18	14910365	.	C	T	3	2	5	0	1	6	0	0
18	14910929	.	A	G	1	3	4	0	0	4	0	0
18	14911309	.	G	T	1	5	6	0	0	7	1	0
18	14917126	.	C	T	2	4	6	0	0	6	0	0
18	14928654	.	C	T	7	6	13	0	0	13	0	0
18	14928681	.	T	C	6	10	16	0	0	16	0	0
18	14933334	.	T	C	1	0	1	0	5	6	0	0
18	14956171	.	A	G	1	6	7	0	0	7	0	0
18	14956177	.	G	A	1	4	5	0	1	6	0	0
18	14963733	.	G	A	6	11	17	0	1	18	0	0
18	14969855	.	G	A	5	5	10	0	0	10	0	0
18	14975502	.	G	C	2	5	7	0	2	9	0	0
18	14979233	.	A	G	3	4	7	0	0	7	0	0
18	14979242	.	C	T	0	5	5	0	3	8	0	0
18	15010642	.	C	T	4	5	9	1	0	10	0	0
18	15010681	.	C	T	4	4	8	1	0	9	0	0
18	15100812	.	T	A	1	4	5	0	2	7	0	0
18	15106813	.	G	T	3	2	5	0	0	5	0	0
18	15119795	.	T	C	7	3	10	0	0	10	0	0
18	15121484	.	G	A	5	4	9	0	0	9	0	0
18	15122894	.	C	T	6	3	9	0	0	9	0	0
18	15122915	.	G	A	0	7	7	0	4	11	0	0
18	15123008	.	C	A	4	7	11	0	0	11	0	0
18	15123011	.	A	G	4	6	10	0	1	11	0	0
18	15125122	.	G	A	5	9	14	0	0	14	0	0
18	15125193	.	A	C	6	7	13	0	2	15	0	0
18	15125418	.	C	A	11	4	15	0	2	17	0	0
18	15128960	.	T	C	5	3	8	0	0	8	0	0
18	15128975	.	G	T	4	3	7	0	0	7	0	0
18	15132372	.	T	C	10	10	20	0	0	20	0	0
18	15132383	.	T	C	9	10	19	0	0	19	0	0
18	15134001	.	A	G	3	8	11	0	0	11	0	0
18	15139004	.	T	A	6	3	9	0	0	9	0	0
18	15139540	.	C	T	10	4	14	0	1	15	0	0
18	15139757	.	G	A	6	2	8	0	0	8	0	0
18	15148021	.	T	C	5	9	14	0	0	14	0	0
18	15148063	.	A	C	6	0	6	0	6	12	0	0
18	15148199	.	T	C	3	6	9	0	0	9	0	0
18	15148207	.	A	C	3	6	9	0	0	9	0	0
18	15148248	.	T	C	3	4	7	0	0	7	0	0
18	15148259	.	A	C	4	4	8	0	0	8	0	0
18	15148290	.	A	C	2	4	6	0	0	6	0	0
18	15148304	.	T	C	3	0	3	0	3	6	0	0
18	15148482	.	A	G	2	3	5	0	1	6	0	0
18	15148886	.	G	A	1	4	5	0	0	5	0	0
18	15148912	.	A	G	1	6	7	0	2	9	0	0
18	15148954	.	T	C	3	5	8	0	0	8	0	0
18	15148985	.	A	G	3	3	6	0	0	6	0	0
18	15149067	.	G	A	4	2	6	0	0	6	0	0
18	15149068	.	G	T	2	2	4	0	1	5	0	0
18	15149475	.	T	C	6	0	6	0	3	9	0	0
18	15149813	.	T	A	1	2	3	0	0	3	0	0
18	15150165	.	A	T	4	5	9	0	0	9	0	0
18	15150207	.	G	A	4	6	10	0	0	10	0	0
18	15150261	.	A	G	3	2	5	0	0	5	0	0
18	15150327	.	C	T	1	3	4	0	1	5	0	0
18	15150330	.	G	A	2	3	5	0	0	5	0	0
18	15150442	.	C	T	6	2	8	0	0	8	0	0
18	15155939	.	G	A	4	2	6	0	0	6	0	0
18	15263421	.	C	T	0	2	2	0	1	3	0	0
18	15285346	.	C	T	3	4	7	0	0	7	0	0
18	15287610	.	C	T	3	2	5	0	0	5	0	0
18	15287709	.	A	G	2	4	6	0	0	6	0	0
18	15295925	.	C	T	1	2	3	0	4	7	0	0
18	15295976	.	G	T	7	3	10	0	1	11	0	0
18	15296062	.	G	A	11	5	16	0	0	16	0	0
18	15309513	.	T	C	7	1	8	0	12	20	0	0
18	15345012	.	A	G	3	2	5	0	0	5	0	0
18	15345315	.	C	T	0	3	3	0	3	6	0	0
18	15345409	.	G	C	3	2	5	0	0	5	0	0
18	15383683	.	C	T	6	5	11	0	1	12	0	0
18	15393324	.	G	A	5	6	11	0	0	11	0	0
18	15393787	.	C	G	5	2	7	0	1	8	0	0
18	15395535	.	A	G	1	4	5	2	0	7	0	0
18	15399135	.	T	C	6	8	14	0	0	14	0	0
18	15403754	.	C	T	3	7	10	0	0	10	0	0
18	15408140	.	G	A	5	3	8	0	0	8	0	0
18	15408185	.	T	C	1	2	3	0	0	3	0	0
18	15410687	.	G	A	4	6	10	0	0	10	0	0
18	15414558	.	T	C	3	2	5	0	0	5	0	0
18	15414564	.	C	T	3	2	5	0	0	5	0	0
18	15459835	.	T	A	2	9	11	1	0	12	0	0
18	15459871	.	C	T	3	6	9	0	1	10	0	0
18	15467318	.	A	G	1	2	3	0	0	3	0	0
18	15469284	.	G	A	1	2	3	0	0	3	0	0
18	15469907	.	T	C	10	4	14	0	0	14	0	0
18	15470114	.	T	G	8	4	12	0	1	13	0	0
18	15478391	.	T	G	4	3	7	0	1	8	0	0
18	15478394	.	G	A	5	2	7	0	1	8	0	0
18	15478597	.	A	G	4	6	10	0	0	10	0	0
18	15481364	.	T	G	3	2	5	0	1	6	0	0
18	15481636	.	C	T	8	2	10	0	1	11	0	0
18	15483351	.	C	T	7	3	10	0	0	10	0	0
18	15490146	.	G	A	5	4	9	0	0	9	0	0
18	15490738	.	A	G	3	4	7	0	0	7	0	0
18	15490739	.	C	T	3	2	5	0	2	7	0	0
18	15514888	.	C	T	3	4	7	0	1	8	0	0
18	15514894	.	C	T	3	5	8	0	0	8	0	0
18	15551362	.	A	T	3	4	7	0	0	7	0	0
18	15569644	.	T	C	2	5	7	0	0	7	0	0
18	15570793	.	C	T	1	2	3	0	1	4	0	0
18	15571066	.	A	G	1	2	3	1	0	4	0	0
18	15571189	.	G	C	2	2	4	0	0	4	0	0
18	15573490	.	G	T	5	2	7	0	0	7	0	0
18	15792294	.	T	G	15	13	28	0	0	28	0	0
18	15792368	.	G	C	25	16	41	0	1	42	0	0
18	15792459	.	A	C	30	17	47	0	1	48	0	0
18	15792596	.	T	A	20	19	39	0	1	40	0	0
18	15792611	.	A	G	16	23	39	0	1	40	0	0
18	15792743	.	T	A	15	26	41	1	1	43	0	0
18	15793064	.	A	G	2	4	6	0	1	7	0	0
18	15829588	.	A	G	12	12	24	0	2	26	0	0
18	15836835	.	A	G	3	6	9	1	0	10	0	0
18	15836917	.	A	G	4	5	9	0	1	10	0	0
18	15836961	.	C	T	8	4	12	0	2	14	0	0
18	15849413	.	T	C	8	9	17	0	0	17	0	0
18	15858916	.	G	A	7	5	12	0	0	12	0	0
18	15863558	.	G	A	1	4	5	0	0	5	0	0
18	15865154	.	T	C	6	8	14	0	0	14	0	0
18	15865196	.	C	G	15	7	22	0	0	22	0	0
18	15866874	.	T	G	5	6	11	0	1	12	0	0
18	15866876	.	G	T	5	6	11	0	1	12	0	0
18	15869816	.	C	A	8	4	12	0	1	13	0	0
18	15869854	.	T	G	9	0	9	0	9	18	0	0
18	15872092	.	A	G	8	4	12	0	0	12	0	0
18	15872435	.	A	G	7	3	10	0	1	11	0	0
18	15872452	.	G	A	4	4	8	0	0	9	1	0
18	15874454	.	T	C	3	3	6	0	1	7	0	0
18	15874550	.	C	T	9	15	24	0	0	24	0	0
18	15875196	.	G	A	12	10	22	0	0	22	0	0
18	15926814	.	G	A	1	2	3	0	0	3	0	0
18	16127885	.	A	G	20	25	45	0	1	46	0	0
18	16127927	.	A	C	22	21	43	0	1	44	0	0
18	16128427	.	T	A	2	4	6	0	1	7	0	0
18	16128730	.	A	G	15	12	27	0	0	27	0	0
18	16128960	.	T	G	29	16	45	0	1	46	0	0
18	16129210	.	A	C	16	11	27	0	3	30	0	0
18	16129583	.	T	A	21	16	37	0	1	38	0	0
18	16129862	.	C	T	21	17	38	0	2	40	0	0
18	16133772	.	C	G	21	15	36	0	0	36	0	0
18	16133773	.	T	A	21	15	36	0	0	36	0	0
18	16133822	.	T	C	13	16	29	0	0	29	0	0
18	16140047	.	G	A	15	9	24	0	0	24	0	0
18	16140337	.	G	T	2	23	25	0	22	47	0	0
18	16145618	.	T	G	26	17	43	0	1	44	0	0
18	16145621	.	C	T	23	18	41	0	2	43	0	0
18	16145994	.	C	G	8	5	13	0	0	13	0	0
18	16151809	.	T	A	7	4	11	0	0	11	0	0
18	16152149	.	G	A	18	13	31	0	1	32	0	0
18	16153487	.	T	C	15	1	16	0	10	26	0	0
18	16157998	.	T	C	11	0	11	0	7	18	0	0
18	16158279	.	G	T	10	6	16	0	0	16	0	0
18	16196575	.	A	G	4	2	6	0	0	6	0	0
18	16199805	.	G	A	1	3	4	0	0	4	0	0
18	16388195	.	G	A	8	8	16	0	0	16	0	0
18	16388294	.	G	C	7	0	7	0	8	15	0	0
18	16388342	.	G	A	5	4	9	0	1	10	0	0
18	16388387	.	G	A	5	4	9	0	0	9	0	0
18	16388579	.	A	G	9	3	12	0	1	13	0	0
18	16388747	.	T	C	7	4	11	0	0	11	0	0
18	16388825	.	A	G	2	9	11	0	0	11	0	0
18	16391712	.	G	A	1	3	4	0	2	6	0	0
18	16391834	.	G	A	7	6	13	1	1	15	0	0
18	16490700	.	A	C	5	3	8	0	1	9	0	0
18	16589702	.	T	C	5	4	9	0	0	9	0	0
18	16589760	.	G	T	3	7	10	0	0	10	0	0
18	16719963	.	T	C	17	12	29	0	3	32	0	0
18	16720197	.	G	A	22	9	31	0	1	32	0	0
18	16721705	.	G	A	20	21	41	0	3	44	0	0
18	16721741	.	G	A	22	20	42	0	3	45	0	0
18	16722124	.	G	A	29	32	61	0	4	65	0	0
18	16722584	.	G	A	23	16	39	0	1	40	0	0
18	16723514	.	T	C	16	20	36	0	0	36	0	0
18	16723520	.	A	G	15	0	15	0	20	35	0	0
18	16723785	.	A	G	14	0	14	0	21	35	0	0
18	16725225	.	G	A	1	17	18	1	17	36	0	0
18	16725309	.	C	T	20	6	26	0	1	27	0	0
18	16725917	.	A	G	15	14	29	0	2	31	0	0
18	16726011	.	C	T	7	8	15	0	2	17	0	0
18	16755962	.	C	A	19	23	42	0	0	42	0	0
18	16756001	.	C	T	14	23	37	0	0	37	0	0
18	16756058	.	T	A	9	18	27	0	1	28	0	0
18	16756065	.	G	A	8	19	27	0	1	28	0	0
18	16876903	.	A	G	3	2	5	0	0	5	0	0
18	16877282	.	C	T	3	5	8	0	0	8	0	0
18	16877283	.	A	G	3	5	8	0	0	8	0	0
18	16885979	.	T	G	9	13	22	0	0	22	0	0
18	16886079	.	C	T	14	10	24	0	0	24	0	0
18	16894571	.	T	A	10	10	20	0	1	21	0	0
18	16894594	.	T	G	11	9	20	1	4	25	0	0
18	16894630	.	A	G	13	11	24	1	0	25	0	0
18	16906522	.	A	G	10	4	14	0	0	14	0	0
18	16915433	.	T	C	3	6	9	0	0	9	0	0
18	16915463	.	A	G	4	5	9	0	0	9	0	0
18	16929772	.	G	A	11	15	26	3	0	29	0	0
18	16953349	.	G	A	3	2	5	0	0	5	0	0
18	16953866	.	C	A	1	1	2	0	1	3	0	0
18	16961046	.	A	G	19	15	34	5	1	40	0	0
18	16962778	.	A	G	21	6	27	1	2	30	0	0
18	16962783	.	C	T	24	7	31	1	0	32	0	0
18	16962823	.	C	T	26	10	36	0	1	37	0	0
18	16963091	.	C	G	13	16	29	0	5	34	0	0
18	16966911	.	T	C	16	8	24	0	0	24	0	0
18	16968314	.	T	C	17	12	29	0	2	32	1	0
18	16970455	.	A	T	9	7	16	0	0	16	0	0
18	16970459	.	G	A	1	6	7	0	10	17	0	0
18	16970598	.	C	T	10	7	17	0	0	17	0	0
18	16970950	.	T	G	10	3	13	1	0	14	0	0
18	16970997	.	G	C	0	6	6	1	17	24	0	0
18	16971129	.	C	T	8	9	17	0	0	17	0	0
18	16986770	.	C	A	1	4	5	0	0	5	0	0
18	16986789	.	C	A	2	2	4	0	0	4	0	0
18	16990150	.	G	T	4	2	6	0	0	6	0	0
18	16990385	.	A	C	3	0	3	0	7	10	0	0
18	16990520	.	C	T	4	9	13	0	0	13	0	0
18	16990550	.	A	G	5	5	10	0	1	11	0	0
18	16993352	.	A	T	2	2	4	0	0	4	0	0
18	16998924	.	A	T	4	3	7	0	0	7	0	0
18	17002614	.	T	C	5	0	5	0	9	14	0	0
18	17002653	.	A	G	4	8	12	0	0	12	0	0
18	17003602	.	A	G	6	11	17	0	0	17	0	0
18	17007458	.	G	A	3	2	5	0	0	5	0	0
18	17007521	.	G	A	4	1	5	0	0	5	0	0
18	17007527	.	C	T	5	2	7	0	0	7	0	0
18	17007720	.	T	C	5	6	11	0	0	11	0	0
18	17016613	.	G	A	6	3	9	0	0	9	0	0
18	17016697	.	T	C	4	5	9	0	0	9	0	0
18	17016721	.	G	T	1	3	4	0	0	4	0	0
18	17024422	.	A	G	1	3	4	0	0	4	0	0
18	17062226	.	G	A	1	3	4	0	0	4	0	0
18	17062227	.	G	A	1	3	4	0	0	4	0	0
18	17062323	.	G	A	1	3	4	0	0	4	0	0
18	17062336	.	T	C	1	3	4	0	0	4	0	0
18	17062487	.	G	T	4	6	10	0	0	10	0	0
18	17062611	.	C	T	5	2	7	0	1	8	0	0
18	17067688	.	T	C	2	2	4	0	0	4	0	0
18	17067975	.	T	A	1	2	3	0	0	3	0	0
18	17070214	.	C	A	2	4	6	0	0	6	0	0
18	17072022	.	T	C	2	2	4	0	0	4	0	0
18	17079156	.	G	C	2	3	5	0	0	5	0	0
18	17079541	.	T	C	15	9	24	1	4	29	0	0
18	17079724	.	C	T	0	6	6	0	8	14	0	0
18	17080089	.	G	C	10	3	13	0	0	13	0	0
18	17080122	.	A	G	7	6	13	0	0	13	0	0
18	17080131	.	T	C	7	0	7	0	6	13	0	0
18	17084489	.	C	T	0	9	9	0	6	15	0	0
18	17097893	.	T	C	11	12	23	0	4	27	0	0
18	17098009	.	G	T	12	8	20	0	4	24	0	0
18	17098317	.	T	A	9	9	18	0	1	19	0	0
18	17098562	.	T	A	13	7	20	0	3	23	0	0
18	17102046	.	C	T	0	7	7	0	15	22	0	0
18	17131006	.	A	G	13	11	24	0	1	25	0	0
18	17134780	.	A	G	9	6	15	0	0	15	0	0
18	17139446	.	G	A	5	4	9	0	0	9	0	0
18	17139461	.	T	C	3	2	5	0	0	5	0	0
18	17144659	.	C	T	6	4	10	0	1	11	0	0
18	17144909	.	T	A	10	8	18	0	1	19	0	0
18	17152045	.	G	C	2	3	5	0	0	5	0	0
18	17155973	.	C	A	1	2	3	0	0	3	0	0
18	17156184	.	A	T	1	2	3	0	0	3	0	0
18	17158974	.	G	A	1	2	3	0	0	3	0	0
18	17173465	.	T	G	4	3	7	0	0	7	0	0
18	17173474	.	A	C	3	2	5	0	1	6	0	0
18	17173687	.	G	T	1	6	7	0	0	7	0	0
18	17272045	.	T	G	1	0	1	0	3	4	0	0
18	17272051	.	T	G	0	1	1	0	3	4	0	0
18	17272280	.	A	G	1	8	9	0	0	9	0	0
18	17535748	.	A	T	11	8	19	0	4	23	0	0
18	17994415	.	A	G	3	17	20	0	2	22	0	0
18	18421826	.	T	G	1	7	8	0	0	8	0	0
18	18472114	.	T	G	3	0	3	0	0	3	0	0
18	18870720	.	A	G	1	2	3	0	0	3	0	0
18	19342739	.	A	G	1	3	4	0	0	4	0	0
18	19405533	.	G	A	3	4	7	0	0	7	0	0
18	19419200	.	A	T	12	13	25	0	3	28	0	0
18	19419307	.	C	T	12	21	33	0	0	33	0	0
18	19441492	.	C	G	23	16	39	0	1	40	0	0
18	19441561	.	T	C	27	21	48	0	2	50	0	0
18	19441585	.	C	A	21	28	49	0	2	51	0	0
18	19450486	.	T	C	30	30	60	0	3	63	0	0
18	19450563	.	A	T	29	29	58	0	0	58	0	0
18	19450642	.	A	T	19	19	38	1	4	43	0	0
18	19450692	.	A	G	23	18	41	2	0	43	0	0
18	19450755	.	A	G	30	32	62	2	3	67	0	0
18	19451023	.	C	T	10	23	33	0	0	33	0	0
18	19451117	.	C	T	6	7	13	0	4	17	0	0
18	19451427	.	G	A	43	32	75	0	1	76	0	0
18	19451430	.	T	C	43	4	47	0	28	75	0	0
18	19451477	.	G	A	40	41	81	0	2	83	0	0
18	19452126	.	T	A	31	35	66	0	2	68	0	0
18	19452594	.	G	A	28	41	69	0	3	72	0	0
18	19487779	.	G	A	12	12	24	0	3	27	0	0
18	19490515	.	C	T	13	28	41	0	2	43	0	0
18	19648878	.	T	C	2	5	7	0	0	7	0	0
18	19698833	.	T	C	1	7	8	0	0	8	0	0
18	19698854	.	G	A	5	7	12	0	0	12	0	0
18	19773113	.	G	A	3	4	7	0	0	7	0	0
18	19805440	.	T	C	3	2	5	0	0	5	0	0
18	19805464	.	C	T	2	2	4	0	0	4	0	0
18	19806135	.	T	G	2	4	6	0	0	6	0	0
18	19812874	.	T	C	3	7	10	0	1	11	0	0
18	19812943	.	A	T	9	7	16	0	1	17	0	0
18	19813002	.	A	G	9	13	22	0	1	23	0	0
18	19814181	.	A	G	14	5	19	0	0	19	0	0
18	19815743	.	A	T	7	8	15	0	0	15	0	0
18	19817682	.	G	A	3	8	11	0	0	11	0	0
18	19817717	.	G	A	6	8	14	0	0	14	0	0
18	19819719	.	C	A	6	6	12	0	0	12	0	0
18	19842354	.	C	T	1	3	4	0	0	4	0	0
18	19883812	.	G	T	1	9	10	0	4	14	0	0
18	19974725	.	C	T	3	3	6	0	0	6	0	0
18	19981553	.	G	A	3	4	7	0	2	9	0	0
18	19981584	.	C	T	3	4	7	0	0	7	0	0
18	20006910	.	C	T	5	7	12	0	1	13	0	0
18	20020108	.	A	T	4	9	13	0	0	13	0	0
18	20022806	.	T	C	1	7	8	0	1	9	0	0
18	20024856	.	T	C	9	4	13	0	0	13	0	0
18	20031213	.	G	A	3	3	6	0	0	6	0	0
18	20034058	.	T	A	4	5	9	0	1	10	0	0
18	20041825	.	T	C	13	13	26	0	0	26	0	0
18	20042088	.	C	T	17	11	28	0	0	28	0	0
18	20044847	.	T	C	11	6	17	0	1	18	0	0
18	20076539	.	C	T	2	4	6	0	0	6	0	0
18	20226023	.	C	A	9	8	17	0	0	17	0	0
18	20226051	.	A	T	6	5	11	0	1	12	0	0
18	20226131	.	G	T	5	3	8	0	0	8	0	0
18	20226288	.	G	A	9	11	20	0	0	20	0	0
18	20228760	.	C	T	10	8	18	0	0	18	0	0
18	20249005	.	G	T	5	14	19	0	15	34	0	0
18	20249735	.	T	C	15	4	19	0	2	21	0	0
18	20252129	.	C	T	11	12	23	0	0	23	0	0
18	20254384	.	C	T	4	8	12	0	1	13	0	0
18	20254398	.	G	A	1	7	8	0	6	14	0	0
18	20256275	.	C	T	10	15	25	0	0	25	0	0
18	20256491	.	T	A	3	6	9	0	0	9	0	0
18	20256492	.	A	T	7	3	10	0	0	10	0	0
18	20256539	.	G	A	8	6	14	0	2	16	0	0
18	20256671	.	T	C	14	3	17	3	0	20	0	0
18	20257005	.	G	A	2	9	11	0	14	25	0	0
18	20257159	.	C	G	6	16	22	0	1	23	0	0
18	20257200	.	A	T	15	11	26	0	1	27	0	0
18	20460291	.	A	G	2	3	5	0	0	5	0	0
18	20468514	.	G	T	0	7	7	0	8	15	0	0
18	20469275	.	T	A	2	2	4	0	0	4	0	0
18	20475854	.	C	T	4	6	10	0	1	11	0	0
18	20479008	.	A	G	5	4	9	0	1	10	0	0
18	20482479	.	A	C	1	2	3	0	0	3	0	0
18	20483240	.	G	A	4	3	7	0	0	7	0	0
18	20483276	.	A	C	1	4	5	0	0	5	0	0
18	20489224	.	G	A	2	3	5	0	0	5	0	0
18	20490510	.	A	T	2	2	4	0	0	4	0	0
18	20491073	.	C	A	1	3	4	0	0	4	0	0
18	20516811	.	T	C	2	5	7	0	0	7	0	0
18	20517000	.	G	A	3	8	11	0	0	11	0	0
18	20518915	.	C	G	1	3	4	0	0	4	0	0
18	20519024	.	G	A	1	3	4	0	0	4	0	0
18	20521431	.	A	T	1	3	4	0	0	4	0	0
18	20521558	.	T	G	3	4	7	0	0	7	0	0
18	20521680	.	G	A	5	2	7	0	0	7	0	0
18	20528116	.	A	G	1	3	4	0	0	4	0	0
18	20528128	.	A	G	1	3	4	0	0	4	0	0
18	20532685	.	T	C	8	3	11	0	1	12	0	0
18	20533934	.	G	A	5	10	15	0	0	15	0	0
18	20534277	.	A	T	8	6	14	0	0	14	0	0
18	20535074	.	T	A	6	8	14	0	0	15	1	0
18	20536533	.	A	G	7	0	7	0	9	16	0	0
18	20539548	.	G	A	1	10	11	0	6	17	0	0
18	20539703	.	T	A	6	4	10	0	0	10	0	0
18	20539844	.	T	A	3	4	7	0	1	8	0	0
18	20539979	.	T	A	3	4	7	0	0	7	0	0
18	20540581	.	G	T	2	6	8	0	1	9	0	0
18	20540606	.	A	T	1	3	4	0	0	4	0	0
18	20541575	.	A	C	7	6	13	0	1	14	0	0
18	20541735	.	A	G	5	6	11	0	0	11	0	0
18	20542107	.	C	T	3	5	8	0	9	17	0	0
18	20542128	.	T	G	8	7	15	0	2	17	0	0
18	20542214	.	A	T	9	7	16	0	0	16	0	0
18	20542388	.	T	G	20	7	27	0	0	27	0	0
18	20542398	.	A	C	19	7	26	0	2	28	0	0
18	20542503	.	G	A	8	20	28	0	3	31	0	0
18	20542562	.	T	G	17	13	30	0	1	31	0	0
18	20542647	.	C	T	11	14	25	0	1	26	0	0
18	20543466	.	T	A	9	20	29	0	4	33	0	0
18	20544691	.	G	A	13	10	23	0	1	24	0	0
18	20544901	.	G	C	12	12	24	0	0	24	0	0
18	20553607	.	T	C	13	21	34	0	0	34	0	0
18	20554066	.	C	T	1	9	10	0	12	22	0	0
18	20559518	.	C	T	15	11	26	0	2	28	0	0
18	20582109	.	G	A	10	4	14	0	0	14	0	0
18	20582222	.	G	A	12	9	21	0	0	21	0	0
18	20582303	.	C	T	0	6	6	0	6	12	0	0
18	20582314	.	C	G	7	7	14	0	0	14	0	0
18	20582356	.	C	T	7	5	12	0	0	12	0	0
18	20582361	.	T	C	8	5	13	0	0	13	0	0
18	20582392	.	C	T	0	5	5	0	4	9	0	0
18	20582629	.	T	C	4	9	13	0	0	13	0	0
18	20583154	.	G	T	5	3	8	0	0	8	0	0
18	20583398	.	C	T	5	2	7	0	1	8	0	0
18	20583551	.	T	C	4	0	4	0	3	7	0	0
18	20583610	.	A	T	1	6	7	0	0	7	0	0
18	20583763	.	A	G	8	8	16	0	1	17	0	0
18	20583820	.	A	T	7	4	11	0	0	11	0	0
18	20584077	.	G	A	2	8	10	0	0	10	0	0
18	20584340	.	C	T	0	3	3	0	4	7	0	0
18	20584797	.	G	A	5	3	8	0	1	9	0	0
18	20584801	.	C	T	5	4	9	0	0	9	0	0
18	20584986	.	T	G	2	4	6	0	0	6	0	0
18	20585314	.	C	T	13	7	20	0	0	20	0	0
18	20585435	.	T	C	9	1	10	0	12	22	0	0
18	20585495	.	C	T	12	8	20	0	0	20	0	0
18	20585532	.	T	C	3	5	8	0	1	9	0	0
18	20585837	.	G	A	8	9	17	0	0	17	0	0
18	20585883	.	G	A	7	6	13	0	0	13	0	0
18	20598286	.	T	C	2	2	4	0	0	4	0	0
18	20598818	.	G	A	4	3	7	0	0	7	0	0
18	20607160	.	G	A	3	8	11	0	0	11	0	0
18	20608212	.	A	T	5	5	10	0	0	10	0	0
18	20726304	.	T	C	26	0	26	0	27	53	0	0
18	20729281	.	C	T	2	15	17	0	24	41	0	0
18	20739268	.	G	T	13	11	24	0	4	28	0	0
18	20739298	.	C	T	12	9	21	0	2	23	0	0
18	20742029	.	C	G	17	19	36	0	1	37	0	0
18	20744164	.	T	C	12	9	21	0	1	22	0	0
18	20752848	.	G	A	9	13	22	0	4	26	0	0
18	20755763	.	G	A	8	9	17	0	0	17	0	0
18	20755787	.	G	T	9	8	17	0	3	20	0	0
18	20755843	.	G	C	13	9	22	0	1	23	0	0
18	20755844	.	C	A	15	9	24	0	1	25	0	0
18	20755971	.	G	T	15	10	25	0	0	25	0	0
18	20757663	.	G	A	10	9	19	0	1	20	0	0
18	20757934	.	C	T	15	9	24	0	2	26	0	0
18	20757977	.	A	C	11	0	11	0	13	24	0	0
18	20757979	.	G	A	12	11	23	0	0	23	0	0
18	20768254	.	T	C	9	1	10	0	8	18	0	0
18	20768407	.	C	T	21	10	31	0	12	43	0	0
18	20768818	.	T	A	13	10	23	0	0	23	0	0
18	20768977	.	C	T	9	10	19	0	0	19	0	0
18	20771078	.	T	C	14	0	14	0	13	27	0	0
18	20771085	.	A	G	13	12	25	0	0	25	0	0
18	20771150	.	C	T	1	7	8	0	2	11	1	0
18	20821793	.	G	A	6	7	13	0	0	13	0	0
18	20859991	.	G	T	7	5	12	0	0	12	0	0
18	20859992	.	G	A	5	7	12	0	0	12	0	0
18	20860597	.	G	A	1	2	3	0	0	3	0	0
18	20861647	.	G	A	4	3	7	0	0	7	0	0
18	20865543	.	T	C	3	2	5	0	0	5	0	0
18	20868503	.	C	G	4	2	6	0	0	6	0	0
18	20869033	.	T	A	1	3	4	0	0	4	0	0
18	20869089	.	C	T	0	3	3	0	4	7	0	0
18	20869128	.	T	C	3	3	6	0	0	6	0	0
18	20881800	.	G	A	3	3	6	0	0	6	0	0
18	20882098	.	C	T	2	2	4	0	0	4	0	0
18	20882237	.	C	G	4	2	6	0	0	6	0	0
18	20894485	.	G	A	3	2	5	0	0	5	0	0
18	20909723	.	C	T	3	4	7	0	0	7	0	0
18	20917327	.	T	G	5	3	8	0	0	8	0	0
18	21071085	.	A	G	5	0	5	0	7	12	0	0
18	21073091	.	A	G	1	5	6	0	0	6	0	0
18	21075715	.	A	C	5	2	7	0	0	7	0	0
18	21075765	.	G	A	2	4	6	0	0	6	0	0
18	21102115	.	T	C	5	2	7	0	1	8	0	0
18	21102764	.	C	T	0	3	3	0	5	8	0	0
18	21103079	.	G	A	3	4	7	0	0	7	0	0
18	21103274	.	G	A	1	4	5	0	0	5	0	0
18	21103334	.	A	C	2	2	4	0	0	4	0	0
18	21105722	.	G	A	5	3	8	0	0	8	0	0
18	21113258	.	G	A	0	7	7	0	2	9	0	0
18	21113273	.	T	C	4	6	10	0	0	10	0	0
18	21113462	.	T	A	4	7	11	0	0	11	0	0
18	21113533	.	G	A	6	5	11	0	1	12	0	0
18	21114475	.	T	C	13	11	24	0	0	24	0	0
18	21116381	.	C	A	8	14	22	0	0	22	0	0
18	21117589	.	C	A	11	8	19	0	0	19	0	0
18	21118232	.	C	G	13	4	17	0	0	17	0	0
18	21119498	.	G	A	10	4	14	0	0	14	0	0
18	21119562	.	G	A	9	8	17	0	0	17	0	0
18	21119579	.	A	T	10	9	19	0	0	19	0	0
18	21119854	.	T	C	5	9	14	0	1	15	0	0
18	21136729	.	C	T	16	17	33	0	2	35	0	0
18	21136948	.	C	T	15	26	41	0	1	42	0	0
18	21143473	.	A	T	17	23	40	0	0	40	0	0
18	21143787	.	C	A	14	15	29	0	0	29	0	0
18	21143938	.	C	G	13	15	28	0	1	29	0	0
18	21143998	.	C	T	13	17	30	0	1	31	0	0
18	21144005	.	C	A	11	17	28	0	2	30	0	0
18	21144060	.	G	A	0	18	18	0	12	30	0	0
18	21144800	.	A	T	5	4	9	0	0	9	0	0
18	21144880	.	G	T	11	13	24	0	0	24	0	0
18	21144965	.	G	C	0	5	5	0	3	8	0	0
18	21145142	.	A	G	14	5	19	0	0	19	0	0
18	21179325	.	T	C	10	0	10	0	7	17	0	0
18	21179730	.	A	G	7	7	14	5	0	19	0	0
18	21185167	.	A	G	9	22	31	0	0	31	0	0
18	21198961	.	G	T	12	13	25	0	0	25	0	0
18	21199165	.	G	T	15	7	22	0	4	26	0	0
18	21199515	.	T	C	26	23	49	1	4	54	0	0
18	21214976	.	T	C	28	13	41	0	2	43	0	0
18	21218734	.	G	A	28	20	48	0	2	50	0	0
18	21257600	.	A	T	18	3	21	0	0	21	0	0
18	21257657	.	T	C	6	17	23	0	0	23	0	0
18	21257786	.	G	A	10	8	18	0	2	20	0	0
18	21257867	.	G	A	4	13	17	0	0	18	1	0
18	21257946	.	C	T	18	14	32	0	0	32	0	0
18	21258083	.	G	A	12	7	19	0	2	21	0	0
18	21263120	.	G	A	7	13	20	0	1	21	0	0
18	21266815	.	A	G	10	3	13	0	1	15	1	0
18	21266885	.	G	A	10	7	17	0	0	17	0	0
18	21492325	.	T	C	20	18	38	0	2	40	0	0
18	21617864	.	G	A	1	31	32	0	32	64	0	0
18	21618343	.	C	T	21	26	47	0	0	47	0	0
18	21618379	.	A	G	27	18	45	0	0	45	0	0
18	21618496	.	G	A	18	24	42	0	2	44	0	0
18	21618659	.	C	A	17	20	37	0	1	38	0	0
18	21618731	.	G	T	28	17	45	0	3	48	0	0
18	21618910	.	G	T	25	22	47	1	2	50	0	0
18	21619011	.	C	T	23	32	55	0	1	56	0	0
18	21619018	.	A	T	22	35	57	0	0	57	0	0
18	21619055	.	G	T	21	25	46	0	0	46	0	0
18	21619260	.	C	T	20	19	39	0	2	41	0	0
18	21619284	.	G	T	18	19	37	1	0	38	0	0
18	21619672	.	A	G	25	21	46	2	0	48	0	0
18	21619686	.	G	A	23	19	42	2	1	45	0	0
18	21619777	.	A	G	38	25	63	2	1	66	0	0
18	21619799	.	T	G	28	31	59	0	4	63	0	0
18	21619948	.	C	T	24	19	43	1	1	45	0	0
18	21620082	.	A	T	28	14	42	0	0	43	1	0
18	21620376	.	A	C	15	26	41	0	0	41	0	0
18	21620426	.	G	A	4	13	17	0	31	48	0	0
18	21645492	.	G	A	6	15	21	0	0	21	0	0
18	21645627	.	A	G	6	6	12	0	0	12	0	0
18	21645902	.	G	C	22	1	23	0	15	38	0	0
18	21645965	.	G	A	13	20	33	0	3	36	0	0
18	21645989	.	T	G	17	16	33	0	0	33	0	0
18	21647419	.	T	C	8	10	18	0	0	18	0	0
18	21648522	.	C	T	14	7	21	0	0	21	0	0
18	21648582	.	A	G	13	7	20	0	1	21	0	0
18	21648627	.	C	T	6	9	15	0	2	17	0	0
18	21648633	.	A	T	7	9	16	0	0	16	0	0
18	21653937	.	C	T	15	15	30	0	0	30	0	0
18	21654124	.	A	C	8	0	8	0	10	18	0	0
18	21654145	.	C	T	10	10	20	0	1	21	0	0
18	21654375	.	C	A	8	5	13	0	0	13	0	0
18	21654432	.	T	C	13	9	22	0	0	22	0	0
18	21654489	.	C	T	6	10	16	0	0	16	0	0
18	21656271	.	C	A	8	3	11	0	0	11	0	0
18	21656274	.	G	A	4	7	11	0	0	11	0	0
18	21656605	.	C	T	10	12	22	0	1	23	0	0
18	21657642	.	T	G	8	6	14	0	0	14	0	0
18	21664864	.	G	A	6	10	16	0	0	16	0	0
18	21674320	.	G	T	4	13	17	0	0	17	0	0
18	21678723	.	G	A	8	6	14	0	0	14	0	0
18	21689043	.	G	C	5	6	11	0	0	11	0	0
18	21689052	.	A	G	7	4	11	0	0	11	0	0
18	21689079	.	G	A	2	6	8	0	0	8	0	0
18	21693213	.	G	A	7	7	14	0	0	14	0	0
18	21693441	.	G	A	4	7	11	0	0	11	0	0
18	21697776	.	C	T	12	4	16	0	1	17	0	0
18	21698855	.	G	T	4	7	11	0	1	12	0	0
18	21704498	.	C	T	0	3	3	0	4	7	0	0
18	21724220	.	G	T	3	3	6	0	0	6	0	0
18	21724334	.	G	A	2	9	11	0	1	12	0	0
18	21724407	.	C	T	3	6	9	0	0	9	0	0
18	21724480	.	A	G	3	3	6	0	0	6	0	0
18	21725161	.	G	T	2	4	6	0	0	7	1	0
18	21782445	.	T	G	6	2	8	0	0	8	0	0
18	21782467	.	A	C	5	2	7	0	0	7	0	0
18	21782908	.	G	A	6	5	11	0	0	11	0	0
18	21783009	.	T	G	7	4	11	0	0	11	0	0
18	21783010	.	A	C	7	4	11	0	0	11	0	0
18	21783049	.	G	C	5	3	8	0	0	8	0	0
18	21783257	.	G	T	3	8	11	0	0	11	0	0
18	21783279	.	G	A	6	2	8	0	0	8	0	0
18	21783325	.	A	T	1	6	7	0	0	7	0	0
18	21783368	.	G	A	4	9	13	0	0	13	0	0
18	21796094	.	G	A	4	3	7	0	0	7	0	0
18	21860755	.	C	T	8	7	15	0	1	16	0	0
18	21861134	.	T	A	8	11	19	0	1	20	0	0
18	21861225	.	T	A	13	12	25	0	2	27	0	0
18	21861381	.	G	T	9	10	19	0	2	21	0	0
18	21861497	.	A	T	10	5	15	0	1	16	0	0
18	21861688	.	C	A	4	5	9	0	0	10	1	0
18	21861749	.	T	C	8	2	10	0	0	10	0	0
18	21861779	.	G	T	9	3	12	1	0	13	0	0
18	21861934	.	C	T	5	2	7	0	0	7	0	0
18	21862000	.	G	C	4	7	11	0	1	12	0	0
18	21862076	.	C	T	1	4	5	2	10	17	0	0
18	21862175	.	C	T	2	4	6	0	7	13	0	0
18	21862237	.	G	T	5	4	9	0	0	9	0	0
18	21862346	.	T	A	12	6	18	0	1	19	0	0
18	21880098	.	T	C	10	0	10	0	14	24	0	0
18	21880191	.	T	C	4	0	4	0	10	14	0	0
18	21884647	.	T	A	2	4	6	17	0	23	0	0
18	21888256	.	C	T	9	6	15	0	0	15	0	0
18	21890428	.	G	C	4	3	7	0	0	7	0	0
18	21891024	.	G	T	8	7	15	0	0	15	0	0
18	21900940	.	A	G	2	3	5	0	0	5	0	0
18	21900961	.	G	A	3	3	6	0	1	7	0	0
18	21904816	.	C	T	0	7	7	0	6	13	0	0
18	21904846	.	T	A	5	9	14	0	0	14	0	0
18	21905255	.	T	C	4	0	4	0	7	11	0	0
18	21906745	.	G	A	5	3	8	0	1	9	0	0
18	21906838	.	C	T	5	4	9	0	2	11	0	0
18	21913799	.	A	T	19	6	25	0	2	27	0	0
18	21913907	.	G	C	18	11	29	0	2	31	0	0
18	21913988	.	C	A	21	13	34	0	0	34	0	0
18	21914018	.	C	A	19	12	31	0	1	32	0	0
18	21914225	.	C	T	1	15	16	0	12	28	0	0
18	21914281	.	G	A	13	11	24	0	0	24	0	0
18	21914283	.	C	A	14	11	25	0	0	25	0	0
18	22002476	.	G	A	9	10	19	0	0	19	0	0
18	22002508	.	C	T	16	11	27	0	1	28	0	0
18	22029828	.	A	C	9	0	9	0	10	19	0	0
18	22030967	.	G	A	5	8	13	0	0	13	0	0
18	22030995	.	A	C	5	7	12	0	1	13	0	0
18	22031018	.	T	G	4	7	11	0	0	11	0	0
18	22082366	.	T	C	6	8	14	0	0	14	0	0
18	22232712	.	G	T	0	2	2	0	4	6	0	0
18	22232775	.	T	C	1	8	9	0	0	9	0	0
18	22255005	.	C	T	5	7	12	0	0	12	0	0
18	22261064	.	C	A	4	5	9	0	1	10	0	0
18	22267741	.	C	T	6	3	9	0	0	9	0	0
18	22272969	.	C	A	11	9	20	0	1	21	0	0
18	22275051	.	T	C	9	11	20	0	0	20	0	0
18	22282766	.	A	T	10	13	23	0	2	25	0	0
18	22282809	.	A	T	9	9	18	0	0	18	0	0
18	22282923	.	G	T	10	10	20	0	2	22	0	0
18	22282960	.	C	T	12	8	20	0	1	21	0	0
18	22282961	.	A	G	12	8	20	0	2	22	0	0
18	22283087	.	C	A	7	6	13	0	1	14	0	0
18	22283116	.	T	A	9	6	15	0	0	15	0	0
18	22287540	.	G	T	1	2	3	0	0	3	0	0
18	22288650	.	T	C	11	12	23	0	1	24	0	0
18	22288659	.	C	T	13	14	27	0	0	27	0	0
18	22289075	.	T	C	10	11	21	0	1	22	0	0
18	22289314	.	C	T	21	11	32	0	0	32	0	0
18	22290900	.	G	A	19	21	40	0	2	42	0	0
18	22290933	.	C	T	13	19	32	0	2	34	0	0
18	22292215	.	A	T	15	9	24	0	0	24	0	0
18	22292286	.	G	A	13	15	28	0	1	29	0	0
18	22292339	.	A	T	11	12	23	0	4	27	0	0
18	22356989	.	C	T	13	12	25	0	1	26	0	0
18	22377096	.	A	T	29	12	41	0	2	43	0	0
18	22377372	.	G	A	2	30	32	0	17	49	0	0
18	22377471	.	C	T	14	16	30	0	4	34	0	0
18	22385900	.	G	A	24	22	46	0	3	49	0	0
18	22405895	.	A	T	3	4	7	0	1	8	0	0
18	22406162	.	C	T	1	2	3	0	1	4	0	0
18	22406187	.	T	A	4	3	7	0	0	7	0	0
18	22406375	.	T	A	6	4	10	0	0	10	0	0
18	22406379	.	G	A	4	5	9	0	0	9	0	0
18	22406728	.	A	T	1	5	6	0	0	6	0	0
18	22406973	.	T	C	1	3	4	0	0	4	0	0
18	22407365	.	C	T	1	4	5	0	2	7	0	0
18	22414542	.	T	G	1	4	5	0	1	6	0	0
18	22417058	.	C	T	12	7	19	0	0	19	0	0
18	22417082	.	G	A	3	6	9	0	10	19	0	0
18	22417103	.	C	A	10	6	16	0	2	18	0	0
18	22420551	.	A	T	3	4	7	0	1	8	0	0
18	22420558	.	C	A	4	4	8	0	1	9	0	0
18	22424532	.	T	C	9	4	13	0	1	14	0	0
18	22424536	.	A	G	10	1	11	0	4	15	0	0
18	22424601	.	A	G	12	0	12	0	9	21	0	0
18	22486579	.	A	T	7	3	10	0	0	10	0	0
18	22669708	.	C	G	7	8	15	0	1	16	0	0
18	22679242	.	A	T	4	4	8	0	0	8	0	0
18	22679275	.	C	T	7	3	10	0	1	11	0	0
18	22679339	.	C	T	7	7	14	0	0	14	0	0
18	22679394	.	C	T	6	2	8	0	1	9	0	0
18	22679444	.	T	G	5	6	11	0	0	11	0	0
18	22679540	.	C	T	4	5	9	0	0	9	0	0
18	22679684	.	G	A	5	5	10	0	0	10	0	0
18	22679786	.	C	T	5	6	11	0	0	11	0	0
18	22679834	.	C	T	2	5	7	0	1	8	0	0
18	22679852	.	C	T	4	2	6	0	1	7	0	0
18	22685266	.	G	A	0	11	11	0	10	21	0	0
18	22685278	.	C	T	14	6	20	0	0	20	0	0
18	22685329	.	T	C	6	14	20	0	1	21	0	0
18	22685380	.	A	T	5	11	16	0	0	16	0	0
18	22685608	.	C	A	12	3	15	0	0	15	0	0
18	22686269	.	A	T	7	10	17	0	0	17	0	0
18	22686320	.	G	A	4	4	8	0	0	8	0	0
18	22686588	.	C	A	5	5	10	0	0	10	0	0
18	22686723	.	C	T	10	9	19	0	0	19	0	0
18	22686789	.	G	A	12	11	23	0	1	24	0	0
18	22686795	.	C	G	11	11	22	0	1	23	0	0
18	22686927	.	G	A	0	12	12	0	0	12	0	0
18	22687312	.	G	A	9	15	24	0	0	24	0	0
18	22687388	.	A	C	13	0	13	1	0	14	0	0
18	22687439	.	A	G	6	0	6	0	10	16	0	0
18	22687527	.	G	C	8	19	27	0	1	28	0	0
18	22687575	.	T	A	16	22	38	0	1	39	0	0
18	22687599	.	A	T	24	12	36	0	0	36	0	0
18	22687666	.	C	T	20	12	32	2	0	34	0	0
18	22728794	.	A	G	17	10	27	0	2	29	0	0
18	22732391	.	A	G	10	18	28	0	0	28	0	0
18	22921942	.	C	T	19	39	58	0	0	58	0	0
18	22921950	.	T	C	21	34	55	0	0	55	0	0
18	22975090	.	T	C	31	32	63	0	0	63	0	0
18	22975297	.	A	C	32	22	54	0	1	55	0	0
18	23071331	.	C	T	1	3	4	0	2	6	0	0
18	23200303	.	G	A	1	9	10	0	17	27	0	0
18	23249388	.	G	A	4	11	15	0	8	23	0	0
18	23270093	.	C	T	8	8	16	0	0	16	0	0
18	23869784	.	T	A	26	15	41	0	1	42	0	0
18	23875111	.	A	C	10	17	27	0	1	28	0	0
18	24922124	.	C	A	3	3	6	0	0	6	0	0
18	24922149	.	G	A	10	2	12	0	0	12	0	0
18	24926768	.	A	G	15	1	16	0	14	30	0	0
18	24926925	.	T	C	8	11	19	0	1	20	0	0
18	24928941	.	A	G	15	9	24	0	0	24	0	0
18	24929079	.	T	G	10	11	21	0	0	21	0	0
18	24929406	.	A	G	10	0	10	0	9	19	0	0
18	24929413	.	G	A	9	9	18	0	1	19	0	0
18	24929465	.	T	C	11	12	23	0	1	24	0	0
18	24929633	.	C	T	11	9	20	0	0	20	0	0
18	24929720	.	C	T	13	16	29	0	1	30	0	0
18	24930530	.	T	C	11	14	25	0	0	25	0	0
18	24931326	.	G	A	14	10	24	0	0	24	0	0
18	24931699	.	T	C	10	17	27	0	1	28	0	0
18	24933638	.	C	G	4	5	9	0	2	11	0	0
18	24933769	.	C	A	11	10	21	0	0	21	0	0
18	24933799	.	A	G	12	16	28	0	0	28	0	0
18	24934333	.	A	T	12	8	20	0	1	21	0	0
18	24934719	.	G	C	8	10	18	0	1	19	0	0
18	24934950	.	G	A	5	7	12	0	0	12	0	0
18	24935099	.	A	G	15	15	30	0	2	32	0	0
18	24938712	.	A	G	4	13	17	0	1	18	0	0
18	24938805	.	A	G	10	11	21	0	2	23	0	0
18	24938871	.	T	C	11	10	21	0	2	23	0	0
18	24938919	.	C	T	8	7	15	0	2	17	0	0
18	24944039	.	A	T	11	8	19	0	1	20	0	0
18	24944045	.	T	C	11	7	18	0	1	19	0	0
18	24946637	.	T	C	12	11	23	1	0	24	0	0
18	24946727	.	T	A	7	9	16	0	1	17	0	0
18	24947678	.	A	G	9	6	15	0	0	15	0	0
18	24950214	.	C	T	7	9	16	0	1	17	0	0
18	24952182	.	G	A	5	9	14	0	0	14	0	0
18	24959289	.	G	A	5	4	9	0	0	9	0	0
18	24964401	.	T	C	8	4	12	0	0	12	0	0
18	24989420	.	G	A	6	2	8	0	0	8	0	0
18	24989427	.	G	T	7	3	10	0	0	10	0	0
18	24990332	.	A	G	1	3	4	0	0	4	0	0
18	25003359	.	A	T	14	10	24	0	0	24	0	0
18	25003448	.	G	C	13	16	29	0	0	29	0	0
18	25009233	.	C	T	13	15	28	0	0	28	0	0
18	25009253	.	C	T	15	15	30	0	0	30	0	0
18	25009326	.	C	A	14	10	24	0	0	24	0	0
18	25009407	.	T	C	13	10	23	0	0	23	0	0
18	25027675	.	T	A	1	2	3	0	1	4	0	0
18	25028181	.	C	A	0	4	4	0	6	10	0	0
18	25037057	.	T	A	1	3	4	0	0	4	0	0
18	25046163	.	G	A	3	2	5	0	0	5	0	0
18	25051450	.	A	G	1	3	4	0	0	4	0	0
18	25084441	.	C	T	2	2	4	0	0	4	0	0
18	25092162	.	C	T	1	3	4	0	4	8	0	0
18	25177158	.	C	T	5	3	8	0	0	8	0	0
18	25569167	.	T	C	5	5	10	0	0	10	0	0
18	25577706	.	C	T	7	2	9	0	0	9	0	0
18	25602074	.	A	C	2	0	2	0	3	5	0	0
18	25752722	.	G	A	21	12	33	0	0	33	0	0
18	25754551	.	G	A	11	5	16	0	0	16	0	0
18	25754580	.	G	T	8	5	13	0	0	13	0	0
18	25754690	.	T	G	2	5	7	0	0	7	0	0
18	25754693	.	A	G	2	0	2	0	5	7	0	0
18	25783752	.	G	A	2	8	10	0	0	10	0	0
18	25783812	.	T	A	5	5	10	0	0	10	0	0
18	25783851	.	C	G	4	2	6	0	0	6	0	0
18	25784196	.	A	T	6	4	10	0	1	11	0	0
18	25796565	.	G	A	3	3	6	0	1	7	0	0
18	25825107	.	G	A	3	3	6	0	2	8	0	0
18	25855449	.	A	G	1	3	4	0	0	4	0	0
18	26088814	.	G	A	0	2	2	0	4	6	0	0
18	26088830	.	T	C	4	3	7	0	0	7	0	0
18	26089028	.	C	G	10	3	13	0	0	13	0	0
18	26089254	.	A	T	7	4	11	0	0	11	0	0
18	26089305	.	G	C	9	7	16	0	0	16	0	0
18	26089657	.	C	T	3	5	8	0	0	8	0	0
18	26097091	.	G	T	27	36	63	0	2	65	0	0
18	26097428	.	G	A	28	32	60	0	8	68	0	0
18	26099274	.	A	T	34	36	70	0	1	72	1	0
18	26338420	.	C	T	9	15	24	0	1	25	0	0
18	26389326	.	G	A	18	11	29	0	1	30	0	0
18	26389401	.	C	T	22	20	42	0	0	42	0	0
18	26393716	.	C	A	27	21	48	0	2	50	0	0
18	26401680	.	T	C	31	18	49	0	4	53	0	0
18	26401719	.	T	C	31	31	62	0	2	64	0	0
18	26401938	.	A	C	20	25	45	0	1	46	0	0
18	26410176	.	T	C	19	5	24	0	1	25	0	0
18	26417753	.	G	A	1	20	21	0	16	37	0	0
18	26425376	.	G	A	3	6	9	0	1	10	0	0
18	26425485	.	A	G	7	5	12	0	0	12	0	0
18	26428415	.	A	T	2	4	6	0	0	6	0	0
18	26460723	.	G	T	9	10	19	0	1	20	0	0
18	26460747	.	G	T	11	6	17	0	0	17	0	0
18	26460773	.	A	T	10	5	15	0	1	16	0	0
18	26460822	.	G	C	6	9	15	0	1	16	0	0
18	26460846	.	C	A	5	12	17	0	0	17	0	0
18	26476088	.	G	A	7	4	11	0	0	11	0	0
18	26479092	.	C	T	5	6	11	0	0	11	0	0
18	26480138	.	T	A	3	7	10	0	0	10	0	0
18	26492859	.	A	G	6	7	13	0	1	14	0	0
18	26502584	.	A	G	4	6	10	1	1	12	0	0
18	26686926	.	T	C	3	0	3	0	2	5	0	0
18	26785160	.	A	C	3	1	4	0	1	5	0	0
18	26785162	.	T	A	3	2	5	0	0	5	0	0
18	26790510	.	A	T	15	13	28	0	0	28	0	0
18	26797112	.	G	A	9	7	16	0	0	16	0	0
18	26800148	.	A	C	12	6	18	0	0	18	0	0
18	26800167	.	C	G	10	6	16	0	0	16	0	0
18	26804218	.	G	A	10	5	15	0	0	15	0	0
18	26804233	.	T	A	12	4	16	0	1	17	0	0
18	26807229	.	T	A	4	7	11	0	1	12	0	0
18	26807304	.	C	T	5	7	12	0	0	12	0	0
18	26809791	.	G	T	8	6	14	0	1	15	0	0
18	26810019	.	T	C	2	4	6	0	1	7	0	0
18	26810034	.	C	T	3	3	6	0	0	6	0	0
18	26810073	.	G	A	5	3	8	0	0	8	0	0
18	26810434	.	G	C	3	4	7	0	0	7	0	0
18	26811801	.	T	G	5	3	8	0	0	9	1	0
18	26863666	.	T	C	2	0	2	0	9	11	0	0
18	26870137	.	G	A	3	8	11	0	2	13	0	0
18	26885718	.	C	T	2	2	4	0	0	4	0	0
18	26891644	.	C	G	2	5	7	0	0	7	0	0
18	26891744	.	A	G	2	5	7	0	0	7	0	0
18	26891752	.	A	G	1	6	7	0	0	7	0	0
18	26891823	.	G	C	5	6	11	0	0	11	0	0
18	26894677	.	G	A	4	5	9	0	0	9	0	0
18	26896160	.	G	C	1	10	11	0	7	18	0	0
18	26896277	.	T	C	10	14	24	0	0	24	0	0
18	26896571	.	C	T	6	4	10	0	0	10	0	0
18	26899453	.	T	C	21	22	43	0	1	44	0	0
18	26919226	.	C	T	17	7	24	0	0	24	0	0
18	26919227	.	T	A	17	7	24	0	0	24	0	0
18	26919865	.	T	C	7	5	12	0	1	13	0	0
18	26919989	.	T	A	25	14	39	0	2	41	0	0
18	26968799	.	G	A	10	5	15	0	1	16	0	0
18	26968822	.	T	C	11	1	12	0	6	18	0	0
18	26971513	.	G	A	4	6	10	0	0	10	0	0
18	26972034	.	A	G	6	2	8	0	0	8	0	0
18	26977226	.	T	C	3	4	7	0	0	7	0	0
18	26977837	.	C	T	2	7	9	0	1	10	0	0
18	27008019	.	T	A	1	2	3	0	0	3	0	0
18	27040523	.	C	T	2	3	5	0	0	5	0	0
18	27054937	.	G	A	1	2	3	0	0	3	0	0
18	27063668	.	G	A	0	2	2	0	2	4	0	0
18	27063722	.	C	T	3	3	6	0	0	6	0	0
18	27080211	.	A	G	1	2	3	0	0	3	0	0
18	27080648	.	G	A	3	3	6	0	0	6	0	0
18	27081050	.	C	T	4	3	7	0	0	7	0	0
18	27081056	.	T	C	4	2	6	0	1	7	0	0
18	27081199	.	G	C	2	2	4	0	0	4	0	0
18	27081275	.	A	G	2	8	10	0	0	10	0	0
18	27085023	.	A	C	4	2	6	0	0	6	0	0
18	27085467	.	T	G	2	3	5	0	0	5	0	0
18	27198125	.	G	T	3	2	5	0	0	5	0	0
18	27224898	.	C	T	3	3	6	0	0	6	0	0
18	27252310	.	G	A	1	3	4	0	0	4	0	0
18	27252377	.	C	A	2	2	4	0	0	4	0	0
18	27252386	.	C	T	2	2	4	0	0	4	0	0
18	27252533	.	G	A	1	3	4	0	0	4	0	0
18	27254538	.	G	A	4	2	6	0	0	6	0	0
18	27254774	.	T	C	1	2	3	0	1	4	0	0
18	27254790	.	T	A	2	2	4	0	0	4	0	0
18	27259047	.	A	G	4	0	4	0	4	8	0	0
18	27259397	.	C	T	1	3	4	0	0	4	0	0
18	27281456	.	A	G	5	3	8	0	0	8	0	0
18	27281673	.	T	G	1	6	7	0	0	7	0	0
18	27281679	.	A	G	2	0	2	0	4	6	0	0
18	27285741	.	C	T	2	6	8	0	0	8	0	0
18	27288580	.	G	A	4	2	6	0	0	6	0	0
18	27288616	.	T	C	2	2	4	0	1	5	0	0
18	27309512	.	T	C	4	2	6	0	1	7	0	0
18	27309713	.	C	A	5	4	9	0	0	9	0	0
18	27309716	.	G	A	5	4	9	0	0	9	0	0
18	27309873	.	C	T	16	13	29	0	1	30	0	0
18	27335583	.	T	C	8	10	18	1	1	20	0	0
18	27335597	.	G	A	9	14	23	1	0	24	0	0
18	27335780	.	A	T	6	10	16	0	0	16	0	0
18	27335828	.	A	G	6	8	14	0	0	14	0	0
18	27335935	.	T	A	6	7	13	0	0	13	0	0
18	27340996	.	A	T	6	6	12	0	0	12	0	0
18	27341313	.	G	A	2	4	6	0	0	6	0	0
18	27341433	.	A	G	1	5	6	0	2	8	0	0
18	27357391	.	T	A	6	2	8	0	2	10	0	0
18	27358499	.	G	A	3	5	8	0	1	9	0	0
18	27358709	.	A	G	2	7	9	0	1	10	0	0
18	27358787	.	T	C	2	7	9	0	0	9	0	0
18	27358841	.	C	T	3	2	5	0	0	5	0	0
18	27358844	.	C	T	3	2	5	0	0	5	0	0
18	27439981	.	T	A	18	7	25	0	0	25	0	0
18	33729756	.	T	G	3	3	6	2	0	8	0	0
18	36598337	.	A	G	3	4	7	0	0	7	0	0
18	36869846	.	A	G	19	7	26	0	0	26	0	0
18	39172728	.	A	T	3	11	14	0	1	15	0	0
18	39523000	.	G	T	1	2	3	0	0	3	0	0
18	40370564	.	A	G	8	4	12	0	3	15	0	0
18	40373365	.	C	T	3	8	11	0	0	11	0	0
18	40375564	.	C	T	8	5	13	0	0	13	0	0
18	40379477	.	G	T	1	8	9	0	3	12	0	0
18	40379516	.	C	T	7	6	13	0	0	13	0	0
18	40379556	.	T	A	5	2	7	0	0	7	0	0
18	40379560	.	C	T	3	3	6	0	2	8	0	0
18	40379612	.	G	A	4	4	8	0	0	8	0	0
18	40382019	.	A	G	3	0	3	0	5	8	0	0
18	40383282	.	T	A	19	7	26	0	0	26	0	0
18	40383665	.	T	A	12	5	17	0	1	18	0	0
18	40384022	.	G	T	0	10	10	0	12	22	0	0
18	40384160	.	C	T	3	12	15	0	0	15	0	0
18	40384214	.	T	C	6	11	17	0	0	17	0	0
18	40384253	.	A	G	4	14	18	0	1	19	0	0
18	40384277	.	T	A	3	15	18	0	1	19	0	0
18	40387506	.	C	T	12	10	22	0	0	22	0	0
18	40387606	.	G	A	8	7	15	0	0	15	0	0
18	40387650	.	T	A	13	9	22	0	0	22	0	0
18	40387811	.	T	A	3	4	7	0	0	7	0	0
18	40476366	.	T	A	1	2	3	0	0	3	0	0
18	40476686	.	C	T	1	2	3	0	0	3	0	0
18	40476697	.	C	T	1	2	3	0	0	3	0	0
18	40480336	.	T	C	1	2	3	0	0	3	0	0
18	40480383	.	A	G	3	5	8	0	1	9	0	0
18	40480416	.	A	G	5	3	8	0	1	9	0	0
18	40480440	.	C	T	5	2	7	0	1	8	0	0
18	40486632	.	A	G	2	4	6	0	0	6	0	0
18	40489539	.	G	A	5	5	10	0	1	11	0	0
18	40492204	.	C	T	6	2	8	0	1	9	0	0
18	40492253	.	T	C	11	6	17	0	2	19	0	0
18	40669765	.	T	C	3	2	5	0	0	5	0	0
18	40762407	.	C	A	3	2	5	0	0	5	0	0
18	41267668	.	A	G	7	8	15	0	0	15	0	0
18	41267988	.	T	A	9	6	15	0	0	15	0	0
18	41278299	.	G	A	11	11	22	0	1	23	0	0
18	41278644	.	T	C	5	4	9	0	1	10	0	0
18	41284700	.	C	T	13	10	23	0	0	23	0	0
18	41293901	.	A	T	5	7	12	0	0	12	0	0
18	41295246	.	C	T	18	13	31	0	1	32	0	0
18	41297082	.	C	T	12	11	23	0	3	26	0	0
18	41305867	.	C	T	8	6	14	0	0	14	0	0
18	41309305	.	G	A	13	22	35	0	0	35	0	0
18	41309583	.	T	G	5	1	6	0	7	13	0	0
18	41310464	.	G	A	1	13	14	0	10	24	0	0
18	41364527	.	C	G	6	3	9	0	1	10	0	0
18	41364697	.	T	C	5	0	5	0	3	8	0	0
18	41365011	.	A	G	4	4	8	0	0	8	0	0
18	41365023	.	C	T	6	2	8	0	0	8	0	0
18	41365125	.	G	A	3	6	9	0	0	9	0	0
18	41365236	.	C	A	4	3	7	0	0	7	0	0
18	41365434	.	G	A	4	4	8	0	0	8	0	0
18	41365482	.	C	T	4	2	6	0	0	6	0	0
18	41365649	.	G	T	5	4	9	0	1	10	0	0
18	41372193	.	G	A	2	2	4	0	0	4	0	0
18	41372345	.	G	A	4	2	6	0	0	6	0	0
18	41448136	.	T	G	1	2	3	0	0	3	0	0
18	41495859	.	A	G	18	19	37	0	0	37	0	0
18	41495865	.	A	T	17	18	35	0	1	36	0	0
18	41499590	.	T	C	26	18	44	2	1	47	0	0
18	41499679	.	A	G	16	12	28	0	1	29	0	0
18	41499683	.	T	C	16	12	28	0	1	29	0	0
18	41499789	.	C	T	19	16	35	0	0	35	0	0
18	41503578	.	C	A	28	18	46	0	2	48	0	0
18	41505624	.	A	G	27	0	27	0	17	44	0	0
18	41509564	.	C	G	24	8	32	0	0	32	0	0
18	41509716	.	G	T	13	6	19	0	0	19	0	0
18	41512217	.	C	T	18	12	30	0	0	30	0	0
18	41512370	.	G	A	10	8	18	0	0	18	0	0
18	41514977	.	C	A	6	6	12	0	1	13	0	0
18	41524354	.	G	A	28	23	51	0	0	51	0	0
18	41524364	.	C	A	29	22	51	0	0	51	0	0
18	41525864	.	T	C	22	20	42	0	0	42	0	0
18	41525880	.	G	A	1	20	21	0	23	44	0	0
18	41526014	.	C	G	19	0	19	0	15	34	0	0
18	41526026	.	A	G	20	11	31	0	1	32	0	0
18	41526247	.	T	A	12	18	30	0	1	31	0	0
18	41526299	.	T	A	11	11	22	0	2	24	0	0
18	41526318	.	A	G	12	12	24	0	0	24	0	0
18	41526380	.	C	T	2	6	8	0	1	9	0	0
18	41526381	.	T	C	5	3	8	0	1	9	0	0
18	41527949	.	T	A	2	2	4	0	0	4	0	0
18	41533072	.	C	T	6	8	14	1	0	15	0	0
18	41538770	.	G	A	8	14	22	0	0	22	0	0
18	41538795	.	A	G	4	14	18	0	0	18	0	0
18	41538856	.	G	A	4	9	13	0	0	13	0	0
18	41542632	.	A	G	1	6	7	1	0	8	0	0
18	41542790	.	T	G	2	3	5	0	0	5	0	0
18	41543076	.	C	T	14	4	18	0	0	18	0	0
18	41546938	.	C	G	4	3	7	0	0	7	0	0
18	41549766	.	G	A	1	3	4	0	0	4	0	0
18	41549817	.	T	A	1	7	8	0	0	8	0	0
18	41556239	.	G	A	0	4	4	0	3	7	0	0
18	41558711	.	C	T	1	4	5	0	0	5	0	0
18	41560857	.	G	T	4	3	7	0	1	8	0	0
18	41560923	.	C	T	1	8	9	0	0	9	0	0
18	41561057	.	C	A	7	3	10	0	0	10	0	0
18	41561127	.	T	C	5	6	11	0	0	11	0	0
18	41561248	.	C	T	7	6	13	0	0	13	0	0
18	41565692	.	T	C	6	4	10	0	0	10	0	0
18	41565731	.	G	A	2	3	5	0	0	5	0	0
18	41565746	.	G	A	1	4	5	0	3	8	0	0
18	41571740	.	A	G	8	5	13	0	0	13	0	0
18	41572423	.	A	C	4	5	9	0	0	9	0	0
18	41572445	.	T	C	6	5	11	0	0	11	0	0
18	41573681	.	T	C	3	4	7	0	0	7	0	0
18	41573696	.	A	G	3	4	7	0	1	8	0	0
18	41573813	.	A	G	6	0	6	0	13	19	0	0
18	41573948	.	G	A	2	14	16	0	3	19	0	0
18	41574155	.	A	G	4	6	10	0	0	10	0	0
18	41574287	.	T	C	5	3	8	0	0	8	0	0
18	41574340	.	C	T	2	4	6	0	0	6	0	0
18	41574557	.	T	C	5	7	12	0	0	12	0	0
18	41574608	.	T	C	6	11	17	0	0	17	0	0
18	41579975	.	T	A	9	11	20	0	0	20	0	0
18	41580151	.	A	T	7	5	12	0	0	12	0	0
18	41586440	.	T	C	16	6	22	0	1	23	0	0
18	41588148	.	A	G	12	1	13	0	8	21	0	0
18	41588166	.	C	T	13	8	21	0	0	21	0	0
18	41589613	.	A	C	5	10	15	0	1	16	0	0
18	41648941	.	T	C	14	6	20	0	0	20	0	0
18	41649061	.	C	T	10	7	17	0	0	17	0	0
18	41649571	.	A	G	8	8	16	0	1	17	0	0
18	41649949	.	C	T	0	5	5	0	4	9	0	0
18	41650171	.	C	T	8	6	14	0	0	14	0	0
18	41650222	.	C	T	9	15	24	0	0	24	0	0
18	41650396	.	G	A	9	3	12	0	1	13	0	0
18	41757350	.	C	A	11	7	18	0	2	20	0	0
18	41757373	.	G	C	18	8	26	0	0	26	0	0
18	41757449	.	G	A	17	25	42	0	1	43	0	0
18	41757454	.	G	A	19	24	43	0	0	43	0	0
18	41757669	.	C	T	23	32	55	0	1	56	0	0
18	41764434	.	G	A	22	29	51	0	0	51	0	0
18	41764452	.	G	C	21	0	21	0	31	52	0	0
18	41772570	.	C	T	1	2	3	0	0	3	0	0
18	41784170	.	T	C	2	2	4	0	0	4	0	0
18	41832317	.	T	C	1	2	3	0	0	3	0	0
18	42151412	.	A	C	15	0	15	0	15	30	0	0
18	42165295	.	A	C	5	7	12	0	1	13	0	0
18	42171988	.	T	C	12	0	12	0	7	19	0	0
18	42189660	.	G	A	14	5	19	0	0	19	0	0
18	42189675	.	A	C	11	0	11	0	8	19	0	0
18	42201141	.	C	G	12	7	19	0	0	19	0	0
18	42215403	.	C	T	7	7	14	0	1	15	0	0
18	42276336	.	T	C	5	8	13	0	0	13	0	0
18	42313749	.	T	C	4	3	7	0	0	7	0	0
18	42333382	.	C	T	10	4	14	0	1	15	0	0
18	42394968	.	A	G	4	8	12	0	0	12	0	0
18	43162650	.	T	C	22	18	40	0	2	42	0	0
18	43183845	.	T	C	15	14	29	0	0	29	0	0
18	43225614	.	T	C	20	24	44	0	1	45	0	0
18	43225650	.	C	T	23	23	46	0	1	47	0	0
18	43225683	.	C	T	27	28	55	0	0	55	0	0
18	43225896	.	C	T	30	25	55	0	1	56	0	0
18	43439265	.	T	A	3	3	6	0	0	6	0	0
18	44321063	.	A	G	2	3	5	0	1	6	0	0
18	44321260	.	T	A	6	5	11	0	0	11	0	0
18	44321323	.	C	T	4	4	8	0	1	9	0	0
18	44321909	.	G	A	3	2	5	0	2	7	0	0
18	44321949	.	T	C	2	3	5	0	1	6	0	0
18	44322043	.	T	A	1	3	4	0	0	4	0	0
18	44322053	.	T	C	0	4	4	0	0	4	0	0
18	44322280	.	T	C	3	3	6	0	0	6	0	0
18	44322377	.	T	C	1	5	6	0	0	6	0	0
18	44322481	.	C	T	1	8	9	0	5	14	0	0
18	44325470	.	A	G	5	11	16	0	0	16	0	0
18	44325526	.	A	T	8	3	11	0	2	13	0	0
18	44327944	.	A	G	7	8	15	0	1	16	0	0
18	44327953	.	G	A	6	6	12	0	2	14	0	0
18	44331117	.	G	C	7	7	14	0	0	14	0	0
18	44334889	.	C	T	6	11	17	0	1	18	0	0
18	44345920	.	T	C	4	0	4	0	4	8	0	0
18	44346102	.	C	T	2	3	5	0	0	5	0	0
18	44349089	.	C	T	4	3	7	0	0	7	0	0
18	44351151	.	G	C	4	0	4	0	9	13	0	0
18	44351202	.	C	A	4	4	8	0	0	8	0	0
18	44354930	.	A	G	3	2	5	0	0	5	0	0
18	44355473	.	A	G	3	4	7	0	0	7	0	0
18	44355485	.	G	A	3	4	7	0	0	7	0	0
18	44359312	.	T	C	3	3	6	0	0	6	0	0
18	44364647	.	C	A	26	20	46	0	0	46	0	0
18	44365064	.	C	A	25	29	54	0	0	55	1	0
18	44365114	.	T	A	30	30	60	0	0	60	0	0
18	44365714	.	C	A	28	20	48	1	3	52	0	0
18	44365717	.	A	G	29	22	51	1	0	52	0	0
18	44365977	.	T	C	18	23	41	0	1	42	0	0
18	44365987	.	T	A	21	21	42	0	2	44	0	0
18	44367241	.	A	T	19	23	42	0	2	44	0	0
18	44367426	.	C	T	31	25	56	0	0	56	0	0
18	44367488	.	G	A	23	38	61	0	1	62	0	0
18	44377404	.	C	A	20	16	36	1	0	37	0	0
18	44377417	.	C	T	20	15	35	1	0	36	0	0
18	44388421	.	C	T	22	22	44	0	0	44	0	0
18	44397330	.	G	A	25	18	43	0	2	45	0	0
18	44404609	.	C	T	34	26	60	0	1	61	0	0
18	44404872	.	C	T	22	29	51	0	0	51	0	0
18	44408841	.	G	A	18	23	41	3	0	44	0	0
18	44418164	.	C	T	23	23	46	0	1	47	0	0
18	44425093	.	A	G	21	28	49	0	3	52	0	0
18	44425105	.	C	T	18	30	48	0	2	50	0	0
18	44425150	.	A	C	24	22	46	0	0	46	0	0
18	44453365	.	G	A	21	22	43	1	0	44	0	0
18	44453377	.	G	C	24	0	24	1	19	44	0	0
18	44567334	.	G	T	3	5	8	0	0	8	0	0
18	44567352	.	C	A	5	2	7	0	0	8	1	0
18	44568226	.	G	T	3	4	7	0	0	7	0	0
18	44569758	.	A	C	3	4	7	0	0	7	0	0
18	44569801	.	T	C	6	2	8	0	0	8	0	0
18	44569847	.	A	G	7	4	11	0	0	11	0	0
18	44569895	.	C	T	6	2	8	0	0	8	0	0
18	44576845	.	C	T	3	2	5	0	0	5	0	0
18	44579965	.	G	A	2	2	4	0	0	4	0	0
18	44580631	.	T	C	1	6	7	0	0	7	0	0
18	44587777	.	C	A	2	2	4	0	0	4	0	0
18	44589770	.	G	C	3	4	7	0	0	7	0	0
18	44597048	.	G	A	5	2	7	0	0	7	0	0
18	44597308	.	C	A	22	23	45	0	1	46	0	0
18	44597850	.	A	G	14	10	24	0	0	24	0	0
18	44597884	.	G	A	16	6	22	0	1	23	0	0
18	44598234	.	C	T	1	15	16	0	11	27	0	0
18	44598371	.	C	T	13	8	21	0	2	23	0	0
18	44599837	.	G	A	23	18	41	3	0	44	0	0
18	44606194	.	G	A	20	6	26	0	1	27	0	0
18	44615685	.	G	A	7	11	18	0	0	18	0	0
18	44615770	.	G	A	13	6	19	0	1	20	0	0
18	44615819	.	T	C	12	9	21	0	1	22	0	0
18	44615861	.	A	T	7	6	13	0	0	13	0	0
18	44618795	.	G	T	15	18	33	0	0	33	0	0
18	44619049	.	T	G	16	13	29	0	1	30	0	0
18	44623527	.	G	A	23	13	36	0	2	38	0	0
18	44632604	.	C	T	7	4	11	0	1	12	0	0
18	44633387	.	G	A	1	4	5	0	2	7	0	0
18	44637835	.	A	T	8	9	17	0	4	21	0	0
18	44637898	.	G	A	8	9	17	0	1	18	0	0
18	44638087	.	G	T	1	6	7	0	6	13	0	0
18	44640464	.	C	T	9	8	17	0	0	17	0	0
18	44640663	.	C	G	9	7	16	0	1	17	0	0
18	44642287	.	A	G	4	0	4	0	5	9	0	0
18	44645008	.	A	T	10	9	19	0	3	22	0	0
18	44645350	.	A	G	4	1	5	0	4	9	0	0
18	44645368	.	T	C	4	1	5	0	0	5	0	0
18	44645485	.	A	G	2	4	6	0	0	6	0	0
18	44645617	.	G	A	0	8	8	0	5	13	0	0
18	44645782	.	G	C	5	12	17	0	1	18	0	0
18	44645870	.	T	A	10	7	17	0	0	17	0	0
18	44646048	.	C	T	2	2	4	0	0	4	0	0
18	44646215	.	C	T	5	6	11	0	0	11	0	0
18	44646467	.	A	C	12	6	18	0	0	18	0	0
18	44646504	.	C	T	17	8	25	0	0	25	0	0
18	44646587	.	G	A	0	5	5	0	10	15	0	0
18	44646678	.	C	T	9	6	15	0	0	15	0	0
18	44646781	.	A	G	6	7	13	0	0	13	0	0
18	44674019	.	A	T	1	2	3	0	0	3	0	0
18	44682124	.	C	T	10	4	14	0	1	15	0	0
18	44682569	.	A	C	4	2	6	0	0	6	0	0
18	44692777	.	T	C	4	6	10	0	0	10	0	0
18	44696096	.	C	T	3	6	9	0	0	9	0	0
18	44696319	.	A	C	5	3	8	0	0	8	0	0
18	44696451	.	A	T	3	6	9	0	0	9	0	0
18	44763419	.	T	C	4	6	10	0	2	12	0	0
18	44764392	.	A	T	3	5	8	0	0	8	0	0
18	44765491	.	A	G	2	0	2	0	8	10	0	0
18	44779016	.	C	T	2	3	5	0	0	5	0	0
18	44779171	.	T	C	3	3	6	0	1	7	0	0
18	44779174	.	A	G	3	3	6	0	0	6	0	0
18	44779219	.	C	A	1	3	4	0	0	4	0	0
18	44781653	.	A	G	4	0	4	0	4	8	0	0
18	44783771	.	C	T	6	7	13	0	0	13	0	0
18	44790506	.	T	C	1	5	6	0	0	6	0	0
18	44790635	.	A	G	1	7	8	0	0	8	0	0
18	44790722	.	G	A	1	5	6	0	0	6	0	0
18	44791251	.	A	C	1	4	5	0	0	5	0	0
18	44791258	.	C	G	0	0	0	0	5	5	0	0
18	44801795	.	G	C	1	3	4	0	0	4	0	0
18	44820453	.	C	T	1	2	3	0	0	3	0	0
18	44826427	.	C	T	0	13	13	0	16	29	0	0
18	44826554	.	T	G	10	11	21	0	1	22	0	0
18	44826910	.	C	T	13	7	20	4	0	24	0	0
18	44830217	.	C	T	7	7	14	0	0	14	0	0
18	44830247	.	G	A	2	8	10	0	2	12	0	0
18	44830283	.	G	A	9	12	21	0	1	22	0	0
18	44832693	.	C	A	13	14	27	0	0	27	0	0
18	44834165	.	T	C	11	0	11	0	12	23	0	0
18	44837085	.	T	C	12	10	22	0	0	22	0	0
18	44838285	.	G	A	16	14	30	0	0	30	0	0
18	44838342	.	G	A	10	17	27	1	0	28	0	0
18	44840994	.	C	T	16	12	28	0	1	29	0	0
18	44843407	.	G	A	10	17	27	0	0	27	0	0
18	44843531	.	C	A	10	12	22	0	2	24	0	0
18	44852404	.	C	T	7	11	18	0	0	18	0	0
18	44857803	.	C	A	10	15	25	0	2	27	0	0
18	44866841	.	C	T	19	25	44	0	1	45	0	0
18	44870505	.	G	A	0	23	23	0	10	33	0	0
18	44870526	.	G	A	3	7	10	0	22	32	0	0
18	44870541	.	G	A	1	11	12	0	18	30	0	0
18	44873083	.	C	T	11	7	18	0	2	20	0	0
18	44873993	.	G	T	22	22	44	0	1	45	0	0
18	44874249	.	T	G	11	1	12	0	15	27	0	0
18	44874252	.	C	T	11	17	28	0	0	28	0	0
18	44913653	.	G	T	9	4	13	0	1	14	0	0
18	44913760	.	A	G	11	6	17	0	0	17	0	0
18	44913993	.	T	C	4	0	4	0	4	8	0	0
18	44927864	.	C	T	4	2	6	0	0	6	0	0
18	44935070	.	C	G	5	4	9	0	0	9	0	0
18	45114550	.	C	T	4	6	10	0	0	10	0	0
18	45231137	.	G	A	6	4	10	0	0	10	0	0
18	45235903	.	G	T	0	7	7	0	6	13	0	0
18	45235924	.	T	C	5	7	12	0	0	12	0	0
18	45248042	.	T	G	5	2	7	0	0	7	0	0
18	45257475	.	C	T	10	6	16	0	2	18	0	0
18	45259886	.	T	C	3	6	9	0	0	9	0	0
18	45259930	.	C	T	4	4	8	0	0	8	0	0
18	45260228	.	T	C	6	2	8	0	0	8	0	0
18	45260316	.	A	C	4	7	11	0	0	11	0	0
18	45260321	.	G	T	0	3	3	0	8	11	0	0
18	45260529	.	G	A	0	3	3	0	2	5	0	0
18	45261319	.	A	T	5	4	9	0	1	10	0	0
18	45261369	.	G	T	6	5	11	0	0	11	0	0
18	45261438	.	G	A	8	8	16	0	0	16	0	0
18	45261501	.	G	C	3	4	7	0	0	7	0	0
18	45261845	.	T	A	3	2	5	0	0	5	0	0
18	45261882	.	T	C	9	4	13	0	1	14	0	0
18	45262227	.	C	T	4	2	6	0	0	6	0	0
18	45262351	.	C	T	2	6	8	0	1	9	0	0
18	45262687	.	G	T	6	8	14	0	0	14	0	0
18	45262855	.	A	C	5	9	14	0	3	17	0	0
18	45262865	.	T	C	4	10	14	0	0	14	0	0
18	45543559	.	G	A	1	2	3	0	0	3	0	0
18	45550831	.	G	C	2	10	12	1	14	27	0	0
18	45550839	.	A	C	16	12	28	1	1	30	0	0
18	45561677	.	G	T	22	14	36	0	1	37	0	0
18	45569037	.	G	A	4	17	21	0	5	26	0	0
18	45569075	.	C	A	8	12	20	0	3	23	0	0
18	45569092	.	A	G	10	0	10	0	8	18	0	0
18	45574140	.	A	G	19	13	32	0	0	32	0	0
18	45574275	.	A	T	20	7	27	0	4	31	0	0
18	45575079	.	G	A	1	13	14	0	12	26	0	0
18	45581704	.	C	A	9	15	24	0	2	26	0	0
18	45581784	.	C	T	16	10	26	0	0	26	0	0
18	45583038	.	A	C	19	16	35	0	0	35	0	0
18	45583042	.	G	A	1	13	14	0	18	32	0	0
18	45584036	.	C	T	19	9	28	0	2	30	0	0
18	45584368	.	T	C	27	18	45	0	3	48	0	0
18	45588336	.	C	T	14	26	40	0	3	43	0	0
18	45591836	.	A	T	9	17	26	0	0	26	0	0
18	45591929	.	G	A	9	10	19	0	0	19	0	0
18	45647838	.	G	A	2	17	19	0	16	35	0	0
18	45647940	.	C	T	21	10	31	0	1	32	0	0
18	45649613	.	C	T	15	10	25	0	0	25	0	0
18	45649658	.	G	T	15	11	26	0	1	27	0	0
18	45651032	.	C	T	16	30	46	0	0	46	0	0
18	45651559	.	T	A	19	20	39	0	1	40	0	0
18	45656062	.	T	C	18	14	32	0	0	32	0	0
18	45656089	.	T	C	20	15	35	0	1	36	0	0
18	45677520	.	G	T	0	3	3	0	4	7	0	0
18	45681884	.	C	G	3	5	8	0	0	8	0	0
18	45682029	.	G	A	0	4	4	0	8	12	0	0
18	45682041	.	C	T	5	6	11	0	2	13	0	0
18	45684119	.	G	T	0	6	6	0	3	9	0	0
18	45684425	.	G	A	0	2	2	0	4	6	0	0
18	45684977	.	T	C	3	3	6	0	0	6	0	0
18	45685625	.	G	A	3	3	6	0	0	6	0	0
18	45685659	.	T	A	2	3	5	0	0	5	0	0
18	45685695	.	G	C	7	5	12	0	0	12	0	0
18	45685700	.	C	A	7	3	10	0	1	11	0	0
18	45686500	.	A	G	3	6	9	0	0	9	0	0
18	45686840	.	T	C	3	4	7	0	0	7	0	0
18	45686882	.	G	A	0	2	2	0	2	4	0	0
18	45687097	.	A	G	1	2	3	0	1	4	0	0
18	45687258	.	G	C	7	2	9	0	0	9	0	0
18	45687882	.	C	T	6	4	10	0	1	11	0	0
18	45689081	.	C	T	4	8	12	0	1	13	0	0
18	45691123	.	G	A	2	5	7	0	0	7	0	0
18	45697623	.	A	G	5	4	9	0	1	10	0	0
18	45697833	.	A	T	4	3	7	0	0	7	0	0
18	45697999	.	T	C	3	3	6	0	0	6	0	0
18	45698344	.	C	A	2	2	4	0	0	4	0	0
18	45734477	.	T	C	5	9	14	0	0	14	0	0
18	45742051	.	C	A	9	17	26	0	0	26	0	0
18	45742059	.	G	A	8	16	24	0	0	25	1	0
18	45743004	.	G	C	13	0	13	0	12	25	0	0
18	45743518	.	G	A	7	10	17	0	1	18	0	0
18	45743522	.	G	A	7	8	15	0	1	16	0	0
18	45743555	.	C	A	10	8	18	0	1	19	0	0
18	45745504	.	A	T	10	8	18	0	1	19	0	0
18	45750912	.	A	C	8	0	8	0	10	18	0	0
18	45750915	.	A	G	9	8	17	0	1	18	0	0
18	45752094	.	C	T	0	15	15	0	5	20	0	0
18	45759309	.	G	T	16	9	25	0	1	26	0	0
18	45784225	.	A	G	34	37	71	0	1	72	0	0
18	45807903	.	C	G	13	0	13	0	16	29	0	0
18	45807942	.	G	C	0	17	17	0	8	25	0	0
18	45809872	.	A	G	14	0	14	0	13	27	0	0
18	45809892	.	T	C	12	10	22	0	1	23	0	0
18	45813651	.	A	G	3	0	3	0	8	11	0	0
18	45818602	.	C	T	22	14	36	0	0	36	0	0
18	45820510	.	G	A	1	8	9	0	14	23	0	0
18	45820588	.	A	G	16	12	28	0	0	28	0	0
18	45824315	.	C	T	18	15	33	0	5	38	0	0
18	45824467	.	G	A	1	11	12	0	19	31	0	0
18	45824607	.	G	A	18	19	37	0	0	37	0	0
18	45835115	.	C	T	17	17	34	0	1	35	0	0
18	45840471	.	T	A	22	10	32	0	2	34	0	0
18	45840504	.	C	T	14	20	34	0	1	35	0	0
18	45842491	.	T	C	23	21	44	1	2	47	0	0
18	45842679	.	G	A	4	23	27	0	23	50	0	0
18	45844458	.	C	T	23	19	42	0	1	43	0	0
18	45844473	.	A	T	27	17	44	0	1	45	0	0
18	45848355	.	C	T	24	16	40	0	3	43	0	0
18	45849283	.	C	T	12	18	30	0	2	32	0	0
18	45851540	.	G	A	2	20	22	1	25	48	0	0
18	45873276	.	T	C	1	2	3	0	0	3	0	0
18	45884732	.	A	T	3	2	5	0	0	5	0	0
18	45886957	.	G	T	3	3	6	0	0	6	0	0
18	45914958	.	C	A	3	2	5	0	0	5	0	0
18	45932359	.	C	T	2	4	6	0	1	7	0	0
18	45934646	.	G	A	0	6	6	0	6	12	0	0
18	45934691	.	G	T	10	4	14	0	1	15	0	0
18	45936773	.	G	A	4	4	8	0	0	8	0	0
18	45938733	.	A	G	1	6	7	0	0	7	0	0
18	45944441	.	G	A	0	2	2	0	5	8	1	0
18	45944522	.	G	A	8	2	10	0	1	11	0	0
18	45944546	.	C	T	4	4	8	0	0	8	0	0
18	45944903	.	G	T	8	6	14	0	0	14	0	0
18	45947835	.	C	T	2	4	6	0	0	6	0	0
18	45947880	.	C	A	3	2	5	0	0	5	0	0
18	45948213	.	G	A	7	2	9	0	0	9	0	0
18	45962500	.	A	G	32	28	60	0	1	61	0	0
18	45962581	.	T	C	21	20	41	4	1	46	0	0
18	45962593	.	G	C	21	17	38	4	2	44	0	0
18	45962668	.	C	T	29	23	52	0	1	53	0	0
18	45969252	.	C	A	31	21	52	0	2	54	0	0
18	45979887	.	C	T	27	27	54	0	1	55	0	0
18	45983268	.	A	C	21	19	40	0	0	40	0	0
18	46012631	.	C	T	7	8	15	0	1	16	0	0
18	46015830	.	G	A	10	7	17	1	0	18	0	0
18	46057023	.	G	T	7	8	15	0	0	15	0	0
18	46059425	.	A	C	6	8	14	0	1	15	0	0
18	46061242	.	G	A	8	11	19	0	0	19	0	0
18	46061326	.	C	A	9	4	13	0	1	14	0	0
18	46063648	.	C	T	11	8	19	0	0	19	0	0
18	46367691	.	G	C	12	13	25	0	0	25	0	0
18	46367733	.	G	A	11	6	17	0	0	17	0	0
18	46367772	.	C	G	1	7	8	0	10	18	0	0
18	46368513	.	T	C	13	0	13	0	13	26	0	0
18	46368771	.	C	T	0	12	12	0	5	17	0	0
18	46368924	.	C	A	4	8	12	0	3	15	0	0
18	46369173	.	T	C	6	11	17	0	0	17	0	0
18	46417181	.	C	T	16	11	27	0	2	29	0	0
18	46417342	.	A	G	24	18	42	0	0	42	0	0
18	46417402	.	G	A	17	19	36	0	1	37	0	0
18	46417624	.	T	C	18	13	31	0	1	32	0	0
18	46417714	.	G	C	14	13	27	0	0	27	0	0
18	46417775	.	T	C	17	0	17	0	19	36	0	0
18	46418632	.	G	A	14	14	28	0	0	28	0	0
18	46418818	.	C	A	12	8	20	0	0	22	2	0
18	46418860	.	C	T	2	14	16	0	15	31	0	0
18	46418932	.	T	A	17	11	28	0	0	28	0	0
18	46419056	.	C	T	14	15	29	0	3	32	0	0
18	46419124	.	T	C	9	16	25	0	1	26	0	0
18	46419275	.	T	C	11	15	26	0	0	27	1	0
18	46419451	.	A	T	15	9	24	0	0	24	0	0
18	46419616	.	T	C	7	12	19	0	0	19	0	0
18	46634544	.	T	C	8	7	15	0	0	15	0	0
18	46635323	.	G	T	11	7	18	0	0	18	0	0
18	46635390	.	G	C	9	6	15	0	0	15	0	0
18	46635591	.	C	T	16	10	26	0	3	29	0	0
18	46635805	.	C	G	15	10	25	0	0	25	0	0
18	46653344	.	G	A	6	15	21	1	1	23	0	0
18	46684230	.	A	T	12	13	25	0	0	25	0	0
18	46684258	.	G	T	10	14	24	0	1	25	0	0
18	46699773	.	G	A	27	31	58	0	5	63	0	0
18	46702492	.	G	A	32	29	61	0	2	63	0	0
18	46714896	.	A	G	17	26	43	0	0	43	0	0
18	46729044	.	A	G	13	23	36	0	1	37	0	0
18	46729321	.	A	G	20	16	36	0	2	38	0	0
18	46732406	.	C	G	23	18	41	0	0	41	0	0
18	46732417	.	T	A	19	16	35	0	1	37	1	0
18	46735972	.	T	C	14	12	26	0	0	26	0	0
18	46738862	.	C	A	5	24	29	0	18	47	0	0
18	46738955	.	A	C	26	21	47	0	2	49	0	0
18	46738990	.	A	T	31	17	48	0	3	51	0	0
18	47095635	.	G	A	1	6	7	0	2	9	0	0
18	47301204	.	T	C	8	9	17	0	0	17	0	0
18	47305433	.	A	G	9	6	15	0	0	15	0	0
18	47306677	.	T	G	2	3	5	1	0	6	0	0
18	47523393	.	A	G	7	6	13	0	0	13	0	0
18	47566919	.	A	T	5	8	13	0	0	13	0	0
18	47567902	.	C	T	4	6	10	0	0	10	0	0
18	48620495	.	C	T	5	2	7	0	0	7	0	0
18	48640143	.	G	C	0	7	7	1	6	14	0	0
18	48640155	.	G	C	0	9	9	0	6	15	0	0
18	48640284	.	C	G	9	0	9	0	11	20	0	0
18	48640317	.	G	T	1	10	11	0	7	18	0	0
18	48640348	.	A	G	6	0	6	0	5	11	0	0
18	48640417	.	G	C	4	7	11	0	1	12	0	0
18	48640420	.	A	G	4	8	12	0	0	12	0	0
18	48641360	.	A	G	1	6	7	0	0	7	0	0
18	48641417	.	T	C	2	2	4	0	0	4	0	0
18	48641451	.	T	A	2	2	4	0	0	4	0	0
18	48642015	.	A	T	1	4	5	0	0	5	0	0
18	48642161	.	A	T	1	7	8	0	1	9	0	0
18	48642270	.	G	A	1	5	6	0	0	6	0	0
18	48642372	.	T	C	4	3	7	0	0	7	0	0
18	48642373	.	T	C	4	3	7	0	0	7	0	0
18	48642821	.	C	T	3	8	11	0	0	11	0	0
18	48642856	.	T	A	3	9	12	0	0	12	0	0
18	48642868	.	A	T	4	8	12	0	0	12	0	0
18	48643055	.	A	G	1	9	10	0	0	10	0	0
18	48715549	.	A	G	1	2	3	0	0	3	0	0
18	48715931	.	A	C	1	3	4	0	0	4	0	0
18	48794005	.	G	A	1	3	4	0	1	5	0	0
18	48803191	.	C	T	6	2	8	0	0	8	0	0
18	48807200	.	C	G	4	0	4	0	3	8	1	0
18	48807499	.	A	G	3	3	6	0	0	6	0	0
18	48807521	.	T	C	4	7	11	0	0	11	0	0
18	48808043	.	A	G	4	2	6	0	0	6	0	0
18	48808099	.	A	G	2	3	5	0	0	5	0	0
18	48808552	.	T	C	4	2	6	0	0	6	0	0
18	48808659	.	G	A	0	3	3	0	2	5	0	0
18	48808708	.	T	A	3	3	6	0	0	6	0	0
18	48864856	.	T	C	11	8	19	0	0	19	0	0
18	48864944	.	C	T	13	10	23	0	0	23	0	0
18	48898641	.	C	T	10	9	19	0	1	20	0	0
18	48928230	.	C	T	21	18	39	0	1	40	0	0
18	48928240	.	A	G	19	0	19	0	20	39	0	0
18	48928342	.	A	G	15	1	16	0	22	38	0	0
18	48928387	.	T	A	17	22	39	0	0	39	0	0
18	48934524	.	T	C	13	18	31	0	2	33	0	0
18	48934593	.	T	C	21	20	41	0	0	41	0	0
18	48934805	.	A	G	13	17	30	0	0	30	0	0
18	48934833	.	T	C	11	13	24	0	2	26	0	0
18	48935170	.	G	A	22	10	32	0	1	33	0	0
18	48935279	.	T	G	13	18	31	1	1	33	0	0
18	48935282	.	T	G	14	20	34	1	0	35	0	0
18	48935394	.	A	T	12	17	29	0	0	29	0	0
18	48935709	.	A	G	16	6	22	0	0	22	0	0
18	48935907	.	T	C	6	9	15	0	0	15	0	0
18	48957589	.	T	C	6	3	9	0	0	9	0	0
18	48957783	.	G	A	0	4	4	0	3	7	0	0
18	48957845	.	T	A	4	6	10	0	0	10	0	0
18	48962318	.	C	T	1	5	6	0	1	7	0	0
18	48964912	.	G	C	2	4	6	0	0	6	0	0
18	48964915	.	G	A	0	5	5	0	2	7	0	0
18	48966177	.	C	T	3	3	6	0	0	6	0	0
18	48967500	.	T	C	4	3	7	0	0	7	0	0
18	48968436	.	C	G	2	0	2	0	9	11	0	0
18	48971165	.	T	C	4	7	11	0	1	12	0	0
18	48971192	.	A	G	3	9	12	0	1	13	0	0
18	48972490	.	A	T	10	10	20	0	0	20	0	0
18	49154130	.	A	G	2	11	13	0	0	13	0	0
18	49154131	.	A	G	6	7	13	0	0	13	0	0
18	49155520	.	A	G	12	8	20	0	1	21	0	0
18	49266589	.	A	G	2	14	16	1	1	18	0	0
18	49266951	.	A	G	5	3	8	0	3	11	0	0
18	49266998	.	A	G	9	11	20	0	0	20	0	0
18	49446470	.	G	A	0	5	5	0	9	14	0	0
18	50038325	.	G	T	0	5	5	0	1	6	0	0
18	50538289	.	T	C	15	8	23	0	1	24	0	0
18	50538340	.	T	C	5	14	19	0	0	19	0	0
18	50689577	.	T	C	2	5	7	0	0	7	0	0
18	50689583	.	G	A	4	0	4	0	0	4	0	0
18	50709147	.	C	A	2	0	2	1	11	14	0	0
18	50911951	.	T	C	3	9	12	2	0	14	0	0
19	1330675	.	C	T	0	3	3	0	2	5	0	0
19	1330743	.	T	A	6	2	8	0	0	8	0	0
19	1330780	.	C	G	5	3	8	0	0	8	0	0
19	1331105	.	T	A	7	4	11	0	1	12	0	0
19	1331296	.	C	T	1	6	7	0	6	13	0	0
19	1331344	.	C	A	8	4	12	0	1	13	0	0
19	1331394	.	T	G	8	3	11	0	0	11	0	0
19	1331443	.	T	C	8	0	8	0	8	16	0	0
19	1331446	.	C	T	8	7	15	0	2	17	0	0
19	1370542	.	T	G	14	0	14	0	11	25	0	0
19	1370714	.	A	G	13	10	23	0	0	23	0	0
19	1370725	.	A	C	14	9	23	0	2	25	0	0
19	1382119	.	T	C	3	6	9	0	1	10	0	0
19	1384408	.	A	T	9	10	19	0	0	19	0	0
19	1385881	.	A	G	12	8	20	0	1	21	0	0
19	1389704	.	C	T	8	9	17	0	0	17	0	0
19	1389886	.	C	T	6	10	16	0	2	18	0	0
19	1389892	.	C	A	6	8	14	0	2	16	0	0
19	1392177	.	A	C	14	11	25	0	1	26	0	0
19	1392178	.	C	T	13	12	25	0	0	25	0	0
19	1392544	.	T	A	11	4	15	0	0	15	0	0
19	1392565	.	A	G	11	3	14	0	0	14	0	0
19	1392579	.	T	G	10	5	15	0	0	15	0	0
19	1392657	.	T	C	13	11	24	0	1	25	0	0
19	1392713	.	A	G	14	7	21	0	0	21	0	0
19	1392718	.	A	T	13	8	21	0	0	21	0	0
19	1392941	.	G	A	6	3	9	1	1	11	0	0
19	1392969	.	T	C	7	6	13	0	0	13	0	0
19	1393029	.	A	G	9	12	21	0	0	21	0	0
19	1406549	.	A	C	1	6	7	0	0	7	0	0
19	1406694	.	G	T	6	4	10	0	1	11	0	0
19	1406795	.	A	C	5	2	7	0	1	8	0	0
19	1406895	.	T	G	5	4	9	0	0	9	0	0
19	1406947	.	G	A	2	4	6	0	0	6	0	0
19	1406960	.	T	G	4	5	9	0	0	9	0	0
19	1407180	.	T	C	2	3	5	0	1	6	0	0
19	1407396	.	A	G	4	6	10	0	0	10	0	0
19	1410794	.	C	A	1	4	5	0	0	5	0	0
19	1410896	.	A	G	4	4	8	0	0	8	0	0
19	1411076	.	A	G	1	6	7	0	0	7	0	0
19	1411160	.	G	T	1	5	6	0	0	6	0	0
19	1411193	.	G	A	1	2	3	0	1	4	0	0
19	1618660	.	G	A	3	2	5	0	0	5	0	0
19	1684972	.	C	T	5	3	8	0	0	8	0	0
19	1685639	.	C	T	2	3	5	0	0	5	0	0
19	1685685	.	A	G	4	0	4	0	3	7	0	0
19	1685690	.	A	G	3	0	3	0	2	5	0	0
19	1735376	.	G	A	1	4	5	0	1	6	0	0
19	1736150	.	T	C	1	4	5	0	0	5	0	0
19	1737060	.	T	C	3	3	6	0	0	6	0	0
19	1737162	.	A	T	1	2	3	0	0	3	0	0
19	1737208	.	A	T	2	2	4	0	0	4	0	0
19	1848021	.	T	C	4	10	14	0	0	14	0	0
19	1848143	.	C	G	10	7	17	0	0	17	0	0
19	1848249	.	T	G	5	6	11	0	3	14	0	0
19	1848298	.	A	G	8	4	12	0	0	12	0	0
19	1848301	.	G	A	1	4	5	0	9	14	0	0
19	1848334	.	T	C	5	8	13	0	0	13	0	0
19	1852303	.	T	C	6	13	19	0	1	20	0	0
19	1853802	.	A	G	24	45	69	0	3	72	0	0
19	1853826	.	T	C	19	46	65	0	8	73	0	0
19	1855354	.	A	G	3	4	7	0	0	7	0	0
19	1856458	.	T	G	6	6	12	0	2	14	0	0
19	1856716	.	A	T	9	18	27	0	0	27	0	0
19	1861691	.	A	G	8	8	16	0	2	18	0	0
19	1868327	.	A	G	5	6	11	0	0	11	0	0
19	1868460	.	C	T	0	5	5	0	5	10	0	0
19	1870977	.	T	C	8	0	8	0	8	16	0	0
19	1871178	.	A	G	9	8	17	0	1	18	0	0
19	1871181	.	G	A	9	10	19	0	1	20	0	0
19	1871355	.	T	C	6	6	12	0	0	12	0	0
19	1877288	.	T	C	22	13	35	0	2	37	0	0
19	1877662	.	C	G	5	4	9	0	0	9	0	0
19	1878579	.	T	C	3	4	7	0	0	7	0	0
19	1879854	.	C	T	2	3	5	0	1	6	0	0
19	1879923	.	G	C	4	5	9	0	0	9	0	0
19	1879956	.	C	T	2	7	9	0	0	9	0	0
19	1880595	.	C	G	2	4	6	0	0	6	0	0
19	1934922	.	A	C	1	2	3	0	0	3	0	0
19	1934923	.	A	C	1	2	3	0	0	3	0	0
19	1953543	.	A	T	15	23	38	0	1	39	0	0
19	1953569	.	A	G	18	18	36	0	4	40	0	0
19	1953742	.	C	T	23	21	44	0	2	46	0	0
19	1960997	.	T	C	29	22	51	0	2	53	0	0
19	1964016	.	G	A	0	4	4	0	7	11	0	0
19	1969841	.	G	C	0	5	5	0	8	13	0	0
19	1992998	.	C	G	1	6	7	0	1	8	0	0
19	1993796	.	A	G	9	6	15	0	2	17	0	0
19	1995133	.	A	T	5	8	13	0	0	13	0	0
19	1995229	.	G	A	0	6	6	0	4	10	0	0
19	1995343	.	C	T	5	6	11	0	0	11	0	0
19	1995367	.	A	G	7	0	7	0	7	14	0	0
19	1995404	.	G	A	9	5	14	0	1	15	0	0
19	1995982	.	G	C	6	6	12	0	0	12	0	0
19	1996019	.	T	C	6	5	11	0	0	11	0	0
19	1996098	.	C	T	3	3	6	0	0	6	0	0
19	1996197	.	C	A	2	3	5	0	0	5	0	0
19	1996323	.	T	A	6	8	14	0	0	14	0	0
19	1996366	.	A	G	8	6	14	0	1	15	0	0
19	1996409	.	T	A	6	3	9	0	0	9	0	0
19	1996445	.	G	A	2	2	4	0	5	9	0	0
19	1996494	.	G	A	0	4	4	0	8	12	0	0
19	1996504	.	T	C	7	3	10	0	0	10	0	0
19	1996577	.	C	T	2	4	6	0	0	6	0	0
19	1996639	.	T	G	5	2	7	0	0	7	0	0
19	1996656	.	G	A	3	3	6	0	0	6	0	0
19	1996755	.	C	T	3	7	10	0	0	10	0	0
19	1996776	.	G	A	5	7	12	0	0	12	0	0
19	1996810	.	G	C	3	6	9	0	0	9	0	0
19	1996934	.	T	G	1	3	4	0	0	4	0	0
19	1997010	.	G	A	3	3	6	0	0	6	0	0
19	1997408	.	C	G	4	2	6	0	0	6	0	0
19	1997409	.	A	T	4	2	6	0	0	6	0	0
19	1997538	.	G	C	2	4	6	1	0	7	0	0
19	1997658	.	A	T	6	5	11	0	1	12	0	0
19	1997676	.	T	C	7	5	12	0	0	12	0	0
19	1997781	.	A	T	4	9	13	0	0	13	0	0
19	1997849	.	T	A	5	9	14	0	0	14	0	0
19	1998153	.	C	A	1	6	7	0	0	7	0	0
19	1998160	.	A	T	2	7	9	0	0	9	0	0
19	2000142	.	C	G	4	3	7	0	0	7	0	0
19	2001557	.	T	C	3	3	6	0	1	7	0	0
19	2001572	.	C	T	3	3	6	0	0	6	0	0
19	2001618	.	A	C	7	5	12	0	0	12	0	0
19	2002992	.	A	G	6	1	7	0	4	11	0	0
19	2003902	.	A	T	8	4	12	0	0	12	0	0
19	2003962	.	G	T	0	7	7	0	8	15	0	0
19	2019430	.	G	A	4	8	12	0	0	12	0	0
19	2019480	.	C	T	0	5	5	0	3	8	0	0
19	2023996	.	G	A	2	2	4	0	0	4	0	0
19	2064629	.	G	A	6	5	11	0	1	12	0	0
19	2065004	.	T	G	4	7	11	0	0	11	0	0
19	2071597	.	T	C	9	4	13	0	0	13	0	0
19	2074361	.	G	A	4	2	6	0	1	7	0	0
19	2083221	.	G	A	5	3	8	0	0	8	0	0
19	2084982	.	G	A	5	4	9	0	1	10	0	0
19	2086798	.	G	A	2	6	8	0	0	8	0	0
19	2088877	.	G	A	5	2	7	0	0	7	0	0
19	2279086	.	T	G	6	4	10	0	0	10	0	0
19	2279284	.	C	T	12	12	24	0	2	26	0	0
19	2289519	.	G	A	2	4	6	0	2	8	0	0
19	2296702	.	G	A	7	9	16	0	0	16	0	0
19	2296713	.	C	T	9	8	17	0	1	18	0	0
19	2298917	.	T	A	5	10	15	0	1	16	0	0
19	2300980	.	G	A	11	4	15	0	0	15	0	0
19	2307248	.	C	A	11	9	20	0	0	20	0	0
19	2307268	.	C	T	9	7	16	0	0	16	0	0
19	2307374	.	C	T	5	4	9	0	0	9	0	0
19	2315511	.	C	T	0	5	5	2	3	10	0	0
19	2315630	.	C	T	0	6	6	0	1	7	0	0
19	2315721	.	A	G	3	10	13	1	0	14	0	0
19	2315936	.	C	T	5	2	7	0	0	7	0	0
19	2316173	.	C	A	2	2	4	0	0	4	0	0
19	2316215	.	G	A	2	3	5	0	0	5	0	0
19	2316354	.	A	T	6	4	10	0	0	10	0	0
19	2316510	.	T	C	7	10	17	0	0	17	0	0
19	2316729	.	G	C	7	8	15	0	1	16	0	0
19	2316765	.	T	C	5	8	13	0	1	14	0	0
19	2316894	.	T	C	6	8	14	0	1	15	0	0
19	2317089	.	A	G	6	4	10	0	0	10	0	0
19	2317263	.	G	C	4	0	4	0	7	11	0	0
19	2317490	.	G	A	10	7	17	0	1	18	0	0
19	2317500	.	A	G	8	6	14	0	1	15	0	0
19	2395806	.	A	G	2	5	7	0	0	7	0	0
19	2395822	.	G	T	1	2	3	0	0	3	0	0
19	2396022	.	C	T	1	2	3	0	1	4	0	0
19	2396037	.	G	A	2	3	5	0	1	6	0	0
19	2396262	.	A	T	2	2	4	0	1	5	0	0
19	2396273	.	T	A	5	3	8	0	0	8	0	0
19	2396492	.	C	A	2	4	6	0	0	6	0	0
19	2396898	.	G	A	2	3	5	0	0	5	0	0
19	2396926	.	G	A	3	2	5	0	0	5	0	0
19	2396948	.	C	T	2	2	4	0	0	4	0	0
19	2397381	.	G	C	2	5	7	0	0	7	0	0
19	2397794	.	C	T	0	5	5	0	1	6	0	0
19	2397813	.	T	G	4	7	11	0	0	11	0	0
19	2402535	.	G	C	1	4	5	0	0	5	0	0
19	2402609	.	T	A	2	4	6	0	0	6	0	0
19	2402611	.	T	A	2	4	6	0	0	6	0	0
19	2403804	.	C	G	2	5	7	0	0	7	0	0
19	2546847	.	C	A	3	5	8	0	1	9	0	0
19	2546871	.	T	A	2	5	7	0	0	7	0	0
19	2547191	.	T	G	6	7	13	0	0	13	0	0
19	2547637	.	C	A	8	4	12	0	0	12	0	0
19	2550676	.	G	A	7	7	14	0	2	16	0	0
19	2550839	.	C	T	12	7	19	0	3	22	0	0
19	2551178	.	A	G	4	6	10	0	1	11	0	0
19	2551214	.	C	T	6	6	12	0	1	13	0	0
19	2551727	.	C	T	17	9	26	0	0	26	0	0
19	2557750	.	A	G	11	10	21	0	0	21	0	0
19	2560883	.	T	G	3	5	8	5	0	13	0	0
19	2560950	.	A	G	8	7	15	0	0	15	0	0
19	2561583	.	A	T	5	8	13	0	1	14	0	0
19	2561596	.	T	A	10	10	20	0	0	20	0	0
19	2561637	.	G	T	1	13	14	0	11	25	0	0
19	2561739	.	G	A	4	11	15	0	9	24	0	0
19	2561811	.	A	G	4	9	13	0	1	14	0	0
19	2561833	.	A	G	7	8	15	0	0	15	0	0
19	2593520	.	G	A	2	2	4	0	0	4	0	0
19	2664611	.	T	C	4	8	12	0	1	13	0	0
19	2857717	.	G	A	5	2	7	0	0	7	0	0
19	2857720	.	A	T	4	2	6	0	0	6	0	0
19	2871511	.	A	G	6	4	10	0	0	10	0	0
19	2871553	.	C	T	8	6	14	0	0	14	0	0
19	2872162	.	G	A	11	8	19	0	1	20	0	0
19	2874618	.	T	C	2	2	4	0	0	4	0	0
19	2875896	.	T	A	5	8	13	0	0	13	0	0
19	2877298	.	A	C	2	3	5	0	0	5	0	0
19	2877371	.	C	T	1	3	4	0	0	4	0	0
19	2877563	.	C	T	2	1	3	0	1	4	0	0
19	2877569	.	G	C	2	2	4	0	0	4	0	0
19	2880160	.	C	T	1	2	3	0	0	3	0	0
19	2930521	.	T	C	0	3	3	0	1	4	0	0
19	2934321	.	A	G	3	6	9	0	1	10	0	0
19	2940996	.	G	T	5	4	9	0	0	9	0	0
19	2965923	.	A	G	1	2	3	0	0	3	0	0
19	2967894	.	A	G	5	5	10	0	0	10	0	0
19	3037184	.	T	C	6	6	12	0	0	12	0	0
19	3037186	.	T	A	6	6	12	0	0	12	0	0
19	3052828	.	A	G	6	3	9	0	0	9	0	0
19	3052836	.	A	T	6	4	10	0	0	10	0	0
19	3052904	.	A	T	3	4	7	0	0	7	0	0
19	3053041	.	C	T	2	3	5	0	1	6	0	0
19	3056629	.	C	T	12	6	18	0	0	18	0	0
19	3080477	.	A	G	24	7	31	0	1	32	0	0
19	3080572	.	G	A	4	4	8	0	1	9	0	0
19	3080712	.	T	A	8	7	15	0	0	15	0	0
19	3080907	.	A	T	7	2	9	0	0	9	0	0
19	3081008	.	A	G	3	0	3	0	7	10	0	0
19	3081154	.	G	C	4	2	6	0	1	7	0	0
19	3081206	.	G	T	3	5	8	0	0	8	0	0
19	3081394	.	A	G	5	10	15	0	1	16	0	0
19	3081628	.	T	C	3	3	6	2	0	8	0	0
19	3081704	.	A	T	1	2	3	0	0	4	1	0
19	3081927	.	G	A	6	9	15	0	0	15	0	0
19	3081933	.	G	A	1	10	11	0	6	17	0	0
19	3082053	.	T	C	9	7	16	0	1	17	0	0
19	3082102	.	C	T	14	7	21	0	0	21	0	0
19	3087025	.	A	G	2	3	5	0	2	7	0	0
19	3093504	.	G	A	1	6	7	0	0	7	0	0
19	3137727	.	C	T	1	30	31	0	16	47	0	0
19	3137761	.	C	A	13	30	43	0	1	44	0	0
19	3137803	.	A	T	14	27	41	0	3	44	0	0
19	3137888	.	T	C	20	0	20	0	32	52	0	0
19	3138166	.	G	T	19	5	24	0	0	24	0	0
19	3138325	.	A	C	19	25	44	0	0	44	0	0
19	3138355	.	T	G	18	24	42	0	0	42	0	0
19	3138638	.	T	C	15	0	15	0	17	32	0	0
19	3142240	.	T	C	13	21	34	0	1	35	0	0
19	3142260	.	T	C	12	1	13	0	25	38	0	0
19	3142286	.	C	G	14	22	36	0	2	38	0	0
19	3144567	.	A	G	18	28	46	0	1	47	0	0
19	3144841	.	T	A	21	22	43	0	2	45	0	0
19	3144859	.	C	T	21	19	40	0	2	42	0	0
19	3149236	.	T	C	6	19	25	0	0	25	0	0
19	3149296	.	A	C	8	17	25	0	1	26	0	0
19	3149320	.	T	G	9	19	28	0	1	29	0	0
19	3149368	.	A	T	10	21	31	0	0	31	0	0
19	3149515	.	T	C	4	6	10	0	0	10	0	0
19	3149516	.	T	C	5	0	5	0	6	11	0	0
19	3149692	.	A	G	10	9	19	0	0	19	0	0
19	3152069	.	C	T	0	15	15	0	5	20	0	0
19	3152091	.	A	T	5	11	16	0	1	17	0	0
19	3152108	.	T	A	4	11	15	0	0	15	0	0
19	3155883	.	A	C	3	1	4	0	5	9	0	0
19	3156017	.	C	T	1	4	5	0	2	7	0	0
19	3163598	.	C	A	2	7	9	0	0	9	0	0
19	3163717	.	A	T	2	8	10	0	0	10	0	0
19	3386580	.	T	A	2	3	5	0	0	5	0	0
19	3866165	.	T	C	11	11	22	0	0	22	0	0
19	4010146	.	A	G	7	5	12	0	2	15	1	0
19	4010175	.	C	A	12	14	26	0	0	26	0	0
19	4828428	.	A	T	6	3	9	0	1	10	0	0
19	4856691	.	G	A	4	3	7	0	0	7	0	0
19	4856825	.	C	A	5	7	12	0	2	14	0	0
19	4856852	.	A	T	8	7	15	0	1	16	0	0
19	4857526	.	C	T	12	10	22	0	2	24	0	0
19	4857697	.	C	A	6	13	19	0	1	20	0	0
19	4857746	.	G	A	4	7	11	0	2	13	0	0
19	4857802	.	C	T	9	10	19	0	0	19	0	0
19	4858000	.	C	T	9	10	19	0	1	20	0	0
19	4866919	.	T	C	17	14	31	0	0	31	0	0
19	4866936	.	C	T	15	12	27	0	2	29	0	0
19	4866986	.	A	G	15	5	20	1	1	22	0	0
19	4867168	.	G	C	9	10	19	1	4	24	0	0
19	4867232	.	C	A	15	11	26	0	1	27	0	0
19	4867274	.	G	A	0	5	5	0	16	21	0	0
19	4875478	.	G	A	11	5	16	0	0	16	0	0
19	4875529	.	C	T	12	7	19	0	0	19	0	0
19	4875583	.	A	G	6	10	16	0	0	16	0	0
19	4875595	.	A	G	5	11	16	0	1	17	0	0
19	4877141	.	T	C	14	9	23	0	0	23	0	0
19	4881414	.	T	C	16	12	28	0	0	28	0	0
19	4885398	.	A	G	12	9	21	0	1	22	0	0
19	4885431	.	A	G	7	6	13	0	4	17	0	0
19	5058188	.	C	T	0	9	9	0	6	15	0	0
19	5077114	.	C	T	35	36	71	0	0	71	0	0
19	5077173	.	C	T	46	26	72	0	1	73	0	0
19	5077356	.	C	T	40	27	67	0	5	72	0	0
19	5080124	.	T	A	37	26	63	0	2	65	0	0
19	5081796	.	C	T	42	22	64	0	0	64	0	0
19	5082161	.	C	T	31	34	65	0	4	69	0	0
19	5089755	.	C	G	40	36	76	0	2	78	0	0
19	5090070	.	A	T	27	33	60	0	0	60	0	0
19	5090071	.	G	T	25	33	58	0	1	59	0	0
19	5090368	.	T	C	23	29	52	0	3	55	0	0
19	5090583	.	C	T	11	7	18	0	0	18	0	0
19	5091483	.	T	C	38	25	63	0	8	71	0	0
19	5091503	.	C	T	34	28	62	0	3	65	0	0
19	5094244	.	C	T	2	2	4	0	1	5	0	0
19	5094288	.	G	T	3	2	5	0	0	5	0	0
19	5094417	.	A	T	10	9	19	0	0	19	0	0
19	5094504	.	A	G	8	14	22	0	1	23	0	0
19	5094564	.	T	A	13	11	24	0	0	25	1	0
19	5094591	.	C	T	12	12	24	0	0	24	0	0
19	5100191	.	G	A	15	16	31	0	1	32	0	0
19	5100240	.	G	A	14	16	30	0	1	31	0	0
19	5100249	.	C	T	11	19	30	0	0	30	0	0
19	5100458	.	G	A	19	16	35	0	1	36	0	0
19	5100665	.	C	T	20	11	31	0	0	31	0	0
19	5135247	.	T	G	12	18	30	0	1	31	0	0
19	5135258	.	C	G	12	15	27	0	0	27	0	0
19	5143975	.	A	T	10	7	17	0	0	17	0	0
19	5144395	.	T	C	6	3	9	0	1	10	0	0
19	5144962	.	G	A	4	4	8	0	1	9	0	0
19	5145097	.	T	C	6	6	12	0	0	12	0	0
19	5146708	.	C	T	17	10	27	0	0	27	0	0
19	5149133	.	T	C	22	24	46	0	1	47	0	0
19	5149867	.	C	T	11	8	19	0	0	19	0	0
19	5158572	.	G	A	23	32	55	4	7	66	0	0
19	5159079	.	A	T	38	22	60	0	1	61	0	0
19	5159083	.	A	T	34	39	73	0	3	76	0	0
19	5159157	.	C	A	33	40	73	0	1	74	0	0
19	5159425	.	C	T	31	28	59	0	4	63	0	0
19	5159534	.	G	A	32	27	59	1	7	67	0	0
19	5160048	.	C	G	35	30	65	0	2	67	0	0
19	5160121	.	T	C	38	0	38	0	26	64	0	0
19	5160201	.	A	G	24	32	56	0	4	60	0	0
19	5161750	.	A	G	24	21	45	4	2	51	0	0
19	5161782	.	C	T	28	25	53	4	1	58	0	0
19	5162252	.	A	T	40	32	72	0	0	72	0	0
19	5162253	.	T	C	40	1	41	0	31	72	0	0
19	5162300	.	T	G	38	29	67	0	1	68	0	0
19	5162544	.	A	G	19	29	48	0	2	50	0	0
19	5162685	.	T	A	30	32	62	0	2	64	0	0
19	5162827	.	C	T	35	21	56	0	1	57	0	0
19	5162839	.	T	C	34	0	34	0	21	55	0	0
19	5162923	.	C	T	25	23	48	0	0	48	0	0
19	5162960	.	A	T	24	18	42	0	2	44	0	0
19	5163031	.	C	T	26	15	41	0	2	43	0	0
19	5163127	.	A	T	22	31	53	0	2	55	0	0
19	5163434	.	A	G	30	32	62	0	0	62	0	0
19	5163635	.	C	T	30	21	51	0	2	61	8	0
19	5254510	.	A	G	27	32	59	0	3	62	0	0
19	5299970	.	T	C	7	10	17	0	0	17	0	0
19	5300120	.	T	C	6	9	15	0	0	15	0	0
19	5300211	.	T	A	9	5	14	0	1	15	0	0
19	5300215	.	C	A	9	6	15	0	0	15	0	0
19	5302463	.	A	C	5	3	8	0	0	8	0	0
19	5305418	.	A	G	9	4	13	0	0	13	0	0
19	5305530	.	A	G	4	3	7	0	0	7	0	0
19	5305710	.	A	T	4	6	10	0	0	10	0	0
19	5305870	.	G	C	7	4	11	0	0	11	0	0
19	5316439	.	T	C	11	8	19	0	1	20	0	0
19	5318355	.	G	A	1	7	8	0	11	19	0	0
19	5318356	.	T	A	10	8	18	0	1	19	0	0
19	5318806	.	A	C	12	10	22	0	1	23	0	0
19	5318979	.	G	A	10	10	20	0	6	26	0	0
19	5319096	.	C	G	14	18	32	0	1	33	0	0
19	5320139	.	G	A	5	9	14	0	5	19	0	0
19	5320234	.	T	C	1	4	5	0	0	5	0	0
19	5378808	.	T	A	12	6	18	0	1	19	0	0
19	5379587	.	T	C	4	5	9	0	0	9	0	0
19	5380014	.	G	T	4	3	7	0	0	7	0	0
19	5418116	.	T	A	23	18	41	0	0	41	0	0
19	5421086	.	T	A	34	30	64	0	4	68	0	0
19	5421277	.	T	G	27	2	29	0	23	53	1	0
19	5480485	.	T	C	10	18	28	0	0	28	0	0
19	5552442	.	G	A	8	8	16	0	0	16	0	0
19	5552550	.	C	T	13	8	21	0	1	22	0	0
19	5569981	.	C	T	11	9	20	0	0	20	0	0
19	5582376	.	A	G	7	15	22	0	0	22	0	0
19	5582418	.	T	C	8	9	17	0	1	18	0	0
19	5587716	.	C	T	11	10	21	0	2	23	0	0
19	5608628	.	C	G	14	14	28	0	1	29	0	0
19	5610860	.	T	A	14	10	24	0	2	26	0	0
19	5611439	.	G	A	2	19	21	0	30	51	0	0
19	5611586	.	T	C	23	15	38	0	4	42	0	0
19	5615570	.	C	A	22	15	37	1	2	40	0	0
19	5617832	.	T	C	18	11	29	0	4	33	0	0
19	5619685	.	G	A	3	19	22	0	25	47	0	0
19	5619735	.	G	A	24	21	45	0	3	48	0	0
19	5619931	.	A	G	7	12	19	0	0	19	0	0
19	5620011	.	G	A	0	10	10	0	16	26	0	0
19	5620380	.	G	A	20	12	32	0	0	32	0	0
19	5620498	.	T	A	16	15	31	0	0	31	0	0
19	5620525	.	C	T	15	16	31	0	3	34	0	0
19	5620631	.	C	T	16	16	32	0	1	33	0	0
19	5620772	.	G	A	19	10	29	0	0	29	0	0
19	5620810	.	T	C	19	10	29	0	0	29	0	0
19	5621124	.	G	T	20	12	32	0	1	33	0	0
19	5779170	.	C	T	3	3	6	0	1	7	0	0
19	5779601	.	T	C	10	14	24	0	0	24	0	0
19	5779897	.	T	C	8	10	18	0	1	19	0	0
19	5779946	.	G	C	12	7	19	0	0	19	0	0
19	5780032	.	C	G	1	6	7	0	5	12	0	0
19	5780301	.	T	A	11	13	24	0	0	24	0	0
19	5780342	.	A	C	10	0	10	0	12	22	0	0
19	5780429	.	C	A	3	2	5	2	0	7	0	0
19	5780989	.	G	A	6	14	20	0	0	20	0	0
19	5781316	.	G	T	7	3	10	0	0	10	0	0
19	5781367	.	T	C	8	8	16	0	0	16	0	0
19	5781397	.	A	G	8	5	13	0	0	13	0	0
19	5781421	.	T	G	5	4	9	0	2	11	0	0
19	5793484	.	C	G	7	4	11	0	0	11	0	0
19	5793532	.	T	C	7	4	11	0	0	11	0	0
19	5805773	.	T	G	3	7	10	0	0	10	0	0
19	5805833	.	G	A	4	7	11	0	0	11	0	0
19	5805839	.	G	A	4	9	13	0	0	13	0	0
19	5805869	.	A	G	10	4	14	0	1	15	0	0
19	6060309	.	A	T	17	13	30	1	1	32	0	0
19	6073362	.	T	C	8	7	15	0	3	18	0	0
19	6076813	.	C	A	11	9	20	0	1	21	0	0
19	6086441	.	C	G	9	15	24	0	0	24	0	0
19	6086577	.	C	T	1	14	15	0	16	31	0	0
19	6087130	.	T	A	6	10	16	0	0	16	0	0
19	6087146	.	C	T	0	10	10	0	6	16	0	0
19	6087186	.	A	T	4	14	18	0	0	18	0	0
19	6087619	.	T	C	9	0	9	0	9	18	0	0
19	6087894	.	G	A	7	12	19	0	0	19	0	0
19	6087948	.	A	T	12	10	22	1	2	25	0	0
19	6088000	.	C	T	1	17	18	1	15	34	0	0
19	6088166	.	T	C	11	10	21	0	2	23	0	0
19	6088259	.	A	C	13	21	34	0	0	34	0	0
19	6088419	.	A	T	20	10	30	0	1	31	0	0
19	6090702	.	T	C	17	12	29	0	0	29	0	0
19	6090732	.	T	A	15	12	27	0	0	27	0	0
19	6097416	.	A	G	13	13	26	0	1	27	0	0
19	6099984	.	G	A	16	14	30	0	1	31	0	0
19	6099992	.	G	A	13	12	25	0	3	28	0	0
19	6100027	.	G	A	15	9	24	0	1	25	0	0
19	6100037	.	C	T	15	9	24	0	0	24	0	0
19	6100073	.	T	G	16	14	30	0	0	30	0	0
19	6100139	.	G	C	11	0	11	1	13	25	0	0
19	6104838	.	C	T	3	16	19	0	15	34	0	0
19	6110968	.	A	T	11	11	22	0	0	22	0	0
19	6111085	.	G	A	12	5	17	0	1	18	0	0
19	6111214	.	A	G	15	15	30	0	2	32	0	0
19	6111223	.	A	G	17	13	30	0	1	32	1	0
19	6111268	.	G	A	17	17	34	0	3	37	0	0
19	6111366	.	C	T	1	13	14	0	13	27	0	0
19	6111460	.	C	G	16	10	26	0	0	26	0	0
19	6111496	.	G	A	16	10	26	0	0	26	0	0
19	6111730	.	C	A	7	3	10	0	1	11	0	0
19	6111793	.	G	A	13	7	20	0	1	21	0	0
19	6116638	.	A	G	12	8	20	0	0	20	0	0
19	6124000	.	T	C	13	0	13	0	9	22	0	0
19	6125197	.	C	A	1	7	8	0	9	17	0	0
19	6125926	.	G	A	16	7	23	0	2	25	0	0
19	6125941	.	C	T	14	13	27	0	1	28	0	0
19	6126001	.	G	A	13	13	26	0	3	29	0	0
19	6126277	.	G	A	13	9	22	0	1	23	0	0
19	6126403	.	C	G	6	8	14	0	0	14	0	0
19	6126544	.	A	G	10	4	14	0	0	14	0	0
19	6126625	.	G	A	10	7	17	0	0	17	0	0
19	6126645	.	T	C	6	6	12	0	1	13	0	0
19	6127108	.	C	A	4	10	14	0	0	14	0	0
19	6127669	.	C	A	8	5	13	0	0	13	0	0
19	6127696	.	T	C	7	4	11	0	0	11	0	0
19	6127847	.	G	T	6	3	9	0	0	9	0	0
19	6128416	.	G	A	6	3	9	0	1	10	0	0
19	6142187	.	C	A	1	9	10	0	5	15	0	0
19	6142714	.	A	T	12	10	22	0	2	24	0	0
19	6142803	.	A	G	5	11	16	0	0	16	0	0
19	6142951	.	A	G	9	4	13	0	0	13	0	0
19	6142970	.	C	T	6	2	8	0	0	8	0	0
19	6143278	.	A	C	3	6	9	0	0	9	0	0
19	6143373	.	T	C	5	11	16	0	0	16	0	0
19	6143583	.	C	G	3	9	12	0	0	12	0	0
19	6143610	.	T	A	2	9	11	0	0	11	0	0
19	6143919	.	T	C	6	4	10	0	0	10	0	0
19	6144101	.	T	A	5	8	13	0	2	15	0	0
19	6144267	.	C	A	8	3	11	0	0	11	0	0
19	6144275	.	C	A	9	4	13	0	0	13	0	0
19	6144342	.	A	G	7	5	12	0	1	13	0	0
19	6144722	.	C	T	9	9	18	0	0	18	0	0
19	6144822	.	C	G	4	3	7	0	0	7	0	0
19	6145568	.	T	C	6	0	6	1	5	12	0	0
19	6145610	.	A	G	9	5	14	1	0	15	0	0
19	6145964	.	A	G	8	4	12	0	0	12	0	0
19	6145970	.	C	T	0	3	3	0	9	12	0	0
19	6193121	.	C	A	1	4	5	0	1	6	0	0
19	6193178	.	T	C	5	2	7	0	1	8	0	0
19	6214772	.	G	A	6	6	12	0	0	12	0	0
19	6214835	.	G	T	4	4	8	0	1	9	0	0
19	6216125	.	C	T	3	3	6	0	0	6	0	0
19	6216392	.	A	G	3	5	8	0	0	8	0	0
19	6216606	.	G	A	4	3	7	0	0	7	0	0
19	6216813	.	G	A	7	3	10	0	0	10	0	0
19	6227414	.	G	C	6	4	10	0	0	10	0	0
19	6227420	.	C	G	5	4	9	0	0	9	0	0
19	6232242	.	T	C	2	1	3	0	6	9	0	0
19	6242954	.	T	C	3	2	5	0	0	5	0	0
19	6328442	.	T	C	36	10	46	1	44	91	0	0
19	6328514	.	A	C	42	41	83	0	0	83	0	0
19	6329154	.	C	T	6	32	38	0	30	68	0	0
19	6329236	.	A	G	42	28	70	2	1	73	0	0
19	6329237	.	G	A	39	27	66	2	4	72	0	0
19	6329301	.	A	C	34	41	75	0	1	76	0	0
19	6329329	.	G	A	34	41	75	0	2	77	0	0
19	6329533	.	C	T	8	30	38	0	35	73	0	0
19	6329660	.	C	T	12	20	32	0	43	82	7	0
19	6330050	.	T	C	37	31	68	1	7	76	0	0
19	6332902	.	C	A	12	31	43	0	41	84	0	0
19	6333448	.	G	A	45	22	67	0	3	70	0	0
19	6338207	.	A	G	31	39	70	0	2	72	0	0
19	6338261	.	A	G	26	44	70	0	1	71	0	0
19	6339131	.	A	G	34	40	74	0	2	76	0	0
19	6341941	.	A	G	34	34	68	0	1	69	0	0
19	6342076	.	C	G	34	28	62	0	2	64	0	0
19	6344573	.	G	T	39	29	68	0	2	71	1	0
19	6344621	.	C	T	37	32	69	0	2	71	0	0
19	6346506	.	C	G	35	29	64	0	1	65	0	0
19	6346587	.	C	T	5	33	38	0	28	66	0	0
19	6352379	.	A	G	30	25	55	1	7	63	0	0
19	6358232	.	A	G	24	30	54	0	5	59	0	0
19	6358244	.	C	A	24	34	58	0	0	59	1	0
19	6362636	.	A	G	21	33	54	0	3	57	0	0
19	6362804	.	T	A	26	39	65	1	1	67	0	0
19	6606673	.	T	A	8	8	16	0	1	17	0	0
19	6606725	.	T	C	9	8	17	0	2	19	0	0
19	6606764	.	A	T	6	13	19	0	0	19	0	0
19	6612432	.	T	C	8	5	13	0	0	13	0	0
19	6618068	.	A	G	15	10	25	0	0	25	0	0
19	6618293	.	A	G	7	4	11	0	0	11	0	0
19	6869051	.	T	C	3	3	6	0	0	6	0	0
19	6871741	.	C	T	7	2	9	6	0	15	0	0
19	6872539	.	T	C	8	9	17	0	0	17	0	0
19	6872595	.	C	T	5	6	11	0	0	11	0	0
19	6892406	.	C	T	1	3	4	3	0	7	0	0
19	6896377	.	A	G	2	3	5	0	1	6	0	0
19	6900002	.	G	T	1	4	5	0	0	5	0	0
19	6900389	.	G	T	2	2	4	0	0	4	0	0
19	6901116	.	A	T	1	3	4	0	0	4	0	0
19	6901174	.	G	T	0	2	2	0	2	4	0	0
19	6907785	.	G	A	2	2	4	0	0	4	0	0
19	6907848	.	G	A	3	3	6	0	0	6	0	0
19	6907857	.	C	T	3	4	7	0	0	7	0	0
19	6908495	.	A	T	1	2	3	0	0	3	0	0
19	6908520	.	T	C	1	2	3	0	0	3	0	0
19	6910409	.	A	G	1	4	5	0	0	5	0	0
19	6914145	.	G	A	3	7	10	0	0	10	0	0
19	6914280	.	A	T	6	3	9	0	0	9	0	0
19	6914319	.	T	A	7	3	10	0	0	10	0	0
19	6914370	.	A	C	8	3	11	0	0	11	0	0
19	6914589	.	T	C	3	4	7	2	0	9	0	0
19	6914706	.	T	G	2	0	2	0	4	6	0	0
19	6914871	.	G	A	3	0	3	3	2	8	0	0
19	6915030	.	T	C	4	2	6	0	0	6	0	0
19	6915175	.	A	C	4	10	14	0	1	15	0	0
19	6915177	.	A	G	3	10	13	0	1	14	0	0
19	6915234	.	G	A	2	2	4	2	0	6	0	0
19	6916019	.	T	C	2	2	4	0	0	4	0	0
19	6916029	.	G	A	2	4	6	0	0	6	0	0
19	6916158	.	C	A	2	4	6	0	0	6	0	0
19	6918179	.	C	T	1	2	3	0	0	3	0	0
19	6922387	.	A	G	1	6	7	0	0	7	0	0
19	6922475	.	T	A	3	1	4	0	0	4	0	0
19	6922498	.	C	T	4	3	7	0	1	8	0	0
19	6923556	.	C	A	1	2	3	0	0	3	0	0
19	6923617	.	A	G	2	2	4	0	0	4	0	0
19	6928466	.	C	A	2	3	5	0	0	5	0	0
19	6928494	.	A	C	3	2	5	0	0	5	0	0
19	6932453	.	C	A	4	2	6	0	0	6	0	0
19	6934166	.	C	T	1	1	2	0	0	2	0	0
19	6934188	.	G	T	1	4	5	0	0	5	0	0
19	6938364	.	A	T	15	16	31	0	0	31	0	0
19	6938377	.	A	T	17	15	32	0	0	32	0	0
19	6940213	.	C	T	14	13	27	0	0	27	0	0
19	6949256	.	G	A	4	21	25	0	19	44	0	0
19	6949316	.	C	A	21	14	35	0	5	40	0	0
19	6950393	.	G	A	22	13	35	0	5	40	0	0
19	6952600	.	T	C	17	19	36	0	1	37	0	0
19	6955061	.	C	T	22	24	46	0	1	47	0	0
19	6955130	.	C	T	20	6	26	0	3	29	0	0
19	6955131	.	C	T	19	7	26	0	3	29	0	0
19	6955198	.	C	A	24	13	37	0	4	41	0	0
19	6955411	.	C	T	12	10	22	0	0	22	0	0
19	6955475	.	T	C	8	7	15	0	3	18	0	0
19	6955609	.	C	G	13	4	17	0	1	18	0	0
19	6955620	.	G	A	3	4	7	0	15	22	0	0
19	6955920	.	G	A	11	13	24	0	0	24	0	0
19	6956058	.	T	C	26	12	38	1	0	39	0	0
19	6956060	.	G	A	25	12	37	1	1	39	0	0
19	6956553	.	A	C	7	5	12	0	0	12	0	0
19	6956555	.	A	T	7	5	12	0	0	12	0	0
19	6956665	.	C	A	14	9	23	0	0	23	0	0
19	6956728	.	T	A	12	14	26	0	0	28	2	0
19	6956829	.	T	A	9	9	18	0	1	19	0	0
19	6956835	.	C	G	9	9	18	0	0	18	0	0
19	6956881	.	T	C	8	9	17	0	0	17	0	0
19	6956892	.	T	A	10	7	17	0	0	17	0	0
19	6957127	.	A	T	28	14	42	0	2	44	0	0
19	6957131	.	C	A	24	15	39	0	5	44	0	0
19	6960653	.	C	A	3	5	8	0	0	8	0	0
19	6961120	.	T	C	4	4	8	0	0	8	0	0
19	6961130	.	T	C	5	0	5	0	4	9	0	0
19	6961211	.	T	C	3	4	7	1	2	11	1	0
19	6961377	.	G	T	9	3	12	0	0	12	0	0
19	6961421	.	T	A	14	6	20	0	0	20	0	0
19	6961610	.	G	A	6	2	8	1	0	9	0	0
19	6961674	.	A	G	6	6	12	0	0	12	0	0
19	6963966	.	G	A	1	2	3	0	0	3	0	0
19	6963996	.	G	A	3	3	6	0	1	7	0	0
19	6964273	.	C	A	7	10	17	0	0	17	0	0
19	6964364	.	C	T	12	5	17	0	1	18	0	0
19	6964381	.	T	C	13	5	18	0	1	19	0	0
19	6964417	.	A	G	10	4	14	0	1	15	0	0
19	6964636	.	C	T	3	5	8	0	0	8	0	0
19	6964641	.	T	C	4	0	4	0	5	9	0	0
19	6965065	.	T	A	1	3	4	0	0	4	0	0
19	6965235	.	A	G	1	4	5	0	0	5	0	0
19	6965382	.	A	T	5	3	8	0	0	8	0	0
19	6965420	.	A	T	3	5	8	0	0	8	0	0
19	6965717	.	A	G	3	5	8	0	0	8	0	0
19	6965752	.	A	T	3	3	6	0	0	7	1	0
19	6965767	.	G	A	3	4	7	0	0	7	0	0
19	6965894	.	C	A	0	5	5	0	6	11	0	0
19	6965897	.	C	T	6	5	11	0	0	11	0	0
19	6966003	.	C	A	2	5	7	0	0	7	0	0
19	6966022	.	A	G	2	5	7	0	2	9	0	0
19	6966208	.	G	A	9	4	13	0	0	13	0	0
19	6966271	.	T	G	6	6	12	0	1	13	0	0
19	6966781	.	A	T	3	9	12	0	1	13	0	0
19	6975261	.	A	C	6	0	6	0	4	10	0	0
19	6977067	.	T	C	7	0	7	0	8	15	0	0
19	6980493	.	C	T	5	8	13	0	0	13	0	0
19	6982477	.	C	G	3	2	5	0	0	5	0	0
19	6988778	.	T	C	7	7	14	0	1	15	0	0
19	7003167	.	C	T	3	3	6	0	0	6	0	0
19	7003228	.	C	A	2	2	4	0	0	4	0	0
19	7003266	.	T	C	2	4	6	0	0	6	0	0
19	7004841	.	G	A	0	4	4	0	1	5	0	0
19	7005030	.	C	T	4	3	7	0	0	7	0	0
19	7005032	.	G	C	4	3	7	0	0	7	0	0
19	7005126	.	C	A	2	2	4	0	0	4	0	0
19	7005462	.	G	A	0	2	2	0	4	6	0	0
19	7005549	.	A	C	2	3	5	0	0	5	0	0
19	7005594	.	C	T	3	3	6	0	0	6	0	0
19	7005630	.	C	T	4	3	7	0	1	8	0	0
19	7005821	.	A	G	5	2	7	0	0	7	0	0
19	7005881	.	C	T	5	6	11	0	0	11	0	0
19	7006037	.	C	A	1	2	3	0	0	3	0	0
19	7006215	.	C	T	5	10	15	0	0	15	0	0
19	7006682	.	G	A	7	2	9	0	0	9	0	0
19	7006709	.	G	T	2	5	7	0	5	12	0	0
19	7006826	.	C	A	2	4	6	0	0	6	0	0
19	7006837	.	A	C	2	4	6	0	0	6	0	0
19	7006928	.	C	T	2	3	5	0	0	5	0	0
19	7014743	.	G	A	1	3	4	0	0	4	0	0
19	7014778	.	T	A	3	2	5	0	0	5	0	0
19	7014815	.	C	T	3	4	7	0	0	7	0	0
19	7014863	.	T	G	6	3	9	0	0	9	0	0
19	7018185	.	C	A	2	2	4	0	0	4	0	0
19	7018187	.	T	C	2	0	2	0	2	4	0	0
19	7020179	.	G	A	6	5	11	0	0	11	0	0
19	7020775	.	T	C	2	4	6	0	1	7	0	0
19	7022107	.	G	A	9	7	16	0	1	17	0	0
19	7022128	.	G	A	11	7	18	0	0	18	0	0
19	7024591	.	T	G	4	3	7	0	1	8	0	0
19	7024593	.	C	T	3	3	6	0	1	7	0	0
19	7024627	.	T	C	8	4	12	0	0	12	0	0
19	7027127	.	G	C	3	4	7	0	0	7	0	0
19	7027810	.	A	T	4	2	6	0	1	7	0	0
19	7027927	.	G	A	4	4	8	0	0	8	0	0
19	7028011	.	C	T	2	3	5	0	0	5	0	0
19	7029769	.	A	G	4	3	7	0	0	7	0	0
19	7029770	.	C	G	4	3	7	0	0	7	0	0
19	7029806	.	C	G	4	3	7	0	0	7	0	0
19	7029811	.	G	A	4	2	6	0	0	6	0	0
19	7029883	.	C	A	2	6	8	0	0	8	0	0
19	7029915	.	A	G	2	8	10	0	0	10	0	0
19	7031333	.	A	G	2	4	6	0	0	6	0	0
19	7031350	.	G	A	2	4	6	0	0	6	0	0
19	7039113	.	G	A	2	5	7	0	1	8	0	0
19	7039335	.	T	C	4	0	4	0	2	6	0	0
19	7039344	.	G	A	4	3	7	0	0	7	0	0
19	7040158	.	A	G	5	4	9	0	0	9	0	0
19	7041652	.	G	C	1	2	3	2	0	5	0	0
19	7042403	.	C	T	0	2	2	1	1	4	0	0
19	7048468	.	G	A	5	4	9	0	0	9	0	0
19	7048584	.	G	A	1	3	4	0	0	4	0	0
19	7048594	.	C	A	1	2	3	0	1	4	0	0
19	7112661	.	C	T	1	2	3	0	0	3	0	0
19	7120577	.	T	A	1	2	3	0	0	3	0	0
19	7128225	.	T	C	4	2	6	0	0	6	0	0
19	7152971	.	G	T	0	8	8	0	10	18	0	0
19	7152974	.	G	A	9	7	16	0	2	18	0	0
19	7154729	.	A	G	18	16	34	0	3	37	0	0
19	7154770	.	A	C	22	11	33	0	3	36	0	0
19	7155001	.	A	T	7	11	18	0	3	21	0	0
19	7155034	.	A	G	15	19	34	0	2	36	0	0
19	7155065	.	T	C	11	19	30	0	0	30	0	0
19	7158469	.	C	T	10	10	20	0	1	21	0	0
19	7158546	.	A	G	8	0	8	0	18	26	0	0
19	7159062	.	G	A	1	12	13	0	13	26	0	0
19	7159107	.	T	C	9	14	23	0	1	24	0	0
19	7161452	.	G	A	8	6	14	0	0	14	0	0
19	7161527	.	A	G	7	0	7	0	13	20	0	0
19	7161539	.	G	T	6	13	19	0	0	19	0	0
19	7163872	.	C	T	16	13	29	0	2	31	0	0
19	7163908	.	A	G	11	16	27	0	0	27	0	0
19	7164022	.	G	A	10	10	20	0	2	22	0	0
19	7166211	.	C	T	12	11	23	0	0	23	0	0
19	7166454	.	C	A	9	8	17	0	0	17	0	0
19	7169204	.	A	C	10	18	28	0	2	30	0	0
19	7169228	.	C	T	14	15	29	0	3	32	0	0
19	7169587	.	A	G	3	6	9	0	0	9	0	0
19	7169588	.	G	A	2	5	7	0	1	8	0	0
19	7169770	.	A	C	11	7	18	1	0	19	0	0
19	7169809	.	C	T	5	11	16	0	1	17	0	0
19	7169880	.	T	C	12	7	19	0	1	20	0	0
19	7169886	.	G	A	13	9	22	0	0	22	0	0
19	7169929	.	G	A	14	11	25	0	1	26	0	0
19	7170014	.	A	C	9	6	15	0	1	16	0	0
19	7170015	.	T	C	9	7	16	0	0	16	0	0
19	7170128	.	A	G	5	7	12	0	0	12	0	0
19	7170191	.	A	C	12	7	19	0	0	19	0	0
19	7170228	.	A	T	11	5	16	0	0	16	0	0
19	7174417	.	C	A	4	3	7	0	0	7	0	0
19	7249800	.	A	G	15	17	32	1	0	33	0	0
19	7249811	.	T	C	17	16	33	1	0	34	0	0
19	7250372	.	T	C	7	7	14	0	0	14	0	0
19	7258085	.	A	G	17	6	23	0	0	23	0	0
19	7258118	.	C	T	17	8	25	0	0	25	0	0
19	7265377	.	T	C	10	4	14	0	2	16	0	0
19	7270102	.	G	A	10	9	19	0	1	20	0	0
19	7270156	.	C	A	3	8	11	0	16	27	0	0
19	7272224	.	C	A	14	9	23	0	0	23	0	0
19	7272935	.	G	A	8	11	19	0	2	21	0	0
19	7276106	.	G	A	10	11	21	0	3	24	0	0
19	7276149	.	A	G	21	21	42	0	1	43	0	0
19	7276194	.	T	A	23	25	48	0	0	48	0	0
19	7276559	.	G	A	36	34	70	0	0	70	0	0
19	7276610	.	G	A	34	31	65	0	6	71	0	0
19	7279235	.	A	G	32	32	64	3	1	68	0	0
19	7279721	.	A	G	24	27	51	0	3	54	0	0
19	7282541	.	C	T	29	32	61	0	2	63	0	0
19	7282554	.	G	A	27	33	60	0	2	62	0	0
19	7283427	.	C	A	36	26	62	0	2	64	0	0
19	7283499	.	A	G	36	22	58	2	5	65	0	0
19	7284840	.	C	T	6	30	36	0	23	59	0	0
19	7286301	.	A	G	26	31	57	0	3	60	0	0
19	7286355	.	A	G	34	30	64	0	2	66	0	0
19	7286421	.	T	A	33	31	64	0	0	64	0	0
19	7286742	.	A	G	28	32	60	0	2	62	0	0
19	7287600	.	T	C	28	32	60	0	2	62	0	0
19	7287603	.	G	A	29	30	59	0	3	62	0	0
19	7288195	.	A	G	34	28	62	0	0	62	0	0
19	7290175	.	A	G	33	30	63	0	6	69	0	0
19	7290214	.	A	G	29	30	59	0	6	65	0	0
19	7291642	.	A	T	25	33	58	0	0	58	0	0
19	7292621	.	G	A	2	4	6	0	1	7	0	0
19	7292636	.	A	T	3	5	8	0	0	8	0	0
19	7293138	.	A	G	2	3	5	0	1	6	0	0
19	7295279	.	G	A	6	5	11	0	0	11	0	0
19	7295572	.	G	C	2	5	7	0	1	8	0	0
19	7307063	.	A	T	1	2	3	0	0	3	0	0
19	7309154	.	G	A	8	12	20	0	1	21	0	0
19	7309391	.	C	A	23	23	46	0	1	47	0	0
19	7309522	.	G	C	21	16	37	0	0	37	0	0
19	7309556	.	T	A	24	12	36	0	0	37	1	0
19	7309557	.	T	A	23	13	36	0	1	37	0	0
19	7309754	.	T	G	6	12	18	0	0	18	0	0
19	7309929	.	A	T	17	17	34	1	1	36	0	0
19	7309968	.	G	T	15	20	35	0	0	35	0	0
19	7310117	.	T	C	20	0	20	1	12	33	0	0
19	7310131	.	C	T	19	11	30	0	1	31	0	0
19	7310154	.	A	T	14	10	24	0	1	25	0	0
19	7310974	.	T	G	21	10	31	0	0	31	0	0
19	7311678	.	T	G	15	15	30	0	1	31	0	0
19	7313933	.	C	G	16	26	42	0	1	43	0	0
19	7327462	.	A	G	16	14	30	1	0	31	0	0
19	7327519	.	C	T	12	13	25	0	1	26	0	0
19	7327564	.	G	T	16	12	28	0	1	29	0	0
19	7327570	.	T	C	16	13	29	0	0	29	0	0
19	7337862	.	C	A	15	5	20	0	1	21	0	0
19	7338033	.	C	T	3	13	16	0	29	45	0	0
19	7338125	.	C	T	8	9	17	0	4	21	0	0
19	7338150	.	G	A	8	8	16	0	0	16	0	0
19	7338218	.	A	T	10	5	15	0	0	15	0	0
19	7338309	.	C	T	0	14	14	0	13	27	0	0
19	7338402	.	C	T	2	8	10	0	16	26	0	0
19	7338425	.	T	C	17	9	26	0	2	28	0	0
19	7338444	.	T	C	19	0	19	0	11	30	0	0
19	7338969	.	C	T	13	12	25	0	0	25	0	0
19	7338978	.	T	C	14	0	14	0	11	25	0	0
19	7339008	.	T	G	14	12	26	0	0	26	0	0
19	7341300	.	G	A	11	15	26	0	1	27	0	0
19	7341385	.	A	G	8	8	16	0	0	16	0	0
19	7358131	.	A	G	11	11	22	1	0	23	0	0
19	7379601	.	C	T	6	8	14	0	1	15	0	0
19	7379637	.	T	C	7	0	7	0	9	16	0	0
19	7406810	.	G	T	6	5	11	0	0	11	0	0
19	7408360	.	T	G	14	16	30	0	0	30	0	0
19	7409036	.	C	G	8	7	15	0	0	15	0	0
19	7409961	.	A	G	5	6	11	0	1	12	0	0
19	7411975	.	T	C	6	4	10	0	0	10	0	0
19	7412062	.	T	C	7	9	16	0	0	16	0	0
19	7412320	.	C	T	2	14	16	0	0	16	0	0
19	7412432	.	C	A	4	4	8	0	0	8	0	0
19	7412441	.	C	A	2	3	5	0	0	5	0	0
19	7412490	.	T	C	4	3	7	0	0	7	0	0
19	7424794	.	G	A	7	6	13	0	0	13	0	0
19	7426637	.	C	T	10	5	15	0	0	15	0	0
19	7426814	.	C	T	7	6	13	0	0	13	0	0
19	7426832	.	G	A	8	9	17	0	0	17	0	0
19	7426967	.	T	C	10	15	25	0	0	25	0	0
19	7427099	.	C	A	12	11	23	0	1	24	0	0
19	7430160	.	T	C	12	9	21	0	2	23	0	0
19	7430607	.	G	A	0	15	15	0	8	23	0	0
19	7430652	.	C	T	7	8	15	0	2	17	0	0
19	7430700	.	A	G	2	1	3	0	8	11	0	0
19	7430715	.	C	A	2	8	10	0	0	10	0	0
19	7432806	.	A	C	1	3	4	0	0	4	0	0
19	7433068	.	T	A	5	4	9	0	1	10	0	0
19	7433454	.	G	A	2	5	7	0	1	8	0	0
19	7433598	.	C	T	1	4	5	0	0	5	0	0
19	7433601	.	T	C	2	3	5	0	1	6	0	0
19	7433841	.	G	T	5	3	8	1	0	9	0	0
19	7434161	.	G	T	5	7	12	0	0	12	0	0
19	7434611	.	G	C	8	4	12	0	0	12	0	0
19	7434753	.	A	G	5	2	7	0	1	8	0	0
19	7434866	.	C	T	7	3	10	0	0	10	0	0
19	7434881	.	C	T	0	2	2	0	6	8	0	0
19	7435410	.	A	G	5	2	7	0	0	7	0	0
19	7435440	.	C	T	1	2	3	0	2	5	0	0
19	7435605	.	T	C	2	4	6	0	0	6	0	0
19	7437053	.	A	G	1	6	7	0	0	7	0	0
19	7438363	.	C	A	6	3	9	0	0	9	0	0
19	7438384	.	C	T	7	3	10	0	0	10	0	0
19	7439799	.	C	T	3	6	9	0	0	9	0	0
19	7445897	.	C	T	26	28	54	0	0	54	0	0
19	7446050	.	T	C	28	20	48	0	1	49	0	0
19	7446137	.	G	T	24	27	51	0	0	51	0	0
19	7446286	.	G	T	32	24	56	0	2	58	0	0
19	7446495	.	G	T	34	32	66	0	6	72	0	0
19	7446621	.	C	A	37	26	63	0	3	66	0	0
19	7446702	.	T	C	38	35	73	0	1	74	0	0
19	7450572	.	G	A	33	35	68	0	2	70	0	0
19	7450658	.	T	C	19	12	31	0	2	33	0	0
19	7450750	.	A	G	11	8	19	0	0	19	0	0
19	7450783	.	C	T	1	6	7	0	8	15	0	0
19	7454109	.	A	C	3	5	8	1	0	9	0	0
19	7456364	.	T	C	3	10	13	0	0	13	0	0
19	7456371	.	A	C	4	11	15	0	0	15	0	0
19	7456722	.	C	G	7	8	15	0	0	15	0	0
19	7456793	.	A	G	4	5	9	0	1	10	0	0
19	7456816	.	C	G	6	5	11	0	1	12	0	0
19	7468556	.	G	T	1	8	9	0	0	9	0	0
19	7468580	.	C	T	5	8	13	0	0	13	0	0
19	7468746	.	T	A	7	11	18	0	3	21	0	0
19	7474242	.	T	C	8	9	17	0	1	18	0	0
19	7474245	.	T	G	8	0	8	0	10	18	0	0
19	7478159	.	A	G	10	13	23	0	0	23	0	0
19	7478283	.	C	T	5	4	9	0	0	9	0	0
19	7478356	.	G	A	4	9	13	0	0	13	0	0
19	7482931	.	C	T	7	6	13	0	0	13	0	0
19	7482993	.	G	A	4	3	7	2	1	10	0	0
19	7483059	.	A	T	7	6	13	0	0	13	0	0
19	7483469	.	T	G	6	5	11	0	1	12	0	0
19	7484313	.	T	A	3	5	8	0	0	8	0	0
19	7484354	.	A	T	4	5	9	0	0	9	0	0
19	7484357	.	G	A	5	5	10	0	0	10	0	0
19	7484536	.	G	T	7	2	9	0	1	10	0	0
19	7484668	.	A	T	6	3	9	2	0	11	0	0
19	7484834	.	A	G	4	3	7	0	0	7	0	0
19	7484856	.	C	G	3	3	6	0	2	8	0	0
19	7485117	.	C	T	1	3	4	0	0	4	0	0
19	7485298	.	A	C	1	4	5	0	0	5	0	0
19	7485339	.	A	C	3	3	6	0	0	6	0	0
19	7485343	.	T	A	3	1	4	0	0	4	0	0
19	7485503	.	G	A	7	3	10	0	0	10	0	0
19	7485839	.	G	T	4	3	7	0	0	7	0	0
19	7485890	.	G	A	5	5	10	0	0	10	0	0
19	7486791	.	T	C	3	3	6	0	0	6	0	0
19	7487096	.	G	A	6	3	9	0	0	9	0	0
19	7487103	.	G	A	6	3	9	0	0	9	0	0
19	7487163	.	A	G	5	2	7	0	1	8	0	0
19	7487321	.	C	T	5	2	7	0	3	10	0	0
19	7487592	.	T	A	5	5	10	0	0	10	0	0
19	7490873	.	T	A	4	7	11	0	0	11	0	0
19	7495867	.	A	T	12	16	28	0	2	30	0	0
19	7498046	.	T	C	12	12	24	0	2	26	0	0
19	7498079	.	A	G	12	12	24	0	5	29	0	0
19	7498103	.	A	G	11	11	22	0	2	24	0	0
19	7505591	.	A	G	8	17	25	0	1	26	0	0
19	7505907	.	A	G	9	0	9	0	8	17	0	0
19	7506097	.	T	C	1	2	3	0	0	3	0	0
19	7507833	.	A	T	12	11	23	0	1	24	0	0
19	7510223	.	T	C	20	10	30	0	1	31	0	0
19	7510348	.	T	C	11	11	22	0	2	24	0	0
19	7510501	.	G	A	2	10	12	0	10	22	0	0
19	7510567	.	C	T	14	12	26	0	0	26	0	0
19	7512406	.	C	G	19	11	30	0	0	30	0	0
19	7513085	.	C	T	9	14	23	0	1	24	0	0
19	7513291	.	A	C	12	10	22	0	0	22	0	0
19	7513406	.	A	T	10	11	21	0	0	21	0	0
19	7513631	.	A	G	8	9	17	0	0	17	0	0
19	7513651	.	A	G	8	8	16	0	0	16	0	0
19	7514025	.	T	C	10	5	15	0	1	16	0	0
19	7514341	.	A	G	3	9	12	0	1	13	0	0
19	7514344	.	A	G	4	8	12	0	1	13	0	0
19	7514512	.	T	C	10	6	16	0	0	16	0	0
19	7514538	.	C	G	9	3	12	0	1	13	0	0
19	7514708	.	A	G	6	3	9	0	0	9	0	0
19	7514852	.	A	G	6	5	11	0	0	11	0	0
19	7514917	.	A	G	9	3	12	1	0	14	1	0
19	7515336	.	A	T	10	7	17	0	1	18	0	0
19	7515356	.	G	A	11	9	20	0	1	21	0	0
19	7515787	.	A	T	9	8	17	0	1	18	0	0
19	7515829	.	C	T	6	13	19	0	0	19	0	0
19	7515845	.	A	T	7	11	18	0	3	21	0	0
19	7516035	.	A	G	5	10	15	0	0	15	0	0
19	7516063	.	A	C	5	14	19	0	1	20	0	0
19	7516169	.	C	A	10	5	15	0	0	15	0	0
19	7516183	.	T	G	5	2	7	0	1	8	0	0
19	7525148	.	C	T	3	6	9	0	11	20	0	0
19	7525222	.	T	G	6	4	10	0	1	11	0	0
19	7529948	.	A	G	3	2	5	0	0	5	0	0
19	7530663	.	C	A	1	3	4	0	0	4	0	0
19	7530865	.	C	G	2	2	4	0	0	4	0	0
19	7534401	.	A	G	5	4	9	0	0	9	0	0
19	7540354	.	C	T	1	3	4	0	4	8	0	0
19	7540734	.	T	G	4	2	6	0	0	6	0	0
19	7552736	.	C	A	17	17	34	0	1	35	0	0
19	7552737	.	G	T	2	16	18	0	17	35	0	0
19	7552887	.	A	G	14	21	35	0	1	36	0	0
19	7553368	.	T	C	17	20	37	0	2	39	0	0
19	7557538	.	T	C	20	20	40	0	2	42	0	0
19	7557735	.	T	C	20	21	41	0	1	42	0	0
19	7557793	.	G	C	16	23	39	0	0	39	0	0
19	7563894	.	A	T	20	24	44	0	0	44	0	0
19	7564073	.	A	G	19	17	36	0	2	38	0	0
19	7564176	.	C	T	31	19	50	0	1	51	0	0
19	7565462	.	T	A	22	18	40	0	0	40	0	0
19	7565463	.	T	C	22	17	39	0	1	40	0	0
19	7566488	.	A	T	6	5	11	0	0	11	0	0
19	7566493	.	A	T	11	4	15	0	0	15	0	0
19	7566770	.	A	G	15	12	27	0	1	28	0	0
19	7567011	.	T	C	14	18	32	0	1	33	0	0
19	7567021	.	T	A	14	15	29	0	0	29	0	0
19	7630359	.	T	A	4	4	8	0	1	9	0	0
19	7630435	.	A	G	1	3	4	0	1	5	0	0
19	7630689	.	A	T	5	6	11	0	0	11	0	0
19	7630785	.	C	T	1	2	3	0	0	3	0	0
19	7631386	.	C	T	19	18	37	0	0	37	0	0
19	7631700	.	G	A	0	9	9	0	19	28	0	0
19	7631860	.	T	C	9	16	25	0	1	26	0	0
19	7631968	.	T	C	4	11	15	0	0	15	0	0
19	7632056	.	C	T	6	4	10	0	0	10	0	0
19	7632470	.	C	T	3	8	11	0	0	11	0	0
19	7632526	.	T	C	5	9	14	0	1	15	0	0
19	7632837	.	C	T	3	9	12	1	1	14	0	0
19	7670506	.	A	G	1	0	1	0	2	3	0	0
19	7675354	.	A	G	2	0	2	0	2	4	0	0
19	7678900	.	A	G	0	2	2	0	1	3	0	0
19	7679110	.	A	G	1	2	3	0	0	3	0	0
19	7761855	.	C	T	15	8	23	0	3	26	0	0
19	7762934	.	G	A	9	10	19	0	0	19	0	0
19	7762958	.	G	A	1	8	9	0	15	24	0	0
19	7773391	.	C	G	6	17	23	0	0	23	0	0
19	7773457	.	A	G	5	0	5	0	8	13	0	0
19	7773459	.	A	C	6	7	13	0	0	13	0	0
19	7775547	.	A	T	14	23	37	0	3	40	0	0
19	7775552	.	T	C	17	24	41	0	1	42	0	0
19	7784681	.	T	A	26	20	46	0	4	50	0	0
19	7784684	.	T	A	24	20	44	0	6	50	0	0
19	7785138	.	C	T	25	23	48	0	2	50	0	0
19	7794830	.	G	C	0	18	18	0	24	42	0	0
19	7794872	.	A	G	20	0	20	0	22	42	0	0
19	7796398	.	C	T	21	19	40	0	0	40	0	0
19	7796975	.	T	C	12	11	23	0	1	24	0	0
19	7797539	.	T	G	14	9	23	0	1	24	0	0
19	7799137	.	T	C	7	8	15	0	0	15	0	0
19	7800812	.	A	G	5	11	16	1	0	17	0	0
19	7802622	.	G	A	6	12	18	0	0	18	0	0
19	7802700	.	G	A	6	17	23	0	1	24	0	0
19	7802704	.	T	C	5	16	21	0	1	22	0	0
19	7803480	.	G	A	0	8	8	0	10	18	0	0
19	7803685	.	C	A	6	13	19	0	0	19	0	0
19	7803730	.	G	A	3	17	20	0	1	21	0	0
19	7803745	.	T	A	5	19	24	0	0	24	0	0
19	7804785	.	A	C	4	18	22	0	0	22	0	0
19	7804841	.	G	A	4	13	17	0	0	17	0	0
19	7804843	.	G	A	4	12	16	0	1	17	0	0
19	7804892	.	C	T	6	17	23	0	1	24	0	0
19	7804937	.	C	T	6	16	22	0	0	22	0	0
19	7804967	.	A	C	1	8	9	0	1	10	0	0
19	7804998	.	T	A	1	3	4	0	0	4	0	0
19	7819726	.	G	A	2	2	4	0	4	8	0	0
19	7820018	.	C	G	8	4	12	0	0	12	0	0
19	7820767	.	C	T	1	11	12	0	8	20	0	0
19	7820992	.	C	A	2	6	8	0	9	17	0	0
19	7821055	.	C	T	12	8	20	0	1	21	0	0
19	7822581	.	T	C	6	0	6	0	10	16	0	0
19	7825025	.	T	G	8	4	12	0	1	13	0	0
19	7825181	.	G	C	9	4	13	0	1	14	0	0
19	7825259	.	G	A	11	10	21	0	1	22	0	0
19	7825300	.	A	G	9	7	16	0	0	16	0	0
19	7827666	.	A	G	4	11	15	0	0	15	0	0
19	7828600	.	T	C	4	6	10	0	2	12	0	0
19	7829333	.	C	A	3	4	7	0	1	8	0	0
19	7829998	.	A	G	4	7	11	0	0	11	0	0
19	7830064	.	A	G	6	7	13	0	0	13	0	0
19	7835708	.	C	T	3	6	9	0	0	9	0	0
19	8979185	.	G	T	5	2	7	0	0	7	0	0
19	9603042	.	T	G	4	0	4	1	16	21	0	0
19	9685695	.	A	G	27	26	53	0	3	56	0	0
19	9685714	.	A	C	23	24	47	0	4	51	0	0
19	9686078	.	C	A	12	8	20	0	0	20	0	0
19	9686099	.	G	T	10	8	18	0	1	19	0	0
19	9686160	.	T	C	12	16	28	0	1	29	0	0
19	9686199	.	G	T	14	17	31	0	1	32	0	0
19	9686474	.	G	A	20	18	38	0	2	40	0	0
19	9686503	.	A	G	18	12	30	0	2	32	0	0
19	9686548	.	T	A	15	5	20	1	0	21	0	0
19	9686575	.	T	A	15	9	24	1	0	25	0	0
19	9686616	.	A	T	16	13	29	0	0	29	0	0
19	9686646	.	C	T	21	8	29	0	0	29	0	0
19	9686678	.	T	A	20	8	28	0	0	28	0	0
19	9686806	.	T	C	12	4	16	0	0	16	0	0
19	9686905	.	T	C	4	0	4	0	11	15	0	0
19	9687033	.	C	T	18	16	34	0	1	35	0	0
19	9687073	.	G	A	21	19	40	0	2	42	0	0
19	9687146	.	T	C	29	21	50	0	0	50	0	0
19	9691780	.	A	G	19	27	46	0	0	46	0	0
19	9700886	.	T	C	9	0	9	0	11	20	0	0
19	9712444	.	G	A	19	17	36	0	1	37	0	0
19	9712514	.	C	T	12	5	17	0	0	17	0	0
19	10255458	.	T	C	1	0	1	0	8	9	0	0
19	10255459	.	A	G	0	7	7	0	1	8	0	0
19	10989189	.	A	C	10	9	19	1	1	21	0	0
19	10989343	.	T	A	18	16	34	0	1	35	0	0
19	10989457	.	T	C	14	15	29	0	2	31	0	0
19	10989511	.	A	G	16	13	29	0	1	30	0	0
19	10989653	.	C	A	18	14	32	0	0	32	0	0
19	10997288	.	A	G	4	2	6	0	0	6	0	0
19	10999786	.	G	T	13	15	28	0	0	29	1	0
19	11014636	.	G	A	17	20	37	0	1	38	0	0
19	11014675	.	A	G	17	17	34	0	1	35	0	0
19	11015010	.	G	C	4	7	11	0	0	11	0	0
19	11039829	.	G	C	4	9	13	0	0	13	0	0
19	11040493	.	A	T	6	14	20	0	1	21	0	0
19	11045311	.	C	A	1	11	12	0	16	28	0	0
19	11045323	.	C	T	16	11	27	0	3	30	0	0
19	11045864	.	A	C	9	11	20	0	0	20	0	0
19	11048822	.	C	T	3	17	20	0	13	33	0	0
19	11051581	.	T	C	12	12	24	0	2	26	0	0
19	11063846	.	C	T	10	6	16	0	0	16	0	0
19	11070794	.	G	A	7	10	17	0	0	17	0	0
19	11079087	.	T	C	3	7	10	0	0	10	0	0
19	11079284	.	C	G	6	5	11	0	0	11	0	0
19	11093564	.	T	C	11	7	18	0	0	18	0	0
19	11093567	.	A	G	11	8	19	0	0	19	0	0
19	11129383	.	T	G	2	3	5	0	0	5	0	0
19	11131388	.	A	G	3	6	9	0	2	11	0	0
19	11172188	.	G	A	6	2	8	0	1	9	0	0
19	11174774	.	C	T	0	2	2	0	6	8	0	0
19	11231386	.	C	A	7	11	18	0	1	19	0	0
19	11237043	.	A	G	14	8	22	0	1	23	0	0
19	11237049	.	T	C	15	10	25	0	0	25	0	0
19	11274926	.	T	C	5	0	5	0	4	9	0	0
19	11275607	.	G	C	4	2	6	0	0	6	0	0
19	11314625	.	C	T	6	2	8	0	0	8	0	0
19	11314807	.	C	T	6	2	8	0	0	8	0	0
19	11314858	.	A	T	6	4	10	0	0	10	0	0
19	11314945	.	A	G	5	3	8	0	0	8	0	0
19	11315067	.	G	A	4	2	6	0	1	7	0	0
19	11331967	.	G	T	13	8	21	1	1	23	0	0
19	11332050	.	G	T	10	20	30	0	2	32	0	0
19	11332071	.	T	C	11	18	29	0	1	30	0	0
19	11332574	.	T	A	18	13	31	0	0	31	0	0
19	11332576	.	C	T	17	13	30	0	1	31	0	0
19	11332670	.	T	C	13	0	13	0	9	22	0	0
19	11344347	.	T	A	17	12	29	0	5	35	1	0
19	11347910	.	C	T	1	12	13	0	18	31	0	0
19	11356692	.	G	A	15	6	21	0	0	21	0	0
19	11430915	.	C	T	2	2	4	0	0	4	0	0
19	11430917	.	C	T	1	2	3	0	1	4	0	0
19	11508991	.	G	C	8	5	13	0	0	13	0	0
19	11509029	.	T	C	8	0	8	0	7	15	0	0
19	11545803	.	T	G	4	9	13	0	0	13	0	0
19	11546105	.	G	A	9	9	18	0	0	18	0	0
19	11546181	.	G	A	6	3	9	0	2	11	0	0
19	11632927	.	A	C	4	3	7	0	1	8	0	0
19	11790720	.	C	T	0	3	3	0	6	9	0	0
19	11790915	.	G	A	5	4	9	0	1	10	0	0
19	11792756	.	A	T	4	3	7	0	0	7	0	0
19	11815087	.	G	A	4	5	9	0	0	9	0	0
19	11815306	.	C	T	2	4	6	0	0	6	0	0
19	11815325	.	C	T	2	5	7	0	1	8	0	0
19	11815448	.	T	A	4	4	8	0	0	8	0	0
19	11815507	.	A	T	3	5	8	0	0	8	0	0
19	11815762	.	T	C	2	0	2	0	5	7	0	0
19	11843254	.	G	A	2	6	8	0	0	8	0	0
19	11846538	.	G	A	4	5	9	0	0	9	0	0
19	11846550	.	G	C	4	4	8	0	1	9	0	0
19	11846607	.	G	T	1	3	4	0	0	4	0	0
19	11846718	.	A	C	1	0	1	0	3	4	0	0
19	11846911	.	A	T	1	5	6	0	0	6	0	0
19	11875436	.	C	T	5	2	7	0	0	7	0	0
19	11877560	.	T	C	2	2	4	0	1	5	0	0
19	11892419	.	A	T	6	10	16	0	0	16	0	0
19	11892422	.	A	G	6	10	16	0	0	16	0	0
19	11892515	.	A	G	2	11	13	0	0	13	0	0
19	11892636	.	T	A	4	10	14	0	0	14	0	0
19	11893087	.	A	G	6	10	16	0	0	16	0	0
19	11893309	.	G	T	0	2	2	2	4	8	0	0
19	11893313	.	G	A	4	3	7	2	0	9	0	0
19	11893445	.	A	G	5	6	11	0	0	11	0	0
19	11893624	.	T	C	3	5	8	0	0	8	0	0
19	11893650	.	T	A	5	4	9	0	0	9	0	0
19	11893785	.	G	T	1	4	5	0	0	5	0	0
19	11897774	.	T	C	6	4	10	0	1	11	0	0
19	11897841	.	G	T	4	3	7	0	0	7	0	0
19	11899324	.	A	G	9	10	19	0	1	20	0	0
19	11899384	.	T	C	14	5	19	0	4	23	0	0
19	11903571	.	A	G	17	10	27	0	1	28	0	0
19	11906178	.	G	A	9	11	20	0	1	21	0	0
19	11906238	.	T	G	10	7	17	0	1	18	0	0
19	11908436	.	A	G	6	4	10	0	1	11	0	0
19	11908567	.	G	A	9	6	15	0	0	15	0	0
19	11910538	.	T	C	6	0	6	0	11	17	0	0
19	11910595	.	A	C	4	9	13	0	0	13	0	0
19	11912635	.	T	A	10	15	25	0	0	25	0	0
19	11912838	.	T	G	9	7	16	0	0	16	0	0
19	11915066	.	T	G	8	9	17	0	0	17	0	0
19	11915233	.	A	G	8	5	13	0	0	13	0	0
19	11915272	.	A	G	7	4	11	0	1	12	0	0
19	11915320	.	G	A	6	13	19	0	0	19	0	0
19	11917609	.	T	A	9	5	14	0	1	15	0	0
19	11917682	.	A	T	4	4	8	0	0	8	0	0
19	11917805	.	T	C	8	7	15	0	0	15	0	0
19	11920819	.	A	G	3	3	6	0	0	6	0	0
19	11921047	.	C	T	5	6	11	0	0	11	0	0
19	11921816	.	G	A	6	5	11	0	0	11	0	0
19	11921817	.	T	A	5	5	10	0	0	10	0	0
19	11927986	.	G	A	3	8	11	0	0	11	0	0
19	11935191	.	A	G	6	8	14	0	0	14	0	0
19	11940228	.	A	G	3	5	8	0	0	8	0	0
19	11941224	.	G	T	7	7	14	0	0	14	0	0
19	11949909	.	A	G	3	4	7	0	1	8	0	0
19	11955713	.	A	G	8	6	14	0	0	14	0	0
19	11960343	.	C	T	2	4	6	0	0	6	0	0
19	11964016	.	A	G	3	5	8	0	1	9	0	0
19	11964313	.	A	G	4	6	10	0	0	10	0	0
19	11969337	.	G	A	5	2	7	0	0	7	0	0
19	11975110	.	A	G	2	3	5	0	0	5	0	0
19	11975159	.	G	T	3	4	7	0	0	7	0	0
19	11985848	.	C	T	9	6	15	0	1	16	0	0
19	11985858	.	T	C	8	4	12	0	1	14	1	0
19	11996249	.	T	A	12	3	15	0	0	15	0	0
19	11996360	.	A	C	9	7	16	0	1	18	1	0
19	12017902	.	G	A	1	15	16	0	8	24	0	0
19	12018036	.	C	G	7	5	12	0	0	12	0	0
19	12018084	.	C	T	7	7	14	0	0	14	0	0
19	12018147	.	A	G	5	2	7	0	0	7	0	0
19	12018291	.	A	G	5	0	5	0	5	10	0	0
19	12018367	.	G	T	2	4	6	0	4	10	0	0
19	12031138	.	G	T	7	7	14	0	1	15	0	0
19	12031202	.	C	T	1	3	4	0	9	13	0	0
19	12031515	.	T	G	8	7	15	0	1	16	0	0
19	12031920	.	G	A	6	7	13	0	0	13	0	0
19	12031925	.	G	T	5	8	13	0	1	14	0	0
19	12032273	.	G	T	3	2	5	0	1	6	0	0
19	12032622	.	C	T	5	3	8	0	0	8	0	0
19	12032649	.	G	A	6	3	9	0	1	10	0	0
19	12033428	.	T	C	9	7	16	0	0	16	0	0
19	12033494	.	T	C	5	0	5	0	6	11	0	0
19	12046899	.	C	A	2	2	4	0	0	4	0	0
19	12122035	.	A	G	22	17	39	0	1	40	0	0
19	12122039	.	G	A	20	17	37	0	2	39	0	0
19	12122124	.	C	A	46	21	67	0	4	71	0	0
19	12122489	.	G	T	41	22	63	0	2	65	0	0
19	12130089	.	G	A	39	39	78	0	1	79	0	0
19	12134950	.	C	G	1	3	4	0	0	4	0	0
19	12134960	.	T	G	1	3	4	0	0	4	0	0
19	12145548	.	A	T	28	26	54	1	5	60	0	0
19	12171712	.	C	T	28	29	57	1	1	59	0	0
19	12188083	.	G	T	36	27	63	0	4	67	0	0
19	12188207	.	A	G	34	30	64	0	2	66	0	0
19	12188243	.	A	G	34	29	63	0	3	66	0	0
19	12188249	.	A	G	33	28	61	0	5	66	0	0
19	12193578	.	G	C	30	26	56	0	0	56	0	0
19	12193604	.	A	G	16	20	36	0	1	37	0	0
19	12193617	.	T	A	9	13	22	0	1	23	0	0
19	12206504	.	T	G	7	9	16	1	1	18	0	0
19	12297178	.	C	T	6	5	11	0	0	11	0	0
19	12297375	.	A	G	7	4	11	0	0	12	1	0
19	12297869	.	A	C	1	4	5	0	1	6	0	0
19	12300840	.	G	A	8	6	14	0	2	16	0	0
19	12304095	.	C	T	10	9	19	0	0	19	0	0
19	12304137	.	A	G	10	8	18	0	3	21	0	0
19	12356418	.	G	A	0	7	7	0	6	13	0	0
19	12356511	.	C	A	6	8	14	0	0	14	0	0
19	12363275	.	C	T	14	11	25	1	0	26	0	0
19	12380004	.	A	T	9	12	21	0	2	23	0	0
19	12380029	.	A	T	9	15	24	0	1	25	0	0
19	12383332	.	T	G	3	0	3	0	13	16	0	0
19	12383623	.	G	A	3	5	8	0	0	8	0	0
19	12385998	.	A	G	7	5	12	0	0	12	0	0
19	12386124	.	T	C	4	3	7	0	1	8	0	0
19	12410252	.	A	G	7	10	17	0	1	18	0	0
19	12413422	.	C	A	12	9	21	0	1	22	0	0
19	12413479	.	C	T	13	7	20	0	2	22	0	0
19	12420188	.	G	A	1	6	7	0	10	17	0	0
19	12424420	.	A	T	9	13	22	0	0	22	0	0
19	12427675	.	G	A	3	10	13	0	0	13	0	0
19	12428228	.	A	G	2	2	4	0	0	4	0	0
19	12428413	.	C	G	3	4	7	0	0	7	0	0
19	12428634	.	A	G	9	9	18	0	2	20	0	0
19	12428646	.	A	G	9	11	20	0	1	21	0	0
19	12428741	.	T	C	9	11	20	0	0	20	0	0
19	12428754	.	A	G	9	11	20	0	0	20	0	0
19	12645583	.	G	T	12	10	22	0	0	22	0	0
19	12645661	.	C	T	14	9	23	0	0	23	0	0
19	12648372	.	T	C	8	6	14	0	0	14	0	0
19	12655554	.	G	A	1	7	8	2	6	16	0	0
19	12655606	.	G	C	3	6	9	0	0	9	0	0
19	12661671	.	T	G	3	7	10	0	0	10	0	0
19	12762981	.	G	C	21	7	28	1	1	30	0	0
19	12801983	.	T	C	17	8	25	0	2	27	0	0
19	12801987	.	T	C	19	9	28	0	1	29	0	0
19	12802125	.	A	C	10	9	19	0	0	19	0	0
19	12802137	.	C	T	12	8	20	0	0	20	0	0
19	12802173	.	G	A	7	7	14	0	0	14	0	0
19	12802326	.	A	G	5	5	10	0	1	11	0	0
19	12802485	.	G	A	0	6	6	0	12	18	0	0
19	12802554	.	T	C	9	10	19	0	0	19	0	0
19	12802662	.	T	C	14	6	20	0	1	21	0	0
19	12802665	.	T	C	15	5	20	0	0	20	0	0
19	12802956	.	C	T	4	5	9	0	0	9	0	0
19	12802986	.	T	C	6	8	14	0	0	14	0	0
19	12803053	.	T	C	3	7	10	0	0	10	0	0
19	12803218	.	A	G	5	10	15	0	2	17	0	0
19	12937249	.	A	G	12	14	26	0	1	27	0	0
19	12937364	.	G	A	11	10	21	0	0	21	0	0
19	12937444	.	T	C	24	0	24	0	9	33	0	0
19	12937542	.	C	T	9	13	22	0	2	24	0	0
19	12937574	.	A	G	8	13	21	0	2	23	0	0
19	12938085	.	G	A	2	2	4	0	0	4	0	0
19	12938114	.	T	C	3	2	5	0	1	6	0	0
19	12938780	.	C	G	4	4	8	0	1	9	0	0
19	12938817	.	A	T	3	3	6	0	1	7	0	0
19	12939013	.	C	T	3	2	5	0	0	5	0	0
19	12939183	.	T	C	1	2	3	0	0	3	0	0
19	12939298	.	A	C	4	3	7	0	0	7	0	0
19	12939317	.	A	G	3	3	6	0	0	6	0	0
19	12939380	.	T	C	1	4	5	0	0	5	0	0
19	12939385	.	G	A	2	3	5	0	0	5	0	0
19	12939471	.	A	T	11	7	18	0	1	19	0	0
19	12939482	.	C	A	12	6	18	0	0	18	0	0
19	12939628	.	G	A	11	12	23	0	1	24	0	0
19	12964728	.	C	T	5	6	11	1	2	14	0	0
19	13121476	.	C	T	13	6	19	0	0	19	0	0
19	13184781	.	A	T	19	14	33	0	2	35	0	0
19	13185127	.	G	A	18	14	32	0	3	35	0	0
19	13185378	.	C	A	21	19	40	0	3	43	0	0
19	13186340	.	C	T	19	27	46	0	0	46	0	0
19	13186357	.	A	G	15	30	45	0	1	46	0	0
19	13186673	.	A	G	17	13	30	0	0	30	0	0
19	13193382	.	T	A	3	2	5	0	0	5	0	0
19	13194073	.	T	A	3	7	10	0	1	11	0	0
19	13194133	.	C	T	9	10	19	0	0	19	0	0
19	13194246	.	A	G	9	4	13	0	2	15	0	0
19	13194309	.	T	G	5	5	10	0	0	10	0	0
19	13194522	.	T	C	3	0	3	0	5	8	0	0
19	13194812	.	T	A	7	8	15	0	3	18	0	0
19	13194902	.	G	T	3	12	15	0	0	15	0	0
19	13194930	.	T	C	6	10	16	0	1	17	0	0
19	13194974	.	C	G	6	10	16	0	0	16	0	0
19	13195023	.	A	T	5	10	15	0	1	16	0	0
19	13195224	.	G	C	6	0	6	0	8	14	0	0
19	13196073	.	A	G	4	3	7	0	0	7	0	0
19	13196586	.	A	G	6	12	18	0	1	19	0	0
19	13198230	.	A	G	4	5	9	0	0	9	0	0
19	13390921	.	G	C	5	8	13	0	0	13	0	0
19	13395156	.	T	A	16	8	24	1	2	27	0	0
19	13395347	.	G	A	0	10	10	0	12	22	0	0
19	13395737	.	A	G	14	11	25	0	1	26	0	0
19	13395819	.	T	C	12	9	21	0	0	21	0	0
19	13395959	.	G	T	17	13	30	0	0	30	0	0
19	13395962	.	T	G	16	12	28	0	0	28	0	0
19	13396252	.	C	T	7	6	13	0	0	13	0	0
19	13396481	.	T	C	15	15	30	0	1	31	0	0
19	13396486	.	G	C	13	16	29	0	0	29	0	0
19	13396619	.	C	A	9	7	16	0	1	17	0	0
19	13396702	.	C	G	8	6	14	0	1	15	0	0
19	13413068	.	A	T	20	17	37	1	1	39	0	0
19	13413387	.	T	C	13	10	23	0	0	23	0	0
19	13413432	.	C	A	10	10	20	0	3	23	0	0
19	13413445	.	A	G	6	12	18	0	0	18	0	0
19	13413547	.	A	G	5	2	7	0	1	8	0	0
19	13413551	.	A	G	5	0	5	0	3	8	0	0
19	13413683	.	A	G	6	11	17	0	1	18	0	0
19	13413727	.	G	A	4	5	9	0	0	9	0	0
19	13413776	.	G	C	7	6	13	0	0	13	0	0
19	13413807	.	G	T	6	4	10	0	0	10	0	0
19	13413844	.	C	T	6	5	11	0	0	11	0	0
19	13414896	.	C	T	8	6	14	0	1	15	0	0
19	13415169	.	C	T	22	12	34	0	0	34	0	0
19	13419582	.	T	C	20	28	48	0	1	49	0	0
19	13419696	.	A	G	20	1	21	0	25	46	0	0
19	13419948	.	A	C	9	7	16	0	5	21	0	0
19	13419986	.	C	G	10	12	22	0	1	23	0	0
19	13425618	.	T	C	8	9	17	0	1	18	0	0
19	13425707	.	A	G	11	7	18	0	0	18	0	0
19	13426090	.	A	T	5	4	9	0	0	9	0	0
19	13639492	.	T	A	14	13	27	0	1	28	0	0
19	13651691	.	G	T	10	7	17	0	0	17	0	0
19	13670103	.	C	T	3	11	14	0	18	32	0	0
19	13688974	.	G	A	19	14	33	0	0	33	0	0
19	13698141	.	G	A	18	10	28	0	1	29	0	0
19	13698643	.	G	A	19	10	29	0	1	30	0	0
19	13698685	.	T	C	11	12	23	0	2	25	0	0
19	13714963	.	A	G	11	7	18	0	0	18	0	0
19	13724014	.	T	C	22	13	35	0	6	41	0	0
19	13724320	.	T	G	11	6	17	0	3	20	0	0
19	13733583	.	C	G	15	14	29	0	0	29	0	0
19	13905442	.	T	A	12	13	25	0	0	25	0	0
19	13905469	.	T	G	13	8	21	0	0	21	0	0
19	13919292	.	A	T	13	18	31	0	1	32	0	0
19	13923051	.	A	T	10	8	18	0	0	18	0	0
19	13925019	.	G	A	1	2	3	0	0	3	0	0
19	13939827	.	T	C	7	3	10	1	0	11	0	0
19	13939839	.	G	C	10	5	15	1	1	17	0	0
19	13939883	.	C	G	16	15	31	0	0	31	0	0
19	13940106	.	A	G	13	19	32	0	0	32	0	0
19	13940123	.	A	T	13	15	28	0	1	30	1	0
19	13940168	.	G	A	15	16	31	0	0	31	0	0
19	13940227	.	G	T	17	15	32	0	2	34	0	0
19	13940423	.	G	T	24	19	43	0	0	43	0	0
19	13940500	.	C	T	16	22	38	0	0	38	0	0
19	13940614	.	T	C	14	11	25	0	0	25	0	0
19	13940728	.	A	G	6	3	9	0	0	9	0	0
19	13940936	.	C	A	13	12	25	0	1	27	1	0
19	13941161	.	C	T	17	22	39	0	3	42	0	0
19	13941285	.	T	C	12	18	30	0	1	31	0	0
19	13941311	.	C	T	8	16	24	0	3	27	0	0
19	13941403	.	T	A	11	17	28	0	3	31	0	0
19	13941442	.	T	C	16	18	34	0	2	36	0	0
19	13941448	.	A	G	18	19	37	0	1	38	0	0
19	13941505	.	G	C	23	25	48	2	0	50	0	0
19	13941526	.	G	T	23	16	39	2	0	42	1	0
19	13941667	.	T	A	23	28	51	0	4	55	0	0
19	13950183	.	T	C	14	7	21	0	0	21	0	0
19	14035650	.	T	C	3	4	7	0	0	7	0	0
19	14035672	.	G	A	3	5	8	0	0	8	0	0
19	14060962	.	G	A	0	2	2	0	2	4	0	0
19	14060976	.	T	C	2	2	4	0	0	4	0	0
19	14165408	.	G	A	0	7	7	0	13	20	0	0
19	14169238	.	T	A	7	11	18	0	1	19	0	0
19	14352629	.	C	A	12	9	21	0	1	22	0	0
19	14352661	.	C	T	13	8	21	0	1	22	0	0
19	14390171	.	G	A	7	7	14	1	1	16	0	0
19	14394930	.	A	T	8	5	13	0	4	17	0	0
19	14419371	.	A	G	7	0	7	0	12	19	0	0
19	14419398	.	T	C	9	8	17	0	0	17	0	0
19	14420840	.	T	A	2	7	9	0	0	9	0	0
19	14420841	.	T	C	2	7	9	0	0	9	0	0
19	14421115	.	C	G	2	3	5	0	0	5	0	0
19	14421259	.	A	G	1	0	1	0	7	8	0	0
19	14431424	.	T	A	8	12	20	0	0	20	0	0
19	14433417	.	A	G	4	7	11	0	0	11	0	0
19	14434077	.	A	G	12	16	28	0	0	28	0	0
19	14434078	.	G	A	13	16	29	0	0	29	0	0
19	14434441	.	A	T	9	11	20	0	0	20	0	0
19	14435968	.	T	C	10	13	23	0	2	25	0	0
19	14454521	.	G	A	8	2	10	0	3	13	0	0
19	14462446	.	G	A	0	13	13	0	7	20	0	0
19	14469746	.	A	G	2	2	4	0	0	4	0	0
19	14470519	.	C	A	2	1	3	0	1	4	0	0
19	14574100	.	G	T	3	2	5	0	0	5	0	0
19	14587556	.	C	T	1	2	3	0	0	3	0	0
19	14921238	.	T	C	1	2	3	0	0	3	0	0
19	14921241	.	C	T	1	2	3	0	0	3	0	0
19	14950741	.	T	C	1	2	3	0	0	3	0	0
19	14951282	.	C	T	4	5	9	0	0	9	0	0
19	14951474	.	T	C	9	6	15	0	1	16	0	0
19	14951567	.	A	G	3	0	3	0	5	8	0	0
19	15307882	.	T	C	9	4	13	0	0	13	0	0
19	15308389	.	G	T	19	17	36	0	1	37	0	0
19	15313034	.	A	C	21	13	34	0	0	34	0	0
19	15313115	.	G	A	16	12	28	0	0	28	0	0
19	15331663	.	T	C	15	18	33	0	0	33	0	0
19	15331686	.	T	C	18	14	32	0	0	32	0	0
19	15331699	.	C	T	2	17	19	0	17	36	0	0
19	15331805	.	C	A	15	9	24	0	1	25	0	0
19	15331970	.	T	C	13	0	13	0	20	33	0	0
19	15331978	.	G	A	14	18	32	0	1	33	0	0
19	15332115	.	G	T	13	16	29	0	0	29	0	0
19	15332116	.	A	G	14	16	30	0	0	30	0	0
19	15332911	.	T	C	14	8	22	0	1	23	0	0
19	15333709	.	T	A	12	10	22	0	4	26	0	0
19	15334602	.	G	A	5	3	8	0	0	8	0	0
19	15334621	.	T	C	7	10	17	0	0	17	0	0
19	15334702	.	G	T	4	5	9	0	0	9	0	0
19	15334745	.	G	A	5	6	11	0	1	12	0	0
19	15334851	.	C	G	8	6	14	0	0	14	0	0
19	15334858	.	G	A	5	9	14	0	0	14	0	0
19	15335123	.	G	A	4	7	11	0	0	11	0	0
19	15411142	.	G	A	1	2	3	0	0	3	0	0
19	15496293	.	C	G	2	2	4	0	0	4	0	0
19	15510543	.	T	C	1	3	4	0	0	4	0	0
19	15527165	.	C	T	3	3	6	0	0	6	0	0
19	15532159	.	C	T	3	3	6	0	0	6	0	0
19	15532186	.	A	G	3	0	3	0	4	7	0	0
19	15532386	.	G	C	3	2	5	0	0	5	0	0
19	15532391	.	C	T	3	3	6	0	0	6	0	0
19	15571480	.	T	C	6	5	11	0	0	11	0	0
19	15617983	.	A	C	4	3	7	0	3	10	0	0
19	15617998	.	A	C	6	3	9	0	0	9	0	0
19	15618501	.	G	A	5	6	11	0	1	12	0	0
19	15618813	.	C	T	6	18	24	0	1	25	0	0
19	15618951	.	G	A	15	14	29	0	2	31	0	0
19	15619503	.	C	T	7	10	17	0	0	17	0	0
19	15619584	.	A	G	14	11	25	0	0	25	0	0
19	15619675	.	A	G	5	0	5	0	15	20	0	0
19	15851707	.	C	A	10	11	21	0	0	21	0	0
19	15851710	.	G	A	11	9	20	0	0	20	0	0
19	15851777	.	G	A	18	13	31	0	1	32	0	0
19	15851890	.	C	T	9	5	14	0	0	14	0	0
19	15852389	.	T	A	14	9	23	0	0	23	0	0
19	15852965	.	C	T	1	13	14	0	6	20	0	0
19	15853008	.	C	T	0	6	6	0	11	17	0	0
19	15853153	.	C	T	9	16	25	0	0	25	0	0
19	15853275	.	A	G	13	19	32	0	3	35	0	0
19	15855335	.	A	T	9	23	32	0	0	32	0	0
19	16016106	.	C	A	6	4	10	0	0	10	0	0
19	16020793	.	A	T	3	5	8	0	0	8	0	0
19	16021307	.	G	A	7	5	12	0	1	13	0	0
19	16022671	.	G	A	4	2	6	0	0	6	0	0
19	16023901	.	C	T	6	9	15	0	0	15	0	0
19	16026993	.	G	A	1	2	3	0	0	3	0	0
19	16027319	.	A	T	1	2	3	0	0	3	0	0
19	16027334	.	G	A	3	3	6	0	0	6	0	0
19	16027840	.	C	A	1	2	3	0	0	3	0	0
19	16027849	.	G	A	1	2	3	0	0	3	0	0
19	16070475	.	A	G	4	6	10	0	0	10	0	0
19	16076887	.	C	T	3	6	9	0	0	9	0	0
19	16077033	.	C	T	7	2	9	0	1	10	0	0
19	16078744	.	C	A	6	6	12	0	0	12	0	0
19	16082394	.	G	A	7	4	11	0	1	12	0	0
19	16082756	.	G	A	5	5	10	0	0	10	0	0
19	16085862	.	A	T	11	11	22	0	1	23	0	0
19	16086025	.	T	A	12	8	20	0	1	21	0	0
19	16086937	.	G	A	5	4	9	0	1	10	0	0
19	16086957	.	T	C	5	6	11	0	1	12	0	0
19	16087201	.	T	C	1	4	5	0	0	5	0	0
19	16087503	.	T	A	2	4	6	0	0	6	0	0
19	16087527	.	C	T	3	4	7	0	1	8	0	0
19	16087538	.	G	A	4	5	9	0	0	9	0	0
19	16087895	.	T	A	1	3	4	0	1	5	0	0
19	16222703	.	C	G	8	10	18	0	0	18	0	0
19	16356349	.	C	G	3	7	10	0	1	11	0	0
19	16522130	.	G	A	0	6	6	0	11	17	0	0
19	16528787	.	A	T	5	7	12	0	1	13	0	0
19	16541333	.	C	T	7	3	10	0	0	10	0	0
19	16541375	.	A	T	5	7	12	0	0	12	0	0
19	16541378	.	G	A	6	7	13	0	0	13	0	0
19	16576532	.	G	A	7	7	14	0	0	14	0	0
19	16576574	.	A	T	3	7	10	0	0	10	0	0
19	16584121	.	G	A	0	8	8	0	15	23	0	0
19	16584205	.	C	T	10	12	22	0	0	22	0	0
19	16625154	.	G	T	9	8	17	0	2	19	0	0
19	16629317	.	A	G	11	12	23	1	2	26	0	0
19	16638661	.	C	T	15	17	32	2	0	34	0	0
19	16638786	.	C	T	21	19	40	0	1	41	0	0
19	16638906	.	C	G	8	11	19	0	2	21	0	0
19	16638951	.	A	G	10	8	18	0	1	19	0	0
19	16651469	.	T	C	16	6	22	0	0	22	0	0
19	16653867	.	T	C	15	9	24	2	1	27	0	0
19	16653977	.	T	C	8	9	17	0	0	17	0	0
19	16653998	.	T	C	8	11	19	0	0	19	0	0
19	16654012	.	T	C	8	10	18	0	0	18	0	0
19	16654277	.	G	A	1	10	11	0	11	22	0	0
19	16654640	.	A	G	13	14	27	1	0	28	0	0
19	17208304	.	C	T	3	6	9	0	0	9	0	0
19	17209325	.	G	A	6	4	10	0	1	11	0	0
19	17260250	.	C	G	10	7	17	0	1	18	0	0
19	17275632	.	C	A	2	5	7	0	0	7	0	0
19	17276921	.	A	T	13	4	17	0	1	18	0	0
19	17292831	.	A	T	1	3	4	0	0	4	0	0
19	17292898	.	T	A	7	4	11	0	0	11	0	0
19	17292905	.	G	A	6	4	10	0	0	10	0	0
19	17293153	.	T	G	2	2	4	0	0	4	0	0
19	17293345	.	C	T	13	8	21	0	4	25	0	0
19	17295656	.	G	A	19	8	27	0	1	28	0	0
19	17295674	.	C	T	16	7	23	0	2	25	0	0
19	17300130	.	G	A	11	7	18	0	1	19	0	0
19	17300536	.	C	T	15	7	22	0	0	22	0	0
19	17301292	.	A	G	7	9	16	0	1	17	0	0
19	17302363	.	T	A	11	10	21	0	0	21	0	0
19	17304888	.	A	G	15	15	30	0	0	30	0	0
19	17304891	.	T	C	15	12	27	0	0	27	0	0
19	17377786	.	T	G	4	2	6	0	0	6	0	0
19	17378361	.	C	T	10	7	17	0	1	18	0	0
19	17385412	.	T	A	1	6	7	0	0	7	0	0
19	17385445	.	C	T	7	2	9	0	0	9	0	0
19	17385479	.	T	G	5	2	7	0	0	7	0	0
19	17385486	.	G	T	4	2	6	0	0	6	0	0
19	17386556	.	G	T	26	31	57	0	0	57	0	0
19	17393069	.	T	C	25	21	46	0	6	52	0	0
19	17400470	.	C	T	14	14	28	0	1	29	0	0
19	17400653	.	G	C	16	15	31	1	0	32	0	0
19	17404237	.	C	T	26	19	45	0	2	47	0	0
19	17405304	.	C	T	33	24	57	0	3	60	0	0
19	17405364	.	C	T	38	26	64	0	2	66	0	0
19	17406014	.	A	T	19	24	43	0	0	43	0	0
19	17406081	.	A	C	22	11	33	0	2	35	0	0
19	17406082	.	G	A	22	11	33	0	2	35	0	0
19	17406271	.	T	G	14	14	28	0	1	29	0	0
19	17406656	.	C	G	29	0	29	0	20	49	0	0
19	17406770	.	T	G	27	20	47	0	0	47	0	0
19	17406918	.	T	C	22	11	33	0	0	33	0	0
19	17514860	.	T	A	13	8	21	0	2	23	0	0
19	17514897	.	T	C	14	0	14	0	11	25	0	0
19	17515048	.	T	C	6	5	11	0	0	11	0	0
19	17515347	.	G	C	5	4	9	0	0	9	0	0
19	17516039	.	G	A	4	4	8	0	1	9	0	0
19	17516070	.	A	G	4	11	15	0	0	15	0	0
19	17516103	.	G	C	8	2	10	0	7	17	0	0
19	17516130	.	T	C	10	15	25	0	1	26	0	0
19	17516162	.	A	T	12	14	26	0	0	26	0	0
19	17516195	.	T	C	14	0	14	0	16	30	0	0
19	17516211	.	G	T	20	11	31	0	0	31	0	0
19	17516330	.	A	G	16	11	27	0	0	27	0	0
19	17516489	.	T	A	24	7	31	0	0	31	0	0
19	17516585	.	C	A	7	5	12	0	0	12	0	0
19	17516920	.	A	G	19	7	26	0	0	26	0	0
19	17516922	.	A	G	19	7	26	0	0	26	0	0
19	17516962	.	T	C	13	8	21	0	0	21	0	0
19	17516997	.	A	G	12	10	22	0	0	22	0	0
19	17517542	.	A	C	14	3	17	0	2	19	0	0
19	17517768	.	T	G	13	3	16	0	1	17	0	0
19	17517816	.	T	C	13	10	23	0	0	23	0	0
19	17517821	.	A	G	13	11	24	0	1	25	0	0
19	17517912	.	T	G	15	7	22	0	0	22	0	0
19	17517928	.	C	G	13	4	17	0	0	17	0	0
19	17518071	.	C	T	7	10	17	0	0	17	0	0
19	17518179	.	A	T	10	12	22	0	3	25	0	0
19	17518231	.	T	C	11	12	23	0	0	23	0	0
19	17518276	.	G	C	9	11	20	0	0	20	0	0
19	17518330	.	T	C	7	12	19	0	4	23	0	0
19	17518351	.	C	A	0	18	18	0	8	26	0	0
19	17518366	.	A	T	8	16	24	0	1	25	0	0
19	17518489	.	T	A	11	11	22	0	1	23	0	0
19	17518531	.	T	G	10	11	21	1	3	25	0	0
19	17518550	.	A	C	9	12	21	1	0	22	0	0
19	17520859	.	A	G	17	6	23	0	1	24	0	0
19	17521027	.	A	T	11	13	24	0	0	24	0	0
19	17521060	.	C	A	7	12	19	0	0	19	0	0
19	17722355	.	T	C	15	8	23	0	0	23	0	0
19	17733001	.	G	A	7	16	23	0	0	23	0	0
19	17834671	.	T	A	1	2	3	0	1	4	0	0
19	17951870	.	A	G	4	4	8	0	0	8	0	0
19	18143837	.	C	T	8	4	12	0	0	12	0	0
19	18636530	.	A	T	10	11	21	0	0	21	0	0
19	18747159	.	A	T	1	2	3	0	0	3	0	0
19	18747182	.	T	A	2	2	4	0	0	4	0	0
19	18758292	.	T	A	2	2	4	0	0	4	0	0
19	18758323	.	G	A	2	2	4	0	0	4	0	0
19	18759915	.	C	T	2	2	4	0	0	4	0	0
19	18764894	.	C	A	1	5	6	0	0	6	0	0
19	18765109	.	C	T	3	4	7	0	0	7	0	0
19	18765165	.	C	T	3	4	7	0	0	7	0	0
19	18765784	.	G	T	3	3	6	0	0	6	0	0
19	18903694	.	C	T	11	8	19	0	0	19	0	0
19	18990243	.	G	A	10	6	16	0	1	17	0	0
19	19136325	.	C	T	11	4	15	0	0	15	0	0
19	19136352	.	C	T	8	4	12	0	0	12	0	0
19	19159264	.	C	A	3	2	5	0	0	5	0	0
19	19159615	.	T	A	1	4	5	0	0	5	0	0
19	19159654	.	C	T	3	3	6	0	0	6	0	0
19	19159687	.	G	A	7	3	10	0	0	10	0	0
19	19200483	.	A	G	18	6	24	0	0	24	0	0
19	19201301	.	T	G	10	13	23	0	3	26	0	0
19	19213871	.	C	T	8	7	15	0	1	16	0	0
19	19214295	.	T	G	12	10	22	0	0	22	0	0
19	19214316	.	T	A	9	11	20	0	1	21	0	0
19	19263510	.	G	T	4	3	7	0	0	7	0	0
19	19269258	.	G	A	3	2	5	0	0	5	0	0
19	19269522	.	C	T	4	5	9	0	1	10	0	0
19	19269659	.	T	C	4	6	10	0	1	11	0	0
19	19269931	.	G	A	2	2	4	0	0	4	0	0
19	19270468	.	C	T	6	3	9	0	0	9	0	0
19	19270606	.	A	C	3	2	5	0	0	5	0	0
19	19270623	.	T	C	4	3	7	0	0	7	0	0
19	19287981	.	G	A	22	24	46	0	1	47	0	0
19	19319164	.	T	C	20	23	43	0	1	44	0	0
19	19319229	.	C	T	30	18	48	0	2	51	1	0
19	19319315	.	G	A	18	18	36	0	3	39	0	0
19	19319337	.	A	G	22	14	36	0	1	37	0	0
19	19319556	.	T	C	12	1	13	0	19	32	0	0
19	19319626	.	A	C	25	8	33	0	2	35	0	0
19	19319692	.	C	T	3	21	24	0	24	48	0	0
19	19319724	.	A	G	20	24	44	0	2	46	0	0
19	19319814	.	T	A	18	21	39	0	0	39	0	0
19	19319852	.	T	A	23	12	35	0	3	38	0	0
19	19319864	.	T	A	12	22	34	0	0	34	0	0
19	19338885	.	T	A	13	12	25	0	0	25	0	0
19	19338923	.	T	A	8	8	16	0	1	17	0	0
19	19339071	.	C	G	9	11	20	0	1	21	0	0
19	19339232	.	C	A	0	13	13	0	20	34	1	0
19	19347856	.	T	C	4	6	10	0	1	11	0	0
19	19353790	.	G	A	5	3	8	0	1	9	0	0
19	19374940	.	G	A	3	4	7	0	0	7	0	0
19	19377963	.	G	A	6	3	9	0	0	9	0	0
19	19378150	.	A	C	2	4	6	0	0	6	0	0
19	19401507	.	T	C	1	2	3	0	0	3	0	0
19	19417985	.	C	T	14	13	27	0	0	28	1	0
19	19418066	.	G	A	12	8	20	0	1	21	0	0
19	19432598	.	C	T	18	11	29	0	0	29	0	0
19	19498760	.	T	C	4	4	8	0	0	8	0	0
19	19512139	.	T	G	2	2	4	0	0	4	0	0
19	19544615	.	C	T	6	5	11	0	0	11	0	0
19	19549921	.	T	C	5	9	14	0	2	16	0	0
19	19550141	.	T	G	11	8	19	0	1	20	0	0
19	19550184	.	G	T	13	7	20	0	2	22	0	0
19	19550381	.	T	G	15	10	25	0	0	25	0	0
19	19550601	.	C	A	14	13	27	0	0	27	0	0
19	19551819	.	G	A	11	8	19	0	0	19	0	0
19	19551828	.	A	G	9	10	19	0	0	19	0	0
19	19561923	.	C	T	1	11	12	0	6	18	0	0
19	19562669	.	A	G	12	9	21	0	0	21	0	0
19	19573913	.	C	T	2	13	15	0	20	35	0	0
19	19579200	.	C	T	15	5	20	0	0	20	0	0
19	19580971	.	C	T	0	12	12	0	13	25	0	0
19	19592010	.	C	T	1	8	9	0	14	23	0	0
19	19596944	.	G	A	6	5	11	0	1	12	0	0
19	19652494	.	G	A	0	2	2	0	2	4	0	0
19	19657032	.	G	A	0	2	2	0	2	4	0	0
19	19769016	.	C	A	6	4	10	0	0	10	0	0
19	19779232	.	C	A	5	4	9	0	0	9	0	0
19	19979049	.	C	T	7	6	13	0	0	13	0	0
19	20062114	.	C	A	2	4	6	0	5	11	0	0
19	20074687	.	T	G	6	9	15	0	0	15	0	0
19	20082608	.	A	T	6	6	12	0	0	12	0	0
19	20082671	.	A	G	1	7	8	0	0	8	0	0
19	20106393	.	T	G	1	2	3	0	0	3	0	0
19	20112056	.	G	C	29	24	53	0	1	54	0	0
19	20113526	.	G	A	29	25	54	0	1	55	0	0
19	20164058	.	G	A	0	11	11	0	6	17	0	0
19	20173714	.	G	A	0	3	3	0	6	9	0	0
19	20176665	.	G	T	5	6	11	0	0	11	0	0
19	20179257	.	G	A	16	10	26	0	1	27	0	0
19	20179291	.	G	A	16	11	27	0	1	28	0	0
19	20185030	.	C	T	21	13	34	0	1	35	0	0
19	20220026	.	G	A	2	2	4	0	0	4	0	0
19	20222648	.	G	C	1	2	3	0	0	3	0	0
19	20244346	.	T	A	3	3	6	0	0	6	0	0
19	20245197	.	T	C	1	3	4	0	0	4	0	0
19	20292344	.	C	T	1	2	3	0	0	3	0	0
19	20292924	.	C	A	1	2	3	0	0	3	0	0
19	20293310	.	C	T	1	2	3	0	0	3	0	0
19	20293373	.	G	T	6	2	8	0	0	8	0	0
19	20301572	.	C	T	1	3	4	0	1	5	0	0
19	20301573	.	C	T	0	4	4	0	1	5	0	0
19	20301691	.	A	C	2	0	2	0	6	8	0	0
19	20301843	.	T	A	2	7	9	0	0	9	0	0
19	20305514	.	A	G	3	3	6	0	0	6	0	0
19	20305589	.	T	C	1	3	4	0	0	4	0	0
19	20311348	.	C	T	6	3	9	0	0	9	0	0
19	20414805	.	C	G	1	8	9	0	9	18	0	0
19	20415143	.	T	A	9	14	23	0	3	26	0	0
19	20415146	.	T	C	14	0	14	0	11	25	0	0
19	20415242	.	G	A	13	10	23	0	1	24	0	0
19	20423199	.	C	T	2	3	5	0	0	5	0	0
19	20423507	.	A	G	7	13	20	0	0	20	0	0
19	20453881	.	A	G	1	5	6	0	2	8	0	0
19	20453933	.	C	T	1	4	5	0	5	10	0	0
19	20454087	.	G	A	7	5	12	0	0	12	0	0
19	20454123	.	A	G	5	4	9	0	0	9	0	0
19	20454276	.	G	A	4	2	6	0	0	6	0	0
19	20454324	.	G	A	5	4	9	0	2	11	0	0
19	20454393	.	G	A	6	4	10	0	0	10	0	0
19	20482239	.	T	G	3	4	7	0	1	8	0	0
19	20482254	.	T	A	3	4	7	0	0	7	0	0
19	20720782	.	T	C	23	25	48	0	2	50	0	0
19	20721025	.	C	T	28	25	53	4	0	57	0	0
19	20721135	.	G	A	33	27	60	1	1	62	0	0
19	20721215	.	C	T	22	27	49	0	6	55	0	0
19	20721761	.	A	C	8	25	33	0	5	38	0	0
19	20722093	.	C	A	11	16	27	0	1	28	0	0
19	20722144	.	C	T	14	10	24	0	0	24	0	0
19	20722330	.	C	G	3	3	6	0	0	6	0	0
19	20740062	.	A	G	4	3	7	0	1	8	0	0
19	20742041	.	T	C	2	4	6	0	0	6	0	0
19	20753194	.	G	T	6	5	11	0	1	12	0	0
19	20754096	.	C	A	1	2	3	0	0	3	0	0
19	20761382	.	C	T	0	2	2	0	2	4	0	0
19	20761710	.	T	G	6	6	12	0	0	12	0	0
19	20762228	.	T	C	8	9	17	0	0	17	0	0
19	20762239	.	G	A	8	6	14	0	0	14	0	0
19	20763798	.	G	A	2	7	9	0	0	9	0	0
19	20771290	.	G	A	3	8	11	0	0	11	0	0
19	20771317	.	G	A	5	7	12	0	0	12	0	0
19	20773965	.	C	A	3	7	10	0	0	10	0	0
19	20776705	.	C	T	4	3	7	0	0	7	0	0
19	20777112	.	G	A	2	6	8	0	0	8	0	0
19	20785859	.	T	A	6	3	9	0	0	9	0	0
19	20789481	.	G	A	1	8	9	0	6	15	0	0
19	20790572	.	T	C	9	16	25	0	0	25	0	0
19	20790809	.	C	T	13	18	31	0	2	33	0	0
19	20791295	.	T	C	7	13	20	0	0	20	0	0
19	20791525	.	T	G	4	4	8	0	0	8	0	0
19	20792049	.	T	A	1	2	3	0	0	3	0	0
19	20796566	.	C	T	20	11	31	0	0	31	0	0
19	20796605	.	C	T	13	14	27	0	0	27	0	0
19	20801926	.	A	G	8	5	13	0	0	13	0	0
19	20803718	.	G	A	0	4	4	0	4	8	0	0
19	20815229	.	T	A	9	10	19	0	1	20	0	0
19	20815256	.	G	A	10	9	19	0	0	19	0	0
19	21366697	.	C	T	1	2	3	0	1	4	0	0
19	21367862	.	C	T	13	16	29	0	1	30	0	0
19	21408969	.	C	T	18	6	24	0	1	25	0	0
19	21410404	.	G	A	11	8	19	0	3	22	0	0
19	21411022	.	C	T	21	10	31	0	2	33	0	0
19	21412041	.	C	T	21	19	40	0	1	41	0	0
19	21412755	.	T	C	8	12	20	0	1	21	0	0
19	21413152	.	G	A	1	7	8	0	14	22	0	0
19	21698413	.	G	A	5	5	10	0	2	12	0	0
19	21711187	.	G	C	4	0	4	0	12	16	0	0
19	21711267	.	G	C	3	6	9	0	1	10	0	0
19	21711681	.	A	G	9	6	15	0	2	17	0	0
19	21712031	.	A	T	4	9	13	0	0	13	0	0
19	21712032	.	C	G	5	9	14	0	0	14	0	0
19	21712179	.	C	T	5	6	11	0	1	12	0	0
19	21712285	.	T	A	3	8	11	0	0	11	0	0
19	21715094	.	A	T	4	4	8	0	0	8	0	0
19	21715367	.	C	T	8	8	16	0	0	16	0	0
19	21715385	.	T	C	8	6	14	0	1	15	0	0
19	21716054	.	C	G	4	5	9	0	0	9	0	0
19	21716122	.	A	G	3	5	8	0	0	8	0	0
19	21716150	.	C	G	1	5	6	0	0	6	0	0
19	21716178	.	C	T	2	7	9	0	0	9	0	0
19	21716775	.	C	A	2	3	5	0	1	6	0	0
19	21716791	.	C	T	3	3	6	0	1	7	0	0
19	21814362	.	A	C	35	46	81	0	3	84	0	0
19	21814372	.	T	A	40	48	88	0	5	93	0	0
19	21814408	.	T	C	45	52	97	0	5	102	0	0
19	21814457	.	C	T	29	75	104	0	9	113	0	0
19	21814515	.	C	T	60	44	104	0	2	106	0	0
19	21814644	.	T	G	37	42	79	0	6	85	0	0
19	21814852	.	T	C	28	54	82	0	2	84	0	0
19	21815151	.	C	T	22	46	68	0	36	104	0	0
19	21826141	.	G	A	1	3	4	0	0	4	0	0
19	21832562	.	A	G	14	6	20	0	1	21	0	0
19	21832623	.	G	A	2	5	7	0	1	8	0	0
19	21920449	.	C	T	1	4	5	0	0	5	0	0
19	21923214	.	A	G	1	2	3	0	0	3	0	0
19	22062875	.	A	G	4	2	6	0	0	6	0	0
19	22069032	.	G	A	2	1	3	0	1	4	0	0
19	22070497	.	G	A	7	5	12	0	0	12	0	0
19	22070526	.	C	A	6	5	11	0	0	11	0	0
19	22070606	.	T	C	3	4	7	0	0	7	0	0
19	22071792	.	T	C	5	3	8	0	1	9	0	0
19	22072839	.	T	G	3	2	5	0	0	5	0	0
19	22114202	.	A	C	5	3	8	0	0	8	0	0
19	22126889	.	C	T	5	3	8	0	0	8	0	0
19	22152330	.	G	A	5	3	8	0	0	8	0	0
19	22156048	.	G	A	0	8	8	0	2	10	0	0
19	22166818	.	T	A	6	3	9	0	0	9	0	0
19	22177104	.	G	A	1	9	10	0	6	16	0	0
19	22177122	.	G	A	1	9	10	0	6	16	0	0
19	22177164	.	T	C	6	8	14	0	0	14	0	0
19	22222208	.	A	T	1	2	3	0	0	3	0	0
19	22303980	.	C	A	2	2	4	0	0	4	0	0
19	22337801	.	A	G	2	3	5	0	0	5	0	0
19	22338041	.	G	A	6	2	8	0	0	8	0	0
19	22338132	.	T	G	5	2	7	0	0	7	0	0
19	22338167	.	C	T	3	4	7	0	0	7	0	0
19	22343150	.	G	A	1	3	4	0	0	4	0	0
19	22346497	.	T	A	2	4	6	0	1	7	0	0
19	22361962	.	A	C	12	9	21	0	1	22	0	0
19	22362260	.	A	C	2	4	6	0	0	6	0	0
19	22408746	.	T	C	5	5	10	0	0	10	0	0
19	22408905	.	G	A	11	5	16	0	1	17	0	0
19	22409431	.	G	T	13	6	19	0	2	21	0	0
19	22409994	.	G	C	6	8	14	0	0	14	0	0
19	22410447	.	C	T	13	5	18	0	0	18	0	0
19	22410578	.	C	G	0	5	5	0	16	21	0	0
19	22410665	.	G	A	9	13	22	0	0	22	0	0
19	22410707	.	C	T	1	9	10	0	12	22	0	0
19	22410923	.	T	A	6	7	13	0	0	13	0	0
19	22411136	.	G	A	6	9	15	0	0	15	0	0
19	22411187	.	A	G	7	12	19	0	0	19	0	0
19	22411664	.	A	G	8	3	11	0	0	11	0	0
19	22411991	.	T	G	9	3	12	0	0	12	0	0
19	22412240	.	G	A	6	2	8	0	1	9	0	0
19	22412822	.	C	T	8	7	15	0	0	15	0	0
19	22412827	.	G	A	7	5	12	0	0	12	0	0
19	22413110	.	C	T	7	6	13	0	1	14	0	0
19	22413296	.	C	T	12	3	15	0	0	15	0	0
19	22413377	.	A	G	6	13	19	0	0	19	0	0
19	22413508	.	T	C	6	4	10	0	2	12	0	0
19	22413713	.	A	G	10	9	19	0	0	19	0	0
19	22413733	.	A	G	10	9	19	0	1	20	0	0
19	22414063	.	C	T	0	3	3	0	3	6	0	0
19	22414304	.	A	G	6	6	12	0	0	12	0	0
19	22415220	.	C	T	1	5	6	0	0	6	0	0
19	22415548	.	G	A	6	5	11	0	0	11	0	0
19	22415905	.	T	A	2	4	6	0	0	6	0	0
19	22416218	.	T	A	6	3	9	0	0	9	0	0
19	22416257	.	G	A	7	5	12	0	1	13	0	0
19	22416317	.	G	A	3	3	6	0	0	6	0	0
19	22416620	.	T	C	8	0	8	0	7	15	0	0
19	22416659	.	T	C	6	7	13	0	0	13	0	0
19	22418174	.	T	A	4	6	10	0	0	10	0	0
19	22418401	.	T	C	4	4	8	0	0	8	0	0
19	22418578	.	G	A	12	3	15	0	0	15	0	0
19	22418602	.	T	C	3	8	11	0	0	11	0	0
19	22419682	.	G	A	9	4	13	0	1	14	0	0
19	22419685	.	C	T	3	8	11	0	2	13	0	0
19	22420183	.	G	A	3	3	6	0	0	6	0	0
19	22420346	.	T	G	3	3	6	0	0	6	0	0
19	22420414	.	A	T	5	7	12	0	1	13	0	0
19	22420633	.	A	T	4	8	12	0	0	12	0	0
19	22420723	.	C	T	5	3	8	0	0	8	0	0
19	22421131	.	C	T	4	3	7	0	0	7	0	0
19	22424261	.	G	A	3	3	6	0	0	6	0	0
19	22424279	.	C	T	3	4	7	0	0	7	0	0
19	22426945	.	T	C	3	4	7	0	0	7	0	0
19	22427035	.	G	A	3	3	6	0	0	6	0	0
19	22427116	.	T	C	4	2	6	0	0	6	0	0
19	22427138	.	C	G	5	4	9	0	0	9	0	0
19	22427461	.	C	T	4	7	11	0	0	11	0	0
19	22438264	.	A	G	3	4	7	0	0	7	0	0
19	22438336	.	G	A	2	5	7	0	0	7	0	0
19	22440308	.	A	C	2	0	2	0	4	6	0	0
19	22446541	.	G	C	2	0	2	0	4	6	0	0
19	22475365	.	A	G	5	2	7	0	0	7	0	0
19	22623505	.	G	A	3	2	5	0	1	6	0	0
19	22623724	.	G	T	1	3	4	0	0	4	0	0
19	22624236	.	A	T	4	2	6	0	0	6	0	0
19	22624237	.	C	T	4	1	5	0	1	6	0	0
19	22624554	.	G	A	6	4	10	0	0	10	0	0
19	22624557	.	G	A	6	4	10	0	1	11	0	0
19	22634093	.	G	A	7	6	13	1	0	14	0	0
19	22638187	.	T	C	6	19	25	0	0	25	0	0
19	22638250	.	C	A	6	12	18	0	0	18	0	0
19	22655190	.	A	G	14	9	23	0	0	23	0	0
19	22655690	.	T	C	9	5	14	0	0	14	0	0
19	22731075	.	C	T	4	5	9	0	0	9	0	0
19	22731086	.	A	G	3	4	7	0	0	7	0	0
19	22731315	.	C	A	2	2	4	0	0	4	0	0
19	22731316	.	C	A	2	2	4	0	0	4	0	0
19	22731573	.	T	G	2	0	2	0	2	4	0	0
19	22759180	.	C	T	1	2	3	0	0	3	0	0
19	22759523	.	C	A	0	7	7	0	7	14	0	0
19	22764168	.	T	G	7	7	14	0	1	15	0	0
19	22764259	.	A	G	7	6	13	0	0	13	0	0
19	22764274	.	G	A	6	6	12	0	0	12	0	0
19	22788372	.	G	C	7	7	14	0	0	14	0	0
19	22788813	.	C	T	1	7	8	0	4	12	0	0
19	22807233	.	A	T	7	4	11	0	1	12	0	0
19	22807317	.	G	A	5	6	11	0	0	11	0	0
19	22826116	.	C	A	5	3	8	0	1	9	0	0
19	22842677	.	T	A	8	3	11	0	0	11	0	0
19	23137063	.	G	A	6	3	9	0	0	9	0	0
19	23877478	.	A	T	2	2	4	0	0	4	0	0
19	23877497	.	C	T	3	3	6	0	0	6	0	0
19	23877558	.	G	A	3	3	6	0	0	6	0	0
19	23880428	.	C	T	1	3	4	0	2	6	0	0
19	23880661	.	C	T	0	3	3	0	6	9	0	0
19	23880677	.	C	A	1	3	4	0	4	8	0	0
19	23884862	.	C	T	4	4	8	0	0	8	0	0
19	23920598	.	G	T	1	13	14	0	18	32	0	0
19	23920826	.	T	G	9	9	18	0	0	18	0	0
19	23921127	.	T	C	14	8	22	0	0	22	0	0
19	23921147	.	C	G	11	0	11	0	7	18	0	0
19	23921282	.	T	A	10	11	21	0	2	23	0	0
19	23921381	.	G	A	11	11	22	0	1	23	0	0
19	23921617	.	A	G	18	13	31	0	0	31	0	0
19	23921662	.	A	G	13	0	13	0	19	32	0	0
19	23921669	.	G	A	2	14	16	0	18	34	0	0
19	23921858	.	A	G	1	5	6	0	1	7	0	0
19	23922103	.	G	T	5	5	10	0	1	11	0	0
19	23922237	.	T	G	15	0	15	0	11	26	0	0
19	23922260	.	A	T	15	11	26	0	0	26	0	0
19	23952920	.	T	G	7	0	7	0	12	19	0	0
19	23952928	.	A	C	3	0	3	0	14	17	0	0
19	23982575	.	T	G	23	17	40	0	2	42	0	0
19	24007465	.	G	A	23	26	49	0	1	50	0	0
19	24007471	.	C	T	28	21	49	0	0	49	0	0
19	24031592	.	C	T	24	23	47	0	7	54	0	0
19	24031761	.	T	A	29	29	58	0	1	59	0	0
19	24032122	.	T	A	22	28	50	0	0	50	0	0
19	24032386	.	G	A	1	11	12	0	13	25	0	0
19	24032407	.	C	A	8	12	20	0	3	23	0	0
19	24032502	.	T	G	13	9	22	1	0	23	0	0
19	24032528	.	C	T	11	12	23	1	0	24	0	0
19	24032766	.	A	T	20	30	50	0	1	51	0	0
19	24032867	.	T	A	20	31	51	1	2	54	0	0
19	24032907	.	T	C	14	39	53	2	1	56	0	0
19	24033226	.	A	C	24	24	48	0	9	57	0	0
19	24033288	.	A	G	29	19	48	0	2	50	0	0
19	24033494	.	G	A	6	33	39	0	30	69	0	0
19	24033686	.	C	T	36	25	61	0	2	63	0	0
19	24033804	.	C	T	41	18	59	0	2	61	0	0
19	24033856	.	A	C	25	27	52	0	4	56	0	0
19	24034115	.	C	T	31	29	60	0	1	61	0	0
19	24034148	.	T	C	30	28	58	0	3	61	0	0
19	24034169	.	T	C	30	22	52	0	6	58	0	0
19	24034276	.	T	G	28	31	59	0	5	64	0	0
19	24034410	.	G	A	26	31	57	0	1	58	0	0
19	24034437	.	G	A	4	40	44	0	21	65	0	0
19	24034525	.	C	T	27	30	57	0	1	58	0	0
19	24034573	.	T	A	27	24	51	0	1	52	0	0
19	24065240	.	G	T	0	3	3	0	5	8	0	0
19	24065367	.	T	G	3	9	12	0	1	13	0	0
19	24068411	.	G	T	7	4	11	0	0	11	0	0
19	24070243	.	G	A	1	6	7	0	0	7	0	0
19	24072602	.	C	T	6	7	13	0	1	14	0	0
19	24072644	.	T	G	8	0	8	0	10	18	0	0
19	24074533	.	T	C	12	11	23	0	1	24	0	0
19	24074564	.	G	A	12	11	23	0	0	23	0	0
19	24074617	.	G	A	0	6	6	0	7	13	0	0
19	24074632	.	C	A	4	8	12	0	0	12	0	0
19	24074679	.	C	T	6	7	13	0	0	13	0	0
19	24074716	.	A	G	7	0	7	0	6	13	0	0
19	24074773	.	C	A	7	7	14	0	0	14	0	0
19	24074794	.	A	G	6	5	11	0	2	13	0	0
19	24074812	.	G	A	8	4	12	0	1	13	0	0
19	24123917	.	G	C	3	2	5	0	1	6	0	0
19	24123919	.	A	T	4	2	6	0	0	6	0	0
19	24124577	.	C	A	10	4	14	0	0	14	0	0
19	24128252	.	G	A	1	3	4	0	0	4	0	0
19	24128693	.	T	C	3	3	6	0	1	7	0	0
19	24128743	.	A	T	5	2	7	0	0	7	0	0
19	24128905	.	G	A	3	3	6	0	0	6	0	0
19	24129199	.	A	T	1	2	3	0	0	3	0	0
19	24129244	.	C	T	2	4	6	0	0	6	0	0
19	24129398	.	G	A	3	3	6	0	0	6	0	0
19	24129464	.	A	T	1	2	3	0	0	3	0	0
19	24129494	.	A	T	1	2	3	0	0	3	0	0
19	24130139	.	G	A	4	5	9	0	1	10	0	0
19	24130179	.	G	T	6	5	11	0	0	11	0	0
19	24130268	.	C	T	4	10	14	0	0	14	0	0
19	24130541	.	T	G	5	5	10	0	1	11	0	0
19	24130685	.	C	G	3	6	9	0	0	9	0	0
19	24133938	.	G	T	6	3	9	0	0	9	0	0
19	24264105	.	G	A	3	5	8	0	0	8	0	0
19	24264106	.	C	G	0	5	5	0	3	8	0	0
19	24325727	.	A	C	1	3	4	0	0	4	0	0
19	24354104	.	T	A	3	3	6	0	0	6	0	0
19	24385036	.	T	C	5	8	13	0	0	13	0	0
19	24385063	.	A	C	8	7	15	0	0	15	0	0
19	24388639	.	T	C	4	2	6	0	0	6	0	0
19	24388866	.	C	T	3	4	7	0	0	7	0	0
19	24388927	.	C	A	3	2	5	0	0	5	0	0
19	24388987	.	A	G	5	0	5	0	4	9	0	0
19	24389170	.	G	A	0	3	3	0	5	8	0	0
19	24389280	.	G	A	1	3	4	0	0	4	0	0
19	24389282	.	A	G	1	3	4	0	0	4	0	0
19	24389357	.	G	A	2	2	4	0	0	4	0	0
19	24391289	.	G	A	1	2	3	0	0	3	0	0
19	24391373	.	T	C	3	2	5	0	0	5	0	0
19	24394573	.	A	G	1	5	6	0	0	6	0	0
19	24397019	.	G	A	8	3	11	0	2	13	0	0
19	24397031	.	G	A	3	8	11	0	0	11	0	0
19	24399414	.	C	T	7	7	14	0	0	14	0	0
19	24448940	.	T	C	4	3	7	0	1	8	0	0
19	24448985	.	T	C	4	1	5	0	4	9	0	0
19	24484690	.	T	A	3	4	7	0	0	7	0	0
19	24488480	.	C	T	2	5	7	0	0	7	0	0
19	24488494	.	T	A	3	6	9	0	0	9	0	0
19	24488728	.	A	T	6	3	9	0	0	9	0	0
19	24489371	.	G	T	4	2	6	0	0	6	0	0
19	24491086	.	A	T	6	8	14	0	0	14	0	0
19	24491140	.	G	T	4	6	10	0	1	11	0	0
19	24491224	.	C	T	6	4	10	0	0	10	0	0
19	24491230	.	A	T	5	4	9	0	1	10	0	0
19	24491268	.	C	T	3	6	9	0	2	11	0	0
19	24491588	.	T	A	3	3	6	0	0	6	0	0
19	24491982	.	G	C	6	7	13	0	0	13	0	0
19	24596426	.	C	T	9	3	12	0	1	13	0	0
19	24596635	.	G	A	7	9	16	0	0	16	0	0
19	24596665	.	C	T	8	9	17	0	0	17	0	0
19	24596725	.	A	G	10	10	20	0	1	21	0	0
19	24596788	.	A	G	7	12	19	0	1	20	0	0
19	24596839	.	C	T	9	7	16	0	0	16	0	0
19	24596989	.	G	C	6	7	13	0	0	13	0	0
19	24597055	.	C	A	10	3	13	0	0	13	0	0
19	24597082	.	T	G	11	0	11	0	4	15	0	0
19	24597091	.	C	T	11	4	15	0	0	15	0	0
19	24597217	.	T	A	15	9	24	0	0	24	0	0
19	24597268	.	A	G	13	5	18	0	0	18	0	0
19	24757063	.	T	C	2	3	5	0	0	5	0	0
19	24882961	.	G	A	10	15	25	0	2	27	0	0
19	24883750	.	G	A	11	8	19	0	3	22	0	0
19	24888024	.	A	G	8	20	28	0	1	29	0	0
19	24888090	.	A	T	12	16	28	0	0	28	0	0
19	24888187	.	C	T	16	10	26	0	1	27	0	0
19	24888195	.	A	T	8	15	23	0	2	25	0	0
19	24888398	.	G	A	3	17	20	0	23	43	0	0
19	24888748	.	T	C	14	20	34	0	1	35	0	0
19	24906427	.	G	A	0	3	3	0	7	10	0	0
19	24909651	.	T	C	4	4	8	0	0	8	0	0
19	24914462	.	C	T	9	6	15	0	0	15	0	0
19	24914632	.	T	C	4	2	6	0	0	6	0	0
19	24914687	.	G	T	1	4	5	0	0	5	0	0
19	24914799	.	T	G	3	4	7	0	0	7	0	0
19	24915403	.	G	A	0	2	2	0	6	8	0	0
19	24915742	.	T	A	2	6	8	0	0	8	0	0
19	24915782	.	G	A	0	7	7	0	3	10	0	0
19	24915796	.	A	G	5	7	12	0	0	12	0	0
19	24916007	.	T	G	6	7	13	0	1	14	0	0
19	24916427	.	C	T	4	5	9	0	0	9	0	0
19	24916445	.	A	T	4	3	7	0	0	7	0	0
19	24916766	.	T	G	3	2	5	0	0	5	0	0
19	25089839	.	A	G	7	16	23	0	1	24	0	0
19	25089979	.	A	G	10	7	17	0	1	18	0	0
19	25090032	.	T	G	14	8	22	0	0	22	0	0
19	25090079	.	A	G	11	14	25	0	0	25	0	0
19	25090231	.	T	C	16	18	34	0	0	34	0	0
19	25113207	.	C	A	11	11	22	0	1	23	0	0
19	25113524	.	T	C	26	17	43	0	2	45	0	0
19	25156572	.	C	T	9	3	12	0	0	12	0	0
19	25156639	.	T	C	2	0	2	0	6	8	0	0
19	25156669	.	T	C	3	8	11	0	0	11	0	0
19	25156717	.	A	C	5	11	16	0	0	16	0	0
19	25156774	.	T	A	12	15	27	0	2	29	0	0
19	25156959	.	A	T	12	21	33	0	1	34	0	0
19	25163587	.	G	A	20	21	41	0	4	45	0	0
19	25163633	.	G	T	18	13	31	0	3	34	0	0
19	25169531	.	A	C	13	0	13	0	11	24	0	0
19	25270949	.	A	G	22	14	36	0	0	36	0	0
19	25352327	.	T	C	12	6	18	0	0	18	0	0
19	25352503	.	G	A	9	11	20	0	0	20	0	0
19	25352702	.	A	C	12	7	19	0	0	19	0	0
19	25352789	.	T	C	7	12	19	0	2	21	0	0
19	25352901	.	A	T	14	7	21	0	0	21	0	0
19	25353088	.	A	G	12	22	34	0	0	34	0	0
19	25367246	.	G	A	20	15	35	0	2	37	0	0
19	25367270	.	T	C	21	1	22	0	15	37	0	0
19	25367291	.	C	T	2	12	14	0	20	34	0	0
19	25367414	.	A	C	14	0	14	0	8	22	0	0
19	25370392	.	G	A	15	22	37	0	0	37	0	0
19	25370730	.	C	T	24	11	35	0	4	39	0	0
19	25426715	.	T	C	4	0	4	0	3	7	0	0
19	25426850	.	G	T	5	5	10	0	0	10	0	0
19	25427053	.	C	T	0	5	5	0	2	7	0	0
19	25427153	.	C	T	1	2	3	0	0	3	0	0
19	25427194	.	G	C	3	3	6	0	0	6	0	0
19	25427210	.	C	A	0	2	2	0	4	6	0	0
19	25435501	.	T	G	4	4	8	0	0	8	0	0
19	25448120	.	G	A	4	3	7	0	1	8	0	0
19	25463927	.	C	T	5	3	8	0	0	8	0	0
19	25464201	.	G	A	1	2	3	0	1	4	0	0
19	25526483	.	G	A	3	9	12	0	4	17	1	0
19	25526529	.	T	C	4	13	17	0	0	17	0	0
19	25548114	.	C	G	4	13	17	0	0	17	0	0
19	25652962	.	C	T	16	14	30	2	0	32	0	0
19	25653042	.	C	T	17	17	34	0	6	40	0	0
19	25653147	.	C	T	9	10	19	0	5	24	0	0
19	25657306	.	C	A	2	7	9	0	0	9	0	0
19	25673419	.	T	C	1	2	3	0	1	4	0	0
19	25680248	.	A	T	5	3	8	0	0	8	0	0
19	25682029	.	G	A	7	7	14	0	0	14	0	0
19	25682044	.	A	G	5	8	13	0	0	13	0	0
19	25693539	.	T	C	2	4	6	0	1	7	0	0
19	25699618	.	T	A	2	2	4	0	1	5	0	0
19	25701183	.	G	A	4	3	7	0	0	7	0	0
19	25701237	.	A	G	6	3	9	0	0	9	0	0
19	25701309	.	A	G	5	2	7	0	0	7	0	0
19	25701373	.	G	C	2	3	5	0	0	5	0	0
19	25701432	.	C	T	0	6	6	0	0	6	0	0
19	25701450	.	G	A	2	5	7	0	0	7	0	0
19	25701474	.	T	A	0	4	4	0	2	6	0	0
19	25701495	.	A	T	1	2	3	0	0	3	0	0
19	25701817	.	G	A	3	3	6	0	0	6	0	0
19	26142915	.	C	T	1	2	3	0	0	3	0	0
19	26156423	.	C	T	1	5	6	0	0	6	0	0
19	26164906	.	G	A	22	15	37	0	1	38	0	0
19	26235083	.	G	A	10	13	23	0	0	23	0	0
19	26235089	.	C	T	9	13	22	0	2	24	0	0
19	26369614	.	C	T	8	4	12	0	1	13	0	0
19	26370720	.	A	T	5	12	17	0	0	17	0	0
19	26370726	.	C	T	13	4	17	0	0	17	0	0
19	26375471	.	C	T	13	4	17	0	0	17	0	0
19	26375643	.	T	G	4	5	9	0	1	10	0	0
19	26375699	.	G	T	12	9	21	0	1	22	0	0
19	26377775	.	A	T	4	8	12	0	0	12	0	0
19	26377946	.	T	A	5	5	10	0	0	10	0	0
19	26378250	.	T	C	4	7	11	0	1	12	0	0
19	26378265	.	G	A	9	2	11	0	1	12	0	0
19	26378285	.	G	A	3	7	10	0	1	11	0	0
19	26378447	.	T	A	3	4	7	0	0	7	0	0
19	26378451	.	G	A	5	3	8	0	0	8	0	0
19	26425147	.	A	C	4	5	9	0	0	9	0	0
19	26425369	.	G	A	1	2	3	0	1	4	0	0
19	26521070	.	G	A	5	4	9	0	0	9	0	0
19	26614612	.	C	T	6	2	8	0	0	8	0	0
19	26614633	.	C	T	1	2	3	0	0	3	0	0
19	26622680	.	C	T	6	3	9	0	0	9	0	0
19	26622722	.	C	T	6	3	9	0	0	9	0	0
19	26623634	.	C	T	4	4	8	0	0	8	0	0
19	26627274	.	G	A	1	3	4	0	3	7	0	0
19	26627680	.	C	T	2	2	4	0	0	4	0	0
19	26627729	.	T	A	1	2	3	0	0	3	0	0
19	26627730	.	C	T	1	2	3	0	0	3	0	0
19	26628037	.	A	G	2	4	6	0	1	7	0	0
19	26628173	.	T	A	7	9	16	0	0	16	0	0
19	26628225	.	G	A	7	7	14	0	0	14	0	0
19	26628244	.	C	T	4	6	10	0	0	10	0	0
19	26628279	.	C	T	2	5	7	0	0	7	0	0
19	26628287	.	G	A	2	4	6	0	0	6	0	0
19	26628333	.	C	T	1	2	3	0	1	4	0	0
19	26628907	.	G	C	3	5	8	0	0	8	0	0
19	26628980	.	C	A	8	4	12	0	0	12	0	0
19	26640232	.	C	T	2	10	12	0	0	12	0	0
19	26645980	.	G	A	7	4	11	0	1	12	0	0
19	26646365	.	C	T	3	3	6	0	0	6	0	0
19	26653931	.	G	A	1	6	7	0	1	8	0	0
19	26657193	.	T	C	5	6	11	0	1	12	0	0
19	26669225	.	G	A	9	3	12	0	1	13	0	0
19	26669228	.	T	C	8	5	13	0	0	13	0	0
19	26670618	.	A	G	7	0	7	0	10	17	0	0
19	26695112	.	A	T	2	2	4	0	0	4	0	0
19	26697499	.	A	G	2	2	4	0	0	4	0	0
19	26697519	.	G	C	2	3	5	0	0	5	0	0
19	26702322	.	C	G	1	0	1	0	2	3	0	0
19	26706935	.	G	A	3	3	6	0	0	6	0	0
19	26706947	.	C	T	3	3	6	0	0	6	0	0
19	26707167	.	A	G	1	2	3	0	0	3	0	0
19	26707185	.	C	T	1	3	4	0	0	4	0	0
19	26710828	.	C	T	2	2	4	0	0	4	0	0
19	26710899	.	T	A	4	3	7	1	0	8	0	0
19	26710961	.	A	T	1	2	3	0	0	3	0	0
19	26711151	.	A	T	4	2	6	0	0	6	0	0
19	26711397	.	G	A	4	3	7	0	0	7	0	0
19	26711447	.	G	A	4	4	8	0	1	9	0	0
19	26711534	.	A	G	2	2	4	0	0	4	0	0
19	26715006	.	A	G	3	0	3	0	5	8	0	0
19	26718204	.	C	T	4	9	13	0	0	13	0	0
19	26718261	.	G	C	2	8	10	0	0	10	0	0
19	26721300	.	C	T	4	8	12	0	1	13	0	0
19	26723474	.	G	C	11	3	14	0	0	14	0	0
19	26723498	.	A	G	12	7	19	0	0	19	0	0
19	26723690	.	G	A	7	13	20	0	1	21	0	0
19	26723705	.	A	T	9	11	20	0	1	21	0	0
19	26727535	.	G	A	0	13	13	0	6	19	0	0
19	26728070	.	G	A	16	6	22	0	0	22	0	0
19	26728079	.	A	C	8	14	22	0	1	23	0	0
19	26729597	.	A	T	5	9	14	0	0	14	0	0
19	26729651	.	T	C	4	7	11	0	0	11	0	0
19	26729811	.	A	C	3	7	10	0	0	10	0	0
19	26729867	.	C	T	5	5	10	0	0	10	0	0
19	26729887	.	T	A	2	5	7	0	0	7	0	0
19	26730073	.	A	T	3	2	5	0	0	5	0	0
19	26730077	.	G	T	3	2	5	0	0	5	0	0
19	26730108	.	A	G	6	0	6	0	3	9	0	0
19	26730545	.	C	T	14	14	28	0	0	28	0	0
19	26730642	.	T	C	24	0	24	0	19	43	0	0
19	26731183	.	C	T	1	18	19	0	8	27	0	0
19	26731240	.	C	A	3	0	3	0	1	4	0	0
19	26731249	.	C	T	1	3	4	0	0	4	0	0
19	26741296	.	C	G	17	26	43	0	0	43	0	0
19	26741378	.	T	C	20	0	20	0	27	47	0	0
19	26741427	.	G	A	21	19	40	0	4	44	0	0
19	26741831	.	C	T	1	17	18	0	24	42	0	0
19	26741918	.	G	T	18	22	40	0	2	42	0	0
19	26742224	.	T	C	20	11	31	0	1	32	0	0
19	26742321	.	G	A	22	14	36	0	0	36	0	0
19	26742379	.	A	C	14	0	14	0	17	31	0	0
19	26742598	.	A	T	16	22	38	0	1	39	0	0
19	26742716	.	T	A	25	24	49	0	0	50	1	0
19	26742732	.	A	G	30	20	50	0	1	51	0	0
19	26742751	.	C	T	19	31	50	0	2	52	0	0
19	26743295	.	A	T	17	29	46	0	1	47	0	0
19	26743446	.	T	A	26	22	48	0	1	49	0	0
19	26743781	.	G	A	23	19	42	0	2	44	0	0
19	26743808	.	C	T	19	18	37	0	4	41	0	0
19	26743900	.	T	A	18	17	35	0	0	35	0	0
19	26743943	.	C	T	18	16	34	0	1	35	0	0
19	26743984	.	A	G	19	15	34	0	0	34	0	0
19	26744235	.	G	T	21	20	41	0	2	43	0	0
19	26744840	.	C	T	30	18	48	0	0	48	0	0
19	26745392	.	T	A	16	21	37	0	2	39	0	0
19	26746246	.	C	T	11	18	29	0	0	29	0	0
19	26747192	.	C	T	17	20	37	0	1	38	0	0
19	26747682	.	G	A	25	14	39	0	0	39	0	0
19	26747979	.	C	T	20	15	35	0	0	35	0	0
19	26748003	.	T	G	11	21	32	0	2	34	0	0
19	26748499	.	G	C	18	0	18	0	13	31	0	0
19	26750310	.	T	C	13	0	13	0	18	31	0	0
19	26756636	.	G	A	19	17	36	0	0	36	0	0
19	26769771	.	A	G	2	7	9	0	1	10	0	0
19	26810460	.	C	T	4	5	9	0	1	10	0	0
19	26813901	.	G	A	4	6	10	0	1	11	0	0
19	26817918	.	T	A	5	2	7	0	0	7	0	0
19	26821825	.	C	T	0	6	6	0	3	9	0	0
19	26821945	.	G	A	4	3	7	0	0	7	0	0
19	26822657	.	G	A	5	6	11	0	0	11	0	0
19	26860799	.	T	C	25	1	26	0	26	52	0	0
19	26868876	.	C	T	21	18	39	0	1	40	0	0
19	26868899	.	G	A	23	15	38	0	0	38	0	0
19	26868972	.	G	T	17	3	20	2	2	24	0	0
19	26872886	.	T	C	5	0	5	0	9	14	0	0
19	26872898	.	C	T	4	7	11	0	1	12	0	0
19	26910991	.	T	C	5	3	8	0	0	8	0	0
19	26911138	.	G	A	5	3	8	0	0	8	0	0
19	26911189	.	T	C	2	5	7	0	1	8	0	0
19	26915036	.	A	G	2	3	5	0	0	5	0	0
19	26917608	.	G	A	1	3	4	0	0	4	0	0
19	26917783	.	C	T	2	2	4	0	0	4	0	0
19	26922171	.	G	A	1	3	4	0	1	5	0	0
19	26925280	.	G	A	6	19	25	0	0	25	0	0
19	26925296	.	T	C	5	15	20	0	0	20	0	0
19	26925526	.	G	A	6	11	17	0	1	18	0	0
19	26928320	.	C	T	9	11	20	0	1	21	0	0
19	26928356	.	A	G	15	14	29	0	1	30	0	0
19	26928399	.	A	C	15	15	30	0	2	32	0	0
19	26931520	.	G	A	4	9	13	0	0	13	0	0
19	26931680	.	T	A	6	6	12	0	0	12	0	0
19	26931730	.	T	A	4	7	11	0	2	13	0	0
19	26931732	.	A	T	8	4	12	0	1	13	0	0
19	26931765	.	G	A	1	7	8	0	4	12	0	0
19	26938344	.	A	T	4	2	6	0	0	6	0	0
19	26938363	.	T	A	5	2	7	0	0	7	0	0
19	26938379	.	A	G	6	2	8	0	0	8	0	0
19	26958040	.	G	A	11	4	15	0	0	15	0	0
19	26958349	.	G	A	7	7	14	0	1	15	0	0
19	26958604	.	G	A	7	4	11	0	2	13	0	0
19	26958687	.	T	G	8	6	14	0	0	14	0	0
19	26964306	.	T	A	2	2	4	0	0	4	0	0
19	26964308	.	G	A	2	1	3	0	1	4	0	0
19	26967634	.	G	T	17	6	23	0	0	23	0	0
19	26967737	.	A	C	8	6	14	0	2	16	0	0
19	26967780	.	C	T	5	7	12	0	0	12	0	0
19	26967783	.	T	G	5	2	7	0	2	9	0	0
19	26994683	.	C	A	12	4	16	0	1	17	0	0
19	27043887	.	A	G	21	25	46	0	2	48	0	0
19	27073262	.	A	G	13	11	24	0	0	24	0	0
19	27105078	.	G	A	24	13	37	0	1	38	0	0
19	27195604	.	A	G	4	8	12	0	0	12	0	0
19	27260458	.	A	C	14	0	14	0	12	26	0	0
19	27260629	.	C	T	1	10	11	0	6	17	0	0
19	27260819	.	C	A	5	2	7	0	0	7	0	0
19	27260906	.	T	C	3	0	3	0	9	12	0	0
19	27283342	.	C	G	9	4	13	0	0	13	0	0
19	27283472	.	A	T	9	10	19	0	1	20	0	0
19	27283557	.	C	A	13	6	19	0	1	20	0	0
19	27283612	.	A	G	14	6	20	0	1	21	0	0
19	27283783	.	G	C	6	10	16	0	0	16	0	0
19	27283940	.	C	T	13	9	22	0	1	23	0	0
19	27284178	.	G	A	14	12	26	0	1	27	0	0
19	27284195	.	T	G	12	9	21	0	0	21	0	0
19	27284387	.	A	G	9	9	18	0	0	18	0	0
19	27284741	.	C	T	9	9	18	0	1	19	0	0
19	27284744	.	C	T	8	11	19	0	0	19	0	0
19	27284817	.	A	C	9	7	16	0	3	19	0	0
19	27284860	.	C	T	8	4	12	0	1	13	0	0
19	27284957	.	G	A	14	9	23	0	0	23	0	0
19	27285085	.	T	C	14	0	14	0	10	24	0	0
19	27285935	.	T	C	1	2	3	0	0	3	0	0
19	27285959	.	A	T	0	2	2	0	0	2	0	0
19	27286007	.	A	T	2	2	4	0	0	4	0	0
19	27286289	.	G	T	2	1	3	0	0	3	0	0
19	27286298	.	T	C	2	3	5	0	0	5	0	0
19	27286390	.	G	T	10	3	13	0	0	13	0	0
19	27286406	.	C	T	12	4	16	0	0	16	0	0
19	27286444	.	C	T	11	6	17	0	1	18	0	0
19	27286590	.	G	C	2	0	2	0	5	7	0	0
19	27286912	.	A	T	1	4	5	0	0	5	0	0
19	27286940	.	C	T	2	6	8	0	0	8	0	0
19	27286966	.	A	T	2	7	9	0	1	10	0	0
19	27287204	.	T	C	12	12	24	0	2	26	0	0
19	27287294	.	T	G	11	10	21	0	1	22	0	0
19	27287492	.	T	A	9	8	17	0	0	17	0	0
19	27307583	.	G	A	8	13	21	0	0	21	0	0
19	27314273	.	T	C	7	10	17	0	1	18	0	0
19	27314393	.	C	G	7	13	20	0	1	21	0	0
19	27314624	.	C	T	7	5	12	0	0	12	0	0
19	27321573	.	C	G	7	11	18	0	1	19	0	0
19	27321615	.	A	G	8	7	15	0	2	17	0	0
19	27321843	.	G	A	2	7	9	0	0	9	0	0
19	27331814	.	T	C	5	3	8	0	1	9	0	0
19	27334273	.	A	T	15	10	25	0	1	26	0	0
19	27339878	.	C	T	2	3	5	0	0	5	0	0
19	27345887	.	G	A	5	5	10	0	0	10	0	0
19	27351218	.	G	A	11	5	16	0	0	16	0	0
19	27354331	.	C	A	7	6	13	0	0	13	0	0
19	27357250	.	C	A	6	7	13	0	0	14	1	0
19	27357485	.	A	T	10	8	18	0	1	19	0	0
19	27357567	.	T	A	4	4	8	0	1	9	0	0
19	27368525	.	C	T	1	4	5	0	0	5	0	0
19	27368719	.	T	C	7	6	13	0	1	14	0	0
19	27368800	.	T	C	2	0	2	0	3	5	0	0
19	27368806	.	T	A	2	4	6	0	0	6	0	0
19	27368870	.	A	G	2	4	6	0	0	6	0	0
19	27369504	.	G	A	2	3	5	0	0	5	0	0
19	27369553	.	T	C	2	4	6	1	0	7	0	0
19	27369853	.	T	A	4	3	7	0	0	8	1	0
19	27369890	.	T	C	4	0	4	0	4	8	0	0
19	27369971	.	A	C	7	2	9	0	0	9	0	0
19	27370197	.	C	A	4	6	10	0	1	11	0	0
19	27370232	.	C	A	7	5	12	0	0	12	0	0
19	27370273	.	C	T	1	6	7	0	3	10	0	0
19	27370380	.	C	T	1	5	6	0	2	8	0	0
19	27370606	.	C	A	1	4	5	0	0	5	0	0
19	27370682	.	G	A	2	4	6	0	0	6	0	0
19	27370774	.	A	T	2	8	10	0	0	10	0	0
19	27370805	.	C	T	0	5	5	0	2	7	0	0
19	27370827	.	C	T	1	3	4	0	1	5	0	0
19	27371290	.	A	T	3	5	8	0	0	8	0	0
19	27372191	.	C	T	0	3	3	0	3	6	0	0
19	27381336	.	T	C	1	7	8	0	0	8	0	0
19	27381585	.	G	A	1	4	5	0	0	5	0	0
19	27395471	.	A	T	5	4	9	0	0	9	0	0
19	27401412	.	G	A	6	4	10	0	0	10	0	0
19	27401515	.	C	T	3	4	7	0	1	8	0	0
19	27401680	.	G	A	6	3	9	0	0	9	0	0
19	27415248	.	G	A	2	6	8	0	0	8	0	0
19	27428120	.	T	A	6	5	11	0	0	11	0	0
19	27430455	.	G	A	2	4	6	0	0	6	0	0
19	27430904	.	T	A	6	3	9	0	0	9	0	0
19	27437074	.	C	T	0	5	5	0	2	7	0	0
19	27440899	.	A	T	2	5	7	0	0	7	0	0
19	27441059	.	G	A	2	4	6	0	0	6	0	0
19	27441130	.	T	C	2	3	5	0	0	5	0	0
19	27444720	.	T	C	3	3	6	0	0	6	0	0
19	27445369	.	A	G	2	4	6	0	0	6	0	0
19	27457166	.	T	C	4	0	4	0	10	14	0	0
19	27457213	.	T	C	9	11	20	0	0	20	0	0
19	27457505	.	G	T	13	8	21	0	0	21	0	0
19	27457516	.	T	G	8	13	21	0	0	21	0	0
19	27457607	.	C	T	9	4	13	0	0	13	0	0
19	27457621	.	T	A	4	10	14	0	0	14	0	0
19	27457749	.	C	T	6	11	17	0	1	18	0	0
19	27457892	.	T	C	8	12	20	0	0	20	0	0
19	27457989	.	T	A	5	13	18	1	0	19	0	0
19	27461139	.	C	T	1	12	13	0	8	21	0	0
19	27461183	.	C	T	10	14	24	0	0	24	0	0
19	27461560	.	C	T	2	16	18	0	10	28	0	0
19	27462092	.	A	T	5	3	8	0	0	8	0	0
19	27462620	.	C	A	5	4	9	0	0	9	0	0
19	27464010	.	A	G	1	2	3	0	0	3	0	0
19	27464012	.	T	C	1	2	3	0	0	3	0	0
19	27464344	.	A	T	7	14	21	0	1	22	0	0
19	27465119	.	G	A	6	4	10	0	0	10	0	0
19	27466189	.	C	G	17	11	28	0	3	31	0	0
19	27468598	.	G	A	18	16	34	0	1	35	0	0
19	27468606	.	C	T	16	15	31	0	2	33	0	0
19	27468983	.	A	C	12	10	22	3	0	25	0	0
19	27469060	.	C	G	3	8	11	0	16	27	0	0
19	27469137	.	A	T	15	1	16	0	0	16	0	0
19	27469178	.	A	C	15	6	21	0	0	21	0	0
19	27469184	.	G	A	15	8	23	0	0	23	0	0
19	27469224	.	A	C	7	3	10	0	0	10	0	0
19	27505122	.	G	A	0	4	4	0	4	8	0	0
19	27505191	.	G	A	0	3	3	0	14	17	0	0
19	27505211	.	G	A	12	8	20	0	0	20	0	0
19	27505962	.	G	T	3	4	7	0	0	7	0	0
19	27609998	.	C	T	12	11	23	0	0	23	0	0
19	27616055	.	C	T	16	13	29	0	1	30	0	0
19	27616337	.	G	A	11	17	28	0	0	28	0	0
19	27634823	.	C	T	10	10	20	0	1	21	0	0
19	28281343	.	G	A	21	9	30	0	1	31	0	0
19	28281351	.	T	G	14	21	35	0	0	35	0	0
19	28283749	.	C	T	2	27	29	0	26	55	0	0
19	28283786	.	C	T	35	26	61	0	1	62	0	0
19	28284146	.	T	A	6	10	16	0	1	17	0	0
19	28284203	.	A	T	23	16	39	0	1	40	0	0
19	28284220	.	T	A	18	12	30	0	2	32	0	0
19	28288148	.	C	T	16	10	26	0	1	27	0	0
19	28288480	.	G	A	13	10	23	0	2	25	0	0
19	28288489	.	C	T	13	10	23	0	0	23	0	0
19	28359920	.	G	A	10	18	28	0	6	34	0	0
19	28360028	.	T	G	27	19	46	0	2	48	0	0
19	28360029	.	C	T	29	18	47	0	2	49	0	0
19	28787154	.	C	T	18	13	31	0	0	31	0	0
19	28788220	.	A	G	17	18	35	0	0	35	0	0
19	28788430	.	T	A	23	15	38	0	1	39	0	0
19	28802039	.	A	G	5	3	8	0	0	8	0	0
19	28802469	.	G	A	5	4	9	0	1	10	0	0
19	28802487	.	G	T	4	7	11	0	2	13	0	0
19	28802954	.	C	A	18	19	37	0	5	42	0	0
19	28803173	.	G	A	26	24	50	1	1	52	0	0
19	28803267	.	G	A	4	22	26	0	15	41	0	0
19	28820643	.	C	T	14	18	32	0	0	32	0	0
19	28821230	.	G	A	10	22	32	0	0	32	0	0
19	28821333	.	G	A	0	18	18	0	17	35	0	0
19	28821334	.	G	T	16	18	34	0	1	35	0	0
19	28821383	.	A	C	12	5	17	0	0	17	0	0
19	28821666	.	G	C	19	14	33	0	0	33	0	0
19	28822057	.	T	C	9	10	19	0	0	19	0	0
19	28822187	.	C	T	21	15	36	0	0	36	0	0
19	28822521	.	A	G	2	4	6	0	0	6	0	0
19	28822624	.	G	A	2	2	4	0	0	4	0	0
19	28822794	.	A	T	4	3	7	0	0	7	0	0
19	28823124	.	C	T	1	7	8	0	0	8	0	0
19	28823162	.	T	C	2	5	7	0	0	7	0	0
19	28823385	.	A	T	3	4	7	0	0	7	0	0
19	28823987	.	C	G	3	2	5	0	0	5	0	0
19	29294076	.	A	T	1	2	3	0	1	4	0	0
19	29298102	.	A	T	3	6	9	0	0	9	0	0
19	29298866	.	C	A	1	7	8	0	0	8	0	0
19	29298942	.	A	C	6	3	9	0	0	9	0	0
19	29301647	.	A	T	4	6	10	0	0	10	0	0
19	29301650	.	C	G	6	3	9	0	0	9	0	0
19	29301708	.	T	C	4	3	7	0	0	7	0	0
19	29301805	.	C	T	1	5	6	0	0	6	0	0
19	29301863	.	A	T	6	3	9	0	0	9	0	0
19	29303871	.	A	C	4	3	7	0	0	7	0	0
19	29305506	.	C	T	3	8	11	0	0	11	0	0
19	29310226	.	G	A	0	4	4	0	6	10	0	0
19	29318861	.	A	C	9	6	15	0	0	15	0	0
19	29327825	.	A	G	6	0	6	0	14	20	0	0
19	29333382	.	C	T	15	9	24	0	1	25	0	0
19	29333418	.	G	T	5	12	17	0	0	17	0	0
19	29333565	.	G	A	2	4	6	0	0	6	0	0
19	29337897	.	A	T	1	3	4	0	2	6	0	0
19	29337923	.	G	A	2	3	5	0	0	5	0	0
19	29358141	.	A	C	3	3	6	0	0	6	0	0
19	29358144	.	C	T	3	3	6	0	0	6	0	0
19	29383644	.	C	T	0	19	19	0	10	29	0	0
19	29383675	.	G	C	11	16	27	4	0	31	0	0
19	29437097	.	A	G	1	2	3	0	0	3	0	0
19	29799885	.	C	T	40	40	80	0	12	92	0	0
19	29799900	.	T	C	42	34	76	0	9	85	0	0
19	29800229	.	A	G	38	38	76	0	2	78	0	0
19	29812799	.	G	T	2	11	13	0	22	35	0	0
19	29815096	.	T	C	22	24	46	0	0	46	0	0
19	29817914	.	C	G	33	20	53	0	0	53	0	0
19	29818142	.	C	T	29	17	46	0	3	49	0	0
19	29822615	.	C	T	2	12	14	0	12	26	0	0
19	29830215	.	G	A	21	17	38	0	1	39	0	0
19	29832781	.	G	A	9	15	24	6	2	32	0	0
19	29836779	.	A	G	1	6	7	0	0	7	0	0
19	29836821	.	T	G	1	6	7	0	0	7	0	0
19	29836946	.	C	T	1	2	3	0	0	3	0	0
19	29836948	.	A	G	1	2	3	0	0	3	0	0
19	29837251	.	T	C	2	4	6	0	0	6	0	0
19	29837310	.	A	G	3	3	6	0	0	6	0	0
19	29837705	.	C	T	0	5	5	0	8	13	0	0
19	29852666	.	C	T	3	6	9	0	1	10	0	0
19	29859831	.	G	A	2	4	6	0	0	6	0	0
19	29859841	.	G	A	3	4	7	0	0	7	0	0
19	29859872	.	G	A	3	2	5	0	0	5	0	0
19	29859987	.	G	A	1	2	3	0	0	3	0	0
19	29861961	.	C	A	1	6	7	0	4	11	0	0
19	29866548	.	G	T	6	2	8	0	1	9	0	0
19	29866559	.	G	A	3	8	11	0	1	12	0	0
19	29866630	.	C	T	0	5	5	0	10	15	0	0
19	29866882	.	G	A	16	16	32	0	0	32	0	0
19	29866918	.	G	A	10	9	19	0	3	22	0	0
19	29872768	.	C	T	0	5	5	0	14	19	0	0
19	29872783	.	C	T	1	3	4	0	12	16	0	0
19	29873369	.	A	G	7	7	14	0	0	14	0	0
19	29875000	.	G	T	2	4	6	0	0	6	0	0
19	29878311	.	T	C	2	5	7	0	0	7	0	0
19	29878997	.	C	T	11	11	22	0	0	22	0	0
19	29879060	.	G	A	11	6	17	0	1	18	0	0
19	29879063	.	G	A	7	9	16	0	0	16	0	0
19	29879393	.	C	T	5	11	16	0	0	16	0	0
19	30348804	.	G	A	15	15	30	0	3	33	0	0
19	30349310	.	A	T	16	11	27	0	1	28	0	0
19	30349553	.	C	G	1	13	14	0	13	27	0	0
19	30355383	.	T	C	29	20	49	0	0	49	0	0
19	30355907	.	A	T	22	14	36	0	2	38	0	0
19	30391816	.	T	C	12	8	20	0	0	20	0	0
19	30391968	.	G	T	16	10	26	0	1	27	0	0
19	30393919	.	C	A	11	11	22	0	2	24	0	0
19	30393967	.	T	C	16	12	28	0	0	28	0	0
19	30410406	.	A	G	9	8	17	0	0	17	0	0
19	30410519	.	C	A	14	10	24	0	0	24	0	0
19	30413354	.	G	A	15	12	27	0	1	28	0	0
19	30416170	.	T	C	18	0	18	0	16	34	0	0
19	30423199	.	A	T	11	11	22	0	1	23	0	0
19	30423209	.	A	G	12	11	23	0	1	25	1	0
19	30423366	.	A	G	8	9	17	0	0	17	0	0
19	30423368	.	G	A	8	9	17	0	0	17	0	0
19	30425616	.	G	T	13	7	20	0	0	20	0	0
19	30425622	.	T	C	12	9	21	0	1	22	0	0
19	30426436	.	C	A	7	7	14	0	0	14	0	0
19	30428688	.	A	C	13	7	20	0	0	20	0	0
19	30428726	.	A	G	9	0	9	0	9	18	0	0
19	30429063	.	G	A	4	3	7	0	0	7	0	0
19	30432697	.	A	G	12	17	29	0	1	30	0	0
19	30432742	.	G	A	12	16	28	0	0	28	0	0
19	30436629	.	G	A	16	13	29	0	1	30	0	0
19	30436891	.	G	A	9	11	20	0	0	20	0	0
19	30438518	.	A	G	12	11	23	0	2	25	0	0
19	30441396	.	A	G	10	8	18	0	0	18	0	0
19	30441399	.	A	G	12	10	22	0	0	22	0	0
19	30442717	.	C	A	10	6	16	0	0	16	0	0
19	30445915	.	C	A	9	13	22	0	1	23	0	0
19	30445927	.	A	G	9	14	23	0	1	24	0	0
19	30446181	.	T	A	14	9	23	0	1	24	0	0
19	30446552	.	T	C	14	9	23	0	0	23	0	0
19	30446567	.	G	T	12	10	22	0	0	22	0	0
19	30450234	.	T	C	8	7	15	0	0	15	0	0
19	30450375	.	C	T	8	14	22	0	0	22	0	0
19	30455640	.	T	C	12	4	16	0	1	17	0	0
19	30455650	.	T	C	11	3	14	0	1	15	0	0
19	30455697	.	A	G	10	6	16	0	0	16	0	0
19	30457770	.	A	T	10	12	22	0	1	23	0	0
19	30458039	.	C	A	15	13	28	0	1	29	0	0
19	30458103	.	G	A	1	14	15	0	17	32	0	0
19	30521443	.	C	A	2	3	5	0	1	6	0	0
19	30521782	.	T	A	3	3	6	0	1	7	0	0
19	32050593	.	A	T	15	15	30	0	0	30	0	0
19	32149988	.	A	C	14	17	31	0	2	33	0	0
19	32167216	.	T	C	14	12	26	0	0	26	0	0
19	32202060	.	A	G	6	3	9	0	0	9	0	0
19	32202179	.	A	C	7	2	9	0	0	10	1	0
19	32202227	.	T	C	5	2	7	0	1	8	0	0
19	32202296	.	C	T	1	3	4	0	1	5	0	0
19	32204061	.	A	G	4	1	5	0	1	6	0	0
19	32204330	.	G	A	1	2	3	0	0	3	0	0
19	32456894	.	A	G	6	0	6	0	6	12	0	0
19	32457087	.	G	T	4	5	9	0	0	9	0	0
19	32457264	.	C	G	10	8	18	0	0	18	0	0
19	32457390	.	T	C	9	9	18	0	2	20	0	0
19	32457564	.	T	C	3	10	13	0	1	14	0	0
19	32457660	.	C	T	5	3	8	0	0	8	0	0
19	32457939	.	G	A	6	8	14	0	0	14	0	0
19	32458152	.	C	T	12	7	19	0	1	20	0	0
19	32458158	.	T	C	12	8	20	0	0	20	0	0
19	32458422	.	G	A	3	4	7	0	4	11	0	0
19	32458431	.	G	A	3	6	9	0	2	11	0	0
19	32461473	.	C	T	4	5	9	0	1	10	0	0
19	32473399	.	A	G	4	8	12	0	1	13	0	0
19	32473451	.	G	A	3	4	7	0	0	7	0	0
19	32473770	.	C	T	5	2	7	0	0	7	0	0
19	32473812	.	C	T	5	4	9	0	0	9	0	0
19	32474031	.	T	G	6	4	10	0	0	10	0	0
19	32474042	.	C	A	3	5	8	0	0	8	0	0
19	32474093	.	G	A	4	2	6	0	0	6	0	0
19	32474102	.	C	T	2	5	7	0	0	7	0	0
19	32474181	.	G	T	2	4	6	0	0	6	0	0
19	32474193	.	G	T	3	3	6	0	0	6	0	0
19	32474355	.	T	A	12	3	15	0	0	15	0	0
19	32474723	.	G	T	3	4	7	0	0	7	0	0
19	32474885	.	A	G	5	7	12	0	0	12	0	0
19	32487242	.	T	C	9	4	13	0	0	13	0	0
19	32487373	.	T	C	3	4	7	0	0	7	0	0
19	32487408	.	C	T	6	7	13	0	0	13	0	0
19	32490366	.	C	T	3	3	6	0	0	6	0	0
19	32497406	.	T	A	4	2	6	0	0	6	0	0
19	32499736	.	G	A	5	3	8	0	0	8	0	0
19	32500172	.	G	C	1	3	4	0	0	4	0	0
19	32505825	.	C	T	5	3	8	0	0	8	0	0
19	32505875	.	C	T	0	3	3	0	8	11	0	0
19	32505927	.	G	T	5	5	10	0	0	10	0	0
19	32515377	.	T	A	10	8	18	0	0	18	0	0
19	32572647	.	T	C	5	7	12	0	0	12	0	0
19	32572999	.	A	T	10	3	13	0	0	13	0	0
19	32573001	.	T	A	8	3	11	0	1	12	0	0
19	32573057	.	G	A	9	7	16	0	1	17	0	0
19	32573064	.	C	T	7	7	14	0	1	15	0	0
19	32573100	.	C	A	6	4	10	0	1	11	0	0
19	32573173	.	T	C	12	0	12	0	4	16	0	0
19	32573193	.	A	G	10	6	16	0	0	16	0	0
19	32573229	.	A	G	10	6	16	0	0	16	0	0
19	32573269	.	T	C	13	4	17	0	1	18	0	0
19	32575190	.	G	A	9	4	13	0	1	14	0	0
19	32588706	.	C	T	9	11	20	0	0	20	0	0
19	32588775	.	G	A	11	3	14	0	1	15	0	0
19	32600206	.	C	G	1	3	4	0	0	4	0	0
19	32600644	.	C	T	1	11	12	0	6	18	0	0
19	32600720	.	A	C	9	10	19	0	0	19	0	0
19	32623259	.	G	A	1	4	5	0	0	5	0	0
19	32623687	.	G	A	27	27	54	0	0	54	0	0
19	32624048	.	A	C	18	21	39	0	1	40	0	0
19	32624138	.	G	A	17	24	41	0	2	43	0	0
19	32624247	.	A	G	22	16	38	0	2	40	0	0
19	32638212	.	G	A	30	25	55	0	5	60	0	0
19	32767965	.	C	T	5	7	12	0	0	12	0	0
19	32768397	.	C	G	5	4	9	0	0	9	0	0
19	32768434	.	T	C	5	3	8	0	0	8	0	0
19	32768551	.	C	T	5	2	7	1	1	9	0	0
19	32768668	.	T	C	6	2	8	0	2	10	0	0
19	32768935	.	T	G	4	5	9	0	0	9	0	0
19	32768954	.	A	C	6	6	12	0	0	12	0	0
19	32768985	.	G	A	4	7	11	0	0	11	0	0
19	32769271	.	G	T	1	6	7	0	0	7	0	0
19	32769296	.	T	C	2	5	7	0	0	7	0	0
19	32770917	.	G	A	2	6	8	0	0	8	0	0
19	32773651	.	A	G	2	4	6	0	0	6	0	0
19	32774718	.	C	T	2	2	4	0	0	4	0	0
19	32804432	.	T	C	2	5	7	0	0	7	0	0
19	32807301	.	A	T	5	6	11	0	0	11	0	0
19	32807706	.	G	A	3	4	7	0	1	8	0	0
19	32807915	.	A	G	7	11	18	0	0	18	0	0
19	32807933	.	A	C	4	10	14	0	0	14	0	0
19	32808140	.	C	T	3	5	8	0	2	10	0	0
19	32808332	.	G	T	1	7	8	0	3	11	0	0
19	32814334	.	G	T	11	12	23	0	0	23	0	0
19	32818503	.	G	T	0	13	13	0	4	17	0	0
19	32818824	.	A	G	11	12	23	0	0	23	0	0
19	32818825	.	G	A	11	12	23	0	0	23	0	0
19	32818910	.	G	A	1	5	6	0	3	9	0	0
19	32819234	.	G	A	9	9	18	0	2	20	0	0
19	32819303	.	T	C	16	13	29	0	1	30	0	0
19	32819347	.	C	T	12	16	28	0	1	29	0	0
19	32819640	.	A	G	4	9	13	0	1	14	0	0
19	32819703	.	C	A	3	4	7	0	1	8	0	0
19	32819760	.	A	T	3	5	8	1	0	9	0	0
19	32819798	.	C	T	2	5	7	0	0	7	0	0
19	32819952	.	T	C	1	3	4	0	0	4	0	0
19	32838396	.	T	A	8	11	19	0	1	20	0	0
19	32864963	.	T	G	21	10	31	0	1	32	0	0
19	32865113	.	G	A	22	13	35	1	1	37	0	0
19	32865276	.	A	T	15	6	21	0	2	23	0	0
19	32865337	.	C	A	20	11	31	0	5	36	0	0
19	32865347	.	C	T	20	14	34	0	3	37	0	0
19	32865504	.	G	T	16	4	20	0	1	21	0	0
19	32865527	.	G	C	11	4	15	0	1	16	0	0
19	32865562	.	C	A	4	4	8	0	0	8	0	0
19	32865569	.	A	G	5	3	8	0	0	8	0	0
19	32865758	.	A	C	2	2	4	0	0	4	0	0
19	32866126	.	A	C	11	11	22	0	0	22	0	0
19	32866234	.	T	G	9	12	21	0	0	21	0	0
19	32866264	.	G	C	14	0	14	0	11	25	0	0
19	32866322	.	A	G	14	8	22	0	0	22	0	0
19	32866362	.	T	A	11	11	22	0	1	23	0	0
19	32866372	.	C	T	9	11	20	0	0	20	0	0
19	32866475	.	T	A	16	16	32	0	0	32	0	0
19	32866570	.	T	A	23	16	39	0	2	41	0	0
19	32866571	.	A	G	22	17	39	0	1	40	0	0
19	32866620	.	G	A	11	5	16	0	1	17	0	0
19	32867218	.	G	A	15	13	28	0	1	29	0	0
19	32867274	.	A	T	22	17	39	0	3	42	0	0
19	32872674	.	A	G	25	13	38	2	0	40	0	0
19	32878103	.	G	A	20	18	38	0	2	40	0	0
19	32878370	.	A	G	19	11	30	0	0	30	0	0
19	32884181	.	A	G	17	8	25	0	1	26	0	0
19	32884256	.	C	T	0	8	8	0	17	25	0	0
19	32895748	.	G	T	18	11	29	0	2	31	0	0
19	32895869	.	A	T	14	6	20	0	2	22	0	0
19	32895873	.	T	A	4	12	16	0	2	18	0	0
19	32896001	.	G	A	11	8	19	0	1	20	0	0
19	32896174	.	A	T	5	2	7	0	0	7	0	0
19	32896336	.	G	T	10	7	17	2	1	20	0	0
19	32896427	.	C	A	1	10	11	0	13	24	0	0
19	32896499	.	T	G	14	18	32	0	0	32	0	0
19	32896519	.	T	C	10	17	27	0	0	27	0	0
19	32899313	.	T	A	12	8	20	0	2	22	0	0
19	32899328	.	T	A	13	12	25	0	0	25	0	0
19	32899452	.	A	G	15	15	30	0	1	31	0	0
19	32907732	.	A	C	16	7	23	0	0	23	0	0
19	32918241	.	T	A	25	5	30	0	0	30	0	0
19	32918807	.	T	C	24	9	33	0	0	33	0	0
19	32919215	.	A	T	12	8	20	0	0	20	0	0
19	32928367	.	A	T	21	7	28	0	0	28	0	0
19	32928446	.	T	C	12	0	12	0	4	16	0	0
19	32931100	.	A	T	18	20	38	0	1	39	0	0
19	32931101	.	C	T	2	20	22	0	18	40	0	0
19	32933891	.	C	A	22	40	62	0	2	64	0	0
19	32935480	.	G	C	22	32	54	0	3	57	0	0
19	32936989	.	T	C	23	27	50	1	1	52	0	0
19	32937663	.	C	A	23	31	54	0	3	57	0	0
19	32944034	.	A	G	12	21	33	0	1	34	0	0
19	32951040	.	G	C	18	16	34	0	1	35	0	0
19	32954310	.	A	G	15	21	36	0	0	36	0	0
19	32979329	.	T	G	1	2	3	0	0	3	0	0
19	32979625	.	A	G	11	14	25	0	0	25	0	0
19	33029587	.	T	C	7	12	19	0	0	19	0	0
19	33043458	.	A	G	9	10	19	0	0	19	0	0
19	33043749	.	T	C	12	9	21	0	0	21	0	0
19	33061247	.	C	T	11	7	18	0	3	21	0	0
19	33066783	.	C	G	18	0	18	0	22	40	0	0
19	33071055	.	C	G	10	12	22	0	2	24	0	0
19	33071126	.	G	T	13	13	26	0	1	27	0	0
19	33071172	.	G	T	12	10	22	0	1	23	0	0
19	33071249	.	G	C	7	7	14	0	0	14	0	0
19	33071635	.	A	T	4	3	7	0	0	7	0	0
19	33071795	.	A	T	11	16	27	0	0	27	0	0
19	33095789	.	T	C	13	8	21	0	0	21	0	0
19	33106035	.	G	C	4	11	15	0	0	15	0	0
19	33106333	.	G	A	0	9	9	0	13	22	0	0
19	33123179	.	A	G	6	11	17	0	2	19	0	0
19	33124700	.	A	T	8	8	16	0	2	18	0	0
19	33127718	.	T	C	15	11	26	0	0	26	0	0
19	33131666	.	C	T	19	15	34	0	1	35	0	0
19	33132033	.	T	A	16	9	25	0	0	25	0	0
19	33136410	.	A	G	19	1	20	0	28	48	0	0
19	33137436	.	A	G	20	0	20	0	15	35	0	0
19	33137667	.	C	T	2	4	6	0	0	6	0	0
19	33139195	.	A	G	3	2	5	0	0	5	0	0
19	33139520	.	A	C	3	2	5	0	0	5	0	0
19	33140052	.	T	G	4	4	8	0	0	8	0	0
19	33140259	.	A	C	1	5	6	0	0	6	0	0
19	33140322	.	T	C	3	3	6	0	0	6	0	0
19	33202996	.	T	A	2	2	4	0	0	4	0	0
19	33203744	.	G	A	7	7	14	0	0	14	0	0
19	33204301	.	A	C	1	2	3	0	1	4	0	0
19	33204574	.	T	C	2	3	5	0	0	5	0	0
19	33205130	.	G	A	2	5	7	0	0	7	0	0
19	33205223	.	T	A	4	4	8	0	0	8	0	0
19	33205255	.	C	G	1	5	6	0	5	11	0	0
19	33205316	.	G	A	2	4	6	0	0	6	0	0
19	33211420	.	C	T	4	4	8	0	1	9	0	0
19	33211504	.	G	T	7	8	15	0	0	15	0	0
19	33211734	.	A	T	3	4	7	0	0	7	0	0
19	33211741	.	T	C	5	4	9	0	0	9	0	0
19	33270936	.	T	C	6	0	6	0	3	9	0	0
19	33476598	.	T	C	6	2	8	0	0	8	0	0
19	33511276	.	A	G	3	2	5	0	0	5	0	0
19	33512144	.	G	A	2	2	4	0	1	5	0	0
19	33512932	.	A	T	1	2	3	0	0	3	0	0
19	33513005	.	A	C	4	5	9	0	0	9	0	0
19	33513413	.	T	A	2	4	6	0	0	6	0	0
19	33513939	.	A	T	3	5	8	0	0	8	0	0
19	33513954	.	G	A	3	8	11	0	0	11	0	0
19	33514118	.	C	T	1	3	4	0	0	4	0	0
19	33514481	.	C	T	2	3	5	0	1	6	0	0
19	33514521	.	C	T	4	3	7	0	0	7	0	0
19	33514616	.	T	G	2	3	5	0	0	5	0	0
19	33701679	.	C	T	9	11	20	0	3	23	0	0
19	33701722	.	A	T	6	6	12	0	0	12	0	0
19	33701838	.	G	A	0	9	9	0	15	24	0	0
19	33701887	.	T	A	15	10	25	0	0	25	0	0
19	33701923	.	T	A	16	11	27	0	2	29	0	0
19	33732336	.	G	A	3	7	10	0	0	10	0	0
19	33732393	.	C	T	2	2	4	0	1	5	0	0
19	33755973	.	G	A	2	15	17	0	12	29	0	0
19	33755985	.	A	G	14	3	17	0	13	30	0	0
19	33756009	.	G	T	17	15	32	0	1	33	0	0
19	33765636	.	C	T	16	20	36	0	1	37	0	0
19	33772226	.	T	A	24	21	45	1	2	48	0	0
19	33772280	.	T	C	26	11	37	0	5	42	0	0
19	33775750	.	C	T	12	15	27	0	1	28	0	0
19	33775810	.	T	C	15	11	26	0	1	27	0	0
19	33782757	.	A	G	11	0	11	0	17	28	0	0
19	33782914	.	A	G	7	7	14	0	6	20	0	0
19	33783332	.	A	T	14	16	30	0	0	30	0	0
19	33784221	.	T	A	6	5	11	0	0	11	0	0
19	33784896	.	T	C	16	13	29	0	0	29	0	0
19	33784897	.	C	T	18	11	29	0	1	30	0	0
19	33784966	.	C	T	17	15	32	0	3	35	0	0
19	33784986	.	T	C	13	21	34	0	3	37	0	0
19	33785094	.	C	T	12	19	31	0	2	33	0	0
19	33785109	.	C	T	12	19	31	0	1	32	0	0
19	33785175	.	G	A	8	13	21	0	3	24	0	0
19	33785197	.	G	A	2	17	19	0	13	32	0	0
19	33785234	.	A	G	14	0	14	0	18	32	0	0
19	33785240	.	T	C	15	20	35	0	0	35	0	0
19	33785357	.	C	A	13	16	29	0	1	30	0	0
19	33785379	.	G	A	15	18	33	0	1	34	0	0
19	33785512	.	T	C	15	15	30	0	2	32	0	0
19	33785704	.	G	T	26	14	40	0	0	40	0	0
19	33785735	.	T	G	23	1	24	0	13	37	0	0
19	34781039	.	C	T	1	6	7	0	3	10	0	0
19	34810815	.	G	A	2	2	4	0	0	4	0	0
19	34960061	.	A	T	6	5	11	0	1	12	0	0
19	34960099	.	A	G	6	3	9	0	1	10	0	0
19	34960190	.	C	G	3	13	16	0	16	32	0	0
19	34960198	.	T	C	19	10	29	0	2	31	0	0
19	34960315	.	T	A	5	3	8	0	0	8	0	0
19	34960574	.	A	G	3	4	7	1	0	8	0	0
19	34960694	.	T	A	2	3	5	0	3	8	0	0
19	34961152	.	C	T	8	10	18	0	1	19	0	0
19	34961269	.	A	G	6	6	12	0	0	12	0	0
19	34967187	.	G	A	1	3	4	0	0	4	0	0
19	34979819	.	C	T	1	2	3	0	0	3	0	0
19	35002450	.	G	A	4	7	11	0	1	12	0	0
19	35002527	.	G	A	0	4	4	0	3	7	0	0
19	35002714	.	A	C	6	5	11	0	0	11	0	0
19	35002723	.	T	C	6	5	11	0	0	11	0	0
19	35004117	.	A	C	10	5	15	0	0	15	0	0
19	35004135	.	C	T	9	5	14	0	1	15	0	0
19	35004868	.	C	A	3	5	8	0	0	8	0	0
19	35004869	.	C	A	2	5	7	0	1	8	0	0
19	35004941	.	T	C	3	7	10	0	0	10	0	0
19	35005136	.	A	C	5	4	9	0	1	10	0	0
19	35005137	.	A	T	4	5	9	0	1	10	0	0
19	35005318	.	G	A	11	9	20	0	6	26	0	0
19	35007021	.	G	A	1	1	2	0	3	5	0	0
19	35007220	.	G	A	13	16	29	0	0	29	0	0
19	35007235	.	G	A	14	16	30	0	0	30	0	0
19	35013166	.	G	T	4	3	7	0	1	8	0	0
19	35013806	.	C	T	28	25	53	0	1	54	0	0
19	35016477	.	C	T	20	12	32	0	0	32	0	0
19	35016553	.	T	G	15	11	26	0	2	28	0	0
19	35016646	.	A	T	22	14	36	0	0	37	1	0
19	35016696	.	T	G	20	9	29	1	1	31	0	0
19	35016835	.	C	T	10	9	19	0	1	20	0	0
19	35016962	.	T	A	5	3	8	0	1	9	0	0
19	35019490	.	T	A	4	5	9	0	0	9	0	0
19	35019560	.	A	G	1	3	4	0	1	5	0	0
19	35040003	.	G	T	6	2	8	0	1	9	0	0
19	35041158	.	T	A	24	30	54	0	3	57	0	0
19	35041308	.	A	G	28	28	56	0	3	59	0	0
19	35041458	.	T	C	35	1	36	0	23	59	0	0
19	35052411	.	G	T	16	16	32	0	1	33	0	0
19	35052435	.	T	C	18	0	18	0	18	36	0	0
19	35055889	.	A	G	17	13	30	0	1	31	0	0
19	35057860	.	G	T	17	9	26	0	1	27	0	0
19	35057869	.	C	T	10	17	27	0	1	28	0	0
19	35058232	.	T	C	24	14	38	0	3	41	0	0
19	35060217	.	A	C	19	16	35	0	0	35	0	0
19	35065906	.	A	T	23	15	38	0	0	38	0	0
19	35067367	.	G	A	14	8	22	0	0	22	0	0
19	35069299	.	G	T	15	19	34	0	1	35	0	0
19	35069755	.	C	A	21	15	36	0	3	39	0	0
19	35069934	.	T	G	12	12	24	0	2	26	0	0
19	35070015	.	C	T	21	5	26	0	2	28	0	0
19	35072613	.	A	C	24	11	35	0	0	35	0	0
19	35072712	.	G	C	15	2	17	0	15	32	0	0
19	35075637	.	C	T	3	14	17	0	18	35	0	0
19	35076301	.	C	T	1	13	14	0	16	30	0	0
19	35076773	.	G	A	17	15	32	0	0	32	0	0
19	35078584	.	T	C	10	0	10	0	20	30	0	0
19	35078632	.	T	C	11	0	11	0	19	30	0	0
19	35079259	.	C	T	11	9	20	0	1	21	0	0
19	35079515	.	A	T	2	9	11	0	0	11	0	0
19	35083010	.	G	A	20	14	34	0	1	35	0	0
19	35083019	.	C	T	20	12	32	0	0	32	0	0
19	35083182	.	C	T	18	8	26	0	3	29	0	0
19	35116228	.	A	G	12	12	24	0	1	25	0	0
19	35116297	.	T	C	11	12	23	0	0	23	0	0
19	35116405	.	A	G	12	12	24	0	0	24	0	0
19	35116438	.	G	A	12	8	20	0	2	22	0	0
19	35118813	.	G	C	8	5	13	0	0	13	0	0
19	35118842	.	T	C	4	6	10	0	1	11	0	0
19	35118860	.	G	T	3	9	12	0	0	12	0	0
19	35118911	.	C	A	8	10	18	0	0	18	0	0
19	35118983	.	A	T	10	6	16	0	0	16	0	0
19	35119039	.	T	C	8	5	13	0	0	13	0	0
19	35119052	.	A	G	7	7	14	0	0	14	0	0
19	35119082	.	T	C	6	0	6	0	6	12	0	0
19	35119169	.	G	A	9	14	23	0	0	23	0	0
19	35119205	.	G	A	10	14	24	0	0	24	0	0
19	35119436	.	C	T	17	7	24	0	0	24	0	0
19	35121381	.	T	C	13	6	19	0	0	20	1	0
19	35121459	.	T	C	6	10	16	0	2	18	0	0
19	35122875	.	G	A	7	6	13	0	1	14	0	0
19	35122876	.	C	A	8	5	13	0	1	14	0	0
19	35123452	.	A	T	6	7	13	0	2	15	0	0
19	35123508	.	T	C	10	0	10	0	9	19	0	0
19	35128238	.	T	C	10	12	22	0	0	22	0	0
19	35131332	.	G	A	5	13	18	0	0	18	0	0
19	35134092	.	G	T	11	9	20	0	1	21	0	0
19	35134181	.	G	A	4	8	12	0	0	12	0	0
19	35135406	.	C	A	0	4	4	0	4	8	0	0
19	35135466	.	G	A	13	7	20	0	0	20	0	0
19	35135600	.	A	G	8	5	13	0	1	14	0	0
19	35135626	.	T	G	10	5	15	0	0	15	0	0
19	35135711	.	A	G	4	10	14	0	1	15	0	0
19	35135870	.	C	T	4	4	8	0	0	8	0	0
19	35135883	.	A	G	3	4	7	0	0	7	0	0
19	35135927	.	T	G	4	9	13	0	1	14	0	0
19	35135961	.	A	G	9	9	18	0	0	18	0	0
19	35137910	.	A	G	5	8	13	0	0	13	0	0
19	35138260	.	A	G	8	4	12	0	1	13	0	0
19	35155676	.	C	T	8	4	12	0	0	12	0	0
19	35157472	.	A	G	5	3	8	0	0	8	0	0
19	35157621	.	C	T	2	3	5	0	0	5	0	0
19	35159665	.	G	T	7	6	13	0	0	13	0	0
19	35159668	.	G	A	7	6	13	0	0	13	0	0
19	35159721	.	A	G	7	8	15	0	0	15	0	0
19	35159826	.	G	T	9	11	20	0	0	20	0	0
19	35159841	.	G	T	6	6	12	0	0	12	0	0
19	35165047	.	T	C	4	1	5	0	7	12	0	0
19	35167217	.	G	C	3	6	9	0	0	9	0	0
19	35167278	.	A	T	1	6	7	0	1	8	0	0
19	35167368	.	C	G	3	5	8	0	0	8	0	0
19	35170195	.	A	T	6	2	8	0	0	8	0	0
19	35170263	.	T	G	7	4	11	1	0	12	0	0
19	35175205	.	A	G	5	5	10	0	0	10	0	0
19	35184402	.	A	G	2	5	7	0	1	8	0	0
19	35191348	.	A	G	9	5	14	0	0	14	0	0
19	35339938	.	C	T	0	3	3	0	4	7	0	0
19	35339968	.	G	A	3	3	6	0	0	6	0	0
19	35359341	.	C	T	25	34	59	0	1	60	0	0
19	35379917	.	A	G	7	7	14	0	1	15	0	0
19	35379923	.	G	A	7	8	15	0	0	15	0	0
19	35379998	.	A	G	10	8	18	0	0	18	0	0
19	35380031	.	G	A	17	9	26	0	1	27	0	0
19	35380070	.	G	A	13	14	27	0	0	27	0	0
19	35380168	.	T	C	11	0	11	0	10	21	0	0
19	35381625	.	T	A	4	4	8	0	0	8	0	0
19	35381956	.	A	G	7	8	15	0	0	15	0	0
19	35383571	.	G	A	9	3	12	0	1	13	0	0
19	35383586	.	C	T	1	3	4	0	9	13	0	0
19	35386288	.	T	G	9	5	14	0	0	14	0	0
19	35390668	.	T	C	2	5	7	0	0	7	0	0
19	35400397	.	G	A	4	2	6	0	0	6	0	0
19	35400505	.	A	G	3	2	5	0	0	5	0	0
19	35419202	.	A	G	1	5	6	0	0	6	0	0
19	35419215	.	T	A	1	4	5	0	0	5	0	0
19	35419292	.	T	A	2	3	5	0	0	5	0	0
19	35419300	.	A	T	3	2	5	0	0	5	0	0
19	35422354	.	T	C	12	15	27	0	2	29	0	0
19	35428735	.	G	A	12	19	31	0	0	31	0	0
19	35459414	.	A	G	20	16	36	0	3	39	0	0
19	35459737	.	G	A	23	22	45	0	1	46	0	0
19	35459801	.	A	T	23	22	45	0	3	48	0	0
19	35473080	.	C	A	3	25	28	0	19	47	0	0
19	35497434	.	T	G	3	3	6	0	0	6	0	0
19	35722947	.	T	C	4	6	10	0	0	10	0	0
19	35723040	.	G	T	20	7	27	0	1	28	0	0
19	35723087	.	G	T	17	16	33	0	1	34	0	0
19	35723113	.	G	T	14	23	37	0	1	38	0	0
19	35723189	.	G	T	0	2	2	0	6	8	0	0
19	35723214	.	T	C	2	1	3	0	11	14	0	0
19	35723237	.	C	A	9	12	21	0	0	21	0	0
19	35723268	.	A	T	10	16	26	0	0	26	0	0
19	35723289	.	C	A	10	12	22	0	3	25	0	0
19	35723422	.	C	T	12	9	21	0	0	21	0	0
19	35723552	.	C	T	1	13	14	0	12	26	0	0
19	35733351	.	T	C	11	16	27	0	0	27	0	0
19	35852378	.	C	T	2	4	6	0	0	6	0	0
19	35852381	.	A	G	2	3	5	0	0	5	0	0
19	36115044	.	G	A	5	8	13	0	1	14	0	0
19	36115084	.	C	T	10	11	21	0	0	21	0	0
19	36115100	.	C	T	1	10	11	0	9	20	0	0
19	36115170	.	G	C	4	9	13	0	0	13	0	0
19	36115210	.	G	A	4	11	15	0	1	16	0	0
19	36120265	.	C	T	1	5	6	0	7	13	0	0
19	36167703	.	C	T	2	6	8	0	6	14	0	0
19	36169872	.	A	G	5	7	12	0	0	12	0	0
19	36171682	.	T	C	4	0	4	0	6	10	0	0
19	36171778	.	G	A	6	7	13	0	1	14	0	0
19	36212370	.	G	A	5	6	11	0	0	11	0	0
19	36227281	.	G	A	3	5	8	0	0	8	0	0
19	36227407	.	A	G	13	5	18	0	1	19	0	0
19	36258165	.	C	T	0	5	5	0	1	6	0	0
19	36271838	.	C	T	4	5	9	0	0	9	0	0
19	36277799	.	G	A	3	6	9	0	1	10	0	0
19	36290642	.	A	G	3	7	10	0	0	10	0	0
19	36290669	.	C	T	0	3	3	0	3	6	0	0
19	36290702	.	G	A	3	4	7	0	0	7	0	0
19	36311813	.	G	A	6	5	11	0	0	11	0	0
19	36311879	.	G	A	1	6	7	0	0	7	0	0
19	36354693	.	T	A	1	2	3	0	1	4	0	0
19	36365526	.	A	C	2	0	2	0	3	5	0	0
19	36369325	.	G	A	3	2	5	0	0	5	0	0
19	36369382	.	C	T	0	3	3	0	5	8	0	0
19	36374340	.	A	G	2	6	8	0	0	8	0	0
19	36374365	.	G	A	3	8	11	0	0	11	0	0
19	36389712	.	G	C	4	2	6	0	0	6	0	0
19	36389748	.	G	A	3	4	7	0	0	7	0	0
19	36427054	.	C	G	5	2	7	0	0	7	0	0
19	37127483	.	A	T	11	15	26	2	0	28	0	0
19	37133533	.	C	A	6	2	8	0	0	8	0	0
19	37133719	.	G	T	7	5	12	0	0	12	0	0
19	37133872	.	T	C	3	3	6	0	0	6	0	0
19	37133916	.	C	T	2	2	4	0	0	4	0	0
19	37135759	.	G	A	8	3	11	0	0	11	0	0
19	37138743	.	C	T	8	8	16	0	1	17	0	0
19	37139266	.	T	C	7	4	11	0	0	11	0	0
19	37478230	.	C	A	6	5	11	0	1	12	0	0
19	37481658	.	C	T	8	4	12	0	1	13	0	0
19	37485121	.	C	T	4	5	9	0	0	9	0	0
19	37488593	.	C	T	5	6	11	0	0	11	0	0
19	37491605	.	C	A	1	2	3	0	0	3	0	0
19	37491689	.	G	A	3	7	10	0	0	10	0	0
19	37492351	.	G	A	5	7	12	0	1	13	0	0
19	37501802	.	C	T	10	16	26	0	0	26	0	0
19	37501935	.	A	G	19	20	39	0	2	41	0	0
19	37501959	.	C	T	27	16	43	0	1	44	0	0
19	37502235	.	G	A	29	23	52	0	3	55	0	0
19	37504201	.	G	A	21	8	29	0	3	32	0	0
19	37505790	.	G	A	21	16	37	0	0	37	0	0
19	37505808	.	G	A	14	19	33	0	1	34	0	0
19	37505880	.	C	G	30	24	54	0	0	54	0	0
19	37506405	.	G	A	14	12	26	2	2	30	0	0
19	37506414	.	T	C	14	12	26	2	1	29	0	0
19	37508533	.	G	A	11	10	21	0	0	21	0	0
19	37518204	.	A	G	1	2	3	0	0	3	0	0
19	37518575	.	G	A	1	2	3	0	0	3	0	0
19	37518745	.	A	G	1	2	3	0	0	3	0	0
19	37701868	.	T	C	4	3	7	0	0	7	0	0
19	37702120	.	A	G	3	6	9	0	0	9	0	0
19	37702255	.	A	T	1	3	4	0	1	5	0	0
19	37702282	.	G	A	1	5	6	0	0	6	0	0
19	37702389	.	C	T	7	3	10	0	0	10	0	0
19	37737736	.	C	T	2	3	5	0	0	5	0	0
19	37759892	.	T	A	4	3	7	0	1	8	0	0
19	37775871	.	T	C	5	6	11	0	2	13	0	0
19	37786292	.	C	A	2	7	9	0	2	11	0	0
19	37799569	.	T	C	4	6	10	0	1	11	0	0
19	37804440	.	T	C	10	4	14	0	1	15	0	0
19	37804719	.	C	T	5	5	10	0	0	10	0	0
19	37815718	.	C	A	5	12	17	0	0	17	0	0
19	37815733	.	A	G	11	5	16	0	1	17	0	0
19	37815763	.	G	A	12	5	17	0	0	17	0	0
19	37829463	.	A	C	6	3	9	1	1	11	0	0
19	37835433	.	A	C	6	5	11	0	0	11	0	0
19	37835502	.	A	G	1	6	7	0	2	9	0	0
19	37835508	.	T	C	3	7	10	0	0	10	0	0
19	37926003	.	C	T	23	16	39	1	2	42	0	0
19	37926066	.	C	A	24	18	42	0	2	44	0	0
19	37926261	.	C	T	10	25	35	0	4	39	0	0
19	37926267	.	C	A	13	26	39	0	2	41	0	0
19	37926447	.	C	T	11	18	29	0	1	30	0	0
19	37926493	.	C	T	16	9	25	0	1	26	0	0
19	37926637	.	A	G	9	0	9	0	9	18	0	0
19	37926816	.	T	G	26	15	41	0	2	43	0	0
19	38171067	.	G	A	14	9	23	0	0	23	0	0
19	38175219	.	C	T	3	2	5	0	0	5	0	0
19	38176911	.	A	G	6	5	11	0	2	13	0	0
19	38205299	.	T	C	8	7	15	0	0	15	0	0
19	38205350	.	T	C	7	5	12	0	1	13	0	0
19	38216302	.	A	C	8	11	19	0	0	19	0	0
19	38216310	.	C	G	9	0	9	0	10	19	0	0
19	38227086	.	T	G	9	6	15	0	0	15	0	0
19	38240541	.	A	G	6	0	6	0	13	19	0	0
19	38327091	.	A	T	2	2	4	0	0	4	0	0
19	38327186	.	T	C	1	2	3	0	0	3	0	0
19	38389833	.	G	A	5	3	8	0	0	8	0	0
19	38391681	.	G	T	1	5	6	0	0	6	0	0
19	38477272	.	G	T	1	2	3	0	1	4	0	0
19	38495968	.	T	C	2	2	4	0	0	4	0	0
19	38776962	.	A	G	11	11	22	0	2	24	0	0
19	38777235	.	T	C	4	13	17	0	0	17	0	0
19	38793349	.	G	A	8	4	12	0	0	12	0	0
19	40026627	.	A	G	28	19	47	0	2	49	0	0
19	40026661	.	T	C	24	29	53	0	3	56	0	0
19	40027585	.	A	G	20	15	35	0	1	36	0	0
19	40027652	.	C	A	24	17	41	0	3	44	0	0
19	40031164	.	G	A	27	29	56	0	1	57	0	0
19	40039603	.	G	A	11	10	21	0	1	22	0	0
19	40039606	.	T	A	10	10	20	0	2	22	0	0
19	40039651	.	A	T	9	10	19	0	0	19	0	0
19	40052809	.	G	T	10	5	15	0	0	15	0	0
19	40052884	.	G	A	8	5	13	0	0	13	0	0
19	40071539	.	T	G	5	4	9	0	0	9	0	0
19	40071577	.	T	C	6	3	9	0	0	9	0	0
19	40071619	.	A	G	2	1	3	0	3	6	0	0
19	40071748	.	G	A	1	2	3	0	0	3	0	0
19	40073659	.	G	C	3	4	7	0	0	7	0	0
19	40073715	.	G	A	1	5	6	0	0	6	0	0
19	40073739	.	A	G	2	0	2	0	4	6	0	0
19	40076842	.	C	T	3	7	10	0	0	10	0	0
19	40076845	.	T	C	3	8	11	0	0	11	0	0
19	40080719	.	T	C	3	5	8	0	0	8	0	0
19	40081613	.	T	C	2	2	4	0	0	4	0	0
19	40081927	.	A	G	1	4	5	0	0	5	0	0
19	40099361	.	C	T	3	4	7	0	0	7	0	0
19	40110897	.	G	A	5	7	12	0	1	13	0	0
19	40113305	.	G	A	3	9	12	0	7	19	0	0
19	40121260	.	T	A	3	5	8	0	0	8	0	0
19	40122510	.	G	A	1	2	3	0	1	4	0	0
19	40122516	.	T	C	2	3	5	0	0	5	0	0
19	40122695	.	G	C	2	2	4	0	0	4	0	0
19	40122723	.	C	A	3	2	5	0	0	5	0	0
19	40122753	.	G	A	0	1	1	0	2	3	0	0
19	40122758	.	C	G	2	2	4	0	0	4	0	0
19	40126533	.	T	C	3	5	8	0	0	8	0	0
19	40126647	.	A	G	5	0	5	0	3	8	0	0
19	40129258	.	A	C	9	9	18	0	0	18	0	0
19	40129443	.	A	G	6	6	12	0	1	13	0	0
19	40145888	.	G	A	9	3	12	0	0	12	0	0
19	40146214	.	C	T	6	9	15	0	2	17	0	0
19	40146215	.	G	A	11	5	16	0	1	17	0	0
19	40147719	.	C	A	16	17	33	0	0	33	0	0
19	40147782	.	T	C	16	12	28	0	0	31	3	0
19	40147821	.	G	A	0	15	15	0	16	31	0	0
19	40151351	.	C	T	7	8	15	0	0	15	0	0
19	40151970	.	G	A	13	10	23	0	2	25	0	0
19	40151983	.	C	T	11	10	21	0	1	22	0	0
19	40152569	.	G	A	10	14	24	0	1	25	0	0
19	40153024	.	A	T	19	14	33	0	0	33	0	0
19	40155144	.	C	A	10	14	24	0	1	25	0	0
19	40155327	.	C	T	23	12	35	3	2	40	0	0
19	40156805	.	G	A	0	12	12	0	9	21	0	0
19	40157041	.	T	A	9	17	26	0	0	26	0	0
19	40162945	.	C	A	12	14	26	0	1	27	0	0
19	40163077	.	C	T	11	16	27	0	0	27	0	0
19	40163184	.	C	T	12	19	31	0	1	32	0	0
19	40163223	.	G	A	12	19	31	0	1	32	0	0
19	40177726	.	G	C	2	5	7	0	0	7	0	0
19	40177762	.	T	C	5	4	9	0	0	9	0	0
19	40179916	.	G	C	2	6	8	0	4	12	0	0
19	40180011	.	C	T	2	7	9	0	0	9	0	0
19	40325166	.	A	G	1	2	3	0	0	3	0	0
19	40326527	.	G	A	0	1	1	0	5	6	0	0
19	40326882	.	C	T	2	5	7	0	1	8	0	0
19	40326950	.	C	T	5	8	13	0	2	15	0	0
19	40326972	.	T	C	3	8	11	0	1	12	0	0
19	40327862	.	C	A	4	3	7	0	0	7	0	0
19	40328092	.	C	G	2	2	4	0	0	4	0	0
19	40340319	.	A	G	11	9	20	0	1	21	0	0
19	40343087	.	C	T	24	16	40	0	1	41	0	0
19	40347600	.	T	G	15	1	16	0	12	29	1	0
19	40347702	.	T	A	12	11	23	0	3	26	0	0
19	40347760	.	T	A	3	13	16	0	3	19	0	0
19	40347785	.	A	T	7	7	14	0	0	14	0	0
19	40395930	.	G	C	0	3	3	0	5	8	0	0
19	40540276	.	A	T	2	7	9	1	0	10	0	0
19	40540324	.	C	T	6	5	11	1	0	12	0	0
19	40540947	.	G	T	3	6	9	0	1	10	0	0
19	40551982	.	T	G	6	0	6	0	9	15	0	0
19	40558221	.	C	T	6	7	13	0	0	13	0	0
19	40558281	.	A	G	11	7	18	0	0	18	0	0
19	40641356	.	C	G	5	0	5	0	4	9	0	0
19	40641379	.	A	G	4	4	8	0	1	9	0	0
19	40641439	.	C	T	6	7	13	0	0	13	0	0
19	40685424	.	C	T	10	11	21	0	2	23	0	0
19	40685875	.	G	A	6	9	15	0	1	16	0	0
19	40685923	.	T	C	4	8	12	0	0	12	0	0
19	40685935	.	A	G	5	6	11	0	0	11	0	0
19	40686133	.	C	G	2	3	5	0	0	5	0	0
19	40686599	.	T	C	5	5	10	0	0	10	0	0
19	40716977	.	T	C	4	4	8	0	0	8	0	0
19	40717649	.	C	A	7	10	17	0	0	17	0	0
19	40731649	.	C	T	1	8	9	0	0	9	0	0
19	40770455	.	G	A	8	3	11	0	0	11	0	0
19	40770527	.	G	A	3	5	8	0	0	8	0	0
19	40773573	.	G	A	6	6	12	0	0	12	0	0
19	40776907	.	G	A	3	3	6	0	1	7	0	0
19	40892312	.	T	C	8	6	14	0	1	15	0	0
19	40895763	.	G	A	5	10	15	0	0	15	0	0
19	40895826	.	T	C	4	11	15	0	1	16	0	0
19	40898334	.	A	C	6	11	17	0	0	17	0	0
19	40898352	.	T	G	5	0	5	0	11	16	0	0
19	40898500	.	G	A	4	3	7	0	0	7	0	0
19	40900205	.	T	C	8	0	8	0	6	14	0	0
19	40900334	.	C	T	8	6	14	0	2	16	0	0
19	40906097	.	A	C	22	13	35	0	0	35	0	0
19	40906118	.	T	A	15	13	28	0	0	28	0	0
19	40944295	.	C	T	1	2	3	0	0	3	0	0
19	41021048	.	T	C	11	9	20	0	1	21	0	0
19	41033811	.	G	A	3	20	23	0	11	34	0	0
19	41038855	.	C	T	11	20	31	0	1	32	0	0
19	41447195	.	T	C	1	3	4	0	1	5	0	0
19	42802294	.	T	A	1	2	3	0	1	4	0	0
19	42802295	.	G	A	1	2	3	0	1	4	0	0
19	42843596	.	A	G	7	6	13	0	0	13	0	0
19	42843640	.	A	G	6	0	6	0	5	11	0	0
19	42843845	.	A	G	13	7	20	0	0	20	0	0
19	42872386	.	A	C	9	1	10	0	29	39	0	0
19	42872392	.	A	C	10	0	10	0	31	41	0	0
19	43704324	.	G	A	1	9	10	1	1	12	0	0
19	43727110	.	A	C	1	3	4	0	0	4	0	0
19	43900995	.	A	G	11	6	17	0	0	17	0	0
19	44801756	.	A	G	1	2	3	0	0	3	0	0
19	44801765	.	T	C	1	0	1	0	2	3	0	0
19	45376049	.	G	A	2	2	4	0	0	4	0	0
19	45856295	.	A	G	7	10	17	0	0	17	0	0
19	45859824	.	C	T	25	15	40	0	1	41	0	0
19	45883626	.	C	A	18	13	31	0	2	33	0	0
19	45962080	.	T	G	2	4	6	0	1	7	0	0
19	45962214	.	G	A	1	8	9	0	0	9	0	0
19	45967297	.	C	G	5	0	5	0	6	11	0	0
19	45967306	.	A	T	5	7	12	0	0	12	0	0
19	45967406	.	G	A	5	5	10	0	0	10	0	0
19	45967516	.	A	G	6	0	6	0	10	16	0	0
19	45967623	.	G	T	2	3	5	0	0	5	0	0
19	45967653	.	G	T	1	2	3	0	0	3	0	0
19	45970765	.	G	A	12	4	16	0	1	17	0	0
19	45978027	.	T	C	2	2	4	0	1	5	0	0
19	45978188	.	C	G	2	3	5	0	0	5	0	0
19	45979380	.	C	T	10	8	18	0	1	19	0	0
19	45980192	.	A	G	3	5	8	0	0	8	0	0
19	45980323	.	C	T	5	8	13	0	0	13	0	0
19	45980428	.	A	C	3	3	6	0	0	6	0	0
19	45991250	.	A	C	1	4	5	0	0	5	0	0
19	45996230	.	G	A	2	5	7	0	0	7	0	0
19	46006240	.	G	A	6	6	12	0	0	12	0	0
19	46007583	.	A	T	3	3	6	0	0	6	0	0
19	46007595	.	A	G	2	2	4	0	1	5	0	0
19	46007628	.	G	A	2	2	4	0	1	5	0	0
19	46010406	.	C	G	2	6	8	0	0	8	0	0
19	46015031	.	G	A	2	3	5	0	1	6	0	0
19	46019603	.	G	A	3	7	10	0	0	10	0	0
19	46019616	.	G	T	2	6	8	0	0	8	0	0
19	46019803	.	A	G	13	16	29	0	2	31	0	0
19	46020453	.	C	A	12	11	23	0	0	23	0	0
19	46022453	.	C	T	1	15	16	0	15	31	0	0
19	46032793	.	T	G	5	8	13	0	1	14	0	0
19	46032947	.	A	G	11	5	16	0	0	16	0	0
19	46036046	.	T	A	10	7	17	0	0	17	0	0
19	46036083	.	A	G	5	6	11	0	1	12	0	0
19	46036091	.	A	T	4	7	11	0	0	11	0	0
19	46036290	.	G	A	14	8	22	0	1	23	0	0
19	46038800	.	G	A	10	11	21	0	0	21	0	0
19	46049173	.	G	A	10	4	14	0	0	14	0	0
19	46050672	.	C	T	0	6	6	0	7	13	0	0
19	46122698	.	T	C	3	3	6	0	0	6	0	0
19	46192325	.	A	G	3	2	5	0	0	5	0	0
19	46192355	.	T	C	2	6	8	0	0	8	0	0
19	46192394	.	G	A	1	4	5	0	0	5	0	0
19	46202060	.	T	C	2	3	5	0	0	5	0	0
19	46202110	.	G	A	5	3	8	0	0	8	0	0
19	46209433	.	G	A	0	2	2	0	4	6	0	0
19	46210120	.	G	T	8	4	12	0	0	12	0	0
19	46210209	.	A	T	5	3	8	0	0	8	0	0
19	46210242	.	G	C	6	4	10	0	1	11	0	0
19	46210286	.	A	G	6	3	9	0	0	9	0	0
19	46210354	.	A	T	4	2	6	0	0	6	0	0
19	46210355	.	T	G	4	2	6	0	0	6	0	0
19	46210464	.	T	A	1	5	6	0	0	6	0	0
19	46210505	.	G	C	3	2	5	0	0	5	0	0
19	46224575	.	G	A	14	19	33	0	1	34	0	0
19	46225960	.	C	T	14	15	29	0	2	31	0	0
19	46225972	.	G	A	15	13	28	0	1	29	0	0
19	46237787	.	C	T	14	17	31	0	2	33	0	0
19	46237794	.	A	T	13	19	32	0	5	37	0	0
19	46237844	.	G	T	0	17	17	0	18	35	0	0
19	46238199	.	G	A	2	12	14	0	5	19	0	0
19	46238227	.	T	C	5	10	15	0	1	16	0	0
19	46238297	.	T	G	2	6	8	0	0	8	0	0
19	46259649	.	A	G	25	15	40	0	3	43	0	0
19	46259660	.	A	T	31	18	49	0	2	51	0	0
19	46259709	.	G	A	2	27	29	0	30	59	0	0
19	46280672	.	G	T	1	27	28	0	27	55	0	0
19	46280861	.	G	A	1	19	20	0	24	45	1	0
19	46288632	.	T	C	27	17	44	0	0	44	0	0
19	46303140	.	C	T	36	31	67	0	2	69	0	0
19	46303320	.	G	A	28	18	46	0	0	46	0	0
19	46303330	.	G	A	3	21	24	0	28	52	0	0
19	46303414	.	C	T	26	24	50	0	1	51	0	0
19	46303457	.	A	T	26	24	50	0	2	52	0	0
19	46309596	.	T	C	2	4	6	0	0	6	0	0
19	46309664	.	C	A	8	15	23	0	0	23	0	0
19	46309686	.	A	G	5	0	5	0	5	10	0	0
19	46309787	.	G	A	8	7	15	0	1	16	0	0
19	46322385	.	A	G	9	13	22	0	0	22	0	0
19	46332910	.	G	A	0	6	6	0	12	18	0	0
19	46333761	.	A	C	5	3	8	0	0	8	0	0
19	46373704	.	T	G	11	14	25	0	0	25	0	0
19	46373705	.	G	T	10	13	23	0	2	25	0	0
19	47976325	.	C	T	22	25	47	0	2	49	0	0
19	48364713	.	T	A	1	2	3	0	0	3	0	0
2	19225	.	T	C	39	30	69	0	2	71	0	0
2	19568	.	G	A	30	24	54	0	3	57	0	0
2	21074	.	A	G	34	40	74	0	2	76	0	0
2	21479	.	C	T	5	41	46	0	26	72	0	0
2	68899	.	A	G	2	3	5	0	1	6	0	0
2	98426	.	T	G	1	4	5	0	0	5	0	0
2	98451	.	A	G	1	2	3	0	0	3	0	0
2	101188	.	C	G	1	2	3	0	1	4	0	0
2	101197	.	A	C	1	3	4	0	0	4	0	0
2	108000	.	C	T	9	9	18	0	0	18	0	0
2	108586	.	G	A	0	9	9	0	13	22	0	0
2	109030	.	G	A	12	13	25	0	1	26	0	0
2	109075	.	T	C	8	8	16	0	0	16	0	0
2	136352	.	C	T	5	7	12	0	1	13	0	0
2	136368	.	C	T	7	7	14	0	1	15	0	0
2	136409	.	T	G	10	6	16	0	0	16	0	0
2	136479	.	A	G	13	10	23	0	1	24	0	0
2	137169	.	T	C	4	9	13	0	0	13	0	0
2	138603	.	G	A	7	5	12	0	0	12	0	0
2	138785	.	A	G	9	3	12	0	0	12	0	0
2	141926	.	G	A	7	6	13	0	1	14	0	0
2	145477	.	A	G	4	4	8	0	0	8	0	0
2	146199	.	T	C	1	7	8	0	2	10	0	0
2	146264	.	T	C	3	0	3	0	10	13	0	0
2	1062670	.	G	A	0	4	4	0	7	11	0	0
2	1175241	.	T	C	1	2	3	0	0	3	0	0
2	1203857	.	C	T	1	3	4	0	0	4	0	0
2	1215156	.	G	A	0	3	3	0	1	4	0	0
2	1215160	.	A	G	1	3	4	0	0	4	0	0
2	1220802	.	T	C	11	15	26	0	1	27	0	0
2	1595275	.	T	C	4	17	21	0	0	21	0	0
2	1595897	.	T	C	4	7	11	0	0	11	0	0
2	1596165	.	T	C	8	3	11	0	0	11	0	0
2	1596717	.	T	C	5	3	8	0	0	8	0	0
2	1597355	.	T	C	7	6	13	0	0	13	0	0
2	1597617	.	T	C	7	9	16	0	0	16	0	0
2	1597691	.	T	C	13	5	18	0	0	18	0	0
2	1599420	.	T	C	13	0	13	0	4	17	0	0
2	1599434	.	C	T	0	16	16	0	1	17	0	0
2	2737855	.	T	C	2	5	7	0	0	7	0	0
2	2988441	.	T	A	9	4	13	3	0	16	0	0
2	3022599	.	A	G	4	2	6	0	0	6	0	0
2	3028893	.	A	G	9	14	23	0	0	23	0	0
2	3028908	.	A	T	6	12	18	0	0	18	0	0
2	3065633	.	A	T	2	6	8	0	0	8	0	0
2	3387676	.	T	C	26	6	32	0	0	32	0	0
2	3401100	.	A	C	8	12	20	0	0	20	0	0
2	4852031	.	T	C	1	0	1	0	4	5	0	0
2	4900798	.	T	C	19	22	41	0	1	42	0	0
2	5775963	.	C	A	4	3	7	0	0	7	0	0
2	5806642	.	C	T	2	3	5	0	0	5	0	0
2	5811792	.	A	G	3	3	6	0	0	6	0	0
2	5811863	.	A	G	2	2	4	0	0	4	0	0
2	5811966	.	G	C	5	3	8	0	0	8	0	0
2	5811971	.	T	G	2	5	7	0	1	8	0	0
2	5812047	.	T	A	1	3	4	0	0	4	0	0
2	5812049	.	A	T	1	3	4	0	0	4	0	0
2	5813710	.	C	T	8	6	14	0	1	15	0	0
2	5813913	.	G	A	7	5	12	0	1	13	0	0
2	5814004	.	C	T	3	4	7	0	0	7	0	0
2	5817327	.	T	G	3	8	11	0	0	11	0	0
2	5830336	.	G	A	2	7	9	0	1	10	0	0
2	5843885	.	G	A	1	5	6	0	0	6	0	0
2	5843996	.	C	T	4	6	10	0	1	11	0	0
2	5844019	.	T	G	5	8	13	0	0	13	0	0
2	5844113	.	G	A	10	8	18	0	0	18	0	0
2	5844235	.	A	G	3	7	10	0	1	11	0	0
2	5844242	.	T	A	2	6	8	0	2	10	0	0
2	5846891	.	A	C	7	3	10	1	1	12	0	0
2	5849076	.	G	T	2	5	7	0	0	7	0	0
2	5852823	.	A	T	5	7	12	0	0	12	0	0
2	5856164	.	A	G	10	4	14	0	0	14	0	0
2	5856206	.	T	C	7	7	14	0	1	15	0	0
2	5856242	.	T	C	4	9	13	0	0	13	0	0
2	5856248	.	A	T	5	9	14	0	0	14	0	0
2	5856326	.	G	T	4	3	7	0	0	7	0	0
2	5856557	.	G	T	1	6	7	0	4	11	0	0
2	5866850	.	T	A	5	6	11	0	1	12	0	0
2	5866977	.	C	T	8	6	14	0	0	14	0	0
2	5866989	.	G	A	5	6	11	0	0	11	0	0
2	5872652	.	C	T	7	9	16	0	0	16	0	0
2	5872950	.	C	T	12	5	17	0	0	17	0	0
2	5880396	.	G	A	13	8	21	0	1	22	0	0
2	5880435	.	T	C	8	5	13	0	1	14	0	0
2	5882398	.	A	T	5	6	11	0	0	11	0	0
2	5882726	.	T	C	3	4	7	0	0	7	0	0
2	5882793	.	A	C	9	4	13	0	0	13	0	0
2	5882799	.	A	G	7	0	7	0	8	15	0	0
2	5883198	.	G	A	7	11	18	1	2	21	0	0
2	5883558	.	A	T	3	5	8	0	0	8	0	0
2	5884019	.	A	T	3	5	8	0	0	8	0	0
2	5884127	.	A	C	6	3	9	0	1	10	0	0
2	5884322	.	C	T	5	9	14	0	0	14	0	0
2	5884355	.	A	G	6	5	11	0	1	12	0	0
2	5887849	.	C	G	5	2	7	0	0	7	0	0
2	5898946	.	C	T	8	7	15	0	1	16	0	0
2	5898955	.	C	T	9	8	17	0	1	18	0	0
2	5901471	.	C	T	5	4	9	0	2	11	0	0
2	5909405	.	C	T	2	3	5	0	0	5	0	0
2	5909435	.	C	T	4	5	9	0	1	10	0	0
2	5909559	.	G	A	1	6	7	0	6	13	0	0
2	5912062	.	A	G	8	4	12	0	0	12	0	0
2	5912257	.	G	A	8	4	12	0	1	13	0	0
2	5912288	.	C	G	8	0	8	0	9	17	0	0
2	5919314	.	C	T	11	7	18	0	1	19	0	0
2	5921661	.	C	T	8	9	17	1	0	18	0	0
2	5923178	.	G	C	0	8	8	0	5	13	0	0
2	5923438	.	G	A	8	11	19	0	0	19	0	0
2	5923517	.	G	A	9	7	16	0	0	16	0	0
2	5923679	.	G	A	7	4	11	0	1	12	0	0
2	5923728	.	T	A	2	2	4	0	0	4	0	0
2	5923863	.	C	T	9	12	21	0	0	21	0	0
2	5923890	.	T	A	14	5	19	0	0	19	0	0
2	5923943	.	C	T	7	7	14	0	1	15	0	0
2	5924085	.	A	T	5	6	11	0	0	11	0	0
2	5929940	.	C	T	0	2	2	0	2	4	0	0
2	5929988	.	A	T	2	4	6	0	0	6	0	0
2	5933999	.	C	A	1	2	3	0	10	13	0	0
2	5934000	.	G	A	10	2	12	0	1	13	0	0
2	5934195	.	A	T	3	8	11	0	0	11	0	0
2	5934804	.	T	G	6	10	16	0	1	17	0	0
2	5935097	.	A	G	5	9	14	0	0	14	0	0
2	5935132	.	C	T	10	12	22	0	0	22	0	0
2	5935137	.	A	G	10	12	22	0	0	22	0	0
2	5935222	.	C	T	1	13	14	0	11	25	0	0
2	5935223	.	G	T	11	13	24	0	1	25	0	0
2	5935294	.	G	A	9	7	16	0	0	16	0	0
2	5935341	.	T	C	7	0	7	0	9	16	0	0
2	5935364	.	A	C	9	11	20	0	0	20	0	0
2	5935425	.	C	T	4	3	7	1	0	8	0	0
2	5935434	.	A	G	5	4	9	1	0	10	0	0
2	5935660	.	A	T	6	4	10	2	1	13	0	0
2	5935861	.	G	T	8	5	13	1	1	15	0	0
2	5936035	.	T	C	6	6	12	0	2	14	0	0
2	5936038	.	A	G	6	8	14	0	0	14	0	0
2	5936153	.	C	A	0	3	3	0	5	8	0	0
2	5936180	.	A	G	3	3	6	0	0	6	0	0
2	5936228	.	G	A	1	4	5	0	0	5	0	0
2	5936248	.	A	C	1	8	9	0	0	9	0	0
2	5936303	.	A	G	1	5	6	0	0	6	0	0
2	5936377	.	G	A	8	4	12	0	0	12	0	0
2	5936380	.	C	T	8	4	12	0	0	12	0	0
2	5936678	.	T	A	13	6	19	0	4	23	0	0
2	5936856	.	C	A	9	5	14	0	0	14	0	0
2	5937035	.	G	A	9	6	15	0	4	19	0	0
2	5937079	.	T	G	3	8	11	0	0	11	0	0
2	5941940	.	T	A	5	8	13	0	0	13	0	0
2	5942008	.	T	G	1	2	3	0	0	3	0	0
2	5942173	.	T	A	3	11	14	0	0	14	0	0
2	6005568	.	T	G	2	3	5	0	1	6	0	0
2	6011531	.	G	A	12	3	15	0	0	15	0	0
2	6026265	.	A	G	6	2	8	0	0	8	0	0
2	6032755	.	C	T	0	6	6	0	5	11	0	0
2	6032802	.	G	A	6	3	9	0	0	9	0	0
2	6033908	.	T	C	2	0	2	0	7	9	0	0
2	6034314	.	C	T	2	7	9	0	0	9	0	0
2	6034469	.	C	T	2	2	4	0	0	4	0	0
2	6039644	.	C	T	6	7	13	0	0	13	0	0
2	6039678	.	T	C	5	3	8	0	1	9	0	0
2	6042195	.	T	C	15	9	24	0	1	25	0	0
2	6052066	.	T	C	3	0	3	0	3	6	0	0
2	6052179	.	A	T	3	5	8	0	0	8	0	0
2	6052379	.	C	A	3	2	5	0	0	5	0	0
2	6052380	.	A	T	3	2	5	0	0	5	0	0
2	6052580	.	T	A	3	4	7	0	0	7	0	0
2	6052932	.	G	A	10	9	19	0	1	20	0	0
2	6054935	.	A	G	2	7	9	0	0	9	0	0
2	6067801	.	T	A	5	2	7	0	0	7	0	0
2	6073604	.	A	T	2	6	8	0	0	8	0	0
2	6077258	.	G	T	1	7	8	0	2	10	0	0
2	6082748	.	T	C	5	8	13	0	0	13	0	0
2	6082752	.	A	C	5	9	14	0	0	14	0	0
2	6089471	.	T	C	8	3	11	0	0	11	0	0
2	6091653	.	A	G	7	3	10	0	1	11	0	0
2	6091689	.	G	A	1	4	5	0	7	12	0	0
2	6091764	.	A	G	3	0	3	0	4	7	0	0
2	6106727	.	T	C	5	0	5	0	6	11	0	0
2	6106742	.	G	A	5	5	10	0	1	11	0	0
2	6107289	.	G	A	11	15	26	0	0	26	0	0
2	6107310	.	A	T	12	13	25	0	0	25	0	0
2	6126753	.	T	A	15	11	26	0	1	27	0	0
2	6126783	.	A	T	13	13	26	0	0	26	0	0
2	6126857	.	T	C	18	16	34	0	0	35	1	0
2	6143912	.	T	C	13	22	35	0	1	36	0	0
2	6144085	.	G	A	1	19	20	0	18	38	0	0
2	6149006	.	T	C	10	7	17	1	1	19	0	0
2	6149220	.	T	G	2	2	4	0	1	5	0	0
2	6173897	.	G	A	1	2	3	0	0	3	0	0
2	6174087	.	C	G	0	2	2	0	1	3	0	0
2	6186956	.	T	A	17	13	30	0	1	31	0	0
2	6187031	.	G	T	11	15	26	0	2	28	0	0
2	6187138	.	T	C	18	14	32	0	1	33	0	0
2	6191691	.	T	C	23	16	39	0	1	40	0	0
2	6191829	.	C	T	9	15	24	0	2	26	0	0
2	6194151	.	T	C	7	7	14	0	9	23	0	0
2	6196798	.	T	A	10	14	24	0	0	24	0	0
2	6196804	.	A	G	8	0	8	0	15	23	0	0
2	6196858	.	C	A	12	11	23	0	0	23	0	0
2	6197216	.	G	T	1	9	10	0	1	11	0	0
2	6197249	.	G	A	3	5	8	0	1	9	0	0
2	6258129	.	G	T	1	2	3	0	0	3	0	0
2	6265929	.	C	A	19	12	31	0	1	33	1	0
2	6266115	.	T	A	9	12	21	0	0	21	0	0
2	6292405	.	T	G	26	13	39	0	1	40	0	0
2	6292416	.	G	C	15	27	42	0	1	43	0	0
2	6292453	.	G	T	18	23	41	0	2	43	0	0
2	6323084	.	C	T	0	7	7	0	5	12	0	0
2	6334330	.	C	T	0	2	2	0	2	4	0	0
2	6334331	.	G	A	2	2	4	0	0	4	0	0
2	6338940	.	G	A	4	2	6	0	0	6	0	0
2	6338985	.	T	C	1	3	4	0	0	4	0	0
2	6339367	.	C	T	2	2	4	0	0	4	0	0
2	6342572	.	G	A	2	2	4	0	0	4	0	0
2	6346196	.	A	G	1	2	3	0	0	3	0	0
2	6358003	.	T	C	2	3	5	0	1	6	0	0
2	6358090	.	C	T	1	2	3	0	0	3	0	0
2	6373790	.	T	A	2	3	5	0	0	5	0	0
2	6373811	.	T	C	1	3	4	0	0	4	0	0
2	6734267	.	A	G	4	3	7	0	0	7	0	0
2	6734317	.	C	T	1	7	8	0	0	8	0	0
2	6734490	.	G	A	2	2	4	0	0	4	0	0
2	6761213	.	C	G	3	3	6	0	0	6	0	0
2	6790253	.	A	G	2	0	2	0	3	5	0	0
2	6804743	.	C	T	1	7	8	0	0	8	0	0
2	6805112	.	G	A	5	5	10	0	0	10	0	0
2	6886758	.	T	G	5	0	5	0	6	11	0	0
2	6886837	.	G	A	1	9	10	0	9	19	0	0
2	6888679	.	G	A	6	7	13	0	1	14	0	0
2	6926482	.	A	G	4	9	13	0	0	13	0	0
2	6926573	.	C	T	6	10	16	1	0	17	0	0
2	6926619	.	C	A	10	7	17	0	0	17	0	0
2	6931552	.	A	G	11	9	20	0	0	20	0	0
2	6941439	.	C	T	6	10	16	0	0	16	0	0
2	6941440	.	G	A	0	10	10	0	6	16	0	0
2	6948707	.	C	T	11	15	26	0	3	29	0	0
2	6948717	.	T	C	15	16	31	0	1	32	0	0
2	6952460	.	G	A	0	5	5	0	9	14	0	0
2	6952596	.	C	T	8	7	15	0	1	16	0	0
2	6952610	.	A	C	8	7	15	0	1	16	0	0
2	6952707	.	A	G	7	3	10	0	0	10	0	0
2	6952740	.	C	A	6	3	9	0	0	9	0	0
2	6958671	.	A	T	11	14	25	0	1	26	0	0
2	6958677	.	A	T	12	14	26	0	0	26	0	0
2	6958712	.	T	A	10	6	16	0	0	16	0	0
2	6958940	.	C	A	9	13	22	0	0	22	0	0
2	6958974	.	T	G	7	3	10	0	0	10	0	0
2	7037580	.	C	T	4	4	8	0	1	9	0	0
2	7039765	.	C	A	12	5	17	0	2	19	0	0
2	7040053	.	A	T	5	4	9	0	1	10	0	0
2	7040253	.	C	T	11	9	20	0	2	22	0	0
2	7042165	.	C	T	4	6	10	0	0	10	0	0
2	7046777	.	C	T	10	7	17	0	0	17	0	0
2	7051164	.	G	A	1	8	9	0	15	24	0	0
2	7056102	.	G	A	8	13	21	2	1	24	0	0
2	7056359	.	G	T	9	12	21	0	2	23	0	0
2	7056604	.	A	G	12	0	12	0	8	20	0	0
2	7056610	.	A	G	14	7	21	0	1	22	0	0
2	7056711	.	T	G	3	4	7	0	0	7	0	0
2	7056761	.	G	A	0	8	8	0	11	19	0	0
2	7056763	.	G	A	0	8	8	0	11	19	0	0
2	7057010	.	T	C	9	6	15	0	0	15	0	0
2	7132376	.	C	T	8	4	12	0	0	12	0	0
2	7134386	.	T	C	2	3	5	0	0	5	0	0
2	7137939	.	A	T	8	3	11	0	1	12	0	0
2	7147920	.	G	A	4	2	6	0	0	6	0	0
2	7150075	.	G	T	6	6	12	0	1	13	0	0
2	7150571	.	C	G	9	6	15	0	0	15	0	0
2	7150573	.	A	G	8	6	14	0	0	14	0	0
2	7150908	.	C	G	9	6	15	0	0	15	0	0
2	7150950	.	A	T	3	4	7	0	1	8	0	0
2	7151148	.	A	G	6	4	10	0	0	10	0	0
2	7151161	.	A	T	6	4	10	0	0	10	0	0
2	7151197	.	C	T	7	2	9	0	1	10	0	0
2	7151392	.	C	A	1	13	14	0	9	23	0	0
2	7151485	.	A	T	9	4	13	0	1	14	0	0
2	7151613	.	A	G	7	2	9	0	0	9	0	0
2	7151843	.	C	A	1	8	9	0	8	17	0	0
2	7152168	.	C	T	1	7	8	0	3	11	0	0
2	7152263	.	G	A	8	7	15	0	2	17	0	0
2	7152268	.	T	C	8	10	18	0	0	18	0	0
2	7152326	.	G	A	9	4	13	0	0	13	0	0
2	7152350	.	C	A	0	3	3	0	7	10	0	0
2	7152409	.	T	C	9	6	15	2	0	17	0	0
2	7152431	.	T	C	8	7	15	1	1	17	0	0
2	7152469	.	G	T	9	5	14	0	0	14	0	0
2	7152518	.	A	G	4	6	10	0	0	10	0	0
2	7152520	.	C	G	5	6	11	0	0	11	0	0
2	7152681	.	C	A	7	3	10	0	0	10	0	0
2	7153293	.	A	T	5	3	8	0	0	8	0	0
2	7153829	.	T	A	6	4	10	0	0	10	0	0
2	7153861	.	T	C	4	3	7	0	0	7	0	0
2	7153868	.	T	C	1	0	1	0	7	8	0	0
2	7153924	.	T	C	4	0	4	0	9	13	0	0
2	7154474	.	C	T	6	7	13	0	0	13	0	0
2	7154584	.	T	C	2	3	5	0	0	5	0	0
2	7154585	.	T	C	4	2	6	0	0	6	0	0
2	7168167	.	G	A	9	5	14	0	0	14	0	0
2	7168179	.	T	A	8	8	16	0	0	16	0	0
2	7168257	.	G	A	6	0	6	0	5	11	0	0
2	7168281	.	T	G	3	0	3	0	12	15	0	0
2	7168762	.	G	A	9	5	14	0	2	16	0	0
2	7179325	.	C	T	0	2	2	0	4	6	0	0
2	7184903	.	C	T	0	4	4	0	4	8	0	0
2	7185054	.	G	A	3	3	6	0	0	6	0	0
2	7239047	.	C	T	7	5	12	0	0	12	0	0
2	7239079	.	T	C	9	6	15	0	0	15	0	0
2	7239308	.	G	A	6	2	8	0	0	8	0	0
2	7239505	.	T	C	13	5	18	0	2	20	0	0
2	7239812	.	G	A	8	11	19	0	1	20	0	0
2	7239816	.	C	T	8	12	20	0	0	20	0	0
2	7239919	.	A	T	7	7	14	0	0	14	0	0
2	7240378	.	G	A	3	4	7	0	0	7	0	0
2	7240484	.	A	C	4	5	9	0	0	9	0	0
2	7240865	.	C	T	1	9	10	0	3	13	0	0
2	7241356	.	T	G	4	3	7	0	0	7	0	0
2	7241358	.	T	G	4	3	7	0	0	7	0	0
2	7241649	.	C	T	11	5	16	0	0	16	0	0
2	7241704	.	G	C	4	8	12	0	0	12	0	0
2	7241962	.	G	A	9	13	22	0	0	22	0	0
2	7241980	.	T	A	7	12	19	0	2	21	0	0
2	7423129	.	T	C	2	3	5	0	0	5	0	0
2	7423142	.	T	C	2	0	2	0	2	4	0	0
2	7423356	.	G	T	0	4	4	0	1	5	0	0
2	7602133	.	T	G	4	7	11	0	1	12	0	0
2	7602149	.	A	G	6	7	13	0	0	13	0	0
2	7604906	.	G	A	3	2	5	1	0	6	0	0
2	7664145	.	A	G	4	2	6	0	0	6	0	0
2	7720800	.	C	T	19	19	38	0	1	39	0	0
2	7720836	.	T	C	21	20	41	0	1	42	0	0
2	7720879	.	C	A	20	26	46	0	3	49	0	0
2	7726414	.	T	A	30	16	46	0	0	46	0	0
2	7726924	.	T	A	13	15	28	0	0	28	0	0
2	7767301	.	C	T	2	5	7	0	1	8	0	0
2	7767314	.	C	T	4	4	8	0	0	8	0	0
2	7991728	.	C	A	14	9	23	0	0	23	0	0
2	8064838	.	G	A	2	2	4	0	2	6	0	0
2	8065311	.	C	T	0	8	8	1	2	11	0	0
2	8066897	.	C	T	0	3	3	0	4	7	0	0
2	8113705	.	T	C	16	16	32	0	1	33	0	0
2	8113819	.	A	G	26	11	37	0	0	37	0	0
2	8114005	.	G	T	2	9	11	0	18	29	0	0
2	8114179	.	T	C	17	20	37	0	1	38	0	0
2	9138242	.	T	C	4	3	7	0	0	7	0	0
2	9983367	.	G	A	2	3	5	0	0	5	0	0
2	10149883	.	C	G	10	0	10	2	19	38	7	0
2	11216824	.	A	G	2	3	5	0	0	5	0	0
2	11216842	.	C	A	2	2	4	0	0	4	0	0
2	11231959	.	G	A	3	3	6	0	0	6	0	0
2	11490393	.	A	G	3	3	6	0	0	6	0	0
2	11503623	.	C	T	1	3	4	0	0	4	0	0
2	11508771	.	A	G	10	3	13	0	0	13	0	0
2	11509517	.	T	C	19	0	19	0	32	51	0	0
2	11512254	.	C	T	12	16	28	0	1	29	0	0
2	11633304	.	G	C	4	4	8	0	1	9	0	0
2	11633431	.	G	A	8	4	12	0	0	12	0	0
2	11640026	.	C	T	6	15	21	0	0	21	0	0
2	11640104	.	A	T	9	13	22	0	2	24	0	0
2	11643077	.	C	T	8	6	14	0	1	15	0	0
2	11643084	.	C	G	7	9	16	0	0	16	0	0
2	11648332	.	C	T	12	11	23	0	0	23	0	0
2	11648698	.	C	T	2	4	6	0	0	6	0	0
2	11651573	.	A	T	4	9	13	0	0	13	0	0
2	11654370	.	G	A	12	12	24	0	2	26	0	0
2	11656775	.	A	G	17	10	27	0	3	30	0	0
2	11661287	.	C	T	1	10	11	0	11	22	0	0
2	11662621	.	A	C	16	15	31	1	2	34	0	0
2	11792804	.	G	A	1	2	3	0	0	3	0	0
2	11794752	.	A	T	1	2	3	0	0	3	0	0
2	11810285	.	C	T	2	2	4	0	0	4	0	0
2	11825016	.	G	A	1	2	3	0	0	3	0	0
2	11831421	.	C	T	1	4	5	0	0	5	0	0
2	11832285	.	T	C	4	2	6	0	0	6	0	0
2	11854009	.	T	C	11	3	14	0	0	14	0	0
2	11854040	.	T	C	7	3	10	0	2	12	0	0
2	11923921	.	G	A	5	5	10	0	0	10	0	0
2	11926016	.	C	T	2	4	6	0	0	6	0	0
2	11926123	.	T	C	2	3	5	0	0	5	0	0
2	11926261	.	A	G	6	0	6	0	7	13	0	0
2	11930007	.	A	G	4	5	9	0	1	10	0	0
2	11930012	.	T	C	3	4	7	0	0	7	0	0
2	11930494	.	G	A	7	5	12	0	0	12	0	0
2	11936125	.	T	C	6	6	12	0	0	12	0	0
2	11944741	.	G	A	3	9	12	1	1	14	0	0
2	11945070	.	C	G	2	6	8	0	0	8	0	0
2	11945171	.	T	C	4	3	7	0	0	7	0	0
2	11945329	.	G	C	8	7	15	0	1	16	0	0
2	11945334	.	G	C	9	7	16	0	0	16	0	0
2	11945679	.	T	A	5	4	9	0	0	9	0	0
2	11945680	.	T	C	6	4	10	0	0	10	0	0
2	11945823	.	T	C	2	5	7	0	0	7	0	0
2	11960471	.	C	T	1	4	5	0	1	6	0	0
2	11965241	.	C	T	13	16	29	0	0	29	0	0
2	11969431	.	A	G	8	10	18	0	0	18	0	0
2	11970199	.	C	T	10	6	16	0	0	16	0	0
2	11976487	.	A	T	6	2	8	0	0	8	0	0
2	11976563	.	C	T	1	8	9	0	6	15	0	0
2	11976603	.	T	C	9	0	9	0	10	19	0	0
2	11976741	.	C	T	0	3	3	0	7	10	0	0
2	11976844	.	G	A	4	8	12	0	0	12	0	0
2	11976896	.	T	G	4	7	11	0	1	12	0	0
2	11977104	.	C	T	0	7	7	0	7	14	0	0
2	11977495	.	A	G	5	8	13	0	0	13	0	0
2	11978032	.	T	A	3	11	14	0	0	15	1	0
2	11978296	.	G	A	9	6	15	0	1	16	0	0
2	11980710	.	C	A	0	3	3	0	3	6	0	0
2	11981009	.	G	C	4	5	9	0	1	10	0	0
2	11998037	.	C	T	11	12	23	0	1	24	0	0
2	11998058	.	T	C	7	11	18	0	2	20	0	0
2	12002385	.	T	A	3	2	5	0	0	5	0	0
2	12002797	.	A	G	2	4	6	0	1	7	0	0
2	12002885	.	T	C	8	3	11	0	0	11	0	0
2	12002899	.	T	G	6	3	9	0	1	10	0	0
2	12002945	.	A	T	3	3	6	0	0	6	0	0
2	12002950	.	T	C	3	3	6	0	0	6	0	0
2	12002993	.	C	G	6	2	8	0	0	8	0	0
2	12104948	.	T	A	10	12	22	0	0	22	0	0
2	12104949	.	C	T	11	12	23	0	0	23	0	0
2	12105078	.	A	T	12	10	22	0	4	26	0	0
2	12155797	.	A	G	3	4	7	0	0	7	0	0
2	12155851	.	C	T	0	4	4	0	5	9	0	0
2	12155860	.	A	C	4	6	10	0	1	11	0	0
2	12155959	.	A	C	8	10	18	0	0	18	0	0
2	12242171	.	G	A	11	5	16	0	0	16	0	0
2	12242818	.	G	T	8	6	14	0	3	17	0	0
2	12279540	.	T	C	2	4	6	0	0	6	0	0
2	12302791	.	G	C	2	4	6	0	0	6	0	0
2	12379872	.	C	T	18	15	33	0	3	36	0	0
2	12405310	.	G	A	2	10	12	0	16	28	0	0
2	12406260	.	C	T	10	10	20	0	1	21	0	0
2	12406490	.	A	G	13	19	32	0	1	33	0	0
2	12407113	.	C	G	10	11	21	0	2	23	0	0
2	12407205	.	T	C	15	2	17	0	12	29	0	0
2	12407586	.	G	T	14	18	32	0	0	32	0	0
2	12407610	.	G	A	21	17	38	0	0	38	0	0
2	12407799	.	C	T	22	19	41	0	1	42	0	0
2	12408085	.	G	A	26	17	43	1	2	46	0	0
2	12420413	.	T	A	24	18	42	0	0	42	0	0
2	12425370	.	G	A	20	13	33	1	1	35	0	0
2	12429868	.	G	A	20	11	31	0	0	31	0	0
2	12436163	.	A	G	12	17	29	0	1	30	0	0
2	12436202	.	G	A	18	18	36	0	0	36	0	0
2	12481342	.	G	A	17	14	31	0	0	31	0	0
2	12481522	.	A	G	15	19	34	0	1	35	0	0
2	12481528	.	A	G	16	15	31	0	2	33	0	0
2	12496522	.	G	C	22	12	34	0	0	34	0	0
2	12502394	.	G	A	20	15	35	0	3	38	0	0
2	12898063	.	C	G	1	3	4	0	0	4	0	0
2	12935519	.	G	A	0	5	5	0	1	6	0	0
2	12939462	.	G	A	1	5	6	0	0	6	0	0
2	12969596	.	A	G	1	2	3	0	0	3	0	0
2	12973165	.	G	T	1	3	4	0	7	11	0	0
2	12982009	.	G	A	4	2	6	0	0	6	0	0
2	12998961	.	T	A	1	7	8	0	0	8	0	0
2	12999296	.	T	C	4	4	8	0	0	8	0	0
2	13000291	.	A	G	4	0	4	0	11	15	0	0
2	13000418	.	G	A	2	5	7	0	0	7	0	0
2	13001219	.	A	C	8	4	12	0	0	12	0	0
2	13001291	.	C	A	2	2	4	0	0	4	0	0
2	13002743	.	A	G	4	0	4	0	9	13	0	0
2	13003417	.	A	C	4	9	13	0	0	13	0	0
2	13003810	.	G	A	9	3	12	0	0	12	0	0
2	13006973	.	A	G	6	0	6	0	4	10	0	0
2	13007141	.	T	A	6	6	12	0	0	12	0	0
2	13007360	.	G	A	6	3	9	0	1	10	0	0
2	13010202	.	A	G	4	7	11	0	3	14	0	0
2	13011555	.	G	T	0	6	6	0	5	11	0	0
2	13018408	.	T	C	9	11	20	0	0	20	0	0
2	13019956	.	A	T	9	9	18	0	0	18	0	0
2	13020122	.	T	A	10	11	21	0	0	21	0	0
2	13020264	.	C	A	11	9	20	0	3	23	0	0
2	13020284	.	G	C	2	6	8	0	11	19	0	0
2	13020611	.	C	A	10	8	18	0	0	18	0	0
2	13023068	.	C	A	11	7	18	0	1	19	0	0
2	13026080	.	G	A	2	8	10	0	12	22	0	0
2	13035847	.	T	A	8	7	15	0	1	16	0	0
2	13036018	.	G	A	20	1	21	0	0	21	0	0
2	13036649	.	G	C	1	6	7	0	8	15	0	0
2	13036769	.	T	C	12	9	21	0	0	21	0	0
2	13036951	.	A	T	15	11	26	0	0	26	0	0
2	13185332	.	T	G	5	3	8	0	0	8	0	0
2	13186237	.	A	T	4	4	8	0	0	8	0	0
2	13186333	.	G	T	19	8	27	0	0	27	0	0
2	13186504	.	C	T	18	16	34	0	3	37	0	0
2	13186521	.	T	C	22	18	40	0	0	40	0	0
2	13186986	.	C	T	22	10	32	0	2	34	0	0
2	13187154	.	A	G	12	10	22	0	1	23	0	0
2	13187210	.	T	G	21	20	41	0	2	43	0	0
2	13187263	.	C	A	27	11	38	0	1	39	0	0
2	13187332	.	G	T	18	17	35	0	0	35	0	0
2	13187386	.	T	G	21	16	37	0	3	40	0	0
2	13187507	.	G	A	24	13	37	0	1	38	0	0
2	13187534	.	A	C	25	13	38	0	0	38	0	0
2	13187749	.	T	A	5	7	12	0	1	14	1	0
2	13187781	.	T	C	8	7	15	0	0	15	0	0
2	13187860	.	T	G	4	4	8	0	1	9	0	0
2	13187868	.	G	A	5	5	10	0	1	11	0	0
2	13187905	.	G	A	8	6	14	0	0	14	0	0
2	13187944	.	G	A	20	14	34	0	2	36	0	0
2	13187958	.	C	A	27	14	41	0	1	42	0	0
2	13188073	.	A	T	19	23	42	0	1	43	0	0
2	13215694	.	C	A	17	17	34	0	3	37	0	0
2	13215795	.	G	T	17	19	36	0	0	36	0	0
2	13215870	.	A	G	14	8	22	0	0	22	0	0
2	13223925	.	A	G	11	4	15	0	0	15	0	0
2	13224274	.	C	T	6	4	10	0	1	11	0	0
2	13224697	.	G	A	6	10	16	0	0	16	0	0
2	13224702	.	T	C	7	8	15	0	1	16	0	0
2	13224981	.	A	G	4	4	8	0	0	8	0	0
2	13225073	.	A	C	2	7	9	0	0	9	0	0
2	13237699	.	A	G	9	8	17	0	2	19	0	0
2	13242171	.	G	A	13	6	19	0	0	19	0	0
2	13254542	.	A	G	8	9	17	0	1	18	0	0
2	13254625	.	C	T	7	8	15	0	0	15	0	0
2	13254670	.	T	C	6	0	6	0	7	13	0	0
2	13256668	.	T	G	4	12	16	0	0	16	0	0
2	13256795	.	G	C	8	7	15	0	0	15	0	0
2	13259024	.	C	T	7	6	13	0	1	14	0	0
2	13694984	.	C	T	7	8	15	0	0	15	0	0
2	13710826	.	T	C	19	11	30	0	1	31	0	0
2	13717388	.	C	T	8	7	15	0	2	17	0	0
2	13743370	.	G	T	6	2	8	0	0	8	0	0
2	13743776	.	C	T	6	4	10	0	1	11	0	0
2	13743907	.	A	T	2	6	8	0	0	8	0	0
2	13744343	.	A	G	4	7	11	0	1	12	0	0
2	13773911	.	G	C	5	9	14	0	1	15	0	0
2	13800275	.	G	C	6	2	8	0	0	8	0	0
2	14278412	.	A	C	11	8	19	0	0	19	0	0
2	14278828	.	A	C	3	0	3	0	10	13	0	0
2	14366676	.	T	A	12	16	28	0	1	29	0	0
2	14366886	.	G	C	17	1	18	0	14	32	0	0
2	14445297	.	C	T	4	2	6	0	2	8	0	0
2	14445697	.	T	C	3	3	6	0	1	7	0	0
2	14447196	.	G	A	2	5	7	0	0	7	0	0
2	14454087	.	G	A	1	3	4	0	0	4	0	0
2	14485527	.	C	G	3	2	5	0	0	5	0	0
2	14655158	.	G	A	2	2	4	0	0	4	0	0
2	14655170	.	T	G	2	2	4	0	0	4	0	0
2	14655769	.	C	G	1	4	5	0	2	7	0	0
2	15039468	.	G	A	4	2	6	0	0	6	0	0
2	15069288	.	G	A	0	5	5	0	2	7	0	0
2	15074470	.	C	T	4	3	7	0	1	8	0	0
2	15074491	.	C	T	4	2	6	0	0	6	0	0
2	15074710	.	G	A	2	2	4	0	0	4	0	0
2	15075134	.	G	A	1	3	4	0	1	5	0	0
2	15109704	.	T	C	6	5	11	0	0	11	0	0
2	15110014	.	T	C	6	4	10	0	0	10	0	0
2	15111806	.	C	T	0	6	6	0	9	15	0	0
2	15111948	.	C	T	7	5	12	0	0	12	0	0
2	15114286	.	C	T	0	6	6	1	5	12	0	0
2	15116120	.	A	T	8	3	11	0	0	11	0	0
2	15116355	.	T	C	2	5	7	0	0	7	0	0
2	15116356	.	C	T	2	5	7	0	0	7	0	0
2	15119619	.	A	G	3	2	5	0	0	5	0	0
2	15125087	.	A	C	5	3	8	0	2	10	0	0
2	15191237	.	G	A	0	2	2	0	2	4	0	0
2	15344015	.	G	A	6	3	9	0	0	9	0	0
2	15344081	.	A	G	4	4	8	0	0	8	0	0
2	15344120	.	A	G	8	7	15	0	0	15	0	0
2	15344210	.	C	A	1	2	3	0	4	7	0	0
2	15790060	.	A	G	7	3	10	0	0	10	0	0
2	15790135	.	T	G	3	4	7	0	0	7	0	0
2	15864127	.	C	T	4	6	10	0	1	11	0	0
2	15864349	.	G	A	0	9	9	0	2	11	0	0
2	15864382	.	A	C	6	3	9	0	0	9	0	0
2	15864466	.	C	T	4	4	8	0	0	8	0	0
2	15900093	.	G	A	0	8	8	0	8	16	0	0
2	15942458	.	G	T	17	13	30	0	2	32	0	0
2	15942636	.	A	G	5	4	9	0	0	9	0	0
2	15942964	.	T	C	5	5	10	0	0	10	0	0
2	15993696	.	T	A	1	6	7	0	0	7	0	0
2	16161211	.	A	G	3	8	11	0	2	13	0	0
2	16161231	.	T	A	3	7	10	0	0	10	0	0
2	16164536	.	A	G	3	10	13	0	3	16	0	0
2	16172013	.	C	A	2	3	5	0	0	5	0	0
2	16172040	.	C	T	1	3	4	0	1	5	0	0
2	16174314	.	G	C	3	13	16	0	1	17	0	0
2	16174346	.	T	C	2	7	9	0	0	9	0	0
2	16176276	.	A	G	6	9	15	0	1	16	0	0
2	16176308	.	G	A	6	5	11	0	0	11	0	0
2	16177521	.	A	G	9	6	15	0	0	15	0	0
2	16177590	.	C	G	7	9	16	0	0	16	0	0
2	16188739	.	A	G	2	2	4	0	0	4	0	0
2	16191697	.	G	C	1	15	16	0	15	31	0	0
2	16191748	.	A	G	15	13	28	0	1	29	0	0
2	16191841	.	A	C	14	8	22	0	0	22	0	0
2	16194018	.	A	G	6	0	6	0	7	13	0	0
2	16194019	.	T	C	5	7	12	0	1	13	0	0
2	16198864	.	T	C	12	0	12	0	10	22	0	0
2	16198932	.	A	G	20	11	31	0	1	32	0	0
2	16199331	.	A	G	22	22	44	0	1	45	0	0
2	16199332	.	G	A	22	21	43	0	2	45	0	0
2	16199411	.	C	T	4	20	24	0	30	54	0	0
2	16204689	.	T	G	21	36	57	1	1	59	0	0
2	16204716	.	C	G	3	31	34	1	24	59	0	0
2	16206766	.	G	T	28	24	52	0	1	53	0	0
2	16207346	.	T	C	14	18	32	0	2	34	0	0
2	16209406	.	T	C	20	19	39	0	1	40	0	0
2	16209753	.	G	A	26	27	53	0	2	55	0	0
2	16212643	.	G	A	13	8	21	0	2	23	0	0
2	16212924	.	A	G	8	17	25	0	1	26	0	0
2	16212957	.	A	G	9	22	31	0	2	33	0	0
2	16216365	.	T	C	3	0	3	0	5	8	0	0
2	16216524	.	A	T	17	8	25	0	3	28	0	0
2	16216830	.	G	T	12	11	23	0	0	23	0	0
2	16221213	.	T	C	12	0	12	0	11	23	0	0
2	16254439	.	T	G	13	9	22	0	1	23	0	0
2	16254659	.	C	T	1	7	8	0	5	13	0	0
2	16257133	.	G	A	1	2	3	0	1	4	0	0
2	16257135	.	G	A	1	2	3	0	1	4	0	0
2	16268954	.	C	T	1	2	3	0	2	5	0	0
2	16269276	.	G	A	2	2	4	0	0	4	0	0
2	16269335	.	G	A	5	2	7	0	0	7	0	0
2	16269626	.	C	T	5	5	10	0	0	10	0	0
2	16269649	.	C	G	4	4	8	0	0	8	0	0
2	16269822	.	C	T	1	2	3	0	0	3	0	0
2	16269932	.	T	G	1	2	3	0	0	3	0	0
2	16270102	.	C	T	0	2	2	0	1	3	0	0
2	16270109	.	C	T	1	2	3	0	1	4	0	0
2	16270146	.	A	C	1	2	3	0	0	3	0	0
2	16270185	.	C	T	1	2	3	0	0	3	0	0
2	16271210	.	C	A	3	3	6	0	0	6	0	0
2	16271290	.	A	T	4	3	7	0	0	7	0	0
2	16273207	.	C	T	2	2	4	0	0	4	0	0
2	16273220	.	G	T	2	3	5	0	0	5	0	0
2	16358724	.	T	G	2	2	4	0	0	4	0	0
2	16375976	.	A	G	1	6	7	0	0	7	0	0
2	16376416	.	G	C	4	5	9	0	0	9	0	0
2	16376687	.	C	T	0	12	12	0	5	17	0	0
2	16376947	.	G	A	8	7	15	1	0	16	0	0
2	16377047	.	T	G	5	6	11	0	0	11	0	0
2	16377474	.	A	G	7	5	12	0	1	13	0	0
2	16378027	.	T	C	7	5	12	0	0	12	0	0
2	16378067	.	A	G	6	3	9	0	0	9	0	0
2	16378123	.	T	C	4	0	4	0	8	12	0	0
2	16378171	.	G	A	3	4	7	0	0	7	0	0
2	16378195	.	T	G	4	4	8	0	0	9	1	0
2	16378255	.	G	A	4	9	13	0	0	13	0	0
2	16378263	.	A	G	3	9	12	0	0	12	0	0
2	16378355	.	A	G	4	3	7	0	0	7	0	0
2	16378395	.	A	T	2	2	4	0	0	4	0	0
2	16378514	.	A	G	2	2	4	0	0	4	0	0
2	16378601	.	G	T	3	2	5	0	0	5	0	0
2	16378606	.	C	G	2	3	5	0	0	5	0	0
2	16393337	.	T	C	2	4	6	0	0	6	0	0
2	16393564	.	G	A	4	3	7	0	0	7	0	0
2	16397538	.	A	G	1	2	3	0	0	3	0	0
2	16400833	.	G	A	4	3	7	0	0	7	0	0
2	16413785	.	T	A	1	2	3	0	0	3	0	0
2	16414037	.	C	T	1	2	3	0	0	3	0	0
2	16415498	.	C	G	2	2	4	0	0	4	0	0
2	16435988	.	A	C	0	1	1	0	3	4	0	0
2	16449687	.	A	T	3	3	6	0	0	6	0	0
2	16449721	.	G	A	4	4	8	0	0	8	0	0
2	16479015	.	A	G	17	14	31	0	0	31	0	0
2	16547866	.	T	C	11	11	22	0	0	22	0	0
2	16548236	.	T	G	10	9	19	0	1	20	0	0
2	16548514	.	T	C	15	10	25	0	0	25	0	0
2	16565384	.	T	G	10	12	22	0	0	22	0	0
2	16565424	.	T	C	15	19	34	0	0	34	0	0
2	16585804	.	T	C	1	3	4	0	0	4	0	0
2	16585907	.	C	T	1	2	3	0	0	3	0	0
2	16585913	.	A	G	1	0	1	0	2	3	0	0
2	16588716	.	A	G	1	2	3	0	0	3	0	0
2	16588727	.	T	A	1	2	3	0	0	3	0	0
2	16589703	.	T	G	1	4	5	0	0	5	0	0
2	16594482	.	A	G	1	5	6	0	0	6	0	0
2	16594765	.	A	G	1	2	3	0	0	3	0	0
2	16597081	.	T	A	5	2	7	0	1	8	0	0
2	16607216	.	T	A	2	6	8	0	0	8	0	0
2	16614798	.	C	T	2	2	4	0	1	5	0	0
2	16614840	.	C	T	3	3	6	0	0	6	0	0
2	16617920	.	T	C	4	2	6	0	1	7	0	0
2	16618156	.	A	G	2	9	11	0	0	11	0	0
2	16623248	.	G	A	4	5	9	0	0	9	0	0
2	16625731	.	A	G	2	0	2	0	4	6	0	0
2	16631570	.	C	T	4	3	7	0	0	7	0	0
2	16632334	.	C	T	4	3	7	0	0	7	0	0
2	16632788	.	T	C	2	7	9	0	0	9	0	0
2	16637276	.	G	A	6	7	13	0	1	14	0	0
2	16637277	.	A	T	7	6	13	0	1	14	0	0
2	16638432	.	C	G	3	7	10	1	0	11	0	0
2	16639434	.	G	A	6	2	8	0	0	8	0	0
2	16639435	.	C	G	6	1	7	0	1	8	0	0
2	16639664	.	T	A	6	6	12	0	1	13	0	0
2	16639827	.	G	T	5	2	7	0	0	7	0	0
2	16642963	.	T	C	5	4	9	0	0	9	0	0
2	16643054	.	C	T	5	5	10	0	0	10	0	0
2	16643718	.	T	C	3	5	8	0	1	9	0	0
2	16646377	.	T	A	3	5	8	0	0	8	0	0
2	16646475	.	T	C	9	6	15	0	1	16	0	0
2	16646519	.	A	T	4	5	9	0	0	9	0	0
2	16646593	.	T	C	4	6	10	1	1	12	0	0
2	16646684	.	A	G	3	4	7	0	0	7	0	0
2	16646693	.	T	C	1	3	4	0	0	4	0	0
2	16647126	.	A	T	1	2	3	0	0	3	0	0
2	16693471	.	T	C	1	2	3	0	0	3	0	0
2	16702630	.	T	C	9	19	28	0	1	29	0	0
2	16706898	.	T	A	24	15	39	0	2	41	0	0
2	16706994	.	T	C	15	14	29	0	2	31	0	0
2	16707014	.	C	A	18	9	27	0	2	29	0	0
2	16707030	.	G	T	22	13	35	0	0	35	0	0
2	16707056	.	C	G	21	12	33	0	2	35	0	0
2	16707209	.	A	G	8	0	8	0	10	18	0	0
2	16707211	.	T	G	10	9	19	0	1	20	0	0
2	16707290	.	G	T	10	7	17	0	0	17	0	0
2	16707329	.	A	C	14	9	23	0	0	23	0	0
2	16707371	.	C	T	12	11	23	0	0	23	0	0
2	16707374	.	C	A	13	11	24	0	0	25	1	0
2	16707509	.	C	A	12	19	31	0	1	32	0	0
2	16707582	.	T	A	11	11	22	0	1	23	0	0
2	16707631	.	C	G	8	9	17	0	1	18	0	0
2	16707718	.	G	A	4	3	7	0	0	7	0	0
2	16723925	.	C	G	5	7	12	0	0	12	0	0
2	16728507	.	T	C	7	6	13	0	1	14	0	0
2	16731783	.	C	T	8	4	12	0	0	12	0	0
2	16734657	.	A	G	6	3	9	0	0	9	0	0
2	16735052	.	G	T	12	6	18	0	0	18	0	0
2	16735160	.	G	A	14	7	21	0	0	21	0	0
2	16735292	.	C	A	10	4	14	0	1	15	0	0
2	16736612	.	C	T	12	10	22	0	0	22	0	0
2	16736678	.	T	C	14	9	23	0	1	24	0	0
2	16736941	.	T	A	6	6	12	0	0	12	0	0
2	16736964	.	T	C	5	5	10	0	0	10	0	0
2	16737086	.	C	T	14	3	17	0	1	18	0	0
2	17728132	.	G	A	7	6	13	0	0	13	0	0
2	17946951	.	T	C	6	0	6	0	6	12	0	0
2	17947129	.	A	G	8	10	18	0	1	19	0	0
2	18698517	.	C	A	19	11	30	0	0	30	0	0
2	18698560	.	T	A	14	17	31	0	2	33	0	0
2	18698648	.	G	A	9	8	17	0	3	20	0	0
2	18698659	.	G	T	11	7	18	0	0	18	0	0
2	18698686	.	C	T	9	7	16	0	0	16	0	0
2	18698912	.	C	G	17	14	31	0	2	33	0	0
2	18698920	.	G	A	17	14	31	0	1	32	0	0
2	18698957	.	A	T	22	15	37	0	1	38	0	0
2	18699071	.	G	A	17	16	33	0	2	35	0	0
2	18699192	.	C	T	11	7	18	0	0	18	0	0
2	18699315	.	C	G	15	14	29	0	1	31	1	0
2	18699474	.	G	T	23	17	40	0	1	41	0	0
2	18699533	.	T	A	14	21	35	0	0	35	0	0
2	18699586	.	G	T	13	16	29	0	0	29	0	0
2	18699590	.	G	T	10	18	28	0	0	28	0	0
2	18700102	.	T	A	14	8	22	0	4	26	0	0
2	18700148	.	G	A	12	9	21	2	2	25	0	0
2	18700194	.	T	A	14	12	26	0	0	26	0	0
2	18700346	.	A	T	7	9	16	0	0	16	0	0
2	18700484	.	C	T	3	3	6	0	0	6	0	0
2	18700489	.	A	G	3	3	6	0	0	6	0	0
2	18700662	.	A	T	4	2	6	0	1	7	0	0
2	18700690	.	A	G	8	6	14	0	0	14	0	0
2	18700750	.	G	A	7	11	18	0	0	18	0	0
2	18700753	.	G	A	7	12	19	0	0	19	0	0
2	18701033	.	G	A	11	13	24	0	1	25	0	0
2	18701228	.	A	G	8	8	16	0	0	16	0	0
2	18701232	.	T	C	9	8	17	0	0	17	0	0
2	18701437	.	A	G	11	10	21	0	1	22	0	0
2	18701576	.	T	C	3	7	10	0	0	10	0	0
2	18701779	.	T	C	10	7	17	0	1	18	0	0
2	18701827	.	A	C	14	14	28	0	1	29	0	0
2	18701924	.	A	T	10	5	15	0	0	15	0	0
2	18701982	.	T	A	13	10	23	0	0	23	0	0
2	18702029	.	C	T	8	9	17	0	0	17	0	0
2	18702199	.	A	T	9	10	19	0	0	19	0	0
2	18702222	.	G	T	8	13	21	0	0	21	0	0
2	18702359	.	G	T	4	4	8	1	0	9	0	0
2	18702657	.	G	T	16	12	28	0	0	28	0	0
2	18702710	.	T	C	15	0	15	0	16	31	0	0
2	18702716	.	A	C	10	15	25	0	3	28	0	0
2	18702772	.	G	A	6	13	19	0	0	19	0	0
2	18702825	.	T	G	5	13	18	0	0	18	0	0
2	18702861	.	C	A	7	7	14	0	0	14	0	0
2	18702862	.	A	G	7	7	14	0	0	14	0	0
2	18703265	.	T	A	9	9	18	0	0	18	0	0
2	18703273	.	A	G	9	9	18	0	1	19	0	0
2	18703344	.	A	T	16	11	27	0	1	28	0	0
2	18703345	.	T	G	17	11	28	0	0	28	0	0
2	18714519	.	A	G	16	14	30	1	1	32	0	0
2	18725918	.	G	A	18	14	32	0	3	35	0	0
2	18727920	.	T	G	18	12	30	0	0	30	0	0
2	18735032	.	A	G	18	9	27	0	1	28	0	0
2	18735038	.	A	G	18	9	27	0	0	27	0	0
2	18830386	.	A	G	10	13	23	0	1	24	0	0
2	18830493	.	G	A	8	13	21	0	1	22	0	0
2	18830645	.	T	A	19	4	23	0	0	23	0	0
2	18830646	.	G	A	19	4	23	0	0	23	0	0
2	18990241	.	G	C	30	28	58	0	4	62	0	0
2	18991317	.	T	C	36	36	72	0	5	77	0	0
2	18991362	.	T	C	36	31	67	0	1	68	0	0
2	18992144	.	G	C	25	17	42	0	2	44	0	0
2	19100786	.	A	T	9	9	18	0	0	18	0	0
2	19100788	.	A	T	9	9	18	0	0	18	0	0
2	19101393	.	A	T	4	5	9	0	1	10	0	0
2	19101485	.	T	G	3	3	6	0	0	6	0	0
2	19101732	.	C	G	7	10	17	0	1	18	0	0
2	19101950	.	A	G	7	8	15	0	0	15	0	0
2	19102757	.	T	A	10	5	15	0	0	15	0	0
2	19102996	.	T	A	2	3	5	0	0	5	0	0
2	19103424	.	C	A	6	6	12	0	0	12	0	0
2	19104850	.	G	A	15	9	24	0	0	24	0	0
2	19109272	.	G	T	8	6	14	0	1	15	0	0
2	19109300	.	T	A	5	9	14	0	1	15	0	0
2	19214616	.	C	T	1	5	6	0	0	6	0	0
2	19214770	.	C	G	2	0	2	0	4	6	0	0
2	19214771	.	C	A	2	3	5	0	0	5	0	0
2	19242878	.	C	T	1	2	3	0	0	3	0	0
2	19274432	.	C	T	1	2	3	0	0	3	0	0
2	19274433	.	G	A	0	1	1	0	2	3	0	0
2	19280915	.	A	T	2	7	9	0	0	9	0	0
2	19281432	.	T	A	4	2	6	0	0	6	0	0
2	19308439	.	G	C	10	5	15	0	0	15	0	0
2	19318112	.	C	A	7	3	10	0	1	11	0	0
2	19318307	.	T	C	5	2	7	0	0	7	0	0
2	19318459	.	T	C	3	8	11	0	0	11	0	0
2	19643198	.	A	G	3	5	8	0	1	9	0	0
2	19645797	.	T	A	3	3	6	0	0	6	0	0
2	19784751	.	C	T	11	9	20	0	1	21	0	0
2	19794484	.	C	T	14	8	22	0	4	26	0	0
2	19794753	.	A	G	5	12	17	0	0	17	0	0
2	19794847	.	T	G	15	1	16	0	11	27	0	0
2	19794937	.	C	T	11	7	18	0	0	18	0	0
2	19795249	.	C	T	10	7	17	0	0	17	0	0
2	19795301	.	A	G	10	7	17	0	0	17	0	0
2	19795333	.	G	C	9	12	21	0	0	21	0	0
2	19795344	.	G	A	2	10	12	0	12	24	0	0
2	19795400	.	A	G	9	12	21	0	0	21	0	0
2	20323825	.	A	G	4	2	6	0	1	7	0	0
2	20323830	.	A	T	6	2	8	0	0	8	0	0
2	20331937	.	C	A	13	6	19	0	0	19	0	0
2	20332061	.	T	A	11	4	15	0	1	16	0	0
2	20332135	.	A	G	8	5	13	0	0	13	0	0
2	20367927	.	G	T	15	14	29	0	0	29	0	0
2	20368101	.	T	C	13	14	27	0	1	28	0	0
2	20368173	.	T	C	7	18	25	0	1	26	0	0
2	20368320	.	G	A	7	14	21	0	2	23	0	0
2	20368383	.	A	G	6	1	7	0	11	18	0	0
2	20368537	.	A	C	19	11	30	0	0	31	1	0
2	20368569	.	A	C	21	16	37	0	2	39	0	0
2	20368812	.	G	A	18	25	43	0	1	44	0	0
2	20368965	.	C	T	28	16	44	0	2	46	0	0
2	20369162	.	A	C	14	16	30	0	2	32	0	0
2	20369240	.	T	G	11	18	29	0	0	29	0	0
2	20369516	.	A	G	17	15	32	0	2	34	0	0
2	20369836	.	A	T	15	26	41	0	1	42	0	0
2	20369925	.	T	A	20	20	40	0	0	40	0	0
2	20369947	.	A	C	11	11	22	1	8	31	0	0
2	20370090	.	G	C	21	16	37	0	0	37	0	0
2	20370143	.	C	T	19	14	33	0	2	35	0	0
2	20370792	.	T	C	18	22	40	0	2	42	0	0
2	20370893	.	C	T	20	10	30	0	3	33	0	0
2	20370998	.	A	G	14	14	28	0	3	31	0	0
2	20371060	.	T	A	17	7	24	0	1	25	0	0
2	20371210	.	G	C	7	3	10	0	0	10	0	0
2	20437703	.	C	A	13	8	21	0	1	22	0	0
2	20437826	.	G	A	1	7	8	0	17	25	0	0
2	20437834	.	C	T	15	7	22	0	2	24	0	0
2	20437878	.	G	A	16	5	21	0	1	22	0	0
2	20437901	.	G	T	17	5	22	0	1	23	0	0
2	20437916	.	G	T	15	7	22	0	1	23	0	0
2	20438061	.	A	T	14	21	35	0	1	36	0	0
2	20438110	.	C	A	12	16	28	0	1	30	1	0
2	20438167	.	G	A	0	13	13	0	15	28	0	0
2	20438219	.	G	A	14	13	27	0	1	28	0	0
2	20438373	.	A	G	15	12	27	0	0	27	0	0
2	20438443	.	G	A	17	12	29	0	1	30	0	0
2	20438589	.	C	T	12	13	25	0	0	25	0	0
2	20438876	.	A	C	13	15	28	0	0	28	0	0
2	20439089	.	T	C	22	16	38	0	3	41	0	0
2	20439303	.	C	T	11	14	25	0	3	28	0	0
2	20439490	.	A	G	17	20	37	0	0	37	0	0
2	20440244	.	G	A	14	18	32	0	0	32	0	0
2	20440307	.	A	C	10	13	23	0	3	26	0	0
2	20440328	.	C	A	17	13	30	0	0	30	0	0
2	20442735	.	G	A	20	14	34	0	1	35	0	0
2	20442939	.	A	G	3	1	4	0	2	6	0	0
2	20475831	.	A	G	10	6	16	0	0	16	0	0
2	20487136	.	A	C	5	3	8	0	1	9	0	0
2	20487211	.	C	T	12	9	21	0	0	21	0	0
2	20487347	.	C	A	9	15	24	0	0	24	0	0
2	20496574	.	T	C	7	5	12	0	0	12	0	0
2	20496616	.	T	A	11	8	19	0	0	19	0	0
2	20503698	.	C	A	10	16	26	0	0	26	0	0
2	20503734	.	T	G	14	0	14	0	11	25	0	0
2	20503770	.	C	T	10	15	25	0	0	25	0	0
2	20505995	.	C	T	7	18	25	0	1	26	0	0
2	20506067	.	G	A	6	10	16	0	0	16	0	0
2	20506439	.	T	C	5	9	14	0	1	15	0	0
2	20509561	.	A	G	11	24	35	0	2	37	0	0
2	20509603	.	A	T	9	17	26	0	3	29	0	0
2	20511713	.	C	A	4	17	21	0	2	23	0	0
2	20511725	.	T	C	7	18	25	0	1	26	0	0
2	20511770	.	C	T	9	16	25	0	0	25	0	0
2	20514915	.	A	G	7	19	26	0	1	27	0	0
2	20515377	.	C	T	6	5	11	0	0	11	0	0
2	20516291	.	G	A	8	5	13	0	1	14	0	0
2	20518033	.	A	G	15	18	33	0	1	34	0	0
2	20518057	.	C	G	11	15	26	0	1	27	0	0
2	20518081	.	T	C	11	23	34	0	0	34	0	0
2	20518093	.	C	T	13	18	31	0	2	33	0	0
2	20520618	.	T	C	14	14	28	0	0	28	0	0
2	20520636	.	T	C	10	16	26	0	1	27	0	0
2	20611186	.	G	A	1	4	5	0	0	5	0	0
2	20611845	.	C	T	1	3	4	0	0	4	0	0
2	20611859	.	T	C	1	3	4	0	0	4	0	0
2	20611985	.	G	C	1	1	2	0	1	3	0	0
2	20611998	.	G	C	1	2	3	0	0	3	0	0
2	20612043	.	A	G	2	0	2	0	3	5	0	0
2	20612045	.	C	T	2	3	5	0	0	5	0	0
2	20612198	.	T	C	2	3	5	0	0	5	0	0
2	20614502	.	C	T	4	2	6	0	0	6	0	0
2	20614879	.	T	C	2	3	5	0	0	5	0	0
2	20662405	.	C	G	3	4	7	0	0	7	0	0
2	20769322	.	T	C	2	3	5	0	0	5	0	0
2	20769343	.	T	C	1	3	4	0	0	4	0	0
2	20811104	.	G	A	2	2	4	0	0	4	0	0
2	20811728	.	A	T	4	4	8	0	0	8	0	0
2	20811739	.	A	G	3	4	7	0	0	7	0	0
2	20811792	.	A	C	1	3	4	0	1	5	0	0
2	20814225	.	A	T	15	8	23	0	0	23	0	0
2	20814754	.	G	T	10	8	18	0	0	18	0	0
2	20817736	.	G	A	13	9	22	0	1	23	0	0
2	20818087	.	T	A	10	6	16	0	2	18	0	0
2	20819762	.	G	T	16	7	23	0	9	32	0	0
2	20820587	.	C	T	20	15	35	0	0	35	0	0
2	20822890	.	G	A	15	4	19	0	0	19	0	0
2	20824654	.	T	C	9	1	10	0	12	22	0	0
2	20826495	.	T	C	10	7	17	0	1	18	0	0
2	20828322	.	A	G	14	12	26	0	0	26	0	0
2	20830336	.	A	G	10	7	17	0	1	18	0	0
2	20830342	.	C	T	12	7	19	0	0	19	0	0
2	20830405	.	A	G	3	22	25	0	0	25	0	0
2	20830993	.	C	G	11	6	17	0	0	17	0	0
2	20833345	.	G	A	5	8	13	0	0	13	0	0
2	20833432	.	A	C	6	0	6	0	6	12	0	0
2	20833914	.	C	T	5	5	10	0	0	10	0	0
2	20833917	.	A	C	6	4	10	0	0	10	0	0
2	20837017	.	G	A	4	6	10	0	1	11	0	0
2	20840328	.	T	C	9	7	16	0	0	16	0	0
2	20840539	.	C	A	8	9	17	0	0	17	0	0
2	20840596	.	C	T	9	6	15	0	0	15	0	0
2	20840783	.	C	T	5	3	8	0	0	8	0	0
2	20840837	.	T	C	5	0	5	0	6	11	0	0
2	20843816	.	A	G	9	10	19	0	0	19	0	0
2	20844349	.	T	C	10	6	16	0	0	16	0	0
2	20863247	.	A	G	2	6	8	0	1	9	0	0
2	20866605	.	A	T	4	5	9	0	1	10	0	0
2	20870961	.	T	C	4	3	7	0	0	7	0	0
2	20871012	.	G	A	1	6	7	0	3	10	0	0
2	20871630	.	T	A	3	4	7	0	0	7	0	0
2	20874515	.	T	C	1	5	6	0	0	6	0	0
2	20875064	.	C	T	3	2	5	0	1	6	0	0
2	20875112	.	G	A	0	4	4	0	4	8	0	0
2	20875166	.	C	T	2	8	10	0	0	10	0	0
2	20875175	.	A	G	1	8	9	0	0	9	0	0
2	20875922	.	T	A	4	5	9	0	0	9	0	0
2	20971423	.	T	C	4	5	9	0	0	9	0	0
2	20971441	.	T	C	3	5	8	0	1	9	0	0
2	20973176	.	C	T	3	8	11	0	1	12	0	0
2	20973369	.	G	A	4	2	6	0	1	7	0	0
2	20973698	.	A	G	5	3	8	1	1	10	0	0
2	20973864	.	G	A	1	3	4	0	8	12	0	0
2	20974085	.	G	A	10	4	14	0	1	15	0	0
2	20974232	.	G	T	6	3	9	0	0	9	0	0
2	20974244	.	A	T	4	3	7	0	1	8	0	0
2	20974837	.	T	G	6	0	6	0	5	11	0	0
2	20974867	.	G	A	5	5	10	0	1	11	0	0
2	20974880	.	T	C	6	6	12	0	0	12	0	0
2	20975009	.	C	A	5	3	8	0	0	8	0	0
2	20975010	.	T	C	5	3	8	0	0	8	0	0
2	20975075	.	A	T	3	4	7	0	0	7	0	0
2	20975451	.	T	C	6	3	9	0	0	9	0	0
2	20980280	.	C	G	6	6	12	0	0	12	0	0
2	21063794	.	T	A	3	4	7	0	0	7	0	0
2	21064752	.	T	C	13	6	19	0	0	19	0	0
2	21064754	.	T	C	13	6	19	0	0	19	0	0
2	21064800	.	T	A	7	2	9	0	0	9	0	0
2	21067812	.	C	T	7	3	10	0	1	11	0	0
2	21067984	.	G	T	7	5	12	0	0	12	0	0
2	21068339	.	A	T	6	4	10	0	0	10	0	0
2	21071401	.	T	A	5	2	7	0	1	8	0	0
2	21071957	.	G	A	3	6	9	0	0	9	0	0
2	21073286	.	T	A	5	6	11	0	1	12	0	0
2	21073350	.	A	C	7	11	18	0	0	18	0	0
2	21076203	.	C	T	10	11	21	0	3	24	0	0
2	21076342	.	T	C	15	9	24	0	3	27	0	0
2	21076763	.	G	A	8	4	12	0	0	12	0	0
2	21076774	.	C	T	9	4	13	0	0	13	0	0
2	21076805	.	C	A	13	4	17	0	0	17	0	0
2	21077191	.	A	C	13	0	13	0	18	31	0	0
2	21077208	.	C	G	10	17	27	0	1	28	0	0
2	21077390	.	G	A	8	15	23	0	1	24	0	0
2	21077726	.	C	T	7	6	13	0	0	13	0	0
2	21077967	.	G	A	21	21	42	0	1	43	0	0
2	21079612	.	T	C	20	24	44	0	2	46	0	0
2	21080291	.	G	A	25	18	43	0	2	45	0	0
2	21081087	.	T	A	19	18	37	0	1	38	0	0
2	21082460	.	C	A	23	19	42	0	1	43	0	0
2	21082585	.	C	G	4	6	10	0	0	10	0	0
2	21082596	.	C	A	5	4	9	0	1	10	0	0
2	21135461	.	T	C	19	16	35	0	1	36	0	0
2	21138516	.	A	G	13	17	30	0	0	30	0	0
2	21151002	.	T	C	21	13	34	0	0	34	0	0
2	21156207	.	T	C	9	6	15	0	0	15	0	0
2	21156350	.	G	A	10	8	18	0	0	18	0	0
2	21156578	.	A	T	2	5	7	0	0	7	0	0
2	21156613	.	T	A	5	5	10	0	0	10	0	0
2	21156809	.	T	A	14	9	23	0	4	27	0	0
2	21165176	.	G	A	15	6	21	0	0	21	0	0
2	21165495	.	C	G	0	7	7	0	9	16	0	0
2	21166042	.	A	G	16	15	31	0	0	31	0	0
2	21166252	.	A	G	16	10	26	0	0	26	0	0
2	21167395	.	G	A	8	5	13	0	0	13	0	0
2	21170190	.	C	T	0	5	5	0	8	13	0	0
2	21175143	.	A	G	14	0	14	0	11	25	0	0
2	21177237	.	G	A	15	5	20	0	0	20	0	0
2	21179467	.	C	T	6	11	17	0	1	18	0	0
2	21179651	.	A	G	11	12	23	0	2	25	0	0
2	21179866	.	T	G	10	8	18	0	1	19	0	0
2	21179939	.	A	G	17	20	37	0	0	37	0	0
2	21186260	.	G	A	2	2	4	0	0	4	0	0
2	21312257	.	T	C	4	5	9	0	0	9	0	0
2	21312482	.	A	G	2	5	7	0	0	7	0	0
2	21312866	.	G	A	0	7	7	0	1	8	0	0
2	21312877	.	C	A	1	6	7	0	1	8	0	0
2	21317042	.	C	T	6	7	13	0	3	16	0	0
2	21320445	.	T	C	2	9	11	0	0	11	0	0
2	21320537	.	C	T	3	4	7	0	0	7	0	0
2	21320759	.	T	A	5	5	10	0	0	10	0	0
2	21320837	.	A	G	3	5	8	0	0	8	0	0
2	21321015	.	A	G	2	4	6	0	0	6	0	0
2	21321731	.	A	G	1	2	3	0	0	3	0	0
2	21335154	.	C	A	1	2	3	0	0	3	0	0
2	21338276	.	T	C	8	3	11	0	0	11	0	0
2	21340519	.	C	T	8	4	12	0	1	13	0	0
2	21346486	.	T	A	1	2	3	0	0	3	0	0
2	21351972	.	A	G	4	6	10	1	0	11	0	0
2	21371159	.	G	A	8	5	13	0	0	13	0	0
2	21376407	.	C	T	8	9	17	0	1	18	0	0
2	21381230	.	C	T	16	12	28	0	1	29	0	0
2	21459157	.	T	C	11	17	28	0	0	28	0	0
2	21459196	.	C	T	14	9	23	0	0	23	0	0
2	21459701	.	C	A	3	5	8	0	1	9	0	0
2	21463923	.	A	T	13	15	28	0	1	29	0	0
2	21466555	.	T	C	18	16	34	0	1	35	0	0
2	21466567	.	A	T	20	16	36	0	0	36	0	0
2	21468732	.	T	G	16	16	32	0	2	34	0	0
2	21468825	.	G	A	20	21	41	0	1	42	0	0
2	21468953	.	C	T	12	13	25	0	0	25	0	0
2	21469080	.	T	G	8	8	16	0	0	16	0	0
2	21469490	.	T	C	9	7	16	0	0	16	0	0
2	21469577	.	A	G	11	9	20	0	0	20	0	0
2	21469579	.	T	G	9	9	18	0	0	18	0	0
2	21469644	.	A	G	10	8	18	0	1	19	0	0
2	21487190	.	G	A	2	4	6	0	0	6	0	0
2	21487308	.	T	C	4	4	8	0	0	8	0	0
2	21501967	.	C	G	3	3	6	0	0	6	0	0
2	21502364	.	C	T	3	5	8	0	0	8	0	0
2	21503460	.	G	A	2	6	8	0	1	9	0	0
2	21503511	.	T	C	4	2	6	0	1	7	0	0
2	21607456	.	G	C	3	4	7	0	0	7	0	0
2	21608427	.	C	G	1	2	3	0	0	3	0	0
2	21608582	.	G	A	17	7	24	0	0	24	0	0
2	21608587	.	C	T	17	8	25	0	2	27	0	0
2	21609016	.	A	T	10	8	18	0	0	18	0	0
2	21609223	.	C	T	0	2	2	0	2	4	0	0
2	21609443	.	C	A	9	7	16	0	0	16	0	0
2	21609446	.	C	T	9	6	15	0	0	15	0	0
2	21609718	.	C	T	3	2	5	0	0	5	0	0
2	21609872	.	T	A	5	2	7	0	0	7	0	0
2	21612356	.	T	G	6	12	18	0	0	18	0	0
2	21612380	.	C	T	1	13	14	0	7	21	0	0
2	21618394	.	G	C	1	3	4	0	0	4	0	0
2	21621762	.	T	C	4	6	10	0	2	12	0	0
2	21625423	.	T	G	4	4	8	0	0	8	0	0
2	21715416	.	C	G	3	0	3	0	3	6	0	0
2	21733971	.	A	G	1	4	5	0	0	5	0	0
2	21766237	.	G	A	5	9	14	0	1	15	0	0
2	21766277	.	G	A	7	7	14	0	2	16	0	0
2	21766319	.	G	A	8	8	16	0	2	18	0	0
2	21766323	.	A	G	10	8	18	0	1	19	0	0
2	21766478	.	T	A	8	6	14	0	1	16	1	0
2	21766554	.	G	A	4	3	7	0	0	7	0	0
2	21767207	.	C	T	6	14	20	0	1	21	0	0
2	21768168	.	G	A	8	5	13	0	1	14	0	0
2	21768392	.	A	C	6	7	13	0	0	13	0	0
2	21769386	.	T	A	1	3	4	0	0	4	0	0
2	21769928	.	A	G	5	12	17	0	1	18	0	0
2	21769947	.	A	G	5	13	18	0	0	18	0	0
2	21770775	.	G	A	5	9	14	0	1	15	0	0
2	21770888	.	T	C	6	6	12	0	0	12	0	0
2	21771091	.	G	T	8	6	14	0	1	15	0	0
2	21771191	.	G	T	5	7	12	0	0	12	0	0
2	21772082	.	G	A	6	4	10	0	1	11	0	0
2	21774400	.	G	A	5	7	12	0	0	12	0	0
2	21777101	.	C	A	3	2	5	0	0	5	0	0
2	21777102	.	A	G	3	2	5	0	0	5	0	0
2	21780896	.	C	T	8	3	11	0	0	11	0	0
2	21784167	.	G	A	5	5	10	0	0	10	0	0
2	21807190	.	T	C	3	0	3	0	2	5	0	0
2	21807194	.	A	G	2	4	6	0	0	6	0	0
2	21807229	.	C	T	4	2	6	0	0	6	0	0
2	21807265	.	T	G	5	4	9	0	0	9	0	0
2	21807295	.	C	T	3	4	7	0	0	7	0	0
2	21807373	.	G	A	4	5	9	0	1	10	0	0
2	21821936	.	A	G	24	19	43	0	4	47	0	0
2	21822288	.	C	A	26	24	50	0	3	53	0	0
2	21822816	.	T	A	25	21	46	1	0	47	0	0
2	21823100	.	C	A	35	24	59	0	3	62	0	0
2	21855248	.	C	G	13	11	24	0	1	25	0	0
2	21865620	.	G	C	23	19	42	0	1	44	1	0
2	21869023	.	T	C	18	17	35	0	1	36	0	0
2	21877560	.	G	A	12	10	22	0	2	24	0	0
2	21877711	.	C	G	11	7	18	0	1	19	0	0
2	21877743	.	T	G	8	11	19	0	1	20	0	0
2	21877769	.	A	T	9	10	19	0	1	20	0	0
2	21877795	.	T	C	7	6	13	0	1	14	0	0
2	21877931	.	T	A	6	13	19	0	0	19	0	0
2	21878036	.	G	C	15	13	28	0	1	29	0	0
2	21878258	.	A	T	19	22	41	0	2	43	0	0
2	21878415	.	C	T	16	13	29	0	2	31	0	0
2	21983059	.	C	T	7	17	24	0	1	25	0	0
2	22058254	.	G	A	14	15	29	0	0	29	0	0
2	22058281	.	C	T	12	14	26	0	1	27	0	0
2	22071062	.	A	C	17	19	36	0	0	37	1	0
2	22073020	.	A	G	26	17	43	0	0	43	0	0
2	22073176	.	C	T	22	19	41	0	2	43	0	0
2	22093084	.	A	G	22	1	23	0	15	38	0	0
2	22104309	.	C	G	18	11	29	3	0	32	0	0
2	22104415	.	C	A	22	13	35	0	1	36	0	0
2	22104506	.	T	C	8	14	22	0	0	22	0	0
2	22104912	.	T	C	12	15	27	0	0	27	0	0
2	22208560	.	G	A	6	6	12	0	1	13	0	0
2	22208767	.	G	A	13	5	18	0	1	19	0	0
2	22208776	.	A	G	13	8	21	0	1	22	0	0
2	22209045	.	C	A	18	8	26	0	1	27	0	0
2	22209743	.	A	G	14	12	26	0	1	27	0	0
2	22209920	.	C	T	9	13	22	0	0	22	0	0
2	22210137	.	T	C	10	0	10	0	14	24	0	0
2	22210412	.	G	A	12	15	27	0	2	29	0	0
2	22286813	.	T	A	4	7	11	0	1	13	1	0
2	22353522	.	T	C	18	1	19	0	14	33	0	0
2	22353568	.	T	C	18	12	30	0	2	32	0	0
2	22353661	.	T	A	12	10	22	0	0	22	0	0
2	22353662	.	A	C	12	10	22	0	1	23	0	0
2	22353993	.	T	C	15	16	31	0	1	32	0	0
2	22362290	.	G	A	18	16	34	0	0	34	0	0
2	22362302	.	G	A	15	15	30	0	0	30	0	0
2	22362347	.	T	C	18	0	18	0	17	35	0	0
2	22363365	.	T	C	15	18	33	0	0	33	0	0
2	22363418	.	T	A	3	7	10	0	0	10	0	0
2	22364135	.	A	T	3	2	5	0	0	5	0	0
2	22388748	.	C	T	2	4	6	0	0	6	0	0
2	22396274	.	G	T	5	5	10	0	2	12	0	0
2	22396304	.	G	T	4	2	6	0	1	7	0	0
2	22396421	.	G	A	4	2	6	1	0	7	0	0
2	22396425	.	A	G	4	2	6	0	0	6	0	0
2	22397185	.	C	T	3	3	6	0	0	6	0	0
2	22483381	.	A	G	9	12	21	0	2	23	0	0
2	22486393	.	A	G	10	8	18	0	0	18	0	0
2	22507132	.	T	A	15	11	26	0	0	26	0	0
2	22513202	.	A	G	3	2	5	0	0	5	0	0
2	22516758	.	A	G	4	3	7	1	0	8	0	0
2	22517039	.	G	A	7	3	10	0	0	10	0	0
2	22521337	.	G	A	3	5	8	0	0	8	0	0
2	22521582	.	A	T	1	4	5	0	0	5	0	0
2	22521905	.	C	A	4	6	10	0	0	10	0	0
2	22522302	.	A	G	4	7	11	0	1	12	0	0
2	22522406	.	A	T	4	3	7	0	1	8	0	0
2	22522895	.	T	C	5	6	11	0	0	11	0	0
2	22523573	.	G	A	5	3	8	0	1	9	0	0
2	22566642	.	T	C	1	1	2	0	0	2	0	0
2	22602424	.	T	C	12	14	26	0	1	27	0	0
2	22602826	.	C	T	13	19	32	0	0	32	0	0
2	22607462	.	G	A	1	11	12	0	16	28	0	0
2	22608314	.	G	T	18	14	32	0	0	32	0	0
2	22612623	.	T	C	12	16	28	0	1	29	0	0
2	22614355	.	G	A	6	4	10	0	1	11	0	0
2	22614357	.	T	A	7	4	11	0	0	11	0	0
2	22614448	.	T	A	10	4	14	0	0	14	0	0
2	22614568	.	A	G	13	8	21	1	0	22	0	0
2	22614988	.	T	C	12	10	22	0	0	22	0	0
2	22615055	.	T	A	14	16	30	0	1	31	0	0
2	22615155	.	G	A	4	7	11	0	1	12	0	0
2	22627149	.	G	A	28	16	44	0	2	46	0	0
2	22628981	.	A	G	20	27	47	0	0	47	0	0
2	22634040	.	T	G	18	29	47	1	1	49	0	0
2	22653693	.	T	A	5	4	9	0	2	11	0	0
2	22656723	.	C	T	8	10	18	0	3	21	0	0
2	22656870	.	A	G	10	9	19	0	0	19	0	0
2	22659072	.	G	A	8	17	25	0	1	26	0	0
2	22702423	.	T	C	21	24	45	1	0	46	0	0
2	22702505	.	C	G	13	28	41	0	0	41	0	0
2	22707536	.	A	C	22	23	45	0	1	46	0	0
2	22710985	.	T	C	24	13	37	0	0	37	0	0
2	22714603	.	A	G	25	26	51	0	0	51	0	0
2	22714618	.	G	A	27	25	52	0	1	53	0	0
2	22717198	.	A	G	28	19	47	0	0	47	0	0
2	22721695	.	T	C	22	26	48	0	3	51	0	0
2	22721734	.	A	T	24	16	40	0	2	42	0	0
2	22731426	.	C	T	18	15	33	0	0	33	0	0
2	22731456	.	G	A	15	19	34	0	1	35	0	0
2	22733715	.	T	C	20	27	47	0	2	50	1	0
2	22733813	.	A	G	16	30	46	0	2	48	0	0
2	22735037	.	T	A	34	23	57	0	2	59	0	0
2	22735205	.	A	T	23	34	57	0	0	57	0	0
2	22735232	.	C	T	26	28	54	0	0	54	0	0
2	22742027	.	T	A	28	23	51	0	3	54	0	0
2	22742034	.	A	C	28	25	53	0	2	55	0	0
2	22742179	.	C	T	23	30	53	0	3	56	0	0
2	22747304	.	C	T	25	28	53	0	0	53	0	0
2	22749202	.	A	C	22	17	39	1	2	43	1	0
2	22749221	.	A	G	24	0	24	1	20	45	0	0
2	22750164	.	C	T	30	33	63	0	0	63	0	0
2	22750621	.	C	T	21	19	40	0	0	40	0	0
2	22750622	.	A	G	21	17	38	0	2	40	0	0
2	22756245	.	T	G	28	32	60	0	2	62	0	0
2	22756289	.	A	G	28	31	59	0	3	62	0	0
2	22791330	.	G	A	2	2	4	0	1	5	0	0
2	22802004	.	T	A	21	23	44	0	1	45	0	0
2	22802402	.	T	C	29	17	46	1	0	47	0	0
2	22802504	.	G	A	21	16	37	0	0	37	0	0
2	22803074	.	G	A	0	24	24	0	22	46	0	0
2	22803366	.	C	T	28	26	54	0	0	54	0	0
2	22858664	.	T	C	2	3	5	0	0	5	0	0
2	22860413	.	C	A	4	2	6	0	0	6	0	0
2	22860541	.	C	T	2	2	4	0	0	4	0	0
2	22860711	.	T	C	6	3	9	0	0	9	0	0
2	22932505	.	A	T	4	2	6	0	0	6	0	0
2	22932510	.	T	A	4	2	6	0	1	7	0	0
2	22932715	.	T	C	6	2	8	0	0	8	0	0
2	22932725	.	G	A	4	2	6	0	0	6	0	0
2	22932931	.	A	G	2	4	6	0	1	7	0	0
2	22933175	.	T	G	2	5	7	0	0	7	0	0
2	22933218	.	C	A	1	5	6	0	0	6	0	0
2	22933377	.	G	T	1	4	5	0	0	5	0	0
2	22933455	.	T	C	6	6	12	0	0	12	0	0
2	22935766	.	A	T	5	6	11	0	0	11	0	0
2	22944185	.	C	T	5	2	7	0	1	8	0	0
2	22953005	.	T	C	8	5	13	0	0	13	0	0
2	22959051	.	G	A	5	2	7	0	0	7	0	0
2	22959114	.	C	A	3	2	5	0	0	5	0	0
2	22959135	.	A	G	2	4	6	0	0	6	0	0
2	22959179	.	A	G	2	3	5	0	0	5	0	0
2	22962013	.	A	G	5	3	8	0	1	9	0	0
2	22962241	.	G	A	4	5	9	0	1	10	0	0
2	22965210	.	A	T	7	3	10	0	0	10	0	0
2	22970603	.	A	C	2	2	4	0	0	4	0	0
2	22986552	.	T	C	3	3	6	0	2	8	0	0
2	22986555	.	C	T	5	3	8	0	0	8	0	0
2	22993548	.	G	C	10	5	15	0	1	16	0	0
2	22994322	.	C	T	2	6	8	0	1	9	0	0
2	22994412	.	C	T	2	11	13	0	1	14	0	0
2	23003843	.	C	G	3	12	15	0	0	15	0	0
2	23006810	.	A	G	1	3	4	0	0	4	0	0
2	23007678	.	G	A	1	1	2	0	1	3	0	0
2	23007852	.	T	C	4	1	5	0	1	6	0	0
2	23008209	.	C	T	4	8	12	0	1	13	0	0
2	23022896	.	A	G	1	8	9	0	0	9	0	0
2	23023337	.	G	A	1	2	3	0	1	4	0	0
2	23023675	.	G	A	2	3	5	0	0	5	0	0
2	23024069	.	C	A	2	3	5	0	0	5	0	0
2	23048494	.	T	G	8	7	15	0	2	17	0	0
2	23061791	.	T	C	9	13	22	0	1	23	0	0
2	23066671	.	C	T	18	16	34	0	2	36	0	0
2	23073536	.	A	G	19	10	29	2	2	33	0	0
2	23077839	.	A	C	8	11	19	0	0	19	0	0
2	23078532	.	T	C	7	4	11	0	2	13	0	0
2	23081309	.	G	A	0	6	6	0	12	18	0	0
2	23082894	.	G	C	7	4	11	0	0	11	0	0
2	23083308	.	T	C	6	7	13	0	0	13	0	0
2	23085121	.	C	T	9	5	14	0	0	14	0	0
2	23085223	.	G	A	3	3	6	0	2	8	0	0
2	23088951	.	G	A	1	2	3	0	0	3	0	0
2	23098916	.	T	C	7	3	10	0	1	11	0	0
2	23165830	.	G	A	2	2	4	0	0	4	0	0
2	23165841	.	G	A	2	3	5	0	0	5	0	0
2	23227385	.	A	G	11	8	19	0	1	20	0	0
2	23232881	.	A	G	6	12	18	0	0	18	0	0
2	23232884	.	T	C	5	12	17	0	0	17	0	0
2	23245557	.	C	T	7	11	18	0	1	19	0	0
2	23254074	.	A	G	16	11	27	0	0	27	0	0
2	23254158	.	G	A	9	15	24	0	2	26	0	0
2	23274792	.	C	T	16	13	29	0	1	30	0	0
2	23292123	.	A	T	10	16	26	0	0	26	0	0
2	23292432	.	C	A	15	17	32	0	2	34	0	0
2	23292490	.	C	G	16	8	24	0	0	24	0	0
2	23292549	.	C	A	5	9	14	0	0	14	0	0
2	23292584	.	C	A	6	6	12	0	1	13	0	0
2	23292595	.	T	A	5	7	12	0	0	12	0	0
2	23292690	.	T	A	9	8	17	0	0	17	0	0
2	23293029	.	T	C	3	7	10	0	0	10	0	0
2	23293123	.	G	C	9	6	15	0	0	15	0	0
2	23293230	.	A	T	13	6	19	0	0	19	0	0
2	23293246	.	T	C	14	6	20	0	0	20	0	0
2	23293376	.	C	A	11	8	19	0	0	19	0	0
2	23352323	.	G	A	15	16	31	0	2	33	0	0
2	23361020	.	T	G	20	8	28	0	0	28	0	0
2	23361208	.	C	T	19	15	34	0	1	35	0	0
2	23361359	.	T	C	12	13	25	0	0	25	0	0
2	23361605	.	C	T	23	8	31	0	0	31	0	0
2	23379480	.	G	C	1	3	4	0	0	4	0	0
2	23379532	.	G	A	4	5	9	0	2	11	0	0
2	23379588	.	C	T	9	10	19	0	0	19	0	0
2	23379757	.	T	A	2	4	6	0	0	6	0	0
2	23379861	.	G	A	7	3	10	0	0	10	0	0
2	23380621	.	C	A	4	11	15	0	0	15	0	0
2	23381056	.	A	G	12	8	20	1	0	21	0	0
2	23387139	.	C	T	4	4	8	0	0	8	0	0
2	23618849	.	T	A	3	2	5	0	0	5	0	0
2	23620131	.	G	A	0	3	3	0	1	4	0	0
2	23622921	.	A	G	1	2	3	0	0	3	0	0
2	23623357	.	T	A	1	2	3	0	0	3	0	0
2	23623532	.	C	T	2	2	4	0	0	4	0	0
2	23623534	.	G	A	2	2	4	0	0	4	0	0
2	23624291	.	G	T	2	1	3	0	1	4	0	0
2	23640924	.	A	G	3	2	5	0	1	6	0	0
2	23643976	.	G	A	1	3	4	0	0	4	0	0
2	23644070	.	A	G	3	2	5	0	0	5	0	0
2	23701651	.	C	T	4	2	6	0	0	6	0	0
2	23707408	.	C	A	7	7	14	0	0	14	0	0
2	23707562	.	A	G	4	3	7	0	1	8	0	0
2	23711756	.	C	T	6	7	13	0	0	13	0	0
2	23711771	.	A	G	4	0	4	0	6	10	0	0
2	23711990	.	T	A	5	5	10	0	1	11	0	0
2	23713763	.	G	A	7	7	14	0	1	15	0	0
2	23713775	.	T	C	10	8	18	0	1	19	0	0
2	23714650	.	C	T	11	8	19	0	0	19	0	0
2	23714743	.	A	T	12	5	17	0	1	18	0	0
2	23716572	.	T	C	6	7	13	0	1	14	0	0
2	23718286	.	T	C	9	12	21	0	0	21	0	0
2	23721729	.	T	A	10	7	17	0	0	17	0	0
2	23722311	.	C	T	2	7	9	0	0	9	0	0
2	23722338	.	G	A	2	5	7	0	0	7	0	0
2	23722444	.	A	T	2	7	9	0	0	9	0	0
2	23722828	.	G	A	10	5	15	0	1	16	0	0
2	23723172	.	A	C	7	8	15	0	0	15	0	0
2	23723187	.	A	G	10	7	17	0	1	18	0	0
2	23723256	.	C	T	3	8	11	0	0	11	0	0
2	23723438	.	G	T	1	4	5	0	3	8	0	0
2	23723959	.	A	T	7	2	9	0	0	9	0	0
2	23724423	.	T	A	2	4	6	0	1	7	0	0
2	23725075	.	G	A	6	5	11	0	1	12	0	0
2	23725144	.	T	C	15	4	19	0	0	19	0	0
2	23725184	.	C	A	10	5	15	0	0	15	0	0
2	23725239	.	C	T	6	5	11	0	0	11	0	0
2	23725754	.	A	T	4	6	10	0	2	12	0	0
2	23725756	.	A	T	3	8	11	0	0	11	0	0
2	23725834	.	G	C	5	4	9	0	1	10	0	0
2	23725872	.	T	C	2	3	5	0	3	8	0	0
2	23725986	.	G	T	3	2	5	0	0	5	0	0
2	23726099	.	A	T	9	10	19	0	0	19	0	0
2	23726155	.	C	A	11	8	19	0	0	19	0	0
2	23726180	.	A	G	9	9	18	1	0	19	0	0
2	23726206	.	T	A	6	10	16	1	0	17	0	0
2	23726230	.	A	T	4	9	13	1	0	14	0	0
2	23726290	.	T	C	11	3	14	0	1	15	0	0
2	23726353	.	G	A	13	4	17	1	1	19	0	0
2	23726393	.	C	T	12	5	17	0	1	18	0	0
2	23800768	.	G	T	1	2	3	0	0	3	0	0
2	23800771	.	T	C	1	2	3	0	0	3	0	0
2	23803219	.	G	A	2	2	4	0	0	4	0	0
2	23808760	.	G	A	4	2	6	0	1	7	0	0
2	23813918	.	T	C	3	5	8	0	0	8	0	0
2	23816293	.	A	C	5	9	14	0	0	14	0	0
2	23816932	.	C	T	3	3	6	0	0	6	0	0
2	23816979	.	G	A	2	3	5	0	0	5	0	0
2	23816996	.	T	C	2	5	7	0	0	7	0	0
2	23817034	.	A	C	1	4	5	0	0	5	0	0
2	23817036	.	C	A	1	4	5	0	0	5	0	0
2	23817497	.	C	T	1	4	5	0	1	6	0	0
2	23817561	.	G	A	2	2	4	1	0	5	0	0
2	23817562	.	G	A	2	1	3	1	1	5	0	0
2	23818418	.	A	T	4	2	6	0	1	7	0	0
2	23818580	.	T	A	2	2	4	0	0	4	0	0
2	23819640	.	T	A	1	5	6	0	0	6	0	0
2	23819862	.	A	C	4	2	6	0	0	6	0	0
2	23835209	.	T	C	3	7	10	0	0	10	0	0
2	23937310	.	T	C	2	2	4	0	0	4	0	0
2	23937432	.	T	G	2	2	4	0	0	4	0	0
2	23953907	.	A	G	1	2	3	0	0	3	0	0
2	23953919	.	A	G	1	2	3	0	0	3	0	0
2	24161700	.	A	G	1	2	3	0	0	3	0	0
2	24164855	.	A	T	2	2	4	0	0	4	0	0
2	24202456	.	G	A	13	15	28	0	5	33	0	0
2	24202855	.	A	G	10	1	11	0	9	20	0	0
2	24219115	.	G	A	31	25	56	0	3	59	0	0
2	24222069	.	A	C	43	26	69	0	4	73	0	0
2	24223991	.	A	G	33	28	61	0	11	72	0	0
2	24238629	.	C	T	25	23	48	0	3	51	0	0
2	24238809	.	A	G	25	26	51	0	3	54	0	0
2	24248619	.	T	G	41	24	65	0	3	68	0	0
2	24248677	.	A	T	47	15	62	0	1	63	0	0
2	24248702	.	T	C	40	17	57	0	1	58	0	0
2	24248767	.	T	C	39	12	51	0	1	52	0	0
2	24248768	.	A	G	40	1	41	0	12	53	0	0
2	24248809	.	C	T	32	23	55	0	2	57	0	0
2	24248871	.	A	G	37	1	38	1	28	67	0	0
2	24249044	.	A	C	39	23	62	0	1	63	0	0
2	24249211	.	A	G	29	32	61	0	3	64	0	0
2	24249299	.	A	G	35	29	64	0	0	64	0	0
2	24249320	.	A	G	28	1	29	0	34	63	0	0
2	24249411	.	T	A	31	38	69	0	1	70	0	0
2	24249516	.	A	G	26	2	28	0	25	53	0	0
2	24249947	.	T	G	28	1	29	0	9	38	0	0
2	24250140	.	T	C	12	22	34	0	5	39	0	0
2	24250182	.	T	G	17	13	30	1	2	33	0	0
2	24250209	.	A	C	20	3	23	0	0	23	0	0
2	24250303	.	C	T	33	22	55	0	0	55	0	0
2	24250345	.	A	C	24	21	45	0	2	47	0	0
2	24250625	.	T	A	32	28	60	0	0	60	0	0
2	24250637	.	A	G	30	29	59	0	1	60	0	0
2	24250681	.	T	C	31	33	64	0	1	65	0	0
2	24251848	.	T	C	38	29	67	0	1	68	0	0
2	24252088	.	C	T	34	29	63	0	1	64	0	0
2	24310822	.	C	T	7	12	19	0	0	19	0	0
2	24310850	.	G	C	8	12	20	0	1	21	0	0
2	24310897	.	G	A	12	22	34	0	1	35	0	0
2	24311035	.	T	C	14	0	14	0	14	28	0	0
2	24311118	.	T	A	4	5	9	0	1	10	0	0
2	24311697	.	C	T	17	19	36	0	6	42	0	0
2	24311703	.	A	G	17	19	36	0	4	40	0	0
2	24311793	.	G	C	18	26	44	0	1	45	0	0
2	24313884	.	T	C	7	9	16	0	0	16	0	0
2	24314185	.	T	A	4	6	10	0	1	11	0	0
2	24315047	.	A	G	9	11	20	0	0	20	0	0
2	24315068	.	A	G	7	10	17	0	0	17	0	0
2	24316545	.	C	T	7	12	19	0	0	19	0	0
2	24317537	.	G	A	6	7	13	0	0	13	0	0
2	24321853	.	T	C	7	0	7	0	6	13	0	0
2	24322180	.	G	T	19	7	26	0	0	26	0	0
2	24326455	.	A	G	10	15	25	0	0	25	0	0
2	24326509	.	G	A	9	10	19	0	3	22	0	0
2	24328453	.	A	T	5	6	11	0	2	13	0	0
2	24331297	.	T	C	9	11	20	0	0	20	0	0
2	24335246	.	G	A	5	9	14	0	0	14	0	0
2	24338492	.	G	A	7	5	12	0	0	12	0	0
2	24348609	.	T	G	9	12	21	0	1	22	0	0
2	24348915	.	G	A	6	5	11	0	1	12	0	0
2	24382093	.	A	G	6	6	12	0	1	13	0	0
2	24385402	.	A	G	9	7	16	0	0	16	0	0
2	24385447	.	T	C	7	2	9	0	1	10	0	0
2	24386672	.	T	C	2	2	4	0	0	4	0	0
2	24411053	.	A	G	13	6	19	0	1	20	0	0
2	24411056	.	C	T	1	8	9	0	14	23	0	0
2	24411114	.	G	C	18	10	28	0	1	29	0	0
2	24411501	.	T	G	5	8	13	0	1	14	0	0
2	24411536	.	T	C	12	0	12	0	9	21	0	0
2	24411625	.	T	C	13	20	33	0	1	34	0	0
2	24411781	.	T	G	16	12	28	0	1	29	0	0
2	24411812	.	A	T	20	13	33	0	1	34	0	0
2	24411840	.	T	C	20	12	32	0	1	33	0	0
2	24411989	.	C	T	9	8	17	0	1	18	0	0
2	24412150	.	T	C	22	0	22	0	12	34	0	0
2	24412908	.	C	A	11	3	14	0	1	15	0	0
2	24413710	.	T	C	7	11	18	0	2	20	0	0
2	24413882	.	T	C	6	13	19	0	1	20	0	0
2	24416775	.	A	G	18	13	31	3	1	35	0	0
2	24421686	.	G	A	17	7	24	0	0	24	0	0
2	24421813	.	T	C	12	0	12	0	8	20	0	0
2	24444650	.	C	T	11	6	17	0	1	18	0	0
2	24444839	.	C	G	1	8	9	0	6	15	0	0
2	24461305	.	C	T	0	6	6	0	5	11	0	0
2	24461649	.	T	C	6	10	16	0	0	16	0	0
2	24461957	.	G	A	10	11	21	0	2	23	0	0
2	24537330	.	A	G	1	0	1	0	2	3	0	0
2	24548812	.	C	T	2	2	4	0	0	4	0	0
2	24548816	.	G	T	4	2	6	0	0	6	0	0
2	24548957	.	G	C	3	6	9	0	0	9	0	0
2	24549470	.	A	G	1	2	3	0	0	3	0	0
2	24565123	.	A	G	6	9	15	0	1	16	0	0
2	24578215	.	G	A	8	7	15	0	0	15	0	0
2	24578272	.	A	G	7	4	11	0	0	11	0	0
2	24578568	.	A	G	7	6	13	0	0	13	0	0
2	24584052	.	C	T	0	4	4	0	9	13	0	0
2	24594669	.	T	G	8	6	14	0	1	15	0	0
2	24594673	.	T	A	9	7	16	0	0	16	0	0
2	24601643	.	A	G	7	5	12	0	0	12	0	0
2	24649228	.	A	G	5	0	5	0	6	11	0	0
2	24650434	.	G	A	0	6	6	0	4	10	0	0
2	24663596	.	C	G	5	3	8	0	0	8	0	0
2	24664541	.	G	A	1	7	8	0	5	13	0	0
2	24664557	.	C	T	7	8	15	0	0	15	0	0
2	24664583	.	G	A	10	7	17	0	1	18	0	0
2	24666197	.	C	T	8	9	17	0	0	17	0	0
2	24682951	.	T	C	24	11	35	0	4	39	0	0
2	24683093	.	A	G	9	2	11	0	10	21	0	0
2	24701098	.	T	C	6	6	12	0	1	13	0	0
2	24701261	.	T	A	7	6	13	0	0	13	0	0
2	24729837	.	C	T	5	3	8	0	0	8	0	0
2	24737749	.	C	T	4	4	8	0	0	8	0	0
2	24737776	.	C	T	7	4	11	0	0	11	0	0
2	24739910	.	G	T	10	6	16	2	0	18	0	0
2	24740121	.	G	C	0	6	6	0	10	16	0	0
2	24740439	.	C	T	7	3	10	0	0	10	0	0
2	24740468	.	T	A	6	6	12	0	0	12	0	0
2	24743855	.	G	A	4	6	10	0	1	11	0	0
2	24748144	.	A	G	5	4	9	0	0	9	0	0
2	24748197	.	C	T	6	6	12	0	0	12	0	0
2	24749886	.	G	A	1	3	4	0	0	4	0	0
2	24751165	.	T	C	4	5	9	0	0	9	0	0
2	24751430	.	C	T	6	3	9	0	0	9	0	0
2	24751567	.	T	A	7	7	14	0	0	14	0	0
2	24751572	.	A	G	5	7	12	0	0	12	0	0
2	24751608	.	A	T	3	8	11	0	1	12	0	0
2	24751986	.	T	G	13	0	13	0	4	17	0	0
2	24751991	.	A	G	11	5	16	0	2	18	0	0
2	24752048	.	C	T	9	7	16	0	0	16	0	0
2	24752071	.	A	G	8	5	13	0	0	13	0	0
2	24752157	.	G	A	11	8	19	0	0	19	0	0
2	24752179	.	C	T	14	11	25	0	0	25	0	0
2	24752391	.	A	G	12	11	23	0	2	25	0	0
2	24752737	.	A	G	6	4	10	0	0	10	0	0
2	24752781	.	G	T	5	7	12	0	0	12	0	0
2	24752784	.	T	G	12	2	14	0	0	14	0	0
2	24752842	.	G	T	7	9	16	0	0	16	0	0
2	24753085	.	C	G	6	5	11	0	0	11	0	0
2	24753311	.	G	T	5	3	8	0	0	8	0	0
2	24753348	.	A	G	5	3	8	0	0	8	0	0
2	24753410	.	A	G	4	2	6	0	1	7	0	0
2	24753492	.	G	C	9	5	14	0	0	14	0	0
2	24753535	.	A	C	12	6	18	0	0	18	0	0
2	24754489	.	G	A	2	4	6	0	1	7	0	0
2	24754565	.	A	T	10	6	16	0	0	16	0	0
2	24754641	.	G	A	2	12	14	0	11	25	0	0
2	24754794	.	G	A	24	10	34	0	1	35	0	0
2	24754883	.	T	A	9	8	17	0	0	17	0	0
2	24755018	.	T	C	13	8	21	0	0	21	0	0
2	24766980	.	C	T	5	7	12	0	0	12	0	0
2	24767285	.	T	C	2	3	5	0	0	5	0	0
2	24770898	.	T	C	3	3	6	0	0	6	0	0
2	24770928	.	A	G	2	0	2	0	4	6	0	0
2	24773684	.	C	A	5	3	8	0	0	8	0	0
2	24773724	.	A	G	6	3	9	0	0	9	0	0
2	24774452	.	C	T	4	2	6	0	0	6	0	0
2	24774461	.	C	T	2	1	3	0	1	4	0	0
2	24858670	.	A	G	3	2	5	0	0	5	0	0
2	24862677	.	G	A	1	3	4	0	3	7	0	0
2	24862691	.	T	C	3	3	6	0	0	6	0	0
2	24863306	.	A	T	4	2	6	0	0	6	0	0
2	24863516	.	G	A	5	3	8	0	0	8	0	0
2	24863757	.	G	T	2	2	4	0	0	4	0	0
2	24864351	.	A	G	7	2	9	0	2	11	0	0
2	24864372	.	A	G	8	7	15	0	0	15	0	0
2	24864387	.	A	G	9	4	13	0	0	13	0	0
2	24864756	.	T	C	1	2	3	0	0	3	0	0
2	24865872	.	T	A	2	2	4	0	0	4	0	0
2	24865961	.	A	G	5	4	9	0	0	9	0	0
2	24865972	.	A	T	6	5	11	0	0	11	0	0
2	24873047	.	G	A	16	13	29	0	5	34	0	0
2	24877010	.	A	G	9	23	32	0	0	32	0	0
2	24877227	.	C	T	12	7	19	0	0	19	0	0
2	24877276	.	A	C	11	8	19	0	1	20	0	0
2	24877294	.	T	C	13	9	22	0	0	22	0	0
2	24877327	.	T	C	7	6	13	0	1	14	0	0
2	24877534	.	G	C	5	3	8	0	1	9	0	0
2	24878017	.	T	A	19	9	28	0	0	28	0	0
2	24878081	.	T	A	19	19	38	0	0	38	0	0
2	24878265	.	G	T	9	10	19	0	1	20	0	0
2	24942639	.	T	C	7	7	14	1	1	16	0	0
2	24943237	.	G	A	4	16	20	0	9	29	0	0
2	24943398	.	C	T	8	5	13	0	1	14	0	0
2	24943671	.	T	A	0	4	4	0	1	5	0	0
2	24944187	.	C	T	12	12	24	0	0	24	0	0
2	24944485	.	T	G	13	4	17	0	1	18	0	0
2	24944566	.	G	A	8	3	11	0	0	11	0	0
2	24947372	.	T	C	5	0	5	0	6	11	0	0
2	24952186	.	G	A	2	7	9	0	0	9	0	0
2	24956856	.	T	C	6	0	6	0	6	12	0	0
2	24957008	.	G	A	4	4	8	0	0	8	0	0
2	24957073	.	T	C	5	8	13	0	0	13	0	0
2	24957086	.	C	T	0	8	8	0	6	14	0	0
2	24959124	.	C	T	2	2	4	0	0	4	0	0
2	24959143	.	T	C	1	4	5	0	0	5	0	0
2	24961833	.	C	T	0	2	2	0	1	3	0	0
2	24964691	.	T	A	2	4	6	0	0	6	0	0
2	24969647	.	C	T	4	3	7	0	0	7	0	0
2	24990621	.	T	A	3	5	8	0	0	9	1	0
2	24990629	.	T	A	5	6	11	0	0	11	0	0
2	24990751	.	A	T	3	6	9	0	0	9	0	0
2	24990845	.	T	C	7	3	10	0	0	10	0	0
2	24991202	.	C	G	15	12	27	0	1	28	0	0
2	24991265	.	T	G	12	7	19	0	2	21	0	0
2	24991387	.	G	T	13	14	27	0	0	27	0	0
2	24991429	.	G	A	15	13	28	0	1	29	0	0
2	24991564	.	A	C	11	0	11	0	12	23	0	0
2	24991573	.	A	G	11	12	23	0	0	23	0	0
2	24991909	.	A	G	17	15	32	0	1	33	0	0
2	24992134	.	G	A	23	8	31	0	2	33	0	0
2	24992185	.	T	C	23	11	34	0	2	36	0	0
2	24992242	.	C	T	0	17	17	0	21	38	0	0
2	24992352	.	G	A	12	21	33	0	0	33	0	0
2	24992407	.	G	A	16	16	32	0	3	35	0	0
2	24992422	.	G	A	16	17	33	0	3	36	0	0
2	24996241	.	C	T	10	12	22	0	2	24	0	0
2	25074756	.	A	T	4	8	12	0	1	13	0	0
2	25074791	.	A	G	4	0	4	0	5	9	0	0
2	25077569	.	T	C	4	11	15	0	0	15	0	0
2	25087019	.	G	T	1	8	9	0	9	18	0	0
2	25087221	.	G	T	4	7	11	0	1	12	0	0
2	25091203	.	G	A	4	9	13	0	0	13	0	0
2	25095096	.	T	C	6	2	8	0	0	8	0	0
2	25095118	.	T	C	5	3	8	0	0	8	0	0
2	25095177	.	T	C	10	3	13	0	1	14	0	0
2	25097106	.	G	A	1	6	7	0	6	13	0	0
2	25097289	.	G	A	1	3	4	0	0	4	0	0
2	25097543	.	C	T	8	5	13	0	0	13	0	0
2	25097576	.	T	G	5	6	11	0	0	11	0	0
2	25100106	.	A	G	8	0	8	0	9	17	0	0
2	25101118	.	A	G	11	8	19	0	0	19	0	0
2	25101124	.	T	C	10	8	18	0	1	19	0	0
2	25101160	.	A	G	8	0	8	0	15	23	0	0
2	25104866	.	A	G	8	11	19	0	0	19	0	0
2	25105482	.	G	A	8	7	15	0	0	15	0	0
2	25105507	.	G	C	10	5	15	0	0	15	0	0
2	25105586	.	C	T	9	10	19	0	1	20	0	0
2	25105856	.	T	A	11	6	17	0	0	17	0	0
2	25105857	.	C	A	11	6	17	0	0	17	0	0
2	25105900	.	C	T	11	13	24	0	1	25	0	0
2	25105992	.	G	A	8	7	15	0	0	15	0	0
2	25106082	.	G	A	2	7	9	0	7	16	0	0
2	25106098	.	T	A	8	6	14	0	0	14	0	0
2	25106343	.	T	A	6	4	10	0	0	12	2	0
2	25106477	.	G	A	4	9	13	0	0	13	0	0
2	25106508	.	G	C	4	10	14	0	2	16	0	0
2	25106554	.	G	T	5	10	15	0	1	16	0	0
2	25106631	.	C	G	1	3	4	0	0	4	0	0
2	25107049	.	G	A	4	3	7	0	8	15	0	0
2	25107532	.	T	G	1	2	3	0	0	3	0	0
2	25107591	.	A	G	2	5	7	0	0	7	0	0
2	25107710	.	T	C	7	16	23	0	0	23	0	0
2	25107713	.	T	C	7	16	23	0	0	23	0	0
2	25108042	.	A	G	19	7	26	0	0	26	0	0
2	25108052	.	C	T	16	7	23	0	0	23	0	0
2	25108137	.	C	T	12	12	24	0	1	25	0	0
2	25108377	.	T	A	9	7	16	0	0	16	0	0
2	25113168	.	A	G	8	7	15	0	1	16	0	0
2	25118414	.	G	A	12	6	18	0	0	18	0	0
2	25119637	.	A	G	13	13	26	0	1	27	0	0
2	25119667	.	G	T	8	15	23	0	2	25	0	0
2	25119950	.	T	G	6	9	15	0	0	15	0	0
2	25124650	.	T	G	6	6	12	0	1	13	0	0
2	25125041	.	A	T	6	4	10	0	0	10	0	0
2	25125073	.	G	A	2	3	5	0	1	6	0	0
2	25127042	.	G	T	6	4	10	0	0	10	0	0
2	25127219	.	T	C	7	6	13	0	0	13	0	0
2	25127261	.	G	T	1	6	7	0	8	15	0	0
2	25127651	.	C	T	3	2	5	0	0	5	0	0
2	25128019	.	C	G	3	3	6	0	0	6	0	0
2	25128024	.	C	T	2	4	6	0	0	6	0	0
2	25128105	.	T	A	1	2	3	0	0	3	0	0
2	25128458	.	C	T	1	2	3	0	0	3	0	0
2	25128590	.	C	T	5	10	15	0	0	15	0	0
2	25128668	.	C	T	9	5	14	0	2	16	0	0
2	25128780	.	T	A	4	6	10	0	0	10	0	0
2	25128858	.	C	T	4	5	9	0	1	10	0	0
2	25128997	.	C	G	2	0	2	0	4	6	0	0
2	25246512	.	C	T	1	4	5	0	0	5	0	0
2	25282463	.	T	G	2	0	2	0	2	4	0	0
2	25289894	.	C	T	1	3	4	0	0	4	0	0
2	25290101	.	T	C	1	3	4	0	0	4	0	0
2	25290690	.	A	C	3	6	9	0	0	9	0	0
2	25456938	.	C	T	1	3	4	0	0	4	0	0
2	25509080	.	C	T	1	1	2	0	1	3	0	0
2	25541066	.	A	G	1	0	1	0	2	3	0	0
2	25541074	.	A	C	1	2	3	0	0	3	0	0
2	25542890	.	C	A	11	1	12	0	2	14	0	0
2	25658126	.	T	C	2	3	5	0	0	5	0	0
2	25658128	.	T	A	2	3	5	0	1	6	0	0
2	25658165	.	C	A	9	3	12	4	1	17	0	0
2	25681707	.	C	A	9	5	14	0	0	14	0	0
2	25756576	.	T	C	3	8	11	0	0	11	0	0
2	25767288	.	A	G	5	4	9	0	1	10	0	0
2	25771840	.	A	G	5	7	12	0	1	13	0	0
2	25781757	.	C	T	12	7	19	0	1	20	0	0
2	25786170	.	A	C	10	9	19	0	1	20	0	0
2	25786254	.	T	C	8	5	13	0	1	14	0	0
2	25787292	.	C	T	5	10	15	0	1	16	0	0
2	25787553	.	G	C	9	6	15	0	0	15	0	0
2	25789394	.	C	T	4	2	6	0	0	6	0	0
2	25794007	.	A	C	4	4	8	0	2	10	0	0
2	25794226	.	A	G	8	9	17	0	1	18	0	0
2	25797439	.	C	T	8	5	13	0	0	13	0	0
2	25797472	.	C	T	9	3	12	0	1	13	0	0
2	25798611	.	A	G	9	4	13	0	0	13	0	0
2	25800881	.	C	T	7	7	14	0	0	14	0	0
2	25839381	.	G	T	3	11	14	0	17	31	0	0
2	25843532	.	T	C	10	13	23	0	2	25	0	0
2	25843806	.	G	A	1	18	19	0	15	34	0	0
2	25844341	.	T	C	7	8	15	0	4	19	0	0
2	25844345	.	A	T	6	12	18	0	1	19	0	0
2	25844986	.	T	A	11	7	18	0	2	20	0	0
2	25947351	.	C	T	12	11	23	0	2	25	0	0
2	25947408	.	G	T	7	7	14	0	1	15	0	0
2	25947531	.	C	T	7	2	9	0	0	10	1	0
2	25947585	.	T	C	10	3	13	0	0	13	0	0
2	25947593	.	G	A	0	6	6	0	9	15	0	0
2	25947651	.	C	T	10	11	21	0	0	21	0	0
2	25947678	.	T	C	10	8	18	0	0	18	0	0
2	25947699	.	T	C	8	8	16	0	3	19	0	0
2	25952953	.	T	C	17	9	26	0	2	28	0	0
2	25952983	.	C	T	18	12	30	0	0	30	0	0
2	25963401	.	T	A	13	5	18	0	1	19	0	0
2	25984751	.	G	A	15	10	25	0	2	27	0	0
2	25984772	.	C	T	16	10	26	0	1	27	0	0
2	25984913	.	T	C	18	10	28	0	0	28	0	0
2	25984928	.	T	C	18	11	29	0	0	29	0	0
2	25984970	.	C	T	19	13	32	0	2	34	0	0
2	25984982	.	C	T	17	12	29	0	2	31	0	0
2	25985012	.	C	T	22	12	34	0	1	35	0	0
2	25985219	.	T	C	12	10	22	0	0	22	0	0
2	25985268	.	G	A	9	10	19	0	1	20	0	0
2	25985300	.	A	C	16	9	25	0	0	25	0	0
2	25985351	.	C	G	22	10	32	0	3	35	0	0
2	25988414	.	G	A	1	12	13	0	19	32	0	0
2	25988475	.	C	T	13	8	21	0	0	21	0	0
2	25988570	.	T	C	14	14	28	0	1	29	0	0
2	25989100	.	A	G	18	10	28	0	1	29	0	0
2	25989290	.	T	G	12	16	28	0	0	28	0	0
2	25990020	.	C	A	15	17	32	0	2	34	0	0
2	25990180	.	C	T	19	20	39	0	3	42	0	0
2	25990302	.	A	G	14	16	30	0	1	31	0	0
2	25990337	.	A	G	14	15	29	0	0	29	0	0
2	25990447	.	G	A	28	9	37	0	2	39	0	0
2	25990522	.	A	C	15	9	24	0	0	24	0	0
2	25990563	.	A	G	11	12	23	0	1	24	0	0
2	25990628	.	C	A	23	9	32	0	0	32	0	0
2	26060584	.	A	G	3	2	5	0	1	6	0	0
2	26155917	.	G	A	0	3	3	0	2	5	0	0
2	26156582	.	G	A	3	2	5	0	0	5	0	0
2	26156618	.	T	A	4	2	6	0	0	6	0	0
2	26179171	.	A	T	2	4	6	0	0	6	0	0
2	26196646	.	C	T	4	4	8	0	0	8	0	0
2	26206930	.	A	G	7	10	17	0	2	19	0	0
2	26206942	.	G	T	1	9	10	0	6	16	0	0
2	26207038	.	A	C	8	9	17	0	0	17	0	0
2	26207071	.	C	T	6	8	14	0	0	14	0	0
2	26207080	.	G	C	8	7	15	0	0	16	1	0
2	26207155	.	C	T	9	7	16	0	2	18	0	0
2	26207254	.	A	G	12	9	21	0	1	22	0	0
2	26207263	.	T	A	14	11	25	0	0	25	0	0
2	26207368	.	A	G	16	8	24	0	0	24	0	0
2	26207713	.	G	A	7	7	14	0	0	14	0	0
2	26207752	.	C	T	8	8	16	0	0	16	0	0
2	26207938	.	C	T	9	16	25	0	2	27	0	0
2	26208480	.	A	C	5	10	15	0	1	16	0	0
2	26208520	.	A	G	6	9	15	0	0	15	0	0
2	26208589	.	A	G	10	8	18	0	1	19	0	0
2	26208668	.	T	G	9	0	9	0	10	19	0	0
2	26208733	.	C	A	10	5	15	0	1	16	0	0
2	26208815	.	G	T	9	11	20	0	1	21	0	0
2	26208996	.	A	G	13	4	17	0	2	19	0	0
2	26209120	.	C	T	6	7	13	0	0	13	0	0
2	26209141	.	G	A	4	6	10	0	0	10	0	0
2	26209169	.	C	T	7	4	11	0	0	11	0	0
2	26209266	.	A	C	3	4	7	0	0	7	0	0
2	26240742	.	C	T	23	20	43	0	3	46	0	0
2	26240805	.	T	C	22	19	41	0	3	44	0	0
2	26240857	.	C	T	19	23	42	0	1	43	0	0
2	26277924	.	C	A	29	16	45	0	9	55	1	0
2	26282745	.	C	T	24	16	40	1	2	43	0	0
2	26282814	.	T	C	23	13	36	0	2	38	0	0
2	26282829	.	A	G	19	1	20	0	19	39	0	0
2	26282916	.	A	G	28	0	28	0	22	50	0	0
2	26298558	.	A	C	4	2	6	0	0	6	0	0
2	26298571	.	C	T	4	2	6	0	0	6	0	0
2	26299788	.	C	A	2	2	4	0	0	4	0	0
2	26300016	.	T	C	2	3	5	0	1	6	0	0
2	26300172	.	A	G	3	1	4	0	0	4	0	0
2	26303719	.	T	G	10	0	10	0	5	15	0	0
2	26303985	.	A	G	8	7	15	0	1	16	0	0
2	26304066	.	T	C	3	10	13	0	3	16	0	0
2	26304266	.	A	G	4	5	9	0	0	10	1	0
2	26304329	.	A	G	3	6	9	0	0	9	0	0
2	26422287	.	C	T	9	3	12	0	0	12	0	0
2	26443211	.	A	C	10	10	20	0	1	21	0	0
2	26443476	.	C	T	3	5	8	0	0	8	0	0
2	26444170	.	T	C	3	3	6	0	1	7	0	0
2	26444190	.	A	T	3	2	5	0	0	5	0	0
2	26444332	.	C	A	4	4	8	0	0	8	0	0
2	26463459	.	C	T	1	4	5	0	4	9	0	0
2	26463622	.	A	G	8	10	18	0	0	18	0	0
2	26468243	.	G	A	8	11	19	0	1	20	0	0
2	26468665	.	A	T	10	8	18	0	0	18	0	0
2	26470237	.	G	T	14	12	26	0	1	27	0	0
2	26470267	.	G	A	13	11	24	0	0	24	0	0
2	26470357	.	G	A	21	12	33	0	0	33	0	0
2	26470666	.	A	G	27	13	40	0	3	43	0	0
2	26473078	.	A	G	21	22	43	0	0	43	0	0
2	26473361	.	C	T	28	14	42	0	5	47	0	0
2	26476109	.	G	A	3	3	6	0	0	6	0	0
2	26479695	.	T	C	4	3	7	0	0	7	0	0
2	26480101	.	A	G	6	0	6	0	10	16	0	0
2	26481029	.	C	T	3	9	12	0	0	12	0	0
2	26483946	.	G	T	10	8	18	0	0	18	0	0
2	26489500	.	C	T	10	7	17	0	1	18	0	0
2	26489681	.	T	C	13	6	19	0	0	19	0	0
2	26491830	.	C	A	4	10	14	0	0	14	0	0
2	26494507	.	G	A	8	7	15	0	2	17	0	0
2	26499519	.	C	T	18	27	45	0	2	47	0	0
2	26500872	.	T	C	31	32	63	0	2	65	0	0
2	26500989	.	C	T	34	33	67	0	1	68	0	0
2	26501691	.	G	A	2	4	6	0	0	6	0	0
2	26576936	.	A	G	1	2	3	0	0	3	0	0
2	26577189	.	T	C	8	4	12	0	0	12	0	0
2	26577267	.	G	C	8	10	18	0	0	18	0	0
2	26577314	.	T	A	5	7	12	0	0	12	0	0
2	26577378	.	A	G	5	12	17	0	0	17	0	0
2	26578227	.	T	G	6	7	13	0	2	15	0	0
2	26578280	.	G	T	5	9	14	0	1	15	0	0
2	26578464	.	G	A	1	2	3	0	0	3	0	0
2	26586134	.	T	C	3	0	3	0	3	6	0	0
2	26586185	.	C	G	5	5	10	0	1	11	0	0
2	26586373	.	A	G	3	7	10	0	0	10	0	0
2	26586393	.	T	C	6	6	12	0	1	13	0	0
2	26592460	.	A	G	5	2	7	0	0	7	0	0
2	26599248	.	A	G	1	3	4	0	0	4	0	0
2	26599287	.	G	A	2	3	5	0	0	5	0	0
2	26604890	.	G	A	3	3	6	0	1	7	0	0
2	26605135	.	G	A	0	2	2	0	1	3	0	0
2	26605350	.	G	A	2	2	4	0	0	4	0	0
2	26605351	.	C	A	2	2	4	0	0	4	0	0
2	26607181	.	G	C	4	2	6	0	0	6	0	0
2	26607399	.	T	C	2	3	5	0	0	5	0	0
2	26609458	.	C	T	1	2	3	0	0	3	0	0
2	26609518	.	C	A	1	4	5	0	0	5	0	0
2	26609537	.	T	C	1	4	5	0	0	5	0	0
2	26609651	.	C	A	2	5	7	0	0	7	0	0
2	26609710	.	C	T	2	2	4	0	0	4	0	0
2	26609832	.	G	C	3	2	5	0	0	5	0	0
2	26610677	.	T	C	3	2	5	0	0	5	0	0
2	26612624	.	G	C	7	7	14	0	0	14	0	0
2	26612893	.	T	C	9	18	27	0	1	28	0	0
2	26617098	.	A	G	13	17	30	0	1	31	0	0
2	26619829	.	G	T	15	21	36	0	1	37	0	0
2	26620695	.	A	G	11	17	28	0	0	28	0	0
2	26627301	.	C	A	25	22	47	0	1	48	0	0
2	26627332	.	T	A	18	15	33	0	1	34	0	0
2	26630587	.	C	T	0	22	22	0	11	33	0	0
2	26632384	.	T	G	26	14	40	1	0	41	0	0
2	26632627	.	G	C	15	13	28	1	3	32	0	0
2	26638355	.	T	G	3	15	18	0	2	20	0	0
2	26638809	.	C	T	7	13	20	0	5	25	0	0
2	26639157	.	T	C	16	6	22	0	0	22	0	0
2	26639217	.	A	G	21	17	38	0	1	39	0	0
2	26662113	.	T	C	15	8	23	0	1	24	0	0
2	26662143	.	T	A	12	8	20	0	0	20	0	0
2	26665065	.	A	G	3	9	12	0	2	14	0	0
2	26665081	.	A	G	4	10	14	0	1	15	0	0
2	26665198	.	T	C	4	6	10	0	0	10	0	0
2	26665199	.	T	C	4	6	10	0	0	10	0	0
2	26665631	.	A	T	2	10	12	0	1	13	0	0
2	26665650	.	A	G	1	8	9	0	1	10	0	0
2	26672266	.	A	G	13	17	30	0	1	32	1	0
2	26672320	.	G	A	9	15	24	0	1	25	0	0
2	26672395	.	G	A	13	3	16	1	2	19	0	0
2	26672440	.	A	G	20	11	31	1	0	32	0	0
2	26672672	.	G	A	8	7	15	0	1	16	0	0
2	26673355	.	C	G	3	0	3	0	3	6	0	0
2	26676715	.	T	A	6	5	11	0	0	11	0	0
2	26676759	.	T	C	6	3	9	0	0	9	0	0
2	26676807	.	T	A	4	3	7	0	0	7	0	0
2	26677109	.	T	A	7	6	13	0	0	13	0	0
2	26677111	.	T	A	7	6	13	0	0	13	0	0
2	26677346	.	T	G	6	4	10	1	1	12	0	0
2	26677361	.	C	A	7	4	11	1	1	13	0	0
2	26677445	.	A	G	12	3	15	0	0	15	0	0
2	26677453	.	T	C	12	4	16	0	0	16	0	0
2	26677512	.	A	T	5	6	11	0	0	11	0	0
2	26677513	.	G	A	5	6	11	0	0	11	0	0
2	26680690	.	A	T	6	2	8	0	0	8	0	0
2	26681076	.	A	G	7	5	12	0	0	12	0	0
2	26681499	.	T	G	4	2	6	0	1	7	0	0
2	26681500	.	A	T	3	2	5	0	2	7	0	0
2	26681773	.	C	T	5	3	8	0	0	8	0	0
2	26681837	.	G	A	6	2	8	0	0	8	0	0
2	26682031	.	G	T	0	3	3	0	8	11	0	0
2	26683155	.	A	T	4	8	12	0	0	12	0	0
2	26688691	.	A	T	6	9	15	0	1	16	0	0
2	26688737	.	G	A	4	6	10	0	1	11	0	0
2	26688747	.	A	G	5	0	5	0	6	11	0	0
2	26697666	.	C	T	0	4	4	0	2	6	0	0
2	26704721	.	A	G	1	2	3	0	0	3	0	0
2	26714144	.	A	G	5	8	13	0	0	13	0	0
2	26714291	.	T	C	4	0	4	0	4	8	0	0
2	26716126	.	G	A	11	4	15	0	0	15	0	0
2	27000728	.	G	T	1	2	3	0	1	4	0	0
2	27000729	.	A	C	2	2	4	0	0	4	0	0
2	27010298	.	A	C	3	2	5	0	0	5	0	0
2	27048999	.	C	A	7	5	12	0	0	12	0	0
2	27064687	.	T	C	6	7	13	0	0	13	0	0
2	27330716	.	A	C	2	3	5	0	0	5	0	0
2	27330756	.	T	A	2	3	5	0	0	5	0	0
2	27330838	.	T	A	3	4	7	0	1	8	0	0
2	27341572	.	C	A	7	2	9	0	0	9	0	0
2	27341611	.	A	T	6	4	10	0	0	10	0	0
2	27341726	.	C	T	1	2	3	0	1	4	0	0
2	27365398	.	T	C	3	5	8	0	0	8	0	0
2	27372537	.	C	G	3	7	10	0	1	11	0	0
2	27372576	.	G	A	10	7	17	0	0	17	0	0
2	27377541	.	T	A	8	6	14	0	2	16	0	0
2	27377590	.	T	C	9	5	14	0	1	15	0	0
2	27378071	.	T	A	2	4	6	0	0	6	0	0
2	27378524	.	T	A	8	2	10	0	1	11	0	0
2	27379170	.	C	T	2	2	4	0	0	4	0	0
2	27379550	.	A	C	1	3	4	0	0	4	0	0
2	27379593	.	T	C	1	3	4	0	0	4	0	0
2	27379659	.	C	T	1	4	5	0	0	6	1	0
2	27379661	.	T	A	1	5	6	0	0	6	0	0
2	27380114	.	A	G	1	3	4	0	0	4	0	0
2	27380292	.	G	T	8	4	12	0	0	12	0	0
2	27380336	.	G	A	4	5	9	0	0	9	0	0
2	27380366	.	C	A	1	5	6	0	1	7	0	0
2	27380500	.	G	T	3	10	13	0	0	13	0	0
2	27382232	.	C	G	6	5	11	0	0	11	0	0
2	27384708	.	C	T	2	5	7	0	0	7	0	0
2	27390802	.	A	G	1	3	4	0	1	5	0	0
2	27390931	.	A	G	3	0	3	0	3	6	0	0
2	27390970	.	C	T	2	3	5	0	0	5	0	0
2	27390973	.	A	G	1	0	1	0	4	5	0	0
2	27391058	.	A	G	3	3	6	0	0	6	0	0
2	27391188	.	G	A	1	2	3	0	0	3	0	0
2	27491075	.	A	C	1	2	3	0	0	3	0	0
2	27532523	.	A	G	6	5	11	0	0	11	0	0
2	27534267	.	G	A	11	6	17	0	1	18	0	0
2	27540182	.	C	T	16	7	23	1	0	24	0	0
2	27540488	.	C	A	17	15	32	0	1	33	0	0
2	27540614	.	C	T	10	22	32	0	1	33	0	0
2	27540905	.	T	C	16	12	28	0	0	28	0	0
2	27541216	.	G	T	0	4	4	0	5	9	0	0
2	27541246	.	A	C	4	4	8	0	1	9	0	0
2	27541468	.	C	T	6	4	10	0	1	11	0	0
2	27541914	.	A	C	11	9	20	0	0	20	0	0
2	27542083	.	G	A	12	13	25	0	2	27	0	0
2	27542958	.	A	G	12	5	17	0	0	17	0	0
2	27543499	.	C	A	2	5	7	0	1	8	0	0
2	27562729	.	T	C	1	2	3	0	0	3	0	0
2	27582691	.	G	A	1	2	3	0	0	3	0	0
2	27614082	.	G	C	11	3	14	0	0	14	0	0
2	27635788	.	C	T	8	4	12	0	1	13	0	0
2	27635849	.	C	A	2	2	4	0	0	4	0	0
2	27635928	.	T	A	3	5	8	0	0	8	0	0
2	27641287	.	G	A	2	3	5	0	0	5	0	0
2	27642776	.	C	G	3	3	6	1	0	7	0	0
2	27642810	.	T	G	4	3	7	0	0	7	0	0
2	27646615	.	A	C	2	4	6	0	0	6	0	0
2	27658973	.	T	G	9	8	17	0	0	17	0	0
2	27659018	.	T	C	8	11	19	0	0	19	0	0
2	27663649	.	A	G	4	6	10	0	0	10	0	0
2	27663673	.	G	A	3	8	11	0	3	14	0	0
2	27663867	.	C	T	4	5	9	0	0	9	0	0
2	27663922	.	G	C	4	5	9	0	0	9	0	0
2	27663938	.	A	T	3	5	8	0	1	9	0	0
2	27664105	.	G	A	5	3	8	0	1	9	0	0
2	27664143	.	G	T	5	6	11	0	0	11	0	0
2	27664195	.	A	C	4	5	9	0	0	10	1	0
2	27664317	.	G	T	7	5	12	0	0	12	0	0
2	27664380	.	G	A	2	6	8	0	0	8	0	0
2	27664407	.	G	C	2	3	5	0	0	5	0	0
2	27670760	.	T	C	12	8	20	0	0	20	0	0
2	27670836	.	C	T	2	16	18	0	14	32	0	0
2	27670886	.	T	C	15	0	15	0	9	24	0	0
2	27672705	.	A	G	13	10	23	0	0	23	0	0
2	27673041	.	A	G	16	13	29	0	0	29	0	0
2	27673173	.	A	G	13	12	25	0	1	26	0	0
2	27673194	.	C	T	9	12	21	0	0	21	0	0
2	27673233	.	T	C	12	8	20	0	1	21	0	0
2	27691348	.	T	C	12	1	13	0	13	26	0	0
2	27691375	.	G	A	8	16	24	0	0	24	0	0
2	27691408	.	T	C	12	13	25	0	0	25	0	0
2	27691459	.	A	G	14	10	24	0	0	24	0	0
2	27812578	.	G	A	2	6	8	0	2	10	0	0
2	27845845	.	A	T	6	4	10	0	0	10	0	0
2	27846053	.	T	A	3	5	8	0	0	8	0	0
2	27846108	.	G	A	5	5	10	0	0	10	0	0
2	27848151	.	T	G	8	8	16	0	1	17	0	0
2	27849787	.	G	A	2	7	9	0	0	9	0	0
2	27858101	.	T	C	1	2	3	0	0	3	0	0
2	27933143	.	C	T	4	9	13	0	0	13	0	0
2	27933215	.	C	A	6	3	9	0	1	10	0	0
2	27933260	.	C	A	7	4	11	0	1	12	0	0
2	27933404	.	A	G	3	0	3	0	10	13	0	0
2	27933764	.	G	T	3	3	6	0	0	6	0	0
2	28049445	.	T	C	18	7	25	0	0	25	0	0
2	28049996	.	A	G	10	10	20	1	1	22	0	0
2	28050565	.	T	A	2	7	9	0	1	10	0	0
2	28050759	.	A	G	9	3	12	0	0	12	0	0
2	28050933	.	G	A	7	8	15	0	0	15	0	0
2	28057518	.	G	A	11	8	19	0	0	19	0	0
2	28077152	.	C	A	0	6	6	0	5	11	0	0
2	28077171	.	A	G	5	6	11	0	0	11	0	0
2	28085730	.	T	A	8	3	11	0	1	12	0	0
2	28085746	.	A	G	8	4	12	0	0	12	0	0
2	28490299	.	T	C	1	1	2	0	1	3	0	0
2	28490544	.	G	A	0	2	2	0	1	3	0	0
2	28503260	.	G	A	3	1	4	0	1	5	0	0
2	28503323	.	T	A	3	2	5	0	0	5	0	0
2	28518679	.	C	T	3	2	5	0	0	5	0	0
2	28521107	.	A	C	4	2	6	0	0	6	0	0
2	28521156	.	A	G	4	2	6	0	0	6	0	0
2	28521207	.	C	G	1	2	3	0	0	3	0	0
2	28650422	.	T	C	7	3	10	0	0	10	0	0
2	28650504	.	T	C	6	8	14	0	0	14	0	0
2	28650612	.	T	G	13	6	19	0	0	19	0	0
2	28650629	.	G	T	13	8	21	0	0	21	0	0
2	28651128	.	T	A	7	14	21	0	0	21	0	0
2	28651193	.	A	G	11	14	25	0	0	25	0	0
2	28651497	.	G	A	8	3	11	0	0	11	0	0
2	28653587	.	A	G	6	4	10	0	0	10	0	0
2	28653707	.	C	G	2	6	8	0	0	8	0	0
2	28657777	.	G	A	5	3	8	0	1	9	0	0
2	28657927	.	G	T	7	7	14	0	0	14	0	0
2	28659726	.	A	C	5	4	9	0	1	10	0	0
2	28659998	.	C	G	11	11	22	0	0	22	0	0
2	28902738	.	C	T	2	4	6	0	0	6	0	0
2	28930159	.	T	C	4	8	12	0	0	12	0	0
2	28934011	.	C	T	11	4	15	0	0	15	0	0
2	28934041	.	A	G	9	1	10	0	4	14	0	0
2	29032134	.	T	C	3	1	4	0	0	4	0	0
2	29032141	.	A	C	2	2	4	0	0	4	0	0
2	29032203	.	A	C	2	2	4	0	0	4	0	0
2	29032212	.	T	C	3	2	5	0	0	5	0	0
2	29037346	.	C	T	2	5	7	0	0	7	0	0
2	29105890	.	C	T	4	2	6	0	0	6	0	0
2	29113515	.	G	A	2	1	3	0	1	4	0	0
2	29113527	.	A	G	2	2	4	0	0	4	0	0
2	29257726	.	T	C	7	6	13	0	1	14	0	0
2	29310996	.	G	A	3	6	9	0	9	18	0	0
2	29317718	.	G	A	11	11	22	0	0	22	0	0
2	29352333	.	G	A	0	9	9	0	10	19	0	0
2	29352479	.	C	T	9	8	17	0	0	17	0	0
2	29477733	.	A	T	16	16	32	0	0	32	0	0
2	29477769	.	G	T	21	10	31	0	2	33	0	0
2	29477895	.	A	T	14	11	25	0	0	25	0	0
2	29477979	.	T	G	11	4	15	0	0	15	0	0
2	29484113	.	A	G	22	18	40	0	0	40	0	0
2	29485046	.	G	A	13	21	34	0	0	34	0	0
2	29491445	.	C	T	4	6	10	0	1	11	0	0
2	29491504	.	T	C	5	11	16	0	0	16	0	0
2	29610050	.	A	T	5	6	11	0	0	11	0	0
2	29610350	.	A	G	8	6	14	0	0	14	0	0
2	29610464	.	G	A	2	8	10	0	2	12	0	0
2	29610866	.	A	C	7	2	9	0	3	12	0	0
2	29676848	.	T	C	10	9	19	0	1	20	0	0
2	29685506	.	G	A	7	12	19	0	0	19	0	0
2	29685575	.	A	G	12	0	12	0	8	20	0	0
2	29726718	.	G	A	0	2	2	0	2	4	0	0
2	29726806	.	A	T	1	1	2	0	1	3	0	0
2	29892926	.	G	A	6	3	9	0	0	9	0	0
2	29905111	.	T	A	7	11	18	0	0	18	0	0
2	29910525	.	A	G	6	2	8	0	0	8	0	0
2	29911153	.	T	C	7	6	13	0	0	13	0	0
2	29914114	.	C	G	10	5	15	0	0	15	0	0
2	29914231	.	G	T	7	7	14	0	0	14	0	0
2	29915902	.	A	G	4	3	7	0	0	7	0	0
2	29915908	.	A	G	3	4	7	0	1	8	0	0
2	29916028	.	G	A	3	3	6	0	0	6	0	0
2	29976452	.	A	T	4	2	6	0	0	6	0	0
2	29976960	.	T	A	6	3	9	0	0	9	0	0
2	30106271	.	A	G	21	22	43	0	2	45	0	0
2	30108443	.	T	C	29	16	45	0	2	47	0	0
2	30108456	.	T	C	27	12	39	0	1	40	0	0
2	30108542	.	T	G	3	8	11	0	0	11	0	0
2	30109678	.	C	T	9	12	21	0	3	24	0	0
2	30116206	.	C	T	8	7	15	0	1	16	0	0
2	30116310	.	A	T	2	2	4	0	1	5	0	0
2	30116586	.	C	A	13	8	21	0	0	21	0	0
2	30116589	.	C	T	11	9	20	0	1	21	0	0
2	30116688	.	A	C	10	5	15	0	1	16	0	0
2	30116808	.	T	A	11	5	16	1	1	18	0	0
2	30116889	.	C	A	7	16	23	0	1	24	0	0
2	30116905	.	A	G	10	12	22	0	0	22	0	0
2	30117123	.	C	A	3	4	7	0	1	8	0	0
2	30117169	.	T	C	4	7	11	0	1	12	0	0
2	30117201	.	T	C	4	3	7	0	0	7	0	0
2	30117245	.	A	T	4	6	10	0	0	10	0	0
2	30117249	.	A	T	4	7	11	0	0	11	0	0
2	30176159	.	T	C	1	2	3	0	1	4	0	0
2	30176232	.	A	T	4	2	6	0	0	6	0	0
2	30176242	.	G	A	4	2	6	0	0	6	0	0
2	30178100	.	C	T	18	21	39	0	3	42	0	0
2	30182631	.	G	T	1	4	5	0	0	5	0	0
2	30183676	.	T	A	1	5	6	0	0	6	0	0
2	30183703	.	G	A	0	6	6	0	1	7	0	0
2	30194777	.	C	T	8	4	12	0	2	14	0	0
2	30194938	.	G	A	3	5	8	0	0	8	0	0
2	30195040	.	A	G	7	5	12	0	0	12	0	0
2	30245900	.	G	C	3	5	8	0	0	8	0	0
2	30245922	.	T	C	8	9	17	0	0	17	0	0
2	30246029	.	T	A	9	13	22	0	1	23	0	0
2	30250126	.	A	T	7	8	15	0	0	15	0	0
2	30251622	.	A	G	5	3	8	0	0	8	0	0
2	30251864	.	G	T	5	8	13	0	0	13	0	0
2	30252029	.	T	C	7	6	13	0	1	14	0	0
2	30252071	.	G	A	2	10	12	0	6	18	0	0
2	30252206	.	T	C	2	3	5	0	0	5	0	0
2	30290749	.	A	G	5	3	8	0	0	8	0	0
2	30291072	.	A	C	10	4	14	0	0	14	0	0
2	30295050	.	T	A	14	9	23	0	1	24	0	0
2	30295052	.	T	G	16	8	24	0	1	25	0	0
2	30295288	.	A	G	16	14	30	0	2	32	0	0
2	30319374	.	C	T	5	9	14	0	0	14	0	0
2	30319375	.	T	G	5	9	14	0	0	14	0	0
2	30319463	.	C	G	6	10	16	0	1	17	0	0
2	30372206	.	A	G	1	2	3	0	0	3	0	0
2	30423663	.	C	G	2	3	5	0	0	5	0	0
2	30427762	.	T	C	3	2	5	0	0	5	0	0
2	30428553	.	G	A	0	7	7	0	7	14	0	0
2	30428637	.	A	G	7	0	7	0	4	11	0	0
2	30428790	.	A	T	4	3	7	0	0	7	0	0
2	30429006	.	C	T	6	7	13	0	0	13	0	0
2	30429367	.	C	T	2	1	3	0	1	4	0	0
2	30429710	.	A	T	7	6	13	0	0	13	0	0
2	30429711	.	T	C	8	6	14	0	0	14	0	0
2	30458754	.	G	A	18	18	36	0	5	41	0	0
2	30460135	.	A	G	8	12	20	0	3	23	0	0
2	30478004	.	G	A	1	3	4	0	0	4	0	0
2	30481027	.	C	A	1	3	4	0	0	4	0	0
2	30481172	.	T	G	3	6	9	0	0	9	0	0
2	30481379	.	G	A	3	3	6	0	0	6	0	0
2	30503714	.	T	C	8	7	15	0	0	15	0	0
2	30506562	.	T	C	4	5	9	0	1	10	0	0
2	30519768	.	C	T	11	19	30	0	1	31	0	0
2	30519975	.	G	A	3	10	13	0	13	26	0	0
2	30520026	.	G	T	14	14	28	0	1	29	0	0
2	30523047	.	A	G	15	8	23	0	0	23	0	0
2	30523053	.	C	T	11	8	19	0	1	20	0	0
2	30524966	.	C	T	14	15	29	0	1	30	0	0
2	30524992	.	T	C	13	22	35	0	1	36	0	0
2	30525062	.	A	G	17	14	31	0	1	32	0	0
2	30525105	.	A	G	22	9	31	0	1	32	0	0
2	30525117	.	C	T	26	8	34	0	0	34	0	0
2	30525169	.	G	T	3	7	10	4	21	35	0	0
2	30525297	.	T	C	11	4	15	0	0	15	0	0
2	30525378	.	C	A	11	12	23	0	1	24	0	0
2	30525596	.	A	G	18	0	18	0	16	34	0	0
2	30525970	.	A	G	27	13	40	0	0	40	0	0
2	30554512	.	G	A	17	8	25	0	0	25	0	0
2	30556102	.	C	A	2	11	13	0	23	37	1	0
2	30556103	.	G	T	23	12	35	0	2	37	0	0
2	30556386	.	G	A	16	16	32	0	2	34	0	0
2	30556419	.	G	T	18	15	33	0	2	35	0	0
2	30561285	.	T	C	15	11	26	0	2	28	0	0
2	30568944	.	A	T	14	9	23	0	0	23	0	0
2	30568959	.	C	T	13	12	25	1	1	27	0	0
2	30579831	.	G	A	16	8	24	0	0	24	0	0
2	30613964	.	A	G	18	17	35	0	2	37	0	0
2	30614153	.	C	A	15	16	31	0	1	32	0	0
2	30618155	.	C	T	8	9	17	0	0	17	0	0
2	30693533	.	A	G	11	10	21	0	1	22	0	0
2	30693612	.	A	G	11	6	17	0	1	18	0	0
2	30693712	.	G	A	11	6	17	0	0	17	0	0
2	30743041	.	T	C	11	21	32	0	2	34	0	0
2	30743864	.	A	G	13	16	29	0	2	31	0	0
2	30743907	.	T	C	16	20	36	0	0	36	0	0
2	30743951	.	C	A	22	18	40	0	0	40	0	0
2	30752675	.	C	T	5	4	9	0	0	9	0	0
2	30753072	.	A	T	8	11	19	0	0	19	0	0
2	30753273	.	G	A	10	8	18	0	0	18	0	0
2	30753720	.	C	T	1	6	7	0	7	14	0	0
2	30753722	.	A	C	7	6	13	0	0	13	0	0
2	30753813	.	G	A	8	10	18	0	0	18	0	0
2	30753928	.	G	A	5	5	10	0	0	10	0	0
2	30753991	.	A	G	3	14	17	0	1	18	0	0
2	30754113	.	T	C	7	11	18	0	0	18	0	0
2	30754196	.	G	A	16	22	38	0	0	38	0	0
2	30754300	.	C	T	16	16	32	0	0	32	0	0
2	30754346	.	A	G	17	16	33	0	1	34	0	0
2	30754432	.	G	T	12	23	35	0	1	36	0	0
2	30754777	.	A	T	9	8	17	0	0	17	0	0
2	30754793	.	A	T	11	7	18	0	1	19	0	0
2	30754885	.	A	T	11	3	14	0	0	14	0	0
2	30755195	.	G	A	6	6	12	0	1	13	0	0
2	30755272	.	T	C	5	0	5	0	9	14	0	0
2	30755278	.	C	A	0	6	6	0	6	12	0	0
2	30755345	.	T	G	8	5	13	2	0	15	0	0
2	30755386	.	T	C	12	0	12	1	2	15	0	0
2	30755660	.	A	G	9	12	21	0	0	21	0	0
2	30755666	.	A	T	10	9	19	0	0	19	0	0
2	30755733	.	A	T	6	5	11	0	1	12	0	0
2	30756091	.	T	C	5	3	8	0	0	8	0	0
2	30756157	.	G	T	5	6	11	0	0	11	0	0
2	30756264	.	A	G	11	7	18	0	1	19	0	0
2	30756320	.	T	A	7	5	12	0	1	13	0	0
2	30756474	.	T	A	5	2	7	0	0	7	0	0
2	30756903	.	A	G	14	5	19	0	0	19	0	0
2	30786795	.	T	C	8	8	16	0	0	16	0	0
2	30787387	.	A	C	23	30	53	3	1	57	0	0
2	30794792	.	T	C	20	24	44	0	0	44	0	0
2	30821859	.	G	A	24	27	51	0	2	53	0	0
2	30821965	.	C	T	22	28	50	0	1	51	0	0
2	30823438	.	T	G	28	0	28	1	25	54	0	0
2	30846719	.	A	G	26	9	35	1	2	38	0	0
2	30883008	.	A	G	1	4	5	0	0	5	0	0
2	30886228	.	C	T	1	5	6	0	0	6	0	0
2	30886240	.	T	C	1	5	6	0	0	6	0	0
2	30886397	.	T	C	4	6	10	0	0	10	0	0
2	30897111	.	C	T	12	15	27	0	1	28	0	0
2	30897990	.	C	T	19	13	32	0	0	32	0	0
2	30898196	.	T	C	15	12	27	0	0	27	0	0
2	30900927	.	C	A	12	8	20	0	0	20	0	0
2	30900945	.	G	C	14	5	19	0	0	19	0	0
2	30900994	.	T	A	13	8	21	0	2	23	0	0
2	30904137	.	G	A	16	17	33	0	1	34	0	0
2	30905298	.	G	A	16	11	27	0	0	27	0	0
2	30906386	.	C	T	15	15	30	0	0	30	0	0
2	30907655	.	T	A	14	16	30	1	0	31	0	0
2	30908006	.	A	T	7	6	13	0	0	13	0	0
2	30960401	.	A	G	24	7	31	0	0	31	0	0
2	30960455	.	A	G	14	0	14	0	14	28	0	0
2	30960456	.	T	C	14	14	28	0	0	28	0	0
2	30971642	.	T	C	14	7	21	0	0	21	0	0
2	30971726	.	T	C	6	12	18	0	0	18	0	0
2	30971783	.	T	C	12	13	25	0	0	25	0	0
2	30971951	.	G	A	8	5	13	0	1	14	0	0
2	30972259	.	A	G	8	1	9	0	9	18	0	0
2	30982409	.	T	C	23	15	38	0	1	39	0	0
2	30982612	.	T	C	18	13	31	0	2	33	0	0
2	30982640	.	A	G	9	11	20	0	1	21	0	0
2	30982897	.	A	G	11	6	17	0	1	18	0	0
2	30982929	.	T	A	9	7	16	0	0	16	0	0
2	30983267	.	G	A	13	12	25	0	0	25	0	0
2	30983294	.	T	C	15	10	25	0	1	26	0	0
2	30987168	.	T	C	1	0	1	0	2	3	0	0
2	31297980	.	A	G	26	19	45	0	1	46	0	0
2	31298077	.	A	G	23	31	54	0	0	54	0	0
2	31298280	.	A	G	34	18	52	0	1	53	0	0
2	31298342	.	G	A	30	22	52	0	2	54	0	0
2	31298483	.	C	A	25	26	51	0	2	53	0	0
2	31298550	.	T	C	28	20	48	0	3	51	0	0
2	31298703	.	T	G	19	26	45	0	0	45	0	0
2	31298723	.	C	T	21	27	48	0	3	51	0	0
2	31298824	.	A	C	24	37	61	0	0	61	0	0
2	31299241	.	A	C	19	11	30	0	2	33	1	0
2	31302609	.	C	T	6	7	13	0	0	13	0	0
2	31308668	.	T	A	7	7	14	0	0	14	0	0
2	31308849	.	C	T	9	4	13	0	0	13	0	0
2	31345207	.	A	C	5	5	10	0	1	11	0	0
2	31348414	.	C	T	3	7	10	0	0	10	0	0
2	31348474	.	G	A	0	9	9	0	13	22	0	0
2	31360724	.	G	A	10	6	16	1	0	17	0	0
2	31360799	.	G	A	10	8	18	0	4	22	0	0
2	31361205	.	C	T	9	9	18	0	0	18	0	0
2	31361380	.	A	C	5	3	8	0	1	10	1	0
2	31361466	.	C	G	6	3	9	0	0	9	0	0
2	31361836	.	A	G	5	3	8	0	0	8	0	0
2	31362285	.	A	G	11	5	16	0	0	16	0	0
2	31362642	.	T	C	8	7	15	0	0	15	0	0
2	31362681	.	T	C	10	5	15	0	2	17	0	0
2	31362730	.	A	T	11	4	15	0	0	15	0	0
2	31362859	.	T	A	11	3	14	0	0	14	0	0
2	31362896	.	T	C	14	5	19	0	0	19	0	0
2	31363190	.	C	T	15	11	26	0	3	29	0	0
2	31363322	.	A	T	1	3	4	0	1	5	0	0
2	31428857	.	C	T	1	2	3	0	0	3	0	0
2	31451284	.	G	A	7	8	15	0	1	16	0	0
2	31451288	.	A	G	8	8	16	0	0	16	0	0
2	31451518	.	G	A	7	11	18	0	2	20	0	0
2	31451542	.	G	A	5	9	14	0	1	15	0	0
2	31451568	.	C	T	10	7	17	0	1	18	0	0
2	31451778	.	G	T	17	16	33	0	1	34	0	0
2	31451871	.	T	A	12	6	18	0	1	19	0	0
2	31452078	.	C	T	17	17	34	0	1	35	0	0
2	31452226	.	T	C	15	18	33	0	1	34	0	0
2	31452354	.	C	T	10	17	27	0	0	27	0	0
2	31499397	.	A	G	1	7	8	0	0	8	0	0
2	31507750	.	A	T	3	10	13	0	1	14	0	0
2	31507882	.	T	C	16	7	23	0	0	23	0	0
2	31511622	.	G	A	2	5	7	0	10	17	0	0
2	31511760	.	C	A	13	13	26	0	1	27	0	0
2	31511763	.	C	T	13	14	27	0	2	29	0	0
2	31511810	.	C	A	10	13	23	0	1	24	0	0
2	31511884	.	A	C	13	17	30	0	0	30	0	0
2	31511945	.	G	A	15	7	22	0	2	24	0	0
2	31511946	.	G	A	17	6	23	0	2	25	0	0
2	31517195	.	G	A	2	2	4	0	5	9	0	0
2	31517355	.	G	A	2	3	5	0	0	5	0	0
2	31627150	.	C	A	5	4	9	0	1	10	0	0
2	31627173	.	C	T	8	3	11	0	0	11	0	0
2	31627212	.	C	G	8	4	12	0	0	12	0	0
2	31627219	.	C	T	5	4	9	0	2	11	0	0
2	31627423	.	C	G	1	3	4	0	7	11	0	0
2	31630129	.	A	T	7	5	12	0	1	13	0	0
2	31630443	.	G	A	10	6	16	0	0	16	0	0
2	31634929	.	A	C	11	4	15	0	0	15	0	0
2	31635007	.	A	T	10	10	20	0	0	20	0	0
2	31635161	.	A	G	14	4	18	0	0	18	0	0
2	31635229	.	C	T	12	9	21	0	0	21	0	0
2	31635287	.	T	C	12	17	29	0	0	29	0	0
2	31635395	.	T	G	14	5	19	0	1	20	0	0
2	31635490	.	A	T	11	14	25	0	1	26	0	0
2	31635599	.	T	C	11	9	20	0	1	21	0	0
2	31635803	.	G	T	9	3	12	0	0	12	0	0
2	31635824	.	C	T	6	4	10	0	1	11	0	0
2	31635859	.	C	T	8	7	15	0	1	16	0	0
2	31635860	.	T	C	7	8	15	0	0	15	0	0
2	31635900	.	T	C	6	7	13	0	1	14	0	0
2	31636048	.	A	G	13	7	20	0	1	21	0	0
2	31636057	.	T	C	11	0	11	0	8	19	0	0
2	31638064	.	G	A	6	11	17	0	0	17	0	0
2	31638111	.	G	T	8	7	15	0	1	16	0	0
2	31638124	.	G	A	7	9	16	0	0	16	0	0
2	31638323	.	A	C	3	0	3	0	6	9	0	0
2	31640332	.	G	A	5	5	10	0	1	11	0	0
2	31650963	.	T	G	4	4	8	0	1	9	0	0
2	31687697	.	G	A	2	4	6	0	0	6	0	0
2	31690434	.	T	A	4	7	11	0	0	11	0	0
2	31690442	.	A	C	3	6	9	0	1	10	0	0
2	31692370	.	T	C	4	3	7	0	1	8	0	0
2	31696687	.	A	C	1	1	2	0	1	3	0	0
2	31700352	.	A	T	2	7	9	0	0	9	0	0
2	31700378	.	T	G	3	9	12	0	0	12	0	0
2	31703368	.	T	A	5	9	14	0	1	15	0	0
2	31703407	.	A	G	6	7	13	0	0	13	0	0
2	31703443	.	C	T	4	8	12	0	2	14	0	0
2	31703678	.	C	T	3	6	9	0	1	10	0	0
2	31709425	.	A	C	2	3	5	0	1	6	0	0
2	31710374	.	A	T	3	4	7	0	0	7	0	0
2	31722631	.	A	T	12	7	19	0	0	19	0	0
2	31727584	.	G	C	15	12	27	0	0	27	0	0
2	31735068	.	T	G	8	8	16	0	0	16	0	0
2	31781957	.	C	T	1	3	4	0	4	8	0	0
2	31782003	.	T	C	11	6	17	0	0	17	0	0
2	31784132	.	A	T	8	9	17	0	0	17	0	0
2	31806920	.	C	T	11	10	21	0	0	21	0	0
2	31820830	.	T	C	10	10	20	0	1	21	0	0
2	31821290	.	C	A	11	14	25	0	0	25	0	0
2	31826750	.	C	T	18	14	32	0	1	33	0	0
2	31827649	.	A	G	9	10	19	0	0	19	0	0
2	31827714	.	A	G	11	0	11	0	8	19	0	0
2	31832360	.	T	C	11	9	20	0	0	20	0	0
2	31833082	.	C	T	8	8	16	0	0	16	0	0
2	31834099	.	G	T	25	14	39	0	0	39	0	0
2	31834110	.	T	C	25	13	38	0	1	39	0	0
2	31834187	.	C	T	15	15	30	0	3	33	0	0
2	31836113	.	T	G	24	11	35	0	0	35	0	0
2	31836119	.	G	T	1	12	13	0	24	37	0	0
2	31836307	.	T	A	21	15	36	0	0	36	0	0
2	31836440	.	A	G	8	0	8	0	9	17	0	0
2	31836550	.	C	A	4	3	7	0	0	7	0	0
2	31836588	.	T	C	10	6	16	0	0	16	0	0
2	31838524	.	A	G	11	17	28	0	1	29	0	0
2	31842454	.	T	G	10	6	16	0	0	16	0	0
2	31891344	.	T	A	18	5	23	0	0	24	1	0
2	31891447	.	A	T	15	17	32	0	1	33	0	0
2	31891513	.	T	C	11	24	35	0	1	36	0	0
2	31891549	.	C	A	12	30	42	0	2	44	0	0
2	31891618	.	A	G	18	27	45	0	2	47	0	0
2	31892076	.	A	G	22	17	39	1	2	42	0	0
2	31892100	.	C	T	3	16	19	1	27	47	0	0
2	31894220	.	T	C	24	31	55	0	0	55	0	0
2	31901953	.	T	C	20	14	34	0	1	35	0	0
2	31902939	.	G	A	18	27	45	0	1	46	0	0
2	31902954	.	C	T	20	26	46	0	0	46	0	0
2	31913491	.	A	G	16	18	34	0	2	36	0	0
2	31919171	.	G	A	20	15	35	0	0	35	0	0
2	31927266	.	C	T	2	22	24	0	21	45	0	0
2	31943041	.	A	G	6	7	13	0	1	14	0	0
2	31943187	.	A	G	4	4	8	0	0	8	0	0
2	31944840	.	C	T	2	4	6	0	0	6	0	0
2	31948424	.	A	G	1	8	9	0	1	10	0	0
2	31948438	.	A	G	1	9	10	0	1	11	0	0
2	31948459	.	C	T	1	9	10	0	2	12	0	0
2	31957808	.	T	C	15	16	31	0	2	33	0	0
2	31975190	.	G	C	8	13	21	0	1	22	0	0
2	31987267	.	A	G	22	11	33	0	0	33	0	0
2	31987352	.	A	C	16	19	35	0	1	37	1	0
2	31987360	.	C	T	16	21	37	0	2	39	0	0
2	31989876	.	T	C	21	19	40	0	1	41	0	0
2	31993886	.	T	C	17	19	36	0	0	36	0	0
2	32005371	.	G	A	29	19	48	1	4	53	0	0
2	32018077	.	A	C	5	10	15	0	1	16	0	0
2	32018141	.	A	G	2	0	2	0	8	10	0	0
2	32089590	.	T	C	1	2	3	0	0	3	0	0
2	32264673	.	T	C	13	0	13	0	20	33	0	0
2	32264879	.	G	A	7	9	16	0	0	16	0	0
2	32264927	.	T	A	13	15	28	1	0	29	0	0
2	32265437	.	T	A	12	6	18	0	0	18	0	0
2	32265508	.	T	C	14	11	25	0	1	26	0	0
2	32265525	.	T	C	10	0	10	0	14	24	0	0
2	32265543	.	A	T	9	13	22	0	0	22	0	0
2	32265890	.	G	T	18	8	26	6	2	34	0	0
2	32265911	.	T	C	15	6	21	0	0	21	0	0
2	32266064	.	G	C	15	9	24	3	0	27	0	0
2	32266101	.	T	G	8	7	15	13	0	28	0	0
2	32266711	.	C	T	2	18	20	0	15	35	0	0
2	32266895	.	A	G	9	12	21	0	0	21	0	0
2	32267105	.	T	G	10	22	32	0	2	34	0	0
2	32267117	.	C	T	0	19	19	0	17	36	0	0
2	32267285	.	A	G	7	17	24	0	1	25	0	0
2	32267506	.	T	C	11	20	31	0	0	31	0	0
2	32267950	.	G	A	6	8	14	0	0	14	0	0
2	32268096	.	C	T	1	20	21	0	7	28	0	0
2	32270976	.	T	C	9	13	22	0	3	25	0	0
2	32270991	.	T	C	9	0	9	0	18	27	0	0
2	32276277	.	G	A	19	17	36	0	1	37	0	0
2	32299324	.	A	G	7	11	18	0	1	19	0	0
2	32299336	.	C	T	7	11	18	0	0	18	0	0
2	32299387	.	A	C	3	7	10	0	0	10	0	0
2	32307725	.	A	G	7	6	13	0	0	13	0	0
2	32352883	.	A	G	6	14	20	0	0	20	0	0
2	32357638	.	A	G	2	2	4	0	0	4	0	0
2	32357811	.	G	A	10	9	19	0	2	21	0	0
2	32357888	.	A	G	14	10	24	0	0	24	0	0
2	32357980	.	T	C	14	2	16	0	6	22	0	0
2	32358081	.	A	T	7	4	11	0	2	13	0	0
2	32361446	.	A	T	2	5	7	0	0	7	0	0
2	32361447	.	G	T	2	4	6	0	1	7	0	0
2	32361687	.	T	C	18	0	18	0	21	39	0	0
2	32366137	.	T	C	16	19	35	0	1	36	0	0
2	32366191	.	C	T	13	16	29	0	1	30	0	0
2	32378607	.	T	C	6	10	16	0	0	16	0	0
2	32380649	.	A	G	13	8	21	0	0	21	0	0
2	32394562	.	T	C	5	3	8	0	0	8	0	0
2	32394572	.	C	T	4	4	8	0	0	8	0	0
2	32407242	.	C	T	1	2	3	0	0	3	0	0
2	32415777	.	C	T	1	2	3	0	0	3	0	0
2	32415816	.	G	A	1	2	3	0	0	3	0	0
2	32430903	.	C	A	2	3	5	0	1	6	0	0
2	32441514	.	A	G	1	2	3	0	0	3	0	0
2	32476018	.	T	G	6	3	9	0	0	9	0	0
2	32476288	.	C	T	13	14	27	0	0	27	0	0
2	32477432	.	T	C	15	11	26	0	0	26	0	0
2	32479616	.	G	A	13	8	21	0	0	21	0	0
2	32483020	.	C	G	11	7	18	0	2	20	0	0
2	32485999	.	A	G	13	6	19	0	1	20	0	0
2	32494486	.	G	A	19	9	28	0	1	29	0	0
2	32494720	.	G	A	11	14	25	0	2	27	0	0
2	32498117	.	A	G	12	6	18	0	1	19	0	0
2	32501188	.	G	A	5	12	17	0	0	17	0	0
2	32505617	.	G	A	1	1	2	0	4	6	0	0
2	32507094	.	C	T	13	13	26	0	2	28	0	0
2	32507218	.	G	A	13	11	24	0	1	25	0	0
2	32508418	.	C	A	20	10	30	0	1	31	0	0
2	32509238	.	T	G	21	13	34	0	2	36	0	0
2	32509309	.	G	T	18	16	34	0	1	35	0	0
2	32509573	.	G	A	22	9	31	0	0	31	0	0
2	32509636	.	C	T	17	14	31	0	1	32	0	0
2	32513440	.	C	T	2	10	12	0	15	27	0	0
2	32515861	.	C	T	1	9	10	0	10	20	0	0
2	32515909	.	A	C	8	7	15	0	0	16	1	0
2	32516110	.	T	C	7	9	16	0	4	20	0	0
2	32516272	.	G	T	13	9	22	0	3	25	0	0
2	32516273	.	C	T	14	9	23	0	2	25	0	0
2	32516359	.	A	T	5	8	13	0	0	13	0	0
2	32516469	.	T	C	9	0	9	0	18	27	0	0
2	32516509	.	A	T	7	16	23	0	1	24	0	0
2	32519666	.	A	G	5	11	16	0	0	16	0	0
2	32531232	.	C	T	5	16	21	0	2	23	0	0
2	32543092	.	T	A	4	4	8	0	0	8	0	0
2	32558621	.	G	A	8	10	18	0	1	19	0	0
2	32561572	.	T	A	10	3	13	2	1	16	0	0
2	32561752	.	A	G	5	6	11	0	0	11	0	0
2	32561754	.	G	A	6	6	12	0	0	12	0	0
2	32562059	.	G	A	15	5	20	1	0	21	0	0
2	32569639	.	G	A	11	11	22	0	2	24	0	0
2	32569717	.	A	G	10	6	16	0	0	16	0	0
2	32569930	.	G	A	10	5	15	0	0	15	0	0
2	32577552	.	C	A	5	3	8	0	0	8	0	0
2	32577939	.	G	A	6	2	8	0	0	8	0	0
2	32578230	.	C	T	15	11	26	0	1	27	0	0
2	32578539	.	C	G	7	3	10	0	0	10	0	0
2	32578580	.	C	A	12	9	21	0	3	24	0	0
2	32578642	.	A	G	13	8	21	0	0	21	0	0
2	32578677	.	C	A	10	3	13	0	1	15	1	0
2	32579109	.	C	T	12	4	16	0	1	17	0	0
2	32579333	.	C	T	8	6	14	0	2	16	0	0
2	32579336	.	C	T	8	5	13	0	1	15	1	0
2	32583162	.	T	A	8	8	16	0	1	17	0	0
2	32583209	.	C	T	10	5	15	0	0	15	0	0
2	32583411	.	C	A	0	14	14	0	10	24	0	0
2	32583453	.	T	A	9	15	24	0	2	26	0	0
2	32583459	.	A	G	9	10	19	0	3	22	0	0
2	32583528	.	C	T	1	10	11	0	10	21	0	0
2	32583600	.	A	G	5	9	14	0	0	14	0	0
2	32583639	.	T	C	7	0	7	0	11	19	1	0
2	32583681	.	T	A	9	7	16	0	0	16	0	0
2	32583687	.	G	A	9	6	15	0	0	15	0	0
2	32590552	.	C	T	10	4	14	0	0	14	0	0
2	32590861	.	A	G	13	3	16	0	0	16	0	0
2	32590987	.	C	A	8	3	11	0	0	11	0	0
2	32590989	.	A	G	8	3	11	0	0	11	0	0
2	32591488	.	C	A	9	3	12	0	0	12	0	0
2	32591602	.	T	C	5	5	10	0	1	11	0	0
2	32591697	.	G	T	12	5	17	0	2	19	0	0
2	32592075	.	G	T	7	9	16	0	0	16	0	0
2	32594233	.	G	C	6	0	6	0	8	14	0	0
2	32594236	.	T	A	7	7	14	0	0	14	0	0
2	32594614	.	G	A	9	3	12	0	0	12	0	0
2	32594620	.	G	A	10	4	14	0	1	15	0	0
2	32623876	.	T	G	5	7	12	2	0	14	0	0
2	32636757	.	T	C	21	45	66	3	3	72	0	0
2	32636886	.	T	A	21	31	52	3	0	55	0	0
2	32636912	.	A	C	20	33	53	2	0	55	0	0
2	32637145	.	G	C	17	22	39	18	0	57	0	0
2	32637582	.	T	C	2	2	4	0	0	4	0	0
2	32654034	.	A	G	2	5	7	0	0	7	0	0
2	32654052	.	G	C	3	1	4	0	7	12	1	0
2	32654570	.	T	C	19	13	32	0	1	33	0	0
2	32665798	.	G	A	12	15	27	0	0	27	0	0
2	32666565	.	C	T	2	12	14	0	10	24	0	0
2	32667941	.	C	A	1	12	13	0	17	30	0	0
2	32676228	.	T	A	7	9	16	0	1	17	0	0
2	32676292	.	G	A	7	12	19	0	1	20	0	0
2	32676482	.	A	C	9	5	14	0	1	15	0	0
2	32679938	.	C	T	6	7	13	0	0	13	0	0
2	32680383	.	A	C	18	0	18	0	12	30	0	0
2	32681833	.	T	A	19	10	29	0	0	29	0	0
2	32681845	.	C	A	16	13	29	0	0	29	0	0
2	32682129	.	C	T	12	13	25	0	0	25	0	0
2	32682547	.	T	G	7	12	19	0	0	19	0	0
2	32686594	.	C	T	14	10	24	0	0	24	0	0
2	32686597	.	A	G	14	11	25	0	0	25	0	0
2	32738137	.	C	T	11	17	28	0	2	30	0	0
2	32738342	.	T	G	3	5	8	0	0	8	0	0
2	32749875	.	T	C	3	3	6	0	0	6	0	0
2	32750028	.	C	T	1	4	5	0	0	5	0	0
2	32750675	.	C	A	4	3	7	0	1	8	0	0
2	32750695	.	A	G	5	4	9	0	0	9	0	0
2	32752447	.	G	A	4	5	9	0	0	9	0	0
2	32754659	.	G	A	0	2	2	0	5	7	0	0
2	32754695	.	C	T	6	3	9	0	0	9	0	0
2	32754749	.	T	G	3	4	7	0	0	7	0	0
2	32756074	.	C	T	2	3	5	0	0	5	0	0
2	32756102	.	C	T	3	4	7	0	0	7	0	0
2	32756630	.	C	T	3	7	10	0	0	10	0	0
2	32756660	.	A	C	5	2	7	0	0	7	0	0
2	32815234	.	G	A	12	9	21	0	1	22	0	0
2	32817615	.	T	A	9	5	14	0	0	14	0	0
2	32817627	.	G	A	9	7	16	0	0	16	0	0
2	32820764	.	G	A	6	13	19	0	1	20	0	0
2	32820806	.	G	T	12	6	18	0	0	18	0	0
2	32821393	.	G	A	6	9	15	0	0	15	0	0
2	32821622	.	T	G	15	5	20	0	0	20	0	0
2	32823461	.	C	T	15	10	25	0	2	27	0	0
2	32823494	.	C	G	1	11	12	0	12	24	0	0
2	32823521	.	T	C	15	7	22	0	0	22	0	0
2	32824526	.	A	G	10	11	21	0	0	21	0	0
2	32824602	.	A	G	11	4	15	0	1	16	0	0
2	32824805	.	G	A	11	13	24	0	0	24	0	0
2	32825033	.	G	A	11	9	20	0	3	23	0	0
2	32825240	.	T	A	8	11	19	0	1	20	0	0
2	32825294	.	G	A	13	4	17	0	1	18	0	0
2	32825382	.	C	T	12	5	17	0	2	19	0	0
2	32827055	.	T	C	5	5	10	0	0	10	0	0
2	32827104	.	T	G	4	5	9	0	0	9	0	0
2	32827181	.	A	T	2	2	4	0	0	4	0	0
2	32828626	.	T	C	2	4	6	0	0	6	0	0
2	32828651	.	A	G	2	2	4	0	0	4	0	0
2	32829016	.	T	C	1	4	5	0	0	5	0	0
2	32830129	.	A	G	8	3	11	0	0	11	0	0
2	32831664	.	C	A	4	4	8	0	1	9	0	0
2	32833572	.	T	C	6	3	9	0	1	10	0	0
2	32849667	.	A	G	7	3	10	1	1	13	1	0
2	32850138	.	C	T	5	6	11	0	1	12	0	0
2	32850305	.	T	C	12	7	19	0	0	19	0	0
2	32850401	.	T	C	10	5	15	0	0	15	0	0
2	32850477	.	T	A	4	2	6	0	0	6	0	0
2	33209645	.	T	G	27	0	27	0	19	46	0	0
2	33216346	.	C	T	19	10	29	0	1	30	0	0
2	33216518	.	G	A	3	13	16	0	15	31	0	0
2	33216563	.	C	G	19	13	32	0	0	32	0	0
2	33399446	.	A	T	1	3	4	0	0	4	0	0
2	33404285	.	T	C	2	2	4	0	0	4	0	0
2	33408758	.	C	T	3	5	8	0	0	8	0	0
2	33415269	.	T	G	1	2	3	0	0	3	0	0
2	33415600	.	G	T	4	3	7	0	0	7	0	0
2	33415981	.	A	G	3	2	5	0	1	6	0	0
2	33416991	.	C	T	4	3	7	0	0	7	0	0
2	33417015	.	T	A	3	3	6	0	0	6	0	0
2	33417081	.	T	C	8	3	11	0	0	11	0	0
2	33417229	.	C	T	6	10	16	0	0	16	0	0
2	33417527	.	A	G	5	3	8	0	0	8	0	0
2	33417533	.	C	G	5	3	8	0	0	8	0	0
2	33417600	.	C	T	1	2	3	0	0	3	0	0
2	33418235	.	T	A	2	3	5	0	0	5	0	0
2	33418476	.	G	A	8	4	12	0	0	12	0	0
2	33418486	.	T	C	10	3	13	0	0	13	0	0
2	33418586	.	C	A	2	6	8	0	0	8	0	0
2	33418604	.	A	T	4	5	9	0	0	9	0	0
2	33419543	.	T	C	6	8	14	0	0	14	0	0
2	33419563	.	G	A	7	9	16	0	0	16	0	0
2	33419661	.	C	T	6	4	10	1	0	11	0	0
2	33419730	.	A	G	5	5	10	0	0	10	0	0
2	33420218	.	T	A	1	6	7	0	0	7	0	0
2	33420272	.	G	T	3	5	8	0	0	8	0	0
2	33420309	.	T	A	1	4	5	0	1	6	0	0
2	33420438	.	C	A	5	4	9	0	1	10	0	0
2	33420638	.	T	G	4	2	6	0	0	6	0	0
2	33420724	.	C	G	1	10	11	0	0	11	0	0
2	33420925	.	C	A	3	14	17	0	0	17	0	0
2	33420975	.	G	A	0	17	17	0	8	25	0	0
2	33421146	.	G	A	7	9	16	0	1	17	0	0
2	33421154	.	G	A	5	10	15	0	2	17	0	0
2	33421547	.	A	G	8	7	15	0	0	15	0	0
2	33421549	.	A	C	9	7	16	0	0	16	0	0
2	33421613	.	C	T	4	8	12	0	1	13	0	0
2	33421860	.	T	G	7	8	15	0	0	15	0	0
2	33421872	.	A	T	5	8	13	0	0	13	0	0
2	33421985	.	T	A	10	5	15	0	0	15	0	0
2	33422125	.	C	T	7	5	12	0	0	12	0	0
2	33422169	.	T	C	7	7	14	0	1	15	0	0
2	33422287	.	G	A	8	7	15	0	0	15	0	0
2	33422327	.	G	A	18	12	30	0	1	31	0	0
2	33422484	.	G	A	3	4	7	0	10	17	0	0
2	33422565	.	C	A	20	10	30	0	3	33	0	0
2	33422604	.	C	T	22	13	35	0	2	37	0	0
2	33466068	.	C	A	3	3	6	0	0	6	0	0
2	33477014	.	G	T	9	5	14	0	0	14	0	0
2	33477160	.	T	C	13	6	19	0	0	19	0	0
2	33477175	.	A	G	14	5	19	0	0	19	0	0
2	33645344	.	C	A	3	3	6	0	0	6	0	0
2	33676169	.	G	T	9	3	12	0	0	12	0	0
2	33676173	.	T	C	9	0	9	0	3	12	0	0
2	33676209	.	A	G	7	4	11	0	0	11	0	0
2	33676218	.	G	A	5	2	7	0	0	7	0	0
2	33676255	.	T	C	7	3	10	0	0	10	0	0
2	33676391	.	G	A	12	9	21	0	0	21	0	0
2	33681330	.	G	A	24	29	53	0	0	53	0	0
2	33681483	.	A	G	19	22	41	0	1	42	0	0
2	33681701	.	A	T	19	27	46	0	1	47	0	0
2	33682321	.	G	A	18	27	45	0	1	46	0	0
2	33682323	.	T	A	15	26	41	0	5	46	0	0
2	33685582	.	T	A	19	26	45	0	3	48	0	0
2	33687110	.	C	A	18	31	49	0	0	49	0	0
2	33821103	.	C	G	3	2	5	0	0	5	0	0
2	33970122	.	T	C	2	4	6	0	0	6	0	0
2	33970431	.	A	C	5	3	8	0	0	9	1	0
2	34022992	.	T	A	9	7	16	0	0	16	0	0
2	34024832	.	A	G	7	8	15	0	0	15	0	0
2	34025152	.	C	A	3	9	12	0	0	12	0	0
2	34025167	.	G	A	5	6	11	0	0	11	0	0
2	34029353	.	G	A	6	4	10	0	0	10	0	0
2	34047951	.	T	C	5	2	7	0	0	7	0	0
2	34065661	.	G	A	4	4	8	0	0	8	0	0
2	34071479	.	G	T	5	10	15	0	0	15	0	0
2	34071955	.	A	T	6	5	11	0	0	11	0	0
2	34112170	.	C	G	3	0	3	0	4	7	0	0
2	34113147	.	A	G	2	7	9	0	2	11	0	0
2	34113153	.	A	G	2	9	11	0	0	11	0	0
2	34113198	.	T	C	2	6	8	0	1	9	0	0
2	34115340	.	C	A	3	7	10	0	0	10	0	0
2	34122859	.	A	G	6	7	13	0	1	14	0	0
2	34122886	.	C	A	4	7	11	0	1	12	0	0
2	34122928	.	C	T	7	11	18	0	0	18	0	0
2	34125775	.	G	A	2	15	17	0	13	30	0	0
2	34125909	.	A	T	4	6	10	0	3	13	0	0
2	34126040	.	T	C	5	7	12	0	0	12	0	0
2	34126514	.	G	T	6	3	9	0	0	9	0	0
2	34126588	.	A	T	5	4	9	0	0	9	0	0
2	34132801	.	A	G	1	2	3	0	0	3	0	0
2	34138460	.	A	T	2	3	5	0	0	5	0	0
2	34138721	.	C	T	2	2	4	0	1	5	0	0
2	34138733	.	T	C	2	1	3	0	1	4	0	0
2	34141494	.	A	G	2	5	7	0	0	7	0	0
2	34156264	.	A	C	2	4	6	0	0	6	0	0
2	34172900	.	C	T	4	2	6	0	0	6	0	0
2	34173136	.	G	A	7	2	9	0	0	9	0	0
2	34173253	.	C	T	2	3	5	0	1	6	0	0
2	34173297	.	C	A	5	4	9	0	0	9	0	0
2	34173335	.	A	C	6	6	12	0	1	13	0	0
2	34173360	.	C	T	7	6	13	0	2	15	0	0
2	34381013	.	T	G	15	11	26	0	1	27	0	0
2	34381032	.	T	C	17	8	25	0	3	28	0	0
2	34444801	.	C	T	11	16	27	0	2	29	0	0
2	34460848	.	G	A	14	5	19	0	1	20	0	0
2	34555410	.	A	G	8	13	21	0	1	22	0	0
2	34924412	.	A	G	15	28	43	0	2	45	0	0
2	34962193	.	A	T	20	20	40	0	0	40	0	0
2	34962223	.	A	G	24	0	24	0	18	42	0	0
2	34970135	.	T	C	20	26	46	0	2	48	0	0
2	34970329	.	A	G	23	18	41	0	2	43	0	0
2	34981747	.	G	A	28	21	49	0	0	49	0	0
2	34981986	.	G	A	26	19	45	0	1	46	0	0
2	34982205	.	T	G	21	15	36	0	0	36	0	0
2	34982322	.	A	T	3	5	8	0	1	9	0	0
2	34986320	.	A	G	2	2	4	0	0	4	0	0
2	34986702	.	C	T	3	3	6	0	0	6	0	0
2	35011823	.	A	T	2	2	4	0	0	4	0	0
2	35012056	.	C	G	0	3	3	0	3	6	0	0
2	35024724	.	A	G	1	5	6	0	1	7	0	0
2	35059323	.	C	T	0	3	3	0	3	6	0	0
2	35116674	.	T	C	6	7	13	0	0	13	0	0
2	35118607	.	C	T	5	10	15	0	0	15	0	0
2	35126353	.	A	C	3	6	9	0	1	10	0	0
2	35390472	.	G	A	1	4	5	0	2	7	0	0
2	35396012	.	T	G	4	3	7	0	0	7	0	0
2	35407144	.	C	T	4	8	12	0	0	12	0	0
2	35418909	.	T	C	4	3	7	0	0	7	0	0
2	35419244	.	G	A	0	5	5	0	5	10	0	0
2	35419307	.	G	A	5	4	9	0	0	9	0	0
2	35420591	.	T	A	10	5	15	0	0	15	0	0
2	35420597	.	T	A	9	6	15	0	0	15	0	0
2	35420669	.	A	G	8	0	8	0	7	15	0	0
2	35421306	.	T	C	7	9	16	0	0	16	0	0
2	35421399	.	A	T	6	11	17	0	1	18	0	0
2	35430682	.	A	G	6	6	12	0	0	12	0	0
2	35434910	.	C	T	13	12	25	3	1	29	0	0
2	35437417	.	C	T	11	10	21	0	0	21	0	0
2	35437513	.	C	A	9	12	21	0	0	21	0	0
2	35468911	.	T	C	12	11	23	0	1	24	0	0
2	35473715	.	G	A	0	8	8	0	13	21	0	0
2	35473847	.	G	A	1	11	12	0	12	24	0	0
2	35473975	.	G	T	10	5	15	0	1	16	0	0
2	35474049	.	G	A	0	16	16	0	18	34	0	0
2	35496475	.	A	G	2	6	8	0	0	8	0	0
2	35496871	.	A	T	1	2	3	0	0	3	0	0
2	35496897	.	G	C	1	2	3	0	0	3	0	0
2	35593364	.	T	G	19	15	34	0	1	35	0	0
2	35593848	.	T	C	9	12	21	0	2	23	0	0
2	35593936	.	A	G	10	0	10	0	13	23	0	0
2	35595514	.	C	A	12	20	32	0	1	33	0	0
2	35595561	.	A	G	18	15	33	0	1	34	0	0
2	35596842	.	A	G	17	22	39	0	3	42	0	0
2	35601159	.	A	G	8	1	9	0	14	23	0	0
2	35601212	.	T	G	4	8	12	0	0	12	0	0
2	35603795	.	A	G	9	13	22	0	2	24	0	0
2	35605429	.	C	T	12	10	22	0	1	23	0	0
2	35605841	.	G	A	7	8	15	0	0	15	0	0
2	35607077	.	G	C	14	15	29	0	0	29	0	0
2	35607191	.	C	T	20	14	34	0	2	36	0	0
2	35607472	.	T	C	11	11	22	0	0	22	0	0
2	35608445	.	T	A	11	17	28	0	2	30	0	0
2	35610541	.	T	C	12	18	30	0	1	31	0	0
2	35610598	.	T	C	14	23	37	0	1	38	0	0
2	35610890	.	T	G	12	9	21	0	0	21	0	0
2	35611051	.	T	A	11	17	28	0	2	30	0	0
2	35611172	.	C	T	12	17	29	0	1	30	0	0
2	35611279	.	C	T	16	7	23	1	0	24	0	0
2	35611595	.	T	G	9	15	24	0	0	24	0	0
2	35728228	.	T	A	1	3	4	0	0	4	0	0
2	35795392	.	G	A	0	4	4	0	2	6	0	0
2	35818945	.	C	G	5	5	10	0	1	11	0	0
2	35825679	.	T	C	5	6	11	0	0	11	0	0
2	35837081	.	T	C	13	5	18	0	0	18	0	0
2	35837252	.	A	C	6	13	19	0	1	20	0	0
2	35837270	.	A	G	5	8	13	0	0	13	0	0
2	35837510	.	G	A	2	8	10	0	13	24	1	0
2	35839687	.	G	A	1	8	9	0	5	14	0	0
2	35839714	.	G	A	0	9	9	0	8	17	0	0
2	35841933	.	G	A	2	11	13	0	6	19	0	0
2	35842020	.	G	A	9	8	17	0	0	17	0	0
2	35843605	.	T	C	6	12	18	0	1	19	0	0
2	35843680	.	A	G	12	11	23	0	0	23	0	0
2	35843812	.	G	A	12	15	27	0	1	28	0	0
2	35844070	.	A	G	10	0	10	0	9	19	0	0
2	35844160	.	A	C	13	11	24	0	1	25	0	0
2	35844433	.	A	G	9	10	19	0	3	22	0	0
2	35846511	.	A	G	14	0	14	0	15	29	0	0
2	35851152	.	C	T	9	3	12	0	0	12	0	0
2	35854264	.	T	C	3	8	11	0	0	11	0	0
2	35855502	.	G	A	1	4	5	0	10	15	0	0
2	35857057	.	C	T	3	9	12	0	1	13	0	0
2	35858435	.	C	T	6	10	16	0	0	16	0	0
2	35861574	.	C	T	9	8	17	0	1	18	0	0
2	35861746	.	T	C	10	10	20	0	0	20	0	0
2	35862971	.	T	C	6	11	17	0	0	17	0	0
2	35866246	.	A	T	2	6	8	0	1	9	0	0
2	35866440	.	G	T	5	6	11	0	1	12	0	0
2	35866515	.	T	G	9	7	16	0	0	16	0	0
2	35866593	.	G	A	7	12	19	0	2	21	0	0
2	35866787	.	T	C	10	13	23	0	0	23	0	0
2	35868275	.	T	G	10	10	20	0	0	20	0	0
2	35868319	.	A	G	9	10	19	0	1	20	0	0
2	35868568	.	G	A	10	7	17	0	1	18	0	0
2	35868896	.	A	G	8	11	19	0	0	19	0	0
2	35976255	.	A	G	2	4	6	0	0	6	0	0
2	35978169	.	T	C	2	3	5	0	0	5	0	0
2	35978201	.	C	A	1	3	4	0	0	4	0	0
2	35978542	.	T	A	1	3	4	0	0	4	0	0
2	35978570	.	T	C	2	5	7	0	0	7	0	0
2	36028724	.	T	G	30	24	54	0	4	58	0	0
2	36028957	.	G	A	23	30	53	0	0	53	0	0
2	36032791	.	C	T	24	24	48	0	2	50	0	0
2	36035697	.	T	C	22	19	41	0	1	42	0	0
2	36040733	.	T	C	26	29	55	0	1	56	0	0
2	36053260	.	T	C	10	7	17	0	0	17	0	0
2	36061201	.	G	A	1	12	13	0	4	17	0	0
2	36062111	.	T	C	5	12	17	0	1	18	0	0
2	36064439	.	G	A	10	15	25	0	1	26	0	0
2	36065871	.	A	G	18	19	37	0	0	37	0	0
2	36065976	.	A	G	14	2	16	0	18	34	0	0
2	36066156	.	C	T	9	11	20	0	3	23	0	0
2	36067656	.	G	A	16	15	31	2	0	33	0	0
2	36067842	.	A	C	8	7	15	0	1	16	0	0
2	36067849	.	A	G	6	0	6	0	10	16	0	0
2	36076419	.	T	G	16	15	31	0	0	31	0	0
2	36076501	.	A	G	10	1	11	0	10	21	0	0
2	36077276	.	A	G	11	0	11	0	15	26	0	0
2	36077384	.	A	G	4	7	11	0	4	15	0	0
2	36077542	.	T	C	18	12	30	0	1	31	0	0
2	36077543	.	T	G	18	0	18	0	13	31	0	0
2	36077664	.	C	T	12	13	25	0	1	26	0	0
2	36078370	.	T	G	15	6	21	0	1	22	0	0
2	36154732	.	T	A	2	4	6	0	0	6	0	0
2	36154761	.	A	G	1	2	3	0	0	3	0	0
2	36609211	.	C	A	6	3	9	0	0	9	0	0
2	36609235	.	C	T	3	2	5	0	0	5	0	0
2	36631086	.	A	G	3	2	5	0	0	5	0	0
2	36635902	.	C	T	4	10	14	0	0	14	0	0
2	36664493	.	T	G	16	13	29	0	0	30	1	0
2	36664545	.	A	G	9	20	29	0	0	29	0	0
2	36664679	.	C	G	21	14	35	0	2	37	0	0
2	36664799	.	G	T	23	9	32	0	0	32	0	0
2	36668765	.	G	A	9	10	19	2	0	21	0	0
2	36670595	.	A	G	5	11	16	0	1	17	0	0
2	36670778	.	G	A	6	7	13	0	1	14	0	0
2	36670785	.	T	G	6	7	13	0	2	15	0	0
2	36671026	.	C	A	5	5	10	0	0	10	0	0
2	36673261	.	G	A	12	9	21	0	0	21	0	0
2	36673264	.	T	C	11	8	19	0	0	19	0	0
2	36673643	.	T	A	11	11	22	0	0	22	0	0
2	36673805	.	C	T	11	5	16	0	1	18	1	0
2	36673866	.	G	T	26	10	36	0	1	37	0	0
2	36694730	.	A	G	1	3	4	0	0	4	0	0
2	36694736	.	C	T	1	3	4	0	0	4	0	0
2	36701395	.	G	A	2	2	4	0	0	4	0	0
2	36708172	.	G	A	0	2	2	0	2	4	0	0
2	36721028	.	C	A	1	3	4	0	0	4	0	0
2	36721057	.	T	C	1	2	3	0	0	3	0	0
2	36722846	.	T	C	16	13	29	0	0	29	0	0
2	36724384	.	A	C	8	22	30	0	0	30	0	0
2	36727360	.	A	T	9	20	29	0	1	30	0	0
2	36816003	.	A	G	14	9	23	0	0	23	0	0
2	36816120	.	T	G	8	6	14	0	0	14	0	0
2	36816312	.	T	C	4	3	7	0	0	7	0	0
2	36816495	.	T	G	8	4	12	0	0	12	0	0
2	36816501	.	T	G	8	4	12	0	0	12	0	0
2	36816828	.	T	C	3	5	8	0	0	8	0	0
2	36817317	.	T	C	9	7	16	0	1	17	0	0
2	36817362	.	G	A	9	5	14	0	1	15	0	0
2	36819320	.	C	T	9	5	14	0	0	14	0	0
2	36819587	.	A	G	2	4	6	0	0	6	0	0
2	36819596	.	A	T	1	2	3	0	1	4	0	0
2	36828901	.	C	G	5	0	5	0	9	14	0	0
2	36833378	.	C	A	4	2	6	0	0	6	0	0
2	36834497	.	C	A	10	10	20	0	0	20	0	0
2	36834542	.	C	T	6	11	17	0	1	18	0	0
2	36834686	.	G	A	7	9	16	0	0	16	0	0
2	36838094	.	C	T	4	11	15	0	1	16	0	0
2	36838274	.	G	A	9	13	22	0	0	22	0	0
2	36838322	.	T	C	9	17	26	0	1	27	0	0
2	36838355	.	A	G	11	1	12	0	10	22	0	0
2	36840594	.	C	T	9	10	19	0	1	20	0	0
2	36840789	.	C	T	10	5	15	0	3	18	0	0
2	36841523	.	A	G	8	6	14	0	0	14	0	0
2	36844035	.	G	T	2	6	8	0	2	10	0	0
2	36852056	.	C	G	13	17	30	0	1	31	0	0
2	36853630	.	C	T	13	17	30	0	3	33	0	0
2	36853936	.	T	C	14	8	22	0	1	23	0	0
2	36853955	.	A	C	12	8	20	0	0	20	0	0
2	36854173	.	T	C	12	13	25	0	0	25	0	0
2	36854184	.	C	A	11	10	21	0	0	21	0	0
2	36854310	.	T	A	2	2	4	0	0	4	0	0
2	36862501	.	A	G	4	4	8	0	2	10	0	0
2	36862726	.	T	C	8	5	13	0	0	13	0	0
2	36889867	.	A	T	9	3	12	0	1	13	0	0
2	36892504	.	C	T	6	6	12	0	0	12	0	0
2	36892518	.	A	G	10	6	16	0	1	17	0	0
2	36892857	.	A	G	5	5	10	0	2	12	0	0
2	36895218	.	T	A	1	2	3	1	0	4	0	0
2	36895230	.	C	T	1	3	4	1	0	5	0	0
2	36921495	.	A	T	11	16	27	0	0	27	0	0
2	36921579	.	G	C	13	0	13	0	14	27	0	0
2	36921588	.	A	G	14	14	28	0	1	29	0	0
2	36922595	.	G	A	9	9	18	0	0	18	0	0
2	36922604	.	A	T	8	8	16	0	1	17	0	0
2	36922883	.	C	T	10	10	20	0	1	21	0	0
2	36922988	.	A	T	10	8	18	0	0	18	0	0
2	36923167	.	T	C	10	0	10	0	11	21	0	0
2	36923300	.	A	T	11	12	23	0	0	24	1	0
2	36924020	.	G	T	6	5	11	0	0	11	0	0
2	36924051	.	T	C	4	0	4	0	4	8	0	0
2	36924739	.	T	C	12	6	18	0	0	18	0	0
2	36925218	.	T	C	6	5	11	0	0	11	0	0
2	36925931	.	A	G	10	7	17	0	1	18	0	0
2	36926239	.	T	G	4	2	6	0	1	8	1	0
2	36932226	.	A	C	5	0	5	0	9	14	0	0
2	36939965	.	T	A	4	2	6	0	0	6	0	0
2	36941365	.	A	G	6	2	8	0	0	8	0	0
2	36990050	.	A	T	15	26	41	0	0	41	0	0
2	36990185	.	A	C	25	17	42	0	1	43	0	0
2	36990283	.	A	T	20	23	43	0	1	44	0	0
2	36990294	.	A	T	19	21	40	0	0	40	0	0
2	36990363	.	A	G	24	23	47	0	1	48	0	0
2	36990458	.	A	G	31	30	61	0	1	62	0	0
2	36992795	.	T	C	23	1	24	0	22	46	0	0
2	37043708	.	A	C	4	0	4	0	6	10	0	0
2	37059643	.	A	G	7	8	15	0	0	15	0	0
2	37059835	.	T	G	3	7	10	0	0	10	0	0
2	37059943	.	G	A	8	9	17	0	0	17	0	0
2	37094361	.	A	G	1	7	8	0	0	8	0	0
2	37123507	.	T	C	14	12	26	0	1	27	0	0
2	37123901	.	T	C	13	12	25	0	1	27	1	0
2	37124181	.	A	C	24	16	40	0	2	42	0	0
2	37124509	.	A	G	14	9	23	0	2	25	0	0
2	37124761	.	C	T	7	10	17	0	0	17	0	0
2	37124821	.	C	A	13	15	28	0	0	28	0	0
2	37124961	.	C	G	14	18	32	0	0	32	0	0
2	37128450	.	C	T	20	13	33	0	2	35	0	0
2	37138899	.	C	A	0	2	2	0	2	4	0	0
2	37141002	.	G	A	3	15	18	0	12	30	0	0
2	37145793	.	T	A	12	15	27	0	0	27	0	0
2	37145820	.	G	C	15	16	31	0	0	31	0	0
2	37146474	.	C	T	14	15	29	0	1	30	0	0
2	37146512	.	A	G	9	0	9	0	14	23	0	0
2	37189834	.	T	C	9	7	16	0	0	16	0	0
2	37191964	.	A	G	16	11	27	0	1	28	0	0
2	37193743	.	G	A	12	19	31	0	2	33	0	0
2	37195406	.	C	A	15	18	33	0	2	35	0	0
2	37195472	.	A	C	15	19	34	0	2	36	0	0
2	37201513	.	G	A	19	21	40	0	2	42	0	0
2	37205437	.	T	G	22	0	22	1	25	48	0	0
2	37257571	.	A	G	12	18	30	0	0	30	0	0
2	37261326	.	A	T	17	11	28	0	2	30	0	0
2	37263874	.	C	A	22	23	45	0	2	47	0	0
2	37264364	.	A	T	24	6	30	0	0	30	0	0
2	37264423	.	G	T	14	14	28	0	1	30	1	0
2	37264693	.	T	C	14	16	30	0	3	33	0	0
2	37264856	.	T	A	17	19	36	0	0	36	0	0
2	37264889	.	T	G	19	18	37	0	0	37	0	0
2	37264915	.	T	A	15	17	32	0	1	33	0	0
2	37264928	.	A	T	14	13	27	0	2	29	0	0
2	37265021	.	C	T	13	11	24	0	0	24	0	0
2	37265125	.	T	A	6	9	15	0	2	17	0	0
2	37265302	.	G	A	16	12	28	0	1	29	0	0
2	37265409	.	T	A	21	13	34	0	2	36	0	0
2	37267319	.	G	T	1	3	4	0	0	4	0	0
2	37267831	.	T	A	7	3	10	0	0	10	0	0
2	37272392	.	A	G	7	5	12	0	0	12	0	0
2	37274451	.	C	T	5	6	11	0	1	12	0	0
2	37274483	.	T	C	5	6	11	0	0	11	0	0
2	37274504	.	A	G	4	7	11	0	1	12	0	0
2	37277452	.	C	T	0	3	3	0	4	7	0	0
2	37280268	.	T	C	6	5	11	0	0	11	0	0
2	37280399	.	A	G	5	5	10	0	0	10	0	0
2	37280457	.	C	T	2	4	6	0	8	14	0	0
2	37280580	.	C	T	6	4	10	0	2	12	0	0
2	37281716	.	T	G	4	2	6	0	0	6	0	0
2	37307422	.	T	A	18	18	36	0	1	37	0	0
2	37307557	.	T	C	10	12	22	1	1	24	0	0
2	37322252	.	G	A	8	12	20	0	0	20	0	0
2	37365855	.	C	T	1	13	14	0	18	32	0	0
2	37366234	.	A	G	6	11	17	0	0	17	0	0
2	37366496	.	A	T	9	17	26	0	3	29	0	0
2	37366526	.	T	C	11	13	24	0	1	25	0	0
2	37366810	.	G	C	10	13	23	0	0	23	0	0
2	37366815	.	G	A	10	14	24	0	0	24	0	0
2	37375027	.	G	A	8	21	29	0	1	30	0	0
2	37379482	.	A	G	16	17	33	0	0	33	0	0
2	37383444	.	A	G	12	12	24	0	0	24	0	0
2	37391319	.	T	C	3	0	3	0	6	9	0	0
2	37424290	.	G	A	4	9	13	0	0	13	0	0
2	37424499	.	G	C	5	6	11	0	0	11	0	0
2	37428557	.	C	T	5	5	10	0	0	10	0	0
2	37428741	.	G	A	7	6	13	0	1	14	0	0
2	37428804	.	A	G	8	8	16	0	1	17	0	0
2	37433540	.	C	T	5	9	14	0	0	14	0	0
2	37436778	.	T	A	9	14	23	0	3	26	0	0
2	37455811	.	A	G	2	2	4	0	0	4	0	0
2	37458464	.	G	C	4	3	7	3	0	10	0	0
2	37458522	.	G	A	4	5	9	2	0	11	0	0
2	37460880	.	C	T	0	3	3	0	2	5	0	0
2	37461082	.	C	G	0	2	2	0	2	4	0	0
2	37469926	.	G	A	25	21	46	0	2	48	0	0
2	37469962	.	A	G	31	15	46	0	0	46	0	0
2	37470001	.	A	G	28	14	42	0	0	42	0	0
2	37471495	.	C	G	20	15	35	0	1	36	0	0
2	37502213	.	G	A	5	14	19	0	3	22	0	0
2	37502412	.	T	G	4	11	15	0	0	15	0	0
2	37502834	.	G	A	3	7	10	0	1	11	0	0
2	37545462	.	A	G	11	4	15	0	0	15	0	0
2	37545473	.	C	G	10	6	16	0	0	16	0	0
2	37545628	.	G	A	9	6	15	0	0	15	0	0
2	37546225	.	T	C	12	0	12	0	9	21	0	0
2	37547874	.	T	C	5	6	11	0	0	11	0	0
2	37554817	.	G	A	7	5	12	0	2	14	0	0
2	37555512	.	A	G	9	6	15	0	0	15	0	0
2	37559306	.	C	T	10	4	14	0	0	14	0	0
2	37559318	.	G	A	10	4	14	0	1	15	0	0
2	37567233	.	T	G	2	5	7	0	0	7	0	0
2	37567609	.	A	T	7	5	12	0	0	12	0	0
2	37577967	.	C	T	1	2	3	0	0	3	0	0
2	37632100	.	C	T	8	4	12	0	0	12	0	0
2	37632381	.	C	A	4	4	8	0	0	8	0	0
2	37632390	.	T	G	3	5	8	0	1	9	0	0
2	37632469	.	A	G	2	2	4	0	1	5	0	0
2	37632593	.	T	C	3	2	5	0	0	5	0	0
2	37632737	.	A	C	5	5	10	0	0	10	0	0
2	37656372	.	A	G	8	5	13	0	1	14	0	0
2	37656498	.	T	A	4	5	9	0	1	10	0	0
2	37656580	.	G	C	4	3	7	0	0	7	0	0
2	37664128	.	G	A	14	7	21	0	1	22	0	0
2	37707452	.	G	A	1	2	3	0	0	3	0	0
2	37707552	.	T	C	1	0	1	0	3	4	0	0
2	37754405	.	T	C	4	5	9	0	0	9	0	0
2	37778966	.	A	T	3	2	5	0	0	5	0	0
2	37815692	.	T	C	1	2	3	0	0	3	0	0
2	37823104	.	C	T	8	9	17	0	0	17	0	0
2	37824133	.	G	A	3	3	6	1	0	7	0	0
2	37826933	.	T	C	2	2	4	0	0	4	0	0
2	37827612	.	T	A	1	2	3	0	0	3	0	0
2	37827977	.	C	T	2	3	5	0	6	11	0	0
2	37830123	.	C	T	1	4	5	0	6	11	0	0
2	37830908	.	G	T	2	2	4	0	1	5	0	0
2	37831076	.	T	C	8	3	11	0	0	11	0	0
2	37833739	.	A	C	3	4	7	0	2	9	0	0
2	37834433	.	T	C	4	4	8	0	0	8	0	0
2	37834703	.	C	T	6	5	11	0	0	11	0	0
2	37837278	.	G	A	2	4	6	0	0	6	0	0
2	37837577	.	A	G	5	3	8	0	0	8	0	0
2	37837608	.	A	G	3	4	7	0	0	7	0	0
2	37838155	.	G	A	0	6	6	0	2	8	0	0
2	37840741	.	G	T	5	5	10	0	1	11	0	0
2	37841270	.	T	C	3	4	7	0	0	7	0	0
2	37846286	.	A	G	2	5	7	0	0	7	0	0
2	37846391	.	A	G	1	0	1	0	3	4	0	0
2	37846397	.	A	T	1	3	4	0	0	4	0	0
2	37846513	.	C	T	2	2	4	0	0	4	0	0
2	37846612	.	T	C	4	5	9	0	0	9	0	0
2	37846705	.	C	T	1	2	3	0	0	3	0	0
2	37867148	.	C	T	7	6	13	0	0	13	0	0
2	37867165	.	C	T	0	7	7	0	8	15	0	0
2	37897115	.	T	C	1	4	5	0	0	5	0	0
2	37990120	.	T	G	3	3	6	0	0	6	0	0
2	37990315	.	A	G	3	3	6	0	1	7	0	0
2	37998116	.	G	A	17	27	44	0	1	45	0	0
2	38000133	.	G	T	19	26	45	0	0	45	0	0
2	38000185	.	G	A	24	21	45	0	1	46	0	0
2	38004485	.	G	A	0	2	2	0	6	8	0	0
2	38004500	.	G	T	5	3	8	0	1	9	0	0
2	38008491	.	G	A	17	4	21	0	1	22	0	0
2	38008916	.	C	T	11	6	17	0	0	17	0	0
2	38018076	.	G	A	11	7	18	0	0	18	0	0
2	38027068	.	G	T	6	12	18	0	1	19	0	0
2	38032270	.	G	A	19	13	32	0	2	34	0	0
2	38033937	.	G	A	11	11	22	0	1	23	0	0
2	38033979	.	C	T	4	12	16	0	1	17	0	0
2	38055638	.	G	C	4	3	7	0	0	7	0	0
2	38055662	.	C	G	6	0	6	0	4	10	0	0
2	38056837	.	T	A	2	8	10	0	0	10	0	0
2	38056840	.	A	G	2	0	2	0	8	10	0	0
2	38064446	.	G	A	0	2	2	0	5	7	0	0
2	38064638	.	T	C	5	3	8	0	0	8	0	0
2	38064903	.	T	C	4	3	7	0	0	7	0	0
2	38065056	.	G	A	0	4	4	0	7	11	0	0
2	38065450	.	C	T	2	2	4	0	0	4	0	0
2	38065676	.	G	T	3	2	5	0	0	5	0	0
2	38068593	.	A	G	8	11	19	0	1	20	0	0
2	38068677	.	T	A	10	17	27	0	1	28	0	0
2	38072328	.	T	C	10	12	22	0	0	22	0	0
2	38072460	.	C	T	12	11	23	0	1	24	0	0
2	38072463	.	G	A	12	10	22	0	2	24	0	0
2	38072547	.	C	T	3	6	9	0	15	24	0	0
2	38072670	.	G	T	16	11	27	0	0	27	0	0
2	38072703	.	G	A	11	14	25	0	1	26	0	0
2	38073092	.	A	G	19	9	28	0	0	28	0	0
2	38076425	.	C	T	11	6	17	0	0	17	0	0
2	38076579	.	A	G	5	8	13	0	0	13	0	0
2	38076754	.	G	A	5	2	7	0	0	7	0	0
2	38076884	.	A	T	9	9	18	0	1	19	0	0
2	38078188	.	C	T	9	4	13	0	0	13	0	0
2	38078227	.	G	A	4	3	7	0	1	8	0	0
2	38087879	.	T	A	6	5	11	0	0	11	0	0
2	38088096	.	A	T	11	5	16	0	1	17	0	0
2	38088329	.	C	G	2	6	8	0	0	8	0	0
2	38088454	.	A	G	20	9	29	0	2	31	0	0
2	38088475	.	A	G	18	10	28	0	1	29	0	0
2	38088535	.	C	T	8	12	20	0	1	21	0	0
2	38092067	.	G	T	6	6	12	0	0	12	0	0
2	38095343	.	A	T	13	13	26	0	1	27	0	0
2	38098442	.	G	A	4	6	10	0	0	10	0	0
2	38098810	.	G	A	12	10	22	0	0	22	0	0
2	38098871	.	C	T	1	10	11	0	7	18	0	0
2	38101590	.	G	A	7	6	13	0	3	16	0	0
2	38101616	.	T	G	5	10	15	0	1	16	0	0
2	38102335	.	A	T	8	7	15	0	0	15	0	0
2	38106744	.	A	G	7	4	11	0	0	11	0	0
2	38106816	.	G	A	5	4	9	0	0	9	0	0
2	38106825	.	T	C	4	7	11	0	0	11	0	0
2	38109319	.	C	T	0	2	2	0	4	6	0	0
2	38112878	.	A	G	4	4	8	0	0	8	0	0
2	38112907	.	T	A	5	4	9	0	0	9	0	0
2	38112917	.	T	C	4	3	7	0	0	7	0	0
2	38114196	.	G	T	2	2	4	0	2	6	0	0
2	38114795	.	C	T	2	10	12	0	0	12	0	0
2	38115820	.	G	A	4	3	7	0	1	8	0	0
2	38115823	.	G	C	5	0	5	0	3	8	0	0
2	38121536	.	C	T	22	29	51	0	3	54	0	0
2	38121558	.	C	T	27	28	55	0	1	56	0	0
2	38123931	.	G	T	32	26	58	1	2	61	0	0
2	38124030	.	A	G	28	29	57	0	3	60	0	0
2	38125620	.	A	G	1	4	5	0	0	5	0	0
2	38151134	.	C	T	5	7	12	0	0	12	0	0
2	38151154	.	T	A	8	4	12	0	0	12	0	0
2	38151478	.	G	A	0	9	9	0	9	18	0	0
2	38151849	.	T	A	7	7	14	0	0	14	0	0
2	38152523	.	C	T	14	11	25	0	0	25	0	0
2	38152717	.	C	T	9	10	19	0	1	20	0	0
2	38153069	.	T	A	9	10	19	0	0	20	1	0
2	38153884	.	C	T	6	4	10	0	0	10	0	0
2	38153929	.	G	A	12	5	17	0	0	17	0	0
2	38154098	.	T	C	14	8	22	0	0	22	0	0
2	38154107	.	G	A	11	8	19	0	0	19	0	0
2	38154177	.	C	A	5	3	8	0	0	8	0	0
2	38154307	.	A	G	7	6	13	0	1	14	0	0
2	38154879	.	A	T	16	7	23	0	0	23	0	0
2	38155022	.	T	C	2	2	4	0	0	4	0	0
2	38155339	.	G	C	7	7	14	0	0	14	0	0
2	38155340	.	T	C	7	5	12	0	1	13	0	0
2	38155479	.	G	A	2	10	12	0	7	19	0	0
2	38155511	.	G	A	5	7	12	0	1	13	0	0
2	38155651	.	G	T	8	6	14	0	0	14	0	0
2	38155802	.	C	T	7	6	13	0	1	14	0	0
2	38156165	.	C	T	5	5	10	0	0	10	0	0
2	38174752	.	C	A	1	2	3	0	0	3	0	0
2	38174753	.	A	C	1	2	3	0	0	3	0	0
2	38181561	.	G	T	0	3	3	0	4	7	0	0
2	38182016	.	C	T	1	4	5	0	0	5	0	0
2	38182416	.	C	T	0	3	3	0	2	5	0	0
2	38198118	.	G	T	20	20	40	0	3	43	0	0
2	38198626	.	C	T	33	16	49	0	0	49	0	0
2	38198627	.	T	G	32	16	48	0	1	49	0	0
2	38199761	.	C	T	25	19	44	0	0	44	0	0
2	38199764	.	G	T	24	18	42	0	1	43	0	0
2	38200181	.	A	G	17	22	39	0	1	40	0	0
2	38200830	.	G	A	19	19	38	0	1	40	1	0
2	38201073	.	T	C	25	2	27	0	16	43	0	0
2	38201864	.	C	A	18	17	35	0	0	35	0	0
2	38202356	.	C	T	20	21	41	0	2	43	0	0
2	38202890	.	C	A	27	44	71	1	0	72	0	0
2	38204025	.	C	A	0	4	4	0	4	8	0	0
2	38204177	.	C	T	6	4	10	0	1	11	0	0
2	38213642	.	G	T	18	14	32	0	6	38	0	0
2	38214094	.	C	T	3	20	23	0	24	47	0	0
2	38214102	.	C	T	26	16	42	0	3	45	0	0
2	38214164	.	C	T	25	28	53	0	1	54	0	0
2	38214720	.	C	T	30	14	44	1	1	46	0	0
2	38215391	.	G	A	23	16	39	0	6	45	0	0
2	38215860	.	C	T	1	24	25	0	19	44	0	0
2	38216481	.	C	T	22	16	38	0	8	46	0	0
2	38216502	.	C	T	22	16	38	0	5	43	0	0
2	38216580	.	T	C	21	18	39	0	2	41	0	0
2	38229906	.	C	T	1	2	3	0	0	3	0	0
2	38261830	.	T	C	15	11	26	0	0	26	0	0
2	38265504	.	G	A	14	12	26	0	2	28	0	0
2	38266439	.	C	T	5	11	16	0	0	16	0	0
2	38269105	.	G	A	12	8	20	0	0	20	0	0
2	38269114	.	T	G	8	10	18	0	0	18	0	0
2	38269355	.	G	A	11	6	17	0	0	17	0	0
2	38269435	.	T	C	2	4	6	2	1	9	0	0
2	38269446	.	A	T	2	5	7	2	1	10	0	0
2	38288796	.	A	T	11	13	24	0	0	24	0	0
2	38289260	.	G	A	21	13	34	0	0	34	0	0
2	38289393	.	C	T	11	14	25	0	0	25	0	0
2	38289494	.	T	A	13	8	21	0	0	21	0	0
2	38289496	.	A	G	13	1	14	0	7	21	0	0
2	38289633	.	G	A	4	5	9	0	1	10	0	0
2	38362104	.	A	G	3	2	5	0	0	5	0	0
2	38362116	.	T	C	3	0	3	0	3	6	0	0
2	38373380	.	T	C	19	18	37	0	3	40	0	0
2	38378888	.	T	A	22	17	39	0	2	41	0	0
2	38391846	.	T	C	21	12	33	1	0	34	0	0
2	38391847	.	T	C	21	12	33	1	1	35	0	0
2	38391945	.	C	T	18	26	44	0	1	45	0	0
2	38556203	.	C	A	9	5	14	0	1	15	0	0
2	38687004	.	T	C	13	7	20	0	1	21	0	0
2	38689219	.	C	T	11	13	24	0	0	24	0	0
2	38695337	.	C	T	11	11	22	0	1	23	0	0
2	38699469	.	C	T	9	6	15	0	1	16	0	0
2	38699526	.	G	A	10	8	18	0	1	19	0	0
2	38708714	.	A	T	9	16	25	0	0	25	0	0
2	38708744	.	C	T	17	6	23	0	2	26	1	0
2	38708780	.	T	A	19	12	31	0	0	31	0	0
2	38791377	.	G	A	0	2	2	0	3	5	0	0
2	38791386	.	G	T	0	2	2	0	3	5	0	0
2	38804272	.	T	C	3	2	5	0	0	5	0	0
2	38847349	.	C	T	4	5	9	0	0	9	0	0
2	38852648	.	T	C	5	7	12	0	0	12	0	0
2	38861234	.	C	T	6	6	12	0	0	12	0	0
2	38862666	.	A	T	7	5	12	0	1	13	0	0
2	38862880	.	G	A	4	5	9	0	0	9	0	0
2	38880942	.	C	T	5	9	14	0	0	14	0	0
2	38880999	.	G	A	7	8	15	0	1	16	0	0
2	38881164	.	A	G	7	5	12	0	1	13	0	0
2	38887527	.	A	G	5	4	9	0	1	10	0	0
2	38887772	.	C	A	6	11	17	0	0	17	0	0
2	38887932	.	G	C	1	3	4	0	0	4	0	0
2	38888157	.	T	A	9	8	17	0	0	17	0	0
2	38888170	.	T	C	9	9	18	0	0	18	0	0
2	38888235	.	A	G	12	10	22	0	0	22	0	0
2	38888272	.	T	C	14	5	19	0	3	22	0	0
2	38888517	.	A	C	9	9	18	0	2	20	0	0
2	38888710	.	G	A	1	3	4	0	0	4	0	0
2	38888789	.	C	T	4	4	8	0	0	8	0	0
2	38888820	.	A	C	7	7	14	0	0	14	0	0
2	38888895	.	T	C	8	4	12	0	1	13	0	0
2	38888939	.	G	T	4	6	10	0	0	10	0	0
2	38888953	.	T	C	6	4	10	0	0	10	0	0
2	38889034	.	A	G	1	2	3	0	0	3	0	0
2	38889369	.	A	G	12	1	13	0	15	28	0	0
2	38889389	.	G	T	11	12	23	0	2	25	0	0
2	38889487	.	A	G	12	0	12	0	13	25	0	0
2	38889523	.	G	C	0	11	11	0	8	19	0	0
2	38889832	.	G	T	3	6	9	1	1	11	0	0
2	38890481	.	T	C	7	12	19	0	0	19	0	0
2	38890495	.	C	A	7	10	17	0	0	17	0	0
2	38926665	.	C	G	9	6	15	0	0	15	0	0
2	38926780	.	A	C	12	4	16	0	0	16	0	0
2	38926787	.	T	C	11	3	14	0	1	15	0	0
2	38927465	.	A	G	9	0	9	0	11	20	0	0
2	38977157	.	G	A	5	6	11	0	0	11	0	0
2	38977159	.	T	C	5	6	11	0	0	11	0	0
2	38977266	.	C	A	5	7	12	0	0	12	0	0
2	38977269	.	A	G	5	6	11	0	0	11	0	0
2	38997627	.	G	T	21	17	38	0	1	39	0	0
2	38997631	.	A	G	22	19	41	0	1	42	0	0
2	38998100	.	G	T	21	24	45	0	2	47	0	0
2	39001713	.	G	A	14	19	33	0	4	37	0	0
2	39001975	.	A	G	18	22	40	1	0	41	0	0
2	39001993	.	G	T	25	14	39	1	0	40	0	0
2	39002038	.	G	A	19	9	28	1	1	30	0	0
2	39002164	.	C	T	0	18	18	0	13	31	0	0
2	39002546	.	G	C	16	18	34	0	0	35	1	0
2	39002692	.	T	C	15	8	23	0	1	24	0	0
2	39005438	.	C	T	24	18	42	0	3	45	0	0
2	39005447	.	A	G	25	18	43	0	0	43	0	0
2	39011421	.	T	A	12	16	28	0	1	29	0	0
2	39013488	.	T	C	17	0	17	0	13	30	0	0
2	39013572	.	A	T	16	14	30	0	0	30	0	0
2	39015083	.	G	A	9	10	19	0	0	19	0	0
2	39015094	.	A	G	7	9	16	0	0	16	0	0
2	39028774	.	G	T	8	3	11	0	0	11	0	0
2	39028811	.	G	T	2	5	7	0	0	7	0	0
2	39036516	.	G	T	3	10	13	0	1	14	0	0
2	39063227	.	C	A	0	2	2	1	1	4	0	0
2	39068306	.	T	A	1	4	5	0	0	5	0	0
2	39068409	.	C	A	3	9	12	0	1	13	0	0
2	39068462	.	C	T	7	3	10	0	0	10	0	0
2	39068537	.	G	A	3	2	5	0	0	5	0	0
2	39108418	.	T	G	4	0	4	0	4	8	0	0
2	39386628	.	G	A	3	4	7	0	0	7	0	0
2	39386670	.	A	G	3	0	3	0	4	7	0	0
2	39426580	.	T	G	6	0	6	0	5	11	0	0
2	39434308	.	G	T	5	3	8	0	0	8	0	0
2	39497992	.	C	T	8	3	11	0	1	12	0	0
2	39498061	.	A	G	11	5	16	0	1	17	0	0
2	39506808	.	T	G	3	0	3	0	5	8	0	0
2	39532346	.	C	A	8	8	16	0	0	16	0	0
2	39549780	.	C	T	8	5	13	0	0	13	0	0
2	39549898	.	A	G	8	4	12	0	0	12	0	0
2	39550007	.	A	G	10	3	13	0	0	13	0	0
2	39550307	.	T	C	9	5	14	0	1	15	0	0
2	39550343	.	T	A	8	6	14	0	0	14	0	0
2	39550380	.	A	C	7	7	14	0	0	14	0	0
2	39550460	.	A	T	8	4	12	0	0	12	0	0
2	39550494	.	C	T	6	7	13	0	0	13	0	0
2	39550627	.	G	A	8	6	14	0	0	14	0	0
2	39550677	.	T	C	9	9	18	0	0	18	0	0
2	39550755	.	C	T	4	6	10	0	0	10	0	0
2	39550761	.	A	C	3	5	8	0	0	8	0	0
2	39550854	.	G	A	0	9	9	0	7	16	0	0
2	39550901	.	C	T	5	7	12	0	0	12	0	0
2	39551023	.	T	C	6	4	10	0	0	10	0	0
2	39551185	.	T	C	7	10	17	1	2	20	0	0
2	39551213	.	G	A	0	10	10	1	8	19	0	0
2	39551304	.	C	T	6	5	11	0	0	11	0	0
2	39551421	.	T	C	5	6	11	0	0	11	0	0
2	39551529	.	G	A	8	3	11	0	0	11	0	0
2	39551538	.	A	G	4	0	4	0	6	10	0	0
2	39551581	.	C	G	3	2	5	0	0	5	0	0
2	39551803	.	T	A	1	4	5	0	0	5	0	0
2	39551869	.	T	G	4	3	7	0	1	8	0	0
2	39553173	.	A	C	7	3	10	0	0	10	0	0
2	39553209	.	C	T	10	7	17	0	1	18	0	0
2	39553213	.	A	G	8	7	15	0	3	18	0	0
2	39553279	.	G	A	4	9	13	0	0	13	0	0
2	39553283	.	A	T	10	4	14	0	0	14	0	0
2	39553351	.	G	A	4	9	13	0	0	13	0	0
2	39553628	.	T	A	8	1	9	0	1	10	0	0
2	39553632	.	T	A	9	1	10	0	1	11	0	0
2	39554098	.	A	C	6	7	13	0	0	13	0	0
2	39554169	.	C	A	3	10	13	0	0	13	0	0
2	39554180	.	A	C	4	10	14	0	0	14	0	0
2	39554514	.	A	C	7	6	13	0	0	13	0	0
2	39555273	.	A	G	8	7	15	2	1	18	0	0
2	39584287	.	A	T	1	6	7	0	0	7	0	0
2	39584370	.	T	C	5	0	5	0	5	10	0	0
2	39584465	.	A	T	3	4	7	0	1	8	0	0
2	39584466	.	T	A	3	5	8	0	0	8	0	0
2	39585130	.	G	A	7	5	12	0	2	14	0	0
2	39649553	.	G	A	6	7	13	0	0	13	0	0
2	39649589	.	C	T	5	10	15	0	1	16	0	0
2	39649592	.	C	T	11	3	14	0	0	14	0	0
2	39649655	.	G	C	9	2	11	0	6	17	0	0
2	39649673	.	C	T	9	10	19	0	2	21	0	0
2	39649799	.	C	T	12	7	19	0	0	19	0	0
2	39650108	.	T	C	8	3	11	0	0	11	0	0
2	39650191	.	T	C	6	6	12	0	3	15	0	0
2	39731567	.	C	T	14	12	26	0	1	27	0	0
2	39732139	.	C	A	14	3	17	0	0	17	0	0
2	39732157	.	G	A	13	3	16	0	1	17	0	0
2	39732710	.	T	C	9	5	14	0	0	14	0	0
2	39732818	.	C	T	2	7	9	0	7	16	0	0
2	39732833	.	G	A	9	4	13	0	0	13	0	0
2	39732955	.	A	G	9	11	20	0	0	20	0	0
2	39732967	.	T	G	9	14	23	0	0	23	0	0
2	39733130	.	T	A	13	19	32	0	5	37	0	0
2	39733531	.	C	T	16	15	31	0	0	31	0	0
2	39734298	.	A	G	8	13	21	1	2	24	0	0
2	39734396	.	G	A	22	16	38	0	1	39	0	0
2	39734410	.	A	T	22	14	36	0	0	36	0	0
2	39734444	.	A	G	21	18	39	0	0	39	0	0
2	39734494	.	T	A	23	16	39	0	0	39	0	0
2	39735568	.	T	C	13	0	13	0	22	35	0	0
2	39753775	.	C	A	1	10	11	0	6	17	0	0
2	39758810	.	A	C	6	0	6	0	7	13	0	0
2	39759009	.	G	A	14	10	24	0	0	24	0	0
2	39759044	.	A	G	6	5	11	0	0	11	0	0
2	40067983	.	A	G	6	7	13	0	3	16	0	0
2	40068188	.	C	T	17	31	48	0	1	49	0	0
2	40068238	.	G	A	20	22	42	0	2	44	0	0
2	40068279	.	G	A	20	23	43	0	2	45	0	0
2	40068281	.	T	G	22	23	45	0	1	46	0	0
2	40068372	.	G	A	24	23	47	1	2	50	0	0
2	40068386	.	G	A	27	23	50	2	2	54	0	0
2	40069392	.	G	A	22	16	38	0	1	39	0	0
2	40070040	.	A	G	15	15	30	0	0	30	0	0
2	40074474	.	G	A	18	15	33	0	1	34	0	0
2	40088719	.	G	A	14	12	26	0	0	26	0	0
2	40088785	.	G	A	12	10	22	0	1	23	0	0
2	40090490	.	C	T	11	15	26	0	1	27	0	0
2	40094202	.	A	T	17	16	33	0	1	34	0	0
2	40094217	.	G	C	15	13	28	1	1	30	0	0
2	40100281	.	G	A	18	6	24	0	3	27	0	0
2	40131941	.	G	C	11	8	19	0	1	20	0	0
2	40132034	.	C	T	12	6	18	0	0	18	0	0
2	40134719	.	G	A	13	6	19	0	0	19	0	0
2	40135884	.	G	A	16	9	25	0	0	25	0	0
2	40342644	.	T	C	13	8	21	0	1	22	0	0
2	40342776	.	T	C	9	5	14	0	0	14	0	0
2	40342875	.	G	T	6	8	14	0	0	14	0	0
2	40343124	.	G	A	11	6	17	0	0	17	0	0
2	40407135	.	A	G	6	8	14	0	0	14	0	0
2	40412057	.	C	A	3	14	17	0	0	17	0	0
2	40469097	.	T	C	14	6	20	0	0	20	0	0
2	40500542	.	T	C	7	6	13	0	0	13	0	0
2	40500596	.	T	C	5	10	15	0	0	15	0	0
2	40507030	.	T	C	10	9	19	0	0	19	0	0
2	40507060	.	A	G	13	11	24	0	0	24	0	0
2	40513998	.	C	T	5	11	16	0	1	17	0	0
2	40831047	.	A	G	5	4	9	0	0	9	0	0
2	40831103	.	T	C	2	0	2	0	6	8	0	0
2	40831119	.	C	A	1	5	6	0	0	6	0	0
2	40831176	.	A	T	3	4	7	0	0	7	0	0
2	40831197	.	C	T	0	4	4	0	2	6	0	0
2	40831613	.	A	T	6	4	10	0	0	10	0	0
2	40831797	.	C	T	7	2	9	0	0	9	0	0
2	40831822	.	T	A	4	3	7	0	1	8	0	0
2	40831974	.	C	G	3	3	6	0	0	6	0	0
2	40832019	.	C	T	2	2	4	0	0	4	0	0
2	40832537	.	T	A	4	3	7	0	0	7	0	0
2	40832596	.	C	T	4	4	8	0	1	9	0	0
2	40832984	.	T	C	6	5	11	0	1	12	0	0
2	40833032	.	C	T	0	7	7	0	4	11	0	0
2	40833063	.	A	G	3	6	9	0	0	9	0	0
2	40833068	.	A	G	3	6	9	0	0	9	0	0
2	40833229	.	A	T	8	3	11	0	0	11	0	0
2	40834735	.	T	C	4	8	12	0	0	12	0	0
2	40834944	.	A	G	1	8	9	0	1	10	0	0
2	40850767	.	G	A	3	2	5	0	0	5	0	0
2	40866720	.	G	A	4	6	10	0	0	10	0	0
2	40902411	.	A	G	6	6	12	0	2	14	0	0
2	40902444	.	A	G	11	6	17	0	0	17	0	0
2	41524321	.	A	G	11	6	17	0	2	19	0	0
2	41532745	.	A	G	7	9	16	0	0	16	0	0
2	41532746	.	A	G	7	9	16	0	0	16	0	0
2	41537384	.	T	G	13	0	13	0	10	23	0	0
2	41539251	.	G	A	1	7	8	0	16	24	0	0
2	41542080	.	T	G	12	11	23	0	0	23	0	0
2	41542451	.	T	C	11	5	16	0	0	16	0	0
2	41542601	.	G	A	12	11	23	0	1	24	0	0
2	41542637	.	A	G	11	1	12	0	15	27	0	0
2	41542707	.	A	T	9	4	13	0	0	13	0	0
2	41542738	.	T	A	7	7	14	0	2	16	0	0
2	41552916	.	A	G	3	5	8	0	1	9	0	0
2	41558407	.	T	C	4	2	6	0	0	6	0	0
2	41561884	.	C	T	0	3	3	0	3	6	0	0
2	41561902	.	T	C	4	5	9	0	0	9	0	0
2	41562020	.	A	T	4	2	6	0	0	6	0	0
2	41562837	.	T	A	1	2	3	0	0	3	0	0
2	41562841	.	C	T	0	2	2	0	1	3	0	0
2	41563610	.	T	C	4	4	8	0	0	8	0	0
2	41563612	.	A	C	4	3	7	0	1	8	0	0
2	41563686	.	T	G	7	4	11	0	0	11	0	0
2	41563689	.	G	A	6	2	8	0	0	8	0	0
2	41566463	.	T	C	8	13	21	0	1	22	0	0
2	41566770	.	T	G	10	11	21	0	1	22	0	0
2	41566852	.	C	T	10	8	18	0	0	18	0	0
2	41569177	.	T	C	16	9	25	0	0	25	0	0
2	41571398	.	A	T	11	9	20	0	0	20	0	0
2	41571440	.	A	G	2	2	4	0	0	4	0	0
2	41578181	.	A	T	21	22	43	0	0	43	0	0
2	41578281	.	C	T	17	16	33	1	8	44	2	0
2	41578656	.	C	A	10	12	22	0	2	24	0	0
2	41578716	.	T	A	11	5	16	0	0	16	0	0
2	41578772	.	G	A	9	3	12	0	1	13	0	0
2	41578921	.	C	T	14	7	21	0	1	22	0	0
2	41579222	.	T	C	3	9	12	0	1	13	0	0
2	41579539	.	C	G	0	8	8	0	7	15	0	0
2	41579572	.	C	G	5	9	14	0	0	14	0	0
2	41579646	.	G	T	7	4	11	0	1	12	0	0
2	41579701	.	G	C	6	4	10	0	1	11	0	0
2	41579804	.	T	C	18	13	31	0	0	31	0	0
2	41579952	.	C	A	14	11	25	0	0	25	0	0
2	41579984	.	A	G	10	10	20	0	0	20	0	0
2	41580004	.	C	A	8	10	18	0	1	19	0	0
2	41580028	.	T	C	6	7	13	0	1	14	0	0
2	41580125	.	C	T	9	9	18	0	0	18	0	0
2	41580263	.	T	A	10	10	20	0	0	20	0	0
2	41580473	.	C	T	0	12	12	0	10	22	0	0
2	41580522	.	G	A	10	6	16	0	1	17	0	0
2	41580546	.	A	G	9	10	19	0	0	19	0	0
2	41580715	.	C	T	1	15	16	0	18	34	0	0
2	41580832	.	G	T	14	15	29	0	0	29	0	0
2	41580897	.	T	C	13	8	21	0	1	22	0	0
2	41580946	.	A	C	16	10	26	0	0	26	0	0
2	41580966	.	T	C	21	10	31	0	2	33	0	0
2	41581035	.	T	A	41	7	48	2	3	53	0	0
2	41581815	.	T	A	13	16	29	2	3	34	0	0
2	41581998	.	G	T	12	11	23	13	5	41	0	0
2	41582136	.	G	A	16	18	34	0	1	35	0	0
2	41582383	.	A	C	14	10	24	0	0	24	0	0
2	41582801	.	T	C	9	8	17	0	1	18	0	0
2	41582805	.	C	T	9	6	15	0	2	17	0	0
2	41582923	.	C	T	10	11	21	0	0	21	0	0
2	41583007	.	A	G	8	15	23	0	1	24	0	0
2	41583043	.	A	G	7	18	25	0	4	29	0	0
2	41583171	.	C	T	1	18	19	0	14	33	0	0
2	41585878	.	A	G	11	15	26	0	2	28	0	0
2	41597062	.	A	C	12	0	12	0	8	20	0	0
2	41599247	.	G	A	11	11	22	0	0	22	0	0
2	42008638	.	T	C	2	2	4	0	0	4	0	0
2	42008661	.	T	G	2	2	4	0	0	4	0	0
2	42016700	.	C	T	2	2	4	0	1	5	0	0
2	42021468	.	T	C	1	2	3	0	0	3	0	0
2	42039046	.	G	A	3	6	9	0	0	9	0	0
2	42039112	.	A	G	1	6	7	0	0	7	0	0
2	42049030	.	G	C	7	3	10	0	0	10	0	0
2	42049795	.	T	A	4	4	8	0	0	8	0	0
2	42049797	.	T	G	3	4	7	0	1	8	0	0
2	42051071	.	G	A	6	7	13	1	0	14	0	0
2	42063897	.	C	T	0	4	4	0	4	8	0	0
2	42068217	.	T	G	5	5	10	0	0	10	0	0
2	42071276	.	A	T	3	2	5	0	0	5	0	0
2	42071507	.	A	T	1	5	6	0	0	6	0	0
2	42072958	.	G	A	4	4	8	0	0	8	0	0
2	42073030	.	T	C	3	5	8	0	0	8	0	0
2	42073153	.	T	C	2	3	5	0	0	5	0	0
2	42073261	.	G	A	4	3	7	0	0	7	0	0
2	42073519	.	T	G	4	2	6	0	0	6	0	0
2	42073543	.	A	G	3	0	3	0	2	5	0	0
2	42073834	.	T	C	3	3	6	0	0	6	0	0
2	42073879	.	T	C	3	6	9	0	0	9	0	0
2	42073933	.	G	A	0	4	4	0	9	13	0	0
2	42074080	.	A	T	4	3	7	0	0	7	0	0
2	42074173	.	G	A	0	3	3	0	6	9	0	0
2	42074419	.	A	G	6	0	6	0	8	14	0	0
2	42074485	.	C	T	8	4	12	0	0	12	0	0
2	42074515	.	G	A	7	5	12	0	0	12	0	0
2	42075103	.	T	G	7	0	7	0	6	13	0	0
2	42075106	.	G	T	0	6	6	0	7	13	0	0
2	42075160	.	C	T	5	3	8	0	0	8	0	0
2	42081425	.	T	C	3	5	8	0	1	9	0	0
2	42135868	.	A	T	3	2	5	0	0	5	0	0
2	42144004	.	T	C	2	2	4	0	0	4	0	0
2	42151919	.	G	A	5	2	7	0	0	7	0	0
2	42156579	.	A	G	8	20	28	0	1	29	0	0
2	42156637	.	G	A	16	8	24	0	0	24	0	0
2	42158839	.	C	T	7	21	28	0	1	29	0	0
2	42159159	.	G	T	21	14	35	0	1	36	0	0
2	42161309	.	A	G	26	18	44	0	1	45	0	0
2	42161351	.	C	T	22	20	42	0	1	43	0	0
2	42168496	.	G	A	18	21	39	0	0	39	0	0
2	42168505	.	A	T	19	19	38	0	1	39	0	0
2	42176962	.	T	C	8	16	24	0	2	26	0	0
2	42177056	.	C	T	12	10	22	0	1	23	0	0
2	42177075	.	G	A	13	12	25	0	1	26	0	0
2	42179607	.	C	A	9	9	18	0	1	19	0	0
2	42179675	.	A	G	5	1	6	0	7	13	0	0
2	42182051	.	T	A	9	9	18	0	2	20	0	0
2	42182089	.	A	G	4	8	12	0	0	12	0	0
2	42184056	.	T	G	4	5	9	0	1	10	0	0
2	42200520	.	G	T	4	8	12	0	1	13	0	0
2	42202043	.	T	C	9	6	15	0	0	15	0	0
2	42206954	.	A	G	2	7	9	0	1	10	0	0
2	42210061	.	T	C	3	8	11	0	0	11	0	0
2	42210431	.	G	T	2	5	7	0	0	7	0	0
2	42210486	.	C	T	4	2	6	0	0	6	0	0
2	42220876	.	C	T	6	3	9	0	0	9	0	0
2	42220887	.	C	T	4	3	7	0	0	7	0	0
2	42221346	.	T	G	2	2	4	0	0	4	0	0
2	42224067	.	C	T	3	5	8	0	0	8	0	0
2	42224171	.	G	T	0	5	5	0	8	13	0	0
2	42224255	.	G	A	6	3	9	0	0	9	0	0
2	42224315	.	C	T	6	4	10	0	0	10	0	0
2	42224403	.	G	C	0	7	7	0	4	11	0	0
2	42224455	.	C	T	4	4	8	0	0	8	0	0
2	42224535	.	T	G	2	8	10	0	0	10	0	0
2	42224544	.	C	A	4	9	13	0	0	13	0	0
2	42224628	.	C	A	4	2	6	0	1	7	0	0
2	42224629	.	A	G	4	3	7	0	0	7	0	0
2	42241637	.	G	C	2	2	4	0	0	4	0	0
2	42354655	.	G	A	2	2	4	0	0	4	0	0
2	42354819	.	G	T	4	2	6	0	0	6	0	0
2	42354839	.	A	G	3	2	5	0	0	5	0	0
2	42354922	.	A	G	4	6	10	0	0	10	0	0
2	42355076	.	T	A	2	7	9	0	0	9	0	0
2	42355086	.	A	G	2	7	9	0	0	9	0	0
2	42355132	.	C	T	3	4	7	0	0	7	0	0
2	42355443	.	G	T	4	5	9	0	0	9	0	0
2	42355919	.	A	C	3	0	3	0	6	9	0	0
2	42355920	.	A	G	3	6	9	0	0	9	0	0
2	42356022	.	G	T	5	3	8	0	0	8	0	0
2	42360123	.	C	T	2	2	4	0	0	4	0	0
2	42360162	.	C	T	0	5	5	0	2	7	0	0
2	42360216	.	A	T	1	4	5	0	0	5	0	0
2	42360369	.	C	G	0	2	2	0	3	5	0	0
2	42361415	.	T	C	2	3	5	0	1	6	0	0
2	42361517	.	C	A	5	12	17	0	0	17	0	0
2	42361616	.	T	A	4	7	11	0	1	12	0	0
2	42361790	.	C	T	8	13	21	0	0	21	0	0
2	42370736	.	A	G	12	16	28	0	0	28	0	0
2	42373646	.	G	T	15	21	36	0	0	36	0	0
2	42374218	.	G	A	22	16	38	0	0	38	0	0
2	42374455	.	T	A	16	23	39	0	1	40	0	0
2	42375232	.	G	A	1	2	3	0	0	3	0	0
2	42382574	.	G	A	4	2	6	0	0	6	0	0
2	42382609	.	G	T	4	4	8	0	0	8	0	0
2	42382670	.	G	A	4	8	12	0	0	12	0	0
2	42382687	.	C	G	7	7	14	0	1	15	0	0
2	42382744	.	T	C	9	20	29	0	1	30	0	0
2	42382905	.	T	A	16	14	30	0	0	30	0	0
2	42383032	.	A	G	8	8	16	0	2	18	0	0
2	42383064	.	C	T	0	9	9	0	19	28	0	0
2	42383071	.	T	C	19	9	28	0	0	28	0	0
2	42383209	.	A	G	19	11	30	0	0	30	0	0
2	42383227	.	T	G	17	11	28	0	2	31	1	0
2	42383263	.	A	G	22	14	36	0	0	36	0	0
2	42383327	.	G	A	22	12	34	0	6	40	0	0
2	42383757	.	A	C	24	23	47	0	0	47	0	0
2	42383768	.	A	G	27	24	51	0	1	52	0	0
2	42383947	.	C	A	24	15	39	1	1	41	0	0
2	42384313	.	A	G	24	14	38	1	4	43	0	0
2	42384338	.	C	A	28	14	42	2	2	46	0	0
2	42384587	.	C	A	22	12	34	0	1	35	0	0
2	42384588	.	A	G	21	12	33	0	2	35	0	0
2	42384637	.	G	A	12	8	20	0	0	20	0	0
2	42384699	.	A	C	25	21	46	0	2	48	0	0
2	42384961	.	T	G	14	10	24	3	2	29	0	0
2	42385022	.	T	C	19	16	35	0	0	35	0	0
2	42385023	.	T	C	17	16	33	0	2	35	0	0
2	42385447	.	C	G	0	12	12	0	13	25	0	0
2	42385498	.	T	C	15	0	15	0	14	29	0	0
2	42388272	.	G	A	19	7	26	0	0	26	0	0
2	42388341	.	A	G	14	13	27	0	0	27	0	0
2	42391328	.	C	T	4	16	20	0	1	21	0	0
2	42393550	.	C	T	1	11	12	0	7	19	0	0
2	42396218	.	A	G	5	5	10	0	0	10	0	0
2	42399232	.	T	G	16	16	32	0	9	41	0	0
2	42401362	.	G	C	30	26	56	0	3	59	0	0
2	42415745	.	G	A	24	17	41	0	5	46	0	0
2	42415798	.	G	A	23	12	35	0	2	37	0	0
2	42420296	.	A	G	1	2	3	0	0	3	0	0
2	42420395	.	A	G	5	5	10	0	0	10	0	0
2	42420430	.	T	A	4	7	11	0	0	11	0	0
2	42420542	.	G	A	3	5	8	0	0	8	0	0
2	42421547	.	T	G	3	2	5	0	0	5	0	0
2	42421884	.	T	C	2	2	4	0	0	4	0	0
2	42421888	.	T	A	2	2	4	0	0	4	0	0
2	42421921	.	T	G	2	2	4	0	0	4	0	0
2	42422169	.	T	C	1	5	6	0	0	6	0	0
2	42422347	.	G	A	1	4	5	0	0	5	0	0
2	42422589	.	C	T	2	3	5	0	2	7	0	0
2	42425216	.	T	C	3	5	8	0	0	8	0	0
2	42425255	.	T	C	2	0	2	0	4	6	0	0
2	42431924	.	A	C	6	2	8	0	0	8	0	0
2	42432137	.	G	C	1	1	2	0	4	6	0	0
2	42432200	.	T	A	4	8	12	0	0	12	0	0
2	42433689	.	A	T	4	6	10	0	1	11	0	0
2	42491908	.	G	A	2	2	4	0	1	5	0	0
2	42492124	.	C	T	1	2	3	0	3	6	0	0
2	42492218	.	T	C	2	2	4	0	0	4	0	0
2	42501860	.	G	A	17	17	34	0	1	35	0	0
2	42504589	.	G	C	9	13	22	0	0	22	0	0
2	42508957	.	G	A	12	6	18	0	1	19	0	0
2	42508987	.	C	A	15	10	25	0	0	25	0	0
2	42510637	.	G	A	11	9	20	0	0	20	0	0
2	42510664	.	G	A	13	10	23	0	0	23	0	0
2	42511435	.	C	T	5	2	7	0	1	8	0	0
2	42511464	.	T	G	6	6	12	0	0	12	0	0
2	42511681	.	T	C	4	5	9	0	0	9	0	0
2	42517602	.	G	A	7	12	19	0	0	19	0	0
2	42519767	.	G	A	13	15	28	0	2	30	0	0
2	42519897	.	T	C	12	16	28	0	0	28	0	0
2	42526893	.	A	G	10	9	19	0	0	19	0	0
2	42526931	.	G	A	13	10	23	0	0	23	0	0
2	42530463	.	G	A	9	9	18	0	1	19	0	0
2	42542024	.	T	C	4	10	14	0	2	16	0	0
2	42550602	.	C	T	9	9	18	0	0	18	0	0
2	42552653	.	G	A	9	5	14	0	0	14	0	0
2	42597593	.	C	T	3	5	8	0	0	8	0	0
2	42597981	.	G	A	0	3	3	0	4	7	0	0
2	42599962	.	C	G	4	2	6	0	0	6	0	0
2	42746504	.	G	C	33	50	83	0	5	88	0	0
2	42746530	.	G	T	7	56	63	0	30	93	0	0
2	42746604	.	C	T	36	29	65	0	3	68	0	0
2	42746833	.	C	T	45	33	78	0	1	79	0	0
2	42747069	.	G	T	36	35	71	0	0	71	0	0
2	42747281	.	T	G	32	29	61	0	2	63	0	0
2	42747389	.	T	C	24	25	49	3	7	59	0	0
2	42748186	.	A	T	27	21	48	0	15	63	0	0
2	42748211	.	A	G	36	36	72	1	4	77	0	0
2	42748257	.	G	C	49	16	65	2	2	69	0	0
2	42776527	.	A	G	14	18	32	0	0	32	0	0
2	42776569	.	A	G	12	16	28	0	1	29	0	0
2	42776683	.	A	G	13	14	27	0	0	27	0	0
2	42780597	.	T	A	11	13	24	0	2	26	0	0
2	42780657	.	T	C	16	15	31	0	1	32	0	0
2	42814888	.	A	G	7	8	15	0	0	15	0	0
2	42814928	.	A	G	10	10	20	0	0	20	0	0
2	42817384	.	G	T	6	15	21	0	1	22	0	0
2	42817462	.	A	T	12	11	23	0	0	23	0	0
2	42817504	.	G	A	15	8	23	0	1	24	0	0
2	42864455	.	A	G	6	12	18	0	0	18	0	0
2	42872714	.	C	A	9	7	16	0	0	16	0	0
2	42925153	.	G	A	8	12	20	0	0	20	0	0
2	42930540	.	A	C	9	13	22	0	2	24	0	0
2	43004419	.	T	C	11	1	12	0	8	20	0	0
2	43005260	.	T	A	12	8	20	0	0	20	0	0
2	43027530	.	A	G	4	9	13	0	0	13	0	0
2	43031914	.	A	G	3	6	9	0	2	11	0	0
2	43082195	.	G	A	2	8	10	1	1	12	0	0
2	43082608	.	G	A	11	8	19	0	0	19	0	0
2	43111833	.	A	T	3	2	5	0	1	6	0	0
2	43113478	.	T	C	2	2	4	0	0	4	0	0
2	43159217	.	T	G	11	20	31	0	2	34	1	0
2	43159293	.	G	A	23	8	31	1	2	34	0	0
2	43159302	.	A	C	25	5	30	1	3	34	0	0
2	43159390	.	A	T	14	11	25	0	1	26	0	0
2	43159396	.	T	C	15	11	26	0	0	26	0	0
2	43159500	.	G	A	10	18	28	0	0	28	0	0
2	43159613	.	A	G	11	6	17	0	1	18	0	0
2	43159781	.	A	G	19	11	30	0	4	34	0	0
2	43159868	.	T	C	15	7	22	1	0	23	0	0
2	43168096	.	T	C	2	8	10	0	1	11	0	0
2	43168123	.	A	G	7	8	15	0	1	16	0	0
2	43279591	.	A	G	2	4	6	0	0	6	0	0
2	43284343	.	T	G	2	3	5	0	0	5	0	0
2	43329280	.	T	C	4	2	6	0	0	6	0	0
2	43378491	.	A	G	1	3	4	0	0	4	0	0
2	43385029	.	A	G	4	2	6	0	0	6	0	0
2	43388865	.	A	T	1	2	3	0	0	3	0	0
2	43469388	.	C	A	4	3	7	0	0	7	0	0
2	43469389	.	T	C	4	3	7	0	0	7	0	0
2	43493466	.	G	C	0	5	5	0	3	8	0	0
2	43505035	.	C	T	8	2	10	0	0	10	0	0
2	43507219	.	G	A	0	2	2	0	5	7	0	0
2	43509935	.	A	C	11	6	17	0	0	17	0	0
2	43513660	.	G	A	9	8	17	0	0	17	0	0
2	43516460	.	T	C	3	6	9	0	0	9	0	0
2	43577775	.	T	C	2	0	2	0	3	5	0	0
2	43578658	.	T	C	1	3	4	0	0	4	0	0
2	43586793	.	A	C	13	7	20	0	0	20	0	0
2	43587478	.	A	T	10	10	20	0	1	21	0	0
2	43589691	.	C	G	10	6	16	0	1	17	0	0
2	43589856	.	T	C	17	12	29	1	2	32	0	0
2	43590136	.	A	T	12	17	29	0	1	30	0	0
2	43593210	.	C	T	1	10	11	0	14	25	0	0
2	43593651	.	T	C	14	14	28	0	1	29	0	0
2	43593696	.	T	G	11	8	19	0	2	21	0	0
2	43714362	.	A	G	18	17	35	0	1	36	0	0
2	43723092	.	C	T	20	16	36	0	1	37	0	0
2	43739287	.	T	C	16	16	32	0	0	32	0	0
2	43739401	.	G	C	12	15	27	0	3	30	0	0
2	43787827	.	A	G	5	6	11	0	0	11	0	0
2	43795117	.	G	A	8	5	13	0	0	13	0	0
2	43795990	.	A	C	9	3	12	0	0	12	0	0
2	43796667	.	A	T	5	3	8	0	0	8	0	0
2	43796676	.	C	G	4	0	4	0	3	7	0	0
2	43796738	.	G	A	0	2	2	0	1	3	0	0
2	43796756	.	G	A	0	4	4	0	4	8	0	0
2	43807356	.	G	A	2	8	10	0	0	10	0	0
2	43807536	.	A	G	12	10	22	0	0	22	0	0
2	43807566	.	T	G	12	9	21	0	1	22	0	0
2	43813088	.	A	G	6	8	14	0	1	15	0	0
2	43813193	.	G	A	8	9	17	0	0	17	0	0
2	43816952	.	G	T	10	7	17	0	1	18	0	0
2	43817247	.	C	T	10	4	14	0	0	14	0	0
2	43817303	.	C	T	7	6	13	0	0	13	0	0
2	43817593	.	C	T	6	11	17	0	3	20	0	0
2	43817760	.	A	C	5	5	10	0	1	11	0	0
2	43817826	.	C	T	0	6	6	0	5	11	0	0
2	43817875	.	T	G	11	7	18	0	0	18	0	0
2	43826043	.	A	C	6	0	6	0	5	11	0	0
2	43962071	.	C	G	7	8	15	0	0	15	0	0
2	43962108	.	C	A	0	9	9	0	8	17	0	0
2	43962242	.	T	A	9	11	20	0	1	21	0	0
2	43962279	.	C	T	7	12	19	0	2	21	0	0
2	43962328	.	T	A	7	8	15	0	1	16	0	0
2	43962483	.	T	A	12	6	18	0	0	18	0	0
2	43962600	.	C	T	3	2	5	0	2	7	0	0
2	43962610	.	T	C	6	2	8	0	1	9	0	0
2	43962864	.	C	T	5	14	19	0	15	34	0	0
2	43962983	.	T	C	9	11	20	0	1	21	0	0
2	43963097	.	G	C	10	10	20	0	1	21	0	0
2	43963136	.	C	T	1	7	8	0	9	17	0	0
2	43963163	.	C	T	0	10	10	0	9	19	0	0
2	43963202	.	T	C	11	0	11	0	12	23	0	0
2	43963454	.	A	T	16	11	27	0	1	28	0	0
2	43963493	.	A	G	14	11	25	0	1	26	0	0
2	43976261	.	G	A	7	6	13	0	0	13	0	0
2	43976333	.	C	A	5	7	12	0	0	12	0	0
2	43976339	.	T	C	4	0	4	0	7	11	0	0
2	43983668	.	T	A	7	10	17	0	0	17	0	0
2	43987317	.	G	A	4	7	11	0	1	12	0	0
2	44082542	.	G	A	19	14	33	0	0	33	0	0
2	44183301	.	G	A	10	11	21	0	1	22	0	0
2	44192871	.	T	C	13	17	30	0	1	31	0	0
2	44192893	.	T	C	14	18	32	0	3	35	0	0
2	44193029	.	T	A	24	23	47	0	3	50	0	0
2	44193742	.	C	T	2	31	33	1	17	51	0	0
2	44193769	.	T	G	17	27	44	1	1	46	0	0
2	44259855	.	G	A	44	35	79	0	3	82	0	0
2	44260002	.	C	T	31	60	91	0	2	93	0	0
2	44260088	.	A	G	31	34	65	0	5	70	0	0
2	44260100	.	A	T	30	38	68	0	3	71	0	0
2	44260358	.	G	A	39	36	75	0	11	86	0	0
2	44260836	.	T	C	44	1	45	6	27	78	0	0
2	44261028	.	A	G	44	19	63	0	1	64	0	0
2	44263025	.	G	A	11	7	18	0	2	20	0	0
2	44263063	.	T	C	8	7	15	0	2	17	0	0
2	44263068	.	C	T	9	7	16	0	0	16	0	0
2	44276731	.	A	G	32	40	72	0	6	78	0	0
2	44304374	.	A	G	6	8	14	0	1	15	0	0
2	44304386	.	T	C	5	6	11	0	0	11	0	0
2	44304485	.	G	C	3	0	3	0	8	11	0	0
2	44304515	.	T	C	11	5	16	0	0	16	0	0
2	44312641	.	G	A	1	2	3	0	0	3	0	0
2	44327877	.	C	T	5	3	8	0	1	9	0	0
2	44328056	.	A	G	5	4	9	0	0	9	0	0
2	44331020	.	T	C	4	3	7	0	0	7	0	0
2	44333396	.	G	A	1	2	3	0	0	3	0	0
2	44338314	.	A	T	4	3	7	0	0	7	0	0
2	44339189	.	C	A	7	5	12	0	1	13	0	0
2	44340602	.	T	C	4	2	6	0	0	6	0	0
2	44340788	.	C	T	2	3	5	0	0	5	0	0
2	44361727	.	T	C	1	2	3	0	0	3	0	0
2	44383457	.	A	G	3	6	9	0	0	9	0	0
2	44398551	.	A	C	22	19	41	0	2	43	0	0
2	44446240	.	T	C	7	4	11	0	4	15	0	0
2	44446246	.	G	A	9	8	17	0	0	17	0	0
2	44470110	.	A	G	13	0	13	0	12	25	0	0
2	44484882	.	T	C	17	9	26	0	0	26	0	0
2	44508273	.	A	G	12	11	23	0	1	24	0	0
2	44509873	.	T	C	11	14	25	0	0	25	0	0
2	44510073	.	T	C	15	15	30	0	0	30	0	0
2	44510263	.	T	A	4	7	11	0	1	12	0	0
2	44510273	.	T	G	4	9	13	0	0	13	0	0
2	44510506	.	A	G	1	0	1	0	6	7	0	0
2	44545970	.	A	G	1	0	1	0	2	3	0	0
2	44550903	.	G	A	0	3	3	0	2	5	0	0
2	44550950	.	C	T	3	3	6	0	1	7	0	0
2	44554362	.	A	T	2	5	7	0	0	7	0	0
2	44556982	.	G	A	0	8	8	0	9	17	0	0
2	44556983	.	G	A	8	8	16	0	1	17	0	0
2	44557141	.	C	T	4	6	10	0	1	11	0	0
2	44557187	.	T	C	5	4	9	0	1	10	0	0
2	44573997	.	C	T	1	2	3	0	0	3	0	0
2	44574025	.	T	C	1	3	4	0	0	4	0	0
2	44574048	.	T	C	1	3	4	0	0	4	0	0
2	44604202	.	T	C	1	3	4	0	0	4	0	0
2	44615260	.	T	C	5	2	7	0	0	7	0	0
2	44621086	.	A	C	7	2	9	0	2	11	0	0
2	44625144	.	T	C	3	6	9	0	0	9	0	0
2	44625156	.	T	C	3	7	10	0	0	10	0	0
2	44633487	.	A	G	3	0	3	0	7	10	0	0
2	44643678	.	G	T	8	3	11	1	0	12	0	0
2	44643696	.	T	G	7	6	13	1	1	15	0	0
2	44666553	.	A	T	9	7	16	0	1	17	0	0
2	44666558	.	G	C	9	6	15	0	0	15	0	0
2	44666695	.	T	G	1	0	1	0	7	8	0	0
2	44666838	.	G	A	0	5	5	0	5	10	0	0
2	44678904	.	C	G	6	4	10	0	0	10	0	0
2	44678913	.	A	G	5	6	11	0	0	11	0	0
2	44679856	.	G	A	0	3	3	0	3	6	0	0
2	44682684	.	C	T	5	3	8	0	0	8	0	0
2	44690374	.	T	A	5	7	12	0	0	12	0	0
2	44690398	.	T	C	5	6	11	0	0	11	0	0
2	44692527	.	T	C	6	5	11	1	0	12	0	0
2	44692529	.	C	T	6	5	11	1	0	12	0	0
2	44692570	.	T	A	3	2	5	0	0	5	0	0
2	44692601	.	A	G	3	0	3	0	2	5	0	0
2	44692638	.	C	G	3	3	6	0	0	6	0	0
2	44692641	.	A	G	3	0	3	0	3	6	0	0
2	44692691	.	C	T	5	4	9	0	0	9	0	0
2	44692696	.	T	C	4	4	8	0	2	10	0	0
2	44692746	.	C	T	4	1	5	0	1	6	0	0
2	44693093	.	A	G	2	2	4	0	0	4	0	0
2	44693241	.	T	G	2	2	4	0	0	4	0	0
2	44697590	.	T	C	15	11	26	0	0	26	0	0
2	44720175	.	A	G	20	15	35	0	2	37	0	0
2	44720201	.	G	A	14	16	30	0	3	33	0	0
2	44720423	.	G	A	19	15	34	0	0	34	0	0
2	44757781	.	G	A	1	3	4	0	0	4	0	0
2	44759674	.	A	G	1	2	3	0	2	5	0	0
2	44762311	.	A	G	2	5	7	0	0	7	0	0
2	44766172	.	A	G	2	3	5	0	0	5	0	0
2	44766173	.	A	G	2	3	5	0	0	5	0	0
2	44768889	.	C	T	1	4	5	0	0	5	0	0
2	44781636	.	G	A	1	3	4	0	0	4	0	0
2	44922480	.	A	G	3	0	3	0	3	6	0	0
2	44925124	.	C	G	2	3	5	0	0	5	0	0
2	44943621	.	C	A	9	3	12	0	2	14	0	0
2	44944789	.	A	T	35	24	59	0	0	59	0	0
2	44961558	.	A	G	3	5	8	0	0	8	0	0
2	44962928	.	G	C	2	2	4	0	0	4	0	0
2	44962938	.	C	T	5	2	7	0	0	7	0	0
2	44962973	.	A	T	4	2	6	0	0	6	0	0
2	44963010	.	G	A	1	2	3	0	0	3	0	0
2	44963011	.	A	G	1	2	3	0	0	3	0	0
2	44964025	.	A	T	1	2	3	0	0	3	0	0
2	44965843	.	A	C	2	2	4	0	0	4	0	0
2	44965846	.	C	A	3	1	4	0	0	4	0	0
2	44965921	.	C	A	1	3	4	0	5	9	0	0
2	44965951	.	G	A	2	4	6	0	0	6	0	0
2	44965985	.	A	G	1	3	4	0	0	4	0	0
2	44980270	.	T	C	2	4	6	0	1	7	0	0
2	44980341	.	C	T	1	6	7	0	0	7	0	0
2	44980359	.	C	T	2	8	10	0	0	10	0	0
2	44980422	.	T	C	4	3	7	0	1	8	0	0
2	44980625	.	T	A	4	5	9	0	0	9	0	0
2	44980997	.	G	T	5	5	10	0	0	10	0	0
2	44981043	.	C	T	3	7	10	0	0	10	0	0
2	45116988	.	C	G	2	10	12	0	8	20	0	0
2	45117063	.	A	G	5	9	14	1	2	17	0	0
2	45117076	.	T	C	5	10	15	1	0	16	0	0
2	45117280	.	C	A	13	14	27	2	1	30	0	0
2	45117354	.	G	C	16	19	35	0	2	37	0	0
2	45117440	.	T	A	12	14	26	0	0	26	0	0
2	45117712	.	T	A	11	8	19	0	1	20	0	0
2	45129977	.	G	A	14	12	26	0	1	27	0	0
2	45132677	.	A	G	14	14	28	0	2	30	0	0
2	45139622	.	A	G	2	3	5	0	0	5	0	0
2	45139633	.	T	A	2	4	6	0	0	6	0	0
2	45139669	.	A	G	2	5	7	0	0	7	0	0
2	45139729	.	T	G	4	5	9	2	0	11	0	0
2	45139894	.	C	T	4	9	13	0	2	15	0	0
2	45142971	.	G	A	7	6	13	0	2	15	0	0
2	45143036	.	T	G	13	10	23	0	2	25	0	0
2	45144030	.	G	A	4	7	11	0	1	12	0	0
2	45144163	.	G	A	6	6	12	0	0	12	0	0
2	45145817	.	A	T	6	10	16	0	1	17	0	0
2	45145969	.	G	C	6	14	20	0	1	21	0	0
2	45145973	.	C	T	6	15	21	0	0	21	0	0
2	45149649	.	G	A	7	9	16	0	0	16	0	0
2	45149730	.	T	G	7	5	12	0	0	12	0	0
2	45149751	.	C	T	5	3	8	0	0	8	0	0
2	45152302	.	T	C	9	7	16	0	1	17	0	0
2	45152323	.	C	A	9	10	19	0	1	20	0	0
2	45152461	.	A	G	3	7	10	0	1	11	0	0
2	45153108	.	T	C	3	0	3	0	8	11	0	0
2	45326207	.	A	G	7	3	10	0	0	10	0	0
2	45326240	.	T	C	4	3	7	0	0	7	0	0
2	45349310	.	G	A	1	3	4	0	7	11	0	0
2	45349423	.	C	T	9	18	27	0	0	27	0	0
2	45354994	.	T	C	10	6	16	0	1	17	0	0
2	45355036	.	A	G	7	7	14	0	0	14	0	0
2	45355138	.	C	T	11	15	26	1	0	27	0	0
2	45355171	.	C	A	6	12	18	1	0	19	0	0
2	45358712	.	C	A	8	9	17	0	0	17	0	0
2	45358796	.	A	T	5	10	15	0	1	16	0	0
2	45358974	.	G	A	10	16	26	0	0	26	0	0
2	45359045	.	T	G	17	0	17	0	10	27	0	0
2	45359159	.	C	A	8	8	16	0	1	17	0	0
2	45359394	.	A	G	9	11	20	0	1	21	0	0
2	45359400	.	A	G	6	13	19	0	0	19	0	0
2	45359492	.	T	G	8	18	26	0	1	27	0	0
2	45359504	.	T	G	9	19	28	0	1	29	0	0
2	45362087	.	G	A	13	13	26	0	1	27	0	0
2	45362117	.	G	A	16	15	31	0	0	31	0	0
2	45362129	.	A	T	16	13	29	0	1	31	1	0
2	45376148	.	T	C	15	14	29	0	0	29	0	0
2	45382521	.	T	A	7	14	21	0	1	22	0	0
2	45384870	.	G	A	22	9	31	0	0	31	0	0
2	45410956	.	A	C	10	11	21	0	0	21	0	0
2	45412340	.	T	C	17	9	26	0	1	27	0	0
2	45417195	.	T	C	10	14	24	0	1	25	0	0
2	45419436	.	T	C	16	13	29	0	0	29	0	0
2	45419583	.	T	G	11	3	14	0	1	15	0	0
2	45491595	.	A	C	4	3	7	0	0	7	0	0
2	45491596	.	C	T	4	3	7	0	0	7	0	0
2	45491633	.	T	G	3	2	5	0	1	6	0	0
2	45491663	.	C	T	5	2	7	0	0	7	0	0
2	45492300	.	C	T	3	4	7	0	0	7	0	0
2	45492371	.	G	A	4	4	8	0	0	9	1	0
2	45493712	.	G	T	6	2	8	0	1	9	0	0
2	45502279	.	G	A	1	2	3	0	0	3	0	0
2	45510677	.	G	C	2	3	5	0	0	5	0	0
2	45655555	.	G	C	7	5	12	0	0	12	0	0
2	45655644	.	A	G	15	18	33	0	0	33	0	0
2	45656177	.	A	T	25	17	42	0	1	43	0	0
2	45656198	.	C	T	27	16	43	0	1	44	0	0
2	45656234	.	T	C	20	21	41	0	2	43	0	0
2	45656260	.	C	T	4	17	21	0	16	37	0	0
2	45656447	.	G	A	23	12	35	1	1	37	0	0
2	45661511	.	C	A	1	12	13	0	11	24	0	0
2	45663532	.	C	T	4	13	17	0	2	19	0	0
2	45663794	.	G	C	8	10	18	0	2	20	0	0
2	45665592	.	A	G	6	2	8	0	0	8	0	0
2	45665615	.	T	G	6	2	8	0	1	9	0	0
2	45665978	.	C	A	4	2	6	0	0	6	0	0
2	45673057	.	T	C	3	4	7	0	0	7	0	0
2	45673071	.	T	G	3	4	7	0	0	7	0	0
2	46032857	.	G	T	2	6	8	0	3	11	0	0
2	46032894	.	T	C	5	6	11	0	0	11	0	0
2	46032933	.	T	A	6	6	12	0	0	12	0	0
2	46032934	.	G	T	5	6	11	0	1	12	0	0
2	49603370	.	G	A	0	3	3	0	1	4	0	0
2	50892529	.	A	G	21	0	21	0	14	35	0	0
2	50892537	.	A	G	9	18	27	0	1	28	0	0
2	50892671	.	A	G	16	9	25	0	0	25	0	0
2	52052697	.	A	G	5	0	5	0	7	12	0	0
2	52052790	.	T	C	5	5	10	0	0	10	0	0
2	52057394	.	A	G	11	0	11	0	12	23	0	0
2	52060070	.	T	G	4	9	13	0	1	14	0	0
2	52060365	.	C	T	4	5	9	0	1	10	0	0
2	52060390	.	T	C	5	6	11	0	0	11	0	0
2	52060409	.	A	G	6	4	10	0	1	11	0	0
2	52060450	.	G	A	9	5	14	2	0	16	0	0
2	52060492	.	A	T	6	8	14	2	2	18	0	0
2	52062918	.	G	A	1	12	13	0	14	27	0	0
2	52062989	.	T	A	6	4	10	0	1	11	0	0
2	52063101	.	T	A	5	4	9	0	1	10	0	0
2	52063207	.	T	C	4	9	13	0	0	13	0	0
2	52063208	.	C	T	4	9	13	0	0	13	0	0
2	52063250	.	C	G	6	10	16	0	0	16	0	0
2	52079772	.	G	T	0	2	2	0	1	3	0	0
2	52093023	.	T	G	1	2	3	0	0	3	0	0
2	52810997	.	G	T	6	8	14	0	0	14	0	0
2	52814146	.	C	T	9	15	24	0	1	25	0	0
2	52815260	.	G	A	10	17	27	0	0	27	0	0
2	52815292	.	C	T	11	16	27	0	0	27	0	0
2	52826659	.	A	G	9	14	23	0	0	23	0	0
2	52827298	.	A	G	12	13	25	0	0	25	0	0
2	53065149	.	C	T	1	2	3	0	0	3	0	0
2	53065392	.	G	A	5	5	10	1	1	12	0	0
2	53065421	.	A	G	5	6	11	0	0	12	1	0
2	53085962	.	C	T	1	4	5	0	5	10	0	0
2	53091285	.	C	T	3	7	10	0	1	11	0	0
2	53205525	.	G	A	3	3	6	0	8	14	0	0
2	53359275	.	T	A	3	3	6	0	0	6	0	0
2	53414142	.	C	T	10	4	14	0	0	14	0	0
2	53665098	.	A	G	5	20	25	0	0	25	0	0
2	53673285	.	G	A	2	19	21	0	21	42	0	0
2	53673342	.	G	A	22	19	41	0	1	42	0	0
2	53673354	.	T	G	21	13	34	0	4	38	0	0
2	53673393	.	C	A	15	18	33	0	1	34	0	0
2	53675227	.	C	T	17	9	26	0	0	27	1	0
2	54017861	.	G	T	8	8	16	0	1	17	0	0
2	54017885	.	C	A	0	12	12	0	6	18	0	0
2	54018350	.	C	T	0	7	7	0	13	20	0	0
2	54018407	.	G	A	12	13	25	0	1	26	0	0
2	54018413	.	T	A	12	12	24	0	1	25	0	0
2	54018461	.	G	A	13	12	25	0	0	25	0	0
2	54039159	.	C	T	0	5	5	0	8	13	0	0
2	54049402	.	T	C	4	8	12	0	0	12	0	0
2	54049453	.	C	A	0	2	2	0	7	9	0	0
2	54051923	.	G	A	4	6	10	0	1	11	0	0
2	54054112	.	C	T	8	6	14	0	0	14	0	0
2	54054184	.	T	A	11	7	18	0	2	20	0	0
2	54771064	.	G	A	0	14	14	0	4	18	0	0
2	54771112	.	C	T	14	8	22	0	0	22	0	0
2	54771296	.	T	G	4	10	14	0	0	14	0	0
2	54774957	.	C	T	6	12	18	0	0	18	0	0
2	54775406	.	C	T	21	10	31	0	1	32	0	0
2	54775415	.	A	G	19	13	32	0	1	33	0	0
2	54775475	.	G	A	16	10	26	0	1	27	0	0
2	54775929	.	G	C	7	12	19	0	1	20	0	0
2	54775940	.	T	C	7	13	20	0	1	21	0	0
2	54775998	.	T	C	12	10	22	0	0	22	0	0
2	54776108	.	G	T	0	11	11	0	8	19	0	0
2	54776170	.	G	T	6	9	15	0	2	17	0	0
2	54776357	.	A	C	11	9	20	0	2	22	0	0
2	54776560	.	T	C	10	5	15	0	1	16	0	0
2	54776870	.	C	T	11	8	19	0	1	20	0	0
2	54776966	.	A	G	11	6	17	0	1	18	0	0
2	54777178	.	T	G	20	12	32	0	0	32	0	0
2	54777642	.	G	A	7	7	14	0	0	14	0	0
2	54777849	.	G	A	17	11	28	0	0	28	0	0
2	54777855	.	C	A	15	11	26	0	1	27	0	0
2	54778064	.	G	A	7	9	16	0	2	18	0	0
2	54778255	.	C	T	14	11	25	0	0	25	0	0
2	54778577	.	C	G	12	11	23	0	1	24	0	0
2	54786533	.	G	A	1	5	6	0	4	10	0	0
2	54830883	.	T	G	1	3	4	0	0	4	0	0
2	54830884	.	T	A	1	2	3	0	1	4	0	0
2	54832290	.	T	A	5	2	7	0	0	7	0	0
2	54832304	.	T	A	4	2	6	0	0	6	0	0
2	54832599	.	A	G	5	4	9	0	0	9	0	0
2	54832750	.	T	A	1	3	4	0	0	4	0	0
2	54923826	.	A	C	1	2	3	0	0	3	0	0
2	54923943	.	T	G	3	4	7	0	0	7	0	0
2	54924042	.	T	A	5	3	8	0	2	13	3	0
2	54924048	.	A	G	5	9	14	0	0	14	0	0
2	54971216	.	G	T	4	9	13	0	0	13	0	0
2	54971464	.	C	T	7	2	9	0	0	9	0	0
2	54977337	.	A	G	12	1	13	0	9	22	0	0
2	54977431	.	C	T	10	14	24	0	3	27	0	0
2	54978348	.	A	G	4	3	7	0	0	7	0	0
2	54978423	.	C	T	4	6	10	0	3	13	0	0
2	54978767	.	G	A	4	8	12	0	1	13	0	0
2	54979273	.	G	C	0	5	5	0	7	12	0	0
2	55200769	.	C	A	6	8	14	3	0	17	0	0
2	55200897	.	C	T	9	5	14	0	1	15	0	0
2	55210962	.	C	T	13	17	30	0	0	30	0	0
2	55211004	.	G	A	0	7	7	0	15	22	0	0
2	55211034	.	A	G	10	0	10	0	12	22	0	0
2	55211049	.	C	G	7	0	7	0	14	21	0	0
2	55273451	.	C	G	3	1	4	0	0	4	0	0
2	55273472	.	A	G	5	3	8	0	0	8	0	0
2	55273537	.	C	T	8	3	11	0	0	11	0	0
2	55273820	.	C	G	0	4	4	0	3	7	0	0
2	55273825	.	G	A	3	5	8	0	0	8	0	0
2	55298004	.	G	A	6	7	13	0	0	13	0	0
2	55432426	.	C	T	22	14	36	2	0	38	0	0
2	55489017	.	A	G	10	0	10	0	8	18	0	0
2	55489067	.	G	T	1	4	5	0	17	22	0	0
2	55489261	.	C	T	5	10	15	0	1	16	0	0
2	55489317	.	T	A	15	18	33	0	2	35	0	0
2	55489342	.	T	G	21	18	39	0	1	40	0	0
2	55490062	.	C	T	7	10	17	0	0	17	0	0
2	55490181	.	A	G	18	20	38	0	0	38	0	0
2	55490232	.	T	C	25	16	41	3	0	44	0	0
2	55490325	.	T	A	18	19	37	0	0	37	0	0
2	55490326	.	C	T	18	18	36	0	1	37	0	0
2	55490377	.	A	G	14	9	23	0	1	24	0	0
2	55490378	.	G	A	13	11	24	0	0	24	0	0
2	55490521	.	T	C	21	12	33	0	3	36	0	0
2	55490686	.	T	A	20	13	33	0	1	34	0	0
2	55490812	.	T	C	16	10	26	0	0	26	0	0
2	55491380	.	A	G	15	9	24	0	1	25	0	0
2	55491445	.	T	G	23	15	38	0	2	40	0	0
2	55491471	.	C	T	28	15	43	0	2	45	0	0
2	55491666	.	G	A	16	20	36	0	1	37	0	0
2	55491717	.	G	A	18	17	35	1	1	37	0	0
2	55491884	.	T	C	17	21	38	0	0	38	0	0
2	55491893	.	T	C	20	20	40	0	1	41	0	0
2	55492010	.	G	A	14	23	37	0	0	37	0	0
2	55492064	.	T	C	15	19	34	0	2	36	0	0
2	55492108	.	A	G	9	0	9	0	21	30	0	0
2	55492127	.	T	A	11	18	29	0	1	30	0	0
2	55670614	.	G	C	2	2	4	0	0	4	0	0
2	55784141	.	C	T	4	5	9	0	0	9	0	0
2	55784269	.	A	G	2	6	8	0	0	8	0	0
2	55784533	.	G	A	3	3	6	0	0	6	0	0
2	55784605	.	C	T	4	3	7	0	0	7	0	0
2	55784674	.	G	A	8	6	14	0	0	14	0	0
2	55785177	.	T	A	10	8	18	0	1	19	0	0
2	55785240	.	T	G	4	3	7	0	0	7	0	0
2	55785341	.	G	T	6	4	10	0	0	10	0	0
2	55785636	.	C	A	8	10	18	0	1	19	0	0
2	55787862	.	C	T	0	12	12	0	5	17	0	0
2	55791100	.	G	A	10	5	15	0	0	15	0	0
2	55915056	.	A	G	6	3	9	0	0	9	0	0
2	55915076	.	A	T	3	4	7	0	2	9	0	0
2	55933277	.	C	T	8	11	19	0	0	19	0	0
2	55962572	.	T	A	9	4	13	0	0	13	0	0
2	55962949	.	G	A	12	6	18	0	0	18	0	0
2	55962973	.	A	T	10	5	15	0	0	15	0	0
2	55963060	.	C	T	5	10	15	0	1	16	0	0
2	55963116	.	G	A	6	5	11	0	1	12	0	0
2	55963134	.	T	G	5	0	5	0	7	12	0	0
2	55963215	.	T	C	2	5	7	3	0	10	0	0
2	55963233	.	T	C	3	4	7	4	0	11	0	0
2	55963497	.	C	T	7	5	12	3	1	16	0	0
2	55963834	.	C	T	6	6	12	0	0	12	0	0
2	55963853	.	C	T	5	5	10	0	1	11	0	0
2	55964201	.	A	G	9	3	12	0	0	12	0	0
2	55964231	.	A	T	7	4	11	0	0	11	0	0
2	55964675	.	G	A	2	12	14	0	7	21	0	0
2	55964727	.	G	A	9	5	14	0	4	18	0	0
2	55964953	.	G	A	1	5	6	0	12	18	0	0
2	55965050	.	T	C	15	7	22	0	0	22	0	0
2	55965163	.	A	T	24	7	31	0	2	33	0	0
2	55965256	.	C	T	9	9	18	0	1	19	0	0
2	55965295	.	G	A	12	10	22	0	1	23	0	0
2	55965330	.	G	A	3	7	10	0	15	25	0	0
2	55965627	.	A	T	13	10	23	0	1	24	0	0
2	55965900	.	G	A	0	6	6	3	8	17	0	0
2	55966310	.	C	A	4	2	6	1	0	7	0	0
2	55966327	.	G	T	0	2	2	3	6	11	0	0
2	55966443	.	T	A	3	2	5	0	2	7	0	0
2	55966487	.	A	C	4	3	7	0	1	8	0	0
2	55966491	.	T	A	4	4	8	0	0	8	0	0
2	55966952	.	T	C	3	10	13	0	1	14	0	0
2	55966996	.	T	C	3	3	6	0	0	6	0	0
2	55967114	.	A	T	4	4	8	0	0	8	0	0
2	55967195	.	T	C	13	6	19	0	2	21	0	0
2	55967341	.	A	T	9	7	16	5	2	23	0	0
2	55967471	.	A	T	12	22	34	0	1	35	0	0
2	55967473	.	C	T	24	12	36	0	0	36	0	0
2	55967758	.	T	C	24	13	37	1	1	39	0	0
2	55967916	.	C	A	9	2	11	0	0	11	0	0
2	55967949	.	A	G	5	3	8	0	0	8	0	0
2	55968117	.	G	A	8	4	12	0	0	12	0	0
2	55968383	.	A	C	19	15	34	0	0	34	0	0
2	55968447	.	C	T	10	14	24	0	1	25	0	0
2	55968472	.	A	G	15	0	15	0	12	27	0	0
2	55984827	.	G	A	1	2	3	0	0	3	0	0
2	55989647	.	C	G	1	2	3	0	0	3	0	0
2	56125687	.	T	C	22	16	38	0	1	39	0	0
2	56125744	.	G	C	17	0	17	0	22	39	0	0
2	56125773	.	C	T	15	21	36	0	2	38	0	0
2	56126132	.	C	G	3	5	8	0	1	9	0	0
2	56126359	.	A	G	4	2	6	0	2	8	0	0
2	56127493	.	T	C	8	13	21	0	1	22	0	0
2	56127693	.	T	G	14	8	22	0	1	23	0	0
2	56127720	.	C	G	13	10	23	0	0	23	0	0
2	56127848	.	T	A	10	11	21	0	1	22	0	0
2	56127881	.	T	A	5	11	16	0	0	16	0	0
2	56127884	.	A	T	4	10	14	0	0	14	0	0
2	56127962	.	T	C	5	18	23	0	0	23	0	0
2	56128025	.	A	G	11	18	29	0	1	30	0	0
2	56128527	.	A	G	3	9	12	0	1	13	0	0
2	56128582	.	A	G	3	12	15	0	1	16	0	0
2	56128622	.	T	C	6	14	20	0	1	21	0	0
2	56128677	.	C	T	12	8	20	0	1	21	0	0
2	56128687	.	A	T	13	7	20	0	1	21	0	0
2	56128768	.	A	T	4	8	12	0	1	13	0	0
2	56129001	.	A	G	25	7	32	0	0	32	0	0
2	56129462	.	C	G	9	8	17	0	0	17	0	0
2	56129633	.	A	G	12	12	24	0	2	26	0	0
2	56129793	.	A	G	9	15	24	0	2	26	0	0
2	56129920	.	T	A	15	12	27	0	1	28	0	0
2	56129931	.	A	G	17	10	27	0	0	27	0	0
2	56130019	.	A	C	11	13	24	0	0	24	0	0
2	56130259	.	A	G	20	14	34	0	0	34	0	0
2	56130260	.	C	A	18	14	32	0	2	34	0	0
2	56131264	.	A	T	27	17	44	0	2	46	0	0
2	56140031	.	C	A	1	4	5	0	0	5	0	0
2	56152326	.	C	A	3	3	6	0	0	6	0	0
2	56159904	.	C	G	2	2	4	0	0	4	0	0
2	56162145	.	G	A	1	4	5	0	3	8	0	0
2	56162404	.	C	G	1	6	7	0	0	7	0	0
2	56181605	.	C	T	6	4	10	0	1	11	0	0
2	56181821	.	C	T	8	5	13	0	0	13	0	0
2	56196950	.	C	T	6	10	16	0	1	17	0	0
2	56200652	.	G	A	0	2	2	0	8	10	0	0
2	56205744	.	G	A	7	6	13	0	0	13	0	0
2	56213063	.	T	C	9	4	13	0	1	14	0	0
2	56213096	.	A	G	7	0	7	0	8	15	0	0
2	56218685	.	A	G	13	5	18	0	0	18	0	0
2	56219233	.	G	A	7	11	18	0	0	18	0	0
2	56233253	.	C	T	18	10	28	0	3	31	0	0
2	56233498	.	C	G	11	7	18	0	0	18	0	0
2	56233508	.	G	T	12	13	25	0	0	25	0	0
2	56234286	.	C	T	9	14	23	0	1	24	0	0
2	56234580	.	T	G	19	14	33	5	0	38	0	0
2	56234584	.	G	T	14	15	29	4	0	34	1	0
2	56234670	.	A	T	11	15	26	0	3	29	0	0
2	56234700	.	C	T	12	11	23	0	2	25	0	0
2	56234872	.	A	T	11	18	29	0	0	29	0	0
2	56278750	.	G	C	1	9	10	0	5	23	8	0
2	56342894	.	G	A	39	28	67	0	2	69	0	0
2	56344833	.	A	G	30	26	56	0	5	61	0	0
2	56356730	.	G	T	15	23	38	0	1	39	0	0
2	56356806	.	T	C	23	15	38	0	1	39	0	0
2	56359363	.	G	A	23	14	37	0	1	38	0	0
2	56359434	.	A	G	13	9	22	0	0	22	0	0
2	56359495	.	G	A	9	13	22	0	1	23	0	0
2	56359641	.	G	A	17	5	22	0	0	22	0	0
2	56359680	.	G	A	7	15	22	0	0	22	0	0
2	56361406	.	G	A	17	10	27	0	0	27	0	0
2	56374933	.	C	A	10	6	16	0	0	16	0	0
2	56374961	.	T	G	5	11	16	0	1	17	0	0
2	56380284	.	G	T	9	5	14	0	1	15	0	0
2	56385241	.	G	A	9	16	25	0	0	25	0	0
2	56463308	.	C	T	13	19	32	4	0	36	0	0
2	56463333	.	C	A	14	20	34	0	0	34	0	0
2	56474451	.	C	T	25	23	48	0	0	48	0	0
2	56476732	.	C	T	23	17	40	0	3	43	0	0
2	56476762	.	A	G	16	12	28	0	2	30	0	0
2	56508695	.	T	C	25	15	40	0	1	41	0	0
2	56508715	.	C	G	20	12	32	0	1	33	0	0
2	56508769	.	T	G	12	20	32	0	1	33	0	0
2	56508797	.	A	T	13	19	32	0	2	34	0	0
2	56508878	.	A	G	8	13	21	0	1	22	0	0
2	56508880	.	C	T	5	13	18	0	2	20	0	0
2	56509165	.	T	C	11	7	18	1	4	23	0	0
2	56509183	.	T	C	10	9	19	0	1	20	0	0
2	56509912	.	A	T	21	13	34	0	1	35	0	0
2	56509929	.	A	C	17	18	35	0	3	38	0	0
2	56510040	.	T	C	10	0	10	1	21	32	0	0
2	56510200	.	G	A	18	11	29	1	2	32	0	0
2	56510216	.	G	A	17	20	37	1	0	38	0	0
2	56510424	.	G	T	13	6	19	1	0	20	0	0
2	56510492	.	T	C	9	14	23	1	0	24	0	0
2	56510782	.	C	T	8	8	16	0	1	17	0	0
2	56510785	.	T	C	9	8	17	0	2	19	0	0
2	56510817	.	T	C	23	0	23	0	10	33	0	0
2	56510824	.	G	T	27	8	35	0	0	35	0	0
2	56511463	.	A	C	1	5	6	0	0	6	0	0
2	56511575	.	C	T	11	10	21	0	0	21	0	0
2	56511713	.	A	T	7	2	9	1	0	10	0	0
2	56511720	.	A	T	5	2	7	1	0	8	0	0
2	56512032	.	C	T	5	6	11	0	2	13	0	0
2	56512054	.	T	C	8	0	8	0	10	18	0	0
2	56512121	.	A	G	7	4	11	1	2	14	0	0
2	56512133	.	A	T	4	8	12	1	0	13	0	0
2	56512162	.	C	T	9	11	20	0	0	20	0	0
2	56512173	.	A	C	8	10	18	0	1	19	0	0
2	56512255	.	T	G	1	6	7	1	3	11	0	0
2	56512266	.	A	T	9	1	10	1	0	11	0	0
2	56513510	.	A	C	12	10	22	0	0	22	0	0
2	56513660	.	C	T	1	15	16	0	7	23	0	0
2	56513742	.	C	A	16	16	32	2	0	34	0	0
2	56533104	.	C	G	14	11	25	0	1	26	0	0
2	56533178	.	A	C	11	0	11	0	16	27	0	0
2	56533234	.	A	T	18	16	34	0	1	35	0	0
2	56541387	.	G	A	12	17	29	0	1	30	0	0
2	56541388	.	T	C	19	0	19	0	12	31	0	0
2	56545260	.	G	A	11	21	32	0	3	35	0	0
2	56553809	.	G	T	18	21	39	0	0	39	0	0
2	56572165	.	C	A	19	6	25	0	0	25	0	0
2	56572168	.	C	A	0	6	6	0	19	25	0	0
2	56572431	.	A	G	11	6	17	0	1	18	0	0
2	56572461	.	G	A	10	10	20	0	1	21	0	0
2	56574525	.	C	T	2	12	14	0	9	23	0	0
2	56642185	.	C	G	9	8	17	0	1	18	0	0
2	56642365	.	A	T	41	13	54	0	1	55	0	0
2	56643465	.	G	A	26	29	55	0	1	56	0	0
2	56645018	.	G	A	31	29	60	0	1	61	0	0
2	56645027	.	G	A	29	29	58	0	2	60	0	0
2	56827892	.	G	A	3	4	7	0	0	7	0	0
2	56831595	.	G	A	3	2	5	0	0	5	0	0
2	56834048	.	G	A	5	3	8	0	0	8	0	0
2	56834054	.	C	G	0	3	3	0	4	7	0	0
2	56838480	.	A	G	1	3	4	0	1	5	0	0
2	56861531	.	C	T	2	3	5	0	0	5	0	0
2	56884794	.	T	A	1	1	2	0	1	3	0	0
2	57076122	.	T	C	3	4	7	0	0	7	0	0
2	57076139	.	C	A	3	5	8	0	0	8	0	0
2	57076329	.	G	T	4	8	12	0	0	12	0	0
2	57076516	.	C	T	0	3	3	0	9	12	0	0
2	57082243	.	G	A	3	2	5	0	0	5	0	0
2	57082309	.	G	A	5	2	7	0	0	7	0	0
2	57121623	.	A	T	9	3	12	0	0	12	0	0
2	57121773	.	C	T	0	7	7	1	3	11	0	0
2	57130154	.	G	A	10	4	14	0	1	15	0	0
2	57135816	.	G	A	4	9	13	0	1	14	0	0
2	57135843	.	T	A	7	3	10	0	3	13	0	0
2	57143433	.	G	A	8	9	17	0	0	17	0	0
2	57143436	.	C	T	6	9	15	0	0	15	0	0
2	57151194	.	G	A	30	30	60	0	1	61	0	0
2	57151242	.	G	T	31	24	55	0	1	57	1	0
2	57151326	.	A	G	30	2	32	0	26	58	0	0
2	57152858	.	T	G	27	29	56	0	1	57	0	0
2	57156050	.	C	A	34	20	54	0	10	64	0	0
2	57156092	.	C	A	33	27	60	0	1	61	0	0
2	57157952	.	C	T	30	32	62	0	6	68	0	0
2	57159557	.	G	A	32	26	58	0	2	60	0	0
2	57159668	.	G	A	32	35	67	0	7	74	0	0
2	57160272	.	C	T	27	27	54	0	7	61	0	0
2	57164902	.	A	G	36	29	65	0	2	67	0	0
2	57165001	.	C	T	32	28	60	0	1	61	0	0
2	57165544	.	C	T	32	33	65	0	1	66	0	0
2	57165565	.	C	T	34	29	63	0	3	66	0	0
2	57212864	.	G	A	9	13	22	0	0	22	0	0
2	57212966	.	T	C	9	1	10	0	11	21	0	0
2	57216903	.	G	A	7	4	11	2	0	13	0	0
2	57225181	.	C	T	0	5	5	1	11	17	0	0
2	57225187	.	A	G	11	2	13	1	1	15	0	0
2	57227354	.	A	C	11	6	17	0	0	17	0	0
2	57240283	.	G	T	2	3	5	0	0	5	0	0
2	57240649	.	C	T	0	4	4	0	4	8	0	0
2	57240668	.	G	T	6	5	11	0	2	13	0	0
2	57247280	.	C	A	0	7	7	0	13	20	0	0
2	57247385	.	C	G	3	6	9	1	1	11	0	0
2	57251501	.	A	T	9	3	12	0	0	12	0	0
2	57268947	.	C	A	34	16	50	0	1	51	0	0
2	57269031	.	C	G	23	27	50	0	0	50	0	0
2	57269123	.	C	A	24	29	53	0	2	55	0	0
2	57269136	.	T	A	32	24	56	0	1	57	0	0
2	57325904	.	A	G	2	5	7	0	0	7	0	0
2	57344052	.	G	C	1	3	4	0	0	4	0	0
2	57417062	.	C	T	7	4	11	0	0	11	0	0
2	57417223	.	G	A	4	3	7	0	0	7	0	0
2	57442945	.	T	C	7	5	12	0	0	12	0	0
2	57609378	.	C	T	1	8	9	0	6	15	0	0
2	57616908	.	T	G	6	2	8	1	0	9	0	0
2	57617218	.	A	G	1	2	3	0	0	3	0	0
2	57620034	.	A	C	1	5	6	0	0	6	0	0
2	57620076	.	C	T	2	7	9	0	0	9	0	0
2	57706877	.	C	A	2	6	8	0	1	9	0	0
2	57830385	.	T	C	12	0	12	1	16	29	0	0
2	57830581	.	A	G	22	12	34	0	2	36	0	0
2	57831603	.	A	T	12	10	22	0	3	25	0	0
2	57834927	.	T	C	11	19	30	0	1	31	0	0
2	57834930	.	T	C	13	20	33	0	1	34	0	0
2	57848889	.	G	C	18	13	31	0	0	31	0	0
2	57848936	.	G	C	16	10	26	0	0	26	0	0
2	57867406	.	G	A	3	8	11	0	10	21	0	0
2	57867471	.	C	T	5	9	14	0	2	16	0	0
2	57867473	.	C	T	6	10	16	0	0	16	0	0
2	57867579	.	G	T	12	4	16	0	0	16	0	0
2	57867642	.	A	T	7	7	14	0	2	16	0	0
2	57868151	.	C	T	3	5	8	0	0	8	0	0
2	57868208	.	A	G	4	6	10	0	1	11	0	0
2	57868263	.	A	G	4	5	9	0	4	13	0	0
2	57868433	.	T	C	9	10	19	6	0	25	0	0
2	57868580	.	A	G	16	7	23	0	3	26	0	0
2	57868716	.	A	G	5	2	7	0	0	7	0	0
2	57869043	.	G	T	3	2	5	0	0	5	0	0
2	57869070	.	C	T	2	3	5	0	0	5	0	0
2	57869966	.	A	T	4	3	7	0	2	9	0	0
2	57870003	.	A	G	8	4	12	0	0	12	0	0
2	57870049	.	G	A	9	4	13	3	0	16	0	0
2	57870051	.	A	G	8	1	9	3	3	15	0	0
2	57870155	.	C	T	15	11	26	0	0	26	0	0
2	57870180	.	T	C	14	14	28	0	3	31	0	0
2	57870323	.	G	T	11	3	14	0	1	15	0	0
2	57870343	.	A	G	13	4	17	0	3	20	0	0
2	57870383	.	G	A	9	6	15	0	0	15	0	0
2	57870659	.	A	T	6	6	12	0	1	13	0	0
2	57870713	.	C	G	13	8	21	0	0	21	0	0
2	57870794	.	G	T	16	16	32	0	0	32	0	0
2	57870795	.	T	A	17	15	32	0	0	32	0	0
2	57870830	.	A	G	15	17	32	0	0	32	0	0
2	57870868	.	G	A	1	13	14	0	17	31	0	0
2	57870887	.	A	G	17	0	17	0	14	31	0	0
2	57870934	.	T	C	10	9	19	0	3	22	0	0
2	57870984	.	A	T	4	9	13	0	4	17	0	0
2	57879582	.	T	C	10	18	28	0	1	29	0	0
2	57879615	.	T	C	11	1	12	0	17	29	0	0
2	57879618	.	T	C	12	18	30	0	0	30	0	0
2	57883433	.	C	T	14	13	27	0	4	31	0	0
2	57883452	.	C	T	12	17	29	0	3	32	0	0
2	57883509	.	C	T	2	27	29	0	12	41	0	0
2	57891444	.	G	A	8	14	22	0	0	22	0	0
2	57891463	.	T	C	4	6	10	0	0	10	0	0
2	57892808	.	A	G	2	3	5	0	0	5	0	0
2	57893340	.	A	T	2	6	8	7	0	15	0	0
2	57893346	.	G	A	7	3	10	7	0	17	0	0
2	57893547	.	A	G	5	4	9	0	0	9	0	0
2	57893684	.	G	A	1	6	7	1	0	8	0	0
2	57893826	.	A	G	3	3	6	0	0	6	0	0
2	57894012	.	T	C	5	0	5	0	9	14	0	0
2	57894127	.	T	G	7	7	14	0	0	14	0	0
2	57897401	.	G	A	6	2	8	1	0	9	0	0
2	57899003	.	G	A	5	2	7	0	1	8	0	0
2	57900156	.	A	G	3	3	6	0	0	6	0	0
2	57900222	.	T	C	4	5	9	0	0	9	0	0
2	57913799	.	T	C	2	2	4	0	1	5	0	0
2	57913904	.	A	G	3	3	6	0	0	6	0	0
2	57913913	.	G	A	3	2	5	0	0	5	0	0
2	57916601	.	T	G	2	2	4	0	1	5	0	0
2	57916766	.	T	C	1	0	1	5	2	8	0	0
2	57918008	.	G	A	2	2	4	0	1	5	0	0
2	57918149	.	T	C	1	6	7	0	0	7	0	0
2	57940770	.	G	A	3	3	6	0	0	6	0	0
2	58009111	.	T	C	4	2	6	0	2	8	0	0
2	58009112	.	G	C	6	2	8	0	0	8	0	0
2	58009416	.	A	G	7	12	19	0	0	19	0	0
2	58012041	.	T	G	8	15	23	0	2	25	0	0
2	58012271	.	T	C	6	13	19	0	3	22	0	0
2	58012293	.	T	C	4	9	13	0	2	15	0	0
2	58012973	.	G	T	6	2	8	0	0	8	0	0
2	58013448	.	G	A	5	7	12	1	0	13	0	0
2	58013477	.	A	T	1	4	5	1	0	8	2	0
2	58013485	.	G	A	1	2	3	1	3	7	0	0
2	58014110	.	G	T	3	8	11	0	0	11	0	0
2	58014156	.	A	T	8	8	16	0	2	18	0	0
2	58014364	.	G	A	5	4	9	0	0	9	0	0
2	58014502	.	G	A	2	2	4	0	1	5	0	0
2	58014537	.	T	C	2	3	5	0	0	5	0	0
2	58077783	.	T	G	3	4	7	0	1	8	0	0
2	58077795	.	C	A	5	7	12	0	0	12	0	0
2	58077869	.	T	C	6	10	16	0	0	16	0	0
2	58078071	.	G	C	8	8	16	0	0	16	0	0
2	58081768	.	G	A	7	11	18	0	0	18	0	0
2	58122023	.	A	T	5	5	10	0	0	10	0	0
2	58126268	.	C	T	7	5	12	1	0	13	0	0
2	58129968	.	C	G	5	6	11	0	1	12	0	0
2	58129992	.	A	G	4	5	9	0	0	9	0	0
2	58132558	.	A	C	8	9	17	0	0	17	0	0
2	58133712	.	C	A	4	2	6	0	0	6	0	0
2	58137902	.	A	C	6	10	16	0	1	17	0	0
2	58186945	.	T	C	15	7	22	0	0	22	0	0
2	58187013	.	C	G	9	5	14	0	1	15	0	0
2	58187038	.	G	A	11	4	15	0	0	15	0	0
2	58187052	.	T	A	9	4	13	0	1	14	0	0
2	58187621	.	G	T	11	13	24	0	0	24	0	0
2	58187624	.	C	T	2	11	13	0	12	25	0	0
2	58221183	.	C	T	4	5	9	0	1	10	0	0
2	58221188	.	A	C	2	6	8	0	3	11	0	0
2	58227068	.	C	T	20	9	29	0	3	32	0	0
2	58228022	.	G	C	11	10	21	0	1	22	0	0
2	58242505	.	C	T	8	9	17	0	0	17	0	0
2	58412124	.	G	A	2	20	22	0	25	47	0	0
2	58516445	.	C	A	17	14	31	1	4	36	0	0
2	58523710	.	C	A	0	7	7	1	8	16	0	0
2	58541939	.	G	A	16	15	31	0	1	32	0	0
2	58541981	.	C	G	10	13	23	0	1	24	0	0
2	58546893	.	G	A	11	15	26	0	2	28	0	0
2	58560081	.	G	C	12	15	27	0	0	27	0	0
2	58568120	.	C	T	3	7	10	0	2	13	1	0
2	58568129	.	G	A	3	9	12	0	1	13	0	0
2	58581582	.	G	C	4	6	10	0	1	11	0	0
2	58632433	.	G	A	10	4	14	0	0	14	0	0
2	58639153	.	C	T	1	3	4	0	7	11	0	0
2	58739467	.	T	C	14	10	24	0	1	25	0	0
2	58742652	.	G	A	3	6	9	0	8	17	0	0
2	58778264	.	G	A	13	28	41	0	0	41	0	0
2	58785286	.	G	A	21	16	37	0	3	40	0	0
2	58789112	.	G	A	16	9	25	0	3	28	0	0
2	58789495	.	C	T	1	14	15	0	18	33	0	0
2	58793396	.	C	T	1	16	17	0	22	39	0	0
2	58793438	.	A	G	17	17	34	0	0	34	0	0
2	58793652	.	A	G	16	10	26	0	1	27	0	0
2	58793667	.	G	A	15	7	22	0	1	23	0	0
2	58845161	.	G	T	2	8	10	0	13	23	0	0
2	58845239	.	C	T	2	3	5	0	0	5	0	0
2	58848646	.	T	G	38	1	39	0	24	63	0	0
2	58848767	.	C	T	25	7	32	0	2	34	0	0
2	58868190	.	G	A	13	3	16	0	1	17	0	0
2	58868439	.	T	C	14	0	14	0	15	29	0	0
2	58868508	.	A	C	11	0	11	0	10	21	0	0
2	58868679	.	G	A	9	14	23	0	0	23	0	0
2	58869037	.	C	G	7	3	10	0	0	10	0	0
2	58869166	.	G	A	6	9	15	0	0	15	0	0
2	58869268	.	A	G	5	13	18	0	0	18	0	0
2	58869319	.	G	A	7	9	16	0	2	18	0	0
2	58878288	.	G	A	2	6	8	0	3	11	0	0
2	58878612	.	C	T	9	11	20	0	0	20	0	0
2	58887659	.	T	C	2	4	6	0	1	7	0	0
2	58887817	.	C	T	0	7	7	0	7	14	0	0
2	58888870	.	A	G	4	10	14	0	2	16	0	0
2	58888916	.	T	A	8	5	13	2	4	19	0	0
2	58898167	.	C	T	1	13	14	0	9	23	0	0
2	58898910	.	A	G	11	10	21	0	0	21	0	0
2	58917504	.	A	T	7	10	17	0	1	18	0	0
2	58919954	.	G	A	8	6	14	0	1	15	0	0
2	59004046	.	C	T	10	5	15	0	1	16	0	0
2	59023901	.	T	C	6	12	18	0	1	19	0	0
2	59045912	.	A	G	5	0	5	0	9	14	0	0
2	59054254	.	A	G	18	12	30	0	1	31	0	0
2	59056203	.	C	T	11	21	32	0	2	34	0	0
2	59056212	.	G	A	10	17	27	0	2	29	0	0
2	59057670	.	C	T	20	18	38	0	1	39	0	0
2	59063227	.	T	C	11	12	23	1	1	25	0	0
2	59136919	.	T	G	3	5	8	0	1	9	0	0
2	59137027	.	C	G	4	2	6	8	0	14	0	0
2	59137050	.	T	A	4	5	9	2	0	11	0	0
2	59137113	.	C	T	11	7	18	0	1	19	0	0
2	59137184	.	G	T	4	8	12	0	0	12	0	0
2	59143145	.	G	A	3	5	8	0	0	8	0	0
2	59143183	.	A	G	8	5	13	1	0	14	0	0
2	59539436	.	C	T	11	4	15	0	2	17	0	0
2	59539454	.	T	G	14	6	20	0	0	20	0	0
2	59550656	.	C	A	6	7	13	0	0	13	0	0
2	59552457	.	G	A	4	7	11	0	0	11	0	0
2	59556935	.	G	T	0	5	5	0	5	10	0	0
2	59565508	.	C	T	9	18	27	0	1	28	0	0
2	59565553	.	G	C	15	14	29	0	0	29	0	0
2	59565584	.	G	A	16	9	25	0	1	26	0	0
20	847779	.	G	A	1	3	4	0	0	4	0	0
20	1079035	.	G	A	6	6	12	0	0	12	0	0
20	1079084	.	G	C	5	10	15	0	0	15	0	0
20	1081952	.	G	T	8	7	15	0	2	17	0	0
20	1081960	.	G	A	6	9	15	0	1	16	0	0
20	1119975	.	C	G	10	5	15	0	1	16	0	0
20	1120055	.	C	T	2	2	4	0	0	4	0	0
20	1125057	.	A	G	14	10	24	0	2	26	0	0
20	1125135	.	G	A	0	11	11	0	9	20	0	0
20	1177879	.	A	T	7	6	13	0	0	13	0	0
20	1178040	.	T	A	10	5	15	0	0	15	0	0
20	1178041	.	T	C	10	5	15	0	0	15	0	0
20	1178725	.	A	G	5	4	9	0	0	9	0	0
20	1178759	.	G	C	10	4	14	0	0	14	0	0
20	1179196	.	T	C	3	5	8	0	1	9	0	0
20	1179348	.	A	C	4	3	7	0	0	7	0	0
20	1179404	.	T	G	1	6	7	0	1	8	0	0
20	1179485	.	T	C	10	6	16	0	0	16	0	0
20	1179577	.	C	T	1	7	8	0	1	9	0	0
20	1179715	.	A	C	9	0	9	0	14	23	0	0
20	1185942	.	G	A	7	4	11	0	1	12	0	0
20	1198485	.	C	T	5	8	13	0	0	13	0	0
20	1198558	.	A	T	13	7	20	0	0	20	0	0
20	1198819	.	T	A	16	7	23	3	1	27	0	0
20	1200453	.	C	T	4	3	7	0	0	7	0	0
20	1200485	.	T	C	3	4	7	0	0	7	0	0
20	1200493	.	G	A	0	5	5	0	0	5	0	0
20	1202099	.	T	C	3	1	4	0	0	4	0	0
20	1202107	.	C	T	3	2	5	0	0	5	0	0
20	1202134	.	A	T	3	4	7	0	0	7	0	0
20	1204020	.	T	G	4	3	7	0	1	8	0	0
20	1205980	.	G	A	4	3	7	0	0	7	0	0
20	1240552	.	A	T	1	5	6	0	1	7	0	0
20	1241409	.	A	T	2	4	6	0	1	7	0	0
20	1241478	.	A	T	2	6	8	0	0	8	0	0
20	1242476	.	T	A	2	2	4	0	0	4	0	0
20	1242495	.	T	C	1	3	4	0	0	4	0	0
20	1243867	.	C	T	2	4	6	0	1	7	0	0
20	1244021	.	T	A	2	2	4	0	0	4	0	0
20	1244029	.	T	G	2	2	4	0	0	4	0	0
20	1244166	.	A	G	6	2	8	0	0	8	0	0
20	1246870	.	C	T	4	3	7	0	1	8	0	0
20	1257193	.	G	A	4	3	7	0	1	8	0	0
20	1278565	.	A	T	3	3	6	0	0	6	0	0
20	1278796	.	G	A	15	17	32	0	2	34	0	0
20	1279033	.	G	A	10	20	30	0	0	30	0	0
20	1281278	.	G	T	13	11	24	0	0	24	0	0
20	1294012	.	T	G	11	9	20	0	0	20	0	0
20	1294062	.	C	G	11	14	25	0	0	25	0	0
20	1294352	.	A	C	23	7	30	3	1	34	0	0
20	1294478	.	T	C	6	2	8	0	0	8	0	0
20	1294612	.	T	C	4	2	6	1	0	7	0	0
20	1294735	.	T	C	5	4	9	2	0	11	0	0
20	1294746	.	T	C	4	0	4	3	6	13	0	0
20	1294782	.	T	C	5	0	5	3	10	18	0	0
20	1294786	.	T	C	12	4	16	3	0	19	0	0
20	1294863	.	T	G	11	4	15	0	0	15	0	0
20	1294903	.	C	G	11	6	17	0	3	20	0	0
20	1294970	.	A	G	20	13	33	1	2	36	0	0
20	1295017	.	T	C	8	4	12	1	0	13	0	0
20	1295302	.	T	C	3	9	12	1	0	13	0	0
20	1295426	.	G	T	3	4	7	0	0	7	0	0
20	1295840	.	G	A	15	22	37	0	0	37	0	0
20	1296022	.	G	C	13	13	26	1	0	27	0	0
20	1296114	.	G	A	10	16	26	0	1	27	0	0
20	1296139	.	A	G	17	15	32	0	2	34	0	0
20	1316594	.	G	A	1	4	5	0	0	5	0	0
20	1316764	.	A	G	6	4	10	0	0	10	0	0
20	1316860	.	G	C	0	3	3	0	6	9	0	0
20	1324404	.	G	A	9	4	13	0	0	13	0	0
20	1324976	.	C	A	9	6	15	0	0	15	0	0
20	1327545	.	A	T	5	12	17	0	1	18	0	0
20	1338988	.	T	G	3	0	3	0	7	10	0	0
20	1339066	.	G	A	0	5	5	0	6	11	0	0
20	1339084	.	G	A	5	4	9	0	0	9	0	0
20	1339657	.	T	C	4	8	12	0	0	12	0	0
20	1339798	.	G	A	7	7	14	0	0	14	0	0
20	1339843	.	C	T	2	6	8	0	0	8	0	0
20	1339924	.	G	A	4	11	15	0	0	15	0	0
20	1340015	.	G	A	2	10	12	0	3	15	0	0
20	1346873	.	T	C	3	3	6	0	0	6	0	0
20	1349947	.	G	A	2	2	4	0	2	6	0	0
20	1350101	.	G	A	1	4	5	0	2	7	0	0
20	1441815	.	A	C	20	14	34	0	0	34	0	0
20	1441825	.	T	C	20	14	34	0	1	35	0	0
20	1442358	.	G	T	8	11	19	0	1	20	0	0
20	1442468	.	G	A	10	5	15	0	1	16	0	0
20	1442515	.	A	T	12	14	26	0	1	27	0	0
20	1442522	.	C	A	17	9	26	0	1	27	0	0
20	1442582	.	G	T	14	10	24	0	1	25	0	0
20	1442624	.	C	T	10	13	23	0	1	24	0	0
20	1454065	.	T	C	16	17	33	0	2	35	0	0
20	1455104	.	G	A	9	19	28	0	0	28	0	0
20	1460979	.	C	A	16	11	27	0	1	28	0	0
20	1476772	.	C	T	11	11	22	0	2	24	0	0
20	1487612	.	T	C	10	3	13	0	1	14	0	0
20	1513605	.	A	G	14	10	24	0	0	24	0	0
20	1513617	.	G	A	8	11	19	0	1	20	0	0
20	1518414	.	G	A	10	20	30	0	0	30	0	0
20	1519699	.	A	G	14	14	28	0	1	29	0	0
20	1560842	.	C	T	1	8	9	0	15	24	0	0
20	2713067	.	A	G	1	3	4	0	0	4	0	0
20	2975540	.	A	G	18	5	23	1	0	24	0	0
20	2976257	.	A	G	30	10	40	1	1	42	0	0
20	2976909	.	C	A	23	11	34	2	0	37	1	0
20	2977257	.	C	T	43	17	60	0	0	60	0	0
20	2977417	.	C	A	30	10	40	7	1	48	0	0
20	2977418	.	C	A	29	9	38	7	2	47	0	0
20	3372441	.	G	A	1	3	4	0	0	4	0	0
20	3916456	.	T	A	12	12	24	0	1	25	0	0
20	3916464	.	C	T	15	16	31	0	0	31	0	0
20	3916621	.	T	G	10	11	21	0	1	22	0	0
20	3920746	.	T	G	22	10	32	0	0	32	0	0
20	3920873	.	T	A	11	19	30	0	2	32	0	0
20	3920875	.	G	A	11	20	31	0	1	32	0	0
20	3920977	.	G	A	2	7	9	0	23	32	0	0
20	3921127	.	A	T	13	16	29	0	1	30	0	0
20	3921184	.	G	A	15	12	27	0	0	27	0	0
20	3921202	.	T	C	16	11	27	0	0	27	0	0
20	3923735	.	C	G	10	11	21	0	1	22	0	0
20	3923983	.	G	A	0	9	9	0	12	21	0	0
20	3924098	.	A	T	17	11	28	0	0	28	0	0
20	3924349	.	G	A	10	13	23	0	1	24	0	0
20	3924430	.	G	A	2	6	8	0	14	22	0	0
20	3924528	.	C	A	6	13	19	0	0	19	0	0
20	3924824	.	A	C	4	3	7	0	0	7	0	0
20	3924943	.	T	G	13	0	13	0	10	23	0	0
20	3925146	.	A	T	4	7	11	0	0	11	0	0
20	3925537	.	T	C	5	12	17	1	0	18	0	0
20	3925544	.	T	A	18	5	23	1	0	24	0	0
20	3925604	.	A	G	14	7	21	0	3	24	0	0
20	3925842	.	C	A	15	4	19	1	0	20	0	0
20	3925907	.	T	A	2	14	16	4	0	20	0	0
20	3925934	.	C	T	8	1	9	5	0	14	0	0
20	3925942	.	A	G	4	1	5	3	3	11	0	0
20	3926020	.	C	T	11	3	14	1	0	15	0	0
20	3926337	.	C	T	4	5	9	5	0	14	0	0
20	3926721	.	T	C	19	9	28	1	0	29	0	0
20	3926736	.	T	A	16	11	27	1	0	28	0	0
20	3926907	.	T	G	20	8	28	0	2	30	0	0
20	3926928	.	T	A	26	10	36	0	0	36	0	0
20	3926951	.	A	G	27	10	37	0	1	38	0	0
20	3927267	.	C	A	25	12	37	0	4	41	0	0
20	3927326	.	A	G	10	19	29	0	0	29	0	0
20	3927446	.	C	G	6	15	21	0	0	21	0	0
20	3947006	.	T	G	4	5	9	0	0	9	0	0
20	3947058	.	C	A	5	3	8	0	0	8	0	0
20	3947100	.	C	T	7	3	10	0	0	10	0	0
20	3953593	.	T	C	4	13	17	0	1	18	0	0
20	3954813	.	G	C	1	5	6	0	0	6	0	0
20	3954846	.	A	T	4	3	7	0	0	7	0	0
20	3954870	.	C	T	0	2	2	0	5	7	0	0
20	3971246	.	G	C	5	2	7	0	0	7	0	0
20	3981697	.	T	C	2	4	6	0	0	6	0	0
20	3985248	.	G	A	2	5	7	0	1	8	0	0
20	3991392	.	G	A	1	4	5	0	0	5	0	0
20	3991416	.	A	G	3	2	5	0	0	5	0	0
20	4000366	.	C	T	6	5	11	0	0	11	0	0
20	4009409	.	C	G	4	7	11	0	0	11	0	0
20	4010256	.	T	C	5	6	11	0	0	11	0	0
20	4010462	.	C	T	4	4	8	0	0	8	0	0
20	4010573	.	A	G	3	2	5	0	1	6	0	0
20	4010725	.	T	A	2	2	4	0	1	5	0	0
20	4011135	.	G	A	1	3	4	0	0	4	0	0
20	4011161	.	C	T	2	2	4	0	0	4	0	0
20	4030825	.	G	A	3	2	5	0	0	5	0	0
20	4035614	.	T	A	2	2	4	0	0	4	0	0
20	4035837	.	G	A	5	4	9	0	0	9	0	0
20	4035858	.	G	C	5	6	11	0	0	11	0	0
20	4036375	.	A	G	4	5	9	0	0	9	0	0
20	4036378	.	G	A	6	4	10	0	0	10	0	0
20	4036462	.	A	G	1	1	2	0	1	3	0	0
20	4036559	.	T	G	1	2	3	0	1	4	0	0
20	4036587	.	T	C	1	3	4	0	0	4	0	0
20	4036720	.	T	C	4	5	9	0	0	9	0	0
20	4036795	.	T	C	2	5	7	0	0	7	0	0
20	4037016	.	T	C	5	2	7	0	1	8	0	0
20	4037409	.	T	A	4	4	8	0	1	9	0	0
20	4037942	.	C	T	6	5	11	0	0	11	0	0
20	4038131	.	T	C	2	0	2	0	4	6	0	0
20	4051818	.	C	T	10	14	24	0	1	25	0	0
20	4052295	.	A	G	6	1	7	0	6	13	0	0
20	4052313	.	T	C	4	6	10	0	0	10	0	0
20	4052854	.	G	C	5	5	10	0	1	11	0	0
20	4053012	.	G	A	1	7	8	0	11	19	0	0
20	4060970	.	T	A	2	5	7	0	1	8	0	0
20	4091851	.	G	A	1	4	5	0	0	5	0	0
20	4124207	.	A	T	1	6	7	0	0	7	0	0
20	4124294	.	T	C	4	4	8	0	1	9	0	0
20	4153436	.	A	G	3	3	6	0	0	6	0	0
20	4157962	.	G	C	3	4	7	0	0	7	0	0
20	4165674	.	G	C	3	2	5	0	0	5	0	0
20	4167100	.	A	T	3	2	5	0	0	5	0	0
20	4167118	.	A	G	1	2	3	0	0	3	0	0
20	4170812	.	T	C	1	3	4	0	0	4	0	0
20	4174220	.	G	A	1	4	5	0	1	6	0	0
20	4175807	.	T	A	2	3	5	0	0	5	0	0
20	4176863	.	G	A	0	4	4	0	3	7	0	0
20	4180728	.	A	G	1	0	1	0	2	3	0	0
20	4180743	.	C	T	2	2	4	0	0	4	0	0
20	5051320	.	A	G	2	6	8	0	0	8	0	0
20	5052112	.	C	T	2	2	4	0	1	5	0	0
20	5052151	.	A	G	2	2	4	0	0	4	0	0
20	5065552	.	C	A	3	7	10	0	1	11	0	0
20	5065553	.	C	G	4	7	11	0	0	11	0	0
20	5065776	.	T	A	5	7	12	0	0	12	0	0
20	5066007	.	T	C	6	3	9	0	0	9	0	0
20	5069500	.	T	C	8	4	12	0	0	12	0	0
20	5069565	.	G	A	4	5	9	0	0	9	0	0
20	5075196	.	C	T	7	4	11	0	0	11	0	0
20	5089011	.	C	T	5	7	12	0	1	13	0	0
20	5089150	.	C	A	8	8	16	0	0	16	0	0
20	5089183	.	G	A	0	3	3	0	10	13	0	0
20	5094207	.	G	A	0	3	3	0	3	6	0	0
20	5094283	.	A	T	2	3	5	0	0	5	0	0
20	5158670	.	T	C	3	1	4	0	1	5	0	0
20	5158691	.	C	T	0	2	2	0	4	6	0	0
20	5158705	.	A	G	4	2	6	0	0	6	0	0
20	5158742	.	A	G	1	3	4	0	0	4	0	0
20	5159001	.	A	C	5	5	10	0	0	10	0	0
20	5228120	.	A	G	3	5	8	0	0	8	0	0
20	5228516	.	G	A	4	5	9	0	0	9	0	0
20	5228911	.	C	T	4	5	9	0	0	9	0	0
20	5228918	.	A	G	2	5	7	0	0	7	0	0
20	5237369	.	A	T	1	2	3	0	0	3	0	0
20	5237385	.	G	A	3	2	5	0	0	5	0	0
20	5241524	.	G	A	4	3	7	0	1	8	0	0
20	5243029	.	A	T	1	2	3	0	0	3	0	0
20	5330666	.	C	G	1	2	3	0	0	3	0	0
20	5330859	.	C	G	4	5	9	0	0	9	0	0
20	5330875	.	A	G	5	5	10	0	0	10	0	0
20	5330990	.	T	A	3	4	7	0	0	7	0	0
20	5331095	.	A	G	4	4	8	0	0	8	0	0
20	5331112	.	G	C	4	3	7	0	0	7	0	0
20	5331685	.	A	C	2	6	8	0	0	8	0	0
20	5331726	.	A	G	1	4	5	0	1	6	0	0
20	5332145	.	C	G	10	4	14	0	1	15	0	0
20	5332551	.	G	A	3	3	6	0	0	6	0	0
20	5332728	.	G	A	1	4	5	0	1	6	0	0
20	5332742	.	A	C	3	3	6	0	0	6	0	0
20	5332901	.	T	C	6	0	6	0	7	13	0	0
20	5333317	.	A	G	4	5	9	0	0	9	0	0
20	5333405	.	T	G	3	9	12	0	0	12	0	0
20	5337006	.	G	A	3	8	11	0	0	11	0	0
20	5348081	.	G	A	3	3	6	0	1	7	0	0
20	5354306	.	T	A	5	3	8	0	0	8	0	0
20	5356870	.	G	T	2	4	6	0	0	6	0	0
20	5356940	.	A	G	4	3	7	0	0	7	0	0
20	5358482	.	A	G	1	5	6	0	0	6	0	0
20	5361156	.	A	G	3	4	7	0	0	7	0	0
20	5368974	.	C	T	3	3	6	0	0	6	0	0
20	5390784	.	A	T	19	11	30	0	2	32	0	0
20	5391138	.	G	T	8	24	32	0	4	36	0	0
20	5394584	.	G	A	5	14	19	1	1	21	0	0
20	5563732	.	T	C	2	4	6	0	0	6	0	0
20	5563744	.	A	T	2	5	7	0	0	7	0	0
20	5563798	.	G	A	3	5	8	0	0	8	0	0
20	5563813	.	C	T	3	4	7	0	0	7	0	0
20	5563947	.	A	C	5	4	9	0	0	9	0	0
20	5564002	.	T	C	2	5	7	0	1	8	0	0
20	5564233	.	T	C	5	6	11	0	0	11	0	0
20	5564292	.	A	G	3	0	3	0	13	16	0	0
20	5673988	.	T	C	5	5	10	0	0	10	0	0
20	5679786	.	T	C	10	8	18	0	1	19	0	0
20	5696935	.	C	T	7	6	13	0	0	13	0	0
20	5696971	.	C	A	4	10	14	0	1	15	0	0
20	5700002	.	C	T	11	9	20	0	0	20	0	0
20	5742118	.	C	T	7	7	14	0	0	14	0	0
20	5742169	.	T	C	8	9	17	0	2	19	0	0
20	5744339	.	T	C	10	4	14	0	0	14	0	0
20	5921278	.	T	C	16	12	28	0	2	30	0	0
20	6079378	.	G	T	0	2	2	0	1	3	0	0
20	6100614	.	A	T	2	4	6	0	0	6	0	0
20	6103222	.	G	T	5	9	14	0	0	14	0	0
20	6107484	.	C	G	0	2	2	0	5	7	0	0
20	6117668	.	T	A	6	2	8	0	0	8	0	0
20	6117830	.	A	G	1	3	4	0	1	5	0	0
20	6121569	.	T	C	4	2	6	0	0	6	0	0
20	6122336	.	G	T	8	1	9	0	1	10	0	0
20	6122357	.	C	T	0	3	3	0	6	9	0	0
20	6126444	.	C	T	1	4	5	0	0	5	0	0
20	6164060	.	A	T	4	13	17	0	1	18	0	0
20	6164432	.	T	A	8	13	21	0	2	23	0	0
20	6164484	.	T	G	12	12	24	0	2	26	0	0
20	6164569	.	A	T	14	9	23	1	1	25	0	0
20	6164608	.	C	A	23	11	34	1	1	36	0	0
20	6164923	.	C	T	11	12	23	0	1	24	0	0
20	6165412	.	T	A	5	9	14	0	2	16	0	0
20	6165675	.	T	C	12	12	24	0	0	24	0	0
20	6165684	.	G	A	13	9	22	0	3	25	0	0
20	6165825	.	A	C	23	15	38	0	0	38	0	0
20	6165864	.	A	G	25	14	39	0	1	40	0	0
20	6166467	.	G	T	6	4	10	0	2	12	0	0
20	6166595	.	T	A	13	15	28	0	0	28	0	0
20	6166757	.	C	A	10	10	20	0	0	20	0	0
20	6166907	.	A	T	2	8	10	0	0	10	0	0
20	6169916	.	G	A	19	13	32	0	2	34	0	0
20	6178530	.	C	T	21	7	28	0	0	28	0	0
20	6341343	.	C	T	10	11	21	0	1	22	0	0
20	6341346	.	C	T	0	10	10	0	12	22	0	0
20	6341427	.	C	T	5	6	11	0	0	11	0	0
20	6347143	.	G	A	8	5	13	0	1	14	0	0
20	6347246	.	C	T	9	7	16	0	0	16	0	0
20	6380081	.	T	C	6	4	10	0	1	11	0	0
20	6380084	.	T	C	4	7	11	0	0	11	0	0
20	6380203	.	C	T	6	8	14	0	0	14	0	0
20	6380210	.	G	A	8	7	15	0	0	15	0	0
20	6380258	.	A	G	8	5	13	0	0	13	0	0
20	6380275	.	A	C	4	5	9	0	1	10	0	0
20	6410812	.	C	T	3	4	7	0	0	7	0	0
20	6412822	.	C	T	5	5	10	0	0	10	0	0
20	6412843	.	C	T	4	5	9	0	0	9	0	0
20	6417523	.	C	T	1	7	8	0	4	12	0	0
20	6421849	.	C	A	6	2	8	0	0	8	0	0
20	6425001	.	G	A	3	4	7	0	1	8	0	0
20	6425067	.	A	G	3	6	9	0	0	9	0	0
20	6425187	.	C	T	0	4	4	0	6	10	0	0
20	6437641	.	T	C	5	2	7	0	0	7	0	0
20	6437659	.	C	T	1	2	3	0	4	7	0	0
20	6967149	.	A	G	7	7	14	0	0	14	0	0
20	8055260	.	A	C	2	4	6	0	0	6	0	0
20	8060106	.	G	A	4	3	7	0	1	8	0	0
20	8060214	.	A	C	5	4	9	0	0	9	0	0
20	8060310	.	G	A	6	5	11	0	1	12	0	0
20	8060394	.	G	T	5	6	11	0	1	12	0	0
20	8060397	.	C	T	3	7	10	0	1	11	0	0
20	8066329	.	T	A	6	3	9	0	0	9	0	0
20	8122772	.	A	T	10	5	15	0	0	15	0	0
20	8122938	.	T	A	4	8	12	0	2	14	0	0
20	8123047	.	G	A	5	5	10	0	0	10	0	0
20	8138389	.	C	G	12	7	19	0	0	19	0	0
20	8147222	.	C	T	0	8	8	0	12	20	0	0
20	8154178	.	G	A	7	12	19	0	1	20	0	0
20	8154562	.	A	G	7	6	13	0	0	13	0	0
20	8189652	.	C	G	2	5	7	0	11	18	0	0
20	8193390	.	T	A	8	5	13	0	3	16	0	0
20	8196380	.	G	A	5	1	6	0	1	7	0	0
20	8245716	.	G	A	9	4	13	0	0	13	0	0
20	8443327	.	T	C	1	2	3	0	0	3	0	0
20	9059110	.	T	A	2	2	4	0	0	4	0	0
20	9091170	.	T	C	1	2	3	0	0	3	0	0
20	9091204	.	T	A	2	3	5	0	0	5	0	0
20	9096560	.	T	A	1	2	3	0	0	3	0	0
20	9109195	.	T	C	5	4	9	0	0	9	0	0
20	9192903	.	T	C	10	0	10	0	8	18	0	0
20	13020938	.	A	G	4	2	6	0	0	6	0	0
20	13567497	.	T	C	9	4	13	0	0	13	0	0
20	13567503	.	T	C	9	0	9	0	5	14	0	0
20	14721015	.	G	T	13	2	15	0	0	15	0	0
20	14721016	.	A	G	11	2	13	0	1	14	0	0
20	14893339	.	A	C	6	20	26	0	1	27	0	0
20	15876778	.	A	G	17	16	33	0	0	34	1	0
20	15876812	.	G	A	19	15	34	0	0	34	0	0
20	15876824	.	C	A	3	15	18	0	13	31	0	0
20	15911808	.	A	G	11	8	19	0	1	20	0	0
20	15911880	.	C	T	9	14	23	0	0	23	0	0
20	15912102	.	T	C	19	15	34	0	1	35	0	0
20	15912167	.	A	G	17	8	25	0	0	25	0	0
20	15912192	.	C	T	0	6	6	0	13	19	0	0
20	15912906	.	T	C	8	12	20	0	0	20	0	0
20	15922331	.	T	C	9	0	9	0	12	21	0	0
20	15922364	.	C	G	18	19	37	0	0	37	0	0
20	15933168	.	G	C	9	8	17	0	0	17	0	0
20	15933223	.	C	A	13	5	18	0	0	18	0	0
20	15933229	.	T	C	13	5	18	0	0	18	0	0
20	15933258	.	C	T	14	5	19	0	0	19	0	0
20	15933289	.	G	A	13	9	22	0	0	22	0	0
20	15933424	.	T	C	9	9	18	0	2	20	0	0
20	15933566	.	G	A	12	7	19	0	0	19	0	0
20	15933659	.	C	T	9	3	12	0	0	12	0	0
20	15934456	.	G	T	7	9	16	0	0	16	0	0
20	15934474	.	A	C	7	0	7	0	9	16	0	0
20	15934947	.	G	A	2	2	4	0	1	5	0	0
20	15935185	.	G	A	5	3	8	0	0	8	0	0
20	15935222	.	G	T	0	3	3	0	4	7	0	0
20	15935650	.	A	C	3	2	5	0	0	5	0	0
20	15935892	.	C	T	3	3	6	0	1	7	0	0
20	15935955	.	A	G	6	5	11	0	0	11	0	0
20	15936774	.	T	A	4	2	6	0	0	6	0	0
20	15936801	.	G	A	3	2	5	0	0	5	0	0
20	15936989	.	G	T	9	5	14	0	1	15	0	0
20	15937018	.	T	C	11	5	16	0	1	17	0	0
20	15937029	.	A	T	9	6	15	0	1	16	0	0
20	15937165	.	A	T	5	2	7	0	0	7	0	0
20	15937178	.	C	T	0	2	2	0	4	6	0	0
20	15937278	.	C	G	2	2	4	0	0	4	0	0
20	15937445	.	G	T	9	3	12	0	0	12	0	0
20	15937567	.	G	T	3	2	5	0	1	6	0	0
20	15937648	.	A	T	11	3	14	1	1	16	0	0
20	15937735	.	A	T	6	5	11	0	1	12	0	0
20	15937763	.	A	G	6	7	13	0	0	13	0	0
20	15937839	.	T	G	4	9	13	0	1	14	0	0
20	15937849	.	G	A	3	6	9	0	0	9	0	0
20	15937883	.	G	A	5	4	9	0	0	9	0	0
20	15937926	.	C	A	7	3	10	0	0	11	1	0
20	15937962	.	A	G	7	3	10	0	0	10	0	0
20	15947267	.	G	C	1	0	1	0	3	4	0	0
20	15969993	.	T	C	3	5	8	0	1	9	0	0
20	15969999	.	G	A	2	6	8	0	0	8	0	0
20	15970150	.	A	G	2	3	5	0	0	5	0	0
20	15970177	.	C	T	4	5	9	0	0	9	0	0
20	15970249	.	T	C	7	0	7	0	2	9	0	0
20	15973728	.	T	C	9	0	9	0	5	14	0	0
20	16034724	.	G	A	2	3	5	0	0	5	0	0
20	16034879	.	T	C	7	4	11	0	0	11	0	0
20	16156347	.	A	G	6	4	10	0	0	10	0	0
20	16156367	.	A	G	6	3	9	0	0	9	0	0
20	16163333	.	T	C	6	0	6	0	9	15	0	0
20	16163384	.	A	G	10	15	25	0	2	27	0	0
20	16171203	.	A	T	5	6	11	0	0	11	0	0
20	16173957	.	T	C	7	4	11	0	0	11	0	0
20	16177754	.	A	G	8	0	8	0	8	16	0	0
20	16180064	.	C	A	15	11	26	0	0	26	0	0
20	16180070	.	G	C	1	9	10	0	14	24	0	0
20	16182806	.	C	T	4	9	13	1	1	15	0	0
20	16182839	.	G	A	0	11	11	1	3	15	0	0
20	16193658	.	T	C	10	8	18	0	1	19	0	0
20	16193776	.	A	G	7	12	19	0	0	19	0	0
20	16193899	.	C	T	12	9	21	0	0	21	0	0
20	16201015	.	C	A	6	7	13	3	2	18	0	0
20	16201111	.	G	A	1	5	6	0	10	16	0	0
20	16201200	.	C	T	13	18	31	0	0	31	0	0
20	16201394	.	G	A	10	14	24	0	0	24	0	0
20	16201709	.	A	G	6	3	9	0	0	9	0	0
20	16201759	.	T	C	6	9	15	0	0	15	0	0
20	16201812	.	A	G	2	3	5	0	0	5	0	0
20	16212837	.	C	T	0	4	4	0	1	5	0	0
20	16212840	.	C	T	0	3	3	0	2	5	0	0
20	16223173	.	T	G	3	2	5	0	0	5	0	0
20	16437895	.	A	G	4	7	11	0	1	12	0	0
20	16438097	.	G	A	10	15	25	0	0	25	0	0
20	16438119	.	T	A	9	15	24	0	0	24	0	0
20	16438252	.	G	A	13	7	20	0	2	22	0	0
20	16438557	.	A	C	5	11	16	0	2	18	0	0
20	16438837	.	T	C	8	0	8	0	12	20	0	0
20	16438854	.	T	C	9	11	20	0	1	21	0	0
20	16441658	.	C	T	12	18	30	0	1	31	0	0
20	16446685	.	A	G	7	15	22	0	1	23	0	0
20	16447831	.	A	G	10	15	25	0	2	27	0	0
20	16448913	.	G	T	9	9	18	0	1	19	0	0
20	16477710	.	A	C	3	4	7	0	0	7	0	0
20	16477718	.	T	G	3	4	7	0	0	7	0	0
20	16477856	.	T	C	1	2	3	0	0	3	0	0
20	16477884	.	A	C	3	2	5	0	0	5	0	0
20	16477963	.	A	G	1	9	10	0	1	11	0	0
20	16477973	.	A	G	3	8	11	0	1	12	0	0
20	16478011	.	A	G	4	8	12	0	1	13	0	0
20	16478146	.	A	T	6	5	11	0	1	12	0	0
20	16485863	.	T	A	6	11	17	0	0	17	0	0
20	16498566	.	T	C	10	7	17	0	0	17	0	0
20	16498590	.	T	C	9	6	15	0	0	15	0	0
20	16498623	.	A	G	12	5	17	0	0	17	0	0
20	16498767	.	A	G	11	12	23	0	0	23	0	0
20	16498932	.	C	A	5	5	10	0	0	10	0	0
20	16639964	.	G	A	0	7	7	0	12	20	1	0
20	16640011	.	G	A	3	5	8	1	0	9	0	0
20	16644943	.	A	G	15	0	15	0	18	33	0	0
20	16645004	.	T	C	21	13	34	0	0	34	0	0
20	16652964	.	G	A	2	13	15	0	12	27	0	0
20	16660327	.	G	C	11	20	31	0	2	33	0	0
20	16660462	.	A	T	13	8	21	0	0	21	0	0
20	16660567	.	G	A	12	7	19	0	0	19	0	0
20	16660652	.	G	A	4	17	21	0	1	22	0	0
20	16660707	.	G	A	0	9	9	0	8	17	0	0
20	16660808	.	C	T	4	2	6	0	0	6	0	0
20	16708388	.	T	C	1	2	3	0	0	3	0	0
20	16708400	.	A	G	1	2	3	0	0	3	0	0
20	16708432	.	G	A	0	2	2	0	1	3	0	0
20	16708457	.	C	T	1	2	3	0	0	3	0	0
20	16734343	.	C	T	18	14	32	0	0	32	0	0
20	16737512	.	C	T	16	15	31	0	0	31	0	0
20	16740834	.	G	A	7	10	17	0	1	18	0	0
20	16771318	.	C	T	31	43	74	0	4	78	0	0
20	16774970	.	T	A	35	26	61	0	5	66	0	0
20	16775173	.	C	T	24	23	47	0	3	50	0	0
20	16832788	.	G	T	14	12	26	0	0	26	0	0
20	16834572	.	C	T	0	5	5	0	8	13	0	0
20	16834778	.	T	C	4	10	14	0	0	14	0	0
20	16849100	.	C	A	0	4	4	0	13	17	0	0
20	16883694	.	C	G	2	0	2	0	3	5	0	0
20	16903806	.	T	A	11	10	21	0	1	22	0	0
20	16903878	.	T	A	10	11	21	0	0	21	0	0
20	16906564	.	C	T	8	12	20	0	0	20	0	0
20	17740215	.	G	A	18	14	32	0	3	35	0	0
20	17798906	.	T	C	17	20	37	0	5	42	0	0
20	17799127	.	C	A	25	20	45	0	0	45	0	0
20	17800493	.	T	C	20	20	40	0	2	42	0	0
20	17800843	.	A	C	14	23	37	0	2	39	0	0
20	17800867	.	T	C	17	26	43	0	1	44	0	0
20	17802895	.	G	A	22	20	42	0	2	44	0	0
20	17802964	.	A	G	26	0	26	0	18	44	0	0
20	17803572	.	T	C	18	19	37	0	2	39	0	0
20	17809141	.	T	C	25	21	46	0	1	47	0	0
20	17813702	.	C	T	28	27	55	0	1	56	0	0
20	17817433	.	T	G	28	18	46	0	3	49	0	0
20	17817886	.	T	A	17	14	31	1	1	33	0	0
20	17817926	.	G	T	17	12	29	0	2	31	0	0
20	17818129	.	G	C	19	17	36	0	0	36	0	0
20	17818159	.	A	T	16	11	27	0	1	28	0	0
20	17818177	.	A	C	18	8	26	0	1	27	0	0
20	17819008	.	T	C	21	11	32	3	2	37	0	0
20	18249646	.	T	C	12	7	19	0	0	19	0	0
20	18255673	.	G	T	6	6	12	0	0	12	0	0
20	18255748	.	A	G	11	7	18	1	0	19	0	0
20	18255755	.	A	G	12	6	18	1	1	20	0	0
20	18255929	.	A	G	13	0	13	0	7	20	0	0
20	18255931	.	A	T	16	5	21	0	0	21	0	0
20	18256170	.	G	A	2	3	5	0	0	5	0	0
20	18256181	.	G	T	7	3	10	0	0	10	0	0
20	18312860	.	C	T	20	22	42	0	0	42	0	0
20	18313822	.	G	A	1	2	3	0	0	3	0	0
20	18328191	.	C	T	1	2	3	0	0	3	0	0
20	18354627	.	C	T	5	8	13	0	0	13	0	0
20	18363238	.	T	C	7	0	7	0	6	13	0	0
20	18369979	.	G	A	7	5	12	0	0	12	0	0
20	18373014	.	T	G	4	3	7	0	1	8	0	0
20	18376800	.	C	T	7	3	10	0	0	10	0	0
20	18392845	.	C	T	22	18	40	0	0	40	0	0
20	18393128	.	G	A	15	2	17	0	0	17	0	0
20	18393132	.	A	C	13	3	16	0	1	18	1	0
20	18393249	.	T	C	21	13	34	0	0	34	0	0
20	18393359	.	A	T	16	15	31	0	1	32	0	0
20	18393376	.	C	T	18	14	32	0	0	32	0	0
20	18396134	.	A	G	18	17	35	0	0	35	0	0
20	18413987	.	T	C	16	1	17	0	10	27	0	0
20	18417768	.	G	A	13	8	21	0	0	21	0	0
20	18417777	.	T	C	12	9	21	0	1	22	0	0
20	18419377	.	G	A	7	2	9	0	0	9	0	0
20	18419383	.	T	C	7	2	9	0	0	9	0	0
20	18431770	.	T	C	16	0	16	0	16	32	0	0
20	18432732	.	C	T	9	12	21	0	4	25	0	0
20	18443489	.	T	C	7	7	14	0	0	14	0	0
20	18443543	.	C	G	0	10	10	0	6	16	0	0
20	18443554	.	C	T	0	10	10	0	5	15	0	0
20	18456785	.	C	T	12	16	28	0	1	29	0	0
20	18456791	.	T	C	12	14	26	0	2	28	0	0
20	18459961	.	G	A	10	14	24	0	0	24	0	0
20	18459976	.	C	T	10	12	22	0	3	25	0	0
20	18465958	.	G	T	7	6	13	1	1	15	0	0
20	18535350	.	G	A	5	14	19	0	1	20	0	0
20	18551728	.	T	A	20	8	28	0	3	31	0	0
20	18591704	.	G	A	13	27	40	0	1	41	0	0
20	18591716	.	A	C	18	28	46	0	0	47	1	0
20	18591743	.	A	T	15	25	40	0	4	44	0	0
20	18594958	.	C	A	23	21	44	1	1	46	0	0
20	18669605	.	T	G	2	9	11	0	1	12	0	0
20	18672033	.	G	A	8	20	28	0	0	28	0	0
20	18672064	.	C	T	5	18	23	0	2	25	0	0
20	18672094	.	T	C	8	14	22	0	0	22	0	0
20	18672162	.	G	A	17	12	29	0	0	29	0	0
20	18672610	.	C	G	9	17	26	0	0	26	0	0
20	18672733	.	A	T	7	14	21	0	1	22	0	0
20	18672970	.	G	A	8	13	21	0	0	21	0	0
20	18673132	.	C	T	11	15	26	0	4	30	0	0
20	18677343	.	G	A	12	13	25	0	0	25	0	0
20	18683158	.	T	C	10	17	27	0	2	29	0	0
20	18683177	.	A	G	15	0	15	0	18	33	0	0
20	18684760	.	G	A	11	12	23	0	0	23	0	0
20	18684769	.	G	A	9	10	19	0	1	20	0	0
20	18685235	.	C	G	4	8	12	0	2	14	0	0
20	18685256	.	G	A	3	5	8	0	0	8	0	0
20	18685279	.	G	C	0	3	3	0	3	6	0	0
20	18708770	.	T	C	20	27	47	0	2	49	0	0
20	18713016	.	C	T	24	35	59	0	2	61	0	0
20	18713067	.	T	C	23	33	56	0	2	58	0	0
20	18714052	.	A	G	1	2	3	0	0	3	0	0
20	18714282	.	A	G	1	0	1	0	4	5	0	0
20	18714390	.	G	A	0	3	3	0	3	6	0	0
20	18721788	.	C	T	25	13	38	0	1	39	0	0
20	18721910	.	G	A	14	8	22	0	0	22	0	0
20	18722565	.	A	T	23	14	37	0	3	40	0	0
20	18722860	.	A	T	9	10	19	0	3	22	0	0
20	18723105	.	C	T	13	9	22	0	1	23	0	0
20	18723277	.	T	C	16	18	34	0	0	34	0	0
20	18723327	.	T	C	13	0	13	0	13	26	0	0
20	18723401	.	T	C	5	0	5	0	15	20	0	0
20	18723459	.	T	C	6	11	17	0	0	17	0	0
20	18727506	.	T	C	19	9	28	0	1	29	0	0
20	18730498	.	G	A	15	12	27	0	1	28	0	0
20	18730840	.	T	C	20	8	28	0	0	28	0	0
20	18731068	.	C	T	18	16	34	0	1	35	0	0
20	18747036	.	C	T	3	4	7	0	0	7	0	0
20	18747062	.	C	A	3	5	8	0	0	8	0	0
20	18755824	.	A	C	4	5	9	0	0	9	0	0
20	18756047	.	A	T	4	4	8	0	0	8	0	0
20	18756069	.	A	G	5	5	10	0	0	10	0	0
20	18756528	.	A	C	3	3	6	0	0	6	0	0
20	18756628	.	A	G	2	4	6	0	0	6	0	0
20	18774169	.	A	T	2	2	4	0	0	4	0	0
20	18774552	.	G	A	1	3	4	0	1	5	0	0
20	18774599	.	C	A	3	3	6	0	0	6	0	0
20	18775947	.	A	G	2	2	4	0	0	4	0	0
20	18776480	.	T	C	3	0	3	0	3	6	0	0
20	18801644	.	G	A	8	5	13	0	1	14	0	0
20	18801670	.	G	A	5	4	9	0	1	10	0	0
20	18802121	.	T	C	2	2	4	0	1	5	0	0
20	18802438	.	A	G	9	6	15	0	0	15	0	0
20	18802567	.	T	C	3	6	9	0	0	9	0	0
20	18802603	.	C	T	2	4	6	0	1	7	0	0
20	18802651	.	G	A	1	4	5	0	0	5	0	0
20	18810050	.	G	A	5	4	9	0	0	9	0	0
20	18810201	.	C	T	3	6	9	0	0	9	0	0
20	18915249	.	C	T	8	5	13	0	0	13	0	0
20	18947388	.	A	G	12	15	27	0	0	27	0	0
20	18958090	.	G	A	1	7	8	0	12	20	0	0
20	18958106	.	C	G	11	8	19	0	1	20	0	0
20	18958420	.	T	C	15	18	33	0	0	33	0	0
20	18958433	.	G	A	1	15	16	0	19	35	0	0
20	18958477	.	G	A	2	11	13	0	13	26	0	0
20	18961838	.	C	T	14	7	21	0	0	21	0	0
20	18968826	.	C	T	17	9	26	0	0	26	0	0
20	19824250	.	A	G	1	0	1	0	4	5	0	0
20	20602154	.	T	C	7	3	10	0	0	10	0	0
20	20602182	.	T	C	8	2	10	0	0	10	0	0
20	20602232	.	T	C	13	7	20	0	0	20	0	0
20	20605071	.	T	C	4	5	9	0	0	9	0	0
20	20605295	.	T	C	1	5	6	0	0	6	0	0
20	20605311	.	T	C	5	3	8	0	0	8	0	0
20	21342009	.	A	T	0	3	3	0	0	3	0	0
20	21392135	.	C	T	1	7	8	0	0	8	0	0
20	21474700	.	A	G	1	5	6	0	2	8	0	0
20	21474715	.	A	C	0	4	4	0	0	4	0	0
20	21632034	.	G	A	0	2	2	0	2	4	0	0
20	21638575	.	T	C	3	3	6	0	0	6	0	0
20	21639637	.	G	T	1	2	3	0	0	3	0	0
20	21642747	.	A	G	0	2	2	0	1	3	0	0
20	21815659	.	G	T	11	12	23	0	1	24	0	0
20	21815986	.	C	T	2	19	21	0	11	32	0	0
20	21816061	.	C	G	14	15	29	0	0	29	0	0
20	21819062	.	T	C	17	22	39	0	2	41	0	0
20	21828117	.	T	C	10	11	21	0	1	22	0	0
20	21839504	.	G	A	12	8	20	0	0	20	0	0
20	21841312	.	G	A	12	17	29	0	0	29	0	0
20	21841316	.	G	T	12	14	26	0	3	29	0	0
20	21855195	.	T	C	12	10	22	1	0	23	0	0
20	21862963	.	C	T	2	12	14	0	12	26	0	0
20	21862975	.	C	T	1	6	7	0	18	25	0	0
20	21872945	.	A	G	4	10	14	0	1	15	0	0
20	21872990	.	G	A	11	11	22	0	0	22	0	0
20	21875111	.	G	A	12	14	26	0	0	26	0	0
20	21875162	.	G	A	13	11	24	0	0	24	0	0
20	21875165	.	T	G	13	11	24	0	1	25	0	0
20	21875411	.	C	A	7	9	16	0	0	16	0	0
20	21910005	.	C	T	0	11	11	0	17	28	0	0
20	22045260	.	A	C	2	4	6	0	0	6	0	0
20	22056800	.	A	G	2	2	4	0	0	4	0	0
20	22144518	.	G	A	5	2	7	0	1	8	0	0
20	22147798	.	T	C	2	3	5	0	0	5	0	0
20	22160859	.	T	A	4	7	11	0	0	11	0	0
20	22163667	.	T	C	4	6	10	0	2	12	0	0
20	22166199	.	G	A	9	6	15	0	0	15	0	0
20	22166512	.	A	G	9	8	17	0	2	19	0	0
20	22168567	.	C	T	4	3	7	0	0	7	0	0
20	22175326	.	G	A	10	4	14	0	1	15	0	0
20	22175457	.	C	A	3	5	8	0	0	8	0	0
20	22175625	.	T	C	5	5	10	0	2	12	0	0
20	22175815	.	T	C	8	4	12	0	0	12	0	0
20	22175830	.	G	A	9	3	12	0	1	13	0	0
20	22175906	.	T	G	5	4	9	0	0	9	0	0
20	22175928	.	C	T	3	2	5	0	2	7	0	0
20	22179962	.	T	A	5	6	11	0	1	12	0	0
20	22186632	.	G	A	11	4	15	0	1	16	0	0
20	22186738	.	G	A	5	10	15	0	1	16	0	0
20	22186765	.	C	G	8	11	19	0	0	19	0	0
20	22186886	.	A	G	9	6	15	0	0	15	0	0
20	22186914	.	A	G	8	7	15	0	1	16	0	0
20	22186971	.	C	T	11	10	21	0	1	22	0	0
20	22186973	.	C	T	10	11	21	0	0	21	0	0
20	22187233	.	T	C	10	11	21	0	2	23	0	0
20	22191361	.	A	T	19	13	32	0	0	32	0	0
20	22191376	.	A	G	18	11	29	0	1	30	0	0
20	22191493	.	T	C	17	0	17	0	8	25	0	0
20	22193013	.	C	A	2	11	13	0	14	27	0	0
20	22194285	.	C	T	0	4	4	0	5	9	0	0
20	22194385	.	A	T	4	3	7	0	1	8	0	0
20	22194395	.	G	A	4	5	9	0	0	9	0	0
20	22196960	.	T	G	7	4	11	0	1	12	0	0
20	22198957	.	C	A	4	2	6	0	0	6	0	0
20	22352712	.	C	G	1	4	5	0	0	5	0	0
20	22352748	.	T	G	2	3	5	0	0	5	0	0
20	22360343	.	A	G	1	2	3	0	0	3	0	0
20	22435609	.	T	A	3	3	6	0	0	6	0	0
20	22435672	.	T	C	3	2	5	1	0	6	0	0
20	22435789	.	G	A	2	3	5	0	0	5	0	0
20	22435893	.	T	A	1	2	3	0	0	3	0	0
20	22435901	.	C	T	1	2	3	0	0	3	0	0
20	22483823	.	T	C	1	4	5	0	0	5	0	0
20	22484279	.	A	G	3	4	7	0	0	7	0	0
20	22709610	.	C	A	19	19	38	0	3	41	0	0
20	22709685	.	T	A	18	13	31	0	1	32	0	0
20	22722200	.	C	A	19	19	38	0	1	39	0	0
20	22722255	.	G	C	16	15	31	0	0	31	0	0
20	22730689	.	C	G	23	21	44	0	1	45	0	0
20	22734031	.	G	A	4	22	26	0	17	43	0	0
20	22734052	.	G	A	1	23	24	0	20	44	0	0
20	22736673	.	C	T	28	18	46	0	1	47	0	0
20	22738204	.	C	A	17	12	29	0	2	31	0	0
20	22739946	.	C	A	28	16	44	0	1	45	0	0
20	22740056	.	C	T	21	15	36	0	0	36	0	0
20	22740140	.	C	T	19	23	42	0	4	46	0	0
20	22740230	.	A	G	21	25	46	0	4	50	0	0
20	22740533	.	A	T	25	10	35	0	0	35	0	0
20	22740567	.	A	G	14	2	16	0	25	41	0	0
20	22800759	.	G	A	5	4	9	0	0	9	0	0
20	22802189	.	G	A	6	4	10	0	0	10	0	0
20	22802259	.	C	A	3	2	5	0	0	5	0	0
20	22843640	.	A	G	2	3	5	0	0	5	0	0
20	23023364	.	G	A	4	9	13	0	0	13	0	0
20	23023471	.	C	T	11	8	19	0	0	19	0	0
20	23023482	.	A	G	6	9	15	0	1	16	0	0
20	23023623	.	G	A	7	8	15	0	1	16	0	0
20	23023641	.	A	G	8	6	14	0	1	15	0	0
20	23023670	.	T	C	5	0	5	0	11	16	0	0
20	23023835	.	A	G	11	7	18	0	1	19	0	0
20	23024096	.	G	A	5	4	9	0	1	10	0	0
20	23026133	.	C	T	1	10	11	0	7	18	0	0
20	23101008	.	G	A	0	4	4	0	3	7	0	0
20	23104485	.	A	C	6	6	12	0	1	13	0	0
20	23175425	.	A	G	11	23	34	0	1	36	1	0
20	23175479	.	C	A	17	13	30	0	1	31	0	0
20	23175495	.	C	A	20	12	32	0	1	33	0	0
20	23178078	.	T	C	13	10	23	0	1	24	0	0
20	23179753	.	A	G	22	0	22	0	23	45	0	0
20	23204754	.	C	A	12	8	20	0	3	23	0	0
20	23205102	.	T	C	15	14	29	0	0	29	0	0
20	23205826	.	A	C	10	0	10	0	8	18	0	0
20	23205831	.	A	C	9	0	9	0	11	20	0	0
20	23205868	.	T	C	17	20	37	1	0	38	0	0
20	23205879	.	G	A	17	24	41	1	1	43	0	0
20	23245852	.	C	T	3	5	8	0	0	8	0	0
20	23246215	.	G	A	5	2	7	0	1	8	0	0
20	23248635	.	T	C	8	14	22	0	1	23	0	0
20	23250530	.	C	A	13	7	20	0	1	21	0	0
20	23254585	.	A	T	2	6	8	0	0	8	0	0
20	23332689	.	G	A	4	3	7	0	0	7	0	0
20	23343929	.	C	A	6	2	8	0	0	8	0	0
20	23360252	.	C	T	4	2	6	0	0	6	0	0
20	23360738	.	G	A	4	8	12	0	1	13	0	0
20	23362238	.	G	A	5	2	7	0	0	7	0	0
20	23362814	.	C	T	5	5	10	0	0	10	0	0
20	23363538	.	C	T	5	3	8	0	0	8	0	0
20	23366188	.	G	A	3	2	5	0	0	5	0	0
20	23368411	.	T	C	9	8	17	0	0	17	0	0
20	23368510	.	A	G	3	0	3	0	9	12	0	0
20	23372087	.	C	T	7	2	9	0	1	10	0	0
20	23374412	.	C	T	4	6	10	0	0	10	0	0
20	23376342	.	C	T	12	6	18	0	0	18	0	0
20	23376659	.	C	T	10	4	14	0	0	14	0	0
20	23385556	.	G	A	8	7	15	0	0	15	0	0
20	23386096	.	G	A	13	9	22	0	2	24	0	0
20	23386198	.	A	T	8	16	24	0	0	24	0	0
20	23387775	.	C	T	6	12	18	0	1	19	0	0
20	23402554	.	A	G	13	10	23	0	0	23	0	0
20	23406545	.	T	A	17	18	35	0	0	35	0	0
20	23408734	.	T	C	9	8	17	0	0	17	0	0
20	23418228	.	G	A	15	20	35	0	3	38	0	0
20	23418291	.	C	G	16	12	28	0	0	28	0	0
20	23420784	.	A	T	20	15	35	0	4	39	0	0
20	23421695	.	T	C	21	23	44	0	3	47	0	0
20	23422061	.	T	C	18	19	37	0	4	41	0	0
20	23422205	.	A	T	16	11	27	0	1	28	0	0
20	23432169	.	G	A	1	2	3	0	0	3	0	0
20	23437421	.	A	G	1	5	6	0	0	6	0	0
20	23437451	.	A	G	1	5	6	0	1	7	0	0
20	23446698	.	G	A	8	9	17	0	2	19	0	0
20	23446854	.	C	T	7	3	10	0	1	11	0	0
20	23447086	.	T	C	6	0	6	0	13	19	0	0
20	23447540	.	C	T	9	13	22	0	0	22	0	0
20	23447564	.	C	G	18	12	30	0	1	31	0	0
20	23453642	.	C	T	10	7	17	0	2	19	0	0
20	23453671	.	C	T	9	4	13	0	2	15	0	0
20	23453802	.	G	A	10	4	14	0	1	15	0	0
20	23467400	.	C	A	0	3	3	0	6	9	0	0
20	23471742	.	G	A	8	4	12	0	0	12	0	0
20	23471859	.	C	A	6	9	15	0	0	15	0	0
20	23472036	.	C	T	4	7	11	0	0	11	0	0
20	23472039	.	C	T	8	4	12	0	0	12	0	0
20	23472186	.	T	C	3	5	8	0	4	12	0	0
20	23472239	.	C	T	0	9	9	0	13	22	0	0
20	23472259	.	G	T	13	10	23	0	0	23	0	0
20	23475496	.	A	T	1	2	3	0	0	3	0	0
20	23477436	.	C	T	12	8	20	0	0	20	0	0
20	23478469	.	C	G	4	4	8	0	1	9	0	0
20	23479857	.	C	T	1	5	6	0	2	8	0	0
20	23480658	.	C	T	0	5	5	0	3	8	0	0
20	23491758	.	C	T	1	3	4	0	0	4	0	0
20	23621625	.	C	G	2	3	5	0	0	5	0	0
20	23621696	.	A	G	1	0	1	0	4	5	0	0
20	23621914	.	G	A	1	2	3	0	3	6	0	0
20	23631011	.	C	T	1	2	3	0	0	3	0	0
20	23647770	.	C	A	3	2	5	0	1	6	0	0
20	23647869	.	T	A	2	4	6	0	0	6	0	0
20	23648828	.	G	A	8	4	12	0	1	13	0	0
20	23651156	.	C	A	5	4	9	0	0	9	0	0
20	23651254	.	G	A	2	6	8	0	0	8	0	0
20	23651294	.	C	T	3	2	5	0	0	5	0	0
20	23651503	.	T	C	10	0	10	0	6	16	0	0
20	23655749	.	A	T	10	3	13	0	0	13	0	0
20	23655767	.	C	T	1	11	12	0	1	13	0	0
20	23656226	.	T	A	4	6	10	0	0	10	0	0
20	23656454	.	A	G	5	9	14	0	0	14	0	0
20	23658812	.	G	C	5	6	11	1	0	12	0	0
20	23665041	.	G	A	0	3	3	0	3	6	0	0
20	23665086	.	C	T	1	2	3	0	1	4	0	0
20	23665185	.	A	T	4	4	8	0	0	8	0	0
20	23665793	.	G	T	1	10	11	0	11	22	0	0
20	23665863	.	G	A	0	7	7	0	8	15	0	0
20	23666055	.	T	A	1	3	4	0	0	4	0	0
20	23666137	.	G	T	2	3	5	0	0	5	0	0
20	23685062	.	G	A	4	6	10	0	0	10	0	0
20	23685106	.	A	T	3	7	10	0	0	11	1	0
20	23685259	.	G	T	6	5	11	0	0	11	0	0
20	23685270	.	T	A	5	4	9	0	0	9	0	0
20	23685529	.	T	A	6	5	11	0	0	11	0	0
20	23689192	.	G	A	3	5	8	0	0	8	0	0
20	23689902	.	T	C	5	6	11	0	0	11	0	0
20	23689933	.	G	C	4	3	7	0	0	7	0	0
20	23689996	.	G	A	5	3	8	0	1	9	0	0
20	23690051	.	A	T	5	6	11	0	1	12	0	0
20	23690077	.	C	A	2	5	7	0	0	7	0	0
20	23691015	.	G	A	1	1	2	0	1	3	0	0
20	23691911	.	T	C	15	4	19	0	0	19	0	0
20	23691917	.	C	T	16	5	21	0	1	22	0	0
20	23692094	.	T	C	12	6	18	0	1	20	1	0
20	23694005	.	C	T	1	6	7	0	0	7	0	0
20	23694299	.	G	T	1	3	4	0	8	12	0	0
20	23705719	.	G	A	3	2	5	0	1	6	0	0
20	23705974	.	G	A	9	6	15	0	0	15	0	0
20	23713122	.	G	A	1	7	8	0	9	17	0	0
20	23713197	.	A	G	4	0	4	0	4	8	0	0
20	23713266	.	G	A	0	5	5	1	4	10	0	0
20	23713435	.	T	C	2	2	4	0	1	5	0	0
20	23713475	.	T	A	2	5	7	0	2	9	0	0
20	23713497	.	G	T	5	6	11	0	0	11	0	0
20	23713512	.	A	T	5	4	9	0	0	9	0	0
20	23713535	.	A	G	3	3	6	0	0	6	0	0
20	23713763	.	G	A	4	5	9	0	0	9	0	0
20	23713824	.	A	G	1	4	5	0	1	6	0	0
20	23713883	.	A	G	2	1	3	0	5	8	0	0
20	23742684	.	T	C	3	5	8	0	0	8	0	0
20	23742692	.	G	A	1	4	5	0	0	5	0	0
20	23746672	.	G	A	0	2	2	0	3	5	0	0
20	23746831	.	G	A	0	6	6	0	2	8	0	0
20	23746885	.	G	A	1	2	3	0	4	7	0	0
20	23746966	.	C	G	5	0	5	0	3	8	0	0
20	23747107	.	G	C	0	7	7	0	6	13	0	0
20	23747167	.	A	G	3	10	13	0	0	13	0	0
20	23796406	.	T	C	5	4	9	0	0	9	0	0
20	23796493	.	C	A	7	4	11	0	0	11	0	0
20	23796565	.	C	T	4	4	8	0	0	8	0	0
20	23801024	.	C	T	3	6	9	0	0	9	0	0
20	23801069	.	G	T	1	6	7	0	8	15	0	0
20	23801255	.	G	C	0	4	4	1	15	20	0	0
20	23826955	.	G	A	6	4	10	0	1	11	0	0
20	23828102	.	G	T	12	7	19	0	0	19	0	0
20	23829131	.	A	G	4	8	12	0	0	12	0	0
20	23829161	.	A	G	6	1	7	0	6	13	0	0
20	23829170	.	C	T	7	5	12	0	1	13	0	0
20	23833193	.	G	T	5	5	10	0	1	11	0	0
20	23835228	.	C	T	8	3	11	0	0	11	0	0
20	23835472	.	C	T	9	8	17	0	0	17	0	0
20	23835549	.	C	A	3	3	6	0	0	6	0	0
20	23835591	.	G	T	3	4	7	0	0	7	0	0
20	23836009	.	G	T	2	2	4	0	0	4	0	0
20	23836037	.	G	A	0	3	3	0	4	7	0	0
20	23836106	.	A	T	4	2	6	0	0	6	0	0
20	23836161	.	C	T	4	3	7	0	0	7	0	0
20	23836422	.	A	T	2	4	6	0	0	6	0	0
20	23836474	.	T	C	1	3	4	0	0	4	0	0
20	23836685	.	A	T	4	4	8	0	0	8	0	0
20	23836688	.	C	A	4	4	8	0	0	8	0	0
20	23836756	.	G	A	0	3	3	0	8	11	0	0
20	23836880	.	C	T	2	4	6	0	0	6	0	0
20	23856274	.	T	A	17	6	23	0	0	23	0	0
20	23856345	.	A	T	18	17	35	0	0	35	0	0
20	23857214	.	G	C	21	12	33	0	1	34	0	0
20	23857407	.	C	A	17	20	37	0	2	39	0	0
20	23857559	.	G	A	14	18	32	0	0	32	0	0
20	23857592	.	C	T	16	15	31	0	1	32	0	0
20	23859383	.	G	C	19	10	29	0	1	30	0	0
20	23859386	.	A	G	19	8	27	0	1	28	0	0
20	23859425	.	G	A	0	12	12	0	16	28	0	0
20	23859458	.	A	G	14	14	28	0	4	32	0	0
20	23859486	.	G	A	2	19	21	0	17	38	0	0
20	23879673	.	C	T	7	9	16	0	1	17	0	0
20	23879879	.	G	T	11	12	23	0	0	23	0	0
20	23879903	.	C	A	9	13	22	0	0	22	0	0
20	23881731	.	C	G	7	9	16	0	0	16	0	0
20	23882437	.	C	T	13	4	17	0	2	19	0	0
20	23883008	.	T	C	6	4	10	0	1	11	0	0
20	23883351	.	T	A	7	9	16	0	0	16	0	0
20	23883599	.	T	C	11	8	19	0	0	19	0	0
20	23884479	.	T	C	7	1	8	0	9	17	0	0
20	23885402	.	T	A	10	3	13	0	0	13	0	0
20	23885485	.	T	A	9	5	14	0	2	16	0	0
20	23885505	.	C	T	0	5	5	0	9	14	0	0
20	23885925	.	G	A	15	7	22	0	1	23	0	0
20	23886277	.	A	G	7	13	20	0	2	22	0	0
20	23886358	.	A	G	8	5	13	0	0	13	0	0
20	23887034	.	C	G	4	3	7	0	0	7	0	0
20	23888878	.	C	G	3	9	12	0	0	12	0	0
20	23889403	.	T	G	3	6	9	0	1	10	0	0
20	23890306	.	T	C	2	3	5	0	0	5	0	0
20	23890307	.	C	T	2	3	5	0	0	5	0	0
20	23890376	.	C	T	2	4	6	0	4	10	0	0
20	23890478	.	C	T	2	2	4	0	1	5	0	0
20	23890489	.	C	T	2	2	4	0	0	4	0	0
20	23892006	.	G	A	5	3	8	0	0	8	0	0
20	23892027	.	C	T	0	5	5	0	7	12	0	0
20	23892059	.	G	A	4	8	12	0	0	12	0	0
20	23897219	.	T	C	1	2	3	0	0	3	0	0
20	23897573	.	C	G	3	2	5	0	0	5	0	0
20	23898417	.	G	C	4	4	8	0	1	9	0	0
20	23898760	.	C	T	2	3	5	0	0	5	0	0
20	23898904	.	C	G	3	2	5	0	0	5	0	0
20	23902097	.	A	G	1	2	3	0	0	3	0	0
20	23903800	.	C	A	1	4	5	0	0	5	0	0
20	23903896	.	A	G	4	2	6	0	0	6	0	0
20	23904038	.	C	T	1	3	4	0	3	7	0	0
20	23905799	.	A	G	2	2	4	0	0	4	0	0
20	23909865	.	T	C	0	2	2	0	1	3	0	0
20	23913928	.	G	A	2	2	4	0	0	4	0	0
20	23913997	.	A	G	2	2	4	0	0	4	0	0
20	23915865	.	C	A	1	2	3	0	0	3	0	0
20	23921497	.	C	G	2	2	4	0	0	4	0	0
20	23927464	.	A	T	2	3	5	0	0	5	0	0
20	23950624	.	A	G	2	3	5	0	0	5	0	0
20	23951047	.	G	C	3	2	5	0	1	6	0	0
20	23951057	.	G	A	1	2	3	0	1	4	0	0
20	23951571	.	A	G	1	2	3	0	0	3	0	0
20	23951684	.	A	T	1	3	4	0	0	4	0	0
20	23951913	.	C	T	2	3	5	0	0	5	0	0
20	23952044	.	C	A	3	2	5	0	0	5	0	0
20	23952628	.	T	C	4	3	7	0	1	8	0	0
20	23952632	.	A	C	4	4	8	0	0	8	0	0
20	23953026	.	G	C	2	5	7	0	0	7	0	0
20	23953822	.	A	G	2	3	5	0	1	6	0	0
20	23953963	.	A	G	3	2	5	0	0	5	0	0
20	23954847	.	G	A	1	5	6	0	1	7	0	0
20	23955171	.	G	T	1	3	4	0	0	4	0	0
20	23955237	.	C	G	2	4	6	0	0	6	0	0
20	23955384	.	A	T	6	9	15	0	0	15	0	0
20	23972997	.	C	T	0	7	7	0	7	14	0	0
20	23973358	.	T	C	4	7	11	0	0	11	0	0
20	23973433	.	T	C	9	4	13	0	0	13	0	0
20	23974755	.	G	A	4	3	7	0	0	7	0	0
20	23974834	.	T	C	3	3	6	0	2	8	0	0
20	23974953	.	T	G	8	7	15	0	2	17	0	0
20	23978159	.	G	C	6	3	9	0	0	9	0	0
20	23996985	.	C	A	4	4	8	0	0	8	0	0
20	24122740	.	G	C	15	6	21	0	0	21	0	0
20	24151599	.	C	T	0	6	6	0	10	16	0	0
20	24152098	.	G	A	6	7	13	0	1	14	0	0
20	24152821	.	G	A	13	15	28	0	3	31	0	0
20	24152822	.	G	A	16	13	29	0	2	31	0	0
20	24175892	.	A	G	7	6	13	0	0	13	0	0
20	24182980	.	C	T	5	6	11	0	0	11	0	0
20	24183288	.	G	A	11	9	20	0	0	20	0	0
20	24818673	.	G	A	10	11	21	0	1	22	0	0
20	24819091	.	A	G	10	5	15	0	1	16	0	0
20	24819582	.	C	T	2	13	15	0	13	28	0	0
20	24819646	.	C	T	14	7	21	0	3	24	0	0
20	24819698	.	G	A	8	7	15	0	1	16	0	0
20	24819858	.	T	C	4	8	12	0	0	12	0	0
20	24819929	.	T	C	9	8	17	0	1	18	0	0
20	24820032	.	T	C	8	5	13	0	0	13	0	0
20	24820746	.	A	T	5	4	9	0	1	10	0	0
20	24820758	.	C	A	5	4	9	0	0	9	0	0
20	24820885	.	C	T	0	10	10	0	6	16	0	0
20	24820963	.	T	A	16	8	24	0	0	24	0	0
20	24821048	.	C	A	8	14	22	0	0	22	0	0
20	24821072	.	A	G	11	12	23	0	0	23	0	0
20	24821499	.	T	G	7	7	14	0	1	15	0	0
20	24821604	.	G	A	18	6	24	0	0	24	0	0
20	24835754	.	C	T	1	3	4	0	6	10	0	0
20	24852707	.	C	T	1	4	5	0	2	7	0	0
20	24915538	.	G	A	6	7	13	0	0	13	0	0
20	24915591	.	T	C	8	0	8	0	7	15	0	0
20	24915712	.	G	A	7	6	13	0	1	14	0	0
20	24959732	.	A	G	5	3	8	0	1	9	0	0
20	24962956	.	G	A	5	6	11	0	0	11	0	0
20	25243971	.	T	A	2	2	4	0	0	4	0	0
20	25271367	.	A	G	2	2	4	0	0	4	0	0
20	25271382	.	A	G	2	1	3	0	0	3	0	0
20	25342164	.	C	T	2	3	5	0	0	5	0	0
20	25342397	.	C	T	2	6	8	0	0	8	0	0
20	25342721	.	C	T	4	4	8	0	0	8	0	0
20	25368785	.	A	G	1	2	3	0	0	3	0	0
20	25368871	.	C	T	5	4	9	0	1	10	0	0
20	25371869	.	A	G	2	6	8	0	0	8	0	0
20	25372057	.	A	G	1	5	6	0	0	6	0	0
20	25372677	.	A	G	2	3	5	0	0	5	0	0
20	25378556	.	C	T	5	4	9	0	0	9	0	0
20	25378583	.	T	G	2	7	9	0	1	10	0	0
20	25378610	.	C	T	2	9	11	0	0	11	0	0
20	25384473	.	A	T	5	6	11	0	0	11	0	0
20	25384494	.	G	A	3	5	8	0	0	8	0	0
20	25387850	.	T	A	7	5	12	0	0	12	0	0
20	25387865	.	A	G	5	6	11	0	1	12	0	0
20	25440724	.	G	T	10	7	17	0	1	18	0	0
20	25441033	.	G	T	12	10	22	0	1	23	0	0
20	25444929	.	A	G	7	6	13	0	0	13	0	0
20	25494132	.	T	A	3	3	6	0	1	7	0	0
20	25499412	.	A	C	4	8	12	0	0	12	0	0
20	25500859	.	A	G	9	0	9	1	8	18	0	0
20	25500922	.	C	T	7	11	18	0	0	18	0	0
20	25507789	.	G	A	3	7	10	0	0	10	0	0
20	25509772	.	C	T	10	16	26	0	1	27	0	0
20	25509842	.	C	A	18	14	32	0	1	33	0	0
20	25509851	.	A	T	19	13	32	0	1	33	0	0
20	25510234	.	A	T	2	6	8	0	0	8	0	0
20	25510256	.	T	A	4	3	7	0	0	7	0	0
20	25510270	.	G	T	4	2	6	0	0	6	0	0
20	25510481	.	A	G	8	5	13	0	1	14	0	0
20	25510586	.	A	G	6	9	15	0	0	15	0	0
20	25510630	.	G	A	6	11	17	0	2	19	0	0
20	25510739	.	C	A	6	5	11	0	1	12	0	0
20	25510897	.	G	C	5	9	14	0	1	15	0	0
20	25511312	.	T	A	8	8	16	0	0	16	0	0
20	25511609	.	T	C	13	13	26	0	0	26	0	0
20	25511785	.	T	C	2	9	11	0	1	12	0	0
20	25511940	.	G	A	0	5	5	0	3	8	0	0
20	25511957	.	A	T	5	2	7	0	0	7	0	0
20	25516185	.	C	T	2	3	5	0	0	5	0	0
20	25548780	.	C	T	0	3	3	0	4	7	0	0
20	25549304	.	G	A	2	3	5	0	0	5	0	0
20	25550804	.	G	A	1	2	3	0	0	3	0	0
20	25564919	.	A	G	1	2	3	0	0	3	0	0
20	25567669	.	G	A	1	2	3	0	0	3	0	0
20	25623778	.	A	T	3	9	12	0	0	12	0	0
20	25625969	.	A	G	3	4	7	0	0	7	0	0
20	25626180	.	T	C	1	3	4	0	0	4	0	0
20	25626615	.	G	T	3	4	7	0	0	7	0	0
20	25628390	.	C	T	1	4	5	0	2	7	0	0
20	25629102	.	G	A	2	5	7	0	0	7	0	0
20	25629158	.	T	A	6	3	9	0	0	9	0	0
20	25629730	.	G	A	7	3	10	0	0	10	0	0
20	25631207	.	T	C	5	3	8	0	0	8	0	0
20	25632820	.	A	G	2	3	5	0	0	5	0	0
20	25635207	.	G	A	2	3	5	0	0	5	0	0
20	25660033	.	T	A	2	4	6	0	0	6	0	0
20	25661199	.	A	G	15	18	33	0	0	33	0	0
20	25661509	.	G	A	22	19	41	0	0	41	0	0
20	25663590	.	T	G	21	17	38	0	3	41	0	0
20	25665101	.	G	T	20	17	37	0	1	38	0	0
20	25665115	.	G	T	22	18	40	0	1	41	0	0
20	25665144	.	G	T	23	19	42	0	1	43	0	0
20	25665195	.	G	A	25	15	40	0	1	41	0	0
20	25665325	.	T	G	5	18	23	0	3	26	0	0
20	25665506	.	C	T	13	11	24	0	0	24	0	0
20	25665515	.	C	T	12	11	23	0	2	25	0	0
20	25665627	.	T	C	9	10	19	0	1	20	0	0
20	25665822	.	G	A	13	9	22	0	1	23	0	0
20	25665927	.	T	C	10	11	21	0	0	21	0	0
20	25666142	.	C	T	13	13	26	0	1	27	0	0
20	25666277	.	G	T	10	12	22	0	3	25	0	0
20	25666812	.	T	A	18	13	31	0	1	32	0	0
20	25666947	.	C	T	15	13	28	0	1	29	0	0
20	25669567	.	T	G	8	7	15	0	1	16	0	0
20	25669888	.	C	A	17	9	26	0	0	26	0	0
20	25853191	.	T	C	3	3	6	0	0	6	0	0
20	25853228	.	T	C	5	4	9	0	0	9	0	0
20	25853767	.	A	G	20	17	37	0	1	38	0	0
20	25855561	.	G	A	17	14	31	0	2	33	0	0
20	25859494	.	C	T	18	14	32	0	0	32	0	0
20	25878578	.	G	A	2	2	4	1	0	5	0	0
20	25906391	.	T	C	4	5	9	0	1	10	0	0
20	25909276	.	T	C	8	9	17	0	0	17	0	0
20	25909330	.	C	T	8	11	19	0	0	19	0	0
20	25909462	.	T	C	7	15	22	0	2	24	0	0
20	25909699	.	C	T	9	13	22	0	0	22	0	0
20	25909765	.	A	C	7	12	19	0	0	19	0	0
20	25910133	.	G	A	1	5	6	0	0	6	0	0
20	25910298	.	A	T	4	3	7	0	0	7	0	0
20	25910366	.	A	T	5	6	11	0	0	11	0	0
20	25910368	.	A	T	5	6	11	0	0	11	0	0
20	25919371	.	T	C	13	22	35	0	0	35	0	0
20	25921009	.	C	T	18	12	30	0	0	30	0	0
20	25923747	.	T	C	14	15	29	0	0	29	0	0
20	25923960	.	T	C	19	24	43	0	3	46	0	0
20	25926048	.	A	G	15	20	35	0	1	36	0	0
20	25926474	.	G	A	11	12	23	0	0	23	0	0
20	25926505	.	T	C	9	8	17	0	0	17	0	0
20	25926540	.	T	A	8	8	16	0	1	17	0	0
20	25926623	.	A	G	4	8	12	0	1	13	0	0
20	25927126	.	C	A	18	15	33	0	2	35	0	0
20	25927259	.	C	G	18	0	18	0	16	34	0	0
20	25927283	.	T	G	17	19	36	0	1	37	0	0
20	25928098	.	C	T	13	8	21	0	1	22	0	0
20	25929913	.	T	A	16	18	34	1	0	35	0	0
20	25930671	.	T	C	17	21	38	0	3	41	0	0
20	25939014	.	G	C	2	4	6	0	0	6	0	0
20	25953365	.	G	C	1	2	3	0	0	3	0	0
20	26002683	.	T	C	5	4	9	0	0	9	0	0
20	26002780	.	T	A	8	8	16	0	0	16	0	0
20	26002822	.	A	G	7	6	13	0	0	13	0	0
20	26002900	.	C	G	16	8	24	0	0	24	0	0
20	26002970	.	A	G	7	0	7	0	9	16	0	0
20	26004160	.	T	A	17	8	25	0	2	27	0	0
20	26004251	.	A	G	9	11	20	0	0	20	0	0
20	26023822	.	T	C	4	5	9	1	0	10	0	0
20	26024196	.	G	A	19	19	38	0	3	41	0	0
20	26024432	.	C	T	18	15	33	0	1	34	0	0
20	26024434	.	A	G	20	15	35	0	1	36	0	0
20	26024565	.	G	A	3	16	19	0	12	31	0	0
20	26027048	.	C	T	1	6	7	0	5	12	0	0
20	26027434	.	G	T	8	7	15	0	1	16	0	0
20	26027630	.	C	T	2	4	6	0	0	6	0	0
20	26030641	.	G	T	9	8	17	0	0	17	0	0
20	26042015	.	C	T	1	2	3	0	1	4	0	0
20	26047462	.	G	A	10	23	33	0	0	33	0	0
20	26048815	.	C	T	2	2	4	0	1	5	0	0
20	26049961	.	G	A	5	5	10	0	0	10	0	0
20	26050226	.	T	C	5	0	5	0	3	8	0	0
20	26055709	.	A	C	1	4	5	0	0	5	0	0
20	26059911	.	T	A	2	2	4	0	0	4	0	0
20	26059928	.	C	T	1	3	4	0	0	4	0	0
20	26060088	.	G	T	3	4	7	0	2	9	0	0
20	26117653	.	T	C	2	3	5	0	0	5	0	0
20	26209673	.	A	G	2	0	2	0	4	6	0	0
20	26209679	.	T	C	2	4	6	0	0	6	0	0
20	26220679	.	A	T	2	2	4	0	0	4	0	0
20	26241632	.	T	G	1	3	4	0	0	4	0	0
20	26241666	.	A	G	2	5	7	0	1	8	0	0
20	26268443	.	T	C	4	3	7	0	0	7	0	0
20	26269970	.	C	T	3	4	7	0	0	7	0	0
20	26270730	.	A	G	6	5	11	0	0	11	0	0
20	26271357	.	G	T	1	4	5	0	6	11	0	0
20	26273194	.	T	C	3	5	8	0	0	8	0	0
20	26273680	.	C	T	6	9	15	0	2	17	0	0
20	26279817	.	A	C	5	4	9	0	2	11	0	0
20	26279961	.	A	C	4	7	11	0	1	12	0	0
20	26283471	.	C	A	12	10	22	0	1	23	0	0
20	26285416	.	A	G	6	0	6	0	7	13	0	0
20	26285606	.	G	A	7	6	13	0	0	13	0	0
20	26290451	.	G	A	17	8	25	0	1	26	0	0
20	26290667	.	A	T	9	10	19	0	0	19	0	0
20	26290738	.	A	T	10	8	18	0	0	18	0	0
20	26290739	.	T	C	10	7	17	0	1	18	0	0
20	26290778	.	A	G	7	7	14	0	3	17	0	0
20	26290947	.	A	G	8	4	12	0	0	12	0	0
20	26290962	.	C	T	8	6	14	0	0	14	0	0
20	26291016	.	G	C	2	11	13	0	0	13	0	0
20	26291147	.	T	C	4	4	8	0	0	8	0	0
20	26291213	.	A	G	6	3	9	0	0	9	0	0
20	26291331	.	T	C	4	8	12	0	1	13	0	0
20	26291985	.	T	C	7	5	12	0	0	12	0	0
20	26298380	.	G	A	7	13	20	0	2	22	0	0
20	26300495	.	A	G	8	6	14	0	0	14	0	0
20	26300840	.	G	T	6	5	11	0	0	11	0	0
20	26301092	.	C	T	6	13	19	0	1	20	0	0
20	26304317	.	A	G	7	5	12	0	1	13	0	0
20	26304918	.	G	A	8	7	15	0	0	15	0	0
20	26304921	.	G	A	8	8	16	0	0	16	0	0
20	26305019	.	A	T	13	5	18	0	0	18	0	0
20	26310596	.	T	A	10	7	17	0	2	19	0	0
20	26310637	.	C	T	5	11	16	0	0	16	0	0
20	26320288	.	T	C	15	12	27	0	3	30	0	0
20	26321073	.	G	A	9	13	22	0	1	23	0	0
20	26323356	.	T	C	10	16	26	0	0	26	0	0
20	26325671	.	A	G	14	13	27	0	3	30	0	0
20	26326345	.	T	C	18	18	36	0	2	38	0	0
20	26327719	.	C	T	12	12	24	0	0	24	0	0
20	26328051	.	C	T	10	14	24	0	0	24	0	0
20	26329035	.	G	A	6	7	13	0	2	15	0	0
20	26331595	.	A	G	16	14	30	0	2	32	0	0
20	26334446	.	C	T	21	10	31	0	3	34	0	0
20	26336921	.	C	G	14	14	28	0	1	30	1	0
20	26337036	.	C	T	20	23	43	0	3	46	0	0
20	26337733	.	C	T	24	26	50	0	2	52	0	0
20	26342889	.	C	T	17	12	29	0	4	33	0	0
20	26344835	.	A	G	21	16	37	0	0	37	0	0
20	26345856	.	T	A	22	22	44	0	1	45	0	0
20	26346710	.	C	T	24	24	48	0	1	49	0	0
20	26348838	.	G	A	2	15	17	0	20	37	0	0
20	26351914	.	T	G	19	2	21	1	21	43	0	0
20	26353751	.	T	C	16	19	35	0	2	37	0	0
20	26353770	.	A	G	17	18	35	0	2	37	0	0
20	26353793	.	T	C	24	17	41	0	0	41	0	0
20	26358574	.	T	C	27	23	50	0	1	51	0	0
20	26360192	.	C	T	4	5	9	0	0	9	0	0
20	26361403	.	G	A	2	4	6	0	0	6	0	0
20	26366752	.	T	C	1	3	4	0	0	4	0	0
20	26382334	.	G	T	1	2	3	0	0	3	0	0
20	26382361	.	G	C	1	2	3	0	0	3	0	0
20	26387181	.	G	A	7	6	13	0	1	14	0	0
20	26387288	.	T	A	6	9	15	0	0	15	0	0
20	26387413	.	A	T	10	4	14	0	0	14	0	0
20	26387881	.	T	G	4	9	13	0	0	13	0	0
20	26390906	.	C	T	6	4	10	0	0	10	0	0
20	26390912	.	G	A	5	4	9	0	1	10	0	0
20	26402615	.	T	C	3	7	10	0	0	10	0	0
20	26404281	.	A	G	3	1	4	0	3	7	0	0
20	26404361	.	C	G	3	4	7	0	0	7	0	0
20	26404443	.	G	A	0	3	3	0	6	9	0	0
20	26404696	.	G	A	1	3	4	0	4	8	0	0
20	26404860	.	T	A	3	8	11	0	1	12	0	0
20	26405406	.	T	G	7	0	7	0	5	12	0	0
20	26405669	.	C	A	3	2	5	0	0	5	0	0
20	26405683	.	T	C	2	2	4	0	0	4	0	0
20	26405808	.	T	A	4	2	6	0	1	7	0	0
20	26405857	.	G	A	0	4	4	0	3	7	0	0
20	26406160	.	G	A	3	9	12	0	3	15	0	0
20	26406252	.	T	C	4	2	6	0	0	6	0	0
20	26406352	.	T	C	5	2	7	0	0	7	0	0
20	26406792	.	T	A	4	3	7	0	0	7	0	0
20	26406806	.	C	T	1	3	4	0	0	4	0	0
20	26406978	.	A	G	3	0	3	0	4	7	0	0
20	26409194	.	T	A	10	4	14	0	0	14	0	0
20	26409261	.	C	A	1	13	14	0	6	20	0	0
20	26409295	.	C	A	12	15	27	0	0	27	0	0
20	26409310	.	A	T	15	12	27	0	0	27	0	0
20	26409403	.	A	T	12	4	16	0	0	16	0	0
20	26409471	.	C	T	0	15	15	0	8	23	0	0
20	26409599	.	C	T	18	18	36	0	0	36	0	0
20	26409922	.	T	C	18	15	33	0	1	34	0	0
20	26409931	.	C	T	24	15	39	0	2	41	0	0
20	26410224	.	G	T	10	11	21	0	1	22	0	0
20	26410275	.	G	A	8	6	14	0	1	15	0	0
20	26410341	.	A	G	16	14	30	0	1	31	0	0
20	26410344	.	A	C	14	15	29	0	3	32	0	0
20	26412372	.	T	A	11	11	22	0	0	22	0	0
20	26412479	.	C	T	11	14	25	0	0	25	0	0
20	26412501	.	G	A	9	13	22	0	0	22	0	0
20	26412579	.	C	A	9	20	29	0	0	29	0	0
20	26412830	.	G	T	22	18	40	0	1	41	0	0
20	26412831	.	G	T	23	18	41	0	0	41	0	0
20	26412876	.	G	A	15	19	34	0	1	35	0	0
20	26412968	.	T	A	16	24	40	0	1	41	0	0
20	26413057	.	G	A	12	13	25	0	0	25	0	0
20	26413181	.	T	C	8	14	22	0	2	24	0	0
20	26413269	.	C	A	11	11	22	0	1	23	0	0
20	26413280	.	A	C	12	0	12	0	12	24	0	0
20	26413311	.	C	T	17	11	28	0	0	28	0	0
20	26413470	.	G	T	11	17	28	0	0	28	0	0
20	26413584	.	G	A	13	7	20	0	0	20	0	0
20	26413923	.	C	T	12	6	18	0	1	19	0	0
20	26413998	.	A	T	8	14	22	0	0	22	0	0
20	26414724	.	C	T	3	12	15	0	4	19	0	0
20	26414747	.	C	T	8	6	14	0	3	17	0	0
20	26414832	.	C	T	13	6	19	0	0	19	0	0
20	26414844	.	G	A	11	6	17	0	0	17	0	0
20	26415021	.	G	T	11	8	19	0	0	19	0	0
20	26416114	.	A	G	6	12	18	0	0	18	0	0
20	26416218	.	C	T	7	8	15	0	0	15	0	0
20	26416265	.	C	T	11	7	18	0	0	18	0	0
20	26416266	.	T	A	11	7	18	0	0	18	0	0
20	26416353	.	T	G	15	11	26	0	1	27	0	0
20	26416469	.	C	G	10	4	14	0	1	15	0	0
20	26416514	.	T	C	9	7	16	0	0	16	0	0
20	26416551	.	A	T	4	7	11	0	0	11	0	0
20	26467216	.	C	T	14	6	20	0	0	20	0	0
20	26467293	.	T	C	5	4	9	0	1	10	0	0
20	26467302	.	G	A	3	4	7	0	0	7	0	0
20	26574266	.	C	T	6	9	15	0	0	15	0	0
20	26584155	.	A	T	6	8	14	0	1	15	0	0
20	26587834	.	A	G	12	11	23	0	0	23	0	0
20	26594516	.	G	T	8	3	11	0	0	11	0	0
20	26599709	.	C	T	9	8	17	0	2	19	0	0
20	26599748	.	G	C	11	6	17	0	1	18	0	0
20	26601222	.	G	A	11	16	27	0	0	27	0	0
20	26610433	.	G	A	11	12	23	0	1	24	0	0
20	26613462	.	A	G	16	15	31	0	0	31	0	0
20	26616241	.	G	C	13	0	13	0	10	23	0	0
20	26684415	.	T	G	1	2	3	0	0	3	0	0
20	26807385	.	G	A	7	4	11	0	0	11	0	0
20	26809059	.	A	G	7	7	14	0	1	15	0	0
20	26822389	.	A	G	9	7	16	0	0	16	0	0
20	26822449	.	A	G	8	11	19	0	1	20	0	0
20	26915443	.	T	C	3	2	5	0	1	6	0	0
20	26918364	.	G	A	2	2	4	0	0	4	0	0
20	26918641	.	A	G	2	2	4	0	0	4	0	0
20	26939926	.	C	T	16	14	30	0	2	32	0	0
20	26944106	.	G	A	12	19	31	0	0	31	0	0
20	26944311	.	G	A	28	10	38	0	6	44	0	0
20	26944576	.	C	T	15	14	29	0	2	31	0	0
20	26944762	.	C	T	15	10	25	0	0	25	0	0
20	26944971	.	G	A	6	7	13	0	0	13	0	0
20	26945120	.	A	T	5	5	10	0	2	12	0	0
20	26945180	.	T	A	4	3	7	0	0	7	0	0
20	26945394	.	C	T	15	7	22	0	0	22	0	0
20	26945735	.	C	T	5	10	15	0	1	16	0	0
20	26945913	.	T	C	15	14	29	0	1	30	0	0
20	26948033	.	A	T	3	7	10	0	2	12	0	0
20	26948161	.	A	G	7	5	12	0	0	12	0	0
20	26948347	.	T	C	10	10	20	0	0	20	0	0
20	26958737	.	C	T	12	16	28	0	0	28	0	0
20	26959139	.	G	C	4	9	13	0	0	13	0	0
20	26959605	.	T	C	8	9	17	0	0	17	0	0
20	26959624	.	C	T	9	8	17	0	1	18	0	0
20	26959829	.	C	T	12	5	17	0	0	17	0	0
20	26959900	.	G	A	0	3	3	0	4	7	0	0
20	26959902	.	G	C	4	3	7	0	0	7	0	0
20	26960032	.	G	C	9	8	17	0	1	18	0	0
20	26960540	.	A	G	4	0	4	0	15	19	0	0
20	26960619	.	A	G	12	9	21	0	0	21	0	0
20	26960673	.	A	G	8	4	12	0	1	13	0	0
20	26960802	.	T	C	7	5	12	0	0	12	0	0
20	26960877	.	G	A	0	9	9	0	8	17	0	0
20	26961079	.	G	A	0	5	5	0	5	10	0	0
20	26961469	.	A	G	6	7	13	0	1	14	0	0
20	26961719	.	T	A	6	4	10	0	0	10	0	0
20	26961758	.	A	T	7	6	13	0	0	13	0	0
20	26961799	.	C	T	14	4	18	0	0	18	0	0
20	26961832	.	T	G	12	3	15	0	0	16	1	0
20	26961907	.	A	G	11	13	24	0	0	24	0	0
20	26962077	.	G	A	0	8	8	0	13	21	0	0
20	26962095	.	T	C	10	8	18	0	0	18	0	0
20	26962385	.	T	A	9	5	14	0	0	14	0	0
20	26962455	.	G	A	2	5	7	0	5	12	0	0
20	26973754	.	T	A	2	2	4	0	0	4	0	0
20	26989248	.	T	G	6	3	9	0	0	9	0	0
20	26989258	.	T	G	5	3	8	0	0	8	0	0
20	26993506	.	C	T	8	4	12	0	1	13	0	0
20	26994703	.	T	A	7	6	13	0	1	14	0	0
20	26999506	.	T	A	6	3	9	0	1	10	0	0
20	27001816	.	A	C	8	14	22	0	1	23	0	0
20	27001864	.	T	A	5	14	19	0	0	19	0	0
20	27001867	.	C	T	4	15	19	0	0	19	0	0
20	27001903	.	C	T	5	14	19	0	1	20	0	0
20	27001915	.	T	C	8	12	20	0	0	20	0	0
20	27002007	.	A	G	7	6	13	0	0	13	0	0
20	27020221	.	G	A	7	11	18	0	2	20	0	0
20	27020294	.	T	A	25	20	45	0	0	45	0	0
20	27020346	.	A	C	17	17	34	0	3	37	0	0
20	27020442	.	G	T	22	20	42	0	1	43	0	0
20	27020446	.	G	A	21	21	42	0	1	43	0	0
20	27029685	.	A	C	28	29	57	1	3	61	0	0
20	27033700	.	C	T	22	34	56	1	5	62	0	0
20	27033847	.	A	T	25	34	59	0	0	59	0	0
20	27033914	.	A	G	25	28	53	3	4	60	0	0
20	27039364	.	G	T	3	34	37	0	29	66	0	0
20	27039400	.	G	A	23	37	60	0	3	63	0	0
20	27039498	.	C	T	28	35	63	0	1	64	0	0
20	27039550	.	A	T	25	31	56	0	0	56	0	0
20	27039577	.	C	T	25	20	45	0	7	52	0	0
20	27045649	.	T	G	23	2	25	0	34	60	1	0
20	27045703	.	A	G	12	23	35	0	3	38	0	0
20	27045719	.	T	C	14	14	28	0	7	35	0	0
20	27045875	.	T	C	10	11	21	0	0	21	0	0
20	27087569	.	C	T	4	8	12	0	1	13	0	0
20	27089494	.	G	T	1	2	3	0	0	3	0	0
20	27089717	.	C	T	2	2	4	0	0	4	0	0
20	27089858	.	A	T	3	5	8	0	0	8	0	0
20	27089870	.	T	A	5	3	8	0	0	8	0	0
20	27090134	.	G	T	2	3	5	0	0	5	0	0
20	27090240	.	A	C	1	2	3	0	0	3	0	0
20	27090340	.	A	G	4	7	11	0	0	11	0	0
20	27090401	.	C	T	3	9	12	0	0	12	0	0
20	27091064	.	G	A	3	6	9	0	1	10	0	0
20	27091143	.	G	A	4	7	11	0	0	11	0	0
20	27092182	.	C	T	13	13	26	0	1	27	0	0
20	27092245	.	A	G	10	12	22	0	0	22	0	0
20	27093198	.	A	T	2	7	9	0	0	9	0	0
20	27093286	.	C	T	4	5	9	0	0	9	0	0
20	27094615	.	A	G	5	3	8	0	2	10	0	0
20	27094624	.	C	T	4	5	9	0	0	9	0	0
20	27094693	.	T	C	7	4	11	0	1	12	0	0
20	27096092	.	A	T	12	15	27	0	0	27	0	0
20	27096469	.	G	T	1	8	9	0	10	19	0	0
20	27100005	.	T	C	16	6	22	1	0	23	0	0
20	27102325	.	C	T	12	9	21	0	0	21	0	0
20	27107173	.	A	C	8	12	20	0	0	20	0	0
20	27107241	.	C	A	6	8	14	0	0	14	0	0
20	27107545	.	G	T	0	2	2	0	4	6	0	0
20	27107572	.	C	G	4	4	8	0	0	8	0	0
20	27115030	.	T	C	3	5	8	0	1	9	0	0
20	27122383	.	C	T	2	2	4	0	0	4	0	0
20	27150027	.	A	G	1	3	4	0	0	4	0	0
20	27281203	.	A	G	7	3	10	0	0	10	0	0
20	27281624	.	T	C	8	5	13	0	0	13	0	0
20	27281678	.	A	C	5	5	10	1	0	11	0	0
20	27281780	.	T	G	5	4	9	0	1	10	0	0
20	27281814	.	T	A	5	2	7	0	0	7	0	0
20	27282179	.	G	A	1	2	3	0	0	3	0	0
20	27282340	.	A	C	2	6	8	0	0	8	0	0
20	27282561	.	T	C	4	9	13	0	0	13	0	0
20	27282592	.	A	G	5	7	12	0	0	12	0	0
20	27282598	.	T	A	6	8	14	0	0	14	0	0
20	27283206	.	C	A	4	2	6	0	0	6	0	0
20	27331149	.	G	A	5	11	16	0	2	18	0	0
20	27352584	.	T	C	9	10	19	2	0	21	0	0
20	27352591	.	A	G	9	0	9	2	10	21	0	0
20	27353040	.	T	C	8	9	17	0	0	17	0	0
20	27353982	.	A	G	15	9	24	0	1	25	0	0
20	27358777	.	C	A	17	16	33	0	0	33	0	0
20	27366122	.	G	A	6	11	17	0	0	17	0	0
20	27366597	.	T	G	14	13	27	0	1	28	0	0
20	27368882	.	A	C	23	17	40	0	1	41	0	0
20	27370340	.	G	A	17	21	38	0	0	38	0	0
20	27371629	.	T	C	6	33	39	0	3	42	0	0
20	27371642	.	A	C	9	30	39	0	3	42	0	0
20	27371693	.	T	A	7	14	21	0	1	22	0	0
20	27371735	.	A	G	4	15	19	0	0	19	0	0
20	27371737	.	T	C	4	0	4	0	15	19	0	0
20	27371821	.	C	A	19	18	37	0	2	39	0	0
20	27374961	.	C	T	30	28	58	1	3	63	1	0
20	27375008	.	C	T	3	27	30	0	33	63	0	0
20	27378174	.	C	T	28	33	61	0	0	61	0	0
20	27378252	.	A	T	29	24	53	0	0	53	0	0
20	27378321	.	G	T	25	37	62	0	3	65	0	0
20	27381508	.	G	A	20	24	44	0	1	45	0	0
20	27381529	.	T	G	18	24	42	0	1	43	0	0
20	27396384	.	T	A	10	8	18	0	1	19	0	0
20	27396385	.	A	T	9	9	18	0	1	19	0	0
20	27396478	.	A	T	3	8	11	0	1	12	0	0
20	27396489	.	C	T	5	5	10	0	0	10	0	0
20	27528655	.	C	A	1	3	4	0	0	4	0	0
20	27528660	.	T	C	1	3	4	0	0	4	0	0
20	27540823	.	A	G	5	2	7	0	0	7	0	0
20	27541507	.	T	C	3	3	6	0	0	6	0	0
20	27541949	.	G	A	2	2	4	0	1	5	0	0
20	27541954	.	G	A	0	3	3	0	2	5	0	0
20	27542146	.	G	A	0	6	6	0	5	11	0	0
20	27542371	.	G	A	0	3	3	0	3	6	0	0
20	27542951	.	A	G	4	2	6	0	1	7	0	0
20	27545969	.	C	T	4	3	7	0	1	8	0	0
20	27549491	.	G	A	5	3	8	0	2	10	0	0
20	27549524	.	G	A	6	4	10	0	0	10	0	0
20	27550063	.	G	A	2	6	8	0	0	8	0	0
20	27550104	.	G	T	3	7	10	0	0	10	0	0
20	27550148	.	C	T	3	3	6	0	0	6	0	0
20	27550150	.	A	C	3	3	6	0	0	6	0	0
20	27550915	.	T	A	4	2	6	0	0	6	0	0
20	27551253	.	A	C	4	3	7	0	0	7	0	0
20	27551329	.	A	G	5	4	9	0	0	9	0	0
20	27551563	.	T	C	2	2	4	0	0	4	0	0
20	27551624	.	C	T	5	2	7	0	1	8	0	0
20	27692420	.	A	G	1	2	3	0	0	3	0	0
20	27692588	.	A	T	1	2	3	0	0	3	0	0
20	27692632	.	G	T	1	2	3	0	1	4	0	0
20	27692634	.	A	G	2	2	4	0	0	4	0	0
20	27707974	.	G	A	3	4	7	0	0	7	0	0
20	27708016	.	G	A	4	4	8	0	0	8	0	0
20	27708181	.	C	T	7	3	10	0	0	10	0	0
20	27708306	.	A	G	4	8	12	0	0	12	0	0
20	27708943	.	G	A	3	6	9	0	0	9	0	0
20	27712847	.	T	C	2	4	6	0	0	6	0	0
20	27716086	.	G	A	0	3	3	0	1	4	0	0
20	27716093	.	C	T	3	3	6	0	0	6	0	0
20	27717055	.	T	A	3	9	12	0	0	12	0	0
20	27717493	.	A	G	3	4	7	0	1	8	0	0
20	27717884	.	G	A	1	2	3	0	0	3	0	0
20	27718082	.	G	T	2	2	4	0	0	4	0	0
20	27718292	.	T	C	1	4	5	0	0	5	0	0
20	27718304	.	T	C	1	4	5	0	0	5	0	0
20	27718549	.	T	A	2	4	6	0	0	6	0	0
20	27718578	.	A	T	1	7	8	0	0	8	0	0
20	27718734	.	A	G	1	2	3	0	0	3	0	0
20	27718751	.	T	G	1	3	4	0	0	4	0	0
20	27719088	.	A	G	1	10	11	0	0	11	0	0
20	27719496	.	C	T	2	2	4	0	0	4	0	0
20	27719578	.	T	C	2	3	5	0	0	5	0	0
20	27719763	.	G	A	6	6	12	0	0	12	0	0
20	27719859	.	T	C	7	6	13	0	1	14	0	0
20	27732628	.	A	G	4	9	13	0	2	15	0	0
20	27732832	.	A	G	7	5	12	0	0	12	0	0
20	27733034	.	G	A	9	14	23	0	0	23	0	0
20	27733611	.	T	C	6	8	14	0	0	14	0	0
20	27733631	.	G	C	3	0	3	0	11	14	0	0
20	27733650	.	C	A	1	11	12	0	5	17	0	0
20	28294732	.	G	T	4	6	10	0	0	10	0	0
20	28310920	.	A	G	1	3	4	0	0	4	0	0
20	28316845	.	G	T	4	5	9	0	1	10	0	0
20	28324826	.	G	T	1	3	4	0	0	4	0	0
20	28326229	.	G	A	5	4	9	0	1	10	0	0
20	28326283	.	A	T	4	3	7	0	0	7	0	0
20	28326508	.	T	C	3	4	7	0	1	8	0	0
20	28326565	.	T	C	3	3	6	0	0	6	0	0
20	28337616	.	G	A	1	5	6	0	0	6	0	0
20	28337640	.	A	G	2	5	7	0	0	7	0	0
20	28347649	.	G	A	3	5	8	0	0	8	0	0
20	28349032	.	G	C	4	1	5	0	0	5	0	0
20	28349054	.	T	G	1	2	3	0	0	3	0	0
20	28349123	.	G	T	2	2	4	0	1	5	0	0
20	28354549	.	T	A	5	5	10	0	0	10	0	0
20	28354588	.	A	G	7	7	14	0	0	14	0	0
20	28354951	.	A	G	4	6	10	0	1	11	0	0
20	28356989	.	T	C	10	12	22	0	1	23	0	0
20	28356998	.	G	A	9	13	22	0	0	22	0	0
20	28357028	.	A	G	10	9	19	0	0	19	0	0
20	28357184	.	A	G	5	9	14	0	0	14	0	0
20	28357190	.	C	T	5	10	15	0	0	15	0	0
20	28357463	.	A	G	9	5	14	0	0	14	0	0
20	28357538	.	G	A	5	4	9	0	1	10	0	0
20	28357570	.	A	G	5	4	9	0	0	9	0	0
20	28357610	.	A	G	8	4	12	0	1	13	0	0
20	28357688	.	T	C	7	7	14	0	0	14	0	0
20	28357718	.	T	C	4	9	13	0	1	14	0	0
20	28357733	.	G	A	5	11	16	0	0	16	0	0
20	28357769	.	A	G	2	10	12	0	1	13	0	0
20	28357823	.	T	A	4	9	13	0	0	13	0	0
20	28357883	.	C	T	5	5	10	0	0	10	0	0
20	28358060	.	C	G	6	4	10	0	0	10	0	0
20	28361044	.	C	T	6	5	11	0	0	11	0	0
20	28400232	.	A	T	3	4	7	0	0	7	0	0
20	28400380	.	A	T	3	2	5	0	0	5	0	0
20	28400422	.	C	T	4	3	7	0	0	7	0	0
20	28400455	.	A	C	6	4	10	0	0	10	0	0
20	28400481	.	A	G	10	5	15	0	1	16	0	0
20	28400619	.	G	A	12	9	21	0	2	23	0	0
20	28401147	.	A	G	9	8	17	0	0	17	0	0
20	28401298	.	C	G	0	6	6	0	0	6	0	0
20	28401309	.	C	T	1	7	8	0	0	8	0	0
20	28402253	.	G	A	6	8	14	0	1	15	0	0
20	28402426	.	G	A	11	7	18	0	1	19	0	0
20	28402456	.	A	G	15	6	21	0	1	22	0	0
20	28402470	.	G	A	13	6	19	0	0	19	0	0
20	28404191	.	A	G	7	6	13	0	0	13	0	0
20	28404247	.	T	C	12	1	13	0	5	18	0	0
20	28404270	.	T	G	7	10	17	0	2	19	0	0
20	28404342	.	G	A	6	3	9	0	0	9	0	0
20	28408028	.	C	T	8	8	16	0	0	16	0	0
20	28409601	.	C	T	6	6	12	0	0	12	0	0
20	28413925	.	C	T	3	6	9	0	0	9	0	0
20	28414423	.	T	C	9	5	14	0	0	14	0	0
20	28417175	.	G	C	7	7	14	0	0	14	0	0
20	28417184	.	G	A	7	7	14	0	0	14	0	0
20	28418550	.	A	G	6	6	12	0	2	14	0	0
20	28418939	.	T	C	4	5	9	0	0	9	0	0
20	28418951	.	T	A	5	2	7	0	1	8	0	0
20	28419015	.	A	T	4	5	9	0	2	11	0	0
20	28419133	.	A	T	6	2	8	0	0	8	0	0
20	28419807	.	T	A	0	3	3	0	0	3	0	0
20	28419831	.	T	C	6	3	9	0	0	9	0	0
20	28420234	.	T	A	4	3	7	0	0	7	0	0
20	28420361	.	C	T	9	4	13	0	0	13	0	0
20	28420438	.	C	G	7	7	14	0	0	14	0	0
20	28420522	.	G	A	4	4	8	0	0	8	0	0
20	28422920	.	A	G	2	3	5	0	0	5	0	0
20	28422927	.	T	C	2	0	2	0	3	5	0	0
20	28423035	.	G	T	1	2	3	0	1	4	0	0
20	28456574	.	T	C	3	8	11	0	1	12	0	0
20	28456616	.	C	T	5	8	13	0	1	14	0	0
20	28469934	.	G	A	6	9	15	0	0	15	0	0
20	28469982	.	A	G	9	12	21	0	2	23	0	0
20	28470057	.	T	C	8	7	15	0	0	15	0	0
20	28476107	.	T	C	8	11	19	0	0	19	0	0
20	28487287	.	T	C	7	10	17	0	0	17	0	0
20	28514822	.	G	C	10	0	10	0	7	17	0	0
20	28514878	.	T	C	11	6	17	0	0	17	0	0
20	28537376	.	G	T	9	5	14	0	1	15	0	0
20	28541670	.	A	G	8	9	17	0	0	17	0	0
20	28541754	.	A	G	5	6	11	0	0	11	0	0
20	28650945	.	A	T	17	16	33	0	1	34	0	0
20	28650946	.	T	G	18	16	34	0	0	34	0	0
20	28650980	.	T	C	17	12	29	0	0	29	0	0
20	28651239	.	A	G	21	16	37	0	2	39	0	0
20	28651693	.	G	T	15	14	29	0	0	29	0	0
20	28651958	.	T	G	8	10	18	0	4	22	0	0
20	28652277	.	G	C	18	22	40	0	2	42	0	0
20	28652449	.	G	C	22	13	35	0	2	37	0	0
20	28652485	.	G	A	19	16	35	2	2	39	0	0
20	28652597	.	G	C	17	10	27	0	1	28	0	0
20	28658597	.	T	C	15	21	36	0	1	37	0	0
20	28658666	.	A	C	14	14	28	0	2	30	0	0
20	28659924	.	A	G	14	10	24	0	1	25	0	0
20	28660582	.	G	A	22	16	38	0	1	39	0	0
20	28660729	.	T	C	7	0	7	0	21	28	0	0
20	28660795	.	G	A	13	15	28	0	0	28	0	0
20	28660828	.	G	T	15	7	22	0	0	22	0	0
20	28660837	.	T	C	16	6	22	0	2	24	0	0
20	28690067	.	G	A	15	9	24	0	0	24	0	0
20	28692254	.	G	A	13	12	25	0	0	25	0	0
20	28695249	.	C	A	13	4	17	0	1	18	0	0
20	28698253	.	G	A	10	7	17	0	0	17	0	0
20	28783859	.	C	T	13	4	17	0	4	21	0	0
20	28834742	.	T	C	2	4	6	0	0	6	0	0
20	28870843	.	T	C	41	14	55	0	0	55	0	0
20	28870922	.	T	C	34	9	43	0	4	47	0	0
20	28871258	.	T	C	22	3	25	0	0	25	0	0
20	28871259	.	T	C	16	1	17	0	8	25	0	0
20	28888106	.	T	C	17	5	22	0	1	23	0	0
20	29216103	.	G	T	5	2	7	0	0	7	0	0
20	29268260	.	A	G	4	3	7	0	0	7	0	0
20	31238061	.	A	G	6	8	14	0	0	14	0	0
20	31252701	.	A	G	2	3	5	0	1	6	0	0
20	31311028	.	A	G	2	2	4	0	0	4	0	0
20	31313111	.	C	T	2	2	4	0	0	4	0	0
20	31427210	.	A	T	3	3	6	0	0	6	0	0
20	31429181	.	C	T	7	3	10	0	0	10	0	0
20	31429648	.	C	T	11	18	29	0	1	30	0	0
20	31429824	.	G	A	10	5	15	0	0	15	0	0
20	31430039	.	G	C	7	9	16	0	0	16	0	0
20	31430115	.	A	T	9	9	18	0	0	18	0	0
20	31430204	.	C	A	7	3	10	0	1	11	0	0
20	31430279	.	A	G	6	10	16	0	0	16	0	0
20	31430320	.	T	C	5	0	5	0	8	13	0	0
20	31430769	.	C	T	0	8	8	0	10	18	0	0
20	31430922	.	T	A	9	4	13	0	1	14	0	0
20	31430993	.	C	T	0	4	4	0	6	10	0	0
20	31431106	.	A	T	8	6	14	0	0	14	0	0
20	31431160	.	A	T	11	6	17	0	0	17	0	0
20	31431345	.	C	T	6	7	13	0	0	13	0	0
20	31431375	.	T	C	5	6	11	0	0	11	0	0
20	31431645	.	A	T	6	4	10	0	1	11	0	0
20	31431701	.	A	G	8	9	17	0	0	17	0	0
20	31431739	.	A	G	9	9	18	0	0	18	0	0
20	31431962	.	A	G	12	7	19	0	1	20	0	0
20	31432826	.	G	T	6	6	12	0	0	12	0	0
20	31432850	.	A	G	4	4	8	0	0	8	0	0
20	31436304	.	C	T	13	9	22	0	0	22	0	0
20	31436387	.	T	C	13	0	13	0	12	25	0	0
20	31436450	.	G	A	12	12	24	0	2	26	0	0
20	31436504	.	T	C	7	0	7	0	14	21	0	0
20	31436750	.	C	T	1	11	12	0	5	17	0	0
20	31436819	.	C	A	7	7	14	0	0	14	0	0
20	31441076	.	G	A	10	7	17	0	0	17	0	0
20	31442308	.	C	T	0	4	4	0	14	18	0	0
20	31447356	.	A	G	7	6	13	0	0	13	0	0
20	31447413	.	C	T	0	8	8	0	6	14	0	0
20	31449686	.	T	C	2	0	2	0	4	6	0	0
20	31451649	.	A	G	5	7	12	0	0	12	0	0
20	31483629	.	C	A	2	6	8	0	0	8	0	0
20	31497034	.	C	T	3	3	6	0	0	6	0	0
20	31746445	.	C	T	14	13	27	0	0	27	0	0
20	31747860	.	C	T	1	15	16	2	19	37	0	0
20	31748032	.	G	T	13	7	20	0	0	20	0	0
20	31748124	.	T	C	13	0	13	0	16	29	0	0
20	31748431	.	A	G	16	3	19	0	1	20	0	0
20	31748448	.	A	C	16	7	23	1	1	25	0	0
20	31748765	.	A	G	8	5	13	0	1	14	0	0
20	31748803	.	A	G	12	14	26	0	0	26	0	0
20	31749118	.	A	G	18	16	34	6	0	40	0	0
20	31749207	.	C	T	2	17	19	0	20	39	0	0
20	31769469	.	A	G	5	11	16	0	0	16	0	0
20	31769523	.	T	A	9	15	24	0	0	24	0	0
20	31786688	.	T	A	12	6	18	0	0	18	0	0
20	31790975	.	A	G	9	14	23	0	0	23	0	0
20	32010029	.	A	G	1	2	3	0	0	3	0	0
20	32047448	.	T	A	7	6	13	0	0	13	0	0
20	32047457	.	T	C	8	4	12	0	1	13	0	0
20	32047546	.	C	T	15	8	23	0	1	24	0	0
20	32047640	.	T	A	13	10	23	0	3	26	0	0
20	32048117	.	A	G	23	12	35	0	1	36	0	0
20	32048369	.	T	A	21	17	38	0	1	39	0	0
20	32049056	.	G	T	14	15	29	0	1	31	1	0
20	32049178	.	G	T	18	23	41	0	7	48	0	0
20	32052708	.	G	A	28	20	48	1	0	49	0	0
20	32052873	.	C	T	6	33	39	0	23	62	0	0
20	32071416	.	G	A	24	23	47	0	2	49	0	0
20	32098046	.	A	G	22	25	47	0	1	48	0	0
20	32110370	.	T	C	24	2	26	0	23	49	0	0
20	32110790	.	T	C	18	9	27	0	1	28	0	0
20	32110829	.	C	G	20	17	37	0	0	37	0	0
20	32110862	.	G	A	21	22	43	0	1	44	0	0
20	32110892	.	C	T	2	18	20	0	19	39	0	0
20	32110898	.	A	T	18	16	34	0	5	39	0	0
20	32118658	.	A	G	13	0	13	0	17	30	0	0
20	32121325	.	C	T	19	15	34	0	0	34	0	0
20	32134705	.	A	G	16	15	31	0	2	33	0	0
20	32135154	.	T	A	18	17	35	0	1	36	0	0
20	32135666	.	C	T	15	19	34	0	2	36	0	0
20	32135673	.	T	C	14	18	32	0	2	34	0	0
20	32135962	.	T	C	20	12	32	0	2	34	0	0
20	32136048	.	C	T	5	10	15	0	0	15	0	0
20	32136220	.	A	C	9	8	17	0	0	17	0	0
20	32136281	.	A	T	5	3	8	0	0	8	0	0
20	32136303	.	T	A	7	2	9	0	0	9	0	0
20	32136443	.	T	G	24	12	36	0	1	37	0	0
20	32136446	.	A	T	21	12	33	0	1	34	0	0
20	32136584	.	T	A	17	9	26	0	0	26	0	0
20	32136847	.	C	G	9	9	18	0	0	18	0	0
20	32137866	.	C	T	14	10	24	0	0	24	0	0
20	32137886	.	C	T	14	8	22	0	1	23	0	0
20	32137984	.	A	C	13	15	28	1	0	29	0	0
20	32138029	.	T	A	17	15	32	1	1	34	0	0
20	32138127	.	C	T	15	9	24	0	0	24	0	0
20	32138305	.	T	C	8	11	19	0	1	20	0	0
20	32138360	.	T	C	12	14	26	0	0	26	0	0
20	32138400	.	A	G	15	12	27	0	1	28	0	0
20	32138478	.	A	G	18	14	32	0	0	32	0	0
20	32138723	.	A	G	12	2	14	0	12	26	0	0
20	32144872	.	T	G	2	3	5	0	0	5	0	0
20	32224532	.	T	C	10	12	22	0	0	22	0	0
20	32226995	.	G	T	13	12	25	0	1	26	0	0
20	32227025	.	C	T	14	14	28	0	0	28	0	0
20	32229214	.	G	T	20	20	40	0	0	40	0	0
20	32229825	.	G	T	20	15	35	0	6	41	0	0
20	32229828	.	G	T	20	16	36	0	5	41	0	0
20	32230168	.	T	C	18	10	28	0	2	30	0	0
20	32230376	.	T	C	12	10	22	0	1	23	0	0
20	32230893	.	C	T	10	10	20	0	0	20	0	0
20	32230957	.	C	T	15	10	25	0	0	25	0	0
20	32286923	.	A	T	19	10	29	0	1	30	0	0
20	32287041	.	C	G	8	9	17	0	1	18	0	0
20	32287943	.	A	C	6	5	11	0	1	12	0	0
20	32288318	.	T	A	10	10	20	0	0	20	0	0
20	32288372	.	T	C	9	0	9	0	15	24	0	0
20	32290222	.	G	A	10	13	23	0	0	23	0	0
20	32290435	.	A	G	16	19	35	0	2	37	0	0
20	32290828	.	C	T	1	15	16	0	21	37	0	0
20	32291287	.	G	A	10	16	26	0	1	27	0	0
20	32330687	.	G	C	11	1	12	0	13	25	0	0
20	32330924	.	T	G	10	8	18	0	1	19	0	0
20	32331316	.	A	G	17	18	35	0	3	38	0	0
20	32331317	.	G	A	18	19	37	0	1	38	0	0
20	32332298	.	T	C	12	0	12	0	9	21	0	0
20	32332527	.	C	G	7	4	11	0	0	12	1	0
20	32332633	.	A	T	12	7	19	0	0	19	0	0
20	32337689	.	A	C	1	2	3	0	0	3	0	0
20	32337918	.	A	C	5	3	8	0	0	8	0	0
20	32337927	.	G	A	3	3	6	0	0	6	0	0
20	32339234	.	G	A	4	3	7	0	1	8	0	0
20	32339879	.	C	T	1	3	4	0	1	5	0	0
20	32403599	.	A	G	5	4	9	0	0	9	0	0
20	32403611	.	C	T	4	3	7	0	0	7	0	0
20	32405384	.	G	A	1	5	6	0	0	6	0	0
20	32432657	.	A	G	9	0	9	0	14	23	0	0
20	32437987	.	C	T	2	3	5	0	0	5	0	0
20	32437993	.	G	T	2	3	5	0	0	5	0	0
20	32438446	.	A	T	3	3	6	0	0	6	0	0
20	32441025	.	A	T	3	3	6	0	0	6	0	0
20	32478509	.	T	C	2	3	5	0	1	6	0	0
20	32484573	.	C	T	10	5	15	0	0	15	0	0
20	32484582	.	T	C	9	6	15	0	0	15	0	0
20	32487624	.	G	A	2	3	5	0	1	6	0	0
20	32487643	.	G	T	1	3	4	0	0	4	0	0
20	32488340	.	A	G	1	0	1	0	2	3	0	0
20	32488341	.	A	G	1	2	3	0	0	3	0	0
20	32489963	.	T	G	2	3	5	1	0	6	0	0
20	32489964	.	G	A	3	3	6	1	0	7	0	0
20	32490004	.	G	T	5	3	8	1	0	9	0	0
20	32490033	.	C	T	4	4	8	0	0	8	0	0
20	32490065	.	T	G	1	2	3	0	0	3	0	0
20	32490783	.	C	G	1	2	3	0	0	3	0	0
20	32490894	.	G	A	2	2	4	0	0	4	0	0
20	32498410	.	C	G	6	4	10	0	0	10	0	0
20	32498662	.	G	A	6	3	9	0	0	9	0	0
20	32498771	.	C	G	4	2	6	0	2	8	0	0
20	32498813	.	A	T	4	4	8	0	0	8	0	0
20	32499199	.	T	C	2	2	4	0	0	4	0	0
20	32501840	.	T	G	10	13	23	0	0	23	0	0
20	32510813	.	A	G	4	9	13	0	0	13	0	0
20	32520171	.	C	T	27	7	34	0	0	34	0	0
20	32520172	.	A	G	23	7	30	0	4	34	0	0
20	32520351	.	A	G	15	0	15	0	9	24	0	0
20	32520365	.	A	G	17	0	17	0	9	26	0	0
20	32520461	.	G	A	6	7	13	0	0	13	0	0
20	32520615	.	T	A	13	8	21	0	0	21	0	0
20	32520673	.	A	G	6	6	12	0	0	12	0	0
20	32520779	.	A	G	7	7	14	0	0	14	0	0
20	32520815	.	A	G	3	0	3	0	10	13	0	0
20	32520847	.	A	T	3	8	11	0	0	11	0	0
20	32520852	.	A	G	3	8	11	0	0	11	0	0
20	32520882	.	C	T	5	5	10	0	0	10	0	0
20	32521048	.	A	T	6	7	13	0	1	14	0	0
20	32521175	.	T	A	11	10	21	0	0	21	0	0
20	32521186	.	T	C	13	11	24	0	0	24	0	0
20	32521266	.	T	G	11	8	19	0	1	20	0	0
20	32521488	.	T	C	10	8	18	0	0	18	0	0
20	32521517	.	A	T	12	10	22	0	3	25	0	0
20	32521534	.	T	A	11	17	28	0	1	29	0	0
20	32521605	.	G	A	16	12	28	0	1	29	0	0
20	32521618	.	T	C	20	12	32	0	0	32	0	0
20	32521719	.	A	C	15	19	34	0	0	34	0	0
20	32521742	.	G	A	15	17	32	0	0	32	0	0
20	32523775	.	C	T	5	2	7	0	0	7	0	0
20	32557375	.	C	T	3	6	9	0	2	11	0	0
20	32567982	.	T	C	7	5	12	0	0	12	0	0
20	32571913	.	T	C	9	7	16	0	1	17	0	0
20	32838484	.	T	C	1	0	1	0	4	5	0	0
20	32838551	.	A	G	3	2	5	0	1	6	0	0
20	32838589	.	A	G	2	4	6	0	0	6	0	0
20	32838695	.	C	A	1	4	5	0	0	5	0	0
20	32863650	.	A	G	9	6	15	0	0	15	0	0
20	32863657	.	A	G	9	5	14	0	0	14	0	0
20	32872075	.	C	A	0	2	2	0	4	6	0	0
20	32872156	.	C	A	2	9	11	0	1	12	0	0
20	32948489	.	C	G	1	3	4	0	0	4	0	0
20	32948512	.	G	A	2	5	7	0	0	7	0	0
20	32963181	.	G	T	1	4	5	0	0	5	0	0
20	32963182	.	T	A	1	4	5	0	0	5	0	0
20	33007794	.	A	C	4	6	10	0	0	10	0	0
20	33007836	.	T	C	1	0	1	0	5	6	0	0
20	33020372	.	C	G	5	3	8	0	0	8	0	0
20	33040873	.	G	C	1	3	4	0	0	4	0	0
20	33087945	.	T	C	2	2	4	0	0	4	0	0
20	33127513	.	A	G	1	4	5	0	0	5	0	0
20	33127615	.	T	A	4	5	9	0	0	9	0	0
20	33146708	.	T	C	3	0	3	0	4	7	0	0
20	33175232	.	A	G	9	0	9	0	8	17	0	0
20	33177904	.	C	T	5	13	18	0	0	18	0	0
20	33180111	.	T	C	7	11	18	0	1	19	0	0
20	33189386	.	G	A	0	16	16	0	4	20	0	0
20	33294503	.	A	T	5	7	12	0	1	13	0	0
20	33295692	.	T	A	5	9	14	0	1	15	0	0
20	33297776	.	A	C	7	4	11	0	0	11	0	0
20	33298184	.	C	T	7	3	10	0	0	10	0	0
20	33298651	.	G	A	4	6	10	0	1	11	0	0
20	33467794	.	A	T	9	7	16	0	0	16	0	0
20	33471085	.	G	A	12	15	27	0	0	27	0	0
20	33471127	.	A	T	12	14	26	0	1	27	0	0
20	33471166	.	C	T	1	13	14	0	12	26	0	0
20	33471199	.	T	C	15	0	15	0	12	27	0	0
20	33487374	.	G	T	5	6	11	0	0	11	0	0
20	33494027	.	C	A	6	6	12	0	0	12	0	0
20	33494064	.	A	G	11	7	18	0	1	19	0	0
20	33494165	.	A	G	12	12	24	0	0	24	0	0
20	33494411	.	G	T	19	19	38	0	2	40	0	0
20	33494436	.	C	T	26	15	41	0	1	42	0	0
20	33497087	.	A	T	12	5	17	0	0	17	0	0
20	33526352	.	G	A	1	1	2	0	2	4	0	0
20	33526358	.	C	A	2	2	4	0	0	4	0	0
20	33530265	.	A	G	2	3	5	0	0	5	0	0
20	33530315	.	T	G	1	2	3	0	0	3	0	0
20	33534255	.	C	T	1	2	3	0	0	3	0	0
20	33534344	.	A	T	1	2	3	0	0	3	0	0
20	33535041	.	G	A	1	3	4	0	1	5	0	0
20	33535068	.	T	C	1	2	3	0	0	3	0	0
20	33669379	.	T	C	3	2	5	0	0	5	0	0
20	33683767	.	A	G	3	5	8	0	0	8	0	0
20	33737482	.	T	C	2	2	4	0	0	4	0	0
20	33759014	.	C	T	18	12	30	0	1	31	0	0
20	33759043	.	T	C	12	11	23	0	2	25	0	0
20	33759067	.	C	T	4	12	16	0	16	32	0	0
20	33759151	.	G	C	18	0	18	0	19	37	0	0
20	33759196	.	A	C	15	0	15	0	16	31	0	0
20	33763208	.	G	A	8	9	17	1	1	19	0	0
20	33771605	.	A	G	9	11	20	0	0	20	0	0
20	33802122	.	T	C	2	3	5	0	0	5	0	0
20	33802262	.	C	T	3	2	5	0	0	5	0	0
20	33802864	.	C	A	1	2	3	0	0	3	0	0
20	33805780	.	C	T	1	2	3	0	0	3	0	0
20	33805789	.	T	G	1	2	3	0	0	3	0	0
20	33810496	.	G	A	3	3	6	0	3	9	0	0
20	33811574	.	G	T	13	11	24	0	1	25	0	0
20	33811622	.	A	G	20	10	30	0	1	31	0	0
20	33831964	.	A	C	15	0	15	0	15	30	0	0
20	33839868	.	A	G	6	8	14	0	0	14	0	0
20	33856373	.	T	C	12	8	20	0	1	21	0	0
20	33860144	.	G	A	19	7	26	0	0	26	0	0
20	33860147	.	G	A	20	7	27	0	0	27	0	0
20	33863932	.	T	C	4	7	11	0	0	11	0	0
20	33905288	.	A	G	1	1	2	0	1	3	0	0
20	33982016	.	G	A	9	6	15	0	0	15	0	0
20	34007128	.	G	A	5	4	9	0	0	9	0	0
20	34007589	.	G	C	3	4	7	0	0	7	0	0
20	34008141	.	G	A	1	3	4	0	4	8	0	0
20	34009363	.	G	A	0	4	4	0	5	9	0	0
20	34009919	.	G	A	0	8	8	0	2	10	0	0
20	34009947	.	A	G	1	6	7	0	0	7	0	0
20	34010028	.	A	G	1	3	4	0	0	4	0	0
20	34012790	.	T	A	8	4	12	0	0	12	0	0
20	34012798	.	T	C	10	4	14	0	0	14	0	0
20	34012828	.	T	A	8	4	12	0	2	14	0	0
20	34012837	.	A	T	8	5	13	0	1	14	0	0
20	34012885	.	G	A	5	4	9	0	0	9	0	0
20	34015907	.	G	A	13	10	23	0	0	23	0	0
20	34015921	.	T	A	15	10	25	0	1	26	0	0
20	34015994	.	T	A	23	7	30	0	1	31	0	0
20	34020861	.	T	A	5	7	12	0	0	12	0	0
20	34020891	.	G	A	5	7	12	0	0	12	0	0
20	34021396	.	A	G	3	2	5	0	0	5	0	0
20	34023948	.	C	T	6	9	15	0	0	15	0	0
20	34039390	.	G	A	3	6	9	0	0	9	0	0
20	34042070	.	A	G	10	14	24	0	0	24	0	0
20	34042209	.	A	G	16	11	27	0	1	28	0	0
20	34044813	.	G	A	13	8	21	0	1	22	0	0
20	34056162	.	A	G	7	8	15	0	1	16	0	0
20	34057305	.	T	C	6	9	15	0	0	15	0	0
20	34059018	.	G	A	3	10	13	0	0	13	0	0
20	34059175	.	A	T	4	7	11	0	1	12	0	0
20	34059346	.	T	C	9	9	18	0	1	19	0	0
20	34061250	.	C	G	0	3	3	0	3	6	0	0
20	34061286	.	A	G	4	5	9	0	0	9	0	0
20	34061784	.	C	T	7	5	12	0	0	12	0	0
20	34063974	.	T	A	9	5	14	0	0	14	0	0
20	34064061	.	C	T	6	3	9	0	0	9	0	0
20	34064272	.	C	T	2	4	6	0	2	8	0	0
20	34066005	.	G	A	5	2	7	0	0	7	0	0
20	34066224	.	A	G	4	6	10	0	0	10	0	0
20	34069429	.	T	C	7	3	10	0	0	10	0	0
20	34069500	.	T	C	2	4	6	0	0	6	0	0
20	34154076	.	C	T	7	6	13	0	0	13	0	0
20	34154618	.	C	A	13	7	20	0	2	22	0	0
20	34154619	.	C	A	13	7	20	0	2	22	0	0
20	34155134	.	G	A	5	6	11	0	0	11	0	0
20	34155339	.	C	A	9	15	24	0	0	24	0	0
20	34155428	.	A	G	12	7	19	0	0	19	0	0
20	34158227	.	T	C	2	0	2	0	1	3	0	0
20	34158234	.	T	C	2	0	2	0	2	4	0	0
20	34159140	.	C	T	2	2	4	0	0	4	0	0
20	34338371	.	T	C	7	12	19	0	0	19	0	0
20	34338884	.	G	A	4	20	24	0	28	53	1	0
20	34339473	.	G	A	26	28	54	0	3	57	0	0
20	34339516	.	C	T	26	25	51	0	2	53	0	0
20	34339786	.	T	A	32	28	60	0	1	61	0	0
20	34340047	.	C	T	39	18	57	0	0	57	0	0
20	34340055	.	T	C	39	15	54	0	0	54	0	0
20	34340176	.	G	A	4	30	34	0	27	61	0	0
20	34340200	.	C	T	29	17	46	0	6	52	0	0
20	34340520	.	T	C	24	12	36	0	3	39	0	0
20	34340675	.	A	C	16	22	38	0	2	40	0	0
20	34341000	.	C	T	13	30	43	0	0	43	0	0
20	34341166	.	C	T	1	2	3	0	0	3	0	0
20	34364267	.	A	G	1	2	3	0	0	3	0	0
20	34364295	.	T	C	1	0	1	0	4	5	0	0
20	34364936	.	A	G	1	10	11	0	0	11	0	0
20	34368274	.	G	A	3	2	5	0	0	5	0	0
20	34368584	.	A	C	2	3	5	0	0	5	0	0
20	34368596	.	C	A	3	4	7	0	0	7	0	0
20	34396763	.	T	G	3	2	5	0	1	6	0	0
20	34420823	.	A	G	15	19	34	0	0	34	0	0
20	34421155	.	C	T	23	10	33	0	0	33	0	0
20	34421159	.	G	A	22	10	32	0	1	33	0	0
20	34421307	.	A	G	13	16	29	0	0	29	0	0
20	34421485	.	C	T	14	13	27	0	0	27	0	0
20	34421672	.	G	A	17	9	26	0	0	26	0	0
20	34421701	.	T	C	14	11	25	0	0	25	0	0
20	34421758	.	G	A	15	12	27	0	1	28	0	0
20	34421801	.	G	C	19	1	20	0	13	33	0	0
20	34421804	.	G	A	17	13	30	0	1	31	0	0
20	34426759	.	A	C	24	10	34	0	0	34	0	0
20	34430100	.	T	G	14	17	31	0	0	31	0	0
20	34431337	.	G	A	9	19	28	0	0	28	0	0
20	34431661	.	A	G	13	9	22	0	0	22	0	0
20	34444945	.	T	C	10	17	27	0	0	27	0	0
20	34445005	.	A	G	7	18	25	0	0	25	0	0
20	34446733	.	A	G	14	12	26	0	1	27	0	0
20	34447025	.	A	G	16	12	28	0	0	28	0	0
20	34447049	.	G	A	14	12	26	0	1	27	0	0
20	34450257	.	T	G	10	10	20	0	2	22	0	0
20	34502644	.	G	A	7	4	11	0	1	12	0	0
20	34537775	.	A	C	8	5	13	0	1	14	0	0
20	34537814	.	G	T	3	5	8	0	0	8	0	0
20	34551195	.	C	T	7	6	13	0	0	13	0	0
20	34592483	.	C	T	7	9	16	0	0	16	0	0
20	34596468	.	A	T	16	11	27	0	0	27	0	0
20	34596617	.	T	C	6	9	15	0	1	16	0	0
20	34596710	.	A	T	7	6	13	0	0	13	0	0
20	34596736	.	C	G	6	0	6	0	5	11	0	0
20	34596788	.	C	T	2	4	6	0	0	6	0	0
20	34596797	.	G	T	2	3	5	0	0	5	0	0
20	34596914	.	A	T	5	4	9	0	1	10	0	0
20	34597127	.	C	T	7	16	23	0	0	23	0	0
20	34597292	.	G	A	9	18	27	0	2	29	0	0
20	34597844	.	T	C	12	18	30	0	2	32	0	0
20	34598113	.	C	A	5	18	23	0	2	25	0	0
20	34601127	.	A	G	13	17	30	0	3	33	0	0
20	34602340	.	C	T	12	17	29	0	0	29	0	0
20	34602561	.	A	C	14	17	31	0	1	32	0	0
20	34603575	.	G	T	18	12	30	0	1	31	0	0
20	34603733	.	T	G	16	24	40	0	1	41	0	0
20	34604356	.	C	T	16	17	33	0	0	33	0	0
20	34604432	.	C	T	14	18	32	0	0	32	0	0
20	34607698	.	A	G	11	1	12	0	8	20	0	0
20	34607893	.	A	G	7	14	21	0	1	22	0	0
20	34608194	.	C	T	5	9	14	0	0	14	0	0
20	34608235	.	A	G	7	9	16	0	0	16	0	0
20	34608272	.	T	C	6	6	12	0	0	12	0	0
20	34608404	.	T	G	3	3	6	0	0	7	1	0
20	34609991	.	G	A	8	6	14	0	0	14	0	0
20	34611709	.	G	T	9	4	13	0	1	14	0	0
20	34627817	.	G	C	4	10	14	0	1	15	0	0
20	34630192	.	T	C	13	7	20	0	0	20	0	0
20	34630281	.	A	G	9	5	14	0	0	14	0	0
20	34630861	.	C	T	11	4	15	0	0	15	0	0
20	34642639	.	C	A	9	9	18	0	0	18	0	0
20	34643491	.	A	T	6	4	10	0	1	11	0	0
20	34655929	.	G	A	1	4	5	0	0	5	0	0
20	34658609	.	G	A	3	2	5	0	1	6	0	0
20	34661498	.	A	G	1	2	3	0	0	3	0	0
20	34661501	.	A	G	1	2	3	0	0	3	0	0
20	34695326	.	C	T	7	10	17	0	1	19	1	0
20	34696329	.	A	C	6	10	16	0	0	16	0	0
20	34696628	.	A	T	9	8	17	0	1	18	0	0
20	34700135	.	G	T	3	3	6	0	1	7	0	0
20	34700237	.	G	T	0	9	9	0	3	12	0	0
20	34700238	.	T	C	3	9	12	0	0	12	0	0
20	34727666	.	G	A	6	9	15	0	0	15	0	0
20	34733259	.	A	G	11	0	11	0	16	27	0	0
20	34733604	.	G	A	11	8	19	0	1	20	0	0
20	34733819	.	G	A	12	11	23	2	0	25	0	0
20	34737818	.	A	G	1	6	7	0	0	7	0	0
20	34737920	.	C	A	3	3	6	0	0	6	0	0
20	34738198	.	G	A	16	22	38	0	8	46	0	0
20	34738205	.	C	T	11	17	28	0	21	49	0	0
20	34738272	.	A	G	25	10	35	0	0	35	0	0
20	34738314	.	G	A	10	22	32	1	2	35	0	0
20	34738397	.	G	T	9	8	17	0	1	18	0	0
20	34738756	.	A	G	20	10	30	0	0	30	0	0
20	34742840	.	G	A	24	11	35	0	3	38	0	0
20	34746019	.	G	A	13	13	26	0	0	26	0	0
20	34749672	.	G	A	10	12	22	0	0	22	0	0
20	34749747	.	G	A	12	12	24	0	1	25	0	0
20	34749754	.	C	T	13	13	26	0	1	27	0	0
20	34749793	.	C	T	11	15	26	0	0	26	0	0
20	34749794	.	A	G	10	15	25	0	1	26	0	0
20	34750025	.	G	C	17	10	27	0	0	27	0	0
20	34777607	.	C	T	1	2	3	0	0	3	0	0
20	34778748	.	G	A	1	2	3	0	2	5	0	0
20	34779430	.	G	A	5	3	8	0	0	8	0	0
20	34780261	.	G	A	1	4	5	0	4	9	0	0
20	34794939	.	C	T	27	27	54	0	3	57	0	0
20	34794988	.	C	G	32	25	57	0	2	59	0	0
20	34795111	.	C	A	33	30	63	0	3	66	0	0
20	34795126	.	A	G	32	35	67	0	2	69	0	0
20	34795221	.	A	T	47	17	64	0	2	66	0	0
20	34795418	.	G	C	32	25	57	0	0	57	0	0
20	34795559	.	C	T	4	42	46	0	27	73	0	0
20	34795631	.	T	G	46	14	60	0	4	64	0	0
20	34795689	.	C	T	44	27	71	0	6	77	0	0
20	34797252	.	G	T	35	45	80	0	1	81	0	0
20	34797532	.	C	A	37	27	64	0	0	64	0	0
20	34933209	.	C	A	45	50	95	7	14	116	0	0
20	34955791	.	C	T	33	27	60	2	4	66	0	0
20	34955810	.	T	G	50	4	54	1	3	58	0	0
20	34956159	.	A	T	18	15	33	0	1	34	0	0
20	34956164	.	T	A	18	16	34	0	2	36	0	0
20	34991776	.	G	A	1	4	5	0	0	5	0	0
20	34991804	.	C	T	2	2	4	0	4	8	0	0
20	35000163	.	C	T	1	5	6	0	5	11	0	0
20	35001423	.	G	A	3	5	8	0	1	9	0	0
20	35017634	.	C	G	1	3	4	0	3	7	0	0
20	35017831	.	C	T	3	2	5	0	0	5	0	0
20	35019437	.	A	C	2	5	7	0	2	9	0	0
20	35058727	.	T	A	15	25	40	0	0	40	0	0
20	35059085	.	G	A	1	9	10	1	24	35	0	0
20	35064521	.	G	A	25	12	37	0	5	42	0	0
20	35065345	.	G	A	2	20	22	0	26	48	0	0
20	35065588	.	G	A	19	23	42	0	2	44	0	0
20	35066821	.	G	A	2	26	28	0	25	53	0	0
20	35068702	.	T	C	21	15	36	3	5	44	0	0
20	35068765	.	A	T	11	12	23	1	6	30	0	0
20	35069756	.	A	G	14	12	26	0	2	28	0	0
20	35069928	.	C	T	18	14	32	0	1	33	0	0
20	35069963	.	A	C	24	15	39	0	1	40	0	0
20	35070176	.	C	T	16	19	35	0	1	36	0	0
20	35070340	.	C	T	11	7	18	0	1	19	0	0
20	35086281	.	G	T	4	2	6	0	1	7	0	0
20	35131977	.	G	A	6	10	16	0	0	16	0	0
20	35144953	.	C	T	4	3	7	0	0	7	0	0
20	35157617	.	C	T	7	3	10	0	1	11	0	0
20	35157667	.	T	C	5	3	8	0	1	9	0	0
20	35159365	.	C	T	11	7	18	0	0	18	0	0
20	35159500	.	C	A	2	9	11	0	2	13	0	0
20	35159707	.	T	C	2	5	7	0	0	7	0	0
20	35159742	.	C	T	8	3	11	0	0	11	0	0
20	35159766	.	C	T	3	7	10	0	0	10	0	0
20	35162012	.	T	G	7	8	15	0	0	15	0	0
20	35162054	.	G	A	5	5	10	0	0	10	0	0
20	35165533	.	G	A	9	10	19	0	1	20	0	0
20	35171257	.	C	T	10	12	22	0	0	22	0	0
20	35177501	.	T	C	10	7	17	0	0	17	0	0
20	35184527	.	T	A	4	4	8	0	0	8	0	0
20	35186620	.	C	T	6	5	11	2	1	14	0	0
20	35186629	.	G	C	0	5	5	2	7	14	0	0
20	35195185	.	G	A	3	13	16	0	12	28	0	0
20	35198110	.	A	G	10	9	19	0	1	20	0	0
20	35198116	.	G	A	11	10	21	0	0	21	0	0
20	35198780	.	G	A	1	10	11	0	9	20	0	0
20	35198810	.	A	C	13	9	22	0	0	22	0	0
20	35204668	.	C	T	12	13	25	0	3	28	0	0
20	35204773	.	C	T	3	13	16	0	0	16	0	0
20	35205061	.	C	T	5	13	18	0	1	19	0	0
20	35205182	.	T	C	9	7	16	0	0	16	0	0
20	35205361	.	T	A	1	6	7	0	1	8	0	0
20	35205552	.	T	G	3	0	3	0	12	15	0	0
20	35205600	.	A	T	6	11	17	0	1	18	0	0
20	35205626	.	T	G	8	0	8	0	11	19	0	0
20	35205772	.	T	A	7	7	14	0	2	16	0	0
20	35206023	.	G	A	14	16	30	0	0	30	0	0
20	35206101	.	A	T	7	9	16	0	0	16	0	0
20	35206272	.	T	C	7	5	12	0	0	12	0	0
20	35208046	.	A	G	7	7	14	0	0	14	0	0
20	35209012	.	G	A	5	2	7	0	0	7	0	0
20	35209080	.	T	A	4	6	10	1	0	11	0	0
20	35209405	.	C	T	9	11	20	0	0	20	0	0
20	35209625	.	G	A	11	10	21	0	0	21	0	0
20	35209680	.	A	T	12	5	17	0	0	17	0	0
20	35209681	.	T	A	12	5	17	0	0	17	0	0
20	35210175	.	C	A	9	13	22	0	3	25	0	0
20	35210176	.	T	C	15	0	15	0	11	26	0	0
20	35210212	.	G	T	14	6	20	0	2	22	0	0
20	35210282	.	T	C	4	0	4	0	5	9	0	0
20	35210297	.	T	C	4	2	6	0	0	6	0	0
20	35210393	.	T	C	5	0	5	0	12	17	0	0
20	35210538	.	C	G	4	3	7	0	1	8	0	0
20	35210575	.	C	T	5	4	9	0	0	9	0	0
20	35210649	.	A	G	7	4	11	0	0	11	0	0
20	35210853	.	A	T	10	3	13	0	1	14	0	0
20	35210909	.	T	C	3	5	8	0	1	9	0	0
20	35211354	.	C	A	1	4	5	0	5	10	0	0
20	35211393	.	T	G	8	7	15	0	0	15	0	0
20	35211515	.	C	T	1	6	7	0	3	10	0	0
20	35211537	.	G	A	4	3	7	0	0	7	0	0
20	35211641	.	C	T	3	2	5	0	0	5	0	0
20	35211972	.	T	C	2	2	4	0	0	4	0	0
20	35212064	.	T	A	1	7	8	0	0	8	0	0
20	35212070	.	G	A	1	6	7	0	1	8	0	0
20	35212315	.	A	G	4	3	7	0	0	7	0	0
20	35212366	.	T	C	2	4	6	0	0	6	0	0
20	35212398	.	A	G	3	3	6	0	0	6	0	0
20	35212405	.	C	T	3	3	6	0	0	6	0	0
20	35212946	.	T	A	7	6	13	0	0	13	0	0
20	35215773	.	C	G	2	5	7	0	11	18	0	0
20	35215776	.	G	C	11	5	16	0	1	17	0	0
20	35220065	.	G	A	5	4	9	0	3	12	0	0
20	35226227	.	T	A	5	3	8	0	0	8	0	0
20	35226446	.	G	A	5	3	8	0	0	8	0	0
20	35226788	.	G	T	3	8	11	0	0	11	0	0
20	35226944	.	G	T	5	9	14	0	0	14	0	0
20	35227256	.	C	G	8	6	14	0	0	14	0	0
20	35245968	.	T	A	8	3	11	0	0	11	0	0
20	35245969	.	T	G	8	3	11	0	0	11	0	0
20	35295208	.	C	T	5	7	12	0	0	12	0	0
20	35297693	.	G	A	5	7	12	0	0	12	0	0
20	35297867	.	C	T	5	3	8	0	2	10	0	0
20	35297931	.	C	T	1	3	4	0	0	4	0	0
20	35428305	.	C	T	48	13	61	0	2	63	0	0
20	35429017	.	T	A	26	13	39	0	0	39	0	0
20	35429269	.	C	T	36	37	73	0	4	77	0	0
20	35429299	.	A	G	38	32	70	0	0	70	0	0
20	35429384	.	C	T	39	29	68	0	2	70	0	0
20	35429610	.	A	T	39	29	68	1	0	69	0	0
20	35433262	.	G	C	16	12	28	0	1	29	0	0
20	35433264	.	G	C	19	12	31	0	0	31	0	0
20	35437838	.	G	C	4	2	6	0	1	7	0	0
20	35462408	.	C	T	2	2	4	0	0	4	0	0
20	35462426	.	G	A	2	3	5	0	0	5	0	0
20	35464735	.	C	G	1	3	4	0	3	7	0	0
20	35798370	.	G	A	10	19	29	0	2	32	1	0
20	35798717	.	A	G	11	7	18	0	0	18	0	0
20	35798973	.	T	A	8	6	14	0	0	14	0	0
20	35800001	.	G	A	10	8	18	0	8	26	0	0
20	35800249	.	C	T	18	5	23	0	1	24	0	0
20	35800349	.	C	T	4	11	15	0	2	17	0	0
20	35800520	.	G	A	10	9	19	0	0	19	0	0
20	35800749	.	G	A	12	8	20	0	0	20	0	0
20	35816606	.	G	A	7	10	17	0	0	17	0	0
20	35816630	.	C	T	7	9	16	0	0	16	0	0
20	35827890	.	C	T	6	4	10	0	0	10	0	0
20	35827896	.	C	A	7	3	10	0	0	10	0	0
20	35827945	.	G	C	6	10	16	0	0	16	0	0
20	35831719	.	C	T	13	11	24	0	0	24	0	0
20	35832168	.	G	A	9	11	20	0	1	21	0	0
20	35941146	.	G	A	0	2	2	0	8	10	0	0
20	35942981	.	T	C	5	3	8	0	0	8	0	0
20	35957401	.	C	A	4	3	7	0	0	7	0	0
20	35972539	.	T	C	6	2	8	0	0	8	0	0
20	35972544	.	G	A	6	2	8	0	0	8	0	0
20	35979899	.	G	T	4	5	9	0	0	9	0	0
20	35979910	.	T	G	4	4	8	0	0	8	0	0
20	35979983	.	G	C	2	5	7	0	0	7	0	0
20	35980009	.	A	G	4	4	8	0	0	8	0	0
20	35980021	.	C	T	3	5	8	0	0	8	0	0
20	36067796	.	C	T	1	5	6	0	3	9	0	0
20	36068096	.	C	A	1	4	5	0	1	6	0	0
20	36068551	.	T	A	3	3	6	0	0	6	0	0
20	36069553	.	A	G	4	3	7	0	1	8	0	0
20	36069562	.	A	T	3	3	6	0	1	7	0	0
20	36234334	.	T	A	10	13	23	0	3	26	0	0
20	36290217	.	C	T	6	11	17	0	3	20	0	0
20	36297304	.	C	T	16	16	32	0	0	32	0	0
20	36297356	.	G	A	1	14	15	0	12	27	0	0
20	36297418	.	C	A	11	19	30	0	0	30	0	0
20	36297448	.	C	T	19	10	29	0	1	30	0	0
20	36297518	.	G	A	1	12	13	0	13	26	0	0
20	36297832	.	C	T	12	7	19	0	1	20	0	0
20	36380602	.	A	C	1	0	1	0	3	4	0	0
20	36395895	.	G	A	1	2	3	0	1	4	0	0
20	36399075	.	G	A	5	2	7	0	0	7	0	0
20	36402140	.	G	C	1	0	1	0	4	5	0	0
20	36402167	.	G	T	3	3	6	0	0	6	0	0
20	36402190	.	T	C	3	0	3	0	3	6	0	0
20	36403820	.	T	A	3	2	5	0	0	5	0	0
20	36404957	.	C	T	4	2	6	0	0	6	0	0
20	36404990	.	C	T	0	2	2	0	5	7	0	0
20	36405129	.	C	T	2	2	4	0	1	5	0	0
20	36416877	.	A	C	3	4	7	0	1	8	0	0
20	36416905	.	C	A	3	0	3	0	4	7	0	0
20	36420218	.	A	C	9	14	23	0	0	23	0	0
20	36420713	.	C	T	1	21	22	0	6	30	2	0
20	36420804	.	G	T	8	11	19	0	3	22	0	0
20	36420982	.	G	A	8	7	15	0	0	15	0	0
20	36421218	.	G	A	4	8	12	0	2	14	0	0
20	36421362	.	G	A	12	8	20	0	0	20	0	0
20	36421530	.	A	C	12	0	12	0	12	25	1	0
20	36421757	.	C	T	1	8	9	0	10	19	0	0
20	36422043	.	G	A	22	20	42	0	0	42	0	0
20	36422098	.	C	A	7	17	24	0	1	25	0	0
20	36422291	.	G	T	11	13	24	0	1	25	0	0
20	36433247	.	G	A	13	22	35	0	0	35	0	0
20	36437314	.	A	G	11	10	21	0	2	23	0	0
20	36440113	.	C	T	4	9	13	0	20	34	1	0
20	36449286	.	G	A	18	11	29	0	1	30	0	0
20	36449385	.	C	T	14	15	29	0	0	29	0	0
20	36449442	.	A	C	18	15	33	0	3	36	0	0
20	36449601	.	C	T	12	6	18	0	3	21	0	0
20	36626195	.	A	G	16	0	16	0	13	29	0	0
20	36626248	.	G	A	15	13	28	0	0	28	0	0
20	36626335	.	C	T	9	5	14	0	0	14	0	0
20	36629281	.	A	G	3	3	6	0	0	6	0	0
20	36629472	.	G	A	6	4	10	0	0	10	0	0
20	36631300	.	C	T	8	5	13	0	0	13	0	0
20	36631341	.	C	T	8	6	14	0	0	14	0	0
20	36633082	.	C	T	5	7	12	0	0	12	0	0
20	36637999	.	G	A	3	2	5	0	0	5	0	0
20	36638169	.	T	C	2	5	7	0	1	8	0	0
20	36646884	.	A	G	2	2	4	0	0	4	0	0
20	36646993	.	G	A	6	3	9	0	0	9	0	0
20	36647133	.	C	T	5	2	7	0	1	8	0	0
20	36648694	.	T	C	5	5	10	0	0	10	0	0
20	36649737	.	C	T	1	4	5	0	0	5	0	0
20	36649769	.	C	G	6	4	10	0	0	10	0	0
20	36660785	.	A	C	4	2	6	0	0	6	0	0
20	36660872	.	T	C	1	6	7	0	0	7	0	0
20	36661000	.	T	G	4	3	7	0	0	7	0	0
20	36671656	.	T	G	1	2	3	0	0	3	0	0
20	36677574	.	G	A	9	5	14	0	1	15	0	0
20	36682562	.	G	A	5	5	10	0	0	10	0	0
20	36700638	.	T	C	1	5	6	0	1	7	0	0
20	36740135	.	G	A	3	3	6	0	2	8	0	0
20	36769391	.	G	T	1	10	11	0	5	16	0	0
20	36773579	.	G	T	1	10	11	0	10	21	0	0
20	36773949	.	G	A	1	14	15	0	4	19	0	0
20	36777354	.	A	C	2	3	5	0	0	5	0	0
20	36783480	.	C	T	7	6	13	0	1	14	0	0
20	36785477	.	G	A	6	9	15	0	0	15	0	0
20	36787166	.	C	A	6	7	13	0	0	13	0	0
20	36787175	.	A	C	6	4	10	0	4	14	0	0
20	36787287	.	C	T	5	4	9	0	0	9	0	0
20	36788775	.	C	T	6	5	11	0	0	11	0	0
20	36798154	.	C	G	2	4	6	0	0	6	0	0
20	36799816	.	A	G	11	12	23	0	0	23	0	0
20	36799934	.	C	T	0	10	10	0	7	17	0	0
20	36816972	.	C	T	1	4	5	0	1	6	0	0
20	36817162	.	T	G	2	3	5	0	0	5	0	0
20	36817184	.	G	A	0	3	3	0	2	5	0	0
20	36817368	.	G	C	3	3	6	0	0	6	0	0
20	36828948	.	A	C	13	9	22	0	0	22	0	0
20	36829418	.	G	A	0	7	7	0	10	17	0	0
20	36829428	.	A	C	8	8	16	0	0	16	0	0
20	36838717	.	C	T	7	4	11	0	0	11	0	0
20	36838871	.	C	T	9	4	13	0	0	13	0	0
20	36838946	.	A	C	5	3	8	1	0	9	0	0
20	36915481	.	G	A	7	7	14	0	0	14	0	0
20	36915493	.	A	T	5	7	12	0	0	12	0	0
20	36915529	.	G	A	14	6	20	0	0	20	0	0
20	36915826	.	C	A	10	9	19	0	3	22	0	0
20	36916050	.	A	G	8	6	14	0	1	15	0	0
20	36916428	.	A	T	5	6	11	0	0	11	0	0
20	36916429	.	A	T	5	6	11	0	0	11	0	0
20	36917037	.	C	T	18	7	25	1	1	27	0	0
20	36917631	.	C	T	8	8	16	1	2	19	0	0
20	37265731	.	T	A	1	2	3	0	0	3	0	0
20	37300798	.	G	A	11	9	20	0	0	20	0	0
20	37300862	.	G	C	1	5	6	0	10	16	0	0
20	37332669	.	T	A	11	6	17	0	1	18	0	0
20	37376467	.	G	A	0	6	6	0	5	11	0	0
20	37533078	.	C	T	9	14	23	0	0	23	0	0
20	37533137	.	C	T	15	14	29	1	0	30	0	0
20	37627953	.	G	A	8	8	16	0	1	17	0	0
20	37733776	.	C	A	3	2	5	0	1	6	0	0
20	37735957	.	C	G	21	12	33	3	1	37	0	0
20	37735980	.	T	C	17	10	27	3	0	30	0	0
20	37736041	.	T	A	9	9	18	0	0	18	0	0
20	37736409	.	T	G	8	2	10	0	1	11	0	0
20	37752102	.	T	A	4	2	6	0	0	6	0	0
20	37752125	.	T	C	3	2	5	0	0	5	0	0
20	37755358	.	A	G	1	3	4	0	0	4	0	0
20	37760596	.	G	C	8	6	14	0	0	14	0	0
20	37761205	.	C	T	5	5	10	0	2	12	0	0
20	37764309	.	C	G	3	4	7	0	0	7	0	0
20	37768621	.	C	T	10	7	17	0	0	17	0	0
20	37768712	.	A	C	7	3	10	0	1	11	0	0
20	37768844	.	G	T	4	9	13	0	0	13	0	0
20	37768995	.	T	A	9	5	14	0	0	14	0	0
20	37768997	.	A	T	7	4	11	0	3	14	0	0
20	37769084	.	A	G	3	4	7	0	0	7	0	0
20	37769099	.	C	A	4	5	9	0	0	9	0	0
20	37796354	.	G	A	0	5	5	0	4	9	0	0
20	37796387	.	T	C	5	5	10	0	1	11	0	0
20	37796527	.	C	A	3	4	7	0	1	8	0	0
20	37798627	.	G	A	8	7	15	0	0	15	0	0
20	37798892	.	C	T	1	4	5	0	1	6	0	0
20	37799497	.	T	C	5	3	8	0	0	8	0	0
20	37799688	.	G	A	0	2	2	0	5	7	0	0
20	37800444	.	C	A	3	2	5	0	0	5	0	0
20	37826300	.	G	T	1	6	7	0	0	7	0	0
20	37831776	.	T	C	3	5	8	0	0	8	0	0
20	37844090	.	A	T	16	7	23	0	0	23	0	0
20	37844298	.	C	G	7	8	15	0	0	15	0	0
20	37845858	.	G	A	12	13	25	0	0	25	0	0
20	37852670	.	T	C	10	7	17	0	1	18	0	0
20	37866463	.	C	T	10	5	15	0	0	15	0	0
20	37899289	.	T	C	14	7	21	0	1	22	0	0
20	37913123	.	T	G	1	3	4	0	0	4	0	0
20	37913237	.	G	A	9	3	12	0	0	12	0	0
20	37913335	.	A	T	11	5	16	0	0	16	0	0
20	37913410	.	A	C	3	5	8	0	0	8	0	0
20	37913552	.	T	C	3	2	5	0	0	5	0	0
20	37913572	.	A	T	3	2	5	0	1	6	0	0
20	37913767	.	T	G	6	8	14	0	0	14	0	0
20	37913919	.	A	G	11	3	14	0	0	14	0	0
20	37914001	.	A	G	15	9	24	0	0	24	0	0
20	37914048	.	G	C	9	6	15	0	1	16	0	0
20	37914057	.	G	A	9	7	16	0	0	16	0	0
20	37914145	.	C	T	10	5	15	0	0	15	0	0
20	37914838	.	C	T	8	2	10	0	0	10	0	0
20	37914855	.	T	G	10	3	13	0	0	13	0	0
20	37915080	.	T	A	8	4	12	0	2	15	1	0
20	37915097	.	C	G	10	5	15	0	0	15	0	0
20	37915217	.	A	T	14	6	20	0	0	20	0	0
20	37915237	.	C	T	13	6	19	0	0	19	0	0
20	37915292	.	A	G	10	4	14	0	0	14	0	0
20	37915465	.	A	G	10	0	10	0	8	18	0	0
20	37915479	.	C	T	8	7	15	0	0	15	0	0
20	37915658	.	T	C	7	8	15	0	1	16	0	0
20	37915699	.	G	T	2	7	9	0	11	20	0	0
20	37915701	.	C	T	13	7	20	0	0	20	0	0
20	37916043	.	T	A	3	3	6	0	0	6	0	0
20	37916143	.	C	T	6	2	8	0	0	8	0	0
20	37916161	.	A	T	5	2	7	0	0	7	0	0
20	37920773	.	T	C	9	7	16	0	0	16	0	0
20	37920822	.	C	T	0	10	10	0	9	19	0	0
20	37924995	.	G	T	6	5	11	0	0	11	0	0
20	37928136	.	T	G	3	9	12	0	0	12	0	0
20	37928510	.	C	G	6	9	15	0	0	15	0	0
20	37930593	.	A	G	5	5	10	0	0	10	0	0
20	37930874	.	C	T	0	5	5	0	7	12	0	0
20	37934040	.	A	T	4	3	7	0	0	7	0	0
20	37934125	.	T	C	5	3	8	0	0	8	0	0
20	37934174	.	A	G	3	6	9	0	0	9	0	0
20	37934178	.	C	A	3	6	9	0	0	9	0	0
20	38032297	.	C	A	1	1	2	0	2	4	0	0
20	38032694	.	G	C	6	6	12	0	0	12	0	0
20	38076127	.	G	A	0	2	2	0	6	8	0	0
20	38086653	.	A	G	11	9	20	0	1	21	0	0
20	38091814	.	C	T	8	7	15	0	1	16	0	0
20	38104080	.	C	A	22	7	29	0	0	29	0	0
20	38201945	.	T	G	5	8	13	0	1	14	0	0
20	38202064	.	G	A	0	8	8	0	6	14	0	0
20	38202135	.	G	T	7	10	17	0	0	17	0	0
20	38202183	.	C	A	10	12	22	0	0	22	0	0
20	38216798	.	C	T	8	16	24	0	0	24	0	0
20	38241282	.	C	A	4	6	10	0	1	11	0	0
20	38241619	.	G	A	12	6	18	0	0	18	0	0
20	38241637	.	C	T	15	6	21	0	0	21	0	0
20	38241762	.	C	T	1	2	3	0	0	3	0	0
20	38241843	.	A	G	3	6	9	0	0	9	0	0
20	38358660	.	C	A	7	8	15	0	1	16	0	0
20	38358864	.	T	C	5	4	9	0	0	9	0	0
20	38358866	.	T	C	4	5	9	0	0	9	0	0
20	38473700	.	C	T	13	11	24	0	0	24	0	0
20	38473763	.	T	C	8	11	19	0	2	21	0	0
20	38508365	.	G	A	0	1	1	0	0	1	0	0
20	38508375	.	G	A	7	3	10	0	0	10	0	0
20	38517929	.	T	A	8	10	18	0	1	19	0	0
20	38517941	.	C	T	8	11	19	0	0	19	0	0
20	38518015	.	C	T	6	9	15	0	3	18	0	0
20	38518082	.	T	G	10	8	18	0	2	20	0	0
20	38518267	.	A	G	6	8	14	0	0	14	0	0
20	38518454	.	T	G	8	6	14	0	0	14	0	0
20	38525595	.	G	A	2	2	4	0	0	4	0	0
20	38526041	.	G	A	6	3	9	0	0	9	0	0
20	38532334	.	C	T	4	3	7	0	1	8	0	0
20	38538248	.	C	T	2	5	7	0	0	7	0	0
20	38595982	.	G	A	1	2	3	0	1	4	0	0
20	38598281	.	T	C	2	4	6	0	0	6	0	0
20	38625973	.	C	T	3	5	8	0	0	8	0	0
20	38657824	.	C	T	13	9	22	0	0	22	0	0
20	38657825	.	T	C	12	9	21	0	1	22	0	0
20	38669294	.	T	C	8	6	14	0	0	14	0	0
20	38669329	.	A	G	6	0	6	0	7	13	0	0
20	38669406	.	C	A	2	5	7	0	0	7	0	0
20	38669453	.	C	G	5	4	9	0	0	9	0	0
20	38669481	.	C	T	5	3	8	0	1	9	0	0
20	38669562	.	C	T	3	12	15	0	0	15	0	0
20	38669869	.	T	G	2	4	6	0	0	6	0	0
20	38669888	.	T	A	4	3	7	0	0	7	0	0
20	38670143	.	C	T	3	6	9	0	0	9	0	0
20	38670157	.	G	A	0	7	7	0	3	10	0	0
20	38726399	.	A	C	7	8	15	0	3	18	0	0
20	38726421	.	A	T	10	14	24	0	0	24	0	0
20	38726624	.	C	G	9	10	19	0	3	22	0	0
20	38764192	.	C	A	8	15	23	0	1	24	0	0
20	38764201	.	C	A	9	14	23	0	0	23	0	0
20	38764265	.	A	G	8	6	14	0	0	14	0	0
20	38764992	.	T	C	9	8	17	0	1	18	0	0
20	38765100	.	C	T	0	8	8	0	7	15	0	0
20	38765296	.	T	G	14	3	17	1	3	21	0	0
20	38765318	.	T	C	10	12	22	1	0	23	0	0
20	38765364	.	T	A	7	19	26	0	2	28	0	0
20	38765467	.	A	G	14	0	14	0	1	15	0	0
20	38765552	.	C	T	0	21	21	0	8	29	0	0
20	38778463	.	G	A	12	12	24	0	1	25	0	0
20	39257354	.	A	C	3	3	6	0	0	6	0	0
20	39579329	.	A	G	3	3	6	0	1	7	0	0
20	39582056	.	A	T	3	3	6	0	0	6	0	0
20	39692306	.	G	C	3	2	5	0	2	7	0	0
20	39692322	.	G	A	4	2	6	0	1	7	0	0
20	39713145	.	G	A	3	3	6	0	0	6	0	0
20	39806373	.	C	T	9	5	14	0	0	14	0	0
20	39806592	.	T	C	6	5	11	0	0	11	0	0
20	40004883	.	G	A	2	2	4	0	0	4	0	0
20	40119242	.	T	A	3	2	5	0	1	6	0	0
20	40119306	.	C	T	0	6	6	0	7	13	0	0
20	40119353	.	A	T	6	5	11	0	1	12	0	0
20	40119662	.	A	T	5	3	8	0	0	8	0	0
20	40119676	.	C	T	3	5	8	0	0	8	0	0
20	40269926	.	T	C	10	1	11	0	17	28	0	0
20	40319575	.	A	C	7	7	14	0	0	14	0	0
20	40319649	.	C	G	15	8	23	0	1	24	0	0
20	40369463	.	C	A	1	3	4	0	0	4	0	0
20	40369829	.	G	C	2	4	6	0	0	6	0	0
20	40372729	.	G	A	20	8	28	0	0	28	0	0
20	40372760	.	T	A	18	13	31	0	1	32	0	0
20	40372811	.	A	G	16	20	36	0	0	36	0	0
20	40451106	.	C	T	2	5	7	0	0	7	0	0
20	40457669	.	G	C	21	23	44	0	3	47	0	0
20	40461550	.	G	A	25	30	55	0	5	60	0	0
20	40464613	.	C	G	33	31	64	0	1	66	1	0
20	40466540	.	C	T	37	28	65	0	4	69	0	0
20	40466662	.	C	T	38	36	74	0	5	79	0	0
20	40467044	.	C	T	35	34	69	0	1	70	0	0
20	40471756	.	A	T	39	37	76	0	1	77	0	0
20	40471844	.	C	T	28	21	49	2	4	55	0	0
20	40471875	.	G	C	0	4	4	0	11	22	7	0
20	40472009	.	T	A	32	37	69	0	1	70	0	0
20	40472075	.	C	A	34	28	62	1	1	64	0	0
20	40472175	.	G	C	43	28	71	1	1	73	0	0
20	40475815	.	C	T	6	6	12	0	0	12	0	0
20	40475872	.	G	A	8	5	13	0	1	14	0	0
20	40476024	.	T	C	3	1	4	0	1	5	0	0
20	40476030	.	A	C	4	2	6	0	1	7	0	0
20	40476094	.	G	A	16	4	20	0	0	20	0	0
20	40476165	.	C	T	11	22	33	0	1	34	0	0
20	40476214	.	A	T	23	16	39	0	3	42	0	0
20	40478035	.	G	A	22	18	40	0	1	41	0	0
20	40478289	.	A	C	16	13	29	0	1	30	0	0
20	40480227	.	G	T	8	11	19	0	0	19	0	0
20	40480250	.	C	T	11	14	25	0	0	25	0	0
20	40485077	.	T	G	5	2	7	0	0	7	0	0
20	40715260	.	A	G	14	25	39	0	4	43	0	0
20	40716123	.	A	G	5	9	14	1	13	28	0	0
20	40716124	.	C	A	19	5	24	1	3	28	0	0
20	40716899	.	G	A	31	31	62	0	5	67	0	0
20	40716911	.	A	G	38	26	64	0	5	69	0	0
20	40717271	.	G	T	20	22	42	0	2	44	0	0
20	40717418	.	G	A	25	17	42	0	0	42	0	0
20	40717691	.	G	A	15	15	30	0	0	30	0	0
20	40762361	.	T	C	3	4	7	0	1	8	0	0
20	40762505	.	G	T	6	5	11	0	0	11	0	0
20	40763990	.	T	C	4	4	8	0	0	8	0	0
20	40764004	.	G	A	2	5	7	0	0	7	0	0
20	40764132	.	G	T	7	4	11	0	1	12	0	0
20	40777579	.	A	G	1	2	3	0	0	3	0	0
20	40781142	.	C	A	4	3	7	0	0	7	0	0
20	40789726	.	C	T	4	6	10	0	0	10	0	0
20	40804683	.	C	A	5	3	8	0	0	8	0	0
20	40812095	.	C	T	3	4	7	0	0	7	0	0
20	40819423	.	C	G	8	3	11	0	1	12	0	0
20	40835131	.	A	G	9	6	15	0	1	16	0	0
20	40840802	.	G	A	7	6	13	0	2	15	0	0
20	40840963	.	A	C	2	4	6	0	1	7	0	0
20	41160499	.	C	T	6	4	10	0	0	10	0	0
20	41219512	.	C	T	3	5	8	0	0	8	0	0
20	41236764	.	G	A	0	8	8	0	5	13	0	0
20	41237086	.	T	A	7	3	10	0	0	10	0	0
20	41237380	.	A	G	5	1	6	0	3	9	0	0
20	41237731	.	G	A	5	2	7	0	0	7	0	0
20	41237948	.	A	G	5	3	8	0	0	8	0	0
20	41238104	.	C	T	5	3	8	0	0	8	0	0
20	41238473	.	T	A	1	4	5	0	1	6	0	0
20	41239038	.	T	C	9	3	12	0	0	12	0	0
20	41239110	.	G	A	0	3	3	0	3	6	0	0
20	41239396	.	T	A	7	5	12	0	0	12	0	0
20	41239399	.	A	G	7	5	12	0	0	12	0	0
20	41239439	.	T	C	5	3	8	0	0	8	0	0
20	41239461	.	C	T	3	4	7	0	0	7	0	0
20	41239753	.	G	T	0	6	6	0	8	14	0	0
20	41239760	.	G	A	0	5	5	0	10	15	0	0
20	41239838	.	A	G	3	5	8	0	0	8	0	0
20	41239899	.	G	T	4	5	9	0	1	10	0	0
20	41239916	.	A	T	6	4	10	0	0	10	0	0
20	41239946	.	A	G	4	10	14	0	0	14	0	0
20	41239977	.	T	C	11	4	15	0	0	15	0	0
20	41239992	.	T	C	11	4	15	0	0	15	0	0
20	41240107	.	G	C	5	4	9	0	0	9	0	0
20	41240108	.	A	G	5	0	5	0	4	9	0	0
20	41240148	.	A	G	6	0	6	0	4	10	0	0
20	41240176	.	C	T	6	0	6	0	1	9	2	0
20	41240480	.	A	G	8	0	8	0	7	15	0	0
20	41240512	.	A	C	10	8	18	0	0	18	0	0
20	41240643	.	G	A	0	5	5	0	4	9	0	0
20	41240736	.	T	C	4	2	6	0	0	6	0	0
20	41240958	.	A	G	9	6	15	0	0	15	0	0
20	41240986	.	A	G	13	0	13	0	8	21	0	0
20	41241316	.	G	C	5	8	13	0	0	13	0	0
20	41241350	.	C	A	7	8	15	0	1	16	0	0
20	41241355	.	C	T	7	8	15	0	0	15	0	0
20	41241443	.	A	C	7	3	10	0	1	11	0	0
20	41242045	.	G	A	0	9	9	0	13	22	0	0
20	41640701	.	A	C	11	9	20	1	0	21	0	0
20	41640743	.	G	A	11	16	27	1	0	28	0	0
20	41640878	.	T	G	17	5	22	0	0	22	0	0
20	41640903	.	T	C	10	6	16	0	2	18	0	0
20	41640917	.	A	G	8	8	16	0	2	18	0	0
20	41641019	.	A	T	7	11	18	0	0	18	0	0
20	41643457	.	C	T	11	16	27	0	0	27	0	0
20	41651639	.	C	T	15	5	20	0	1	21	0	0
20	41655513	.	G	A	1	10	11	0	17	28	0	0
20	41689967	.	A	G	12	22	34	0	0	34	0	0
20	41689979	.	C	T	19	14	33	0	1	34	0	0
20	41734344	.	C	T	18	11	29	0	1	30	0	0
20	41757835	.	A	G	13	13	26	1	4	31	0	0
20	41765105	.	T	C	18	12	30	0	0	30	0	0
20	41859385	.	C	T	6	4	10	0	0	10	0	0
20	41859612	.	C	T	3	4	7	0	0	7	0	0
20	41915989	.	A	G	1	2	3	1	0	4	0	0
20	41926416	.	G	A	2	3	5	0	0	5	0	0
20	41946745	.	A	G	4	4	8	0	0	8	0	0
20	41949354	.	G	T	1	3	4	0	3	7	0	0
20	41949355	.	C	T	3	3	6	0	0	6	0	0
20	41949432	.	C	T	6	3	9	0	0	9	0	0
20	41960702	.	G	A	0	2	2	0	1	3	0	0
20	41960908	.	C	T	8	4	12	0	0	12	0	0
20	41960962	.	C	T	3	7	10	0	1	11	0	0
20	41961043	.	G	A	1	2	3	0	1	4	0	0
20	41961076	.	G	A	4	2	6	0	1	7	0	0
20	41961113	.	C	T	2	8	10	0	0	10	0	0
20	41961229	.	A	T	2	3	5	0	0	5	0	0
20	41961283	.	A	G	1	1	2	0	3	5	0	0
20	41962214	.	A	T	5	2	7	0	0	7	0	0
20	41962605	.	C	T	1	6	7	0	0	7	0	0
20	41962677	.	C	G	6	0	6	0	3	9	0	0
20	41962872	.	A	G	3	3	6	0	0	6	0	0
20	41962923	.	A	T	8	3	11	0	0	11	0	0
20	41963451	.	G	A	0	3	3	0	5	8	0	0
20	41963530	.	A	G	5	5	10	0	1	11	0	0
20	41963652	.	C	T	1	7	8	0	1	9	0	0
20	41963660	.	C	T	1	7	8	0	0	8	0	0
20	41998507	.	T	C	23	5	28	0	0	28	0	0
20	41998601	.	C	G	14	12	26	0	1	27	0	0
20	41999025	.	C	A	8	14	22	0	0	22	0	0
20	41999046	.	G	A	7	16	23	0	2	25	0	0
20	41999106	.	A	G	9	12	21	0	1	22	0	0
20	42047386	.	C	T	15	9	24	0	1	25	0	0
20	42049122	.	G	A	10	11	21	0	1	22	0	0
20	42049131	.	G	A	8	11	19	0	0	19	0	0
20	42221269	.	T	C	2	2	4	0	0	4	0	0
20	42221438	.	C	A	2	5	7	0	0	7	0	0
20	42221439	.	A	T	2	5	7	0	0	7	0	0
20	42221710	.	C	T	7	12	19	0	2	21	0	0
20	42221901	.	G	A	2	2	4	0	0	4	0	0
20	42221916	.	A	T	1	2	3	0	0	3	0	0
20	42222023	.	T	C	1	5	6	0	0	6	0	0
20	42222113	.	A	G	2	5	7	0	0	7	0	0
20	42222546	.	A	T	8	6	14	0	1	15	0	0
20	42222549	.	A	T	8	7	15	0	0	15	0	0
20	42222770	.	T	C	8	5	13	1	1	15	0	0
20	42222823	.	T	A	9	9	18	0	0	18	0	0
20	42222824	.	A	T	9	8	17	0	1	18	0	0
20	42222883	.	T	C	9	6	15	0	1	16	0	0
20	42223350	.	A	T	3	3	6	0	0	6	0	0
20	42223467	.	G	T	9	6	15	0	0	15	0	0
20	42223480	.	A	T	9	7	16	0	0	16	0	0
20	42232554	.	A	G	6	8	14	0	0	14	0	0
20	42241224	.	T	G	6	10	16	0	0	16	0	0
20	42241254	.	A	T	5	10	15	0	1	16	0	0
20	42241367	.	C	T	1	5	6	0	6	12	0	0
20	42246990	.	C	T	9	8	17	0	1	18	0	0
20	42247018	.	G	C	10	9	19	0	0	19	0	0
20	42247180	.	T	C	8	5	13	0	1	14	0	0
20	42247231	.	G	A	7	4	11	0	1	12	0	0
20	42269631	.	G	A	10	3	13	0	0	13	0	0
20	42275414	.	C	T	14	12	26	0	0	26	0	0
20	42278043	.	C	T	13	9	22	0	1	23	0	0
20	42281068	.	C	T	6	6	12	0	0	12	0	0
20	42281408	.	G	A	1	2	3	0	5	8	0	0
20	42296496	.	C	A	0	3	3	0	2	5	0	0
20	42296500	.	T	A	2	3	5	0	0	5	0	0
20	42296804	.	G	T	2	2	4	0	0	4	0	0
20	42296815	.	C	T	2	3	5	0	0	5	0	0
20	42297094	.	A	C	1	2	3	0	0	3	0	0
20	42297107	.	C	A	3	2	5	0	0	5	0	0
20	42298013	.	T	C	3	0	3	0	4	7	0	0
20	42298456	.	G	A	4	2	6	0	0	6	0	0
20	42298515	.	T	A	4	4	8	1	0	9	0	0
20	42298893	.	G	T	1	2	3	0	0	3	0	0
20	42316292	.	G	A	4	3	7	0	1	8	0	0
20	44373112	.	T	C	7	7	14	0	0	14	0	0
20	44373117	.	T	C	7	5	12	0	0	12	0	0
20	45644152	.	G	C	21	11	32	0	1	33	0	0
20	45644163	.	G	T	21	16	37	0	0	37	0	0
20	46733096	.	C	T	2	5	7	0	3	10	0	0
20	48483184	.	T	A	2	3	5	0	1	6	0	0
20	48483921	.	C	G	7	3	10	0	2	12	0	0
20	48483989	.	A	T	5	4	9	0	0	9	0	0
20	48484411	.	A	C	6	0	6	0	8	14	0	0
20	48598493	.	C	T	3	12	15	0	0	16	1	0
20	48806088	.	A	G	3	2	5	0	0	5	0	0
20	48806586	.	C	T	1	3	4	0	0	4	0	0
20	48844050	.	T	C	16	0	16	0	16	32	0	0
20	48844134	.	A	G	11	19	30	0	1	31	0	0
20	48844259	.	G	T	14	11	25	0	1	26	0	0
20	48844295	.	C	T	1	11	12	0	17	29	0	0
20	48845298	.	A	G	17	11	28	0	0	28	0	0
20	48860755	.	G	A	5	13	18	1	2	21	0	0
20	48869895	.	G	A	10	15	25	0	1	26	0	0
20	48877311	.	G	T	12	8	20	0	1	21	0	0
20	48877475	.	G	A	8	4	12	0	0	12	0	0
20	48886005	.	C	T	12	6	18	1	0	19	0	0
20	48895103	.	G	A	10	13	23	0	1	24	0	0
20	49082581	.	C	T	4	3	7	0	0	7	0	0
20	49085648	.	G	A	1	5	6	1	1	8	0	0
20	49087762	.	G	A	1	3	4	0	10	14	0	0
20	49087768	.	G	A	9	3	12	0	1	13	0	0
20	49087816	.	G	T	8	4	12	0	1	13	0	0
20	49089192	.	T	C	9	5	14	0	0	14	0	0
20	49089237	.	C	T	8	4	12	0	0	12	0	0
20	49094970	.	C	T	11	6	17	0	0	17	0	0
20	49094973	.	T	C	10	5	15	0	0	15	0	0
20	49099900	.	A	G	7	6	13	0	0	13	0	0
20	49100237	.	C	T	9	10	19	0	1	20	0	0
20	49103131	.	G	A	8	9	17	0	1	18	0	0
20	49103164	.	G	A	10	7	17	0	0	17	0	0
20	49103217	.	A	T	7	4	11	0	0	11	0	0
20	49787832	.	A	G	7	0	7	0	4	11	0	0
20	49795211	.	C	T	1	7	8	0	0	8	0	0
20	49797899	.	C	A	2	4	6	0	0	6	0	0
20	49804501	.	C	T	4	6	10	0	0	10	0	0
20	49895249	.	T	A	2	3	5	0	0	6	1	0
20	49902337	.	A	G	5	7	12	0	0	12	0	0
20	49916653	.	T	C	6	3	9	0	0	9	0	0
20	49928358	.	A	T	1	2	3	0	2	5	0	0
20	49940895	.	G	A	12	5	17	0	0	17	0	0
20	49940969	.	G	T	15	7	22	0	1	23	0	0
20	49952738	.	A	G	13	8	21	0	2	23	0	0
20	49959810	.	T	A	8	5	13	0	0	13	0	0
20	49960011	.	A	G	12	4	16	0	0	16	0	0
20	49960328	.	A	G	8	3	11	0	0	11	0	0
20	49960791	.	A	G	7	5	12	0	1	13	0	0
20	49961070	.	C	T	3	2	5	0	0	5	0	0
20	49961268	.	G	T	8	3	11	0	1	12	0	0
20	49961402	.	T	G	10	3	13	0	0	13	0	0
20	49961995	.	G	C	9	5	14	0	0	14	0	0
20	49961998	.	C	T	9	3	12	0	0	12	0	0
20	50015754	.	C	T	6	11	17	0	1	18	0	0
20	50022331	.	T	C	6	2	8	0	0	8	0	0
20	50022333	.	G	C	6	2	8	0	0	8	0	0
20	50032187	.	G	C	3	4	7	0	0	7	0	0
20	50041707	.	A	G	2	3	5	0	0	5	0	0
20	50049078	.	C	A	42	21	63	0	3	66	0	0
20	50054717	.	C	T	4	4	8	0	0	8	0	0
20	50057348	.	C	T	7	4	11	0	0	11	0	0
20	50074077	.	C	T	6	4	10	0	1	11	0	0
20	50074173	.	C	T	9	10	19	0	0	19	0	0
20	50074212	.	C	T	11	6	17	0	1	18	0	0
20	50076480	.	G	A	0	3	3	0	6	9	0	0
20	50079067	.	T	C	4	6	10	0	0	10	0	0
20	50079070	.	A	G	3	6	9	0	0	9	0	0
20	50079154	.	T	C	8	4	12	0	0	12	0	0
20	50082425	.	A	G	3	6	9	0	0	9	0	0
20	50082861	.	T	C	7	9	16	0	0	16	0	0
20	50085935	.	T	A	3	3	6	0	0	6	0	0
20	50650253	.	G	A	1	5	6	0	9	15	0	0
20	50725479	.	G	A	0	4	4	0	7	11	0	0
20	50740230	.	G	T	1	12	13	0	5	18	0	0
20	50898883	.	T	C	19	12	31	0	0	31	0	0
20	50917646	.	T	C	9	11	20	0	0	20	0	0
20	50921211	.	T	C	10	9	19	0	0	19	0	0
20	50923848	.	G	A	15	16	31	0	0	31	0	0
20	50926695	.	G	A	2	11	13	0	18	31	0	0
20	50989199	.	A	G	16	0	16	0	15	31	0	0
20	50999024	.	C	G	25	16	41	0	0	41	0	0
20	51069864	.	A	G	9	0	9	0	7	16	0	0
20	51069996	.	T	C	7	11	18	0	0	18	0	0
20	51073369	.	A	T	17	8	25	0	0	25	0	0
20	51073449	.	G	A	5	6	11	0	14	25	0	0
20	51073692	.	G	A	8	6	14	0	1	15	0	0
20	51073730	.	G	A	11	11	22	0	1	23	0	0
20	51074352	.	A	T	5	3	8	0	0	8	0	0
20	51074463	.	T	C	3	2	5	0	0	5	0	0
20	51088802	.	A	T	26	31	57	0	3	60	0	0
20	51089236	.	T	C	19	0	19	3	25	47	0	0
20	51089243	.	T	C	12	29	41	3	3	47	0	0
20	51089328	.	C	T	6	18	24	0	36	60	0	0
20	51089332	.	T	C	41	16	57	0	4	61	0	0
20	51100498	.	T	C	21	16	37	0	0	38	1	0
20	51100562	.	A	G	31	21	52	0	2	54	0	0
20	51112184	.	C	T	14	15	29	0	2	31	0	0
20	51112208	.	C	T	16	13	29	0	4	34	1	0
20	51117661	.	A	C	24	16	40	0	2	42	0	0
20	51117664	.	G	A	17	24	41	0	2	43	0	0
20	51118227	.	A	G	20	0	20	0	27	47	0	0
20	51118281	.	C	A	24	26	50	0	0	50	0	0
20	51118314	.	T	C	17	20	37	0	3	40	0	0
20	51122939	.	C	T	21	16	37	0	2	39	0	0
20	51123088	.	C	T	18	14	32	0	0	32	0	0
20	51123109	.	G	C	13	14	27	0	2	29	0	0
20	51123229	.	C	T	4	2	6	0	0	6	0	0
20	51132284	.	A	G	25	15	40	0	3	43	0	0
20	51141284	.	C	T	1	12	13	0	11	24	0	0
20	51146152	.	T	G	14	12	26	0	2	28	0	0
20	51146153	.	G	A	13	15	28	0	0	28	0	0
20	51146194	.	A	G	16	7	23	0	2	25	0	0
20	51150029	.	G	T	12	5	17	0	0	17	0	0
20	51151647	.	G	A	13	8	21	0	0	21	0	0
20	51157010	.	T	G	6	13	19	0	0	19	0	0
20	51157061	.	C	T	1	13	14	0	5	19	0	0
20	51157082	.	T	C	11	14	25	0	1	26	0	0
20	51157109	.	C	T	14	14	28	0	1	29	0	0
20	51157204	.	G	A	7	15	22	0	2	24	0	0
20	51168502	.	T	C	10	8	18	0	0	18	0	0
20	51200015	.	C	T	34	29	63	0	15	78	0	0
20	51204759	.	C	T	19	47	66	0	12	78	0	0
20	51205691	.	T	G	28	51	79	0	4	83	0	0
20	51205745	.	G	A	36	47	83	0	4	87	0	0
20	51206976	.	C	A	40	32	72	1	3	76	0	0
20	51207030	.	C	T	38	36	74	0	3	77	0	0
20	51207051	.	G	A	48	31	79	0	3	82	0	0
20	51207609	.	C	A	42	40	82	0	8	90	0	0
20	51207672	.	C	T	46	36	82	0	5	87	0	0
20	51207726	.	C	T	33	48	81	1	2	84	0	0
20	51211455	.	G	A	14	35	49	1	39	89	0	0
20	51648293	.	T	C	6	2	8	0	0	8	0	0
20	51648557	.	T	C	3	0	3	0	1	4	0	0
20	51819054	.	T	C	3	2	5	0	0	5	0	0
20	51822241	.	C	A	0	5	5	0	0	5	0	0
20	52333070	.	A	G	2	12	14	0	0	14	0	0
20	52540721	.	A	G	3	4	7	0	1	8	0	0
20	52907422	.	A	G	4	5	9	0	1	10	0	0
20	52907598	.	T	C	4	0	4	0	10	14	0	0
20	52928149	.	G	A	1	2	3	0	0	3	0	0
20	52939332	.	C	T	1	5	6	0	0	6	0	0
20	53069778	.	C	T	1	12	13	0	14	27	0	0
20	53069784	.	G	A	14	13	27	0	0	27	0	0
20	53074615	.	T	C	7	0	7	0	4	11	0	0
20	53181091	.	G	A	2	3	5	0	5	10	0	0
20	53183510	.	C	T	9	6	15	0	0	15	0	0
20	53191016	.	G	A	4	6	10	0	0	10	0	0
20	53215338	.	A	G	7	0	7	1	9	17	0	0
20	53224585	.	A	G	10	7	17	0	0	17	0	0
20	53278952	.	C	T	1	2	3	0	0	3	0	0
20	53279495	.	G	T	0	3	3	0	7	10	0	0
20	53279543	.	C	T	2	3	5	0	0	5	0	0
20	53312604	.	G	T	14	15	29	0	3	32	0	0
20	53318814	.	G	T	12	13	25	0	1	27	1	0
20	53318884	.	C	T	0	13	13	0	13	27	1	0
20	53365862	.	C	T	10	13	23	2	2	27	0	0
20	53366073	.	A	C	4	8	12	0	0	12	0	0
20	53377661	.	A	G	7	0	7	0	11	18	0	0
20	53377691	.	G	A	5	6	11	0	1	12	0	0
20	53378919	.	T	G	5	0	5	0	13	18	0	0
20	53393594	.	T	C	4	10	14	0	1	15	0	0
20	53393669	.	C	A	12	6	18	0	0	19	1	0
20	53398784	.	T	A	9	12	21	0	1	22	0	0
20	53401771	.	T	C	8	9	17	0	0	17	0	0
20	53401778	.	A	G	6	11	17	0	0	17	0	0
20	53408394	.	A	C	2	2	4	0	0	4	0	0
20	53408532	.	G	A	1	3	4	0	0	4	0	0
20	53422244	.	G	T	1	2	3	0	0	3	0	0
20	53600883	.	G	A	1	2	3	0	1	4	0	0
20	53601067	.	C	T	5	4	9	0	0	9	0	0
20	53601186	.	C	T	0	2	2	0	4	6	0	0
20	53601260	.	A	G	1	2	3	0	0	3	0	0
20	53601323	.	T	C	1	3	4	0	0	4	0	0
20	53601437	.	C	T	1	2	3	0	6	9	0	0
20	53601461	.	T	C	4	0	4	0	3	7	0	0
20	53601590	.	G	A	4	2	6	0	0	6	0	0
20	53601608	.	C	T	3	2	5	0	0	5	0	0
20	53601677	.	T	C	2	0	2	0	4	6	0	0
20	53635042	.	T	C	2	5	7	0	0	7	0	0
20	53637686	.	G	A	4	8	12	0	0	12	0	0
20	53639358	.	C	T	2	3	5	0	0	5	0	0
20	53639391	.	C	G	3	3	6	0	0	6	0	0
20	53639462	.	T	C	2	5	7	0	0	7	0	0
20	53639876	.	T	C	3	6	9	0	0	9	0	0
20	53639964	.	A	G	6	4	10	1	0	11	0	0
20	53639980	.	C	T	4	2	6	1	0	7	0	0
20	53640054	.	C	T	2	2	4	0	0	4	0	0
20	53641251	.	T	A	2	4	6	0	0	6	0	0
20	53803360	.	G	C	3	2	5	0	1	6	0	0
20	53803637	.	C	T	10	18	28	0	0	28	0	0
20	53803783	.	T	A	12	19	31	0	3	34	0	0
20	53804306	.	A	G	19	8	27	0	1	28	0	0
20	53804342	.	A	G	23	7	30	0	3	33	0	0
20	53804439	.	A	G	15	11	26	0	1	27	0	0
20	53804470	.	G	A	15	7	22	0	2	24	0	0
20	53804618	.	G	C	7	11	18	0	0	18	0	0
20	53810197	.	A	T	13	18	31	0	1	32	0	0
20	53810395	.	G	A	14	3	17	0	2	19	0	0
20	53810419	.	A	G	7	4	11	0	5	16	0	0
20	53898735	.	T	A	11	14	25	0	6	31	0	0
20	53898770	.	C	T	1	23	24	0	9	33	0	0
20	53898930	.	G	A	4	10	14	0	1	15	0	0
20	53899023	.	G	C	17	16	33	0	1	34	0	0
20	53899035	.	G	A	20	15	35	0	2	37	0	0
20	53900860	.	C	T	10	6	16	0	0	16	0	0
20	53901183	.	A	G	3	9	12	6	0	18	0	0
20	53902151	.	G	A	11	4	15	0	1	16	0	0
20	53902155	.	G	C	12	5	17	0	0	17	0	0
20	53903856	.	T	C	11	21	32	2	1	35	0	0
20	53912151	.	T	C	10	0	10	0	11	21	0	0
20	53912208	.	C	T	1	14	15	0	7	22	0	0
20	53921147	.	T	C	9	12	21	0	2	23	0	0
20	53928363	.	T	C	4	1	5	0	7	12	0	0
20	53930457	.	G	A	7	8	15	0	1	16	0	0
20	53930466	.	C	T	1	11	12	0	5	17	0	0
20	53949741	.	A	G	4	14	18	0	0	18	0	0
20	53958187	.	C	T	3	3	6	0	0	6	0	0
20	53968105	.	A	G	31	26	57	0	2	59	0	0
20	54047440	.	A	G	4	0	4	0	7	11	0	0
20	54047664	.	G	A	4	4	8	0	0	8	0	0
20	54047697	.	A	T	2	3	5	0	0	5	0	0
20	54048057	.	C	T	3	5	8	0	1	9	0	0
20	54048078	.	T	C	3	3	6	0	1	7	0	0
20	54048099	.	C	T	4	2	6	0	1	7	0	0
20	54050450	.	G	T	0	2	2	0	2	4	0	0
20	54050653	.	C	T	1	3	4	0	0	4	0	0
20	54050670	.	A	G	1	3	4	0	0	4	0	0
20	54050825	.	T	A	3	5	8	0	1	9	0	0
20	54051096	.	T	G	2	0	2	0	6	8	0	0
20	54067345	.	A	G	7	10	17	0	1	18	0	0
20	54067399	.	G	A	9	6	15	0	0	15	0	0
20	54067414	.	G	A	9	5	14	0	0	14	0	0
20	54067714	.	A	G	10	10	20	0	1	21	0	0
20	54067894	.	G	A	5	8	13	0	1	14	0	0
20	54085851	.	T	C	24	23	47	0	1	48	0	0
20	54175443	.	C	T	5	4	9	0	0	9	0	0
20	54175527	.	A	G	6	3	9	0	0	9	0	0
20	54180851	.	C	T	1	3	4	0	0	4	0	0
20	54183612	.	T	C	5	0	5	0	3	8	0	0
20	54197221	.	A	C	15	0	15	0	18	33	0	0
20	54197287	.	A	T	18	14	32	0	1	33	0	0
20	54197383	.	G	A	15	21	36	0	2	39	1	0
20	54197473	.	A	G	16	13	29	0	0	29	0	0
20	54197485	.	C	T	1	13	14	0	15	29	0	0
20	54197751	.	A	G	14	16	30	0	2	32	0	0
20	54197752	.	G	A	14	16	30	0	2	32	0	0
20	54205704	.	C	T	38	26	64	0	2	66	0	0
20	54215073	.	C	A	6	2	8	0	1	9	0	0
20	54215081	.	T	C	8	0	8	0	2	10	0	0
20	54215133	.	A	C	8	6	14	0	1	15	0	0
20	54219286	.	T	C	23	1	24	0	24	48	0	0
20	54228003	.	A	T	21	23	44	0	2	46	0	0
20	54233207	.	T	C	17	0	17	0	13	30	0	0
20	54235969	.	G	A	20	14	34	0	0	34	0	0
20	54236421	.	A	C	16	11	27	0	0	27	0	0
20	54236423	.	G	A	16	11	27	0	0	27	0	0
20	54249577	.	G	C	16	16	32	0	4	36	0	0
20	54251406	.	T	C	26	22	48	0	1	49	0	0
20	54274561	.	G	A	11	14	25	0	2	27	0	0
20	54277241	.	A	C	17	17	34	0	2	36	0	0
20	54278129	.	T	A	22	11	33	0	2	35	0	0
20	54283833	.	T	C	16	13	29	0	2	31	0	0
20	54284869	.	A	G	17	0	17	0	19	36	0	0
20	54284986	.	A	G	22	25	47	0	2	49	0	0
20	54285758	.	T	C	14	24	38	0	3	41	0	0
20	54285799	.	C	T	15	24	39	0	0	39	0	0
20	54285804	.	C	T	17	24	41	0	1	42	0	0
20	54285853	.	A	T	24	21	45	1	1	47	0	0
20	54286016	.	G	A	23	10	33	1	1	35	0	0
20	54286097	.	A	T	18	11	29	0	0	29	0	0
20	54286145	.	A	G	22	6	28	0	0	28	0	0
20	54286454	.	C	A	6	12	18	0	1	19	0	0
20	54286666	.	C	T	18	9	27	0	2	29	0	0
20	54286682	.	G	A	18	6	24	0	5	29	0	0
20	54286797	.	G	T	9	5	14	0	1	15	0	0
20	54286798	.	A	G	9	4	13	0	2	15	0	0
20	54334478	.	C	T	8	13	21	0	0	21	0	0
20	54339998	.	C	T	4	13	17	0	0	17	0	0
20	54340018	.	G	C	5	7	12	0	1	13	0	0
20	54340285	.	C	T	5	17	22	0	0	22	0	0
20	54340700	.	T	C	5	5	10	0	1	11	0	0
20	54340865	.	C	T	3	2	5	0	0	5	0	0
20	54341019	.	A	G	9	3	12	0	0	12	0	0
20	54341082	.	A	C	7	11	18	0	1	19	0	0
20	54341108	.	G	T	0	8	8	0	10	18	0	0
20	54341130	.	C	T	8	8	16	0	0	16	0	0
20	54341154	.	A	G	8	7	15	0	0	15	0	0
20	54341203	.	T	A	6	4	10	0	0	10	0	0
20	54341305	.	G	A	0	3	3	0	5	8	0	0
20	54341822	.	C	T	2	4	6	0	0	6	0	0
20	54342051	.	T	G	6	4	10	0	0	10	0	0
20	54342530	.	G	T	2	6	8	1	1	10	0	0
20	54342589	.	A	T	2	8	10	0	0	10	0	0
20	54342674	.	T	C	4	7	11	0	0	11	0	0
20	54342715	.	C	T	3	4	7	0	0	7	0	0
20	54343566	.	G	C	0	10	10	0	10	20	0	0
20	54343639	.	C	A	4	3	7	0	0	7	0	0
20	54343682	.	T	C	6	3	9	0	1	10	0	0
20	54343695	.	A	T	9	6	15	0	0	15	0	0
20	54343866	.	G	A	9	7	16	0	0	16	0	0
20	54343928	.	A	G	7	9	16	0	0	16	0	0
20	54344711	.	A	G	11	0	11	0	11	22	0	0
20	54344748	.	T	C	8	14	22	0	0	22	0	0
20	54344795	.	G	A	9	15	24	0	0	24	0	0
20	54344815	.	G	T	9	12	21	0	1	22	0	0
20	54344910	.	C	T	8	7	15	0	0	15	0	0
20	54345808	.	T	C	5	2	7	0	0	7	0	0
20	54345955	.	A	T	17	9	26	0	1	27	0	0
20	54345979	.	A	G	17	7	24	2	0	26	0	0
20	54346012	.	G	C	1	2	3	2	15	22	2	0
20	54346159	.	G	T	1	3	4	0	12	16	0	0
20	54346178	.	G	T	13	5	18	0	1	19	0	0
20	54346239	.	A	G	10	11	21	0	0	21	0	0
20	54356452	.	G	C	10	26	36	0	0	36	0	0
20	54357955	.	C	T	12	7	19	0	0	19	0	0
20	54358656	.	T	C	2	5	7	0	1	8	0	0
20	54360143	.	G	A	2	5	7	0	0	7	0	0
20	54360148	.	G	T	0	4	4	0	2	6	0	0
20	54360939	.	G	A	2	3	5	0	0	5	0	0
20	54360940	.	A	G	2	3	5	0	0	5	0	0
20	54368893	.	T	C	2	3	5	0	1	6	0	0
20	54369479	.	A	G	2	2	4	0	0	4	0	0
20	54397812	.	T	C	13	9	22	0	1	23	0	0
20	54397846	.	A	G	13	0	13	0	13	26	0	0
20	54397897	.	G	C	21	14	35	0	0	35	0	0
20	54398242	.	C	T	13	12	25	0	1	26	0	0
20	54398380	.	T	A	18	7	25	0	1	26	0	0
20	54398443	.	A	G	9	15	24	0	2	26	0	0
20	54402157	.	G	T	3	16	19	0	11	30	0	0
20	54402346	.	G	A	18	11	29	0	1	30	0	0
20	54402489	.	G	A	12	20	32	0	0	32	0	0
20	54406699	.	A	T	13	15	28	0	1	29	0	0
20	54406813	.	A	G	16	12	28	0	0	28	0	0
20	54407401	.	G	C	14	19	33	0	5	38	0	0
20	54407456	.	T	C	14	12	26	0	0	26	0	0
20	54407556	.	C	T	14	4	18	0	0	18	0	0
20	54422636	.	G	A	15	10	25	0	0	25	0	0
20	54422780	.	C	G	13	15	28	0	0	28	0	0
20	54422909	.	C	T	14	13	27	0	0	27	0	0
20	54422929	.	G	A	14	11	25	0	0	25	0	0
20	54423005	.	T	C	17	7	24	0	0	24	0	0
20	54423027	.	C	G	3	20	23	0	1	24	0	0
20	54428696	.	A	G	15	15	30	0	0	30	0	0
20	54432835	.	T	C	18	0	18	0	15	33	0	0
20	54432855	.	T	C	23	2	25	0	16	41	0	0
20	54434895	.	G	A	14	25	39	0	4	43	0	0
20	54434918	.	C	T	15	22	37	0	2	39	0	0
20	54441757	.	A	C	33	31	64	0	2	66	0	0
20	54446877	.	G	A	26	22	48	0	2	50	0	0
20	54462151	.	G	C	24	18	42	0	1	43	0	0
20	54525439	.	T	C	4	5	9	0	0	9	0	0
20	54563425	.	A	G	9	10	19	0	1	20	0	0
20	54563866	.	C	A	12	7	19	0	0	19	0	0
20	54563995	.	G	A	10	7	17	0	0	17	0	0
20	54563998	.	G	C	10	6	16	0	0	16	0	0
20	54670746	.	T	C	2	3	5	0	0	5	0	0
20	54670770	.	T	G	2	4	6	0	1	7	0	0
20	54670836	.	C	G	6	3	9	0	0	9	0	0
20	54670904	.	C	G	6	0	6	0	3	9	0	0
20	54670966	.	A	G	4	4	8	0	1	9	0	0
20	54670984	.	T	A	4	4	8	0	1	9	0	0
20	54671032	.	A	C	5	4	9	0	0	9	0	0
20	54671839	.	A	G	4	0	4	0	1	5	0	0
20	54671864	.	T	G	3	3	6	0	0	6	0	0
20	54671894	.	A	C	2	4	6	0	1	7	0	0
20	54671989	.	G	A	2	3	5	0	6	11	0	0
20	54672009	.	A	C	5	4	9	0	0	9	0	0
20	54672839	.	A	G	6	0	6	0	14	20	0	0
20	54672869	.	T	C	7	8	15	0	0	15	0	0
20	54672891	.	T	C	12	6	18	0	0	18	0	0
20	54672974	.	G	A	1	4	5	0	14	19	0	0
20	54673175	.	T	C	7	5	12	0	1	13	0	0
20	54673198	.	T	A	6	4	10	0	1	11	0	0
20	54675294	.	T	C	3	10	13	0	0	13	0	0
20	54675308	.	C	G	4	0	4	0	6	10	0	0
20	54675356	.	C	T	5	8	13	0	1	14	0	0
20	54675391	.	T	C	4	6	10	0	0	10	0	0
20	54676529	.	A	G	6	0	6	0	15	21	0	0
20	54676532	.	T	G	7	16	23	0	0	23	0	0
20	54676583	.	C	T	8	8	16	0	0	16	0	0
20	54681734	.	G	A	4	7	11	0	1	12	0	0
20	54681797	.	T	A	2	7	9	0	0	9	0	0
20	54681944	.	A	T	9	5	14	0	0	14	0	0
20	54698791	.	C	T	7	8	15	0	2	17	0	0
20	54699133	.	C	T	9	9	18	0	0	18	0	0
20	54708193	.	T	C	14	13	27	0	1	28	0	0
20	54708277	.	G	A	1	13	14	0	11	25	0	0
20	54711535	.	G	C	6	5	11	0	3	14	0	0
20	54738249	.	C	G	7	8	15	1	0	16	0	0
20	54740904	.	G	A	16	9	25	0	1	26	0	0
20	54740907	.	A	G	16	0	16	0	10	26	0	0
20	54740955	.	C	T	8	10	18	0	5	23	0	0
20	54740976	.	G	T	1	10	11	0	15	26	0	0
20	54741763	.	G	A	8	10	18	0	1	19	0	0
20	54742641	.	C	G	9	8	17	0	2	19	0	0
20	54742714	.	C	T	10	8	18	0	4	22	0	0
20	54742750	.	A	G	7	0	7	0	11	18	0	0
20	54742765	.	A	C	6	13	19	0	1	20	0	0
20	54742912	.	A	C	7	8	15	0	0	15	0	0
20	54743917	.	G	A	16	11	27	0	1	28	0	0
20	54743937	.	C	T	14	5	19	0	1	20	0	0
20	54744230	.	C	T	16	12	28	0	1	29	0	0
20	54744314	.	A	G	19	0	19	0	16	35	0	0
20	54744363	.	A	G	15	0	15	0	10	26	1	0
20	54744419	.	A	G	17	8	25	0	0	25	0	0
21	238575	.	T	C	6	13	19	0	2	21	0	0
21	734962	.	A	G	14	0	14	0	13	27	0	0
21	735222	.	A	G	38	0	38	0	29	67	0	0
21	1780794	.	C	T	3	2	5	0	1	6	0	0
21	1780912	.	A	C	6	5	11	0	1	12	0	0
21	1788234	.	A	G	4	4	8	0	0	8	0	0
21	1788474	.	G	A	9	3	12	0	0	12	0	0
21	1798961	.	C	T	4	6	10	0	0	10	0	0
21	1907038	.	C	A	20	12	32	0	2	34	0	0
21	1907080	.	C	T	2	18	20	0	16	36	0	0
21	1930112	.	A	T	21	7	28	0	2	30	0	0
21	1934091	.	T	C	23	18	41	0	1	42	0	0
21	1934156	.	A	G	16	17	33	0	1	34	0	0
21	1944766	.	A	G	13	18	31	0	0	31	0	0
21	1944924	.	G	A	11	14	25	8	2	35	0	0
21	1948578	.	T	C	13	0	13	2	13	28	0	0
21	1963391	.	G	A	19	8	27	1	0	28	0	0
21	1963433	.	A	G	23	8	31	2	0	33	0	0
21	1968842	.	T	C	19	10	29	0	1	30	0	0
21	1991007	.	G	T	19	21	40	0	0	40	0	0
21	1991097	.	A	G	26	20	46	0	4	50	0	0
21	1991118	.	G	A	18	25	43	0	8	52	1	0
21	1991160	.	G	A	22	36	58	0	5	63	0	0
21	1996944	.	T	C	18	29	47	0	3	50	0	0
21	2014639	.	G	A	17	19	36	0	0	36	0	0
21	2025607	.	C	T	14	23	37	0	0	37	0	0
21	2030212	.	C	T	14	13	27	0	2	29	0	0
21	2031804	.	C	T	14	12	26	0	1	27	0	0
21	2031810	.	G	T	13	11	24	0	2	26	0	0
21	2031843	.	A	G	11	12	23	0	1	24	0	0
21	2031849	.	A	G	11	14	25	0	0	25	0	0
21	2031894	.	A	G	14	18	32	0	1	33	0	0
21	2033854	.	G	A	15	15	30	0	1	31	0	0
21	2033964	.	T	G	10	11	21	0	2	23	0	0
21	2035056	.	C	A	2	18	20	0	15	36	1	0
21	2035059	.	C	G	15	17	32	0	1	33	0	0
21	2035146	.	T	A	9	12	21	0	0	21	0	0
21	2036975	.	G	A	11	15	26	0	1	27	0	0
21	2042005	.	C	T	2	7	9	0	22	31	0	0
21	2103128	.	G	A	1	2	3	0	0	3	0	0
21	2111153	.	T	C	1	3	4	0	0	4	0	0
21	2111162	.	G	A	1	2	3	0	1	4	0	0
21	2111312	.	C	A	1	5	6	0	0	6	0	0
21	2112595	.	A	T	3	3	6	0	0	6	0	0
21	2113073	.	T	A	2	2	4	0	0	4	0	0
21	2119876	.	C	T	5	0	5	0	0	5	0	0
21	2119891	.	A	G	3	3	6	0	0	6	0	0
21	2119920	.	A	G	3	4	7	0	0	7	0	0
21	2119973	.	G	T	1	5	6	0	1	7	0	0
21	2120038	.	T	C	2	0	2	0	2	4	0	0
21	2120061	.	C	G	2	3	5	0	0	5	0	0
21	2120193	.	A	G	3	3	6	0	0	6	0	0
21	2120217	.	T	A	4	3	7	0	0	7	0	0
21	2120237	.	C	A	5	4	9	0	0	9	0	0
21	2120546	.	C	T	0	5	5	0	1	6	0	0
21	2120550	.	T	G	1	4	5	0	2	7	0	0
21	2124201	.	G	A	5	3	8	0	0	8	0	0
21	2124206	.	T	G	5	3	8	0	0	8	0	0
21	2129890	.	A	G	2	2	4	0	0	4	0	0
21	2220988	.	C	T	1	6	7	0	0	7	0	0
21	2738221	.	C	T	24	19	43	0	0	43	0	0
21	3004163	.	A	G	2	2	4	0	0	4	0	0
21	3247678	.	A	T	4	9	13	0	0	13	0	0
21	3247687	.	A	G	2	5	7	0	1	8	0	0
21	3301916	.	C	T	7	6	13	0	1	14	0	0
21	3301931	.	C	A	8	5	13	0	2	15	0	0
21	3302296	.	A	G	4	0	4	0	6	10	0	0
21	3422565	.	T	G	8	9	17	1	0	18	0	0
21	3452462	.	A	G	10	6	16	0	0	16	0	0
21	3478014	.	A	G	5	3	8	0	1	9	0	0
21	3536050	.	A	G	8	7	15	0	1	16	0	0
21	3536056	.	T	A	8	8	16	0	0	16	0	0
21	3536113	.	A	C	8	3	11	0	0	11	0	0
21	3536116	.	G	A	6	4	10	0	0	10	0	0
21	3536597	.	C	T	1	8	9	0	4	13	0	0
21	3539275	.	C	T	9	9	18	0	1	19	0	0
21	3567722	.	A	G	6	6	12	1	0	13	0	0
21	3597391	.	C	T	1	3	4	0	7	11	0	0
21	3600561	.	T	G	3	6	9	0	0	9	0	0
21	3600921	.	G	A	4	5	9	0	0	9	0	0
21	3606571	.	C	T	1	5	6	0	1	7	0	0
21	3613482	.	A	C	1	3	4	0	0	4	0	0
21	3613551	.	G	A	3	5	8	0	1	9	0	0
21	3715950	.	A	G	9	13	22	0	4	26	0	0
21	3715986	.	T	A	13	8	21	0	0	21	0	0
21	3715989	.	A	G	13	7	20	0	1	21	0	0
21	3716058	.	T	A	14	12	26	0	1	27	0	0
21	3716234	.	A	G	6	2	8	0	0	8	0	0
21	3716517	.	C	A	1	2	3	0	0	3	0	0
21	3716732	.	G	T	18	15	33	0	1	34	0	0
21	3716845	.	G	A	6	3	9	0	9	18	0	0
21	3716846	.	A	T	5	4	9	0	9	18	0	0
21	3716930	.	G	A	19	18	37	0	3	40	0	0
21	3717055	.	G	A	22	23	45	0	2	47	0	0
21	3717505	.	T	C	15	0	15	0	15	30	0	0
21	3719779	.	G	A	7	7	14	0	2	16	0	0
21	3725881	.	A	C	9	0	9	0	13	22	0	0
21	3738181	.	C	T	3	14	17	0	23	40	0	0
21	3778633	.	T	C	3	6	9	0	0	9	0	0
21	3785401	.	C	T	4	4	8	0	0	8	0	0
21	3786377	.	C	T	4	7	11	0	1	12	0	0
21	3789922	.	T	A	10	8	18	0	0	18	0	0
21	3789930	.	C	T	12	10	22	0	0	22	0	0
21	3789998	.	A	G	15	16	31	0	2	33	0	0
21	3793211	.	G	A	15	19	34	0	1	35	0	0
21	3793309	.	T	C	17	18	35	0	0	35	0	0
21	3793413	.	C	T	26	17	43	0	1	44	0	0
21	3796376	.	G	T	11	17	28	0	2	30	0	0
21	3796398	.	G	T	8	10	18	0	0	18	0	0
21	3796732	.	A	T	2	5	7	0	0	7	0	0
21	3797577	.	A	T	1	2	3	0	1	4	0	0
21	3801868	.	C	T	3	4	7	0	0	7	0	0
21	3801871	.	C	T	3	3	6	0	0	6	0	0
21	3803354	.	A	G	3	2	5	0	0	5	0	0
21	3822666	.	T	C	8	0	8	0	9	17	0	0
21	3822827	.	T	G	16	7	23	0	0	23	0	0
21	3822841	.	A	T	15	6	21	0	2	23	0	0
21	3822896	.	T	C	8	0	8	0	8	16	0	0
21	3825019	.	T	A	11	9	20	0	1	21	0	0
21	3868983	.	T	C	4	2	6	0	0	6	0	0
21	3874247	.	T	A	0	2	2	0	1	3	0	0
21	3875939	.	C	T	2	2	4	0	1	5	0	0
21	3880885	.	G	A	1	4	5	0	5	10	0	0
21	3881003	.	G	A	4	8	12	0	1	13	0	0
21	3881105	.	C	T	5	3	8	0	0	8	0	0
21	3912699	.	C	G	3	10	13	0	0	13	0	0
21	3917912	.	C	A	9	5	14	0	1	15	0	0
21	3918006	.	A	G	11	4	15	0	1	16	0	0
21	3918186	.	G	A	10	8	18	0	0	18	0	0
21	3955290	.	T	A	5	3	8	0	0	8	0	0
21	3955319	.	C	A	3	3	6	0	1	7	0	0
21	3955445	.	G	A	4	3	7	0	3	10	0	0
21	3958058	.	T	C	2	3	5	0	0	5	0	0
21	3958285	.	A	G	1	3	4	0	0	4	0	0
21	3962692	.	T	C	2	5	7	0	2	9	0	0
21	3965882	.	A	G	5	2	7	0	0	7	0	0
21	3972766	.	G	A	6	4	10	0	0	10	0	0
21	3995529	.	A	G	7	8	15	0	0	15	0	0
21	4025201	.	T	A	8	5	13	0	0	13	0	0
21	4116559	.	T	C	4	5	9	0	0	9	0	0
21	4166110	.	C	G	4	5	9	0	0	9	0	0
21	4180976	.	G	A	0	3	3	0	3	6	0	0
21	4180985	.	C	T	2	3	5	0	0	5	0	0
21	4182811	.	C	G	1	4	5	0	0	5	0	0
21	4185028	.	C	A	12	7	19	0	0	19	0	0
21	4185102	.	G	C	0	5	5	0	8	13	0	0
21	4188200	.	G	A	8	8	16	0	1	17	0	0
21	4188269	.	A	G	6	3	9	0	1	10	0	0
21	4188272	.	G	C	7	4	11	0	0	11	0	0
21	4201072	.	C	G	3	3	6	0	0	6	0	0
21	4209004	.	C	A	1	2	3	0	0	3	0	0
21	4209027	.	T	C	2	2	4	0	0	4	0	0
21	4209156	.	T	C	2	3	5	0	0	5	0	0
21	4210998	.	A	G	4	0	4	0	5	9	0	0
21	4219400	.	T	A	9	3	12	0	1	13	0	0
21	4227387	.	C	G	12	6	18	0	0	18	0	0
21	4227392	.	T	A	10	6	16	0	0	16	0	0
21	4227433	.	T	G	4	6	10	0	0	10	0	0
21	4227788	.	G	A	9	8	17	1	0	18	0	0
21	4228026	.	G	A	15	13	28	0	2	30	0	0
21	4232774	.	A	G	2	11	13	0	0	13	0	0
21	4237466	.	T	A	4	12	16	0	0	16	0	0
21	4237496	.	C	T	2	5	7	0	5	12	0	0
21	4240010	.	A	G	5	13	18	0	0	18	0	0
21	4240016	.	A	G	5	13	18	0	0	18	0	0
21	4240121	.	T	C	5	2	7	0	0	7	0	0
21	4244348	.	T	A	13	13	26	0	0	26	0	0
21	4244377	.	C	G	14	14	28	0	1	29	0	0
21	4247684	.	A	G	3	8	11	0	0	11	0	0
21	4250360	.	T	C	9	5	14	0	0	14	0	0
21	4250401	.	C	T	8	5	13	0	1	14	0	0
21	4250583	.	C	A	5	3	8	0	0	8	0	0
21	4250596	.	C	T	0	4	4	0	4	8	0	0
21	4250634	.	G	A	2	3	5	0	0	5	0	0
21	4250642	.	T	A	2	2	4	0	0	4	0	0
21	4284196	.	C	T	2	4	6	0	0	6	0	0
21	4284222	.	G	A	2	5	7	0	0	7	0	0
21	4287853	.	G	A	0	4	4	0	7	11	0	0
21	4293557	.	C	A	5	5	10	0	0	10	0	0
21	4293620	.	C	T	3	4	7	0	0	7	0	0
21	4300254	.	T	C	6	9	15	0	0	15	0	0
21	4300257	.	T	C	6	8	14	0	0	14	0	0
21	4300290	.	G	A	5	6	11	0	2	13	0	0
21	4300308	.	G	A	5	8	13	0	0	13	0	0
21	4300413	.	A	G	6	2	8	0	0	8	0	0
21	4304262	.	A	G	4	4	8	0	0	8	0	0
21	4304471	.	T	C	4	3	7	0	0	7	0	0
21	4304489	.	A	T	3	4	7	0	1	8	0	0
21	4304725	.	G	A	0	9	9	0	4	13	0	0
21	4304744	.	T	C	3	5	8	0	0	8	0	0
21	4304875	.	T	A	4	7	11	0	0	11	0	0
21	4304912	.	A	T	4	4	8	0	0	8	0	0
21	4304913	.	C	T	4	4	8	0	0	8	0	0
21	4518181	.	A	T	1	4	5	0	0	5	0	0
21	4518209	.	A	G	1	0	1	0	4	5	0	0
21	4534248	.	A	C	2	5	7	0	0	7	0	0
21	4534374	.	A	G	2	3	5	0	1	6	0	0
21	4534865	.	T	A	2	4	6	0	0	6	0	0
21	4539862	.	T	A	3	3	6	0	0	6	0	0
21	4554316	.	C	T	2	2	4	0	0	4	0	0
21	4556490	.	C	T	2	3	5	0	0	5	0	0
21	4559567	.	C	T	2	4	6	0	0	6	0	0
21	4562238	.	G	C	1	4	5	0	0	5	0	0
21	4571398	.	T	C	2	12	14	0	1	15	0	0
21	4573597	.	A	G	2	5	7	0	0	7	0	0
21	4575674	.	T	C	1	2	3	0	0	3	0	0
21	4575688	.	C	T	1	2	3	0	0	3	0	0
21	4576310	.	G	C	2	7	9	0	0	9	0	0
21	4576319	.	G	C	0	8	8	0	2	10	0	0
21	4578122	.	G	A	3	10	13	0	1	14	0	0
21	4578137	.	G	A	0	9	9	0	3	12	0	0
21	4578352	.	G	T	0	4	4	0	4	8	0	0
21	4578428	.	C	A	5	7	12	0	0	12	0	0
21	4578520	.	T	C	8	3	11	0	0	11	0	0
21	4578892	.	T	C	4	6	10	0	0	10	0	0
21	4578907	.	T	C	5	3	8	0	0	8	0	0
21	4582249	.	T	C	7	3	10	0	0	10	0	0
21	4582270	.	T	A	7	5	12	0	0	12	0	0
21	4583663	.	A	G	1	0	1	0	9	10	0	0
21	4585012	.	A	C	3	13	16	0	0	16	0	0
21	4585027	.	A	G	4	0	4	0	9	13	0	0
21	4589826	.	A	G	2	7	9	0	1	10	0	0
21	4591407	.	C	G	6	9	15	0	3	18	0	0
21	4591410	.	A	T	6	11	17	0	1	18	0	0
21	4591443	.	A	G	6	5	11	0	1	12	0	0
21	4591502	.	A	G	1	0	1	0	4	5	0	0
21	4592959	.	T	C	4	5	9	0	0	9	0	0
21	4592984	.	A	G	4	5	9	0	0	9	0	0
21	4593008	.	A	T	4	6	10	0	0	10	0	0
21	4596883	.	G	T	8	21	29	0	1	30	0	0
21	4596970	.	A	G	5	6	11	0	0	11	0	0
21	4600889	.	A	G	10	0	10	0	10	20	0	0
21	4603372	.	C	T	6	17	23	0	0	23	0	0
21	4647939	.	C	T	4	4	8	0	0	8	0	0
21	4653403	.	C	T	5	4	9	0	1	10	0	0
21	4653578	.	A	G	6	4	10	0	0	10	0	0
21	4653590	.	T	C	5	4	9	0	0	9	0	0
21	4656793	.	A	T	3	3	6	0	1	7	0	0
21	4657681	.	A	C	6	2	8	0	0	8	0	0
21	4659003	.	T	C	2	2	4	0	1	5	0	0
21	4659650	.	A	C	1	0	1	0	3	4	0	0
21	4660756	.	C	T	0	6	6	0	6	12	0	0
21	4660804	.	G	C	1	2	3	0	2	5	0	0
21	4660849	.	C	T	3	3	6	0	0	6	0	0
21	4661022	.	G	C	4	4	8	0	0	8	0	0
21	4667092	.	C	T	5	4	9	0	0	9	0	0
21	4668144	.	T	C	4	2	6	0	0	6	0	0
21	4670307	.	T	C	3	0	3	0	2	5	0	0
21	4670308	.	T	G	3	2	5	0	0	5	0	0
21	4670376	.	G	A	2	3	5	0	0	5	0	0
21	4679623	.	T	C	7	6	13	0	0	13	0	0
21	4679703	.	C	G	1	4	5	0	0	5	0	0
21	4712743	.	A	G	2	2	4	0	0	4	0	0
21	4713252	.	T	C	14	0	14	0	12	26	0	0
21	4718518	.	G	A	10	10	20	0	2	22	0	0
21	4720325	.	C	T	8	14	22	0	1	23	0	0
21	4723670	.	G	A	12	10	22	0	0	22	0	0
21	4724351	.	C	T	0	7	7	0	5	12	0	0
21	4724428	.	A	G	7	14	21	0	1	22	0	0
21	4724564	.	G	A	12	11	23	0	0	23	0	0
21	4724810	.	T	C	4	9	13	0	1	14	0	0
21	4729876	.	G	A	7	14	21	0	0	21	0	0
21	4740850	.	A	G	7	8	15	0	0	15	0	0
21	4742721	.	A	G	6	6	12	0	1	13	0	0
21	4742793	.	G	A	4	7	11	0	0	11	0	0
21	4748802	.	G	C	2	12	14	0	0	14	0	0
21	4748841	.	A	G	5	10	15	0	1	16	0	0
21	5034442	.	T	C	3	1	4	0	8	12	0	0
21	5056600	.	T	C	4	0	4	0	4	8	0	0
21	5066371	.	A	G	9	7	16	0	1	17	0	0
21	5066417	.	T	C	7	0	7	0	10	17	0	0
21	5066425	.	T	C	8	0	8	0	7	15	0	0
21	5169217	.	T	A	21	13	34	0	2	36	0	0
21	5171036	.	C	T	25	33	58	0	2	60	0	0
21	5173402	.	T	G	27	1	28	0	28	56	0	0
21	5173447	.	C	T	30	23	53	0	3	56	0	0
21	5173638	.	T	C	24	24	48	0	1	49	0	0
21	5199875	.	G	A	37	25	62	0	1	63	0	0
21	5200683	.	C	T	31	28	59	0	2	61	0	0
21	5209585	.	A	G	14	0	14	0	17	31	0	0
21	5209666	.	C	T	15	18	33	0	0	33	0	0
21	5237137	.	G	A	15	11	26	0	0	26	0	0
21	5240259	.	C	T	13	16	29	0	0	29	0	0
21	5368346	.	G	A	5	6	11	0	0	11	0	0
21	5368417	.	C	T	0	7	7	0	5	12	0	0
21	5368461	.	C	T	1	7	8	0	9	17	0	0
21	5368510	.	C	T	0	7	7	0	9	16	0	0
21	5370451	.	T	A	9	4	13	0	2	15	0	0
21	5372598	.	G	A	3	9	12	0	0	12	0	0
21	5372643	.	T	C	6	5	11	0	0	11	0	0
21	5372673	.	G	A	6	4	10	0	0	10	0	0
21	5374209	.	C	T	1	4	5	0	7	12	0	0
21	5374528	.	T	C	4	9	13	0	0	13	0	0
21	5374788	.	G	A	3	5	8	0	0	8	0	0
21	5376720	.	A	C	4	4	8	0	0	8	0	0
21	5392941	.	T	A	7	6	13	0	1	14	0	0
21	5392963	.	G	T	7	5	12	0	0	12	0	0
21	5497933	.	C	G	1	3	4	0	0	4	0	0
21	5590041	.	A	T	4	6	10	0	0	10	0	0
21	5601792	.	C	G	2	5	7	0	0	7	0	0
21	5601835	.	C	T	4	2	6	0	0	6	0	0
21	5601941	.	C	T	7	5	12	0	0	12	0	0
21	5602006	.	A	G	7	0	7	0	5	12	0	0
21	5602507	.	C	A	2	2	4	0	0	4	0	0
21	5602619	.	G	A	0	9	9	0	3	12	0	0
21	5602646	.	C	T	3	4	7	0	0	7	0	0
21	5603057	.	C	T	3	2	5	0	0	5	0	0
21	5603151	.	C	A	2	5	7	0	0	7	0	0
21	5781134	.	C	T	31	29	60	0	6	66	0	0
21	5782043	.	T	C	36	5	41	0	41	82	0	0
21	5789938	.	G	A	31	41	72	0	1	73	0	0
21	5796060	.	T	C	29	33	62	1	2	65	0	0
21	5798978	.	T	A	30	23	53	0	1	54	0	0
21	5802878	.	A	G	4	4	8	0	1	9	0	0
21	5803474	.	C	T	11	11	22	0	1	23	0	0
21	5803495	.	T	C	11	7	18	0	5	23	0	0
21	5807177	.	A	C	8	6	14	0	2	16	0	0
21	5813676	.	C	T	3	7	10	0	0	10	0	0
21	5816717	.	T	A	1	2	3	0	0	3	0	0
21	5816792	.	G	A	3	4	7	0	0	7	0	0
21	5816912	.	T	C	2	0	2	0	7	9	0	0
21	5816950	.	A	G	4	2	6	0	0	6	0	0
21	5819927	.	C	T	0	3	3	0	3	6	0	0
21	5825465	.	C	A	0	3	3	0	3	6	0	0
21	5825468	.	C	T	0	2	2	0	4	6	0	0
21	5829215	.	C	T	0	2	2	0	1	3	0	0
21	5829875	.	G	A	3	3	6	0	0	6	0	0
21	5831364	.	G	T	2	3	5	0	0	5	0	0
21	5884836	.	G	A	3	22	25	0	34	59	0	0
21	5884897	.	T	A	32	21	53	0	1	54	0	0
21	5884945	.	G	A	21	17	38	0	0	38	0	0
21	5885071	.	T	G	1	3	4	0	0	4	0	0
21	5891274	.	G	T	5	4	9	0	1	10	0	0
21	5891343	.	G	A	2	4	6	0	0	6	0	0
21	5891394	.	C	T	3	5	8	0	0	8	0	0
21	5905143	.	T	C	4	14	18	0	0	18	0	0
21	5908772	.	T	C	5	3	8	0	0	8	0	0
21	5915055	.	C	T	3	9	12	0	1	13	0	0
21	5915707	.	G	A	0	9	9	0	4	13	0	0
21	5915813	.	T	G	6	12	18	0	0	18	0	0
21	5916374	.	A	T	6	6	12	0	0	12	0	0
21	5920348	.	G	C	3	8	11	0	0	11	0	0
21	5920426	.	C	T	18	6	24	0	0	24	0	0
21	5920586	.	A	C	17	6	23	8	0	31	0	0
21	5920604	.	T	C	16	8	24	6	1	31	0	0
21	5926856	.	A	G	1	2	3	0	0	3	0	0
21	5926913	.	A	T	1	3	4	0	0	4	0	0
21	5927236	.	T	C	1	4	5	0	0	5	0	0
21	5929144	.	A	G	4	0	4	0	4	8	0	0
21	5932610	.	C	T	2	4	6	0	0	6	0	0
21	5938364	.	T	C	1	2	3	0	0	3	0	0
21	5942661	.	G	T	8	5	13	0	0	13	0	0
21	5942868	.	T	G	8	10	18	0	1	19	0	0
21	5942906	.	C	A	9	8	17	0	2	19	0	0
21	5942927	.	C	T	6	9	15	0	0	15	0	0
21	5947841	.	G	A	5	4	9	0	1	10	0	0
21	5948087	.	G	A	5	2	7	0	0	7	0	0
21	5957793	.	G	A	2	3	5	0	0	5	0	0
21	5966657	.	G	A	0	3	3	0	7	10	0	0
21	5971630	.	C	A	18	0	18	0	0	18	0	0
21	5971638	.	C	A	14	4	18	0	1	19	0	0
21	5971839	.	A	T	5	8	13	0	1	14	0	0
21	5971949	.	A	T	13	9	22	0	0	22	0	0
21	5971983	.	C	T	16	11	27	0	0	27	0	0
21	5972087	.	G	T	2	10	12	0	11	23	0	0
21	5972092	.	T	C	10	9	19	0	0	19	0	0
21	5972252	.	A	G	12	5	17	0	0	17	0	0
21	5972543	.	C	T	6	2	8	0	0	8	0	0
21	5972631	.	T	A	2	2	4	0	0	4	0	0
21	5982357	.	A	G	1	3	4	0	0	4	0	0
21	6114465	.	C	A	1	4	5	0	0	5	0	0
21	6114776	.	G	T	2	4	6	0	0	6	0	0
21	6114810	.	A	C	3	2	5	0	1	6	0	0
21	6129133	.	A	G	1	0	1	0	3	4	0	0
21	6133407	.	G	A	1	2	3	0	1	4	0	0
21	6133434	.	G	A	0	3	3	0	3	6	0	0
21	6137579	.	C	T	9	12	21	0	0	21	0	0
21	6145991	.	G	A	11	12	23	0	0	23	0	0
21	6147499	.	C	T	12	11	23	0	3	26	0	0
21	6148091	.	G	A	1	13	14	0	11	25	0	0
21	6149938	.	T	C	14	18	32	0	0	32	0	0
21	6150113	.	T	A	8	3	11	0	1	12	0	0
21	6150504	.	A	G	2	0	2	0	2	4	0	0
21	6212959	.	C	T	6	9	15	0	0	15	0	0
21	6338245	.	A	G	7	0	7	0	8	15	0	0
21	6722285	.	C	A	0	2	2	0	2	4	0	0
21	6722290	.	C	A	1	0	1	0	1	2	0	0
21	7901070	.	T	G	0	0	0	0	4	4	0	0
21	7901072	.	T	G	0	0	0	0	4	4	0	0
21	11133630	.	A	G	5	2	7	0	0	7	0	0
21	11133633	.	A	G	3	0	3	0	2	5	0	0
21	11494536	.	A	G	16	0	16	0	53	69	0	0
21	11501975	.	A	G	24	26	50	1	2	53	0	0
21	11502056	.	A	G	44	23	67	0	2	69	0	0
21	11502143	.	A	G	10	52	62	0	0	62	0	0
21	11517232	.	T	A	4	2	6	0	0	6	0	0
21	13612494	.	T	C	7	0	7	0	4	11	0	0
21	13612502	.	T	C	5	0	5	0	4	9	0	0
21	13612803	.	T	C	4	2	6	0	0	6	0	0
21	13613001	.	T	C	6	3	9	0	0	9	0	0
21	13613038	.	T	C	3	3	6	0	0	6	0	0
21	13613250	.	T	C	2	3	5	0	0	5	0	0
21	13613255	.	T	C	4	2	6	0	0	6	0	0
21	13613479	.	T	C	3	2	5	0	0	5	0	0
21	17255773	.	C	T	1	13	14	0	0	14	0	0
21	19764727	.	T	A	10	4	14	0	0	14	0	0
21	20634252	.	A	G	4	0	4	0	7	11	0	0
21	20634263	.	A	G	4	5	9	0	1	10	0	0
21	22100149	.	G	A	14	5	19	0	6	26	1	0
21	22448151	.	T	G	4	5	9	0	2	11	0	0
21	22448380	.	C	G	5	6	11	0	1	12	0	0
21	22448445	.	A	T	2	4	6	0	0	6	0	0
21	22448808	.	A	G	3	5	8	0	0	8	0	0
21	22448961	.	C	T	7	9	16	0	0	16	0	0
21	22454381	.	T	C	4	3	7	0	0	7	0	0
21	22454396	.	A	G	5	4	9	0	0	9	0	0
21	22454715	.	G	A	5	3	8	0	1	9	0	0
21	22460206	.	C	T	8	6	14	0	0	14	0	0
21	22466319	.	T	C	2	3	5	0	0	5	0	0
21	22467239	.	C	T	1	6	7	0	1	8	0	0
21	22474446	.	C	T	3	5	8	0	0	8	0	0
21	22476263	.	A	G	4	4	8	0	0	8	0	0
21	22478246	.	C	G	2	6	8	0	0	8	0	0
21	22479385	.	T	C	3	4	7	0	0	7	0	0
21	22479463	.	T	C	1	4	5	0	0	5	0	0
21	22479621	.	A	G	1	4	5	0	0	5	0	0
21	22479711	.	A	G	3	3	6	0	0	6	0	0
21	22497259	.	C	T	2	4	6	0	1	7	0	0
21	22497303	.	T	C	3	4	7	0	0	7	0	0
21	22515676	.	G	T	2	2	4	0	0	4	0	0
21	22543603	.	T	C	1	2	3	0	0	3	0	0
21	22593525	.	G	A	1	2	3	0	0	3	0	0
21	22602205	.	T	A	1	2	3	0	0	3	0	0
21	22630324	.	C	T	4	5	9	0	0	9	0	0
21	22630712	.	T	A	2	7	9	0	0	9	0	0
21	22630864	.	G	A	11	7	18	0	0	19	1	0
21	22633734	.	A	G	16	11	27	0	0	27	0	0
21	22697107	.	C	T	4	4	8	0	1	9	0	0
21	22697161	.	T	C	8	8	16	0	0	16	0	0
21	22698790	.	T	C	9	7	16	0	1	17	0	0
21	22698809	.	C	T	7	10	17	0	1	18	0	0
21	22699471	.	T	C	3	7	10	0	0	10	0	0
21	22699491	.	T	C	3	11	14	0	0	14	0	0
21	22699512	.	T	C	5	10	15	0	0	15	0	0
21	22699556	.	A	G	8	7	15	0	0	15	0	0
21	22699563	.	C	T	7	6	13	0	0	13	0	0
21	22699595	.	C	A	4	9	13	0	1	14	0	0
21	22699608	.	T	C	4	8	12	0	0	12	0	0
21	22699853	.	G	T	0	5	5	0	8	13	0	0
21	22699916	.	G	A	2	9	11	0	0	11	0	0
21	22699956	.	T	G	3	3	6	0	0	6	0	0
21	22699986	.	T	A	4	4	8	0	0	8	0	0
21	22700015	.	A	G	3	1	4	0	6	10	0	0
21	22702551	.	A	C	8	6	14	0	3	17	0	0
21	22702804	.	C	T	8	10	18	0	0	18	0	0
21	22705087	.	C	T	5	3	8	0	1	9	0	0
21	22705203	.	C	T	3	4	7	0	0	7	0	0
21	22706396	.	G	T	1	2	3	0	0	3	0	0
21	22706822	.	A	C	1	3	4	0	0	4	0	0
21	22708876	.	C	A	0	9	9	0	4	13	0	0
21	22718008	.	A	T	3	3	6	0	0	6	0	0
21	22739074	.	G	A	1	3	4	0	0	4	0	0
21	22772230	.	T	C	2	4	6	0	0	6	0	0
21	22777182	.	T	C	4	3	7	0	0	7	0	0
21	22791122	.	T	C	8	5	13	0	0	13	0	0
21	22793229	.	A	G	3	0	3	0	4	7	0	0
21	22793238	.	A	G	4	4	8	0	0	8	0	0
21	22795009	.	T	C	3	3	6	0	2	8	0	0
21	22795107	.	G	A	2	6	8	0	6	14	0	0
21	22795593	.	C	G	3	3	6	0	0	6	0	0
21	22846973	.	C	T	16	14	30	0	0	30	0	0
21	22846986	.	T	C	15	18	33	0	0	33	0	0
21	22847022	.	A	T	11	16	27	0	0	27	0	0
21	22847136	.	C	T	17	18	35	0	1	36	0	0
21	22847163	.	A	G	14	16	30	0	4	34	0	0
21	22847174	.	G	C	13	21	34	0	2	36	0	0
21	22847207	.	A	G	22	14	36	0	2	38	0	0
21	22847284	.	A	G	31	2	33	0	19	52	0	0
21	22847750	.	C	T	22	21	43	0	9	52	0	0
21	22847969	.	C	T	23	29	52	0	2	54	0	0
21	22847984	.	A	T	23	27	50	0	3	53	0	0
21	22848011	.	G	A	23	23	46	0	2	48	0	0
21	22848047	.	C	T	25	18	43	0	0	43	0	0
21	22848173	.	C	T	15	16	31	0	0	31	0	0
21	22848403	.	T	C	10	20	30	0	3	33	0	0
21	22848424	.	C	T	11	24	35	0	1	36	0	0
21	22849817	.	A	C	16	23	39	2	4	45	0	0
21	22850949	.	G	A	24	12	36	0	0	36	0	0
21	22874664	.	A	G	1	2	3	0	0	3	0	0
21	22876417	.	A	G	4	2	6	0	1	7	0	0
21	22876955	.	A	G	2	0	2	0	4	6	0	0
21	22878844	.	A	C	5	6	11	0	0	11	0	0
21	22878856	.	G	A	9	8	17	0	0	17	0	0
21	22879338	.	C	A	7	7	14	0	0	14	0	0
21	22879458	.	A	G	8	0	8	0	6	14	0	0
21	22879559	.	A	C	6	14	20	0	1	21	0	0
21	22879733	.	G	C	0	9	9	0	9	18	0	0
21	22879824	.	A	C	7	8	15	0	1	16	0	0
21	22879909	.	C	A	6	9	15	0	0	15	0	0
21	22880016	.	A	T	12	7	19	0	2	21	0	0
21	22880079	.	C	T	11	9	20	0	2	22	0	0
21	22881408	.	A	G	16	7	23	0	1	24	0	0
21	22881477	.	G	C	10	10	20	0	0	21	1	0
21	22882138	.	T	C	12	11	23	0	0	23	0	0
21	22882354	.	G	T	12	4	16	0	1	17	0	0
21	22882587	.	A	C	9	10	19	0	1	20	0	0
21	22882761	.	C	T	11	10	21	0	0	21	0	0
21	22882801	.	G	T	11	4	15	0	1	16	0	0
21	22882818	.	A	G	8	0	8	0	4	12	0	0
21	22882866	.	T	C	6	11	17	0	0	17	0	0
21	22883182	.	C	T	5	14	19	0	0	19	0	0
21	22883363	.	T	C	6	13	19	0	1	20	0	0
21	22884361	.	T	C	14	14	28	0	0	28	0	0
21	22884412	.	C	T	21	11	32	0	1	33	0	0
21	22884556	.	G	A	1	11	12	0	14	26	0	0
21	22884661	.	T	C	18	14	32	0	1	33	0	0
21	22884769	.	C	T	19	18	37	0	0	37	0	0
21	22885083	.	G	T	20	15	35	0	1	36	0	0
21	22901119	.	G	A	3	3	6	0	0	6	0	0
21	22967106	.	A	G	8	5	13	0	1	14	0	0
21	22998064	.	G	A	2	4	6	0	0	6	0	0
21	23017038	.	A	G	1	2	3	0	0	3	0	0
21	23017210	.	G	C	2	6	8	0	0	8	0	0
21	23019589	.	T	G	6	6	12	0	0	12	0	0
21	23019679	.	C	A	19	18	37	0	1	38	0	0
21	23019836	.	T	G	16	16	32	0	0	32	0	0
21	23020095	.	A	C	18	20	38	0	0	38	0	0
21	23020126	.	A	G	18	17	35	0	3	38	0	0
21	23020440	.	A	T	23	15	38	0	1	39	0	0
21	23020523	.	T	C	19	1	20	1	16	37	0	0
21	23020558	.	C	T	2	18	20	1	17	38	0	0
21	23021145	.	C	A	13	14	27	0	1	28	0	0
21	23025233	.	G	A	14	12	26	0	1	27	0	0
21	23025349	.	G	A	13	20	33	0	4	37	0	0
21	23025352	.	C	G	5	18	23	0	14	37	0	0
21	23026978	.	C	T	1	21	22	0	12	34	0	0
21	23027017	.	C	T	14	23	37	0	1	38	0	0
21	23027023	.	A	T	21	13	34	0	7	41	0	0
21	23036534	.	G	A	10	4	14	0	0	14	0	0
21	23040529	.	C	T	2	3	5	0	2	7	0	0
21	23040577	.	A	G	7	8	15	0	2	17	0	0
21	23041283	.	G	A	8	7	15	0	0	15	0	0
21	23041602	.	T	A	6	6	12	0	0	12	0	0
21	23042616	.	C	T	0	3	3	0	6	9	0	0
21	23043466	.	A	G	5	3	8	0	0	8	0	0
21	23043777	.	G	A	3	3	6	0	0	6	0	0
21	23160558	.	T	G	4	7	11	0	0	11	0	0
21	23160689	.	T	A	12	3	15	0	0	15	0	0
21	23160851	.	A	T	10	17	27	0	1	28	0	0
21	23161651	.	C	A	13	4	17	1	1	19	0	0
21	23162023	.	C	T	15	11	26	1	1	28	0	0
21	23162127	.	A	T	13	15	28	0	3	31	0	0
21	23162395	.	T	G	9	8	17	0	2	19	0	0
21	23162618	.	C	A	14	7	21	0	0	21	0	0
21	23163534	.	T	C	19	0	19	0	9	28	0	0
21	23163564	.	T	A	18	8	26	0	0	26	0	0
21	23163841	.	A	T	13	7	20	0	2	22	0	0
21	23163884	.	A	G	14	8	22	0	0	22	0	0
21	23163885	.	A	G	12	8	20	0	1	21	0	0
21	23163938	.	G	T	19	7	26	0	2	28	0	0
21	23163990	.	A	T	23	10	33	0	0	33	0	0
21	23164090	.	C	T	4	3	7	0	0	7	0	0
21	23175440	.	C	T	12	14	26	0	2	28	0	0
21	23304314	.	G	A	6	7	13	0	1	14	0	0
21	23304539	.	T	A	6	8	14	0	0	14	0	0
21	23307764	.	T	A	8	6	14	0	0	14	0	0
21	23338168	.	A	G	12	11	23	0	1	24	0	0
21	23338241	.	G	A	7	12	19	0	0	19	0	0
21	23350240	.	A	G	15	17	32	0	2	34	0	0
21	23352629	.	A	G	17	16	33	0	0	33	0	0
21	23352707	.	A	G	9	13	22	0	0	22	0	0
21	23352749	.	G	A	5	13	18	0	0	18	0	0
21	23367200	.	C	T	23	19	42	0	2	44	0	0
21	23367218	.	T	G	19	21	40	0	0	40	0	0
21	23469825	.	T	C	23	1	24	0	10	34	0	0
21	23473213	.	G	A	11	23	34	0	1	35	0	0
21	23475195	.	G	A	10	14	24	0	1	25	0	0
21	23746912	.	G	T	7	6	13	0	1	14	0	0
21	24287537	.	C	T	21	12	33	0	0	33	0	0
21	24411429	.	C	G	21	19	40	0	1	41	0	0
21	24531725	.	A	T	4	6	10	0	0	10	0	0
21	24545622	.	A	G	7	11	18	0	0	18	0	0
21	24548355	.	A	G	5	8	13	0	0	13	0	0
21	24548563	.	G	A	9	5	14	0	0	14	0	0
21	24548695	.	C	T	0	12	12	0	8	20	0	0
21	24548716	.	C	T	7	12	19	0	3	22	0	0
21	24548838	.	A	C	8	1	9	0	10	19	0	0
21	24549545	.	C	T	3	5	8	0	0	8	0	0
21	24554450	.	C	T	3	6	9	0	0	9	0	0
21	24612536	.	G	A	1	4	5	0	0	5	0	0
21	24703356	.	G	A	1	2	3	0	0	3	0	0
21	24704025	.	T	C	4	0	4	0	9	13	0	0
21	24704235	.	A	G	4	2	6	0	0	6	0	0
21	24739576	.	T	C	2	0	2	0	3	5	0	0
21	24742000	.	C	T	0	2	2	0	2	4	0	0
21	24814953	.	G	A	1	2	3	0	0	3	0	0
21	25037431	.	G	T	0	4	4	0	3	7	0	0
21	25037521	.	G	A	1	2	3	0	5	8	0	0
21	25037557	.	C	A	5	3	8	0	1	9	0	0
21	25043381	.	T	A	1	4	5	0	0	5	0	0
21	25043681	.	C	T	4	3	7	0	1	8	0	0
21	25044153	.	A	T	4	3	7	0	0	7	0	0
21	25044196	.	C	T	6	7	13	0	0	13	0	0
21	25044523	.	G	A	0	4	4	0	5	9	0	0
21	25044532	.	C	A	6	3	9	0	0	9	0	0
21	25044848	.	C	G	5	6	11	0	0	11	0	0
21	25044876	.	A	T	6	3	9	0	1	10	0	0
21	25044885	.	G	C	6	4	10	0	0	10	0	0
21	25044968	.	G	A	2	5	7	0	4	11	0	0
21	25045470	.	C	A	6	3	9	0	1	10	0	0
21	25045517	.	C	T	5	4	9	0	1	10	0	0
21	25045521	.	T	C	5	3	8	0	1	9	0	0
21	25046210	.	G	C	4	3	7	0	0	7	0	0
21	25046840	.	C	T	2	6	8	0	0	8	0	0
21	25055553	.	T	C	8	8	16	0	1	17	0	0
21	25057140	.	G	A	0	7	7	0	8	15	0	0
21	25057217	.	G	T	10	10	20	0	1	21	0	0
21	25057544	.	G	A	5	5	10	0	0	10	0	0
21	25057547	.	A	G	5	4	9	0	2	11	0	0
21	25059752	.	G	A	0	8	8	0	8	16	0	0
21	25059941	.	G	A	3	9	12	0	1	13	0	0
21	25082995	.	G	A	4	4	8	0	1	9	0	0
21	25083046	.	C	T	4	6	10	0	0	10	0	0
21	25103457	.	G	A	12	16	28	0	1	29	0	0
21	25103676	.	T	A	21	13	34	0	2	36	0	0
21	25109986	.	A	G	13	16	29	0	0	29	0	0
21	25117588	.	A	G	12	12	24	0	2	26	0	0
21	25117626	.	A	G	13	0	13	0	11	24	0	0
21	25117777	.	T	G	18	11	29	0	0	29	0	0
21	25117959	.	G	A	12	15	27	0	0	27	0	0
21	25117974	.	A	C	18	14	32	0	0	32	0	0
21	25118065	.	G	A	11	11	22	0	1	23	0	0
21	25118108	.	T	C	7	8	15	0	2	17	0	0
21	25121405	.	G	A	4	2	6	0	0	6	0	0
21	25123257	.	G	T	1	5	6	0	5	11	0	0
21	25125110	.	C	T	2	2	4	0	0	4	0	0
21	25127461	.	T	C	1	2	3	0	0	3	0	0
21	25127542	.	G	A	3	4	7	0	1	8	0	0
21	25135777	.	A	G	10	0	10	0	2	12	0	0
21	25135789	.	C	T	10	4	14	0	0	14	0	0
21	25136093	.	T	C	4	4	8	0	0	8	0	0
21	25140596	.	A	G	3	7	10	0	0	10	0	0
21	25142536	.	T	A	9	7	16	0	1	17	0	0
21	25142635	.	A	G	7	9	16	1	1	18	0	0
21	25156379	.	C	T	3	10	13	0	0	13	0	0
21	25156487	.	C	A	2	8	10	0	0	10	0	0
21	25182091	.	C	A	14	12	26	0	1	27	0	0
21	25182207	.	A	T	14	8	22	0	0	22	0	0
21	25195376	.	G	A	1	2	3	0	0	3	0	0
21	25209223	.	G	A	8	3	11	0	0	11	0	0
21	25213423	.	G	A	1	5	6	0	0	6	0	0
21	25231265	.	T	A	10	13	23	0	1	24	0	0
21	25231269	.	T	G	11	0	11	0	14	25	0	0
21	25247236	.	C	T	0	5	5	0	2	7	0	0
21	25247240	.	C	T	0	5	5	0	1	6	0	0
21	25247533	.	T	C	10	0	10	0	7	17	0	0
21	25250497	.	C	T	2	8	10	0	6	16	0	0
21	25250632	.	G	C	4	0	4	0	5	9	0	0
21	25250836	.	G	A	3	2	5	0	1	6	0	0
21	25250986	.	G	A	11	9	20	0	1	21	0	0
21	25251013	.	G	A	13	8	21	0	0	21	0	0
21	25251034	.	G	T	12	8	20	0	0	20	0	0
21	25256907	.	C	T	7	5	12	0	0	12	0	0
21	25257059	.	T	C	6	4	10	0	0	10	0	0
21	25257086	.	C	T	6	4	10	0	1	11	0	0
21	25259454	.	A	G	3	3	6	0	0	6	0	0
21	25262612	.	A	G	7	4	11	0	1	12	0	0
21	25269469	.	C	T	2	3	5	0	0	5	0	0
21	25269653	.	G	A	1	2	3	0	0	3	0	0
21	25269836	.	G	A	1	1	2	0	0	2	0	0
21	25269844	.	C	G	0	2	2	0	1	3	0	0
21	25269895	.	G	A	2	1	3	0	1	4	0	0
21	25271522	.	T	A	2	2	4	0	1	5	0	0
21	25380894	.	G	T	4	4	8	0	0	8	0	0
21	25384076	.	T	C	22	17	39	1	1	41	0	0
21	25386752	.	T	C	29	20	49	0	1	50	0	0
21	25391290	.	C	A	25	25	50	0	2	52	0	0
21	25399339	.	T	G	7	8	15	0	1	16	0	0
21	25399423	.	C	A	15	4	19	0	0	19	0	0
21	25399909	.	T	G	15	18	33	0	3	36	0	0
21	25407216	.	C	G	18	29	47	0	2	49	0	0
21	25425204	.	T	C	1	2	3	0	0	3	0	0
21	25425773	.	C	A	11	4	15	0	3	18	0	0
21	25425798	.	T	C	2	11	13	0	1	14	0	0
21	25425826	.	G	T	11	5	16	0	2	18	0	0
21	25425848	.	C	A	1	13	14	0	8	22	0	0
21	25425873	.	A	T	14	10	24	0	1	25	0	0
21	25439974	.	T	A	1	2	3	0	11	14	0	0
21	25440049	.	G	A	24	12	36	0	1	37	0	0
21	25449464	.	G	A	23	18	41	0	1	42	0	0
21	25450846	.	G	A	16	18	34	0	0	34	0	0
21	25451002	.	A	G	8	14	22	0	0	22	0	0
21	25452558	.	G	A	14	15	29	0	3	32	0	0
21	25458902	.	T	A	15	10	25	1	0	26	0	0
21	25460713	.	G	A	20	15	35	0	3	38	0	0
21	25460734	.	G	A	25	15	40	0	1	41	0	0
21	25463338	.	A	G	15	20	35	0	0	35	0	0
21	25476597	.	G	A	16	18	34	0	1	35	0	0
21	25492981	.	C	T	12	7	19	0	2	21	0	0
21	25522674	.	C	T	0	10	10	0	11	21	0	0
21	25533882	.	G	A	6	5	11	0	0	11	0	0
21	25534003	.	C	T	3	5	8	0	0	8	0	0
21	25536182	.	G	A	5	4	9	0	0	9	0	0
21	25538219	.	A	C	3	8	11	0	0	11	0	0
21	25538237	.	G	A	0	9	9	0	3	12	0	0
21	25540822	.	C	A	5	8	13	0	0	13	0	0
21	25540846	.	A	C	5	5	10	0	1	11	0	0
21	25540900	.	G	A	4	3	7	0	1	8	0	0
21	25541272	.	A	G	3	3	6	0	1	7	0	0
21	25541473	.	C	T	5	10	15	0	0	15	0	0
21	25541704	.	T	C	8	4	12	0	0	12	0	0
21	25541893	.	A	G	3	6	9	0	0	9	0	0
21	25541902	.	C	T	3	5	8	0	0	8	0	0
21	25542356	.	C	A	7	3	10	0	0	10	0	0
21	25542966	.	G	T	3	6	9	0	0	9	0	0
21	25543284	.	C	A	0	2	2	0	1	3	0	0
21	25543286	.	T	C	1	3	4	0	0	4	0	0
21	25561362	.	G	A	1	2	3	0	1	4	0	0
21	25561388	.	C	A	5	6	11	0	0	11	0	0
21	25561775	.	T	C	20	0	20	0	28	48	0	0
21	25565215	.	T	C	11	0	11	0	16	27	0	0
21	25565268	.	C	T	19	11	30	0	2	32	0	0
21	25570042	.	A	G	19	14	33	0	0	33	0	0
21	25570275	.	G	C	11	15	26	0	2	28	0	0
21	25570416	.	C	G	1	15	16	0	12	28	0	0
21	25571377	.	A	G	11	4	15	0	0	15	0	0
21	25571392	.	G	A	10	4	14	0	1	15	0	0
21	25571436	.	T	A	7	9	16	0	1	17	0	0
21	25571446	.	G	A	9	10	19	0	1	20	0	0
21	25571488	.	T	A	14	5	19	0	1	20	0	0
21	25571919	.	T	C	11	6	17	0	0	17	0	0
21	25572145	.	C	T	6	5	11	0	2	13	0	0
21	25572156	.	C	T	1	5	6	0	7	13	0	0
21	25572785	.	G	T	5	4	9	0	0	9	0	0
21	25572930	.	C	T	1	4	5	0	9	14	0	0
21	25605525	.	G	C	6	2	8	0	0	8	0	0
21	25605551	.	A	G	6	2	8	0	1	9	0	0
21	25605571	.	T	A	6	1	7	0	0	7	0	0
21	25606796	.	C	T	11	5	16	0	2	18	0	0
21	25606819	.	C	G	1	5	6	0	11	17	0	0
21	25611659	.	A	G	15	4	19	0	0	19	0	0
21	25612938	.	C	T	0	2	2	0	8	10	0	0
21	25620446	.	T	C	5	3	8	0	0	8	0	0
21	25620573	.	A	G	3	2	5	0	1	6	0	0
21	25645217	.	A	C	15	7	22	0	0	22	0	0
21	25645555	.	T	G	19	18	37	0	0	37	0	0
21	25645655	.	G	C	13	17	30	0	2	32	0	0
21	25663378	.	T	A	1	2	3	0	0	3	0	0
21	25670078	.	G	A	1	2	3	0	1	4	0	0
21	25676323	.	G	A	3	3	6	0	0	6	0	0
21	25677015	.	T	G	6	3	9	0	0	9	0	0
21	25713908	.	T	C	9	8	17	0	0	17	0	0
21	25722719	.	C	T	10	12	22	0	0	22	0	0
21	25796628	.	G	T	1	2	3	0	0	3	0	0
21	25811263	.	C	T	6	5	11	0	0	11	0	0
21	25816780	.	G	A	1	3	4	0	1	5	0	0
21	25817159	.	A	G	1	6	7	0	3	10	0	0
21	25817162	.	A	G	1	0	1	0	8	9	0	0
21	25817741	.	A	G	4	4	8	0	0	8	0	0
21	25817842	.	A	G	3	4	7	0	2	9	0	0
21	25818170	.	G	C	6	6	12	0	0	12	0	0
21	25936329	.	A	C	3	5	8	0	2	10	0	0
21	25936341	.	G	A	0	6	6	0	4	10	0	0
21	25968253	.	C	T	8	4	12	0	0	12	0	0
21	26022126	.	G	A	7	2	9	0	0	9	0	0
21	26022127	.	A	T	5	2	7	0	1	8	0	0
21	26022992	.	C	T	3	2	5	0	4	9	0	0
21	26023146	.	G	A	3	9	12	0	1	13	0	0
21	26023147	.	T	A	4	9	13	0	0	13	0	0
21	26023209	.	G	A	6	5	11	0	1	12	0	0
21	26023231	.	G	A	4	6	10	0	1	11	0	0
21	26029021	.	T	C	8	10	18	0	1	19	0	0
21	26030687	.	T	C	6	8	14	0	1	15	0	0
21	26033800	.	C	T	10	5	15	0	0	15	0	0
21	26041741	.	C	T	2	9	11	0	1	12	0	0
21	26043333	.	A	G	12	6	18	0	1	19	0	0
21	26050097	.	C	T	5	10	15	0	0	15	0	0
21	26050115	.	C	T	8	12	20	0	0	20	0	0
21	26050415	.	T	G	12	8	20	0	0	20	0	0
21	26053710	.	T	G	15	0	15	0	16	31	0	0
21	26053929	.	C	A	17	20	37	0	0	37	0	0
21	26054453	.	A	G	19	0	19	0	22	41	0	0
21	26057490	.	T	A	10	11	21	0	0	21	0	0
21	26057707	.	C	T	8	11	19	0	7	26	0	0
21	26057864	.	T	A	11	5	16	0	1	18	1	0
21	26058121	.	C	T	9	9	18	0	1	19	0	0
21	26058275	.	G	T	10	15	25	0	1	26	0	0
21	26058378	.	C	T	11	5	16	0	1	17	0	0
21	26058386	.	C	A	9	5	14	0	1	15	0	0
21	26080402	.	A	G	10	10	20	0	1	21	0	0
21	26080633	.	G	C	10	7	17	0	2	19	0	0
21	26389462	.	C	T	29	15	44	0	1	45	0	0
21	26390614	.	G	A	18	13	31	0	1	32	0	0
21	26390620	.	A	G	19	12	31	0	0	31	0	0
21	26391964	.	T	A	5	8	13	0	0	13	0	0
21	26408340	.	A	C	10	0	10	0	10	20	0	0
21	26415195	.	C	T	13	11	24	0	0	24	0	0
21	26417389	.	A	T	7	16	23	0	1	24	0	0
21	26417854	.	A	T	8	13	21	0	1	22	0	0
21	26426274	.	C	A	0	5	5	0	9	14	0	0
21	26429227	.	G	A	10	7	17	0	1	18	0	0
21	26433160	.	T	C	4	5	9	0	1	10	0	0
21	26438785	.	C	T	3	3	6	0	0	6	0	0
21	26438854	.	T	C	4	6	10	0	0	10	0	0
21	26441889	.	A	G	7	9	16	0	0	16	0	0
21	26441904	.	C	T	7	10	17	0	0	17	0	0
21	26482972	.	A	T	6	5	11	0	1	12	0	0
21	26483092	.	A	G	5	8	13	0	0	13	0	0
21	26522682	.	G	A	17	15	32	0	1	33	0	0
21	26523233	.	C	T	10	18	28	0	1	29	0	0
21	26523454	.	A	T	13	15	28	0	1	29	0	0
21	26525311	.	C	T	9	7	16	0	0	16	0	0
21	26527782	.	G	A	1	13	14	0	11	25	0	0
21	26527808	.	A	G	15	10	25	0	0	25	0	0
21	26530332	.	G	A	1	7	8	0	12	20	0	0
21	26530663	.	T	A	8	8	16	0	0	16	0	0
21	26530737	.	G	C	9	17	26	0	0	26	0	0
21	26531014	.	G	A	11	11	22	0	1	23	0	0
21	26545469	.	C	T	10	5	15	0	0	15	0	0
21	26545622	.	T	A	7	9	16	0	0	16	0	0
21	26607004	.	T	G	7	5	12	0	1	13	0	0
21	26634042	.	C	T	14	15	29	0	1	30	0	0
21	26657476	.	C	T	24	34	58	0	3	61	0	0
21	26657484	.	C	A	33	27	60	0	0	60	0	0
21	26660055	.	G	A	2	31	33	0	21	54	0	0
21	26662745	.	G	A	31	23	54	0	2	56	0	0
21	26664824	.	G	A	7	3	10	0	0	10	0	0
21	26665092	.	C	T	2	6	8	0	4	12	0	0
21	26665141	.	A	G	4	6	10	0	0	10	0	0
21	26668855	.	T	C	5	4	9	0	0	9	0	0
21	26669068	.	A	T	3	2	5	0	0	5	0	0
21	26669386	.	C	G	6	5	11	0	1	12	0	0
21	26669394	.	C	T	5	6	11	0	1	12	0	0
21	26669421	.	T	C	7	7	14	0	1	15	0	0
21	26669480	.	C	A	9	6	15	0	1	16	0	0
21	26669495	.	G	A	6	5	11	0	0	11	0	0
21	26670145	.	T	C	12	0	12	1	8	21	0	0
21	26670306	.	T	A	8	7	15	0	0	15	0	0
21	26670858	.	G	A	4	4	8	0	0	8	0	0
21	26670860	.	C	A	4	3	7	0	1	8	0	0
21	26670900	.	C	T	4	9	13	0	0	13	0	0
21	26671390	.	G	A	2	1	3	0	2	5	0	0
21	26672014	.	G	A	7	6	13	0	1	14	0	0
21	26672160	.	C	T	3	4	7	0	0	7	0	0
21	26672184	.	C	T	0	4	4	0	5	9	0	0
21	26672217	.	G	C	10	5	15	0	0	15	0	0
21	26672270	.	T	C	7	5	12	0	0	12	0	0
21	26672293	.	A	G	3	6	9	0	0	9	0	0
21	26672373	.	T	C	7	4	11	0	0	11	0	0
21	26672611	.	G	A	7	9	16	0	0	16	0	0
21	26675073	.	T	C	2	2	4	0	0	4	0	0
21	26675240	.	C	T	0	5	5	0	6	11	0	0
21	26675363	.	T	C	3	0	3	0	7	10	0	0
21	26678649	.	C	T	9	5	14	0	0	14	0	0
21	26678650	.	C	T	8	5	13	0	0	13	0	0
21	26678838	.	C	A	4	4	8	0	0	8	0	0
21	26678965	.	C	T	1	10	11	0	8	19	0	0
21	26679023	.	T	C	11	5	16	0	1	17	0	0
21	26689875	.	T	A	9	6	15	0	0	15	0	0
21	26689934	.	A	T	7	13	20	0	0	20	0	0
21	26690151	.	T	A	3	19	22	0	0	22	0	0
21	26691889	.	T	C	8	17	25	0	0	25	0	0
21	26691898	.	A	T	8	16	24	0	0	24	0	0
21	26697686	.	G	C	46	19	65	2	1	68	0	0
21	26706581	.	C	A	38	21	59	0	0	59	0	0
21	26706583	.	G	A	37	21	58	0	1	59	0	0
21	26706646	.	C	G	27	20	47	0	2	49	0	0
21	26706662	.	T	A	27	23	50	0	1	53	2	0
21	26706846	.	T	A	25	20	45	0	0	45	0	0
21	26710071	.	A	G	11	15	26	0	0	26	0	0
21	26710194	.	T	A	23	13	36	0	1	37	0	0
21	26710239	.	G	A	25	10	35	0	1	36	0	0
21	26710496	.	C	A	32	22	54	0	1	55	0	0
21	26710514	.	A	G	31	17	48	0	2	50	0	0
21	26714361	.	C	T	1	25	26	0	16	42	0	0
21	26714373	.	C	A	20	23	43	0	2	45	0	0
21	26721385	.	C	A	5	3	8	0	0	8	0	0
21	26721400	.	G	A	2	10	12	0	7	19	0	0
21	26722269	.	C	T	13	22	35	0	1	36	0	0
21	26722347	.	G	A	7	24	31	0	1	32	0	0
21	26722431	.	T	C	13	10	23	0	0	23	0	0
21	26722625	.	C	T	18	12	30	0	0	30	0	0
21	26722688	.	T	A	11	12	23	0	1	24	0	0
21	26724649	.	A	G	14	17	31	0	3	34	0	0
21	26724833	.	A	G	20	19	39	0	2	41	0	0
21	26725247	.	C	T	13	20	33	0	1	34	0	0
21	26731344	.	G	A	40	21	61	0	1	62	0	0
21	26731364	.	T	A	35	24	59	0	0	60	1	0
21	26731765	.	C	T	35	38	73	0	4	77	0	0
21	26731925	.	C	A	29	25	54	2	6	62	0	0
21	26733416	.	C	T	14	10	24	0	0	24	0	0
21	26733455	.	G	T	8	11	19	0	0	19	0	0
21	26733489	.	G	A	8	5	13	0	0	13	0	0
21	26733517	.	A	G	6	7	13	0	1	14	0	0
21	26748198	.	A	G	10	7	17	0	0	17	0	0
21	26750549	.	G	A	6	5	11	0	1	12	0	0
21	26753714	.	G	A	7	7	14	0	2	16	0	0
21	26760073	.	G	A	1	9	10	0	8	18	0	0
21	26787786	.	T	C	6	11	17	0	0	17	0	0
21	26909169	.	C	T	8	12	20	0	0	20	0	0
21	26909177	.	C	T	6	9	15	0	1	16	0	0
21	26909228	.	A	G	9	11	20	0	1	21	0	0
21	26909425	.	C	G	15	7	22	0	0	22	0	0
21	26909560	.	A	C	13	0	13	0	10	23	0	0
21	26914870	.	T	G	5	10	15	0	1	16	0	0
21	26914915	.	T	G	10	18	28	0	0	28	0	0
21	26915086	.	G	A	14	9	23	0	0	23	0	0
21	26915203	.	A	G	8	10	18	0	0	18	0	0
21	26915355	.	G	A	9	7	16	0	0	16	0	0
21	26916142	.	A	G	5	5	10	0	0	10	0	0
21	26916238	.	C	T	1	12	13	1	10	24	0	0
21	26918601	.	C	T	7	19	26	0	0	26	0	0
21	26918684	.	G	A	8	8	16	0	0	16	0	0
21	26918703	.	A	G	10	11	21	0	0	21	0	0
21	26918726	.	G	A	8	13	21	0	1	22	0	0
21	26918762	.	C	A	7	11	18	1	0	19	0	0
21	26918767	.	G	A	9	11	20	1	0	21	0	0
21	26918892	.	A	G	5	5	10	0	0	10	0	0
21	26918898	.	G	A	3	4	7	0	0	7	0	0
21	26927201	.	C	A	14	10	24	0	1	25	0	0
21	26927255	.	T	C	6	13	19	0	0	19	0	0
21	26934419	.	G	A	14	12	26	0	0	26	0	0
21	26934888	.	C	T	14	11	25	0	2	27	0	0
21	26954405	.	G	A	8	8	16	0	1	17	0	0
21	26954430	.	T	C	7	12	19	0	2	21	0	0
21	26961015	.	A	T	12	15	27	0	3	30	0	0
21	26961084	.	A	G	18	14	32	0	2	34	0	0
21	26965918	.	A	T	15	22	37	0	1	38	0	0
21	26966025	.	T	C	10	8	18	0	0	18	0	0
21	26966047	.	A	T	13	6	19	0	0	19	0	0
21	26966079	.	A	G	15	0	15	0	9	24	0	0
21	26966088	.	A	T	11	9	20	0	0	20	0	0
21	26966287	.	G	A	1	14	15	0	13	28	0	0
21	26966315	.	G	A	7	10	17	0	2	19	0	0
21	26966681	.	A	G	5	0	5	0	18	23	0	0
21	26967230	.	C	T	11	13	24	0	2	26	0	0
21	26967265	.	T	A	10	8	18	0	0	18	0	0
21	26967551	.	A	T	11	21	32	0	0	32	0	0
21	26967906	.	T	G	30	20	50	0	1	51	0	0
21	26968042	.	G	A	21	15	36	0	1	37	0	0
21	26968344	.	G	A	14	10	24	0	2	26	0	0
21	26968499	.	T	G	8	10	18	0	2	20	0	0
21	26995869	.	G	A	4	6	10	0	0	10	0	0
21	26996849	.	C	A	2	19	21	0	28	49	0	0
21	26996893	.	T	C	24	2	26	0	19	45	0	0
21	27010406	.	T	A	18	15	33	0	1	35	1	0
21	27047839	.	A	T	25	20	45	0	1	47	1	0
21	27047955	.	G	A	20	17	37	0	3	40	0	0
21	27048320	.	C	A	9	12	21	0	1	22	0	0
21	27048423	.	G	T	14	11	25	0	1	26	0	0
21	27048534	.	G	A	19	11	30	0	0	30	0	0
21	27053061	.	G	A	11	4	15	0	1	16	0	0
21	27061097	.	C	T	15	14	29	0	0	29	0	0
21	27119735	.	T	A	12	17	29	0	1	30	0	0
21	27121852	.	G	A	8	11	19	0	0	19	0	0
21	27122362	.	G	A	13	16	29	0	1	30	0	0
21	27122596	.	A	G	4	10	14	0	1	15	0	0
21	27122620	.	C	T	6	9	15	0	0	15	0	0
21	27122908	.	C	G	0	12	12	0	9	21	0	0
21	27122980	.	C	T	2	9	11	0	5	16	0	0
21	27123024	.	T	C	8	0	8	0	16	24	0	0
21	27123089	.	G	A	8	13	21	0	1	22	0	0
21	27185479	.	T	G	11	11	22	0	4	26	0	0
21	27185545	.	A	G	11	11	22	0	1	23	0	0
21	27189802	.	G	A	0	9	9	0	14	23	0	0
21	27190038	.	G	C	8	11	19	0	0	19	0	0
21	27198405	.	C	T	9	15	24	0	1	25	0	0
21	27198592	.	T	C	4	6	10	0	1	11	0	0
21	27198628	.	T	G	3	3	6	0	1	7	0	0
21	27199893	.	G	A	6	31	37	0	0	37	0	0
21	27204648	.	C	T	5	6	11	0	0	11	0	0
21	27204669	.	T	C	6	0	6	0	4	10	0	0
21	27204713	.	T	A	16	10	26	0	0	26	0	0
21	27204747	.	C	T	22	19	41	0	0	41	0	0
21	27204942	.	G	A	15	14	29	0	0	29	0	0
21	27204957	.	G	A	9	16	25	0	2	27	0	0
21	27205050	.	G	A	17	13	30	0	0	30	0	0
21	27213209	.	A	T	10	20	30	0	0	30	0	0
21	27213287	.	T	A	10	23	33	0	1	34	0	0
21	27221206	.	G	A	13	14	27	0	3	30	0	0
21	27233048	.	C	T	6	7	13	0	0	13	0	0
21	27283782	.	G	A	5	6	11	0	0	11	0	0
21	27302868	.	A	G	13	0	13	0	18	31	0	0
21	27302943	.	C	A	18	16	34	0	2	36	0	0
21	27305739	.	T	G	16	15	31	0	0	31	0	0
21	27305972	.	A	G	19	1	20	0	20	40	0	0
21	27306203	.	C	T	18	20	38	0	1	39	0	0
21	27308671	.	C	T	26	20	46	0	0	47	1	0
21	27311230	.	C	T	18	18	36	0	1	37	0	0
21	27311450	.	C	T	17	17	34	0	1	35	0	0
21	27312950	.	C	T	17	26	43	0	1	44	0	0
21	27312962	.	G	A	24	20	44	0	2	46	0	0
21	27318274	.	G	T	25	15	40	0	0	40	0	0
21	27327792	.	T	A	1	3	4	0	0	4	0	0
21	27327836	.	C	T	1	3	4	0	0	4	0	0
21	27327875	.	A	C	2	3	5	0	0	5	0	0
21	27327904	.	T	C	3	4	7	0	0	7	0	0
21	27328015	.	T	C	0	0	0	0	2	2	0	0
21	27328018	.	C	T	0	2	2	0	1	3	0	0
21	27331819	.	A	T	1	2	3	0	0	3	0	0
21	27331823	.	A	T	1	2	3	0	0	3	0	0
21	27331984	.	G	A	1	2	3	0	1	4	0	0
21	27332720	.	T	C	2	2	4	0	0	4	0	0
21	27332893	.	A	G	2	2	4	0	0	4	0	0
21	27333282	.	G	A	1	2	3	0	0	3	0	0
21	27336613	.	C	T	0	3	3	0	1	4	0	0
21	27336615	.	T	C	1	3	4	0	0	4	0	0
21	27341211	.	G	A	6	7	13	0	0	13	0	0
21	27341444	.	C	T	2	9	11	0	0	11	0	0
21	27341453	.	G	A	0	2	2	0	10	12	0	0
21	27343611	.	C	T	6	12	18	0	0	18	0	0
21	27343637	.	T	C	9	9	18	0	0	18	0	0
21	27343814	.	G	A	1	6	7	0	11	18	0	0
21	27344065	.	A	G	5	6	11	0	0	11	0	0
21	27344125	.	T	C	5	6	11	0	1	12	0	0
21	27346260	.	T	C	3	5	8	0	0	8	0	0
21	27347994	.	C	T	4	12	16	0	0	16	0	0
21	27348033	.	A	C	6	6	12	0	2	14	0	0
21	27351316	.	T	C	10	14	24	0	0	24	0	0
21	27354112	.	A	G	14	10	24	0	0	24	0	0
21	27354142	.	C	A	13	7	20	0	1	21	0	0
21	27354147	.	T	C	14	7	21	0	1	22	0	0
21	27354434	.	C	A	7	11	18	0	0	18	0	0
21	27354505	.	T	C	9	9	18	0	0	18	0	0
21	27354602	.	G	T	4	3	7	0	0	7	0	0
21	27354621	.	T	G	1	2	3	0	1	4	0	0
21	27356981	.	G	A	1	2	3	0	1	4	0	0
21	27357019	.	T	C	1	2	3	0	1	4	0	0
21	27357530	.	C	T	2	3	5	0	0	5	0	0
21	27358941	.	C	T	1	2	3	0	0	3	0	0
21	27359016	.	G	C	1	1	2	0	2	4	0	0
21	27362764	.	C	G	2	2	4	0	0	4	0	0
21	27375247	.	C	T	10	12	22	0	4	26	0	0
21	27377354	.	C	A	24	12	36	0	5	41	0	0
21	27377815	.	G	A	0	7	7	0	3	10	0	0
21	27378011	.	A	C	12	7	19	0	0	19	0	0
21	27378269	.	T	A	7	7	14	0	0	14	0	0
21	27378388	.	T	G	8	9	17	0	0	17	0	0
21	27378607	.	T	A	8	8	16	0	1	17	0	0
21	27378663	.	G	A	1	7	8	0	3	11	0	0
21	27408467	.	G	C	1	2	3	0	0	3	0	0
21	27472129	.	C	T	1	2	3	0	0	3	0	0
21	27482324	.	G	A	10	3	13	0	0	13	0	0
21	27488954	.	A	G	1	2	3	0	1	4	0	0
21	27514002	.	T	A	10	2	12	0	3	16	1	0
21	27514139	.	T	G	6	0	6	0	5	11	0	0
21	27523079	.	T	C	9	4	13	0	0	13	0	0
21	27526405	.	C	T	7	11	18	0	0	18	0	0
21	27530414	.	C	A	5	8	13	0	2	15	0	0
21	27536026	.	G	A	0	13	13	0	5	18	0	0
21	27549702	.	G	T	11	5	16	0	0	16	0	0
21	27552349	.	A	G	9	0	9	0	11	20	0	0
21	27552667	.	A	G	11	0	11	0	11	22	0	0
21	27552699	.	C	G	14	12	26	0	0	26	0	0
21	27554837	.	T	C	11	7	18	0	0	18	0	0
21	27554858	.	C	T	11	10	21	0	2	23	0	0
21	27554904	.	A	G	14	9	23	0	0	23	0	0
21	27554939	.	G	C	10	11	21	0	1	22	0	0
21	27554986	.	C	T	7	7	14	0	1	15	0	0
21	27555051	.	G	T	12	4	16	0	0	16	0	0
21	27581311	.	G	A	1	5	6	0	0	6	0	0
21	27586558	.	C	T	4	2	6	0	0	6	0	0
21	27602975	.	C	T	0	5	5	0	4	9	0	0
21	27603396	.	C	T	4	2	6	0	0	6	0	0
21	27606744	.	G	A	1	5	6	0	1	7	0	0
21	27606765	.	G	A	4	4	8	0	1	9	0	0
21	27611818	.	T	C	3	6	9	0	0	9	0	0
21	27611821	.	A	C	3	0	3	0	6	9	0	0
21	27614231	.	A	G	6	2	8	0	0	8	0	0
21	27614423	.	T	G	1	2	3	0	0	3	0	0
21	27636438	.	C	T	20	21	41	0	2	43	0	0
21	27636664	.	C	T	1	15	16	3	24	43	0	0
21	27636733	.	C	A	16	25	41	0	1	43	1	0
21	27636739	.	G	A	15	25	40	0	2	42	0	0
21	27636867	.	C	T	15	13	28	0	0	28	0	0
21	27637534	.	C	T	12	21	33	0	2	35	0	0
21	27637912	.	G	A	19	32	51	0	6	57	0	0
21	27637951	.	A	G	32	23	55	0	2	57	0	0
21	27637993	.	G	A	26	25	51	0	2	53	0	0
21	27638260	.	A	G	19	21	40	0	2	42	0	0
21	27657331	.	T	A	27	18	45	0	3	48	0	0
21	27657475	.	A	G	22	22	44	0	4	48	0	0
21	27880547	.	G	A	11	14	25	0	0	25	0	0
21	27880607	.	C	T	2	13	15	0	10	25	0	0
21	27881043	.	G	C	13	0	13	0	13	26	0	0
21	27881449	.	A	G	8	5	13	0	0	13	0	0
21	27881474	.	C	T	11	4	15	0	2	17	0	0
21	27881577	.	A	G	9	10	19	0	3	22	0	0
21	27881609	.	C	T	2	14	16	0	5	21	0	0
21	27881729	.	C	T	1	15	16	0	12	28	0	0
21	28051119	.	A	G	7	6	13	0	0	13	0	0
21	28051224	.	G	T	6	8	14	0	0	14	0	0
21	28051332	.	C	T	8	8	16	0	0	16	0	0
21	28076575	.	A	G	13	8	21	0	0	21	0	0
21	28076668	.	G	A	16	6	22	0	1	23	0	0
21	28076770	.	T	C	9	10	19	0	0	19	0	0
21	28076821	.	A	G	11	11	22	0	0	22	0	0
21	28078711	.	G	T	7	2	9	0	2	11	0	0
21	28078826	.	A	G	4	12	16	0	2	18	0	0
21	28078907	.	T	C	5	8	13	0	1	14	0	0
21	28082587	.	T	G	4	5	9	0	0	9	0	0
21	28089641	.	G	T	7	9	16	0	0	16	0	0
21	28235200	.	A	G	10	5	15	0	0	15	0	0
21	28235371	.	A	G	6	7	13	0	0	13	0	0
21	28235605	.	C	T	8	7	15	0	2	17	0	0
21	28235740	.	G	T	6	2	8	0	0	8	0	0
21	28493772	.	C	T	1	4	5	0	0	5	0	0
21	28496276	.	T	C	27	18	45	0	0	45	0	0
21	28496332	.	C	T	34	36	70	0	1	71	0	0
21	28500561	.	C	T	40	22	62	0	1	63	0	0
21	28502369	.	G	A	10	7	17	0	0	17	0	0
21	28510226	.	C	T	14	20	34	0	2	36	0	0
21	28510258	.	A	G	16	20	36	0	3	39	0	0
21	28512800	.	G	T	7	9	16	0	1	17	0	0
21	28555214	.	G	T	3	4	7	0	0	7	0	0
21	28564947	.	T	C	2	0	2	0	4	6	0	0
21	28567343	.	G	A	7	3	10	0	0	10	0	0
21	28636721	.	C	A	5	2	7	0	0	7	0	0
21	28724148	.	C	T	12	17	29	0	0	29	0	0
21	28793352	.	C	T	1	2	3	0	0	3	0	0
21	28793354	.	C	T	1	2	3	0	0	3	0	0
21	28793800	.	A	C	2	2	4	0	0	4	0	0
21	28863254	.	A	G	9	5	14	0	1	15	0	0
21	28863810	.	A	G	13	9	22	0	0	22	0	0
21	28863858	.	C	A	11	3	14	0	0	14	0	0
21	28863884	.	G	A	3	4	7	0	0	7	0	0
21	28864246	.	G	A	19	5	24	0	2	26	0	0
21	28864475	.	C	T	2	17	19	0	23	42	0	0
21	28901022	.	C	A	1	14	15	0	26	41	0	0
21	28901037	.	G	A	22	16	38	0	0	38	0	0
21	28901078	.	T	C	22	13	35	0	1	36	0	0
21	28920111	.	C	T	0	12	12	0	12	24	0	0
21	29039214	.	C	A	20	25	45	0	2	47	0	0
21	29059819	.	G	A	4	22	26	0	26	52	0	0
21	29062843	.	G	A	1	17	18	0	25	43	0	0
21	29064692	.	T	C	24	18	42	0	2	44	0	0
21	29074438	.	C	G	24	26	50	0	2	52	0	0
21	29074439	.	T	C	24	26	50	0	2	52	0	0
21	29074492	.	A	T	22	26	48	0	5	53	0	0
21	29075234	.	T	G	10	4	14	0	0	14	0	0
21	29075235	.	T	G	9	5	14	0	1	15	0	0
21	29075332	.	G	T	18	16	34	0	2	36	0	0
21	29088594	.	G	A	2	2	4	0	0	4	0	0
21	29088595	.	G	C	2	1	3	0	1	4	0	0
21	29090879	.	C	T	1	6	7	0	9	16	0	0
21	29090935	.	C	T	1	5	6	0	6	12	0	0
21	29091053	.	T	C	26	14	40	0	0	40	0	0
21	29091054	.	G	A	26	13	39	0	1	40	0	0
21	29091362	.	C	G	23	28	51	0	0	51	0	0
21	29092303	.	T	A	1	3	4	0	0	4	0	0
21	29092351	.	T	C	1	3	4	0	0	4	0	0
21	29094676	.	T	C	22	0	22	1	26	49	0	0
21	29096390	.	A	T	18	24	42	0	1	43	0	0
21	29096709	.	T	G	21	28	49	0	1	50	0	0
21	29100081	.	G	A	2	6	8	0	0	8	0	0
21	29108242	.	G	A	1	2	3	0	0	3	0	0
21	29108299	.	A	T	2	3	5	0	0	5	0	0
21	29108326	.	A	C	1	0	1	0	4	5	0	0
21	29227325	.	G	A	1	3	4	0	2	6	0	0
21	29228027	.	A	G	2	4	6	0	0	6	0	0
21	29228144	.	A	C	6	8	14	0	0	14	0	0
21	29247636	.	C	T	11	5	16	0	1	17	0	0
21	29247813	.	A	G	5	5	10	0	1	11	0	0
21	30010042	.	T	C	6	9	15	0	0	15	0	0
21	30010146	.	C	T	6	4	10	0	1	11	0	0
21	30010299	.	C	A	4	8	12	0	1	13	0	0
21	30010332	.	G	A	0	5	5	0	7	12	0	0
21	30010462	.	C	T	7	10	17	0	2	19	0	0
21	30014066	.	C	T	4	4	8	0	0	8	0	0
21	30014318	.	C	T	9	9	18	0	0	18	0	0
21	30018856	.	T	C	13	7	20	0	1	21	0	0
21	30019385	.	C	G	9	4	13	0	0	13	0	0
21	30019586	.	T	A	2	2	4	0	0	4	0	0
21	30020062	.	T	A	3	3	6	0	0	6	0	0
21	30020097	.	A	G	4	3	7	0	0	7	0	0
21	30025205	.	T	C	5	0	5	0	11	16	0	0
21	30025514	.	G	A	6	10	16	0	0	16	0	0
21	30026162	.	C	T	1	12	13	0	11	24	0	0
21	30031126	.	G	A	12	7	19	0	0	19	0	0
21	30031316	.	G	A	5	5	10	0	2	12	0	0
21	30031987	.	G	A	13	10	23	0	0	23	0	0
21	30032045	.	C	T	10	18	28	0	1	29	0	0
21	30116508	.	G	A	5	6	11	0	1	12	0	0
21	30166087	.	C	T	0	2	2	0	3	5	0	0
21	30166110	.	C	T	1	3	4	0	0	4	0	0
21	30169705	.	T	C	2	0	2	0	4	6	0	0
21	30181216	.	G	A	9	12	21	0	1	22	0	0
21	30181662	.	T	A	12	15	27	0	1	28	0	0
21	30195389	.	C	T	13	13	26	0	0	26	0	0
21	30201092	.	G	A	12	15	27	0	0	27	0	0
21	30201235	.	C	T	8	15	23	0	0	23	0	0
21	30206393	.	A	T	10	8	18	0	0	18	0	0
21	30208255	.	G	A	3	12	15	0	17	32	0	0
21	30232112	.	T	G	11	13	24	0	0	24	0	0
21	30232187	.	C	T	15	10	25	0	1	26	0	0
21	30232212	.	C	T	11	14	25	0	1	26	0	0
21	30232304	.	C	T	16	15	31	0	2	33	0	0
21	30232307	.	C	T	16	15	31	0	0	31	0	0
21	30236791	.	C	A	2	4	6	0	0	6	0	0
21	30240378	.	C	A	25	14	39	0	0	39	0	0
21	30240400	.	T	G	18	11	29	0	4	33	0	0
21	30244739	.	G	T	18	17	35	0	1	36	0	0
21	30246684	.	A	G	20	17	37	0	1	38	0	0
21	30253692	.	A	G	20	16	36	0	0	36	0	0
21	30253884	.	A	G	12	10	22	0	1	23	0	0
21	30253942	.	A	C	10	12	22	0	1	23	0	0
21	30253954	.	A	C	8	17	25	0	0	25	0	0
21	30253982	.	T	A	19	8	27	0	1	28	0	0
21	30260059	.	G	T	1	3	4	0	1	5	0	0
21	30260961	.	C	T	2	13	15	0	8	23	0	0
21	30270012	.	T	G	7	3	10	0	4	14	0	0
21	30270015	.	C	G	2	3	5	0	9	14	0	0
21	30273366	.	C	A	14	12	26	0	1	27	0	0
21	30299416	.	T	C	21	14	35	0	0	35	0	0
21	30299561	.	T	C	6	15	21	0	0	21	0	0
21	30299679	.	A	T	5	3	8	0	0	8	0	0
21	30299735	.	C	T	3	7	10	0	0	10	0	0
21	30692632	.	A	G	6	4	10	0	0	10	0	0
21	30692796	.	A	G	4	4	8	0	1	9	0	0
21	30693311	.	A	G	7	12	19	0	1	20	0	0
21	30693312	.	A	G	7	10	17	0	3	20	0	0
21	30693630	.	T	C	1	7	8	0	0	8	0	0
21	31271962	.	A	G	1	5	6	0	0	6	0	0
21	32281076	.	G	A	9	5	14	0	0	14	0	0
21	32281122	.	G	A	9	9	18	0	1	19	0	0
21	32281155	.	G	A	4	13	17	0	1	18	0	0
21	32281680	.	C	T	8	7	15	0	0	15	0	0
21	32283519	.	G	A	14	9	23	0	2	25	0	0
21	32284398	.	A	G	6	7	13	0	1	14	0	0
21	32285080	.	C	T	2	5	7	0	0	7	0	0
21	32285135	.	T	C	1	0	1	0	2	3	0	0
21	32342458	.	G	A	9	9	18	0	0	18	0	0
21	32343230	.	C	A	9	14	23	0	1	24	0	0
21	32343248	.	C	A	14	14	28	0	1	29	0	0
21	32343316	.	T	A	19	13	32	0	3	35	0	0
21	32343453	.	C	T	15	16	31	1	1	33	0	0
21	32343577	.	T	C	13	11	24	0	0	24	0	0
21	32343649	.	C	A	15	10	25	0	3	28	0	0
21	32343721	.	T	G	9	0	9	0	9	18	0	0
21	32344021	.	C	A	9	13	22	0	0	22	0	0
21	32345162	.	T	C	13	10	23	0	2	25	0	0
21	32345318	.	G	A	1	7	8	0	7	15	0	0
21	32345499	.	A	G	6	6	12	0	0	12	0	0
21	32345607	.	C	T	9	5	14	0	0	14	0	0
21	32345724	.	A	G	3	7	10	1	1	12	0	0
21	32345749	.	A	G	6	6	12	1	1	14	0	0
21	32345774	.	A	T	5	3	8	1	1	10	0	0
21	32345899	.	G	A	0	3	3	0	2	5	0	0
21	32346273	.	G	A	20	7	27	0	1	28	0	0
21	32346603	.	G	C	8	22	30	0	0	30	0	0
21	32346630	.	T	C	12	15	27	0	1	28	0	0
21	32346674	.	T	A	16	13	29	0	0	29	0	0
21	32346689	.	A	G	18	9	27	1	1	29	0	0
21	32346799	.	G	A	15	21	36	0	0	36	0	0
21	32346800	.	T	A	14	21	35	0	1	36	0	0
21	32346899	.	A	G	20	10	30	0	0	30	0	0
21	32346901	.	A	G	20	10	30	0	0	30	0	0
21	32347134	.	T	A	19	26	45	0	1	46	0	0
21	32347569	.	G	T	15	21	36	0	1	37	0	0
21	32347855	.	T	C	17	18	35	0	1	36	0	0
21	32347966	.	A	C	15	1	16	0	17	33	0	0
21	32348230	.	A	T	16	16	32	0	0	32	0	0
21	32348321	.	C	A	4	4	8	0	0	8	0	0
21	32348512	.	G	T	13	15	28	0	1	29	0	0
21	32348542	.	A	T	13	18	31	0	1	32	0	0
21	32348570	.	C	T	17	15	32	0	1	33	0	0
21	32348600	.	C	T	15	15	30	0	0	30	0	0
21	32348664	.	G	A	14	11	25	0	0	25	0	0
21	32352459	.	C	G	15	12	27	0	0	27	0	0
21	32353049	.	G	A	14	16	30	0	0	30	0	0
21	32354920	.	A	G	11	16	27	0	0	27	0	0
21	32354980	.	A	G	11	15	26	0	0	26	0	0
21	32374460	.	A	T	18	9	27	0	1	28	0	0
21	32457785	.	T	C	8	10	18	0	0	18	0	0
21	32457923	.	C	A	20	14	34	0	0	34	0	0
21	32457931	.	T	G	20	8	28	0	3	31	0	0
21	32457983	.	G	A	13	16	29	0	1	30	0	0
21	32458261	.	A	G	22	21	43	0	0	43	0	0
21	32458315	.	T	A	23	17	40	0	1	41	0	0
21	32460912	.	A	G	19	24	43	0	2	45	0	0
21	32466140	.	G	C	22	19	41	0	6	47	0	0
21	32467660	.	A	G	29	20	49	0	1	50	0	0
21	32467724	.	T	C	23	19	42	0	1	43	0	0
21	32476760	.	A	G	23	17	40	0	1	41	0	0
21	32477584	.	T	C	21	22	43	0	2	45	0	0
21	32477967	.	C	T	20	24	44	0	2	46	0	0
21	32477987	.	A	T	19	18	37	0	8	45	0	0
21	32478227	.	G	T	32	27	59	0	0	60	1	0
21	32482797	.	C	T	27	24	51	0	4	55	0	0
21	32482854	.	T	C	22	1	23	1	24	48	0	0
21	32523607	.	C	T	4	2	6	0	0	6	0	0
21	32552555	.	A	T	2	4	6	0	0	6	0	0
21	32758254	.	G	A	12	8	20	0	0	20	0	0
21	32758351	.	C	T	12	8	20	0	2	22	0	0
21	32758584	.	G	A	21	15	36	0	1	37	0	0
21	32759421	.	C	T	9	6	15	0	2	17	0	0
21	32766389	.	G	A	14	12	26	0	2	28	0	0
21	32772450	.	G	A	13	7	20	0	2	22	0	0
21	33066214	.	T	G	22	8	30	0	2	32	0	0
21	33069896	.	A	G	19	6	25	0	0	25	0	0
21	33211193	.	G	T	5	2	7	0	0	7	0	0
21	33211506	.	T	A	14	13	27	0	1	28	0	0
21	33211568	.	C	T	10	9	19	1	1	21	0	0
21	33211664	.	T	G	11	12	23	0	2	25	0	0
21	33211809	.	A	T	14	14	28	0	3	31	0	0
21	33213315	.	C	T	11	12	23	0	1	24	0	0
21	33213384	.	G	A	12	9	21	0	1	22	0	0
21	33218312	.	T	C	11	6	17	0	0	17	0	0
21	33218405	.	G	A	12	11	23	0	2	25	0	0
21	33249606	.	T	A	3	6	9	0	0	9	0	0
21	33249638	.	A	C	2	3	5	0	0	5	0	0
21	33447251	.	A	G	13	10	23	0	1	24	0	0
21	33463486	.	A	G	8	16	24	0	0	24	0	0
21	34001982	.	C	T	14	9	23	0	0	23	0	0
21	34002041	.	C	A	11	8	19	0	0	19	0	0
21	34002154	.	A	C	11	8	19	0	0	19	0	0
21	34002155	.	A	T	11	8	19	0	0	19	0	0
21	34002333	.	T	C	3	5	8	0	0	8	0	0
21	34002455	.	G	A	8	4	12	0	0	12	0	0
21	34002507	.	A	G	9	8	17	0	0	17	0	0
21	34026657	.	T	C	5	6	11	0	1	12	0	0
21	34031232	.	G	A	1	6	7	0	1	8	0	0
21	34056463	.	A	T	2	7	9	0	0	9	0	0
21	34057611	.	T	G	7	6	13	0	2	15	0	0
21	34059079	.	A	C	4	6	10	0	0	10	0	0
21	34074618	.	A	G	3	7	10	0	2	12	0	0
21	34074684	.	G	A	2	9	11	0	0	11	0	0
21	34074712	.	T	C	3	7	10	0	0	10	0	0
21	34088192	.	C	T	1	3	4	0	0	4	0	0
21	34103275	.	G	A	2	5	7	0	10	17	0	0
21	34114058	.	C	A	5	3	8	0	0	8	0	0
21	34128660	.	A	G	19	16	35	0	1	36	0	0
21	34129007	.	C	G	12	1	13	0	27	40	0	0
21	34129073	.	G	C	8	17	25	0	1	26	0	0
21	34129195	.	G	T	13	11	24	0	0	24	0	0
21	34129279	.	A	G	8	20	28	0	0	28	0	0
21	34129401	.	T	A	9	7	16	0	0	16	0	0
21	34176051	.	A	T	2	2	4	0	0	4	0	0
21	34195712	.	G	A	5	2	7	0	0	7	0	0
21	34195790	.	T	C	4	8	12	0	0	12	0	0
21	34199704	.	T	C	2	7	9	0	0	9	0	0
21	34210970	.	G	A	6	6	12	0	1	13	0	0
21	34211206	.	T	C	11	6	17	0	1	18	0	0
21	34211344	.	G	A	8	11	19	0	2	21	0	0
21	34211418	.	G	A	3	5	8	0	8	16	0	0
21	34211427	.	A	C	6	6	12	0	0	12	0	0
21	34211511	.	A	T	6	7	13	0	0	13	0	0
21	34364595	.	G	A	2	8	10	0	0	10	0	0
21	34364774	.	G	A	1	6	7	0	0	7	0	0
21	34364962	.	G	T	13	7	20	0	2	22	0	0
21	34391104	.	C	T	13	11	24	0	1	25	0	0
21	34391155	.	T	C	7	6	13	0	0	13	0	0
21	34392786	.	C	T	10	12	22	0	1	23	0	0
21	34392828	.	G	T	12	10	22	0	2	24	0	0
21	34424116	.	A	G	15	14	29	0	1	30	0	0
21	34430533	.	A	G	11	8	19	0	0	19	0	0
21	34430544	.	A	G	10	9	19	1	2	22	0	0
21	34714359	.	G	A	0	9	9	0	9	18	0	0
21	34714403	.	C	A	3	7	10	0	0	10	0	0
21	34717099	.	C	T	5	7	12	0	0	12	0	0
21	34724797	.	G	A	6	14	20	0	0	20	0	0
21	34724956	.	C	T	11	15	26	0	0	26	0	0
21	34741120	.	T	C	11	17	28	0	1	29	0	0
21	34770460	.	G	A	10	7	17	0	1	18	0	0
21	34770483	.	G	A	8	7	15	0	1	16	0	0
21	34770510	.	C	T	10	12	22	0	0	22	0	0
21	34792896	.	G	A	9	9	18	0	5	23	0	0
21	34793224	.	C	T	15	13	28	0	1	29	0	0
21	34793405	.	C	T	10	10	20	0	0	20	0	0
21	34793660	.	T	A	5	2	7	0	1	8	0	0
21	34793694	.	T	C	3	5	8	0	0	8	0	0
21	34793786	.	C	G	3	6	9	0	0	9	0	0
21	34826742	.	A	G	1	3	4	0	0	4	0	0
21	34826781	.	G	A	0	2	2	0	4	6	0	0
21	34826838	.	G	C	1	3	4	0	1	5	0	0
21	34834292	.	C	G	2	3	5	0	0	5	0	0
21	34834295	.	A	G	2	0	2	0	3	5	0	0
21	34834472	.	A	T	1	2	3	0	0	3	0	0
21	34849534	.	A	G	8	5	13	0	2	15	0	0
21	34851824	.	G	A	1	4	5	0	4	9	0	0
21	34851899	.	G	A	3	3	6	0	0	6	0	0
21	34856770	.	C	T	5	2	7	0	0	7	0	0
21	34878938	.	A	C	11	11	22	0	0	22	0	0
21	34880000	.	G	A	1	3	4	0	0	4	0	0
21	34981031	.	G	A	3	8	11	0	1	12	0	0
21	34987505	.	C	T	6	7	13	0	0	13	0	0
21	34987612	.	G	A	1	5	6	0	5	11	0	0
21	34987662	.	G	T	5	3	8	0	1	9	0	0
21	35009472	.	C	T	3	2	5	1	1	7	0	0
21	35009509	.	A	G	2	2	4	1	0	5	0	0
21	35010135	.	A	T	1	3	4	0	0	4	0	0
21	35025588	.	G	A	0	5	5	0	2	7	0	0
21	35033847	.	G	A	4	5	9	0	0	9	0	0
21	35033853	.	G	A	3	5	8	0	0	8	0	0
21	35035560	.	G	A	0	8	8	0	4	12	0	0
21	35040310	.	C	T	3	4	7	0	0	7	0	0
21	35042916	.	G	A	1	2	3	0	0	3	0	0
21	35048278	.	T	A	2	3	5	0	0	5	0	0
21	35054466	.	A	G	5	5	10	0	1	11	0	0
21	35054645	.	G	A	1	2	3	0	1	4	0	0
21	35279874	.	C	T	8	10	18	0	1	19	0	0
21	35280099	.	A	G	10	5	15	0	0	15	0	0
21	35280209	.	G	A	1	3	4	0	6	10	0	0
21	35280233	.	T	C	7	4	11	0	0	11	0	0
21	35280285	.	G	A	8	5	13	0	0	13	0	0
21	35280388	.	T	A	5	6	11	0	0	11	0	0
21	35280389	.	A	T	5	6	11	0	0	11	0	0
21	35280482	.	G	T	2	5	7	0	1	8	0	0
21	35280938	.	C	T	11	9	20	0	1	21	0	0
21	35281246	.	A	C	7	5	12	0	0	12	0	0
21	35312079	.	T	A	2	2	4	15	0	19	0	0
21	35319331	.	T	C	11	7	18	2	5	25	0	0
21	35325483	.	T	G	3	9	12	0	0	12	0	0
21	35359489	.	A	G	2	0	2	0	3	5	0	0
21	35652761	.	G	C	3	3	6	0	0	6	0	0
21	35652972	.	C	T	3	3	6	0	0	6	0	0
21	35653043	.	T	C	2	4	6	0	0	6	0	0
21	35653077	.	A	C	3	6	9	0	0	9	0	0
21	35653321	.	G	A	7	5	12	0	0	12	0	0
21	35677566	.	C	A	0	4	4	0	5	9	0	0
21	35831056	.	G	A	3	2	5	0	0	5	0	0
21	35831176	.	A	T	2	2	4	0	0	4	0	0
21	36386928	.	G	A	3	3	6	0	3	9	0	0
21	36387018	.	A	G	9	13	22	0	0	22	0	0
21	36387051	.	T	C	12	9	21	0	0	21	0	0
21	36392696	.	A	G	6	13	19	0	0	19	0	0
21	36392866	.	T	C	14	10	24	0	1	25	0	0
21	36399238	.	G	A	2	2	4	0	0	4	0	0
21	36399334	.	C	T	1	3	4	0	0	4	0	0
21	36413239	.	G	A	2	2	4	0	0	4	0	0
21	36417065	.	C	A	2	3	5	0	0	5	0	0
21	36419256	.	G	A	3	3	6	0	1	7	0	0
21	36419430	.	A	G	4	4	8	0	0	8	0	0
21	36435851	.	G	A	0	2	2	0	3	5	0	0
21	36435859	.	G	A	0	2	2	0	3	5	0	0
21	36439821	.	G	A	0	4	4	0	4	8	0	0
21	36439834	.	C	A	4	4	8	0	0	8	0	0
21	36439876	.	A	C	1	2	3	0	0	3	0	0
21	36442260	.	T	A	5	6	11	0	0	11	0	0
21	36442633	.	G	A	9	10	19	0	4	23	0	0
21	36446952	.	A	G	6	14	20	0	3	23	0	0
21	36449385	.	T	G	7	7	14	0	0	14	0	0
21	36449427	.	G	A	8	5	13	0	0	13	0	0
21	36449686	.	T	C	12	12	24	0	1	25	0	0
21	36449716	.	G	A	13	14	27	0	0	27	0	0
21	36465970	.	T	C	3	5	8	0	1	9	0	0
21	36468431	.	G	A	9	4	13	0	1	14	0	0
21	36473774	.	T	C	4	9	13	0	0	13	0	0
21	36492004	.	G	A	2	4	6	0	0	6	0	0
21	36492016	.	C	T	0	3	3	0	2	5	0	0
21	36496157	.	C	T	8	4	12	0	0	12	0	0
21	36496160	.	C	T	0	3	3	0	8	11	0	0
21	36501319	.	C	T	5	2	7	0	0	7	0	0
21	36512296	.	G	A	2	2	4	0	1	5	0	0
21	36525582	.	A	T	2	3	5	0	0	5	0	0
21	36546067	.	G	A	1	2	3	0	0	3	0	0
21	36571428	.	C	T	0	3	3	0	2	5	0	0
21	36592117	.	T	C	6	7	13	0	0	13	0	0
21	36592164	.	G	A	8	3	11	0	1	12	0	0
21	36592212	.	T	C	7	6	13	0	0	13	0	0
21	36598047	.	T	C	12	8	20	0	0	20	0	0
21	36598143	.	G	A	0	7	7	0	8	15	0	0
21	36598349	.	T	G	8	2	10	0	0	10	0	0
21	36598471	.	T	C	8	8	16	0	1	17	0	0
21	36598474	.	C	A	7	8	15	0	1	16	0	0
21	36598529	.	G	T	10	10	20	0	0	20	0	0
21	36598583	.	T	C	4	6	10	0	0	10	0	0
21	36598596	.	A	G	1	5	6	0	0	6	0	0
21	36598750	.	A	G	3	5	8	2	0	10	0	0
21	36598853	.	G	A	0	4	4	1	9	14	0	0
21	36598959	.	A	T	4	3	7	1	1	9	0	0
21	36599020	.	A	T	5	14	19	0	0	19	0	0
21	36599077	.	T	C	9	4	13	1	0	14	0	0
21	36599320	.	C	T	9	5	14	0	0	14	0	0
21	36599358	.	A	C	10	7	17	1	0	18	0	0
21	36599847	.	G	A	6	4	10	0	0	10	0	0
21	36599944	.	C	T	3	7	10	0	0	10	0	0
21	36612586	.	T	A	3	7	10	0	0	10	0	0
21	36612633	.	T	C	4	6	10	0	0	10	0	0
21	37107380	.	C	A	3	0	3	0	9	13	1	0
21	37397958	.	T	G	1	0	1	0	11	12	0	0
21	37690017	.	T	C	8	3	11	0	0	11	0	0
21	38013631	.	T	C	2	4	6	0	0	6	0	0
21	38587378	.	T	C	12	11	23	0	0	23	0	0
21	38647510	.	A	T	8	3	11	5	0	16	0	0
21	38773816	.	C	T	1	2	3	0	0	3	0	0
21	39453940	.	G	A	3	43	46	0	5	51	0	0
21	39511364	.	A	G	3	5	8	0	0	8	0	0
21	40355102	.	G	A	1	5	6	0	1	7	0	0
21	40532368	.	T	C	5	4	9	0	0	9	0	0
21	40532455	.	T	C	5	2	7	0	1	8	0	0
21	40532665	.	T	C	5	5	10	0	0	10	0	0
21	41598942	.	G	C	11	4	15	0	2	17	0	0
21	41598961	.	T	C	13	0	13	0	9	22	0	0
21	41599060	.	T	C	20	14	34	0	2	36	0	0
21	41599721	.	T	C	8	3	11	2	0	13	0	0
21	41599722	.	T	C	8	2	10	2	1	13	0	0
21	41600427	.	T	C	1	0	1	0	6	7	0	0
21	42046871	.	T	C	31	10	41	33	5	80	1	0
21	42046874	.	G	A	36	9	45	34	4	83	0	0
21	42046969	.	G	A	15	11	26	40	1	67	0	0
21	42971463	.	T	C	30	18	48	0	8	56	0	0
21	43420703	.	T	C	4	0	4	0	4	8	0	0
21	43461082	.	T	C	7	6	13	0	1	14	0	0
21	43476276	.	T	C	17	7	24	0	0	24	0	0
21	43477593	.	T	C	23	12	35	0	2	37	0	0
21	43477894	.	T	C	21	9	30	0	3	33	0	0
21	44439578	.	C	T	4	6	10	0	0	10	0	0
21	44553806	.	A	G	7	10	17	0	0	17	0	0
21	44558587	.	T	A	1	2	3	0	0	3	0	0
21	44558693	.	C	T	1	3	4	0	0	4	0	0
21	44558697	.	T	C	1	2	3	0	0	3	0	0
21	44558898	.	T	C	9	0	9	0	11	20	0	0
21	44559095	.	C	T	21	23	44	0	0	44	0	0
21	44561900	.	A	G	34	19	53	0	3	56	0	0
21	44563129	.	T	A	25	19	44	0	4	48	0	0
21	44581845	.	A	T	2	5	7	0	1	8	0	0
21	44581947	.	C	T	5	5	10	0	0	10	0	0
21	44581948	.	C	A	5	5	10	0	1	11	0	0
21	44618620	.	G	A	0	6	6	0	8	14	0	0
21	44741375	.	G	A	1	2	3	0	0	3	0	0
21	44777084	.	G	A	0	6	6	0	6	12	0	0
21	44777617	.	G	T	1	7	8	0	9	17	0	0
21	44777713	.	T	C	6	4	10	0	1	11	0	0
21	44781745	.	A	G	12	13	25	0	1	26	0	0
21	44784156	.	A	G	9	0	9	0	9	18	0	0
21	44784223	.	A	G	14	0	14	0	14	28	0	0
21	44784493	.	G	T	9	6	15	0	1	16	0	0
21	44784589	.	T	C	3	2	5	0	0	5	0	0
21	44784663	.	C	T	3	6	9	0	0	9	0	0
21	44868607	.	G	A	3	4	7	0	0	7	0	0
21	44988849	.	A	G	6	1	7	0	3	10	0	0
21	45017433	.	T	C	3	4	7	0	0	7	0	0
21	45024622	.	C	T	4	3	7	0	1	8	0	0
21	45031046	.	T	G	5	3	8	0	0	8	0	0
21	45039897	.	G	A	4	5	9	0	0	9	0	0
21	45103191	.	C	T	4	2	6	0	0	6	0	0
21	45114742	.	G	A	0	7	7	0	7	14	0	0
21	45114778	.	C	T	6	8	14	0	0	14	0	0
21	45117403	.	A	G	5	4	9	1	0	10	0	0
21	45117465	.	T	C	5	5	10	0	0	10	0	0
21	45117469	.	T	G	6	3	9	0	0	9	0	0
21	45117537	.	C	T	5	2	7	0	0	7	0	0
21	45182345	.	A	G	5	5	10	0	0	10	0	0
21	45182488	.	G	A	6	8	14	0	0	14	0	0
21	45182566	.	C	T	13	7	20	0	1	21	0	0
21	45185829	.	A	G	20	15	35	0	1	36	0	0
21	45186175	.	G	A	23	12	35	0	1	36	0	0
21	45187072	.	T	G	16	15	31	0	0	31	0	0
21	45187248	.	A	G	13	15	28	0	0	28	0	0
21	45187258	.	G	A	15	15	30	0	0	30	0	0
21	45190709	.	T	A	31	23	54	0	2	56	0	0
21	45190754	.	C	T	2	26	28	0	22	50	0	0
21	45190884	.	G	A	19	25	44	0	1	45	0	0
21	45190926	.	C	T	26	23	49	0	0	49	0	0
21	45190975	.	C	T	27	25	52	0	0	52	0	0
21	45190984	.	T	C	30	23	53	0	2	55	0	0
21	45191163	.	A	T	31	39	70	0	3	73	0	0
21	45193365	.	G	A	36	30	66	0	2	68	0	0
21	45198712	.	C	T	4	25	29	0	27	56	0	0
21	45330929	.	C	T	1	2	3	0	0	3	0	0
21	45352415	.	C	T	1	20	21	0	17	38	0	0
21	45356811	.	T	G	19	27	46	0	0	46	0	0
21	45359397	.	G	A	30	23	53	0	1	54	0	0
21	45363684	.	C	T	20	20	40	0	1	41	0	0
21	45363728	.	C	T	23	16	39	0	0	39	0	0
21	45363778	.	T	G	13	34	47	0	2	49	0	0
21	45366262	.	T	A	8	9	17	0	0	17	0	0
21	45366268	.	C	T	15	9	24	0	0	24	0	0
21	45366301	.	A	C	14	18	32	0	1	33	0	0
21	45374413	.	C	A	18	7	25	0	0	25	0	0
21	45374439	.	C	T	13	12	25	0	0	25	0	0
21	45374475	.	A	G	17	9	26	0	0	26	0	0
21	45374509	.	T	C	10	8	18	0	2	20	0	0
21	45375109	.	G	T	4	7	11	0	1	12	0	0
21	45377351	.	G	T	8	4	12	0	1	13	0	0
21	45377404	.	T	C	14	3	17	0	0	17	0	0
21	45377409	.	T	C	13	3	16	0	0	16	0	0
21	45377604	.	T	G	12	9	21	0	2	23	0	0
21	45382032	.	G	A	19	19	38	0	1	39	0	0
21	45386175	.	C	T	5	8	13	0	1	14	0	0
21	45388336	.	T	C	4	6	10	0	1	11	0	0
21	45393627	.	C	T	6	9	15	0	0	15	0	0
21	45398178	.	T	C	9	11	20	0	1	21	0	0
21	45399775	.	A	T	8	8	16	0	0	16	0	0
21	45410019	.	G	A	1	18	19	0	3	22	0	0
21	45410118	.	T	C	8	8	16	0	0	16	0	0
21	45410479	.	A	C	6	6	12	0	1	13	0	0
21	45410601	.	G	A	4	4	8	0	0	8	0	0
21	45510529	.	G	A	1	4	5	0	0	5	0	0
21	45510620	.	C	T	8	4	12	0	0	12	0	0
21	45510699	.	A	G	7	0	7	0	8	15	0	0
21	45521741	.	C	T	5	9	14	0	0	14	0	0
21	45535881	.	A	G	7	8	15	0	1	16	0	0
21	45544374	.	C	T	11	10	21	0	0	21	0	0
21	45544384	.	A	G	9	0	9	0	12	21	0	0
21	45544709	.	A	G	11	6	17	0	0	17	0	0
21	45673667	.	T	A	2	36	38	0	2	40	0	0
21	45737829	.	C	A	11	10	21	5	5	31	0	0
21	45920602	.	T	A	1	5	6	0	0	6	0	0
22	336325	.	T	C	19	20	39	1	0	40	0	0
22	336982	.	C	T	17	18	35	0	0	35	0	0
22	337121	.	A	C	8	3	11	0	21	32	0	0
22	337127	.	A	C	5	0	5	0	27	33	1	0
22	337540	.	A	T	20	17	37	0	0	37	0	0
22	337970	.	C	G	11	4	15	0	0	15	0	0
22	338187	.	G	A	19	11	30	5	1	36	0	0
22	338199	.	G	T	3	11	14	5	20	39	0	0
22	338226	.	C	T	19	10	29	7	0	36	0	0
22	338431	.	C	T	5	7	12	0	2	14	0	0
22	700364	.	G	A	0	2	2	0	1	3	0	0
22	711071	.	A	G	24	21	45	0	2	47	0	0
22	711475	.	T	C	4	5	9	0	0	9	0	0
22	711787	.	A	T	25	18	43	0	1	44	0	0
22	712187	.	G	T	16	16	32	0	1	33	0	0
22	728171	.	G	A	0	6	6	0	2	8	0	0
22	730015	.	A	G	4	0	4	0	11	15	0	0
22	732142	.	G	A	2	6	8	0	8	16	0	0
22	732149	.	G	T	1	6	7	0	12	19	0	0
22	732271	.	A	G	6	0	6	0	7	13	0	0
22	732398	.	T	G	3	2	5	0	1	6	0	0
22	732718	.	C	T	1	2	3	0	0	3	0	0
22	732725	.	T	A	7	2	9	0	0	9	0	0
22	744646	.	T	C	4	5	9	0	0	9	0	0
22	745380	.	C	T	11	4	15	0	0	15	0	0
22	745425	.	A	C	5	3	8	0	1	9	0	0
22	748837	.	C	T	8	8	16	1	0	17	0	0
22	748951	.	T	C	4	4	8	0	1	9	0	0
22	750695	.	T	C	5	5	10	0	0	10	0	0
22	750699	.	G	A	0	6	6	0	5	11	0	0
22	750759	.	C	A	2	5	7	0	0	7	0	0
22	750770	.	C	G	2	4	6	0	0	6	0	0
22	750863	.	T	C	5	6	11	0	0	11	0	0
22	753210	.	C	T	2	2	4	0	0	4	0	0
22	753219	.	T	C	2	2	4	0	0	4	0	0
22	774949	.	G	C	11	11	22	0	1	23	0	0
22	775044	.	T	C	18	0	18	0	18	36	0	0
22	775085	.	G	A	14	15	29	0	1	30	0	0
22	776875	.	T	G	24	6	30	0	1	31	0	0
22	777072	.	G	A	25	11	36	0	0	36	0	0
22	797117	.	G	A	17	10	27	0	0	27	0	0
22	797196	.	G	T	1	11	12	0	20	32	0	0
22	797255	.	T	C	16	11	27	0	0	27	0	0
22	799595	.	A	G	14	0	14	1	18	33	0	0
22	799712	.	C	T	15	11	26	0	3	29	0	0
22	806155	.	C	T	15	19	34	0	3	37	0	0
22	808015	.	T	A	12	4	16	0	1	17	0	0
22	808032	.	T	C	12	8	20	0	1	21	0	0
22	808069	.	T	A	7	9	16	0	1	17	0	0
22	808077	.	A	G	7	0	7	0	8	15	0	0
22	813148	.	C	G	1	1	2	0	3	5	0	0
22	813152	.	G	A	2	2	4	0	0	4	0	0
22	813369	.	G	A	2	2	4	0	0	4	0	0
22	813432	.	G	A	2	2	4	0	0	4	0	0
22	814622	.	T	G	2	3	5	0	0	5	0	0
22	819756	.	G	A	4	4	8	0	0	8	0	0
22	819787	.	G	A	2	4	6	0	1	7	0	0
22	820459	.	G	T	13	17	30	0	1	31	0	0
22	820660	.	A	G	18	12	30	0	0	30	0	0
22	822601	.	A	C	11	0	11	0	18	29	0	0
22	825091	.	T	A	17	12	29	0	1	30	0	0
22	825130	.	G	A	12	12	24	0	4	28	0	0
22	827256	.	A	T	6	11	17	0	1	18	0	0
22	827309	.	G	A	6	10	16	0	0	16	0	0
22	828235	.	C	G	7	12	19	0	1	20	0	0
22	828517	.	C	T	1	7	8	0	6	14	0	0
22	831180	.	C	T	0	7	7	0	12	19	0	0
22	831185	.	C	T	8	11	19	0	0	19	0	0
22	831482	.	C	T	0	8	8	0	8	16	0	0
22	831533	.	G	A	12	9	21	0	0	21	0	0
22	831575	.	C	T	8	8	16	0	1	17	0	0
22	831591	.	T	C	9	0	9	0	10	19	0	0
22	833928	.	G	A	9	8	17	0	0	17	0	0
22	857511	.	C	G	6	8	14	0	0	14	0	0
22	857572	.	A	T	6	5	11	0	1	12	0	0
22	857662	.	C	T	7	1	8	0	1	9	0	0
22	857720	.	A	G	10	10	20	0	0	20	0	0
22	860224	.	G	A	8	3	11	0	0	11	0	0
22	860236	.	G	A	8	5	13	0	0	13	0	0
22	861221	.	G	A	7	8	15	0	1	16	0	0
22	862526	.	C	T	1	6	7	0	7	14	0	0
22	866064	.	C	T	5	5	10	1	3	14	0	0
22	868098	.	A	G	7	3	10	0	0	10	0	0
22	868195	.	C	A	12	5	17	0	0	18	1	0
22	868321	.	T	C	6	12	18	0	0	18	0	0
22	869514	.	C	T	2	4	6	0	0	6	0	0
22	869584	.	C	T	7	3	10	0	2	12	0	0
22	869739	.	G	A	11	10	21	0	2	23	0	0
22	869793	.	C	A	8	9	17	0	0	17	0	0
22	869798	.	G	T	9	10	19	0	0	19	0	0
22	873058	.	G	C	6	6	12	0	1	13	0	0
22	875469	.	A	T	5	2	7	0	0	7	0	0
22	876988	.	G	A	5	10	15	0	1	16	0	0
22	877097	.	C	T	0	5	5	0	11	16	0	0
22	877805	.	A	G	5	5	10	0	1	11	0	0
22	877922	.	C	T	6	8	14	0	0	14	0	0
22	994512	.	T	A	1	3	4	0	0	4	0	0
22	1016425	.	G	T	1	2	3	0	0	3	0	0
22	1037128	.	G	A	2	2	4	1	0	5	0	0
22	1037136	.	A	G	2	2	4	0	0	4	0	0
22	1203320	.	A	T	8	9	17	0	0	17	0	0
22	1203373	.	A	T	9	8	17	0	0	17	0	0
22	1209816	.	T	C	11	11	22	0	2	24	0	0
22	1212997	.	A	G	6	12	18	0	2	20	0	0
22	1212998	.	A	G	5	14	19	0	1	20	0	0
22	1214289	.	T	C	6	6	12	0	1	13	0	0
22	1214535	.	T	G	6	8	14	0	0	14	0	0
22	1216047	.	C	T	11	5	16	0	2	18	0	0
22	1223100	.	C	T	1	4	5	0	5	10	0	0
22	1226910	.	T	A	6	8	14	0	1	15	0	0
22	1228158	.	T	C	9	6	15	0	0	15	0	0
22	1234232	.	A	T	6	4	10	0	0	10	0	0
22	1713223	.	G	A	0	2	2	0	3	5	0	0
22	1727204	.	C	A	2	3	5	0	0	5	0	0
22	1727238	.	A	G	3	3	6	0	0	6	0	0
22	1757069	.	A	T	2	2	4	0	0	4	0	0
22	1757132	.	A	G	4	0	4	0	6	10	0	0
22	1757150	.	T	C	4	6	10	0	0	10	0	0
22	1757201	.	A	T	1	3	4	0	0	4	0	0
22	1793416	.	T	C	4	2	6	0	0	6	0	0
22	1794253	.	T	G	6	0	6	0	3	9	0	0
22	1794263	.	G	A	6	2	8	0	0	8	0	0
22	1808814	.	A	C	3	2	5	0	0	5	0	0
22	1809053	.	A	G	1	3	4	1	0	5	0	0
22	1809081	.	C	A	1	4	5	1	0	6	0	0
22	1809224	.	G	C	0	2	2	0	2	4	0	0
22	1809229	.	C	T	1	3	4	0	0	4	0	0
22	1849115	.	G	C	2	3	5	0	1	6	0	0
22	1849335	.	A	T	4	2	6	0	0	6	0	0
22	1860867	.	G	A	5	5	10	0	0	10	0	0
22	1899998	.	G	C	9	3	12	0	0	12	0	0
22	1900144	.	T	C	3	2	5	0	1	6	0	0
22	1900146	.	A	G	4	0	4	0	2	6	0	0
22	1900230	.	G	C	3	2	5	0	0	5	0	0
22	1900376	.	T	C	3	2	5	0	0	5	0	0
22	1900389	.	G	A	3	3	6	0	0	6	0	0
22	1900416	.	A	G	2	4	6	1	0	7	0	0
22	1900767	.	A	G	2	3	5	0	0	5	0	0
22	1900888	.	G	A	5	3	8	0	1	9	0	0
22	1901238	.	T	A	4	4	8	0	0	8	0	0
22	1901245	.	T	C	5	5	10	0	0	10	0	0
22	1924442	.	C	A	1	2	3	0	0	3	0	0
22	1924603	.	G	C	5	2	7	0	1	8	0	0
22	1924746	.	A	C	6	4	10	0	0	10	0	0
22	1924754	.	T	A	5	4	9	0	0	9	0	0
22	1924952	.	C	T	2	2	4	0	2	6	0	0
22	1925132	.	T	C	6	3	9	0	0	9	0	0
22	1925182	.	A	G	4	3	7	0	0	7	0	0
22	1925228	.	G	A	1	4	5	0	2	7	0	0
22	1935482	.	A	C	1	2	3	0	0	3	0	0
22	1945243	.	G	A	2	2	4	0	0	4	0	0
22	1945258	.	C	T	2	2	4	0	0	4	0	0
22	1946691	.	C	A	4	4	8	1	1	10	0	0
22	2033389	.	C	A	2	2	4	0	0	4	0	0
22	2033430	.	A	G	4	0	4	0	7	11	0	0
22	2033674	.	C	T	2	7	9	0	0	9	0	0
22	2033740	.	C	T	2	3	5	0	0	5	0	0
22	2033767	.	G	A	1	2	3	0	0	3	0	0
22	2034016	.	A	G	4	0	4	0	4	8	0	0
22	2034138	.	C	A	1	3	4	0	0	4	0	0
22	2106449	.	A	C	3	2	5	1	0	6	0	0
22	2106630	.	C	T	0	3	3	0	1	4	0	0
22	2106657	.	G	C	2	5	7	0	0	7	0	0
22	2106748	.	C	A	3	6	9	0	0	9	0	0
22	2106749	.	G	A	0	6	6	0	3	9	0	0
22	2106806	.	A	C	1	3	4	0	1	5	0	0
22	2106814	.	G	A	0	1	1	0	2	3	0	0
22	2107007	.	A	T	2	4	6	0	0	6	0	0
22	2107359	.	G	A	2	3	5	0	0	5	0	0
22	2107418	.	C	T	3	3	6	0	0	6	0	0
22	2125384	.	T	C	3	4	7	0	0	7	0	0
22	2125392	.	A	G	3	4	7	0	0	7	0	0
22	2125757	.	A	G	3	2	5	0	0	5	0	0
22	2144325	.	A	G	1	2	3	0	0	3	0	0
22	2172051	.	G	C	2	2	4	4	0	8	0	0
22	2172090	.	C	T	2	2	4	0	0	4	0	0
22	2172239	.	A	G	4	2	6	0	0	6	0	0
22	2172240	.	G	A	4	2	6	0	0	6	0	0
22	2172283	.	G	T	3	2	5	0	0	5	0	0
22	2172294	.	A	G	0	2	2	0	2	4	0	0
22	2172437	.	C	G	2	3	5	1	0	6	0	0
22	2178221	.	T	C	2	2	4	0	0	4	0	0
22	2178333	.	A	C	3	4	7	0	0	7	0	0
22	2242507	.	G	A	1	3	4	0	0	4	0	0
22	2347850	.	C	T	1	2	3	0	0	3	0	0
22	2347889	.	A	G	1	5	6	0	0	6	0	0
22	2347923	.	A	C	4	4	8	0	0	8	0	0
22	2347958	.	T	C	4	2	6	0	0	6	0	0
22	2365114	.	C	T	4	2	6	0	0	6	0	0
22	2368037	.	C	T	3	3	6	0	0	6	0	0
22	2374028	.	A	G	3	0	3	0	2	5	0	0
22	2374088	.	T	C	2	5	7	0	0	7	0	0
22	2385377	.	G	C	3	2	5	0	0	5	0	0
22	2389041	.	T	C	6	2	8	0	0	8	0	0
22	2389225	.	G	T	6	4	10	0	0	10	0	0
22	2391135	.	A	T	6	2	8	0	0	8	0	0
22	2394112	.	T	C	4	3	7	0	1	8	0	0
22	2394152	.	C	A	6	3	9	0	0	9	0	0
22	2403919	.	T	A	3	2	5	0	0	5	0	0
22	2411925	.	G	A	2	4	6	0	0	6	0	0
22	2417311	.	G	T	1	3	4	0	4	8	0	0
22	2417389	.	T	C	2	5	7	0	0	7	0	0
22	2420325	.	A	G	6	5	11	0	0	11	0	0
22	2420405	.	A	G	4	0	4	0	4	8	0	0
22	2420409	.	G	T	4	3	7	0	1	8	0	0
22	2420493	.	C	G	3	3	6	0	1	7	0	0
22	2420623	.	C	G	5	2	7	0	0	7	0	0
22	2420744	.	C	A	4	3	7	0	0	7	0	0
22	2420881	.	T	C	5	3	8	0	0	8	0	0
22	2421028	.	A	T	5	11	16	0	0	16	0	0
22	2443763	.	T	C	2	2	4	0	0	4	0	0
22	2443787	.	G	A	3	3	6	0	0	6	0	0
22	2443803	.	A	G	3	3	6	0	0	6	0	0
22	2444234	.	G	A	5	3	8	0	0	8	0	0
22	2444303	.	G	A	7	4	11	0	0	11	0	0
22	2460539	.	G	A	1	4	5	0	6	11	0	0
22	2473557	.	G	T	0	2	2	0	6	8	0	0
22	2497650	.	C	A	1	3	4	0	0	4	0	0
22	2498196	.	G	A	1	4	5	0	1	6	0	0
22	2498212	.	C	T	2	5	7	0	0	7	0	0
22	2498538	.	C	T	3	2	5	0	0	5	0	0
22	2498539	.	G	A	0	2	2	0	3	5	0	0
22	2505120	.	A	G	3	2	5	0	1	6	0	0
22	2525748	.	T	C	1	2	3	0	0	3	0	0
22	2528804	.	T	C	4	4	8	0	0	8	0	0
22	2528837	.	A	G	2	0	2	0	4	6	0	0
22	2529008	.	A	G	3	3	6	0	0	6	0	0
22	2529408	.	G	A	1	2	3	0	0	3	0	0
22	2529641	.	A	C	1	3	4	0	0	4	0	0
22	2535173	.	A	T	4	2	6	0	0	6	0	0
22	2535180	.	T	C	4	2	6	0	0	6	0	0
22	2538363	.	T	C	1	2	3	0	1	4	0	0
22	2538440	.	T	C	3	2	5	0	0	5	0	0
22	2552814	.	G	A	0	5	5	0	3	8	0	0
22	2554749	.	A	T	3	8	11	0	0	11	0	0
22	2554793	.	C	A	3	8	11	0	0	11	0	0
22	2554800	.	G	A	3	8	11	0	0	11	0	0
22	2557735	.	C	T	3	6	9	0	1	10	0	0
22	2557783	.	G	A	4	7	11	0	2	13	0	0
22	2557876	.	C	T	4	5	9	0	0	9	0	0
22	2557879	.	G	A	4	4	8	0	0	8	0	0
22	2558279	.	A	T	7	5	12	2	0	14	0	0
22	2558344	.	G	A	4	3	7	0	0	7	0	0
22	2558386	.	C	T	6	4	10	0	0	10	0	0
22	2558416	.	A	T	4	6	10	0	1	11	0	0
22	2574805	.	T	C	5	2	7	0	0	7	0	0
22	2574815	.	T	C	4	2	6	0	0	6	0	0
22	2580443	.	G	A	4	5	9	0	0	9	0	0
22	2580444	.	T	C	4	5	9	0	0	9	0	0
22	2599163	.	T	G	1	2	3	0	0	3	0	0
22	2623083	.	G	A	4	4	8	0	0	8	0	0
22	2623632	.	T	G	3	0	3	0	2	5	0	0
22	2627317	.	A	G	2	0	2	0	3	5	0	0
22	2627391	.	A	G	5	3	8	0	2	10	0	0
22	2627395	.	T	A	6	0	6	0	3	9	0	0
22	2627736	.	A	T	2	5	7	0	0	7	0	0
22	2627773	.	A	T	5	4	9	0	1	10	0	0
22	2645215	.	G	C	2	4	6	0	0	6	0	0
22	2645410	.	G	A	3	3	6	0	0	6	0	0
22	2645660	.	G	C	1	3	4	0	0	4	0	0
22	2645662	.	G	A	2	3	5	0	0	5	0	0
22	2645741	.	C	T	3	2	5	0	0	5	0	0
22	2646501	.	C	T	1	2	3	0	0	3	0	0
22	2647754	.	G	T	1	2	3	0	0	3	0	0
22	2650072	.	T	A	5	4	9	0	0	9	0	0
22	2653023	.	T	C	3	5	8	1	0	9	0	0
22	2664297	.	C	T	1	4	5	0	1	6	0	0
22	2664302	.	A	G	3	2	5	0	0	5	0	0
22	2664411	.	G	A	1	3	4	0	0	4	0	0
22	2668031	.	G	A	2	3	5	0	0	5	0	0
22	2668043	.	C	T	3	3	6	0	0	6	0	0
22	2668262	.	A	G	4	2	6	0	0	6	0	0
22	2668352	.	C	T	3	2	5	0	0	5	0	0
22	2668467	.	G	C	0	3	3	0	2	5	0	0
22	2676234	.	G	C	5	7	12	1	0	13	0	0
22	2676393	.	A	G	5	0	5	0	2	7	0	0
22	2676415	.	A	C	4	2	6	0	0	6	0	0
22	2690523	.	A	C	2	2	4	0	0	4	0	0
22	2690718	.	A	C	5	3	8	1	1	10	0	0
22	2850293	.	G	A	3	2	5	0	1	6	0	0
22	2850299	.	G	A	3	2	5	0	1	6	0	0
22	2869790	.	G	A	5	2	7	0	0	7	0	0
22	2897580	.	T	C	19	0	19	0	8	27	0	0
22	2897681	.	A	G	13	16	29	0	2	31	0	0
22	2897742	.	G	A	7	14	21	0	0	21	0	0
22	2897997	.	G	C	12	13	25	0	1	26	0	0
22	2898089	.	C	A	4	20	24	1	7	32	0	0
22	2900999	.	G	A	20	13	33	0	3	36	0	0
22	2908264	.	T	G	13	14	27	0	1	28	0	0
22	2912869	.	G	T	14	20	34	2	2	38	0	0
22	2919050	.	A	G	12	12	24	0	1	25	0	0
22	2919501	.	C	T	17	14	31	0	1	32	0	0
22	2931544	.	T	A	7	3	10	1	0	11	0	0
22	2933861	.	G	C	6	6	12	0	0	12	0	0
22	2937428	.	A	G	2	6	8	0	0	8	0	0
22	2941538	.	A	G	12	0	12	0	11	23	0	0
22	2941886	.	C	T	7	4	11	0	0	11	0	0
22	2941888	.	C	T	7	4	11	0	0	11	0	0
22	2949133	.	G	C	1	2	3	0	1	4	0	0
22	2951416	.	C	G	1	10	11	0	3	14	0	0
22	2961868	.	G	A	1	3	4	0	4	8	0	0
22	3077580	.	C	T	4	9	13	0	0	13	0	0
22	3077603	.	A	C	6	12	18	0	0	18	0	0
22	3077621	.	T	C	6	11	17	0	2	19	0	0
22	3077657	.	A	C	5	9	14	0	1	15	0	0
22	3077768	.	G	A	5	9	14	0	1	15	0	0
22	3077828	.	A	G	4	0	4	0	5	9	0	0
22	3077864	.	T	A	4	6	10	0	1	11	0	0
22	3078101	.	T	C	1	5	6	0	0	6	0	0
22	3121191	.	T	G	1	6	7	0	0	7	0	0
22	3121451	.	C	A	0	5	5	0	5	10	0	0
22	3121531	.	A	T	4	3	7	0	0	7	0	0
22	3121683	.	T	A	6	3	9	0	1	10	0	0
22	3121725	.	T	G	9	8	17	0	1	18	0	0
22	3121789	.	A	T	9	11	20	0	0	20	0	0
22	3122004	.	A	G	3	6	9	0	1	10	0	0
22	3122040	.	A	G	4	2	6	0	0	6	0	0
22	3123805	.	G	A	5	4	9	0	0	9	0	0
22	3124031	.	G	A	4	4	8	0	0	8	0	0
22	3124071	.	C	T	0	5	5	0	2	7	0	0
22	3124132	.	G	T	7	6	13	0	2	15	0	0
22	3127257	.	T	C	13	0	13	0	9	22	0	0
22	3128036	.	T	A	7	7	14	1	2	17	0	0
22	3143236	.	C	T	2	7	9	0	11	20	0	0
22	3161346	.	C	T	3	9	12	0	0	12	0	0
22	3162335	.	T	C	7	5	12	0	1	13	0	0
22	3162405	.	G	A	3	5	8	0	1	9	0	0
22	3169448	.	C	T	0	5	5	0	6	11	0	0
22	3169529	.	T	C	2	5	7	0	0	7	0	0
22	3169723	.	T	C	2	4	6	0	0	6	0	0
22	3172774	.	C	T	9	8	17	0	1	18	0	0
22	3177026	.	G	C	2	0	2	0	8	10	0	0
22	3177063	.	G	A	3	7	10	0	0	10	0	0
22	3177196	.	T	G	8	9	17	0	0	17	0	0
22	3177227	.	A	G	10	9	19	0	0	19	0	0
22	3181612	.	C	A	0	6	6	0	4	10	0	0
22	3182452	.	G	C	3	2	5	0	7	12	0	0
22	3182457	.	T	C	7	8	15	0	0	15	0	0
22	3182698	.	G	C	10	5	15	0	0	15	0	0
22	3182728	.	T	C	8	4	12	0	1	13	0	0
22	3198047	.	C	T	5	4	9	0	0	9	0	0
22	3198158	.	C	T	2	3	5	0	0	5	0	0
22	3202141	.	C	G	5	3	8	0	1	9	0	0
22	3204054	.	G	A	4	4	8	0	1	9	0	0
22	3208098	.	A	G	2	3	5	0	2	7	0	0
22	3208281	.	A	G	8	8	16	0	0	16	0	0
22	3214279	.	G	A	4	5	9	0	0	9	0	0
22	3214309	.	G	A	2	5	7	0	0	7	0	0
22	3231635	.	A	G	4	1	5	0	8	13	0	0
22	3231677	.	T	G	3	12	15	0	1	16	0	0
22	3232370	.	T	A	5	4	9	0	0	9	0	0
22	3232967	.	T	C	1	2	3	0	0	3	0	0
22	3233100	.	G	A	0	3	3	0	4	7	0	0
22	3233298	.	A	C	14	5	19	2	3	24	0	0
22	3233302	.	A	G	6	0	6	2	10	24	6	0
22	3233974	.	G	C	4	6	10	0	0	10	0	0
22	3262925	.	C	T	2	8	10	0	3	13	0	0
22	3263129	.	T	C	7	8	15	0	1	16	0	0
22	3263318	.	A	G	11	6	17	0	1	18	0	0
22	3263672	.	G	T	9	7	16	0	1	17	0	0
22	3263917	.	C	T	12	13	25	0	0	25	0	0
22	3265889	.	C	A	6	8	14	0	0	14	0	0
22	3267636	.	C	T	5	9	14	0	1	15	0	0
22	3270790	.	G	A	2	7	9	0	1	10	0	0
22	3273527	.	C	A	4	8	12	0	0	12	0	0
22	3384831	.	G	A	22	28	50	0	0	50	0	0
22	3384844	.	C	T	25	19	44	0	2	46	0	0
22	3387865	.	T	C	4	9	13	0	0	13	0	0
22	3387946	.	T	C	3	0	3	0	6	9	0	0
22	3389500	.	T	G	10	20	30	0	1	31	0	0
22	3389606	.	A	G	12	18	30	0	0	30	0	0
22	3389615	.	T	C	12	15	27	0	0	27	0	0
22	3389803	.	G	A	14	19	33	0	0	33	0	0
22	3392768	.	A	T	10	17	27	0	3	30	0	0
22	3402151	.	A	G	15	12	27	0	1	28	0	0
22	3413876	.	C	T	11	6	17	0	1	18	0	0
22	3413993	.	G	A	16	8	24	0	0	24	0	0
22	4747456	.	C	A	1	3	4	0	1	5	0	0
22	4952789	.	G	T	4	2	6	0	0	6	0	0
22	4962472	.	T	A	3	6	9	0	0	9	0	0
22	4962559	.	G	A	12	5	17	0	1	18	0	0
22	4962610	.	A	T	13	8	21	0	0	22	1	0
22	4962635	.	A	G	12	12	24	0	0	24	0	0
22	4962696	.	T	C	13	14	27	0	0	27	0	0
22	4962878	.	G	A	12	15	27	0	0	27	0	0
22	4968955	.	A	G	18	17	35	1	2	38	0	0
22	4969051	.	G	A	23	7	30	0	0	30	0	0
22	4970773	.	T	C	14	0	14	0	15	29	0	0
22	4970797	.	G	C	18	10	28	0	0	28	0	0
22	4972848	.	T	G	13	12	25	0	5	30	0	0
22	4972980	.	C	T	4	15	19	0	12	31	0	0
22	4975236	.	T	A	12	20	32	0	6	38	0	0
22	4977106	.	G	A	10	14	24	0	1	25	0	0
22	4985831	.	G	C	9	6	15	0	0	15	0	0
22	4985888	.	T	C	7	0	7	0	7	14	0	0
22	5056425	.	G	T	11	8	19	0	0	19	0	0
22	5056706	.	G	A	12	3	15	0	0	15	0	0
22	5056760	.	T	G	10	19	29	0	0	29	0	0
22	5056978	.	A	T	9	5	14	0	2	16	0	0
22	5057421	.	C	A	0	8	8	0	7	15	0	0
22	5057443	.	T	C	7	0	7	0	8	15	0	0
22	5057489	.	T	A	9	6	15	0	0	15	0	0
22	5057504	.	T	A	8	5	13	0	1	14	0	0
22	5059916	.	A	G	16	9	25	0	0	25	0	0
22	5060087	.	T	G	9	11	20	0	0	20	0	0
22	5060162	.	T	A	16	10	26	0	1	28	1	0
22	5062457	.	G	A	4	11	15	0	0	15	0	0
22	5075291	.	T	C	6	10	16	1	0	17	0	0
22	5075390	.	A	G	5	4	9	0	0	9	0	0
22	5075673	.	A	G	9	8	17	0	2	19	0	0
22	5075732	.	T	C	6	10	16	0	0	16	0	0
22	5087451	.	G	A	14	15	29	1	0	30	0	0
22	5087488	.	G	A	10	11	21	0	1	22	0	0
22	5090115	.	C	A	2	11	13	0	18	31	0	0
22	5098433	.	G	T	13	20	33	0	0	33	0	0
22	5103769	.	G	A	4	3	7	0	0	7	0	0
22	5109554	.	G	A	28	33	61	1	0	62	0	0
22	5109560	.	T	A	28	27	55	1	4	60	0	0
22	5112644	.	G	T	28	18	46	0	0	46	0	0
22	5112749	.	T	C	33	16	49	0	3	52	0	0
22	5112864	.	G	A	26	16	42	0	2	44	0	0
22	5112915	.	A	C	24	22	46	0	3	49	0	0
22	5114380	.	G	C	2	34	36	1	22	59	0	0
22	5116267	.	A	C	11	9	20	0	0	20	0	0
22	5118373	.	A	G	1	0	1	0	2	3	0	0
22	5118378	.	G	A	1	3	4	0	1	5	0	0
22	5118437	.	C	T	4	6	10	0	0	10	0	0
22	5121464	.	C	T	7	10	17	0	3	20	0	0
22	5121471	.	C	T	8	10	18	0	1	19	0	0
22	5121623	.	A	G	6	0	6	0	7	13	0	0
22	5135241	.	T	A	8	7	15	0	0	15	0	0
22	5140750	.	G	A	5	3	8	0	0	8	0	0
22	5140774	.	G	C	3	0	3	0	5	8	0	0
22	5144566	.	G	C	5	7	12	0	0	12	0	0
22	5144645	.	C	T	10	9	19	0	0	19	0	0
22	5144750	.	T	A	3	3	6	0	0	6	0	0
22	5144981	.	T	C	7	3	10	0	1	11	0	0
22	5145109	.	C	A	5	6	11	0	0	11	0	0
22	5228744	.	G	A	2	5	7	10	12	29	0	0
22	5228882	.	A	C	1	6	7	2	0	9	0	0
22	5228889	.	A	G	1	5	6	3	1	10	0	0
22	5229077	.	T	C	14	9	23	0	2	25	0	0
22	5230339	.	A	G	15	11	26	6	2	34	0	0
22	5909268	.	T	C	1	3	4	0	0	4	0	0
22	5909293	.	C	T	1	2	3	0	0	3	0	0
22	5909310	.	T	A	1	2	3	0	0	3	0	0
22	6074079	.	A	T	2	6	8	0	0	8	0	0
22	6075315	.	T	C	4	5	9	0	1	10	0	0
22	6077657	.	T	C	3	0	3	0	5	8	0	0
22	6080380	.	G	A	2	5	7	0	0	7	0	0
22	6183420	.	A	T	2	2	4	0	0	4	0	0
22	6300363	.	C	T	5	5	10	0	0	10	0	0
22	6353494	.	G	T	1	3	4	0	0	4	0	0
22	6527546	.	C	T	4	8	12	0	0	12	0	0
22	6527553	.	C	A	0	4	4	0	11	15	0	0
22	6528059	.	A	T	8	4	12	0	0	12	0	0
22	6528151	.	T	C	5	4	9	2	0	11	0	0
22	6528177	.	C	T	0	6	6	0	3	9	0	0
22	6528313	.	T	C	5	0	5	0	8	13	0	0
22	6528586	.	C	T	9	6	15	0	0	15	0	0
22	6528632	.	C	T	4	4	8	0	1	9	0	0
22	6528746	.	A	G	5	4	9	0	1	10	0	0
22	6529143	.	T	C	2	1	3	0	4	7	0	0
22	6546796	.	G	A	2	5	7	0	0	7	0	0
22	6546800	.	T	C	2	4	6	0	0	6	0	0
22	6546965	.	C	G	4	2	6	0	0	6	0	0
22	6547014	.	G	A	4	2	6	0	0	6	0	0
22	6547035	.	G	A	3	2	5	0	0	5	0	0
22	6547309	.	C	T	2	3	5	0	0	5	0	0
22	6548057	.	G	A	3	3	6	0	1	7	0	0
22	6548072	.	G	A	5	3	8	0	0	9	1	0
22	6548408	.	C	T	2	3	5	0	0	5	0	0
22	6960934	.	A	T	2	2	4	0	0	4	0	0
22	6960938	.	T	G	2	2	4	0	0	4	0	0
22	6996343	.	G	A	9	12	21	0	1	22	0	0
22	6998904	.	A	G	17	17	34	0	0	34	0	0
22	6998949	.	G	T	15	14	29	0	0	29	0	0
22	6998988	.	T	C	17	14	31	0	2	33	0	0
22	6999006	.	A	G	19	11	30	0	0	30	0	0
22	6999060	.	G	C	7	0	7	0	11	18	0	0
22	6999148	.	T	A	6	13	19	0	1	20	0	0
22	7001474	.	G	T	5	5	10	0	0	10	0	0
22	7001528	.	C	T	7	4	11	0	1	12	0	0
22	7001827	.	G	A	5	7	12	0	1	13	0	0
22	7003603	.	A	G	4	6	10	0	0	10	0	0
22	7006913	.	T	C	8	0	8	0	7	15	0	0
22	7009333	.	A	T	14	11	25	0	2	27	0	0
22	7009833	.	C	T	2	9	11	0	1	12	0	0
22	7009835	.	T	G	2	8	10	0	2	12	0	0
22	7009911	.	A	G	5	9	14	0	0	14	0	0
22	7009915	.	C	T	1	8	9	0	6	15	0	0
22	7010011	.	A	C	19	18	37	0	0	37	0	0
22	7010100	.	T	C	23	0	23	0	16	39	0	0
22	7010151	.	T	C	20	15	35	0	1	36	0	0
22	7012898	.	C	T	2	17	19	0	10	29	0	0
22	7012931	.	C	G	16	16	32	0	2	34	0	0
22	7016655	.	A	G	21	18	39	0	1	40	0	0
22	7018223	.	G	A	14	14	28	0	0	28	0	0
22	7019397	.	C	A	0	22	22	0	17	39	0	0
22	7019701	.	T	A	10	16	26	0	1	28	1	0
22	7044634	.	C	G	10	6	16	0	0	16	0	0
22	7044667	.	T	G	5	12	17	0	0	17	0	0
22	7044681	.	T	C	3	12	15	0	0	15	0	0
22	7045031	.	G	A	3	13	16	0	0	16	0	0
22	7045041	.	C	A	3	11	14	0	1	15	0	0
22	7045070	.	C	T	8	7	15	0	0	15	0	0
22	7045215	.	A	G	4	13	17	0	1	18	0	0
22	7056645	.	C	T	16	13	29	0	1	30	0	0
22	7128829	.	C	T	1	4	5	0	6	11	0	0
22	7128897	.	C	G	4	3	7	0	0	7	0	0
22	7129007	.	A	G	1	3	4	0	0	4	0	0
22	7129110	.	C	T	0	3	3	0	6	9	0	0
22	7129212	.	G	C	8	3	11	0	0	11	0	0
22	7359844	.	T	C	7	8	15	0	0	15	0	0
22	7400193	.	A	G	9	12	21	0	1	22	0	0
22	7523858	.	A	G	1	3	4	0	0	4	0	0
22	7526963	.	C	G	1	2	3	0	0	3	0	0
22	7526994	.	G	A	1	3	4	0	0	4	0	0
22	7528153	.	C	T	0	2	2	0	1	3	0	0
22	7542756	.	A	T	8	2	10	0	0	10	0	0
22	7545956	.	T	A	3	2	5	0	0	5	0	0
22	7556516	.	C	T	2	2	4	0	0	4	0	0
22	7558417	.	C	T	2	3	5	0	0	5	0	0
22	7558430	.	T	A	2	4	6	0	0	6	0	0
22	7676984	.	G	T	1	3	4	1	0	5	0	0
22	7677356	.	C	T	1	3	4	0	0	4	0	0
22	7677409	.	T	A	4	2	6	3	0	9	0	0
22	7677434	.	G	A	3	2	5	4	0	9	0	0
22	7682820	.	T	A	9	2	11	1	0	12	0	0
22	7682825	.	T	G	8	2	10	1	0	11	0	0
22	7682887	.	A	C	1	3	4	0	0	4	0	0
22	7682888	.	C	T	1	3	4	0	0	4	0	0
22	7683668	.	A	T	16	4	20	2	0	22	0	0
22	7683759	.	C	T	0	10	10	0	5	15	0	0
22	7693582	.	T	A	2	3	5	0	0	5	0	0
22	7693586	.	A	T	3	2	5	0	0	5	0	0
22	7972538	.	C	T	0	3	3	0	7	10	0	0
22	7972544	.	G	A	4	7	11	0	0	11	0	0
22	7972792	.	A	G	4	3	7	0	0	7	0	0
22	7972848	.	A	G	5	6	11	1	0	12	0	0
22	7972851	.	T	C	4	6	10	1	0	11	0	0
22	7974164	.	C	A	5	4	9	4	0	13	0	0
22	7974277	.	A	C	2	2	4	0	0	4	0	0
22	7974302	.	C	G	2	4	6	0	0	6	0	0
22	8074068	.	G	T	4	2	6	5	0	11	0	0
22	8074093	.	T	A	3	4	7	3	0	10	0	0
22	8161183	.	A	C	10	7	17	0	0	17	0	0
22	8163863	.	T	C	8	1	9	0	4	13	0	0
22	8163993	.	G	T	9	10	19	0	0	19	0	0
22	8164035	.	C	T	2	11	13	0	0	13	0	0
22	8296714	.	C	T	6	9	15	0	1	16	0	0
22	8296763	.	G	T	5	9	14	0	0	14	0	0
22	8328718	.	T	C	1	3	4	0	0	4	0	0
22	8328719	.	G	A	1	3	4	0	0	4	0	0
22	8339700	.	G	C	5	3	8	0	0	8	0	0
22	8341167	.	A	G	5	2	7	0	0	7	0	0
22	8341173	.	T	C	8	2	10	0	0	10	0	0
22	8341622	.	C	T	1	1	2	0	1	3	0	0
22	8342310	.	A	T	1	2	3	0	0	3	0	0
22	8342535	.	G	A	5	3	8	0	0	8	0	0
22	8347393	.	C	T	4	11	15	0	0	15	0	0
22	8347478	.	G	C	5	2	7	1	0	8	0	0
22	8347579	.	A	G	2	10	12	0	0	12	0	0
22	8348028	.	A	G	6	3	9	0	0	9	0	0
22	8351214	.	T	C	2	6	8	0	0	8	0	0
22	8351215	.	G	A	2	6	8	0	0	8	0	0
22	8351431	.	A	T	4	3	7	0	0	7	0	0
22	8639593	.	T	G	1	2	3	0	0	3	0	0
22	8639622	.	T	C	1	2	3	0	0	3	0	0
22	8715470	.	A	T	4	4	8	0	0	9	1	0
22	8719170	.	T	C	1	8	9	3	1	13	0	0
22	8769274	.	T	G	4	1	5	0	0	5	0	0
22	8769428	.	A	G	1	3	4	0	0	4	0	0
22	8769777	.	G	A	1	3	4	0	0	4	0	0
22	8769782	.	C	T	1	2	3	0	0	3	0	0
22	8770151	.	T	G	3	4	7	0	0	7	0	0
22	8770153	.	G	A	3	4	7	0	0	7	0	0
22	8775160	.	C	G	4	0	4	0	3	7	0	0
22	8775207	.	G	A	4	4	8	0	0	8	0	0
22	8784184	.	A	G	2	0	2	0	2	4	0	0
22	8784585	.	T	A	1	3	4	0	0	4	0	0
22	8785223	.	G	A	1	3	4	1	0	5	0	0
22	8785303	.	T	A	2	2	4	1	0	5	0	0
22	8785313	.	C	A	2	2	4	2	0	6	0	0
22	8785621	.	C	T	2	4	6	0	0	6	0	0
22	8785647	.	T	C	4	5	9	0	0	9	0	0
22	8785914	.	C	T	2	3	5	0	0	5	0	0
22	8785965	.	C	T	4	3	7	0	1	8	0	0
22	8786022	.	G	A	3	5	8	0	0	8	0	0
22	8786056	.	T	G	2	2	4	0	0	4	0	0
22	8786177	.	A	G	0	3	3	0	1	5	1	0
22	8786178	.	G	T	2	3	5	0	0	5	0	0
22	8787194	.	T	A	4	4	8	0	0	8	0	0
22	8787335	.	G	C	2	2	4	0	0	4	0	0
22	8787704	.	A	C	2	4	6	0	0	6	0	0
22	8995871	.	G	A	6	3	9	0	0	9	0	0
22	8995902	.	G	A	3	1	4	0	0	4	0	0
22	8995908	.	A	T	3	2	5	0	0	5	0	0
22	9052827	.	C	T	2	2	4	0	0	4	0	0
22	9062299	.	T	G	4	3	7	0	0	7	0	0
22	9062307	.	G	A	3	3	6	0	0	6	0	0
22	9472870	.	T	C	7	9	16	0	0	16	0	0
22	9472873	.	T	C	6	10	16	0	1	17	0	0
22	9483293	.	C	T	13	14	27	0	0	27	0	0
22	9484355	.	T	C	13	10	23	0	0	23	0	0
22	9489885	.	A	G	15	9	24	1	0	25	0	0
22	9490730	.	C	T	13	13	26	0	2	28	0	0
22	9494144	.	A	G	16	17	33	0	0	33	0	0
22	9496453	.	C	T	5	15	20	0	1	21	0	0
22	9496608	.	A	G	7	12	19	0	1	20	0	0
22	9496766	.	T	C	8	13	21	0	0	21	0	0
22	9496781	.	C	A	8	14	22	0	1	23	0	0
22	9496933	.	T	A	13	16	29	0	0	29	0	0
22	9496954	.	G	A	2	18	20	0	15	35	0	0
22	9499564	.	C	T	19	12	31	0	1	32	0	0
22	9499579	.	C	G	19	0	19	0	8	27	0	0
22	9499762	.	T	C	11	15	26	0	0	26	0	0
22	9508704	.	T	G	12	22	34	1	1	36	0	0
22	9509637	.	G	A	1	10	11	0	21	32	0	0
22	9512565	.	A	C	27	17	44	0	3	47	0	0
22	9512628	.	T	C	21	23	44	0	0	44	0	0
22	9512630	.	T	C	21	23	44	0	0	44	0	0
22	9512670	.	C	T	21	19	40	0	2	42	0	0
22	9512717	.	C	T	17	7	24	2	0	26	0	0
22	9512731	.	T	A	17	5	22	2	1	25	0	0
22	9512829	.	A	G	5	9	14	0	1	15	0	0
22	9512885	.	T	G	9	2	11	0	4	15	0	0
22	9513039	.	C	T	13	13	26	0	0	26	0	0
22	9513048	.	T	C	12	13	25	0	1	26	0	0
22	9523557	.	A	T	16	9	25	0	0	25	0	0
22	9523618	.	A	G	12	9	21	0	1	22	0	0
22	9524673	.	T	C	9	10	19	0	1	20	0	0
22	9525415	.	C	T	11	8	19	0	1	20	0	0
22	9526254	.	T	G	5	9	14	0	0	14	0	0
22	9526389	.	C	T	4	11	15	0	0	15	0	0
22	9527373	.	T	C	6	7	13	0	1	14	0	0
22	9527409	.	T	C	14	10	24	0	0	24	0	0
22	9527439	.	G	T	13	9	22	0	4	26	0	0
22	9527450	.	C	G	17	10	27	0	1	28	0	0
22	9527983	.	A	G	5	15	20	0	4	24	0	0
22	9530328	.	T	C	9	13	22	0	0	22	0	0
22	9530388	.	C	T	8	12	20	0	0	20	0	0
22	9530418	.	A	G	6	0	6	0	11	17	0	0
22	9530571	.	T	C	12	10	22	0	0	22	0	0
22	9530598	.	G	A	10	11	21	0	1	22	0	0
22	9532339	.	C	T	13	6	19	0	1	20	0	0
22	9532431	.	G	A	12	8	20	0	1	21	0	0
22	9532455	.	T	C	8	16	24	0	0	24	0	0
22	9534066	.	C	T	9	18	27	0	0	27	0	0
22	9534138	.	C	T	17	8	25	0	0	25	0	0
22	9535191	.	T	C	12	12	24	0	0	24	0	0
22	9535290	.	C	T	6	17	23	0	2	25	0	0
22	9535890	.	T	C	11	8	19	0	0	19	0	0
22	9535914	.	G	A	14	7	21	0	0	21	0	0
22	9536134	.	G	A	3	12	15	0	7	22	0	0
22	9536984	.	C	T	6	10	16	0	0	16	0	0
22	9537165	.	A	G	13	12	25	0	3	28	0	0
22	9537186	.	T	C	11	18	29	0	1	30	0	0
22	9537267	.	T	C	5	16	21	0	2	23	0	0
22	9537339	.	C	T	10	11	21	0	2	23	0	0
22	9537637	.	T	C	15	19	34	0	0	34	0	0
22	9537640	.	T	C	16	18	34	0	1	35	0	0
22	9537779	.	A	G	9	2	11	0	4	15	0	0
22	9537859	.	C	T	8	4	12	0	1	13	0	0
22	9538004	.	C	T	3	3	6	0	0	6	0	0
22	9538011	.	G	C	3	3	6	0	0	6	0	0
22	9824674	.	T	G	1	1	2	0	1	3	0	0
22	9828656	.	C	A	1	4	5	0	0	5	0	0
22	9834718	.	G	A	3	3	6	0	0	6	0	0
22	9835039	.	C	T	2	5	7	0	0	7	0	0
22	9835096	.	A	G	4	5	9	0	0	9	0	0
22	9835189	.	T	C	4	5	9	0	0	9	0	0
22	9835438	.	T	C	1	4	5	0	0	5	0	0
22	9835951	.	A	G	1	2	3	0	0	3	0	0
22	9836274	.	T	A	3	3	6	0	0	6	0	0
22	9836301	.	G	C	1	3	4	0	1	5	0	0
22	9836312	.	C	A	0	5	5	0	2	7	0	0
22	9836348	.	T	C	2	2	4	0	0	4	0	0
22	9836443	.	T	G	4	3	7	1	0	8	0	0
22	9862913	.	G	A	0	2	2	0	2	4	0	0
22	9862922	.	T	A	3	2	5	0	0	5	0	0
22	9862962	.	T	C	1	3	4	0	0	4	0	0
22	9878324	.	C	A	7	2	9	0	0	9	0	0
22	9878335	.	G	A	0	2	2	0	5	7	0	0
22	9886990	.	C	T	0	4	4	0	3	7	0	0
22	9887054	.	A	T	4	5	9	0	0	9	0	0
22	9887293	.	A	G	3	6	9	0	0	9	0	0
22	9887881	.	A	G	3	3	6	1	0	7	0	0
22	9888591	.	A	G	1	3	4	0	0	4	0	0
22	9893577	.	G	T	3	2	5	8	1	14	0	0
22	9894218	.	C	T	2	4	6	4	0	10	0	0
22	9898031	.	A	G	1	3	4	0	0	4	0	0
22	9898190	.	A	C	2	5	7	0	0	7	0	0
22	9898259	.	C	A	6	8	14	0	0	14	0	0
22	9898277	.	C	T	0	8	8	2	5	15	0	0
22	9898445	.	G	A	2	3	5	1	0	6	0	0
22	9899279	.	A	G	6	2	8	0	0	8	0	0
22	9899717	.	T	C	2	3	5	7	0	12	0	0
22	9899741	.	A	G	1	5	6	2	0	8	0	0
22	9900443	.	T	C	1	2	3	0	0	3	0	0
22	9926204	.	A	G	6	2	8	0	0	8	0	0
22	9933972	.	C	T	1	4	5	0	1	6	0	0
22	9934095	.	T	G	3	6	9	0	1	10	0	0
22	9934109	.	A	G	5	5	10	0	0	10	0	0
22	10019376	.	G	A	3	3	6	0	0	6	0	0
22	10019568	.	C	T	2	7	9	0	0	9	0	0
22	10019645	.	C	G	6	6	12	0	0	12	0	0
22	10039100	.	G	T	2	2	4	0	0	4	0	0
22	10039124	.	T	C	1	2	3	0	0	3	0	0
22	10039367	.	C	T	1	3	4	0	0	4	0	0
22	10039376	.	T	C	0	0	0	0	3	3	0	0
22	10039497	.	G	A	3	4	7	0	0	7	0	0
22	10039889	.	G	T	2	2	4	0	1	5	0	0
22	10040000	.	G	A	6	2	8	0	0	8	0	0
22	10040015	.	C	T	0	7	7	0	4	11	0	0
22	10040099	.	C	T	0	2	2	0	1	3	0	0
22	10048389	.	G	T	1	5	6	0	0	6	0	0
22	10048454	.	T	C	3	3	6	0	0	6	0	0
22	10049524	.	C	G	2	2	4	1	0	5	0	0
22	10071117	.	G	A	3	4	7	0	1	8	0	0
22	10123910	.	G	C	12	11	23	0	0	23	0	0
22	10123962	.	T	C	7	0	7	0	11	18	0	0
22	10123998	.	C	T	0	7	7	0	14	21	0	0
22	10129878	.	A	G	9	7	16	0	2	18	0	0
22	10151000	.	G	A	1	2	3	0	0	3	0	0
22	10159001	.	C	T	3	5	8	0	0	8	0	0
22	10159339	.	C	T	11	8	19	0	0	19	0	0
22	10162958	.	A	T	10	4	14	0	0	14	0	0
22	10164417	.	C	G	1	2	3	0	0	3	0	0
22	10164418	.	G	C	0	2	2	0	1	3	0	0
22	10168219	.	T	C	8	8	16	0	0	16	0	0
22	10184031	.	G	T	9	11	20	0	0	20	0	0
22	10188095	.	C	T	7	12	19	0	0	19	0	0
22	10196297	.	A	T	11	11	22	0	0	22	0	0
22	10196330	.	C	T	7	15	22	2	0	24	0	0
22	10196394	.	G	A	1	9	10	0	16	26	0	0
22	10196468	.	A	T	9	11	20	0	0	20	0	0
22	10196483	.	A	G	8	10	18	0	1	19	0	0
22	10196621	.	C	A	15	11	26	0	0	26	0	0
22	10196634	.	C	T	16	9	25	0	2	27	0	0
22	10196864	.	G	A	19	8	27	1	0	28	0	0
22	10196951	.	C	A	11	14	25	0	0	25	0	0
22	10197061	.	C	T	9	11	20	0	1	21	0	0
22	10197100	.	T	G	14	5	19	0	0	19	0	0
22	10197146	.	C	T	17	12	29	0	2	31	0	0
22	10197180	.	T	A	28	11	39	0	1	40	0	0
22	10197796	.	G	C	0	10	10	0	10	20	0	0
22	10198075	.	T	G	6	1	7	0	3	10	0	0
22	10198120	.	A	T	6	5	11	0	0	11	0	0
22	10198167	.	G	A	8	10	18	0	0	18	0	0
22	10198178	.	A	T	6	10	16	0	1	17	0	0
22	10198211	.	T	C	6	8	14	0	1	15	0	0
22	10198232	.	T	A	6	7	13	0	1	14	0	0
22	10198283	.	T	C	9	7	16	0	1	17	0	0
22	10198335	.	A	C	18	13	31	0	1	32	0	0
22	10198399	.	T	A	15	20	35	0	1	37	1	0
22	10198737	.	G	A	8	9	17	0	0	17	0	0
22	10198779	.	G	C	6	8	14	1	0	16	1	0
22	10201858	.	G	C	1	9	10	0	6	16	0	0
22	10201888	.	G	A	18	23	41	0	1	42	0	0
22	10201906	.	G	A	1	26	27	0	25	52	0	0
22	10205736	.	C	T	23	28	51	0	2	53	0	0
22	10207978	.	A	T	29	19	48	0	0	48	0	0
22	10208011	.	T	C	25	28	53	0	1	54	0	0
22	10208032	.	A	C	26	22	48	0	2	50	0	0
22	10208089	.	C	T	27	24	51	0	2	53	0	0
22	10208101	.	T	G	28	25	53	0	5	58	0	0
22	10208134	.	G	A	27	25	52	0	0	52	0	0
22	10208182	.	C	T	20	28	48	0	4	52	0	0
22	10208404	.	C	T	20	23	43	0	1	44	0	0
22	10210467	.	T	C	29	19	48	0	2	50	0	0
22	10211754	.	C	T	24	20	44	0	0	44	0	0
22	10212089	.	C	T	20	23	43	0	5	48	0	0
22	10212161	.	A	C	26	22	48	0	4	52	0	0
22	10212230	.	C	G	16	26	42	0	2	44	0	0
22	10212417	.	T	A	6	12	18	0	1	19	0	0
22	10215007	.	T	C	8	4	12	0	0	12	0	0
22	10215008	.	G	A	8	4	12	0	0	12	0	0
22	10215120	.	A	G	6	3	9	0	0	9	0	0
22	10215135	.	A	G	4	4	8	0	1	9	0	0
22	10220257	.	C	T	6	7	13	0	0	13	0	0
22	10220259	.	T	C	7	6	13	0	1	14	0	0
22	10220298	.	A	T	10	6	16	0	0	16	0	0
22	10220444	.	G	T	1	15	16	0	9	25	0	0
22	10220451	.	C	T	16	10	26	0	0	26	0	0
22	10260078	.	A	G	3	5	8	0	0	8	0	0
22	10260468	.	A	G	4	0	4	0	5	9	0	0
22	10260774	.	C	T	9	5	14	0	1	15	0	0
22	10260828	.	C	T	7	5	12	0	0	12	0	0
22	10261037	.	C	T	2	5	7	0	0	7	0	0
22	10261792	.	T	A	8	6	14	0	0	14	0	0
22	10261840	.	T	C	9	10	19	0	1	20	0	0
22	10261888	.	C	T	9	11	20	0	2	22	0	0
22	10261945	.	A	C	11	13	24	0	1	25	0	0
22	10262216	.	A	T	8	4	12	0	0	12	0	0
22	10361385	.	C	G	3	4	7	0	2	9	0	0
22	10361391	.	T	C	5	3	8	0	1	9	0	0
22	10361577	.	G	C	8	0	8	0	7	15	0	0
22	10361787	.	C	G	11	8	19	0	1	20	0	0
22	10361889	.	A	G	14	5	19	0	0	19	0	0
22	10361892	.	A	G	12	6	18	0	1	19	0	0
22	10361937	.	C	T	0	5	5	0	9	14	0	0
22	10361964	.	T	C	9	0	9	0	13	22	0	0
22	10362003	.	T	G	15	6	21	0	0	22	1	0
22	10362174	.	C	T	1	9	10	0	10	20	0	0
22	10364681	.	A	G	7	8	15	0	1	16	0	0
22	10372847	.	C	T	0	14	14	0	11	25	0	0
22	10372950	.	A	C	9	0	9	0	9	18	0	0
22	10373081	.	T	C	13	0	13	0	8	21	0	0
22	10373118	.	A	T	8	7	15	0	2	17	0	0
22	10373263	.	G	T	10	8	18	0	1	19	0	0
22	10373795	.	A	T	4	4	8	0	0	8	0	0
22	10373849	.	G	A	3	3	6	0	2	8	0	0
22	10373879	.	C	A	4	3	7	0	1	8	0	0
22	10373915	.	T	C	3	6	9	0	0	9	0	0
22	10373931	.	T	A	11	3	14	0	0	14	0	0
22	10374012	.	G	A	11	8	19	0	0	19	0	0
22	10374042	.	A	C	13	6	19	0	2	21	0	0
22	10383159	.	A	G	9	7	16	0	1	17	0	0
22	10390580	.	T	A	3	4	7	0	1	8	0	0
22	10390824	.	G	C	4	8	12	0	0	12	0	0
22	10391347	.	C	T	10	6	16	0	0	16	0	0
22	10393045	.	C	T	3	9	12	0	0	12	0	0
22	10396692	.	G	A	5	4	9	0	0	9	0	0
22	10397610	.	G	T	5	7	12	0	0	12	0	0
22	10428509	.	A	C	4	3	7	0	1	8	0	0
22	10430183	.	C	A	0	3	3	0	3	6	0	0
22	10430189	.	A	G	4	2	6	0	0	6	0	0
22	10430252	.	A	G	4	2	6	0	0	6	0	0
22	10430572	.	G	A	5	7	12	0	1	13	0	0
22	10430709	.	T	C	6	4	10	0	1	11	0	0
22	10434709	.	T	A	3	5	8	0	0	8	0	0
22	10434738	.	C	A	6	4	10	0	0	10	0	0
22	10436247	.	G	A	1	2	3	0	0	3	0	0
22	10436314	.	A	T	4	2	6	0	0	6	0	0
22	10436363	.	G	C	1	4	5	0	0	5	0	0
22	10514154	.	T	A	4	2	6	0	0	6	0	0
22	10514288	.	G	T	6	7	13	0	0	13	0	0
22	10514303	.	G	C	5	0	5	0	6	11	0	0
22	10516808	.	C	T	4	3	7	0	0	7	0	0
22	10517499	.	T	C	5	1	6	0	3	9	0	0
22	10517505	.	A	C	5	1	6	0	3	9	0	0
22	10545308	.	A	G	2	0	2	0	3	5	0	0
22	10638667	.	G	T	5	2	7	0	0	7	0	0
22	12391474	.	A	G	4	0	4	0	3	7	0	0
22	12391475	.	A	G	4	3	7	0	0	7	0	0
22	13977910	.	T	G	4	8	12	0	0	12	0	0
22	13978228	.	T	C	9	8	17	0	0	17	0	0
22	13978465	.	A	G	13	0	13	0	9	22	0	0
22	13978480	.	T	C	9	8	17	0	0	17	0	0
22	13978849	.	C	T	4	4	8	0	3	11	0	0
22	13979234	.	C	T	3	2	5	0	0	5	0	0
22	14077017	.	A	G	2	3	5	0	0	5	0	0
22	14077029	.	T	C	3	2	5	0	0	5	0	0
22	14078027	.	C	T	5	2	7	0	0	7	0	0
22	14083209	.	T	C	7	2	9	0	0	9	0	0
22	14083218	.	A	G	8	0	8	0	3	11	0	0
22	14083532	.	T	C	3	6	9	0	0	9	0	0
22	14124381	.	C	T	15	20	35	0	2	37	0	0
22	14124465	.	G	A	16	20	36	0	1	37	0	0
22	14124655	.	C	T	21	15	36	0	1	37	0	0
22	14366222	.	G	A	3	7	10	0	2	12	0	0
22	14381780	.	A	T	2	5	7	0	0	7	0	0
22	14381812	.	G	T	4	4	8	0	1	9	0	0
22	14390053	.	A	T	4	3	7	0	1	8	0	0
22	14398645	.	G	A	3	2	5	0	0	5	0	0
22	14404788	.	C	A	2	4	6	0	0	6	0	0
22	14422533	.	A	T	2	4	6	0	0	6	0	0
22	14427749	.	G	A	2	4	6	0	0	6	0	0
22	14454650	.	T	C	2	3	5	0	1	6	0	0
22	14458857	.	T	A	3	4	7	0	0	7	0	0
22	14459518	.	A	G	1	2	3	0	0	3	0	0
22	14461547	.	A	C	1	0	1	0	3	4	0	0
22	14539620	.	C	T	0	1	1	0	2	3	0	0
22	14539725	.	A	G	1	5	6	0	0	6	0	0
22	14556620	.	T	C	1	3	4	0	0	4	0	0
22	14556663	.	A	T	1	2	3	0	1	4	0	0
22	14557666	.	T	C	2	3	5	0	1	6	0	0
22	14603729	.	G	A	2	2	4	0	1	5	0	0
22	15009267	.	G	A	5	4	9	0	0	9	0	0
22	15010349	.	T	C	6	4	10	0	0	10	0	0
22	15010490	.	A	C	3	0	3	0	3	6	0	0
22	15010508	.	G	A	3	2	5	0	0	5	0	0
22	15010604	.	C	A	6	6	12	0	1	13	0	0
22	15251931	.	T	C	1	2	3	0	0	3	0	0
22	15345339	.	T	A	4	5	9	0	0	9	0	0
22	15384695	.	T	C	8	0	8	0	7	15	0	0
22	15384759	.	A	T	7	5	12	0	0	12	0	0
22	15385143	.	T	A	6	4	10	0	1	11	0	0
22	15385422	.	A	G	4	2	6	0	0	6	0	0
22	15464100	.	C	T	1	3	4	0	1	5	0	0
22	15541277	.	C	T	5	7	12	0	0	12	0	0
22	15543490	.	C	T	6	7	13	0	0	13	0	0
22	15545930	.	T	A	10	9	19	0	0	19	0	0
22	15548150	.	C	T	7	10	17	0	1	18	0	0
22	15593456	.	C	G	1	2	3	0	0	3	0	0
22	15627810	.	C	T	1	3	4	0	0	4	0	0
22	15628710	.	G	A	9	5	14	0	1	15	0	0
22	15628909	.	C	A	8	5	13	0	0	13	0	0
22	15629043	.	G	A	5	2	7	0	1	8	0	0
22	15629923	.	C	T	4	5	9	0	1	10	0	0
22	15696007	.	A	G	21	22	43	0	0	43	0	0
22	15696026	.	A	G	25	24	49	0	0	49	0	0
22	15696191	.	T	G	17	31	48	0	2	50	0	0
22	15700157	.	C	T	0	19	19	0	10	29	0	0
22	15701561	.	G	A	23	11	34	0	1	35	0	0
22	15701636	.	A	G	26	25	51	0	0	51	0	0
22	15704622	.	C	T	18	31	49	0	1	50	0	0
22	15719625	.	T	A	12	12	24	0	1	25	0	0
22	15719672	.	G	T	15	11	26	0	1	27	0	0
22	15719682	.	G	A	14	11	25	0	0	25	0	0
22	15719891	.	T	C	12	18	30	0	1	31	0	0
22	15720199	.	A	G	5	13	18	0	0	18	0	0
22	15720200	.	C	A	2	13	15	0	4	19	0	0
22	15720250	.	T	G	16	10	26	0	0	26	0	0
22	15720583	.	C	T	6	4	10	0	0	10	0	0
22	15721534	.	C	T	0	5	5	0	1	6	0	0
22	15721558	.	C	G	5	3	8	0	0	8	0	0
22	15900745	.	T	C	2	3	5	0	0	5	0	0
22	15900812	.	T	C	5	3	8	0	0	8	0	0
22	15912259	.	A	G	10	9	19	0	1	20	0	0
22	15912298	.	C	T	16	10	26	0	2	28	0	0
22	15912346	.	C	T	1	17	18	0	11	29	0	0
22	15915994	.	G	A	4	1	5	0	1	6	0	0
22	15916027	.	A	T	1	4	5	0	1	6	0	0
22	15917855	.	G	A	12	13	25	0	2	27	0	0
22	15929136	.	A	G	11	20	31	0	1	32	0	0
22	15932428	.	C	A	15	19	34	0	0	34	0	0
22	15943833	.	G	A	9	16	25	0	1	26	0	0
22	15979490	.	T	G	4	5	9	0	0	9	0	0
22	15979650	.	G	A	0	6	6	0	3	9	0	0
22	15979827	.	C	T	6	4	10	0	0	10	0	0
22	15987864	.	G	A	2	2	4	0	1	5	0	0
22	15987966	.	A	T	4	3	7	0	0	7	0	0
22	15996502	.	T	C	4	3	7	0	0	7	0	0
22	16000383	.	C	T	5	4	9	0	0	9	0	0
22	16002106	.	C	T	4	8	12	1	3	16	0	0
22	16002121	.	C	G	4	0	4	1	11	16	0	0
22	16002161	.	T	C	7	9	16	0	1	17	0	0
22	16002283	.	A	T	10	8	18	0	1	19	0	0
22	16002397	.	C	T	4	5	9	0	0	9	0	0
22	16032205	.	G	A	2	4	6	0	0	6	0	0
22	16032550	.	T	G	9	3	12	0	0	12	0	0
22	16033259	.	T	C	2	5	7	0	1	8	0	0
22	16033622	.	G	T	7	6	13	0	1	14	0	0
22	16038660	.	G	A	5	8	13	0	0	13	0	0
22	16038749	.	A	G	10	13	23	0	0	23	0	0
22	16038858	.	T	G	4	9	13	0	0	13	0	0
22	16039194	.	C	A	12	15	27	0	1	28	0	0
22	16039398	.	A	C	6	8	14	0	0	14	0	0
22	16039806	.	T	C	7	0	7	0	10	17	0	0
22	16040007	.	T	C	10	11	21	0	2	23	0	0
22	16097261	.	T	G	6	2	8	0	0	8	0	0
22	16097286	.	T	C	6	2	8	0	0	8	0	0
22	16097296	.	T	G	5	0	5	0	3	8	0	0
22	16112012	.	T	A	4	3	7	1	0	8	0	0
22	16112039	.	G	A	0	3	3	1	5	9	0	0
22	16120728	.	A	G	6	4	10	0	0	10	0	0
22	16120828	.	A	G	2	3	5	0	0	5	0	0
22	16121035	.	T	A	5	6	11	0	0	11	0	0
22	16121281	.	C	A	2	5	7	0	1	8	0	0
22	16123284	.	C	A	9	3	12	0	0	12	0	0
22	16123437	.	T	G	9	10	19	0	1	20	0	0
22	16123931	.	A	G	7	8	15	0	1	16	0	0
22	16144846	.	G	T	6	8	14	0	0	14	0	0
22	16150462	.	A	G	6	3	9	0	1	10	0	0
22	16171715	.	A	C	3	3	6	0	0	6	0	0
22	16171869	.	G	A	5	7	12	0	0	12	0	0
22	16171871	.	A	G	6	6	12	0	1	13	0	0
22	16173380	.	T	G	6	3	9	0	0	9	0	0
22	16174191	.	A	G	5	2	7	0	0	7	0	0
22	16175977	.	C	T	8	3	11	0	0	11	0	0
22	16176033	.	T	A	4	4	8	0	1	9	0	0
22	16176220	.	T	C	6	3	9	0	0	9	0	0
22	16176229	.	T	G	6	3	9	0	0	9	0	0
22	16176975	.	G	T	1	2	3	0	1	4	0	0
22	16177026	.	C	T	4	2	6	0	0	6	0	0
22	16177033	.	G	T	3	2	5	0	0	5	0	0
22	16177174	.	G	C	2	3	5	0	0	5	0	0
22	16177938	.	T	C	3	0	3	0	4	7	0	0
22	16191456	.	T	A	1	2	3	0	0	3	0	0
22	16191841	.	T	C	5	0	5	0	3	8	0	0
22	16191845	.	T	G	5	2	7	0	0	7	0	0
22	16191912	.	C	A	1	2	3	0	2	5	0	0
22	16191920	.	T	A	4	2	6	0	0	6	0	0
22	16192925	.	T	C	6	3	9	0	0	9	0	0
22	16193420	.	T	A	2	2	4	0	0	4	0	0
22	16193494	.	T	A	3	3	6	0	0	6	0	0
22	16193591	.	A	C	3	3	6	0	0	6	0	0
22	16201599	.	C	T	0	2	2	0	2	4	0	0
22	16201632	.	G	A	3	1	4	0	1	5	0	0
22	16204158	.	G	A	1	3	4	0	0	4	0	0
22	16219858	.	A	G	2	2	4	0	0	4	0	0
22	16221091	.	T	G	1	2	3	0	0	3	0	0
22	16270388	.	G	A	3	2	5	0	0	5	0	0
22	16270437	.	G	A	3	6	9	0	0	9	0	0
22	16270441	.	T	A	3	5	8	0	0	8	0	0
22	16282323	.	A	T	0	2	2	0	1	3	0	0
22	16282335	.	A	G	1	3	4	0	0	4	0	0
22	16282571	.	T	A	9	9	18	0	0	18	0	0
22	16282636	.	T	G	7	8	15	0	0	15	0	0
22	16282757	.	C	G	2	15	17	0	9	26	0	0
22	16285578	.	G	A	7	3	10	0	0	10	0	0
22	16287499	.	T	G	4	7	11	0	0	11	0	0
22	16287608	.	T	G	6	7	13	0	0	13	0	0
22	16287659	.	C	T	1	8	9	0	6	15	0	0
22	16290698	.	G	A	5	7	12	0	1	13	0	0
22	16290772	.	G	A	2	7	9	0	1	10	0	0
22	16290906	.	G	A	4	3	7	0	0	7	0	0
22	16298473	.	A	G	2	0	2	0	5	7	0	0
22	16298535	.	G	T	0	4	4	0	7	11	0	0
22	16298666	.	T	C	11	7	18	0	0	18	0	0
22	16298720	.	A	C	13	10	23	0	0	23	0	0
22	16298756	.	C	T	13	7	20	0	1	21	0	0
22	16302465	.	C	T	2	5	7	0	0	7	0	0
22	16302468	.	C	T	2	5	7	0	0	7	0	0
22	16302877	.	A	T	7	7	14	0	1	15	0	0
22	16305098	.	C	A	10	4	14	0	0	14	0	0
22	16305164	.	A	C	3	9	12	0	0	12	0	0
22	16305565	.	G	T	2	3	5	0	0	5	0	0
22	16311748	.	C	T	0	2	2	0	1	3	0	0
22	16312075	.	T	C	5	2	7	0	0	7	0	0
22	16312085	.	T	C	5	0	5	0	3	8	0	0
22	16312278	.	C	T	3	4	7	0	0	7	0	0
22	16312399	.	A	G	5	7	12	0	0	12	0	0
22	16313005	.	T	A	4	2	6	0	1	7	0	0
22	16313093	.	C	A	0	1	1	0	6	7	0	0
22	16313095	.	C	A	5	2	7	0	0	7	0	0
22	16313559	.	G	A	3	4	7	0	1	8	0	0
22	16317797	.	A	T	6	6	12	0	0	12	0	0
22	16320351	.	A	T	5	3	8	0	0	9	1	0
22	16324766	.	G	A	1	3	4	0	0	4	0	0
22	16328344	.	T	A	1	2	3	0	0	3	0	0
22	16342137	.	C	T	3	3	6	0	0	6	0	0
22	16345630	.	C	T	4	3	7	0	0	7	0	0
22	16350811	.	T	G	20	19	39	1	3	45	2	0
22	16351199	.	C	G	12	17	29	0	1	30	0	0
22	16351204	.	C	T	0	18	18	0	11	29	0	0
22	16351317	.	G	A	6	9	15	0	1	16	0	0
22	16351353	.	G	A	5	6	11	0	1	12	0	0
22	16351404	.	C	T	5	3	8	0	0	8	0	0
22	16351490	.	T	G	9	4	13	0	0	13	0	0
22	16351552	.	A	T	5	2	7	0	0	7	0	0
22	16352146	.	G	T	2	3	5	0	0	5	0	0
22	16352154	.	C	G	2	3	5	0	1	6	0	0
22	16352215	.	A	G	9	7	16	0	0	16	0	0
22	16352349	.	A	G	9	25	34	0	1	35	0	0
22	16352463	.	C	A	2	10	12	0	13	25	0	0
22	16352469	.	A	G	14	10	24	0	2	26	0	0
22	16352528	.	G	A	15	11	26	0	0	26	0	0
22	16352668	.	T	C	22	0	22	0	9	31	0	0
22	16352739	.	C	T	3	12	15	0	16	31	0	0
22	16355013	.	A	C	24	14	38	0	2	40	0	0
22	16355042	.	C	A	20	19	39	0	0	39	0	0
22	16355555	.	A	G	15	12	27	0	0	27	0	0
22	16357818	.	A	G	16	10	26	0	1	27	0	0
22	16357831	.	A	G	15	12	27	0	1	28	0	0
22	16357867	.	G	A	17	14	31	0	2	33	0	0
22	16367007	.	T	C	8	0	8	0	14	22	0	0
22	16367055	.	A	G	8	13	21	1	0	22	0	0
22	16368886	.	G	A	18	20	38	0	0	38	0	0
22	16377364	.	A	G	12	14	26	0	0	26	0	0
22	16377863	.	C	T	0	3	3	0	7	10	0	0
22	16377891	.	C	T	4	1	5	0	1	6	0	0
22	16411199	.	G	A	1	4	5	0	1	6	0	0
22	16412091	.	A	G	5	3	8	0	1	9	0	0
22	16412514	.	C	T	0	2	2	0	1	3	0	0
22	16422166	.	A	G	10	0	10	0	14	24	0	0
22	16424576	.	T	C	15	11	26	0	0	26	0	0
22	16430672	.	C	T	11	8	19	0	1	20	0	0
22	16432627	.	C	T	17	14	31	0	1	32	0	0
22	16432628	.	A	T	16	15	31	0	1	32	0	0
22	16433078	.	G	A	9	7	16	1	0	17	0	0
22	16433096	.	A	G	13	7	20	0	0	20	0	0
22	16433131	.	T	G	13	7	20	0	0	20	0	0
22	16433250	.	G	A	8	7	15	0	0	15	0	0
22	16433912	.	T	A	11	6	17	0	0	17	0	0
22	16433940	.	C	T	16	8	24	0	1	25	0	0
22	16434056	.	G	A	12	18	30	0	1	31	0	0
22	16438112	.	A	C	21	19	40	0	1	41	0	0
22	16440086	.	T	C	15	0	15	0	22	37	0	0
22	16464063	.	G	C	1	2	3	0	0	3	0	0
22	16464410	.	C	T	1	2	3	0	0	3	0	0
22	16473823	.	C	T	2	2	4	0	0	4	0	0
22	16484621	.	G	A	14	8	22	0	0	22	0	0
22	16484877	.	A	T	8	9	17	0	0	17	0	0
22	16484938	.	A	G	12	15	27	0	0	27	0	0
22	16484944	.	T	C	10	12	22	0	2	24	0	0
22	16485035	.	A	G	8	7	15	0	0	15	0	0
22	16485538	.	T	C	12	1	13	0	8	21	0	0
22	16485563	.	A	T	7	6	13	0	3	16	0	0
22	16485625	.	A	G	4	4	8	0	0	8	0	0
22	16485688	.	G	A	7	3	10	0	2	12	0	0
22	16485920	.	G	A	15	10	25	0	0	25	0	0
22	16485954	.	C	T	8	10	18	0	5	23	0	0
22	16485962	.	C	G	8	10	18	0	3	21	0	0
22	16485994	.	C	A	0	8	8	0	5	13	0	0
22	16486112	.	T	C	11	13	24	0	1	25	0	0
22	16491693	.	G	A	18	14	32	0	0	32	0	0
22	16491720	.	T	C	14	0	14	0	11	25	0	0
22	16491942	.	G	A	18	20	38	0	0	38	0	0
22	16492000	.	T	A	17	15	32	0	1	33	0	0
22	16497953	.	G	A	14	13	27	0	0	27	0	0
22	16498155	.	G	C	0	10	10	0	9	19	0	0
22	16498317	.	A	G	15	18	33	0	1	34	0	0
22	16498661	.	A	G	11	0	11	0	12	23	0	0
22	16537701	.	C	T	4	4	8	0	0	8	0	0
22	16543627	.	C	T	21	12	33	0	0	33	0	0
22	16543714	.	T	C	15	18	33	0	2	35	0	0
22	16544186	.	A	G	6	7	13	0	1	14	0	0
22	16544197	.	A	G	7	8	15	0	0	15	0	0
22	16544243	.	C	T	7	7	14	0	1	15	0	0
22	16544260	.	C	T	9	7	16	2	0	18	0	0
22	16544384	.	G	A	14	15	29	0	0	29	0	0
22	16544400	.	T	G	13	9	22	0	0	22	0	0
22	16544599	.	A	G	17	0	17	0	14	31	0	0
22	16544674	.	T	G	20	13	33	0	0	33	0	0
22	16544780	.	A	T	19	9	28	0	1	29	0	0
22	16544800	.	G	A	13	8	21	0	1	22	0	0
22	16569394	.	T	C	8	3	11	0	2	14	1	0
22	16569403	.	T	C	8	3	11	0	1	12	0	0
22	16569862	.	C	T	15	9	24	0	2	26	0	0
22	16584241	.	C	G	21	20	41	0	0	41	0	0
22	16592011	.	A	G	24	11	35	0	4	39	0	0
22	16592029	.	C	G	1	11	12	0	26	38	0	0
22	16594870	.	T	A	9	18	27	0	0	27	0	0
22	16594981	.	C	A	13	7	20	0	2	22	0	0
22	16595022	.	A	G	16	11	27	0	1	28	0	0
22	16601400	.	C	T	13	10	23	1	0	24	0	0
22	16609449	.	T	C	14	19	33	0	5	38	0	0
22	16609494	.	G	A	22	17	39	0	0	39	0	0
22	16614011	.	C	T	9	9	18	0	2	20	0	0
22	16759111	.	G	A	14	4	18	0	0	18	0	0
22	16775306	.	C	T	10	11	21	0	1	22	0	0
22	16840292	.	T	C	4	9	13	1	0	14	0	0
22	18233234	.	T	C	2	2	4	0	1	5	0	0
22	18966298	.	T	C	7	3	10	0	0	10	0	0
22	18966421	.	G	A	4	6	10	0	0	10	0	0
22	18971697	.	T	C	5	11	16	0	1	17	0	0
22	18971725	.	T	C	8	5	13	0	0	13	0	0
22	19004989	.	A	T	6	7	13	0	0	13	0	0
22	19006676	.	A	G	5	5	10	0	0	10	0	0
22	19006763	.	T	C	7	10	17	0	2	19	0	0
22	19006994	.	T	C	12	14	26	0	0	26	0	0
22	19007574	.	A	G	15	12	27	0	1	28	0	0
22	19007677	.	C	A	6	11	17	1	0	18	0	0
22	19007764	.	A	G	6	8	14	0	0	14	0	0
22	19007931	.	A	T	3	2	5	0	0	5	0	0
22	19024732	.	T	G	1	4	5	0	0	5	0	0
22	19065870	.	G	A	1	3	4	0	1	5	0	0
22	19065897	.	C	T	0	2	2	0	4	6	0	0
22	19067550	.	C	T	2	2	4	0	0	4	0	0
22	19074656	.	T	A	1	2	3	0	0	3	0	0
22	19547573	.	C	G	2	10	12	0	9	21	0	0
22	19547575	.	A	C	9	0	9	0	11	20	0	0
22	19547796	.	C	T	9	13	22	0	0	22	0	0
22	19552745	.	C	T	8	13	21	0	3	24	0	0
22	19642960	.	T	A	4	9	13	0	0	13	0	0
22	19643017	.	A	G	4	1	5	0	3	8	0	0
22	19643020	.	G	A	0	2	2	0	4	6	0	0
22	19645155	.	G	A	2	5	7	0	1	8	0	0
22	19645170	.	G	A	2	2	4	0	0	4	0	0
22	19645233	.	T	C	3	3	6	0	0	6	0	0
22	19645802	.	G	A	2	3	5	0	0	5	0	0
22	19665618	.	C	T	17	9	26	0	1	27	0	0
22	19671776	.	A	G	21	7	28	0	0	28	0	0
22	20011558	.	T	C	2	3	5	0	0	5	0	0
22	20105123	.	C	G	5	7	12	0	0	12	0	0
22	20105242	.	A	G	3	3	6	0	0	6	0	0
22	20105353	.	G	A	4	2	6	0	0	6	0	0
22	20105500	.	G	A	5	6	11	0	2	13	0	0
22	20105686	.	T	C	5	3	8	0	0	8	0	0
22	20138473	.	G	A	1	3	4	0	0	4	0	0
22	20140913	.	G	A	1	4	5	0	3	8	0	0
22	20141195	.	G	A	2	2	4	0	0	4	0	0
22	20141632	.	T	C	6	3	9	0	0	9	0	0
22	20141635	.	C	A	6	2	8	0	0	8	0	0
22	20142713	.	C	T	4	3	7	0	0	7	0	0
22	20142723	.	A	T	6	4	10	0	0	10	0	0
22	20142753	.	T	A	6	5	11	0	1	12	0	0
22	20142772	.	T	G	2	6	8	0	2	10	0	0
22	20142832	.	A	G	2	0	2	0	3	5	0	0
22	20143002	.	G	T	1	4	5	0	0	5	0	0
22	20143138	.	A	G	2	2	4	0	0	4	0	0
22	20143143	.	G	T	3	2	5	0	0	5	0	0
22	20159200	.	A	C	16	12	28	0	0	28	0	0
22	20159576	.	A	T	17	13	30	0	3	33	0	0
22	20159771	.	C	A	22	15	37	0	1	38	0	0
22	20164449	.	T	C	15	23	38	0	0	38	0	0
22	20169411	.	A	C	7	9	16	0	0	16	0	0
22	20169429	.	G	A	11	14	25	0	1	26	0	0
22	20172105	.	A	G	8	0	8	0	12	20	0	0
22	20172642	.	A	G	11	15	26	0	0	26	0	0
22	20175295	.	G	A	11	7	18	0	2	20	0	0
22	20177970	.	G	A	0	6	6	0	6	12	0	0
22	20177981	.	G	A	7	6	13	0	1	14	0	0
22	20202641	.	G	A	17	9	26	0	0	26	0	0
22	20211187	.	T	C	12	5	17	0	0	17	0	0
22	20211289	.	G	T	2	11	13	0	9	22	0	0
22	20212794	.	G	T	2	13	15	0	14	29	0	0
22	20214649	.	G	A	1	14	15	0	24	39	0	0
22	20215089	.	T	A	17	16	33	0	1	34	0	0
22	20215351	.	C	T	12	13	25	0	0	25	0	0
22	20220161	.	A	G	14	0	14	0	16	30	0	0
22	20220197	.	C	T	17	13	30	0	1	31	0	0
22	20222950	.	G	C	14	14	28	0	0	28	0	0
22	20230044	.	T	C	17	14	31	0	1	32	0	0
22	20240483	.	T	C	18	22	40	0	0	40	0	0
22	20240835	.	A	G	15	24	39	0	0	39	0	0
22	20292595	.	A	T	8	15	23	0	0	23	0	0
22	20292789	.	T	C	25	19	44	0	1	45	0	0
22	20293440	.	G	A	9	7	16	0	2	18	0	0
22	20296615	.	A	T	18	19	37	0	1	38	0	0
22	20296669	.	T	C	17	19	36	1	1	38	0	0
22	20299280	.	A	G	24	21	45	0	0	45	0	0
22	20299283	.	G	A	23	21	44	0	1	45	0	0
22	20299349	.	T	C	29	20	49	0	0	49	0	0
22	20303406	.	A	G	24	16	40	0	0	40	0	0
22	20303412	.	G	T	21	15	36	0	3	39	0	0
22	20303487	.	A	G	27	26	53	0	1	54	0	0
22	20305443	.	G	T	27	27	54	0	4	58	0	0
22	20313722	.	C	A	12	16	28	0	4	32	0	0
22	20313791	.	A	G	14	10	24	0	0	24	0	0
22	20313887	.	C	G	16	17	33	0	0	33	0	0
22	20313926	.	C	A	3	17	20	2	16	38	0	0
22	20315851	.	T	C	15	1	16	0	10	26	0	0
22	20315883	.	C	T	17	12	29	0	0	29	0	0
22	20315896	.	G	A	21	15	36	0	0	36	0	0
22	20316020	.	G	A	19	17	36	0	1	37	0	0
22	20318937	.	C	T	2	12	14	0	16	30	0	0
22	20319149	.	A	G	18	10	28	0	2	30	0	0
22	20372675	.	T	A	6	3	9	0	0	9	0	0
22	20375447	.	C	A	3	3	6	0	0	6	0	0
22	20375448	.	T	A	2	3	5	0	0	5	0	0
22	20388735	.	T	A	2	4	6	0	0	6	0	0
22	20388853	.	G	A	11	9	20	0	0	20	0	0
22	20389198	.	C	A	14	11	25	0	0	25	0	0
22	20389286	.	A	G	13	4	17	0	1	18	0	0
22	20389392	.	A	G	9	10	19	0	1	20	0	0
22	20389538	.	A	T	20	8	28	0	0	28	0	0
22	20389545	.	G	A	21	8	29	0	1	30	0	0
22	20389620	.	T	A	11	15	26	0	1	27	0	0
22	20390002	.	C	A	9	14	23	1	0	24	0	0
22	20390041	.	C	T	10	15	25	0	0	25	0	0
22	20402889	.	T	C	4	10	14	0	0	14	0	0
22	20407002	.	C	T	0	3	3	0	5	8	0	0
22	20409099	.	C	T	6	5	11	0	2	13	0	0
22	20475073	.	G	A	2	2	4	0	1	5	0	0
22	20574066	.	T	C	10	12	22	0	0	22	0	0
22	20574402	.	A	G	7	12	19	0	0	19	0	0
22	20574585	.	A	G	6	12	18	0	0	18	0	0
22	20575634	.	G	A	7	6	13	0	1	14	0	0
22	20783269	.	T	A	3	3	6	0	2	8	0	0
22	20788656	.	C	T	4	2	6	0	0	6	0	0
22	20791016	.	T	C	3	8	11	0	0	11	0	0
22	20794383	.	A	G	8	3	11	0	0	11	0	0
22	20797091	.	C	T	3	4	7	0	0	7	0	0
22	20797280	.	G	A	5	6	11	0	0	11	0	0
22	20797511	.	A	G	2	7	9	0	0	9	0	0
22	20797556	.	G	A	2	2	4	0	1	5	0	0
22	20797691	.	G	A	5	2	7	0	1	8	0	0
22	20801339	.	G	C	7	3	10	0	0	10	0	0
22	20801844	.	C	T	3	4	7	0	0	7	0	0
22	20806394	.	G	A	3	4	7	0	0	7	0	0
22	20814342	.	A	G	4	4	8	0	0	8	0	0
22	20848297	.	G	A	4	5	9	0	1	10	0	0
22	20848326	.	C	T	5	3	8	0	1	9	0	0
22	20848488	.	G	A	7	4	11	0	1	12	0	0
22	20848501	.	A	G	8	3	11	0	0	11	0	0
22	20849615	.	T	C	6	0	6	0	6	12	0	0
22	20926412	.	C	T	5	4	9	0	0	9	0	0
22	20926466	.	G	A	8	5	13	0	0	13	0	0
22	20926511	.	G	A	6	12	18	0	1	19	0	0
22	20940039	.	C	T	0	10	10	0	12	22	0	0
22	20940048	.	G	A	10	10	20	0	1	21	0	0
22	20944679	.	A	G	11	7	18	0	1	19	0	0
22	20951387	.	T	C	8	0	8	0	6	14	0	0
22	20951514	.	C	T	1	13	14	0	13	27	0	0
22	20951788	.	G	A	17	9	26	0	0	26	0	0
22	20951861	.	C	T	6	11	17	0	0	17	0	0
22	20951866	.	G	T	6	10	16	0	0	16	0	0
22	20952257	.	A	G	17	15	32	0	0	32	0	0
22	20952292	.	A	T	22	8	30	0	0	30	0	0
22	20952534	.	T	C	2	3	5	0	0	5	0	0
22	20953053	.	T	A	8	8	16	0	2	18	0	0
22	20953127	.	A	T	5	6	11	0	1	12	0	0
22	20953141	.	C	A	5	5	10	0	0	10	0	0
22	20953418	.	G	A	8	8	16	0	1	17	0	0
22	20953555	.	C	A	14	11	25	0	0	25	0	0
22	20953578	.	A	G	15	9	24	0	0	24	0	0
22	20954386	.	C	T	5	7	12	0	0	12	0	0
22	20954391	.	C	T	5	8	13	0	1	14	0	0
22	20954557	.	T	A	9	10	19	0	0	19	0	0
22	20954717	.	A	T	12	14	26	0	5	31	0	0
22	20954810	.	C	T	2	16	18	0	15	33	0	0
22	20954953	.	C	T	12	24	36	0	2	38	0	0
22	20955427	.	C	T	0	4	4	0	4	8	0	0
22	20955469	.	C	T	1	11	12	0	2	14	0	0
22	21032184	.	A	G	10	19	29	0	1	30	0	0
22	21128200	.	A	G	14	16	30	4	2	36	0	0
22	21129075	.	G	A	33	23	56	0	6	62	0	0
22	21129101	.	G	A	35	27	62	0	2	64	0	0
22	21129407	.	A	G	35	33	68	0	3	71	0	0
22	21129558	.	T	G	39	26	65	0	0	66	1	0
22	21129575	.	T	C	36	27	63	0	2	65	0	0
22	21167167	.	C	T	1	2	3	0	1	4	0	0
22	21361753	.	T	C	2	2	4	0	0	4	0	0
22	21365143	.	C	T	0	7	7	0	4	11	0	0
22	21367155	.	G	C	5	2	7	0	0	7	0	0
22	21369882	.	C	T	0	3	3	0	5	8	0	0
22	21372030	.	A	G	4	4	8	0	0	8	0	0
22	21385205	.	G	T	1	2	3	0	0	3	0	0
22	21398640	.	T	A	2	4	6	0	1	7	0	0
22	21399836	.	A	G	3	0	3	0	6	9	0	0
22	21407312	.	T	C	5	4	9	0	0	9	0	0
22	21465109	.	T	C	5	4	9	0	0	9	0	0
22	21465156	.	T	C	2	7	9	0	0	9	0	0
22	21465232	.	T	C	3	4	7	0	1	8	0	0
22	21530404	.	C	G	2	2	4	0	0	4	0	0
22	21530405	.	A	G	2	2	4	0	0	4	0	0
22	21541437	.	A	G	6	3	9	0	1	10	0	0
22	21544232	.	G	A	4	3	7	0	0	7	0	0
22	21618495	.	A	G	5	0	5	0	8	13	0	0
22	21618633	.	G	A	13	8	21	0	0	21	0	0
22	21624764	.	G	C	7	9	16	1	3	20	0	0
22	21657871	.	C	T	7	6	13	0	2	15	0	0
22	21661029	.	T	C	9	5	14	0	0	14	0	0
22	21661258	.	T	A	11	12	23	0	0	23	0	0
22	21661569	.	C	T	2	1	3	7	2	12	0	0
22	21661789	.	G	A	11	5	16	1	0	17	0	0
22	21661819	.	T	C	3	12	15	1	1	17	0	0
22	21662138	.	G	A	2	4	6	1	0	7	0	0
22	21676215	.	A	G	8	7	15	9	0	24	0	0
22	21676233	.	G	A	13	5	18	8	0	26	0	0
22	21676296	.	G	A	6	12	18	0	0	18	0	0
22	21680179	.	T	C	3	0	3	0	8	11	0	0
22	21680240	.	T	A	11	8	19	0	0	19	0	0
22	21697826	.	T	C	7	5	12	0	0	12	0	0
22	21737900	.	C	T	2	2	4	0	0	4	0	0
22	21737948	.	T	C	4	0	4	0	4	8	0	0
22	21852158	.	C	T	23	19	42	0	1	43	0	0
22	21852269	.	A	G	16	9	25	0	6	31	0	0
22	21852281	.	T	C	17	0	17	0	13	30	0	0
22	22129883	.	T	C	4	5	9	0	0	9	0	0
22	22130015	.	T	A	4	10	14	0	1	15	0	0
22	22130085	.	C	T	2	10	12	0	1	13	0	0
22	22130255	.	G	A	10	12	22	0	1	23	0	0
22	22130414	.	A	C	5	0	5	0	7	12	0	0
22	22130468	.	T	C	4	0	4	0	5	9	0	0
22	22130528	.	G	A	4	4	8	0	0	8	0	0
22	22141567	.	G	A	6	6	12	0	0	12	0	0
22	22141788	.	C	T	4	3	7	0	0	7	0	0
22	22142302	.	A	G	3	3	6	0	1	7	0	0
22	22175516	.	C	T	2	20	22	0	8	30	0	0
22	22179825	.	C	T	17	16	33	0	1	34	0	0
22	22188682	.	T	C	18	21	39	0	1	40	0	0
22	22196339	.	G	A	13	11	24	0	2	26	0	0
22	22199227	.	G	A	13	13	26	0	0	26	0	0
22	22204002	.	C	T	8	13	21	0	0	21	0	0
22	22204098	.	C	T	7	12	19	0	0	19	0	0
22	22204395	.	G	A	18	12	30	0	0	30	0	0
22	22204440	.	G	A	16	16	32	0	0	32	0	0
22	22214852	.	T	C	14	10	24	0	1	25	0	0
22	22215458	.	G	T	11	13	24	0	1	25	0	0
22	22231662	.	C	T	5	11	16	0	2	18	0	0
22	22231717	.	A	T	7	16	23	0	1	24	0	0
22	22234418	.	C	T	2	8	10	1	9	20	0	0
22	22240918	.	G	A	14	14	28	1	0	29	0	0
22	22241772	.	A	T	9	20	29	0	1	30	0	0
22	22242861	.	C	T	1	15	16	0	11	27	0	0
22	22245400	.	T	C	11	17	28	0	0	28	0	0
22	22245781	.	G	T	14	14	28	0	0	28	0	0
22	22251493	.	A	C	12	0	12	1	14	27	0	0
22	22259155	.	G	A	10	15	25	0	0	25	0	0
22	22260456	.	G	A	3	5	8	0	0	8	0	0
22	22266519	.	T	C	4	7	11	0	0	11	0	0
22	22267524	.	G	C	1	4	5	0	11	16	0	0
22	22273388	.	C	T	6	9	15	0	0	15	0	0
22	22273736	.	G	A	1	9	10	0	10	20	0	0
22	22273871	.	A	C	8	11	19	0	1	20	0	0
22	22274000	.	A	T	4	8	12	0	1	13	0	0
22	22274137	.	C	T	7	6	13	0	1	14	0	0
22	22274157	.	G	T	2	6	8	0	0	8	0	0
22	22274249	.	T	G	5	4	9	0	0	9	0	0
22	22276418	.	C	T	2	2	4	0	0	4	0	0
22	22311283	.	T	C	6	6	12	0	0	12	0	0
22	22312463	.	G	A	6	3	9	0	2	11	0	0
22	22312496	.	C	A	6	5	11	0	0	11	0	0
22	22312548	.	C	A	5	7	12	0	0	12	0	0
22	22313260	.	A	T	6	2	8	0	0	8	0	0
22	22313376	.	T	C	3	15	18	0	0	18	0	0
22	22313395	.	G	A	2	12	14	0	4	18	0	0
22	22313574	.	A	G	3	0	3	0	4	7	0	0
22	22313601	.	C	T	4	3	7	0	0	7	0	0
22	22313927	.	G	C	7	3	10	0	0	10	0	0
22	22313953	.	T	A	5	2	7	0	0	7	0	0
22	22314547	.	T	A	5	4	9	0	0	9	0	0
22	22314564	.	C	A	8	4	12	0	1	13	0	0
22	22314721	.	A	G	15	10	25	0	1	26	0	0
22	22314861	.	C	G	4	4	8	0	0	8	0	0
22	22314870	.	G	C	3	4	7	0	0	7	0	0
22	22314991	.	T	C	4	3	7	0	0	7	0	0
22	22315048	.	T	C	4	4	8	0	0	8	0	0
22	22315211	.	A	G	2	2	4	0	0	4	0	0
22	22345136	.	C	T	4	12	16	0	17	33	0	0
22	22345179	.	A	C	16	16	32	0	1	33	0	0
22	22345255	.	G	A	15	17	32	0	0	32	0	0
22	22345367	.	C	T	2	13	15	0	20	35	0	0
22	22345403	.	G	A	17	13	30	0	1	31	0	0
22	22345418	.	G	A	21	15	36	0	0	36	0	0
22	22351103	.	A	T	24	15	39	0	1	40	0	0
22	22351180	.	A	T	21	10	31	0	2	33	0	0
22	22352611	.	A	C	14	12	26	0	1	27	0	0
22	22352693	.	T	A	18	10	28	0	0	28	0	0
22	22353222	.	G	A	15	10	25	0	0	25	0	0
22	22353416	.	A	G	8	11	19	0	0	19	0	0
22	22353779	.	G	A	11	6	17	0	1	18	0	0
22	22353887	.	G	A	9	8	17	0	0	17	0	0
22	22354145	.	G	A	8	8	16	0	1	17	0	0
22	22354217	.	G	A	11	8	19	0	0	19	0	0
22	22354698	.	C	T	0	8	8	0	6	14	0	0
22	22376081	.	G	C	6	0	6	0	8	14	0	0
22	22376174	.	C	T	0	12	12	0	8	20	0	0
22	22397336	.	G	A	10	12	22	0	0	22	0	0
22	22416255	.	G	T	4	6	10	0	1	11	0	0
22	22418465	.	A	T	5	5	10	0	1	11	0	0
22	22420420	.	A	G	5	3	8	0	0	8	0	0
22	22420646	.	G	T	0	3	3	0	6	9	0	0
22	22420664	.	A	G	4	2	6	0	0	6	0	0
22	22420746	.	G	T	7	6	13	0	2	15	0	0
22	22422264	.	C	T	2	5	7	0	0	7	0	0
22	22422270	.	G	T	2	5	7	0	1	8	0	0
22	22424058	.	C	T	2	9	11	0	1	12	0	0
22	22425439	.	T	C	6	4	10	0	0	10	0	0
22	22427442	.	T	C	3	7	10	0	0	10	0	0
22	22427612	.	C	T	8	9	17	0	0	17	0	0
22	22427694	.	C	T	5	6	11	0	0	11	0	0
22	22634168	.	A	G	2	2	4	0	0	4	0	0
22	22634944	.	A	T	1	3	4	0	0	4	0	0
22	22635879	.	G	C	2	2	4	0	0	4	0	0
22	22636374	.	G	T	1	3	4	0	0	4	0	0
22	23228600	.	C	G	1	4	5	0	0	5	0	0
22	23360503	.	G	A	4	2	6	0	1	7	0	0
22	23452957	.	C	T	3	5	8	0	0	8	0	0
22	23456296	.	T	C	5	4	9	0	0	9	0	0
22	23478541	.	A	G	3	3	6	0	2	8	0	0
22	23493268	.	C	A	3	4	7	0	0	7	0	0
22	23509256	.	G	A	1	3	4	0	0	4	0	0
22	23512621	.	G	T	2	2	4	0	0	4	0	0
22	23513044	.	C	T	0	3	3	0	2	5	0	0
22	23513045	.	G	T	2	2	4	0	1	5	0	0
22	23518014	.	G	A	1	3	4	0	0	4	0	0
22	23575276	.	T	A	1	2	3	0	0	3	0	0
22	24157961	.	G	C	11	19	30	0	1	31	0	0
22	24158037	.	T	A	10	9	19	0	0	19	0	0
22	24158146	.	A	C	15	16	31	0	0	31	0	0
22	24158190	.	C	T	16	17	33	0	2	35	0	0
22	24158242	.	C	A	16	22	38	0	0	38	0	0
22	24158275	.	G	C	11	18	29	0	3	32	0	0
22	24166896	.	G	A	4	18	22	0	16	38	0	0
22	24166919	.	A	G	19	22	41	0	0	41	0	0
22	24167633	.	C	T	16	16	32	0	1	33	0	0
22	24168125	.	T	C	20	14	34	0	0	34	0	0
22	24168573	.	T	C	13	11	24	0	2	26	0	0
22	24168610	.	T	A	19	16	35	0	4	39	0	0
22	24218631	.	A	G	5	0	5	0	5	10	0	0
22	24218656	.	T	A	8	3	11	0	0	11	0	0
22	24220962	.	A	G	14	17	31	0	2	33	0	0
22	24220996	.	G	A	21	14	35	0	4	39	0	0
22	24221009	.	C	T	16	21	37	0	0	37	0	0
22	24224676	.	A	T	13	12	25	0	1	26	0	0
22	24225409	.	T	C	23	11	34	0	0	34	0	0
22	24229293	.	C	T	21	11	32	0	0	32	0	0
22	24229513	.	T	C	21	19	40	0	0	40	0	0
22	24229890	.	T	C	20	21	41	0	1	42	0	0
22	24230005	.	G	A	3	12	15	0	27	42	0	0
22	24230020	.	G	A	13	26	39	0	1	40	0	0
22	24233536	.	G	T	16	18	34	1	1	36	0	0
22	24360198	.	G	T	3	3	6	0	0	6	0	0
22	24360581	.	A	T	1	3	4	0	0	4	0	0
22	24360615	.	G	T	3	2	5	0	1	6	0	0
22	24361096	.	A	G	10	4	14	0	0	14	0	0
22	24621794	.	A	G	8	2	10	0	0	10	0	0
22	24715404	.	A	G	15	1	16	0	23	39	0	0
22	24716636	.	T	A	18	14	32	0	0	32	0	0
22	24717105	.	G	A	16	29	45	0	0	45	0	0
22	24718973	.	T	C	19	27	46	0	2	48	0	0
22	24724279	.	T	C	7	5	12	7	0	19	0	0
22	24724459	.	A	G	9	4	13	2	0	15	0	0
22	24975613	.	C	T	3	2	5	0	0	5	0	0
22	24975753	.	G	A	2	3	5	0	0	5	0	0
22	24975792	.	C	T	2	3	5	0	0	5	0	0
22	24981171	.	T	C	2	5	7	0	0	7	0	0
22	24984053	.	A	C	3	5	8	0	0	8	0	0
22	25025208	.	G	A	21	24	45	0	0	45	0	0
22	25028424	.	G	A	19	23	42	0	4	46	0	0
22	25028660	.	G	A	24	16	40	0	0	40	0	0
22	25028694	.	G	A	26	13	39	0	1	40	0	0
22	25032266	.	C	T	27	16	43	0	0	43	0	0
22	25032344	.	C	T	4	20	24	0	16	40	0	0
22	25032532	.	C	G	17	11	28	0	2	31	1	0
22	25032572	.	G	A	18	10	28	0	3	31	0	0
22	25032620	.	A	C	20	2	22	0	18	40	0	0
22	25032857	.	G	A	17	14	31	0	3	34	0	0
22	25032863	.	A	G	21	13	34	0	0	34	0	0
22	25032921	.	A	T	7	12	19	0	1	20	0	0
22	25034863	.	C	G	2	4	6	0	0	6	0	0
22	25034865	.	C	T	2	4	6	0	0	6	0	0
22	25049594	.	T	C	1	3	4	0	0	4	0	0
22	25053542	.	C	T	2	5	7	0	0	7	0	0
22	25053744	.	A	G	1	4	5	0	1	6	0	0
22	25055645	.	G	T	2	2	4	0	0	4	0	0
22	25058509	.	C	G	5	0	5	0	1	6	0	0
22	25058518	.	T	G	1	2	3	0	1	4	0	0
22	25059919	.	G	A	0	4	4	0	7	11	0	0
22	25060629	.	C	A	4	3	7	0	0	7	0	0
22	25063474	.	C	T	8	4	12	0	0	12	0	0
22	25063696	.	A	G	7	0	7	0	7	14	0	0
22	25063745	.	C	A	5	4	9	0	1	10	0	0
22	25063767	.	C	A	6	4	10	0	0	10	0	0
22	25066160	.	G	T	2	2	4	0	0	4	0	0
22	25066332	.	C	T	0	3	3	1	6	10	0	0
22	25066410	.	T	C	7	8	15	0	0	15	0	0
22	25066585	.	G	A	9	4	13	0	0	13	0	0
22	25066939	.	C	T	5	6	11	0	1	12	0	0
22	25067274	.	A	G	3	2	5	0	0	5	0	0
22	25067596	.	C	T	8	8	16	0	1	17	0	0
22	25069856	.	G	A	3	4	7	0	0	7	0	0
22	25069884	.	C	A	3	3	6	0	0	6	0	0
22	25072073	.	G	A	4	4	8	0	1	9	0	0
22	25072474	.	C	G	9	6	15	0	0	15	0	0
22	25076701	.	G	A	3	6	9	0	1	10	0	0
22	25076727	.	A	G	11	6	17	0	1	18	0	0
22	25078630	.	A	C	13	10	23	0	2	25	0	0
22	25096079	.	T	C	2	3	5	0	1	6	0	0
22	25554236	.	C	T	2	2	4	0	1	5	0	0
22	25554258	.	T	C	4	3	7	0	0	7	0	0
22	25566572	.	A	T	2	2	4	0	0	4	0	0
22	25573197	.	G	T	6	3	9	0	0	9	0	0
22	25577248	.	C	T	5	2	7	0	0	7	0	0
22	25577265	.	A	G	4	2	6	0	0	6	0	0
22	25582764	.	T	C	4	4	8	0	0	8	0	0
22	25586906	.	T	A	3	4	7	0	1	8	0	0
22	25586963	.	C	T	1	3	4	0	0	4	0	0
22	25587071	.	C	G	1	2	3	0	0	3	0	0
22	25843519	.	T	A	2	3	5	0	0	5	0	0
22	25931976	.	A	G	6	0	6	0	9	15	0	0
22	25935627	.	G	A	1	3	4	0	6	10	0	0
22	25937001	.	G	A	0	2	2	0	8	10	0	0
22	25937037	.	T	A	7	3	10	0	0	10	0	0
22	25937052	.	T	C	6	5	11	0	0	11	0	0
22	25938882	.	T	C	5	7	12	0	1	13	0	0
22	25938915	.	C	T	5	4	9	0	1	10	0	0
22	25939060	.	C	T	5	4	9	0	0	9	0	0
22	25942934	.	T	G	5	4	9	0	0	9	0	0
22	25942940	.	A	G	3	5	8	0	1	9	0	0
22	26239654	.	A	T	3	6	9	0	0	9	0	0
22	26239681	.	C	T	0	4	4	0	4	8	0	0
22	26239752	.	G	A	5	8	13	0	0	13	0	0
22	26239774	.	T	A	5	5	10	0	0	10	0	0
22	26239798	.	C	A	1	4	5	0	4	10	1	0
22	26239873	.	T	A	10	2	12	0	0	12	0	0
22	26239879	.	G	A	8	3	11	0	1	12	0	0
22	26243236	.	A	C	4	0	4	0	4	8	0	0
22	26243242	.	C	T	3	4	7	0	0	7	0	0
22	26244755	.	C	T	2	6	8	0	1	9	0	0
22	26245743	.	A	G	5	4	9	0	0	9	0	0
22	26245881	.	T	C	2	0	2	0	5	7	0	0
22	26266807	.	T	A	10	5	15	0	0	15	0	0
22	26274099	.	G	A	10	3	13	0	0	13	0	0
22	26274106	.	A	T	9	3	12	0	0	13	1	0
22	26277695	.	T	C	17	5	22	0	2	24	0	0
22	26277735	.	A	C	12	4	16	0	1	17	0	0
22	26277773	.	G	A	12	3	15	0	0	15	0	0
22	26277871	.	C	A	5	3	8	0	0	8	0	0
22	26277939	.	T	C	4	1	5	0	4	9	0	0
22	26278042	.	T	C	4	6	10	0	0	10	0	0
22	26278081	.	C	T	7	5	12	0	1	13	0	0
22	26278144	.	T	G	7	5	12	0	1	13	0	0
22	26278273	.	G	A	21	8	29	0	0	29	0	0
22	26281043	.	A	G	9	6	15	0	0	15	0	0
22	26289397	.	A	C	8	4	12	0	1	13	0	0
22	26289430	.	G	A	14	8	22	0	0	22	0	0
22	26289501	.	A	T	6	3	9	0	2	11	0	0
22	26290508	.	C	T	13	16	29	0	2	31	0	0
22	26290764	.	A	G	7	3	10	0	0	10	0	0
22	26290797	.	T	G	3	0	3	0	5	8	0	0
22	26290851	.	A	T	1	2	3	0	1	4	0	0
22	26304186	.	T	C	6	3	9	0	2	11	0	0
22	26307620	.	T	G	7	6	13	0	2	15	0	0
22	26307671	.	A	G	6	5	11	0	0	11	0	0
22	26307728	.	A	G	4	7	11	0	0	11	0	0
22	26307743	.	T	C	5	0	5	1	8	14	0	0
22	26313876	.	A	T	7	4	11	0	1	12	0	0
22	26317666	.	T	A	7	3	10	0	0	10	0	0
22	26317671	.	A	G	7	3	10	0	0	10	0	0
22	26320661	.	A	G	6	4	10	0	0	10	0	0
22	26323726	.	T	A	3	4	7	0	0	7	0	0
22	26323861	.	G	A	3	7	10	0	0	10	0	0
22	26525935	.	T	G	5	3	8	0	1	9	0	0
22	26525960	.	A	G	5	3	8	0	0	8	0	0
22	26525979	.	C	T	5	3	8	0	0	8	0	0
22	26526004	.	A	T	2	4	6	0	0	6	0	0
22	26526057	.	C	T	0	4	4	0	4	8	0	0
22	26526249	.	A	T	3	6	9	0	0	9	0	0
22	26526412	.	G	A	6	4	10	0	0	10	0	0
22	26526471	.	A	G	1	5	6	0	0	6	0	0
22	26526522	.	G	A	2	3	5	0	0	5	0	0
22	26526564	.	T	C	1	4	5	0	0	5	0	0
22	26526611	.	G	C	5	1	6	0	2	8	0	0
22	26526864	.	C	A	8	3	11	0	0	11	0	0
22	26527864	.	C	T	3	2	5	0	0	5	0	0
22	26528286	.	G	A	4	3	7	0	0	7	0	0
22	26528518	.	A	T	2	3	5	0	0	5	0	0
22	26528740	.	T	A	6	3	9	0	0	9	0	0
22	26529165	.	T	G	2	3	5	0	0	5	0	0
22	26529204	.	C	T	1	4	5	0	2	7	0	0
22	26529315	.	G	A	6	3	9	0	0	9	0	0
22	26529438	.	C	A	0	7	7	0	5	12	0	0
22	26529471	.	G	T	6	8	14	0	0	14	0	0
22	26529500	.	T	G	6	5	11	0	0	11	0	0
22	26532302	.	C	T	1	3	4	0	4	8	0	0
22	26536435	.	C	A	3	4	7	0	3	10	0	0
22	26536443	.	T	A	3	8	11	0	1	12	0	0
22	26696672	.	A	T	2	3	5	0	0	5	0	0
22	26696699	.	C	T	1	4	5	0	1	6	0	0
22	26696747	.	T	C	2	3	5	0	1	6	0	0
22	26696783	.	T	C	1	3	4	0	0	4	0	0
22	26703503	.	C	T	5	7	12	0	1	13	0	0
22	26738889	.	A	C	8	7	15	1	0	16	0	0
22	26739000	.	C	T	8	9	17	0	1	18	0	0
22	26739087	.	A	G	6	0	6	0	9	15	0	0
22	26739094	.	G	A	5	7	12	0	1	13	0	0
22	26739273	.	T	C	4	4	8	0	0	8	0	0
22	26739297	.	G	C	4	3	7	0	0	7	0	0
22	26739441	.	G	T	0	2	2	0	6	8	0	0
22	26739480	.	C	T	8	9	17	0	0	17	0	0
22	26751297	.	C	T	9	3	12	0	0	12	0	0
22	26768020	.	C	G	14	11	25	0	1	26	0	0
22	26768023	.	T	C	14	11	25	0	0	25	0	0
22	26768400	.	A	G	8	0	8	0	6	14	0	0
22	26768433	.	A	G	5	8	13	0	1	14	0	0
22	26771067	.	G	T	11	19	30	0	1	31	0	0
22	26774079	.	G	A	2	10	12	0	13	25	0	0
22	26774660	.	C	T	9	6	15	0	0	15	0	0
22	26776678	.	C	T	8	6	14	0	1	15	0	0
22	26776681	.	G	A	9	6	15	0	1	16	0	0
22	26785015	.	C	T	6	8	14	0	0	14	0	0
22	26785290	.	C	T	7	2	9	0	0	9	0	0
22	26786013	.	A	G	12	6	18	0	2	20	0	0
22	26786559	.	C	A	12	6	18	0	0	18	0	0
22	26787710	.	G	T	9	9	18	0	0	18	0	0
22	26787911	.	C	T	16	15	31	0	1	32	0	0
22	26788340	.	G	A	12	21	33	0	1	34	0	0
22	26788449	.	T	C	13	22	35	0	0	35	0	0
22	26788565	.	T	C	19	14	33	0	1	34	0	0
22	26788885	.	C	A	14	9	23	0	4	27	0	0
22	26789228	.	G	A	4	19	23	0	22	45	0	0
22	26789465	.	A	G	12	0	12	0	17	29	0	0
22	26789667	.	C	G	8	0	8	0	8	16	0	0
22	26789813	.	A	T	12	9	21	0	0	21	0	0
22	26790074	.	C	T	9	11	20	0	0	20	0	0
22	26790436	.	A	T	11	9	20	0	3	23	0	0
22	26798978	.	A	G	2	2	4	0	0	4	0	0
22	26799927	.	G	A	0	5	5	0	4	9	0	0
22	26799960	.	A	G	4	5	9	0	1	10	0	0
22	26800113	.	T	A	1	3	4	0	0	4	0	0
22	26806276	.	A	G	2	3	5	0	0	5	0	0
22	26812058	.	G	A	6	3	9	0	0	9	0	0
22	26812153	.	A	G	7	1	8	0	2	10	0	0
22	26812506	.	C	T	5	6	11	0	0	11	0	0
22	26812751	.	G	A	4	4	8	0	0	8	0	0
22	26812754	.	A	G	2	4	6	0	2	8	0	0
22	26812825	.	G	A	4	6	10	0	0	10	0	0
22	26812902	.	T	C	5	2	7	0	0	7	0	0
22	26812921	.	A	G	4	2	6	0	0	6	0	0
22	26813028	.	T	A	5	4	9	0	0	9	0	0
22	26813046	.	G	A	0	5	5	0	4	9	0	0
22	26813412	.	C	T	4	4	8	0	0	8	0	0
22	26813670	.	G	A	7	3	10	0	0	10	0	0
22	26813725	.	T	G	8	4	12	0	0	12	0	0
22	26813801	.	A	C	6	2	8	0	0	8	0	0
22	26813851	.	T	G	5	3	8	0	1	9	0	0
22	26814164	.	C	G	5	3	8	0	0	8	0	0
22	26818086	.	G	A	0	3	3	0	9	12	0	0
22	26818851	.	T	A	8	8	16	0	0	16	0	0
22	26818907	.	A	G	7	0	7	0	6	13	0	0
22	26832125	.	G	A	8	8	16	0	1	17	0	0
22	26832977	.	A	T	3	2	5	0	0	5	0	0
22	26839502	.	T	A	8	3	11	0	1	12	0	0
22	26839505	.	G	A	8	4	12	0	1	13	0	0
22	26844260	.	G	A	14	9	23	0	2	25	0	0
22	26844345	.	A	C	10	7	17	0	0	17	0	0
22	26851904	.	A	C	8	1	9	0	4	13	0	0
22	26852142	.	A	C	5	3	8	0	1	9	0	0
22	26852163	.	A	C	9	3	12	0	1	13	0	0
22	26852209	.	G	A	9	3	12	0	0	12	0	0
22	26852243	.	C	T	1	4	5	0	4	9	0	0
22	26854336	.	T	G	1	5	6	0	0	6	0	0
22	26854465	.	A	G	13	5	18	0	2	20	0	0
22	26854530	.	T	C	9	7	16	0	0	16	0	0
22	26854626	.	C	A	4	7	11	0	1	12	0	0
22	26854815	.	A	C	5	4	9	0	1	10	0	0
22	26854965	.	A	G	3	6	9	0	0	9	0	0
22	26855844	.	T	C	2	2	4	0	0	4	0	0
22	26856023	.	A	G	2	6	8	0	1	9	0	0
22	26856059	.	A	T	5	5	10	1	0	11	0	0
22	26858002	.	A	G	7	5	12	0	2	14	0	0
22	26858153	.	T	C	1	0	1	0	3	4	0	0
22	26858216	.	T	C	7	5	12	0	0	12	0	0
22	26860639	.	C	T	1	14	15	0	20	35	0	0
22	26860753	.	T	C	9	17	26	0	0	26	0	0
22	26861264	.	T	C	13	0	13	0	12	25	0	0
22	26865182	.	C	A	4	4	8	0	0	8	0	0
22	26929689	.	G	A	3	3	6	0	1	7	0	0
22	26929826	.	C	A	21	14	35	1	0	36	0	0
22	26929931	.	A	T	23	19	42	0	2	44	0	0
22	26929969	.	A	G	21	17	38	0	2	40	0	0
22	26930076	.	A	G	13	16	29	0	3	32	0	0
22	26930079	.	G	T	13	17	30	0	2	32	0	0
22	26930133	.	G	C	21	17	38	0	0	38	0	0
22	26930313	.	C	T	19	17	36	0	0	36	0	0
22	26930335	.	A	T	19	15	34	0	3	37	0	0
22	26930390	.	C	T	14	20	34	0	0	34	0	0
22	26930489	.	C	G	19	17	36	0	1	37	0	0
22	26930527	.	T	A	16	13	29	0	0	29	0	0
22	26930601	.	T	C	8	11	19	0	0	19	0	0
22	26930735	.	G	C	15	0	15	0	10	25	0	0
22	26930894	.	C	T	2	25	27	0	16	43	0	0
22	26931467	.	C	T	5	5	10	0	1	11	0	0
22	26931509	.	G	T	5	5	10	0	0	10	0	0
22	26931567	.	C	A	3	7	10	0	0	10	0	0
22	26931661	.	A	G	3	3	6	0	0	6	0	0
22	26931699	.	A	T	8	2	10	0	0	10	0	0
22	26931723	.	T	C	11	3	14	0	0	14	0	0
22	26931906	.	C	T	13	10	23	1	1	25	0	0
22	26931967	.	G	A	23	13	36	0	1	37	0	0
22	26940409	.	G	A	9	12	21	0	0	21	0	0
22	27091989	.	C	T	3	2	5	0	0	5	0	0
22	27098736	.	G	A	10	7	17	0	1	18	0	0
22	27098899	.	T	C	15	5	20	0	0	20	0	0
22	27102556	.	C	T	6	7	13	0	0	13	0	0
22	27104159	.	C	G	8	5	13	0	0	13	0	0
22	28236839	.	A	T	3	6	9	0	1	10	0	0
22	28240544	.	A	G	3	6	9	0	2	12	1	0
22	28240555	.	T	A	6	5	11	0	0	11	0	0
22	28241719	.	A	T	2	10	12	0	2	14	0	0
22	28241831	.	T	A	2	10	12	0	0	12	0	0
22	28244972	.	A	G	2	6	8	0	0	8	0	0
22	28255399	.	G	T	2	6	8	0	0	8	0	0
22	28255495	.	T	C	2	6	8	0	1	9	0	0
22	28255514	.	C	G	3	0	3	0	8	11	0	0
22	28265596	.	T	G	4	6	10	0	0	10	0	0
22	28265621	.	T	C	6	9	15	0	0	15	0	0
22	28265636	.	G	T	6	9	15	0	0	15	0	0
22	28284646	.	A	C	2	6	8	0	1	9	0	0
22	28284659	.	C	T	5	5	10	0	0	10	0	0
22	28287669	.	T	C	7	5	12	0	0	12	0	0
22	28290817	.	C	T	5	3	8	0	0	8	0	0
22	28303025	.	C	T	3	8	11	0	0	11	0	0
22	28303091	.	C	A	2	13	15	0	1	16	0	0
22	28446657	.	A	G	3	0	3	0	2	5	0	0
22	28474403	.	T	C	1	2	3	0	0	3	0	0
22	28481616	.	A	C	1	4	5	0	0	5	0	0
22	28481641	.	G	A	0	5	5	0	2	7	0	0
22	28642555	.	G	A	3	6	9	0	0	9	0	0
22	28642777	.	G	A	7	6	13	0	0	13	0	0
22	28642997	.	C	A	4	4	8	0	0	8	0	0
22	28644462	.	T	A	1	5	6	0	0	6	0	0
22	28644474	.	T	C	1	0	1	0	3	4	0	0
22	28804013	.	G	A	0	9	9	0	4	13	0	0
22	28832823	.	G	C	10	8	18	1	0	19	0	0
22	28836202	.	C	T	16	11	27	0	0	27	0	0
22	28836346	.	G	A	21	12	33	0	0	33	0	0
22	28836631	.	A	G	16	9	25	0	2	27	0	0
22	28837231	.	A	G	19	10	29	0	1	30	0	0
22	28837546	.	G	C	3	5	8	0	8	16	0	0
22	28839917	.	A	C	11	12	23	0	1	24	0	0
22	28840101	.	C	A	10	14	24	1	2	27	0	0
22	28840154	.	A	G	12	9	21	1	1	23	0	0
22	28847988	.	G	A	13	8	21	0	0	21	0	0
22	28848724	.	A	T	6	12	18	2	0	20	0	0
22	28848735	.	T	C	6	11	17	2	1	20	0	0
22	28848920	.	A	G	4	5	9	0	0	9	0	0
22	28858314	.	A	G	16	13	29	0	1	30	0	0
22	28859346	.	G	A	35	16	51	0	0	51	0	0
22	28859409	.	A	G	27	13	40	0	1	41	0	0
22	28859618	.	A	G	21	19	40	0	3	43	0	0
22	28859683	.	G	T	24	15	39	0	1	40	0	0
22	28862336	.	C	T	11	15	26	0	2	28	0	0
22	28862534	.	A	G	11	16	27	0	1	28	0	0
22	28863137	.	G	A	15	11	26	0	1	27	0	0
22	28863140	.	G	A	13	10	23	0	1	24	0	0
22	28865752	.	G	A	17	14	31	0	2	33	0	0
22	28865970	.	A	G	13	8	21	0	0	21	0	0
22	28868174	.	A	G	21	11	32	0	0	32	0	0
22	28868183	.	T	C	20	9	29	0	4	33	0	0
22	28871698	.	G	C	23	0	23	0	16	39	0	0
22	29076058	.	T	G	5	3	8	0	0	8	0	0
22	29076126	.	A	G	9	4	13	0	0	13	0	0
22	29076172	.	G	A	13	6	19	0	0	19	0	0
22	29076236	.	T	C	12	7	19	0	1	20	0	0
22	29076381	.	G	C	11	12	23	0	1	24	0	0
22	29076389	.	A	G	11	10	21	0	1	22	0	0
22	29076444	.	G	C	7	9	16	0	1	17	0	0
22	29077023	.	T	A	11	9	20	0	0	20	0	0
22	29077380	.	G	A	9	7	16	0	0	16	0	0
22	29077432	.	A	G	2	8	10	0	0	10	0	0
22	29077515	.	G	A	3	8	11	0	0	11	0	0
22	29078255	.	T	A	7	5	12	0	0	12	0	0
22	29078715	.	C	T	6	7	13	0	1	14	0	0
22	29079722	.	G	T	10	11	21	0	1	22	0	0
22	29079761	.	T	C	6	9	15	0	2	17	0	0
22	29080205	.	G	A	13	11	24	0	0	24	0	0
22	29080233	.	G	A	7	9	16	0	3	19	0	0
22	29080427	.	G	A	16	8	24	0	3	27	0	0
22	29080477	.	T	G	11	10	21	0	1	22	0	0
22	29080864	.	C	T	7	15	22	0	1	23	0	0
22	29091732	.	G	C	8	7	15	0	1	16	0	0
22	29092222	.	C	A	4	12	16	0	0	16	0	0
22	29093632	.	G	T	11	5	16	0	2	18	0	0
22	29096343	.	C	T	2	2	4	0	0	4	0	0
22	29096361	.	G	A	2	2	4	0	0	4	0	0
22	29097228	.	C	T	7	8	15	0	0	15	0	0
22	29097303	.	A	G	9	0	9	0	9	18	0	0
22	29097327	.	T	C	7	9	16	0	0	16	0	0
22	29097354	.	T	A	8	7	15	0	0	15	0	0
22	29103453	.	A	G	5	4	9	0	0	9	0	0
22	29113882	.	A	G	3	4	7	0	1	8	0	0
22	29114351	.	G	A	14	8	22	0	1	23	0	0
22	29118736	.	G	A	1	12	13	0	8	21	0	0
22	29119270	.	T	C	4	7	11	0	2	13	0	0
22	29119326	.	T	A	3	7	10	0	0	10	0	0
22	29121740	.	G	A	0	5	5	0	5	10	0	0
22	29121765	.	C	T	6	6	12	0	1	13	0	0
22	29121789	.	G	A	0	8	8	0	6	14	0	0
22	29125660	.	C	T	7	4	11	0	0	11	0	0
22	29125699	.	T	A	7	5	12	0	0	12	0	0
22	29125791	.	T	A	6	5	11	0	0	11	0	0
22	29126817	.	G	A	1	2	3	0	0	3	0	0
22	29168879	.	G	A	30	31	61	0	2	63	0	0
22	29168940	.	T	A	31	30	61	0	4	65	0	0
22	29242280	.	A	G	23	9	32	0	3	35	0	0
22	29242296	.	G	C	19	15	34	0	0	34	0	0
22	29242317	.	G	A	7	12	19	0	2	21	0	0
22	29312360	.	T	A	3	2	5	0	0	5	0	0
22	29312363	.	T	C	3	2	5	0	0	5	0	0
22	29312851	.	A	C	1	3	4	0	0	4	0	0
22	29316013	.	T	C	2	2	4	0	0	4	0	0
22	29316091	.	T	A	4	8	12	0	0	12	0	0
22	29316139	.	A	T	2	6	8	0	0	8	0	0
22	29316153	.	A	C	3	0	3	0	5	8	0	0
22	29316479	.	A	T	2	2	4	0	3	7	0	0
22	29336097	.	A	G	1	2	3	0	0	3	0	0
22	29585169	.	G	A	1	2	3	0	0	3	0	0
22	29585244	.	G	A	2	2	4	0	0	4	0	0
22	29585247	.	G	C	2	3	5	0	0	5	0	0
22	29585304	.	T	C	2	4	6	0	0	6	0	0
22	29612096	.	A	G	8	4	12	0	1	13	0	0
22	29615056	.	A	G	9	8	17	0	0	17	0	0
22	29617050	.	G	A	7	6	13	0	1	14	0	0
22	29620306	.	A	G	8	4	12	0	1	13	0	0
22	29620488	.	T	G	5	8	13	0	0	13	0	0
22	29640098	.	T	C	4	7	11	0	0	11	0	0
22	29651938	.	C	T	9	17	26	0	1	27	0	0
22	29652161	.	T	A	13	11	24	0	0	24	0	0
22	29652201	.	A	G	7	0	7	0	14	21	0	0
22	29659031	.	T	A	4	4	8	0	0	8	0	0
22	29659637	.	G	A	23	25	48	0	1	49	0	0
22	29666501	.	G	A	24	18	42	1	0	43	0	0
22	29666505	.	C	T	3	24	27	1	18	46	0	0
22	29666746	.	G	A	16	18	34	0	0	34	0	0
22	29668796	.	C	T	13	13	26	0	0	26	0	0
22	29668799	.	C	T	14	11	25	0	1	26	0	0
22	29670324	.	G	A	15	15	30	0	0	30	0	0
22	29671553	.	A	G	11	15	26	1	2	29	0	0
22	29681366	.	G	A	1	4	5	2	0	7	0	0
22	29689458	.	T	C	18	18	36	0	3	39	0	0
22	29858936	.	T	C	9	14	23	1	1	25	0	0
22	30359955	.	G	T	14	2	16	0	0	16	0	0
22	31364253	.	A	G	1	0	1	0	2	3	0	0
22	31364277	.	A	T	3	3	6	0	0	6	0	0
22	31389400	.	A	C	6	4	10	0	0	10	0	0
22	31404427	.	T	A	3	6	9	0	0	9	0	0
22	31406548	.	G	A	0	5	5	0	4	9	0	0
22	31407736	.	G	C	5	2	7	0	0	7	0	0
22	31407847	.	A	T	2	1	3	0	1	4	0	0
22	31431740	.	G	A	0	2	2	0	1	3	0	0
22	31440806	.	C	T	2	7	9	0	0	9	0	0
22	31445113	.	A	G	2	3	5	0	0	5	0	0
22	31456026	.	A	T	4	4	8	0	0	8	0	0
22	31466141	.	G	A	3	4	7	0	0	7	0	0
22	31466268	.	A	G	3	3	6	0	0	6	0	0
22	31504542	.	G	C	6	2	8	0	0	8	0	0
22	31504546	.	C	A	4	4	8	0	0	8	0	0
22	31513575	.	C	T	0	8	8	0	4	12	0	0
22	31517163	.	A	G	4	2	6	0	0	6	0	0
22	31668049	.	T	C	18	1	19	0	12	31	0	0
22	31671957	.	T	A	19	21	40	0	2	43	1	0
22	31821990	.	G	C	6	5	11	0	1	12	0	0
22	31933332	.	G	A	0	7	7	0	8	15	0	0
22	31933335	.	T	G	7	8	15	0	0	15	0	0
22	31992224	.	G	A	0	4	4	0	2	6	0	0
22	32103392	.	T	C	7	4	11	0	0	11	0	0
22	32106535	.	C	T	8	6	14	0	2	16	0	0
22	32239223	.	A	G	2	5	7	0	1	8	0	0
22	32239227	.	A	G	3	5	8	0	0	8	0	0
22	34701851	.	G	A	1	3	4	0	0	4	0	0
22	34701901	.	G	C	12	23	35	0	2	37	0	0
22	34702200	.	A	G	32	25	57	0	1	58	0	0
22	34706938	.	T	C	37	20	57	0	2	59	0	0
22	34707041	.	A	G	20	2	22	0	21	43	0	0
22	34707062	.	T	G	19	12	31	0	1	32	0	0
22	34707084	.	C	T	20	15	35	0	1	36	0	0
22	34707119	.	G	T	20	15	35	0	0	35	0	0
22	34707272	.	T	A	13	16	29	0	6	35	0	0
22	34707295	.	C	T	6	14	20	0	3	23	0	0
22	34806074	.	A	C	2	5	7	0	0	7	0	0
22	34817865	.	C	G	3	3	6	0	1	7	0	0
22	34818012	.	C	A	2	4	6	0	0	6	0	0
22	34843892	.	C	T	1	3	4	0	4	8	0	0
22	34843910	.	T	C	4	3	7	0	0	7	0	0
22	34843964	.	C	A	0	3	3	0	7	10	0	0
22	34847690	.	A	G	1	7	8	0	0	8	0	0
22	34849108	.	G	A	1	4	5	0	0	5	0	0
22	34849285	.	G	A	2	2	4	0	0	4	0	0
22	34849297	.	A	C	2	0	2	0	2	4	0	0
22	34859662	.	C	T	0	2	2	0	3	5	0	0
22	34880611	.	C	T	1	2	3	0	3	6	0	0
22	34962553	.	G	A	2	4	6	0	0	6	0	0
22	34964031	.	G	A	3	2	5	0	0	5	0	0
22	34964055	.	C	T	0	3	3	0	3	6	0	0
22	34969708	.	A	G	1	2	3	0	0	3	0	0
22	35013675	.	C	T	0	8	8	0	2	10	0	0
22	35013679	.	C	T	1	8	9	0	0	9	0	0
22	35013855	.	A	T	1	4	5	0	0	5	0	0
22	35013856	.	T	G	1	3	4	0	1	5	0	0
22	35014014	.	G	A	3	4	7	0	0	7	0	0
22	35015699	.	T	C	1	2	3	0	0	3	0	0
22	35015828	.	C	T	2	3	5	0	0	5	0	0
22	35016177	.	G	A	5	5	10	0	1	11	0	0
22	35016185	.	A	G	6	6	12	0	0	12	0	0
22	35041537	.	T	C	4	7	11	0	2	13	0	0
22	35042857	.	T	C	9	0	9	0	7	16	0	0
22	35049063	.	A	G	6	9	15	0	0	15	0	0
22	35058599	.	A	G	7	6	13	0	1	14	0	0
22	35176526	.	C	A	4	0	4	0	14	18	0	0
22	35527460	.	A	G	4	2	6	0	1	7	0	0
22	35527461	.	T	C	4	3	7	0	0	7	0	0
22	35527749	.	G	A	0	2	2	0	1	3	0	0
22	35531002	.	C	T	6	3	9	0	1	10	0	0
22	35531196	.	G	A	3	2	5	0	1	6	0	0
22	35531281	.	G	A	1	3	4	0	0	4	0	0
22	35931992	.	A	G	4	0	4	0	3	7	0	0
22	36502348	.	T	C	2	2	4	0	0	4	0	0
22	36502355	.	G	T	1	3	4	0	0	4	0	0
22	36502390	.	A	G	2	2	4	0	0	4	0	0
22	36502399	.	T	A	1	2	3	0	1	4	0	0
22	36513878	.	G	A	1	3	4	0	0	4	0	0
22	36514675	.	G	A	1	2	3	0	0	3	0	0
22	36521516	.	G	A	3	3	6	0	0	6	0	0
22	36527075	.	C	T	9	3	12	0	1	13	0	0
22	36527591	.	A	G	8	3	11	0	0	11	0	0
22	36530090	.	C	T	1	6	7	0	6	13	0	0
22	36582968	.	C	A	2	2	4	0	0	4	0	0
22	36582983	.	G	A	1	2	3	0	2	5	0	0
22	36584949	.	C	T	3	2	5	0	1	6	0	0
22	36590944	.	C	T	1	5	6	0	0	6	0	0
22	36592548	.	C	A	2	4	6	1	0	7	0	0
22	36592638	.	T	C	4	3	7	0	0	7	0	0
22	36598444	.	C	T	4	6	10	0	2	12	0	0
22	36598459	.	G	C	7	7	14	0	1	15	0	0
22	36601758	.	A	G	3	0	3	0	6	9	0	0
22	36601761	.	A	C	3	6	9	0	0	9	0	0
22	36616814	.	G	A	0	3	3	0	3	6	0	0
22	36622717	.	A	G	4	5	9	0	1	10	0	0
22	36634111	.	T	C	6	3	9	0	1	10	0	0
22	36674186	.	G	A	37	11	48	0	3	51	0	0
22	36674646	.	A	G	7	10	17	1	3	21	0	0
22	36674658	.	G	A	11	14	25	1	1	27	0	0
22	36676056	.	G	C	30	24	54	0	1	55	0	0
22	36681357	.	T	G	22	21	43	0	3	46	0	0
22	36681359	.	A	G	21	22	43	0	4	47	0	0
22	36683803	.	C	A	27	18	45	0	0	45	0	0
22	36684170	.	A	G	27	22	49	8	0	57	0	0
22	36685768	.	T	C	28	0	28	0	25	53	0	0
22	36687328	.	G	A	24	14	38	1	5	44	0	0
22	36687403	.	G	A	25	21	46	0	0	46	0	0
22	36687418	.	C	T	2	19	21	0	25	46	0	0
22	36687616	.	C	T	1	30	31	0	23	54	0	0
22	36690743	.	A	G	2	2	4	0	0	4	0	0
22	36713738	.	G	C	4	2	6	1	0	7	0	0
22	36713763	.	A	T	3	3	6	0	0	6	0	0
22	36741498	.	G	A	2	4	6	2	0	8	0	0
22	36742674	.	T	A	3	6	9	2	0	11	0	0
22	36750472	.	G	A	3	4	7	3	1	11	0	0
22	36750518	.	G	A	3	4	7	3	0	10	0	0
22	36750547	.	G	A	4	4	8	1	0	9	0	0
22	36755458	.	A	T	1	2	3	0	0	3	0	0
22	36755680	.	T	A	4	3	7	1	0	8	0	0
22	36756005	.	T	C	3	7	10	0	0	10	0	0
22	36756112	.	A	G	4	11	15	0	0	15	0	0
22	36756154	.	A	T	8	7	15	0	0	15	0	0
22	36756325	.	G	A	3	8	11	0	0	11	0	0
22	36756400	.	C	T	5	12	17	0	1	18	0	0
22	36756404	.	G	C	5	12	17	0	1	18	0	0
22	36756464	.	T	A	5	6	11	0	2	13	0	0
22	36757140	.	C	G	3	2	5	0	2	7	0	0
22	36757170	.	C	T	7	9	16	0	1	17	0	0
22	36768102	.	G	A	7	4	11	1	0	12	0	0
22	36795279	.	C	T	4	4	8	0	0	8	0	0
22	36795755	.	G	C	9	12	21	0	2	23	0	0
22	36795803	.	T	C	8	0	8	0	15	23	0	0
22	36800685	.	T	A	9	6	15	0	0	15	0	0
22	36801126	.	G	A	6	2	8	0	0	8	0	0
22	36801283	.	A	T	5	3	8	0	0	8	0	0
22	36801429	.	C	T	4	4	8	0	0	8	0	0
22	36801551	.	A	T	3	2	5	0	0	5	0	0
22	36803075	.	G	T	1	3	4	0	1	5	0	0
22	36803414	.	G	T	3	4	7	0	0	7	0	0
22	36803531	.	G	A	9	5	14	0	1	15	0	0
22	36803561	.	A	G	6	4	10	0	0	10	0	0
22	36877344	.	T	C	8	12	20	0	1	21	0	0
22	36877531	.	G	A	2	9	11	0	7	18	0	0
22	36877534	.	G	T	2	10	12	0	6	18	0	0
22	36878044	.	T	A	8	10	18	0	0	18	0	0
22	36882388	.	T	C	13	10	23	0	1	24	0	0
22	36882409	.	T	A	15	9	24	0	1	25	0	0
22	36885065	.	T	G	11	0	11	0	8	19	0	0
22	36888572	.	A	G	17	0	17	0	15	32	0	0
22	36888623	.	A	G	16	12	28	0	0	28	0	0
22	36893357	.	G	A	9	11	20	0	0	20	0	0
22	36893411	.	A	C	10	9	19	0	3	23	1	0
22	36894283	.	T	A	14	12	26	0	0	26	0	0
22	36894410	.	A	C	9	18	27	0	3	30	0	0
22	36896641	.	G	A	1	10	11	0	10	21	0	0
22	36896681	.	C	T	7	10	17	0	4	21	0	0
22	36896705	.	C	T	4	13	17	0	0	17	0	0
22	36898727	.	T	C	17	6	23	0	0	23	0	0
22	36899149	.	G	A	4	10	14	0	15	29	0	0
22	36899269	.	C	T	19	15	34	0	1	35	0	0
22	36899621	.	A	T	3	6	9	0	0	9	0	0
22	36947793	.	T	A	6	8	14	0	0	14	0	0
22	36947797	.	G	T	8	6	14	0	0	14	0	0
22	36947963	.	T	C	4	0	4	0	11	15	0	0
22	36948177	.	C	A	3	10	13	0	1	14	0	0
22	36948237	.	A	T	6	5	11	0	0	11	0	0
22	36948242	.	A	G	6	5	11	0	0	11	0	0
22	36948312	.	C	T	0	4	4	0	9	13	0	0
22	36948410	.	G	A	6	12	18	0	0	18	0	0
22	36948530	.	A	G	11	10	21	0	2	23	0	0
22	36948672	.	T	G	3	2	5	0	3	8	0	0
22	36970997	.	A	G	1	5	6	0	0	6	0	0
22	36978378	.	C	T	1	3	4	0	0	4	0	0
22	36985054	.	A	G	2	2	4	0	0	4	0	0
22	36985066	.	A	G	2	2	4	0	0	4	0	0
22	37276606	.	C	A	6	12	18	0	0	18	0	0
22	37276709	.	C	T	1	6	7	0	11	18	0	0
22	37276717	.	A	G	6	13	19	0	0	19	0	0
22	37276971	.	T	A	3	4	7	0	0	7	0	0
22	37277941	.	A	C	1	5	6	0	0	6	0	0
22	37277963	.	A	G	1	4	5	0	2	7	0	0
22	37278260	.	G	T	1	4	5	0	0	5	0	0
22	37278385	.	G	A	5	4	9	0	0	9	0	0
22	37278475	.	A	G	12	11	23	0	1	24	0	0
22	37834111	.	G	T	15	13	28	0	0	28	0	0
22	37834215	.	T	C	11	9	20	0	1	21	0	0
22	37834218	.	G	A	10	10	20	0	0	20	0	0
22	37874723	.	C	T	5	3	8	0	0	8	0	0
22	37875270	.	T	C	4	9	13	0	0	13	0	0
22	37875454	.	C	G	3	3	6	0	1	7	0	0
22	37875482	.	T	G	4	6	10	0	0	10	0	0
22	37881023	.	G	A	8	12	20	0	0	20	0	0
22	37881433	.	G	T	10	9	19	0	0	19	0	0
22	37910031	.	C	T	2	2	4	0	0	4	0	0
22	37951871	.	C	A	1	6	7	0	1	8	0	0
22	37951877	.	G	A	2	4	6	0	0	6	0	0
22	37952292	.	C	A	2	2	4	0	0	4	0	0
22	37952411	.	A	T	1	3	4	0	0	4	0	0
22	37995397	.	T	A	3	3	6	0	0	6	0	0
22	38001504	.	G	A	4	7	11	0	0	11	0	0
22	38014843	.	A	G	2	5	7	0	0	7	0	0
22	38014900	.	T	C	3	5	8	0	0	8	0	0
22	38019898	.	T	C	1	5	6	0	0	6	0	0
22	38022147	.	C	T	4	2	6	0	0	6	0	0
22	38022171	.	A	T	4	4	8	0	0	8	0	0
22	38028903	.	A	G	1	2	3	0	1	4	0	0
22	38029013	.	T	C	4	5	9	0	1	10	0	0
22	38029035	.	A	T	6	2	8	0	0	8	0	0
22	38030646	.	T	C	4	3	7	0	0	7	0	0
22	38030803	.	C	T	1	3	4	0	1	5	0	0
22	38030812	.	C	T	1	3	4	0	1	5	0	0
22	38030854	.	C	A	5	2	7	0	0	7	0	0
22	38034721	.	T	C	3	3	6	0	0	6	0	0
22	38034830	.	C	T	1	5	6	0	3	9	0	0
22	38037578	.	A	T	9	7	16	0	1	17	0	0
22	38040050	.	G	A	0	6	6	0	4	10	0	0
22	38041860	.	T	A	11	9	20	0	0	20	0	0
22	38041893	.	C	T	18	10	28	0	0	28	0	0
22	38045009	.	T	A	6	11	17	0	3	20	0	0
22	38168506	.	G	T	1	2	3	0	0	3	0	0
22	38176538	.	C	T	5	2	7	0	1	8	0	0
22	38176577	.	C	T	4	6	10	0	1	11	0	0
22	38178703	.	G	A	1	6	7	0	9	16	0	0
22	38178736	.	T	C	5	4	9	0	1	10	0	0
22	38178747	.	G	A	4	5	9	0	1	10	0	0
22	38181037	.	G	A	2	4	6	0	0	6	0	0
22	38183762	.	C	T	6	7	13	0	2	15	0	0
22	38186385	.	C	A	5	8	13	0	2	15	0	0
22	38186409	.	A	G	6	10	16	0	0	16	0	0
22	38191029	.	C	G	4	12	16	0	0	16	0	0
22	38191168	.	C	G	8	6	14	0	0	14	0	0
22	38191181	.	G	A	5	7	12	0	1	13	0	0
22	38191715	.	A	G	9	13	22	0	0	22	0	0
22	38191718	.	T	A	13	10	23	0	1	24	0	0
22	38194106	.	C	T	21	17	38	0	1	39	0	0
22	38194124	.	T	G	18	16	34	0	0	34	0	0
22	38195217	.	G	A	18	23	41	0	0	41	0	0
22	38195229	.	C	T	21	19	40	1	2	43	0	0
22	38197900	.	C	T	32	33	65	0	6	71	0	0
22	38202898	.	T	C	6	7	13	0	0	13	0	0
22	38202904	.	C	T	6	7	13	0	0	13	0	0
22	38207367	.	T	A	6	2	8	0	0	8	0	0
22	38207454	.	A	G	3	5	8	0	1	9	0	0
22	38207495	.	G	T	2	6	8	0	0	8	0	0
22	38209295	.	A	G	4	2	6	0	0	6	0	0
22	38209646	.	C	T	2	5	7	0	1	8	0	0
22	38209685	.	C	G	0	7	7	0	2	9	0	0
22	38216690	.	G	T	3	7	10	0	0	10	0	0
22	38284020	.	A	C	5	5	10	0	0	10	0	0
22	38286993	.	C	A	3	6	9	0	0	9	0	0
22	38289964	.	T	C	4	11	15	0	0	15	0	0
22	38290259	.	C	T	3	2	5	0	0	5	0	0
22	38290307	.	G	A	8	4	12	0	0	12	0	0
22	38293746	.	G	A	1	9	10	0	9	19	0	0
22	38293785	.	C	G	14	0	14	0	9	23	0	0
22	38293791	.	C	G	14	0	14	0	11	25	0	0
22	38293854	.	T	C	11	9	20	0	1	21	0	0
22	38293890	.	C	T	8	8	16	0	2	18	0	0
22	38322307	.	G	A	0	2	2	0	1	3	0	0
22	38343178	.	G	A	9	7	16	0	1	17	0	0
22	38343217	.	C	T	0	5	5	0	10	15	0	0
22	38343265	.	G	T	9	7	16	0	0	16	0	0
22	38348138	.	G	A	4	5	9	0	1	10	0	0
22	38377029	.	C	T	3	6	9	0	0	9	0	0
22	38396186	.	C	G	4	3	7	0	0	7	0	0
22	38400939	.	T	C	7	3	10	0	1	11	0	0
22	38413289	.	C	T	0	3	3	0	2	5	0	0
22	38415019	.	C	T	0	2	2	0	2	4	0	0
22	38468163	.	A	G	14	8	22	0	1	23	0	0
22	38468562	.	C	T	4	26	30	0	24	54	0	0
22	38468595	.	C	T	29	20	49	0	5	54	0	0
22	38468644	.	C	T	24	20	44	0	1	45	0	0
22	38469848	.	C	A	2	21	23	0	22	45	0	0
22	38475593	.	A	G	33	19	52	0	2	54	0	0
22	38492116	.	G	A	22	24	46	0	5	51	0	0
22	38496335	.	A	G	17	23	40	0	1	41	0	0
22	38499727	.	C	T	0	18	18	1	20	39	0	0
22	38501815	.	G	C	16	21	37	0	2	39	0	0
22	38507937	.	C	T	24	14	38	0	3	41	0	0
22	38508006	.	C	A	23	21	44	0	0	44	0	0
22	38508018	.	C	A	23	16	39	0	1	40	0	0
22	38508100	.	C	T	15	19	34	0	4	38	0	0
22	38508102	.	C	T	14	22	36	0	1	37	0	0
22	38516814	.	A	T	17	17	34	0	1	35	0	0
22	38516816	.	C	T	16	17	33	0	1	34	0	0
22	38516899	.	G	A	8	6	14	0	2	16	0	0
22	38520336	.	A	C	12	1	13	0	1	14	0	0
22	38520360	.	A	C	13	7	20	0	1	21	0	0
22	38520867	.	A	T	10	9	19	0	1	20	0	0
22	38521353	.	G	C	19	9	28	0	1	29	0	0
22	38521454	.	C	A	5	7	12	0	0	12	0	0
22	38521542	.	T	C	4	2	6	0	1	7	0	0
22	38521596	.	C	G	4	6	10	0	1	11	0	0
22	38521683	.	A	T	21	14	35	0	2	37	0	0
22	38521883	.	C	A	4	5	9	0	0	9	0	0
22	38522271	.	G	T	11	10	21	0	2	23	0	0
22	38522468	.	C	T	6	5	11	0	1	12	0	0
22	38522471	.	T	A	7	6	13	0	1	14	0	0
22	38522622	.	G	C	12	12	24	0	1	25	0	0
22	38523540	.	T	A	13	10	23	0	1	24	0	0
22	38523917	.	C	A	0	9	9	0	10	19	0	0
22	38523941	.	T	C	8	8	16	0	0	16	0	0
22	38524033	.	T	C	10	6	16	0	0	16	0	0
22	38524099	.	C	T	5	5	10	0	0	10	0	0
22	38524107	.	C	T	6	4	10	0	0	10	0	0
22	38524304	.	T	A	7	7	14	0	1	15	0	0
22	38524322	.	G	A	5	8	13	0	0	13	0	0
22	38524544	.	A	G	13	7	20	0	0	20	0	0
22	38524621	.	G	C	9	6	15	0	2	17	0	0
22	38524721	.	T	C	7	0	7	0	6	13	0	0
22	38525003	.	C	T	1	9	10	0	10	20	0	0
22	38525326	.	T	G	8	4	12	0	1	13	0	0
22	38525996	.	G	T	6	5	11	0	0	11	0	0
22	38526033	.	A	G	5	6	11	0	0	11	0	0
22	38543597	.	C	G	15	9	24	0	0	24	0	0
22	38549152	.	G	A	13	7	20	0	3	23	0	0
22	38549990	.	A	G	9	11	20	0	0	20	0	0
22	38550922	.	T	C	7	7	14	0	0	14	0	0
22	38559907	.	A	G	16	13	29	0	0	29	0	0
22	38567348	.	C	T	1	6	7	0	9	16	0	0
22	38615186	.	T	A	5	2	7	0	0	7	0	0
22	38617884	.	G	A	4	6	10	0	0	10	0	0
22	38621256	.	A	T	9	6	15	0	0	15	0	0
22	38796811	.	T	C	7	0	7	0	8	15	0	0
22	38798816	.	T	C	3	0	3	0	10	13	0	0
22	38800038	.	T	A	4	3	7	0	1	8	0	0
22	38801483	.	C	T	1	6	7	0	0	8	1	0
22	38905799	.	A	G	2	3	5	0	0	5	0	0
22	38906622	.	C	G	1	3	4	0	0	4	0	0
22	38911658	.	T	A	1	2	3	0	0	3	0	0
22	38911814	.	G	T	2	2	4	0	0	4	0	0
22	38912535	.	C	A	1	3	4	0	0	4	0	0
22	38912542	.	T	C	1	2	3	0	0	3	0	0
22	38912863	.	G	A	1	2	3	0	0	3	0	0
22	38912944	.	A	G	4	2	6	0	0	6	0	0
22	38913626	.	G	C	1	3	4	0	0	4	0	0
22	38913631	.	G	A	1	3	4	0	0	4	0	0
22	38915071	.	T	A	5	9	14	0	0	14	0	0
22	38919010	.	A	C	4	4	8	0	0	8	0	0
22	38919290	.	A	C	5	2	7	0	0	7	0	0
22	38919325	.	G	T	0	4	4	0	4	8	0	0
22	38919354	.	G	C	2	3	5	0	1	7	1	0
22	38919752	.	C	T	3	5	8	0	0	8	0	0
22	38928275	.	T	A	8	6	14	0	0	14	0	0
22	38928367	.	G	C	0	5	5	0	9	14	0	0
22	38928450	.	A	T	2	6	8	0	1	9	0	0
22	38928517	.	T	A	6	3	9	1	0	10	0	0
22	38928586	.	G	A	3	7	10	0	0	10	0	0
22	38928593	.	G	T	3	6	9	0	0	9	0	0
22	38928738	.	G	A	5	3	8	0	0	8	0	0
22	38928979	.	T	G	4	3	7	0	0	7	0	0
22	38929002	.	T	C	2	4	6	0	0	6	0	0
22	38929112	.	T	C	2	4	6	0	1	7	0	0
22	38932288	.	G	A	13	7	20	0	1	21	0	0
22	38934663	.	C	T	2	14	16	0	0	16	0	0
22	38934759	.	T	C	9	0	9	0	6	15	0	0
22	38937336	.	A	G	1	0	1	0	5	6	0	0
22	38943059	.	T	C	7	3	10	0	0	10	0	0
22	38943113	.	T	C	5	6	11	0	0	11	0	0
22	38943160	.	G	A	1	2	3	0	2	5	0	0
22	38945312	.	C	T	9	2	11	1	0	12	0	0
22	38945316	.	A	C	9	2	11	1	0	12	0	0
22	38945420	.	T	C	1	6	7	0	0	7	0	0
22	38945937	.	C	T	2	2	4	0	0	4	0	0
22	38946013	.	T	G	2	2	4	0	1	5	0	0
22	38946014	.	C	T	0	2	2	0	3	5	0	0
22	38946148	.	G	C	1	5	6	0	0	6	0	0
22	38946246	.	T	A	3	6	9	0	0	9	0	0
22	38946287	.	A	G	4	6	10	0	0	10	0	0
22	38946369	.	G	C	2	4	6	0	0	6	0	0
22	38946403	.	T	C	2	1	3	0	1	4	0	0
22	38946553	.	T	C	4	6	10	0	0	10	0	0
22	38946576	.	T	C	7	9	16	0	0	16	0	0
22	38946608	.	A	C	10	10	20	0	0	20	0	0
22	38946953	.	T	A	17	10	27	0	0	27	0	0
22	38951084	.	T	C	9	12	21	0	0	21	0	0
22	38951130	.	A	T	8	15	23	0	1	24	0	0
22	38951137	.	C	A	9	14	23	0	1	24	0	0
22	39015203	.	A	T	5	4	9	0	1	10	0	0
22	39015567	.	A	G	9	10	19	0	0	19	0	0
22	39017130	.	G	A	0	9	9	0	8	17	0	0
22	39023318	.	G	C	0	3	3	0	4	7	0	0
22	39023435	.	A	G	2	6	8	0	1	9	0	0
22	39023501	.	T	C	3	5	8	0	0	8	0	0
22	39023680	.	C	A	11	10	21	0	3	24	0	0
22	39026706	.	T	C	5	8	13	0	0	13	0	0
22	39027520	.	A	C	5	6	11	0	0	11	0	0
22	39028350	.	G	A	1	9	10	0	6	16	0	0
22	39028700	.	T	G	6	0	6	0	16	22	0	0
22	39032738	.	C	A	5	7	12	0	0	12	0	0
22	39032814	.	A	G	9	8	17	0	0	17	0	0
22	39032925	.	A	G	4	11	15	0	0	15	0	0
22	39033134	.	C	T	10	10	20	0	0	20	0	0
22	39033332	.	A	G	2	0	2	0	5	7	0	0
22	39033637	.	C	G	7	9	16	0	3	19	0	0
22	39033644	.	T	C	8	5	13	0	1	14	0	0
22	39033838	.	T	G	4	3	7	1	0	8	0	0
22	39054209	.	A	G	5	6	11	0	0	11	0	0
22	39054260	.	A	C	6	8	14	0	0	14	0	0
22	39054270	.	G	A	3	5	8	0	1	9	0	0
22	39054466	.	C	T	5	3	8	0	1	9	0	0
22	39054510	.	G	A	7	6	13	0	2	15	0	0
22	39076602	.	C	T	7	7	14	0	0	14	0	0
22	39077407	.	C	G	16	0	16	0	14	30	0	0
22	39079335	.	G	A	1	5	6	0	11	17	0	0
22	39079356	.	A	C	7	11	18	0	0	18	0	0
22	39079379	.	C	A	6	12	18	0	0	18	0	0
22	39079428	.	C	G	12	5	17	0	0	17	0	0
22	39079470	.	G	A	0	10	10	1	8	19	0	0
22	39079528	.	T	A	5	9	14	0	2	16	0	0
22	39079950	.	C	A	9	10	19	0	1	20	0	0
22	39080035	.	C	G	10	16	26	0	0	26	0	0
22	39080043	.	G	C	8	17	25	0	1	26	0	0
22	39080290	.	C	T	10	13	23	0	0	23	0	0
22	39080402	.	A	C	13	11	24	0	3	27	0	0
22	39080547	.	A	C	12	11	23	0	1	24	0	0
22	39080679	.	C	G	10	8	18	0	3	21	0	0
22	39080701	.	C	A	16	12	28	0	0	28	0	0
22	39081126	.	A	T	14	5	19	0	0	19	0	0
22	39084966	.	A	T	9	7	16	0	1	17	0	0
22	39095748	.	G	A	9	3	12	0	2	14	0	0
22	39095966	.	T	C	6	2	8	0	0	8	0	0
22	39096080	.	C	A	7	2	9	0	0	9	0	0
22	39100984	.	C	T	5	2	7	0	1	8	0	0
22	39104849	.	G	A	4	2	6	0	1	7	0	0
22	39105022	.	T	C	1	3	4	0	0	4	0	0
23	252305	.	T	C	2	3	5	0	1	6	0	0
23	310662	.	G	T	15	11	26	0	4	30	0	0
23	310860	.	G	C	8	10	18	0	0	18	0	0
23	312700	.	C	A	12	10	22	0	1	23	0	0
23	312703	.	A	C	13	10	23	0	0	24	1	0
23	313274	.	G	A	11	6	17	0	1	18	0	0
23	313368	.	A	G	6	0	6	0	13	19	0	0
23	313468	.	A	G	2	2	4	0	1	5	0	0
23	313485	.	G	A	4	2	6	0	0	6	0	0
23	313559	.	G	A	4	6	10	0	0	10	0	0
23	314018	.	G	A	6	7	13	0	0	13	0	0
23	314055	.	T	C	3	2	5	0	0	5	0	0
23	314268	.	T	C	1	6	7	0	1	8	0	0
23	314284	.	A	T	0	6	6	0	0	6	0	0
23	314370	.	T	A	5	5	10	0	0	10	0	0
23	314413	.	G	T	0	5	5	0	7	12	0	0
23	314573	.	A	G	1	4	5	0	0	5	0	0
23	314647	.	A	G	1	7	8	0	0	8	0	0
23	314648	.	T	A	1	6	7	0	1	8	0	0
23	314841	.	A	T	1	2	3	0	0	3	0	0
23	314910	.	C	T	5	4	9	0	0	9	0	0
23	315057	.	G	C	2	4	6	0	1	7	0	0
23	315286	.	A	G	23	6	29	0	2	31	0	0
23	320806	.	T	C	5	11	16	0	1	17	0	0
23	320819	.	A	G	9	7	16	0	2	18	0	0
23	322290	.	A	G	6	9	15	0	0	15	0	0
23	324071	.	G	A	2	6	8	0	0	8	0	0
23	324614	.	C	A	0	5	5	0	4	9	0	0
23	324662	.	A	G	2	4	6	0	0	6	0	0
23	327998	.	C	T	10	4	14	0	1	15	0	0
23	328248	.	G	C	10	8	18	0	1	19	0	0
23	328251	.	T	C	9	0	9	0	10	19	0	0
23	328469	.	A	T	6	9	15	0	0	15	0	0
23	328582	.	G	T	6	7	13	0	0	13	0	0
23	328589	.	T	A	8	7	15	0	0	15	0	0
23	328783	.	G	T	12	6	18	0	1	19	0	0
23	328806	.	C	G	14	7	21	0	1	22	0	0
23	328825	.	C	T	2	11	13	0	12	25	0	0
23	328916	.	G	C	7	0	7	0	7	14	0	0
23	336332	.	A	T	6	2	8	0	0	8	0	0
23	339059	.	G	A	7	5	12	0	0	12	0	0
23	341802	.	C	G	5	4	9	0	0	9	0	0
23	341820	.	T	C	2	0	2	0	5	7	0	0
23	343229	.	G	A	5	3	8	0	1	9	0	0
23	344114	.	T	A	4	6	10	0	1	11	0	0
23	354431	.	C	T	4	3	7	0	0	7	0	0
23	355312	.	G	A	3	4	7	0	0	7	0	0
23	355954	.	C	T	3	4	7	0	0	7	0	0
23	359116	.	G	A	3	3	6	0	0	6	0	0
23	359371	.	A	T	6	3	9	0	0	9	0	0
23	359442	.	C	T	4	8	12	0	0	12	0	0
23	360316	.	C	T	2	6	8	0	0	8	0	0
23	360355	.	G	A	3	5	8	0	0	8	0	0
23	365495	.	A	G	6	0	6	0	8	14	0	0
23	366662	.	T	C	6	3	9	0	0	9	0	0
23	367431	.	T	A	6	3	9	0	0	9	0	0
23	367500	.	C	T	5	6	11	0	0	11	0	0
23	367521	.	G	A	6	3	9	0	0	9	0	0
23	367535	.	T	C	2	4	6	0	0	6	0	0
23	457797	.	A	T	4	2	6	1	0	7	0	0
23	457872	.	T	C	2	3	5	0	0	5	0	0
23	457995	.	A	T	2	5	7	1	0	8	0	0
23	458042	.	C	T	2	2	4	1	0	5	0	0
23	458086	.	G	A	6	5	11	0	0	11	0	0
23	458194	.	T	A	3	2	5	0	0	5	0	0
23	458995	.	A	T	4	2	6	0	0	6	0	0
23	459015	.	T	C	1	4	5	0	0	5	0	0
23	459671	.	C	T	0	4	4	0	9	13	0	0
23	460612	.	G	C	2	4	6	0	0	6	0	0
23	460794	.	C	T	2	6	8	0	1	9	0	0
23	460926	.	G	A	1	2	3	0	0	3	0	0
23	461010	.	G	A	3	3	6	0	0	6	0	0
23	461177	.	T	C	3	5	8	0	2	10	0	0
23	461273	.	G	A	7	2	9	0	0	9	0	0
23	461636	.	A	G	5	4	9	0	0	9	0	0
23	462156	.	G	T	2	2	4	0	0	4	0	0
23	462162	.	G	A	2	3	5	0	0	5	0	0
23	464395	.	C	T	2	2	4	0	0	4	0	0
23	464402	.	G	C	2	2	4	0	0	4	0	0
23	464469	.	T	G	1	3	4	0	1	5	0	0
23	464521	.	A	T	2	4	6	0	0	6	0	0
23	464663	.	A	G	0	2	2	0	1	3	0	0
23	467114	.	T	G	1	2	3	0	0	3	0	0
23	467145	.	T	G	0	2	2	0	1	3	0	0
23	471054	.	A	G	2	3	5	0	0	5	0	0
23	473250	.	A	G	2	4	6	0	0	6	0	0
23	476092	.	T	A	2	2	4	0	0	4	0	0
23	480551	.	C	G	4	11	15	0	0	15	0	0
23	480552	.	A	G	4	11	15	0	0	15	0	0
23	481089	.	T	G	30	11	41	0	3	44	0	0
23	484376	.	C	A	26	16	42	1	0	43	0	0
23	484588	.	G	A	17	11	28	0	1	29	0	0
23	488257	.	A	G	15	12	27	0	1	28	0	0
23	488996	.	G	A	19	17	36	0	1	37	0	0
23	491052	.	G	A	11	13	24	0	1	25	0	0
23	493127	.	A	C	10	0	10	0	14	24	0	0
23	495817	.	T	A	2	2	4	0	0	4	0	0
23	496469	.	A	G	1	2	3	0	0	3	0	0
23	496582	.	C	T	2	3	5	0	0	5	0	0
23	496672	.	G	A	1	4	5	0	0	5	0	0
23	500195	.	A	G	3	4	7	0	0	7	0	0
23	500255	.	T	C	2	0	2	0	3	5	0	0
23	506078	.	C	G	8	6	14	0	0	14	0	0
23	517969	.	C	T	0	4	4	0	1	5	0	0
23	527301	.	T	C	3	4	7	0	0	7	0	0
23	527331	.	T	A	2	6	8	0	0	9	1	0
23	527362	.	T	C	0	7	7	0	1	8	0	0
23	527384	.	T	C	5	2	7	0	0	7	0	0
23	527620	.	G	A	3	3	6	0	0	6	0	0
23	527621	.	T	G	2	3	5	0	0	5	0	0
23	528234	.	T	A	2	4	6	0	0	6	0	0
23	531253	.	C	T	0	5	5	0	4	9	0	0
23	531256	.	T	C	4	0	4	0	5	9	0	0
23	531290	.	C	A	4	2	6	0	0	6	0	0
23	536780	.	C	T	5	2	7	0	0	7	0	0
23	547870	.	T	G	3	5	8	0	1	9	0	0
23	547873	.	G	A	4	5	9	0	0	9	0	0
23	551277	.	C	T	4	5	9	0	0	9	0	0
23	585825	.	A	G	12	8	20	0	0	20	0	0
23	585848	.	A	G	11	0	11	0	9	20	0	0
23	587161	.	A	G	6	5	11	0	0	11	0	0
23	804124	.	A	G	4	1	5	0	3	8	0	0
23	804154	.	G	C	6	3	9	0	2	11	0	0
23	804164	.	A	G	6	5	11	0	0	11	0	0
23	804687	.	A	G	2	0	2	0	4	6	0	0
23	805479	.	A	T	5	3	8	0	1	9	0	0
23	811188	.	T	C	1	4	5	0	0	5	0	0
23	813290	.	T	C	7	5	12	0	0	12	0	0
23	816171	.	A	G	3	1	4	0	3	7	0	0
23	821178	.	T	A	6	4	10	0	0	10	0	0
23	821220	.	C	T	6	7	13	0	2	15	0	0
23	825773	.	A	G	3	4	7	0	0	7	0	0
23	828299	.	G	A	4	4	8	0	0	8	0	0
23	828372	.	C	A	2	3	5	0	0	5	0	0
23	830033	.	C	T	6	5	11	0	0	11	0	0
23	830047	.	G	C	6	5	11	0	1	12	0	0
23	831608	.	G	C	4	12	16	0	0	16	0	0
23	831613	.	A	G	3	12	15	0	1	16	0	0
23	831659	.	C	T	8	4	12	0	1	13	0	0
23	831749	.	T	C	9	8	17	0	0	17	0	0
23	835575	.	G	C	8	3	11	0	0	12	1	0
23	835631	.	A	G	5	4	9	0	0	9	0	0
23	835712	.	A	G	3	5	8	0	1	9	0	0
23	835717	.	T	C	4	4	8	0	0	8	0	0
23	835970	.	G	A	5	3	8	0	2	10	0	0
23	838285	.	C	G	6	4	10	0	0	10	0	0
23	862501	.	C	G	1	3	4	0	0	4	0	0
23	862713	.	T	G	2	2	4	0	0	4	0	0
23	862782	.	T	A	5	5	10	0	0	10	0	0
23	863024	.	G	A	3	3	6	0	0	6	0	0
23	863105	.	T	A	5	3	8	0	0	8	0	0
23	863135	.	A	G	5	4	9	0	0	9	0	0
23	863261	.	C	A	4	3	7	0	0	7	0	0
23	863967	.	A	T	4	2	6	0	0	7	1	0
23	863971	.	T	C	3	5	8	0	0	8	0	0
23	864595	.	T	C	2	2	4	0	1	5	0	0
23	864657	.	T	C	1	4	5	0	0	5	0	0
23	864658	.	T	C	1	0	1	0	4	5	0	0
23	865619	.	T	C	5	5	10	0	1	11	0	0
23	865644	.	G	T	5	9	14	0	0	14	0	0
23	865726	.	G	A	4	2	6	0	0	6	0	0
23	865999	.	C	T	0	7	7	0	2	9	0	0
23	866004	.	A	T	2	7	9	0	0	9	0	0
23	866409	.	A	G	13	6	19	0	0	19	0	0
23	866439	.	C	T	0	9	9	0	11	20	0	0
23	866444	.	T	C	11	1	12	0	8	20	0	0
23	866836	.	A	G	10	12	22	0	0	22	0	0
23	874342	.	A	G	5	10	15	0	0	15	0	0
23	874620	.	A	G	7	10	17	0	0	17	0	0
23	874621	.	T	G	7	10	17	0	0	17	0	0
23	895965	.	G	A	5	4	9	0	0	9	0	0
23	896023	.	C	A	3	9	12	0	0	12	0	0
23	898127	.	A	G	6	5	11	0	1	12	0	0
23	898217	.	A	G	4	6	10	0	1	11	0	0
23	898329	.	T	G	5	5	10	0	1	11	0	0
23	903104	.	A	G	2	7	9	0	0	9	0	0
23	903212	.	G	C	18	9	27	0	2	29	0	0
23	903334	.	G	A	23	18	41	0	0	41	0	0
23	903415	.	T	A	13	21	34	0	0	34	0	0
23	903553	.	T	G	20	25	45	0	4	50	1	0
23	903848	.	G	A	23	20	43	0	1	44	0	0
23	906346	.	T	A	18	22	40	0	0	40	0	0
23	910357	.	A	G	20	17	37	0	0	37	0	0
23	1045635	.	A	C	3	1	4	0	1	5	0	0
23	1046764	.	A	C	1	2	3	0	0	3	0	0
23	1046767	.	G	A	1	2	3	0	0	3	0	0
23	1048361	.	A	G	1	2	3	0	0	3	0	0
23	1235029	.	C	T	3	2	5	0	0	5	0	0
23	1235552	.	G	A	1	2	3	0	0	3	0	0
23	1240569	.	T	C	3	4	7	0	0	7	0	0
23	1240614	.	A	G	2	2	4	0	0	4	0	0
23	1262521	.	C	T	3	3	6	0	0	6	0	0
23	1269234	.	G	T	0	2	2	0	1	3	0	0
23	1270215	.	T	A	2	3	5	0	0	5	0	0
23	1565211	.	T	A	1	2	3	0	0	3	0	0
23	1565256	.	C	T	0	2	2	0	2	4	0	0
23	1565454	.	C	T	0	2	2	0	1	3	0	0
23	1565984	.	A	C	2	0	2	0	3	5	0	0
23	1691708	.	G	A	1	3	4	0	3	7	0	0
23	1697434	.	C	T	5	2	7	0	2	9	0	0
23	1697689	.	A	G	3	4	7	0	0	7	0	0
23	1697726	.	A	G	7	4	11	0	0	11	0	0
23	1698202	.	C	T	8	4	12	0	0	12	0	0
23	1698229	.	G	T	4	3	7	0	0	7	0	0
23	1698256	.	G	A	3	3	6	0	0	6	0	0
23	1702648	.	C	T	7	7	14	0	2	16	0	0
23	1709724	.	C	T	12	7	19	0	0	19	0	0
23	1709740	.	A	G	11	0	11	0	9	20	0	0
23	1719384	.	A	G	8	4	12	0	3	15	0	0
23	1723720	.	A	G	10	0	10	0	8	18	0	0
23	1723748	.	G	A	7	6	13	0	1	14	0	0
23	1723992	.	C	T	9	5	14	0	2	16	0	0
23	1725456	.	T	C	6	7	13	0	0	13	0	0
23	1725785	.	G	C	5	4	9	0	1	10	0	0
23	1725803	.	G	C	3	7	10	0	0	10	0	0
23	1725959	.	C	T	12	4	16	0	0	16	0	0
23	1725974	.	T	A	11	6	17	0	0	17	0	0
23	1726080	.	T	C	17	8	25	0	3	28	0	0
23	1726467	.	T	A	6	3	9	0	0	9	0	0
23	2053414	.	A	G	1	1	2	0	1	3	0	0
23	2053418	.	C	A	1	3	4	0	0	4	0	0
23	2054010	.	C	T	11	8	19	0	2	21	0	0
23	2054175	.	G	A	8	7	15	0	2	17	0	0
23	2054316	.	C	G	9	12	21	0	1	22	0	0
23	2054505	.	G	A	6	6	12	0	0	12	0	0
23	2054584	.	G	C	4	9	13	0	0	13	0	0
23	2054613	.	A	G	5	10	15	0	0	15	0	0
23	2054622	.	T	C	5	0	5	0	9	14	0	0
23	2054760	.	G	A	3	3	6	0	0	6	0	0
23	2054838	.	C	T	1	3	4	0	7	11	0	0
23	2054886	.	A	G	5	4	9	0	0	9	0	0
23	2054952	.	T	G	6	7	13	0	0	13	0	0
23	2055162	.	G	A	9	8	17	0	0	17	0	0
23	2055219	.	T	C	7	7	14	0	0	14	0	0
23	2055240	.	T	A	3	7	10	0	0	10	0	0
23	2081004	.	T	G	8	3	11	0	1	12	0	0
23	2099214	.	A	G	7	6	13	0	1	14	0	0
23	2136417	.	T	C	13	10	23	0	0	23	0	0
23	2155134	.	T	C	7	13	20	0	2	22	0	0
23	2158054	.	T	C	5	10	15	0	0	15	0	0
23	2159114	.	G	A	13	6	19	0	1	20	0	0
23	2160242	.	T	C	15	9	24	0	0	24	0	0
23	2192341	.	T	A	3	2	5	0	0	5	0	0
23	2204806	.	T	C	2	4	6	0	0	6	0	0
23	2232040	.	T	C	4	3	7	0	0	7	0	0
23	2246536	.	G	A	5	5	10	1	0	11	0	0
23	2246855	.	C	G	2	0	2	0	3	5	0	0
23	2249589	.	G	A	0	2	2	0	2	4	0	0
23	2256142	.	G	C	1	5	6	0	0	6	0	0
23	2361516	.	A	G	11	11	22	1	0	23	0	0
23	2391852	.	G	A	1	15	16	0	14	30	0	0
23	2421552	.	C	T	3	2	5	0	0	5	0	0
23	2435776	.	G	A	31	21	52	0	3	55	0	0
23	2438388	.	G	A	18	29	47	0	1	48	0	0
23	2438463	.	G	T	1	17	18	0	22	40	0	0
23	2438641	.	A	T	26	19	45	0	0	45	0	0
23	2440698	.	G	A	16	21	37	0	1	38	0	0
23	2443160	.	C	T	19	24	43	0	0	43	0	0
23	2443613	.	C	T	13	19	32	0	0	32	0	0
23	2443772	.	T	C	14	3	17	0	1	18	0	0
23	2443782	.	T	C	16	3	19	0	1	20	0	0
23	2542247	.	T	A	4	6	10	0	1	11	0	0
23	2547556	.	A	C	15	9	24	0	0	24	0	0
23	2564339	.	T	A	19	16	35	3	2	40	0	0
23	2564420	.	T	C	19	13	32	0	0	32	0	0
23	2679634	.	G	A	1	10	11	20	11	42	0	0
23	2689807	.	T	C	20	15	35	0	2	37	0	0
23	2690659	.	C	T	22	16	38	0	3	41	0	0
23	2703243	.	T	A	10	6	16	0	0	16	0	0
23	2709931	.	T	C	4	6	10	0	0	10	0	0
23	2716519	.	C	A	9	6	15	0	0	15	0	0
23	2717852	.	A	C	15	22	37	0	1	38	0	0
23	2717867	.	T	G	15	23	38	0	2	40	0	0
23	2718009	.	C	G	16	14	30	0	1	31	0	0
23	2721539	.	A	G	17	12	29	0	1	30	0	0
23	2725095	.	A	C	4	11	15	0	1	16	0	0
23	2757841	.	C	T	11	6	17	0	0	17	0	0
23	2757876	.	T	A	7	4	11	0	0	11	0	0
23	2762007	.	A	G	9	8	17	0	2	19	0	0
23	2762855	.	G	A	4	8	12	1	0	13	0	0
23	2767194	.	G	A	1	14	15	0	11	26	0	0
23	2767227	.	C	T	6	7	13	0	3	16	0	0
23	2773310	.	C	T	11	3	14	0	0	14	0	0
23	2774812	.	G	A	4	18	22	0	0	22	0	0
23	2775033	.	G	A	5	5	10	0	0	10	0	0
23	2777534	.	G	A	7	3	10	0	0	10	0	0
23	2778827	.	A	G	2	6	8	0	2	10	0	0
23	2837155	.	T	C	9	10	19	0	1	20	0	0
23	2837188	.	C	T	8	11	19	0	1	20	0	0
23	2837218	.	T	C	10	8	18	0	4	22	0	0
23	2839156	.	G	T	1	4	5	0	7	12	0	0
23	2842292	.	G	T	2	7	9	0	11	20	0	0
23	2842407	.	C	A	9	3	12	0	0	13	1	0
23	2842409	.	G	A	9	4	13	0	0	13	0	0
23	2849307	.	G	A	0	6	6	0	13	19	0	0
23	2860937	.	T	G	7	0	7	0	11	18	0	0
23	2861990	.	C	T	9	12	21	0	0	21	0	0
23	2864186	.	A	T	11	6	17	0	0	17	0	0
23	2870732	.	T	A	14	10	24	0	1	25	0	0
23	2871264	.	C	T	9	5	14	0	0	14	0	0
23	2871699	.	G	A	15	10	25	0	1	26	0	0
23	2871908	.	A	G	10	7	17	0	0	17	0	0
23	2871994	.	T	C	12	7	19	0	0	19	0	0
23	2872206	.	T	C	15	11	26	0	2	28	0	0
23	2872338	.	T	G	20	0	20	0	12	32	0	0
23	2872517	.	G	T	16	19	35	0	4	39	0	0
23	2872924	.	A	C	1	2	3	0	0	3	0	0
23	2877144	.	C	T	1	9	10	0	6	16	0	0
23	2877519	.	T	C	4	0	4	0	10	14	0	0
23	2877603	.	A	C	5	4	9	0	0	9	0	0
23	2877930	.	T	C	6	6	12	0	0	12	0	0
23	2878041	.	C	A	0	6	6	0	5	11	0	0
23	2878401	.	A	G	6	3	9	0	1	10	0	0
23	2878629	.	T	G	7	5	12	0	0	12	0	0
23	2878630	.	A	C	5	5	10	0	2	12	0	0
23	2878689	.	C	T	1	2	3	0	0	3	0	0
23	2878974	.	A	T	3	2	5	0	0	5	0	0
23	2879040	.	A	G	3	3	6	0	0	6	0	0
23	2880143	.	T	C	2	5	7	0	0	7	0	0
23	2880272	.	G	T	2	2	4	0	0	4	0	0
23	2900767	.	A	G	6	3	9	0	2	11	0	0
23	2906312	.	A	G	7	12	19	0	1	20	0	0
23	2914612	.	A	G	5	0	5	0	6	11	0	0
23	2914789	.	C	A	8	2	10	0	0	10	0	0
23	2917463	.	T	C	7	3	10	0	0	10	0	0
23	2919264	.	A	G	7	0	7	0	7	14	0	0
23	2919276	.	T	C	5	7	12	0	0	12	0	0
23	2920448	.	C	T	5	6	11	0	0	11	0	0
23	2920588	.	G	T	1	3	4	0	6	10	0	0
23	2920603	.	T	C	2	6	8	0	0	8	0	0
23	2920753	.	G	A	6	6	12	0	2	14	0	0
23	2923068	.	G	A	0	2	2	0	5	7	0	0
23	2925086	.	T	C	6	6	12	0	0	12	0	0
23	2925137	.	C	T	10	7	17	0	1	18	0	0
23	2925357	.	T	C	9	4	13	0	1	14	0	0
23	2927117	.	A	G	7	4	11	0	1	12	0	0
23	2927144	.	A	G	13	8	21	0	0	21	0	0
23	2927175	.	C	T	11	8	19	0	1	20	0	0
23	2928559	.	G	A	9	3	12	0	1	13	0	0
23	2928583	.	A	G	9	4	13	0	0	13	0	0
23	2929180	.	A	G	8	4	12	0	0	12	0	0
23	2931288	.	T	A	2	8	10	0	2	12	0	0
23	2931321	.	G	A	6	8	14	0	1	15	0	0
23	2931329	.	C	A	7	10	17	0	0	17	0	0
23	2931358	.	C	T	7	14	21	0	0	21	0	0
23	2931409	.	C	T	8	14	22	0	0	22	0	0
23	2931461	.	A	G	6	0	6	0	7	13	0	0
23	2931732	.	C	A	6	9	15	0	0	15	0	0
23	2931836	.	C	A	9	4	13	0	0	13	0	0
23	2931970	.	T	A	8	7	15	0	0	15	0	0
23	2932241	.	A	T	8	4	12	0	0	12	0	0
23	3406094	.	C	A	5	3	8	0	2	10	0	0
23	3406708	.	T	C	11	11	22	0	0	22	0	0
23	3406729	.	A	G	12	11	23	0	1	24	0	0
23	3406811	.	T	C	18	17	35	0	1	36	0	0
23	3406950	.	T	G	6	10	16	0	0	16	0	0
23	3407285	.	T	A	11	20	31	0	2	33	0	0
23	3407305	.	C	A	11	22	33	0	1	34	0	0
23	3503614	.	C	A	3	5	8	0	0	8	0	0
23	3503622	.	A	G	3	4	7	0	0	7	0	0
23	3511204	.	C	A	1	2	3	0	0	3	0	0
23	3511291	.	T	C	2	5	7	0	0	7	0	0
23	3517582	.	T	A	6	8	14	0	1	15	0	0
23	3517621	.	T	G	4	12	16	0	2	18	0	0
23	3517734	.	T	G	12	1	13	0	11	24	0	0
23	3517800	.	C	T	7	6	13	0	0	13	0	0
23	3520120	.	C	T	12	17	29	0	1	30	0	0
23	3653478	.	G	T	20	21	41	0	2	43	0	0
23	3653846	.	T	C	25	16	41	0	0	41	0	0
23	3653859	.	G	A	23	16	39	0	0	39	0	0
23	3653953	.	T	A	18	9	27	0	0	28	1	0
23	3654034	.	A	G	13	19	32	0	1	33	0	0
23	3654106	.	C	T	6	7	13	0	0	13	0	0
23	3654134	.	A	G	3	7	10	0	0	10	0	0
23	3654356	.	C	T	10	14	24	0	0	24	0	0
23	3654490	.	A	C	24	10	34	0	1	35	0	0
23	3654747	.	C	T	2	24	26	0	18	44	0	0
23	3654774	.	G	A	18	21	39	0	2	41	0	0
23	3654989	.	A	G	24	32	56	0	1	57	0	0
23	3655082	.	C	T	1	16	17	0	25	43	1	0
23	3655139	.	T	A	25	29	54	0	0	54	0	0
23	3655207	.	T	G	25	27	52	0	1	53	0	0
23	3655220	.	A	G	25	31	56	0	1	57	0	0
23	3657557	.	T	C	32	29	61	0	2	63	0	0
23	3657602	.	T	C	31	0	31	0	31	62	0	0
23	3660060	.	C	A	5	20	25	0	35	60	0	0
23	3660674	.	A	G	26	34	60	0	2	62	0	0
23	3660713	.	G	A	29	31	60	0	2	62	0	0
23	3662210	.	G	A	32	19	51	0	1	52	0	0
23	3662246	.	C	T	2	20	22	0	34	56	0	0
23	3664306	.	A	G	21	24	45	0	4	49	0	0
23	3667257	.	T	C	24	25	49	0	0	49	0	0
23	3711308	.	C	A	5	3	8	0	0	8	0	0
23	3711949	.	T	G	9	3	12	0	2	14	0	0
23	3712002	.	G	A	11	4	15	0	0	15	0	0
23	3712062	.	C	T	9	3	12	0	0	12	0	0
23	3712654	.	A	G	6	7	13	0	0	13	0	0
23	3713045	.	T	G	2	4	6	0	0	6	0	0
23	3713321	.	A	G	11	9	20	0	0	20	0	0
23	3713363	.	A	G	13	12	25	0	0	25	0	0
23	3713388	.	C	T	11	11	22	0	0	22	0	0
23	3713400	.	A	C	11	7	18	0	1	19	0	0
23	3713452	.	T	C	10	5	15	0	0	15	0	0
23	3713453	.	G	A	10	5	15	0	0	15	0	0
23	3713491	.	G	A	12	8	20	0	0	20	0	0
23	3713622	.	A	G	10	11	21	0	2	23	0	0
23	3713643	.	G	A	8	9	17	0	1	18	0	0
23	3713928	.	A	G	10	7	17	0	0	17	0	0
23	3713968	.	C	T	6	10	16	0	0	16	0	0
23	3721131	.	T	C	15	16	31	0	1	32	0	0
23	3740379	.	T	A	10	12	22	0	0	22	0	0
23	3744621	.	C	T	7	15	22	0	0	22	0	0
23	3744654	.	A	C	6	4	10	0	0	10	0	0
23	3751965	.	A	G	26	15	41	0	1	42	0	0
23	3751990	.	A	G	19	17	36	0	2	38	0	0
23	3752305	.	C	G	15	21	36	0	2	38	0	0
23	3752394	.	C	T	1	19	20	0	16	36	0	0
23	3752992	.	T	A	16	23	39	1	3	43	0	0
23	3777916	.	T	C	0	2	2	0	1	3	0	0
23	3951804	.	T	C	3	2	5	0	0	5	0	0
23	3951942	.	G	C	6	2	8	0	3	11	0	0
23	3951948	.	G	T	9	3	12	0	1	13	0	0
23	3962692	.	A	G	2	5	7	0	1	8	0	0
23	3982480	.	G	A	4	6	10	0	1	11	0	0
23	3982588	.	G	A	3	4	7	0	3	10	0	0
23	3982936	.	G	C	3	0	3	0	7	10	0	0
23	4017626	.	G	A	6	6	12	0	0	12	0	0
23	4019600	.	T	C	7	4	11	0	0	11	0	0
23	4063013	.	T	A	2	4	6	0	1	7	0	0
23	4086829	.	C	G	3	2	5	0	0	5	0	0
23	4087478	.	C	G	3	2	5	0	0	5	0	0
23	4087588	.	G	A	1	2	3	0	0	3	0	0
23	4216472	.	C	T	5	5	10	0	0	10	0	0
23	4222119	.	A	G	4	7	11	0	1	12	0	0
23	4222149	.	G	A	7	6	13	0	0	13	0	0
23	4222164	.	G	T	5	6	11	0	2	13	0	0
23	4222437	.	C	G	6	5	11	0	0	11	0	0
23	4225552	.	A	C	4	2	6	0	0	6	0	0
23	4254105	.	G	T	3	34	37	0	20	57	0	0
23	4254192	.	A	C	24	14	38	0	1	39	0	0
23	4255566	.	C	G	22	0	22	0	29	51	0	0
23	4259194	.	A	G	22	17	39	0	2	41	0	0
23	4259369	.	T	G	18	22	40	0	2	42	0	0
23	4259626	.	G	A	26	10	36	0	0	36	0	0
23	4259635	.	G	C	4	11	15	0	21	36	0	0
23	4259674	.	G	T	11	5	16	0	1	17	0	0
23	4260629	.	G	A	15	12	27	0	0	27	0	0
23	4269780	.	C	G	23	15	38	0	1	39	0	0
23	4270928	.	T	C	30	17	47	0	4	51	0	0
23	4271333	.	A	G	25	26	51	0	0	51	0	0
23	4271730	.	G	C	19	12	31	0	0	31	0	0
23	4274411	.	G	T	4	3	7	0	0	7	0	0
23	4274423	.	C	T	4	3	7	0	0	7	0	0
23	4277683	.	A	G	2	5	7	0	0	7	0	0
23	4280877	.	A	C	2	5	7	0	0	7	0	0
23	4280888	.	G	A	2	6	8	0	0	8	0	0
23	4289066	.	C	G	17	10	27	0	1	28	0	0
23	4292251	.	C	T	7	11	18	0	0	18	0	0
23	4307737	.	C	T	11	13	24	0	3	27	0	0
23	4307740	.	T	C	11	14	25	0	3	28	0	0
23	4312033	.	T	G	18	10	28	0	1	29	0	0
23	4314691	.	G	A	10	9	19	0	1	20	0	0
23	4355923	.	C	T	2	3	5	0	0	5	0	0
23	4356042	.	G	T	0	1	1	0	2	3	0	0
23	4356773	.	A	T	4	1	5	0	0	5	0	0
23	4356779	.	T	A	3	2	5	0	0	5	0	0
23	4357124	.	T	C	2	4	6	0	0	6	0	0
23	4362847	.	C	G	2	8	10	0	0	10	0	0
23	4362874	.	T	C	3	8	11	0	0	11	0	0
23	4363971	.	A	G	1	2	3	0	0	3	0	0
23	4364914	.	C	T	8	5	13	0	0	13	0	0
23	4367071	.	G	A	7	3	10	0	0	10	0	0
23	4367390	.	T	A	6	5	11	6	2	19	0	0
23	4392491	.	T	C	5	3	8	0	0	8	0	0
23	4398854	.	A	G	2	3	5	0	0	5	0	0
23	4398919	.	T	C	5	2	7	0	0	7	0	0
23	4488685	.	T	C	2	2	4	0	0	4	0	0
23	4492820	.	C	T	0	3	3	0	1	4	0	0
23	4538412	.	C	T	3	3	6	0	0	6	0	0
23	4538475	.	A	G	4	4	8	0	1	9	0	0
23	4540349	.	G	A	0	3	3	0	3	6	0	0
23	4540397	.	A	G	1	4	5	0	1	6	0	0
23	4540400	.	T	G	2	0	2	0	4	6	0	0
23	4540439	.	C	T	1	5	6	0	1	7	0	0
23	4545389	.	T	G	3	2	5	0	0	6	1	0
23	4549501	.	T	C	1	3	4	0	0	4	0	0
23	4549514	.	C	T	1	3	4	0	0	4	0	0
23	4553255	.	T	C	2	5	7	0	0	7	0	0
23	4554745	.	A	G	1	0	1	0	2	3	0	0
23	4557483	.	C	T	3	3	6	0	0	6	0	0
23	4557759	.	A	T	1	2	3	0	0	3	0	0
23	4923845	.	A	G	7	2	9	0	0	9	0	0
23	5010070	.	T	A	1	2	3	0	1	4	0	0
23	5010178	.	C	T	4	3	7	0	0	7	0	0
23	5010228	.	T	C	4	3	7	0	1	8	0	0
23	5010250	.	T	A	6	6	12	0	0	12	0	0
23	5010722	.	C	T	11	6	17	0	0	17	0	0
23	5011064	.	T	A	3	9	12	0	2	14	0	0
23	5011968	.	A	G	2	8	10	0	0	10	0	0
23	5012763	.	A	G	3	7	10	0	0	10	0	0
23	5012788	.	T	C	3	4	7	0	0	7	0	0
23	6301287	.	T	A	23	13	36	0	2	38	0	0
23	6301332	.	T	C	11	16	27	0	1	28	0	0
23	6301413	.	A	G	14	19	33	0	1	34	0	0
23	6301416	.	T	C	14	20	34	0	2	36	0	0
23	6304243	.	A	G	20	0	20	0	19	39	0	0
23	6304249	.	T	C	20	20	40	0	1	41	0	0
23	6313372	.	T	C	9	0	9	0	12	21	0	0
23	6313752	.	T	A	17	19	36	0	2	38	0	0
23	6313801	.	T	G	16	17	33	0	3	36	0	0
23	6586608	.	A	C	3	5	8	0	0	8	0	0
23	6586974	.	C	G	3	2	5	0	0	5	0	0
23	6600949	.	C	T	4	2	6	0	0	6	0	0
23	6631499	.	G	T	4	5	9	0	0	9	0	0
23	6673724	.	C	A	1	16	17	0	5	22	0	0
23	6673956	.	A	G	15	8	23	0	0	23	0	0
23	6673991	.	A	C	15	8	23	0	0	23	0	0
23	6674645	.	G	A	2	2	4	0	0	4	0	0
23	6674970	.	T	C	2	6	8	0	0	8	0	0
23	6674988	.	A	G	5	4	9	0	0	9	0	0
23	6675100	.	C	T	7	6	13	0	0	13	0	0
23	6675135	.	G	A	8	8	16	0	0	16	0	0
23	6675325	.	G	T	13	9	22	0	0	22	0	0
23	6675537	.	G	A	12	19	31	0	0	31	0	0
23	6675550	.	A	T	13	16	29	0	0	29	0	0
23	6675835	.	G	A	11	11	22	0	0	22	0	0
23	6675959	.	C	G	8	24	32	0	2	34	0	0
23	6680521	.	T	C	15	0	15	0	14	29	0	0
23	6680805	.	G	A	14	19	33	0	1	34	0	0
23	6680880	.	C	T	13	17	30	0	0	30	0	0
23	6682025	.	C	T	11	11	22	0	0	22	0	0
23	6683992	.	C	A	0	9	9	0	13	22	0	0
23	6692100	.	T	C	11	0	11	0	9	20	0	0
23	6694340	.	G	A	13	15	28	0	1	29	0	0
23	6694341	.	A	T	13	14	27	0	1	29	1	0
23	6694608	.	A	T	12	12	24	0	0	24	0	0
23	6694634	.	G	T	14	9	23	0	0	23	0	0
23	6694929	.	C	T	0	11	11	0	8	19	0	0
23	6695073	.	T	C	4	6	10	0	3	13	0	0
23	6697466	.	A	G	6	10	16	0	1	17	0	0
23	6700626	.	C	A	15	9	24	0	2	26	0	0
23	6703099	.	G	A	17	13	30	0	0	30	0	0
23	6703449	.	T	C	4	3	7	1	0	8	0	0
23	6704783	.	C	T	10	4	14	0	0	14	0	0
23	6707243	.	T	A	13	12	25	0	1	26	0	0
23	6707357	.	G	A	4	13	17	0	0	17	0	0
23	6707724	.	C	T	10	11	21	0	2	23	0	0
23	6711172	.	C	G	1	8	9	0	8	17	0	0
23	6711634	.	A	C	5	7	12	0	0	12	0	0
23	6714412	.	T	C	9	0	9	0	13	22	0	0
23	6714810	.	G	T	12	10	22	0	0	22	0	0
23	6716371	.	A	T	5	5	10	0	0	10	0	0
23	6716379	.	A	T	4	5	9	0	0	9	0	0
23	6716785	.	G	A	7	3	10	0	1	11	0	0
23	6717050	.	G	A	8	5	13	0	0	13	0	0
23	6719745	.	C	G	4	4	8	2	1	11	0	0
23	6736121	.	T	A	8	6	14	0	0	14	0	0
23	6736166	.	C	T	1	9	10	0	11	21	0	0
23	6736265	.	C	A	13	4	17	0	0	17	0	0
23	6744328	.	C	T	22	15	37	0	1	38	0	0
23	6744385	.	C	T	16	11	27	0	1	28	0	0
23	6744576	.	T	G	16	15	31	0	1	32	0	0
23	6749754	.	C	G	12	23	35	0	1	36	0	0
23	6749783	.	T	C	8	0	8	0	10	18	0	0
23	6752944	.	T	A	3	8	11	0	0	11	0	0
23	6753002	.	A	T	4	4	8	0	0	8	0	0
23	6753309	.	C	T	11	8	19	0	0	19	0	0
23	6753363	.	C	T	13	13	26	0	0	26	0	0
23	6753414	.	C	T	12	13	25	0	0	25	0	0
23	6753462	.	G	T	1	14	15	0	13	28	0	0
23	6773374	.	T	C	13	12	25	0	1	26	0	0
23	6773392	.	G	A	17	6	23	0	6	29	0	0
23	6780803	.	A	G	5	7	12	0	0	12	0	0
23	6780856	.	G	A	0	12	12	0	15	27	0	0
23	6780859	.	G	A	15	14	29	0	0	29	0	0
23	6780895	.	A	G	17	12	29	0	2	31	0	0
23	6783957	.	C	T	13	11	24	0	0	24	0	0
23	6784176	.	C	T	9	14	23	0	0	23	0	0
23	6788768	.	T	C	3	3	6	0	0	6	0	0
23	6795737	.	A	T	6	8	14	0	0	14	0	0
23	6804831	.	T	C	8	3	11	0	0	11	0	0
23	6808515	.	C	T	10	4	14	0	0	14	0	0
23	6809524	.	G	A	11	4	15	0	0	15	0	0
23	6814119	.	T	G	10	7	17	0	0	17	0	0
23	6827511	.	C	T	15	10	25	0	1	26	0	0
23	6841005	.	T	C	8	5	13	0	1	14	0	0
23	6841021	.	G	A	4	5	9	0	6	15	0	0
23	6926315	.	G	A	4	4	8	0	0	8	0	0
23	6938413	.	C	T	2	2	4	0	0	4	0	0
23	6951157	.	C	T	0	4	4	1	1	6	0	0
23	6952261	.	T	C	2	0	2	0	4	6	0	0
23	6958256	.	A	G	3	4	7	0	0	7	0	0
23	6961424	.	G	A	2	3	5	0	1	6	0	0
23	6961490	.	A	G	6	4	10	0	0	10	0	0
23	7003572	.	G	T	12	13	25	0	1	26	0	0
23	7003744	.	C	T	12	6	18	0	0	18	0	0
23	7007879	.	C	T	13	4	17	0	1	18	0	0
23	7017443	.	A	G	12	12	24	0	1	25	0	0
23	7024631	.	T	C	12	18	30	0	1	31	0	0
23	7029585	.	G	A	19	8	27	0	0	27	0	0
23	7029600	.	G	A	13	9	22	0	2	24	0	0
23	7029741	.	G	A	9	6	15	0	0	15	0	0
23	7029916	.	A	T	14	9	23	0	0	23	0	0
23	7040258	.	G	A	5	6	11	0	2	13	0	0
23	7040725	.	G	A	15	8	23	0	0	23	0	0
23	7046813	.	G	A	12	13	25	0	2	27	0	0
23	7046816	.	G	C	13	0	13	0	14	27	0	0
23	7067236	.	T	G	2	7	9	0	2	11	0	0
23	7070404	.	G	T	1	6	7	0	1	8	0	0
23	7089569	.	A	C	3	2	5	0	0	5	0	0
23	7093722	.	C	T	0	2	2	0	5	7	0	0
23	7125366	.	A	T	2	3	5	0	0	5	0	0
23	7557081	.	C	T	12	5	17	0	0	17	0	0
23	7557382	.	C	T	7	10	17	0	1	18	0	0
23	7557383	.	G	A	10	6	16	0	2	18	0	0
23	7565426	.	C	A	6	9	15	0	0	15	0	0
23	7567105	.	A	G	11	9	20	0	0	20	0	0
23	7572445	.	A	G	10	0	10	0	6	16	0	0
23	7573845	.	T	C	9	8	17	0	1	18	0	0
23	7578710	.	T	C	14	8	22	0	0	22	0	0
23	7702068	.	G	A	0	2	2	0	3	5	0	0
23	7705287	.	G	A	1	3	4	0	1	5	0	0
23	7710831	.	G	A	7	2	9	0	1	10	0	0
23	7715282	.	G	T	4	3	7	0	0	7	0	0
23	7715477	.	T	C	4	3	7	0	1	8	0	0
23	7715747	.	A	G	5	7	12	0	0	12	0	0
23	7715873	.	G	A	9	4	13	0	1	14	0	0
23	7715909	.	T	C	7	8	15	0	0	15	0	0
23	7716023	.	T	C	7	7	14	0	1	15	0	0
23	7716281	.	T	C	6	7	13	0	0	13	0	0
23	7718359	.	C	T	10	8	18	0	1	19	0	0
23	7725252	.	T	C	8	4	12	0	0	12	0	0
23	7728594	.	T	C	5	8	13	0	0	13	0	0
23	7728606	.	C	T	7	6	13	0	1	14	0	0
23	7732649	.	C	T	8	5	13	0	1	14	0	0
23	7732651	.	T	C	7	6	13	0	1	14	0	0
23	7732761	.	C	T	4	3	7	0	0	7	0	0
23	7732866	.	C	G	7	2	9	0	0	9	0	0
23	7732874	.	C	G	7	3	10	0	0	10	0	0
23	7732918	.	G	A	8	5	13	0	0	13	0	0
23	7733043	.	C	T	2	10	12	0	2	14	0	0
23	7733047	.	G	A	9	5	14	0	1	15	0	0
23	7733081	.	A	G	8	2	10	0	8	18	0	0
23	7733118	.	A	G	9	1	10	0	9	19	0	0
23	7733269	.	C	G	3	2	5	0	5	10	0	0
23	7733374	.	C	T	4	4	8	0	0	8	0	0
23	7733732	.	T	C	2	4	6	0	0	6	0	0
23	7733768	.	G	T	3	2	5	0	0	5	0	0
23	7734020	.	A	G	5	5	10	0	0	10	0	0
23	7735384	.	C	T	4	4	8	0	0	8	0	0
23	7735497	.	T	C	4	3	7	0	0	7	0	0
23	7735695	.	C	T	7	5	12	0	1	13	0	0
23	7735830	.	G	A	1	4	5	0	1	6	0	0
23	7736145	.	T	A	2	5	7	0	0	7	0	0
23	7736257	.	G	A	3	2	5	0	0	5	0	0
23	7743748	.	G	T	11	10	21	0	0	21	0	0
23	7743871	.	C	T	1	11	12	0	12	24	0	0
23	7750495	.	A	G	5	2	7	0	0	7	0	0
23	7750552	.	G	A	5	5	10	0	1	11	0	0
23	7755088	.	T	C	4	0	4	0	10	14	0	0
23	7755112	.	A	C	4	8	12	0	0	12	0	0
23	7755165	.	G	A	7	13	20	0	0	20	0	0
23	7755215	.	T	C	1	4	5	0	0	5	0	0
23	7765955	.	G	A	13	6	19	0	0	19	0	0
23	7768578	.	C	T	7	14	21	0	0	21	0	0
23	7771440	.	G	A	9	8	17	0	1	18	0	0
23	7783606	.	C	T	10	6	16	0	1	17	0	0
23	7792567	.	A	G	9	8	17	0	0	17	0	0
23	7808944	.	C	T	10	12	22	1	0	23	0	0
23	7823555	.	C	T	3	2	5	0	1	6	0	0
23	8284903	.	C	T	4	3	7	0	0	7	0	0
23	8284991	.	G	T	7	2	9	0	0	9	0	0
23	8285220	.	G	A	6	11	17	0	0	17	0	0
23	8285236	.	G	T	9	15	24	0	0	25	1	0
23	8285332	.	C	T	8	13	21	0	3	24	0	0
23	8285365	.	G	A	10	15	25	0	1	26	0	0
23	8286192	.	T	C	12	2	14	0	17	31	0	0
23	8286261	.	C	T	2	16	18	0	6	24	0	0
23	8286333	.	G	T	11	10	21	0	0	21	0	0
23	8303831	.	A	C	2	1	3	0	3	6	0	0
23	8303897	.	C	T	7	7	14	0	0	14	0	0
23	8373535	.	T	G	10	13	23	0	0	23	0	0
23	8373641	.	A	G	7	11	18	0	1	19	0	0
23	8699686	.	C	T	2	3	5	0	0	5	0	0
23	8699811	.	C	T	2	2	4	0	1	5	0	0
23	9131458	.	T	C	6	4	10	0	0	10	0	0
23	9131467	.	C	T	5	4	9	0	0	9	0	0
23	9132150	.	T	C	1	2	3	0	0	3	0	0
23	9137288	.	T	C	7	3	10	0	0	10	0	0
23	9137333	.	G	A	0	3	3	0	6	9	0	0
23	9137400	.	A	C	4	3	7	0	0	7	0	0
23	9137442	.	C	T	1	5	6	0	0	6	0	0
23	9268466	.	T	C	6	8	14	0	1	15	0	0
23	9272674	.	C	T	4	7	11	0	1	12	0	0
23	9272984	.	T	C	5	6	11	0	0	11	0	0
23	9287619	.	G	A	2	4	6	0	0	6	0	0
23	9287629	.	C	A	4	4	8	0	0	8	0	0
23	9288047	.	T	A	5	3	8	0	0	8	0	0
23	9288062	.	C	G	7	3	10	0	1	11	0	0
23	9288200	.	G	T	4	6	10	0	0	10	0	0
23	9400848	.	G	C	6	7	13	0	0	13	0	0
23	9400902	.	G	A	4	8	12	0	1	13	0	0
23	9401006	.	A	T	3	6	9	0	0	9	0	0
23	9401107	.	C	T	3	5	8	0	1	9	0	0
23	9401210	.	T	C	8	0	8	0	6	14	0	0
23	9401344	.	G	A	8	12	20	0	2	22	0	0
23	9401439	.	T	C	11	6	17	0	0	17	0	0
23	9401470	.	C	T	15	5	20	0	0	20	0	0
23	9401918	.	A	G	8	5	13	0	0	13	0	0
23	9401954	.	G	A	8	5	13	0	0	13	0	0
23	9402065	.	T	C	8	3	11	0	0	11	0	0
23	9402326	.	G	A	2	5	7	0	0	7	0	0
23	9402459	.	G	A	5	5	10	0	0	10	0	0
23	9402564	.	G	A	7	5	12	0	0	12	0	0
23	9402758	.	G	A	4	6	10	0	0	10	0	0
23	9402857	.	C	T	4	5	9	0	1	10	0	0
23	9402915	.	G	C	1	5	6	0	0	6	0	0
23	9403223	.	G	A	5	6	11	0	0	11	0	0
23	9403348	.	T	G	4	2	6	0	0	6	0	0
23	9405562	.	C	T	2	4	6	0	0	6	0	0
23	9405689	.	A	C	4	2	6	0	0	6	0	0
23	9413159	.	G	A	2	6	8	0	0	8	0	0
23	9413456	.	C	T	4	5	9	0	0	9	0	0
23	9422205	.	C	A	2	2	4	0	0	4	0	0
23	9422427	.	G	A	3	2	5	0	1	6	0	0
23	9422783	.	G	C	5	2	7	0	0	7	0	0
23	9491115	.	G	T	5	3	8	0	0	8	0	0
23	9491414	.	A	G	4	2	6	0	0	6	0	0
23	9491450	.	G	A	3	4	7	0	0	7	0	0
23	9491859	.	T	C	3	4	7	0	0	7	0	0
23	9491865	.	A	T	3	4	7	0	0	7	0	0
23	9533222	.	T	C	2	6	8	0	1	9	0	0
23	9535351	.	G	A	0	4	4	0	6	10	0	0
23	9542588	.	T	C	5	8	13	0	0	13	0	0
23	9549493	.	A	G	8	8	16	1	1	18	0	0
23	9561030	.	A	C	2	4	6	1	0	7	0	0
23	9561035	.	T	C	4	6	10	1	0	11	0	0
23	9561099	.	C	A	10	14	24	1	1	26	0	0
23	9561695	.	G	A	13	12	25	0	0	25	0	0
23	9564268	.	T	C	12	5	17	0	0	17	0	0
23	9564283	.	C	A	9	7	16	0	0	16	0	0
23	9565948	.	T	C	21	19	40	0	2	42	0	0
23	9566370	.	T	C	14	12	26	0	1	27	0	0
23	9566375	.	G	A	0	12	12	0	18	30	0	0
23	9566471	.	T	G	20	0	20	0	20	40	0	0
23	9567071	.	C	T	15	7	22	0	0	22	0	0
23	9567122	.	C	T	10	8	18	0	0	18	0	0
23	9567481	.	G	A	5	2	7	0	0	7	0	0
23	9567484	.	G	C	5	2	7	0	0	7	0	0
23	9572424	.	A	G	2	2	4	0	3	7	0	0
23	9579168	.	T	C	2	4	6	0	0	6	0	0
23	9579392	.	T	C	2	7	9	0	0	9	0	0
23	9598156	.	G	A	1	4	5	0	0	5	0	0
23	9604718	.	T	C	1	2	3	0	0	3	0	0
23	9614615	.	G	A	1	2	3	0	0	3	0	0
23	9635997	.	C	T	0	2	2	0	2	4	0	0
23	9640651	.	G	C	1	2	3	0	0	3	0	0
23	9640678	.	A	C	1	2	3	0	0	3	0	0
23	9794733	.	T	C	8	4	12	4	0	16	0	0
23	9794868	.	T	G	13	18	31	0	2	33	0	0
23	9794959	.	T	A	13	18	31	0	2	33	0	0
23	9795057	.	A	G	19	23	42	0	0	42	0	0
23	9795434	.	C	T	0	8	8	0	14	22	0	0
23	9795663	.	A	C	16	14	30	0	2	32	0	0
23	9800761	.	T	G	23	21	44	0	2	46	0	0
23	9800872	.	T	C	15	19	34	0	1	35	0	0
23	9805838	.	A	G	13	15	28	1	0	29	0	0
23	9809863	.	A	G	10	12	22	0	1	23	0	0
23	9818057	.	A	G	12	22	34	0	0	34	0	0
23	9818153	.	C	T	8	10	18	0	2	20	0	0
23	9823221	.	T	C	11	12	23	0	3	26	0	0
23	9828634	.	C	A	1	14	15	0	11	26	0	0
23	9828762	.	G	A	11	8	19	0	0	20	1	0
23	9828765	.	C	G	0	9	9	0	10	19	0	0
23	9828838	.	T	C	6	0	6	0	6	12	0	0
23	9828925	.	G	A	5	5	10	0	2	12	0	0
23	9836778	.	G	A	9	10	19	0	1	20	0	0
23	9837018	.	G	A	5	10	15	0	0	15	0	0
23	9840151	.	A	G	7	5	12	0	0	12	0	0
23	9840154	.	A	C	6	3	9	0	2	11	0	0
23	9840669	.	G	A	4	2	6	0	0	6	0	0
23	9842935	.	G	A	5	6	11	0	0	11	0	0
23	9842980	.	C	T	7	6	13	0	0	13	0	0
23	9851839	.	C	T	11	5	16	0	0	16	0	0
23	9855623	.	G	A	6	13	19	0	0	19	0	0
23	9859734	.	G	A	1	2	3	0	0	3	0	0
23	9859735	.	T	G	0	2	2	0	0	2	0	0
23	10348052	.	C	T	2	4	6	0	0	6	0	0
23	10348206	.	C	T	6	3	9	0	0	9	0	0
23	10350549	.	T	C	5	5	10	0	1	11	0	0
23	10350591	.	G	A	6	6	12	0	0	12	0	0
23	10351405	.	T	A	9	4	13	0	0	13	0	0
23	10351661	.	A	G	2	5	7	0	1	8	0	0
23	10405703	.	G	A	17	16	33	1	0	34	0	0
23	10405707	.	A	G	15	0	15	1	17	33	0	0
23	10405742	.	G	C	1	11	12	0	15	27	0	0
23	10411562	.	A	C	13	6	19	0	2	21	0	0
23	10417484	.	T	G	6	12	18	0	2	20	0	0
23	10417502	.	C	T	8	5	13	1	1	15	0	0
23	10419933	.	A	C	24	19	43	0	0	43	0	0
23	10421216	.	A	C	15	19	34	0	1	35	0	0
23	10448606	.	G	T	0	18	18	0	16	34	0	0
23	10448642	.	G	A	18	17	35	0	0	35	0	0
23	10448936	.	C	T	10	11	21	0	0	21	0	0
23	10449063	.	T	C	6	11	17	0	0	17	0	0
23	10449136	.	A	G	7	1	8	0	11	19	0	0
23	10449185	.	C	T	7	7	14	0	0	14	0	0
23	10568850	.	T	A	2	1	3	0	0	3	0	0
23	10568874	.	C	A	2	2	4	0	0	4	0	0
23	10569480	.	G	A	1	2	3	0	1	4	0	0
23	10569594	.	G	A	0	3	3	0	2	5	0	0
23	10570219	.	A	T	1	2	3	0	0	3	0	0
23	10576546	.	G	A	2	2	4	0	0	4	0	0
23	10587177	.	T	A	2	2	4	0	0	4	0	0
23	10587182	.	A	T	2	3	5	0	0	5	0	0
23	10639121	.	G	A	11	6	17	0	1	18	0	0
23	10725272	.	A	T	5	2	7	0	0	7	0	0
23	10725320	.	T	C	4	7	11	0	1	12	0	0
23	10725334	.	T	C	6	8	14	0	0	14	0	0
23	10725638	.	A	T	11	11	22	0	1	23	0	0
23	10725919	.	C	A	15	10	25	0	1	26	0	0
23	10727563	.	G	A	11	12	23	0	0	23	0	0
23	10727614	.	C	T	7	12	19	0	1	20	0	0
23	10745058	.	G	T	10	4	14	0	2	16	0	0
23	10762922	.	G	A	10	7	17	0	0	17	0	0
23	10762972	.	T	A	8	5	13	0	0	13	0	0
23	10763070	.	G	A	4	10	14	0	0	14	0	0
23	10771991	.	C	A	0	14	14	0	21	35	0	0
23	10805322	.	A	G	6	4	10	0	0	10	0	0
23	10817179	.	G	A	3	9	12	0	0	12	0	0
23	10817292	.	T	G	7	7	14	0	0	14	0	0
23	10825591	.	C	T	6	5	11	0	0	11	0	0
23	10826427	.	C	T	9	9	18	0	0	18	0	0
23	10826718	.	C	A	13	10	23	0	1	24	0	0
23	10826754	.	C	T	8	7	15	0	0	15	0	0
23	10826917	.	C	T	4	2	6	0	0	6	0	0
23	10829164	.	A	G	2	2	4	0	0	4	0	0
23	10829996	.	G	A	1	2	3	0	0	3	0	0
23	10831645	.	C	T	2	2	4	0	0	4	0	0
23	10913921	.	C	A	2	3	5	0	0	5	0	0
23	10913970	.	C	T	2	3	5	0	0	5	0	0
23	11014766	.	G	A	3	2	5	0	0	5	0	0
23	11023633	.	C	T	1	3	4	0	0	4	0	0
23	11099935	.	A	G	3	2	5	0	0	5	0	0
23	11763235	.	A	G	1	0	1	0	6	7	0	0
23	11763431	.	C	A	3	3	6	0	0	6	0	0
23	11764269	.	C	T	1	3	4	0	0	4	0	0
23	11772230	.	A	C	6	4	10	0	1	11	0	0
23	11772310	.	C	T	1	6	7	0	0	7	0	0
23	11802582	.	C	T	5	2	7	0	1	8	0	0
23	11842406	.	C	A	6	2	8	0	1	9	0	0
23	11851545	.	T	C	4	5	9	0	0	9	0	0
23	11851603	.	C	T	2	5	7	0	1	8	0	0
23	11855160	.	A	G	8	4	12	0	1	13	0	0
23	11855169	.	G	A	7	6	13	0	0	13	0	0
23	11865055	.	T	A	14	13	27	0	0	27	0	0
23	11865934	.	C	T	14	22	36	0	0	36	0	0
23	11866086	.	G	A	25	16	41	0	2	43	0	0
23	11866183	.	G	A	19	23	42	0	2	44	0	0
23	11866259	.	T	C	21	18	39	0	2	41	0	0
23	11870203	.	A	T	17	23	40	0	0	40	0	0
23	11896251	.	G	A	15	13	28	0	0	28	0	0
23	11920705	.	G	A	5	11	16	0	0	16	0	0
23	11920712	.	C	T	11	8	19	0	0	19	0	0
23	12147588	.	A	T	2	2	4	0	0	4	0	0
23	12155166	.	G	A	7	12	19	0	0	19	0	0
23	12155298	.	G	A	13	14	27	0	2	29	0	0
23	12155319	.	G	A	15	14	29	0	0	29	0	0
23	12155364	.	A	G	8	9	17	0	2	19	0	0
23	12155391	.	G	A	10	12	22	0	0	22	0	0
23	12158643	.	A	G	7	8	15	0	1	16	0	0
23	12161009	.	T	A	2	2	4	0	0	4	0	0
23	12161145	.	T	A	2	2	4	0	0	4	0	0
23	12161148	.	G	T	2	2	4	0	0	4	0	0
23	12161593	.	G	C	0	2	2	0	3	5	0	0
23	12162034	.	G	A	3	7	10	0	0	10	0	0
23	12162073	.	T	G	3	0	3	0	3	6	0	0
23	12162099	.	G	C	2	3	5	0	0	5	0	0
23	12162163	.	C	T	2	3	5	0	0	5	0	0
23	12162386	.	A	C	3	6	9	0	1	10	0	0
23	12232873	.	G	A	4	2	6	0	0	6	0	0
23	12233117	.	G	A	12	12	24	0	0	24	0	0
23	12233121	.	C	T	1	10	11	0	13	24	0	0
23	12259026	.	C	T	1	18	19	0	13	32	0	0
23	12345695	.	G	A	8	9	17	0	0	17	0	0
23	12486063	.	T	C	4	2	6	0	0	6	0	0
23	12840452	.	C	T	2	5	7	0	0	7	0	0
23	13271881	.	T	C	6	2	8	0	0	8	0	0
23	13271925	.	C	T	2	3	5	0	1	6	0	0
23	13332153	.	A	G	2	7	9	0	0	9	0	0
23	13332269	.	T	C	1	3	4	0	0	4	0	0
23	13332325	.	A	C	4	2	6	0	1	7	0	0
23	13376078	.	C	T	2	2	4	0	0	4	0	0
23	13454551	.	A	G	3	6	9	0	0	9	0	0
23	13459141	.	G	A	2	2	4	0	0	4	0	0
23	13558711	.	C	T	5	4	9	0	0	9	0	0
23	13567194	.	C	T	6	6	12	0	1	13	0	0
23	13567257	.	G	T	5	3	8	0	1	9	0	0
23	13567264	.	A	C	5	5	10	0	0	10	0	0
23	13598632	.	T	C	8	7	15	0	0	15	0	0
23	13598679	.	C	T	11	5	16	0	0	16	0	0
23	13599008	.	G	A	4	2	6	0	0	6	0	0
23	13722416	.	C	A	9	10	19	0	0	19	0	0
23	13722728	.	G	A	1	15	16	1	9	26	0	0
23	13722755	.	C	G	10	0	10	1	19	30	0	0
23	13806408	.	C	T	16	11	27	0	0	27	0	0
23	13833376	.	T	A	19	12	31	0	1	32	0	0
23	13835932	.	C	A	11	5	16	0	0	16	0	0
23	13840297	.	G	A	9	9	18	0	0	18	0	0
23	13840362	.	C	T	0	10	10	0	7	17	0	0
23	13845114	.	A	C	8	4	12	0	2	14	0	0
23	13845131	.	G	A	6	6	12	0	0	12	0	0
23	13845149	.	T	G	9	6	15	0	0	15	0	0
23	13845201	.	A	G	6	5	11	0	0	11	0	0
23	13845258	.	A	T	1	3	4	0	0	4	0	0
23	13845389	.	C	A	7	6	13	0	0	13	0	0
23	13845411	.	G	T	9	8	17	0	0	17	0	0
23	13845447	.	T	C	11	6	17	0	0	17	0	0
23	13845901	.	G	T	7	8	15	0	0	15	0	0
23	13846482	.	G	T	2	3	5	0	0	5	0	0
23	13846535	.	G	A	2	1	3	0	0	3	0	0
23	13846627	.	G	T	2	6	8	0	0	8	0	0
23	13846631	.	C	T	6	2	8	0	0	8	0	0
23	13846664	.	T	C	1	6	7	0	0	7	0	0
23	13846802	.	A	C	3	0	3	0	4	7	0	0
23	13846885	.	A	G	4	5	9	0	0	9	0	0
23	13846953	.	C	A	8	2	10	1	0	11	0	0
23	13847086	.	C	T	1	5	6	1	0	7	0	0
23	13847142	.	G	A	6	3	9	0	1	10	0	0
23	13847220	.	T	C	6	6	12	0	0	12	0	0
23	13848537	.	G	A	7	10	17	0	0	17	0	0
23	13857170	.	G	T	11	11	22	0	0	22	0	0
23	13941275	.	C	T	5	8	13	0	0	13	0	0
23	13946174	.	C	T	1	11	12	0	7	19	0	0
23	13948993	.	G	A	12	12	24	0	1	25	0	0
23	13949110	.	C	T	1	8	9	0	12	21	0	0
23	14006105	.	G	A	12	3	15	0	0	15	0	0
23	14056306	.	C	T	7	7	14	0	0	14	0	0
23	14056640	.	G	A	5	8	13	0	1	14	0	0
23	14056679	.	G	A	8	5	13	0	0	13	0	0
23	14057102	.	C	T	2	4	6	0	0	6	0	0
23	14193676	.	A	G	7	3	10	0	1	11	0	0
23	14193777	.	C	T	6	10	16	0	0	16	0	0
23	14193880	.	C	T	13	6	19	0	0	19	0	0
23	14193923	.	A	C	9	10	19	0	0	19	0	0
23	14193940	.	C	T	11	11	22	0	1	23	0	0
23	14194035	.	C	G	10	12	22	0	0	22	0	0
23	14194058	.	G	A	15	9	24	0	1	25	0	0
23	14198137	.	G	A	15	11	26	0	0	26	0	0
23	14201512	.	T	C	14	10	24	0	0	24	0	0
23	14201521	.	T	C	13	12	25	0	0	25	0	0
23	14203829	.	T	G	10	11	21	0	0	21	0	0
23	14208718	.	A	G	6	13	19	0	1	20	0	0
23	14208817	.	A	T	14	20	34	0	1	35	0	0
23	14209024	.	T	G	11	19	30	0	2	32	0	0
23	14211707	.	C	T	11	21	32	0	0	32	0	0
23	14217769	.	G	A	0	4	4	0	10	14	0	0
23	14217799	.	G	A	5	2	7	0	0	7	0	0
23	14218018	.	A	G	5	2	7	0	0	7	0	0
23	14222913	.	A	G	4	4	8	0	0	8	0	0
23	14432386	.	C	A	5	4	9	0	0	9	0	0
23	14432447	.	T	C	6	4	10	0	0	10	0	0
23	14504141	.	C	T	3	6	9	0	0	9	0	0
23	14591009	.	G	A	2	3	5	0	0	5	0	0
23	14720234	.	G	A	0	3	3	0	5	8	0	0
23	14731394	.	A	G	1	3	4	0	0	4	0	0
23	14743447	.	G	A	3	2	5	0	0	5	0	0
23	14743497	.	A	G	5	6	11	0	0	11	0	0
23	14752817	.	G	A	1	3	4	0	0	4	0	0
23	14752841	.	T	C	0	4	4	0	1	5	0	0
23	14769323	.	G	T	1	2	3	0	0	3	0	0
23	14769407	.	G	A	4	2	6	0	0	6	0	0
23	14772079	.	G	A	4	4	8	0	0	8	0	0
23	14777039	.	A	C	5	8	13	0	0	13	0	0
23	14782599	.	C	T	2	3	5	0	1	6	0	0
23	14784150	.	G	A	6	3	9	0	0	9	0	0
23	14784192	.	C	T	5	4	9	0	0	9	0	0
23	14784237	.	A	C	7	6	13	0	0	13	0	0
23	14786347	.	T	C	4	4	8	1	1	10	0	0
23	14786429	.	A	T	7	9	16	0	3	19	0	0
23	14787318	.	T	A	4	7	11	0	0	11	0	0
23	14787409	.	G	A	1	4	5	0	4	9	0	0
23	14787426	.	G	A	5	8	13	0	0	13	0	0
23	14790429	.	G	A	5	7	12	0	0	12	0	0
23	14790611	.	C	T	9	6	15	0	0	15	0	0
23	14790827	.	G	A	4	6	10	0	0	10	0	0
23	14803409	.	C	T	3	3	6	0	2	8	0	0
23	14808490	.	G	A	2	3	5	0	0	5	0	0
23	14808537	.	G	T	1	4	5	0	0	5	0	0
23	14809613	.	C	A	3	3	6	0	0	6	0	0
23	14832549	.	A	T	0	2	2	0	1	3	0	0
23	14832677	.	G	A	15	20	35	0	2	37	0	0
23	14832774	.	G	A	33	13	46	0	1	47	0	0
23	14832835	.	C	T	30	24	54	0	2	56	0	0
23	14832866	.	C	T	27	25	52	0	3	55	0	0
23	14832926	.	A	T	24	21	45	0	1	46	0	0
23	14833032	.	C	T	34	12	46	0	3	49	0	0
23	14833142	.	A	T	23	32	55	0	1	56	0	0
23	14833143	.	A	T	22	30	52	0	4	56	0	0
23	14833189	.	A	C	28	22	50	0	1	51	0	0
23	14833552	.	T	C	31	21	52	0	0	52	0	0
23	14833581	.	T	C	28	0	28	0	23	51	0	0
23	14833664	.	G	A	36	26	62	0	0	62	0	0
23	14833765	.	G	A	27	32	59	2	7	68	0	0
23	14851621	.	A	G	36	20	56	0	4	60	0	0
23	14853221	.	G	A	27	26	53	0	0	53	0	0
23	14853342	.	G	A	30	26	56	0	3	59	0	0
23	14853411	.	C	T	34	16	50	0	3	53	0	0
23	14853414	.	C	T	3	16	19	0	33	52	0	0
23	14853833	.	C	T	30	19	49	0	5	54	0	0
23	14861941	.	T	C	28	18	46	0	2	48	0	0
23	14993089	.	G	A	8	9	17	0	1	18	0	0
23	14993140	.	T	C	9	0	9	0	10	19	0	0
23	14993200	.	A	T	8	12	20	0	0	20	0	0
23	14993393	.	C	A	8	6	14	0	0	14	0	0
23	14993936	.	A	T	8	7	15	0	0	15	0	0
23	14999053	.	C	T	14	14	28	0	2	30	0	0
23	14999095	.	C	T	2	8	10	0	21	31	0	0
23	15006653	.	C	T	1	15	16	0	19	35	0	0
23	15021985	.	A	T	14	9	23	0	0	23	0	0
23	15022206	.	T	C	13	0	13	0	8	21	0	0
23	15022526	.	C	T	8	15	23	0	0	23	0	0
23	15025084	.	G	C	6	0	6	0	11	17	0	0
23	15036698	.	G	A	18	8	26	0	1	27	0	0
23	15047065	.	G	T	1	2	3	0	1	4	0	0
23	15047732	.	C	T	4	5	9	0	1	10	0	0
23	15047745	.	C	T	0	2	2	0	7	10	1	0
23	15048070	.	A	G	4	3	7	0	0	7	0	0
23	15048874	.	G	A	3	2	5	0	0	5	0	0
23	15050912	.	T	C	6	2	8	0	0	8	0	0
23	15053420	.	C	G	4	3	7	0	0	7	0	0
23	15076070	.	T	C	5	6	11	0	0	11	0	0
23	15087289	.	G	A	2	3	5	0	0	5	0	0
23	15087634	.	T	G	1	4	5	0	0	5	0	0
23	15090620	.	G	A	1	3	4	0	0	4	0	0
23	15204222	.	C	T	1	13	14	0	16	30	0	0
23	15204321	.	T	A	25	9	34	0	1	35	0	0
23	15204324	.	T	A	24	12	36	0	0	36	0	0
23	15204417	.	A	G	9	19	28	0	0	28	0	0
23	15204936	.	G	T	15	10	25	0	3	28	0	0
23	15205428	.	A	T	23	17	40	0	2	42	0	0
23	15205487	.	C	G	20	20	40	0	1	41	0	0
23	15205994	.	G	A	25	26	51	0	3	54	0	0
23	15206057	.	A	G	22	28	50	0	2	52	0	0
23	15206061	.	G	C	22	27	49	0	3	52	0	0
23	15211253	.	G	C	27	19	46	0	2	48	0	0
23	15215796	.	T	G	25	23	48	0	3	51	0	0
23	15216314	.	G	A	18	25	43	0	0	43	0	0
23	15216644	.	T	C	18	0	18	0	21	39	0	0
23	15216664	.	G	T	21	17	38	0	2	40	0	0
23	15222572	.	G	A	24	18	42	0	2	44	0	0
23	15232380	.	T	G	18	16	34	0	3	37	0	0
23	15259821	.	G	A	10	19	29	0	3	32	0	0
23	15270775	.	G	A	12	17	29	0	0	29	0	0
23	15284590	.	C	T	23	13	36	0	3	39	0	0
23	16621314	.	C	T	11	11	22	0	0	22	0	0
23	16640852	.	A	G	15	0	15	0	8	23	0	0
23	16640925	.	A	G	13	25	38	0	3	41	0	0
23	16641012	.	A	G	22	1	23	0	14	37	0	0
23	16641017	.	A	G	18	18	36	0	1	37	0	0
23	16641127	.	A	G	21	9	30	0	1	31	0	0
23	16648643	.	A	G	2	2	4	0	2	6	0	0
23	16648656	.	A	G	5	2	7	0	0	7	0	0
23	16648950	.	T	A	14	7	21	0	2	23	0	0
23	16649054	.	C	T	9	7	16	2	0	18	0	0
23	16649599	.	G	T	12	11	23	0	3	26	0	0
23	16649855	.	T	C	21	2	23	2	21	46	0	0
23	16650074	.	G	A	35	14	49	0	2	51	0	0
23	16654424	.	A	G	26	17	43	0	0	43	0	0
23	16655133	.	G	A	16	11	27	0	0	27	0	0
23	16688448	.	G	A	13	19	32	0	0	32	0	0
23	16688565	.	A	G	27	17	44	0	0	44	0	0
23	16748903	.	A	T	9	5	14	0	1	15	0	0
23	16748915	.	T	A	9	3	12	0	0	12	0	0
23	16753735	.	T	C	5	6	11	0	2	13	0	0
23	16757528	.	G	T	5	5	10	0	0	10	0	0
23	16761309	.	C	A	3	3	6	0	0	6	0	0
23	16769949	.	T	C	4	3	7	0	0	7	0	0
23	16780557	.	T	C	1	2	3	1	0	4	0	0
23	16780582	.	C	T	2	2	4	2	0	6	0	0
23	16817055	.	T	C	4	3	7	5	0	12	0	0
23	16821752	.	T	G	5	3	8	0	0	8	0	0
23	16822464	.	G	A	1	5	6	0	9	15	0	0
23	16822469	.	T	C	10	5	15	0	0	15	0	0
23	16822707	.	G	A	0	4	4	0	3	7	0	0
23	16831207	.	A	T	4	2	6	0	0	6	0	0
23	16831344	.	A	T	2	5	7	0	0	7	0	0
23	16831386	.	G	A	4	3	7	0	0	7	0	0
23	16831507	.	A	T	2	2	4	0	0	4	0	0
23	16831822	.	G	A	0	3	3	0	6	9	0	0
23	16831928	.	G	A	1	3	4	0	0	4	0	0
23	16831976	.	G	T	5	2	7	0	0	7	0	0
23	16834080	.	G	A	4	2	6	1	2	9	0	0
23	16848866	.	G	A	2	6	8	0	0	8	0	0
23	16849183	.	A	G	4	3	7	0	0	7	0	0
23	16849341	.	C	T	2	4	6	0	1	7	0	0
23	16964518	.	T	G	1	2	3	0	1	4	0	0
23	16978813	.	G	A	1	2	3	0	0	3	0	0
23	17012438	.	G	A	1	3	4	0	0	4	0	0
23	17027328	.	C	G	1	2	3	0	0	3	0	0
23	17105324	.	C	T	9	6	15	0	0	15	0	0
23	17113831	.	G	A	0	4	4	0	2	6	0	0
23	17113842	.	A	G	2	2	4	0	0	4	0	0
23	17146825	.	C	T	1	2	3	0	0	3	0	0
23	17197420	.	C	T	1	3	4	0	0	4	0	0
23	17339044	.	C	T	7	6	13	0	0	13	0	0
23	17340346	.	G	A	0	6	6	0	6	12	0	0
23	17340355	.	G	A	6	4	10	0	0	10	0	0
23	17354662	.	T	C	2	4	6	0	0	6	0	0
23	17354693	.	G	T	4	3	7	0	0	7	0	0
23	17354718	.	A	T	4	3	7	0	0	7	0	0
23	17354853	.	G	A	11	9	20	0	0	20	0	0
23	17354868	.	C	A	11	8	19	0	0	19	0	0
23	17355063	.	C	T	7	8	15	0	0	15	0	0
23	17355109	.	C	T	4	6	10	0	0	10	0	0
23	17355174	.	C	T	7	8	15	0	1	16	0	0
23	17355498	.	G	T	3	4	7	0	0	7	0	0
23	17362473	.	G	A	2	3	5	0	2	7	0	0
23	17370877	.	C	A	5	4	9	0	2	11	0	0
23	17381564	.	G	A	3	7	10	0	0	10	0	0
23	17384755	.	G	A	5	3	8	0	0	8	0	0
23	17384981	.	A	G	4	8	12	0	0	12	0	0
23	17385050	.	T	A	7	5	12	0	1	13	0	0
23	17428153	.	C	T	38	35	73	0	2	75	0	0
23	17429632	.	C	T	3	25	28	0	34	62	0	0
23	17431644	.	A	T	24	21	45	0	0	45	0	0
23	17431707	.	T	A	26	11	37	0	0	37	0	0
23	17431734	.	C	T	19	10	29	0	2	31	0	0
23	17432036	.	T	C	15	18	33	0	0	33	0	0
23	17432133	.	A	C	11	10	21	0	0	21	0	0
23	17432169	.	T	A	8	14	22	0	0	22	0	0
23	17432412	.	T	C	17	12	29	0	0	29	0	0
23	17450623	.	T	G	17	12	29	0	1	30	0	0
23	17450660	.	T	A	14	18	32	1	1	34	0	0
23	17450661	.	A	T	18	15	33	1	0	34	0	0
23	17450779	.	A	T	15	4	19	0	0	19	0	0
23	17473278	.	C	G	11	10	21	0	1	22	0	0
23	17473365	.	T	C	7	10	17	0	1	18	0	0
23	17473398	.	G	T	8	7	15	0	0	15	0	0
23	17473590	.	C	A	15	8	23	0	0	23	0	0
23	17473611	.	C	G	9	11	20	0	0	20	0	0
23	17473779	.	G	A	25	19	44	1	2	47	0	0
23	17473795	.	A	C	21	21	42	1	1	44	0	0
23	17474167	.	G	A	4	6	10	0	2	12	0	0
23	17474350	.	G	T	1	2	3	0	0	3	0	0
23	17474532	.	T	C	6	7	13	1	1	15	0	0
23	17474590	.	T	C	14	8	22	1	0	23	0	0
23	17474592	.	G	A	14	8	22	1	0	23	0	0
23	17474862	.	C	T	18	16	34	0	0	34	0	0
23	17474928	.	C	G	16	12	28	0	1	29	0	0
23	17475043	.	C	A	12	12	24	0	2	26	0	0
23	17475074	.	A	C	14	5	19	0	2	21	0	0
23	17475329	.	G	C	14	0	14	0	0	20	6	0
23	17475349	.	A	T	11	5	16	0	1	17	0	0
23	17475378	.	C	A	14	4	18	0	0	18	0	0
23	17475389	.	T	A	13	5	18	0	1	19	0	0
23	17475552	.	G	A	5	7	12	0	2	14	0	0
23	17475553	.	T	C	7	1	8	0	6	14	0	0
23	17475702	.	C	T	17	8	25	0	2	27	0	0
23	17475808	.	G	T	23	12	35	0	1	36	0	0
23	17476213	.	C	T	1	7	8	0	14	22	0	0
23	17476453	.	T	C	9	6	15	0	0	15	0	0
23	17476459	.	G	T	7	7	14	0	0	14	0	0
23	17476491	.	A	G	6	8	14	0	0	14	0	0
23	17476792	.	A	T	3	6	9	0	1	10	0	0
23	17476834	.	A	T	5	2	7	0	0	7	0	0
23	17477252	.	C	T	14	6	20	0	0	20	0	0
23	17477384	.	A	C	20	19	39	0	1	40	0	0
23	17481905	.	C	T	3	13	16	0	11	27	0	0
23	17484484	.	A	G	8	3	11	3	2	16	0	0
23	17516945	.	G	A	18	17	35	0	0	35	0	0
23	17520025	.	C	G	23	8	31	0	0	31	0	0
23	17520086	.	A	T	20	15	35	0	1	36	0	0
23	17520245	.	T	C	10	14	24	1	1	26	0	0
23	17520311	.	T	G	14	7	21	0	1	22	0	0
23	17520338	.	G	A	13	14	27	0	0	27	0	0
23	17523056	.	C	G	8	3	11	1	0	12	0	0
23	17656044	.	A	G	9	7	16	0	0	16	0	0
23	17656477	.	G	A	12	12	24	0	0	24	0	0
23	17657130	.	T	G	10	4	14	1	2	17	0	0
23	17657265	.	G	C	14	12	26	0	0	26	0	0
23	17657325	.	A	G	15	18	33	0	0	33	0	0
23	17812711	.	C	T	28	20	48	0	0	48	0	0
23	17812720	.	T	A	24	27	51	0	0	51	0	0
23	17812755	.	G	T	19	28	47	0	1	48	0	0
23	17813057	.	G	A	20	20	40	1	0	41	0	0
23	17813161	.	T	A	12	14	26	2	3	31	0	0
23	17813717	.	G	A	27	21	48	0	2	50	0	0
23	17813952	.	G	T	11	5	16	0	0	16	0	0
23	17814056	.	G	A	27	16	43	0	1	44	0	0
23	17814223	.	C	T	20	14	34	0	13	47	0	0
23	17814281	.	G	T	20	13	33	0	0	33	0	0
23	17814299	.	A	C	20	13	33	0	1	34	0	0
23	17814408	.	A	C	12	15	27	0	2	29	0	0
23	17842285	.	G	A	3	2	5	0	0	5	0	0
23	17842410	.	T	A	4	3	7	0	0	7	0	0
23	17848361	.	G	T	2	2	4	1	0	5	0	0
23	17848364	.	A	G	3	2	5	1	0	6	0	0
23	17848401	.	T	C	2	2	4	4	0	8	0	0
23	17849044	.	T	A	3	4	7	0	0	7	0	0
23	17849275	.	T	G	8	7	15	0	1	16	0	0
23	17849296	.	C	G	2	5	7	0	8	15	0	0
23	17849627	.	C	T	9	13	22	0	0	22	0	0
23	17851768	.	C	T	2	8	10	0	8	18	0	0
23	17853145	.	T	G	13	5	18	0	1	19	0	0
23	17853396	.	A	T	5	6	11	0	1	12	0	0
23	17855427	.	C	A	5	6	11	0	2	13	0	0
23	17857831	.	G	A	6	5	11	0	0	11	0	0
23	17866146	.	T	A	1	3	4	0	0	4	0	0
23	17871787	.	A	T	0	3	3	0	0	3	0	0
23	17872443	.	G	A	2	4	6	0	0	6	0	0
23	17873750	.	C	A	43	23	66	0	0	66	0	0
23	17879066	.	C	A	7	4	11	0	0	11	0	0
23	17879107	.	C	T	2	6	8	0	0	8	0	0
23	17879152	.	A	T	3	4	7	0	0	7	0	0
23	17879153	.	A	C	4	3	7	0	0	7	0	0
23	17880800	.	C	T	6	7	13	0	0	13	0	0
23	17881252	.	T	C	7	2	9	0	0	9	0	0
23	17899284	.	A	C	5	3	8	0	0	8	0	0
23	17901655	.	A	G	7	0	7	0	7	14	0	0
23	17901724	.	A	G	4	0	4	0	3	7	0	0
23	17903519	.	G	A	0	3	3	0	7	10	0	0
23	17903574	.	C	T	13	5	18	0	0	18	0	0
23	17907323	.	A	C	4	3	7	0	0	7	0	0
23	17994274	.	C	G	3	2	5	0	0	5	0	0
23	17994354	.	T	C	4	14	18	0	1	19	0	0
23	17994359	.	C	T	13	4	17	0	0	17	0	0
23	17995169	.	A	T	2	2	4	0	0	4	0	0
23	17997033	.	A	G	6	5	11	0	0	11	0	0
23	17997043	.	T	C	5	0	5	0	6	11	0	0
23	18001836	.	A	C	4	4	8	0	0	8	0	0
23	18004297	.	A	G	4	11	15	1	1	17	0	0
23	18014744	.	C	T	1	5	6	0	0	6	0	0
23	18032772	.	G	A	1	4	5	0	0	5	0	0
23	18032912	.	A	C	5	4	9	0	0	9	0	0
23	18032924	.	T	A	5	3	8	0	0	8	0	0
23	18118653	.	A	T	5	2	7	0	0	7	0	0
23	18118922	.	G	A	24	15	39	0	0	39	0	0
23	18119166	.	C	T	18	18	36	0	2	38	0	0
23	18119192	.	T	C	16	0	16	0	16	32	0	0
23	18119399	.	A	G	13	15	28	0	1	29	0	0
23	18286781	.	G	A	6	5	11	0	0	11	0	0
23	18286782	.	C	T	6	5	11	0	0	11	0	0
23	18375847	.	G	A	18	9	27	0	0	27	0	0
23	18375853	.	T	C	13	1	14	0	16	30	0	0
23	18387709	.	T	A	26	21	47	0	1	48	0	0
23	18388004	.	G	A	20	15	35	0	1	36	0	0
23	18388166	.	T	A	15	9	24	0	3	27	0	0
23	18388476	.	G	A	11	13	24	0	1	25	0	0
23	18388555	.	A	G	14	13	27	0	0	27	0	0
23	18388620	.	A	C	5	13	18	0	0	18	0	0
23	18388685	.	G	A	12	7	19	0	0	19	0	0
23	18388764	.	G	A	12	15	27	0	1	28	0	0
23	18388858	.	T	G	9	3	12	2	0	14	0	0
23	18388954	.	G	A	7	8	15	0	0	15	0	0
23	18389594	.	G	T	17	12	29	0	3	32	0	0
23	18390402	.	G	A	13	14	27	0	1	28	0	0
23	18390635	.	G	A	17	12	29	0	0	29	0	0
23	18390758	.	T	C	14	0	14	0	13	27	0	0
23	18390780	.	C	T	11	15	26	0	1	27	0	0
23	18391490	.	G	A	8	5	13	0	3	16	0	0
23	18394401	.	T	G	13	15	28	0	1	29	0	0
23	18405812	.	C	T	14	8	22	0	1	23	0	0
23	18405862	.	A	G	9	9	18	0	0	18	0	0
23	18406479	.	G	A	14	11	25	0	1	26	0	0
23	18406573	.	C	A	7	11	18	0	2	20	0	0
23	18409242	.	C	T	12	9	21	0	1	22	0	0
23	18415329	.	G	C	12	16	28	0	0	28	0	0
23	18415493	.	C	A	0	8	8	0	3	11	0	0
23	18532950	.	C	T	1	2	3	0	0	3	0	0
23	18537386	.	C	T	2	2	4	0	0	4	0	0
23	18561051	.	T	C	8	5	13	0	1	14	0	0
23	18561289	.	T	A	17	13	30	0	0	30	0	0
23	18561434	.	C	T	0	13	13	0	10	23	0	0
23	18562299	.	A	T	3	2	5	0	0	5	0	0
23	18562358	.	T	G	6	8	14	0	1	15	0	0
23	18562427	.	C	T	8	8	16	0	0	16	0	0
23	18562484	.	G	A	11	3	14	1	1	16	0	0
23	18562522	.	A	C	11	4	15	0	0	15	0	0
23	18562623	.	C	T	12	10	22	0	0	22	0	0
23	18562911	.	C	A	2	8	10	0	19	29	0	0
23	18563951	.	G	T	12	12	24	0	1	25	0	0
23	18563952	.	T	C	12	0	12	0	12	24	0	0
23	18568144	.	G	A	6	7	13	0	2	15	0	0
23	18568206	.	G	A	9	3	12	0	0	12	0	0
23	18568520	.	G	A	2	4	6	0	0	6	0	0
23	18569380	.	T	A	3	7	10	0	1	11	0	0
23	18569399	.	C	A	0	3	3	0	5	8	0	0
23	18569455	.	T	G	11	2	13	0	2	15	0	0
23	18569462	.	T	A	12	3	15	0	0	15	0	0
23	18569543	.	T	C	6	15	21	0	1	22	0	0
23	18569625	.	A	G	27	8	35	0	0	35	0	0
23	18570887	.	C	T	14	11	25	0	0	25	0	0
23	18572547	.	T	A	15	16	31	0	1	32	0	0
23	18572605	.	T	A	12	14	26	0	0	26	0	0
23	18572618	.	G	A	11	8	19	0	2	21	0	0
23	18574353	.	G	A	11	8	19	0	1	20	0	0
23	18574720	.	T	C	20	18	38	0	0	38	0	0
23	18574800	.	C	T	3	14	17	0	17	34	0	0
23	18580933	.	C	A	19	16	35	0	0	35	0	0
23	18580939	.	C	A	1	17	18	0	14	32	0	0
23	18581065	.	A	G	16	16	32	0	0	32	0	0
23	18581835	.	G	A	11	15	26	0	3	29	0	0
23	18581933	.	T	G	15	19	34	0	0	34	0	0
23	18584225	.	G	A	15	17	32	0	1	33	0	0
23	18586793	.	C	T	1	7	8	1	20	29	0	0
23	18588969	.	C	T	12	14	26	0	3	29	0	0
23	18597667	.	G	A	13	16	29	0	0	29	0	0
23	18616517	.	A	T	10	7	17	0	0	17	0	0
23	18616880	.	T	A	14	9	23	0	0	23	0	0
23	18616980	.	C	G	11	10	21	0	1	22	0	0
23	18617300	.	G	A	15	11	26	0	2	28	0	0
23	18619766	.	C	T	13	7	20	0	4	24	0	0
23	18622541	.	T	G	12	8	20	0	0	20	0	0
23	18628460	.	T	G	12	11	23	0	0	23	0	0
23	18628746	.	C	T	9	9	18	0	0	18	0	0
23	18629024	.	T	C	6	4	10	0	0	10	0	0
23	18651789	.	G	A	9	8	17	0	0	17	0	0
23	18651918	.	C	A	9	11	20	0	1	21	0	0
23	18652067	.	T	C	5	8	13	0	3	16	0	0
23	18668440	.	T	C	12	4	16	0	0	16	0	0
23	18707455	.	T	C	1	3	4	0	0	4	0	0
23	18759827	.	T	C	2	7	9	0	1	10	0	0
23	18759944	.	C	T	4	3	7	1	1	9	0	0
23	18759945	.	G	A	2	4	6	1	1	8	0	0
23	18760049	.	T	A	9	9	18	0	1	19	0	0
23	18760223	.	T	A	6	4	10	0	1	11	0	0
23	18760256	.	C	T	5	3	8	0	0	8	0	0
23	18760519	.	T	A	11	13	24	0	0	24	0	0
23	18764770	.	A	C	4	5	9	0	0	9	0	0
23	18767148	.	T	C	2	0	2	0	3	5	0	0
23	18769161	.	T	C	4	0	4	0	8	12	0	0
23	18774122	.	T	C	8	6	14	0	2	16	0	0
23	18777816	.	C	T	4	7	11	0	0	11	0	0
23	18795055	.	T	C	5	3	8	0	0	8	0	0
23	18795620	.	A	G	13	29	42	0	0	42	0	0
23	18795721	.	C	T	18	15	33	0	2	35	0	0
23	18801275	.	G	A	31	12	43	0	0	43	0	0
23	18869550	.	C	A	0	4	4	0	5	9	0	0
23	18870235	.	A	T	10	7	17	0	0	17	0	0
23	18870245	.	T	C	8	0	8	0	10	18	0	0
23	18870716	.	G	T	8	10	18	0	0	19	1	0
23	18944417	.	C	A	1	3	4	0	0	4	0	0
23	18944489	.	A	G	8	7	15	0	0	15	0	0
23	18944543	.	G	A	2	17	19	0	15	34	0	0
23	18947344	.	C	A	12	19	31	0	0	31	0	0
23	18947385	.	G	C	13	18	31	0	0	31	0	0
23	18950968	.	T	C	16	9	25	0	1	26	0	0
23	18950970	.	T	A	18	9	27	0	0	27	0	0
23	18951010	.	G	A	14	9	23	0	1	24	0	0
23	18954023	.	A	G	5	9	14	0	0	14	0	0
23	18954100	.	A	G	2	12	14	0	0	14	0	0
23	18954151	.	G	A	13	6	19	0	0	19	0	0
23	18954542	.	G	C	1	3	4	1	0	5	0	0
23	18954759	.	T	G	19	11	30	0	0	30	0	0
23	18979342	.	C	T	18	16	34	0	2	36	0	0
23	18979561	.	G	A	18	20	38	0	0	38	0	0
23	18979756	.	T	C	9	22	31	0	1	32	0	0
23	18981525	.	G	A	2	3	5	0	0	5	0	0
23	18982375	.	G	A	13	9	22	0	1	23	0	0
23	18986338	.	G	A	15	10	25	0	1	26	0	0
23	18986344	.	G	A	10	14	24	0	0	24	0	0
23	18990914	.	C	T	3	10	13	0	7	20	0	0
23	18993525	.	T	C	17	6	23	0	1	24	0	0
23	18993827	.	C	T	1	7	8	1	11	20	0	0
23	18996030	.	C	T	11	8	19	0	0	19	0	0
23	19003263	.	A	G	7	12	19	0	1	20	0	0
23	19005426	.	G	T	5	10	15	0	0	15	0	0
23	19005486	.	T	C	9	11	20	0	2	22	0	0
23	19005758	.	C	T	10	8	18	0	0	18	0	0
23	19005761	.	C	G	9	9	18	0	0	18	0	0
23	19007389	.	G	T	10	11	21	0	0	21	0	0
23	19008149	.	C	T	3	6	9	0	1	10	0	0
23	19012845	.	C	G	11	7	18	0	0	18	0	0
23	19017421	.	C	A	6	4	10	0	1	11	0	0
23	19022254	.	A	G	9	7	16	0	0	16	0	0
23	19022534	.	G	A	9	3	12	0	0	12	0	0
23	19027408	.	G	A	2	5	7	0	1	8	0	0
23	19027510	.	A	C	8	0	8	0	5	13	0	0
23	19035542	.	A	G	5	2	7	0	0	7	0	0
23	19036052	.	C	G	2	9	11	0	1	12	0	0
23	19042706	.	A	T	1	2	3	0	0	3	0	0
23	19051645	.	C	T	5	2	7	0	1	8	0	0
23	19051737	.	C	T	11	5	16	0	2	18	0	0
23	19051739	.	G	A	11	7	18	0	0	18	0	0
23	19051831	.	C	T	10	3	13	0	0	13	0	0
23	19067116	.	G	A	3	3	6	0	0	6	0	0
23	19099020	.	G	A	1	3	4	0	0	4	0	0
23	19106781	.	G	A	4	5	9	0	0	9	0	0
23	19118372	.	G	T	5	3	8	0	0	8	0	0
23	19118960	.	G	T	1	2	3	0	1	4	0	0
23	19153221	.	A	T	2	3	5	0	0	5	0	0
23	19198348	.	A	T	3	9	12	0	1	13	0	0
23	19198588	.	A	T	10	8	18	0	0	18	0	0
23	19200168	.	G	A	9	10	19	0	1	20	0	0
23	19201103	.	C	A	5	12	17	0	3	20	0	0
23	19201148	.	G	T	2	6	8	0	0	8	0	0
23	19202958	.	A	G	2	3	5	0	0	5	0	0
23	19203952	.	C	T	3	5	8	0	0	8	0	0
23	19204126	.	C	T	4	7	11	0	1	12	0	0
23	19204130	.	T	C	4	7	11	0	1	12	0	0
23	19204237	.	G	A	0	2	2	0	4	6	0	0
23	19204597	.	G	A	5	7	12	0	0	12	0	0
23	19204738	.	C	T	2	3	5	0	1	6	0	0
23	19312803	.	C	T	0	2	2	0	1	3	0	0
23	19474823	.	G	T	9	14	23	0	2	25	0	0
23	19483010	.	C	T	1	8	9	0	10	19	0	0
23	19483260	.	A	G	4	3	7	0	1	8	0	0
23	19484162	.	C	T	4	4	8	0	0	8	0	0
23	19575044	.	G	A	1	17	18	0	19	37	0	0
23	19575134	.	C	T	9	21	30	0	1	31	0	0
23	19577464	.	G	A	3	21	24	0	21	45	0	0
23	19582481	.	T	C	14	17	31	0	0	31	0	0
23	19582559	.	G	T	8	11	19	0	0	19	0	0
23	19582668	.	T	C	12	14	26	0	1	27	0	0
23	19582678	.	C	T	16	16	32	0	0	32	0	0
23	19583208	.	G	A	2	12	14	0	12	26	0	0
23	19583252	.	C	T	8	11	19	0	2	21	0	0
23	19603630	.	T	C	27	38	65	0	2	67	0	0
23	19603753	.	T	C	22	31	53	0	1	54	0	0
23	19603803	.	T	C	25	19	44	0	4	48	0	0
23	19603880	.	A	T	18	26	44	3	5	52	0	0
23	19603994	.	G	A	14	21	35	0	0	35	0	0
23	19604263	.	A	G	14	0	14	0	21	35	0	0
23	19604351	.	G	T	11	9	20	0	0	20	0	0
23	19638368	.	T	C	1	2	3	0	0	3	0	0
23	19644757	.	G	A	1	2	3	0	0	3	0	0
23	19670139	.	G	C	5	6	11	0	0	11	0	0
23	19670185	.	A	T	9	16	25	0	0	25	0	0
23	19672720	.	T	C	8	7	15	0	0	15	0	0
23	19673170	.	C	T	15	7	22	0	1	23	0	0
23	19673376	.	C	T	7	9	16	0	2	18	0	0
23	19673547	.	G	A	5	6	11	0	1	12	0	0
23	19712898	.	G	A	35	22	57	0	5	62	0	0
23	19713291	.	A	G	34	35	69	0	0	69	0	0
23	19713324	.	A	G	32	29	61	0	4	65	0	0
23	19759280	.	G	C	0	3	3	0	2	5	0	0
23	19759370	.	T	C	1	2	3	0	0	3	0	0
23	19774238	.	C	T	3	2	5	0	0	5	0	0
23	19786363	.	T	C	1	2	3	0	0	3	0	0
23	19788562	.	A	T	5	2	7	0	0	7	0	0
23	19790413	.	A	G	5	2	7	0	0	7	0	0
23	19790452	.	G	A	0	3	3	0	6	9	0	0
23	19790712	.	C	T	4	4	8	0	0	8	0	0
23	19790760	.	A	T	5	3	8	0	0	8	0	0
23	19791217	.	G	A	2	3	5	0	0	5	0	0
23	19792704	.	G	A	4	3	7	0	0	7	0	0
23	19792737	.	C	T	2	4	6	0	0	6	0	0
23	19792821	.	T	C	6	4	10	0	0	10	0	0
23	19796643	.	A	T	2	5	7	0	0	7	0	0
23	19796651	.	G	A	2	4	6	0	0	6	0	0
23	19798168	.	T	C	2	3	5	0	0	5	0	0
23	19798174	.	A	G	3	3	6	0	0	6	0	0
23	19798493	.	T	C	3	4	7	0	1	8	0	0
23	19800228	.	T	C	4	5	9	0	1	10	0	0
23	19804543	.	C	A	4	5	9	0	0	9	0	0
23	19804743	.	A	C	2	4	6	0	1	7	0	0
23	19804744	.	T	C	1	5	6	0	0	6	0	0
23	19804878	.	T	C	8	3	11	0	0	11	0	0
23	19805577	.	A	T	2	8	10	0	0	10	0	0
23	19808022	.	C	T	12	8	20	0	0	20	0	0
23	19808078	.	T	C	15	6	21	0	0	21	0	0
23	19808691	.	G	A	2	9	11	0	8	19	0	0
23	19815467	.	G	A	9	9	18	1	0	19	0	0
23	19816699	.	A	T	8	10	18	0	0	18	0	0
23	19821136	.	A	G	5	0	5	0	8	13	0	0
23	19821150	.	C	T	9	6	15	0	0	15	0	0
23	19821277	.	A	C	11	9	20	0	0	20	0	0
23	19821408	.	C	T	8	4	12	0	0	12	0	0
23	19821489	.	A	T	3	3	6	0	1	7	0	0
23	19827611	.	T	C	4	0	4	0	7	11	0	0
23	19827641	.	A	C	6	0	6	0	5	11	0	0
23	19835308	.	T	C	38	21	59	0	0	59	0	0
23	19836260	.	C	T	23	33	56	0	3	59	0	0
23	19837080	.	T	C	33	30	63	0	3	66	0	0
23	19837503	.	G	A	29	20	49	0	2	51	0	0
23	19837939	.	A	G	15	14	29	0	1	30	0	0
23	19837974	.	G	A	14	12	26	0	3	29	0	0
23	19838100	.	C	A	29	25	54	1	2	57	0	0
23	19838295	.	T	G	8	7	15	0	2	17	0	0
23	19838312	.	A	T	9	5	14	0	1	15	0	0
23	19838387	.	A	T	10	16	26	0	0	26	0	0
23	19838388	.	T	A	9	16	25	0	1	26	0	0
23	19838458	.	A	T	16	16	32	0	0	32	0	0
23	19838459	.	A	C	17	16	33	0	0	33	0	0
23	19869132	.	G	A	19	23	42	0	5	47	0	0
23	19871615	.	A	G	26	31	57	0	3	60	0	0
23	19879576	.	C	T	2	19	21	0	33	54	0	0
23	19883318	.	T	C	22	28	50	0	1	51	0	0
23	19893409	.	A	T	25	24	49	0	4	53	0	0
23	19933542	.	A	G	22	14	36	0	3	39	0	0
23	19933578	.	G	A	23	14	37	0	1	38	0	0
23	19933742	.	G	A	12	21	33	0	2	35	0	0
23	19933850	.	A	G	22	19	41	0	2	43	0	0
23	19933896	.	A	G	23	11	34	0	2	36	0	0
23	19933952	.	A	G	21	16	37	0	2	39	0	0
23	19952743	.	C	T	2	27	29	0	26	55	0	0
23	19952869	.	T	A	22	16	38	0	2	40	0	0
23	19969420	.	A	T	2	3	5	0	0	5	0	0
23	19969710	.	G	A	1	2	3	0	0	3	0	0
23	19974092	.	G	A	3	4	7	0	0	7	0	0
23	19976882	.	G	C	2	2	4	0	0	4	0	0
23	19980896	.	A	C	2	4	6	0	1	7	0	0
23	19981119	.	C	T	1	2	3	0	0	3	0	0
23	19981124	.	T	C	1	2	3	0	0	3	0	0
23	19981510	.	G	T	4	6	10	0	0	10	0	0
23	19981554	.	T	C	7	3	10	0	0	10	0	0
23	19981608	.	A	T	1	5	6	0	0	6	0	0
23	19985201	.	A	G	2	5	7	0	0	7	0	0
23	19985210	.	G	T	0	6	6	0	1	7	0	0
23	19985307	.	G	T	3	4	7	0	0	7	0	0
23	19985403	.	T	C	7	4	11	0	0	11	0	0
23	20000716	.	A	G	5	6	11	0	6	17	0	0
23	20002339	.	G	C	4	7	11	0	1	12	0	0
23	20002373	.	T	A	9	6	15	0	0	15	0	0
23	20002439	.	G	C	7	0	7	0	6	13	0	0
23	20002524	.	A	G	5	8	13	0	0	13	0	0
23	20010287	.	T	A	3	3	6	0	0	6	0	0
23	20014199	.	T	C	7	4	11	0	0	11	0	0
23	20014390	.	C	T	0	2	2	0	2	4	0	0
23	20014407	.	A	T	1	5	6	0	0	6	0	0
23	20014474	.	T	A	3	3	6	0	0	6	0	0
23	20014802	.	T	A	7	1	8	0	1	9	0	0
23	20014811	.	C	T	0	2	2	0	6	8	0	0
23	20014995	.	T	G	3	2	5	0	0	5	0	0
23	20014996	.	C	T	3	2	5	0	0	5	0	0
23	20015251	.	T	C	2	2	4	0	0	4	0	0
23	20015294	.	T	C	1	2	3	0	0	3	0	0
23	20015397	.	C	T	4	2	6	0	0	6	0	0
23	20021141	.	A	G	1	2	3	0	0	3	0	0
23	20022144	.	A	G	6	3	9	0	0	9	0	0
23	20022199	.	G	A	6	2	8	0	0	8	0	0
23	20051215	.	A	C	3	0	3	2	2	7	0	0
23	20051217	.	A	G	3	2	5	2	0	7	0	0
23	20113599	.	T	C	13	15	28	1	0	29	0	0
23	20113848	.	G	T	20	14	34	0	2	36	0	0
23	20114327	.	C	A	28	21	49	0	1	50	0	0
23	20117625	.	C	G	2	16	18	0	13	32	1	0
23	20117830	.	A	G	21	16	37	0	2	39	0	0
23	20117938	.	A	C	21	0	21	0	19	40	0	0
23	20118597	.	T	G	17	15	32	0	1	33	0	0
23	20118730	.	T	A	23	9	32	0	3	35	0	0
23	20120646	.	T	C	28	2	30	0	17	47	0	0
23	20121265	.	T	A	30	15	45	0	3	48	0	0
23	20121270	.	G	T	33	15	48	0	0	48	0	0
23	20121326	.	G	A	28	16	44	0	1	45	0	0
23	20122190	.	A	G	15	24	39	0	0	39	0	0
23	20123375	.	G	A	29	11	40	0	0	40	0	0
23	20123386	.	G	T	25	13	38	0	1	39	0	0
23	20123575	.	C	A	29	18	47	0	0	47	0	0
23	20123576	.	C	T	28	18	46	0	0	46	0	0
23	20123629	.	A	G	17	20	37	0	0	37	0	0
23	20133927	.	G	T	1	0	1	0	0	3	2	0
23	20133937	.	T	A	1	2	3	0	0	3	0	0
23	20138134	.	T	C	4	2	6	0	0	6	0	0
23	20139320	.	T	C	1	2	3	0	1	4	0	0
23	20141739	.	G	A	5	2	7	0	0	7	0	0
23	20141748	.	C	A	4	4	8	0	0	8	0	0
23	20143100	.	T	G	2	3	5	0	0	5	0	0
23	20143177	.	G	A	3	3	6	0	0	6	0	0
23	20145420	.	T	A	15	12	27	0	0	27	0	0
23	20145823	.	T	C	10	3	13	0	0	13	0	0
23	20146080	.	A	G	9	12	21	0	1	22	0	0
23	20152477	.	T	C	14	9	23	0	0	23	0	0
23	20152640	.	G	A	9	17	26	0	1	27	0	0
23	20154486	.	A	G	9	6	15	0	1	16	0	0
23	20157790	.	G	A	7	11	18	0	2	20	0	0
23	20157923	.	G	C	5	0	5	0	8	13	0	0
23	20157930	.	T	C	5	0	5	0	7	12	0	0
23	20159225	.	C	T	1	6	7	0	3	10	0	0
23	20159234	.	G	T	2	6	8	0	0	8	0	0
23	20162522	.	C	T	1	6	7	0	4	11	0	0
23	20167944	.	T	C	8	6	14	0	0	14	0	0
23	20167966	.	G	A	11	10	21	0	0	21	0	0
23	20168111	.	T	A	6	10	16	0	2	18	0	0
23	20168127	.	C	T	1	12	13	0	5	18	0	0
23	20168404	.	C	G	9	8	17	0	0	17	0	0
23	20168568	.	T	C	9	10	19	0	1	20	0	0
23	20168573	.	A	G	9	11	20	0	0	20	0	0
23	20168642	.	G	A	8	5	13	0	2	15	0	0
23	20168739	.	T	C	10	8	18	0	2	20	0	0
23	20169105	.	C	G	3	5	8	0	6	14	0	0
23	20170945	.	T	A	10	3	13	0	0	13	0	0
23	20189590	.	T	G	1	2	3	0	0	3	0	0
23	20190137	.	T	C	1	3	4	0	0	4	0	0
23	20264937	.	T	C	3	2	5	0	0	5	0	0
23	20528114	.	A	T	6	2	8	0	0	8	0	0
23	21111170	.	A	G	7	0	7	0	13	20	0	0
23	21470390	.	C	G	1	3	4	0	0	4	0	0
23	21489572	.	A	G	10	4	14	0	0	14	0	0
23	22060088	.	T	A	2	9	11	0	1	12	0	0
23	22874433	.	T	A	6	5	11	0	0	11	0	0
23	22876775	.	G	A	6	6	12	0	2	14	0	0
23	22886149	.	C	T	9	6	15	0	2	17	0	0
23	22888817	.	G	A	9	6	15	0	1	16	0	0
23	22918609	.	A	T	12	12	24	0	0	24	0	0
23	22919817	.	C	T	24	18	42	0	1	43	0	0
23	22919883	.	T	C	17	11	28	0	3	31	0	0
23	22920221	.	T	A	12	24	36	0	5	41	0	0
23	22920594	.	C	T	19	23	42	0	3	45	0	0
23	22923021	.	A	C	19	21	40	0	2	42	0	0
23	22923057	.	A	G	19	0	19	0	17	36	0	0
23	22923093	.	C	T	15	27	42	0	0	42	0	0
23	22923147	.	C	T	18	14	32	0	0	32	0	0
23	22923198	.	C	T	12	15	27	0	2	29	0	0
23	22923537	.	C	T	19	13	32	0	0	32	0	0
23	23118653	.	A	T	6	8	14	0	0	14	0	0
23	23118815	.	C	T	5	2	7	0	0	7	0	0
23	23122178	.	G	A	1	9	10	1	7	18	0	0
23	23122381	.	C	T	6	8	14	0	0	14	0	0
23	23122528	.	C	T	3	7	10	0	1	11	0	0
23	23122898	.	A	G	7	10	17	0	0	17	0	0
23	23123146	.	G	T	9	4	13	0	0	13	0	0
23	23123420	.	G	T	2	4	6	0	0	6	0	0
23	23123715	.	C	T	1	3	4	0	0	4	0	0
23	23126414	.	A	G	5	4	9	0	1	10	0	0
23	23126621	.	T	C	1	3	4	0	0	4	0	0
23	23136745	.	G	A	7	4	11	0	0	11	0	0
23	23154388	.	T	A	5	3	8	0	0	8	0	0
23	23160057	.	C	T	2	7	9	0	0	9	0	0
23	23171172	.	C	T	4	3	7	0	0	7	0	0
23	23174035	.	A	G	5	2	7	0	0	7	0	0
23	23174059	.	G	A	1	4	5	0	0	5	0	0
23	23178359	.	G	A	3	3	6	0	0	6	0	0
23	23190151	.	T	A	2	9	11	0	1	12	0	0
23	23205469	.	A	G	4	0	4	3	23	30	0	0
23	23213068	.	A	C	3	14	17	0	2	19	0	0
23	23213069	.	A	C	3	16	19	0	0	19	0	0
23	23213219	.	T	C	4	19	23	0	2	25	0	0
23	23213232	.	G	T	25	6	31	0	0	31	0	0
23	23213355	.	A	C	20	7	27	0	0	27	0	0
23	23214070	.	C	T	2	9	11	0	0	11	0	0
23	23399987	.	T	C	10	7	17	0	1	18	0	0
23	23400032	.	A	G	10	12	22	0	1	23	0	0
23	23401093	.	T	A	4	3	7	0	1	8	0	0
23	23658506	.	T	A	7	9	16	0	0	16	0	0
23	23658708	.	A	T	9	9	18	0	0	18	0	0
23	23658766	.	C	T	5	11	16	0	0	16	0	0
23	23754415	.	C	T	12	8	20	0	0	20	0	0
23	23794656	.	T	C	15	13	28	0	0	28	0	0
23	23825441	.	A	C	11	16	27	0	0	27	0	0
23	23830952	.	T	C	13	6	19	0	1	20	0	0
23	23830985	.	C	G	20	6	26	0	0	26	0	0
23	23860113	.	T	A	13	7	20	0	0	20	0	0
23	23860117	.	G	A	13	7	20	0	0	20	0	0
23	23863569	.	G	A	13	10	23	0	0	23	0	0
23	23869182	.	T	C	17	22	39	1	1	41	0	0
23	23877088	.	A	G	18	0	18	0	15	33	0	0
23	23888136	.	G	A	1	10	11	0	20	31	0	0
23	23890928	.	T	C	23	20	43	0	3	46	0	0
23	23891535	.	C	T	18	19	37	0	3	40	0	0
23	23891551	.	G	A	2	17	19	0	20	39	0	0
23	23903278	.	G	A	2	14	16	0	20	36	0	0
23	23903308	.	C	T	9	17	26	0	1	27	0	0
23	23912720	.	G	T	19	5	24	0	2	26	0	0
23	23912723	.	C	A	20	7	27	0	1	28	0	0
23	23912881	.	C	T	19	21	40	0	1	41	0	0
23	23913053	.	T	A	10	3	13	0	0	13	0	0
23	23913055	.	T	A	13	3	16	0	0	16	0	0
23	23913240	.	G	T	20	17	37	0	1	38	0	0
23	23913417	.	T	C	24	26	50	0	3	53	0	0
23	23913818	.	A	T	14	16	30	0	2	32	0	0
23	23913832	.	G	A	16	16	32	0	0	32	0	0
23	23913858	.	A	C	23	15	38	0	3	41	0	0
23	23914176	.	A	T	18	18	36	0	1	38	1	0
23	23973724	.	T	A	7	4	11	0	0	11	0	0
23	23977689	.	T	C	6	5	11	0	2	13	0	0
23	23987646	.	A	G	4	4	8	0	2	10	0	0
23	23995111	.	G	T	6	5	11	0	0	11	0	0
23	23995260	.	T	A	3	3	6	0	0	6	0	0
23	23995278	.	T	A	3	5	8	0	0	8	0	0
23	23995349	.	A	T	6	4	10	0	0	10	0	0
23	23995375	.	C	T	7	4	11	0	0	11	0	0
23	24144860	.	A	G	2	2	4	0	0	4	0	0
23	24144872	.	T	C	2	2	4	0	0	4	0	0
23	24167144	.	C	G	3	4	7	0	0	7	0	0
23	24167169	.	C	G	3	3	6	0	0	6	0	0
23	24167254	.	T	A	3	3	6	0	1	7	0	0
23	24176425	.	C	T	2	15	17	0	17	35	1	0
23	24176474	.	A	G	15	23	38	0	0	38	0	0
23	24178789	.	C	T	3	8	11	0	9	20	0	0
23	24181913	.	G	A	6	14	20	0	0	20	0	0
23	24183523	.	A	C	11	11	22	0	1	23	0	0
23	24190677	.	C	T	12	14	26	0	0	26	0	0
23	24202583	.	A	T	5	4	9	0	0	9	0	0
23	24202734	.	C	A	1	5	6	0	4	10	0	0
23	24202754	.	A	C	5	0	5	0	4	9	0	0
23	24202859	.	A	T	2	11	13	0	0	13	0	0
23	24202985	.	T	C	5	5	10	0	0	10	0	0
23	24207787	.	G	A	3	5	8	0	1	9	0	0
23	24208208	.	G	C	7	4	11	0	0	11	0	0
23	24214381	.	G	A	6	5	11	0	0	11	0	0
23	24219220	.	G	A	1	4	5	0	0	5	0	0
23	24227400	.	G	A	7	6	13	0	0	13	0	0
23	24227696	.	C	T	28	7	35	0	0	35	0	0
23	24227702	.	T	A	25	6	31	0	1	32	0	0
23	24229110	.	G	A	9	14	23	0	3	26	0	0
23	24233831	.	A	G	16	8	24	0	1	25	0	0
23	24234181	.	T	C	9	14	23	0	0	23	0	0
23	24234232	.	T	C	10	18	28	0	3	31	0	0
23	24239009	.	C	T	14	7	21	0	0	21	0	0
23	24243168	.	G	A	9	7	16	0	0	16	0	0
23	24244694	.	C	T	3	4	7	0	7	14	0	0
23	24246864	.	A	G	7	6	13	0	1	14	0	0
23	24249074	.	G	T	9	12	21	0	0	21	0	0
23	24249227	.	C	T	11	8	19	0	2	21	0	0
23	24251531	.	C	A	6	6	12	0	2	14	0	0
23	24253171	.	T	G	4	8	12	0	0	12	0	0
23	24301297	.	C	T	3	9	12	0	0	12	0	0
23	24304648	.	T	C	3	3	6	0	0	6	0	0
23	24308629	.	A	C	1	3	4	0	0	4	0	0
23	24315930	.	G	A	3	2	5	0	0	5	0	0
23	24359069	.	A	G	1	2	3	0	0	3	0	0
23	24439480	.	G	T	11	16	27	0	0	27	0	0
23	24439580	.	T	C	18	0	18	0	22	40	0	0
23	24439780	.	G	A	14	11	25	0	0	25	0	0
23	24440414	.	C	A	15	10	25	1	0	26	0	0
23	24443161	.	G	T	5	16	21	0	0	22	1	0
23	24444279	.	C	T	12	16	28	0	0	28	0	0
23	24444803	.	T	G	11	12	23	0	1	24	0	0
23	24444861	.	G	A	14	7	21	0	1	22	0	0
23	24445112	.	G	T	16	13	29	0	2	31	0	0
23	24445584	.	A	G	17	7	24	0	0	24	0	0
23	24445906	.	G	C	13	13	26	0	3	29	0	0
23	24446040	.	T	A	10	10	20	0	0	20	0	0
23	24446411	.	C	T	9	7	16	0	1	17	0	0
23	24447113	.	C	T	12	7	19	0	1	20	0	0
23	24447534	.	C	T	0	8	8	0	13	21	0	0
23	24448071	.	T	A	11	11	22	0	0	22	0	0
23	24448568	.	T	A	9	5	14	0	0	14	0	0
23	24448621	.	G	C	10	10	20	0	0	20	0	0
23	24448630	.	G	T	8	9	17	0	1	18	0	0
23	24450327	.	T	C	4	4	8	0	0	8	0	0
23	24450353	.	C	T	4	3	7	0	0	7	0	0
23	24450618	.	G	A	4	7	11	0	0	11	0	0
23	24451083	.	A	G	5	8	13	0	0	13	0	0
23	24451283	.	A	G	7	9	16	0	0	16	0	0
23	24451920	.	T	A	3	5	8	0	1	9	0	0
23	24452496	.	C	T	5	3	8	0	0	8	0	0
23	24452508	.	G	A	4	2	6	0	0	6	0	0
23	24475749	.	G	T	8	4	12	0	0	12	0	0
23	24483315	.	G	C	7	3	10	0	0	10	0	0
23	24507550	.	A	G	12	19	31	0	0	31	0	0
23	24507555	.	T	C	11	18	29	0	1	30	0	0
23	24507668	.	A	G	10	0	10	0	8	18	0	0
23	24508422	.	T	G	4	10	14	0	0	14	0	0
23	24508500	.	C	T	10	11	21	0	0	21	0	0
23	24508630	.	T	C	8	10	18	0	0	18	0	0
23	24512720	.	C	T	1	3	4	0	1	5	0	0
23	24513096	.	C	T	0	2	2	0	1	3	0	0
23	24528507	.	G	A	3	3	6	0	0	6	0	0
23	24540767	.	C	A	1	2	3	0	0	3	0	0
23	24581809	.	G	A	11	10	21	0	0	22	1	0
23	24582165	.	G	A	11	11	22	0	2	24	0	0
23	24582185	.	C	T	17	9	26	0	0	26	0	0
23	24589983	.	G	A	1	3	4	0	0	4	0	0
23	24590317	.	G	A	2	2	4	0	0	4	0	0
23	24590361	.	C	A	4	4	8	0	0	8	0	0
23	24591045	.	G	A	2	2	4	0	0	4	0	0
23	24591051	.	A	T	2	2	4	0	0	4	0	0
23	24591158	.	C	T	2	2	4	0	0	4	0	0
23	24591168	.	A	C	0	3	3	0	0	3	0	0
23	24591291	.	G	A	2	2	4	0	0	4	0	0
23	24591764	.	G	A	2	2	4	0	0	4	0	0
23	24595418	.	G	A	0	2	2	0	1	3	0	0
23	24595782	.	T	A	3	2	5	0	1	6	0	0
23	24598841	.	A	T	3	2	5	0	0	5	0	0
23	24600513	.	C	T	16	8	24	0	1	25	0	0
23	24600947	.	T	C	9	11	20	0	1	21	0	0
23	24604042	.	C	T	6	12	18	0	3	21	0	0
23	24604323	.	C	T	6	11	17	0	0	17	0	0
23	24604461	.	A	G	7	0	7	0	10	17	0	0
23	24605243	.	T	A	12	8	20	0	2	22	0	0
23	24608805	.	G	A	10	11	21	0	1	22	0	0
23	24608847	.	G	A	0	12	12	0	15	27	0	0
23	24611786	.	G	A	0	6	6	0	3	9	0	0
23	24652909	.	G	A	0	10	10	0	6	16	0	0
23	24652929	.	G	A	0	7	7	0	5	12	0	0
23	24654287	.	G	T	9	3	12	0	1	13	0	0
23	24654391	.	A	T	2	4	6	0	0	6	0	0
23	24654528	.	G	T	2	2	4	0	1	5	0	0
23	24655227	.	T	C	6	6	12	0	1	13	0	0
23	24655478	.	C	T	7	5	12	0	1	13	0	0
23	24655761	.	T	G	6	0	6	0	12	18	0	0
23	24655833	.	A	G	5	6	11	0	2	13	0	0
23	24659777	.	C	T	7	6	13	0	0	13	0	0
23	24661762	.	A	G	2	0	2	0	12	14	0	0
23	24661851	.	C	T	10	9	19	0	0	19	0	0
23	24669319	.	A	T	7	8	15	0	0	15	0	0
23	24669381	.	C	T	1	9	10	0	3	13	0	0
23	24669561	.	A	G	9	11	20	0	0	20	0	0
23	24669633	.	T	C	12	2	14	0	10	24	0	0
23	24676192	.	G	C	11	9	20	0	0	20	0	0
23	24694096	.	C	T	9	11	20	1	2	23	0	0
23	24694184	.	G	C	18	9	27	0	0	27	0	0
23	24694242	.	C	A	17	13	30	0	0	30	0	0
23	24694387	.	A	G	23	24	47	0	1	48	0	0
23	24694756	.	C	T	14	19	33	0	0	33	0	0
23	24696943	.	A	G	17	20	37	0	0	37	0	0
23	24697036	.	G	A	23	21	44	0	1	45	0	0
23	24697287	.	A	C	17	21	38	0	0	38	0	0
23	24699281	.	T	A	31	26	57	0	1	59	1	0
23	24749959	.	T	C	1	2	3	0	0	3	0	0
23	24819831	.	C	G	8	13	21	0	3	24	0	0
23	24819936	.	G	A	16	16	32	0	2	34	0	0
23	24823899	.	T	C	7	12	19	0	0	20	1	0
23	24824048	.	C	T	12	12	24	0	2	26	0	0
23	24824056	.	G	A	14	10	24	0	0	24	0	0
23	24926470	.	G	A	10	14	24	0	0	25	1	0
23	24932979	.	G	A	16	7	23	0	1	24	0	0
23	24933121	.	C	T	7	6	13	0	0	13	0	0
23	24934567	.	T	C	12	8	20	0	3	23	0	0
23	24934597	.	C	G	13	6	19	0	1	20	0	0
23	24934646	.	G	A	15	4	19	0	0	19	0	0
23	24937143	.	T	C	19	18	37	0	1	38	0	0
23	24937357	.	T	C	12	7	19	0	1	20	0	0
23	24937676	.	T	C	4	4	8	0	0	8	0	0
23	24938401	.	G	A	10	8	18	0	1	19	0	0
23	24938446	.	T	C	8	7	15	0	1	16	0	0
23	24938559	.	T	C	6	2	8	0	0	8	0	0
23	24938642	.	C	T	5	2	7	0	0	7	0	0
23	24938901	.	G	A	5	2	7	0	0	7	0	0
23	24939008	.	T	C	5	2	7	0	0	7	0	0
23	24941366	.	T	A	1	3	4	0	1	5	0	0
23	24941449	.	T	C	3	4	7	0	0	7	0	0
23	24941479	.	C	A	4	3	7	0	0	7	0	0
23	24941524	.	T	C	2	2	4	0	0	4	0	0
23	24941572	.	G	A	1	3	4	0	0	4	0	0
23	24941714	.	T	C	3	4	7	0	0	7	0	0
23	24944247	.	G	A	3	3	6	0	0	6	0	0
23	24948934	.	C	G	1	3	4	0	0	4	0	0
23	24955580	.	C	T	2	4	6	0	0	6	0	0
23	24955637	.	A	T	3	3	6	0	0	6	0	0
23	24956985	.	A	T	5	5	10	0	0	10	0	0
23	24957161	.	G	C	2	7	9	0	1	10	0	0
23	24957184	.	A	G	1	0	1	0	7	8	0	0
23	24959374	.	G	C	8	3	11	0	0	11	0	0
23	24960393	.	T	A	2	4	6	0	1	7	0	0
23	24960686	.	C	A	3	2	5	0	0	5	0	0
23	24960701	.	C	T	5	2	7	0	0	7	0	0
23	24968676	.	C	A	5	3	8	0	0	8	0	0
23	24969026	.	G	T	9	7	16	0	1	17	0	0
23	24970592	.	T	C	5	2	7	0	0	7	0	0
23	24970593	.	G	A	5	2	7	0	0	7	0	0
23	24973857	.	C	T	2	5	7	0	0	7	0	0
23	24973871	.	T	C	3	4	7	0	0	7	0	0
23	24980093	.	A	G	4	0	4	0	3	7	0	0
23	24980415	.	G	A	2	5	7	0	1	8	0	0
23	24984588	.	T	A	4	2	6	0	0	6	0	0
23	24984969	.	A	C	3	3	6	0	0	6	0	0
23	25009575	.	T	A	6	4	10	0	1	11	0	0
23	25009935	.	C	T	6	4	10	0	0	10	0	0
23	25012510	.	G	T	5	4	9	0	0	9	0	0
23	25122283	.	T	A	8	7	15	0	0	15	0	0
23	25132264	.	G	A	14	19	33	0	1	34	0	0
23	25135899	.	C	G	4	2	6	0	0	6	0	0
23	25135944	.	T	A	7	11	18	0	0	18	0	0
23	25135945	.	T	A	7	11	18	0	0	18	0	0
23	25136039	.	G	A	0	5	5	0	5	10	0	0
23	25136067	.	G	A	4	6	10	0	1	11	0	0
23	25149777	.	C	T	17	9	26	0	0	26	0	0
23	25149921	.	A	G	6	6	12	0	0	12	0	0
23	25172729	.	A	C	7	5	12	0	0	12	0	0
23	25173282	.	C	T	3	3	6	0	0	6	0	0
23	25211392	.	T	G	14	12	26	0	0	26	0	0
23	25211419	.	C	A	11	13	24	0	0	24	0	0
23	25217774	.	C	T	16	6	22	0	0	22	0	0
23	25218647	.	C	G	15	8	23	0	2	25	0	0
23	25218728	.	G	A	10	13	23	0	1	24	0	0
23	25218850	.	A	G	13	15	28	0	2	30	0	0
23	25218854	.	A	G	10	15	25	0	4	29	0	0
23	25220160	.	A	G	22	6	28	0	0	28	0	0
23	25220217	.	T	C	19	11	30	0	0	30	0	0
23	25220226	.	G	T	19	12	31	0	1	32	0	0
23	25220262	.	T	C	13	13	26	0	2	28	0	0
23	25220286	.	C	A	12	8	20	0	4	24	0	0
23	25220545	.	C	T	10	5	15	0	0	15	0	0
23	25221198	.	G	A	11	9	20	0	1	21	0	0
23	25221264	.	G	A	15	11	26	0	2	28	0	0
23	25222196	.	C	T	21	12	33	0	1	34	0	0
23	25222214	.	G	A	1	11	12	0	22	34	0	0
23	25222578	.	G	T	11	5	16	0	2	18	0	0
23	25222585	.	A	T	10	6	16	0	0	16	0	0
23	25268652	.	T	C	4	5	9	0	0	9	0	0
23	25270745	.	C	A	2	5	7	0	0	7	0	0
23	25272790	.	C	T	4	2	6	0	1	7	0	0
23	25274450	.	T	G	4	6	10	0	1	11	0	0
23	25274483	.	G	A	6	4	10	0	2	12	0	0
23	25274526	.	T	C	4	5	9	0	1	10	0	0
23	25274537	.	C	A	1	5	6	0	1	7	0	0
23	25276118	.	C	T	1	2	3	0	0	3	0	0
23	25280208	.	A	G	3	3	6	0	0	6	0	0
23	25280235	.	G	A	3	3	6	0	0	6	0	0
23	25282883	.	T	A	6	5	11	0	0	11	0	0
23	25284824	.	C	T	4	4	8	0	0	8	0	0
23	25284869	.	T	C	2	5	7	0	0	7	0	0
23	25286802	.	A	C	3	8	11	0	0	11	0	0
23	25287292	.	A	C	8	5	13	0	0	13	0	0
23	25287308	.	G	A	0	5	5	0	10	15	0	0
23	25292000	.	G	A	10	20	30	0	0	30	0	0
23	25293908	.	A	C	9	8	17	0	0	17	0	0
23	25308040	.	A	G	2	0	2	0	2	4	0	0
23	25317939	.	A	G	1	0	1	0	2	3	0	0
23	25330324	.	G	A	2	10	12	0	0	12	0	0
23	25335350	.	G	A	3	2	5	0	0	5	0	0
23	25338908	.	T	C	2	2	4	0	0	4	0	0
23	25448451	.	T	C	2	4	6	0	0	6	0	0
23	25448554	.	T	C	2	5	7	0	1	8	0	0
23	25448582	.	T	C	1	4	5	0	0	5	0	0
23	25458584	.	G	A	16	18	34	0	1	35	0	0
23	25458615	.	G	A	19	15	34	0	2	36	0	0
23	25464156	.	A	G	21	15	36	0	1	37	0	0
23	25471197	.	G	A	6	10	16	0	0	16	0	0
23	25471652	.	G	A	10	9	19	0	3	22	0	0
23	25484859	.	G	A	10	9	19	0	0	19	0	0
23	25484886	.	G	A	12	16	28	0	0	28	0	0
23	25491895	.	T	C	4	0	4	0	5	9	0	0
23	25495443	.	A	G	7	6	13	0	0	13	0	0
23	25501969	.	T	G	7	3	10	0	0	10	0	0
23	25502162	.	C	T	4	5	9	0	1	10	0	0
23	25502163	.	T	C	4	6	10	0	0	10	0	0
23	25504804	.	G	T	4	5	9	0	0	9	0	0
23	25505753	.	G	T	4	4	8	0	0	8	0	0
23	25506675	.	C	A	4	8	12	0	0	12	0	0
23	25514702	.	G	A	7	3	10	0	1	11	0	0
23	25515733	.	G	A	5	6	11	0	0	11	0	0
23	25518832	.	G	T	1	3	4	0	0	4	0	0
23	25525236	.	A	G	5	2	7	0	0	7	0	0
23	25525335	.	A	G	2	5	7	0	0	7	0	0
23	25532166	.	T	C	3	6	9	0	0	9	0	0
23	25532238	.	T	C	5	5	10	0	0	10	0	0
23	25532499	.	C	A	4	3	7	0	0	7	0	0
23	25533685	.	C	T	0	3	3	0	5	8	0	0
23	25539994	.	G	A	5	4	9	0	0	9	0	0
23	25550894	.	A	G	4	3	7	0	0	7	0	0
23	25555473	.	G	A	4	3	7	0	1	8	0	0
23	25560480	.	C	T	9	3	12	0	0	12	0	0
23	25560899	.	G	A	6	6	12	0	1	13	0	0
23	25564701	.	T	C	3	5	8	0	0	8	0	0
23	25564716	.	C	T	3	4	7	0	0	7	0	0
23	25592044	.	G	A	3	2	5	0	1	6	0	0
23	25592116	.	T	A	3	6	9	0	0	9	0	0
23	25592155	.	T	C	5	6	11	0	0	11	0	0
23	25592666	.	C	A	2	9	11	0	0	11	0	0
23	25756641	.	A	G	2	6	8	0	1	9	0	0
23	25771107	.	G	A	7	4	11	0	1	12	0	0
23	25773505	.	G	T	6	4	10	0	0	10	0	0
23	25774855	.	A	G	4	3	7	0	1	8	0	0
23	25776499	.	G	A	4	2	6	0	0	6	0	0
23	25776811	.	G	T	6	8	14	0	1	15	0	0
23	25776879	.	A	G	6	7	13	0	0	13	0	0
23	25777286	.	A	G	5	3	8	0	0	8	0	0
23	25789308	.	G	C	3	3	6	0	0	6	0	0
23	25792923	.	A	T	10	4	14	0	1	15	0	0
23	25796355	.	C	T	4	4	8	0	0	8	0	0
23	25796484	.	G	C	1	0	1	0	4	5	0	0
23	25796899	.	G	A	4	11	15	0	0	15	0	0
23	25796975	.	G	A	5	4	9	0	0	9	0	0
23	25797143	.	G	C	7	12	19	1	0	20	0	0
23	25869424	.	A	G	17	1	18	0	15	33	0	0
23	25869571	.	G	A	10	5	15	0	1	16	0	0
23	25869596	.	C	A	11	5	16	0	0	16	0	0
23	25869658	.	C	T	7	10	17	0	1	18	0	0
23	25869706	.	A	G	10	9	19	0	0	19	0	0
23	25871493	.	A	G	7	10	17	0	0	17	0	0
23	25871628	.	G	C	6	6	12	0	1	13	0	0
23	25871764	.	C	A	12	8	20	0	0	20	0	0
23	25873670	.	A	G	2	2	4	0	0	4	0	0
23	25874089	.	A	C	12	8	20	0	2	22	0	0
23	25874100	.	A	T	14	10	24	0	2	26	0	0
23	25874135	.	G	A	0	10	10	0	14	24	0	0
23	25874154	.	T	G	12	6	18	0	0	18	0	0
23	25874249	.	A	G	11	0	11	0	10	21	0	0
23	25874261	.	T	A	15	6	21	0	2	23	0	0
23	25874334	.	C	G	6	4	10	0	0	10	0	0
23	25874355	.	A	T	6	2	8	0	1	9	0	0
23	25874385	.	T	C	5	5	10	0	0	10	0	0
23	25874452	.	A	T	6	5	11	0	0	11	0	0
23	25930689	.	C	T	10	22	32	0	3	35	0	0
23	25942399	.	T	G	4	1	5	0	13	18	0	0
23	25942559	.	T	A	1	5	6	0	0	6	0	0
23	25942708	.	G	A	0	2	2	0	1	3	0	0
23	25946732	.	A	G	2	2	4	0	0	4	0	0
23	25946766	.	C	T	1	2	3	0	0	3	0	0
23	25946882	.	T	C	3	0	3	0	4	7	0	0
23	25946931	.	A	T	1	2	3	0	0	3	0	0
23	25946941	.	A	T	1	3	4	0	0	4	0	0
23	25948000	.	G	A	3	2	5	0	0	5	0	0
23	26063179	.	A	T	3	2	5	0	0	5	0	0
23	26063264	.	T	C	1	2	3	0	0	3	0	0
23	26063560	.	A	T	22	27	49	0	3	52	0	0
23	26063581	.	T	C	26	1	27	0	25	52	0	0
23	26063614	.	A	C	26	35	61	0	0	61	0	0
23	26064050	.	T	A	27	25	52	1	4	57	0	0
23	26064122	.	T	A	14	20	34	2	2	38	0	0
23	26064124	.	T	A	29	7	36	2	1	39	0	0
23	26064186	.	C	G	15	15	30	2	0	32	0	0
23	26064192	.	T	A	13	14	27	2	1	30	0	0
23	26064234	.	G	T	16	14	30	0	4	34	0	0
23	26064266	.	T	A	19	11	30	0	0	30	0	0
23	26074123	.	G	A	28	21	49	0	0	49	0	0
23	26074252	.	T	A	22	23	45	0	4	49	0	0
23	26074288	.	T	C	24	24	48	0	1	49	0	0
23	26074312	.	C	T	25	22	47	0	1	48	0	0
23	26082089	.	C	T	1	4	5	0	0	5	0	0
23	26083603	.	A	G	9	6	15	0	1	16	0	0
23	26083822	.	A	C	8	5	13	0	0	13	0	0
23	26088857	.	T	C	5	4	9	0	0	9	0	0
23	26094671	.	C	T	11	5	16	0	0	16	0	0
23	26184132	.	T	C	9	13	22	0	1	23	0	0
23	26184225	.	G	A	9	11	20	0	0	20	0	0
23	26187373	.	C	T	1	6	7	0	10	17	0	0
23	26187415	.	A	G	4	8	12	0	1	13	0	0
23	26187603	.	C	A	0	2	2	0	10	12	0	0
23	26187657	.	A	G	3	3	6	0	0	6	0	0
23	26187735	.	C	T	6	3	9	0	1	10	0	0
23	26187885	.	T	C	9	4	13	0	0	13	0	0
23	26187912	.	G	A	7	5	12	0	0	12	0	0
23	26225670	.	T	C	7	4	11	0	0	11	0	0
23	26225739	.	G	A	6	4	10	0	1	11	0	0
23	26225871	.	G	A	4	6	10	0	0	10	0	0
23	26225907	.	A	T	6	5	11	0	0	11	0	0
23	26226066	.	G	T	5	7	12	0	0	12	0	0
23	26227697	.	C	T	2	11	13	0	7	20	0	0
23	26232509	.	C	A	13	8	21	0	0	21	0	0
23	26240897	.	C	T	10	12	22	0	3	25	0	0
23	26241224	.	T	A	9	6	15	0	1	16	0	0
23	26249884	.	G	A	6	7	13	0	0	13	0	0
23	26251973	.	C	T	6	8	14	0	2	16	0	0
23	26251979	.	A	T	5	9	14	0	3	17	0	0
23	26252012	.	A	G	10	9	19	0	0	19	0	0
23	26273212	.	C	T	0	7	7	0	2	9	0	0
23	26299011	.	T	C	4	0	4	0	8	12	0	0
23	26311056	.	T	C	3	3	6	0	0	6	0	0
23	26343689	.	C	G	2	4	6	0	0	6	0	0
23	26488554	.	A	G	3	3	6	0	0	6	0	0
23	26500799	.	C	T	1	2	3	0	0	3	0	0
23	26504151	.	A	C	38	4	42	0	19	61	0	0
23	26504202	.	A	T	41	30	71	0	1	72	0	0
23	26504254	.	G	A	36	23	59	0	1	60	0	0
23	26504264	.	C	T	34	19	53	0	2	55	0	0
23	26507741	.	G	A	29	26	55	0	0	55	0	0
23	26509764	.	G	A	26	33	59	0	0	59	0	0
23	26514677	.	G	A	18	25	43	0	1	44	0	0
23	26514797	.	T	C	23	23	46	0	1	47	0	0
23	26517183	.	G	A	25	25	50	0	2	52	0	0
23	26519635	.	T	G	14	20	34	0	4	38	0	0
23	26522647	.	A	G	23	19	42	0	1	43	0	0
23	26557286	.	A	G	2	4	6	0	0	6	0	0
23	26560135	.	C	A	1	2	3	0	0	3	0	0
23	26569709	.	C	A	2	2	4	0	0	4	0	0
23	26763798	.	A	T	6	5	11	0	0	11	0	0
23	26764138	.	T	C	7	3	10	0	0	10	0	0
23	26764269	.	G	A	7	6	13	0	0	13	0	0
23	26764324	.	C	A	2	5	7	0	0	7	0	0
23	26764351	.	A	C	5	3	8	0	1	9	0	0
23	26770174	.	A	G	5	8	13	0	0	13	0	0
23	26775784	.	C	T	0	2	2	0	3	5	0	0
23	26777492	.	G	A	5	2	7	0	1	8	0	0
23	26777537	.	G	A	4	3	7	0	0	7	0	0
23	26797108	.	T	A	4	2	6	0	1	7	0	0
23	26801696	.	C	T	3	2	5	0	0	5	0	0
23	26819681	.	T	G	2	4	6	0	0	6	0	0
23	26821702	.	G	A	2	3	5	0	0	5	0	0
23	26828236	.	C	T	0	2	2	0	2	4	0	0
23	26828760	.	G	A	5	6	11	0	0	11	0	0
23	26832320	.	C	T	0	6	6	0	2	8	0	0
23	26879781	.	A	C	2	4	6	0	0	6	0	0
23	26946805	.	A	G	3	7	10	0	0	10	0	0
23	26950928	.	G	A	0	3	3	0	7	10	0	0
23	26951926	.	G	A	5	5	10	0	0	10	0	0
23	26955401	.	A	G	11	12	23	0	0	23	0	0
23	26979212	.	C	A	13	10	23	0	0	23	0	0
23	27003720	.	G	A	20	29	49	0	3	52	0	0
23	27003925	.	T	C	23	25	48	0	0	48	0	0
23	27003983	.	A	T	19	20	39	0	2	41	0	0
23	27005195	.	G	A	20	17	37	0	2	39	0	0
23	27041132	.	G	T	2	2	4	0	0	4	0	0
23	27041461	.	A	T	2	3	5	0	1	6	0	0
23	27042357	.	G	A	9	3	12	0	0	12	0	0
23	27042454	.	T	C	6	2	8	0	0	8	0	0
23	27044136	.	G	A	6	2	8	0	0	8	0	0
23	27044307	.	A	G	6	8	14	0	1	15	0	0
23	27044526	.	A	G	4	7	11	0	0	11	0	0
23	27044653	.	G	A	5	5	10	0	1	11	0	0
23	27045022	.	G	A	4	4	8	0	0	8	0	0
23	27049986	.	A	T	4	4	8	0	0	8	0	0
23	27052058	.	C	T	30	25	55	0	2	58	1	0
23	27054361	.	C	T	18	12	30	0	1	31	0	0
23	27056877	.	G	A	21	20	41	0	1	42	0	0
23	27059120	.	G	A	1	16	17	0	22	39	0	0
23	27059376	.	T	A	15	11	26	1	0	27	0	0
23	27059422	.	C	T	14	20	34	1	1	36	0	0
23	27059526	.	G	A	0	18	18	0	18	36	0	0
23	27059591	.	C	A	12	12	24	0	0	24	0	0
23	27059782	.	A	G	16	14	30	0	1	31	0	0
23	27085505	.	T	A	1	2	3	0	0	3	0	0
23	27085506	.	T	C	1	0	1	0	2	3	0	0
23	27135178	.	A	T	1	4	5	0	0	5	0	0
23	27135734	.	G	A	3	4	7	0	0	7	0	0
23	27136385	.	T	G	5	2	7	0	1	8	0	0
23	27251789	.	G	C	21	19	40	1	1	42	0	0
23	27252024	.	G	A	23	25	48	0	2	50	0	0
23	27252425	.	G	A	23	34	57	0	0	57	0	0
23	27252587	.	A	G	24	14	38	0	0	38	0	0
23	27252833	.	A	G	26	18	44	0	2	46	0	0
23	27274110	.	G	A	16	7	23	0	1	24	0	0
23	27274266	.	G	A	16	16	32	0	4	36	0	0
23	27279320	.	A	G	20	20	40	0	2	42	0	0
23	27279533	.	C	T	15	14	29	0	0	29	0	0
23	27283466	.	T	C	14	14	28	0	0	28	0	0
23	27283475	.	A	G	16	13	29	0	3	32	0	0
23	27293293	.	C	T	1	18	19	0	13	33	1	0
23	27293335	.	G	A	15	13	28	0	2	30	0	0
23	27296964	.	G	C	16	0	16	0	16	32	0	0
23	27318104	.	C	T	15	9	24	0	1	25	0	0
23	27336193	.	G	A	10	11	21	0	1	22	0	0
23	27359176	.	A	G	9	8	17	0	0	17	0	0
23	27359526	.	T	C	6	9	15	0	0	15	0	0
23	27359528	.	C	G	6	9	15	0	0	15	0	0
23	27359825	.	C	A	9	10	19	0	1	20	0	0
23	27361210	.	A	T	4	6	10	0	0	10	0	0
23	27361216	.	G	A	3	5	8	0	0	8	0	0
23	27364018	.	C	T	8	8	16	0	0	16	0	0
23	27366669	.	C	T	11	6	17	0	1	18	0	0
23	27380430	.	A	C	2	0	2	0	4	6	0	0
23	27383135	.	T	C	2	0	2	0	3	5	0	0
23	27383362	.	G	A	4	3	7	0	0	7	0	0
23	27384946	.	T	C	2	0	2	0	4	6	0	0
23	27385057	.	G	A	3	5	8	0	0	8	0	0
23	27389324	.	C	A	7	3	10	0	1	11	0	0
23	27498040	.	C	G	9	5	14	0	2	16	0	0
23	27498111	.	C	A	6	10	16	0	0	16	0	0
23	27498177	.	T	C	12	5	17	0	0	17	0	0
23	27498195	.	A	T	12	8	20	0	1	21	0	0
23	27498359	.	T	A	7	4	11	0	0	11	0	0
23	27498798	.	C	T	1	7	8	0	18	26	0	0
23	27498865	.	G	A	21	10	31	0	5	36	0	0
23	27499096	.	G	A	14	9	23	0	0	23	0	0
23	27499135	.	G	A	14	8	22	0	1	23	0	0
23	27499195	.	A	T	10	16	26	0	3	29	0	0
23	27499246	.	G	A	9	13	22	0	1	23	0	0
23	27513919	.	G	A	15	10	25	0	0	25	0	0
23	27513934	.	T	C	14	13	27	0	0	27	0	0
23	27518434	.	G	A	15	15	30	0	3	33	0	0
23	27521608	.	A	T	10	8	18	0	0	18	0	0
23	27547467	.	C	T	0	7	7	0	9	16	0	0
23	27547568	.	G	A	9	6	15	0	1	16	0	0
23	27547650	.	A	T	7	7	14	0	1	15	0	0
23	27547850	.	C	T	1	8	9	0	7	16	0	0
23	27579064	.	T	A	2	2	4	0	0	4	0	0
23	27581369	.	G	T	1	3	4	0	0	4	0	0
23	27581407	.	C	T	0	2	2	0	1	3	0	0
23	27591378	.	G	T	7	10	17	0	3	20	0	0
23	27591734	.	C	A	4	2	6	0	0	6	0	0
23	27593230	.	C	T	12	14	26	0	0	26	0	0
23	27595823	.	C	A	1	5	6	0	18	24	0	0
23	27595868	.	T	C	11	10	21	0	1	22	0	0
23	27596059	.	G	A	7	12	19	0	0	19	0	0
23	27597141	.	C	A	1	9	10	0	7	17	0	0
23	27601731	.	G	A	7	3	10	0	1	11	0	0
23	27601803	.	C	T	4	9	13	0	0	13	0	0
23	27603158	.	C	T	8	7	15	0	0	15	0	0
23	27605903	.	C	T	5	5	10	0	0	10	0	0
23	27605927	.	C	T	7	6	13	0	0	13	0	0
23	27606827	.	T	A	12	5	17	0	0	17	0	0
23	27622036	.	T	A	27	18	45	0	2	47	0	0
23	27622094	.	C	A	18	24	42	0	2	44	0	0
23	27622324	.	T	C	11	17	28	0	1	29	0	0
23	27622452	.	C	A	7	3	10	0	0	10	0	0
23	27622531	.	A	T	19	8	27	0	0	27	0	0
23	27622706	.	T	C	16	0	16	1	14	31	0	0
23	27629713	.	G	A	19	18	37	0	0	37	0	0
23	27629923	.	A	T	23	13	36	0	1	37	0	0
23	27643941	.	T	C	1	0	1	0	4	5	0	0
23	27654841	.	C	A	4	2	6	0	0	6	0	0
23	27676223	.	G	T	36	27	63	0	1	64	0	0
23	27677278	.	G	A	26	21	47	0	4	51	0	0
23	27677457	.	G	A	10	13	23	1	2	26	0	0
23	27683143	.	G	T	5	10	15	0	0	15	0	0
23	27683248	.	C	A	0	3	3	0	1	4	0	0
23	27683371	.	C	T	0	4	4	0	6	10	0	0
23	27683497	.	C	T	8	10	18	0	0	18	0	0
23	27683629	.	C	T	0	6	6	0	7	13	0	0
23	27683710	.	G	A	5	5	10	0	1	11	0	0
23	27720126	.	T	G	1	2	3	0	0	3	0	0
23	27784090	.	C	A	6	4	10	1	1	12	0	0
23	27784412	.	G	C	7	3	10	0	0	10	0	0
23	27788665	.	C	T	12	9	21	0	4	25	0	0
23	27800681	.	G	T	6	7	13	0	0	13	0	0
23	27807664	.	G	A	7	9	16	0	0	16	0	0
23	27809601	.	A	C	13	4	17	0	1	18	0	0
23	27822743	.	T	C	11	7	18	0	0	18	0	0
23	27836235	.	C	T	1	6	7	0	7	14	0	0
23	27842530	.	A	T	5	4	9	0	0	9	0	0
23	27845306	.	C	G	1	3	4	0	2	7	1	0
23	27856751	.	G	T	2	2	4	0	0	4	0	0
23	28803343	.	T	C	2	6	8	0	0	8	0	0
23	29712670	.	G	A	15	10	25	1	3	29	0	0
23	29841965	.	T	C	9	3	12	0	0	12	0	0
23	30061605	.	A	C	14	14	28	0	5	33	0	0
23	30065641	.	T	G	6	8	14	1	0	15	0	0
23	30128781	.	A	T	12	3	15	1	0	16	0	0
23	30128788	.	G	A	9	4	13	1	0	14	0	0
23	30712041	.	T	A	5	8	13	0	2	15	0	0
23	30715397	.	G	A	0	3	3	0	7	10	0	0
23	30716096	.	C	T	7	7	14	0	1	15	0	0
23	30718514	.	T	A	11	6	17	0	0	17	0	0
23	30723747	.	A	T	11	4	15	0	0	15	0	0
23	30724362	.	T	G	2	3	5	0	0	5	0	0
23	30724440	.	T	C	6	11	17	0	3	20	0	0
23	30727136	.	T	A	1	5	6	0	0	7	1	0
23	30727172	.	T	C	2	0	2	0	4	6	0	0
23	30727288	.	T	G	2	3	5	0	0	5	0	0
23	30730351	.	C	T	5	6	11	0	0	11	0	0
23	30730374	.	C	T	5	5	10	0	0	10	0	0
23	30747357	.	G	C	12	10	22	0	0	22	0	0
23	30747953	.	G	A	12	10	22	0	0	22	0	0
23	30748097	.	G	A	11	11	22	0	3	25	0	0
23	30748712	.	C	G	11	0	11	0	12	23	0	0
23	30748743	.	C	T	10	13	23	0	2	25	0	0
23	30750402	.	C	A	14	9	23	0	1	24	0	0
23	30750694	.	C	A	15	11	26	0	2	29	1	0
23	30750751	.	G	A	2	16	18	0	17	35	0	0
23	30750932	.	A	C	18	17	35	0	0	35	0	0
23	30751008	.	T	C	10	20	30	0	0	30	0	0
23	30751027	.	A	T	9	21	30	0	1	31	0	0
23	30751061	.	A	G	10	1	11	0	21	32	0	0
23	30751117	.	T	C	14	12	26	0	0	26	0	0
23	30751132	.	T	G	17	1	18	0	14	32	0	0
23	30751252	.	A	G	17	12	29	0	2	32	1	0
23	30751570	.	C	T	12	18	30	0	2	32	0	0
23	30751633	.	T	C	12	17	29	0	4	33	0	0
23	30755989	.	C	T	15	9	24	0	1	25	0	0
23	30758493	.	G	T	12	11	23	0	0	23	0	0
23	30764058	.	T	A	10	6	16	0	1	17	0	0
23	30767575	.	T	A	17	15	32	0	0	32	0	0
23	30770193	.	A	G	11	10	21	0	0	21	0	0
23	30772610	.	C	T	1	11	12	0	8	20	0	0
23	30772902	.	C	T	8	9	17	0	1	18	0	0
23	30775315	.	T	C	18	0	18	0	11	29	0	0
23	30776329	.	T	A	4	7	11	0	0	11	0	0
23	30776380	.	T	C	4	0	4	0	13	17	0	0
23	30776574	.	A	T	8	5	13	0	0	13	0	0
23	30778358	.	T	C	5	5	10	0	0	10	0	0
23	30778499	.	G	A	12	10	22	0	0	22	0	0
23	30778864	.	C	G	0	14	14	0	11	25	0	0
23	30781226	.	T	A	11	12	23	0	3	26	0	0
23	30781319	.	A	G	6	6	12	0	1	13	0	0
23	30781367	.	T	C	13	6	19	0	0	19	0	0
23	30859543	.	C	A	6	5	11	0	2	13	0	0
23	30878451	.	G	A	0	2	2	0	7	9	0	0
23	30890018	.	G	T	4	3	7	0	0	7	0	0
23	30890191	.	T	G	4	2	6	0	0	6	0	0
23	30898132	.	C	T	5	2	7	0	0	7	0	0
23	30898150	.	T	C	4	3	7	0	0	7	0	0
23	30898297	.	T	C	5	3	8	0	0	8	0	0
23	30898355	.	A	C	3	4	7	0	0	7	0	0
23	30898387	.	C	T	1	2	3	0	0	3	0	0
23	30898467	.	G	C	0	7	7	0	5	12	0	0
23	30898503	.	A	T	4	4	8	0	0	8	0	0
23	30919027	.	T	G	3	2	5	0	0	5	0	0
23	30940412	.	A	T	2	4	6	0	0	6	0	0
23	30951633	.	A	G	5	4	9	0	0	9	0	0
23	31248605	.	A	T	2	2	4	0	1	5	0	0
23	31248779	.	T	C	1	4	5	0	0	5	0	0
23	31276396	.	T	A	6	9	15	0	0	15	0	0
23	31276453	.	G	A	7	12	19	0	0	19	0	0
23	31276509	.	C	T	8	4	12	0	1	13	0	0
23	31276657	.	T	C	3	5	8	0	1	9	0	0
23	31278183	.	G	T	12	4	16	0	1	17	0	0
23	31278237	.	C	T	1	7	8	0	4	12	0	0
23	31278322	.	A	G	6	11	17	0	1	18	0	0
23	31278375	.	A	G	12	10	22	0	1	23	0	0
23	31278417	.	G	T	11	9	20	0	0	20	0	0
23	31278450	.	T	A	8	9	17	0	0	17	0	0
23	31278732	.	C	T	5	3	8	0	0	8	0	0
23	31278792	.	G	T	5	4	9	0	1	10	0	0
23	31279122	.	G	T	7	8	15	0	0	15	0	0
23	31280198	.	G	A	2	4	6	0	0	6	0	0
23	31280892	.	T	A	3	2	5	0	0	5	0	0
23	31281768	.	T	G	5	2	7	0	0	7	0	0
23	31307138	.	C	A	4	6	10	0	0	10	0	0
23	31309431	.	A	T	2	2	4	0	2	6	0	0
23	31309710	.	T	C	5	2	7	0	0	7	0	0
23	31309722	.	T	C	4	2	6	0	1	7	0	0
23	31358342	.	A	T	25	17	42	2	2	46	0	0
23	31358344	.	A	T	24	18	42	1	2	45	0	0
23	31358489	.	T	G	26	18	44	0	1	45	0	0
23	31358631	.	G	A	37	26	63	1	3	67	0	0
23	31380641	.	A	G	1	4	5	0	1	6	0	0
23	31380643	.	G	A	2	4	6	0	0	6	0	0
23	31381335	.	A	G	3	3	6	0	0	6	0	0
23	31381425	.	C	T	1	2	3	0	0	3	0	0
23	31388310	.	G	A	2	3	5	0	0	5	0	0
23	31405519	.	C	T	7	6	13	0	1	14	0	0
23	31405570	.	A	C	11	16	27	0	0	27	0	0
23	31419064	.	C	T	13	5	18	0	1	19	0	0
23	31419172	.	A	T	10	7	17	0	1	18	0	0
23	31422369	.	A	T	13	4	17	0	0	17	0	0
23	31422429	.	C	T	6	3	9	0	0	9	0	0
23	31422537	.	A	G	9	8	17	0	0	17	0	0
23	31422551	.	A	G	13	5	18	0	1	19	0	0
23	31422577	.	A	G	7	8	15	0	1	16	0	0
23	31422600	.	C	T	7	6	13	0	1	14	0	0
23	31423091	.	T	C	9	5	14	0	0	14	0	0
23	31423145	.	G	A	1	8	9	0	8	17	0	0
23	31423392	.	C	A	17	9	26	0	0	26	0	0
23	31423427	.	A	G	21	0	21	0	13	34	0	0
23	31423432	.	C	A	19	13	32	0	0	32	0	0
23	31432102	.	A	G	8	0	8	0	11	19	0	0
23	31440119	.	T	A	3	2	5	0	0	5	0	0
23	31596584	.	T	G	7	0	7	0	7	14	0	0
23	31597571	.	T	C	6	2	8	0	0	8	0	0
23	31620033	.	C	A	0	2	2	0	1	3	0	0
23	31640363	.	A	G	3	3	6	0	0	6	0	0
23	31641153	.	C	A	21	27	48	0	3	51	0	0
23	31641197	.	A	G	28	23	51	0	0	51	0	0
23	31641270	.	G	A	30	18	48	0	1	49	0	0
23	31643818	.	A	G	16	10	26	0	0	26	0	0
23	31644368	.	A	G	12	14	26	0	0	26	0	0
23	31644419	.	A	G	11	18	29	0	1	30	0	0
23	31644602	.	T	G	12	20	32	0	3	35	0	0
23	31684352	.	G	A	13	20	33	0	0	33	0	0
23	31768596	.	T	C	5	11	16	0	0	16	0	0
23	31771282	.	T	C	5	7	12	0	1	13	0	0
23	31774194	.	G	A	10	2	12	0	1	13	0	0
23	31778174	.	A	G	12	6	18	0	1	19	0	0
23	31778183	.	C	T	12	6	18	0	1	19	0	0
23	31782969	.	T	C	8	0	8	0	14	22	0	0
23	31785175	.	G	A	15	13	28	0	0	28	0	0
23	31785183	.	T	G	16	12	28	0	0	28	0	0
23	31787127	.	C	G	5	9	14	0	0	14	0	0
23	31804162	.	A	G	8	6	14	0	0	14	0	0
23	31915069	.	T	C	5	2	7	0	0	7	0	0
23	31933674	.	C	G	1	4	5	0	0	5	0	0
23	31933739	.	T	G	1	6	7	0	0	7	0	0
23	31940192	.	T	A	5	2	7	0	0	7	0	0
23	31940681	.	C	A	5	2	7	0	0	7	0	0
23	31940775	.	T	A	1	3	4	0	0	4	0	0
23	31940776	.	A	G	1	3	4	0	0	4	0	0
23	31940818	.	C	T	0	2	2	0	1	3	0	0
23	31962971	.	T	C	11	6	17	0	0	17	0	0
23	31963226	.	C	T	6	3	9	0	1	10	0	0
23	31963360	.	A	G	2	3	5	0	0	5	0	0
23	31964680	.	C	T	8	12	20	0	1	21	0	0
23	31981951	.	A	C	4	2	6	0	1	7	0	0
23	31981972	.	A	G	2	3	5	0	0	5	0	0
23	31982041	.	T	C	6	7	13	0	0	13	0	0
23	31982042	.	C	T	6	7	13	0	0	13	0	0
23	31992375	.	T	C	3	2	5	0	0	5	0	0
23	31992522	.	T	C	3	5	8	0	0	8	0	0
23	31992537	.	C	T	5	4	9	0	0	9	0	0
23	31992690	.	C	T	4	4	8	0	2	10	0	0
23	31993590	.	C	T	3	5	8	0	0	8	0	0
23	31995113	.	G	A	1	5	6	0	1	7	0	0
23	31997582	.	G	A	5	9	14	0	1	15	0	0
23	31997953	.	C	T	5	6	11	0	0	11	0	0
23	31998162	.	T	C	3	5	8	0	0	8	0	0
23	31998741	.	A	G	3	0	3	0	8	11	0	0
23	32000336	.	G	C	9	5	14	0	0	14	0	0
23	32003354	.	T	A	6	5	11	0	0	11	0	0
23	32003808	.	T	C	6	5	11	0	1	12	0	0
23	32003820	.	G	T	7	7	14	0	0	14	0	0
23	32007376	.	T	G	7	8	15	0	1	16	0	0
23	32007445	.	T	A	8	9	17	0	0	17	0	0
23	32007520	.	T	C	5	7	12	0	0	12	0	0
23	32007526	.	C	G	5	6	11	0	0	11	0	0
23	32026927	.	T	C	14	9	23	0	0	23	0	0
23	32026978	.	C	T	3	4	7	0	0	7	0	0
23	32026996	.	G	A	1	4	5	0	2	7	0	0
23	32033874	.	T	C	3	2	5	0	0	5	0	0
23	32034342	.	G	A	2	5	7	0	0	7	0	0
23	32081708	.	C	T	18	14	32	0	2	34	0	0
23	32081717	.	T	C	18	16	34	0	0	35	1	0
23	32085908	.	G	T	2	2	4	0	0	4	0	0
23	32088077	.	T	G	7	4	11	0	0	11	0	0
23	32096873	.	C	T	1	3	4	0	3	7	0	0
23	32128893	.	T	C	2	2	4	0	0	4	0	0
23	32129476	.	G	T	7	3	10	0	0	10	0	0
23	32151669	.	A	C	14	9	23	0	0	23	0	0
23	32152022	.	C	T	17	11	28	0	1	29	0	0
23	32154021	.	G	T	6	7	13	0	0	13	0	0
23	32155325	.	A	G	13	10	23	0	1	24	0	0
23	32155719	.	C	T	14	11	25	0	1	26	0	0
23	32155720	.	C	T	3	11	14	0	13	27	0	0
23	32155975	.	C	T	5	5	10	0	1	11	0	0
23	32157787	.	G	T	6	11	17	0	0	17	0	0
23	32200410	.	A	G	6	2	8	0	0	8	0	0
23	32200482	.	T	C	4	3	7	1	0	8	0	0
23	32200517	.	C	A	4	2	6	0	0	6	0	0
23	32200979	.	A	G	5	2	7	0	0	7	0	0
23	32201087	.	G	T	8	6	14	0	0	14	0	0
23	32216002	.	G	C	2	0	2	0	3	5	0	0
23	32239672	.	G	A	11	4	15	0	2	17	0	0
23	32239688	.	C	A	13	5	18	0	0	18	0	0
23	32239708	.	G	A	14	7	21	0	0	21	0	0
23	32239824	.	G	A	16	8	24	1	0	25	0	0
23	32240258	.	C	T	5	6	11	0	0	11	0	0
23	32240290	.	A	G	6	5	11	0	1	12	0	0
23	32242086	.	C	A	10	12	22	0	0	22	0	0
23	32242251	.	T	C	10	10	20	0	1	21	0	0
23	32246169	.	A	G	16	12	28	0	0	28	0	0
23	32246190	.	A	G	15	13	28	0	0	28	0	0
23	32248595	.	C	G	10	12	22	0	1	23	0	0
23	32250286	.	C	T	7	11	18	0	1	19	0	0
23	32251473	.	T	G	14	8	22	0	0	22	0	0
23	32252805	.	A	G	7	3	10	0	1	11	0	0
23	32262708	.	G	A	7	11	18	0	0	18	0	0
23	32304535	.	T	G	4	4	8	0	1	9	0	0
23	32309187	.	T	C	11	16	27	0	0	27	0	0
23	32309193	.	G	A	11	14	25	0	0	25	0	0
23	32309323	.	G	A	10	15	25	0	0	25	0	0
23	32309533	.	A	G	8	11	19	0	1	20	0	0
23	32309659	.	C	A	1	10	11	0	12	23	0	0
23	32309709	.	G	A	8	6	14	0	0	14	0	0
23	32309787	.	A	C	7	13	20	0	1	21	0	0
23	32309846	.	T	A	5	5	10	0	0	10	0	0
23	32309860	.	C	T	4	2	6	0	0	6	0	0
23	32309943	.	A	G	3	6	9	0	1	10	0	0
23	32310209	.	C	T	5	6	11	0	0	11	0	0
23	32310254	.	T	A	2	3	5	0	0	5	0	0
23	32310808	.	C	T	5	2	7	0	1	8	0	0
23	32310864	.	G	A	12	5	17	0	1	18	0	0
23	32311418	.	T	C	10	7	17	0	1	18	0	0
23	32311555	.	G	C	14	12	26	0	2	28	0	0
23	32311612	.	G	A	17	14	31	0	2	33	0	0
23	32318047	.	A	G	20	17	37	0	0	37	0	0
23	32326532	.	A	G	12	16	28	0	1	29	0	0
23	32362317	.	A	G	3	14	17	0	0	17	0	0
23	32532451	.	C	G	1	2	3	0	0	3	0	0
23	32589398	.	C	T	7	5	12	0	2	14	0	0
23	32592331	.	A	G	11	5	16	0	1	17	0	0
23	32592518	.	A	G	5	8	13	0	1	14	0	0
23	32636197	.	G	A	11	7	18	0	1	19	0	0
23	32636364	.	G	A	5	3	8	0	0	8	0	0
23	32641956	.	C	T	1	2	3	0	4	7	0	0
23	32641959	.	G	A	4	2	6	0	1	7	0	0
23	32645443	.	G	A	9	6	15	0	0	15	0	0
23	32668999	.	A	G	7	8	15	0	0	15	0	0
23	32685487	.	C	A	5	4	9	0	2	11	0	0
23	32702903	.	C	T	5	2	7	0	1	8	0	0
23	32702945	.	A	G	4	5	9	0	1	11	1	0
23	32702993	.	C	T	2	5	7	0	0	7	0	0
23	32722944	.	C	T	0	3	3	0	2	5	0	0
23	32722992	.	T	C	1	0	1	0	5	6	0	0
23	32891503	.	A	T	4	3	7	0	0	7	0	0
23	32891673	.	T	G	2	2	4	0	0	4	0	0
23	32891899	.	A	T	5	2	7	0	0	7	0	0
23	32892620	.	A	G	4	3	7	0	1	8	0	0
23	33357856	.	A	C	7	6	13	0	0	13	0	0
23	33357953	.	T	A	2	6	8	0	2	10	0	0
23	33361256	.	C	T	1	8	9	0	8	17	0	0
23	33425642	.	A	T	1	2	3	0	0	3	0	0
23	33437167	.	C	T	1	5	6	0	0	6	0	0
23	33448146	.	T	A	1	4	5	0	0	5	0	0
23	33448148	.	C	T	1	4	5	0	0	5	0	0
23	33633592	.	T	C	4	2	6	0	0	6	0	0
23	33654535	.	G	A	1	5	6	0	1	7	0	0
23	33657431	.	T	A	12	9	21	0	0	21	0	0
23	33657460	.	C	T	13	11	24	0	1	25	0	0
23	33657467	.	T	A	12	13	25	0	0	25	0	0
23	33657714	.	T	G	5	9	14	0	1	15	0	0
23	33682306	.	T	C	2	4	6	0	0	6	0	0
23	33682313	.	A	G	2	4	6	0	0	6	0	0
23	33682371	.	A	T	1	3	4	0	0	4	0	0
23	33682416	.	T	A	4	4	8	0	0	8	0	0
23	33682736	.	A	G	2	4	6	0	0	6	0	0
23	33682740	.	A	T	2	4	6	0	0	6	0	0
23	33682780	.	C	T	2	3	5	0	0	5	0	0
23	33683092	.	T	G	4	7	11	0	0	11	0	0
23	33683281	.	T	C	5	2	7	0	0	7	0	0
23	33683299	.	T	A	4	4	8	0	0	8	0	0
23	33683518	.	A	G	6	5	11	0	0	11	0	0
23	33693482	.	G	A	5	9	14	0	1	15	0	0
23	33693572	.	T	C	10	5	15	0	0	15	0	0
23	33694328	.	A	C	3	0	3	0	2	5	0	0
23	33696929	.	T	G	3	2	5	0	0	5	0	0
23	33696938	.	C	G	3	4	7	0	0	7	0	0
23	33699234	.	G	C	2	5	7	0	0	7	0	0
23	33702812	.	G	A	6	6	12	0	0	12	0	0
23	33718699	.	T	C	27	28	55	0	1	56	0	0
23	33724825	.	G	A	0	20	20	0	25	45	0	0
23	33727916	.	C	T	25	24	49	0	1	50	0	0
23	33728398	.	A	T	24	14	38	0	1	39	0	0
23	33728518	.	T	C	27	15	42	0	1	43	0	0
23	33728609	.	A	T	19	21	40	0	2	42	0	0
23	33728877	.	T	A	27	26	53	0	1	54	0	0
23	33728994	.	T	A	21	12	33	0	0	33	0	0
23	33729231	.	T	A	6	14	20	0	2	22	0	0
23	33729510	.	A	G	21	23	44	0	2	46	0	0
23	33731595	.	T	C	1	2	3	0	0	3	0	0
23	33738436	.	A	C	1	2	3	0	0	3	0	0
23	33822891	.	T	C	8	4	12	0	1	13	0	0
23	33837975	.	C	T	8	4	12	0	1	13	0	0
23	33837983	.	A	G	10	0	10	0	5	15	0	0
23	33852675	.	T	C	6	5	11	0	0	11	0	0
23	33873137	.	T	A	11	5	16	1	2	19	0	0
23	33873187	.	C	G	13	9	22	1	0	23	0	0
23	33887839	.	C	T	12	11	23	0	1	24	0	0
23	33892021	.	C	T	5	7	12	0	0	12	0	0
23	33901239	.	C	T	13	8	21	0	0	21	0	0
23	33901271	.	C	T	11	11	22	0	0	22	0	0
23	33907969	.	C	A	23	14	37	0	4	41	0	0
23	33907990	.	A	G	27	0	27	0	19	46	0	0
23	33918162	.	C	T	29	19	48	0	1	49	0	0
23	33920287	.	G	A	27	16	43	0	1	44	0	0
23	33920311	.	A	G	21	19	40	0	2	42	0	0
23	33920344	.	C	T	19	17	36	0	1	37	0	0
23	33920431	.	C	T	16	21	37	0	2	39	0	0
23	33923716	.	A	G	21	1	22	1	16	39	0	0
23	33926555	.	C	A	24	16	40	0	3	43	0	0
23	33926663	.	C	T	26	25	51	0	0	51	0	0
23	33927045	.	C	T	31	21	52	0	0	52	0	0
23	33927244	.	G	A	1	24	25	0	15	40	0	0
23	33927500	.	T	A	18	13	31	0	1	32	0	0
23	33927897	.	T	G	30	16	46	0	3	49	0	0
23	33927941	.	C	T	21	13	34	0	7	41	0	0
23	33935471	.	C	G	9	13	22	0	0	22	0	0
23	33935549	.	C	T	14	7	21	0	0	21	0	0
23	33942036	.	C	T	3	11	14	0	0	14	0	0
23	33944059	.	G	A	7	7	14	0	0	14	0	0
23	33944188	.	C	T	5	14	19	0	1	20	0	0
23	33944295	.	T	G	7	8	15	0	0	15	0	0
23	33944336	.	A	T	8	10	18	0	0	18	0	0
23	33944337	.	G	A	8	10	18	0	0	18	0	0
23	33944421	.	C	A	4	5	9	0	0	10	1	0
23	33974392	.	T	C	19	15	34	0	1	35	0	0
23	33974659	.	C	A	9	12	21	0	2	23	0	0
23	33974662	.	A	T	9	11	20	0	1	22	1	0
23	33974827	.	A	T	13	14	27	0	0	27	0	0
23	33974904	.	T	A	13	8	21	0	1	22	0	0
23	33975854	.	T	A	20	12	32	0	0	32	0	0
23	33975994	.	G	A	5	3	8	0	0	8	0	0
23	33978028	.	T	G	5	6	11	0	0	11	0	0
23	33978049	.	A	T	5	4	9	0	0	9	0	0
23	33978125	.	A	C	1	3	4	0	0	4	0	0
23	33978462	.	T	A	16	11	27	0	0	27	0	0
23	33978469	.	C	T	12	14	26	0	0	26	0	0
23	33978577	.	C	T	7	10	17	0	0	17	0	0
23	33978639	.	G	T	9	4	13	0	1	14	0	0
23	33978671	.	T	A	9	8	17	0	0	17	0	0
23	33983333	.	G	C	13	13	26	0	1	27	0	0
23	33984364	.	G	A	16	16	32	0	1	33	0	0
23	33987467	.	T	G	10	9	19	0	0	19	0	0
23	33987637	.	C	T	7	9	16	0	2	18	0	0
23	33991132	.	G	A	10	9	19	0	1	20	0	0
23	33991460	.	A	G	5	2	7	0	0	7	0	0
23	33993191	.	T	C	12	5	17	1	2	20	0	0
23	34005089	.	G	T	7	10	17	0	0	17	0	0
23	34005095	.	T	C	6	6	12	0	2	14	0	0
23	34035241	.	G	T	21	9	30	0	1	31	0	0
23	34035295	.	G	A	16	18	34	0	0	34	0	0
23	34035364	.	C	T	17	15	32	0	1	33	0	0
23	34036432	.	A	G	13	18	31	0	1	32	0	0
23	34038436	.	C	T	15	23	38	0	0	38	0	0
23	34042998	.	C	T	20	19	39	0	1	40	0	0
23	34043308	.	G	T	15	20	35	0	1	36	0	0
23	34043335	.	G	A	3	17	20	0	16	36	0	0
23	34043423	.	G	A	17	16	33	0	1	34	0	0
23	34043536	.	T	C	17	13	30	0	0	31	1	0
23	34043596	.	T	C	2	4	6	0	1	7	0	0
23	34047440	.	G	A	0	6	6	0	14	20	0	0
23	34110634	.	C	T	17	21	38	0	0	38	0	0
23	34136467	.	C	T	11	17	28	0	3	31	0	0
23	34384939	.	C	T	6	5	11	0	0	11	0	0
23	34385435	.	C	T	3	3	6	0	0	6	0	0
23	34385520	.	T	C	6	2	8	0	0	8	0	0
23	34385597	.	G	A	3	7	10	0	2	12	0	0
23	34385720	.	G	A	6	6	12	0	2	14	0	0
23	34386119	.	T	C	3	5	8	0	0	8	0	0
23	34559897	.	C	T	9	5	14	0	1	15	0	0
23	34559971	.	C	T	7	6	13	1	2	16	0	0
23	34641505	.	G	A	0	4	4	0	9	13	0	0
23	34658549	.	C	T	6	6	12	0	0	12	0	0
23	34659533	.	C	T	7	4	11	0	1	12	0	0
23	34678957	.	G	T	15	10	25	0	1	26	0	0
23	34679008	.	A	G	9	4	13	0	2	15	0	0
23	34696631	.	C	T	5	7	12	0	0	12	0	0
23	34710333	.	C	T	15	11	26	0	0	26	0	0
23	34726384	.	A	G	9	0	9	0	8	17	0	0
23	34726387	.	A	G	9	9	18	0	0	18	0	0
23	34726438	.	T	C	15	12	27	0	0	27	0	0
23	34726444	.	G	T	12	11	23	0	3	26	0	0
23	34732871	.	A	G	15	0	15	0	10	25	0	0
23	34748833	.	G	A	2	9	11	0	17	28	0	0
23	34753803	.	A	G	9	11	20	0	1	21	0	0
23	35027386	.	T	G	3	4	7	0	0	7	0	0
23	35027480	.	T	G	3	5	8	0	0	8	0	0
23	35027518	.	T	A	5	4	9	0	0	9	0	0
23	35027541	.	A	G	6	4	10	0	0	10	0	0
23	35027736	.	C	G	4	3	7	0	1	8	0	0
23	35039803	.	C	T	2	6	8	0	1	9	0	0
23	35052494	.	G	A	6	4	10	0	0	10	0	0
23	35187726	.	C	T	2	3	5	0	0	5	0	0
23	35187825	.	G	T	2	2	4	0	0	4	0	0
23	35187831	.	A	G	2	2	4	0	0	4	0	0
23	35192697	.	G	T	1	5	6	0	0	6	0	0
23	35256186	.	G	A	6	6	12	0	0	12	0	0
23	35310779	.	G	A	3	5	8	0	1	9	0	0
23	35362951	.	C	T	8	7	15	0	2	17	0	0
23	35362973	.	G	T	8	4	12	0	1	13	0	0
23	35363024	.	A	T	7	4	11	0	1	12	0	0
23	35363067	.	A	T	6	7	13	0	1	14	0	0
23	35363106	.	G	A	10	10	20	0	0	20	0	0
23	35363111	.	C	G	9	11	20	0	0	20	0	0
23	35363226	.	T	C	16	0	16	0	15	31	0	0
23	35363341	.	A	G	13	8	21	0	2	23	0	0
23	35369733	.	G	A	8	8	16	0	0	16	0	0
23	35376893	.	A	G	5	3	8	0	0	8	0	0
23	35382971	.	C	T	8	6	14	0	0	14	0	0
23	35386349	.	A	G	4	4	8	0	0	8	0	0
23	35386394	.	C	T	0	4	4	0	5	9	0	0
23	35386415	.	G	A	5	3	8	0	0	8	0	0
23	35386436	.	T	C	2	4	6	0	0	6	0	0
23	35389118	.	C	T	3	5	8	0	1	9	0	0
23	35393459	.	A	G	9	9	18	0	0	18	0	0
23	35393473	.	G	T	6	8	14	0	1	15	0	0
23	35394053	.	G	C	5	5	10	0	0	10	0	0
23	35396735	.	C	A	9	6	15	0	1	16	0	0
23	35396791	.	C	A	6	3	9	0	1	10	0	0
23	35469135	.	T	C	2	2	4	0	1	5	0	0
23	35469136	.	G	A	2	3	5	0	0	5	0	0
23	35469479	.	A	G	4	4	8	0	2	10	0	0
23	35469668	.	G	T	8	9	17	0	0	17	0	0
23	35479283	.	A	C	1	4	5	0	0	5	0	0
23	35479987	.	G	A	2	3	5	0	0	5	0	0
23	35537474	.	G	A	18	3	21	0	0	21	0	0
23	35537482	.	C	T	17	3	20	0	0	20	0	0
23	35537599	.	G	A	8	6	14	0	0	14	0	0
23	35537617	.	G	A	8	4	12	0	0	12	0	0
23	35537693	.	A	C	1	3	4	0	0	4	0	0
23	35642195	.	C	T	5	5	10	0	0	10	0	0
23	35642327	.	T	G	7	7	14	0	2	16	0	0
23	35644234	.	C	T	8	10	18	0	1	19	0	0
23	35651790	.	T	C	6	9	15	0	0	15	0	0
23	35661380	.	C	T	10	6	16	0	2	18	0	0
23	35661530	.	T	C	6	6	12	0	0	12	0	0
23	35661549	.	A	C	7	9	16	0	0	16	0	0
23	35661572	.	A	C	6	9	15	0	0	15	0	0
23	35661660	.	T	G	7	2	9	0	9	18	0	0
23	35661692	.	C	A	10	10	20	0	0	20	0	0
23	35661723	.	A	C	11	6	17	0	0	17	0	0
23	35663421	.	T	G	6	7	13	0	0	13	0	0
23	35664298	.	A	G	4	3	7	0	0	7	0	0
23	35664460	.	A	C	3	5	8	1	1	10	0	0
23	35691968	.	T	G	12	13	25	2	0	27	0	0
23	35691989	.	G	A	2	2	4	2	0	6	0	0
23	35710179	.	A	C	39	16	55	5	2	62	0	0
23	37287851	.	T	C	2	2	4	0	0	4	0	0
23	37467115	.	A	G	20	0	20	0	9	29	0	0
23	39634414	.	T	G	1	2	3	0	0	3	0	0
23	39634423	.	T	C	0	1	1	0	0	1	0	0
23	39757045	.	T	C	8	3	11	0	0	11	0	0
23	39758586	.	T	C	2	2	4	0	1	5	0	0
23	39758587	.	G	A	0	4	4	0	0	4	0	0
23	39930009	.	G	A	8	3	11	0	0	11	0	0
23	40437082	.	C	T	3	2	5	0	0	5	0	0
23	40452660	.	A	T	15	8	23	0	1	24	0	0
23	40452667	.	T	C	15	8	23	0	0	23	0	0
23	40452735	.	G	T	16	9	25	0	1	26	0	0
23	40452739	.	G	C	2	10	12	0	15	27	0	0
23	40452793	.	A	G	9	10	19	0	1	20	0	0
23	40460860	.	G	C	8	14	22	0	1	23	0	0
23	40462004	.	A	G	8	7	15	0	0	15	0	0
23	40462538	.	G	A	16	9	25	0	1	26	0	0
23	40466320	.	C	T	10	17	27	0	0	27	0	0
23	40466623	.	C	G	11	11	22	0	0	22	0	0
23	40466714	.	T	A	11	11	22	0	1	23	0	0
23	40471963	.	G	A	1	13	14	0	14	28	0	0
23	40472068	.	A	G	12	0	12	0	12	24	0	0
23	40480255	.	C	A	16	9	25	0	0	25	0	0
23	40480263	.	C	T	13	10	23	0	0	23	0	0
23	40526326	.	T	C	4	0	4	0	3	7	0	0
23	40526562	.	T	C	3	5	8	0	0	8	0	0
23	40526705	.	T	C	6	1	7	3	0	10	0	0
23	40526713	.	T	C	6	2	8	3	0	11	0	0
23	40526821	.	A	T	8	9	17	1	0	18	0	0
23	40526826	.	T	C	5	8	13	1	4	18	0	0
23	40526883	.	T	G	8	4	12	1	0	13	0	0
23	40527359	.	T	C	4	0	4	0	4	8	0	0
23	40527556	.	C	G	4	3	7	2	0	9	0	0
23	40527583	.	G	A	5	3	8	3	0	11	0	0
23	40527608	.	T	C	5	3	8	5	0	13	0	0
23	40527632	.	G	A	6	3	9	5	0	14	0	0
23	40527653	.	T	G	6	6	12	3	0	15	0	0
23	40527759	.	G	T	10	6	16	1	0	17	0	0
23	40527787	.	A	T	5	3	8	1	0	9	0	0
23	40528182	.	T	C	5	1	6	0	6	12	0	0
23	40528209	.	C	T	11	4	15	0	0	15	0	0
23	40528226	.	G	C	9	4	13	2	1	16	0	0
23	40528267	.	T	C	4	3	7	3	1	11	0	0
23	40528397	.	A	G	8	5	13	0	0	13	0	0
23	40528427	.	C	T	9	2	11	0	2	13	0	0
23	40528669	.	C	T	2	8	10	0	14	24	0	0
23	40528727	.	G	A	14	15	29	0	1	30	0	0
23	40528886	.	T	A	11	13	24	0	2	26	0	0
23	40528998	.	G	A	18	12	30	0	0	30	0	0
23	40529137	.	T	C	8	13	21	0	0	21	0	0
23	40529288	.	T	C	9	13	22	0	0	22	0	0
23	40529318	.	A	G	11	14	25	0	0	25	0	0
23	40529693	.	T	C	7	11	18	0	1	19	0	0
23	40529708	.	T	C	9	9	18	0	2	20	0	0
23	40529747	.	G	A	8	7	15	0	1	16	0	0
23	40605139	.	G	C	5	3	8	0	0	8	0	0
23	40605155	.	T	C	3	4	7	0	0	7	0	0
23	40605193	.	A	T	2	6	8	0	1	9	0	0
23	40605223	.	T	A	4	5	9	0	0	9	0	0
23	40605234	.	A	G	5	3	8	0	0	8	0	0
23	40605356	.	C	T	2	6	8	0	0	8	0	0
23	40655395	.	T	G	5	6	11	0	0	11	0	0
23	40655425	.	A	G	3	7	10	0	0	10	0	0
23	40709924	.	A	G	6	0	6	0	8	14	0	0
23	40709943	.	A	G	5	0	5	0	4	9	0	0
23	40731713	.	G	A	0	3	3	0	3	6	0	0
23	40731757	.	A	G	3	2	5	0	0	5	0	0
23	40738428	.	T	C	4	5	9	0	0	9	0	0
23	40738508	.	A	G	3	7	10	0	0	10	0	0
23	40741673	.	A	G	10	3	13	0	0	13	0	0
23	40741765	.	C	T	6	2	8	0	0	8	0	0
23	40742133	.	G	C	7	14	21	0	0	21	0	0
23	40742145	.	A	G	7	0	7	0	11	18	0	0
23	40742234	.	C	A	7	8	15	0	1	16	0	0
23	40761073	.	T	A	7	7	14	0	0	14	0	0
23	40761326	.	T	A	11	6	17	0	0	17	0	0
23	40876907	.	G	T	1	5	6	0	0	6	0	0
23	40895018	.	A	G	1	2	3	0	0	3	0	0
23	40937532	.	T	C	6	3	9	0	0	9	0	0
23	40951613	.	A	G	5	2	7	0	0	7	0	0
23	40972208	.	C	T	17	5	22	0	0	22	0	0
23	40987369	.	G	A	5	3	8	0	2	10	0	0
23	41021803	.	C	T	1	2	3	0	0	3	0	0
23	41021805	.	G	C	0	2	2	0	1	3	0	0
23	41198801	.	C	T	4	3	7	0	0	7	0	0
23	41224850	.	T	C	1	3	4	0	0	4	0	0
23	41225006	.	A	G	2	0	2	0	3	5	0	0
23	41225159	.	C	A	1	3	4	0	0	4	0	0
23	41225162	.	T	C	1	3	4	0	0	4	0	0
23	41225825	.	C	G	3	0	3	0	4	7	0	0
23	41227146	.	C	G	5	0	5	0	4	9	0	0
23	41228876	.	G	A	0	1	1	0	2	3	0	0
23	41228903	.	T	G	2	2	4	0	0	4	0	0
23	41229119	.	C	T	1	4	5	0	0	5	0	0
23	41229152	.	C	T	1	2	3	0	0	3	0	0
23	41313116	.	G	C	7	11	18	0	0	18	0	0
23	41320957	.	G	A	7	10	17	0	0	17	0	0
23	41334628	.	T	C	4	4	8	0	1	9	0	0
23	41346686	.	G	A	5	4	9	0	0	9	0	0
23	41381026	.	A	C	6	3	9	0	0	9	0	0
23	41431885	.	C	T	2	3	5	0	0	5	0	0
23	41739874	.	C	A	4	6	10	0	0	10	0	0
23	41739952	.	G	A	4	3	7	0	0	7	0	0
23	41754587	.	A	G	3	10	13	0	0	13	0	0
23	41799849	.	C	A	12	4	16	0	0	16	0	0
23	41800953	.	T	C	2	2	4	0	0	4	0	0
23	41801492	.	C	T	18	7	25	0	0	25	0	0
23	41801555	.	G	A	11	15	26	0	0	26	0	0
23	41801940	.	G	T	12	15	27	0	0	27	0	0
23	41802130	.	T	G	5	13	18	0	0	18	0	0
23	41802198	.	C	G	6	0	6	0	2	8	0	0
23	41802205	.	T	A	6	2	8	0	0	8	0	0
23	41803017	.	G	A	3	6	9	0	1	10	0	0
23	41803124	.	G	T	3	7	10	0	0	10	0	0
23	41803160	.	C	T	9	5	14	0	0	14	0	0
23	41803217	.	T	C	7	0	7	0	10	17	0	0
23	41803447	.	G	A	2	13	15	0	0	15	0	0
23	41803473	.	A	G	5	7	12	0	1	13	0	0
23	41803643	.	G	C	2	4	6	0	0	6	0	0
23	41803672	.	C	T	1	5	6	0	0	6	0	0
23	41803740	.	A	G	3	5	8	0	0	8	0	0
23	41804039	.	A	G	2	7	9	0	2	11	0	0
23	41804070	.	C	T	0	5	5	0	4	9	0	0
23	41804202	.	T	A	3	4	7	0	0	7	0	0
23	41804518	.	A	C	7	3	10	0	0	10	0	0
23	41804600	.	T	A	4	8	12	0	0	12	0	0
23	41804776	.	G	C	1	5	6	0	0	6	0	0
23	41804779	.	A	T	1	5	6	0	0	6	0	0
23	41804934	.	A	C	3	0	3	0	7	10	0	0
23	41805158	.	C	T	6	5	11	0	0	11	0	0
23	41805348	.	G	A	5	8	13	0	2	15	0	0
23	41821117	.	G	C	2	6	8	0	1	9	0	0
23	41831305	.	T	A	18	18	36	0	0	36	0	0
23	41831306	.	C	T	15	18	33	0	2	35	0	0
23	41839373	.	G	A	0	15	15	0	10	25	0	0
23	41853782	.	T	C	10	10	20	0	0	20	0	0
23	41853876	.	T	C	4	10	14	0	1	15	0	0
23	41853892	.	A	T	3	10	13	0	1	14	0	0
23	41854025	.	C	A	17	5	22	0	0	22	0	0
23	41854030	.	C	A	16	5	21	0	0	22	1	0
23	41854068	.	G	T	12	10	22	0	0	22	0	0
23	41949602	.	T	G	5	2	7	0	0	7	0	0
23	41964709	.	G	A	3	4	7	0	0	7	0	0
23	41965438	.	G	A	2	2	4	0	0	4	0	0
23	41976923	.	C	T	4	4	8	0	0	8	0	0
23	42000700	.	C	T	0	4	4	0	1	5	0	0
23	42131924	.	G	A	0	3	3	0	3	6	0	0
23	42641688	.	A	G	5	4	9	0	0	9	0	0
23	42642211	.	A	C	4	3	7	0	11	18	0	0
23	43508528	.	A	G	1	0	1	0	5	6	0	0
23	43513159	.	T	G	2	0	2	0	3	5	0	0
23	43517458	.	A	G	3	3	6	0	1	7	0	0
23	43519354	.	C	G	2	5	7	0	1	8	0	0
23	43519414	.	G	A	3	4	7	0	0	7	0	0
23	43530633	.	T	C	1	3	4	0	1	5	0	0
23	43530699	.	A	G	3	3	6	0	0	6	0	0
23	43530703	.	T	C	3	3	6	0	0	6	0	0
23	43539272	.	A	G	5	3	8	0	0	8	0	0
23	43539296	.	G	T	4	5	9	0	0	9	0	0
23	43543158	.	A	G	3	3	6	0	1	7	0	0
23	43543197	.	A	G	2	4	6	0	0	6	0	0
23	43544974	.	A	G	4	3	7	0	0	7	0	0
23	43556499	.	A	G	2	3	5	0	0	5	0	0
23	43576550	.	A	G	5	4	9	0	0	9	0	0
23	43595811	.	C	G	4	2	6	0	0	6	0	0
23	43649431	.	T	C	1	3	4	0	1	5	0	0
23	43652306	.	G	C	10	5	15	0	0	15	0	0
23	43652901	.	C	G	4	2	6	0	0	6	0	0
23	43686266	.	G	A	1	3	4	0	0	4	0	0
23	43688291	.	T	C	5	5	10	0	0	10	0	0
23	43688361	.	A	T	6	8	14	0	0	14	0	0
23	43688364	.	A	T	3	8	11	0	3	14	0	0
23	43688409	.	A	T	5	9	14	0	1	15	0	0
23	43688852	.	C	G	6	6	12	0	0	12	0	0
23	43688959	.	C	G	3	5	8	0	0	8	0	0
23	43689621	.	C	G	7	0	7	0	7	14	0	0
23	43689675	.	T	C	2	2	4	0	1	5	0	0
23	43690361	.	T	C	2	4	6	0	1	7	0	0
23	43690490	.	A	G	3	4	7	0	1	8	0	0
23	43690622	.	G	C	2	4	6	0	0	6	0	0
23	43690625	.	T	G	2	3	5	0	0	5	0	0
23	43690715	.	T	C	2	6	8	0	0	8	0	0
23	43690762	.	C	A	2	6	8	0	0	8	0	0
23	43690838	.	A	G	1	3	4	0	0	4	0	0
23	43690913	.	T	G	2	4	6	0	0	6	0	0
23	43691515	.	C	T	1	2	3	0	0	3	0	0
23	43691528	.	C	T	1	2	3	0	0	3	0	0
23	43695927	.	C	A	1	7	8	0	6	14	0	0
23	43695956	.	C	T	1	11	12	0	7	19	0	0
23	43696355	.	G	A	13	25	38	0	2	40	0	0
23	43699846	.	A	G	27	19	46	0	1	47	0	0
23	43700064	.	T	C	12	0	12	0	21	33	0	0
23	43700082	.	C	G	10	19	29	0	0	29	0	0
23	43700114	.	G	A	5	17	22	0	1	23	0	0
23	43700121	.	G	A	8	15	23	0	1	24	0	0
23	43705961	.	G	T	21	24	45	0	2	47	0	0
23	43706003	.	A	G	16	25	41	0	0	41	0	0
23	43706102	.	T	G	16	18	34	0	0	34	0	0
23	43707165	.	C	T	13	18	31	0	1	32	0	0
23	43718042	.	C	A	7	5	12	0	1	13	0	0
23	43723615	.	G	A	7	5	12	0	0	12	0	0
23	43770583	.	C	A	12	10	22	0	1	23	0	0
23	43770667	.	A	G	12	0	12	0	11	23	0	0
23	43770682	.	T	C	12	10	22	0	0	22	0	0
23	43770715	.	C	T	7	10	17	0	1	18	0	0
23	43770832	.	T	C	7	12	19	0	1	20	0	0
23	43778396	.	T	G	8	14	22	0	2	24	0	0
23	43780214	.	C	T	10	7	17	0	1	18	0	0
23	43781781	.	C	T	6	10	16	0	1	17	0	0
23	43784587	.	T	C	11	4	15	1	4	20	0	0
23	43784985	.	C	T	8	10	18	0	1	19	0	0
23	43799463	.	T	C	1	6	7	0	0	7	0	0
23	43799542	.	G	C	3	3	6	0	0	6	0	0
23	43799598	.	G	C	0	4	4	0	4	8	0	0
23	43799634	.	A	G	4	0	4	0	4	8	0	0
23	43799798	.	A	C	2	2	4	0	0	4	0	0
23	43800214	.	T	A	2	3	5	0	0	5	0	0
23	43800594	.	C	T	1	3	4	0	0	4	0	0
23	43800621	.	G	C	0	3	3	0	2	5	0	0
23	43800684	.	G	A	1	4	5	0	2	7	0	0
23	43800701	.	T	C	2	3	5	0	0	5	0	0
23	43800723	.	G	A	0	3	3	0	1	4	0	0
23	43800968	.	T	G	2	2	4	0	0	4	0	0
23	43800983	.	G	A	3	2	5	0	0	5	0	0
23	43801090	.	A	C	2	4	6	0	0	6	0	0
23	43801284	.	C	G	4	3	7	0	0	7	0	0
23	43801408	.	A	T	4	2	6	0	0	6	0	0
23	43830005	.	T	G	2	2	4	0	0	4	0	0
23	43830408	.	C	T	1	2	3	0	0	3	0	0
23	43830412	.	T	C	1	2	3	0	0	3	0	0
23	43876103	.	C	A	5	3	8	0	0	8	0	0
23	43876109	.	T	A	5	3	8	0	0	8	0	0
23	43876158	.	A	C	3	5	8	0	0	8	0	0
23	43876163	.	T	G	4	0	4	0	4	8	0	0
23	43889641	.	T	C	4	2	6	0	0	6	0	0
23	43898075	.	C	T	2	4	6	0	0	6	0	0
23	43898097	.	A	C	4	3	7	0	0	7	0	0
23	43928824	.	A	G	1	2	3	0	1	4	0	0
23	43971368	.	G	A	3	3	6	0	2	8	0	0
23	43977921	.	C	T	1	8	9	0	0	9	0	0
23	43989294	.	C	T	1	3	4	0	0	4	0	0
23	44090326	.	T	A	20	13	33	0	0	33	0	0
23	44092839	.	T	A	23	21	44	0	2	46	0	0
23	44096060	.	A	G	20	0	20	0	12	32	0	0
23	44098511	.	A	G	26	11	37	0	3	40	0	0
23	44098517	.	C	T	22	12	34	0	1	35	0	0
23	44102199	.	G	T	19	14	33	0	2	35	0	0
23	44106540	.	C	T	32	19	51	0	1	52	0	0
23	44106591	.	G	C	26	26	52	0	0	52	0	0
23	44106860	.	G	A	9	6	15	1	17	34	1	0
23	44107138	.	C	T	8	12	20	0	1	21	0	0
23	44142820	.	C	T	2	2	4	0	0	4	0	0
23	44216008	.	C	A	0	3	3	0	6	9	0	0
23	44216026	.	C	T	1	6	7	0	0	7	0	0
23	44236361	.	G	T	9	9	18	0	1	19	0	0
23	44236388	.	A	T	6	5	11	0	1	12	0	0
23	44236561	.	G	A	4	7	11	0	0	11	0	0
23	44236673	.	C	T	5	7	12	0	1	13	0	0
23	44236750	.	T	A	5	6	11	0	0	11	0	0
23	44236939	.	G	A	0	8	8	0	9	17	0	0
23	44236946	.	C	T	7	10	17	0	0	17	0	0
23	44237029	.	T	C	6	8	14	0	0	14	0	0
23	44237030	.	A	G	6	0	6	0	8	14	0	0
23	44237065	.	A	C	7	4	11	0	0	11	0	0
23	44237068	.	A	G	6	4	10	0	1	11	0	0
23	44237158	.	A	C	16	7	23	0	1	24	0	0
23	44237416	.	T	C	9	9	18	0	0	18	0	0
23	44237531	.	G	T	10	10	20	0	0	20	0	0
23	44237611	.	G	C	1	18	19	0	14	33	0	0
23	44237701	.	C	A	21	13	34	0	0	34	0	0
23	44238125	.	G	T	9	9	18	0	1	19	0	0
23	44238186	.	C	T	11	7	18	0	1	19	0	0
23	44242535	.	A	C	7	14	21	0	0	21	0	0
23	44242608	.	T	C	8	11	19	0	2	21	0	0
23	44250638	.	A	G	3	0	3	0	6	9	0	0
23	44250702	.	C	A	7	6	13	0	0	13	0	0
23	44250736	.	C	T	8	8	16	0	0	16	0	0
23	44308088	.	G	A	18	17	35	0	1	36	0	0
23	44312611	.	G	A	0	8	8	1	18	27	0	0
23	44313190	.	G	C	14	13	27	0	1	28	0	0
23	44328488	.	G	A	27	19	46	1	2	49	0	0
23	44328557	.	C	T	24	18	42	0	2	44	0	0
23	44332614	.	C	T	24	18	42	0	4	46	0	0
23	44332617	.	C	T	19	23	42	0	4	46	0	0
23	44332675	.	C	T	19	15	34	2	2	38	0	0
23	44400965	.	C	T	3	3	6	0	0	6	0	0
23	44428067	.	A	C	14	19	33	0	1	34	0	0
23	44430544	.	C	T	17	15	32	0	1	33	0	0
23	44432608	.	C	T	12	14	26	0	2	28	0	0
23	44440489	.	C	T	6	17	23	0	0	23	0	0
23	44478131	.	A	G	15	12	27	0	2	29	0	0
23	44487465	.	C	G	13	10	23	0	2	25	0	0
23	44487521	.	A	G	16	4	20	0	1	21	0	0
23	44489428	.	A	C	7	0	7	0	10	17	0	0
23	44489449	.	C	T	0	5	5	0	12	17	0	0
23	44515717	.	C	T	4	2	6	0	0	6	0	0
23	44515735	.	T	A	3	4	7	0	0	7	0	0
23	44515822	.	C	T	4	3	7	0	0	7	0	0
23	44516266	.	T	A	1	2	3	0	0	3	0	0
23	44516711	.	G	A	1	2	3	0	0	3	0	0
23	44516713	.	C	T	1	2	3	0	0	3	0	0
23	44516756	.	G	A	2	3	5	0	0	5	0	0
23	44517484	.	A	T	1	2	3	0	1	4	0	0
23	44517792	.	C	A	4	2	6	0	0	6	0	0
23	44518479	.	G	A	1	6	7	0	0	7	0	0
23	44518668	.	A	T	1	3	4	0	1	5	0	0
23	44518752	.	C	T	3	2	5	0	0	5	0	0
23	44519381	.	T	G	1	0	1	0	5	6	0	0
23	44521264	.	A	T	9	3	12	0	0	12	0	0
23	44521330	.	A	G	5	7	12	0	1	13	0	0
23	44521495	.	G	A	4	4	8	0	0	8	0	0
23	44521516	.	A	C	3	4	7	0	0	7	0	0
23	44521676	.	C	T	3	4	7	0	0	7	0	0
23	44550446	.	G	A	11	5	16	0	0	16	0	0
23	44599045	.	G	A	0	2	2	0	1	3	0	0
23	44603710	.	T	C	16	25	41	0	1	42	0	0
23	44603912	.	G	A	13	7	20	0	0	20	0	0
23	44603990	.	C	G	6	10	16	0	0	16	0	0
23	44617600	.	T	C	3	5	8	0	2	10	0	0
23	44620750	.	C	T	11	10	21	0	1	22	0	0
23	44620911	.	C	T	10	6	16	0	0	16	0	0
23	44621684	.	C	A	15	9	24	0	0	24	0	0
23	44621690	.	C	A	13	9	22	0	0	22	0	0
23	44622736	.	T	C	12	13	25	0	2	27	0	0
23	44652616	.	C	A	4	3	7	0	0	7	0	0
23	44653647	.	A	G	1	0	1	0	4	5	0	0
23	44732976	.	G	A	39	22	61	0	5	66	0	0
23	44755296	.	T	C	32	37	69	0	3	72	0	0
23	44761680	.	G	C	22	25	47	0	3	50	0	0
23	44762190	.	T	C	24	41	65	1	1	67	0	0
23	44844111	.	T	A	1	5	6	0	0	6	0	0
23	44850211	.	A	T	3	2	5	0	0	5	0	0
23	44850274	.	G	A	4	2	6	0	0	6	0	0
23	44858858	.	C	T	4	7	11	0	0	11	0	0
23	44858903	.	G	A	4	6	10	0	0	10	0	0
23	44861891	.	T	A	1	4	5	0	1	6	0	0
23	44861899	.	A	G	2	5	7	0	0	7	0	0
23	44862985	.	G	A	3	3	6	0	1	7	0	0
23	44863907	.	C	T	0	4	4	0	3	7	0	0
23	44975073	.	G	A	7	3	10	0	0	10	0	0
23	44975079	.	G	T	8	4	12	0	0	12	0	0
23	44985727	.	A	T	2	4	6	0	0	6	0	0
23	44991467	.	T	A	5	4	9	0	0	9	0	0
23	44991476	.	T	C	4	0	4	0	3	7	0	0
23	44991504	.	A	G	3	2	5	0	0	5	0	0
23	44995892	.	C	G	4	3	7	0	0	7	0	0
23	44999663	.	A	C	2	3	5	0	1	6	0	0
23	45017066	.	C	A	0	4	4	0	1	5	0	0
23	45018662	.	G	A	3	2	5	0	0	5	0	0
23	45025952	.	A	G	12	22	34	1	0	35	0	0
23	45027911	.	C	T	29	24	53	0	0	53	0	0
23	45028191	.	T	C	29	19	48	0	0	48	0	0
23	45028248	.	C	T	28	24	52	0	4	56	0	0
23	45043654	.	G	A	10	6	16	0	0	16	0	0
23	46208578	.	T	G	13	14	27	0	1	28	0	0
23	46208611	.	T	G	14	20	34	0	1	35	0	0
23	46208718	.	G	A	17	19	36	0	1	37	0	0
23	46210225	.	C	T	2	2	4	0	0	4	0	0
23	46217045	.	C	A	19	23	42	0	0	42	0	0
24	187643	.	A	G	15	12	27	0	1	28	0	0
24	187757	.	A	G	14	6	20	0	0	20	0	0
24	187946	.	A	G	5	4	9	0	1	10	0	0
24	187971	.	A	G	2	5	7	0	0	7	0	0
24	188199	.	A	G	13	4	17	0	0	17	0	0
24	786351	.	A	G	2	2	4	0	0	4	0	0
24	788327	.	A	G	5	5	10	0	0	10	0	0
24	945877	.	A	G	14	2	16	0	1	17	0	0
24	945880	.	A	G	15	2	17	0	0	17	0	0
24	985258	.	T	G	7	10	17	0	0	17	0	0
24	1119044	.	A	G	3	1	4	0	0	4	0	0
24	2893407	.	C	A	1	5	6	0	0	6	0	0
24	3470405	.	T	C	6	6	12	0	0	12	0	0
24	3471477	.	T	C	6	5	11	0	0	11	0	0
24	6018727	.	C	T	1	6	7	0	0	7	0	0
24	7306440	.	C	A	14	2	16	0	1	17	0	0
24	7306441	.	A	G	14	2	16	0	1	17	0	0
24	8861521	.	G	C	4	5	9	1	0	10	0	0
24	8861555	.	T	C	4	2	6	0	0	6	0	0
24	8861687	.	A	G	5	3	8	0	0	8	0	0
24	8861821	.	A	G	5	3	8	0	0	8	0	0
24	8861996	.	A	G	6	2	8	0	0	8	0	0
24	8862053	.	G	A	5	2	7	0	0	7	0	0
24	8862242	.	T	C	6	0	6	0	2	8	0	0
24	8862262	.	T	A	4	2	6	0	0	6	0	0
24	8862434	.	C	T	1	6	7	1	5	13	0	0
24	8862438	.	C	A	6	4	10	1	1	12	0	0
24	8862896	.	T	C	2	3	5	0	0	5	0	0
24	8863029	.	G	A	4	4	8	0	0	8	0	0
24	8863082	.	A	G	2	7	9	0	1	10	0	0
24	8864099	.	A	T	1	2	3	0	0	3	0	0
24	8865645	.	T	G	1	3	4	0	1	5	0	0
24	8904718	.	C	T	4	4	8	0	0	8	0	0
24	8906130	.	A	T	4	2	6	0	2	8	0	0
24	8968808	.	G	A	1	14	15	0	9	24	0	0
24	8979615	.	C	G	2	2	4	0	0	4	0	0
24	8979618	.	G	A	2	3	5	0	0	5	0	0
24	8979708	.	C	T	2	5	7	0	14	21	0	0
24	8979917	.	G	A	6	4	10	0	1	11	0	0
24	8979937	.	G	A	5	5	10	0	0	10	0	0
24	8988945	.	G	C	6	2	8	0	14	22	0	0
24	9001888	.	T	C	3	0	3	0	4	7	0	0
24	9162766	.	G	A	4	3	7	0	0	7	0	0
24	9163246	.	A	C	1	2	3	0	0	3	0	0
24	9163528	.	T	C	1	3	4	0	0	4	0	0
24	9178093	.	C	T	8	3	11	0	0	11	0	0
24	9250601	.	C	T	4	3	7	0	1	8	0	0
24	9260452	.	A	C	7	4	11	0	0	11	0	0
24	9265777	.	T	C	3	2	5	0	0	5	0	0
24	9267967	.	A	T	4	4	8	0	1	9	0	0
24	9269953	.	G	A	1	3	4	0	2	6	0	0
24	9270074	.	G	A	4	4	8	0	0	8	0	0
24	9288889	.	G	T	20	16	36	0	2	38	0	0
24	9293831	.	A	G	13	13	26	0	0	26	0	0
24	9298312	.	G	A	2	2	4	0	0	4	0	0
24	9298678	.	T	A	1	3	4	0	0	4	0	0
24	9299325	.	T	C	1	2	3	0	0	3	0	0
24	9299466	.	T	C	2	3	5	0	0	5	0	0
24	9299542	.	G	A	1	3	4	0	0	4	0	0
24	9619638	.	A	C	1	3	4	0	0	4	0	0
24	9661219	.	T	C	2	2	4	0	0	4	0	0
24	9661225	.	G	A	3	2	5	0	0	5	0	0
24	9676144	.	T	C	13	11	24	0	1	25	0	0
24	9683072	.	G	A	7	5	12	1	1	14	0	0
24	9683376	.	A	G	11	6	17	0	0	17	0	0
24	9689613	.	G	T	6	6	12	0	0	12	0	0
24	9694121	.	C	T	1	2	3	0	0	3	0	0
24	9702183	.	T	G	1	2	3	0	0	3	0	0
24	9702207	.	A	T	1	2	3	0	0	3	0	0
24	9706655	.	C	T	3	3	6	0	0	6	0	0
24	9706900	.	C	A	2	2	4	0	0	4	0	0
24	9706939	.	T	C	1	4	5	0	0	5	0	0
24	9706946	.	C	T	1	3	4	0	0	4	0	0
24	9707007	.	G	C	5	3	8	0	0	8	0	0
24	9708544	.	A	C	7	3	10	0	1	11	0	0
24	9708851	.	C	G	1	3	4	0	0	4	0	0
24	9717383	.	C	T	3	2	5	0	1	6	0	0
24	9724925	.	A	G	1	7	8	0	0	8	0	0
24	9725084	.	C	G	2	3	5	0	0	5	0	0
24	9726828	.	C	G	4	2	6	0	0	6	0	0
24	9729835	.	T	C	5	2	7	0	1	8	0	0
24	9730098	.	G	A	3	2	5	0	0	5	0	0
24	9732066	.	T	A	3	2	5	0	0	5	0	0
24	9734938	.	G	A	3	2	5	0	0	5	0	0
24	9744227	.	G	A	3	9	12	0	1	13	0	0
24	9744236	.	G	A	0	11	11	0	6	17	0	0
24	9746304	.	C	T	5	3	8	0	0	8	0	0
24	9746370	.	T	A	5	3	8	0	0	8	0	0
24	9865836	.	G	A	3	15	18	0	15	33	0	0
24	9866192	.	A	T	12	8	20	0	1	21	0	0
24	9866270	.	G	A	9	11	20	0	1	21	0	0
24	9866562	.	A	T	14	15	29	0	0	29	0	0
24	9866623	.	G	T	12	9	21	0	0	21	0	0
24	9866721	.	C	T	11	8	19	0	3	22	0	0
24	9867105	.	T	A	10	12	22	0	0	22	0	0
24	10237360	.	C	T	4	2	6	0	0	6	0	0
24	10270447	.	T	C	4	3	7	0	0	7	0	0
24	10309244	.	G	A	3	4	7	0	0	7	0	0
24	10309382	.	T	C	4	4	8	0	0	8	0	0
24	10309611	.	G	T	5	5	10	0	0	10	0	0
24	10314437	.	T	A	1	3	4	0	0	4	0	0
24	10319239	.	G	C	0	3	3	0	6	9	0	0
24	10319270	.	G	A	4	3	7	0	0	7	0	0
24	10319304	.	C	A	2	3	5	0	0	5	0	0
24	10319320	.	C	A	4	3	7	0	0	7	0	0
24	10323410	.	T	C	1	5	6	0	0	6	0	0
24	10323570	.	T	C	2	4	6	0	0	6	0	0
24	10332172	.	C	T	4	3	7	0	0	7	0	0
24	10332212	.	G	A	2	2	4	0	0	4	0	0
24	10338272	.	C	T	4	5	9	0	0	9	0	0
24	10344333	.	C	G	6	2	8	0	0	8	0	0
24	10349671	.	C	T	1	3	4	0	1	5	0	0
24	10349818	.	G	A	2	6	8	0	0	8	0	0
24	10349898	.	T	C	1	5	6	0	1	7	0	0
24	10350089	.	T	A	6	3	9	0	0	9	0	0
24	10350135	.	A	T	4	3	7	0	0	7	0	0
24	10356563	.	G	A	3	6	9	0	0	9	0	0
24	10356592	.	T	C	3	6	9	0	0	9	0	0
24	10356617	.	G	A	3	6	9	0	0	9	0	0
24	10368855	.	G	A	5	3	8	0	1	9	0	0
24	10376840	.	G	A	5	2	7	0	0	7	0	0
24	10376984	.	G	A	1	2	3	0	0	3	0	0
24	10376990	.	T	C	1	2	3	0	0	3	0	0
24	10393951	.	C	G	3	6	9	0	0	9	0	0
24	10393979	.	G	T	3	6	9	0	0	9	0	0
24	10393995	.	A	C	6	6	12	0	0	12	0	0
24	10394224	.	G	A	1	7	8	0	0	8	0	0
24	10413706	.	T	C	7	4	11	0	0	11	0	0
24	10414439	.	G	T	2	2	4	0	2	6	0	0
24	10415193	.	A	G	8	12	20	0	1	21	0	0
24	10415424	.	A	C	18	8	26	0	0	26	0	0
24	10415487	.	G	A	0	13	13	0	8	21	0	0
24	10828512	.	A	G	15	10	25	0	0	25	0	0
24	10897254	.	G	A	8	17	25	0	0	25	0	0
24	10897340	.	C	A	3	4	7	1	0	8	0	0
24	10901696	.	C	G	20	27	47	0	2	49	0	0
24	10901759	.	G	T	26	15	41	0	1	42	0	0
24	10901946	.	C	T	18	9	27	0	0	27	0	0
24	10902065	.	T	G	9	10	19	0	2	21	0	0
24	10902268	.	G	A	10	13	23	0	1	24	0	0
24	10902688	.	G	A	23	14	37	0	1	38	0	0
24	10907000	.	T	C	18	20	38	0	0	38	0	0
24	10907473	.	C	T	18	22	40	0	3	43	0	0
24	10907587	.	G	T	23	20	43	0	2	45	0	0
24	10915813	.	A	G	22	25	47	0	1	48	0	0
24	10917040	.	C	T	23	18	41	0	2	43	0	0
24	10917046	.	C	T	1	15	16	0	25	41	0	0
24	10917238	.	C	T	17	12	29	0	1	31	1	0
24	10919519	.	A	G	13	6	19	0	0	19	0	0
24	10919563	.	G	T	17	8	25	0	1	26	0	0
24	10924880	.	C	T	11	21	32	0	2	34	0	0
24	10924912	.	C	T	15	18	33	0	1	34	0	0
24	10924930	.	T	A	13	15	28	0	2	30	0	0
24	10944579	.	T	A	15	12	27	0	0	27	0	0
24	10961510	.	T	C	9	10	19	0	0	19	0	0
24	10971127	.	C	T	5	10	15	0	1	16	0	0
24	10971160	.	G	A	7	8	15	0	0	15	0	0
24	11062559	.	C	T	1	2	3	0	0	3	0	0
24	11113152	.	T	C	12	12	24	0	0	24	0	0
24	11821479	.	A	T	1	2	3	0	0	3	0	0
24	11889107	.	T	C	7	3	10	0	0	10	0	0
24	11889164	.	T	C	2	2	4	0	0	4	0	0
24	11889528	.	T	C	6	2	8	0	0	8	0	0
24	11889579	.	T	C	4	5	9	0	0	9	0	0
24	14443136	.	C	T	6	3	9	0	0	9	0	0
24	14567055	.	T	A	1	2	3	0	0	3	0	0
24	17214629	.	T	C	13	12	25	1	2	28	0	0
24	17215855	.	C	T	1	2	3	0	2	5	0	0
24	18521384	.	T	A	3	3	6	0	1	7	0	0
24	19373816	.	A	T	5	6	11	0	0	11	0	0
24	19656939	.	G	A	1	1	2	0	5	7	0	0
24	19687567	.	C	T	2	3	5	0	0	5	0	0
24	19692822	.	C	A	6	4	10	0	1	11	0	0
24	19692828	.	G	A	0	5	5	0	7	12	0	0
24	19696794	.	C	G	7	3	10	0	0	10	0	0
24	19697387	.	A	G	5	3	8	0	1	9	0	0
24	19707838	.	G	A	16	18	34	0	1	35	0	0
24	19711455	.	A	G	17	8	25	0	0	25	0	0
24	19711576	.	G	T	15	18	33	0	0	33	0	0
24	19719122	.	G	A	16	17	33	0	0	33	0	0
24	19719189	.	G	T	6	12	18	0	0	18	0	0
24	20064232	.	G	A	7	5	12	0	0	12	0	0
24	20064988	.	A	C	5	2	7	0	0	7	0	0
24	20065268	.	T	C	3	3	6	0	0	6	0	0
24	20065553	.	C	T	1	1	2	0	1	3	0	0
24	20065688	.	T	A	2	2	4	0	1	5	0	0
24	20066111	.	G	T	5	4	9	0	0	11	2	0
24	20066116	.	T	C	6	3	9	0	1	10	0	0
24	20082836	.	C	T	0	4	4	0	8	12	0	0
24	20082881	.	T	C	6	5	11	0	0	11	0	0
24	20082944	.	G	A	3	6	9	0	1	10	0	0
24	20192868	.	A	G	0	1	1	0	2	3	0	0
24	20192873	.	A	C	2	2	4	0	0	4	0	0
24	20199122	.	A	C	1	6	7	0	0	7	0	0
24	20200528	.	A	G	1	4	5	0	0	5	0	0
24	20200540	.	T	C	2	3	5	0	0	5	0	0
24	20204453	.	C	A	1	2	3	0	0	3	0	0
24	20208353	.	A	G	4	8	12	0	0	12	0	0
24	20320432	.	A	T	1	2	3	0	0	3	0	0
24	20325475	.	G	A	0	3	3	0	6	9	0	0
24	20325754	.	G	A	4	3	7	0	0	7	0	0
24	20328567	.	G	C	10	8	18	0	2	20	0	0
24	20328609	.	G	A	9	5	14	0	2	16	0	0
24	20329346	.	A	T	6	7	13	0	0	13	0	0
24	20335825	.	C	G	2	3	5	0	0	5	0	0
24	20335869	.	T	C	1	2	3	0	0	3	0	0
24	20450191	.	A	G	8	5	13	0	0	13	0	0
24	20450270	.	G	C	7	6	13	0	2	15	0	0
24	20450417	.	C	G	6	8	14	0	0	14	0	0
24	20450467	.	C	G	6	7	13	0	0	13	0	0
24	20450672	.	C	G	11	8	19	0	2	21	0	0
24	20450843	.	A	C	11	0	11	0	14	25	0	0
24	20470788	.	A	G	6	9	15	0	1	16	0	0
24	20531566	.	C	T	12	9	21	0	0	21	0	0
24	20531692	.	C	A	7	7	14	0	0	14	0	0
24	20536292	.	A	G	14	9	23	0	0	23	0	0
24	20537515	.	A	T	14	6	20	0	0	20	0	0
24	20537554	.	C	A	13	8	21	0	1	22	0	0
24	20541421	.	C	T	12	9	21	0	1	22	0	0
24	20542972	.	T	C	12	9	21	0	2	23	0	0
24	20554857	.	G	T	5	11	16	0	0	16	0	0
24	20554858	.	T	G	5	11	16	0	0	16	0	0
24	20589791	.	G	A	12	14	26	0	0	26	0	0
24	20591775	.	G	A	7	12	19	0	0	19	0	0
24	20600027	.	C	T	6	5	11	0	0	11	0	0
24	20628266	.	T	C	5	2	7	0	0	7	0	0
24	20644356	.	C	T	16	12	28	0	1	29	0	0
24	20645858	.	A	T	23	11	34	0	0	34	0	0
24	20646694	.	G	A	5	15	20	0	2	22	0	0
24	20647423	.	G	T	14	9	23	0	1	24	0	0
24	20648945	.	T	C	13	24	37	0	1	38	0	0
24	20649013	.	T	C	17	12	29	0	0	29	0	0
24	20658421	.	T	G	4	8	12	0	0	12	0	0
24	20658427	.	T	A	2	6	8	0	1	9	0	0
24	20659046	.	C	G	1	2	3	0	0	3	0	0
24	20664650	.	C	G	1	0	1	0	5	6	0	0
24	20708388	.	A	G	2	7	9	0	1	10	0	0
24	20807990	.	G	A	3	2	5	0	1	6	0	0
24	20893161	.	C	T	1	2	3	0	0	3	0	0
24	20893389	.	A	G	4	4	8	0	1	9	0	0
24	20895293	.	T	A	4	5	9	0	0	9	0	0
24	20895308	.	A	G	4	4	8	0	0	8	0	0
24	20898218	.	A	T	1	2	3	0	0	3	0	0
24	20898334	.	T	C	2	2	4	0	0	4	0	0
24	20898485	.	G	A	3	4	7	1	0	8	0	0
24	20899964	.	A	T	1	3	4	0	0	4	0	0
24	20900142	.	A	G	5	3	8	0	0	8	0	0
24	20902081	.	G	A	2	2	4	0	0	4	0	0
24	20908137	.	T	C	4	3	7	0	0	7	0	0
24	20916772	.	A	T	1	3	4	0	0	4	0	0
24	20916788	.	A	G	2	5	7	0	0	7	0	0
24	20916874	.	A	T	3	2	5	0	0	5	0	0
24	20917029	.	T	C	5	3	8	0	1	9	0	0
24	20918078	.	T	G	10	8	18	0	1	19	0	0
24	20921565	.	C	A	7	6	13	0	0	13	0	0
24	20921615	.	A	G	7	3	10	0	0	10	0	0
24	20922783	.	G	A	3	6	9	0	0	9	0	0
24	20934223	.	C	T	22	19	41	0	4	45	0	0
24	20941605	.	A	G	13	8	21	0	1	22	0	0
24	20941687	.	A	G	27	19	46	0	0	46	0	0
24	20941789	.	A	G	13	25	38	0	1	39	0	0
24	20942281	.	G	A	12	10	22	0	1	23	0	0
24	20942541	.	G	T	26	17	43	0	4	47	0	0
24	20946263	.	G	A	16	19	35	0	3	38	0	0
24	20946305	.	C	T	16	14	30	0	1	31	0	0
24	20948122	.	C	T	15	24	39	0	4	43	0	0
24	20948330	.	G	A	17	14	31	0	3	34	0	0
24	20949494	.	A	G	16	23	39	0	0	39	0	0
24	20953045	.	C	T	11	6	17	0	1	18	0	0
24	20962342	.	G	A	0	2	2	0	5	7	0	0
24	20962473	.	C	A	2	3	5	0	0	5	0	0
24	20962477	.	G	C	2	2	4	0	0	4	0	0
24	20969385	.	C	T	8	3	11	0	0	11	0	0
24	20969467	.	C	T	4	3	7	0	1	8	0	0
24	20969491	.	G	A	0	2	2	0	5	7	0	0
24	20980039	.	A	G	4	0	4	0	8	12	0	0
24	20980141	.	A	G	5	12	17	0	1	18	0	0
24	20980197	.	C	T	3	5	8	0	0	8	0	0
24	20984901	.	T	C	3	4	7	0	0	7	0	0
24	20987865	.	A	G	1	3	4	0	0	4	0	0
24	21005729	.	A	G	5	12	17	0	1	18	0	0
24	21005908	.	A	T	4	6	10	0	0	10	0	0
24	21005973	.	A	T	4	6	10	0	0	10	0	0
24	21060253	.	A	T	3	2	5	0	0	5	0	0
24	21068518	.	A	G	3	2	5	0	0	5	0	0
24	21128660	.	A	G	1	3	4	0	0	4	0	0
24	21154415	.	A	G	18	12	30	0	0	30	0	0
24	21154421	.	A	T	17	12	29	0	1	30	0	0
24	21154707	.	A	G	32	24	56	0	2	58	0	0
24	21157661	.	G	A	32	22	54	0	1	55	0	0
24	21159814	.	A	G	29	18	47	0	4	51	0	0
24	21161459	.	C	T	2	18	20	0	26	46	0	0
24	21167389	.	A	G	25	16	41	0	1	42	0	0
24	21167443	.	G	A	17	22	39	0	0	39	0	0
24	21167446	.	G	A	19	21	40	0	1	41	0	0
24	21167660	.	G	A	15	20	35	0	0	35	0	0
24	21168638	.	G	A	17	15	32	0	2	34	0	0
24	21172062	.	G	A	4	4	8	0	0	8	0	0
24	21182156	.	A	G	2	4	6	0	0	6	0	0
24	21182444	.	A	G	8	9	17	0	0	17	0	0
24	21182642	.	G	A	9	11	20	1	0	21	0	0
24	21182783	.	C	T	12	10	22	0	3	25	0	0
24	21183047	.	A	C	12	4	16	0	1	17	0	0
24	21183181	.	C	T	11	15	26	0	0	26	0	0
24	21183228	.	C	G	10	16	26	0	2	28	0	0
24	21183290	.	A	C	16	14	30	0	1	31	0	0
24	21183467	.	T	C	1	5	6	0	0	6	0	0
24	21195122	.	A	T	3	3	6	0	0	6	0	0
24	21195375	.	G	T	3	2	5	0	0	5	0	0
24	21195881	.	A	G	5	3	8	0	0	8	0	0
24	21196136	.	G	A	1	3	4	0	4	8	0	0
24	21196166	.	T	C	3	5	8	0	1	9	0	0
24	21196211	.	C	A	4	4	8	0	0	8	0	0
24	21196410	.	A	G	1	5	6	0	1	7	0	0
24	21196446	.	T	G	1	6	7	0	0	7	0	0
24	21196503	.	A	C	2	4	6	0	0	6	0	0
24	21196637	.	T	A	4	4	8	0	0	8	0	0
24	21197152	.	T	C	2	3	5	0	0	5	0	0
24	21197324	.	A	G	2	2	4	0	0	4	0	0
24	21197665	.	T	G	2	5	7	0	0	7	0	0
24	21197823	.	A	G	2	2	4	0	0	4	0	0
24	21198025	.	T	C	5	6	11	0	0	11	0	0
24	21198226	.	G	T	3	4	7	0	0	7	0	0
24	21198264	.	T	A	3	4	7	0	0	7	0	0
24	21199460	.	C	T	4	3	7	0	0	7	0	0
24	21200926	.	C	T	7	11	18	0	0	18	0	0
24	21200953	.	C	G	6	7	13	0	0	13	0	0
24	21201500	.	G	T	1	9	10	0	10	20	0	0
24	21201506	.	T	C	10	10	20	0	1	21	0	0
24	21201830	.	A	T	8	11	19	0	0	19	0	0
24	21202067	.	G	T	3	4	7	0	0	7	0	0
24	21202203	.	A	G	4	5	9	0	0	9	0	0
24	21202225	.	C	T	4	5	9	0	0	9	0	0
24	21206347	.	T	A	1	2	3	0	0	3	0	0
24	21206352	.	G	T	1	2	3	0	0	3	0	0
24	21206903	.	T	A	3	3	6	0	1	7	0	0
24	21207571	.	G	C	3	6	9	0	0	9	0	0
24	21212663	.	A	G	1	4	5	0	0	5	0	0
24	21212684	.	G	A	2	2	4	0	0	4	0	0
24	21230992	.	G	A	1	2	3	0	0	3	0	0
24	21258864	.	T	C	1	2	3	0	0	3	0	0
24	21333648	.	G	T	2	4	6	0	0	6	0	0
24	21336101	.	G	A	1	5	6	0	0	6	0	0
24	21371282	.	A	C	1	3	4	0	0	4	0	0
24	21371345	.	C	T	0	5	5	0	7	12	0	0
24	21371848	.	T	C	22	0	22	0	20	42	0	0
24	21382737	.	C	A	13	21	34	0	0	34	0	0
24	21392168	.	T	C	14	22	36	0	1	37	0	0
24	21392258	.	T	C	13	16	29	0	2	31	0	0
24	21411514	.	G	A	18	24	42	0	0	42	0	0
24	21411834	.	G	T	21	16	37	0	1	38	0	0
24	21417797	.	C	T	1	11	12	0	17	29	0	0
24	21438161	.	G	A	15	10	25	0	1	26	0	0
24	21442815	.	A	G	17	17	34	0	1	35	0	0
24	21445237	.	C	T	19	17	36	0	1	37	0	0
24	21445240	.	G	A	17	20	37	0	0	37	0	0
24	21448002	.	T	C	10	9	19	0	3	22	0	0
24	21450130	.	C	T	15	16	31	0	0	31	0	0
24	21462810	.	A	G	14	17	31	0	2	33	0	0
24	21469067	.	T	G	10	13	23	0	1	24	0	0
24	21469157	.	T	C	23	1	24	1	35	60	0	0
24	21470892	.	A	C	2	8	10	0	1	11	0	0
24	21502305	.	A	G	10	6	16	0	0	16	0	0
24	21502973	.	G	A	8	5	13	1	1	15	0	0
24	21503043	.	G	T	8	16	24	0	1	25	0	0
24	21503350	.	C	T	8	6	14	0	0	14	0	0
24	21503748	.	T	C	7	3	10	0	0	10	0	0
24	21503830	.	T	C	0	7	7	0	0	7	0	0
24	21503839	.	T	C	1	7	8	0	1	9	0	0
24	21504169	.	T	G	1	5	6	0	0	6	0	0
24	21504467	.	A	G	11	8	19	0	0	19	0	0
24	21504746	.	C	T	0	10	10	0	10	20	0	0
24	21504785	.	A	G	9	15	24	0	0	24	0	0
24	21504860	.	G	T	10	8	18	0	1	19	0	0
24	21505178	.	A	C	8	6	14	0	1	15	0	0
24	21505255	.	T	G	4	4	8	0	1	9	0	0
24	21505446	.	A	T	7	7	14	0	0	14	0	0
24	21505895	.	A	G	7	6	13	0	0	13	0	0
24	21507501	.	A	G	4	2	6	0	1	7	0	0
24	21514386	.	T	A	10	10	20	0	1	21	0	0
24	21514437	.	T	C	7	8	15	0	0	15	0	0
24	21538430	.	C	T	14	13	27	0	1	28	0	0
24	21538441	.	T	G	13	0	13	0	12	25	0	0
24	21538568	.	A	C	10	9	19	0	0	19	0	0
24	21538957	.	T	C	11	5	16	0	3	19	0	0
24	21538982	.	T	A	9	7	16	0	1	17	0	0
24	21561074	.	C	T	9	5	14	0	1	15	0	0
24	21567672	.	C	T	6	8	14	0	0	14	0	0
24	21568808	.	T	A	10	6	16	0	1	17	0	0
24	21572604	.	G	T	7	14	21	0	2	23	0	0
24	21575273	.	T	A	15	11	26	0	0	26	0	0
24	21575311	.	G	C	11	14	25	0	0	25	0	0
24	21575372	.	G	A	6	11	17	0	0	17	0	0
24	21577239	.	G	A	7	6	13	0	0	13	0	0
24	21577450	.	C	G	5	13	18	0	1	19	0	0
24	21577620	.	T	G	4	6	10	0	0	10	0	0
24	21584231	.	T	A	8	13	21	0	0	21	0	0
24	21584287	.	A	G	9	6	15	0	0	15	0	0
24	21585802	.	G	A	6	7	13	0	0	13	0	0
24	21586020	.	C	T	5	3	8	0	1	9	0	0
24	21586189	.	G	A	8	4	12	0	0	12	0	0
24	21586190	.	C	A	8	4	12	0	0	12	0	0
24	21586229	.	G	A	6	7	13	0	0	13	0	0
24	21587309	.	T	G	10	5	15	0	1	16	0	0
24	21600873	.	T	G	3	7	10	0	6	16	0	0
24	21621684	.	C	T	1	3	4	0	0	4	0	0
24	21621694	.	T	C	2	2	4	0	1	5	0	0
24	21621730	.	G	T	12	17	29	0	0	29	0	0
24	21646704	.	G	T	31	16	47	0	1	48	0	0
24	21646808	.	G	A	25	14	39	0	0	39	0	0
24	21646847	.	A	C	21	10	31	0	0	31	0	0
24	21650088	.	G	A	21	12	33	0	1	34	0	0
24	21657738	.	T	C	15	0	15	0	17	32	0	0
24	21659864	.	A	T	16	15	31	0	2	33	0	0
24	21659873	.	A	G	19	12	31	0	0	31	0	0
24	21662298	.	T	G	17	8	25	0	2	27	0	0
24	21671387	.	G	A	5	20	25	0	0	25	0	0
24	21724424	.	C	T	8	7	15	0	1	16	0	0
24	21729346	.	C	T	6	4	10	0	0	10	0	0
24	21744239	.	G	A	0	5	5	0	9	14	0	0
24	21744266	.	A	G	6	6	12	0	2	14	0	0
24	21747550	.	G	T	4	4	8	0	1	9	0	0
24	21747672	.	G	A	0	6	6	0	7	13	0	0
24	21748175	.	A	G	9	9	18	0	1	20	1	0
24	21748249	.	T	C	14	13	27	0	1	28	0	0
24	21751022	.	T	G	1	4	5	0	0	5	0	0
24	21752764	.	G	A	1	3	4	0	0	4	0	0
24	21781146	.	A	G	5	6	11	0	0	11	0	0
24	21781451	.	T	G	8	4	12	0	0	12	0	0
24	21867319	.	T	A	2	4	6	0	0	6	0	0
24	21917293	.	A	C	1	2	3	0	1	4	0	0
24	21917704	.	G	C	7	4	11	0	0	11	0	0
24	21917745	.	T	G	7	6	13	0	0	13	0	0
24	21917863	.	T	C	3	8	11	0	1	12	0	0
24	21920915	.	A	G	4	6	10	0	0	10	0	0
24	21920918	.	T	G	4	7	11	0	0	11	0	0
24	21921104	.	T	C	5	3	8	0	0	8	0	0
24	21923967	.	A	G	1	2	3	0	0	3	0	0
24	21927434	.	G	A	3	2	5	0	3	8	0	0
24	21927503	.	A	G	5	3	8	0	0	8	0	0
24	21927506	.	A	G	5	3	8	0	0	8	0	0
24	21927720	.	T	G	3	3	6	0	0	6	0	0
24	21928294	.	C	T	0	3	3	0	2	5	0	0
24	21929107	.	T	C	2	0	2	0	3	5	0	0
24	21960044	.	C	A	1	3	4	0	1	5	0	0
24	21960098	.	T	A	6	2	8	0	0	8	0	0
24	21960293	.	C	T	5	8	13	0	0	13	0	0
24	21960299	.	G	A	5	8	13	0	0	13	0	0
24	21960445	.	A	T	6	4	10	0	0	10	0	0
24	21960559	.	T	C	2	2	4	0	0	4	0	0
24	21960598	.	T	A	6	3	9	0	0	9	0	0
24	21960609	.	T	C	4	4	8	0	0	8	0	0
24	21960930	.	C	T	8	5	13	0	0	13	0	0
24	21967802	.	T	C	3	2	5	0	0	5	0	0
24	21968103	.	A	G	11	11	22	0	0	22	0	0
24	21969526	.	G	A	8	5	13	0	0	13	0	0
24	21978531	.	A	G	11	12	23	0	0	23	0	0
24	21978593	.	T	C	10	0	10	0	9	19	0	0
24	21978647	.	C	G	11	15	26	0	3	29	0	0
24	21978733	.	C	T	18	19	37	0	1	38	0	0
24	21978790	.	T	C	19	15	34	0	0	34	0	0
24	21984192	.	C	A	9	4	13	0	1	14	0	0
24	21984256	.	C	A	2	13	15	0	17	32	0	0
24	21986571	.	T	C	14	14	28	0	1	29	0	0
24	21986826	.	C	G	17	29	46	0	1	47	0	0
24	22024613	.	A	G	1	0	1	0	3	4	0	0
24	22070389	.	T	A	2	6	8	0	0	8	0	0
24	22070530	.	G	T	4	5	9	0	2	11	0	0
24	22070711	.	T	C	3	2	5	0	0	5	0	0
24	22070957	.	C	T	1	2	3	0	0	3	0	0
24	22070965	.	C	T	1	2	3	0	0	3	0	0
24	22071556	.	G	C	9	0	9	0	12	22	1	0
24	22071644	.	G	T	18	22	40	0	6	46	0	0
24	22071649	.	G	T	27	13	40	0	5	45	0	0
24	22100861	.	G	C	14	21	35	0	0	35	0	0
24	22122922	.	C	T	2	9	11	0	15	26	0	0
24	22123784	.	T	A	23	16	39	0	0	39	0	0
24	22123927	.	A	C	16	0	16	0	20	36	0	0
24	22123930	.	G	T	18	15	33	0	6	39	0	0
24	22124020	.	G	A	20	21	41	1	5	47	0	0
24	22442349	.	T	C	6	5	11	1	1	13	0	0
24	22533940	.	T	C	8	5	13	0	0	13	0	0
24	22740589	.	T	C	4	4	8	1	0	9	0	0
24	22740772	.	T	A	15	11	26	0	1	27	0	0
24	22744460	.	C	T	12	8	20	0	0	20	0	0
24	22744487	.	C	T	9	9	18	0	2	20	0	0
24	22744502	.	A	G	8	8	16	0	2	18	0	0
24	22746843	.	T	G	18	13	31	0	1	32	0	0
24	22759703	.	C	T	18	10	28	0	0	28	0	0
24	22769484	.	C	T	5	2	7	0	0	7	0	0
24	23213206	.	C	G	4	3	7	0	0	7	0	0
24	23213411	.	C	A	4	4	8	0	0	8	0	0
24	23213419	.	A	C	4	3	7	0	0	7	0	0
24	23213595	.	C	T	3	4	7	0	0	7	0	0
24	23213599	.	T	C	4	4	8	0	0	8	0	0
24	23213644	.	C	T	1	3	4	0	0	4	0	0
24	23213886	.	G	A	1	2	3	0	2	5	0	0
24	23214125	.	G	A	0	2	2	0	1	3	0	0
24	23243257	.	A	G	1	4	5	0	1	6	0	0
24	23243749	.	C	A	10	4	14	0	0	14	0	0
24	23244265	.	G	A	0	9	9	0	1	10	0	0
24	23244266	.	A	G	7	2	9	0	2	11	0	0
24	23250116	.	T	A	9	9	18	0	2	20	0	0
24	23300755	.	A	G	5	4	9	0	0	9	0	0
24	23302371	.	A	G	6	3	9	0	0	9	0	0
24	23302441	.	A	G	3	3	6	0	0	6	0	0
24	23302707	.	T	G	5	7	12	0	0	12	0	0
24	23302799	.	T	C	11	4	15	0	0	15	0	0
24	23302897	.	G	C	4	4	8	0	0	8	0	0
24	23303003	.	G	A	4	4	8	0	0	8	0	0
24	23694147	.	C	T	0	2	2	0	1	3	0	0
24	23717064	.	C	G	11	9	20	0	0	21	1	0
24	23720091	.	G	A	13	15	28	0	0	28	0	0
24	23723983	.	G	A	10	20	30	0	0	30	0	0
24	23747297	.	G	A	3	2	5	0	1	6	0	0
24	23758880	.	A	C	4	4	8	0	0	8	0	0
24	23759679	.	G	A	10	7	17	0	0	17	0	0
24	23766841	.	G	A	2	7	9	0	0	9	0	0
24	23768788	.	G	A	6	5	11	0	0	11	0	0
24	23784647	.	G	A	7	7	14	0	0	14	0	0
24	23816117	.	T	C	1	2	3	0	0	3	0	0
24	23839024	.	T	C	4	10	14	0	2	16	0	0
24	23839088	.	C	T	8	4	12	0	1	13	0	0
24	23839600	.	A	G	9	6	15	0	2	17	0	0
24	23841767	.	T	A	2	2	4	0	0	4	0	0
24	23851341	.	A	C	1	4	5	0	0	5	0	0
24	23854579	.	G	A	1	2	3	0	0	3	0	0
24	23854709	.	C	T	1	2	3	0	0	3	0	0
24	23858097	.	G	T	2	4	6	0	0	6	0	0
24	23931982	.	C	T	2	3	5	0	0	5	0	0
24	23937985	.	C	T	14	7	21	0	3	24	0	0
24	23941618	.	G	T	6	12	18	0	0	19	1	0
24	23942642	.	G	A	7	10	17	0	1	18	0	0
24	23971151	.	C	G	16	12	28	0	0	28	0	0
24	23971205	.	T	C	17	15	32	0	0	32	0	0
24	23972311	.	T	G	1	3	4	0	0	4	0	0
24	23973556	.	T	A	1	3	4	0	0	4	0	0
24	23974411	.	C	T	28	27	55	0	2	57	0	0
24	23974484	.	C	T	1	20	21	0	13	34	0	0
24	23991043	.	G	C	1	3	4	0	0	4	0	0
24	24014987	.	C	A	2	9	11	0	1	12	0	0
24	24015086	.	G	T	4	7	11	0	1	12	0	0
24	24020314	.	C	T	18	11	29	0	1	30	0	0
24	24027939	.	A	G	8	10	18	0	1	19	0	0
24	24028016	.	C	T	13	9	22	0	1	23	0	0
24	24028032	.	G	C	16	9	25	0	0	25	0	0
24	24028059	.	T	A	13	12	25	0	0	25	0	0
24	24102026	.	C	T	0	8	8	0	5	13	0	0
24	24102091	.	T	C	19	0	19	0	17	36	0	0
24	24102190	.	A	T	15	17	32	0	0	32	0	0
24	24102318	.	A	C	16	24	40	0	0	40	0	0
24	24108653	.	T	C	13	28	41	0	2	43	0	0
24	24111587	.	G	T	8	8	16	0	1	17	0	0
24	24114321	.	C	T	22	17	39	0	1	40	0	0
24	24114744	.	G	A	15	16	31	0	3	34	0	0
24	24115352	.	T	G	11	13	24	0	0	24	0	0
24	24115485	.	C	G	0	15	15	0	16	31	0	0
24	24115602	.	A	G	17	10	27	0	1	28	0	0
24	24115626	.	G	T	16	9	25	0	0	25	0	0
24	24118213	.	A	C	11	8	19	0	0	19	0	0
24	24118272	.	A	G	7	11	18	0	1	19	0	0
24	24118362	.	C	T	9	9	18	0	0	18	0	0
24	24118366	.	A	T	5	8	13	0	4	17	0	0
24	24119757	.	G	A	3	5	8	0	0	8	0	0
24	24119879	.	G	A	2	2	4	0	0	4	0	0
24	24121130	.	C	T	22	21	43	0	1	44	0	0
24	24121568	.	C	T	16	15	31	0	0	31	0	0
24	24121582	.	T	C	18	2	20	0	16	36	0	0
24	24121826	.	G	T	20	20	40	0	2	42	0	0
24	24121851	.	A	T	28	18	46	0	2	48	0	0
24	24122040	.	G	A	35	33	68	0	2	70	0	0
24	24124517	.	G	A	24	26	50	0	2	52	0	0
24	24129728	.	C	T	46	27	73	1	0	74	0	0
24	24135906	.	G	A	32	23	55	0	1	56	0	0
24	24146815	.	T	A	12	11	23	0	0	23	0	0
24	24155586	.	T	C	16	15	31	0	7	38	0	0
24	24159360	.	C	G	13	24	37	0	0	37	0	0
24	24163114	.	C	T	13	8	21	0	1	22	0	0
24	24164278	.	C	A	8	2	10	0	1	11	0	0
24	24164770	.	G	A	17	13	30	0	1	31	0	0
24	24164935	.	A	C	10	14	24	0	2	26	0	0
24	24165563	.	G	T	33	28	61	1	2	64	0	0
24	24168471	.	C	G	9	3	12	0	0	12	0	0
24	24171178	.	T	C	6	2	8	0	0	8	0	0
24	24174791	.	C	T	3	2	5	0	0	5	0	0
24	24174826	.	C	T	1	4	5	0	0	5	0	0
24	24175497	.	G	T	3	3	6	0	1	7	0	0
24	24175782	.	G	A	1	2	3	0	0	3	0	0
24	24175788	.	A	T	1	2	3	0	0	3	0	0
24	24177080	.	G	A	4	7	11	0	0	11	0	0
24	24177137	.	A	G	6	4	10	0	0	10	0	0
24	24177158	.	T	C	9	3	12	0	0	12	0	0
24	24177357	.	G	C	3	3	6	0	0	6	0	0
24	24183959	.	T	G	4	7	11	0	1	12	0	0
24	24183974	.	T	C	5	3	8	0	1	9	0	0
24	24183996	.	C	T	5	6	11	0	0	11	0	0
24	24184394	.	T	C	8	0	8	0	5	13	0	0
24	24184414	.	A	C	7	8	15	0	3	18	0	0
24	24184677	.	T	A	13	8	21	0	0	21	0	0
24	24187454	.	T	G	9	6	15	0	0	15	0	0
24	24189345	.	T	A	10	8	18	0	0	18	0	0
24	24189516	.	C	T	0	4	4	0	8	12	0	0
24	24189543	.	T	C	5	4	9	0	2	11	0	0
24	24189561	.	G	A	4	6	10	0	1	11	0	0
24	24189591	.	C	T	6	7	13	0	0	13	0	0
24	24194328	.	A	G	8	8	16	0	1	17	0	0
24	24194331	.	A	G	9	8	17	0	0	17	0	0
24	24210479	.	C	T	2	7	9	0	1	10	0	0
24	24210485	.	G	A	3	7	10	0	0	10	0	0
24	24273914	.	A	G	2	3	5	0	0	5	0	0
24	24274024	.	A	G	3	3	6	0	0	6	0	0
24	24274069	.	A	T	1	2	3	0	0	3	0	0
24	24287980	.	T	C	5	3	8	0	1	9	0	0
24	24288223	.	T	C	7	9	16	0	1	17	0	0
24	24299421	.	G	A	0	3	3	0	8	11	0	0
24	24300125	.	C	T	0	3	3	0	0	3	0	0
24	24461710	.	T	A	15	17	32	0	0	32	0	0
24	24462021	.	C	T	17	15	32	0	1	33	0	0
24	24462036	.	G	C	2	13	15	0	18	33	0	0
24	24462081	.	C	T	17	18	35	0	2	37	0	0
24	24463030	.	T	A	14	16	30	0	1	31	0	0
24	24463060	.	A	G	12	15	27	0	1	28	0	0
24	24463212	.	T	A	22	13	35	0	1	36	0	0
24	24701885	.	C	G	10	13	23	0	0	23	0	0
24	24701938	.	T	C	8	8	16	0	1	17	0	0
24	24702119	.	A	C	4	0	4	0	14	18	0	0
24	24702674	.	C	T	15	16	31	0	1	32	0	0
24	24702930	.	C	T	1	16	17	0	10	27	0	0
24	24702936	.	T	C	10	14	24	0	1	25	0	0
24	24720991	.	G	A	13	6	19	0	2	21	0	0
24	24728940	.	C	T	3	3	6	0	0	6	0	0
24	24731396	.	T	C	1	2	3	0	1	4	0	0
24	24796567	.	C	G	0	2	2	0	5	7	0	0
24	24796901	.	T	C	4	5	9	0	0	9	0	0
24	24797416	.	C	T	6	4	10	0	0	10	0	0
24	24848118	.	C	T	2	18	20	0	21	41	0	0
24	24931465	.	T	C	6	9	15	0	1	16	0	0
24	24934236	.	A	G	10	9	19	0	2	21	0	0
24	24934347	.	T	C	10	14	24	0	1	25	0	0
24	24935527	.	G	A	12	10	22	0	1	23	0	0
24	24935560	.	A	G	15	0	15	0	14	29	0	0
24	24935791	.	G	C	8	1	9	0	0	9	0	0
24	24935810	.	T	C	8	4	12	0	1	13	0	0
24	24944387	.	A	C	14	14	28	0	0	28	0	0
24	24948089	.	T	A	18	8	26	0	1	27	0	0
24	24948101	.	T	A	16	5	21	0	2	23	0	0
24	24950569	.	T	C	12	12	24	0	0	24	0	0
24	24954478	.	T	C	7	12	19	0	0	19	0	0
24	24989293	.	T	G	8	5	13	0	1	14	0	0
24	24989368	.	C	T	1	8	9	0	12	21	0	0
24	24992522	.	G	A	7	4	11	0	0	11	0	0
24	25008378	.	G	C	1	0	1	0	3	4	0	0
24	25008884	.	G	A	8	7	15	0	0	15	0	0
24	25008887	.	G	A	8	5	13	0	1	14	0	0
24	25020054	.	T	G	6	5	11	0	1	12	0	0
24	25026344	.	C	T	1	4	5	0	10	15	0	0
24	25029860	.	T	A	6	6	12	0	0	12	0	0
24	25030071	.	G	A	1	5	6	0	0	6	0	0
24	25032485	.	G	A	5	6	11	0	0	11	0	0
24	25041054	.	T	C	10	6	16	0	0	16	0	0
24	25047572	.	C	G	4	0	4	0	8	12	0	0
24	25049209	.	C	T	14	14	28	0	0	28	0	0
24	25049436	.	T	C	4	8	12	0	0	12	0	0
24	25049484	.	T	G	6	6	12	0	1	13	0	0
24	25049658	.	T	C	6	7	13	0	0	13	0	0
24	25052078	.	C	T	9	4	13	0	0	13	0	0
24	25052723	.	T	A	11	10	21	0	0	21	0	0
24	25052774	.	C	T	8	7	15	0	0	15	0	0
24	25053032	.	C	A	12	13	25	0	0	25	0	0
24	25059127	.	C	T	3	4	7	0	0	7	0	0
24	25059129	.	T	C	3	4	7	0	0	7	0	0
24	25069670	.	G	A	9	7	16	0	2	18	0	0
24	25069926	.	A	G	11	0	11	0	10	21	0	0
24	25069928	.	T	A	11	9	20	0	0	20	0	0
24	25070289	.	C	T	10	7	17	0	1	18	0	0
24	25070515	.	C	T	10	6	16	0	1	17	0	0
24	25070745	.	G	A	2	10	12	0	5	17	0	0
24	25070921	.	C	T	3	10	13	0	0	13	0	0
24	25070922	.	T	G	3	10	13	0	0	13	0	0
24	25071270	.	T	A	10	11	21	0	3	24	0	0
24	25071474	.	T	C	18	23	41	0	0	41	0	0
24	25071486	.	A	T	20	19	39	0	0	39	0	0
24	25071726	.	G	A	4	13	17	0	1	18	0	0
24	25071742	.	T	C	3	10	13	0	1	14	0	0
24	25072088	.	T	C	12	11	23	0	0	23	0	0
24	25072102	.	T	C	12	11	23	0	0	23	0	0
24	25072311	.	C	T	10	7	17	0	1	18	0	0
24	25072358	.	C	A	8	8	16	0	1	17	0	0
24	25072487	.	A	G	10	7	17	0	0	17	0	0
24	25072511	.	T	G	9	9	18	0	0	18	0	0
24	25072678	.	C	A	13	4	17	0	0	17	0	0
24	25072711	.	G	A	13	9	22	0	0	22	0	0
24	25203867	.	G	A	0	2	2	0	2	4	0	0
24	25204095	.	A	G	1	3	4	0	0	4	0	0
24	25347794	.	G	T	6	4	10	0	0	10	0	0
24	25348187	.	C	A	3	2	5	0	0	5	0	0
24	25348354	.	C	T	5	8	13	0	0	13	0	0
24	25350710	.	G	A	3	4	7	0	0	7	0	0
24	25350712	.	G	A	3	4	7	0	0	7	0	0
24	25351091	.	A	G	5	4	9	0	0	9	0	0
24	25351121	.	T	C	5	2	7	0	0	7	0	0
24	25351172	.	A	T	4	3	7	0	1	8	0	0
24	25351368	.	A	T	2	6	8	0	0	8	0	0
24	25351455	.	T	G	3	2	5	0	1	6	0	0
24	25351911	.	C	T	1	4	5	0	4	9	0	0
24	25351955	.	C	T	6	3	9	0	0	9	0	0
24	25352109	.	G	A	4	4	8	0	0	8	0	0
24	25352325	.	G	A	2	4	6	0	0	6	0	0
24	25352630	.	T	C	3	0	3	0	4	7	0	0
24	25353090	.	A	G	1	2	3	0	1	4	0	0
24	25359629	.	G	A	2	3	5	0	0	5	0	0
24	25359803	.	A	G	4	6	10	0	0	10	0	0
24	25363083	.	C	T	3	2	5	0	1	6	0	0
24	25363324	.	C	G	4	3	7	0	0	7	0	0
24	25448155	.	G	A	7	10	17	0	0	17	0	0
24	25448185	.	C	A	1	9	10	0	4	14	0	0
24	25449319	.	G	A	4	3	7	0	0	7	0	0
24	25452620	.	G	A	3	6	9	0	0	9	0	0
24	25454912	.	G	A	6	7	13	0	0	13	0	0
24	25456649	.	G	A	0	4	4	0	2	6	0	0
24	25456896	.	T	A	3	3	6	0	0	6	0	0
24	25461217	.	T	C	4	0	4	0	5	9	0	0
24	25496133	.	T	C	5	6	11	0	0	11	0	0
24	25496194	.	A	C	1	7	8	0	0	8	0	0
24	25496215	.	T	G	1	4	5	0	0	5	0	0
24	25496271	.	C	T	1	3	4	0	1	5	0	0
24	25496346	.	C	T	3	2	5	0	0	5	0	0
24	25496435	.	T	C	3	9	12	0	0	12	0	0
24	25496590	.	T	C	3	8	11	0	3	14	0	0
24	25496789	.	T	C	3	7	10	0	1	11	0	0
24	25497273	.	A	T	3	3	6	0	0	7	1	0
24	25497353	.	G	A	0	2	2	0	3	5	0	0
24	25497904	.	C	A	1	2	3	0	0	3	0	0
24	25498229	.	C	T	1	2	3	0	0	3	0	0
24	25526192	.	C	A	12	13	25	0	1	26	0	0
24	25565407	.	T	C	8	0	8	0	10	18	0	0
24	25565556	.	T	C	6	9	15	0	1	16	0	0
24	25575049	.	A	G	4	11	15	0	1	16	0	0
24	25582229	.	A	G	10	9	19	0	0	19	0	0
24	25602136	.	G	T	9	7	16	0	0	16	0	0
24	25635801	.	C	T	8	6	14	0	1	15	0	0
24	25635933	.	G	A	7	4	11	0	3	14	0	0
24	25693003	.	G	A	21	19	40	0	0	40	0	0
24	25693026	.	C	T	24	23	47	0	1	48	0	0
24	25693948	.	A	G	25	28	53	0	0	53	0	0
24	25693992	.	T	A	17	17	34	1	6	41	0	0
24	25694537	.	A	C	15	20	35	0	1	36	0	0
24	25762884	.	C	T	1	7	8	0	0	8	0	0
24	25762930	.	C	A	3	4	7	0	0	7	0	0
24	25764207	.	A	T	2	2	4	0	0	4	0	0
24	25764756	.	G	A	1	4	5	0	0	5	0	0
24	25764987	.	T	G	1	2	3	0	0	3	0	0
24	25767989	.	A	G	1	5	6	0	0	6	0	0
24	25786579	.	G	A	1	5	6	0	0	6	0	0
24	25787005	.	A	G	1	2	3	0	0	3	0	0
24	25787029	.	G	A	1	3	4	0	0	4	0	0
24	25794334	.	C	T	1	2	3	0	0	3	0	0
24	25794522	.	C	A	9	7	16	0	0	16	0	0
24	25794530	.	G	A	7	8	15	0	0	15	0	0
24	25872390	.	C	T	15	7	22	0	0	22	0	0
24	25987617	.	C	T	2	2	4	0	0	4	0	0
24	25988133	.	C	A	1	2	3	2	0	5	0	0
24	25988171	.	T	G	1	2	3	0	0	3	0	0
24	26017133	.	T	C	8	4	12	0	1	13	0	0
24	26017175	.	T	A	18	8	26	0	2	28	0	0
24	26017188	.	A	G	17	10	27	0	1	28	0	0
24	26020254	.	A	T	5	11	16	0	1	17	0	0
24	26020514	.	T	G	7	6	13	0	0	13	0	0
24	26021810	.	T	C	8	3	11	0	1	12	0	0
24	26021871	.	G	A	10	6	16	0	3	19	0	0
24	26025151	.	T	C	12	10	22	0	0	22	0	0
24	26025384	.	T	A	9	11	20	0	2	22	0	0
24	26026179	.	A	T	9	14	23	0	0	23	0	0
24	26030340	.	T	G	15	13	28	0	0	28	0	0
24	26030571	.	C	T	16	21	37	0	4	41	0	0
24	26030663	.	T	C	15	10	25	0	2	27	0	0
24	26030827	.	A	C	12	18	30	0	2	32	0	0
24	26030849	.	T	A	11	20	31	0	1	32	0	0
24	26030893	.	G	A	13	18	31	0	1	32	0	0
24	26030985	.	A	T	13	14	27	0	1	28	0	0
24	26039798	.	A	G	3	6	9	0	0	9	0	0
24	26040719	.	A	G	6	5	11	0	0	11	0	0
24	26041227	.	T	C	4	7	11	0	0	11	0	0
24	26045132	.	C	T	3	7	10	0	1	11	0	0
24	26045910	.	A	G	2	4	6	0	0	6	0	0
24	26045916	.	T	C	1	5	6	0	0	6	0	0
24	26046588	.	A	G	7	0	7	0	13	20	0	0
24	26046618	.	G	A	8	12	20	0	1	21	0	0
24	26046820	.	A	G	10	0	10	0	6	16	0	0
24	26046822	.	T	C	10	6	16	0	0	16	0	0
24	26048017	.	G	A	7	16	23	0	0	23	0	0
24	26049166	.	G	T	8	8	16	0	0	16	0	0
24	26049825	.	T	C	7	16	23	0	1	24	0	0
24	26049946	.	A	C	4	15	19	0	0	19	0	0
24	26050066	.	A	T	13	8	21	0	1	22	0	0
24	26052082	.	T	C	6	10	16	0	0	16	0	0
24	26197142	.	T	C	1	2	3	0	0	3	0	0
24	26197291	.	A	G	3	2	5	0	0	5	0	0
24	26197313	.	G	T	5	2	7	0	0	7	0	0
24	26280058	.	G	A	1	5	6	0	0	6	0	0
24	26280163	.	A	G	1	5	6	0	0	6	0	0
24	26280756	.	G	A	1	2	3	0	1	4	0	0
24	26281680	.	G	T	4	2	6	0	0	6	0	0
24	26284612	.	G	T	9	9	18	0	0	18	0	0
24	26331250	.	C	T	4	3	7	0	0	7	0	0
24	26331279	.	G	A	4	2	6	0	0	6	0	0
24	26331307	.	C	T	4	3	7	0	0	7	0	0
24	26333084	.	T	C	3	3	6	0	1	7	0	0
24	26333366	.	G	A	4	2	6	0	0	6	0	0
24	26333597	.	C	T	3	4	7	0	0	7	0	0
24	26333801	.	C	T	2	6	8	0	0	8	0	0
24	26334257	.	G	A	4	6	10	0	0	10	0	0
24	26334299	.	A	G	2	0	2	0	10	12	0	0
24	26337236	.	T	G	4	3	7	0	0	7	0	0
24	26337238	.	T	G	4	0	4	0	3	7	0	0
24	26373354	.	G	A	5	2	7	0	1	8	0	0
24	26373473	.	G	A	6	10	16	0	0	16	0	0
24	26373498	.	G	A	6	10	16	0	1	17	0	0
24	26376380	.	A	G	12	10	22	0	0	22	0	0
24	26383253	.	C	T	7	11	18	0	2	20	0	0
24	26383430	.	A	G	8	3	11	0	2	13	0	0
24	26383604	.	T	A	8	8	16	1	0	17	0	0
24	26383670	.	A	G	8	9	17	0	0	17	0	0
24	26383700	.	C	T	1	4	5	0	12	17	0	0
24	26383829	.	C	T	0	7	7	1	9	17	0	0
24	26383840	.	C	T	7	8	15	1	2	18	0	0
24	26383907	.	T	C	8	9	17	0	1	18	0	0
24	26383971	.	A	C	7	1	8	0	11	19	0	0
24	26406895	.	C	A	6	7	13	0	4	17	0	0
24	26406898	.	A	G	9	0	9	0	8	17	0	0
24	26406967	.	G	T	9	12	21	0	0	21	0	0
24	26415190	.	T	C	10	19	29	0	0	29	0	0
24	26420141	.	T	C	11	7	18	0	0	18	0	0
24	26429443	.	T	C	6	5	11	0	0	11	0	0
24	26429456	.	C	T	7	7	14	0	1	15	0	0
24	26475434	.	C	T	19	10	29	0	0	29	0	0
24	26478889	.	C	T	4	21	25	0	27	52	0	0
24	26482337	.	T	C	34	37	71	0	3	74	0	0
24	26492113	.	C	T	2	13	15	0	14	29	0	0
24	26492505	.	G	T	11	7	18	1	6	25	0	0
24	26492905	.	G	T	10	6	16	0	1	17	0	0
24	26493029	.	T	G	5	4	9	0	2	11	0	0
24	26493158	.	A	C	12	0	12	0	5	17	0	0
24	26493542	.	C	A	19	18	37	0	0	37	0	0
24	26493691	.	T	A	13	9	22	0	0	22	0	0
24	26494077	.	C	A	9	7	16	0	0	16	0	0
24	26494477	.	C	T	1	15	16	0	13	29	0	0
24	26508886	.	C	T	1	10	11	0	8	19	0	0
24	26511001	.	C	T	10	4	14	0	0	14	0	0
24	26513205	.	T	C	12	6	18	0	0	18	0	0
24	26518811	.	A	G	14	11	25	0	0	25	0	0
24	26527472	.	G	A	8	14	22	0	1	23	0	0
24	26529715	.	G	A	4	7	11	0	2	13	0	0
24	26530814	.	T	A	10	9	19	0	0	19	0	0
24	26558029	.	A	G	15	13	28	0	1	29	0	0
24	26574127	.	C	T	8	3	11	0	2	13	0	0
24	26663739	.	T	C	4	4	8	0	0	8	0	0
24	26663944	.	A	G	5	6	11	0	0	11	0	0
24	26687731	.	G	A	2	3	5	0	0	5	0	0
24	26688607	.	C	T	4	4	8	0	1	9	0	0
24	26689033	.	G	A	8	4	12	0	1	13	0	0
24	26692342	.	C	G	4	2	6	0	0	6	0	0
24	26692396	.	C	G	1	4	5	0	3	8	0	0
24	26701534	.	C	T	1	6	7	0	0	7	0	0
24	26701540	.	C	T	0	5	5	0	1	6	0	0
24	26889347	.	C	T	4	4	8	0	0	8	0	0
24	26889359	.	G	A	4	3	7	0	0	7	0	0
24	26891144	.	G	T	5	4	9	0	0	9	0	0
24	26891149	.	A	G	5	5	10	0	0	10	0	0
24	26896162	.	A	G	2	3	5	0	0	5	0	0
24	26896163	.	C	T	2	3	5	0	0	5	0	0
24	26901589	.	A	G	2	4	6	0	0	6	0	0
24	26901690	.	T	C	1	2	3	0	1	4	0	0
24	26936794	.	G	A	2	2	4	0	0	4	0	0
24	26941493	.	T	G	6	5	11	0	0	11	0	0
24	26941713	.	C	T	10	9	19	0	2	21	0	0
24	26941996	.	A	G	9	11	20	0	0	20	0	0
24	26942242	.	C	G	8	15	23	0	0	23	0	0
24	26942711	.	T	C	12	9	21	0	1	22	0	0
24	26942880	.	A	T	8	14	22	0	1	23	0	0
24	26942989	.	G	A	5	5	10	0	0	10	0	0
24	26943103	.	C	G	9	7	16	1	1	18	0	0
24	26943148	.	C	T	7	6	13	0	1	14	0	0
24	26945274	.	T	A	12	7	19	0	0	19	0	0
24	26948820	.	G	A	2	4	6	0	0	6	0	0
24	26948823	.	A	C	2	4	6	0	0	6	0	0
24	26948933	.	A	T	1	3	4	0	0	4	0	0
24	26949164	.	T	A	0	5	5	0	0	5	0	0
24	26949555	.	T	G	2	5	7	0	0	7	0	0
24	26959891	.	T	C	3	1	4	0	6	10	0	0
24	26962107	.	G	A	3	4	7	0	0	7	0	0
24	26962277	.	C	T	6	6	12	0	0	12	0	0
24	26968308	.	G	A	2	4	6	0	0	6	0	0
24	26970323	.	A	T	7	2	9	0	0	9	0	0
24	26970404	.	G	A	1	5	6	0	0	6	0	0
24	26970407	.	C	T	0	3	3	0	2	5	0	0
24	26970936	.	T	C	4	0	4	0	4	8	0	0
24	26971515	.	C	T	3	2	5	0	0	5	0	0
24	26980770	.	A	C	2	5	7	0	0	7	0	0
24	26980842	.	A	G	2	3	5	0	0	5	0	0
24	26997920	.	G	A	5	4	9	0	0	9	0	0
24	26998086	.	T	A	7	2	9	0	1	10	0	0
24	27009231	.	C	A	7	4	11	0	1	12	0	0
24	27011189	.	T	A	8	12	20	0	0	20	0	0
24	27023403	.	C	T	6	9	15	0	0	15	0	0
24	27153245	.	C	T	11	9	20	0	0	20	0	0
24	27168681	.	T	C	4	6	10	0	0	10	0	0
24	27168939	.	C	T	5	8	13	0	0	13	0	0
24	27169668	.	T	C	4	3	7	0	1	8	0	0
24	27185574	.	A	G	11	10	21	0	0	21	0	0
24	27203410	.	C	T	9	6	15	2	0	17	0	0
24	27207238	.	G	T	12	7	19	0	2	21	0	0
24	27216987	.	G	A	1	12	13	1	10	24	0	0
24	27222574	.	G	A	7	11	18	0	0	18	0	0
24	27222662	.	C	T	16	13	29	0	1	30	0	0
24	27222731	.	A	G	10	0	10	0	10	20	0	0
24	27222937	.	G	A	2	14	16	0	14	30	0	0
24	27223018	.	C	T	9	7	16	0	1	17	0	0
24	27224064	.	T	A	17	17	34	0	0	34	0	0
24	27224598	.	G	A	5	3	8	0	0	9	1	0
24	27224863	.	C	A	6	7	13	0	1	14	0	0
24	27225096	.	T	C	11	16	27	1	0	28	0	0
24	27225423	.	C	A	8	10	18	0	0	18	0	0
24	27226057	.	C	T	8	8	16	0	1	17	0	0
24	27238808	.	C	T	1	17	18	0	17	35	0	0
24	27238826	.	G	A	17	12	29	0	2	31	0	0
24	27244691	.	C	A	0	2	2	0	3	5	0	0
24	27245021	.	C	A	1	3	4	0	0	4	0	0
24	27245854	.	A	T	3	2	5	0	0	5	0	0
24	27245861	.	G	A	3	1	4	0	2	6	0	0
24	27251249	.	C	T	17	6	23	0	1	24	0	0
24	27399969	.	T	C	5	11	16	0	0	16	0	0
24	28137355	.	G	A	6	4	10	0	0	10	0	0
24	28137429	.	G	A	2	6	8	0	0	8	0	0
24	28137679	.	C	T	1	3	4	0	4	8	0	0
24	28228495	.	G	A	2	4	6	0	1	7	0	0
24	28228572	.	G	A	9	3	12	0	0	12	0	0
24	28228587	.	T	C	6	5	11	0	0	11	0	0
24	28228993	.	A	T	2	5	7	0	0	7	0	0
24	28229130	.	A	T	3	1	4	0	1	5	0	0
24	28229132	.	T	G	3	2	5	0	0	5	0	0
24	28252608	.	C	T	6	2	8	0	0	8	0	0
24	28252699	.	G	A	9	5	14	0	0	14	0	0
24	28252898	.	C	A	9	10	19	0	0	19	0	0
24	28253740	.	A	T	13	16	29	0	2	31	0	0
24	28253802	.	T	C	16	0	16	1	19	36	0	0
24	28259134	.	T	C	15	15	30	0	1	31	0	0
24	28263856	.	G	C	7	16	23	2	0	25	0	0
24	28263964	.	G	A	18	15	33	0	1	34	0	0
24	28276193	.	C	T	0	13	13	0	14	27	0	0
24	28306386	.	T	A	5	7	12	0	0	12	0	0
24	28306413	.	A	C	5	0	5	0	9	14	0	0
24	28354675	.	T	G	13	17	30	0	1	31	0	0
24	28365152	.	G	A	10	8	18	0	0	18	0	0
24	28381103	.	C	T	4	3	7	0	1	8	0	0
24	28381130	.	T	C	3	4	7	0	0	7	0	0
24	28381298	.	C	A	0	6	6	0	5	12	1	0
24	28392367	.	A	G	4	0	4	0	4	8	0	0
24	28392421	.	T	C	3	3	6	0	0	6	0	0
24	28426082	.	T	A	14	6	20	0	1	21	0	0
24	28426597	.	G	A	21	20	41	0	1	42	0	0
24	28432465	.	C	T	26	15	41	0	0	41	0	0
24	28437375	.	A	G	23	17	40	0	1	42	1	0
24	28437562	.	G	C	13	6	19	0	1	20	0	0
24	28555808	.	A	G	1	3	4	0	0	4	0	0
24	28555826	.	C	T	2	3	5	0	0	5	0	0
24	28687424	.	C	T	1	12	13	0	10	23	0	0
24	28687576	.	A	G	10	9	19	0	0	19	0	0
24	28688104	.	G	A	5	9	14	0	0	14	0	0
24	28688137	.	G	A	6	9	15	0	1	16	0	0
24	28688416	.	G	A	7	11	18	0	0	19	1	0
24	28691389	.	C	T	6	3	9	0	2	11	0	0
24	28691457	.	C	T	0	11	11	0	7	18	0	0
24	28710825	.	A	G	13	9	22	0	0	22	0	0
24	28711103	.	T	C	3	2	5	0	0	5	0	0
24	28781199	.	G	A	1	3	4	0	0	4	0	0
24	28935232	.	A	G	6	4	10	0	0	10	0	0
24	28936771	.	C	T	15	10	25	0	0	25	0	0
24	28936801	.	A	T	18	15	33	0	1	34	0	0
24	28953040	.	C	A	14	6	20	0	2	22	0	0
24	28960786	.	T	G	17	7	24	0	2	26	0	0
24	28960808	.	A	C	17	9	26	0	7	33	0	0
24	28964708	.	T	A	3	2	5	0	0	5	0	0
24	28964747	.	T	A	4	3	7	0	0	7	0	0
24	28965006	.	A	G	1	3	4	0	0	4	0	0
24	28966006	.	G	T	1	2	3	0	0	3	0	0
24	28966034	.	C	G	3	2	5	0	0	5	0	0
24	28966873	.	C	A	6	5	11	0	0	11	0	0
24	28966892	.	T	C	4	5	9	0	0	9	0	0
24	28967826	.	T	C	1	4	5	0	0	5	0	0
24	29352703	.	T	C	3	3	6	0	2	8	0	0
24	29353048	.	C	T	4	6	10	0	1	11	0	0
24	29382153	.	T	A	15	12	27	0	1	28	0	0
24	29449847	.	C	T	13	11	24	0	1	25	0	0
24	29450222	.	C	T	13	10	23	0	2	25	0	0
24	29525169	.	T	A	9	12	21	0	5	26	0	0
24	29525262	.	T	C	9	8	17	0	1	18	0	0
24	29930669	.	G	A	0	2	2	0	1	3	0	0
24	29961798	.	C	T	0	2	2	0	1	3	0	0
24	29961833	.	A	T	1	2	3	0	0	3	0	0
24	29961857	.	C	T	1	3	4	0	0	4	0	0
24	29961883	.	G	A	2	4	6	0	0	6	0	0
24	29965385	.	G	A	1	2	3	0	0	3	0	0
24	30053987	.	C	T	0	7	7	0	8	15	0	0
24	30054257	.	A	G	6	11	17	0	1	18	0	0
24	30054404	.	G	A	5	4	9	0	1	10	0	0
24	30054812	.	G	C	10	8	18	0	0	18	0	0
24	30054835	.	A	T	9	7	16	0	1	17	0	0
24	30054857	.	A	G	6	10	16	0	1	17	0	0
24	30054898	.	G	A	5	16	21	0	0	21	0	0
24	30054947	.	C	T	8	13	21	0	1	22	0	0
24	30054980	.	T	G	8	8	16	0	0	16	0	0
24	30055046	.	G	A	8	4	12	0	1	13	0	0
24	30056786	.	C	T	6	6	12	0	2	14	0	0
24	30067126	.	C	T	7	7	14	0	1	15	0	0
24	30082868	.	A	G	4	5	9	0	1	10	0	0
24	30082884	.	A	G	5	3	8	0	0	8	0	0
24	30082929	.	A	G	5	4	9	0	0	9	0	0
24	30160662	.	T	C	3	2	5	0	0	5	0	0
24	30228171	.	A	C	1	2	3	0	0	3	0	0
24	30245151	.	G	A	1	3	4	0	0	4	0	0
24	30258239	.	G	A	2	2	4	0	0	4	0	0
24	30350077	.	T	G	9	5	14	0	0	14	0	0
24	30352234	.	C	T	12	10	22	0	1	23	0	0
24	30352276	.	T	C	15	10	25	0	0	25	0	0
24	30352907	.	T	C	13	14	27	0	0	27	0	0
24	30352940	.	T	A	11	14	25	0	1	27	1	0
24	30353036	.	T	A	19	11	30	0	0	30	0	0
24	30353065	.	G	A	27	14	41	0	1	42	0	0
24	30353083	.	G	A	26	16	42	0	0	42	0	0
24	30353298	.	A	G	11	9	20	0	0	20	0	0
24	30353447	.	T	C	9	9	18	0	1	19	0	0
24	30353683	.	A	G	7	8	15	0	0	15	0	0
24	30353893	.	C	A	7	9	16	0	0	16	0	0
24	30353918	.	C	T	7	12	19	0	2	21	0	0
24	30521947	.	A	T	1	2	3	0	0	3	0	0
24	30521950	.	A	T	1	2	3	0	0	3	0	0
24	30528567	.	T	A	1	2	3	0	0	3	0	0
24	30835934	.	T	C	6	9	15	0	1	16	0	0
24	30835936	.	A	G	7	9	16	0	0	16	0	0
24	30835992	.	G	T	7	4	11	0	2	13	0	0
24	30836132	.	A	G	9	5	14	0	1	15	0	0
24	30837512	.	A	G	2	13	15	0	1	16	0	0
24	30837682	.	G	C	8	9	17	0	1	18	0	0
24	30845845	.	G	A	9	3	12	0	0	12	0	0
24	30845875	.	G	C	5	0	5	0	5	10	0	0
24	30845893	.	C	T	3	4	7	0	0	7	0	0
24	30855507	.	A	G	4	3	7	0	0	7	0	0
24	30862080	.	A	T	4	5	9	0	0	9	0	0
24	31082078	.	A	G	4	5	9	0	0	9	0	0
24	31082432	.	G	T	11	6	17	0	0	17	0	0
24	31082758	.	A	T	9	3	12	0	1	13	0	0
24	31092530	.	T	G	14	12	26	0	0	26	0	0
24	31098564	.	A	C	8	4	12	0	2	14	0	0
24	31098655	.	C	A	14	11	25	0	0	25	0	0
24	31098820	.	A	G	11	14	25	0	0	25	0	0
24	31116765	.	T	C	5	5	10	0	0	10	0	0
24	31170701	.	C	T	1	8	9	0	4	13	0	0
24	31170921	.	A	G	1	2	3	0	0	3	0	0
24	31176087	.	A	G	6	4	10	0	0	10	0	0
24	31222905	.	T	C	3	3	6	0	1	7	0	0
24	31222923	.	A	G	3	2	5	0	1	6	0	0
24	31277760	.	C	T	1	3	4	0	0	4	0	0
24	31290487	.	A	C	5	5	10	0	2	12	0	0
24	31311080	.	A	C	14	7	21	0	1	22	0	0
24	31311323	.	C	G	2	4	6	0	12	18	0	0
24	31311334	.	G	C	11	5	16	0	1	17	0	0
24	31313234	.	G	A	12	8	20	0	1	21	0	0
24	31319044	.	A	G	10	6	16	0	0	16	0	0
24	31319592	.	C	T	2	4	6	0	8	14	0	0
24	31320049	.	G	A	8	4	12	0	1	13	0	0
24	31322911	.	G	C	6	0	6	0	13	19	0	0
24	31322950	.	T	G	3	8	11	0	0	11	0	0
24	31323142	.	C	T	7	10	17	0	0	17	0	0
24	31325202	.	T	C	9	3	12	0	0	12	0	0
24	31334313	.	A	G	20	18	38	0	1	39	0	0
24	31340673	.	T	C	34	29	63	0	4	67	0	0
24	31340819	.	A	T	35	24	59	0	2	61	0	0
24	31342807	.	T	C	4	2	6	0	0	6	0	0
24	31342846	.	G	C	2	4	6	0	0	6	0	0
24	31342855	.	G	A	2	3	5	0	0	5	0	0
24	31342883	.	T	A	1	2	3	0	1	4	0	0
24	31346647	.	G	T	15	20	35	0	2	37	0	0
24	31364567	.	G	A	6	2	8	0	0	8	0	0
24	31364622	.	C	T	7	5	12	0	0	12	0	0
24	31367491	.	A	G	5	7	12	0	1	13	0	0
24	31367841	.	C	A	3	4	7	0	0	7	0	0
24	31367851	.	G	A	3	2	5	0	0	5	0	0
24	31367891	.	C	T	2	4	6	0	0	6	0	0
24	31367999	.	A	G	2	6	8	0	0	8	0	0
24	31368370	.	A	T	3	2	5	0	0	5	0	0
24	31368390	.	T	A	4	3	7	0	0	7	0	0
24	31374494	.	T	C	5	7	12	0	0	12	0	0
24	31379444	.	A	C	6	3	9	0	0	9	0	0
24	31390756	.	G	A	0	3	3	0	5	8	0	0
24	31393945	.	T	C	2	5	7	0	0	7	0	0
24	31393957	.	A	T	3	5	8	0	0	8	0	0
24	31397840	.	G	A	10	5	15	0	1	16	0	0
24	31832549	.	G	A	6	12	18	0	1	19	0	0
24	31832615	.	T	G	8	5	13	0	0	13	0	0
24	31832657	.	G	A	7	7	14	0	0	14	0	0
24	31832761	.	G	A	4	3	7	0	0	7	0	0
24	31832970	.	C	T	11	3	14	0	0	14	0	0
24	31833114	.	A	T	8	11	19	0	0	19	0	0
24	31833717	.	A	C	0	7	7	0	0	7	0	0
24	31833991	.	G	A	9	10	19	1	0	20	0	0
24	31834286	.	A	G	9	6	15	0	0	15	0	0
24	31834396	.	G	A	12	7	19	0	1	20	0	0
24	31834681	.	A	T	7	5	12	0	1	13	0	0
24	31836483	.	A	T	11	4	15	0	1	16	0	0
24	31838995	.	C	A	8	7	15	0	0	15	0	0
24	31839067	.	G	A	12	6	18	0	0	18	0	0
24	31842739	.	C	T	5	8	13	0	0	13	0	0
24	31846257	.	C	T	6	9	15	0	0	15	0	0
24	31846270	.	C	T	7	3	10	0	0	10	0	0
24	31850591	.	G	C	1	4	5	0	1	6	0	0
24	31853438	.	C	T	1	2	3	0	0	3	0	0
24	31854349	.	A	G	1	2	3	0	0	3	0	0
24	31942105	.	T	G	11	3	14	2	0	16	0	0
24	31952384	.	G	T	1	2	3	0	0	3	0	0
24	32152862	.	A	G	2	2	4	0	0	4	0	0
24	32163890	.	C	T	3	5	8	0	0	8	0	0
24	32163896	.	C	A	0	3	3	0	6	9	0	0
24	32164054	.	A	G	1	3	4	0	0	4	0	0
24	32168897	.	A	G	2	2	4	0	1	5	0	0
24	32173200	.	A	T	4	7	11	0	0	11	0	0
24	32173646	.	A	G	2	4	6	0	0	6	0	0
24	32176448	.	C	T	11	19	30	0	0	30	0	0
24	32176716	.	G	C	21	20	41	0	4	45	0	0
24	32184363	.	C	T	28	10	38	0	0	38	0	0
24	32184379	.	C	A	28	8	36	0	4	40	0	0
24	32187534	.	G	A	37	12	49	0	4	53	0	0
24	32192622	.	T	C	11	12	23	0	0	23	0	0
24	32415367	.	C	G	2	2	4	0	0	4	0	0
24	32418818	.	G	A	1	2	3	0	0	3	0	0
24	32472919	.	T	C	8	12	20	0	0	20	0	0
24	32473291	.	C	T	12	12	24	0	0	24	0	0
24	32473326	.	C	G	9	0	9	0	11	20	0	0
24	32473386	.	C	T	17	6	23	0	2	25	0	0
24	32473464	.	T	C	7	7	14	0	1	15	0	0
24	32473597	.	G	A	0	10	10	0	9	19	0	0
24	32473829	.	A	G	7	7	14	0	0	14	0	0
24	32474070	.	G	C	3	3	6	0	0	6	0	0
24	32474360	.	A	G	5	2	7	0	1	8	0	0
24	32474439	.	A	T	1	4	5	0	1	6	0	0
24	32474442	.	A	T	2	4	6	0	0	6	0	0
24	32474546	.	A	C	9	6	15	0	0	15	0	0
24	32517984	.	G	A	7	8	15	0	1	16	0	0
24	32519471	.	G	A	22	28	50	0	3	53	0	0
24	32519528	.	C	T	3	24	27	0	21	48	0	0
24	32522462	.	T	A	20	20	40	0	4	44	0	0
24	32522577	.	A	T	13	9	22	0	1	23	0	0
24	32530539	.	A	G	6	8	14	0	2	16	0	0
24	32531527	.	G	A	5	7	12	0	1	13	0	0
24	32533395	.	T	A	7	3	10	0	0	10	0	0
24	32534789	.	C	T	4	6	10	0	0	10	0	0
24	32534867	.	C	T	5	5	10	0	1	11	0	0
24	32547959	.	A	T	4	6	10	0	0	10	0	0
24	32548481	.	A	G	3	4	7	0	1	8	0	0
24	32650263	.	T	G	15	10	25	0	0	25	0	0
24	32658577	.	C	T	8	16	24	0	0	24	0	0
24	32664790	.	A	T	9	11	20	0	1	21	0	0
24	32664823	.	T	G	8	12	20	0	1	21	0	0
24	32664870	.	A	C	8	4	12	0	0	12	0	0
24	32668834	.	G	A	7	3	10	0	0	10	0	0
24	32668880	.	T	A	8	11	19	0	1	20	0	0
24	32674708	.	C	T	6	9	15	0	0	15	0	0
24	33228611	.	A	G	7	18	25	2	0	27	0	0
24	33228620	.	C	T	7	17	24	2	1	27	0	0
24	33234934	.	T	C	6	1	7	0	5	12	0	0
24	33280061	.	C	T	4	5	9	0	0	9	0	0
24	33283197	.	G	A	8	4	12	0	0	12	0	0
24	33284689	.	G	A	8	9	17	0	1	19	1	0
24	33289134	.	G	T	4	5	9	0	0	9	0	0
24	33291528	.	T	C	8	0	8	0	3	11	0	0
24	33291656	.	C	G	6	3	9	0	0	9	0	0
24	33291690	.	C	A	0	2	2	0	5	7	0	0
24	33291698	.	G	A	5	2	7	0	0	7	0	0
24	33400863	.	C	T	4	3	7	0	0	7	0	0
24	33401158	.	C	T	9	7	16	0	0	16	0	0
24	33402901	.	G	A	8	7	15	0	0	15	0	0
24	33403196	.	A	G	7	0	7	0	9	16	0	0
24	33403328	.	G	A	1	3	4	0	6	10	0	0
24	33410992	.	G	A	2	7	9	0	1	10	0	0
24	33411097	.	C	T	4	6	10	0	0	11	1	0
24	33411157	.	A	C	6	7	13	0	0	13	0	0
24	33836491	.	A	G	5	3	8	0	1	9	0	0
24	33836651	.	T	C	1	5	6	0	1	7	0	0
24	33836719	.	A	G	4	4	8	0	0	8	0	0
24	33836733	.	A	G	4	3	7	0	1	8	0	0
24	33837196	.	A	G	5	8	13	0	0	13	0	0
24	33837210	.	A	G	5	8	13	0	0	13	0	0
24	33837790	.	A	G	4	9	13	0	1	14	0	0
24	33837865	.	A	G	3	2	5	0	0	5	0	0
24	33837914	.	A	G	4	2	6	0	1	7	0	0
24	34549405	.	A	G	2	4	6	0	0	6	0	0
24	34607240	.	C	T	16	7	23	0	0	23	0	0
24	34607282	.	C	G	15	9	24	0	1	25	0	0
24	34607366	.	C	A	10	4	14	0	0	14	0	0
24	34608653	.	C	T	15	16	31	0	0	31	0	0
24	34608844	.	C	T	10	8	18	0	0	18	0	0
24	34610215	.	G	T	1	16	17	0	11	28	0	0
24	34610293	.	A	G	9	10	19	0	0	19	0	0
24	34610391	.	T	C	13	14	27	4	0	31	0	0
24	34610515	.	G	A	14	15	29	0	1	30	0	0
24	34610655	.	G	A	1	6	7	0	13	20	0	0
24	34610874	.	A	G	15	15	30	0	3	33	0	0
24	34610920	.	A	T	9	14	23	0	3	26	0	0
24	34611151	.	T	C	17	13	30	0	0	30	0	0
24	34611211	.	G	A	23	12	35	0	0	35	0	0
24	34611236	.	G	A	1	18	19	0	21	40	0	0
24	34611407	.	G	C	15	13	28	0	2	30	0	0
24	34611445	.	A	G	13	17	30	0	3	33	0	0
24	34611681	.	C	T	15	15	30	0	3	33	0	0
24	34611779	.	T	A	12	7	19	0	2	21	0	0
24	34611798	.	C	T	9	6	15	0	0	15	0	0
24	34611885	.	T	A	5	9	14	0	2	16	0	0
24	34611915	.	A	G	7	0	7	0	8	16	1	0
24	34612123	.	A	G	22	7	29	0	0	29	0	0
24	34612160	.	A	G	19	13	32	0	3	35	0	0
24	34612187	.	C	A	20	15	35	0	0	35	0	0
24	34612327	.	A	T	19	11	30	0	2	32	0	0
24	34612564	.	G	A	1	16	17	0	20	37	0	0
24	34973991	.	C	T	9	6	15	0	1	16	0	0
24	34974022	.	C	A	9	10	19	0	0	19	0	0
24	34974105	.	C	T	17	6	23	0	1	24	0	0
24	34974536	.	C	T	4	9	13	0	1	14	0	0
24	34976349	.	T	C	4	12	16	0	0	16	0	0
24	34976465	.	G	A	7	8	15	0	1	16	0	0
24	34979444	.	T	C	11	8	19	0	0	19	0	0
24	34991185	.	A	G	18	12	30	0	1	31	0	0
24	34993400	.	A	G	23	11	34	0	1	35	0	0
24	34993406	.	T	C	24	10	34	0	1	35	0	0
24	34996173	.	C	T	13	13	26	0	1	27	0	0
24	35000961	.	G	T	0	20	20	0	14	34	0	0
24	35002871	.	G	A	14	13	27	0	0	27	0	0
24	35196166	.	C	T	15	17	32	0	0	32	0	0
24	35196205	.	C	G	11	9	20	0	0	20	0	0
24	35213755	.	T	C	13	19	32	0	1	33	0	0
24	35213764	.	G	A	3	19	22	0	15	37	0	0
24	35216439	.	A	T	19	26	45	0	3	48	0	0
24	35216541	.	C	T	23	18	41	0	0	41	0	0
24	35216835	.	A	G	10	10	20	0	1	21	0	0
24	35217255	.	G	A	7	8	15	0	1	16	0	0
24	35217258	.	C	G	6	8	14	0	1	15	0	0
24	35217302	.	T	G	4	6	10	0	0	10	0	0
24	35217308	.	C	T	5	3	8	0	0	8	0	0
24	35218586	.	C	G	1	2	3	0	0	3	0	0
24	35218889	.	A	G	1	6	7	0	0	7	0	0
24	35219219	.	C	T	1	2	3	0	0	3	0	0
24	35232722	.	C	T	1	4	5	0	2	7	0	0
24	35269876	.	T	C	1	2	3	0	0	3	0	0
24	35270459	.	A	G	2	6	8	0	1	9	0	0
24	35720364	.	G	A	10	5	15	0	1	17	1	0
24	35726377	.	A	G	4	7	11	0	1	12	0	0
24	35749830	.	T	C	4	5	9	0	0	9	0	0
24	35767462	.	C	T	2	7	9	0	0	9	0	0
24	36304463	.	T	C	1	3	4	0	1	5	0	0
24	36304471	.	T	A	1	4	5	0	0	5	0	0
24	37604311	.	G	T	1	4	5	0	0	5	0	0
24	37623247	.	A	C	7	5	12	0	2	14	0	0
24	37639393	.	C	A	2	2	4	0	0	4	0	0
24	37647015	.	A	G	1	8	9	0	0	9	0	0
24	37649768	.	C	G	2	2	4	0	0	4	0	0
24	37649783	.	A	G	0	4	4	0	0	4	0	0
24	37649810	.	T	C	2	3	5	0	0	5	0	0
24	37653261	.	C	T	2	6	8	0	0	8	0	0
24	37655196	.	A	T	5	3	8	0	0	8	0	0
24	37655213	.	C	T	3	5	8	0	0	8	0	0
24	37668208	.	T	C	1	2	3	0	0	3	0	0
24	37681556	.	G	T	1	2	3	0	1	4	0	0
24	37685925	.	C	T	5	2	7	0	1	8	0	0
24	37685942	.	C	T	1	5	6	0	2	8	0	0
24	37689919	.	T	C	36	24	60	0	1	61	0	0
24	37692529	.	G	A	27	32	59	0	2	61	0	0
24	37696508	.	T	C	3	4	7	0	0	7	0	0
24	37704287	.	G	C	4	8	12	0	0	12	0	0
24	37708017	.	T	C	2	5	7	0	0	7	0	0
24	37708207	.	T	A	3	6	9	0	0	9	0	0
24	37708288	.	A	C	2	3	5	0	0	5	0	0
24	37709552	.	T	C	3	4	7	0	0	7	0	0
24	37718769	.	T	C	4	5	9	0	0	9	0	0
24	37718813	.	C	T	4	3	7	0	0	7	0	0
24	37721298	.	T	G	3	2	5	0	0	5	0	0
24	37722162	.	T	C	7	4	11	0	0	11	0	0
24	37722245	.	T	C	5	2	7	0	0	7	0	0
24	37722627	.	A	C	2	3	5	0	0	5	0	0
24	37722632	.	T	C	3	2	5	0	0	5	0	0
24	37722702	.	C	A	4	5	9	0	0	9	0	0
24	37722900	.	T	C	4	3	7	0	0	7	0	0
24	37723056	.	G	A	4	5	9	0	0	9	0	0
24	37723096	.	G	A	6	4	10	0	0	10	0	0
24	37723133	.	G	A	5	4	9	0	1	10	0	0
24	37723173	.	A	T	5	6	11	0	1	12	0	0
24	37723950	.	C	A	5	8	13	0	0	13	0	0
24	37724045	.	A	T	5	4	9	0	0	9	0	0
24	37724175	.	A	G	6	9	15	0	1	16	0	0
24	37724206	.	T	C	7	8	15	0	0	15	0	0
24	37724700	.	A	C	6	5	11	0	0	11	0	0
24	37725117	.	T	C	5	5	10	0	0	10	0	0
24	37725260	.	T	G	3	2	5	0	0	5	0	0
24	37725304	.	C	T	6	3	9	0	0	9	0	0
24	37725817	.	G	A	8	2	10	1	1	12	0	0
24	37725860	.	T	G	9	10	19	1	0	20	0	0
24	37726004	.	G	A	7	5	12	0	0	12	0	0
24	37726367	.	C	T	5	7	12	0	1	13	0	0
24	37726377	.	A	G	7	5	12	0	0	12	0	0
24	37726529	.	T	C	4	7	11	0	0	11	0	0
24	37726649	.	G	A	0	7	7	0	8	15	0	0
24	37726867	.	C	G	6	3	9	0	1	10	0	0
24	37726991	.	C	T	8	9	17	0	1	18	0	0
24	37726997	.	G	A	9	8	17	0	0	17	0	0
24	37752430	.	C	T	8	5	13	0	2	15	0	0
24	37774244	.	C	T	3	5	8	0	0	8	0	0
24	37781428	.	G	A	9	7	16	0	0	16	0	0
24	37781446	.	C	T	8	8	16	0	4	20	0	0
24	37791099	.	C	T	8	12	20	0	2	22	0	0
24	37793276	.	C	A	9	8	17	0	0	17	0	0
24	37793282	.	C	T	11	9	20	0	0	20	0	0
24	37793315	.	C	T	9	10	19	0	0	19	0	0
24	37793725	.	C	T	15	6	21	1	1	23	0	0
24	37800119	.	A	T	2	2	4	0	1	5	0	0
24	37800433	.	C	T	4	4	8	0	0	8	0	0
24	37816851	.	T	C	1	2	3	0	0	3	0	0
24	37823458	.	T	G	1	1	2	0	0	2	0	0
24	37823467	.	A	T	1	1	2	0	0	2	0	0
24	37877497	.	G	A	1	2	3	0	2	5	0	0
24	37877544	.	G	T	1	2	3	0	0	3	0	0
24	37888518	.	C	T	2	4	6	0	0	6	0	0
24	37893269	.	A	G	4	2	6	0	0	6	0	0
24	37895022	.	C	T	5	3	8	0	0	8	0	0
24	37896875	.	C	T	4	5	9	0	0	9	0	0
24	37897208	.	G	C	4	4	8	0	0	8	0	0
24	37899479	.	A	T	5	3	8	0	0	8	0	0
24	37900945	.	G	A	0	4	4	0	4	8	0	0
24	37901148	.	A	G	4	2	6	0	0	6	0	0
24	37901178	.	C	T	5	4	9	0	0	9	0	0
24	37941922	.	A	C	8	4	12	0	0	12	0	0
24	37942032	.	C	T	4	7	11	0	0	11	0	0
24	37942183	.	A	T	8	4	12	0	0	12	0	0
24	37942224	.	T	C	8	4	12	0	0	12	0	0
24	37942242	.	A	G	7	4	11	0	0	11	0	0
24	37942423	.	G	A	1	3	4	0	0	4	0	0
24	37942559	.	C	T	6	3	9	0	0	9	0	0
24	37942664	.	T	C	3	6	9	0	0	9	0	0
24	37943052	.	A	G	4	3	7	0	0	7	0	0
24	37943725	.	A	C	2	4	6	0	1	7	0	0
24	37943767	.	C	T	0	2	2	0	5	7	0	0
24	38073247	.	A	G	14	25	39	0	2	41	0	0
24	38073271	.	G	A	16	30	46	0	1	47	0	0
24	38073625	.	A	G	17	32	49	0	4	53	0	0
24	38073712	.	C	T	27	26	53	0	2	55	0	0
24	38073754	.	A	C	31	22	53	0	4	57	0	0
24	38159262	.	C	T	3	4	7	1	0	8	0	0
24	38159274	.	G	T	0	2	2	1	4	7	0	0
24	38159480	.	A	T	1	2	3	0	0	3	0	0
24	38171235	.	C	A	1	3	4	0	0	4	0	0
24	38179208	.	G	C	1	3	4	0	1	5	0	0
24	38188229	.	A	G	2	3	5	0	0	5	0	0
24	38189702	.	A	C	7	7	14	0	0	14	0	0
24	38190199	.	A	G	4	4	8	1	1	10	0	0
24	38190201	.	C	T	5	4	9	1	0	10	0	0
24	38190387	.	T	C	0	1	1	0	1	2	0	0
24	38190396	.	A	C	0	3	3	0	1	4	0	0
24	38190594	.	G	T	0	3	3	0	3	6	0	0
24	38190606	.	A	T	4	3	7	0	0	7	0	0
24	38190654	.	T	C	2	2	4	0	0	4	0	0
24	38190768	.	G	A	1	5	6	0	0	6	0	0
24	38190868	.	A	G	4	5	9	0	0	9	0	0
24	38190894	.	G	A	4	4	8	0	0	8	0	0
24	38190968	.	A	T	2	2	4	0	1	5	0	0
24	38191525	.	A	C	1	5	6	0	0	6	0	0
24	38191537	.	C	T	1	6	7	0	0	7	0	0
24	38191590	.	T	C	1	5	6	0	0	6	0	0
24	38191643	.	A	G	1	2	3	0	0	3	0	0
24	38191652	.	A	T	2	2	4	0	0	4	0	0
24	38369559	.	T	A	23	19	42	0	1	43	0	0
24	38369873	.	G	A	17	31	48	0	1	49	0	0
24	38370188	.	A	G	18	13	31	0	1	32	0	0
24	38370245	.	C	G	2	19	21	0	20	41	0	0
24	38370443	.	C	T	2	16	18	0	19	37	0	0
24	38370998	.	A	G	22	13	35	0	3	38	0	0
24	38371178	.	A	G	14	10	24	0	1	25	0	0
24	38384245	.	A	T	16	10	26	0	1	27	0	0
24	38544812	.	C	T	4	2	6	0	0	6	0	0
24	38544813	.	A	G	4	2	6	0	0	6	0	0
24	38563693	.	G	C	2	5	7	1	0	8	0	0
24	38618980	.	G	A	1	2	3	0	0	3	0	0
24	38619076	.	T	G	3	2	5	0	0	5	0	0
24	38755855	.	A	G	1	2	3	0	0	3	0	0
24	38756179	.	C	T	0	2	2	0	1	3	0	0
24	38815105	.	T	A	4	3	7	0	0	7	0	0
24	38815524	.	G	A	5	3	8	0	0	8	0	0
24	38816010	.	G	T	9	5	14	0	0	14	0	0
24	39051126	.	C	T	9	14	23	0	0	23	0	0
24	39051210	.	C	T	9	3	12	0	3	15	0	0
24	39051803	.	A	C	6	9	15	0	0	15	0	0
24	39051981	.	G	A	0	8	8	0	8	16	0	0
24	39052200	.	C	T	9	11	20	0	0	20	0	0
24	39052236	.	G	T	1	6	7	0	14	21	0	0
24	39052302	.	G	A	10	12	22	0	0	22	0	0
24	39052311	.	C	T	12	9	21	0	1	22	0	0
24	39052410	.	C	T	2	6	8	0	2	10	0	0
24	39073885	.	G	A	0	5	5	0	10	15	0	0
24	39075534	.	T	C	12	10	22	0	2	24	0	0
24	39078597	.	A	G	10	0	10	0	8	18	0	0
24	39137015	.	C	T	8	15	23	0	1	24	0	0
24	39137027	.	G	C	9	14	23	0	2	25	0	0
24	39137777	.	G	A	0	13	13	0	12	25	0	0
24	39137785	.	G	T	11	12	23	0	1	24	0	0
24	39151989	.	A	G	26	8	34	0	0	34	0	0
24	39152001	.	A	G	26	8	34	0	0	34	0	0
24	39152107	.	A	G	12	4	16	0	0	16	0	0
24	39152504	.	A	G	3	9	12	0	0	12	0	0
24	39152523	.	A	G	10	4	14	0	1	15	0	0
24	39152798	.	A	G	15	9	24	0	1	25	0	0
24	39153010	.	C	G	13	4	17	0	0	17	0	0
24	39215736	.	G	T	0	4	4	0	2	6	0	0
24	39268891	.	A	G	17	12	29	0	0	29	0	0
24	39272041	.	A	G	14	9	23	0	0	23	0	0
24	39274821	.	A	G	8	13	21	0	1	22	0	0
24	39277575	.	C	G	14	6	20	0	0	20	0	0
24	39287210	.	A	G	13	13	26	0	3	29	0	0
24	39295664	.	T	C	17	15	32	0	0	32	0	0
24	39298214	.	C	T	15	17	32	0	0	32	0	0
24	39309684	.	A	G	9	0	9	0	17	26	0	0
24	39309889	.	A	T	22	24	46	0	1	47	0	0
24	39310129	.	G	A	11	14	25	0	1	26	0	0
24	39310163	.	G	T	11	12	23	0	2	25	0	0
24	39310253	.	C	T	11	14	25	0	0	25	0	0
24	39321017	.	T	C	22	19	41	0	4	45	0	0
24	39322945	.	G	T	3	23	26	0	20	46	0	0
24	39323791	.	C	T	22	25	47	0	2	49	0	0
24	39333916	.	C	T	18	19	37	1	0	38	0	0
24	39334153	.	T	G	21	19	40	0	1	41	0	0
24	39334388	.	A	G	13	25	38	0	1	39	0	0
24	39334681	.	G	T	11	35	46	0	2	48	0	0
24	39334796	.	G	A	0	8	8	0	14	22	0	0
24	39353424	.	T	C	1	2	3	0	0	3	0	0
24	39353469	.	T	C	2	2	4	0	0	4	0	0
24	39354752	.	G	A	2	2	4	0	0	4	0	0
24	39511034	.	G	A	4	3	7	0	0	7	0	0
24	39511157	.	G	A	5	3	8	0	0	8	0	0
24	39511298	.	A	C	4	5	9	0	0	9	0	0
24	39514075	.	A	C	7	7	14	0	0	14	0	0
24	39514296	.	C	G	10	6	16	0	0	16	0	0
24	39518554	.	C	G	0	11	11	0	8	19	0	0
24	39530034	.	G	A	1	3	4	0	5	9	0	0
24	39533337	.	A	G	4	5	9	0	1	10	0	0
24	39533836	.	C	T	2	6	8	0	1	9	0	0
24	39533987	.	T	A	6	9	15	0	1	16	0	0
24	39534532	.	A	G	2	0	2	0	8	10	0	0
24	39537605	.	C	T	2	3	5	0	0	5	0	0
24	39544398	.	G	A	1	4	5	0	0	5	0	0
24	39549343	.	G	A	1	5	6	0	4	10	0	0
24	39556276	.	G	T	1	4	5	0	2	7	0	0
24	39556324	.	G	A	4	3	7	0	0	7	0	0
24	39556716	.	C	G	4	4	8	0	0	8	0	0
24	39556760	.	G	A	0	3	3	0	7	10	0	0
24	39559205	.	T	C	4	2	6	0	0	6	0	0
24	39559345	.	A	G	5	0	5	0	6	11	0	0
24	39559356	.	C	T	8	4	12	0	1	13	0	0
24	39559386	.	G	A	3	7	10	0	0	10	0	0
24	39576071	.	A	T	4	6	10	0	0	10	0	0
24	39576166	.	G	A	0	3	3	0	3	6	0	0
24	39576247	.	C	T	2	3	5	0	0	5	0	0
24	39576414	.	C	T	3	3	6	0	0	6	0	0
24	39579443	.	C	T	5	9	14	0	0	14	0	0
24	39579989	.	G	A	2	3	5	0	8	13	0	0
24	39586778	.	A	T	7	5	12	0	0	12	0	0
24	39587369	.	C	G	7	6	13	0	0	13	0	0
24	39593038	.	G	A	1	3	4	0	11	15	0	0
24	39595866	.	A	C	6	6	12	0	0	12	0	0
24	39606237	.	G	A	21	17	38	0	0	38	0	0
24	39610535	.	G	T	17	10	27	0	0	27	0	0
24	39615406	.	G	A	17	7	24	3	1	28	0	0
24	39615640	.	G	A	6	3	9	2	1	12	0	0
24	39616170	.	C	A	4	5	9	0	0	9	0	0
24	39627628	.	T	A	1	2	3	0	1	4	0	0
24	39638642	.	G	A	20	22	42	0	0	42	0	0
24	39642072	.	A	T	13	4	17	1	1	19	0	0
24	39642220	.	A	G	9	4	13	0	0	13	0	0
24	39642229	.	A	G	8	5	13	0	0	13	0	0
24	39642336	.	C	A	11	6	17	1	0	18	0	0
24	39642361	.	G	T	11	8	19	0	0	19	0	0
24	39644259	.	T	C	18	17	35	0	0	35	0	0
24	39646762	.	C	T	14	22	36	0	2	38	0	0
24	39647021	.	C	T	17	23	40	0	5	45	0	0
24	39647042	.	G	C	25	19	44	0	1	45	0	0
24	39648806	.	C	T	29	19	48	0	1	49	0	0
24	39651567	.	T	G	27	26	53	0	2	55	0	0
24	39651612	.	A	T	30	15	45	0	1	46	0	0
24	39653626	.	G	A	29	14	43	17	1	61	0	0
24	39660219	.	C	T	16	11	27	0	0	27	0	0
24	39661890	.	T	A	13	12	25	0	0	25	0	0
24	39661905	.	C	T	13	12	25	0	0	25	0	0
24	39662074	.	T	C	18	11	29	0	0	29	0	0
24	39663197	.	A	G	9	17	26	0	3	29	0	0
24	39667348	.	T	C	12	11	23	1	0	24	0	0
24	39742217	.	A	G	9	3	12	0	0	12	0	0
24	39742273	.	G	A	6	6	12	0	0	12	0	0
24	39742336	.	G	A	4	5	9	0	0	9	0	0
24	39742396	.	G	A	7	8	15	0	1	16	0	0
24	39742786	.	T	A	10	16	26	0	1	27	0	0
24	39742869	.	G	T	11	9	20	0	0	20	0	0
24	39771659	.	G	T	5	9	14	0	1	15	0	0
24	39771864	.	T	C	5	3	8	0	0	8	0	0
24	39771976	.	G	A	9	5	14	0	1	15	0	0
24	39771983	.	A	G	8	6	14	0	1	15	0	0
24	39778970	.	C	T	2	2	4	0	0	4	0	0
24	39778982	.	C	G	3	3	6	0	0	6	0	0
24	39779020	.	C	T	4	3	7	0	0	7	0	0
24	39779637	.	A	G	3	2	5	0	0	5	0	0
24	39787653	.	G	C	3	0	3	0	3	6	0	0
24	39799296	.	G	A	1	2	3	0	0	3	0	0
24	39801853	.	C	T	1	3	4	0	0	4	0	0
24	39801874	.	A	G	1	3	4	0	0	4	0	0
24	40489039	.	C	G	6	2	8	1	0	9	0	0
24	40495406	.	G	A	4	3	7	0	0	7	0	0
24	40497825	.	G	A	1	2	3	0	4	7	0	0
24	40497826	.	A	G	3	2	5	0	2	7	0	0
24	40498708	.	G	A	5	6	11	0	0	11	0	0
24	40498712	.	C	A	4	6	10	0	0	10	0	0
24	40608954	.	C	T	19	18	37	0	1	38	0	0
24	40608962	.	G	T	21	14	35	0	1	36	0	0
24	40609001	.	A	G	11	23	34	0	0	35	1	0
24	40624408	.	T	C	12	26	38	1	2	41	0	0
24	40633168	.	T	C	6	7	13	5	1	19	0	0
24	40648270	.	C	T	11	30	41	0	1	42	0	0
24	40648284	.	T	A	30	9	39	2	0	41	0	0
24	40876839	.	G	A	1	2	3	9	0	12	0	0
24	40876873	.	G	T	2	3	5	1	0	6	0	0
24	40881213	.	T	C	6	0	6	2	6	14	0	0
24	40881240	.	T	A	2	6	8	1	1	10	0	0
24	40885816	.	A	G	6	10	16	0	0	16	0	0
24	40885828	.	T	C	7	10	17	0	0	17	0	0
24	40891668	.	G	A	5	2	7	0	0	7	0	0
24	40892759	.	C	T	0	5	5	1	7	13	0	0
24	41220108	.	G	A	1	2	3	0	0	3	0	0
24	41246800	.	G	A	5	2	7	0	0	7	0	0
24	41281276	.	T	G	3	0	3	0	4	7	0	0
24	41291593	.	T	C	7	4	11	0	1	12	0	0
24	41293409	.	G	A	5	6	11	0	0	11	0	0
24	41299605	.	A	T	3	6	9	2	0	11	0	0
24	41473576	.	T	C	17	0	17	0	8	25	0	0
24	41473618	.	G	A	22	5	27	0	0	27	0	0
24	41953649	.	T	G	39	21	60	0	0	60	0	0
24	41964610	.	G	A	1	15	16	0	14	30	0	0
24	41964613	.	A	C	14	14	28	0	2	30	0	0
24	41969781	.	C	A	23	19	42	0	0	42	0	0
24	41972519	.	A	G	21	17	38	0	0	38	0	0
24	41972633	.	C	G	23	1	24	0	23	47	0	0
24	41972638	.	A	T	26	19	45	0	2	47	0	0
24	41974704	.	G	A	23	19	42	0	4	46	0	0
24	41974736	.	C	T	17	19	36	0	2	38	0	0
24	41981865	.	A	G	20	20	40	0	1	42	1	0
24	41986273	.	C	T	20	23	43	1	1	45	0	0
24	41986311	.	C	A	19	23	42	0	1	43	0	0
24	41986626	.	G	C	2	17	19	0	11	30	0	0
24	41989196	.	A	C	9	3	12	0	1	13	0	0
24	41989453	.	T	C	3	5	8	0	0	8	0	0
24	41990626	.	A	T	4	9	13	0	1	14	0	0
24	41990821	.	G	A	0	9	9	0	15	24	0	0
24	41991010	.	A	G	12	7	19	0	0	19	0	0
24	42061316	.	T	A	4	6	10	0	1	11	0	0
24	42061364	.	G	T	5	3	8	0	2	10	0	0
24	42083840	.	G	A	18	17	35	0	1	36	0	0
24	42083906	.	G	A	12	13	25	0	1	26	0	0
24	42090574	.	A	T	23	18	41	0	1	42	0	0
24	42094925	.	G	A	10	4	14	0	0	14	0	0
24	42102416	.	T	A	1	3	4	0	0	4	0	0
24	42102647	.	G	A	3	3	6	0	0	6	0	0
24	42105278	.	C	A	4	5	9	0	0	9	0	0
24	42105443	.	G	A	3	2	5	0	0	5	0	0
24	42117761	.	A	G	5	7	12	0	0	12	0	0
24	42118145	.	C	T	5	9	14	0	2	16	0	0
24	42120459	.	G	C	3	7	10	0	0	10	0	0
24	42138533	.	A	G	16	1	17	0	17	34	0	0
24	42139889	.	C	T	9	6	15	0	1	16	0	0
24	42141460	.	C	T	7	8	15	1	2	18	0	0
24	42141461	.	T	C	7	0	7	1	10	18	0	0
24	42141605	.	G	A	6	19	25	5	2	32	0	0
24	42141770	.	T	C	12	12	24	0	0	24	0	0
24	42141793	.	A	G	12	11	23	0	0	23	0	0
24	42142938	.	C	T	7	8	15	0	0	15	0	0
24	42148189	.	G	A	14	15	29	0	0	29	0	0
24	42153199	.	C	T	9	12	21	0	0	21	0	0
24	42153205	.	C	T	8	12	20	0	0	20	0	0
24	42153241	.	A	G	9	12	21	0	0	21	0	0
24	42153476	.	G	A	0	7	7	0	15	22	0	0
24	42153503	.	G	A	13	6	19	0	0	19	0	0
24	42155187	.	T	C	11	15	26	0	2	28	0	0
24	42157498	.	C	T	6	10	16	0	2	18	0	0
24	42157571	.	A	G	13	10	23	0	0	23	0	0
24	42157602	.	C	T	15	9	24	0	0	24	0	0
24	42157817	.	C	T	7	3	10	1	0	11	0	0
25	13978	.	C	T	24	10	34	0	0	34	0	0
25	14095	.	C	T	15	15	30	0	0	30	0	0
25	14101	.	C	T	15	14	29	0	1	30	0	0
25	15524	.	C	T	16	19	35	0	0	35	0	0
25	15704	.	C	T	24	22	46	0	1	47	0	0
25	127734	.	A	G	3	9	12	0	0	12	0	0
25	127770	.	G	T	0	6	6	0	7	13	0	0
25	136788	.	T	C	16	20	36	2	2	40	0	0
25	137033	.	C	T	10	8	18	0	4	22	0	0
25	137064	.	G	A	1	4	5	0	4	9	0	0
25	137128	.	G	A	0	15	15	0	15	30	0	0
25	137492	.	C	A	9	10	19	1	3	23	0	0
25	146159	.	G	A	2	28	30	0	29	59	0	0
25	146198	.	C	T	29	20	49	0	2	51	0	0
25	146237	.	G	A	28	18	46	0	3	49	0	0
25	146735	.	C	G	21	25	46	0	2	48	0	0
25	146778	.	C	T	24	24	48	0	1	49	0	0
25	146918	.	G	A	17	29	46	0	1	47	0	0
25	154392	.	T	C	13	11	24	0	1	25	0	0
25	154440	.	C	T	12	11	23	0	2	25	0	0
25	157404	.	C	A	6	9	15	0	0	15	0	0
25	158958	.	C	T	18	13	31	0	1	32	0	0
25	159510	.	C	T	18	12	30	0	1	31	0	0
25	160490	.	C	T	15	13	28	0	1	29	0	0
25	168172	.	G	A	3	1	4	0	2	6	0	0
25	196495	.	T	C	28	32	60	0	4	64	0	0
25	203396	.	T	C	27	26	53	0	4	57	0	0
25	238588	.	A	G	5	4	9	0	1	10	0	0
25	244180	.	C	T	1	3	4	0	0	4	0	0
25	252326	.	C	T	8	4	12	0	0	12	0	0
25	254542	.	G	A	0	7	7	0	8	15	0	0
25	260616	.	C	T	7	2	9	0	2	11	0	0
25	260925	.	T	G	14	0	14	1	0	15	0	0
25	261008	.	C	T	8	4	12	0	0	12	0	0
25	261081	.	G	A	8	7	15	0	0	15	0	0
25	261376	.	G	A	7	4	11	0	0	11	0	0
25	267219	.	G	A	3	1	4	0	1	5	0	0
25	267224	.	A	C	5	0	5	0	2	7	0	0
25	315124	.	G	C	2	3	5	0	0	5	0	0
25	315333	.	T	C	2	1	3	0	2	5	0	0
25	316185	.	A	T	2	3	5	0	0	5	0	0
25	316193	.	T	A	3	2	5	0	0	5	0	0
25	317160	.	T	C	1	2	3	0	0	3	0	0
25	321152	.	T	C	2	2	4	0	0	4	0	0
25	321304	.	C	T	1	3	4	0	0	4	0	0
25	399657	.	G	A	5	4	9	0	0	9	0	0
25	399691	.	G	A	5	2	7	0	0	7	0	0
25	399735	.	C	T	4	6	10	0	0	10	0	0
25	399984	.	G	T	9	5	14	0	0	14	0	0
25	400361	.	G	A	1	5	6	0	3	9	0	0
25	401039	.	C	T	4	4	8	0	0	8	0	0
25	401363	.	T	C	8	7	15	0	0	15	0	0
25	401558	.	C	A	14	10	24	0	2	26	0	0
25	402053	.	C	T	5	7	12	0	1	13	0	0
25	402186	.	C	A	3	9	12	0	0	12	0	0
25	403761	.	C	T	3	2	5	0	0	5	0	0
25	404795	.	T	A	6	8	14	0	3	17	0	0
25	405253	.	G	A	6	4	10	0	4	14	0	0
25	469932	.	G	T	29	25	54	0	3	57	0	0
25	469983	.	C	T	28	24	52	0	1	54	1	0
25	472843	.	A	T	27	22	49	0	0	49	0	0
25	474766	.	G	C	29	18	47	0	2	49	0	0
25	474981	.	A	C	31	13	44	0	1	45	0	0
25	474983	.	A	C	14	30	44	0	1	45	0	0
25	485418	.	T	A	2	7	9	0	1	10	0	0
25	485612	.	C	T	4	16	20	0	14	34	0	0
25	485653	.	A	G	24	16	40	0	1	41	0	0
25	485847	.	T	C	20	18	38	0	0	38	0	0
25	486276	.	A	T	12	10	22	0	0	22	0	0
25	486363	.	T	G	15	13	28	0	1	29	0	0
25	486472	.	A	T	9	5	14	0	0	14	0	0
25	486712	.	G	A	6	12	18	1	0	19	0	0
25	486895	.	C	T	9	9	18	0	0	18	0	0
25	487039	.	C	A	13	14	27	0	4	31	0	0
25	487078	.	T	G	14	14	28	0	0	29	1	0
25	487360	.	C	T	0	23	23	1	9	33	0	0
25	489557	.	C	G	1	10	11	0	6	17	0	0
25	494685	.	A	G	11	14	25	0	2	27	0	0
25	502593	.	C	G	0	9	9	0	11	20	0	0
25	504816	.	C	T	10	5	15	0	0	15	0	0
25	509223	.	G	T	11	8	19	0	0	19	0	0
25	509744	.	A	T	6	15	21	0	2	23	0	0
25	509917	.	T	A	8	6	14	0	3	17	0	0
25	510000	.	T	G	8	15	23	0	2	25	0	0
25	510468	.	C	T	2	7	9	0	12	21	0	0
25	510514	.	T	A	14	5	19	0	1	21	1	0
25	513362	.	C	T	6	8	14	0	1	15	0	0
25	518436	.	G	A	12	10	22	0	1	24	1	0
25	523342	.	C	T	1	13	14	0	4	18	0	0
25	525220	.	T	C	6	9	15	0	1	16	0	0
25	527694	.	A	G	13	5	18	0	1	19	0	0
25	527721	.	G	A	9	7	16	1	0	17	0	0
25	535003	.	A	T	10	9	19	0	1	20	0	0
25	538788	.	G	A	8	7	15	0	0	15	0	0
25	552548	.	G	A	8	14	22	0	1	23	0	0
25	552560	.	G	A	14	8	22	0	0	22	0	0
25	552677	.	T	G	8	7	15	0	0	15	0	0
25	552743	.	A	C	8	0	8	0	6	14	0	0
25	552761	.	C	T	1	3	4	0	8	12	0	0
25	552779	.	G	A	5	8	13	0	0	13	0	0
25	582432	.	G	T	23	17	40	0	1	41	0	0
25	582437	.	T	C	23	18	41	0	2	43	0	0
25	582484	.	C	A	23	22	45	0	2	47	0	0
25	615178	.	G	A	14	22	36	0	0	36	0	0
25	617774	.	C	T	24	23	47	0	1	48	0	0
25	617859	.	T	C	19	20	39	0	2	41	0	0
25	626817	.	C	T	20	23	43	0	0	43	0	0
25	640440	.	G	A	5	16	21	0	16	37	0	0
25	663214	.	C	T	25	22	47	0	1	48	0	0
25	664590	.	A	C	26	21	47	0	1	48	0	0
25	713131	.	G	C	5	2	7	0	0	7	0	0
25	763197	.	C	T	10	10	20	0	0	20	0	0
25	764745	.	G	A	14	23	37	0	1	38	0	0
25	769201	.	C	T	1	2	3	0	0	3	0	0
25	771552	.	T	C	1	2	3	0	0	3	0	0
25	771573	.	T	C	3	0	3	0	2	5	0	0
25	773164	.	T	G	4	4	8	0	0	8	0	0
25	824627	.	C	T	0	9	9	0	5	14	0	0
25	824750	.	C	T	0	2	2	0	8	10	0	0
25	824807	.	G	A	12	4	16	0	0	16	0	0
25	824881	.	G	T	8	6	14	0	0	14	0	0
25	824909	.	G	A	7	8	15	0	0	15	0	0
25	825323	.	A	G	8	4	12	0	0	12	0	0
25	825827	.	C	T	1	6	7	0	3	10	0	0
25	826108	.	A	G	4	4	8	0	0	8	0	0
25	826445	.	G	T	2	5	7	0	0	8	1	0
25	826790	.	C	T	5	3	8	0	0	8	0	0
25	827027	.	C	T	2	4	6	0	0	6	0	0
25	827036	.	G	A	4	3	7	0	0	7	0	0
25	827246	.	A	G	5	6	11	0	1	12	0	0
25	827255	.	G	A	6	7	13	0	0	13	0	0
25	827459	.	C	A	3	7	10	0	0	10	0	0
25	836168	.	C	T	0	5	5	0	8	13	0	0
25	867342	.	C	T	0	1	1	0	6	7	0	0
25	946980	.	T	C	1	3	4	0	1	5	0	0
25	1048070	.	G	A	1	2	3	0	0	3	0	0
25	1049179	.	G	C	3	2	5	0	0	5	0	0
25	1049194	.	T	C	4	1	5	0	1	6	0	0
25	1049686	.	G	C	1	3	4	0	0	4	0	0
25	1049940	.	C	T	0	5	5	0	3	8	0	0
25	1066338	.	G	A	2	3	5	2	0	7	0	0
25	1077978	.	C	T	0	3	3	0	2	5	0	0
25	1079356	.	C	G	1	2	3	0	0	3	0	0
25	1088800	.	A	G	1	3	4	0	1	5	0	0
25	1089010	.	G	A	12	15	27	0	1	28	0	0
25	1089026	.	G	A	14	13	27	0	0	27	0	0
25	1091760	.	A	G	8	10	18	0	0	18	0	0
25	1093520	.	G	A	7	8	15	0	0	15	0	0
25	1093526	.	A	G	7	6	13	0	2	15	0	0
25	1093567	.	G	A	10	5	15	0	1	16	0	0
25	1094460	.	T	G	7	7	14	0	0	15	1	0
25	1098649	.	T	C	7	0	7	0	5	12	0	0
25	1098666	.	T	G	7	4	11	0	1	12	0	0
25	1101860	.	A	G	2	2	4	0	1	5	0	0
25	1103486	.	C	T	4	7	11	0	0	11	0	0
25	1104000	.	T	C	4	5	9	0	0	9	0	0
25	1106187	.	G	A	5	5	10	0	1	12	1	0
25	1108057	.	T	C	4	0	4	0	4	8	0	0
25	1116480	.	C	T	4	3	7	0	0	7	0	0
25	1117241	.	G	A	3	3	6	0	1	7	0	0
25	1122013	.	G	T	1	2	3	0	0	3	0	0
25	1122014	.	T	C	1	2	3	0	0	3	0	0
25	1124062	.	G	A	8	8	16	0	0	16	0	0
25	1132543	.	G	A	11	10	21	0	1	22	0	0
25	1133793	.	G	A	0	4	4	0	7	11	0	0
25	1133797	.	T	G	3	6	9	0	0	9	0	0
25	1558383	.	G	A	2	3	5	0	0	5	0	0
25	1558385	.	G	A	0	3	3	0	2	5	0	0
25	1592111	.	G	A	20	22	42	0	1	43	0	0
25	1603727	.	G	A	0	7	7	0	10	17	0	0
25	1603772	.	C	A	13	7	20	0	3	23	0	0
25	1603787	.	G	T	10	9	19	0	2	21	0	0
25	1604543	.	T	G	8	0	8	0	14	22	0	0
25	1605150	.	T	C	11	9	20	0	0	20	0	0
25	1608836	.	C	G	8	12	20	0	1	21	0	0
25	1608857	.	C	G	10	7	17	0	3	20	0	0
25	1624547	.	C	A	14	20	34	0	1	35	0	0
25	1624777	.	G	A	16	14	30	0	0	30	0	0
25	1635419	.	G	A	7	4	11	0	0	11	0	0
25	1635714	.	C	G	20	7	27	0	0	27	0	0
25	1635783	.	G	A	16	9	25	0	2	28	1	0
25	1635786	.	C	T	3	8	11	0	16	27	0	0
25	1635879	.	G	A	18	13	31	0	0	31	0	0
25	1639932	.	G	T	9	11	20	0	2	23	1	0
25	1642066	.	C	T	20	10	30	0	1	31	0	0
25	1642319	.	C	A	6	16	22	0	1	23	0	0
25	1644857	.	C	T	8	11	19	0	2	21	0	0
25	1652138	.	C	T	1	9	10	0	9	19	0	0
25	1652294	.	G	A	10	6	16	0	1	17	0	0
25	1652450	.	A	G	12	6	18	0	0	18	0	0
25	1652513	.	G	A	11	9	20	0	0	20	0	0
25	1652543	.	C	T	1	8	9	0	11	20	0	0
25	1652591	.	A	G	8	8	16	0	0	16	0	0
25	1652766	.	C	A	15	6	21	0	1	22	0	0
25	1652793	.	C	T	1	8	9	0	10	19	0	0
25	1652916	.	G	A	6	9	15	0	0	15	0	0
25	1654432	.	G	T	13	9	22	0	0	22	0	0
25	1655408	.	G	A	8	7	15	0	1	16	0	0
25	1655502	.	G	A	12	8	20	0	0	20	0	0
25	1655535	.	G	C	10	7	17	0	1	18	0	0
25	1655537	.	G	A	11	7	18	0	0	18	0	0
25	1660233	.	G	A	9	8	17	1	0	18	0	0
25	1660255	.	G	T	8	5	13	1	0	14	0	0
25	1662047	.	G	A	6	9	15	1	0	16	0	0
25	1670785	.	T	C	10	5	15	0	1	16	0	0
25	1670878	.	T	C	5	6	11	0	1	12	0	0
25	1672306	.	A	G	4	10	14	0	0	14	0	0
25	1672911	.	C	T	14	4	18	0	1	19	0	0
25	1672920	.	G	T	4	12	16	0	0	16	0	0
25	1680477	.	G	A	5	5	10	0	0	10	0	0
25	1681344	.	A	C	5	6	11	0	0	11	0	0
25	1687455	.	A	G	7	6	13	0	2	15	0	0
25	3012715	.	A	G	4	2	6	0	0	6	0	0
25	3245895	.	A	G	7	4	11	0	0	11	0	0
25	3246577	.	T	C	1	11	12	1	0	13	0	0
25	3246593	.	A	G	11	3	14	2	1	17	0	0
25	3451196	.	T	A	10	4	14	0	1	15	0	0
25	3451250	.	A	C	14	9	23	1	1	25	0	0
25	3451760	.	A	C	10	10	20	0	1	21	0	0
25	3451779	.	A	G	9	5	14	0	1	15	0	0
25	3453651	.	G	A	12	16	28	0	0	28	0	0
25	3454644	.	G	A	13	6	19	0	1	20	0	0
25	3454719	.	G	A	16	8	24	0	0	24	0	0
25	3457756	.	G	A	5	11	16	0	0	16	0	0
25	3461097	.	C	G	2	13	15	0	12	27	0	0
25	3465854	.	G	A	6	6	12	0	3	15	0	0
25	3465905	.	C	G	0	4	4	0	17	21	0	0
25	3465911	.	A	G	5	15	20	0	2	22	0	0
25	3469502	.	G	A	4	11	15	0	0	15	0	0
25	3478467	.	G	T	11	16	27	0	1	28	0	0
25	3478617	.	C	T	15	15	30	0	1	31	0	0
25	3481088	.	G	T	14	13	27	0	0	27	0	0
25	3483727	.	G	A	14	15	29	0	3	32	0	0
25	3513274	.	G	A	4	2	6	0	0	6	0	0
25	3528738	.	T	C	4	3	7	0	0	7	0	0
25	3529701	.	G	A	1	3	4	0	3	7	0	0
25	3529758	.	C	T	8	4	12	0	0	12	0	0
25	3529806	.	A	G	3	6	9	0	1	10	0	0
25	3536269	.	G	A	6	4	10	0	0	10	0	0
25	3536279	.	G	T	6	3	9	0	0	9	0	0
25	3536470	.	G	T	1	2	3	0	0	3	0	0
25	3536512	.	A	T	4	6	10	0	0	10	0	0
25	3542072	.	G	T	2	2	4	0	0	4	0	0
25	3544210	.	G	A	2	3	5	0	0	5	0	0
25	3544253	.	G	A	4	3	7	0	0	7	0	0
25	3546464	.	G	A	10	3	13	0	0	13	0	0
25	3546488	.	A	C	9	3	12	0	1	13	0	0
25	3550991	.	C	T	3	2	5	0	0	5	0	0
25	3552350	.	A	G	2	6	8	0	0	8	0	0
25	3557470	.	G	A	0	8	8	0	6	14	0	0
25	3560066	.	G	A	0	3	3	0	3	6	0	0
25	3573266	.	T	G	2	2	4	2	0	6	0	0
25	3573283	.	A	G	3	3	6	2	0	8	0	0
25	3573350	.	G	A	3	6	9	0	0	9	0	0
25	3573624	.	G	C	6	6	12	0	0	12	0	0
25	3573635	.	A	T	8	7	15	0	0	15	0	0
25	3573796	.	C	A	0	8	8	0	7	15	0	0
25	3573815	.	G	A	7	6	13	0	1	14	0	0
25	3579429	.	A	C	7	8	15	0	0	15	0	0
25	3579459	.	C	A	6	7	13	0	1	14	0	0
25	3582443	.	A	G	6	5	11	0	0	11	0	0
25	3583975	.	C	T	12	4	16	0	1	18	1	0
25	3583983	.	G	T	11	5	16	0	1	18	1	0
25	3584053	.	G	A	5	10	15	0	0	15	0	0
25	3584156	.	T	C	8	0	8	0	9	17	0	0
25	3590931	.	G	A	6	2	8	0	0	8	0	0
25	3594911	.	T	C	8	5	13	0	1	14	0	0
25	3595118	.	G	A	5	3	8	0	0	8	0	0
25	3595120	.	C	T	0	3	3	0	5	8	0	0
25	3596319	.	C	T	1	7	8	0	2	10	0	0
25	3596361	.	T	G	4	8	12	0	0	12	0	0
25	3599390	.	A	G	0	2	2	0	1	3	0	0
25	3606970	.	C	T	6	3	9	0	0	9	0	0
25	3607015	.	A	G	6	7	13	1	0	14	0	0
25	3607033	.	G	C	5	1	6	1	6	13	0	0
25	3623403	.	T	C	3	2	5	0	1	6	0	0
25	3623573	.	T	G	3	2	5	0	0	5	0	0
25	3623921	.	C	T	1	4	5	0	0	5	0	0
25	3638484	.	T	G	1	4	5	0	0	5	0	0
25	3641123	.	C	T	2	2	4	0	6	10	0	0
25	3641160	.	G	A	3	3	6	0	3	9	0	0
25	3644524	.	A	G	2	4	6	0	2	8	0	0
25	3677703	.	G	A	1	21	22	0	21	43	0	0
25	3682253	.	C	T	18	25	43	0	2	45	0	0
25	3682610	.	G	A	1	14	15	0	19	34	0	0
25	3682789	.	G	A	28	26	54	0	2	56	0	0
25	3682795	.	A	C	27	27	54	0	1	55	0	0
25	3683247	.	G	A	28	25	53	0	2	55	0	0
25	3683297	.	C	T	29	25	54	0	1	55	0	0
25	3683386	.	C	T	24	20	44	0	5	49	0	0
25	3683527	.	G	A	3	19	22	0	17	39	0	0
25	3683796	.	A	T	10	9	19	0	3	22	0	0
25	3683887	.	C	T	23	14	37	0	2	39	0	0
25	3684141	.	C	A	25	26	51	0	2	53	0	0
25	3684148	.	A	G	25	27	52	0	2	54	0	0
25	3684195	.	G	A	2	13	15	11	26	52	0	0
25	3684409	.	G	T	4	20	24	2	39	65	0	0
25	3684741	.	A	G	23	22	45	0	0	45	0	0
25	3708429	.	G	T	4	5	9	0	1	10	0	0
25	3713652	.	T	C	12	0	12	0	13	25	0	0
25	3713724	.	T	C	13	7	20	0	0	20	0	0
25	3719768	.	T	C	3	7	10	0	1	11	0	0
25	3719888	.	G	T	15	12	27	0	1	28	0	0
25	3721726	.	G	C	12	0	12	0	8	20	0	0
25	3725000	.	G	A	8	11	19	0	0	19	0	0
25	3739815	.	T	G	3	4	7	0	0	7	0	0
25	3750559	.	T	C	10	4	14	0	0	14	0	0
25	3750655	.	C	T	11	14	25	0	0	25	0	0
25	3754606	.	G	A	11	10	21	0	3	24	0	0
25	3755271	.	G	A	14	10	24	0	1	25	0	0
25	3755303	.	A	G	15	15	30	0	0	30	0	0
25	3757584	.	G	A	9	7	16	0	0	16	0	0
25	3757606	.	G	A	4	8	12	0	0	12	0	0
25	3757670	.	C	T	7	7	14	0	2	16	0	0
25	3758022	.	T	C	5	6	11	0	0	11	0	0
25	3765659	.	G	A	0	7	7	0	3	10	0	0
25	3765897	.	G	A	2	4	6	0	0	6	0	0
25	3772165	.	T	C	2	4	6	0	1	7	0	0
25	3774637	.	A	C	5	8	13	0	0	13	0	0
25	3774681	.	G	A	4	8	12	0	0	12	0	0
25	3774705	.	A	T	3	11	14	0	0	14	0	0
25	3777625	.	T	G	5	9	14	0	1	15	0	0
25	3777795	.	G	C	1	2	3	0	4	7	0	0
25	3779091	.	T	C	1	6	7	0	0	7	0	0
25	3782576	.	T	C	5	9	14	0	0	14	0	0
25	3788564	.	T	C	11	6	17	0	1	18	0	0
25	3789004	.	G	A	2	8	10	0	10	20	0	0
25	3790279	.	G	A	1	8	9	0	11	20	0	0
25	3790373	.	T	A	2	2	4	0	0	4	0	0
25	3792945	.	A	G	23	11	34	0	0	34	0	0
25	3793096	.	T	C	14	12	26	0	3	29	0	0
25	3793141	.	T	A	10	3	13	0	1	14	0	0
25	3794975	.	A	G	12	0	12	0	18	30	0	0
25	3800590	.	C	T	12	6	18	0	1	19	0	0
25	3801310	.	C	T	3	3	6	0	0	6	0	0
25	3801505	.	T	G	8	3	11	0	0	11	0	0
25	3801726	.	A	G	5	11	16	0	1	17	0	0
25	3801737	.	T	C	6	13	19	0	2	21	0	0
25	3804410	.	A	G	16	25	41	0	0	41	0	0
25	3807526	.	C	T	0	12	12	0	18	30	0	0
25	3808572	.	T	A	12	7	19	0	1	20	0	0
25	3868516	.	C	G	4	2	6	0	0	6	0	0
25	3881424	.	G	A	0	2	2	0	6	8	0	0
25	3881608	.	T	C	0	2	2	0	2	4	0	0
25	3887287	.	C	T	1	6	7	0	0	7	0	0
25	3891940	.	A	T	17	29	46	0	1	47	0	0
25	3898332	.	A	G	17	10	27	0	1	28	0	0
25	3898449	.	T	C	14	0	14	0	10	24	0	0
25	3898483	.	C	T	16	10	26	0	0	26	0	0
25	3898566	.	G	T	8	9	17	0	2	19	0	0
25	3898572	.	C	A	1	9	10	0	10	20	0	0
25	3899039	.	A	C	10	16	26	0	1	27	0	0
25	3899169	.	C	T	15	15	30	0	2	32	0	0
25	3903316	.	A	T	14	12	26	0	1	27	0	0
25	3903317	.	C	G	15	13	28	0	0	28	0	0
25	3906840	.	A	C	21	0	21	0	24	46	1	0
25	3907063	.	A	G	28	21	49	0	3	52	0	0
25	3910957	.	A	G	18	7	25	0	0	25	0	0
25	3913568	.	G	A	17	16	33	0	0	33	0	0
25	3915284	.	C	A	0	14	14	0	12	26	0	0
25	4097514	.	T	C	8	10	18	0	0	18	0	0
25	4111974	.	G	A	3	2	5	0	0	5	0	0
25	4112013	.	C	T	2	5	7	0	0	7	0	0
25	4113930	.	T	C	4	11	15	1	1	17	0	0
25	4117899	.	C	T	5	4	9	0	2	11	0	0
25	4126771	.	G	A	2	6	8	0	0	8	0	0
25	4129075	.	G	T	6	6	12	0	0	12	0	0
25	4129093	.	T	A	4	5	9	0	0	9	0	0
25	4129131	.	C	A	9	3	12	0	0	12	0	0
25	4129165	.	C	A	10	6	16	0	0	16	0	0
25	4133498	.	T	C	14	16	30	0	0	30	0	0
25	4133647	.	C	A	18	9	27	0	0	27	0	0
25	4133648	.	T	C	18	0	18	0	9	27	0	0
25	4133708	.	T	G	26	15	41	0	1	42	0	0
25	4133720	.	C	A	27	17	44	0	1	45	0	0
25	4136001	.	C	A	23	16	39	0	2	41	0	0
25	4136292	.	A	G	18	13	31	0	4	35	0	0
25	4141629	.	G	A	13	12	25	0	0	25	0	0
25	4460165	.	T	C	16	9	25	0	1	26	0	0
25	4460441	.	G	A	15	21	36	0	2	38	0	0
25	4479442	.	A	G	17	17	34	0	0	34	0	0
25	4479613	.	G	C	10	12	22	0	0	22	0	0
25	4581599	.	T	C	1	3	4	0	0	4	0	0
25	4689362	.	A	G	2	2	4	0	0	4	0	0
25	4708201	.	T	G	2	3	5	0	0	5	0	0
25	4717246	.	C	T	1	6	7	0	5	12	0	0
25	4723885	.	A	G	4	2	6	0	0	6	0	0
25	4733021	.	A	G	7	3	10	0	0	10	0	0
25	4837937	.	G	C	18	13	31	0	0	31	0	0
25	4838118	.	A	G	17	18	35	0	4	39	0	0
25	4841406	.	T	C	26	19	45	0	0	45	0	0
25	4843398	.	A	G	24	15	39	0	1	40	0	0
25	4846836	.	T	C	30	25	55	0	0	55	0	0
25	4848808	.	C	T	25	15	40	0	0	40	0	0
25	4849326	.	A	G	24	0	24	0	20	44	0	0
25	4849422	.	T	A	26	16	42	0	1	43	0	0
25	4849453	.	C	T	25	18	43	0	1	44	0	0
25	4850969	.	C	G	21	0	21	0	18	39	0	0
25	4850989	.	G	A	23	18	41	0	3	44	0	0
25	4855650	.	T	C	2	2	4	0	0	4	0	0
25	4867781	.	C	G	5	2	7	0	0	7	0	0
25	4871568	.	T	C	5	3	8	0	1	9	0	0
25	4871597	.	G	A	1	3	4	0	4	8	0	0
25	4873979	.	T	C	3	5	8	0	1	9	0	0
25	4874000	.	G	T	4	3	7	0	0	7	0	0
25	4876366	.	A	G	1	0	1	0	7	8	0	0
25	4877685	.	A	G	5	2	7	0	1	8	0	0
25	4877781	.	C	A	4	7	11	0	0	11	0	0
25	4879937	.	T	A	8	6	14	0	0	14	0	0
25	4879964	.	C	T	8	4	12	0	0	12	0	0
25	4879973	.	A	C	7	5	12	0	0	12	0	0
25	4880030	.	G	A	5	8	13	0	0	13	0	0
25	4880138	.	A	C	6	2	8	0	0	8	0	0
25	4880144	.	A	G	7	0	7	0	2	9	0	0
25	4880363	.	C	T	1	4	5	0	0	5	0	0
25	4880372	.	T	A	1	5	6	0	0	6	0	0
25	4883338	.	A	G	6	0	6	0	4	10	0	0
25	4891272	.	G	A	49	22	71	0	0	71	0	0
25	4891286	.	A	T	42	26	68	0	3	71	0	0
25	4891350	.	C	T	22	38	60	0	3	63	0	0
25	4891538	.	A	G	21	28	49	1	3	53	0	0
25	4891597	.	G	A	20	26	46	0	5	51	0	0
25	4891762	.	C	G	18	29	47	0	0	47	0	0
25	4891867	.	T	C	21	1	22	0	10	32	0	0
25	4891882	.	C	T	16	9	25	0	0	25	0	0
25	4892010	.	A	C	4	23	27	0	0	27	0	0
25	4892172	.	G	T	19	34	53	0	1	54	0	0
25	4892203	.	T	A	17	32	49	0	4	53	0	0
25	4892291	.	T	C	24	36	60	0	4	64	0	0
25	4892537	.	A	G	25	28	53	1	0	54	0	0
25	4892830	.	C	T	24	29	53	0	0	53	0	0
25	4892982	.	T	C	8	30	38	0	0	38	0	0
25	4892985	.	T	C	8	29	37	0	0	37	0	0
25	4893024	.	A	C	9	16	25	0	0	25	0	0
25	4893049	.	T	C	8	10	18	0	1	19	0	0
25	4893059	.	G	A	6	7	13	0	2	15	0	0
25	4893176	.	C	T	1	5	6	0	10	16	0	0
25	4893193	.	A	C	8	11	19	0	0	19	0	0
25	4893214	.	T	G	10	18	28	0	2	30	0	0
25	4893238	.	A	G	9	26	35	0	2	37	0	0
25	4893304	.	G	T	6	40	46	0	1	47	0	0
25	4893398	.	T	C	24	42	66	0	0	66	0	0
25	4893435	.	C	T	24	42	66	0	1	67	0	0
25	4896182	.	A	G	23	23	46	0	2	48	0	0
25	4896281	.	A	C	20	1	21	0	24	45	0	0
25	4896290	.	A	G	16	25	41	0	4	45	0	0
25	4897187	.	T	A	14	32	46	0	0	46	0	0
25	4899071	.	G	A	9	28	37	0	1	38	0	0
25	4902538	.	A	T	17	30	47	0	1	48	0	0
25	4902586	.	T	C	17	1	18	0	27	45	0	0
25	4904387	.	A	G	9	19	28	0	1	29	0	0
25	5018352	.	C	T	1	4	5	0	0	5	0	0
25	5028992	.	T	A	2	3	5	0	0	5	0	0
25	5189406	.	C	T	2	6	8	0	3	11	0	0
25	5189445	.	T	C	6	1	7	4	8	19	0	0
25	5604947	.	T	C	1	5	6	0	1	7	0	0
25	5605252	.	A	G	2	0	2	0	3	5	0	0
25	5605309	.	T	C	4	3	7	0	0	7	0	0
25	5605370	.	T	C	3	2	5	0	0	5	0	0
25	5605507	.	G	T	1	3	4	0	0	4	0	0
25	5605518	.	C	A	1	3	4	0	0	4	0	0
25	5624240	.	A	C	6	5	11	0	1	12	0	0
25	5627518	.	G	A	0	3	3	0	3	6	0	0
25	5634058	.	C	T	3	3	6	0	0	6	0	0
25	5636152	.	G	A	3	3	6	0	1	7	0	0
25	5636158	.	C	T	3	4	7	0	0	7	0	0
25	5636188	.	C	T	3	5	8	0	0	8	0	0
25	5654679	.	G	T	0	3	3	0	4	7	0	0
25	5654724	.	A	C	4	3	7	0	1	8	0	0
25	5666904	.	C	T	3	4	7	0	1	8	0	0
25	5666925	.	A	G	4	3	7	0	0	7	0	0
25	5679314	.	A	T	1	8	9	0	2	11	0	0
25	5702160	.	G	T	19	22	41	0	0	41	0	0
25	5709328	.	T	G	16	22	38	0	2	40	0	0
25	5709381	.	C	T	2	9	11	0	18	29	0	0
25	5710949	.	C	G	11	21	32	0	4	36	0	0
25	5713704	.	G	C	13	1	14	0	22	37	1	0
25	5722072	.	A	G	23	17	40	0	3	43	0	0
25	5724887	.	C	T	2	10	12	0	18	30	0	0
25	5724905	.	G	A	11	20	31	0	0	31	0	0
25	5730936	.	A	T	13	16	29	0	1	30	0	0
25	5733681	.	G	A	14	8	22	0	0	22	0	0
25	5733684	.	G	A	15	8	23	0	0	23	0	0
25	5734392	.	C	T	0	5	5	0	14	19	0	0
25	5736673	.	C	T	0	18	18	0	12	30	0	0
25	5765760	.	A	G	3	0	3	0	7	10	0	0
25	5768774	.	C	G	3	6	9	0	0	9	0	0
25	5770764	.	C	T	1	8	9	0	0	9	0	0
25	5774925	.	C	T	6	8	14	0	1	15	0	0
25	5774984	.	C	G	7	9	16	0	2	18	0	0
25	5774990	.	T	A	8	9	17	0	0	17	0	0
25	5775124	.	C	T	11	9	20	0	0	20	0	0
25	5775139	.	T	A	12	6	18	0	2	20	0	0
25	5775423	.	G	A	2	5	7	0	7	14	0	0
25	5775497	.	T	C	4	8	12	0	1	13	0	0
25	5775498	.	C	T	4	8	12	0	0	12	0	0
25	5775536	.	T	A	9	4	13	0	1	14	0	0
25	5775552	.	C	T	12	3	15	0	0	15	0	0
25	5775605	.	G	C	5	4	9	0	0	9	0	0
25	5775638	.	G	C	6	5	11	0	0	11	0	0
25	5775697	.	G	A	7	5	12	0	0	12	0	0
25	5776138	.	G	A	2	4	6	0	14	20	0	0
25	5776822	.	G	A	0	8	8	0	6	14	0	0
25	5776920	.	T	A	2	4	6	0	2	8	0	0
25	5776966	.	G	C	3	2	5	0	1	6	0	0
25	5777032	.	T	A	7	10	17	0	0	17	0	0
25	5777674	.	G	A	6	11	17	0	0	17	0	0
25	5778797	.	C	T	4	8	12	0	0	12	0	0
25	5779557	.	G	A	8	6	14	0	0	14	0	0
25	5780633	.	T	C	9	7	16	0	1	17	0	0
25	5783309	.	T	C	12	11	23	0	1	24	0	0
25	5783523	.	C	T	8	8	16	0	0	16	0	0
25	5783598	.	T	A	5	6	11	0	0	11	0	0
25	5786668	.	T	C	5	3	8	0	0	8	0	0
25	5787684	.	C	T	5	11	16	0	1	17	0	0
25	5787966	.	C	A	7	11	18	0	2	20	0	0
25	5788212	.	A	G	1	4	5	0	0	5	0	0
25	5788244	.	T	G	1	3	4	0	0	4	0	0
25	5788310	.	T	C	5	5	10	0	1	11	0	0
25	5788321	.	C	T	6	8	14	0	0	14	0	0
25	5788384	.	C	T	9	8	17	0	1	18	0	0
25	5788432	.	A	G	12	6	18	0	1	19	0	0
25	5788519	.	G	T	5	10	15	0	1	16	0	0
25	5788670	.	C	T	2	16	18	0	17	35	0	0
25	5788783	.	G	C	19	12	31	0	1	32	0	0
25	5788838	.	A	G	7	7	14	0	0	14	0	0
25	5788842	.	C	T	1	7	8	0	5	13	0	0
25	5788968	.	C	T	0	4	4	0	3	7	0	0
25	5789625	.	T	A	12	7	19	0	0	19	0	0
25	5789626	.	T	C	12	0	12	0	7	19	0	0
25	5789660	.	A	T	9	6	15	0	0	15	0	0
25	5789721	.	G	A	5	6	11	0	1	12	0	0
25	5789734	.	G	C	6	4	10	0	0	10	0	0
25	5789937	.	A	C	8	9	17	0	0	17	0	0
25	5790050	.	T	G	8	9	17	0	1	19	1	0
25	5790341	.	C	G	8	9	17	0	0	17	0	0
25	5790414	.	A	T	8	7	15	0	1	16	0	0
25	5790500	.	T	C	6	3	9	0	0	9	0	0
25	5790556	.	T	C	13	3	16	0	4	20	0	0
25	5790558	.	T	G	18	3	21	0	1	22	0	0
25	5790742	.	G	A	10	12	22	0	0	22	0	0
25	5796606	.	A	G	13	14	27	0	3	30	0	0
25	5796675	.	A	C	18	0	18	0	12	30	0	0
25	5803529	.	A	G	15	8	23	0	0	23	0	0
25	5805328	.	G	A	19	10	29	0	0	29	0	0
25	5805346	.	G	T	21	11	32	0	1	33	0	0
25	5805382	.	G	A	15	9	24	0	0	24	0	0
25	5815822	.	G	A	4	5	9	0	0	9	0	0
25	5835564	.	T	C	16	9	25	0	0	26	1	0
25	5936080	.	C	T	6	4	10	0	1	11	0	0
25	5936556	.	A	T	4	16	20	0	1	21	0	0
25	5936725	.	T	A	20	11	31	0	1	32	0	0
25	5936764	.	C	A	18	13	31	0	0	31	0	0
25	5936886	.	C	T	0	6	6	0	5	11	0	0
25	5937424	.	T	G	13	3	16	1	2	19	0	0
25	5937516	.	C	T	1	15	16	0	22	38	0	0
25	5937686	.	G	C	16	2	18	0	27	45	0	0
25	5938065	.	A	T	6	9	15	0	0	15	0	0
25	5938694	.	G	A	1	5	6	0	0	6	0	0
25	5938858	.	A	C	11	8	19	0	1	20	0	0
25	5938881	.	G	T	9	7	16	0	0	16	0	0
25	5938895	.	C	T	7	6	13	0	0	13	0	0
25	5939052	.	C	A	9	2	11	0	1	12	0	0
25	5939484	.	C	T	8	10	18	0	0	18	0	0
25	5939569	.	T	C	8	7	15	0	0	15	0	0
25	5940272	.	T	C	9	5	14	0	1	15	0	0
25	5944304	.	G	A	2	9	11	0	0	11	0	0
25	5947539	.	G	A	4	8	12	0	0	12	0	0
25	5962763	.	C	T	1	11	12	0	11	23	0	0
25	5963021	.	T	A	1	4	5	0	0	5	0	0
25	5986994	.	A	G	30	1	31	0	33	64	0	0
25	5990107	.	A	C	17	10	27	0	1	28	0	0
25	6010948	.	C	A	3	3	6	0	0	6	0	0
25	6010983	.	C	A	0	2	2	0	0	2	0	0
25	6016708	.	G	A	5	3	8	0	0	8	0	0
25	6016829	.	C	T	12	4	16	0	1	17	0	0
25	6017382	.	A	T	13	7	20	0	1	21	0	0
25	6017623	.	C	T	1	9	10	0	11	21	0	0
25	6025278	.	C	A	15	7	22	0	0	22	0	0
25	6025326	.	G	T	9	10	19	0	0	19	0	0
25	6026106	.	G	A	4	15	19	0	2	21	0	0
25	6028947	.	G	A	6	8	14	0	0	14	0	0
25	6042871	.	G	A	7	7	14	0	1	15	0	0
25	6049177	.	G	A	11	15	26	0	1	27	0	0
25	6051785	.	G	T	0	3	3	0	2	5	0	0
25	6056910	.	T	A	3	2	5	0	0	5	0	0
25	6056915	.	G	T	2	3	5	0	0	5	0	0
25	6065026	.	A	T	5	4	9	0	0	9	0	0
25	6065064	.	G	A	6	4	10	0	0	10	0	0
25	6065094	.	G	A	6	2	8	0	0	8	0	0
25	6065121	.	T	G	4	4	8	0	0	8	0	0
25	6069635	.	T	G	3	4	7	0	1	8	0	0
25	6069639	.	A	T	3	5	8	0	1	9	0	0
25	6076542	.	C	T	3	4	7	0	0	7	0	0
25	6079096	.	C	A	3	5	8	0	0	8	0	0
25	6079207	.	A	G	4	3	7	0	0	7	0	0
25	6142178	.	C	T	1	2	3	0	0	3	0	0
25	6186933	.	A	G	12	16	28	0	2	30	0	0
25	6202870	.	T	A	7	11	18	0	1	19	0	0
25	6203292	.	A	G	9	13	22	0	0	22	0	0
25	6205703	.	C	T	12	19	31	0	1	32	0	0
25	6206304	.	A	G	2	0	2	0	3	5	0	0
25	6216349	.	A	C	17	15	32	0	3	35	0	0
25	6222555	.	G	A	18	16	34	0	0	34	0	0
25	6222600	.	C	A	0	17	17	0	16	34	1	0
25	6228616	.	G	A	7	7	14	0	0	14	0	0
25	6228651	.	A	G	8	11	19	0	0	19	0	0
25	6230616	.	G	A	13	12	25	0	0	25	0	0
25	6230721	.	T	C	15	6	21	0	0	21	0	0
25	6230736	.	T	G	11	8	19	0	1	20	0	0
25	6230935	.	T	C	10	10	20	0	0	20	0	0
25	6233485	.	C	T	12	14	26	0	1	27	0	0
25	6237656	.	G	A	6	3	9	0	2	11	0	0
25	6237674	.	T	C	5	0	5	0	4	9	0	0
25	6237993	.	A	G	9	7	16	0	1	17	0	0
25	6239911	.	T	C	8	3	11	0	0	11	0	0
25	6240154	.	G	A	8	6	14	0	0	14	0	0
25	6242742	.	C	T	5	9	14	0	1	15	0	0
25	6245099	.	A	G	6	8	14	0	0	14	0	0
25	6276817	.	A	T	2	3	5	0	0	5	0	0
25	6288353	.	G	C	9	14	23	0	2	25	0	0
25	6292481	.	C	T	2	10	12	0	7	19	0	0
25	6312955	.	A	C	28	35	63	0	0	63	0	0
25	6313069	.	G	A	3	36	39	0	26	65	0	0
25	6313075	.	T	C	30	29	59	0	6	65	0	0
25	6337253	.	A	T	17	17	34	0	4	38	0	0
25	6337271	.	C	A	20	16	36	0	0	36	0	0
25	6351282	.	A	G	5	7	12	0	0	12	0	0
25	6351283	.	C	G	6	7	13	0	0	13	0	0
25	6357227	.	C	T	7	10	17	0	0	17	0	0
25	6357245	.	C	T	0	7	7	0	9	16	0	0
25	6357451	.	T	C	3	6	9	0	0	9	0	0
25	6357503	.	G	A	7	8	15	0	0	15	0	0
25	6360049	.	T	A	8	10	18	0	0	18	0	0
25	6360225	.	T	C	7	16	23	0	1	24	0	0
25	6365322	.	T	C	10	7	17	0	1	18	0	0
25	6365361	.	C	A	9	8	17	0	0	17	0	0
25	6365394	.	G	T	10	9	19	0	0	19	0	0
25	6365415	.	T	C	9	7	16	0	0	16	0	0
25	6366800	.	T	G	6	6	12	0	1	13	0	0
25	6366888	.	G	A	3	4	7	0	1	8	0	0
25	6370171	.	C	T	1	5	6	0	7	13	0	0
25	6370184	.	T	C	4	3	7	0	2	9	0	0
25	6377669	.	G	C	5	4	9	0	0	9	0	0
25	6377724	.	T	C	7	0	7	0	9	16	0	0
25	6383376	.	T	C	4	0	4	0	6	10	0	0
25	6403852	.	T	C	6	4	10	0	0	10	0	0
25	6403853	.	T	C	7	3	10	0	0	10	0	0
25	6404230	.	G	T	1	3	4	0	0	4	0	0
25	6404599	.	C	T	2	2	4	0	7	11	0	0
25	6404630	.	T	G	6	4	10	0	2	12	0	0
25	6407526	.	T	C	5	0	5	0	8	13	0	0
25	6410720	.	A	G	6	3	9	0	0	9	0	0
25	6411731	.	T	A	4	4	8	0	0	8	0	0
25	6411935	.	A	G	5	5	10	0	0	10	0	0
25	6417123	.	C	T	3	7	10	0	0	10	0	0
25	6420717	.	T	C	5	3	8	0	0	8	0	0
25	6431715	.	T	C	4	5	9	0	1	10	0	0
25	6431985	.	A	C	2	2	4	0	0	4	0	0
25	6435955	.	A	G	3	3	6	0	0	6	0	0
25	6436199	.	G	C	12	9	21	0	0	21	0	0
25	6437716	.	A	G	6	12	18	0	0	18	0	0
25	6437735	.	A	G	4	10	14	0	0	14	0	0
25	6437945	.	C	T	5	5	10	1	0	11	0	0
25	6442284	.	C	A	1	2	3	0	0	3	0	0
25	6442290	.	C	A	1	2	3	0	0	3	0	0
25	6507581	.	C	A	0	2	2	0	1	3	0	0
25	6507821	.	G	T	2	2	4	0	0	4	0	0
25	6507833	.	T	C	2	2	4	0	0	4	0	0
25	6511079	.	A	T	2	2	4	0	0	4	0	0
25	7327718	.	C	T	16	10	26	0	1	27	0	0
25	7333751	.	G	A	13	17	30	0	1	31	0	0
25	7333841	.	C	T	10	26	36	0	1	37	0	0
25	7334915	.	T	C	17	18	35	0	3	38	0	0
25	7334951	.	T	C	17	14	31	0	3	34	0	0
25	7334957	.	G	A	0	16	16	0	18	34	0	0
25	7336096	.	T	A	10	8	18	0	1	19	0	0
25	7398659	.	C	A	2	4	6	0	0	6	0	0
25	7399195	.	A	G	5	7	12	0	0	12	0	0
25	7399507	.	T	C	4	4	8	0	0	8	0	0
25	7399814	.	C	T	3	2	5	0	0	5	0	0
25	7400530	.	C	T	5	5	10	0	0	10	0	0
25	7400866	.	T	C	4	2	6	0	0	6	0	0
25	7401509	.	C	G	3	5	8	0	0	8	0	0
25	7401601	.	C	G	9	6	15	0	0	15	0	0
25	7410822	.	G	A	1	8	9	0	1	10	0	0
25	7412750	.	G	A	6	2	8	0	0	8	0	0
25	7412865	.	G	A	4	6	10	0	0	10	0	0
25	7413037	.	C	G	6	5	11	0	2	13	0	0
25	7413144	.	C	T	4	4	8	0	0	8	0	0
25	7413288	.	T	A	8	7	15	0	1	16	0	0
25	7413351	.	C	T	4	7	11	0	0	11	0	0
25	7413648	.	T	C	7	4	11	0	0	11	0	0
25	7413786	.	C	A	2	2	4	0	0	4	0	0
25	7413815	.	G	A	0	2	2	0	3	5	0	0
25	7431334	.	G	A	13	4	17	0	0	17	0	0
25	7431626	.	T	C	11	3	14	0	0	14	0	0
25	7445883	.	G	C	4	2	6	0	0	6	0	0
25	7458924	.	G	A	2	2	4	0	0	4	0	0
25	7477641	.	C	T	17	18	35	0	3	38	0	0
25	7480949	.	G	C	19	18	37	0	1	38	0	0
25	7481063	.	C	A	26	26	52	0	4	56	0	0
25	7481123	.	G	A	5	27	32	0	23	55	0	0
25	7481159	.	C	T	25	26	51	0	4	55	0	0
25	7485040	.	A	G	16	0	16	0	25	41	0	0
25	7485073	.	G	A	19	23	42	0	2	44	0	0
25	7485527	.	C	T	21	30	51	0	2	53	0	0
25	7485588	.	A	G	31	21	52	0	0	52	0	0
25	7487809	.	T	C	24	33	57	0	0	57	0	0
25	7487835	.	G	C	24	22	46	0	5	51	0	0
25	7488310	.	T	A	0	29	29	0	0	29	0	0
25	7488407	.	T	C	7	29	36	0	0	36	0	0
25	7488660	.	C	T	23	10	33	0	1	34	0	0
25	7488749	.	T	G	22	16	38	0	2	40	0	0
25	7488753	.	C	T	18	17	35	0	4	39	0	0
25	7489011	.	A	T	31	28	59	0	2	61	0	0
25	7489197	.	G	T	14	13	27	0	2	29	0	0
25	7492927	.	T	A	9	7	16	0	1	17	0	0
25	7494184	.	C	T	11	19	30	0	1	31	0	0
25	7494207	.	T	C	18	17	35	0	1	36	0	0
25	7494243	.	G	A	3	10	13	0	13	26	0	0
25	7494258	.	G	C	13	8	21	0	1	22	0	0
25	7494306	.	T	C	6	7	13	0	0	13	0	0
25	7496003	.	C	T	12	12	24	0	0	24	0	0
25	7496099	.	G	A	1	8	9	0	11	20	0	0
25	7496992	.	G	C	2	16	18	0	12	30	0	0
25	7500473	.	T	C	20	18	38	0	2	40	0	0
25	7501997	.	G	A	17	10	27	0	1	28	0	0
25	7502119	.	T	C	8	6	14	0	0	14	0	0
25	7502227	.	G	A	5	5	10	0	0	10	0	0
25	7520131	.	G	A	2	3	5	0	0	5	0	0
25	7520753	.	G	T	3	2	5	0	3	8	0	0
25	7533161	.	A	G	4	5	9	0	1	10	0	0
25	7533333	.	C	T	1	5	6	0	2	8	0	0
25	7533437	.	C	T	8	3	11	0	1	12	0	0
25	7533476	.	C	T	11	6	17	0	1	18	0	0
25	7549175	.	G	A	3	7	10	0	0	10	0	0
25	7549339	.	G	C	0	7	7	0	4	11	0	0
25	7551182	.	C	T	13	5	18	0	0	18	0	0
25	7553064	.	G	T	11	6	17	0	0	17	0	0
25	7556313	.	A	G	10	5	15	0	2	17	0	0
25	7556410	.	T	C	4	12	16	0	0	16	0	0
25	7556427	.	C	T	5	10	15	0	1	16	0	0
25	7556454	.	C	T	11	7	18	0	0	18	0	0
25	7562272	.	C	A	4	6	10	0	0	10	0	0
25	7562301	.	T	A	5	12	17	0	0	17	0	0
25	7562418	.	G	A	2	5	7	0	9	16	0	0
25	7562921	.	C	T	12	10	22	0	1	23	0	0
25	7562925	.	A	T	11	11	22	0	2	24	0	0
25	7562975	.	A	G	13	15	28	0	1	29	0	0
25	7574991	.	T	C	2	4	6	0	0	6	0	0
25	7576483	.	A	G	3	2	5	0	1	6	0	0
25	7578131	.	C	T	3	2	5	0	0	5	0	0
25	7578184	.	C	T	5	5	10	0	0	10	0	0
25	7580798	.	T	C	6	3	9	0	0	9	0	0
25	7580945	.	C	T	2	2	4	0	0	4	0	0
25	7586915	.	A	G	6	3	9	0	0	9	0	0
25	7587748	.	A	T	3	9	12	0	2	14	0	0
25	7589915	.	A	G	2	0	2	0	8	10	0	0
25	7589921	.	A	C	0	8	8	0	0	8	0	0
25	7589951	.	C	T	3	4	7	0	0	7	0	0
25	7590702	.	C	T	6	3	9	0	1	10	0	0
25	7590731	.	A	G	5	2	7	0	1	8	0	0
25	7601289	.	G	T	1	2	3	0	0	3	0	0
25	7601295	.	G	A	1	2	3	0	0	3	0	0
25	7625339	.	G	A	1	1	2	0	1	3	0	0
25	7667923	.	G	A	2	7	9	0	0	9	0	0
25	7667943	.	T	C	1	5	6	0	0	6	0	0
25	7668161	.	A	G	7	10	17	0	0	17	0	0
25	7668166	.	C	T	0	7	7	0	10	17	0	0
25	7672067	.	C	T	8	14	22	0	0	22	0	0
25	7672382	.	G	A	3	12	15	0	10	25	0	0
25	7672385	.	C	T	11	12	23	0	2	25	0	0
25	7673040	.	T	C	13	14	27	0	3	30	0	0
25	7673052	.	C	T	11	14	25	0	1	26	0	0
25	7673139	.	T	A	10	19	29	0	0	29	0	0
25	7673140	.	C	T	9	17	26	0	2	28	0	0
25	7673897	.	T	G	16	14	30	0	0	30	0	0
25	7673930	.	G	A	20	15	35	0	0	35	0	0
25	7673951	.	C	T	15	17	32	0	1	33	0	0
25	7674098	.	G	A	19	13	32	2	2	36	0	0
25	7678180	.	A	T	14	12	26	0	1	27	0	0
25	7692826	.	T	C	2	4	6	0	0	6	0	0
25	7693339	.	A	C	4	2	6	0	0	6	0	0
25	7693511	.	T	C	5	7	12	0	0	12	0	0
25	7693546	.	G	A	6	2	8	0	0	8	0	0
25	7693889	.	C	T	3	2	5	2	0	7	0	0
25	7694577	.	A	T	3	2	5	0	0	5	0	0
25	7694669	.	C	A	3	5	8	0	0	8	0	0
25	7694684	.	G	A	2	5	7	0	0	7	0	0
25	7694855	.	T	G	5	2	7	0	1	8	0	0
25	7695625	.	C	T	5	5	10	0	0	10	0	0
25	7696399	.	G	A	4	4	8	0	0	8	0	0
25	7696428	.	C	T	1	2	3	0	2	5	0	0
25	7696755	.	G	T	1	4	5	0	0	5	0	0
25	7697457	.	G	A	1	2	3	0	0	3	0	0
25	7697487	.	G	A	1	3	4	0	0	4	0	0
25	7697584	.	G	T	3	4	7	0	0	7	0	0
25	7697986	.	A	G	1	3	4	0	0	4	0	0
25	7698611	.	A	G	1	3	4	0	2	6	0	0
25	7698643	.	C	T	2	3	5	0	0	5	0	0
25	7719778	.	A	G	5	5	10	0	0	10	0	0
25	7722339	.	C	T	3	4	7	0	0	7	0	0
25	7734809	.	C	G	3	6	9	0	0	9	0	0
25	7784705	.	G	A	3	3	6	0	2	8	0	0
25	7784711	.	G	T	5	4	9	0	2	11	0	0
25	7784981	.	G	T	6	14	20	0	1	21	0	0
25	7890351	.	T	C	3	4	7	0	1	8	0	0
25	7890814	.	T	C	3	2	5	0	0	5	0	0
25	7892125	.	T	C	1	5	6	0	0	6	0	0
25	7892297	.	T	C	1	6	7	0	0	7	0	0
25	8478814	.	T	C	4	10	14	0	0	14	0	0
25	8482771	.	G	A	5	12	17	0	0	17	0	0
25	8482837	.	C	T	3	7	10	0	0	10	0	0
25	8486622	.	C	T	0	6	6	0	5	11	0	0
25	8486631	.	A	C	3	0	3	0	8	11	0	0
25	8486705	.	A	G	4	12	16	0	0	16	0	0
25	8486736	.	A	G	5	11	16	0	0	16	0	0
25	8486884	.	T	A	5	12	17	0	0	17	0	0
25	8495246	.	A	G	2	8	10	0	0	10	0	0
25	8497562	.	G	A	5	2	7	0	0	7	0	0
25	8497786	.	G	A	6	4	10	0	0	10	0	0
25	8505325	.	T	A	1	4	5	0	0	5	0	0
25	8511250	.	C	T	2	6	8	0	0	8	0	0
25	8511772	.	A	G	2	2	4	0	0	4	0	0
25	8624335	.	G	A	2	5	7	0	0	7	0	0
25	8624914	.	T	C	2	2	4	0	0	4	0	0
25	8627940	.	G	A	5	4	9	0	0	9	0	0
25	8627943	.	T	C	3	5	8	0	0	8	0	0
25	8628139	.	G	C	7	4	11	0	0	11	0	0
25	8630910	.	A	G	1	7	8	0	1	9	0	0
25	8631015	.	A	T	4	5	9	0	0	9	0	0
25	8631017	.	C	T	0	4	4	0	5	9	0	0
25	8639640	.	C	T	8	5	13	0	2	15	0	0
25	8642211	.	A	G	6	6	12	0	1	13	0	0
25	8642262	.	C	T	7	9	16	0	0	16	0	0
25	8645380	.	T	G	2	2	4	0	0	4	0	0
25	8646583	.	A	T	5	3	8	0	0	8	0	0
25	8646670	.	A	G	2	2	4	0	0	4	0	0
25	8649494	.	A	G	3	4	7	0	1	8	0	0
25	8649910	.	C	T	0	3	3	0	5	8	0	0
25	8658002	.	A	T	5	4	9	0	0	9	0	0
25	8660651	.	G	A	7	3	10	0	0	10	0	0
25	8666051	.	A	G	3	4	7	0	0	7	0	0
25	8673064	.	A	G	2	0	2	0	10	12	0	0
25	8675516	.	G	A	4	2	6	0	1	7	0	0
25	8675555	.	A	G	1	2	3	0	0	3	0	0
25	8675615	.	C	T	6	3	9	0	1	10	0	0
25	8690528	.	T	C	1	4	5	0	1	6	0	0
25	8690561	.	G	A	4	4	8	0	1	9	0	0
25	8699495	.	G	C	0	5	5	0	5	10	0	0
25	8699525	.	T	C	5	4	9	0	1	10	0	0
25	8700450	.	T	C	7	7	14	0	0	14	0	0
25	8700514	.	G	A	9	9	18	0	1	19	0	0
25	8700603	.	G	A	1	2	3	0	5	8	0	0
25	8700630	.	C	T	5	3	8	0	0	8	0	0
25	8703357	.	T	C	4	2	6	0	0	6	0	0
25	8707860	.	A	G	6	0	6	0	5	11	0	0
25	8722680	.	T	G	7	0	7	0	4	11	0	0
25	8725562	.	A	T	7	3	10	0	2	12	0	0
25	8736254	.	C	T	15	9	24	0	0	24	0	0
25	8739444	.	T	A	8	7	15	0	1	16	0	0
25	8739881	.	A	T	9	4	13	0	0	13	0	0
25	8740236	.	G	T	1	5	6	0	2	8	0	0
25	8740545	.	G	A	1	6	7	0	19	26	0	0
25	8740550	.	G	C	21	6	27	0	0	27	0	0
25	8740951	.	A	G	9	0	9	0	6	15	0	0
25	8741303	.	C	T	8	12	20	0	0	20	0	0
25	8741469	.	T	A	10	8	18	0	0	18	0	0
25	8741471	.	C	T	10	7	17	0	1	18	0	0
25	8741624	.	C	T	7	2	9	0	0	9	0	0
25	8741758	.	C	T	10	9	19	0	0	19	0	0
25	8741759	.	G	T	0	9	9	0	10	19	0	0
25	8741877	.	G	C	7	12	19	0	1	20	0	0
25	8741968	.	G	C	13	10	23	0	2	25	0	0
25	8742126	.	T	C	13	17	30	0	4	34	0	0
25	8742148	.	T	A	17	16	33	0	0	33	0	0
25	8756099	.	T	C	5	7	12	0	0	12	0	0
25	8756492	.	A	G	1	4	5	0	0	5	0	0
25	8756516	.	A	G	1	4	5	0	1	6	0	0
25	8756573	.	C	A	3	7	10	0	0	10	0	0
25	8757038	.	A	C	11	0	11	0	22	33	0	0
25	8767925	.	A	G	11	19	30	0	1	31	0	0
25	8773257	.	A	G	6	22	28	0	1	29	0	0
25	8773867	.	T	G	9	17	26	0	0	26	0	0
25	8773897	.	C	T	8	17	25	0	0	25	0	0
25	8791174	.	A	G	6	21	27	0	2	29	0	0
25	8834967	.	T	G	8	13	21	0	0	21	0	0
25	8834968	.	G	C	8	1	9	0	12	21	0	0
25	8852072	.	A	T	8	8	16	1	1	18	0	0
25	8908297	.	C	T	1	7	8	0	3	11	0	0
25	8916632	.	G	A	8	7	15	0	0	15	0	0
25	8916635	.	C	G	8	8	16	0	0	16	0	0
25	8916859	.	A	G	2	9	11	0	0	11	0	0
25	8921682	.	C	T	1	3	4	0	0	4	0	0
25	8921867	.	C	T	4	7	11	0	0	11	0	0
25	8922223	.	T	C	6	7	13	0	1	14	0	0
25	8922331	.	C	T	4	8	12	0	0	12	0	0
25	8925678	.	C	A	5	3	8	0	0	8	0	0
25	8925748	.	T	C	6	9	15	0	0	15	0	0
25	8925778	.	G	A	14	8	22	0	0	22	0	0
25	8925837	.	T	C	6	2	8	0	0	8	0	0
25	8925928	.	T	C	4	3	7	0	0	7	0	0
25	8926097	.	T	A	3	2	5	0	0	5	0	0
25	8934234	.	G	T	6	8	14	0	0	14	0	0
25	8940231	.	G	A	2	6	8	0	3	11	0	0
25	8940242	.	T	C	3	5	8	0	0	8	0	0
25	8940269	.	G	T	4	2	6	0	0	6	0	0
25	8948700	.	G	A	0	3	3	0	5	8	0	0
25	8948978	.	C	A	2	5	7	0	0	7	0	0
25	8949062	.	A	T	5	4	9	0	0	9	0	0
25	8949124	.	C	T	4	4	8	0	1	9	0	0
25	9028223	.	C	T	1	5	6	0	1	7	0	0
25	11805675	.	T	A	0	9	9	0	1	10	0	0
25	11837376	.	A	T	2	2	4	0	0	4	0	0
25	11837397	.	C	T	1	3	4	0	2	6	0	0
25	11894540	.	G	A	3	8	11	0	0	11	0	0
25	11998840	.	A	C	2	0	2	0	6	8	0	0
25	12008441	.	G	A	7	4	11	0	0	11	0	0
25	12203623	.	A	G	2	3	5	0	0	5	0	0
25	12203626	.	G	A	2	2	4	0	0	4	0	0
25	12401527	.	A	G	6	3	9	0	1	10	0	0
25	12406706	.	A	G	1	3	4	0	1	5	0	0
25	12409668	.	A	T	2	2	4	0	1	5	0	0
25	12412576	.	G	C	4	2	6	0	1	7	0	0
25	12412696	.	G	T	4	4	8	0	0	8	0	0
25	12494253	.	A	C	27	28	55	0	0	55	0	0
25	12504795	.	G	A	32	22	54	0	2	56	0	0
25	12504863	.	C	T	26	22	48	0	3	51	0	0
25	12504913	.	A	T	31	22	53	0	3	56	0	0
25	12504926	.	T	G	31	20	51	0	1	53	1	0
25	12505103	.	C	T	24	22	46	0	1	47	0	0
25	12505121	.	A	G	22	2	24	0	22	46	0	0
25	12505185	.	T	C	27	17	44	1	0	45	0	0
25	12505222	.	T	C	27	20	47	1	2	50	0	0
25	12505299	.	C	T	29	21	50	1	2	53	0	0
25	12505327	.	T	C	32	17	49	1	2	52	0	0
25	12505356	.	T	G	37	10	47	1	3	51	0	0
25	12505542	.	A	G	26	4	30	0	18	48	0	0
25	12640549	.	C	T	15	16	31	1	0	32	0	0
25	12656712	.	C	G	13	8	21	0	1	22	0	0
25	12657103	.	C	T	12	11	23	0	3	26	0	0
25	12657193	.	C	T	10	17	27	0	0	28	1	0
25	12688845	.	C	T	9	8	17	0	0	17	0	0
25	12695658	.	C	T	20	10	30	0	2	32	0	0
25	12695750	.	T	A	15	11	26	0	3	29	0	0
25	12695779	.	T	C	19	10	29	0	4	33	0	0
25	12695810	.	T	A	18	14	32	0	0	32	0	0
25	12707631	.	A	G	4	2	6	0	0	6	0	0
25	12707716	.	C	T	8	4	12	0	1	13	0	0
25	12707730	.	A	G	6	5	11	0	0	11	0	0
25	12707849	.	T	C	3	0	3	0	6	9	0	0
25	12707884	.	A	G	5	5	10	0	0	10	0	0
25	12717574	.	C	T	5	5	10	1	1	12	0	0
25	12719939	.	T	A	1	6	7	0	1	8	0	0
25	12719946	.	G	T	2	6	8	0	0	8	0	0
25	12723890	.	G	A	4	4	8	0	0	8	0	0
25	12723960	.	A	G	2	7	9	0	0	9	0	0
25	12725258	.	C	T	8	3	11	0	0	11	0	0
25	12727800	.	G	A	5	1	6	0	1	7	0	0
25	12729928	.	A	G	6	2	8	0	0	8	0	0
25	12730070	.	C	T	1	2	3	0	8	11	0	0
25	12730102	.	C	T	0	7	7	0	2	9	0	0
25	12730124	.	T	C	2	9	11	0	0	11	0	0
25	12730164	.	A	G	6	6	12	0	0	12	0	0
25	12730170	.	A	G	4	6	10	0	0	10	0	0
25	12752956	.	A	G	4	10	14	0	0	14	0	0
25	12787869	.	T	A	7	4	11	0	0	11	0	0
25	12798284	.	A	C	5	4	9	0	0	9	0	0
25	12798321	.	C	T	1	7	8	0	0	8	0	0
25	12798328	.	T	C	1	7	8	0	0	8	0	0
25	12798426	.	G	T	8	4	12	0	0	13	1	0
25	12798468	.	T	G	6	3	9	0	1	10	0	0
25	12798560	.	G	A	12	10	22	0	0	22	0	0
25	12798645	.	C	T	10	13	23	0	0	23	0	0
25	12804003	.	A	G	7	8	15	0	1	16	0	0
25	12804006	.	A	G	9	6	15	0	1	16	0	0
25	12804051	.	T	C	11	7	18	0	1	19	0	0
25	12804428	.	A	G	10	5	15	0	0	15	0	0
25	12804512	.	A	T	11	10	21	0	0	21	0	0
25	12809004	.	A	G	2	7	9	0	0	9	0	0
25	12809088	.	T	A	2	6	8	0	0	8	0	0
25	12811755	.	A	G	4	7	11	0	0	11	0	0
25	12811901	.	G	A	10	9	19	0	0	19	0	0
25	12816557	.	G	A	5	14	19	0	0	19	0	0
25	12816888	.	G	A	15	13	28	0	0	28	0	0
25	12819014	.	C	A	6	9	15	0	0	15	0	0
25	12819197	.	A	C	6	6	12	0	0	12	0	0
25	12819353	.	A	G	6	6	12	0	0	12	0	0
25	12822691	.	C	T	9	10	19	0	0	19	0	0
25	12824600	.	G	A	5	4	9	0	0	9	0	0
25	12853243	.	C	T	1	3	4	0	1	5	0	0
25	12853318	.	C	A	8	13	21	0	1	22	0	0
25	12853377	.	T	C	14	1	15	0	24	39	0	0
25	12853407	.	A	T	19	21	40	1	0	41	0	0
25	12853498	.	A	C	15	23	38	0	1	39	0	0
25	12853602	.	T	C	26	21	47	0	2	49	0	0
25	12853611	.	T	A	25	26	51	0	1	52	0	0
25	12853850	.	A	C	10	21	31	0	1	33	1	0
25	12854016	.	G	A	26	22	48	0	1	49	0	0
25	12854021	.	T	A	21	23	44	0	0	45	1	0
25	12854266	.	A	T	30	15	45	0	2	47	0	0
25	12854279	.	T	G	30	18	48	0	0	48	0	0
25	12854393	.	T	C	25	22	47	0	2	49	0	0
25	12858013	.	C	T	23	33	56	0	1	57	0	0
25	12858025	.	G	T	23	34	57	0	3	60	0	0
25	12859458	.	T	C	26	30	56	0	2	58	0	0
25	12859464	.	T	C	29	0	29	0	29	58	0	0
25	12866625	.	C	T	27	20	47	0	3	50	0	0
25	12871405	.	G	A	13	17	30	0	0	30	0	0
25	12906738	.	A	G	15	17	32	0	0	32	0	0
25	12906775	.	G	T	19	22	41	0	1	42	0	0
25	12906777	.	C	A	23	22	45	0	0	45	0	0
25	12906814	.	G	A	21	19	40	0	2	42	0	0
25	12925574	.	A	T	3	4	7	0	0	7	0	0
25	13332406	.	A	T	30	24	54	0	3	57	0	0
25	13332531	.	C	T	39	19	58	0	1	59	0	0
25	13332693	.	G	A	30	43	73	0	0	73	0	0
25	13333191	.	G	T	44	31	75	0	3	78	0	0
25	13333463	.	G	A	42	38	80	0	15	95	0	0
25	13333508	.	A	T	42	32	74	0	2	76	0	0
25	13333665	.	C	T	31	37	68	1	2	71	0	0
25	13333809	.	G	A	41	26	67	1	5	73	0	0
25	13333839	.	A	T	20	33	53	1	1	55	0	0
25	13333986	.	T	A	37	32	69	0	2	71	0	0
25	13334304	.	T	C	25	1	26	0	27	53	0	0
25	13334487	.	A	T	29	19	48	0	1	50	1	0
25	13334729	.	C	T	37	35	72	0	5	77	0	0
25	13334744	.	C	T	37	34	71	0	3	74	0	0
25	13334977	.	A	T	41	33	74	0	3	77	0	0
25	13334990	.	A	T	34	42	76	0	1	77	0	0
25	13335040	.	T	C	32	0	32	0	41	73	0	0
25	13335071	.	G	C	30	37	67	0	2	69	0	0
25	13335607	.	G	T	34	34	68	1	0	69	0	0
25	13335674	.	A	T	29	27	56	0	3	59	0	0
25	13335762	.	C	T	20	19	39	1	0	40	0	0
25	13335765	.	C	T	1	20	21	1	19	41	0	0
25	13336129	.	C	A	40	24	64	0	1	65	0	0
25	13336277	.	G	A	26	17	43	0	1	44	0	0
25	13336323	.	T	G	39	30	69	0	3	72	0	0
25	13336343	.	T	C	34	32	66	0	4	70	0	0
25	13336493	.	A	G	42	22	64	0	0	64	0	0
25	13336545	.	T	C	40	36	76	0	1	77	0	0
25	13336598	.	C	G	45	32	77	0	4	81	0	0
25	13336768	.	A	C	35	28	63	0	4	68	1	0
25	13336861	.	A	G	38	27	65	1	2	68	0	0
25	13336926	.	C	T	26	35	61	1	0	62	0	0
25	13336930	.	C	T	24	35	59	1	1	61	0	0
25	13337184	.	C	G	28	29	57	0	7	65	1	0
25	13337272	.	G	A	44	29	73	0	7	80	0	0
25	13337338	.	G	A	44	43	87	2	1	90	0	0
25	13346730	.	A	G	32	35	67	0	0	67	0	0
25	13350259	.	A	G	33	35	68	0	2	70	0	0
25	13351957	.	T	C	30	39	69	0	1	70	0	0
25	13352008	.	G	A	25	37	62	0	0	62	0	0
25	13363206	.	C	T	1	23	24	0	27	51	0	0
25	13363248	.	G	T	27	21	48	0	2	50	0	0
25	13363258	.	G	A	24	18	42	0	3	45	0	0
25	13406138	.	G	C	14	10	24	0	3	27	0	0
25	13470123	.	T	C	16	18	34	0	1	35	0	0
25	13470336	.	G	T	2	11	13	0	14	27	0	0
25	13470430	.	A	T	9	15	24	0	3	27	0	0
25	13471079	.	A	C	18	10	28	0	1	29	0	0
25	13474192	.	G	A	2	7	9	0	0	9	0	0
25	13474246	.	C	T	4	6	10	0	0	10	0	0
25	13478185	.	G	T	3	6	9	0	0	9	0	0
25	13478217	.	T	G	5	7	12	0	1	13	0	0
25	13484787	.	A	G	9	6	15	0	1	16	0	0
25	13484791	.	T	C	7	5	12	0	1	13	0	0
25	13485301	.	G	A	7	4	11	0	2	13	0	0
25	13485370	.	A	T	4	4	8	0	2	10	0	0
25	13488501	.	C	T	5	4	9	0	1	10	0	0
25	13498342	.	G	A	0	10	10	0	5	15	0	0
25	13510467	.	G	C	1	12	13	0	12	25	0	0
25	13525848	.	A	T	11	14	25	0	1	26	0	0
25	13525864	.	G	A	10	15	25	0	1	26	0	0
25	13526171	.	A	C	18	14	32	4	0	36	0	0
25	13528732	.	G	A	2	2	4	0	0	4	0	0
25	13528787	.	G	T	2	1	3	0	0	3	0	0
25	13528796	.	C	T	1	2	3	0	1	4	0	0
25	13529294	.	A	G	5	7	12	0	0	12	0	0
25	13531933	.	G	A	1	4	5	0	0	5	0	0
25	13559168	.	T	G	5	3	8	0	1	9	0	0
25	13559194	.	G	A	10	5	15	0	0	15	0	0
25	13559548	.	T	A	8	10	18	0	3	21	0	0
25	13559633	.	T	C	11	0	11	0	7	18	0	0
25	13559950	.	G	A	7	13	20	3	1	25	1	0
25	13559953	.	A	T	15	5	20	2	2	24	0	0
25	13560080	.	C	T	10	5	15	0	1	16	0	0
25	13560342	.	T	C	8	17	25	0	0	25	0	0
25	13560518	.	G	A	10	10	20	0	3	23	0	0
25	13560638	.	C	A	5	6	11	0	1	12	0	0
25	13561133	.	T	C	6	7	13	0	0	13	0	0
25	13561149	.	T	C	3	6	9	0	1	10	0	0
25	13561775	.	C	A	0	5	5	0	6	11	0	0
25	13561851	.	A	C	4	4	8	0	0	8	0	0
25	13562044	.	T	A	3	3	6	0	1	7	0	0
25	13562066	.	G	A	5	4	9	0	0	9	0	0
25	13744587	.	T	C	2	3	5	0	0	5	0	0
25	15029181	.	C	T	1	2	3	0	0	3	0	0
25	15648092	.	A	G	8	12	20	0	1	21	0	0
25	15694794	.	T	G	8	10	18	0	0	18	0	0
25	15694823	.	G	A	5	14	19	0	2	21	0	0
25	15769320	.	C	G	14	12	26	0	1	27	0	0
25	15792621	.	C	T	20	18	38	0	2	40	0	0
25	15792625	.	A	G	19	20	39	0	0	39	0	0
25	15799767	.	C	A	22	18	40	0	2	42	0	0
25	15841757	.	T	C	9	11	20	0	0	20	0	0
25	15841767	.	T	C	9	10	19	0	1	20	0	0
25	15857126	.	C	G	17	9	26	0	2	28	0	0
25	15857129	.	C	T	19	10	29	0	0	29	0	0
25	15888282	.	G	T	11	15	26	0	0	26	0	0
25	15893140	.	C	T	15	13	28	0	0	28	0	0
25	15905378	.	A	G	14	0	14	0	15	29	0	0
25	15905654	.	G	A	0	5	5	0	7	12	0	0
25	15998175	.	C	T	2	2	4	0	0	4	0	0
25	15998184	.	A	C	3	3	6	0	0	6	0	0
25	16007602	.	A	G	1	3	4	0	1	5	0	0
25	16015192	.	C	A	5	4	9	0	1	10	0	0
25	16016636	.	T	C	3	8	11	0	0	11	0	0
25	16022424	.	G	A	1	8	9	0	2	11	0	0
25	16027795	.	G	A	2	5	7	0	0	7	0	0
25	16027879	.	T	C	7	7	14	0	1	15	0	0
25	16032614	.	C	A	8	6	14	0	1	15	0	0
25	16035983	.	G	T	0	7	7	0	9	16	0	0
25	16036013	.	G	A	1	7	8	0	8	16	0	0
25	16036064	.	G	A	7	4	11	0	0	11	0	0
25	16041768	.	G	C	3	2	5	0	0	5	0	0
25	16041891	.	T	C	3	4	7	0	0	7	0	0
25	16042256	.	A	T	4	2	6	0	1	7	0	0
25	16044986	.	T	A	7	13	20	0	1	21	0	0
25	16045078	.	C	T	6	8	14	0	1	15	0	0
25	16045418	.	C	G	6	4	10	0	1	11	0	0
25	16045427	.	C	G	8	6	14	0	0	14	0	0
25	16045517	.	T	C	10	8	18	0	2	20	0	0
25	16045574	.	T	C	7	10	17	0	4	21	0	0
25	16045686	.	G	C	5	4	9	0	0	9	0	0
25	16045700	.	A	G	5	2	7	0	0	7	0	0
25	16046004	.	C	T	2	5	7	0	0	7	0	0
25	16046543	.	T	C	2	4	6	0	0	6	0	0
25	16046544	.	C	T	2	4	6	0	0	6	0	0
25	16963906	.	T	C	3	5	8	0	1	9	0	0
25	17479430	.	A	G	4	3	7	0	0	7	0	0
25	17485825	.	A	T	9	6	15	0	0	15	0	0
25	17490629	.	A	G	4	7	11	0	1	12	0	0
25	17495836	.	A	C	2	0	2	0	4	6	0	0
25	17495845	.	C	T	1	3	4	0	0	4	0	0
25	17500213	.	T	G	2	3	5	0	0	5	0	0
25	17503102	.	A	C	1	8	9	0	0	9	0	0
25	17508537	.	T	C	2	2	4	0	0	4	0	0
25	17511303	.	T	C	3	4	7	0	1	8	0	0
25	17560673	.	C	T	1	2	3	0	1	4	0	0
25	17560686	.	A	G	1	3	4	0	0	4	0	0
25	17590251	.	T	C	5	4	9	0	0	9	0	0
25	17590330	.	C	G	4	3	7	0	0	7	0	0
25	17590481	.	T	G	6	4	10	0	0	10	0	0
25	17590492	.	G	C	6	4	10	0	0	10	0	0
25	17590516	.	T	G	3	4	7	0	0	7	0	0
25	17590670	.	C	T	6	5	11	0	1	12	0	0
25	17593585	.	T	C	3	5	8	1	1	10	0	0
25	17596788	.	C	T	7	7	14	0	0	14	0	0
25	17605418	.	A	C	9	11	20	0	0	20	0	0
25	17605433	.	A	G	8	1	9	0	9	18	0	0
25	17606587	.	C	T	15	15	30	0	1	31	0	0
25	17610834	.	T	C	5	11	16	0	0	16	0	0
25	17610867	.	A	G	5	0	5	0	9	14	0	0
25	17611017	.	C	T	3	10	13	0	0	13	0	0
25	17611157	.	T	A	3	2	5	0	0	5	0	0
25	17611217	.	C	A	2	2	4	0	1	5	0	0
25	17689632	.	G	A	1	4	5	0	0	5	0	0
25	17689639	.	C	A	2	4	6	0	0	6	0	0
25	17756661	.	G	A	5	3	8	0	0	8	0	0
25	17756675	.	A	G	5	0	5	0	3	8	0	0
25	17807652	.	G	A	2	9	11	0	0	11	0	0
25	17807679	.	A	T	2	4	6	0	0	6	0	0
25	17825010	.	T	C	5	3	8	0	1	9	0	0
25	17847117	.	C	T	10	12	22	0	0	22	0	0
25	17847242	.	T	C	16	8	24	0	0	24	0	0
25	17847251	.	G	T	15	8	23	0	2	25	0	0
25	17847328	.	A	G	14	0	14	0	9	23	0	0
25	17849049	.	G	A	2	12	14	0	15	29	0	0
25	17849306	.	G	C	6	6	12	0	0	12	0	0
25	17849737	.	C	G	1	2	3	0	0	3	0	0
25	17850108	.	C	T	0	4	4	0	2	6	0	0
25	17850151	.	T	G	2	2	4	0	0	4	0	0
25	17850219	.	A	G	1	0	1	0	4	5	0	0
25	17862464	.	C	A	6	4	10	0	0	10	0	0
25	17864945	.	A	G	5	3	8	0	0	8	0	0
25	17870843	.	C	T	4	2	6	0	1	7	0	0
25	17870916	.	A	G	4	2	6	0	1	7	0	0
25	17887154	.	A	G	11	19	30	0	0	30	0	0
25	17891011	.	G	A	17	24	41	0	1	42	0	0
25	17891616	.	A	T	16	6	22	0	0	22	0	0
25	17891654	.	G	A	10	8	18	0	0	18	0	0
25	17892405	.	A	T	11	7	18	0	0	18	0	0
25	17892517	.	T	G	9	10	19	0	2	21	0	0
25	17892643	.	G	A	5	3	8	0	0	8	0	0
25	17901093	.	C	T	3	10	13	0	9	22	0	0
25	17904020	.	G	A	7	12	19	0	1	20	0	0
25	17904131	.	G	A	13	7	20	0	0	20	0	0
25	17905153	.	C	T	9	8	17	0	0	17	0	0
25	17905297	.	T	C	6	9	15	0	0	15	0	0
25	17905486	.	A	G	9	8	17	0	0	17	0	0
25	17907138	.	G	A	10	9	19	0	0	19	0	0
25	17907476	.	C	A	2	10	12	0	6	18	0	0
25	17918735	.	T	C	9	12	21	0	2	23	0	0
25	17921450	.	G	A	2	9	11	0	8	19	0	0
25	17924018	.	C	T	5	13	18	0	0	18	0	0
25	17932234	.	T	C	12	8	20	0	0	20	0	0
25	17932249	.	G	A	12	6	18	0	1	19	0	0
25	17932486	.	G	A	8	9	17	0	2	19	0	0
25	17934417	.	G	A	6	4	10	0	0	10	0	0
25	17934452	.	G	A	11	7	18	0	0	18	0	0
25	17934557	.	T	A	10	8	18	0	0	18	0	0
25	17934587	.	G	C	8	3	11	0	2	15	2	0
25	17934604	.	C	A	8	4	12	1	1	14	0	0
25	17934711	.	C	T	4	15	19	0	4	23	0	0
25	17934813	.	A	G	7	8	15	0	9	24	0	0
25	17938365	.	G	A	10	4	14	0	0	14	0	0
25	17953432	.	T	G	2	8	10	0	0	10	0	0
25	17954003	.	C	T	3	3	6	0	1	7	0	0
25	17954993	.	G	A	4	3	7	0	0	7	0	0
25	17955037	.	C	T	2	5	7	0	0	7	0	0
25	17955906	.	C	T	0	3	3	0	3	6	0	0
25	17955987	.	C	T	5	2	7	0	0	7	0	0
25	17956071	.	C	T	0	5	5	0	5	10	0	0
25	17956157	.	T	C	5	0	5	0	5	10	0	0
25	17967494	.	A	T	3	5	8	0	1	9	0	0
25	17977799	.	A	T	3	3	6	0	0	6	0	0
25	17990393	.	T	A	5	5	10	0	0	10	0	0
25	17998404	.	A	C	2	4	6	0	0	6	0	0
25	18031372	.	G	A	1	7	8	0	0	8	0	0
25	18031462	.	C	T	4	7	11	0	0	11	0	0
25	18039060	.	C	T	2	6	8	0	0	8	0	0
25	18039078	.	T	A	4	3	7	0	1	8	0	0
25	18048667	.	G	A	6	3	9	0	2	11	0	0
25	18052468	.	C	A	1	6	7	0	1	8	0	0
25	18052663	.	T	C	10	3	13	0	0	13	0	0
25	18052840	.	T	C	6	8	14	0	0	14	0	0
25	18052864	.	C	T	5	8	13	0	0	13	0	0
25	18053440	.	T	A	8	4	12	0	0	12	0	0
25	18053680	.	A	C	6	3	9	0	0	9	0	0
25	18054030	.	G	C	2	6	8	0	1	9	0	0
25	18054317	.	T	C	3	8	11	0	1	12	0	0
25	18054573	.	C	A	6	6	12	0	1	13	0	0
25	18054723	.	T	C	8	13	21	0	0	21	0	0
25	18054913	.	A	G	1	0	1	0	2	3	0	0
25	18054917	.	A	C	1	2	3	0	0	3	0	0
25	18119387	.	C	A	3	5	8	0	1	9	0	0
25	18122159	.	C	T	0	5	5	0	3	8	0	0
25	18122202	.	G	A	4	4	8	0	1	9	0	0
25	18326988	.	T	G	16	26	42	0	0	42	0	0
25	18327559	.	G	A	6	7	13	0	2	15	0	0
25	18328884	.	G	C	16	0	16	0	18	34	0	0
25	18369576	.	T	C	1	2	3	0	0	3	0	0
25	18440779	.	A	T	5	3	8	0	0	8	0	0
25	18443485	.	A	C	6	5	11	0	0	11	0	0
25	18443596	.	T	C	3	2	5	0	0	5	0	0
25	18445181	.	T	C	3	4	7	0	0	7	0	0
25	18463573	.	G	A	4	4	8	0	0	8	0	0
25	18561521	.	C	T	1	3	4	0	0	4	0	0
25	18561575	.	A	T	5	2	7	0	0	7	0	0
25	18575547	.	G	A	0	4	4	0	2	6	0	0
25	18575636	.	A	T	1	2	3	0	0	3	0	0
25	18575720	.	A	G	1	0	1	0	2	3	0	0
25	18575725	.	G	A	1	3	4	0	0	4	0	0
25	18575764	.	G	A	1	2	3	0	0	3	0	0
25	18576212	.	G	A	0	5	5	0	2	7	0	0
25	18576273	.	G	T	4	3	7	0	0	7	0	0
25	18576321	.	T	G	6	7	13	0	0	13	0	0
25	18576336	.	C	A	4	8	12	0	0	12	0	0
25	18576400	.	T	G	2	3	5	0	0	5	0	0
25	18576411	.	A	G	2	0	2	0	3	5	0	0
25	18577142	.	A	G	5	3	8	0	0	8	0	0
25	18658727	.	A	G	1	2	3	0	0	3	0	0
25	18672539	.	T	A	4	3	7	0	0	7	0	0
25	18711899	.	T	A	1	2	3	0	0	3	0	0
25	18711913	.	T	A	2	2	4	0	0	4	0	0
25	18711986	.	A	G	3	2	5	0	0	5	0	0
25	18714979	.	C	T	4	5	9	0	0	9	0	0
25	18715376	.	C	T	1	5	6	0	0	6	0	0
25	18715662	.	A	T	3	2	5	0	1	6	0	0
25	18720166	.	G	A	4	2	6	0	0	6	0	0
25	18720205	.	T	A	4	3	7	0	1	8	0	0
25	18720216	.	T	C	4	2	6	0	0	6	0	0
25	18720384	.	C	T	4	5	9	0	0	9	0	0
25	18720512	.	A	G	5	3	8	0	0	8	0	0
25	18886644	.	T	G	1	7	8	0	0	8	0	0
25	18886658	.	T	C	1	6	7	0	0	7	0	0
25	18886804	.	G	T	2	2	4	0	0	4	0	0
25	18886899	.	C	A	4	5	9	0	1	10	0	0
25	18886941	.	A	G	3	0	3	0	3	6	0	0
25	18886944	.	T	A	4	2	6	0	0	6	0	0
25	18887065	.	A	G	3	2	5	0	0	5	0	0
25	18887774	.	A	G	8	4	12	0	0	12	0	0
25	18890880	.	C	G	2	4	6	0	0	6	0	0
25	18894751	.	T	C	4	3	7	0	0	7	0	0
25	18894807	.	C	T	9	5	14	0	0	14	0	0
25	18895884	.	G	T	1	2	3	0	1	4	0	0
25	18899589	.	G	A	5	4	9	0	0	9	0	0
25	18899616	.	T	A	4	5	9	0	1	10	0	0
25	18899637	.	G	A	0	6	6	0	6	12	0	0
25	18902365	.	T	C	5	4	9	0	0	9	0	0
25	18906540	.	A	G	2	2	4	0	0	4	0	0
25	18906596	.	T	A	2	2	4	0	1	5	0	0
25	18906760	.	G	T	2	6	8	0	0	8	0	0
25	18906917	.	A	G	6	5	11	2	0	13	0	0
25	18906928	.	G	A	1	4	5	2	7	14	0	0
25	18906984	.	A	G	6	4	10	1	0	11	0	0
25	18906991	.	A	T	7	5	12	0	0	12	0	0
25	18907043	.	A	T	7	5	12	0	0	12	0	0
25	18907213	.	G	A	7	3	10	1	0	11	0	0
25	18907218	.	C	T	7	4	11	1	0	12	0	0
25	18908054	.	G	C	2	6	8	0	0	8	0	0
25	18908255	.	T	C	4	8	12	0	0	12	0	0
25	18908313	.	G	A	3	5	8	0	0	8	0	0
25	18908397	.	C	A	5	6	11	0	0	11	0	0
25	18908403	.	T	C	5	7	12	0	0	12	0	0
25	18908630	.	G	A	11	6	17	0	1	18	0	0
25	18908651	.	A	G	12	5	17	0	0	17	0	0
25	18944377	.	A	G	2	6	8	0	0	8	0	0
25	18948541	.	T	A	1	4	5	0	0	5	0	0
25	18948578	.	T	C	1	6	7	0	0	7	0	0
25	18948706	.	G	T	1	4	5	0	0	5	0	0
25	18951829	.	G	A	10	3	13	0	1	14	0	0
25	18952163	.	A	G	9	8	17	0	0	17	0	0
25	18952238	.	G	A	14	11	25	0	1	26	0	0
25	18953285	.	T	C	2	3	5	0	1	6	0	0
25	18953830	.	G	T	6	3	9	0	0	9	0	0
25	18956959	.	G	A	0	4	4	0	2	6	0	0
25	18959047	.	G	C	0	6	6	0	2	8	0	0
25	18959251	.	G	A	3	6	9	0	1	10	0	0
25	18961695	.	C	T	1	3	4	0	2	6	0	0
25	18961792	.	A	T	3	2	5	0	2	7	0	0
25	18962235	.	A	G	4	4	8	0	0	8	0	0
25	18962782	.	G	T	4	8	12	0	0	12	0	0
25	18962802	.	T	C	4	6	10	0	0	10	0	0
25	18962858	.	C	T	6	6	12	0	1	13	0	0
25	18963607	.	A	G	4	3	7	0	0	7	0	0
25	18964883	.	A	T	7	8	15	0	1	16	0	0
25	18965018	.	T	A	3	2	5	0	0	5	0	0
25	18965278	.	T	A	2	3	5	0	0	5	0	0
25	18965293	.	C	G	2	0	2	0	3	5	0	0
25	18970837	.	C	T	7	4	11	0	0	11	0	0
25	18976498	.	C	T	4	7	11	0	0	11	0	0
25	18976522	.	A	G	7	0	7	0	8	15	0	0
25	18976555	.	C	T	9	7	16	0	0	16	0	0
25	18977092	.	A	G	4	3	7	0	0	7	0	0
25	18977429	.	A	G	8	4	12	0	1	13	0	0
25	18977469	.	T	A	12	4	16	0	2	18	0	0
25	19009527	.	T	C	8	11	19	0	2	21	0	0
25	19013611	.	C	T	10	8	18	0	0	18	0	0
25	19016529	.	A	G	13	0	13	0	18	31	0	0
25	19016690	.	T	C	16	9	25	0	0	25	0	0
25	19016736	.	C	T	20	15	35	0	1	36	0	0
25	19018845	.	T	C	16	11	27	0	1	28	0	0
25	19019003	.	A	T	16	10	26	0	0	26	0	0
25	19020981	.	G	A	1	19	20	0	16	36	0	0
25	19021062	.	T	C	7	11	18	0	1	19	0	0
25	19021618	.	C	A	6	7	13	0	0	13	0	0
25	19021647	.	T	G	8	1	9	0	6	15	0	0
25	19021680	.	A	G	7	9	16	0	1	17	0	0
25	19026877	.	A	C	7	3	10	0	2	12	0	0
25	19026941	.	G	A	5	6	11	0	0	11	0	0
25	19028610	.	G	A	6	3	9	0	0	9	0	0
25	19028637	.	C	T	4	5	9	0	0	9	0	0
25	19030154	.	C	T	2	3	5	0	1	6	0	0
25	19051746	.	T	C	5	0	5	0	3	8	0	0
25	19051761	.	A	G	6	4	10	0	0	10	0	0
25	19060434	.	G	A	6	5	11	1	0	12	0	0
25	19063190	.	A	G	2	5	7	0	0	7	0	0
25	19097035	.	A	T	1	5	6	0	0	6	0	0
25	19097082	.	A	T	6	3	9	0	0	9	0	0
25	19097172	.	A	G	4	5	9	0	1	10	0	0
25	19097214	.	A	C	8	5	13	0	0	13	0	0
25	19097314	.	A	C	6	6	12	0	0	12	0	0
25	19098388	.	C	T	9	5	14	0	0	14	0	0
25	19107718	.	G	A	0	5	5	0	2	7	0	0
25	19111574	.	C	T	4	4	8	0	0	8	0	0
25	19111806	.	C	T	1	4	5	0	0	5	0	0
25	19120716	.	T	A	1	2	3	0	0	3	0	0
25	19120764	.	A	G	4	4	8	0	0	8	0	0
25	19120800	.	C	T	2	8	10	0	0	10	0	0
25	19121092	.	T	C	3	7	10	0	0	10	0	0
25	19121126	.	T	C	4	1	5	0	8	13	0	0
25	19121147	.	A	G	6	7	13	0	0	13	0	0
25	19132008	.	T	C	1	0	1	0	6	7	0	0
25	19133092	.	G	C	2	3	5	0	0	5	0	0
25	19134470	.	C	T	5	4	9	0	0	9	0	0
25	19164147	.	G	A	7	7	14	0	0	14	0	0
25	19179124	.	A	C	4	3	7	0	0	7	0	0
25	19180129	.	A	G	2	1	3	0	3	6	0	0
25	19180159	.	C	T	4	4	8	0	0	8	0	0
25	19181396	.	T	C	13	11	24	0	1	25	0	0
25	19181471	.	A	T	11	12	23	1	1	25	0	0
25	19184051	.	T	C	13	9	22	0	1	23	0	0
25	19184105	.	T	G	11	0	11	0	9	20	0	0
25	19184159	.	A	C	11	8	19	0	2	21	0	0
25	19188454	.	C	T	17	18	35	0	1	36	0	0
25	19189113	.	T	G	3	7	10	0	0	10	0	0
25	19189144	.	T	C	2	4	6	0	0	6	0	0
25	19189217	.	G	A	2	2	4	0	0	4	0	0
25	19189238	.	C	A	3	4	7	0	0	7	0	0
25	19189461	.	C	A	3	3	6	0	0	6	0	0
25	19189502	.	T	G	5	2	7	0	1	8	0	0
25	19189769	.	C	T	4	2	6	0	0	6	0	0
25	19190111	.	T	C	6	9	15	0	1	16	0	0
25	19190183	.	G	A	9	9	18	0	0	18	0	0
25	19190244	.	C	A	3	3	6	0	2	8	0	0
25	19190282	.	A	C	1	5	6	0	0	6	0	0
25	19190376	.	G	T	6	10	16	0	0	16	0	0
25	19190408	.	C	T	6	8	14	0	0	14	0	0
25	19190802	.	A	G	1	3	4	0	0	4	0	0
25	19191325	.	C	T	2	4	6	0	0	6	0	0
25	19191575	.	C	T	8	8	16	0	2	18	0	0
25	19191652	.	T	G	13	1	14	0	21	35	0	0
25	19191797	.	A	C	8	13	21	0	7	28	0	0
25	19191959	.	A	T	9	8	17	0	0	17	0	0
25	19205208	.	A	C	1	2	3	0	0	3	0	0
25	19205216	.	A	G	2	2	4	0	0	4	0	0
25	19205345	.	A	T	1	4	5	0	1	6	0	0
25	19205783	.	G	C	4	8	12	0	0	12	0	0
25	19272737	.	A	G	1	2	3	0	0	3	0	0
25	19311299	.	G	A	0	2	2	0	1	3	0	0
25	19359314	.	G	A	21	20	41	0	0	41	0	0
25	19359402	.	A	G	22	16	38	0	1	39	0	0
25	19359640	.	C	T	2	26	28	0	23	51	0	0
25	19359734	.	A	G	33	25	58	0	2	60	0	0
25	19361012	.	C	T	28	30	58	0	3	62	1	0
25	19363616	.	G	A	30	25	55	1	5	61	0	0
25	19364155	.	G	A	40	17	57	0	0	57	0	0
25	19364184	.	T	A	36	22	58	0	3	61	0	0
25	19364210	.	T	G	34	30	64	0	1	65	0	0
25	19364279	.	T	A	34	26	60	0	11	71	0	0
25	19364519	.	T	A	29	27	56	0	1	57	0	0
25	19364598	.	T	G	34	25	59	0	2	62	1	0
25	19364642	.	C	T	30	23	53	0	3	56	0	0
25	19364717	.	A	G	25	21	46	0	2	48	0	0
25	19365053	.	G	A	32	24	56	0	4	60	0	0
25	19365559	.	G	A	25	23	48	0	3	51	0	0
25	19365647	.	A	G	21	23	44	0	2	46	0	0
25	19366124	.	A	G	25	25	50	0	4	54	0	0
25	19366175	.	A	T	19	30	49	0	0	49	0	0
25	19366363	.	T	C	21	22	43	0	4	47	0	0
25	19366432	.	A	T	22	33	55	0	4	59	0	0
25	19366741	.	A	C	21	31	52	0	0	52	0	0
25	19367304	.	T	A	26	16	42	0	3	45	0	0
25	19367531	.	A	G	21	14	35	0	0	35	0	0
25	19367753	.	A	T	23	25	48	0	1	49	0	0
25	19368016	.	A	T	17	23	40	0	4	44	0	0
25	19368105	.	A	G	21	22	43	0	0	44	1	0
25	19368429	.	G	A	31	19	50	0	0	50	0	0
25	19368548	.	G	T	33	18	51	0	1	52	0	0
25	19368620	.	T	A	27	26	53	0	0	53	0	0
25	19368803	.	T	C	17	20	37	0	2	39	0	0
25	19369326	.	A	G	10	28	38	0	1	39	0	0
25	19369331	.	G	A	11	28	39	0	0	39	0	0
25	19369400	.	A	C	19	19	38	0	2	40	0	0
25	19369420	.	C	T	26	18	44	0	2	46	0	0
25	19369448	.	G	T	24	20	44	0	1	45	0	0
25	19369701	.	T	A	20	20	40	0	5	45	0	0
25	19369822	.	C	T	14	22	36	0	1	37	0	0
25	19369911	.	G	A	18	16	34	0	3	37	0	0
25	19369913	.	A	T	20	17	37	0	1	38	0	0
25	19370082	.	G	A	21	23	44	0	2	46	0	0
25	19370308	.	G	C	21	27	48	0	0	48	0	0
25	19370464	.	T	C	17	23	40	0	2	42	0	0
25	19370507	.	T	C	21	19	40	0	1	41	0	0
25	19370623	.	A	C	28	1	29	0	17	46	0	0
25	19370670	.	A	T	22	13	35	0	1	36	0	0
25	19371055	.	A	T	19	8	27	0	0	27	0	0
25	19371087	.	G	A	15	6	21	0	1	22	0	0
25	19372297	.	A	G	26	21	47	0	4	51	0	0
25	19372490	.	A	T	16	14	30	0	1	31	0	0
25	19372491	.	T	G	15	15	30	0	1	31	0	0
25	19372943	.	T	G	22	13	35	0	0	35	0	0
25	19395132	.	G	A	2	5	7	0	0	7	0	0
25	19433024	.	A	G	3	8	11	0	0	11	0	0
25	19433039	.	T	A	3	9	12	0	1	13	0	0
25	19442049	.	T	C	5	6	11	0	0	11	0	0
25	19442955	.	G	A	34	25	59	0	3	62	0	0
25	19443192	.	T	C	30	28	58	0	0	58	0	0
25	19443356	.	C	T	40	24	64	0	1	65	0	0
25	19486356	.	A	C	11	0	11	0	8	19	0	0
25	19531894	.	T	A	6	4	10	0	0	10	0	0
25	19535374	.	G	A	2	2	4	0	0	4	0	0
25	19535746	.	C	T	3	3	6	0	0	6	0	0
25	19535782	.	G	T	2	3	5	0	0	5	0	0
25	19552965	.	T	C	3	1	4	2	0	6	0	0
25	19560890	.	T	C	3	5	8	0	0	8	0	0
25	19560982	.	A	G	1	3	4	0	0	4	0	0
25	19562558	.	G	A	2	2	4	0	0	4	0	0
25	19562756	.	C	T	5	5	10	0	0	10	0	0
25	19570612	.	T	C	4	0	4	0	3	7	0	0
25	19570631	.	G	T	2	4	6	0	1	7	0	0
25	19570692	.	A	G	4	3	7	0	0	7	0	0
25	19570725	.	T	A	2	3	5	0	0	5	0	0
25	19570873	.	A	G	6	3	9	0	1	10	0	0
25	19570995	.	T	G	5	7	12	0	0	12	0	0
25	19571018	.	A	G	5	7	12	0	0	12	0	0
25	19574054	.	T	C	2	6	8	0	0	8	0	0
25	19585916	.	C	A	12	11	23	0	0	23	0	0
25	19586712	.	G	A	6	14	20	0	0	20	0	0
25	19586743	.	A	G	7	11	18	0	0	18	0	0
25	19588294	.	A	G	5	12	17	0	2	19	0	0
25	19591844	.	T	C	7	10	17	0	0	17	0	0
25	19593478	.	G	A	8	8	16	0	1	17	0	0
25	19600005	.	G	T	1	2	3	0	1	4	0	0
25	19602158	.	C	T	1	2	3	0	1	4	0	0
25	19602169	.	T	G	1	3	4	0	0	4	0	0
25	19609988	.	T	C	2	4	6	0	0	6	0	0
25	19610021	.	C	T	0	3	3	0	1	4	0	0
25	19610708	.	G	T	2	4	6	0	0	6	0	0
25	19612818	.	G	T	3	2	5	0	0	5	0	0
25	19614982	.	A	G	2	4	6	0	0	6	0	0
25	19614991	.	A	G	2	3	5	0	0	5	0	0
25	19714180	.	C	T	1	2	3	0	0	3	0	0
25	19714217	.	T	C	1	1	2	0	1	3	0	0
25	19730570	.	T	C	1	5	6	0	0	6	0	0
25	19741229	.	A	G	5	10	15	0	1	16	0	0
25	19741340	.	C	A	4	5	9	0	1	10	0	0
25	19743751	.	A	G	5	5	10	0	2	12	0	0
25	19746661	.	A	G	9	0	9	0	8	17	0	0
25	19747150	.	T	C	15	13	28	0	0	28	0	0
25	19805200	.	G	A	0	2	2	0	1	3	0	0
25	19818433	.	T	C	1	2	3	0	0	3	0	0
25	19839762	.	A	C	3	2	5	0	0	5	0	0
25	19839768	.	T	A	3	2	5	0	0	5	0	0
25	19839837	.	G	A	1	2	3	0	1	4	0	0
25	19839861	.	C	G	2	2	4	0	0	4	0	0
25	19857993	.	G	A	0	3	3	0	1	4	0	0
25	19858043	.	G	A	0	2	2	0	3	5	0	0
25	19864594	.	C	T	3	2	5	0	1	6	0	0
25	19865441	.	A	T	2	2	4	0	0	4	0	0
25	19865897	.	T	G	2	0	2	0	4	6	0	0
25	19865904	.	G	T	2	4	6	0	0	6	0	0
25	19865986	.	G	C	3	4	7	2	0	9	0	0
25	19866660	.	A	G	2	0	2	0	5	7	0	0
25	19866713	.	C	T	4	5	9	0	0	9	0	0
25	19866749	.	T	A	3	3	6	0	0	6	0	0
25	19866752	.	G	T	3	4	7	0	0	7	0	0
25	19867103	.	C	T	4	2	6	0	1	7	0	0
25	19867180	.	C	T	2	2	4	0	0	4	0	0
25	19867208	.	T	C	1	4	5	0	0	5	0	0
25	19867313	.	A	G	2	2	4	0	0	4	0	0
25	19867383	.	T	C	5	3	8	0	0	8	0	0
25	19867436	.	A	T	3	4	7	0	0	7	0	0
25	19867442	.	G	A	1	2	3	0	2	5	0	0
25	19867483	.	A	C	3	2	5	0	0	5	0	0
25	19871095	.	C	A	3	3	6	0	1	7	0	0
25	19871116	.	A	G	5	4	9	0	0	9	0	0
25	19901714	.	T	C	1	7	8	0	0	8	0	0
25	19923247	.	T	C	3	3	6	0	0	6	0	0
25	19924211	.	C	T	9	4	13	0	0	13	0	0
25	19931496	.	T	C	1	4	5	0	0	5	0	0
25	19931796	.	A	G	4	0	4	0	2	6	0	0
25	19931803	.	C	T	4	4	8	0	1	9	0	0
25	19932011	.	C	T	2	3	5	2	0	7	0	0
25	19932096	.	C	T	7	4	11	0	0	11	0	0
25	19932261	.	C	T	2	4	6	0	0	6	0	0
25	19932332	.	A	T	2	3	5	0	0	5	0	0
25	19932352	.	T	C	3	3	6	0	0	6	0	0
25	19932911	.	T	C	3	3	6	0	0	6	0	0
25	19933034	.	T	C	2	2	4	0	0	4	0	0
25	19933297	.	T	A	6	3	9	0	0	9	0	0
25	19933302	.	A	T	5	3	8	0	0	8	0	0
25	19933582	.	A	G	3	2	5	1	0	6	0	0
25	19933667	.	A	C	2	3	5	0	0	5	0	0
25	19933793	.	G	A	0	7	7	0	3	10	0	0
25	19933807	.	A	C	4	7	11	0	0	11	0	0
25	19933831	.	T	G	2	8	10	0	0	10	0	0
25	19933842	.	A	T	3	6	9	0	0	9	0	0
25	19934006	.	A	G	1	5	6	0	0	6	0	0
25	19934008	.	T	A	1	5	6	0	0	6	0	0
25	19934181	.	A	G	5	8	13	0	0	13	0	0
25	19934231	.	A	T	5	7	12	0	0	12	0	0
25	19934455	.	G	A	5	11	16	0	3	19	0	0
25	19934482	.	G	C	5	10	15	0	0	15	0	0
25	19934727	.	T	G	2	0	2	0	5	7	0	0
25	19934763	.	A	C	1	3	4	0	1	5	0	0
25	19934831	.	C	T	1	2	3	0	0	3	0	0
25	19934942	.	A	G	3	0	3	0	5	8	0	0
25	19934966	.	A	G	5	0	5	0	5	10	0	0
25	19935213	.	A	C	9	13	22	0	1	23	0	0
25	19935222	.	T	A	10	16	26	0	0	26	0	0
25	19935269	.	C	T	7	13	20	1	2	23	0	0
25	19935313	.	G	A	1	6	7	1	5	13	0	0
25	19935402	.	A	T	7	4	11	0	2	13	0	0
25	19935437	.	G	A	0	6	6	0	17	23	0	0
25	19935538	.	T	C	4	6	10	1	0	11	0	0
25	19935556	.	G	A	4	4	8	0	0	8	0	0
25	19935700	.	A	G	11	7	18	2	0	20	0	0
25	19935791	.	A	G	2	0	2	0	5	7	0	0
25	19935951	.	G	A	4	5	9	0	0	9	0	0
25	19936101	.	G	A	6	7	13	0	0	13	0	0
25	19936123	.	A	G	5	5	10	0	0	10	0	0
25	19936304	.	A	T	4	10	14	0	2	16	0	0
25	19955458	.	A	G	14	17	31	0	0	31	0	0
25	19955855	.	T	C	10	15	25	0	2	27	0	0
25	19955984	.	G	A	10	12	22	0	1	23	0	0
25	19956833	.	T	C	17	17	34	0	1	35	0	0
25	19957759	.	A	C	10	11	21	0	0	21	0	0
25	20003413	.	G	C	1	15	16	0	13	29	0	0
25	20016318	.	A	G	8	4	12	0	1	13	0	0
25	20027511	.	T	A	1	1	2	0	1	3	0	0
25	20121387	.	T	C	13	13	26	0	2	28	0	0
25	20121447	.	A	G	17	1	18	0	12	30	0	0
25	20121462	.	G	A	21	12	33	0	1	34	0	0
25	20125827	.	C	T	19	14	33	0	0	33	0	0
25	20125879	.	T	A	12	19	31	0	2	33	0	0
25	20125897	.	T	C	14	15	29	0	0	29	0	0
25	20125934	.	G	T	10	10	20	0	2	22	0	0
25	20125949	.	C	T	10	11	21	0	1	22	0	0
25	20126004	.	T	A	13	11	24	0	0	24	0	0
25	20126152	.	T	C	11	5	16	0	0	16	0	0
25	20126157	.	T	A	10	6	16	0	0	16	0	0
25	20126204	.	G	T	6	5	11	0	1	12	0	0
25	20126261	.	A	G	10	5	15	0	0	16	1	0
25	20126273	.	A	G	12	5	17	0	0	17	0	0
25	20126305	.	T	A	11	6	17	0	0	17	0	0
25	20126433	.	G	A	1	5	6	0	3	9	0	0
25	20126688	.	A	T	2	4	6	0	0	6	0	0
25	20126702	.	A	G	5	4	9	0	0	9	0	0
25	20126750	.	T	A	9	5	14	0	0	14	0	0
25	20126870	.	T	G	5	9	14	0	0	14	0	0
25	20126915	.	A	G	5	7	12	0	0	12	0	0
25	20126953	.	G	A	0	2	2	0	5	7	0	0
25	20126971	.	G	T	4	2	6	0	0	6	0	0
25	20229802	.	C	T	2	17	19	0	23	42	0	0
25	20229843	.	T	C	20	1	21	0	21	42	0	0
25	20229887	.	C	A	18	27	45	0	1	46	0	0
25	20231657	.	G	A	23	21	44	0	0	44	0	0
25	20241699	.	T	A	13	18	31	0	0	32	1	0
25	20241705	.	T	G	12	17	29	0	1	30	0	0
25	20241759	.	A	G	13	18	31	0	1	32	0	0
25	20241884	.	C	T	2	12	14	0	14	28	0	0
25	20244861	.	T	C	20	0	20	0	19	39	0	0
25	20245022	.	C	T	2	16	18	0	19	37	0	0
25	20245332	.	C	T	14	17	31	0	1	32	0	0
25	20247968	.	T	C	12	11	23	0	2	25	0	0
25	20252987	.	T	C	13	17	30	0	2	32	0	0
25	20253053	.	C	T	3	17	20	0	24	44	0	0
25	20253092	.	C	T	20	18	38	0	4	42	0	0
25	20279817	.	C	T	1	2	3	0	0	3	0	0
25	20284179	.	A	C	3	6	9	0	0	9	0	0
25	20290315	.	G	A	4	3	7	0	0	7	0	0
25	20297601	.	C	T	3	5	8	0	0	8	0	0
25	20355326	.	G	C	1	4	5	1	2	8	0	0
25	20355432	.	C	T	4	2	6	0	0	6	0	0
25	20358708	.	A	T	13	14	27	0	4	31	0	0
25	20358999	.	G	A	12	12	24	0	1	25	0	0
25	20359005	.	C	A	0	13	13	0	15	28	0	0
25	20359639	.	G	A	7	9	16	0	0	16	0	0
25	20366747	.	C	T	11	15	26	0	1	27	0	0
25	20378086	.	G	A	8	9	17	0	1	18	0	0
25	20378095	.	T	C	6	9	15	0	1	16	0	0
25	20381198	.	C	T	6	7	13	0	0	13	0	0
25	20388721	.	C	T	2	3	5	0	1	6	0	0
25	20389277	.	G	A	6	2	8	0	0	8	0	0
25	20389337	.	G	A	5	6	11	0	0	11	0	0
25	20389664	.	C	T	4	2	6	0	2	8	0	0
25	20389682	.	C	T	3	4	7	0	0	7	0	0
25	20389796	.	G	T	1	6	7	0	0	7	0	0
25	20390144	.	G	C	5	8	13	0	0	13	0	0
25	20482425	.	A	G	3	3	6	0	0	6	0	0
25	20571077	.	A	C	3	2	5	0	0	5	0	0
25	20601690	.	A	T	4	2	6	0	0	6	0	0
25	20601819	.	T	A	6	4	10	0	0	10	0	0
25	20602316	.	T	A	19	18	37	0	3	40	0	0
25	20602347	.	C	T	15	15	30	0	2	32	0	0
25	20602373	.	C	T	18	17	35	0	1	36	0	0
25	20602716	.	A	G	20	15	35	0	1	36	0	0
25	20666018	.	T	C	8	8	16	0	0	16	0	0
25	20666024	.	T	C	9	7	16	0	0	16	0	0
25	20669130	.	G	T	4	3	7	0	1	8	0	0
25	20669323	.	C	T	6	2	8	0	1	9	0	0
25	20669332	.	G	A	1	5	6	0	1	7	0	0
25	20669657	.	A	G	2	12	14	0	0	14	0	0
25	20669939	.	A	C	1	2	3	0	1	4	0	0
25	20670029	.	A	G	3	6	9	0	0	9	0	0
25	20670036	.	T	C	5	2	7	0	1	8	0	0
25	20670127	.	G	A	5	5	10	0	0	10	0	0
25	20670203	.	G	C	5	4	9	0	1	10	0	0
25	20670370	.	C	T	3	3	6	0	0	6	0	0
25	20670632	.	A	T	2	4	6	0	0	6	0	0
25	20670669	.	G	A	1	5	6	0	0	6	0	0
25	20670673	.	T	A	1	5	6	0	0	6	0	0
25	20670708	.	T	C	2	4	6	0	0	6	0	0
25	20670840	.	A	G	2	3	5	0	1	6	0	0
25	20671174	.	C	T	2	2	4	0	0	4	0	0
25	20671316	.	C	T	0	2	2	0	2	4	0	0
25	20671769	.	T	C	2	3	5	0	0	5	0	0
25	20672281	.	A	G	1	6	7	0	0	7	0	0
25	20672810	.	T	C	2	3	5	0	0	5	0	0
25	20678773	.	G	T	3	2	5	0	0	5	0	0
25	20682441	.	T	C	5	3	8	0	1	9	0	0
25	20682510	.	T	C	3	0	3	0	5	8	0	0
25	20682576	.	T	A	2	1	3	0	1	4	0	0
25	20682582	.	C	T	2	2	4	0	1	5	0	0
25	20682618	.	G	A	3	2	5	0	1	6	0	0
25	20687235	.	G	A	5	4	9	0	0	9	0	0
25	20687279	.	G	A	1	5	6	0	0	6	0	0
25	20701369	.	G	A	7	11	18	0	0	18	0	0
25	20701408	.	T	C	8	14	22	0	0	22	0	0
25	20701409	.	G	A	8	14	22	0	0	22	0	0
25	20701516	.	A	G	6	2	8	0	4	12	0	0
25	20721482	.	A	C	11	6	17	0	1	18	0	0
25	20721502	.	C	T	10	9	19	0	0	19	0	0
25	20723017	.	A	C	6	9	15	0	3	18	0	0
25	20724822	.	G	A	4	14	18	0	10	28	0	0
25	20724879	.	G	A	11	7	18	0	1	19	0	0
25	20726626	.	G	A	2	10	12	0	13	25	0	0
25	20726884	.	G	T	5	4	9	4	0	13	0	0
25	20729919	.	G	A	2	3	5	0	0	5	0	0
25	20730091	.	G	A	1	2	3	0	0	3	0	0
25	20730499	.	C	T	1	3	4	0	8	12	0	0
25	20730707	.	T	A	6	5	11	0	1	12	0	0
25	20750471	.	C	T	2	2	4	0	1	5	0	0
25	20760221	.	G	A	3	5	8	0	0	8	0	0
25	20768049	.	G	C	6	2	8	0	0	8	0	0
25	20774898	.	G	A	2	3	5	0	0	5	0	0
25	20815496	.	G	C	2	2	4	0	0	4	0	0
25	20850573	.	G	A	6	2	8	0	0	8	0	0
25	20853317	.	C	A	2	3	5	0	1	6	0	0
25	20998004	.	G	A	1	6	7	0	0	7	0	0
25	20999140	.	T	A	2	4	6	0	0	6	0	0
25	21064337	.	A	T	2	3	5	0	0	5	0	0
25	21064358	.	C	G	2	2	4	0	0	4	0	0
25	21065024	.	T	C	7	5	12	0	0	12	0	0
25	21066091	.	T	C	7	1	8	0	5	13	0	0
25	21066092	.	G	A	5	7	12	0	1	13	0	0
25	21075410	.	G	T	11	12	23	0	1	24	0	0
25	21077571	.	A	C	9	0	9	0	8	17	0	0
25	21085569	.	A	G	7	4	11	0	3	14	0	0
25	21085659	.	C	T	8	8	16	0	1	17	0	0
25	21091634	.	C	A	0	10	10	0	10	20	0	0
25	21110562	.	A	T	2	2	4	0	0	4	0	0
25	21115784	.	C	A	14	15	29	0	0	29	0	0
25	21119687	.	G	A	24	14	38	0	0	38	0	0
25	21119697	.	T	C	15	0	15	0	21	36	0	0
25	21119843	.	T	A	16	13	29	0	1	30	0	0
25	21121964	.	C	T	15	14	29	0	0	29	0	0
25	21125075	.	G	A	12	14	26	0	2	28	0	0
25	21125108	.	A	G	16	11	27	0	0	27	0	0
25	21126004	.	C	T	8	8	16	0	0	16	0	0
25	21129695	.	A	G	14	9	23	0	0	23	0	0
25	21129729	.	G	A	11	13	24	0	1	25	0	0
25	21129836	.	A	T	13	10	23	0	4	27	0	0
25	21132534	.	C	A	12	13	25	0	0	25	0	0
25	21133118	.	T	C	9	0	9	0	11	20	0	0
25	21134398	.	A	T	7	7	14	0	1	15	0	0
25	21134399	.	C	T	0	7	7	0	8	15	0	0
25	21134472	.	C	T	6	5	11	0	0	11	0	0
25	21153474	.	C	T	2	7	9	0	7	16	0	0
25	21154418	.	G	T	7	3	10	0	1	11	0	0
25	21156339	.	T	C	2	5	7	0	0	7	0	0
25	21156379	.	C	T	6	2	8	0	0	8	0	0
25	21156509	.	C	T	0	3	3	0	2	5	0	0
25	21177396	.	A	G	10	0	10	0	14	24	0	0
25	21180649	.	G	T	11	10	21	1	0	22	0	0
25	21180658	.	C	T	11	6	17	1	0	18	0	0
25	21194552	.	C	T	13	21	34	0	0	34	0	0
25	21202349	.	C	T	11	16	27	0	1	28	0	0
25	21206481	.	G	A	18	13	31	0	0	31	0	0
25	21213122	.	G	T	16	16	32	0	4	36	0	0
25	21253053	.	T	C	21	17	38	0	1	39	0	0
25	21277546	.	C	A	1	2	3	0	0	3	0	0
25	21277558	.	C	T	0	2	2	0	1	3	0	0
25	21277721	.	A	G	7	3	10	0	0	10	0	0
25	21277739	.	C	T	0	4	4	0	7	12	1	0
25	21277765	.	T	C	6	5	11	0	0	11	0	0
25	21277786	.	C	T	0	5	5	0	5	10	0	0
25	21277811	.	C	T	5	6	11	0	0	11	0	0
25	21277839	.	T	C	3	7	10	0	0	10	0	0
25	21277856	.	A	G	5	3	8	0	0	8	0	0
25	21277927	.	G	T	8	8	16	0	0	16	0	0
25	21278053	.	T	A	4	10	14	0	0	14	0	0
25	21278055	.	A	G	5	10	15	0	0	15	0	0
25	21278193	.	G	A	9	5	14	0	1	15	0	0
25	21278235	.	G	A	3	8	11	0	1	12	0	0
25	21278244	.	A	G	3	7	10	0	1	11	0	0
25	21280506	.	T	G	5	7	12	0	1	13	0	0
25	21298444	.	C	T	2	2	4	0	0	4	0	0
25	21324661	.	C	T	11	5	16	0	1	17	0	0
25	21324726	.	C	A	14	11	25	0	1	26	0	0
25	21341712	.	T	A	16	9	25	0	0	25	0	0
25	21342512	.	C	T	19	12	31	0	0	31	0	0
25	21343250	.	A	C	6	16	22	0	0	22	0	0
25	21343301	.	C	T	20	17	37	0	0	37	0	0
25	21343340	.	G	C	13	25	38	0	1	39	0	0
25	21343358	.	C	T	26	13	39	0	0	39	0	0
25	21343408	.	T	C	16	7	23	0	1	24	0	0
25	21343420	.	A	T	14	9	23	0	1	24	0	0
25	21343476	.	G	A	11	10	21	0	1	22	0	0
25	21343487	.	C	T	12	7	19	0	2	21	0	0
25	21343631	.	T	A	15	18	33	0	2	35	0	0
25	21343643	.	A	G	17	0	17	0	21	38	0	0
25	21343901	.	T	C	20	16	36	0	0	36	0	0
25	21344290	.	G	T	12	10	22	0	0	22	0	0
25	21507432	.	A	G	1	5	6	0	0	6	0	0
25	21518393	.	T	C	1	0	1	0	4	5	0	0
25	21518545	.	G	A	4	3	7	0	0	7	0	0
25	21518554	.	T	C	1	0	1	0	4	5	0	0
25	21518679	.	T	A	3	7	10	0	0	10	0	0
25	21519943	.	C	T	0	2	2	0	4	6	0	0
25	21520164	.	C	G	1	2	3	0	1	4	0	0
25	21520198	.	C	A	2	2	4	0	0	4	0	0
25	21520202	.	G	A	1	2	3	0	0	3	0	0
25	21520383	.	T	G	3	1	4	0	1	5	0	0
25	21520391	.	T	C	3	0	3	0	2	5	0	0
25	21520440	.	T	A	4	2	6	0	0	6	0	0
25	21520756	.	A	G	1	3	4	0	0	4	0	0
25	21520792	.	G	A	2	7	9	0	1	10	0	0
25	21520834	.	A	C	3	9	12	0	1	13	0	0
25	21521504	.	T	A	5	5	10	0	0	10	0	0
25	21521666	.	A	G	4	5	9	0	0	9	0	0
25	21521764	.	G	A	2	5	7	0	0	7	0	0
25	21522151	.	A	T	1	2	3	0	0	3	0	0
25	21522152	.	C	A	1	2	3	0	0	3	0	0
25	21522819	.	G	C	3	2	5	0	0	5	0	0
25	21522846	.	A	T	2	3	5	0	0	5	0	0
25	21528828	.	A	G	2	3	5	0	1	6	0	0
25	21532512	.	G	A	10	4	14	0	0	14	0	0
25	21533711	.	G	C	6	0	6	0	6	12	0	0
25	21535738	.	G	A	12	8	20	0	0	20	0	0
25	21538973	.	T	C	6	0	6	0	7	13	0	0
25	21541250	.	G	A	2	5	7	1	1	9	0	0
25	21554990	.	C	T	1	4	5	0	0	5	0	0
25	21557276	.	G	C	1	0	1	0	2	3	0	0
25	21561817	.	G	A	4	5	9	0	1	10	0	0
25	21581005	.	G	A	4	2	6	0	0	6	0	0
25	21586891	.	G	A	5	3	8	0	0	8	0	0
25	21601206	.	C	T	2	3	5	0	0	5	0	0
25	21609733	.	A	T	4	2	6	0	0	6	0	0
25	21612623	.	A	G	2	3	5	0	0	5	0	0
25	21628322	.	G	A	3	2	5	0	0	5	0	0
25	21630686	.	T	C	3	2	5	0	0	5	0	0
25	21652493	.	C	A	2	2	4	0	0	4	0	0
25	21654940	.	T	G	6	5	11	0	0	11	0	0
25	21654952	.	G	A	6	5	11	0	0	11	0	0
25	21724876	.	C	A	2	3	5	0	0	5	0	0
25	21726776	.	C	T	8	2	10	0	0	10	0	0
25	21737010	.	T	C	5	4	9	0	0	9	0	0
25	21741444	.	A	G	3	3	6	0	0	6	0	0
25	21743630	.	G	A	3	4	7	0	1	8	0	0
25	21771898	.	T	G	10	11	21	0	1	22	0	0
25	21833163	.	A	G	22	26	48	0	0	48	0	0
25	21833307	.	C	T	33	32	65	2	0	67	0	0
25	21833308	.	G	T	0	32	32	2	33	67	0	0
25	21834976	.	G	A	4	22	26	0	37	63	0	0
25	21835081	.	T	C	36	26	62	0	1	63	0	0
25	21835093	.	T	C	32	27	59	0	4	63	0	0
25	21835126	.	A	T	31	27	58	0	2	60	0	0
25	21835268	.	T	C	35	31	66	0	2	68	0	0
25	21841487	.	G	A	24	28	52	0	1	53	0	0
25	21843369	.	G	T	36	22	58	0	3	61	0	0
25	21847233	.	C	T	36	33	69	1	4	74	0	0
25	21860841	.	T	A	12	6	18	0	1	19	0	0
25	21860842	.	A	T	13	5	18	0	0	19	1	0
25	21860969	.	G	T	12	7	19	0	0	19	0	0
25	21861070	.	C	T	1	4	5	0	14	19	0	0
25	21861098	.	T	C	7	0	7	0	8	15	0	0
25	21863452	.	C	T	3	2	5	0	0	5	0	0
25	21863525	.	T	G	7	5	12	0	0	12	0	0
25	21863630	.	C	T	9	9	18	0	0	18	0	0
25	21863636	.	G	A	10	8	18	0	0	18	0	0
25	21865988	.	C	T	1	7	8	0	6	14	0	0
25	21866386	.	G	A	15	10	25	0	0	25	0	0
25	21866404	.	C	T	1	7	8	0	18	26	0	0
25	21877548	.	C	T	8	4	12	0	1	13	0	0
25	21893958	.	T	G	8	5	13	0	2	15	0	0
25	21893988	.	G	C	9	6	15	0	0	15	0	0
25	21894072	.	A	G	7	4	11	0	0	11	0	0
25	22066772	.	G	C	0	4	4	0	5	9	0	0
25	22070316	.	G	A	6	4	10	0	0	10	0	0
25	22070352	.	C	T	1	3	4	0	0	4	0	0
25	22079368	.	T	C	3	3	6	0	0	6	0	0
25	22079372	.	T	A	3	3	6	0	0	6	0	0
25	22079521	.	G	A	0	2	2	0	4	6	0	0
25	22079532	.	C	A	4	3	7	0	0	7	0	0
25	22079673	.	C	T	1	3	4	0	0	4	0	0
25	22079682	.	T	C	1	2	3	0	0	3	0	0
25	22085092	.	T	C	5	2	7	0	0	7	0	0
25	22085155	.	C	A	7	2	9	0	1	10	0	0
25	22086896	.	T	C	2	5	7	0	0	7	0	0
25	22087025	.	T	C	4	2	6	0	0	6	0	0
25	22087040	.	G	C	0	1	1	0	2	3	0	0
25	22087140	.	T	C	5	4	9	0	0	9	0	0
25	22087173	.	A	G	4	0	4	0	4	8	0	0
25	22090699	.	T	C	5	3	8	0	0	8	0	0
25	22090721	.	T	C	2	3	5	0	0	5	0	0
25	22092134	.	T	A	4	3	7	0	0	7	0	0
25	22092137	.	G	A	4	3	7	0	0	7	0	0
25	22095325	.	G	C	1	5	6	0	0	6	0	0
25	22095498	.	T	G	1	2	3	0	0	3	0	0
25	22228713	.	G	T	0	3	3	0	6	9	0	0
25	22232870	.	C	T	9	6	15	0	0	15	0	0
25	22232873	.	C	A	9	6	15	0	0	15	0	0
25	22241195	.	G	A	0	2	2	0	5	7	0	0
25	22281504	.	C	A	4	3	7	0	0	7	0	0
25	22281645	.	G	A	3	3	6	0	1	7	0	0
25	22288473	.	G	C	3	6	9	0	0	9	0	0
25	22288605	.	A	G	4	0	4	0	8	12	0	0
25	22291766	.	T	C	7	6	13	0	2	15	0	0
25	22292558	.	G	A	1	3	4	0	0	4	0	0
25	22635759	.	A	G	26	21	47	0	4	51	0	0
25	22635812	.	T	G	23	24	47	0	0	47	0	0
25	22635999	.	C	A	26	11	37	0	0	37	0	0
25	22636020	.	T	A	21	12	33	1	1	35	0	0
25	22636565	.	A	T	34	20	54	0	5	59	0	0
25	22636574	.	G	A	29	22	51	0	4	55	0	0
25	22636967	.	C	T	22	31	53	0	1	54	0	0
25	22637039	.	A	G	29	25	54	0	0	54	0	0
25	22637273	.	A	G	21	24	45	0	3	48	0	0
25	22637290	.	C	A	2	27	29	0	21	50	0	0
25	22637384	.	G	A	23	27	50	0	1	51	0	0
25	22637444	.	A	T	22	17	39	0	3	42	0	0
25	22637501	.	A	G	19	19	38	0	2	40	0	0
25	22637584	.	A	T	19	17	36	0	5	41	0	0
25	22637667	.	T	C	27	25	52	0	0	52	0	0
25	22637729	.	G	T	35	22	57	0	1	58	0	0
25	22637732	.	G	A	33	21	54	0	2	56	0	0
25	22638037	.	A	G	14	19	33	0	1	34	0	0
25	22638047	.	C	T	13	19	32	0	0	32	0	0
25	22638101	.	G	A	10	16	26	0	1	27	0	0
25	22638170	.	C	G	4	12	16	0	9	25	0	0
25	22639039	.	G	A	19	20	39	0	0	39	0	0
25	22730409	.	T	C	4	4	8	0	2	10	0	0
25	22730504	.	T	C	6	5	11	0	1	12	0	0
25	22730594	.	G	A	0	7	7	0	10	17	0	0
25	22737094	.	G	A	0	7	7	0	9	16	0	0
25	22737119	.	C	T	9	9	18	0	1	19	0	0
25	22739486	.	G	T	1	8	9	0	5	14	0	0
25	22743865	.	T	C	6	5	11	0	0	11	0	0
25	22743983	.	A	G	4	11	15	0	0	15	0	0
25	22748533	.	G	T	9	9	18	0	0	18	0	0
25	22748535	.	A	C	9	9	18	0	0	18	0	0
25	22748589	.	T	C	8	12	20	0	0	20	0	0
25	22748739	.	T	C	10	5	15	0	0	15	0	0
25	22754907	.	A	G	8	0	8	0	14	22	0	0
25	22754943	.	A	T	10	18	28	0	0	28	0	0
25	22757101	.	T	A	5	4	9	0	0	9	0	0
25	22762088	.	G	A	0	3	3	0	7	10	0	0
25	22763599	.	G	A	9	7	16	0	0	16	0	0
25	22779492	.	G	A	5	13	18	0	0	18	0	0
25	22782284	.	A	C	6	10	16	0	2	18	0	0
25	22784956	.	G	A	7	11	18	0	0	18	0	0
25	22798671	.	T	C	15	10	25	0	0	25	0	0
25	22807977	.	T	C	7	6	13	0	0	13	0	0
25	22808076	.	A	G	10	10	20	0	0	20	0	0
25	22821577	.	A	G	15	0	15	0	10	25	0	0
25	22829714	.	T	C	10	9	19	0	1	20	0	0
25	22829738	.	C	T	9	11	20	0	0	20	0	0
25	22834487	.	G	A	9	6	15	1	0	16	0	0
25	22853789	.	A	T	3	3	6	0	0	6	0	0
25	22853810	.	G	A	2	3	5	0	1	6	0	0
25	22854194	.	A	T	6	2	8	0	1	9	0	0
25	22854251	.	G	A	0	4	4	0	2	6	0	0
25	22854452	.	A	C	3	8	11	0	0	11	0	0
25	22854563	.	G	A	8	7	15	0	1	16	0	0
25	22854653	.	T	C	6	5	11	0	1	12	0	0
25	22863226	.	C	A	5	6	11	0	0	11	0	0
25	22863282	.	T	A	5	2	7	0	0	7	0	0
25	22863768	.	C	T	4	10	14	0	2	16	0	0
25	22863792	.	A	G	6	11	17	0	0	17	0	0
25	22878133	.	T	C	8	0	8	0	4	12	0	0
25	22979939	.	A	G	9	9	18	0	0	18	0	0
25	22979996	.	C	G	6	6	12	0	0	12	0	0
25	22980436	.	G	T	14	10	24	0	0	24	0	0
25	22981075	.	A	C	23	13	36	0	1	37	0	0
25	22981268	.	A	G	15	14	29	0	1	30	0	0
25	22981493	.	A	G	6	15	21	0	2	23	0	0
25	22981550	.	G	A	10	13	23	0	1	24	0	0
25	22981774	.	T	C	17	10	27	0	1	28	0	0
25	22982194	.	A	G	19	14	33	0	2	35	0	0
25	22982469	.	A	G	19	12	31	0	1	32	0	0
25	22982478	.	G	T	18	12	30	0	0	30	0	0
25	22982698	.	A	G	11	14	25	0	3	28	0	0
25	22982752	.	A	G	21	15	36	0	1	37	0	0
25	23015692	.	T	C	6	0	6	0	8	14	0	0
25	23052662	.	A	G	1	4	5	0	1	6	0	0
25	23359109	.	A	G	7	5	12	0	2	14	0	0
25	23359126	.	A	C	10	5	15	0	0	15	0	0
25	23359332	.	T	G	4	2	6	0	0	6	0	0
25	23403835	.	G	C	1	8	9	0	9	18	0	0
25	23403850	.	C	T	9	5	14	0	0	14	0	0
25	23403907	.	G	A	1	2	3	0	5	8	0	0
25	23419896	.	G	A	2	4	6	0	0	6	0	0
25	23419974	.	C	T	4	4	8	0	3	11	0	0
25	23431000	.	G	A	4	4	8	0	0	8	0	0
25	23431015	.	A	T	5	4	9	0	0	9	0	0
25	23433886	.	C	T	8	4	12	1	1	14	0	0
25	23448513	.	T	C	13	16	29	0	1	30	0	0
25	23448584	.	A	G	6	0	6	0	11	17	0	0
25	23449787	.	A	G	5	3	8	0	1	9	0	0
25	23449814	.	A	G	6	0	6	0	6	12	0	0
25	23450319	.	T	A	6	7	13	0	1	14	0	0
25	23450388	.	A	G	9	3	12	0	1	13	0	0
25	23450390	.	C	A	9	4	13	0	0	13	0	0
25	23450424	.	A	G	7	9	16	0	3	19	0	0
25	23525518	.	G	T	5	7	12	0	0	12	0	0
25	23525524	.	A	T	4	7	11	0	0	11	0	0
25	23525983	.	A	C	1	0	1	0	5	6	0	0
25	23555815	.	C	T	1	9	10	0	7	17	0	0
25	23555852	.	T	C	5	0	5	0	9	14	0	0
25	23555998	.	A	T	3	10	13	0	0	13	0	0
25	23556047	.	G	A	4	6	10	0	0	10	0	0
25	23556240	.	A	T	5	5	10	0	0	10	0	0
25	23556254	.	C	T	4	5	9	0	1	10	0	0
25	23556378	.	C	G	5	9	14	0	0	14	0	0
25	23560111	.	A	T	4	9	13	0	0	13	0	0
25	23562487	.	C	T	1	6	7	0	12	19	0	0
25	23570933	.	G	A	16	5	21	0	1	22	0	0
25	23571614	.	A	G	11	3	14	0	0	14	0	0
25	24583152	.	C	A	3	10	13	0	6	19	0	0
25	24583223	.	C	T	8	7	15	0	0	15	0	0
25	24583450	.	C	T	5	4	9	0	0	9	0	0
25	24593493	.	G	A	1	5	6	0	6	12	0	0
25	24594153	.	T	C	9	10	19	0	1	20	0	0
25	24594163	.	C	T	8	7	15	0	0	15	0	0
25	24594276	.	T	C	6	13	19	0	0	19	0	0
25	24594339	.	C	T	7	8	15	0	0	15	0	0
25	24594633	.	A	G	3	0	3	0	8	11	0	0
25	24598826	.	C	A	6	6	12	0	0	12	0	0
25	24598869	.	T	C	4	8	12	0	1	13	0	0
25	24605595	.	G	T	8	7	15	0	1	16	0	0
25	24605598	.	A	C	8	7	15	0	1	16	0	0
25	24607933	.	A	G	7	0	7	0	6	13	0	0
25	24609463	.	T	A	6	6	12	0	1	13	0	0
25	24609656	.	G	A	3	3	6	0	0	6	0	0
25	24610020	.	G	A	10	4	14	0	0	14	0	0
25	24610030	.	T	C	11	4	15	0	0	15	0	0
25	24610543	.	A	T	6	9	15	0	2	17	0	0
25	24610544	.	A	G	6	11	17	0	0	17	0	0
25	24618992	.	C	A	1	2	3	0	0	3	0	0
25	24686077	.	A	G	1	0	1	0	3	4	0	0
25	24691349	.	C	T	2	4	6	0	0	6	0	0
25	24715018	.	T	C	2	3	5	0	0	5	0	0
25	24716990	.	C	G	2	3	5	0	0	5	0	0
25	24723129	.	G	A	4	3	7	0	0	7	0	0
25	24736579	.	A	T	9	10	19	0	0	19	0	0
25	24736669	.	A	C	8	6	14	0	1	15	0	0
25	24736828	.	A	T	3	6	9	0	0	9	0	0
25	24736921	.	G	A	2	5	7	0	0	7	0	0
25	24737080	.	G	A	2	5	7	0	0	7	0	0
25	24737081	.	A	G	1	5	6	0	1	7	0	0
25	24737154	.	C	T	0	2	2	0	1	3	0	0
25	24737276	.	T	C	3	0	3	0	6	9	0	0
25	24737739	.	A	C	8	5	13	0	0	13	0	0
25	24737940	.	A	C	5	7	12	0	1	13	0	0
25	24737961	.	C	T	4	5	9	0	1	10	0	0
25	24738084	.	T	C	4	0	4	0	16	20	0	0
25	24738155	.	T	A	11	7	18	0	0	18	0	0
25	24738810	.	C	A	6	4	10	0	0	11	1	0
25	24738826	.	G	A	5	6	11	0	0	11	0	0
25	24738892	.	G	A	14	10	24	0	0	24	0	0
25	24739029	.	A	G	12	16	28	0	1	29	0	0
25	24752103	.	T	C	12	13	25	0	0	25	0	0
25	24752175	.	G	A	9	17	26	0	0	26	0	0
25	24752181	.	A	G	8	16	24	0	0	24	0	0
25	24752211	.	C	T	0	14	14	0	6	20	0	0
25	24763746	.	A	G	7	8	15	0	1	16	0	0
25	24763755	.	G	T	9	7	16	0	2	18	0	0
25	24763914	.	C	T	13	14	27	0	2	29	0	0
25	24770089	.	G	A	20	13	33	0	1	34	0	0
25	24792647	.	C	A	10	9	19	0	1	20	0	0
25	24826237	.	G	T	10	8	18	0	0	18	0	0
25	24826240	.	T	C	9	0	9	0	8	17	0	0
25	24826290	.	A	G	3	13	16	0	0	16	0	0
25	25058180	.	C	T	6	7	13	0	0	13	0	0
25	25058334	.	A	C	7	1	8	0	9	17	0	0
25	25058469	.	T	C	5	4	9	0	1	10	0	0
25	25123444	.	G	T	16	27	43	0	1	44	0	0
25	25123445	.	T	C	17	25	42	0	3	45	0	0
25	25124779	.	A	T	18	26	44	0	1	45	0	0
25	25127673	.	G	A	0	35	35	0	18	53	0	0
25	25130749	.	G	C	21	19	40	0	3	43	0	0
25	25130782	.	G	A	26	27	53	0	0	53	0	0
25	25130908	.	C	T	27	22	49	0	0	49	0	0
25	25130968	.	C	T	16	30	46	0	1	47	0	0
25	25131165	.	G	A	3	9	12	0	0	12	0	0
25	25131298	.	A	T	14	20	34	0	0	34	0	0
25	25131427	.	G	A	17	36	53	0	1	54	0	0
25	25132985	.	C	T	11	6	17	0	1	18	0	0
25	25133030	.	G	A	11	11	22	0	2	24	0	0
25	25133104	.	G	A	14	16	30	0	1	31	0	0
25	25133123	.	T	G	18	18	36	0	1	37	0	0
25	25133171	.	A	G	23	21	44	0	2	46	0	0
25	25133353	.	G	A	12	19	31	0	1	32	0	0
25	25133365	.	T	A	16	19	35	0	1	36	0	0
25	25133509	.	A	G	20	12	32	0	1	33	0	0
25	25133721	.	G	A	23	16	39	0	1	40	0	0
25	25142171	.	T	C	12	11	23	0	1	24	0	0
25	25142202	.	T	A	14	12	26	0	0	26	0	0
25	25396237	.	T	C	7	9	16	0	2	18	0	0
25	25396295	.	T	C	8	9	17	0	0	17	0	0
25	25453622	.	A	G	2	2	4	0	0	4	0	0
25	25488555	.	G	C	1	3	4	0	1	5	0	0
25	25488772	.	T	G	5	3	8	0	0	8	0	0
25	25509245	.	A	G	6	0	6	0	7	13	0	0
25	25509254	.	C	T	5	5	10	0	0	10	0	0
25	25536394	.	C	A	6	4	10	0	0	10	0	0
25	25536661	.	A	T	7	8	15	0	0	15	0	0
25	25538354	.	T	A	5	7	12	0	0	12	0	0
25	25538624	.	C	A	6	6	12	0	2	14	0	0
25	25538786	.	T	G	7	1	8	0	9	17	0	0
25	25539199	.	G	T	9	4	13	0	0	13	0	0
25	25539270	.	C	A	4	9	13	0	0	13	0	0
25	25539434	.	G	A	0	9	9	0	4	13	0	0
25	25539539	.	C	A	6	5	11	0	0	11	0	0
25	25539723	.	C	A	18	8	26	0	1	28	1	0
25	25540058	.	T	A	9	7	16	0	0	16	0	0
25	25540060	.	G	A	10	7	17	0	0	17	0	0
25	25540181	.	A	T	8	8	16	0	0	16	0	0
25	25540245	.	A	G	6	8	14	0	0	14	0	0
25	25540312	.	C	A	6	11	17	0	1	18	0	0
25	25540935	.	A	G	5	0	5	0	11	16	0	0
25	25540954	.	G	A	13	10	23	0	1	24	0	0
25	25542708	.	C	T	15	10	25	0	0	25	0	0
25	25544468	.	C	T	13	14	27	0	0	27	0	0
25	25545007	.	G	A	10	8	18	0	0	18	0	0
25	25545913	.	C	T	4	4	8	0	0	8	0	0
25	25546053	.	G	A	1	3	4	0	0	4	0	0
25	25547043	.	C	A	3	3	6	0	0	6	0	0
25	25547137	.	C	A	3	3	6	0	0	6	0	0
25	25547228	.	G	A	3	4	7	0	0	7	0	0
25	25548032	.	G	T	1	4	5	0	0	5	0	0
25	25564734	.	T	A	2	2	4	0	0	4	0	0
25	25565303	.	T	C	1	2	3	0	0	3	0	0
25	25565819	.	A	G	4	2	6	0	1	7	0	0
25	25565837	.	A	C	1	2	3	0	1	4	0	0
25	25565883	.	A	T	2	4	6	0	0	6	0	0
25	25566006	.	A	G	4	2	6	0	0	6	0	0
25	25566063	.	A	T	1	2	3	0	0	3	0	0
25	25566069	.	C	A	1	2	3	0	0	3	0	0
25	25593980	.	T	C	1	1	2	0	1	3	0	0
25	25594104	.	A	G	5	3	8	0	0	8	0	0
25	25594240	.	G	A	3	5	8	0	0	8	0	0
25	25594291	.	T	A	5	6	11	0	0	11	0	0
25	25595684	.	A	C	5	2	7	0	1	8	0	0
25	25736923	.	C	G	21	10	31	0	0	31	0	0
25	25736949	.	C	T	16	10	26	0	0	26	0	0
25	25737514	.	A	G	1	2	3	0	0	3	0	0
25	25737565	.	A	T	1	2	3	0	0	3	0	0
25	25740159	.	A	T	1	3	4	0	0	4	0	0
25	25740451	.	G	A	2	2	4	0	0	4	0	0
25	25740469	.	G	A	4	3	7	0	0	7	0	0
25	25782997	.	T	C	29	15	44	1	2	47	0	0
25	26673233	.	A	G	2	12	14	0	1	15	0	0
25	26738746	.	T	C	8	5	13	0	0	13	0	0
25	26738868	.	A	T	1	5	6	0	0	6	0	0
25	26747970	.	G	A	7	6	13	0	0	13	0	0
25	26752970	.	A	G	7	3	10	0	0	10	0	0
25	26823927	.	T	C	6	3	9	0	0	9	0	0
25	26829918	.	A	G	3	6	9	0	1	10	0	0
25	26831784	.	A	G	1	7	8	0	0	8	0	0
25	26831874	.	G	A	2	3	5	0	0	5	0	0
25	26831958	.	G	A	3	4	7	0	0	7	0	0
25	26832023	.	A	G	3	3	6	0	0	6	0	0
25	26833066	.	G	T	3	2	5	0	0	5	0	0
25	26834042	.	C	T	4	2	6	0	0	6	0	0
25	26834061	.	A	T	6	4	10	0	0	10	0	0
25	26840480	.	T	G	9	5	14	0	0	14	0	0
25	26840678	.	A	T	6	7	13	0	1	14	0	0
25	26840919	.	G	A	7	8	15	0	1	16	0	0
25	26843027	.	A	C	10	0	10	0	8	18	0	0
25	26845327	.	G	A	2	6	8	0	0	8	0	0
25	26845516	.	G	A	1	1	2	0	1	3	0	0
25	26853906	.	C	T	4	3	7	0	0	7	0	0
25	26853918	.	T	A	4	3	7	0	1	8	0	0
25	26854875	.	G	T	2	3	5	0	0	5	0	0
25	26866444	.	A	G	3	3	6	0	0	6	0	0
25	26867426	.	C	T	4	2	6	0	0	6	0	0
25	26867671	.	A	T	5	2	7	0	0	7	0	0
25	26867709	.	C	T	5	3	8	0	0	8	0	0
25	26867731	.	C	T	4	3	7	0	0	7	0	0
25	26867765	.	C	A	3	5	8	0	0	8	0	0
25	26867787	.	C	T	1	3	4	0	0	4	0	0
25	26879592	.	T	C	25	18	43	0	2	45	0	0
25	26884407	.	C	T	14	15	29	0	0	29	0	0
25	26888024	.	A	G	16	7	23	0	2	25	0	0
25	26888170	.	A	G	19	20	39	0	0	39	0	0
25	26890845	.	A	G	30	21	51	0	2	53	0	0
25	26905739	.	C	A	3	8	11	0	0	11	0	0
25	26906224	.	A	G	3	0	3	0	9	12	0	0
25	26908052	.	A	C	6	9	15	0	0	15	0	0
25	26909013	.	C	T	3	5	8	0	0	8	0	0
25	26909041	.	A	C	3	6	9	0	1	10	0	0
25	26909197	.	G	A	9	4	13	0	1	14	0	0
25	26909269	.	A	G	10	7	17	0	0	17	0	0
25	26909392	.	A	T	15	10	25	0	0	25	0	0
25	26909560	.	T	C	6	4	10	0	0	10	0	0
25	26909572	.	A	G	7	0	7	0	5	12	0	0
25	26911350	.	T	A	1	4	5	0	0	5	0	0
25	26911554	.	T	A	4	12	16	0	0	16	0	0
25	26911605	.	C	A	4	12	16	0	0	16	0	0
25	26911768	.	A	G	2	5	7	0	0	7	0	0
25	26911883	.	A	G	5	6	11	0	0	11	0	0
25	26912037	.	C	T	6	8	14	0	0	14	0	0
25	26922991	.	A	G	7	5	12	0	1	13	0	0
25	26923004	.	A	G	6	0	6	0	6	12	0	0
25	26923055	.	C	T	9	3	12	0	0	12	0	0
25	26923108	.	A	G	6	0	6	0	4	10	0	0
25	26923177	.	G	A	4	8	12	0	1	13	0	0
25	26923180	.	T	A	5	4	9	0	2	11	0	0
25	26923579	.	T	C	6	5	11	0	0	11	0	0
25	27089335	.	G	A	3	3	6	0	0	6	0	0
25	27089349	.	G	A	5	3	8	0	0	8	0	0
25	27092669	.	C	G	12	7	19	0	0	19	0	0
25	27166182	.	A	G	5	0	5	0	5	10	0	0
25	27173849	.	G	A	2	12	14	0	2	16	0	0
25	27173979	.	G	A	3	11	14	0	0	14	0	0
25	27174323	.	C	T	5	7	12	0	1	13	0	0
25	27210906	.	T	C	12	9	21	0	0	21	0	0
25	27487191	.	C	A	1	2	3	0	0	3	0	0
25	27493723	.	A	T	4	2	6	0	0	6	0	0
25	27493728	.	T	C	2	2	4	0	0	4	0	0
25	27493974	.	T	C	4	5	9	0	0	9	0	0
25	27494044	.	T	C	2	4	6	0	0	6	0	0
25	27494577	.	C	T	0	2	2	0	1	3	0	0
25	27499172	.	A	G	3	3	6	0	0	6	0	0
25	27499322	.	T	C	7	3	10	0	0	10	0	0
25	27499928	.	T	G	2	2	4	0	0	4	0	0
25	27500206	.	A	T	2	3	5	0	0	5	0	0
25	27550532	.	A	G	2	3	5	0	0	5	0	0
25	27715164	.	T	G	4	9	13	0	0	13	0	0
25	27715234	.	A	G	12	10	22	0	0	22	0	0
25	27715335	.	T	A	4	5	9	0	0	9	0	0
25	27715429	.	A	G	6	3	9	0	0	9	0	0
25	27715468	.	G	A	5	5	10	0	0	10	0	0
25	27718173	.	A	T	3	4	7	0	1	8	0	0
25	27718388	.	C	T	2	1	3	0	0	3	0	0
25	27718406	.	A	G	4	3	7	0	0	7	0	0
25	27718481	.	C	T	5	12	17	0	1	18	0	0
25	27718493	.	G	A	8	12	20	0	0	20	0	0
25	27718641	.	A	T	7	8	15	0	1	16	0	0
25	27718698	.	A	G	6	6	12	0	1	13	0	0
25	27718709	.	T	C	6	10	16	0	2	18	0	0
25	27718739	.	G	A	8	14	22	0	0	22	0	0
25	27744408	.	C	A	13	6	19	0	3	22	0	0
25	27759983	.	A	G	8	11	19	0	0	19	0	0
25	27763514	.	A	T	10	11	21	0	0	21	0	0
25	27788094	.	T	C	10	18	28	0	2	30	0	0
25	27788109	.	C	T	16	19	35	0	1	36	0	0
25	27795017	.	A	G	18	14	32	0	1	33	0	0
25	27795083	.	C	T	14	11	25	0	0	25	0	0
25	27795086	.	G	A	13	10	23	0	1	24	0	0
25	27801759	.	T	G	8	0	8	0	23	31	0	0
25	27801783	.	A	T	9	12	21	0	9	30	0	0
25	27802005	.	C	T	12	10	22	0	1	23	0	0
25	27806800	.	C	T	19	17	36	0	2	38	0	0
25	28120183	.	C	T	4	4	8	0	1	9	0	0
25	28222152	.	T	C	9	8	17	0	0	17	0	0
25	28229540	.	C	T	5	8	13	0	0	13	0	0
25	28240151	.	T	C	1	7	8	0	0	8	0	0
25	28244215	.	A	G	4	0	4	0	4	8	0	0
25	28244242	.	A	T	3	4	7	0	2	9	0	0
25	28254059	.	C	T	9	5	14	0	0	14	0	0
25	28269651	.	G	T	11	2	13	0	1	14	0	0
25	28269652	.	T	C	8	3	11	0	3	14	0	0
25	28269735	.	T	C	3	5	8	0	0	8	0	0
25	28273576	.	T	C	4	3	7	0	0	7	0	0
25	28273732	.	C	T	1	3	4	0	0	4	0	0
25	28279624	.	A	G	1	2	3	0	0	3	0	0
25	28279630	.	C	G	1	0	1	0	2	3	0	0
25	28286808	.	C	T	3	2	5	0	0	5	0	0
25	28286904	.	A	G	4	2	6	0	1	7	0	0
25	28293745	.	A	T	4	4	8	0	0	8	0	0
25	28317616	.	C	T	7	4	11	0	0	11	0	0
25	28317697	.	C	T	3	3	6	0	1	7	0	0
25	28320453	.	C	T	6	3	9	0	0	9	0	0
25	28320664	.	G	C	6	4	10	0	0	10	0	0
25	28320907	.	G	C	4	5	9	0	0	9	0	0
25	28322663	.	T	C	6	8	14	0	0	14	0	0
25	28322671	.	T	A	7	8	15	0	0	15	0	0
25	28322704	.	G	A	7	8	15	0	1	16	0	0
25	28322939	.	G	A	1	3	4	0	3	7	0	0
25	28323048	.	C	T	9	3	12	1	1	14	0	0
25	28323054	.	A	C	11	3	14	1	1	16	0	0
25	28334272	.	C	T	7	6	13	0	0	13	0	0
25	28335569	.	C	T	2	2	4	0	0	4	0	0
25	28335576	.	T	C	3	3	6	0	0	6	0	0
25	28335632	.	C	A	4	3	7	0	0	7	0	0
25	28335744	.	G	A	0	4	4	0	2	6	0	0
25	28357358	.	G	C	4	7	11	0	1	12	0	0
25	28357581	.	T	C	3	0	3	0	5	8	0	0
25	28367153	.	C	T	1	2	3	0	2	5	0	0
25	28369239	.	G	A	3	4	7	0	0	7	0	0
25	28376926	.	A	G	7	3	10	0	0	10	0	0
25	28379710	.	G	A	1	5	6	0	0	6	0	0
25	28379767	.	C	T	0	2	2	0	6	8	0	0
25	28383289	.	A	C	1	0	1	0	4	5	0	0
25	28383467	.	G	A	3	4	7	0	0	7	0	0
25	28383715	.	T	G	3	5	8	0	1	9	0	0
25	28383914	.	A	G	3	2	5	0	0	5	0	0
25	28383945	.	T	C	2	2	4	0	0	4	0	0
25	28384078	.	G	A	2	2	4	0	0	4	0	0
25	28384101	.	A	G	2	3	5	0	0	5	0	0
25	28384178	.	C	T	0	3	3	0	5	8	0	0
25	28384202	.	A	T	6	2	8	0	0	8	0	0
25	28390474	.	A	G	2	2	4	0	0	4	0	0
25	28399698	.	C	T	1	2	3	0	0	3	0	0
25	28399791	.	A	G	3	2	5	0	0	5	0	0
25	28640526	.	G	A	7	2	9	0	1	10	0	0
25	28640599	.	G	A	13	13	26	0	2	28	0	0
25	28640662	.	G	A	12	12	24	0	1	25	0	0
25	28641005	.	A	C	18	7	25	0	2	27	0	0
25	28648166	.	G	A	24	19	43	0	1	44	0	0
25	28650764	.	T	A	15	14	29	0	2	31	0	0
25	28650812	.	G	A	14	14	28	0	2	30	0	0
25	28652511	.	G	A	15	20	35	0	0	35	0	0
25	28656024	.	G	C	17	9	26	0	1	27	0	0
25	28656078	.	G	T	9	14	23	0	1	24	0	0
25	28661279	.	T	C	15	13	28	0	2	30	0	0
25	28661351	.	G	A	15	17	32	0	1	33	0	0
25	28665386	.	T	A	12	13	25	0	1	26	0	0
25	28665446	.	T	A	15	11	26	0	2	28	0	0
25	28668001	.	G	A	12	15	27	0	0	27	0	0
25	28668046	.	G	T	13	9	22	0	1	23	0	0
25	28668614	.	T	C	18	11	29	0	3	32	0	0
25	28668627	.	G	A	22	17	39	0	2	41	0	0
25	28668723	.	C	A	11	12	23	0	0	23	0	0
25	28668746	.	G	T	8	3	11	0	0	11	0	0
25	28750027	.	A	G	4	2	6	0	0	6	0	0
25	29260207	.	A	G	4	2	6	0	0	6	0	0
25	29429187	.	A	G	4	22	26	0	3	29	0	0
25	31562846	.	C	G	1	0	1	0	1	2	0	0
25	31562859	.	C	T	0	2	2	0	0	2	0	0
25	32216389	.	A	G	5	0	5	0	13	18	0	0
25	32887340	.	T	G	1	2	3	0	0	3	0	0
25	32887361	.	G	T	1	2	3	0	0	3	0	0
25	32888015	.	A	G	4	2	6	0	0	6	0	0
25	33004294	.	T	A	3	4	7	0	0	7	0	0
25	33038216	.	A	G	1	0	1	0	4	5	0	0
25	33050967	.	T	C	3	3	6	0	1	7	0	0
25	33052316	.	G	T	5	2	7	0	0	7	0	0
25	33052544	.	C	T	1	2	3	0	1	4	0	0
25	33065530	.	A	G	5	0	5	0	5	10	0	0
25	33065551	.	C	T	3	4	7	0	1	8	0	0
25	33078229	.	G	A	7	4	11	0	0	11	0	0
25	33078253	.	A	C	5	7	12	0	0	12	0	0
25	33081889	.	A	G	1	8	9	0	0	9	0	0
25	33093485	.	T	C	11	5	16	0	0	16	0	0
25	33104491	.	T	C	4	6	10	0	0	10	0	0
25	33104494	.	T	C	4	5	9	0	0	9	0	0
25	33121219	.	T	C	6	7	13	0	0	13	0	0
25	33121740	.	C	T	2	5	7	0	0	7	0	0
25	33121782	.	A	G	6	0	6	0	7	13	0	0
25	33125194	.	A	C	4	9	13	0	0	13	0	0
25	33145031	.	C	T	3	8	11	0	0	11	0	0
25	33151573	.	C	G	6	0	6	0	10	17	1	0
25	33194649	.	A	G	4	2	6	0	0	6	0	0
25	33194667	.	A	C	3	2	5	0	0	5	0	0
25	33225248	.	A	G	23	26	49	0	1	50	0	0
25	33225287	.	G	A	24	24	48	0	1	49	0	0
25	33226972	.	A	G	20	35	55	0	1	56	0	0
25	33226984	.	A	G	19	33	52	0	0	52	0	0
25	33238303	.	G	A	1	3	4	0	0	4	0	0
25	33238370	.	C	T	1	2	3	0	0	3	0	0
25	33238373	.	T	A	0	2	2	0	1	3	0	0
25	33239183	.	A	C	10	2	12	0	0	12	0	0
25	33239189	.	A	C	11	0	11	0	2	13	0	0
25	33239223	.	T	A	11	4	15	0	0	15	0	0
25	33239228	.	T	C	10	5	15	0	0	15	0	0
25	33239557	.	T	G	5	2	7	0	0	7	0	0
25	33239903	.	G	A	1	3	4	0	0	4	0	0
25	33239905	.	C	T	2	3	5	0	0	5	0	0
25	33239946	.	A	G	3	0	3	0	2	5	0	0
25	33242605	.	A	T	4	3	7	1	1	9	0	0
25	33242606	.	T	G	4	3	7	1	1	9	0	0
25	33242985	.	A	G	1	2	3	0	0	3	0	0
25	33243301	.	T	C	0	2	2	0	1	3	0	0
25	33249905	.	T	G	9	19	28	0	2	30	0	0
25	33250017	.	C	A	7	9	16	0	2	18	0	0
25	33250053	.	A	G	9	10	19	0	2	21	0	0
25	33256212	.	C	A	4	2	6	0	0	6	0	0
25	33258745	.	T	G	1	0	1	0	8	9	0	0
25	33258811	.	A	G	4	0	4	0	3	7	0	0
25	33258817	.	C	T	4	3	7	0	0	7	0	0
25	33259568	.	A	G	3	0	3	0	6	9	0	0
25	33259778	.	T	C	5	4	9	0	0	9	0	0
25	33262180	.	A	G	4	5	9	0	0	9	0	0
25	33265759	.	A	G	3	8	11	0	0	11	0	0
25	33265814	.	C	T	4	5	9	0	0	9	0	0
25	33265898	.	C	T	7	7	14	0	0	14	0	0
25	33266029	.	G	A	5	8	13	0	0	13	0	0
25	33266128	.	A	G	4	0	4	0	4	8	0	0
25	33962809	.	G	A	1	19	20	0	15	35	0	0
25	33963168	.	C	A	10	10	20	0	0	20	0	0
25	33963427	.	A	T	9	12	21	0	0	21	0	0
25	33964506	.	A	C	4	3	7	0	0	7	0	0
25	33964791	.	A	G	12	8	20	2	1	23	0	0
25	33964962	.	A	G	13	10	23	0	3	26	0	0
25	33964968	.	A	G	14	9	23	0	1	24	0	0
25	33965016	.	C	A	13	7	20	0	0	20	0	0
25	33965238	.	A	G	4	9	13	0	1	14	0	0
25	33965251	.	G	A	1	6	7	0	5	12	0	0
25	33965518	.	G	T	15	6	21	0	1	22	0	0
25	33965541	.	C	T	16	8	24	0	0	24	0	0
25	33965695	.	C	T	9	9	18	0	0	18	0	0
25	33965786	.	T	C	6	3	9	2	0	11	0	0
25	33965831	.	G	A	0	2	2	2	4	8	0	0
25	33965893	.	C	T	5	2	7	0	0	7	0	0
25	33965974	.	A	C	9	10	19	0	2	21	0	0
25	33966100	.	G	A	10	11	21	0	1	22	0	0
25	33966251	.	T	G	19	11	30	0	1	31	0	0
25	33966585	.	C	G	12	1	13	0	9	22	0	0
25	33966854	.	C	T	16	11	27	0	0	27	0	0
25	33966969	.	T	A	6	7	13	0	0	13	0	0
25	33967133	.	T	A	8	13	21	0	2	23	0	0
25	33967361	.	A	G	19	18	37	0	0	37	0	0
25	33967495	.	T	C	10	7	17	0	0	17	0	0
25	33967695	.	T	C	12	7	19	0	1	20	0	0
25	33967791	.	C	T	10	11	21	0	1	22	0	0
25	33967803	.	G	A	10	14	24	0	2	27	1	0
25	33968091	.	C	T	17	13	30	0	0	30	0	0
25	33968470	.	T	A	13	9	22	0	0	22	0	0
25	33968691	.	A	G	12	15	27	0	0	27	0	0
25	33968842	.	G	C	23	12	35	0	1	37	1	0
25	33968857	.	C	T	18	16	34	0	2	36	0	0
25	33968881	.	T	A	16	13	29	0	3	32	0	0
25	33975414	.	A	G	1	0	1	0	3	4	0	0
25	33975420	.	T	A	1	2	3	0	0	3	0	0
25	33983108	.	G	A	2	5	7	0	0	7	0	0
25	33983286	.	C	T	8	4	12	0	0	12	0	0
25	33983303	.	T	C	8	3	11	0	0	11	0	0
25	33988864	.	T	G	1	3	4	0	0	4	0	0
25	33988893	.	G	A	1	5	6	0	1	7	0	0
25	33988928	.	A	T	1	4	5	0	0	5	0	0
25	34002853	.	T	C	3	5	8	0	0	8	0	0
25	34014573	.	A	G	8	16	24	0	0	24	0	0
25	34017089	.	A	G	8	7	15	0	1	16	0	0
25	34018537	.	C	T	6	10	16	0	0	16	0	0
25	34020631	.	T	A	12	8	20	0	1	21	0	0
25	34022288	.	T	C	13	13	26	0	0	26	0	0
25	34022309	.	T	C	11	12	23	0	0	23	0	0
25	34027086	.	A	T	12	4	16	0	0	16	0	0
25	34027215	.	C	A	6	4	10	0	1	11	0	0
25	34027263	.	G	T	6	3	9	0	0	9	0	0
25	34154496	.	A	T	8	9	17	0	0	17	0	0
25	34154540	.	T	G	10	10	20	0	2	22	0	0
25	34154678	.	G	A	16	16	32	0	1	33	0	0
25	34246669	.	G	T	0	6	6	0	3	9	0	0
25	34246687	.	A	T	4	6	10	0	0	10	0	0
25	34247031	.	T	C	2	4	6	0	0	6	0	0
25	34247047	.	T	G	1	0	1	0	4	5	0	0
25	34247217	.	G	A	2	4	6	0	0	6	0	0
25	34257427	.	T	C	3	4	7	0	0	7	0	0
25	34257433	.	G	A	2	5	7	0	0	7	0	0
25	34260835	.	T	C	1	5	6	0	0	6	0	0
25	34267764	.	C	A	2	2	4	0	0	4	0	0
25	34267800	.	C	G	2	3	5	0	0	5	0	0
25	34267806	.	G	T	2	2	4	0	1	5	0	0
25	34455242	.	A	T	7	7	14	0	0	14	0	0
25	34456976	.	A	G	13	5	18	0	1	19	0	0
25	34457251	.	G	C	8	9	17	0	0	17	0	0
25	34457288	.	A	G	4	10	14	0	0	14	0	0
25	34457558	.	T	C	6	7	13	0	0	13	0	0
25	34457564	.	G	A	5	7	12	0	0	12	0	0
25	34457663	.	C	T	7	11	18	0	1	19	0	0
25	34457841	.	A	T	7	10	17	0	3	20	0	0
25	34458131	.	A	C	7	4	11	0	0	11	0	0
25	34487733	.	T	C	9	0	9	0	6	15	0	0
25	34487775	.	G	A	9	8	17	0	0	17	0	0
25	34487895	.	C	G	1	8	9	0	14	23	0	0
25	34488111	.	A	G	11	7	18	0	1	19	0	0
25	34488373	.	T	A	13	8	21	0	0	21	0	0
25	34488650	.	T	C	7	9	16	0	3	19	0	0
25	34489315	.	G	T	24	12	36	0	0	36	0	0
25	34511600	.	A	G	14	12	26	0	4	30	0	0
25	34511604	.	T	C	13	16	29	0	3	32	0	0
25	34511741	.	T	C	7	8	15	0	1	16	0	0
25	34511852	.	C	A	1	13	14	0	9	23	0	0
25	34511927	.	T	C	6	18	24	0	0	24	0	0
25	34511963	.	C	A	10	20	30	0	0	30	0	0
25	34614950	.	G	A	1	2	3	0	0	3	0	0
25	34614953	.	A	G	1	2	3	0	0	3	0	0
25	34615114	.	C	T	1	2	3	0	0	3	0	0
25	34643883	.	G	T	11	6	17	0	0	17	0	0
25	34643918	.	G	A	5	5	10	0	0	10	0	0
25	34647825	.	A	G	5	5	10	0	1	11	0	0
25	34662400	.	C	A	6	2	8	0	0	8	0	0
25	34662430	.	A	G	5	4	9	0	1	10	0	0
25	34670351	.	A	G	1	3	4	0	0	4	0	0
25	34670411	.	C	A	6	6	12	0	0	12	0	0
25	34697157	.	G	A	6	7	13	0	0	13	0	0
25	34703720	.	A	G	10	4	14	0	0	14	0	0
25	34704377	.	G	A	7	9	16	0	1	17	0	0
25	34706860	.	T	C	7	6	13	0	0	13	0	0
25	34706944	.	G	A	4	2	6	0	0	6	0	0
25	34707740	.	C	T	1	4	5	0	8	13	0	0
25	34707777	.	G	A	5	7	12	0	0	12	0	0
25	34709562	.	T	G	6	6	12	0	0	12	0	0
25	34713616	.	T	C	6	6	12	0	0	12	0	0
25	34718638	.	A	G	2	2	4	0	0	4	0	0
25	34718896	.	A	G	5	5	10	0	0	10	0	0
25	34722053	.	G	A	3	5	8	0	0	8	0	0
25	34728253	.	C	T	1	2	3	0	10	13	0	0
25	34728762	.	T	G	8	10	18	0	1	19	0	0
25	34728921	.	G	C	11	15	26	0	0	26	0	0
25	34728924	.	T	C	11	0	11	0	17	28	0	0
25	34740542	.	A	G	13	4	17	0	0	17	0	0
25	34752389	.	T	C	5	13	18	0	0	18	0	0
25	34762343	.	A	G	18	1	19	0	15	34	0	0
25	34762403	.	A	G	18	0	18	0	15	33	0	0
25	34763022	.	T	A	16	19	35	0	1	36	0	0
25	34763065	.	A	G	12	19	31	0	1	32	0	0
25	34763121	.	T	A	11	14	25	0	1	26	0	0
25	34763473	.	G	A	10	15	25	0	1	26	0	0
25	34765654	.	A	C	6	20	26	0	0	26	0	0
25	34765717	.	A	G	7	1	8	0	14	22	0	0
25	34765732	.	G	T	11	12	23	0	0	23	0	0
25	34794357	.	T	C	8	16	24	0	0	24	0	0
25	34797387	.	G	A	14	13	27	0	2	29	0	0
25	34798189	.	C	T	16	14	30	0	1	31	0	0
25	34798237	.	T	C	15	14	29	0	1	30	0	0
25	34798246	.	A	G	11	16	27	0	1	28	0	0
25	34799413	.	T	C	8	15	23	0	1	25	1	0
25	34799446	.	T	C	14	15	29	0	0	29	0	0
25	34801664	.	T	C	13	19	32	0	0	32	0	0
25	34801945	.	A	G	7	0	7	0	13	20	0	0
25	34801977	.	C	T	7	14	21	0	1	22	0	0
25	34802054	.	T	C	8	13	21	0	0	21	0	0
25	34802119	.	G	A	11	7	18	0	1	19	0	0
25	34802235	.	C	T	9	9	18	0	1	19	0	0
25	34802236	.	G	A	1	10	11	0	8	19	0	0
25	34802308	.	G	A	0	7	7	0	11	18	0	0
25	34802310	.	G	T	13	7	20	0	0	20	0	0
25	34802426	.	C	T	11	18	29	0	0	29	0	0
25	34802897	.	C	T	9	13	22	0	0	22	0	0
25	34802995	.	A	C	11	17	28	0	0	28	0	0
25	34803010	.	C	A	11	17	28	0	2	30	0	0
25	34803128	.	C	T	11	21	32	0	0	32	0	0
25	34803153	.	A	G	18	19	37	0	1	38	0	0
25	34803254	.	T	C	13	18	31	0	1	32	0	0
25	34803496	.	T	A	16	14	30	0	1	31	0	0
25	34803524	.	C	T	19	17	36	0	0	36	0	0
25	34803744	.	G	A	20	12	32	0	2	34	0	0
25	34803871	.	T	C	8	10	18	0	0	18	0	0
25	34803908	.	G	A	0	7	7	0	7	14	0	0
25	34803954	.	T	C	6	7	13	0	0	13	0	0
25	34804010	.	G	A	5	2	7	0	0	7	0	0
25	34804015	.	A	G	4	2	6	0	0	6	0	0
25	34804046	.	T	A	2	2	4	0	0	4	0	0
25	34813720	.	C	T	3	3	6	1	0	7	0	0
25	34813741	.	C	A	5	2	7	1	0	8	0	0
25	34818133	.	G	A	2	2	4	0	0	4	0	0
25	34835772	.	A	G	25	28	53	0	2	55	0	0
25	34841329	.	C	T	1	28	29	0	23	52	0	0
25	34844995	.	C	T	2	33	35	0	22	57	0	0
25	34845042	.	T	C	17	0	17	0	22	39	0	0
25	34845741	.	A	G	4	3	7	0	0	7	0	0
25	34845749	.	A	G	3	3	6	0	1	7	0	0
25	34845780	.	C	T	5	3	8	0	1	9	0	0
25	34845894	.	A	C	6	3	9	0	1	10	0	0
25	34851815	.	A	G	3	1	4	0	3	7	0	0
25	34859364	.	G	A	1	5	6	0	7	13	0	0
25	34859413	.	C	T	8	6	14	0	0	14	0	0
25	34859416	.	C	T	8	4	12	0	1	13	0	0
25	34889487	.	A	G	8	3	11	0	7	18	0	0
25	34889563	.	C	T	5	6	11	0	1	12	0	0
25	34910471	.	A	G	4	2	6	0	2	8	0	0
25	34956376	.	T	C	1	6	7	0	2	9	0	0
25	34973070	.	C	T	6	3	9	0	0	9	0	0
25	34973090	.	C	A	7	3	10	0	0	10	0	0
25	34976212	.	T	C	1	2	3	0	0	3	0	0
25	34979430	.	C	G	2	2	4	0	0	4	0	0
25	34979457	.	C	A	3	2	5	0	0	5	0	0
25	35002394	.	G	A	28	34	62	0	2	64	0	0
25	35005362	.	G	A	41	26	67	1	1	69	0	0
25	35006830	.	G	A	4	35	39	0	20	60	1	0
25	35006989	.	C	T	34	20	54	0	4	58	0	0
25	35007857	.	C	T	39	25	64	0	0	64	0	0
25	35007864	.	G	A	33	25	58	0	2	60	0	0
25	35098818	.	C	A	1	2	3	0	0	3	0	0
25	35101643	.	G	A	1	2	3	0	0	3	0	0
25	35244227	.	A	G	1	1	2	0	2	4	0	0
25	35270407	.	A	G	23	27	50	0	2	53	1	0
25	35467246	.	A	C	10	7	17	1	1	19	0	0
25	35713260	.	G	A	20	11	31	0	1	32	0	0
25	35713263	.	G	C	19	11	30	0	0	30	0	0
25	36040526	.	A	G	1	6	7	0	0	7	0	0
25	37335959	.	A	G	3	1	4	0	1	5	0	0
25	37335961	.	A	G	3	3	6	0	0	6	0	0
25	37336715	.	A	G	4	2	6	0	0	6	0	0
25	37365602	.	A	G	6	2	8	0	0	8	0	0
3	13937	.	C	T	3	8	11	2	0	13	0	0
3	13952	.	T	C	1	4	5	0	0	5	0	0
3	40915	.	C	T	1	2	3	2	2	7	0	0
3	41014	.	T	C	3	4	7	1	0	8	0	0
3	45953	.	T	C	3	2	5	1	0	6	0	0
3	166715	.	C	G	0	2	2	0	4	6	0	0
3	180463	.	G	C	1	0	1	0	5	6	0	0
3	197008	.	T	C	2	0	2	0	2	4	0	0
3	197033	.	T	C	3	3	6	0	0	6	0	0
3	197661	.	T	C	5	4	9	0	0	9	0	0
3	197667	.	A	G	5	4	9	0	0	9	0	0
3	198123	.	T	C	1	0	1	0	2	3	0	0
3	198129	.	A	G	1	2	3	0	0	3	0	0
3	205614	.	A	G	2	2	4	0	0	4	0	0
3	214039	.	A	T	1	2	3	0	0	3	0	0
3	214061	.	G	T	0	2	2	0	1	3	0	0
3	214149	.	C	T	2	4	6	0	0	6	0	0
3	214163	.	T	G	2	4	6	0	0	6	0	0
3	248989	.	C	T	1	3	4	0	0	4	0	0
3	249464	.	A	G	4	2	6	1	0	7	0	0
3	249764	.	C	A	6	3	9	1	0	10	0	0
3	250117	.	C	T	6	2	8	0	1	9	0	0
3	250120	.	T	C	6	3	9	0	0	9	0	0
3	1096863	.	A	G	2	0	2	0	6	8	0	0
3	1101705	.	T	C	10	5	15	0	1	16	0	0
3	1101709	.	C	A	14	4	18	0	1	19	0	0
3	1101781	.	A	G	11	7	18	0	0	18	0	0
3	1101847	.	A	G	4	2	6	0	0	6	0	0
3	1101910	.	G	A	8	4	12	0	0	12	0	0
3	1101925	.	C	T	8	9	17	0	0	17	0	0
3	1102252	.	G	A	0	6	6	0	6	12	0	0
3	1104917	.	A	G	5	8	13	0	0	13	0	0
3	1105108	.	G	A	0	8	8	0	9	17	0	0
3	1105133	.	T	C	9	9	18	0	0	18	0	0
3	1105175	.	T	C	6	10	16	0	1	17	0	0
3	1105241	.	T	G	7	1	8	0	7	15	0	0
3	1105286	.	T	A	6	5	11	0	0	11	0	0
3	1105290	.	G	A	2	4	6	0	5	11	0	0
3	1105331	.	T	G	6	0	6	0	7	13	0	0
3	1105427	.	G	A	2	3	5	0	2	7	0	0
3	1105436	.	T	A	5	5	10	0	0	10	0	0
3	1105566	.	C	T	7	9	16	0	2	18	0	0
3	1105760	.	G	A	6	7	13	0	1	14	0	0
3	1105983	.	G	A	3	4	7	0	0	7	0	0
3	1105991	.	C	T	3	2	5	0	0	5	0	0
3	1106083	.	A	G	7	5	12	0	0	12	0	0
3	1106160	.	A	C	4	8	12	0	0	12	0	0
3	1106261	.	T	C	1	4	5	0	0	5	0	0
3	1107273	.	G	C	22	18	40	0	0	40	0	0
3	1113879	.	A	G	23	13	36	0	5	41	0	0
3	1116936	.	G	A	1	12	13	0	20	33	0	0
3	1117574	.	G	A	16	7	23	0	1	24	0	0
3	1118431	.	C	T	22	15	37	0	0	37	0	0
3	1122833	.	T	G	20	0	20	0	14	34	0	0
3	1122908	.	A	G	13	11	24	0	3	27	0	0
3	1123280	.	T	C	16	9	25	0	0	25	0	0
3	1123335	.	G	A	0	11	11	0	18	29	0	0
3	1123598	.	C	T	8	9	17	0	0	17	0	0
3	1123848	.	G	A	2	6	8	0	16	24	0	0
3	1123860	.	A	T	16	6	22	0	0	22	0	0
3	1126605	.	A	G	16	0	16	0	23	39	0	0
3	1126632	.	A	G	17	0	17	0	23	40	0	0
3	1129313	.	C	T	30	16	46	0	1	47	0	0
3	1129325	.	C	T	33	13	46	0	0	46	0	0
3	1129364	.	G	A	33	19	52	0	0	52	0	0
3	1129768	.	T	A	31	17	48	0	0	48	0	0
3	1129840	.	G	A	3	23	26	0	21	47	0	0
3	1130620	.	G	A	18	10	28	0	1	29	0	0
3	1130623	.	G	A	19	10	29	0	1	30	0	0
3	1130716	.	A	T	19	6	25	0	1	26	0	0
3	1133171	.	A	G	7	3	10	0	0	10	0	0
3	1133176	.	G	A	7	3	10	0	0	10	0	0
3	1133305	.	T	C	10	0	10	0	5	15	0	0
3	1133480	.	T	A	7	7	14	0	1	15	0	0
3	1133573	.	A	G	11	3	14	0	0	14	0	0
3	1133669	.	C	T	4	6	10	0	0	10	0	0
3	1133695	.	G	C	4	8	12	0	0	12	0	0
3	1133780	.	T	C	4	8	12	0	0	12	0	0
3	1133805	.	T	C	4	7	11	0	0	11	0	0
3	1133815	.	T	A	4	6	10	0	0	10	0	0
3	1133861	.	G	C	5	5	10	0	0	10	0	0
3	1133894	.	G	C	6	4	10	0	0	10	0	0
3	1135321	.	A	G	1	6	7	3	0	10	0	0
3	1135550	.	T	C	7	0	7	0	11	18	0	0
3	1135598	.	C	T	6	13	19	0	0	19	0	0
3	1141878	.	A	G	9	14	23	0	0	23	0	0
3	1141894	.	T	C	5	0	5	0	13	18	0	0
3	1142089	.	T	C	8	3	11	0	0	11	0	0
3	1150419	.	G	A	0	5	5	0	3	8	0	0
3	1150462	.	G	T	5	11	16	0	0	16	0	0
3	1150463	.	G	T	4	11	15	0	1	16	0	0
3	1167116	.	T	C	7	4	11	0	1	12	0	0
3	1178562	.	G	A	2	10	12	0	9	21	0	0
3	1178605	.	A	G	6	0	6	0	12	18	0	0
3	1179097	.	T	C	10	9	19	0	1	20	0	0
3	1179609	.	G	C	3	10	13	0	0	13	0	0
3	1187069	.	C	T	4	15	19	0	12	31	0	0
3	1187075	.	A	G	17	18	35	0	1	36	0	0
3	1187174	.	A	G	24	17	41	0	1	42	0	0
3	1187177	.	T	C	21	0	21	0	18	39	0	0
3	1191482	.	C	T	12	11	23	0	2	25	0	0
3	1191573	.	A	C	9	12	21	0	0	21	0	0
3	1191685	.	A	G	12	8	20	0	0	20	0	0
3	1191731	.	T	C	12	6	18	3	1	23	1	0
3	1191965	.	T	C	26	1	27	3	9	39	0	0
3	1191972	.	G	A	27	9	36	2	0	38	0	0
3	1192582	.	G	A	23	12	35	2	1	38	0	0
3	1192664	.	T	G	28	10	38	0	1	39	0	0
3	1192677	.	G	A	30	12	42	0	1	43	0	0
3	1192757	.	T	C	19	14	33	1	3	37	0	0
3	1195669	.	A	G	18	13	31	0	0	31	0	0
3	1196650	.	A	C	11	1	12	0	14	26	0	0
3	1196926	.	C	T	4	18	22	0	12	34	0	0
3	1196938	.	A	G	18	17	35	0	1	36	0	0
3	1197157	.	A	G	26	18	44	0	0	44	0	0
3	1197161	.	T	C	28	0	28	0	17	45	0	0
3	1200012	.	C	A	1	16	17	0	18	35	0	0
3	1200019	.	G	C	17	16	33	0	2	35	0	0
3	1209085	.	C	G	12	0	12	0	13	25	0	0
3	1211342	.	T	C	3	4	7	0	0	7	0	0
3	1211489	.	T	C	16	9	25	0	1	26	0	0
3	1211586	.	T	C	9	9	18	0	1	20	1	0
3	1211753	.	G	A	16	5	21	0	1	22	0	0
3	1211804	.	A	G	13	10	23	0	1	24	0	0
3	1211810	.	C	T	10	12	22	0	2	24	0	0
3	1212141	.	T	A	23	16	39	0	0	39	0	0
3	1215233	.	A	G	9	0	9	0	18	27	0	0
3	1218176	.	T	C	14	5	19	0	1	20	0	0
3	1220373	.	C	T	10	5	15	0	0	15	0	0
3	1220420	.	C	T	8	4	12	0	1	13	0	0
3	1220423	.	C	A	8	6	14	0	0	14	0	0
3	1220548	.	A	G	11	5	16	0	0	16	0	0
3	1220612	.	T	C	14	10	24	0	2	26	0	0
3	1220621	.	A	G	14	0	14	0	13	27	0	0
3	1222144	.	T	C	7	4	11	0	0	11	0	0
3	1222149	.	A	C	7	3	10	0	1	11	0	0
3	1223892	.	G	A	1	36	37	0	24	61	0	0
3	1226959	.	T	C	26	31	57	0	2	59	0	0
3	1227040	.	G	C	2	29	31	0	29	60	0	0
3	1227230	.	T	C	24	36	60	0	3	63	0	0
3	1230094	.	A	G	14	9	23	0	2	25	0	0
3	1260566	.	T	C	15	7	22	0	1	23	0	0
3	1260572	.	C	T	1	5	6	0	15	21	0	0
3	1261214	.	A	G	20	13	33	0	2	35	0	0
3	1262641	.	A	G	28	14	42	0	0	42	0	0
3	1263068	.	C	T	19	13	32	0	2	34	0	0
3	1263376	.	T	C	16	0	16	0	13	29	0	0
3	1263420	.	G	A	16	12	28	0	0	28	0	0
3	1263584	.	G	T	20	13	33	0	0	33	0	0
3	1263606	.	G	T	20	10	30	0	1	31	0	0
3	1263690	.	T	A	9	11	20	0	3	23	0	0
3	1264045	.	C	G	7	6	13	0	0	13	0	0
3	1264312	.	A	G	11	11	22	0	1	23	0	0
3	1264342	.	T	C	11	11	22	0	0	22	0	0
3	1264361	.	G	A	9	12	21	0	1	22	0	0
3	1264448	.	C	G	14	5	19	0	3	22	0	0
3	1264749	.	G	A	7	15	22	0	1	23	0	0
3	1264822	.	C	T	7	8	15	0	1	16	0	0
3	1264853	.	A	G	8	7	15	0	1	16	0	0
3	1265019	.	T	A	7	14	21	0	2	23	0	0
3	1265064	.	G	A	14	7	21	0	1	22	0	0
3	1265084	.	A	G	16	7	23	0	0	23	0	0
3	1265140	.	G	T	17	13	30	0	1	31	0	0
3	1265965	.	C	T	9	4	13	0	0	13	0	0
3	1266110	.	T	C	7	9	16	0	0	16	0	0
3	1266229	.	G	A	7	16	23	0	0	23	0	0
3	1266344	.	T	C	11	11	22	0	1	23	0	0
3	1266871	.	C	T	16	5	21	0	1	22	0	0
3	1267132	.	T	A	6	5	11	0	1	12	0	0
3	1267162	.	C	T	7	3	10	0	1	11	0	0
3	1267201	.	C	T	7	5	12	0	1	13	0	0
3	1267267	.	G	A	11	6	17	0	0	17	0	0
3	1267499	.	G	A	7	5	12	0	2	14	0	0
3	1267500	.	T	C	8	1	9	0	5	14	0	0
3	1267678	.	T	C	7	11	18	0	0	18	0	0
3	1267684	.	T	A	7	11	18	0	1	19	0	0
3	1267993	.	A	T	12	11	23	0	2	25	0	0
3	1268874	.	T	G	8	9	17	0	2	19	0	0
3	1268906	.	G	A	6	7	13	0	0	13	0	0
3	1269079	.	G	A	3	3	6	0	0	6	0	0
3	1269207	.	C	T	0	2	2	0	4	6	0	0
3	1269212	.	C	T	0	2	2	0	3	5	0	0
3	1269250	.	T	A	5	5	10	0	0	10	0	0
3	1269303	.	C	G	4	4	8	0	1	9	0	0
3	1269307	.	T	A	6	4	10	0	0	10	0	0
3	1269418	.	A	C	3	7	10	0	1	11	0	0
3	1269476	.	T	C	8	7	15	3	1	19	0	0
3	1269563	.	A	G	5	9	14	0	0	14	0	0
3	1283113	.	C	G	9	4	13	0	0	13	0	0
3	1304528	.	C	T	15	16	31	0	3	34	0	0
3	1304633	.	G	A	13	23	36	0	0	36	0	0
3	1304772	.	C	T	8	18	26	0	0	26	0	0
3	1323879	.	T	A	2	4	6	0	1	7	0	0
3	1323895	.	C	A	7	4	11	0	0	11	0	0
3	1324045	.	C	A	12	7	19	0	3	22	0	0
3	1324064	.	C	A	12	6	18	0	0	18	0	0
3	1324281	.	G	T	11	5	16	0	0	16	0	0
3	1324300	.	T	C	12	5	17	0	0	17	0	0
3	1324383	.	G	C	2	0	2	0	9	11	0	0
3	1324509	.	C	A	4	7	11	0	0	11	0	0
3	1324515	.	C	T	5	9	14	0	0	14	0	0
3	1325095	.	T	G	1	2	3	8	0	11	0	0
3	1337674	.	T	C	7	0	7	0	20	27	0	0
3	1386456	.	G	A	17	6	23	0	1	24	0	0
3	1388780	.	T	A	13	6	19	0	5	24	0	0
3	1395837	.	A	G	22	16	38	0	1	39	0	0
3	1395861	.	C	T	2	19	21	0	20	41	0	0
3	1395918	.	C	T	0	9	9	23	11	43	0	0
3	1397544	.	T	C	11	0	11	8	21	40	0	0
3	1397946	.	C	T	5	4	9	12	3	24	0	0
3	1397997	.	G	A	12	11	23	4	1	28	0	0
3	1408451	.	G	A	3	2	5	0	0	5	0	0
3	1408460	.	A	G	2	2	4	0	0	4	0	0
3	1492276	.	C	T	2	11	13	0	0	13	0	0
3	1494431	.	T	C	4	7	11	0	0	11	0	0
3	1494466	.	T	A	5	3	8	0	0	8	0	0
3	1494533	.	G	A	7	3	10	0	1	11	0	0
3	1494536	.	G	A	8	3	11	0	0	11	0	0
3	1494570	.	A	T	6	4	10	0	1	11	0	0
3	1494588	.	G	A	6	3	9	0	0	9	0	0
3	1494612	.	G	A	4	3	7	0	0	7	0	0
3	1494643	.	G	T	0	5	5	0	6	11	0	0
3	1494751	.	A	C	3	9	12	0	0	12	0	0
3	1497102	.	T	C	9	13	22	0	0	22	0	0
3	1499548	.	G	A	17	15	32	0	2	34	0	0
3	1499581	.	T	C	19	14	33	0	0	33	0	0
3	1499677	.	A	G	21	12	33	0	0	33	0	0
3	1499908	.	T	G	20	0	20	0	9	29	0	0
3	1499909	.	A	G	22	8	30	0	0	30	0	0
3	1500004	.	A	T	23	12	35	0	0	35	0	0
3	1500232	.	T	A	12	7	19	0	1	20	0	0
3	1500648	.	G	A	11	10	21	0	1	22	0	0
3	1501016	.	T	C	1	4	5	0	1	6	0	0
3	1501131	.	C	T	5	3	8	0	1	9	0	0
3	1511271	.	G	A	4	8	12	0	0	12	0	0
3	1515168	.	G	A	10	34	44	0	3	47	0	0
3	1520510	.	A	C	8	29	37	0	3	40	0	0
3	3319014	.	T	A	3	4	7	15	0	22	0	0
3	3358066	.	C	G	6	2	8	0	0	8	0	0
3	3361187	.	A	C	6	0	6	2	3	11	0	0
3	3361724	.	A	G	4	4	8	0	0	8	0	0
3	3361781	.	C	T	7	4	11	0	0	11	0	0
3	3361817	.	A	G	4	2	6	0	1	7	0	0
3	3362031	.	C	T	9	2	11	0	1	12	0	0
3	3362248	.	T	A	4	7	11	0	0	11	0	0
3	3362350	.	G	C	8	4	12	0	1	13	0	0
3	3362682	.	C	G	0	2	2	0	1	3	0	0
3	3610185	.	C	A	9	5	14	0	0	14	0	0
3	3610202	.	A	T	10	4	14	0	1	15	0	0
3	3610255	.	C	T	3	7	10	1	0	11	0	0
3	3622281	.	A	G	8	9	17	0	1	18	0	0
3	3628238	.	G	A	1	15	16	0	9	25	0	0
3	3628248	.	A	C	5	15	20	0	0	20	0	0
3	3630587	.	T	C	11	20	31	0	2	33	0	0
3	3631389	.	T	G	8	16	24	0	0	24	0	0
3	3634393	.	G	C	15	12	27	0	0	27	0	0
3	3634580	.	C	T	3	4	7	0	0	7	0	0
3	3634802	.	T	A	3	2	5	0	0	5	0	0
3	3810947	.	A	G	6	6	12	0	0	12	0	0
3	3813847	.	T	C	2	10	12	0	0	12	0	0
3	3820708	.	T	C	7	6	13	0	0	13	0	0
3	4461117	.	G	T	1	2	3	0	0	3	0	0
3	4502158	.	C	A	11	17	28	0	0	28	0	0
3	4502161	.	T	C	12	17	29	0	0	29	0	0
3	4504739	.	A	G	13	23	36	0	0	36	0	0
3	4504808	.	A	G	11	13	24	0	0	24	0	0
3	4506897	.	A	G	5	11	16	0	0	16	0	0
3	4506961	.	G	A	1	12	13	0	7	20	0	0
3	4508042	.	A	C	17	6	23	0	0	23	0	0
3	4508093	.	C	A	21	11	32	0	0	32	0	0
3	4508120	.	C	T	19	14	33	0	3	36	0	0
3	4511052	.	T	C	5	19	24	0	2	26	0	0
3	4511163	.	A	G	7	0	7	0	7	14	0	0
3	4514030	.	G	A	6	7	13	0	0	13	0	0
3	4522767	.	A	G	10	0	10	0	8	18	0	0
3	4530061	.	G	A	7	8	15	0	0	15	0	0
3	4530118	.	T	A	2	2	4	0	1	5	0	0
3	4648886	.	C	A	0	2	2	0	1	3	0	0
3	4997623	.	C	T	5	3	8	0	0	8	0	0
3	4997917	.	A	T	5	7	12	0	0	12	0	0
3	5010664	.	A	T	19	14	33	0	1	34	0	0
3	5012736	.	T	C	14	3	17	0	12	29	0	0
3	5012832	.	C	G	2	20	22	0	19	41	0	0
3	5019643	.	C	T	1	2	3	0	0	3	0	0
3	5019660	.	T	C	1	2	3	0	0	3	0	0
3	5019701	.	C	A	2	1	3	0	1	5	1	0
3	5019801	.	A	G	4	14	18	0	0	18	0	0
3	5019839	.	A	T	5	11	16	0	0	16	0	0
3	5021453	.	C	T	3	11	14	0	7	21	0	0
3	5021516	.	T	C	11	10	21	0	1	22	0	0
3	5027635	.	A	G	9	12	21	0	0	21	0	0
3	5029924	.	A	C	13	20	33	0	0	33	0	0
3	5029982	.	A	T	13	12	25	0	0	25	0	0
3	5035201	.	A	C	7	8	15	0	0	16	1	0
3	5040591	.	A	G	4	8	12	0	0	12	0	0
3	5040757	.	A	G	9	6	15	0	0	15	0	0
3	5040777	.	G	A	5	7	12	0	1	13	0	0
3	5040798	.	A	C	6	9	15	0	0	15	0	0
3	5053060	.	C	T	4	24	28	0	26	54	0	0
3	5053084	.	C	T	3	25	28	0	23	51	0	0
3	5053108	.	A	C	25	19	44	0	0	44	0	0
3	5053246	.	G	A	17	13	30	0	0	30	0	0
3	5053260	.	C	T	20	10	30	0	0	30	0	0
3	5053409	.	C	T	2	22	24	0	21	45	0	0
3	5053586	.	C	T	3	18	21	0	28	49	0	0
3	5053934	.	G	A	15	31	46	0	0	46	0	0
3	5054018	.	A	G	20	23	43	0	3	46	0	0
3	5056247	.	G	A	21	26	47	0	3	50	0	0
3	5056390	.	A	T	27	26	53	1	5	60	1	0
3	5062927	.	G	A	24	25	49	0	1	50	0	0
3	5062980	.	C	A	24	24	48	0	1	49	0	0
3	5063011	.	T	C	18	0	18	0	21	39	0	0
3	5063176	.	G	A	18	16	34	0	1	35	0	0
3	5130791	.	C	A	12	9	21	0	0	21	0	0
3	5130851	.	T	C	11	11	22	0	3	25	0	0
3	5134113	.	G	A	13	13	26	0	2	28	0	0
3	5134122	.	G	A	14	13	27	0	1	28	0	0
3	5136617	.	G	A	10	11	21	0	0	21	0	0
3	5140851	.	A	G	13	9	22	0	0	22	0	0
3	5141035	.	C	T	14	6	20	0	1	21	0	0
3	5141152	.	C	T	9	10	19	0	1	20	0	0
3	5143119	.	C	T	7	6	13	0	0	13	0	0
3	5143522	.	C	T	10	9	19	0	2	21	0	0
3	5145139	.	C	A	2	9	11	0	8	19	0	0
3	5145797	.	C	T	1	8	9	0	7	16	0	0
3	5145988	.	G	A	6	10	16	0	0	16	0	0
3	5145991	.	T	C	5	0	5	0	10	15	0	0
3	5147544	.	G	A	8	7	15	0	1	16	0	0
3	5147606	.	G	T	5	5	10	0	0	10	0	0
3	5150391	.	G	A	5	5	10	0	0	10	0	0
3	5152715	.	T	C	8	6	14	0	0	14	0	0
3	5159345	.	G	A	6	3	9	0	0	9	0	0
3	5163352	.	C	T	5	8	13	0	0	13	0	0
3	5163418	.	C	G	3	15	18	0	1	19	0	0
3	5163442	.	G	T	3	12	15	0	1	16	0	0
3	5163826	.	C	T	1	5	6	0	3	9	0	0
3	5163889	.	G	A	4	4	8	0	0	8	0	0
3	5171303	.	G	T	4	3	7	0	0	7	0	0
3	5193439	.	C	T	5	4	9	2	0	11	0	0
3	5228084	.	A	G	4	7	11	0	0	11	0	0
3	5267221	.	G	A	14	20	34	0	1	35	0	0
3	5267251	.	C	T	17	13	30	0	0	30	0	0
3	5270274	.	C	T	1	20	21	0	17	38	0	0
3	5623807	.	C	T	2	18	20	0	21	41	0	0
3	5624487	.	C	T	3	21	24	1	12	37	0	0
3	5624604	.	C	A	17	20	37	0	2	40	1	0
3	5627917	.	G	A	23	18	41	0	1	42	0	0
3	5633089	.	G	A	10	16	26	0	0	26	0	0
3	5652999	.	G	A	2	2	4	0	0	4	0	0
3	5719007	.	G	T	1	7	8	0	0	8	0	0
3	5723572	.	G	A	1	2	3	1	0	4	0	0
3	5778981	.	G	A	14	12	26	0	1	27	0	0
3	5779044	.	T	A	7	16	23	0	3	26	0	0
3	5779093	.	G	T	9	16	25	0	1	26	0	0
3	5782501	.	A	G	8	9	17	0	1	18	0	0
3	5782715	.	A	G	12	15	27	0	2	29	0	0
3	5792569	.	T	A	14	7	21	0	0	21	0	0
3	5812205	.	C	T	14	7	21	0	1	22	0	0
3	5812802	.	C	T	2	10	12	0	16	28	0	0
3	5812813	.	G	A	10	11	21	0	7	28	0	0
3	5814475	.	C	T	8	4	12	0	0	12	0	0
3	5814478	.	C	T	7	6	13	0	0	13	0	0
3	5823477	.	G	A	6	9	15	0	1	16	0	0
3	5823483	.	C	A	1	10	11	0	5	16	0	0
3	5824826	.	T	C	10	6	16	0	2	18	0	0
3	5824858	.	C	T	9	6	15	0	0	15	0	0
3	5824870	.	C	T	10	7	17	0	1	18	0	0
3	5829415	.	A	G	9	5	14	0	0	14	0	0
3	5882351	.	G	A	6	2	8	0	1	9	0	0
3	5882397	.	A	G	6	3	9	0	1	10	0	0
3	5882439	.	A	G	7	3	10	0	0	10	0	0
3	5882661	.	T	C	1	5	6	0	0	6	0	0
3	5882912	.	A	T	1	2	3	0	0	3	0	0
3	5882973	.	T	C	1	7	8	0	0	8	0	0
3	5886917	.	C	T	0	30	30	0	21	51	0	0
3	5887223	.	T	C	21	19	40	0	0	40	0	0
3	5887463	.	T	G	17	24	41	0	2	43	0	0
3	5887661	.	A	T	21	23	44	0	1	45	0	0
3	5887673	.	G	C	22	0	22	0	24	46	0	0
3	5887715	.	T	C	22	16	38	0	4	42	0	0
3	5887841	.	T	A	17	21	38	0	10	48	0	0
3	5887931	.	A	T	25	12	37	0	3	40	0	0
3	5888245	.	C	T	24	16	40	0	2	42	0	0
3	5888664	.	G	A	15	15	30	0	0	30	0	0
3	5888868	.	G	A	26	11	37	0	2	39	0	0
3	5889077	.	G	T	25	8	33	0	1	34	0	0
3	5889302	.	T	C	17	19	36	0	2	38	0	0
3	5889642	.	A	T	12	16	28	0	1	29	0	0
3	5889983	.	A	G	7	4	11	0	0	11	0	0
3	5890274	.	T	A	25	13	38	0	0	38	0	0
3	5890287	.	A	G	24	10	34	0	4	38	0	0
3	5890698	.	C	T	1	29	30	0	16	46	0	0
3	5890833	.	G	A	20	26	46	1	1	48	0	0
3	5908262	.	C	T	11	21	32	0	1	33	0	0
3	5908302	.	T	C	6	0	6	0	23	29	0	0
3	5908452	.	T	C	13	0	13	0	19	32	0	0
3	5908569	.	C	A	1	10	11	0	17	28	0	0
3	5964113	.	G	A	15	9	24	0	2	26	0	0
3	5991798	.	C	T	0	5	5	0	4	9	0	0
3	5991822	.	G	A	6	5	11	0	0	11	0	0
3	5994984	.	C	T	11	6	17	0	0	17	0	0
3	5995038	.	A	G	9	6	15	0	1	16	0	0
3	5995071	.	A	G	8	6	14	0	0	14	0	0
3	6015843	.	A	G	6	7	13	0	0	13	0	0
3	6018562	.	A	G	6	7	13	0	0	13	0	0
3	6018622	.	G	A	6	4	10	0	1	11	0	0
3	6033237	.	G	A	7	3	10	0	0	10	0	0
3	6035431	.	G	T	5	3	8	0	0	8	0	0
3	6380368	.	T	C	29	18	47	1	4	52	0	0
3	6417172	.	G	A	30	19	49	0	3	52	0	0
3	6444075	.	C	A	4	4	8	0	0	8	0	0
3	6454507	.	G	A	2	4	6	0	0	6	0	0
3	6466036	.	C	T	2	4	6	0	1	7	0	0
3	6474593	.	A	G	4	6	10	0	0	10	0	0
3	6477596	.	G	C	1	7	8	0	0	8	0	0
3	6491540	.	C	T	7	7	14	1	0	15	0	0
3	6491542	.	G	T	8	7	15	1	0	16	0	0
3	6491670	.	C	T	3	13	16	1	2	19	0	0
3	6491820	.	A	T	9	5	14	0	0	14	0	0
3	6491833	.	A	G	8	3	11	0	1	12	0	0
3	6491881	.	G	T	8	11	19	0	0	19	0	0
3	6491906	.	T	C	8	13	21	0	0	21	0	0
3	6492062	.	T	A	1	3	4	0	1	5	0	0
3	6492076	.	A	T	5	2	7	0	0	7	0	0
3	6495017	.	G	A	8	6	14	0	0	14	0	0
3	6498049	.	C	G	1	17	18	0	10	28	0	0
3	6499606	.	T	C	9	0	9	0	8	17	0	0
3	6499636	.	A	G	9	5	14	0	1	15	0	0
3	6502039	.	G	A	10	11	21	0	3	24	0	0
3	6504814	.	T	A	14	12	26	0	0	26	0	0
3	6505007	.	G	T	6	10	16	0	0	16	0	0
3	6505010	.	T	C	5	10	15	0	0	15	0	0
3	6515014	.	C	G	5	12	17	0	0	17	0	0
3	6515029	.	A	G	4	12	16	0	1	17	0	0
3	6516457	.	C	T	0	5	5	0	7	12	0	0
3	6608024	.	C	A	1	4	5	0	1	6	0	0
3	6659843	.	C	T	2	8	10	0	0	10	0	0
3	6663606	.	G	A	7	2	9	0	0	9	0	0
3	6663814	.	A	G	4	3	7	1	0	8	0	0
3	6663815	.	A	G	4	3	7	1	0	8	0	0
3	6664270	.	A	G	2	0	2	0	2	4	0	0
3	6664603	.	A	G	1	5	6	1	1	8	0	0
3	6664609	.	T	C	4	2	6	1	1	8	0	0
3	6664915	.	A	G	4	5	9	0	2	11	0	0
3	6664932	.	G	A	6	2	8	0	0	8	0	0
3	6665874	.	C	G	4	0	4	0	5	9	0	0
3	6665902	.	G	T	7	7	14	0	0	15	1	0
3	6665951	.	C	A	13	7	20	0	1	21	0	0
3	6665985	.	A	T	13	6	19	0	1	20	0	0
3	6666027	.	C	T	6	9	15	0	0	15	0	0
3	6666080	.	A	G	9	9	18	0	0	18	0	0
3	6666092	.	T	C	7	10	17	0	1	18	0	0
3	6666194	.	G	C	6	12	18	0	0	18	0	0
3	6666283	.	A	T	5	12	17	0	0	17	0	0
3	6666341	.	A	G	11	4	15	0	0	15	0	0
3	6666362	.	G	A	10	4	14	0	0	14	0	0
3	6666689	.	T	C	3	5	8	0	1	9	0	0
3	6666691	.	T	C	6	3	9	0	0	9	0	0
3	6666730	.	C	T	1	2	3	0	0	3	0	0
3	6666846	.	T	C	2	3	5	0	0	5	0	0
3	6667060	.	G	C	16	10	26	0	1	27	0	0
3	6667209	.	C	T	9	14	23	0	0	23	0	0
3	6667383	.	T	C	3	2	5	2	0	7	0	0
3	6667959	.	A	C	1	2	3	9	0	12	0	0
3	6669068	.	G	A	1	1	2	0	1	3	0	0
3	6721286	.	G	C	6	4	10	0	0	10	0	0
3	6721421	.	T	G	12	10	22	0	0	22	0	0
3	6721430	.	T	C	13	6	19	0	1	20	0	0
3	6721456	.	A	T	5	7	12	0	3	15	0	0
3	6721579	.	G	A	4	3	7	0	0	7	0	0
3	6721763	.	T	C	4	5	9	0	0	10	1	0
3	6721851	.	C	T	6	8	14	0	0	14	0	0
3	6721971	.	A	T	12	9	21	0	0	21	0	0
3	6722438	.	C	T	2	9	11	0	0	11	0	0
3	6722981	.	G	A	15	7	22	0	1	23	0	0
3	6722986	.	A	T	12	5	17	0	2	19	0	0
3	6723078	.	A	C	11	5	16	1	1	19	1	0
3	6723257	.	A	G	8	6	14	0	0	14	0	0
3	6725130	.	C	T	13	5	18	2	1	21	0	0
3	6725150	.	G	C	3	7	10	2	1	13	0	0
3	6725332	.	T	G	6	8	14	0	1	15	0	0
3	6725432	.	T	A	7	8	15	0	0	15	0	0
3	6725468	.	C	T	7	7	14	0	0	14	0	0
3	6725523	.	C	T	5	3	8	2	1	11	0	0
3	6726020	.	C	T	5	3	8	0	0	8	0	0
3	6726284	.	A	T	3	10	13	0	1	14	0	0
3	6726317	.	A	G	11	7	18	0	2	20	0	0
3	6726359	.	G	A	10	12	22	0	3	25	0	0
3	6726455	.	A	T	19	12	31	0	2	33	0	0
3	6727154	.	C	T	2	11	13	0	13	26	0	0
3	6732696	.	G	A	6	8	14	0	1	15	0	0
3	6732697	.	C	T	0	8	8	0	7	15	0	0
3	6737079	.	G	A	6	14	20	0	0	20	0	0
3	6737099	.	G	T	5	14	19	0	0	19	0	0
3	6739411	.	T	C	2	0	2	0	4	6	0	0
3	6739417	.	G	A	2	3	5	0	0	5	0	0
3	6744185	.	C	G	5	6	11	0	0	11	0	0
3	6744653	.	A	G	5	5	10	0	0	10	0	0
3	6746560	.	G	A	9	5	14	0	0	14	0	0
3	6746749	.	T	C	2	6	8	0	0	8	0	0
3	6752150	.	G	C	1	3	4	0	0	4	0	0
3	6895908	.	C	A	3	3	6	0	0	6	0	0
3	7006992	.	C	A	3	4	7	0	0	7	0	0
3	7007530	.	T	A	2	3	5	0	0	5	0	0
3	7007553	.	G	A	2	3	5	0	0	5	0	0
3	7007642	.	C	T	1	2	3	2	0	5	0	0
3	7007650	.	C	T	1	2	3	1	0	4	0	0
3	7008117	.	C	T	5	2	7	0	0	7	0	0
3	7008132	.	A	G	4	2	6	0	1	7	0	0
3	7008750	.	C	T	2	5	7	3	0	10	0	0
3	7008772	.	T	C	2	2	4	2	0	6	0	0
3	7081667	.	T	C	1	0	1	0	3	4	0	0
3	7081696	.	G	C	1	3	4	0	0	4	0	0
3	7098976	.	T	C	3	2	5	0	0	5	0	0
3	7099049	.	C	T	2	4	6	0	0	6	0	0
3	7099210	.	T	C	2	5	7	1	0	8	0	0
3	7099380	.	C	T	1	5	6	0	0	6	0	0
3	7099600	.	T	C	2	2	4	0	0	4	0	0
3	7099888	.	T	C	3	2	5	2	1	8	0	0
3	7100061	.	A	G	2	2	4	0	0	4	0	0
3	7113025	.	C	T	1	6	7	1	3	11	0	0
3	7113330	.	T	C	6	7	13	0	0	13	0	0
3	7113660	.	A	G	6	6	12	0	0	12	0	0
3	7113669	.	C	T	5	5	10	0	0	10	0	0
3	7113720	.	G	A	5	3	8	0	0	8	0	0
3	7113742	.	G	A	3	4	7	2	0	9	0	0
3	7113934	.	A	G	5	5	10	0	0	10	0	0
3	7114079	.	C	T	5	4	9	3	0	12	0	0
3	7114097	.	T	C	5	2	7	6	1	14	0	0
3	7124140	.	G	A	4	4	8	0	0	8	0	0
3	7124157	.	C	G	2	3	5	0	1	6	0	0
3	7124437	.	A	G	1	4	5	0	0	5	0	0
3	7134022	.	G	C	2	2	4	0	0	4	0	0
3	7141527	.	G	T	7	8	15	0	0	15	0	0
3	7141651	.	T	C	8	3	11	0	0	11	0	0
3	7141717	.	A	G	5	5	10	0	0	10	0	0
3	7141846	.	G	A	4	2	6	2	1	9	0	0
3	7142233	.	C	T	4	3	7	0	0	7	0	0
3	7155225	.	G	A	5	8	13	1	0	14	0	0
3	7155403	.	A	G	4	11	15	0	0	15	0	0
3	7155428	.	G	A	8	3	11	0	2	13	0	0
3	7155462	.	C	T	0	4	4	0	2	6	0	0
3	7155846	.	T	C	5	6	11	0	0	11	0	0
3	7155960	.	T	G	4	3	7	0	1	8	0	0
3	7170561	.	C	T	7	2	9	6	1	16	0	0
3	7276854	.	C	T	0	2	2	0	2	4	0	0
3	7509845	.	C	G	0	2	2	0	1	3	0	0
3	7510268	.	G	A	1	2	3	0	0	3	0	0
3	7510466	.	T	A	2	3	5	0	0	5	0	0
3	7617385	.	G	A	1	17	18	0	13	31	0	0
3	7617429	.	C	G	8	8	16	0	0	16	0	0
3	7618805	.	C	T	11	7	18	0	2	20	0	0
3	7618823	.	A	C	10	10	20	0	1	21	0	0
3	7618880	.	A	G	7	0	7	0	12	19	0	0
3	7623208	.	G	A	14	13	27	0	1	28	0	0
3	7638510	.	A	G	6	10	16	0	3	19	0	0
3	7638520	.	T	G	16	6	22	0	1	23	0	0
3	7638616	.	A	C	4	11	15	0	2	17	0	0
3	7638675	.	C	A	11	12	23	0	0	23	0	0
3	7638946	.	T	A	13	17	30	0	0	30	0	0
3	7638947	.	T	C	12	17	29	0	1	30	0	0
3	7654833	.	C	G	4	22	26	0	29	55	0	0
3	7654835	.	T	C	30	23	53	0	3	56	0	0
3	7655186	.	A	G	31	31	62	0	4	66	0	0
3	7655588	.	T	C	25	1	26	1	27	54	0	0
3	7655660	.	C	T	27	25	52	0	2	54	0	0
3	7655780	.	T	G	29	31	60	0	2	62	0	0
3	7655817	.	A	T	25	23	48	0	0	49	1	0
3	7655819	.	C	T	4	21	25	0	23	48	0	0
3	7655908	.	A	G	30	19	49	0	0	49	0	0
3	7782615	.	A	T	2	4	6	0	1	7	0	0
3	7792316	.	A	G	4	5	9	0	0	9	0	0
3	7795302	.	A	G	4	0	4	0	5	9	0	0
3	7801149	.	G	T	6	5	11	0	0	11	0	0
3	7801997	.	G	A	0	4	4	0	6	10	0	0
3	7806099	.	T	C	7	3	10	0	0	10	0	0
3	7818839	.	A	T	4	7	11	0	3	14	0	0
3	7818905	.	C	G	7	2	9	0	5	14	0	0
3	7818929	.	G	A	1	7	8	0	3	11	0	0
3	7818989	.	C	T	3	6	9	0	0	9	0	0
3	7819798	.	C	T	0	3	3	0	1	4	0	0
3	7819801	.	A	T	1	3	4	0	0	4	0	0
3	7823333	.	G	A	17	11	28	0	1	29	0	0
3	7833801	.	T	C	7	5	12	0	1	13	0	0
3	7833897	.	T	C	15	16	31	0	1	32	0	0
3	7833928	.	C	G	14	15	29	0	1	30	0	0
3	7833995	.	T	C	8	9	17	0	0	17	0	0
3	7853231	.	A	T	5	5	10	0	0	10	0	0
3	7853248	.	A	G	5	6	11	0	1	12	0	0
3	7853274	.	A	C	6	5	11	0	0	11	0	0
3	7853320	.	G	A	5	2	7	0	0	7	0	0
3	7853755	.	T	A	5	5	10	0	1	11	0	0
3	7853827	.	A	C	6	4	10	0	0	10	0	0
3	7853886	.	G	T	10	9	19	0	2	21	0	0
3	7853899	.	T	C	6	1	7	0	10	17	0	0
3	7853950	.	T	C	4	1	5	0	14	19	0	0
3	7853965	.	T	C	6	9	15	0	0	15	0	0
3	7854082	.	G	A	4	7	11	0	0	11	0	0
3	7858092	.	A	G	3	5	8	0	0	8	0	0
3	7862533	.	C	T	4	5	9	0	1	10	0	0
3	7862593	.	A	G	6	3	9	0	0	9	0	0
3	7866215	.	G	A	3	3	6	0	1	7	0	0
3	7866296	.	G	C	1	1	2	0	1	3	0	0
3	7870868	.	T	C	3	2	5	0	0	5	0	0
3	7882384	.	G	A	4	3	7	0	0	7	0	0
3	7882409	.	G	T	2	2	4	0	0	4	0	0
3	7897147	.	A	T	1	4	5	0	1	6	0	0
3	8334392	.	C	T	0	4	4	0	11	15	0	0
3	8348306	.	C	T	0	3	3	0	4	7	0	0
3	8399640	.	A	G	5	4	9	0	0	9	0	0
3	9380616	.	C	T	3	1	4	1	1	6	0	0
3	9380690	.	T	A	3	2	5	0	0	5	0	0
3	9417311	.	C	G	7	4	11	0	0	11	0	0
3	9417377	.	G	A	0	6	6	0	4	10	0	0
3	9417431	.	T	C	2	4	6	0	0	6	0	0
3	9417823	.	G	T	1	2	3	0	0	3	0	0
3	9417827	.	G	T	1	1	2	0	1	3	0	0
3	9417916	.	C	T	1	2	3	0	0	3	0	0
3	9417919	.	A	G	1	2	3	0	0	3	0	0
3	9418030	.	C	T	2	2	4	0	0	4	0	0
3	9418412	.	C	T	1	2	3	0	0	3	0	0
3	9418575	.	C	T	5	5	10	0	0	10	0	0
3	9418654	.	G	A	2	3	5	0	1	6	0	0
3	9418700	.	A	G	2	3	5	0	0	5	0	0
3	9418839	.	A	T	2	2	4	0	0	4	0	0
3	9419095	.	C	T	4	3	7	0	0	7	0	0
3	9419131	.	A	T	2	1	3	0	0	3	0	0
3	9419138	.	T	C	2	3	5	0	0	5	0	0
3	9419890	.	A	G	5	2	7	0	0	7	0	0
3	9419953	.	G	A	0	2	2	0	1	3	0	0
3	9419973	.	T	A	2	4	6	0	0	6	0	0
3	9420002	.	G	A	4	5	9	0	0	9	0	0
3	9420518	.	A	T	4	2	6	0	0	6	0	0
3	9420541	.	T	C	2	4	6	0	0	6	0	0
3	9420613	.	A	T	6	3	9	0	0	9	0	0
3	9420973	.	A	G	2	5	7	0	0	7	0	0
3	9421253	.	T	C	1	4	5	0	0	5	0	0
3	9421668	.	G	A	0	5	5	0	5	10	0	0
3	9421878	.	C	A	3	4	7	0	1	8	0	0
3	9422062	.	G	A	4	3	7	0	0	7	0	0
3	9422130	.	T	C	2	2	4	0	0	4	0	0
3	9422176	.	T	A	1	3	4	0	1	5	0	0
3	9593338	.	G	T	8	3	11	0	0	11	0	0
3	9593344	.	A	T	5	7	12	0	0	12	0	0
3	9596311	.	C	T	6	11	17	0	0	17	0	0
3	9596313	.	C	T	7	11	18	0	0	18	0	0
3	9599885	.	G	T	7	3	10	0	1	11	0	0
3	9609472	.	C	G	15	18	33	0	0	33	0	0
3	9609502	.	G	A	13	17	30	0	0	32	2	0
3	9611371	.	G	A	2	14	16	0	9	25	0	0
3	9615718	.	G	A	12	12	24	0	1	25	0	0
3	9616399	.	C	T	20	10	30	0	1	31	0	0
3	9624849	.	G	A	20	9	29	0	0	29	0	0
3	9624882	.	G	A	9	11	20	0	2	22	0	0
3	9625735	.	C	T	10	10	20	0	3	23	0	0
3	9626138	.	G	T	7	4	11	0	0	11	0	0
3	9626141	.	T	C	5	3	8	0	2	10	0	0
3	9626206	.	C	T	2	2	4	0	0	4	0	0
3	9626276	.	G	T	4	8	12	0	0	12	0	0
3	9626307	.	T	G	7	9	16	0	0	17	1	0
3	9640322	.	C	T	1	9	10	0	11	21	0	0
3	9640467	.	A	G	14	12	26	0	0	26	0	0
3	9640659	.	A	G	23	12	35	0	1	36	0	0
3	9641205	.	C	T	8	7	15	0	3	18	0	0
3	9641217	.	T	C	4	14	18	0	1	19	0	0
3	9641244	.	C	T	7	8	15	0	0	15	0	0
3	9641337	.	C	T	14	16	30	0	1	31	0	0
3	9641451	.	C	T	3	16	19	0	17	36	0	0
3	9641859	.	G	A	4	11	15	0	0	15	0	0
3	9644553	.	C	T	7	8	15	0	0	15	0	0
3	9644745	.	G	A	7	7	14	0	0	14	0	0
3	9644772	.	A	G	5	7	12	0	1	13	0	0
3	9646926	.	A	G	15	4	19	1	0	20	0	0
3	9650313	.	A	G	6	7	13	0	0	13	0	0
3	9650327	.	A	G	8	5	13	0	0	13	0	0
3	9650403	.	A	G	9	4	13	0	1	14	0	0
3	9650598	.	G	A	3	7	10	0	0	10	0	0
3	9650631	.	C	T	2	5	7	0	6	13	0	0
3	9650682	.	T	C	14	2	16	0	7	23	0	0
3	9650706	.	A	G	11	13	24	0	0	24	0	0
3	9654675	.	G	A	10	9	19	0	3	22	0	0
3	9656656	.	C	T	2	9	11	0	12	23	0	0
3	9658463	.	C	T	0	6	6	0	9	15	0	0
3	9658481	.	A	G	9	6	15	0	0	15	0	0
3	9663966	.	A	T	10	8	18	0	0	18	0	0
3	9664193	.	C	T	1	6	7	0	4	11	0	0
3	9665608	.	G	T	4	3	7	0	2	9	0	0
3	9665629	.	A	G	6	4	10	0	0	10	0	0
3	9686142	.	C	A	7	4	11	1	0	12	0	0
3	9706117	.	T	G	7	4	11	0	2	13	0	0
3	9706331	.	A	G	5	8	13	0	0	13	0	0
3	9706445	.	T	C	12	9	21	0	0	21	0	0
3	9706577	.	T	C	3	5	8	0	1	9	0	0
3	9738707	.	G	A	3	6	9	0	0	9	0	0
3	9738941	.	A	T	5	2	7	0	0	7	0	0
3	9738962	.	G	T	2	3	5	0	1	6	0	0
3	9749791	.	C	A	5	3	8	0	0	8	0	0
3	9749806	.	A	C	4	0	4	0	4	8	0	0
3	9761259	.	C	T	0	1	1	0	2	3	0	0
3	10152166	.	G	T	3	4	7	0	2	9	0	0
3	10162939	.	T	C	4	4	8	0	0	8	0	0
3	10163116	.	G	A	1	5	6	0	1	7	0	0
3	10163153	.	C	A	2	4	6	0	0	6	0	0
3	10163287	.	C	G	3	0	3	0	2	5	0	0
3	10163302	.	T	C	4	2	6	0	0	6	0	0
3	10164025	.	C	T	1	3	4	0	0	4	0	0
3	10164398	.	T	C	1	2	3	0	0	3	0	0
3	10410994	.	C	A	4	9	13	0	0	13	0	0
3	10411002	.	T	A	4	9	13	0	0	13	0	0
3	10411054	.	T	C	4	3	7	0	0	7	0	0
3	10421097	.	A	G	5	5	10	0	0	10	0	0
3	10536157	.	T	G	5	5	10	0	0	10	0	0
3	10536511	.	C	T	12	5	17	0	0	17	0	0
3	10551014	.	G	A	2	10	12	0	1	13	0	0
3	10559821	.	T	C	3	0	3	0	6	9	0	0
3	10559824	.	G	T	5	3	8	0	1	9	0	0
3	10561044	.	C	T	6	6	12	0	0	12	0	0
3	10561127	.	G	C	2	5	7	0	1	8	0	0
3	10567608	.	T	A	12	4	16	0	2	18	0	0
3	10569342	.	G	A	7	6	13	0	0	13	0	0
3	10574232	.	A	G	4	3	7	0	0	7	0	0
3	10575699	.	C	G	8	2	10	0	0	10	0	0
3	10575701	.	T	G	7	2	9	0	1	10	0	0
3	10576463	.	A	T	3	3	6	0	1	7	0	0
3	10582122	.	C	G	5	3	8	0	0	8	0	0
3	10582197	.	G	C	2	7	9	0	0	9	0	0
3	10582212	.	C	T	1	5	6	0	1	7	0	0
3	10582254	.	G	T	4	2	6	0	1	7	0	0
3	10612103	.	G	A	5	8	13	0	0	13	0	0
3	10634422	.	C	T	14	14	28	0	2	30	0	0
3	10634437	.	T	C	13	15	28	0	1	29	0	0
3	11073388	.	A	G	18	19	37	0	1	38	0	0
3	11073431	.	C	T	15	13	28	0	1	29	0	0
3	11073454	.	T	C	14	12	26	0	0	26	0	0
3	11073517	.	C	T	13	11	24	0	1	25	0	0
3	11074764	.	C	G	18	0	18	0	8	26	0	0
3	11075120	.	G	A	10	15	25	0	1	26	0	0
3	11075190	.	G	A	2	16	18	0	15	33	0	0
3	11075310	.	A	G	18	0	18	0	13	31	0	0
3	11548516	.	C	T	7	7	14	0	0	14	0	0
3	11554135	.	A	G	7	0	7	0	12	19	0	0
3	11554141	.	T	C	8	12	20	0	0	20	0	0
3	11558287	.	G	A	9	6	15	0	0	15	0	0
3	11575354	.	G	A	0	7	7	0	14	21	0	0
3	11575471	.	T	C	12	8	20	0	1	21	0	0
3	11575591	.	C	A	8	7	15	1	3	19	0	0
3	11575675	.	C	G	3	12	15	0	2	17	0	0
3	11575679	.	C	G	3	11	14	0	1	15	0	0
3	11575753	.	T	C	5	7	12	0	1	13	0	0
3	11575955	.	T	A	2	5	7	0	0	7	0	0
3	11585815	.	A	G	12	7	19	0	1	20	0	0
3	11585852	.	T	A	8	12	20	0	2	22	0	0
3	11585937	.	G	A	13	14	27	0	2	29	0	0
3	11586002	.	T	G	15	6	21	0	10	31	0	0
3	11586028	.	T	A	16	4	20	0	0	20	0	0
3	11586227	.	C	A	5	3	8	0	0	8	0	0
3	11586331	.	C	T	3	17	20	0	25	45	0	0
3	11586346	.	C	T	28	18	46	0	1	47	0	0
3	11586382	.	G	A	31	15	46	0	1	47	0	0
3	11586635	.	A	G	28	11	39	0	3	42	0	0
3	11586679	.	C	T	18	12	30	3	1	34	0	0
3	11586695	.	C	T	2	10	12	5	10	27	0	0
3	11590280	.	A	G	14	22	36	0	3	39	0	0
3	11614970	.	T	C	35	17	52	0	1	53	0	0
3	11615007	.	A	T	33	17	50	0	4	54	0	0
3	11615041	.	T	C	35	0	35	0	21	56	0	0
3	11615109	.	G	A	26	28	54	0	2	56	0	0
3	11615133	.	A	G	25	29	54	0	4	58	0	0
3	11615224	.	A	G	31	22	53	0	1	54	0	0
3	11624298	.	A	G	21	14	35	0	1	36	0	0
3	11781003	.	A	C	10	13	23	4	2	29	0	0
3	11781079	.	T	C	16	13	29	0	5	34	0	0
3	11781113	.	G	A	17	21	38	0	5	43	0	0
3	11784743	.	G	A	11	23	34	0	3	37	0	0
3	11797076	.	C	T	1	11	12	0	16	28	0	0
3	11947254	.	A	G	9	7	16	0	0	16	0	0
3	11947261	.	A	G	9	6	15	0	0	15	0	0
3	12203028	.	C	G	2	8	10	0	0	10	0	0
3	12226807	.	T	C	1	5	6	0	0	6	0	0
3	12226808	.	C	T	1	5	6	0	0	6	0	0
3	13424233	.	T	C	6	3	9	0	0	9	0	0
3	13502218	.	T	G	1	3	4	0	0	4	0	0
3	13502219	.	A	T	0	3	3	0	0	3	0	0
3	14451642	.	A	G	6	13	19	0	0	19	0	0
3	14451657	.	A	G	16	5	21	0	0	21	0	0
3	14496823	.	T	C	22	12	34	0	2	36	0	0
3	14497004	.	T	C	4	24	28	0	2	30	0	0
3	14497015	.	T	C	18	8	26	0	2	28	0	0
3	14507506	.	A	G	3	4	7	0	0	7	0	0
3	15310678	.	T	A	1	2	3	0	0	3	0	0
3	15332538	.	C	G	18	20	38	0	1	39	0	0
3	15332601	.	G	T	16	13	29	0	4	33	0	0
3	15332881	.	G	A	17	17	34	0	1	35	0	0
3	15332902	.	C	A	3	20	23	0	14	37	0	0
3	15332923	.	G	A	21	20	41	0	1	42	0	0
3	15333065	.	G	A	23	24	47	0	3	50	0	0
3	15358652	.	C	T	8	9	17	0	0	17	0	0
3	15360723	.	C	T	6	6	12	0	0	12	0	0
3	15361086	.	G	T	11	21	32	0	1	33	0	0
3	15361222	.	T	C	17	6	23	0	0	23	0	0
3	15361359	.	T	A	10	10	20	1	0	21	0	0
3	15362277	.	C	T	6	9	15	0	0	15	0	0
3	15362403	.	A	C	12	13	25	0	0	25	0	0
3	15392350	.	C	A	5	14	19	1	2	22	0	0
3	15392401	.	G	A	9	11	20	0	3	23	0	0
3	15392460	.	A	G	10	3	13	0	7	20	0	0
3	15400517	.	G	A	5	3	8	0	0	8	0	0
3	15412770	.	C	A	10	10	20	0	0	20	0	0
3	15416645	.	G	A	0	8	8	0	23	31	0	0
3	15419098	.	C	T	10	7	17	0	0	17	0	0
3	15455662	.	A	G	5	6	11	0	1	12	0	0
3	15458554	.	G	A	10	11	21	0	0	21	0	0
3	15469172	.	G	A	5	8	13	0	0	13	0	0
3	15476676	.	T	A	1	3	4	0	0	4	0	0
3	15476843	.	G	A	5	8	13	0	0	13	0	0
3	15476891	.	G	T	7	10	17	0	0	17	0	0
3	15477765	.	C	T	8	12	20	0	0	20	0	0
3	15477827	.	T	C	3	6	9	0	0	9	0	0
3	15480386	.	A	T	11	4	15	0	1	16	0	0
3	15480437	.	G	T	5	8	13	0	0	13	0	0
3	15480464	.	A	G	5	6	11	0	0	11	0	0
3	15486290	.	G	A	9	4	13	0	0	13	0	0
3	15489831	.	T	C	2	3	5	0	0	5	0	0
3	15489862	.	G	A	4	2	6	0	0	6	0	0
3	15490026	.	A	C	5	7	12	0	1	13	0	0
3	15490543	.	C	T	1	6	7	0	9	16	0	0
3	15490681	.	T	G	8	9	17	0	1	18	0	0
3	15491473	.	G	A	7	8	15	0	0	15	0	0
3	15491503	.	A	C	7	0	7	0	7	14	0	0
3	15496463	.	G	T	2	11	13	0	0	13	0	0
3	15505359	.	T	C	15	9	24	0	0	24	0	0
3	15505394	.	T	C	10	3	13	0	0	13	0	0
3	15505658	.	G	A	7	3	10	0	0	10	0	0
3	15505700	.	A	G	6	5	11	0	0	11	0	0
3	15505703	.	C	G	6	5	11	0	0	11	0	0
3	15505856	.	A	T	9	12	21	0	0	21	0	0
3	15505864	.	G	A	2	10	12	0	10	22	0	0
3	15505910	.	C	T	13	3	16	0	1	17	0	0
3	15505911	.	G	A	0	4	4	0	13	17	0	0
3	15505979	.	G	A	2	3	5	0	0	5	0	0
3	15550837	.	C	T	8	11	19	0	1	20	0	0
3	15551446	.	A	C	12	7	19	0	1	20	0	0
3	15551723	.	G	A	14	10	24	0	0	24	0	0
3	15562804	.	G	A	1	13	14	0	16	30	0	0
3	15562834	.	A	C	15	18	33	0	0	33	0	0
3	15571888	.	G	A	15	15	30	0	2	32	0	0
3	15591107	.	C	T	9	11	20	0	1	21	0	0
3	15599576	.	A	G	8	0	8	1	17	26	0	0
3	15607970	.	T	G	19	15	34	0	0	35	1	0
3	15622584	.	T	G	2	5	7	0	0	7	0	0
3	15622701	.	C	G	1	3	4	0	0	4	0	0
3	15623003	.	A	T	4	4	8	0	0	8	0	0
3	15623132	.	T	G	2	4	6	0	1	7	0	0
3	15625376	.	G	A	1	2	3	0	1	4	0	0
3	15627447	.	A	G	1	3	4	0	0	4	0	0
3	15627493	.	C	T	1	2	3	0	5	8	0	0
3	15627502	.	G	A	3	6	9	0	0	9	0	0
3	15627539	.	G	A	4	2	6	0	0	6	0	0
3	15627767	.	G	A	5	9	14	0	1	15	0	0
3	15627806	.	G	C	10	10	20	0	0	20	0	0
3	15628056	.	G	A	1	0	1	0	0	1	0	0
3	15628281	.	C	T	0	2	2	0	4	6	0	0
3	15628455	.	G	A	4	6	10	0	0	10	0	0
3	15628458	.	A	C	4	0	4	0	6	10	0	0
3	15628704	.	A	C	6	4	10	0	0	10	0	0
3	15628753	.	G	A	4	5	9	0	0	9	0	0
3	15628782	.	G	A	2	4	6	0	0	6	0	0
3	15628956	.	G	A	7	6	13	2	0	15	0	0
3	15629022	.	T	C	2	5	7	0	1	8	0	0
3	15629148	.	T	C	2	5	7	0	0	7	0	0
3	15629149	.	G	C	2	5	7	0	0	7	0	0
3	15629349	.	A	G	6	3	9	0	0	9	0	0
3	15629436	.	G	A	1	3	4	0	0	4	0	0
3	15629894	.	T	C	1	2	3	0	0	3	0	0
3	15629967	.	G	C	6	6	12	0	1	13	0	0
3	15630257	.	A	T	5	7	12	0	0	12	0	0
3	15635054	.	G	A	5	6	11	0	1	12	0	0
3	15635069	.	A	G	4	7	11	0	0	11	0	0
3	15635192	.	G	C	5	1	6	0	5	11	0	0
3	15635249	.	T	C	3	9	12	0	0	12	0	0
3	15635250	.	T	A	3	9	12	0	0	12	0	0
3	15637713	.	T	A	8	5	13	0	0	13	0	0
3	15637716	.	C	G	4	7	11	0	2	13	0	0
3	15638264	.	C	T	0	10	10	0	2	12	0	0
3	15642367	.	C	T	4	3	7	0	0	7	0	0
3	15642384	.	T	C	2	4	6	0	3	9	0	0
3	15642539	.	C	T	1	3	4	0	0	4	0	0
3	15642564	.	T	C	2	3	5	0	0	5	0	0
3	15642576	.	G	C	4	2	6	0	0	6	0	0
3	15642897	.	C	T	0	2	2	0	3	5	0	0
3	15646974	.	T	A	3	13	16	0	0	16	0	0
3	15647699	.	C	T	5	10	15	0	1	16	0	0
3	15648759	.	T	C	4	2	6	0	1	7	0	0
3	15648767	.	C	T	5	3	8	0	0	8	0	0
3	15648886	.	C	T	2	2	4	0	1	5	0	0
3	15649094	.	T	C	4	2	6	0	1	7	0	0
3	15649096	.	G	A	4	2	6	0	1	7	0	0
3	15649431	.	A	C	4	5	9	1	2	12	0	0
3	15649452	.	C	T	4	5	9	1	0	10	0	0
3	15649675	.	G	A	6	7	13	0	0	13	0	0
3	15649731	.	C	T	5	5	10	0	0	10	0	0
3	15661675	.	G	A	5	2	7	0	0	7	0	0
3	15661705	.	G	A	8	3	11	0	0	11	0	0
3	15661726	.	C	T	4	6	10	0	0	10	0	0
3	15670505	.	G	A	3	2	5	0	0	5	0	0
3	15670922	.	C	T	2	5	7	0	1	8	0	0
3	15670923	.	G	C	2	5	7	0	1	8	0	0
3	15671055	.	G	A	5	8	13	0	0	13	0	0
3	15671578	.	A	T	4	4	8	0	0	8	0	0
3	15671631	.	T	C	10	4	14	0	1	15	0	0
3	15671635	.	T	A	9	4	13	0	1	14	0	0
3	15678918	.	G	A	7	5	12	0	0	12	0	0
3	15679004	.	C	A	5	5	10	0	1	11	0	0
3	15679039	.	C	A	4	3	7	0	0	7	0	0
3	15697388	.	A	G	18	12	30	0	0	30	0	0
3	15697454	.	A	G	16	13	29	0	0	29	0	0
3	15697487	.	G	T	9	10	19	0	5	24	0	0
3	15697529	.	C	T	9	14	23	0	3	26	0	0
3	15706550	.	T	A	9	19	28	0	0	28	0	0
3	15706582	.	G	A	17	14	31	0	1	32	0	0
3	15715141	.	A	G	4	4	8	0	2	10	0	0
3	15715907	.	T	C	7	3	10	0	1	11	0	0
3	15717641	.	C	G	6	7	13	0	0	13	0	0
3	15722591	.	G	A	5	6	11	0	1	12	0	0
3	15741954	.	C	T	15	18	33	0	1	34	0	0
3	15744752	.	A	G	25	0	25	0	15	40	0	0
3	15744895	.	G	A	19	25	44	0	0	44	0	0
3	15746427	.	T	A	16	8	24	0	1	25	0	0
3	15746488	.	T	C	19	11	30	0	0	30	0	0
3	15746518	.	G	T	11	11	22	0	2	24	0	0
3	15746612	.	G	A	16	13	29	0	0	29	0	0
3	15746613	.	T	C	17	10	27	0	2	29	0	0
3	15746701	.	C	T	14	13	27	0	0	27	0	0
3	15746884	.	G	T	13	14	27	0	0	27	0	0
3	15746937	.	A	T	4	4	8	0	0	8	0	0
3	15746938	.	C	T	3	4	7	0	0	7	0	0
3	15774083	.	T	A	4	4	8	0	2	11	1	0
3	15775783	.	A	G	6	2	8	0	0	8	0	0
3	15776000	.	G	A	3	10	13	0	5	18	0	0
3	15776027	.	G	A	1	7	8	0	4	12	0	0
3	15776060	.	C	T	9	6	15	0	0	15	0	0
3	15776153	.	T	C	7	10	17	0	1	18	0	0
3	15776377	.	G	A	7	12	19	0	0	19	0	0
3	15776603	.	T	A	5	11	16	0	0	16	0	0
3	15776624	.	G	A	10	4	14	0	0	14	0	0
3	15776729	.	A	G	2	4	6	0	0	6	0	0
3	15794907	.	C	G	9	0	9	0	14	23	0	0
3	15795012	.	C	T	12	11	23	0	0	23	0	0
3	15795090	.	C	T	8	18	26	0	0	26	0	0
3	15795192	.	A	G	16	16	32	0	0	32	0	0
3	15795395	.	G	A	6	9	15	0	0	15	0	0
3	15809394	.	G	C	1	2	3	0	0	3	0	0
3	15809862	.	C	T	2	4	6	0	0	6	0	0
3	15810350	.	A	T	1	2	3	0	0	3	0	0
3	15818992	.	T	C	8	8	16	0	0	16	0	0
3	15821653	.	C	T	12	5	17	1	0	18	0	0
3	15821763	.	C	T	12	10	22	0	0	22	0	0
3	15821919	.	C	T	10	4	14	0	0	14	0	0
3	15822017	.	A	T	8	5	13	0	0	13	0	0
3	15822260	.	G	A	0	3	3	0	4	7	0	0
3	15822354	.	A	G	6	0	6	0	7	13	0	0
3	15822628	.	A	T	5	5	10	0	0	10	0	0
3	15822668	.	T	C	9	4	13	0	0	13	0	0
3	15822706	.	A	T	6	5	11	0	0	12	1	0
3	15822721	.	T	C	10	4	14	0	0	14	0	0
3	15823267	.	C	A	4	8	12	0	0	12	0	0
3	15823373	.	C	A	14	7	21	0	1	22	0	0
3	15823578	.	T	A	9	7	16	0	0	16	0	0
3	15823695	.	C	T	13	4	17	0	2	19	0	0
3	15823701	.	T	C	13	2	15	0	2	17	0	0
3	15823857	.	T	A	12	7	19	0	1	20	0	0
3	15823858	.	C	T	12	8	20	0	0	20	0	0
3	15823958	.	A	G	5	4	9	0	0	9	0	0
3	15835605	.	A	C	17	18	35	0	2	37	0	0
3	15835616	.	G	A	2	16	18	0	17	35	0	0
3	15835777	.	G	A	1	11	12	0	13	25	0	0
3	15852739	.	T	A	11	5	16	0	1	17	0	0
3	15856170	.	G	C	6	6	12	0	1	13	0	0
3	15856234	.	C	A	2	11	13	0	12	25	0	0
3	15862581	.	A	T	8	7	15	0	2	17	0	0
3	15862687	.	G	A	7	11	18	0	2	20	0	0
3	15862895	.	G	A	8	10	18	0	0	18	0	0
3	15863398	.	G	C	10	10	20	0	0	20	0	0
3	15867593	.	G	A	13	9	22	0	0	22	0	0
3	15868504	.	C	T	10	10	20	0	3	23	0	0
3	15868578	.	C	T	3	9	12	0	2	14	0	0
3	15873653	.	A	G	6	8	14	0	0	14	0	0
3	15876085	.	T	A	8	11	19	0	0	19	0	0
3	15878957	.	A	G	9	8	17	0	0	17	0	0
3	15879331	.	G	A	1	2	3	0	1	4	0	0
3	15882141	.	A	G	5	8	13	0	0	13	0	0
3	15882171	.	T	C	8	5	13	0	0	13	0	0
3	15882177	.	G	T	7	6	13	0	1	14	0	0
3	15886590	.	G	A	12	8	20	0	2	22	0	0
3	15887079	.	C	T	3	4	7	0	5	12	0	0
3	15900668	.	A	C	14	5	19	1	5	25	0	0
3	15900764	.	C	T	6	7	13	0	0	13	0	0
3	15900849	.	T	C	5	9	14	0	2	16	0	0
3	15900875	.	T	G	5	0	5	0	12	17	0	0
3	15900998	.	C	T	10	7	17	0	1	18	0	0
3	15901024	.	C	T	7	8	15	0	1	16	0	0
3	15901147	.	A	T	15	8	23	0	0	23	0	0
3	15901187	.	A	G	11	1	12	0	9	21	0	0
3	15901481	.	C	T	6	9	15	0	1	16	0	0
3	15902013	.	A	C	3	9	12	0	0	12	0	0
3	15907410	.	G	A	19	22	41	0	0	41	0	0
3	15907421	.	T	C	16	23	39	0	0	39	0	0
3	15907523	.	T	G	22	26	48	0	1	49	0	0
3	15907610	.	T	G	18	17	35	0	4	39	0	0
3	15907619	.	C	T	21	22	43	0	3	46	0	0
3	15921020	.	A	G	19	12	31	0	2	33	0	0
3	15921045	.	T	C	22	14	36	0	1	37	0	0
3	15921089	.	T	C	17	19	36	0	2	38	0	0
3	15922002	.	A	T	23	22	45	0	0	45	0	0
3	15957830	.	T	G	22	1	23	0	21	44	0	0
3	15957896	.	T	C	30	28	58	0	1	59	0	0
3	15957962	.	T	C	24	28	52	0	0	52	0	0
3	15969632	.	A	C	21	21	42	0	0	42	0	0
3	15974017	.	A	T	31	19	50	1	3	54	0	0
3	15986073	.	G	A	1	23	24	1	30	55	0	0
3	15988113	.	A	G	25	7	32	0	0	32	0	0
3	15988337	.	A	G	21	17	38	5	0	43	0	0
3	15990607	.	C	T	3	5	8	0	1	9	0	0
3	15990688	.	C	A	3	12	15	0	0	15	0	0
3	15990698	.	A	G	2	9	11	0	1	12	0	0
3	15990797	.	C	T	7	7	14	0	0	14	0	0
3	15990891	.	G	A	7	6	13	0	0	13	0	0
3	15990929	.	A	T	6	7	13	0	0	13	0	0
3	15991029	.	A	T	0	11	11	0	0	11	0	0
3	15991141	.	C	T	0	11	11	1	9	21	0	0
3	15993894	.	T	C	12	0	12	0	5	17	0	0
3	15994064	.	C	T	5	8	13	0	0	13	0	0
3	15996759	.	G	T	9	13	22	0	1	23	0	0
3	15996819	.	G	T	22	12	34	0	0	34	0	0
3	16003199	.	C	A	5	2	7	0	1	8	0	0
3	16003208	.	T	C	3	5	8	0	0	8	0	0
3	16003276	.	T	A	7	6	13	0	0	13	0	0
3	16003282	.	A	T	8	7	15	0	0	15	0	0
3	16003331	.	T	A	13	11	24	0	2	26	0	0
3	16004015	.	G	A	15	18	33	0	1	34	0	0
3	16004240	.	G	A	22	21	43	1	2	46	0	0
3	16018378	.	T	G	7	2	9	1	1	11	0	0
3	16018463	.	A	T	7	3	10	0	3	13	0	0
3	16018813	.	G	A	3	5	8	0	0	8	0	0
3	16019165	.	C	A	10	5	15	0	0	15	0	0
3	16019451	.	A	G	4	6	10	0	1	11	0	0
3	16019455	.	A	T	3	7	10	0	2	12	0	0
3	16019929	.	A	T	3	3	6	0	0	6	0	0
3	16020526	.	T	A	1	2	3	0	0	3	0	0
3	16020902	.	G	A	1	4	5	1	0	6	0	0
3	16021057	.	A	G	2	4	6	0	0	6	0	0
3	16021208	.	G	A	10	5	15	0	1	16	0	0
3	16021210	.	T	G	9	6	15	0	1	16	0	0
3	16021244	.	G	A	5	8	13	0	0	13	0	0
3	16021397	.	C	T	10	9	19	0	0	19	0	0
3	16021491	.	T	C	6	6	12	2	0	14	0	0
3	16021531	.	C	T	4	6	10	2	0	12	0	0
3	16021723	.	T	A	5	3	8	0	0	8	0	0
3	16021820	.	G	A	2	4	6	0	0	6	0	0
3	16021960	.	C	T	5	5	10	0	0	10	0	0
3	16022076	.	C	T	1	4	5	0	14	19	0	0
3	16024429	.	C	T	8	6	14	0	0	14	0	0
3	16024459	.	G	A	6	6	12	0	0	12	0	0
3	16024501	.	C	A	8	6	14	0	0	14	0	0
3	16035067	.	T	G	6	5	11	0	0	11	0	0
3	16039493	.	G	A	9	10	19	0	0	19	0	0
3	16045215	.	G	A	12	16	28	0	8	36	0	0
3	16045404	.	A	C	43	33	76	0	0	76	0	0
3	16045544	.	A	G	42	27	69	2	2	73	0	0
3	16045569	.	C	G	45	24	69	2	1	72	0	0
3	16045592	.	T	A	43	22	65	1	1	67	0	0
3	16068159	.	T	G	22	21	43	0	3	46	0	0
3	16073274	.	A	T	19	19	38	0	0	39	1	0
3	16073434	.	A	C	17	1	18	0	16	34	0	0
3	16073453	.	G	A	18	18	36	0	0	36	0	0
3	16073481	.	C	T	22	13	35	0	2	37	0	0
3	16073547	.	C	T	21	17	38	0	2	40	0	0
3	16073594	.	C	T	2	20	22	0	30	52	0	0
3	16073991	.	G	A	27	27	54	0	9	63	0	0
3	16074016	.	T	A	30	26	56	0	5	61	0	0
3	16074031	.	G	A	27	22	49	0	2	51	0	0
3	16074141	.	G	T	34	25	59	0	3	62	0	0
3	16074155	.	G	A	34	18	52	0	6	58	0	0
3	16074340	.	C	G	32	27	59	0	2	61	0	0
3	16074376	.	C	T	4	27	31	0	26	57	0	0
3	16134797	.	C	G	0	6	6	1	5	12	0	0
3	16134798	.	C	G	7	5	12	1	0	13	0	0
3	16138950	.	C	G	12	10	22	0	0	22	0	0
3	16141709	.	A	T	4	7	11	0	0	11	0	0
3	16141725	.	C	T	8	4	12	0	0	12	0	0
3	16141803	.	C	T	6	4	10	1	0	11	0	0
3	16141828	.	C	A	0	4	4	2	5	11	0	0
3	16141870	.	C	T	3	7	10	2	0	12	0	0
3	16157194	.	A	G	5	5	10	0	0	10	0	0
3	16157220	.	T	G	9	5	14	0	0	14	0	0
3	16157243	.	T	A	8	9	17	0	1	18	0	0
3	16157328	.	G	T	13	19	32	0	2	34	0	0
3	16161653	.	G	T	19	11	30	0	6	36	0	0
3	16165135	.	T	C	8	11	19	0	1	20	0	0
3	16171589	.	G	A	16	8	24	0	0	24	0	0
3	16191248	.	C	T	6	9	15	0	1	16	0	0
3	16227536	.	A	C	11	13	24	0	0	24	0	0
3	16241142	.	T	A	1	2	3	0	1	4	0	0
3	16241621	.	A	G	3	4	7	0	0	7	0	0
3	16241695	.	A	G	1	5	6	0	0	6	0	0
3	16245299	.	G	A	2	2	4	0	0	4	0	0
3	16257552	.	T	C	2	0	2	0	5	7	0	0
3	16275821	.	A	T	4	2	6	0	0	6	0	0
3	16276446	.	G	A	2	2	4	0	0	4	0	0
3	16282144	.	G	A	2	4	6	0	0	6	0	0
3	16282145	.	G	A	2	4	6	0	0	6	0	0
3	16282198	.	T	G	4	3	7	0	3	10	0	0
3	16282254	.	C	G	1	4	5	0	1	6	0	0
3	16282838	.	T	C	2	3	5	0	0	5	0	0
3	16283243	.	C	A	2	3	5	0	0	5	0	0
3	16283389	.	G	A	3	5	8	0	0	8	0	0
3	16283791	.	T	A	5	6	11	0	0	11	0	0
3	16283797	.	T	C	6	3	9	0	0	9	0	0
3	16283872	.	A	G	5	2	7	2	0	9	0	0
3	16283989	.	G	T	10	5	15	0	0	15	0	0
3	16284258	.	C	T	2	5	7	0	0	7	0	0
3	16284475	.	T	C	4	3	7	0	0	7	0	0
3	16284492	.	G	T	6	2	8	0	0	8	0	0
3	16637877	.	G	A	12	17	29	1	3	33	0	0
3	16644872	.	C	T	20	18	38	0	0	38	0	0
3	16645507	.	A	C	25	23	48	0	0	48	0	0
3	16646520	.	A	G	18	23	41	0	1	42	0	0
3	16646562	.	T	C	12	21	33	0	2	35	0	0
3	16650129	.	G	A	16	7	23	0	1	24	0	0
3	16652265	.	C	T	19	17	36	1	0	37	0	0
3	16664530	.	C	T	8	6	14	0	0	14	0	0
3	16668614	.	G	A	2	8	10	0	6	16	0	0
3	16670880	.	T	G	10	1	11	0	12	23	0	0
3	16671831	.	A	G	18	0	18	0	11	29	0	0
3	16671849	.	A	G	15	0	15	0	14	29	0	0
3	16671903	.	G	A	2	10	12	0	14	26	0	0
3	16679794	.	A	G	4	2	6	0	0	6	0	0
3	16719180	.	G	A	1	3	4	0	0	4	0	0
3	16731938	.	A	G	10	0	10	0	10	20	0	0
3	16746036	.	T	C	18	7	25	0	1	26	0	0
3	16746153	.	A	C	10	23	33	0	1	34	0	0
3	16746659	.	A	T	2	3	5	0	0	5	0	0
3	16746666	.	T	C	2	3	5	0	0	5	0	0
3	16746718	.	T	A	6	2	8	0	0	8	0	0
3	16746756	.	G	A	7	6	13	0	0	13	0	0
3	16746782	.	A	G	6	4	10	0	0	10	0	0
3	16746849	.	C	A	10	5	15	0	0	15	0	0
3	16746871	.	T	G	10	6	16	0	0	16	0	0
3	16747148	.	T	C	10	6	16	0	1	17	0	0
3	16841984	.	C	A	2	4	6	0	0	6	0	0
3	16842343	.	G	A	4	4	8	0	0	8	0	0
3	16871826	.	C	T	2	2	4	0	0	4	0	0
3	16872084	.	A	G	3	1	4	0	1	5	0	0
3	16872131	.	A	C	4	2	6	0	0	6	0	0
3	16872179	.	G	T	3	4	7	0	0	7	0	0
3	16872200	.	C	T	2	2	4	0	0	4	0	0
3	16872508	.	G	T	3	8	11	0	0	11	0	0
3	16872572	.	T	C	3	8	11	0	0	11	0	0
3	16872634	.	A	G	3	4	7	0	0	7	0	0
3	16961428	.	C	T	5	4	9	0	0	9	0	0
3	16961455	.	T	C	3	2	5	0	1	6	0	0
3	16972991	.	T	C	2	2	4	0	1	5	0	0
3	17070217	.	T	C	5	2	7	0	2	9	0	0
3	17078552	.	C	T	3	3	6	0	0	6	0	0
3	17090749	.	T	C	3	7	10	0	0	10	0	0
3	17090941	.	G	A	3	8	11	0	1	12	0	0
3	17090956	.	T	C	4	8	12	0	1	13	0	0
3	17093097	.	T	C	13	12	25	0	0	25	0	0
3	17104220	.	T	C	9	6	15	0	0	15	0	0
3	17289515	.	G	A	0	2	2	0	1	3	0	0
3	17457550	.	G	T	3	2	5	0	0	5	0	0
3	17458054	.	C	T	2	4	6	0	0	6	0	0
3	17458120	.	T	C	2	3	5	0	0	5	0	0
3	17522960	.	A	G	1	1	2	0	12	14	0	0
3	17523058	.	T	G	1	2	3	0	2	5	0	0
3	17564259	.	C	T	1	2	3	0	0	3	0	0
3	17582229	.	C	G	1	3	4	0	0	4	0	0
3	17588449	.	C	T	3	2	5	0	0	5	0	0
3	17593480	.	C	T	3	3	6	0	0	6	0	0
3	17600108	.	G	T	0	6	6	0	2	8	0	0
3	17600702	.	C	T	4	2	6	0	0	6	0	0
3	17600849	.	A	G	1	0	1	0	2	3	0	0
3	17600870	.	A	T	3	2	5	0	0	5	0	0
3	17600916	.	T	C	2	4	6	0	0	6	0	0
3	17600994	.	T	C	1	4	5	0	0	5	0	0
3	17603512	.	T	C	1	3	4	0	0	4	0	0
3	17615630	.	A	C	8	4	12	0	2	14	0	0
3	17634816	.	T	C	21	27	48	0	2	50	0	0
3	17640544	.	C	T	18	22	40	0	1	41	0	0
3	17647236	.	T	C	14	24	38	0	3	41	0	0
3	17650732	.	A	G	26	20	46	0	3	49	0	0
3	17650927	.	C	G	15	22	37	0	1	38	0	0
3	17650983	.	G	A	20	19	39	0	1	40	0	0
3	17651072	.	A	G	21	0	21	0	24	45	0	0
3	17651208	.	C	A	21	18	39	0	1	40	0	0
3	17651382	.	C	T	10	4	14	0	0	14	0	0
3	17651508	.	G	A	22	12	34	0	3	37	0	0
3	17651847	.	C	A	7	10	17	0	1	18	0	0
3	17653813	.	A	T	6	3	9	0	1	10	0	0
3	17653924	.	T	C	4	7	11	0	0	11	0	0
3	17654944	.	T	C	1	7	8	0	0	8	0	0
3	17654983	.	A	T	2	7	9	0	0	9	0	0
3	17660084	.	A	G	5	5	10	0	0	10	0	0
3	17660156	.	C	T	7	11	18	0	1	19	0	0
3	17660204	.	T	C	4	11	15	0	0	15	0	0
3	17664912	.	G	C	5	5	10	0	0	10	0	0
3	17669427	.	A	G	2	10	12	0	0	12	0	0
3	17669484	.	T	C	6	6	12	0	0	12	0	0
3	17669502	.	T	A	4	6	10	0	0	10	0	0
3	17671567	.	C	T	3	6	9	0	1	10	0	0
3	17673157	.	G	C	6	8	14	0	0	14	0	0
3	17677237	.	G	T	14	4	18	0	1	19	0	0
3	17744438	.	T	A	7	8	15	0	0	15	0	0
3	17744491	.	C	T	6	5	11	0	1	12	0	0
3	17806557	.	G	C	13	7	20	0	3	24	1	0
3	17806561	.	G	A	0	8	8	0	14	22	0	0
3	17813564	.	A	G	6	0	6	0	16	22	0	0
3	17847103	.	T	G	11	17	28	0	1	29	0	0
3	17853383	.	T	C	13	9	22	0	0	22	0	0
3	17853488	.	C	T	15	11	26	0	0	26	0	0
3	17867668	.	T	A	11	6	17	0	1	18	0	0
3	17867683	.	T	A	8	6	14	0	0	14	0	0
3	17867748	.	T	C	2	4	6	0	0	6	0	0
3	17867784	.	T	C	2	5	7	0	0	7	0	0
3	17867970	.	G	C	13	9	22	0	0	22	0	0
3	17868103	.	G	A	4	2	6	0	0	6	0	0
3	17868295	.	C	T	7	3	10	0	1	11	0	0
3	17868297	.	T	G	0	4	4	0	1	9	4	0
3	17868540	.	T	C	17	0	17	0	11	28	0	0
3	17868585	.	G	A	14	4	18	0	1	19	0	0
3	17868586	.	T	C	14	5	19	0	0	19	0	0
3	17868710	.	T	C	8	4	12	0	0	12	0	0
3	17868776	.	C	T	3	3	6	0	0	6	0	0
3	17868949	.	G	C	9	10	19	0	0	19	0	0
3	17869030	.	G	C	9	9	18	0	2	20	0	0
3	17878505	.	A	G	25	18	43	0	1	44	0	0
3	17894416	.	A	G	13	17	30	1	0	31	0	0
3	17896899	.	T	C	15	11	26	0	2	28	0	0
3	17896956	.	T	C	20	17	37	0	0	37	0	0
3	17897723	.	T	C	18	22	40	0	1	41	0	0
3	17899820	.	A	G	18	0	18	0	24	42	0	0
3	17902600	.	C	T	24	22	46	0	1	47	0	0
3	17907520	.	C	T	25	31	56	0	0	56	0	0
3	17907545	.	T	C	26	27	53	0	3	56	0	0
3	17907626	.	T	C	33	21	54	0	2	56	0	0
3	17907741	.	A	T	24	17	41	0	2	43	0	0
3	17907801	.	T	A	35	19	54	0	0	54	0	0
3	17907812	.	T	C	29	15	44	0	4	48	0	0
3	17907861	.	G	T	17	24	41	0	4	45	0	0
3	17907907	.	T	C	26	16	42	0	7	49	0	0
3	17907976	.	G	A	2	16	18	0	24	42	0	0
3	17908002	.	A	G	25	20	45	0	2	47	0	0
3	17908034	.	G	T	28	21	49	0	1	50	0	0
3	17908730	.	T	C	20	24	44	0	2	46	0	0
3	17939970	.	C	T	12	6	18	0	0	18	0	0
3	17940057	.	G	C	17	6	23	0	0	23	0	0
3	17940184	.	G	A	2	6	8	0	11	19	0	0
3	17940289	.	T	G	4	11	15	0	2	17	0	0
3	17942432	.	C	T	6	8	14	0	0	14	0	0
3	17942468	.	G	A	1	6	7	0	13	20	0	0
3	17942471	.	C	T	12	8	20	0	0	20	0	0
3	17942627	.	C	A	8	17	25	0	0	25	0	0
3	17942948	.	G	C	12	11	23	0	0	23	0	0
3	17943523	.	G	T	12	5	17	0	0	17	0	0
3	17943529	.	C	A	11	5	16	1	1	18	0	0
3	17943567	.	C	A	10	6	16	1	2	19	0	0
3	17943648	.	A	C	11	6	17	0	1	18	0	0
3	17943679	.	C	T	14	5	19	0	1	20	0	0
3	17944149	.	A	G	8	5	13	0	0	13	0	0
3	17967826	.	C	A	13	12	25	0	0	25	0	0
3	17967859	.	G	A	6	12	18	1	1	20	0	0
3	17967880	.	A	G	5	8	13	1	2	16	0	0
3	17967896	.	T	A	7	8	15	1	1	17	0	0
3	17984415	.	G	A	12	20	32	0	0	32	0	0
3	17986376	.	A	C	13	19	32	0	0	32	0	0
3	17988049	.	T	A	15	13	28	0	0	28	0	0
3	17991395	.	A	T	21	12	33	0	5	38	0	0
3	17991465	.	C	T	19	17	36	0	1	37	0	0
3	17991468	.	A	G	16	1	17	0	18	35	0	0
3	17993540	.	G	A	23	15	38	0	3	41	0	0
3	17993892	.	C	T	18	14	32	1	1	34	0	0
3	17995833	.	G	A	19	16	35	0	1	36	0	0
3	17995860	.	T	C	16	16	32	0	1	33	0	0
3	17996064	.	A	T	12	22	34	0	1	35	0	0
3	17996133	.	T	C	15	15	30	0	0	30	0	0
3	17999665	.	T	G	19	32	51	0	2	53	0	0
3	17999773	.	T	C	27	17	44	0	4	48	0	0
3	18002989	.	T	G	19	18	37	0	0	37	0	0
3	18004984	.	T	C	32	21	53	0	2	55	0	0
3	18004987	.	C	T	32	20	52	0	2	54	0	0
3	18006423	.	T	C	23	17	40	0	0	40	0	0
3	18007841	.	A	G	7	6	13	0	6	19	0	0
3	18007946	.	T	G	22	16	38	0	1	39	0	0
3	18008040	.	C	G	15	30	45	0	1	46	0	0
3	18008083	.	T	C	17	25	42	0	0	42	0	0
3	18008095	.	A	T	14	27	41	0	1	42	0	0
3	18008273	.	T	A	13	16	29	1	3	33	0	0
3	18008351	.	C	G	21	31	52	0	0	52	0	0
3	18008510	.	T	C	19	19	38	0	2	40	0	0
3	18008564	.	A	G	16	22	38	0	3	41	0	0
3	18008642	.	G	C	18	9	27	0	0	27	0	0
3	18008833	.	C	A	8	4	12	0	0	12	0	0
3	18008853	.	G	A	7	2	9	0	0	9	0	0
3	18056951	.	G	C	8	6	14	0	1	15	0	0
3	18059698	.	G	A	7	8	15	0	0	15	0	0
3	18060929	.	C	A	3	3	6	0	1	7	0	0
3	18061160	.	G	C	4	6	10	0	0	10	0	0
3	18061548	.	A	G	2	5	7	0	0	7	0	0
3	18063189	.	G	A	0	5	5	0	5	10	0	0
3	18069821	.	C	T	10	12	22	0	2	24	0	0
3	18070082	.	T	C	12	5	17	0	4	21	0	0
3	18079331	.	C	G	12	6	18	0	0	18	0	0
3	18079662	.	A	G	5	0	5	0	9	14	0	0
3	18079754	.	T	C	4	12	16	0	1	17	0	0
3	18079787	.	C	T	5	6	11	0	0	11	0	0
3	18080208	.	G	A	8	7	15	0	1	16	0	0
3	18103293	.	T	C	1	2	3	0	0	3	0	0
3	18186295	.	C	T	2	8	10	0	19	29	0	0
3	18189151	.	C	A	19	26	45	0	3	48	0	0
3	18189250	.	A	T	20	19	39	0	0	39	0	0
3	18303452	.	A	G	9	4	13	0	0	13	0	0
3	18303473	.	G	C	10	5	15	0	0	15	0	0
3	18303515	.	T	C	15	6	21	0	0	21	0	0
3	18303521	.	T	A	14	7	21	0	0	21	0	0
3	18322462	.	T	G	11	4	15	0	0	15	0	0
3	18325373	.	G	A	11	5	16	0	1	17	0	0
3	18333407	.	A	G	15	8	23	0	2	25	0	0
3	18333449	.	T	C	20	6	26	0	0	26	0	0
3	18333463	.	T	C	17	6	23	0	1	24	0	0
3	18349286	.	C	T	14	9	23	0	0	23	0	0
3	18349301	.	T	C	15	8	23	0	0	23	0	0
3	18376403	.	A	T	10	5	15	0	2	17	0	0
3	18376408	.	A	T	7	6	13	0	1	14	0	0
3	18376464	.	T	C	6	12	18	0	1	19	0	0
3	18377229	.	T	G	8	8	16	0	0	16	0	0
3	18377230	.	A	G	9	8	17	0	0	17	0	0
3	18377406	.	C	T	2	13	15	0	16	31	0	0
3	18377441	.	A	T	15	14	29	0	0	29	0	0
3	18377514	.	T	C	11	11	22	0	0	22	0	0
3	18377728	.	C	T	3	24	27	0	19	46	0	0
3	18379645	.	T	G	12	5	17	0	4	21	0	0
3	18383126	.	A	G	9	8	17	1	1	19	0	0
3	18383141	.	G	A	13	9	22	1	1	24	0	0
3	18384272	.	C	T	11	10	21	0	1	22	0	0
3	18384424	.	T	A	13	8	21	0	1	22	0	0
3	18384456	.	G	A	5	3	8	0	0	8	0	0
3	18399412	.	A	G	43	23	66	0	4	70	0	0
3	18399695	.	G	A	37	27	64	0	3	67	0	0
3	18400615	.	A	C	34	31	65	0	2	67	0	0
3	18400819	.	G	A	32	38	70	0	5	75	0	0
3	18405239	.	A	C	6	0	6	0	8	14	0	0
3	18407179	.	A	T	38	20	58	0	0	58	0	0
3	18407184	.	T	C	35	0	35	0	22	57	0	0
3	18409607	.	A	G	29	27	56	0	3	59	0	0
3	18409612	.	T	G	31	22	53	0	5	58	0	0
3	18410941	.	T	C	8	5	13	0	1	14	0	0
3	18435053	.	C	T	2	2	4	0	0	4	0	0
3	18435063	.	G	C	2	2	4	0	0	4	0	0
3	18435107	.	T	C	3	2	5	0	0	5	0	0
3	18447738	.	T	C	15	4	19	0	0	19	0	0
3	18448093	.	C	T	10	5	15	0	0	15	0	0
3	18448234	.	A	G	8	4	12	0	0	12	0	0
3	18448294	.	T	C	5	6	11	0	2	13	0	0
3	18468857	.	T	C	5	12	17	0	0	17	0	0
3	18468905	.	G	A	3	14	17	0	1	18	0	0
3	18468932	.	T	G	5	7	12	0	0	12	0	0
3	18469004	.	T	C	8	8	16	0	1	17	0	0
3	18473078	.	A	G	12	0	12	0	5	17	0	0
3	18487320	.	G	T	14	9	23	0	0	23	0	0
3	18498313	.	T	C	9	9	18	0	1	19	0	0
3	18498486	.	C	T	5	9	14	0	1	15	0	0
3	18498563	.	A	G	4	3	7	0	0	7	0	0
3	18561461	.	T	C	7	7	14	0	0	14	0	0
3	18562193	.	T	C	6	8	14	0	0	14	0	0
3	18562235	.	G	A	6	3	9	0	0	9	0	0
3	18562418	.	T	C	11	5	16	0	0	16	0	0
3	18562584	.	T	C	2	4	6	0	0	6	0	0
3	18562655	.	T	C	3	3	6	0	0	6	0	0
3	18562656	.	T	C	3	2	5	0	1	6	0	0
3	18563136	.	C	T	5	5	10	0	0	10	0	0
3	18563143	.	G	T	4	5	9	0	0	9	0	0
3	18563512	.	A	T	2	5	7	0	0	7	0	0
3	18563779	.	T	C	1	2	3	0	0	3	0	0
3	18568896	.	G	A	12	6	18	0	0	18	0	0
3	18569080	.	C	A	6	4	10	0	0	10	0	0
3	18569431	.	G	A	1	3	4	0	0	4	0	0
3	18569617	.	T	G	4	2	6	0	0	6	0	0
3	18569659	.	G	C	11	4	15	0	1	16	0	0
3	18569699	.	C	A	11	4	15	0	0	15	0	0
3	18569905	.	A	C	5	2	7	0	1	8	0	0
3	18570029	.	A	T	6	6	12	0	0	12	0	0
3	18570041	.	G	T	0	8	8	0	6	14	0	0
3	18570142	.	T	C	4	2	6	1	0	7	0	0
3	18570434	.	A	C	2	11	13	0	0	13	0	0
3	18570683	.	G	C	5	4	9	0	0	9	0	0
3	18570696	.	G	A	3	2	5	0	1	6	0	0
3	18570730	.	C	A	3	3	6	0	0	6	0	0
3	18570759	.	A	G	5	4	9	0	1	10	0	0
3	18570815	.	G	A	4	4	8	0	0	8	0	0
3	18650395	.	G	A	1	2	3	0	0	3	0	0
3	18650458	.	A	T	1	2	3	0	0	3	0	0
3	18676153	.	C	T	3	5	8	0	1	9	0	0
3	18676186	.	G	A	7	7	14	0	0	14	0	0
3	18676190	.	T	A	8	6	14	0	1	15	0	0
3	18676224	.	A	T	7	5	12	0	1	13	0	0
3	18676953	.	T	C	1	5	6	0	0	6	0	0
3	18677047	.	A	T	3	5	8	0	1	9	0	0
3	18677077	.	A	G	7	11	18	0	0	18	0	0
3	18677171	.	C	T	20	17	37	0	2	39	0	0
3	18677314	.	C	T	12	8	20	0	0	20	0	0
3	18677389	.	G	T	20	10	30	0	0	30	0	0
3	18680023	.	A	C	15	13	28	0	1	29	0	0
3	18685468	.	A	T	22	27	49	0	3	52	0	0
3	18685471	.	T	A	22	28	50	0	2	52	0	0
3	18685669	.	T	C	15	19	34	0	3	37	0	0
3	18685762	.	C	G	2	12	14	0	20	34	0	0
3	18685918	.	T	C	24	18	42	0	3	45	0	0
3	18686542	.	T	C	18	20	38	0	1	39	0	0
3	18686740	.	T	G	2	0	2	0	9	11	0	0
3	18686781	.	T	C	16	0	16	0	17	33	0	0
3	18687899	.	G	T	7	8	15	0	0	15	0	0
3	18688780	.	G	A	13	12	25	0	0	25	0	0
3	18688852	.	A	G	8	11	19	0	0	19	0	0
3	18689384	.	C	T	1	20	21	1	11	33	0	0
3	18692264	.	C	T	11	8	19	0	1	20	0	0
3	18694054	.	T	C	12	0	12	0	15	27	0	0
3	18702639	.	T	C	3	7	10	0	0	10	0	0
3	18702657	.	T	G	3	10	13	0	0	13	0	0
3	18704081	.	C	A	9	4	13	0	0	13	0	0
3	18704114	.	T	A	12	5	17	0	0	17	0	0
3	18704195	.	A	C	7	0	7	0	4	11	0	0
3	18708094	.	C	T	1	10	11	0	8	19	0	0
3	18708095	.	G	A	8	10	18	0	1	19	0	0
3	18710296	.	A	G	10	9	19	0	0	19	0	0
3	18710326	.	G	A	9	6	15	0	0	15	0	0
3	18720511	.	A	G	4	5	9	0	1	10	0	0
3	18720719	.	A	G	4	6	10	0	0	10	0	0
3	18720949	.	G	A	4	5	9	0	0	9	0	0
3	18723030	.	G	A	4	1	5	0	0	5	0	0
3	18723036	.	T	C	4	2	6	0	0	6	0	0
3	18723095	.	A	G	7	4	11	1	0	12	0	0
3	18732955	.	A	T	4	4	8	0	0	8	0	0
3	18732969	.	G	C	3	7	10	0	0	10	0	0
3	18760534	.	T	C	6	6	12	0	1	13	0	0
3	18760539	.	G	A	0	6	6	0	7	13	0	0
3	18765436	.	T	C	3	4	7	0	0	7	0	0
3	18768933	.	T	C	4	7	11	0	0	11	0	0
3	18769081	.	T	C	8	8	16	0	0	16	0	0
3	18769165	.	T	C	3	4	7	0	2	9	0	0
3	18769436	.	G	C	4	2	6	0	0	6	0	0
3	18769741	.	G	A	7	4	11	0	0	11	0	0
3	18774922	.	T	A	6	7	13	0	0	13	0	0
3	18775305	.	C	A	16	17	33	0	2	35	0	0
3	18777284	.	T	C	17	14	31	0	0	31	0	0
3	18778996	.	A	T	10	14	24	0	3	27	0	0
3	18787884	.	G	A	17	13	30	0	0	30	0	0
3	18795907	.	G	T	2	6	8	0	4	12	0	0
3	18795938	.	T	A	4	8	12	0	0	12	0	0
3	18796218	.	C	T	2	6	8	0	0	8	0	0
3	18798491	.	T	C	1	3	4	0	0	4	0	0
3	18798523	.	G	A	1	4	5	0	0	5	0	0
3	18807519	.	C	G	2	2	4	0	0	4	0	0
3	18817622	.	T	C	5	3	8	0	1	9	0	0
3	18818368	.	G	A	4	5	9	0	0	9	0	0
3	18818395	.	G	A	2	7	9	0	3	12	0	0
3	18818893	.	T	C	3	5	8	0	0	8	0	0
3	18818929	.	C	T	8	6	14	0	0	14	0	0
3	18818962	.	A	G	9	8	17	0	0	17	0	0
3	18819979	.	T	C	9	4	13	0	0	13	0	0
3	18821163	.	C	T	11	4	15	0	1	16	0	0
3	18823027	.	T	C	11	7	18	0	1	19	0	0
3	18823331	.	T	C	8	10	18	0	1	19	0	0
3	18827249	.	G	T	12	11	23	0	0	23	0	0
3	18827491	.	T	C	15	11	26	0	1	27	0	0
3	18827509	.	G	A	18	11	29	0	0	29	0	0
3	18833001	.	G	A	2	6	8	0	17	25	0	0
3	18833016	.	C	T	18	9	27	0	0	27	0	0
3	18835665	.	C	T	7	11	18	0	1	19	0	0
3	18835852	.	C	G	4	9	13	0	0	13	0	0
3	18836023	.	T	C	8	12	20	0	1	21	0	0
3	18836289	.	C	G	9	6	15	0	0	15	0	0
3	18836316	.	G	A	7	3	10	0	1	11	0	0
3	18836518	.	C	T	7	3	10	1	1	12	0	0
3	18836857	.	A	T	8	4	12	0	0	12	0	0
3	18836935	.	T	G	3	10	13	0	0	13	0	0
3	18836986	.	C	A	4	2	6	0	0	6	0	0
3	18836995	.	C	T	3	3	6	0	1	7	0	0
3	18837029	.	G	A	4	4	8	0	0	8	0	0
3	18837095	.	A	T	4	12	16	0	0	16	0	0
3	18837111	.	G	A	0	10	10	0	5	15	0	0
3	18837456	.	G	A	11	4	15	0	0	15	0	0
3	18837887	.	G	A	2	10	12	0	16	28	0	0
3	18837917	.	A	T	15	8	23	0	0	23	0	0
3	18837995	.	C	T	9	4	13	0	0	13	0	0
3	18838097	.	A	C	7	7	14	0	1	15	0	0
3	18838559	.	T	A	5	8	13	0	0	13	0	0
3	18839017	.	C	T	6	3	9	0	0	9	0	0
3	18840990	.	G	A	4	2	6	0	0	6	0	0
3	18840996	.	A	G	4	2	6	0	0	6	0	0
3	18841069	.	A	T	1	3	4	0	0	4	0	0
3	18846562	.	C	T	4	3	7	0	1	8	0	0
3	20108790	.	T	C	26	14	40	3	0	43	0	0
3	20109247	.	T	C	19	1	20	0	8	28	0	0
3	20110268	.	T	C	27	14	41	0	0	41	0	0
3	20110269	.	T	C	29	12	41	0	1	42	0	0
3	21888977	.	A	G	3	3	6	0	0	6	0	0
3	21889223	.	A	G	5	2	7	0	0	7	0	0
3	21889336	.	A	G	5	4	9	0	0	9	0	0
3	21889443	.	A	G	1	5	6	0	0	6	0	0
3	22154352	.	A	G	9	3	12	0	0	12	0	0
3	22154368	.	A	G	6	6	12	0	0	12	0	0
3	22154467	.	A	G	16	6	22	0	1	23	0	0
3	22154474	.	A	G	13	6	19	0	4	23	0	0
3	22154554	.	A	G	24	5	29	0	1	30	0	0
3	22160938	.	T	A	15	4	19	0	1	20	0	0
3	23488794	.	T	A	15	10	25	0	0	25	0	0
3	23488816	.	T	C	9	15	24	0	1	25	0	0
3	23492529	.	A	T	13	12	25	0	1	26	0	0
3	23493864	.	C	T	25	25	50	0	0	50	0	0
3	23494015	.	G	A	2	16	18	0	27	45	0	0
3	23494216	.	T	C	22	23	45	0	1	46	0	0
3	23494780	.	A	G	12	16	28	0	0	28	0	0
3	23494805	.	G	A	1	14	15	0	10	25	0	0
3	23495767	.	T	C	17	17	34	0	1	35	0	0
3	23495872	.	T	C	8	9	17	0	1	18	0	0
3	23495905	.	G	T	5	6	11	0	1	12	0	0
3	23584052	.	G	A	5	4	9	0	0	9	0	0
3	23584128	.	G	A	6	3	9	0	0	9	0	0
3	23584173	.	G	C	8	9	17	0	1	18	0	0
3	23584703	.	A	T	6	11	17	0	0	17	0	0
3	23584704	.	T	A	6	11	17	0	0	17	0	0
3	23584748	.	C	A	9	8	17	0	1	18	0	0
3	23584977	.	A	C	7	6	13	0	0	13	0	0
3	23585082	.	T	A	6	4	10	0	3	13	0	0
3	23585197	.	T	A	11	8	19	0	1	20	0	0
3	23585253	.	T	A	14	13	27	0	0	27	0	0
3	23585442	.	G	T	11	10	21	0	2	23	0	0
3	23592988	.	G	T	13	12	25	0	0	25	0	0
3	23596401	.	G	A	11	9	20	0	1	21	0	0
3	23596632	.	G	C	16	15	31	0	0	31	0	0
3	23596791	.	T	A	18	19	37	0	2	39	0	0
3	23599443	.	G	T	28	30	58	0	1	59	0	0
3	23689526	.	G	A	2	4	6	0	0	6	0	0
3	23705327	.	T	G	2	0	2	0	5	7	0	0
3	23708080	.	G	A	2	10	12	0	27	39	0	0
3	23709399	.	A	G	2	0	2	0	7	9	0	0
3	23710000	.	G	T	2	2	4	0	0	4	0	0
3	23731118	.	G	A	4	2	6	0	0	6	0	0
3	24065389	.	A	T	14	8	22	0	0	22	0	0
3	24065395	.	A	G	12	10	22	0	1	23	0	0
3	24065437	.	C	T	19	13	32	0	1	33	0	0
3	24067629	.	A	T	14	17	31	0	2	33	0	0
3	24070118	.	C	T	10	10	20	0	0	20	0	0
3	24070251	.	T	C	13	11	24	0	0	24	0	0
3	24070336	.	G	A	8	6	14	0	0	14	0	0
3	24070815	.	G	T	11	3	14	0	0	14	0	0
3	24071108	.	T	C	4	6	10	0	2	12	0	0
3	24071163	.	G	A	9	7	16	0	0	16	0	0
3	24071294	.	A	T	14	9	23	0	0	23	0	0
3	24072783	.	G	T	1	2	3	0	1	4	0	0
3	24074177	.	C	T	0	2	2	0	1	3	0	0
3	24096191	.	C	T	16	9	25	0	1	26	0	0
3	24109865	.	T	A	5	4	9	0	1	10	0	0
3	24110160	.	T	C	4	0	4	0	0	7	3	0
3	24110213	.	T	A	1	2	3	0	0	3	0	0
3	24110822	.	C	T	7	7	14	1	0	15	0	0
3	24111129	.	T	C	7	5	12	0	1	13	0	0
3	24111135	.	A	G	7	5	12	0	0	12	0	0
3	24142965	.	C	T	15	10	25	0	0	25	0	0
3	24143468	.	C	T	4	5	9	0	0	9	0	0
3	24143497	.	T	A	3	4	7	0	0	7	0	0
3	24144037	.	A	G	8	4	12	0	0	12	0	0
3	24144716	.	C	T	4	2	6	0	0	6	0	0
3	24144729	.	T	C	3	1	4	1	0	5	0	0
3	24144773	.	G	A	2	4	6	1	0	7	0	0
3	24196284	.	G	T	2	3	5	0	0	5	0	0
3	24197954	.	G	A	4	2	6	0	0	6	0	0
3	24199073	.	T	G	31	2	33	0	35	68	0	0
3	24199154	.	T	C	17	32	49	0	6	55	0	0
3	24199577	.	T	C	31	32	63	0	6	69	0	0
3	24199689	.	T	C	30	36	66	0	1	67	0	0
3	24200287	.	T	A	38	30	68	0	1	69	0	0
3	24200563	.	T	A	11	7	18	0	1	19	0	0
3	24200578	.	C	T	10	10	20	0	4	24	0	0
3	24200643	.	C	T	8	4	12	0	0	12	0	0
3	24200645	.	A	G	7	4	11	0	1	12	0	0
3	24200768	.	G	T	5	2	7	0	1	8	0	0
3	24203272	.	C	T	8	7	15	0	0	15	0	0
3	24203310	.	A	G	7	7	14	0	0	14	0	0
3	24203513	.	G	A	13	5	18	0	0	18	0	0
3	24203584	.	C	T	6	7	13	0	0	13	0	0
3	24203588	.	T	C	6	5	11	0	0	11	0	0
3	24203735	.	G	A	8	3	11	0	0	11	0	0
3	24207449	.	T	C	3	10	13	0	0	13	0	0
3	24209715	.	T	A	8	10	18	0	2	20	0	0
3	24209792	.	G	A	4	9	13	0	1	14	0	0
3	24209852	.	T	C	6	12	18	0	0	18	0	0
3	24211740	.	A	G	8	5	13	0	0	13	0	0
3	24211741	.	A	C	7	5	12	0	0	12	0	0
3	24212197	.	T	G	5	11	16	0	0	16	0	0
3	24216029	.	A	G	5	7	12	0	0	12	0	0
3	24216161	.	T	C	9	11	20	0	0	20	0	0
3	24218564	.	A	C	3	4	7	0	0	7	0	0
3	24295149	.	A	G	4	5	9	0	0	9	0	0
3	24295157	.	C	A	5	5	10	0	0	10	0	0
3	24295562	.	G	T	3	5	8	0	0	8	0	0
3	24361132	.	C	T	24	19	43	1	2	46	0	0
3	24361245	.	T	C	26	30	56	2	0	58	0	0
3	24361257	.	T	C	26	30	56	0	1	58	1	0
3	24433057	.	C	A	32	34	66	0	1	67	0	0
3	24434494	.	T	A	44	25	69	0	5	74	0	0
3	24434833	.	C	A	14	12	26	0	1	27	0	0
3	24438441	.	T	A	1	2	3	0	0	3	0	0
3	24463746	.	A	C	1	2	3	0	3	6	0	0
3	24483064	.	C	A	16	30	46	0	0	46	0	0
3	24483259	.	G	A	3	17	20	0	18	38	0	0
3	24483322	.	C	T	24	25	49	0	0	49	0	0
3	24487821	.	A	G	26	23	49	0	3	52	0	0
3	24487905	.	A	G	15	20	35	0	2	37	0	0
3	24489838	.	A	G	31	14	45	0	3	48	0	0
3	24517152	.	C	T	1	2	3	0	0	3	0	0
3	24517173	.	A	T	1	2	3	0	0	3	0	0
3	24518388	.	A	G	3	2	5	0	1	6	0	0
3	24518414	.	T	G	3	2	5	0	0	5	0	0
3	24518459	.	T	C	2	3	5	0	1	6	0	0
3	24518471	.	T	C	2	5	7	0	0	7	0	0
3	24577171	.	A	C	3	2	5	0	0	5	0	0
3	24577817	.	G	A	2	3	5	0	0	5	0	0
3	24577835	.	A	G	2	2	4	0	0	4	0	0
3	24682798	.	A	T	2	4	6	0	0	6	0	0
3	24684339	.	C	T	1	3	4	0	0	4	0	0
3	24691685	.	C	T	3	2	5	0	1	6	0	0
3	24691714	.	A	T	2	2	4	0	0	4	0	0
3	24692005	.	G	T	0	7	7	0	2	9	0	0
3	24692014	.	T	C	2	7	9	0	0	9	0	0
3	24708699	.	G	T	1	3	4	0	0	4	0	0
3	24763271	.	A	G	2	3	5	0	0	5	0	0
3	24763427	.	A	T	1	4	5	0	0	5	0	0
3	24763520	.	A	G	3	0	3	0	4	7	0	0
3	24763903	.	A	C	1	2	3	0	0	3	0	0
3	24764263	.	G	A	1	2	3	0	0	3	0	0
3	24764736	.	A	T	2	4	6	0	0	6	0	0
3	24764836	.	A	T	1	3	4	0	0	4	0	0
3	24764877	.	G	T	2	4	6	0	0	6	0	0
3	24764933	.	T	A	6	2	8	0	1	9	0	0
3	24764940	.	A	G	6	2	8	0	0	8	0	0
3	24765011	.	C	T	3	2	5	0	0	5	0	0
3	24765117	.	C	G	2	5	7	0	0	7	0	0
3	24904147	.	C	T	0	2	2	0	1	3	0	0
3	24904262	.	C	A	2	2	4	0	0	4	0	0
3	24904277	.	A	G	4	2	6	0	0	6	0	0
3	24973667	.	T	A	17	12	29	0	2	31	0	0
3	24990746	.	A	C	16	29	45	0	4	49	0	0
3	24993349	.	G	A	5	37	42	1	21	64	0	0
3	24993449	.	G	A	16	32	48	0	1	49	0	0
3	24993663	.	G	A	29	14	43	0	1	44	0	0
3	24993682	.	A	G	28	17	45	0	3	48	0	0
3	24993791	.	G	A	1	30	31	0	23	54	0	0
3	24994253	.	T	C	18	25	43	0	2	45	0	0
3	24997955	.	A	T	7	13	20	0	1	21	0	0
3	24998797	.	C	T	14	8	22	0	1	23	0	0
3	24998977	.	G	T	11	13	24	0	0	24	0	0
3	24999094	.	T	C	6	5	11	0	6	17	0	0
3	24999259	.	G	A	11	11	22	0	0	22	0	0
3	24999358	.	T	G	9	7	16	0	2	18	0	0
3	24999601	.	C	T	2	11	13	0	12	25	0	0
3	24999636	.	A	C	16	14	30	0	1	32	1	0
3	24999916	.	A	G	16	11	27	0	0	27	0	0
3	24999967	.	A	G	14	9	23	0	0	23	0	0
3	25000417	.	C	A	0	14	14	0	9	23	0	0
3	25005814	.	A	C	7	5	12	0	0	12	0	0
3	25024580	.	C	T	5	7	12	0	0	12	0	0
3	25027685	.	A	G	4	5	9	0	0	9	0	0
3	25030198	.	G	T	5	8	13	0	0	13	0	0
3	25030209	.	C	A	6	8	14	0	0	14	0	0
3	25030431	.	C	T	7	5	12	0	0	12	0	0
3	25030809	.	C	T	3	4	7	0	1	8	0	0
3	25031999	.	G	A	1	4	5	0	0	5	0	0
3	25033548	.	C	T	6	8	14	0	0	14	0	0
3	25033581	.	G	A	9	5	14	0	0	14	0	0
3	25033623	.	T	C	11	4	15	0	1	16	0	0
3	25039367	.	C	G	5	4	9	0	0	9	0	0
3	25039390	.	T	C	7	3	10	0	0	10	0	0
3	25040812	.	G	A	8	3	11	0	0	11	0	0
3	25046097	.	A	G	2	3	5	0	1	6	0	0
3	25046136	.	A	G	3	8	11	0	1	12	0	0
3	25046205	.	G	A	5	2	7	0	0	7	0	0
3	25051437	.	A	G	5	3	8	0	0	8	0	0
3	25059662	.	T	A	1	2	3	0	0	3	0	0
3	25059690	.	A	G	2	2	4	0	1	5	0	0
3	25059864	.	T	A	3	4	7	0	1	8	0	0
3	25060009	.	C	T	3	5	8	0	1	9	0	0
3	25075675	.	T	C	2	4	6	0	0	6	0	0
3	25080982	.	G	T	2	10	12	0	1	13	0	0
3	25081126	.	T	G	3	4	7	0	0	7	0	0
3	25086740	.	T	A	1	4	5	0	0	5	0	0
3	25086904	.	A	G	2	6	8	0	0	8	0	0
3	25094623	.	G	A	2	21	23	0	19	42	0	0
3	25097047	.	C	A	32	20	52	0	6	58	0	0
3	25099018	.	A	G	31	19	50	1	1	52	0	0
3	25099988	.	T	A	24	22	46	0	2	48	0	0
3	25100004	.	A	G	26	14	40	0	3	43	0	0
3	25100159	.	A	G	17	14	31	0	2	33	0	0
3	25100182	.	A	T	23	18	41	0	0	41	0	0
3	25100260	.	A	G	16	24	40	0	4	44	0	0
3	25100311	.	C	G	14	25	39	0	0	39	0	0
3	25100430	.	T	C	22	22	44	0	4	48	0	0
3	25100535	.	G	T	13	13	26	0	1	27	0	0
3	25100565	.	T	G	5	1	6	0	10	16	0	0
3	25100673	.	G	T	1	2	3	0	0	3	0	0
3	25100691	.	C	G	1	1	2	0	1	3	0	0
3	25102121	.	C	T	23	26	49	0	0	49	0	0
3	25107705	.	T	C	24	23	47	0	1	48	0	0
3	25107729	.	A	T	19	15	34	0	0	34	0	0
3	25132922	.	A	G	2	2	4	0	0	4	0	0
3	25136479	.	C	T	1	3	4	0	8	12	0	0
3	25136571	.	G	A	5	4	9	0	0	9	0	0
3	25136655	.	T	A	10	3	13	0	1	14	0	0
3	25136781	.	T	G	11	4	15	0	0	15	0	0
3	25136819	.	T	G	8	3	11	0	1	12	0	0
3	25136855	.	G	T	6	3	9	0	0	9	0	0
3	25136868	.	A	G	8	4	12	0	0	12	0	0
3	25137144	.	G	T	6	5	11	0	1	12	0	0
3	25137339	.	A	G	3	4	7	0	0	7	0	0
3	25137418	.	T	A	1	3	4	0	0	4	0	0
3	25137605	.	C	T	1	2	3	0	0	3	0	0
3	25137706	.	A	G	1	3	4	0	0	4	0	0
3	25138114	.	A	G	9	11	20	0	0	20	0	0
3	25138264	.	G	T	11	9	20	0	1	21	0	0
3	25138306	.	C	T	11	10	21	0	0	21	0	0
3	25138624	.	G	A	1	5	6	0	0	6	0	0
3	25138668	.	G	A	4	3	7	0	0	7	0	0
3	25138804	.	C	G	1	7	8	0	7	15	0	0
3	25142371	.	T	A	3	6	9	0	0	9	0	0
3	25144109	.	T	C	12	6	18	0	2	20	0	0
3	25144211	.	A	G	6	6	12	0	0	12	0	0
3	25147990	.	C	G	0	5	5	0	3	8	0	0
3	25167117	.	T	C	8	3	11	0	0	11	0	0
3	25167162	.	A	G	8	11	19	0	0	19	0	0
3	25167168	.	C	T	7	12	19	0	1	20	0	0
3	25167238	.	C	A	4	5	9	0	0	10	1	0
3	25167332	.	A	C	6	7	13	0	1	14	0	0
3	25167351	.	A	C	10	6	16	0	0	16	0	0
3	25168882	.	T	C	13	8	21	0	0	21	0	0
3	25168907	.	A	T	13	8	21	0	0	21	0	0
3	25168994	.	C	T	10	11	21	0	0	21	0	0
3	25270048	.	G	T	18	10	28	2	1	31	0	0
3	25270320	.	A	G	26	28	54	3	13	70	0	0
3	25270515	.	G	A	30	40	70	0	4	74	0	0
3	25271209	.	T	A	26	39	65	0	1	66	0	0
3	25271653	.	T	C	32	19	51	0	2	53	0	0
3	25272051	.	T	A	39	33	72	0	3	75	0	0
3	25272623	.	C	T	22	40	62	0	6	68	0	0
3	25272653	.	T	C	34	35	69	0	2	71	0	0
3	25272859	.	T	A	35	33	68	0	3	71	0	0
3	25273524	.	G	C	24	37	61	0	3	64	0	0
3	25273648	.	A	G	29	32	61	0	3	64	0	0
3	25282004	.	C	T	0	5	5	0	1	6	0	0
3	25282135	.	T	C	4	0	4	0	6	10	0	0
3	25282348	.	T	C	7	10	17	0	0	17	0	0
3	25282387	.	T	G	10	9	19	0	1	20	0	0
3	25282422	.	A	G	15	13	28	0	0	28	0	0
3	25282928	.	G	A	11	3	14	0	0	14	0	0
3	25282979	.	T	C	10	14	24	0	0	24	0	0
3	25286050	.	G	A	16	8	24	0	4	28	0	0
3	25312797	.	C	A	12	9	21	0	0	22	1	0
3	25322673	.	G	A	8	7	15	0	0	15	0	0
3	25381494	.	G	A	16	14	30	0	1	31	0	0
3	25391167	.	G	A	16	13	29	0	0	29	0	0
3	25393509	.	G	C	14	13	27	0	2	29	0	0
3	25393602	.	T	A	16	19	35	0	5	40	0	0
3	25393641	.	C	T	1	13	14	0	28	42	0	0
3	25393677	.	A	C	15	0	15	0	25	40	0	0
3	25393707	.	A	C	14	0	14	1	28	43	0	0
3	25393785	.	C	T	15	16	31	0	9	40	0	0
3	25396597	.	C	T	3	14	17	0	26	44	1	0
3	25396731	.	G	A	23	19	42	0	0	42	0	0
3	25397899	.	C	T	11	11	22	0	0	22	0	0
3	25400320	.	C	T	14	11	25	0	0	25	0	0
3	25403685	.	G	A	9	7	16	0	0	16	0	0
3	25403812	.	G	C	6	8	14	0	0	14	0	0
3	25404444	.	G	T	9	6	15	0	0	15	0	0
3	25404591	.	G	A	12	11	23	0	0	23	0	0
3	25404618	.	T	C	8	11	19	0	2	21	0	0
3	25404626	.	G	T	10	10	20	0	1	21	0	0
3	25404699	.	G	A	7	8	15	0	0	15	0	0
3	25405033	.	C	T	3	2	5	0	0	5	0	0
3	25405540	.	T	C	12	10	22	0	0	22	0	0
3	25409114	.	A	T	6	3	9	0	1	10	0	0
3	25414648	.	T	C	8	6	14	0	1	15	0	0
3	25416925	.	A	G	8	8	16	0	0	16	0	0
3	25416928	.	T	C	8	9	17	0	0	17	0	0
3	25417237	.	A	T	3	4	7	0	1	8	0	0
3	25417255	.	A	G	6	3	9	0	0	9	0	0
3	25417327	.	T	C	5	7	12	0	0	12	0	0
3	25417408	.	G	A	4	5	9	0	0	9	0	0
3	25420829	.	C	A	8	8	16	1	1	18	0	0
3	25420845	.	T	C	9	11	20	1	0	21	0	0
3	25421239	.	T	A	1	2	3	0	0	3	0	0
3	25421283	.	C	T	2	2	4	0	0	4	0	0
3	25436085	.	A	C	12	23	35	0	2	37	0	0
3	25436370	.	G	A	9	4	13	0	0	13	0	0
3	25436439	.	G	C	11	4	15	0	0	15	0	0
3	25436440	.	C	T	2	4	6	0	9	15	0	0
3	25436493	.	T	A	11	7	18	0	0	18	0	0
3	25436561	.	A	G	18	12	30	0	2	32	0	0
3	25436620	.	A	G	18	12	30	0	1	31	0	0
3	25436631	.	T	C	19	0	19	0	12	31	0	0
3	25436830	.	T	C	10	5	15	0	0	15	0	0
3	25437017	.	G	A	5	10	15	0	0	15	0	0
3	25437451	.	A	G	25	17	42	0	1	43	0	0
3	25437517	.	G	A	18	18	36	1	0	37	0	0
3	25491134	.	A	G	13	9	22	0	0	22	0	0
3	25492299	.	A	G	16	10	26	0	0	26	0	0
3	25508913	.	C	T	1	2	3	0	0	3	0	0
3	25510044	.	C	T	4	1	5	0	0	5	0	0
3	25510068	.	C	T	2	2	4	0	1	5	0	0
3	25510091	.	T	C	6	1	7	0	0	7	0	0
3	25510465	.	A	G	6	3	9	0	0	9	0	0
3	25510531	.	T	C	5	4	9	0	0	9	0	0
3	25510782	.	A	G	1	0	1	0	2	3	0	0
3	25510832	.	T	A	1	4	5	0	0	5	0	0
3	25511057	.	G	C	2	2	4	0	0	4	0	0
3	25511071	.	A	T	2	2	4	0	0	4	0	0
3	25511435	.	T	C	1	3	4	0	0	4	0	0
3	25511506	.	A	T	6	3	9	0	0	9	0	0
3	25547772	.	A	G	2	3	5	0	0	5	0	0
3	25547835	.	T	C	1	2	3	0	0	3	0	0
3	25709176	.	T	A	4	9	13	0	0	13	0	0
3	25709242	.	A	G	6	5	11	0	1	12	0	0
3	25709515	.	A	G	2	4	6	3	0	9	0	0
3	25709844	.	T	C	4	0	4	2	4	10	0	0
3	25709859	.	C	T	3	3	6	2	1	9	0	0
3	25709914	.	A	G	4	7	11	0	0	11	0	0
3	25710190	.	G	A	3	2	5	0	0	5	0	0
3	25710444	.	A	T	3	3	6	0	0	6	0	0
3	25710551	.	T	G	4	4	8	0	0	8	0	0
3	25710591	.	G	A	5	3	8	0	0	8	0	0
3	25710632	.	A	T	5	6	11	0	0	11	0	0
3	25710753	.	G	C	4	2	6	0	0	6	0	0
3	25710758	.	C	A	0	1	1	0	5	6	0	0
3	25710799	.	C	G	5	4	9	0	0	9	0	0
3	25710828	.	A	C	6	4	10	0	1	11	0	0
3	25710886	.	A	C	6	4	10	0	0	10	0	0
3	25710891	.	T	G	9	0	9	0	1	10	0	0
3	25710952	.	A	G	6	5	11	0	0	11	0	0
3	25711321	.	A	G	2	4	6	0	0	6	0	0
3	25711329	.	G	A	2	5	7	0	0	7	0	0
3	25711551	.	T	G	6	4	10	0	0	10	0	0
3	25739022	.	C	T	6	3	9	0	1	10	0	0
3	25739042	.	T	G	8	6	14	0	0	14	0	0
3	25739060	.	T	A	6	5	11	0	1	12	0	0
3	25775004	.	T	G	2	4	6	0	0	6	0	0
3	25812638	.	A	G	4	3	7	0	0	7	0	0
3	25813178	.	G	A	1	1	2	0	1	3	0	0
3	25813214	.	A	C	1	0	1	0	4	5	0	0
3	25813253	.	A	C	4	0	4	0	7	11	0	0
3	25813286	.	G	A	4	5	9	0	0	9	0	0
3	25857125	.	A	C	6	5	11	0	0	11	0	0
3	25857144	.	G	A	0	6	6	0	5	11	0	0
3	25890275	.	T	C	3	4	7	0	0	7	0	0
3	25892553	.	A	G	4	6	10	0	2	12	0	0
3	25893017	.	G	T	4	2	6	0	0	6	0	0
3	25914122	.	G	T	13	10	23	0	1	24	0	0
3	25914125	.	T	C	16	8	24	0	1	25	0	0
3	25914386	.	A	C	8	10	18	0	0	18	0	0
3	25914415	.	C	T	11	6	17	0	2	19	0	0
3	25917795	.	C	T	4	8	12	0	1	13	0	0
3	25917972	.	A	T	9	13	22	0	0	22	0	0
3	25918090	.	G	A	17	8	25	0	0	25	0	0
3	25938298	.	C	T	14	13	27	0	2	29	0	0
3	25938375	.	T	C	14	11	25	0	0	25	0	0
3	25938377	.	T	C	12	11	23	0	1	24	0	0
3	25938793	.	A	C	5	6	11	0	1	12	0	0
3	25938950	.	G	T	6	5	11	0	0	11	0	0
3	25939068	.	T	G	2	3	5	0	2	7	0	0
3	25991709	.	T	C	2	2	4	0	0	4	0	0
3	25991802	.	G	A	3	3	6	0	0	6	0	0
3	25991805	.	A	T	4	2	6	0	0	6	0	0
3	25992741	.	T	C	6	2	8	0	0	8	0	0
3	25997862	.	A	T	4	2	6	0	0	6	0	0
3	26007942	.	G	A	0	2	2	0	1	3	0	0
3	26009102	.	A	G	4	2	6	0	1	7	0	0
3	26009129	.	C	T	4	1	5	0	1	6	0	0
3	26120598	.	C	A	3	2	5	2	0	7	0	0
3	26177633	.	G	A	5	2	7	0	0	7	0	0
3	27695326	.	A	G	3	0	3	0	6	9	0	0
3	27695413	.	A	G	4	2	6	0	0	6	0	0
3	27767182	.	A	G	15	5	20	0	0	20	0	0
3	27767208	.	A	G	13	4	17	0	5	22	0	0
3	27767284	.	A	G	6	16	22	0	2	24	0	0
3	27767288	.	A	G	14	8	22	0	1	23	0	0
3	27831388	.	A	G	3	3	6	0	0	6	0	0
3	27834134	.	T	C	30	8	38	0	0	38	0	0
3	27834412	.	T	C	23	14	37	0	4	41	0	0
3	27834552	.	T	C	8	11	19	0	0	19	0	0
3	27834563	.	T	C	16	6	22	0	1	23	0	0
3	27836036	.	T	C	9	13	22	0	2	24	0	0
3	28208772	.	C	A	1	5	6	0	0	6	0	0
3	28581572	.	C	T	4	2	6	0	0	6	0	0
3	28621247	.	C	T	6	2	8	0	0	8	0	0
3	28621351	.	C	T	5	8	13	0	1	14	0	0
3	28626340	.	A	C	5	6	11	0	0	11	0	0
3	28627044	.	T	A	7	6	13	0	0	13	0	0
3	28634485	.	T	A	18	6	24	0	1	25	0	0
3	28634549	.	A	G	19	13	32	0	1	33	0	0
3	28634883	.	C	A	15	10	25	0	8	33	0	0
3	28634884	.	A	C	9	18	27	0	5	32	0	0
3	28635106	.	G	A	14	19	33	0	3	36	0	0
3	28640608	.	C	T	3	19	22	0	21	43	0	0
3	28640734	.	G	A	15	12	27	0	0	27	0	0
3	28650721	.	T	C	14	0	14	0	15	29	0	0
3	28665218	.	T	C	20	11	31	0	0	31	0	0
3	28665239	.	G	A	18	8	26	0	0	26	0	0
3	28719103	.	G	A	1	3	4	0	0	4	0	0
3	28719506	.	C	G	8	8	16	0	0	16	0	0
3	28719592	.	T	G	6	7	13	0	1	14	0	0
3	28719636	.	T	A	9	7	16	0	0	16	0	0
3	28719649	.	C	T	9	8	17	1	0	18	0	0
3	28719730	.	G	T	6	8	14	0	0	14	0	0
3	28719852	.	T	C	4	9	13	0	0	13	0	0
3	28719878	.	G	A	4	11	15	0	1	16	0	0
3	28719905	.	C	A	0	8	8	0	6	14	0	0
3	28719971	.	C	A	1	5	6	0	3	9	0	0
3	28720010	.	G	A	5	5	10	0	0	10	0	0
3	28750223	.	G	T	10	4	14	0	0	14	0	0
3	28750376	.	A	C	6	2	8	0	0	8	0	0
3	28750377	.	G	C	6	2	8	0	0	8	0	0
3	29950927	.	T	C	9	8	17	0	1	18	0	0
3	29951384	.	T	C	20	9	29	0	0	29	0	0
3	30749508	.	T	C	7	0	7	0	9	16	0	0
3	30749541	.	G	A	7	8	15	0	0	15	0	0
3	30801282	.	G	A	13	10	23	0	0	23	0	0
3	30801297	.	G	T	10	9	19	0	1	20	0	0
3	30801370	.	T	C	9	0	9	0	8	17	0	0
3	30860896	.	A	T	5	7	12	0	1	13	0	0
3	30861043	.	G	A	4	3	7	0	1	8	0	0
3	30868853	.	T	G	8	13	21	0	0	21	0	0
3	30868855	.	T	C	7	13	20	0	1	21	0	0
3	30869205	.	A	G	8	11	19	0	0	19	0	0
3	30869206	.	C	T	8	8	16	0	3	19	0	0
3	30869662	.	C	T	8	7	15	0	0	15	0	0
3	30869728	.	C	T	0	9	9	0	7	16	0	0
3	30869938	.	A	G	8	4	12	0	0	12	0	0
3	30870382	.	T	G	5	4	9	0	2	11	0	0
3	30870409	.	G	A	8	5	13	0	0	13	0	0
3	30870508	.	G	A	5	4	9	0	0	9	0	0
3	30870838	.	T	A	5	4	9	0	0	10	1	0
3	30870974	.	A	C	5	8	13	0	1	14	0	0
3	30871021	.	G	T	5	6	11	0	1	12	0	0
3	30871478	.	A	T	5	6	11	0	0	11	0	0
3	30871873	.	C	G	0	4	4	0	4	8	0	0
3	30872004	.	C	T	8	3	11	0	0	11	0	0
3	30872264	.	T	G	11	11	22	0	0	22	0	0
3	30872608	.	C	T	0	3	3	0	5	8	0	0
3	30873029	.	G	A	6	6	12	0	0	12	0	0
3	30873048	.	G	A	4	6	10	0	1	11	0	0
3	30873102	.	T	C	3	5	8	0	0	8	0	0
3	30873165	.	C	T	6	7	13	0	0	13	0	0
3	30873185	.	A	T	6	4	10	0	0	10	0	0
3	30873408	.	T	C	5	3	8	0	0	8	0	0
3	30877163	.	C	T	2	4	6	0	0	6	0	0
3	30890630	.	T	A	6	8	14	0	1	15	0	0
3	30890869	.	G	A	18	27	45	0	1	46	0	0
3	30891201	.	A	G	24	18	42	0	4	46	0	0
3	30894281	.	A	G	12	14	26	0	2	28	0	0
3	30926689	.	A	G	7	5	12	0	0	12	0	0
3	30929960	.	G	A	2	3	5	0	0	5	0	0
3	30935001	.	A	G	2	3	5	0	0	5	0	0
3	30948173	.	G	A	2	5	7	0	0	7	0	0
3	30948206	.	C	A	7	5	12	0	1	13	0	0
3	31043800	.	T	C	2	5	7	0	0	7	0	0
3	31044205	.	A	G	1	2	3	0	0	3	0	0
3	31044431	.	C	T	2	6	8	0	0	8	0	0
3	31044579	.	A	G	2	6	8	0	0	8	0	0
3	31044649	.	T	C	5	4	9	0	0	9	0	0
3	31044782	.	A	C	6	0	6	0	8	14	0	0
3	31044850	.	T	C	2	3	5	0	0	5	0	0
3	31044986	.	G	T	2	5	7	0	0	7	0	0
3	31045098	.	G	A	2	3	5	0	1	6	0	0
3	31045335	.	C	G	4	5	9	0	0	9	0	0
3	31045407	.	C	A	2	2	4	0	0	4	0	0
3	31045415	.	A	T	2	2	4	0	0	4	0	0
3	31050126	.	T	A	3	3	6	0	0	6	0	0
3	31050554	.	T	C	3	5	8	0	1	9	0	0
3	31053268	.	A	C	3	0	3	0	4	7	0	0
3	31057563	.	G	A	1	5	6	0	0	6	0	0
3	31060219	.	A	G	8	0	8	0	4	12	0	0
3	31060366	.	C	T	1	5	6	0	0	6	0	0
3	31063319	.	A	G	3	2	5	0	0	5	0	0
3	31063625	.	A	T	9	6	15	0	0	15	0	0
3	31066143	.	C	G	7	6	13	0	0	13	0	0
3	31066637	.	G	A	3	2	5	0	0	5	0	0
3	31069634	.	T	C	21	5	26	1	3	30	0	0
3	31070574	.	T	C	1	2	3	0	0	3	0	0
3	31070892	.	A	G	19	26	45	0	3	48	0	0
3	31084598	.	C	T	4	2	6	0	0	6	0	0
3	31086366	.	A	G	4	2	6	0	1	7	0	0
3	31087613	.	A	T	1	3	4	0	0	4	0	0
3	31089630	.	G	A	3	2	5	0	0	5	0	0
3	31090424	.	T	C	2	4	6	0	0	6	0	0
3	31090557	.	G	C	3	3	6	0	0	6	0	0
3	31103852	.	G	A	2	5	7	0	0	7	0	0
3	31103861	.	C	T	1	4	5	0	0	5	0	0
3	31104046	.	T	C	2	2	4	0	0	4	0	0
3	31104065	.	T	C	2	2	4	0	0	4	0	0
3	31104127	.	A	T	1	2	3	0	0	3	0	0
3	31104695	.	C	T	5	3	8	0	0	8	0	0
3	31104718	.	C	A	0	2	2	0	2	4	0	0
3	31105259	.	A	C	32	21	53	0	1	54	0	0
3	31120249	.	C	T	13	17	30	0	3	33	0	0
3	31122581	.	T	G	12	13	25	0	2	27	0	0
3	31135832	.	T	C	8	0	8	0	8	16	0	0
3	31135898	.	T	C	14	0	14	0	7	21	0	0
3	31137926	.	T	C	13	6	19	0	0	19	0	0
3	31137957	.	G	A	9	8	17	0	0	17	0	0
3	31138225	.	A	G	8	11	19	0	1	20	0	0
3	31138247	.	C	T	11	8	19	0	1	20	0	0
3	31140267	.	C	T	5	3	8	0	0	8	0	0
3	31143129	.	T	G	8	7	15	0	0	15	0	0
3	31144674	.	A	G	8	5	13	0	0	13	0	0
3	31146690	.	C	T	4	8	12	0	0	12	0	0
3	31146909	.	G	A	5	3	8	0	0	8	0	0
3	31149781	.	C	A	7	7	14	0	0	14	0	0
3	31150018	.	C	T	5	8	13	0	0	13	0	0
3	31150363	.	A	G	4	5	9	0	0	9	0	0
3	31150996	.	G	A	9	3	12	0	0	12	0	0
3	31151008	.	T	A	9	4	13	0	0	13	0	0
3	31152156	.	A	C	3	5	8	0	0	8	0	0
3	31152284	.	A	G	5	7	12	0	0	12	0	0
3	31152443	.	G	A	3	3	6	0	0	6	0	0
3	31155340	.	C	T	0	2	2	0	4	6	0	0
3	31184034	.	C	T	4	2	6	0	1	7	0	0
3	31187608	.	C	T	5	2	7	0	0	7	0	0
3	31187719	.	G	A	5	3	8	0	0	8	0	0
3	31187721	.	A	C	6	3	9	0	0	9	0	0
3	31201643	.	T	G	3	3	6	0	1	7	0	0
3	31214520	.	G	A	4	2	6	0	0	6	0	0
3	31217714	.	G	T	7	3	10	0	1	11	0	0
3	31217723	.	G	A	6	5	11	0	1	12	0	0
3	31218153	.	C	T	0	10	10	0	3	13	0	0
3	31218230	.	G	A	3	2	5	0	0	5	0	0
3	31218240	.	T	A	5	4	9	0	0	9	0	0
3	31396679	.	A	G	15	10	25	0	0	25	0	0
3	31396760	.	A	C	11	10	21	0	0	21	0	0
3	31396781	.	C	G	7	0	7	0	7	14	0	0
3	31396826	.	T	C	6	9	15	1	0	16	0	0
3	31430327	.	T	C	15	14	29	0	0	29	0	0
3	31600731	.	T	C	5	3	8	0	0	8	0	0
3	31603766	.	G	A	1	3	4	0	1	5	0	0
3	31603787	.	G	A	3	2	5	0	1	6	0	0
3	31603925	.	A	G	3	3	6	0	0	6	0	0
3	31603976	.	G	A	6	3	9	0	0	9	0	0
3	31604030	.	T	C	3	4	7	0	0	7	0	0
3	31604053	.	G	A	3	4	7	0	0	7	0	0
3	31604133	.	T	C	1	3	4	0	0	4	0	0
3	31604834	.	A	T	5	3	8	0	0	8	0	0
3	31605033	.	A	G	4	3	7	0	1	8	0	0
3	31605039	.	C	T	4	3	7	0	0	7	0	0
3	31622904	.	T	C	1	2	3	0	0	3	0	0
3	31706607	.	C	A	11	6	17	0	1	18	0	0
3	31706966	.	T	C	6	11	17	0	0	17	0	0
3	31709010	.	C	T	13	17	30	0	0	30	0	0
3	31709079	.	G	A	20	16	36	0	0	36	0	0
3	31711526	.	T	C	11	12	23	0	0	23	0	0
3	31712328	.	G	T	8	4	12	0	0	12	0	0
3	31717595	.	C	T	20	12	32	0	0	32	0	0
3	31722101	.	A	T	19	22	41	0	2	43	0	0
3	31722342	.	A	G	22	21	43	0	1	44	0	0
3	31725824	.	C	T	21	22	43	0	1	44	0	0
3	31726066	.	T	C	15	12	27	3	0	30	0	0
3	31726395	.	G	A	1	9	10	0	8	18	0	0
3	31726829	.	C	T	8	10	18	0	0	18	0	0
3	31729328	.	A	G	2	3	5	0	0	5	0	0
3	31729531	.	C	T	2	5	7	0	0	7	0	0
3	31729707	.	C	T	0	5	5	0	6	11	0	0
3	31742271	.	G	T	3	2	5	0	0	5	0	0
3	31742277	.	C	T	2	3	5	0	0	5	0	0
3	31768915	.	C	T	1	3	4	0	0	4	0	0
3	31792856	.	G	A	9	14	23	0	0	23	0	0
3	31793080	.	C	T	7	12	19	0	0	19	0	0
3	31793515	.	T	G	10	14	24	0	2	26	0	0
3	31793518	.	G	A	14	11	25	0	0	25	0	0
3	31793557	.	A	G	11	11	22	0	0	22	0	0
3	31793715	.	G	C	19	15	34	0	0	34	0	0
3	31793739	.	C	T	17	17	34	0	0	34	0	0
3	31797508	.	C	G	15	12	27	0	0	27	0	0
3	31797749	.	A	G	12	14	26	0	2	28	0	0
3	31799575	.	G	A	6	4	10	0	0	10	0	0
3	31804244	.	A	G	5	5	10	0	0	10	0	0
3	31815498	.	G	A	2	2	4	0	0	4	0	0
3	31874969	.	G	T	8	16	24	0	0	24	0	0
3	31879626	.	G	A	4	4	8	0	0	8	0	0
3	31879725	.	T	A	6	9	15	1	0	16	0	0
3	31879726	.	C	A	6	9	15	1	0	16	0	0
3	31879880	.	G	T	10	14	24	0	1	25	0	0
3	31879911	.	T	C	12	9	21	0	1	22	0	0
3	31880184	.	C	G	1	7	8	0	8	16	0	0
3	31880641	.	C	T	2	14	16	0	14	30	0	0
3	31881082	.	G	T	13	12	25	0	0	25	0	0
3	31884001	.	A	G	9	5	14	0	0	14	0	0
3	31884321	.	C	T	2	10	12	0	11	23	0	0
3	31884477	.	C	T	6	10	16	0	3	19	0	0
3	31886783	.	C	T	0	7	7	0	9	16	0	0
3	31890010	.	T	C	15	4	19	0	1	20	0	0
3	31892324	.	C	T	7	9	16	0	0	16	0	0
3	31897070	.	A	G	4	6	10	0	0	10	0	0
3	31897120	.	T	A	4	11	15	0	0	15	0	0
3	31914167	.	T	A	14	11	25	0	0	25	0	0
3	31916624	.	T	G	10	0	10	4	16	30	0	0
3	31916701	.	A	T	11	8	19	0	2	21	0	0
3	31916724	.	A	G	10	10	20	0	2	22	0	0
3	31916787	.	G	T	13	16	29	0	1	30	0	0
3	31916863	.	T	C	14	6	20	0	1	21	0	0
3	31917075	.	T	G	13	0	13	0	10	23	0	0
3	31917279	.	G	T	4	3	7	0	0	7	0	0
3	31926052	.	C	A	24	17	41	0	1	42	0	0
3	31939272	.	A	G	16	15	31	0	2	33	0	0
3	31939473	.	G	T	1	16	17	0	21	38	0	0
3	31939566	.	C	A	17	14	31	0	1	32	0	0
3	31941152	.	C	T	14	25	39	0	1	40	0	0
3	31961992	.	G	A	3	13	16	0	19	35	0	0
3	32021628	.	G	A	19	19	38	0	0	38	0	0
3	32049740	.	C	T	17	11	28	0	3	31	0	0
3	32083179	.	C	T	2	2	4	0	0	4	0	0
3	32087455	.	T	G	4	8	12	0	0	12	0	0
3	32098130	.	G	A	0	2	2	0	2	4	0	0
3	32098379	.	A	G	2	2	4	0	0	4	0	0
3	32099841	.	A	G	36	1	37	1	18	56	0	0
3	32100183	.	G	T	20	9	29	18	1	48	0	0
3	32100755	.	T	C	23	9	32	7	1	40	0	0
3	32105746	.	C	A	11	11	22	0	3	25	0	0
3	32120187	.	A	T	1	7	8	4	0	12	0	0
3	32139671	.	G	A	4	3	7	1	0	8	0	0
3	32139701	.	C	G	3	4	7	0	0	7	0	0
3	32157262	.	C	G	1	2	3	0	0	3	0	0
3	32160490	.	G	A	9	5	14	0	0	14	0	0
3	32169545	.	G	A	1	3	4	0	1	5	0	0
3	32169677	.	C	T	1	2	3	0	0	3	0	0
3	32170835	.	C	T	6	4	10	0	0	10	0	0
3	32172913	.	C	G	3	3	6	0	0	6	0	0
3	32172915	.	G	A	3	3	6	0	0	6	0	0
3	32175758	.	C	T	0	3	3	0	6	9	0	0
3	32175918	.	C	A	5	6	11	0	0	11	0	0
3	32175945	.	T	C	3	0	3	0	4	7	0	0
3	32176926	.	G	C	4	0	4	0	7	11	0	0
3	32195106	.	T	C	1	0	1	0	2	3	0	0
3	32195116	.	A	T	1	2	3	0	0	3	0	0
3	32294745	.	G	A	16	23	39	0	2	41	0	0
3	32294869	.	C	G	0	10	10	0	31	41	0	0
3	32295151	.	C	T	23	17	40	0	0	40	0	0
3	32295294	.	G	A	19	16	35	8	2	45	0	0
3	32295519	.	A	C	17	14	31	0	1	32	0	0
3	32295635	.	T	A	10	9	19	0	3	22	0	0
3	32296122	.	C	T	21	12	33	0	0	33	0	0
3	32296202	.	G	A	14	10	24	0	1	25	0	0
3	32296253	.	T	A	19	10	29	0	0	29	0	0
3	32296283	.	G	A	16	10	26	0	0	26	0	0
3	32296306	.	G	A	16	9	25	0	1	26	0	0
3	32296379	.	A	G	20	13	33	0	0	33	0	0
3	32296559	.	G	A	14	18	32	0	0	32	0	0
3	32296560	.	C	T	1	12	13	0	20	33	0	0
3	32296673	.	A	G	21	18	39	0	3	42	0	0
3	32296873	.	G	A	19	17	36	0	3	39	0	0
3	32303045	.	G	A	17	8	25	0	0	25	0	0
3	32303589	.	G	C	3	0	3	0	2	5	0	0
3	32303590	.	T	G	1	2	3	0	1	4	0	0
3	32303698	.	A	G	16	21	37	0	1	38	0	0
3	32314732	.	G	A	10	15	25	0	0	25	0	0
3	32325218	.	A	G	2	5	7	0	0	7	0	0
3	32329167	.	A	T	8	15	23	0	0	23	0	0
3	32357596	.	C	T	15	30	45	3	7	55	0	0
3	32357799	.	A	C	26	27	53	0	0	54	1	0
3	32360978	.	G	A	20	12	32	0	1	33	0	0
3	32361669	.	G	A	18	24	42	0	2	44	0	0
3	32361865	.	A	G	24	20	44	1	1	46	0	0
3	32366131	.	T	C	18	19	37	0	0	37	0	0
3	32366279	.	T	C	17	17	34	0	2	36	0	0
3	32366332	.	G	A	18	17	35	0	1	36	0	0
3	32366403	.	C	T	25	20	45	0	1	46	0	0
3	32400967	.	C	T	27	29	56	0	5	61	0	0
3	32401159	.	C	A	22	33	55	0	2	57	0	0
3	32401252	.	C	T	19	25	44	0	2	46	0	0
3	32403959	.	T	G	15	0	15	0	13	28	0	0
3	32405571	.	C	T	19	17	36	0	0	36	0	0
3	32405865	.	G	C	26	18	44	0	1	45	0	0
3	32405910	.	C	T	24	20	44	0	1	45	0	0
3	32406447	.	T	C	24	34	58	0	0	58	0	0
3	32406547	.	T	C	30	28	58	0	0	58	0	0
3	32406618	.	G	A	25	27	52	0	2	54	0	0
3	32406631	.	C	G	22	24	46	0	1	47	0	0
3	32410865	.	T	C	3	2	5	0	0	5	0	0
3	32414109	.	T	C	6	2	8	0	0	8	0	0
3	32415781	.	A	C	1	2	3	0	0	3	0	0
3	32433953	.	T	C	14	10	24	0	1	25	0	0
3	32434974	.	G	A	0	12	12	0	16	28	0	0
3	32435034	.	G	T	0	19	19	0	16	35	0	0
3	32435757	.	G	A	2	10	12	0	11	23	0	0
3	32435874	.	G	A	2	10	12	0	7	19	0	0
3	32436024	.	C	A	10	9	19	0	1	20	0	0
3	32436109	.	T	A	12	14	26	0	1	27	0	0
3	32436156	.	T	C	9	12	21	0	0	21	0	0
3	32436426	.	C	T	18	12	30	0	1	31	0	0
3	32436736	.	G	C	17	12	29	0	1	30	0	0
3	32436774	.	G	A	11	12	23	0	0	23	0	0
3	32438425	.	A	C	16	16	32	0	3	35	0	0
3	32440805	.	A	G	15	14	29	0	4	33	0	0
3	32441156	.	T	G	26	0	26	0	17	43	0	0
3	32441297	.	C	A	13	12	25	0	3	28	0	0
3	32441385	.	G	C	16	19	35	0	2	37	0	0
3	32441532	.	G	A	12	22	34	0	6	40	0	0
3	32441779	.	C	T	30	18	48	0	2	50	0	0
3	32447386	.	G	A	11	5	16	0	0	16	0	0
3	32447674	.	C	G	17	19	36	0	1	37	0	0
3	32447800	.	T	C	14	11	25	0	1	26	0	0
3	32450399	.	T	C	20	19	39	0	3	42	0	0
3	32453727	.	G	A	20	16	36	0	1	37	0	0
3	32457325	.	G	A	2	15	17	1	28	46	0	0
3	32457620	.	T	C	14	16	30	0	0	30	0	0
3	32457686	.	T	C	15	18	33	0	2	35	0	0
3	32458627	.	C	T	12	7	19	0	0	19	0	0
3	32477891	.	T	C	8	13	21	0	0	21	0	0
3	32477950	.	T	A	9	6	15	0	1	16	0	0
3	32479471	.	T	C	8	9	17	0	1	18	0	0
3	32482222	.	A	T	17	10	27	0	1	28	0	0
3	32482231	.	A	G	18	0	18	0	11	29	0	0
3	32482495	.	G	T	1	15	16	0	6	22	0	0
3	32482834	.	A	G	17	11	28	0	0	28	0	0
3	32483557	.	T	G	10	21	31	0	6	37	0	0
3	32483956	.	T	C	15	15	30	0	2	32	0	0
3	32484034	.	A	G	27	0	27	0	16	43	0	0
3	32484039	.	A	G	23	0	23	0	20	43	0	0
3	32484204	.	T	C	19	16	35	0	2	37	0	0
3	32484472	.	T	C	16	17	33	0	0	33	0	0
3	32484676	.	T	G	21	15	36	0	3	39	0	0
3	32484892	.	A	G	19	7	26	0	0	26	0	0
3	32485306	.	A	G	23	22	45	0	0	45	0	0
3	32485324	.	C	T	25	17	42	0	0	42	0	0
3	32485366	.	A	G	23	20	43	0	2	45	0	0
3	32485519	.	A	C	12	12	24	0	9	33	0	0
3	32485967	.	C	A	27	13	40	1	3	44	0	0
3	32486049	.	A	T	22	18	40	0	1	41	0	0
3	32486069	.	C	G	20	0	20	0	16	36	0	0
3	32489613	.	C	T	21	23	44	0	2	46	0	0
3	32490098	.	C	T	16	5	21	0	0	21	0	0
3	32490251	.	G	T	14	12	26	0	0	26	0	0
3	32490264	.	G	A	10	11	21	0	2	23	0	0
3	32490487	.	G	T	5	7	12	0	1	13	0	0
3	32532801	.	G	A	5	4	9	0	0	9	0	0
3	32534263	.	A	G	10	15	25	0	0	25	0	0
3	32534353	.	C	T	6	18	24	0	0	24	0	0
3	32534365	.	T	A	8	14	22	0	0	22	0	0
3	32637967	.	A	T	1	5	6	0	1	7	0	0
3	32637977	.	A	C	1	4	5	0	2	7	0	0
3	32641716	.	T	G	14	15	29	0	0	29	0	0
3	32643512	.	G	A	12	13	25	0	1	26	0	0
3	32647124	.	T	C	17	21	38	0	2	40	0	0
3	32647194	.	C	T	10	8	18	0	1	19	0	0
3	32647252	.	G	A	14	7	21	0	3	24	0	0
3	32647308	.	G	C	9	11	20	0	2	22	0	0
3	32647414	.	A	G	10	10	20	0	0	20	0	0
3	32647558	.	A	G	14	0	14	0	20	34	0	0
3	32649846	.	C	T	9	12	21	0	2	23	0	0
3	32649960	.	G	A	9	14	23	0	0	23	0	0
3	32650004	.	A	G	8	12	20	0	0	20	0	0
3	32650199	.	C	A	3	2	5	0	1	6	0	0
3	32657323	.	C	T	1	4	5	0	0	5	0	0
3	32662034	.	A	C	4	5	9	0	0	9	0	0
3	32663255	.	T	C	5	4	9	0	0	9	0	0
3	32663335	.	A	G	3	0	3	0	3	6	0	0
3	32663485	.	T	C	7	5	12	0	0	12	0	0
3	32663638	.	A	G	5	5	10	0	0	10	0	0
3	32663764	.	T	G	5	2	7	0	0	7	0	0
3	32665515	.	G	A	1	3	4	0	0	4	0	0
3	32667118	.	A	C	8	8	16	0	0	16	0	0
3	32668806	.	A	G	8	5	13	0	1	14	0	0
3	32668818	.	A	G	7	6	13	0	0	13	0	0
3	32669077	.	T	A	1	2	3	0	0	3	0	0
3	32672501	.	C	A	8	3	11	0	1	12	0	0
3	32675236	.	G	A	11	8	19	0	3	22	0	0
3	32679267	.	T	A	13	16	29	0	1	30	0	0
3	32679289	.	T	A	16	10	26	0	2	28	0	0
3	32679332	.	C	T	20	13	33	0	0	33	0	0
3	32679528	.	C	A	12	13	25	0	1	26	0	0
3	32685708	.	A	G	14	0	14	0	9	23	0	0
3	32698458	.	T	C	6	3	9	0	0	9	0	0
3	32698500	.	A	G	17	16	33	0	0	33	0	0
3	32700697	.	A	G	16	17	33	0	1	34	0	0
3	32700758	.	A	G	22	15	37	0	0	37	0	0
3	32700988	.	C	T	17	12	29	0	3	32	0	0
3	32701031	.	T	G	15	1	16	0	21	37	0	0
3	32702596	.	T	A	12	9	21	0	1	22	0	0
3	32707219	.	G	A	3	12	15	0	1	16	0	0
3	32707267	.	T	C	6	11	17	0	1	18	0	0
3	32707272	.	C	A	6	11	17	0	0	17	0	0
3	32707480	.	C	T	7	5	12	0	0	12	0	0
3	32707621	.	C	G	10	16	26	0	0	26	0	0
3	32707813	.	C	G	11	16	27	0	1	28	0	0
3	32708077	.	T	C	27	24	51	0	1	52	0	0
3	32709139	.	G	A	1	5	6	0	0	6	0	0
3	32710705	.	A	G	25	22	47	0	1	48	0	0
3	32710812	.	G	A	2	19	21	0	19	40	0	0
3	32710999	.	C	A	4	5	9	1	2	12	0	0
3	32715571	.	G	A	4	3	7	0	0	7	0	0
3	32717529	.	C	T	1	5	6	0	2	8	0	0
3	32718451	.	T	G	3	4	7	0	0	7	0	0
3	32718460	.	C	T	4	3	7	0	0	7	0	0
3	32718605	.	A	G	5	5	10	0	1	11	0	0
3	32718851	.	T	C	8	8	16	0	1	17	0	0
3	32718945	.	C	G	9	7	16	0	0	16	0	0
3	32719715	.	T	C	8	12	20	0	1	21	0	0
3	32720184	.	A	C	3	11	14	0	2	16	0	0
3	32720342	.	T	C	9	5	14	0	1	15	0	0
3	32722973	.	C	T	17	9	26	0	1	27	0	0
3	32723033	.	A	G	9	0	9	1	12	22	0	0
3	32723119	.	A	G	3	0	3	0	7	10	0	0
3	32723497	.	A	G	8	1	9	0	13	22	0	0
3	32723698	.	C	T	9	7	16	0	0	16	0	0
3	32724010	.	G	A	2	10	12	0	3	15	0	0
3	32724100	.	G	A	3	3	6	0	0	6	0	0
3	32726271	.	A	G	8	6	14	0	0	14	0	0
3	32726357	.	A	G	2	4	6	0	0	6	0	0
3	32728304	.	T	C	9	9	18	0	1	19	0	0
3	32729150	.	T	C	12	10	22	0	0	22	0	0
3	32729232	.	T	C	7	11	18	0	2	20	0	0
3	32729265	.	C	G	2	0	2	0	6	8	0	0
3	32729270	.	T	G	1	0	1	0	5	6	0	0
3	32729429	.	T	A	12	4	16	0	0	16	0	0
3	32729663	.	C	T	8	9	17	0	0	17	0	0
3	32729759	.	C	A	10	8	18	0	0	18	0	0
3	32729827	.	A	T	9	9	18	0	0	18	0	0
3	32729845	.	G	A	6	9	15	0	1	16	0	0
3	32730011	.	A	G	12	1	13	0	6	19	0	0
3	32730071	.	T	A	8	5	13	0	0	13	0	0
3	32730131	.	A	G	7	7	14	0	0	14	0	0
3	32731255	.	A	G	10	0	10	0	7	17	0	0
3	32731418	.	C	T	9	8	17	0	0	17	0	0
3	32731750	.	A	G	7	0	7	0	12	19	0	0
3	32731804	.	T	C	4	12	16	0	0	16	0	0
3	32731840	.	T	C	4	9	13	0	0	13	0	0
3	32731855	.	T	C	4	7	11	0	0	11	0	0
3	32731879	.	A	G	2	0	2	0	5	7	0	0
3	32734926	.	G	A	0	11	11	0	9	20	0	0
3	32737727	.	C	T	8	8	16	0	0	16	0	0
3	32741137	.	G	A	0	9	9	0	6	15	0	0
3	32741385	.	G	A	0	7	7	4	11	22	0	0
3	32741809	.	A	G	8	0	8	0	7	15	0	0
3	32742472	.	G	T	1	1	2	0	0	2	0	0
3	32742479	.	T	C	0	1	1	0	2	3	0	0
3	32777481	.	A	C	12	13	25	0	1	26	0	0
3	32777733	.	G	T	11	10	21	0	0	21	0	0
3	32789654	.	G	T	6	10	16	0	11	27	0	0
3	32789985	.	T	C	17	12	29	0	3	32	0	0
3	32794931	.	C	A	12	11	23	0	2	25	0	0
3	32795068	.	C	T	12	18	30	0	1	31	0	0
3	32795425	.	G	A	9	6	15	0	1	16	0	0
3	32795461	.	A	T	13	11	24	0	0	24	0	0
3	32795614	.	C	T	8	9	17	0	0	17	0	0
3	32807667	.	G	A	5	14	19	0	2	21	0	0
3	32808023	.	T	A	18	10	28	0	0	28	0	0
3	32808185	.	T	C	17	16	33	0	0	33	0	0
3	32808214	.	G	A	19	16	35	0	2	37	0	0
3	32808338	.	A	C	27	20	47	0	3	50	0	0
3	32808554	.	T	G	13	18	31	0	1	32	0	0
3	32808771	.	G	A	11	14	25	0	1	26	0	0
3	32808772	.	G	C	11	15	26	0	0	26	0	0
3	32808979	.	T	G	15	15	30	0	0	30	0	0
3	32809154	.	A	T	8	20	28	0	0	28	0	0
3	32809368	.	G	A	11	15	26	0	1	27	0	0
3	32809410	.	G	A	10	15	25	0	1	26	0	0
3	32809432	.	T	A	10	12	22	0	0	22	0	0
3	32809548	.	T	C	11	16	27	0	1	28	0	0
3	32809561	.	G	A	12	16	28	0	1	29	0	0
3	32809836	.	A	G	8	0	8	0	11	19	0	0
3	32809927	.	T	C	7	15	22	0	0	22	0	0
3	32810011	.	T	A	11	9	20	0	2	22	0	0
3	32810580	.	C	T	13	15	28	0	2	30	0	0
3	32810715	.	A	G	14	19	33	0	0	33	0	0
3	32811094	.	A	T	9	6	15	0	0	15	0	0
3	32825427	.	C	T	4	7	11	0	0	11	0	0
3	32825564	.	T	A	4	4	8	0	0	8	0	0
3	32825565	.	C	T	4	4	8	0	0	8	0	0
3	32825846	.	G	A	1	5	6	0	0	6	0	0
3	32831417	.	T	C	3	3	6	0	0	6	0	0
3	32837514	.	G	A	25	16	41	0	1	42	0	0
3	32837643	.	G	A	15	13	28	0	5	33	0	0
3	32837904	.	A	G	21	0	21	0	20	41	0	0
3	32838033	.	G	A	0	12	12	0	19	32	1	0
3	32838039	.	A	G	18	12	30	0	0	30	0	0
3	32842163	.	C	T	10	5	15	0	3	18	0	0
3	32842235	.	G	T	10	3	13	0	0	13	0	0
3	32842318	.	C	T	6	2	8	0	1	9	0	0
3	32847607	.	C	T	4	5	9	0	0	9	0	0
3	32847771	.	G	A	0	7	7	0	4	11	0	0
3	32847839	.	C	A	3	8	11	0	0	11	0	0
3	32847887	.	C	G	8	8	16	0	0	16	0	0
3	32847923	.	C	A	10	6	16	0	0	16	0	0
3	32847942	.	A	G	13	0	13	0	5	18	0	0
3	32848175	.	T	G	4	9	13	0	0	13	0	0
3	32848418	.	C	T	8	7	15	0	0	15	0	0
3	32848714	.	A	G	12	7	19	0	1	20	0	0
3	32849079	.	C	T	13	9	22	0	0	22	0	0
3	32849679	.	T	A	18	12	30	0	0	30	0	0
3	32850029	.	A	T	17	12	29	0	0	29	0	0
3	32850265	.	A	G	5	0	5	0	7	12	0	0
3	32850499	.	T	C	7	8	15	0	0	15	0	0
3	32854276	.	T	C	5	8	13	0	0	13	0	0
3	32854533	.	T	C	8	11	19	0	0	19	0	0
3	32854743	.	C	G	9	0	9	0	6	15	0	0
3	32854744	.	A	G	8	6	14	0	1	15	0	0
3	32855066	.	G	A	5	8	13	0	0	13	0	0
3	32863016	.	A	G	7	7	14	0	1	15	0	0
3	32863128	.	C	A	1	7	8	0	0	8	0	0
3	32865030	.	T	A	1	4	5	0	0	5	0	0
3	32866068	.	A	T	2	2	4	0	0	4	0	0
3	32866175	.	C	G	8	3	11	0	0	11	0	0
3	32867865	.	A	G	2	4	6	0	0	6	0	0
3	32868114	.	G	T	5	5	10	0	0	10	0	0
3	32868143	.	C	T	4	7	11	0	0	11	0	0
3	32868519	.	G	T	5	5	10	0	1	11	0	0
3	32868590	.	C	T	4	2	6	0	0	6	0	0
3	32868593	.	A	G	2	1	3	0	3	6	0	0
3	32869770	.	C	T	3	5	8	0	0	8	0	0
3	32869773	.	G	A	2	6	8	0	1	9	0	0
3	32869913	.	C	T	1	5	6	0	1	7	0	0
3	32869930	.	C	T	2	4	6	0	0	6	0	0
3	32870564	.	G	C	2	3	5	0	0	5	0	0
3	32870572	.	C	A	2	2	4	0	0	4	0	0
3	32870947	.	A	G	1	6	7	0	0	7	0	0
3	32871023	.	G	C	3	2	5	0	0	5	0	0
3	32871202	.	T	C	1	2	3	0	3	6	0	0
3	32871350	.	T	C	2	0	2	0	3	5	0	0
3	32873507	.	A	T	1	3	4	0	0	4	0	0
3	32873573	.	T	G	1	4	5	0	0	5	0	0
3	32873596	.	A	G	1	2	3	0	0	3	0	0
3	32889849	.	T	C	6	0	6	0	11	17	0	0
3	32890002	.	G	T	12	21	33	0	0	33	0	0
3	32890058	.	A	G	9	21	30	0	0	30	0	0
3	32892061	.	G	A	13	21	34	0	0	34	0	0
3	32892422	.	A	G	14	18	32	0	2	34	0	0
3	32900428	.	A	G	13	24	37	0	0	37	0	0
3	32924386	.	G	A	6	4	10	0	0	10	0	0
3	32924643	.	G	A	5	4	9	0	0	9	0	0
3	32924836	.	T	A	17	11	28	0	2	30	0	0
3	32924989	.	G	A	12	11	23	0	0	23	0	0
3	32925066	.	G	A	7	15	22	0	0	22	0	0
3	32925248	.	C	T	11	8	19	0	0	19	0	0
3	32925264	.	G	T	11	7	18	0	2	20	0	0
3	32925400	.	C	T	3	8	11	0	0	11	0	0
3	32926016	.	C	T	0	5	5	0	8	13	0	0
3	32926025	.	G	A	7	6	13	0	0	13	0	0
3	32926058	.	A	G	5	4	9	0	0	9	0	0
3	32926148	.	G	A	4	5	9	0	0	9	0	0
3	32926184	.	A	T	5	6	11	0	1	12	0	0
3	32927336	.	A	G	2	2	4	0	0	4	0	0
3	32933774	.	A	C	9	10	19	0	1	20	0	0
3	32933849	.	A	T	10	12	22	0	0	22	0	0
3	32935936	.	A	G	8	0	8	0	10	18	0	0
3	32937628	.	A	G	14	21	35	0	0	35	0	0
3	32941242	.	G	A	11	16	27	0	1	28	0	0
3	32941661	.	A	G	14	11	25	0	0	25	0	0
3	32944203	.	C	A	14	18	32	0	2	34	0	0
3	32944569	.	C	T	17	22	39	0	2	41	0	0
3	32944668	.	C	A	14	16	30	0	1	31	0	0
3	32944854	.	C	T	23	20	43	0	0	43	0	0
3	32947971	.	T	C	18	22	40	0	1	41	0	0
3	32950959	.	G	A	10	9	19	0	0	19	0	0
3	32950977	.	G	A	1	8	9	0	9	19	1	0
3	32951001	.	G	T	1	10	11	0	10	21	0	0
3	32951394	.	G	A	24	23	47	0	1	48	0	0
3	32951564	.	A	C	5	9	14	0	1	15	0	0
3	32951637	.	G	A	10	9	19	0	0	19	0	0
3	32951778	.	C	T	16	12	28	0	2	30	0	0
3	32951891	.	T	C	6	16	22	0	2	24	0	0
3	33047597	.	G	T	1	2	3	4	0	7	0	0
3	33065643	.	T	A	5	3	8	6	1	15	0	0
3	33065985	.	A	G	7	4	11	0	0	11	0	0
3	33066155	.	C	T	0	8	8	0	12	20	0	0
3	33066241	.	C	T	0	3	3	2	7	12	0	0
3	33066252	.	G	C	9	1	10	2	1	13	0	0
3	33066292	.	C	T	8	7	15	2	2	19	0	0
3	33066629	.	C	T	0	4	4	0	9	13	0	0
3	33066714	.	A	T	9	6	15	0	0	15	0	0
3	33066804	.	T	C	13	0	13	0	10	23	0	0
3	33066809	.	C	G	11	10	21	0	0	21	0	0
3	33066969	.	T	C	9	1	10	0	6	16	0	0
3	33066976	.	T	C	9	6	15	0	1	16	0	0
3	33067092	.	A	T	2	2	4	0	0	4	0	0
3	33067337	.	A	G	8	5	13	0	1	14	0	0
3	33067340	.	A	G	9	5	14	0	0	14	0	0
3	33067376	.	G	A	7	7	14	0	0	14	0	0
3	33067438	.	G	A	4	8	12	0	1	13	0	0
3	33069274	.	A	C	3	10	13	0	1	14	0	0
3	33069596	.	G	A	8	13	21	0	0	21	0	0
3	33075167	.	C	T	8	10	18	0	0	18	0	0
3	33259407	.	G	A	1	2	3	0	3	6	0	0
3	33341072	.	T	A	12	31	43	0	1	44	0	0
3	33344470	.	T	A	14	19	33	0	0	33	0	0
3	33345482	.	G	A	0	11	11	0	10	21	0	0
3	33360480	.	A	G	13	0	13	0	10	23	0	0
3	33368134	.	T	C	7	10	17	0	0	17	0	0
3	33372555	.	G	C	1	8	9	0	9	18	0	0
3	33373540	.	A	C	8	11	19	0	2	21	0	0
3	33375645	.	C	A	11	15	26	0	0	26	0	0
3	33379072	.	C	T	5	4	9	0	0	9	0	0
3	33414640	.	G	A	3	2	5	0	0	5	0	0
3	33420561	.	C	T	1	3	4	0	0	4	0	0
3	33420614	.	A	T	1	2	3	0	0	3	0	0
3	33424010	.	C	T	2	9	11	0	5	16	0	0
3	33424420	.	G	A	30	25	55	0	8	63	0	0
3	33426513	.	G	A	37	35	72	0	1	73	0	0
3	33432379	.	A	C	4	0	4	0	7	11	0	0
3	33433319	.	T	C	3	0	3	0	7	10	0	0
3	33433621	.	G	A	10	9	19	0	0	19	0	0
3	33437399	.	T	C	6	3	9	0	1	10	0	0
3	33440693	.	C	T	10	5	15	0	0	15	0	0
3	33445039	.	A	T	14	10	24	0	1	25	0	0
3	33445090	.	G	C	2	15	17	0	9	26	0	0
3	33449405	.	C	T	15	17	32	0	2	34	0	0
3	33449554	.	G	A	1	9	10	0	17	27	0	0
3	33452168	.	C	T	29	10	39	0	2	41	0	0
3	33455809	.	G	A	3	17	20	0	20	40	0	0
3	33458803	.	C	T	18	10	28	0	3	31	0	0
3	33458911	.	A	T	12	12	24	0	2	26	0	0
3	33459394	.	T	A	11	10	21	0	1	22	0	0
3	33459489	.	C	T	10	6	16	0	0	16	0	0
3	33459517	.	C	T	6	4	10	0	1	11	0	0
3	33459532	.	G	A	6	4	10	0	0	10	0	0
3	33461366	.	C	T	1	14	15	1	13	29	0	0
3	33461646	.	C	T	1	6	7	0	10	17	0	0
3	33461796	.	A	T	12	10	22	0	0	22	0	0
3	33469413	.	A	G	15	21	36	0	1	37	0	0
3	33469614	.	T	A	19	15	34	0	2	36	0	0
3	33473131	.	C	T	0	15	15	0	12	27	0	0
3	33476589	.	T	C	13	10	23	0	1	24	0	0
3	33478690	.	G	A	14	6	20	0	2	22	0	0
3	33494089	.	A	T	14	19	33	0	0	33	0	0
3	33494091	.	G	C	12	19	31	0	2	33	0	0
3	33570763	.	G	A	5	3	8	0	0	8	0	0
3	33571002	.	C	T	5	4	9	0	2	11	0	0
3	33571231	.	C	T	5	8	13	0	1	14	0	0
3	33571264	.	T	C	3	1	4	0	8	12	0	0
3	33571294	.	C	T	6	9	15	0	1	16	0	0
3	33571840	.	G	C	2	0	2	0	10	12	0	0
3	33572095	.	G	A	8	3	11	0	0	11	0	0
3	33572206	.	G	C	10	0	10	0	13	23	0	0
3	33572298	.	G	A	10	7	17	0	2	19	0	0
3	33572335	.	C	T	10	9	19	0	0	19	0	0
3	33572404	.	C	T	1	6	7	0	7	14	0	0
3	33572464	.	T	C	11	0	11	0	4	15	0	0
3	33572473	.	A	G	9	3	12	0	1	13	0	0
3	33572512	.	C	A	4	7	11	0	0	11	0	0
3	33572553	.	T	G	5	7	12	0	1	13	0	0
3	33572617	.	A	T	3	8	11	0	0	11	0	0
3	33572668	.	A	G	8	3	11	0	0	11	0	0
3	33573178	.	G	A	5	4	9	0	1	10	0	0
3	33747527	.	A	G	17	12	29	2	2	33	0	0
3	33747563	.	A	G	15	0	15	2	14	31	0	0
3	33761597	.	C	T	11	11	22	0	0	22	0	0
3	33761705	.	G	A	2	7	9	0	23	32	0	0
3	33761834	.	G	A	24	7	31	0	2	33	0	0
3	33761835	.	A	T	23	8	31	0	1	32	0	0
3	33762068	.	A	G	13	10	23	0	3	26	0	0
3	33762278	.	A	G	8	11	19	0	0	19	0	0
3	33762310	.	C	A	6	10	16	0	1	17	0	0
3	33762408	.	T	A	7	8	15	0	0	15	0	0
3	33762480	.	C	T	6	7	13	0	0	13	0	0
3	33773294	.	A	G	20	18	38	0	9	47	0	0
3	33777317	.	T	G	18	22	40	0	2	42	0	0
3	33777425	.	A	G	21	20	41	0	1	42	0	0
3	33777807	.	A	G	23	17	40	1	2	43	0	0
3	33820568	.	C	T	16	12	28	0	0	28	0	0
3	33820580	.	A	G	13	13	26	0	1	27	0	0
3	33821929	.	C	T	6	4	10	0	0	10	0	0
3	33834678	.	T	C	9	5	14	0	2	16	0	0
3	33842844	.	A	G	10	9	19	0	0	19	0	0
3	33844761	.	T	C	12	0	12	0	9	21	0	0
3	33847104	.	A	G	4	9	13	0	0	13	0	0
3	33847191	.	T	C	5	6	11	0	3	14	0	0
3	33847832	.	G	A	6	3	9	0	2	11	0	0
3	33854879	.	T	C	6	10	16	0	0	16	0	0
3	33854927	.	G	A	1	7	8	0	0	8	0	0
3	33918537	.	T	A	1	2	3	0	0	3	0	0
3	33918611	.	A	G	4	4	8	0	0	8	0	0
3	33918675	.	T	G	8	2	10	0	3	13	0	0
3	33918775	.	A	G	9	5	14	0	0	14	0	0
3	33921663	.	A	C	2	9	11	0	0	11	0	0
3	33921878	.	C	A	1	5	6	0	0	6	0	0
3	33921985	.	C	A	2	2	4	0	0	4	0	0
3	33922168	.	T	A	1	2	3	0	0	3	0	0
3	33922269	.	A	G	4	2	6	1	0	7	0	0
3	33922359	.	G	A	6	2	8	0	0	8	0	0
3	33922413	.	T	A	6	2	8	0	1	9	0	0
3	33922415	.	G	A	6	3	9	0	0	9	0	0
3	33932170	.	C	T	1	9	10	0	12	22	0	0
3	33932430	.	T	A	14	9	23	0	0	23	0	0
3	33932628	.	G	A	6	9	15	0	0	15	0	0
3	33934848	.	T	C	5	3	8	0	0	8	0	0
3	33934849	.	G	C	5	3	8	0	0	8	0	0
3	33936783	.	G	C	4	5	9	0	1	10	0	0
3	34129941	.	C	T	1	8	9	0	18	27	0	0
3	34135868	.	C	T	9	5	14	0	2	16	0	0
3	34144353	.	A	T	6	2	8	0	1	9	0	0
3	34144807	.	C	G	7	6	13	0	1	14	0	0
3	34144808	.	G	A	1	5	6	0	8	14	0	0
3	34145131	.	T	G	3	4	7	0	0	7	0	0
3	34146882	.	G	T	4	10	14	0	1	15	0	0
3	34146955	.	A	G	4	4	8	0	0	8	0	0
3	34166288	.	C	A	20	20	40	1	1	42	0	0
3	34170913	.	G	A	8	20	28	0	1	29	0	0
3	34171862	.	C	G	1	0	1	0	17	18	0	0
3	34171863	.	C	G	1	0	1	0	17	18	0	0
3	34180096	.	G	T	10	10	20	0	0	20	0	0
3	34180332	.	A	G	5	8	13	0	0	13	0	0
3	34180386	.	G	A	7	8	15	0	0	15	0	0
3	34182164	.	C	T	7	7	14	0	1	15	0	0
3	34182306	.	G	C	10	5	15	0	1	16	0	0
3	34182376	.	A	C	8	6	14	0	0	14	0	0
3	34182386	.	G	A	0	3	3	0	9	12	0	0
3	34220359	.	A	T	10	14	24	0	0	24	0	0
3	34244901	.	G	C	7	8	15	0	1	16	0	0
3	34258965	.	G	A	10	10	20	0	0	20	0	0
3	34259013	.	C	G	14	9	23	0	1	24	0	0
3	34259060	.	C	T	21	12	33	0	1	34	0	0
3	34259869	.	T	G	11	1	12	1	11	26	2	0
3	34260325	.	T	C	12	10	22	0	0	22	0	0
3	34260808	.	T	C	8	10	18	0	0	18	0	0
3	34261204	.	T	C	3	10	13	0	1	14	0	0
3	34261354	.	A	G	12	15	27	0	2	29	0	0
3	34261795	.	G	A	5	15	20	0	0	20	0	0
3	34262290	.	C	T	12	14	26	0	1	27	0	0
3	34262421	.	C	A	16	10	26	0	2	28	0	0
3	34262639	.	G	A	21	14	35	0	0	35	0	0
3	34262823	.	A	T	19	8	27	0	2	29	0	0
3	34263007	.	C	T	1	8	9	1	17	27	0	0
3	34264140	.	A	T	8	6	14	0	1	15	0	0
3	34264634	.	T	A	6	8	14	0	6	20	0	0
3	34264657	.	A	T	11	7	18	0	2	20	0	0
3	34270546	.	A	G	9	15	24	0	0	24	0	0
3	34323584	.	C	T	2	5	7	0	0	7	0	0
3	34327103	.	G	A	4	8	12	0	1	13	0	0
3	34337389	.	A	G	4	3	7	0	0	7	0	0
3	34337734	.	A	T	1	2	3	0	0	3	0	0
3	34337828	.	T	A	3	3	6	0	0	6	0	0
3	34456397	.	G	A	1	1	2	0	2	4	0	0
3	34456405	.	A	G	0	2	2	0	1	3	0	0
3	34456538	.	A	G	4	3	7	0	0	7	0	0
3	34588493	.	A	G	1	2	3	0	0	3	0	0
3	34588788	.	G	A	3	4	7	0	0	7	0	0
3	34589501	.	C	T	2	2	4	0	0	4	0	0
3	34590350	.	A	C	1	3	4	0	0	4	0	0
3	34599655	.	T	G	1	5	6	0	0	6	0	0
3	34697461	.	G	A	3	6	9	0	0	9	0	0
3	34697514	.	T	C	7	0	7	0	14	21	0	0
3	34703722	.	T	G	6	3	9	0	0	9	0	0
3	34703731	.	G	C	4	3	7	0	1	8	0	0
3	34706676	.	G	A	3	10	13	0	0	13	0	0
3	34767112	.	G	T	25	26	51	0	5	56	0	0
3	34767662	.	T	G	28	40	68	0	2	70	0	0
3	34767669	.	G	A	27	38	65	0	1	66	0	0
3	34772941	.	T	G	42	29	71	0	1	73	1	0
3	34775942	.	G	A	40	31	71	0	1	72	0	0
3	34776115	.	T	G	28	30	58	0	10	68	0	0
3	34776133	.	G	C	33	28	61	0	6	67	0	0
3	34776151	.	C	A	38	30	68	0	1	69	0	0
3	34781074	.	A	G	28	37	65	0	1	66	0	0
3	34781095	.	C	T	26	37	63	0	3	66	0	0
3	34781448	.	T	C	25	27	52	0	2	54	0	0
3	34781586	.	T	C	28	1	29	0	26	55	0	0
3	34783970	.	G	A	25	33	58	0	3	61	0	0
3	34783982	.	A	G	27	31	58	0	2	60	0	0
3	34801034	.	T	C	15	8	23	0	0	23	0	0
3	34804427	.	A	G	15	4	19	0	1	20	0	0
3	34814839	.	A	G	10	7	17	0	0	17	0	0
3	34822049	.	C	T	22	18	40	0	0	40	0	0
3	34822169	.	C	T	16	17	33	0	1	34	0	0
3	34822214	.	T	C	17	17	34	0	0	34	0	0
3	34911761	.	T	C	2	2	4	0	0	4	0	0
3	34911795	.	G	C	0	2	2	0	2	4	0	0
3	34919892	.	C	T	12	8	20	0	0	20	0	0
3	34977497	.	A	G	11	1	12	0	10	22	0	0
3	34977508	.	A	G	9	1	10	0	8	18	0	0
3	34981394	.	T	C	3	2	5	0	0	5	0	0
3	34994140	.	C	T	28	30	58	1	3	62	0	0
3	34994750	.	A	G	9	16	25	0	0	25	0	0
3	35170112	.	T	C	20	15	35	1	2	38	0	0
3	35225160	.	A	G	24	0	24	0	23	47	0	0
3	35225202	.	C	T	15	32	47	0	1	48	0	0
3	35248470	.	T	C	9	7	16	0	0	16	0	0
3	35248492	.	T	A	11	6	17	0	0	17	0	0
3	35249369	.	T	C	14	13	27	0	0	27	0	0
3	35249535	.	T	C	16	12	28	0	0	28	0	0
3	35250145	.	A	T	15	13	28	0	0	28	0	0
3	35250188	.	A	G	12	9	21	0	1	22	0	0
3	35264406	.	T	G	21	28	49	0	2	51	0	0
3	35264460	.	C	T	27	25	52	1	1	54	0	0
3	35264744	.	T	A	16	18	34	0	2	36	0	0
3	35264951	.	G	A	18	12	30	1	3	34	0	0
3	35265350	.	T	C	16	16	32	6	1	39	0	0
3	35265419	.	T	G	14	17	31	0	0	31	0	0
3	35265654	.	G	A	2	25	27	0	25	52	0	0
3	35266006	.	G	A	2	2	4	0	0	4	0	0
3	35298531	.	G	T	11	11	22	0	2	24	0	0
3	35298725	.	T	A	9	11	20	0	0	21	1	0
3	35374719	.	C	T	17	6	23	0	0	24	1	0
3	35375112	.	G	A	11	12	23	0	4	27	0	0
3	35375162	.	T	A	15	12	27	0	3	30	0	0
3	35375279	.	A	T	16	10	26	0	0	26	0	0
3	35375306	.	T	C	17	7	24	0	1	25	0	0
3	35375448	.	T	G	18	0	18	0	19	37	0	0
3	35375638	.	T	A	14	11	25	0	0	25	0	0
3	35406475	.	G	A	5	6	11	0	0	11	0	0
3	35418047	.	A	G	9	9	18	0	2	20	0	0
3	35419683	.	A	T	9	7	16	0	1	17	0	0
3	35420588	.	A	G	4	8	12	0	0	12	0	0
3	35420604	.	C	T	3	8	11	0	0	11	0	0
3	35513674	.	A	G	1	5	6	0	1	7	0	0
3	35514786	.	C	T	10	16	26	0	0	26	0	0
3	35514849	.	C	A	17	6	23	0	3	26	0	0
3	35515053	.	G	T	13	11	24	0	2	26	0	0
3	35515074	.	C	T	12	8	20	0	0	21	1	0
3	35515103	.	G	A	9	8	17	0	0	17	0	0
3	35515179	.	T	C	11	6	17	0	1	18	0	0
3	35515206	.	G	A	8	9	17	0	0	17	0	0
3	35515304	.	T	G	10	10	20	0	0	20	0	0
3	35515866	.	A	T	14	9	23	0	0	23	0	0
3	35517999	.	A	C	12	7	19	0	1	20	0	0
3	35518036	.	C	G	9	10	19	0	1	20	0	0
3	35518464	.	A	C	16	7	23	0	1	24	0	0
3	35518962	.	C	A	12	11	23	0	0	23	0	0
3	35523824	.	C	G	15	16	31	0	1	32	0	0
3	35527024	.	T	C	9	6	15	0	2	17	0	0
3	35529040	.	T	C	8	20	28	0	1	29	0	0
3	35530787	.	C	T	5	7	12	0	1	13	0	0
3	35531018	.	T	C	8	11	19	0	2	21	0	0
3	35531028	.	T	C	12	13	25	0	2	27	0	0
3	35531328	.	G	A	0	11	11	0	10	21	0	0
3	35531329	.	A	T	10	11	21	0	0	21	0	0
3	35531671	.	A	T	11	11	22	0	1	23	0	0
3	35531791	.	A	G	21	0	21	0	20	41	0	0
3	35531866	.	T	A	22	17	39	0	2	41	0	0
3	35531985	.	G	A	15	23	38	0	2	40	0	0
3	35532074	.	A	T	23	16	39	0	0	39	0	0
3	35532452	.	A	T	21	15	36	0	0	36	0	0
3	35532634	.	A	G	11	1	12	0	24	36	0	0
3	35532665	.	C	T	14	23	37	0	0	37	0	0
3	35532736	.	A	C	19	11	30	0	0	30	0	0
3	35535695	.	A	C	3	4	7	0	0	7	0	0
3	35535702	.	G	T	3	4	7	0	0	7	0	0
3	35536115	.	C	G	16	11	27	0	1	28	0	0
3	35536269	.	G	A	10	5	15	0	1	16	0	0
3	35541273	.	A	G	33	28	61	0	1	62	0	0
3	35548636	.	T	C	8	9	17	0	0	17	0	0
3	35548642	.	G	A	8	7	15	0	1	16	0	0
3	35548780	.	T	C	7	5	12	0	0	12	0	0
3	35548903	.	G	A	9	3	12	0	0	12	0	0
3	35549002	.	G	A	6	2	8	0	0	8	0	0
3	35551047	.	A	T	11	15	26	0	2	28	0	0
3	35551190	.	C	T	1	4	5	0	10	15	0	0
3	35589548	.	C	T	22	19	41	0	2	43	0	0
3	35589881	.	T	C	23	28	51	0	2	53	0	0
3	35589908	.	A	G	27	31	58	0	0	58	0	0
3	35589918	.	G	A	25	30	55	0	2	57	0	0
3	35590270	.	T	C	35	6	41	1	27	69	0	0
3	35602007	.	A	C	25	0	25	0	22	47	0	0
3	35602047	.	A	G	26	22	48	0	1	49	0	0
3	35602153	.	A	G	16	27	43	0	0	43	0	0
3	35602154	.	T	A	15	27	42	0	1	43	0	0
3	35608511	.	C	T	4	4	8	0	0	8	0	0
3	35617940	.	A	C	9	4	13	0	1	14	0	0
3	35617943	.	A	C	8	5	13	0	0	13	0	0
3	35621473	.	G	A	1	7	8	0	6	14	0	0
3	35621515	.	T	G	7	0	7	0	6	13	0	0
3	35634953	.	A	G	8	5	13	0	0	13	0	0
3	35635039	.	C	T	7	6	13	0	0	13	0	0
3	35636388	.	A	G	3	3	6	0	0	6	0	0
3	35636410	.	A	G	6	4	10	0	0	10	0	0
3	35637535	.	A	G	3	0	3	0	3	6	0	0
3	35638008	.	T	A	13	7	20	0	0	20	0	0
3	35638119	.	A	C	9	11	20	0	1	21	0	0
3	35638201	.	A	G	14	13	27	0	1	28	0	0
3	35638240	.	C	T	14	4	18	0	1	19	0	0
3	35638366	.	T	C	11	2	13	0	1	14	0	0
3	35638450	.	T	A	9	2	11	0	1	12	0	0
3	35638513	.	G	A	16	9	25	0	0	25	0	0
3	35638908	.	C	T	2	20	22	0	16	38	0	0
3	35638986	.	C	A	16	21	37	1	0	38	0	0
3	35639020	.	A	G	13	25	38	1	0	39	0	0
3	35639021	.	G	A	13	24	37	1	1	39	0	0
3	35639194	.	T	C	16	17	33	0	0	33	0	0
3	35639621	.	A	C	19	10	29	0	0	29	0	0
3	35639817	.	T	A	8	4	12	0	3	15	0	0
3	35639862	.	G	T	8	13	21	0	1	22	0	0
3	35639884	.	T	C	11	0	11	0	9	20	0	0
3	35639958	.	T	C	19	7	26	0	0	26	0	0
3	35640042	.	A	G	8	7	15	0	0	15	0	0
3	35640122	.	G	T	9	9	18	0	3	21	0	0
3	35640441	.	C	A	16	7	23	0	0	23	0	0
3	35640588	.	A	G	11	6	17	0	0	17	0	0
3	35640625	.	C	T	12	15	27	0	1	28	0	0
3	35640784	.	T	C	18	15	33	1	1	35	0	0
3	35640828	.	A	G	15	6	21	1	1	23	0	0
3	35641173	.	C	T	5	9	14	0	1	15	0	0
3	35641371	.	C	T	2	19	21	0	21	42	0	0
3	35641382	.	G	A	16	25	41	0	3	44	0	0
3	35641595	.	A	T	13	16	29	0	2	31	0	0
3	35641785	.	C	T	0	10	10	0	9	19	0	0
3	35642012	.	A	T	14	15	29	0	0	29	0	0
3	35642072	.	A	G	12	16	28	0	0	28	0	0
3	35642242	.	T	C	8	0	8	0	11	19	0	0
3	35642462	.	T	C	16	0	16	0	12	28	0	0
3	35643320	.	G	A	3	8	11	0	1	12	0	0
3	35643357	.	G	A	2	2	4	0	7	11	0	0
3	35643540	.	G	A	17	12	29	0	1	30	0	0
3	35643546	.	A	T	15	10	25	0	1	26	0	0
3	35645380	.	T	C	17	1	18	1	14	33	0	0
3	35645411	.	G	A	15	13	28	3	1	32	0	0
3	35645661	.	T	G	13	19	32	0	4	36	0	0
3	35646025	.	G	T	18	12	30	0	1	31	0	0
3	35646160	.	G	T	10	12	22	0	1	23	0	0
3	35646611	.	T	G	4	13	17	0	0	17	0	0
3	35647181	.	A	G	13	24	37	0	2	39	0	0
3	35647321	.	G	A	8	17	25	0	0	25	0	0
3	35647882	.	G	A	7	5	12	0	0	12	0	0
3	35647975	.	A	G	9	13	22	0	0	22	0	0
3	35652750	.	G	A	8	10	18	0	0	18	0	0
3	35652765	.	G	A	9	7	16	0	0	16	0	0
3	35679270	.	A	G	4	6	10	0	0	10	0	0
3	35800319	.	G	A	7	2	9	0	1	10	0	0
3	35800614	.	C	G	1	7	8	0	3	11	0	0
3	35800738	.	T	C	3	6	9	0	0	9	0	0
3	35831029	.	T	C	2	6	8	0	0	8	0	0
3	35831095	.	G	T	8	3	11	0	0	11	0	0
3	35831167	.	T	C	7	6	13	0	0	13	0	0
3	35840264	.	A	G	5	0	5	0	6	11	0	0
3	35840267	.	T	A	5	6	11	0	0	11	0	0
3	35845735	.	A	G	3	5	8	0	0	8	0	0
3	35845774	.	T	C	1	3	4	0	1	5	0	0
3	35845805	.	A	G	1	4	5	0	0	5	0	0
3	35846120	.	C	G	1	10	11	0	1	12	0	0
3	35846343	.	C	G	4	6	10	2	0	12	0	0
3	35846410	.	A	T	4	12	16	0	0	16	0	0
3	35846440	.	G	A	5	7	12	0	0	12	0	0
3	35846823	.	A	G	5	7	12	0	1	13	0	0
3	35850254	.	G	A	3	4	7	0	0	7	0	0
3	35850364	.	A	G	4	2	6	0	0	6	0	0
3	35858954	.	G	T	4	2	6	0	0	6	0	0
3	35862955	.	G	A	1	2	3	0	0	3	0	0
3	35864419	.	G	A	1	3	4	0	0	4	0	0
3	36023342	.	T	G	24	26	50	0	0	50	0	0
3	36023455	.	A	G	19	24	43	0	2	45	0	0
3	36023465	.	A	G	18	30	48	0	1	49	0	0
3	36026294	.	C	G	1	36	37	0	21	58	0	0
3	36032241	.	G	A	17	30	47	0	0	47	0	0
3	36038631	.	G	A	19	23	42	1	0	43	0	0
3	36040863	.	A	G	27	20	47	0	1	48	0	0
3	36041017	.	A	C	28	21	49	1	4	54	0	0
3	36125256	.	C	G	2	5	7	0	3	10	0	0
3	36127055	.	T	A	1	3	4	0	0	4	0	0
3	36127108	.	G	A	3	3	6	0	0	6	0	0
3	36131883	.	T	A	4	4	8	0	0	8	0	0
3	36132740	.	T	C	11	8	19	0	0	19	0	0
3	36134956	.	T	C	2	1	3	0	1	4	0	0
3	36134960	.	G	T	2	2	4	0	0	4	0	0
3	36135084	.	A	G	4	4	8	0	0	8	0	0
3	36135309	.	G	A	1	2	3	0	0	3	0	0
3	36135641	.	T	A	2	5	7	0	1	8	0	0
3	36135867	.	A	C	3	3	6	0	1	7	0	0
3	36136242	.	T	G	1	2	3	0	0	3	0	0
3	36136405	.	A	T	1	4	5	0	1	6	0	0
3	36143805	.	C	T	0	2	2	0	2	4	0	0
3	36143844	.	G	A	2	3	5	0	0	5	0	0
3	36146491	.	C	A	4	2	6	0	2	8	0	0
3	36146497	.	G	C	3	4	7	0	1	8	0	0
3	36167286	.	T	C	5	8	13	0	1	14	0	0
3	36173633	.	T	C	11	12	23	0	0	23	0	0
3	36174175	.	C	A	17	12	29	0	3	32	0	0
3	36174248	.	C	G	12	7	19	0	2	21	0	0
3	36174276	.	T	C	11	0	11	0	12	23	0	0
3	36184806	.	A	G	18	11	29	0	0	29	0	0
3	36188400	.	A	G	14	9	23	0	0	23	0	0
3	36210030	.	G	A	10	10	20	0	0	20	0	0
3	36210074	.	C	T	5	10	15	0	0	15	0	0
3	36210307	.	T	A	1	3	4	0	0	4	0	0
3	36224109	.	C	T	4	2	6	0	0	6	0	0
3	36228295	.	G	A	1	2	3	0	0	3	0	0
3	36229823	.	G	A	4	3	7	0	0	7	0	0
3	36229886	.	A	T	3	10	13	0	0	13	0	0
3	36232331	.	C	T	3	4	7	0	0	7	0	0
3	36232368	.	A	C	1	6	7	0	0	7	0	0
3	36241839	.	T	C	12	15	27	1	0	28	0	0
3	36241938	.	T	C	11	0	11	0	14	25	0	0
3	36242239	.	C	T	1	12	13	0	12	25	0	0
3	36249172	.	C	T	6	7	13	0	0	13	0	0
3	36249419	.	G	A	20	7	27	0	2	29	0	0
3	36249476	.	T	A	19	17	36	0	0	36	0	0
3	36249516	.	T	A	15	10	25	0	2	27	0	0
3	36249518	.	A	C	17	10	27	0	0	27	0	0
3	36255436	.	A	G	16	29	45	0	0	45	0	0
3	36259855	.	T	C	24	14	38	0	3	41	0	0
3	36262799	.	A	C	16	0	16	0	16	33	1	0
3	36263099	.	T	C	14	0	14	0	20	34	0	0
3	36263151	.	A	G	18	16	34	0	1	35	0	0
3	36263163	.	C	T	17	13	30	0	1	31	0	0
3	36263464	.	C	A	20	17	37	0	0	37	0	0
3	36263557	.	A	G	15	19	34	0	1	35	0	0
3	36263563	.	T	A	14	21	35	0	2	37	0	0
3	36263596	.	T	C	8	1	9	0	14	23	0	0
3	36263666	.	T	C	6	0	6	0	9	15	0	0
3	36263824	.	T	C	21	23	44	0	1	45	0	0
3	36263895	.	A	T	22	17	39	0	2	41	0	0
3	36264028	.	T	C	14	0	14	0	17	31	0	0
3	36264204	.	T	G	12	13	25	0	1	26	0	0
3	36264217	.	A	C	13	14	27	0	1	28	0	0
3	36264248	.	T	C	15	13	28	0	2	30	0	0
3	36265895	.	C	T	1	20	21	0	19	40	0	0
3	36266137	.	T	A	18	18	36	0	1	37	0	0
3	36266173	.	A	G	22	11	33	0	0	33	0	0
3	36268616	.	A	G	22	13	35	0	0	35	0	0
3	36281264	.	C	T	1	2	3	0	0	3	0	0
3	36285177	.	C	A	10	4	14	0	0	14	0	0
3	36291213	.	A	G	19	0	19	0	12	31	0	0
3	36292481	.	G	C	0	9	9	0	18	27	0	0
3	36292657	.	T	C	12	6	18	0	1	19	0	0
3	36293950	.	C	T	7	8	15	0	1	16	0	0
3	36293964	.	C	T	9	9	18	0	1	19	0	0
3	36305854	.	A	G	14	18	32	0	4	36	0	0
3	36305860	.	A	G	19	1	20	0	17	37	0	0
3	36305971	.	T	A	11	7	18	0	0	18	0	0
3	36319778	.	T	A	8	3	11	0	0	11	0	0
3	36322947	.	C	T	6	6	12	0	0	12	0	0
3	36323001	.	T	C	7	4	11	0	0	11	0	0
3	36323064	.	C	T	0	2	2	0	1	3	0	0
3	36323397	.	C	A	4	4	8	0	0	8	0	0
3	36323436	.	A	G	5	2	7	0	0	7	0	0
3	36325569	.	T	A	2	2	4	0	0	4	0	0
3	36325599	.	G	C	1	4	5	0	0	5	0	0
3	36325648	.	A	T	5	5	10	0	1	11	0	0
3	36325726	.	C	T	4	4	8	0	0	8	0	0
3	36326031	.	C	T	3	3	6	0	0	6	0	0
3	36326091	.	A	C	3	5	8	0	0	8	0	0
3	36326108	.	A	T	5	5	10	0	1	11	0	0
3	36326370	.	A	G	3	6	9	0	0	9	0	0
3	36326681	.	T	C	5	4	9	0	0	9	0	0
3	36326685	.	T	A	4	4	8	0	0	8	0	0
3	36326839	.	T	A	5	4	9	0	0	9	0	0
3	36327060	.	G	A	1	4	5	0	7	12	0	0
3	36327061	.	A	C	8	4	12	0	0	12	0	0
3	36327097	.	C	T	12	4	16	0	1	17	0	0
3	36327129	.	G	A	11	8	19	0	1	20	0	0
3	36327306	.	A	T	3	2	5	0	0	5	0	0
3	36327872	.	G	A	11	5	16	0	0	16	0	0
3	36327906	.	G	T	11	4	15	0	0	15	0	0
3	36327909	.	G	T	1	4	5	0	9	14	0	0
3	36328204	.	C	A	5	6	11	0	1	12	0	0
3	36328218	.	G	A	4	8	12	0	1	13	0	0
3	36328339	.	G	A	1	1	2	0	1	3	0	0
3	36328390	.	A	T	2	2	4	0	0	4	0	0
3	36328414	.	T	A	3	2	5	0	0	5	0	0
3	36349176	.	T	C	2	2	4	0	0	4	0	0
3	36402930	.	T	C	3	0	3	0	4	7	0	0
3	36407283	.	C	A	5	4	9	0	0	9	0	0
3	36407604	.	A	G	5	3	8	0	0	8	0	0
3	36409877	.	C	T	5	6	11	0	0	11	0	0
3	36409969	.	T	C	5	2	7	0	1	8	0	0
3	36409995	.	T	C	4	0	4	0	3	7	0	0
3	36410172	.	A	G	3	2	5	0	0	5	0	0
3	36415987	.	A	G	4	2	6	0	0	6	0	0
3	36415999	.	A	C	4	2	6	0	0	6	0	0
3	36419413	.	A	C	2	3	5	0	0	5	0	0
3	36428612	.	T	A	23	17	40	0	0	40	0	0
3	36428620	.	T	A	23	18	41	0	0	41	0	0
3	36431380	.	T	C	25	24	49	1	1	51	0	0
3	36441465	.	G	A	5	2	7	0	1	8	0	0
3	36441484	.	T	C	4	2	6	0	0	6	0	0
3	36442071	.	A	G	4	6	10	0	0	10	0	0
3	36442551	.	C	T	0	12	12	0	12	24	0	0
3	36442661	.	T	G	12	10	22	0	1	23	0	0
3	36442726	.	A	G	17	15	32	0	1	33	0	0
3	36443189	.	G	A	18	12	30	0	1	31	0	0
3	36446613	.	A	G	9	10	19	0	0	19	0	0
3	37051949	.	A	G	3	2	5	0	0	5	0	0
3	37104617	.	A	G	5	2	7	0	0	7	0	0
3	37104671	.	A	G	3	2	5	0	0	5	0	0
3	37104675	.	A	G	2	3	5	0	0	5	0	0
3	37107100	.	G	T	4	4	8	0	0	8	0	0
3	37234561	.	C	A	4	2	6	0	0	6	0	0
3	37237750	.	T	C	11	6	17	0	0	17	0	0
3	37559334	.	A	T	26	30	56	0	1	57	0	0
3	37559905	.	A	C	17	25	42	0	2	44	0	0
3	37564769	.	G	A	22	34	56	0	1	57	0	0
3	37571596	.	C	A	9	4	13	0	2	15	0	0
3	37649598	.	G	C	8	10	18	0	1	19	0	0
3	37660307	.	G	A	8	5	13	0	0	13	0	0
3	37664117	.	A	T	14	8	22	0	0	22	0	0
3	37664635	.	A	G	9	11	20	0	0	20	0	0
3	37665855	.	G	A	16	25	41	0	0	41	0	0
3	37666774	.	C	T	2	14	16	0	26	42	0	0
3	37667562	.	C	T	3	21	24	0	23	47	0	0
3	37667608	.	G	C	26	14	40	0	2	42	0	0
3	37667646	.	C	T	21	14	35	0	2	37	0	0
3	37667952	.	C	T	4	15	19	0	23	43	1	0
3	37668319	.	A	G	12	6	18	0	0	18	0	0
3	37668370	.	T	C	6	5	11	0	0	11	0	0
3	37668578	.	T	A	7	9	16	0	3	19	0	0
3	37668667	.	C	A	9	12	21	0	2	23	0	0
3	37670156	.	G	T	7	7	14	0	0	14	0	0
3	37673750	.	T	A	7	7	14	0	0	14	0	0
3	37726111	.	C	T	2	5	7	0	0	7	0	0
3	37727784	.	T	C	5	2	7	0	1	8	0	0
3	37737680	.	C	A	8	6	14	0	0	14	0	0
3	37737735	.	T	G	8	0	8	0	3	11	0	0
3	37737736	.	C	T	8	3	11	0	0	11	0	0
3	37738024	.	A	G	11	4	15	0	1	16	0	0
3	37738050	.	C	G	6	4	10	0	0	10	0	0
3	37738089	.	G	A	6	4	10	0	0	10	0	0
3	37742116	.	A	C	2	6	8	0	0	8	0	0
3	37742152	.	T	C	6	4	10	0	0	10	0	0
3	37742245	.	C	T	4	6	10	0	0	10	0	0
3	37742247	.	A	G	4	6	10	0	0	10	0	0
3	37742338	.	C	G	3	2	5	0	0	5	0	0
3	37776713	.	T	C	2	2	4	0	0	4	0	0
3	37777309	.	A	T	4	4	8	0	2	11	1	0
3	37777417	.	G	C	3	2	5	0	0	5	0	0
3	37777590	.	C	T	4	6	10	0	0	10	0	0
3	37777811	.	C	T	0	12	12	0	8	20	0	0
3	37781162	.	A	G	9	4	13	0	0	13	0	0
3	37788401	.	T	C	35	23	58	1	3	62	0	0
3	37789216	.	G	T	9	6	15	0	1	16	0	0
3	37824441	.	C	A	8	5	13	0	0	13	0	0
3	37824608	.	C	G	5	2	7	0	1	8	0	0
3	37827364	.	G	A	2	8	10	0	0	10	0	0
3	37827420	.	G	A	1	4	5	0	0	5	0	0
3	37827822	.	C	T	4	10	14	0	1	15	0	0
3	37827948	.	C	T	4	5	9	0	1	10	0	0
3	38505629	.	A	G	20	19	39	0	2	41	0	0
3	38614366	.	C	T	15	10	25	0	0	25	0	0
3	38614426	.	A	G	9	0	9	0	17	26	0	0
3	38614562	.	C	T	15	18	33	0	1	34	0	0
3	38624737	.	A	G	20	0	20	0	12	32	0	0
3	38624823	.	G	A	20	16	36	0	0	36	0	0
3	38625098	.	A	C	16	17	33	0	3	36	0	0
3	38625497	.	G	T	11	13	24	0	0	24	0	0
3	38625559	.	T	C	13	3	16	0	1	17	0	0
3	38625605	.	G	A	21	9	30	0	1	31	0	0
3	38625751	.	A	C	14	11	25	0	1	26	0	0
3	38625901	.	T	G	10	7	17	0	0	17	0	0
3	38649991	.	A	T	13	11	24	0	0	24	0	0
3	38650341	.	T	C	13	6	19	0	0	19	0	0
3	38650348	.	T	C	3	16	19	0	1	20	0	0
3	38650440	.	T	C	5	12	17	0	1	18	0	0
3	38650462	.	T	C	9	12	21	0	1	22	0	0
3	38763153	.	T	A	8	5	13	0	2	15	0	0
3	38763174	.	G	A	4	6	10	0	8	18	0	0
3	38763391	.	A	G	7	5	12	0	1	13	0	0
3	38763449	.	C	T	5	3	8	0	0	8	0	0
3	38763505	.	G	A	9	3	12	0	0	12	0	0
3	38763527	.	C	T	0	3	3	0	7	10	0	0
3	38763564	.	C	A	6	6	12	0	0	12	0	0
3	38763700	.	G	A	7	6	13	0	0	13	0	0
3	38764227	.	C	T	3	3	6	0	2	8	0	0
3	38764229	.	G	A	2	4	6	0	2	8	0	0
3	38764738	.	A	C	4	0	4	0	6	10	0	0
3	38765149	.	A	T	3	3	6	0	1	7	0	0
3	38765811	.	A	T	1	4	5	0	0	5	0	0
3	38766207	.	C	T	0	11	11	0	14	25	0	0
3	38766395	.	G	A	9	4	13	0	0	13	0	0
3	38766507	.	G	A	4	6	10	0	1	11	0	0
3	38766759	.	G	A	4	2	6	0	0	6	0	0
3	38767750	.	T	C	7	4	11	0	0	11	0	0
3	38793631	.	C	T	6	6	12	0	0	12	0	0
3	38793674	.	A	G	5	3	8	0	1	9	0	0
3	38793729	.	G	T	1	3	4	0	2	6	0	0
3	38793808	.	G	A	1	3	4	0	0	4	0	0
3	38858514	.	T	G	2	0	2	0	7	9	0	0
3	38858649	.	A	G	5	4	9	0	1	10	0	0
3	38858673	.	C	A	4	6	10	0	0	10	0	0
3	38858722	.	G	A	4	2	6	0	1	7	0	0
3	38858949	.	G	C	5	8	13	0	1	14	0	0
3	38859066	.	G	A	5	4	9	0	0	9	0	0
3	38859126	.	A	T	3	3	6	0	0	6	0	0
3	39181560	.	A	C	3	3	6	0	1	7	0	0
3	39181635	.	C	T	2	5	7	0	0	7	0	0
3	39181793	.	A	G	2	2	4	0	0	4	0	0
3	39181823	.	A	G	4	2	6	0	0	6	0	0
3	39181849	.	A	G	3	5	8	0	0	8	0	0
3	39184156	.	A	G	6	10	16	0	0	16	0	0
3	39184180	.	C	T	6	11	17	0	0	17	0	0
3	39184710	.	A	G	6	11	17	0	0	17	0	0
3	39184883	.	C	T	5	7	12	0	2	14	0	0
3	39186729	.	T	C	4	3	7	0	0	7	0	0
3	39238579	.	C	A	4	7	11	0	1	12	0	0
3	39238580	.	C	A	4	8	12	0	0	12	0	0
3	39239380	.	A	G	20	19	39	0	2	41	0	0
3	39241350	.	G	T	16	19	35	0	0	35	0	0
3	39248863	.	A	G	10	13	23	0	0	23	0	0
3	39251020	.	G	T	14	11	25	0	0	25	0	0
3	39251341	.	T	C	7	12	19	0	0	19	0	0
3	39259624	.	T	C	8	0	8	0	15	23	0	0
3	39260818	.	A	G	4	3	7	0	0	7	0	0
3	39260934	.	G	A	2	3	5	0	0	5	0	0
3	39261182	.	C	A	0	4	4	0	2	6	0	0
3	39261230	.	C	T	2	3	5	0	0	5	0	0
3	39261270	.	C	T	0	2	2	0	2	4	0	0
3	39261843	.	T	G	1	2	3	0	1	4	0	0
3	39262694	.	A	G	3	2	5	0	0	5	0	0
3	39262695	.	T	A	2	1	3	0	2	5	0	0
3	39262786	.	G	A	3	3	6	0	0	6	0	0
3	39262801	.	C	A	1	3	4	0	3	7	0	0
3	39263316	.	G	C	2	0	2	0	2	4	0	0
3	39263324	.	T	C	2	0	2	0	2	4	0	0
3	39313310	.	A	G	6	7	13	0	1	14	0	0
3	39313625	.	T	C	7	3	10	0	0	10	0	0
3	39314028	.	C	T	8	21	29	0	2	31	0	0
3	39314101	.	T	C	11	16	27	0	1	28	0	0
3	39314146	.	C	G	10	11	21	0	0	21	0	0
3	39314260	.	A	G	7	9	16	0	0	16	0	0
3	39314502	.	G	C	18	11	29	0	1	30	0	0
3	39314631	.	C	T	1	6	7	0	15	22	0	0
3	39314677	.	C	T	9	7	16	0	0	16	0	0
3	39314857	.	G	T	6	2	8	0	0	8	0	0
3	39314893	.	C	A	7	2	9	0	0	9	0	0
3	39314899	.	C	T	7	2	9	0	0	9	0	0
3	39315154	.	C	A	3	10	13	0	0	13	0	0
3	39315169	.	C	G	3	10	13	0	0	13	0	0
3	39315191	.	C	G	5	6	11	0	0	11	0	0
3	39315229	.	A	T	5	3	8	0	0	8	0	0
3	39315292	.	A	G	3	6	9	0	0	9	0	0
3	39315728	.	C	T	5	7	12	0	0	12	0	0
3	39315737	.	T	C	6	6	12	0	0	12	0	0
3	39315816	.	A	G	3	10	13	0	0	13	0	0
3	39315874	.	C	A	8	14	22	0	0	22	0	0
3	39315876	.	C	T	6	14	20	0	2	22	0	0
3	39315937	.	A	C	12	0	12	0	5	17	0	0
3	39316037	.	T	C	9	9	18	0	0	18	0	0
3	39316062	.	G	A	12	15	27	0	0	27	0	0
3	39316167	.	A	G	8	10	18	0	1	19	0	0
3	39316570	.	G	A	5	12	17	0	0	17	0	0
3	39316846	.	T	C	14	18	32	0	1	33	0	0
3	39316906	.	C	A	13	21	34	0	3	38	1	0
3	39316912	.	G	A	13	22	35	0	0	35	0	0
3	39316996	.	A	G	20	23	43	0	2	45	0	0
3	39317215	.	C	G	16	7	23	0	1	24	0	0
3	39317279	.	C	T	8	13	21	0	2	23	0	0
3	39317310	.	T	C	9	12	21	0	0	21	0	0
3	39317370	.	C	T	7	8	15	0	2	17	0	0
3	39322109	.	G	A	8	12	20	0	0	20	0	0
3	39328095	.	G	C	13	14	27	0	0	27	0	0
3	39330407	.	T	C	5	0	5	0	18	23	0	0
3	39348533	.	G	A	10	10	20	0	1	21	0	0
3	39348914	.	G	A	4	9	13	0	1	14	0	0
3	39454708	.	C	G	4	3	7	0	0	7	0	0
3	39454892	.	T	C	2	0	2	0	5	7	0	0
3	39563142	.	T	C	1	2	3	0	0	3	0	0
3	39563144	.	T	C	1	2	3	0	0	3	0	0
3	39563370	.	G	T	1	2	3	0	0	3	0	0
3	39568368	.	T	G	16	24	40	0	0	40	0	0
3	39568856	.	A	G	29	31	60	1	0	61	0	0
3	39574883	.	C	A	28	33	61	0	8	69	0	0
3	39574961	.	G	A	38	38	76	0	2	78	0	0
3	39576621	.	T	G	29	3	32	0	41	73	0	0
3	39576663	.	A	G	38	37	75	0	5	80	0	0
3	39576866	.	T	C	24	12	36	0	3	39	0	0
3	39579616	.	C	A	2	3	5	0	0	5	0	0
3	39579660	.	G	T	6	3	9	0	0	9	0	0
3	39580908	.	T	C	4	8	12	0	0	12	0	0
3	39592797	.	C	T	7	4	11	0	0	11	0	0
3	39592800	.	G	C	0	4	4	0	8	12	0	0
3	39606220	.	C	T	6	9	15	0	1	16	0	0
3	39612261	.	T	A	11	13	24	0	0	24	0	0
3	39612430	.	T	C	12	5	17	0	1	18	0	0
3	39612579	.	G	C	9	11	20	0	3	23	0	0
3	39612715	.	A	T	9	9	18	0	0	18	0	0
3	39613024	.	T	C	12	5	17	0	0	17	0	0
3	39631505	.	T	C	5	2	7	0	0	7	0	0
3	39634053	.	T	A	1	2	3	0	1	4	0	0
3	39663915	.	C	T	4	5	9	0	1	10	0	0
3	39663929	.	T	C	5	4	9	0	1	10	0	0
3	39664211	.	C	T	3	2	5	0	0	5	0	0
3	39683715	.	A	G	4	2	6	0	0	6	0	0
3	39685635	.	G	T	1	4	5	0	3	8	0	0
3	39686776	.	T	A	6	4	10	0	2	12	0	0
3	39686807	.	A	T	7	5	12	0	0	12	0	0
3	39688558	.	T	G	2	6	8	0	0	8	0	0
3	39688716	.	A	C	1	2	3	0	0	3	0	0
3	39688745	.	A	T	1	2	3	0	0	3	0	0
3	39688892	.	T	C	2	5	7	0	1	8	0	0
3	39688906	.	C	T	1	4	5	0	2	7	0	0
3	39689216	.	T	C	9	5	14	0	0	14	0	0
3	39689234	.	G	T	9	3	12	0	1	13	0	0
3	39691795	.	C	T	1	3	4	0	0	4	0	0
3	39692165	.	A	T	3	4	7	0	0	7	0	0
3	39692196	.	C	T	0	6	6	0	7	13	0	0
3	39692206	.	C	T	4	7	11	0	2	13	0	0
3	39692235	.	C	A	6	9	15	0	1	16	0	0
3	39692265	.	G	A	9	7	16	0	1	17	0	0
3	39692307	.	A	G	6	9	15	0	0	15	0	0
3	39695744	.	T	C	7	7	14	0	0	14	0	0
3	39876186	.	C	T	4	3	7	0	0	7	0	0
3	39878663	.	C	T	6	5	11	0	0	11	0	0
3	39878822	.	T	C	5	7	12	0	0	12	0	0
3	39884348	.	G	A	0	3	3	0	13	16	0	0
3	39923512	.	G	A	1	4	5	0	1	6	0	0
3	39925012	.	T	G	9	1	10	0	10	20	0	0
3	39925087	.	T	C	9	4	13	0	0	13	0	0
3	39940210	.	T	C	11	5	16	0	1	17	0	0
3	39945696	.	A	G	7	4	11	0	0	11	0	0
3	39949389	.	G	A	11	11	22	0	0	22	0	0
3	39949650	.	G	A	0	13	13	0	16	29	0	0
3	39950276	.	A	C	16	11	27	0	3	30	0	0
3	39950340	.	C	T	17	7	24	0	0	24	0	0
3	39950414	.	T	C	11	16	27	0	3	30	0	0
3	39951124	.	C	T	5	11	16	0	0	16	0	0
3	39951216	.	T	C	12	5	17	0	0	17	0	0
3	39951703	.	A	T	12	9	21	0	0	21	0	0
3	39952025	.	T	C	8	4	12	0	1	13	0	0
3	39952272	.	A	G	10	8	18	0	0	18	0	0
3	39952273	.	A	T	9	8	17	0	1	18	0	0
3	39958680	.	C	T	4	8	12	0	0	12	0	0
3	39958729	.	T	A	8	8	16	0	0	16	0	0
3	39959679	.	A	C	6	8	14	0	4	18	0	0
3	39960535	.	G	C	0	9	9	0	6	15	0	0
3	39962906	.	T	G	3	11	14	0	1	15	0	0
3	39962981	.	T	C	8	5	13	0	0	13	0	0
3	39963053	.	T	C	10	7	17	0	0	17	0	0
3	39963089	.	A	G	6	5	11	0	2	13	0	0
3	39963128	.	G	A	6	2	8	0	1	9	0	0
3	39963131	.	A	G	5	2	7	0	0	7	0	0
3	39967177	.	C	T	1	2	3	0	0	3	0	0
3	39970555	.	G	A	9	3	12	0	1	13	0	0
3	39970641	.	T	G	8	15	23	0	0	23	0	0
3	39971335	.	T	A	6	4	10	0	0	10	0	0
3	39971365	.	T	C	4	2	6	0	0	6	0	0
3	39971373	.	T	C	3	2	5	0	1	6	0	0
3	39971470	.	T	C	5	9	14	0	0	14	0	0
3	39971499	.	T	C	5	8	13	0	0	13	0	0
3	39971592	.	T	C	5	5	10	0	0	10	0	0
3	39971657	.	T	C	9	3	12	0	2	14	0	0
3	39971894	.	T	C	11	8	19	0	0	19	0	0
3	39972055	.	T	C	9	3	12	0	0	12	0	0
3	39972073	.	G	A	6	7	13	0	0	13	0	0
3	39975467	.	T	C	10	0	10	0	5	15	0	0
3	39982019	.	C	T	3	11	14	0	1	15	0	0
3	39982198	.	A	T	5	4	9	0	0	9	0	0
3	39984551	.	C	T	0	2	2	0	6	8	0	0
3	39984581	.	G	A	3	5	8	0	0	8	0	0
3	39984776	.	G	T	6	5	11	0	0	11	0	0
3	39987992	.	T	C	4	0	4	0	7	11	0	0
3	39990027	.	A	C	5	5	10	0	0	10	0	0
3	40003947	.	T	G	5	7	12	0	0	12	0	0
3	40003965	.	C	T	13	2	15	0	0	15	0	0
3	40015463	.	A	G	2	2	4	0	0	4	0	0
3	40015490	.	C	T	0	1	1	0	1	2	0	0
3	40015499	.	T	C	3	2	5	0	0	5	0	0
3	40054647	.	C	T	0	9	9	0	7	16	0	0
3	40207086	.	T	C	18	15	33	0	2	35	0	0
3	40256199	.	A	T	7	6	13	0	0	13	0	0
3	40256334	.	T	C	6	10	16	0	0	16	0	0
3	40256418	.	C	T	7	7	14	0	1	15	0	0
3	40257357	.	A	G	4	0	4	0	9	13	0	0
3	40258465	.	T	C	6	17	23	0	0	23	0	0
3	40278023	.	C	T	1	17	18	0	13	31	0	0
3	40278180	.	T	C	14	0	14	0	19	33	0	0
3	40280034	.	T	C	11	17	28	0	1	29	0	0
3	40284375	.	T	C	15	0	15	0	13	28	0	0
3	40284447	.	T	A	12	12	24	0	0	24	0	0
3	40284860	.	G	T	14	9	23	1	0	24	0	0
3	40284982	.	T	C	13	25	38	0	2	40	0	0
3	40287185	.	G	C	1	7	8	0	7	15	0	0
3	40287188	.	G	A	9	8	17	0	0	17	0	0
3	40287227	.	C	T	9	5	14	0	0	14	0	0
3	40290123	.	T	C	5	9	14	0	1	15	0	0
3	40290138	.	A	G	4	7	11	0	0	11	0	0
3	40294179	.	G	A	6	8	14	0	0	14	0	0
3	40294260	.	A	T	8	10	18	0	0	18	0	0
3	40294511	.	G	C	5	8	13	0	0	13	0	0
3	40297428	.	G	A	37	30	67	0	0	67	0	0
3	40297479	.	C	T	39	29	68	0	0	68	0	0
3	40299995	.	G	A	31	41	72	0	0	72	0	0
3	40301233	.	A	G	4	8	12	0	0	12	0	0
3	40315555	.	G	T	15	4	19	0	1	20	0	0
3	40318555	.	C	G	6	7	13	0	0	13	0	0
3	40318556	.	C	G	6	7	13	0	0	13	0	0
3	40318613	.	A	G	12	4	16	0	0	16	0	0
3	40318733	.	T	A	6	4	10	0	0	10	0	0
3	40318754	.	T	C	4	2	6	0	2	8	0	0
3	40329683	.	T	C	4	6	10	0	1	11	0	0
3	40333577	.	A	G	3	0	3	0	6	9	0	0
3	40333592	.	C	T	3	5	8	0	0	8	0	0
3	40333700	.	A	G	7	0	7	0	8	15	0	0
3	40333793	.	T	C	10	10	20	0	0	20	0	0
3	40346035	.	C	T	14	15	29	0	0	29	0	0
3	40346059	.	T	C	18	13	31	0	2	33	0	0
3	40348839	.	T	C	19	16	35	1	0	36	0	0
3	40349310	.	A	G	10	8	18	0	0	18	0	0
3	40349354	.	T	G	3	7	10	0	0	10	0	0
3	40404937	.	C	T	1	2	3	0	0	3	0	0
3	40430922	.	G	A	2	9	11	0	14	26	1	0
3	40443096	.	C	G	9	12	21	0	2	23	0	0
3	40444020	.	C	T	10	6	16	0	0	16	0	0
3	40444539	.	T	C	12	11	23	0	2	25	0	0
3	40448097	.	A	C	11	11	22	0	1	23	0	0
3	40448130	.	A	G	13	0	13	0	11	24	0	0
3	40448220	.	T	C	16	8	24	0	0	24	0	0
3	40449595	.	C	A	12	18	30	0	0	30	0	0
3	40449603	.	T	C	14	14	28	0	0	28	0	0
3	40449696	.	C	T	11	14	25	0	1	26	0	0
3	40450743	.	C	T	21	13	34	0	1	35	0	0
3	40450961	.	T	G	14	0	14	0	14	28	0	0
3	40451268	.	C	T	12	11	23	0	0	23	0	0
3	40451319	.	T	C	14	8	22	0	1	23	0	0
3	40451352	.	A	T	5	4	9	0	2	11	0	0
3	40451407	.	A	G	5	0	5	0	5	10	0	0
3	40451574	.	A	C	10	4	14	0	1	15	0	0
3	40452119	.	G	C	11	14	25	0	0	25	0	0
3	40452134	.	A	G	12	0	12	0	12	24	0	0
3	40458531	.	C	A	7	19	26	0	0	26	0	0
3	40458594	.	G	A	1	10	11	0	16	27	0	0
3	40467464	.	C	T	16	7	23	0	0	23	0	0
3	40467693	.	A	G	14	0	14	1	14	29	0	0
3	40467756	.	C	T	18	14	32	0	4	36	0	0
3	40469891	.	T	C	14	17	31	0	2	33	0	0
3	40480877	.	G	A	2	13	15	0	22	37	0	0
3	40480986	.	G	T	22	17	39	0	0	39	0	0
3	40481346	.	G	A	1	14	15	0	18	33	0	0
3	40481459	.	C	T	26	11	37	0	2	39	0	0
3	40481513	.	A	G	14	13	27	0	0	27	0	0
3	40481649	.	T	G	12	10	22	0	1	23	0	0
3	40481930	.	T	A	20	21	41	0	0	41	0	0
3	40482007	.	T	C	19	16	35	0	0	35	0	0
3	40482027	.	A	G	15	0	15	0	13	28	0	0
3	40482289	.	C	A	28	16	44	1	4	49	0	0
3	40482446	.	A	G	19	25	44	0	3	47	0	0
3	40484376	.	A	T	10	20	30	0	1	31	0	0
3	40485360	.	C	A	8	15	23	0	0	23	0	0
3	40485378	.	T	G	7	17	24	0	0	24	0	0
3	40485422	.	G	T	2	24	26	0	13	39	0	0
3	40485499	.	G	A	14	19	33	0	0	33	0	0
3	40485965	.	G	C	8	10	18	0	2	20	0	0
3	40487095	.	G	T	9	12	21	0	2	23	0	0
3	40487162	.	A	C	8	8	16	2	2	20	0	0
3	40487385	.	T	A	11	11	22	0	1	23	0	0
3	40487704	.	T	C	36	10	46	0	1	47	0	0
3	40487820	.	A	G	17	13	30	0	2	32	0	0
3	40487821	.	G	C	18	12	30	0	2	32	0	0
3	40488212	.	C	T	17	14	31	0	2	33	0	0
3	40488264	.	C	T	5	16	21	0	14	35	0	0
3	40488630	.	T	C	1	4	5	0	0	5	0	0
3	40488640	.	T	C	0	4	4	0	0	4	0	0
3	40527028	.	G	A	45	41	86	1	3	90	0	0
3	40527512	.	G	A	38	36	74	1	3	78	0	0
3	40527575	.	G	A	52	62	114	4	14	132	0	0
3	40527665	.	A	G	15	8	23	0	0	23	0	0
3	40527727	.	G	A	11	15	26	0	0	26	0	0
3	40528132	.	C	T	0	3	3	0	1	4	0	0
3	40528241	.	A	T	33	38	71	0	4	75	0	0
3	40576600	.	C	T	22	29	51	0	4	55	0	0
3	40576736	.	C	T	27	18	45	0	2	47	0	0
3	40576972	.	A	G	24	0	24	0	27	51	0	0
3	40577032	.	C	T	26	20	46	0	3	49	0	0
3	40583989	.	C	G	24	23	47	0	2	49	0	0
3	40584318	.	T	A	22	23	45	0	2	47	0	0
3	40587967	.	C	T	25	28	53	0	3	56	0	0
3	40588109	.	A	T	26	27	53	0	0	53	0	0
3	40588195	.	T	C	25	19	44	0	4	48	0	0
3	40588363	.	C	T	25	18	43	0	3	46	0	0
3	40588410	.	C	A	24	23	47	0	1	49	1	0
3	40588467	.	T	C	32	16	48	0	0	48	0	0
3	40588595	.	A	C	22	16	38	0	1	39	0	0
3	40588746	.	C	G	16	25	41	0	0	41	0	0
3	40588845	.	A	G	20	17	37	0	3	40	0	0
3	40589147	.	T	C	35	21	56	0	1	57	0	0
3	40589179	.	C	A	37	23	60	0	1	61	0	0
3	40589191	.	T	G	34	21	55	0	2	57	0	0
3	40589214	.	C	A	28	24	52	0	2	54	0	0
3	40589232	.	A	G	30	21	51	0	2	53	0	0
3	40589266	.	C	T	18	20	38	0	3	41	0	0
3	40589348	.	A	G	15	15	30	0	2	33	1	0
3	40589356	.	A	G	19	14	33	0	1	34	0	0
3	40690704	.	T	C	8	0	8	0	10	18	0	0
3	40690901	.	G	A	5	4	9	0	1	10	0	0
3	40690937	.	T	A	5	4	9	0	0	9	0	0
3	40691448	.	A	G	6	6	12	0	0	12	0	0
3	40691473	.	A	T	7	4	11	0	3	14	0	0
3	40691643	.	A	T	4	6	10	0	0	11	1	0
3	40691969	.	C	T	11	8	19	0	1	20	0	0
3	40692064	.	A	T	8	6	14	0	0	15	1	0
3	40698424	.	C	A	7	10	17	1	1	19	0	0
3	40698481	.	A	G	5	6	11	0	0	11	0	0
3	40712935	.	G	A	4	12	16	0	0	16	0	0
3	40713085	.	G	T	18	8	26	0	3	29	0	0
3	40715629	.	T	C	6	6	12	0	0	12	0	0
3	40768371	.	A	T	5	7	12	0	1	13	0	0
3	40804286	.	T	G	30	5	35	2	1	38	0	0
3	40814521	.	T	C	6	5	11	0	0	11	0	0
3	40814587	.	G	A	3	6	9	0	1	10	0	0
3	40819959	.	A	C	2	6	8	0	3	11	0	0
3	40820007	.	A	G	5	4	9	0	0	9	0	0
3	40821838	.	C	A	12	15	27	0	0	27	0	0
3	40821871	.	A	T	17	16	33	0	3	36	0	0
3	40821953	.	C	A	2	17	19	0	15	34	0	0
3	40828768	.	T	C	8	0	8	0	12	20	0	0
3	40870729	.	A	T	1	3	4	0	0	4	0	0
3	40870775	.	G	C	3	2	5	0	0	5	0	0
3	40870784	.	A	C	3	3	6	0	0	6	0	0
3	40871189	.	C	T	2	2	4	0	0	4	0	0
3	40882964	.	A	T	2	5	7	0	0	7	0	0
3	40883137	.	C	T	1	3	4	0	0	4	0	0
3	40885949	.	A	G	3	4	7	0	0	7	0	0
3	40885997	.	C	A	2	6	8	0	0	8	0	0
3	40887999	.	C	T	0	6	6	0	4	10	0	0
3	40888004	.	G	T	3	6	9	0	1	10	0	0
3	40895235	.	T	A	3	2	5	0	0	5	0	0
3	40895265	.	A	G	3	2	5	0	0	5	0	0
3	40902163	.	C	T	1	8	9	0	7	16	0	0
3	40907953	.	T	C	8	0	8	0	12	20	0	0
3	40913730	.	G	A	9	14	23	0	0	23	0	0
3	40927653	.	C	T	13	8	21	0	0	21	0	0
3	40969547	.	C	T	0	2	2	0	5	7	0	0
3	40973539	.	C	T	7	3	10	0	0	10	0	0
3	40974632	.	G	A	1	2	3	0	0	3	0	0
3	40979281	.	T	C	1	2	3	0	0	3	0	0
3	40980024	.	G	A	7	3	10	0	0	10	0	0
3	40980166	.	T	A	11	7	18	0	0	18	0	0
3	40983062	.	A	G	10	8	18	0	0	18	0	0
3	40983077	.	G	A	10	7	17	0	0	17	0	0
3	40985992	.	T	C	9	10	19	0	1	20	0	0
3	40997589	.	T	A	3	2	5	0	0	5	0	0
3	41003413	.	G	A	9	5	14	0	0	14	0	0
3	41023331	.	G	A	5	6	11	0	0	11	0	0
3	41037795	.	A	C	10	0	10	0	7	17	0	0
3	41047649	.	C	T	3	3	6	0	0	6	0	0
3	41069430	.	G	A	6	5	11	0	0	11	0	0
3	41084346	.	C	T	8	3	11	0	0	11	0	0
3	41084442	.	G	C	5	1	6	0	4	10	0	0
3	41092137	.	A	T	6	10	16	0	1	17	0	0
3	41092392	.	T	A	4	3	7	0	0	7	0	0
3	41103034	.	T	C	3	0	3	0	7	10	0	0
3	41162819	.	C	T	2	5	7	0	0	7	0	0
3	41165422	.	G	A	1	2	3	0	0	3	0	0
3	41165431	.	A	C	1	3	4	0	0	4	0	0
3	41511148	.	G	C	2	2	4	0	0	4	0	0
3	41511204	.	T	A	3	2	5	0	0	5	0	0
3	41705141	.	T	C	4	2	6	0	0	6	0	0
3	41705268	.	A	C	2	2	4	0	0	4	0	0
3	41705468	.	A	T	5	1	6	0	0	6	0	0
3	41705476	.	C	T	3	1	4	0	1	5	0	0
3	41705560	.	A	G	2	4	6	0	0	6	0	0
3	41705597	.	C	T	2	4	6	0	0	6	0	0
3	41705949	.	G	A	4	2	6	0	1	7	0	0
3	41719049	.	G	A	16	10	26	0	1	27	0	0
3	41721916	.	G	A	18	10	28	0	2	30	0	0
3	41723437	.	G	A	13	16	29	0	0	29	0	0
3	41724806	.	G	A	17	7	24	0	2	26	0	0
3	41917608	.	G	T	6	3	9	0	1	10	0	0
3	41917747	.	T	C	5	7	12	0	1	13	0	0
3	41917830	.	T	C	2	4	6	0	0	6	0	0
3	41922587	.	C	T	4	6	10	0	0	10	0	0
3	41922799	.	C	T	5	3	8	0	1	9	0	0
3	41925154	.	C	T	4	5	9	0	0	9	0	0
3	41925508	.	A	G	1	2	3	0	0	3	0	0
3	41925541	.	C	G	3	3	6	0	0	6	0	0
3	41925823	.	C	T	3	3	6	0	1	7	0	0
3	41925889	.	T	C	1	3	4	0	1	5	0	0
3	41926020	.	T	A	4	5	9	0	1	10	0	0
3	41955449	.	A	G	2	3	5	0	0	5	0	0
3	41955613	.	G	T	17	9	26	0	2	28	0	0
3	41955911	.	C	G	11	17	28	0	1	29	0	0
3	41956040	.	G	T	14	13	27	0	0	27	0	0
3	41956299	.	T	C	7	7	14	0	1	15	0	0
3	41956353	.	T	A	10	11	21	0	0	21	0	0
3	41956467	.	T	A	4	3	7	0	0	7	0	0
3	41956504	.	C	T	3	2	5	0	0	5	0	0
3	41956581	.	C	A	2	3	5	0	0	5	0	0
3	41956584	.	T	A	2	3	5	0	0	5	0	0
3	41956792	.	A	T	6	18	24	0	0	24	0	0
3	41956818	.	T	C	9	15	24	0	1	25	0	0
3	41956837	.	T	G	13	13	26	0	0	26	0	0
3	41956855	.	C	T	11	16	27	0	0	27	0	0
3	41956921	.	T	A	4	10	14	1	0	15	0	0
3	41956941	.	T	C	8	4	12	1	1	14	0	0
3	41956978	.	G	A	6	11	17	0	0	17	0	0
3	41957580	.	G	T	9	8	17	0	0	17	0	0
3	41957660	.	A	T	4	2	6	0	1	7	0	0
3	41957918	.	T	G	1	2	3	0	0	3	0	0
3	41957924	.	C	T	2	3	5	0	2	7	0	0
3	41958291	.	T	G	6	5	11	0	0	11	0	0
3	41958690	.	C	T	1	2	3	0	0	3	0	0
3	41958705	.	T	A	1	3	4	0	0	4	0	0
3	41959370	.	G	T	8	13	21	0	1	22	0	0
3	41959658	.	G	T	9	11	20	0	0	20	0	0
3	41959772	.	A	G	10	11	21	0	1	22	0	0
3	41959906	.	T	A	8	8	16	0	0	16	0	0
3	41959943	.	T	C	7	7	14	0	0	14	0	0
3	41959958	.	A	G	7	4	11	0	0	11	0	0
3	41960005	.	C	A	8	6	14	0	0	14	0	0
3	41960069	.	G	T	10	6	16	0	1	18	1	0
3	41960346	.	A	G	3	7	10	0	0	10	0	0
3	41960652	.	G	A	2	2	4	0	0	4	0	0
3	41960654	.	T	A	1	2	3	0	1	4	0	0
3	41961314	.	G	A	7	5	12	0	0	12	0	0
3	41961341	.	T	G	7	6	13	0	1	15	1	0
3	41961469	.	A	G	7	12	19	0	0	19	0	0
3	41961558	.	A	T	6	13	19	0	0	19	0	0
3	41961587	.	T	G	6	12	18	0	1	19	0	0
3	41961651	.	G	A	6	7	13	0	0	13	0	0
3	41961688	.	T	C	8	0	8	0	13	21	0	0
3	41961993	.	C	G	0	6	6	0	9	15	0	0
3	41962098	.	T	C	10	6	16	0	1	17	0	0
3	41962463	.	G	A	3	4	7	0	2	9	0	0
3	41985866	.	G	A	4	9	13	0	1	14	0	0
3	41985953	.	C	T	2	8	10	0	1	11	0	0
3	41985959	.	G	A	2	8	10	0	0	10	0	0
3	42016675	.	A	T	5	6	11	0	1	12	0	0
3	42016682	.	C	G	0	8	8	0	5	13	0	0
3	42121500	.	G	A	2	2	4	0	0	4	0	0
3	42125556	.	G	A	2	2	4	0	0	4	0	0
3	42125560	.	G	A	2	2	4	0	0	4	0	0
3	42126551	.	A	G	2	4	6	0	0	6	0	0
3	42126594	.	A	T	1	1	2	0	1	3	0	0
3	42126782	.	A	G	1	0	1	0	5	6	0	0
3	42918924	.	C	A	13	10	23	0	2	25	0	0
3	42919474	.	C	T	15	4	19	0	1	20	0	0
3	42919510	.	C	T	10	6	16	0	0	16	0	0
3	42919664	.	C	T	6	3	9	0	0	9	0	0
3	42919846	.	T	G	6	2	8	0	0	8	0	0
3	42919849	.	C	T	6	2	8	0	0	8	0	0
3	42919943	.	G	C	5	3	8	0	0	8	0	0
3	42919959	.	A	T	5	3	8	0	0	8	0	0
3	43000474	.	A	G	3	3	6	0	0	6	0	0
3	43009405	.	G	A	2	2	4	0	1	5	0	0
3	43011376	.	C	T	2	2	4	0	0	4	0	0
3	43014396	.	T	C	4	2	6	0	1	7	0	0
3	43017888	.	A	C	7	5	12	0	0	12	0	0
3	43017912	.	T	C	6	3	9	0	0	10	1	0
3	43018270	.	C	T	2	4	6	0	0	6	0	0
3	43018281	.	C	T	1	5	6	0	1	7	0	0
3	43024872	.	T	C	1	4	5	0	0	5	0	0
3	43025019	.	C	T	3	2	5	0	0	5	0	0
3	43029889	.	T	C	3	5	8	0	0	8	0	0
3	43038222	.	G	A	4	5	9	0	1	10	0	0
3	43039306	.	A	G	6	8	14	0	2	16	0	0
3	43040677	.	G	A	0	8	8	0	3	11	0	0
3	43052230	.	T	C	2	6	8	0	0	8	0	0
3	43059090	.	A	G	6	7	13	0	1	14	0	0
3	43059153	.	A	G	8	7	15	0	0	15	0	0
3	43060866	.	T	C	1	4	5	0	1	6	0	0
3	43376543	.	A	G	5	5	10	0	0	10	0	0
3	43380283	.	C	T	9	6	15	0	0	15	0	0
3	43392755	.	T	A	6	8	14	0	1	15	0	0
3	43392795	.	C	A	4	4	8	0	0	8	0	0
3	43467654	.	T	C	8	4	12	0	0	12	0	0
3	43474920	.	A	T	8	10	18	0	0	18	0	0
3	43475184	.	C	T	6	6	12	0	0	12	0	0
3	43475265	.	G	A	5	9	14	0	0	14	0	0
3	43475325	.	A	G	12	10	22	0	0	22	0	0
3	43475376	.	T	C	9	11	20	0	1	21	0	0
3	43475397	.	C	T	6	12	18	0	0	18	0	0
3	43475592	.	A	C	6	2	8	0	1	9	0	0
3	43475617	.	G	T	1	3	4	0	5	9	0	0
3	43475654	.	C	T	5	4	9	0	0	9	0	0
3	43475742	.	G	T	5	4	9	0	0	9	0	0
3	43475772	.	A	G	6	4	10	0	0	10	0	0
3	43476088	.	G	T	6	3	9	0	0	9	0	0
3	43476097	.	C	A	6	3	9	0	0	9	0	0
3	43476514	.	A	C	8	8	16	0	0	16	0	0
3	43476698	.	A	G	4	6	10	0	0	10	0	0
3	43476880	.	C	T	5	6	11	0	0	11	0	0
3	43476887	.	T	G	4	6	10	0	0	10	0	0
3	43477749	.	G	C	5	3	8	0	0	8	0	0
3	43477975	.	T	G	4	3	7	0	1	8	0	0
3	43478137	.	T	C	7	7	14	0	0	14	0	0
3	43478238	.	C	T	6	6	12	0	0	12	0	0
3	43478310	.	T	G	7	10	17	0	1	18	0	0
3	43478321	.	A	G	5	0	5	0	10	15	0	0
3	43478433	.	A	T	4	7	11	0	0	11	0	0
3	43478586	.	C	T	4	2	6	0	0	6	0	0
3	43579820	.	C	T	2	9	11	0	14	25	0	0
3	43580055	.	A	G	16	5	21	0	0	21	0	0
3	43580195	.	A	T	8	7	15	0	0	15	0	0
3	43580583	.	T	C	7	11	18	0	0	18	0	0
3	43581272	.	A	C	13	7	20	1	2	23	0	0
3	43584453	.	T	C	14	10	24	0	0	24	0	0
3	43594256	.	A	G	13	12	25	0	0	25	0	0
3	43594358	.	C	T	11	12	23	0	2	25	0	0
3	43594376	.	C	T	3	15	18	0	8	26	0	0
3	43594577	.	G	A	14	7	21	0	1	22	0	0
3	43594655	.	C	T	1	7	8	0	14	22	0	0
3	43594658	.	G	A	13	8	21	0	0	21	0	0
3	43594735	.	T	C	7	5	12	0	0	12	0	0
3	43600999	.	C	T	0	8	8	0	8	16	0	0
3	43645900	.	G	C	7	13	20	0	0	20	0	0
3	43646161	.	A	G	8	6	14	0	1	15	0	0
3	43646362	.	C	T	2	7	9	0	5	14	0	0
3	43774440	.	C	A	9	8	17	0	1	18	0	0
3	43776859	.	T	C	9	5	14	0	0	14	0	0
3	43785646	.	A	T	3	5	8	0	1	9	0	0
3	43791284	.	T	C	7	12	19	0	0	19	0	0
3	43791317	.	G	A	8	8	16	0	0	16	0	0
3	43793147	.	T	C	9	4	13	0	0	13	0	0
3	43793273	.	G	A	10	5	15	0	0	15	0	0
3	43793389	.	T	C	11	6	17	0	1	18	0	0
3	43796956	.	T	G	4	0	4	0	3	7	0	0
3	43797073	.	C	T	6	6	12	0	0	12	0	0
3	43801338	.	C	T	12	16	28	0	1	29	0	0
3	43807512	.	T	C	6	5	11	0	2	13	0	0
3	43807921	.	C	A	12	10	22	0	1	23	0	0
3	43807945	.	T	A	14	7	21	0	0	24	3	0
3	43814607	.	C	T	6	9	15	0	0	15	0	0
3	43821273	.	G	T	11	10	21	0	0	21	0	0
3	43821328	.	A	G	8	6	14	0	1	15	0	0
3	43825892	.	T	A	3	5	8	0	2	10	0	0
3	43825901	.	T	C	4	3	7	0	0	7	0	0
3	43828902	.	G	A	2	3	5	1	0	6	0	0
3	43828906	.	T	C	1	3	4	0	1	5	0	0
3	43829154	.	G	C	3	6	9	0	0	9	0	0
3	43829179	.	G	C	3	6	9	0	0	9	0	0
3	43829370	.	A	C	1	5	6	0	0	6	0	0
3	43829411	.	C	T	2	2	4	0	0	4	0	0
3	43829413	.	C	T	2	2	4	0	0	4	0	0
3	43829712	.	G	A	1	4	5	0	6	11	0	0
3	43942053	.	A	C	2	2	4	0	0	4	0	0
3	43944611	.	A	G	6	5	11	0	1	12	0	0
3	43953805	.	C	T	3	5	8	0	0	8	0	0
3	43953883	.	T	C	9	1	10	0	4	14	0	0
3	43985593	.	A	G	1	2	3	0	0	3	0	0
3	43985795	.	T	A	3	2	5	0	0	5	0	0
3	43985815	.	G	T	0	2	2	0	2	4	0	0
3	44077285	.	T	C	2	2	4	0	0	4	0	0
3	44077295	.	A	T	2	2	4	0	0	4	0	0
3	44077429	.	A	C	1	4	5	0	0	5	0	0
3	44081793	.	G	A	1	3	4	0	0	4	0	0
3	44082239	.	T	G	2	2	4	0	0	4	0	0
3	44082427	.	A	G	1	5	6	0	0	6	0	0
3	44082439	.	A	G	1	4	5	0	1	6	0	0
3	44089225	.	T	G	4	4	8	0	0	8	0	0
3	44089529	.	A	G	3	3	6	0	0	6	0	0
3	44089576	.	A	G	2	5	7	0	0	7	0	0
3	44094114	.	C	T	1	4	5	0	0	5	0	0
3	44541766	.	C	T	0	2	2	0	3	5	0	0
3	44541955	.	C	A	3	9	12	0	0	12	0	0
3	45285512	.	A	G	6	2	8	0	0	8	0	0
3	45714678	.	C	T	3	2	5	0	0	5	0	0
3	45715511	.	T	A	3	5	8	0	1	9	0	0
3	45715716	.	C	T	3	6	9	0	0	9	0	0
3	45715776	.	T	C	5	7	12	0	0	12	0	0
3	45716082	.	T	C	4	2	6	0	0	6	0	0
3	45716098	.	C	T	4	3	7	0	0	7	0	0
3	45716766	.	A	G	6	0	6	0	5	11	0	0
3	45717180	.	C	T	9	12	21	0	0	21	0	0
3	45776520	.	T	C	19	0	19	0	18	37	0	0
3	45776721	.	T	C	28	29	57	0	2	59	0	0
3	45778103	.	T	A	2	3	5	0	1	6	0	0
3	45790559	.	T	C	8	5	13	0	0	13	0	0
3	45805605	.	C	G	8	11	19	0	0	19	0	0
3	45814631	.	A	T	6	9	15	0	0	15	0	0
3	45815894	.	A	C	4	4	8	0	1	9	0	0
3	45815997	.	G	A	2	4	6	0	3	9	0	0
3	45816004	.	C	T	5	4	9	0	0	9	0	0
3	45816549	.	A	G	4	6	10	0	0	10	0	0
3	45816618	.	T	C	9	11	20	0	0	20	0	0
3	45817571	.	G	T	2	6	8	0	0	8	0	0
3	45817572	.	T	G	1	3	4	0	4	8	0	0
3	46043483	.	G	A	7	5	12	0	0	12	0	0
3	46043617	.	G	A	2	4	6	0	0	6	0	0
3	46043918	.	T	A	3	3	6	0	0	6	0	0
3	46044097	.	C	T	2	3	5	0	1	6	0	0
3	46044190	.	G	T	3	2	5	0	1	6	0	0
3	46114398	.	A	G	3	5	8	0	1	9	0	0
3	46114458	.	C	T	2	4	6	0	3	9	0	0
3	46114491	.	C	A	5	6	11	0	0	11	0	0
3	46114814	.	C	G	3	3	6	0	0	6	0	0
3	46114824	.	G	A	3	4	7	0	0	7	0	0
3	46114925	.	C	G	1	2	3	0	0	3	0	0
3	46338286	.	A	G	2	9	11	0	0	11	0	0
3	46353405	.	C	A	3	2	5	0	0	5	0	0
3	46353747	.	C	A	3	4	7	0	1	8	0	0
3	46354031	.	C	T	4	4	8	0	0	8	0	0
3	46354217	.	A	G	6	4	10	0	0	10	0	0
3	46354230	.	G	A	6	4	10	0	0	10	0	0
3	46358537	.	A	G	7	0	7	0	8	15	0	0
3	46361536	.	C	A	2	5	7	0	1	8	0	0
3	46362514	.	C	T	2	8	10	0	0	10	0	0
3	46362640	.	C	T	5	9	14	0	0	14	0	0
3	46362753	.	C	A	4	3	7	0	0	7	0	0
3	46362830	.	G	A	0	4	4	0	4	8	0	0
3	46362844	.	C	G	5	0	5	0	3	8	0	0
3	46362895	.	T	C	4	2	6	0	0	6	0	0
3	46364162	.	T	A	1	5	6	0	0	6	0	0
3	46364654	.	G	A	1	3	4	0	1	5	0	0
3	46364847	.	T	G	1	0	1	0	3	4	0	0
3	46365432	.	T	C	1	6	7	0	0	7	0	0
3	46377497	.	A	T	6	2	8	0	0	8	0	0
3	46377528	.	C	A	7	3	10	0	0	10	0	0
3	46379849	.	C	G	3	2	5	1	0	6	0	0
3	46380144	.	A	C	5	3	8	0	0	8	0	0
3	46380189	.	A	G	14	11	25	0	1	26	0	0
3	46380194	.	T	A	15	11	26	0	0	26	0	0
3	46388058	.	C	T	12	9	21	1	3	25	0	0
3	46388285	.	G	A	23	6	29	1	0	30	0	0
3	46388439	.	A	T	11	8	19	0	0	19	0	0
3	46388487	.	A	C	13	9	22	0	0	22	0	0
3	46388490	.	T	A	11	10	21	0	0	21	0	0
3	46388636	.	T	C	8	7	15	0	0	15	0	0
3	46388711	.	C	T	10	5	15	0	1	16	0	0
3	46388714	.	G	A	7	10	17	0	0	17	0	0
3	46388854	.	T	C	16	9	25	0	1	26	0	0
3	46388905	.	G	A	13	9	22	0	1	23	0	0
3	46388954	.	A	C	6	14	20	0	0	20	0	0
3	46388968	.	G	C	13	6	19	0	0	19	0	0
3	46389009	.	C	T	18	17	35	0	1	36	0	0
3	46391844	.	C	T	1	14	15	0	15	30	0	0
3	46398380	.	G	A	15	12	27	0	1	28	0	0
3	46403743	.	C	T	4	19	23	0	11	34	0	0
3	46410288	.	T	C	19	11	30	0	0	30	0	0
3	46462656	.	A	G	2	2	4	0	0	4	0	0
3	46462883	.	T	A	2	4	6	1	0	7	0	0
3	46463113	.	T	C	5	6	11	0	0	11	0	0
3	46463156	.	C	T	8	7	15	0	1	16	0	0
3	46463213	.	A	C	7	6	13	1	1	15	0	0
3	46463240	.	C	T	6	5	11	1	0	12	0	0
3	46473247	.	G	C	2	6	8	0	4	12	0	0
3	46473292	.	G	A	10	11	21	0	0	21	0	0
3	46479971	.	G	A	2	2	4	0	0	4	0	0
3	46494019	.	C	A	3	3	6	0	0	6	0	0
3	46498099	.	G	A	0	3	3	0	4	7	0	0
3	46502597	.	T	C	3	4	7	0	1	8	0	0
3	46502666	.	T	C	2	4	6	0	0	6	0	0
3	46512161	.	T	A	3	2	5	0	0	5	0	0
3	46512175	.	G	C	3	2	5	0	0	5	0	0
3	46524720	.	A	G	0	3	3	0	1	4	0	0
3	46528534	.	C	T	2	8	10	0	0	10	0	0
3	46528835	.	G	A	3	3	6	0	0	6	0	0
3	46551285	.	T	A	1	3	4	0	0	4	0	0
3	46551498	.	C	T	1	2	3	0	0	3	0	0
3	46552712	.	G	C	4	2	6	0	0	6	0	0
3	46552775	.	G	A	3	2	5	0	0	5	0	0
3	46552832	.	A	C	7	6	13	0	0	13	0	0
3	46552993	.	A	G	3	6	9	0	0	9	0	0
3	46553206	.	T	G	5	3	8	0	0	8	0	0
3	46553234	.	G	C	3	5	8	0	0	8	0	0
3	46553470	.	A	G	7	0	7	0	4	11	0	0
3	46553480	.	C	A	9	3	12	0	0	12	0	0
3	46553534	.	C	T	5	5	10	0	0	10	0	0
3	46553540	.	C	A	6	4	10	0	1	11	0	0
3	46553720	.	C	A	4	5	9	0	0	9	0	0
3	46553850	.	A	C	4	2	6	0	0	6	0	0
3	46553893	.	T	C	4	5	9	0	0	9	0	0
3	46553986	.	A	T	4	9	13	0	0	13	0	0
3	46554085	.	G	T	4	2	6	0	0	6	0	0
3	46554177	.	C	A	5	6	11	1	1	13	0	0
3	46554181	.	C	A	6	6	12	1	0	13	0	0
3	46554259	.	G	A	6	4	10	0	1	11	0	0
3	46554307	.	T	A	5	2	7	0	0	7	0	0
3	46554458	.	G	T	4	4	8	0	0	8	0	0
3	46554564	.	A	G	5	3	8	0	0	8	0	0
3	46554648	.	T	A	12	3	15	2	0	17	0	0
3	46554711	.	G	A	5	12	17	0	0	17	0	0
3	46586065	.	C	G	0	2	2	0	1	3	0	0
3	46749479	.	A	G	10	4	14	0	2	16	0	0
3	46750272	.	C	T	10	11	21	0	0	21	0	0
3	46750752	.	G	A	16	9	25	0	1	26	0	0
3	46750996	.	C	T	12	11	23	0	0	23	0	0
3	46751630	.	G	A	10	11	21	0	0	21	0	0
3	46752486	.	A	C	8	9	17	0	1	18	0	0
3	46752522	.	T	G	4	6	10	0	0	10	0	0
3	46753340	.	T	G	6	0	6	0	0	7	1	0
3	46753613	.	T	C	2	4	6	0	0	6	0	0
3	46753619	.	G	A	2	5	7	0	0	7	0	0
3	46753742	.	A	G	12	0	12	0	9	21	0	0
3	46754078	.	T	A	24	23	47	0	0	47	0	0
3	46764069	.	G	T	0	2	2	0	3	5	0	0
3	46764485	.	A	T	10	11	21	0	1	22	0	0
3	46764572	.	A	T	7	12	19	0	0	19	0	0
3	46767646	.	T	C	13	5	18	0	0	18	0	0
3	46778789	.	G	T	14	17	31	0	2	33	0	0
3	46795118	.	G	T	2	2	4	0	0	4	0	0
3	46800490	.	A	T	31	34	65	0	3	68	0	0
3	46800692	.	G	A	22	23	45	0	0	45	0	0
3	46800940	.	C	T	37	28	65	0	3	68	0	0
3	46800946	.	T	G	34	29	63	0	3	66	0	0
3	46802227	.	T	C	26	2	28	0	25	53	0	0
3	46919523	.	C	T	3	2	5	0	0	5	0	0
3	46923509	.	G	A	3	5	8	0	0	8	0	0
3	46925154	.	G	A	5	3	8	0	0	8	0	0
3	46927089	.	A	G	3	2	5	0	0	5	0	0
3	46927137	.	G	A	2	2	4	0	0	4	0	0
3	46928958	.	A	G	4	3	7	0	0	7	0	0
3	46928982	.	G	T	5	3	8	0	0	9	1	0
3	46932602	.	C	A	1	2	3	0	6	9	0	0
3	47000841	.	T	A	2	4	6	0	0	6	0	0
3	47000852	.	A	G	2	5	7	0	1	8	0	0
3	47010524	.	G	A	1	3	4	0	1	5	0	0
3	47114734	.	A	G	2	2	4	0	1	5	0	0
3	47114746	.	G	A	3	3	6	0	1	7	0	0
3	47119662	.	T	A	4	6	10	0	0	10	0	0
3	47119900	.	G	A	3	6	9	0	0	9	0	0
3	47119964	.	C	T	0	5	5	0	2	7	0	0
3	47125636	.	T	A	3	5	8	0	0	8	0	0
3	47125693	.	G	A	4	6	10	0	0	10	0	0
3	47125771	.	T	C	3	3	6	0	0	6	0	0
3	47128073	.	A	G	1	2	3	0	1	4	0	0
3	47131174	.	C	T	2	4	6	0	0	6	0	0
3	47164580	.	C	T	4	3	7	0	0	7	0	0
3	47166295	.	C	T	2	2	4	0	0	4	0	0
3	47167574	.	C	A	6	2	8	0	0	8	0	0
3	47173202	.	C	T	1	2	3	0	0	3	0	0
3	47173208	.	C	T	3	3	6	0	0	6	0	0
3	47198805	.	G	A	5	6	11	0	0	11	0	0
3	47201409	.	C	T	10	4	14	1	0	15	0	0
3	47201440	.	A	G	7	3	10	1	1	12	0	0
3	47201479	.	T	C	11	9	20	0	1	21	0	0
3	47201482	.	T	C	9	10	19	0	2	21	0	0
3	47201518	.	C	T	7	11	18	0	1	20	1	0
3	47205408	.	C	T	9	6	15	0	2	17	0	0
3	47205417	.	A	G	8	0	8	0	9	17	0	0
3	47205507	.	G	A	4	15	19	0	2	21	0	0
3	47205534	.	A	G	7	0	7	0	15	22	0	0
3	47205543	.	C	T	13	7	20	0	0	20	0	0
3	47205585	.	A	T	9	8	17	0	0	17	0	0
3	47205597	.	C	T	10	10	20	0	1	22	1	0
3	47209257	.	A	T	4	15	19	0	6	25	0	0
3	47209433	.	T	C	9	9	18	0	2	20	0	0
3	47209445	.	A	T	10	10	20	0	1	21	0	0
3	47212662	.	A	G	2	4	6	0	0	6	0	0
3	47212774	.	T	C	3	5	8	0	0	8	0	0
3	47212790	.	A	G	3	0	3	0	5	8	0	0
3	47212826	.	A	G	1	5	6	0	0	6	0	0
3	47212914	.	T	C	4	3	7	0	0	7	0	0
3	47322641	.	G	A	1	5	6	0	0	6	0	0
3	47322646	.	T	C	1	4	5	0	1	6	0	0
3	47376649	.	A	G	4	2	6	0	0	6	0	0
3	47376878	.	C	T	4	4	8	0	2	10	0	0
3	47384568	.	C	T	9	3	12	0	0	12	0	0
3	47384653	.	T	C	9	9	18	0	0	18	0	0
3	47387084	.	A	C	6	7	13	2	0	15	0	0
3	47387085	.	A	C	6	7	13	2	0	15	0	0
3	47498493	.	C	T	1	3	4	0	6	10	0	0
3	47498565	.	A	T	7	3	10	0	0	10	0	0
3	47498625	.	C	A	7	8	15	0	0	15	0	0
3	47498633	.	G	A	6	8	14	0	0	14	0	0
3	47499240	.	G	A	1	5	6	0	0	6	0	0
3	47499273	.	G	A	1	3	4	0	0	4	0	0
3	47529406	.	G	A	2	8	10	0	0	10	0	0
3	47529469	.	T	G	3	2	5	0	1	6	0	0
3	47529490	.	G	A	3	7	10	0	0	10	0	0
3	47537356	.	A	G	5	2	7	0	0	7	0	0
3	47548264	.	A	G	3	4	7	0	0	7	0	0
3	47550275	.	C	T	1	3	4	0	3	7	0	0
3	47550282	.	G	A	5	4	9	0	0	9	0	0
3	47554609	.	A	C	5	4	9	0	1	10	0	0
3	47554651	.	T	C	3	5	8	0	0	8	0	0
3	47555423	.	A	G	2	2	4	0	0	4	0	0
3	47557276	.	A	G	5	7	12	1	0	13	0	0
3	47571410	.	A	C	0	5	5	0	0	5	0	0
3	47571417	.	C	A	2	2	4	0	0	4	0	0
3	47571522	.	C	T	1	4	5	0	3	8	0	0
3	47572451	.	G	A	3	3	6	0	0	6	0	0
3	47572463	.	C	A	4	2	6	0	0	6	0	0
3	47573343	.	C	T	0	2	2	0	2	4	0	0
3	47573385	.	C	T	1	2	3	0	0	3	0	0
3	47638327	.	G	A	4	2	6	0	0	6	0	0
3	47638363	.	A	G	1	3	4	0	0	4	0	0
3	47694671	.	C	T	1	3	4	0	0	4	0	0
3	47694677	.	A	G	1	3	4	0	0	4	0	0
3	47694751	.	C	T	0	6	6	0	2	8	0	0
3	47875576	.	A	T	1	6	7	0	0	7	0	0
3	47875968	.	G	T	1	2	3	0	0	3	0	0
3	48225485	.	A	G	4	4	8	0	0	8	0	0
3	48226259	.	G	A	2	2	4	0	0	4	0	0
3	48229390	.	A	G	2	0	2	0	9	11	0	0
3	48229423	.	C	T	5	7	12	0	0	12	0	0
3	48229507	.	A	G	1	6	7	0	0	7	0	0
3	48229654	.	C	T	2	5	7	0	0	7	0	0
3	48241805	.	C	T	4	4	8	0	0	8	0	0
3	48244963	.	G	A	1	2	3	0	7	10	0	0
3	48245071	.	C	A	2	3	5	0	0	5	0	0
3	48247601	.	A	G	4	11	15	0	0	15	0	0
3	48253319	.	G	A	2	4	6	0	0	6	0	0
3	48253673	.	C	T	3	4	7	0	0	7	0	0
3	48253733	.	T	G	7	3	10	0	0	10	0	0
3	48253881	.	C	T	7	3	10	0	0	10	0	0
3	48254157	.	T	G	3	3	6	0	0	6	0	0
3	48254271	.	G	A	3	2	5	0	0	5	0	0
3	48278752	.	C	T	11	7	18	0	0	18	0	0
3	48283580	.	G	A	7	8	15	0	0	15	0	0
3	48283768	.	C	A	7	5	12	0	0	12	0	0
3	48286490	.	C	T	2	6	8	0	0	8	0	0
3	48286514	.	T	C	2	3	5	0	0	5	0	0
3	48286648	.	C	A	3	3	6	0	1	7	0	0
3	48286654	.	G	C	3	4	7	0	0	7	0	0
3	48297335	.	A	G	8	0	8	0	3	11	0	0
3	48301180	.	A	G	5	12	17	0	1	18	0	0
3	48305837	.	C	G	14	7	21	0	0	21	0	0
3	48305841	.	G	A	0	15	15	0	7	22	0	0
3	48305898	.	C	G	7	8	15	0	1	16	0	0
3	48305908	.	C	A	9	3	12	0	1	13	0	0
3	48320968	.	A	G	3	6	9	0	0	9	0	0
3	48326568	.	G	A	12	5	17	0	0	17	0	0
3	48326631	.	C	T	9	6	15	0	0	15	0	0
3	48326725	.	A	C	5	10	15	0	0	15	0	0
3	48327002	.	G	A	5	15	20	0	1	21	0	0
3	48473521	.	C	A	3	4	7	0	0	7	0	0
3	48473546	.	C	A	3	5	8	0	0	8	0	0
3	48473565	.	A	G	6	8	14	0	0	14	0	0
3	48473641	.	A	G	4	4	8	0	0	8	0	0
3	48479982	.	C	T	4	3	7	0	0	7	0	0
3	48480156	.	T	G	9	7	16	0	0	16	0	0
3	48480333	.	T	C	6	8	14	0	1	15	0	0
3	48486609	.	C	T	4	10	14	0	1	15	0	0
3	48488909	.	G	T	10	8	18	0	0	18	0	0
3	48489101	.	C	G	3	0	3	0	8	11	0	0
3	48550676	.	G	A	17	12	29	0	2	31	0	0
3	48557707	.	T	C	14	0	14	0	41	55	0	0
3	48584800	.	A	T	5	7	12	0	1	13	0	0
3	48585222	.	C	T	2	18	20	0	14	34	0	0
3	48585236	.	C	A	22	14	36	0	0	36	0	0
3	48585271	.	A	C	23	13	36	0	2	38	0	0
3	48585331	.	A	G	28	11	39	1	0	40	0	0
3	48585377	.	G	T	15	20	35	0	2	37	0	0
3	48585411	.	G	T	10	17	27	0	2	29	0	0
3	48586985	.	A	G	18	16	34	0	1	35	0	0
3	48587176	.	C	A	21	17	38	0	2	40	0	0
3	48587191	.	C	T	21	17	38	0	3	41	0	0
3	48588830	.	A	G	15	17	32	0	1	33	0	0
3	48588884	.	A	G	18	12	30	0	2	32	0	0
3	48589156	.	A	G	13	10	23	0	1	24	0	0
3	48591769	.	A	G	10	16	26	0	2	28	0	0
3	48591825	.	G	T	16	7	23	0	2	25	0	0
3	48593781	.	T	C	19	13	32	0	0	32	0	0
3	48593811	.	G	A	14	19	33	0	1	34	0	0
3	48594098	.	T	C	18	0	18	0	24	42	0	0
3	48596834	.	T	C	17	10	27	0	1	28	0	0
3	48612027	.	T	C	12	0	12	0	17	29	0	0
3	48612038	.	A	G	12	11	23	0	0	23	0	0
3	48638932	.	C	T	2	4	6	0	2	8	0	0
3	48645801	.	G	T	8	11	19	0	0	19	0	0
3	48645863	.	A	C	9	10	19	0	0	19	0	0
3	48661500	.	A	G	10	12	22	0	0	22	0	0
3	48661700	.	G	A	2	7	9	0	2	11	0	0
3	48665796	.	C	G	1	9	10	0	15	25	0	0
3	48665832	.	T	A	15	8	23	0	0	23	0	0
3	48665841	.	T	G	14	8	22	0	2	24	0	0
3	48686990	.	G	A	8	12	20	0	0	20	0	0
3	48687134	.	C	T	1	12	13	0	8	21	0	0
3	48691411	.	A	G	7	6	13	0	0	13	0	0
3	48699868	.	T	C	5	6	11	0	1	12	0	0
3	48699877	.	A	T	8	6	14	0	0	14	0	0
3	48700453	.	G	A	7	6	13	0	1	14	0	0
3	48700498	.	C	T	7	7	14	0	0	14	0	0
3	48700504	.	C	A	2	7	9	0	4	13	0	0
3	48704776	.	G	A	8	3	11	0	0	11	0	0
3	48704848	.	G	A	13	4	17	0	1	18	0	0
3	48713618	.	G	A	7	5	12	0	0	12	0	0
3	49130387	.	A	C	9	0	9	0	10	19	0	0
3	49130480	.	G	A	4	4	8	0	0	8	0	0
3	49134236	.	A	C	8	10	18	0	0	18	0	0
3	49134373	.	A	G	5	8	13	0	0	13	0	0
3	49137821	.	C	A	1	5	6	0	8	14	0	0
3	49154025	.	G	A	2	5	7	0	0	7	0	0
3	49154124	.	C	A	2	2	4	0	0	4	0	0
3	49154214	.	G	A	5	3	8	0	0	8	0	0
3	49163528	.	G	T	5	3	8	0	1	9	0	0
3	49163558	.	T	C	8	4	12	0	1	13	0	0
3	49426063	.	G	A	9	9	18	0	0	18	0	0
3	49426184	.	G	A	3	12	15	0	2	17	0	0
3	49439450	.	G	T	18	8	26	1	0	27	0	0
3	49439587	.	A	G	16	15	31	1	0	32	0	0
3	49440129	.	G	T	9	8	17	0	1	18	0	0
3	49447514	.	C	A	2	8	10	0	14	24	0	0
3	49466407	.	T	C	11	10	21	0	0	21	0	0
3	49503880	.	A	G	23	24	47	0	0	47	0	0
3	49559523	.	C	T	40	27	67	0	5	72	0	0
3	49559527	.	G	T	39	29	68	0	4	72	0	0
3	49559637	.	G	T	40	33	73	0	10	84	1	0
3	49559703	.	G	A	30	43	73	0	2	75	0	0
3	49559904	.	G	A	29	43	72	0	4	76	0	0
3	49559979	.	A	G	28	36	64	0	6	70	0	0
3	49559988	.	T	A	34	31	65	0	3	69	1	0
3	49560084	.	A	G	30	41	71	0	1	72	0	0
3	49560204	.	G	C	34	40	74	0	2	76	0	0
3	49560276	.	T	G	33	38	71	0	4	75	0	0
3	49560420	.	C	T	42	24	66	0	3	69	0	0
3	49560507	.	G	A	35	33	68	0	4	72	0	0
3	49758151	.	A	T	2	2	4	0	0	4	0	0
3	49758152	.	A	C	2	2	4	0	0	4	0	0
3	49758994	.	A	G	4	3	7	0	0	7	0	0
3	49759921	.	C	A	0	2	2	0	1	3	0	0
3	49766995	.	C	T	2	2	4	0	0	4	0	0
3	49794316	.	G	T	2	1	3	0	1	4	0	0
3	50054508	.	G	A	10	3	13	0	1	14	0	0
3	50054619	.	A	T	5	2	7	0	2	9	0	0
3	50054766	.	G	A	5	5	10	1	0	11	0	0
3	50059143	.	A	T	12	19	31	0	0	31	0	0
3	50063458	.	C	T	11	12	23	0	0	23	0	0
3	50063491	.	C	T	2	17	19	0	13	32	0	0
3	50066373	.	A	G	13	16	29	1	12	42	0	0
3	50066402	.	G	A	26	19	45	1	2	48	0	0
3	50066497	.	C	T	2	2	4	0	0	4	0	0
3	50077077	.	G	A	7	8	15	0	0	15	0	0
3	50077311	.	A	G	12	32	44	0	2	46	0	0
3	50077364	.	T	A	27	14	41	2	6	49	0	0
3	50077371	.	G	A	15	29	44	3	1	48	0	0
3	50077428	.	G	C	15	18	33	1	2	36	0	0
3	50081696	.	G	A	25	12	37	0	1	38	0	0
3	50083980	.	C	A	22	27	49	0	1	50	0	0
3	50084011	.	A	G	26	22	48	0	4	52	0	0
3	50087361	.	C	A	2	17	19	0	21	40	0	0
3	50087370	.	G	A	17	19	36	0	0	36	0	0
3	50087433	.	C	A	3	12	15	0	15	30	0	0
3	50089113	.	G	A	14	20	34	0	0	34	0	0
3	50089470	.	T	C	19	21	40	0	0	40	0	0
3	50091985	.	A	G	9	20	29	0	1	30	0	0
3	50092630	.	T	G	14	21	35	0	1	36	0	0
3	50092633	.	A	G	13	21	34	0	0	34	0	0
3	50095869	.	A	T	12	5	17	0	5	22	0	0
3	50095929	.	C	T	1	20	21	0	13	34	0	0
3	50099806	.	G	A	17	10	27	0	1	28	0	0
3	50104084	.	C	T	16	11	27	0	0	27	0	0
3	50110202	.	T	C	13	0	13	0	15	28	0	0
3	50110205	.	C	A	15	13	28	0	1	29	0	0
3	50110369	.	T	C	10	5	15	0	0	15	0	0
3	50110399	.	A	G	9	8	17	0	0	17	0	0
3	50123650	.	C	A	2	13	15	0	20	35	0	0
3	50123709	.	A	G	28	15	43	0	0	43	0	0
3	50123758	.	A	G	29	22	51	0	2	53	0	0
3	50123760	.	C	A	23	26	49	0	1	51	1	0
3	50123936	.	G	A	16	32	48	0	2	50	0	0
3	50124107	.	A	G	30	11	41	0	3	44	0	0
3	50124108	.	C	G	31	13	44	0	1	45	0	0
3	50127196	.	G	A	6	12	18	0	0	18	0	0
3	50127241	.	T	C	1	0	1	0	3	4	0	0
3	50155592	.	C	T	2	2	4	0	0	5	1	0
3	50155593	.	T	C	2	3	5	0	0	5	0	0
3	50156200	.	A	G	2	2	4	0	0	4	0	0
3	50156275	.	T	C	4	4	8	0	0	8	0	0
3	50159431	.	C	T	1	3	4	0	0	4	0	0
3	50166550	.	T	C	10	5	15	0	1	17	1	0
3	50170236	.	A	G	5	0	5	0	6	11	0	0
3	50170338	.	T	A	4	5	9	0	2	11	0	0
3	50170354	.	C	T	6	5	11	0	1	12	0	0
3	50171713	.	A	G	7	4	11	0	0	11	0	0
3	50172725	.	G	C	2	3	5	0	0	5	0	0
3	50172735	.	T	A	3	2	5	0	0	5	0	0
3	50172788	.	C	T	1	4	5	0	1	6	0	0
3	50175940	.	G	T	5	2	7	0	0	7	0	0
3	50176620	.	G	T	5	8	13	0	0	13	0	0
3	50253969	.	G	A	6	13	19	0	0	19	0	0
3	50256147	.	G	A	8	3	11	0	1	12	0	0
3	50256938	.	A	C	8	11	19	0	1	20	0	0
3	50265852	.	C	T	8	10	18	0	0	18	0	0
3	50265903	.	A	C	9	14	23	0	2	25	0	0
3	50265906	.	T	C	11	13	24	0	1	25	0	0
3	50265994	.	C	T	9	10	19	0	0	19	0	0
3	50266043	.	C	A	7	9	16	0	0	16	0	0
3	50266063	.	A	G	5	6	11	0	1	12	0	0
3	50266198	.	T	C	5	5	10	0	0	10	0	0
3	50266330	.	T	A	3	14	17	0	0	17	0	0
3	50266384	.	A	G	3	9	12	0	0	12	0	0
3	50266394	.	T	A	3	7	10	0	0	10	0	0
3	50266474	.	G	A	3	5	8	0	0	8	0	0
3	50266765	.	A	G	1	5	6	0	0	6	0	0
3	50266804	.	A	G	2	3	5	0	0	5	0	0
3	50266893	.	A	G	5	2	7	0	0	7	0	0
3	50266907	.	A	G	3	5	8	0	0	8	0	0
3	50266948	.	A	G	3	7	10	0	2	12	0	0
3	50267171	.	T	G	3	3	6	0	0	6	0	0
3	50267256	.	T	A	5	6	11	0	0	11	0	0
3	50267460	.	G	A	6	8	14	0	0	14	0	0
3	50267471	.	A	T	5	6	11	0	0	11	0	0
3	50267686	.	T	C	5	11	16	1	0	17	0	0
3	50267860	.	A	T	6	16	22	0	2	24	0	0
3	50267981	.	G	C	5	9	14	0	0	14	0	0
3	50267992	.	T	A	4	10	14	0	0	14	0	0
3	50268052	.	A	T	4	8	12	0	0	12	0	0
3	50268073	.	A	G	3	7	10	0	0	10	0	0
3	50268106	.	G	T	2	5	7	0	1	8	0	0
3	50268146	.	T	A	3	5	8	0	1	9	0	0
3	50268220	.	C	T	6	9	15	0	0	15	0	0
3	50268437	.	T	A	3	3	6	0	1	7	0	0
3	50268535	.	A	C	11	5	16	0	0	16	0	0
3	50268715	.	C	T	8	10	18	0	2	20	0	0
3	50268744	.	G	A	6	11	17	0	0	17	0	0
3	50272168	.	C	T	1	3	4	0	1	5	0	0
3	50272435	.	T	G	11	3	14	0	0	14	0	0
3	50272438	.	T	G	11	3	14	0	0	14	0	0
3	50273026	.	G	A	8	6	14	0	1	15	0	0
3	50273031	.	C	T	7	6	13	0	1	14	0	0
3	50273469	.	C	T	3	4	7	0	7	14	0	0
3	50276336	.	A	T	4	8	12	0	0	12	0	0
3	50277657	.	A	T	1	2	3	0	0	3	0	0
3	50277660	.	C	T	3	2	5	0	0	5	0	0
3	50277887	.	G	A	1	9	10	0	0	10	0	0
3	50366189	.	G	A	12	8	20	0	0	20	0	0
3	50418826	.	G	C	12	15	27	0	1	28	0	0
3	50419046	.	C	T	9	6	15	0	1	16	0	0
3	50419155	.	C	T	2	9	11	0	0	11	0	0
3	50419344	.	T	A	2	6	8	0	0	8	0	0
3	50419626	.	A	T	1	4	5	0	0	5	0	0
3	50419658	.	T	A	2	6	8	0	1	9	0	0
3	50419686	.	A	T	5	6	11	0	0	11	0	0
3	50419722	.	G	C	10	6	16	0	0	16	0	0
3	50419723	.	C	A	10	4	14	0	2	16	0	0
3	50419803	.	C	A	2	16	18	0	1	19	0	0
3	50419827	.	T	C	4	17	21	0	0	21	0	0
3	50420001	.	A	C	5	8	13	0	0	13	0	0
3	50420087	.	A	G	9	7	16	0	0	16	0	0
3	50420139	.	A	T	15	8	23	0	0	23	0	0
3	50420152	.	G	T	10	13	23	0	0	23	0	0
3	50420191	.	A	T	12	11	23	0	0	24	1	0
3	50420194	.	T	A	10	13	23	0	0	23	0	0
3	50951272	.	C	T	6	6	12	0	0	12	0	0
3	50951299	.	C	A	4	6	10	0	1	11	0	0
3	50951644	.	C	G	6	4	10	0	0	10	0	0
3	50951770	.	T	G	8	5	13	0	0	13	0	0
3	50951862	.	A	G	6	4	10	0	1	11	0	0
3	50952021	.	T	C	3	3	6	0	0	6	0	0
3	50952163	.	G	A	7	5	12	0	1	13	0	0
3	50952404	.	G	T	4	3	7	0	0	7	0	0
3	50952749	.	G	T	2	2	4	0	0	4	0	0
3	50998386	.	T	C	5	3	8	0	0	8	0	0
3	51034995	.	G	T	10	8	18	0	1	19	0	0
3	51039012	.	C	T	1	7	8	0	8	16	0	0
3	51043176	.	G	A	3	5	8	0	0	8	0	0
3	51043976	.	G	A	5	6	11	0	1	12	0	0
3	51043994	.	G	A	5	7	12	0	0	12	0	0
3	51046799	.	A	G	6	4	10	0	1	11	0	0
3	51046805	.	A	G	8	4	12	0	0	12	0	0
3	51056311	.	C	G	4	4	8	0	1	9	0	0
3	51056350	.	A	G	9	3	12	0	0	12	0	0
3	51056368	.	T	A	8	5	13	0	1	14	0	0
3	51056559	.	G	A	4	3	7	0	0	7	0	0
3	51060094	.	A	G	6	5	11	0	0	11	0	0
3	51060341	.	G	A	4	4	8	0	1	9	0	0
3	51063396	.	C	T	4	4	8	0	1	9	0	0
3	51063398	.	C	T	5	4	9	0	0	9	0	0
3	51065588	.	T	C	5	0	5	0	5	10	0	0
3	51066925	.	C	T	1	5	6	0	2	8	0	0
3	51071651	.	G	T	3	2	5	0	0	5	0	0
3	51071664	.	G	A	1	2	3	0	0	3	0	0
3	51071888	.	G	A	3	3	6	0	0	6	0	0
3	51074564	.	A	G	6	3	9	0	0	9	0	0
3	51074579	.	T	A	6	3	9	0	0	9	0	0
3	51074618	.	C	T	1	4	5	0	1	6	0	0
3	51074648	.	C	G	2	2	4	0	0	4	0	0
3	51096235	.	C	T	3	3	6	0	0	6	0	0
3	51096247	.	A	G	2	2	4	0	1	5	0	0
3	51109189	.	G	A	3	2	5	0	0	5	0	0
3	51131484	.	A	G	1	2	3	0	0	3	0	0
3	51563736	.	G	A	1	7	8	0	6	14	0	0
3	51563824	.	T	C	4	4	8	0	0	8	0	0
3	51563874	.	G	C	5	3	8	0	0	8	0	0
3	51563876	.	T	G	5	3	8	0	0	8	0	0
3	51563911	.	T	C	5	3	8	0	1	9	0	0
3	51563998	.	A	G	2	3	5	0	0	5	0	0
3	51581066	.	G	T	0	3	3	1	6	10	0	0
3	51619684	.	A	G	5	3	8	0	0	8	0	0
3	51619708	.	G	A	6	3	9	0	0	9	0	0
3	51619762	.	C	T	5	6	11	0	0	11	0	0
3	51619789	.	A	C	3	6	9	0	0	9	0	0
3	51619801	.	T	A	3	3	6	0	0	6	0	0
3	51619846	.	T	C	5	4	9	0	0	9	0	0
3	51632778	.	A	G	8	0	8	0	4	12	0	0
3	51653411	.	G	A	9	7	16	0	0	16	0	0
3	51653435	.	C	T	6	8	14	0	0	14	0	0
3	51656720	.	G	A	5	11	16	0	1	17	0	0
3	51656726	.	C	A	6	10	16	0	1	17	0	0
3	51656762	.	G	A	3	10	13	0	0	13	0	0
3	51656921	.	T	C	9	6	15	0	1	16	0	0
3	51656931	.	G	A	6	8	14	0	0	14	0	0
3	51656973	.	C	A	7	7	14	0	1	15	0	0
3	51657082	.	C	T	10	3	13	0	1	14	0	0
3	51657291	.	G	A	8	3	11	0	0	11	0	0
3	51657339	.	C	T	9	3	12	0	0	12	0	0
3	51657382	.	G	C	7	3	10	0	0	10	0	0
3	51657439	.	A	G	4	4	8	1	0	9	0	0
3	51657456	.	C	T	5	4	9	1	0	10	0	0
3	51742263	.	G	A	15	15	30	0	2	32	0	0
3	51808378	.	C	T	8	10	18	0	1	19	0	0
3	51813083	.	G	A	9	10	19	1	2	22	0	0
3	51834434	.	C	T	11	14	25	0	4	29	0	0
3	51861767	.	G	A	12	11	23	0	0	23	0	0
3	51871663	.	A	T	12	12	24	0	1	25	0	0
3	51871671	.	C	T	11	13	24	0	1	25	0	0
3	51871704	.	G	C	7	12	19	0	0	19	0	0
3	51871788	.	G	A	16	8	24	0	0	24	0	0
3	51874119	.	C	A	13	11	24	0	0	24	0	0
3	51874163	.	G	A	9	11	20	0	1	21	0	0
3	51874274	.	G	A	11	13	24	0	0	24	0	0
3	51879297	.	G	T	8	18	26	0	0	26	0	0
3	51891785	.	A	G	9	0	9	0	14	23	0	0
3	51891787	.	C	T	13	9	22	0	1	23	0	0
3	51892095	.	T	A	4	5	9	0	0	9	0	0
3	51892136	.	A	T	4	8	12	0	0	12	0	0
3	51892162	.	A	G	4	9	13	0	0	13	0	0
3	51892176	.	T	A	5	9	14	0	0	14	0	0
3	51892212	.	A	G	5	6	11	0	0	11	0	0
3	51892225	.	T	A	5	6	11	0	0	11	0	0
3	51899772	.	T	A	12	13	25	1	0	26	0	0
3	51899802	.	C	T	0	8	8	0	14	22	0	0
3	51899872	.	C	T	1	7	8	0	13	21	0	0
3	51900357	.	C	A	12	14	26	0	1	27	0	0
3	51900400	.	A	G	18	5	23	0	0	23	0	0
3	51900415	.	T	C	10	10	20	0	1	21	0	0
3	51900487	.	A	C	11	19	30	0	1	31	0	0
3	51900552	.	A	G	11	11	22	0	3	25	0	0
3	51900587	.	C	T	6	15	21	0	0	21	0	0
3	51900589	.	A	C	4	15	19	0	0	19	0	0
3	51900693	.	C	G	14	14	28	0	2	30	0	0
3	51900702	.	C	A	1	15	16	0	10	26	0	0
3	51900768	.	T	A	10	13	23	0	3	26	0	0
3	51900784	.	T	C	11	0	11	0	13	24	0	0
3	51901018	.	C	T	13	13	26	0	1	27	0	0
3	51901092	.	A	T	19	17	36	0	1	37	0	0
3	51901127	.	A	G	29	16	45	0	2	47	0	0
3	51901178	.	T	A	21	27	48	0	0	48	0	0
3	51901199	.	G	T	19	26	45	0	2	47	0	0
3	51901309	.	G	A	20	22	42	0	3	45	0	0
3	51901344	.	T	C	13	21	34	0	6	40	0	0
3	51901413	.	A	G	16	12	28	0	0	28	0	0
3	51901670	.	C	T	7	18	25	0	2	27	0	0
3	51901799	.	T	C	13	22	35	0	0	35	0	0
3	51901835	.	G	A	18	18	36	0	1	37	0	0
3	51901873	.	A	G	15	24	39	0	0	39	0	0
3	51901885	.	T	C	16	25	41	0	1	42	0	0
3	51902099	.	C	T	11	21	32	0	0	32	0	0
3	51902171	.	T	A	10	13	23	0	1	24	0	0
3	51902454	.	T	A	20	7	27	0	0	27	0	0
3	51902591	.	T	A	16	12	28	0	1	29	0	0
3	51902695	.	C	T	18	11	29	0	4	33	0	0
3	51902834	.	A	G	23	8	31	0	0	31	0	0
3	51902883	.	G	A	17	17	34	0	0	34	0	0
3	51902987	.	A	G	13	13	26	0	1	27	0	0
3	51903048	.	A	C	12	14	26	0	0	26	0	0
3	51903080	.	A	G	8	11	19	0	2	21	0	0
3	51903168	.	C	T	15	11	26	0	2	28	0	0
3	51903198	.	A	C	13	0	13	0	12	25	0	0
3	51903211	.	T	G	18	13	31	0	0	31	0	0
3	51903233	.	A	G	18	14	32	0	0	33	1	0
3	51903286	.	G	T	15	22	37	0	0	37	0	0
3	51903495	.	A	G	12	11	23	0	1	24	0	0
3	51903591	.	C	T	10	18	28	0	2	30	0	0
3	51903605	.	G	A	12	18	30	0	0	30	0	0
3	51903742	.	C	G	8	9	17	0	2	19	0	0
3	51903810	.	T	G	8	9	17	0	1	18	0	0
3	51903815	.	T	A	9	10	19	0	1	20	0	0
3	51903979	.	T	C	13	12	25	0	0	25	0	0
3	51904019	.	G	T	11	12	23	0	1	24	0	0
3	51904043	.	G	T	10	10	20	0	1	21	0	0
3	51904226	.	A	G	12	4	16	0	0	16	0	0
3	51904359	.	T	A	16	19	35	0	0	35	0	0
3	51904826	.	G	A	16	12	28	0	1	29	0	0
3	51907077	.	G	T	12	9	21	0	0	21	0	0
3	51907297	.	G	A	9	13	22	0	0	22	0	0
3	51907657	.	A	G	9	8	17	0	1	18	0	0
3	51911718	.	A	C	12	9	21	0	1	22	0	0
3	51911727	.	A	G	14	9	23	0	0	23	0	0
3	52558270	.	A	G	6	0	6	0	5	11	0	0
3	52558333	.	A	G	2	2	4	0	0	4	0	0
3	52558384	.	A	G	1	3	4	0	0	4	0	0
3	52558558	.	T	A	5	2	7	0	0	7	0	0
3	52563568	.	C	T	4	7	11	0	1	12	0	0
3	52584332	.	C	T	7	3	10	0	0	10	0	0
3	52584428	.	C	T	4	7	11	0	1	12	0	0
3	52588941	.	C	T	5	6	11	0	0	11	0	0
3	52594760	.	G	A	13	11	24	0	1	25	0	0
3	52594966	.	T	C	15	13	28	0	1	29	0	0
3	52603216	.	A	C	14	10	24	0	1	25	0	0
3	52641771	.	C	A	4	3	7	0	1	8	0	0
3	52641819	.	T	C	6	0	6	0	5	11	0	0
3	52641831	.	C	T	2	5	7	0	5	12	0	0
3	52642132	.	T	A	9	5	14	0	1	15	0	0
3	52642488	.	A	G	7	6	13	0	0	13	0	0
3	52642614	.	T	C	10	0	10	0	6	16	0	0
3	52647283	.	A	G	3	2	5	0	0	5	0	0
3	52647284	.	A	T	3	2	5	0	0	5	0	0
3	52647870	.	C	T	6	4	10	0	1	11	0	0
3	52648764	.	G	A	3	3	6	0	0	6	0	0
3	52648842	.	T	C	0	2	2	0	1	3	0	0
3	52660538	.	A	T	1	2	3	0	0	3	0	0
3	52668150	.	C	T	0	2	2	0	2	4	0	0
3	52668542	.	G	A	7	9	16	0	0	16	0	0
3	52668679	.	C	T	0	10	10	0	5	15	0	0
3	52669995	.	G	A	6	4	10	1	0	11	0	0
3	52673834	.	T	A	3	5	8	0	1	9	0	0
3	52673854	.	A	T	4	4	8	0	0	8	0	0
3	52673936	.	G	A	6	7	13	0	0	13	0	0
3	52674017	.	T	A	4	6	10	0	0	10	0	0
3	52674018	.	A	C	5	4	9	0	1	10	0	0
3	52674105	.	A	C	1	3	4	0	0	4	0	0
3	52677279	.	G	A	2	4	6	0	0	6	0	0
3	52677281	.	C	T	2	4	6	0	0	6	0	0
3	52677492	.	C	G	7	3	10	0	0	10	0	0
3	52677501	.	T	C	7	3	10	0	0	10	0	0
3	52689511	.	C	T	5	4	9	0	1	10	0	0
3	52697304	.	G	C	8	10	18	0	0	18	0	0
3	52697312	.	A	C	8	9	17	0	1	18	0	0
3	52697371	.	T	A	7	6	13	0	0	13	0	0
3	52699405	.	G	A	13	4	17	0	1	18	0	0
3	52699441	.	G	A	12	4	16	0	0	16	0	0
3	52699449	.	G	T	1	3	4	0	10	14	0	0
3	52699494	.	A	G	4	3	7	0	0	7	0	0
3	52699503	.	T	C	5	3	8	0	1	9	0	0
3	52699830	.	G	T	6	3	9	0	1	10	0	0
3	52699995	.	T	C	8	5	13	0	1	14	0	0
3	52700035	.	A	C	11	7	18	0	0	18	0	0
3	52700048	.	A	G	11	6	17	0	0	17	0	0
3	52700195	.	T	G	2	2	4	0	0	4	0	0
3	52875857	.	C	G	1	0	1	0	3	4	0	0
3	52895631	.	G	A	4	2	6	0	0	6	0	0
3	52895667	.	G	A	5	4	9	0	0	9	0	0
3	52895688	.	C	T	5	4	9	0	1	10	0	0
3	52895725	.	C	G	7	3	10	0	0	10	0	0
3	52898520	.	C	T	0	5	5	0	2	7	0	0
3	52898922	.	G	A	3	6	9	0	0	9	0	0
3	52898927	.	T	A	2	5	7	0	1	8	0	0
3	52899872	.	A	T	3	5	8	0	4	12	0	0
3	52899911	.	A	T	3	3	6	0	0	6	0	0
3	52902240	.	G	A	0	4	4	0	4	9	1	0
3	52902344	.	G	A	0	7	7	0	6	13	0	0
3	52902356	.	T	C	4	7	11	0	0	11	0	0
3	52911245	.	A	G	10	9	19	0	1	20	0	0
3	52913391	.	T	C	7	6	13	0	0	13	0	0
3	52913508	.	C	T	5	7	12	0	0	12	0	0
3	52913529	.	A	G	3	7	10	0	0	10	0	0
3	52913559	.	T	A	3	7	10	0	0	10	0	0
3	52921735	.	C	T	5	5	10	0	0	10	0	0
3	52921780	.	A	G	5	3	8	0	2	10	0	0
3	52921926	.	A	G	5	0	5	0	9	14	0	0
3	52925915	.	G	A	0	4	4	0	9	13	0	0
3	52931588	.	T	C	4	9	13	0	0	13	0	0
3	52932770	.	C	T	3	3	6	0	0	6	0	0
3	52932793	.	A	C	7	4	11	0	2	13	0	0
3	52935355	.	C	A	10	11	21	0	0	21	0	0
3	52937419	.	T	C	6	7	13	0	1	14	0	0
3	52937723	.	G	T	6	10	16	0	1	17	0	0
3	52937747	.	G	A	1	7	8	0	7	15	0	0
3	52945346	.	G	A	5	2	7	0	0	7	0	0
3	53000280	.	G	A	0	7	7	0	4	11	0	0
3	53000517	.	T	C	6	12	18	0	1	19	0	0
3	53000558	.	A	G	7	0	7	0	9	16	0	0
3	53000673	.	G	T	0	10	10	0	7	17	0	0
3	53001045	.	C	A	8	17	25	0	0	25	0	0
3	53047903	.	C	T	2	2	4	0	0	4	0	0
3	53047981	.	A	G	12	1	13	0	9	22	0	0
3	53048032	.	C	T	3	5	8	10	2	20	0	0
3	53074317	.	C	T	16	19	35	0	1	36	0	0
3	53074581	.	C	T	16	17	33	0	0	33	0	0
3	53075050	.	C	A	6	6	12	0	0	12	0	0
3	53075475	.	T	G	9	11	20	0	0	20	0	0
3	53076037	.	A	T	14	9	23	0	0	23	0	0
3	53076160	.	G	T	1	25	26	1	23	50	0	0
3	53140883	.	A	G	2	3	5	1	0	6	0	0
3	53156875	.	A	T	2	3	5	0	0	5	0	0
3	53192505	.	C	T	7	5	12	0	2	14	0	0
3	53196776	.	C	T	10	5	15	0	2	17	0	0
3	53198571	.	A	C	12	11	23	0	1	24	0	0
3	53198736	.	T	C	9	7	16	0	1	17	0	0
3	53198987	.	T	G	9	13	22	0	1	23	0	0
3	53199113	.	G	A	1	4	5	0	7	12	0	0
3	53199182	.	C	T	6	4	10	0	0	10	0	0
3	53199433	.	A	T	6	5	11	0	0	11	0	0
3	53201554	.	A	G	3	2	5	0	0	5	0	0
3	53203455	.	A	G	5	4	9	0	1	10	0	0
3	53203566	.	C	T	3	4	7	0	2	9	0	0
3	53203782	.	A	G	4	5	9	0	0	9	0	0
3	53203823	.	T	G	7	0	7	0	10	17	0	0
3	53204009	.	C	T	5	11	16	0	1	17	0	0
3	53204135	.	A	G	6	0	6	0	8	14	0	0
3	53206055	.	A	G	6	0	6	0	6	12	0	0
3	53206260	.	A	G	9	9	18	0	3	21	0	0
3	53206418	.	G	A	19	11	30	0	0	30	0	0
3	53206427	.	C	T	18	8	26	0	3	29	0	0
3	53206469	.	A	T	18	9	27	0	1	28	0	0
3	53206472	.	C	T	17	10	27	0	2	29	0	0
3	53211032	.	A	G	13	18	31	1	3	35	0	0
3	53211168	.	G	C	20	6	26	0	4	30	0	0
3	53211170	.	T	C	19	8	27	0	1	28	0	0
3	53211206	.	A	T	13	12	25	0	2	27	0	0
3	53211239	.	A	G	9	15	24	0	0	24	0	0
3	53211248	.	T	G	10	0	10	0	16	26	0	0
3	53211356	.	A	T	16	12	28	0	2	30	0	0
3	53211366	.	C	A	15	9	24	0	4	28	0	0
3	53211604	.	C	G	14	13	27	0	2	29	0	0
3	53211605	.	C	T	15	14	29	0	1	30	0	0
3	53214615	.	T	C	17	10	27	0	0	27	0	0
3	53215644	.	C	T	14	14	28	0	1	29	0	0
3	53215711	.	T	A	13	8	21	0	1	22	0	0
3	53215729	.	G	A	7	8	15	0	0	15	0	0
3	53218471	.	C	T	14	13	27	0	0	27	0	0
3	53222943	.	G	T	0	9	9	0	12	21	0	0
3	53223032	.	C	A	12	6	18	0	1	19	0	0
3	53223110	.	T	C	11	6	17	0	0	17	0	0
3	53223290	.	G	A	16	14	30	0	0	30	0	0
3	53223415	.	C	T	11	10	21	0	1	22	0	0
3	53223783	.	C	T	17	9	26	0	1	27	0	0
3	53223973	.	A	C	10	6	16	0	0	16	0	0
3	53224029	.	G	A	11	12	23	0	1	24	0	0
3	53224181	.	A	G	16	10	26	0	0	26	0	0
3	53228771	.	T	A	17	12	29	0	3	32	0	0
3	53229021	.	G	A	17	19	36	0	1	37	0	0
3	53229036	.	T	A	20	18	38	0	0	38	0	0
3	53230980	.	T	C	12	4	16	0	1	17	0	0
3	53240607	.	G	A	0	2	2	0	2	4	0	0
3	53245548	.	G	T	1	2	3	0	0	3	0	0
3	53245549	.	G	T	1	2	3	0	0	3	0	0
3	53248260	.	C	T	1	4	5	0	0	5	0	0
3	53248278	.	A	G	1	0	1	0	2	3	0	0
3	53253891	.	T	G	3	2	5	0	0	5	0	0
3	53253900	.	C	T	2	2	4	0	1	5	0	0
3	53264626	.	C	T	3	4	7	0	1	8	0	0
3	53264641	.	T	G	3	5	8	0	0	8	0	0
3	53264689	.	T	C	2	3	5	0	1	6	0	0
3	53267769	.	T	C	3	4	7	0	0	7	0	0
3	53271759	.	A	G	1	0	1	0	3	4	0	0
3	53273484	.	G	A	0	2	2	0	1	3	0	0
3	53273539	.	T	C	2	2	4	0	0	4	0	0
3	53273545	.	A	G	0	2	2	0	0	2	0	0
3	53273579	.	C	T	2	2	4	0	0	4	0	0
3	53273599	.	A	G	2	2	4	0	0	4	0	0
3	53273763	.	G	A	3	2	5	0	0	5	0	0
3	53317044	.	T	G	1	2	3	0	0	3	0	0
3	53317061	.	C	T	2	3	5	0	0	5	0	0
3	53319426	.	C	T	4	2	6	0	0	6	0	0
3	53325722	.	C	T	1	3	4	0	0	4	0	0
3	53327058	.	T	A	6	8	14	0	0	14	0	0
3	53329518	.	C	T	1	4	5	0	1	6	0	0
3	53330005	.	A	G	4	4	8	0	0	8	0	0
3	53342694	.	G	A	6	2	8	0	0	8	0	0
3	53342706	.	C	A	6	3	9	0	0	9	0	0
3	53343415	.	C	T	5	6	11	0	0	11	0	0
3	53343418	.	C	T	5	7	12	0	0	12	0	0
3	53344694	.	T	C	5	6	11	0	0	11	0	0
3	53344842	.	C	T	4	5	9	0	0	9	0	0
3	53344968	.	C	T	4	3	7	0	0	7	0	0
3	53350410	.	T	C	7	2	9	0	0	9	0	0
3	53350411	.	G	A	7	2	9	0	0	9	0	0
3	53350547	.	A	G	2	0	2	0	3	5	0	0
3	53352516	.	G	T	5	6	11	0	1	12	0	0
3	53352579	.	A	G	2	3	5	0	1	6	0	0
3	53352604	.	A	G	2	4	6	0	1	7	0	0
3	53352621	.	G	A	0	3	3	0	4	7	0	0
3	53352736	.	G	A	0	2	2	0	3	5	0	0
3	53398022	.	C	T	3	2	5	0	2	7	0	0
3	53398107	.	G	T	4	4	8	0	2	10	0	0
3	53444492	.	G	A	6	3	9	0	0	9	0	0
3	53444674	.	G	A	1	5	6	0	4	10	0	0
3	53445378	.	A	T	5	11	16	0	0	16	0	0
3	53445979	.	C	T	6	3	9	0	1	10	0	0
3	53446039	.	A	C	4	3	7	0	0	7	0	0
3	53446126	.	G	A	2	6	8	0	0	8	0	0
3	53446429	.	A	G	10	6	16	0	0	16	0	0
3	53447714	.	C	T	4	4	8	0	0	8	0	0
3	53447717	.	C	T	3	5	8	0	0	8	0	0
3	53447960	.	C	T	8	3	11	0	0	11	0	0
3	53448188	.	T	C	7	3	10	0	0	10	0	0
3	53448920	.	A	G	4	0	4	0	4	8	0	0
3	53449227	.	C	A	8	8	16	0	0	16	0	0
3	53449263	.	A	G	5	8	13	0	2	15	0	0
3	53484528	.	A	T	3	3	6	0	0	6	0	0
3	53484534	.	G	A	3	3	6	0	0	6	0	0
3	53527681	.	T	C	2	2	4	0	0	4	0	0
3	53528017	.	T	C	11	7	18	0	0	18	0	0
3	53528039	.	G	A	14	5	19	0	1	20	0	0
3	53528090	.	T	C	8	3	11	0	0	11	0	0
3	53528190	.	T	C	9	6	15	0	0	15	0	0
3	53528251	.	C	A	2	9	11	0	7	18	0	0
3	53528750	.	T	A	5	5	10	0	1	11	0	0
3	53528814	.	T	C	7	10	17	0	0	17	0	0
3	53528893	.	A	T	9	5	14	0	0	14	0	0
3	53529027	.	A	G	4	8	12	0	0	12	0	0
3	53529723	.	A	T	0	2	2	0	1	3	0	0
3	53530097	.	C	A	8	4	12	0	0	12	0	0
3	53530298	.	G	A	9	12	21	0	0	21	0	0
3	53530334	.	G	A	7	7	14	0	0	14	0	0
3	53530423	.	C	T	8	10	18	0	5	23	0	0
3	53530656	.	C	T	9	6	15	0	0	15	0	0
3	53530700	.	G	A	3	4	7	0	0	7	0	0
3	53687983	.	C	T	3	5	8	0	0	8	0	0
3	53688276	.	T	C	6	0	6	0	6	12	0	0
3	53688381	.	G	A	4	6	10	0	1	11	0	0
3	53698009	.	C	T	0	3	3	0	4	7	0	0
3	53823605	.	G	A	1	2	3	0	0	3	0	0
3	53823626	.	C	T	1	2	3	0	0	3	0	0
3	54047599	.	T	G	8	10	18	0	0	18	0	0
3	54047881	.	T	C	14	14	28	0	1	29	0	0
3	54168046	.	C	T	19	18	37	0	2	39	0	0
3	54168127	.	C	T	10	12	22	0	1	23	0	0
3	54168174	.	T	C	11	13	24	0	2	26	0	0
3	54168192	.	T	C	14	13	27	0	0	27	0	0
3	54168318	.	T	C	11	11	22	0	2	24	0	0
3	54207610	.	C	T	27	25	52	0	3	55	0	0
3	54223504	.	G	A	18	17	35	0	3	38	0	0
3	54236612	.	A	G	24	1	25	0	26	51	0	0
3	54236621	.	T	G	28	24	52	0	1	53	0	0
3	54236657	.	C	A	29	19	48	0	1	49	0	0
3	54236750	.	A	G	20	24	44	0	0	44	0	0
3	54236996	.	G	A	1	28	29	0	26	55	0	0
3	54237347	.	C	T	29	16	45	0	1	46	0	0
3	54237443	.	G	C	14	5	19	0	0	19	0	0
3	54237472	.	T	C	12	7	19	0	0	19	0	0
3	54434378	.	A	T	1	2	3	0	0	3	0	0
3	54434398	.	C	T	0	1	1	0	2	3	0	0
3	54434468	.	C	T	2	3	5	0	0	5	0	0
3	54434654	.	A	G	1	3	4	0	0	4	0	0
3	54435002	.	A	G	5	4	9	0	0	9	0	0
3	54435018	.	A	G	6	3	9	0	0	9	0	0
3	54435085	.	G	T	2	3	5	0	0	5	0	0
3	54435273	.	G	A	5	5	10	0	0	10	0	0
3	54435336	.	C	G	0	6	6	0	10	16	0	0
3	54435453	.	G	A	4	8	12	0	3	15	0	0
3	54438753	.	G	A	4	2	6	1	0	7	0	0
3	54455057	.	T	C	6	4	10	0	1	11	0	0
3	54455616	.	G	T	6	7	13	0	0	13	0	0
3	54455657	.	T	G	6	4	10	0	0	10	0	0
3	54455827	.	G	A	4	5	9	0	2	11	0	0
3	54456183	.	T	C	9	3	12	0	0	12	0	0
3	54474860	.	G	A	10	7	17	0	0	17	0	0
3	54500103	.	T	C	2	7	9	0	3	12	0	0
3	54500111	.	C	G	5	6	11	0	1	12	0	0
3	54554306	.	C	G	3	0	3	0	4	7	0	0
3	54561375	.	A	G	3	11	14	0	1	15	0	0
3	54567186	.	G	A	6	8	14	0	1	15	0	0
3	54567303	.	T	A	9	9	18	0	0	18	0	0
3	54567463	.	T	A	10	9	19	0	1	20	0	0
3	54567502	.	G	A	10	9	19	0	0	19	0	0
3	54567715	.	A	C	2	5	7	0	0	7	0	0
3	54567777	.	A	G	3	0	3	0	4	7	0	0
3	54567856	.	A	C	2	2	4	0	0	4	0	0
3	54567857	.	C	T	2	2	4	0	0	4	0	0
3	54583742	.	C	T	22	13	35	0	1	36	0	0
3	54585281	.	A	G	22	25	47	0	1	48	0	0
3	54585359	.	C	T	26	16	42	0	2	44	0	0
3	54585637	.	T	C	20	26	46	0	1	47	0	0
3	54585685	.	C	T	21	24	45	0	0	45	0	0
3	54586125	.	T	C	11	10	21	0	2	23	0	0
3	54589582	.	T	C	18	21	39	0	0	39	0	0
3	54591385	.	G	A	3	3	6	0	0	6	0	0
3	54591432	.	A	C	6	4	10	0	1	11	0	0
3	54591677	.	G	A	5	8	13	0	1	14	0	0
3	54591701	.	A	G	6	4	10	0	1	11	0	0
3	54591849	.	G	A	13	8	21	0	0	21	0	0
3	54592322	.	G	A	10	10	20	1	1	22	0	0
3	54592376	.	A	T	16	12	28	0	2	30	0	0
3	54593034	.	A	T	6	7	13	0	1	14	0	0
3	54593046	.	C	T	6	6	12	0	1	13	0	0
3	54594823	.	C	T	16	7	23	0	0	23	0	0
3	54594865	.	T	A	12	5	17	0	0	17	0	0
3	54596362	.	A	G	5	11	16	0	2	18	0	0
3	54596385	.	C	T	8	10	18	0	0	18	0	0
3	54596634	.	G	A	9	10	19	0	1	20	0	0
3	54596651	.	G	A	13	8	21	0	0	21	0	0
3	54596892	.	T	C	14	0	14	0	9	23	0	0
3	54596935	.	A	G	8	16	24	0	0	24	0	0
3	54597183	.	G	A	8	16	24	0	0	24	0	0
3	54597712	.	A	C	14	5	19	0	0	19	0	0
3	54598196	.	T	G	6	3	9	0	0	9	0	0
3	54600682	.	A	G	4	6	10	0	1	11	0	0
3	54601833	.	G	A	4	6	10	0	0	10	0	0
3	54601836	.	C	T	0	5	5	0	5	10	0	0
3	54601991	.	C	T	7	7	14	0	0	14	0	0
3	54602027	.	A	G	4	5	9	0	0	9	0	0
3	54602054	.	G	A	4	2	6	0	1	7	0	0
3	54602194	.	C	T	5	3	8	0	1	9	0	0
3	54603711	.	C	T	0	5	5	0	3	8	0	0
3	54603721	.	C	G	4	7	11	0	0	11	0	0
3	54603808	.	C	T	3	9	12	0	0	12	0	0
3	54604010	.	C	T	0	3	3	0	5	8	0	0
3	54607032	.	C	A	3	3	6	0	0	6	0	0
3	54616909	.	G	A	1	2	3	0	0	3	0	0
3	54744429	.	G	C	1	2	3	0	0	3	0	0
3	54749083	.	C	T	3	2	5	0	0	5	0	0
3	54767478	.	C	T	2	3	5	0	0	5	0	0
3	54771659	.	A	T	2	3	5	0	0	5	0	0
3	54771720	.	C	A	1	3	4	0	1	5	0	0
3	54809707	.	C	T	4	2	6	1	0	7	0	0
3	54810164	.	G	A	4	5	9	3	0	12	0	0
3	54837844	.	G	A	6	3	9	0	1	10	0	0
3	54837876	.	C	T	4	2	6	0	0	6	0	0
3	54845866	.	G	C	3	0	3	0	3	6	0	0
3	54849375	.	A	G	5	0	5	0	11	16	0	0
3	54849409	.	T	A	9	10	19	0	0	19	0	0
3	54849576	.	T	A	6	7	13	3	0	16	0	0
3	54850678	.	C	T	8	4	12	0	0	12	0	0
3	54852465	.	T	C	6	8	14	0	0	14	0	0
3	54852507	.	G	A	6	6	12	0	0	12	0	0
3	54856549	.	A	T	7	8	15	0	0	15	0	0
3	54856591	.	T	C	15	4	19	0	1	20	0	0
3	54856592	.	C	T	13	5	18	0	1	19	0	0
3	54856645	.	T	C	20	6	26	0	0	26	0	0
3	54859022	.	G	A	2	12	14	0	16	30	0	0
3	54859127	.	T	C	14	12	26	0	0	26	0	0
3	54866207	.	A	G	17	11	28	1	1	30	0	0
3	54868514	.	C	T	9	9	18	0	0	18	0	0
3	54871515	.	C	A	22	24	46	0	3	49	0	0
3	54871745	.	C	T	14	10	24	0	1	25	0	0
3	54872003	.	C	G	9	11	20	0	0	20	0	0
3	54872172	.	T	A	12	6	18	0	0	18	0	0
3	54872207	.	T	C	21	3	24	0	0	24	0	0
3	54872213	.	A	C	21	3	24	0	1	25	0	0
3	54872520	.	C	G	13	8	21	0	1	22	0	0
3	54873055	.	C	A	17	20	37	0	0	37	0	0
3	54873844	.	T	C	11	16	27	0	1	28	0	0
3	54874245	.	C	T	10	9	19	1	2	22	0	0
3	54874371	.	C	T	17	9	26	0	0	26	0	0
3	54874477	.	A	G	14	12	26	0	2	28	0	0
3	54874631	.	G	A	17	9	26	0	1	27	0	0
3	54874660	.	C	T	13	11	24	0	5	29	0	0
3	54874711	.	G	A	7	14	21	0	0	21	0	0
3	54896371	.	A	G	1	2	3	0	1	4	0	0
3	54896372	.	G	T	2	2	4	0	0	4	0	0
3	54897099	.	G	T	5	3	8	0	0	8	0	0
3	54897152	.	G	A	3	4	7	0	0	7	0	0
3	54902365	.	C	T	0	5	5	0	1	6	0	0
3	54907937	.	C	T	0	8	8	0	5	13	0	0
3	54908057	.	C	T	1	3	4	0	0	4	0	0
3	54910359	.	A	G	2	2	4	0	0	5	1	0
3	54911854	.	T	G	4	5	9	0	0	9	0	0
3	54911890	.	T	C	4	3	7	0	0	7	0	0
3	54912019	.	C	T	3	9	12	0	0	12	0	0
3	54914258	.	A	G	5	3	8	0	0	8	0	0
3	54916497	.	T	C	3	5	8	0	0	8	0	0
3	54992928	.	T	G	2	3	5	0	1	6	0	0
3	55032137	.	C	G	2	2	4	0	0	4	0	0
3	55042728	.	C	T	3	3	6	0	0	6	0	0
3	55045602	.	T	A	4	5	9	0	0	9	0	0
3	55045709	.	G	T	1	6	7	0	3	10	0	0
3	55045854	.	A	G	5	2	7	0	0	7	0	0
3	55046165	.	A	G	10	4	14	0	0	14	0	0
3	55050175	.	A	G	7	7	14	0	0	14	0	0
3	55050191	.	T	A	4	4	8	0	0	8	0	0
3	55053879	.	A	G	3	6	9	0	0	9	0	0
3	55063295	.	C	T	0	1	1	0	2	3	0	0
3	55079251	.	C	T	3	3	6	0	0	6	0	0
3	55079269	.	T	C	4	3	7	0	0	7	0	0
3	55079287	.	T	C	4	0	4	0	4	8	0	0
3	55079508	.	A	T	2	4	6	0	0	6	0	0
3	55079530	.	G	T	1	4	5	0	0	5	0	0
3	55091710	.	A	G	4	15	19	0	0	19	0	0
3	55091734	.	A	T	3	21	24	0	0	24	0	0
3	55091941	.	C	T	2	2	4	0	0	4	0	0
3	55093668	.	G	C	7	14	21	0	0	21	0	0
3	55093923	.	T	C	12	14	26	0	0	26	0	0
3	55093980	.	T	C	11	7	18	0	1	19	0	0
3	55094004	.	C	T	6	7	13	0	0	13	0	0
3	55094016	.	A	G	7	6	13	0	0	13	0	0
3	55094200	.	C	G	4	6	10	0	0	10	0	0
3	55098813	.	G	T	31	13	44	31	5	80	0	0
3	55100228	.	T	C	32	11	43	6	2	51	0	0
3	55100522	.	A	G	10	14	24	45	1	70	0	0
3	55100590	.	T	G	38	20	58	19	1	78	0	0
3	55100795	.	A	G	29	14	43	28	0	71	0	0
3	55103453	.	A	G	5	2	7	8	3	18	0	0
3	55104214	.	T	C	15	0	15	26	4	45	0	0
3	55104215	.	A	G	13	4	17	26	1	44	0	0
3	55105254	.	T	C	10	14	24	25	1	50	0	0
3	55161819	.	A	T	2	4	6	0	0	6	0	0
3	55162551	.	G	A	8	3	11	0	0	11	0	0
3	55164243	.	C	T	0	3	3	0	5	8	0	0
3	55174830	.	G	A	5	3	8	0	1	9	0	0
3	55174832	.	C	A	4	4	8	0	0	8	0	0
3	55174998	.	G	A	4	4	8	0	0	8	0	0
3	55178801	.	A	G	1	2	3	0	0	3	0	0
3	55178807	.	T	G	1	2	3	0	0	3	0	0
3	55197782	.	T	C	1	2	3	0	0	3	0	0
3	55218724	.	C	T	0	5	5	0	2	7	0	0
3	55218772	.	G	A	2	3	5	0	0	5	0	0
3	55218830	.	T	C	2	0	2	0	1	3	0	0
3	55219120	.	T	C	4	1	5	0	0	5	0	0
3	55219125	.	T	C	3	2	5	0	0	5	0	0
3	55219205	.	G	A	7	2	9	0	0	9	0	0
3	55222778	.	G	T	2	2	4	0	0	4	0	0
3	55229436	.	G	A	1	2	3	0	1	4	0	0
3	55229759	.	G	A	3	3	6	0	0	6	0	0
3	55229777	.	G	C	0	0	0	0	6	6	0	0
3	55233840	.	G	T	2	5	7	0	0	7	0	0
3	55242726	.	G	A	1	2	3	0	0	3	0	0
3	55244554	.	A	G	5	2	7	0	0	7	0	0
3	55251622	.	C	A	0	2	2	0	2	4	0	0
3	55269307	.	G	A	1	2	3	0	0	3	0	0
3	55269870	.	A	G	1	4	5	0	1	6	0	0
3	55322264	.	G	A	2	2	4	0	0	4	0	0
3	55422153	.	T	C	1	4	5	1	1	7	0	0
3	55422191	.	T	C	4	2	6	2	0	8	0	0
3	55422192	.	T	C	2	4	6	2	0	8	0	0
3	55422831	.	G	A	5	8	13	0	0	13	0	0
3	55422926	.	C	A	0	5	5	0	6	11	0	0
3	55422980	.	T	C	2	4	6	0	0	6	0	0
3	55423611	.	G	A	2	5	7	0	1	8	0	0
3	55430826	.	A	G	3	2	5	0	0	5	0	0
3	55438733	.	C	T	1	6	7	0	1	8	0	0
3	56883674	.	T	C	5	3	8	0	0	8	0	0
3	56883678	.	T	C	8	2	10	0	0	10	0	0
3	57462962	.	T	C	3	9	12	0	2	14	0	0
3	58197513	.	G	A	1	6	7	4	0	11	0	0
3	58197600	.	A	G	3	6	9	9	0	18	0	0
3	58197648	.	C	T	23	9	32	10	1	43	0	0
3	58197871	.	G	A	9	5	14	4	0	18	0	0
3	58210564	.	A	G	2	4	6	1	0	7	0	0
3	58210593	.	T	A	4	4	8	3	0	11	0	0
3	58211317	.	T	C	4	10	14	3	1	18	0	0
3	58608380	.	G	A	1	8	9	22	0	31	0	0
3	58615428	.	T	G	4	9	13	3	0	16	0	0
3	58615543	.	G	C	10	6	16	2	3	21	0	0
3	58704259	.	G	A	1	2	3	4	0	7	0	0
3	58704640	.	T	C	1	9	10	0	1	11	0	0
3	58704655	.	C	A	1	7	8	0	0	8	0	0
3	59802400	.	C	T	2	3	5	0	0	5	0	0
3	59805622	.	G	A	4	2	6	0	0	6	0	0
3	59808126	.	G	A	1	2	3	0	1	4	0	0
3	59816007	.	C	T	2	3	5	0	0	5	0	0
3	59868371	.	A	G	15	0	15	0	12	27	0	0
3	59868391	.	T	C	15	13	28	0	1	29	0	0
3	59868427	.	G	A	14	14	28	0	0	28	0	0
3	59870578	.	C	T	8	11	19	0	0	19	0	0
3	59876195	.	C	T	10	9	19	0	1	20	0	0
3	59876233	.	T	C	13	4	17	0	0	17	0	0
3	59876405	.	C	A	13	10	23	2	1	26	0	0
3	59880349	.	C	T	21	12	33	0	1	34	0	0
3	59880544	.	C	T	13	9	22	0	1	23	0	0
3	59883465	.	T	A	10	8	18	0	1	19	0	0
3	59883489	.	C	A	7	10	17	0	0	17	0	0
3	59887325	.	G	A	2	23	25	0	22	47	0	0
3	59887331	.	A	G	21	24	45	0	0	45	0	0
3	59889663	.	C	A	32	15	47	3	1	51	0	0
3	59941534	.	C	T	20	19	39	0	3	42	0	0
3	59941542	.	C	T	20	19	39	0	2	41	0	0
3	59941572	.	C	T	11	21	32	0	3	35	0	0
3	59942142	.	G	A	18	17	35	0	2	37	0	0
3	59945851	.	T	C	18	29	47	2	2	51	0	0
3	59945922	.	C	G	5	5	10	1	30	41	0	0
3	59946094	.	A	T	21	18	39	1	1	41	0	0
3	59946097	.	T	A	18	16	34	1	1	36	0	0
3	59946432	.	C	T	15	19	34	0	1	35	0	0
3	59946642	.	G	T	0	17	17	0	27	44	0	0
3	59946828	.	T	C	17	8	25	0	2	27	0	0
3	59946877	.	C	T	17	6	23	0	0	23	0	0
3	59946901	.	C	T	18	9	27	0	2	29	0	0
3	59947092	.	A	T	16	6	22	0	0	22	0	0
3	59951426	.	C	A	10	12	22	0	0	22	0	0
3	59951767	.	T	C	12	0	12	0	22	34	0	0
3	59951800	.	G	A	18	12	30	0	2	32	0	0
3	59952046	.	T	C	20	2	22	0	22	44	0	0
3	59952268	.	C	G	18	15	33	0	0	33	0	0
3	59961399	.	G	A	18	19	37	0	2	39	0	0
3	59986172	.	C	T	0	3	3	0	2	5	0	0
3	59986181	.	G	T	4	2	6	0	0	6	0	0
3	59994744	.	G	A	10	10	20	0	3	23	0	0
3	59994888	.	C	T	9	2	11	0	1	12	0	0
3	59995019	.	T	G	7	11	18	0	0	18	0	0
3	59995028	.	C	T	5	9	14	0	2	16	0	0
3	59995122	.	G	T	11	6	17	0	0	17	0	0
3	59997180	.	C	T	2	5	7	0	2	9	0	0
3	59998195	.	C	T	2	2	4	0	0	4	0	0
3	60002951	.	T	C	3	10	13	0	0	13	0	0
3	60003007	.	T	A	13	3	16	0	0	16	0	0
3	60016147	.	C	T	1	2	3	0	0	3	0	0
3	60016177	.	A	T	1	2	3	0	0	3	0	0
3	60025650	.	T	C	2	2	4	0	4	8	0	0
3	60073756	.	A	G	2	2	4	1	0	5	0	0
3	60177849	.	G	A	4	4	8	0	0	8	0	0
3	60206163	.	G	A	5	2	7	0	0	7	0	0
3	60223424	.	G	A	1	3	4	0	1	5	0	0
3	60225995	.	T	C	1	3	4	0	0	4	0	0
3	60226005	.	T	C	1	3	4	0	0	4	0	0
3	60294079	.	A	G	0	3	3	3	1	7	0	0
3	60294089	.	C	G	1	7	8	4	0	12	0	0
3	60526316	.	C	T	0	3	3	0	3	6	0	0
3	60526385	.	G	C	2	5	7	0	0	7	0	0
3	60526647	.	A	G	1	3	4	0	0	4	0	0
3	60567573	.	C	G	2	7	9	0	0	9	0	0
3	60575958	.	G	A	2	3	5	0	0	5	0	0
3	60575990	.	T	C	1	2	3	0	0	3	0	0
3	60576371	.	G	A	2	3	5	0	0	5	0	0
3	60576453	.	G	A	2	3	5	0	0	5	0	0
3	60577319	.	T	C	2	2	4	0	0	4	0	0
3	60578117	.	G	A	1	2	3	0	0	3	0	0
3	60578352	.	A	C	1	0	1	0	3	4	0	0
3	60584225	.	A	G	1	4	5	0	0	5	0	0
3	60589244	.	G	T	4	3	7	0	1	8	0	0
3	60589503	.	G	A	4	5	9	0	0	9	0	0
3	60589644	.	C	T	2	2	4	0	0	4	0	0
3	60594169	.	A	G	1	6	7	0	0	7	0	0
3	60594197	.	C	G	5	4	9	0	0	9	0	0
3	60595980	.	G	T	6	3	9	0	0	9	0	0
3	60595983	.	A	T	7	3	10	0	0	10	0	0
3	60596020	.	G	A	5	4	9	0	0	9	0	0
3	60596264	.	G	C	1	2	3	0	0	3	0	0
3	60596647	.	A	G	7	2	9	0	0	9	0	0
3	60596808	.	A	C	10	7	17	0	0	17	0	0
3	60601907	.	A	T	10	5	15	0	0	15	0	0
3	60601958	.	G	A	10	3	13	0	2	15	0	0
3	60618971	.	G	A	0	6	6	0	5	11	0	0
3	60620712	.	A	G	1	2	3	0	1	4	0	0
3	60685330	.	C	T	3	3	6	0	1	7	0	0
3	60710969	.	C	T	5	5	10	0	0	10	0	0
3	60711017	.	T	C	7	4	11	0	0	11	0	0
3	60722182	.	G	T	1	2	3	0	5	8	0	0
3	60722200	.	G	A	3	5	8	0	0	8	0	0
3	60730287	.	C	G	3	7	10	0	0	10	0	0
3	60731022	.	A	C	2	4	6	0	1	7	0	0
3	60731100	.	A	T	2	3	5	0	0	5	0	0
3	60731557	.	G	T	3	4	7	0	0	7	0	0
3	60732098	.	A	T	7	3	10	0	0	10	0	0
3	60732306	.	C	A	3	2	5	0	0	5	0	0
3	60732406	.	C	T	4	2	6	0	0	6	0	0
3	60732416	.	G	A	4	2	6	0	0	6	0	0
3	60732761	.	G	T	0	2	2	0	1	3	0	0
3	60778550	.	T	C	3	2	5	0	0	5	0	0
3	60789331	.	G	A	3	4	7	0	3	10	0	0
3	60789730	.	C	A	2	2	4	0	0	4	0	0
3	60795738	.	A	G	3	0	3	0	6	9	0	0
3	60795789	.	T	C	1	2	3	0	0	3	0	0
3	60818468	.	A	G	1	2	3	0	1	4	0	0
3	60818735	.	C	T	1	4	5	0	0	5	0	0
3	60829456	.	G	T	6	3	9	0	0	9	0	0
3	60834600	.	C	T	3	5	8	0	1	9	0	0
3	60834672	.	G	A	0	5	5	0	4	9	0	0
3	60835623	.	C	T	6	5	11	0	1	12	0	0
3	60839133	.	G	A	1	4	5	0	6	11	0	0
3	60839303	.	C	T	5	4	9	0	0	9	0	0
3	60841105	.	C	T	6	8	14	0	0	14	0	0
3	60841149	.	C	T	6	6	12	0	0	12	0	0
3	60854011	.	C	T	4	4	8	0	0	8	0	0
3	60855800	.	C	T	6	5	11	0	0	11	0	0
3	60862519	.	G	A	22	16	38	0	1	39	0	0
3	60864804	.	G	A	13	5	18	0	1	19	0	0
3	60875101	.	C	T	14	14	28	0	1	29	0	0
3	60875169	.	T	G	10	11	21	0	0	21	0	0
3	60962589	.	T	C	4	7	11	0	2	13	0	0
3	60971719	.	G	C	19	7	26	0	1	27	0	0
3	60976921	.	C	T	7	5	12	0	0	12	0	0
3	60976985	.	G	A	0	13	13	0	8	21	0	0
3	60977060	.	A	G	13	0	13	0	15	28	0	0
3	60977134	.	T	A	6	6	12	0	0	12	0	0
3	60978344	.	G	A	11	9	20	0	0	21	1	0
3	60982492	.	A	C	15	12	27	0	1	28	0	0
3	60984213	.	A	G	13	1	14	0	16	30	0	0
3	60985862	.	C	T	15	11	26	0	2	28	0	0
3	60992134	.	A	G	20	0	20	0	14	34	0	0
3	60994781	.	G	C	19	9	28	0	1	29	0	0
3	60997781	.	C	G	21	14	35	0	0	35	0	0
3	61004295	.	G	A	1	19	20	0	17	37	0	0
3	61004397	.	C	T	17	13	30	0	1	31	0	0
3	61004442	.	G	T	16	16	32	0	1	33	0	0
3	61013397	.	C	T	16	11	27	0	0	28	1	0
3	61026883	.	G	T	17	22	39	0	0	39	0	0
3	61030127	.	G	A	18	14	32	0	3	35	0	0
3	61030181	.	C	T	18	15	33	0	2	35	0	0
3	61030220	.	C	T	20	18	38	0	3	41	0	0
3	61030699	.	G	C	11	18	29	0	2	31	0	0
3	61030800	.	G	A	17	18	35	0	5	40	0	0
3	61030829	.	G	A	27	16	43	0	4	47	0	0
3	61033183	.	C	T	15	28	43	0	4	47	0	0
3	61033859	.	C	A	17	19	36	0	7	43	0	0
3	61033979	.	C	A	24	27	51	0	0	51	0	0
3	61034060	.	T	G	33	0	33	0	26	59	0	0
3	61034096	.	T	C	20	24	44	0	6	50	0	0
3	61034130	.	A	C	15	2	17	0	29	46	0	0
3	61043871	.	G	A	8	12	20	0	1	21	0	0
3	61043925	.	G	T	11	11	22	0	0	22	0	0
3	61078285	.	T	C	3	2	5	0	0	5	0	0
3	61078325	.	T	G	3	3	6	0	0	6	0	0
3	61078337	.	A	C	3	3	6	0	0	6	0	0
3	61078484	.	C	T	2	3	5	0	0	5	0	0
3	61078492	.	A	G	2	3	5	0	0	5	0	0
3	61079085	.	A	T	2	4	6	0	0	6	0	0
3	61079390	.	A	G	5	3	8	0	1	9	0	0
3	61079477	.	G	A	4	2	6	0	0	6	0	0
3	61082852	.	T	C	1	0	1	0	2	3	0	0
3	61098695	.	C	T	1	5	6	0	0	6	0	0
3	61098925	.	G	C	3	2	5	0	0	5	0	0
3	61108600	.	G	T	18	7	25	0	3	28	0	0
3	61108732	.	A	G	10	17	27	0	1	28	0	0
3	61108734	.	T	C	11	1	12	0	17	29	0	0
3	61108830	.	C	A	1	12	13	0	17	30	0	0
3	61111826	.	G	T	12	11	23	0	0	23	0	0
3	61116160	.	C	T	11	8	19	0	1	20	0	0
3	61221441	.	T	A	3	3	6	0	1	7	0	0
3	61221589	.	C	T	5	2	7	0	0	7	0	0
3	61244015	.	C	T	11	6	17	0	0	17	0	0
3	61264122	.	G	A	6	11	17	0	0	17	0	0
3	61276907	.	C	T	3	6	9	0	0	9	0	0
3	61277028	.	C	G	15	9	24	0	0	24	0	0
3	61278584	.	C	T	5	9	14	0	3	17	0	0
3	61278866	.	C	T	6	7	13	0	2	15	0	0
3	61278992	.	C	T	9	7	16	0	0	16	0	0
3	61279124	.	T	C	7	4	11	0	1	12	0	0
3	61279427	.	A	C	13	7	20	0	0	20	0	0
3	61279585	.	G	A	2	11	13	0	11	24	0	0
3	61279588	.	T	A	16	7	23	0	0	23	0	0
3	61279643	.	T	C	12	10	22	0	0	22	0	0
3	61279781	.	C	T	12	8	20	0	1	21	0	0
3	61279844	.	G	A	0	4	4	0	12	16	0	0
3	61280198	.	G	T	7	11	18	0	1	19	0	0
3	61280495	.	T	C	10	10	20	0	0	20	0	0
3	61280579	.	T	G	11	0	11	0	13	24	0	0
3	61280717	.	A	G	9	0	9	0	14	23	0	0
3	61285784	.	C	T	10	8	18	0	0	18	0	0
3	61285947	.	A	G	4	0	4	0	5	9	0	0
3	61286007	.	T	G	2	10	12	0	1	13	0	0
3	61286325	.	C	G	11	0	11	0	7	18	0	0
3	61286387	.	C	T	1	2	3	0	0	3	0	0
3	61286468	.	C	T	5	5	10	0	0	10	0	0
3	61286522	.	A	C	2	4	6	0	0	6	0	0
3	61286528	.	A	T	5	3	8	1	0	9	0	0
3	61286889	.	T	C	9	12	21	0	2	23	0	0
3	61286998	.	G	A	0	15	15	0	10	25	0	0
3	61287010	.	A	G	8	15	23	0	0	23	0	0
3	61287094	.	A	G	7	0	7	0	7	14	0	0
3	61287214	.	A	T	8	12	20	0	0	20	0	0
3	61287260	.	G	T	11	5	16	0	0	16	0	0
3	61287289	.	C	T	9	8	17	0	0	17	0	0
3	61287343	.	G	T	11	15	26	0	0	26	0	0
3	61287491	.	T	A	16	11	27	0	0	27	0	0
3	61287627	.	C	G	13	17	30	0	0	30	0	0
3	61287893	.	T	G	18	0	18	0	13	31	0	0
3	61288028	.	T	C	13	15	28	0	1	29	0	0
3	61288238	.	A	C	12	10	22	0	0	22	0	0
3	61303838	.	G	A	1	3	4	0	0	4	0	0
3	61306473	.	C	G	3	3	6	0	0	6	0	0
3	61319542	.	C	T	1	3	4	0	1	5	0	0
3	61334468	.	G	A	1	2	3	0	0	3	0	0
3	61342032	.	C	T	0	4	4	0	3	7	0	0
3	61342341	.	G	T	6	4	10	0	1	11	0	0
3	61342770	.	G	A	8	8	16	0	2	18	0	0
3	61342942	.	T	C	8	4	12	0	1	13	0	0
3	61343181	.	C	G	3	6	9	0	0	9	0	0
3	61343425	.	T	A	4	6	10	0	0	10	0	0
3	61343589	.	T	C	3	2	5	0	0	5	0	0
3	61349495	.	C	A	4	2	6	0	0	6	0	0
3	61349556	.	C	G	4	3	7	0	0	7	0	0
3	61349602	.	G	A	6	7	13	0	1	14	0	0
3	61349654	.	C	T	8	6	14	0	0	14	0	0
3	61349734	.	G	A	12	8	20	0	1	21	0	0
3	61349820	.	A	G	5	2	7	0	0	7	0	0
3	61349887	.	A	T	7	5	12	0	0	12	0	0
3	61350466	.	T	A	1	5	6	0	0	6	0	0
3	61350487	.	T	C	2	2	4	0	0	4	0	0
3	61350667	.	C	T	4	4	8	0	0	8	0	0
3	61350673	.	T	G	5	4	9	0	1	10	0	0
3	61351007	.	A	G	5	7	12	0	0	12	0	0
3	61351073	.	C	T	3	6	9	0	0	9	0	0
3	61351294	.	A	G	3	4	7	0	0	7	0	0
3	61351691	.	C	G	5	2	7	1	0	8	0	0
3	61351719	.	T	A	2	1	3	0	0	3	0	0
3	61351967	.	T	C	5	5	10	0	0	10	0	0
3	61352062	.	C	T	3	4	7	0	0	7	0	0
3	61354125	.	T	A	2	2	4	0	0	4	0	0
3	61354143	.	C	T	2	2	4	0	0	4	0	0
3	61354221	.	A	G	4	6	10	0	0	10	0	0
3	61358265	.	C	T	7	5	12	0	0	12	0	0
3	61358269	.	G	A	5	6	11	0	1	12	0	0
3	61358787	.	C	T	6	2	8	0	0	8	0	0
3	61359027	.	A	T	1	2	3	0	0	3	0	0
3	61359605	.	A	G	8	0	8	0	1	9	0	0
3	61359629	.	A	G	0	5	5	0	0	5	0	0
3	61359713	.	C	A	0	4	4	0	4	8	0	0
3	61360127	.	C	T	1	2	3	2	1	6	0	0
3	61365135	.	G	A	5	4	9	7	0	16	0	0
3	61372259	.	G	A	3	2	5	0	0	5	0	0
3	61372724	.	A	G	4	5	9	0	0	9	0	0
3	61372736	.	T	C	4	1	5	0	4	9	0	0
3	61375539	.	A	T	4	2	6	0	0	6	0	0
3	61375586	.	G	A	1	2	3	2	1	6	0	0
3	61382369	.	C	A	1	2	3	2	0	5	0	0
3	61382382	.	G	C	1	2	3	2	0	5	0	0
3	61383072	.	C	T	0	7	7	3	2	12	0	0
3	61383084	.	G	A	8	2	10	2	0	12	0	0
3	61383279	.	G	A	4	4	8	0	1	9	0	0
3	61383550	.	T	G	1	2	3	0	1	4	0	0
3	61383824	.	G	A	6	5	11	1	0	12	0	0
3	61385043	.	A	G	4	7	11	0	1	12	0	0
3	61391687	.	T	C	8	11	19	0	1	20	0	0
3	61391797	.	G	A	1	7	8	0	11	19	0	0
3	61392048	.	A	G	10	0	10	0	19	29	0	0
3	61396523	.	C	T	8	15	23	1	1	25	0	0
3	61396868	.	A	T	3	5	8	0	1	9	0	0
3	61397093	.	C	T	11	9	20	0	0	20	0	0
3	61397231	.	C	A	11	10	21	0	1	22	0	0
3	61397294	.	C	T	7	6	13	0	1	14	0	0
3	61398728	.	A	G	12	8	20	0	1	21	0	0
3	61398809	.	T	C	7	8	15	0	0	15	0	0
3	61542663	.	G	A	0	2	2	0	3	5	0	0
3	61542700	.	C	T	2	2	4	0	0	4	0	0
3	61542854	.	G	T	6	5	11	0	0	11	0	0
3	61542910	.	C	T	4	3	7	0	0	7	0	0
3	61543130	.	G	A	1	3	4	0	0	4	0	0
3	61585516	.	G	A	2	3	5	0	0	5	0	0
3	61592775	.	T	C	1	0	1	0	2	3	0	0
3	61961782	.	A	C	4	2	6	0	1	7	0	0
3	62034943	.	G	A	10	5	15	0	0	15	0	0
3	62035030	.	G	A	0	10	10	0	9	19	0	0
3	62035861	.	C	T	7	4	11	0	0	11	0	0
3	62036047	.	G	A	0	8	8	0	8	16	0	0
3	62036320	.	A	G	9	2	11	0	1	12	0	0
3	62036323	.	A	G	9	3	12	0	0	12	0	0
3	62036426	.	G	A	5	5	10	0	2	12	0	0
3	62036570	.	G	A	8	14	22	0	1	23	0	0
3	62037105	.	T	C	5	10	15	0	0	15	0	0
3	62037343	.	G	C	4	7	11	0	0	11	0	0
3	62037430	.	A	G	6	0	6	0	8	14	0	0
3	62037716	.	G	A	6	5	11	0	0	11	0	0
3	62038526	.	T	C	11	11	22	0	0	22	0	0
3	62038739	.	G	C	14	9	23	0	1	24	0	0
3	62038993	.	G	A	2	9	11	0	15	26	0	0
3	62039278	.	A	G	15	0	15	0	14	29	0	0
3	62039657	.	G	A	2	12	14	0	13	27	0	0
3	62039689	.	C	A	12	14	26	0	0	26	0	0
3	62039718	.	G	A	8	13	21	0	1	22	0	0
3	62039813	.	T	A	11	10	21	0	0	21	0	0
3	62040555	.	G	A	13	24	37	0	1	38	0	0
3	62051107	.	C	T	17	5	22	0	2	24	0	0
3	62051125	.	C	T	17	3	20	0	1	21	0	0
3	62051395	.	A	G	13	11	24	2	0	26	0	0
3	62051660	.	T	A	14	5	19	0	0	19	0	0
3	62051731	.	G	A	4	2	6	0	0	6	0	0
3	62068866	.	A	G	6	4	10	0	0	10	0	0
3	62068871	.	A	G	5	5	10	0	0	10	0	0
3	62069739	.	G	T	8	6	14	0	1	15	0	0
3	62069815	.	G	A	12	13	25	0	2	27	0	0
3	62069821	.	G	A	15	12	27	0	2	29	0	0
3	62070762	.	T	C	14	6	20	0	0	20	0	0
3	62070890	.	G	A	16	13	29	0	0	29	0	0
3	62073967	.	T	A	17	12	29	0	2	31	0	0
3	62074030	.	T	C	12	8	20	0	0	20	0	0
3	62080117	.	G	C	19	11	30	0	1	31	0	0
3	62080172	.	G	A	7	17	24	0	4	28	0	0
3	62080183	.	G	A	15	10	25	0	2	27	0	0
3	62091398	.	A	G	1	6	7	0	1	8	0	0
3	62091632	.	T	A	6	11	17	0	0	17	0	0
3	62091660	.	T	A	5	9	14	0	1	15	0	0
3	62091880	.	C	T	14	5	19	0	2	21	0	0
3	62091975	.	C	A	15	8	23	0	2	25	0	0
3	62091995	.	G	T	16	7	23	0	1	24	0	0
3	62092262	.	T	A	3	11	14	0	0	14	0	0
3	62092279	.	A	T	2	7	9	0	0	9	0	0
3	62092666	.	G	A	13	16	29	0	0	29	0	0
3	62092715	.	A	C	10	14	24	0	0	24	0	0
3	62092749	.	G	C	6	9	15	0	0	15	0	0
3	62092801	.	C	T	9	5	14	0	0	14	0	0
3	62092902	.	A	T	10	10	20	0	0	20	0	0
3	62093241	.	T	A	16	9	25	0	0	25	0	0
3	62093567	.	A	C	1	5	6	0	1	7	0	0
3	62093955	.	T	A	2	2	4	0	0	4	0	0
3	62094006	.	A	C	2	4	6	0	0	6	0	0
3	62094327	.	C	T	11	7	18	0	1	19	0	0
3	62094645	.	A	G	8	5	13	0	0	13	0	0
3	62094686	.	C	A	0	5	5	0	6	11	0	0
3	62094849	.	A	G	11	10	21	0	0	21	0	0
3	62095051	.	G	A	11	7	18	0	0	18	0	0
3	62095130	.	T	A	2	3	5	0	0	5	0	0
3	62095175	.	T	A	8	8	16	0	1	17	0	0
3	62095572	.	T	A	11	3	14	0	0	14	0	0
3	62095573	.	G	T	11	3	14	0	0	14	0	0
3	62095827	.	G	C	4	4	8	1	0	9	0	0
3	62095887	.	T	C	7	0	7	0	10	17	0	0
3	62095940	.	G	C	5	6	11	0	0	11	0	0
3	62095980	.	A	C	6	6	12	0	0	12	0	0
3	62096021	.	G	A	6	4	10	0	0	10	0	0
3	62096288	.	A	T	2	3	5	0	0	5	0	0
3	62096871	.	G	T	4	2	6	0	0	6	0	0
3	62097272	.	T	C	1	3	4	0	1	5	0	0
3	62097300	.	A	T	5	2	7	0	0	7	0	0
3	62097490	.	A	T	9	3	12	0	4	16	0	0
3	62097548	.	A	T	6	9	15	0	0	15	0	0
3	62114615	.	C	T	0	8	8	0	5	13	0	0
3	62114663	.	C	T	11	8	19	0	0	19	0	0
3	62117154	.	C	T	0	7	7	0	9	16	0	0
3	62117187	.	C	T	7	9	16	0	0	16	0	0
3	62129751	.	T	C	6	3	9	0	0	9	0	0
3	62129754	.	G	A	7	3	10	0	0	10	0	0
3	62138746	.	A	G	5	2	7	0	0	7	0	0
3	62147737	.	G	A	8	9	17	0	0	17	0	0
3	62149774	.	C	T	10	13	23	0	2	25	0	0
3	62173546	.	C	T	6	3	9	0	0	9	0	0
3	62173593	.	T	C	6	3	9	0	0	9	0	0
3	62173628	.	T	C	6	4	10	0	0	10	0	0
3	62180788	.	G	A	6	5	11	0	0	11	0	0
3	62188877	.	A	G	1	2	3	0	0	3	0	0
3	62188883	.	G	A	2	3	5	0	0	5	0	0
3	62196977	.	C	T	6	10	16	0	0	16	0	0
3	62203509	.	G	A	8	7	15	0	0	15	0	0
3	62203653	.	T	A	6	2	8	0	0	8	0	0
3	62205906	.	C	A	6	5	11	2	0	13	0	0
3	62208678	.	C	T	5	3	8	0	0	8	0	0
3	62209216	.	A	G	3	7	10	0	0	10	0	0
3	62209325	.	A	G	4	3	7	0	1	8	0	0
3	62238692	.	G	A	1	5	6	3	0	9	0	0
3	62238721	.	C	T	3	5	8	0	1	9	0	0
3	62240421	.	A	T	1	2	3	0	0	3	0	0
3	62240972	.	G	T	1	2	3	1	0	4	0	0
3	62240973	.	C	T	1	2	3	1	0	4	0	0
3	62241387	.	G	A	2	2	4	0	0	4	0	0
3	62241401	.	A	T	2	2	4	0	0	4	0	0
3	62275115	.	A	T	3	4	7	0	0	7	0	0
3	62275598	.	G	A	3	3	6	0	1	7	0	0
3	62275743	.	T	C	5	4	9	0	0	9	0	0
3	62276009	.	A	T	2	4	6	0	0	6	0	0
3	62276101	.	G	A	4	4	8	0	1	9	0	0
3	62276104	.	A	G	4	4	8	0	1	9	0	0
3	62323087	.	T	C	2	3	5	1	0	6	0	0
3	62323165	.	T	C	5	7	12	0	0	12	0	0
3	62323564	.	C	T	1	6	7	0	1	8	0	0
3	62324030	.	C	T	2	2	4	0	0	4	0	0
3	62324063	.	A	T	5	2	7	0	0	7	0	0
3	62324382	.	C	G	2	3	5	0	0	5	0	0
3	62328846	.	G	C	8	3	11	4	1	16	0	0
3	62328938	.	A	C	5	5	10	1	0	11	0	0
3	62328970	.	A	G	8	5	13	1	0	14	0	0
3	62329097	.	G	C	3	6	9	0	0	9	0	0
3	62329545	.	G	T	2	4	6	0	0	6	0	0
3	62345335	.	A	G	2	4	6	0	0	6	0	0
3	62345471	.	A	T	6	5	11	1	1	13	0	0
3	62345588	.	T	A	4	3	7	0	1	8	0	0
3	62345770	.	A	T	3	13	16	0	0	16	0	0
3	62353952	.	G	A	9	4	13	0	2	15	0	0
3	62359440	.	G	T	9	15	24	0	0	24	0	0
3	62360484	.	C	T	16	14	30	0	0	30	0	0
3	62369864	.	G	A	23	19	42	0	1	43	0	0
3	62370068	.	A	G	19	19	38	0	0	38	0	0
3	62370381	.	A	G	13	13	26	0	0	26	0	0
3	62370476	.	G	A	12	18	30	0	1	31	0	0
3	62379739	.	C	T	13	17	30	0	2	32	0	0
3	62379797	.	A	T	7	6	13	0	1	14	0	0
3	62382863	.	A	G	41	23	64	0	1	65	0	0
3	62383438	.	G	A	30	33	63	0	0	63	0	0
3	62383439	.	A	G	29	33	62	0	1	63	0	0
3	62383565	.	T	A	21	25	46	0	3	49	0	0
3	62383589	.	A	C	27	16	43	1	2	46	0	0
3	62383610	.	G	C	21	4	25	1	17	43	0	0
3	62383706	.	C	T	27	26	53	4	3	60	0	0
3	62384112	.	T	A	4	6	10	3	2	15	0	0
3	62384208	.	C	T	2	40	42	0	19	62	1	0
3	62384219	.	G	A	40	13	53	0	2	55	0	0
3	62384423	.	C	G	30	40	70	0	1	71	0	0
3	62384428	.	T	A	40	29	69	0	2	71	0	0
3	62384565	.	C	G	33	30	63	1	1	65	0	0
3	62386420	.	T	C	37	0	37	0	28	65	0	0
3	62386955	.	G	T	37	25	62	0	2	64	0	0
3	62387141	.	C	T	4	28	32	1	24	57	0	0
3	62387144	.	C	T	31	23	54	1	2	57	0	0
3	62393321	.	G	A	31	9	40	0	3	43	0	0
3	62398151	.	C	T	4	3	7	0	0	7	0	0
3	62398192	.	C	A	1	4	5	0	0	5	0	0
3	62398193	.	C	A	1	4	5	0	0	5	0	0
3	62398359	.	C	T	1	2	3	0	0	3	0	0
3	62398820	.	A	G	4	3	7	0	0	7	0	0
3	62398836	.	G	C	3	3	6	0	2	8	0	0
3	62399310	.	T	C	3	5	8	0	0	8	0	0
3	62399314	.	A	C	5	4	9	0	0	9	0	0
3	62433064	.	C	T	11	4	15	0	0	15	0	0
3	62433138	.	T	G	3	10	13	0	1	14	0	0
3	62521142	.	T	C	8	0	8	0	3	11	0	0
3	62521263	.	T	A	11	10	21	0	0	21	0	0
3	62521956	.	G	A	13	11	24	0	1	25	0	0
3	62522063	.	A	T	14	11	25	0	0	25	0	0
3	62522065	.	G	T	13	11	24	0	1	25	0	0
3	62522238	.	A	G	4	15	19	0	2	21	0	0
3	62522742	.	C	A	10	5	15	0	3	18	0	0
3	62522750	.	G	C	8	9	17	0	1	18	0	0
3	62522804	.	C	T	1	10	11	0	11	22	0	0
3	62522808	.	C	T	2	7	9	0	10	19	0	0
3	62523031	.	A	G	8	16	24	3	2	29	0	0
3	62523032	.	A	T	17	8	25	3	1	29	0	0
3	62523325	.	G	T	9	13	22	0	1	23	0	0
3	62523502	.	G	A	10	7	17	0	0	17	0	0
3	62523550	.	C	T	10	10	20	0	1	21	0	0
3	62527379	.	G	T	14	5	19	0	0	19	0	0
3	62527397	.	G	T	6	8	14	0	4	18	0	0
3	62527533	.	C	A	5	5	10	0	2	12	0	0
3	62527550	.	C	T	0	10	10	1	0	11	0	0
4	316946	.	A	T	12	22	34	0	0	35	1	0
4	317091	.	A	G	18	19	37	0	0	37	0	0
4	317217	.	T	A	8	20	28	0	0	28	0	0
4	317275	.	G	T	9	14	23	0	2	25	0	0
4	317938	.	G	A	2	2	4	0	0	4	0	0
4	325126	.	G	A	8	6	14	0	0	14	0	0
4	325136	.	G	A	9	6	15	0	0	15	0	0
4	325161	.	A	C	7	0	7	0	9	16	0	0
4	329743	.	G	A	9	13	22	0	1	23	0	0
4	329746	.	A	G	10	12	22	0	0	22	0	0
4	332491	.	G	T	0	8	8	0	3	11	0	0
4	344264	.	T	G	2	5	7	0	0	7	0	0
4	344662	.	G	A	3	4	7	0	0	7	0	0
4	344878	.	C	G	2	3	5	0	1	6	0	0
4	348201	.	G	A	0	1	1	0	8	9	0	0
4	348216	.	C	T	9	3	12	0	0	12	0	0
4	348297	.	T	C	2	9	11	0	0	11	0	0
4	349298	.	T	C	7	2	9	0	0	9	0	0
4	349304	.	A	G	7	3	10	0	0	10	0	0
4	349490	.	A	C	8	5	13	0	1	14	0	0
4	349514	.	T	C	6	6	12	0	0	12	0	0
4	349886	.	T	C	5	13	18	0	1	19	0	0
4	350652	.	C	T	9	6	15	0	0	15	0	0
4	350832	.	G	A	4	2	6	0	0	6	0	0
4	351654	.	T	A	4	4	8	0	0	8	0	0
4	351840	.	G	C	6	4	10	0	1	11	0	0
4	351845	.	A	C	6	4	10	0	0	10	0	0
4	352031	.	C	G	5	4	9	0	1	10	0	0
4	352284	.	A	G	11	0	11	0	14	25	0	0
4	352289	.	T	C	11	13	24	0	1	25	0	0
4	352504	.	T	C	11	12	23	0	1	24	0	0
4	353049	.	A	T	12	6	18	0	0	18	0	0
4	353064	.	C	G	13	4	17	0	0	17	0	0
4	353238	.	T	G	12	1	13	0	4	17	0	0
4	353247	.	T	C	11	7	18	0	0	18	0	0
4	353379	.	A	T	9	9	18	0	2	20	0	0
4	353481	.	A	G	5	0	5	0	9	14	0	0
4	353638	.	C	T	6	6	12	0	0	12	0	0
4	353778	.	T	A	6	3	9	0	1	10	0	0
4	357887	.	T	G	9	13	22	0	3	25	0	0
4	357954	.	G	A	7	9	16	0	1	17	0	0
4	358080	.	T	C	7	3	10	0	0	10	0	0
4	362282	.	C	T	11	8	19	0	1	20	0	0
4	367532	.	T	G	11	1	12	0	11	23	0	0
4	385092	.	C	T	17	12	29	0	5	34	0	0
4	385625	.	A	T	4	5	9	0	0	9	0	0
4	385668	.	G	A	6	10	16	0	1	17	0	0
4	385710	.	T	C	14	11	25	0	0	25	0	0
4	386014	.	A	C	18	2	20	1	3	24	0	0
4	386037	.	T	G	19	6	25	1	1	27	0	0
4	386085	.	G	A	11	4	15	0	1	16	0	0
4	386124	.	C	A	3	3	6	0	9	15	0	0
4	386537	.	T	A	27	10	37	1	4	42	0	0
4	386538	.	T	A	31	8	39	1	4	44	0	0
4	387059	.	G	A	8	0	8	2	1	11	0	0
4	394020	.	T	C	29	41	70	0	4	74	0	0
4	397913	.	A	G	4	4	8	0	3	11	0	0
4	397974	.	G	T	1	2	3	0	0	3	0	0
4	624589	.	A	G	1	2	3	0	1	4	0	0
4	647752	.	G	T	9	10	19	0	1	20	0	0
4	659276	.	C	T	14	6	20	0	1	21	0	0
4	659345	.	T	C	8	4	12	0	2	14	0	0
4	660571	.	G	A	9	5	14	1	1	16	0	0
4	660649	.	T	A	18	15	33	0	0	33	0	0
4	660655	.	G	A	1	12	13	0	17	30	0	0
4	660715	.	T	C	20	6	26	0	0	26	0	0
4	667358	.	T	C	15	18	33	0	1	34	0	0
4	667382	.	A	G	16	0	16	0	14	30	0	0
4	674838	.	T	C	17	13	30	0	2	32	0	0
4	676885	.	A	G	9	9	18	0	0	18	0	0
4	676942	.	A	G	10	9	19	0	1	20	0	0
4	678853	.	C	T	10	12	22	0	0	22	0	0
4	679441	.	C	G	0	12	12	0	19	31	0	0
4	680314	.	G	T	10	9	19	0	3	22	0	0
4	680320	.	C	T	9	15	24	0	0	24	0	0
4	680359	.	C	T	8	13	21	0	0	21	0	0
4	680395	.	T	C	14	0	14	0	11	25	0	0
4	680404	.	G	A	15	10	25	0	0	25	0	0
4	681595	.	G	A	13	9	22	0	1	23	0	0
4	686987	.	G	A	2	7	9	0	5	14	0	0
4	686999	.	C	G	6	8	14	0	0	14	0	0
4	694254	.	T	C	7	2	9	0	2	11	0	0
4	694373	.	C	T	8	5	13	0	0	13	0	0
4	694680	.	A	C	6	5	11	0	0	11	0	0
4	694718	.	G	A	8	3	11	0	0	11	0	0
4	694741	.	T	G	6	7	13	0	0	13	0	0
4	694757	.	A	T	6	6	12	0	0	12	0	0
4	695367	.	C	T	6	6	12	0	0	12	0	0
4	700281	.	A	C	9	11	20	0	2	22	0	0
4	700284	.	G	T	1	8	9	0	12	21	0	0
4	700563	.	G	T	3	2	5	0	0	5	0	0
4	700569	.	G	A	1	2	3	0	3	6	0	0
4	700598	.	A	T	4	2	6	0	0	6	0	0
4	700606	.	T	C	2	2	4	0	0	4	0	0
4	700634	.	A	C	2	3	5	0	0	5	0	0
4	700665	.	G	T	1	1	2	0	1	3	0	0
4	702061	.	C	G	2	7	9	0	1	10	0	0
4	702130	.	G	A	2	5	7	0	2	9	0	0
4	702138	.	C	A	2	7	9	0	0	9	0	0
4	710278	.	G	C	1	4	5	0	0	5	0	0
4	710577	.	T	G	2	3	5	0	0	5	0	0
4	710593	.	G	A	2	4	6	0	0	6	0	0
4	736442	.	A	G	8	15	23	0	1	24	0	0
4	737636	.	A	T	4	3	7	0	0	7	0	0
4	737883	.	T	A	3	4	7	0	0	7	0	0
4	737927	.	T	G	2	3	5	0	1	6	0	0
4	740435	.	A	T	7	7	14	0	0	14	0	0
4	740921	.	T	C	8	5	13	0	1	14	0	0
4	740965	.	T	G	6	9	15	1	1	17	0	0
4	749803	.	G	A	20	13	33	0	2	35	0	0
4	749989	.	G	T	12	14	26	0	0	26	0	0
4	750016	.	T	C	13	1	14	0	10	24	0	0
4	750526	.	C	G	15	9	24	0	0	24	0	0
4	750531	.	C	T	17	9	26	0	1	27	0	0
4	750661	.	C	T	1	10	11	0	13	24	0	0
4	751275	.	A	G	11	7	18	0	0	18	0	0
4	751546	.	G	A	16	5	21	0	1	22	0	0
4	751553	.	C	T	15	6	21	0	1	22	0	0
4	751640	.	T	G	9	12	21	0	0	21	0	0
4	755539	.	C	T	13	4	17	0	0	17	0	0
4	757405	.	C	T	9	7	16	0	0	16	0	0
4	757613	.	T	C	12	12	24	0	0	24	0	0
4	760555	.	G	T	5	5	10	0	0	10	0	0
4	765112	.	A	G	8	10	18	0	0	18	0	0
4	766575	.	G	A	13	14	27	0	0	27	0	0
4	766588	.	G	A	14	11	25	0	1	26	0	0
4	766613	.	A	C	10	12	22	0	0	22	0	0
4	769533	.	A	T	14	9	23	0	0	23	0	0
4	769726	.	G	A	18	7	25	1	1	27	0	0
4	772363	.	C	T	14	10	24	0	0	24	0	0
4	776550	.	G	T	12	6	18	0	1	19	0	0
4	778111	.	G	A	18	15	33	0	2	35	0	0
4	779310	.	G	A	18	15	33	0	0	33	0	0
4	779363	.	T	C	16	0	16	0	17	33	0	0
4	779429	.	A	G	17	13	30	0	1	31	0	0
4	779442	.	G	A	17	15	32	0	0	32	0	0
4	783816	.	G	T	23	15	38	0	1	39	0	0
4	783835	.	A	G	25	14	39	0	1	40	0	0
4	784002	.	T	A	31	15	46	0	0	46	0	0
4	784177	.	T	C	23	20	43	0	5	48	0	0
4	784325	.	A	T	8	10	18	0	0	18	0	0
4	784373	.	T	A	6	7	13	0	0	13	0	0
4	784543	.	A	C	5	4	9	0	0	9	0	0
4	784558	.	G	A	6	3	9	0	0	9	0	0
4	784733	.	T	A	7	4	11	0	1	12	0	0
4	784854	.	C	A	6	3	9	0	1	10	0	0
4	784990	.	T	A	12	16	28	0	4	32	0	0
4	785011	.	T	C	17	8	25	0	3	28	0	0
4	785132	.	G	A	21	20	41	0	1	42	0	0
4	788970	.	G	C	20	0	20	0	21	41	0	0
4	789589	.	A	G	11	23	34	0	1	35	0	0
4	798804	.	G	A	8	12	20	0	1	21	0	0
4	798850	.	A	C	9	18	27	0	1	28	0	0
4	798861	.	G	T	10	17	27	0	1	28	0	0
4	799006	.	G	T	15	11	26	0	1	27	0	0
4	799090	.	T	C	16	16	32	0	0	32	0	0
4	799127	.	T	G	17	12	29	0	1	30	0	0
4	799245	.	G	A	13	13	26	0	0	26	0	0
4	799385	.	C	G	7	4	11	0	0	11	0	0
4	799475	.	A	G	12	10	22	0	0	23	1	0
4	799513	.	G	A	13	17	30	0	1	31	0	0
4	799620	.	C	T	22	14	36	0	0	36	0	0
4	799643	.	T	A	29	13	42	0	1	43	0	0
4	799933	.	C	T	21	19	40	0	1	41	0	0
4	800094	.	A	G	22	15	37	0	2	39	0	0
4	800113	.	A	G	22	19	41	0	0	42	1	0
4	800363	.	C	T	2	16	18	0	21	39	0	0
4	800520	.	T	C	27	21	48	0	1	49	0	0
4	802909	.	T	A	23	23	46	0	1	47	0	0
4	803862	.	T	C	19	0	19	0	16	35	0	0
4	806319	.	G	A	20	14	34	0	1	35	0	0
4	806322	.	T	C	21	14	35	0	0	35	0	0
4	807895	.	C	G	19	21	40	0	3	43	0	0
4	807898	.	A	G	19	21	40	0	1	41	0	0
4	808031	.	C	T	25	18	43	0	0	43	0	0
4	808421	.	A	G	13	16	29	0	1	30	0	0
4	809456	.	A	G	24	20	44	0	1	45	0	0
4	809512	.	T	C	22	0	22	0	23	45	0	0
4	809549	.	A	G	18	16	34	0	0	34	0	0
4	813157	.	G	A	12	16	28	0	0	28	0	0
4	813226	.	A	G	16	19	35	0	1	36	0	0
4	818931	.	A	C	1	3	4	0	0	4	0	0
4	818983	.	A	T	2	2	4	0	0	4	0	0
4	823659	.	G	A	2	2	4	0	1	5	0	0
4	824032	.	C	A	2	2	4	0	1	5	0	0
4	824040	.	C	G	3	2	5	0	0	5	0	0
4	831731	.	C	A	0	3	3	0	1	4	0	0
4	831732	.	A	G	1	3	4	0	0	4	0	0
4	862009	.	A	G	3	4	7	0	0	7	0	0
4	864324	.	T	A	1	7	8	0	1	9	0	0
4	864739	.	G	C	3	2	5	0	0	5	0	0
4	867454	.	A	G	3	2	5	0	0	5	0	0
4	867601	.	G	C	2	2	4	0	1	5	0	0
4	870876	.	C	T	4	4	8	0	0	8	0	0
4	872356	.	A	G	3	3	6	0	0	6	0	0
4	873763	.	C	G	4	3	7	0	1	8	0	0
4	874323	.	C	T	2	2	4	0	0	4	0	0
4	880033	.	A	G	3	2	5	0	0	5	0	0
4	880275	.	A	G	3	2	5	0	1	6	0	0
4	880286	.	C	T	4	2	6	0	0	6	0	0
4	880692	.	T	G	3	2	5	0	0	5	0	0
4	880693	.	G	T	3	2	5	0	0	5	0	0
4	880890	.	C	G	2	2	4	0	0	4	0	0
4	881497	.	A	C	1	2	3	0	0	3	0	0
4	883709	.	C	T	3	1	4	0	2	6	0	0
4	883729	.	A	G	2	3	5	0	1	6	0	0
4	883854	.	G	A	1	1	2	0	1	3	0	0
4	883906	.	T	A	1	2	3	0	0	3	0	0
4	905612	.	G	A	2	2	4	0	0	4	0	0
4	905801	.	A	C	1	3	4	0	0	4	0	0
4	959015	.	T	C	2	4	6	0	0	6	0	0
4	961542	.	G	A	4	2	6	0	0	6	0	0
4	963452	.	A	G	2	9	11	0	0	12	1	0
4	965124	.	C	G	0	2	2	0	2	4	0	0
4	967974	.	C	T	6	12	18	0	1	19	0	0
4	968001	.	G	A	1	12	13	0	4	17	0	0
4	968121	.	T	C	14	8	22	0	0	22	0	0
4	969475	.	A	T	11	4	15	0	2	18	1	0
4	970689	.	A	G	6	0	6	0	6	12	0	0
4	971765	.	A	G	8	7	15	0	2	17	0	0
4	971842	.	G	C	2	9	11	0	8	19	0	0
4	974482	.	C	T	8	7	15	0	1	16	0	0
4	975735	.	G	C	2	12	14	0	9	23	0	0
4	975758	.	C	T	14	9	23	0	0	23	0	0
4	975792	.	G	C	0	13	13	0	11	24	0	0
4	975938	.	T	C	9	11	20	0	1	21	0	0
4	982892	.	G	A	4	6	10	0	1	11	0	0
4	982893	.	T	C	6	4	10	0	0	10	0	0
4	982938	.	C	G	3	2	5	0	0	5	0	0
4	983105	.	G	A	0	2	2	0	3	5	0	0
4	986210	.	T	C	2	2	4	0	0	4	0	0
4	986350	.	C	A	1	2	3	0	3	6	0	0
4	1054775	.	G	A	6	16	22	0	0	22	0	0
4	1054866	.	G	T	37	7	44	0	5	49	0	0
4	1054868	.	G	A	32	6	38	0	11	50	1	0
4	1055008	.	C	T	43	13	56	0	1	57	0	0
4	1055081	.	C	T	37	11	48	0	0	48	0	0
4	1055095	.	T	A	32	12	44	0	3	47	0	0
4	1055149	.	A	G	18	9	27	0	0	27	0	0
4	1055200	.	A	G	14	6	20	2	2	24	0	0
4	1055724	.	C	T	26	20	46	0	5	51	0	0
4	1055770	.	A	G	33	22	55	0	2	57	0	0
4	1146384	.	T	C	10	4	14	0	0	14	0	0
4	1146466	.	G	C	7	8	15	0	0	15	0	0
4	1283605	.	A	G	2	0	2	0	7	9	0	0
4	1283626	.	T	C	2	7	9	0	2	11	0	0
4	1283707	.	C	T	10	6	16	0	0	16	0	0
4	1283989	.	G	A	9	3	12	0	0	12	0	0
4	1284013	.	C	A	11	5	16	0	0	16	0	0
4	1284608	.	T	A	6	8	14	0	1	15	0	0
4	1301785	.	G	T	1	4	5	0	0	5	0	0
4	1301848	.	G	A	3	6	9	0	0	9	0	0
4	1301866	.	A	T	4	8	12	0	1	13	0	0
4	1301921	.	T	C	6	0	6	0	8	14	0	0
4	1301954	.	C	T	8	5	13	0	0	13	0	0
4	1302059	.	T	C	14	1	15	1	7	23	0	0
4	1302155	.	A	G	18	7	25	0	0	25	0	0
4	1302198	.	G	A	9	3	12	0	6	18	0	0
4	1302385	.	G	A	9	11	20	0	1	21	0	0
4	1302401	.	G	A	12	13	25	0	1	26	0	0
4	1302437	.	A	G	16	13	29	0	0	29	0	0
4	1302485	.	T	C	14	0	14	0	8	22	0	0
4	1302488	.	T	C	13	0	13	0	10	23	0	0
4	1302584	.	A	G	13	6	19	1	0	20	0	0
4	1302609	.	A	G	7	8	15	1	1	17	0	0
4	1302624	.	A	G	9	10	19	1	0	20	0	0
4	1302702	.	C	A	8	12	20	0	0	20	0	0
4	1302785	.	C	T	1	12	13	0	12	25	0	0
4	1303044	.	C	T	2	11	13	0	0	13	0	0
4	1303097	.	A	G	4	8	12	0	0	12	0	0
4	1303196	.	G	A	8	5	13	0	0	13	0	0
4	1303206	.	T	C	6	0	6	0	4	10	0	0
4	1303235	.	G	C	6	0	6	0	6	12	0	0
4	1389106	.	C	T	16	13	29	0	0	29	0	0
4	1392957	.	G	A	6	12	18	0	1	19	0	0
4	1393032	.	T	A	4	11	15	0	1	16	0	0
4	1393062	.	A	G	6	10	16	0	1	17	0	0
4	1396176	.	C	T	8	9	17	0	0	17	0	0
4	1469788	.	T	C	7	5	12	0	0	12	0	0
4	1469839	.	A	T	1	3	4	0	0	4	0	0
4	1469872	.	A	G	3	3	6	0	0	6	0	0
4	1470000	.	C	T	10	3	13	0	0	13	0	0
4	1470380	.	C	A	15	10	25	0	0	25	0	0
4	1470689	.	T	C	8	0	8	0	4	13	1	0
4	1470707	.	T	G	5	4	9	1	2	12	0	0
4	1477538	.	A	G	10	7	17	0	2	19	0	0
4	1479855	.	C	A	9	7	16	0	0	16	0	0
4	1497159	.	G	A	11	6	17	0	1	18	0	0
4	1547304	.	G	C	3	3	6	0	0	6	0	0
4	1547354	.	G	A	0	3	3	0	3	6	0	0
4	1563938	.	T	A	5	4	9	0	1	10	0	0
4	1565288	.	G	A	2	3	5	0	0	5	0	0
4	1565315	.	G	T	4	2	6	0	0	6	0	0
4	1565587	.	G	A	6	7	13	0	1	14	0	0
4	1565673	.	T	C	6	5	11	0	0	11	0	0
4	1565789	.	A	G	4	2	6	0	1	7	0	0
4	1566427	.	C	A	4	4	8	0	0	8	0	0
4	1566501	.	T	C	1	2	3	0	0	3	0	0
4	1566502	.	T	G	1	0	1	0	2	3	0	0
4	1730440	.	A	G	28	5	33	0	1	34	0	0
4	1733945	.	T	C	1	2	3	0	0	3	0	0
4	1734755	.	T	C	2	2	4	0	0	4	0	0
4	1832229	.	T	C	3	0	3	0	7	10	0	0
4	1834169	.	C	G	3	9	12	0	1	13	0	0
4	1834190	.	G	A	9	4	13	0	0	13	0	0
4	1835982	.	T	C	2	3	5	0	0	5	0	0
4	1837647	.	A	T	2	5	7	0	1	8	0	0
4	1988669	.	G	A	4	6	10	0	0	10	0	0
4	1989101	.	T	C	6	0	6	0	6	12	0	0
4	1994560	.	A	T	3	10	13	0	1	14	0	0
4	1997528	.	C	T	1	5	6	0	7	13	0	0
4	1997549	.	G	A	6	7	13	0	0	13	0	0
4	2014312	.	T	C	7	0	7	0	9	16	0	0
4	2036617	.	C	A	0	6	6	0	9	15	0	0
4	2044213	.	A	G	13	9	22	0	0	22	0	0
4	2044432	.	G	T	24	9	33	2	0	35	0	0
4	2044517	.	A	G	19	10	29	0	2	31	0	0
4	2044721	.	A	C	2	3	5	0	0	5	0	0
4	2051259	.	C	T	0	2	2	0	2	4	0	0
4	2051447	.	A	G	1	3	4	0	0	4	0	0
4	2055067	.	C	A	7	5	12	0	9	21	0	0
4	2055103	.	G	T	4	10	14	0	1	15	0	0
4	2055118	.	T	A	4	7	11	0	0	11	0	0
4	2055265	.	G	A	17	15	32	0	3	35	0	0
4	2055318	.	G	A	24	17	41	0	2	43	0	0
4	2056028	.	G	A	20	23	43	0	0	43	0	0
4	2059765	.	C	A	14	6	20	0	0	20	0	0
4	2059801	.	T	A	11	14	25	0	0	25	0	0
4	2059831	.	C	G	9	14	23	0	0	23	0	0
4	2059846	.	A	T	14	7	21	0	0	21	0	0
4	2060125	.	T	C	12	11	23	0	1	24	0	0
4	2060134	.	C	T	11	12	23	0	1	24	0	0
4	2061214	.	G	A	11	9	20	0	2	22	0	0
4	2062085	.	A	G	10	11	21	0	1	22	0	0
4	2062133	.	G	A	7	10	17	0	0	17	0	0
4	2062237	.	T	A	4	10	14	0	1	15	0	0
4	2151743	.	G	A	6	5	11	0	0	11	0	0
4	2160995	.	G	A	9	10	19	0	0	19	0	0
4	2162664	.	T	G	12	6	18	0	2	20	0	0
4	2162726	.	C	G	0	13	13	0	12	25	0	0
4	2162798	.	G	A	16	6	22	0	0	22	0	0
4	2162804	.	A	G	15	7	22	0	2	24	0	0
4	2163383	.	T	C	10	0	10	0	11	21	0	0
4	2163521	.	A	G	12	7	19	0	1	20	0	0
4	2260515	.	T	C	5	0	5	0	12	17	0	0
4	2261176	.	A	G	3	6	9	0	0	9	0	0
4	2349386	.	G	A	16	7	23	0	0	23	0	0
4	2349391	.	C	T	12	7	19	0	1	20	0	0
4	2349527	.	A	G	16	9	25	0	0	25	0	0
4	2349542	.	A	T	9	13	22	0	1	23	0	0
4	2349576	.	A	C	3	11	14	0	1	15	0	0
4	2349656	.	T	C	3	2	5	1	1	7	0	0
4	2349798	.	G	A	11	11	22	0	1	23	0	0
4	2349805	.	G	T	10	8	18	0	2	20	0	0
4	2368016	.	A	G	23	17	40	19	1	60	0	0
4	2396616	.	C	T	4	6	10	0	0	10	0	0
4	2402861	.	G	A	2	4	6	0	1	7	0	0
4	2404782	.	T	G	3	5	8	0	0	8	0	0
4	2404785	.	G	A	3	4	7	0	1	8	0	0
4	2405686	.	C	T	2	2	4	0	0	4	0	0
4	2503808	.	T	C	9	6	15	0	0	15	0	0
4	2506611	.	C	T	22	10	32	0	0	32	0	0
4	2508427	.	A	C	16	17	33	0	1	34	0	0
4	2511830	.	C	T	23	14	37	0	3	40	0	0
4	2511921	.	T	C	19	17	36	0	1	37	0	0
4	2511991	.	A	T	18	10	28	0	0	28	0	0
4	2514580	.	G	A	3	2	5	0	0	5	0	0
4	2514596	.	C	A	1	2	3	0	0	3	0	0
4	2516385	.	G	A	3	9	12	0	1	13	0	0
4	2523618	.	C	G	4	6	10	0	0	10	0	0
4	2548957	.	T	C	3	4	7	0	0	7	0	0
4	2548968	.	T	C	2	5	7	0	0	7	0	0
4	2549060	.	G	A	7	2	9	0	0	9	0	0
4	2550932	.	T	C	6	5	11	0	0	11	0	0
4	2550934	.	C	T	1	5	6	0	5	11	0	0
4	2554997	.	G	A	10	8	18	0	1	19	0	0
4	2556364	.	A	C	12	0	12	0	7	19	0	0
4	2559498	.	A	G	5	5	10	0	0	10	0	0
4	2562365	.	A	G	5	4	9	0	0	9	0	0
4	2562373	.	A	G	6	2	8	0	2	10	0	0
4	2563181	.	G	A	3	5	8	0	0	8	0	0
4	2571695	.	T	A	7	5	12	0	0	12	0	0
4	2571701	.	A	G	6	6	12	0	0	12	0	0
4	2573559	.	G	T	10	3	13	0	3	16	0	0
4	2620973	.	C	A	10	10	20	0	1	21	0	0
4	2621086	.	G	A	14	6	20	0	1	21	0	0
4	2621186	.	G	A	13	16	29	0	1	30	0	0
4	2621761	.	T	C	7	9	16	0	1	17	0	0
4	2622344	.	G	C	11	18	29	0	0	29	0	0
4	2622496	.	T	C	12	14	26	0	0	26	0	0
4	2622529	.	C	A	11	15	26	0	2	28	0	0
4	2638351	.	A	T	3	6	9	0	0	9	0	0
4	2638453	.	A	C	2	2	4	0	0	4	0	0
4	2642254	.	T	A	3	6	9	0	0	9	0	0
4	2655466	.	A	G	8	6	14	0	0	14	0	0
4	2662696	.	A	G	7	4	11	0	0	11	0	0
4	2665987	.	T	C	1	6	7	0	0	7	0	0
4	2666007	.	A	G	5	3	8	0	0	8	0	0
4	2666219	.	T	C	3	2	5	0	1	6	0	0
4	2675148	.	C	T	10	5	15	0	2	17	0	0
4	2675235	.	C	T	18	15	33	0	3	36	0	0
4	2685837	.	G	A	9	6	15	0	1	16	0	0
4	2688740	.	T	C	7	4	11	0	0	11	0	0
4	2688785	.	T	G	6	4	10	0	0	10	0	0
4	2695257	.	T	G	2	4	6	0	0	6	0	0
4	2701313	.	A	G	3	5	8	0	0	8	0	0
4	2701352	.	G	A	4	4	8	0	0	8	0	0
4	2701370	.	T	C	3	4	7	0	0	7	0	0
4	2705726	.	G	A	3	4	7	0	0	7	0	0
4	2752987	.	C	T	9	9	18	0	0	18	0	0
4	2753455	.	C	T	0	4	4	0	6	10	0	0
4	2762063	.	A	T	5	3	8	0	0	8	0	0
4	2765529	.	C	G	2	3	5	0	0	5	0	0
4	2773997	.	G	A	5	7	12	0	1	13	0	0
4	2866721	.	C	A	7	7	14	0	1	15	0	0
4	2866748	.	T	C	5	5	10	0	1	11	0	0
4	2867111	.	C	A	2	6	8	0	2	10	0	0
4	2867168	.	G	A	5	4	9	0	0	9	0	0
4	2867741	.	C	T	3	3	6	0	1	7	0	0
4	4079716	.	T	C	4	5	9	0	0	9	0	0
4	4090438	.	C	T	2	5	7	0	0	7	0	0
4	4098479	.	T	A	12	10	22	0	1	23	0	0
4	4104264	.	A	G	9	0	9	0	18	27	0	0
4	4111070	.	A	G	6	5	11	0	0	11	0	0
4	4111180	.	C	T	5	8	13	0	0	13	0	0
4	4111229	.	A	T	4	8	12	0	0	12	0	0
4	4111396	.	T	C	7	9	16	0	1	17	0	0
4	4111673	.	G	A	1	1	2	0	1	3	0	0
4	4117174	.	A	C	1	3	4	0	0	4	0	0
4	4117480	.	T	C	3	5	8	0	0	8	0	0
4	4117876	.	G	A	1	3	4	0	0	4	0	0
4	4119065	.	C	T	0	7	7	0	3	10	0	0
4	4119344	.	G	A	1	2	3	0	1	4	0	0
4	4122652	.	C	T	2	2	4	0	0	4	0	0
4	4228581	.	T	C	10	3	13	0	0	13	0	0
4	4228583	.	C	G	9	3	12	0	0	12	0	0
4	4232578	.	T	A	3	3	6	0	0	6	0	0
4	4232705	.	A	T	6	5	11	0	1	12	0	0
4	4232886	.	C	G	1	0	1	0	4	5	0	0
4	4235162	.	A	G	24	20	44	0	3	47	0	0
4	4238175	.	C	T	1	13	14	0	27	41	0	0
4	4240177	.	T	C	23	25	48	0	1	49	0	0
4	4243084	.	G	A	18	26	44	1	1	46	0	0
4	4249690	.	G	A	24	8	32	0	0	32	0	0
4	4258884	.	A	G	25	8	33	0	0	33	0	0
4	4258927	.	T	C	25	12	37	0	0	37	0	0
4	4258951	.	C	T	26	17	43	0	1	44	0	0
4	4273225	.	G	A	0	2	2	0	2	4	0	0
4	4290728	.	C	G	11	0	11	0	14	25	0	0
4	4291289	.	A	C	6	6	12	0	1	13	0	0
4	4327793	.	C	T	3	6	9	0	1	10	0	0
4	4329022	.	G	A	0	5	5	0	4	9	0	0
4	4331151	.	C	T	3	7	10	0	0	10	0	0
4	4348785	.	C	T	15	14	29	0	0	29	0	0
4	4355714	.	C	T	5	8	13	0	1	15	1	0
4	4355791	.	G	T	0	10	10	0	14	24	0	0
4	4356757	.	T	G	2	2	4	0	0	4	0	0
4	4356902	.	A	T	1	3	4	0	0	4	0	0
4	4357073	.	A	G	10	13	23	0	1	24	0	0
4	4357173	.	C	T	4	13	17	0	1	18	0	0
4	4357175	.	G	A	4	14	18	0	0	18	0	0
4	4357851	.	A	G	1	3	4	3	0	7	0	0
4	4358471	.	C	T	8	6	14	0	0	14	0	0
4	4358536	.	A	G	8	4	12	0	0	12	0	0
4	4358549	.	A	G	7	6	13	1	0	14	0	0
4	4358610	.	C	A	9	6	15	1	0	16	0	0
4	4484788	.	A	G	21	7	28	0	1	29	0	0
4	4484914	.	T	A	20	12	32	0	3	35	0	0
4	4485186	.	A	T	22	19	41	3	1	45	0	0
4	4485247	.	A	T	17	26	43	0	0	43	0	0
4	4485306	.	T	C	15	23	38	1	3	43	1	0
4	4485534	.	C	A	18	17	35	0	1	37	1	0
4	4485650	.	A	T	15	12	27	0	3	30	0	0
4	4485736	.	T	G	11	19	30	0	0	30	0	0
4	4485793	.	C	G	14	21	35	0	0	35	0	0
4	4488137	.	A	G	12	12	24	0	2	26	0	0
4	4488207	.	G	A	13	12	25	0	0	25	0	0
4	4491782	.	T	C	11	1	12	0	14	27	1	0
4	4492003	.	C	T	15	13	28	0	0	28	0	0
4	4492336	.	A	G	10	13	23	0	1	24	0	0
4	4492369	.	C	A	0	13	13	0	7	20	0	0
4	4492444	.	A	G	11	10	21	0	0	21	0	0
4	4492456	.	T	C	8	0	8	0	11	19	0	0
4	4494733	.	C	A	12	14	26	0	1	27	0	0
4	4510097	.	A	G	9	0	9	0	10	19	0	0
4	4514215	.	A	G	8	0	8	0	14	22	0	0
4	4516310	.	G	C	3	18	21	0	18	39	0	0
4	4516313	.	A	G	19	1	20	0	21	41	0	0
4	4516346	.	C	T	27	18	45	0	0	45	0	0
4	4519688	.	G	A	16	15	31	0	2	33	0	0
4	4519697	.	T	C	15	16	31	0	3	34	0	0
4	4523403	.	C	G	29	22	51	0	1	53	1	0
4	4523579	.	T	C	24	23	47	1	1	49	0	0
4	4523885	.	A	C	11	16	27	0	1	28	0	0
4	4524215	.	T	A	5	4	9	0	1	10	0	0
4	4526251	.	G	A	4	3	7	0	0	7	0	0
4	4527510	.	T	A	2	2	4	0	0	4	0	0
4	4527535	.	T	A	2	3	5	0	0	5	0	0
4	4527554	.	A	T	2	2	4	0	0	4	0	0
4	4528554	.	A	G	3	3	6	0	0	6	0	0
4	4546362	.	T	C	2	0	2	0	2	4	0	0
4	4546376	.	C	T	1	2	3	0	0	3	0	0
4	4635691	.	C	G	21	16	37	0	1	38	0	0
4	4640605	.	G	A	16	15	31	0	1	32	0	0
4	4640614	.	G	A	15	17	32	0	0	32	0	0
4	4647977	.	A	G	20	14	34	0	1	35	0	0
4	4653380	.	A	C	22	0	22	0	17	39	0	0
4	4657961	.	G	A	16	19	35	0	1	36	0	0
4	4706687	.	G	T	13	13	26	0	0	26	0	0
4	4706819	.	C	T	1	8	9	0	18	27	0	0
4	4706825	.	C	G	17	9	26	0	3	29	0	0
4	4712951	.	G	A	3	4	7	0	0	7	0	0
4	4713042	.	T	G	2	2	4	0	1	5	0	0
4	4713854	.	T	G	3	1	4	0	0	4	0	0
4	4713899	.	T	G	3	4	7	0	0	8	1	0
4	4714109	.	C	A	2	3	5	0	1	6	0	0
4	4714338	.	A	T	1	6	7	0	0	7	0	0
4	4714358	.	C	T	0	4	4	0	3	7	0	0
4	4714402	.	A	G	1	6	7	0	0	7	0	0
4	4714413	.	G	C	1	4	5	0	1	6	0	0
4	4714590	.	T	C	5	0	5	0	4	9	0	0
4	4751738	.	T	C	3	2	5	0	0	5	0	0
4	4751837	.	C	T	1	3	4	0	0	4	0	0
4	4751867	.	G	A	1	2	3	0	0	3	0	0
4	4754474	.	A	G	6	11	17	0	0	17	0	0
4	4755605	.	G	T	8	6	14	1	1	16	0	0
4	4755627	.	G	T	5	12	17	1	2	20	0	0
4	4758178	.	C	T	6	4	10	0	0	10	0	0
4	4760581	.	C	T	3	3	6	0	0	6	0	0
4	4762804	.	T	A	4	2	6	0	1	7	0	0
4	4768062	.	T	C	3	0	3	0	5	8	0	0
4	4780448	.	C	T	4	2	6	0	0	6	0	0
4	4782880	.	C	G	1	2	3	0	0	3	0	0
4	4782962	.	A	C	5	4	9	0	0	9	0	0
4	4783020	.	C	T	1	2	3	1	3	7	0	0
4	4783059	.	A	T	3	7	10	0	2	12	0	0
4	4783067	.	C	T	5	9	14	0	1	15	0	0
4	4784802	.	G	A	6	6	12	0	0	12	0	0
4	4786350	.	A	G	12	8	20	0	1	21	0	0
4	4786383	.	G	A	6	7	13	0	0	13	0	0
4	4786443	.	A	C	7	0	7	0	6	13	0	0
4	4831630	.	T	G	8	7	15	0	0	15	0	0
4	4831660	.	G	A	8	8	16	0	0	16	0	0
4	4831885	.	A	C	6	2	8	0	0	8	0	0
4	4831898	.	T	C	2	6	8	0	0	8	0	0
4	4831968	.	A	C	4	5	9	0	0	9	0	0
4	4832241	.	A	G	9	4	13	0	0	13	0	0
4	4834125	.	G	A	16	11	27	0	2	29	0	0
4	4834497	.	A	G	12	10	22	0	1	23	0	0
4	4834526	.	T	C	8	8	16	0	0	16	0	0
4	4894486	.	C	A	5	6	11	0	0	11	0	0
4	4901602	.	C	T	14	12	26	0	1	27	0	0
4	4901611	.	T	G	13	0	13	0	12	25	0	0
4	4902137	.	A	C	14	9	23	0	1	24	0	0
4	4902425	.	G	C	14	13	27	0	1	28	0	0
4	4908409	.	C	T	13	9	22	0	0	22	0	0
4	4911071	.	C	T	9	18	27	0	0	27	0	0
4	4911247	.	A	G	6	14	20	0	0	20	0	0
4	4913422	.	C	T	15	7	22	0	2	24	0	0
4	4914832	.	A	G	16	16	32	0	0	32	0	0
4	4921733	.	T	C	15	20	35	0	2	37	0	0
4	4921773	.	G	A	1	20	21	0	15	36	0	0
4	4923290	.	A	T	16	11	27	0	1	28	0	0
4	4923323	.	C	T	17	14	31	0	0	31	0	0
4	4923755	.	T	G	14	17	31	0	1	32	0	0
4	4925611	.	C	T	15	13	28	0	4	32	0	0
4	4926035	.	G	A	7	2	9	0	1	10	0	0
4	4926037	.	G	T	4	6	10	0	0	10	0	0
4	4971836	.	T	C	5	3	8	0	0	8	0	0
4	4971847	.	T	A	6	3	9	0	0	9	0	0
4	4971911	.	G	T	12	8	20	0	0	20	0	0
4	4971947	.	A	G	11	9	20	1	1	22	0	0
4	4972056	.	C	T	6	10	16	0	0	16	0	0
4	4972533	.	G	A	9	8	17	0	0	17	0	0
4	4972555	.	G	C	10	8	18	0	0	18	0	0
4	4972664	.	G	T	5	6	11	0	0	11	0	0
4	4973053	.	G	A	5	9	14	0	0	14	0	0
4	4975329	.	C	G	6	12	18	0	0	18	0	0
4	4975597	.	G	A	6	8	14	0	1	15	0	0
4	4980443	.	G	A	8	11	19	0	1	20	0	0
4	4980458	.	C	T	1	11	12	0	8	20	0	0
4	4983209	.	T	C	5	3	8	0	0	8	0	0
4	4983339	.	T	C	2	4	6	0	0	6	0	0
4	4984298	.	G	A	5	8	13	0	0	13	0	0
4	4985789	.	G	A	9	11	20	0	0	20	0	0
4	4992114	.	A	C	9	3	12	0	0	12	0	0
4	5006535	.	T	C	11	5	16	0	0	16	0	0
4	5006562	.	G	T	11	4	15	0	0	15	0	0
4	5025964	.	G	C	17	17	34	2	2	38	0	0
4	5026355	.	T	C	26	23	49	0	0	49	0	0
4	5042689	.	T	A	23	20	43	0	2	45	0	0
4	5042755	.	C	T	28	18	46	0	2	48	0	0
4	5048903	.	C	T	19	16	35	0	1	36	0	0
4	5094237	.	C	T	3	6	9	0	1	10	0	0
4	5097421	.	C	T	0	6	6	0	9	15	0	0
4	5098152	.	G	A	4	7	11	0	0	11	0	0
4	5098507	.	A	G	3	7	10	0	1	11	0	0
4	5102316	.	A	C	8	0	8	0	8	16	0	0
4	5104859	.	G	A	6	6	12	0	0	12	0	0
4	5106041	.	G	A	6	4	10	0	0	10	0	0
4	5106051	.	A	G	4	5	9	0	0	9	0	0
4	5107389	.	G	A	5	5	10	0	0	10	0	0
4	5158749	.	C	T	12	13	25	0	0	25	0	0
4	5161241	.	G	T	9	7	16	0	0	16	0	0
4	5161256	.	A	C	7	5	12	0	1	14	1	0
4	5181042	.	C	T	2	5	7	0	0	7	0	0
4	5202538	.	A	G	2	3	5	0	0	5	0	0
4	5202543	.	G	C	2	3	5	0	0	5	0	0
4	5240203	.	A	C	27	1	28	0	22	50	0	0
4	5240265	.	C	T	30	17	47	4	1	52	0	0
4	5240472	.	T	A	23	28	51	1	1	53	0	0
4	5240505	.	A	G	23	22	45	0	2	47	0	0
4	5242055	.	T	G	37	24	61	0	1	62	0	0
4	5242300	.	C	G	40	29	69	0	3	72	0	0
4	5243657	.	C	A	28	35	63	0	2	65	0	0
4	5244568	.	C	A	27	32	59	0	1	60	0	0
4	5244789	.	G	A	30	33	63	0	0	63	0	0
4	5247107	.	G	A	28	25	53	0	3	56	0	0
4	5247127	.	G	C	28	29	57	0	1	58	0	0
4	5247145	.	C	T	3	31	34	0	28	62	0	0
4	5255128	.	C	A	19	10	29	2	1	32	0	0
4	5255148	.	C	T	16	19	35	2	1	38	0	0
4	5255180	.	T	C	13	23	36	0	0	36	0	0
4	5256482	.	A	G	10	15	25	0	2	27	0	0
4	5256659	.	A	G	6	0	6	0	7	13	0	0
4	5256674	.	G	T	9	5	14	0	0	15	1	0
4	5256737	.	A	G	4	5	9	0	0	9	0	0
4	5256788	.	G	A	4	4	8	0	0	8	0	0
4	5265594	.	G	A	3	2	5	0	0	5	0	0
4	5265598	.	C	A	2	3	5	0	0	5	0	0
4	5269608	.	G	A	37	27	64	0	4	68	0	0
4	5269660	.	C	G	36	45	81	0	1	82	0	0
4	5273942	.	G	C	21	56	77	1	3	81	0	0
4	5273945	.	G	C	22	51	73	1	3	78	1	0
4	5290944	.	G	A	25	26	51	0	2	53	0	0
4	5290947	.	C	T	24	27	51	0	1	52	0	0
4	5291755	.	T	C	22	40	62	0	2	64	0	0
4	5291794	.	T	C	25	32	57	0	1	58	0	0
4	5302127	.	C	T	3	22	25	0	33	58	0	0
4	5302195	.	A	G	29	24	53	0	2	55	0	0
4	5302327	.	G	A	22	25	47	0	1	48	0	0
4	5302689	.	G	A	11	19	30	0	0	30	0	0
4	5318995	.	G	A	12	17	29	0	1	30	0	0
4	5324871	.	G	T	14	13	27	0	0	27	0	0
4	5325105	.	C	T	9	8	17	1	2	20	0	0
4	5329849	.	G	A	4	11	15	0	2	17	0	0
4	5329850	.	G	A	11	6	17	0	0	17	0	0
4	5330192	.	C	A	7	3	10	0	0	10	0	0
4	5330341	.	C	T	7	6	13	0	0	13	0	0
4	5331720	.	G	A	5	7	12	0	0	12	0	0
4	5334029	.	G	C	5	10	15	0	0	15	0	0
4	5334061	.	G	A	10	15	25	0	0	25	0	0
4	5338909	.	T	A	10	4	14	1	1	20	4	0
4	5338950	.	G	T	13	11	24	0	3	27	0	0
4	5339053	.	T	A	10	18	28	0	1	29	0	0
4	5360934	.	G	A	0	2	2	1	1	4	0	0
4	5360970	.	A	G	1	4	5	0	0	5	0	0
4	5363697	.	T	G	3	1	4	0	0	4	0	0
4	5363744	.	A	C	3	2	5	0	0	5	0	0
4	5363760	.	A	T	4	3	7	0	0	7	0	0
4	5363913	.	C	T	2	3	5	0	0	5	0	0
4	5363921	.	A	C	3	3	6	0	0	6	0	0
4	5364786	.	G	T	3	2	5	0	0	5	0	0
4	5365199	.	A	G	1	3	4	0	0	4	0	0
4	5365235	.	C	T	1	2	3	0	0	3	0	0
4	5365243	.	C	T	1	2	3	0	0	3	0	0
4	5365307	.	C	T	3	2	5	0	1	6	0	0
4	5365325	.	C	T	7	2	9	0	0	9	0	0
4	5365678	.	G	T	2	3	5	0	0	5	0	0
4	5366462	.	C	G	2	4	6	0	0	6	0	0
4	5367032	.	G	A	2	2	4	0	0	4	0	0
4	5367319	.	T	C	4	4	8	0	0	8	0	0
4	5367455	.	G	A	2	3	5	0	0	5	0	0
4	5367493	.	C	T	0	2	2	0	4	6	0	0
4	5370156	.	A	T	7	3	10	0	0	10	0	0
4	5473703	.	A	G	1	3	4	0	0	4	0	0
4	5515160	.	T	G	1	3	4	0	0	4	0	0
4	5515184	.	G	A	0	3	3	0	0	3	0	0
4	5521510	.	C	T	13	12	25	0	0	25	0	0
4	5521996	.	G	T	23	6	29	0	2	31	0	0
4	5522154	.	G	T	18	14	32	0	0	32	0	0
4	5522161	.	C	T	14	16	30	0	2	32	0	0
4	5595171	.	C	T	7	6	13	0	0	13	0	0
4	5597604	.	C	A	6	5	11	0	0	11	0	0
4	5643321	.	G	A	20	15	35	0	2	37	0	0
4	5644808	.	G	A	8	20	28	0	1	29	0	0
4	5644974	.	G	A	6	11	17	0	4	21	0	0
4	5645097	.	C	T	1	4	5	0	1	6	0	0
4	5645116	.	T	G	2	3	5	0	0	5	0	0
4	5645340	.	C	T	1	2	3	0	0	3	0	0
4	5665612	.	T	C	2	0	2	0	6	8	0	0
4	5665912	.	T	C	6	0	6	0	4	10	0	0
4	5682623	.	G	A	1	3	4	0	0	4	0	0
4	5691208	.	C	A	0	3	3	0	5	8	0	0
4	5742551	.	G	A	15	9	24	0	0	24	0	0
4	5742831	.	A	C	12	15	27	0	1	29	1	0
4	5742846	.	C	T	19	12	31	0	0	31	0	0
4	5742936	.	G	A	3	17	20	0	16	36	0	0
4	5742962	.	A	T	14	17	31	0	0	31	0	0
4	5743027	.	A	G	9	8	17	0	1	18	0	0
4	5750854	.	G	A	17	11	28	0	1	29	0	0
4	5750884	.	T	A	11	17	28	0	0	28	0	0
4	5750924	.	A	G	8	10	18	0	1	19	0	0
4	5751381	.	A	C	24	11	35	0	0	35	0	0
4	5751382	.	C	T	1	10	11	0	24	35	0	0
4	5751551	.	G	A	10	10	20	0	2	22	0	0
4	5755018	.	C	T	1	12	13	0	10	23	0	0
4	5755027	.	C	T	3	12	15	0	16	31	0	0
4	5757253	.	C	T	8	15	23	0	0	23	0	0
4	5759617	.	T	G	14	18	32	0	3	35	0	0
4	5763975	.	G	A	19	18	37	0	2	39	0	0
4	5764128	.	T	A	18	21	39	0	3	42	0	0
4	5765516	.	T	G	1	4	5	0	0	5	0	0
4	5765529	.	T	G	3	4	7	0	0	7	0	0
4	5765985	.	C	A	5	3	8	0	0	8	0	0
4	5766156	.	C	T	0	7	7	0	3	10	0	0
4	5766200	.	T	A	5	7	12	0	0	12	0	0
4	5766315	.	G	A	8	6	14	2	0	16	0	0
4	5769036	.	T	C	7	6	13	0	0	13	0	0
4	5785840	.	C	T	2	2	4	0	0	4	0	0
4	5786267	.	G	T	7	4	11	0	0	11	0	0
4	5788942	.	G	T	3	3	6	0	0	6	0	0
4	5790647	.	T	C	2	2	4	0	0	4	0	0
4	5794344	.	C	T	5	3	8	0	0	8	0	0
4	5804902	.	C	T	2	2	4	0	0	4	0	0
4	5805611	.	G	A	6	3	9	0	0	9	0	0
4	5834198	.	G	A	4	2	6	0	0	6	0	0
4	5834200	.	G	T	2	4	6	0	0	6	0	0
4	5834538	.	A	C	1	2	3	0	0	3	0	0
4	5835612	.	C	T	5	2	7	0	0	7	0	0
4	5835635	.	G	A	4	3	7	0	0	7	0	0
4	5835688	.	T	G	5	4	9	0	1	10	0	0
4	5835733	.	G	A	6	8	14	0	1	15	0	0
4	5838505	.	G	A	5	2	7	0	0	7	0	0
4	5840111	.	T	G	8	3	11	0	0	11	0	0
4	5849003	.	C	A	8	18	26	0	1	27	0	0
4	5849225	.	G	A	4	8	12	0	0	12	0	0
4	5850169	.	T	C	4	6	10	0	1	11	0	0
4	5850281	.	T	C	7	10	17	0	1	18	0	0
4	5850297	.	A	G	7	7	14	0	1	15	0	0
4	5850800	.	C	T	3	3	6	0	0	6	0	0
4	5851019	.	G	A	1	2	3	0	2	5	0	0
4	5875509	.	T	C	2	2	4	0	0	4	0	0
4	5886022	.	C	T	1	2	3	0	0	3	0	0
4	5893945	.	G	C	2	2	4	0	0	4	0	0
4	5895744	.	G	T	1	2	3	0	0	3	0	0
4	5900783	.	C	A	5	3	8	0	0	8	0	0
4	5905677	.	C	T	1	5	6	0	0	6	0	0
4	5905707	.	T	C	1	2	3	0	0	3	0	0
4	5907100	.	C	T	2	4	6	0	1	7	0	0
4	5907145	.	C	T	5	4	9	0	1	10	0	0
4	5907465	.	G	T	0	4	4	0	2	6	0	0
4	5908763	.	T	C	3	4	7	0	0	7	0	0
4	5908764	.	C	T	3	4	7	0	0	7	0	0
4	5910302	.	C	T	3	5	8	0	0	8	0	0
4	5910492	.	A	G	12	4	16	0	14	30	0	0
4	5910644	.	G	A	24	30	54	0	1	55	0	0
4	5912445	.	C	T	18	17	35	0	1	36	0	0
4	5912475	.	G	A	14	25	39	0	0	39	0	0
4	5912707	.	A	G	17	17	34	0	1	35	0	0
4	6339825	.	C	A	0	2	2	0	1	3	0	0
4	6339826	.	G	A	1	2	3	0	0	3	0	0
4	6432112	.	G	A	14	15	29	0	1	30	0	0
4	6449366	.	G	A	11	8	19	0	2	21	0	0
4	6455849	.	G	A	13	15	28	0	1	29	0	0
4	6507474	.	A	C	2	4	6	0	0	6	0	0
4	6508382	.	G	C	3	2	5	0	0	5	0	0
4	6579838	.	A	T	1	2	3	0	0	3	0	0
4	6639440	.	A	G	17	11	28	0	0	28	0	0
4	6639665	.	G	A	18	16	34	0	0	34	0	0
4	6639786	.	C	T	14	13	27	0	0	27	0	0
4	6640145	.	G	C	8	8	16	0	0	16	0	0
4	6640156	.	T	C	6	9	15	0	1	16	0	0
4	6645994	.	C	T	13	13	26	0	0	26	0	0
4	6646283	.	A	C	16	9	25	0	1	26	0	0
4	6646851	.	G	A	13	7	20	0	0	20	0	0
4	6737104	.	C	T	3	3	6	0	0	6	0	0
4	6737609	.	T	G	2	2	4	0	1	5	0	0
4	6749054	.	T	C	3	4	7	0	0	7	0	0
4	6749060	.	C	G	3	4	7	0	0	7	0	0
4	6799942	.	A	G	23	18	41	0	0	41	0	0
4	6800153	.	T	C	18	22	40	0	1	41	0	0
4	6800162	.	C	T	18	23	41	0	1	42	0	0
4	6800393	.	G	A	25	21	46	0	1	47	0	0
4	6802173	.	T	G	22	25	47	0	3	51	1	0
4	6802506	.	A	C	23	23	46	0	5	51	0	0
4	6802518	.	C	G	1	25	26	0	23	49	0	0
4	6877975	.	T	C	3	7	10	0	0	10	0	0
4	6880306	.	C	T	1	4	5	0	0	5	0	0
4	6884753	.	C	T	7	3	10	0	0	10	0	0
4	6902159	.	C	T	3	6	9	0	1	10	0	0
4	6909858	.	G	A	7	4	11	1	0	12	0	0
4	6940374	.	C	T	8	11	19	0	0	19	0	0
4	6946608	.	C	T	7	13	20	0	1	21	0	0
4	6946831	.	G	A	9	8	17	0	0	17	0	0
4	6960365	.	G	A	2	7	9	0	9	18	0	0
4	6960377	.	C	T	9	8	17	0	0	17	0	0
4	6990096	.	C	T	19	15	34	0	0	34	0	0
4	6990421	.	T	C	2	3	5	0	0	5	0	0
4	6990621	.	G	A	1	4	5	0	4	9	0	0
4	6990632	.	A	G	4	6	10	0	0	10	0	0
4	6990682	.	G	A	7	6	13	0	0	13	0	0
4	6990882	.	C	T	16	10	26	0	0	26	0	0
4	6990886	.	C	A	9	13	22	0	3	25	0	0
4	6991220	.	T	A	7	8	15	0	0	15	0	0
4	6991272	.	G	A	7	3	10	0	0	10	0	0
4	6991764	.	G	T	17	4	21	0	0	21	0	0
4	6992264	.	G	T	11	9	20	0	2	22	0	0
4	6992744	.	C	T	11	8	19	0	0	19	0	0
4	6992918	.	G	C	12	4	16	0	0	16	0	0
4	7211013	.	G	A	19	19	38	0	1	39	0	0
4	7211097	.	C	T	18	17	35	0	1	36	0	0
4	7211264	.	A	G	24	17	41	0	0	41	0	0
4	7211364	.	C	T	1	16	17	0	16	33	0	0
4	7212228	.	G	A	18	11	29	0	1	30	0	0
4	7212236	.	G	A	16	12	28	0	0	28	0	0
4	7212342	.	G	A	11	10	21	0	0	21	0	0
4	7212461	.	G	A	20	8	28	0	1	29	0	0
4	7212606	.	A	G	19	11	30	0	1	31	0	0
4	7212624	.	G	A	17	11	28	0	1	29	0	0
4	7222118	.	G	T	8	7	15	0	0	15	0	0
4	7465914	.	T	C	4	5	9	0	0	9	0	0
4	7471682	.	A	T	5	2	7	0	0	7	0	0
4	7476736	.	C	T	3	6	9	0	1	10	0	0
4	7546046	.	T	A	13	3	16	0	2	18	0	0
4	7549361	.	G	A	0	5	5	0	3	8	0	0
4	7652726	.	G	A	3	6	9	0	0	9	0	0
4	7653887	.	C	T	7	6	13	0	0	13	0	0
4	7653951	.	A	T	6	3	9	0	1	10	0	0
4	7659049	.	C	T	5	3	8	0	0	8	0	0
4	7659924	.	G	A	4	12	16	0	1	17	0	0
4	7664811	.	G	A	2	3	5	0	0	5	0	0
4	7668432	.	G	A	2	6	8	0	0	8	0	0
4	7668510	.	A	G	5	6	11	0	1	12	0	0
4	7668516	.	G	A	5	7	12	0	0	12	0	0
4	7713041	.	A	G	4	0	4	0	2	6	0	0
4	7713070	.	T	C	4	3	7	0	0	7	0	0
4	7713176	.	C	T	4	4	8	0	0	8	0	0
4	7718868	.	C	T	14	10	24	0	3	27	0	0
4	7726665	.	G	A	3	10	13	0	0	13	0	0
4	7726752	.	T	C	9	17	26	0	0	26	0	0
4	7729807	.	G	A	10	10	20	0	2	22	0	0
4	7737468	.	G	T	12	14	26	0	2	28	0	0
4	7743092	.	C	T	0	9	9	0	16	25	0	0
4	7870599	.	T	C	3	5	8	0	0	8	0	0
4	7870913	.	T	G	8	3	11	0	0	11	0	0
4	7870952	.	C	T	0	6	6	0	5	11	0	0
4	7870983	.	C	T	7	6	13	0	0	13	0	0
4	7871084	.	A	C	6	2	8	0	0	8	0	0
4	7872229	.	A	G	7	4	11	0	0	11	0	0
4	7872637	.	G	A	7	8	15	0	0	15	0	0
4	7875702	.	A	T	8	6	14	0	0	14	0	0
4	7875901	.	T	G	7	5	12	0	0	12	0	0
4	7875917	.	A	T	8	5	13	0	0	13	0	0
4	7876796	.	C	A	6	8	14	0	0	14	0	0
4	7881534	.	C	G	4	0	4	0	7	11	0	0
4	7883462	.	A	C	4	8	12	0	0	12	0	0
4	7883466	.	G	A	4	7	11	0	0	11	0	0
4	7888181	.	A	C	8	9	17	0	2	19	0	0
4	7943958	.	C	T	8	7	15	0	0	15	0	0
4	7959162	.	T	C	9	4	13	0	0	13	0	0
4	7981872	.	A	C	2	1	3	1	11	15	0	0
4	8609609	.	T	A	4	2	6	0	1	7	0	0
4	8609620	.	A	T	8	7	15	1	0	16	0	0
4	8609648	.	G	A	9	8	17	1	0	18	0	0
4	8609799	.	T	C	14	9	23	0	1	24	0	0
4	8662255	.	C	T	1	5	6	0	0	6	0	0
4	8662495	.	C	T	1	2	3	0	0	3	0	0
4	8662683	.	A	C	2	2	4	0	1	5	0	0
4	8680965	.	C	T	13	7	20	0	1	21	0	0
4	8681039	.	C	T	8	13	21	0	0	21	0	0
4	8697245	.	C	T	8	7	15	0	0	16	1	0
4	8697269	.	A	G	4	8	12	0	0	12	0	0
4	8702687	.	G	A	5	6	11	0	2	13	0	0
4	8702729	.	C	A	11	7	18	0	0	18	0	0
4	8702765	.	C	T	11	11	22	0	0	22	0	0
4	8706385	.	G	A	13	6	19	0	1	20	0	0
4	8706412	.	G	T	7	12	19	0	0	19	0	0
4	8706716	.	A	G	11	11	22	0	1	23	0	0
4	8706855	.	A	T	2	3	5	0	1	6	0	0
4	8707154	.	C	T	2	11	13	0	2	15	0	0
4	8707182	.	T	C	2	11	13	0	2	15	0	0
4	8709301	.	C	T	1	1	2	1	0	3	0	0
4	8755661	.	G	C	4	4	8	0	0	8	0	0
4	8761264	.	T	C	1	2	3	0	0	3	0	0
4	8777050	.	T	G	5	2	7	0	0	7	0	0
4	8781919	.	T	A	4	3	7	0	0	7	0	0
4	8797201	.	T	A	31	24	55	0	3	58	0	0
4	8797234	.	T	A	29	23	52	0	3	56	1	0
4	8797315	.	T	C	40	12	52	0	0	52	0	0
4	8803071	.	C	T	22	25	47	0	2	49	0	0
4	8805792	.	T	C	30	27	57	0	2	59	0	0
4	8808775	.	C	T	38	36	74	0	9	83	0	0
4	8808823	.	C	T	34	35	69	0	3	72	0	0
4	8808974	.	C	T	29	23	52	0	1	53	0	0
4	8809268	.	T	G	18	28	46	0	1	47	0	0
4	8809431	.	T	G	11	7	18	0	1	19	0	0
4	8809444	.	T	G	12	8	20	0	0	20	0	0
4	8809506	.	A	T	18	10	28	0	0	28	0	0
4	8809544	.	C	G	12	0	12	0	25	37	0	0
4	8809690	.	G	T	0	9	9	0	2	11	0	0
4	8809695	.	C	T	0	23	23	0	0	23	0	0
4	8809879	.	T	G	5	2	7	0	0	7	0	0
4	8809985	.	G	T	11	6	17	0	1	18	0	0
4	8810200	.	G	T	13	9	22	0	0	22	0	0
4	8810367	.	A	C	18	24	42	0	0	42	0	0
4	8810474	.	A	T	26	23	49	0	0	49	0	0
4	8810597	.	A	T	20	16	36	0	1	37	0	0
4	8810607	.	C	T	21	13	34	0	1	35	0	0
4	8850984	.	A	G	8	3	11	0	2	13	0	0
4	8850998	.	G	A	7	3	10	0	1	11	0	0
4	8851503	.	T	A	18	7	25	0	1	26	0	0
4	8851547	.	A	G	9	16	25	0	1	26	0	0
4	8851740	.	G	A	10	21	31	0	1	32	0	0
4	8851864	.	G	A	13	11	24	0	1	25	0	0
4	8851999	.	C	T	12	10	22	0	0	22	0	0
4	8852085	.	G	T	11	15	26	0	1	27	0	0
4	8854403	.	G	T	20	20	40	0	2	42	0	0
4	8857562	.	T	G	11	20	31	0	0	31	0	0
4	8882297	.	G	T	22	11	33	0	1	34	0	0
4	8898917	.	C	T	2	16	18	0	14	32	0	0
4	8898939	.	G	A	16	13	29	0	2	31	0	0
4	8903051	.	T	A	16	12	28	0	1	29	0	0
4	8908342	.	G	A	4	2	6	0	1	7	0	0
4	8908366	.	G	A	3	1	4	0	1	5	0	0
4	8909871	.	A	C	1	0	1	0	3	4	0	0
4	8912614	.	A	G	2	2	4	0	2	6	0	0
4	9008698	.	T	G	1	2	3	0	0	3	0	0
4	9012215	.	T	G	14	0	14	0	10	24	0	0
4	9012218	.	T	C	15	10	25	0	0	25	0	0
4	9012258	.	A	T	10	7	17	0	2	19	0	0
4	9017996	.	C	T	5	8	13	0	0	13	0	0
4	9021166	.	T	G	11	9	20	0	0	20	0	0
4	9021369	.	T	C	14	11	25	0	1	26	0	0
4	9024665	.	T	G	14	6	20	0	0	20	0	0
4	9024671	.	A	G	15	6	21	0	0	21	0	0
4	9024720	.	A	C	14	11	25	0	2	27	0	0
4	9024784	.	A	G	9	13	22	0	1	23	0	0
4	9024807	.	A	G	10	8	18	0	1	19	0	0
4	9028868	.	T	C	6	2	8	0	0	8	0	0
4	9038894	.	T	A	1	2	3	0	1	4	0	0
4	9039030	.	G	A	0	3	3	0	3	6	0	0
4	9045012	.	T	C	4	4	8	0	0	8	0	0
4	9045979	.	C	T	5	5	10	0	1	11	0	0
4	9047365	.	C	T	4	4	8	0	0	8	0	0
4	9048957	.	G	T	5	6	11	0	0	11	0	0
4	9052184	.	A	G	4	3	7	0	0	7	0	0
4	9052192	.	T	A	3	5	8	0	0	8	0	0
4	9052228	.	C	G	0	6	6	0	2	8	0	0
4	9085337	.	A	G	7	0	7	0	5	12	0	0
4	9094270	.	G	T	5	4	9	0	0	9	0	0
4	9094347	.	G	A	6	2	8	0	2	10	0	0
4	9094666	.	T	G	7	5	12	0	0	12	0	0
4	9094668	.	T	A	7	5	12	0	0	12	0	0
4	9104173	.	G	C	5	8	13	0	1	14	0	0
4	9104510	.	T	C	6	0	6	0	3	9	0	0
4	9105199	.	T	C	5	0	5	1	13	19	0	0
4	9128095	.	T	C	6	0	6	0	12	18	0	0
4	9173425	.	A	G	4	8	12	0	0	12	0	0
4	9173514	.	T	C	7	3	10	0	0	10	0	0
4	9180680	.	G	A	13	12	25	0	1	26	0	0
4	9180746	.	T	C	15	13	28	0	0	28	0	0
4	9183115	.	T	A	14	15	29	0	2	31	0	0
4	9184684	.	A	T	4	2	6	0	2	8	0	0
4	9189969	.	C	T	0	4	4	0	3	7	0	0
4	9192444	.	G	A	4	3	7	0	2	9	0	0
4	9192507	.	A	C	2	0	2	0	5	7	0	0
4	9192549	.	G	A	1	6	7	0	1	8	0	0
4	9194875	.	C	T	5	3	8	0	0	8	0	0
4	9195006	.	A	G	4	3	7	0	0	7	0	0
4	9196205	.	A	T	3	2	5	0	0	5	0	0
4	9208383	.	A	G	2	2	4	0	0	4	0	0
4	9208486	.	C	G	2	5	7	0	0	7	0	0
4	9209469	.	G	A	1	3	4	0	1	5	0	0
4	9209486	.	G	A	2	3	5	0	0	5	0	0
4	9280030	.	C	T	1	5	6	0	0	6	0	0
4	9308224	.	C	T	8	5	13	0	0	13	0	0
4	9308332	.	C	T	6	7	13	0	0	13	0	0
4	9308344	.	G	A	6	6	12	0	0	12	0	0
4	9317959	.	T	C	5	7	12	0	0	12	0	0
4	9329819	.	T	A	10	14	24	0	1	25	0	0
4	9329912	.	C	A	9	6	15	0	0	15	0	0
4	9331495	.	T	G	13	1	14	0	11	25	0	0
4	9333448	.	C	T	11	13	24	0	1	25	0	0
4	9333565	.	G	A	1	15	16	0	17	33	0	0
4	9333739	.	A	C	15	13	28	0	1	29	0	0
4	9334180	.	G	C	2	9	11	0	12	23	0	0
4	9334196	.	A	G	12	10	22	0	0	22	0	0
4	9334735	.	A	G	8	0	8	0	7	15	0	0
4	9339140	.	G	A	3	5	8	0	1	9	0	0
4	9339202	.	G	A	6	3	9	0	0	9	0	0
4	9339316	.	C	T	2	3	5	0	8	13	0	0
4	9339637	.	C	T	2	3	5	0	6	11	0	0
4	9350470	.	C	T	2	5	7	0	0	7	0	0
4	9350496	.	G	T	5	6	11	0	0	11	0	0
4	9364317	.	C	T	2	5	7	0	0	7	0	0
4	9371180	.	G	T	2	4	6	0	0	6	0	0
4	9372530	.	C	T	6	2	8	0	0	8	0	0
4	9376859	.	A	G	9	0	9	0	7	16	0	0
4	9385390	.	A	G	10	1	11	0	11	22	0	0
4	9386108	.	C	T	8	5	13	0	1	14	0	0
4	9388890	.	C	T	4	7	11	0	0	11	0	0
4	9389112	.	G	A	3	3	6	0	0	6	0	0
4	9405038	.	G	T	8	4	12	0	1	13	0	0
4	9429583	.	A	T	2	4	6	0	1	7	0	0
4	9429769	.	G	A	2	6	8	0	0	8	0	0
4	9446126	.	C	G	6	9	15	0	0	15	0	0
4	9447758	.	C	T	11	4	15	0	1	16	0	0
4	9448634	.	G	A	5	11	16	0	0	16	0	0
4	9448643	.	G	T	7	9	16	0	0	16	0	0
4	9460213	.	A	G	9	0	9	0	9	18	0	0
4	9460450	.	T	A	2	4	6	0	0	6	0	0
4	9460603	.	A	C	6	8	14	0	0	14	0	0
4	9461162	.	A	T	4	3	7	0	0	7	0	0
4	9461164	.	C	A	4	3	7	0	0	7	0	0
4	9461548	.	A	G	1	0	1	0	5	6	0	0
4	9461822	.	C	A	5	8	13	0	2	15	0	0
4	9461839	.	C	A	6	6	12	0	1	13	0	0
4	9461946	.	T	A	15	6	21	0	0	21	0	0
4	9462039	.	T	G	3	6	9	0	1	10	0	0
4	9462897	.	A	G	4	0	4	0	3	7	0	0
4	9463840	.	C	G	7	5	12	0	1	13	0	0
4	9463855	.	T	A	9	4	13	0	0	13	0	0
4	9464057	.	T	A	4	3	7	0	0	7	0	0
4	9464143	.	T	G	4	4	8	0	0	8	0	0
4	9464224	.	T	C	2	4	6	0	0	6	0	0
4	9465637	.	A	G	6	4	10	0	0	10	0	0
4	9465832	.	G	T	8	7	15	0	1	16	0	0
4	9465899	.	C	A	8	9	17	0	0	17	0	0
4	9465900	.	C	A	8	9	17	0	0	17	0	0
4	9466075	.	G	T	5	12	17	0	0	17	0	0
4	9466192	.	C	A	4	3	7	0	0	7	0	0
4	9486839	.	A	G	1	5	6	0	0	6	0	0
4	9490315	.	T	A	4	3	7	0	0	7	0	0
4	9492315	.	A	G	5	3	8	0	0	8	0	0
4	9495749	.	C	G	5	8	13	0	0	13	0	0
4	9496926	.	C	T	4	2	6	0	0	6	0	0
4	9496934	.	G	A	5	1	6	0	0	6	0	0
4	9496969	.	A	T	4	4	8	0	0	8	0	0
4	9496976	.	C	G	4	3	7	0	0	7	0	0
4	9498803	.	C	A	4	4	8	0	0	8	0	0
4	9498886	.	G	C	5	8	13	0	0	13	0	0
4	9498896	.	T	C	2	11	13	0	0	13	0	0
4	9499404	.	G	A	7	4	11	0	0	11	0	0
4	9499448	.	C	A	7	4	11	0	0	11	0	0
4	9500311	.	A	T	8	6	14	0	0	14	0	0
4	9500312	.	G	T	8	5	13	0	1	14	0	0
4	9500370	.	G	A	6	7	13	0	0	13	0	0
4	9502243	.	G	T	9	11	20	0	2	22	0	0
4	9502312	.	T	A	9	7	16	0	1	17	0	0
4	9502347	.	C	G	5	1	6	0	7	13	0	0
4	9502388	.	T	C	7	9	16	0	1	17	0	0
4	9502422	.	G	A	8	8	16	0	2	18	0	0
4	9502440	.	A	G	11	0	11	0	10	21	0	0
4	9537015	.	A	G	17	11	28	0	1	29	0	0
4	9537025	.	C	T	18	11	29	0	2	31	0	0
4	9539303	.	G	A	3	2	5	0	1	6	0	0
4	9560129	.	C	T	6	8	14	0	0	14	0	0
4	9562957	.	G	T	6	6	12	0	1	13	0	0
4	9565450	.	C	T	1	5	6	0	8	14	0	0
4	9573368	.	G	A	13	4	17	0	0	17	0	0
4	9579297	.	C	G	7	5	12	0	1	13	0	0
4	9592782	.	A	T	9	13	22	0	1	23	0	0
4	9593832	.	C	A	5	4	9	0	3	12	0	0
4	9596614	.	A	G	7	8	15	0	2	17	0	0
4	9597837	.	G	A	6	4	10	0	2	12	0	0
4	9597862	.	G	A	6	4	10	0	0	10	0	0
4	9598642	.	C	T	10	7	17	0	0	17	0	0
4	9598690	.	C	T	13	6	19	0	0	19	0	0
4	9599566	.	G	A	13	9	22	0	0	22	0	0
4	9601158	.	C	T	11	5	16	0	1	17	0	0
4	9601174	.	T	C	15	9	24	0	0	24	0	0
4	9601256	.	A	C	8	3	11	1	0	12	0	0
4	9601401	.	A	T	13	7	20	0	0	20	0	0
4	9603620	.	A	T	5	3	8	1	1	10	0	0
4	9603791	.	G	A	7	8	15	0	0	15	0	0
4	9603803	.	G	A	8	5	13	0	3	16	0	0
4	9604134	.	G	A	8	7	15	0	0	15	0	0
4	9604294	.	C	T	0	8	8	0	10	18	0	0
4	9604336	.	T	C	4	0	4	0	11	15	0	0
4	9604384	.	A	G	2	6	8	0	0	8	0	0
4	9605221	.	C	T	1	6	7	0	7	14	0	0
4	9605397	.	A	G	8	4	12	0	1	13	0	0
4	9605505	.	C	T	8	5	13	0	0	13	0	0
4	9607259	.	A	G	2	4	6	0	1	7	0	0
4	9616190	.	A	G	7	8	15	0	0	15	0	0
4	9618432	.	A	G	6	15	21	0	0	21	0	0
4	9618867	.	A	C	8	5	13	0	1	14	0	0
4	9637367	.	C	T	1	2	3	0	0	3	0	0
4	9637368	.	T	G	1	2	3	0	0	3	0	0
4	9653570	.	A	G	3	5	8	0	0	8	0	0
4	9653574	.	C	A	1	5	6	0	2	8	0	0
4	9653925	.	T	G	5	7	12	0	0	12	0	0
4	9654020	.	T	A	9	8	17	0	0	17	0	0
4	9654071	.	T	C	12	6	18	0	1	19	0	0
4	9654103	.	A	G	10	8	18	0	1	19	0	0
4	9654114	.	C	T	1	10	11	0	8	19	0	0
4	9654149	.	C	G	6	8	14	0	1	15	0	0
4	9655534	.	T	C	6	0	6	0	8	14	0	0
4	9655807	.	G	A	7	13	20	0	0	20	0	0
4	9661253	.	A	T	5	6	11	0	0	11	0	0
4	9661625	.	T	A	7	3	10	0	2	12	0	0
4	9664900	.	G	A	2	5	7	0	0	7	0	0
4	9669846	.	A	T	11	16	27	0	1	28	0	0
4	9669869	.	C	T	14	13	27	0	0	27	0	0
4	9674206	.	G	A	17	10	27	0	0	27	0	0
4	9675420	.	G	A	2	11	13	0	15	28	0	0
4	9677280	.	G	C	12	13	25	0	1	26	0	0
4	9677319	.	T	C	16	17	33	0	2	35	0	0
4	9686153	.	A	G	17	0	17	0	15	32	0	0
4	9688093	.	T	C	14	17	31	0	1	32	0	0
4	9688570	.	C	T	16	16	32	0	0	32	0	0
4	9688636	.	G	A	16	24	40	0	0	40	0	0
4	9689825	.	G	A	0	29	29	0	22	51	0	0
4	9697346	.	A	G	2	2	4	0	1	5	0	0
4	9697599	.	C	A	21	6	27	0	1	28	0	0
4	9697763	.	A	C	6	5	11	0	0	11	0	0
4	9697813	.	C	T	6	8	14	0	0	14	0	0
4	9698023	.	C	T	16	16	32	0	3	35	0	0
4	9722442	.	G	A	1	2	3	0	0	3	0	0
4	9722454	.	G	T	3	2	5	0	0	5	0	0
4	9724635	.	T	A	7	18	25	0	0	25	0	0
4	9724644	.	C	T	6	17	23	0	1	24	0	0
4	9724718	.	C	A	8	18	26	0	0	26	0	0
4	9724898	.	A	G	9	19	28	0	1	29	0	0
4	9736186	.	A	G	13	13	26	0	0	26	0	0
4	9736211	.	C	T	11	12	23	0	0	23	0	0
4	9737157	.	G	T	11	9	20	0	0	20	0	0
4	9737314	.	A	C	15	0	15	0	13	28	0	0
4	9739228	.	C	A	4	4	8	0	0	8	0	0
4	9740769	.	G	A	22	12	34	0	1	35	0	0
4	9743708	.	G	C	9	9	18	0	0	18	0	0
4	9743762	.	T	G	6	6	12	0	0	12	0	0
4	9743774	.	C	T	5	8	13	0	0	13	0	0
4	9744561	.	A	T	3	2	5	0	2	7	0	0
4	9746515	.	A	G	6	2	8	0	1	9	0	0
4	9746547	.	C	T	8	7	15	0	1	16	0	0
4	9746559	.	C	A	8	8	16	0	1	17	0	0
4	9746604	.	G	A	7	10	17	0	1	18	0	0
4	9747209	.	C	G	1	8	9	0	8	17	0	0
4	9747647	.	C	T	7	8	15	0	0	15	0	0
4	9750109	.	G	T	8	9	17	0	1	18	0	0
4	9750154	.	T	G	9	15	24	0	0	24	0	0
4	9751050	.	A	G	4	5	9	0	1	10	0	0
4	9751310	.	T	G	8	11	19	0	0	19	0	0
4	9753200	.	A	G	14	6	20	0	0	20	0	0
4	9755341	.	G	A	13	9	22	0	0	22	0	0
4	9755350	.	G	A	13	9	22	0	0	22	0	0
4	9756488	.	G	T	8	8	16	0	0	16	0	0
4	9758862	.	C	A	0	12	12	0	6	18	0	0
4	9764703	.	G	A	12	7	19	0	0	19	0	0
4	9784331	.	T	A	6	7	13	0	0	13	0	0
4	9784444	.	C	T	5	6	11	0	0	11	0	0
4	9784669	.	G	A	8	8	16	0	2	18	0	0
4	9784678	.	C	T	0	9	9	0	10	19	0	0
4	9784740	.	A	G	6	9	15	0	1	16	0	0
4	9784747	.	T	A	5	11	16	0	0	16	0	0
4	9785412	.	T	C	11	10	21	0	0	21	0	0
4	9785444	.	G	A	10	9	19	0	1	20	0	0
4	9785477	.	G	A	7	2	9	0	0	9	0	0
4	9785900	.	T	A	6	9	15	0	1	16	0	0
4	9786203	.	A	G	13	11	24	0	2	26	0	0
4	9786338	.	T	A	3	12	15	0	0	15	0	0
4	9786466	.	C	G	1	7	8	0	1	9	0	0
4	9786617	.	C	A	8	10	18	0	0	18	0	0
4	9786670	.	C	A	11	6	17	0	1	18	0	0
4	9786855	.	T	C	4	2	6	0	1	7	0	0
4	9786925	.	T	C	7	0	7	0	4	11	0	0
4	9786976	.	G	A	1	4	5	0	0	5	0	0
4	9787130	.	A	G	6	3	9	0	1	10	0	0
4	9787250	.	A	G	7	7	14	0	1	15	0	0
4	9787415	.	G	A	8	15	23	0	0	23	0	0
4	9787516	.	C	T	9	8	17	1	1	19	0	0
4	9787600	.	G	T	11	17	28	0	0	28	0	0
4	9787761	.	A	G	18	8	26	1	1	28	0	0
4	9789478	.	A	G	7	16	23	0	0	23	0	0
4	9791466	.	A	T	13	6	19	0	0	19	0	0
4	9792102	.	T	G	10	7	17	0	0	17	0	0
4	9792229	.	G	T	15	6	21	0	0	21	0	0
4	9792726	.	T	G	9	7	16	0	1	17	0	0
4	9792798	.	A	G	10	3	13	0	0	13	0	0
4	9794644	.	C	A	1	6	7	0	15	22	0	0
4	9795288	.	C	T	12	8	20	0	2	22	0	0
4	9795309	.	C	T	10	7	17	0	1	18	0	0
4	9795417	.	T	A	4	7	11	0	1	12	0	0
4	9797312	.	C	T	0	10	10	0	4	14	0	0
4	9797376	.	G	A	4	7	11	0	2	13	0	0
4	9797390	.	G	C	7	0	7	0	5	12	0	0
4	9797411	.	C	T	8	4	12	0	0	12	0	0
4	9798229	.	T	C	7	0	7	0	8	15	0	0
4	9798825	.	C	A	0	17	17	0	8	26	1	0
4	9801626	.	G	A	6	8	14	1	1	16	0	0
4	9801662	.	A	G	7	8	15	1	2	18	0	0
4	9801730	.	A	T	9	9	18	0	0	18	0	0
4	9801747	.	G	A	10	8	18	0	0	19	1	0
4	9801935	.	A	G	14	14	28	0	0	28	0	0
4	9802472	.	A	T	5	7	12	0	0	12	0	0
4	9802487	.	C	T	0	7	7	0	4	11	0	0
4	9809733	.	T	G	4	2	6	0	1	7	0	0
4	9814044	.	C	G	2	5	7	0	0	7	0	0
4	9814880	.	T	G	9	4	13	0	0	13	0	0
4	9817327	.	C	T	6	2	8	0	1	9	0	0
4	9819720	.	A	G	4	4	8	0	0	8	0	0
4	9819721	.	T	C	4	0	4	0	4	8	0	0
4	9819858	.	A	T	2	6	8	0	0	8	0	0
4	9819944	.	T	C	7	5	12	0	1	13	0	0
4	9836583	.	T	A	11	13	24	0	0	24	0	0
4	9837992	.	A	G	11	10	21	0	0	21	0	0
4	9838875	.	T	C	17	9	26	0	1	27	0	0
4	9838932	.	C	T	14	9	23	0	1	24	0	0
4	9838974	.	T	C	14	11	25	0	0	25	0	0
4	9840136	.	T	C	18	10	28	0	2	30	0	0
4	9840242	.	T	C	20	11	31	0	0	31	0	0
4	9840338	.	T	C	7	14	21	0	0	21	0	0
4	9841657	.	G	A	18	20	38	0	0	38	0	0
4	9843829	.	G	A	2	3	5	0	0	5	0	0
4	9843830	.	A	G	2	2	4	0	1	5	0	0
4	9855482	.	G	A	3	5	8	0	2	10	0	0
4	9858023	.	A	G	6	3	9	0	0	9	0	0
4	9858050	.	C	T	7	3	10	0	0	10	0	0
4	9860188	.	T	G	3	5	8	0	0	8	0	0
4	9863363	.	G	A	5	2	7	0	0	7	0	0
4	9863747	.	C	T	3	2	5	0	0	5	0	0
4	9863771	.	T	C	3	2	5	0	0	5	0	0
4	9863795	.	A	G	2	2	4	0	0	4	0	0
4	9866737	.	G	A	1	4	5	0	0	5	0	0
4	9866926	.	T	C	1	4	5	0	0	5	0	0
4	9867387	.	A	G	1	8	9	0	0	9	0	0
4	9943066	.	T	C	10	5	15	0	0	15	0	0
4	9955338	.	A	G	4	0	4	0	8	12	0	0
4	9955350	.	C	T	8	7	15	0	1	16	0	0
4	9957319	.	T	C	11	8	19	0	1	20	0	0
4	9957331	.	C	T	13	9	22	0	1	23	0	0
4	9957367	.	T	C	14	7	21	0	0	21	0	0
4	9961823	.	T	A	7	5	12	0	0	12	0	0
4	9962466	.	C	T	10	5	15	0	0	15	0	0
4	9964813	.	C	T	7	8	15	0	0	15	0	0
4	9966229	.	C	T	7	4	11	0	0	11	0	0
4	9969261	.	C	T	14	11	25	0	0	25	0	0
4	9969306	.	G	T	11	9	20	0	2	22	0	0
4	9969447	.	T	C	11	4	15	0	0	15	0	0
4	9974720	.	C	T	9	6	15	0	0	15	0	0
4	9979792	.	T	C	4	9	13	0	0	13	0	0
4	9980400	.	G	A	2	12	14	0	9	23	0	0
4	9981763	.	C	T	10	5	15	0	0	15	0	0
4	9981838	.	G	A	9	11	20	0	2	22	0	0
4	9982775	.	G	T	11	15	26	0	0	26	0	0
4	9982872	.	A	T	12	10	22	0	0	22	0	0
4	9982883	.	A	G	11	13	24	0	0	24	0	0
4	9983251	.	G	A	6	11	17	0	5	22	0	0
4	9983269	.	C	G	8	13	21	0	0	21	0	0
4	9983347	.	G	T	10	11	21	0	0	21	0	0
4	9983940	.	C	T	9	10	19	0	1	20	0	0
4	9983943	.	T	C	9	7	16	0	2	18	0	0
4	9985320	.	G	C	5	14	19	0	1	20	0	0
4	9986279	.	G	A	12	10	22	0	0	22	0	0
4	9988867	.	C	T	11	15	26	0	0	26	0	0
4	9990796	.	G	A	15	12	27	0	0	27	0	0
4	9993789	.	C	T	21	20	41	0	0	41	0	0
4	9996182	.	T	C	18	15	33	0	2	35	0	0
4	9998553	.	G	A	1	18	19	0	20	39	0	0
4	9998566	.	A	C	18	15	33	0	1	34	0	0
4	9998677	.	A	G	12	13	25	0	0	25	0	0
4	9998986	.	A	T	13	6	19	0	2	21	0	0
4	9998988	.	T	C	13	8	21	0	0	21	0	0
4	9999240	.	C	T	13	21	34	0	0	34	0	0
4	9999367	.	A	G	18	15	33	0	1	34	0	0
4	9999830	.	T	C	9	4	13	0	3	16	0	0
4	9999909	.	A	T	5	4	9	0	0	9	0	0
4	10008917	.	C	T	2	3	5	0	0	5	0	0
4	10011770	.	A	C	4	6	10	0	0	10	0	0
4	10017468	.	A	G	24	22	46	0	1	47	0	0
4	10038009	.	T	C	21	28	49	0	0	49	0	0
4	10040249	.	G	A	0	23	23	0	23	46	0	0
4	10040285	.	A	G	30	0	30	0	28	58	0	0
4	10040297	.	C	T	30	27	57	0	2	59	0	0
4	10111174	.	C	T	1	2	3	0	0	3	0	0
4	10121856	.	A	C	1	2	3	0	1	4	0	0
4	10124153	.	A	C	1	2	3	0	0	3	0	0
4	10126486	.	T	A	3	2	5	0	0	5	0	0
4	10128125	.	T	C	3	3	6	0	0	6	0	0
4	10128875	.	T	C	2	3	5	0	1	6	0	0
4	10366043	.	G	A	0	5	5	0	5	10	0	0
4	10366045	.	C	T	3	6	9	0	0	9	0	0
4	10366710	.	G	A	7	7	14	0	0	14	0	0
4	10367028	.	A	G	6	6	12	0	1	13	0	0
4	10367349	.	G	A	4	5	9	0	2	11	0	0
4	10367358	.	A	G	2	0	2	0	8	10	0	0
4	10367412	.	A	C	7	6	13	0	0	13	0	0
4	10553528	.	G	A	7	3	10	0	1	11	0	0
4	10558370	.	C	T	6	5	11	0	0	11	0	0
4	10558600	.	A	T	7	3	10	0	0	10	0	0
4	10559042	.	A	T	6	3	9	0	0	9	0	0
4	10559213	.	C	G	6	5	11	0	1	12	0	0
4	10559621	.	C	A	5	4	9	0	0	9	0	0
4	10560246	.	G	A	11	15	26	0	1	27	0	0
4	10560253	.	A	T	9	17	26	0	0	26	0	0
4	10560284	.	C	T	9	13	22	0	0	22	0	0
4	10560404	.	A	T	15	9	24	0	0	24	0	0
4	10560607	.	A	G	4	7	11	0	0	11	0	0
4	10561598	.	T	C	9	11	20	0	0	20	0	0
4	10561603	.	G	A	10	9	19	0	0	19	0	0
4	10605409	.	T	C	10	10	20	0	1	21	0	0
4	10605457	.	C	T	9	10	19	0	0	19	0	0
4	10608878	.	G	T	7	5	12	0	0	12	0	0
4	10611014	.	T	A	16	10	26	0	1	27	0	0
4	10615123	.	A	T	9	7	16	0	0	16	0	0
4	10615127	.	G	T	9	9	18	0	0	18	0	0
4	10615175	.	A	G	8	0	8	0	7	15	0	0
4	10690319	.	T	C	1	2	3	0	0	3	0	0
4	10704073	.	C	A	2	2	4	0	0	4	0	0
4	10757096	.	A	G	1	2	3	0	0	3	0	0
4	10761803	.	C	G	1	1	2	0	2	4	0	0
4	10762071	.	G	A	1	4	5	2	1	8	0	0
4	10762087	.	G	A	0	4	4	2	3	9	0	0
4	10763439	.	A	G	1	2	3	0	0	4	1	0
4	10812042	.	C	G	0	5	5	3	2	10	0	0
4	10814729	.	A	T	3	3	6	0	0	6	0	0
4	10825629	.	G	A	2	4	6	0	0	6	0	0
4	10826346	.	C	T	2	2	4	0	0	4	0	0
4	10888842	.	G	C	0	9	9	0	7	16	0	0
4	10888890	.	T	A	5	8	13	0	0	13	0	0
4	10888935	.	C	A	9	5	14	0	0	14	0	0
4	10890516	.	G	T	6	4	10	1	0	11	0	0
4	10890822	.	G	A	11	11	22	0	1	23	0	0
4	10896354	.	G	C	9	7	16	0	1	17	0	0
4	10896570	.	G	A	16	6	22	0	1	23	0	0
4	10896582	.	G	T	14	5	19	0	0	19	0	0
4	10896618	.	C	T	8	2	10	0	0	10	0	0
4	10896620	.	A	T	8	2	10	0	0	10	0	0
4	10904784	.	C	T	6	10	16	0	2	18	0	0
4	10905246	.	C	T	12	11	23	0	0	23	0	0
4	10906254	.	C	T	13	9	22	0	0	22	0	0
4	10908001	.	C	T	14	14	28	0	1	29	0	0
4	10908182	.	T	C	6	7	13	0	0	13	0	0
4	10908294	.	C	T	8	6	14	1	1	16	0	0
4	10908726	.	T	C	11	5	16	0	0	16	0	0
4	10974650	.	C	T	3	4	7	0	0	7	0	0
4	10974722	.	G	A	9	3	12	0	0	12	0	0
4	10974747	.	A	T	7	5	12	0	0	12	0	0
4	10975629	.	A	G	6	5	11	0	0	11	0	0
4	10975632	.	G	A	6	5	11	0	0	11	0	0
4	10976944	.	G	A	1	5	6	0	0	6	0	0
4	10982291	.	C	T	4	3	7	0	0	7	0	0
4	10982339	.	T	G	3	3	6	0	0	6	0	0
4	10982390	.	C	A	0	5	5	0	6	11	0	0
4	10987895	.	T	A	5	4	9	0	0	9	0	0
4	10988147	.	A	G	1	2	3	0	0	3	0	0
4	10988546	.	G	C	5	7	12	0	0	12	0	0
4	10988581	.	C	T	0	7	7	0	4	11	0	0
4	10994841	.	G	A	2	7	9	0	0	9	0	0
4	10995138	.	G	A	3	6	9	0	0	9	0	0
4	11035566	.	C	A	1	2	3	0	0	3	0	0
4	11035567	.	C	T	0	2	2	0	1	3	0	0
4	11051793	.	C	T	1	3	4	0	0	4	0	0
4	11051839	.	C	T	1	2	3	0	0	3	0	0
4	11053851	.	G	A	0	7	7	0	5	12	0	0
4	11054484	.	A	C	7	10	17	0	0	17	0	0
4	11054509	.	G	C	8	7	15	0	0	15	0	0
4	11311632	.	T	A	4	4	8	0	1	9	0	0
4	11311751	.	C	T	2	5	7	0	0	7	0	0
4	11344964	.	G	A	5	8	13	0	0	13	0	0
4	11356555	.	A	G	4	7	11	0	3	14	0	0
4	11356618	.	T	C	11	7	18	0	0	18	0	0
4	11358626	.	C	T	8	8	16	0	0	16	0	0
4	11366360	.	T	C	9	9	18	0	0	18	0	0
4	11366481	.	G	A	10	10	20	0	4	24	0	0
4	11367668	.	T	A	13	10	23	0	2	25	0	0
4	11367952	.	T	C	8	6	14	0	0	14	0	0
4	11368056	.	A	T	9	12	21	0	5	27	1	0
4	11368076	.	G	T	15	14	29	0	2	31	0	0
4	11368171	.	G	A	1	16	17	0	22	39	0	0
4	11385001	.	T	C	3	3	6	0	0	6	0	0
4	11387698	.	A	T	12	11	23	0	0	23	0	0
4	11414424	.	A	T	4	4	8	0	1	9	0	0
4	11414567	.	A	T	5	8	13	0	0	13	0	0
4	11414937	.	A	G	4	6	10	0	0	10	0	0
4	11415471	.	G	A	10	10	20	0	1	21	0	0
4	11415483	.	G	A	6	7	13	0	1	14	0	0
4	11415852	.	A	T	6	3	9	0	0	9	0	0
4	11415853	.	G	A	7	3	10	0	0	10	0	0
4	11416701	.	C	T	12	17	29	0	7	36	0	0
4	11416758	.	T	A	21	10	31	0	0	31	0	0
4	11416854	.	G	A	14	15	29	0	0	29	0	0
4	11417753	.	G	T	9	3	12	0	1	13	0	0
4	11417829	.	C	A	5	10	15	0	1	16	0	0
4	11418969	.	C	T	5	14	19	0	0	19	0	0
4	11419062	.	G	A	7	12	19	0	2	21	0	0
4	11419163	.	C	G	9	8	17	0	0	17	0	0
4	11419510	.	C	T	13	9	22	0	1	23	0	0
4	11419656	.	C	T	15	7	22	0	0	22	0	0
4	11419869	.	T	C	5	10	15	0	0	15	0	0
4	11420005	.	A	T	13	20	33	0	0	33	0	0
4	11421575	.	C	T	16	13	29	1	0	30	0	0
4	11422121	.	C	T	9	19	28	0	0	28	0	0
4	11425839	.	G	T	17	19	36	0	2	38	0	0
4	11439544	.	C	A	7	7	14	0	2	16	0	0
4	11446078	.	A	G	24	11	35	0	2	37	0	0
4	11446365	.	A	T	23	15	38	1	1	40	0	0
4	11446774	.	A	G	9	4	13	0	0	13	0	0
4	11447135	.	T	C	24	15	39	0	1	40	0	0
4	11447144	.	G	A	14	21	35	0	2	37	0	0
4	11447226	.	T	G	14	0	14	0	13	27	0	0
4	11447251	.	T	C	11	16	27	0	0	27	0	0
4	11447719	.	T	G	25	18	43	0	3	46	0	0
4	11448296	.	A	T	14	21	35	0	1	36	0	0
4	11448403	.	G	A	1	17	18	0	26	44	0	0
4	11458171	.	G	T	1	4	5	0	8	13	0	0
4	11461914	.	A	G	2	6	8	0	0	8	0	0
4	11464390	.	A	G	29	27	56	0	1	57	0	0
4	11470854	.	A	G	14	15	29	0	2	31	0	0
4	11471203	.	T	C	24	18	42	0	1	43	0	0
4	11472674	.	T	C	19	27	46	0	1	47	0	0
4	11476472	.	G	A	3	30	33	0	25	58	0	0
4	11476487	.	C	T	29	23	52	0	4	56	0	0
4	11476740	.	C	T	24	27	51	1	2	54	0	0
4	11476868	.	C	G	25	32	57	0	2	59	0	0
4	11476945	.	C	T	31	28	59	0	7	66	0	0
4	11477047	.	T	A	35	28	63	0	5	68	0	0
4	11477377	.	C	T	46	13	59	0	4	63	0	0
4	11480649	.	T	C	6	8	14	0	1	15	0	0
4	11480824	.	C	A	9	4	13	0	0	13	0	0
4	11480866	.	C	T	5	7	12	0	0	12	0	0
4	11482235	.	G	A	1	5	6	0	8	14	0	0
4	11482259	.	G	A	5	10	15	0	0	15	0	0
4	11482358	.	T	G	11	6	17	0	0	17	0	0
4	11482367	.	C	G	10	7	17	0	0	17	0	0
4	11482668	.	T	A	11	7	18	0	0	18	0	0
4	11482830	.	C	T	3	3	6	0	0	6	0	0
4	11484854	.	A	G	5	2	7	0	0	7	0	0
4	11485626	.	G	T	1	2	3	0	0	3	0	0
4	11485671	.	C	T	1	2	3	0	0	3	0	0
4	11704180	.	C	T	5	7	12	0	0	12	0	0
4	11704195	.	A	G	6	3	9	0	1	10	0	0
4	11712704	.	G	T	0	3	3	0	7	10	0	0
4	11712794	.	T	C	5	10	15	0	0	15	0	0
4	11721659	.	T	C	1	6	7	0	1	8	0	0
4	11721731	.	C	T	4	4	8	0	0	8	0	0
4	11726366	.	T	A	9	15	24	0	0	24	0	0
4	11728959	.	G	A	3	15	18	0	7	25	0	0
4	11729719	.	G	A	4	6	10	0	2	12	0	0
4	11730159	.	G	C	7	9	16	0	0	16	0	0
4	11730515	.	C	A	8	6	14	0	0	14	0	0
4	11732213	.	G	A	3	2	5	0	0	5	0	0
4	11732222	.	G	A	4	2	6	0	0	6	0	0
4	11732589	.	T	C	5	6	11	0	1	12	0	0
4	11732590	.	T	C	4	8	12	0	0	12	0	0
4	11732956	.	A	G	8	3	11	0	0	11	0	0
4	11733061	.	A	C	3	4	7	0	0	7	0	0
4	11733114	.	A	C	2	0	2	0	2	4	0	0
4	11733201	.	T	A	2	5	7	0	1	8	0	0
4	11733222	.	C	T	3	5	8	0	0	8	0	0
4	11733281	.	G	T	1	3	4	1	0	5	0	0
4	11733286	.	C	T	1	2	3	1	0	4	0	0
4	11733545	.	T	C	9	0	9	0	8	17	0	0
4	11733573	.	G	A	12	9	21	0	0	21	0	0
4	11733726	.	A	C	8	8	16	0	0	16	0	0
4	11733778	.	C	A	0	5	5	0	5	10	0	0
4	11733830	.	G	A	3	4	7	0	0	7	0	0
4	11733909	.	A	T	6	3	9	0	0	9	0	0
4	11734071	.	T	C	6	3	9	0	0	9	0	0
4	11734072	.	A	C	6	3	9	0	0	9	0	0
4	11734150	.	A	G	1	4	5	0	0	5	0	0
4	11734196	.	A	T	5	2	7	0	0	7	0	0
4	11734696	.	C	G	5	6	11	0	0	11	0	0
4	11737021	.	G	A	2	3	5	0	0	5	0	0
4	11765871	.	C	T	1	5	6	6	0	12	0	0
4	11780629	.	T	C	6	4	10	4	0	14	0	0
4	11804825	.	C	G	7	3	10	0	0	10	0	0
4	11804940	.	G	A	10	4	14	0	1	15	0	0
4	11805396	.	G	T	4	9	13	0	0	13	0	0
4	11805423	.	T	C	4	6	10	0	0	10	0	0
4	11806934	.	G	A	7	9	16	0	1	17	0	0
4	11806965	.	G	C	9	7	16	0	1	17	0	0
4	11810123	.	T	G	4	3	7	0	0	7	0	0
4	11810129	.	A	G	5	3	8	0	0	8	0	0
4	11814022	.	A	G	20	13	33	0	1	34	0	0
4	11814055	.	C	T	2	27	29	0	15	44	0	0
4	11814074	.	T	A	21	25	46	0	1	47	0	0
4	11814429	.	A	T	14	9	23	0	0	23	0	0
4	11814456	.	A	G	8	10	18	0	2	20	0	0
4	11814471	.	G	A	11	9	20	0	0	20	0	0
4	11814494	.	C	T	12	10	22	0	0	22	0	0
4	11814565	.	A	T	6	7	13	0	0	13	0	0
4	11814684	.	C	T	19	5	24	0	0	24	0	0
4	11814723	.	A	C	8	14	22	0	1	23	0	0
4	11815137	.	G	T	23	14	37	0	1	38	0	0
4	11815143	.	C	G	25	14	39	0	1	40	0	0
4	11815324	.	A	C	16	11	27	0	1	28	0	0
4	11818347	.	G	A	14	6	20	0	1	21	0	0
4	11818353	.	A	G	15	6	21	0	0	21	0	0
4	11827171	.	C	T	15	17	32	0	3	35	0	0
4	11841949	.	T	A	10	9	19	0	0	19	0	0
4	12006542	.	G	A	10	15	25	0	1	26	0	0
4	12006761	.	C	T	1	8	9	0	7	16	0	0
4	12007149	.	T	A	10	7	17	0	1	18	0	0
4	12013470	.	T	G	14	7	21	0	3	24	0	0
4	12013513	.	A	T	13	7	20	0	1	21	0	0
4	12020936	.	C	T	19	10	29	0	1	30	0	0
4	12021120	.	C	T	16	16	32	0	2	34	0	0
4	12021703	.	C	T	17	20	37	0	1	38	0	0
4	12021748	.	G	T	1	21	22	0	19	41	0	0
4	12022108	.	A	G	18	2	20	0	19	39	0	0
4	12022444	.	T	C	17	18	35	0	1	36	0	0
4	12023445	.	A	C	17	26	43	0	0	43	0	0
4	12025771	.	G	A	32	15	47	1	2	50	0	0
4	12026098	.	G	A	9	7	16	0	1	17	0	0
4	12026286	.	A	T	18	20	38	0	1	39	0	0
4	12026305	.	T	C	22	15	37	0	2	39	0	0
4	12026369	.	G	T	12	12	24	0	0	24	0	0
4	12026429	.	C	A	10	9	19	0	2	21	0	0
4	12080673	.	C	T	11	9	20	0	1	21	0	0
4	12080911	.	T	G	14	14	28	1	2	31	0	0
4	12087262	.	G	C	10	0	10	0	6	16	0	0
4	12091037	.	T	C	12	0	12	0	16	28	0	0
4	12091104	.	G	T	13	13	26	0	0	26	0	0
4	12103535	.	G	A	2	2	4	0	0	4	0	0
4	12103619	.	T	C	3	0	3	1	2	6	0	0
4	12103840	.	G	T	2	4	6	0	0	6	0	0
4	12103846	.	A	T	2	2	4	0	1	5	0	0
4	12103911	.	A	T	4	5	9	0	0	9	0	0
4	12103964	.	T	A	3	14	17	0	0	17	0	0
4	12106000	.	G	C	4	0	4	0	11	15	0	0
4	12111399	.	G	A	10	10	20	0	1	21	0	0
4	12113128	.	C	T	7	7	14	0	1	15	0	0
4	12230029	.	C	T	19	14	33	0	2	35	0	0
4	12230509	.	C	A	15	9	24	0	1	26	1	0
4	12230510	.	T	C	14	10	24	0	1	25	0	0
4	12230608	.	T	C	13	13	26	0	0	26	0	0
4	12230665	.	C	T	14	5	19	0	0	19	0	0
4	12230698	.	C	T	12	4	16	0	0	16	0	0
4	12230713	.	T	C	12	6	18	0	0	18	0	0
4	12230833	.	G	T	5	2	7	1	1	9	0	0
4	12230890	.	T	A	7	2	9	0	0	9	0	0
4	12230909	.	G	A	8	9	17	0	1	18	0	0
4	12231008	.	G	A	1	11	12	0	8	20	0	0
4	12231131	.	A	C	3	8	11	0	1	12	0	0
4	12231328	.	A	T	8	14	22	0	0	22	0	0
4	12231751	.	A	C	10	10	20	0	0	20	0	0
4	12231789	.	C	A	6	11	17	0	2	19	0	0
4	12232164	.	C	G	16	4	20	0	0	20	0	0
4	12232253	.	G	T	14	8	22	0	0	22	0	0
4	12232254	.	C	T	14	8	22	0	1	23	0	0
4	12232323	.	A	T	16	10	26	0	0	26	0	0
4	12232328	.	A	T	17	11	28	0	0	28	0	0
4	12232415	.	G	T	11	5	16	0	1	17	0	0
4	12232509	.	C	T	4	5	9	0	1	10	0	0
4	12232614	.	A	C	4	9	13	1	0	14	0	0
4	12232644	.	A	T	11	12	23	1	1	25	0	0
4	12232737	.	G	A	7	6	13	0	0	13	0	0
4	12232746	.	T	C	6	5	11	0	1	12	0	0
4	12232958	.	T	C	5	7	12	0	1	13	0	0
4	12232985	.	G	T	8	9	17	0	0	17	0	0
4	12233004	.	A	G	10	0	10	0	10	20	0	0
4	12233125	.	T	A	7	13	20	0	4	24	0	0
4	12233220	.	C	T	7	13	20	0	1	21	0	0
4	12233252	.	A	T	6	11	17	0	0	17	0	0
4	12233431	.	C	A	4	2	6	0	1	7	0	0
4	12233450	.	C	A	9	2	11	0	0	11	0	0
4	12233651	.	A	T	8	4	12	2	0	14	0	0
4	12233728	.	G	T	7	4	11	0	0	11	0	0
4	12233770	.	G	T	5	2	7	0	0	7	0	0
4	12233908	.	A	C	17	9	26	1	1	28	0	0
4	12234398	.	T	G	5	9	14	0	0	14	0	0
4	12234458	.	C	T	7	9	16	0	0	16	0	0
4	12234670	.	A	G	10	0	10	0	11	21	0	0
4	12234755	.	C	A	7	17	24	0	1	25	0	0
4	12234792	.	A	G	21	7	28	0	0	28	0	0
4	12234828	.	C	T	13	13	26	0	1	27	0	0
4	12234955	.	C	T	13	11	24	0	1	25	0	0
4	12235677	.	T	C	8	16	24	0	0	24	0	0
4	12235722	.	A	G	13	7	20	0	1	21	0	0
4	12235770	.	T	C	14	13	27	0	0	27	0	0
4	12235987	.	T	G	7	5	12	1	1	14	0	0
4	12236171	.	G	A	16	13	29	1	0	30	0	0
4	12236178	.	T	G	16	12	28	1	0	29	0	0
4	12236429	.	T	A	9	11	20	0	2	23	1	0
4	12236495	.	A	G	8	0	8	0	13	21	0	0
4	12236519	.	A	G	15	8	23	0	0	23	0	0
4	12236584	.	C	T	11	8	19	0	1	20	0	0
4	12236592	.	T	A	11	0	11	0	0	12	1	0
4	12236641	.	A	G	7	12	19	0	1	20	0	0
4	12236667	.	C	A	6	8	14	0	1	15	0	0
4	12236740	.	A	C	1	2	3	0	0	3	0	0
4	12237490	.	C	A	26	13	39	0	0	39	0	0
4	12237689	.	C	A	15	18	33	0	0	33	0	0
4	12237849	.	C	T	12	14	26	0	2	28	0	0
4	12238161	.	C	T	12	19	31	0	5	36	0	0
4	12238418	.	C	T	21	16	37	0	0	37	0	0
4	12238711	.	G	A	14	8	22	2	0	24	0	0
4	12238904	.	G	A	10	8	18	0	2	20	0	0
4	12238956	.	G	A	20	12	32	2	4	38	0	0
4	12243881	.	T	G	8	6	14	0	2	16	0	0
4	12244071	.	T	C	12	10	22	0	1	23	0	0
4	12244099	.	T	C	13	20	33	0	0	33	0	0
4	12244153	.	T	A	14	17	31	0	1	32	0	0
4	12244258	.	T	C	10	7	17	0	0	17	0	0
4	12244322	.	C	T	9	11	20	0	0	20	0	0
4	12244607	.	C	T	0	6	6	0	5	11	0	0
4	12245058	.	G	A	13	4	17	0	0	17	0	0
4	12245584	.	A	G	8	15	23	0	0	23	0	0
4	12265268	.	T	A	6	8	14	0	2	16	0	0
4	12265337	.	T	C	7	0	7	0	10	17	0	0
4	12269050	.	T	C	8	0	8	0	5	13	0	0
4	12270202	.	A	T	6	8	14	0	0	14	0	0
4	12275400	.	T	C	2	3	5	0	0	5	0	0
4	12285925	.	T	C	1	3	4	0	1	5	0	0
4	12286040	.	C	T	3	2	5	0	0	5	0	0
4	12293506	.	C	T	1	3	4	0	2	6	0	0
4	12293535	.	T	A	2	3	5	0	0	5	0	0
4	12312261	.	T	A	1	3	4	0	0	4	0	0
4	12312670	.	C	A	5	7	12	0	0	12	0	0
4	12312712	.	C	T	2	4	6	0	0	6	0	0
4	12312717	.	T	G	2	3	5	0	0	5	0	0
4	12312865	.	T	C	1	5	6	0	1	7	0	0
4	12312899	.	G	A	4	4	8	0	0	8	0	0
4	12312969	.	T	G	6	0	6	0	3	9	0	0
4	12317636	.	T	G	2	2	4	0	1	5	0	0
4	12381900	.	T	C	4	7	11	0	1	12	0	0
4	12381930	.	G	A	5	7	12	0	0	12	0	0
4	12382076	.	A	G	16	8	24	0	2	26	0	0
4	12382234	.	C	T	7	6	13	0	0	13	0	0
4	12382336	.	T	G	17	6	23	0	0	23	0	0
4	12382433	.	G	C	11	7	18	0	2	20	0	0
4	12382673	.	A	T	11	7	18	0	0	18	0	0
4	12382871	.	G	A	10	12	22	0	1	23	0	0
4	12382889	.	T	G	7	15	22	0	4	26	0	0
4	12382943	.	T	G	18	11	29	0	0	29	0	0
4	12383030	.	C	T	22	15	37	0	0	37	0	0
4	12383081	.	C	T	25	13	38	0	2	40	0	0
4	12384831	.	A	G	19	14	33	0	1	34	0	0
4	12384840	.	G	A	18	10	28	0	1	29	0	0
4	12384873	.	C	G	1	14	15	0	22	37	0	0
4	12388419	.	T	C	20	10	30	0	1	31	0	0
4	13755907	.	A	G	18	5	23	0	0	23	0	0
4	13756335	.	A	G	6	4	10	0	0	10	0	0
4	14992499	.	T	C	12	5	17	0	1	18	0	0
4	14992569	.	T	C	9	10	19	0	0	19	0	0
4	14992592	.	T	C	7	4	11	0	1	12	0	0
4	15007429	.	C	T	3	2	5	0	1	6	0	0
4	16315830	.	A	G	2	4	6	0	0	6	0	0
4	16318963	.	G	A	0	2	2	0	6	8	0	0
4	16319377	.	C	T	5	6	11	0	1	12	0	0
4	16319839	.	T	A	2	5	7	0	0	7	0	0
4	16319954	.	T	C	2	2	4	0	1	5	0	0
4	16319961	.	T	C	2	3	5	0	0	5	0	0
4	16352126	.	G	A	1	1	2	0	0	2	0	0
4	16368805	.	T	C	16	0	16	0	9	25	0	0
4	16368977	.	G	A	11	6	17	0	0	17	0	0
4	16369033	.	T	A	7	7	14	0	1	15	0	0
4	16369335	.	T	C	11	0	11	0	9	20	0	0
4	16369375	.	G	C	7	9	16	0	1	17	0	0
4	16369384	.	T	C	6	9	15	0	1	16	0	0
4	16369440	.	C	T	6	7	13	0	0	13	0	0
4	16369486	.	T	C	8	3	11	0	0	11	0	0
4	16382917	.	A	G	11	5	16	0	2	18	0	0
4	16536330	.	A	G	10	1	11	0	1	12	0	0
4	16536356	.	G	A	2	5	7	0	4	11	0	0
4	16536946	.	C	A	19	15	34	0	0	34	0	0
4	16537045	.	T	C	20	10	30	0	7	37	0	0
4	16537099	.	A	T	28	23	51	0	3	54	0	0
4	16537575	.	T	G	20	30	50	0	2	52	0	0
4	16537770	.	G	A	28	24	52	0	1	53	0	0
4	16538055	.	T	A	16	20	36	0	0	36	0	0
4	16539253	.	A	G	28	20	48	0	3	52	1	0
4	16616237	.	C	T	0	2	2	0	1	3	0	0
4	16632415	.	G	A	6	7	13	0	1	14	0	0
4	16632650	.	A	T	11	8	19	0	0	19	0	0
4	16632762	.	A	T	4	8	12	0	0	12	0	0
4	16632907	.	T	A	4	4	8	0	0	8	0	0
4	16633208	.	C	T	11	4	15	0	1	16	0	0
4	16634916	.	A	G	10	11	21	0	0	21	0	0
4	16634929	.	A	T	9	9	18	0	0	18	0	0
4	16635088	.	G	A	5	4	9	0	0	9	0	0
4	16635162	.	G	A	12	9	21	0	1	22	0	0
4	16635208	.	G	A	8	7	15	0	1	16	0	0
4	16635426	.	A	G	8	7	15	0	1	16	0	0
4	16635460	.	T	A	8	7	15	0	0	15	0	0
4	16635710	.	T	C	7	8	15	0	2	17	0	0
4	16638015	.	T	C	7	5	12	0	2	14	0	0
4	16638021	.	T	G	6	7	13	0	3	16	0	0
4	16641677	.	T	C	11	7	18	0	2	20	0	0
4	16650102	.	T	C	6	3	9	0	2	11	0	0
4	16650142	.	A	T	8	7	15	0	1	16	0	0
4	16650433	.	A	C	22	12	34	0	0	34	0	0
4	16650482	.	T	C	16	16	32	0	0	32	0	0
4	16650611	.	T	G	10	13	23	0	0	23	0	0
4	16650618	.	A	G	9	13	22	0	0	22	0	0
4	16650898	.	C	A	8	5	13	1	1	15	0	0
4	16651010	.	G	C	11	0	11	0	10	21	0	0
4	16651046	.	G	C	12	9	21	0	2	23	0	0
4	16651121	.	A	G	18	13	31	0	0	31	0	0
4	16651414	.	G	A	27	8	35	0	0	35	0	0
4	16652890	.	A	G	18	17	35	0	0	35	0	0
4	16654337	.	G	C	15	21	36	0	2	38	0	0
4	16654349	.	C	T	0	18	18	0	18	36	0	0
4	16659679	.	G	A	16	9	25	0	2	27	0	0
4	16666267	.	C	T	12	9	21	0	0	21	0	0
4	16671133	.	T	C	12	9	21	0	0	21	0	0
4	16671232	.	C	T	0	12	12	0	12	24	0	0
4	16672481	.	G	T	9	10	19	0	1	20	0	0
4	16672771	.	C	T	18	17	35	0	2	38	1	0
4	16677348	.	T	C	10	14	24	0	4	28	0	0
4	16677354	.	C	G	12	16	28	0	3	31	0	0
4	16680671	.	T	G	15	7	22	0	2	24	0	0
4	16680674	.	T	G	16	7	23	0	0	23	0	0
4	16706865	.	T	C	8	14	22	0	1	23	0	0
4	16706889	.	A	T	10	10	20	0	1	21	0	0
4	16733585	.	G	A	13	8	21	0	0	21	0	0
4	16733984	.	C	T	9	13	22	0	0	22	0	0
4	16736812	.	C	G	5	1	6	0	8	14	0	0
4	16736833	.	A	G	5	0	5	0	7	12	0	0
4	16739031	.	A	G	8	7	15	0	0	15	0	0
4	16739061	.	T	C	6	8	14	0	0	14	0	0
4	16739122	.	G	A	0	9	9	0	12	21	0	0
4	16741979	.	T	G	10	6	16	0	0	16	0	0
4	16742444	.	G	C	12	13	25	0	1	26	0	0
4	16784840	.	G	T	19	29	48	0	3	51	0	0
4	16784876	.	C	T	26	16	42	0	5	47	0	0
4	16785393	.	A	G	20	21	41	0	0	41	0	0
4	16785664	.	A	T	16	12	28	0	0	28	0	0
4	16785766	.	T	C	4	11	15	0	0	15	0	0
4	16785960	.	G	A	0	2	2	0	4	6	0	0
4	16785961	.	G	T	4	2	6	0	0	6	0	0
4	16786002	.	C	A	4	6	10	0	2	12	0	0
4	16786018	.	A	T	4	9	13	0	1	14	0	0
4	16786059	.	T	C	2	8	10	0	1	11	0	0
4	16786208	.	C	T	2	13	15	0	0	15	0	0
4	16788485	.	C	T	2	7	9	0	0	9	0	0
4	16788500	.	G	A	0	8	8	0	2	10	0	0
4	16791616	.	G	A	6	6	12	0	0	12	0	0
4	16791673	.	C	A	8	3	11	0	0	11	0	0
4	16791780	.	A	G	6	0	6	0	7	13	0	0
4	16791781	.	G	C	6	6	12	0	1	13	0	0
4	16791934	.	C	T	2	3	5	0	4	9	0	0
4	16795020	.	C	T	1	4	5	0	0	5	0	0
4	16829355	.	T	C	45	24	69	0	3	72	0	0
4	16829387	.	T	G	40	27	67	0	2	69	0	0
4	16829651	.	G	A	28	30	58	0	12	70	0	0
4	16831399	.	A	T	28	38	66	0	0	66	0	0
4	16832124	.	C	A	3	30	33	0	30	63	0	0
4	16832894	.	G	A	26	38	64	0	5	69	0	0
4	16858074	.	A	T	1	3	4	0	0	4	0	0
4	16858075	.	A	G	1	3	4	0	0	4	0	0
4	16858155	.	G	A	1	2	3	0	0	3	0	0
4	16858289	.	G	C	3	0	3	0	5	8	0	0
4	16858414	.	A	T	4	4	8	0	0	8	0	0
4	16858442	.	C	G	0	4	4	0	4	8	0	0
4	16876881	.	A	T	2	3	5	0	0	5	0	0
4	16877387	.	C	T	1	15	16	0	14	30	0	0
4	16879505	.	T	C	19	0	19	0	25	44	0	0
4	16881865	.	T	G	17	18	35	0	0	35	0	0
4	16885898	.	A	T	18	15	33	0	0	33	0	0
4	16889709	.	C	T	15	12	27	0	1	28	0	0
4	16889745	.	G	A	13	11	24	0	0	24	0	0
4	16893050	.	A	G	15	8	23	0	1	24	0	0
4	16893062	.	T	C	12	13	25	0	0	25	0	0
4	16898904	.	A	T	8	16	24	0	0	24	0	0
4	16899273	.	T	C	16	25	41	0	2	43	0	0
4	16904521	.	C	G	21	25	46	0	3	49	0	0
4	16904527	.	A	G	18	2	20	0	30	50	0	0
4	16905090	.	T	C	17	17	34	0	1	35	0	0
4	16905119	.	T	C	17	18	35	0	1	36	0	0
4	16905184	.	T	C	17	16	33	0	1	34	0	0
4	16905224	.	A	G	17	15	32	0	0	32	0	0
4	16905318	.	G	A	21	9	30	0	0	30	0	0
4	16905370	.	G	A	18	5	23	0	0	23	0	0
4	16905511	.	C	T	7	5	12	0	0	12	0	0
4	16905684	.	T	G	12	13	25	0	0	26	1	0
4	16905708	.	T	A	18	9	27	0	1	28	0	0
4	16905723	.	C	A	19	11	30	0	1	31	0	0
4	16905853	.	T	A	12	15	27	0	0	27	0	0
4	16906173	.	C	A	22	16	38	0	0	38	0	0
4	16906198	.	C	A	23	14	37	0	1	38	0	0
4	16906244	.	A	T	19	19	38	0	1	40	1	0
4	16906562	.	G	A	18	26	44	0	1	45	0	0
4	16982269	.	G	A	14	14	28	0	1	29	0	0
4	16982682	.	C	A	13	16	29	0	0	29	0	0
4	16983131	.	A	G	4	7	11	0	0	11	0	0
4	16983183	.	G	A	2	4	6	0	0	6	0	0
4	16983434	.	T	C	24	0	24	0	16	40	0	0
4	16984252	.	C	G	10	7	17	0	3	20	0	0
4	16984542	.	A	G	14	11	25	5	4	34	0	0
4	16985045	.	C	T	7	15	22	0	0	22	0	0
4	16988139	.	A	G	8	19	27	0	0	27	0	0
4	17008995	.	A	G	11	12	23	0	0	23	0	0
4	17251623	.	T	C	1	1	2	0	1	3	0	0
4	17253737	.	A	G	9	5	14	0	0	14	0	0
4	17253758	.	C	T	7	5	12	0	0	12	0	0
4	17253813	.	A	C	2	5	7	0	0	7	0	0
4	17253818	.	A	G	2	4	6	0	0	6	0	0
4	17253925	.	T	A	9	9	18	0	0	18	0	0
4	17253927	.	T	A	9	9	18	0	0	18	0	0
4	17254046	.	A	G	7	11	18	0	1	19	0	0
4	17256855	.	C	T	7	6	13	0	0	13	0	0
4	17257386	.	G	A	14	9	23	0	0	23	0	0
4	17257458	.	C	T	5	5	10	0	0	10	0	0
4	17260535	.	G	A	11	8	19	0	0	19	0	0
4	17287446	.	T	G	14	11	25	0	0	25	0	0
4	17288964	.	T	C	18	21	39	0	1	40	0	0
4	17291024	.	A	G	6	21	27	0	1	28	0	0
4	17292575	.	C	A	16	17	33	0	1	34	0	0
4	17292770	.	G	A	24	20	44	0	2	46	0	0
4	17292789	.	A	C	21	27	48	0	0	48	0	0
4	17292837	.	A	G	20	19	39	0	2	41	0	0
4	17294947	.	T	C	17	26	43	0	1	44	0	0
4	17296974	.	A	G	1	7	8	0	5	13	0	0
4	17297086	.	C	A	9	19	28	0	1	29	0	0
4	17297338	.	T	G	5	5	10	0	0	10	0	0
4	17326234	.	C	T	3	6	9	0	0	9	0	0
4	17326332	.	T	A	2	4	6	0	0	6	0	0
4	17326465	.	A	C	2	5	7	0	0	7	0	0
4	17326506	.	T	C	2	3	5	0	0	5	0	0
4	17336624	.	C	T	11	3	14	0	0	14	0	0
4	17336693	.	G	A	7	4	11	0	0	11	0	0
4	17337593	.	A	T	4	6	10	0	0	10	0	0
4	17338664	.	T	C	6	3	9	0	0	9	0	0
4	17344789	.	C	T	0	2	2	0	1	3	0	0
4	17354824	.	T	C	1	4	5	0	0	5	0	0
4	17359901	.	G	A	1	3	4	0	0	4	0	0
4	17380828	.	C	A	4	2	6	0	0	6	0	0
4	17382830	.	T	C	2	2	4	0	1	5	0	0
4	17382833	.	A	G	3	2	5	0	0	5	0	0
4	17384624	.	A	T	2	3	5	0	1	6	0	0
4	17524485	.	T	C	1	2	3	0	0	3	0	0
4	17528599	.	G	A	3	3	6	0	1	7	0	0
4	17530572	.	T	C	4	2	6	0	0	6	0	0
4	17530763	.	C	T	2	3	5	0	0	5	0	0
4	17533769	.	C	T	6	7	13	0	0	13	0	0
4	17534198	.	A	G	7	0	7	0	6	13	0	0
4	17537639	.	A	G	5	4	9	0	0	9	0	0
4	17537939	.	G	T	0	4	4	0	6	10	0	0
4	17545083	.	A	G	12	0	12	0	7	19	0	0
4	17572583	.	C	T	14	14	28	0	0	28	0	0
4	17572589	.	C	A	12	14	26	0	0	26	0	0
4	17572898	.	T	C	15	13	28	1	1	30	0	0
4	17572901	.	A	C	15	13	28	1	0	29	0	0
4	17573071	.	A	T	12	12	24	0	0	24	0	0
4	17573081	.	G	C	9	15	24	0	0	24	0	0
4	17573464	.	A	G	15	7	22	0	0	23	1	0
4	17573465	.	A	G	15	8	23	0	0	23	0	0
4	17573594	.	T	A	12	15	27	0	0	27	0	0
4	17573616	.	A	G	11	12	23	1	0	24	0	0
4	17573644	.	A	C	14	3	17	1	1	19	0	0
4	17573697	.	G	A	15	8	23	0	0	23	0	0
4	17573706	.	A	G	13	10	23	0	0	23	0	0
4	17573802	.	T	C	18	13	31	0	2	33	0	0
4	17573841	.	A	G	17	15	32	0	4	36	0	0
4	17573865	.	T	A	15	16	31	0	4	35	0	0
4	17573959	.	T	A	16	9	25	0	1	26	0	0
4	17573982	.	A	T	13	12	25	0	0	25	0	0
4	17574093	.	A	G	11	13	24	0	1	25	0	0
4	17574175	.	G	C	13	9	22	0	1	23	0	0
4	17574390	.	C	T	9	16	25	0	2	27	0	0
4	17574608	.	A	C	15	13	28	0	1	29	0	0
4	17574706	.	T	C	3	5	8	0	1	9	0	0
4	17580468	.	A	T	16	12	28	0	1	29	0	0
4	17596433	.	T	C	9	0	9	0	22	31	0	0
4	17596490	.	T	C	13	10	23	0	1	24	0	0
4	17629138	.	C	T	1	19	20	0	13	33	0	0
4	17629266	.	C	A	7	12	19	0	0	19	0	0
4	17635533	.	A	T	2	2	4	0	0	4	0	0
4	17636416	.	C	T	2	2	4	0	0	4	0	0
4	17636616	.	C	T	0	2	2	0	1	3	0	0
4	17642772	.	C	T	2	2	4	0	0	4	0	0
4	17642813	.	G	T	3	2	5	0	0	5	0	0
4	17643252	.	A	G	5	2	7	0	0	7	0	0
4	17643448	.	T	C	7	3	10	0	0	10	0	0
4	17644600	.	T	C	3	3	6	0	1	7	0	0
4	17644913	.	A	G	4	4	8	0	0	8	0	0
4	17644964	.	G	A	2	3	5	0	1	6	0	0
4	17645408	.	T	C	5	3	8	0	0	8	0	0
4	17645890	.	A	C	8	8	16	0	1	17	0	0
4	17645962	.	C	T	6	3	9	0	0	9	0	0
4	17657549	.	A	G	8	1	9	0	7	16	0	0
4	17660723	.	C	T	4	6	10	0	0	10	0	0
4	17660732	.	A	G	4	6	10	0	0	10	0	0
4	17660859	.	G	A	3	4	7	0	0	7	0	0
4	17660871	.	A	G	3	3	6	0	0	6	0	0
4	17660913	.	G	A	2	2	4	0	0	4	0	0
4	17661191	.	T	C	8	3	11	0	0	11	0	0
4	17661200	.	C	T	10	3	13	0	0	13	0	0
4	17661265	.	A	G	8	3	11	0	1	12	0	0
4	17661349	.	C	T	5	3	8	0	0	8	0	0
4	17661354	.	T	G	5	2	7	0	0	7	0	0
4	17661421	.	G	T	3	2	5	0	0	5	0	0
4	17674690	.	T	C	3	2	5	0	0	5	0	0
4	17675998	.	G	A	0	4	4	0	4	8	0	0
4	17684505	.	C	T	5	4	9	0	0	9	0	0
4	17684535	.	A	T	5	3	8	0	0	8	0	0
4	17684608	.	T	C	5	2	7	0	0	7	0	0
4	17686494	.	T	C	6	4	10	0	0	10	0	0
4	17686515	.	G	C	3	6	9	0	0	9	0	0
4	17688726	.	G	A	3	4	7	0	0	7	0	0
4	17688795	.	T	C	6	11	17	0	0	17	0	0
4	17688849	.	T	C	11	5	16	0	1	17	0	0
4	17688874	.	T	C	8	9	17	0	0	17	0	0
4	17688897	.	C	T	3	9	12	0	1	13	0	0
4	17689128	.	C	T	4	2	6	0	0	6	0	0
4	17689133	.	A	T	5	2	7	0	0	7	0	0
4	17689377	.	A	G	4	4	8	0	0	8	0	0
4	17689395	.	C	T	5	5	10	0	0	10	0	0
4	17689464	.	C	A	6	3	9	0	0	9	0	0
4	17689476	.	A	G	7	0	7	0	2	9	0	0
4	17689551	.	G	A	3	1	4	0	0	4	0	0
4	17689561	.	T	C	5	2	7	0	0	7	0	0
4	17693223	.	C	T	5	6	11	0	0	11	0	0
4	17693232	.	C	T	5	5	10	0	0	10	0	0
4	17693286	.	T	C	3	9	12	0	0	12	0	0
4	17693400	.	A	G	8	11	19	1	2	22	0	0
4	17695054	.	A	G	4	5	9	0	0	9	0	0
4	17696254	.	G	A	8	3	11	0	0	11	0	0
4	17696341	.	A	G	2	0	2	0	3	5	0	0
4	17704067	.	G	A	4	10	14	0	0	14	0	0
4	17704123	.	T	C	8	6	14	0	0	14	0	0
4	17704279	.	T	A	4	2	6	0	0	6	0	0
4	17704393	.	A	T	5	2	7	0	0	7	0	0
4	17704560	.	A	G	3	7	10	0	0	10	0	0
4	17704842	.	A	G	2	3	5	0	0	5	0	0
4	17704915	.	A	T	0	4	4	0	1	5	0	0
4	17704928	.	T	A	0	4	4	0	1	5	0	0
4	17708230	.	T	C	6	7	13	0	1	14	0	0
4	17708346	.	G	A	7	12	19	0	0	19	0	0
4	17712719	.	A	G	3	5	8	0	2	10	0	0
4	17821696	.	A	G	1	6	7	0	0	7	0	0
4	17822279	.	G	A	2	6	8	0	0	8	0	0
4	17849010	.	C	T	1	2	3	0	0	3	0	0
4	17849156	.	A	G	4	3	7	0	0	7	0	0
4	17851366	.	T	C	3	3	6	0	0	6	0	0
4	17873530	.	T	G	6	6	12	0	0	12	0	0
4	17873615	.	T	C	6	2	8	0	3	11	0	0
4	17873620	.	T	C	8	4	12	0	0	12	0	0
4	17873787	.	G	A	0	2	2	0	3	5	0	0
4	17873808	.	G	C	2	3	5	0	1	6	0	0
4	17886974	.	G	A	16	12	28	1	1	30	0	0
4	17887059	.	T	C	15	13	28	2	0	30	0	0
4	17887388	.	A	T	18	19	37	0	1	38	0	0
4	17887826	.	C	T	22	27	49	0	1	50	0	0
4	17887885	.	A	C	24	19	43	0	7	50	0	0
4	17902098	.	A	G	15	21	36	0	1	37	0	0
4	17904325	.	A	C	17	0	17	0	21	38	0	0
4	17915070	.	G	A	19	24	43	0	2	45	0	0
4	17949261	.	C	T	15	19	34	0	2	36	0	0
4	17999156	.	G	A	5	3	8	0	0	8	0	0
4	17999310	.	C	A	4	6	10	0	0	10	0	0
4	17999412	.	G	T	5	3	8	0	0	8	0	0
4	18067311	.	C	T	8	6	14	0	0	14	0	0
4	18067324	.	G	T	6	5	11	0	0	11	0	0
4	18098108	.	C	T	0	3	3	0	3	6	0	0
4	18119557	.	G	C	4	8	12	0	0	12	0	0
4	18208005	.	A	G	1	3	4	0	1	5	0	0
4	18208068	.	A	G	4	7	11	0	0	11	0	0
4	18208347	.	C	G	5	5	10	0	4	14	0	0
4	18208635	.	T	A	4	2	6	0	0	6	0	0
4	18208760	.	G	A	9	3	12	0	1	13	0	0
4	18208769	.	A	G	8	3	11	0	0	11	0	0
4	18208939	.	C	T	5	4	9	0	1	10	0	0
4	18209107	.	G	C	8	7	15	1	0	16	0	0
4	18209185	.	A	T	8	1	9	0	1	10	0	0
4	18213267	.	C	T	6	4	10	0	2	12	0	0
4	18216182	.	A	G	10	11	21	0	0	21	0	0
4	18216251	.	T	C	11	11	22	0	1	23	0	0
4	18216332	.	A	G	14	7	21	0	1	22	0	0
4	18235106	.	T	C	8	5	13	0	0	13	0	0
4	18235397	.	A	T	9	4	13	0	0	13	0	0
4	18237355	.	A	G	4	6	10	0	0	10	0	0
4	18240356	.	A	G	2	8	10	0	0	10	0	0
4	18240451	.	G	A	6	4	10	0	1	11	0	0
4	18240546	.	C	T	1	4	5	0	13	18	0	0
4	18240607	.	C	A	0	8	8	0	2	10	0	0
4	18240658	.	T	C	1	5	6	0	0	6	0	0
4	18240690	.	A	T	3	2	5	0	0	5	0	0
4	18240811	.	G	A	4	2	6	0	0	6	0	0
4	18240822	.	G	A	3	3	6	0	0	6	0	0
4	18241030	.	A	G	2	3	5	0	1	6	0	0
4	18241255	.	C	G	6	2	8	0	0	8	0	0
4	18241297	.	C	T	4	3	7	0	0	7	0	0
4	18242936	.	G	T	6	4	10	0	0	10	0	0
4	18244632	.	T	A	9	4	13	0	1	14	0	0
4	18244669	.	G	A	5	7	12	0	1	13	0	0
4	18244670	.	G	C	5	0	5	0	8	13	0	0
4	18248692	.	C	T	1	4	5	0	10	15	0	0
4	18249120	.	G	C	7	4	11	0	0	11	0	0
4	18249414	.	T	C	4	5	9	0	0	9	0	0
4	18249423	.	G	T	4	5	9	0	0	9	0	0
4	18250996	.	G	A	5	3	8	0	0	8	0	0
4	18251171	.	T	G	5	8	13	0	0	13	0	0
4	18280931	.	A	G	6	3	9	0	1	10	0	0
4	18287263	.	T	C	1	4	5	0	0	5	0	0
4	18287410	.	T	C	1	0	1	0	4	5	0	0
4	18301293	.	C	A	0	3	3	0	3	6	0	0
4	18301353	.	T	C	3	3	6	0	2	8	0	0
4	18416371	.	C	G	4	3	7	0	0	8	1	0
4	18416429	.	A	G	2	2	4	0	0	4	0	0
4	18416462	.	T	G	2	3	5	0	0	5	0	0
4	18432317	.	T	C	1	2	3	0	0	3	0	0
4	18432790	.	C	A	3	3	6	0	1	7	0	0
4	18436549	.	G	A	3	2	5	0	0	5	0	0
4	18436714	.	T	C	1	2	3	0	0	3	0	0
4	18436759	.	T	A	1	2	3	0	0	3	0	0
4	18443849	.	C	A	1	4	5	0	0	5	0	0
4	18449062	.	G	A	4	2	6	0	0	6	0	0
4	18449080	.	T	C	3	2	5	0	0	5	0	0
4	18454352	.	A	G	9	5	14	0	0	14	0	0
4	18454363	.	T	A	10	3	13	0	0	13	0	0
4	18454400	.	C	T	0	3	3	0	6	9	0	0
4	18454423	.	G	A	7	2	9	0	0	9	0	0
4	18502494	.	C	T	3	2	5	0	1	6	0	0
4	18503393	.	G	C	2	2	4	0	0	4	0	0
4	18505935	.	G	C	3	2	5	0	0	5	0	0
4	18510675	.	C	T	0	2	2	1	2	5	0	0
4	18512471	.	A	T	4	3	7	0	0	7	0	0
4	18592863	.	A	C	1	2	3	0	0	4	1	0
4	18593839	.	G	A	13	9	22	0	3	25	0	0
4	18594019	.	G	T	12	8	20	0	1	22	1	0
4	18594045	.	T	C	9	3	12	0	1	13	0	0
4	18594125	.	T	A	7	6	13	0	0	13	0	0
4	18594871	.	T	C	9	14	23	0	3	26	0	0
4	18594920	.	G	A	13	15	28	0	0	28	0	0
4	18597841	.	C	G	15	14	29	0	1	30	0	0
4	18606501	.	G	T	27	14	41	0	1	42	0	0
4	18606512	.	C	T	23	10	33	0	1	34	0	0
4	18609613	.	T	G	4	2	6	0	1	7	0	0
4	18609812	.	A	C	5	2	7	0	0	7	0	0
4	18609855	.	G	C	1	3	4	0	0	4	0	0
4	18614034	.	A	G	2	6	8	0	0	8	0	0
4	18614208	.	C	T	3	2	5	0	0	5	0	0
4	18614232	.	A	G	4	2	6	0	0	6	0	0
4	18614367	.	A	G	3	3	6	0	2	8	0	0
4	18614484	.	G	A	6	5	11	0	0	11	0	0
4	18623708	.	A	G	5	4	9	0	0	9	0	0
4	18713937	.	T	C	1	4	5	0	1	6	0	0
4	18720871	.	C	T	4	5	9	0	0	9	0	0
4	18720942	.	C	T	5	5	10	0	0	10	0	0
4	18720947	.	G	T	5	7	12	0	0	12	0	0
4	18741886	.	T	C	1	3	4	0	0	4	0	0
4	18741940	.	C	G	1	2	3	0	0	3	0	0
4	18837898	.	A	T	7	8	15	0	4	19	0	0
4	18853972	.	C	G	13	11	24	0	3	27	0	0
4	18854250	.	A	C	14	0	14	0	17	31	0	0
4	18854433	.	A	G	9	3	12	0	2	14	0	0
4	18939328	.	A	G	4	2	6	0	0	6	0	0
4	18963897	.	G	A	4	9	13	0	10	23	0	0
4	18963908	.	C	A	9	8	17	0	1	18	0	0
4	18963960	.	G	C	12	7	19	0	0	19	0	0
4	18976182	.	A	G	12	7	19	0	0	19	0	0
4	18976574	.	C	T	12	10	22	0	0	22	0	0
4	18979820	.	T	A	15	18	33	0	0	33	0	0
4	18985807	.	T	A	11	13	24	0	0	24	0	0
4	18985846	.	A	G	15	13	28	0	1	29	0	0
4	18985995	.	G	A	7	14	21	0	0	21	0	0
4	18986107	.	C	T	3	3	6	0	0	6	0	0
4	18986282	.	T	C	10	1	11	0	3	14	0	0
4	18986293	.	T	G	9	3	12	0	0	12	0	0
4	18986413	.	G	A	7	7	14	0	0	14	0	0
4	18986497	.	C	T	3	10	13	0	19	32	0	0
4	18986771	.	A	T	11	6	17	0	0	17	0	0
4	18986805	.	G	T	12	4	16	0	0	16	0	0
4	18986893	.	C	G	3	7	10	0	1	11	0	0
4	18986897	.	T	A	5	6	11	0	1	12	0	0
4	18987202	.	C	A	8	5	13	0	0	13	0	0
4	18987216	.	T	C	9	4	13	0	1	14	0	0
4	18987250	.	G	A	11	5	16	0	1	17	0	0
4	18987275	.	A	G	13	6	19	0	1	20	0	0
4	18987391	.	G	A	4	9	13	0	1	14	0	0
4	18987523	.	T	C	13	9	22	0	2	24	0	0
4	18987835	.	G	C	13	0	13	0	19	32	0	0
4	18988068	.	T	C	10	0	10	0	15	25	0	0
4	18988084	.	G	A	9	14	23	0	0	23	0	0
4	18988150	.	T	G	14	11	25	0	1	26	0	0
4	18988222	.	A	G	13	15	28	0	1	29	0	0
4	18988270	.	T	A	8	7	15	0	0	15	0	0
4	18988426	.	G	C	5	10	15	0	2	17	0	0
4	18988912	.	G	A	6	10	16	0	0	16	0	0
4	18989185	.	T	C	10	1	11	0	10	21	0	0
4	18999680	.	C	T	0	13	13	0	15	28	0	0
4	19007158	.	C	T	1	7	8	0	13	21	0	0
4	19007377	.	T	A	13	7	20	0	1	22	1	0
4	19007486	.	A	C	13	8	21	0	2	23	0	0
4	19007601	.	A	T	9	12	21	0	0	21	0	0
4	19007711	.	T	C	17	0	17	0	10	27	0	0
4	19007811	.	T	C	12	14	26	0	2	28	0	0
4	19007823	.	A	G	13	14	27	0	0	27	0	0
4	19008090	.	C	T	1	4	5	0	8	13	0	0
4	19397641	.	A	T	23	6	29	0	0	29	0	0
4	19414905	.	G	A	14	9	23	0	2	25	0	0
4	19421890	.	G	A	9	15	24	0	1	25	0	0
4	19493773	.	G	T	10	16	26	0	1	27	0	0
4	19493808	.	G	A	10	12	22	0	3	25	0	0
4	19535841	.	T	G	15	13	28	0	4	32	0	0
4	19536422	.	T	C	15	21	36	0	0	36	0	0
4	19536917	.	C	T	19	28	47	0	2	49	0	0
4	19537703	.	A	G	29	22	51	0	2	54	1	0
4	19537937	.	A	G	29	0	29	0	21	50	0	0
4	19539017	.	C	T	8	5	13	0	1	14	0	0
4	19567605	.	A	G	13	22	35	0	1	36	0	0
4	19611694	.	G	A	15	15	30	0	1	31	0	0
4	19611739	.	T	G	13	16	29	0	0	29	0	0
4	19630280	.	A	G	13	10	23	0	0	23	0	0
4	19651917	.	G	A	11	12	23	0	1	24	0	0
4	19686284	.	A	G	10	5	15	0	0	15	0	0
4	19690484	.	C	A	0	7	7	0	12	19	0	0
4	19776011	.	G	A	2	6	8	0	0	8	0	0
4	19776014	.	G	C	2	1	3	0	6	9	0	0
4	19947781	.	G	T	1	3	4	0	0	4	0	0
4	19948131	.	G	A	4	6	10	0	0	10	0	0
4	19948312	.	A	G	3	5	8	0	0	8	0	0
4	19948313	.	A	G	3	5	8	0	0	8	0	0
4	19948467	.	T	C	2	2	4	1	0	5	0	0
4	19948746	.	T	C	1	3	4	0	0	4	0	0
4	19949148	.	T	C	5	7	12	0	1	13	0	0
4	19949178	.	A	T	3	5	8	0	0	8	0	0
4	19949260	.	A	G	1	2	3	0	0	3	0	0
4	19949597	.	T	C	2	5	7	0	2	9	0	0
4	19949598	.	T	C	4	0	4	0	5	9	0	0
4	19949651	.	C	T	0	2	2	0	4	6	0	0
4	19949730	.	T	C	6	4	10	0	0	10	0	0
4	19950024	.	T	A	5	5	10	0	0	10	0	0
4	19950032	.	T	A	5	3	8	0	1	9	0	0
4	19950212	.	A	C	2	3	5	0	0	5	0	0
4	19954907	.	G	C	2	0	2	0	3	5	0	0
4	19955017	.	G	T	2	2	4	0	0	4	0	0
4	19955237	.	A	G	5	5	10	0	0	10	0	0
4	19955276	.	A	G	2	3	5	0	1	6	0	0
4	19962613	.	T	G	3	4	7	0	1	8	0	0
4	19981642	.	T	C	1	4	5	0	0	5	0	0
4	19981777	.	C	T	1	2	3	0	0	3	0	0
4	20049543	.	C	T	32	23	55	0	3	58	0	0
4	20051021	.	A	G	27	26	53	0	3	56	0	0
4	20051092	.	C	T	1	21	22	0	14	36	0	0
4	20051485	.	A	G	8	7	15	0	0	15	0	0
4	20051488	.	A	G	8	9	17	0	0	17	0	0
4	20053199	.	T	C	18	20	38	0	1	39	0	0
4	20053211	.	A	G	21	20	41	0	1	42	0	0
4	20053901	.	C	T	20	14	34	0	1	35	0	0
4	20054036	.	C	T	17	15	32	0	0	32	0	0
4	20054135	.	A	G	5	5	10	0	0	10	0	0
4	20054190	.	T	G	4	2	6	0	1	7	0	0
4	20054243	.	A	G	3	2	5	0	2	7	0	0
4	20065233	.	C	T	4	2	6	0	1	7	0	0
4	20066194	.	T	G	8	6	14	0	2	16	0	0
4	20066208	.	G	A	9	5	14	0	2	16	0	0
4	20066263	.	T	C	12	7	19	0	1	20	0	0
4	20068149	.	T	G	6	5	11	0	0	11	0	0
4	20068185	.	A	G	5	5	10	0	0	10	0	0
4	20068266	.	A	G	4	4	8	0	1	9	0	0
4	20068446	.	G	A	10	10	20	0	0	20	0	0
4	20068470	.	C	G	9	10	19	0	0	19	0	0
4	20068717	.	G	A	7	7	14	0	0	14	0	0
4	20068890	.	G	A	7	10	17	0	0	17	0	0
4	20068903	.	T	C	9	11	20	0	0	20	0	0
4	20069091	.	T	C	7	4	11	0	0	11	0	0
4	20069343	.	C	A	10	6	16	0	0	16	0	0
4	20071344	.	A	T	2	6	8	0	0	8	0	0
4	20071401	.	G	T	4	7	11	0	0	11	0	0
4	20072394	.	C	G	8	13	21	0	0	21	0	0
4	20072429	.	T	G	11	9	20	0	0	20	0	0
4	20073790	.	T	C	13	8	21	1	0	22	0	0
4	20073799	.	A	G	12	9	21	1	1	23	0	0
4	20075455	.	T	C	4	2	6	0	0	6	0	0
4	20075473	.	G	A	4	4	8	0	0	8	0	0
4	20078569	.	G	A	4	2	6	0	0	6	0	0
4	20080778	.	T	A	6	6	12	0	1	13	0	0
4	20081451	.	A	G	4	6	10	0	0	10	0	0
4	20081520	.	C	A	1	6	7	0	1	8	0	0
4	20085183	.	A	G	4	5	9	0	0	9	0	0
4	20089075	.	C	A	7	8	15	0	0	15	0	0
4	20091055	.	G	C	1	7	8	0	8	17	1	0
4	20098937	.	C	T	6	3	9	0	0	9	0	0
4	20099022	.	G	A	5	6	11	0	0	11	0	0
4	20099261	.	C	T	7	4	11	0	0	11	0	0
4	20099516	.	G	A	0	4	4	0	2	6	0	0
4	20099564	.	C	T	3	4	7	0	0	7	0	0
4	20099842	.	A	G	5	4	9	0	2	11	0	0
4	20101105	.	G	T	8	8	16	0	0	16	0	0
4	20103813	.	T	A	2	7	9	0	0	9	0	0
4	20103864	.	G	A	3	4	7	0	0	7	0	0
4	20103873	.	T	C	3	4	7	0	0	7	0	0
4	20105455	.	T	A	5	6	11	0	0	11	0	0
4	20127909	.	C	T	4	4	8	0	1	9	0	0
4	20130216	.	T	C	2	3	5	0	0	5	0	0
4	20135088	.	A	C	4	0	4	0	6	10	0	0
4	20195525	.	A	G	1	2	3	0	0	3	0	0
4	20226677	.	A	G	12	10	22	0	0	22	0	0
4	20226826	.	T	C	7	6	13	0	2	15	0	0
4	20226916	.	A	C	11	11	22	0	1	23	0	0
4	20229626	.	C	T	11	13	24	0	0	24	0	0
4	20229920	.	C	A	1	11	12	0	17	29	0	0
4	20230213	.	G	A	14	6	20	0	1	21	0	0
4	20232838	.	A	G	7	11	18	0	2	20	0	0
4	20235766	.	G	A	11	10	21	0	1	22	0	0
4	20255240	.	T	C	5	9	14	0	0	14	0	0
4	20265275	.	A	T	17	11	28	0	0	28	0	0
4	20265309	.	C	T	19	9	28	0	1	29	0	0
4	20303381	.	C	T	1	2	3	0	3	6	0	0
4	20303545	.	T	C	3	4	7	0	0	7	0	0
4	20303604	.	T	C	3	4	7	0	0	7	0	0
4	20305777	.	T	G	3	4	7	0	1	8	0	0
4	20305985	.	A	C	5	3	8	0	0	8	0	0
4	20305991	.	G	C	4	2	6	0	0	6	0	0
4	20306737	.	A	G	3	2	5	0	0	5	0	0
4	20447754	.	A	G	4	5	9	0	1	10	0	0
4	20453583	.	A	C	9	5	14	0	1	15	0	0
4	20453824	.	A	G	11	8	19	0	0	19	0	0
4	20464937	.	C	T	7	12	19	0	0	19	0	0
4	20465711	.	T	C	4	4	8	0	1	9	0	0
4	20465899	.	C	T	10	9	19	0	2	21	0	0
4	20467610	.	T	C	18	11	29	0	1	30	0	0
4	20470061	.	G	A	16	15	31	0	0	31	0	0
4	20470205	.	C	T	18	12	30	0	1	31	0	0
4	20470316	.	C	T	5	23	28	0	2	30	0	0
4	20473032	.	G	A	14	10	24	0	2	26	0	0
4	20473127	.	G	A	2	9	11	0	16	27	0	0
4	20473142	.	C	T	19	7	26	0	2	28	0	0
4	20473175	.	C	T	20	8	28	0	0	28	0	0
4	20474363	.	A	T	11	17	28	0	2	30	0	0
4	20474728	.	A	T	9	13	22	0	0	22	0	0
4	20474969	.	A	G	13	0	13	0	10	23	0	0
4	20480734	.	G	A	8	4	12	0	0	12	0	0
4	20482150	.	T	C	8	4	12	0	2	14	0	0
4	20482425	.	A	G	5	7	12	1	0	13	0	0
4	20482615	.	G	T	7	5	12	0	0	12	0	0
4	20482726	.	A	G	8	4	12	0	0	12	0	0
4	20483846	.	T	G	9	8	17	0	0	17	0	0
4	20483881	.	C	T	6	8	14	0	1	15	0	0
4	20483901	.	G	A	5	6	11	0	0	11	0	0
4	20483918	.	A	G	3	4	7	0	0	7	0	0
4	20490031	.	C	T	5	2	7	0	0	7	0	0
4	20490043	.	T	C	5	2	7	0	0	7	0	0
4	20496653	.	A	G	2	4	6	0	0	6	0	0
4	20496655	.	C	T	1	4	5	0	0	5	0	0
4	20498240	.	A	G	10	6	16	0	0	16	0	0
4	20499421	.	G	C	3	3	6	0	0	6	0	0
4	20499440	.	A	G	2	4	6	0	0	6	0	0
4	20499493	.	T	G	6	4	10	0	0	10	0	0
4	20499557	.	G	A	4	3	7	0	0	7	0	0
4	20507121	.	T	A	7	10	17	0	1	18	0	0
4	20507155	.	A	C	15	14	29	0	2	31	0	0
4	20507546	.	T	A	7	9	16	1	0	17	0	0
4	20508691	.	G	A	6	9	15	0	3	18	0	0
4	20508913	.	A	G	18	16	34	0	1	35	0	0
4	20508928	.	A	G	23	15	38	0	0	38	0	0
4	20508992	.	C	T	26	14	40	0	0	41	1	0
4	20930170	.	C	T	1	5	6	0	1	7	0	0
4	20949623	.	G	C	1	8	9	0	0	9	0	0
4	20950073	.	C	T	5	3	8	0	1	9	0	0
4	20950816	.	T	C	8	4	12	0	0	12	0	0
4	20950990	.	A	C	2	2	4	0	0	4	0	0
4	20951080	.	C	T	3	2	5	0	0	5	0	0
4	20951111	.	G	A	3	2	5	0	0	5	0	0
4	20951390	.	C	T	15	7	22	0	1	23	0	0
4	20952889	.	C	T	8	7	15	0	1	16	0	0
4	20952934	.	A	G	8	0	8	0	5	13	0	0
4	20953265	.	C	A	3	8	11	0	0	11	0	0
4	20955052	.	T	C	5	6	11	0	1	12	0	0
4	20958929	.	G	A	0	5	5	0	11	16	0	0
4	20959176	.	T	C	12	4	16	0	0	16	0	0
4	20965426	.	A	T	6	9	15	0	0	15	0	0
4	20965483	.	T	C	5	6	11	0	2	13	0	0
4	20971490	.	C	T	17	13	30	0	0	30	0	0
4	20974250	.	C	T	10	10	20	1	1	22	0	0
4	20974343	.	C	A	6	8	14	0	0	14	0	0
4	20976062	.	A	T	11	8	19	0	0	19	0	0
4	20976085	.	G	A	13	8	21	0	0	21	0	0
4	20976252	.	G	A	5	5	10	0	3	13	0	0
4	20976371	.	C	T	7	2	9	0	0	9	0	0
4	20979435	.	C	A	12	4	16	0	2	18	0	0
4	20980971	.	A	G	5	12	17	0	2	19	0	0
4	20981198	.	G	A	1	6	7	0	12	19	0	0
4	20981273	.	A	C	14	7	21	0	0	21	0	0
4	21290798	.	G	A	29	30	59	0	1	60	0	0
4	21295949	.	T	C	27	28	55	0	10	65	0	0
4	21297417	.	A	C	33	29	62	0	2	64	0	0
4	21312642	.	T	C	38	17	55	0	6	61	0	0
4	21312981	.	C	T	27	27	54	0	7	61	0	0
4	21313120	.	A	G	27	2	29	0	38	67	0	0
4	21313136	.	T	C	29	34	63	0	5	68	0	0
4	21313779	.	T	G	39	25	64	0	0	64	0	0
4	21313805	.	G	A	4	29	33	0	38	71	0	0
4	21314120	.	T	C	21	25	46	1	2	49	0	0
4	21314204	.	G	T	30	20	50	1	1	52	0	0
4	21314338	.	G	T	31	26	57	0	3	60	0	0
4	21314583	.	T	C	29	29	58	0	2	60	0	0
4	21323215	.	T	C	3	0	3	0	5	8	0	0
4	21323216	.	T	G	3	5	8	0	0	8	0	0
4	21323363	.	G	C	2	5	7	0	1	8	0	0
4	21323454	.	A	G	2	5	7	0	0	7	0	0
4	21323467	.	G	C	1	6	7	0	0	7	0	0
4	21323532	.	C	T	0	5	5	0	2	7	0	0
4	21323536	.	T	C	2	5	7	0	0	7	0	0
4	21369434	.	G	A	3	5	8	0	1	9	0	0
4	21489392	.	C	A	8	5	13	0	3	16	0	0
4	21489551	.	A	G	12	1	13	0	2	15	0	0
4	21489629	.	G	T	13	10	23	0	1	24	0	0
4	21490320	.	T	C	18	11	29	1	1	31	0	0
4	21490344	.	A	G	21	13	34	1	0	35	0	0
4	21499521	.	G	A	12	12	24	0	0	24	0	0
4	21507026	.	G	A	10	9	19	0	2	21	0	0
4	21508353	.	C	T	16	13	29	0	1	30	0	0
4	21512191	.	C	T	16	14	30	2	3	35	0	0
4	21517970	.	A	G	10	14	24	0	0	24	0	0
4	21523541	.	A	T	11	11	22	3	4	29	0	0
4	21523789	.	T	G	10	11	21	0	3	24	0	0
4	21525430	.	G	T	13	9	22	0	1	23	0	0
4	21526300	.	A	G	6	11	17	0	1	18	0	0
4	21649505	.	G	A	30	32	62	1	10	73	0	0
4	21651486	.	G	A	40	25	65	0	0	65	0	0
4	21652609	.	A	T	6	13	19	0	0	19	0	0
4	21751835	.	C	T	0	2	2	0	3	5	0	0
4	21752284	.	G	A	7	8	15	0	0	15	0	0
4	21752291	.	C	T	5	8	13	0	1	14	0	0
4	21752688	.	G	C	13	0	13	0	8	21	0	0
4	21752736	.	T	C	12	10	22	0	1	23	0	0
4	21752941	.	T	A	7	8	15	0	1	16	0	0
4	21752969	.	C	T	9	11	20	0	0	20	0	0
4	21752984	.	C	A	10	10	20	0	1	21	0	0
4	21753139	.	C	T	9	17	26	0	1	27	0	0
4	21753185	.	T	C	10	15	25	0	0	25	0	0
4	21753316	.	T	C	11	22	33	0	1	34	0	0
4	21753344	.	G	A	12	16	28	0	3	31	0	0
4	21761688	.	A	T	16	19	35	0	0	36	1	0
4	22756239	.	T	C	19	15	34	0	0	34	0	0
4	25331367	.	C	A	3	1	4	0	1	5	0	0
4	26080321	.	A	G	8	4	12	0	1	13	0	0
4	26762518	.	G	T	4	3	7	0	0	7	0	0
4	26762524	.	G	T	7	4	11	0	1	12	0	0
4	26763482	.	G	T	4	3	7	0	0	7	0	0
4	27112663	.	T	A	4	3	7	0	0	7	0	0
4	27149634	.	A	T	2	2	4	0	0	4	0	0
4	31303760	.	A	T	1	2	3	0	0	3	0	0
4	44852572	.	G	C	1	2	3	0	0	3	0	0
4	55587518	.	T	C	0	2	2	0	1	3	0	0
4	57105623	.	G	A	7	3	10	1	0	11	0	0
4	69189397	.	C	T	3	2	5	1	0	6	0	0
4	70842262	.	A	T	2	2	4	0	0	4	0	0
4	70851069	.	G	A	5	2	7	6	0	13	0	0
4	70851105	.	A	G	7	5	12	2	0	14	0	0
4	70860034	.	A	C	9	0	9	0	4	13	0	0
4	70860166	.	A	G	10	7	17	0	0	17	0	0
4	70864441	.	C	G	2	1	3	0	1	4	0	0
4	70864466	.	G	A	4	3	7	0	0	7	0	0
4	70866787	.	A	T	11	3	14	0	0	14	0	0
4	70866791	.	A	T	11	3	14	0	0	14	0	0
4	70867005	.	G	C	2	5	7	0	1	8	0	0
4	71822602	.	G	A	1	2	3	0	0	3	0	0
4	72217180	.	C	T	4	2	6	0	0	6	0	0
4	72560293	.	A	G	5	2	7	0	0	7	0	0
4	72630316	.	G	A	1	4	5	0	0	5	0	0
4	73064409	.	A	G	2	2	4	0	1	5	0	0
4	73336084	.	T	C	5	2	7	0	0	7	0	0
4	73336700	.	T	C	1	3	4	0	1	5	0	0
4	73336711	.	T	C	2	0	2	0	3	5	0	0
4	73574946	.	T	C	1	3	4	0	0	4	0	0
4	73899191	.	A	G	1	3	4	0	0	4	0	0
4	74204780	.	A	G	7	3	10	0	1	11	0	0
4	74875829	.	A	G	1	2	3	0	0	3	0	0
4	74891524	.	C	T	0	3	3	0	4	7	0	0
4	74891617	.	A	T	2	3	5	0	0	5	0	0
4	74891619	.	C	G	2	2	4	0	1	5	0	0
4	74892233	.	G	A	1	1	2	0	1	3	0	0
4	74943202	.	A	T	13	18	31	0	0	31	0	0
4	74952477	.	G	A	17	16	33	0	0	33	0	0
4	74952525	.	A	G	16	0	16	0	17	33	0	0
4	74952660	.	G	T	2	11	13	0	16	29	0	0
4	74960826	.	C	T	18	18	36	0	3	39	0	0
4	74961011	.	C	T	15	7	22	1	4	27	0	0
4	74961075	.	G	A	13	12	25	0	0	25	0	0
4	74961520	.	T	A	6	7	13	0	0	13	0	0
4	74969932	.	G	C	1	2	3	0	1	4	0	0
4	75031322	.	A	G	6	3	9	0	1	10	0	0
4	76322771	.	T	C	9	4	13	0	0	13	0	0
4	76334977	.	T	G	2	0	2	0	2	4	0	0
4	76335026	.	A	T	2	2	4	0	0	4	0	0
4	76336468	.	T	A	2	2	4	0	0	4	0	0
4	76336471	.	A	C	1	2	3	0	1	4	0	0
4	76345923	.	A	G	1	0	1	1	4	6	0	0
4	76345974	.	A	G	1	3	4	0	0	4	0	0
4	76346004	.	T	C	1	2	3	0	0	3	0	0
4	76346188	.	T	A	9	4	13	0	0	13	0	0
4	76346238	.	C	A	7	4	11	2	1	14	0	0
4	76347126	.	T	C	2	3	5	0	0	5	0	0
4	76347163	.	A	G	5	2	7	0	0	7	0	0
4	76347508	.	T	G	7	6	13	0	0	13	0	0
4	76347850	.	T	C	6	2	8	0	0	8	0	0
4	76347977	.	A	T	1	2	3	0	0	3	0	0
4	76348088	.	T	A	4	4	8	0	0	8	0	0
4	76350043	.	A	G	2	3	5	0	0	5	0	0
4	76363060	.	A	C	4	2	6	0	1	7	0	0
4	76363195	.	C	T	0	2	2	0	4	6	0	0
4	76363204	.	A	C	4	2	6	0	0	6	0	0
4	76378005	.	T	C	1	2	3	0	0	3	0	0
4	76378072	.	G	A	1	4	5	0	0	5	0	0
4	76378449	.	T	C	1	1	2	0	0	2	0	0
4	76378457	.	T	A	1	2	3	0	0	3	0	0
4	76378541	.	C	T	2	1	3	0	1	4	0	0
4	76379040	.	T	G	1	2	3	0	0	3	0	0
4	76383149	.	G	A	2	2	4	0	0	4	0	0
4	76403792	.	T	C	3	2	5	0	0	5	0	0
4	76409876	.	G	A	4	2	6	0	0	6	0	0
4	76409882	.	A	G	2	3	5	0	0	5	0	0
4	76410654	.	T	C	4	2	6	0	1	7	0	0
4	76411017	.	C	T	5	3	8	0	1	9	0	0
4	76411252	.	G	A	10	2	12	0	0	12	0	0
4	76411255	.	A	C	9	2	11	0	1	12	0	0
4	76411346	.	T	C	1	4	5	0	0	5	0	0
4	76411925	.	T	G	4	2	6	0	0	6	0	0
4	76411990	.	A	G	2	0	2	0	9	11	0	0
4	76411991	.	G	C	9	3	12	0	0	12	0	0
4	76412107	.	C	T	4	2	6	0	0	6	0	0
4	76412368	.	C	G	7	0	7	0	4	11	0	0
4	76412432	.	G	T	3	9	12	0	0	12	0	0
4	76412464	.	G	T	4	6	10	0	0	10	0	0
4	76412625	.	C	A	1	3	4	0	0	4	0	0
4	76412937	.	C	T	16	3	19	0	1	20	0	0
4	76412938	.	A	C	16	3	19	0	1	20	0	0
4	76416857	.	G	T	3	2	5	0	0	5	0	0
4	76420875	.	C	T	5	4	9	0	1	10	0	0
4	76420883	.	G	A	5	4	9	0	0	9	0	0
4	76421602	.	A	C	3	5	8	0	0	8	0	0
4	76421898	.	A	G	2	2	4	0	0	4	0	0
4	76422084	.	A	G	4	2	6	0	0	6	0	0
4	76422231	.	G	A	1	5	6	0	5	11	0	0
4	76422357	.	T	C	3	2	5	0	0	5	0	0
4	76422395	.	C	T	4	3	7	0	0	7	0	0
4	76422615	.	C	T	1	2	3	0	1	4	0	0
4	76423418	.	A	G	5	2	7	0	2	9	0	0
4	76423537	.	C	T	2	3	5	0	0	5	0	0
4	76427137	.	G	C	0	4	4	0	0	4	0	0
4	76427145	.	A	G	1	4	5	0	0	5	0	0
4	76429102	.	A	G	3	7	10	0	0	10	0	0
4	76429202	.	A	C	2	4	6	0	1	7	0	0
4	76429270	.	C	T	7	4	11	0	0	11	0	0
4	76429479	.	T	C	1	4	5	0	0	5	0	0
4	76429482	.	G	A	1	3	4	0	0	4	0	0
4	76429878	.	G	T	5	3	8	0	0	8	0	0
4	76429969	.	G	A	1	8	9	0	0	9	0	0
4	76430256	.	G	A	2	2	4	0	0	4	0	0
4	76430257	.	A	G	2	2	4	0	0	4	0	0
4	76436851	.	G	A	2	2	4	0	0	4	0	0
4	76436853	.	A	G	1	2	3	0	1	4	0	0
4	76437869	.	A	G	2	3	5	0	0	5	0	0
4	76437999	.	A	T	1	6	7	0	1	8	0	0
4	76438049	.	T	C	1	5	6	0	0	6	0	0
4	76438052	.	A	G	1	0	1	0	4	5	0	0
4	76439450	.	C	T	2	2	4	0	0	4	0	0
4	76455090	.	C	G	2	5	7	0	0	7	0	0
4	76462977	.	T	C	3	3	6	0	0	6	0	0
4	76463007	.	C	A	3	3	6	0	0	6	0	0
4	76464961	.	G	A	6	4	10	0	0	10	0	0
4	76465087	.	C	T	2	5	7	0	1	8	0	0
4	76465329	.	T	C	4	6	10	0	0	10	0	0
4	76465346	.	C	T	3	6	9	0	0	9	0	0
4	76473500	.	T	C	5	2	7	0	0	7	0	0
4	76473527	.	A	G	3	2	5	0	0	5	0	0
4	76473673	.	T	C	1	2	3	0	1	4	0	0
4	76473716	.	G	A	1	4	5	0	0	5	0	0
4	76473737	.	T	C	2	2	4	0	0	4	0	0
4	76473911	.	A	G	3	5	8	0	0	8	0	0
4	76474078	.	G	A	5	2	7	0	0	7	0	0
4	76480793	.	G	A	1	2	3	0	0	3	0	0
4	76480806	.	G	A	1	2	3	0	0	3	0	0
4	76480943	.	C	A	1	2	3	0	0	3	0	0
4	76480996	.	C	T	0	2	2	0	1	3	0	0
4	76481137	.	A	T	2	2	4	0	0	4	0	0
4	76481140	.	C	A	1	1	2	0	1	3	0	0
4	76481216	.	G	C	2	0	2	0	6	8	0	0
4	76481403	.	T	A	11	9	20	0	3	23	0	0
4	76481572	.	G	A	3	8	11	0	3	14	0	0
4	76481665	.	A	T	5	3	8	0	0	8	0	0
4	76482075	.	G	T	3	3	6	0	1	7	0	0
4	76482207	.	A	G	4	8	12	0	0	12	0	0
4	76482249	.	C	T	3	5	8	0	0	8	0	0
4	76482673	.	T	C	5	3	8	0	0	8	0	0
4	76482756	.	G	T	2	4	6	0	0	6	0	0
4	76484343	.	G	A	3	8	11	0	2	13	0	0
4	76484531	.	T	C	2	7	9	0	0	9	0	0
4	76488299	.	C	A	2	4	6	0	4	10	0	0
4	76488514	.	T	A	3	4	7	0	0	7	0	0
4	76488617	.	G	A	0	5	5	0	1	6	0	0
4	76488624	.	A	G	1	5	6	0	0	6	0	0
4	76488742	.	G	C	4	4	8	0	1	9	0	0
4	76488820	.	G	A	2	5	7	0	1	8	0	0
4	76582329	.	T	C	2	2	4	0	0	4	0	0
4	76866860	.	A	G	5	8	13	1	0	14	0	0
4	76866875	.	A	G	4	0	4	1	10	15	0	0
4	76866993	.	A	G	11	5	16	0	1	17	0	0
4	76960544	.	C	G	7	0	7	0	6	13	0	0
4	77093155	.	T	C	1	5	6	0	0	6	0	0
4	77148536	.	A	G	1	2	3	0	2	5	0	0
4	77148561	.	A	G	5	0	5	0	4	9	0	0
4	77251021	.	T	C	2	1	3	0	5	8	0	0
4	77389832	.	G	C	6	3	9	0	1	10	0	0
4	77390083	.	A	T	10	3	13	0	0	13	0	0
4	77390628	.	A	T	5	6	11	0	0	11	0	0
4	77402069	.	G	A	4	4	8	0	0	8	0	0
4	77975670	.	T	C	4	2	6	0	0	6	0	0
4	77975728	.	A	G	3	2	5	0	0	5	0	0
5	32110	.	C	T	2	7	9	0	0	9	0	0
5	43375	.	G	T	2	2	4	0	0	4	0	0
5	55297	.	C	T	1	1	2	0	1	3	0	0
5	83367	.	G	A	4	2	6	0	0	6	0	0
5	318077	.	G	A	8	13	21	0	0	21	0	0
5	318125	.	C	T	18	12	30	0	2	32	0	0
5	320383	.	T	C	9	0	9	0	9	18	0	0
5	340614	.	A	G	10	7	17	0	2	19	0	0
5	341288	.	T	C	15	7	22	0	0	22	0	0
5	341331	.	C	T	11	8	19	0	1	20	0	0
5	341740	.	A	C	12	10	22	0	2	24	0	0
5	393858	.	G	A	6	10	16	0	1	17	0	0
5	393979	.	T	C	8	12	20	0	1	21	0	0
5	394181	.	G	A	17	17	34	0	0	34	0	0
5	394184	.	T	C	15	17	32	0	1	33	0	0
5	394238	.	A	G	18	20	38	0	1	39	0	0
5	394239	.	T	G	19	21	40	0	0	40	0	0
5	394360	.	C	G	13	15	28	0	0	28	0	0
5	394417	.	G	A	1	10	11	0	15	26	0	0
5	394484	.	A	G	4	1	5	0	19	24	0	0
5	395404	.	T	A	7	9	16	0	0	16	0	0
5	395405	.	T	C	6	8	14	0	2	16	0	0
5	416808	.	T	C	6	0	6	0	7	13	0	0
5	440032	.	A	G	7	0	7	0	8	15	0	0
5	440033	.	A	C	6	7	13	0	2	15	0	0
5	440106	.	T	C	4	10	14	0	1	15	0	0
5	457736	.	C	G	16	16	32	0	1	33	0	0
5	484451	.	T	A	3	2	5	0	0	5	0	0
5	490242	.	C	T	3	2	5	0	0	5	0	0
5	491982	.	T	C	6	3	9	0	0	9	0	0
5	894613	.	C	T	6	8	14	0	0	14	0	0
5	894882	.	T	A	8	6	14	0	0	14	0	0
5	895581	.	T	C	14	9	23	0	0	23	0	0
5	896908	.	C	A	11	4	15	0	1	16	0	0
5	899952	.	C	T	13	8	21	0	1	22	0	0
5	905263	.	C	A	13	9	22	0	0	22	0	0
5	917336	.	C	T	14	13	27	0	1	28	0	0
5	1055103	.	C	T	17	25	42	0	1	43	0	0
5	1059697	.	T	C	17	17	34	0	0	34	0	0
5	1064013	.	A	G	11	19	30	0	2	32	0	0
5	1068116	.	T	A	15	15	30	0	1	31	0	0
5	1073850	.	T	G	2	2	4	0	0	4	0	0
5	1079480	.	C	T	15	17	32	0	0	32	0	0
5	1079558	.	G	T	6	9	15	1	1	17	0	0
5	1083073	.	A	G	3	0	3	0	4	7	0	0
5	1083203	.	G	C	2	11	13	1	1	15	0	0
5	1083283	.	G	T	2	2	4	0	1	5	0	0
5	1083429	.	A	G	7	3	10	2	1	13	0	0
5	1083431	.	G	A	4	2	6	2	8	16	0	0
5	1083894	.	T	G	6	0	6	0	7	13	0	0
5	1109244	.	C	T	2	3	5	0	0	5	0	0
5	1116890	.	G	A	0	2	2	0	3	5	0	0
5	1120788	.	C	T	4	2	6	0	0	6	0	0
5	1150143	.	T	C	1	7	8	0	0	8	0	0
5	1152013	.	G	C	3	4	7	0	1	8	0	0
5	1155594	.	G	A	5	4	9	0	0	9	0	0
5	1187950	.	G	A	7	9	16	0	1	17	0	0
5	1207835	.	C	T	7	4	11	0	0	11	0	0
5	1216494	.	A	G	5	6	11	0	0	11	0	0
5	1216536	.	C	T	1	10	11	0	6	17	0	0
5	1216575	.	G	A	6	11	17	0	0	17	0	0
5	1218781	.	G	A	5	3	8	0	0	8	0	0
5	1219263	.	C	T	14	10	24	0	1	25	0	0
5	1219381	.	G	A	16	11	27	0	0	27	0	0
5	1223368	.	A	T	8	9	17	2	1	20	0	0
5	1223369	.	C	T	9	7	16	2	2	20	0	0
5	1223460	.	G	A	11	3	14	0	2	16	0	0
5	1223487	.	G	T	10	5	15	0	0	15	0	0
5	1240403	.	C	A	1	6	7	0	2	9	0	0
5	1240517	.	T	C	4	4	8	0	1	9	0	0
5	1240534	.	G	A	3	4	7	0	0	7	0	0
5	1240589	.	C	T	1	9	10	0	1	11	0	0
5	1244945	.	A	G	1	3	4	0	0	4	0	0
5	1244952	.	C	T	1	3	4	0	1	5	0	0
5	1245017	.	T	C	3	9	12	0	0	12	0	0
5	1270554	.	T	C	3	0	3	0	3	6	0	0
5	1271483	.	C	G	3	2	5	0	2	7	0	0
5	1299350	.	C	G	19	0	19	0	14	33	0	0
5	1311041	.	G	A	27	17	44	0	4	48	0	0
5	1317871	.	T	C	17	20	37	0	1	38	0	0
5	1317883	.	G	A	19	23	42	0	2	44	0	0
5	1346838	.	T	C	24	25	49	0	0	49	0	0
5	1420729	.	A	G	16	12	28	0	3	31	0	0
5	1420843	.	A	G	16	4	20	0	1	21	0	0
5	1438628	.	G	A	16	13	29	0	1	30	0	0
5	1445964	.	G	A	3	11	14	0	0	14	0	0
5	1451568	.	G	A	5	7	12	1	1	14	0	0
5	1451666	.	T	C	7	0	7	0	5	12	0	0
5	1456393	.	G	A	11	11	22	0	1	23	0	0
5	1456411	.	T	C	12	10	22	0	1	23	0	0
5	1461953	.	C	T	8	11	19	0	0	19	0	0
5	1464617	.	G	T	8	7	15	0	1	16	0	0
5	1467806	.	C	T	0	6	6	0	4	10	0	0
5	1468472	.	T	C	2	0	2	2	9	13	0	0
5	1519571	.	G	C	11	17	28	0	0	28	0	0
5	1519574	.	T	A	11	14	25	0	2	27	0	0
5	1624525	.	G	A	22	11	33	0	2	35	0	0
5	1653920	.	C	T	26	20	46	0	6	52	0	0
5	1653989	.	T	C	19	27	46	0	1	47	0	0
5	1673291	.	G	C	2	3	5	0	0	5	0	0
5	1707066	.	T	A	2	2	4	0	1	5	0	0
5	1709098	.	G	C	6	3	9	0	0	9	0	0
5	1869447	.	T	C	2	10	12	0	0	12	0	0
5	1869601	.	T	A	1	4	5	0	1	6	0	0
5	1950783	.	G	A	36	37	73	0	0	73	0	0
5	1952857	.	T	C	44	37	81	0	2	83	0	0
5	1952872	.	A	G	48	27	75	0	10	85	0	0
5	1952940	.	A	G	50	28	78	0	0	79	1	0
5	1953019	.	C	A	45	31	76	0	2	78	0	0
5	1955757	.	G	A	44	30	74	0	6	80	0	0
5	1957996	.	G	A	48	23	71	0	4	75	0	0
5	1958120	.	T	A	33	40	73	0	2	75	0	0
5	1962010	.	G	A	35	32	67	0	4	71	0	0
5	1989852	.	T	A	1	2	3	0	2	5	0	0
5	1989858	.	G	A	0	5	5	0	1	6	0	0
5	1990001	.	T	A	2	0	2	0	0	10	8	0
5	1990040	.	A	C	7	6	13	0	0	13	0	0
5	1997902	.	A	G	12	4	16	0	0	16	0	0
5	1997957	.	A	G	21	9	30	0	1	31	0	0
5	1997958	.	G	A	21	9	30	0	1	31	0	0
5	1998153	.	A	T	1	2	3	0	0	3	0	0
5	1998379	.	C	A	1	2	3	0	0	3	0	0
5	1999199	.	G	A	24	26	50	0	0	50	0	0
5	1999289	.	C	T	16	22	38	0	1	39	0	0
5	1999419	.	T	C	2	2	4	0	0	4	0	0
5	2047132	.	A	C	3	3	6	0	0	6	0	0
5	2047608	.	C	T	1	3	4	0	1	5	0	0
5	2067504	.	C	T	2	6	8	0	0	8	0	0
5	2067557	.	T	C	2	0	2	0	4	6	0	0
5	2067597	.	T	G	5	4	9	0	0	9	0	0
5	2067621	.	G	A	5	5	10	0	1	11	0	0
5	2067781	.	G	A	2	4	6	4	0	10	0	0
5	2067832	.	C	T	1	7	8	0	0	8	0	0
5	2067842	.	T	A	7	2	9	0	1	10	0	0
5	2069080	.	G	A	2	2	4	2	0	6	0	0
5	2074369	.	C	T	7	4	11	0	0	11	0	0
5	2086120	.	G	A	3	4	7	0	0	7	0	0
5	2086223	.	C	G	4	6	10	0	0	10	0	0
5	2095161	.	A	C	6	0	6	0	7	13	0	0
5	2099323	.	T	G	2	3	5	0	0	5	0	0
5	2106195	.	T	C	5	4	9	0	0	9	0	0
5	2111886	.	T	C	3	5	8	0	0	8	0	0
5	2242324	.	A	C	3	0	3	0	4	7	0	0
5	2242346	.	G	A	3	4	7	2	0	9	0	0
5	2242499	.	C	T	3	6	9	0	0	9	0	0
5	2242549	.	G	A	5	4	9	0	1	10	0	0
5	2242550	.	G	T	6	4	10	0	0	10	0	0
5	2242599	.	G	A	6	4	10	0	0	10	0	0
5	2242602	.	G	T	4	4	8	0	1	9	0	0
5	2242708	.	A	G	7	6	13	0	0	13	0	0
5	2242762	.	C	G	8	5	13	0	0	13	0	0
5	2242795	.	G	A	7	7	14	0	0	14	0	0
5	2242815	.	A	T	6	7	13	0	0	13	0	0
5	2243005	.	G	T	6	14	20	0	1	21	0	0
5	2248737	.	G	A	5	4	9	0	0	9	0	0
5	2248948	.	G	A	4	3	7	0	2	9	0	0
5	2410373	.	T	C	33	0	33	0	19	52	0	0
5	2410610	.	G	A	16	29	45	1	3	49	0	0
5	2413134	.	G	A	13	15	28	0	0	28	0	0
5	2413303	.	A	G	21	14	35	0	8	43	0	0
5	2413327	.	G	A	20	19	39	0	4	43	0	0
5	2419100	.	G	A	21	19	40	0	3	43	0	0
5	2420156	.	G	A	27	12	39	0	2	41	0	0
5	2426103	.	C	T	18	13	31	0	3	34	0	0
5	2434335	.	C	A	16	16	32	0	1	33	0	0
5	2434362	.	G	A	18	15	33	0	2	35	0	0
5	2434401	.	C	T	1	14	15	0	15	30	0	0
5	2434504	.	C	T	14	6	20	0	6	26	0	0
5	2434507	.	T	A	12	14	26	0	1	27	0	0
5	2435940	.	G	A	17	18	35	0	1	36	0	0
5	2451222	.	G	A	21	15	36	0	1	37	0	0
5	2451276	.	C	T	3	10	13	0	26	39	0	0
5	2451294	.	A	C	19	1	20	0	21	41	0	0
5	2454780	.	C	G	15	14	29	0	4	33	0	0
5	2454791	.	C	T	16	17	33	0	1	34	0	0
5	2457599	.	C	T	2	8	10	0	24	34	0	0
5	2460563	.	C	G	9	9	18	0	0	18	0	0
5	2461886	.	G	A	25	12	37	0	1	38	0	0
5	2463679	.	T	C	14	0	14	9	23	46	0	0
5	2467870	.	G	A	16	12	28	0	1	29	0	0
5	2495522	.	T	C	18	14	32	0	0	32	0	0
5	2498476	.	C	T	2	9	11	0	20	31	0	0
5	2509488	.	A	T	19	14	33	1	2	36	0	0
5	2509521	.	G	A	11	23	34	1	0	35	0	0
5	2521496	.	G	A	16	13	29	0	0	29	0	0
5	2658348	.	G	A	8	11	19	0	1	20	0	0
5	2681119	.	G	C	2	3	5	0	0	5	0	0
5	2686225	.	G	C	12	4	16	0	0	16	0	0
5	2689283	.	G	A	8	7	15	0	0	15	0	0
5	2689347	.	G	A	4	7	11	0	1	12	0	0
5	2689361	.	C	G	2	7	9	0	0	9	0	0
5	2693879	.	G	C	3	2	5	0	0	5	0	0
5	2693889	.	T	C	4	4	8	0	0	8	0	0
5	2696450	.	A	C	1	5	6	0	0	6	0	0
5	2696477	.	A	G	2	6	8	0	0	8	0	0
5	2709533	.	A	G	2	2	4	0	1	5	0	0
5	2713967	.	A	G	20	14	34	0	2	36	0	0
5	2714042	.	C	T	26	22	48	0	0	48	0	0
5	2714135	.	C	T	24	22	46	0	2	48	0	0
5	2714237	.	G	A	22	29	51	0	1	52	0	0
5	2714495	.	G	A	25	27	52	0	1	53	0	0
5	2714507	.	A	G	28	24	52	0	2	54	0	0
5	2714531	.	T	C	25	0	25	0	30	55	0	0
5	2716930	.	G	A	19	18	37	2	3	42	0	0
5	2716963	.	G	A	23	14	37	0	2	39	0	0
5	2717014	.	G	A	20	17	37	0	0	37	0	0
5	2717022	.	G	A	17	16	33	0	0	33	0	0
5	2717260	.	T	C	15	22	37	0	1	38	0	0
5	2717350	.	G	C	14	0	14	0	23	37	0	0
5	2717611	.	C	T	19	18	37	0	2	39	0	0
5	2717623	.	A	G	17	18	35	0	1	36	0	0
5	2717960	.	A	G	14	10	24	0	2	26	0	0
5	2718696	.	A	G	14	12	26	0	0	26	0	0
5	2718834	.	G	A	10	11	21	0	5	26	0	0
5	2720119	.	A	G	18	13	31	0	0	31	0	0
5	2721588	.	C	T	21	19	40	0	0	40	0	0
5	2742784	.	A	G	4	12	16	0	0	16	0	0
5	2744938	.	C	T	10	9	19	0	0	19	0	0
5	2744962	.	C	G	11	10	21	0	0	21	0	0
5	2744998	.	C	T	7	16	23	0	1	24	0	0
5	2745220	.	G	T	14	17	31	0	1	32	0	0
5	2750087	.	G	A	13	16	29	0	0	29	0	0
5	2750127	.	G	A	9	18	27	0	1	28	0	0
5	2750244	.	G	A	8	12	20	0	3	23	0	0
5	2750256	.	G	A	11	8	19	0	1	20	0	0
5	2751319	.	G	A	7	9	16	0	0	16	0	0
5	2751511	.	G	A	11	17	28	0	0	28	0	0
5	3118783	.	C	T	2	3	5	0	2	7	0	0
5	3118842	.	A	G	21	16	37	0	1	38	0	0
5	3185195	.	A	T	6	2	8	0	1	9	0	0
5	3185231	.	G	A	2	8	10	0	0	10	0	0
5	3192019	.	C	T	0	5	5	0	3	8	0	0
5	3194281	.	G	A	2	2	4	0	0	4	0	0
5	3197134	.	C	A	0	3	3	0	2	5	0	0
5	3363014	.	C	T	2	1	3	0	1	4	0	0
5	3363050	.	C	T	3	3	6	0	0	6	0	0
5	3430240	.	C	A	0	2	2	0	1	3	0	0
5	3502001	.	A	G	16	20	36	0	13	49	0	0
5	3544098	.	C	T	33	33	66	1	3	70	0	0
5	3544380	.	C	T	27	32	59	0	1	60	0	0
5	3544955	.	T	C	26	21	47	0	3	50	0	0
5	3545011	.	T	A	17	28	45	0	3	48	0	0
5	3545205	.	A	T	32	0	32	0	0	32	0	0
5	3568386	.	C	T	1	2	3	0	3	6	0	0
5	3568401	.	G	A	5	4	9	0	0	9	0	0
5	3568494	.	C	T	9	15	24	0	1	25	0	0
5	3568518	.	G	T	7	15	22	0	1	23	0	0
5	3573992	.	C	T	0	4	4	0	3	7	0	0
5	3611613	.	T	C	9	0	9	1	7	17	0	0
5	3611638	.	T	A	8	6	14	1	0	15	0	0
5	3611730	.	T	C	4	0	4	0	6	10	0	0
5	3611952	.	C	T	1	2	3	0	0	3	0	0
5	3612254	.	A	G	8	9	17	0	0	17	0	0
5	3618043	.	A	G	5	10	15	0	0	15	0	0
5	3670231	.	G	A	5	4	9	0	0	9	0	0
5	3891528	.	C	A	7	6	13	0	0	13	0	0
5	3892688	.	G	T	5	7	12	0	0	12	0	0
5	3898074	.	G	A	6	2	8	0	0	8	0	0
5	3901558	.	T	C	7	3	10	0	0	10	0	0
5	3901564	.	A	C	4	7	11	0	1	12	0	0
5	3914668	.	C	T	17	11	28	0	0	28	0	0
5	3914701	.	G	A	19	10	29	0	0	29	0	0
5	3927700	.	C	T	9	10	19	0	0	19	0	0
5	4009631	.	G	A	5	6	11	0	0	11	0	0
5	4009886	.	C	T	3	3	6	0	0	6	0	0
5	4009904	.	C	T	5	3	8	0	0	8	0	0
5	4010735	.	C	T	4	4	8	0	0	8	0	0
5	4024797	.	G	T	10	8	18	0	0	18	0	0
5	4024863	.	T	C	7	6	13	0	0	13	0	0
5	4037394	.	T	C	6	10	16	0	0	16	0	0
5	4037469	.	C	T	10	8	18	0	1	19	0	0
5	4040153	.	G	A	12	10	22	0	1	23	0	0
5	4041064	.	C	T	8	10	18	0	0	18	0	0
5	4041181	.	T	C	8	10	18	0	1	19	0	0
5	4041671	.	C	A	14	11	25	0	0	25	0	0
5	4048760	.	A	G	10	11	21	0	0	21	0	0
5	4048820	.	C	T	10	20	30	0	1	31	0	0
5	4051551	.	C	T	13	20	33	0	1	34	0	0
5	4051594	.	A	G	15	0	15	0	15	30	0	0
5	4054867	.	A	C	2	3	5	0	0	5	0	0
5	4054900	.	C	A	2	3	5	0	0	5	0	0
5	4055082	.	G	T	1	6	7	0	0	7	0	0
5	4132049	.	C	A	3	6	9	0	0	9	0	0
5	4142284	.	T	G	7	4	11	0	0	11	0	0
5	4142487	.	G	A	4	4	8	0	0	8	0	0
5	4142581	.	T	A	2	4	6	0	1	7	0	0
5	4142582	.	T	G	3	4	7	0	0	7	0	0
5	4253986	.	T	C	0	5	5	0	0	5	0	0
5	4254061	.	C	T	0	3	3	0	12	15	0	0
5	4260672	.	G	A	8	11	19	0	3	22	0	0
5	4263154	.	G	C	16	8	24	0	2	26	0	0
5	4263241	.	G	T	21	13	34	0	1	35	0	0
5	4263297	.	G	T	16	14	30	0	1	31	0	0
5	4263322	.	C	T	16	18	34	0	0	34	0	0
5	4265441	.	G	A	12	9	21	0	0	21	0	0
5	4265468	.	C	T	1	17	18	0	7	25	0	0
5	4269325	.	G	T	14	7	21	0	0	21	0	0
5	4273144	.	T	C	13	6	19	0	2	21	0	0
5	4273159	.	T	C	13	8	21	0	1	22	0	0
5	4273216	.	G	A	9	14	23	0	1	24	0	0
5	4278433	.	G	A	16	14	30	0	3	33	0	0
5	4292545	.	A	T	2	6	8	0	1	9	0	0
5	4292578	.	A	G	3	9	12	0	0	12	0	0
5	4296556	.	C	G	9	16	25	0	1	26	0	0
5	4308861	.	G	A	12	9	21	0	0	21	0	0
5	4342558	.	C	T	3	3	6	0	0	6	0	0
5	4342759	.	T	A	1	3	4	0	0	4	0	0
5	4373684	.	C	T	13	6	19	0	1	20	0	0
5	4387137	.	T	G	10	6	16	0	1	17	0	0
5	4436449	.	G	C	1	3	4	0	6	10	0	0
5	4445039	.	T	C	6	7	13	0	0	13	0	0
5	4448306	.	T	C	2	6	8	0	0	8	0	0
5	4469479	.	A	T	4	7	11	0	0	11	0	0
5	4469556	.	A	G	6	4	10	0	0	10	0	0
5	4469658	.	G	A	0	4	4	0	5	9	0	0
5	4469754	.	G	A	1	4	5	0	5	10	0	0
5	4470225	.	T	G	5	0	5	0	4	9	0	0
5	4482992	.	G	A	16	7	23	0	1	24	0	0
5	4493427	.	C	G	2	12	14	0	18	32	0	0
5	4523677	.	T	C	8	0	8	0	5	13	0	0
5	4528225	.	G	A	6	10	16	0	0	16	0	0
5	4532499	.	A	G	2	8	10	0	0	10	0	0
5	4533367	.	C	G	4	4	8	0	0	8	0	0
5	4547680	.	C	T	3	3	6	0	0	6	0	0
5	4729334	.	G	A	7	7	14	0	0	14	0	0
5	4733927	.	C	T	0	7	7	0	9	16	0	0
5	4931257	.	G	C	2	3	5	0	0	5	0	0
5	5171838	.	G	A	4	4	8	0	0	8	0	0
5	5171846	.	A	T	4	2	6	0	0	6	0	0
5	5171978	.	G	A	4	2	6	0	0	6	0	0
5	5217028	.	G	A	5	4	9	1	0	10	0	0
5	5308502	.	A	G	7	6	13	1	0	14	0	0
5	5313840	.	C	T	0	2	2	0	3	5	0	0
5	5321110	.	A	G	4	4	8	0	1	9	0	0
5	5321191	.	C	T	3	4	7	0	0	7	0	0
5	5325772	.	G	A	2	7	9	0	0	9	0	0
5	5325934	.	C	T	2	3	5	0	0	5	0	0
5	5399006	.	G	A	3	2	5	0	0	5	0	0
5	5399019	.	C	T	2	3	5	0	0	5	0	0
5	5406529	.	T	C	5	2	7	0	0	7	0	0
5	5434071	.	G	C	1	3	4	0	4	8	0	0
5	5498155	.	C	T	8	4	12	0	0	12	0	0
5	5498206	.	G	A	4	4	8	0	1	9	0	0
5	5619609	.	G	C	2	6	8	0	1	9	0	0
5	5619670	.	G	T	3	5	8	0	0	8	0	0
5	5619677	.	C	G	0	4	4	0	2	6	0	0
5	5619722	.	A	G	4	4	8	0	0	8	0	0
5	5622094	.	C	G	2	2	4	0	0	4	0	0
5	5628979	.	C	T	5	5	10	0	0	10	0	0
5	5632371	.	T	C	2	0	2	0	3	5	0	0
5	5642756	.	C	A	0	3	3	0	3	6	0	0
5	5669820	.	G	A	4	2	6	0	0	6	0	0
5	5696023	.	G	A	0	3	3	0	4	7	0	0
5	5696044	.	T	C	5	2	7	0	0	7	0	0
5	5708595	.	C	G	4	5	9	0	0	9	0	0
5	5720021	.	G	A	4	7	11	0	0	11	0	0
5	5731919	.	C	T	8	6	14	0	0	14	0	0
5	5733101	.	T	C	4	3	7	0	1	8	0	0
5	5733130	.	C	T	7	4	11	0	0	11	0	0
5	5733227	.	C	G	5	5	10	0	0	10	0	0
5	5736673	.	A	G	6	6	12	0	1	13	0	0
5	5736683	.	C	T	0	5	5	0	7	12	0	0
5	6858380	.	C	A	10	8	18	0	0	18	0	0
5	6858540	.	T	A	24	6	30	0	0	30	0	0
5	6858779	.	G	T	1	4	5	0	14	19	0	0
5	6863577	.	C	T	17	17	34	0	1	35	0	0
5	6863647	.	C	T	15	12	27	0	0	27	0	0
5	6863768	.	G	C	8	15	23	0	0	23	0	0
5	6863793	.	G	A	6	17	23	0	1	24	0	0
5	6863834	.	A	G	5	0	5	0	18	23	0	0
5	6863855	.	G	A	9	9	18	0	1	19	0	0
5	6864010	.	C	T	7	6	13	0	0	13	0	0
5	6864061	.	A	G	3	3	6	0	0	6	0	0
5	6864067	.	G	A	0	4	4	0	0	4	0	0
5	8035857	.	A	G	3	2	5	0	1	6	0	0
5	8417952	.	T	C	2	3	5	0	0	5	0	0
5	8537820	.	T	C	5	3	8	0	0	8	0	0
5	8537821	.	T	C	4	3	7	0	1	8	0	0
5	9444733	.	T	A	4	3	7	0	0	7	0	0
5	9986173	.	A	G	2	3	5	0	0	5	0	0
5	10046718	.	G	A	0	2	2	0	3	5	0	0
5	10046839	.	G	A	1	3	4	0	2	6	0	0
5	10053867	.	C	T	5	3	8	0	0	8	0	0
5	10056181	.	T	G	1	0	1	0	6	7	0	0
5	10084310	.	C	T	2	2	4	0	0	4	0	0
5	10766286	.	G	A	9	7	16	0	0	16	0	0
5	10766505	.	A	G	10	12	22	2	0	24	0	0
5	10766529	.	G	A	15	7	22	4	0	26	0	0
5	10766879	.	A	G	16	12	28	0	2	30	0	0
5	10767113	.	C	T	13	12	25	0	1	26	0	0
5	10767259	.	A	G	23	17	40	0	1	41	0	0
5	10767456	.	G	A	9	7	16	0	0	16	0	0
5	10767588	.	C	T	3	5	8	0	1	9	0	0
5	10768089	.	G	A	12	16	28	0	0	28	0	0
5	10768182	.	G	A	10	10	20	0	0	20	0	0
5	10768215	.	T	C	10	0	10	0	10	20	0	0
5	10946038	.	G	A	13	8	21	0	0	21	0	0
5	10946085	.	G	T	11	7	18	0	1	19	0	0
5	11244675	.	A	G	2	2	4	0	0	4	0	0
5	11504372	.	A	G	13	13	26	0	0	26	0	0
5	11507602	.	A	G	8	22	30	0	1	31	0	0
5	11573461	.	C	T	12	6	18	0	0	18	0	0
5	11812278	.	C	T	13	7	20	0	0	20	0	0
5	11816439	.	C	T	2	2	4	0	0	4	0	0
5	11816599	.	G	A	18	11	29	0	0	29	0	0
5	11824059	.	G	A	0	11	11	0	3	14	0	0
5	11824188	.	T	C	5	6	11	0	0	11	0	0
5	11826347	.	T	C	6	2	8	0	0	8	0	0
5	11836437	.	T	C	14	9	23	0	3	26	0	0
5	11864774	.	T	G	8	8	16	0	2	18	0	0
5	11869576	.	C	A	0	5	5	1	8	14	0	0
5	11900230	.	T	C	9	0	9	0	8	17	0	0
5	11905038	.	G	A	2	5	7	0	0	7	0	0
5	11905044	.	A	C	4	6	10	0	0	10	0	0
5	11905086	.	A	T	2	4	6	0	0	6	0	0
5	11905661	.	T	C	2	0	2	0	3	5	0	0
5	11905725	.	C	T	2	4	6	0	0	6	0	0
5	11905890	.	A	G	6	14	20	0	0	20	0	0
5	11905903	.	T	G	11	4	15	0	0	15	0	0
5	11917125	.	C	T	3	4	7	0	1	8	0	0
5	11917405	.	G	A	8	6	14	0	0	14	0	0
5	11917436	.	G	A	3	9	12	0	2	14	0	0
5	11917485	.	G	A	9	7	16	0	0	16	0	0
5	11917596	.	C	A	1	17	18	0	8	26	0	0
5	11933155	.	A	G	7	15	22	0	1	23	0	0
5	11935444	.	G	A	5	11	16	0	1	17	0	0
5	11937486	.	G	A	11	5	16	0	1	17	0	0
5	11937564	.	A	T	9	3	12	0	2	14	0	0
5	11941903	.	T	C	5	0	5	0	10	15	0	0
5	11943662	.	A	C	8	8	16	0	1	17	0	0
5	11943868	.	G	A	15	8	23	0	1	24	0	0
5	11943934	.	C	A	8	11	19	0	1	20	0	0
5	11943948	.	T	A	9	8	17	0	0	18	1	0
5	11943989	.	G	A	7	7	14	0	0	14	0	0
5	11944060	.	T	G	5	9	14	0	0	14	0	0
5	11949244	.	G	T	12	9	21	0	1	22	0	0
5	11959776	.	G	T	0	15	15	0	12	27	0	0
5	11959777	.	C	T	16	12	28	0	0	28	0	0
5	11959818	.	C	T	13	13	26	0	1	27	0	0
5	11959966	.	C	G	7	10	17	0	0	17	0	0
5	11959988	.	G	A	1	6	7	0	11	18	0	0
5	11983017	.	T	C	7	5	12	0	0	12	0	0
5	11983548	.	C	G	5	10	15	0	0	15	0	0
5	11983628	.	T	A	10	1	11	0	1	12	0	0
5	11984086	.	T	C	3	4	7	0	0	7	0	0
5	11984133	.	C	T	4	3	7	0	0	7	0	0
5	11984808	.	C	T	3	4	7	0	0	7	0	0
5	11984850	.	A	T	2	2	4	0	0	4	0	0
5	11985133	.	A	T	2	2	4	1	0	5	0	0
5	11985166	.	T	C	2	0	2	1	2	5	0	0
5	11985178	.	G	A	2	1	3	1	0	4	0	0
5	11985546	.	A	T	4	4	8	0	0	8	0	0
5	11985626	.	A	T	2	2	4	0	0	4	0	0
5	11986569	.	C	A	2	2	4	0	0	4	0	0
5	11986577	.	T	C	2	0	2	0	3	5	0	0
5	11986647	.	C	G	2	2	4	0	0	4	0	0
5	11986649	.	T	C	2	2	4	0	0	4	0	0
5	12041978	.	G	A	1	6	7	0	0	7	0	0
5	12100335	.	G	A	2	10	12	0	0	12	0	0
5	12113257	.	T	C	2	0	2	0	4	6	0	0
5	12115313	.	A	G	7	6	13	0	0	13	0	0
5	12136669	.	G	C	6	3	9	0	0	9	0	0
5	12144035	.	T	C	6	2	8	0	0	8	0	0
5	12146026	.	A	G	5	2	7	0	0	7	0	0
5	12168413	.	A	G	4	5	9	0	0	9	0	0
5	12170258	.	G	A	3	7	10	0	0	10	0	0
5	12284075	.	C	T	16	15	31	0	0	31	0	0
5	12285172	.	T	C	10	0	10	0	13	23	0	0
5	12285601	.	C	G	4	7	11	0	0	11	0	0
5	12288511	.	T	C	12	8	20	0	3	23	0	0
5	12288541	.	A	G	12	14	26	0	0	26	0	0
5	12297084	.	C	T	11	9	20	1	1	22	0	0
5	12322321	.	G	A	5	6	11	0	1	12	0	0
5	12357538	.	G	A	15	18	33	0	0	33	0	0
5	12357554	.	C	T	16	15	31	0	0	31	0	0
5	12454563	.	T	C	8	1	9	0	15	24	0	0
5	12503554	.	G	A	9	12	21	0	0	21	0	0
5	12524938	.	A	G	11	9	20	1	1	22	0	0
5	12530423	.	G	T	6	7	13	0	1	14	0	0
5	12530425	.	C	A	6	7	13	0	1	14	0	0
5	12533197	.	C	T	9	5	14	0	0	14	0	0
5	12535785	.	A	T	3	5	8	0	1	9	0	0
5	12549258	.	C	T	10	4	14	0	0	14	0	0
5	12549326	.	C	T	6	7	13	0	2	15	0	0
5	12549776	.	G	T	4	5	9	0	1	10	0	0
5	12549807	.	A	G	5	6	11	0	0	11	0	0
5	12549981	.	G	T	5	5	10	0	0	10	0	0
5	12553935	.	C	T	0	3	3	0	8	11	0	0
5	12558090	.	C	T	4	3	7	0	1	8	0	0
5	12613409	.	C	A	4	3	7	0	0	7	0	0
5	12618451	.	G	A	1	3	4	0	0	4	0	0
5	12645971	.	G	A	5	3	8	0	0	8	0	0
5	12648074	.	G	A	3	1	4	0	2	6	0	0
5	12664278	.	G	A	3	5	8	0	0	8	0	0
5	12664330	.	T	C	2	3	5	0	0	5	0	0
5	12724121	.	C	T	8	6	14	0	0	14	0	0
5	12724224	.	G	A	7	3	10	0	1	11	0	0
5	12724249	.	A	C	5	3	8	0	0	8	0	0
5	12724307	.	A	G	4	8	12	0	0	12	0	0
5	12724412	.	A	G	1	1	2	0	1	3	0	0
5	12724450	.	C	T	0	7	7	0	6	13	0	0
5	12724505	.	C	A	13	16	29	0	1	30	0	0
5	12724518	.	G	C	15	1	16	0	14	30	0	0
5	12724567	.	A	G	19	14	33	0	4	37	0	0
5	12724694	.	C	T	0	11	11	0	13	24	0	0
5	12725930	.	G	A	21	23	44	0	3	47	0	0
5	12726842	.	A	G	23	15	38	0	0	38	0	0
5	12729397	.	C	T	12	12	24	0	1	25	0	0
5	12732247	.	C	T	16	7	23	0	0	23	0	0
5	12734883	.	G	T	11	21	32	0	0	32	0	0
5	12734910	.	T	C	9	20	29	0	1	30	0	0
5	12743011	.	C	A	6	10	16	0	0	16	0	0
5	12837013	.	T	A	2	2	4	0	0	4	0	0
5	12837064	.	G	A	9	6	15	0	2	17	0	0
5	12859258	.	T	C	12	9	21	0	0	21	0	0
5	12865136	.	A	G	7	0	7	0	10	17	0	0
5	12903862	.	G	C	5	4	9	0	0	9	0	0
5	12905285	.	C	A	1	2	3	0	0	3	0	0
5	12905466	.	C	T	1	2	3	0	0	3	0	0
5	12905911	.	A	C	3	2	5	0	0	5	0	0
5	12906014	.	C	T	2	2	4	0	1	5	0	0
5	12906273	.	C	T	1	4	5	0	1	6	0	0
5	12908828	.	C	A	10	5	15	0	0	15	0	0
5	12926507	.	C	A	5	5	10	0	0	10	0	0
5	12935223	.	A	G	2	5	7	0	0	7	0	0
5	12956918	.	T	C	11	3	14	0	0	14	0	0
5	12956960	.	C	T	10	5	15	0	1	16	0	0
5	12975297	.	G	A	1	9	10	0	8	18	0	0
5	12975532	.	C	T	4	11	15	0	0	15	0	0
5	13037199	.	C	T	2	5	7	0	6	13	0	0
5	13037203	.	C	T	0	6	6	0	5	11	0	0
5	13037723	.	A	G	6	5	11	0	0	11	0	0
5	13037939	.	T	G	10	12	22	0	0	22	0	0
5	13037967	.	G	A	6	16	22	0	0	22	0	0
5	13037998	.	A	G	7	15	22	0	0	22	0	0
5	13086495	.	A	T	1	4	5	0	0	5	0	0
5	13105070	.	C	A	5	32	37	0	23	60	0	0
5	13112979	.	G	A	17	30	47	0	0	47	0	0
5	13167048	.	A	T	23	21	44	0	2	46	0	0
5	13214637	.	C	G	11	6	17	0	0	17	0	0
5	13214802	.	C	G	5	6	11	0	1	12	0	0
5	13223062	.	G	A	5	4	9	0	2	11	0	0
5	13227057	.	C	T	1	5	6	0	3	9	0	0
5	13229024	.	C	A	5	5	10	0	0	10	0	0
5	13229846	.	G	T	3	5	8	0	1	9	0	0
5	13235157	.	G	C	2	7	9	0	0	9	0	0
5	13237809	.	G	A	2	3	5	0	0	5	0	0
5	13239172	.	A	G	6	7	13	0	0	13	0	0
5	13239412	.	A	G	5	3	8	0	0	8	0	0
5	13251737	.	C	A	0	3	3	0	5	8	0	0
5	13309215	.	C	T	8	6	14	0	1	15	0	0
5	13309273	.	C	T	19	8	27	0	0	27	0	0
5	13309309	.	G	A	18	5	23	0	1	24	0	0
5	13309402	.	A	G	14	11	25	0	2	27	0	0
5	13309435	.	A	T	11	16	27	0	1	28	0	0
5	13309522	.	G	A	14	12	26	1	0	27	0	0
5	13312671	.	A	T	20	11	31	0	2	33	0	0
5	13312746	.	G	A	13	13	26	0	0	26	0	0
5	13315490	.	G	C	22	14	36	0	1	37	0	0
5	13315526	.	T	C	12	11	23	0	2	25	0	0
5	13315603	.	A	C	17	11	28	0	0	28	0	0
5	13326851	.	C	T	3	4	7	0	1	8	0	0
5	13326920	.	G	A	3	4	7	0	0	7	0	0
5	13329785	.	G	C	4	4	8	0	0	8	0	0
5	13332930	.	A	G	5	5	10	0	0	10	0	0
5	13335291	.	C	T	4	2	6	0	0	6	0	0
5	13335333	.	G	A	5	4	9	0	0	9	0	0
5	13335373	.	G	T	1	6	7	0	5	12	0	0
5	13335423	.	C	T	5	7	12	0	0	12	0	0
5	13337803	.	C	T	8	14	22	0	0	22	0	0
5	13337883	.	T	A	10	17	27	0	0	28	1	0
5	13338441	.	C	T	2	16	18	0	17	35	0	0
5	13338762	.	A	T	13	13	26	0	0	26	0	0
5	13339038	.	G	C	16	18	34	2	10	47	1	0
5	13385916	.	T	A	5	2	7	0	0	7	0	0
5	13415128	.	A	T	2	3	5	0	0	5	0	0
5	13415131	.	A	G	2	0	2	0	3	5	0	0
5	13419418	.	T	C	2	2	4	0	0	4	0	0
5	13445433	.	C	T	3	6	9	0	0	9	0	0
5	13445511	.	A	G	8	5	13	0	1	14	0	0
5	13461551	.	A	G	7	0	7	0	7	14	0	0
5	13465095	.	T	C	5	3	8	0	0	8	0	0
5	13468108	.	G	T	2	8	10	0	2	12	0	0
5	13468172	.	C	T	7	7	14	0	1	15	0	0
5	13468440	.	T	A	5	4	9	0	0	9	0	0
5	13468574	.	G	A	4	4	8	0	0	8	0	0
5	13468655	.	G	A	2	4	6	0	0	6	0	0
5	13468656	.	A	T	2	3	5	0	1	6	0	0
5	13472279	.	C	T	7	7	14	0	0	14	0	0
5	13472295	.	G	T	6	7	13	0	1	14	0	0
5	13473094	.	T	G	5	3	8	0	0	8	0	0
5	13473418	.	C	T	3	3	6	0	0	6	0	0
5	13473436	.	T	C	1	2	3	0	0	3	0	0
5	13501228	.	T	C	1	4	5	0	2	7	0	0
5	13501288	.	C	A	2	5	7	0	1	8	0	0
5	13501336	.	C	T	6	2	8	0	0	8	0	0
5	13501345	.	C	T	6	6	12	0	0	12	0	0
5	13539403	.	A	G	6	0	6	0	9	15	0	0
5	13539493	.	A	G	6	0	6	0	8	14	0	0
5	13540689	.	C	T	13	9	22	0	0	22	0	0
5	13540738	.	C	T	7	8	15	0	1	16	0	0
5	13540846	.	T	A	12	6	18	0	0	18	0	0
5	13557614	.	T	C	1	2	3	0	1	4	0	0
5	13614438	.	T	A	1	2	3	0	0	3	0	0
5	13614896	.	A	T	1	2	3	0	0	3	0	0
5	13643325	.	G	A	7	16	23	0	1	24	0	0
5	13643411	.	C	T	2	26	28	0	18	46	0	0
5	13643824	.	G	A	15	8	23	0	0	23	0	0
5	13644126	.	A	T	21	16	37	0	1	38	0	0
5	13644185	.	T	G	20	14	34	0	1	35	0	0
5	13644189	.	T	G	20	12	32	0	1	33	0	0
5	13644227	.	A	G	18	13	31	4	2	37	0	0
5	13644256	.	A	T	18	10	28	6	0	34	0	0
5	13644581	.	T	G	20	20	40	0	2	42	0	0
5	13644602	.	T	A	19	13	32	0	2	35	1	0
5	13644781	.	C	T	12	11	23	0	2	25	0	0
5	13644797	.	A	G	14	9	23	0	0	23	0	0
5	13645047	.	C	G	17	18	35	0	0	35	0	0
5	13645746	.	A	G	21	16	37	0	3	40	0	0
5	13645885	.	T	C	12	15	27	0	1	28	0	0
5	13649518	.	C	T	18	19	37	0	3	41	1	0
5	13652410	.	T	C	8	26	34	0	2	36	0	0
5	13671624	.	G	T	15	11	26	0	0	26	0	0
5	13671631	.	A	C	11	14	25	0	1	26	0	0
5	13671899	.	C	G	16	18	34	0	1	35	0	0
5	13672004	.	C	T	4	22	26	0	26	52	0	0
5	13672211	.	C	T	24	31	55	0	2	57	0	0
5	13672232	.	C	T	27	21	48	0	2	50	0	0
5	13673016	.	C	G	1	23	24	0	14	38	0	0
5	13684132	.	A	G	36	20	56	0	3	59	0	0
5	13684502	.	C	A	10	27	37	0	23	60	0	0
5	13766188	.	A	T	11	9	20	0	1	21	0	0
5	13766276	.	A	G	8	18	26	0	1	27	0	0
5	13772666	.	T	C	17	18	35	1	4	40	0	0
5	13778659	.	G	T	16	27	43	0	1	44	0	0
5	13778663	.	C	T	15	28	43	0	0	43	0	0
5	13782325	.	T	C	21	14	35	0	1	36	0	0
5	13782786	.	C	A	16	7	23	0	2	25	0	0
5	13782936	.	A	T	3	4	7	0	0	7	0	0
5	13783341	.	G	T	1	2	3	0	0	3	0	0
5	13783377	.	A	G	1	3	4	0	0	4	0	0
5	13783516	.	A	C	8	15	23	0	0	23	0	0
5	13784111	.	G	T	7	3	10	0	2	12	0	0
5	13784243	.	T	A	11	9	20	0	3	23	0	0
5	13784486	.	G	T	8	11	19	0	1	20	0	0
5	13784559	.	T	A	8	10	18	3	0	21	0	0
5	13784629	.	A	G	0	0	0	1	4	12	7	0
5	13784914	.	G	T	5	6	11	0	0	11	0	0
5	13784916	.	C	T	5	5	10	0	1	11	0	0
5	13785289	.	T	C	13	0	13	5	8	26	0	0
5	13785304	.	A	G	12	7	19	5	0	24	0	0
5	13785326	.	A	G	10	10	20	5	1	26	0	0
5	13785441	.	A	G	14	8	22	0	0	22	0	0
5	13785485	.	T	C	14	0	14	0	7	21	0	0
5	13785490	.	G	A	11	9	20	0	1	21	0	0
5	13785522	.	T	C	8	9	17	0	5	22	0	0
5	13785559	.	G	A	6	6	12	1	0	13	0	0
5	13785563	.	T	C	5	3	8	0	2	10	0	0
5	13785735	.	C	T	10	13	23	0	1	24	0	0
5	13791984	.	G	A	23	11	34	0	1	35	0	0
5	13793333	.	T	C	23	6	29	0	0	29	0	0
5	13799613	.	G	A	12	13	25	0	0	25	0	0
5	13799635	.	C	T	10	13	23	0	2	25	0	0
5	13799704	.	G	A	17	19	36	0	0	36	0	0
5	13800062	.	C	T	13	11	24	0	0	24	0	0
5	13800170	.	C	A	6	10	16	0	1	17	0	0
5	13803918	.	C	A	0	8	8	0	12	20	0	0
5	13803960	.	C	T	9	11	20	0	0	20	0	0
5	13820304	.	C	T	11	16	27	0	0	27	0	0
5	13820457	.	G	A	9	13	22	0	0	22	0	0
5	13835410	.	T	A	2	5	7	0	0	7	0	0
5	13835462	.	T	G	6	4	10	0	1	11	0	0
5	13906875	.	C	A	1	2	3	0	0	3	0	0
5	13992582	.	T	C	1	2	3	0	0	3	0	0
5	14306793	.	G	T	12	22	34	0	0	34	0	0
5	14307459	.	G	A	10	12	22	0	0	22	0	0
5	14307720	.	C	T	7	13	20	0	1	21	0	0
5	14308394	.	A	C	11	0	11	0	0	11	0	0
5	14308480	.	A	G	4	5	9	0	0	9	0	0
5	14308481	.	A	C	3	5	8	0	1	9	0	0
5	14308710	.	A	G	12	17	29	0	1	30	0	0
5	14308773	.	G	A	17	7	24	0	0	24	0	0
5	14308792	.	C	A	15	9	24	0	1	25	0	0
5	14309073	.	T	C	11	9	20	0	0	20	0	0
5	14309219	.	A	G	3	9	12	0	1	13	0	0
5	14309334	.	C	T	1	5	6	0	18	24	0	0
5	14309661	.	C	T	3	4	7	0	0	7	0	0
5	14310874	.	T	A	26	13	39	0	2	41	0	0
5	14312030	.	C	T	0	14	14	0	19	33	0	0
5	14312091	.	G	A	8	14	22	0	0	22	0	0
5	14321243	.	G	A	6	13	19	0	0	19	0	0
5	14321336	.	G	A	7	10	17	0	0	17	0	0
5	14321393	.	C	T	10	10	20	0	0	20	0	0
5	14321438	.	A	G	10	10	20	0	0	20	0	0
5	14321488	.	G	A	5	3	8	0	0	8	0	0
5	14322022	.	C	T	11	9	20	0	0	20	0	0
5	14322037	.	C	T	11	11	22	0	1	23	0	0
5	14322212	.	C	T	12	11	23	0	1	24	0	0
5	14322269	.	T	C	9	11	20	0	0	20	0	0
5	14322433	.	A	T	14	8	22	0	3	25	0	0
5	14322647	.	C	T	8	10	18	0	0	18	0	0
5	14322898	.	T	G	12	16	28	0	0	28	0	0
5	14323082	.	A	T	9	13	22	0	0	22	0	0
5	14323934	.	T	C	8	6	14	0	0	14	0	0
5	14375330	.	T	A	5	5	10	0	0	10	0	0
5	14375529	.	A	G	12	18	30	0	0	30	0	0
5	14375598	.	A	G	16	15	31	0	0	31	0	0
5	14375623	.	A	G	16	17	33	0	2	35	0	0
5	14375881	.	T	C	13	18	31	1	0	32	0	0
5	14376155	.	A	G	18	14	32	0	2	34	0	0
5	14380632	.	C	T	17	14	31	0	1	32	0	0
5	14382534	.	C	G	12	18	30	0	0	30	0	0
5	14383193	.	G	A	17	10	27	0	2	29	0	0
5	14386045	.	T	A	16	9	25	0	1	26	0	0
5	14386277	.	A	G	12	12	24	0	2	26	0	0
5	14387338	.	G	A	15	10	25	0	0	25	0	0
5	14394466	.	A	G	22	22	44	0	2	46	0	0
5	14394515	.	G	A	24	18	42	0	0	42	0	0
5	14394872	.	T	A	15	14	29	0	1	30	0	0
5	14395430	.	G	A	19	14	33	0	0	33	0	0
5	14395664	.	G	A	21	24	45	0	1	46	0	0
5	14395697	.	G	A	20	18	38	0	1	39	0	0
5	14396030	.	C	T	9	8	17	0	1	18	0	0
5	14396438	.	C	G	1	19	20	0	18	38	0	0
5	14396609	.	T	C	10	6	16	0	0	16	0	0
5	14396783	.	C	T	15	14	29	0	1	30	0	0
5	14396876	.	C	T	13	12	25	0	2	27	0	0
5	14396893	.	G	T	14	13	27	0	0	27	0	0
5	14397231	.	T	A	13	9	22	0	0	22	0	0
5	14397232	.	G	T	13	9	22	0	0	22	0	0
5	14398364	.	C	T	14	8	22	0	0	22	0	0
5	14398876	.	A	T	6	6	12	0	0	12	0	0
5	14399766	.	G	C	9	5	14	0	2	16	0	0
5	14402108	.	C	T	7	10	17	0	1	18	0	0
5	14402144	.	C	T	0	5	5	0	11	16	0	0
5	14402848	.	C	T	7	8	15	0	2	17	0	0
5	14413810	.	A	G	5	6	11	0	0	11	0	0
5	14442388	.	C	T	1	4	5	0	6	11	0	0
5	14529221	.	C	T	2	8	10	0	23	33	0	0
5	14529450	.	C	T	15	11	26	0	1	27	0	0
5	14530091	.	T	G	16	11	27	0	2	29	0	0
5	14530346	.	C	T	7	6	13	0	0	13	0	0
5	14530457	.	G	A	13	9	22	0	0	22	0	0
5	14530511	.	T	C	12	14	26	0	0	26	0	0
5	14530571	.	A	G	9	7	16	0	0	16	0	0
5	14530595	.	C	T	10	7	17	0	0	17	0	0
5	14533937	.	C	T	0	11	11	0	16	27	0	0
5	14534025	.	G	A	12	12	24	0	1	25	0	0
5	14543331	.	G	A	15	19	34	0	1	35	0	0
5	14545814	.	C	T	0	7	7	0	21	28	0	0
5	14560993	.	G	A	9	9	18	0	1	19	0	0
5	14564831	.	G	A	9	6	15	0	0	15	0	0
5	14647979	.	T	C	16	7	23	0	1	24	0	0
5	14648272	.	G	A	2	3	5	0	0	5	0	0
5	15357116	.	A	G	29	7	36	0	0	36	0	0
5	15357517	.	A	G	7	8	15	0	0	15	0	0
5	15394285	.	G	T	11	10	21	0	0	21	0	0
5	15394354	.	G	A	18	11	29	0	0	29	0	0
5	15394357	.	A	G	16	12	28	0	0	28	0	0
5	15394396	.	C	T	3	10	13	0	12	25	0	0
5	15416836	.	T	A	8	7	15	0	0	15	0	0
5	15809480	.	A	G	5	1	6	0	2	8	0	0
5	15809483	.	A	G	3	4	7	0	0	7	0	0
5	15809671	.	G	T	1	2	3	0	0	3	0	0
5	15809887	.	A	G	7	2	9	0	0	9	0	0
5	15809903	.	C	T	2	5	7	0	0	7	0	0
5	15810282	.	A	G	7	0	7	1	4	12	0	0
5	16123097	.	A	T	2	3	5	0	0	5	0	0
5	16124919	.	C	T	3	3	6	0	0	6	0	0
5	16125734	.	C	T	1	4	5	0	0	5	0	0
5	16126203	.	C	T	2	4	6	0	0	6	0	0
5	16126392	.	G	A	3	3	6	0	0	6	0	0
5	16126440	.	T	C	2	4	6	0	0	6	0	0
5	16126762	.	C	A	2	4	6	0	0	6	0	0
5	16128798	.	C	T	6	6	12	0	0	12	0	0
5	16128841	.	G	A	7	3	10	0	0	10	0	0
5	16134766	.	C	T	1	5	6	0	5	11	0	0
5	16138840	.	G	C	3	5	8	0	0	8	0	0
5	16139401	.	G	A	3	4	7	0	0	7	0	0
5	16139451	.	A	G	3	6	9	0	1	10	0	0
5	16139511	.	C	T	15	4	19	0	2	21	0	0
5	16139521	.	G	T	14	3	17	0	1	18	0	0
5	16139556	.	T	C	2	0	2	0	6	8	0	0
5	16218707	.	C	G	0	1	1	0	2	3	0	0
5	16331902	.	G	C	1	2	3	0	0	3	0	0
5	16331918	.	G	A	1	3	4	0	0	4	0	0
5	16360394	.	G	A	3	3	6	0	0	6	0	0
5	16405527	.	T	C	1	2	3	0	0	3	0	0
5	16581204	.	A	C	1	2	3	0	0	3	0	0
5	16718993	.	G	C	3	7	10	0	0	10	0	0
5	16720830	.	G	A	11	14	25	0	0	25	0	0
5	16800437	.	A	G	15	7	22	0	0	22	0	0
5	16800710	.	T	C	13	0	13	0	16	29	0	0
5	16800955	.	C	T	2	10	12	0	11	23	0	0
5	16815222	.	C	G	15	12	27	0	1	28	0	0
5	16818828	.	G	A	21	9	30	0	1	31	0	0
5	16818858	.	T	G	18	13	31	0	1	32	0	0
5	16833631	.	A	G	10	5	15	0	2	17	0	0
5	16916446	.	T	C	13	9	22	0	0	22	0	0
5	16916476	.	G	A	12	8	20	0	0	20	0	0
5	16916575	.	T	C	18	8	26	0	2	28	0	0
5	16928099	.	T	C	11	0	11	0	9	20	0	0
5	16956501	.	G	A	10	13	23	0	0	23	0	0
5	16956615	.	C	T	11	11	22	0	0	22	0	0
5	16982624	.	G	A	11	18	29	0	0	29	0	0
5	16983206	.	C	T	9	9	18	0	1	19	0	0
5	17624676	.	G	A	1	6	7	0	6	13	0	0
5	17624944	.	G	T	4	3	7	0	0	7	0	0
5	17727417	.	C	A	9	17	26	0	1	27	0	0
5	17727421	.	A	C	9	15	24	0	4	28	0	0
5	17731592	.	C	A	6	10	16	0	5	21	0	0
5	17738720	.	G	A	0	14	14	0	11	25	0	0
5	17751119	.	G	A	10	7	17	0	1	18	0	0
5	17751681	.	G	A	0	10	10	0	16	26	0	0
5	17751894	.	A	T	13	11	24	0	5	29	0	0
5	17751939	.	A	G	22	9	31	0	1	32	0	0
5	17752545	.	A	G	15	17	32	0	1	33	0	0
5	17752702	.	C	T	4	11	15	0	1	16	0	0
5	17752778	.	A	T	6	6	12	0	0	12	0	0
5	17753214	.	G	A	4	3	7	0	5	12	0	0
5	17753216	.	G	A	5	2	7	0	5	12	0	0
5	17753529	.	A	T	17	11	28	0	0	28	0	0
5	17782339	.	A	T	1	3	4	0	0	4	0	0
5	17812792	.	G	C	2	3	5	0	0	5	0	0
5	17813181	.	C	T	3	2	5	0	1	7	1	0
5	17848892	.	G	T	1	2	3	0	0	3	0	0
5	17848898	.	G	C	1	3	4	0	0	4	0	0
5	17881995	.	A	T	4	2	6	0	0	6	0	0
5	17882282	.	T	A	7	5	12	0	1	13	0	0
5	17882291	.	C	T	7	5	12	0	1	13	0	0
5	17882438	.	G	A	5	3	8	0	0	8	0	0
5	17882454	.	G	A	5	4	9	0	0	9	0	0
5	17885194	.	T	C	3	0	3	0	10	13	0	0
5	17885287	.	A	C	7	6	13	0	0	13	0	0
5	17885863	.	G	A	5	6	11	0	1	12	0	0
5	17885902	.	G	A	6	6	12	0	0	12	0	0
5	17885920	.	C	T	4	7	11	0	1	12	0	0
5	17885995	.	A	G	6	6	12	0	0	12	0	0
5	17886028	.	T	G	3	8	11	0	0	11	0	0
5	17886039	.	G	T	3	6	9	0	3	12	0	0
5	17891709	.	G	A	6	2	8	0	1	9	0	0
5	18827368	.	T	C	12	4	16	0	1	17	0	0
5	19008334	.	A	G	31	2	33	2	6	41	0	0
5	19008335	.	A	G	22	10	32	2	6	40	0	0
5	20283504	.	T	A	2	3	5	0	0	5	0	0
5	20416565	.	G	C	1	7	8	0	7	15	0	0
5	20416618	.	A	T	11	7	18	0	0	18	0	0
5	20416958	.	T	C	10	8	18	0	0	18	0	0
5	20417018	.	A	C	8	6	14	0	0	14	0	0
5	20417099	.	T	C	7	7	14	1	0	15	0	0
5	20417180	.	G	A	3	5	8	0	14	22	0	0
5	20417274	.	G	A	0	12	12	0	5	17	0	0
5	20417399	.	G	C	6	6	12	0	0	12	0	0
5	20417405	.	C	G	5	6	11	0	0	11	0	0
5	20417515	.	T	C	6	4	10	0	0	10	0	0
5	20417631	.	T	G	13	0	13	0	8	21	0	0
5	20418958	.	A	T	6	3	9	0	0	9	0	0
5	20419008	.	A	T	8	6	14	0	0	14	0	0
5	20419087	.	A	G	9	5	14	0	1	15	0	0
5	20419563	.	A	C	7	4	11	0	2	13	0	0
5	20419613	.	G	A	4	6	10	1	0	11	0	0
5	20443918	.	T	A	1	4	5	0	0	5	0	0
5	20443949	.	A	G	5	3	8	0	2	10	0	0
5	20444017	.	G	T	10	10	20	0	2	22	0	0
5	20444216	.	G	C	21	20	41	0	1	42	0	0
5	20445065	.	G	A	15	14	29	0	1	30	0	0
5	20445985	.	A	T	18	22	40	0	1	42	1	0
5	20446021	.	T	A	8	11	19	0	2	21	0	0
5	20457291	.	T	C	9	13	22	0	1	23	0	0
5	20457390	.	C	T	12	11	23	0	0	23	0	0
5	20467641	.	A	G	11	13	24	0	2	26	0	0
5	20471875	.	G	C	8	18	26	0	4	30	0	0
5	20473812	.	A	G	11	0	11	0	16	27	0	0
5	20473818	.	G	A	1	14	15	0	11	26	0	0
5	20474076	.	A	G	11	9	20	0	0	20	0	0
5	20475730	.	A	G	11	12	23	0	2	25	0	0
5	20477419	.	T	C	13	22	35	0	1	36	0	0
5	20479921	.	C	A	6	12	18	0	2	20	0	0
5	20479990	.	A	G	7	12	19	0	0	19	0	0
5	20480036	.	A	T	5	8	13	0	0	13	0	0
5	20480369	.	T	C	5	5	10	0	0	10	0	0
5	20480401	.	G	A	6	9	15	0	0	15	0	0
5	20480758	.	T	A	11	12	23	0	0	23	0	0
5	20481132	.	G	A	7	10	17	0	2	19	0	0
5	20485754	.	G	A	4	1	5	0	0	5	0	0
5	20485769	.	T	C	3	5	8	0	0	8	0	0
5	20485896	.	T	C	2	2	4	0	0	4	0	0
5	20485912	.	G	T	3	2	5	0	0	5	0	0
5	20485965	.	C	T	2	4	6	0	0	6	0	0
5	20486338	.	G	A	2	2	4	0	0	4	0	0
5	20486442	.	T	A	2	5	7	0	1	8	0	0
5	20486444	.	A	T	2	6	8	0	0	8	0	0
5	20486485	.	G	A	2	4	6	0	0	6	0	0
5	20486727	.	G	T	4	8	12	0	0	12	0	0
5	20486746	.	A	G	2	6	8	0	0	8	0	0
5	20486866	.	T	C	6	4	10	0	0	10	0	0
5	20487328	.	G	A	6	5	11	0	1	12	0	0
5	20487379	.	G	A	4	4	8	0	0	9	1	0
5	20487433	.	C	T	7	5	12	0	0	12	0	0
5	20487490	.	A	G	5	2	7	0	1	8	0	0
5	20590460	.	T	C	1	2	3	0	0	3	0	0
5	20627301	.	G	A	3	4	7	0	0	7	0	0
5	20627337	.	G	A	2	2	4	0	0	4	0	0
5	20627556	.	G	T	2	5	7	0	0	7	0	0
5	20627569	.	A	G	4	5	9	0	0	9	0	0
5	20627609	.	G	A	2	4	6	0	0	6	0	0
5	20627917	.	T	G	4	4	8	0	0	8	0	0
5	20628036	.	G	A	4	3	7	0	0	7	0	0
5	20638976	.	A	T	4	2	6	0	0	6	0	0
5	20647434	.	A	G	3	5	8	0	1	9	0	0
5	20678070	.	T	C	3	8	11	0	1	12	0	0
5	20678159	.	T	C	4	0	4	0	7	11	0	0
5	20787190	.	T	C	6	3	9	0	0	9	0	0
5	20894016	.	C	A	1	2	3	0	0	3	0	0
5	20933321	.	C	A	4	42	46	0	2	49	1	0
5	20933332	.	T	C	6	1	7	6	44	57	0	0
5	21853050	.	C	A	5	3	8	0	0	8	0	0
5	22012452	.	T	C	7	2	9	0	1	10	0	0
5	22012459	.	T	C	6	3	9	0	1	10	0	0
5	22106347	.	A	G	7	6	13	0	0	13	0	0
5	22873075	.	C	T	8	0	8	0	0	8	0	0
5	23370824	.	T	C	13	20	33	0	0	33	0	0
5	23393032	.	T	C	18	5	23	0	1	24	0	0
5	23397221	.	T	C	22	18	40	0	1	41	0	0
5	23574916	.	T	C	1	5	6	0	0	6	0	0
5	24163098	.	A	G	4	4	8	0	0	8	0	0
5	24163099	.	A	G	3	5	8	0	0	8	0	0
5	24816449	.	C	A	0	3	3	0	0	3	0	0
5	24818523	.	T	C	7	7	14	0	2	16	0	0
5	24818529	.	T	C	11	4	15	0	2	17	0	0
5	24818564	.	T	C	8	8	16	0	1	17	0	0
5	24818941	.	T	C	6	5	11	0	0	11	0	0
5	24818957	.	T	C	3	2	5	0	1	6	0	0
5	25610274	.	T	C	1	0	1	0	2	3	0	0
5	25726927	.	T	C	1	6	7	0	0	7	0	0
5	26062582	.	A	G	9	10	19	0	1	20	0	0
5	26168782	.	G	A	1	5	6	0	1	7	0	0
5	26733856	.	C	G	3	0	3	0	3	6	0	0
5	26733857	.	C	G	3	0	3	0	3	6	0	0
5	29001096	.	A	G	5	4	9	0	0	9	0	0
5	29572465	.	T	C	2	2	4	0	0	4	0	0
5	29573455	.	T	C	1	2	3	0	0	3	0	0
5	29573468	.	T	C	1	2	3	0	0	3	0	0
5	30606225	.	A	G	1	3	4	0	0	4	0	0
5	30805143	.	G	A	2	2	4	0	0	4	0	0
5	31432387	.	A	G	2	4	6	0	0	6	0	0
5	32796788	.	T	C	1	3	4	0	0	4	0	0
5	33329786	.	A	G	5	7	12	0	0	12	0	0
5	34529691	.	A	G	2	2	4	0	0	4	0	0
5	35124435	.	T	C	11	0	11	0	5	16	0	0
5	35124479	.	C	T	1	6	7	0	8	15	0	0
5	35124859	.	C	T	7	11	18	0	0	18	0	0
5	35124939	.	G	A	4	5	9	0	0	9	0	0
5	35125414	.	C	T	0	5	5	0	5	10	0	0
5	35125423	.	C	T	5	7	12	0	0	12	0	0
5	35125882	.	G	A	7	7	14	0	0	14	0	0
5	35125883	.	A	T	7	7	14	0	0	14	0	0
5	35129861	.	C	A	4	4	8	0	0	8	0	0
5	35135687	.	G	A	10	6	16	0	0	16	0	0
5	35137384	.	A	G	8	6	14	0	2	16	0	0
5	35137621	.	C	T	1	3	4	0	11	15	0	0
5	35178640	.	G	A	5	5	10	0	0	10	0	0
5	35200648	.	T	G	2	8	10	0	1	11	0	0
5	35200718	.	G	T	1	4	5	0	0	5	0	0
5	35202876	.	A	T	8	6	14	0	1	15	0	0
5	35202958	.	G	A	8	7	15	0	0	16	1	0
5	35202959	.	A	T	10	7	17	0	0	17	0	0
5	35203092	.	G	A	6	6	12	0	2	14	0	0
5	35203486	.	C	A	11	7	18	0	1	19	0	0
5	35203629	.	C	T	0	10	10	0	7	17	0	0
5	35204077	.	T	G	6	9	15	0	3	18	0	0
5	35204159	.	C	T	5	4	9	0	0	9	0	0
5	35204280	.	A	T	9	6	15	0	0	15	0	0
5	35204353	.	C	T	6	5	11	0	0	11	0	0
5	35204390	.	G	A	5	11	16	0	1	17	0	0
5	35204681	.	A	C	4	11	15	0	1	16	0	0
5	35204689	.	A	C	4	0	4	0	10	14	0	0
5	35204754	.	C	T	7	9	16	0	0	16	0	0
5	35205005	.	G	A	9	12	21	0	1	22	0	0
5	35207914	.	T	G	7	6	13	0	1	14	0	0
5	35220402	.	T	A	3	5	8	0	1	9	0	0
5	35271001	.	C	T	19	14	33	0	0	33	0	0
5	35271154	.	A	T	17	18	35	1	0	36	0	0
5	35271181	.	A	G	19	18	37	0	4	41	0	0
5	35271194	.	G	A	24	22	46	0	1	47	0	0
5	35271309	.	T	A	35	24	59	0	1	60	0	0
5	35271465	.	T	C	32	22	54	0	0	54	0	0
5	35271824	.	C	A	22	22	44	0	2	46	0	0
5	35272032	.	G	A	20	20	40	0	2	42	0	0
5	35272438	.	C	T	2	22	24	0	21	45	0	0
5	35272497	.	G	A	15	14	29	0	5	34	0	0
5	35272560	.	T	G	14	16	30	0	1	31	0	0
5	35273062	.	G	A	26	24	50	0	4	54	0	0
5	35273225	.	T	C	20	16	36	0	3	39	0	0
5	35273447	.	A	G	28	14	42	0	1	43	0	0
5	35273509	.	A	T	21	20	41	0	1	42	0	0
5	35273546	.	A	T	22	15	37	0	1	38	0	0
5	35273564	.	G	A	20	11	31	0	1	32	0	0
5	35273708	.	T	C	18	12	30	0	1	31	0	0
5	35273793	.	A	T	21	21	42	0	3	45	0	0
5	35273838	.	A	C	18	26	44	0	1	45	0	0
5	35273992	.	A	G	15	25	40	0	0	40	0	0
5	35274398	.	G	A	18	15	33	0	2	35	0	0
5	35275103	.	C	T	23	27	50	0	1	51	0	0
5	35275859	.	G	T	20	16	36	0	3	39	0	0
5	35276154	.	A	G	25	22	47	0	3	50	0	0
5	35276303	.	G	C	26	22	48	0	5	53	0	0
5	35276386	.	G	A	19	16	35	0	1	36	0	0
5	35276580	.	A	G	29	16	45	0	2	47	0	0
5	35276811	.	C	G	17	14	31	0	0	31	0	0
5	35276911	.	C	T	3	20	23	0	15	38	0	0
5	35277184	.	T	A	20	21	41	0	1	42	0	0
5	35277256	.	T	A	15	14	29	0	2	32	1	0
5	35277280	.	T	C	22	15	37	0	1	38	0	0
5	35277459	.	T	C	20	20	40	0	1	41	0	0
5	35277509	.	A	T	17	18	35	0	2	37	0	0
5	35278237	.	A	T	18	10	28	0	0	28	0	0
5	35278597	.	C	T	19	8	27	0	0	28	1	0
5	35278863	.	C	T	12	16	28	0	2	30	0	0
5	35278933	.	T	C	18	0	18	0	18	36	0	0
5	35278977	.	T	G	13	13	26	0	2	28	0	0
5	35279007	.	C	T	2	18	20	0	12	32	0	0
5	35279065	.	A	G	15	14	29	0	0	29	0	0
5	35279230	.	T	G	14	12	26	0	0	26	0	0
5	35279275	.	T	G	17	13	30	0	0	30	0	0
5	35279831	.	C	T	11	11	22	0	0	22	0	0
5	35279884	.	G	A	11	13	24	0	0	24	0	0
5	35297280	.	T	C	12	0	12	0	13	25	0	0
5	35301563	.	A	G	15	12	27	0	0	27	0	0
5	35401011	.	T	A	2	2	4	0	1	5	0	0
5	35401028	.	G	A	0	3	3	0	1	4	0	0
5	35422324	.	T	C	4	7	11	0	2	13	0	0
5	35431641	.	A	G	13	6	19	0	1	20	0	0
5	35431703	.	T	G	7	12	19	0	0	19	0	0
5	35454464	.	C	T	20	10	30	0	2	32	0	0
5	35473544	.	T	C	3	2	5	0	0	5	0	0
5	35475907	.	A	T	8	5	13	0	1	14	0	0
5	35478593	.	G	C	0	6	6	0	3	9	0	0
5	35486822	.	C	T	1	2	3	0	0	3	0	0
5	35486827	.	G	A	1	2	3	0	0	3	0	0
5	35486917	.	C	A	1	3	4	0	0	4	0	0
5	35487030	.	A	G	6	4	10	0	1	11	0	0
5	35487407	.	A	T	7	4	11	0	0	11	0	0
5	35487416	.	G	C	7	5	12	0	0	12	0	0
5	35487459	.	A	T	7	3	10	0	0	10	0	0
5	35487781	.	C	G	3	2	5	0	0	5	0	0
5	35562337	.	A	C	2	2	4	0	0	4	0	0
5	35562617	.	T	C	2	3	5	0	0	5	0	0
5	35563099	.	A	C	2	3	5	0	0	5	0	0
5	35678570	.	G	A	1	4	5	0	5	10	0	0
5	35682874	.	A	G	1	2	3	0	0	3	0	0
5	35683991	.	A	G	3	3	6	0	0	6	0	0
5	35684014	.	C	T	4	3	7	0	0	7	0	0
5	35728246	.	T	C	2	2	4	0	1	5	0	0
5	35730403	.	T	C	1	2	3	0	0	3	0	0
5	35731349	.	T	A	2	3	5	0	0	5	0	0
5	35748938	.	T	C	6	8	14	0	0	14	0	0
5	35749470	.	A	G	6	12	18	0	0	18	0	0
5	35751883	.	G	T	10	10	20	0	0	20	0	0
5	35751977	.	A	G	17	11	28	0	1	29	0	0
5	35754284	.	A	G	12	1	13	0	13	26	0	0
5	35754424	.	T	C	16	9	25	0	0	25	0	0
5	35754431	.	A	G	14	0	14	0	11	25	0	0
5	35754503	.	A	C	11	11	22	0	0	22	0	0
5	35754599	.	T	A	18	11	29	0	0	29	0	0
5	35754663	.	A	G	9	10	19	0	0	19	0	0
5	35898689	.	T	C	1	2	3	0	0	3	0	0
5	35940643	.	G	A	2	2	4	0	0	4	0	0
5	35955514	.	T	C	15	15	30	0	1	31	0	0
5	35967234	.	C	T	5	11	16	0	0	16	0	0
5	35967270	.	T	A	5	7	12	0	0	12	0	0
5	35967438	.	A	T	2	2	4	0	0	4	0	0
5	36271160	.	T	G	7	4	11	0	0	11	0	0
5	36274750	.	C	A	2	6	8	0	0	8	0	0
5	36296066	.	G	A	6	3	9	0	1	10	0	0
5	36416204	.	A	G	22	12	34	0	1	35	0	0
5	36416307	.	C	G	10	0	10	0	16	27	1	0
5	36416367	.	G	A	1	6	7	0	14	21	0	0
5	36416478	.	G	T	16	9	25	0	1	26	0	0
5	36416583	.	C	T	18	17	35	0	1	36	0	0
5	36421991	.	G	A	3	10	13	0	9	22	0	0
5	36439680	.	C	G	1	0	1	0	4	5	0	0
5	36530959	.	A	T	17	13	30	0	3	33	0	0
5	36536665	.	T	C	9	9	18	0	0	19	1	0
5	36536742	.	C	T	11	11	22	0	2	24	0	0
5	36536910	.	G	A	14	5	19	0	0	19	0	0
5	36537020	.	A	G	18	8	26	1	1	28	0	0
5	36537021	.	T	A	17	8	25	1	1	27	0	0
5	36537057	.	G	A	10	14	24	1	0	25	0	0
5	36537073	.	A	C	10	14	24	1	0	25	0	0
5	36537113	.	A	G	13	0	13	0	5	18	0	0
5	36537126	.	G	A	9	7	16	0	0	16	0	0
5	36537231	.	A	T	10	11	21	0	0	21	0	0
5	36537246	.	A	G	6	0	6	0	9	15	0	0
5	36537611	.	C	A	6	2	8	0	1	9	0	0
5	36537672	.	C	A	2	7	9	0	0	9	0	0
5	36537927	.	T	C	2	4	6	0	0	6	0	0
5	36558059	.	G	A	19	16	35	0	1	36	0	0
5	36558348	.	A	G	13	14	27	0	0	27	0	0
5	36558369	.	G	A	9	12	21	0	1	22	0	0
5	36558441	.	C	T	16	13	29	0	1	30	0	0
5	36563257	.	T	C	15	8	23	0	1	24	0	0
5	36564205	.	A	G	7	9	16	0	0	16	0	0
5	36564206	.	A	T	6	9	15	0	1	16	0	0
5	36567750	.	C	A	1	7	8	0	15	23	0	0
5	36570280	.	G	A	9	8	17	0	0	17	0	0
5	36583271	.	A	G	3	7	10	0	0	10	0	0
5	36583575	.	C	T	0	5	5	0	10	15	0	0
5	36584779	.	G	T	7	6	13	0	1	14	0	0
5	36584985	.	C	T	4	7	11	0	0	11	0	0
5	36585054	.	C	T	6	8	14	0	1	15	0	0
5	36585662	.	G	A	6	9	15	0	0	15	0	0
5	36585933	.	C	T	9	5	14	0	0	14	0	0
5	36586190	.	G	A	12	5	17	0	1	18	0	0
5	36586192	.	C	G	12	5	17	0	2	19	0	0
5	36586867	.	A	G	5	4	9	0	0	9	0	0
5	36586906	.	C	G	0	6	6	0	6	12	0	0
5	36592135	.	G	A	3	5	8	0	0	8	0	0
5	36595772	.	A	T	8	6	14	0	0	14	0	0
5	36595912	.	G	A	10	6	16	0	0	16	0	0
5	36596106	.	A	G	2	2	4	0	0	4	0	0
5	36596278	.	G	A	7	4	11	0	0	11	0	0
5	36596294	.	G	A	7	6	13	0	0	13	0	0
5	36596378	.	G	A	2	6	8	0	1	9	0	0
5	36596397	.	T	A	2	6	8	0	1	9	0	0
5	36596517	.	C	A	1	8	9	0	5	14	0	0
5	36597547	.	C	A	6	5	11	0	1	12	0	0
5	36607909	.	C	T	1	3	4	0	0	4	0	0
5	36624620	.	G	A	1	22	23	0	8	31	0	0
5	36650153	.	C	A	5	4	9	0	0	9	0	0
5	36650289	.	T	G	4	2	6	0	2	8	0	0
5	36653522	.	G	A	6	8	14	0	0	14	0	0
5	36653876	.	T	G	7	1	8	0	5	13	0	0
5	36665351	.	C	T	11	9	20	0	0	20	0	0
5	36668321	.	C	T	10	7	17	0	0	17	0	0
5	36673347	.	C	T	6	6	12	0	0	12	0	0
5	36673609	.	A	G	6	4	10	0	0	10	0	0
5	36674796	.	G	C	1	2	3	0	0	3	0	0
5	36674831	.	C	T	2	4	6	0	0	6	0	0
5	36732199	.	G	C	26	16	42	1	2	45	0	0
5	36732217	.	A	G	25	15	40	1	0	41	0	0
5	36739134	.	T	C	13	19	32	0	0	32	0	0
5	36739310	.	T	A	18	12	30	0	0	30	0	0
5	36739316	.	T	C	20	12	32	0	0	32	0	0
5	36739352	.	T	A	20	7	27	0	0	27	0	0
5	36739361	.	T	C	16	8	24	0	1	25	0	0
5	36786641	.	G	A	1	12	13	0	9	22	0	0
5	36802395	.	A	C	5	11	16	0	0	16	0	0
5	36802407	.	T	C	6	10	16	0	1	17	0	0
5	36851191	.	C	T	12	6	18	0	1	19	0	0
5	36852848	.	G	A	0	7	7	0	8	15	0	0
5	36853849	.	C	G	21	8	29	0	0	29	0	0
5	36854206	.	A	T	13	5	18	0	0	18	0	0
5	36880102	.	A	G	1	2	3	0	0	3	0	0
5	36883871	.	A	G	2	3	5	0	0	5	0	0
5	36897749	.	C	A	2	2	4	0	0	4	0	0
5	36898476	.	C	T	28	20	48	0	0	48	0	0
5	36898668	.	A	G	38	0	38	0	19	57	0	0
5	36901003	.	T	G	22	13	35	0	2	37	0	0
5	36902610	.	A	G	12	0	12	0	23	35	0	0
5	36902628	.	T	C	12	21	33	0	1	34	0	0
5	36903194	.	A	T	1	5	6	0	0	6	0	0
5	36907182	.	G	T	7	4	11	0	0	12	1	0
5	36908034	.	T	C	23	21	44	0	3	47	0	0
5	36914018	.	A	C	1	0	1	0	5	6	0	0
5	36916370	.	A	T	5	6	11	0	0	11	0	0
5	36922399	.	A	G	3	7	10	0	0	10	0	0
5	36924122	.	G	C	10	8	18	0	1	19	0	0
5	36945378	.	T	A	18	12	30	6	2	38	0	0
5	36945383	.	A	T	20	16	36	6	0	42	0	0
5	36945463	.	T	A	30	21	51	0	3	54	0	0
5	36945518	.	T	G	28	13	41	0	9	50	0	0
5	36945719	.	G	T	28	32	60	1	16	78	1	0
5	36945747	.	T	A	29	33	62	1	14	77	0	0
5	36945927	.	A	C	36	27	63	0	3	66	0	0
5	36945937	.	C	T	36	26	62	0	1	63	0	0
5	36946244	.	A	G	32	34	66	0	7	73	0	0
5	36946261	.	T	C	33	3	36	0	35	71	0	0
5	36946341	.	C	T	6	37	43	0	29	72	0	0
5	36996458	.	A	G	16	13	29	0	3	32	0	0
5	36996638	.	A	G	21	0	21	0	18	39	0	0
5	36997133	.	A	G	17	12	29	0	1	30	0	0
5	37032095	.	A	G	10	18	28	0	4	32	0	0
5	37032191	.	T	C	8	18	26	0	0	26	0	0
5	37032280	.	C	G	9	21	30	0	2	32	0	0
5	37032339	.	A	G	12	0	12	0	17	29	0	0
5	37032611	.	T	C	8	14	22	0	0	22	0	0
5	37032782	.	G	A	7	27	34	0	1	35	0	0
5	37032799	.	A	T	7	32	39	0	1	40	0	0
5	37032959	.	A	G	10	17	27	0	1	28	0	0
5	37034111	.	T	C	11	12	23	0	1	24	0	0
5	37036404	.	T	C	6	8	14	0	0	14	0	0
5	37036856	.	T	C	7	13	20	0	0	20	0	0
5	37036975	.	A	T	6	11	17	0	0	17	0	0
5	37037079	.	C	T	18	10	28	0	1	29	0	0
5	37037152	.	T	C	13	19	32	0	1	33	0	0
5	37037308	.	C	A	7	5	12	0	0	12	0	0
5	37037436	.	G	T	2	8	10	0	1	11	0	0
5	37037583	.	T	C	8	22	30	0	2	32	0	0
5	37037617	.	A	T	6	18	24	0	1	25	0	0
5	37037669	.	T	G	9	20	29	0	0	29	0	0
5	37037742	.	A	T	14	21	35	0	1	36	0	0
5	37038017	.	T	C	7	6	13	0	0	13	0	0
5	37061485	.	G	A	30	26	56	0	2	58	0	0
5	37061487	.	C	T	32	26	58	0	0	58	0	0
5	37065416	.	T	C	23	25	48	0	5	53	0	0
5	37065729	.	C	T	24	14	38	0	0	45	7	0
5	37087733	.	C	A	5	3	8	0	0	8	0	0
5	37141356	.	T	G	5	4	9	0	0	9	0	0
5	37141834	.	T	C	6	3	9	0	0	9	0	0
5	37277355	.	A	G	1	5	6	0	0	6	0	0
5	37277377	.	T	A	1	4	5	0	0	5	0	0
5	37277534	.	A	G	3	3	6	0	0	6	0	0
5	37280125	.	A	G	0	3	3	0	1	4	0	0
5	37280343	.	T	G	3	2	5	0	0	5	0	0
5	37280856	.	C	T	4	5	9	0	0	9	0	0
5	37286325	.	A	G	2	1	3	0	4	7	0	0
5	37293768	.	G	A	10	7	17	0	1	18	0	0
5	37293815	.	T	C	11	9	20	0	0	20	0	0
5	37293841	.	G	A	10	10	20	0	2	22	0	0
5	37294077	.	G	A	3	7	10	0	0	10	0	0
5	37295646	.	C	T	6	12	18	0	0	18	0	0
5	37296298	.	C	T	5	6	11	0	1	12	0	0
5	37301236	.	G	A	9	10	19	0	1	20	0	0
5	37301249	.	C	T	9	9	18	0	0	18	0	0
5	37301282	.	C	T	13	7	20	0	1	21	0	0
5	37301505	.	A	G	8	7	15	0	0	15	0	0
5	37301783	.	A	G	9	14	23	0	5	28	0	0
5	37304028	.	T	C	8	8	16	0	0	16	0	0
5	37304070	.	G	T	7	5	12	0	0	12	0	0
5	37307921	.	C	G	16	14	30	0	1	31	0	0
5	37309734	.	A	G	17	14	31	0	2	33	0	0
5	37309881	.	C	T	21	16	37	0	0	37	0	0
5	37331854	.	C	T	6	8	14	0	0	14	0	0
5	37333870	.	G	A	16	13	29	0	0	30	1	0
5	37334264	.	T	A	11	7	18	0	1	19	0	0
5	37380533	.	T	C	9	5	14	0	1	15	0	0
5	37413762	.	G	A	8	9	17	0	0	17	0	0
5	37422999	.	A	T	9	10	19	0	0	19	0	0
5	37423193	.	G	A	9	10	19	0	0	19	0	0
5	37439388	.	C	T	11	9	20	0	0	20	0	0
5	37439418	.	C	T	10	10	20	0	0	20	0	0
5	37439505	.	T	C	5	11	16	0	2	18	0	0
5	37439517	.	A	C	8	11	19	0	0	19	0	0
5	37439891	.	T	C	18	11	29	0	1	30	0	0
5	37488453	.	C	T	3	2	5	0	0	5	0	0
5	37494666	.	C	T	1	2	3	0	0	3	0	0
5	37504340	.	T	A	3	5	8	0	2	10	0	0
5	37504439	.	T	A	3	4	7	0	0	7	0	0
5	37504470	.	C	A	0	6	6	0	0	6	0	0
5	37504489	.	G	T	6	2	8	0	0	8	0	0
5	37504966	.	G	A	5	5	10	0	0	10	0	0
5	37505245	.	G	A	6	9	15	0	1	16	0	0
5	37507823	.	T	C	7	14	21	0	1	22	0	0
5	37507901	.	C	T	11	16	27	0	0	27	0	0
5	37508828	.	C	T	6	7	13	0	0	13	0	0
5	37508832	.	T	G	6	7	13	0	0	13	0	0
5	37508893	.	A	T	4	3	7	0	1	8	0	0
5	37509102	.	T	C	2	5	7	0	0	7	0	0
5	37509156	.	G	A	2	6	8	0	0	8	0	0
5	37509296	.	G	C	10	14	24	0	0	24	0	0
5	37509428	.	T	G	5	3	8	0	0	8	0	0
5	37509703	.	C	T	12	7	19	0	0	19	0	0
5	37509766	.	G	A	0	9	9	0	10	19	0	0
5	37509857	.	A	G	4	10	14	0	0	14	0	0
5	37509916	.	A	G	6	5	11	0	0	11	0	0
5	37510028	.	G	T	9	3	12	0	0	12	0	0
5	37510292	.	C	T	1	9	10	0	1	11	0	0
5	37510293	.	T	C	2	9	11	0	0	11	0	0
5	37564513	.	G	A	2	3	5	0	0	5	0	0
5	37573605	.	T	A	1	4	5	0	0	5	0	0
5	37580857	.	C	T	6	3	9	0	0	9	0	0
5	37581111	.	G	A	5	2	7	0	0	7	0	0
5	37584160	.	A	G	4	3	7	0	0	7	0	0
5	37584380	.	G	A	0	2	2	0	3	5	0	0
5	37677229	.	C	T	15	12	27	0	2	29	0	0
5	37678256	.	T	C	11	20	31	0	1	32	0	0
5	37680403	.	G	A	0	16	16	1	16	33	0	0
5	37686590	.	C	T	19	16	35	0	1	36	0	0
5	37688077	.	C	T	12	11	23	0	0	23	0	0
5	37688422	.	A	G	18	18	36	0	1	37	0	0
5	37688878	.	A	C	14	21	35	0	1	37	1	0
5	37691223	.	A	G	16	12	28	0	0	28	0	0
5	37692171	.	A	G	19	19	38	0	0	38	0	0
5	37692620	.	T	C	18	18	36	0	1	37	0	0
5	37694283	.	G	A	20	17	37	0	1	38	0	0
5	37694568	.	A	C	20	17	37	0	0	37	0	0
5	37695528	.	A	G	12	14	26	0	0	26	0	0
5	37696582	.	G	A	7	18	25	0	0	25	0	0
5	37697134	.	C	T	23	17	40	0	0	40	0	0
5	37699115	.	A	G	20	23	43	0	1	44	0	0
5	37700687	.	C	A	19	16	35	0	3	39	1	0
5	37700908	.	T	C	16	19	35	0	1	36	0	0
5	37701262	.	T	A	19	21	40	0	1	41	0	0
5	37702934	.	C	T	19	18	37	0	2	39	0	0
5	37703176	.	G	A	0	15	15	0	15	30	0	0
5	37706798	.	C	T	23	26	49	1	3	54	1	0
5	37707190	.	G	A	28	14	42	0	2	44	0	0
5	37708995	.	A	T	26	23	49	0	1	50	0	0
5	37709057	.	T	A	27	22	49	0	2	51	0	0
5	37754583	.	A	G	3	4	7	0	1	8	0	0
5	37757677	.	C	T	10	6	16	0	0	16	0	0
5	37757690	.	T	C	10	8	18	0	0	18	0	0
5	37812090	.	C	T	3	4	7	0	0	7	0	0
5	37812150	.	A	G	3	2	5	0	0	5	0	0
5	37812693	.	C	T	3	2	5	0	0	5	0	0
5	37838415	.	T	C	45	36	81	0	10	91	0	0
5	37839029	.	G	T	58	53	111	0	4	115	0	0
5	37841113	.	T	C	2	2	4	0	0	4	0	0
5	37851166	.	C	A	2	1	3	0	0	3	0	0
5	37851171	.	A	G	2	2	4	0	0	4	0	0
5	37851201	.	C	T	3	3	6	0	0	6	0	0
5	37851528	.	T	C	2	6	8	0	0	8	0	0
5	37851542	.	G	A	3	5	8	0	0	8	0	0
5	37851588	.	A	C	3	2	5	0	0	5	0	0
5	37851758	.	T	A	5	2	7	0	0	7	0	0
5	37851830	.	C	A	6	5	11	0	0	11	0	0
5	37851876	.	C	T	7	6	13	0	0	13	0	0
5	37851923	.	G	A	5	4	9	0	0	9	0	0
5	37864845	.	A	G	10	6	16	0	1	17	0	0
5	37865142	.	C	T	8	6	14	0	0	14	0	0
5	37865628	.	T	C	7	5	12	0	1	13	0	0
5	37865677	.	G	T	6	4	10	0	0	10	0	0
5	37865744	.	C	G	5	11	16	0	0	16	0	0
5	37865836	.	A	T	7	2	9	0	0	9	0	0
5	37865837	.	T	A	4	4	8	0	0	8	0	0
5	37866310	.	C	T	13	9	22	0	0	22	0	0
5	37867491	.	C	T	14	11	25	0	0	25	0	0
5	37872801	.	C	T	7	7	14	0	1	15	0	0
5	37875576	.	A	G	6	2	8	0	0	8	0	0
5	37880681	.	C	A	5	4	9	0	2	11	0	0
5	37880796	.	A	T	5	8	13	0	0	13	0	0
5	37880896	.	C	T	1	2	3	0	7	10	0	0
5	37881139	.	T	A	3	3	6	0	0	6	0	0
5	37912292	.	T	A	15	16	31	0	2	33	0	0
5	37912442	.	A	G	10	12	22	0	2	24	0	0
5	37912489	.	T	A	16	15	31	0	0	31	0	0
5	37912748	.	A	T	16	7	23	0	0	23	0	0
5	37912859	.	A	C	12	16	28	0	0	28	0	0
5	37912970	.	A	C	21	6	27	0	0	27	0	0
5	37913041	.	C	G	13	14	27	0	1	28	0	0
5	37913064	.	T	C	13	19	32	0	0	32	0	0
5	37918855	.	G	A	7	14	21	0	0	21	0	0
5	37918894	.	A	T	14	9	23	0	0	23	0	0
5	37918932	.	A	T	13	10	23	0	0	23	0	0
5	37918994	.	C	T	6	8	14	0	0	14	0	0
5	37926281	.	G	A	6	6	12	0	0	12	0	0
5	37926323	.	T	A	8	12	20	0	0	20	0	0
5	37926362	.	C	T	1	5	6	0	8	14	0	0
5	37933914	.	A	G	5	7	12	0	0	12	0	0
5	37933930	.	C	G	0	9	9	0	4	13	0	0
5	37934005	.	C	T	9	9	18	0	0	18	0	0
5	37934206	.	T	C	3	11	14	0	5	19	0	0
5	37957522	.	T	C	3	3	6	0	0	6	0	0
5	37963259	.	C	T	17	11	28	0	1	29	0	0
5	37963262	.	G	T	13	17	30	0	0	30	0	0
5	37963316	.	C	A	14	16	30	0	2	32	0	0
5	37963326	.	C	A	16	12	28	0	1	29	0	0
5	37968912	.	T	G	17	16	33	0	0	33	0	0
5	37968951	.	G	A	16	12	28	0	0	28	0	0
5	37968966	.	T	C	15	10	25	0	1	26	0	0
5	37970764	.	C	T	16	17	33	1	0	34	0	0
5	37970773	.	A	T	17	14	31	1	2	34	0	0
5	37970818	.	T	G	11	0	11	0	12	23	0	0
5	37981906	.	T	G	3	2	5	0	0	5	0	0
5	37987369	.	G	A	6	4	10	0	0	10	0	0
5	37988969	.	G	T	3	7	10	0	2	13	1	0
5	37989090	.	G	A	10	9	19	0	1	20	0	0
5	37989135	.	A	G	13	14	27	0	1	28	0	0
5	37989325	.	G	A	17	12	29	0	1	30	0	0
5	37989379	.	G	T	13	10	23	0	0	23	0	0
5	37989443	.	A	C	12	9	21	0	1	22	0	0
5	37989447	.	A	G	12	9	21	0	1	22	0	0
5	37991350	.	T	A	8	8	16	0	0	16	0	0
5	37991566	.	C	A	0	5	5	0	8	13	0	0
5	37991756	.	C	T	4	2	6	0	0	6	0	0
5	37991757	.	C	T	4	1	5	0	1	6	0	0
5	37992120	.	T	C	3	11	14	0	0	14	0	0
5	38089247	.	G	T	5	3	8	0	0	8	0	0
5	38089309	.	G	A	4	7	11	0	1	12	0	0
5	38089537	.	T	C	5	5	10	0	0	10	0	0
5	38089578	.	T	G	3	11	14	0	0	14	0	0
5	38089651	.	G	A	8	12	20	0	0	20	0	0
5	38089733	.	G	C	10	0	10	0	6	16	0	0
5	38089834	.	A	G	7	11	18	0	0	18	0	0
5	38089930	.	G	T	6	7	13	0	0	13	0	0
5	38090070	.	A	G	7	5	12	0	0	12	0	0
5	38090179	.	A	G	7	8	15	0	1	16	0	0
5	38090230	.	A	C	6	3	9	0	0	9	0	0
5	38090542	.	G	A	2	4	6	0	0	6	0	0
5	38090659	.	G	C	4	0	4	0	9	13	0	0
5	38090677	.	A	G	8	6	14	0	0	14	0	0
5	38090707	.	G	A	7	8	15	0	0	15	0	0
5	38090734	.	G	T	8	7	15	0	0	15	0	0
5	38091247	.	A	G	7	5	12	0	0	12	0	0
5	38091547	.	A	G	2	2	4	0	1	5	0	0
5	38097406	.	C	G	4	2	6	0	1	7	0	0
5	38097408	.	T	A	4	3	7	0	0	7	0	0
5	38100745	.	G	T	1	4	5	0	0	5	0	0
5	38100756	.	G	A	1	4	5	0	0	5	0	0
5	38101745	.	T	G	1	0	1	0	5	6	0	0
5	38101869	.	C	T	2	3	5	1	0	6	0	0
5	38105257	.	A	T	1	2	3	0	0	3	0	0
5	38105327	.	T	C	4	5	9	0	0	9	0	0
5	38107054	.	T	C	1	2	3	0	0	3	0	0
5	38110826	.	G	T	9	6	15	0	0	15	0	0
5	38110908	.	A	T	5	7	12	0	0	12	0	0
5	38111060	.	T	C	11	0	11	0	12	23	0	0
5	38115349	.	T	C	5	5	10	0	0	10	0	0
5	38115361	.	T	C	5	5	10	0	0	10	0	0
5	38115395	.	A	G	5	2	7	0	0	7	0	0
5	38115502	.	C	T	5	8	13	0	0	13	0	0
5	38115582	.	C	T	5	8	13	0	1	14	0	0
5	38115685	.	A	T	9	6	15	0	0	15	0	0
5	38120116	.	A	G	3	2	5	0	0	5	0	0
5	38120117	.	C	A	2	2	4	0	1	5	0	0
5	38121914	.	T	A	6	10	16	0	1	17	0	0
5	38121942	.	A	G	5	12	17	0	0	17	0	0
5	38121991	.	A	T	5	8	13	0	0	13	0	0
5	38121993	.	T	C	7	8	15	0	0	15	0	0
5	38122100	.	C	A	5	8	13	0	0	13	0	0
5	38122112	.	T	A	3	7	10	0	1	11	0	0
5	38206476	.	C	T	2	2	4	0	0	4	0	0
5	38206485	.	G	T	0	2	2	0	2	4	0	0
5	38206680	.	C	A	4	3	7	0	0	7	0	0
5	38210371	.	T	C	2	2	4	0	0	4	0	0
5	38212551	.	T	G	6	1	7	0	7	14	0	0
5	38213052	.	A	G	3	0	3	0	2	5	0	0
5	38213877	.	G	C	5	8	13	0	0	13	0	0
5	38214258	.	A	G	3	8	11	0	0	11	0	0
5	38214567	.	T	G	2	6	8	0	0	8	0	0
5	38216175	.	T	G	1	4	5	0	0	5	0	0
5	38216204	.	G	A	1	5	6	0	0	6	0	0
5	38216469	.	C	A	4	2	6	0	0	6	0	0
5	38216471	.	C	T	1	2	3	0	4	7	0	0
5	38216661	.	G	A	1	2	3	0	0	3	0	0
5	38218004	.	G	A	3	3	6	0	0	6	0	0
5	38218105	.	A	T	4	2	6	0	0	6	0	0
5	38225079	.	G	A	1	2	3	0	0	3	0	0
5	38225127	.	G	A	2	4	6	0	1	7	0	0
5	38225175	.	C	T	0	4	4	0	1	5	0	0
5	38241345	.	A	G	6	4	10	0	0	10	0	0
5	38241390	.	A	G	4	3	7	0	0	7	0	0
5	38251968	.	T	G	2	9	11	0	0	11	0	0
5	38252113	.	G	C	6	3	9	0	0	9	0	0
5	38254734	.	A	G	2	7	9	0	1	10	0	0
5	38254919	.	A	G	4	2	6	0	0	6	0	0
5	38254958	.	C	T	0	2	2	0	2	4	0	0
5	38255108	.	G	T	2	9	11	0	0	11	0	0
5	38255132	.	G	A	4	7	11	0	0	11	0	0
5	38255219	.	A	C	4	0	4	0	6	10	0	0
5	38263384	.	G	A	22	20	42	0	3	45	0	0
5	38263611	.	G	A	17	14	31	0	0	31	0	0
5	38263870	.	C	T	12	24	36	0	0	36	0	0
5	38281540	.	G	C	3	18	21	0	17	38	0	0
5	38287103	.	C	T	23	24	47	0	2	49	0	0
5	38288313	.	T	A	15	23	38	0	0	38	0	0
5	38288346	.	T	A	18	21	39	0	0	39	0	0
5	38289358	.	A	C	24	16	40	0	4	44	0	0
5	38296192	.	C	T	17	28	45	0	3	48	0	0
5	38296193	.	A	G	19	29	48	0	0	48	0	0
5	38296475	.	G	A	16	19	35	0	0	35	0	0
5	38296765	.	A	C	21	23	44	0	1	45	0	0
5	38296799	.	A	C	17	27	44	0	0	44	0	0
5	38297305	.	A	G	18	0	18	0	21	39	0	0
5	38302085	.	G	A	12	11	23	0	1	24	0	0
5	38302158	.	C	A	21	13	34	0	1	35	0	0
5	38302159	.	A	C	28	7	35	0	0	35	0	0
5	38302490	.	A	G	28	16	44	0	0	44	0	0
5	38302589	.	T	A	18	18	36	0	1	37	0	0
5	38302753	.	G	T	15	25	40	0	7	47	0	0
5	38302859	.	C	T	29	13	42	0	0	42	0	0
5	38302911	.	A	T	29	9	38	0	3	41	0	0
5	38303028	.	G	T	20	25	45	0	2	48	1	0
5	38303301	.	T	C	19	0	19	1	15	35	0	0
5	38303895	.	A	T	29	18	47	0	0	47	0	0
5	38303896	.	G	A	29	18	47	0	1	48	0	0
5	38304578	.	C	T	26	16	42	0	3	45	0	0
5	38304633	.	T	G	27	18	45	0	2	47	0	0
5	38304768	.	G	A	24	17	41	0	2	43	0	0
5	38305068	.	G	A	21	22	43	0	0	43	0	0
5	38305127	.	T	C	17	10	27	0	2	35	6	0
5	38305493	.	C	T	6	23	29	0	0	29	0	0
5	38305698	.	G	A	20	17	37	0	0	37	0	0
5	38308378	.	C	A	23	15	38	0	1	39	0	0
5	38314069	.	C	T	18	15	33	0	2	35	0	0
5	38320825	.	A	G	12	22	34	0	1	35	0	0
5	38324453	.	C	T	24	12	36	0	1	37	0	0
5	38349956	.	A	G	11	18	29	0	0	29	0	0
5	38369850	.	C	T	22	16	38	0	0	38	0	0
5	38388741	.	C	A	4	6	10	0	0	10	0	0
5	38388786	.	G	A	3	4	7	0	0	7	0	0
5	38388875	.	C	G	3	3	6	0	3	9	0	0
5	38389087	.	C	G	2	4	6	0	4	10	0	0
5	38389089	.	G	A	2	6	8	0	2	10	0	0
5	38389147	.	T	C	6	3	9	0	1	10	0	0
5	38389165	.	G	T	4	5	9	0	0	9	0	0
5	38389441	.	A	T	5	2	7	0	1	9	1	0
5	38389538	.	G	A	6	6	12	0	1	13	0	0
5	38389641	.	G	A	3	3	6	0	0	6	0	0
5	38389642	.	G	T	3	3	6	0	0	6	0	0
5	38389811	.	C	T	5	3	8	0	0	8	0	0
5	38390158	.	T	C	1	2	3	0	0	3	0	0
5	38390162	.	C	T	0	1	1	0	1	2	0	0
5	38390429	.	C	T	5	2	7	0	0	7	0	0
5	38391622	.	T	G	3	4	7	0	0	7	0	0
5	38399358	.	C	A	2	3	5	0	0	5	0	0
5	38399454	.	C	G	0	4	4	0	1	5	0	0
5	38409151	.	T	C	2	2	4	0	0	4	0	0
5	38412459	.	T	C	3	2	5	0	0	5	0	0
5	38412478	.	T	C	1	0	1	0	3	4	0	0
5	38475953	.	C	G	9	10	19	0	0	19	0	0
5	38476030	.	T	A	3	7	10	0	2	12	0	0
5	38476185	.	C	T	7	4	11	0	0	11	0	0
5	38476750	.	C	A	11	12	23	0	0	23	0	0
5	38506785	.	T	G	6	10	16	7	0	23	0	0
5	38531848	.	T	A	13	6	19	0	1	20	0	0
5	38532216	.	A	T	9	10	19	0	1	20	0	0
5	38532462	.	T	C	11	0	11	0	18	29	0	0
5	38532535	.	A	G	8	12	20	0	1	21	0	0
5	38533170	.	A	G	11	15	26	0	1	27	0	0
5	38533248	.	G	A	9	8	17	0	1	18	0	0
5	38533296	.	T	G	7	20	27	0	1	28	0	0
5	38533392	.	G	T	15	18	33	0	0	33	0	0
5	38533404	.	C	T	2	18	20	0	13	33	0	0
5	38533464	.	A	G	11	12	23	0	1	24	0	0
5	38533551	.	A	G	14	16	30	0	0	30	0	0
5	38605000	.	T	C	2	2	4	0	0	4	0	0
5	38605003	.	A	T	2	2	4	0	0	4	0	0
5	38605164	.	C	T	7	3	10	0	0	10	0	0
5	38605201	.	A	C	8	6	14	0	0	14	0	0
5	38605291	.	G	C	9	6	15	1	1	17	0	0
5	38605347	.	G	T	17	5	22	1	0	23	0	0
5	38611096	.	G	T	14	12	26	0	0	26	0	0
5	38611108	.	T	C	14	0	14	0	9	23	0	0
5	38721044	.	G	C	4	8	12	0	0	12	0	0
5	38726961	.	A	T	5	2	7	0	0	7	0	0
5	38749541	.	T	A	4	4	8	0	0	8	0	0
5	38749814	.	G	A	3	5	8	0	0	8	0	0
5	38786808	.	C	T	4	3	7	0	1	8	0	0
5	38786823	.	G	A	5	2	7	0	1	8	0	0
5	38786922	.	T	C	3	6	9	0	0	9	0	0
5	38803214	.	G	A	2	2	4	0	1	5	0	0
5	38804812	.	G	A	2	3	5	0	0	5	0	0
5	38824361	.	A	G	1	5	6	0	0	6	0	0
5	38826047	.	A	C	6	5	11	0	0	11	0	0
5	38827340	.	T	A	7	6	13	0	0	13	0	0
5	38831573	.	A	G	6	5	11	0	1	12	0	0
5	38972966	.	T	A	1	2	3	0	1	4	0	0
5	39034736	.	G	A	0	2	2	0	5	7	0	0
5	39035768	.	C	T	2	2	4	0	0	4	0	0
5	39035796	.	A	G	1	3	4	0	0	4	0	0
5	39048254	.	G	A	0	2	2	0	5	7	0	0
5	39058420	.	T	C	2	3	5	0	0	5	0	0
5	39058470	.	A	C	1	2	3	0	0	3	0	0
5	39061917	.	T	C	2	4	6	0	0	6	0	0
5	39061992	.	C	T	1	2	3	0	0	3	0	0
5	39064110	.	T	C	1	3	4	0	0	4	0	0
5	39066642	.	T	C	4	5	9	0	0	9	0	0
5	39067289	.	T	C	6	4	10	0	2	12	0	0
5	39081359	.	C	G	6	0	6	0	5	11	0	0
5	39082734	.	T	A	4	3	7	0	0	7	0	0
5	39083116	.	T	C	2	2	4	0	0	4	0	0
5	39083125	.	G	A	3	2	5	0	0	5	0	0
5	39084712	.	T	G	1	3	4	0	0	4	0	0
5	39085976	.	C	T	1	3	4	0	0	4	0	0
5	39086295	.	T	A	2	3	5	0	0	5	0	0
5	39099379	.	C	T	2	4	6	0	0	6	0	0
5	39099642	.	T	C	6	7	13	0	0	13	0	0
5	39124314	.	C	T	8	7	15	0	0	15	0	0
5	39136032	.	G	A	11	5	16	0	1	17	0	0
5	39142657	.	A	G	10	0	10	0	6	16	0	0
5	39142677	.	A	T	7	8	15	1	0	16	0	0
5	39143310	.	C	T	3	4	7	0	0	7	0	0
5	39150608	.	C	A	6	3	9	0	0	9	0	0
5	39150623	.	C	T	5	2	7	0	1	8	0	0
5	39150701	.	G	A	0	2	2	0	5	7	0	0
5	39151045	.	A	T	6	3	9	0	0	9	0	0
5	39151493	.	G	A	0	3	3	0	3	6	0	0
5	39152411	.	C	T	6	4	10	0	0	10	0	0
5	39152582	.	A	G	5	2	7	0	0	7	0	0
5	39154714	.	A	C	1	0	1	0	4	5	0	0
5	39154819	.	C	G	12	7	19	0	0	19	0	0
5	39154829	.	G	T	12	7	19	0	0	19	0	0
5	39154919	.	A	G	6	12	18	0	1	19	0	0
5	39154958	.	C	G	10	8	18	0	0	18	0	0
5	39154979	.	C	T	1	5	6	0	10	16	0	0
5	39155006	.	T	A	10	8	18	0	1	19	0	0
5	39155044	.	A	G	12	8	20	0	0	20	0	0
5	39155146	.	T	A	4	1	5	0	0	5	0	0
5	39155419	.	C	T	5	3	8	0	0	8	0	0
5	39155473	.	T	A	7	8	15	0	2	17	0	0
5	39155474	.	G	T	6	9	15	0	2	17	0	0
5	39155511	.	A	G	4	8	12	0	1	13	0	0
5	39160584	.	G	A	7	9	16	0	0	16	0	0
5	39169387	.	T	C	2	0	2	0	3	5	0	0
5	39504271	.	G	C	8	14	22	0	1	23	0	0
5	39504307	.	C	A	9	5	14	0	3	17	0	0
5	39508009	.	C	T	24	20	44	0	2	46	0	0
5	39508059	.	T	A	27	14	41	0	2	43	0	0
5	39508540	.	G	A	1	4	5	1	10	16	0	0
5	39667312	.	T	G	1	0	1	0	4	5	0	0
5	39670239	.	A	G	3	0	3	0	2	5	0	0
5	39707665	.	A	T	4	4	8	0	0	8	0	0
5	39707758	.	A	C	6	10	16	0	0	16	0	0
5	39707825	.	G	A	7	4	11	0	0	11	0	0
5	39708046	.	A	G	12	4	16	0	0	16	0	0
5	39712557	.	T	C	20	10	30	0	0	30	0	0
5	39714917	.	T	C	10	13	23	0	0	23	0	0
5	39715249	.	G	A	10	14	24	0	0	24	0	0
5	39730511	.	A	G	11	16	27	0	0	27	0	0
5	39730575	.	C	T	14	8	22	0	0	22	0	0
5	39730713	.	T	C	10	10	20	0	1	21	0	0
5	39730785	.	A	G	8	7	15	0	2	17	0	0
5	39731805	.	T	C	17	8	25	0	0	25	0	0
5	39736279	.	C	T	11	3	14	0	0	14	0	0
5	39805398	.	T	C	5	0	5	0	3	8	0	0
5	40003053	.	G	A	1	7	8	0	8	16	0	0
5	40003650	.	C	T	7	9	16	0	2	18	0	0
5	40012989	.	G	A	8	6	14	0	1	15	0	0
5	40040322	.	T	G	3	2	5	0	0	5	0	0
5	40052933	.	A	G	4	34	38	0	1	39	0	0
5	40054407	.	C	G	17	16	33	0	1	34	0	0
5	40059722	.	C	G	26	21	47	0	2	49	0	0
5	40059761	.	T	C	18	22	40	0	1	41	0	0
5	40062351	.	A	G	16	14	30	0	3	33	0	0
5	40062390	.	G	A	11	17	28	0	0	28	0	0
5	40071745	.	C	T	16	10	26	0	0	26	0	0
5	40077300	.	G	A	9	13	22	0	1	23	0	0
5	40078717	.	C	A	18	12	30	0	0	30	0	0
5	40080885	.	G	A	13	18	31	0	0	31	0	0
5	40093858	.	G	A	11	15	26	0	0	26	0	0
5	40095602	.	C	T	0	12	12	0	3	15	0	0
5	40097502	.	A	G	11	8	19	0	1	20	0	0
5	40097505	.	A	G	12	8	20	0	0	20	0	0
5	40111613	.	G	T	7	10	17	0	1	18	0	0
5	40203540	.	G	A	10	14	24	0	0	24	0	0
5	40206117	.	G	A	11	7	18	0	0	18	0	0
5	40206358	.	A	C	12	8	20	0	0	20	0	0
5	40210379	.	A	C	6	7	13	0	1	14	0	0
5	40248430	.	G	A	0	2	2	0	1	3	0	0
5	40273444	.	A	C	4	3	7	0	0	7	0	0
5	40273606	.	C	T	0	6	6	0	5	11	0	0
5	40273727	.	T	A	3	3	6	0	0	6	0	0
5	40273864	.	G	A	1	3	4	0	0	4	0	0
5	40291442	.	C	G	0	5	5	0	5	10	0	0
5	40506670	.	G	A	4	3	7	0	0	7	0	0
5	40507001	.	G	A	1	3	4	0	1	5	0	0
5	40507154	.	C	G	6	3	9	0	0	9	0	0
5	40507577	.	C	A	6	8	14	0	1	15	0	0
5	40508436	.	T	C	4	0	4	0	8	12	0	0
5	40510347	.	T	G	5	4	9	0	0	9	0	0
5	40728852	.	A	G	3	3	6	0	0	6	0	0
5	40729081	.	A	C	3	4	7	0	0	7	0	0
5	40729147	.	T	C	4	3	7	0	0	7	0	0
5	40729408	.	G	A	8	8	16	0	0	16	0	0
5	40729618	.	A	G	10	6	16	0	0	16	0	0
5	40732293	.	A	G	6	9	15	0	0	15	0	0
5	40732341	.	T	A	5	7	12	0	0	12	0	0
5	40845312	.	A	G	7	8	15	0	0	15	0	0
5	40845344	.	G	C	6	8	14	0	0	14	0	0
5	40845387	.	A	G	7	6	13	0	0	13	0	0
5	40845389	.	A	T	7	6	13	0	0	13	0	0
5	40845433	.	A	G	5	5	10	0	0	10	0	0
5	40845434	.	G	A	4	3	7	0	3	10	0	0
5	40845505	.	G	C	3	0	3	0	9	13	1	0
5	40845556	.	C	A	10	7	17	0	0	17	0	0
5	40845893	.	A	G	6	6	12	0	0	12	0	0
5	40846122	.	G	A	10	5	15	0	0	15	0	0
5	40848896	.	C	T	0	2	2	0	6	8	0	0
5	40856738	.	T	G	8	4	12	0	1	13	0	0
5	40857564	.	C	T	6	6	12	0	0	12	0	0
5	40877058	.	T	C	11	5	16	0	0	16	0	0
5	40910613	.	A	T	7	2	9	0	1	10	0	0
5	40910770	.	A	G	5	6	11	0	1	12	0	0
5	40951489	.	C	T	2	2	4	0	0	4	0	0
5	40952467	.	G	A	3	2	5	0	0	5	0	0
5	40952475	.	A	G	1	2	3	0	0	3	0	0
5	40952768	.	A	G	1	2	3	0	0	3	0	0
5	40953178	.	G	T	1	2	3	0	0	3	0	0
5	40957598	.	C	A	1	3	4	0	0	4	0	0
5	41082921	.	C	G	12	8	20	0	0	20	0	0
5	41082951	.	A	C	12	0	12	0	10	22	0	0
5	41083000	.	C	A	8	8	16	0	1	17	0	0
5	41083001	.	T	C	9	0	9	0	8	17	0	0
5	41083118	.	C	T	0	3	3	0	2	5	0	0
5	41083227	.	A	G	5	3	8	0	0	8	0	0
5	41083763	.	A	G	12	8	20	0	1	21	0	0
5	41083854	.	T	C	13	16	29	1	0	30	0	0
5	41083874	.	G	T	16	19	35	0	0	35	0	0
5	41083917	.	T	C	24	9	33	0	4	37	0	0
5	41084063	.	G	C	11	10	21	0	1	22	0	0
5	41084116	.	A	T	9	5	14	2	0	16	0	0
5	41084274	.	A	G	14	19	33	0	1	34	0	0
5	41084367	.	C	A	1	7	8	0	13	21	0	0
5	41085049	.	A	C	2	4	6	0	0	7	1	0
5	41085118	.	A	G	4	7	11	0	0	11	0	0
5	41085511	.	C	T	1	6	7	0	9	16	0	0
5	41086082	.	T	G	4	6	10	0	1	11	0	0
5	41086195	.	A	T	7	7	14	0	2	16	0	0
5	41103286	.	T	C	7	17	24	0	3	27	0	0
5	41103462	.	A	G	15	9	24	0	2	26	0	0
5	41103469	.	G	A	16	8	24	0	1	25	0	0
5	41106540	.	A	G	1	3	4	0	0	4	0	0
5	41106602	.	C	T	4	2	6	0	0	6	0	0
5	41110566	.	C	T	0	2	2	0	3	5	0	0
5	41125097	.	C	T	1	3	4	0	0	4	0	0
5	41125229	.	G	T	6	6	12	0	0	12	0	0
5	41125310	.	A	C	27	13	40	0	0	40	0	0
5	41125311	.	A	C	26	12	38	0	1	39	0	0
5	41125354	.	C	A	25	15	40	0	1	41	0	0
5	41125996	.	T	C	28	20	48	0	0	48	0	0
5	41126059	.	G	A	30	17	47	0	4	51	0	0
5	41127078	.	A	G	20	14	34	0	1	35	0	0
5	41127111	.	T	C	16	15	31	0	0	31	0	0
5	41127132	.	C	T	15	19	34	0	0	34	0	0
5	41128808	.	T	G	18	20	38	0	0	39	1	0
5	41133401	.	A	T	17	22	39	0	2	41	0	0
5	41134921	.	A	T	23	18	41	0	0	41	0	0
5	41134942	.	A	G	20	17	37	0	1	38	0	0
5	41135002	.	A	G	25	22	47	0	1	48	0	0
5	41137311	.	G	A	27	21	48	0	6	54	0	0
5	41137341	.	G	A	35	17	52	0	3	55	0	0
5	41138377	.	C	T	27	25	52	0	5	57	0	0
5	41138720	.	T	C	30	20	50	0	1	51	0	0
5	41138738	.	A	G	31	13	44	0	3	47	0	0
5	41138756	.	C	A	28	19	47	0	1	48	0	0
5	41138807	.	T	C	29	0	29	0	18	47	0	0
5	41146801	.	G	A	29	24	53	0	1	54	0	0
5	41150615	.	C	T	18	21	39	1	1	41	0	0
5	41150898	.	T	A	18	23	41	0	1	42	0	0
5	41150979	.	A	C	23	16	39	0	0	39	0	0
5	41151265	.	G	A	5	10	15	0	1	16	0	0
5	41260937	.	C	T	6	4	10	0	0	10	0	0
5	41261680	.	A	G	5	1	6	0	2	8	0	0
5	41261684	.	G	A	6	2	8	0	0	8	0	0
5	41261901	.	G	C	2	4	6	0	0	6	0	0
5	41261907	.	G	A	2	4	6	0	0	6	0	0
5	41271673	.	A	G	6	5	11	0	0	11	0	0
5	41286892	.	G	A	3	2	5	0	0	5	0	0
5	41306594	.	C	T	3	5	8	0	2	10	0	0
5	41306624	.	G	A	2	8	10	0	0	10	0	0
5	41307243	.	T	A	3	3	6	0	0	6	0	0
5	41307253	.	G	T	2	2	4	0	0	4	0	0
5	41307456	.	C	T	2	2	4	0	1	5	0	0
5	41307487	.	A	G	4	7	11	0	0	11	0	0
5	41478162	.	A	G	5	2	7	0	0	7	0	0
5	41478237	.	G	A	5	5	10	0	1	11	0	0
5	41478264	.	A	G	5	0	5	0	5	10	0	0
5	41478349	.	C	T	2	7	9	0	0	9	0	0
5	41478382	.	T	C	2	9	11	0	0	11	0	0
5	41481405	.	A	G	7	13	20	0	0	20	0	0
5	41481991	.	C	T	4	4	8	0	1	9	0	0
5	41481996	.	C	T	4	4	8	0	2	10	0	0
5	41482098	.	T	C	9	5	14	0	0	14	0	0
5	41484391	.	A	C	6	14	20	0	1	21	0	0
5	41484460	.	T	C	8	10	18	0	0	18	0	0
5	41484496	.	T	C	7	6	13	0	0	13	0	0
5	41484680	.	C	T	9	12	21	0	0	21	0	0
5	41484797	.	C	A	10	6	16	0	0	16	0	0
5	41484991	.	A	G	2	1	3	0	1	4	0	0
5	41485363	.	C	G	16	11	27	0	4	31	0	0
5	41485365	.	A	G	17	12	29	0	2	31	0	0
5	41485497	.	C	G	23	15	38	0	2	40	0	0
5	41485533	.	C	T	3	29	32	0	23	55	0	0
5	41485709	.	A	T	32	28	60	0	1	61	0	0
5	41485814	.	A	T	29	25	54	0	2	56	0	0
5	41486025	.	A	G	35	23	58	0	5	63	0	0
5	41486031	.	T	G	34	25	59	0	0	59	0	0
5	41486803	.	G	A	30	31	61	0	0	61	0	0
5	41486890	.	C	T	25	34	59	0	2	61	0	0
5	41488903	.	A	G	26	29	55	0	4	59	0	0
5	41489487	.	G	T	25	31	56	0	6	62	0	0
5	41489493	.	C	T	27	33	60	0	5	65	0	0
5	41489748	.	T	C	29	28	57	0	1	58	0	0
5	41492135	.	C	T	19	30	49	0	1	50	0	0
5	41492183	.	C	T	4	24	28	0	20	48	0	0
5	41492234	.	G	A	28	26	54	0	3	57	0	0
5	41492279	.	G	A	31	25	56	0	4	60	0	0
5	41492901	.	G	A	26	23	49	0	2	51	0	0
5	41492934	.	A	G	27	18	45	0	2	47	0	0
5	41513013	.	T	C	27	15	42	0	2	44	0	0
5	41514127	.	A	G	17	13	30	1	0	31	0	0
5	41516322	.	A	C	16	18	34	0	1	35	0	0
5	41516521	.	G	A	21	12	33	0	0	33	0	0
5	41518836	.	T	C	29	18	47	0	2	49	0	0
5	41519423	.	A	C	20	30	50	1	4	55	0	0
5	41519459	.	T	C	23	32	55	1	1	57	0	0
5	41520822	.	A	T	20	18	38	1	0	39	0	0
5	41520823	.	T	C	19	17	36	1	1	38	0	0
5	41559351	.	G	T	5	3	8	0	1	9	0	0
5	41560836	.	T	A	4	3	7	0	1	8	0	0
5	41582736	.	G	A	2	10	12	0	0	12	0	0
5	41585126	.	C	T	8	5	13	0	0	13	0	0
5	41585186	.	G	A	5	7	12	0	0	12	0	0
5	41591467	.	T	C	5	3	8	0	1	9	0	0
5	41594919	.	G	T	3	6	9	0	0	9	0	0
5	41597659	.	G	T	1	2	3	0	0	3	0	0
5	41597713	.	C	T	3	2	5	0	0	5	0	0
5	41597740	.	A	G	3	4	7	0	0	7	0	0
5	41600769	.	G	T	5	6	11	0	0	11	0	0
5	41607883	.	C	T	8	9	17	0	0	17	0	0
5	41610842	.	G	T	2	3	5	0	0	5	0	0
5	41614608	.	T	A	2	3	5	0	0	5	0	0
5	41617159	.	C	T	1	2	3	0	0	3	0	0
5	41617163	.	G	A	1	2	3	0	0	3	0	0
5	41617410	.	A	G	2	2	4	0	1	5	0	0
5	41626474	.	C	T	0	4	4	0	5	9	0	0
5	41626492	.	C	T	4	2	6	0	0	6	0	0
5	41633397	.	A	G	2	2	4	0	1	5	0	0
5	41633418	.	C	T	1	4	5	0	0	5	0	0
5	41637233	.	G	A	2	5	7	0	0	7	0	0
5	41637290	.	C	T	3	4	7	0	0	7	0	0
5	41637317	.	C	T	6	3	9	0	0	9	0	0
5	41637983	.	C	T	0	2	2	0	1	3	0	0
5	41637984	.	G	A	1	2	3	0	0	3	0	0
5	41639787	.	A	T	1	1	2	0	1	3	0	0
5	41639814	.	A	G	1	2	3	0	2	5	0	0
5	41639874	.	G	T	3	6	9	0	0	9	0	0
5	41641750	.	G	A	11	8	19	0	0	19	0	0
5	41641835	.	G	C	7	10	17	0	0	17	0	0
5	41641887	.	A	G	5	10	15	0	0	15	0	0
5	41642167	.	A	G	5	8	13	0	0	13	0	0
5	41642348	.	G	A	3	5	8	0	0	8	0	0
5	41643084	.	A	G	3	3	6	0	0	6	0	0
5	41643095	.	A	G	3	4	7	0	0	7	0	0
5	41643359	.	G	A	4	4	8	0	1	9	0	0
5	41645652	.	A	G	10	24	34	0	1	35	0	0
5	41645815	.	C	G	16	7	23	0	0	23	0	0
5	41645827	.	T	A	17	8	25	0	2	27	0	0
5	41645982	.	A	G	20	22	42	0	2	44	0	0
5	41650451	.	T	C	15	1	16	0	19	36	1	0
5	41655134	.	G	A	16	14	30	0	0	30	0	0
5	41655155	.	T	A	19	9	28	0	1	29	0	0
5	41670193	.	G	A	13	9	22	0	0	22	0	0
5	41675669	.	T	C	5	6	11	0	0	11	0	0
5	41676855	.	T	C	8	12	20	0	2	22	0	0
5	41684870	.	A	G	14	8	22	0	0	22	0	0
5	41684885	.	A	T	16	7	23	0	1	24	0	0
5	41689439	.	T	G	7	8	15	0	0	15	0	0
5	41691606	.	A	G	6	11	17	0	0	17	0	0
5	41705757	.	A	G	10	4	14	0	0	14	0	0
5	41708947	.	C	T	1	5	6	0	4	10	0	0
5	41878612	.	A	C	5	11	16	0	0	16	0	0
5	41878660	.	A	G	9	10	19	0	1	20	0	0
5	41878711	.	C	T	2	11	13	0	15	28	0	0
5	41878965	.	G	C	5	4	9	0	0	9	0	0
5	41879465	.	C	G	8	14	22	0	0	22	0	0
5	41879497	.	T	C	7	10	17	0	0	17	0	0
5	41879848	.	C	A	4	6	10	0	0	10	0	0
5	41880186	.	G	C	4	0	4	0	15	19	0	0
5	41880240	.	T	C	10	1	11	1	15	27	0	0
5	41880243	.	T	C	6	1	7	1	19	27	0	0
5	41880280	.	C	G	21	17	38	1	0	39	0	0
5	41880288	.	G	A	21	15	36	1	1	38	0	0
5	41882364	.	T	C	9	13	22	0	4	26	0	0
5	41885861	.	C	A	18	12	30	1	1	32	0	0
5	41888132	.	T	C	19	0	19	0	11	30	0	0
5	41890054	.	G	A	15	17	32	0	1	33	0	0
5	41890092	.	A	G	9	12	21	0	0	21	0	0
5	41890277	.	T	G	9	6	15	0	1	16	0	0
5	41891324	.	T	C	10	0	10	0	7	17	0	0
5	41898424	.	A	G	12	18	30	0	0	30	0	0
5	41899006	.	C	G	1	10	11	0	6	17	0	0
5	41899015	.	C	T	2	12	14	0	6	20	0	0
5	41900012	.	A	C	2	11	13	0	0	13	0	0
5	41900020	.	A	G	2	12	14	0	0	14	0	0
5	41900126	.	G	T	6	11	17	0	0	17	0	0
5	41900153	.	T	C	8	0	8	0	10	18	0	0
5	41900604	.	C	T	2	8	10	0	2	12	0	0
5	41901020	.	A	G	5	4	9	0	0	9	0	0
5	41901093	.	T	C	4	4	8	0	0	8	0	0
5	41914620	.	C	T	7	6	13	0	1	14	0	0
5	41914647	.	A	G	7	5	12	0	0	12	0	0
5	41914679	.	G	T	2	7	9	0	0	9	0	0
5	41914692	.	T	C	4	7	11	0	0	11	0	0
5	41914784	.	A	G	9	7	16	0	1	17	0	0
5	41915295	.	G	T	10	5	15	0	2	17	0	0
5	41917306	.	A	G	6	5	11	0	1	12	0	0
5	41917426	.	C	T	9	4	13	0	0	13	0	0
5	41917501	.	G	A	9	6	15	0	2	17	0	0
5	41917544	.	C	T	4	4	8	0	0	8	0	0
5	41917615	.	G	A	4	4	8	0	0	8	0	0
5	41917631	.	C	A	8	5	13	0	1	14	0	0
5	41917678	.	T	A	7	4	11	0	1	12	0	0
5	41932185	.	C	T	0	4	4	0	5	9	0	0
5	41960208	.	A	G	7	9	16	0	1	17	0	0
5	41974556	.	C	A	1	6	7	0	4	11	0	0
5	41975971	.	T	A	3	7	10	0	0	10	0	0
5	41984305	.	A	G	3	6	9	0	0	9	0	0
5	41996202	.	C	A	8	5	13	0	0	13	0	0
5	41996262	.	G	A	6	5	11	0	0	11	0	0
5	41997098	.	T	C	2	2	4	0	0	4	0	0
5	41997144	.	G	A	2	4	6	0	0	6	0	0
5	41997146	.	A	T	2	4	6	0	0	6	0	0
5	42028963	.	C	A	1	4	5	0	0	5	0	0
5	42053399	.	T	C	2	4	6	0	0	6	0	0
5	42053465	.	G	C	4	4	8	0	1	9	0	0
5	42066958	.	C	T	16	15	31	10	2	43	0	0
5	42067588	.	G	A	22	7	29	30	5	64	0	0
5	42092244	.	G	A	1	2	3	0	0	3	0	0
5	42122907	.	C	T	7	5	12	0	0	12	0	0
5	42122914	.	C	T	8	6	14	0	0	14	0	0
5	42123023	.	C	T	17	16	33	0	0	33	0	0
5	42123125	.	C	T	18	18	36	0	0	36	0	0
5	42123375	.	C	A	20	11	31	0	0	31	0	0
5	42123664	.	A	G	18	15	33	0	2	35	0	0
5	42123697	.	G	C	24	14	38	0	2	41	1	0
5	42123766	.	G	T	13	10	23	0	0	23	0	0
5	44795141	.	A	G	7	4	11	0	0	11	0	0
5	44795146	.	A	G	4	6	10	0	1	11	0	0
5	44795297	.	A	G	8	0	8	0	20	28	0	0
5	44795308	.	A	G	11	18	29	0	0	29	0	0
5	45140921	.	T	G	7	4	11	0	0	11	0	0
5	45141069	.	C	T	6	4	10	0	1	11	0	0
5	45141075	.	T	A	5	4	9	0	1	10	0	0
5	45183345	.	C	T	7	5	12	0	0	12	0	0
5	45183470	.	G	A	11	9	20	0	0	20	0	0
5	45204118	.	C	T	8	15	23	0	0	23	0	0
5	45204175	.	G	A	6	8	14	0	1	15	0	0
5	45204971	.	A	G	6	4	10	0	1	11	0	0
5	45224048	.	C	T	14	9	23	0	2	25	0	0
5	45224396	.	A	G	9	6	15	0	0	15	0	0
5	45230659	.	C	A	9	9	18	0	1	19	0	0
5	45261926	.	C	T	20	8	28	0	2	30	0	0
5	45269380	.	A	G	16	11	27	0	0	27	0	0
5	45269386	.	A	G	17	11	28	0	2	30	0	0
5	45272009	.	A	G	14	0	14	0	15	29	0	0
5	45272056	.	C	T	17	18	35	0	2	37	0	0
5	45272068	.	G	A	17	16	33	0	1	34	0	0
5	45274486	.	C	T	15	12	27	0	2	29	0	0
5	45282910	.	G	A	8	4	12	0	0	12	0	0
5	45283046	.	G	T	6	6	12	0	1	13	0	0
5	45283074	.	G	A	0	5	5	0	4	9	0	0
5	45283117	.	A	C	3	7	10	0	0	10	0	0
5	45283165	.	C	T	4	3	7	0	0	7	0	0
5	45283274	.	T	C	4	12	16	0	1	17	0	0
5	45283284	.	T	C	5	14	19	0	0	19	0	0
5	45283365	.	G	A	9	6	15	0	0	15	0	0
5	45283645	.	C	T	6	7	13	0	0	13	0	0
5	45613282	.	A	G	4	4	8	0	0	8	0	0
5	45613465	.	G	T	5	4	9	0	0	9	0	0
5	45613585	.	T	C	2	2	4	0	0	4	0	0
5	45632949	.	G	C	3	2	5	0	0	5	0	0
5	45634429	.	T	C	4	3	7	0	1	8	0	0
5	45747455	.	C	T	24	18	42	0	0	42	0	0
5	45747475	.	C	T	4	14	18	0	15	33	0	0
5	45747647	.	A	G	17	15	32	0	0	32	0	0
5	45747845	.	C	A	6	4	10	0	0	10	0	0
5	45747924	.	A	T	11	5	16	0	0	16	0	0
5	45748172	.	T	A	3	3	6	0	0	6	0	0
5	45748339	.	T	G	17	18	35	0	0	35	0	0
5	45748726	.	A	C	17	0	17	0	16	33	0	0
5	45751208	.	C	T	0	8	8	0	21	29	0	0
5	45754818	.	C	T	11	15	26	0	3	29	0	0
5	45754851	.	A	G	17	15	32	0	3	35	0	0
5	45754899	.	G	A	16	16	32	0	0	32	0	0
5	45757617	.	A	G	10	15	25	0	1	26	0	0
5	45757731	.	A	G	8	17	25	0	0	25	0	0
5	45762709	.	A	G	8	17	25	0	3	28	0	0
5	45762892	.	A	G	10	14	24	0	1	25	0	0
5	45769800	.	C	G	7	6	13	0	0	13	0	0
5	45771930	.	G	A	10	11	21	0	2	23	0	0
5	45781819	.	G	A	6	3	9	0	0	9	0	0
5	45781837	.	G	A	6	5	11	0	0	11	0	0
5	45786377	.	C	T	3	5	8	0	0	8	0	0
5	45876906	.	G	A	2	4	6	0	0	6	0	0
5	45890036	.	A	T	4	4	8	0	1	9	0	0
5	45890086	.	A	T	4	3	7	0	0	7	0	0
5	45890087	.	A	T	5	1	6	0	1	7	0	0
5	45890195	.	A	G	5	5	10	0	0	10	0	0
5	45890219	.	A	T	5	8	13	0	0	13	0	0
5	45890625	.	C	T	10	12	22	0	2	24	0	0
5	45890908	.	C	T	1	11	12	0	9	21	0	0
5	45890915	.	C	T	8	9	17	0	1	18	0	0
5	45891074	.	A	G	5	6	11	0	0	11	0	0
5	45891090	.	A	G	7	7	14	0	0	14	0	0
5	45891147	.	T	A	11	7	18	0	0	18	0	0
5	45891226	.	T	A	13	11	24	0	0	24	0	0
5	45891327	.	G	T	16	11	27	0	0	27	0	0
5	45892671	.	C	A	10	6	16	0	1	17	0	0
5	45894699	.	C	T	13	16	29	0	1	30	0	0
5	45894720	.	T	C	14	20	34	0	0	34	0	0
5	45894737	.	T	C	13	19	32	0	4	36	0	0
5	45908336	.	G	C	3	3	6	0	0	6	0	0
5	45908348	.	C	A	3	3	6	0	0	6	0	0
5	45990216	.	C	T	11	5	16	0	0	16	0	0
5	45990252	.	C	T	8	7	15	0	1	16	0	0
5	45990372	.	G	A	15	12	27	0	0	27	0	0
5	45990426	.	C	T	11	9	20	0	0	20	0	0
5	45990588	.	C	T	3	4	7	0	0	7	0	0
5	46025989	.	A	G	3	3	6	0	0	6	0	0
5	46056557	.	T	C	6	6	12	0	0	12	0	0
5	46064330	.	G	T	10	8	18	0	0	18	0	0
5	46066129	.	C	T	2	11	13	0	0	13	0	0
5	46066228	.	A	G	5	0	5	0	11	16	0	0
5	46209051	.	G	T	10	10	20	0	1	21	0	0
5	46242156	.	C	T	4	6	10	0	0	10	0	0
5	46285187	.	A	T	1	2	3	0	0	3	0	0
5	46327798	.	G	T	5	7	12	0	0	12	0	0
5	46328476	.	T	C	4	0	4	0	5	9	0	0
5	46328611	.	C	T	9	6	15	0	0	15	0	0
5	46329750	.	C	G	1	9	10	0	6	16	0	0
5	46491126	.	G	T	2	2	4	0	0	4	0	0
5	46659285	.	T	G	22	14	36	1	1	38	0	0
5	46659401	.	A	G	17	21	38	0	1	39	0	0
5	46659666	.	T	A	32	19	51	0	2	53	0	0
5	46659707	.	C	A	25	27	52	0	2	54	0	0
5	46659861	.	G	A	12	19	31	0	7	38	0	0
5	46659950	.	C	T	28	17	45	0	1	46	0	0
5	46659985	.	A	G	17	26	43	0	4	47	0	0
5	46660068	.	C	T	19	16	35	0	3	38	0	0
5	46660116	.	C	T	21	14	35	0	3	38	0	0
5	46660120	.	A	G	15	22	37	0	1	38	0	0
5	46660162	.	C	G	27	19	46	0	1	47	0	0
5	46660600	.	T	A	20	11	31	2	2	35	0	0
5	46660672	.	G	A	22	15	37	2	1	40	0	0
5	46660940	.	G	A	19	21	40	1	1	42	0	0
5	46660941	.	A	T	22	20	42	0	0	42	0	0
5	46661073	.	G	A	13	9	22	0	0	22	0	0
5	46661168	.	T	A	9	8	17	0	1	18	0	0
5	46661213	.	A	G	13	15	28	0	0	28	0	0
5	46661240	.	A	G	19	12	31	0	1	32	0	0
5	46661423	.	T	C	24	0	24	0	27	51	0	0
5	46661519	.	C	T	19	18	37	0	1	38	0	0
5	46661678	.	T	A	5	11	16	0	0	16	0	0
5	46662184	.	G	T	5	6	11	0	0	11	0	0
5	46662271	.	A	G	8	17	25	0	1	26	0	0
5	46662316	.	A	G	12	13	25	0	4	29	0	0
5	46685872	.	A	G	16	21	37	0	3	40	0	0
5	46724854	.	G	A	25	17	42	0	0	42	0	0
5	46724893	.	G	T	17	23	40	1	0	41	0	0
5	47727760	.	C	T	2	25	27	0	17	44	0	0
5	47863190	.	G	C	3	2	5	0	0	5	0	0
5	47914036	.	T	C	4	3	7	0	0	7	0	0
5	47924339	.	G	C	1	2	3	0	0	3	0	0
5	47949989	.	A	G	3	0	3	0	5	8	0	0
5	47950082	.	A	C	3	7	10	0	0	10	0	0
5	47950862	.	C	T	6	4	10	0	0	10	0	0
5	47953562	.	G	A	3	8	11	0	0	11	0	0
5	47955833	.	C	A	2	7	9	0	0	9	0	0
5	47968970	.	C	T	7	9	16	0	0	16	0	0
5	47970622	.	A	G	8	7	15	0	0	15	0	0
5	47972770	.	T	C	4	1	5	0	5	10	0	0
5	47973579	.	A	T	6	2	8	0	0	8	0	0
5	47975285	.	A	T	1	4	5	0	0	5	0	0
5	47975340	.	A	T	3	3	6	0	3	9	0	0
5	47976525	.	C	T	5	3	8	0	0	8	0	0
5	47976747	.	C	A	8	2	10	0	0	10	0	0
5	47976827	.	A	G	7	5	12	0	5	17	0	0
5	47977673	.	G	T	4	3	7	0	0	7	0	0
5	48022757	.	T	C	3	6	9	0	0	9	0	0
5	48022826	.	G	A	0	2	2	0	3	5	0	0
5	48028338	.	C	A	1	2	3	0	0	3	0	0
5	48028406	.	A	C	12	8	20	0	0	20	0	0
5	48028435	.	G	T	12	8	20	0	0	20	0	0
5	48028508	.	T	C	9	5	14	0	0	14	0	0
5	48029494	.	A	C	7	0	7	1	0	10	2	0
5	48029510	.	C	A	6	6	12	0	0	12	0	0
5	48029667	.	G	A	1	6	7	0	1	8	0	0
5	48029720	.	T	G	6	5	11	0	0	11	0	0
5	48029732	.	C	T	0	4	4	0	7	11	0	0
5	48029793	.	C	T	1	5	6	0	0	6	0	0
5	48029805	.	A	C	1	6	7	0	0	7	0	0
5	48029828	.	A	T	1	8	9	0	0	9	0	0
5	48033995	.	T	C	3	2	5	0	0	5	0	0
5	48034061	.	A	G	4	2	6	0	0	6	0	0
5	48036243	.	C	T	6	6	12	0	1	13	0	0
5	48036246	.	G	C	6	8	14	0	0	14	0	0
5	48050510	.	C	A	1	3	4	0	0	4	0	0
5	48110331	.	G	A	5	11	16	0	0	16	0	0
5	48154436	.	G	A	15	15	30	0	1	31	0	0
5	48154456	.	T	A	13	18	31	0	2	33	0	0
5	48172446	.	C	A	0	13	13	0	7	20	0	0
5	48182088	.	A	G	18	4	22	0	1	23	0	0
5	48182265	.	A	G	7	2	9	0	3	12	0	0
5	48182550	.	A	T	8	6	14	0	0	14	0	0
5	48182725	.	T	C	9	6	15	0	1	16	0	0
5	48183577	.	C	T	1	14	15	0	15	30	0	0
5	48183579	.	A	G	14	14	28	0	1	29	0	0
5	48183628	.	T	C	14	1	15	0	13	28	0	0
5	48208539	.	G	A	14	8	22	0	0	22	0	0
5	48208572	.	G	A	9	6	15	0	1	16	0	0
5	48242529	.	T	G	7	10	17	0	1	18	0	0
5	48242610	.	G	A	10	7	17	0	1	18	0	0
5	48285619	.	C	T	8	9	17	0	0	17	0	0
5	48664229	.	T	C	4	3	7	0	0	7	0	0
5	48664289	.	T	C	5	0	5	0	4	9	0	0
5	48672740	.	G	A	3	4	7	0	0	7	0	0
5	48672970	.	G	A	1	2	3	0	0	3	0	0
5	48673501	.	A	G	9	12	21	0	1	22	0	0
5	48673639	.	C	A	0	5	5	0	4	9	0	0
5	48673720	.	A	G	5	5	10	0	0	10	0	0
5	48679320	.	A	G	5	3	8	0	0	8	0	0
5	48679428	.	A	T	10	5	15	0	1	16	0	0
5	48679482	.	A	T	12	9	21	0	0	21	0	0
5	48680486	.	T	C	3	2	5	0	0	5	0	0
5	48806776	.	C	T	1	3	4	0	1	5	0	0
5	48806800	.	G	A	2	2	4	0	0	4	0	0
5	48822761	.	G	A	1	2	3	0	0	3	0	0
5	48833078	.	C	T	1	3	4	0	0	4	0	0
5	48833105	.	C	T	2	3	5	0	0	5	0	0
5	48833303	.	G	A	4	4	8	0	0	8	0	0
5	48835380	.	G	A	1	2	3	0	2	5	0	0
5	48842023	.	A	T	2	2	4	0	0	4	0	0
5	48893880	.	G	A	5	4	9	0	1	10	0	0
5	48935981	.	C	T	1	2	3	0	0	3	0	0
5	48936032	.	C	T	5	3	8	0	1	9	0	0
5	48986109	.	G	A	6	8	14	0	0	14	0	0
5	48986405	.	T	A	14	11	25	1	1	27	0	0
5	48986410	.	G	T	16	11	27	1	0	28	0	0
5	48986565	.	A	G	10	12	22	0	0	22	0	0
5	48986626	.	A	T	12	15	27	0	1	28	0	0
5	48986939	.	C	T	17	10	27	0	0	27	0	0
5	48987007	.	A	T	12	15	27	0	2	29	0	0
5	48987199	.	C	T	17	19	36	0	0	36	0	0
5	48987356	.	G	T	8	18	26	0	1	27	0	0
5	48987920	.	T	C	14	12	26	0	0	26	0	0
5	48988051	.	C	T	0	12	12	0	14	26	0	0
5	48988084	.	A	G	10	7	17	0	5	22	0	0
5	48992401	.	T	C	11	0	11	0	13	24	0	0
5	48992972	.	C	T	0	4	4	0	13	17	0	0
5	48993345	.	T	C	7	8	15	0	2	17	0	0
5	48995559	.	A	T	10	10	20	0	0	20	0	0
5	48995613	.	A	G	15	10	25	0	1	26	0	0
5	48995637	.	A	T	22	12	34	0	2	36	0	0
5	48995860	.	A	G	3	7	10	0	0	10	0	0
5	48995884	.	G	A	13	14	27	0	0	27	0	0
5	48995945	.	G	A	8	8	16	0	0	16	0	0
5	49019451	.	G	A	2	3	5	0	0	5	0	0
5	49019456	.	G	A	2	2	4	0	0	4	0	0
5	49019528	.	T	C	2	2	4	1	0	5	0	0
5	49019744	.	A	T	5	3	8	0	0	8	0	0
5	49019746	.	C	A	5	3	8	0	0	8	0	0
5	49019798	.	A	T	2	3	5	0	0	5	0	0
5	49021535	.	G	T	7	3	10	0	0	10	0	0
5	49028707	.	G	T	1	2	3	0	0	3	0	0
5	49734581	.	C	T	5	7	12	0	0	12	0	0
5	49734889	.	C	T	11	4	15	0	0	15	0	0
5	49735022	.	G	T	3	2	5	0	1	6	0	0
5	49735135	.	C	A	4	4	8	0	0	8	0	0
5	49735453	.	T	C	2	5	7	0	0	7	0	0
5	49735942	.	T	G	4	3	7	0	0	7	0	0
5	49743020	.	A	T	6	7	13	0	0	13	0	0
5	49745130	.	T	A	13	12	25	0	0	25	0	0
5	49747271	.	G	T	0	15	15	1	21	37	0	0
5	49750765	.	C	T	12	10	22	0	0	22	0	0
5	49750796	.	A	C	4	11	15	0	0	15	0	0
5	49768774	.	C	G	1	1	2	0	1	3	0	0
5	49768977	.	A	G	4	2	6	0	0	6	0	0
5	49769711	.	C	G	6	8	14	0	1	15	0	0
5	49769812	.	A	T	4	8	12	0	0	12	0	0
5	49919762	.	G	A	2	2	4	0	0	4	0	0
5	50035819	.	A	C	7	0	7	0	7	14	0	0
5	50038692	.	G	T	5	4	9	0	0	9	0	0
5	50081761	.	T	C	2	0	2	0	7	9	0	0
5	50081817	.	A	C	5	0	5	0	6	11	0	0
5	50086657	.	C	T	2	2	4	0	0	4	0	0
5	50253447	.	T	A	4	2	6	0	0	6	0	0
5	50256327	.	T	G	3	2	5	0	0	5	0	0
5	50279592	.	C	T	1	2	3	0	0	3	0	0
5	50296731	.	C	T	1	2	3	0	0	3	0	0
5	50435897	.	G	A	4	4	8	0	0	8	0	0
5	50436028	.	C	T	5	9	14	0	0	14	0	0
5	50436127	.	C	T	2	4	6	0	1	7	0	0
5	50443077	.	T	C	10	11	21	0	7	28	0	0
5	50443184	.	A	G	12	14	26	0	0	26	0	0
5	50443211	.	C	A	12	9	21	0	0	21	0	0
5	50443399	.	G	C	19	6	25	0	2	27	0	0
5	50443418	.	T	A	16	21	37	0	1	38	0	0
5	50443466	.	A	G	16	15	31	0	1	32	0	0
5	50465188	.	C	T	0	11	11	0	13	24	0	0
5	50465649	.	G	A	10	10	20	0	1	21	0	0
5	50520009	.	G	A	14	20	34	0	0	34	0	0
5	50544227	.	G	A	8	5	13	0	0	13	0	0
5	50544281	.	T	C	6	7	13	0	0	13	0	0
5	50576699	.	G	A	10	6	16	0	0	16	0	0
5	50576705	.	A	G	8	8	16	0	1	17	0	0
5	50582271	.	G	A	9	4	13	0	1	14	0	0
5	50582482	.	T	G	3	6	9	0	1	10	0	0
5	50582594	.	A	G	5	9	14	0	1	15	0	0
5	50594268	.	C	T	2	5	7	0	2	9	0	0
5	50594298	.	G	C	5	0	5	0	5	10	0	0
5	50636003	.	G	A	6	7	13	0	0	13	0	0
5	50636066	.	C	T	2	8	10	0	9	19	0	0
5	50781108	.	G	A	3	8	11	0	1	12	0	0
5	50781246	.	G	A	7	5	12	0	0	12	0	0
5	50817403	.	C	T	5	3	8	0	1	9	0	0
5	50817414	.	C	T	1	5	6	0	1	7	0	0
5	50819775	.	C	T	4	11	15	0	0	15	0	0
5	50819811	.	G	A	6	9	15	0	0	15	0	0
5	50820988	.	A	G	2	3	5	0	0	5	0	0
5	50821047	.	T	C	3	3	6	0	0	6	0	0
5	50821075	.	A	T	3	3	6	0	0	6	0	0
5	50828304	.	G	T	2	4	6	0	0	6	0	0
5	50831444	.	T	A	6	4	10	0	0	10	0	0
5	50837383	.	G	T	7	2	9	0	0	9	0	0
5	50837467	.	C	T	5	4	9	0	0	9	0	0
5	50839022	.	T	C	4	0	4	0	10	14	0	0
5	50840669	.	G	T	5	2	7	0	0	7	0	0
5	50840893	.	A	G	5	8	13	0	1	14	0	0
5	50843374	.	G	T	4	3	7	0	0	7	0	0
5	50843399	.	C	T	0	3	3	0	4	7	0	0
5	50843442	.	G	A	3	2	5	0	1	6	0	0
5	50844377	.	A	G	2	3	5	0	0	5	0	0
5	50847528	.	G	T	3	4	7	0	0	7	0	0
5	50848691	.	A	T	3	2	5	0	0	5	0	0
5	50848985	.	G	C	5	2	7	0	0	7	0	0
5	50856928	.	C	A	2	2	4	0	0	4	0	0
5	50856945	.	G	A	3	2	5	0	1	6	0	0
5	50866884	.	T	G	3	3	6	0	0	6	0	0
5	50869192	.	A	G	1	2	3	0	0	3	0	0
5	50869213	.	T	C	2	3	5	0	0	5	0	0
5	50869828	.	G	A	0	2	2	0	1	3	0	0
5	50869840	.	C	G	1	2	3	0	0	3	0	0
5	50869887	.	T	G	3	3	6	0	0	6	0	0
5	50871801	.	G	T	0	2	2	0	4	6	0	0
5	50872348	.	G	A	3	2	5	0	0	5	0	0
5	50872448	.	C	A	5	2	7	0	0	7	0	0
5	50872460	.	A	G	1	4	5	0	1	6	0	0
5	50874827	.	A	G	4	4	8	0	1	9	0	0
5	50874881	.	G	T	5	5	10	0	0	10	0	0
5	50877597	.	C	A	2	4	6	0	0	6	0	0
5	50879164	.	G	A	0	2	2	0	3	5	0	0
5	50879493	.	G	A	0	3	3	0	2	5	0	0
5	50886309	.	C	T	1	3	4	0	0	4	0	0
5	50889675	.	T	G	4	3	7	0	0	7	0	0
5	50889714	.	G	A	2	2	4	0	1	5	0	0
5	50892968	.	T	A	5	5	10	0	1	11	0	0
5	50893082	.	A	G	5	0	5	0	4	9	0	0
5	50895544	.	C	T	1	3	4	0	0	4	0	0
5	50897465	.	G	T	0	4	4	0	5	9	0	0
5	50897528	.	C	A	2	2	4	0	0	4	0	0
5	50949712	.	A	T	3	2	5	0	0	5	0	0
5	50953383	.	C	A	1	2	3	0	0	3	0	0
5	50960402	.	C	A	3	3	6	0	0	6	0	0
5	50960453	.	T	C	2	2	4	0	0	4	0	0
5	50967003	.	C	A	1	2	3	0	0	3	0	0
5	50969971	.	G	T	0	3	3	0	1	4	0	0
5	50969974	.	C	G	1	3	4	0	0	4	0	0
5	50970360	.	A	G	0	3	3	0	0	3	0	0
5	50973014	.	C	T	4	2	6	0	0	6	0	0
5	50973039	.	C	T	3	2	5	0	1	6	0	0
5	50973357	.	T	A	5	2	7	0	0	7	0	0
5	50973471	.	C	G	5	8	13	0	0	13	0	0
5	50973518	.	A	C	12	8	20	0	0	20	0	0
5	50973625	.	A	T	5	8	13	1	1	15	0	0
5	50973669	.	C	T	0	10	10	0	6	16	0	0
5	50973748	.	C	T	4	7	11	0	2	13	0	0
5	50978920	.	G	C	10	3	13	0	0	13	0	0
5	50981198	.	G	A	5	6	11	0	1	12	0	0
5	50981201	.	C	T	6	7	13	0	0	13	0	0
5	50983029	.	G	A	4	5	9	0	0	9	0	0
5	50983097	.	G	T	1	5	6	0	2	8	0	0
5	50983137	.	C	A	6	3	9	0	0	9	0	0
5	50988165	.	T	C	2	5	7	0	0	7	0	0
5	50990275	.	G	A	6	3	9	0	0	9	0	0
5	50990278	.	G	A	2	6	8	0	0	8	0	0
5	50992542	.	G	T	2	3	5	0	0	5	0	0
5	51102044	.	T	C	5	4	9	0	0	9	0	0
5	51102266	.	C	T	2	4	6	0	0	7	1	0
5	51102602	.	T	G	4	5	9	0	0	9	0	0
5	51102641	.	T	C	5	6	11	0	1	12	0	0
5	51102828	.	G	A	1	4	5	0	0	5	0	0
5	51102947	.	C	A	2	8	10	0	1	11	0	0
5	51103006	.	T	C	8	3	11	0	0	11	0	0
5	51103007	.	T	C	3	7	10	0	1	11	0	0
5	51103043	.	T	C	5	8	13	0	0	13	0	0
5	51103411	.	G	A	8	5	13	0	0	13	0	0
5	51103550	.	G	A	6	6	12	0	0	12	0	0
5	51103904	.	A	T	4	6	10	0	1	11	0	0
5	51103944	.	A	T	5	4	9	0	0	9	0	0
5	51104010	.	G	A	6	5	11	0	0	11	0	0
5	51104458	.	G	T	7	4	11	0	0	11	0	0
5	51111786	.	G	A	2	2	4	0	1	5	0	0
5	51117800	.	G	A	4	5	9	0	0	9	0	0
5	51121295	.	G	A	4	5	9	0	0	9	0	0
5	51124803	.	A	G	6	7	13	0	0	13	0	0
5	51133499	.	T	C	1	2	3	0	0	3	0	0
5	51169354	.	A	T	3	6	9	0	0	9	0	0
5	51169376	.	T	C	2	0	2	0	7	9	0	0
5	51169732	.	G	A	2	2	4	0	0	4	0	0
5	51170048	.	C	T	3	2	5	0	0	5	0	0
5	51170113	.	G	A	2	4	6	0	0	6	0	0
5	51170375	.	C	T	3	2	5	0	0	5	0	0
5	51170577	.	G	A	4	4	8	0	0	8	0	0
5	51170595	.	A	G	2	2	4	0	0	4	0	0
5	51171072	.	G	A	4	4	8	1	0	9	0	0
5	51202374	.	T	A	1	2	3	0	1	4	0	0
5	51202938	.	G	A	4	7	11	0	0	11	0	0
5	51203146	.	C	T	4	4	8	0	1	9	0	0
5	51205439	.	G	T	2	3	5	0	0	5	0	0
5	51205473	.	T	A	2	5	7	0	0	7	0	0
5	51205593	.	G	A	6	5	11	0	1	12	0	0
5	51208565	.	G	A	3	2	5	1	0	6	0	0
5	51227011	.	T	A	11	8	19	0	0	19	0	0
5	51227197	.	C	T	10	11	21	0	0	21	0	0
5	51228935	.	G	A	6	6	12	0	1	13	0	0
5	51230665	.	C	G	4	8	12	0	0	12	0	0
5	51236457	.	C	A	4	6	10	0	1	11	0	0
5	51236528	.	A	G	7	8	15	0	1	16	0	0
5	51240588	.	T	C	5	8	13	0	1	14	0	0
5	51240679	.	A	G	6	6	12	0	1	13	0	0
5	51240830	.	T	C	9	4	13	0	0	13	0	0
5	51240936	.	A	G	3	3	6	0	0	6	0	0
5	51241023	.	A	G	7	5	12	0	0	12	0	0
5	51241095	.	C	T	4	4	8	0	0	8	0	0
5	51242020	.	C	T	4	6	10	0	0	10	0	0
5	51242572	.	C	T	1	5	6	0	2	8	0	0
5	51242684	.	A	G	4	5	9	0	0	9	0	0
5	51242882	.	A	G	9	10	19	0	1	20	0	0
5	51242904	.	C	T	10	6	16	0	1	17	0	0
5	51243006	.	T	A	8	5	13	0	1	14	0	0
5	51243068	.	A	G	10	11	21	0	0	21	0	0
5	51243085	.	C	A	8	7	15	0	0	15	0	0
5	51243157	.	T	A	6	7	13	0	1	14	0	0
5	51243243	.	C	T	2	6	8	0	1	9	0	0
5	51243287	.	G	A	7	2	9	0	0	9	0	0
5	51243341	.	G	A	7	2	9	0	1	10	0	0
5	51243635	.	C	T	13	11	24	0	0	24	0	0
5	51243645	.	A	T	8	11	19	0	1	20	0	0
5	51243680	.	T	G	11	7	18	0	0	18	0	0
5	51243706	.	C	T	13	7	20	0	1	21	0	0
5	51257110	.	C	T	1	2	3	0	0	3	0	0
5	51271871	.	C	T	2	2	4	0	0	4	0	0
5	51360567	.	C	T	1	2	3	0	1	4	0	0
5	51360591	.	C	T	2	4	6	0	0	6	0	0
5	51425579	.	C	A	2	2	4	0	0	4	0	0
5	51438782	.	T	C	4	4	8	0	0	8	0	0
5	51443310	.	T	A	2	4	6	0	0	6	0	0
5	51515847	.	T	C	1	3	4	0	1	5	0	0
5	51521887	.	G	A	2	7	9	0	0	9	0	0
5	51525739	.	C	T	3	6	9	0	1	10	0	0
5	51532096	.	C	A	4	3	7	0	0	7	0	0
5	51538738	.	C	T	2	5	7	0	0	7	0	0
5	51546497	.	T	C	4	6	10	0	1	11	0	0
5	51546541	.	C	T	6	7	13	0	0	13	0	0
5	51548092	.	C	T	10	6	16	0	0	16	0	0
5	51548107	.	A	G	6	0	6	0	11	17	0	0
5	51559010	.	C	G	5	0	5	0	6	11	0	0
5	51575756	.	C	T	3	2	5	0	0	5	0	0
5	51578328	.	G	A	1	5	6	0	0	6	0	0
5	51579076	.	C	T	2	5	7	0	0	7	0	0
5	51616474	.	A	T	4	2	6	0	1	7	0	0
5	51616580	.	A	T	5	2	7	0	0	7	0	0
5	51616704	.	C	G	10	4	14	0	0	14	0	0
5	51616959	.	G	A	7	5	12	0	1	13	0	0
5	51619248	.	C	T	6	4	10	0	1	11	0	0
5	51775190	.	C	T	8	5	13	0	0	13	0	0
5	51775291	.	A	T	12	8	20	0	0	20	0	0
5	51775364	.	A	T	15	17	32	0	0	32	0	0
5	51775458	.	A	C	21	8	29	0	0	29	0	0
5	51775501	.	T	G	12	12	24	0	1	25	0	0
5	51775642	.	T	A	15	17	32	0	0	32	0	0
5	51775962	.	G	T	15	14	29	0	4	33	0	0
5	51776150	.	C	A	21	8	29	0	0	29	0	0
5	51779513	.	C	T	28	11	39	0	2	41	0	0
5	51789180	.	C	T	0	3	3	0	6	9	0	0
5	51792974	.	G	A	19	19	38	0	0	38	0	0
5	51834217	.	C	A	3	4	7	0	0	7	0	0
5	51835634	.	C	T	5	2	7	0	0	7	0	0
5	51836211	.	T	A	4	3	7	0	0	7	0	0
5	51840420	.	C	T	5	4	9	0	1	10	0	0
5	51840942	.	C	T	4	7	11	0	0	11	0	0
5	51846285	.	C	A	4	5	9	0	0	9	0	0
5	51847274	.	T	C	6	6	12	0	0	12	0	0
5	51847429	.	T	C	6	2	8	0	0	8	0	0
5	51886188	.	A	C	8	9	17	0	1	18	0	0
5	51894040	.	T	C	4	12	16	0	1	17	0	0
5	51898796	.	C	T	0	4	4	0	5	9	0	0
5	51898933	.	C	G	5	5	10	0	0	10	0	0
5	51902067	.	T	G	8	7	15	0	0	15	0	0
5	51902253	.	A	G	6	5	11	0	0	11	0	0
5	51935155	.	T	C	1	3	4	0	0	4	0	0
5	51947370	.	G	T	4	5	9	0	0	9	0	0
5	51947398	.	C	T	2	7	9	0	7	16	0	0
5	51947497	.	C	T	10	10	20	0	1	21	0	0
5	51947650	.	T	C	9	3	12	0	0	12	0	0
5	51947696	.	A	T	6	6	12	0	0	12	0	0
5	51947852	.	A	T	8	8	16	0	0	16	0	0
5	51947927	.	T	C	8	1	9	0	3	12	0	0
5	51947976	.	C	G	6	7	13	0	0	13	0	0
5	51948017	.	G	T	5	4	9	0	0	9	0	0
5	51948146	.	G	A	4	9	13	0	0	13	0	0
5	51948207	.	T	C	6	5	11	0	0	11	0	0
5	51948708	.	A	T	3	8	11	0	0	11	0	0
5	51948737	.	C	T	1	6	7	0	4	11	0	0
5	51948755	.	C	A	6	7	13	0	1	14	0	0
5	51948825	.	T	C	6	8	14	0	0	14	0	0
5	51948827	.	C	G	9	5	14	0	0	14	0	0
5	51948870	.	A	G	4	13	17	0	0	17	0	0
5	51949069	.	T	A	7	13	20	0	1	21	0	0
5	51949115	.	G	T	7	11	18	0	2	20	0	0
5	51950032	.	G	C	5	9	14	0	1	15	0	0
5	51950357	.	C	T	0	3	3	0	5	8	0	0
5	51958296	.	T	A	4	5	9	0	0	9	0	0
5	51960989	.	G	A	6	3	9	0	0	9	0	0
5	51961039	.	C	T	3	5	8	0	1	9	0	0
5	51968073	.	A	G	4	2	6	0	1	7	0	0
5	52002660	.	T	G	5	5	10	0	0	10	0	0
5	52002708	.	T	C	6	4	10	0	3	13	0	0
5	52002743	.	T	G	4	5	9	0	0	9	0	0
5	52005851	.	G	T	4	14	18	0	1	19	0	0
5	52005893	.	C	T	2	8	10	0	1	11	0	0
5	52007700	.	C	T	4	6	10	0	0	10	0	0
5	52010134	.	C	T	0	2	2	0	1	3	0	0
5	52039107	.	C	A	10	3	13	0	0	13	0	0
5	52039112	.	G	A	10	3	13	0	0	13	0	0
5	52039349	.	T	C	8	5	13	0	1	14	0	0
5	52068001	.	T	C	8	6	14	0	1	15	0	0
5	52068332	.	G	A	6	5	11	0	2	13	0	0
5	52068422	.	C	T	5	2	7	0	0	7	0	0
5	52068452	.	G	A	3	2	5	0	0	5	0	0
5	52121557	.	T	C	4	7	11	0	0	11	0	0
5	52121629	.	G	A	9	3	12	0	0	12	0	0
5	52121680	.	G	T	9	6	15	0	0	15	0	0
5	52121759	.	A	G	3	7	10	0	0	10	0	0
5	52121801	.	G	C	7	7	14	0	0	14	0	0
5	52121923	.	C	G	8	4	12	0	0	12	0	0
5	52122057	.	C	G	9	0	9	0	6	15	0	0
5	52122189	.	C	G	6	6	12	0	0	12	0	0
5	52122637	.	C	T	8	5	13	0	0	13	0	0
5	52122779	.	C	G	7	3	10	0	1	11	0	0
5	52123640	.	G	T	17	11	28	0	2	30	0	0
5	52124734	.	A	G	10	14	24	0	0	24	0	0
5	52132468	.	G	A	8	14	22	0	0	22	0	0
5	52132498	.	A	T	6	9	15	0	0	15	0	0
5	52132561	.	C	T	5	7	12	0	0	12	0	0
5	52132966	.	A	G	9	6	15	0	2	17	0	0
5	52190969	.	A	G	1	3	4	0	0	4	0	0
5	52191039	.	C	T	0	3	3	0	2	5	0	0
5	52191185	.	G	T	3	2	5	1	1	7	0	0
5	52191288	.	C	A	4	3	7	0	0	7	0	0
5	52191593	.	C	T	4	2	6	0	1	7	0	0
5	52191630	.	T	C	5	3	8	0	0	8	0	0
5	52192470	.	G	T	5	2	7	0	0	7	0	0
5	52192545	.	T	A	5	3	8	0	0	8	0	0
5	52192557	.	C	T	3	3	6	0	0	6	0	0
5	52192704	.	T	C	2	1	3	0	8	11	0	0
5	52193066	.	C	T	5	5	10	0	0	10	0	0
5	52193249	.	T	G	6	2	8	0	1	9	0	0
5	52193817	.	A	G	3	8	11	0	0	11	0	0
5	52197793	.	C	T	2	5	7	0	0	7	0	0
5	52198066	.	G	A	8	9	17	0	1	18	0	0
5	52199622	.	C	T	3	4	7	0	1	8	0	0
5	52201458	.	T	C	3	0	3	0	4	7	0	0
5	52211755	.	G	A	7	8	15	0	0	15	0	0
5	52215311	.	A	G	2	6	8	0	0	8	0	0
5	52215356	.	A	C	4	4	8	0	0	8	0	0
5	52215386	.	T	A	5	4	9	0	0	9	0	0
5	52215405	.	T	A	3	3	6	0	1	7	0	0
5	52227030	.	A	C	3	3	6	0	0	6	0	0
5	52227190	.	T	A	4	5	9	0	0	9	0	0
5	52227393	.	T	C	9	3	12	0	0	12	0	0
5	52227570	.	C	T	2	3	5	0	1	6	0	0
5	52227686	.	A	G	2	4	6	0	1	7	0	0
5	52234708	.	A	G	1	6	7	0	1	8	0	0
5	52235144	.	A	G	6	4	10	0	0	10	0	0
5	52235385	.	C	T	5	3	8	0	0	8	0	0
5	52236775	.	G	T	3	10	13	0	0	13	0	0
5	52237001	.	T	G	3	6	9	0	0	9	0	0
5	52237028	.	C	T	4	5	9	0	0	9	0	0
5	52237039	.	G	A	3	4	7	0	1	8	0	0
5	52237263	.	T	C	1	0	1	0	9	10	0	0
5	52237449	.	G	C	4	0	4	0	10	14	0	0
5	52240005	.	C	T	0	2	2	0	3	5	0	0
5	52240397	.	C	T	1	2	3	0	2	5	0	0
5	52240449	.	C	A	3	3	6	0	0	6	0	0
5	52242924	.	C	G	0	6	6	0	4	10	0	0
5	52243245	.	G	A	4	2	6	0	0	6	0	0
5	52243263	.	G	A	5	1	6	0	0	6	0	0
5	52257106	.	A	C	7	0	7	0	4	11	0	0
5	52257299	.	G	A	6	12	18	0	1	19	0	0
5	52257976	.	G	T	3	12	15	0	1	16	0	0
5	52258036	.	G	A	5	6	11	0	1	12	0	0
5	52258234	.	G	A	6	13	19	1	1	21	0	0
5	52258268	.	C	G	4	13	17	1	1	19	0	0
5	52258518	.	C	T	14	13	27	0	1	28	0	0
5	52258614	.	C	A	8	7	15	0	0	15	0	0
5	52258721	.	C	G	5	4	9	0	0	9	0	0
5	52258921	.	T	G	7	6	13	0	1	14	0	0
5	52259221	.	T	A	10	4	14	0	0	14	0	0
5	52259542	.	G	C	8	0	8	0	7	15	0	0
5	52259579	.	A	T	6	7	13	0	0	13	0	0
5	52259825	.	C	A	11	12	23	0	0	23	0	0
5	52264354	.	C	T	0	13	13	0	5	18	0	0
5	52264456	.	C	G	1	11	12	0	12	24	0	0
5	52264512	.	G	A	8	6	14	0	1	15	0	0
5	52264549	.	C	T	6	5	11	0	0	11	0	0
5	52264654	.	C	G	0	11	11	0	12	23	0	0
5	52264663	.	G	A	9	12	21	0	0	21	0	0
5	52277282	.	G	A	13	4	17	0	0	17	0	0
5	52277390	.	G	A	10	11	21	0	0	21	0	0
5	52277448	.	A	T	12	8	20	0	1	21	0	0
5	52277487	.	T	A	10	7	17	0	0	17	0	0
5	52277574	.	G	A	10	6	16	0	2	18	0	0
5	52598377	.	C	T	4	2	6	0	0	6	0	0
5	52598546	.	A	T	8	8	16	0	1	17	0	0
5	52598563	.	G	A	11	10	21	0	0	21	0	0
5	52617922	.	A	G	9	9	18	0	0	18	0	0
5	52626169	.	A	G	4	0	4	0	3	7	0	0
5	52696865	.	T	A	10	5	15	0	3	18	0	0
5	52697519	.	A	C	16	12	28	0	2	30	0	0
5	52698067	.	G	A	17	10	27	0	0	27	0	0
5	52710951	.	A	G	8	17	25	0	1	26	0	0
5	52710957	.	G	A	11	15	26	0	1	27	0	0
5	52725675	.	C	T	8	12	20	0	1	21	0	0
5	52730540	.	C	T	9	9	18	0	1	19	0	0
5	52730645	.	C	T	12	6	18	0	1	19	0	0
5	52730704	.	C	T	8	6	14	0	0	14	0	0
5	52730742	.	G	C	10	5	15	0	2	17	0	0
5	52730793	.	G	A	3	11	14	0	1	15	0	0
5	52730846	.	C	A	10	6	16	0	1	17	0	0
5	52731647	.	G	A	3	14	17	0	7	24	0	0
5	52731678	.	A	T	16	10	26	0	2	28	0	0
5	52731787	.	G	A	6	13	19	0	0	19	0	0
5	52731919	.	C	A	10	4	14	0	0	14	0	0
5	52732146	.	C	T	13	12	25	0	0	25	0	0
5	52732147	.	G	A	13	11	24	0	1	25	0	0
5	52732383	.	C	T	18	7	25	0	2	27	0	0
5	52732727	.	G	A	14	10	24	1	2	27	0	0
5	52732931	.	C	T	12	14	26	0	0	26	0	0
5	52732991	.	A	G	10	0	10	0	15	25	0	0
5	52733022	.	G	T	18	12	30	0	0	30	0	0
5	52733230	.	G	A	16	10	26	0	1	27	0	0
5	52733259	.	T	G	15	10	25	0	0	25	0	0
5	52733266	.	T	G	11	12	23	0	0	23	0	0
5	52733370	.	A	T	18	14	32	0	2	34	0	0
5	52733411	.	G	A	10	10	20	0	1	21	0	0
5	52745571	.	T	G	6	5	11	0	0	11	0	0
5	52748724	.	T	C	3	3	6	0	0	6	0	0
5	52751568	.	C	T	0	3	3	0	8	11	0	0
5	52752441	.	T	A	8	4	12	0	1	13	0	0
5	52752479	.	A	G	3	5	8	0	1	9	0	0
5	52783758	.	C	T	3	3	6	0	0	6	0	0
5	52845320	.	A	G	4	8	12	0	0	12	0	0
5	52845497	.	A	C	3	1	4	0	1	6	1	0
5	52845638	.	C	T	3	6	9	0	3	12	0	0
5	52855974	.	A	T	9	7	16	0	1	17	0	0
5	52858847	.	C	T	6	5	11	0	0	11	0	0
5	52858898	.	A	G	6	0	6	0	12	18	0	0
5	52859422	.	T	G	7	7	14	0	0	14	0	0
5	52859510	.	C	T	7	5	12	0	0	12	0	0
5	52859624	.	A	G	3	1	4	0	5	9	0	0
5	52859751	.	G	T	6	9	15	0	0	15	0	0
5	52860209	.	A	T	3	6	9	0	0	9	0	0
5	52860243	.	T	A	4	6	10	0	1	11	0	0
5	52860310	.	T	A	6	5	11	0	0	11	0	0
5	52860413	.	G	A	2	8	10	0	6	16	0	0
5	52860503	.	A	T	9	11	20	0	1	21	0	0
5	52860701	.	G	T	7	7	14	0	2	16	0	0
5	52860718	.	G	C	8	10	18	0	0	18	0	0
5	52860863	.	G	T	6	12	18	0	3	21	0	0
5	52861213	.	T	C	6	6	12	0	4	16	0	0
5	52861239	.	G	T	0	9	9	0	10	19	0	0
5	52861266	.	A	C	9	6	15	0	0	15	0	0
5	52861818	.	G	A	7	4	11	0	2	13	0	0
5	52937798	.	A	G	2	2	4	0	0	4	0	0
5	52937849	.	A	T	6	2	8	0	1	9	0	0
5	52937956	.	A	T	11	5	16	0	1	17	0	0
5	52937988	.	T	A	5	11	16	0	0	16	0	0
5	52938528	.	A	G	2	8	10	0	1	11	0	0
5	52938532	.	T	C	2	8	10	0	0	10	0	0
5	52938742	.	C	T	5	5	10	0	0	10	0	0
5	52938787	.	C	A	2	5	7	0	0	7	0	0
5	52939163	.	T	C	5	5	10	0	0	10	0	0
5	52971471	.	T	A	1	4	5	0	0	5	0	0
5	52971478	.	C	T	2	4	6	0	0	6	0	0
5	52972260	.	A	G	3	7	10	0	0	10	0	0
5	52972323	.	C	A	7	7	14	0	0	14	0	0
5	52988108	.	C	T	13	8	21	0	3	24	0	0
5	52988147	.	C	T	7	9	16	0	0	16	0	0
5	53003463	.	C	G	0	9	9	0	6	15	0	0
5	53003640	.	C	G	5	6	11	0	0	11	0	0
5	53003896	.	G	A	8	8	16	0	1	17	0	0
5	53003988	.	A	C	7	0	7	0	6	14	1	0
5	53734556	.	C	T	4	7	11	0	0	11	0	0
5	53748244	.	C	T	8	3	11	0	0	11	0	0
5	53748304	.	T	G	3	8	11	0	1	12	0	0
5	53759491	.	A	T	8	7	15	0	1	16	0	0
5	53876236	.	A	T	14	13	27	0	1	28	0	0
5	53876244	.	G	A	17	17	34	0	2	36	0	0
5	53899585	.	G	T	11	8	19	0	2	21	0	0
5	53908613	.	T	A	2	3	5	0	0	5	0	0
5	53908722	.	G	T	5	3	8	0	0	8	0	0
5	53908892	.	A	G	3	9	12	0	0	12	0	0
5	53908893	.	G	A	3	8	11	0	1	12	0	0
5	53908957	.	A	T	4	8	12	0	0	12	0	0
5	53909509	.	G	A	0	6	6	0	4	10	0	0
5	53909914	.	C	T	4	5	9	0	0	9	0	0
5	53910004	.	G	A	2	3	5	0	0	5	0	0
5	54280198	.	A	T	4	3	7	0	1	8	0	0
5	54280223	.	C	T	3	5	8	0	1	9	0	0
5	54280436	.	A	T	2	3	5	0	0	5	0	0
5	54280495	.	T	G	1	4	5	0	0	5	0	0
5	54280801	.	G	A	1	4	5	0	0	5	0	0
5	54280889	.	G	A	9	4	13	1	0	14	0	0
5	54290289	.	C	A	5	7	12	0	0	12	0	0
5	54297376	.	T	A	2	7	9	0	0	9	0	0
5	54297377	.	C	T	2	7	9	0	0	9	0	0
5	54304666	.	C	G	1	2	3	0	0	3	0	0
5	54304731	.	T	A	5	6	11	0	1	12	0	0
5	54304736	.	G	T	6	5	11	0	1	12	0	0
5	54309452	.	G	T	8	11	19	1	0	20	0	0
5	54337575	.	G	A	5	3	8	0	1	9	0	0
5	54337831	.	T	A	8	10	18	0	1	19	0	0
5	54337880	.	T	C	13	1	14	0	10	24	0	0
5	54337902	.	C	T	7	15	22	0	1	23	0	0
5	54337934	.	C	A	12	7	19	0	0	19	0	0
5	54339740	.	C	T	7	5	12	0	1	13	0	0
5	54340047	.	G	A	9	4	13	0	0	13	0	0
5	54342135	.	C	T	10	5	15	0	0	15	0	0
5	54342519	.	T	A	9	4	13	0	0	13	0	0
5	54395339	.	T	A	9	8	17	0	0	17	0	0
5	54416743	.	A	T	1	3	4	0	0	4	0	0
5	54416810	.	C	T	6	6	12	0	1	13	0	0
5	54416820	.	A	G	7	5	12	0	0	12	0	0
5	54439142	.	G	A	2	2	4	0	0	4	0	0
5	54458053	.	A	C	9	3	12	0	1	13	0	0
5	54458326	.	G	A	12	8	20	0	0	20	0	0
5	54458345	.	T	A	10	9	19	0	1	20	0	0
5	54458437	.	C	T	6	12	18	0	1	19	0	0
5	54458668	.	C	A	8	7	15	0	0	16	1	0
5	54458791	.	C	G	2	6	8	0	9	17	0	0
5	54458974	.	C	G	4	13	17	0	0	17	0	0
5	54459086	.	G	T	11	6	17	0	0	17	0	0
5	54459467	.	T	C	2	1	3	0	5	8	0	0
5	54459628	.	G	T	11	12	23	0	1	24	0	0
5	54459647	.	A	C	10	17	27	0	1	28	0	0
5	54459682	.	C	T	8	8	16	0	1	17	0	0
5	54459808	.	A	C	3	2	5	0	0	5	0	0
5	54460218	.	A	C	7	4	11	0	0	11	0	0
5	54460237	.	T	A	8	5	13	0	0	13	0	0
5	54460259	.	G	A	6	8	14	0	0	14	0	0
5	54460322	.	T	A	10	7	17	0	0	17	0	0
5	54460371	.	T	A	10	6	16	0	1	17	0	0
5	54460460	.	A	G	10	8	18	0	0	18	0	0
5	54460481	.	C	T	2	14	16	0	5	21	0	0
5	54460555	.	G	A	16	11	27	0	1	28	0	0
5	54460558	.	A	T	11	8	19	0	8	27	0	0
5	54467999	.	G	T	10	4	14	0	0	14	0	0
5	54470845	.	C	G	2	7	9	0	12	21	0	0
5	54470912	.	C	G	11	7	18	0	0	18	0	0
5	54473134	.	G	A	6	5	11	0	0	11	0	0
5	54482550	.	G	A	2	3	5	0	0	5	0	0
5	54482561	.	A	C	3	2	5	0	0	5	0	0
5	54482806	.	C	T	3	2	5	0	0	5	0	0
5	54483295	.	G	A	1	3	4	0	1	5	0	0
5	54492797	.	C	T	0	3	3	0	5	8	0	0
5	54492839	.	C	T	0	3	3	0	3	6	0	0
5	54493073	.	A	C	2	4	6	0	0	6	0	0
5	54497628	.	C	T	2	4	6	0	0	6	0	0
5	54498226	.	G	C	9	8	17	0	0	17	0	0
5	54498255	.	A	C	9	3	12	0	0	12	0	0
5	54498272	.	G	A	5	4	9	0	0	9	0	0
5	54498292	.	C	T	4	5	9	0	0	9	0	0
5	54498363	.	C	T	7	13	20	0	0	20	0	0
5	54498452	.	C	T	9	10	19	0	0	19	0	0
5	54501179	.	C	T	6	7	13	0	0	13	0	0
5	54501485	.	C	T	6	10	16	0	1	17	0	0
5	54501993	.	A	G	7	0	7	0	10	17	0	0
5	54502264	.	G	A	14	4	18	0	4	22	0	0
5	54502307	.	G	A	0	10	10	0	15	25	0	0
5	54502414	.	G	C	11	15	26	0	1	27	0	0
5	54502697	.	A	G	6	0	6	0	5	11	0	0
5	54552033	.	A	C	3	4	7	0	0	7	0	0
5	54555593	.	A	G	1	3	4	0	1	5	0	0
5	54557025	.	G	A	5	5	10	0	0	10	0	0
5	54558663	.	T	C	5	5	10	0	0	10	0	0
5	54558684	.	G	A	0	5	5	0	5	10	0	0
5	54558738	.	A	C	7	3	10	0	0	10	0	0
5	54558787	.	G	A	1	4	5	0	2	7	0	0
5	54564682	.	C	T	3	4	7	0	0	7	0	0
5	54564835	.	C	T	4	8	12	0	0	12	0	0
5	54565379	.	A	C	4	3	7	0	1	8	0	0
5	54572808	.	C	T	2	2	4	0	0	4	0	0
5	54572859	.	T	A	4	4	8	0	1	9	0	0
5	54576142	.	C	T	6	3	9	0	0	9	0	0
5	54576223	.	C	T	4	5	9	0	0	9	0	0
5	54576238	.	G	A	4	3	7	0	0	7	0	0
5	54579900	.	A	C	4	6	10	0	0	10	0	0
5	54579955	.	C	T	4	5	9	0	0	9	0	0
5	54580125	.	G	A	4	4	8	0	0	8	0	0
5	54585600	.	C	T	1	5	6	0	0	6	0	0
5	54585660	.	A	C	1	2	3	0	0	3	0	0
5	54586011	.	A	G	1	3	4	0	0	4	0	0
5	54586098	.	T	C	6	4	10	0	0	10	0	0
5	54602360	.	C	A	2	3	5	0	0	5	0	0
5	54610737	.	G	A	0	7	7	0	6	13	0	0
5	54624856	.	T	C	6	4	10	0	0	10	0	0
5	54628542	.	C	T	4	3	7	0	0	7	0	0
5	54628851	.	C	T	2	3	5	0	1	6	0	0
5	54652941	.	T	A	6	11	17	0	1	18	0	0
5	54652947	.	C	A	12	5	17	0	0	17	0	0
5	54656583	.	A	G	5	0	5	0	6	11	0	0
5	54656613	.	T	C	7	8	15	0	0	15	0	0
5	54672301	.	G	A	1	2	3	0	0	3	0	0
5	54672324	.	T	A	1	2	3	0	0	3	0	0
5	54685371	.	A	T	11	8	19	0	0	19	0	0
5	54685445	.	C	A	8	12	20	0	0	20	0	0
5	54712104	.	G	A	1	3	4	0	0	4	0	0
5	54712134	.	T	C	2	2	4	0	0	4	0	0
5	54719503	.	A	G	7	4	11	0	0	11	0	0
5	54719844	.	G	A	9	13	22	0	2	24	0	0
5	54720249	.	C	T	5	2	7	0	1	8	0	0
5	54724444	.	A	T	5	3	8	0	0	8	0	0
5	54724738	.	T	A	8	7	15	0	1	16	0	0
5	54726445	.	A	T	6	7	13	0	0	13	0	0
5	54726636	.	A	G	1	2	3	0	1	4	0	0
5	54767361	.	C	A	15	6	21	0	0	21	0	0
5	54767688	.	C	T	26	10	36	0	3	39	0	0
5	54767734	.	T	A	20	14	34	0	6	40	0	0
5	54768993	.	G	T	20	20	40	0	1	41	0	0
5	54769091	.	A	G	17	10	27	0	0	27	0	0
5	54769896	.	A	G	24	13	37	0	2	39	0	0
5	54769914	.	C	T	23	15	38	0	1	39	0	0
5	54770121	.	T	C	22	26	48	0	0	48	0	0
5	54770370	.	G	A	30	21	51	0	1	52	0	0
5	54770889	.	C	T	28	27	55	0	1	56	0	0
5	54772818	.	G	A	6	7	13	0	0	13	0	0
5	54772955	.	T	C	3	6	9	0	1	10	0	0
5	54773182	.	C	A	2	10	12	0	10	22	0	0
5	54776408	.	T	C	12	11	23	0	2	25	0	0
5	54776413	.	G	C	15	11	26	0	1	27	0	0
5	54778115	.	G	C	10	3	13	0	1	14	0	0
5	54778236	.	G	C	7	10	17	0	0	17	0	0
5	54790426	.	A	C	12	6	18	0	0	18	0	0
5	54790513	.	T	C	6	7	13	0	0	13	0	0
5	54790751	.	A	C	8	13	21	0	0	21	0	0
5	54790769	.	T	C	7	12	19	0	0	19	0	0
5	54790808	.	T	G	5	5	10	0	0	10	0	0
5	54792072	.	G	C	4	5	9	0	0	9	0	0
5	54958580	.	G	A	12	18	30	0	4	34	0	0
5	54961109	.	A	G	12	11	23	0	3	26	0	0
5	54964633	.	G	A	13	10	23	0	3	26	0	0
5	54965991	.	G	A	12	12	24	0	0	24	0	0
5	54966114	.	C	A	12	7	19	0	0	19	0	0
5	54967094	.	C	T	13	7	20	0	1	21	0	0
5	54971774	.	G	C	15	10	25	0	1	26	0	0
5	54974350	.	A	G	11	10	21	0	1	22	0	0
5	54977130	.	A	G	11	6	17	0	1	18	0	0
5	54982520	.	G	A	14	8	22	0	1	23	0	0
5	55160685	.	C	T	3	16	19	1	0	20	0	0
5	55165175	.	A	T	9	14	23	0	0	23	0	0
5	55168177	.	G	T	16	12	28	1	0	29	0	0
5	55200982	.	C	T	6	11	17	0	0	17	0	0
5	55371908	.	C	T	11	7	18	0	0	18	0	0
5	55372218	.	A	G	18	11	29	0	1	30	0	0
5	55372425	.	A	C	11	14	25	0	0	25	0	0
5	55372761	.	G	T	15	7	22	0	1	23	0	0
5	55372773	.	A	T	9	16	25	0	0	25	0	0
5	55373299	.	G	A	18	18	36	0	0	36	0	0
5	55373869	.	G	T	8	10	18	0	0	18	0	0
5	55374343	.	T	A	9	11	20	0	2	22	0	0
5	55374560	.	T	C	5	7	12	0	1	13	0	0
5	55588458	.	T	C	10	6	16	0	0	16	0	0
5	55588562	.	T	C	7	9	16	0	1	17	0	0
5	55599950	.	G	C	10	10	20	0	0	20	0	0
5	55600108	.	A	C	13	5	18	0	0	18	0	0
5	55600149	.	T	C	10	10	20	0	1	21	0	0
5	55600154	.	A	G	12	10	22	0	0	22	0	0
5	55600657	.	C	T	4	8	12	0	0	12	0	0
5	55600679	.	A	T	2	2	4	0	1	5	0	0
5	55604037	.	G	C	9	3	12	0	1	13	0	0
5	55604162	.	G	C	18	10	28	0	2	30	0	0
5	55604211	.	A	T	29	5	34	0	1	35	0	0
5	55604228	.	G	T	18	11	29	0	1	30	0	0
5	55604302	.	A	T	24	2	26	1	0	27	0	0
5	55604392	.	T	A	11	10	21	0	8	29	0	0
5	55604438	.	A	G	15	20	35	0	1	36	0	0
5	55609426	.	T	G	21	24	45	0	2	47	0	0
5	55613789	.	G	A	19	16	35	0	0	35	0	0
5	55613813	.	A	C	14	18	32	0	2	34	0	0
5	55613864	.	A	G	18	13	31	0	0	31	0	0
5	55613999	.	G	A	20	16	36	0	0	36	0	0
5	55626700	.	T	A	11	7	18	0	1	19	0	0
5	55648510	.	G	C	8	9	17	0	0	17	0	0
5	55669528	.	C	T	7	10	17	0	1	18	0	0
5	55674606	.	A	G	13	4	17	0	1	18	0	0
5	55686574	.	T	C	11	6	17	0	1	18	0	0
5	55689628	.	C	T	9	7	16	0	1	17	0	0
5	55720177	.	A	G	11	1	12	0	2	14	0	0
5	55720486	.	C	T	1	13	14	0	9	23	0	0
5	55723534	.	A	G	7	9	16	0	0	16	0	0
5	55763649	.	A	G	23	28	51	0	0	51	0	0
5	55763752	.	G	T	19	19	38	0	1	39	0	0
5	55763884	.	G	A	22	17	39	0	0	39	0	0
5	55764173	.	T	C	13	0	13	0	19	32	0	0
5	55764509	.	G	A	24	22	46	0	2	48	0	0
5	55773856	.	A	G	27	16	43	0	3	46	0	0
5	55866925	.	C	T	0	3	3	0	2	5	0	0
5	55873688	.	G	T	2	6	8	0	0	8	0	0
5	55873712	.	C	A	3	6	9	0	0	9	0	0
5	55876508	.	C	G	5	5	10	0	1	11	0	0
5	55876698	.	T	A	3	4	7	0	0	7	0	0
5	55893950	.	G	T	1	2	3	0	1	4	0	0
5	55895690	.	T	C	2	0	2	0	3	5	0	0
5	55895902	.	A	G	2	2	4	0	0	4	0	0
5	55920930	.	A	C	1	2	3	0	1	4	0	0
5	55920943	.	A	T	1	4	5	0	0	5	0	0
5	55921076	.	A	T	9	10	19	0	0	19	0	0
5	55921335	.	G	A	14	17	31	0	2	33	0	0
5	55921628	.	T	C	5	3	8	0	0	8	0	0
5	55921931	.	A	G	4	12	16	0	1	17	0	0
5	55928142	.	G	A	7	8	15	0	0	15	0	0
5	55928367	.	A	G	11	9	20	1	1	22	0	0
5	55933055	.	G	A	4	16	20	0	4	24	0	0
5	55933243	.	T	C	6	14	20	0	0	20	0	0
5	55936430	.	C	A	4	5	9	0	0	9	0	0
5	55951471	.	T	G	3	11	14	0	3	17	0	0
5	55951639	.	A	T	3	11	14	0	1	15	0	0
5	55951810	.	G	T	4	5	9	0	1	10	0	0
5	55951928	.	T	G	3	3	6	0	0	6	0	0
5	55951937	.	T	C	3	3	6	0	0	6	0	0
5	56099842	.	C	A	2	4	6	0	0	6	0	0
5	56100260	.	T	A	4	4	8	0	0	8	0	0
5	56102224	.	A	C	4	3	7	0	0	7	0	0
5	56110137	.	C	T	2	4	6	0	0	6	0	0
5	56113870	.	C	T	4	3	7	0	0	7	0	0
5	56113978	.	C	T	1	2	3	0	0	3	0	0
5	56268496	.	T	C	1	4	5	0	0	5	0	0
5	56268593	.	T	C	2	2	4	0	0	4	0	0
5	56268603	.	T	C	2	2	4	0	0	4	0	0
5	56271365	.	T	C	3	3	6	0	0	6	0	0
5	56273446	.	A	G	5	1	6	0	3	9	0	0
5	56274002	.	A	G	1	4	5	0	0	5	0	0
5	56274085	.	T	C	1	4	5	0	0	5	0	0
5	56277966	.	C	A	7	5	12	0	0	12	0	0
5	56277975	.	C	T	6	5	11	0	0	11	0	0
5	56280092	.	G	A	2	2	4	0	0	4	0	0
5	56280498	.	C	T	6	5	11	0	0	11	0	0
5	56280547	.	T	A	4	3	7	0	0	7	0	0
5	56289800	.	G	A	0	4	4	0	3	7	0	0
5	56289818	.	C	A	5	5	10	0	0	10	0	0
5	56289884	.	A	G	3	4	7	0	1	8	0	0
5	56289904	.	T	C	2	2	4	0	1	5	0	0
5	56289925	.	G	A	0	3	3	0	3	6	0	0
5	56308816	.	C	T	1	12	13	0	9	22	0	0
5	56309013	.	G	C	17	9	26	2	0	28	0	0
5	56309046	.	G	A	19	2	21	0	2	23	0	0
5	56309109	.	C	T	3	30	33	0	10	43	0	0
5	56309115	.	A	T	11	32	43	0	0	43	0	0
5	56309454	.	A	G	18	10	28	0	0	28	0	0
5	56309517	.	T	C	13	16	29	0	2	31	0	0
5	56309672	.	C	A	1	11	12	0	19	31	0	0
5	56309677	.	C	A	19	10	29	0	1	30	0	0
5	56309761	.	G	C	14	10	24	0	1	25	0	0
5	56309844	.	G	A	28	11	39	0	1	40	0	0
5	56313189	.	A	G	24	24	48	0	1	49	0	0
5	56313207	.	G	A	25	19	44	0	2	46	0	0
5	56317153	.	T	A	17	17	34	0	0	34	0	0
5	56317170	.	C	T	21	16	37	0	0	37	0	0
5	56317377	.	G	A	26	15	41	0	0	41	0	0
5	56322148	.	A	G	18	16	34	0	2	36	0	0
5	56322205	.	C	T	14	15	29	0	1	30	0	0
5	56322404	.	A	G	12	8	20	0	4	24	0	0
5	56322449	.	T	C	11	14	25	0	1	26	0	0
5	56322467	.	G	A	11	14	25	0	0	25	0	0
5	56322680	.	A	G	17	11	28	0	1	29	0	0
5	56326387	.	A	G	9	14	23	0	2	25	0	0
5	56326485	.	C	T	8	13	21	0	1	22	0	0
5	56340613	.	A	G	10	7	17	0	1	18	0	0
5	56343032	.	C	T	0	9	9	0	17	26	0	0
5	56343095	.	C	T	14	6	20	0	0	20	0	0
5	56345091	.	A	G	13	8	21	0	0	21	0	0
5	56345109	.	A	G	13	4	17	0	1	18	0	0
5	56345138	.	T	G	12	7	19	0	0	19	0	0
5	56345653	.	T	C	7	7	14	0	0	14	0	0
5	56355401	.	A	G	11	10	21	0	0	21	0	0
5	56362376	.	C	T	12	8	20	0	1	21	0	0
5	56364862	.	A	G	15	8	23	0	3	26	0	0
5	56364946	.	G	A	13	10	23	0	4	27	0	0
5	56364979	.	A	G	16	12	28	0	1	29	0	0
5	56364982	.	G	T	16	12	28	0	0	28	0	0
5	56375274	.	C	T	7	14	21	0	3	24	0	0
5	56375289	.	G	T	8	13	21	0	2	23	0	0
5	56376648	.	A	G	1	8	9	0	0	9	0	0
5	56376741	.	T	G	10	9	19	0	0	19	0	0
5	56378072	.	C	A	15	5	20	0	1	22	1	0
5	56381781	.	G	A	14	4	18	3	0	21	0	0
5	56383131	.	C	G	5	4	9	7	0	16	0	0
5	56383379	.	T	G	8	5	13	1	0	14	0	0
5	56384447	.	A	G	11	3	14	1	0	15	0	0
5	56384546	.	C	T	5	3	8	0	0	8	0	0
5	56390247	.	G	A	4	4	8	0	0	8	0	0
5	56390253	.	G	A	4	3	7	0	1	8	0	0
5	56390352	.	G	A	5	9	14	0	0	14	0	0
5	56405852	.	A	G	4	5	9	0	0	9	0	0
5	56405867	.	G	A	4	5	9	0	0	9	0	0
5	56405927	.	T	C	2	3	5	4	0	9	0	0
5	56405947	.	T	C	4	2	6	4	0	10	0	0
5	56412197	.	G	A	7	8	15	0	0	15	0	0
5	56412236	.	C	T	4	4	8	0	0	8	0	0
5	56416052	.	G	A	6	7	13	0	0	13	0	0
5	56508622	.	G	T	2	2	4	0	1	5	0	0
5	56918932	.	G	A	4	11	15	0	0	15	0	0
5	56918974	.	A	G	2	9	11	0	1	12	0	0
5	56920385	.	A	T	6	3	9	0	0	9	0	0
5	56924447	.	G	T	2	10	12	0	0	12	0	0
5	56927749	.	G	T	1	4	5	0	0	5	0	0
5	56927772	.	C	T	4	2	6	0	0	6	0	0
5	56927784	.	G	A	4	4	8	0	0	8	0	0
5	56934960	.	A	G	4	3	7	0	0	7	0	0
5	56935031	.	G	T	4	2	6	0	0	6	0	0
5	56939414	.	G	A	2	2	4	0	1	5	0	0
5	56939449	.	C	T	0	3	3	0	2	5	0	0
5	56951015	.	A	C	7	0	7	0	7	14	0	0
5	56951081	.	T	C	8	13	21	1	4	26	0	0
5	56951144	.	A	T	5	14	19	1	2	22	0	0
5	56951156	.	C	T	18	6	24	1	0	25	0	0
5	56951220	.	C	T	20	15	35	0	0	35	0	0
5	56951258	.	A	C	8	7	15	0	0	15	0	0
5	56958513	.	C	T	16	11	27	0	2	29	0	0
5	56961378	.	C	T	12	7	19	0	0	19	0	0
5	56964475	.	G	A	10	11	21	0	0	21	0	0
5	57210284	.	G	A	2	4	6	0	1	7	0	0
5	57210293	.	T	C	4	4	8	0	0	8	0	0
5	57217249	.	G	A	1	8	9	1	9	19	0	0
5	57217343	.	T	G	12	6	18	0	1	19	0	0
5	57217391	.	C	G	10	6	16	0	0	16	0	0
5	57219429	.	T	C	6	18	24	0	0	24	0	0
5	57219430	.	T	A	6	17	23	0	2	25	0	0
5	57219496	.	G	A	9	8	17	0	0	17	0	0
5	57219616	.	C	T	3	2	5	0	1	6	0	0
5	57219628	.	T	C	5	3	8	0	0	8	0	0
5	57219736	.	T	C	7	2	9	0	1	10	0	0
5	57219789	.	C	T	7	5	12	0	1	13	0	0
5	57219938	.	G	C	1	6	7	0	10	17	0	0
5	57219990	.	C	A	8	5	13	0	0	13	0	0
5	57220108	.	G	A	0	6	6	0	11	17	0	0
5	57220262	.	A	T	10	8	18	0	0	18	0	0
5	57220324	.	T	C	9	5	14	0	0	14	0	0
5	57225332	.	C	T	6	13	19	0	0	19	0	0
5	57225343	.	C	T	10	5	15	0	0	15	0	0
5	57225496	.	C	G	13	1	14	0	7	21	0	0
5	57226522	.	T	C	9	12	21	0	1	22	0	0
5	57234053	.	A	C	5	4	9	0	0	9	0	0
5	57234074	.	C	T	3	3	6	0	0	6	0	0
5	57244075	.	T	G	0	3	3	0	1	4	0	0
5	57244390	.	C	G	2	3	5	0	0	5	0	0
5	57246037	.	C	T	1	2	3	0	0	3	0	0
5	57248338	.	T	C	2	2	4	0	0	4	0	0
5	57272949	.	A	G	4	2	6	0	0	6	0	0
5	57320235	.	C	T	25	36	61	0	2	63	0	0
5	57320274	.	G	A	32	32	64	0	4	68	0	0
5	57325158	.	T	G	36	27	63	0	2	65	0	0
5	57325204	.	T	G	29	0	29	0	31	60	0	0
5	57325210	.	G	A	28	30	58	0	1	59	0	0
5	57325359	.	G	A	24	22	46	0	1	47	0	0
5	57350958	.	C	T	1	3	4	0	2	6	0	0
5	57351036	.	A	G	6	0	6	0	3	9	0	0
5	57351189	.	C	T	1	2	3	0	0	3	0	0
5	57351382	.	C	A	1	4	5	0	0	5	0	0
5	57351403	.	G	A	4	2	6	0	0	6	0	0
5	57352465	.	G	C	6	3	9	0	0	9	0	0
5	57352633	.	G	A	3	3	6	0	0	6	0	0
5	57353387	.	T	C	2	7	9	0	1	10	0	0
5	57353886	.	C	T	5	2	7	0	0	7	0	0
5	57353959	.	C	A	5	10	15	1	3	19	0	0
5	57353981	.	C	T	10	8	18	0	2	20	0	0
5	57354046	.	G	A	10	7	17	0	0	17	0	0
5	57354061	.	G	A	0	7	7	0	7	14	0	0
5	57354096	.	A	G	8	5	13	0	0	13	0	0
5	57354302	.	A	G	11	5	16	0	0	16	0	0
5	57354311	.	G	A	10	3	13	0	2	15	0	0
5	57354552	.	C	T	4	2	6	0	1	7	0	0
5	57354656	.	A	G	6	9	15	0	2	17	0	0
5	57354680	.	G	A	0	11	11	0	8	19	0	0
5	57354719	.	T	G	10	9	19	0	0	19	0	0
5	57354786	.	G	T	5	6	11	0	0	11	0	0
5	57354832	.	C	A	2	3	5	0	1	6	0	0
5	57354839	.	A	G	3	0	3	0	3	6	0	0
5	57359740	.	G	A	9	10	19	0	0	19	0	0
5	57359811	.	A	G	6	8	14	0	0	14	0	0
5	57361015	.	G	T	14	18	32	0	0	33	1	0
5	57444318	.	G	C	4	2	6	0	0	6	0	0
5	57446925	.	G	A	7	7	14	0	0	14	0	0
5	57448788	.	T	C	6	3	9	0	0	9	0	0
5	57449035	.	C	A	5	2	7	0	0	7	0	0
5	57450862	.	C	T	8	5	13	0	1	14	0	0
5	57450868	.	C	A	10	5	15	0	0	15	0	0
5	57453587	.	T	C	2	4	6	0	0	6	0	0
5	57453635	.	T	C	2	3	5	0	0	5	0	0
5	57489821	.	G	A	11	16	27	0	3	30	0	0
5	57499990	.	T	C	24	0	24	0	11	35	0	0
5	57500086	.	T	C	11	15	26	0	2	28	0	0
5	57505050	.	C	T	15	13	28	0	0	28	0	0
5	57506568	.	A	C	14	16	30	0	1	31	0	0
5	57514332	.	G	A	18	18	36	0	3	39	0	0
5	57514428	.	G	A	16	19	35	0	1	36	0	0
5	57635542	.	A	T	1	2	3	0	0	3	0	0
5	57641711	.	A	T	7	9	16	0	0	16	0	0
5	57641751	.	C	T	7	16	23	0	0	23	0	0
5	57641808	.	T	C	6	21	27	0	1	28	0	0
5	57641895	.	T	C	8	15	23	0	0	23	0	0
5	57643949	.	T	C	9	20	29	0	1	30	0	0
5	57644184	.	T	G	10	17	27	0	0	28	1	0
5	57644256	.	G	A	8	20	28	0	0	28	0	0
5	57644280	.	G	A	17	12	29	0	0	29	0	0
5	57644790	.	C	T	2	3	5	0	0	5	0	0
5	57644813	.	A	T	2	2	4	0	0	4	0	0
5	57644833	.	G	C	1	3	4	0	1	5	0	0
5	57645311	.	A	T	1	1	2	0	0	2	0	0
5	57645325	.	T	C	1	2	3	0	0	3	0	0
5	57650695	.	C	T	10	9	19	0	0	19	0	0
5	57650699	.	C	A	12	7	19	0	0	19	0	0
5	57650830	.	G	A	2	2	4	0	0	4	0	0
5	57654923	.	G	T	1	1	2	0	0	2	0	0
5	57654933	.	G	A	1	2	3	0	0	3	0	0
5	57693607	.	T	G	1	7	8	0	0	8	0	0
5	57693625	.	C	A	1	5	6	0	0	6	0	0
5	57693709	.	T	C	7	3	10	0	1	11	0	0
5	57693730	.	G	A	6	2	8	0	1	9	0	0
5	57693872	.	T	G	2	1	3	0	0	3	0	0
5	57693880	.	T	A	2	2	4	0	0	4	0	0
5	57693926	.	T	C	4	2	6	0	0	6	0	0
5	57699903	.	C	G	1	3	4	0	5	9	0	0
5	57699936	.	C	T	6	3	9	0	0	9	0	0
5	57700098	.	T	C	6	0	6	0	4	10	0	0
5	57704982	.	C	T	0	6	6	0	3	9	0	0
5	57711761	.	G	A	1	4	5	0	0	5	0	0
5	57715159	.	T	C	3	6	9	0	1	10	0	0
5	57715904	.	T	C	18	20	38	0	1	39	0	0
5	57716169	.	T	C	14	13	27	0	1	28	0	0
5	57718478	.	G	T	10	11	21	0	1	22	0	0
5	57718614	.	C	A	2	3	5	1	1	7	0	0
5	57718649	.	A	G	15	0	15	1	0	16	0	0
5	57718659	.	C	T	6	15	21	1	1	23	0	0
5	57726573	.	T	A	6	12	18	0	0	18	0	0
5	57734692	.	A	T	7	8	15	0	1	16	0	0
5	57737337	.	A	G	6	8	14	0	1	15	0	0
5	57737427	.	G	A	1	4	5	0	4	9	0	0
5	57737460	.	C	T	3	8	11	0	1	12	0	0
5	57737504	.	C	A	9	6	15	0	0	15	0	0
5	57737587	.	G	A	5	6	11	0	0	11	0	0
5	57737637	.	A	G	6	0	6	0	5	11	0	0
5	57737677	.	A	T	1	6	7	0	0	7	0	0
5	57737704	.	C	T	6	4	10	0	0	10	0	0
5	57737727	.	A	T	7	6	13	0	0	13	0	0
5	57737862	.	T	A	5	4	9	0	0	9	0	0
5	57737863	.	A	C	5	4	9	0	0	9	0	0
5	57737937	.	G	A	4	6	10	0	0	10	0	0
5	57738078	.	C	T	5	5	10	0	1	11	0	0
5	57738233	.	C	T	6	5	11	0	0	11	0	0
5	57738321	.	G	A	4	8	12	0	0	12	0	0
5	57743868	.	G	A	11	13	24	0	0	24	0	0
5	57743907	.	A	G	11	12	23	0	3	26	0	0
5	57744681	.	C	T	13	14	27	0	0	27	0	0
5	57744731	.	T	C	12	15	27	0	0	27	0	0
5	57747691	.	A	G	11	7	18	0	2	20	0	0
5	57751676	.	T	A	10	10	20	0	2	22	0	0
5	57753821	.	C	T	9	10	19	0	1	21	1	0
5	57753827	.	A	G	11	0	11	0	11	22	0	0
5	57762390	.	A	G	32	11	43	0	1	44	0	0
5	57762468	.	G	T	21	24	45	0	0	45	0	0
5	57762479	.	A	T	17	22	39	0	2	42	1	0
5	57762529	.	C	T	24	15	39	0	2	41	0	0
5	57762656	.	T	G	13	24	37	0	2	39	0	0
5	57762849	.	A	T	8	11	19	0	1	20	0	0
5	57762868	.	A	G	8	15	23	0	0	23	0	0
5	57762900	.	T	C	11	15	26	0	0	26	0	0
5	57762938	.	A	T	17	12	29	0	0	29	0	0
5	57762986	.	C	G	11	7	18	0	1	19	0	0
5	57777906	.	C	G	26	1	27	0	25	52	0	0
5	57787630	.	C	T	35	27	62	0	3	65	0	0
5	57790313	.	G	A	43	22	65	0	4	69	0	0
5	57790583	.	G	A	40	23	63	1	3	67	0	0
5	57797085	.	A	C	30	24	54	0	9	63	0	0
5	57797770	.	T	C	35	24	59	0	2	61	0	0
5	57797774	.	T	C	36	23	59	0	1	60	0	0
5	57797887	.	A	T	17	34	51	0	0	52	1	0
5	57797914	.	A	G	16	3	19	0	22	41	0	0
5	57797954	.	T	C	20	11	31	0	1	32	0	0
5	57814287	.	C	G	4	2	6	0	0	6	0	0
5	57814454	.	C	A	4	8	12	0	1	13	0	0
5	57814627	.	G	A	12	12	24	1	3	28	0	0
5	57814630	.	T	C	13	0	13	1	14	28	0	0
5	57815018	.	G	A	7	4	11	0	0	11	0	0
5	57818963	.	G	T	10	8	18	0	0	18	0	0
5	57819009	.	C	T	0	8	8	0	7	15	0	0
5	57820641	.	C	A	4	6	10	0	0	10	0	0
5	57820683	.	A	G	10	4	14	0	0	14	0	0
5	57820731	.	T	A	6	11	17	0	2	19	0	0
5	57820743	.	G	C	13	6	19	0	1	20	0	0
5	57838329	.	G	A	4	2	6	0	0	6	0	0
5	57845178	.	T	A	3	2	5	1	1	7	0	0
5	58075599	.	C	T	5	4	9	0	0	9	0	0
5	58075686	.	A	G	11	3	14	0	1	15	0	0
5	58075815	.	T	G	6	5	11	0	1	12	0	0
5	58075863	.	G	A	5	4	9	0	1	10	0	0
5	58081110	.	C	T	7	6	13	0	2	15	0	0
5	58081173	.	T	A	1	9	10	0	0	10	0	0
5	58111830	.	C	T	1	1	2	0	2	4	0	0
5	58111948	.	C	T	4	2	6	0	0	6	0	0
5	58111962	.	G	A	5	1	6	0	1	7	0	0
5	58173388	.	C	T	3	5	8	0	0	8	0	0
5	58173414	.	G	A	4	4	8	0	1	9	0	0
5	58173435	.	A	T	4	5	9	0	0	9	0	0
5	58173573	.	T	A	1	4	5	0	0	5	0	0
5	58372268	.	T	C	29	31	60	0	0	60	0	0
5	58372286	.	G	A	34	24	58	0	2	60	0	0
5	58382159	.	A	G	32	1	33	0	40	73	0	0
5	58382358	.	C	T	18	31	49	0	1	50	0	0
5	58382440	.	T	A	15	8	23	1	4	41	13	0
5	58382457	.	C	G	27	6	33	1	7	41	0	0
5	58402264	.	C	T	4	3	7	0	0	7	0	0
5	58405010	.	G	A	0	5	5	0	3	8	0	0
5	58409519	.	C	T	4	7	11	0	0	11	0	0
5	58412403	.	T	C	2	12	14	0	1	15	0	0
5	58412439	.	C	T	10	4	14	0	2	16	0	0
5	58440528	.	A	T	9	2	11	0	1	12	0	0
5	58440541	.	A	G	3	0	3	0	7	10	0	0
5	58444059	.	G	A	2	2	4	0	0	4	0	0
5	58459476	.	A	C	9	7	16	0	0	16	0	0
5	58478188	.	C	T	11	12	23	0	0	23	0	0
5	58481813	.	G	A	1	3	4	0	5	9	0	0
5	58504183	.	C	T	4	2	6	0	0	6	0	0
5	58504447	.	G	T	2	5	7	0	0	7	0	0
5	58504562	.	G	T	1	5	6	0	0	6	0	0
5	58511553	.	T	C	2	5	7	0	1	8	0	0
5	58687569	.	A	C	2	7	9	0	0	9	0	0
5	58687623	.	A	T	13	10	23	0	1	24	0	0
5	58687649	.	C	A	12	11	23	0	0	23	0	0
5	58687673	.	T	C	6	9	15	0	0	15	0	0
5	58687739	.	G	A	1	5	6	0	9	15	0	0
5	58688749	.	A	G	7	7	14	0	2	16	0	0
5	58695764	.	G	A	1	6	7	0	6	13	0	0
5	58696412	.	A	C	7	12	19	0	1	20	0	0
5	58696420	.	C	G	16	9	25	0	0	25	0	0
5	58696905	.	C	G	12	6	18	1	2	21	0	0
5	58704272	.	C	T	6	5	11	0	0	11	0	0
5	58711159	.	G	T	8	9	17	0	0	17	0	0
5	58713213	.	C	T	0	7	7	0	7	14	0	0
5	58713579	.	C	T	4	13	17	0	0	17	0	0
5	58717412	.	C	T	7	10	17	0	1	18	0	0
5	58717618	.	A	T	11	7	18	0	1	19	0	0
5	58719797	.	C	T	2	4	6	0	0	6	0	0
5	58721406	.	C	T	1	6	7	0	9	16	0	0
5	58722507	.	T	C	6	2	8	0	1	9	0	0
5	58726558	.	C	T	2	5	7	0	0	7	0	0
5	58726575	.	C	T	2	6	8	0	0	8	0	0
5	58730739	.	G	A	5	5	10	0	0	10	0	0
5	58736043	.	C	A	5	6	11	0	0	11	0	0
5	58736111	.	T	G	5	5	10	0	1	11	0	0
5	58736144	.	C	T	8	4	12	0	0	12	0	0
5	58742862	.	C	T	7	4	11	0	0	11	0	0
5	58745861	.	G	A	5	5	10	0	0	10	0	0
5	58751855	.	T	A	5	6	11	0	0	11	0	0
5	58776499	.	G	A	3	2	5	0	0	5	0	0
5	58831161	.	G	T	2	3	5	0	0	5	0	0
5	58831533	.	C	T	3	2	5	0	0	5	0	0
5	58832085	.	T	A	1	2	3	0	0	3	0	0
5	58832145	.	T	A	1	4	5	0	0	5	0	0
5	58832202	.	G	C	3	2	5	2	0	7	0	0
5	58850871	.	G	T	10	16	26	0	1	27	0	0
5	58850923	.	A	C	9	16	25	0	1	26	0	0
5	58851297	.	T	A	5	11	16	0	1	17	0	0
5	58851789	.	A	C	18	0	18	1	18	37	0	0
5	58851865	.	T	C	18	0	18	0	17	35	0	0
5	58851925	.	G	A	14	17	31	0	2	33	0	0
5	58851938	.	C	T	11	16	27	0	2	29	0	0
5	58852042	.	T	C	17	1	18	0	11	29	0	0
5	58852164	.	T	C	13	11	24	0	2	26	0	0
5	58852223	.	A	T	16	8	24	0	0	24	0	0
5	58852515	.	A	G	2	5	7	7	0	14	0	0
5	58852758	.	C	A	6	14	20	0	0	20	0	0
5	58852825	.	A	C	14	15	29	0	1	30	0	0
5	58852864	.	T	G	13	11	24	0	2	26	0	0
5	58852925	.	T	G	5	3	8	0	0	8	0	0
5	58853407	.	C	T	5	9	14	0	0	14	0	0
5	58853711	.	T	A	13	7	20	0	1	21	0	0
5	58866495	.	C	T	11	15	26	0	1	27	0	0
5	58868891	.	A	G	13	5	18	0	0	18	0	0
5	58875086	.	A	G	6	16	22	0	0	22	0	0
5	58875113	.	T	C	2	11	13	0	0	13	0	0
5	58875140	.	C	G	0	5	5	0	12	17	0	0
5	58876301	.	C	T	1	10	11	0	7	18	0	0
5	58876498	.	T	C	6	0	6	0	10	16	0	0
5	58878863	.	G	C	9	8	17	0	0	17	0	0
5	58939388	.	C	A	0	20	20	0	11	31	0	0
5	58993040	.	G	A	0	2	2	0	1	3	0	0
5	58997286	.	T	A	3	5	8	0	1	9	0	0
5	59030172	.	T	C	4	3	7	0	0	7	0	0
5	59041862	.	T	C	7	4	11	0	0	11	0	0
5	59046275	.	G	A	0	5	5	0	10	15	0	0
5	59046296	.	T	C	12	4	16	0	1	17	0	0
5	59050313	.	C	T	10	8	18	0	0	18	0	0
5	59060620	.	C	T	8	9	17	0	0	17	0	0
5	59060855	.	C	T	5	8	13	0	0	13	0	0
5	59067763	.	T	A	10	10	20	0	0	20	0	0
5	59079919	.	G	A	0	6	6	0	7	13	0	0
5	59079932	.	C	T	9	5	14	0	1	15	0	0
5	59080452	.	G	T	1	14	15	0	9	24	0	0
5	59080526	.	T	A	13	12	25	0	0	25	0	0
5	59080874	.	A	G	10	3	13	0	0	13	0	0
5	59080924	.	A	G	1	2	3	0	0	3	0	0
5	59080925	.	A	G	1	2	3	0	0	3	0	0
5	59082495	.	C	A	15	8	23	0	0	23	0	0
5	59082540	.	C	T	7	7	14	0	0	14	0	0
5	59082581	.	T	A	9	7	16	0	0	16	0	0
5	59082882	.	C	T	10	13	23	0	1	24	0	0
5	59083136	.	T	G	9	4	13	0	0	13	0	0
5	59083201	.	T	A	4	5	9	0	0	9	0	0
5	59092513	.	A	G	9	6	15	0	0	15	0	0
5	59092644	.	G	A	9	8	17	0	1	18	0	0
5	59100577	.	G	A	6	5	11	0	0	11	0	0
5	59101813	.	G	A	3	4	7	0	0	7	0	0
5	59101933	.	G	A	5	6	11	0	0	11	0	0
5	59108196	.	A	G	4	2	6	0	0	6	0	0
5	59111584	.	G	A	5	2	7	0	1	8	0	0
5	59199018	.	G	A	2	3	5	0	3	8	0	0
5	59199316	.	A	T	3	6	9	0	0	9	0	0
5	59199332	.	A	C	3	6	9	0	0	9	0	0
5	59199517	.	C	T	3	5	8	0	0	8	0	0
5	59199538	.	C	T	3	4	7	0	0	7	0	0
5	59199589	.	T	A	2	2	4	0	1	5	0	0
5	59199734	.	C	T	4	3	7	0	0	7	0	0
5	59199738	.	G	A	0	3	3	0	4	7	0	0
5	59200130	.	A	G	2	5	7	0	0	7	0	0
5	59200153	.	T	G	3	6	9	0	0	9	0	0
5	59200206	.	G	T	3	4	7	0	0	7	0	0
5	59200211	.	C	T	4	3	7	0	0	7	0	0
5	59200270	.	T	A	7	5	12	0	0	12	0	0
5	59200435	.	T	G	2	5	7	0	0	7	0	0
5	59200444	.	G	A	2	5	7	0	0	7	0	0
5	59201308	.	G	A	0	8	8	0	4	12	0	0
5	59201690	.	T	C	7	5	12	0	1	13	0	0
5	59201785	.	T	G	6	3	9	0	0	9	0	0
5	59201825	.	G	A	3	8	11	0	0	11	0	0
5	59201883	.	T	G	15	3	18	0	0	18	0	0
5	59201947	.	A	G	5	5	10	0	1	11	0	0
5	59234451	.	G	T	7	5	12	0	0	12	0	0
5	59239773	.	C	G	5	8	13	0	0	13	0	0
5	59239851	.	G	A	11	13	24	0	1	25	0	0
5	59247894	.	A	G	11	9	20	0	2	22	0	0
5	59248038	.	C	G	6	3	9	0	0	9	0	0
5	59248156	.	A	G	4	0	4	0	4	8	0	0
5	59248162	.	T	C	5	2	7	0	0	7	0	0
5	59248231	.	G	T	0	2	2	0	2	4	0	0
5	59278455	.	C	T	5	2	7	0	0	7	0	0
5	59278463	.	T	C	4	5	9	0	0	9	0	0
5	59278569	.	G	A	6	2	8	0	0	8	0	0
5	59303988	.	C	T	5	4	9	0	0	9	0	0
5	59328502	.	G	A	9	4	13	0	0	13	0	0
5	59380488	.	C	T	4	6	10	0	1	11	0	0
5	59381774	.	C	T	9	7	16	0	1	17	0	0
5	59386337	.	G	T	0	10	10	0	5	15	0	0
5	59386416	.	A	G	7	8	15	0	0	15	0	0
5	59386512	.	C	G	5	6	11	0	0	11	0	0
5	59386716	.	G	C	2	4	6	0	0	6	0	0
5	59386727	.	C	T	1	2	3	0	0	3	0	0
5	59386799	.	T	A	1	2	3	0	0	3	0	0
5	59387075	.	A	C	2	5	7	0	0	7	0	0
5	59387179	.	A	C	4	2	6	0	0	6	0	0
5	59387476	.	C	A	4	6	10	0	0	10	0	0
5	59387478	.	C	A	4	6	10	0	0	10	0	0
5	59387566	.	G	T	9	9	18	0	0	18	0	0
5	59388449	.	G	A	0	8	8	0	6	14	0	0
5	59388479	.	G	A	5	7	12	0	0	12	0	0
5	59388660	.	A	G	7	13	20	0	0	20	0	0
5	59388686	.	C	T	5	8	13	0	0	13	0	0
5	59389014	.	G	A	8	5	13	0	0	13	0	0
5	59389101	.	G	A	4	4	8	0	2	10	0	0
5	59389107	.	G	A	6	4	10	0	0	10	0	0
5	59389688	.	G	A	10	6	16	0	0	16	0	0
5	59397579	.	C	A	4	3	7	0	1	8	0	0
5	59397604	.	G	C	3	3	6	0	0	6	0	0
5	59397689	.	A	C	1	4	5	0	1	6	0	0
5	59419954	.	C	T	3	10	13	0	0	13	0	0
5	59420030	.	C	T	6	10	16	0	0	16	0	0
5	59420096	.	T	C	5	10	15	0	0	15	0	0
5	59420111	.	G	A	4	9	13	0	0	13	0	0
5	59420138	.	G	A	1	5	6	0	4	10	0	0
5	59420249	.	A	G	3	0	3	0	9	12	0	0
5	59420321	.	A	C	5	8	13	0	0	13	0	0
5	59420414	.	G	T	1	8	9	0	5	14	0	0
5	59444562	.	C	A	12	8	20	0	0	20	0	0
5	59449717	.	T	C	8	11	19	0	1	20	0	0
5	59449729	.	C	T	6	10	16	0	1	17	0	0
5	59449767	.	C	T	11	11	22	0	0	22	0	0
5	59462457	.	G	A	10	6	16	0	1	17	0	0
5	59462595	.	C	T	10	6	16	0	0	16	0	0
5	59462663	.	C	T	8	7	15	0	0	15	0	0
5	59462679	.	C	T	8	7	15	1	0	16	0	0
5	59462829	.	T	G	5	13	18	0	3	21	0	0
5	59462881	.	G	A	11	10	21	0	0	21	0	0
5	59462994	.	A	T	6	6	12	0	0	12	0	0
5	59463183	.	G	T	7	6	13	0	0	13	0	0
5	59463213	.	T	C	6	7	13	0	0	13	0	0
5	59463261	.	C	A	6	11	17	0	2	19	0	0
5	59473885	.	A	C	11	6	17	0	2	19	0	0
5	59479541	.	C	A	8	16	24	0	2	26	0	0
5	59479818	.	C	G	7	8	15	1	0	16	0	0
5	59479973	.	C	T	13	7	20	0	0	20	0	0
5	59515629	.	G	C	3	4	7	0	1	8	0	0
5	59536913	.	G	C	7	3	10	0	0	10	0	0
5	59538508	.	T	G	4	0	4	1	7	12	0	0
5	59538782	.	C	T	4	6	10	0	0	10	0	0
5	59544327	.	C	T	7	7	14	0	0	14	0	0
5	59548944	.	T	A	2	5	7	0	0	7	0	0
5	59549182	.	G	A	2	7	9	0	1	10	0	0
5	59549382	.	A	G	7	3	10	0	1	11	0	0
5	59549389	.	G	A	8	3	11	0	0	11	0	0
5	59549516	.	T	G	5	2	7	0	0	7	0	0
5	59549528	.	T	A	4	3	7	0	1	8	0	0
5	59550260	.	A	T	3	5	8	0	0	8	0	0
5	59550529	.	T	G	6	4	10	0	0	10	0	0
5	59550762	.	A	C	3	1	4	0	1	5	0	0
5	59553797	.	A	G	7	0	7	0	11	18	0	0
5	59559881	.	C	T	7	9	16	0	1	17	0	0
5	59559905	.	T	C	5	11	16	0	0	16	0	0
5	59560110	.	T	C	12	12	24	0	1	25	0	0
5	59560131	.	A	G	9	0	9	0	16	25	0	0
5	59584626	.	C	T	12	6	18	0	0	18	0	0
5	59589199	.	G	A	1	10	11	0	11	22	0	0
5	59593297	.	G	C	1	11	12	0	11	23	0	0
5	59593363	.	C	T	11	7	18	0	0	19	1	0
5	59593408	.	G	T	8	8	16	0	1	17	0	0
5	59593441	.	G	A	8	6	14	0	1	15	0	0
5	59593471	.	G	A	1	7	8	0	8	16	0	0
5	59593523	.	C	T	6	8	14	0	0	14	0	0
5	59593623	.	C	T	10	6	16	0	0	16	0	0
5	59593844	.	C	T	5	7	12	0	0	12	0	0
5	59594328	.	T	C	10	5	15	0	0	15	0	0
5	59594648	.	A	T	4	5	9	0	0	9	0	0
5	59594762	.	G	A	10	7	17	0	0	17	0	0
5	59594825	.	A	T	7	3	10	0	0	10	0	0
5	59595127	.	T	C	2	4	6	0	0	6	0	0
5	59595193	.	G	A	8	5	13	0	0	13	0	0
5	59595307	.	C	A	4	9	13	0	1	14	0	0
5	59595339	.	G	A	9	8	17	0	2	19	0	0
5	59595360	.	A	G	8	5	13	0	0	13	0	0
5	59595407	.	G	A	8	11	19	0	1	20	0	0
5	60520788	.	G	C	5	4	9	0	0	9	0	0
5	60521085	.	A	G	5	0	5	0	10	15	0	0
5	60665225	.	A	C	6	12	18	0	0	18	0	0
5	60665315	.	G	A	0	12	12	0	3	15	0	0
5	60665324	.	A	C	4	11	15	0	0	15	0	0
5	60673572	.	C	G	7	6	13	0	1	14	0	0
5	60683909	.	C	T	8	6	14	0	1	15	0	0
5	60683998	.	C	A	3	8	11	0	0	11	0	0
5	60684257	.	C	T	7	6	13	0	0	13	0	0
5	60684434	.	C	T	9	7	16	0	0	16	0	0
5	60685481	.	G	A	13	14	27	0	0	27	0	0
5	60685513	.	A	G	11	10	21	0	2	23	0	0
5	60685584	.	A	C	3	0	3	0	4	7	0	0
5	60685590	.	A	C	2	0	2	0	4	6	0	0
5	60685758	.	T	C	3	14	17	0	0	17	0	0
5	60685822	.	C	T	11	8	19	0	2	21	0	0
5	60685851	.	G	A	11	7	18	0	1	19	0	0
5	60686374	.	A	T	8	9	17	0	0	17	0	0
5	60686380	.	C	A	9	10	19	0	0	19	0	0
5	60686409	.	G	A	13	9	22	0	0	22	0	0
5	60686686	.	C	G	6	4	10	0	0	10	0	0
5	60686784	.	G	T	8	6	14	0	0	14	0	0
5	60687344	.	A	T	8	3	11	0	1	12	0	0
5	60850285	.	A	C	4	3	7	0	0	7	0	0
5	60850291	.	T	A	4	3	7	0	0	7	0	0
5	60853645	.	G	A	0	2	2	0	3	5	0	0
5	60867936	.	A	G	4	6	10	0	1	11	0	0
5	60868009	.	A	G	5	0	5	0	12	17	0	0
5	60868173	.	G	A	0	6	6	0	6	12	0	0
5	60868216	.	G	A	10	3	13	0	2	15	0	0
5	60871999	.	A	T	7	10	17	0	1	18	0	0
5	60872258	.	C	T	2	5	7	0	0	7	0	0
5	60872299	.	T	G	2	3	5	0	0	5	0	0
5	60886282	.	C	T	7	2	9	0	0	9	0	0
5	60893399	.	C	T	3	8	11	0	1	12	0	0
5	60894675	.	G	A	12	3	15	0	2	17	0	0
5	60894807	.	A	G	4	0	4	0	8	12	0	0
5	60906002	.	C	T	5	11	16	0	0	16	0	0
5	60906313	.	G	A	2	7	9	0	7	16	0	0
5	61270901	.	G	A	14	7	21	0	2	23	0	0
5	61270905	.	C	T	16	8	24	0	1	25	0	0
5	61316248	.	T	C	11	11	22	0	2	24	0	0
5	61325345	.	A	T	12	9	21	0	0	21	0	0
5	61329486	.	G	A	8	13	21	0	2	23	0	0
5	61329508	.	G	C	13	12	25	0	1	26	0	0
5	61329650	.	A	G	10	7	17	0	4	21	0	0
5	61351851	.	C	T	4	5	9	0	1	10	0	0
5	61352582	.	T	C	8	9	17	0	1	18	0	0
5	61354097	.	A	C	3	5	8	0	1	9	0	0
5	61354264	.	A	G	5	2	7	0	0	7	0	0
5	61380091	.	A	G	12	0	12	0	9	21	0	0
5	61380103	.	T	A	13	7	20	0	0	20	0	0
5	61380130	.	C	T	18	9	27	0	0	27	0	0
5	61389725	.	T	C	22	17	39	0	1	40	0	0
5	61396054	.	G	A	12	14	26	0	4	30	0	0
5	61401915	.	C	T	12	10	22	0	2	24	0	0
5	61402030	.	G	A	7	6	13	0	4	17	0	0
5	61402366	.	G	C	11	10	21	0	2	23	0	0
5	61402440	.	T	C	10	17	27	0	1	29	1	0
5	61402479	.	G	A	8	21	29	2	0	31	0	0
5	61402532	.	C	T	13	12	25	1	2	28	0	0
5	61402534	.	T	A	15	13	28	1	0	29	0	0
5	61402570	.	T	C	20	14	34	0	1	35	0	0
5	61403005	.	A	T	8	8	16	0	2	18	0	0
5	61404702	.	A	T	4	2	6	0	0	6	0	0
5	61405885	.	A	G	11	5	16	0	0	16	0	0
5	61414618	.	A	T	16	5	21	0	2	23	0	0
5	61420653	.	C	T	4	5	9	0	0	9	0	0
5	61429013	.	C	A	7	3	10	0	0	10	0	0
5	61431675	.	G	A	6	2	8	0	1	9	0	0
5	61432808	.	A	C	1	2	3	0	0	3	0	0
5	61432829	.	T	A	1	2	3	0	0	3	0	0
5	61433329	.	A	G	1	3	4	0	0	4	0	0
5	61433369	.	A	T	3	2	5	0	0	5	0	0
5	61459502	.	T	C	11	12	23	0	1	24	0	0
5	61464874	.	G	T	8	3	11	0	0	11	0	0
5	61467748	.	G	T	4	2	6	0	0	6	0	0
5	61467754	.	T	A	3	2	5	0	1	6	0	0
5	61472457	.	C	T	4	5	9	0	1	10	0	0
5	61472598	.	C	G	1	2	3	0	0	3	0	0
5	61552554	.	T	C	15	17	32	0	3	35	0	0
5	61552591	.	A	T	10	15	25	0	2	27	0	0
5	61552620	.	G	C	9	15	24	0	1	25	0	0
5	61552724	.	G	T	10	12	22	0	0	22	0	0
5	61552808	.	T	A	8	8	16	0	1	17	0	0
5	61552836	.	T	A	8	13	21	0	0	21	0	0
5	61553119	.	A	G	5	6	11	0	0	11	0	0
5	61553207	.	C	T	7	3	10	0	2	12	0	0
5	61553252	.	G	T	10	7	17	0	0	17	0	0
5	61553418	.	G	A	10	14	24	0	1	25	0	0
5	61553517	.	G	T	11	15	26	0	0	26	0	0
5	61553556	.	A	T	13	10	23	1	0	24	0	0
5	61553611	.	T	G	14	4	18	1	1	20	0	0
5	61553614	.	C	T	14	3	17	1	0	18	0	0
5	61553702	.	A	T	12	13	25	0	0	25	0	0
5	61553852	.	A	T	16	8	24	0	0	24	0	0
5	61566678	.	G	C	6	5	11	0	0	11	0	0
5	61566753	.	T	C	4	7	11	0	0	11	0	0
5	61570931	.	C	T	3	6	9	0	0	9	0	0
5	61571203	.	C	T	3	6	9	0	0	9	0	0
5	61571441	.	A	G	2	0	2	0	8	10	0	0
5	61584008	.	A	T	4	7	11	0	1	12	0	0
5	61584010	.	A	T	3	7	10	0	2	12	0	0
5	61584144	.	G	C	9	4	13	0	0	13	0	0
5	61588913	.	A	G	3	8	11	0	0	11	0	0
5	61588974	.	G	T	3	2	5	0	1	6	0	0
5	61657699	.	G	T	5	2	7	0	1	8	0	0
5	61657805	.	C	T	29	21	50	0	3	53	0	0
5	61665215	.	G	A	25	26	51	0	0	51	0	0
5	61668302	.	G	A	4	26	30	0	26	56	0	0
5	61676676	.	T	G	25	1	26	0	14	40	0	0
5	61676700	.	T	G	21	13	34	0	2	37	1	0
5	61676739	.	A	C	26	16	42	0	1	43	0	0
5	61682577	.	C	T	24	17	41	0	2	43	0	0
5	61682715	.	A	C	28	22	50	0	2	52	0	0
5	61682721	.	C	T	27	23	50	0	2	52	0	0
5	61698770	.	C	T	31	19	50	0	0	50	0	0
5	61701969	.	C	A	32	31	63	0	2	66	1	0
5	61712754	.	C	T	36	28	64	0	2	66	0	0
5	61723061	.	G	A	33	30	63	0	3	66	0	0
5	61723180	.	T	C	33	30	63	0	3	66	0	0
5	61723366	.	A	G	26	26	52	1	0	53	0	0
5	61723538	.	A	G	24	0	24	0	20	44	0	0
5	61723637	.	A	G	15	19	34	0	0	34	0	0
5	61723694	.	T	G	22	22	44	0	0	44	0	0
5	61723914	.	T	C	19	30	49	0	0	49	0	0
5	61723979	.	C	T	20	4	24	0	0	24	0	0
5	61723981	.	G	A	19	4	23	0	1	24	0	0
5	61790154	.	C	T	2	2	4	0	0	4	0	0
5	61790220	.	G	A	1	2	3	0	0	3	0	0
5	61790442	.	C	G	0	3	3	0	4	7	0	0
5	61790460	.	G	T	3	6	9	0	0	9	0	0
5	61790480	.	A	G	1	6	7	0	1	8	0	0
5	61790501	.	A	T	2	3	5	0	0	5	0	0
5	61791376	.	G	A	1	3	4	0	0	4	0	0
5	61793019	.	T	A	4	5	9	0	0	9	0	0
5	61793811	.	T	C	1	0	1	0	4	5	0	0
5	61793978	.	C	T	2	4	6	0	1	7	0	0
5	61794625	.	G	A	2	4	6	0	2	8	0	0
5	61799766	.	G	A	16	25	41	0	3	44	0	0
5	61801070	.	G	A	16	17	33	0	4	37	0	0
5	61804538	.	C	T	16	19	35	0	3	38	0	0
5	61806498	.	T	C	22	13	35	0	2	37	0	0
5	61817051	.	A	T	24	27	51	0	2	53	0	0
5	61864241	.	T	C	7	3	10	0	1	11	0	0
5	61866749	.	G	A	0	7	7	0	7	14	0	0
5	61868378	.	C	T	4	5	9	0	0	9	0	0
5	61868691	.	C	T	3	5	8	0	0	8	0	0
5	61868731	.	G	A	2	5	7	0	0	7	0	0
5	61870677	.	G	T	7	3	10	0	1	11	0	0
5	61871360	.	T	C	3	5	8	0	0	8	0	0
5	61874068	.	G	A	7	4	11	0	0	11	0	0
5	61877517	.	G	A	6	3	9	0	0	9	0	0
5	61881101	.	C	T	2	7	9	0	0	9	0	0
5	61881353	.	A	G	4	2	6	0	1	7	0	0
5	61884167	.	G	A	11	5	16	0	0	16	0	0
5	61884460	.	C	T	10	11	21	0	0	21	0	0
5	61884478	.	C	T	14	11	25	0	1	26	0	0
5	61884514	.	C	T	16	10	26	0	1	27	0	0
5	61886601	.	C	T	17	16	33	0	1	34	0	0
5	61886622	.	G	A	17	17	34	0	3	37	0	0
5	61889421	.	A	G	19	0	19	0	15	34	0	0
5	61889572	.	C	G	11	12	23	0	1	24	0	0
5	61890223	.	G	A	2	9	11	0	12	23	0	0
5	61890336	.	A	T	6	6	12	0	0	12	0	0
5	61921824	.	C	T	1	3	4	0	0	4	0	0
5	61923322	.	A	G	1	6	7	0	0	7	0	0
5	61928415	.	C	T	4	3	7	0	0	7	0	0
5	61930715	.	A	T	7	6	13	0	0	13	0	0
5	61931392	.	A	G	17	21	38	0	2	40	0	0
5	61931409	.	C	T	21	14	35	0	1	36	0	0
5	61931795	.	T	C	1	4	5	0	0	6	1	0
5	61932038	.	T	C	26	14	40	0	2	42	0	0
5	61932177	.	G	A	3	4	7	0	0	7	0	0
5	61932319	.	C	T	9	9	18	0	0	18	0	0
5	61932332	.	C	T	10	10	20	0	1	21	0	0
5	61932361	.	A	T	13	6	19	0	0	19	0	0
5	61932383	.	G	A	10	11	21	0	0	21	0	0
5	61932568	.	T	C	12	12	24	0	1	25	0	0
5	61932604	.	C	T	9	8	17	0	1	18	0	0
5	61932706	.	C	G	17	12	29	0	1	30	0	0
5	61932707	.	T	G	17	13	30	0	0	30	0	0
5	61932754	.	G	C	20	13	33	0	1	34	0	0
5	61934579	.	C	T	9	18	27	0	1	28	0	0
5	61941680	.	C	T	6	4	10	0	0	10	0	0
5	61941770	.	G	A	0	3	3	0	5	8	0	0
5	61941867	.	C	G	3	3	6	0	0	6	0	0
5	61944550	.	G	T	0	4	4	0	8	12	0	0
5	61947326	.	C	T	8	7	15	0	0	15	0	0
5	61947395	.	C	T	5	6	11	0	0	11	0	0
5	61947586	.	G	C	7	2	9	0	0	9	0	0
5	61947734	.	C	T	2	5	7	0	0	7	0	0
5	61947848	.	G	C	1	4	5	0	0	5	0	0
5	61947914	.	A	T	1	3	4	0	0	4	0	0
5	61947962	.	G	A	5	2	7	0	0	7	0	0
5	61947983	.	G	A	5	3	8	0	0	8	0	0
5	61948214	.	C	T	3	4	7	0	1	8	0	0
5	61948535	.	G	A	4	2	6	0	0	6	0	0
5	61948809	.	G	A	0	2	2	0	9	11	0	0
5	61949198	.	G	T	4	3	7	0	0	7	0	0
5	61949549	.	T	G	9	3	12	0	0	12	0	0
5	61949624	.	C	T	7	4	11	0	0	11	0	0
5	61949757	.	C	G	5	4	9	0	1	10	0	0
5	61950249	.	G	A	0	3	3	0	3	6	0	0
5	61950345	.	T	G	2	4	6	0	1	7	0	0
5	61950507	.	C	G	5	1	6	0	0	6	0	0
5	61950513	.	A	T	5	2	7	0	0	7	0	0
5	61950573	.	A	G	3	4	7	0	0	7	0	0
5	61950834	.	A	T	2	2	4	0	0	4	0	0
5	61951032	.	T	C	7	5	12	0	0	12	0	0
5	61951038	.	A	G	7	3	10	0	1	11	0	0
5	61998644	.	C	T	8	13	21	0	0	21	0	0
5	62004552	.	C	T	25	18	43	0	3	46	0	0
5	62004561	.	A	G	19	25	44	0	0	44	0	0
5	62004999	.	A	G	10	8	18	0	2	20	0	0
5	62005005	.	G	T	11	9	20	0	0	20	0	0
5	62018920	.	G	A	3	7	10	0	11	21	0	0
5	62025541	.	C	T	7	6	13	0	0	13	0	0
5	62025736	.	G	A	1	3	4	0	12	16	0	0
5	62025829	.	C	A	2	6	8	0	1	9	0	0
5	62025924	.	T	C	6	6	12	0	0	12	0	0
5	62025991	.	A	G	6	0	6	0	4	10	0	0
5	62026018	.	C	A	3	5	8	0	1	9	0	0
5	62029820	.	C	T	6	4	10	0	0	10	0	0
5	62033817	.	G	A	8	8	16	0	0	16	0	0
5	62038700	.	C	A	11	5	16	0	0	16	0	0
5	62042450	.	A	G	15	9	24	0	0	24	0	0
5	62052860	.	T	G	3	3	6	0	0	6	0	0
5	62053043	.	G	A	11	8	19	0	0	19	0	0
5	62288882	.	T	C	4	5	9	0	1	10	0	0
5	62288960	.	C	T	8	10	18	0	0	18	0	0
5	62289032	.	A	T	7	10	17	0	2	19	0	0
5	62289363	.	C	A	1	3	4	0	0	4	0	0
5	62289365	.	A	G	1	3	4	0	0	4	0	0
5	62289478	.	A	G	5	2	7	0	0	7	0	0
5	62290430	.	G	T	8	5	13	0	0	13	0	0
5	62290448	.	A	T	14	5	19	0	0	19	0	0
5	62290568	.	A	T	4	2	6	0	0	6	0	0
5	62290605	.	T	C	5	5	10	0	0	10	0	0
5	62290844	.	G	A	5	3	8	0	0	8	0	0
5	62290869	.	A	T	8	3	11	0	0	11	0	0
5	62290904	.	T	C	4	5	9	0	1	10	0	0
5	62290931	.	T	C	2	9	11	0	0	11	0	0
5	62315402	.	A	C	6	3	9	0	0	9	0	0
5	62315426	.	G	A	4	2	6	0	0	6	0	0
5	62319386	.	C	T	1	2	3	0	0	3	0	0
5	62321412	.	G	A	2	4	6	0	0	6	0	0
5	62328731	.	C	G	2	3	5	0	1	6	0	0
5	62328740	.	G	A	1	3	4	0	0	4	0	0
5	62328795	.	G	T	0	2	2	0	1	3	0	0
5	62329288	.	A	G	5	3	8	0	1	9	0	0
5	62329437	.	G	A	1	5	6	0	0	6	0	0
5	62329689	.	G	A	2	4	6	0	0	6	0	0
5	62329773	.	G	T	3	4	7	0	0	7	0	0
5	62329876	.	C	G	3	3	6	0	0	6	0	0
5	62329944	.	A	G	3	0	3	0	6	9	0	0
5	62330232	.	G	T	1	4	5	0	1	6	0	0
5	62330313	.	A	G	1	4	5	0	0	5	0	0
5	62330389	.	A	G	2	2	4	0	0	4	0	0
5	62330438	.	G	A	0	3	3	0	3	6	0	0
5	62330661	.	G	A	1	3	4	0	6	10	0	0
5	62330737	.	C	G	3	2	5	0	0	5	0	0
5	62330879	.	G	A	1	3	4	0	3	7	0	0
5	62330913	.	A	G	3	0	3	0	4	7	0	0
5	62331120	.	T	C	2	4	6	0	0	6	0	0
5	62331123	.	A	T	2	4	6	0	0	6	0	0
5	62331427	.	A	T	7	7	14	0	0	14	0	0
5	62331478	.	C	A	8	4	12	0	0	12	0	0
5	62331516	.	A	T	5	5	10	0	0	10	0	0
5	62331519	.	A	G	5	5	10	0	0	10	0	0
5	62331675	.	G	A	6	6	12	0	1	13	0	0
5	62331897	.	C	T	5	4	9	0	0	9	0	0
5	62331932	.	T	G	5	2	7	0	0	7	0	0
5	62332231	.	A	C	4	6	10	0	0	10	0	0
5	62332336	.	A	G	2	2	4	0	0	4	0	0
5	62332341	.	A	G	2	2	4	0	0	4	0	0
5	62332491	.	G	A	6	5	11	0	0	11	0	0
5	62332508	.	G	A	4	5	9	0	0	9	0	0
5	62332735	.	C	T	2	6	8	0	1	9	0	0
5	62332756	.	A	T	2	3	5	0	0	5	0	0
5	62333198	.	C	A	3	2	5	0	0	5	0	0
5	62333534	.	A	C	7	7	14	0	0	14	0	0
5	62333740	.	T	G	6	2	8	0	0	8	0	0
5	62333926	.	T	A	4	5	9	0	0	9	0	0
5	62333981	.	A	G	6	1	7	0	4	11	0	0
5	62334062	.	A	G	9	6	15	0	1	16	0	0
5	62334064	.	C	T	9	6	15	0	0	15	0	0
5	62334121	.	G	C	8	3	11	0	0	11	0	0
5	62334164	.	G	A	5	6	11	0	0	11	0	0
5	62334569	.	A	T	2	3	5	0	0	5	0	0
5	62334610	.	C	T	5	6	11	0	0	11	0	0
5	62334694	.	A	T	8	7	15	0	1	16	0	0
5	62334738	.	A	C	3	3	6	0	3	9	0	0
5	62334754	.	G	A	8	2	10	0	0	10	0	0
5	62334843	.	G	T	7	5	12	0	0	12	0	0
5	62335079	.	A	G	5	0	5	0	11	16	0	0
5	62335089	.	A	G	4	0	4	0	11	15	0	0
5	62335167	.	T	C	6	4	10	0	0	10	0	0
5	62335297	.	C	A	7	9	16	0	0	16	0	0
5	62335337	.	A	T	5	5	10	0	1	11	0	0
5	62335523	.	A	G	8	0	8	0	8	16	0	0
5	62335641	.	T	A	4	2	6	0	0	6	0	0
5	62335655	.	G	T	5	2	7	0	0	7	0	0
5	62341098	.	A	G	1	2	3	0	0	3	0	0
5	62346850	.	G	A	2	3	5	0	0	5	0	0
5	62521757	.	C	A	12	9	21	0	2	23	0	0
5	62526241	.	T	C	7	9	16	0	2	18	0	0
5	62526295	.	C	T	12	10	22	0	0	22	0	0
5	62533737	.	C	T	8	7	15	0	0	15	0	0
5	62633231	.	A	G	10	2	12	0	23	35	0	0
5	62637753	.	A	C	15	17	32	0	2	34	0	0
5	62639596	.	G	A	29	22	51	0	2	53	0	0
5	62642976	.	T	G	15	3	18	3	12	34	1	0
5	62642989	.	A	G	13	8	21	3	2	26	0	0
5	62806675	.	A	G	7	12	19	0	0	19	0	0
5	62806701	.	A	G	5	8	13	0	1	14	0	0
5	62806902	.	T	C	6	0	6	0	4	10	0	0
5	62806918	.	G	C	5	6	11	0	0	11	0	0
5	62806951	.	A	G	4	4	8	0	0	8	0	0
5	62807044	.	T	A	1	3	4	0	0	4	0	0
5	62807056	.	T	C	1	2	3	0	0	3	0	0
5	62807294	.	G	A	2	5	7	0	0	7	0	0
5	62807357	.	G	A	3	2	5	0	0	5	0	0
5	62821214	.	A	T	10	10	20	0	0	20	0	0
5	62856559	.	C	T	7	8	15	0	0	15	0	0
5	62868303	.	T	C	4	5	9	0	1	10	0	0
5	62868328	.	G	A	6	5	11	0	0	11	0	0
5	62883587	.	C	T	12	4	16	0	1	17	0	0
5	62884052	.	T	C	17	7	24	0	0	24	0	0
5	62885777	.	A	G	13	7	20	0	0	20	0	0
5	62885835	.	C	T	17	7	24	0	1	25	0	0
5	62885838	.	G	A	16	8	24	0	0	24	0	0
5	62889966	.	C	G	9	11	20	0	0	20	0	0
5	62890047	.	C	T	1	8	9	0	6	15	0	0
5	62890397	.	T	A	5	9	14	0	0	14	0	0
5	62890482	.	C	T	11	4	15	0	3	18	0	0
5	62890515	.	A	G	10	6	16	0	0	16	0	0
5	62890541	.	C	T	0	7	7	0	8	15	0	0
5	62890593	.	C	T	0	8	8	0	14	22	0	0
5	62890650	.	C	T	12	7	19	0	1	20	0	0
5	62890740	.	C	T	8	8	16	0	0	16	0	0
5	62940788	.	A	G	6	7	13	1	0	14	0	0
5	62987996	.	G	A	6	5	11	0	0	11	0	0
5	63065718	.	C	T	3	3	6	0	0	6	0	0
5	63065739	.	G	A	3	6	9	0	0	9	0	0
5	63065768	.	A	C	6	0	6	0	9	15	0	0
5	63089582	.	T	G	3	6	9	0	0	9	0	0
5	63091929	.	T	G	8	7	15	0	0	15	0	0
5	63248665	.	A	C	7	4	11	0	0	11	0	0
5	63248668	.	T	C	6	5	11	0	0	11	0	0
5	63268917	.	G	A	3	2	5	0	0	5	0	0
5	63285995	.	T	G	4	4	8	0	0	8	0	0
5	63289312	.	C	A	2	4	6	0	0	6	0	0
5	63305610	.	T	C	4	2	6	1	0	7	0	0
5	63315112	.	C	G	1	4	5	0	0	5	0	0
5	63315113	.	T	C	0	3	3	0	2	5	0	0
5	63319045	.	C	T	1	3	4	0	0	4	0	0
5	63360161	.	T	G	1	0	1	0	3	4	0	0
5	63360284	.	C	T	1	1	2	0	0	2	0	0
5	63360290	.	A	G	1	2	3	0	0	3	0	0
5	63360344	.	T	C	3	2	5	0	0	5	0	0
5	63363058	.	C	T	3	3	6	0	1	7	0	0
5	63367615	.	C	A	3	3	6	0	0	6	0	0
5	63375709	.	A	G	0	4	4	0	1	5	0	0
5	63375980	.	C	T	3	4	7	0	0	7	0	0
5	63376006	.	G	C	1	4	5	0	0	5	0	0
5	63376032	.	A	G	1	3	4	0	0	4	0	0
5	63376108	.	C	T	4	2	6	0	0	6	0	0
5	63376220	.	C	G	4	2	6	1	0	7	0	0
5	63378588	.	G	A	0	2	2	1	2	5	0	0
5	63395030	.	T	C	20	29	49	0	3	52	0	0
5	63395057	.	A	T	20	26	46	0	4	50	0	0
5	63398317	.	A	T	30	11	41	0	2	43	0	0
5	63398847	.	T	C	9	16	25	0	0	25	0	0
5	63399066	.	G	C	27	11	38	0	0	38	0	0
5	63399202	.	C	T	28	19	47	0	3	50	0	0
5	63399479	.	C	T	26	28	54	0	1	55	0	0
5	63399683	.	T	A	10	12	22	0	0	22	0	0
5	63411033	.	A	G	2	2	4	0	0	4	0	0
5	63510908	.	G	T	9	8	17	0	0	17	0	0
5	63511045	.	A	G	4	4	8	0	0	8	0	0
5	63511110	.	T	C	4	0	4	0	6	10	0	0
5	63511170	.	A	G	3	2	5	0	2	7	0	0
5	63511172	.	T	G	5	2	7	0	0	7	0	0
5	63511537	.	A	G	16	6	22	0	0	22	0	0
5	63514810	.	T	C	3	0	3	0	4	7	0	0
5	63629121	.	C	A	5	4	9	0	1	10	0	0
5	63629136	.	G	A	4	8	12	0	1	13	0	0
5	63629299	.	A	T	12	5	17	0	1	18	0	0
5	63644850	.	G	A	3	8	11	0	0	11	0	0
5	63648324	.	C	T	2	4	6	0	0	6	0	0
5	63648376	.	T	C	2	0	2	0	3	5	0	0
5	63648811	.	A	G	3	4	7	0	0	7	0	0
5	63655829	.	T	C	2	3	5	0	0	5	0	0
5	63657590	.	G	C	3	3	6	0	0	6	0	0
5	63657628	.	A	G	2	2	4	0	1	5	0	0
5	63680655	.	A	G	13	0	13	0	19	32	0	0
5	63680661	.	C	G	13	21	34	0	0	34	0	0
5	63680709	.	T	G	14	16	30	0	2	32	0	0
5	63680718	.	A	G	12	0	12	0	16	28	0	0
5	63681123	.	A	G	16	12	28	0	0	28	0	0
5	63681300	.	A	G	16	13	29	0	0	29	0	0
5	63695760	.	C	T	21	29	50	0	0	50	0	0
5	63698549	.	T	C	14	21	35	0	1	36	0	0
5	63699468	.	T	C	23	17	40	0	2	42	0	0
5	63720639	.	A	G	16	22	38	0	1	39	0	0
5	63723807	.	G	A	1	22	23	0	20	43	0	0
5	63730115	.	G	A	6	21	27	1	28	56	0	0
5	63740093	.	C	T	14	13	27	0	0	27	0	0
5	63740097	.	T	A	13	12	25	0	1	26	0	0
5	63740167	.	A	G	9	8	17	0	2	20	1	0
5	63740293	.	A	G	10	7	17	0	2	19	0	0
5	63740304	.	A	G	14	6	20	0	2	22	0	0
5	63740815	.	A	C	26	16	42	0	1	43	0	0
5	63740874	.	A	C	27	20	47	0	2	49	0	0
5	63740895	.	A	C	26	21	47	0	2	49	0	0
5	63740910	.	A	G	24	22	46	0	0	46	0	0
5	63741023	.	T	A	7	8	15	0	2	17	0	0
5	63741077	.	A	T	8	10	18	0	1	19	0	0
5	63848566	.	G	A	0	4	4	0	3	7	0	0
5	63848593	.	T	C	4	7	11	0	0	11	0	0
5	63848662	.	C	G	10	8	18	0	0	18	0	0
5	63857154	.	A	C	4	6	10	0	1	11	0	0
5	63860701	.	G	A	1	4	5	0	9	14	0	0
5	63860831	.	A	G	5	0	5	0	5	10	0	0
5	63860943	.	A	G	7	0	7	0	8	15	0	0
5	63861257	.	A	C	3	4	7	0	0	7	0	0
5	63861331	.	A	G	6	4	10	0	0	10	0	0
5	63861355	.	G	A	0	2	2	0	5	7	0	0
5	63862380	.	G	C	5	4	9	0	0	9	0	0
5	63862397	.	T	A	4	3	7	0	0	7	0	0
5	63862671	.	T	C	2	2	4	0	0	4	0	0
5	63862938	.	A	G	1	5	6	0	0	6	0	0
5	63862942	.	A	G	1	5	6	0	0	6	0	0
5	63863998	.	G	A	1	4	5	0	4	9	0	0
5	64177760	.	T	A	5	6	11	0	0	11	0	0
5	64177762	.	T	A	6	5	11	0	0	11	0	0
5	64181114	.	T	A	6	6	12	0	0	12	0	0
5	64182403	.	G	A	2	2	4	0	0	4	0	0
5	64184521	.	C	T	6	3	9	0	0	9	0	0
5	64184626	.	G	A	3	9	12	0	0	12	0	0
5	64204517	.	C	T	10	11	21	0	0	21	0	0
5	64204524	.	T	C	9	11	20	0	1	21	0	0
5	64205046	.	C	T	9	9	18	0	0	18	0	0
5	64205388	.	C	T	8	13	21	0	1	22	0	0
5	64205624	.	C	A	0	2	2	0	2	4	0	0
5	64205639	.	A	T	3	3	6	0	0	6	0	0
5	64205937	.	T	C	8	7	15	0	0	15	0	0
5	64206182	.	G	A	8	5	13	1	0	14	0	0
5	64206266	.	C	T	0	2	2	5	5	12	0	0
5	64206402	.	G	A	12	5	17	0	2	19	0	0
5	64206411	.	A	G	12	6	18	2	1	21	0	0
5	64206453	.	G	A	6	4	10	2	1	13	0	0
5	64206455	.	C	T	5	2	7	2	3	12	0	0
5	64206591	.	A	G	8	17	25	0	0	25	0	0
5	64206688	.	C	T	9	8	17	0	1	18	0	0
5	64207415	.	C	T	1	13	14	0	10	24	0	0
5	64207570	.	T	G	6	9	15	0	0	15	0	0
5	64207779	.	A	G	7	5	12	0	0	12	0	0
5	64210227	.	C	T	1	3	4	0	3	7	0	0
5	64210350	.	G	A	8	7	15	0	1	16	0	0
5	64212865	.	G	A	5	11	16	0	0	16	0	0
5	64212868	.	T	A	5	11	16	0	0	16	0	0
5	64291458	.	C	T	1	8	9	0	0	9	0	0
5	64291675	.	G	T	7	5	12	0	2	14	0	0
5	64299257	.	T	C	4	9	13	0	0	13	0	0
5	64369001	.	A	C	6	5	11	0	0	11	0	0
5	64369089	.	C	T	5	4	9	0	0	9	0	0
5	64376756	.	C	A	5	2	7	0	0	8	1	0
5	64377399	.	C	T	5	3	8	0	0	8	0	0
5	64377529	.	G	T	2	2	4	0	0	4	0	0
5	64377618	.	T	C	5	2	7	0	0	7	0	0
5	64378272	.	C	T	4	4	8	0	1	9	0	0
5	64378293	.	G	A	0	3	3	0	7	10	0	0
5	64378369	.	T	C	1	7	8	0	0	8	0	0
5	64378404	.	T	C	3	8	11	0	0	11	0	0
5	64378413	.	G	C	8	3	11	0	0	11	0	0
5	64397667	.	C	A	20	16	36	0	0	36	0	0
5	64398506	.	C	T	27	30	57	0	1	58	0	0
5	64398554	.	G	A	24	33	57	0	2	59	0	0
5	64398688	.	C	T	25	27	52	0	0	52	0	0
5	64408134	.	A	G	1	6	7	0	0	7	0	0
5	64408157	.	A	T	1	5	6	0	0	6	0	0
5	64408477	.	A	G	2	2	4	0	0	4	0	0
5	64412096	.	C	T	1	11	12	0	7	19	0	0
5	64412907	.	G	A	5	17	22	0	1	23	0	0
5	64413095	.	A	C	19	16	35	0	1	36	0	0
5	64413319	.	G	A	7	9	16	0	2	18	0	0
5	64413383	.	G	T	14	4	18	0	1	19	0	0
5	64413458	.	A	G	5	7	12	0	0	12	0	0
5	64413834	.	G	T	11	4	15	0	0	21	6	0
5	64413943	.	C	T	13	14	27	0	0	27	0	0
5	64439116	.	G	A	12	10	22	0	0	22	0	0
5	64439218	.	T	C	5	7	12	0	3	15	0	0
5	64439272	.	T	C	10	0	10	0	16	26	0	0
5	64444517	.	G	A	18	16	34	0	0	34	0	0
5	64448456	.	T	A	13	5	18	0	1	19	0	0
5	64454394	.	A	G	11	7	18	1	0	19	0	0
5	64732170	.	T	A	26	25	51	0	6	57	0	0
5	64732240	.	T	C	34	28	62	0	1	63	0	0
5	64740004	.	G	A	12	10	22	0	0	22	0	0
5	66250917	.	C	T	4	3	7	0	0	7	0	0
5	66252054	.	G	A	1	3	4	0	5	9	0	0
5	66252127	.	A	T	7	2	9	0	1	10	0	0
5	66263544	.	A	T	3	5	8	0	0	8	0	0
5	66266997	.	A	G	5	4	9	0	0	9	0	0
5	66271189	.	G	A	4	6	10	0	0	10	0	0
5	66271214	.	C	T	6	3	9	0	0	9	0	0
5	66388196	.	G	A	9	3	12	0	0	12	0	0
5	66389676	.	C	T	11	3	14	0	1	15	0	0
5	66397643	.	C	A	9	9	18	0	0	18	0	0
5	66402697	.	G	A	8	5	13	0	1	14	0	0
5	66404663	.	T	C	5	0	5	0	7	12	0	0
5	66404761	.	G	T	7	7	14	0	0	14	0	0
5	66498617	.	C	T	1	2	3	0	1	4	0	0
5	66676766	.	C	G	8	14	22	0	0	22	0	0
5	66676768	.	G	A	7	13	20	0	2	22	0	0
5	66699135	.	G	T	8	12	20	0	1	21	0	0
5	66699138	.	C	G	11	13	24	0	0	24	0	0
5	66699564	.	G	T	7	6	13	0	0	13	0	0
5	66700388	.	C	T	5	4	9	0	0	9	0	0
5	66700602	.	T	A	5	3	8	0	0	8	0	0
5	66700608	.	T	C	6	2	8	0	0	8	0	0
5	66700734	.	C	A	1	6	7	0	8	15	0	0
5	66700833	.	T	C	8	0	8	0	9	17	0	0
5	66700974	.	T	A	4	6	10	0	2	12	0	0
5	66701266	.	T	C	7	4	11	0	0	11	0	0
5	66701493	.	T	C	3	5	8	0	0	8	0	0
5	66702411	.	G	A	7	5	12	0	0	12	0	0
5	66733482	.	C	G	4	2	6	0	0	6	0	0
5	66733572	.	C	T	0	5	5	0	6	11	0	0
5	66733682	.	T	C	8	9	17	0	2	19	0	0
5	66733694	.	T	C	11	0	11	0	11	22	0	0
5	66733891	.	G	C	10	6	16	0	0	16	0	0
5	66736211	.	T	C	6	7	13	0	2	15	0	0
5	66736280	.	A	G	4	2	6	0	1	7	0	0
5	66740183	.	A	T	9	6	15	0	2	17	0	0
5	66740239	.	T	G	11	9	20	0	1	21	0	0
5	66740273	.	A	T	6	6	12	0	3	15	0	0
5	66807482	.	C	T	14	15	29	0	4	33	0	0
5	66807543	.	C	T	1	15	16	0	16	32	0	0
5	66807735	.	A	G	10	8	18	0	0	18	0	0
5	66807771	.	T	G	10	9	19	0	2	21	0	0
5	66807788	.	C	T	2	11	13	0	10	23	0	0
5	66807830	.	G	A	14	11	25	0	1	26	0	0
5	66807831	.	A	G	15	11	26	0	0	26	0	0
5	66807881	.	A	G	20	12	32	1	3	36	0	0
5	66807916	.	T	C	26	12	38	1	2	41	0	0
5	66813647	.	T	C	15	1	16	0	15	31	0	0
5	66813674	.	G	A	15	18	33	0	0	33	0	0
5	66813722	.	A	G	17	20	37	0	0	37	0	0
5	66814504	.	T	C	17	16	33	0	0	33	0	0
5	66814522	.	A	G	19	17	36	1	0	37	0	0
5	66818699	.	C	T	9	27	36	0	1	37	0	0
5	66819515	.	T	C	20	19	39	0	4	43	0	0
5	66820859	.	A	T	10	15	25	0	0	25	0	0
5	67273276	.	A	G	2	3	5	0	0	5	0	0
5	67273308	.	A	G	5	4	9	0	0	9	0	0
5	68766688	.	T	C	4	0	4	0	4	8	0	0
5	68766704	.	C	T	3	5	8	0	0	8	0	0
5	68767050	.	C	T	1	6	7	0	6	13	0	0
5	68767334	.	G	A	6	4	10	0	1	11	0	0
5	68767439	.	G	T	7	5	12	1	0	13	0	0
5	68767802	.	G	A	5	12	17	0	2	19	0	0
5	68778040	.	G	T	7	8	15	0	1	16	0	0
5	68778455	.	T	A	16	5	21	0	0	21	0	0
5	68778524	.	C	A	1	5	6	0	10	16	0	0
5	68778746	.	C	G	1	8	9	0	3	12	0	0
5	68778895	.	C	G	9	9	18	0	1	19	0	0
5	68778937	.	A	G	10	6	16	0	0	16	0	0
5	68778957	.	G	T	10	4	14	0	0	14	0	0
5	68779049	.	A	G	9	5	14	0	0	14	0	0
5	68779214	.	A	G	8	6	14	0	1	15	0	0
5	68779472	.	G	T	2	8	10	0	0	10	0	0
5	68779595	.	G	T	7	10	17	0	0	17	0	0
5	68782433	.	T	G	4	3	7	0	2	9	0	0
5	68807856	.	T	C	1	2	3	0	0	3	0	0
5	68826647	.	C	T	2	5	7	0	0	7	0	0
5	68831382	.	C	T	3	4	7	0	0	7	0	0
5	68832435	.	A	G	5	9	14	0	0	14	0	0
5	68840928	.	T	C	8	15	23	0	2	25	0	0
5	68846542	.	G	T	8	4	12	0	2	14	0	0
5	68848116	.	G	A	9	3	12	0	0	12	0	0
5	68850856	.	C	T	2	11	13	0	7	20	0	0
5	68850967	.	C	G	1	6	7	0	10	17	0	0
5	68860776	.	A	C	6	0	6	0	7	13	0	0
5	68863784	.	C	T	1	6	7	0	4	11	0	0
5	68863806	.	T	C	10	2	12	0	5	17	0	0
5	68873804	.	C	T	7	8	15	0	0	15	0	0
5	68892515	.	A	C	20	14	34	6	0	40	0	0
5	68892801	.	G	A	4	2	6	1	0	7	0	0
5	68899505	.	C	T	8	4	12	0	0	12	0	0
5	68900820	.	C	G	9	14	23	0	0	23	0	0
5	68900825	.	G	A	8	15	23	0	0	23	0	0
5	68900891	.	C	T	1	13	14	0	19	33	0	0
5	68927410	.	T	A	5	9	14	0	0	14	0	0
5	68927539	.	G	A	13	9	22	0	2	24	0	0
5	68927557	.	G	A	12	8	20	0	1	21	0	0
5	68927591	.	G	A	7	11	18	0	0	18	0	0
5	68963602	.	A	T	5	9	14	0	0	14	0	0
5	68980985	.	G	T	5	11	16	0	0	16	0	0
5	68982205	.	G	T	4	10	14	0	0	14	0	0
5	68982340	.	G	A	12	11	23	0	1	24	0	0
5	68993809	.	G	C	4	0	4	0	10	14	0	0
5	68996186	.	C	T	4	3	7	0	0	7	0	0
5	68998572	.	A	T	2	9	11	0	0	11	0	0
5	68999492	.	A	T	3	5	8	0	2	10	0	0
5	69002293	.	C	T	12	15	27	0	0	27	0	0
5	69008453	.	A	C	6	0	6	0	8	14	0	0
5	69014276	.	T	C	4	17	21	0	1	22	0	0
5	69016025	.	C	T	5	6	11	0	0	11	0	0
5	69018997	.	G	A	6	8	14	0	1	15	0	0
5	69140658	.	T	C	6	3	9	0	0	9	0	0
5	69140680	.	T	A	6	3	9	0	0	9	0	0
5	69141307	.	G	A	7	6	13	0	0	13	0	0
5	69141440	.	G	T	7	5	12	0	2	14	0	0
5	69144428	.	C	T	0	10	10	0	5	15	0	0
5	69150733	.	T	C	2	3	5	0	0	5	0	0
5	69155281	.	G	A	4	5	9	0	0	9	0	0
5	69200146	.	G	A	1	4	5	0	0	5	0	0
5	69205284	.	A	G	1	2	3	0	0	3	0	0
5	69209014	.	C	T	1	2	3	0	0	3	0	0
5	69209020	.	T	A	1	2	3	0	0	3	0	0
5	69234725	.	C	T	3	5	8	0	8	16	0	0
5	69234768	.	A	G	9	5	14	0	0	14	0	0
5	69235583	.	G	A	8	11	19	1	0	20	0	0
5	69235589	.	A	C	7	10	17	1	2	20	0	0
5	69238002	.	G	A	3	7	10	0	0	10	0	0
5	69246853	.	G	C	10	5	15	0	0	15	0	0
5	69259068	.	C	T	6	7	13	0	2	15	0	0
5	69259347	.	G	A	10	9	19	0	0	19	0	0
5	69259384	.	G	A	11	8	19	0	0	19	0	0
5	69271104	.	G	T	6	10	16	0	1	17	0	0
5	69271220	.	G	T	4	3	7	0	0	7	0	0
5	69271304	.	A	C	5	3	8	0	0	8	0	0
5	69278192	.	A	G	10	0	10	0	17	27	0	0
5	69280119	.	G	A	5	12	17	0	1	18	0	0
5	69287061	.	C	T	15	18	33	0	1	34	0	0
5	69287180	.	A	T	14	18	32	0	3	35	0	0
5	69287264	.	C	G	11	4	15	0	1	16	0	0
5	69287498	.	C	T	5	3	8	0	0	8	0	0
5	69316105	.	T	G	3	4	7	0	0	7	0	0
5	69316129	.	C	T	1	5	6	0	0	6	0	0
5	69427984	.	A	G	12	15	27	0	0	27	0	0
5	69428056	.	A	T	8	3	11	0	0	11	0	0
5	69429132	.	G	A	4	5	9	0	0	9	0	0
5	69429544	.	G	A	23	13	36	0	1	37	0	0
5	69431287	.	G	C	12	17	29	0	2	31	0	0
5	69462882	.	G	A	4	4	8	0	0	8	0	0
5	69462894	.	C	T	0	3	3	0	4	7	0	0
5	69463008	.	C	A	2	4	6	0	1	7	0	0
5	69463038	.	G	T	6	4	10	0	1	11	0	0
5	69463077	.	G	A	5	6	11	0	0	11	0	0
5	69464731	.	G	A	12	5	17	0	0	17	0	0
5	69464773	.	G	A	11	7	18	0	0	18	0	0
5	69464811	.	C	T	1	13	14	0	2	16	0	0
5	69466375	.	G	T	4	6	10	0	0	10	0	0
5	69468882	.	C	G	4	2	6	0	0	6	0	0
5	69469336	.	G	A	8	8	16	0	0	16	0	0
5	69479393	.	T	G	3	4	7	0	0	7	0	0
5	69482885	.	C	T	1	9	10	0	7	17	0	0
5	69486618	.	T	C	4	8	12	0	0	12	0	0
5	69486698	.	G	A	5	6	11	0	1	12	0	0
5	69486749	.	A	T	10	13	23	0	0	23	0	0
5	69486756	.	G	A	8	12	20	0	0	20	0	0
5	69486844	.	G	T	11	9	20	0	0	20	0	0
5	69491754	.	G	A	9	10	19	0	1	20	0	0
5	69491766	.	T	C	7	0	7	0	10	17	0	0
5	69492126	.	G	C	9	0	9	0	8	17	0	0
5	69495925	.	G	A	1	7	8	0	0	8	0	0
5	69495928	.	C	G	0	2	2	0	5	7	0	0
5	69505374	.	G	A	1	3	4	0	0	4	0	0
5	69509826	.	G	A	1	2	3	0	0	3	0	0
5	69536449	.	C	G	5	5	10	0	0	10	0	0
5	69538025	.	C	T	0	2	2	0	1	3	0	0
5	69557764	.	A	G	4	6	10	0	0	10	0	0
5	69557776	.	G	T	3	5	8	0	0	8	0	0
5	69574886	.	A	G	3	2	5	0	0	5	0	0
5	69574972	.	G	T	13	7	20	0	1	21	0	0
5	69577902	.	G	T	12	7	19	13	2	34	0	0
5	69579118	.	T	C	14	0	14	0	19	33	0	0
5	69579378	.	G	A	9	5	14	10	1	25	0	0
5	69579435	.	A	C	1	2	3	11	0	14	0	0
5	69581943	.	C	T	0	3	3	1	9	13	0	0
5	69582208	.	G	A	4	3	7	5	0	12	0	0
5	69588720	.	A	T	4	19	23	0	0	23	0	0
5	69595361	.	G	A	10	23	33	1	2	36	0	0
5	69599798	.	G	T	5	7	12	1	0	13	0	0
5	69607398	.	T	C	2	5	7	0	0	7	0	0
5	69607411	.	A	C	2	5	7	2	0	12	3	0
5	69616625	.	A	T	3	3	6	5	0	11	0	0
5	69666561	.	C	G	1	3	4	0	0	4	0	0
5	69686414	.	T	C	2	2	4	0	0	4	0	0
5	71943593	.	A	G	5	2	7	0	0	7	0	0
6	267516	.	G	A	1	4	5	0	1	6	0	0
6	267634	.	A	G	7	3	10	0	1	11	0	0
6	272194	.	A	G	37	1	38	0	11	49	0	0
6	842264	.	T	C	17	7	24	0	0	24	0	0
6	844282	.	T	C	9	4	13	0	0	13	0	0
6	1323115	.	G	A	1	7	8	0	0	8	0	0
6	3005094	.	T	G	9	9	18	0	0	18	0	0
6	3005179	.	G	T	4	9	13	1	0	14	0	0
6	3040450	.	G	A	0	7	7	0	5	12	0	0
6	3040536	.	T	C	11	4	15	0	0	15	0	0
6	3040572	.	G	A	5	6	11	0	2	13	0	0
6	3047971	.	A	T	7	5	12	0	0	12	0	0
6	3143292	.	T	A	9	10	19	0	1	20	0	0
6	3143609	.	G	A	12	5	17	0	1	18	0	0
6	3197028	.	C	T	13	13	26	0	3	29	0	0
6	3223245	.	C	T	5	9	14	0	0	14	0	0
6	3223341	.	C	G	12	11	23	0	0	23	0	0
6	3249490	.	C	T	11	10	21	0	0	21	0	0
6	3256066	.	C	A	17	17	34	0	1	35	0	0
6	3268327	.	T	C	12	12	24	0	3	27	0	0
6	3269864	.	A	G	10	1	11	0	22	33	0	0
6	3270011	.	G	A	10	24	34	0	2	36	0	0
6	3273272	.	A	T	12	14	26	0	0	26	0	0
6	3273341	.	T	A	12	9	21	0	2	23	0	0
6	3273379	.	A	G	7	9	16	0	2	18	0	0
6	3273901	.	T	G	11	0	11	0	19	30	0	0
6	3274114	.	G	C	2	15	17	0	16	33	0	0
6	3274191	.	G	C	11	12	23	2	3	28	0	0
6	3280947	.	C	T	4	6	10	0	1	11	0	0
6	3280975	.	G	C	5	6	11	0	1	12	0	0
6	3282817	.	G	A	1	3	4	0	4	8	0	0
6	3284988	.	A	C	5	4	9	0	0	9	0	0
6	3287392	.	G	A	0	4	4	0	1	5	0	0
6	3287437	.	A	G	1	3	4	0	1	5	0	0
6	3293193	.	G	A	0	4	4	0	3	7	0	0
6	3293322	.	T	C	5	2	7	0	0	7	0	0
6	3293385	.	G	A	0	5	5	0	3	8	0	0
6	3293428	.	T	A	4	5	9	0	0	9	0	0
6	3293441	.	C	G	4	5	9	0	0	9	0	0
6	3293933	.	T	G	5	2	7	0	2	9	0	0
6	3294037	.	C	A	0	3	3	0	1	4	0	0
6	3294048	.	G	A	0	4	4	0	1	5	0	0
6	3294251	.	T	C	5	7	12	0	3	15	0	0
6	3294306	.	G	T	0	6	6	0	4	10	0	0
6	3294755	.	C	T	7	8	15	0	0	15	0	0
6	3295262	.	C	T	5	3	8	0	0	8	0	0
6	3295596	.	G	A	0	2	2	4	8	14	0	0
6	3295607	.	C	T	9	2	11	2	1	14	0	0
6	3295664	.	T	A	6	6	12	0	1	13	0	0
6	3298796	.	G	A	6	4	10	0	0	10	0	0
6	3298816	.	G	C	6	4	10	0	0	10	0	0
6	3298844	.	C	T	3	4	7	0	0	7	0	0
6	3312627	.	C	T	2	2	4	0	0	4	0	0
6	3312750	.	A	T	6	2	8	0	0	8	0	0
6	3318673	.	T	C	5	7	12	0	0	12	0	0
6	3318721	.	G	A	0	3	3	0	10	13	0	0
6	3343800	.	T	C	4	2	6	0	0	6	0	0
6	3395649	.	C	T	3	3	6	0	0	6	0	0
6	3398906	.	A	G	5	4	9	0	0	9	0	0
6	3404956	.	G	A	0	4	4	0	6	10	0	0
6	3404974	.	C	T	7	5	12	0	0	12	0	0
6	3405143	.	T	C	7	5	12	0	0	12	0	0
6	3405191	.	G	C	5	7	12	0	0	12	0	0
6	3405244	.	A	G	6	4	10	0	1	11	0	0
6	3405245	.	C	A	7	3	10	0	1	11	0	0
6	3499159	.	T	A	2	2	4	0	0	4	0	0
6	3514481	.	A	C	33	24	57	3	4	64	0	0
6	3516914	.	A	G	2	2	4	0	0	4	0	0
6	3516918	.	T	C	2	2	4	0	0	4	0	0
6	3537472	.	G	A	2	2	4	0	1	5	0	0
6	3564404	.	A	G	5	3	8	0	1	9	0	0
6	3566481	.	T	C	4	2	6	0	0	6	0	0
6	3566597	.	A	G	1	2	3	0	0	3	0	0
6	3573650	.	T	G	2	4	6	0	0	6	0	0
6	3698558	.	C	T	9	5	14	0	0	14	0	0
6	3704391	.	G	A	0	12	12	0	8	20	0	0
6	3707095	.	A	G	11	11	22	0	0	22	0	0
6	3707116	.	G	A	18	10	28	0	0	28	0	0
6	3707371	.	G	A	0	10	10	0	13	23	0	0
6	3707372	.	A	G	9	10	19	0	4	23	0	0
6	3707407	.	T	C	6	12	18	0	0	18	0	0
6	3708061	.	A	G	2	8	10	0	2	12	0	0
6	3708149	.	T	C	4	6	10	0	0	10	0	0
6	3711200	.	T	A	7	9	16	0	1	17	0	0
6	3711221	.	A	G	13	12	25	0	1	26	0	0
6	3711282	.	T	G	15	0	15	0	20	35	0	0
6	3711338	.	A	G	7	12	19	0	1	20	0	0
6	3711386	.	T	C	10	13	23	0	1	24	0	0
6	3711419	.	A	G	9	8	17	0	0	17	0	0
6	3711448	.	C	A	5	7	12	0	0	12	0	0
6	3711616	.	G	A	7	5	12	0	0	12	0	0
6	3711971	.	G	A	6	6	12	0	2	14	0	0
6	3712045	.	T	A	5	7	12	0	1	13	0	0
6	3712069	.	A	T	4	7	11	0	0	11	0	0
6	3712136	.	G	A	11	6	17	0	1	18	0	0
6	3712198	.	G	T	6	6	12	0	0	12	0	0
6	3712199	.	A	C	6	6	12	0	0	12	0	0
6	3712238	.	A	T	7	7	14	0	0	16	2	0
6	3712264	.	A	C	11	6	17	0	2	19	0	0
6	3712335	.	T	G	13	0	13	0	11	24	0	0
6	3712389	.	C	T	9	6	15	0	1	16	0	0
6	3712433	.	A	T	4	4	8	0	0	8	0	0
6	3712713	.	C	G	4	10	14	0	1	15	0	0
6	3717060	.	T	A	6	4	10	0	0	10	0	0
6	3717110	.	A	T	23	8	31	0	1	32	0	0
6	3717843	.	C	T	11	10	21	0	0	21	0	0
6	3724870	.	A	C	14	16	30	0	1	31	0	0
6	3725767	.	C	A	20	23	43	0	0	43	0	0
6	3727891	.	C	T	7	13	20	0	0	20	0	0
6	3728295	.	A	T	4	5	9	0	0	9	0	0
6	3728559	.	G	C	4	2	6	0	0	6	0	0
6	3812378	.	C	T	2	3	5	0	0	5	0	0
6	3812470	.	T	C	1	3	4	0	0	4	0	0
6	3812562	.	A	T	1	2	3	0	0	3	0	0
6	3812572	.	G	C	1	2	3	0	0	3	0	0
6	3827894	.	C	A	18	23	41	0	4	45	0	0
6	3834630	.	G	C	39	28	67	0	2	69	0	0
6	3853120	.	T	G	38	0	38	0	33	71	0	0
6	3853165	.	T	C	38	35	73	0	2	75	0	0
6	3862018	.	A	G	11	19	30	0	0	30	0	0
6	3867542	.	A	T	11	15	26	0	4	30	0	0
6	3869454	.	G	A	0	20	20	0	21	41	0	0
6	3869891	.	C	T	22	24	46	0	0	46	0	0
6	3871982	.	T	A	25	21	46	1	4	51	0	0
6	3874504	.	G	A	4	20	24	0	20	44	0	0
6	3874533	.	C	T	19	25	44	0	0	44	0	0
6	3874686	.	A	G	19	10	29	0	0	29	0	0
6	3878513	.	T	A	9	8	17	0	0	17	0	0
6	3878593	.	A	G	6	7	13	0	0	13	0	0
6	3878831	.	G	C	6	5	11	0	1	12	0	0
6	3878983	.	A	T	14	6	20	0	4	24	0	0
6	3879158	.	A	G	11	11	22	0	1	23	0	0
6	3879247	.	C	A	3	9	12	0	18	30	0	0
6	3879314	.	C	G	0	12	12	0	8	20	0	0
6	3879335	.	C	T	6	15	21	0	0	21	0	0
6	3879367	.	G	A	6	19	25	0	0	25	0	0
6	3881078	.	G	A	12	15	27	0	2	29	0	0
6	3885451	.	C	T	13	8	21	0	2	23	0	0
6	3895442	.	A	T	13	10	23	0	0	23	0	0
6	3895460	.	C	T	0	6	6	0	17	23	0	0
6	3901120	.	C	T	1	14	15	0	11	26	0	0
6	3906051	.	C	T	0	6	6	0	7	13	0	0
6	3907796	.	A	T	4	7	11	0	0	11	0	0
6	3934836	.	G	A	8	4	12	0	0	12	0	0
6	3944518	.	G	T	3	6	9	0	0	9	0	0
6	3945773	.	C	A	7	8	15	0	0	15	0	0
6	3945792	.	C	A	9	9	18	0	1	19	0	0
6	3953280	.	T	C	7	11	18	0	1	19	0	0
6	3953302	.	A	C	7	10	17	0	0	17	0	0
6	3961387	.	G	A	5	2	7	0	0	7	0	0
6	3962132	.	G	A	32	16	48	0	1	49	0	0
6	3962192	.	A	T	25	20	45	0	2	47	0	0
6	3964619	.	G	A	14	13	27	0	0	27	0	0
6	3965389	.	G	T	17	15	32	0	0	32	0	0
6	3965461	.	A	G	18	17	35	0	0	35	0	0
6	3973572	.	G	A	17	13	30	0	1	31	0	0
6	3973638	.	T	G	13	10	23	0	0	23	0	0
6	3974047	.	G	A	9	14	23	0	1	24	0	0
6	3985083	.	G	A	7	6	13	0	0	13	0	0
6	3985137	.	G	A	9	14	23	0	0	23	0	0
6	3987131	.	A	G	4	5	9	0	0	9	0	0
6	3987145	.	T	C	4	2	6	0	0	6	0	0
6	3989704	.	C	A	4	4	8	0	0	8	0	0
6	4109451	.	C	T	1	1	2	0	1	3	0	0
6	4109454	.	T	C	0	2	2	0	0	2	0	0
6	4109924	.	C	T	1	3	4	0	0	4	0	0
6	4144415	.	C	T	9	3	12	0	0	12	0	0
6	4144448	.	C	T	3	5	8	0	0	8	0	0
6	4145917	.	C	G	2	4	6	0	0	6	0	0
6	4185678	.	G	A	19	20	39	0	1	40	0	0
6	4191449	.	C	T	10	13	23	0	0	23	0	0
6	4191554	.	A	T	7	11	18	0	0	18	0	0
6	4192025	.	G	A	10	7	17	0	1	18	0	0
6	4192031	.	A	G	7	9	16	0	0	16	0	0
6	4192171	.	G	A	6	4	10	0	0	10	0	0
6	4199494	.	T	C	4	10	14	0	0	14	0	0
6	4200799	.	C	T	6	3	9	0	2	11	0	0
6	4204072	.	G	T	7	10	17	0	1	18	0	0
6	4204117	.	G	T	5	9	14	0	0	14	0	0
6	4206411	.	G	A	4	2	6	0	0	6	0	0
6	4206435	.	G	A	2	5	7	0	0	7	0	0
6	4219856	.	G	A	10	11	21	0	2	23	0	0
6	4229789	.	T	C	8	5	13	0	1	14	0	0
6	4229790	.	T	C	8	6	14	0	0	14	0	0
6	4229830	.	C	T	4	4	8	0	0	8	0	0
6	4229854	.	A	G	5	2	7	0	4	11	0	0
6	4241945	.	C	T	1	2	3	0	0	3	0	0
6	4241954	.	A	G	1	3	4	0	0	4	0	0
6	4245276	.	C	T	11	5	16	0	0	16	0	0
6	4246466	.	T	C	7	3	10	1	0	11	0	0
6	4246496	.	G	A	1	3	4	0	7	11	0	0
6	4246638	.	A	C	3	5	8	0	0	8	0	0
6	4247755	.	C	T	6	3	9	1	0	10	0	0
6	4247928	.	C	T	2	4	6	0	1	7	0	0
6	4247942	.	T	C	4	3	7	0	0	7	0	0
6	4248160	.	A	G	5	2	7	0	1	8	0	0
6	4248195	.	G	C	5	5	10	0	0	10	0	0
6	4248399	.	A	T	10	2	12	0	0	12	0	0
6	4248412	.	T	A	8	4	12	0	0	12	0	0
6	4248527	.	T	A	1	3	4	0	0	4	0	0
6	4249420	.	C	T	2	3	5	0	0	5	0	0
6	4249437	.	A	G	3	2	5	0	0	5	0	0
6	4249684	.	A	G	8	3	11	0	0	11	0	0
6	4249821	.	G	A	2	2	4	0	0	4	0	0
6	4290203	.	T	C	3	5	8	0	0	8	0	0
6	4401087	.	T	A	1	6	7	1	0	8	0	0
6	4401088	.	A	T	2	5	7	1	0	8	0	0
6	6307947	.	T	C	2	2	4	0	1	5	0	0
6	6737472	.	T	C	6	3	9	0	1	10	0	0
6	7542491	.	G	T	2	13	15	0	18	33	0	0
6	7545794	.	C	T	17	13	30	0	1	31	0	0
6	7545824	.	T	C	20	9	29	0	0	29	0	0
6	7547451	.	C	T	7	10	17	0	0	17	0	0
6	7549967	.	G	A	26	21	47	0	1	48	0	0
6	7550210	.	A	C	11	10	21	0	0	21	0	0
6	7550405	.	C	T	16	8	24	0	0	24	0	0
6	7555618	.	C	T	11	11	22	0	0	22	0	0
6	7591018	.	G	A	7	10	17	0	0	17	0	0
6	7603032	.	G	A	13	5	18	0	1	19	0	0
6	7604821	.	A	C	8	5	13	0	2	15	0	0
6	7608307	.	C	T	8	8	16	0	0	16	0	0
6	7612455	.	T	C	7	6	13	0	0	13	0	0
6	7624012	.	T	C	10	14	24	0	2	26	0	0
6	7626457	.	C	T	10	10	20	0	0	20	0	0
6	7633452	.	G	C	2	17	19	0	17	36	0	0
6	7636811	.	A	T	16	14	30	0	0	30	0	0
6	7637195	.	C	T	22	13	35	0	1	37	1	0
6	7638717	.	G	A	14	17	31	0	4	35	0	0
6	7645319	.	T	C	10	17	27	0	1	29	1	0
6	7646039	.	A	G	9	15	24	0	1	25	0	0
6	7646102	.	G	A	14	18	32	0	0	32	0	0
6	7646111	.	G	C	14	20	34	0	0	34	0	0
6	7648224	.	A	G	13	0	13	0	17	30	0	0
6	7652458	.	C	T	25	10	35	0	0	35	0	0
6	7652470	.	A	C	22	14	36	0	0	36	0	0
6	7652896	.	G	A	3	24	27	0	14	41	0	0
6	7652959	.	C	T	20	17	37	0	1	38	0	0
6	7652989	.	C	T	25	21	46	0	0	46	0	0
6	7656920	.	A	G	25	0	25	1	24	50	0	0
6	7656932	.	A	G	23	25	48	1	0	49	0	0
6	7657077	.	A	C	26	7	33	1	2	36	0	0
6	7657177	.	C	T	13	16	29	0	0	29	0	0
6	7657793	.	A	C	17	16	33	0	0	33	0	0
6	7657886	.	T	A	22	14	36	0	0	36	0	0
6	7657887	.	G	T	22	13	35	0	1	36	0	0
6	7657972	.	T	G	17	5	22	1	1	24	0	0
6	7658076	.	G	A	12	13	25	0	1	26	0	0
6	7659823	.	A	T	1	3	4	0	1	5	0	0
6	7659915	.	G	A	4	5	9	0	0	9	0	0
6	7660119	.	A	G	7	6	13	0	1	14	0	0
6	7660300	.	T	C	4	0	4	0	4	8	0	0
6	7660458	.	A	C	3	0	3	0	8	11	0	0
6	7660594	.	C	T	3	6	9	0	1	10	0	0
6	7660659	.	C	A	0	7	7	0	1	8	0	0
6	7663116	.	A	T	4	2	6	0	0	6	0	0
6	7679455	.	G	A	5	3	8	0	1	9	0	0
6	7682793	.	C	A	0	2	2	0	3	5	0	0
6	7686080	.	G	A	5	4	9	0	0	9	0	0
6	7688757	.	A	C	5	0	5	0	7	12	0	0
6	7697573	.	G	A	3	6	9	0	0	9	0	0
6	7702770	.	G	T	9	4	13	0	0	13	0	0
6	7705984	.	G	A	3	5	8	0	0	8	0	0
6	7713433	.	G	A	21	25	46	0	3	49	0	0
6	7721530	.	T	A	7	6	13	0	1	14	0	0
6	7721860	.	G	A	6	3	9	0	1	10	0	0
6	7721906	.	G	A	6	12	18	0	0	18	0	0
6	7721958	.	C	A	9	14	23	1	1	25	0	0
6	7722143	.	G	T	21	7	28	0	0	29	1	0
6	7722159	.	A	T	18	9	27	0	5	32	0	0
6	7722195	.	G	T	11	9	20	0	0	20	0	0
6	7722205	.	G	A	9	8	17	0	0	17	0	0
6	7722333	.	G	A	11	8	19	2	1	22	0	0
6	7722467	.	T	A	13	4	17	2	0	19	0	0
6	7722577	.	C	T	0	16	16	0	8	24	0	0
6	7722921	.	A	T	2	5	7	0	0	7	0	0
6	7723008	.	G	T	10	10	20	0	0	20	0	0
6	7723155	.	A	C	8	10	18	0	0	18	0	0
6	7723232	.	A	T	7	7	14	0	1	15	0	0
6	7723850	.	C	T	1	12	13	0	12	25	0	0
6	7723961	.	G	A	7	10	17	0	1	18	0	0
6	7726824	.	G	A	12	11	23	0	0	23	0	0
6	7734250	.	A	C	6	8	14	0	1	15	0	0
6	7734271	.	C	A	4	9	13	0	0	13	0	0
6	7795698	.	C	T	16	14	30	0	6	36	0	0
6	7842013	.	C	T	2	17	19	0	13	32	0	0
6	7842034	.	C	A	14	19	33	0	0	33	0	0
6	8176101	.	A	G	8	7	15	0	1	16	0	0
6	8176575	.	C	T	9	6	15	0	0	15	0	0
6	8177030	.	T	C	14	11	25	0	0	25	0	0
6	8177399	.	T	C	8	5	13	0	0	13	0	0
6	8177600	.	T	C	17	13	30	0	0	30	0	0
6	8177678	.	C	T	10	8	18	0	0	18	0	0
6	8178002	.	T	C	16	12	28	0	0	28	0	0
6	8178053	.	G	A	1	13	14	0	9	23	0	0
6	8178113	.	T	C	15	10	25	0	1	26	0	0
6	8178351	.	G	A	11	9	20	0	0	20	0	0
6	8179022	.	G	T	2	12	14	0	17	31	0	0
6	8179205	.	A	T	9	15	24	0	0	24	0	0
6	8179373	.	G	A	14	11	25	0	0	25	0	0
6	8210404	.	C	T	4	2	6	0	0	6	0	0
6	8210902	.	C	G	2	3	5	0	0	5	0	0
6	8211075	.	C	T	5	4	9	0	0	9	0	0
6	8211106	.	T	C	6	3	9	0	0	9	0	0
6	8211143	.	A	T	2	4	6	0	0	6	0	0
6	8211154	.	T	C	3	2	5	0	0	5	0	0
6	8211253	.	G	A	5	7	12	0	0	12	0	0
6	8214118	.	T	C	5	2	7	0	1	8	0	0
6	8214947	.	T	C	1	0	1	0	6	7	0	0
6	8217870	.	G	A	3	4	7	0	0	7	0	0
6	8224881	.	A	G	1	2	3	0	0	3	0	0
6	8265282	.	G	A	2	10	12	0	1	13	0	0
6	8267111	.	C	T	16	16	32	0	2	34	0	0
6	8267266	.	A	G	18	19	37	0	0	37	0	0
6	8267284	.	G	A	14	18	32	0	0	32	0	0
6	8267307	.	G	C	16	16	32	0	0	32	0	0
6	8267352	.	A	T	20	16	36	0	0	36	0	0
6	8267519	.	G	A	26	20	46	0	1	47	0	0
6	8267563	.	G	T	24	22	46	0	0	46	0	0
6	8267635	.	T	C	21	15	36	0	3	39	0	0
6	8267795	.	T	A	11	8	19	0	1	20	0	0
6	8267880	.	G	A	9	10	19	0	2	21	0	0
6	8268529	.	A	G	13	12	25	0	0	25	0	0
6	8273066	.	G	A	11	12	23	0	0	23	0	0
6	8277141	.	C	A	11	12	23	0	1	24	0	0
6	8282275	.	A	G	9	9	18	0	0	18	0	0
6	8283360	.	A	G	4	11	15	0	0	15	0	0
6	8283393	.	T	C	5	2	7	0	12	19	0	0
6	8289112	.	G	A	10	5	15	0	0	15	0	0
6	8291577	.	T	G	7	8	15	0	1	16	0	0
6	8310840	.	C	T	2	5	7	0	1	8	0	0
6	8315076	.	A	G	14	16	30	0	1	31	0	0
6	8315078	.	A	G	14	14	28	0	3	31	0	0
6	8316947	.	A	G	6	10	16	0	0	16	0	0
6	8318001	.	T	C	6	18	24	0	1	25	0	0
6	8318037	.	G	A	0	16	16	0	13	29	0	0
6	8328181	.	G	T	6	18	24	0	0	24	0	0
6	8366006	.	A	T	13	5	18	0	1	19	0	0
6	8366167	.	C	T	12	9	21	0	2	23	0	0
6	8370489	.	T	C	14	15	29	0	1	30	0	0
6	8375089	.	C	T	13	13	26	0	0	26	0	0
6	8380345	.	G	A	5	6	11	0	1	12	0	0
6	8380433	.	G	C	5	6	11	0	0	11	0	0
6	8380485	.	G	T	7	4	11	0	0	11	0	0
6	8391629	.	C	T	0	10	10	0	12	22	0	0
6	8392005	.	G	A	7	11	18	0	2	20	0	0
6	8460400	.	A	T	2	3	5	0	0	5	0	0
6	8460435	.	G	T	3	3	6	0	1	7	0	0
6	8460493	.	G	T	4	6	10	0	0	10	0	0
6	8501017	.	A	G	2	3	5	0	0	5	0	0
6	8512263	.	A	G	2	2	4	0	0	4	0	0
6	8518860	.	C	T	1	2	3	0	0	3	0	0
6	9130482	.	A	G	2	2	4	0	0	4	0	0
6	9130521	.	A	G	1	7	8	0	0	8	0	0
6	9130575	.	A	G	1	13	14	0	1	15	0	0
6	10586742	.	A	G	5	2	7	0	0	7	0	0
6	10702220	.	A	T	5	2	7	0	0	7	0	0
6	10982877	.	C	T	1	2	3	0	0	3	0	0
6	10983029	.	A	C	4	5	9	0	0	9	0	0
6	10983356	.	G	A	3	3	6	0	0	6	0	0
6	10983409	.	A	T	1	2	3	0	0	3	0	0
6	10983465	.	A	T	3	5	8	0	1	9	0	0
6	10985878	.	C	T	8	11	19	0	0	19	0	0
6	10986131	.	C	T	1	13	14	0	8	22	0	0
6	10986652	.	A	G	9	9	18	0	0	18	0	0
6	11059757	.	G	A	1	3	4	0	0	4	0	0
6	11059775	.	T	A	1	3	4	0	0	4	0	0
6	11070411	.	G	C	19	8	27	0	0	27	0	0
6	11070563	.	A	C	19	27	46	0	4	50	0	0
6	11070806	.	G	A	30	22	52	0	1	53	0	0
6	11071056	.	T	A	24	22	46	0	3	50	1	0
6	11071222	.	A	G	21	32	53	1	1	55	0	0
6	11071345	.	G	A	18	38	56	0	4	60	0	0
6	11071357	.	A	G	20	36	56	0	3	59	0	0
6	11107326	.	T	C	6	0	6	0	6	12	0	0
6	11113028	.	C	T	7	8	15	0	0	15	0	0
6	11120420	.	G	A	2	3	5	0	1	6	0	0
6	11122754	.	G	A	2	5	7	0	1	8	0	0
6	11129033	.	G	A	11	7	18	0	1	19	0	0
6	11129105	.	C	T	8	3	11	0	0	11	0	0
6	11129282	.	C	T	1	2	3	0	6	9	0	0
6	11129357	.	T	C	2	3	5	0	0	5	0	0
6	11129447	.	A	T	1	2	3	0	1	4	0	0
6	11141514	.	T	G	4	3	7	0	0	7	0	0
6	11148875	.	C	T	2	2	4	0	0	4	0	0
6	11250077	.	G	T	12	19	31	0	2	33	0	0
6	11250973	.	T	C	9	10	19	0	0	19	0	0
6	11253396	.	T	C	14	12	26	0	0	26	0	0
6	11253417	.	T	C	11	12	23	0	2	25	0	0
6	11253432	.	A	G	8	14	22	0	1	23	0	0
6	11253881	.	T	C	9	10	19	0	0	19	0	0
6	11253890	.	C	T	10	10	20	0	3	23	0	0
6	11253989	.	C	T	14	13	27	0	0	27	0	0
6	11254196	.	C	T	8	14	22	0	1	23	0	0
6	11254430	.	C	T	9	5	14	0	0	14	0	0
6	11254610	.	C	T	12	11	23	0	0	23	0	0
6	11257788	.	C	T	16	18	34	0	0	34	0	0
6	11261308	.	C	A	22	14	36	0	0	36	0	0
6	11262080	.	C	T	17	12	29	0	0	29	0	0
6	11264258	.	G	A	10	19	29	0	2	31	0	0
6	11265321	.	G	T	13	9	22	0	0	22	0	0
6	11265424	.	T	C	9	14	23	0	0	23	0	0
6	11265505	.	A	T	11	11	22	0	1	23	0	0
6	11265562	.	T	A	14	13	27	0	2	29	0	0
6	11265761	.	A	T	22	22	44	0	1	45	0	0
6	11265833	.	A	G	18	2	20	0	20	40	0	0
6	11266164	.	T	C	25	17	42	0	0	42	0	0
6	11266176	.	C	T	22	14	36	0	0	36	0	0
6	11266360	.	T	G	8	13	21	0	0	21	0	0
6	11266490	.	A	T	4	3	7	0	0	7	0	0
6	11266496	.	T	C	3	3	6	0	0	6	0	0
6	11276912	.	A	G	6	7	13	0	0	13	0	0
6	11279686	.	T	C	2	3	5	0	1	6	0	0
6	11279815	.	T	C	1	4	5	0	1	6	0	0
6	11281973	.	G	A	7	6	13	0	1	14	0	0
6	11282709	.	G	A	4	3	7	0	0	7	0	0
6	11282741	.	C	T	3	2	5	0	2	7	0	0
6	11285310	.	C	T	4	3	7	0	2	9	0	0
6	11285362	.	T	C	6	0	6	0	9	15	0	0
6	11285374	.	C	T	5	9	14	0	1	15	0	0
6	11285453	.	T	C	3	5	8	0	0	8	0	0
6	11285459	.	C	G	3	5	8	0	0	8	0	0
6	11285583	.	C	T	4	6	10	0	1	11	0	0
6	11285772	.	C	T	4	4	8	0	0	8	0	0
6	11288179	.	T	A	2	2	4	0	0	4	0	0
6	11288265	.	T	G	6	3	9	0	0	9	0	0
6	11288558	.	T	C	4	0	4	0	4	8	0	0
6	11292087	.	G	T	1	4	5	0	0	5	0	0
6	11295408	.	T	G	2	2	4	0	0	4	0	0
6	11295553	.	A	G	3	7	10	0	1	11	0	0
6	11295616	.	T	G	4	2	6	0	1	7	0	0
6	11299394	.	T	C	1	2	3	0	0	3	0	0
6	11299883	.	A	G	1	7	8	0	0	8	0	0
6	11299909	.	C	T	2	6	8	0	0	8	0	0
6	11299961	.	C	A	3	5	8	0	0	8	0	0
6	11299963	.	C	T	3	5	8	0	0	8	0	0
6	11303035	.	A	G	2	5	7	0	1	8	0	0
6	11303050	.	T	C	1	4	5	0	1	6	0	0
6	11303338	.	C	T	3	2	5	0	0	5	0	0
6	11303424	.	T	G	4	5	9	0	1	10	0	0
6	11309571	.	C	T	1	4	5	0	0	5	0	0
6	11309604	.	G	A	1	3	4	0	0	4	0	0
6	11316726	.	G	A	1	2	3	0	0	3	0	0
6	11320584	.	C	T	0	3	3	0	1	4	0	0
6	11326973	.	G	A	2	5	7	0	0	7	0	0
6	11330918	.	T	A	1	2	3	0	1	4	0	0
6	11330927	.	C	T	0	2	2	0	2	4	0	0
6	11337568	.	C	T	1	4	5	0	0	5	0	0
6	11337576	.	T	G	1	4	5	0	0	5	0	0
6	11338728	.	A	G	2	2	4	0	0	4	0	0
6	11338737	.	G	C	2	2	4	0	0	4	0	0
6	11340037	.	T	C	3	3	6	0	0	6	0	0
6	11349666	.	G	T	1	3	4	0	0	4	0	0
6	11350045	.	G	C	7	3	10	0	0	10	0	0
6	11398324	.	G	T	9	9	18	0	0	18	0	0
6	11407918	.	G	A	7	9	16	0	1	17	0	0
6	11407944	.	A	G	8	9	17	0	0	17	0	0
6	11407954	.	A	G	8	10	18	0	1	19	0	0
6	11414431	.	A	G	11	0	11	0	11	22	0	0
6	11414448	.	T	C	13	12	25	0	2	27	0	0
6	11414748	.	G	A	8	5	13	0	2	15	0	0
6	11414777	.	A	T	6	5	11	0	1	12	0	0
6	11414822	.	T	G	11	0	11	0	5	16	0	0
6	11415089	.	G	A	5	3	8	0	0	8	0	0
6	11415104	.	C	T	4	5	9	0	3	12	0	0
6	11504430	.	A	T	2	2	4	0	0	4	0	0
6	11508125	.	T	C	9	7	16	0	2	18	0	0
6	11522921	.	C	T	3	2	5	0	0	5	0	0
6	11765506	.	A	G	28	28	56	0	0	56	0	0
6	11766190	.	T	A	16	21	37	0	4	41	0	0
6	11766267	.	G	A	23	17	40	0	1	41	0	0
6	11766276	.	A	G	21	19	40	0	1	41	0	0
6	11766765	.	T	C	27	23	50	0	0	50	0	0
6	11978886	.	T	G	2	2	4	0	1	5	0	0
6	12503989	.	T	G	6	4	10	0	0	10	0	0
6	12504230	.	T	C	8	10	18	0	1	19	0	0
6	12504362	.	C	T	2	6	8	0	0	8	0	0
6	12504392	.	G	C	2	4	6	1	1	8	0	0
6	12529163	.	C	T	8	10	18	0	1	19	0	0
6	12529247	.	C	T	10	10	20	0	0	20	0	0
6	12550437	.	G	A	21	9	30	0	1	31	0	0
6	12550764	.	G	A	5	8	13	0	2	15	0	0
6	12550934	.	C	T	7	13	20	0	1	21	0	0
6	12595161	.	T	A	11	3	14	0	3	17	0	0
6	12627321	.	T	A	4	3	7	0	1	8	0	0
6	12671341	.	T	C	6	3	9	0	0	9	0	0
6	12671681	.	A	G	1	4	5	0	0	5	0	0
6	12680449	.	C	A	0	3	3	0	4	7	0	0
6	12681048	.	G	A	3	2	5	0	0	5	0	0
6	12684618	.	A	T	4	4	8	0	1	9	0	0
6	12684627	.	T	C	3	5	8	0	0	8	0	0
6	12701412	.	G	A	4	2	6	0	0	6	0	0
6	12701453	.	G	A	2	4	6	0	1	7	0	0
6	12797677	.	C	T	9	4	13	0	2	15	0	0
6	12797755	.	G	A	10	15	25	0	1	26	0	0
6	12797815	.	A	G	16	23	39	0	1	40	0	0
6	12798083	.	G	T	4	6	10	0	1	12	1	0
6	12798124	.	T	C	5	4	9	0	0	9	0	0
6	12798320	.	C	G	9	3	12	0	0	12	0	0
6	12798326	.	T	G	8	3	11	0	2	13	0	0
6	12803257	.	C	A	7	6	13	0	2	15	0	0
6	12803568	.	A	G	9	10	19	0	2	21	0	0
6	12803598	.	T	C	13	10	23	0	1	24	0	0
6	12803664	.	G	A	10	15	25	0	0	25	0	0
6	12803790	.	A	G	6	12	18	0	0	18	0	0
6	12803919	.	C	G	10	5	15	0	0	15	0	0
6	12804024	.	A	T	10	8	18	0	1	19	0	0
6	12804132	.	G	A	6	9	15	0	1	16	0	0
6	12810249	.	C	G	1	7	8	0	12	20	0	0
6	13506886	.	G	T	1	2	3	0	0	3	0	0
6	13506931	.	G	C	3	2	5	0	0	5	0	0
6	13509296	.	C	T	3	2	5	0	0	5	0	0
6	13510307	.	A	G	4	3	7	0	1	8	0	0
6	13510493	.	G	A	6	4	10	0	0	10	0	0
6	13513936	.	C	T	4	2	6	0	0	6	0	0
6	13514034	.	T	C	1	2	3	0	0	3	0	0
6	13607317	.	C	T	5	2	7	0	0	7	0	0
6	13669432	.	A	G	1	2	3	0	0	3	0	0
6	13699488	.	G	A	1	3	4	0	0	4	0	0
6	13703251	.	A	G	1	6	7	0	0	7	0	0
6	13703286	.	T	C	5	2	7	0	0	7	0	0
6	13734266	.	G	A	8	4	12	0	0	12	0	0
6	13734439	.	C	T	3	3	6	0	0	6	0	0
6	13734449	.	C	T	2	2	4	0	0	4	0	0
6	13743317	.	G	A	25	31	56	0	4	60	0	0
6	13743753	.	T	C	26	33	59	0	4	63	0	0
6	13743923	.	C	T	30	37	67	0	2	69	0	0
6	13744099	.	C	T	35	30	65	1	3	69	0	0
6	13806522	.	C	T	9	16	25	0	1	26	0	0
6	13862171	.	C	T	10	8	18	0	1	19	0	0
6	13862576	.	A	C	31	17	48	0	0	48	0	0
6	13866551	.	G	A	25	21	46	0	3	49	0	0
6	13868823	.	A	G	24	21	45	0	8	53	0	0
6	13868850	.	A	T	25	21	46	0	3	51	2	0
6	13869540	.	C	A	24	7	31	0	1	32	0	0
6	13869608	.	C	T	23	13	36	0	0	36	0	0
6	13871773	.	A	G	2	2	4	0	1	5	0	0
6	13871812	.	C	G	0	2	2	0	1	3	0	0
6	13873193	.	T	C	3	5	8	0	0	8	0	0
6	13897552	.	G	A	2	3	5	0	0	5	0	0
6	13900918	.	C	G	5	0	5	0	5	10	0	0
6	13901213	.	G	A	4	5	9	0	0	9	0	0
6	13901255	.	A	T	5	3	8	0	0	8	0	0
6	13901312	.	C	T	6	4	10	0	0	10	0	0
6	13901496	.	C	T	8	4	12	0	2	14	0	0
6	13901604	.	T	C	3	5	8	0	0	8	0	0
6	13907856	.	T	A	3	4	7	0	2	9	0	0
6	13908633	.	G	A	1	12	13	0	12	25	0	0
6	13914821	.	T	C	9	4	13	0	1	14	0	0
6	13914824	.	G	A	10	5	15	0	0	15	0	0
6	13920194	.	A	G	5	2	7	0	1	8	0	0
6	13920549	.	C	T	8	6	14	1	0	15	0	0
6	13941729	.	C	A	22	18	40	0	5	45	0	0
6	13967038	.	A	T	21	20	41	0	0	41	0	0
6	13967328	.	G	A	25	19	44	0	0	44	0	0
6	13967512	.	C	A	25	19	44	0	2	54	8	0
6	13977080	.	T	A	23	28	51	0	2	53	0	0
6	13977567	.	G	T	26	21	47	0	0	47	0	0
6	13977588	.	C	T	20	22	42	0	4	46	0	0
6	13977648	.	G	A	18	27	45	0	1	46	0	0
6	13987287	.	G	C	19	7	26	0	1	27	0	0
6	13987299	.	A	T	20	15	35	0	0	35	0	0
6	13987346	.	C	T	12	20	32	0	0	32	0	0
6	13987560	.	T	C	18	15	33	0	4	37	0	0
6	13987631	.	G	A	21	29	50	0	0	50	0	0
6	13987663	.	T	A	23	25	48	0	3	51	0	0
6	13987710	.	G	A	15	19	34	0	0	34	0	0
6	13987713	.	T	G	14	17	31	0	0	31	0	0
6	13993783	.	A	T	6	2	8	0	1	9	0	0
6	14032693	.	T	C	30	8	38	0	0	38	0	0
6	14032698	.	T	A	31	5	36	0	0	36	0	0
6	14032739	.	G	A	10	16	26	0	2	28	0	0
6	14033030	.	G	T	10	7	17	0	2	19	0	0
6	14033167	.	G	A	24	19	43	0	2	45	0	0
6	14033556	.	T	A	12	8	20	0	2	22	0	0
6	14033836	.	G	C	12	8	20	0	2	22	0	0
6	14034887	.	G	C	16	14	30	0	0	30	0	0
6	14034907	.	C	T	1	14	15	0	15	30	0	0
6	14034949	.	G	A	16	11	27	1	2	30	0	0
6	14038306	.	C	T	14	8	22	0	1	23	0	0
6	14038506	.	T	A	14	13	27	0	1	28	0	0
6	14086810	.	T	C	24	25	49	0	3	52	0	0
6	14086901	.	G	T	29	23	52	0	0	52	0	0
6	14086942	.	G	C	29	23	52	0	1	53	0	0
6	14087182	.	C	A	24	28	52	0	1	53	0	0
6	14087220	.	T	A	20	29	49	0	0	49	0	0
6	14087569	.	T	G	19	32	51	0	0	51	0	0
6	14087641	.	A	C	23	29	52	0	4	56	0	0
6	14087883	.	T	C	21	18	39	0	1	40	0	0
6	14088095	.	C	T	30	22	52	0	7	59	0	0
6	14092942	.	T	A	22	24	46	0	8	54	0	0
6	14096684	.	C	T	0	28	28	0	24	52	0	0
6	14098760	.	C	T	6	28	34	0	27	61	0	0
6	14105071	.	G	T	27	18	45	0	0	45	0	0
6	14172926	.	A	T	3	2	5	0	0	5	0	0
6	14173159	.	C	A	7	4	11	0	0	11	0	0
6	14173599	.	A	G	6	5	11	0	0	11	0	0
6	14173641	.	G	A	11	8	19	0	1	20	0	0
6	14191637	.	A	G	11	11	22	0	0	22	0	0
6	14191676	.	G	A	7	9	16	0	0	16	0	0
6	14191709	.	T	C	5	0	5	0	7	12	0	0
6	14209151	.	C	T	8	9	17	0	1	18	0	0
6	14209674	.	A	G	8	10	18	0	0	18	0	0
6	14212352	.	G	A	7	9	16	0	0	16	0	0
6	14212370	.	G	A	5	9	14	0	0	14	0	0
6	14212430	.	T	G	2	15	17	0	0	17	0	0
6	14220145	.	G	T	5	6	11	0	0	11	0	0
6	14240226	.	C	T	2	8	10	0	0	10	0	0
6	15042213	.	A	G	1	2	3	0	0	3	0	0
6	15491378	.	C	T	2	5	7	0	0	7	0	0
6	15491538	.	T	C	5	4	9	0	0	9	0	0
6	15491568	.	A	G	3	4	7	0	0	7	0	0
6	15527385	.	G	A	10	7	17	0	0	17	0	0
6	15538138	.	G	A	18	12	30	0	0	30	0	0
6	15541015	.	G	A	13	8	21	0	1	22	0	0
6	15543412	.	C	A	8	10	18	0	2	20	0	0
6	15543451	.	C	T	11	10	21	0	0	21	0	0
6	15548966	.	A	G	12	14	26	0	2	28	0	0
6	15557526	.	T	G	9	8	17	0	1	18	0	0
6	15603784	.	G	A	7	12	19	0	3	22	0	0
6	15603866	.	T	C	8	9	17	0	1	18	0	0
6	15604016	.	G	A	9	9	18	0	0	18	0	0
6	15604079	.	A	G	7	10	17	0	0	17	0	0
6	15604133	.	C	T	9	8	17	0	0	17	0	0
6	15604142	.	A	G	8	6	14	0	1	15	0	0
6	15604178	.	G	T	1	3	4	0	0	4	0	0
6	15752602	.	A	G	2	6	8	0	0	8	0	0
6	15752641	.	C	T	3	3	6	0	0	6	0	0
6	15753199	.	G	A	3	4	7	0	0	7	0	0
6	15757769	.	A	G	1	2	3	0	0	3	0	0
6	15790083	.	C	T	1	2	3	0	0	3	0	0
6	15798119	.	A	C	1	2	3	0	0	3	0	0
6	15824535	.	A	G	4	2	6	0	0	6	0	0
6	15824597	.	T	A	1	3	4	0	0	4	0	0
6	16031554	.	T	G	2	3	5	0	0	5	0	0
6	16031580	.	T	C	1	4	5	0	0	5	0	0
6	16031714	.	C	T	5	4	9	0	0	9	0	0
6	16043950	.	C	T	2	10	12	0	12	24	0	0
6	16043980	.	A	G	11	10	21	0	0	21	0	0
6	16043999	.	T	C	12	12	24	0	0	24	0	0
6	16044019	.	T	C	16	1	17	0	13	30	0	0
6	16044282	.	A	G	12	8	20	0	2	22	0	0
6	16044597	.	C	T	13	8	21	0	0	21	0	0
6	16045046	.	G	C	5	5	10	0	0	10	0	0
6	16045413	.	T	C	11	5	16	0	0	16	0	0
6	16045463	.	G	C	10	0	10	0	7	17	0	0
6	16045516	.	G	C	13	11	24	0	0	24	0	0
6	16045712	.	C	T	16	9	25	0	0	25	0	0
6	16045768	.	C	G	14	5	19	0	0	19	0	0
6	16045798	.	T	C	14	5	19	0	1	20	0	0
6	16045946	.	A	C	15	16	31	0	3	34	0	0
6	16045947	.	A	T	16	15	31	0	4	35	0	0
6	16046049	.	G	T	21	10	31	1	3	37	2	0
6	16046272	.	G	T	12	9	21	0	0	21	0	0
6	16046365	.	G	A	5	4	9	0	0	9	0	0
6	16046371	.	A	T	5	4	9	0	0	9	0	0
6	16046676	.	G	A	8	16	24	0	0	24	0	0
6	16046761	.	A	C	11	7	18	0	1	19	0	0
6	16046850	.	G	A	8	13	21	0	3	24	0	0
6	16046934	.	A	C	15	14	29	0	2	31	0	0
6	16104448	.	G	T	10	15	25	0	0	25	0	0
6	16104463	.	T	C	10	13	23	0	0	23	0	0
6	16135966	.	C	T	6	7	13	0	0	13	0	0
6	16162994	.	G	A	12	9	21	0	1	22	0	0
6	16169641	.	G	A	19	9	28	0	0	29	1	0
6	16194568	.	G	A	18	10	28	0	1	29	0	0
6	16214658	.	C	T	2	7	9	0	15	24	0	0
6	16393459	.	G	T	9	3	12	0	0	12	0	0
6	16393816	.	G	C	4	4	8	0	0	8	0	0
6	16394004	.	G	A	5	6	11	0	1	12	0	0
6	16394018	.	C	T	9	4	13	0	0	13	0	0
6	16394244	.	A	G	5	5	10	0	0	10	0	0
6	16394341	.	A	T	3	2	5	0	0	5	0	0
6	16474107	.	G	A	5	5	10	0	1	11	0	0
6	16474381	.	T	C	12	9	21	0	0	21	0	0
6	16474853	.	T	C	4	5	9	0	1	10	0	0
6	16474879	.	T	C	5	4	9	0	1	10	0	0
6	16474948	.	T	C	9	6	15	0	0	15	0	0
6	16475047	.	T	A	8	9	17	0	1	18	0	0
6	16475269	.	C	G	6	6	12	0	1	13	0	0
6	16475395	.	A	C	8	3	11	0	0	11	0	0
6	16475468	.	G	A	1	8	9	0	4	13	0	0
6	16475728	.	G	A	0	3	3	0	9	12	0	0
6	16478198	.	C	A	0	3	3	0	11	14	0	0
6	16491056	.	G	A	19	19	38	0	0	38	0	0
6	16493381	.	A	T	31	15	46	0	1	47	0	0
6	16493415	.	T	C	18	29	47	0	0	47	0	0
6	16499260	.	A	G	10	4	14	0	1	15	0	0
6	16499311	.	C	T	4	11	15	0	2	17	0	0
6	16499428	.	G	A	9	5	14	0	1	15	0	0
6	16499473	.	G	C	4	13	17	0	0	17	0	0
6	16509980	.	G	A	9	14	23	0	2	25	0	0
6	16510064	.	T	G	5	9	14	0	2	16	0	0
6	16523788	.	G	A	11	4	15	0	0	15	0	0
6	16524067	.	A	G	11	8	19	0	0	19	0	0
6	16524468	.	G	T	3	14	17	0	1	18	0	0
6	16524618	.	C	G	8	5	13	0	0	13	0	0
6	16540645	.	G	A	2	3	5	0	0	5	0	0
6	16540646	.	G	C	3	0	3	0	3	6	0	0
6	16548741	.	T	C	3	3	6	0	0	6	0	0
6	16548873	.	C	T	2	5	7	0	0	7	0	0
6	16551826	.	G	A	1	4	5	0	0	5	0	0
6	16558508	.	A	T	4	5	9	0	0	9	0	0
6	16561379	.	C	T	9	4	13	0	4	17	0	0
6	16561522	.	A	G	5	8	13	0	0	13	0	0
6	16561535	.	A	G	0	11	11	0	0	11	0	0
6	16572007	.	C	T	4	3	7	0	0	7	0	0
6	16574765	.	G	C	4	5	9	0	1	10	0	0
6	16574794	.	T	A	4	5	9	0	1	10	0	0
6	16574890	.	C	G	7	3	10	0	1	11	0	0
6	16577229	.	C	T	0	6	6	0	5	11	0	0
6	16577736	.	G	A	6	3	9	0	2	11	0	0
6	16589347	.	C	T	3	9	12	0	1	13	0	0
6	16589452	.	T	G	3	4	7	0	0	7	0	0
6	16589455	.	T	C	4	3	7	0	0	7	0	0
6	16599048	.	A	G	3	4	7	0	0	7	0	0
6	16656833	.	C	T	10	5	15	0	0	15	0	0
6	16661736	.	T	A	8	6	14	0	1	15	0	0
6	16664776	.	C	T	1	3	4	0	0	4	0	0
6	16664780	.	G	A	3	2	5	0	0	5	0	0
6	16665359	.	G	A	5	9	14	0	0	14	0	0
6	16674296	.	A	G	14	6	20	1	1	22	0	0
6	16674344	.	T	A	16	8	24	1	1	26	0	0
6	16674371	.	T	C	6	8	14	1	7	22	0	0
6	16674435	.	A	C	11	21	32	0	2	34	0	0
6	16674618	.	G	A	7	14	21	0	0	21	0	0
6	16674808	.	T	C	9	11	20	0	1	21	0	0
6	16683385	.	T	C	15	14	29	0	1	30	0	0
6	16684004	.	A	G	16	6	22	0	2	24	0	0
6	16687429	.	C	A	11	19	30	0	0	30	0	0
6	16687432	.	T	A	11	19	30	0	1	31	0	0
6	16688900	.	T	C	15	7	22	0	0	22	0	0
6	16689083	.	G	A	7	5	12	0	0	12	0	0
6	16689416	.	T	A	9	10	19	0	1	20	0	0
6	16695771	.	C	T	7	11	18	0	0	18	0	0
6	16695994	.	A	C	5	12	17	0	0	18	1	0
6	16696083	.	C	T	8	5	13	0	2	15	0	0
6	16699616	.	G	A	3	2	5	0	0	5	0	0
6	16704848	.	T	C	9	7	16	0	0	16	0	0
6	16704876	.	G	A	4	6	10	0	0	10	0	0
6	16714138	.	A	T	2	7	9	0	0	9	0	0
6	16714175	.	G	T	3	4	7	0	0	7	0	0
6	16714192	.	C	T	2	5	7	0	0	7	0	0
6	16714219	.	G	A	2	4	6	0	0	6	0	0
6	16714231	.	G	C	2	5	7	0	0	7	0	0
6	16714407	.	A	G	2	5	7	0	1	8	0	0
6	16714419	.	A	G	2	4	6	0	1	7	0	0
6	16714599	.	T	A	5	2	7	0	0	7	0	0
6	17726078	.	G	A	3	4	7	0	0	7	0	0
6	17837240	.	A	T	1	3	4	0	0	4	0	0
6	17910266	.	C	T	1	4	5	0	0	5	0	0
6	17911148	.	C	T	0	3	3	0	4	7	0	0
6	17980479	.	A	T	4	3	7	0	0	7	0	0
6	18077210	.	G	A	9	3	12	0	1	13	0	0
6	18203782	.	C	A	19	11	30	0	0	30	0	0
6	18203977	.	A	T	10	0	10	0	0	10	0	0
6	18204420	.	A	G	9	12	21	0	0	21	0	0
6	18220141	.	G	A	8	15	23	0	0	23	0	0
6	18226653	.	T	G	10	15	25	0	0	25	0	0
6	18228324	.	G	A	11	11	22	0	0	22	0	0
6	18244879	.	A	T	1	2	3	0	0	3	0	0
6	18244924	.	T	C	1	3	4	0	0	4	0	0
6	18244925	.	T	C	1	3	4	0	0	4	0	0
6	18244987	.	C	T	1	3	4	0	1	5	0	0
6	18245385	.	G	A	23	20	43	0	1	44	0	0
6	18251271	.	A	G	2	3	5	0	0	5	0	0
6	18251299	.	T	C	1	3	4	1	1	6	0	0
6	18267819	.	C	T	3	3	6	0	0	6	0	0
6	18272540	.	T	C	5	3	8	0	0	8	0	0
6	18290415	.	T	C	4	2	6	0	0	6	0	0
6	18359376	.	C	T	4	10	14	0	1	15	0	0
6	18361359	.	A	T	12	14	26	0	1	27	0	0
6	18361444	.	C	G	11	12	23	0	0	23	0	0
6	18361609	.	T	C	10	8	18	0	0	18	0	0
6	18361729	.	G	C	7	9	16	0	1	17	0	0
6	18362043	.	T	G	5	0	5	0	6	11	0	0
6	18364051	.	A	T	2	2	4	0	0	4	0	0
6	18364543	.	A	T	2	2	4	0	1	5	0	0
6	18367543	.	T	C	5	6	11	0	1	12	0	0
6	18367670	.	C	A	2	4	6	0	1	7	0	0
6	18367758	.	C	T	7	4	11	0	0	11	0	0
6	18388387	.	T	G	4	4	8	0	0	8	0	0
6	18388569	.	C	T	3	3	6	0	0	6	0	0
6	18388835	.	C	A	4	7	11	0	1	12	0	0
6	18388975	.	G	A	4	5	9	0	0	9	0	0
6	18389220	.	G	A	6	4	10	0	0	10	0	0
6	18389324	.	T	C	7	0	7	0	9	16	0	0
6	18389541	.	C	T	3	7	10	0	0	10	0	0
6	18393826	.	A	T	4	6	10	0	2	12	0	0
6	18399981	.	C	T	1	5	6	0	3	9	0	0
6	18436500	.	C	T	8	5	13	0	0	13	0	0
6	18436880	.	C	A	15	7	22	0	0	22	0	0
6	18436966	.	G	A	10	16	26	0	2	28	0	0
6	18436969	.	T	C	14	17	31	0	0	31	0	0
6	18438322	.	C	G	6	8	14	0	1	15	0	0
6	18439222	.	C	T	12	11	23	0	0	23	0	0
6	18439256	.	C	A	11	11	22	0	0	22	0	0
6	18439540	.	G	A	12	4	16	0	0	16	0	0
6	18439683	.	C	T	11	7	18	0	1	19	0	0
6	18520930	.	T	A	12	24	36	0	2	38	0	0
6	18523549	.	C	A	16	11	27	0	0	27	0	0
6	18523770	.	A	T	10	11	21	0	1	22	0	0
6	18523772	.	C	G	12	10	22	0	0	22	0	0
6	18523817	.	T	A	14	8	22	0	0	22	0	0
6	18523895	.	C	G	3	3	6	0	0	6	0	0
6	18524579	.	A	G	2	7	9	0	0	9	0	0
6	18526432	.	A	G	2	4	6	0	0	6	0	0
6	18526754	.	G	T	8	5	13	0	0	13	0	0
6	18529148	.	G	T	4	3	7	0	0	7	0	0
6	18529589	.	G	A	3	4	7	0	1	8	0	0
6	18529593	.	T	G	4	2	6	0	1	7	0	0
6	18530378	.	C	T	5	6	11	0	0	11	0	0
6	18531296	.	T	G	5	3	8	0	0	8	0	0
6	18532445	.	A	T	3	6	9	0	1	10	0	0
6	18533201	.	T	C	1	2	3	0	1	4	0	0
6	18536239	.	G	T	7	11	18	0	0	18	0	0
6	18540911	.	T	C	11	12	23	0	1	24	0	0
6	18540932	.	C	T	14	13	27	0	0	27	0	0
6	18541022	.	T	C	2	2	4	0	0	4	0	0
6	18541077	.	A	G	2	2	4	0	0	4	0	0
6	18541083	.	A	G	1	2	3	0	1	4	0	0
6	18541159	.	A	T	4	2	6	0	0	6	0	0
6	18543253	.	G	A	1	7	8	0	7	15	0	0
6	18543400	.	A	G	12	13	25	0	0	25	0	0
6	18543637	.	A	G	7	9	16	0	0	16	0	0
6	18543950	.	G	T	8	8	16	0	0	16	0	0
6	18544301	.	T	A	5	6	11	0	1	12	0	0
6	18554177	.	T	G	1	7	8	0	0	8	0	0
6	18554208	.	G	A	4	2	6	0	0	6	0	0
6	18554541	.	G	A	3	3	6	0	0	6	0	0
6	18554580	.	C	T	1	3	4	0	0	4	0	0
6	18554836	.	T	G	3	3	6	0	2	8	0	0
6	18557909	.	T	C	2	0	2	0	5	7	0	0
6	18584793	.	T	A	3	3	6	0	0	6	0	0
6	18587728	.	G	A	3	3	6	0	0	6	0	0
6	18589067	.	C	T	9	4	13	0	0	13	0	0
6	18589090	.	T	C	8	10	18	0	1	19	0	0
6	18589235	.	T	C	10	5	15	0	0	15	0	0
6	18594539	.	A	C	1	3	4	0	0	4	0	0
6	18594604	.	C	T	1	2	3	0	0	3	0	0
6	18595156	.	T	G	1	1	2	0	3	5	0	0
6	18595497	.	T	C	1	0	1	0	5	6	0	0
6	18598494	.	A	T	9	4	13	0	0	13	0	0
6	18606063	.	T	C	10	7	17	0	1	18	0	0
6	18606230	.	G	T	14	9	23	0	3	26	0	0
6	18607151	.	G	A	14	14	28	0	0	28	0	0
6	18607557	.	C	T	13	14	27	0	4	31	0	0
6	18612230	.	C	T	15	10	25	0	1	26	0	0
6	18617255	.	A	T	11	10	21	0	0	21	0	0
6	18618051	.	C	T	8	10	18	0	3	21	0	0
6	18624162	.	T	A	2	11	13	0	0	13	0	0
6	18625021	.	G	A	8	6	14	0	3	17	0	0
6	18625062	.	G	A	20	6	26	0	1	27	0	0
6	18654314	.	T	A	3	11	14	0	0	14	0	0
6	18715712	.	A	G	7	7	14	0	0	14	0	0
6	18716085	.	C	T	7	12	19	0	1	20	0	0
6	18716242	.	G	A	6	5	11	0	0	11	0	0
6	18716539	.	C	T	1	8	9	0	8	17	0	0
6	18716611	.	T	C	6	1	7	0	12	19	0	0
6	18717934	.	T	C	1	3	4	0	0	4	0	0
6	18718397	.	G	A	6	4	10	0	1	11	0	0
6	18718438	.	T	G	7	7	14	0	0	14	0	0
6	18718473	.	C	T	5	5	10	0	0	10	0	0
6	18718846	.	A	T	6	6	12	0	1	13	0	0
6	18718964	.	A	G	6	6	12	0	0	12	0	0
6	18721060	.	T	G	3	2	5	0	2	7	0	0
6	18721099	.	T	C	3	7	10	0	0	10	0	0
6	18724415	.	T	A	11	9	20	0	0	20	0	0
6	18725196	.	C	T	5	9	14	0	1	15	0	0
6	18725881	.	T	A	6	6	12	0	4	16	0	0
6	18728766	.	A	G	2	3	5	0	2	7	0	0
6	18731328	.	G	C	5	6	11	0	1	12	0	0
6	18731389	.	G	A	5	6	11	0	0	11	0	0
6	18736413	.	A	C	2	7	9	0	0	9	0	0
6	18736460	.	A	G	2	8	10	0	0	10	0	0
6	18737442	.	A	G	4	8	12	0	0	12	0	0
6	18738949	.	C	T	4	3	7	0	0	7	0	0
6	18738969	.	G	A	5	3	8	0	0	8	0	0
6	18751091	.	C	T	4	7	11	0	0	11	0	0
6	18751146	.	C	T	0	2	2	0	2	4	0	0
6	18936455	.	T	C	7	0	7	0	6	13	0	0
6	18937493	.	T	C	3	3	6	0	0	6	0	0
6	18958920	.	C	T	4	6	10	0	0	10	0	0
6	19035665	.	C	T	0	2	2	0	1	3	0	0
6	19265802	.	C	A	3	5	8	0	2	10	0	0
6	19271131	.	A	T	3	2	5	0	1	6	0	0
6	19295454	.	C	T	26	18	44	0	0	44	0	0
6	19295469	.	T	C	20	0	20	0	22	42	0	0
6	19295609	.	A	T	7	13	20	0	0	20	0	0
6	19295625	.	T	A	10	16	26	0	1	27	0	0
6	19295644	.	C	T	1	15	16	0	12	28	0	0
6	19327320	.	T	G	6	5	11	0	0	11	0	0
6	19327380	.	C	T	9	7	16	0	1	17	0	0
6	19330205	.	G	A	1	4	5	0	0	5	0	0
6	19330232	.	T	C	1	5	6	0	1	7	0	0
6	19330729	.	T	C	2	3	5	0	0	5	0	0
6	19331045	.	G	A	2	3	5	0	0	5	0	0
6	19331054	.	C	T	2	3	5	0	0	5	0	0
6	19334643	.	T	C	0	3	3	0	0	3	0	0
6	19334659	.	A	G	1	2	3	0	0	3	0	0
6	19334678	.	G	C	1	1	2	0	0	2	0	0
6	19334948	.	A	T	1	4	5	0	0	5	0	0
6	19334949	.	C	A	1	4	5	0	0	5	0	0
6	19344846	.	C	T	6	15	21	0	0	21	0	0
6	19344862	.	T	C	17	8	25	0	0	25	0	0
6	19344930	.	G	C	2	13	15	0	1	16	0	0
6	19345191	.	G	A	9	6	15	2	0	17	0	0
6	19347426	.	C	T	0	6	6	0	8	14	0	0
6	19378992	.	G	A	2	6	8	0	0	8	0	0
6	19381816	.	T	G	6	6	12	0	0	12	0	0
6	19381843	.	A	G	7	5	12	0	0	12	0	0
6	19381856	.	C	T	5	6	11	0	0	11	0	0
6	19715552	.	G	A	0	11	11	0	5	16	0	0
6	19802042	.	T	C	12	5	17	0	0	17	0	0
6	19802145	.	G	T	2	6	8	0	8	16	0	0
6	19802148	.	C	A	10	5	15	0	1	16	0	0
6	19802242	.	C	T	8	9	17	0	0	17	0	0
6	19802330	.	G	A	4	6	10	0	0	10	0	0
6	19802354	.	G	A	3	3	6	0	1	7	0	0
6	19802415	.	G	A	1	5	6	0	2	8	0	0
6	19804702	.	A	C	2	3	5	0	0	5	0	0
6	19804878	.	C	T	4	8	12	0	0	12	0	0
6	19807126	.	T	A	2	2	4	0	0	4	0	0
6	19807326	.	A	G	1	3	4	0	0	4	0	0
6	19807658	.	C	G	3	2	5	0	0	5	0	0
6	19807858	.	C	A	1	2	3	0	2	5	0	0
6	19807936	.	A	T	1	2	3	0	0	3	0	0
6	19808590	.	G	A	2	2	4	0	1	5	0	0
6	19808670	.	C	T	3	6	9	0	1	10	0	0
6	19926081	.	G	A	3	3	6	0	0	6	0	0
6	20766299	.	G	A	10	9	19	0	1	20	0	0
6	20766307	.	A	G	8	9	17	0	0	17	0	0
6	20766352	.	C	T	6	11	17	0	1	18	0	0
6	20766500	.	G	T	6	7	13	0	0	13	0	0
6	20766565	.	C	G	0	8	8	0	17	25	0	0
6	20767015	.	T	A	16	14	30	0	0	30	0	0
6	20767167	.	C	A	8	8	16	0	1	17	0	0
6	20767502	.	A	G	20	17	37	0	2	39	0	0
6	20767575	.	G	C	18	1	19	0	27	46	0	0
6	20767830	.	T	G	9	4	13	0	0	13	0	0
6	20767910	.	A	G	2	3	5	0	1	7	1	0
6	20767958	.	T	G	8	5	13	0	0	13	0	0
6	20768076	.	C	A	12	8	20	0	0	20	0	0
6	20768107	.	A	T	14	10	24	0	3	27	0	0
6	20768338	.	G	A	14	16	30	0	1	31	0	0
6	20768346	.	T	G	15	15	30	0	0	30	0	0
6	20768407	.	A	T	9	14	23	0	0	23	0	0
6	20768558	.	C	G	15	11	26	0	0	26	0	0
6	20773961	.	G	A	21	14	35	0	0	35	0	0
6	20774048	.	A	C	24	17	41	0	0	41	0	0
6	20774701	.	G	A	25	14	39	0	1	40	0	0
6	20774752	.	G	A	17	17	34	0	2	36	0	0
6	20774768	.	C	T	18	12	30	0	2	32	0	0
6	20910625	.	C	T	10	8	18	0	1	19	0	0
6	20910627	.	A	C	8	10	18	0	1	19	0	0
6	20910713	.	G	T	9	5	14	0	0	14	0	0
6	20910759	.	A	T	6	6	12	0	0	12	0	0
6	20910830	.	T	C	11	5	16	0	4	20	0	0
6	20910880	.	G	A	15	5	20	0	0	20	0	0
6	20910898	.	A	G	4	1	5	0	13	18	0	0
6	20917730	.	A	T	2	3	5	0	0	5	0	0
6	20917780	.	T	A	8	5	13	0	0	13	0	0
6	20917921	.	G	A	6	11	17	0	0	17	0	0
6	20917922	.	A	C	5	11	16	0	1	17	0	0
6	20918418	.	G	T	8	13	21	0	1	22	0	0
6	20921859	.	G	A	10	3	13	0	0	13	0	0
6	20921919	.	G	A	5	6	11	0	0	11	0	0
6	20922271	.	G	T	9	8	17	0	0	17	0	0
6	20922316	.	G	C	8	1	9	0	7	16	0	0
6	20922330	.	G	A	7	7	14	0	1	15	0	0
6	20922396	.	G	A	6	14	20	0	0	20	0	0
6	20922468	.	G	A	4	10	14	0	0	14	0	0
6	20954511	.	T	C	3	5	8	0	0	8	0	0
6	20954521	.	T	C	4	5	9	0	0	9	0	0
6	20956881	.	C	T	0	1	1	0	2	3	0	0
6	20965710	.	G	A	0	2	2	0	8	10	0	0
6	20965723	.	G	A	1	8	9	0	3	12	0	0
6	20965780	.	A	G	2	1	3	0	6	9	0	0
6	20965855	.	A	G	3	11	14	0	1	15	0	0
6	20969124	.	A	T	4	4	8	0	0	8	0	0
6	20969126	.	G	T	4	4	8	0	0	8	0	0
6	20978972	.	C	T	6	4	10	0	0	10	0	0
6	20979015	.	C	T	7	7	14	0	0	14	0	0
6	20986906	.	C	G	4	0	4	0	11	16	1	0
6	20995800	.	A	G	7	4	11	0	1	12	0	0
6	20996640	.	C	T	3	7	10	0	1	11	0	0
6	20997031	.	A	T	7	4	11	0	0	11	0	0
6	21116134	.	C	G	9	6	15	0	1	16	0	0
6	21119574	.	C	T	7	6	13	0	0	13	0	0
6	21119598	.	C	T	4	8	12	0	0	12	0	0
6	21119910	.	G	A	6	7	13	0	0	13	0	0
6	21119914	.	A	G	6	6	12	0	0	12	0	0
6	21119949	.	T	C	9	8	17	0	0	17	0	0
6	21119953	.	C	A	8	10	18	0	0	18	0	0
6	21120080	.	A	G	7	12	19	0	1	20	0	0
6	21120193	.	T	C	6	11	17	0	0	17	0	0
6	21120261	.	C	T	10	6	16	0	0	16	0	0
6	21121977	.	T	C	2	3	5	0	0	5	0	0
6	21121987	.	C	T	3	3	6	0	0	6	0	0
6	21131414	.	C	A	7	11	18	0	0	18	0	0
6	21131504	.	G	A	5	6	11	0	2	13	0	0
6	21135702	.	G	A	9	3	12	0	0	12	0	0
6	21138740	.	T	C	6	5	11	0	0	11	0	0
6	21138869	.	C	T	8	9	17	0	0	17	0	0
6	21138870	.	T	G	7	8	15	0	2	17	0	0
6	21140553	.	G	T	5	5	10	0	0	10	0	0
6	21143033	.	T	C	7	9	16	0	0	16	0	0
6	21143041	.	C	A	9	7	16	0	0	16	0	0
6	21143685	.	C	T	4	9	13	0	0	13	0	0
6	21144233	.	G	A	8	6	14	0	1	15	0	0
6	21144245	.	C	T	8	7	15	0	0	15	0	0
6	21146252	.	C	T	13	16	29	0	0	29	0	0
6	21146501	.	C	T	6	3	9	0	0	9	0	0
6	21146505	.	C	A	6	3	9	0	0	9	0	0
6	21146549	.	G	T	11	5	16	0	1	17	0	0
6	21146633	.	G	A	17	8	25	0	0	25	0	0
6	21146648	.	G	A	18	7	25	0	0	25	0	0
6	21146813	.	T	G	6	0	6	0	6	12	0	0
6	21147332	.	T	A	9	12	21	0	0	21	0	0
6	21147334	.	T	A	9	12	21	0	0	21	0	0
6	21147837	.	A	G	9	8	17	0	0	17	0	0
6	21147920	.	A	C	9	12	21	0	0	21	0	0
6	21148166	.	A	T	7	6	13	0	1	14	0	0
6	21148167	.	T	C	5	7	12	0	2	14	0	0
6	21148367	.	G	A	8	8	16	0	0	16	0	0
6	21148393	.	T	A	10	7	17	0	1	18	0	0
6	21148736	.	T	A	6	7	13	0	0	13	0	0
6	21148737	.	A	T	6	7	13	0	0	13	0	0
6	21148972	.	G	C	9	13	22	0	1	23	0	0
6	21149353	.	G	C	4	8	12	0	11	23	0	0
6	21149383	.	A	T	12	10	22	0	0	22	0	0
6	21150672	.	G	A	9	22	31	0	1	32	0	0
6	21150712	.	A	T	10	16	26	0	2	28	0	0
6	21150772	.	A	T	22	11	33	0	1	34	0	0
6	21150872	.	C	T	15	25	40	0	1	41	0	0
6	21151664	.	T	G	12	12	24	0	0	24	0	0
6	21151751	.	C	T	17	17	34	0	1	35	0	0
6	21376635	.	T	G	5	9	14	0	0	14	0	0
6	21390653	.	G	T	4	7	11	0	0	11	0	0
6	21390667	.	A	T	4	9	13	0	0	13	0	0
6	21391499	.	T	A	5	2	7	0	0	7	0	0
6	21391675	.	A	G	1	8	9	0	0	9	0	0
6	21391810	.	T	A	3	5	8	0	0	8	0	0
6	21392049	.	A	T	13	3	16	0	0	16	0	0
6	21392057	.	C	A	10	2	12	0	0	12	0	0
6	21428926	.	A	G	1	0	1	0	3	4	0	0
6	21433003	.	C	A	3	5	8	0	0	8	0	0
6	21433813	.	T	C	5	2	7	0	0	7	0	0
6	21454984	.	C	A	4	6	10	0	0	10	0	0
6	21513778	.	A	G	3	2	5	0	0	5	0	0
6	21513826	.	C	A	4	3	7	0	0	7	0	0
6	21514651	.	G	T	3	5	8	0	0	8	0	0
6	21514961	.	C	T	0	6	6	0	7	13	0	0
6	21515032	.	C	T	7	3	10	0	0	10	0	0
6	21515100	.	C	T	1	4	5	0	0	5	0	0
6	21526395	.	A	G	10	17	27	0	0	27	0	0
6	21526620	.	T	C	14	16	30	0	2	32	0	0
6	21526783	.	G	A	21	17	38	0	2	40	0	0
6	21529229	.	A	G	15	16	31	0	0	31	0	0
6	21529379	.	A	T	22	13	35	0	0	35	0	0
6	21529767	.	A	T	17	8	25	0	2	27	0	0
6	21532427	.	T	C	16	0	16	0	13	29	0	0
6	21547932	.	T	A	3	2	5	1	0	6	0	0
6	21548296	.	G	A	1	2	3	0	0	3	0	0
6	21570468	.	A	G	2	4	6	0	0	6	0	0
6	21576216	.	T	G	2	3	5	0	1	6	0	0
6	21576452	.	C	T	1	2	3	0	0	3	0	0
6	21576632	.	T	A	1	2	3	0	0	3	0	0
6	21588285	.	C	T	9	14	23	0	1	24	0	0
6	21589102	.	A	G	5	7	12	0	0	12	0	0
6	21589103	.	G	A	5	7	12	0	0	12	0	0
6	21589280	.	A	G	7	5	12	0	0	12	0	0
6	21589325	.	C	T	0	7	7	0	4	11	0	0
6	21596632	.	A	G	15	9	24	0	0	24	0	0
6	21601054	.	T	G	10	15	25	0	3	28	0	0
6	21602529	.	T	A	15	15	30	0	1	31	0	0
6	21602679	.	T	G	15	12	27	0	0	27	0	0
6	21602849	.	C	A	13	9	22	0	2	24	0	0
6	21615621	.	T	A	17	7	24	0	1	25	0	0
6	21687292	.	C	T	2	2	4	0	1	5	0	0
6	21692821	.	A	G	5	7	12	0	0	12	0	0
6	21693589	.	G	T	0	10	10	0	6	16	0	0
6	21693969	.	C	T	7	10	17	0	1	18	0	0
6	21694306	.	G	A	9	10	19	0	1	20	0	0
6	21694401	.	C	A	10	4	14	0	0	14	0	0
6	21694544	.	A	G	6	9	15	0	0	15	0	0
6	21694624	.	C	A	7	10	17	0	0	17	0	0
6	21699689	.	A	T	2	1	3	0	1	4	0	0
6	21700062	.	T	C	3	2	5	0	0	5	0	0
6	21700138	.	G	A	9	3	12	0	1	13	0	0
6	21700212	.	A	G	9	5	14	0	0	14	0	0
6	21700263	.	A	G	8	7	15	0	1	16	0	0
6	21709382	.	G	A	3	2	5	0	0	5	0	0
6	21710190	.	G	A	1	3	4	0	1	5	0	0
6	21710226	.	T	G	1	3	4	0	1	5	0	0
6	21726739	.	T	G	4	4	8	0	0	8	0	0
6	21726758	.	A	G	3	3	6	0	0	6	0	0
6	21811593	.	A	G	6	6	12	0	3	15	0	0
6	21815090	.	T	C	5	4	9	0	0	9	0	0
6	21815301	.	C	A	0	10	10	0	7	17	0	0
6	21815389	.	G	A	5	6	11	0	0	11	0	0
6	21815427	.	T	C	4	2	6	0	0	6	0	0
6	21830392	.	G	A	4	3	7	0	1	8	0	0
6	21861324	.	G	T	23	12	35	0	3	38	0	0
6	21861490	.	C	A	1	17	18	0	23	41	0	0
6	21861526	.	T	G	14	22	36	0	0	36	0	0
6	21861736	.	T	G	9	6	15	0	0	15	0	0
6	21861771	.	G	A	10	9	19	0	0	19	0	0
6	21861949	.	G	A	26	16	42	0	0	42	0	0
6	21862288	.	G	A	20	15	35	0	3	38	0	0
6	21862359	.	A	T	24	22	46	0	0	46	0	0
6	21862460	.	A	G	20	18	38	0	1	39	0	0
6	21871928	.	T	C	24	24	48	0	2	50	0	0
6	21871931	.	G	T	27	23	50	0	0	50	0	0
6	21875373	.	C	G	0	2	2	0	2	4	0	0
6	21875741	.	G	T	5	6	11	0	0	11	0	0
6	21876006	.	G	A	1	5	6	0	0	6	0	0
6	21876852	.	C	T	2	15	17	0	11	28	0	0
6	21877278	.	T	G	4	3	7	0	0	7	0	0
6	21877295	.	C	T	0	1	1	0	7	8	0	0
6	21880932	.	G	A	2	2	4	0	0	4	0	0
6	21885400	.	C	T	3	4	7	0	0	7	0	0
6	21885403	.	C	A	3	3	6	0	1	7	0	0
6	22013133	.	A	G	2	3	5	0	0	5	0	0
6	22026088	.	A	G	5	0	5	0	4	9	0	0
6	22026249	.	G	T	8	10	18	0	1	19	0	0
6	22026339	.	T	A	6	11	17	0	0	17	0	0
6	22026431	.	G	C	10	7	17	0	0	18	1	0
6	22026440	.	G	A	9	8	17	0	1	18	0	0
6	22026504	.	T	G	4	0	4	0	5	9	0	0
6	22026636	.	A	G	4	6	10	0	0	10	0	0
6	22026645	.	A	C	6	4	10	0	0	10	0	0
6	22026825	.	C	A	3	6	9	0	0	9	0	0
6	22027263	.	A	G	5	0	5	0	7	12	0	0
6	22028009	.	A	T	9	8	17	0	1	18	0	0
6	22030296	.	G	A	8	11	19	0	1	20	0	0
6	22034802	.	A	G	9	11	20	0	0	20	0	0
6	22034961	.	A	C	8	12	20	0	0	20	0	0
6	22034985	.	A	C	9	12	21	0	1	22	0	0
6	22035352	.	A	G	5	9	14	0	1	15	0	0
6	22035426	.	A	G	6	7	13	0	1	14	0	0
6	22035534	.	G	A	6	9	15	0	1	16	0	0
6	22037715	.	A	T	5	9	14	0	0	14	0	0
6	22037743	.	C	T	8	6	14	0	0	14	0	0
6	22053067	.	C	T	1	3	4	0	0	4	0	0
6	22062823	.	A	C	1	3	4	0	0	4	0	0
6	22090275	.	T	C	1	2	3	0	0	3	0	0
6	22102090	.	T	A	1	3	4	0	0	4	0	0
6	22105135	.	C	A	11	7	18	0	1	19	0	0
6	22105554	.	A	G	12	10	22	0	2	24	0	0
6	22112395	.	A	G	13	1	14	0	21	35	0	0
6	22112416	.	C	T	23	15	38	0	2	40	0	0
6	22118165	.	T	C	23	21	44	0	1	45	0	0
6	22118216	.	G	A	19	26	45	0	1	46	0	0
6	22118630	.	G	A	27	16	43	4	5	52	0	0
6	22118681	.	C	T	18	11	29	0	1	30	0	0
6	22118690	.	C	T	10	13	23	0	1	24	0	0
6	22118885	.	T	G	19	2	21	2	18	41	0	0
6	22119056	.	C	T	26	29	55	0	4	59	0	0
6	22119582	.	T	C	17	7	24	0	1	25	0	0
6	22119836	.	T	A	3	2	5	0	0	5	0	0
6	22119977	.	T	A	10	11	21	0	0	21	0	0
6	22120074	.	C	T	7	9	16	0	1	17	0	0
6	22120342	.	T	A	10	6	16	0	1	17	0	0
6	22120793	.	A	G	7	6	13	0	1	14	0	0
6	22120877	.	A	G	4	8	12	0	0	12	0	0
6	22127197	.	A	G	13	4	17	0	1	18	0	0
6	22128520	.	G	A	12	9	21	0	1	22	0	0
6	22128603	.	G	A	5	5	10	0	0	10	0	0
6	22134174	.	G	A	7	4	11	0	0	11	0	0
6	22134649	.	T	G	9	8	17	0	1	18	0	0
6	22137124	.	A	G	9	4	13	0	0	13	0	0
6	22137403	.	C	T	4	8	12	0	2	14	0	0
6	22330400	.	A	T	12	14	26	0	1	27	0	0
6	22333884	.	A	T	2	6	8	0	0	8	0	0
6	22338938	.	A	G	25	28	53	0	1	54	0	0
6	22344003	.	A	T	27	25	52	0	0	52	0	0
6	22344452	.	C	T	25	21	46	0	1	47	0	0
6	22347259	.	G	A	23	30	53	0	3	56	0	0
6	22348271	.	T	A	23	22	45	0	3	48	0	0
6	22348274	.	G	C	24	20	44	0	5	49	0	0
6	22351770	.	A	C	24	18	42	0	1	43	0	0
6	22352229	.	T	C	2	14	16	0	0	16	0	0
6	22352370	.	C	T	5	10	15	0	0	15	0	0
6	22354738	.	C	A	3	3	6	0	0	6	0	0
6	22463346	.	C	T	3	3	6	0	0	6	0	0
6	22464834	.	A	G	2	0	2	0	4	6	0	0
6	22464835	.	C	A	3	3	6	0	0	6	0	0
6	22519217	.	T	C	2	4	6	0	0	6	0	0
6	22628997	.	T	G	7	0	7	0	8	15	0	0
6	22980251	.	T	C	5	4	9	0	0	9	0	0
6	22986191	.	A	C	3	3	6	0	0	6	0	0
6	22986242	.	T	G	6	6	12	0	0	12	0	0
6	22998568	.	G	T	3	2	5	0	0	5	0	0
6	22998590	.	C	T	1	3	4	0	2	6	0	0
6	22998625	.	A	G	5	6	11	0	0	11	0	0
6	22998653	.	C	A	5	8	13	0	1	14	0	0
6	23001656	.	G	T	5	7	12	0	0	12	0	0
6	23001704	.	C	T	12	10	22	0	1	23	0	0
6	23010431	.	T	C	2	2	4	0	0	4	0	0
6	23010894	.	G	T	2	2	4	0	0	4	0	0
6	23010903	.	A	C	2	2	4	0	0	4	0	0
6	23018861	.	G	A	3	3	6	0	0	6	0	0
6	23053296	.	A	G	5	6	11	0	1	12	0	0
6	23053393	.	C	A	11	11	22	0	0	22	0	0
6	23053482	.	G	C	9	7	16	0	0	16	0	0
6	23053748	.	A	G	15	5	20	0	0	20	0	0
6	23053761	.	A	G	10	11	21	0	1	22	0	0
6	23053824	.	T	C	10	7	17	0	0	17	0	0
6	23053968	.	A	G	14	8	22	0	0	22	0	0
6	23053980	.	A	T	14	8	22	0	2	24	0	0
6	23054266	.	C	T	17	18	35	0	0	35	0	0
6	23054267	.	A	G	19	8	27	0	8	35	0	0
6	23054403	.	A	G	11	10	21	0	0	21	0	0
6	23054404	.	A	G	13	8	21	0	0	21	0	0
6	23054569	.	C	T	8	9	17	0	1	18	0	0
6	23054936	.	T	C	4	2	6	0	0	6	0	0
6	23125548	.	G	A	1	7	8	0	9	17	0	0
6	23620940	.	C	A	11	4	15	1	0	16	0	0
6	23752615	.	G	A	1	4	5	0	10	15	0	0
6	23752775	.	G	A	0	7	7	0	9	16	0	0
6	23778255	.	G	A	6	4	10	0	1	11	0	0
6	23781314	.	C	T	4	4	8	0	0	8	0	0
6	23810518	.	T	C	11	10	21	0	2	23	0	0
6	23810922	.	G	C	15	17	32	0	0	32	0	0
6	23811154	.	C	T	24	14	38	0	0	38	0	0
6	23812885	.	T	C	22	19	41	0	1	42	0	0
6	23813361	.	G	A	4	19	23	0	17	40	0	0
6	23813437	.	G	C	21	15	36	0	0	36	0	0
6	23813554	.	C	A	19	18	37	0	2	39	0	0
6	23901377	.	T	C	2	3	5	0	0	5	0	0
6	23938676	.	A	C	6	2	8	0	0	8	0	0
6	23938738	.	A	G	4	4	8	0	1	9	0	0
6	23938829	.	G	A	2	6	8	0	0	8	0	0
6	24056103	.	C	T	0	5	5	0	9	14	0	0
6	24056319	.	T	C	6	4	10	0	0	10	0	0
6	24065975	.	C	G	0	4	4	0	9	13	0	0
6	24066296	.	G	A	9	4	13	0	1	14	0	0
6	24066382	.	T	A	11	9	20	0	0	20	0	0
6	24066611	.	G	A	15	12	27	0	1	28	0	0
6	24153075	.	G	A	21	28	49	0	0	49	0	0
6	24153114	.	A	G	22	27	49	0	1	50	0	0
6	24153159	.	C	T	20	19	39	0	3	42	0	0
6	24153297	.	T	C	22	25	47	0	5	52	0	0
6	24155357	.	C	T	24	22	46	0	2	48	0	0
6	24155442	.	A	T	18	19	37	0	1	38	0	0
6	24155459	.	T	G	18	16	34	0	3	37	0	0
6	24155744	.	T	C	13	12	25	0	3	28	0	0
6	24156027	.	T	C	22	21	43	0	0	43	0	0
6	24156219	.	T	C	16	0	16	0	15	31	0	0
6	24156344	.	T	G	16	14	30	0	1	31	0	0
6	24156399	.	C	G	18	8	26	0	3	29	0	0
6	24156428	.	A	T	20	13	33	0	0	33	0	0
6	24156476	.	T	G	16	10	26	0	0	27	1	0
6	24156567	.	T	C	14	0	14	0	24	38	0	0
6	24158601	.	T	C	12	0	12	0	15	27	0	0
6	24163420	.	T	C	5	4	9	0	0	9	0	0
6	24163448	.	C	T	2	5	7	0	0	7	0	0
6	24163505	.	C	T	3	5	8	0	0	8	0	0
6	24163535	.	A	C	5	4	9	0	0	9	0	0
6	24176023	.	G	A	5	2	7	0	0	7	0	0
6	24176062	.	C	T	3	3	6	0	0	6	0	0
6	24179197	.	A	G	1	4	5	1	0	6	0	0
6	24190589	.	A	C	1	2	3	0	0	3	0	0
6	24202458	.	C	T	3	2	5	0	0	5	0	0
6	24203829	.	A	C	3	7	10	0	0	10	0	0
6	24203928	.	C	T	5	2	7	0	0	7	0	0
6	24329318	.	G	T	3	2	5	0	0	5	0	0
6	24329685	.	C	T	3	4	7	0	0	7	0	0
6	24330029	.	C	T	14	13	27	0	0	27	0	0
6	24330196	.	G	A	23	19	42	0	0	42	0	0
6	24330229	.	G	A	16	15	31	1	0	32	0	0
6	24338496	.	T	A	20	10	30	0	2	32	0	0
6	24338526	.	G	A	12	14	26	0	0	26	0	0
6	24340631	.	G	A	8	17	25	0	1	26	0	0
6	24340688	.	G	T	17	14	31	0	0	31	0	0
6	24349237	.	T	C	14	5	19	0	1	20	0	0
6	24358323	.	A	T	9	6	15	0	1	16	0	0
6	24358596	.	G	A	5	7	12	0	0	12	0	0
6	24358720	.	C	T	3	5	8	0	2	10	0	0
6	24364750	.	C	T	2	2	4	0	0	4	0	0
6	24365102	.	C	G	3	2	5	0	0	5	0	0
6	24365276	.	C	A	7	4	11	0	0	11	0	0
6	24365453	.	G	A	6	6	12	0	1	13	0	0
6	24365482	.	C	A	5	7	12	0	0	12	0	0
6	24365838	.	G	A	8	4	12	0	1	13	0	0
6	24384613	.	T	C	8	10	18	0	1	19	0	0
6	24389518	.	A	T	7	8	15	0	0	15	0	0
6	24392318	.	C	T	12	4	16	0	0	16	0	0
6	24392498	.	G	A	2	2	4	0	0	4	0	0
6	24392562	.	T	C	6	0	6	0	6	12	0	0
6	24392674	.	G	T	6	3	9	0	0	9	0	0
6	24392732	.	T	C	3	3	6	0	0	6	0	0
6	24681563	.	G	A	5	12	17	0	0	17	0	0
6	24682720	.	T	A	10	8	18	0	0	18	0	0
6	24682913	.	A	T	11	8	19	0	0	19	0	0
6	24682950	.	G	A	6	5	11	0	0	11	0	0
6	24683723	.	A	T	9	7	16	0	0	16	0	0
6	24690886	.	A	G	9	6	15	0	0	15	0	0
6	24691366	.	C	T	13	6	19	0	0	19	0	0
6	24691600	.	A	T	4	3	7	0	0	7	0	0
6	24691718	.	A	T	6	4	10	0	0	10	0	0
6	24691845	.	A	T	9	5	14	0	2	16	0	0
6	24692168	.	G	A	5	2	7	0	0	7	0	0
6	24692307	.	A	G	6	9	15	0	0	15	0	0
6	24697891	.	T	G	7	6	13	0	1	14	0	0
6	25168647	.	G	C	5	2	7	0	1	8	0	0
6	25169241	.	A	T	3	5	8	0	0	8	0	0
6	25169277	.	C	T	1	2	3	0	2	5	0	0
6	25170438	.	T	C	4	8	12	0	0	12	0	0
6	25170579	.	A	G	8	4	12	0	0	12	0	0
6	25170743	.	G	A	3	3	6	0	1	7	0	0
6	25171078	.	T	A	6	4	10	0	0	10	0	0
6	25171100	.	A	G	4	6	10	0	0	10	0	0
6	25171285	.	A	G	8	5	13	0	0	13	0	0
6	25172730	.	A	G	6	2	8	0	0	8	0	0
6	25173005	.	G	A	8	4	12	0	1	13	0	0
6	25173026	.	A	G	9	4	13	0	1	14	0	0
6	25265479	.	C	T	1	3	4	2	0	6	0	0
6	27212949	.	G	A	7	7	14	8	2	24	0	0
6	27220317	.	C	T	24	14	38	0	2	40	0	0
6	27221029	.	T	C	24	17	41	0	0	41	0	0
6	27231706	.	G	A	0	19	19	0	16	35	0	0
6	27232880	.	T	C	28	11	39	0	1	40	0	0
6	27234032	.	T	G	24	18	42	0	1	43	0	0
6	27234250	.	C	T	25	22	47	0	4	51	0	0
6	27260541	.	A	G	29	1	30	1	19	50	0	0
6	27265350	.	T	C	21	29	50	0	2	52	0	0
6	27265434	.	C	T	23	20	43	0	2	45	0	0
6	27269268	.	G	A	19	24	43	1	2	46	0	0
6	27269425	.	G	A	3	12	15	0	36	51	0	0
6	27269612	.	T	A	18	19	37	0	1	38	0	0
6	27269662	.	A	T	23	19	42	0	6	48	0	0
6	27269674	.	C	T	24	21	45	0	2	47	0	0
6	27269862	.	G	A	2	18	20	0	23	43	0	0
6	27269902	.	T	A	29	12	41	0	1	42	0	0
6	27270147	.	G	A	11	11	22	0	1	23	0	0
6	27270288	.	A	C	17	15	32	0	2	34	0	0
6	27270548	.	G	A	25	20	45	0	3	48	0	0
6	27270664	.	T	A	26	18	44	0	3	47	0	0
6	27270738	.	A	G	23	1	24	0	17	42	1	0
6	27270959	.	C	A	14	12	26	0	0	26	0	0
6	27271114	.	A	G	33	0	33	0	21	54	0	0
6	27271115	.	A	T	31	21	52	0	2	54	0	0
6	27271352	.	G	A	3	22	25	0	14	39	0	0
6	27271355	.	C	T	15	24	39	0	0	39	0	0
6	27271409	.	G	A	25	19	44	0	0	44	0	0
6	27271443	.	G	A	20	22	42	0	0	42	0	0
6	27271530	.	A	G	25	12	37	0	1	38	0	0
6	27271543	.	C	T	17	18	35	0	0	35	0	0
6	27271610	.	A	T	19	17	36	0	0	36	0	0
6	27271617	.	G	A	21	13	34	0	3	37	0	0
6	27272081	.	T	C	38	25	63	0	2	65	0	0
6	27272205	.	G	C	17	25	42	0	1	43	0	0
6	27272364	.	T	A	17	30	47	0	0	47	0	0
6	27272373	.	A	T	15	25	40	0	1	41	0	0
6	27272440	.	C	T	12	23	35	0	0	35	0	0
6	27272555	.	T	C	15	33	48	0	5	53	0	0
6	27272623	.	A	G	17	26	43	0	1	44	0	0
6	27272660	.	C	G	18	17	35	0	1	36	0	0
6	27272835	.	G	T	22	15	37	0	1	38	0	0
6	27278025	.	A	G	3	1	4	0	3	7	0	0
6	27280529	.	G	C	1	5	6	0	0	6	0	0
6	27284490	.	C	G	0	0	0	0	3	3	0	0
6	27284678	.	G	A	1	5	6	0	0	6	0	0
6	27438102	.	G	A	1	2	3	0	0	3	0	0
6	27449452	.	G	A	3	2	5	0	0	5	0	0
6	27574439	.	C	G	5	5	10	0	0	10	0	0
6	27574472	.	G	A	7	2	9	0	1	10	0	0
6	27578216	.	C	T	2	3	5	0	0	5	0	0
6	27598823	.	C	T	2	4	6	0	0	6	0	0
6	27613597	.	C	T	1	4	5	0	0	5	0	0
6	27614446	.	T	C	2	3	5	0	0	5	0	0
6	27667378	.	C	A	12	14	26	0	1	27	0	0
6	27775416	.	T	A	33	17	50	0	0	50	0	0
6	27816260	.	T	C	26	24	50	0	2	52	0	0
6	27874309	.	T	C	14	13	27	0	6	33	0	0
6	27874487	.	G	A	27	23	50	0	3	53	0	0
6	27874529	.	G	A	2	27	29	0	27	56	0	0
6	27874591	.	T	A	20	23	43	0	0	43	0	0
6	27875383	.	G	T	34	23	57	0	1	58	0	0
6	27875519	.	G	T	34	21	55	1	4	60	0	0
6	27875555	.	C	T	23	29	52	1	8	61	0	0
6	27875598	.	T	C	0	49	49	0	0	49	0	0
6	27875600	.	A	C	57	0	57	0	3	60	0	0
6	27875876	.	T	G	21	25	46	0	1	47	0	0
6	27875941	.	C	G	30	24	54	0	2	56	0	0
6	27875944	.	G	A	1	25	26	0	29	55	0	0
6	27922335	.	G	A	1	2	3	0	0	3	0	0
6	27925110	.	G	T	2	2	4	0	0	4	0	0
6	27993450	.	A	T	4	6	10	0	0	10	0	0
6	27993735	.	T	C	5	8	13	0	0	13	0	0
6	27997333	.	C	T	5	3	8	0	1	9	0	0
6	27997662	.	C	A	7	2	9	0	0	9	0	0
6	27998329	.	C	A	9	7	16	0	1	17	0	0
6	27999287	.	C	A	5	5	10	0	0	10	0	0
6	27999373	.	T	C	3	9	12	0	0	12	0	0
6	27999396	.	G	C	5	3	8	0	0	8	0	0
6	28000316	.	G	A	0	8	8	0	4	12	0	0
6	28000597	.	A	C	3	4	7	0	0	7	0	0
6	28000768	.	G	T	5	3	8	0	0	8	0	0
6	28020204	.	T	C	4	2	6	0	0	6	0	0
6	28025129	.	A	C	5	4	9	0	0	9	0	0
6	28025189	.	A	G	5	0	5	0	8	13	0	0
6	28025213	.	C	T	7	5	12	0	0	12	0	0
6	28031468	.	G	A	8	9	17	0	0	17	0	0
6	28031474	.	T	C	7	8	15	0	1	16	0	0
6	28031610	.	T	A	7	9	16	0	0	16	0	0
6	28031622	.	C	T	9	8	17	0	0	17	0	0
6	28033036	.	C	T	9	10	19	0	0	19	0	0
6	28033174	.	G	C	10	8	18	0	0	18	0	0
6	28033221	.	T	A	8	4	12	0	1	13	0	0
6	28035197	.	G	A	2	7	9	0	12	21	0	0
6	28036714	.	A	G	6	0	6	0	7	13	0	0
6	28038882	.	C	G	8	9	17	0	1	18	0	0
6	28044308	.	C	T	7	8	15	0	0	15	0	0
6	28044398	.	C	T	7	5	12	0	0	12	0	0
6	28044401	.	A	G	4	5	9	0	1	10	0	0
6	28048870	.	C	T	4	2	6	0	1	7	0	0
6	28124470	.	A	G	4	0	4	0	4	8	0	0
6	28124823	.	A	G	5	0	5	0	4	9	0	0
6	28124863	.	G	C	4	3	7	0	0	7	0	0
6	28125400	.	G	A	5	3	8	0	1	9	0	0
6	28206112	.	C	T	11	19	30	0	0	30	0	0
6	28206124	.	T	C	10	19	29	0	1	30	0	0
6	28207532	.	C	A	4	5	9	0	0	9	0	0
6	28207534	.	A	G	4	4	8	0	1	9	0	0
6	28209026	.	T	G	1	2	3	0	0	3	0	0
6	28209177	.	C	T	1	3	4	0	1	5	0	0
6	28216496	.	G	A	8	5	13	0	2	15	0	0
6	28216535	.	C	T	18	13	31	0	1	32	0	0
6	28217058	.	C	G	10	10	20	0	1	21	0	0
6	28217103	.	T	C	11	0	11	0	14	25	0	0
6	28217674	.	T	C	17	0	17	1	8	26	0	0
6	28218159	.	G	T	8	15	23	0	2	25	0	0
6	28218367	.	G	A	9	10	19	0	1	20	0	0
6	28218555	.	T	G	7	7	14	0	0	14	0	0
6	28689103	.	T	C	1	2	3	0	0	3	0	0
6	28689130	.	A	C	1	2	3	0	0	3	0	0
6	28914336	.	C	T	5	4	9	0	1	10	0	0
6	28914790	.	G	A	14	11	25	0	0	25	0	0
6	28914975	.	T	A	10	5	15	0	1	16	0	0
6	28915342	.	T	G	3	3	6	0	1	7	0	0
6	28929960	.	A	G	6	7	13	0	0	13	0	0
6	28931649	.	A	G	10	11	21	0	1	22	0	0
6	28932595	.	G	A	11	13	24	0	0	24	0	0
6	28934498	.	A	G	9	13	22	0	0	22	0	0
6	28946048	.	A	T	18	16	34	0	0	34	0	0
6	28956350	.	T	A	22	14	36	1	5	42	0	0
6	28957820	.	G	T	14	18	32	0	3	35	0	0
6	28961407	.	A	G	21	16	37	0	1	38	0	0
6	29011988	.	C	T	10	7	17	0	0	17	0	0
6	29012037	.	A	T	8	5	13	0	2	15	0	0
6	29034576	.	G	C	11	12	23	1	2	26	0	0
6	29039981	.	A	C	14	0	14	0	10	24	0	0
6	29040066	.	A	C	11	10	21	0	3	24	0	0
6	29040789	.	C	T	0	15	15	0	9	24	0	0
6	29040870	.	C	T	0	17	17	0	10	27	0	0
6	29040885	.	C	T	1	15	16	0	12	28	0	0
6	29043162	.	T	G	7	6	13	0	1	14	0	0
6	29044465	.	A	G	5	5	10	0	1	11	0	0
6	29044900	.	G	A	6	5	11	0	0	11	0	0
6	29086613	.	C	T	2	5	7	0	0	7	0	0
6	29086676	.	A	T	24	27	51	0	2	53	0	0
6	29087164	.	T	G	27	27	54	0	1	55	0	0
6	29089480	.	T	A	24	31	55	0	1	56	0	0
6	29097297	.	G	A	18	15	33	0	5	38	0	0
6	29097344	.	T	C	11	5	16	0	3	19	0	0
6	29103419	.	G	A	7	4	11	0	0	11	0	0
6	29103470	.	T	C	5	9	14	0	0	14	0	0
6	29103551	.	C	A	0	9	9	0	5	14	0	0
6	29103749	.	T	C	13	4	17	0	1	18	0	0
6	29105698	.	C	T	5	5	10	0	0	10	0	0
6	29145433	.	C	A	1	5	6	0	11	17	0	0
6	29145742	.	T	A	11	10	21	0	0	21	0	0
6	29147764	.	C	T	6	6	12	0	0	12	0	0
6	29152334	.	G	A	5	3	8	0	3	11	0	0
6	29152466	.	T	C	4	0	4	0	9	13	0	0
6	29152618	.	A	G	9	5	14	0	0	14	0	0
6	29152669	.	A	G	7	5	12	0	0	12	0	0
6	29152819	.	C	T	6	6	12	0	0	12	0	0
6	29154193	.	C	T	6	2	8	0	0	8	0	0
6	29154295	.	T	C	9	1	10	0	5	15	0	0
6	29154496	.	A	G	6	7	13	0	0	13	0	0
6	29154721	.	G	A	5	9	14	0	0	14	0	0
6	29156573	.	A	C	5	7	12	0	0	12	0	0
6	29158227	.	T	C	3	5	8	0	1	9	0	0
6	29159735	.	C	T	1	10	11	0	4	15	0	0
6	29159768	.	A	G	3	8	11	0	0	11	0	0
6	29222796	.	A	C	14	18	32	1	0	33	0	0
6	29223513	.	G	A	0	9	9	0	9	18	0	0
6	29223651	.	T	C	17	19	36	0	2	38	0	0
6	29226126	.	G	A	2	17	19	0	11	30	0	0
6	29227149	.	A	G	16	12	28	0	2	32	2	0
6	29258214	.	T	A	6	8	14	0	1	15	0	0
6	29273690	.	C	T	6	2	8	0	0	8	0	0
6	29273855	.	G	A	5	3	8	0	2	10	0	0
6	29287954	.	G	A	6	4	10	0	0	10	0	0
6	29288121	.	A	G	5	8	13	0	0	13	0	0
6	29289844	.	A	T	3	4	7	0	0	7	0	0
6	29289883	.	C	T	2	4	6	0	2	8	0	0
6	29289905	.	G	A	4	4	8	0	0	8	0	0
6	29292728	.	C	T	2	4	6	0	1	7	0	0
6	29292780	.	G	A	3	5	8	0	1	9	0	0
6	29292804	.	G	A	4	3	7	0	0	7	0	0
6	29292849	.	G	T	5	4	9	0	0	9	0	0
6	29295388	.	T	A	5	6	11	0	0	11	0	0
6	29295414	.	A	T	3	10	13	0	0	13	0	0
6	29295713	.	C	A	1	8	9	0	9	18	0	0
6	29303573	.	C	T	13	12	25	0	1	26	0	0
6	29303625	.	G	A	13	12	25	0	1	26	0	0
6	29303863	.	T	A	14	12	26	0	0	26	0	0
6	29313312	.	C	A	4	11	15	0	0	15	0	0
6	29313607	.	A	T	8	10	18	0	0	18	0	0
6	29313679	.	A	G	7	7	14	0	0	14	0	0
6	29322029	.	T	C	7	0	7	0	11	18	0	0
6	29322547	.	G	A	13	9	22	0	0	22	0	0
6	29322595	.	C	G	12	8	20	0	0	20	0	0
6	29328308	.	G	A	9	8	17	0	0	17	0	0
6	29328524	.	A	G	9	7	16	0	0	16	0	0
6	29330676	.	G	A	9	3	12	0	0	12	0	0
6	29330727	.	A	G	10	6	16	0	0	16	0	0
6	29335675	.	G	A	11	9	20	0	4	24	0	0
6	29336100	.	T	C	10	5	15	0	0	15	0	0
6	29337926	.	A	G	10	8	18	0	0	18	0	0
6	29347514	.	G	A	2	4	6	0	0	6	0	0
6	29347875	.	T	C	6	0	6	0	9	15	0	0
6	29348152	.	T	A	4	4	8	0	0	8	0	0
6	29387493	.	G	A	9	6	15	0	0	15	0	0
6	29390565	.	A	G	5	10	15	0	0	15	0	0
6	29391718	.	T	C	8	3	11	0	0	11	0	0
6	29393533	.	T	A	8	9	17	0	0	17	0	0
6	29394244	.	A	T	7	7	14	0	0	14	0	0
6	29395297	.	C	T	13	10	23	0	0	23	0	0
6	29401837	.	T	C	4	13	17	0	0	17	0	0
6	29402220	.	C	T	10	5	15	0	1	16	0	0
6	29402451	.	C	A	1	5	6	0	10	16	0	0
6	29403076	.	C	T	16	23	39	0	0	39	0	0
6	29403550	.	G	A	19	22	41	0	0	41	0	0
6	29404094	.	T	C	25	37	62	0	3	65	0	0
6	29430722	.	G	A	2	3	5	0	0	5	0	0
6	29441055	.	G	A	1	2	3	0	0	3	0	0
6	29459034	.	T	C	4	4	8	0	0	8	0	0
6	29459054	.	A	G	4	0	4	0	6	10	0	0
6	29466588	.	T	A	1	2	3	0	0	3	0	0
6	29466626	.	C	A	2	4	6	0	0	6	0	0
6	29466897	.	A	C	1	2	3	0	0	3	0	0
6	29468320	.	C	T	5	3	8	0	0	8	0	0
6	29468331	.	A	T	4	4	8	0	0	8	0	0
6	29468671	.	A	G	4	2	6	0	0	6	0	0
6	29477093	.	T	A	4	7	11	0	0	11	0	0
6	29477094	.	T	C	4	7	11	0	0	11	0	0
6	29477188	.	C	T	4	5	9	0	1	10	0	0
6	29477739	.	C	T	3	5	8	0	0	8	0	0
6	29477929	.	T	C	7	4	11	0	0	11	0	0
6	29477962	.	C	T	6	2	8	0	0	8	0	0
6	29485253	.	T	C	4	6	10	0	1	11	0	0
6	29488695	.	A	G	3	6	9	0	0	9	0	0
6	29498150	.	A	T	3	4	7	0	0	7	0	0
6	29519903	.	G	A	5	3	8	0	0	8	0	0
6	29612067	.	G	A	5	2	7	0	0	7	0	0
6	29703846	.	A	C	7	5	12	0	1	13	0	0
6	29703865	.	A	T	7	7	14	0	0	14	0	0
6	29705343	.	C	T	10	8	18	0	1	19	0	0
6	29705709	.	T	A	2	4	6	0	0	6	0	0
6	29705710	.	T	C	2	4	6	0	0	6	0	0
6	29705767	.	A	G	5	7	12	0	1	13	0	0
6	29708010	.	T	C	15	14	29	0	0	29	0	0
6	29708073	.	A	C	11	14	25	0	0	25	0	0
6	29708100	.	C	T	7	8	15	0	1	16	0	0
6	29710111	.	C	T	6	13	19	0	0	19	0	0
6	29710157	.	A	G	7	0	7	0	11	18	0	0
6	29710216	.	C	T	7	11	18	0	0	18	0	0
6	29710252	.	T	C	5	11	16	0	1	17	0	0
6	29712410	.	C	T	11	11	22	0	2	24	0	0
6	29712420	.	C	A	12	14	26	0	0	26	0	0
6	29712470	.	T	C	8	7	15	0	0	15	0	0
6	29712651	.	G	A	9	15	24	0	3	27	0	0
6	29791206	.	C	G	4	13	17	0	1	19	1	0
6	29791310	.	A	C	29	36	65	0	3	68	0	0
6	29793798	.	C	A	38	35	73	0	3	76	0	0
6	29793814	.	C	T	33	34	67	0	8	75	0	0
6	29794042	.	G	A	30	36	66	0	5	71	0	0
6	29794639	.	T	C	23	35	58	0	4	62	0	0
6	29794695	.	T	C	26	29	55	0	3	58	0	0
6	30019954	.	C	T	13	12	25	0	2	27	0	0
6	30032574	.	A	G	14	0	14	1	18	33	0	0
6	30048285	.	A	G	11	0	11	0	8	19	0	0
6	30048421	.	G	A	3	15	18	0	17	35	0	0
6	30060296	.	C	T	24	24	48	0	1	49	0	0
6	30066414	.	A	T	5	2	7	0	0	7	0	0
6	30081420	.	C	T	19	17	36	0	3	39	0	0
6	30081421	.	T	C	18	17	35	0	1	36	0	0
6	30081503	.	A	G	27	15	42	0	1	43	0	0
6	30081725	.	C	T	18	19	37	0	0	37	0	0
6	30082255	.	G	A	8	10	18	0	1	19	0	0
6	30082752	.	T	G	29	19	48	1	1	50	0	0
6	30082838	.	G	T	6	16	22	0	0	22	0	0
6	30113800	.	C	T	6	4	10	0	0	10	0	0
6	30115399	.	A	G	4	4	8	0	0	8	0	0
6	30117495	.	G	A	6	4	10	0	0	10	0	0
6	30120409	.	C	A	6	8	14	0	0	14	0	0
6	30121872	.	G	T	7	3	10	0	0	10	0	0
6	30133958	.	G	T	19	14	33	0	8	41	0	0
6	30147219	.	G	A	18	22	40	0	1	41	0	0
6	30147831	.	C	T	11	14	25	0	0	25	0	0
6	30148056	.	A	T	15	15	30	0	1	31	0	0
6	30148143	.	G	A	12	11	23	0	0	23	0	0
6	30148182	.	G	A	9	10	19	0	2	21	0	0
6	30148863	.	T	C	22	15	37	1	0	38	0	0
6	30151519	.	G	A	16	18	34	0	1	35	0	0
6	30177635	.	G	A	9	10	19	0	1	20	0	0
6	30177724	.	G	A	6	9	15	0	0	15	0	0
6	30431878	.	G	A	1	4	5	0	1	6	0	0
6	30432533	.	T	G	5	3	8	0	0	8	0	0
6	30433125	.	C	T	2	2	4	0	0	4	0	0
6	30434078	.	A	T	1	3	4	0	1	5	0	0
6	30434288	.	A	T	1	2	3	0	0	3	0	0
6	30440258	.	G	A	0	4	4	0	7	11	0	0
6	30441333	.	G	A	4	4	8	0	0	8	0	0
6	30441399	.	G	A	1	4	5	0	4	9	0	0
6	30441536	.	G	A	5	2	7	0	1	8	0	0
6	30450464	.	G	A	7	5	12	0	1	13	0	0
6	30452316	.	T	C	2	7	9	0	0	9	0	0
6	30452932	.	G	C	1	4	5	0	0	5	0	0
6	30573564	.	T	G	2	5	7	0	0	7	0	0
6	30573927	.	G	A	0	2	2	0	3	5	0	0
6	30583746	.	A	G	4	0	4	0	7	11	0	0
6	30587201	.	T	A	5	2	7	0	0	7	0	0
6	30588283	.	C	T	2	4	6	0	0	6	0	0
6	30592556	.	T	C	1	2	3	0	0	3	0	0
6	30592558	.	A	T	1	2	3	0	0	3	0	0
6	30626227	.	A	G	14	11	25	0	0	25	0	0
6	30626240	.	A	T	13	13	26	0	0	26	0	0
6	30626276	.	T	C	10	12	22	0	2	24	0	0
6	30626630	.	T	G	10	8	18	0	2	20	0	0
6	30626715	.	T	G	11	15	26	0	1	27	0	0
6	30626765	.	C	T	10	13	23	0	2	25	0	0
6	30627182	.	T	A	14	12	26	0	1	27	0	0
6	30627228	.	A	C	24	13	37	0	1	38	0	0
6	30627292	.	T	C	17	12	29	0	6	35	0	0
6	30627605	.	G	C	19	7	26	0	0	26	0	0
6	30627606	.	A	C	19	0	19	0	8	27	0	0
6	30627660	.	A	C	15	4	19	0	0	19	0	0
6	30627674	.	G	T	14	8	22	0	0	22	0	0
6	30627744	.	C	T	17	12	29	0	2	31	0	0
6	30627764	.	G	T	15	13	28	0	0	28	0	0
6	30627811	.	T	C	11	10	21	0	1	22	0	0
6	30627914	.	T	C	18	7	25	0	0	25	0	0
6	30627921	.	G	T	17	8	25	0	0	25	0	0
6	30627996	.	A	C	8	0	8	0	6	14	0	0
6	30627998	.	T	C	8	0	8	0	6	14	0	0
6	30628097	.	C	T	11	15	26	0	0	26	0	0
6	30628170	.	T	C	5	3	8	0	0	8	0	0
6	30628228	.	A	G	3	4	7	1	0	8	0	0
6	30628848	.	C	T	15	8	23	0	0	23	0	0
6	30628922	.	T	C	9	12	21	0	1	22	0	0
6	30628976	.	T	A	13	18	31	0	0	31	0	0
6	30629229	.	T	A	4	8	12	0	0	12	0	0
6	30629303	.	T	A	8	4	12	0	0	12	0	0
6	30629317	.	C	A	8	3	11	0	0	11	0	0
6	30629384	.	T	C	7	0	7	0	10	17	0	0
6	30629459	.	A	G	7	6	13	0	0	13	0	0
6	30629827	.	C	A	4	6	10	0	0	10	0	0
6	30629850	.	G	C	2	6	8	0	1	9	0	0
6	30629865	.	A	C	3	3	6	0	2	8	0	0
6	30629895	.	G	A	5	3	8	0	1	9	0	0
6	30629912	.	A	T	7	6	13	0	1	14	0	0
6	30629935	.	T	C	9	0	9	0	7	16	0	0
6	30630017	.	C	T	1	2	3	0	3	6	0	0
6	30630163	.	G	A	3	2	5	0	1	6	0	0
6	30630171	.	C	T	3	2	5	0	0	5	0	0
6	30630265	.	C	T	5	3	8	0	0	8	0	0
6	30630266	.	A	C	5	2	7	0	1	8	0	0
6	30630438	.	G	A	8	3	11	0	1	12	0	0
6	30630811	.	T	C	10	13	23	0	1	24	0	0
6	30630904	.	A	G	10	4	14	0	0	14	0	0
6	30631021	.	T	C	6	11	17	0	1	18	0	0
6	30658102	.	T	C	10	5	15	0	0	15	0	0
6	30658545	.	G	A	9	8	17	0	1	18	0	0
6	30658728	.	A	C	8	10	18	0	0	18	0	0
6	30677475	.	A	G	2	7	9	0	0	9	0	0
6	30677582	.	T	C	11	3	14	0	0	14	0	0
6	30677602	.	A	T	8	6	14	0	0	14	0	0
6	30677646	.	A	G	6	11	17	0	0	17	0	0
6	30677654	.	A	C	5	10	15	0	0	15	0	0
6	30677701	.	C	T	0	5	5	0	5	10	0	0
6	30677734	.	A	C	3	0	3	0	7	10	0	0
6	30678086	.	T	C	2	0	2	0	2	4	0	0
6	30678112	.	T	A	1	4	5	0	0	5	0	0
6	30678126	.	C	T	3	3	6	0	0	6	0	0
6	30678406	.	C	A	2	2	4	0	3	7	0	0
6	30681208	.	C	T	5	5	10	0	0	10	0	0
6	30682141	.	A	G	6	3	9	0	0	9	0	0
6	30683382	.	G	A	4	4	8	0	1	9	0	0
6	30683571	.	T	A	6	8	14	0	0	14	0	0
6	30683578	.	T	C	6	8	14	0	0	14	0	0
6	30685027	.	T	C	2	4	6	0	1	7	0	0
6	30685044	.	A	G	3	3	6	0	1	7	0	0
6	30685632	.	A	G	2	3	5	0	1	6	0	0
6	30685644	.	A	T	3	3	6	0	0	6	0	0
6	30687631	.	C	T	3	3	6	0	0	6	0	0
6	30689024	.	C	T	0	2	2	0	1	3	0	0
6	30710270	.	A	G	22	23	45	0	1	46	0	0
6	30710313	.	C	A	21	23	44	0	0	44	0	0
6	30710342	.	T	G	24	17	41	0	0	41	0	0
6	30710351	.	G	T	23	13	36	0	0	36	0	0
6	30710457	.	C	T	21	14	35	0	0	35	0	0
6	30710460	.	T	G	18	12	30	0	2	32	0	0
6	30710496	.	T	A	15	10	25	0	1	26	0	0
6	30711269	.	T	A	2	2	4	0	0	4	0	0
6	30711554	.	C	T	3	11	14	0	18	32	0	0
6	30711777	.	C	T	16	13	29	0	0	29	0	0
6	30711779	.	G	A	13	12	25	0	2	28	1	0
6	30711844	.	A	G	11	19	30	0	0	30	0	0
6	30711851	.	T	C	11	21	32	0	0	32	0	0
6	30712265	.	T	C	12	14	26	0	0	26	0	0
6	30712455	.	A	T	10	16	26	0	0	26	0	0
6	30712616	.	C	T	0	7	7	0	10	17	0	0
6	30712622	.	A	G	11	9	20	1	1	22	0	0
6	30712917	.	G	A	24	9	33	1	0	34	0	0
6	30713296	.	C	T	13	14	27	0	0	27	0	0
6	30713334	.	G	C	14	12	26	1	1	28	0	0
6	30713647	.	C	T	7	4	11	0	1	12	0	0
6	30713666	.	T	C	9	4	13	0	1	14	0	0
6	30713822	.	T	G	15	8	23	0	0	23	0	0
6	30713824	.	A	T	14	7	21	0	1	22	0	0
6	30713869	.	C	T	2	15	17	0	15	32	0	0
6	30713910	.	C	T	20	21	41	0	0	41	0	0
6	30714020	.	T	C	15	12	27	0	0	27	0	0
6	30714053	.	T	C	10	19	29	0	0	29	0	0
6	30714177	.	T	A	13	13	26	0	3	29	0	0
6	30714240	.	T	C	16	5	21	0	1	22	0	0
6	30715009	.	T	G	11	13	24	0	0	24	0	0
6	30715446	.	T	C	15	0	15	0	9	24	0	0
6	30717579	.	T	C	15	26	41	0	1	42	0	0
6	30717636	.	T	C	15	0	15	0	21	36	0	0
6	30719319	.	G	A	17	12	29	0	0	29	0	0
6	30719935	.	C	T	18	11	29	0	1	30	0	0
6	30740064	.	A	G	12	13	25	0	1	26	0	0
6	30740106	.	G	A	17	11	28	0	1	29	0	0
6	30740127	.	T	A	13	7	20	0	5	25	0	0
6	30742651	.	A	G	22	24	46	0	2	48	0	0
6	30747415	.	A	G	12	16	28	0	0	28	0	0
6	30761742	.	G	A	10	10	20	0	2	22	0	0
6	30761775	.	G	A	11	10	21	0	0	21	0	0
6	30855423	.	G	A	21	22	43	0	1	44	0	0
6	30868450	.	A	G	5	7	12	0	0	12	0	0
6	31069556	.	G	A	6	3	9	0	0	9	0	0
6	31069622	.	T	A	6	4	10	0	1	11	0	0
6	31069682	.	T	C	7	4	11	0	1	12	0	0
6	31069748	.	A	G	7	3	10	0	0	10	0	0
6	31146921	.	T	C	4	3	7	0	1	8	0	0
6	31146955	.	A	T	4	7	11	0	0	11	0	0
6	31184478	.	A	G	1	5	6	0	0	6	0	0
6	31184651	.	T	C	5	2	7	0	0	7	0	0
6	31184674	.	C	T	4	2	6	0	0	6	0	0
6	31184952	.	T	C	3	8	11	0	0	11	0	0
6	31185515	.	A	T	2	2	4	0	0	4	0	0
6	31185523	.	C	T	2	2	4	0	0	4	0	0
6	31185825	.	A	T	2	2	4	0	0	4	0	0
6	31186981	.	G	A	9	3	12	0	1	13	0	0
6	31198825	.	C	T	1	4	5	0	0	5	0	0
6	31198869	.	G	A	1	2	3	0	0	3	0	0
6	31198876	.	T	A	4	2	6	0	0	6	0	0
6	31209550	.	T	C	1	3	4	0	0	4	0	0
6	31209552	.	T	C	1	0	1	0	3	4	0	0
6	31214421	.	C	G	4	3	7	0	0	7	0	0
6	31217220	.	C	T	2	3	5	0	0	5	0	0
6	31219005	.	G	A	3	3	6	0	0	6	0	0
6	31279834	.	G	A	6	13	19	0	1	20	0	0
6	31280141	.	G	A	26	14	40	0	0	40	0	0
6	31280164	.	T	C	18	18	36	0	3	39	0	0
6	31280185	.	T	A	18	21	39	0	2	41	0	0
6	31280645	.	C	A	19	8	27	0	0	29	2	0
6	31280681	.	C	A	12	10	22	0	0	22	0	0
6	31280735	.	T	G	12	15	27	0	0	27	0	0
6	31280741	.	G	A	13	17	30	0	0	30	0	0
6	31280936	.	A	T	13	16	29	0	0	30	1	0
6	31280945	.	A	T	15	15	30	0	1	31	0	0
6	31281282	.	G	A	19	18	37	0	1	38	0	0
6	31281304	.	C	A	26	17	43	0	2	45	0	0
6	31281481	.	A	G	11	2	13	0	0	13	0	0
6	31281533	.	T	A	10	14	24	0	0	24	0	0
6	31281537	.	A	G	12	14	26	0	1	27	0	0
6	31281594	.	A	T	14	14	28	0	1	29	0	0
6	31281674	.	T	C	13	10	23	0	0	23	0	0
6	31281694	.	C	T	8	8	16	0	0	16	0	0
6	31281732	.	T	A	7	6	13	0	0	14	1	0
6	31282205	.	C	T	14	14	28	0	0	28	0	0
6	31282399	.	T	C	11	7	18	0	0	18	0	0
6	31282494	.	C	T	15	10	25	0	2	27	0	0
6	31282835	.	A	G	5	2	7	0	0	7	0	0
6	31283055	.	G	A	10	7	17	0	0	17	0	0
6	31283180	.	C	T	14	4	18	0	0	18	0	0
6	31283191	.	T	C	11	4	15	0	4	19	0	0
6	31283245	.	A	G	10	19	29	1	0	30	0	0
6	31283280	.	T	A	12	17	29	1	1	31	0	0
6	31283299	.	G	A	12	10	22	1	1	24	0	0
6	31285874	.	G	A	15	12	27	1	0	28	0	0
6	31288637	.	C	G	15	25	40	0	0	40	0	0
6	31288642	.	C	G	2	22	24	0	15	39	0	0
6	31288742	.	T	C	21	2	23	0	18	41	0	0
6	31288894	.	T	A	16	24	40	1	1	42	0	0
6	31291030	.	G	A	19	23	42	0	3	45	0	0
6	31291033	.	C	A	16	24	40	0	5	45	0	0
6	31309823	.	C	T	3	14	17	0	13	30	0	0
6	31352298	.	T	A	11	6	17	0	2	19	0	0
6	31352339	.	T	A	8	4	12	0	1	13	0	0
6	31352406	.	C	A	8	9	17	0	2	20	1	0
6	31352555	.	T	C	3	5	8	0	0	8	0	0
6	31352556	.	G	A	3	5	8	0	0	8	0	0
6	31352635	.	T	G	1	6	7	0	0	7	0	0
6	31353022	.	G	C	16	5	21	0	0	21	0	0
6	31353345	.	T	A	14	11	25	0	1	26	0	0
6	31353451	.	A	T	9	9	18	0	0	18	0	0
6	31353613	.	G	A	12	11	23	0	0	23	0	0
6	31355787	.	C	T	10	13	23	0	1	24	0	0
6	31358525	.	C	T	1	8	9	0	18	27	0	0
6	31394445	.	A	C	4	2	6	0	0	6	0	0
6	31394453	.	A	C	4	3	7	0	0	7	0	0
6	31395835	.	G	A	5	6	11	0	1	12	0	0
6	31396249	.	A	T	1	4	5	0	1	6	0	0
6	31405898	.	G	A	1	4	5	0	8	13	0	0
6	31405923	.	C	T	8	4	12	0	1	13	0	0
6	31411751	.	C	T	5	9	14	0	0	14	0	0
6	31414061	.	A	C	5	6	11	0	0	11	0	0
6	31419749	.	T	C	8	5	13	0	0	13	0	0
6	31426287	.	G	T	13	8	21	0	1	23	1	0
6	31426465	.	T	C	11	18	29	0	0	29	0	0
6	31426546	.	C	A	7	4	11	0	1	12	0	0
6	31426551	.	C	A	7	4	11	2	1	14	0	0
6	31426727	.	C	G	7	9	16	0	0	16	0	0
6	31426886	.	C	T	11	7	18	0	1	19	0	0
6	31426955	.	G	A	13	8	21	0	3	24	0	0
6	31427226	.	C	T	6	3	9	0	0	9	0	0
6	31427240	.	A	G	7	3	10	0	1	11	0	0
6	31427363	.	C	G	9	0	9	0	9	18	0	0
6	31427397	.	T	C	9	6	15	0	1	16	0	0
6	31427437	.	C	A	7	3	10	0	0	10	0	0
6	31427468	.	A	G	7	3	10	0	0	10	0	0
6	31427906	.	A	G	9	9	18	0	0	18	0	0
6	31427907	.	A	G	11	8	19	0	0	19	0	0
6	31428565	.	T	G	5	7	12	0	1	13	0	0
6	31428566	.	A	G	5	7	12	0	1	13	0	0
6	31428705	.	C	T	11	8	19	0	1	20	0	0
6	31428746	.	G	A	11	8	19	0	0	19	0	0
6	31431355	.	G	A	9	13	22	0	1	23	0	0
6	31431422	.	A	G	10	10	20	0	1	21	0	0
6	31431520	.	A	G	12	12	24	0	0	24	0	0
6	31431646	.	A	T	10	12	22	0	1	23	0	0
6	31431775	.	T	C	15	9	24	0	5	29	0	0
6	31431926	.	A	T	16	21	37	0	1	38	0	0
6	31432232	.	G	A	5	7	12	0	1	13	0	0
6	31432315	.	T	C	4	3	7	0	0	7	0	0
6	31432458	.	A	G	1	1	2	0	1	3	0	0
6	31432554	.	A	T	7	6	13	0	0	13	0	0
6	31432617	.	T	G	4	6	10	0	1	11	0	0
6	31432679	.	T	A	5	4	9	0	0	9	0	0
6	31432746	.	A	C	12	13	25	0	1	26	0	0
6	31432761	.	A	G	14	11	25	0	2	27	0	0
6	31433056	.	C	T	13	6	19	0	0	19	0	0
6	31433060	.	T	C	9	6	15	0	3	18	0	0
6	31433126	.	C	G	3	5	8	1	10	19	0	0
6	31433362	.	T	A	3	3	6	0	0	6	0	0
6	31433392	.	T	G	5	6	11	0	0	11	0	0
6	31433412	.	A	G	6	6	12	0	1	13	0	0
6	31433572	.	T	A	5	4	9	0	0	9	0	0
6	31433756	.	C	A	5	4	9	0	0	9	0	0
6	31434470	.	G	T	10	4	14	0	0	14	0	0
6	31434554	.	G	A	3	3	6	2	3	11	0	0
6	31434555	.	A	G	3	2	5	2	4	11	0	0
6	31434773	.	T	G	11	10	21	0	4	25	0	0
6	31434830	.	A	G	7	7	14	0	0	14	0	0
6	31434923	.	C	T	2	6	8	0	9	17	0	0
6	31435005	.	T	C	4	7	11	0	3	14	0	0
6	31438395	.	T	C	16	12	28	0	0	28	0	0
6	31438404	.	T	G	14	10	24	0	3	27	0	0
6	31441574	.	A	T	19	10	29	0	2	31	0	0
6	31465978	.	G	C	6	1	7	1	11	19	0	0
6	31469966	.	T	G	7	6	13	0	1	14	0	0
6	31483364	.	A	C	7	8	15	0	0	15	0	0
6	31518368	.	T	C	6	0	6	0	5	11	0	0
6	31591116	.	C	T	8	6	14	0	1	15	0	0
6	31591123	.	C	T	6	6	12	0	4	16	0	0
6	31591163	.	A	G	6	6	12	0	1	13	0	0
6	31591452	.	C	T	6	10	16	0	2	18	0	0
6	31591619	.	G	A	6	5	11	0	0	11	0	0
6	31591838	.	T	G	14	20	34	0	0	34	0	0
6	31591883	.	C	T	14	3	17	0	11	28	0	0
6	31591884	.	A	G	6	9	15	0	13	28	0	0
6	31591997	.	A	C	25	0	25	0	15	40	0	0
6	31598783	.	C	T	17	9	26	0	3	30	1	0
6	31607768	.	T	G	9	10	19	0	1	20	0	0
6	31611647	.	T	A	8	5	13	0	0	13	0	0
6	31617167	.	C	G	1	6	7	0	9	16	0	0
6	31631366	.	A	G	4	7	11	0	0	11	0	0
6	31632508	.	T	C	7	9	16	0	0	16	0	0
6	31632519	.	G	A	8	11	19	0	0	19	0	0
6	31632550	.	G	C	5	0	5	0	11	16	0	0
6	31646560	.	C	T	1	7	8	0	4	12	0	0
6	32020326	.	G	A	11	17	28	0	1	29	0	0
6	32020327	.	T	A	10	14	24	0	5	29	0	0
6	32021615	.	T	A	8	14	22	0	0	22	0	0
6	32032374	.	A	C	7	7	14	0	1	15	0	0
6	32035947	.	A	G	4	5	9	0	0	9	0	0
6	32037710	.	T	C	8	6	14	0	0	14	0	0
6	32040581	.	G	A	3	2	5	0	0	5	0	0
6	32040620	.	G	A	1	1	2	0	2	4	0	0
6	32042325	.	C	T	2	3	5	0	0	5	0	0
6	32042501	.	G	A	7	2	9	0	0	9	0	0
6	32043513	.	G	C	5	6	11	0	0	11	0	0
6	32043514	.	G	T	4	6	10	0	0	10	0	0
6	32065310	.	C	T	3	3	6	0	2	8	0	0
6	32068390	.	C	T	0	3	3	0	2	5	0	0
6	32092825	.	C	T	0	2	2	0	1	3	0	0
6	32301137	.	A	T	6	4	10	0	0	10	0	0
6	32301161	.	C	T	6	3	9	0	0	9	0	0
6	32301214	.	A	T	9	3	12	0	0	12	0	0
6	32301265	.	A	T	7	8	15	0	0	15	0	0
6	32301839	.	T	C	3	0	3	0	3	6	0	0
6	32301900	.	C	G	1	8	9	0	4	13	0	0
6	32301969	.	T	G	3	4	7	0	3	10	0	0
6	32302086	.	T	A	6	6	12	0	0	12	0	0
6	32302236	.	C	T	0	3	3	0	6	9	0	0
6	32309717	.	T	A	5	2	7	0	0	7	0	0
6	32314240	.	G	A	2	4	6	0	0	6	0	0
6	32331333	.	G	A	0	6	6	0	8	14	0	0
6	32336532	.	C	T	7	7	14	0	0	14	0	0
6	32338356	.	T	C	4	4	8	0	0	8	0	0
6	32339606	.	T	C	7	14	21	0	0	21	0	0
6	32339831	.	C	A	11	11	22	0	0	22	0	0
6	32340005	.	C	T	11	8	19	0	0	19	0	0
6	32346790	.	G	A	1	2	3	0	0	3	0	0
6	32355214	.	G	A	0	1	1	0	0	1	0	0
6	32355221	.	C	T	8	10	18	1	0	19	0	0
6	32359371	.	A	G	8	6	14	0	0	14	0	0
6	32359533	.	G	A	7	8	15	0	0	15	0	0
6	32364439	.	C	T	12	7	19	0	1	20	0	0
6	32368787	.	A	T	5	3	8	0	0	8	0	0
6	32368952	.	C	T	6	4	10	0	0	10	0	0
6	32368970	.	A	T	7	6	13	0	0	13	0	0
6	32371414	.	A	G	11	5	16	0	0	16	0	0
6	32371423	.	T	C	11	5	16	0	0	16	0	0
6	32371466	.	A	T	8	7	15	0	1	17	1	0
6	32375581	.	T	C	9	11	20	0	1	21	0	0
6	32375838	.	T	C	9	12	21	0	0	21	0	0
6	32378097	.	G	A	0	4	4	0	6	10	0	0
6	32378689	.	T	C	8	10	18	0	1	19	0	0
6	32385091	.	A	G	12	8	20	0	0	20	0	0
6	32386908	.	T	C	14	11	25	0	0	25	0	0
6	32396755	.	T	C	10	6	16	0	0	16	0	0
6	32397659	.	T	C	12	11	23	0	1	24	0	0
6	32398844	.	G	A	14	15	29	0	0	30	1	0
6	32403028	.	G	A	14	9	23	0	1	24	0	0
6	32403052	.	T	C	14	10	24	0	0	24	0	0
6	32404957	.	A	G	4	8	12	0	2	14	0	0
6	32404984	.	A	G	4	11	15	0	0	15	0	0
6	32405020	.	G	A	5	9	14	0	0	14	0	0
6	32405054	.	A	T	6	4	10	0	0	10	0	0
6	32405784	.	A	G	10	10	20	0	1	21	0	0
6	32408182	.	A	G	3	6	9	0	1	10	0	0
6	32408742	.	A	T	4	3	7	0	1	8	0	0
6	32409135	.	C	T	3	10	13	0	0	13	0	0
6	32409258	.	T	C	6	1	7	0	6	13	0	0
6	32409301	.	G	A	4	7	11	0	0	11	0	0
6	32409846	.	G	A	2	6	8	0	0	8	0	0
6	32411039	.	C	T	0	4	4	0	3	7	0	0
6	32411623	.	C	A	3	9	12	0	0	12	0	0
6	32415658	.	T	G	1	3	4	0	0	4	0	0
6	32416209	.	T	A	2	4	6	0	0	6	0	0
6	32416217	.	C	T	3	4	7	0	0	7	0	0
6	32481312	.	T	C	5	7	12	0	0	12	0	0
6	32482213	.	A	G	5	3	8	0	0	8	0	0
6	32482727	.	G	A	2	5	7	0	0	7	0	0
6	32483750	.	T	C	9	9	18	0	0	18	0	0
6	32487220	.	A	T	3	7	10	0	2	12	0	0
6	32497525	.	A	G	5	0	5	0	10	15	0	0
6	32497549	.	A	G	6	9	15	0	1	16	0	0
6	32504356	.	C	T	9	5	14	0	0	14	0	0
6	32506350	.	G	A	7	12	19	0	0	19	0	0
6	32506473	.	G	A	0	7	7	0	9	16	0	0
6	32699666	.	G	A	3	3	6	0	1	7	0	0
6	32699682	.	T	A	3	5	8	0	0	8	0	0
6	32699775	.	A	C	5	0	5	0	4	9	0	0
6	32699870	.	A	T	8	4	12	0	0	12	0	0
6	32700064	.	A	G	1	1	2	0	4	6	0	0
6	32700069	.	G	A	0	3	3	0	1	4	0	0
6	32700108	.	T	C	1	3	4	0	0	4	0	0
6	32700228	.	G	A	4	3	7	0	0	7	0	0
6	32700607	.	T	G	4	7	11	0	0	11	0	0
6	32702198	.	C	T	6	8	14	0	0	14	0	0
6	32703298	.	T	A	3	2	5	0	0	5	0	0
6	32722579	.	A	G	1	5	6	0	1	7	0	0
6	32722640	.	C	T	0	4	4	0	10	14	0	0
6	32773726	.	T	C	6	0	6	0	3	9	0	0
6	32830082	.	T	C	5	3	8	0	0	8	0	0
6	32830083	.	A	G	3	5	8	0	0	8	0	0
6	32831529	.	C	T	0	2	2	0	1	3	0	0
6	32831584	.	A	G	2	3	5	0	0	5	0	0
6	32831635	.	A	G	3	6	9	0	0	9	0	0
6	32831644	.	A	T	3	5	8	0	0	8	0	0
6	32831728	.	A	G	4	4	8	0	0	8	0	0
6	32832003	.	A	G	1	4	5	0	0	5	0	0
6	32832061	.	C	T	0	4	4	0	2	6	0	0
6	32832113	.	G	A	3	5	8	0	0	8	0	0
6	32832166	.	T	C	2	0	2	0	3	5	0	0
6	32832409	.	G	T	3	4	7	0	0	7	0	0
6	32832662	.	A	G	4	5	9	0	1	10	0	0
6	32832747	.	A	C	4	2	6	0	0	6	0	0
6	32844375	.	T	C	0	2	2	0	1	3	0	0
6	32883071	.	A	T	4	3	7	0	0	7	0	0
6	32960710	.	C	T	2	2	4	0	0	4	0	0
6	32966915	.	G	C	13	10	23	0	0	23	0	0
6	32967065	.	C	T	13	10	23	0	0	23	0	0
6	32967080	.	T	C	15	7	22	0	0	22	0	0
6	32967174	.	G	A	15	10	25	0	2	27	0	0
6	32967182	.	A	T	16	9	25	0	3	28	0	0
6	32967357	.	G	A	14	11	25	0	0	25	0	0
6	32970032	.	G	A	11	10	21	0	0	21	0	0
6	32970178	.	T	C	5	12	17	0	1	18	0	0
6	32976281	.	G	A	10	9	19	0	0	19	0	0
6	32979285	.	A	C	14	7	21	0	1	22	0	0
6	32999747	.	A	C	9	0	9	0	11	20	0	0
6	33023389	.	T	A	11	6	17	0	1	18	0	0
6	33023439	.	G	A	13	10	23	0	0	23	0	0
6	33023545	.	T	C	8	0	8	0	13	21	0	0
6	33023601	.	A	G	8	15	23	0	2	25	0	0
6	33023625	.	G	C	15	7	22	0	0	22	0	0
6	33077446	.	T	C	5	2	7	0	0	7	0	0
6	33083415	.	G	A	4	4	8	0	1	9	0	0
6	33085555	.	G	T	5	7	12	0	0	12	0	0
6	33085558	.	G	T	8	5	13	0	0	13	0	0
6	33085730	.	G	A	3	4	7	0	0	7	0	0
6	33086403	.	T	C	7	3	10	0	0	10	0	0
6	33089139	.	G	A	1	4	5	0	2	7	0	0
6	33091561	.	C	T	1	3	4	0	1	5	0	0
6	33091567	.	T	C	3	2	5	0	1	6	0	0
6	33094767	.	A	C	3	3	6	0	1	7	0	0
6	33095174	.	G	A	3	2	5	0	0	5	0	0
6	33095499	.	T	C	5	2	7	0	1	8	0	0
6	33549187	.	T	G	10	0	10	0	10	20	0	0
6	33550455	.	C	T	12	11	23	0	1	24	0	0
6	33550691	.	C	A	13	9	22	0	0	22	0	0
6	33550947	.	G	A	19	16	35	0	0	35	0	0
6	33552574	.	T	C	20	12	32	0	0	32	0	0
6	33552601	.	A	T	21	11	32	0	0	32	0	0
6	33553084	.	G	A	8	3	11	0	0	11	0	0
6	33554009	.	T	A	7	6	13	0	1	15	1	0
6	33554231	.	T	C	9	13	22	0	2	24	0	0
6	33554356	.	T	C	13	17	30	0	1	31	0	0
6	33554576	.	T	C	3	9	12	0	0	12	0	0
6	33554620	.	A	G	2	0	2	0	6	8	0	0
6	33554702	.	T	C	6	12	18	0	0	18	0	0
6	33554737	.	T	C	7	13	20	0	0	20	0	0
6	33554904	.	T	G	3	3	6	0	0	6	0	0
6	33555159	.	G	A	0	6	6	0	5	11	0	0
6	33555168	.	C	T	4	7	11	0	1	12	0	0
6	33555227	.	A	T	5	6	11	0	2	13	0	0
6	33555241	.	T	C	8	3	11	0	0	11	0	0
6	33555351	.	A	G	11	16	27	0	1	28	0	0
6	33555374	.	G	A	0	11	11	0	12	23	0	0
6	33555397	.	A	G	13	6	19	0	1	21	1	0
6	33555570	.	G	A	5	10	15	0	1	16	0	0
6	33555594	.	T	C	2	9	11	0	1	12	0	0
6	33555691	.	T	G	9	0	9	1	10	20	0	0
6	33555736	.	G	T	5	12	17	2	4	23	0	0
6	33555952	.	T	A	10	16	26	0	1	27	0	0
6	33556325	.	A	T	9	13	22	0	1	23	0	0
6	33556441	.	G	A	10	15	25	0	0	25	0	0
6	33556486	.	C	T	6	14	20	0	1	21	0	0
6	33556493	.	A	T	6	18	24	0	1	25	0	0
6	33556730	.	A	G	13	15	28	0	2	30	0	0
6	33556772	.	A	T	12	17	29	0	0	29	0	0
6	33556819	.	G	A	14	15	29	0	0	29	0	0
6	33556835	.	T	C	13	12	25	0	0	25	0	0
6	33556968	.	G	C	9	16	25	0	0	25	0	0
6	33557000	.	A	C	2	0	2	0	10	12	0	0
6	33557006	.	A	C	4	3	7	0	6	13	0	0
6	33557077	.	G	A	2	6	8	0	9	17	0	0
6	33557141	.	G	C	10	12	22	0	0	22	0	0
6	33557227	.	A	G	11	13	24	0	0	24	0	0
6	33557377	.	A	C	11	7	18	0	1	19	0	0
6	33557438	.	T	A	6	6	12	0	1	13	0	0
6	33557562	.	T	G	16	16	32	4	1	37	0	0
6	33558711	.	G	C	9	18	27	0	1	28	0	0
6	33558837	.	C	T	8	9	17	0	0	17	0	0
6	33663690	.	T	C	9	6	15	0	0	15	0	0
6	33663776	.	A	T	15	8	23	0	0	23	0	0
6	33663842	.	T	A	14	14	28	0	2	30	0	0
6	33664182	.	A	G	9	10	19	0	0	19	0	0
6	33664390	.	A	G	8	4	12	0	0	12	0	0
6	33664460	.	A	G	6	4	10	0	0	10	0	0
6	33664518	.	G	A	3	2	5	0	1	6	0	0
6	33664801	.	A	G	9	14	23	0	0	23	0	0
6	33664852	.	T	C	11	9	20	0	0	20	0	0
6	33664899	.	G	A	5	11	16	0	1	17	0	0
6	33664937	.	G	C	5	13	18	0	0	18	0	0
6	33665062	.	A	G	11	7	18	0	2	20	0	0
6	33665097	.	A	G	11	11	22	0	3	25	0	0
6	33665123	.	T	G	19	8	27	0	1	28	0	0
6	33665320	.	G	A	6	5	11	0	0	12	1	0
6	33665327	.	C	T	4	4	8	0	0	8	0	0
6	33665408	.	A	T	5	9	14	0	0	14	0	0
6	33665513	.	C	T	0	10	10	0	14	24	0	0
6	33665578	.	A	T	10	6	16	0	0	16	0	0
6	33665867	.	G	T	6	18	24	0	3	27	0	0
6	33666166	.	G	A	12	11	23	0	0	23	0	0
6	33666250	.	C	A	0	16	16	0	9	25	0	0
6	33666532	.	A	C	17	0	17	0	18	35	0	0
6	33666660	.	A	T	22	18	40	0	1	41	0	0
6	33666715	.	C	A	22	18	40	0	1	41	0	0
6	33666733	.	A	G	26	20	46	0	0	46	0	0
6	33666777	.	C	T	26	15	41	0	2	43	0	0
6	33666871	.	A	T	13	12	25	0	1	26	0	0
6	33666952	.	T	C	9	0	9	0	12	21	0	0
6	33666964	.	G	C	12	0	12	0	9	21	0	0
6	33667006	.	C	T	8	9	17	0	0	17	0	0
6	33667162	.	A	G	7	7	14	0	1	15	0	0
6	33667222	.	G	A	8	13	21	0	3	24	0	0
6	33667252	.	G	C	16	8	24	0	1	25	0	0
6	33667257	.	G	A	16	10	26	0	0	26	0	0
6	33667369	.	G	A	22	14	36	0	0	36	0	0
6	33667435	.	G	A	24	12	36	0	3	39	0	0
6	33667483	.	T	G	11	20	31	0	6	37	0	0
6	33667546	.	G	A	18	16	34	0	0	34	0	0
6	33668681	.	A	G	10	12	22	0	0	22	0	0
6	33669168	.	G	C	12	0	12	0	9	21	0	0
6	33669460	.	A	C	8	3	11	0	0	11	0	0
6	33671910	.	C	T	3	4	7	0	0	7	0	0
6	33672116	.	C	A	6	3	9	0	0	9	0	0
6	33672134	.	A	G	7	3	10	0	0	10	0	0
6	33673964	.	A	G	7	4	11	0	0	11	0	0
6	33683816	.	A	G	6	9	15	0	0	15	0	0
6	33683837	.	G	A	4	10	14	0	0	14	0	0
6	33683882	.	A	G	3	6	9	0	0	9	0	0
6	33683885	.	T	A	3	6	9	0	0	9	0	0
6	33694269	.	G	A	12	7	19	0	0	19	0	0
6	33883580	.	C	T	10	9	19	0	1	20	0	0
6	33883916	.	T	A	25	7	32	0	0	32	0	0
6	33884447	.	G	A	1	22	23	0	18	41	0	0
6	33896399	.	T	A	23	17	40	0	4	44	0	0
6	33896406	.	T	G	20	1	21	0	21	42	0	0
6	33896476	.	T	C	15	26	41	0	1	42	0	0
6	33896508	.	A	T	20	24	44	0	1	45	0	0
6	33896620	.	C	T	15	15	30	0	2	32	0	0
6	33896858	.	T	C	16	17	33	0	1	34	0	0
6	33896975	.	A	C	16	19	35	0	1	36	0	0
6	33897193	.	T	A	11	8	19	0	0	19	0	0
6	33897472	.	T	A	13	9	22	0	2	25	1	0
6	33897766	.	A	T	4	7	11	0	0	11	0	0
6	33910449	.	C	T	1	2	3	0	0	3	0	0
6	33912240	.	G	A	7	9	16	0	0	16	0	0
6	33918916	.	A	G	3	4	7	0	0	7	0	0
6	33921298	.	C	T	5	5	10	0	0	10	0	0
6	33921304	.	T	C	5	6	11	0	0	11	0	0
6	33921511	.	G	A	8	10	18	0	0	18	0	0
6	33921559	.	G	A	8	7	15	0	0	15	0	0
6	33921631	.	A	G	5	2	7	0	0	7	0	0
6	33923900	.	C	T	8	6	14	0	1	15	0	0
6	33925182	.	C	A	2	3	5	0	0	5	0	0
6	33925183	.	A	G	2	3	5	0	0	5	0	0
6	33925345	.	G	A	5	4	9	0	1	10	0	0
6	33927040	.	A	T	7	9	16	0	0	16	0	0
6	33929724	.	G	C	10	6	16	0	0	16	0	0
6	33931582	.	T	C	14	10	24	0	1	25	0	0
6	33984216	.	T	A	3	2	5	0	0	5	0	0
6	34064144	.	C	A	2	0	2	0	2	4	0	0
6	34064161	.	A	G	1	0	1	0	2	3	0	0
6	34072103	.	G	A	1	2	3	0	0	3	0	0
6	34072514	.	A	C	5	2	7	0	0	7	0	0
6	34072517	.	A	T	5	2	7	0	0	7	0	0
6	34512342	.	T	A	2	2	4	0	0	4	0	0
6	34710598	.	C	T	1	2	3	0	0	3	0	0
6	34722611	.	C	T	4	2	6	0	0	6	0	0
6	34767154	.	T	C	4	5	9	0	0	9	0	0
6	34767157	.	T	A	3	5	8	0	0	8	0	0
6	34767193	.	T	C	5	4	9	0	0	9	0	0
6	34767202	.	C	T	5	5	10	0	0	10	0	0
6	34772224	.	T	C	2	4	6	0	0	6	0	0
6	34787495	.	C	G	13	0	13	0	5	18	0	0
6	34787632	.	C	T	7	6	13	0	1	14	0	0
6	34805913	.	C	A	2	2	4	0	0	4	0	0
6	34806257	.	G	A	6	7	13	0	0	13	0	0
6	34806307	.	T	C	6	5	11	0	0	11	0	0
6	34806407	.	G	A	12	6	18	0	0	18	0	0
6	34806450	.	G	T	7	6	13	0	0	13	0	0
6	34806494	.	C	T	6	9	15	0	0	15	0	0
6	34806893	.	A	T	5	5	10	0	0	10	0	0
6	34807576	.	T	C	6	5	11	0	0	11	0	0
6	34807809	.	G	A	4	4	8	0	0	8	0	0
6	34807862	.	T	C	3	3	6	0	0	6	0	0
6	34808517	.	A	G	5	5	10	0	0	10	0	0
6	34808591	.	G	A	10	11	21	0	1	22	0	0
6	34808754	.	C	T	6	10	16	0	0	16	0	0
6	34808821	.	G	A	9	7	16	0	0	16	0	0
6	34808835	.	C	A	6	9	15	0	0	15	0	0
6	34808914	.	C	T	4	7	11	0	1	12	0	0
6	34809040	.	G	A	7	9	16	0	0	16	0	0
6	34809564	.	A	T	7	7	14	0	0	14	0	0
6	34809826	.	C	A	7	11	18	0	2	20	0	0
6	34809850	.	G	T	8	12	20	0	0	20	0	0
6	34810313	.	C	T	20	19	39	0	0	39	0	0
6	34810415	.	A	G	11	0	11	0	13	24	0	0
6	34810490	.	G	A	1	16	17	0	13	30	0	0
6	34810495	.	G	A	2	12	14	0	14	28	0	0
6	34810890	.	T	C	9	4	13	0	0	13	0	0
6	34810908	.	T	C	2	10	12	0	1	13	0	0
6	34811130	.	A	T	4	3	7	0	0	7	0	0
6	34811150	.	A	C	7	4	11	0	0	11	0	0
6	34825910	.	A	C	2	3	5	0	0	5	0	0
6	34826002	.	T	C	3	3	6	0	0	6	0	0
6	34826051	.	T	C	3	2	5	0	0	5	0	0
6	34826598	.	G	A	3	3	6	0	1	7	0	0
6	34826638	.	C	T	5	2	7	0	0	7	0	0
6	34826640	.	C	T	4	3	7	0	0	7	0	0
6	34826711	.	A	T	6	3	9	0	3	12	0	0
6	34826736	.	A	T	5	7	12	0	0	12	0	0
6	34826750	.	C	G	1	6	7	0	5	12	0	0
6	34828893	.	A	T	10	12	22	0	1	23	0	0
6	34847698	.	C	A	1	4	5	0	2	7	0	0
6	34847699	.	G	A	2	3	5	0	1	6	0	0
6	34847761	.	T	A	1	2	3	0	0	3	0	0
6	34851921	.	G	A	2	5	7	0	0	7	0	0
6	34931646	.	G	A	13	7	20	0	0	20	0	0
6	34931911	.	C	T	24	26	50	0	1	51	0	0
6	34931912	.	C	T	24	25	49	0	2	51	0	0
6	34932657	.	G	A	27	28	55	0	1	56	0	0
6	34932927	.	A	T	32	27	59	0	3	62	0	0
6	34934870	.	C	T	6	24	30	0	35	65	0	0
6	34943550	.	A	G	1	2	3	0	0	3	0	0
6	34943683	.	A	T	6	5	11	0	0	11	0	0
6	34943824	.	A	T	2	2	4	0	2	6	0	0
6	34943900	.	A	T	2	2	4	0	1	5	0	0
6	34943938	.	T	C	3	3	6	0	0	6	0	0
6	34947195	.	T	A	6	5	11	0	0	11	0	0
6	35036275	.	A	C	1	2	3	0	1	4	0	0
6	35036520	.	A	G	8	4	12	0	0	12	0	0
6	35046852	.	T	C	6	2	8	0	0	8	0	0
6	35047157	.	G	A	6	5	11	0	0	11	0	0
6	35054984	.	T	G	6	4	10	0	0	10	0	0
6	35058696	.	A	G	4	7	11	0	0	11	0	0
6	35058850	.	A	G	3	7	10	0	0	10	0	0
6	35060985	.	C	A	4	8	12	0	1	13	0	0
6	35061226	.	C	T	3	10	13	0	1	14	0	0
6	35061298	.	T	C	2	6	8	0	0	8	0	0
6	35100461	.	T	A	2	3	5	0	0	5	0	0
6	35100484	.	C	T	0	2	2	0	3	5	0	0
6	35102089	.	C	G	0	4	4	0	3	7	0	0
6	35102535	.	C	T	1	2	3	0	0	3	0	0
6	35136781	.	C	T	0	3	3	0	2	5	0	0
6	35365179	.	T	C	5	6	11	0	1	12	0	0
6	35365185	.	T	A	5	7	12	0	0	12	0	0
6	35365649	.	G	T	1	3	4	0	0	4	0	0
6	35365768	.	C	T	4	5	9	0	0	9	0	0
6	35365785	.	C	G	5	5	10	0	0	10	0	0
6	35365872	.	C	T	13	6	19	0	1	20	0	0
6	35365877	.	C	T	14	6	20	0	0	20	0	0
6	35366253	.	C	T	5	6	11	0	0	11	0	0
6	35366375	.	C	T	4	2	6	0	0	6	0	0
6	35366544	.	A	G	6	3	9	0	1	10	0	0
6	35388874	.	C	T	1	4	5	0	3	8	0	0
6	35389095	.	G	A	6	2	8	0	0	8	0	0
6	35389116	.	T	A	3	3	6	0	1	7	0	0
6	35389181	.	C	A	2	4	6	0	0	6	0	0
6	35389254	.	T	C	2	2	4	0	0	4	0	0
6	35389493	.	C	T	6	4	10	0	0	10	0	0
6	35389696	.	C	T	4	4	8	0	2	10	0	0
6	35389723	.	C	T	4	4	8	0	3	11	0	0
6	35389773	.	G	A	8	6	14	0	0	14	0	0
6	35389826	.	A	G	10	7	17	0	0	17	0	0
6	35389915	.	C	T	0	2	2	0	4	6	0	0
6	35392431	.	G	C	4	3	7	0	0	7	0	0
6	35398617	.	T	C	6	1	7	0	4	11	0	0
6	35401154	.	C	T	2	2	4	0	0	4	0	0
6	35443819	.	G	T	17	5	22	0	0	22	0	0
6	35443822	.	C	T	16	13	29	0	1	30	0	0
6	35443951	.	T	C	25	17	42	0	1	43	0	0
6	35443960	.	C	T	5	11	16	0	30	46	0	0
6	35444467	.	G	A	32	22	54	0	2	56	0	0
6	35461688	.	T	C	3	3	6	0	0	6	0	0
6	35462087	.	G	A	18	11	29	0	0	29	0	0
6	35462088	.	A	G	19	11	30	0	1	31	0	0
6	35462134	.	G	A	19	8	27	4	2	33	0	0
6	35462186	.	A	G	20	12	32	0	2	34	0	0
6	35462470	.	G	A	14	19	33	0	3	36	0	0
6	35472834	.	C	T	18	16	34	0	1	35	0	0
6	35472858	.	G	T	15	19	34	0	0	34	0	0
6	35676724	.	C	T	16	8	24	0	0	24	0	0
6	35676784	.	A	G	12	10	22	0	0	22	0	0
6	35677534	.	T	A	9	10	19	0	0	19	0	0
6	35688251	.	T	C	11	0	11	0	5	16	0	0
6	35718058	.	T	C	8	12	20	0	1	21	0	0
6	35738430	.	C	A	1	7	8	0	11	19	0	0
6	36129066	.	A	G	2	4	6	0	0	6	0	0
6	36129135	.	T	A	1	3	4	0	1	5	0	0
6	36129565	.	C	T	0	6	6	0	9	15	0	0
6	36129580	.	G	A	11	7	18	0	0	18	0	0
6	36129601	.	G	A	10	6	16	0	0	16	0	0
6	36130351	.	T	A	5	6	11	0	1	12	0	0
6	36130358	.	A	C	7	4	11	0	0	11	0	0
6	36131055	.	A	G	7	3	10	0	1	11	0	0
6	36131097	.	A	C	6	1	7	0	3	10	0	0
6	36131376	.	A	G	7	3	10	0	2	12	0	0
6	36131538	.	C	T	0	12	12	0	9	21	0	0
6	36131876	.	G	A	7	3	10	0	0	10	0	0
6	36131937	.	G	A	3	7	10	0	0	10	0	0
6	36136977	.	A	G	2	6	8	0	0	8	0	0
6	36157011	.	T	C	6	0	6	0	3	9	0	0
6	36178531	.	A	G	4	8	12	0	1	13	0	0
6	36197454	.	G	A	3	5	8	0	0	8	0	0
6	36284427	.	C	T	1	5	6	0	0	6	0	0
6	36468692	.	T	A	1	3	4	0	0	4	0	0
6	36470765	.	T	A	3	0	3	0	0	3	0	0
6	36552168	.	G	A	1	2	3	0	0	3	0	0
6	36552508	.	A	G	15	11	26	0	0	26	0	0
6	36720006	.	G	A	1	3	4	0	1	5	0	0
6	36720457	.	C	T	8	8	16	0	0	16	0	0
6	36720936	.	C	T	10	8	18	0	0	18	0	0
6	36721061	.	T	A	21	20	41	0	0	41	0	0
6	36721066	.	G	T	20	19	39	0	1	41	1	0
6	36721125	.	A	T	14	17	31	0	0	31	0	0
6	36721159	.	A	T	19	17	36	0	4	40	0	0
6	36721339	.	G	T	24	18	42	0	0	42	0	0
6	36721366	.	G	A	28	25	53	0	0	53	0	0
6	36721380	.	C	G	21	30	51	0	0	51	0	0
6	36724345	.	A	G	21	21	42	0	2	44	0	0
6	36724375	.	G	A	20	22	42	0	1	43	0	0
6	37163932	.	T	C	22	19	41	0	0	41	0	0
6	37163943	.	C	T	20	18	38	0	1	39	0	0
6	37164060	.	T	C	21	18	39	0	2	41	0	0
6	37164173	.	T	G	24	18	42	0	0	42	0	0
6	37301386	.	G	A	2	2	4	0	0	4	0	0
6	37301438	.	G	T	23	8	31	0	0	31	0	0
6	37301458	.	A	G	25	10	35	0	1	36	0	0
6	37301479	.	A	T	29	9	38	0	1	39	0	0
6	37305142	.	A	C	13	13	26	0	0	26	0	0
6	37305368	.	A	G	6	0	6	0	4	10	0	0
6	37305383	.	A	G	8	4	12	0	0	12	0	0
6	37305470	.	G	A	7	4	11	0	0	11	0	0
6	37305532	.	G	T	7	6	13	0	0	13	0	0
6	37305539	.	G	T	7	7	14	0	0	14	0	0
6	37306620	.	A	T	25	8	33	0	1	34	0	0
6	37306827	.	C	T	10	16	26	0	0	26	0	0
6	37307034	.	C	T	3	6	9	1	3	13	0	0
6	37309501	.	A	G	1	0	1	0	2	3	0	0
6	37409738	.	C	T	11	10	21	0	0	21	0	0
6	37409986	.	C	T	3	9	12	0	1	13	0	0
6	37410029	.	A	G	8	10	18	0	1	19	0	0
6	37410047	.	C	T	9	12	21	0	1	22	0	0
6	37410119	.	C	T	6	11	17	0	1	18	0	0
6	37417345	.	T	A	8	6	14	1	0	15	0	0
6	37419449	.	G	A	8	8	16	0	1	17	0	0
6	37419479	.	G	A	8	7	15	0	0	15	0	0
6	37419491	.	A	T	6	6	12	0	1	13	0	0
6	37420172	.	A	C	6	2	8	0	3	11	0	0
6	37421038	.	C	A	0	5	5	0	7	12	0	0
6	37422787	.	A	G	13	7	20	0	0	20	0	0
6	37431386	.	A	T	4	2	6	0	0	6	0	0
6	37431476	.	T	G	1	6	7	0	0	7	0	0
6	37431532	.	G	C	3	9	12	0	1	13	0	0
6	37431592	.	C	T	3	4	7	0	0	7	0	0
6	37431649	.	T	C	3	9	12	0	2	14	0	0
6	37438497	.	T	A	2	9	11	0	0	11	0	0
6	37440068	.	G	A	5	5	10	0	0	10	0	0
6	37440302	.	A	G	5	4	9	0	0	9	0	0
6	37440515	.	G	T	4	7	11	0	0	11	0	0
6	37440547	.	T	A	4	3	7	0	1	8	0	0
6	37441474	.	T	C	6	10	16	0	0	16	0	0
6	37441492	.	G	A	3	8	11	0	0	11	0	0
6	37441823	.	G	T	0	2	2	0	1	3	0	0
6	37442006	.	T	C	3	2	5	0	0	5	0	0
6	37442821	.	G	A	3	3	6	0	0	6	0	0
6	37443945	.	T	C	3	6	9	0	0	9	0	0
6	37445258	.	T	A	4	3	7	0	0	7	0	0
6	37445357	.	T	C	4	6	10	0	1	11	0	0
6	37454707	.	G	A	1	3	4	0	0	4	0	0
6	37460889	.	C	T	3	2	5	0	0	5	0	0
6	37461072	.	C	T	1	3	4	0	0	4	0	0
6	37461661	.	G	A	4	6	10	0	1	11	0	0
6	37461662	.	T	A	5	6	11	0	0	11	0	0
6	37469295	.	T	G	4	3	7	0	0	7	0	0
6	37469418	.	G	T	1	3	4	0	0	4	0	0
6	37469571	.	C	A	0	2	2	0	3	5	0	0
6	37469637	.	C	A	2	3	5	0	0	5	0	0
6	37478859	.	G	A	3	6	9	0	1	10	0	0
6	37478878	.	G	A	1	6	7	0	1	8	0	0
6	37478905	.	G	A	3	6	9	0	1	10	0	0
6	37479506	.	G	A	7	6	13	0	0	13	0	0
6	37479563	.	C	G	1	6	7	0	1	8	0	0
6	37479578	.	G	A	3	6	9	0	0	9	0	0
6	37479779	.	A	C	10	10	20	0	0	20	0	0
6	37479785	.	A	C	10	10	20	0	0	20	0	0
6	37479910	.	T	G	10	5	15	0	0	15	0	0
6	37479932	.	G	A	11	6	17	0	1	18	0	0
6	37479998	.	A	G	9	8	17	0	0	17	0	0
6	37480028	.	A	G	8	6	14	0	2	16	0	0
6	37480100	.	T	A	3	3	6	0	0	6	0	0
6	37485828	.	G	A	3	2	5	0	0	5	0	0
6	37489092	.	C	G	3	3	6	0	0	6	0	0
6	37495117	.	G	A	3	5	8	0	0	8	0	0
6	37495147	.	G	A	2	3	5	0	0	5	0	0
6	37498477	.	A	G	2	3	5	0	0	5	0	0
6	37499562	.	A	C	4	2	6	0	0	6	0	0
6	37515300	.	C	T	2	3	5	0	2	7	0	0
6	37515353	.	T	A	7	3	10	0	0	10	0	0
6	37521529	.	A	T	5	7	12	0	2	14	0	0
6	37521594	.	C	A	12	6	18	0	1	19	0	0
6	37521778	.	G	A	4	6	10	0	0	10	0	0
6	37525748	.	G	A	7	4	11	0	0	11	0	0
6	37529504	.	C	A	21	17	38	0	6	44	0	0
6	37548605	.	T	C	10	16	26	0	2	28	0	0
6	37548897	.	C	T	23	16	39	0	0	39	0	0
6	37551165	.	G	A	1	14	15	0	17	32	0	0
6	37551548	.	T	C	22	18	40	0	0	40	0	0
6	37552621	.	C	T	21	21	42	0	1	43	0	0
6	37554293	.	C	T	20	15	35	0	2	37	0	0
6	37598966	.	C	T	20	16	36	0	2	38	0	0
6	37599293	.	C	T	13	9	22	0	0	22	0	0
6	37599406	.	G	A	14	15	29	0	0	29	0	0
6	37599499	.	G	T	11	18	29	0	0	29	0	0
6	37599687	.	A	T	22	15	37	1	0	38	0	0
6	37599937	.	T	G	14	16	30	0	2	32	0	0
6	37599954	.	C	T	15	13	28	0	0	28	0	0
6	37600210	.	G	A	0	21	21	1	15	37	0	0
6	37600233	.	G	A	12	27	39	1	0	40	0	0
6	37600539	.	G	A	0	8	8	0	1	9	0	0
6	37600544	.	T	A	1	7	8	0	0	8	0	0
6	37604105	.	T	C	3	0	3	0	4	7	0	0
6	37604146	.	G	A	2	2	4	0	0	4	0	0
6	37604152	.	C	T	1	3	4	0	1	5	0	0
6	37604311	.	C	A	6	3	9	0	0	9	0	0
6	37604410	.	T	A	5	9	14	0	0	14	0	0
6	37604547	.	A	G	10	7	17	0	0	17	0	0
6	37604724	.	G	A	12	10	22	0	1	23	0	0
6	37604866	.	A	C	10	12	22	0	3	25	0	0
6	37621150	.	T	C	4	7	11	0	0	11	0	0
6	37621204	.	A	G	4	8	12	0	0	12	0	0
6	37621213	.	A	G	5	9	14	0	0	14	0	0
6	37621918	.	A	G	8	7	15	0	1	16	0	0
6	37622089	.	C	T	0	11	11	0	9	20	0	0
6	37626084	.	T	A	1	6	7	0	3	10	0	0
6	37627004	.	A	G	5	9	14	0	0	14	0	0
6	37627114	.	G	A	6	7	13	0	0	13	0	0
6	37627141	.	C	A	7	6	13	0	1	14	0	0
6	37628973	.	G	A	6	9	15	0	0	15	0	0
6	37628991	.	C	T	6	9	15	0	1	16	0	0
6	37629402	.	A	G	7	0	7	0	7	14	0	0
6	37631456	.	A	G	7	10	17	0	0	17	0	0
6	37632921	.	G	A	8	8	16	0	1	17	0	0
6	37632963	.	A	G	5	0	5	0	7	12	0	0
6	37632966	.	C	T	4	7	11	0	0	11	0	0
6	37633005	.	C	A	4	7	11	0	1	12	0	0
6	37633549	.	G	A	1	6	7	0	7	14	0	0
6	37635589	.	G	A	2	10	12	0	1	13	0	0
6	37635595	.	C	A	3	10	13	0	0	13	0	0
6	37635649	.	T	C	2	10	12	0	0	12	0	0
6	37637987	.	G	A	3	9	12	0	1	13	0	0
6	37651619	.	T	C	9	9	18	0	0	18	0	0
6	37692164	.	C	T	1	2	3	0	0	3	0	0
6	37728484	.	T	C	3	4	7	0	0	7	0	0
6	37728496	.	T	C	2	4	6	0	1	7	0	0
6	37730423	.	G	T	3	6	9	0	0	9	0	0
6	37730520	.	C	T	7	2	9	0	0	9	0	0
6	37730527	.	C	T	3	7	10	0	0	10	0	0
6	37733992	.	G	A	8	3	11	0	0	11	0	0
6	37737188	.	C	A	8	3	11	0	1	12	0	0
6	37743373	.	C	G	5	3	8	0	1	9	0	0
6	37743456	.	T	C	7	0	7	0	5	12	0	0
6	37744304	.	C	A	7	8	15	0	0	15	0	0
6	37746085	.	C	T	3	3	6	0	0	6	0	0
6	37746099	.	G	A	3	3	6	0	0	6	0	0
6	37752838	.	A	G	4	6	10	0	0	10	0	0
6	37754825	.	C	T	6	5	11	0	0	11	0	0
6	37757883	.	G	A	5	2	7	0	0	7	0	0
6	37771609	.	T	C	2	5	7	0	0	7	0	0
6	37772400	.	C	T	6	5	11	0	0	11	0	0
6	37772406	.	A	G	5	5	10	0	0	10	0	0
6	37775562	.	G	A	0	5	5	0	6	11	0	0
6	37784031	.	A	G	7	0	7	0	4	11	0	0
6	37786017	.	T	C	3	2	5	0	0	5	0	0
6	37792602	.	A	T	4	5	9	0	1	10	0	0
6	37794637	.	C	A	5	7	12	0	0	12	0	0
6	37796222	.	G	C	7	5	12	0	0	12	0	0
6	37797710	.	G	A	7	5	12	0	1	13	0	0
6	37800824	.	G	A	1	7	8	0	5	13	0	0
6	37801954	.	A	G	7	0	7	0	9	16	0	0
6	37808238	.	G	A	0	10	10	0	13	23	0	0
6	37808262	.	G	C	1	7	8	0	14	22	0	0
6	37808349	.	G	A	3	4	7	0	0	7	0	0
6	37809918	.	C	T	7	9	16	0	0	16	0	0
6	37810029	.	T	C	11	4	15	0	0	15	0	0
6	37810256	.	C	T	5	8	13	0	0	13	0	0
6	37812199	.	A	G	6	8	14	0	0	14	0	0
6	37812271	.	G	A	0	4	4	0	10	14	0	0
6	37815348	.	C	G	7	4	11	0	0	12	1	0
6	37815525	.	T	C	10	5	15	0	0	15	0	0
6	37815621	.	T	G	12	6	18	0	0	18	0	0
6	37815799	.	C	T	2	7	9	0	0	9	0	0
6	37818324	.	A	C	10	9	19	0	2	21	0	0
6	37818327	.	G	A	12	9	21	0	0	21	0	0
6	37820306	.	C	T	10	13	23	0	1	24	0	0
6	37820960	.	T	C	11	15	26	0	0	26	0	0
6	37821169	.	G	T	1	5	6	0	10	16	0	0
6	37824355	.	G	T	7	14	21	0	0	21	0	0
6	37824645	.	T	C	12	8	20	0	1	21	0	0
6	37825508	.	T	G	13	0	13	0	9	22	0	0
6	37829585	.	G	A	13	11	24	0	1	25	0	0
6	37829613	.	T	C	11	16	27	0	1	28	0	0
6	37830742	.	A	T	20	11	31	0	1	32	0	0
6	37830784	.	C	T	19	15	34	0	0	34	0	0
6	37830811	.	C	T	14	19	33	0	1	34	0	0
6	37832947	.	C	T	21	10	31	0	2	33	0	0
6	37832953	.	G	A	18	14	32	0	2	34	0	0
6	37833493	.	T	C	19	11	30	0	1	31	0	0
6	37835767	.	T	C	22	16	38	0	0	38	0	0
6	37835797	.	C	T	15	23	38	0	0	38	0	0
6	37836387	.	G	A	24	13	37	0	3	40	0	0
6	37841100	.	C	T	14	8	22	0	1	23	0	0
6	37846026	.	C	T	29	20	49	0	1	50	0	0
6	38149601	.	A	G	1	3	4	0	0	4	0	0
6	38357666	.	T	A	2	2	4	0	0	4	0	0
6	38367062	.	G	C	18	0	18	0	19	37	0	0
6	38367107	.	T	C	16	16	32	0	1	33	0	0
6	38375020	.	G	A	21	15	36	0	1	37	0	0
6	38381094	.	G	A	13	7	20	0	1	21	0	0
6	38415315	.	G	A	11	13	24	0	0	24	0	0
6	38415385	.	A	G	12	17	29	0	2	31	0	0
6	38426875	.	A	T	4	6	10	0	0	10	0	0
6	38427427	.	G	A	7	5	12	0	1	13	0	0
6	38427515	.	A	T	3	10	13	0	0	13	0	0
6	38477019	.	G	T	16	15	31	0	1	32	0	0
6	38503673	.	C	T	17	11	28	1	0	29	0	0
6	38511604	.	G	A	14	18	32	0	0	32	0	0
6	38511739	.	C	T	10	10	20	0	0	20	0	0
6	38511921	.	T	C	10	6	16	0	0	16	0	0
6	38511967	.	A	T	7	9	16	0	1	17	0	0
6	38512160	.	T	C	13	11	24	0	1	25	0	0
6	38512178	.	G	A	17	14	31	0	1	32	0	0
6	38512236	.	C	T	15	17	32	0	3	35	0	0
6	38512629	.	C	T	15	12	27	0	3	30	0	0
6	38513231	.	C	T	9	13	22	1	2	25	0	0
6	38778327	.	T	C	4	4	8	0	0	8	0	0
6	38782025	.	C	T	11	11	22	0	0	22	0	0
6	38782439	.	C	A	10	6	16	0	0	16	0	0
6	38782442	.	C	T	11	4	15	0	1	16	0	0
6	38782511	.	A	G	10	6	16	0	0	16	0	0
6	38782794	.	C	T	10	6	16	0	0	16	0	0
6	38782799	.	T	A	12	5	17	0	1	18	0	0
6	38783002	.	T	A	2	6	8	0	0	8	0	0
6	38783044	.	T	A	2	8	10	0	0	10	0	0
6	38786301	.	G	A	2	4	6	0	3	10	1	0
6	38786622	.	C	A	12	8	20	0	0	20	0	0
6	38789065	.	C	A	16	8	24	0	1	25	0	0
6	38789292	.	C	T	10	11	21	0	1	22	0	0
6	38789317	.	C	T	9	12	21	0	0	21	0	0
6	38789507	.	A	T	6	8	14	0	0	14	0	0
6	38789583	.	G	C	14	12	26	0	2	28	0	0
6	38789733	.	A	G	13	8	21	0	3	24	0	0
6	38789832	.	A	G	13	10	23	0	0	23	0	0
6	38789853	.	T	A	13	9	22	0	1	23	0	0
6	38845817	.	T	C	9	4	13	0	1	14	0	0
6	38845865	.	G	A	13	5	18	0	0	18	0	0
6	38845943	.	C	G	6	12	18	0	1	19	0	0
6	38845964	.	A	G	3	11	14	0	0	14	0	0
6	38845986	.	A	G	2	1	3	0	6	9	0	0
6	38846240	.	A	G	4	5	9	2	0	11	0	0
6	38858036	.	G	T	2	10	12	0	10	22	0	0
6	38858558	.	T	A	3	4	7	0	0	7	0	0
6	38858784	.	T	G	8	6	14	0	1	15	0	0
6	38858832	.	T	G	9	6	15	0	0	15	0	0
6	38859796	.	T	A	5	6	11	0	0	11	0	0
6	38860293	.	C	G	6	3	9	0	1	10	0	0
6	38860362	.	T	A	4	4	8	0	0	8	0	0
6	38860421	.	C	T	4	4	8	0	0	8	0	0
6	38860815	.	A	G	1	12	13	0	0	13	0	0
6	38860823	.	C	T	2	14	16	0	0	16	0	0
6	38860898	.	T	C	8	14	22	0	2	24	0	0
6	38860905	.	C	T	8	15	23	0	0	23	0	0
6	38860981	.	T	C	5	9	14	0	1	15	0	0
6	38860985	.	T	G	5	11	16	0	0	16	0	0
6	38861020	.	G	A	7	12	19	0	0	19	0	0
6	38861035	.	C	A	9	8	17	0	0	17	0	0
6	38896523	.	T	C	9	9	18	0	2	20	0	0
6	38899123	.	T	C	6	6	12	0	0	12	0	0
6	38901991	.	T	C	5	7	12	0	0	12	0	0
6	38902291	.	T	A	6	4	10	0	0	10	0	0
6	38902329	.	C	T	4	2	6	0	0	6	0	0
6	38955236	.	A	G	1	2	3	0	0	3	0	0
6	39075254	.	A	C	15	10	25	0	0	26	1	0
6	39075513	.	G	A	18	13	31	0	0	31	0	0
6	39077308	.	G	C	24	8	32	0	1	33	0	0
6	39077364	.	C	T	9	5	14	0	0	14	0	0
6	39123923	.	C	A	5	4	9	0	0	9	0	0
6	39124288	.	C	A	4	7	11	0	1	12	0	0
6	39124304	.	A	C	4	7	11	0	0	11	0	0
6	39124688	.	C	T	1	3	4	0	4	8	0	0
6	39124784	.	T	A	8	4	12	1	0	14	1	0
6	39124789	.	C	A	9	4	13	1	0	14	0	0
6	39125228	.	G	A	3	2	5	0	0	5	0	0
6	39125296	.	C	T	3	3	6	0	0	6	0	0
6	39125609	.	A	C	2	5	7	0	0	7	0	0
6	39125626	.	G	A	3	3	6	0	0	6	0	0
6	39125746	.	A	C	2	5	7	0	0	7	0	0
6	39126503	.	G	A	3	4	7	0	0	7	0	0
6	39126533	.	C	T	0	2	2	0	5	7	0	0
6	39126884	.	C	T	1	4	5	0	3	8	0	0
6	39127005	.	A	T	5	2	7	0	0	7	0	0
6	39127012	.	A	T	5	3	8	0	1	9	0	0
6	39127231	.	G	C	5	4	9	0	0	9	0	0
6	39127340	.	G	A	3	4	7	0	0	7	0	0
6	39136487	.	A	G	5	3	8	0	0	8	0	0
6	39141303	.	C	T	2	7	9	0	0	9	0	0
6	39160327	.	C	T	3	6	9	0	1	10	0	0
6	39160328	.	A	G	3	7	10	0	0	10	0	0
6	39162488	.	C	A	2	4	6	0	0	6	0	0
6	39162491	.	C	G	2	2	4	0	1	5	0	0
6	39162607	.	C	T	13	9	22	0	0	22	0	0
6	39162718	.	A	T	3	11	14	0	0	15	1	0
6	39162756	.	T	A	6	11	17	0	0	17	0	0
6	39162855	.	C	T	10	6	16	0	0	16	0	0
6	39162896	.	G	A	6	10	16	0	0	16	0	0
6	39163058	.	T	A	6	5	11	3	0	14	0	0
6	39163286	.	G	A	9	5	14	0	0	14	0	0
6	39163363	.	A	T	8	3	11	0	0	11	0	0
6	39163657	.	T	G	11	5	16	0	0	16	0	0
6	39163876	.	A	G	2	10	12	0	0	12	0	0
6	39164046	.	T	G	9	7	16	0	0	16	0	0
6	40661853	.	T	C	5	2	7	0	0	7	0	0
6	40708523	.	G	A	6	2	8	0	0	8	0	0
6	40770883	.	T	A	17	4	21	0	0	21	0	0
6	41435866	.	A	G	31	27	58	0	1	59	0	0
6	42038693	.	C	A	5	3	8	0	0	8	0	0
6	42657181	.	G	C	4	2	6	0	0	6	0	0
6	44007178	.	C	A	8	2	10	0	0	10	0	0
6	46425620	.	A	G	1	17	18	0	0	18	0	0
6	46737244	.	T	A	1	1	2	0	0	2	0	0
6	47833071	.	C	T	1	6	7	0	1	8	0	0
6	48163738	.	G	T	5	5	10	0	0	10	0	0
6	48172890	.	C	T	6	3	9	0	0	9	0	0
6	48181994	.	A	C	11	8	19	0	0	19	0	0
6	48182033	.	A	G	11	0	11	0	11	22	0	0
6	48182090	.	T	A	11	8	19	0	2	21	0	0
6	48182720	.	A	G	3	0	3	0	10	13	0	0
6	48193191	.	T	C	8	10	18	0	0	18	0	0
6	48193426	.	T	C	6	4	10	0	0	10	0	0
6	48195610	.	G	C	11	4	15	0	1	16	0	0
6	48198255	.	T	A	7	10	17	0	1	18	0	0
6	48198431	.	T	C	12	10	22	1	1	24	0	0
6	48198533	.	C	G	9	8	17	0	0	17	0	0
6	48198718	.	C	A	9	3	12	0	0	12	0	0
6	48198883	.	G	A	6	6	12	0	0	12	0	0
6	48198892	.	A	T	6	7	13	0	0	13	0	0
6	48199068	.	G	A	8	7	15	0	1	16	0	0
6	48241389	.	C	T	1	2	3	0	0	3	0	0
6	48383714	.	T	A	3	5	8	0	1	9	0	0
6	49108078	.	T	C	13	6	19	0	0	19	0	0
6	49108157	.	T	C	10	5	15	0	0	15	0	0
6	49529037	.	C	T	2	2	4	0	0	4	0	0
6	49636508	.	T	A	0	20	20	1	1	22	0	0
6	49738923	.	A	G	12	4	16	3	0	19	0	0
6	50581320	.	C	G	0	13	13	0	4	17	0	0
6	50581579	.	C	T	13	5	18	0	0	18	0	0
6	50581589	.	G	A	11	4	15	0	0	15	0	0
6	50590597	.	C	T	7	7	14	0	0	14	0	0
6	50594126	.	C	T	0	11	11	0	8	19	0	0
6	50596189	.	T	C	10	2	12	0	5	17	0	0
6	50617026	.	C	T	0	5	5	0	7	12	0	0
6	50685346	.	T	C	4	3	7	0	0	7	0	0
6	50695455	.	T	C	4	0	4	0	8	12	0	0
6	50695470	.	C	T	3	5	8	0	0	8	0	0
6	50695625	.	A	G	4	2	6	0	0	6	0	0
6	50695857	.	G	A	5	8	13	0	1	14	0	0
6	50695890	.	T	C	9	0	9	0	6	15	0	0
6	50696328	.	C	T	3	5	8	0	0	8	0	0
6	50696376	.	A	G	5	5	10	0	0	10	0	0
6	50696532	.	A	T	4	5	9	0	0	9	0	0
6	50698791	.	T	C	2	7	9	0	0	9	0	0
6	50701168	.	C	T	8	8	16	0	0	16	0	0
6	50704598	.	G	A	10	3	13	0	0	13	0	0
6	50704605	.	A	T	14	4	18	0	0	18	0	0
6	50713800	.	T	A	2	4	6	0	0	6	0	0
6	50713804	.	G	A	2	5	7	0	0	7	0	0
6	50713997	.	T	A	3	2	5	0	0	5	0	0
6	50714039	.	A	T	3	3	6	0	0	6	0	0
6	50714196	.	T	G	2	3	5	0	2	7	0	0
6	50714358	.	G	C	3	11	14	0	0	14	0	0
6	50721807	.	C	T	2	3	5	0	7	12	0	0
6	51010098	.	T	A	10	13	23	0	0	23	0	0
6	51010126	.	G	A	11	13	24	0	1	25	0	0
6	51010143	.	T	A	12	12	24	0	1	25	0	0
6	51021107	.	C	T	0	9	9	0	7	16	0	0
6	51034674	.	G	A	4	2	6	0	0	6	0	0
6	51045271	.	C	T	13	12	25	0	1	26	0	0
6	51045352	.	G	C	10	11	21	1	0	22	0	0
6	51054620	.	C	T	8	14	22	0	2	24	0	0
6	51064869	.	C	T	10	7	17	1	0	18	0	0
6	51086166	.	G	A	11	14	25	0	2	27	0	0
6	51161255	.	T	A	16	8	24	0	0	24	0	0
6	51161306	.	A	T	8	9	17	1	0	18	0	0
6	51202858	.	A	G	9	4	13	0	0	13	0	0
6	51202901	.	A	G	11	9	20	0	1	21	0	0
6	51277499	.	G	T	4	5	9	0	0	9	0	0
6	51321555	.	A	T	4	2	6	0	0	6	0	0
6	51328737	.	G	A	8	9	17	0	1	18	0	0
6	51529336	.	A	G	2	3	5	0	0	5	0	0
6	51529393	.	C	T	8	7	15	0	1	16	0	0
6	51529725	.	G	A	6	4	10	0	1	11	0	0
6	51529747	.	A	C	4	5	9	0	0	9	0	0
6	51530973	.	G	A	2	4	6	0	0	6	0	0
6	51530979	.	G	A	2	3	5	0	0	5	0	0
6	51531046	.	C	A	2	8	10	0	0	10	0	0
6	51531104	.	T	C	2	3	5	0	0	5	0	0
6	51531155	.	C	T	1	2	3	0	0	3	0	0
6	51531195	.	C	A	1	2	3	0	0	3	0	0
6	51532015	.	C	T	1	2	3	0	4	7	0	0
6	51538326	.	A	G	3	2	5	0	0	5	0	0
6	51541002	.	G	T	7	7	14	0	0	14	0	0
6	51541166	.	A	C	10	3	13	0	1	14	0	0
6	51541255	.	A	T	5	7	12	0	2	14	0	0
6	51541258	.	G	A	8	6	14	0	1	15	0	0
6	51552341	.	G	A	4	3	7	0	0	7	0	0
6	51552347	.	G	A	3	3	6	0	0	6	0	0
6	51556260	.	A	G	2	3	5	0	0	5	0	0
6	51557866	.	A	T	1	2	3	1	0	4	0	0
6	51576035	.	A	C	4	5	9	0	0	9	0	0
6	51576055	.	A	T	6	8	14	0	1	15	0	0
6	51576177	.	T	G	10	15	25	0	1	26	0	0
6	51577365	.	A	T	10	4	14	0	0	14	0	0
6	51577938	.	T	A	8	9	17	0	0	17	0	0
6	51578224	.	A	G	9	12	21	0	1	22	0	0
6	51578684	.	C	T	0	9	9	0	4	13	0	0
6	51579196	.	C	A	11	3	14	0	0	14	0	0
6	51579271	.	G	A	3	9	12	0	0	12	0	0
6	51579298	.	T	C	2	8	10	0	2	12	0	0
6	51579538	.	A	T	6	6	12	0	1	13	0	0
6	51579840	.	C	T	4	5	9	0	1	10	0	0
6	51579901	.	G	A	9	6	15	0	2	17	0	0
6	51580373	.	G	A	6	8	14	0	0	14	0	0
6	51580457	.	G	A	10	11	21	0	1	22	0	0
6	51583877	.	T	C	9	6	15	0	0	15	0	0
6	51586559	.	C	T	1	10	11	1	11	23	0	0
6	51591176	.	C	T	6	4	10	0	2	12	0	0
6	51592403	.	T	C	7	4	11	0	0	11	0	0
6	51592538	.	C	T	14	8	22	0	2	24	0	0
6	51594323	.	T	C	10	7	17	0	1	18	0	0
6	51594542	.	C	T	5	3	8	0	0	8	0	0
6	51594884	.	T	C	2	8	10	0	1	11	0	0
6	51595043	.	C	T	1	10	11	0	6	17	0	0
6	51595052	.	A	G	5	8	13	0	1	14	0	0
6	51595124	.	G	A	2	8	10	0	0	10	0	0
6	51595259	.	T	C	7	0	7	0	5	12	0	0
6	51595484	.	G	T	6	10	16	0	0	16	0	0
6	51595679	.	T	C	8	0	8	0	6	14	0	0
6	51596000	.	T	C	6	2	8	0	0	8	0	0
6	51598123	.	C	A	10	6	16	0	2	18	0	0
6	51598153	.	T	G	8	9	17	0	0	17	0	0
6	51599855	.	C	A	4	6	10	0	0	10	0	0
6	51601868	.	C	A	9	4	13	0	0	13	0	0
6	51601898	.	G	A	7	6	13	0	0	13	0	0
6	51605080	.	G	A	6	6	12	0	0	12	0	0
6	51605463	.	A	G	4	4	8	0	0	8	0	0
6	51615523	.	T	C	6	3	9	0	1	10	0	0
6	51615532	.	T	C	7	3	10	0	0	10	0	0
6	51631055	.	G	T	1	3	4	0	0	4	0	0
6	51631098	.	A	C	7	3	10	0	1	11	0	0
6	51666397	.	C	A	4	2	6	0	0	6	0	0
6	51796672	.	T	C	15	1	16	0	19	35	0	0
6	51796714	.	T	A	14	16	30	0	0	30	0	0
6	51797732	.	A	G	14	14	28	0	2	30	0	0
6	51797741	.	C	T	1	13	14	0	17	31	0	0
6	51806186	.	T	A	13	16	29	0	3	32	0	0
6	51806238	.	T	G	11	9	20	0	3	23	0	0
6	51808819	.	C	T	17	11	28	0	0	28	0	0
6	51808983	.	T	G	15	17	32	0	1	33	0	0
6	51809065	.	T	A	12	13	25	0	1	26	0	0
6	51810855	.	T	G	11	4	15	0	1	16	0	0
6	51810987	.	T	G	8	17	25	0	1	26	0	0
6	51811024	.	T	C	22	10	32	0	0	32	0	0
6	51932372	.	T	C	2	3	5	0	0	5	0	0
6	51932408	.	G	A	1	2	3	0	0	3	0	0
6	52024437	.	G	C	1	5	6	0	0	6	0	0
6	52024481	.	G	A	0	5	5	0	3	8	0	0
6	52024493	.	C	T	3	3	6	0	0	6	0	0
6	52030374	.	C	T	1	2	3	0	0	3	0	0
6	52081983	.	C	A	9	9	18	0	1	19	0	0
6	52082262	.	A	G	4	7	11	0	0	11	0	0
6	52082324	.	G	A	10	6	16	0	1	17	0	0
6	52082328	.	A	T	11	6	17	0	0	17	0	0
6	52082361	.	A	T	12	7	19	0	0	19	0	0
6	52082832	.	A	G	14	12	26	0	1	27	0	0
6	52082880	.	G	A	17	14	31	0	2	33	0	0
6	52089379	.	T	C	9	0	9	0	7	16	0	0
6	52119079	.	T	C	11	0	11	0	11	22	0	0
6	52220316	.	G	A	3	28	31	0	43	74	0	0
6	52222481	.	G	T	44	38	82	0	4	86	0	0
6	52222564	.	C	T	41	41	82	0	4	86	0	0
6	52222654	.	G	A	4	34	38	0	35	73	0	0
6	52223247	.	G	A	5	32	37	0	33	70	0	0
6	52223369	.	T	C	36	25	61	0	0	61	0	0
6	52224090	.	A	G	26	14	40	0	0	40	0	0
6	52224147	.	A	G	4	37	41	5	1	47	0	0
6	52224158	.	A	G	25	13	38	3	1	43	1	0
6	52224376	.	T	C	55	12	67	2	3	73	1	0
6	52224590	.	A	G	35	22	57	2	1	60	0	0
6	52227301	.	G	A	7	3	10	0	0	10	0	0
6	52234251	.	G	A	2	5	7	0	1	8	0	0
6	52247876	.	T	G	0	0	0	1	5	6	0	0
6	52247883	.	G	T	1	4	5	1	0	6	0	0
6	52248478	.	G	A	3	15	18	0	9	27	0	0
6	52249075	.	C	A	3	2	5	0	0	5	0	0
6	52263355	.	C	A	1	2	3	0	0	3	0	0
6	52317262	.	A	T	1	3	4	0	0	4	0	0
6	52318249	.	A	G	6	5	11	0	0	11	0	0
6	52321944	.	A	G	3	0	3	0	6	9	0	0
6	52321959	.	G	C	2	6	8	0	0	8	0	0
6	52323648	.	G	A	1	5	6	0	6	12	0	0
6	52323967	.	G	A	0	4	4	0	5	9	0	0
6	52326474	.	C	T	3	4	7	0	0	7	0	0
6	52331937	.	T	A	3	2	5	0	0	5	0	0
6	52332506	.	C	T	6	3	9	0	2	11	0	0
6	52339605	.	C	T	2	6	8	0	0	8	0	0
6	52341721	.	G	A	13	5	18	0	1	19	0	0
6	52341742	.	A	G	11	8	19	0	0	19	0	0
6	52352028	.	G	T	10	3	13	0	0	13	0	0
6	52352544	.	A	T	5	3	8	0	0	8	0	0
6	52352570	.	T	C	3	4	7	0	1	8	0	0
6	52352636	.	G	A	1	3	4	0	1	5	0	0
6	52352718	.	T	G	5	2	7	0	0	7	0	0
6	52352743	.	A	G	6	6	12	0	0	12	0	0
6	52352758	.	G	A	6	5	11	0	0	11	0	0
6	52352788	.	C	G	5	6	11	0	0	11	0	0
6	52352802	.	T	C	5	9	14	0	0	14	0	0
6	52353064	.	G	A	7	3	10	0	1	11	0	0
6	52353074	.	T	A	6	2	8	0	2	10	0	0
6	52353105	.	G	C	1	3	4	0	5	9	0	0
6	52353112	.	C	T	2	3	5	0	0	5	0	0
6	52353345	.	T	C	8	7	15	0	0	15	0	0
6	52353357	.	C	G	10	6	16	0	0	16	0	0
6	52353497	.	T	C	5	2	7	1	0	8	0	0
6	52353505	.	A	G	5	3	8	1	0	9	0	0
6	52353826	.	G	A	2	2	4	0	0	4	0	0
6	52354259	.	A	T	6	5	11	0	0	11	0	0
6	52354783	.	T	C	9	6	15	0	1	16	0	0
6	52354830	.	G	A	9	7	16	0	0	16	0	0
6	52354892	.	A	T	10	3	13	0	0	13	0	0
6	52354909	.	A	G	2	8	10	0	1	11	0	0
6	52362498	.	C	T	1	7	8	2	10	20	0	0
6	52363477	.	G	A	6	6	12	0	0	12	0	0
6	52363487	.	A	T	6	3	9	0	0	9	0	0
6	52363683	.	A	T	12	3	15	0	0	15	0	0
6	52363704	.	C	A	9	4	13	0	0	13	0	0
6	52364352	.	T	C	6	12	18	0	0	18	0	0
6	52364497	.	G	T	10	11	21	0	1	22	0	0
6	52364539	.	C	T	12	11	23	0	0	23	0	0
6	52364701	.	C	T	1	6	7	0	9	16	0	0
6	52372698	.	C	T	1	9	10	0	7	17	0	0
6	52372701	.	C	T	1	7	8	0	9	17	0	0
6	52383370	.	G	A	7	6	13	0	2	15	0	0
6	52397137	.	A	G	7	8	15	0	1	16	0	0
6	52397326	.	G	A	6	13	19	1	0	20	0	0
6	52397362	.	C	T	1	8	9	1	11	21	0	0
6	52521891	.	T	G	12	16	28	0	6	34	0	0
6	52533195	.	G	A	9	13	22	0	1	23	0	0
6	52533228	.	G	A	12	10	22	0	1	23	0	0
6	52536386	.	C	T	0	6	6	0	10	16	0	0
6	52552993	.	G	A	12	13	25	0	1	26	0	0
6	52563953	.	A	C	7	7	14	0	1	15	0	0
6	52566456	.	C	G	8	3	11	0	0	11	0	0
6	52663535	.	C	A	0	2	2	0	2	4	0	0
6	52664120	.	A	T	1	3	4	0	0	4	0	0
6	52675456	.	C	T	1	2	3	0	0	3	0	0
6	52715746	.	C	A	3	3	6	0	0	6	0	0
6	52715879	.	G	T	9	5	14	0	1	15	0	0
6	52715946	.	C	T	10	5	15	0	1	16	0	0
6	52715957	.	G	A	8	6	14	0	0	14	0	0
6	52716053	.	T	C	2	5	7	0	0	7	0	0
6	52716311	.	C	T	13	12	25	0	5	30	0	0
6	52716325	.	G	A	19	9	28	0	2	30	0	0
6	52716630	.	G	A	11	18	29	0	0	29	0	0
6	52716714	.	G	T	10	14	24	0	1	25	0	0
6	52716795	.	G	T	19	18	37	0	5	42	0	0
6	52720695	.	G	A	14	12	26	0	0	26	0	0
6	52720727	.	T	G	15	8	23	0	1	24	0	0
6	52810909	.	T	C	3	4	7	0	0	7	0	0
6	52811127	.	A	G	4	2	6	0	0	6	0	0
6	52811187	.	T	C	5	3	8	0	0	8	0	0
6	52827119	.	A	G	4	2	6	0	0	6	0	0
6	52830561	.	G	A	0	7	7	0	8	15	0	0
6	52830566	.	T	A	8	6	14	0	0	14	0	0
6	52830650	.	T	C	4	3	7	0	0	7	0	0
6	52830743	.	T	A	6	2	8	0	1	9	0	0
6	52840313	.	G	A	1	11	12	0	9	21	0	0
6	52845491	.	G	A	5	4	9	0	0	9	0	0
6	52845763	.	A	G	4	4	8	0	2	10	0	0
6	52845936	.	A	G	4	5	9	0	0	9	0	0
6	53050515	.	T	A	18	23	41	0	3	44	0	0
6	53050761	.	C	T	22	17	39	0	1	40	0	0
6	53050805	.	C	T	17	31	48	0	0	48	0	0
6	53055338	.	T	C	23	1	24	0	24	48	0	0
6	53065954	.	G	A	16	10	26	0	3	29	0	0
6	53143647	.	C	A	4	19	23	0	20	43	0	0
6	53149356	.	A	C	2	2	4	0	0	4	0	0
6	53149396	.	G	A	1	3	4	0	0	4	0	0
6	53264365	.	T	A	35	29	64	0	2	66	0	0
6	53264383	.	C	T	34	36	70	0	1	71	0	0
6	53271887	.	T	C	22	31	53	0	1	54	0	0
6	53272169	.	G	A	30	16	46	0	7	53	0	0
6	53272637	.	G	C	21	15	36	1	3	40	0	0
6	53273943	.	A	G	22	23	45	0	2	47	0	0
6	53273979	.	A	G	29	19	48	0	3	51	0	0
6	53305633	.	T	C	27	22	49	0	5	54	0	0
6	53305888	.	T	C	22	22	44	0	7	51	0	0
6	53305968	.	C	G	7	16	23	2	1	26	0	0
6	53306034	.	A	T	9	21	30	1	1	32	0	0
6	53306806	.	G	T	37	9	46	1	2	49	0	0
6	53306847	.	G	T	33	10	43	0	3	47	1	0
6	53306886	.	C	A	21	11	32	0	1	33	0	0
6	53306897	.	A	G	21	8	29	0	1	30	0	0
6	53326383	.	G	C	30	25	55	1	2	58	0	0
6	53334014	.	A	G	18	20	38	0	1	39	0	0
6	53334082	.	T	G	16	28	44	0	1	46	1	0
6	54063247	.	G	T	1	2	3	0	0	3	0	0
6	54063306	.	G	T	2	2	4	0	0	4	0	0
6	54078725	.	C	T	5	2	7	0	0	7	0	0
6	54078834	.	C	T	3	9	12	0	0	12	0	0
6	54079586	.	T	A	3	2	5	0	0	5	0	0
6	54079590	.	G	C	2	3	5	0	0	5	0	0
6	54079807	.	G	A	10	3	13	0	2	15	0	0
6	54079816	.	A	C	9	5	14	0	0	14	0	0
6	54117152	.	A	G	2	7	9	0	0	9	0	0
6	54120966	.	G	C	7	6	13	0	0	13	0	0
6	54142313	.	G	A	19	8	27	0	0	27	0	0
6	54150237	.	G	A	1	5	6	0	8	14	0	0
6	54150488	.	T	C	9	16	25	0	0	25	0	0
6	54150730	.	G	A	1	16	17	0	11	28	0	0
6	54150826	.	A	T	13	14	27	0	0	27	0	0
6	54151027	.	A	G	13	1	14	1	13	28	0	0
6	54151132	.	A	G	18	14	32	0	0	32	0	0
6	54151210	.	C	T	18	14	32	0	1	33	0	0
6	54151318	.	G	C	12	11	23	0	1	24	0	0
6	54151408	.	T	G	23	11	34	1	0	35	0	0
6	54151554	.	G	A	1	8	9	0	16	25	0	0
6	54151615	.	C	G	9	10	19	2	0	21	0	0
6	54151674	.	G	T	17	15	32	0	2	34	0	0
6	54151782	.	A	G	18	8	26	4	2	32	0	0
6	54151798	.	A	C	18	9	27	2	0	29	0	0
6	54151951	.	T	C	17	10	27	0	2	29	0	0
6	54151963	.	T	C	14	12	26	0	0	26	0	0
6	54152125	.	T	A	18	9	27	1	0	28	0	0
6	54152151	.	T	A	23	10	33	1	0	34	0	0
6	54164974	.	A	T	15	4	19	1	0	20	0	0
6	54165082	.	G	T	0	4	4	0	11	15	0	0
6	54165133	.	C	T	4	7	11	0	2	13	0	0
6	54177352	.	A	T	28	31	59	0	7	67	1	0
6	54177478	.	A	G	42	28	70	2	2	74	0	0
6	54179724	.	C	G	29	36	65	0	1	66	0	0
6	54179733	.	G	A	31	32	63	0	0	63	0	0
6	54262298	.	C	T	9	6	15	0	0	15	0	0
6	54266317	.	T	C	13	13	26	0	0	26	0	0
6	54270266	.	C	T	10	8	18	1	0	19	0	0
6	54270296	.	G	A	9	9	18	1	0	19	0	0
6	54270561	.	T	A	10	5	15	0	0	15	0	0
6	54270680	.	G	T	21	5	26	0	2	28	0	0
6	54270760	.	C	T	7	12	19	0	1	20	0	0
6	54270951	.	T	G	1	2	3	0	0	3	0	0
6	54271007	.	C	T	1	2	3	0	0	3	0	0
6	54271196	.	A	T	4	5	9	0	1	10	0	0
6	54325368	.	A	G	8	5	13	0	0	13	0	0
6	54325487	.	A	G	3	6	9	0	0	9	0	0
6	54325658	.	C	A	10	3	13	0	1	14	0	0
6	54326008	.	T	C	5	6	11	0	0	11	0	0
6	54326314	.	G	A	4	2	6	0	1	7	0	0
6	54326759	.	T	C	4	8	12	0	1	13	0	0
6	54337547	.	G	A	6	14	20	0	1	21	0	0
6	54337568	.	G	A	13	9	22	0	0	22	0	0
6	55217796	.	A	G	11	8	19	0	3	22	0	0
6	55218016	.	A	G	5	2	7	0	0	7	0	0
6	55218047	.	A	G	5	5	10	0	0	10	0	0
6	55218127	.	A	G	7	8	15	0	1	16	0	0
6	55218137	.	A	G	6	8	14	0	1	15	0	0
6	58867240	.	A	G	16	8	24	0	0	24	0	0
6	59883372	.	A	C	7	3	10	0	16	26	0	0
6	59883460	.	A	C	8	0	8	0	13	21	0	0
7	742828	.	T	C	11	20	31	0	2	33	0	0
7	837955	.	T	G	5	5	10	1	0	11	0	0
7	841689	.	G	A	3	4	7	8	1	16	0	0
7	846579	.	C	T	7	12	19	0	0	19	0	0
7	846972	.	T	C	10	14	24	1	0	25	0	0
7	847189	.	A	T	9	13	22	0	0	22	0	0
7	860914	.	A	G	6	5	11	1	0	12	0	0
7	861057	.	G	C	3	6	9	1	0	10	0	0
7	1418310	.	T	C	4	4	8	2	0	10	0	0
7	1418416	.	T	C	3	3	6	2	1	9	0	0
7	1526860	.	G	A	3	8	11	0	17	28	0	0
7	1530119	.	C	T	1	2	3	0	0	3	0	0
7	1535799	.	C	T	4	5	9	0	0	9	0	0
7	1535874	.	G	C	5	4	9	0	1	10	0	0
7	1535877	.	T	C	6	4	10	0	0	10	0	0
7	1539463	.	C	T	6	3	9	0	0	9	0	0
7	1539481	.	C	T	6	2	8	0	0	8	0	0
7	1539532	.	C	T	5	3	8	1	0	9	0	0
7	1539538	.	C	T	5	2	7	1	0	8	0	0
7	1540812	.	T	A	9	6	15	0	0	15	0	0
7	1541012	.	G	A	0	7	7	0	10	17	0	0
7	1541117	.	G	T	2	8	10	3	7	20	0	0
7	1588610	.	C	T	11	5	16	4	1	21	0	0
7	1594408	.	C	T	9	18	27	0	0	27	0	0
7	1594606	.	C	A	19	14	33	0	1	34	0	0
7	1600153	.	C	T	17	8	25	0	1	26	0	0
7	1600263	.	A	T	11	12	23	0	0	23	0	0
7	1603053	.	G	T	1	10	11	0	21	32	0	0
7	1603116	.	T	G	8	2	10	0	24	34	0	0
7	1606334	.	C	T	25	6	31	0	2	33	0	0
7	1608893	.	G	A	18	6	24	0	0	24	0	0
7	1609555	.	C	T	16	11	27	0	0	27	0	0
7	1613117	.	T	C	23	13	36	0	1	37	0	0
7	1613131	.	A	G	24	13	37	0	1	38	0	0
7	1613230	.	T	G	29	16	45	0	1	47	1	0
7	1615439	.	C	T	27	19	46	0	2	48	0	0
7	1617209	.	T	A	38	17	55	0	0	55	0	0
7	1617218	.	T	C	36	7	43	0	2	45	0	0
7	1617433	.	A	C	32	18	50	0	0	50	0	0
7	1618769	.	G	A	1	7	8	1	12	21	0	0
7	1618771	.	G	A	0	11	11	1	9	21	0	0
7	1618863	.	T	C	22	8	30	1	0	31	0	0
7	1618865	.	G	A	8	18	26	1	3	30	0	0
7	1619124	.	A	T	6	3	9	0	0	9	0	0
7	1620135	.	G	A	0	2	2	0	1	3	0	0
7	1620180	.	G	C	2	2	4	0	0	4	0	0
7	3931029	.	A	G	39	16	55	0	1	56	0	0
7	3931264	.	C	T	27	21	48	0	2	50	0	0
7	3931396	.	A	T	30	28	58	0	0	58	0	0
7	3931543	.	A	T	26	29	55	0	3	58	0	0
7	3931598	.	G	T	17	37	54	0	3	57	0	0
7	3931644	.	T	C	24	0	24	0	21	45	0	0
7	3932209	.	A	T	18	27	45	0	1	46	0	0
7	3932402	.	T	C	17	11	28	0	1	29	0	0
7	3932405	.	A	T	17	11	28	0	1	29	0	0
7	3932463	.	T	G	14	12	26	0	1	27	0	0
7	3932694	.	G	A	28	8	36	0	0	36	0	0
7	3932698	.	T	C	30	8	38	0	2	40	0	0
7	3932731	.	C	A	31	12	43	0	2	45	0	0
7	3932935	.	C	A	23	14	37	0	1	39	1	0
7	3933121	.	G	A	30	22	52	0	2	54	0	0
7	3933243	.	C	A	30	9	39	0	1	40	0	0
7	3933271	.	C	T	26	10	36	0	2	38	0	0
7	3933383	.	A	C	10	0	10	0	17	27	0	0
7	3933481	.	T	C	31	0	31	0	12	43	0	0
7	3933483	.	C	T	3	11	14	0	29	43	0	0
7	3933998	.	C	T	21	15	36	0	1	37	0	0
7	3934038	.	A	T	16	16	32	0	0	32	0	0
7	3934387	.	C	T	20	22	42	0	2	44	0	0
7	3934428	.	G	T	20	21	41	0	3	44	0	0
7	3934551	.	A	T	13	7	20	0	0	20	0	0
7	3934645	.	A	C	9	14	23	0	0	23	0	0
7	3934818	.	G	A	23	7	30	0	0	30	0	0
7	3934970	.	A	G	9	19	28	0	0	28	0	0
7	3935055	.	T	C	11	23	34	0	0	34	0	0
7	3935123	.	A	G	11	19	30	0	0	30	0	0
7	3935171	.	G	C	18	14	32	0	0	32	0	0
7	3935283	.	G	A	14	16	30	0	3	33	0	0
7	3935737	.	C	T	3	19	22	0	29	51	0	0
7	3935788	.	C	A	16	14	30	1	0	31	0	0
7	3936127	.	C	T	3	15	18	1	13	32	0	0
7	3936702	.	A	G	4	3	7	0	0	7	0	0
7	3936764	.	G	A	12	12	24	0	1	25	0	0
7	3936946	.	C	T	2	13	15	0	17	32	0	0
7	3951010	.	C	T	3	25	28	0	15	43	0	0
7	3951115	.	G	A	28	12	40	0	1	41	0	0
7	3952993	.	A	G	12	27	39	0	0	39	0	0
7	3955628	.	G	A	9	16	25	0	2	27	0	0
7	4088334	.	C	T	17	15	32	0	3	35	0	0
7	4088545	.	C	T	3	10	13	0	13	26	0	0
7	4088680	.	G	A	12	19	31	0	1	32	0	0
7	4088727	.	A	T	24	18	42	0	1	43	0	0
7	4088832	.	A	G	16	21	37	0	0	37	0	0
7	4089042	.	A	G	19	12	31	0	0	31	0	0
7	4089090	.	G	A	18	11	29	0	0	29	0	0
7	4095265	.	C	T	1	22	23	0	21	44	0	0
7	4100931	.	C	T	11	19	30	0	1	31	0	0
7	4100967	.	G	A	14	19	33	0	2	35	0	0
7	4169127	.	A	G	1	3	4	0	0	4	0	0
7	4174990	.	T	C	2	5	7	0	0	7	0	0
7	4178506	.	C	A	3	5	8	0	1	9	0	0
7	4179204	.	G	A	1	2	3	0	0	3	0	0
7	4180015	.	G	A	0	2	2	0	1	3	0	0
7	4180423	.	A	G	1	3	4	0	0	4	0	0
7	4180742	.	C	T	1	2	3	1	1	5	0	0
7	4180787	.	T	C	1	5	6	0	1	7	0	0
7	4182432	.	T	A	3	4	7	0	0	7	0	0
7	4183222	.	C	G	2	5	7	0	0	7	0	0
7	4183890	.	G	T	1	3	4	0	0	4	0	0
7	4183926	.	C	G	3	2	5	0	0	5	0	0
7	4183996	.	C	T	9	4	13	0	0	13	0	0
7	4184897	.	G	T	5	5	10	0	1	11	0	0
7	4186499	.	A	G	2	3	5	2	1	8	0	0
7	4186532	.	G	A	1	2	3	1	4	8	0	0
7	4186553	.	T	C	2	4	6	1	0	7	0	0
7	4237424	.	G	A	0	2	2	0	1	3	0	0
7	7245508	.	C	G	4	3	7	0	0	7	0	0
7	7248193	.	C	T	16	10	26	0	2	28	0	0
7	7365928	.	A	C	1	6	7	1	0	8	0	0
7	7372341	.	A	G	9	11	20	0	0	20	0	0
7	7372404	.	A	G	11	6	17	4	2	23	0	0
7	7552113	.	G	A	19	14	33	0	0	33	0	0
7	7597059	.	A	G	14	0	14	0	12	26	0	0
7	7608920	.	G	A	1	13	14	0	17	31	0	0
7	7608944	.	T	G	19	0	19	0	15	34	0	0
7	7608965	.	C	T	16	14	30	0	2	32	0	0
7	7611758	.	C	T	24	17	41	0	0	41	0	0
7	7611803	.	C	A	14	13	27	0	16	43	0	0
7	7611866	.	T	C	19	13	32	0	1	33	0	0
7	7617855	.	T	C	29	16	45	0	0	45	0	0
7	7617963	.	C	G	20	17	37	0	0	37	0	0
7	7624082	.	A	G	19	24	43	0	10	53	0	0
7	7624090	.	T	C	27	25	52	0	4	56	0	0
7	7641230	.	A	T	15	26	41	0	1	42	0	0
7	7641351	.	G	A	27	18	45	0	0	45	0	0
7	7641353	.	G	A	27	18	45	0	0	45	0	0
7	7641559	.	C	T	19	22	41	0	1	42	0	0
7	7641567	.	C	T	20	18	38	0	1	40	1	0
7	7641608	.	A	G	20	23	43	0	0	43	0	0
7	7641678	.	T	A	21	7	28	1	0	29	0	0
7	7641976	.	T	C	14	13	27	1	1	29	0	0
7	7641984	.	G	T	13	11	24	1	0	25	0	0
7	7642730	.	C	T	23	11	34	0	3	37	0	0
7	7642819	.	G	A	15	17	32	0	1	33	0	0
7	7642840	.	T	A	17	10	27	0	2	29	0	0
7	7642856	.	C	T	17	10	27	0	2	29	0	0
7	7643184	.	A	G	15	0	15	0	11	26	0	0
7	7643348	.	G	A	22	13	35	0	1	36	0	0
7	7643362	.	T	A	22	9	31	0	4	35	0	0
7	7643488	.	A	G	21	20	41	0	1	42	0	0
7	7643629	.	A	G	33	16	49	2	3	54	0	0
7	7662467	.	C	G	5	9	14	0	0	14	0	0
7	7662475	.	T	C	9	1	10	0	8	18	0	0
7	7662527	.	A	C	15	8	23	0	0	23	0	0
7	7662580	.	G	A	13	15	28	0	1	29	0	0
7	7662872	.	A	C	10	13	23	0	1	24	0	0
7	7662978	.	A	C	9	16	25	0	1	26	0	0
7	7663017	.	T	A	14	17	31	0	0	31	0	0
7	7663048	.	A	G	19	17	36	0	2	38	0	0
7	7663132	.	A	G	19	17	36	0	0	36	0	0
7	7663152	.	A	T	14	14	28	0	1	29	0	0
7	7663320	.	C	G	15	10	25	0	0	25	0	0
7	7663449	.	A	C	20	0	20	0	11	31	0	0
7	7663453	.	A	T	20	11	31	0	1	32	0	0
7	7663682	.	C	T	0	7	7	0	8	15	0	0
7	7663902	.	G	T	8	12	20	1	0	21	0	0
7	7663962	.	G	T	6	4	10	0	1	12	1	0
7	7664083	.	G	A	4	2	6	0	0	6	0	0
7	7664237	.	C	T	3	4	7	0	0	7	0	0
7	7664558	.	G	T	5	8	13	3	0	16	0	0
7	7664838	.	G	T	12	4	16	0	1	17	0	0
7	7664870	.	G	T	8	4	12	0	0	12	0	0
7	7664882	.	G	C	9	4	13	0	1	14	0	0
7	7664912	.	A	C	9	5	14	0	0	14	0	0
7	7665338	.	G	T	14	5	19	1	1	21	0	0
7	7665353	.	T	A	20	4	24	1	0	25	0	0
7	7665480	.	A	C	9	10	19	0	1	20	0	0
7	7665877	.	T	C	2	2	4	0	0	4	0	0
7	7665878	.	C	T	2	2	4	0	0	4	0	0
7	7665952	.	T	A	6	3	9	0	0	9	0	0
7	7665961	.	T	C	6	3	9	0	1	10	0	0
7	7666388	.	G	A	22	11	33	0	0	33	0	0
7	7666625	.	G	A	20	8	28	0	0	28	0	0
7	7674378	.	T	C	10	0	10	0	14	24	0	0
7	7674462	.	C	G	16	12	28	0	0	28	0	0
7	7674474	.	T	A	16	13	29	0	0	29	0	0
7	7676086	.	C	T	12	14	26	0	0	26	0	0
7	7676112	.	C	T	13	13	26	0	1	27	0	0
7	7676185	.	C	T	12	3	15	0	0	15	0	0
7	7680073	.	C	T	7	4	11	0	0	11	0	0
7	7681415	.	T	G	6	5	11	0	0	11	0	0
7	7681419	.	C	G	0	6	6	0	6	12	0	0
7	7683342	.	G	A	2	6	8	0	0	8	0	0
7	7683537	.	G	A	5	4	9	0	0	9	0	0
7	7683545	.	C	T	0	3	3	0	3	6	0	0
7	7685156	.	C	T	4	4	8	0	1	9	0	0
7	7687435	.	G	A	1	3	4	0	0	4	0	0
7	7696726	.	G	C	6	13	19	0	0	19	0	0
7	7696742	.	A	G	9	14	23	0	0	23	0	0
7	7696785	.	T	A	9	7	16	0	0	16	0	0
7	7696794	.	G	T	0	8	8	0	10	18	0	0
7	7700867	.	G	A	0	8	8	0	9	17	0	0
7	7700965	.	T	G	8	0	8	0	10	18	0	0
7	7700987	.	T	C	10	8	18	0	0	18	0	0
7	7701016	.	G	C	5	12	17	0	1	18	0	0
7	7705993	.	C	G	7	0	7	0	12	19	0	0
7	7706005	.	C	T	7	7	14	0	0	14	0	0
7	7706702	.	G	A	1	7	8	0	12	20	0	0
7	7706869	.	A	G	7	6	13	0	1	14	0	0
7	7706997	.	C	A	7	9	16	0	0	16	0	0
7	7707029	.	T	G	8	11	19	0	0	19	0	0
7	7708572	.	T	C	3	3	6	0	0	6	0	0
7	7708631	.	C	A	1	8	9	0	0	9	0	0
7	7708640	.	C	G	1	8	9	0	0	9	0	0
7	7708666	.	A	C	2	7	9	0	2	11	0	0
7	7708714	.	T	C	5	6	11	0	1	12	0	0
7	7708826	.	T	G	2	3	5	0	1	6	0	0
7	7708840	.	C	A	3	4	7	0	0	7	0	0
7	7709815	.	T	A	2	3	5	0	0	5	0	0
7	7710531	.	A	G	1	2	3	0	0	3	0	0
7	7772265	.	C	T	0	2	2	0	1	3	0	0
7	7779047	.	A	T	1	7	8	0	0	8	0	0
7	7779060	.	G	A	1	9	10	0	1	11	0	0
7	7779091	.	A	G	1	6	7	0	0	7	0	0
7	7783117	.	G	T	1	2	3	0	0	3	0	0
7	7783147	.	G	A	1	2	3	0	0	3	0	0
7	7795237	.	C	G	3	2	5	0	0	5	0	0
7	7796088	.	T	C	1	3	4	0	0	4	0	0
7	7797397	.	T	G	3	2	5	0	0	5	0	0
7	7797598	.	T	C	2	2	4	0	0	4	0	0
7	7797616	.	C	A	2	2	4	0	0	4	0	0
7	8571551	.	A	C	2	2	4	0	0	4	0	0
7	8694818	.	T	G	5	4	9	0	0	9	0	0
7	8694893	.	A	C	0	7	7	0	1	8	0	0
7	8694999	.	T	A	1	4	5	0	0	5	0	0
7	8695001	.	C	A	1	4	5	0	0	5	0	0
7	8702121	.	C	T	5	2	7	0	1	8	0	0
7	8728503	.	G	A	1	2	3	0	0	3	0	0
7	8728524	.	C	T	3	2	5	0	0	5	0	0
7	8890495	.	C	T	1	5	6	0	4	10	0	0
7	8890515	.	G	C	8	0	8	0	11	19	0	0
7	8890717	.	T	C	7	2	9	0	0	9	0	0
7	8891418	.	T	C	2	2	4	0	1	5	0	0
7	8891675	.	T	A	10	4	14	0	0	14	0	0
7	8891710	.	A	G	8	23	31	0	0	31	0	0
7	8891717	.	A	G	8	25	33	0	1	34	0	0
7	8891755	.	T	G	10	14	24	3	0	27	0	0
7	8893271	.	T	C	2	3	5	0	0	5	0	0
7	8950378	.	G	A	3	2	5	0	0	5	0	0
7	8950386	.	C	A	3	3	6	0	0	6	0	0
7	9189605	.	T	C	4	3	7	0	0	7	0	0
7	9212234	.	A	G	4	4	8	0	0	8	0	0
7	9224366	.	G	A	1	3	4	0	3	7	0	0
7	9229327	.	A	C	1	8	9	0	0	9	0	0
7	9232531	.	T	C	1	3	4	0	0	4	0	0
7	9232615	.	C	T	8	2	10	0	0	10	0	0
7	9232621	.	C	G	8	2	10	0	0	10	0	0
7	9238631	.	A	G	8	0	8	0	6	14	0	0
7	9261589	.	T	C	7	4	11	0	0	11	0	0
7	9290939	.	G	T	2	2	4	0	0	4	0	0
7	9291049	.	C	A	9	15	24	0	1	25	0	0
7	9299699	.	G	A	3	5	8	0	1	9	0	0
7	9299726	.	A	G	4	5	9	0	0	9	0	0
7	9299776	.	T	A	6	3	9	0	0	9	0	0
7	9302736	.	C	A	9	2	11	0	1	13	1	0
7	9302841	.	A	G	14	6	20	0	1	21	0	0
7	9302990	.	T	A	15	5	20	0	0	21	1	0
7	9303000	.	T	A	17	3	20	0	0	20	0	0
7	9304692	.	T	C	24	12	36	0	0	36	0	0
7	9305501	.	G	A	4	5	9	0	0	9	0	0
7	9308683	.	A	G	17	20	37	0	0	37	0	0
7	9308715	.	C	T	22	15	37	0	0	37	0	0
7	9308817	.	A	G	15	17	32	0	0	32	0	0
7	9312770	.	G	A	1	22	23	0	21	44	0	0
7	9317990	.	G	A	18	20	38	0	2	40	0	0
7	9319626	.	T	C	22	20	42	0	1	43	0	0
7	9319774	.	A	C	1	2	3	0	0	3	0	0
7	9320123	.	A	T	2	3	5	0	0	5	0	0
7	9320431	.	A	T	13	8	21	0	1	22	0	0
7	9320489	.	A	G	13	6	19	0	1	20	0	0
7	9320719	.	C	T	17	14	31	0	1	32	0	0
7	9321124	.	G	A	0	6	6	0	5	11	0	0
7	9321374	.	C	T	8	4	12	0	0	12	0	0
7	9321375	.	T	A	8	4	12	0	0	12	0	0
7	9321800	.	G	A	2	9	11	0	10	21	0	0
7	9321981	.	G	T	15	25	40	0	0	40	0	0
7	9322070	.	A	T	16	16	32	0	3	35	0	0
7	9322073	.	A	C	19	16	35	0	1	36	0	0
7	9322133	.	C	A	20	20	40	0	3	43	0	0
7	9322134	.	T	A	20	20	40	0	2	43	1	0
7	9322176	.	C	A	25	4	29	0	1	32	2	0
7	9322178	.	T	C	26	5	31	0	1	32	0	0
7	9322216	.	A	G	21	7	28	0	0	28	0	0
7	9322271	.	G	C	8	13	21	0	1	22	0	0
7	9322441	.	C	T	6	6	12	0	0	12	0	0
7	9509429	.	C	T	3	4	7	0	0	7	0	0
7	9509450	.	C	T	5	4	9	0	0	9	0	0
7	9844342	.	T	C	5	0	5	0	5	10	0	0
7	10875024	.	A	G	26	8	34	0	1	35	0	0
7	10875101	.	A	G	15	18	33	0	3	36	0	0
7	10875187	.	A	G	24	9	33	0	2	35	0	0
7	10875386	.	A	G	19	7	26	0	3	29	0	0
7	10875552	.	A	G	17	5	22	0	1	23	0	0
7	10875751	.	A	G	22	13	35	0	2	37	0	0
7	11340658	.	A	G	8	0	8	0	8	16	0	0
7	11340746	.	A	G	5	4	9	0	1	10	0	0
7	12843975	.	T	C	6	1	7	0	5	12	0	0
7	13242820	.	A	G	3	0	3	0	6	9	0	0
7	13569928	.	T	C	7	3	10	1	0	11	0	0
7	13897615	.	C	T	0	2	2	0	1	3	0	0
7	13897633	.	T	C	1	2	3	0	0	3	0	0
7	13897711	.	T	C	3	2	5	0	0	5	0	0
7	13897765	.	A	C	6	6	12	0	0	12	0	0
7	13897768	.	A	C	6	0	6	0	6	12	0	0
7	13897822	.	G	A	5	4	9	0	1	10	0	0
7	13897878	.	G	A	2	2	4	0	0	4	0	0
7	13897897	.	T	C	2	3	5	0	0	5	0	0
7	13900964	.	A	G	5	3	8	0	0	8	0	0
7	13900967	.	G	A	4	3	7	0	0	7	0	0
7	13906372	.	C	T	2	2	4	0	0	4	0	0
7	14118714	.	C	T	2	5	7	0	0	7	0	0
7	14203111	.	T	C	1	2	3	0	0	3	0	0
7	14203690	.	A	G	2	3	5	0	0	5	0	0
7	14204653	.	A	T	1	2	3	0	0	3	0	0
7	14205503	.	G	A	1	7	8	0	1	9	0	0
7	14205527	.	G	C	2	6	8	0	1	9	0	0
7	14205559	.	T	C	2	4	6	0	0	6	0	0
7	14205781	.	T	G	2	3	5	0	0	5	0	0
7	14205857	.	C	A	3	6	9	0	0	9	0	0
7	14205881	.	A	G	4	5	9	0	0	9	0	0
7	14205992	.	G	T	1	4	5	0	0	5	0	0
7	14206199	.	T	A	3	2	5	0	0	6	1	0
7	14206200	.	C	T	4	2	6	0	0	6	0	0
7	14206499	.	T	A	2	6	8	0	0	8	0	0
7	14206790	.	T	G	4	4	8	0	0	8	0	0
7	14206847	.	C	A	3	4	7	0	0	7	0	0
7	14217069	.	A	G	0	2	2	0	1	3	0	0
7	14262108	.	A	T	4	2	6	0	0	6	0	0
7	14262111	.	G	T	0	3	3	0	4	7	0	0
7	14379559	.	T	C	3	2	5	0	1	6	0	0
7	14381177	.	G	A	1	4	5	0	1	6	0	0
7	14393796	.	T	C	2	2	4	0	0	4	0	0
7	14394839	.	G	C	1	5	6	0	0	6	0	0
7	14394860	.	A	C	1	6	7	0	0	7	0	0
7	14394891	.	G	A	2	4	6	0	0	6	0	0
7	14394925	.	A	G	0	3	3	0	1	4	0	0
7	14394991	.	G	A	4	4	8	0	0	8	0	0
7	14395029	.	A	G	4	5	9	0	0	9	0	0
7	14397735	.	A	G	2	2	4	0	0	4	0	0
7	14400512	.	C	T	4	2	6	0	1	7	0	0
7	14417122	.	C	T	2	4	6	0	0	6	0	0
7	14417212	.	G	A	3	2	5	0	0	5	0	0
7	14417239	.	C	A	3	3	6	0	0	6	0	0
7	14423500	.	T	G	1	2	3	0	0	3	0	0
7	14424246	.	C	A	1	2	3	0	0	3	0	0
7	14424254	.	C	T	1	2	3	0	0	3	0	0
7	14532066	.	T	C	10	10	20	0	2	22	0	0
7	14534326	.	T	C	17	1	18	0	11	29	0	0
7	14534789	.	T	C	12	15	27	0	1	28	0	0
7	14535719	.	T	C	10	12	22	0	0	22	0	0
7	14535749	.	T	A	9	12	21	0	0	21	0	0
7	14535782	.	G	T	9	16	25	0	3	28	0	0
7	14535834	.	A	C	6	5	11	0	1	12	0	0
7	14536163	.	A	G	8	9	17	0	0	17	0	0
7	14539470	.	T	C	5	3	8	0	2	10	0	0
7	14542854	.	C	T	7	6	13	0	0	13	0	0
7	14542893	.	C	T	8	10	18	0	0	18	0	0
7	14543002	.	T	C	2	12	14	0	0	14	0	0
7	14543128	.	A	T	2	5	7	0	0	7	0	0
7	14543454	.	G	T	1	3	4	0	0	4	0	0
7	14543463	.	T	C	1	4	5	0	0	5	0	0
7	14632554	.	A	C	4	4	8	0	1	9	0	0
7	14632664	.	G	A	6	5	11	0	0	11	0	0
7	14774086	.	C	A	9	7	16	0	0	16	0	0
7	14789964	.	G	A	0	11	11	0	9	20	0	0
7	14860521	.	C	T	9	23	32	0	0	32	0	0
7	14860524	.	A	C	10	21	31	0	2	33	0	0
7	14900869	.	G	A	10	10	20	0	0	20	0	0
7	14905516	.	G	C	11	9	20	0	1	21	0	0
7	14938134	.	C	T	6	8	14	0	0	14	0	0
7	15088130	.	A	G	2	2	4	0	0	4	0	0
7	15088184	.	G	A	2	3	5	0	0	5	0	0
7	15088838	.	C	A	1	2	3	0	3	6	0	0
7	15089514	.	T	A	1	1	2	0	1	3	0	0
7	15093805	.	G	A	1	2	3	0	0	3	0	0
7	15374448	.	C	T	1	4	5	0	0	5	0	0
7	15447011	.	A	C	2	2	4	0	0	4	0	0
7	15459009	.	A	C	2	3	5	0	0	5	0	0
7	15543788	.	C	T	1	2	3	0	0	3	0	0
7	15543860	.	G	A	0	2	2	0	5	7	0	0
7	15543920	.	T	C	4	5	9	0	0	9	0	0
7	15546686	.	A	C	2	4	6	0	0	6	0	0
7	15572650	.	G	C	4	2	6	1	0	7	0	0
7	15572797	.	A	G	5	4	9	0	0	9	0	0
7	15603667	.	A	T	2	3	5	0	0	5	0	0
7	15605180	.	A	T	1	4	5	0	0	5	0	0
7	15605844	.	C	T	6	4	10	0	1	11	0	0
7	15605846	.	T	C	5	4	9	0	2	11	0	0
7	15605950	.	T	C	6	5	11	0	0	11	0	0
7	15605968	.	T	A	5	6	11	0	1	12	0	0
7	15607478	.	A	G	5	4	9	0	1	10	0	0
7	15607650	.	C	T	6	5	11	0	1	12	0	0
7	15607757	.	G	A	0	7	7	0	4	11	0	0
7	15607867	.	C	T	4	2	6	0	0	6	0	0
7	15608183	.	T	C	3	3	6	0	1	7	0	0
7	15608620	.	G	A	3	4	7	0	0	7	0	0
7	15608707	.	T	G	0	2	2	0	1	3	0	0
7	15608730	.	A	C	3	3	6	0	0	6	0	0
7	15608767	.	T	A	3	2	5	0	0	5	0	0
7	15608774	.	C	G	2	2	4	0	0	4	0	0
7	15609137	.	A	C	2	3	5	0	0	5	0	0
7	15609156	.	G	A	2	3	5	0	0	5	0	0
7	15609387	.	T	A	3	7	10	0	1	11	0	0
7	15609469	.	C	T	7	6	13	0	0	13	0	0
7	15609520	.	G	A	2	6	8	0	0	8	0	0
7	15609826	.	C	T	4	7	11	0	1	12	0	0
7	15609961	.	C	T	7	9	16	0	0	16	0	0
7	15618216	.	T	C	8	8	16	0	0	16	0	0
7	15618227	.	C	T	9	6	15	0	1	16	0	0
7	15620071	.	A	G	6	3	9	0	0	9	0	0
7	15623727	.	A	C	5	8	13	0	0	13	0	0
7	15629291	.	A	G	5	4	9	0	0	9	0	0
7	15629298	.	C	T	5	2	7	0	0	7	0	0
7	15634379	.	A	G	2	5	7	0	0	7	0	0
7	15634391	.	G	A	1	6	7	0	3	10	0	0
7	15648755	.	C	T	2	3	5	0	1	6	0	0
7	15653514	.	G	A	3	6	9	0	1	10	0	0
7	15653537	.	G	A	2	2	4	0	0	4	0	0
7	15819692	.	C	T	6	5	11	0	0	11	0	0
7	15825888	.	T	C	6	0	6	0	6	12	0	0
7	15825932	.	T	C	8	0	8	0	12	20	0	0
7	15826026	.	G	A	7	2	9	0	0	9	0	0
7	15830007	.	T	C	7	8	15	0	0	15	0	0
7	15830026	.	A	G	8	7	15	0	0	15	0	0
7	15830095	.	C	T	6	2	8	0	0	8	0	0
7	15875886	.	C	T	1	5	6	0	0	6	0	0
7	15875919	.	G	C	1	3	4	0	1	5	0	0
7	15875951	.	T	G	2	2	4	0	0	4	0	0
7	15882074	.	C	A	3	4	7	0	0	7	0	0
7	15891623	.	C	A	8	6	14	0	1	15	0	0
7	15896959	.	G	C	5	4	9	0	0	9	0	0
7	15896998	.	G	A	1	12	13	0	3	16	0	0
7	15897024	.	G	A	4	8	12	0	0	12	0	0
7	15897470	.	G	C	4	2	6	0	0	6	0	0
7	15897615	.	G	T	4	3	7	0	0	7	0	0
7	15897671	.	G	T	4	8	12	0	0	12	0	0
7	15897676	.	T	C	3	7	10	0	0	10	0	0
7	15897755	.	A	G	2	7	9	0	1	10	0	0
7	15898112	.	G	T	4	4	8	0	0	8	0	0
7	15898280	.	T	C	3	5	8	0	0	8	0	0
7	15898400	.	T	C	6	7	13	0	0	13	0	0
7	15898712	.	C	A	2	4	6	0	0	6	0	0
7	15899189	.	T	C	4	4	8	0	0	8	0	0
7	15899191	.	A	G	4	4	8	0	0	8	0	0
7	15899532	.	T	A	11	7	18	0	3	21	0	0
7	16033726	.	A	G	4	3	7	0	0	7	0	0
7	16033730	.	A	G	4	3	7	0	0	7	0	0
7	16232308	.	G	A	1	4	5	1	0	6	0	0
7	16348898	.	A	G	9	14	23	0	2	25	0	0
7	16388262	.	C	T	15	16	31	0	1	32	0	0
7	16388307	.	C	T	10	15	25	0	2	27	0	0
7	16388310	.	G	C	10	16	26	0	1	27	0	0
7	16388358	.	T	C	5	10	15	0	0	15	0	0
7	16456854	.	C	T	16	11	27	0	2	29	0	0
7	16460093	.	C	T	6	7	13	0	2	15	0	0
7	16460252	.	G	A	16	5	21	0	0	21	0	0
7	16514226	.	G	A	7	3	10	0	0	10	0	0
7	16514265	.	C	T	6	6	12	0	1	13	0	0
7	16516650	.	C	T	5	2	7	0	0	7	0	0
7	16529521	.	C	T	3	4	7	0	0	7	0	0
7	16533097	.	G	A	0	3	3	0	3	6	0	0
7	16534940	.	A	G	4	5	9	0	1	10	0	0
7	16534946	.	A	G	4	4	8	0	1	9	0	0
7	16538203	.	T	C	1	3	4	0	0	4	0	0
7	16545638	.	C	T	7	8	15	0	0	15	0	0
7	16545777	.	T	A	4	9	13	0	0	13	0	0
7	16545790	.	A	G	3	8	11	0	0	11	0	0
7	16546048	.	T	A	3	4	7	1	1	9	0	0
7	16546052	.	G	C	0	3	3	1	5	9	0	0
7	16955564	.	C	T	2	2	4	0	0	4	0	0
7	16955692	.	T	C	5	4	9	0	1	10	0	0
7	16958050	.	C	T	4	5	9	0	1	10	0	0
7	16963444	.	C	A	3	2	5	0	0	5	0	0
7	16994582	.	G	A	0	3	3	0	3	6	0	0
7	16994639	.	G	A	0	4	4	0	3	7	0	0
7	16996078	.	C	T	4	3	7	0	1	8	0	0
7	17000956	.	G	A	0	4	4	0	2	6	0	0
7	17003632	.	A	T	1	2	3	0	0	3	0	0
7	17004383	.	C	T	2	4	6	0	0	6	0	0
7	17007283	.	C	T	4	4	8	0	0	8	0	0
7	17008188	.	G	T	1	4	5	0	1	6	0	0
7	17009538	.	C	T	2	2	4	0	1	5	0	0
7	17011427	.	T	C	5	10	15	0	1	16	0	0
7	17012073	.	G	C	1	2	3	0	1	4	0	0
7	17012233	.	T	G	1	4	5	0	0	5	0	0
7	17012573	.	G	C	1	2	3	0	0	3	0	0
7	17012967	.	C	A	1	2	3	0	0	3	0	0
7	17013825	.	T	C	2	4	6	0	0	6	0	0
7	17013827	.	T	A	2	4	6	0	0	6	0	0
7	17013899	.	C	T	2	3	5	0	1	6	0	0
7	17014301	.	T	C	1	2	3	0	2	5	0	0
7	17014338	.	T	G	3	0	3	0	6	9	0	0
7	17014453	.	A	C	5	3	8	0	0	8	0	0
7	17014531	.	C	A	5	6	11	0	0	11	0	0
7	17014548	.	G	T	6	5	11	0	0	11	0	0
7	17014621	.	T	A	8	8	16	0	0	16	0	0
7	17014653	.	C	T	6	8	14	0	0	15	1	0
7	17014748	.	T	C	2	8	10	0	0	10	0	0
7	17014809	.	A	C	6	5	11	0	1	12	0	0
7	17014815	.	T	C	5	6	11	0	0	11	0	0
7	17014914	.	A	G	2	3	5	0	0	5	0	0
7	17027735	.	T	A	1	2	3	0	0	3	0	0
7	17096421	.	T	C	11	5	16	0	1	17	0	0
7	17097176	.	G	A	15	6	21	0	0	21	0	0
7	17097191	.	C	T	14	10	24	0	0	24	0	0
7	17100259	.	T	C	14	4	18	0	4	22	0	0
7	17100271	.	G	A	11	8	19	0	1	20	0	0
7	17103021	.	A	G	1	2	3	0	1	4	0	0
7	17104238	.	T	A	1	4	5	0	0	5	0	0
7	17104445	.	C	A	1	2	3	0	0	3	0	0
7	17106599	.	C	T	4	4	8	0	0	8	0	0
7	17109072	.	G	C	0	2	2	0	1	3	0	0
7	17230385	.	G	A	11	8	19	0	1	20	0	0
7	17238028	.	T	C	0	6	6	0	0	6	0	0
7	17238034	.	T	G	1	6	7	0	0	7	0	0
7	17238293	.	C	T	6	7	13	0	1	14	0	0
7	17238335	.	G	A	4	5	9	0	1	10	0	0
7	17246018	.	G	A	0	6	6	0	11	17	0	0
7	17246036	.	C	T	11	7	18	0	2	20	0	0
7	17247785	.	T	A	3	19	22	0	0	22	0	0
7	17247804	.	G	C	12	2	14	0	0	14	0	0
7	17247827	.	C	A	0	9	9	0	4	13	0	0
7	17247899	.	A	C	14	6	20	0	1	21	0	0
7	17248022	.	G	A	12	8	20	0	1	21	0	0
7	17248373	.	T	G	16	0	16	0	11	27	0	0
7	17248433	.	G	A	8	12	20	0	1	21	0	0
7	17248436	.	G	A	0	12	12	0	9	21	0	0
7	17248476	.	G	T	12	5	17	0	0	17	0	0
7	17248484	.	A	C	3	11	14	0	0	14	0	0
7	17248579	.	T	C	8	6	14	0	0	14	0	0
7	17248656	.	G	A	14	8	22	0	1	23	0	0
7	17248865	.	T	A	9	7	16	0	1	17	0	0
7	17249121	.	C	T	11	7	18	0	1	19	0	0
7	17249240	.	C	A	5	5	10	0	2	12	0	0
7	17249293	.	A	T	9	6	15	0	1	16	0	0
7	17249392	.	G	A	7	7	14	0	3	17	0	0
7	17249439	.	T	A	4	11	15	0	1	16	0	0
7	17249463	.	C	A	9	3	12	0	0	12	0	0
7	17249534	.	T	C	1	5	6	0	0	6	0	0
7	17249599	.	A	G	2	12	14	0	1	15	0	0
7	17249642	.	C	T	5	14	19	0	0	19	0	0
7	17249829	.	A	T	3	13	16	0	0	16	0	0
7	17249885	.	G	A	5	14	19	7	0	26	0	0
7	17249945	.	A	C	7	18	25	0	0	25	0	0
7	17250191	.	C	T	10	18	28	0	0	28	0	0
7	17250249	.	G	A	0	13	13	0	6	19	0	0
7	17250298	.	C	T	3	5	8	0	0	8	0	0
7	17251098	.	C	A	26	11	37	0	0	37	0	0
7	17251222	.	G	A	2	15	17	0	23	40	0	0
7	17251234	.	A	G	24	15	39	0	1	40	0	0
7	17650751	.	G	C	3	2	5	0	1	6	0	0
7	17650899	.	T	C	2	2	4	2	0	6	0	0
7	17663134	.	C	T	2	3	5	0	0	5	0	0
7	17663289	.	T	C	3	5	8	0	0	8	0	0
7	17690697	.	G	A	1	2	3	0	0	3	0	0
7	17690859	.	T	A	3	4	7	0	0	7	0	0
7	17690892	.	A	T	3	5	8	0	0	8	0	0
7	17692797	.	G	A	6	7	13	0	0	13	0	0
7	17692857	.	T	C	6	3	9	0	1	10	0	0
7	17692920	.	T	C	1	1	2	0	7	9	0	0
7	17695039	.	C	T	7	4	11	0	0	11	0	0
7	17695051	.	A	G	4	5	9	0	0	9	0	0
7	17695425	.	A	G	3	12	15	0	0	15	0	0
7	17702671	.	G	A	3	4	7	0	2	9	0	0
7	17708783	.	C	T	3	5	8	0	0	8	0	0
7	17708811	.	G	A	2	3	5	0	0	5	0	0
7	17708968	.	G	A	3	3	6	0	0	6	0	0
7	17754299	.	G	A	16	21	37	4	3	44	0	0
7	17754537	.	G	A	0	6	6	0	0	6	0	0
7	17754811	.	T	A	3	9	12	1	0	13	0	0
7	17755699	.	C	T	6	3	9	0	1	10	0	0
7	17757019	.	A	G	21	26	47	0	3	50	0	0
7	17757024	.	C	T	27	23	50	0	0	50	0	0
7	17757078	.	A	G	29	27	56	0	1	57	0	0
7	17757243	.	T	G	30	11	41	0	2	43	0	0
7	17757371	.	T	C	22	37	59	0	3	62	0	0
7	17757408	.	G	A	26	22	48	0	1	49	0	0
7	17761063	.	A	C	2	3	5	0	0	5	0	0
7	17761342	.	T	G	1	2	3	0	0	3	0	0
7	17762455	.	C	G	0	2	2	0	3	5	0	0
7	17765269	.	T	C	3	0	3	0	3	6	0	0
7	17766963	.	T	A	4	2	6	0	0	6	0	0
7	17767011	.	G	T	2	4	6	0	0	6	0	0
7	17770871	.	G	A	2	2	4	0	0	4	0	0
7	17772438	.	C	G	2	2	4	0	0	4	0	0
7	17772564	.	C	T	0	1	1	0	2	3	0	0
7	17800748	.	C	T	3	3	6	0	0	6	0	0
7	17800956	.	A	G	2	4	6	0	0	6	0	0
7	17801064	.	A	C	3	3	6	0	0	6	0	0
7	17801841	.	C	T	4	4	8	0	0	8	0	0
7	17801857	.	C	A	4	6	10	0	0	10	0	0
7	17801896	.	T	G	5	7	12	0	0	12	0	0
7	17801900	.	A	G	5	0	5	0	7	12	0	0
7	17802405	.	G	A	2	2	4	0	0	4	0	0
7	17802452	.	T	C	1	3	4	0	0	4	0	0
7	17803355	.	T	A	2	1	3	0	0	3	0	0
7	17803374	.	T	G	2	3	5	0	0	5	0	0
7	17805586	.	G	C	6	0	6	0	3	9	0	0
7	17805595	.	T	A	8	3	11	0	0	11	0	0
7	17805706	.	C	G	7	4	11	0	0	11	0	0
7	17809860	.	C	T	6	9	15	0	1	16	0	0
7	17810581	.	C	T	7	3	10	0	0	10	0	0
7	17810611	.	G	A	8	3	11	0	0	11	0	0
7	17810624	.	C	T	11	6	17	0	0	17	0	0
7	17812892	.	T	A	7	7	14	0	0	14	0	0
7	17813283	.	A	G	10	13	23	0	1	24	0	0
7	17813987	.	T	C	8	0	8	0	5	13	0	0
7	17933314	.	C	G	9	10	19	0	0	19	0	0
7	17933323	.	C	T	7	7	14	0	0	14	0	0
7	17933350	.	G	A	2	6	8	0	17	25	0	0
7	17933362	.	A	G	17	0	17	0	7	24	0	0
7	17933413	.	T	A	11	12	23	0	0	23	0	0
7	17933777	.	G	A	4	14	18	0	15	33	0	0
7	17936753	.	C	G	20	15	35	0	2	37	0	0
7	17936795	.	G	A	1	21	22	0	16	38	0	0
7	17938069	.	C	A	21	13	34	0	0	34	0	0
7	17941936	.	C	T	13	10	23	0	2	25	0	0
7	17942370	.	G	A	6	10	16	0	0	16	0	0
7	17942482	.	A	G	4	3	7	0	0	7	0	0
7	17942540	.	A	G	4	2	6	0	0	6	0	0
7	17942883	.	T	G	21	11	32	0	0	32	0	0
7	17943078	.	A	G	13	9	22	0	1	23	0	0
7	17943133	.	C	T	18	10	28	0	0	28	0	0
7	17943170	.	G	A	3	13	16	0	20	36	0	0
7	17943376	.	C	G	17	6	23	0	4	27	0	0
7	17943509	.	A	G	17	1	18	0	22	40	0	0
7	17953895	.	T	G	2	6	8	0	0	8	0	0
7	17953986	.	G	A	3	4	7	0	0	7	0	0
7	17957514	.	C	A	2	2	4	0	0	4	0	0
7	17957770	.	C	A	4	4	8	0	0	8	0	0
7	17958994	.	G	A	4	2	6	0	0	6	0	0
7	17963815	.	C	T	9	3	12	0	0	12	0	0
7	17965749	.	G	A	9	5	14	0	0	14	0	0
7	17969145	.	C	T	11	8	19	0	0	19	0	0
7	17969461	.	T	A	4	5	9	0	0	9	0	0
7	17969679	.	A	G	1	2	3	0	0	3	0	0
7	17969720	.	C	T	4	3	7	0	0	7	0	0
7	17969792	.	A	G	4	2	6	0	0	6	0	0
7	17969793	.	A	G	4	2	6	0	0	6	0	0
7	17969851	.	A	G	6	3	9	0	0	9	0	0
7	17969883	.	G	C	0	4	4	0	4	8	0	0
7	17970016	.	C	T	5	3	8	0	0	8	0	0
7	17970124	.	T	A	3	3	6	1	0	7	0	0
7	17970186	.	G	A	5	4	9	0	0	9	0	0
7	17970654	.	G	A	3	4	7	0	0	7	0	0
7	18060756	.	T	C	2	2	4	0	0	4	0	0
7	18066556	.	A	G	2	3	5	0	0	5	0	0
7	18066598	.	G	A	4	4	8	0	0	8	0	0
7	18072322	.	C	G	2	2	4	0	0	4	0	0
7	18072762	.	C	A	2	2	4	0	0	4	0	0
7	18072797	.	T	G	2	2	4	0	0	4	0	0
7	18072800	.	C	T	1	2	3	0	1	4	0	0
7	18114316	.	G	A	8	31	39	0	36	75	0	0
7	18114495	.	C	T	21	22	43	0	5	48	0	0
7	18114518	.	A	T	10	15	25	0	12	37	0	0
7	18115220	.	T	A	21	21	42	0	1	43	0	0
7	18115261	.	G	T	20	24	44	0	0	44	0	0
7	18115302	.	G	A	0	25	25	0	19	44	0	0
7	18115470	.	C	T	27	20	47	0	1	48	0	0
7	18115721	.	G	A	2	23	25	0	22	47	0	0
7	18116037	.	C	T	11	7	18	0	0	18	0	0
7	18116204	.	G	A	33	17	50	0	2	52	0	0
7	18122445	.	C	G	7	5	12	0	1	13	0	0
7	18122541	.	G	C	27	2	29	0	18	47	0	0
7	18124218	.	C	T	20	15	35	0	0	35	0	0
7	18124314	.	C	T	14	20	34	0	1	35	0	0
7	18124329	.	T	A	16	17	33	0	0	33	0	0
7	18137325	.	C	T	3	23	26	0	22	48	0	0
7	18146699	.	T	G	17	9	26	0	1	27	0	0
7	18168253	.	T	A	18	18	36	0	1	37	0	0
7	18168419	.	A	T	2	3	5	0	1	6	0	0
7	18366865	.	T	A	2	3	5	0	0	5	0	0
7	18366932	.	T	C	1	2	3	0	0	3	0	0
7	18366936	.	A	T	1	1	2	0	0	2	0	0
7	18367075	.	A	C	2	3	5	0	0	5	0	0
7	18367165	.	A	T	1	2	3	0	1	4	0	0
7	18413054	.	G	T	4	3	7	0	0	7	0	0
7	18413086	.	G	T	7	2	9	0	0	9	0	0
7	18413585	.	A	C	6	3	9	0	0	9	0	0
7	18413798	.	G	A	3	3	6	0	1	7	0	0
7	18414158	.	A	G	1	2	3	0	0	3	0	0
7	18414163	.	A	G	1	2	3	0	0	3	0	0
7	18415009	.	A	T	5	3	8	0	0	8	0	0
7	18415905	.	C	T	4	2	6	0	0	6	0	0
7	18416136	.	G	A	5	8	13	0	1	14	0	0
7	18416191	.	C	A	11	2	13	0	0	13	0	0
7	18416769	.	C	T	0	2	2	0	5	7	0	0
7	18416779	.	A	T	6	2	8	0	0	8	0	0
7	18416804	.	C	A	1	4	5	0	0	5	0	0
7	18416830	.	G	A	1	2	3	0	0	3	0	0
7	18462498	.	A	G	0	4	4	0	2	6	0	0
7	18462733	.	G	A	4	5	9	0	0	9	0	0
7	18463132	.	T	A	3	5	8	0	1	9	0	0
7	18463259	.	T	C	2	2	4	0	0	4	0	0
7	18463488	.	A	T	4	8	12	0	0	12	0	0
7	18463589	.	A	T	2	3	5	0	0	5	0	0
7	18464352	.	G	A	1	2	3	0	0	3	0	0
7	18464919	.	C	T	7	7	14	0	0	14	0	0
7	18465000	.	G	A	9	11	20	0	0	20	0	0
7	18465096	.	A	G	12	10	22	0	0	22	0	0
7	18465435	.	T	G	10	9	19	0	0	19	0	0
7	18470277	.	G	A	2	5	7	0	2	9	0	0
7	18470294	.	G	T	6	3	9	0	0	9	0	0
7	18470314	.	C	T	5	5	10	0	1	11	0	0
7	18470573	.	C	A	5	6	11	0	1	12	0	0
7	18470813	.	C	A	6	6	12	0	1	13	0	0
7	18474945	.	G	A	2	2	4	0	0	4	0	0
7	18474994	.	C	T	4	3	7	0	0	7	0	0
7	18475150	.	C	G	1	2	3	1	1	5	0	0
7	18482163	.	G	A	2	2	4	0	1	5	0	0
7	18550622	.	G	A	3	2	5	0	0	5	0	0
7	18558504	.	C	T	8	8	16	0	1	17	0	0
7	18558806	.	A	T	11	7	18	0	1	19	0	0
7	18558871	.	G	A	12	10	22	0	0	22	0	0
7	18558906	.	T	G	13	10	23	0	0	23	0	0
7	18559197	.	G	T	6	5	11	0	0	12	1	0
7	18559212	.	C	A	9	6	15	0	0	15	0	0
7	18559258	.	A	G	9	10	19	0	1	20	0	0
7	18559548	.	C	T	4	10	14	0	0	14	0	0
7	18560013	.	C	A	8	6	14	0	0	14	0	0
7	18560047	.	G	A	7	7	14	0	0	14	0	0
7	18560397	.	C	T	0	10	10	0	2	12	0	0
7	18560474	.	C	T	2	6	8	0	5	13	0	0
7	18560478	.	T	A	6	5	11	0	2	13	0	0
7	18560952	.	C	T	0	14	14	0	9	23	0	0
7	18564318	.	G	A	12	7	19	0	0	19	0	0
7	18594557	.	T	C	15	3	18	0	14	32	0	0
7	18598610	.	C	T	13	12	25	0	1	26	0	0
7	18607852	.	T	A	4	2	6	0	0	6	0	0
7	18618113	.	T	A	7	6	13	0	0	13	0	0
7	18618608	.	T	A	3	2	5	0	0	5	0	0
7	18618776	.	T	C	6	6	12	0	1	13	0	0
7	18618860	.	T	C	3	0	3	0	8	11	0	0
7	18618927	.	T	C	16	4	20	0	0	20	0	0
7	18619661	.	G	A	6	5	11	0	1	12	0	0
7	18619956	.	T	A	4	2	6	0	0	6	0	0
7	18619990	.	C	T	3	4	7	0	0	7	0	0
7	18620018	.	G	A	3	2	5	0	0	5	0	0
7	18620223	.	C	T	2	9	11	0	11	22	0	0
7	18620273	.	T	C	7	7	14	0	0	14	0	0
7	18620481	.	C	A	3	5	8	0	0	8	0	0
7	18645360	.	G	A	5	6	11	0	1	12	0	0
7	18650823	.	C	G	7	3	10	0	0	10	0	0
7	18655921	.	G	A	9	8	17	0	0	17	0	0
7	18655949	.	T	G	7	6	13	0	0	14	1	0
7	18656025	.	G	A	7	6	13	0	0	13	0	0
7	18705728	.	G	A	3	6	9	0	0	9	0	0
7	18710367	.	T	G	6	4	10	0	0	10	0	0
7	18712511	.	C	T	5	1	6	0	1	7	0	0
7	18726223	.	A	G	1	2	3	0	1	4	0	0
7	18727025	.	C	A	1	2	3	0	0	3	0	0
7	18727387	.	A	T	1	2	3	0	0	3	0	0
7	18780119	.	A	G	4	4	8	0	0	8	0	0
7	18780196	.	A	G	7	4	11	0	2	13	0	0
7	18810675	.	A	G	9	4	13	0	0	13	0	0
7	18810710	.	C	T	7	3	10	0	0	10	0	0
7	18810768	.	C	A	2	8	10	0	4	14	0	0
7	18810926	.	T	C	7	4	11	0	1	12	0	0
7	18810971	.	C	T	2	6	8	0	5	13	0	0
7	18810990	.	C	A	4	5	9	0	0	9	0	0
7	18811128	.	A	G	5	10	15	0	0	16	1	0
7	18876417	.	A	C	4	5	9	0	0	9	0	0
7	18876519	.	G	A	6	4	10	0	0	10	0	0
7	18941773	.	C	T	1	2	3	0	0	3	0	0
7	18945062	.	T	C	3	1	4	0	0	4	0	0
7	18945068	.	C	A	3	2	5	0	0	5	0	0
7	18971066	.	G	T	2	2	4	0	0	4	0	0
7	18971068	.	C	A	1	2	3	0	0	3	0	0
7	18980857	.	T	C	1	3	4	0	0	4	0	0
7	18983123	.	G	A	1	3	4	0	1	5	0	0
7	19028850	.	G	A	8	2	10	0	2	12	0	0
7	19028857	.	A	T	9	3	12	0	0	12	0	0
7	19055605	.	C	T	23	21	44	0	0	44	0	0
7	19065861	.	A	G	13	22	35	0	0	35	0	0
7	19070994	.	C	T	0	14	14	0	13	27	0	0
7	19071420	.	T	C	13	0	13	0	10	23	0	0
7	19071617	.	T	C	13	4	17	0	1	18	0	0
7	19071639	.	C	A	10	7	17	0	1	18	0	0
7	19072139	.	T	C	3	8	11	0	0	11	0	0
7	19072767	.	T	A	4	4	8	0	0	8	0	0
7	19073202	.	T	C	6	2	8	0	2	10	0	0
7	19073481	.	T	C	14	9	23	0	1	24	0	0
7	19073495	.	G	A	13	10	23	0	2	25	0	0
7	19073563	.	A	T	7	12	19	0	0	19	0	0
7	19073576	.	T	A	6	10	16	0	0	16	0	0
7	19073788	.	T	C	3	13	16	0	1	17	0	0
7	19073818	.	T	C	4	10	14	0	1	15	0	0
7	19073833	.	G	A	9	5	14	0	0	14	0	0
7	19073918	.	G	A	9	7	16	0	1	17	0	0
7	19074041	.	G	A	11	9	20	0	0	20	0	0
7	19074056	.	T	C	14	8	22	0	0	22	0	0
7	19074173	.	C	T	13	12	25	0	2	27	0	0
7	19074194	.	A	T	12	7	19	0	2	21	0	0
7	19074270	.	G	A	5	7	12	0	0	12	0	0
7	19074363	.	T	C	11	8	19	0	0	19	0	0
7	19075025	.	C	T	2	8	10	0	10	20	0	0
7	19075058	.	T	C	6	0	6	0	11	17	0	0
7	19075591	.	T	C	11	5	16	0	0	16	0	0
7	19075605	.	A	C	12	7	19	0	0	19	0	0
7	19075760	.	A	G	1	5	6	0	1	7	0	0
7	19075849	.	G	A	4	2	6	0	0	6	0	0
7	19076219	.	C	T	4	7	11	0	1	12	0	0
7	19076415	.	C	T	3	2	5	0	0	5	0	0
7	19076419	.	G	A	3	2	5	0	0	5	0	0
7	19076536	.	A	G	7	7	14	0	1	15	0	0
7	19076550	.	G	A	5	8	13	0	0	13	0	0
7	19076759	.	C	A	4	5	9	0	0	9	0	0
7	19077092	.	G	A	10	10	20	0	1	21	0	0
7	19083600	.	G	A	4	11	15	0	0	15	0	0
7	19095988	.	C	A	0	3	3	0	5	8	0	0
7	19099986	.	G	A	3	2	5	0	0	5	0	0
7	19101929	.	C	T	0	4	4	0	6	10	0	0
7	19180152	.	T	A	1	3	4	0	0	4	0	0
7	19397626	.	T	C	6	2	8	0	0	8	0	0
7	19745853	.	G	A	1	9	10	0	6	16	0	0
7	19753008	.	C	A	11	12	23	0	0	23	0	0
7	19753702	.	C	T	8	13	21	0	2	23	0	0
7	19759079	.	G	T	11	10	21	0	1	22	0	0
7	19759194	.	C	A	12	10	22	0	0	22	0	0
7	19759209	.	G	A	0	6	6	0	11	17	0	0
7	19759296	.	C	T	10	4	14	0	0	14	0	0
7	19759299	.	A	T	9	4	13	0	0	13	0	0
7	19759550	.	C	T	7	5	12	0	0	12	0	0
7	19851480	.	C	T	4	2	6	0	0	6	0	0
7	19860967	.	T	C	2	2	4	0	0	4	0	0
7	19864504	.	G	A	0	2	2	0	1	3	0	0
7	19891283	.	A	G	1	2	3	0	0	3	0	0
7	19891365	.	A	G	5	0	5	0	4	9	0	0
7	19891551	.	G	A	9	4	13	0	0	13	0	0
7	19891779	.	G	C	3	6	9	0	0	9	0	0
7	19892265	.	C	T	8	8	16	0	0	16	0	0
7	19892592	.	A	G	7	0	7	0	10	17	0	0
7	19892880	.	G	A	0	6	6	0	5	11	0	0
7	19893023	.	A	G	3	4	7	0	0	7	0	0
7	19893149	.	T	G	5	9	14	0	0	14	0	0
7	19893290	.	C	G	2	3	5	0	0	5	0	0
7	19893463	.	A	G	4	5	9	0	0	9	0	0
7	19893573	.	T	A	6	6	12	0	0	12	0	0
7	19893623	.	A	C	2	5	7	1	0	8	0	0
7	19893705	.	A	T	6	6	12	0	0	12	0	0
7	19894016	.	A	G	7	4	11	0	0	11	0	0
7	19894099	.	A	G	4	0	4	0	6	10	0	0
7	19894114	.	G	A	0	5	5	0	4	9	0	0
7	19894322	.	T	G	7	5	12	0	0	12	0	0
7	19895088	.	G	A	0	4	4	0	15	19	0	0
7	19895139	.	G	C	9	4	13	0	0	13	0	0
7	19895268	.	G	A	2	4	6	0	1	7	0	0
7	19895683	.	C	T	7	4	11	0	0	11	0	0
7	19895919	.	C	G	1	2	3	0	0	3	0	0
7	19895958	.	G	A	1	3	4	0	0	4	0	0
7	19895963	.	G	T	1	3	4	0	0	4	0	0
7	19896400	.	A	C	5	5	10	0	0	10	0	0
7	19896628	.	G	A	11	3	14	0	0	14	0	0
7	19896642	.	G	T	8	4	12	0	0	12	0	0
7	19897309	.	C	T	7	12	19	0	1	20	0	0
7	19897830	.	C	T	8	2	10	0	1	11	0	0
7	19897959	.	T	C	6	12	18	0	2	20	0	0
7	19965281	.	G	A	5	6	11	0	1	12	0	0
7	19965721	.	T	A	11	8	19	0	1	20	0	0
7	19966252	.	G	A	4	7	11	0	0	11	0	0
7	19966273	.	T	G	5	6	11	0	0	11	0	0
7	19978616	.	G	A	3	8	11	0	1	12	0	0
7	19978847	.	G	A	2	3	5	0	0	5	0	0
7	19979028	.	C	T	2	7	9	0	0	9	0	0
7	19979133	.	C	T	3	2	5	0	0	5	0	0
7	19979200	.	A	G	3	6	9	0	0	9	0	0
7	19979561	.	C	T	0	2	2	0	5	7	0	0
7	19979575	.	G	T	4	2	6	0	0	6	0	0
7	19979669	.	G	A	5	4	9	0	0	9	0	0
7	19979876	.	A	C	3	0	3	0	7	10	0	0
7	19979943	.	A	T	7	7	14	1	0	15	0	0
7	19979968	.	C	A	2	4	6	1	10	17	0	0
7	19984249	.	A	G	4	4	8	0	0	8	0	0
7	19986080	.	A	T	5	3	8	0	0	8	0	0
7	19988581	.	G	A	5	8	13	0	1	14	0	0
7	19991770	.	T	C	3	0	3	0	4	7	0	0
7	19991783	.	G	T	3	4	7	0	1	8	0	0
7	19998621	.	A	G	6	8	14	0	0	14	0	0
7	20024319	.	G	A	1	3	4	0	1	5	0	0
7	20024358	.	C	T	1	2	3	0	0	3	0	0
7	20024364	.	G	A	2	2	4	0	0	4	0	0
7	20026875	.	A	G	4	2	6	0	0	6	0	0
7	20027251	.	G	A	0	1	1	0	2	3	0	0
7	20027595	.	A	T	3	5	8	0	0	8	0	0
7	20027717	.	G	A	3	4	7	0	0	7	0	0
7	20027943	.	T	C	1	2	3	0	0	3	0	0
7	20027961	.	C	T	0	3	3	0	0	3	0	0
7	20054381	.	C	T	3	3	6	0	0	6	0	0
7	20118228	.	C	G	16	10	26	0	0	26	0	0
7	20118330	.	T	C	7	12	19	0	3	23	1	0
7	20141697	.	T	C	14	15	29	0	2	31	0	0
7	20141823	.	A	G	9	8	17	0	0	17	0	0
7	20141916	.	T	C	6	9	15	0	0	15	0	0
7	20142253	.	A	T	3	3	6	0	0	6	0	0
7	20142360	.	A	G	1	2	3	0	0	3	0	0
7	20142361	.	A	T	1	2	3	0	0	3	0	0
7	20142497	.	T	A	1	3	4	0	0	4	0	0
7	20176444	.	A	T	4	3	7	0	1	8	0	0
7	20222385	.	A	G	10	9	19	0	0	19	0	0
7	20222861	.	C	G	2	4	6	0	1	7	0	0
7	20222949	.	A	C	1	3	4	0	0	4	0	0
7	20222993	.	A	T	3	4	7	0	0	7	0	0
7	20223074	.	G	A	10	8	18	0	0	18	0	0
7	20223079	.	A	G	12	8	20	0	0	20	0	0
7	20223110	.	G	A	11	4	15	0	1	16	0	0
7	20223208	.	G	C	1	3	4	0	0	4	0	0
7	20223384	.	A	C	7	6	13	0	0	13	0	0
7	20223385	.	C	T	6	6	12	0	1	13	0	0
7	20223478	.	T	A	8	7	15	0	1	16	0	0
7	20223568	.	C	T	9	11	20	0	0	20	0	0
7	20223632	.	C	T	7	9	16	0	0	16	0	0
7	20223880	.	G	A	0	3	3	0	2	5	0	0
7	20292791	.	C	T	1	2	3	0	1	4	0	0
7	20294433	.	C	T	1	3	4	0	0	4	0	0
7	20298563	.	A	T	10	6	16	0	0	17	1	0
7	20298577	.	A	G	10	7	17	0	0	17	0	0
7	20298598	.	A	T	10	11	21	0	0	21	0	0
7	20298670	.	T	C	5	4	9	0	1	10	0	0
7	20298709	.	A	C	3	2	5	0	0	5	0	0
7	20298789	.	C	G	10	16	26	0	0	26	0	0
7	20298851	.	C	G	7	6	13	0	1	14	0	0
7	20301839	.	C	T	12	17	29	0	0	29	0	0
7	20302952	.	A	G	12	14	26	0	1	27	0	0
7	20305694	.	C	T	9	8	17	0	0	17	0	0
7	20305697	.	C	T	8	7	15	0	2	17	0	0
7	20310893	.	T	C	13	9	22	0	0	22	0	0
7	20310929	.	T	C	14	11	25	0	0	25	0	0
7	20315913	.	G	A	16	8	24	0	0	24	0	0
7	20325995	.	C	T	10	12	22	0	6	28	0	0
7	20326405	.	T	C	11	16	27	0	1	28	0	0
7	20332513	.	T	C	12	15	27	0	0	27	0	0
7	20332775	.	A	T	10	10	20	0	2	22	0	0
7	20332784	.	G	A	12	11	23	0	1	24	0	0
7	20332959	.	G	A	15	10	25	0	0	25	0	0
7	20332963	.	G	A	15	9	24	0	0	24	0	0
7	20333061	.	A	G	10	0	10	0	13	23	0	0
7	20333076	.	C	A	7	11	18	0	0	18	0	0
7	20333120	.	A	C	8	8	16	0	0	16	0	0
7	20333276	.	T	G	4	12	16	0	0	16	0	0
7	20334388	.	A	C	1	2	3	0	1	4	0	0
7	20334603	.	T	C	2	6	8	0	0	8	0	0
7	20334891	.	T	G	2	4	6	0	0	6	0	0
7	20335035	.	C	T	1	3	4	0	0	4	0	0
7	20335247	.	G	C	0	3	3	0	4	7	0	0
7	20335283	.	T	C	3	3	6	0	1	7	0	0
7	20335323	.	G	A	0	3	3	0	1	4	0	0
7	20335331	.	A	G	1	2	3	0	0	3	0	0
7	20524110	.	T	C	4	2	6	0	0	6	0	0
7	20529043	.	A	C	3	6	9	0	1	10	0	0
7	20529155	.	A	G	13	5	18	0	0	18	0	0
7	20529578	.	A	C	7	9	16	0	0	16	0	0
7	20529725	.	C	T	16	12	28	0	1	29	0	0
7	20529728	.	G	A	13	12	25	0	2	27	0	0
7	20529760	.	C	T	13	12	25	0	1	26	0	0
7	20529773	.	T	C	9	12	21	0	0	21	0	0
7	20530284	.	A	T	8	6	14	0	0	14	0	0
7	20530314	.	G	A	7	4	11	0	0	11	0	0
7	20530338	.	C	T	4	5	9	0	0	9	0	0
7	20530373	.	T	A	1	4	5	0	0	6	1	0
7	20537117	.	A	G	2	1	3	0	1	4	0	0
7	20537118	.	T	C	2	2	4	0	0	4	0	0
7	20539326	.	C	A	7	3	10	0	1	11	0	0
7	20539345	.	A	G	6	5	11	0	1	12	0	0
7	20540284	.	C	T	8	5	13	0	0	13	0	0
7	20540299	.	T	C	8	2	10	0	0	10	0	0
7	20542251	.	G	A	7	3	10	0	0	10	0	0
7	20587681	.	G	T	6	5	11	0	0	11	0	0
7	20587685	.	T	G	7	6	13	0	0	13	0	0
7	20587812	.	T	C	5	6	11	0	0	11	0	0
7	20588229	.	G	A	9	6	15	0	1	16	0	0
7	20588280	.	C	G	7	9	16	0	2	18	0	0
7	20593682	.	G	A	1	13	14	0	5	19	0	0
7	20593809	.	G	A	11	11	22	0	3	25	0	0
7	20597033	.	G	A	7	5	12	0	0	12	0	0
7	20597132	.	C	T	8	3	11	0	0	11	0	0
7	20600211	.	T	A	7	9	16	0	0	17	1	0
7	20600447	.	A	G	4	0	4	0	8	12	0	0
7	20601052	.	G	A	6	7	13	0	0	13	0	0
7	20601072	.	T	C	6	6	12	0	0	12	0	0
7	20601192	.	C	T	3	7	10	0	0	10	0	0
7	20601250	.	A	G	5	5	10	0	4	14	0	0
7	20601325	.	A	G	3	9	12	0	0	12	0	0
7	20601410	.	T	A	1	4	5	0	0	5	0	0
7	20601524	.	G	A	2	4	6	0	0	6	0	0
7	20601539	.	T	C	2	4	6	0	0	6	0	0
7	20601578	.	T	C	1	4	5	0	2	7	0	0
7	20601583	.	T	C	3	4	7	0	0	7	0	0
7	20601713	.	A	T	3	3	6	0	0	6	0	0
7	20601835	.	G	T	8	5	13	0	1	14	0	0
7	20601907	.	A	T	12	4	16	0	0	16	0	0
7	20602053	.	T	C	1	2	3	0	6	9	0	0
7	20605541	.	C	T	8	3	11	0	1	12	0	0
7	20605661	.	A	G	10	5	15	0	0	15	0	0
7	20629684	.	T	C	3	7	10	0	0	10	0	0
7	20629792	.	G	A	9	14	23	0	0	23	0	0
7	20629801	.	A	G	7	14	21	0	1	22	0	0
7	20633683	.	A	C	5	11	16	0	3	19	0	0
7	20633686	.	T	A	6	14	20	0	0	20	0	0
7	20634045	.	A	G	2	1	3	10	2	15	0	0
7	20634202	.	C	G	7	10	17	0	1	18	0	0
7	20634444	.	A	T	4	7	11	0	0	11	0	0
7	20634498	.	T	A	8	17	25	0	0	25	0	0
7	20634577	.	T	G	12	20	32	0	1	33	0	0
7	20635475	.	A	G	11	18	29	0	0	29	0	0
7	20635495	.	T	A	8	12	20	0	0	20	0	0
7	20635519	.	A	G	13	8	21	0	0	21	0	0
7	20635616	.	T	C	5	12	17	0	0	17	0	0
7	20635760	.	A	G	6	6	12	0	1	13	0	0
7	20636344	.	A	G	5	14	19	0	0	19	0	0
7	20636379	.	A	T	4	14	18	0	1	19	0	0
7	20636410	.	C	T	5	16	21	0	1	22	0	0
7	20636414	.	T	G	5	16	21	0	0	21	0	0
7	20636464	.	G	A	7	19	26	0	0	26	0	0
7	20636465	.	A	G	7	19	26	0	1	27	0	0
7	20636802	.	T	G	10	10	20	0	0	20	0	0
7	20636833	.	A	G	8	11	19	0	2	21	0	0
7	20636844	.	T	A	10	11	21	0	0	22	1	0
7	20664621	.	A	T	3	4	7	0	0	7	0	0
7	20664794	.	T	C	3	4	7	0	0	7	0	0
7	20693673	.	G	T	24	21	45	0	0	45	0	0
7	20695949	.	G	T	26	16	42	0	1	43	0	0
7	20698208	.	T	A	12	13	25	0	1	26	0	0
7	20712555	.	C	T	16	10	26	0	0	26	0	0
7	20715178	.	G	A	25	16	41	0	2	43	0	0
7	20715434	.	C	T	16	9	25	0	1	26	0	0
7	20715485	.	A	G	11	9	20	0	0	20	0	0
7	20731052	.	C	T	15	11	26	0	4	30	0	0
7	20731166	.	A	G	19	18	37	0	1	38	0	0
7	20735155	.	G	A	9	7	16	0	0	16	0	0
7	20738148	.	A	G	15	18	33	0	0	33	0	0
7	20743583	.	G	A	14	8	22	0	0	22	0	0
7	20743984	.	C	T	1	12	13	0	8	21	0	0
7	20754669	.	G	A	7	5	12	0	0	12	0	0
7	20772180	.	G	A	5	2	7	0	0	7	0	0
7	20775041	.	A	G	1	2	3	0	0	3	0	0
7	20780285	.	G	A	5	3	8	0	0	8	0	0
7	20780317	.	C	T	13	5	18	0	0	18	0	0
7	20780337	.	A	C	10	5	15	0	0	15	0	0
7	20780356	.	A	G	5	10	15	0	0	15	0	0
7	20780424	.	A	T	6	6	12	0	0	12	0	0
7	20780453	.	C	A	11	2	13	0	0	13	0	0
7	20780732	.	A	C	7	9	16	0	1	17	0	0
7	20780758	.	T	C	11	5	16	0	1	17	0	0
7	20780797	.	T	C	12	6	18	0	0	18	0	0
7	20780918	.	C	T	1	7	8	0	11	19	0	0
7	20780987	.	G	A	7	7	14	0	1	15	0	0
7	20781110	.	C	T	4	2	6	0	0	6	0	0
7	20781327	.	A	G	7	4	11	0	0	11	0	0
7	20781996	.	T	G	4	4	8	0	0	8	0	0
7	20784496	.	C	T	9	6	15	0	0	15	0	0
7	20784772	.	G	A	6	3	9	0	0	9	0	0
7	20787233	.	C	T	5	6	11	0	1	12	0	0
7	20789958	.	T	C	6	3	9	0	0	9	0	0
7	20790042	.	G	A	2	2	4	0	0	4	0	0
7	20790796	.	A	G	9	7	16	0	0	16	0	0
7	20790882	.	G	A	2	3	5	1	1	7	0	0
7	20796929	.	T	C	6	5	11	0	1	12	0	0
7	20859446	.	G	C	11	5	16	1	0	17	0	0
7	20859843	.	T	G	1	4	5	0	0	5	0	0
7	20859975	.	G	A	9	6	15	0	1	16	0	0
7	20860011	.	T	C	8	11	19	0	0	19	0	0
7	20864097	.	A	G	17	10	27	0	0	27	0	0
7	20864256	.	T	C	14	12	26	0	0	26	0	0
7	20876420	.	G	A	4	2	6	0	0	6	0	0
7	20876421	.	G	A	0	5	5	0	0	5	0	0
7	20889840	.	C	A	6	9	15	0	1	16	0	0
7	20890420	.	T	C	7	9	16	0	0	16	0	0
7	20890435	.	C	T	8	8	16	0	0	16	0	0
7	20890715	.	G	A	4	4	8	0	0	8	0	0
7	20890718	.	G	A	5	2	7	0	2	9	0	0
7	20892307	.	A	T	4	9	13	2	1	16	0	0
7	20894701	.	G	A	1	4	5	0	5	10	0	0
7	20897911	.	G	A	5	3	8	0	1	9	0	0
7	20901170	.	C	T	8	5	13	0	2	15	0	0
7	20904582	.	G	A	0	4	4	0	8	12	0	0
7	20924115	.	C	T	2	5	7	0	0	7	0	0
7	20935058	.	T	C	2	4	6	0	1	7	0	0
7	20935547	.	G	A	5	4	9	0	0	9	0	0
7	20935684	.	C	T	2	3	5	0	0	5	0	0
7	20935737	.	T	A	1	4	5	0	1	6	0	0
7	20935765	.	A	G	7	3	10	0	0	10	0	0
7	20966203	.	A	C	6	7	13	0	0	13	0	0
7	20966369	.	G	A	8	3	11	0	0	11	0	0
7	20966508	.	G	T	1	7	8	0	7	15	0	0
7	21626312	.	G	A	1	2	3	0	0	3	0	0
7	21721702	.	C	T	1	2	3	0	0	3	0	0
7	21752348	.	C	A	8	5	13	0	0	13	0	0
7	21752398	.	T	C	5	5	10	0	0	10	0	0
7	21752758	.	A	G	3	4	7	0	0	7	0	0
7	21765244	.	G	A	8	8	16	0	0	16	0	0
7	21765562	.	C	A	11	14	25	0	0	25	0	0
7	21765702	.	T	A	9	8	17	0	1	18	0	0
7	21766917	.	G	A	17	13	30	0	2	32	0	0
7	21766937	.	C	A	17	17	34	0	0	34	0	0
7	21767423	.	A	G	14	13	27	0	3	30	0	0
7	21768002	.	T	C	13	13	26	0	1	27	0	0
7	21768060	.	A	G	11	11	22	0	0	22	0	0
7	21768270	.	G	A	18	9	27	0	2	29	0	0
7	21768334	.	C	A	18	8	26	0	3	29	0	0
7	21768540	.	T	A	10	9	19	0	1	20	0	0
7	21769286	.	T	G	7	8	15	0	0	15	0	0
7	21769318	.	A	G	7	8	15	0	1	16	0	0
7	21769733	.	G	A	7	11	18	0	1	19	0	0
7	21770141	.	A	G	8	0	8	0	11	19	0	0
7	21770567	.	C	T	13	13	26	0	1	27	0	0
7	21770819	.	G	T	1	4	5	0	11	16	0	0
7	21772869	.	A	T	10	19	29	0	2	31	0	0
7	21773542	.	C	T	10	14	24	0	2	26	0	0
7	21773626	.	C	T	11	10	21	0	1	22	0	0
7	21774127	.	G	A	16	18	34	0	0	34	0	0
7	21776426	.	C	T	16	11	27	0	2	29	0	0
7	21776683	.	G	A	18	7	25	0	3	28	0	0
7	21776693	.	T	C	18	7	25	0	0	25	0	0
7	21777203	.	G	T	8	8	16	0	1	17	0	0
7	21777720	.	G	A	17	11	28	0	2	30	0	0
7	21777978	.	T	G	12	13	25	0	4	29	0	0
7	21778055	.	G	A	9	8	17	0	1	18	0	0
7	21778070	.	T	C	5	5	10	0	0	10	0	0
7	21872656	.	G	A	5	2	7	0	0	7	0	0
7	21872716	.	G	A	2	2	4	0	0	4	0	0
7	21872759	.	T	A	4	2	6	0	0	6	0	0
7	21873176	.	G	A	3	4	7	0	0	7	0	0
7	21873266	.	G	A	0	2	2	0	2	4	0	0
7	21873342	.	A	C	2	4	6	0	1	7	0	0
7	21873350	.	G	A	4	3	7	0	1	8	0	0
7	21881863	.	C	T	4	3	7	0	0	7	0	0
7	21884138	.	C	A	0	4	4	0	4	8	0	0
7	21884703	.	C	T	0	2	2	0	6	8	0	0
7	21884799	.	C	T	6	5	11	0	0	11	0	0
7	21887797	.	A	T	37	20	57	0	1	58	0	0
7	21887967	.	C	T	17	20	37	0	1	38	0	0
7	21888084	.	T	A	25	18	43	0	0	43	0	0
7	21888274	.	T	A	15	8	23	0	1	24	0	0
7	21890998	.	C	T	7	5	12	0	1	13	0	0
7	21891031	.	G	A	2	6	8	0	6	14	0	0
7	21891208	.	C	T	9	7	16	0	0	16	0	0
7	21891510	.	T	G	2	4	6	0	0	6	0	0
7	21891540	.	T	G	4	3	7	0	0	7	0	0
7	21917927	.	C	A	4	8	12	0	0	12	0	0
7	21917972	.	C	G	1	3	4	0	0	4	0	0
7	21918235	.	G	A	3	4	7	0	0	7	0	0
7	21918410	.	G	A	1	2	3	0	7	10	0	0
7	21918412	.	T	A	8	2	10	0	0	10	0	0
7	21940965	.	T	G	5	8	13	0	3	16	0	0
7	21940992	.	A	G	8	13	21	0	0	21	0	0
7	21941016	.	T	G	15	16	31	0	1	32	0	0
7	21941460	.	G	A	14	6	20	0	0	20	0	0
7	21941477	.	C	A	7	12	19	0	2	21	0	0
7	21941568	.	C	T	14	8	22	0	1	24	1	0
7	21941579	.	A	C	9	12	21	0	1	23	1	0
7	21942378	.	C	T	15	18	33	0	0	33	0	0
7	21942513	.	A	T	14	17	31	0	1	32	0	0
7	21942644	.	T	A	13	14	27	0	0	27	0	0
7	21942672	.	C	T	18	15	33	0	0	33	0	0
7	21943553	.	A	G	19	15	34	0	0	34	0	0
7	21943625	.	G	A	9	10	19	0	1	20	0	0
7	21943716	.	T	G	10	10	20	0	0	20	0	0
7	21943772	.	T	C	11	11	22	0	0	22	0	0
7	21943886	.	C	A	8	4	12	0	1	13	0	0
7	21944495	.	T	C	11	7	18	0	0	18	0	0
7	21944753	.	G	A	11	14	25	0	1	26	0	0
7	21945257	.	C	T	3	20	23	0	11	34	0	0
7	21945347	.	C	T	1	21	22	1	15	38	0	0
7	21947228	.	G	A	10	8	18	0	4	22	0	0
7	21947237	.	C	T	10	13	23	0	2	25	0	0
7	21951353	.	G	A	9	14	23	1	4	28	0	0
7	21956571	.	A	G	12	9	21	0	0	21	0	0
7	22131815	.	C	T	1	12	13	0	6	19	0	0
7	22132134	.	A	G	13	9	22	0	0	22	0	0
7	22324727	.	A	G	1	5	6	0	0	6	0	0
7	22793530	.	T	G	13	0	13	0	26	40	1	0
7	22891912	.	C	T	1	2	3	0	0	3	0	0
7	23907703	.	T	G	3	0	3	0	4	7	0	0
7	23907784	.	G	T	25	28	53	0	0	53	0	0
7	23909369	.	A	C	23	29	52	0	1	53	0	0
7	23909456	.	T	G	23	25	48	0	3	51	0	0
7	23915104	.	G	A	3	30	33	1	23	57	0	0
7	23915296	.	C	T	24	33	57	0	3	60	0	0
7	23915359	.	G	A	6	29	35	0	31	66	0	0
7	23915379	.	T	A	27	33	60	0	3	64	1	0
7	23915700	.	G	T	20	12	32	0	2	34	0	0
7	23915731	.	G	T	22	19	41	0	2	43	0	0
7	23915926	.	C	T	28	31	59	0	1	60	0	0
7	23915963	.	A	G	26	1	27	0	28	55	0	0
7	23915964	.	A	T	28	27	55	0	0	55	0	0
7	23967515	.	A	C	12	0	12	0	6	18	0	0
7	23967522	.	G	A	13	6	19	0	0	19	0	0
7	23967591	.	G	A	9	14	23	0	0	23	0	0
7	23967596	.	G	A	9	10	19	0	0	19	0	0
7	23967705	.	G	A	9	4	13	0	0	13	0	0
7	23967772	.	A	G	15	14	29	0	0	29	0	0
7	23967861	.	C	T	1	19	20	0	12	32	0	0
7	23967878	.	G	A	16	17	33	0	0	33	0	0
7	23967930	.	A	G	17	24	41	0	2	43	0	0
7	23968009	.	T	C	14	0	14	0	18	32	0	0
7	23968174	.	A	C	13	15	28	0	0	28	0	0
7	23968267	.	A	C	11	11	22	0	0	22	0	0
7	23968292	.	T	G	10	13	23	0	0	23	0	0
7	23968414	.	A	C	5	5	10	0	0	10	0	0
7	23968777	.	G	A	11	3	14	0	0	14	0	0
7	23968787	.	T	A	14	5	19	0	0	19	0	0
7	23969226	.	G	A	7	6	13	0	0	13	0	0
7	23969446	.	C	T	10	12	22	0	0	22	0	0
7	23969593	.	G	A	15	9	24	4	1	29	0	0
7	23969819	.	A	G	5	4	9	3	0	12	0	0
7	23970196	.	A	G	12	15	27	0	1	28	0	0
7	23970236	.	T	A	10	13	23	0	4	27	0	0
7	23970320	.	G	T	22	19	41	0	0	41	0	0
7	23970331	.	G	A	23	20	43	0	1	44	0	0
7	23970428	.	T	C	13	12	25	0	0	25	0	0
7	23970674	.	T	A	3	5	8	0	0	8	0	0
7	23970695	.	T	C	6	7	13	0	0	13	0	0
7	23971181	.	G	C	1	6	7	0	0	7	0	0
7	23971682	.	T	A	8	14	22	0	0	22	0	0
7	23971714	.	G	C	14	9	23	0	1	24	0	0
7	23971728	.	T	A	9	11	20	0	0	20	0	0
7	23977711	.	T	C	9	5	14	0	0	14	0	0
7	23977905	.	A	C	5	5	10	0	0	10	0	0
7	23979686	.	C	T	7	9	16	0	0	16	0	0
7	23979703	.	C	T	7	9	16	0	0	16	0	0
7	23984264	.	C	T	6	6	12	0	1	13	0	0
7	24006992	.	A	T	5	6	11	0	0	11	0	0
7	24007014	.	T	C	4	4	8	0	0	8	0	0
7	24007097	.	A	G	1	4	5	0	2	7	0	0
7	24007222	.	T	C	4	6	10	1	1	12	0	0
7	24011474	.	C	A	4	8	12	0	1	13	0	0
7	24011926	.	T	C	6	7	13	0	0	13	0	0
7	24013269	.	G	A	4	6	10	0	0	10	0	0
7	24013489	.	G	A	0	8	8	0	7	15	0	0
7	24033639	.	C	G	4	5	9	0	0	9	0	0
7	24041600	.	G	A	1	6	7	0	0	7	0	0
7	24041627	.	T	C	6	0	6	0	6	12	0	0
7	24043250	.	C	T	7	6	13	0	0	13	0	0
7	24043391	.	G	A	5	5	10	0	0	10	0	0
7	24052845	.	T	A	3	3	6	0	1	7	0	0
7	24053314	.	G	A	5	3	8	0	0	8	0	0
7	24053451	.	G	A	2	5	7	0	0	7	0	0
7	24053526	.	T	C	2	2	4	0	0	4	0	0
7	24053553	.	A	G	3	4	7	0	0	7	0	0
7	24053575	.	A	G	5	0	5	0	4	9	0	0
7	24053673	.	A	G	8	7	15	0	0	15	0	0
7	24053689	.	C	T	8	8	16	0	1	17	0	0
7	24059449	.	T	A	5	3	8	0	0	8	0	0
7	24059570	.	C	T	7	9	16	0	2	18	0	0
7	24059705	.	G	A	5	5	10	0	1	11	0	0
7	24059861	.	C	G	6	3	9	0	0	9	0	0
7	24059873	.	C	T	6	3	9	0	1	10	0	0
7	24060071	.	A	C	8	5	13	0	2	15	0	0
7	24060107	.	G	T	4	3	7	0	2	9	0	0
7	24066825	.	C	T	1	5	6	0	1	7	0	0
7	24067056	.	G	T	3	6	9	0	0	9	0	0
7	24068078	.	T	G	5	5	10	0	0	10	0	0
7	24068224	.	A	T	4	6	10	0	1	11	0	0
7	24068669	.	T	G	1	2	3	0	0	3	0	0
7	24069484	.	T	C	8	4	12	0	0	12	0	0
7	24069592	.	A	G	8	8	16	0	0	16	0	0
7	24069598	.	G	A	8	7	15	0	0	15	0	0
7	24072217	.	C	T	6	5	11	0	0	11	0	0
7	24075155	.	C	G	8	3	11	0	0	11	0	0
7	24075776	.	C	T	7	16	23	0	1	24	0	0
7	24075842	.	A	C	14	10	24	0	3	27	0	0
7	24075911	.	G	A	13	6	19	0	1	20	0	0
7	24076009	.	A	T	11	8	19	0	0	19	0	0
7	24076044	.	A	C	9	13	22	0	1	23	0	0
7	24076086	.	C	A	10	9	19	0	0	19	0	0
7	24076088	.	A	G	9	9	18	0	0	18	0	0
7	24076269	.	C	T	9	7	16	0	0	16	0	0
7	24076329	.	C	T	14	8	22	0	0	22	0	0
7	24076373	.	C	T	13	6	19	0	0	19	0	0
7	24084783	.	C	T	21	18	39	0	3	42	0	0
7	24084879	.	C	T	10	10	20	0	1	21	0	0
7	24087362	.	A	T	8	5	13	0	0	13	0	0
7	24087365	.	T	C	6	8	14	0	1	15	0	0
7	24087724	.	C	A	6	3	9	0	0	9	0	0
7	24090182	.	G	A	21	8	29	0	1	30	0	0
7	24091054	.	G	A	20	17	37	0	0	37	0	0
7	24091269	.	G	A	2	14	16	0	11	27	0	0
7	24092626	.	C	T	9	13	22	0	0	22	0	0
7	24093165	.	C	G	21	15	36	0	0	36	0	0
7	24093300	.	C	T	16	18	34	1	0	35	0	0
7	24093301	.	A	C	15	16	31	1	3	35	0	0
7	24093372	.	A	G	22	21	43	0	1	44	0	0
7	24095515	.	C	G	16	20	36	0	1	38	1	0
7	24095717	.	G	A	1	12	13	0	20	33	0	0
7	24095776	.	G	A	16	13	29	0	2	31	0	0
7	24095788	.	A	G	18	15	33	0	0	33	0	0
7	24095836	.	C	T	10	17	27	0	0	27	0	0
7	24095848	.	G	A	18	16	34	0	0	34	0	0
7	24095883	.	T	A	17	21	38	0	0	38	0	0
7	24095926	.	A	C	13	18	31	0	1	32	0	0
7	24095978	.	T	A	16	16	32	0	3	35	0	0
7	24096399	.	C	A	12	17	29	0	1	30	0	0
7	24096505	.	G	A	3	11	14	0	10	24	0	0
7	24096541	.	C	T	13	10	23	0	2	25	0	0
7	24096767	.	A	C	14	17	31	0	2	33	0	0
7	24110161	.	C	T	1	2	3	0	0	3	0	0
7	24115186	.	G	A	11	13	24	0	0	24	0	0
7	24124479	.	C	T	3	2	5	0	0	5	0	0
7	24153885	.	G	A	4	3	7	0	1	8	0	0
7	24154878	.	C	T	4	3	7	0	0	7	0	0
7	24156373	.	A	G	2	4	6	0	1	7	0	0
7	24156994	.	G	A	1	3	4	0	4	8	0	0
7	24158918	.	G	A	3	5	8	0	4	12	0	0
7	24159155	.	G	T	6	4	10	0	1	11	0	0
7	24159248	.	C	A	3	5	8	0	1	9	0	0
7	24159284	.	G	A	7	5	12	0	0	12	0	0
7	24161591	.	C	A	8	10	18	0	5	23	0	0
7	24161648	.	G	A	2	8	10	0	12	22	0	0
7	24162019	.	G	A	5	6	11	0	0	11	0	0
7	24162034	.	C	T	3	4	7	0	0	7	0	0
7	24162368	.	A	T	9	7	16	0	1	17	0	0
7	24162369	.	A	C	8	7	15	0	2	17	0	0
7	24162485	.	C	T	12	14	26	0	1	27	0	0
7	24162567	.	T	C	6	4	10	1	1	12	0	0
7	24162761	.	G	T	4	2	6	0	0	6	0	0
7	24197574	.	C	A	5	3	8	0	0	8	0	0
7	24197814	.	G	A	3	2	5	0	0	5	0	0
7	24198170	.	C	A	6	2	8	0	0	8	0	0
7	24198334	.	C	T	3	3	6	0	1	7	0	0
7	24198335	.	C	T	0	3	3	0	4	7	0	0
7	24200052	.	C	T	1	9	10	0	9	19	0	0
7	24207520	.	A	C	22	14	36	0	1	37	0	0
7	24207552	.	A	G	22	0	22	0	15	37	0	0
7	24207590	.	A	T	13	21	34	0	1	35	0	0
7	24207632	.	G	C	15	9	24	0	1	25	0	0
7	24210323	.	C	A	2	14	16	0	11	27	0	0
7	24210422	.	T	C	15	10	25	0	2	27	0	0
7	24210629	.	T	A	15	21	36	2	0	38	0	0
7	24210659	.	A	G	15	20	35	2	1	38	0	0
7	24210676	.	A	G	20	18	38	0	3	41	0	0
7	24211015	.	A	T	15	11	26	0	1	27	0	0
7	24211054	.	G	A	18	12	30	0	0	30	0	0
7	24211081	.	T	A	16	12	28	0	0	28	0	0
7	24211342	.	C	T	2	12	14	0	13	27	0	0
7	24211443	.	C	T	2	7	9	0	19	28	0	0
7	24211542	.	G	T	3	4	7	0	0	7	0	0
7	24211560	.	A	T	3	3	6	0	0	6	0	0
7	24211646	.	C	T	1	5	6	0	9	15	0	0
7	24211911	.	A	T	3	5	8	0	0	8	0	0
7	24211978	.	G	A	16	16	32	2	0	34	0	0
7	24212093	.	C	G	10	11	21	0	0	21	0	0
7	24212122	.	T	C	12	9	21	0	0	21	0	0
7	24212159	.	G	C	10	0	10	0	13	23	0	0
7	24212383	.	G	A	9	19	28	0	0	28	0	0
7	24214655	.	C	T	17	12	29	0	0	29	0	0
7	24214673	.	C	A	15	14	29	0	0	29	0	0
7	24219052	.	A	G	6	11	17	0	0	17	0	0
7	24227149	.	T	G	7	11	18	0	0	18	0	0
7	24235806	.	G	A	6	5	11	0	0	11	0	0
7	24235933	.	T	C	5	6	11	0	1	12	0	0
7	24236035	.	A	G	3	6	9	0	0	9	0	0
7	24236177	.	C	G	12	9	21	0	1	22	0	0
7	24344307	.	C	T	3	2	5	0	0	5	0	0
7	24457691	.	C	A	24	32	56	0	1	57	0	0
7	24457788	.	C	A	28	19	47	0	1	48	0	0
7	24457803	.	A	C	26	15	41	0	1	42	0	0
7	24458103	.	C	A	22	23	45	0	2	47	0	0
7	24458128	.	G	C	26	23	49	0	1	50	0	0
7	24458205	.	G	A	40	19	59	0	1	60	0	0
7	24458282	.	C	T	30	17	47	1	2	50	0	0
7	24458339	.	A	G	37	19	56	0	0	56	0	0
7	24458866	.	T	C	30	15	45	0	1	46	0	0
7	24458894	.	T	A	29	15	44	0	2	46	0	0
7	24459452	.	G	A	26	15	41	0	1	42	0	0
7	24459847	.	A	G	26	23	49	0	0	49	0	0
7	24459932	.	T	C	21	24	45	0	1	46	0	0
7	24460025	.	G	A	21	16	37	0	0	37	0	0
7	24460026	.	C	T	20	15	35	0	3	38	0	0
7	24460189	.	T	C	25	14	39	0	2	41	0	0
7	24460443	.	G	A	21	13	34	0	3	37	0	0
7	24460461	.	G	A	23	18	41	0	0	41	0	0
7	24461115	.	A	C	25	18	43	0	1	44	0	0
7	24461298	.	G	A	23	13	36	0	0	36	0	0
7	24461601	.	A	G	21	13	34	0	2	36	0	0
7	24462394	.	A	G	30	15	45	2	4	51	0	0
7	24470812	.	A	G	26	24	50	0	1	51	0	0
7	24486088	.	A	G	4	2	6	0	0	6	0	0
7	24486345	.	A	G	24	16	40	0	2	44	2	0
7	24486515	.	A	C	24	36	60	0	2	62	0	0
7	24486546	.	G	C	25	35	60	0	0	62	2	0
7	24486721	.	G	A	37	28	65	0	4	70	1	0
7	24486822	.	G	A	33	25	58	0	3	61	0	0
7	24489888	.	A	G	26	28	54	0	0	54	0	0
7	24498912	.	C	T	9	11	20	0	0	20	0	0
7	24501156	.	T	C	5	5	10	0	5	15	0	0
7	24504508	.	C	T	12	9	21	0	0	21	0	0
7	24504875	.	C	T	7	8	15	0	0	15	0	0
7	24505063	.	A	G	4	3	7	0	0	7	0	0
7	24528917	.	T	A	8	5	13	0	0	13	0	0
7	24528976	.	G	T	1	6	7	0	0	7	0	0
7	24529001	.	A	T	1	4	5	0	0	5	0	0
7	24529257	.	G	A	0	4	4	0	5	9	0	0
7	24551057	.	G	C	3	2	5	0	0	5	0	0
7	24569961	.	T	C	6	11	17	0	4	21	0	0
7	24569990	.	T	G	8	7	15	0	2	17	0	0
7	24570012	.	A	T	8	8	16	0	2	18	0	0
7	24570714	.	G	A	1	4	5	0	9	14	0	0
7	24581226	.	A	T	1	2	3	0	0	3	0	0
7	24593439	.	T	C	10	6	16	0	2	18	0	0
7	24593452	.	T	A	12	8	20	0	0	20	0	0
7	24598728	.	G	T	4	8	12	0	0	12	0	0
7	24603028	.	G	T	10	12	22	0	0	22	0	0
7	24603231	.	C	T	2	10	12	0	10	22	0	0
7	24612524	.	G	A	7	8	15	0	0	15	0	0
7	24612623	.	C	T	4	2	6	0	0	6	0	0
7	24616240	.	G	A	4	3	7	0	0	7	0	0
7	24621385	.	C	T	5	9	14	0	0	14	0	0
7	24621480	.	T	C	5	4	9	0	0	9	0	0
7	24621564	.	A	C	5	8	13	0	0	13	0	0
7	24631757	.	C	A	2	2	4	0	0	4	0	0
7	24632080	.	C	T	1	8	9	0	7	16	0	0
7	24635159	.	G	A	5	6	11	0	0	11	0	0
7	24637765	.	C	A	3	4	7	0	0	7	0	0
7	24637934	.	T	C	7	8	15	0	1	16	0	0
7	24644434	.	G	C	8	7	15	0	0	15	0	0
7	24644446	.	A	C	10	7	17	0	0	17	0	0
7	24644588	.	G	A	1	2	3	0	0	3	0	0
7	24645292	.	A	G	6	3	9	0	0	9	0	0
7	24645402	.	G	A	10	5	15	0	0	15	0	0
7	24646602	.	T	C	9	5	14	0	0	14	0	0
7	24649421	.	C	T	3	6	9	0	0	9	0	0
7	24649610	.	G	C	2	8	10	0	0	10	0	0
7	24649694	.	T	C	6	5	11	0	1	12	0	0
7	24651636	.	C	T	5	4	9	0	0	9	0	0
7	24651645	.	G	A	5	3	8	0	1	9	0	0
7	24652951	.	A	G	7	0	7	0	7	14	0	0
7	24653020	.	G	A	4	7	11	0	1	12	0	0
7	24653068	.	C	T	7	2	9	0	2	11	0	0
7	24653121	.	G	A	11	4	15	0	0	15	0	0
7	24655086	.	T	A	13	11	24	0	1	25	0	0
7	24655094	.	T	C	11	14	25	0	0	25	0	0
7	24655261	.	A	G	7	2	9	0	0	9	0	0
7	24658938	.	G	A	1	5	6	0	10	16	0	0
7	24662235	.	G	A	6	2	8	0	0	8	0	0
7	24663995	.	T	C	6	6	12	0	0	12	0	0
7	24672147	.	A	G	16	0	16	0	16	32	0	0
7	24672257	.	G	C	12	12	24	0	0	24	0	0
7	24681673	.	A	G	21	21	42	0	2	44	0	0
7	24681731	.	T	C	22	25	47	0	3	50	0	0
7	24681755	.	A	G	25	21	46	0	2	48	0	0
7	24681806	.	A	G	19	19	38	0	1	39	0	0
7	24697400	.	T	C	12	12	24	0	3	27	0	0
7	24699881	.	G	T	17	14	31	0	2	33	0	0
7	24715058	.	T	C	2	5	7	0	0	7	0	0
7	24715278	.	A	G	2	3	5	0	0	5	0	0
7	24715361	.	T	C	0	2	2	0	1	3	0	0
7	24715870	.	C	T	0	3	3	0	3	6	0	0
7	24715879	.	C	T	3	3	6	0	0	6	0	0
7	24716056	.	G	T	1	3	4	0	0	4	0	0
7	24716169	.	G	A	1	3	4	0	0	4	0	0
7	24716172	.	G	A	1	2	3	0	1	4	0	0
7	24716258	.	C	T	4	2	6	0	0	6	0	0
7	24716508	.	T	G	1	4	5	0	0	5	0	0
7	24716538	.	G	A	1	3	4	0	0	4	0	0
7	24717234	.	A	T	2	3	5	0	1	6	0	0
7	24717322	.	T	G	2	5	7	0	0	7	0	0
7	24717327	.	T	G	2	4	6	0	0	6	0	0
7	24793980	.	C	A	1	2	3	0	0	3	0	0
7	24801593	.	G	A	0	3	3	0	3	6	0	0
7	24801682	.	G	A	0	2	2	0	1	3	0	0
7	24801742	.	C	T	3	3	6	0	0	6	0	0
7	24801743	.	C	T	3	3	6	0	0	6	0	0
7	24801886	.	G	A	4	3	7	0	2	9	0	0
7	24801920	.	G	T	0	5	5	0	5	10	0	0
7	24801937	.	T	A	3	4	7	0	0	7	0	0
7	24801961	.	T	A	1	5	6	0	1	7	0	0
7	24804343	.	T	G	5	2	7	0	0	7	0	0
7	24807919	.	A	G	3	3	6	0	0	6	0	0
7	24807931	.	C	T	2	3	5	0	1	6	0	0
7	24811726	.	T	A	3	2	5	0	1	6	0	0
7	24812127	.	C	A	1	2	3	0	0	3	0	0
7	24812587	.	C	T	6	2	8	0	0	8	0	0
7	24812829	.	A	G	1	2	3	0	0	3	0	0
7	24815992	.	C	T	8	5	13	0	0	13	0	0
7	24819788	.	G	A	25	21	46	0	0	46	0	0
7	24819812	.	G	A	19	19	38	0	2	40	0	0
7	24822914	.	G	A	18	18	36	0	2	38	0	0
7	24830460	.	C	T	1	2	3	0	0	3	0	0
7	24830546	.	C	T	1	2	3	0	0	3	0	0
7	24888986	.	T	C	12	9	21	0	0	21	0	0
7	24889051	.	G	C	0	5	5	0	5	10	0	0
7	24889617	.	T	G	5	0	5	0	13	18	0	0
7	24889758	.	T	C	4	5	9	0	1	10	0	0
7	24889808	.	C	G	8	4	12	1	1	14	0	0
7	24923112	.	G	A	1	10	11	0	12	23	0	0
7	24944724	.	C	T	7	10	17	0	0	17	0	0
7	24946895	.	C	T	7	14	21	0	1	22	0	0
7	24946913	.	T	C	9	11	20	0	1	21	0	0
7	24947440	.	T	C	11	8	19	0	0	19	0	0
7	24968774	.	C	T	2	1	3	0	0	3	0	0
7	24968798	.	T	C	1	3	4	0	0	4	0	0
7	24974916	.	T	C	14	15	29	1	1	31	0	0
7	24974937	.	T	C	17	9	26	1	0	27	0	0
7	24975264	.	T	C	12	11	23	0	1	24	0	0
7	24975646	.	C	T	16	13	29	0	2	31	0	0
7	24975678	.	G	A	20	12	32	0	1	33	0	0
7	24976539	.	T	C	14	13	27	0	0	27	0	0
7	24979979	.	A	G	5	6	11	0	0	11	0	0
7	24980107	.	T	G	2	7	9	0	0	9	0	0
7	24980185	.	T	G	5	5	10	0	0	10	0	0
7	24980469	.	C	T	12	13	25	0	0	25	0	0
7	24980956	.	C	G	3	4	7	0	8	15	0	0
7	24983304	.	C	T	8	10	18	0	2	20	0	0
7	24983328	.	C	T	0	10	10	0	11	21	0	0
7	24985300	.	A	C	2	1	3	0	5	8	0	0
7	24985318	.	C	G	0	5	5	0	3	8	0	0
7	24985506	.	T	C	2	3	5	0	0	5	0	0
7	25010745	.	C	T	19	19	38	0	1	39	0	0
7	25011238	.	A	G	14	9	23	0	0	23	0	0
7	25011375	.	T	C	2	4	6	0	0	6	0	0
7	25011585	.	T	G	5	4	9	0	1	10	0	0
7	25015154	.	C	T	7	6	13	0	0	13	0	0
7	25015239	.	C	T	12	19	31	0	0	31	0	0
7	25015419	.	T	C	11	9	20	0	2	22	0	0
7	25015424	.	G	A	12	9	21	0	0	21	0	0
7	25017967	.	G	C	10	8	18	0	1	19	0	0
7	25018043	.	G	T	8	6	14	0	1	15	0	0
7	25021647	.	T	G	12	8	20	0	1	21	0	0
7	25021697	.	T	C	13	12	25	0	2	27	0	0
7	25021718	.	C	T	10	10	20	0	2	22	0	0
7	25024266	.	T	C	10	14	24	0	1	25	0	0
7	25024277	.	A	T	11	13	24	0	1	25	0	0
7	25024346	.	G	C	0	13	13	2	9	24	0	0
7	25026873	.	C	T	13	13	26	0	1	27	0	0
7	25026960	.	C	T	11	9	20	0	1	21	0	0
7	25027022	.	T	C	9	12	21	0	1	22	0	0
7	25027034	.	A	G	10	13	23	0	1	24	0	0
7	25027208	.	G	A	7	8	15	0	0	15	0	0
7	25027211	.	G	T	1	9	10	0	6	16	0	0
7	25027266	.	T	C	8	5	13	0	0	13	0	0
7	25027397	.	T	C	3	3	6	0	0	6	0	0
7	25027399	.	T	G	3	3	6	0	0	6	0	0
7	25027466	.	C	A	5	4	9	0	1	10	0	0
7	25027561	.	C	T	5	9	14	0	0	14	0	0
7	25027571	.	A	G	5	11	16	0	2	18	0	0
7	25027756	.	T	C	10	3	13	0	1	14	0	0
7	25028034	.	C	T	6	15	21	0	0	21	0	0
7	25028081	.	A	G	10	11	21	0	0	21	0	0
7	25028085	.	G	C	10	12	22	0	0	22	0	0
7	25028205	.	T	A	16	12	28	0	1	29	0	0
7	25028440	.	A	T	1	2	3	0	1	4	0	0
7	25029003	.	T	C	4	5	9	0	0	9	0	0
7	25029129	.	C	T	3	4	7	0	0	7	0	0
7	25029140	.	T	A	2	5	7	0	1	8	0	0
7	25029169	.	G	A	3	4	7	0	0	7	0	0
7	25029191	.	G	A	0	2	2	0	2	4	0	0
7	25042942	.	A	C	6	9	15	0	2	17	0	0
7	25045337	.	T	A	6	3	9	0	0	9	0	0
7	25045642	.	C	T	4	3	7	0	0	7	0	0
7	25045777	.	A	G	7	7	14	0	0	14	0	0
7	25047307	.	G	C	7	6	13	0	0	13	0	0
7	25047318	.	A	C	7	6	13	0	1	14	0	0
7	25047441	.	T	G	11	6	17	0	0	17	0	0
7	25047604	.	T	A	19	9	28	0	0	28	0	0
7	25047954	.	G	A	19	13	32	0	0	32	0	0
7	25049262	.	A	G	20	12	32	0	2	34	0	0
7	25059856	.	C	T	23	10	33	0	0	33	0	0
7	25096889	.	T	C	19	18	37	0	1	38	0	0
7	25098910	.	G	A	38	19	57	0	4	61	0	0
7	25099133	.	A	G	30	3	33	2	19	54	0	0
7	25099302	.	T	C	9	14	23	0	0	23	0	0
7	25099594	.	T	G	19	13	32	0	0	32	0	0
7	25099704	.	T	C	19	18	37	0	0	37	0	0
7	25128575	.	T	A	2	2	4	0	0	4	0	0
7	25129407	.	A	T	3	3	6	0	0	6	0	0
7	25129432	.	T	G	1	2	3	0	0	3	0	0
7	25292455	.	T	C	7	6	13	0	0	13	0	0
7	25292978	.	G	A	0	3	3	0	5	8	0	0
7	25293123	.	C	A	1	7	8	0	0	8	0	0
7	25293131	.	G	T	3	7	10	0	0	10	0	0
7	25293261	.	T	C	8	5	13	0	1	14	0	0
7	25293666	.	A	G	3	3	6	0	1	7	0	0
7	25339860	.	A	C	3	2	5	0	0	5	0	0
7	25339872	.	A	T	4	4	8	0	0	8	0	0
7	25346765	.	T	C	4	3	7	0	0	7	0	0
7	25346924	.	G	C	0	6	6	0	10	16	0	0
7	25347024	.	C	T	7	6	13	1	0	14	0	0
7	25347459	.	T	G	14	12	26	0	1	27	0	0
7	25347679	.	A	T	6	2	8	0	0	8	0	0
7	25347684	.	C	A	6	1	7	0	0	7	0	0
7	25558837	.	T	A	1	3	4	0	0	4	0	0
7	25558952	.	C	A	0	5	5	0	5	10	0	0
7	25559010	.	T	C	1	4	5	0	0	5	0	0
7	25559093	.	A	G	3	4	7	0	1	8	0	0
7	25560010	.	T	A	1	2	3	0	0	3	0	0
7	25560013	.	C	A	1	1	2	0	0	2	0	0
7	25561094	.	A	T	3	3	6	0	0	6	0	0
7	25655748	.	A	G	3	2	5	0	0	5	0	0
7	25843643	.	A	G	3	0	3	0	4	7	0	0
7	25846430	.	G	A	1	3	4	0	0	4	0	0
7	25846562	.	C	T	3	4	7	0	0	7	0	0
7	25852549	.	A	G	5	0	5	0	7	12	0	0
7	25854239	.	T	C	9	9	18	0	0	18	0	0
7	25854245	.	C	G	7	9	16	0	0	17	1	0
7	25858611	.	C	A	14	4	18	0	1	19	0	0
7	25863708	.	C	T	12	16	28	0	2	30	0	0
7	25867412	.	C	T	7	14	21	0	1	22	0	0
7	25869617	.	C	T	10	19	29	0	1	30	0	0
7	25872580	.	C	T	9	9	18	0	1	19	0	0
7	25872691	.	G	A	4	7	11	0	10	21	0	0
7	25873009	.	C	T	21	6	27	0	0	27	0	0
7	25873601	.	A	T	16	13	29	0	0	29	0	0
7	25873728	.	T	G	20	1	21	0	14	35	0	0
7	25873743	.	C	A	17	18	35	0	4	39	0	0
7	25873857	.	T	C	10	11	21	0	0	21	0	0
7	25876947	.	A	C	8	14	22	0	0	22	0	0
7	25877033	.	A	T	11	11	22	0	1	23	0	0
7	25877038	.	G	A	13	10	23	0	1	24	0	0
7	25877420	.	T	C	14	20	34	0	1	35	0	0
7	25877445	.	G	C	15	19	34	0	0	34	0	0
7	25878417	.	T	G	7	11	18	0	0	18	0	0
7	25878642	.	G	T	14	11	25	0	0	25	0	0
7	25878723	.	A	C	23	19	42	0	1	43	0	0
7	25878786	.	C	T	3	30	33	0	18	51	0	0
7	25878849	.	T	C	15	16	31	0	3	34	0	0
7	25878977	.	A	G	30	15	45	0	1	46	0	0
7	25879116	.	T	G	18	21	39	0	4	44	1	0
7	25879130	.	G	C	16	25	41	0	4	45	0	0
7	25879514	.	T	A	16	24	40	0	1	41	0	0
7	25879905	.	G	A	16	24	40	0	1	41	0	0
7	25879920	.	G	T	25	13	38	0	2	40	0	0
7	25880033	.	A	T	23	11	34	0	0	34	0	0
7	25880046	.	C	A	20	11	31	0	0	31	0	0
7	25880207	.	T	A	10	16	26	0	0	26	0	0
7	25880226	.	G	A	17	6	23	0	0	23	0	0
7	25880313	.	T	A	24	16	40	0	1	41	0	0
7	25880340	.	C	T	3	23	26	0	20	46	0	0
7	25880754	.	C	T	1	17	18	0	13	31	0	0
7	25880843	.	G	A	14	20	34	0	0	34	0	0
7	25881215	.	C	T	26	20	46	0	3	49	0	0
7	25881583	.	G	A	25	9	34	4	4	42	0	0
7	25881605	.	A	C	19	19	38	4	1	43	0	0
7	25884007	.	G	T	17	18	35	0	0	35	0	0
7	25884148	.	A	G	17	32	49	0	0	49	0	0
7	25895399	.	G	A	2	5	7	0	0	7	0	0
7	25917046	.	A	G	34	32	66	0	7	73	0	0
7	25917473	.	G	A	5	29	34	3	34	71	0	0
7	25917634	.	A	T	29	40	69	0	0	69	0	0
7	25918056	.	C	T	26	38	64	2	2	68	0	0
7	25918101	.	T	G	21	1	22	0	35	58	1	0
7	25920966	.	A	G	19	0	19	0	17	36	0	0
7	25979203	.	T	C	16	17	33	0	0	33	0	0
7	25979417	.	C	T	16	15	31	0	3	34	0	0
7	25979468	.	C	T	28	15	43	0	1	44	0	0
7	25979510	.	T	C	30	16	46	0	1	47	0	0
7	25986069	.	G	T	1	15	16	0	26	42	0	0
7	25986099	.	C	T	25	17	42	0	3	45	0	0
7	25988324	.	C	A	18	17	35	0	0	35	0	0
7	26002674	.	C	T	17	26	43	0	3	46	0	0
7	26002915	.	T	A	18	16	34	0	1	35	0	0
7	26003853	.	C	T	1	5	6	0	0	6	0	0
7	26004014	.	G	T	4	4	8	0	0	8	0	0
7	26004616	.	A	G	11	8	19	0	1	20	0	0
7	26004876	.	T	A	7	8	15	1	0	16	0	0
7	26004951	.	A	G	10	4	14	0	1	15	0	0
7	26005033	.	A	G	6	5	11	0	0	11	0	0
7	26005108	.	A	G	2	0	2	0	3	5	0	0
7	26008444	.	A	G	3	8	11	0	0	11	0	0
7	26011665	.	A	T	4	6	10	0	0	10	0	0
7	26013041	.	C	G	4	4	8	0	0	8	0	0
7	26015376	.	C	T	7	3	10	0	1	11	0	0
7	26015378	.	A	G	7	4	11	0	0	11	0	0
7	26015544	.	G	T	10	8	18	0	0	18	0	0
7	26015595	.	C	A	9	14	23	0	0	23	0	0
7	26015628	.	T	C	13	20	33	0	0	33	0	0
7	26015663	.	T	C	13	22	35	0	0	35	0	0
7	26015693	.	C	A	15	16	31	0	1	33	1	0
7	26020078	.	T	C	16	12	28	0	1	29	0	0
7	26020192	.	C	T	16	11	27	0	0	27	0	0
7	26020273	.	G	A	1	5	6	0	18	24	0	0
7	26020370	.	T	C	8	8	16	0	1	17	0	0
7	26020408	.	A	C	4	8	12	0	2	15	1	0
7	26020659	.	C	T	19	8	27	0	3	30	0	0
7	26020779	.	C	T	9	6	15	0	1	16	0	0
7	26020927	.	A	T	6	7	13	0	1	14	0	0
7	26021146	.	A	G	9	14	23	0	0	23	0	0
7	26026114	.	A	G	10	0	10	0	10	20	0	0
7	26026176	.	C	T	7	11	18	0	1	19	0	0
7	26026188	.	C	A	10	10	20	0	0	20	0	0
7	26026241	.	G	A	10	7	17	0	0	17	0	0
7	26026264	.	C	G	5	6	11	1	0	12	0	0
7	26026298	.	T	G	4	0	4	1	7	12	0	0
7	26026330	.	A	T	2	6	8	1	0	9	0	0
7	26026358	.	A	C	4	4	8	0	0	8	0	0
7	26026379	.	C	T	4	2	6	0	0	6	0	0
7	26026491	.	T	G	2	5	7	0	0	7	0	0
7	26048144	.	G	C	1	1	2	0	1	3	0	0
7	26048364	.	T	A	2	2	4	0	0	4	0	0
7	26051793	.	T	A	2	2	4	0	0	4	0	0
7	26074160	.	C	A	11	10	21	0	0	21	0	0
7	26076368	.	A	G	5	8	13	0	1	14	0	0
7	26076458	.	A	T	4	6	10	0	0	10	0	0
7	26077845	.	G	T	23	19	42	0	0	43	1	0
7	26077947	.	T	A	20	26	46	0	2	48	0	0
7	26077949	.	C	T	19	28	47	0	1	48	0	0
7	26078061	.	T	C	23	21	44	1	1	46	0	0
7	26078243	.	A	C	20	21	41	0	4	45	0	0
7	26078284	.	C	T	19	29	48	0	1	49	0	0
7	26078345	.	T	A	26	31	57	0	1	58	0	0
7	26078435	.	G	T	22	11	33	0	2	35	0	0
7	26078516	.	T	A	22	7	29	0	0	29	0	0
7	26078897	.	G	A	21	30	51	0	2	53	0	0
7	26078947	.	G	A	27	14	41	0	3	44	0	0
7	26079370	.	T	G	23	23	46	0	1	47	0	0
7	26079667	.	C	G	3	30	33	0	23	56	0	0
7	26081171	.	C	T	19	21	40	0	5	45	0	0
7	26081252	.	A	G	16	29	45	0	1	46	0	0
7	26081744	.	T	C	26	24	50	0	1	51	0	0
7	26082281	.	G	A	12	21	33	0	0	33	0	0
7	26082311	.	A	G	11	19	30	0	2	32	0	0
7	26116876	.	A	G	4	3	7	0	0	7	0	0
7	26132724	.	C	T	31	26	57	0	1	58	0	0
7	26132743	.	C	T	32	21	53	0	1	54	0	0
7	26140767	.	A	G	36	31	67	0	1	68	0	0
7	26141394	.	G	C	31	19	50	0	0	50	0	0
7	26141519	.	T	A	23	30	53	0	2	55	0	0
7	26141568	.	T	A	31	29	60	0	1	61	0	0
7	26142339	.	T	C	14	14	28	0	5	33	0	0
7	26142525	.	T	G	23	4	27	3	16	46	0	0
7	26142702	.	A	G	26	27	53	0	4	57	0	0
7	26142736	.	A	T	33	20	53	0	2	55	0	0
7	26143343	.	A	G	11	29	40	0	1	41	0	0
7	26143501	.	T	C	31	23	54	0	2	56	0	0
7	26143760	.	G	A	28	23	51	0	1	52	0	0
7	26144551	.	T	A	12	8	20	0	1	21	0	0
7	26144628	.	C	T	6	8	14	0	1	15	0	0
7	26145605	.	T	C	24	35	59	0	1	60	0	0
7	26145873	.	C	T	11	11	22	0	0	22	0	0
7	26145910	.	T	C	11	16	27	0	1	28	0	0
7	26146176	.	A	C	33	25	58	0	0	58	0	0
7	26146188	.	T	C	33	24	57	0	0	57	0	0
7	26146796	.	A	G	30	2	32	0	32	64	0	0
7	26146993	.	C	T	32	36	68	0	4	72	0	0
7	26148181	.	A	C	34	26	60	0	2	62	0	0
7	26148263	.	A	G	52	12	64	0	2	66	0	0
7	26148312	.	T	G	35	21	56	0	0	56	0	0
7	26148773	.	G	A	5	5	10	0	1	11	0	0
7	26149252	.	G	A	27	34	61	0	0	61	0	0
7	26149690	.	C	T	26	27	53	0	2	55	0	0
7	26150096	.	T	A	21	20	41	0	0	41	0	0
7	26224320	.	A	G	26	24	50	0	3	53	0	0
7	26224365	.	A	T	18	24	42	0	0	42	0	0
7	26226772	.	G	C	20	17	37	0	0	37	0	0
7	26227119	.	C	T	25	24	49	0	1	50	0	0
7	26227149	.	C	T	21	25	46	0	0	46	0	0
7	26227527	.	T	C	20	24	44	0	2	46	0	0
7	26227539	.	T	C	22	22	44	0	2	46	0	0
7	26228290	.	C	T	26	17	43	0	0	43	0	0
7	26228639	.	T	C	24	18	42	0	1	43	0	0
7	26229449	.	G	A	16	12	28	0	2	30	0	0
7	26229529	.	C	T	25	18	43	0	1	44	0	0
7	26229551	.	T	A	29	17	46	0	3	49	0	0
7	26229640	.	T	C	25	25	50	1	2	53	0	0
7	26229935	.	C	T	23	7	30	0	2	32	0	0
7	26229979	.	A	G	11	5	16	0	4	20	0	0
7	26245668	.	T	C	13	10	23	0	2	25	0	0
7	26245714	.	A	T	19	11	30	0	0	30	0	0
7	26263153	.	C	T	11	11	22	0	0	22	0	0
7	26263174	.	T	C	5	0	5	0	4	9	0	0
7	26265832	.	C	A	0	2	2	0	1	3	0	0
7	26265961	.	G	A	4	3	7	0	1	8	0	0
7	26266069	.	G	C	4	5	9	0	0	9	0	0
7	26268126	.	G	A	1	3	4	0	0	4	0	0
7	26268150	.	A	G	1	3	4	0	0	4	0	0
7	26268433	.	T	C	1	7	8	0	0	8	0	0
7	26269944	.	C	T	3	2	5	0	0	5	0	0
7	26300184	.	A	G	5	3	8	0	0	8	0	0
7	26300263	.	A	G	7	3	10	0	0	10	0	0
7	26300359	.	A	G	4	9	13	0	1	14	0	0
7	26300955	.	T	C	2	0	2	0	3	5	0	0
7	26306336	.	A	G	1	2	3	0	0	3	0	0
7	26366778	.	G	A	12	5	17	0	0	17	0	0
7	26366919	.	G	A	7	5	12	0	1	13	0	0
7	26367056	.	T	C	8	0	8	0	6	14	0	0
7	26367280	.	C	T	0	5	5	0	12	17	0	0
7	26367364	.	T	G	3	2	5	0	0	5	0	0
7	26367470	.	C	G	4	3	7	1	0	8	0	0
7	26367486	.	A	C	5	5	10	1	0	11	0	0
7	26367525	.	A	G	7	5	12	0	2	14	0	0
7	26367628	.	A	G	3	3	6	0	0	6	0	0
7	26367797	.	T	C	1	3	4	0	0	4	0	0
7	26367944	.	G	A	8	4	12	0	1	13	0	0
7	26368080	.	T	A	4	7	11	0	1	12	0	0
7	26368240	.	C	A	12	5	17	1	0	18	0	0
7	26368291	.	A	C	4	4	8	0	0	8	0	0
7	26368333	.	A	T	5	5	10	0	1	11	0	0
7	26368483	.	T	A	11	5	16	0	1	17	0	0
7	26368549	.	A	G	5	5	10	0	0	10	0	0
7	26368719	.	C	A	7	5	12	0	0	12	0	0
7	26368748	.	A	T	11	4	15	0	1	16	0	0
7	26368836	.	A	T	7	7	14	0	0	14	0	0
7	26368955	.	G	T	8	10	18	0	0	18	0	0
7	26369030	.	C	T	8	4	12	0	0	12	0	0
7	26369034	.	G	C	8	2	10	0	0	10	0	0
7	26369106	.	T	A	5	1	6	0	1	7	0	0
7	26369114	.	C	T	6	3	9	0	0	9	0	0
7	26369227	.	G	A	3	10	13	0	0	13	0	0
7	26369269	.	C	T	1	2	3	0	6	9	0	0
7	26369583	.	A	C	9	0	9	0	6	15	0	0
7	26371702	.	G	A	13	6	19	0	0	19	0	0
7	26371711	.	G	A	11	9	20	0	1	21	0	0
7	26378224	.	G	A	7	7	14	0	1	15	0	0
7	26380290	.	T	C	5	6	11	0	0	11	0	0
7	26389261	.	C	T	8	3	11	0	0	11	0	0
7	26389351	.	C	T	7	3	10	0	1	11	0	0
7	26389369	.	G	A	5	4	9	0	1	10	0	0
7	26389429	.	C	T	7	3	10	0	0	10	0	0
7	26389486	.	G	A	6	5	11	0	0	11	0	0
7	26389805	.	A	G	7	7	14	0	0	14	0	0
7	26394208	.	A	T	12	17	29	0	0	29	0	0
7	26394285	.	A	T	16	9	25	0	1	26	0	0
7	26394382	.	C	T	2	21	23	0	6	29	0	0
7	26394476	.	G	A	19	13	32	0	1	33	0	0
7	26394791	.	A	G	22	22	44	0	0	44	0	0
7	26394848	.	G	A	22	8	30	0	1	31	0	0
7	26394951	.	T	A	11	8	19	0	0	19	0	0
7	26395215	.	C	G	1	3	4	0	0	4	0	0
7	26395538	.	T	C	17	13	30	0	4	34	0	0
7	26395625	.	T	A	7	12	19	0	0	19	0	0
7	26395778	.	T	G	8	6	14	0	1	15	0	0
7	26396170	.	G	A	13	9	22	0	0	22	0	0
7	26396560	.	C	G	4	11	15	0	0	15	0	0
7	26396768	.	G	A	22	14	36	0	0	36	0	0
7	26396915	.	A	C	10	8	18	0	0	18	0	0
7	26396975	.	A	G	6	13	19	0	0	19	0	0
7	26397003	.	T	G	7	9	16	0	0	16	0	0
7	26397243	.	G	A	12	12	24	0	0	24	0	0
7	26397475	.	T	A	12	8	20	0	0	20	0	0
7	26397541	.	G	A	18	14	32	0	0	32	0	0
7	26397760	.	C	T	14	10	24	0	0	24	0	0
7	26398159	.	A	T	13	11	24	0	1	25	0	0
7	26398351	.	A	G	17	14	31	0	0	31	0	0
7	26398867	.	G	A	20	23	43	0	0	43	0	0
7	26402680	.	C	A	14	17	31	0	0	31	0	0
7	26402788	.	T	G	11	8	19	0	5	24	0	0
7	26408340	.	C	T	8	4	12	0	0	12	0	0
7	26408466	.	C	A	0	5	5	0	6	11	0	0
7	26432105	.	G	A	4	2	6	0	0	6	0	0
7	26432464	.	A	T	9	2	11	0	4	15	0	0
7	26469820	.	G	A	0	7	7	0	9	16	0	0
7	26472340	.	A	C	6	10	16	0	0	16	0	0
7	26472346	.	A	T	6	9	15	0	0	15	0	0
7	26472398	.	C	T	8	11	19	0	0	19	0	0
7	26472413	.	A	G	7	10	17	0	2	19	0	0
7	26472512	.	G	T	5	9	14	0	1	15	0	0
7	26472971	.	C	G	4	7	11	0	0	11	0	0
7	26473040	.	A	G	6	0	6	0	8	14	0	0
7	26473163	.	G	A	1	2	3	1	0	4	0	0
7	26473435	.	G	A	3	2	5	0	1	6	0	0
7	26497577	.	C	T	1	2	3	0	0	3	0	0
7	26511439	.	A	T	21	24	45	0	0	45	0	0
7	26511691	.	G	A	34	19	53	0	2	55	0	0
7	26511760	.	A	G	27	19	46	0	1	47	0	0
7	26511801	.	T	G	25	14	39	0	2	41	0	0
7	26514756	.	A	T	1	2	3	0	0	3	0	0
7	26514784	.	G	C	1	2	3	0	0	3	0	0
7	26519052	.	A	G	7	5	12	0	0	12	0	0
7	26519150	.	A	T	12	11	23	0	0	23	0	0
7	26522358	.	T	C	9	14	23	0	1	24	0	0
7	26522364	.	C	T	10	13	23	0	0	23	0	0
7	26523169	.	A	G	7	10	17	0	0	17	0	0
7	26525463	.	C	T	6	5	11	0	0	11	0	0
7	27681025	.	G	T	8	8	16	0	0	17	1	0
7	27681071	.	A	T	9	14	23	0	2	25	0	0
7	27682919	.	C	T	11	10	21	0	0	21	0	0
7	27700517	.	G	A	12	8	20	0	0	20	0	0
7	27700777	.	C	T	2	8	10	0	11	21	0	0
7	27701155	.	C	G	0	4	4	0	3	7	0	0
7	27701231	.	T	A	9	10	19	0	0	19	0	0
7	27701348	.	A	C	4	11	15	0	1	16	0	0
7	27701561	.	A	T	8	7	15	0	0	15	0	0
7	27701623	.	C	A	6	6	12	0	0	12	0	0
7	27701634	.	A	G	5	6	11	0	0	11	0	0
7	27702003	.	A	C	1	5	6	0	1	7	0	0
7	27702571	.	T	G	9	6	15	0	1	16	0	0
7	27702934	.	G	A	14	6	20	0	1	21	0	0
7	27702998	.	T	A	10	11	21	0	0	21	0	0
7	27703102	.	T	C	11	8	19	0	3	22	0	0
7	27705837	.	G	A	8	7	15	0	0	15	0	0
7	27718258	.	C	G	2	11	13	0	4	17	0	0
7	27720520	.	A	G	11	9	20	0	1	21	0	0
7	27722513	.	A	G	7	11	18	0	0	18	0	0
7	27722534	.	A	G	5	9	14	0	3	17	0	0
7	27724908	.	T	C	8	6	14	0	2	16	0	0
7	27724920	.	T	G	11	7	18	0	0	18	0	0
7	27797760	.	A	G	4	3	7	0	1	8	0	0
7	27797834	.	A	C	7	6	13	0	0	13	0	0
7	27798561	.	A	C	7	7	14	0	0	14	0	0
7	27805487	.	A	G	14	10	24	0	0	24	0	0
7	27805547	.	C	T	11	10	21	0	0	21	0	0
7	27806074	.	G	A	0	10	10	1	15	26	0	0
7	27811770	.	C	T	12	17	29	0	1	30	0	0
7	27813749	.	C	T	19	15	34	0	0	34	0	0
7	27813942	.	G	A	12	14	26	0	1	27	0	0
7	27813978	.	A	G	12	0	12	0	9	21	0	0
7	27814326	.	C	T	9	14	23	0	0	23	0	0
7	27816668	.	T	C	16	13	29	0	1	30	0	0
7	27816875	.	C	T	20	14	34	0	1	35	0	0
7	27817229	.	C	A	23	11	34	1	0	35	0	0
7	27817283	.	A	G	23	1	24	0	13	37	0	0
7	27817755	.	G	C	21	16	37	0	0	37	0	0
7	27834170	.	A	G	5	8	13	0	0	13	0	0
7	27884185	.	A	G	10	9	19	0	1	20	0	0
7	27884211	.	A	G	10	10	20	0	0	20	0	0
7	27884611	.	T	G	3	2	5	0	1	6	0	0
7	27884618	.	C	T	3	2	5	0	1	6	0	0
7	27884979	.	G	T	7	8	15	0	0	15	0	0
7	27885000	.	T	C	9	9	18	0	0	18	0	0
7	27885043	.	C	T	6	9	15	0	0	15	0	0
7	27885118	.	T	C	7	4	11	1	0	12	0	0
7	27885160	.	A	G	7	6	13	0	0	13	0	0
7	27885364	.	A	T	1	4	5	0	0	5	0	0
7	27885365	.	A	C	1	4	5	0	0	5	0	0
7	27885703	.	A	T	8	4	12	0	0	12	0	0
7	27885706	.	C	T	7	4	11	0	0	11	0	0
7	27885941	.	G	A	9	4	13	0	1	14	0	0
7	27886502	.	A	T	3	7	10	0	0	10	0	0
7	27886508	.	A	T	3	7	10	0	0	10	0	0
7	27886602	.	C	A	10	8	18	0	0	18	0	0
7	27886923	.	A	G	10	10	20	0	0	20	0	0
7	27886924	.	A	G	10	10	20	0	0	20	0	0
7	27976671	.	G	T	2	2	4	0	1	5	0	0
7	27976894	.	C	T	9	7	16	0	0	16	0	0
7	27977061	.	C	T	7	7	14	0	0	14	0	0
7	27977083	.	G	A	1	8	9	0	7	16	0	0
7	28033649	.	G	A	0	18	18	0	12	30	0	0
7	28039990	.	G	A	2	8	10	0	13	23	0	0
7	28040014	.	G	T	2	11	13	0	13	26	0	0
7	28040083	.	T	C	13	7	20	0	0	20	0	0
7	28040885	.	T	C	10	14	24	0	0	24	0	0
7	28041147	.	G	A	0	5	5	0	10	15	0	0
7	28041246	.	T	G	4	0	4	0	8	12	0	0
7	28041336	.	T	A	1	2	3	0	0	3	0	0
7	28041496	.	T	C	7	3	10	0	0	10	0	0
7	28041538	.	T	C	9	7	16	0	0	16	0	0
7	28041570	.	G	T	8	11	19	0	1	20	0	0
7	28041615	.	C	T	9	11	20	0	0	20	0	0
7	28041736	.	A	G	8	5	13	0	0	13	0	0
7	28041842	.	T	C	12	5	17	0	2	19	0	0
7	28041942	.	T	C	13	6	19	0	1	20	0	0
7	28042027	.	G	A	16	6	22	0	0	22	0	0
7	28042395	.	T	A	8	5	13	0	0	13	0	0
7	28042732	.	G	A	6	5	11	0	1	12	0	0
7	28042740	.	G	A	6	6	12	0	0	12	0	0
7	28043040	.	C	A	2	10	12	0	0	12	0	0
7	28043173	.	T	G	7	5	12	0	1	13	0	0
7	28043184	.	A	G	7	0	7	0	10	17	0	0
7	28043284	.	A	G	10	10	20	0	0	20	0	0
7	28043416	.	A	G	10	17	27	0	0	27	0	0
7	28043837	.	T	G	9	0	9	0	7	16	0	0
7	28043852	.	G	A	12	8	20	0	1	21	0	0
7	28044193	.	A	G	18	10	28	0	0	28	0	0
7	28045160	.	G	A	0	6	6	0	11	17	0	0
7	28045263	.	C	G	14	5	19	1	2	22	0	0
7	28045444	.	T	A	14	8	22	0	0	22	0	0
7	28045541	.	A	T	14	4	18	0	1	19	0	0
7	28045571	.	T	C	10	9	19	1	2	22	0	0
7	28045600	.	C	T	15	12	27	1	0	28	0	0
7	28045685	.	C	T	5	11	16	0	0	16	0	0
7	28046436	.	T	C	9	3	12	1	0	13	0	0
7	28046530	.	A	G	6	14	20	0	0	20	0	0
7	28046572	.	T	C	12	5	17	0	1	18	0	0
7	28046580	.	A	G	7	11	18	0	0	18	0	0
7	28046619	.	A	G	13	1	14	3	13	30	0	0
7	28046918	.	A	C	5	2	7	0	1	8	0	0
7	28047004	.	G	A	7	7	14	0	0	14	0	0
7	28147806	.	T	A	19	17	36	0	1	37	0	0
7	28407151	.	G	T	1	6	7	1	1	9	0	0
7	28407152	.	T	G	1	6	7	1	1	9	0	0
7	28407339	.	A	G	1	5	6	0	0	6	0	0
7	28424237	.	C	G	6	5	11	0	0	11	0	0
7	28424381	.	A	T	6	6	12	0	0	12	0	0
7	28430010	.	G	A	14	7	21	0	1	22	0	0
7	28430127	.	C	A	13	6	19	0	0	19	0	0
7	28430430	.	C	T	12	9	21	0	0	21	0	0
7	28430454	.	C	A	13	9	22	0	1	23	0	0
7	28430503	.	G	A	12	4	16	0	1	17	0	0
7	28430528	.	G	T	8	6	14	0	1	16	1	0
7	28436486	.	G	C	11	9	20	0	2	22	0	0
7	28442009	.	G	C	10	8	18	0	0	18	0	0
7	28445929	.	T	C	7	11	18	0	1	19	0	0
7	28448588	.	C	T	14	5	19	0	0	19	0	0
7	28454686	.	A	G	5	5	10	0	0	10	0	0
7	28465338	.	G	A	4	5	9	0	0	9	0	0
7	28467182	.	A	G	10	10	20	0	0	20	0	0
7	28485206	.	G	A	5	5	10	0	0	10	0	0
7	28485287	.	T	A	1	5	6	0	0	6	0	0
7	28499926	.	G	A	3	8	11	0	0	11	0	0
7	28513074	.	G	A	2	2	4	0	0	4	0	0
7	28516154	.	A	G	5	5	10	0	0	10	0	0
7	28516231	.	A	G	3	4	7	0	0	7	0	0
7	28516250	.	G	A	3	5	8	0	0	8	0	0
7	28516328	.	G	A	3	2	5	0	0	5	0	0
7	28516811	.	T	G	2	1	3	0	1	4	0	0
7	28516997	.	C	G	2	2	4	0	0	4	0	0
7	28517010	.	A	C	2	2	4	0	0	4	0	0
7	28559907	.	G	A	12	11	23	0	3	26	0	0
7	28559969	.	G	T	11	7	18	0	0	18	0	0
7	28560250	.	G	C	13	18	31	0	1	32	0	0
7	28560256	.	G	A	13	18	31	0	1	32	0	0
7	28560467	.	C	G	17	18	35	0	1	36	0	0
7	28562196	.	A	G	26	13	39	0	0	39	0	0
7	28580690	.	C	T	4	7	11	0	0	11	0	0
7	28580691	.	T	C	4	7	11	0	0	11	0	0
7	28612726	.	T	C	21	13	34	0	0	34	0	0
7	28612899	.	G	A	2	18	20	0	11	31	0	0
7	28612929	.	A	G	15	17	32	0	0	32	0	0
7	28612962	.	G	A	14	19	33	0	1	34	0	0
7	28615709	.	T	C	18	21	39	0	0	40	1	0
7	28615850	.	G	A	20	15	35	1	3	39	0	0
7	28615922	.	A	G	15	2	17	0	14	31	0	0
7	28618813	.	C	T	30	12	42	0	3	45	0	0
7	28622856	.	G	A	22	19	41	0	3	44	0	0
7	28622970	.	T	C	23	19	42	0	2	44	0	0
7	28623456	.	G	A	5	4	9	0	0	9	0	0
7	28623506	.	T	A	3	4	7	0	0	7	0	0
7	28623803	.	G	A	3	1	4	0	1	5	0	0
7	28623823	.	G	T	6	3	9	0	0	9	0	0
7	28623860	.	A	G	7	4	11	0	0	11	0	0
7	28623863	.	A	G	6	5	11	0	0	11	0	0
7	28624106	.	A	T	7	3	10	0	0	10	0	0
7	28624688	.	A	T	5	9	14	0	1	15	0	0
7	28624692	.	T	C	10	6	16	0	0	16	0	0
7	28624934	.	T	A	4	5	9	0	0	9	0	0
7	28625080	.	G	T	2	3	5	0	0	5	0	0
7	28625145	.	A	T	3	2	5	0	0	5	0	0
7	28625174	.	G	C	2	4	6	0	0	6	0	0
7	28625933	.	G	T	2	2	4	0	0	4	0	0
7	28626098	.	G	A	3	2	5	0	0	5	0	0
7	28636305	.	G	A	2	7	9	0	0	9	0	0
7	28999020	.	A	G	1	1	2	0	4	6	0	0
7	29051871	.	A	G	7	3	10	0	1	11	0	0
7	29675520	.	T	A	6	2	8	0	0	8	0	0
7	29690318	.	A	T	3	2	5	0	0	5	0	0
7	29960848	.	G	A	1	8	9	0	0	9	0	0
7	30264915	.	A	G	0	3	3	0	0	3	0	0
7	30285341	.	A	G	2	2	4	0	0	4	0	0
7	30410887	.	A	G	4	2	6	1	1	8	0	0
7	31140634	.	A	C	2	17	19	0	1	20	0	0
7	32645605	.	T	C	10	2	12	0	0	12	0	0
7	32743231	.	A	G	10	3	13	5	1	19	0	0
7	32746213	.	A	G	22	8	30	0	0	30	0	0
7	32747973	.	A	G	7	16	23	0	1	24	0	0
7	32835573	.	T	A	6	3	9	0	0	9	0	0
7	33958994	.	T	C	3	2	5	0	0	5	0	0
7	34105793	.	T	C	5	2	7	0	0	7	0	0
7	34417536	.	T	A	3	7	10	0	0	10	0	0
7	34417537	.	T	A	1	8	9	0	0	10	1	0
7	34651768	.	C	T	6	2	8	0	0	8	0	0
7	36112610	.	G	T	0	8	8	1	0	9	0	0
7	37585016	.	T	A	6	2	8	0	0	8	0	0
7	38340539	.	T	C	2	0	2	0	5	7	0	0
7	38379379	.	T	C	2	2	4	0	0	4	0	0
7	38456578	.	T	C	2	3	5	0	0	5	0	0
7	38456592	.	A	T	3	2	5	0	0	5	0	0
7	38456699	.	T	C	5	8	13	0	0	13	0	0
7	38456944	.	T	C	5	0	5	0	4	9	0	0
7	38476911	.	T	A	9	7	16	0	0	16	0	0
7	38476976	.	C	T	9	4	13	0	0	13	0	0
7	38477026	.	C	T	3	9	12	0	10	22	0	0
7	38477075	.	G	A	11	9	20	0	4	24	0	0
7	38477196	.	C	T	3	3	6	0	2	8	0	0
7	38529272	.	G	T	6	4	10	0	0	10	0	0
7	38529290	.	C	T	6	3	9	0	0	9	0	0
7	38529503	.	C	T	4	2	6	0	0	6	0	0
7	38529617	.	G	T	0	5	5	0	2	7	0	0
7	38529623	.	C	T	3	5	8	0	0	8	0	0
7	38529680	.	G	A	6	4	10	0	0	10	0	0
7	38529689	.	C	G	5	0	5	0	4	9	0	0
7	38529768	.	C	G	6	0	6	0	2	8	0	0
7	38529773	.	T	C	6	2	8	0	0	8	0	0
7	38529867	.	A	T	7	5	12	0	1	13	0	0
7	38529899	.	C	T	5	4	9	0	0	9	0	0
7	38529950	.	G	T	3	2	5	0	0	5	0	0
7	38531615	.	C	A	4	3	7	0	0	7	0	0
7	38531729	.	G	A	5	3	8	0	0	8	0	0
7	38532382	.	A	C	3	4	7	0	2	9	0	0
7	38532390	.	G	A	0	3	3	0	2	5	0	0
7	38532570	.	A	G	2	3	5	0	0	5	0	0
7	38532832	.	C	T	6	3	9	0	0	9	0	0
7	38532833	.	C	T	6	2	8	0	1	9	0	0
7	38532888	.	G	A	3	2	5	0	1	6	0	0
7	38533013	.	T	C	4	2	6	1	0	7	0	0
7	38533048	.	C	A	4	3	7	0	0	7	0	0
7	38533225	.	G	T	6	2	8	0	0	8	0	0
7	38533250	.	C	G	5	4	9	0	0	9	0	0
7	38533683	.	A	T	8	3	11	0	0	11	0	0
7	38536370	.	C	T	20	11	31	0	0	31	0	0
7	38536416	.	C	T	20	15	35	0	0	35	0	0
7	38536697	.	A	G	25	9	34	0	1	35	0	0
7	38536703	.	A	T	21	10	31	0	2	33	0	0
7	38536889	.	G	T	19	11	30	0	1	31	0	0
7	38537085	.	T	A	12	9	21	0	0	21	0	0
7	38537345	.	C	T	13	16	29	0	0	29	0	0
7	38537657	.	C	T	8	14	22	0	1	23	0	0
7	38539320	.	T	A	6	5	11	0	0	12	1	0
7	38539554	.	A	G	10	9	19	0	1	20	0	0
7	38539577	.	A	G	15	7	22	0	1	23	0	0
7	38539643	.	C	A	10	8	18	0	0	18	0	0
7	38539730	.	G	A	5	7	12	0	0	12	0	0
7	38539768	.	T	A	11	10	21	0	1	22	0	0
7	38539992	.	G	A	9	11	20	0	0	20	0	0
7	38540134	.	G	A	15	9	24	0	1	25	0	0
7	38544706	.	A	G	14	9	23	0	0	23	0	0
7	38552294	.	T	C	11	9	20	0	2	22	0	0
7	38570789	.	C	T	13	7	20	0	4	24	0	0
7	38578128	.	T	C	6	6	12	0	0	12	0	0
7	38578140	.	T	C	5	8	13	0	0	13	0	0
7	38588890	.	T	G	6	13	19	0	1	20	0	0
7	38594474	.	A	C	10	15	25	0	0	25	0	0
7	38594510	.	G	C	8	12	20	0	0	20	0	0
7	38600226	.	A	G	14	22	36	0	0	36	0	0
7	38600265	.	T	C	19	23	42	0	1	43	0	0
7	38600483	.	A	G	6	18	24	1	2	27	0	0
7	38600585	.	C	T	3	13	16	0	26	42	0	0
7	38600892	.	G	A	18	15	33	0	1	34	0	0
7	38600982	.	G	A	30	27	57	0	1	58	0	0
7	38601025	.	G	T	29	26	55	0	3	58	0	0
7	38601067	.	G	T	33	20	53	0	1	55	1	0
7	38601156	.	G	T	25	16	41	0	0	41	0	0
7	38601374	.	C	T	31	31	62	0	0	62	0	0
7	38601391	.	T	A	23	37	60	0	1	61	0	0
7	38601417	.	A	C	28	32	60	0	1	61	0	0
7	38601625	.	C	A	41	7	48	0	1	49	0	0
7	38601646	.	G	A	35	14	49	0	1	50	0	0
7	38601751	.	T	C	33	19	52	0	2	54	0	0
7	38601759	.	C	G	38	19	57	0	1	58	0	0
7	38601823	.	C	A	1	10	11	1	38	50	0	0
7	38601909	.	C	T	4	15	19	0	31	50	0	0
7	38602123	.	C	T	32	29	61	0	2	63	0	0
7	38602160	.	A	T	28	29	57	0	0	57	0	0
7	38602623	.	T	C	39	29	68	0	4	72	0	0
7	38602656	.	G	A	38	29	67	0	4	71	0	0
7	38602917	.	A	T	37	30	67	0	3	70	0	0
7	38612100	.	A	G	29	25	54	0	0	54	0	0
7	38612109	.	G	A	23	27	50	0	1	51	0	0
7	38612334	.	T	C	1	0	1	0	4	5	0	0
7	38671516	.	A	G	14	11	25	0	1	26	0	0
7	38671782	.	T	C	15	18	33	0	0	33	0	0
7	38673259	.	G	A	1	14	15	0	15	30	0	0
7	38674189	.	T	C	16	18	34	0	2	36	0	0
7	38677497	.	T	C	15	16	31	0	5	36	0	0
7	38677880	.	G	T	17	11	28	0	1	29	0	0
7	38677999	.	A	T	6	9	15	0	1	16	0	0
7	38680066	.	G	T	5	7	12	0	0	12	0	0
7	38681322	.	C	T	16	13	29	0	0	29	0	0
7	38683503	.	C	A	13	16	29	0	1	30	0	0
7	38683834	.	T	C	16	16	32	0	1	33	0	0
7	38684830	.	C	T	23	23	46	0	0	46	0	0
7	38684970	.	C	T	11	14	25	0	2	27	0	0
7	38689592	.	A	T	2	5	7	0	0	7	0	0
7	38689603	.	A	C	2	5	7	0	0	7	0	0
7	38689701	.	G	A	1	8	9	0	1	10	0	0
7	38689898	.	G	A	0	5	5	1	0	6	0	0
7	38689954	.	G	C	1	3	4	0	0	4	0	0
7	38696163	.	A	G	41	35	76	0	4	80	0	0
7	38698648	.	G	T	1	3	4	0	0	4	0	0
7	38703598	.	C	T	6	4	10	0	1	11	0	0
7	38703962	.	G	T	7	5	12	0	0	12	0	0
7	38703964	.	A	T	7	5	12	0	0	12	0	0
7	38704006	.	G	A	4	6	10	0	0	10	0	0
7	38704009	.	G	A	4	6	10	0	0	10	0	0
7	38704063	.	T	C	2	10	12	0	0	12	0	0
7	38704201	.	T	C	2	2	4	0	0	4	0	0
7	38704622	.	C	A	6	4	10	0	0	10	0	0
7	38704623	.	T	C	6	0	6	0	4	10	0	0
7	38704832	.	G	A	7	3	10	0	0	10	0	0
7	38704834	.	A	G	7	2	9	0	1	10	0	0
7	38705012	.	A	T	9	6	15	0	0	15	0	0
7	38705097	.	A	C	7	0	7	0	5	12	0	0
7	38705367	.	C	G	1	12	13	0	6	19	0	0
7	38705643	.	A	G	9	11	20	1	0	21	0	0
7	38709326	.	G	T	7	7	14	0	0	14	0	0
7	38709701	.	G	A	6	4	10	0	1	11	0	0
7	38714503	.	A	T	2	6	8	0	0	8	0	0
7	38717795	.	G	A	1	13	14	0	11	25	0	0
7	38717819	.	A	C	16	12	28	0	2	30	0	0
7	38722708	.	T	C	20	15	35	0	0	35	0	0
7	38722716	.	T	A	22	13	35	0	5	40	0	0
7	38726646	.	A	G	22	16	38	0	0	38	0	0
7	38734152	.	G	A	1	15	16	0	5	21	0	0
7	38734276	.	T	G	9	10	19	0	0	19	0	0
7	38734431	.	C	A	21	13	34	0	2	36	0	0
7	38734475	.	A	C	17	19	36	0	1	37	0	0
7	38734527	.	T	C	13	16	29	0	1	30	0	0
7	38734573	.	A	G	16	18	34	0	1	35	0	0
7	38734626	.	G	T	24	17	41	0	1	42	0	0
7	38735363	.	A	G	20	18	38	0	0	38	0	0
7	38735406	.	C	T	22	22	44	0	0	44	0	0
7	38735460	.	G	T	28	16	44	0	0	44	0	0
7	38735465	.	A	C	30	15	45	0	1	46	0	0
7	38735501	.	T	C	21	11	32	0	0	32	0	0
7	38735580	.	G	T	2	3	5	0	0	5	0	0
7	38735711	.	G	A	7	17	24	0	1	25	0	0
7	38735727	.	A	T	9	16	25	0	0	25	0	0
7	38735827	.	A	C	12	6	18	0	3	21	0	0
7	38736320	.	G	C	26	21	47	0	2	49	0	0
7	38736526	.	C	T	10	12	22	0	1	23	0	0
7	38736818	.	C	A	2	3	5	0	0	5	0	0
7	38736819	.	A	G	2	3	5	0	0	5	0	0
7	38736912	.	T	C	3	5	8	0	0	8	0	0
7	38737020	.	T	C	9	11	20	0	1	21	0	0
7	38737224	.	C	T	15	6	21	0	0	21	0	0
7	38737286	.	C	T	11	10	21	0	2	23	0	0
7	38748417	.	T	C	1	2	3	0	0	3	0	0
7	38748418	.	T	G	1	0	1	0	2	3	0	0
7	38762091	.	A	C	10	3	13	0	1	14	0	0
7	38762127	.	A	G	23	0	23	0	19	42	0	0
7	38773039	.	C	T	23	12	35	0	1	36	0	0
7	38775075	.	A	G	19	22	41	0	3	44	0	0
7	38775078	.	C	T	21	22	43	0	2	45	0	0
7	38777082	.	C	T	23	14	37	1	1	39	0	0
7	38779339	.	A	G	20	1	21	0	14	35	0	0
7	38779759	.	A	G	29	1	30	1	22	53	0	0
7	38783439	.	C	T	24	26	50	0	4	54	0	0
7	38783644	.	A	G	19	21	40	0	2	42	0	0
7	38783742	.	G	A	25	8	33	0	2	35	0	0
7	38783972	.	T	C	14	15	29	2	0	31	0	0
7	38784415	.	A	G	2	0	2	1	29	32	0	0
7	38784439	.	A	G	9	18	27	1	2	30	0	0
7	38784648	.	A	G	30	23	53	0	2	55	0	0
7	38784766	.	C	A	26	22	48	0	2	50	0	0
7	38784786	.	T	A	28	30	58	0	1	59	0	0
7	38784818	.	G	A	32	25	57	0	3	60	0	0
7	38784976	.	T	A	19	24	43	0	4	47	0	0
7	38785069	.	C	T	22	16	38	0	0	38	0	0
7	38785182	.	G	C	1	17	18	0	21	39	0	0
7	38785224	.	G	A	3	19	22	0	18	40	0	0
7	38794090	.	T	G	17	14	31	0	1	32	0	0
7	38794235	.	C	T	11	16	27	0	0	27	0	0
7	38798630	.	A	G	18	11	29	0	1	30	0	0
7	38805508	.	T	G	11	15	26	0	0	26	0	0
7	38805781	.	T	A	7	10	17	1	1	19	0	0
7	38807677	.	T	G	14	18	32	0	1	33	0	0
7	38807714	.	G	A	25	11	36	0	2	38	0	0
7	38807723	.	A	T	28	12	40	0	2	42	0	0
7	38807797	.	G	A	11	6	17	0	0	17	0	0
7	38809508	.	C	T	3	2	5	0	1	6	0	0
7	38809865	.	G	T	0	3	3	0	3	6	0	0
7	38810084	.	A	C	1	10	11	0	1	12	0	0
7	38822327	.	C	T	5	7	12	0	0	12	0	0
7	38822368	.	A	T	6	5	11	0	0	11	0	0
7	38822523	.	G	A	5	2	7	0	1	8	0	0
7	38822528	.	C	A	1	2	3	0	5	8	0	0
7	38822559	.	C	T	0	4	4	0	5	9	0	0
7	38822825	.	T	C	5	3	8	0	0	8	0	0
7	38824259	.	G	A	8	5	13	0	0	13	0	0
7	38824387	.	C	G	7	6	13	0	0	13	0	0
7	38827635	.	T	A	4	6	10	0	0	10	0	0
7	38842502	.	C	T	0	4	4	0	9	13	0	0
7	38861650	.	C	G	0	2	2	0	1	3	0	0
7	38953464	.	G	C	4	2	6	0	0	6	0	0
7	38954102	.	T	C	1	5	6	0	1	7	0	0
7	38962294	.	C	A	6	3	9	0	0	9	0	0
7	38962353	.	T	G	0	2	2	0	1	3	0	0
7	38962584	.	T	C	5	5	10	0	3	13	0	0
7	39089696	.	C	A	5	8	13	0	0	13	0	0
7	39100137	.	C	A	5	5	10	0	1	11	0	0
7	39123095	.	G	A	2	11	13	0	11	24	0	0
7	39145653	.	C	T	14	10	24	0	0	24	0	0
7	39153769	.	C	A	3	6	9	0	1	10	0	0
7	39153849	.	G	A	0	11	11	0	8	19	0	0
7	39153975	.	G	A	6	4	10	0	0	10	0	0
7	39154119	.	C	T	5	9	14	0	0	14	0	0
7	39154181	.	A	T	4	5	9	0	0	9	0	0
7	39154844	.	A	G	3	2	5	0	0	5	0	0
7	39155099	.	C	T	1	7	8	0	0	8	0	0
7	39155115	.	T	C	2	7	9	0	0	9	0	0
7	39155163	.	C	A	4	6	10	0	0	11	1	0
7	39155298	.	A	G	11	3	14	0	2	16	0	0
7	39155301	.	A	G	13	0	13	0	3	16	0	0
7	39155344	.	G	A	11	6	17	0	0	17	0	0
7	39155758	.	T	G	2	3	5	0	0	5	0	0
7	39155940	.	T	A	5	5	10	0	0	10	0	0
7	39156140	.	T	C	11	15	26	0	1	27	0	0
7	39156161	.	C	T	16	8	24	0	0	24	0	0
7	39156207	.	T	C	11	8	19	0	2	21	0	0
7	39156474	.	T	C	12	14	26	0	0	26	0	0
7	39156553	.	C	A	13	11	24	0	1	25	0	0
7	39156673	.	A	T	4	4	8	0	1	9	0	0
7	39156760	.	A	G	12	12	24	0	2	26	0	0
7	39157175	.	A	T	9	7	16	0	0	16	0	0
7	39157219	.	G	A	1	4	5	0	5	10	0	0
7	39157239	.	C	A	4	6	10	0	0	10	0	0
7	39174052	.	T	C	15	17	32	0	2	34	0	0
7	39174452	.	G	A	1	26	27	0	19	46	0	0
7	39176261	.	G	A	4	17	21	0	26	47	0	0
7	39176444	.	G	A	2	26	28	0	20	48	0	0
7	39176447	.	A	C	19	26	45	0	3	48	0	0
7	39176739	.	A	T	17	10	27	0	0	27	0	0
7	39176863	.	G	A	15	22	37	0	0	37	0	0
7	39176881	.	G	A	23	13	36	1	1	38	0	0
7	39176940	.	A	G	7	4	11	3	0	14	0	0
7	39176957	.	A	G	2	8	10	1	0	11	0	0
7	39176983	.	T	C	3	4	7	0	2	9	0	0
7	39177717	.	A	G	0	19	19	0	0	19	0	0
7	39177729	.	A	G	7	10	17	0	2	19	0	0
7	39177871	.	C	A	3	5	8	0	0	8	0	0
7	39178065	.	A	G	4	1	5	1	2	8	0	0
7	39181275	.	A	G	14	8	22	0	0	22	0	0
7	39181318	.	C	T	15	13	28	0	0	28	0	0
7	39181597	.	C	A	13	14	27	0	0	27	0	0
7	39181853	.	C	A	12	8	20	0	1	21	0	0
7	39182265	.	T	C	20	13	33	0	1	34	0	0
7	39182433	.	T	C	15	18	33	0	2	35	0	0
7	39182910	.	G	A	22	18	40	0	0	40	0	0
7	39183045	.	A	G	15	14	29	0	1	30	0	0
7	39280721	.	A	T	4	4	8	0	1	9	0	0
7	39451843	.	A	G	2	2	4	0	0	4	0	0
7	39482671	.	C	G	0	5	5	0	1	6	0	0
7	39482674	.	G	C	1	0	1	0	5	6	0	0
7	39482841	.	T	C	1	5	6	0	0	6	0	0
7	39537983	.	C	G	5	4	9	0	0	9	0	0
7	39538001	.	T	C	4	6	10	0	0	10	0	0
7	39541293	.	T	G	2	8	10	0	1	11	0	0
7	39541452	.	A	C	1	3	4	0	0	4	0	0
7	39548697	.	G	A	8	4	12	0	1	13	0	0
7	39551880	.	C	T	0	2	2	0	9	11	0	0
7	39552270	.	G	T	5	2	7	0	0	7	0	0
7	39642671	.	G	A	2	8	10	0	10	20	0	0
7	39643001	.	G	A	12	10	22	0	0	22	0	0
7	39643046	.	A	G	8	8	16	0	0	16	0	0
7	39648980	.	A	G	5	6	11	0	0	11	0	0
7	39649070	.	C	T	8	6	14	0	0	14	0	0
7	39654722	.	C	T	10	10	20	0	2	22	0	0
7	39655392	.	T	G	6	11	17	0	0	17	0	0
7	39655524	.	T	A	8	7	15	0	0	15	0	0
7	39655586	.	C	G	8	5	13	0	0	13	0	0
7	39656372	.	C	T	5	7	12	0	0	12	0	0
7	39656394	.	T	A	6	5	11	0	0	11	0	0
7	39656620	.	G	A	8	9	17	0	0	17	0	0
7	39656916	.	C	T	4	7	11	1	0	12	0	0
7	39656950	.	G	T	4	5	9	3	1	13	0	0
7	39657301	.	C	T	5	3	8	0	0	8	0	0
7	39657693	.	G	T	6	5	11	0	0	11	0	0
7	39658224	.	A	C	11	15	26	0	0	26	0	0
7	39658293	.	C	A	12	11	23	0	0	24	1	0
7	39658356	.	T	C	9	11	20	0	1	21	0	0
7	39658445	.	C	A	9	12	21	0	0	21	0	0
7	39658730	.	G	T	1	16	17	0	13	30	0	0
7	39658831	.	T	G	13	13	26	0	2	28	0	0
7	39659275	.	A	C	6	4	10	0	0	10	0	0
7	39659400	.	T	A	7	2	9	2	1	12	0	0
7	39659711	.	A	C	5	3	8	2	0	10	0	0
7	39659758	.	C	A	6	5	11	0	1	12	0	0
7	39659806	.	G	A	8	4	12	0	0	12	0	0
7	39659973	.	A	G	9	8	17	0	1	18	0	0
7	39660054	.	A	C	5	4	9	0	1	10	0	0
7	39660201	.	G	A	11	16	27	0	3	30	0	0
7	39660240	.	A	T	6	26	32	0	1	33	0	0
7	39660249	.	A	C	24	15	39	0	1	40	0	0
7	39670892	.	G	C	11	11	22	0	1	23	0	0
7	39671118	.	T	A	10	7	17	0	2	19	0	0
7	39671281	.	G	A	16	13	29	0	0	29	0	0
7	39671647	.	C	T	16	7	23	0	1	24	0	0
7	39671715	.	A	C	9	7	16	0	0	16	0	0
7	39672054	.	A	T	7	8	15	0	0	15	0	0
7	39672165	.	G	A	14	6	20	0	1	21	0	0
7	39672741	.	A	G	11	17	28	0	0	28	0	0
7	39673095	.	A	G	11	0	11	0	8	19	0	0
7	39673773	.	G	C	2	10	12	0	8	20	0	0
7	39675838	.	A	G	7	8	15	0	0	15	0	0
7	39675961	.	T	A	2	3	5	0	0	5	0	0
7	39676027	.	A	G	2	2	4	0	0	4	0	0
7	39676183	.	T	A	8	12	20	0	0	20	0	0
7	39676446	.	A	T	9	7	16	0	1	17	0	0
7	39676518	.	A	G	9	7	16	0	2	18	0	0
7	39676833	.	T	C	7	13	20	0	1	21	0	0
7	39676947	.	T	G	14	9	23	1	3	27	0	0
7	39676948	.	T	G	16	8	24	1	4	29	0	0
7	39677347	.	G	A	11	8	19	0	0	19	0	0
7	39677948	.	G	T	11	17	28	0	0	28	0	0
7	39691119	.	G	A	2	13	15	0	8	23	0	0
7	39691357	.	G	A	10	4	14	0	0	14	0	0
7	39693686	.	T	C	7	7	14	0	0	14	0	0
7	39695776	.	A	C	5	7	12	0	0	12	0	0
7	39701913	.	A	C	9	15	24	0	0	24	0	0
7	39702172	.	T	C	4	2	6	0	0	6	0	0
7	39702337	.	C	A	8	5	13	0	1	14	0	0
7	39702569	.	G	T	5	2	7	0	0	7	0	0
7	39702800	.	C	T	4	2	6	0	0	6	0	0
7	39702827	.	C	T	2	6	8	0	0	8	0	0
7	39703720	.	G	T	4	2	6	0	0	6	0	0
7	39703734	.	T	C	3	2	5	0	0	5	0	0
7	39704063	.	T	A	6	2	8	0	0	8	0	0
7	39704085	.	A	G	6	5	11	0	0	11	0	0
7	39704166	.	A	T	8	5	13	0	0	13	0	0
7	39704267	.	C	A	12	4	16	0	0	16	0	0
7	39705601	.	A	G	8	7	15	0	0	15	0	0
7	39705683	.	T	A	6	0	6	0	0	6	0	0
7	39731015	.	T	A	1	3	4	0	0	4	0	0
7	39742334	.	G	A	0	2	2	0	1	3	0	0
7	39742820	.	T	G	3	2	5	0	0	5	0	0
7	39742841	.	A	T	3	3	6	0	1	7	0	0
7	39743126	.	G	A	6	2	8	0	0	8	0	0
7	39743177	.	C	A	2	5	7	0	0	7	0	0
7	39743181	.	T	C	5	2	7	0	0	7	0	0
7	39744543	.	G	A	2	3	5	0	0	5	0	0
7	39745091	.	T	C	8	6	14	0	0	14	0	0
7	39745110	.	A	T	6	9	15	0	0	15	0	0
7	39748847	.	T	C	16	6	22	0	0	22	0	0
7	39748934	.	A	C	12	14	26	0	1	27	0	0
7	39758749	.	G	A	5	3	8	0	0	8	0	0
7	39983885	.	G	A	7	3	10	0	0	10	0	0
7	39998146	.	A	G	1	2	3	0	0	3	0	0
7	40023279	.	C	T	5	9	14	0	0	14	0	0
7	40040982	.	C	T	2	6	8	0	0	8	0	0
7	40043336	.	T	C	5	5	10	0	0	10	0	0
7	40046715	.	G	A	7	6	13	0	2	15	0	0
7	40046734	.	T	C	9	6	15	0	0	15	0	0
7	40050962	.	C	T	7	10	17	0	0	17	0	0
7	40050986	.	G	C	0	8	8	0	10	18	0	0
7	40053306	.	G	A	13	8	21	0	0	21	0	0
7	40053490	.	T	C	14	7	21	0	0	21	0	0
7	40053537	.	C	T	12	12	24	0	1	25	0	0
7	40053717	.	T	A	7	10	17	0	2	19	0	0
7	40053720	.	G	A	10	6	16	0	2	18	0	0
7	40053978	.	C	T	9	12	21	0	0	21	0	0
7	40054052	.	C	T	0	12	12	0	3	15	0	0
7	40054234	.	G	A	3	9	12	0	0	12	0	0
7	40054464	.	A	C	6	3	9	0	0	9	0	0
7	40054901	.	G	T	11	9	20	0	2	22	0	0
7	40054925	.	G	T	0	11	11	0	14	25	0	0
7	40055080	.	T	C	18	12	30	0	1	31	0	0
7	40055099	.	C	T	14	15	29	0	0	29	0	0
7	40055117	.	T	A	12	10	22	0	3	25	0	0
7	40055178	.	C	G	7	16	23	1	3	27	0	0
7	40055353	.	A	G	10	0	10	0	7	17	0	0
7	40055612	.	C	T	13	7	20	0	0	20	0	0
7	40055628	.	G	A	14	6	20	0	1	21	0	0
7	40055672	.	G	A	11	7	18	0	0	18	0	0
7	40055711	.	A	T	6	4	10	0	0	10	0	0
7	40055844	.	C	T	5	7	12	0	1	13	0	0
7	40055928	.	T	C	7	6	13	0	1	14	0	0
7	40055945	.	C	T	10	3	13	0	0	13	0	0
7	40056060	.	C	T	16	7	23	0	0	23	0	0
7	40056112	.	T	G	15	8	23	0	0	23	0	0
7	40056307	.	C	T	11	9	20	0	1	21	0	0
7	40056353	.	G	A	6	9	15	0	0	15	0	0
7	40056417	.	C	A	4	8	12	0	0	12	0	0
7	40056542	.	A	T	10	8	18	0	0	18	0	0
7	40056587	.	C	T	12	8	20	0	0	20	0	0
7	40056589	.	T	C	11	7	18	0	1	19	0	0
7	40056729	.	A	T	7	12	19	0	0	19	0	0
7	40056851	.	T	C	6	8	14	1	0	15	0	0
7	40056854	.	C	T	8	6	14	1	1	16	0	0
7	40056982	.	C	T	6	6	12	1	0	13	0	0
7	40057140	.	G	A	7	8	15	0	0	15	0	0
7	40057393	.	C	T	10	8	18	0	1	19	0	0
7	40057581	.	T	G	5	5	10	0	1	11	0	0
7	40057674	.	A	G	1	2	3	0	0	3	0	0
7	40059207	.	G	A	6	4	10	0	0	10	0	0
7	40059248	.	T	C	8	9	17	0	0	17	0	0
7	40059673	.	G	A	3	3	6	0	0	6	0	0
7	40059984	.	T	C	6	0	6	0	0	6	0	0
7	40060505	.	C	T	3	4	7	0	0	7	0	0
7	40060543	.	A	T	3	3	6	0	0	6	0	0
7	40060665	.	T	A	2	2	4	0	0	4	0	0
7	40063669	.	G	T	4	4	8	0	0	8	0	0
7	40064621	.	G	C	4	5	9	0	0	9	0	0
7	40070531	.	C	G	1	2	3	0	0	3	0	0
7	40071605	.	A	C	1	0	1	0	2	3	0	0
7	40071776	.	G	A	6	4	10	0	0	10	0	0
7	40072184	.	T	C	5	2	7	0	0	7	0	0
7	40072371	.	T	G	9	9	18	0	0	18	0	0
7	40074825	.	A	G	9	9	18	0	0	18	0	0
7	40076634	.	T	C	11	0	11	0	8	19	0	0
7	40076782	.	A	G	5	8	13	0	0	13	0	0
7	40079824	.	A	C	7	1	8	0	2	10	0	0
7	40080166	.	C	T	8	3	11	0	0	11	0	0
7	40081813	.	C	T	1	5	6	0	7	13	0	0
7	40083683	.	T	A	14	17	31	0	1	32	0	0
7	40083762	.	C	G	11	7	18	0	1	19	0	0
7	40083786	.	A	T	8	7	15	0	0	15	0	0
7	40083815	.	T	A	8	5	13	0	1	14	0	0
7	40090547	.	T	A	10	12	22	1	0	23	0	0
7	40090602	.	T	C	17	12	29	0	0	29	0	0
7	40091332	.	C	A	12	3	15	0	1	16	0	0
7	40091460	.	C	T	8	5	13	0	0	13	0	0
7	40091510	.	G	T	2	4	6	0	0	6	0	0
7	40091543	.	T	C	4	3	7	0	0	7	0	0
7	40091552	.	A	T	5	7	12	0	0	12	0	0
7	40091622	.	C	G	12	4	16	0	0	16	0	0
7	40091718	.	G	A	16	14	30	0	1	31	0	0
7	40091749	.	T	C	14	10	24	0	1	25	0	0
7	40091818	.	T	G	6	9	15	0	1	16	0	0
7	40091951	.	A	T	4	2	6	0	0	6	0	0
7	40093771	.	C	T	2	2	4	0	1	5	0	0
7	40094359	.	C	A	6	5	11	0	0	11	0	0
7	40097105	.	A	C	8	10	18	0	2	20	0	0
7	40097271	.	C	G	6	7	13	0	0	13	0	0
7	40097304	.	C	A	6	6	12	0	1	13	0	0
7	40097313	.	G	C	5	4	9	0	1	10	0	0
7	40097345	.	A	G	7	5	12	0	0	12	0	0
7	40097395	.	A	G	7	8	15	0	0	15	0	0
7	40097396	.	T	C	7	8	15	0	0	15	0	0
7	40097602	.	A	G	5	0	5	0	5	10	0	0
7	40097681	.	T	A	4	5	9	0	0	9	0	0
7	40100168	.	A	C	5	5	10	0	0	10	0	0
7	40100294	.	C	T	3	3	6	0	1	7	0	0
7	40100306	.	T	C	3	2	5	0	1	6	0	0
7	40100357	.	C	T	1	2	3	0	0	3	0	0
7	40100976	.	C	T	1	3	4	0	0	4	0	0
7	40104296	.	T	C	2	4	6	0	0	6	0	0
7	40123073	.	T	A	1	2	3	0	0	3	0	0
7	40126570	.	T	C	1	0	1	0	3	4	0	0
7	40126615	.	T	C	1	3	4	0	0	4	0	0
7	40140152	.	C	T	1	2	3	0	0	3	0	0
7	40140213	.	A	T	4	2	6	0	1	7	0	0
7	40140399	.	T	C	2	8	10	0	0	10	0	0
7	40144428	.	T	A	5	4	9	0	0	9	0	0
7	40145032	.	A	T	4	5	9	0	0	10	1	0
7	40183152	.	A	G	3	3	6	0	0	6	0	0
7	40183822	.	T	A	5	4	9	0	0	9	0	0
7	40183825	.	G	A	5	4	9	0	0	9	0	0
7	40188991	.	C	T	7	6	13	0	0	13	0	0
7	40197623	.	C	A	7	7	14	0	0	14	0	0
7	40200740	.	G	A	1	3	4	0	0	4	0	0
7	40201016	.	C	T	5	6	11	0	2	13	0	0
7	40201108	.	G	T	7	7	14	0	0	14	0	0
7	40201200	.	G	A	3	6	9	0	0	9	0	0
7	40201975	.	A	G	4	5	9	0	1	10	0	0
7	40228499	.	A	T	27	15	42	0	5	47	0	0
7	40292834	.	T	C	21	20	41	0	1	42	0	0
7	40318309	.	T	A	14	22	36	0	1	38	1	0
7	40318486	.	A	G	25	1	26	0	24	50	0	0
7	40318580	.	G	T	17	17	34	0	2	36	0	0
7	40318593	.	G	A	18	18	36	0	3	39	0	0
7	40320956	.	A	C	25	22	47	0	0	47	0	0
7	40321174	.	C	T	16	28	44	0	2	46	0	0
7	40321224	.	A	G	22	22	44	0	2	46	0	0
7	40321273	.	G	T	29	23	52	0	2	54	0	0
7	40321443	.	C	T	23	19	42	0	3	45	0	0
7	40460256	.	T	C	25	26	51	0	1	52	0	0
7	40460371	.	C	T	19	23	42	0	1	43	0	0
7	40466026	.	A	G	32	27	59	0	2	61	0	0
7	40471301	.	A	G	24	34	58	0	1	59	0	0
7	40492740	.	T	A	42	28	70	0	3	73	0	0
7	40492764	.	G	C	4	38	42	0	34	76	0	0
7	40492789	.	T	C	40	26	66	0	2	68	0	0
7	40492800	.	G	T	38	22	60	0	2	62	0	0
7	40498598	.	G	A	27	26	53	0	1	54	0	0
7	40498934	.	C	A	22	16	38	0	3	41	0	0
7	40499177	.	A	C	7	9	16	0	0	16	0	0
7	40499182	.	A	G	7	8	15	0	0	15	0	0
7	40560398	.	C	T	4	3	7	0	0	7	0	0
7	40560934	.	G	A	14	11	25	0	0	25	0	0
7	40561366	.	G	A	6	3	9	0	0	9	0	0
7	40562662	.	C	T	0	8	8	0	8	16	0	0
7	40562743	.	G	A	9	6	15	0	0	15	0	0
7	40562757	.	T	G	10	6	16	1	0	17	0	0
7	40567075	.	T	C	14	11	25	0	1	26	0	0
7	40569966	.	G	A	12	11	23	0	0	23	0	0
7	40578658	.	C	G	11	9	20	0	0	20	0	0
7	40584121	.	A	C	11	3	14	0	2	16	0	0
7	40584148	.	T	C	13	0	13	0	7	20	0	0
7	40584395	.	G	C	12	10	22	0	0	22	0	0
7	40584415	.	G	C	11	12	23	0	2	25	0	0
7	40584469	.	C	T	8	11	19	0	0	19	0	0
7	40584988	.	A	C	7	4	11	0	0	11	0	0
7	40585112	.	A	G	1	6	7	0	0	7	0	0
7	40585217	.	T	C	6	6	12	0	0	12	0	0
7	40585546	.	A	T	4	7	11	0	1	12	0	0
7	40602439	.	G	A	6	6	12	0	1	13	0	0
7	40605299	.	T	A	9	6	15	0	0	15	0	0
7	40607911	.	T	A	7	3	10	0	0	10	0	0
7	40608459	.	T	C	4	0	4	0	4	8	0	0
7	40615603	.	T	C	6	2	8	0	0	8	0	0
7	40615648	.	T	C	6	0	6	0	5	11	0	0
7	40616896	.	A	G	2	6	8	0	0	8	0	0
7	40624281	.	A	T	7	3	10	0	0	10	0	0
7	40624753	.	G	A	3	5	8	0	0	8	0	0
7	40626449	.	C	T	3	5	8	0	0	8	0	0
7	40645217	.	A	G	7	5	12	0	2	14	0	0
7	40649674	.	G	A	2	3	5	0	0	5	0	0
7	40650862	.	G	T	1	2	3	0	1	4	0	0
7	40650869	.	G	A	1	1	2	0	1	3	0	0
7	40655696	.	A	G	1	2	3	0	0	3	0	0
7	40676025	.	G	A	1	4	5	0	0	5	0	0
7	40707966	.	G	A	0	4	4	0	5	9	0	0
7	40884570	.	T	C	2	5	7	0	0	7	0	0
7	40889981	.	C	T	2	9	11	0	0	11	0	0
7	40890410	.	A	G	4	6	10	0	1	11	0	0
7	40890678	.	G	A	4	5	9	1	1	11	0	0
7	40900772	.	G	A	10	13	23	2	1	26	0	0
7	40900785	.	C	A	3	6	9	2	14	26	1	0
7	40901126	.	A	T	3	2	5	0	0	5	0	0
7	40901425	.	T	A	3	3	6	0	0	6	0	0
7	40901436	.	G	A	3	4	7	0	0	7	0	0
7	40901584	.	A	C	5	4	9	0	0	9	0	0
7	40901592	.	T	C	6	6	12	0	0	12	0	0
7	40901628	.	A	G	3	4	7	0	0	7	0	0
7	40901659	.	A	G	6	2	8	0	1	9	0	0
7	40901704	.	C	T	1	4	5	0	4	9	0	0
7	40901779	.	C	G	7	4	11	0	1	12	0	0
7	40901945	.	T	C	12	6	18	0	1	19	0	0
7	40902057	.	A	C	2	0	2	0	4	6	0	0
7	40902065	.	A	G	2	3	5	0	0	5	0	0
7	40903292	.	G	A	1	7	8	0	0	8	0	0
7	40903491	.	T	A	8	6	14	0	1	15	0	0
7	40904099	.	A	G	4	2	6	0	0	6	0	0
7	40904446	.	C	T	3	3	6	1	0	7	0	0
7	40904630	.	T	A	1	2	3	0	0	3	0	0
7	40904709	.	A	C	2	2	4	0	0	4	0	0
7	40904762	.	T	A	2	4	6	0	1	7	0	0
7	40905695	.	A	T	6	5	11	0	2	13	0	0
7	40905774	.	C	T	0	8	8	0	14	22	0	0
7	40906286	.	T	C	5	10	15	0	0	15	0	0
7	40906377	.	T	C	9	4	13	0	0	13	0	0
7	40906415	.	T	A	3	3	6	0	1	7	0	0
7	40906516	.	C	A	1	2	3	0	3	6	0	0
7	40931758	.	G	C	9	7	16	0	0	16	0	0
7	40931873	.	T	A	5	7	12	0	0	12	0	0
7	40931874	.	C	T	0	6	6	0	6	12	0	0
7	40935308	.	C	T	8	9	17	0	1	18	0	0
7	40942588	.	G	C	6	4	10	0	0	10	0	0
7	40951391	.	G	A	7	8	15	0	0	15	0	0
7	40951554	.	G	A	4	3	7	0	0	7	0	0
7	40951557	.	G	A	2	3	5	0	1	6	0	0
7	40989156	.	A	G	3	4	7	0	1	8	0	0
7	40990473	.	G	C	3	8	11	0	0	11	0	0
7	40993298	.	G	A	7	6	13	0	1	14	0	0
7	40993422	.	G	A	3	6	9	0	0	9	0	0
7	40993442	.	T	G	2	6	8	0	1	9	0	0
7	41008618	.	T	C	15	5	20	0	1	21	0	0
7	41008856	.	C	T	0	8	8	0	12	20	0	0
7	41009217	.	C	T	1	13	14	0	13	27	0	0
7	41009797	.	T	A	14	19	33	1	5	39	0	0
7	41012081	.	A	T	11	14	25	0	1	26	0	0
7	41012505	.	C	T	4	12	16	0	16	32	0	0
7	41014175	.	C	T	9	12	21	0	1	22	0	0
7	41082391	.	T	G	3	3	6	0	0	6	0	0
7	41082686	.	A	T	2	2	4	0	0	4	0	0
7	41094469	.	T	C	2	1	3	0	3	6	0	0
7	41147792	.	A	G	20	0	20	1	14	35	0	0
7	41157531	.	G	C	9	23	32	0	3	35	0	0
7	41157735	.	T	C	13	20	33	0	2	36	1	0
7	41157805	.	C	A	22	17	39	0	1	40	0	0
7	41157997	.	G	A	5	19	24	0	0	24	0	0
7	41158057	.	C	T	9	16	25	0	1	26	0	0
7	41223561	.	C	T	6	9	15	0	0	15	0	0
7	41229427	.	T	C	3	9	12	0	0	12	0	0
7	41238313	.	C	T	7	7	14	0	0	14	0	0
7	41238671	.	T	C	5	9	14	0	0	14	0	0
7	41244570	.	C	G	6	0	6	0	11	17	0	0
7	41249387	.	T	C	5	3	8	0	0	8	0	0
7	41249526	.	C	T	4	3	7	0	0	7	0	0
7	41249613	.	A	G	5	0	5	0	6	11	0	0
7	41250813	.	T	C	7	5	12	0	0	12	0	0
7	41255443	.	A	T	14	17	31	0	2	33	0	0
7	41257549	.	G	T	9	3	12	0	0	12	0	0
7	41258015	.	T	C	7	8	15	0	1	16	0	0
7	41261343	.	C	A	15	11	26	0	3	29	0	0
7	41262058	.	T	G	11	12	23	0	0	23	0	0
7	41262277	.	A	G	12	14	26	0	1	27	0	0
7	41262361	.	G	A	9	6	15	0	0	15	0	0
7	41263277	.	G	A	1	6	7	0	13	20	0	0
7	41267424	.	C	T	13	14	27	0	1	28	0	0
7	41269653	.	C	G	19	16	35	0	1	36	0	0
7	41273527	.	T	C	10	7	17	0	1	18	0	0
7	41273889	.	T	C	2	14	16	0	0	16	0	0
7	41274080	.	T	G	7	15	22	0	0	22	0	0
7	41274258	.	T	C	7	12	19	0	0	19	0	0
7	41274261	.	A	G	7	0	7	0	12	19	0	0
7	41274802	.	C	A	17	6	23	0	2	25	0	0
7	41274896	.	A	C	13	12	25	0	2	27	0	0
7	41274916	.	A	C	10	10	20	0	1	21	0	0
7	41274943	.	T	A	10	11	21	0	0	21	0	0
7	41313645	.	G	A	6	3	9	0	0	9	0	0
7	41313853	.	C	A	2	2	4	0	0	4	0	0
7	41313894	.	G	C	1	4	5	0	0	5	0	0
7	41313920	.	C	A	2	3	5	0	0	5	0	0
7	41314900	.	G	T	1	7	8	0	0	8	0	0
7	41316722	.	T	G	5	5	10	0	1	11	0	0
7	41318020	.	A	G	4	3	7	0	0	7	0	0
7	41318023	.	A	T	4	3	7	0	0	7	0	0
7	41318087	.	A	T	3	2	5	0	0	5	0	0
7	41322440	.	G	A	5	2	7	0	0	7	0	0
7	41322946	.	G	A	2	2	4	0	0	4	0	0
7	41326482	.	A	G	4	3	7	0	1	8	0	0
7	41329433	.	G	C	3	2	5	0	0	5	0	0
7	41329674	.	T	G	5	3	8	0	0	8	0	0
7	41329683	.	A	G	3	4	7	0	0	7	0	0
7	41329778	.	A	G	3	0	3	0	2	5	0	0
7	41330059	.	T	A	5	3	8	0	0	8	0	0
7	41330198	.	G	A	2	3	5	0	0	5	0	0
7	41330210	.	T	A	1	2	3	0	0	3	0	0
7	41331205	.	T	C	4	4	8	3	1	13	1	0
7	41340562	.	C	T	5	2	7	0	1	8	0	0
7	41340641	.	T	C	5	5	10	0	0	10	0	0
7	41344440	.	T	A	4	3	7	0	0	7	0	0
7	41345105	.	C	T	4	2	6	0	1	7	0	0
7	41345123	.	C	T	3	3	6	0	1	7	0	0
7	41345282	.	A	C	5	6	11	0	0	11	0	0
7	41345375	.	T	C	6	4	10	0	0	10	0	0
7	41345393	.	A	T	5	3	8	0	0	8	0	0
7	41345463	.	T	G	4	3	7	0	0	7	0	0
7	41345720	.	G	A	3	4	7	0	0	7	0	0
7	41345723	.	T	C	3	4	7	0	0	7	0	0
7	41345828	.	G	T	10	7	17	0	1	18	0	0
7	41347138	.	C	T	3	3	6	0	0	6	0	0
7	41347642	.	T	C	6	8	14	0	1	15	0	0
7	41347813	.	C	T	2	2	4	0	2	6	0	0
7	41348023	.	C	T	2	5	7	0	0	7	0	0
7	41348026	.	T	C	2	5	7	0	0	7	0	0
7	41348827	.	C	T	1	3	4	0	0	4	0	0
7	41349128	.	C	T	0	8	8	0	5	13	0	0
7	41349454	.	G	T	13	8	21	0	0	21	0	0
7	41350424	.	A	G	2	4	6	0	0	6	0	0
7	41352145	.	T	A	10	3	13	0	0	13	0	0
7	41353258	.	G	A	6	6	12	0	0	12	0	0
7	41355308	.	T	C	3	5	8	0	0	8	0	0
7	41356188	.	A	G	6	2	8	0	0	8	0	0
7	41356547	.	C	T	4	3	7	0	1	8	0	0
7	41357602	.	G	A	7	5	12	0	0	12	0	0
7	41357623	.	G	C	6	3	9	0	0	9	0	0
7	41359972	.	C	T	6	7	13	0	1	14	0	0
7	41359987	.	A	T	4	7	11	0	0	11	0	0
7	41360436	.	T	C	5	2	7	0	0	7	0	0
7	41361864	.	A	G	7	3	10	0	0	10	0	0
7	41362017	.	A	T	4	4	8	0	0	8	0	0
7	41362029	.	G	A	3	4	7	0	0	7	0	0
7	41362945	.	A	G	2	2	4	0	0	4	0	0
7	41363014	.	C	G	3	5	8	0	0	8	0	0
7	41363031	.	C	G	3	7	10	0	0	10	0	0
7	41363065	.	T	C	4	6	10	0	0	10	0	0
7	41363510	.	C	T	3	2	5	0	0	5	0	0
7	41364578	.	G	A	4	3	7	0	0	7	0	0
7	41364668	.	C	T	3	2	5	0	0	5	0	0
7	41367337	.	G	A	3	4	7	0	1	8	0	0
7	41367380	.	A	T	2	3	5	0	1	6	0	0
7	41368963	.	T	C	1	2	3	0	0	3	0	0
7	41372225	.	A	T	4	4	8	0	0	8	0	0
7	41372229	.	C	G	3	4	7	0	0	7	0	0
7	41372423	.	A	G	6	4	10	0	0	10	0	0
7	41372568	.	A	G	3	2	5	0	0	5	0	0
7	41372622	.	C	T	2	2	4	0	0	4	0	0
7	41377188	.	A	G	4	3	7	0	0	7	0	0
7	41382293	.	T	C	5	2	7	0	0	7	0	0
7	41384630	.	G	A	1	2	3	0	0	3	0	0
7	41389964	.	G	A	2	2	4	0	0	4	0	0
7	41389994	.	C	A	1	2	3	0	0	3	0	0
7	41390033	.	G	A	2	2	4	0	0	4	0	0
7	41390039	.	G	T	2	3	5	0	0	5	0	0
7	41401881	.	T	C	2	3	5	0	0	5	0	0
7	41402943	.	C	G	2	4	6	0	0	6	0	0
7	41402988	.	G	C	3	3	6	0	0	6	0	0
7	41403970	.	T	A	6	3	9	0	1	10	0	0
7	41403991	.	A	T	6	4	10	0	0	10	0	0
7	41404012	.	A	G	9	6	15	0	1	16	0	0
7	41404081	.	C	T	16	2	18	0	2	20	0	0
7	41404552	.	G	A	10	4	14	0	1	15	0	0
7	41404564	.	A	G	10	6	16	0	0	16	0	0
7	41405926	.	A	G	6	3	9	0	1	10	0	0
7	41406005	.	G	A	10	6	16	1	0	17	0	0
7	41413530	.	G	A	7	7	14	0	0	14	0	0
7	41413760	.	C	T	6	4	10	0	0	10	0	0
7	41413829	.	T	C	10	3	13	0	0	13	0	0
7	41413838	.	A	C	9	0	9	0	5	14	0	0
7	41416192	.	G	A	9	3	12	0	1	13	0	0
7	41419036	.	A	C	8	6	14	0	1	15	0	0
7	41419132	.	G	A	8	7	15	0	1	16	0	0
7	41419183	.	G	T	14	12	26	0	0	26	0	0
7	41422030	.	T	A	5	3	8	0	0	8	0	0
7	41422123	.	C	A	11	4	15	0	0	15	0	0
7	41422318	.	C	G	8	6	14	0	0	14	0	0
7	41427737	.	G	T	4	10	14	0	0	14	0	0
7	41430417	.	T	C	7	10	17	0	3	20	0	0
7	41431901	.	A	T	5	10	15	0	1	16	0	0
7	41431916	.	T	C	4	9	13	0	0	13	0	0
7	41432039	.	T	C	9	6	15	0	1	16	0	0
7	41432220	.	G	A	1	10	11	0	11	22	0	0
7	41432324	.	T	A	4	4	8	0	0	8	0	0
7	41432676	.	T	C	14	6	20	0	0	20	0	0
7	41432732	.	A	T	8	10	18	0	0	18	0	0
7	41432906	.	T	C	4	9	13	0	1	14	0	0
7	41433390	.	T	A	9	4	13	0	0	13	0	0
7	41436575	.	T	C	6	0	6	0	4	10	0	0
7	41436811	.	T	A	1	3	4	0	0	4	0	0
7	41436845	.	G	A	3	3	6	0	0	6	0	0
7	41436902	.	A	G	4	4	8	0	0	8	0	0
7	41436907	.	G	A	5	5	10	0	0	10	0	0
7	41437342	.	A	C	8	10	18	0	0	18	0	0
7	41437363	.	A	G	10	12	22	0	0	22	0	0
7	41437623	.	C	A	11	7	18	0	0	18	0	0
7	41437715	.	T	G	11	10	21	0	0	21	0	0
7	41437827	.	C	A	0	3	3	0	16	19	0	0
7	41437948	.	G	A	9	9	18	0	1	19	0	0
7	41438036	.	A	C	7	5	12	0	0	12	0	0
7	41438417	.	T	A	11	4	15	0	0	15	0	0
7	41438502	.	C	T	0	7	7	0	7	14	0	0
7	41438676	.	G	T	5	4	9	0	1	10	0	0
7	41438677	.	T	C	5	5	10	0	0	10	0	0
7	41438826	.	C	T	1	14	15	0	10	25	0	0
7	41438871	.	C	T	4	11	15	0	6	21	0	0
7	41438896	.	C	T	1	6	7	0	8	15	0	0
7	41438970	.	G	A	7	11	18	0	0	18	0	0
7	41439411	.	C	T	1	15	16	0	7	23	0	0
7	41443125	.	G	A	5	7	12	0	0	12	0	0
7	41443186	.	C	T	1	6	7	0	3	10	0	0
7	41452225	.	T	C	10	1	11	0	12	23	0	0
7	41491652	.	C	T	7	2	9	0	0	9	0	0
7	41491701	.	A	T	6	2	8	0	0	8	0	0
7	41491758	.	G	A	5	2	7	0	0	7	0	0
7	41491785	.	A	G	3	3	6	0	1	7	0	0
7	41491841	.	T	C	3	4	7	0	0	7	0	0
7	41496791	.	G	A	11	9	20	0	0	20	0	0
7	41500538	.	A	G	10	13	23	0	0	23	0	0
7	41500676	.	G	A	8	5	13	0	0	13	0	0
7	41501061	.	A	G	4	7	11	0	0	11	0	0
7	41501124	.	A	G	6	10	16	0	1	17	0	0
7	41503775	.	G	A	9	5	14	0	1	15	0	0
7	41506677	.	A	G	6	6	12	0	0	12	0	0
7	41506683	.	T	C	5	8	13	0	0	13	0	0
7	41511515	.	G	T	6	4	10	0	0	10	0	0
7	41511558	.	T	C	5	2	7	0	0	7	0	0
7	41511626	.	C	T	5	7	12	0	0	12	0	0
7	41511804	.	T	C	8	6	14	0	2	16	0	0
7	41511939	.	A	C	11	6	17	0	0	17	0	0
7	41512171	.	A	T	1	3	4	0	0	4	0	0
7	41512833	.	T	A	6	5	11	0	1	12	0	0
7	41517442	.	C	G	9	6	15	0	0	15	0	0
7	41517467	.	A	G	10	2	12	0	0	12	0	0
7	41517593	.	G	T	2	3	5	0	1	6	0	0
7	41517607	.	T	A	2	5	7	0	0	7	0	0
7	41517659	.	G	A	3	3	6	0	0	6	0	0
7	41517777	.	T	A	3	4	7	0	0	7	0	0
7	41517796	.	T	C	1	3	4	0	0	4	0	0
7	41517909	.	T	A	3	4	7	0	0	7	0	0
7	41517978	.	A	G	8	5	13	0	0	13	0	0
7	41518033	.	G	A	10	6	16	0	0	16	0	0
7	41518109	.	C	A	6	3	9	0	0	9	0	0
7	41518146	.	G	A	8	3	11	1	1	13	0	0
7	41518147	.	C	G	8	4	12	1	1	14	0	0
7	41518217	.	C	A	2	5	7	0	6	13	0	0
7	41518328	.	T	G	12	5	17	0	2	19	0	0
7	41518420	.	G	C	3	9	12	0	0	12	0	0
7	41518721	.	G	T	8	6	14	0	0	14	0	0
7	41518727	.	C	T	9	7	16	0	0	16	0	0
7	41518871	.	T	G	6	6	12	0	1	13	0	0
7	41518875	.	G	A	7	6	13	0	0	13	0	0
7	41519390	.	A	G	4	5	9	0	0	9	0	0
7	41550790	.	T	A	8	4	12	0	0	12	0	0
7	41556773	.	C	T	5	3	8	0	0	8	0	0
7	41574673	.	C	G	3	9	12	0	0	12	0	0
7	41627849	.	G	C	4	3	7	0	0	7	0	0
7	41627885	.	T	G	3	3	6	0	0	6	0	0
7	41714059	.	C	T	0	4	4	0	3	7	0	0
7	41714076	.	A	T	3	3	6	0	0	6	0	0
7	41714140	.	C	T	1	2	3	0	5	8	0	0
7	41714196	.	T	A	9	5	14	0	0	14	0	0
7	41714205	.	C	T	8	5	13	0	0	13	0	0
7	41714244	.	A	G	7	3	10	0	0	10	0	0
7	41714377	.	T	G	8	8	16	0	0	16	0	0
7	41714385	.	T	C	6	6	12	0	1	13	0	0
7	41714923	.	G	A	9	6	15	0	2	17	0	0
7	41715156	.	A	T	2	2	4	0	0	4	0	0
7	41715446	.	G	A	7	5	12	0	0	12	0	0
7	41715594	.	T	A	5	11	16	0	0	16	0	0
7	41715721	.	T	A	6	4	10	0	0	10	0	0
7	41715794	.	C	T	0	3	3	0	5	8	0	0
7	41726186	.	C	T	8	5	13	0	1	14	0	0
7	41726280	.	A	C	5	0	5	0	8	13	0	0
7	41726339	.	C	T	2	9	11	0	3	14	0	0
7	41726355	.	G	T	7	11	18	0	2	20	0	0
7	41726535	.	G	T	5	3	8	0	0	8	0	0
7	41726580	.	A	C	8	3	11	0	0	11	0	0
7	41748916	.	G	T	15	6	21	0	1	22	0	0
7	41749093	.	A	T	8	8	16	0	1	17	0	0
7	41749150	.	A	G	9	7	16	0	0	16	0	0
7	41749265	.	G	C	1	2	3	0	0	3	0	0
7	41749382	.	C	T	9	4	13	0	0	13	0	0
7	41751146	.	C	T	15	6	21	0	0	21	0	0
7	41751510	.	T	C	8	7	15	0	1	16	0	0
7	41751671	.	C	T	5	12	17	0	1	18	0	0
7	41752422	.	G	T	10	4	14	3	1	18	0	0
7	41752440	.	A	C	15	6	21	3	2	26	0	0
7	41752463	.	A	G	22	0	22	3	9	34	0	0
7	41752497	.	C	A	15	5	20	4	1	25	0	0
7	41752507	.	C	G	15	3	18	5	1	24	0	0
7	41752590	.	T	C	11	5	16	0	1	17	0	0
7	41752631	.	A	G	14	12	26	0	1	27	0	0
7	41752662	.	G	A	14	10	24	0	0	24	0	0
7	41752892	.	T	A	8	3	11	0	0	11	0	0
7	41753038	.	C	T	6	4	10	2	0	12	0	0
7	41753061	.	A	G	4	7	11	0	0	11	0	0
7	41753093	.	T	A	7	4	11	0	0	11	0	0
7	41753107	.	T	A	2	6	8	0	0	8	0	0
7	41753195	.	A	T	6	10	16	0	0	16	0	0
7	41757730	.	G	A	24	19	43	0	1	44	0	0
7	41773951	.	T	G	22	21	43	0	3	47	1	0
7	41774020	.	A	G	17	21	38	0	1	39	0	0
7	41774035	.	G	A	21	22	43	0	2	45	0	0
7	41774125	.	A	G	21	24	45	0	1	46	0	0
7	41780925	.	A	T	18	15	33	0	3	36	0	0
7	41791391	.	A	G	15	8	23	0	1	24	0	0
7	41791469	.	T	C	22	27	49	0	1	50	0	0
7	41791538	.	G	A	30	12	42	0	2	44	0	0
7	41791857	.	C	T	31	24	55	1	2	58	0	0
7	41791920	.	C	T	21	20	41	0	2	43	0	0
7	41805215	.	G	T	16	19	35	0	1	36	0	0
7	41805518	.	C	T	15	13	28	0	1	29	0	0
7	41805881	.	G	A	18	15	33	0	1	34	0	0
7	41820827	.	T	C	2	2	4	0	0	4	0	0
7	41873215	.	A	T	3	9	12	0	0	12	0	0
7	41873256	.	C	T	11	7	18	0	0	18	0	0
7	41873257	.	T	G	11	7	18	0	0	18	0	0
7	41873368	.	T	A	16	8	24	0	0	24	0	0
7	41873426	.	T	C	15	11	26	0	1	27	0	0
7	41873503	.	A	G	16	10	26	0	1	27	0	0
7	41873554	.	A	T	19	17	36	0	2	38	0	0
7	41873691	.	T	C	19	15	34	0	0	34	0	0
7	41875951	.	T	C	18	18	36	0	0	36	0	0
7	41887496	.	T	G	1	4	5	0	0	5	0	0
7	41887690	.	C	A	3	7	10	0	0	10	0	0
7	41890937	.	A	T	3	8	11	0	0	11	0	0
7	41891612	.	C	G	3	3	6	0	1	7	0	0
7	41896315	.	A	C	4	7	11	0	0	11	0	0
7	41896385	.	A	G	3	8	11	0	0	11	0	0
7	41899051	.	A	C	6	7	13	0	1	14	0	0
7	41899352	.	C	T	5	3	8	0	0	8	0	0
7	41899426	.	C	A	5	8	13	0	1	14	0	0
7	41899674	.	T	C	6	6	12	0	1	13	0	0
7	41900215	.	T	C	4	3	7	0	0	7	0	0
7	41900402	.	G	C	4	3	7	0	0	7	0	0
7	41901207	.	A	G	9	3	12	0	0	12	0	0
7	41901355	.	A	G	9	7	16	0	1	17	0	0
7	41903633	.	T	A	12	10	22	0	0	22	0	0
7	41903681	.	C	T	15	17	32	0	2	34	0	0
7	41903907	.	A	G	5	5	10	0	2	12	0	0
7	41904152	.	A	G	21	28	49	0	1	50	0	0
7	41904520	.	G	A	29	26	55	0	1	56	0	0
7	41911604	.	C	T	1	26	27	0	27	54	0	0
7	41912618	.	T	C	20	10	30	0	0	30	0	0
7	41957814	.	G	A	13	11	24	0	2	26	0	0
7	41995046	.	T	C	14	14	28	0	2	30	0	0
7	42068201	.	C	T	11	8	19	1	1	21	0	0
7	42096376	.	C	A	14	8	22	0	0	22	0	0
7	42096378	.	A	G	14	8	22	0	0	22	0	0
7	42096413	.	C	T	3	6	9	0	12	21	0	0
7	42125466	.	G	A	11	11	22	0	0	22	0	0
7	42125480	.	C	G	9	15	24	0	0	24	0	0
7	42161814	.	G	A	10	4	14	0	3	17	0	0
7	42203869	.	T	C	10	9	19	0	0	19	0	0
7	42229877	.	C	T	7	7	14	0	1	15	0	0
7	42255966	.	C	T	10	14	24	0	2	26	0	0
7	42267249	.	C	T	8	9	17	0	0	17	0	0
7	42267339	.	T	C	8	9	17	0	0	17	0	0
7	42323699	.	G	C	0	9	9	0	9	18	0	0
7	42338816	.	A	G	17	12	29	6	1	36	0	0
7	42345361	.	G	T	14	11	25	0	0	25	0	0
7	42345681	.	T	A	16	12	28	0	2	30	0	0
7	42345782	.	G	A	1	2	3	0	0	3	0	0
7	42488478	.	C	G	1	2	3	0	0	3	0	0
7	42539900	.	A	G	1	0	1	0	2	3	0	0
7	42545468	.	G	A	3	2	5	0	0	5	0	0
7	42545554	.	G	C	1	2	3	0	0	3	0	0
7	42546151	.	G	A	1	2	3	0	0	3	0	0
7	42546897	.	C	T	2	4	6	0	0	6	0	0
7	42547161	.	C	T	1	2	3	0	0	3	0	0
7	43174642	.	G	A	20	12	32	0	0	32	0	0
7	43309851	.	T	G	12	15	27	0	2	29	0	0
7	43760754	.	T	C	18	5	23	0	3	26	0	0
7	43760755	.	T	C	16	5	21	0	3	25	1	0
7	43760822	.	G	A	9	9	18	0	2	20	0	0
7	43760875	.	T	A	19	14	33	0	1	34	0	0
7	43760881	.	G	A	10	21	31	0	0	31	0	0
7	43761810	.	T	A	14	17	31	0	1	32	0	0
7	43765189	.	A	G	15	16	31	0	0	31	0	0
7	43765197	.	A	G	16	17	33	0	0	33	0	0
7	43765348	.	G	A	18	11	29	0	1	30	0	0
7	43775054	.	G	A	19	18	37	0	1	38	0	0
7	43778690	.	C	G	19	18	37	0	1	38	0	0
7	43781554	.	G	T	13	12	25	0	1	26	0	0
7	43787480	.	C	G	5	7	12	0	0	12	0	0
7	43840624	.	C	T	7	10	17	0	1	18	0	0
7	43840669	.	G	C	4	9	13	0	1	14	0	0
7	45400790	.	C	T	21	9	30	0	1	31	0	0
7	45402452	.	C	T	22	29	51	0	1	52	0	0
7	45402887	.	C	A	17	20	37	0	0	37	0	0
7	45402989	.	C	T	17	17	34	0	3	37	0	0
7	45403244	.	C	T	17	14	31	0	1	32	0	0
7	45403292	.	G	A	19	14	33	0	0	33	0	0
7	45403294	.	A	T	17	14	31	0	2	33	0	0
7	45403360	.	T	G	15	10	25	0	0	25	0	0
7	45403370	.	A	T	14	12	26	0	0	26	0	0
7	45403416	.	C	T	12	8	20	0	4	24	0	0
7	45403735	.	G	A	0	5	5	0	6	11	0	0
7	45403793	.	G	A	5	5	10	0	1	11	0	0
7	45403831	.	A	C	4	6	10	1	0	11	0	0
7	45403844	.	A	T	2	1	3	1	0	8	4	0
7	45403868	.	C	T	2	5	7	0	0	7	0	0
7	45403983	.	T	C	5	2	7	0	0	7	0	0
7	45403985	.	T	C	4	2	6	0	1	7	0	0
7	45404063	.	T	G	1	2	3	0	0	3	0	0
7	45404247	.	C	A	5	2	7	0	0	7	0	0
7	45404264	.	A	G	3	0	3	0	6	9	0	0
7	45404490	.	C	T	8	12	20	0	0	20	0	0
7	45405163	.	C	T	9	6	15	0	3	18	0	0
7	45405179	.	G	T	10	8	18	0	0	18	0	0
7	45405839	.	G	T	6	6	12	0	0	12	0	0
7	45405871	.	A	C	4	3	7	1	1	9	0	0
7	45405992	.	C	T	4	4	8	0	0	8	0	0
7	45840234	.	T	A	1	3	4	0	0	4	0	0
7	45851949	.	A	C	1	1	2	0	1	3	0	0
7	45966120	.	C	T	3	3	6	0	0	6	0	0
7	45971454	.	A	T	5	2	7	0	1	8	0	0
7	46004948	.	T	G	8	14	22	0	2	24	0	0
7	46004971	.	C	G	8	14	22	0	2	24	0	0
7	46004991	.	C	G	9	1	10	0	15	25	0	0
7	46009637	.	G	C	2	3	5	0	0	5	0	0
7	46009650	.	T	C	1	2	3	0	0	3	0	0
7	46015987	.	G	A	1	4	5	0	0	5	0	0
7	46019705	.	A	G	1	4	5	0	0	5	0	0
7	46373295	.	A	G	5	7	12	0	0	12	0	0
7	46373463	.	T	C	2	7	9	0	0	9	0	0
7	46374272	.	T	A	8	10	18	0	0	18	0	0
7	46374390	.	A	G	9	7	16	0	0	16	0	0
7	46430098	.	C	T	12	5	17	0	1	18	0	0
7	46430530	.	G	A	6	10	16	0	0	16	0	0
7	46430696	.	T	A	8	11	19	0	0	20	1	0
7	46430847	.	C	G	13	12	25	0	1	26	0	0
7	46431108	.	T	A	11	13	24	0	1	25	0	0
7	46431256	.	C	A	16	6	22	0	0	23	1	0
7	46431273	.	C	G	14	10	24	0	2	27	1	0
7	46431319	.	A	G	14	10	24	0	0	24	0	0
7	46431577	.	G	A	17	10	27	0	1	28	0	0
7	46486048	.	C	T	8	13	21	0	0	21	0	0
7	46486244	.	A	C	14	9	23	0	2	25	0	0
7	46486629	.	G	A	0	8	8	0	15	23	0	0
7	46486719	.	G	T	14	13	27	0	1	28	0	0
7	46487322	.	C	T	10	15	25	0	0	25	0	0
7	46487662	.	C	A	3	2	5	0	2	7	0	0
7	46728687	.	G	A	6	5	11	0	0	11	0	0
7	46728721	.	A	C	8	0	8	0	5	13	0	0
7	46729053	.	C	T	5	4	9	0	0	9	0	0
7	46729545	.	C	T	0	8	8	0	2	10	0	0
7	46730164	.	T	C	5	2	7	0	1	8	0	0
7	46730469	.	C	T	19	16	35	0	0	35	0	0
7	46730705	.	C	T	13	7	20	0	0	20	0	0
7	46730754	.	G	A	10	3	13	0	1	14	0	0
7	46730820	.	T	C	6	0	6	0	8	14	0	0
7	46731141	.	C	T	4	12	16	0	0	16	0	0
7	46731669	.	T	C	7	3	10	0	0	10	0	0
7	46732365	.	C	T	2	8	10	0	1	11	0	0
7	46732680	.	G	A	3	5	8	0	0	8	0	0
7	46782083	.	A	C	5	0	5	0	1	6	0	0
7	46782483	.	G	A	1	4	5	0	0	5	0	0
7	47243676	.	C	T	2	2	4	0	0	4	0	0
7	47265569	.	A	G	2	0	2	0	7	9	0	0
7	47265810	.	G	A	2	7	9	0	1	10	0	0
7	47265859	.	A	T	4	6	10	0	0	10	0	0
7	47288309	.	C	T	4	5	9	0	0	9	0	0
7	47308166	.	C	T	4	3	7	0	1	8	0	0
7	47308411	.	C	G	2	0	2	0	4	6	0	0
7	47323685	.	C	T	6	7	13	0	0	13	0	0
7	47324109	.	G	A	8	9	17	0	0	17	0	0
7	47358467	.	G	T	6	7	13	0	1	14	0	0
7	47410829	.	C	T	6	9	15	0	0	15	0	0
7	47411071	.	G	A	0	5	5	0	3	8	0	0
7	47411358	.	C	A	4	7	11	0	0	11	0	0
7	47411434	.	C	T	3	3	6	0	0	6	0	0
7	47411791	.	C	G	9	7	16	0	1	17	0	0
7	47411837	.	T	G	11	0	11	0	8	19	0	0
7	47411838	.	G	A	11	8	19	0	0	19	0	0
7	47411962	.	C	A	12	4	16	0	1	17	0	0
7	47412000	.	T	A	14	7	21	0	0	21	0	0
7	47412040	.	C	T	13	10	23	0	0	23	0	0
7	47412366	.	C	T	3	4	7	1	0	8	0	0
7	47412418	.	C	T	3	3	6	0	0	6	0	0
7	47412447	.	T	A	3	5	8	0	0	8	0	0
7	47412495	.	A	G	3	0	3	0	7	10	0	0
7	47412525	.	C	T	2	7	9	0	0	9	0	0
7	47412600	.	G	A	3	4	7	0	0	7	0	0
7	47413091	.	A	C	1	5	6	0	1	7	0	0
7	47413329	.	T	C	7	3	10	0	0	10	0	0
7	47413331	.	C	G	6	3	9	0	0	9	0	0
7	47413517	.	C	A	5	8	13	0	0	13	0	0
7	47413691	.	A	T	4	6	10	0	0	10	0	0
7	47413948	.	A	T	8	10	18	0	0	18	0	0
7	47414174	.	C	T	7	8	15	1	1	17	0	0
7	47414199	.	G	T	6	0	6	1	0	7	0	0
7	47414348	.	C	T	10	15	25	0	1	26	0	0
7	47416473	.	G	A	3	9	12	2	1	15	0	0
7	47416496	.	T	A	10	4	14	2	1	17	0	0
7	47416790	.	T	A	7	11	18	0	0	18	0	0
7	47416807	.	A	T	5	10	15	0	0	15	0	0
7	47416904	.	T	A	2	2	4	0	0	4	0	0
7	47417002	.	C	A	9	6	15	0	0	15	0	0
7	47417810	.	C	T	6	10	16	0	0	17	1	0
7	47417934	.	T	A	13	8	21	0	0	21	0	0
7	47418575	.	G	T	8	15	23	0	0	23	0	0
7	47418697	.	C	A	6	17	23	0	2	25	0	0
7	47418847	.	T	A	9	5	14	0	1	15	0	0
7	47419114	.	A	C	12	8	20	0	1	21	0	0
7	47419177	.	A	C	13	0	13	0	11	24	0	0
7	47419250	.	T	G	14	9	23	0	2	25	0	0
7	47419653	.	G	A	17	11	28	0	1	29	0	0
7	47419842	.	G	A	18	15	33	0	2	35	0	0
7	47420019	.	A	G	11	17	28	0	1	30	1	0
7	47421313	.	C	T	7	11	18	0	2	20	0	0
7	47448218	.	G	A	10	6	16	0	0	16	0	0
7	47462909	.	G	A	17	8	25	0	1	26	0	0
7	47488246	.	C	T	15	14	29	0	0	29	0	0
7	47488312	.	G	A	10	8	18	0	3	21	0	0
7	47507136	.	G	A	16	11	27	0	0	27	0	0
7	47563359	.	C	T	1	5	6	0	7	13	0	0
7	47563853	.	G	A	5	7	12	0	1	13	0	0
7	47584257	.	C	T	7	3	10	0	0	10	0	0
7	47596554	.	G	A	6	4	10	0	0	10	0	0
7	47596641	.	G	A	2	6	8	0	0	8	0	0
7	47596707	.	T	A	6	5	11	0	1	12	0	0
7	47614319	.	G	A	6	4	10	0	1	11	0	0
7	47614349	.	A	G	7	6	13	0	0	13	0	0
7	47685711	.	G	A	3	3	6	0	0	6	0	0
7	47685719	.	G	A	3	2	5	0	0	5	0	0
7	47691435	.	A	G	5	7	12	0	0	12	0	0
7	47691483	.	A	G	4	6	10	0	0	10	0	0
7	47691531	.	T	C	5	5	10	0	1	11	0	0
7	47850562	.	C	T	2	2	4	0	0	4	0	0
7	48041940	.	G	A	10	9	19	0	0	19	0	0
7	48041967	.	G	A	14	9	23	0	0	23	0	0
7	48042195	.	G	A	7	11	18	0	2	20	0	0
7	48042456	.	A	G	7	13	20	0	0	20	0	0
7	48042483	.	G	T	9	10	19	0	1	20	0	0
7	48054942	.	T	A	5	3	8	0	0	8	0	0
7	48054990	.	G	A	11	10	21	1	2	24	0	0
7	48063519	.	A	G	9	9	18	0	0	18	0	0
7	48063546	.	A	G	4	4	8	0	1	9	0	0
7	48071605	.	T	C	10	10	20	0	0	20	0	0
7	48138432	.	T	C	8	0	8	0	13	21	0	0
7	48172753	.	A	G	5	2	7	0	0	7	0	0
7	48252774	.	A	T	5	2	7	0	0	7	0	0
7	48253537	.	G	A	5	3	8	0	1	9	0	0
7	48263490	.	G	A	4	2	6	0	0	6	0	0
7	48288848	.	A	G	19	22	41	0	1	42	0	0
7	48291844	.	A	G	20	21	41	1	0	42	0	0
7	48291864	.	G	A	21	22	43	1	1	45	0	0
7	48295902	.	G	T	17	19	36	0	0	36	0	0
7	48295910	.	C	T	19	18	37	0	0	37	0	0
7	48296075	.	A	G	6	6	12	0	2	14	0	0
7	48296181	.	T	G	3	5	8	0	1	9	0	0
7	48300621	.	T	C	5	6	11	0	0	11	0	0
7	48300648	.	G	C	4	7	11	0	0	11	0	0
7	48300795	.	C	T	7	4	11	0	1	12	0	0
7	48302925	.	A	G	5	5	10	0	1	11	0	0
7	48303198	.	T	A	5	4	9	0	0	9	0	0
7	48303216	.	G	A	4	5	9	0	0	9	0	0
7	48303497	.	A	G	2	2	4	0	0	4	0	0
7	48304118	.	C	T	4	2	6	0	0	6	0	0
7	48304119	.	T	C	5	1	6	0	1	7	0	0
7	48304348	.	C	T	1	3	4	0	0	4	0	0
7	48304350	.	A	T	1	2	3	0	1	4	0	0
7	48304460	.	G	T	6	2	8	0	3	11	0	0
7	48304548	.	A	T	4	3	7	0	1	8	0	0
7	48304589	.	A	T	5	4	9	0	1	10	0	0
7	48327801	.	A	G	6	4	10	0	0	10	0	0
7	48327867	.	C	A	5	9	14	0	0	14	0	0
7	48327906	.	T	C	8	3	11	0	0	11	0	0
7	48327912	.	C	T	7	3	10	0	0	10	0	0
7	48342519	.	A	T	3	3	6	0	0	6	0	0
7	48342526	.	T	C	3	2	5	0	0	5	0	0
7	48347478	.	T	G	7	8	15	0	1	16	0	0
7	48347680	.	A	C	8	13	21	0	1	22	0	0
7	48348003	.	G	A	5	10	15	0	0	15	0	0
7	48348006	.	A	G	5	10	15	0	0	15	0	0
7	48348062	.	C	T	6	8	14	0	1	15	0	0
7	48348519	.	C	T	6	5	11	0	0	11	0	0
7	48348554	.	G	A	7	8	15	0	0	15	0	0
7	48352914	.	G	A	1	3	4	0	0	4	0	0
7	48353844	.	G	A	8	12	20	0	0	20	0	0
7	48358792	.	A	T	7	7	14	0	0	14	0	0
7	48369043	.	C	G	0	7	7	0	13	20	0	0
7	48369306	.	G	A	4	2	6	0	1	7	0	0
7	48369999	.	C	T	7	6	13	0	0	13	0	0
7	48370014	.	T	G	9	9	18	0	1	19	0	0
7	48383527	.	A	G	9	5	14	0	0	14	0	0
7	48383605	.	A	G	1	5	6	0	0	6	0	0
7	48383811	.	C	T	1	3	4	0	1	5	0	0
7	48391400	.	T	C	7	0	7	0	5	12	0	0
7	48391532	.	C	T	7	3	10	0	2	12	0	0
7	48460315	.	C	T	18	17	35	0	1	36	0	0
7	48482286	.	C	A	17	10	27	0	2	29	0	0
7	48482370	.	C	T	10	11	21	0	1	22	0	0
7	48482616	.	T	C	9	7	16	0	0	16	0	0
7	48483513	.	T	A	20	22	42	0	0	42	0	0
7	48484269	.	T	C	15	12	27	1	0	28	0	0
7	48484307	.	G	A	0	9	9	1	8	18	0	0
7	48484416	.	G	A	5	11	16	0	1	17	0	0
7	48484621	.	C	T	9	9	18	0	0	18	0	0
7	48664862	.	C	T	3	4	7	0	0	7	0	0
7	48720977	.	G	T	2	2	4	0	0	4	0	0
7	48721692	.	C	T	0	3	3	0	1	4	0	0
7	48721976	.	T	C	5	2	7	0	1	8	0	0
7	48722905	.	C	A	3	2	5	0	0	5	0	0
7	48723668	.	A	G	2	2	4	0	1	5	0	0
7	48788256	.	G	A	2	2	4	0	2	6	0	0
7	48788265	.	A	T	4	3	7	0	1	8	0	0
7	48788369	.	T	C	8	12	20	0	0	20	0	0
7	48788389	.	G	C	10	0	10	0	13	23	0	0
7	48788622	.	G	A	6	3	9	0	1	10	0	0
7	48788790	.	A	T	8	5	13	0	1	14	0	0
7	48788791	.	T	A	9	5	14	0	0	14	0	0
7	48788910	.	C	T	5	12	17	0	1	18	0	0
7	48788966	.	C	T	6	8	14	0	0	14	0	0
7	48790641	.	G	A	2	6	8	0	0	8	0	0
7	48790794	.	A	C	9	6	15	0	1	16	0	0
7	48790824	.	A	G	8	6	14	0	1	15	0	0
7	48800907	.	G	A	2	6	8	0	0	8	0	0
7	48800943	.	T	C	1	2	3	0	0	3	0	0
7	48800997	.	G	T	3	2	5	0	0	5	0	0
7	48805629	.	C	T	10	14	24	0	0	24	0	0
7	48805874	.	G	A	1	2	3	0	1	4	0	0
7	48805939	.	A	G	4	4	8	0	0	8	0	0
7	48806542	.	G	A	10	8	18	0	0	18	0	0
7	48806554	.	A	G	10	7	17	0	0	17	0	0
7	48806809	.	T	C	11	10	21	0	1	22	0	0
7	48809031	.	T	C	8	9	17	0	0	17	0	0
7	48811446	.	C	T	7	6	13	0	0	13	0	0
7	48818563	.	T	C	17	12	29	0	0	29	0	0
7	48819684	.	A	G	14	13	27	0	1	28	0	0
7	48820740	.	T	A	16	8	24	0	0	24	0	0
7	48820773	.	C	T	13	15	28	0	0	28	0	0
7	48821065	.	T	C	12	11	23	0	0	23	0	0
7	48821331	.	T	C	10	14	24	1	0	25	0	0
7	48821362	.	C	T	11	9	20	1	2	23	0	0
7	48823809	.	A	T	13	16	29	0	1	30	0	0
7	48829569	.	G	C	14	16	30	0	0	30	0	0
7	48829728	.	A	G	12	5	17	0	0	17	0	0
7	48829926	.	A	T	3	5	8	0	1	9	0	0
7	49020658	.	G	A	13	3	16	0	0	16	0	0
7	49033078	.	A	G	3	3	6	0	0	6	0	0
7	49033102	.	T	G	5	0	5	0	9	14	0	0
7	49036296	.	T	C	8	8	16	0	1	17	0	0
7	49036549	.	A	G	8	0	8	0	5	13	0	0
7	49046764	.	C	T	9	8	17	0	0	17	0	0
7	49049686	.	G	C	12	11	23	0	1	24	0	0
7	49051660	.	C	T	19	8	27	0	0	27	0	0
7	49052044	.	T	A	11	8	19	0	0	19	0	0
7	49052097	.	T	G	11	13	24	0	0	24	0	0
7	49052112	.	C	T	7	17	24	0	1	25	0	0
7	49052138	.	G	A	12	19	31	0	1	32	0	0
7	49052333	.	C	T	9	6	15	0	1	16	0	0
7	49052359	.	A	G	10	10	20	0	3	23	0	0
7	49052476	.	G	A	13	6	19	0	1	20	0	0
7	49052575	.	G	A	10	5	15	0	1	16	0	0
7	49052625	.	C	T	8	7	15	0	0	15	0	0
7	49052840	.	T	G	9	0	9	0	16	25	0	0
7	49053143	.	T	C	7	4	11	0	0	11	0	0
7	49053300	.	A	T	5	10	15	0	1	16	0	0
7	49053314	.	T	A	4	13	17	0	0	17	0	0
7	49053445	.	A	G	7	11	18	0	0	18	0	0
7	49053454	.	T	A	9	10	19	0	1	20	0	0
7	49053483	.	A	C	13	9	22	0	0	22	0	0
7	49053491	.	T	A	12	9	21	0	0	21	0	0
7	49053785	.	G	C	16	12	28	0	3	31	0	0
7	49053828	.	G	A	17	7	24	0	0	24	0	0
7	49053977	.	C	T	6	7	13	0	0	13	0	0
7	49053991	.	A	G	7	0	7	0	7	14	0	0
7	49054161	.	G	A	4	7	11	0	0	11	0	0
7	49054212	.	C	A	5	2	7	0	1	8	0	0
7	49054419	.	A	G	18	5	23	0	0	23	0	0
7	49054475	.	T	C	8	16	24	0	0	24	0	0
7	49054739	.	A	G	12	6	18	0	2	20	0	0
7	49054885	.	C	T	13	11	24	0	0	24	0	0
7	49054899	.	C	T	13	12	25	0	0	25	0	0
7	49054981	.	T	A	4	2	6	0	0	6	0	0
7	49054985	.	T	C	4	2	6	0	0	6	0	0
7	49055227	.	G	A	0	7	7	0	12	19	0	0
7	49055256	.	T	C	8	14	22	0	1	23	0	0
7	49079010	.	A	T	4	3	7	0	1	8	0	0
7	49079029	.	T	G	5	4	9	0	2	11	0	0
7	49079102	.	C	T	4	5	9	0	0	9	0	0
7	49079241	.	A	T	8	7	15	0	1	16	0	0
7	49079278	.	T	C	8	7	15	0	0	15	0	0
7	49079824	.	T	G	5	2	7	0	0	7	0	0
7	49147462	.	G	C	6	5	11	0	0	11	0	0
7	49147525	.	C	T	3	2	5	0	0	5	0	0
7	49189329	.	A	T	6	3	9	0	0	9	0	0
7	49251540	.	A	G	5	4	9	0	0	9	0	0
7	49257220	.	C	T	12	9	21	0	1	22	0	0
7	49257333	.	T	C	7	10	17	0	1	18	0	0
7	49257384	.	T	C	12	7	19	0	0	19	0	0
7	49257686	.	G	T	10	7	17	0	1	18	0	0
7	49257774	.	C	T	14	8	22	0	1	23	0	0
7	49257979	.	A	G	15	6	21	0	0	21	0	0
7	49258012	.	G	A	18	5	23	0	1	24	0	0
7	49258132	.	G	C	7	5	12	0	0	12	0	0
7	49258279	.	C	T	6	11	17	0	2	19	0	0
7	49266802	.	G	C	6	14	20	0	0	20	0	0
7	49269896	.	A	G	7	0	7	0	11	18	0	0
7	49269913	.	A	G	4	0	4	0	10	14	0	0
7	49271069	.	C	T	11	5	16	0	0	16	0	0
7	49271121	.	G	T	8	6	14	0	0	14	0	0
7	49271147	.	A	C	9	7	16	0	1	17	0	0
7	49271208	.	C	T	7	9	16	0	2	18	0	0
7	49273372	.	A	G	1	2	3	0	0	3	0	0
7	49313925	.	T	A	1	5	6	0	0	6	0	0
7	49318737	.	G	A	3	2	5	0	0	5	0	0
7	49320253	.	G	A	7	6	13	0	0	13	0	0
7	49320342	.	A	T	4	2	6	0	0	6	0	0
7	49320841	.	A	G	2	2	4	0	0	4	0	0
7	49324690	.	C	T	1	4	5	0	1	6	0	0
7	49325125	.	G	A	14	6	20	0	0	20	0	0
7	49325319	.	T	C	8	9	17	0	2	19	0	0
7	49325346	.	A	G	12	10	22	0	1	23	0	0
7	49338336	.	G	A	17	13	30	0	1	31	0	0
7	49355496	.	T	C	15	0	15	0	16	31	0	0
7	49357357	.	G	A	18	18	36	0	1	37	0	0
7	49358228	.	A	C	23	11	34	0	1	35	0	0
7	49620059	.	T	C	1	5	6	0	0	6	0	0
7	49620089	.	T	G	1	4	5	0	0	5	0	0
7	49620241	.	T	C	2	0	2	0	10	12	0	0
7	49624379	.	T	C	2	0	2	0	6	8	0	0
7	49633361	.	A	G	4	3	7	0	0	7	0	0
7	49633373	.	T	C	3	2	5	0	0	5	0	0
7	49637226	.	A	T	3	4	7	2	0	9	0	0
7	49638742	.	G	A	6	3	9	0	0	9	0	0
7	49638748	.	T	A	6	3	9	0	0	9	0	0
7	49638880	.	T	G	4	6	10	0	0	10	0	0
7	49639272	.	G	T	6	4	10	0	0	10	0	0
7	49639370	.	A	G	2	3	5	0	1	6	0	0
7	49639609	.	C	T	3	2	5	0	0	5	0	0
7	49639701	.	T	C	4	4	8	0	1	9	0	0
7	49639876	.	A	T	8	9	17	0	0	17	0	0
7	49639926	.	A	C	10	11	21	0	0	21	0	0
7	49640040	.	G	A	13	10	23	0	1	24	0	0
7	49715779	.	C	G	1	3	4	0	0	4	0	0
7	49716731	.	C	G	2	3	5	0	0	5	0	0
7	49716898	.	T	C	2	4	6	0	0	6	0	0
7	49716935	.	T	A	1	3	4	0	0	4	0	0
7	49799470	.	A	T	8	4	12	0	0	12	0	0
7	49799526	.	T	A	9	6	15	0	0	15	0	0
7	49799584	.	G	A	5	6	11	0	0	11	0	0
7	49799805	.	A	T	4	7	11	0	0	11	0	0
7	49844446	.	C	G	1	3	4	0	0	4	0	0
7	50053347	.	C	T	6	3	9	0	2	11	0	0
7	50109317	.	T	C	5	7	12	0	2	14	0	0
7	50110585	.	C	T	7	10	17	0	0	18	1	0
7	50111330	.	C	T	11	4	15	0	0	15	0	0
7	50112025	.	C	T	17	8	25	0	0	25	0	0
7	50112039	.	T	G	16	10	26	0	1	27	0	0
7	50112063	.	G	A	11	11	22	0	2	24	0	0
7	50112196	.	A	G	2	0	2	0	0	8	6	0
7	50112383	.	G	A	11	6	17	0	0	17	0	0
7	50112460	.	C	T	12	14	26	0	3	29	0	0
7	50112825	.	A	T	19	8	27	0	0	27	0	0
7	50112922	.	C	A	6	5	11	0	1	12	0	0
7	50228314	.	C	A	5	6	11	0	2	13	0	0
7	50228326	.	T	C	7	0	7	0	7	14	0	0
7	50228355	.	C	T	8	10	18	0	0	18	0	0
7	50228463	.	G	A	7	7	14	0	0	14	0	0
7	50228487	.	T	C	8	7	15	0	0	15	0	0
7	50228517	.	G	T	10	3	13	0	1	14	0	0
7	50228548	.	T	C	11	6	17	0	0	17	0	0
7	50228702	.	A	T	1	3	4	0	0	4	0	0
7	50228785	.	C	G	4	9	13	0	0	13	0	0
7	50228872	.	A	C	5	5	10	0	0	10	0	0
7	50229223	.	T	C	14	11	25	1	1	27	0	0
7	50272707	.	G	A	11	15	26	0	1	27	0	0
7	50272779	.	A	G	12	16	28	0	2	30	0	0
7	50272859	.	A	G	9	7	16	0	1	17	0	0
7	50277760	.	T	C	1	2	3	0	0	3	0	0
7	50295823	.	G	A	9	4	13	0	0	13	0	0
7	50295974	.	G	T	7	6	13	0	3	16	0	0
7	50295997	.	T	A	6	9	15	0	2	17	0	0
7	50296016	.	A	G	4	8	12	0	0	12	0	0
7	50296545	.	T	G	4	2	6	0	0	6	0	0
7	50296612	.	G	C	2	5	7	0	0	7	0	0
7	50296815	.	G	A	5	8	13	0	0	13	0	0
7	50296981	.	A	G	7	7	14	0	1	15	0	0
7	50299379	.	G	A	5	7	12	0	1	13	0	0
7	50323793	.	A	G	2	3	5	0	1	6	0	0
7	50323934	.	G	A	4	3	7	0	0	7	0	0
7	50323967	.	C	T	1	4	5	0	1	6	0	0
7	50324984	.	C	T	5	3	8	0	0	8	0	0
7	50325006	.	G	C	4	2	6	0	0	6	0	0
7	50328256	.	G	A	4	6	10	0	0	10	0	0
7	50328275	.	T	A	4	8	12	0	0	12	0	0
7	50333581	.	T	C	8	3	11	0	0	11	0	0
7	50333629	.	T	C	6	4	10	0	1	11	0	0
7	50338221	.	A	T	9	6	15	0	0	15	0	0
7	50348175	.	A	G	3	5	8	0	0	8	0	0
7	50348280	.	T	C	1	5	6	0	1	7	0	0
7	50348448	.	T	C	3	7	10	0	0	10	0	0
7	50349225	.	T	C	10	7	17	0	0	17	0	0
7	50376101	.	T	A	3	2	5	1	1	7	0	0
7	50376214	.	T	C	1	2	3	0	0	3	0	0
7	50376243	.	G	A	1	2	3	0	1	4	0	0
7	50376395	.	G	A	6	4	10	0	0	10	0	0
7	50376518	.	C	A	4	2	6	0	0	6	0	0
7	50376751	.	G	A	10	4	14	0	0	14	0	0
7	50377025	.	A	G	6	10	16	0	0	16	0	0
7	50377045	.	C	T	0	6	6	0	8	14	0	0
7	50383553	.	C	T	6	5	11	1	0	12	0	0
7	50388219	.	C	T	2	5	7	0	6	13	0	0
7	50388859	.	C	T	3	7	10	0	0	10	0	0
7	50388889	.	G	A	4	3	7	0	0	7	0	0
7	50394956	.	C	T	1	2	3	0	1	4	0	0
7	50395016	.	T	C	5	7	12	0	0	12	0	0
7	50395043	.	A	T	8	7	15	0	1	16	0	0
7	50395385	.	A	G	2	3	5	0	0	5	0	0
7	50395947	.	T	G	4	3	7	0	0	7	0	0
7	50396019	.	C	T	5	2	7	0	0	7	0	0
7	50399759	.	A	G	13	0	13	0	10	23	0	0
7	50399782	.	T	C	9	10	19	0	0	19	0	0
7	50400267	.	A	G	13	12	25	0	0	25	0	0
7	50407469	.	A	G	11	7	18	0	0	18	0	0
7	50407532	.	T	C	4	5	9	0	3	12	0	0
7	50407587	.	T	C	10	6	16	0	1	17	0	0
7	50407588	.	C	A	9	6	15	0	2	17	0	0
7	50407724	.	C	T	11	13	24	1	1	26	0	0
7	50410394	.	T	A	27	19	46	0	1	47	0	0
7	50410475	.	T	C	11	14	25	0	0	25	0	0
7	50477387	.	C	T	3	2	5	0	0	5	0	0
7	50477402	.	A	G	2	3	5	0	0	5	0	0
7	50477443	.	T	G	1	1	2	0	2	4	0	0
7	50480544	.	G	C	1	0	1	0	3	4	0	0
7	50480571	.	G	T	2	2	4	0	1	5	0	0
7	50548086	.	A	G	5	5	10	0	0	10	0	0
7	50586497	.	A	T	1	3	4	0	2	6	0	0
7	50650625	.	C	T	2	2	4	0	0	4	0	0
7	50654089	.	C	T	1	2	3	0	0	3	0	0
7	50654152	.	C	G	0	3	3	0	2	5	0	0
7	50766151	.	T	C	2	3	5	0	0	5	0	0
7	50766240	.	A	C	2	3	5	0	0	5	0	0
7	50828894	.	T	A	7	7	14	0	1	15	0	0
7	50828998	.	C	T	9	5	14	0	1	15	0	0
7	50829201	.	A	C	12	10	22	0	0	22	0	0
7	50829360	.	G	C	8	14	22	0	1	23	0	0
7	50829393	.	G	A	6	13	19	0	0	19	0	0
7	50831901	.	G	A	7	9	16	0	0	16	0	0
7	50833143	.	T	C	8	7	15	0	0	15	0	0
7	50833262	.	C	T	9	9	18	0	0	18	0	0
7	50833928	.	C	G	6	1	7	0	11	18	0	0
7	50833943	.	C	A	13	7	20	0	0	20	0	0
7	50833979	.	C	T	9	10	19	0	0	19	0	0
7	50834821	.	A	G	13	5	18	0	0	18	0	0
7	50836382	.	C	T	3	9	12	0	0	12	0	0
7	50836424	.	C	T	12	10	22	0	1	23	0	0
7	50837949	.	G	A	9	11	20	0	4	24	0	0
7	50838135	.	G	C	1	19	20	0	14	34	0	0
7	50838194	.	C	A	4	7	11	0	2	13	0	0
7	50838210	.	G	T	1	9	10	0	3	13	0	0
7	50838251	.	C	T	13	10	23	0	0	23	0	0
7	50840008	.	C	T	10	17	27	0	2	29	0	0
7	50840428	.	G	A	12	12	24	0	0	24	0	0
7	50840512	.	C	T	7	17	24	0	0	24	0	0
7	50841072	.	G	A	14	23	37	0	2	39	0	0
7	50841237	.	C	T	16	22	38	0	3	41	0	0
7	50841690	.	G	A	1	11	12	0	9	21	0	0
7	50841693	.	A	T	10	11	21	0	0	21	0	0
7	50843813	.	C	A	10	16	26	0	0	26	0	0
7	50843827	.	A	G	10	17	27	0	0	27	0	0
7	50844117	.	G	A	2	10	12	0	15	27	0	0
7	50844142	.	G	A	9	14	23	0	2	25	0	0
7	50844165	.	C	T	18	11	29	0	1	30	0	0
7	50844830	.	G	T	10	9	19	0	1	20	0	0
7	50844834	.	G	A	2	8	10	0	10	20	0	0
7	50844895	.	A	T	6	10	16	0	0	16	0	0
7	50844936	.	A	T	8	6	14	0	0	14	0	0
7	50845000	.	G	A	14	16	30	0	0	30	0	0
7	50845105	.	A	T	12	9	21	0	1	22	0	0
7	50845158	.	A	G	11	9	20	0	0	20	0	0
7	50845210	.	A	G	6	18	24	0	2	26	0	0
7	50845331	.	G	A	0	5	5	0	7	12	0	0
7	50845486	.	A	T	5	6	11	0	0	11	0	0
7	50845892	.	C	A	13	12	25	0	0	25	0	0
7	50846055	.	T	C	10	12	22	1	2	25	0	0
7	50846081	.	T	A	16	9	25	0	0	25	0	0
7	50877064	.	T	C	5	3	8	0	0	8	0	0
7	50877100	.	T	C	2	2	4	0	0	4	0	0
7	50878385	.	T	C	7	4	11	0	0	11	0	0
7	50878473	.	A	C	6	4	10	0	1	11	0	0
7	50879293	.	C	A	3	2	5	0	1	6	0	0
7	50879591	.	T	C	4	4	8	0	2	10	0	0
7	50879595	.	C	T	4	6	10	0	1	11	0	0
7	50880436	.	A	G	3	7	10	0	0	10	0	0
7	50880467	.	C	G	1	4	5	0	1	6	0	0
7	50880471	.	G	A	1	3	4	0	2	6	0	0
7	50880624	.	T	G	2	5	7	0	0	7	0	0
7	50880703	.	G	A	2	2	4	0	0	4	0	0
7	50880885	.	C	A	2	2	4	0	0	4	0	0
7	50880927	.	G	T	1	1	2	0	1	3	0	0
7	50880933	.	T	A	1	2	3	0	1	4	0	0
7	50881252	.	G	A	3	4	7	0	0	7	0	0
7	50881363	.	C	T	5	3	8	0	1	9	0	0
7	50881465	.	A	G	2	9	11	0	1	12	0	0
7	50882104	.	G	A	3	2	5	0	0	5	0	0
7	50882379	.	C	T	4	5	9	0	0	9	0	0
7	50883095	.	T	A	1	1	2	0	1	3	0	0
7	50883281	.	C	T	5	2	7	0	0	7	0	0
7	50911223	.	T	A	7	9	16	0	0	16	0	0
7	50911278	.	C	T	19	14	33	0	1	34	0	0
7	50912212	.	C	T	15	15	30	0	1	31	0	0
7	50912227	.	C	G	13	16	29	0	0	29	0	0
7	50917219	.	C	T	9	15	24	0	1	25	0	0
7	50922238	.	C	G	3	2	5	0	0	5	0	0
7	50923438	.	C	T	2	0	2	0	0	4	2	0
7	51219420	.	C	G	6	4	10	0	0	10	0	0
7	51219436	.	A	C	6	3	9	0	1	10	0	0
7	51220278	.	T	C	10	5	15	0	1	16	0	0
7	51220739	.	A	G	7	10	17	0	0	17	0	0
7	51220740	.	C	A	0	10	10	0	7	17	0	0
7	51221418	.	T	A	6	11	17	0	0	17	0	0
7	51221475	.	C	T	8	3	11	0	0	11	0	0
7	51221784	.	A	G	9	4	13	0	0	13	0	0
7	51222115	.	G	A	9	6	15	0	0	15	0	0
7	51222297	.	G	A	4	2	6	0	2	8	0	0
7	51246426	.	G	A	8	7	15	0	0	15	0	0
7	51246457	.	G	T	10	8	18	0	2	20	0	0
7	51246573	.	T	C	13	6	19	0	0	19	0	0
7	51247467	.	C	T	0	9	9	0	5	14	0	0
7	51248010	.	C	A	3	8	11	0	0	11	0	0
7	51248756	.	C	A	1	7	8	0	4	12	0	0
7	51248834	.	C	T	1	3	4	0	6	10	0	0
7	51249441	.	G	T	4	5	9	0	0	9	0	0
7	51315177	.	G	T	2	4	6	0	0	6	0	0
7	51315217	.	A	T	1	3	4	0	0	4	0	0
7	51353191	.	G	A	11	4	15	0	0	15	0	0
7	51353421	.	C	T	6	6	12	0	0	12	0	0
7	51353447	.	G	T	6	7	13	0	0	13	0	0
7	51354066	.	G	A	1	6	7	0	1	8	0	0
7	51354176	.	A	G	1	6	7	0	0	7	0	0
7	51354296	.	A	G	2	6	8	0	0	8	0	0
7	51354306	.	T	C	6	3	9	0	0	9	0	0
7	51354424	.	T	A	5	5	10	0	0	10	0	0
7	51354442	.	C	A	3	3	6	0	0	6	0	0
7	51356078	.	A	G	3	4	7	0	0	7	0	0
7	51356090	.	A	G	2	6	8	0	0	8	0	0
7	51356542	.	C	G	9	11	20	0	1	21	0	0
7	51356625	.	C	A	8	5	13	0	0	13	0	0
7	51356733	.	G	T	3	1	4	0	1	5	0	0
7	51368654	.	T	G	1	4	5	0	0	5	0	0
7	51461339	.	G	A	2	2	4	0	0	4	0	0
7	51468119	.	C	T	12	17	29	0	0	29	0	0
7	51468241	.	C	T	14	18	32	0	1	33	0	0
7	51468389	.	C	T	2	13	15	0	11	26	0	0
7	51468411	.	A	T	14	11	25	0	0	25	0	0
7	51468577	.	C	A	19	17	36	1	1	38	0	0
7	51469048	.	T	G	18	15	33	0	0	33	0	0
7	51469166	.	A	T	17	15	32	0	0	32	0	0
7	51469267	.	G	C	11	12	23	0	1	24	0	0
7	51469304	.	T	A	7	10	17	0	1	18	0	0
7	51469518	.	T	A	10	10	20	0	2	22	0	0
7	51469578	.	T	G	11	11	22	0	0	22	0	0
7	51469814	.	C	T	1	8	9	0	9	18	0	0
7	51469897	.	A	G	7	8	15	0	0	15	0	0
7	51470070	.	T	C	7	0	7	0	14	21	0	0
7	51470286	.	T	C	5	6	11	1	0	12	0	0
7	51470569	.	G	T	6	8	14	0	0	14	0	0
7	51471195	.	T	C	14	8	22	0	0	22	0	0
7	51471201	.	G	A	7	14	21	0	0	22	1	0
7	51471379	.	G	A	7	13	20	0	0	20	0	0
7	51471554	.	T	C	2	0	2	0	12	14	0	0
7	51471560	.	T	C	11	4	15	0	1	16	0	0
7	51471591	.	T	C	8	4	12	0	1	13	0	0
7	51471714	.	A	G	8	9	17	0	0	17	0	0
7	51472102	.	C	T	3	3	6	0	0	6	0	0
7	51472175	.	A	C	4	2	6	0	1	7	0	0
7	51472179	.	C	A	3	4	7	0	0	7	0	0
7	51472456	.	C	T	3	8	11	0	0	11	0	0
7	51472534	.	T	A	4	7	11	0	1	12	0	0
7	51472536	.	T	A	5	7	12	0	0	12	0	0
7	51472793	.	A	C	7	0	7	0	10	17	0	0
7	51472853	.	G	A	13	8	21	0	0	21	0	0
7	51473585	.	T	C	11	0	11	0	8	19	0	0
7	51473814	.	C	T	13	13	26	0	0	26	0	0
7	51473831	.	T	G	10	10	20	0	1	21	0	0
7	51474238	.	G	A	10	9	19	0	0	19	0	0
7	51474279	.	C	A	17	8	25	0	2	27	0	0
7	51474300	.	G	T	17	6	23	0	0	23	0	0
7	51474832	.	T	G	15	5	20	0	3	23	0	0
7	51475180	.	A	G	13	7	20	0	2	22	0	0
7	51475288	.	G	A	5	7	12	0	1	13	0	0
7	51475578	.	A	G	13	5	18	0	0	18	0	0
7	51475795	.	T	A	7	3	10	0	1	11	0	0
7	51476108	.	G	A	5	5	10	0	0	10	0	0
7	51483327	.	G	A	7	3	10	0	1	11	0	0
7	51483357	.	G	A	4	7	11	0	0	11	0	0
7	51493063	.	C	T	0	5	5	0	5	10	0	0
7	51634285	.	C	T	28	33	61	0	1	62	0	0
7	51634480	.	G	A	37	30	67	0	1	69	1	0
7	51635615	.	A	G	36	35	71	0	2	73	0	0
7	51643163	.	A	G	5	5	10	0	0	10	0	0
7	51643212	.	G	A	6	4	10	0	0	10	0	0
7	51643409	.	C	A	9	4	13	0	1	14	0	0
7	51643639	.	A	C	2	6	8	0	0	8	0	0
7	51698403	.	T	A	7	4	11	0	0	11	0	0
7	51705806	.	C	G	5	2	7	0	0	7	0	0
7	51709223	.	A	G	6	4	10	0	0	10	0	0
7	51709914	.	C	A	4	3	7	0	0	7	0	0
7	51713257	.	G	A	3	6	9	0	0	9	0	0
7	51713267	.	G	A	2	5	7	0	0	7	0	0
7	51714712	.	A	G	2	3	5	0	0	5	0	0
7	51716203	.	T	G	3	2	5	0	0	5	0	0
7	51719051	.	G	A	4	3	7	0	0	7	0	0
7	51719052	.	T	C	4	3	7	0	0	7	0	0
7	51779628	.	G	A	22	21	43	0	2	45	0	0
7	51779636	.	T	C	23	23	46	0	1	47	0	0
7	51785901	.	T	C	18	23	41	0	2	43	0	0
7	51788227	.	T	G	38	19	57	0	0	57	0	0
7	51788756	.	A	C	21	27	48	2	1	51	0	0
7	51795788	.	T	C	9	4	13	0	0	13	0	0
7	51795791	.	G	T	9	4	13	0	0	13	0	0
7	51795827	.	C	T	4	5	9	0	1	10	0	0
7	51795949	.	A	T	2	3	5	0	1	6	0	0
7	51808319	.	T	A	5	2	7	0	0	7	0	0
7	51808327	.	T	C	4	4	8	0	0	8	0	0
7	51808555	.	A	G	1	0	1	0	4	5	0	0
7	51808585	.	C	T	1	3	4	0	0	4	0	0
7	51811165	.	G	A	8	3	11	0	0	11	0	0
7	51813946	.	T	G	5	6	11	0	0	11	0	0
7	51814287	.	C	G	3	6	9	0	1	10	0	0
7	51814445	.	T	A	3	2	5	0	0	5	0	0
7	52153006	.	C	T	4	4	8	0	0	8	0	0
7	52153052	.	T	C	2	2	4	0	1	5	0	0
7	52156095	.	G	A	0	6	6	0	4	10	0	0
7	52157845	.	A	T	5	5	10	0	1	11	0	0
7	52161646	.	G	T	10	5	15	0	1	16	0	0
7	52165601	.	C	T	5	7	12	0	0	12	0	0
7	52165631	.	C	T	4	9	13	0	0	13	0	0
7	52173207	.	G	A	9	9	18	0	0	18	0	0
7	52173228	.	A	G	9	8	17	0	0	17	0	0
7	52285027	.	T	C	8	3	11	1	0	12	0	0
7	52285040	.	T	A	3	3	6	2	1	9	0	0
7	52285113	.	C	G	3	3	6	0	0	6	0	0
7	52293935	.	C	T	1	3	4	0	0	4	0	0
7	52294009	.	G	T	12	7	19	0	1	20	0	0
7	52294540	.	A	T	20	12	32	0	0	32	0	0
7	52294579	.	C	T	16	9	25	0	1	26	0	0
7	52294756	.	A	T	12	11	23	0	3	26	0	0
7	52295016	.	C	T	1	19	20	0	12	32	0	0
7	52295183	.	G	A	23	21	44	0	1	45	0	0
7	52295795	.	C	T	2	16	18	0	12	30	0	0
7	52295935	.	T	C	28	7	35	0	2	37	0	0
7	52296064	.	A	C	11	0	11	0	17	28	0	0
7	52296221	.	G	A	16	13	29	0	0	29	0	0
7	52296320	.	G	A	12	7	19	0	0	19	0	0
7	52296352	.	G	T	10	6	16	0	1	17	0	0
7	52296791	.	G	A	17	19	36	0	0	36	0	0
7	52309924	.	G	A	16	12	28	0	2	30	0	0
7	52315434	.	C	G	1	8	9	0	7	16	0	0
7	52328569	.	C	T	11	12	23	0	0	23	0	0
7	52432249	.	G	A	1	2	3	0	0	3	0	0
7	52432317	.	T	G	2	4	6	0	0	6	0	0
7	52432325	.	A	G	2	5	7	0	0	7	0	0
7	52432459	.	G	A	3	3	6	0	0	6	0	0
7	52460382	.	C	T	1	2	3	0	0	3	0	0
7	52517325	.	G	A	2	4	6	0	1	7	0	0
7	52517759	.	G	A	6	4	10	0	1	11	0	0
7	52518529	.	T	G	5	3	8	0	0	8	0	0
7	52518813	.	C	T	6	6	12	0	0	12	0	0
7	52519015	.	T	C	9	15	24	0	0	24	0	0
7	52521352	.	G	A	8	10	18	0	0	18	0	0
7	52522182	.	T	C	7	15	22	0	0	22	0	0
7	52531152	.	C	T	2	8	10	0	9	19	0	0
7	52532811	.	G	A	5	2	7	0	0	7	0	0
7	52533621	.	C	T	6	7	13	0	0	13	0	0
7	52533649	.	C	T	4	6	10	0	0	10	0	0
7	52551518	.	G	A	10	9	19	0	1	20	0	0
7	52716777	.	T	A	6	8	14	0	0	14	0	0
7	52716875	.	C	A	10	7	17	0	1	18	0	0
7	52717095	.	T	C	6	10	16	0	0	16	0	0
7	52750565	.	C	T	15	7	22	0	1	23	0	0
7	52750656	.	G	A	7	7	14	0	1	15	0	0
7	52750776	.	G	T	9	10	19	0	0	19	0	0
7	52750847	.	C	T	13	6	19	0	0	19	0	0
7	52751016	.	C	T	6	8	14	0	1	15	0	0
7	52751306	.	T	C	5	4	9	0	0	9	0	0
7	52761496	.	G	T	0	2	2	0	2	4	0	0
7	52765884	.	C	A	8	4	12	0	1	13	0	0
7	52765985	.	G	T	0	6	6	0	5	11	0	0
7	52765999	.	T	A	5	4	9	0	1	10	0	0
7	52766099	.	A	T	4	4	8	0	1	9	0	0
7	52766191	.	C	T	4	7	11	0	0	11	0	0
7	52774338	.	A	T	6	3	9	0	1	10	0	0
7	52780861	.	A	T	5	4	9	0	0	9	0	0
7	52785384	.	A	G	3	2	5	0	0	5	0	0
7	52788912	.	T	G	10	0	10	0	8	18	0	0
7	52789065	.	C	T	2	7	9	0	0	9	0	0
7	52793313	.	C	T	6	9	15	0	0	15	0	0
7	52820092	.	G	C	11	12	23	0	1	24	0	0
7	52820221	.	G	A	3	9	12	0	10	22	0	0
7	52820320	.	C	T	13	13	26	0	0	26	0	0
7	52820588	.	A	C	2	4	6	0	0	6	0	0
7	52821561	.	T	A	1	5	6	0	0	6	0	0
7	52821658	.	C	A	7	3	10	0	0	10	0	0
7	52821691	.	A	C	6	4	10	0	2	12	0	0
7	52821904	.	G	A	10	12	22	0	0	22	0	0
7	52822136	.	G	A	15	8	23	0	1	24	0	0
7	52822217	.	T	A	10	9	19	0	0	19	0	0
7	52822351	.	A	T	11	10	21	0	1	22	0	0
7	52822493	.	A	C	8	14	22	1	0	23	0	0
7	52822860	.	A	G	7	4	11	0	0	11	0	0
7	52822981	.	T	A	1	2	3	0	0	3	0	0
7	52823161	.	G	A	8	4	12	0	0	12	0	0
7	52823210	.	C	G	4	5	9	0	0	9	0	0
7	52823377	.	T	A	1	6	7	0	0	7	0	0
7	52823388	.	C	T	3	6	9	0	0	9	0	0
7	52823429	.	A	T	8	5	13	0	2	15	0	0
7	52830591	.	A	T	17	15	32	0	3	35	0	0
7	52830601	.	T	G	15	20	35	0	2	37	0	0
7	52830639	.	C	T	16	26	42	0	0	42	0	0
7	52831053	.	G	T	20	16	36	0	3	39	0	0
7	52831198	.	T	A	10	12	22	0	3	25	0	0
7	52831236	.	A	G	15	11	26	0	0	26	0	0
7	52831430	.	C	T	11	12	23	0	1	24	0	0
7	52833126	.	C	G	10	8	18	0	0	18	0	0
7	52833248	.	A	T	17	11	28	0	1	29	0	0
7	52833329	.	G	T	12	16	28	0	4	32	0	0
7	52833682	.	T	A	16	17	33	4	0	37	0	0
7	52833792	.	G	A	18	19	37	0	1	38	0	0
7	52834334	.	T	G	12	8	20	0	0	20	0	0
7	52836325	.	C	T	20	28	48	0	2	50	0	0
7	52836403	.	A	G	26	26	52	0	1	53	0	0
7	52836451	.	C	T	24	19	43	0	3	46	0	0
7	52837644	.	G	A	20	21	41	0	0	41	0	0
7	52837686	.	C	A	19	20	39	0	2	41	0	0
7	52837687	.	T	A	17	20	37	0	3	40	0	0
7	52839062	.	C	T	13	11	24	0	0	24	0	0
7	52840871	.	T	A	24	15	39	0	1	40	0	0
7	52841033	.	T	C	16	0	16	0	13	29	0	0
7	52841276	.	A	G	19	21	40	0	0	40	0	0
7	52842329	.	C	T	20	11	31	0	2	33	0	0
7	52900987	.	C	T	11	15	26	0	2	28	0	0
7	52921521	.	C	A	17	13	30	0	0	30	0	0
7	52924873	.	T	A	20	8	28	0	0	28	0	0
7	52929182	.	G	A	19	20	39	0	1	40	0	0
7	52933088	.	C	A	22	13	35	0	2	37	0	0
7	52933191	.	C	T	2	6	8	0	0	8	0	0
7	52937334	.	G	A	7	16	23	0	1	24	0	0
7	52942312	.	G	T	14	6	20	0	0	20	0	0
7	52942472	.	C	T	3	11	14	0	0	14	0	0
7	52944199	.	G	A	11	11	22	0	1	23	0	0
7	52958387	.	A	T	2	2	4	0	0	4	0	0
7	52959391	.	C	A	1	2	3	0	1	4	0	0
7	54307309	.	T	A	3	2	5	0	0	5	0	0
7	54323986	.	T	C	14	1	15	0	15	30	0	0
7	54331379	.	G	C	8	10	18	0	0	18	0	0
7	54366517	.	A	G	12	6	18	0	1	19	0	0
7	54407619	.	C	T	12	10	22	0	2	24	0	0
7	54420390	.	C	T	2	5	7	0	8	15	0	0
7	54430450	.	T	C	8	7	15	0	1	16	0	0
7	55261074	.	C	T	11	7	18	0	1	19	0	0
7	55530884	.	G	C	5	1	6	0	0	9	3	0
7	55532316	.	A	G	5	3	8	0	0	8	0	0
7	55536487	.	G	A	4	3	7	0	0	7	0	0
7	55629611	.	A	G	1	2	3	0	0	3	0	0
7	55635202	.	T	C	14	17	31	0	0	31	0	0
7	55635355	.	G	A	0	7	7	0	9	16	0	0
7	55637122	.	C	A	7	5	12	0	0	12	0	0
7	55637360	.	G	A	1	2	3	0	0	3	0	0
7	55660269	.	G	A	9	24	33	0	2	35	0	0
7	55669479	.	G	A	12	12	24	0	0	24	0	0
7	55671547	.	T	C	6	16	22	0	1	23	0	0
7	55675544	.	T	C	9	0	9	0	16	25	0	0
7	55675577	.	G	A	15	10	25	0	1	26	0	0
7	55953094	.	A	T	2	2	4	0	0	4	0	0
7	55953284	.	G	A	1	3	4	0	0	4	0	0
7	55953298	.	G	C	1	2	3	0	1	4	0	0
7	55953452	.	C	T	1	2	3	0	0	3	0	0
7	55955842	.	G	T	1	2	3	0	0	3	0	0
7	56020062	.	C	T	3	2	5	0	0	5	0	0
7	56152686	.	G	C	12	7	19	0	1	20	0	0
7	56158111	.	G	A	20	7	27	0	0	27	0	0
7	56158197	.	G	A	9	14	23	0	0	23	0	0
7	56158823	.	A	G	19	7	26	0	0	26	0	0
7	56158874	.	C	T	20	5	25	0	1	26	0	0
7	56172458	.	T	C	10	3	13	0	0	13	0	0
7	56174222	.	T	C	6	7	13	0	1	14	0	0
7	56177177	.	C	T	1	8	9	0	9	18	0	0
7	56177188	.	T	G	9	9	18	0	0	18	0	0
7	56180258	.	C	T	11	7	18	0	0	18	0	0
7	56180399	.	A	G	4	3	7	0	0	7	0	0
7	56180482	.	G	A	5	4	9	0	0	9	0	0
7	56180555	.	G	A	5	3	8	0	0	8	0	0
7	56180589	.	C	A	0	6	6	0	5	11	0	0
7	56253928	.	T	A	4	4	8	0	1	9	0	0
7	56395283	.	A	G	6	5	11	0	0	11	0	0
7	56397859	.	G	A	7	13	20	0	0	20	0	0
7	56398522	.	A	T	6	11	17	0	2	19	0	0
7	56398651	.	C	T	10	8	18	0	0	18	0	0
7	56405508	.	T	C	8	10	18	0	1	19	0	0
7	56484426	.	G	A	14	17	31	0	0	31	0	0
7	56517453	.	T	C	1	2	3	0	0	3	0	0
7	56523233	.	A	G	4	3	7	0	0	7	0	0
7	56528494	.	C	T	3	6	9	0	1	10	0	0
7	56528922	.	G	A	7	3	10	0	0	10	0	0
7	56737268	.	C	G	6	0	6	0	8	14	0	0
7	56743837	.	G	C	1	6	7	0	0	7	0	0
7	56743879	.	A	G	5	7	12	0	0	12	0	0
7	56746311	.	C	T	8	12	20	0	1	21	0	0
7	56751971	.	A	G	7	13	20	0	1	21	0	0
7	56752243	.	G	A	6	18	24	0	0	24	0	0
7	56761453	.	A	T	5	9	14	0	0	14	0	0
7	56766115	.	C	T	0	15	15	0	10	25	0	0
7	56766282	.	A	C	4	0	4	0	8	12	0	0
7	56766754	.	A	T	6	4	10	1	0	11	0	0
7	56766828	.	C	G	2	7	9	0	0	9	0	0
7	56766845	.	T	C	1	3	4	0	2	6	0	0
7	56777813	.	T	C	12	0	12	0	8	20	0	0
7	56778235	.	T	A	15	16	31	0	1	32	0	0
7	56778251	.	T	C	15	13	28	0	3	31	0	0
7	56778282	.	C	T	1	10	11	0	13	24	0	0
7	56778305	.	G	A	7	18	25	0	1	26	0	0
7	56778672	.	G	T	21	15	36	0	1	38	1	0
7	56778721	.	G	T	15	19	34	0	2	36	0	0
7	56778822	.	A	T	12	8	20	0	0	20	0	0
7	56778895	.	A	G	7	11	18	0	1	19	0	0
7	56784070	.	A	T	20	6	26	0	3	29	0	0
7	56785006	.	T	C	14	16	30	0	0	30	0	0
7	56785308	.	C	T	16	20	36	0	2	38	0	0
7	56785315	.	G	A	17	19	36	0	1	37	0	0
7	56787414	.	A	T	18	19	37	0	2	39	0	0
7	56787483	.	T	A	20	14	34	0	0	34	0	0
7	56787527	.	C	T	23	11	34	0	1	35	0	0
7	56793362	.	G	A	9	14	23	0	0	23	0	0
7	56830948	.	C	T	1	3	4	0	0	4	0	0
7	56831575	.	G	A	3	2	5	0	0	5	0	0
7	56889971	.	C	T	2	1	3	0	0	3	0	0
7	56890016	.	C	T	2	3	5	0	0	5	0	0
7	56890418	.	G	A	6	3	9	0	0	9	0	0
7	56981010	.	T	C	2	2	4	0	0	4	0	0
7	56998877	.	C	T	5	3	8	0	0	8	0	0
7	57017140	.	C	T	3	2	5	0	0	5	0	0
7	57038463	.	A	G	3	0	3	0	6	9	0	0
7	57048022	.	C	T	10	0	10	0	0	10	0	0
7	57048059	.	A	T	6	5	11	0	1	12	0	0
7	57048677	.	T	C	4	3	7	0	0	7	0	0
7	57048682	.	C	A	4	2	6	0	1	7	0	0
7	57048885	.	T	A	3	3	6	0	0	6	0	0
7	57049308	.	T	C	7	5	12	0	0	12	0	0
7	57049578	.	C	T	7	7	14	0	0	14	0	0
7	57049638	.	A	G	5	3	8	0	3	11	0	0
7	57049911	.	C	T	7	4	11	0	0	11	0	0
7	57049958	.	C	T	4	6	10	0	1	11	0	0
7	57057285	.	C	T	2	2	4	0	0	4	0	0
7	57071707	.	C	T	4	5	9	0	0	9	0	0
7	57081143	.	C	T	4	6	10	0	1	11	0	0
7	57083043	.	C	T	4	5	9	0	1	10	0	0
7	57083088	.	G	A	5	2	7	0	1	8	0	0
7	57083094	.	A	G	6	0	6	0	2	8	0	0
7	57086153	.	C	T	7	10	17	0	0	17	0	0
7	57086216	.	G	A	0	3	3	0	8	11	0	0
7	57086277	.	G	A	0	7	7	0	6	13	0	0
7	57086383	.	C	A	9	3	12	0	0	12	0	0
7	57119358	.	T	C	2	3	5	0	0	5	0	0
7	57119399	.	A	C	3	3	6	0	0	6	0	0
7	57120266	.	T	G	2	0	2	0	5	7	0	0
7	57122408	.	T	A	4	3	7	0	0	7	0	0
7	57129474	.	A	G	1	5	6	0	0	6	0	0
7	57129729	.	G	T	5	6	11	0	0	11	0	0
7	57485710	.	T	C	6	4	10	0	1	11	0	0
7	57485736	.	A	G	5	3	8	0	1	9	0	0
7	57485766	.	A	G	5	5	10	0	0	10	0	0
7	57497353	.	T	C	8	9	17	0	0	17	0	0
7	57497455	.	C	G	6	6	12	0	0	12	0	0
7	57504905	.	C	G	5	15	20	0	0	20	0	0
7	57725867	.	G	A	12	6	18	0	0	18	0	0
7	57800754	.	C	T	10	9	19	1	0	20	0	0
7	57839716	.	A	C	8	22	30	0	1	31	0	0
7	57862456	.	C	T	11	17	28	0	0	28	0	0
7	57874026	.	G	A	9	13	22	0	1	23	0	0
7	57874038	.	A	C	9	16	25	0	0	25	0	0
7	57874083	.	G	A	1	14	15	0	10	25	0	0
7	57876512	.	T	C	15	14	29	0	1	30	0	0
7	57878712	.	T	C	4	11	15	0	1	16	0	0
7	57878726	.	A	T	2	10	12	0	0	12	0	0
7	57878885	.	C	T	5	8	13	0	0	13	0	0
7	57878973	.	A	T	13	6	19	0	0	19	0	0
7	57878974	.	C	T	13	6	19	0	0	19	0	0
7	57879076	.	A	G	10	0	10	0	7	17	0	0
7	57879205	.	C	T	5	7	12	0	0	12	0	0
7	57879245	.	C	T	4	7	11	0	0	11	0	0
7	57879396	.	T	A	20	16	36	0	1	37	0	0
7	57879431	.	G	T	2	18	20	0	14	34	0	0
7	57879436	.	C	A	15	15	30	0	2	32	0	0
7	57879576	.	C	A	17	14	31	0	1	32	0	0
7	57879601	.	T	C	16	9	25	0	3	28	0	0
7	57879959	.	C	A	6	4	10	0	0	10	0	0
7	57879992	.	G	A	5	5	10	0	2	12	0	0
7	57880073	.	G	C	2	7	9	0	0	9	0	0
7	57886347	.	C	A	26	15	41	0	3	44	0	0
7	57886392	.	T	A	28	16	44	0	3	47	0	0
7	57886964	.	T	G	27	28	55	0	3	58	0	0
7	57887480	.	C	T	27	26	53	0	3	56	0	0
7	57898605	.	G	A	38	15	53	0	1	54	0	0
7	57898623	.	C	T	37	20	57	0	0	57	0	0
7	57898650	.	T	C	22	33	55	0	1	56	0	0
7	57898658	.	C	G	20	37	57	0	2	59	0	0
7	57900948	.	T	A	7	3	10	0	0	10	0	0
7	57913558	.	C	A	27	25	52	0	3	55	0	0
7	57914155	.	T	G	28	23	51	0	3	54	0	0
7	57918590	.	A	G	13	13	26	0	0	26	0	0
7	57918799	.	G	A	30	22	52	0	3	55	0	0
7	57919087	.	T	G	26	23	49	0	3	52	0	0
7	57919241	.	G	A	25	26	51	0	0	51	0	0
7	57919249	.	T	C	21	1	22	0	29	51	0	0
7	57919567	.	T	C	22	9	31	0	1	32	0	0
7	57920608	.	A	T	14	18	32	0	2	34	0	0
7	57920908	.	A	G	22	13	35	0	2	37	0	0
7	57921094	.	A	G	21	25	46	0	2	48	0	0
7	57921335	.	A	G	17	14	31	0	2	33	0	0
7	57921914	.	G	A	17	19	36	0	2	38	0	0
7	57922018	.	T	G	10	10	20	0	0	20	0	0
7	57922480	.	G	A	27	9	36	0	0	36	0	0
7	57922555	.	G	T	15	14	29	0	1	30	0	0
7	57922793	.	G	T	21	10	31	0	0	31	0	0
7	57922827	.	C	T	9	17	26	0	1	27	0	0
7	57922828	.	A	G	8	18	26	0	1	27	0	0
7	57928407	.	A	T	17	11	28	0	1	29	0	0
7	57934036	.	A	T	18	16	34	1	2	37	0	0
7	57934051	.	T	C	17	18	35	1	0	36	0	0
7	57936171	.	G	A	17	20	37	0	0	37	0	0
7	57952714	.	T	C	15	20	35	2	0	37	0	0
7	57954099	.	G	A	11	17	28	1	1	30	0	0
7	57954123	.	A	C	12	16	28	1	0	29	0	0
7	57956503	.	C	T	18	9	27	0	2	29	0	0
7	57959962	.	G	A	20	21	41	0	1	42	0	0
7	57961917	.	C	A	13	20	33	0	1	34	0	0
7	57967373	.	A	G	14	11	25	0	0	25	0	0
7	57972616	.	T	C	13	5	18	0	0	18	0	0
7	57989277	.	C	T	0	2	2	0	1	3	0	0
7	57994952	.	T	A	15	9	24	0	0	24	0	0
7	58007916	.	G	T	16	15	31	0	2	33	0	0
7	58130658	.	A	G	2	2	4	0	0	4	0	0
7	58143104	.	A	G	1	3	4	0	0	4	0	0
7	58143123	.	G	C	1	3	4	0	0	4	0	0
7	58144163	.	G	A	1	4	5	0	1	6	0	0
7	58150120	.	A	T	8	5	13	0	0	13	0	0
7	58153549	.	A	G	9	5	14	0	0	14	0	0
7	58158456	.	C	T	1	3	4	0	8	12	0	0
7	58158484	.	T	C	8	8	16	0	0	16	0	0
7	58158847	.	T	C	5	6	11	0	0	11	0	0
7	58164082	.	G	A	3	2	5	0	0	5	0	0
7	58166226	.	G	C	2	3	5	0	0	5	0	0
7	58170243	.	C	T	0	4	4	0	4	8	0	0
7	58188252	.	A	G	6	6	12	0	0	12	0	0
7	58188253	.	A	C	6	6	12	0	0	12	0	0
7	58193141	.	T	C	2	5	7	0	0	7	0	0
7	58193195	.	A	G	2	5	7	0	0	7	0	0
7	58197726	.	T	C	2	3	5	0	0	5	0	0
7	58199935	.	A	G	5	3	8	0	1	9	0	0
7	58200145	.	G	A	4	4	8	0	0	8	0	0
7	58205460	.	A	T	9	7	16	0	1	17	0	0
7	58207453	.	A	G	3	10	13	0	0	13	0	0
7	58259472	.	C	T	10	8	18	0	1	19	0	0
7	58259494	.	T	A	4	6	10	0	1	11	0	0
7	58259561	.	A	G	11	16	27	0	1	28	0	0
7	58259808	.	C	T	1	7	8	0	13	21	0	0
7	58262100	.	G	A	13	15	28	0	1	29	0	0
7	58264129	.	T	C	16	9	25	0	0	25	0	0
7	58265533	.	G	A	15	14	29	0	0	29	0	0
7	58687138	.	G	A	20	13	33	0	0	33	0	0
7	58695379	.	A	C	5	11	16	0	0	16	0	0
7	58695441	.	C	A	18	15	33	0	1	34	0	0
7	58695599	.	G	T	16	10	26	0	0	26	0	0
7	58748871	.	A	C	38	20	58	0	4	62	0	0
7	58748891	.	T	C	35	26	61	0	1	62	0	0
7	58750327	.	A	C	14	20	34	0	1	35	0	0
7	58841391	.	T	C	12	0	12	0	12	24	0	0
7	58841552	.	T	G	8	10	18	0	1	19	0	0
7	58843134	.	T	C	8	16	24	0	0	24	0	0
7	59037274	.	T	C	1	3	4	0	0	4	0	0
7	59037573	.	A	C	1	3	4	0	2	6	0	0
7	59037972	.	C	T	4	6	10	0	0	10	0	0
7	59041504	.	A	G	5	2	7	0	0	7	0	0
7	59041531	.	A	G	5	1	6	0	7	13	0	0
7	59043246	.	C	A	2	7	9	0	0	9	0	0
7	59043421	.	T	C	6	7	13	0	0	13	0	0
7	59046711	.	T	A	7	4	11	0	1	12	0	0
7	59046795	.	G	A	2	4	6	0	0	6	0	0
7	59046966	.	T	A	12	14	26	0	0	26	0	0
7	59048307	.	C	T	4	14	18	0	17	35	0	0
7	59048907	.	G	A	9	8	17	0	0	17	0	0
7	59069079	.	G	A	4	3	7	0	0	7	0	0
7	59069080	.	T	G	2	2	4	0	2	6	0	0
7	59087347	.	A	G	4	2	6	0	0	7	1	0
7	59202989	.	A	T	5	5	10	0	1	11	0	0
7	59203097	.	A	G	4	8	12	0	0	12	0	0
7	59203289	.	G	A	5	5	10	0	0	10	0	0
7	59210423	.	T	A	5	8	13	0	1	14	0	0
7	59210625	.	C	T	5	9	14	0	0	14	0	0
7	59212907	.	A	T	3	4	7	0	0	7	0	0
7	59212908	.	T	A	3	4	7	0	0	7	0	0
7	59235540	.	C	T	1	3	4	0	0	4	0	0
7	59235638	.	G	A	6	6	12	0	0	12	0	0
7	59235696	.	C	T	6	3	9	0	0	9	0	0
7	59240761	.	G	A	2	6	8	0	1	9	0	0
7	59245594	.	G	T	7	4	11	0	0	11	0	0
7	59245612	.	G	T	7	4	11	0	0	11	0	0
7	59335135	.	A	C	1	4	5	0	0	5	0	0
7	59469015	.	G	A	5	9	14	0	1	15	0	0
7	59574234	.	C	A	2	2	4	0	0	4	0	0
7	59589259	.	A	G	6	9	15	0	1	16	0	0
7	60149599	.	C	T	35	15	50	0	1	51	0	0
7	60240748	.	T	C	2	4	6	0	1	7	0	0
7	60240944	.	C	T	3	2	5	0	0	5	0	0
7	60240946	.	C	A	3	2	5	0	0	5	0	0
7	60240990	.	T	G	2	4	6	0	1	7	0	0
7	60241377	.	G	T	4	4	8	0	1	9	0	0
7	60241387	.	C	T	3	4	7	0	1	8	0	0
7	60242951	.	A	G	5	3	8	0	0	8	0	0
7	60244637	.	A	G	4	5	9	0	0	9	0	0
7	60256778	.	C	T	1	3	4	0	1	5	0	0
7	60258390	.	G	T	2	2	4	0	1	5	0	0
7	60359512	.	G	A	3	2	5	0	1	6	0	0
7	60359516	.	A	C	4	2	6	0	0	6	0	0
7	60359574	.	G	A	0	2	2	0	4	6	0	0
7	60359584	.	C	T	3	2	5	0	0	5	0	0
7	60359719	.	A	T	5	5	10	0	0	10	0	0
7	60409230	.	T	C	6	8	14	0	0	14	0	0
7	60415571	.	G	T	5	7	12	0	0	12	0	0
7	60415928	.	T	C	7	5	12	0	0	12	0	0
7	60415945	.	A	T	6	5	11	0	1	12	0	0
7	60416010	.	T	C	13	6	19	0	0	19	0	0
7	60416016	.	A	G	11	5	16	0	1	17	0	0
7	60416074	.	T	A	14	4	18	0	0	18	0	0
7	60416096	.	C	A	4	12	16	0	0	16	0	0
7	60416175	.	C	T	4	7	11	0	1	12	0	0
7	60416317	.	A	G	5	0	5	0	6	11	0	0
7	60416327	.	C	T	7	7	14	0	0	14	0	0
7	60416379	.	G	A	7	5	12	0	0	12	0	0
7	60416383	.	C	T	7	7	14	0	0	14	0	0
7	60416439	.	A	G	5	14	19	0	0	19	0	0
7	60416724	.	A	G	3	4	7	0	0	7	0	0
7	60416764	.	T	G	2	5	7	0	0	7	0	0
7	60417176	.	T	A	5	3	8	0	0	8	0	0
7	60551171	.	A	C	20	20	40	0	2	43	1	0
7	60551471	.	A	G	7	18	25	0	4	29	0	0
7	60585523	.	A	G	24	1	25	0	19	44	0	0
7	60585599	.	G	A	16	22	38	0	0	38	0	0
7	60585702	.	G	A	12	14	26	0	1	27	0	0
7	60585748	.	G	T	13	12	25	0	0	25	0	0
7	60585818	.	G	C	15	16	31	0	0	31	0	0
7	60586187	.	T	C	15	26	41	0	2	43	0	0
7	60586771	.	C	T	8	11	19	0	2	21	0	0
7	60586784	.	A	T	12	7	19	0	2	22	1	0
7	60586835	.	C	T	11	13	24	0	0	24	0	0
7	60586874	.	G	A	1	10	11	0	11	22	0	0
7	60586976	.	C	T	12	14	26	0	1	27	0	0
7	60597482	.	G	A	10	21	31	0	1	32	0	0
7	60597500	.	T	G	10	17	27	0	2	29	0	0
7	60597863	.	C	T	18	21	39	0	1	40	0	0
7	60598265	.	T	A	21	17	38	0	0	38	0	0
7	61170165	.	C	T	6	2	8	0	1	9	0	0
7	61586719	.	C	T	0	3	3	0	7	10	0	0
7	61587138	.	A	G	3	3	6	0	0	6	0	0
7	61587143	.	T	A	2	3	5	0	1	6	0	0
7	61587520	.	A	G	1	1	2	0	0	2	0	0
7	61587536	.	A	G	1	2	3	0	0	3	0	0
7	61587740	.	G	A	1	2	3	0	1	4	0	0
7	61594209	.	G	A	3	2	5	0	1	6	0	0
7	61619394	.	A	G	1	2	3	0	0	3	0	0
7	61764102	.	G	A	3	3	6	0	0	6	0	0
7	61766585	.	T	C	3	5	8	0	0	8	0	0
7	61767441	.	A	C	3	2	5	0	0	5	0	0
7	61771497	.	C	T	1	4	5	0	0	5	0	0
7	61772874	.	C	T	5	6	11	0	0	11	0	0
7	61772930	.	G	T	4	3	7	0	0	7	0	0
7	61775744	.	G	A	5	2	7	0	0	7	0	0
7	61777825	.	A	G	5	2	7	0	1	8	0	0
7	61777828	.	T	C	5	2	7	0	0	7	0	0
7	61787154	.	C	A	2	3	5	0	0	5	0	0
7	61804557	.	A	T	4	3	7	0	0	7	0	0
7	61804658	.	C	T	1	4	5	0	0	5	0	0
7	61804880	.	A	T	6	4	10	0	0	10	0	0
7	61804909	.	C	A	6	6	12	0	0	12	0	0
7	61805102	.	G	A	11	4	15	0	0	15	0	0
7	61805104	.	T	A	10	4	14	0	1	15	0	0
7	61826026	.	G	A	1	0	1	0	1	2	0	0
7	61826035	.	C	A	1	2	3	0	0	3	0	0
7	61921320	.	G	A	11	10	21	0	1	22	0	0
7	61921463	.	C	T	8	10	18	0	1	20	1	0
7	61921465	.	T	A	10	6	16	0	4	20	0	0
7	61931851	.	A	C	4	3	7	0	1	8	0	0
7	61934189	.	T	A	6	12	18	0	1	19	0	0
7	61934278	.	C	T	9	6	15	0	7	22	0	0
7	61934306	.	A	G	11	0	11	0	9	20	0	0
7	61934330	.	A	G	9	0	9	0	6	15	0	0
7	61945030	.	A	G	6	5	11	0	0	11	0	0
7	61959031	.	G	A	6	4	10	0	1	11	0	0
7	61961063	.	G	A	13	8	21	0	1	22	0	0
7	61961229	.	T	C	3	9	12	0	1	13	0	0
7	61962040	.	T	C	2	5	7	0	0	7	0	0
7	61962292	.	G	T	2	3	5	0	0	5	0	0
7	61977170	.	G	C	4	5	9	0	0	9	0	0
7	61977499	.	T	C	13	7	20	0	0	20	0	0
7	61977514	.	G	A	10	10	20	0	1	21	0	0
7	61977769	.	G	A	3	8	11	0	1	12	0	0
7	61981518	.	A	G	5	2	7	0	0	7	0	0
7	62004146	.	C	T	22	14	36	0	1	37	0	0
7	62009630	.	T	A	7	4	11	0	2	13	0	0
7	62009677	.	G	A	0	7	7	0	7	14	0	0
7	62194008	.	G	A	2	4	6	0	0	6	0	0
7	62206340	.	G	A	0	2	2	0	1	3	0	0
7	62248670	.	T	A	5	4	9	0	0	9	0	0
7	62251340	.	T	C	3	6	9	0	0	9	0	0
7	62251342	.	G	A	3	6	9	0	0	9	0	0
7	62258058	.	A	T	4	5	9	0	0	9	0	0
7	62260866	.	C	T	8	4	12	0	0	12	0	0
7	62261533	.	A	T	8	6	14	0	0	14	0	0
7	62261581	.	C	T	8	7	15	0	0	15	0	0
7	64740893	.	T	C	5	0	5	0	8	13	0	0
7	64741855	.	T	C	3	3	6	0	0	6	0	0
7	64742491	.	G	A	1	2	3	0	0	3	0	0
7	64978891	.	A	C	19	10	29	0	2	31	0	0
7	64980793	.	A	G	19	8	27	0	0	27	0	0
7	64980820	.	A	G	15	13	28	0	1	29	0	0
7	64988061	.	A	G	18	14	32	0	1	33	0	0
7	64996666	.	A	G	4	13	17	0	0	17	0	0
7	65019731	.	T	C	15	7	22	0	0	22	0	0
7	65024082	.	C	T	1	12	13	0	12	26	1	0
7	65026828	.	C	T	1	7	8	0	6	15	1	0
7	65035275	.	A	G	17	6	23	0	2	25	0	0
7	65035416	.	G	T	12	10	22	0	1	23	0	0
7	65035437	.	C	T	11	10	21	0	2	23	0	0
7	65039374	.	T	A	15	15	30	0	1	31	0	0
7	65039436	.	A	C	18	0	18	0	18	36	0	0
7	65049706	.	C	T	1	7	8	0	11	19	0	0
7	65050312	.	A	T	14	9	23	0	4	27	0	0
7	65092935	.	G	A	4	9	13	1	7	21	0	0
7	65093097	.	G	A	16	12	28	0	2	30	0	0
7	65104080	.	A	G	5	4	9	0	0	9	0	0
7	65104792	.	C	T	2	5	7	0	0	7	0	0
7	65104840	.	C	A	5	2	7	0	0	8	1	0
7	65105011	.	G	C	2	8	10	0	0	10	0	0
7	65105160	.	C	A	8	5	13	0	0	13	0	0
7	65113970	.	C	A	1	6	7	0	1	8	0	0
7	65121982	.	C	T	14	16	30	0	0	30	0	0
7	65132884	.	C	T	15	5	20	0	1	21	0	0
7	65138868	.	A	G	11	12	23	0	1	24	0	0
7	65140532	.	C	A	11	9	20	0	2	22	0	0
7	65140738	.	T	A	9	9	18	0	1	19	0	0
7	65140786	.	G	A	12	10	22	0	1	23	0	0
7	65144861	.	G	T	2	11	13	0	10	23	0	0
7	65147905	.	G	A	8	8	16	0	1	17	0	0
7	65152024	.	T	C	11	6	17	0	0	17	0	0
7	65152036	.	C	A	7	12	19	0	1	20	0	0
7	65152075	.	A	G	7	12	19	0	0	19	0	0
7	65157397	.	A	C	13	11	24	0	2	26	0	0
7	65162339	.	G	A	3	13	16	0	15	31	0	0
7	65173289	.	A	T	15	16	31	0	1	32	0	0
7	65173534	.	C	T	8	4	12	0	0	12	0	0
7	65173829	.	A	T	2	4	6	0	0	6	0	0
7	65177521	.	A	G	1	3	4	0	0	4	0	0
7	65177923	.	C	G	3	3	6	0	0	6	0	0
7	65178135	.	C	T	3	5	8	0	2	10	0	0
7	65178270	.	C	T	1	4	5	0	0	5	0	0
7	65297041	.	A	T	11	7	18	0	0	18	0	0
7	65297313	.	G	T	3	6	9	0	0	9	0	0
7	65306067	.	T	C	7	6	13	0	2	15	0	0
7	65306229	.	G	A	4	9	13	0	0	13	0	0
7	65309852	.	T	C	1	2	3	0	2	5	0	0
7	65333843	.	T	C	5	8	13	0	1	14	0	0
7	65333874	.	C	T	11	10	21	0	0	21	0	0
7	65333930	.	T	A	8	10	18	0	0	18	0	0
7	65374634	.	T	A	1	7	8	0	0	8	0	0
7	65427004	.	A	G	7	3	10	0	1	11	0	0
7	65432972	.	T	C	3	10	13	0	0	13	0	0
7	65433092	.	T	C	4	8	12	0	0	12	0	0
7	65433343	.	G	T	8	8	16	0	0	16	0	0
7	65433352	.	C	A	8	9	17	0	0	17	0	0
7	65434589	.	C	T	7	5	12	0	0	12	0	0
7	65434610	.	C	T	8	8	16	0	1	17	0	0
7	65440232	.	T	A	8	5	13	0	0	13	0	0
7	65440308	.	T	A	7	5	12	0	1	13	0	0
7	65440361	.	G	A	0	5	5	0	8	13	0	0
7	65440493	.	C	T	4	8	12	0	1	13	0	0
7	65440505	.	G	A	9	4	13	0	1	14	0	0
7	65443348	.	T	C	9	12	21	0	0	21	0	0
7	65443396	.	G	A	10	13	23	0	0	23	0	0
7	65445483	.	G	A	7	6	13	0	2	15	0	0
7	65451324	.	T	A	11	10	21	0	0	21	0	0
7	65451369	.	C	T	10	8	18	0	2	20	0	0
7	65452005	.	G	A	1	13	14	0	9	23	0	0
7	65452017	.	G	A	9	11	20	0	0	20	0	0
7	65453057	.	G	A	1	10	11	0	7	18	0	0
7	65461040	.	G	A	3	12	15	0	6	21	0	0
7	65463165	.	C	A	11	9	20	0	0	20	0	0
7	65463297	.	G	T	1	7	8	0	12	20	0	0
7	65463511	.	G	A	0	16	16	0	17	33	0	0
7	65463586	.	C	T	6	11	17	0	0	17	0	0
7	65463906	.	T	C	8	7	15	0	0	15	0	0
7	65464120	.	T	G	6	5	11	0	0	11	0	0
7	65464132	.	T	G	6	0	6	0	6	12	0	0
7	65473137	.	G	T	10	17	27	0	0	27	0	0
7	65473421	.	G	C	31	14	45	0	2	47	0	0
7	65473775	.	G	T	13	34	47	0	1	48	0	0
7	65473814	.	T	C	40	15	55	0	0	55	0	0
7	65473972	.	T	C	15	22	37	0	1	38	0	0
7	65475422	.	T	G	16	32	48	0	2	50	0	0
7	65475708	.	T	G	30	14	44	0	3	47	0	0
7	65491835	.	G	A	31	26	57	0	1	58	0	0
7	65491910	.	T	A	12	7	19	0	1	20	0	0
7	65582553	.	T	A	1	3	4	0	0	4	0	0
7	65917548	.	C	T	1	3	4	0	1	5	0	0
7	65917580	.	G	A	2	2	4	0	1	5	0	0
7	65917615	.	G	T	1	2	3	0	1	4	0	0
7	65918094	.	C	T	1	3	4	0	0	4	0	0
7	65918176	.	A	T	1	2	3	0	0	3	0	0
7	65918445	.	A	G	1	4	5	0	0	5	0	0
7	65918473	.	G	T	1	4	5	0	0	5	0	0
7	65918566	.	A	G	4	4	8	0	0	8	0	0
7	65918569	.	T	C	3	4	7	0	1	8	0	0
7	65918793	.	T	G	3	7	10	0	0	10	0	0
7	65919103	.	T	C	4	2	6	0	0	6	0	0
7	65919136	.	C	A	3	2	5	0	1	6	0	0
7	65919326	.	C	A	3	4	7	0	1	8	0	0
7	65920010	.	G	A	4	3	7	0	1	8	0	0
7	65920618	.	G	A	1	5	6	0	0	6	0	0
7	65920720	.	A	G	2	0	2	0	3	5	0	0
7	65921037	.	G	A	0	2	2	0	3	5	0	0
7	65921695	.	A	G	5	5	10	0	0	10	0	0
7	65921726	.	G	T	2	3	5	0	6	11	0	0
7	65922732	.	G	C	2	3	5	0	0	5	0	0
7	65922868	.	T	C	3	2	5	0	1	6	0	0
7	65923179	.	C	T	8	5	13	0	0	13	0	0
7	65923921	.	T	C	1	5	6	0	0	6	0	0
7	65924277	.	T	C	3	2	5	0	0	5	0	0
7	65924621	.	T	C	3	2	5	0	0	5	0	0
7	65924634	.	A	G	3	1	4	0	1	5	0	0
7	65940234	.	G	A	2	2	4	0	0	4	0	0
7	66069906	.	A	G	5	2	7	0	0	7	0	0
7	66080231	.	G	A	6	3	9	2	0	11	0	0
7	66090927	.	C	T	4	6	10	0	0	10	0	0
7	66093051	.	T	A	1	5	6	0	0	6	0	0
7	66093216	.	C	T	4	7	11	0	1	12	0	0
7	66105498	.	C	T	15	5	20	0	0	20	0	0
7	66105663	.	A	G	7	0	7	0	4	11	0	0
7	66105752	.	C	T	13	4	17	0	0	17	0	0
7	66133626	.	A	T	6	6	12	0	2	14	0	0
7	66276243	.	G	A	4	3	7	0	0	7	0	0
7	66361984	.	A	G	6	10	16	0	1	17	0	0
7	66368605	.	G	C	4	0	4	1	9	14	0	0
7	66368653	.	T	C	7	0	7	1	6	14	0	0
7	67416891	.	C	T	1	2	3	0	0	3	0	0
7	67419225	.	C	A	1	4	5	0	0	5	0	0
7	67434693	.	A	C	14	25	39	0	0	39	0	0
7	67434807	.	T	C	15	11	26	0	0	26	0	0
7	67435587	.	T	C	15	16	31	0	1	32	0	0
7	67436273	.	C	T	13	20	33	0	1	34	0	0
7	67439428	.	A	C	13	15	28	0	3	31	0	0
7	67439496	.	T	A	14	14	28	0	0	28	0	0
7	67439520	.	T	A	13	15	28	0	0	28	0	0
7	67439742	.	T	C	21	17	38	0	1	39	0	0
7	67439743	.	C	T	21	17	38	0	0	38	0	0
7	67439781	.	T	C	17	11	28	0	1	29	0	0
7	67443766	.	T	C	15	19	34	0	0	34	0	0
7	67444837	.	G	A	23	11	34	0	1	35	0	0
7	67446295	.	C	T	28	12	40	2	1	43	0	0
7	67448338	.	T	C	19	16	35	0	0	35	0	0
7	67448363	.	A	T	14	17	31	0	0	31	0	0
7	67448373	.	T	A	10	16	26	0	0	26	0	0
7	67476376	.	T	C	32	25	57	0	3	60	0	0
7	67493909	.	C	T	8	6	14	0	0	14	0	0
7	67524394	.	G	A	8	5	13	0	0	13	0	0
7	67524484	.	G	A	11	4	15	0	0	15	0	0
7	67524520	.	C	A	9	4	13	0	0	13	0	0
7	67545588	.	T	C	5	4	9	0	0	9	0	0
7	67581909	.	T	C	13	5	18	1	0	19	0	0
7	67584796	.	C	T	11	8	19	0	2	21	0	0
7	67594248	.	C	T	7	6	13	0	3	16	0	0
7	67594292	.	A	T	8	5	13	0	4	17	0	0
7	67594380	.	C	G	6	0	6	0	7	13	0	0
7	67594467	.	T	C	9	8	17	0	0	17	0	0
7	67594506	.	G	A	0	9	9	0	8	17	0	0
7	67733819	.	G	A	17	6	23	7	3	33	0	0
7	67743603	.	T	A	9	6	15	0	0	15	0	0
7	67743604	.	G	T	9	6	15	0	0	15	0	0
7	67743646	.	A	G	10	5	15	0	1	16	0	0
7	67743878	.	T	C	3	5	8	0	0	8	0	0
7	67747819	.	T	C	10	6	16	0	0	16	0	0
7	67747826	.	T	G	12	4	16	0	0	16	0	0
7	67747869	.	G	C	6	2	8	0	0	8	0	0
7	67749343	.	T	C	4	3	7	0	0	7	0	0
7	67749359	.	G	A	1	4	5	0	3	8	0	0
7	67749397	.	A	G	1	0	1	0	4	5	0	0
7	67751133	.	C	T	3	5	8	0	0	8	0	0
7	67751286	.	A	G	9	0	9	0	5	14	0	0
7	67751430	.	C	T	8	5	13	0	0	13	0	0
7	67752263	.	T	C	7	8	15	0	0	15	0	0
7	67752290	.	G	A	9	5	14	0	1	15	0	0
7	67753196	.	T	C	8	7	15	0	2	17	0	0
7	67759739	.	C	T	6	10	16	0	0	16	0	0
7	67759772	.	C	A	7	5	12	0	0	12	0	0
7	67760437	.	G	C	0	9	9	0	5	14	0	0
7	67760488	.	C	G	9	11	20	0	2	22	0	0
7	67760491	.	C	T	9	13	22	0	0	22	0	0
7	67765772	.	T	C	8	9	17	0	1	18	0	0
7	67767943	.	G	A	2	6	8	0	0	8	0	0
7	67770477	.	T	G	7	6	13	0	1	14	0	0
7	67776588	.	C	T	4	3	7	0	2	9	0	0
7	67794260	.	T	A	1	2	3	0	0	3	0	0
7	67794264	.	T	G	1	3	4	0	0	4	0	0
7	67795367	.	T	C	4	3	7	0	0	7	0	0
7	67795386	.	A	G	4	4	8	0	1	9	0	0
7	67795429	.	G	A	5	4	9	0	0	9	0	0
7	67796494	.	G	A	1	5	6	0	6	12	0	0
7	67797037	.	C	G	7	4	11	0	0	11	0	0
7	67797087	.	G	T	7	10	17	0	0	17	0	0
7	67797097	.	C	T	6	10	16	0	2	18	0	0
7	67817280	.	T	A	3	2	5	0	0	5	0	0
7	67817399	.	C	T	5	5	10	0	0	10	0	0
7	67830051	.	C	T	0	3	3	0	3	6	0	0
7	67833051	.	G	A	4	6	10	0	1	11	0	0
7	67835264	.	A	G	2	4	6	0	0	6	0	0
7	67835269	.	A	C	2	3	5	0	0	5	0	0
7	67842641	.	G	T	3	4	7	0	0	7	0	0
7	67846087	.	T	C	3	2	5	0	0	5	0	0
7	67861868	.	T	G	5	6	11	0	0	11	0	0
7	67861872	.	G	C	6	0	6	0	6	12	0	0
7	67865220	.	G	C	2	5	7	0	0	7	0	0
7	67876771	.	C	T	1	2	3	0	3	6	0	0
7	67876820	.	T	G	2	3	5	0	1	6	0	0
7	67876822	.	C	T	2	4	6	0	0	6	0	0
7	67876880	.	T	A	3	6	9	0	0	9	0	0
7	67876881	.	G	A	3	6	9	0	0	9	0	0
7	67916456	.	C	A	4	4	8	0	0	8	0	0
7	68215451	.	A	T	16	6	22	1	2	26	1	0
7	68215990	.	T	G	13	18	31	0	0	31	0	0
7	68216504	.	C	A	0	4	4	0	9	13	0	0
7	68217387	.	G	A	12	11	23	0	0	23	0	0
7	68219332	.	A	G	7	4	11	0	0	11	0	0
7	68219340	.	A	T	4	3	7	0	1	8	0	0
7	68219412	.	T	A	8	8	16	0	2	18	0	0
7	68220824	.	A	C	5	6	11	0	0	11	0	0
7	68224841	.	G	A	10	7	17	0	0	17	0	0
7	68232112	.	A	G	3	2	5	0	0	5	0	0
7	68232123	.	A	G	4	2	6	0	0	6	0	0
7	68234585	.	T	G	1	5	6	0	2	8	0	0
7	68328858	.	T	G	3	4	7	0	0	7	0	0
7	68328861	.	A	G	3	4	7	0	0	7	0	0
7	68328908	.	A	G	1	4	5	0	0	5	0	0
7	68370504	.	G	A	3	2	5	0	0	5	0	0
7	68370843	.	A	G	5	4	9	0	0	9	0	0
7	68371158	.	A	G	4	4	8	0	0	8	0	0
7	68371530	.	C	T	0	9	9	0	2	11	0	0
7	68372337	.	A	G	2	3	5	0	0	5	0	0
7	68372794	.	C	A	1	2	3	0	0	3	0	0
7	68540716	.	T	A	4	2	6	0	1	7	0	0
7	68541265	.	A	G	3	2	5	0	0	5	0	0
7	69143989	.	T	C	3	7	10	0	1	11	0	0
7	69144984	.	T	C	10	3	13	0	1	14	0	0
7	69145516	.	T	C	13	3	16	0	0	16	0	0
7	69145836	.	T	C	13	4	17	0	0	17	0	0
7	69416511	.	C	T	0	2	2	0	1	3	0	0
7	69437422	.	A	C	5	6	11	0	2	13	0	0
7	69437472	.	T	C	6	9	15	0	1	16	0	0
7	69437495	.	C	A	7	6	13	0	0	13	0	0
7	69439094	.	T	A	6	6	12	0	0	12	0	0
7	69439436	.	T	C	2	6	8	0	1	9	0	0
7	69439580	.	A	G	1	2	3	0	0	3	0	0
7	69439587	.	A	G	2	0	2	0	2	4	0	0
7	69442261	.	T	G	1	3	4	0	0	4	0	0
7	69442374	.	C	T	3	3	6	0	0	6	0	0
7	69447352	.	T	C	4	5	9	0	0	9	0	0
7	69447469	.	C	G	5	5	10	0	0	10	0	0
7	69447516	.	A	G	2	5	7	0	0	7	0	0
7	69447520	.	G	A	2	5	7	0	0	7	0	0
7	69447699	.	G	T	3	2	5	0	0	5	0	0
7	69450044	.	A	G	1	3	4	0	0	4	0	0
7	69458368	.	G	A	0	2	2	0	3	5	0	0
7	69466751	.	A	G	6	2	8	0	0	8	0	0
7	69467145	.	A	G	5	3	8	0	0	8	0	0
7	69467228	.	G	A	3	2	5	0	0	5	0	0
7	69467267	.	A	G	6	6	12	0	0	12	0	0
7	69477283	.	T	G	29	23	52	2	2	58	2	0
7	69477303	.	A	G	23	1	24	1	33	58	0	0
7	69477361	.	T	C	20	28	48	1	1	50	0	0
7	69477437	.	A	G	32	23	55	0	3	58	0	0
7	69477464	.	T	C	33	21	54	0	3	57	0	0
7	69478939	.	C	T	1	2	3	0	0	3	0	0
7	69484697	.	A	G	1	1	2	0	4	6	0	0
7	69496521	.	C	A	13	12	25	0	1	26	0	0
7	69496537	.	A	T	14	10	24	0	1	25	0	0
7	69496572	.	A	G	13	14	27	0	0	27	0	0
7	69497048	.	A	T	14	7	21	0	1	22	0	0
7	69497493	.	G	T	19	17	36	0	1	37	0	0
7	69497637	.	G	A	20	22	42	0	2	44	0	0
7	69501040	.	A	G	17	17	34	0	1	36	1	0
7	69501148	.	A	G	19	18	37	0	0	37	0	0
7	69501300	.	A	G	16	12	28	0	0	28	0	0
7	69501345	.	G	T	21	5	26	0	1	27	0	0
7	69566119	.	A	G	17	11	28	0	0	28	0	0
7	69566179	.	A	T	14	16	30	0	1	31	0	0
7	69566848	.	G	A	11	14	25	0	0	25	0	0
7	69576019	.	C	A	17	10	27	0	1	28	0	0
7	69583133	.	A	T	17	11	28	0	4	32	0	0
7	69583139	.	C	T	15	13	28	0	1	29	0	0
7	69601962	.	C	T	9	2	11	0	0	11	0	0
7	69615021	.	G	A	12	13	25	0	1	27	1	0
7	69911530	.	G	A	2	5	7	0	1	8	0	0
7	69913830	.	C	T	2	2	4	0	0	4	0	0
7	69913832	.	T	C	0	3	3	0	0	3	0	0
7	69917639	.	C	A	2	3	5	0	1	6	0	0
7	69934685	.	C	T	1	2	3	0	0	3	0	0
7	69934781	.	A	C	3	4	7	0	0	7	0	0
7	69943002	.	C	T	1	5	6	0	0	6	0	0
7	69950322	.	G	A	6	5	11	0	0	11	0	0
7	69950644	.	G	T	5	3	8	0	0	8	0	0
7	69950666	.	T	C	6	3	9	0	0	9	0	0
7	69959980	.	G	A	3	6	9	0	0	9	0	0
7	71792889	.	T	C	1	4	5	0	0	5	0	0
7	72034534	.	T	C	6	16	22	0	1	23	0	0
7	72034590	.	T	C	3	2	5	0	1	6	0	0
7	72103375	.	C	T	12	2	14	3	2	19	0	0
7	72103376	.	T	G	11	3	14	3	1	18	0	0
7	72159892	.	C	T	1	5	6	1	0	7	0	0
7	72537890	.	G	A	4	2	6	0	0	6	0	0
7	73617717	.	A	G	7	4	11	0	0	11	0	0
7	73617817	.	A	G	15	4	19	0	1	20	0	0
7	73618413	.	A	G	5	7	12	0	0	12	0	0
7	73618841	.	A	G	2	6	8	0	0	8	0	0
7	73656361	.	G	A	5	3	8	0	2	10	0	0
7	74135779	.	G	T	7	5	12	0	2	14	0	0
8	5733	.	T	C	28	23	51	0	3	54	0	0
8	6265	.	C	T	39	20	59	0	1	60	0	0
8	7184	.	T	C	10	13	23	0	1	24	0	0
8	7276	.	G	A	12	11	23	0	0	23	0	0
8	7346	.	G	T	10	11	21	0	1	22	0	0
8	8904	.	G	C	2	2	4	0	0	4	0	0
8	41751	.	G	C	8	18	26	0	1	27	0	0
8	41754	.	C	T	8	19	27	0	0	27	0	0
8	41925	.	T	C	11	0	11	0	15	26	0	0
8	41948	.	A	G	17	15	32	0	1	33	0	0
8	43740	.	T	C	13	0	13	0	16	29	0	0
8	43800	.	A	G	10	22	32	0	0	32	0	0
8	44337	.	G	A	6	12	18	0	0	18	0	0
8	52280	.	C	T	13	8	21	0	1	22	0	0
8	56225	.	T	G	5	6	11	0	0	11	0	0
8	56285	.	A	G	5	8	13	0	0	13	0	0
8	56884	.	C	T	7	9	16	0	0	16	0	0
8	57732	.	C	T	1	9	10	0	10	20	0	0
8	58399	.	C	G	9	7	16	0	0	16	0	0
8	61833	.	G	A	4	8	12	0	0	12	0	0
8	75188	.	C	A	16	4	20	0	0	20	0	0
8	75446	.	G	T	2	5	7	0	6	13	0	0
8	75646	.	G	C	0	2	2	0	4	6	0	0
8	81536	.	A	G	4	0	4	0	8	12	0	0
8	109321	.	G	A	0	7	7	0	13	20	0	0
8	109375	.	C	A	7	8	15	0	0	15	0	0
8	109378	.	T	C	7	7	14	0	1	15	0	0
8	109489	.	T	C	6	7	13	0	0	13	0	0
8	115080	.	T	C	9	4	13	0	0	13	0	0
8	118378	.	T	C	6	8	14	0	1	15	0	0
8	120282	.	G	A	7	9	16	0	0	16	0	0
8	120377	.	A	G	4	0	4	0	3	7	0	0
8	120839	.	G	A	1	12	13	0	12	25	0	0
8	120896	.	T	C	10	13	23	0	2	25	0	0
8	121145	.	A	C	7	7	14	0	0	14	0	0
8	121149	.	A	C	6	7	13	0	0	13	0	0
8	158431	.	C	T	7	5	12	0	1	13	0	0
8	173841	.	A	G	13	11	24	0	0	24	0	0
8	174020	.	G	A	19	10	29	0	2	31	0	0
8	247267	.	A	T	1	5	6	0	0	6	0	0
8	248757	.	C	T	2	3	5	0	0	5	0	0
8	250769	.	C	T	3	2	5	0	0	5	0	0
8	252789	.	A	T	2	4	6	0	0	6	0	0
8	261498	.	T	C	2	3	5	0	0	5	0	0
8	262012	.	C	T	8	4	12	0	1	13	0	0
8	262054	.	C	A	4	5	9	0	0	9	0	0
8	268215	.	G	A	4	5	9	0	0	9	0	0
8	276277	.	C	T	11	6	17	1	0	18	0	0
8	276334	.	A	G	7	8	15	0	1	16	0	0
8	286192	.	A	G	5	7	12	0	2	14	0	0
8	286251	.	C	T	6	8	14	0	0	14	0	0
8	286302	.	G	A	12	9	21	0	1	22	0	0
8	388885	.	C	T	12	14	26	0	2	28	0	0
8	391931	.	A	C	2	3	5	0	0	5	0	0
8	391943	.	G	A	4	4	8	0	0	8	0	0
8	392047	.	G	T	13	7	20	0	0	20	0	0
8	392389	.	T	C	8	0	8	0	14	22	0	0
8	392503	.	C	T	17	7	24	1	4	29	0	0
8	392689	.	C	T	1	7	8	0	26	34	0	0
8	395281	.	C	A	1	10	11	0	11	22	0	0
8	395287	.	C	T	10	12	22	0	1	23	0	0
8	395428	.	G	A	13	7	20	0	1	21	0	0
8	397338	.	T	C	12	16	28	0	2	30	0	0
8	397341	.	C	T	0	17	17	0	11	28	0	0
8	406330	.	T	G	8	10	18	0	0	18	0	0
8	406432	.	A	C	11	5	16	0	0	16	0	0
8	412114	.	C	T	0	5	5	0	7	12	0	0
8	412296	.	T	C	12	0	12	0	6	18	0	0
8	412303	.	G	A	11	4	15	0	2	17	0	0
8	412355	.	A	G	13	13	26	0	3	29	0	0
8	412358	.	A	G	14	15	29	0	1	30	0	0
8	412504	.	T	C	15	0	15	0	10	25	0	0
8	413845	.	G	C	16	0	16	0	12	28	0	0
8	417849	.	A	G	6	11	17	0	0	17	0	0
8	418575	.	A	G	9	4	13	0	1	14	0	0
8	423723	.	C	T	10	3	13	0	2	16	1	0
8	423920	.	T	C	10	7	17	0	2	20	1	0
8	424969	.	G	A	13	8	21	0	0	21	0	0
8	428851	.	A	C	7	8	15	0	1	16	0	0
8	473773	.	G	A	6	9	15	0	0	15	0	0
8	478889	.	G	T	3	2	5	0	1	6	0	0
8	482033	.	A	G	5	3	8	0	0	8	0	0
8	484740	.	A	G	2	0	2	1	2	5	0	0
8	484746	.	T	C	1	2	3	1	0	4	0	0
8	534513	.	A	T	2	2	4	0	1	5	0	0
8	539973	.	T	G	13	0	13	0	13	26	0	0
8	539979	.	C	G	13	13	26	0	0	26	0	0
8	541376	.	C	A	14	10	24	0	1	25	0	0
8	544637	.	G	T	1	2	3	0	1	4	0	0
8	610902	.	C	A	1	4	5	0	0	5	0	0
8	653919	.	A	G	3	1	4	0	4	8	0	0
8	926772	.	G	A	2	3	5	0	0	5	0	0
8	926779	.	C	T	0	3	3	0	2	5	0	0
8	928341	.	G	A	13	9	22	0	1	23	0	0
8	941343	.	T	C	7	8	15	0	0	15	0	0
8	941369	.	T	C	7	9	16	0	1	17	0	0
8	941378	.	C	T	0	8	8	0	6	14	0	0
8	943953	.	G	C	7	3	10	0	1	11	0	0
8	1082142	.	T	G	1	3	4	2	0	6	0	0
8	1094388	.	G	A	6	16	22	0	1	23	0	0
8	1094542	.	T	C	15	17	32	0	1	33	0	0
8	1094566	.	C	T	14	13	27	0	0	27	0	0
8	1094590	.	G	A	1	7	8	0	17	25	0	0
8	1094910	.	T	A	12	8	20	0	0	20	0	0
8	1100463	.	C	T	16	14	30	0	0	30	0	0
8	1102404	.	T	C	21	11	32	0	2	34	0	0
8	1104980	.	A	G	14	0	14	0	16	30	0	0
8	1106149	.	C	T	14	17	31	0	0	31	0	0
8	1106494	.	C	A	14	6	20	0	0	20	0	0
8	1129821	.	A	G	3	4	7	0	0	7	0	0
8	1129838	.	T	C	5	3	8	0	1	9	0	0
8	1129971	.	T	G	3	4	7	0	0	7	0	0
8	1130331	.	C	T	3	4	7	0	1	8	0	0
8	1130544	.	T	C	5	4	9	0	1	10	0	0
8	1133689	.	A	G	4	5	9	0	0	9	0	0
8	1133743	.	A	G	4	0	4	0	3	7	0	0
8	1133753	.	C	G	3	3	6	0	0	6	0	0
8	1151416	.	T	C	8	17	25	0	5	30	0	0
8	1222504	.	T	C	11	0	11	0	18	29	0	0
8	1222558	.	A	G	9	20	29	0	1	30	0	0
8	1253651	.	G	A	13	25	38	0	1	39	0	0
8	1254337	.	C	T	19	16	35	0	1	36	0	0
8	1255292	.	C	G	1	18	19	0	18	37	0	0
8	1255304	.	G	A	23	14	37	0	1	38	0	0
8	1259023	.	G	A	24	21	45	0	0	45	0	0
8	1264645	.	A	G	9	12	21	0	0	21	0	0
8	1267233	.	G	T	2	3	5	0	3	8	0	0
8	1270107	.	T	G	1	3	4	0	0	4	0	0
8	1270126	.	G	A	1	3	4	0	0	4	0	0
8	1291857	.	T	G	3	0	3	0	5	8	0	0
8	1298792	.	C	T	3	4	7	0	0	7	0	0
8	1298813	.	C	T	3	3	6	0	0	6	0	0
8	1298889	.	A	G	3	0	3	0	4	7	0	0
8	1852056	.	A	G	3	5	8	0	0	8	0	0
8	1852078	.	A	G	5	4	9	0	0	9	0	0
8	1852185	.	A	G	5	3	8	0	0	8	0	0
8	1852537	.	A	G	11	0	11	0	4	15	0	0
8	1852599	.	A	G	8	9	17	0	0	17	0	0
8	1853004	.	A	G	9	5	14	0	1	15	0	0
8	1853400	.	A	G	7	11	18	0	0	18	0	0
8	1853474	.	A	G	2	7	9	0	0	9	0	0
8	1855245	.	A	G	6	2	8	0	0	8	0	0
8	2375439	.	C	T	1	4	5	0	1	6	0	0
8	2387844	.	C	T	1	3	4	0	0	4	0	0
8	2387885	.	T	C	3	2	5	0	0	5	0	0
8	2412800	.	C	T	38	6	44	0	0	44	0	0
8	2412911	.	G	A	28	21	49	0	0	49	0	0
8	2413133	.	T	G	29	35	64	0	4	68	0	0
8	2413160	.	G	C	30	2	32	0	30	63	1	0
8	2416886	.	G	A	24	23	47	0	3	50	0	0
8	2416931	.	C	T	2	26	28	0	23	51	0	0
8	2417891	.	T	C	24	25	49	0	2	51	0	0
8	2421318	.	T	C	21	23	44	0	1	45	0	0
8	2421342	.	C	A	25	25	50	0	2	52	0	0
8	2426500	.	A	G	31	27	58	0	2	60	0	0
8	2442765	.	C	T	3	5	8	0	2	10	0	0
8	2456933	.	C	T	5	10	15	0	0	15	0	0
8	2456953	.	C	G	7	10	17	0	1	18	0	0
8	2457571	.	T	C	4	8	12	0	0	12	0	0
8	2467230	.	A	G	12	0	12	0	8	20	0	0
8	2467233	.	A	G	13	7	20	0	0	20	0	0
8	2469292	.	G	A	8	9	17	0	0	17	0	0
8	2469377	.	G	C	5	5	10	0	0	10	0	0
8	2469401	.	C	T	6	3	9	0	1	10	0	0
8	2469528	.	G	T	3	3	6	0	0	6	0	0
8	2469559	.	C	T	5	2	7	0	0	7	0	0
8	2487329	.	T	C	21	30	51	0	2	54	1	0
8	2490968	.	C	T	19	29	48	0	1	49	0	0
8	2491338	.	G	A	11	5	16	0	1	17	0	0
8	2502037	.	G	A	41	32	73	0	0	73	0	0
8	2502067	.	C	T	42	29	71	0	0	71	0	0
8	2502088	.	A	G	41	25	66	0	5	71	0	0
8	2502112	.	A	G	44	30	74	0	2	76	0	0
8	2516019	.	C	T	0	4	4	0	9	13	0	0
8	2525435	.	A	G	10	4	14	0	0	14	0	0
8	2525450	.	T	C	8	4	12	0	0	12	0	0
8	2525492	.	A	T	7	7	14	0	0	14	0	0
8	2529817	.	T	A	4	10	14	0	0	15	1	0
8	2529852	.	A	G	3	3	6	0	0	6	0	0
8	2530118	.	G	A	15	4	19	0	1	20	0	0
8	2535588	.	T	A	8	11	19	0	1	20	0	0
8	2535642	.	T	C	6	4	10	0	0	10	0	0
8	2536673	.	A	G	4	2	6	0	0	6	0	0
8	2536761	.	G	C	3	2	5	0	0	5	0	0
8	2543700	.	C	T	2	3	5	0	0	5	0	0
8	2549002	.	A	G	3	4	7	0	0	7	0	0
8	2549011	.	G	A	1	2	3	0	3	6	0	0
8	2549579	.	T	C	8	4	12	0	1	13	0	0
8	2549582	.	A	G	9	3	12	0	1	13	0	0
8	2555046	.	C	G	8	6	14	0	0	14	0	0
8	2560680	.	T	G	3	1	4	0	4	8	0	0
8	2560848	.	A	G	12	9	21	0	1	22	0	0
8	2566882	.	G	T	6	3	9	0	1	10	0	0
8	2567788	.	T	C	9	5	14	0	0	14	0	0
8	2567818	.	C	T	10	8	18	0	0	18	0	0
8	2571478	.	T	C	7	4	11	0	0	11	0	0
8	2574113	.	G	A	8	2	10	0	0	10	0	0
8	2574463	.	A	G	7	0	7	0	3	10	0	0
8	2574470	.	T	G	6	3	9	0	1	10	0	0
8	2574514	.	A	C	8	4	12	0	0	12	0	0
8	2574524	.	A	C	8	3	11	0	0	11	0	0
8	2585329	.	G	C	4	5	9	0	1	10	0	0
8	2585681	.	C	A	12	19	31	0	3	34	0	0
8	2588348	.	A	G	27	21	48	0	7	55	0	0
8	2588354	.	C	A	2	21	23	0	32	55	0	0
8	2591624	.	A	C	6	0	6	0	10	16	0	0
8	2606435	.	A	T	3	2	5	0	1	6	0	0
8	2606588	.	T	A	1	2	3	0	0	3	0	0
8	2606668	.	T	C	1	2	3	0	0	3	0	0
8	2607359	.	T	C	1	4	5	0	0	5	0	0
8	3085393	.	G	A	1	4	5	0	1	6	0	0
8	3085423	.	T	C	3	4	7	0	0	7	0	0
8	3085466	.	C	A	3	3	6	0	1	7	0	0
8	3085565	.	A	G	3	4	7	0	0	7	0	0
8	3085841	.	T	A	2	5	7	0	0	7	0	0
8	3085863	.	A	G	2	4	6	0	0	6	0	0
8	3099585	.	G	A	1	10	11	0	7	18	0	0
8	3099890	.	A	T	1	2	3	0	0	3	0	0
8	3101081	.	T	A	3	4	7	0	0	7	0	0
8	3101086	.	C	A	3	4	7	0	0	7	0	0
8	3101241	.	G	T	5	9	14	0	0	14	0	0
8	3101277	.	T	C	7	10	17	0	0	17	0	0
8	3431779	.	T	C	4	2	6	0	0	6	0	0
8	3431801	.	C	A	3	3	6	0	0	6	0	0
8	3431825	.	C	T	2	3	5	0	0	5	0	0
8	3434245	.	C	T	5	7	12	0	0	12	0	0
8	3434302	.	T	C	3	4	7	0	0	7	0	0
8	3434449	.	C	T	5	6	11	0	0	11	0	0
8	3434506	.	C	A	5	4	9	0	0	9	0	0
8	3438906	.	A	G	7	5	12	0	0	12	0	0
8	3439266	.	G	T	3	6	9	0	0	9	0	0
8	3439351	.	A	G	3	3	6	0	0	6	0	0
8	3498833	.	G	C	1	3	4	0	0	4	0	0
8	3537152	.	G	A	0	6	6	0	8	14	0	0
8	3538846	.	G	T	6	5	11	0	1	12	0	0
8	3555637	.	G	C	3	2	5	0	0	5	0	0
8	3561455	.	G	A	0	5	5	0	4	9	0	0
8	3561515	.	G	A	8	5	13	0	0	13	0	0
8	3566151	.	A	T	2	5	7	0	1	8	0	0
8	3571612	.	G	A	4	5	9	0	2	11	0	0
8	3571818	.	G	A	3	8	11	0	6	17	0	0
8	3586385	.	C	T	8	7	15	0	2	17	0	0
8	3591190	.	C	T	5	8	13	0	0	14	1	0
8	3591211	.	C	A	10	4	14	0	0	14	0	0
8	3595161	.	G	A	0	7	7	0	15	22	0	0
8	3595359	.	C	T	9	13	22	0	1	23	0	0
8	3602041	.	T	C	7	11	18	0	0	18	0	0
8	3605171	.	C	T	6	4	10	0	0	10	0	0
8	3624208	.	G	C	16	10	26	0	0	26	0	0
8	3624690	.	G	A	1	9	10	0	12	22	0	0
8	3628683	.	C	T	13	14	27	0	0	27	0	0
8	3628747	.	C	A	7	6	13	0	1	14	0	0
8	3628758	.	T	A	7	6	13	0	0	13	0	0
8	3628782	.	G	A	0	12	12	0	10	22	0	0
8	3629231	.	G	T	4	7	11	0	16	27	0	0
8	3629232	.	T	C	18	7	25	0	2	27	0	0
8	3630935	.	A	T	11	15	26	0	0	26	0	0
8	3631371	.	T	C	14	10	24	0	0	24	0	0
8	3641224	.	C	T	19	15	34	0	1	35	0	0
8	3643299	.	T	C	22	23	45	0	0	45	0	0
8	3659979	.	T	C	6	8	14	0	0	14	0	0
8	3660034	.	C	T	11	5	16	0	0	16	0	0
8	3674670	.	C	T	2	3	5	0	0	5	0	0
8	3690953	.	G	A	3	3	6	0	0	6	0	0
8	3691184	.	C	T	1	7	8	0	4	12	0	0
8	3701225	.	C	A	2	2	4	0	0	4	0	0
8	3711928	.	C	A	1	4	5	0	0	5	0	0
8	3711967	.	T	C	1	2	3	0	0	3	0	0
8	3715247	.	G	C	1	2	3	0	0	3	0	0
8	3716675	.	C	T	1	3	4	0	2	6	0	0
8	3859383	.	T	A	10	16	26	0	0	26	0	0
8	3865233	.	T	C	15	12	27	1	0	28	0	0
8	3883831	.	C	G	18	15	33	0	1	34	0	0
8	3885609	.	C	T	6	9	15	0	0	15	0	0
8	3886223	.	C	T	14	15	29	0	3	32	0	0
8	3889662	.	G	A	5	17	22	0	14	36	0	0
8	3890837	.	T	C	16	17	33	0	2	35	0	0
8	3893987	.	C	T	13	14	27	0	1	28	0	0
8	3894008	.	A	T	15	17	32	0	0	32	0	0
8	3894077	.	G	A	20	13	33	0	1	34	0	0
8	3904963	.	C	T	10	11	21	0	1	22	0	0
8	3906073	.	C	A	15	13	28	0	1	29	0	0
8	3915909	.	G	A	11	19	30	0	1	31	0	0
8	3918567	.	C	T	22	12	34	0	1	35	0	0
8	3932842	.	T	G	4	3	7	0	3	10	0	0
8	3932889	.	A	T	3	7	10	0	0	10	0	0
8	3932990	.	A	G	3	9	12	1	0	13	0	0
8	3949558	.	G	T	7	3	10	0	0	10	0	0
8	3950039	.	C	G	6	10	16	0	0	16	0	0
8	3950317	.	G	A	11	4	15	0	0	15	0	0
8	3950341	.	A	G	2	11	13	0	0	13	0	0
8	3950529	.	C	T	2	7	9	0	0	9	0	0
8	3950764	.	A	C	3	6	9	0	0	9	0	0
8	3956898	.	G	A	4	2	6	0	1	7	0	0
8	3974903	.	G	A	1	6	7	0	0	7	0	0
8	4010894	.	G	A	1	4	5	0	0	5	0	0
8	4044846	.	G	A	9	7	16	0	0	16	0	0
8	4067291	.	G	A	2	3	5	0	0	5	0	0
8	4074139	.	G	A	2	2	4	0	0	4	0	0
8	4074427	.	G	A	1	2	3	0	0	3	0	0
8	4399623	.	A	G	8	6	14	0	0	14	0	0
8	4798179	.	A	G	1	3	4	0	0	4	0	0
8	5844982	.	T	C	3	5	8	0	0	8	0	0
8	5845042	.	C	T	5	4	9	0	1	10	0	0
8	5845060	.	T	G	7	5	12	0	1	13	0	0
8	5845210	.	T	A	6	10	16	0	0	16	0	0
8	5845222	.	C	T	5	7	12	0	0	12	0	0
8	5845807	.	A	G	4	2	6	0	0	6	0	0
8	6415113	.	C	T	2	4	6	0	0	6	0	0
8	6415377	.	G	A	2	2	4	0	1	5	0	0
8	6415431	.	A	G	3	2	5	0	0	5	0	0
8	6415959	.	T	C	4	4	8	0	1	9	0	0
8	6863678	.	A	G	11	1	12	0	22	34	0	0
8	6863822	.	G	A	22	11	33	0	0	33	0	0
8	6864062	.	C	G	10	16	26	0	2	28	0	0
8	6864077	.	T	C	13	12	25	0	2	27	0	0
8	6864416	.	C	A	22	10	32	0	1	33	0	0
8	6865247	.	T	A	17	36	53	0	1	54	0	0
8	6865357	.	C	T	22	30	52	0	0	52	0	0
8	6865542	.	C	T	18	21	39	0	0	39	0	0
8	6865834	.	A	G	18	16	34	0	1	35	0	0
8	6866083	.	G	A	21	29	50	0	2	52	0	0
8	6866592	.	G	T	21	23	44	0	1	45	0	0
8	6866835	.	T	G	5	7	12	0	1	13	0	0
8	6874937	.	C	T	13	7	20	0	0	20	0	0
8	6874968	.	A	G	12	11	23	0	0	23	0	0
8	6875061	.	G	T	9	15	24	0	0	24	0	0
8	6875300	.	C	T	14	10	24	0	1	25	0	0
8	6875354	.	T	C	11	13	24	0	0	24	0	0
8	6875562	.	C	T	8	11	19	0	0	19	0	0
8	6875563	.	C	T	8	11	19	0	0	19	0	0
8	6875722	.	A	G	21	13	34	0	0	34	0	0
8	6876297	.	T	C	22	8	30	0	0	30	0	0
8	6876381	.	A	G	12	13	25	0	3	28	0	0
8	6876705	.	A	C	21	13	34	0	0	34	0	0
8	6876941	.	G	T	11	13	24	0	1	25	0	0
8	6876999	.	T	C	18	13	31	0	0	31	0	0
8	6877130	.	T	G	6	10	16	0	1	17	0	0
8	6877248	.	T	C	5	0	5	0	12	17	0	0
8	6877268	.	T	C	5	14	19	0	0	19	0	0
8	6877375	.	A	G	6	3	9	0	0	9	0	0
8	6903650	.	A	G	6	3	9	0	0	9	0	0
8	6903778	.	A	T	2	2	4	0	0	4	0	0
8	6908059	.	C	T	0	3	3	0	4	7	0	0
8	6913809	.	T	C	3	0	3	0	6	9	0	0
8	6920909	.	A	G	8	7	15	0	2	17	0	0
8	6921117	.	C	G	3	28	31	0	19	50	0	0
8	6921344	.	A	C	10	22	32	0	1	33	0	0
8	6921421	.	T	A	13	15	28	0	0	28	0	0
8	6921581	.	A	C	11	28	39	0	1	40	0	0
8	6921671	.	G	A	14	29	43	0	3	46	0	0
8	6927428	.	T	C	18	16	34	0	2	36	0	0
8	6935642	.	A	T	25	17	42	0	2	44	0	0
8	6943167	.	A	T	6	8	14	0	0	14	0	0
8	6970040	.	G	A	12	8	20	0	0	20	0	0
8	6985008	.	A	G	12	12	24	0	0	24	0	0
8	7014341	.	A	G	19	10	29	0	1	30	0	0
8	7014476	.	C	T	20	14	34	0	2	36	0	0
8	7021512	.	C	T	14	12	26	0	1	27	0	0
8	7022029	.	G	A	3	12	15	0	18	33	0	0
8	7022113	.	T	A	14	7	21	0	1	22	0	0
8	7022115	.	T	C	15	8	23	0	0	23	0	0
8	7022155	.	T	A	11	10	21	0	1	22	0	0
8	7022164	.	T	C	14	13	27	0	0	27	0	0
8	7022216	.	T	A	9	11	20	0	1	21	0	0
8	7023007	.	G	C	23	8	31	6	0	37	0	0
8	7023056	.	G	A	2	14	16	2	21	39	0	0
8	7052323	.	T	C	1	1	2	0	1	3	0	0
8	7123010	.	A	G	11	17	28	0	0	28	0	0
8	7123014	.	A	G	22	5	27	0	3	30	0	0
8	7740078	.	A	G	6	8	14	0	2	16	0	0
8	7742196	.	C	T	18	7	25	0	2	27	0	0
8	7745898	.	G	A	14	11	25	0	0	25	0	0
8	7745907	.	T	C	16	10	26	0	1	27	0	0
8	7746030	.	C	T	18	14	32	0	0	32	0	0
8	7747613	.	A	G	21	0	21	0	9	30	0	0
8	7747616	.	C	T	21	12	33	0	0	33	0	0
8	7754289	.	C	T	9	7	16	0	0	16	0	0
8	7765230	.	G	A	2	15	17	0	19	36	0	0
8	7772097	.	C	T	20	12	32	0	1	34	1	0
8	7778832	.	T	C	3	3	6	0	0	6	0	0
8	7854167	.	G	C	5	4	9	0	0	9	0	0
8	7854194	.	C	G	5	4	9	0	0	9	0	0
8	7854236	.	G	T	1	2	3	0	5	8	0	0
8	7854247	.	T	C	4	2	6	0	0	6	0	0
8	7855697	.	G	T	0	7	7	0	7	14	0	0
8	7855888	.	G	A	0	2	2	0	6	8	0	0
8	7857369	.	A	G	6	0	6	0	9	15	0	0
8	7857378	.	T	C	5	12	17	0	0	17	0	0
8	7860547	.	A	C	6	6	12	0	0	12	0	0
8	7863603	.	C	T	6	10	16	0	0	16	0	0
8	7863747	.	T	C	9	6	15	0	0	15	0	0
8	7872053	.	A	T	9	3	12	0	2	14	0	0
8	7872056	.	C	T	10	3	13	0	0	13	0	0
8	7880869	.	G	A	3	5	8	0	0	8	0	0
8	7880956	.	A	G	2	6	8	0	0	8	0	0
8	7889397	.	T	A	5	7	12	0	1	13	0	0
8	7891240	.	T	C	4	4	8	0	0	8	0	0
8	7891371	.	A	C	5	3	8	0	1	9	0	0
8	7891397	.	G	A	0	4	4	0	6	10	0	0
8	7892241	.	C	T	5	5	10	0	0	10	0	0
8	7902138	.	C	T	5	5	10	0	0	10	0	0
8	7903144	.	C	T	2	4	6	0	1	7	0	0
8	7907837	.	G	C	1	8	9	0	0	9	0	0
8	7908417	.	C	A	1	5	6	0	0	6	0	0
8	7909000	.	C	T	1	2	3	0	0	3	0	0
8	7910035	.	G	A	2	1	3	0	0	3	0	0
8	7910050	.	C	T	2	3	5	0	0	5	0	0
8	7910107	.	T	C	1	5	6	0	1	7	0	0
8	7910605	.	C	A	1	2	3	0	0	3	0	0
8	7910611	.	A	T	1	2	3	0	0	3	0	0
8	7911746	.	A	C	1	3	4	0	0	4	0	0
8	7911749	.	C	T	2	3	5	0	0	5	0	0
8	7912216	.	A	C	5	9	14	0	0	14	0	0
8	7912267	.	C	G	3	1	4	0	8	12	0	0
8	7912394	.	G	A	10	8	18	0	0	18	0	0
8	8014683	.	T	A	2	3	5	0	0	5	0	0
8	8026005	.	T	C	1	4	5	0	1	6	0	0
8	8032391	.	C	A	4	3	7	0	0	7	0	0
8	8032540	.	G	C	2	7	9	0	1	10	0	0
8	8032918	.	T	C	1	4	5	0	0	5	0	0
8	8032945	.	A	G	2	6	8	0	0	8	0	0
8	8033275	.	G	A	1	3	4	0	11	15	0	0
8	8033290	.	A	G	15	5	20	0	0	20	0	0
8	8034876	.	A	G	11	0	11	0	4	15	0	0
8	8034912	.	A	G	6	0	6	0	5	11	0	0
8	8034933	.	A	C	5	2	7	0	0	7	0	0
8	8196284	.	G	A	0	2	2	0	1	3	0	0
8	8196623	.	T	C	1	3	4	0	0	4	0	0
8	8196827	.	C	G	2	3	5	0	0	5	0	0
8	8197097	.	T	A	4	3	7	0	0	7	0	0
8	8223411	.	G	A	0	2	2	0	2	4	0	0
8	8236101	.	G	C	3	4	7	0	0	7	0	0
8	8247328	.	G	A	5	2	7	0	0	7	0	0
8	8247412	.	T	C	3	2	5	0	1	6	0	0
8	8250814	.	T	G	4	0	4	0	3	7	0	0
8	8250970	.	A	G	3	0	3	0	5	8	0	0
8	8253355	.	G	A	5	3	8	0	0	8	0	0
8	8253412	.	C	T	2	2	4	0	0	4	0	0
8	8257329	.	T	G	4	0	4	0	5	9	0	0
8	8263614	.	C	T	5	4	9	0	0	9	0	0
8	8263677	.	C	T	5	4	9	0	0	9	0	0
8	8263732	.	T	C	5	4	9	0	0	9	0	0
8	8270610	.	A	T	6	2	8	0	0	8	0	0
8	8282233	.	G	C	2	4	6	0	0	6	0	0
8	8282259	.	T	A	2	3	5	0	0	5	0	0
8	8282518	.	C	T	3	2	5	0	0	5	0	0
8	8298291	.	A	G	11	16	27	0	3	30	0	0
8	8298472	.	C	T	15	16	31	0	0	31	0	0
8	8301910	.	A	G	5	4	9	0	0	9	0	0
8	8301913	.	T	A	5	4	9	0	0	9	0	0
8	8325553	.	T	A	7	9	16	0	2	18	0	0
8	8331823	.	A	T	14	8	22	0	1	23	0	0
8	8334428	.	C	T	8	5	13	0	1	14	0	0
8	8338969	.	C	T	7	6	13	0	2	15	0	0
8	8341313	.	T	C	6	4	10	0	1	11	0	0
8	8341340	.	A	C	8	4	12	0	1	13	0	0
8	8341383	.	T	C	6	11	17	0	0	17	0	0
8	8341486	.	A	C	1	7	8	0	1	9	0	0
8	8341617	.	A	C	5	9	14	0	0	14	0	0
8	8341619	.	T	C	5	0	5	0	9	14	0	0
8	8343217	.	T	G	6	16	22	0	0	22	0	0
8	8362684	.	G	A	14	9	23	0	1	24	0	0
8	8363058	.	C	T	0	4	4	0	3	7	0	0
8	8389011	.	A	G	7	11	18	0	0	18	0	0
8	8390797	.	A	G	5	9	14	0	0	14	0	0
8	8391508	.	A	G	6	5	11	0	0	11	0	0
8	8394495	.	A	C	7	10	17	0	0	17	0	0
8	8426432	.	A	G	4	8	12	0	0	12	0	0
8	8446197	.	C	T	0	11	11	0	10	21	0	0
8	8446343	.	T	A	14	12	26	0	2	28	0	0
8	8475010	.	T	C	3	3	6	0	0	6	0	0
8	8478746	.	G	A	1	4	5	0	4	9	0	0
8	8478751	.	C	A	5	3	8	0	1	9	0	0
8	8478819	.	A	G	6	2	8	0	3	11	0	0
8	8478861	.	C	T	4	3	7	0	0	7	0	0
8	8478862	.	T	C	4	3	7	0	0	7	0	0
8	8478921	.	A	C	1	3	4	0	0	4	0	0
8	8484032	.	G	A	1	2	3	0	0	3	0	0
8	8484269	.	A	G	5	4	9	0	0	9	0	0
8	8484275	.	A	G	6	5	11	0	0	11	0	0
8	8486783	.	G	A	4	5	9	0	1	10	0	0
8	8486882	.	G	A	1	4	5	0	1	6	0	0
8	8489342	.	C	G	4	5	9	0	0	9	0	0
8	8532417	.	A	G	3	0	3	0	6	9	0	0
8	8532879	.	C	A	2	2	4	0	0	4	0	0
8	8575352	.	C	T	2	4	6	0	0	6	0	0
8	8579618	.	A	C	3	6	9	0	0	9	0	0
8	8605950	.	T	C	10	7	17	0	2	19	0	0
8	8606067	.	C	T	10	5	15	0	1	16	0	0
8	8606070	.	C	T	10	5	15	0	0	15	0	0
8	8686442	.	T	C	1	2	3	0	0	3	0	0
8	8695935	.	G	T	1	2	3	0	0	3	0	0
8	8699163	.	A	T	3	2	5	0	2	7	0	0
8	8699174	.	T	A	4	2	6	0	1	7	0	0
8	8699211	.	C	T	5	3	8	0	0	8	0	0
8	8699235	.	G	A	6	6	12	0	0	12	0	0
8	8704215	.	C	T	1	4	5	0	1	6	0	0
8	8704274	.	A	G	1	0	1	0	2	3	0	0
8	8704377	.	G	C	2	3	5	0	0	5	0	0
8	8729278	.	C	G	9	5	14	0	1	15	0	0
8	8729308	.	T	A	7	7	14	0	1	16	1	0
8	8735644	.	T	C	10	13	23	0	1	24	0	0
8	8735698	.	C	A	15	11	26	0	0	26	0	0
8	8846132	.	C	T	7	5	12	0	0	12	0	0
8	8846924	.	G	A	12	10	22	0	1	23	0	0
8	8847410	.	A	G	10	7	17	0	0	17	0	0
8	8847434	.	A	C	10	3	13	0	2	15	0	0
8	8847461	.	A	G	7	0	7	0	8	15	0	0
8	8847593	.	T	C	15	7	22	0	1	23	0	0
8	8847676	.	G	C	15	21	36	0	0	36	0	0
8	8847788	.	A	C	13	17	30	0	2	32	0	0
8	8847857	.	T	C	9	14	23	1	1	25	0	0
8	8847860	.	T	C	10	14	24	1	0	25	0	0
8	8847893	.	A	T	8	9	17	1	3	21	0	0
8	8861240	.	G	A	0	11	11	0	12	23	0	0
8	8905416	.	T	C	14	11	25	0	1	26	0	0
8	8914899	.	T	C	15	12	27	0	2	29	0	0
8	8922367	.	T	A	14	16	30	0	1	31	0	0
8	8957226	.	G	T	1	2	3	0	0	3	0	0
8	8957424	.	G	A	4	4	8	0	1	9	0	0
8	8974572	.	G	A	1	22	23	0	15	38	0	0
8	8975926	.	T	C	10	18	28	0	0	28	0	0
8	8975929	.	T	C	8	17	25	0	1	26	0	0
8	8993240	.	A	G	26	10	36	0	0	36	0	0
8	9011843	.	G	A	16	22	38	0	0	38	0	0
8	9015855	.	A	G	17	20	37	0	3	40	0	0
8	9015894	.	G	C	10	18	28	0	3	31	0	0
8	9028945	.	G	A	1	14	15	0	17	32	0	0
8	9029076	.	A	G	11	12	23	0	0	23	0	0
8	9052184	.	A	T	14	19	33	0	0	33	0	0
8	9059491	.	C	T	12	7	19	1	1	21	0	0
8	9076296	.	T	C	11	14	25	0	2	27	0	0
8	9076389	.	C	T	2	7	9	0	16	25	0	0
8	9092466	.	A	G	16	12	28	0	0	28	0	0
8	9222894	.	G	A	7	15	22	0	2	24	0	0
8	9222988	.	G	C	13	13	26	0	1	28	1	0
8	9223044	.	A	G	18	18	36	0	0	36	0	0
8	9231039	.	T	C	11	0	11	0	13	24	0	0
8	9231054	.	C	T	11	10	21	0	0	21	0	0
8	9234574	.	G	A	9	15	24	0	0	24	0	0
8	9267615	.	G	C	10	5	15	0	0	15	0	0
8	9270038	.	A	G	16	8	24	0	1	25	0	0
8	9270041	.	G	A	16	9	25	0	0	25	0	0
8	9275102	.	G	A	13	10	23	0	1	24	0	0
8	9280529	.	G	A	7	8	15	0	1	16	0	0
8	9369304	.	A	G	4	8	12	0	0	12	0	0
8	9369382	.	A	G	7	4	11	0	0	11	0	0
8	9369390	.	A	G	6	4	10	0	0	10	0	0
8	9394977	.	C	T	11	10	21	0	1	22	0	0
8	9444568	.	T	C	8	8	16	0	0	16	0	0
8	9532683	.	A	G	8	6	14	0	1	15	0	0
8	9543159	.	G	T	3	3	6	0	0	6	0	0
8	9543482	.	C	T	6	7	13	0	0	13	0	0
8	9543704	.	G	A	5	6	11	1	0	12	0	0
8	9570386	.	A	C	1	5	6	0	0	6	0	0
8	9699182	.	G	C	5	3	8	0	0	8	0	0
8	9699228	.	A	C	5	4	9	0	0	9	0	0
8	9700176	.	G	T	2	6	8	0	5	13	0	0
8	9704537	.	T	C	5	4	9	0	0	9	0	0
8	9704548	.	T	C	6	5	11	0	1	12	0	0
8	9709591	.	T	C	7	5	12	0	1	13	0	0
8	9709653	.	G	C	3	4	7	0	0	7	0	0
8	9716087	.	C	G	11	5	16	0	0	16	0	0
8	9716114	.	G	A	10	6	16	0	1	17	0	0
8	9731233	.	A	G	8	12	20	0	0	20	0	0
8	9736134	.	A	G	11	9	20	0	1	21	0	0
8	9736287	.	G	A	12	7	19	0	0	19	0	0
8	9748864	.	A	G	7	12	19	0	0	19	0	0
8	9755356	.	T	G	10	19	29	1	0	30	0	0
8	9761116	.	A	C	8	10	18	0	0	18	0	0
8	9781903	.	G	A	12	8	20	0	0	20	0	0
8	9791577	.	G	A	0	11	11	0	12	23	0	0
8	9791902	.	T	C	13	6	19	0	0	19	0	0
8	9791976	.	T	C	10	8	18	0	0	18	0	0
8	9792083	.	C	G	4	3	7	0	0	7	0	0
8	9867301	.	C	G	5	0	5	0	7	12	0	0
8	9867459	.	T	C	3	7	10	0	0	10	0	0
8	9867477	.	T	C	3	6	9	0	0	9	0	0
8	9867514	.	G	A	1	5	6	0	5	11	0	0
8	9867540	.	A	T	4	7	11	0	0	11	0	0
8	9867564	.	T	A	6	6	12	0	0	12	0	0
8	9867730	.	C	T	4	6	10	0	1	11	0	0
8	9867790	.	A	G	4	7	11	0	1	12	0	0
8	9867823	.	G	A	5	11	16	0	0	16	0	0
8	9867838	.	A	G	5	11	16	0	0	16	0	0
8	9867902	.	G	A	5	10	15	0	1	16	0	0
8	9868004	.	C	T	7	6	13	0	0	13	0	0
8	9868310	.	A	G	5	5	10	0	2	12	0	0
8	9868973	.	G	A	0	7	7	0	3	10	0	0
8	9961673	.	T	C	4	6	10	0	0	10	0	0
8	9985374	.	A	G	20	8	28	0	2	30	0	0
8	9985458	.	T	C	8	10	18	0	1	19	0	0
8	10305260	.	C	T	12	14	26	0	1	27	0	0
8	10306061	.	C	T	12	23	35	0	0	35	0	0
8	10306283	.	T	C	16	11	27	0	0	27	0	0
8	10307170	.	C	T	19	21	40	0	0	40	0	0
8	10307686	.	G	T	22	10	32	0	2	34	0	0
8	10307924	.	G	A	14	7	21	0	2	23	0	0
8	10308278	.	G	T	15	19	34	2	0	36	0	0
8	10340023	.	C	A	3	2	5	0	0	5	0	0
8	10369089	.	T	C	4	2	6	0	0	6	0	0
8	10404778	.	A	C	1	2	3	0	0	3	0	0
8	10425096	.	C	T	1	3	4	0	0	4	0	0
8	10562144	.	C	T	11	7	18	0	0	18	0	0
8	10562198	.	A	G	5	10	15	0	0	15	0	0
8	10562400	.	A	C	12	9	21	0	1	22	0	0
8	10823080	.	G	A	1	8	9	0	1	10	0	0
8	10823100	.	G	C	6	11	17	0	2	19	0	0
8	10835439	.	A	G	7	3	10	0	0	10	0	0
8	10848266	.	T	G	3	0	3	0	7	10	0	0
8	10852169	.	T	A	7	4	11	0	1	12	0	0
8	10856107	.	A	G	9	3	12	0	0	12	0	0
8	10856915	.	T	C	6	2	8	0	0	8	0	0
8	10862635	.	C	A	10	6	16	0	0	16	0	0
8	10869215	.	T	C	4	6	10	0	0	10	0	0
8	10870010	.	A	G	2	2	4	0	0	4	0	0
8	10870571	.	C	A	4	5	9	0	0	9	0	0
8	10879223	.	C	A	3	5	8	0	2	10	0	0
8	10882708	.	T	C	2	8	10	0	1	11	0	0
8	10884375	.	G	A	0	9	9	0	5	14	0	0
8	10884489	.	T	C	10	8	18	0	1	19	0	0
8	10884492	.	C	T	8	8	16	0	1	17	0	0
8	10890056	.	G	A	1	5	6	0	9	15	0	0
8	10890079	.	C	T	11	8	19	0	0	19	0	0
8	10890169	.	T	C	14	6	20	0	0	20	0	0
8	10890318	.	T	C	5	6	11	0	1	12	0	0
8	10890325	.	C	G	6	0	6	0	6	12	0	0
8	10895135	.	T	A	7	5	12	0	0	12	0	0
8	10895162	.	G	A	5	3	8	0	1	9	0	0
8	10937696	.	A	T	2	2	4	0	1	5	0	0
8	10949833	.	G	A	3	3	6	0	0	6	0	0
8	10949838	.	T	A	3	3	6	0	0	6	0	0
8	10956561	.	G	T	4	2	6	0	0	6	0	0
8	10957168	.	A	C	12	0	12	0	12	24	0	0
8	10969651	.	T	A	5	6	11	0	0	11	0	0
8	10969694	.	C	T	5	7	12	0	3	15	0	0
8	10978101	.	A	G	15	12	27	0	3	30	0	0
8	10980909	.	A	G	10	8	18	0	0	18	0	0
8	10981277	.	A	T	3	6	9	0	1	10	0	0
8	10987348	.	A	G	8	8	16	0	0	16	0	0
8	10987621	.	G	A	4	7	11	0	0	11	0	0
8	10988963	.	A	G	7	9	16	0	1	17	0	0
8	10991498	.	C	T	0	6	6	0	3	9	0	0
8	11004454	.	T	A	0	5	5	0	12	17	0	0
8	11004484	.	C	A	1	6	7	0	14	21	0	0
8	11004549	.	C	T	17	8	25	0	1	26	0	0
8	11004597	.	G	T	15	9	24	0	0	24	0	0
8	11004625	.	A	G	16	6	22	0	5	27	0	0
8	11004652	.	T	A	21	12	33	0	0	33	0	0
8	11009117	.	T	C	5	10	15	0	0	15	0	0
8	11010146	.	C	T	11	14	25	0	2	27	0	0
8	11010149	.	T	C	12	13	25	0	1	26	0	0
8	11016720	.	A	C	3	8	11	0	0	11	0	0
8	11019138	.	T	C	3	0	3	0	3	6	0	0
8	11019273	.	A	T	7	3	10	0	0	10	0	0
8	11028031	.	T	C	3	2	5	0	1	6	0	0
8	11036882	.	A	G	3	8	11	0	1	12	0	0
8	11036904	.	C	A	4	5	9	0	1	10	0	0
8	11039055	.	G	A	3	3	6	0	0	6	0	0
8	11055988	.	A	G	2	3	5	0	0	5	0	0
8	11055994	.	G	A	2	3	5	0	0	5	0	0
8	11066361	.	T	C	1	0	1	0	2	3	0	0
8	11066862	.	C	T	1	2	3	0	0	3	0	0
8	11067152	.	G	A	4	4	8	0	0	8	0	0
8	11067186	.	A	C	1	3	4	0	0	4	0	0
8	11076871	.	C	T	1	2	3	0	0	3	0	0
8	11077059	.	A	T	1	2	3	0	0	3	0	0
8	11088352	.	G	A	1	3	4	0	0	4	0	0
8	11115005	.	A	T	3	2	5	0	0	5	0	0
8	11115372	.	G	T	3	2	5	0	0	5	0	0
8	11115687	.	T	C	1	4	5	0	0	5	0	0
8	11131560	.	G	C	1	4	5	0	0	5	0	0
8	11136791	.	G	A	7	5	12	0	0	12	0	0
8	11139954	.	C	G	9	10	19	0	1	20	0	0
8	11141807	.	C	T	6	2	8	0	0	8	0	0
8	11144820	.	T	C	4	0	4	0	4	8	0	0
8	11146856	.	T	C	5	7	12	0	0	12	0	0
8	11146883	.	T	G	6	12	18	0	1	19	0	0
8	11180115	.	G	C	10	11	21	0	0	21	0	0
8	11182273	.	G	A	6	7	13	0	0	13	0	0
8	11182825	.	G	A	3	8	11	0	1	12	0	0
8	11182873	.	G	A	3	9	12	0	1	13	0	0
8	11183130	.	T	A	2	7	9	0	0	9	0	0
8	11183262	.	T	A	8	7	15	0	2	17	0	0
8	11183284	.	T	G	11	5	16	0	1	17	0	0
8	11183773	.	T	G	6	3	9	0	1	10	0	0
8	11183817	.	C	G	2	6	8	0	6	14	0	0
8	11183892	.	T	A	6	7	13	0	2	15	0	0
8	11183943	.	A	T	14	9	23	0	0	23	0	0
8	11184230	.	G	A	5	5	10	0	0	10	0	0
8	11184413	.	C	A	3	6	9	0	0	9	0	0
8	11184609	.	T	G	2	5	7	0	0	7	0	0
8	11184623	.	T	C	2	6	8	0	0	8	0	0
8	11185286	.	C	T	4	10	14	0	0	14	0	0
8	11185371	.	T	C	9	3	12	0	0	12	0	0
8	11189059	.	A	G	4	3	7	0	0	7	0	0
8	11189275	.	A	G	4	6	10	0	0	10	0	0
8	11189290	.	A	G	6	6	12	0	0	12	0	0
8	11190085	.	G	A	6	2	8	0	0	8	0	0
8	11190263	.	T	G	5	4	9	0	0	9	0	0
8	11190319	.	T	C	4	0	4	0	3	7	0	0
8	11190403	.	A	T	6	11	17	0	0	17	0	0
8	11190496	.	C	G	2	5	7	0	0	7	0	0
8	11191006	.	A	C	1	2	3	0	0	3	0	0
8	11191097	.	C	T	3	6	9	0	1	10	0	0
8	11191263	.	C	T	2	4	6	0	0	6	0	0
8	11191694	.	A	G	1	5	6	0	0	6	0	0
8	11201802	.	G	A	3	3	6	0	0	6	0	0
8	11201986	.	G	T	2	5	7	0	0	7	0	0
8	11201995	.	T	G	2	5	7	0	0	7	0	0
8	11202290	.	A	G	1	2	3	0	0	3	0	0
8	11202300	.	G	A	1	2	3	0	0	3	0	0
8	11204295	.	C	T	1	3	4	0	0	4	0	0
8	11204321	.	A	G	1	2	3	0	0	3	0	0
8	11204365	.	C	A	2	3	5	0	0	5	0	0
8	11204441	.	C	T	1	2	3	4	1	8	0	0
8	11204533	.	A	G	2	5	7	0	0	7	0	0
8	11207204	.	G	A	2	6	8	0	0	8	0	0
8	11209538	.	G	A	2	3	5	0	0	5	0	0
8	11209559	.	G	A	2	1	3	0	1	4	0	0
8	11209601	.	G	A	2	3	5	0	0	5	0	0
8	11234333	.	A	C	0	0	0	0	5	5	0	0
8	11234334	.	T	G	1	4	5	0	0	5	0	0
8	11234489	.	T	C	4	0	4	0	5	9	0	0
8	11234522	.	T	G	5	10	15	0	0	15	0	0
8	11234573	.	A	G	5	6	11	0	0	11	0	0
8	11234678	.	G	A	3	3	6	0	0	6	0	0
8	11241284	.	A	T	4	5	9	0	2	11	0	0
8	11245918	.	C	T	2	9	11	0	1	12	0	0
8	11245967	.	A	G	3	11	14	0	1	15	0	0
8	11246006	.	G	A	2	11	13	0	0	13	0	0
8	11250740	.	A	T	5	7	12	0	0	12	0	0
8	11268717	.	A	T	4	8	12	0	0	12	0	0
8	11268807	.	G	A	4	8	12	0	0	12	0	0
8	11327947	.	C	G	4	6	10	0	0	10	0	0
8	11329595	.	G	A	1	2	3	0	5	8	0	0
8	11337395	.	C	T	2	4	6	0	0	6	0	0
8	11337614	.	G	A	4	3	7	0	0	7	0	0
8	11337627	.	G	A	3	4	7	0	0	7	0	0
8	11338550	.	A	G	1	0	1	0	4	5	0	0
8	11338552	.	A	G	0	0	0	0	5	5	0	0
8	11338934	.	A	T	6	6	12	0	0	12	0	0
8	11338941	.	G	A	0	7	7	0	6	13	0	0
8	11339307	.	T	C	4	5	9	0	0	9	0	0
8	11488414	.	C	T	13	15	28	0	1	29	0	0
8	11488468	.	C	T	20	12	32	0	1	33	0	0
8	11491308	.	A	G	16	8	24	0	1	25	0	0
8	11491347	.	G	C	2	12	14	0	10	24	0	0
8	11504174	.	T	A	5	2	7	1	0	8	0	0
8	11511403	.	C	T	10	5	15	0	0	15	0	0
8	11513517	.	A	G	7	10	17	0	1	18	0	0
8	11521110	.	A	T	8	10	18	0	2	20	0	0
8	11521244	.	A	G	9	5	14	0	0	14	0	0
8	11535261	.	A	G	10	12	22	0	1	23	0	0
8	11541880	.	T	C	7	11	18	0	0	18	0	0
8	11542207	.	C	G	2	6	8	0	0	8	0	0
8	11546047	.	A	C	5	3	8	0	0	8	0	0
8	11546062	.	G	T	4	2	6	0	0	6	0	0
8	11548311	.	G	T	2	4	6	0	1	7	0	0
8	11548419	.	A	G	3	2	5	0	0	5	0	0
8	11588953	.	C	A	4	7	11	0	0	11	0	0
8	11590976	.	G	A	8	7	15	0	0	15	0	0
8	11642293	.	T	A	3	5	8	0	0	8	0	0
8	11642357	.	T	C	1	2	3	0	0	3	0	0
8	11661708	.	C	T	6	7	13	0	0	13	0	0
8	11673220	.	C	A	2	3	5	0	0	5	0	0
8	11680661	.	T	A	1	2	3	0	0	3	0	0
8	11681078	.	G	A	2	3	5	0	0	5	0	0
8	11681128	.	T	C	4	2	6	0	0	6	0	0
8	11681215	.	A	G	1	0	1	0	2	3	0	0
8	11681227	.	A	G	2	1	3	0	0	3	0	0
8	11722187	.	T	C	2	12	14	0	0	14	0	0
8	11724237	.	T	C	4	3	7	0	0	7	0	0
8	11737826	.	T	C	4	2	6	0	0	6	0	0
8	11737937	.	A	G	3	3	6	0	0	6	0	0
8	11740220	.	T	C	11	10	21	0	0	21	0	0
8	11740370	.	G	A	7	13	20	0	0	20	0	0
8	11744619	.	A	G	3	6	9	0	1	10	0	0
8	11744660	.	A	G	3	5	8	0	1	9	0	0
8	11744723	.	T	G	1	7	8	0	0	8	0	0
8	11744810	.	G	A	2	4	6	0	0	6	0	0
8	11746647	.	A	G	1	4	5	0	0	5	0	0
8	11746759	.	G	A	9	8	17	0	0	17	0	0
8	11752672	.	T	A	2	5	7	0	0	7	0	0
8	11756494	.	C	T	3	4	7	0	0	7	0	0
8	11757121	.	T	C	4	3	7	0	0	7	0	0
8	11757139	.	T	C	3	3	6	0	1	7	0	0
8	11761829	.	T	A	7	7	14	0	0	15	1	0
8	11761862	.	T	C	7	0	7	0	5	12	0	0
8	11770033	.	T	A	7	4	11	0	0	11	0	0
8	11789554	.	T	C	2	2	4	0	1	5	0	0
8	11789587	.	G	A	1	3	4	0	0	4	0	0
8	11794663	.	C	T	4	6	10	0	0	10	0	0
8	11831881	.	A	G	5	4	9	0	0	9	0	0
8	11832709	.	G	T	1	2	3	0	0	3	0	0
8	11884842	.	A	G	2	2	4	0	0	4	0	0
8	11884857	.	C	T	0	4	4	0	3	7	0	0
8	11885082	.	T	C	8	7	15	0	0	15	0	0
8	11985228	.	A	G	7	10	17	0	0	17	0	0
8	12016451	.	T	C	13	10	23	0	2	25	0	0
8	12016553	.	G	A	7	5	12	0	0	12	0	0
8	12118473	.	A	G	7	3	10	0	0	10	0	0
8	12121766	.	C	T	15	4	19	0	0	19	0	0
8	12121893	.	C	T	6	3	9	0	1	10	0	0
8	12135193	.	A	G	6	13	19	0	3	22	0	0
8	12135196	.	T	C	7	16	23	0	1	24	0	0
8	12142180	.	T	A	12	8	20	0	1	21	0	0
8	12149688	.	C	T	8	10	18	0	0	18	0	0
8	12149865	.	G	T	12	13	25	0	2	27	0	0
8	12150471	.	C	T	9	9	18	0	1	19	0	0
8	12150480	.	A	G	8	8	16	0	0	16	0	0
8	12156204	.	C	T	5	6	11	0	0	11	0	0
8	12183187	.	T	C	6	0	6	0	10	16	0	0
8	12209354	.	C	G	4	4	8	0	0	8	0	0
8	12452284	.	C	T	0	5	5	0	11	16	0	0
8	12521420	.	A	G	9	8	17	0	0	17	0	0
8	12574533	.	A	G	10	7	17	0	0	17	0	0
8	12601513	.	G	A	11	9	20	1	0	21	0	0
8	12668578	.	G	T	3	6	9	0	1	10	0	0
8	12668714	.	C	T	4	7	11	0	1	12	0	0
8	12925505	.	T	C	12	7	19	0	1	20	0	0
8	12932734	.	G	A	9	16	25	0	0	25	0	0
8	12935793	.	A	G	7	0	7	0	8	15	0	0
8	12935799	.	T	C	8	8	16	0	0	16	0	0
8	12935844	.	C	T	9	9	18	0	0	18	0	0
8	12936041	.	A	G	4	0	4	0	7	11	0	0
8	12936857	.	A	C	7	14	21	0	1	22	0	0
8	12937147	.	T	C	5	11	16	0	0	16	0	0
8	12951260	.	C	G	2	3	5	0	0	5	0	0
8	12951524	.	G	T	0	2	2	0	2	4	0	0
8	12962712	.	T	C	2	4	6	0	1	7	0	0
8	12991628	.	C	T	2	3	5	0	0	5	0	0
8	12994619	.	C	T	4	3	7	0	0	7	0	0
8	13006414	.	A	G	3	5	8	0	0	8	0	0
8	13068237	.	A	T	8	13	21	0	0	21	0	0
8	13068315	.	C	T	11	14	25	0	1	26	0	0
8	13093662	.	G	A	13	9	22	0	1	23	0	0
8	13093677	.	C	T	15	8	23	0	1	24	0	0
8	13094216	.	A	G	11	8	19	0	1	20	0	0
8	13094340	.	C	T	7	7	14	0	2	16	0	0
8	13097535	.	C	T	4	8	12	0	6	18	0	0
8	13097538	.	C	A	4	15	19	0	0	19	0	0
8	13132374	.	G	C	1	2	3	0	0	3	0	0
8	13132375	.	C	A	1	2	3	0	0	3	0	0
8	13136913	.	C	T	1	3	4	0	0	4	0	0
8	13137009	.	C	T	3	2	5	0	0	5	0	0
8	13153691	.	T	C	1	2	3	0	0	3	0	0
8	13153694	.	T	C	1	3	4	0	0	4	0	0
8	13157541	.	C	G	1	0	1	0	3	4	0	0
8	13157718	.	C	T	2	3	5	0	0	5	0	0
8	13157719	.	A	C	2	3	5	0	0	5	0	0
8	13157817	.	T	C	5	3	8	0	0	8	0	0
8	13157827	.	A	C	5	3	8	0	0	8	0	0
8	13158453	.	T	C	3	2	5	0	0	5	0	0
8	13158454	.	C	T	3	2	5	0	0	5	0	0
8	13158766	.	T	A	2	2	4	0	0	4	0	0
8	13159401	.	A	C	4	3	7	0	0	7	0	0
8	13159411	.	G	A	4	2	6	0	0	6	0	0
8	13161999	.	A	G	6	4	10	0	0	10	0	0
8	13162008	.	T	C	6	5	11	0	1	12	0	0
8	13192061	.	T	C	8	8	16	0	0	16	0	0
8	13194912	.	C	T	1	10	11	0	13	24	0	0
8	13207577	.	G	A	5	5	10	0	0	10	0	0
8	13210853	.	G	A	7	6	13	0	0	13	0	0
8	13211089	.	C	A	1	6	7	0	3	10	0	0
8	13211198	.	A	G	6	3	9	0	0	9	0	0
8	13244683	.	T	C	1	5	6	0	1	7	0	0
8	13352100	.	C	A	1	18	19	0	15	34	0	0
8	13352103	.	T	A	14	19	33	0	1	34	0	0
8	13352166	.	T	C	22	17	39	0	1	40	0	0
8	13352318	.	G	A	23	14	37	0	1	38	0	0
8	13352428	.	A	G	25	27	52	0	3	55	0	0
8	13355949	.	C	T	20	22	42	0	0	42	0	0
8	13362699	.	T	C	26	27	53	0	3	56	0	0
8	13364868	.	T	C	8	5	13	0	0	13	0	0
8	13382258	.	G	T	1	2	3	0	0	3	0	0
8	13630677	.	G	T	2	3	5	0	1	6	0	0
8	13643998	.	A	T	2	3	5	0	0	5	0	0
8	13644051	.	A	T	2	4	6	0	0	6	0	0
8	13644084	.	G	A	2	6	8	0	0	8	0	0
8	13779556	.	C	T	8	7	15	0	0	15	0	0
8	13779604	.	T	C	11	11	22	0	0	22	0	0
8	13782862	.	C	G	13	4	17	0	0	17	0	0
8	13782902	.	C	A	14	6	20	0	0	20	0	0
8	13784177	.	A	G	13	6	19	0	0	19	0	0
8	13784180	.	G	A	13	7	20	0	0	20	0	0
8	13784231	.	A	G	23	8	31	0	1	32	0	0
8	13784288	.	A	T	22	13	35	0	1	36	0	0
8	13786944	.	G	C	25	10	35	0	1	36	0	0
8	13787093	.	G	A	0	7	7	0	9	16	0	0
8	13787132	.	G	A	11	5	16	0	0	16	0	0
8	13787150	.	A	T	13	3	16	0	0	16	0	0
8	13787310	.	T	G	9	6	15	0	0	15	0	0
8	13787345	.	G	A	11	5	16	0	0	16	0	0
8	13787528	.	G	A	11	9	20	0	1	21	0	0
8	13852774	.	C	T	24	16	40	0	3	43	0	0
8	13852795	.	T	C	23	17	40	0	4	44	0	0
8	13852864	.	T	C	22	17	39	0	3	42	0	0
8	13852930	.	G	A	21	12	33	0	5	38	0	0
8	13853026	.	C	T	15	17	32	0	2	34	0	0
8	13910234	.	C	A	18	15	33	2	1	36	0	0
8	13944193	.	T	C	23	21	44	1	2	47	0	0
8	13991564	.	A	C	2	2	4	0	0	4	0	0
8	13991828	.	G	A	4	5	9	0	0	9	0	0
8	13991875	.	C	A	1	3	4	0	1	5	0	0
8	13993704	.	A	G	2	6	8	0	0	8	0	0
8	13998361	.	A	C	8	0	8	0	5	13	0	0
8	13998502	.	C	A	1	3	4	0	0	4	0	0
8	14003374	.	G	A	32	25	57	0	2	59	0	0
8	14012346	.	C	T	3	23	26	0	31	57	0	0
8	14018790	.	C	T	25	30	55	0	3	58	0	0
8	14020571	.	A	G	25	27	52	0	1	53	0	0
8	14027241	.	A	C	31	18	49	2	3	54	0	0
8	14041319	.	A	G	32	25	57	0	2	59	0	0
8	14043810	.	A	G	28	27	55	0	5	60	0	0
8	14049333	.	A	C	21	22	43	0	2	45	0	0
8	14049447	.	G	A	23	27	50	0	3	53	0	0
8	14049462	.	A	G	25	31	56	0	0	56	0	0
8	14049641	.	G	A	31	25	56	0	2	58	0	0
8	14049702	.	T	C	30	29	59	0	1	60	0	0
8	14063418	.	T	A	12	4	16	0	1	17	0	0
8	14063639	.	G	A	4	2	6	0	0	6	0	0
8	14063644	.	G	A	3	3	6	0	1	7	0	0
8	14064253	.	T	A	2	5	7	0	0	7	0	0
8	14064374	.	G	A	8	4	12	0	0	12	0	0
8	14064441	.	C	A	5	3	8	0	0	8	0	0
8	14070490	.	T	C	18	8	26	0	1	27	0	0
8	14075809	.	C	T	14	14	28	0	1	29	0	0
8	14076247	.	G	A	10	12	22	0	1	23	0	0
8	14076340	.	T	G	11	10	21	0	3	24	0	0
8	14133855	.	G	A	1	3	4	0	0	4	0	0
8	14134678	.	G	T	2	3	5	0	0	5	0	0
8	14163845	.	A	G	11	6	17	0	1	18	0	0
8	14170428	.	C	A	7	4	11	0	2	13	0	0
8	14170546	.	A	T	5	2	7	0	0	7	0	0
8	14170712	.	C	T	12	16	28	0	2	30	0	0
8	14170789	.	A	T	14	15	29	0	0	29	0	0
8	14170863	.	C	A	15	4	19	0	0	19	0	0
8	14171076	.	A	T	33	25	58	0	2	60	0	0
8	14171346	.	T	C	12	26	38	0	1	39	0	0
8	14171414	.	G	A	14	30	44	0	0	44	0	0
8	14171660	.	T	C	25	26	51	0	3	54	0	0
8	14171825	.	C	T	3	14	17	0	19	36	0	0
8	14171875	.	G	T	28	24	52	0	1	54	1	0
8	14171955	.	T	C	20	20	40	0	0	40	0	0
8	14172113	.	A	T	29	18	47	0	1	48	0	0
8	14174231	.	G	A	30	24	54	1	0	55	0	0
8	14176574	.	T	C	22	23	45	0	1	46	0	0
8	14176592	.	A	G	18	26	44	0	3	47	0	0
8	14184198	.	C	T	2	10	12	0	36	48	0	0
8	14184246	.	A	G	17	26	43	0	0	43	0	0
8	14211960	.	A	G	4	3	7	0	1	8	0	0
8	14212264	.	T	G	2	5	7	0	0	7	0	0
8	14212545	.	T	C	7	0	7	0	9	16	0	0
8	14212676	.	A	G	5	9	14	0	1	15	0	0
8	14213303	.	T	C	10	9	19	0	0	19	0	0
8	14217986	.	T	C	7	7	14	0	1	15	0	0
8	14219756	.	C	T	0	5	5	0	7	12	0	0
8	14225269	.	G	A	9	7	16	0	0	16	0	0
8	14228320	.	G	A	3	3	6	0	0	6	0	0
8	14229557	.	A	G	5	4	9	1	0	10	0	0
8	14238810	.	G	A	6	3	9	0	0	9	0	0
8	14238826	.	C	T	3	2	5	0	1	6	0	0
8	14244494	.	A	G	28	20	48	0	1	49	0	0
8	14246405	.	G	A	34	18	52	0	2	54	0	0
8	14246411	.	A	G	33	18	51	0	1	52	0	0
8	14247431	.	A	G	23	12	35	0	1	36	0	0
8	14250036	.	C	T	17	10	27	0	1	28	0	0
8	14250063	.	A	T	21	9	30	0	1	31	0	0
8	14272806	.	A	G	17	22	39	0	1	40	0	0
8	14275609	.	G	A	10	17	27	0	1	28	0	0
8	14278444	.	G	A	10	17	27	0	1	28	0	0
8	14375543	.	A	T	21	11	32	0	1	33	0	0
8	14375718	.	T	A	19	14	33	0	0	33	0	0
8	14375742	.	C	A	20	10	30	0	0	30	0	0
8	14375841	.	T	C	14	7	21	0	0	21	0	0
8	14375873	.	T	C	4	3	7	0	0	7	0	0
8	14384377	.	A	G	11	10	21	0	0	21	0	0
8	14388428	.	A	G	7	5	12	0	0	12	0	0
8	14388482	.	G	A	7	8	15	0	0	15	0	0
8	14439556	.	T	G	12	9	21	0	0	21	0	0
8	14440447	.	A	C	9	15	24	0	1	25	0	0
8	14440526	.	A	G	6	0	6	0	5	11	0	0
8	14440528	.	T	C	6	5	11	0	0	11	0	0
8	14440564	.	A	G	11	6	17	0	0	17	0	0
8	14440580	.	C	A	10	5	15	0	0	15	0	0
8	14441120	.	A	G	9	6	15	0	0	15	0	0
8	14441149	.	A	G	14	4	18	0	1	19	0	0
8	14441344	.	C	T	13	3	16	0	0	16	0	0
8	14441416	.	C	A	9	10	19	0	0	19	0	0
8	14441524	.	A	G	4	10	14	0	1	15	0	0
8	14441535	.	C	T	11	6	17	0	1	18	0	0
8	14441656	.	A	C	8	8	16	0	0	16	0	0
8	14441657	.	C	A	8	8	16	0	0	16	0	0
8	14454425	.	G	T	3	2	5	0	0	5	0	0
8	14455363	.	C	G	3	2	5	0	0	5	0	0
8	14560612	.	G	A	6	8	14	0	1	15	0	0
8	14561063	.	C	A	7	4	11	0	0	11	0	0
8	14561195	.	A	C	3	1	4	0	1	5	0	0
8	14564126	.	C	T	0	4	4	0	3	7	0	0
8	14564717	.	T	A	5	5	10	0	0	10	0	0
8	14564813	.	G	T	5	6	11	0	0	11	0	0
8	14565180	.	T	C	7	4	11	0	0	11	0	0
8	14565303	.	T	A	5	5	10	0	1	11	0	0
8	14565350	.	G	A	4	10	14	0	0	14	0	0
8	14565376	.	T	C	7	7	14	0	0	14	0	0
8	14565457	.	T	C	4	5	9	0	0	9	0	0
8	14565632	.	C	T	2	4	6	0	0	6	0	0
8	14565662	.	A	G	1	4	5	0	0	5	0	0
8	14565674	.	G	T	1	3	4	0	1	5	0	0
8	14565843	.	C	T	0	3	3	0	2	5	0	0
8	14565850	.	A	G	1	5	6	0	0	6	0	0
8	14566295	.	G	T	1	3	4	0	0	4	0	0
8	14566360	.	C	A	4	6	10	0	0	10	0	0
8	14566380	.	A	C	5	0	5	0	8	13	0	0
8	14568457	.	T	C	5	0	5	0	4	9	0	0
8	14568760	.	G	A	4	6	10	0	0	10	0	0
8	14571008	.	C	T	6	4	10	0	1	11	0	0
8	14571053	.	A	G	4	5	9	0	0	9	0	0
8	14578369	.	A	G	4	7	11	0	0	11	0	0
8	14581138	.	A	T	3	6	9	0	0	9	0	0
8	14581650	.	T	C	2	6	8	0	0	8	0	0
8	14591771	.	C	T	0	3	3	0	3	6	0	0
8	14601733	.	A	G	3	3	6	0	0	6	0	0
8	14778465	.	C	T	0	2	2	0	1	3	0	0
8	14781631	.	G	A	0	7	7	0	3	10	0	0
8	14782073	.	C	T	8	5	13	0	0	13	0	0
8	14790282	.	T	C	11	12	23	0	1	24	0	0
8	14790559	.	A	G	4	5	9	0	2	12	1	0
8	14790733	.	C	T	13	5	18	0	0	18	0	0
8	14792860	.	A	G	4	12	16	0	0	16	0	0
8	14796863	.	C	A	5	3	8	0	0	8	0	0
8	14801544	.	G	A	4	8	12	0	1	13	0	0
8	14802951	.	T	C	12	11	23	0	0	23	0	0
8	14805109	.	C	T	9	3	12	0	1	13	0	0
8	14810160	.	A	G	8	8	16	0	0	16	0	0
8	14810527	.	A	G	7	2	9	0	2	11	0	0
8	14915387	.	A	C	3	5	8	0	0	8	0	0
8	14961331	.	T	C	5	5	10	0	0	10	0	0
8	14972782	.	T	A	3	6	9	0	0	9	0	0
8	14978906	.	T	C	7	8	15	0	1	16	0	0
8	14979893	.	A	C	6	11	17	0	2	19	0	0
8	14980933	.	C	A	4	2	6	0	0	6	0	0
8	14981059	.	A	T	9	5	14	0	0	14	0	0
8	14981124	.	A	T	8	8	16	0	0	16	0	0
8	14981991	.	C	T	6	7	13	0	0	13	0	0
8	14982022	.	A	G	9	7	16	0	0	16	0	0
8	14982477	.	A	C	5	8	13	0	0	13	0	0
8	14982919	.	C	T	5	4	9	0	0	9	0	0
8	14982962	.	A	T	10	3	13	0	1	14	0	0
8	14983081	.	T	C	3	3	6	0	0	6	0	0
8	14983176	.	A	G	1	7	8	0	1	9	0	0
8	14983191	.	A	G	1	5	6	0	1	7	0	0
8	14983866	.	C	T	9	6	15	0	0	15	0	0
8	15056624	.	C	G	16	13	29	0	1	30	0	0
8	15072236	.	A	C	15	7	22	0	0	22	0	0
8	15080551	.	G	A	11	13	24	2	0	26	0	0
8	15080566	.	A	G	9	12	21	2	2	25	0	0
8	15088972	.	T	C	4	0	4	0	4	8	0	0
8	15088981	.	T	C	4	0	4	0	4	8	0	0
8	15090910	.	A	G	2	5	7	0	0	7	0	0
8	15091708	.	C	T	4	12	16	0	0	16	0	0
8	15091727	.	T	A	2	11	13	0	0	13	0	0
8	15094241	.	T	C	5	11	16	0	1	17	0	0
8	15094262	.	C	T	6	8	14	0	2	16	0	0
8	15094525	.	A	G	5	4	9	0	1	10	0	0
8	15094588	.	G	C	6	7	13	0	0	13	0	0
8	15094599	.	C	A	0	11	11	0	6	17	0	0
8	15094803	.	C	G	1	9	10	0	6	16	0	0
8	15094809	.	G	A	6	11	17	0	0	17	0	0
8	15100461	.	A	G	4	3	7	0	0	7	0	0
8	15100653	.	T	C	11	0	11	0	7	18	0	0
8	15100731	.	A	G	4	4	8	0	0	8	0	0
8	15150031	.	G	A	2	3	5	0	1	6	0	0
8	15249989	.	G	A	4	2	6	0	0	6	0	0
8	15252141	.	A	G	16	9	25	0	0	25	0	0
8	15252250	.	C	G	16	13	29	1	0	30	0	0
8	15252306	.	G	A	10	14	24	0	0	24	0	0
8	15253365	.	C	A	11	7	18	0	0	18	0	0
8	15253384	.	T	C	10	5	15	0	0	15	0	0
8	15253496	.	G	A	5	4	9	0	0	9	0	0
8	15272931	.	C	T	4	3	7	0	2	9	0	0
8	15275665	.	T	C	11	11	22	0	3	25	0	0
8	15275704	.	G	A	14	8	22	0	1	23	0	0
8	15276587	.	T	A	15	6	21	0	0	21	0	0
8	15276588	.	C	G	14	6	20	0	1	21	0	0
8	15276678	.	G	A	10	5	15	0	0	15	0	0
8	15276684	.	G	A	1	5	6	0	9	15	0	0
8	15276864	.	A	T	1	2	3	0	0	3	0	0
8	15276944	.	T	G	3	3	6	0	0	6	0	0
8	15277957	.	T	C	6	9	15	0	0	15	0	0
8	15277965	.	T	C	6	10	16	0	1	17	0	0
8	15281446	.	A	T	3	3	6	0	1	7	0	0
8	15296967	.	C	T	1	4	5	0	1	6	0	0
8	15300291	.	A	C	2	2	4	0	0	4	0	0
8	15300304	.	T	C	1	2	3	0	0	3	0	0
8	15312985	.	A	G	6	10	16	0	0	16	0	0
8	15503365	.	G	A	2	2	4	0	0	4	0	0
8	15506831	.	G	A	2	3	5	0	0	5	0	0
8	15951146	.	C	T	1	6	7	0	6	13	0	0
8	16054374	.	C	T	34	24	58	0	3	61	0	0
8	16054389	.	T	C	30	22	52	0	7	59	0	0
8	16112107	.	G	A	3	31	34	0	26	60	0	0
8	16112212	.	C	T	31	29	60	0	2	62	0	0
8	16113850	.	C	A	23	20	43	0	0	43	0	0
8	16115682	.	C	T	6	11	17	2	10	32	3	0
8	16275011	.	G	C	3	6	9	0	5	14	0	0
8	16294511	.	G	A	20	13	33	0	1	34	0	0
8	16382915	.	G	A	3	8	11	0	0	11	0	0
8	16406283	.	C	A	3	6	9	0	0	9	0	0
8	16408621	.	A	G	4	2	6	0	0	6	0	0
8	16408771	.	T	A	1	6	7	0	0	7	0	0
8	16408914	.	T	A	6	2	8	0	1	9	0	0
8	16411633	.	G	T	8	3	11	0	0	11	0	0
8	16411635	.	T	G	8	3	11	0	0	11	0	0
8	16425038	.	C	T	19	11	30	0	0	30	0	0
8	16425079	.	C	T	2	11	13	0	12	25	0	0
8	16425383	.	T	C	14	13	27	0	1	28	0	0
8	16439114	.	G	T	8	11	19	0	0	19	0	0
8	16464100	.	A	G	7	7	14	0	1	15	0	0
8	16464166	.	G	A	7	5	12	0	1	13	0	0
8	16464296	.	T	A	16	6	22	1	0	23	0	0
8	16464306	.	T	G	15	8	23	1	0	24	0	0
8	16470571	.	G	A	4	3	7	1	0	8	0	0
8	16470750	.	C	T	4	5	9	0	0	9	0	0
8	16471018	.	A	C	2	3	5	0	0	5	0	0
8	16516832	.	A	T	4	4	8	0	0	8	0	0
8	16517152	.	C	A	2	8	10	0	0	10	0	0
8	16517265	.	C	T	0	5	5	0	3	8	0	0
8	16517553	.	G	A	3	3	6	0	0	6	0	0
8	16517558	.	T	C	3	3	6	0	0	6	0	0
8	16518493	.	T	A	3	2	5	0	1	6	0	0
8	16519055	.	C	T	5	7	12	0	0	12	0	0
8	16519084	.	C	A	8	7	15	0	0	15	0	0
8	16519102	.	T	G	10	6	16	0	0	16	0	0
8	16519370	.	G	A	5	4	9	0	1	10	0	0
8	16519389	.	C	T	7	5	12	0	0	12	0	0
8	16519506	.	T	C	3	4	7	0	0	7	0	0
8	16519560	.	A	G	2	5	7	0	0	7	0	0
8	16519637	.	C	T	9	11	20	0	1	21	0	0
8	16519646	.	G	T	11	10	21	0	0	21	0	0
8	16519821	.	G	A	19	5	24	0	1	25	0	0
8	16525366	.	T	A	10	5	15	0	0	15	0	0
8	16525417	.	A	G	7	6	13	0	0	13	0	0
8	16527055	.	C	G	8	11	19	0	0	19	0	0
8	16527060	.	T	C	5	0	5	0	13	18	0	0
8	16527091	.	G	A	9	12	21	0	0	21	0	0
8	16546457	.	C	T	2	2	4	0	1	5	0	0
8	16554805	.	A	G	2	4	6	0	0	6	0	0
8	16554826	.	C	T	2	3	5	0	0	5	0	0
8	16582470	.	T	A	19	9	28	0	2	30	0	0
8	16582608	.	G	A	21	13	34	0	1	35	0	0
8	16583127	.	C	T	10	21	31	16	0	47	0	0
8	16583142	.	A	C	25	12	37	8	0	45	0	0
8	16583447	.	C	T	27	20	47	0	0	47	0	0
8	16583528	.	C	T	22	16	38	2	3	48	5	0
8	16583534	.	G	C	18	24	42	2	1	46	1	0
8	16583591	.	C	T	24	11	35	0	3	38	0	0
8	16583851	.	C	T	3	5	8	24	0	32	0	0
8	16587510	.	T	A	21	33	54	0	1	55	0	0
8	16587964	.	A	T	18	21	39	0	0	39	0	0
8	16588157	.	A	G	22	19	41	0	1	42	0	0
8	16588444	.	G	A	19	20	39	1	1	41	0	0
8	16591864	.	A	G	18	11	29	0	1	30	0	0
8	16592465	.	G	C	20	23	43	0	2	45	0	0
8	16597215	.	C	T	12	8	20	0	0	20	0	0
8	16597238	.	G	A	17	6	23	0	0	23	0	0
8	16597252	.	G	A	14	6	20	0	1	21	0	0
8	16597524	.	T	C	6	3	9	0	2	11	0	0
8	16597589	.	T	A	4	6	10	1	0	11	0	0
8	16597621	.	T	C	4	6	10	0	0	10	0	0
8	16597654	.	T	C	4	0	4	0	6	10	0	0
8	16597680	.	C	G	4	5	9	0	0	9	0	0
8	16597889	.	G	A	6	5	11	0	0	11	0	0
8	16597949	.	A	T	6	11	17	0	0	17	0	0
8	16597964	.	G	A	6	12	18	0	0	18	0	0
8	16597986	.	G	A	6	11	17	0	1	18	0	0
8	16598076	.	C	T	1	7	8	0	7	15	0	0
8	16598148	.	C	T	1	5	6	0	7	13	0	0
8	16600671	.	T	C	8	9	17	0	0	17	0	0
8	16602571	.	G	A	9	12	21	0	0	21	0	0
8	16605678	.	G	A	3	7	10	0	1	11	0	0
8	16605723	.	G	A	5	15	20	0	0	20	0	0
8	16610048	.	G	T	7	3	10	1	0	11	0	0
8	16610051	.	G	A	8	3	11	1	0	12	0	0
8	16610221	.	T	A	1	2	3	1	0	4	0	0
8	16611005	.	A	C	4	12	16	0	0	16	0	0
8	16611498	.	T	G	2	2	4	0	0	4	0	0
8	16615802	.	T	C	9	8	17	0	1	18	0	0
8	16616697	.	C	T	1	22	23	0	23	46	0	0
8	16621919	.	A	G	13	19	32	0	1	33	0	0
8	16632794	.	G	A	8	10	18	0	0	18	0	0
8	16680296	.	T	C	3	3	6	0	0	6	0	0
8	16680556	.	A	C	5	2	7	0	0	7	0	0
8	16682943	.	G	A	3	2	5	0	1	6	0	0
8	16685439	.	C	T	6	2	8	0	0	8	0	0
8	16685796	.	T	A	1	5	6	0	0	6	0	0
8	16686479	.	C	G	2	3	5	0	0	5	0	0
8	16702114	.	G	A	3	3	6	0	0	6	0	0
8	16702129	.	G	A	3	4	7	0	1	8	0	0
8	16702267	.	C	T	1	3	4	0	0	4	0	0
8	16702396	.	A	T	1	3	4	0	0	4	0	0
8	16729938	.	A	G	14	12	26	0	0	26	0	0
8	16729941	.	G	A	13	13	26	0	0	26	0	0
8	16734037	.	A	T	8	4	12	0	3	15	0	0
8	16734074	.	C	G	4	6	10	0	3	13	0	0
8	16734247	.	C	A	8	8	16	0	1	17	0	0
8	16736489	.	A	T	13	11	24	0	2	26	0	0
8	16738054	.	G	A	13	11	24	0	0	24	0	0
8	16738149	.	G	T	11	6	17	0	0	17	0	0
8	16740792	.	A	G	5	11	16	0	0	16	0	0
8	16740977	.	C	T	2	4	6	0	0	6	0	0
8	16755381	.	G	A	6	7	13	0	1	14	0	0
8	16756847	.	G	C	3	6	9	0	0	9	0	0
8	16768992	.	A	G	9	0	9	0	10	19	0	0
8	16769126	.	C	T	14	15	29	0	1	30	0	0
8	16769396	.	T	G	8	2	10	0	1	11	0	0
8	17039140	.	G	A	1	4	5	0	1	6	0	0
8	17044255	.	G	A	0	4	4	0	8	12	0	0
8	17044618	.	C	T	1	3	4	0	0	4	0	0
8	17055727	.	C	T	5	27	32	0	25	57	0	0
8	17055766	.	G	A	32	22	54	0	1	55	0	0
8	17062173	.	G	A	23	24	47	0	0	47	0	0
8	17067269	.	T	C	21	21	42	1	0	43	0	0
8	17079902	.	C	T	9	14	23	0	1	24	0	0
8	17081782	.	C	T	19	15	34	0	3	37	0	0
8	17081863	.	G	A	17	18	35	0	3	38	0	0
8	17082696	.	C	A	10	16	26	0	1	27	0	0
8	17082927	.	G	A	2	11	13	0	17	30	0	0
8	17084696	.	G	C	15	21	36	0	3	39	0	0
8	17084733	.	C	G	21	20	41	0	2	43	0	0
8	17085921	.	G	A	15	16	31	0	0	31	0	0
8	17086002	.	C	T	13	8	21	0	1	22	0	0
8	17086033	.	C	T	13	4	17	0	0	17	0	0
8	17086096	.	A	T	4	2	6	0	0	6	0	0
8	17145317	.	A	G	4	4	8	0	0	8	0	0
8	17145332	.	A	G	5	4	9	0	1	10	0	0
8	17146845	.	T	G	3	5	8	0	1	9	0	0
8	17146887	.	T	C	6	4	10	0	0	10	0	0
8	17151997	.	A	G	2	3	5	0	0	5	0	0
8	17152057	.	C	A	4	2	6	0	2	8	0	0
8	17154110	.	C	T	6	5	11	0	1	12	0	0
8	17154128	.	A	G	4	0	4	0	5	9	0	0
8	17154188	.	C	T	2	11	13	0	0	13	0	0
8	17156641	.	A	G	5	3	8	0	0	8	0	0
8	17156772	.	G	C	5	6	11	0	0	11	0	0
8	17156806	.	A	G	5	5	10	0	0	10	0	0
8	17156869	.	C	T	9	4	13	0	0	13	0	0
8	17156950	.	T	A	4	6	10	0	1	11	0	0
8	17163766	.	T	A	10	13	23	0	0	23	0	0
8	17163771	.	A	G	10	11	21	0	1	22	0	0
8	17163856	.	T	G	8	10	18	0	1	19	0	0
8	17191942	.	G	T	2	1	3	0	1	4	0	0
8	17192129	.	A	G	5	4	9	0	0	9	0	0
8	17396056	.	G	T	14	7	21	0	1	22	0	0
8	17396303	.	G	A	17	10	27	0	1	28	0	0
8	17396447	.	A	C	4	5	9	0	0	9	0	0
8	17396657	.	C	G	0	9	9	0	4	14	1	0
8	17396811	.	T	A	9	2	11	0	2	13	0	0
8	17396904	.	T	C	12	0	12	0	13	25	0	0
8	17397095	.	C	T	2	2	4	0	0	4	0	0
8	17397807	.	C	A	6	6	12	0	0	12	0	0
8	17398070	.	T	C	12	9	21	0	1	23	1	0
8	17398229	.	A	T	9	8	17	0	0	17	0	0
8	17398775	.	G	A	10	9	19	0	0	19	0	0
8	17399061	.	C	T	10	5	15	2	1	18	0	0
8	17399281	.	A	T	8	7	15	0	1	16	0	0
8	17399586	.	T	A	19	20	39	0	0	39	0	0
8	17399609	.	C	T	21	17	38	0	2	40	0	0
8	17404605	.	C	A	1	7	8	0	12	20	0	0
8	17407150	.	G	A	13	13	26	0	1	27	0	0
8	17407210	.	C	G	0	11	11	0	14	25	0	0
8	17407258	.	T	C	14	0	14	0	12	26	0	0
8	17515848	.	G	A	10	4	14	0	1	15	0	0
8	17516304	.	C	T	0	15	15	0	12	27	0	0
8	17534858	.	G	T	4	2	6	0	1	7	0	0
8	17534887	.	C	T	4	3	7	0	0	7	0	0
8	17583923	.	T	G	16	9	25	0	2	27	0	0
8	17775482	.	A	G	3	6	9	0	1	10	0	0
8	17775526	.	A	T	2	2	4	0	0	4	0	0
8	17775655	.	A	C	7	3	10	0	0	10	0	0
8	17775692	.	C	G	4	2	6	0	0	6	0	0
8	17775697	.	A	T	4	2	6	0	0	6	0	0
8	17775728	.	A	G	5	0	5	0	3	8	0	0
8	17778741	.	T	C	6	5	11	0	0	11	0	0
8	17778744	.	A	G	6	0	6	0	5	11	0	0
8	17778843	.	G	C	6	5	11	0	1	12	0	0
8	17778864	.	C	T	7	3	10	0	1	11	0	0
8	17781165	.	A	G	6	10	16	0	1	17	0	0
8	17781416	.	A	T	2	9	11	0	2	13	0	0
8	17781468	.	C	G	6	8	14	0	0	14	0	0
8	17781555	.	C	T	6	2	8	0	0	8	0	0
8	17783735	.	G	A	5	9	14	0	1	15	0	0
8	17784322	.	T	A	6	7	13	1	0	14	0	0
8	17784426	.	T	G	8	4	12	0	0	12	0	0
8	17787431	.	A	C	1	2	3	0	0	3	0	0
8	17788008	.	T	G	2	2	4	0	0	4	0	0
8	17788302	.	T	C	5	3	8	0	0	8	0	0
8	17790323	.	C	T	2	5	7	0	1	8	0	0
8	17800823	.	A	T	2	4	6	0	0	6	0	0
8	17800918	.	G	A	2	3	5	0	0	5	0	0
8	17801028	.	G	A	2	5	7	0	0	7	0	0
8	17801061	.	T	C	2	4	6	0	1	7	0	0
8	17801078	.	T	A	5	3	8	0	0	8	0	0
8	17801438	.	A	G	7	8	15	0	0	15	0	0
8	17808331	.	A	G	1	3	4	0	0	4	0	0
8	17820740	.	G	A	3	3	6	0	0	6	0	0
8	17820773	.	T	C	3	2	5	0	0	5	0	0
8	17820839	.	C	G	2	4	6	0	0	6	0	0
8	17820846	.	G	A	2	4	6	0	0	6	0	0
8	17822181	.	G	A	2	7	9	0	1	10	0	0
8	17895075	.	G	A	1	6	7	0	4	11	0	0
8	17904618	.	A	G	4	5	9	0	0	9	0	0
8	17905324	.	A	C	2	10	12	0	1	13	0	0
8	17906164	.	C	T	4	10	14	0	0	14	0	0
8	17906181	.	C	A	9	5	14	0	0	14	0	0
8	17909833	.	C	T	3	9	12	0	0	12	0	0
8	17911215	.	C	T	5	5	10	0	0	10	0	0
8	17917127	.	A	G	1	2	3	0	0	3	0	0
8	17917129	.	A	G	1	0	1	0	2	3	0	0
8	17917340	.	C	A	1	3	4	0	0	4	0	0
8	17917371	.	G	T	3	6	9	0	0	9	0	0
8	17917388	.	T	C	2	6	8	0	0	9	1	0
8	17940408	.	C	T	2	2	4	0	0	4	0	0
8	17983788	.	C	A	6	5	11	0	0	11	0	0
8	17983867	.	A	C	3	0	3	0	2	5	0	0
8	17984761	.	A	G	6	6	12	0	0	12	0	0
8	17984835	.	T	C	1	0	1	0	5	6	0	0
8	18024959	.	C	T	23	22	45	0	1	46	0	0
8	18026052	.	G	A	3	7	10	1	20	31	0	0
8	18030857	.	C	T	10	18	28	0	3	31	0	0
8	18030884	.	G	A	9	18	27	0	2	29	0	0
8	18035231	.	T	A	17	14	31	0	3	34	0	0
8	18035290	.	T	C	10	8	18	0	6	24	0	0
8	18035303	.	T	A	11	12	23	0	2	25	0	0
8	18035371	.	T	C	19	13	32	0	1	33	0	0
8	18035786	.	C	T	9	17	26	0	1	27	0	0
8	18035963	.	T	C	10	9	19	0	1	20	0	0
8	18036167	.	T	C	9	9	18	0	0	18	0	0
8	18041793	.	C	T	6	4	10	0	0	10	0	0
8	18041814	.	G	A	3	6	9	0	0	9	0	0
8	18041925	.	A	C	3	0	3	0	7	10	0	0
8	18041974	.	A	T	1	4	5	0	0	5	0	0
8	18102007	.	C	T	1	2	3	0	0	3	0	0
8	18152398	.	T	C	1	4	5	0	0	5	0	0
8	18152413	.	T	C	2	6	8	0	0	8	0	0
8	18193373	.	C	G	6	11	17	0	1	18	0	0
8	18193420	.	C	G	6	6	12	0	1	13	0	0
8	18193591	.	A	T	10	9	19	0	0	19	0	0
8	18193628	.	T	C	21	14	35	0	0	35	0	0
8	18193707	.	T	C	20	23	43	0	1	44	0	0
8	18194238	.	T	C	22	22	44	0	3	47	0	0
8	18194283	.	G	A	27	22	49	0	0	49	0	0
8	18196444	.	C	T	4	16	20	0	30	50	0	0
8	18196462	.	A	G	31	16	47	0	1	48	0	0
8	18198801	.	C	T	14	17	31	0	1	32	0	0
8	18199999	.	A	G	4	2	6	0	0	6	0	0
8	18207465	.	C	T	6	2	8	0	0	8	0	0
8	18256255	.	A	G	2	2	4	0	0	4	0	0
8	18356524	.	G	A	13	10	23	0	2	25	0	0
8	18356688	.	G	A	13	11	24	0	0	24	0	0
8	18358709	.	T	C	3	7	10	0	0	10	0	0
8	18358760	.	C	A	1	5	6	0	0	6	0	0
8	18361223	.	G	A	7	7	14	0	0	14	0	0
8	18365134	.	G	A	2	5	7	0	1	8	0	0
8	18367734	.	T	C	2	5	7	0	0	7	0	0
8	18509756	.	A	G	3	8	11	0	1	12	0	0
8	18510560	.	A	G	1	5	6	0	0	6	0	0
8	18512015	.	A	T	4	7	11	0	0	11	0	0
8	18514407	.	C	T	4	2	6	0	1	7	0	0
8	18514466	.	C	T	5	5	10	0	1	11	0	0
8	18514476	.	A	G	7	4	11	0	0	11	0	0
8	18514518	.	C	A	0	6	6	0	2	8	0	0
8	18514855	.	A	T	2	11	13	0	1	14	0	0
8	18515092	.	G	T	6	4	10	0	0	10	0	0
8	18515137	.	G	A	3	2	5	0	0	5	0	0
8	18515138	.	G	A	3	2	5	0	0	5	0	0
8	18515206	.	T	G	4	2	6	0	1	7	0	0
8	18516279	.	A	T	3	1	4	0	3	7	0	0
8	18535786	.	C	T	1	1	2	0	1	3	0	0
8	18545641	.	A	T	6	6	12	0	1	13	0	0
8	18554651	.	T	C	7	6	13	0	0	13	0	0
8	18554731	.	T	A	12	14	26	0	2	28	0	0
8	18554826	.	G	A	11	12	23	0	1	24	0	0
8	18555104	.	A	G	19	0	19	0	12	31	0	0
8	18562225	.	C	A	19	13	32	0	1	33	0	0
8	18562551	.	G	A	6	8	14	0	1	15	0	0
8	18562570	.	C	T	7	9	16	0	0	16	0	0
8	18566278	.	G	A	9	5	14	0	0	14	0	0
8	18566327	.	C	A	7	12	19	0	0	19	0	0
8	18566419	.	T	A	9	8	17	0	0	17	0	0
8	18566466	.	A	T	6	14	20	0	0	20	0	0
8	18566615	.	T	G	17	11	28	0	2	30	0	0
8	18566669	.	C	T	16	17	33	0	0	33	0	0
8	18566687	.	T	C	12	18	30	0	2	32	0	0
8	18567020	.	G	A	21	16	37	0	0	37	0	0
8	18567230	.	G	A	14	7	21	0	9	30	0	0
8	18567266	.	C	T	4	8	12	0	16	28	0	0
8	18567291	.	A	C	11	11	22	1	1	24	0	0
8	18567342	.	G	A	15	13	28	1	0	29	0	0
8	18567453	.	A	G	21	11	32	0	1	33	0	0
8	18567559	.	C	T	14	5	19	0	2	21	0	0
8	18567577	.	G	T	19	8	27	0	0	27	0	0
8	18568022	.	G	C	8	12	20	0	1	21	0	0
8	18568121	.	C	T	15	9	24	0	1	25	0	0
8	18568741	.	G	T	13	18	31	0	4	35	0	0
8	18568852	.	T	C	11	0	11	0	14	25	0	0
8	18569126	.	T	C	13	10	23	0	1	24	0	0
8	18569129	.	A	G	14	9	23	0	1	24	0	0
8	18569221	.	C	A	5	10	15	0	0	15	0	0
8	18569316	.	T	G	7	10	17	0	0	17	0	0
8	18569767	.	A	T	2	11	13	0	2	15	0	0
8	18570117	.	C	G	1	11	12	0	7	19	0	0
8	18570190	.	G	C	9	10	19	0	0	19	0	0
8	18570239	.	A	G	11	14	25	0	0	25	0	0
8	18582554	.	C	T	9	13	22	0	5	27	0	0
8	18582626	.	G	A	10	15	25	0	0	25	0	0
8	18582710	.	C	A	9	13	22	0	0	22	0	0
8	18582789	.	C	G	9	12	21	0	0	21	0	0
8	18582857	.	T	C	11	17	28	0	0	28	0	0
8	18589215	.	T	C	5	6	11	0	0	11	0	0
8	18592966	.	C	T	5	2	7	0	0	7	0	0
8	18592973	.	C	T	5	2	7	0	0	7	0	0
8	18593245	.	G	A	3	6	9	0	0	9	0	0
8	18593266	.	T	C	4	5	9	0	0	9	0	0
8	18598306	.	C	T	10	5	15	0	0	15	0	0
8	18598333	.	A	T	11	7	18	0	0	18	0	0
8	18598351	.	A	T	11	6	17	0	0	17	0	0
8	18598590	.	T	G	6	0	6	0	7	13	0	0
8	18598628	.	A	T	4	10	14	0	1	15	0	0
8	18598782	.	T	C	10	10	20	0	0	20	0	0
8	18598997	.	G	T	12	13	25	0	0	25	0	0
8	18599235	.	G	A	1	4	5	0	0	5	0	0
8	18609265	.	A	T	8	5	13	0	1	14	0	0
8	18609272	.	C	A	9	5	14	0	0	14	0	0
8	18611048	.	G	A	10	8	18	0	0	18	0	0
8	18613763	.	C	T	5	5	10	0	0	10	0	0
8	18613770	.	A	C	4	5	9	0	0	9	0	0
8	18613889	.	G	A	3	3	6	0	1	7	0	0
8	18623033	.	T	C	2	2	4	0	0	4	0	0
8	18641712	.	T	C	19	9	28	0	0	28	0	0
8	18647298	.	G	A	10	3	13	0	0	13	0	0
8	18647357	.	G	T	12	6	18	0	3	21	0	0
8	18836881	.	T	C	3	4	7	0	0	7	0	0
8	18837255	.	C	A	6	3	9	0	0	9	0	0
8	18837864	.	C	T	6	8	14	0	0	14	0	0
8	18840330	.	C	T	8	4	12	0	0	12	0	0
8	18842364	.	A	G	6	7	13	0	0	13	0	0
8	18842586	.	T	C	4	2	6	0	0	6	0	0
8	18842587	.	A	T	4	2	6	0	0	6	0	0
8	18879613	.	A	G	2	3	5	0	0	5	0	0
8	18890966	.	A	G	5	8	13	0	0	13	0	0
8	18891001	.	G	A	6	8	14	0	1	15	0	0
8	18891033	.	T	A	10	12	22	0	0	22	0	0
8	18936739	.	C	T	1	4	5	0	7	12	0	0
8	19232588	.	C	A	11	5	16	0	0	16	0	0
8	19232618	.	A	G	7	7	14	0	0	14	0	0
8	19246305	.	G	C	1	4	5	0	1	6	0	0
8	19278153	.	A	G	1	2	3	0	0	3	0	0
8	19283418	.	A	C	0	2	2	0	1	3	0	0
8	19283759	.	G	A	3	3	6	0	0	6	0	0
8	19284537	.	C	T	1	2	3	0	0	3	0	0
8	19401508	.	C	T	4	21	25	0	23	48	0	0
8	19402136	.	G	T	6	7	13	0	1	14	0	0
8	19402363	.	A	G	20	21	41	0	2	43	0	0
8	19402374	.	C	T	3	22	25	0	19	44	0	0
8	19472131	.	C	G	9	4	13	0	1	14	0	0
8	19474072	.	T	C	9	0	9	0	8	17	0	0
8	19476600	.	A	G	6	7	13	0	0	13	0	0
8	19476613	.	C	T	9	6	15	0	0	15	0	0
8	19477263	.	A	T	4	7	11	0	0	11	0	0
8	19477928	.	A	G	10	5	15	0	2	17	0	0
8	19478140	.	C	T	5	5	10	0	1	11	0	0
8	19479784	.	A	G	5	6	11	0	0	11	0	0
8	19483818	.	G	A	6	4	10	0	0	10	0	0
8	19485981	.	G	A	4	5	9	0	0	9	0	0
8	19489979	.	G	A	3	3	6	0	0	6	0	0
8	19490196	.	T	G	2	0	2	0	5	7	0	0
8	19490204	.	A	G	2	4	6	0	0	6	0	0
8	19490532	.	A	G	4	3	7	0	0	7	0	0
8	19499929	.	A	G	2	3	5	0	0	5	0	0
8	19504059	.	A	G	6	5	11	0	2	13	0	0
8	19504081	.	T	A	11	11	22	0	0	22	0	0
8	19504144	.	A	G	11	14	25	0	0	25	0	0
8	19508927	.	A	G	19	18	37	0	0	37	0	0
8	19508961	.	C	A	21	19	40	0	2	43	1	0
8	19511673	.	C	G	11	13	24	0	0	24	0	0
8	19511674	.	C	A	10	11	21	0	2	24	1	0
8	19511770	.	A	C	10	19	29	0	0	29	0	0
8	19511901	.	G	A	16	16	32	0	0	32	0	0
8	19511902	.	T	A	16	16	32	0	0	32	0	0
8	20440330	.	C	A	14	17	31	0	0	31	0	0
8	20440699	.	G	A	21	13	34	0	0	34	0	0
8	20443562	.	C	T	9	7	16	0	0	16	0	0
8	20448181	.	G	A	7	11	18	0	2	20	0	0
8	20448687	.	T	C	19	18	37	0	0	37	0	0
8	20449016	.	G	A	1	9	10	0	7	17	0	0
8	20449478	.	G	A	1	8	9	0	15	24	0	0
8	20449590	.	G	A	18	8	26	1	1	28	0	0
8	20449614	.	A	G	12	11	23	0	1	24	0	0
8	20449847	.	A	G	6	10	16	0	1	17	0	0
8	20449851	.	T	A	8	12	20	0	0	20	0	0
8	20450168	.	C	T	15	13	28	1	0	29	0	0
8	20450249	.	T	A	13	11	24	0	0	24	0	0
8	20450289	.	G	A	13	6	19	0	0	19	0	0
8	20455345	.	A	G	2	4	6	0	0	6	0	0
8	20457706	.	T	C	2	3	5	0	0	6	1	0
8	20457933	.	G	A	5	5	10	0	0	10	0	0
8	20458138	.	A	G	2	0	2	0	3	5	0	0
8	20458640	.	A	G	3	2	5	0	0	5	0	0
8	20460509	.	A	G	2	0	2	0	2	4	0	0
8	20460633	.	C	A	2	3	5	0	0	5	0	0
8	20460726	.	G	T	0	2	2	0	2	4	0	0
8	20471248	.	C	T	8	4	12	0	0	12	0	0
8	20471387	.	G	A	1	6	7	0	1	8	0	0
8	20471391	.	C	T	1	6	7	0	1	8	0	0
8	20503515	.	C	T	5	10	15	0	3	18	0	0
8	20503697	.	A	G	5	8	13	0	0	13	0	0
8	20503829	.	C	T	7	10	17	0	1	18	0	0
8	20503838	.	G	A	7	10	17	0	0	17	0	0
8	20546122	.	T	C	12	21	33	0	0	33	0	0
8	20546182	.	T	C	15	11	26	0	1	27	0	0
8	20559103	.	T	C	13	16	29	2	0	31	0	0
8	20559169	.	A	G	7	0	7	0	23	30	0	0
8	20559202	.	A	G	14	0	14	0	22	36	0	0
8	20559211	.	T	A	16	21	37	0	1	38	0	0
8	20559241	.	G	A	16	18	34	0	0	34	0	0
8	20559270	.	A	G	14	17	31	0	1	32	0	0
8	20559373	.	G	A	17	10	27	0	1	28	0	0
8	20559682	.	G	A	13	19	32	0	2	34	0	0
8	20559683	.	A	G	11	19	30	0	2	32	0	0
8	20679974	.	G	A	0	3	3	0	3	6	0	0
8	20679977	.	A	G	3	0	3	0	3	6	0	0
8	20680043	.	C	T	1	2	3	0	1	4	0	0
8	20680049	.	G	A	2	3	5	0	0	5	0	0
8	20755224	.	C	A	6	3	9	0	0	9	0	0
8	20782390	.	G	T	0	5	5	0	5	10	0	0
8	20853335	.	A	T	9	14	23	0	0	23	0	0
8	20853987	.	C	G	7	7	14	0	0	14	0	0
8	20856643	.	G	A	12	11	23	0	2	25	0	0
8	20865557	.	A	T	9	9	18	0	1	19	0	0
8	20868167	.	T	A	7	9	16	0	2	18	0	0
8	20868191	.	G	A	12	3	15	0	1	16	0	0
8	20868209	.	G	A	14	5	19	0	1	20	0	0
8	20870301	.	G	A	13	7	20	0	0	20	0	0
8	20870439	.	A	T	9	7	16	0	0	16	0	0
8	20870639	.	G	C	0	11	11	0	9	20	0	0
8	20872987	.	G	T	14	13	27	0	1	28	0	0
8	20873011	.	G	A	1	11	12	0	14	26	0	0
8	20873113	.	C	T	16	10	26	0	1	27	0	0
8	20873183	.	C	T	8	7	15	0	0	15	0	0
8	20876466	.	C	T	10	6	16	0	0	16	0	0
8	21047673	.	G	T	3	2	5	0	1	6	0	0
8	21047698	.	C	G	3	3	6	0	0	6	0	0
8	21047824	.	C	A	4	9	13	0	0	13	0	0
8	21052270	.	T	C	2	5	7	0	0	7	0	0
8	21052694	.	A	G	1	2	3	0	0	3	0	0
8	21053030	.	G	A	11	7	18	0	0	18	0	0
8	21053084	.	A	T	10	5	15	0	1	16	0	0
8	21053122	.	G	A	8	6	14	0	0	14	0	0
8	21053345	.	T	C	5	0	5	0	6	11	0	0
8	21053371	.	G	A	6	6	12	0	1	13	0	0
8	21053404	.	T	C	4	5	9	0	1	10	0	0
8	21053744	.	G	A	5	7	12	0	1	13	0	0
8	21053754	.	A	G	7	7	14	0	1	15	0	0
8	21068849	.	C	T	2	8	10	0	0	10	0	0
8	21071724	.	C	T	3	7	10	0	1	11	0	0
8	21089923	.	A	T	2	7	9	2	0	11	0	0
8	21095288	.	G	A	12	5	17	1	1	19	0	0
8	21095439	.	G	C	5	11	16	0	0	16	0	0
8	21095504	.	A	C	4	11	15	0	0	15	0	0
8	21095506	.	G	A	11	4	15	0	0	15	0	0
8	21100278	.	T	A	7	6	13	1	0	14	0	0
8	21100290	.	G	A	6	8	14	0	0	14	0	0
8	21104837	.	G	A	3	5	8	0	1	9	0	0
8	21104853	.	G	T	3	4	7	0	1	8	0	0
8	21105045	.	G	A	4	8	12	0	0	12	0	0
8	21105504	.	G	A	17	7	24	0	0	24	0	0
8	21110074	.	A	G	12	14	26	0	0	26	0	0
8	21114444	.	C	T	9	17	26	0	0	26	0	0
8	21123525	.	A	T	10	8	18	0	0	18	0	0
8	21123561	.	T	C	1	8	9	0	1	10	0	0
8	21123607	.	T	C	8	5	13	0	0	13	0	0
8	21130028	.	A	G	15	10	25	0	2	27	0	0
8	21130158	.	G	A	7	7	14	0	1	15	0	0
8	21130292	.	G	A	4	3	7	0	0	7	0	0
8	21130441	.	T	A	1	2	3	0	0	3	0	0
8	21130746	.	T	C	6	6	12	0	1	13	0	0
8	21131089	.	A	T	5	3	8	0	0	8	0	0
8	21131310	.	C	T	2	4	6	0	1	7	0	0
8	21131373	.	C	A	3	5	8	0	1	9	0	0
8	21131432	.	G	A	7	2	9	0	0	9	0	0
8	21131926	.	A	G	10	6	16	0	0	16	0	0
8	21132190	.	A	G	5	4	9	0	0	9	0	0
8	21132445	.	A	C	8	9	17	0	0	17	0	0
8	21132599	.	G	A	2	14	16	0	7	23	0	0
8	21132648	.	T	C	10	11	21	0	1	22	0	0
8	21132947	.	G	T	0	6	6	0	5	11	0	0
8	21132979	.	T	A	2	2	4	0	0	4	0	0
8	21134536	.	T	C	23	22	45	0	0	45	0	0
8	21137675	.	G	A	4	3	7	0	0	7	0	0
8	21139950	.	C	A	1	7	8	0	11	19	0	0
8	21140215	.	T	G	5	2	7	0	0	8	1	0
8	21140286	.	C	T	1	5	6	0	5	11	0	0
8	21140910	.	C	T	0	5	5	0	5	10	0	0
8	21140913	.	T	G	6	6	12	0	0	12	0	0
8	21141006	.	G	A	6	3	9	0	0	9	0	0
8	21141329	.	G	C	6	0	6	0	5	11	0	0
8	21141330	.	A	G	6	5	11	0	0	11	0	0
8	21146292	.	C	A	5	10	15	0	0	15	0	0
8	21146302	.	G	T	7	5	12	0	0	12	0	0
8	21146936	.	C	T	4	5	9	0	0	9	0	0
8	21148814	.	G	A	4	4	8	0	1	9	0	0
8	21151760	.	C	T	5	8	13	0	0	13	0	0
8	21152728	.	C	G	10	7	17	0	0	17	0	0
8	21152737	.	C	A	9	9	18	0	0	18	0	0
8	21153088	.	G	T	7	6	13	0	1	14	0	0
8	21153257	.	A	T	5	7	12	0	0	12	0	0
8	21155864	.	A	G	7	5	12	0	0	13	1	0
8	21155871	.	T	C	7	7	14	0	0	14	0	0
8	21155937	.	T	G	2	13	15	0	0	15	0	0
8	21162056	.	C	T	4	3	7	0	1	8	0	0
8	21162161	.	C	T	11	11	22	0	0	22	0	0
8	21162209	.	T	C	13	7	20	0	1	21	0	0
8	21162278	.	G	A	0	10	10	0	8	18	0	0
8	21162284	.	A	G	6	0	6	0	11	17	0	0
8	21162318	.	T	C	7	11	18	0	2	20	0	0
8	21162593	.	A	G	2	0	2	0	4	6	0	0
8	21225163	.	G	A	2	19	21	0	13	34	0	0
8	21225172	.	A	G	10	12	22	0	5	27	0	0
8	21241111	.	T	G	17	0	17	0	17	34	0	0
8	21241122	.	T	C	19	16	35	0	0	35	0	0
8	21245386	.	A	T	6	5	11	0	0	11	0	0
8	21245422	.	T	C	3	4	7	0	0	7	0	0
8	21245803	.	C	T	12	8	20	0	0	20	0	0
8	21247280	.	G	A	19	20	39	0	0	39	0	0
8	21248852	.	C	A	26	24	50	0	0	50	0	0
8	21248879	.	G	A	24	27	51	0	2	53	0	0
8	21250132	.	T	A	25	16	41	0	2	43	0	0
8	21250183	.	T	A	15	22	37	0	1	38	0	0
8	21250553	.	T	C	14	3	17	0	12	29	0	0
8	21250558	.	G	A	9	16	25	0	4	29	0	0
8	21250694	.	A	G	19	0	19	0	20	39	0	0
8	21251179	.	T	C	23	27	50	0	1	51	0	0
8	21251456	.	T	G	27	20	47	0	2	49	0	0
8	21251569	.	G	C	22	27	49	1	2	52	0	0
8	21251732	.	C	T	21	13	34	0	2	36	0	0
8	21251775	.	T	C	13	19	32	0	0	32	0	0
8	21252042	.	G	T	7	13	20	0	0	20	0	0
8	21252125	.	A	T	30	25	55	0	0	55	0	0
8	21252155	.	T	C	27	23	50	0	3	53	0	0
8	21252163	.	A	G	25	24	49	0	1	50	0	0
8	21252215	.	A	T	20	28	48	0	3	51	0	0
8	21252237	.	T	C	20	28	48	0	1	49	0	0
8	21252472	.	C	G	15	15	30	0	0	30	0	0
8	21265272	.	G	A	11	14	25	0	1	26	0	0
8	21265488	.	C	G	4	7	11	0	0	11	0	0
8	21265536	.	T	C	3	6	9	0	0	9	0	0
8	21361307	.	G	A	1	3	4	0	0	4	0	0
8	21361321	.	C	T	1	3	4	0	0	4	0	0
8	21365130	.	A	C	2	3	5	0	1	6	0	0
8	21368481	.	A	T	3	4	7	0	0	7	0	0
8	21368497	.	T	C	4	3	7	0	0	7	0	0
8	21368737	.	T	C	3	5	8	0	0	8	0	0
8	21368892	.	G	A	5	2	7	1	0	8	0	0
8	21588443	.	G	T	0	9	9	0	4	13	0	0
8	21629342	.	G	C	1	8	9	0	1	10	0	0
8	21664464	.	C	T	16	8	24	0	1	25	0	0
8	21672605	.	A	G	7	9	16	0	0	16	0	0
8	21673091	.	T	C	16	7	23	0	1	24	0	0
8	21673248	.	A	T	18	6	24	0	0	24	0	0
8	21673516	.	G	A	1	20	21	0	9	30	0	0
8	21673666	.	G	A	9	4	13	0	0	13	0	0
8	21673765	.	C	T	11	7	18	0	1	19	0	0
8	21673789	.	T	G	8	0	8	0	13	21	0	0
8	21673813	.	C	T	16	10	26	0	0	26	0	0
8	21673880	.	A	C	14	8	22	0	1	23	0	0
8	21673886	.	A	G	14	0	14	0	5	19	0	0
8	21674080	.	G	T	5	10	15	0	0	16	1	0
8	21674141	.	A	G	6	3	9	0	0	9	0	0
8	21674359	.	A	T	2	6	8	0	0	8	0	0
8	21674449	.	T	A	2	7	9	0	2	11	0	0
8	21674546	.	A	T	2	2	4	0	0	4	0	0
8	21674610	.	C	T	1	3	4	0	0	4	0	0
8	21674795	.	A	C	9	10	19	0	0	19	0	0
8	21674815	.	A	T	8	14	22	0	0	22	0	0
8	21675004	.	G	A	13	8	21	0	1	22	0	0
8	21675008	.	A	G	13	9	22	0	1	23	0	0
8	21675043	.	G	C	8	14	22	0	0	22	0	0
8	21675057	.	T	A	8	12	20	0	1	21	0	0
8	21675200	.	A	G	18	5	23	0	0	23	0	0
8	21675551	.	A	G	9	18	27	0	0	27	0	0
8	21675575	.	T	C	12	10	22	0	1	23	0	0
8	21675608	.	G	C	6	8	14	0	1	15	0	0
8	21675695	.	G	T	0	16	16	0	8	24	0	0
8	21675698	.	G	A	0	16	16	0	9	25	0	0
8	21675745	.	G	A	6	15	21	0	0	21	0	0
8	21675755	.	A	G	11	6	17	0	0	17	0	0
8	21675787	.	T	A	6	5	11	0	0	11	0	0
8	21978302	.	A	C	2	2	4	0	1	5	0	0
8	21978306	.	G	A	2	2	4	0	1	5	0	0
8	22003593	.	G	T	1	2	3	0	0	3	0	0
8	22010925	.	A	T	3	3	6	0	0	6	0	0
8	22011057	.	A	G	1	2	3	0	1	4	0	0
8	22014523	.	T	A	2	3	5	0	0	5	0	0
8	22033753	.	G	C	3	2	5	0	0	5	0	0
8	22054581	.	T	C	4	0	4	0	2	6	0	0
8	22054593	.	T	C	3	2	5	0	0	5	0	0
8	22273778	.	C	T	1	2	3	0	0	3	0	0
8	22277274	.	A	T	4	4	8	0	0	8	0	0
8	22278411	.	T	C	2	8	10	0	0	10	0	0
8	22278432	.	C	T	8	3	11	0	0	11	0	0
8	22278456	.	G	T	2	6	8	0	1	9	0	0
8	22282637	.	T	C	8	5	13	0	0	13	0	0
8	22284192	.	G	T	7	5	12	0	1	13	0	0
8	22284206	.	G	T	10	6	16	0	0	16	0	0
8	22284262	.	C	T	10	5	15	0	1	16	0	0
8	22284306	.	C	T	4	9	13	0	1	14	0	0
8	22284425	.	G	A	6	2	8	0	0	8	0	0
8	22284509	.	T	C	10	10	20	0	0	20	0	0
8	22284570	.	T	G	5	11	16	0	1	17	0	0
8	22286820	.	G	A	8	9	17	0	2	19	0	0
8	22287063	.	A	C	15	2	17	0	11	28	0	0
8	22287163	.	A	G	10	4	14	0	0	14	0	0
8	22298241	.	A	C	5	9	14	0	0	14	0	0
8	22298242	.	G	T	5	9	14	0	0	14	0	0
8	22301156	.	T	C	5	4	9	0	0	9	0	0
8	22302712	.	C	T	5	6	11	0	0	11	0	0
8	22302716	.	G	A	5	6	11	0	0	11	0	0
8	22303766	.	A	G	9	7	16	0	0	16	0	0
8	22303820	.	G	A	7	4	11	0	0	11	0	0
8	22303922	.	A	T	6	5	11	0	0	11	0	0
8	22311505	.	T	C	3	0	3	0	6	9	0	0
8	22317583	.	C	A	5	6	11	0	0	11	0	0
8	22319173	.	G	A	5	4	9	0	0	9	0	0
8	22319331	.	T	G	7	3	10	0	0	10	0	0
8	22320850	.	C	T	3	4	7	0	0	7	0	0
8	22320853	.	C	T	3	4	7	0	0	7	0	0
8	22324866	.	A	G	2	1	3	0	2	5	0	0
8	22324992	.	G	A	1	4	5	0	0	5	0	0
8	22326679	.	A	G	2	3	5	0	0	5	0	0
8	22327353	.	G	A	4	6	10	0	0	10	0	0
8	22329411	.	C	A	9	7	16	0	0	16	0	0
8	22329434	.	A	G	3	7	10	0	1	11	0	0
8	22329471	.	G	A	9	2	11	0	0	11	0	0
8	22329678	.	T	C	7	9	16	0	0	16	0	0
8	22335414	.	A	G	4	5	9	0	0	9	0	0
8	22335420	.	T	C	5	3	8	0	0	8	0	0
8	22337301	.	T	C	6	6	12	0	0	12	0	0
8	22337337	.	G	A	0	2	2	0	6	8	0	0
8	22337436	.	T	C	7	5	12	0	1	13	0	0
8	22337718	.	C	G	1	3	4	0	0	4	0	0
8	22337744	.	A	G	1	3	4	0	0	4	0	0
8	22337754	.	A	G	1	0	1	0	3	4	0	0
8	22345747	.	A	C	4	3	7	0	0	7	0	0
8	22346502	.	C	T	8	7	15	0	0	15	0	0
8	22346508	.	T	C	7	6	13	0	0	13	0	0
8	22346638	.	C	T	5	7	12	0	0	12	0	0
8	22499652	.	G	C	1	2	3	0	0	3	0	0
8	22499724	.	T	G	1	5	6	0	0	6	0	0
8	22500274	.	C	T	2	7	9	0	4	13	0	0
8	22500307	.	A	C	7	3	10	0	4	14	0	0
8	22500406	.	A	T	9	6	15	0	0	15	0	0
8	22500436	.	G	A	8	8	16	0	0	16	0	0
8	22500543	.	T	C	6	1	7	0	10	17	0	0
8	22502731	.	C	T	7	10	17	0	1	18	0	0
8	22503469	.	G	C	7	9	16	0	0	16	0	0
8	22503709	.	T	A	5	5	10	0	2	12	0	0
8	22504329	.	C	G	7	7	14	0	1	15	0	0
8	22511375	.	C	T	4	6	10	0	0	10	0	0
8	22511471	.	C	T	6	5	11	0	0	11	0	0
8	22511654	.	C	T	0	3	3	0	4	7	0	0
8	22511817	.	G	A	5	2	7	0	0	7	0	0
8	22512539	.	T	A	5	2	7	0	0	7	0	0
8	22514745	.	G	C	2	2	4	0	0	4	0	0
8	22514751	.	A	G	0	3	3	0	0	3	0	0
8	22514817	.	T	A	2	2	4	0	0	4	0	0
8	22521792	.	G	C	5	8	13	0	2	15	0	0
8	22522136	.	A	G	17	17	34	3	3	40	0	0
8	22522397	.	G	A	7	8	15	0	0	15	0	0
8	22522688	.	G	A	12	13	25	0	2	27	0	0
8	22522699	.	C	G	1	13	14	0	16	34	4	0
8	22522742	.	T	C	18	16	34	0	0	34	0	0
8	22522913	.	T	A	20	19	39	0	2	41	0	0
8	22523118	.	G	A	27	19	46	0	0	46	0	0
8	22524820	.	C	T	24	25	49	0	2	51	0	0
8	22525773	.	C	T	3	17	20	0	24	44	0	0
8	22525978	.	C	T	19	20	39	0	1	40	0	0
8	22526355	.	T	G	18	12	30	0	0	30	0	0
8	22530423	.	T	C	15	14	29	0	2	31	0	0
8	22530480	.	G	A	25	16	41	0	0	41	0	0
8	22531978	.	G	A	19	16	35	1	0	36	0	0
8	22533535	.	C	T	20	14	34	0	1	35	0	0
8	22536031	.	C	T	11	10	21	0	0	21	0	0
8	22544636	.	G	A	3	4	7	0	0	7	0	0
8	22551311	.	G	A	1	5	6	0	1	7	0	0
8	22554321	.	C	G	2	2	4	0	0	4	0	0
8	22556630	.	A	G	2	4	6	0	0	6	0	0
8	22558582	.	G	A	5	4	9	0	0	9	0	0
8	22558686	.	T	A	4	3	7	0	0	7	0	0
8	22604028	.	C	T	9	3	12	0	0	12	0	0
8	22604170	.	A	T	8	6	14	0	3	17	0	0
8	22604181	.	T	C	9	4	13	0	2	15	0	0
8	22607125	.	T	C	7	6	13	0	0	13	0	0
8	22612068	.	C	A	10	9	19	0	0	19	0	0
8	22612069	.	C	A	9	9	18	0	0	18	0	0
8	22612258	.	G	A	8	4	12	0	2	14	0	0
8	22612608	.	T	C	9	5	14	0	0	14	0	0
8	22612712	.	C	T	7	6	13	0	0	13	0	0
8	22612869	.	C	A	5	5	10	0	0	10	0	0
8	22612977	.	T	A	7	1	8	0	2	10	0	0
8	22612979	.	A	T	7	3	10	0	0	10	0	0
8	22613051	.	A	G	10	0	10	0	6	16	0	0
8	22613062	.	T	G	11	6	17	0	1	18	0	0
8	22619212	.	T	C	20	0	20	0	27	47	0	0
8	22619443	.	G	A	18	29	47	0	6	53	0	0
8	22622733	.	A	T	10	16	26	0	4	30	0	0
8	22627917	.	A	C	15	10	25	0	0	25	0	0
8	22630366	.	A	G	14	10	24	0	0	24	0	0
8	22631775	.	T	C	12	16	28	0	4	32	0	0
8	22632687	.	T	A	11	13	24	1	0	25	0	0
8	22635807	.	C	T	1	17	18	0	14	32	0	0
8	22637674	.	G	A	17	10	27	0	2	29	0	0
8	22637699	.	T	G	15	14	29	0	3	32	0	0
8	22660118	.	A	T	12	8	20	0	1	21	0	0
8	22761882	.	C	G	1	3	4	0	0	4	0	0
8	22762019	.	G	A	1	7	8	0	0	8	0	0
8	22762173	.	C	T	9	6	15	0	1	16	0	0
8	22762194	.	A	C	10	9	19	0	1	20	0	0
8	22762365	.	T	C	2	0	2	0	3	5	0	0
8	22762380	.	C	G	5	6	11	0	0	11	0	0
8	22762508	.	A	T	5	5	10	0	0	10	0	0
8	22788971	.	A	G	9	8	17	0	0	17	0	0
8	22788994	.	C	T	11	11	22	0	1	23	0	0
8	22789112	.	A	G	8	9	17	0	1	18	0	0
8	22826829	.	T	A	4	5	9	0	0	9	0	0
8	22826868	.	T	C	3	0	3	0	4	7	0	0
8	22837646	.	G	A	4	2	6	0	0	6	0	0
8	22916092	.	T	C	1	2	3	0	0	3	0	0
8	22922731	.	C	T	1	4	5	0	1	6	0	0
8	22945572	.	T	C	35	25	60	0	1	61	0	0
8	22947209	.	C	T	40	35	75	0	7	82	0	0
8	22951053	.	G	A	26	33	59	0	4	63	0	0
8	22951054	.	C	G	26	36	62	0	2	64	0	0
8	22951203	.	A	T	30	33	63	0	3	66	0	0
8	22951730	.	G	A	28	23	51	0	1	52	0	0
8	22951847	.	A	T	24	36	60	0	1	61	0	0
8	22951919	.	C	T	28	37	65	0	0	65	0	0
8	22951979	.	T	G	27	32	59	0	2	61	0	0
8	22952330	.	A	T	36	34	70	0	3	73	0	0
8	22952758	.	G	A	2	3	5	0	1	6	0	0
8	22953068	.	G	A	1	2	3	0	0	3	0	0
8	22985426	.	G	A	2	3	5	0	0	5	0	0
8	23041461	.	C	T	0	13	13	0	14	27	0	0
8	23044478	.	G	T	12	12	24	0	0	24	0	0
8	23044554	.	T	C	19	0	19	0	12	31	0	0
8	23044620	.	G	A	17	13	30	0	2	32	0	0
8	23102951	.	T	A	1	3	4	0	1	5	0	0
8	23103307	.	C	T	1	7	8	0	1	9	0	0
8	23105304	.	T	A	8	12	20	0	1	21	0	0
8	23105429	.	A	G	13	8	21	0	1	22	0	0
8	23109308	.	C	T	13	12	25	0	1	26	0	0
8	23109443	.	G	A	9	9	18	0	0	18	0	0
8	23109554	.	C	A	11	25	36	0	2	38	0	0
8	23119100	.	T	A	4	10	14	0	1	15	0	0
8	23120158	.	T	G	1	2	3	0	0	3	0	0
8	23147682	.	C	G	11	3	14	0	0	14	0	0
8	23149956	.	G	A	4	12	16	1	17	34	0	0
8	23151697	.	C	T	3	2	5	0	0	5	0	0
8	23165835	.	G	T	1	28	29	0	26	55	0	0
8	23175234	.	C	T	25	30	55	0	0	55	0	0
8	23177298	.	C	T	26	28	54	0	1	55	0	0
8	23179659	.	G	T	28	26	54	0	3	57	0	0
8	23179702	.	T	G	26	21	47	0	2	49	0	0
8	23195394	.	C	T	10	6	16	0	0	16	0	0
8	23202689	.	C	T	11	8	19	0	3	22	0	0
8	23202730	.	T	C	14	7	21	0	2	23	0	0
8	23206517	.	C	T	2	2	4	0	0	4	0	0
8	23206529	.	G	A	0	4	4	0	0	4	0	0
8	23206582	.	C	T	2	2	4	0	0	4	0	0
8	23206939	.	C	T	9	9	18	0	1	19	0	0
8	23210492	.	T	C	17	9	26	0	1	27	0	0
8	23210579	.	G	A	13	9	22	0	0	22	0	0
8	23210598	.	G	C	9	14	23	0	0	23	0	0
8	23210652	.	G	A	11	12	23	0	0	23	0	0
8	23210955	.	C	T	8	9	17	0	1	18	0	0
8	23211120	.	C	T	9	6	15	0	0	15	0	0
8	23211200	.	G	T	4	2	6	0	1	7	0	0
8	23211233	.	G	T	4	6	10	0	0	10	0	0
8	23211402	.	T	C	6	9	15	0	1	16	0	0
8	23211424	.	C	A	7	6	13	0	0	13	0	0
8	23211446	.	A	C	10	6	16	0	0	16	0	0
8	23213414	.	C	T	9	8	17	0	1	18	0	0
8	23215697	.	G	A	0	4	4	0	12	16	0	0
8	23215800	.	T	C	7	10	17	0	0	17	0	0
8	23253068	.	T	A	6	5	11	0	1	12	0	0
8	23253238	.	A	T	2	6	8	0	0	8	0	0
8	23253242	.	C	T	6	2	8	0	0	8	0	0
8	23253640	.	A	T	6	3	9	0	0	9	0	0
8	23253656	.	C	T	0	3	3	0	5	8	0	0
8	23253720	.	G	A	6	3	9	0	0	9	0	0
8	23253892	.	A	G	8	9	17	0	0	17	0	0
8	23256703	.	C	T	11	4	15	0	1	16	0	0
8	23258522	.	T	C	4	0	4	0	6	10	0	0
8	23260866	.	G	A	5	6	11	0	0	11	0	0
8	23261031	.	A	G	3	4	7	0	0	7	0	0
8	23271275	.	G	A	9	7	16	0	0	16	0	0
8	23271281	.	G	A	7	6	13	0	1	14	0	0
8	23327394	.	C	G	0	5	5	0	1	6	0	0
8	23327460	.	G	A	8	3	11	0	0	11	0	0
8	23377767	.	A	C	1	2	3	0	0	3	0	0
8	23382618	.	C	G	2	2	4	0	0	4	0	0
8	23383928	.	G	A	2	2	4	0	0	4	0	0
8	23384003	.	G	A	1	3	4	0	0	4	0	0
8	23388348	.	T	C	3	4	7	0	0	7	0	0
8	23389781	.	T	A	6	6	12	0	1	13	0	0
8	23415651	.	C	T	8	7	15	0	1	16	0	0
8	23415693	.	G	A	11	10	21	0	0	21	0	0
8	23415717	.	A	G	12	14	26	0	1	27	0	0
8	23542258	.	G	A	0	2	2	0	2	4	0	0
8	23553476	.	A	G	7	8	15	0	0	15	0	0
8	23553648	.	C	T	3	3	6	0	0	6	0	0
8	23553785	.	A	G	2	3	5	0	0	5	0	0
8	23567740	.	G	T	6	5	11	0	1	12	0	0
8	23567750	.	T	G	3	4	7	0	4	11	0	0
8	23567780	.	T	G	3	4	7	0	2	9	0	0
8	23615247	.	C	T	5	3	8	0	0	8	0	0
8	23615446	.	G	A	5	4	9	0	0	9	0	0
8	23615456	.	C	T	6	5	11	0	0	11	0	0
8	23625823	.	T	G	7	8	15	0	0	15	0	0
8	23627345	.	G	A	1	6	7	0	11	18	0	0
8	23629548	.	T	C	5	2	7	0	1	8	0	0
8	23631692	.	C	T	7	6	13	0	0	13	0	0
8	23636779	.	A	C	10	3	13	0	1	14	0	0
8	23636901	.	C	A	9	6	15	0	0	15	0	0
8	23636923	.	C	T	6	9	15	0	0	15	0	0
8	23637140	.	A	G	9	4	13	0	0	13	0	0
8	23637232	.	A	G	1	4	5	0	0	6	1	0
8	23637245	.	G	T	2	5	7	0	0	7	0	0
8	23637386	.	A	G	4	1	5	0	0	5	0	0
8	23637395	.	C	T	2	2	4	0	0	4	0	0
8	23639163	.	G	A	0	5	5	0	0	5	0	0
8	23639165	.	T	C	1	5	6	0	0	6	0	0
8	23639298	.	C	A	13	8	21	0	1	22	0	0
8	23639472	.	T	C	6	2	8	0	1	9	0	0
8	23642271	.	T	C	6	6	12	0	0	12	0	0
8	23647389	.	T	A	13	8	21	0	2	23	0	0
8	23648725	.	G	A	12	7	19	0	1	20	0	0
8	23651328	.	C	T	11	9	20	0	0	20	0	0
8	23651370	.	C	T	13	11	24	0	2	26	0	0
8	23651397	.	G	A	3	13	16	0	12	28	0	0
8	23655728	.	A	C	2	1	3	0	23	26	0	0
8	23655735	.	T	G	9	0	9	0	19	28	0	0
8	23656125	.	G	T	7	3	10	0	0	10	0	0
8	23656212	.	A	T	14	4	18	0	0	18	0	0
8	23656321	.	C	A	7	10	17	0	1	18	0	0
8	23658888	.	A	T	1	6	7	0	0	7	0	0
8	23666962	.	T	C	3	7	10	0	0	10	0	0
8	23667281	.	T	C	2	6	8	0	0	8	0	0
8	23667290	.	A	G	3	0	3	0	6	9	0	0
8	23667561	.	C	T	9	5	14	0	0	14	0	0
8	23667739	.	C	T	7	5	12	0	1	13	0	0
8	23667902	.	C	A	8	7	15	0	0	15	0	0
8	23667909	.	G	T	7	6	13	0	2	15	0	0
8	23667966	.	G	A	7	8	15	0	0	15	0	0
8	23668050	.	G	A	10	6	16	0	0	16	0	0
8	23668060	.	C	T	6	5	11	0	2	13	0	0
8	23669276	.	C	T	6	6	12	0	0	12	0	0
8	23669423	.	T	C	4	4	8	0	0	8	0	0
8	23669617	.	T	C	7	8	15	0	0	15	0	0
8	23669642	.	C	T	7	6	13	0	1	14	0	0
8	23669736	.	A	T	4	5	9	0	0	9	0	0
8	23669802	.	C	A	9	5	14	0	1	15	0	0
8	23669821	.	G	A	1	5	6	0	9	15	0	0
8	23669885	.	G	T	6	6	12	0	1	13	0	0
8	23669933	.	C	A	4	6	10	0	0	10	0	0
8	23669968	.	C	T	6	5	11	0	0	11	0	0
8	23670019	.	T	C	2	3	5	0	0	5	0	0
8	23670115	.	T	C	2	2	4	0	0	4	0	0
8	23670202	.	A	G	6	4	10	0	0	10	0	0
8	23670246	.	T	G	6	0	6	0	3	9	0	0
8	23672802	.	A	G	2	4	6	0	0	6	0	0
8	23672812	.	G	A	2	4	6	0	0	6	0	0
8	23690989	.	C	G	2	2	4	0	0	4	0	0
8	23691751	.	G	C	2	2	4	0	0	4	0	0
8	23703739	.	C	T	10	5	15	0	0	15	0	0
8	23713578	.	T	C	3	4	7	0	0	7	0	0
8	23716979	.	G	T	8	5	13	0	0	13	0	0
8	23717117	.	C	A	6	3	9	0	0	9	0	0
8	23720518	.	A	G	4	5	9	0	0	9	0	0
8	23723723	.	G	A	1	5	6	0	1	7	0	0
8	23724620	.	G	A	0	6	6	0	2	8	0	0
8	23724752	.	A	T	2	3	5	0	0	5	0	0
8	23733221	.	C	T	4	2	6	0	1	7	0	0
8	23733248	.	C	A	5	2	7	0	1	8	0	0
8	23733260	.	C	T	4	2	6	0	2	8	0	0
8	23733413	.	G	A	4	3	7	0	0	7	0	0
8	23734414	.	G	A	1	7	8	0	2	10	0	0
8	23736063	.	G	A	1	9	10	0	2	12	0	0
8	23740148	.	T	C	8	8	16	0	0	16	0	0
8	23753934	.	G	A	2	5	7	0	0	7	0	0
8	23756089	.	A	T	7	6	13	0	1	14	0	0
8	23756188	.	C	T	5	2	7	0	1	8	0	0
8	23756536	.	C	G	1	10	11	0	8	19	0	0
8	23756557	.	G	A	10	8	18	0	1	19	0	0
8	23756680	.	T	A	11	11	22	0	1	23	0	0
8	23756749	.	G	C	5	10	15	0	0	15	0	0
8	23760288	.	C	T	0	4	4	0	7	11	0	0
8	23760297	.	C	T	1	7	8	0	2	10	0	0
8	23760323	.	G	A	4	6	10	0	0	10	0	0
8	23762559	.	A	G	2	4	6	0	0	6	0	0
8	23781358	.	G	C	2	3	5	0	0	5	0	0
8	23824498	.	G	A	1	2	3	0	0	3	0	0
8	23827610	.	C	T	11	6	17	0	0	17	0	0
8	23827617	.	G	A	11	6	17	0	0	17	0	0
8	23827670	.	C	T	10	8	18	0	0	18	0	0
8	23833257	.	G	A	6	5	11	1	0	12	0	0
8	23860641	.	G	T	1	4	5	0	6	11	0	0
8	23865804	.	A	C	10	12	22	0	0	22	0	0
8	23868598	.	T	C	11	9	20	0	0	20	0	0
8	23869978	.	C	T	15	6	21	0	0	21	0	0
8	23871782	.	C	T	10	6	16	0	1	17	0	0
8	23871978	.	T	C	10	5	15	1	0	16	0	0
8	23878994	.	G	A	12	11	23	0	1	24	0	0
8	23879461	.	C	T	5	4	9	0	0	9	0	0
8	23961168	.	G	T	5	6	11	0	0	11	0	0
8	24063987	.	T	C	7	5	12	0	0	12	0	0
8	24064017	.	G	A	6	6	12	0	0	12	0	0
8	24108899	.	T	C	3	2	5	0	0	5	0	0
8	24109195	.	A	T	6	10	16	0	0	16	0	0
8	24109317	.	T	A	7	5	12	0	0	12	0	0
8	24109336	.	A	G	6	7	13	0	0	13	0	0
8	24109399	.	A	G	4	12	16	0	1	17	0	0
8	24109496	.	C	T	1	7	8	0	12	20	0	0
8	24109561	.	C	T	6	8	14	0	1	15	0	0
8	24109562	.	T	C	7	8	15	0	0	15	0	0
8	24109693	.	A	G	9	17	26	0	0	26	0	0
8	24109787	.	C	T	8	9	17	0	2	19	0	0
8	24109860	.	G	A	8	4	12	0	1	13	0	0
8	24109879	.	G	A	4	10	14	0	0	14	0	0
8	24111082	.	T	C	6	8	14	0	0	14	0	0
8	24113044	.	C	A	12	5	17	1	1	19	0	0
8	24113075	.	A	G	7	6	13	0	1	14	0	0
8	24113420	.	A	G	6	8	14	0	1	15	0	0
8	24122960	.	C	A	0	9	9	0	6	15	0	0
8	24123161	.	G	T	6	5	11	0	0	11	0	0
8	24135019	.	C	T	9	6	15	0	0	15	0	0
8	24291866	.	C	T	2	2	4	0	0	4	0	0
8	24292976	.	C	T	1	3	4	0	0	4	0	0
8	24292987	.	C	T	1	3	4	0	0	4	0	0
8	24303896	.	T	A	5	3	8	0	0	8	0	0
8	24304440	.	G	A	0	2	2	0	1	3	0	0
8	24310532	.	T	G	2	3	5	0	1	6	0	0
8	24312973	.	A	T	1	2	3	0	0	3	0	0
8	24314382	.	G	A	0	3	3	0	3	6	0	0
8	24314430	.	C	T	1	3	4	0	0	4	0	0
8	24318472	.	G	A	1	5	6	3	0	9	0	0
8	24322223	.	G	A	3	4	7	0	0	7	0	0
8	24322229	.	G	T	2	4	6	0	0	7	1	0
8	24322446	.	C	T	5	2	7	0	0	7	0	0
8	24322489	.	T	C	2	7	9	0	0	9	0	0
8	24325254	.	G	A	8	7	15	0	0	15	0	0
8	24325363	.	A	G	4	4	8	0	0	8	0	0
8	24740093	.	T	A	4	5	9	0	1	10	0	0
8	24740094	.	A	C	5	4	9	0	1	10	0	0
8	24743696	.	T	G	4	0	4	0	10	14	0	0
8	24743756	.	A	C	2	4	6	0	0	6	0	0
8	24743823	.	C	A	3	4	7	0	0	7	0	0
8	24743874	.	G	A	0	2	2	0	1	3	0	0
8	24778560	.	G	A	1	3	4	0	0	4	0	0
8	24788514	.	C	T	10	9	19	0	1	20	0	0
8	24789174	.	C	T	4	10	14	0	0	14	0	0
8	24789324	.	C	T	2	10	12	0	6	18	0	0
8	24789513	.	T	G	11	13	24	0	1	25	0	0
8	24790017	.	G	A	6	9	15	0	1	16	0	0
8	24790194	.	A	G	13	8	21	0	0	21	0	0
8	24790724	.	C	T	16	5	21	0	3	24	0	0
8	24870426	.	C	T	16	9	25	0	3	28	0	0
8	24880220	.	G	A	11	17	28	0	0	28	0	0
8	24880304	.	C	T	18	12	30	0	1	31	0	0
8	24881058	.	T	C	13	18	31	0	0	31	0	0
8	24883433	.	G	A	3	23	26	0	13	39	0	0
8	24883873	.	C	T	16	11	27	0	0	27	0	0
8	24883963	.	C	A	12	10	22	0	2	24	0	0
8	24889230	.	G	A	3	22	25	0	29	54	0	0
8	24889468	.	C	T	14	22	36	0	0	36	0	0
8	24889674	.	C	T	17	22	39	0	2	41	0	0
8	24890238	.	T	A	22	18	40	0	0	40	0	0
8	24890891	.	C	T	26	15	41	0	1	42	0	0
8	24890913	.	T	G	17	21	38	0	0	38	0	0
8	24938274	.	C	T	5	6	11	0	0	11	0	0
8	24939910	.	A	T	3	5	8	0	0	8	0	0
8	24939940	.	G	A	6	6	12	0	0	12	0	0
8	24940083	.	A	G	5	3	8	0	0	8	0	0
8	24940165	.	C	T	3	5	8	0	0	8	0	0
8	24940282	.	G	A	1	2	3	0	0	3	0	0
8	24940303	.	G	A	1	2	3	0	1	4	0	0
8	24972107	.	T	A	15	19	34	0	1	35	0	0
8	24972119	.	G	T	18	17	35	0	2	37	0	0
8	24972413	.	A	C	7	7	14	0	0	14	0	0
8	24972665	.	T	C	18	12	30	0	2	32	0	0
8	24973010	.	T	A	13	20	33	0	1	34	0	0
8	24973088	.	G	C	12	12	24	0	0	24	0	0
8	24973116	.	C	G	15	12	27	0	1	28	0	0
8	24973239	.	T	A	14	14	28	0	0	28	0	0
8	24983245	.	C	G	2	25	27	0	26	54	1	0
8	24991082	.	G	T	14	18	32	0	1	33	0	0
8	24991127	.	G	A	15	14	29	0	1	30	0	0
8	25010904	.	C	A	0	22	22	0	21	43	0	0
8	25022506	.	C	T	0	4	4	0	7	11	0	0
8	25028646	.	A	G	6	2	8	0	0	8	0	0
8	25036367	.	A	T	13	6	19	0	0	19	0	0
8	25036493	.	C	T	3	3	6	0	0	6	0	0
8	25036679	.	T	A	10	3	13	0	1	14	0	0
8	25039840	.	T	C	4	5	9	0	0	9	0	0
8	25039967	.	C	A	7	4	11	0	0	11	0	0
8	25040295	.	A	G	4	6	10	0	1	11	0	0
8	25041986	.	G	A	4	6	10	0	0	10	0	0
8	25042269	.	T	C	9	8	17	0	1	18	0	0
8	25042275	.	T	C	11	9	20	0	0	20	0	0
8	25042328	.	A	G	18	9	27	0	0	27	0	0
8	25042352	.	G	A	13	6	19	0	1	20	0	0
8	25042447	.	T	C	8	9	17	0	1	18	0	0
8	25042474	.	T	C	10	0	10	0	7	17	0	0
8	25043112	.	T	G	9	7	16	0	3	19	0	0
8	25043125	.	A	G	8	9	17	0	1	18	0	0
8	25043167	.	A	T	7	15	22	0	0	22	0	0
8	25044564	.	C	G	1	14	15	0	8	23	0	0
8	25044591	.	C	T	0	12	12	0	12	24	0	0
8	25056207	.	A	G	11	6	17	0	2	19	0	0
8	25065675	.	T	A	14	7	21	0	1	22	0	0
8	25065762	.	A	G	13	8	21	0	0	21	0	0
8	25066100	.	C	T	5	15	20	0	1	21	0	0
8	25070634	.	T	C	4	0	4	0	8	12	0	0
8	25074028	.	T	C	6	15	21	0	3	24	0	0
8	25091546	.	G	T	5	8	13	0	0	13	0	0
8	25094247	.	G	A	0	5	5	0	11	16	0	0
8	25094248	.	A	T	10	5	15	0	1	16	0	0
8	25094288	.	C	T	5	3	8	0	0	8	0	0
8	25094326	.	A	C	5	4	9	0	1	10	0	0
8	25094389	.	A	G	4	0	4	0	9	13	0	0
8	25097206	.	T	C	5	3	8	0	1	9	0	0
8	25097431	.	G	A	2	5	7	0	0	7	0	0
8	25101435	.	G	A	5	3	8	0	1	9	0	0
8	25103407	.	C	T	9	12	21	0	1	22	0	0
8	25103581	.	C	T	5	5	10	0	0	10	0	0
8	25103801	.	A	G	3	0	3	0	6	9	0	0
8	25103887	.	G	A	5	5	10	0	0	10	0	0
8	25117759	.	A	G	11	9	20	0	1	21	0	0
8	25117981	.	G	A	18	17	35	0	0	35	0	0
8	25117990	.	T	C	19	16	35	0	0	35	0	0
8	25118128	.	C	T	11	12	23	0	1	24	0	0
8	25118164	.	C	A	11	18	29	0	3	32	0	0
8	25118587	.	A	G	12	10	22	0	0	22	0	0
8	25118608	.	A	T	10	10	20	0	0	20	0	0
8	25176197	.	C	T	16	9	25	0	0	25	0	0
8	25176257	.	T	C	8	12	20	0	1	21	0	0
8	25176303	.	A	G	10	11	21	0	1	22	0	0
8	25176677	.	T	C	9	5	14	0	0	14	0	0
8	25176957	.	C	G	2	4	6	0	0	6	0	0
8	25177264	.	G	C	6	8	14	0	1	15	0	0
8	25177285	.	A	G	4	8	12	0	0	12	0	0
8	25177501	.	T	G	8	6	14	0	0	14	0	0
8	25190442	.	C	T	3	2	5	0	0	5	0	0
8	25190513	.	C	T	5	2	7	0	0	7	0	0
8	25247355	.	A	G	11	0	11	0	4	15	0	0
8	25267833	.	T	C	16	22	38	0	1	39	0	0
8	25269942	.	G	A	6	7	13	0	0	13	0	0
8	25269993	.	G	A	7	6	13	0	4	17	0	0
8	25270753	.	G	C	0	12	12	0	7	19	0	0
8	25271544	.	T	C	7	10	17	0	1	18	0	0
8	25271550	.	G	A	3	9	12	0	6	18	0	0
8	25272575	.	T	C	12	9	21	0	1	22	0	0
8	25277047	.	G	A	3	19	22	0	16	38	0	0
8	25280530	.	T	C	15	18	33	0	0	33	0	0
8	25280807	.	C	T	8	13	21	0	0	21	0	0
8	25281877	.	A	G	12	0	12	0	6	18	0	0
8	25288980	.	T	C	14	12	26	0	0	26	0	0
8	25289156	.	A	G	10	0	10	0	11	21	0	0
8	25291308	.	C	T	11	21	32	0	0	32	0	0
8	25291742	.	A	C	18	13	31	0	1	32	0	0
8	25291839	.	T	C	14	25	39	0	1	40	0	0
8	25291876	.	A	G	15	24	39	0	1	40	0	0
8	25292020	.	A	T	24	17	41	0	1	42	0	0
8	25292274	.	G	A	2	12	14	0	10	24	0	0
8	25292330	.	C	T	9	14	23	0	0	23	0	0
8	25292407	.	G	T	11	15	26	0	0	26	0	0
8	25292667	.	G	T	15	17	32	0	1	33	0	0
8	25293008	.	A	G	20	13	33	0	0	33	0	0
8	25293145	.	C	T	21	18	39	0	1	40	0	0
8	25293275	.	A	G	19	0	19	0	16	35	0	0
8	25293445	.	T	C	3	2	5	0	0	5	0	0
8	25297371	.	T	C	22	13	35	4	1	40	0	0
8	25301350	.	A	G	5	3	8	0	2	10	0	0
8	25306230	.	C	T	2	3	5	0	0	5	0	0
8	25329981	.	A	T	9	3	12	0	1	13	0	0
8	25330229	.	G	A	12	6	18	0	0	18	0	0
8	25330334	.	T	A	14	8	22	0	1	23	0	0
8	25330367	.	A	C	16	6	22	0	0	22	0	0
8	25330498	.	G	A	20	28	48	0	1	49	0	0
8	25336175	.	A	G	3	2	5	0	1	6	0	0
8	25367091	.	C	T	3	5	8	0	0	8	0	0
8	25368451	.	A	G	5	2	7	0	0	7	0	0
8	25368613	.	G	A	3	6	9	0	2	11	0	0
8	25397537	.	A	G	4	3	7	0	0	7	0	0
8	25398628	.	A	T	1	2	3	0	0	3	0	0
8	25398679	.	T	C	2	0	2	0	7	9	0	0
8	25424375	.	C	A	9	7	16	0	0	16	0	0
8	25424558	.	A	G	10	4	14	0	1	15	0	0
8	25424734	.	T	A	5	3	8	0	0	8	0	0
8	25424741	.	C	T	1	5	6	0	4	10	0	0
8	25424865	.	T	A	8	5	13	0	2	15	0	0
8	25425033	.	T	C	6	8	14	0	0	14	0	0
8	25425103	.	A	G	6	4	10	0	0	10	0	0
8	25425137	.	C	T	3	4	7	0	0	7	0	0
8	25425311	.	T	C	1	5	6	0	0	6	0	0
8	25425391	.	C	T	7	6	13	0	0	13	0	0
8	25425453	.	G	A	5	4	9	0	0	9	0	0
8	25425621	.	T	A	2	2	4	0	0	4	0	0
8	25425749	.	T	C	3	2	5	0	0	5	0	0
8	25426321	.	A	G	5	2	7	0	0	7	0	0
8	25426338	.	T	G	3	2	5	0	0	5	0	0
8	25426405	.	G	A	6	5	11	0	0	11	0	0
8	25426521	.	T	A	3	3	6	0	0	6	0	0
8	25426563	.	T	G	4	3	7	0	0	7	0	0
8	25431300	.	T	C	5	0	5	0	7	12	0	0
8	25433771	.	A	G	5	2	7	0	0	7	0	0
8	25438858	.	C	A	1	4	5	0	2	7	0	0
8	25445451	.	A	G	4	3	7	0	0	7	0	0
8	25445553	.	A	G	5	2	7	0	0	7	0	0
8	25445604	.	C	T	1	2	3	0	3	6	0	0
8	25450326	.	A	G	5	6	11	0	0	11	0	0
8	25452003	.	G	A	7	4	11	0	0	11	0	0
8	25452117	.	T	C	4	3	7	0	0	7	0	0
8	25455977	.	C	T	0	2	2	0	6	8	0	0
8	25497525	.	G	A	4	4	8	0	0	8	0	0
8	25566019	.	C	G	4	2	6	1	1	8	0	0
8	25566055	.	A	G	6	2	8	0	0	8	0	0
8	25591038	.	C	A	2	2	4	0	0	4	0	0
8	25591187	.	T	C	1	0	1	0	2	3	0	0
8	25591256	.	A	G	2	2	4	0	0	4	0	0
8	25591640	.	A	G	6	4	10	0	0	10	0	0
8	25623778	.	C	T	1	2	3	0	0	3	0	0
8	25650386	.	A	G	2	3	5	0	0	5	0	0
8	25659531	.	A	G	1	2	3	0	0	3	0	0
8	25708311	.	C	T	3	3	6	0	0	6	0	0
8	25708547	.	G	T	1	3	4	0	0	4	0	0
8	25708998	.	C	T	3	7	10	0	0	10	0	0
8	25709085	.	T	G	12	13	25	0	3	28	0	0
8	25709426	.	G	T	4	7	11	0	1	12	0	0
8	25709521	.	T	A	11	4	15	0	1	16	0	0
8	25709522	.	A	C	12	4	16	0	0	16	0	0
8	25713035	.	T	A	7	14	21	0	0	21	0	0
8	25715118	.	A	C	12	2	14	0	10	24	0	0
8	25715181	.	C	T	10	9	19	0	1	20	0	0
8	25715325	.	G	C	6	4	10	0	7	17	0	0
8	25715950	.	C	A	6	8	14	0	1	15	0	0
8	25716000	.	C	A	12	9	21	0	1	22	0	0
8	25717126	.	C	T	2	2	4	0	1	5	0	0
8	25734814	.	C	A	9	4	13	0	2	15	0	0
8	25734892	.	G	A	7	5	12	0	0	12	0	0
8	25745877	.	T	A	8	10	18	0	1	19	0	0
8	25745915	.	A	T	5	6	11	0	0	11	0	0
8	25746125	.	C	T	8	12	20	0	0	20	0	0
8	25746183	.	G	A	1	8	9	0	12	21	0	0
8	25746213	.	A	G	12	0	12	0	11	23	0	0
8	25746376	.	G	A	8	10	18	0	0	18	0	0
8	25746508	.	A	G	10	3	13	0	0	13	0	0
8	25746535	.	C	A	9	4	13	0	0	13	0	0
8	25746606	.	C	T	6	8	14	0	1	15	0	0
8	25746650	.	T	G	5	6	11	0	0	11	0	0
8	25746684	.	C	T	2	4	6	0	1	7	0	0
8	25746788	.	C	G	8	6	14	0	1	15	0	0
8	25746881	.	A	G	8	6	14	0	0	14	0	0
8	25746909	.	A	C	4	7	11	0	1	12	0	0
8	25746923	.	T	C	6	8	14	0	0	14	0	0
8	25746999	.	G	A	0	13	13	0	8	21	0	0
8	25747028	.	T	A	5	6	11	0	3	14	0	0
8	25747202	.	A	C	8	11	19	0	0	19	0	0
8	25747365	.	T	C	14	6	20	0	1	21	0	0
8	25747425	.	A	T	10	16	26	0	0	26	0	0
8	25747502	.	T	C	14	5	19	0	0	19	0	0
8	25747518	.	T	C	10	5	15	0	0	15	0	0
8	25747644	.	T	G	7	7	14	0	2	16	0	0
8	25747704	.	C	A	8	9	17	0	0	17	0	0
8	25747705	.	A	G	7	9	16	0	1	17	0	0
8	25747993	.	G	A	0	12	12	0	8	20	0	0
8	25748047	.	G	A	1	10	11	0	9	20	0	0
8	25748185	.	T	C	8	4	12	0	4	16	0	0
8	25748244	.	G	A	5	6	11	0	1	12	0	0
8	25748329	.	A	T	10	4	14	0	0	14	0	0
8	25748330	.	T	A	10	3	13	0	1	14	0	0
8	25748405	.	T	C	15	10	25	0	0	25	0	0
8	25748434	.	G	A	13	13	26	0	0	26	0	0
8	25748562	.	T	A	13	9	22	0	0	22	0	0
8	25748685	.	G	A	5	4	9	0	0	9	0	0
8	25751167	.	A	G	11	2	13	0	8	21	0	0
8	25751348	.	A	T	3	4	7	0	0	7	0	0
8	25751367	.	T	C	1	3	4	0	0	4	0	0
8	25765640	.	T	A	10	9	19	0	0	19	0	0
8	25766249	.	A	G	2	3	5	0	0	5	0	0
8	25805481	.	C	T	2	2	4	0	0	4	0	0
8	25805492	.	G	A	0	2	2	0	2	4	0	0
8	25812113	.	G	A	14	5	19	0	0	19	0	0
8	25812324	.	A	G	15	13	28	0	4	32	0	0
8	25812327	.	G	A	12	16	28	0	4	32	0	0
8	25813904	.	A	G	15	20	35	0	0	35	0	0
8	25813937	.	G	T	14	17	31	0	1	32	0	0
8	25816849	.	G	A	22	17	39	0	0	39	0	0
8	25816863	.	G	A	17	20	37	0	0	37	0	0
8	25816959	.	G	T	23	20	43	0	1	44	0	0
8	25818836	.	C	T	1	13	14	4	16	34	0	0
8	25819090	.	G	T	15	8	23	0	0	23	0	0
8	25819128	.	A	G	11	6	17	0	0	17	0	0
8	25819137	.	T	C	7	4	11	0	0	11	0	0
8	25819172	.	T	A	6	2	8	0	0	8	0	0
8	25819478	.	G	A	13	8	21	0	0	21	0	0
8	25820884	.	G	T	6	2	8	0	1	9	0	0
8	25820917	.	G	T	5	9	14	0	1	15	0	0
8	25821105	.	T	A	9	7	16	0	0	16	0	0
8	25821140	.	G	A	8	15	23	0	0	23	0	0
8	25821426	.	T	C	27	16	43	0	0	43	0	0
8	25845780	.	C	T	23	16	39	0	0	39	0	0
8	25845885	.	G	C	18	19	37	0	1	38	0	0
8	25858618	.	C	T	1	3	4	0	1	5	0	0
8	25863441	.	C	T	0	2	2	0	3	5	0	0
8	25892736	.	A	C	3	7	10	0	0	10	0	0
8	25893862	.	C	T	8	5	13	0	0	13	0	0
8	25894222	.	G	A	1	8	9	0	10	19	0	0
8	25894300	.	C	T	10	14	24	0	0	24	0	0
8	25897145	.	T	A	10	12	22	1	0	23	0	0
8	25897287	.	C	T	8	7	15	0	0	15	0	0
8	25897373	.	G	A	1	5	6	0	4	10	0	0
8	25897378	.	C	T	5	5	10	0	0	10	0	0
8	25897489	.	G	A	5	5	10	0	1	11	0	0
8	25897694	.	C	T	3	3	6	0	0	6	0	0
8	25898011	.	T	A	1	5	6	0	0	6	0	0
8	25902319	.	C	T	21	26	47	0	1	48	0	0
8	25902970	.	T	A	29	21	50	0	3	53	0	0
8	25905524	.	T	A	23	16	39	0	1	40	0	0
8	25905686	.	T	A	23	17	40	0	0	40	0	0
8	25905744	.	T	G	23	21	44	0	1	45	0	0
8	25913795	.	A	C	1	3	4	0	0	4	0	0
8	25913896	.	C	T	5	4	9	0	0	9	0	0
8	25925483	.	G	A	1	11	12	1	5	18	0	0
8	25925497	.	G	A	9	5	14	1	0	15	0	0
8	25927455	.	C	T	8	5	13	0	1	14	0	0
8	25927472	.	C	T	5	9	14	0	0	14	0	0
8	25927496	.	G	A	1	6	7	0	6	13	0	0
8	25927539	.	C	A	8	10	18	0	0	18	0	0
8	25940273	.	A	G	7	8	15	0	0	15	0	0
8	25948519	.	A	C	8	8	16	0	0	16	0	0
8	25950577	.	G	A	3	12	15	0	2	17	0	0
8	25950704	.	G	C	7	6	13	0	2	15	0	0
8	25950707	.	G	C	8	9	17	0	1	18	0	0
8	25950772	.	G	A	12	11	23	0	2	25	0	0
8	25950803	.	G	A	0	13	13	0	8	21	0	0
8	25950877	.	C	T	12	14	26	0	2	28	0	0
8	25950880	.	G	T	17	12	29	0	0	29	0	0
8	25950999	.	G	A	1	11	12	0	21	33	0	0
8	25951265	.	A	T	14	9	23	0	0	23	0	0
8	25951293	.	A	T	18	9	27	0	0	27	0	0
8	25951473	.	A	T	12	12	24	0	0	24	0	0
8	25951517	.	C	T	11	8	19	0	0	19	0	0
8	25951575	.	A	T	3	5	8	0	0	8	0	0
8	25951660	.	G	T	6	4	10	0	0	10	0	0
8	25951665	.	T	A	5	6	11	0	0	11	0	0
8	25951762	.	C	T	12	8	20	0	0	20	0	0
8	25951804	.	A	G	5	6	11	0	0	11	0	0
8	25951806	.	A	T	5	6	11	0	0	11	0	0
8	25960115	.	G	A	0	2	2	0	1	3	0	0
8	25963150	.	A	G	7	12	19	0	2	21	0	0
8	25963151	.	C	A	9	12	21	0	1	22	0	0
8	25963223	.	A	C	9	12	21	0	0	21	0	0
8	25964397	.	A	C	15	15	30	0	0	30	0	0
8	25964398	.	T	C	13	15	28	0	2	30	0	0
8	25969188	.	C	T	15	11	26	0	1	27	0	0
8	25969466	.	C	T	10	9	19	0	0	19	0	0
8	25969498	.	A	G	11	7	18	0	1	19	0	0
8	25969506	.	G	A	0	10	10	0	12	22	0	0
8	25969778	.	T	A	6	6	12	0	1	13	0	0
8	25970719	.	A	T	10	7	17	0	0	17	0	0
8	25970772	.	A	G	12	8	20	0	2	22	0	0
8	25970816	.	G	T	11	7	18	0	1	19	0	0
8	25970932	.	G	A	12	11	23	0	0	23	0	0
8	25971143	.	C	A	7	5	12	0	6	18	0	0
8	25971306	.	T	A	15	11	26	0	2	28	0	0
8	25971367	.	C	T	6	10	16	0	0	16	0	0
8	26019075	.	G	A	1	2	3	0	1	4	0	0
8	26019123	.	G	C	3	3	6	0	0	6	0	0
8	26019765	.	G	A	0	3	3	0	2	5	0	0
8	26025040	.	T	C	4	6	10	0	1	11	0	0
8	26030223	.	C	T	8	7	15	0	0	15	0	0
8	26030226	.	G	A	8	7	15	0	0	15	0	0
8	26030739	.	T	A	2	2	4	0	1	5	0	0
8	26030852	.	A	G	1	5	6	0	0	6	0	0
8	26034676	.	C	T	12	18	30	0	0	30	0	0
8	26038309	.	G	A	20	10	30	0	0	30	0	0
8	26046168	.	G	C	0	10	10	0	8	18	0	0
8	26056801	.	G	A	27	18	45	0	0	45	0	0
8	26056891	.	T	G	29	20	49	1	4	54	0	0
8	26057130	.	T	C	23	14	37	0	2	39	0	0
8	26059717	.	T	G	9	5	14	0	3	17	0	0
8	26066234	.	C	T	9	7	16	0	1	17	0	0
8	26073777	.	G	A	4	4	8	0	0	8	0	0
8	26075413	.	T	C	8	8	16	0	0	16	0	0
8	26075518	.	C	T	3	6	9	0	2	11	0	0
8	26078551	.	C	T	16	12	28	0	0	28	0	0
8	26078898	.	C	A	4	5	9	0	0	9	0	0
8	26083987	.	C	T	10	10	20	0	0	20	0	0
8	26091767	.	C	T	9	16	25	0	2	27	0	0
8	26091939	.	G	A	1	9	10	0	13	23	0	0
8	26092050	.	A	G	19	18	37	0	1	38	0	0
8	26093660	.	G	A	10	4	14	0	1	15	0	0
8	26095683	.	G	A	22	10	32	0	1	33	0	0
8	26097321	.	C	T	18	23	41	0	0	41	0	0
8	26097744	.	G	T	1	8	9	0	4	13	0	0
8	26097881	.	T	C	3	8	11	0	0	11	0	0
8	26097895	.	C	A	8	5	13	0	0	13	0	0
8	26097966	.	C	T	9	5	14	0	0	14	0	0
8	26125496	.	T	C	6	4	10	0	0	10	0	0
8	26125649	.	T	C	4	3	7	0	0	7	0	0
8	26125896	.	T	C	3	2	5	0	0	5	0	0
8	26126279	.	G	T	3	4	7	0	1	8	0	0
8	26126672	.	T	C	6	3	9	0	1	10	0	0
8	26126711	.	T	G	2	6	8	0	0	8	0	0
8	26126732	.	A	G	2	0	2	0	7	9	0	0
8	26126765	.	C	A	5	4	9	0	0	9	0	0
8	26127590	.	A	G	1	2	3	0	0	3	0	0
8	26127764	.	G	A	0	6	6	0	4	10	0	0
8	26151750	.	G	T	8	4	12	0	1	13	0	0
8	26166320	.	C	T	5	6	11	0	0	11	0	0
8	26176023	.	G	A	4	5	9	0	0	9	0	0
8	26176125	.	T	C	5	6	11	0	0	11	0	0
8	26179738	.	T	C	5	10	15	0	2	18	1	0
8	26185498	.	G	C	6	5	11	0	0	11	0	0
8	26189449	.	G	A	2	6	8	0	6	14	0	0
8	26192708	.	G	A	0	12	12	0	9	21	0	0
8	26192798	.	C	T	4	4	8	0	1	9	0	0
8	26192936	.	C	T	3	6	9	0	0	9	0	0
8	26203373	.	C	T	7	7	14	0	0	14	0	0
8	26205537	.	C	T	7	5	12	0	0	12	0	0
8	26208387	.	T	C	8	9	17	0	0	17	0	0
8	26221228	.	C	T	0	4	4	0	2	6	0	0
8	26226146	.	G	T	2	3	5	0	0	5	0	0
8	26226397	.	T	C	2	2	4	0	0	4	0	0
8	26230167	.	G	T	2	3	5	0	0	5	0	0
8	26233133	.	A	G	3	3	6	0	0	6	0	0
8	26233287	.	G	A	1	5	6	0	0	6	0	0
8	26233584	.	C	A	1	3	4	0	0	4	0	0
8	26234078	.	G	A	5	6	11	0	0	11	0	0
8	26234154	.	G	A	6	3	9	0	0	9	0	0
8	26234169	.	G	A	4	4	8	0	1	9	0	0
8	26234207	.	T	C	4	5	9	0	0	9	0	0
8	26234225	.	G	A	3	3	6	0	1	7	0	0
8	26234599	.	A	T	4	6	10	0	0	10	0	0
8	26234703	.	C	T	4	2	6	0	0	6	0	0
8	26235117	.	A	C	4	4	8	0	0	8	0	0
8	26235275	.	C	T	3	3	6	0	1	7	0	0
8	26235323	.	T	C	6	3	9	0	0	9	0	0
8	26235554	.	C	T	6	4	10	0	1	11	0	0
8	26235560	.	T	G	6	4	10	0	0	10	0	0
8	26283388	.	C	T	1	4	5	0	0	5	0	0
8	26292594	.	G	T	7	12	19	0	0	19	0	0
8	26317376	.	T	C	15	14	29	0	2	31	0	0
8	26321296	.	C	T	16	17	33	0	1	34	0	0
8	26321359	.	G	A	22	16	38	0	1	39	0	0
8	26323458	.	A	T	13	13	26	0	1	27	0	0
8	26323511	.	T	A	16	9	25	0	0	25	0	0
8	26323893	.	A	T	1	3	4	0	0	4	0	0
8	26324575	.	G	C	5	3	8	0	0	8	0	0
8	26324584	.	A	T	5	5	10	0	0	10	0	0
8	26324647	.	A	T	9	8	17	0	1	18	0	0
8	26325519	.	A	T	17	16	33	0	0	33	0	0
8	26325600	.	T	C	14	22	36	0	2	38	0	0
8	26325679	.	C	T	17	22	39	0	1	40	0	0
8	26325680	.	G	A	23	16	39	0	1	40	0	0
8	26325888	.	G	A	3	11	14	0	22	36	0	0
8	26326046	.	G	A	20	19	39	0	0	39	0	0
8	26326152	.	T	C	22	23	45	0	0	45	0	0
8	26330047	.	A	C	12	6	18	0	2	20	0	0
8	26330134	.	A	T	19	8	27	0	0	27	0	0
8	26330352	.	T	A	14	6	20	0	2	22	0	0
8	26330545	.	C	T	13	14	27	0	0	27	0	0
8	26360974	.	G	T	16	23	39	0	1	40	0	0
8	26361294	.	G	A	14	17	31	0	2	33	0	0
8	26368150	.	C	T	21	23	44	2	0	46	0	0
8	26368356	.	G	A	3	13	16	0	17	33	0	0
8	26368446	.	A	T	4	3	7	0	1	8	0	0
8	26369055	.	C	T	2	5	7	0	1	8	0	0
8	26386415	.	A	G	1	4	5	0	0	5	0	0
8	26417276	.	C	T	3	4	7	0	0	7	0	0
8	26424873	.	A	G	6	7	13	0	0	13	0	0
8	26426478	.	G	A	6	7	13	0	1	14	0	0
8	26426487	.	G	A	3	8	11	0	0	11	0	0
8	26426621	.	C	T	7	5	12	0	2	14	0	0
8	26432720	.	A	T	1	2	3	0	2	5	0	0
8	26432930	.	A	T	1	2	3	0	0	3	0	0
8	26432974	.	A	T	2	2	4	0	0	4	0	0
8	26433849	.	A	G	7	7	14	0	1	15	0	0
8	26435187	.	G	A	5	8	13	0	1	14	0	0
8	26436030	.	A	G	5	7	12	0	0	12	0	0
8	26438912	.	A	G	6	5	11	0	0	11	0	0
8	26439033	.	C	T	2	7	9	0	0	9	0	0
8	26439101	.	G	T	3	3	6	0	0	6	0	0
8	26442442	.	A	T	2	3	5	0	1	6	0	0
8	26444759	.	A	T	2	6	8	0	0	8	0	0
8	26444877	.	C	T	5	2	7	0	0	7	0	0
8	26444892	.	T	A	6	2	8	0	0	8	0	0
8	26445037	.	T	C	8	6	14	0	0	14	0	0
8	26445075	.	T	C	7	6	13	0	0	13	0	0
8	26445100	.	G	T	5	5	10	0	1	11	0	0
8	26445166	.	G	A	0	5	5	0	2	7	0	0
8	26445184	.	A	T	5	3	8	0	0	8	0	0
8	26447468	.	G	A	1	3	4	0	0	4	0	0
8	26449218	.	A	T	2	3	5	0	0	5	0	0
8	26449383	.	G	A	2	2	4	0	1	5	0	0
8	27623973	.	A	G	16	1	17	0	19	36	0	0
8	28066077	.	T	A	7	10	17	0	2	19	0	0
8	28066167	.	G	A	14	10	24	0	1	25	0	0
8	28066168	.	C	A	14	10	24	0	1	25	0	0
8	28224987	.	G	A	18	14	32	0	1	33	0	0
8	28229971	.	C	T	16	19	35	0	2	37	0	0
8	28232496	.	G	A	10	16	26	0	1	27	0	0
8	28232512	.	G	T	16	8	24	0	1	25	0	0
8	28232557	.	T	A	9	16	25	0	3	28	0	0
8	28232745	.	G	T	16	16	32	0	3	35	0	0
8	28232812	.	G	T	13	10	23	0	4	32	5	0
8	28243292	.	A	G	1	2	3	0	0	3	0	0
8	28243437	.	A	G	3	5	8	0	0	8	0	0
8	28243707	.	C	G	4	8	12	0	1	13	0	0
8	28243830	.	T	G	1	4	5	0	0	5	0	0
8	28244063	.	C	T	3	2	5	0	0	5	0	0
8	28244076	.	C	T	4	2	6	0	0	6	0	0
8	28244193	.	G	A	8	3	11	0	0	11	0	0
8	28244267	.	C	A	5	3	8	0	0	8	0	0
8	28248692	.	G	T	1	5	6	0	0	6	0	0
8	28251839	.	C	T	3	3	6	0	0	6	0	0
8	28252294	.	A	G	3	3	6	0	0	6	0	0
8	28256577	.	T	C	2	2	4	0	0	4	0	0
8	28256649	.	A	C	2	0	2	0	3	5	0	0
8	28256727	.	A	G	1	2	3	0	0	3	0	0
8	28313256	.	G	A	11	20	31	0	2	33	0	0
8	28315258	.	A	G	18	13	31	0	0	31	0	0
8	28315301	.	T	C	15	0	15	0	16	31	0	0
8	28315378	.	A	G	11	16	27	0	0	27	0	0
8	28315424	.	C	G	11	10	21	0	1	22	0	0
8	28315436	.	G	T	11	10	21	0	0	22	1	0
8	28315481	.	A	G	9	14	23	0	0	23	0	0
8	28315694	.	A	G	11	10	21	0	1	22	0	0
8	28315699	.	A	G	9	13	22	0	0	22	0	0
8	28317748	.	A	T	15	13	28	0	0	28	0	0
8	28317844	.	T	C	8	0	8	0	10	18	0	0
8	28323403	.	C	A	2	15	17	0	15	32	0	0
8	28323442	.	A	G	11	17	28	0	0	28	0	0
8	28346143	.	A	G	3	1	4	0	0	4	0	0
8	28346146	.	C	T	3	2	5	0	0	5	0	0
8	28346284	.	G	A	7	7	14	0	0	14	0	0
8	28346569	.	A	G	5	10	15	0	1	16	0	0
8	28346656	.	A	G	3	2	5	0	1	6	0	0
8	28346659	.	G	C	4	2	6	0	1	7	0	0
8	28346701	.	A	C	5	6	11	0	0	11	0	0
8	28351147	.	T	A	4	4	8	0	0	8	0	0
8	28351678	.	T	C	7	2	9	0	0	9	0	0
8	28351679	.	C	T	6	2	8	0	0	8	0	0
8	28358501	.	C	A	12	12	24	0	1	25	0	0
8	28359559	.	T	C	12	19	31	0	0	31	0	0
8	28364854	.	G	A	1	8	9	0	16	25	0	0
8	28364923	.	T	A	17	17	34	0	0	35	1	0
8	28365119	.	C	T	10	4	14	0	1	15	0	0
8	28365328	.	A	T	4	7	11	0	0	11	0	0
8	28365361	.	C	T	5	4	9	0	0	9	0	0
8	28365417	.	A	G	4	5	9	0	1	10	0	0
8	28365479	.	C	T	5	5	10	0	1	11	0	0
8	28365496	.	C	A	5	3	8	0	0	8	0	0
8	28379249	.	G	A	0	4	4	0	3	7	0	0
8	28379375	.	T	A	2	7	9	0	0	9	0	0
8	28383189	.	G	A	4	6	10	0	0	10	0	0
8	28399297	.	T	A	5	4	9	0	0	9	0	0
8	28399580	.	T	A	7	6	13	0	0	13	0	0
8	28399625	.	A	C	7	9	16	0	1	17	0	0
8	28399672	.	A	G	9	10	19	0	0	19	0	0
8	28400338	.	G	T	3	10	13	0	0	13	0	0
8	28401003	.	C	A	4	7	11	0	1	12	0	0
8	28404364	.	C	T	4	3	7	0	0	7	0	0
8	28406481	.	G	A	3	7	10	0	0	10	0	0
8	28449176	.	A	G	3	9	12	0	0	12	0	0
8	28457220	.	C	T	9	5	14	0	1	15	0	0
8	28463137	.	C	T	5	3	8	0	0	8	0	0
8	28463373	.	A	T	4	5	9	0	0	9	0	0
8	28463551	.	T	G	4	0	4	0	3	7	0	0
8	28463587	.	T	C	7	8	15	0	0	15	0	0
8	28463785	.	A	T	5	10	15	0	1	16	0	0
8	28464556	.	C	T	3	12	15	0	0	15	0	0
8	28527921	.	G	A	1	3	4	0	0	4	0	0
8	28528277	.	A	T	13	11	24	0	1	25	0	0
8	28532166	.	G	A	1	6	7	0	5	12	0	0
8	28532304	.	C	T	8	9	17	0	0	17	0	0
8	28532490	.	C	T	9	9	18	0	2	20	0	0
8	28532715	.	C	T	10	9	19	0	0	19	0	0
8	28547745	.	T	C	3	4	7	0	0	7	0	0
8	28594221	.	G	A	4	3	7	0	0	7	0	0
8	28654619	.	A	G	1	2	3	0	0	3	0	0
8	28724810	.	C	T	5	2	7	0	0	7	0	0
8	28726907	.	C	G	6	4	10	0	1	11	0	0
8	28726914	.	G	A	4	7	11	0	0	11	0	0
8	28727282	.	T	A	2	2	4	0	0	4	0	0
8	28727396	.	A	G	7	3	10	0	0	10	0	0
8	28727546	.	G	T	1	7	8	0	3	11	0	0
8	28727828	.	G	T	4	4	8	0	0	8	0	0
8	28727972	.	A	G	3	0	3	0	4	7	0	0
8	28772494	.	G	A	0	5	5	0	3	8	0	0
8	28868120	.	G	A	0	4	4	0	4	8	0	0
8	28868137	.	A	G	2	0	2	0	6	8	0	0
8	28868245	.	T	C	3	5	8	0	0	8	0	0
8	28868416	.	G	A	0	6	6	0	10	16	0	0
8	28900870	.	G	T	0	9	9	0	12	21	0	0
8	28901165	.	C	T	12	9	21	0	0	21	0	0
8	29267122	.	A	C	15	14	29	1	1	31	0	0
8	29267218	.	C	T	16	13	29	0	0	29	0	0
8	29267269	.	T	C	8	12	20	0	0	20	0	0
8	29285574	.	T	C	10	18	28	0	1	29	0	0
8	29336744	.	C	A	13	10	23	0	0	23	0	0
8	29336828	.	C	T	10	12	22	0	0	22	0	0
8	29427894	.	C	T	14	12	26	0	1	27	0	0
8	29427918	.	G	A	2	19	21	0	6	27	0	0
8	29427954	.	T	C	21	8	29	0	0	29	0	0
8	29428071	.	G	A	1	16	17	2	14	33	0	0
8	29428110	.	C	T	14	14	28	2	2	32	0	0
8	29476190	.	T	C	10	14	24	0	0	24	0	0
8	29587232	.	C	T	25	15	40	0	0	41	1	0
8	29640595	.	G	A	1	4	5	0	2	7	0	0
8	29644115	.	A	G	4	4	8	0	0	8	0	0
8	29644195	.	G	A	1	3	4	0	1	5	0	0
8	29644438	.	C	A	2	5	7	0	0	7	0	0
8	29644838	.	T	A	3	3	6	0	0	6	0	0
8	29644845	.	C	T	4	3	7	0	0	7	0	0
8	29645127	.	G	A	1	6	7	0	0	7	0	0
8	29647473	.	G	T	5	6	11	0	0	11	0	0
8	29647488	.	A	T	4	5	9	0	1	10	0	0
8	29647694	.	C	T	5	2	7	0	0	7	0	0
8	29651670	.	G	A	4	8	12	0	0	12	0	0
8	29651951	.	A	G	7	7	14	0	1	15	0	0
8	29652100	.	A	G	3	0	3	0	4	7	0	0
8	29652143	.	A	G	3	4	7	0	0	7	0	0
8	29652174	.	G	A	4	4	8	0	0	8	0	0
8	29710722	.	G	A	6	5	11	0	0	11	0	0
8	29710888	.	A	G	6	5	11	0	1	12	0	0
8	29710891	.	C	T	6	6	12	0	0	12	0	0
8	29711803	.	T	G	4	2	6	0	0	6	0	0
8	29718974	.	G	T	2	8	10	0	1	11	0	0
8	29734525	.	T	A	3	4	7	0	1	8	0	0
8	29742483	.	C	T	13	5	18	0	0	18	0	0
8	29742498	.	A	G	2	6	8	0	0	8	0	0
8	29749008	.	C	T	6	4	10	0	0	10	0	0
8	29749112	.	T	G	6	5	11	0	1	12	0	0
8	29749346	.	C	T	2	7	9	0	0	9	0	0
8	29758522	.	G	A	0	6	6	1	9	16	0	0
8	29759705	.	C	T	6	6	12	0	1	13	0	0
8	29759726	.	A	C	6	5	11	0	0	11	0	0
8	29760980	.	G	A	0	7	7	1	6	15	1	0
8	29763383	.	A	G	8	0	8	1	8	17	0	0
8	29763621	.	G	T	7	14	21	0	0	21	0	0
8	29763812	.	G	C	15	5	20	0	0	20	0	0
8	29763822	.	A	G	4	0	4	0	16	20	0	0
8	29763954	.	A	G	9	12	21	0	0	21	0	0
8	29764103	.	G	A	5	9	14	0	1	15	0	0
8	29764150	.	A	T	9	7	16	0	1	17	0	0
8	29764695	.	G	T	3	2	5	0	1	6	0	0
8	29764789	.	A	G	2	2	4	0	0	4	0	0
8	29764843	.	A	G	7	4	11	0	0	11	0	0
8	29764926	.	T	C	8	5	13	0	0	13	0	0
8	29765010	.	G	C	0	8	8	0	5	13	0	0
8	29765016	.	C	T	4	7	11	0	0	11	0	0
8	29765219	.	G	C	5	4	9	0	1	10	0	0
8	29765235	.	G	T	5	5	10	0	1	11	0	0
8	29765429	.	C	A	8	4	12	0	0	12	0	0
8	29765453	.	G	A	2	7	9	0	2	11	0	0
8	29765472	.	A	G	3	5	8	0	1	9	0	0
8	29765493	.	A	G	4	2	6	0	0	6	0	0
8	29766087	.	A	T	2	2	4	0	0	4	0	0
8	29766516	.	T	C	1	2	3	0	0	3	0	0
8	29770185	.	C	T	12	9	21	0	1	22	0	0
8	29770207	.	G	A	16	17	33	0	3	36	0	0
8	29770592	.	G	A	29	13	42	3	2	47	0	0
8	29770734	.	T	A	25	21	46	0	2	48	0	0
8	29770771	.	A	C	24	19	43	0	1	44	0	0
8	29770775	.	A	T	26	19	45	0	0	45	0	0
8	29771013	.	G	A	24	16	40	0	0	40	0	0
8	29771032	.	T	A	24	11	35	0	1	36	0	0
8	29771173	.	G	A	13	21	34	0	0	34	0	0
8	29771336	.	T	C	6	0	6	0	18	24	0	0
8	29771773	.	C	T	0	2	2	0	5	7	0	0
8	29772076	.	T	A	6	3	9	0	0	9	0	0
8	29772253	.	G	A	20	13	33	0	0	33	0	0
8	29772268	.	T	C	23	13	36	0	0	36	0	0
8	29772489	.	T	A	1	2	3	0	0	3	0	0
8	29772933	.	C	T	1	17	18	0	7	25	0	0
8	29773164	.	G	A	15	20	35	0	1	36	0	0
8	29773263	.	G	A	17	18	35	1	0	36	0	0
8	29773329	.	C	A	12	10	22	0	1	23	0	0
8	29773444	.	A	G	26	24	50	0	1	51	0	0
8	29774042	.	C	G	0	14	14	0	24	38	0	0
8	29774309	.	A	T	26	15	41	0	5	46	0	0
8	29774370	.	T	A	13	15	28	0	1	30	1	0
8	29774570	.	C	T	15	12	27	0	2	29	0	0
8	29774747	.	A	T	6	6	12	0	0	12	0	0
8	29774827	.	C	T	0	13	13	0	6	19	0	0
8	29775340	.	A	T	20	11	31	0	1	32	0	0
8	29775342	.	T	A	16	17	33	0	3	36	0	0
8	29787292	.	C	T	1	13	14	0	14	28	0	0
8	29793782	.	A	G	14	15	29	0	2	31	0	0
8	29799045	.	C	T	25	9	34	0	0	34	0	0
8	29799192	.	T	C	18	2	20	0	20	40	0	0
8	29801150	.	C	G	23	23	46	0	2	48	0	0
8	29806615	.	G	A	16	12	28	0	1	29	0	0
8	29819604	.	C	T	2	14	16	0	15	31	0	0
8	29819610	.	C	T	13	16	29	0	1	30	0	0
8	29851592	.	T	G	10	16	26	0	1	27	0	0
8	29865886	.	C	T	2	2	4	0	0	4	0	0
8	29871737	.	C	A	3	3	6	0	0	6	0	0
8	29875544	.	A	T	4	2	6	0	0	6	0	0
8	29875559	.	A	T	2	4	6	0	0	6	0	0
8	29875593	.	C	G	3	4	7	0	0	7	0	0
8	29899027	.	G	A	4	8	12	0	0	12	0	0
8	29899082	.	C	T	0	9	9	0	3	12	0	0
8	29899087	.	G	C	3	0	3	0	8	11	0	0
8	29899117	.	G	A	6	9	15	0	1	16	0	0
8	29899209	.	T	C	6	3	9	0	2	11	0	0
8	29899248	.	T	C	6	10	16	0	0	16	0	0
8	29899318	.	T	C	10	4	14	0	0	14	0	0
8	29899477	.	C	G	4	6	10	0	0	10	0	0
8	29899543	.	A	G	7	6	13	0	0	13	0	0
8	29904949	.	G	A	4	3	7	0	0	7	0	0
8	29904952	.	C	A	3	3	6	0	0	6	0	0
8	29907396	.	C	T	2	3	5	0	0	5	0	0
8	29907648	.	A	C	2	5	7	0	0	7	0	0
8	29911381	.	G	T	5	5	10	0	0	10	0	0
8	29913358	.	T	A	1	2	3	0	0	3	0	0
8	29986293	.	G	A	1	2	3	1	0	4	0	0
8	30016888	.	C	T	3	3	6	0	0	6	0	0
8	30021383	.	C	T	4	2	6	0	0	6	0	0
8	30021416	.	A	G	2	0	2	0	4	6	0	0
8	30021816	.	G	A	3	4	7	0	1	8	0	0
8	30022393	.	G	T	4	2	6	0	0	6	0	0
8	30047510	.	C	T	3	3	6	0	0	6	0	0
8	30062679	.	A	G	5	5	10	0	0	10	0	0
8	30063293	.	G	A	0	4	4	0	5	9	0	0
8	30065903	.	G	A	3	3	6	0	0	6	0	0
8	30159394	.	G	C	2	2	4	0	1	5	0	0
8	30326441	.	C	T	1	3	4	0	0	4	0	0
8	30326594	.	T	C	3	2	5	0	0	5	0	0
8	30330694	.	A	T	7	5	12	0	0	12	0	0
8	30338857	.	G	A	7	10	17	0	1	18	0	0
8	30338887	.	G	A	7	7	14	0	2	16	0	0
8	30356647	.	G	A	2	4	6	0	0	6	0	0
8	30358397	.	T	G	1	5	6	0	0	6	0	0
8	30361917	.	G	A	2	4	6	0	0	6	0	0
8	30365279	.	G	A	1	3	4	0	0	4	0	0
8	30368293	.	T	C	1	4	5	0	0	5	0	0
8	30379818	.	C	T	1	2	3	0	1	4	0	0
8	30379821	.	C	T	0	2	2	0	2	4	0	0
8	30425723	.	T	A	8	6	14	0	0	14	0	0
8	30426211	.	C	A	17	6	23	0	1	24	0	0
8	30437510	.	C	T	11	7	18	0	0	18	0	0
8	30501524	.	C	T	5	4	9	0	0	9	0	0
8	30501545	.	G	A	3	5	8	0	0	8	0	0
8	30501802	.	A	G	2	2	4	0	0	4	0	0
8	30502189	.	G	A	0	3	3	0	3	6	0	0
8	30546080	.	T	C	2	2	4	0	0	4	0	0
8	30546140	.	C	T	4	4	8	0	0	8	0	0
8	30547230	.	C	A	5	4	9	0	0	9	0	0
8	30560592	.	T	C	7	3	10	0	0	10	0	0
8	30560605	.	C	T	7	3	10	0	0	10	0	0
8	30560867	.	C	T	4	7	11	0	0	11	0	0
8	30560889	.	C	T	3	5	8	0	1	9	0	0
8	30570483	.	T	C	5	6	11	0	1	12	0	0
8	30570496	.	G	A	5	5	10	0	1	11	0	0
8	30570674	.	T	C	3	6	9	0	0	9	0	0
8	30576118	.	G	A	4	9	13	0	0	13	0	0
8	30590805	.	A	G	8	4	12	0	1	13	0	0
8	30593538	.	A	G	10	0	10	0	9	19	0	0
8	30600668	.	G	C	9	9	18	0	0	18	0	0
8	30619922	.	G	A	6	6	12	0	0	12	0	0
8	30620073	.	C	T	8	11	19	0	0	19	0	0
8	30621203	.	A	T	3	5	8	0	1	9	0	0
8	30623106	.	T	C	1	2	3	0	0	3	0	0
8	30623379	.	G	A	6	6	12	0	0	12	0	0
8	30624247	.	G	A	10	11	21	0	0	21	0	0
8	30624340	.	T	C	5	5	10	0	1	11	0	0
8	30657865	.	T	C	6	13	19	0	0	19	0	0
8	30661568	.	G	A	1	11	12	0	10	22	0	0
8	30661645	.	G	A	12	13	25	0	2	27	0	0
8	30661762	.	A	G	3	0	3	0	6	9	0	0
8	30662366	.	A	T	4	2	6	0	0	6	0	0
8	30662417	.	C	T	2	5	7	0	1	8	0	0
8	30662461	.	C	T	8	11	19	0	0	19	0	0
8	30662505	.	A	T	6	9	15	0	2	17	0	0
8	30662649	.	T	C	1	6	7	1	0	8	0	0
8	30730722	.	G	C	1	3	4	0	0	4	0	0
8	30730974	.	A	G	3	4	7	0	0	7	0	0
8	30731158	.	T	G	7	4	11	0	0	11	0	0
8	30731185	.	G	A	5	3	8	0	1	9	0	0
8	30731197	.	G	T	6	3	9	0	1	10	0	0
8	30731362	.	C	T	5	3	8	0	1	9	0	0
8	30731421	.	T	A	1	3	4	0	0	4	0	0
8	30731478	.	T	A	5	2	7	0	1	8	0	0
8	30731709	.	A	C	2	3	5	0	0	5	0	0
8	30731763	.	A	G	3	3	6	0	0	6	0	0
8	30734914	.	G	A	5	5	10	0	2	12	0	0
8	30742130	.	C	T	1	9	10	0	7	17	0	0
8	30744528	.	C	T	4	2	6	0	0	6	0	0
8	30758485	.	A	G	2	4	6	0	0	6	0	0
8	30758557	.	C	T	2	5	7	0	0	7	0	0
8	30758590	.	G	A	3	2	5	0	0	5	0	0
8	30758735	.	C	A	1	2	3	0	0	3	0	0
8	30758752	.	C	T	1	2	3	0	0	3	0	0
8	30764690	.	C	G	0	2	2	0	1	3	0	0
8	30765129	.	C	T	2	2	4	0	0	4	0	0
8	30921457	.	C	G	4	4	8	0	1	9	0	0
8	30921546	.	G	T	11	5	16	0	1	17	0	0
8	30923606	.	C	T	6	2	8	0	0	8	0	0
8	30928624	.	G	A	8	8	16	0	1	17	0	0
8	30928987	.	C	T	10	10	20	0	0	20	0	0
8	30929006	.	T	A	7	10	17	0	2	19	0	0
8	30929143	.	T	A	11	5	16	0	0	16	0	0
8	30929261	.	C	T	12	6	18	0	1	19	0	0
8	30929267	.	A	G	13	0	13	0	8	21	0	0
8	30929313	.	C	T	11	11	22	0	0	22	0	0
8	30929886	.	A	G	11	6	17	0	0	17	0	0
8	30938396	.	T	C	11	14	25	0	1	26	0	0
8	30938408	.	T	A	13	15	28	0	1	29	0	0
8	30940072	.	T	G	14	19	33	0	0	33	0	0
8	30949969	.	C	T	13	12	25	0	3	28	0	0
8	30951562	.	G	A	15	9	24	0	2	26	0	0
8	30960906	.	G	C	1	0	1	0	6	7	0	0
8	30960975	.	G	A	8	5	13	0	0	13	0	0
8	30961032	.	T	C	6	6	12	0	0	12	0	0
8	30962897	.	C	T	0	3	3	0	7	10	0	0
8	30963727	.	A	T	14	9	23	0	0	23	0	0
8	30963942	.	G	A	5	8	13	0	0	13	0	0
8	30963943	.	G	A	5	7	12	0	1	13	0	0
8	30964038	.	G	A	6	10	16	0	0	16	0	0
8	31008426	.	G	A	1	8	9	0	15	24	0	0
8	31008514	.	G	C	7	11	18	0	1	19	0	0
8	31008525	.	A	T	9	7	16	0	2	18	0	0
8	31010623	.	A	C	19	10	29	0	1	30	0	0
8	31010648	.	T	C	16	11	27	0	0	27	0	0
8	31010988	.	T	A	13	7	20	0	1	21	0	0
8	31012948	.	A	C	13	14	27	0	1	28	0	0
8	31013027	.	C	T	10	7	17	0	0	17	0	0
8	31013220	.	A	G	9	3	12	0	1	13	0	0
8	31013318	.	C	T	3	5	8	0	0	8	0	0
8	31013319	.	G	A	0	5	5	0	3	8	0	0
8	31013493	.	A	C	2	1	3	0	0	4	1	0
8	31013525	.	A	T	4	2	6	0	0	6	0	0
8	31013547	.	A	G	2	2	4	0	0	4	0	0
8	31030838	.	G	C	4	5	9	0	1	10	0	0
8	31031068	.	A	G	7	16	23	0	1	24	0	0
8	31031180	.	T	G	7	11	18	0	0	18	0	0
8	31031307	.	C	G	2	5	7	0	0	7	0	0
8	31031438	.	T	A	1	2	3	0	0	3	0	0
8	31031481	.	C	G	1	4	5	0	0	5	0	0
8	31031639	.	C	T	0	14	14	0	6	20	0	0
8	31031740	.	A	G	20	19	39	0	3	42	0	0
8	31032510	.	G	A	14	16	30	0	0	30	0	0
8	31033861	.	A	T	15	16	31	0	1	32	0	0
8	31034924	.	A	G	16	16	32	0	2	34	0	0
8	31036057	.	G	A	19	13	32	0	0	32	0	0
8	31037626	.	T	C	6	0	6	0	5	11	0	0
8	31037647	.	A	G	6	5	11	1	1	13	0	0
8	31038890	.	C	T	10	12	22	0	1	23	0	0
8	31040175	.	A	G	12	14	26	0	0	26	0	0
8	31040211	.	A	G	9	12	21	0	0	21	0	0
8	31040765	.	T	C	8	10	18	0	1	19	0	0
8	31040861	.	G	A	10	12	22	0	0	22	0	0
8	31040988	.	C	A	9	8	17	0	2	19	0	0
8	31041913	.	G	A	8	7	15	0	0	15	0	0
8	31042318	.	G	A	10	10	20	0	1	21	0	0
8	31044577	.	A	C	8	5	13	0	0	13	0	0
8	31045010	.	A	C	8	0	8	0	9	17	0	0
8	31048748	.	G	T	4	4	8	0	3	11	0	0
8	31050240	.	C	T	6	7	13	0	0	13	0	0
8	31051207	.	G	A	5	7	12	0	0	12	0	0
8	31053781	.	T	G	6	2	8	0	0	8	0	0
8	31053836	.	C	T	10	3	13	0	0	13	0	0
8	31053840	.	C	T	10	3	13	0	0	13	0	0
8	31072288	.	C	A	1	2	3	0	0	3	0	0
8	31119730	.	A	G	19	19	38	0	2	40	0	0
8	31119865	.	T	C	21	19	40	0	0	40	0	0
8	31119909	.	T	G	24	0	24	0	15	39	0	0
8	31131079	.	G	A	30	17	47	0	0	47	0	0
8	31131277	.	A	G	30	26	56	0	1	57	0	0
8	31131394	.	A	C	23	17	40	0	2	42	0	0
8	31135892	.	A	G	21	24	45	0	4	49	0	0
8	31135934	.	C	T	19	23	42	0	1	43	0	0
8	31139439	.	C	T	26	28	54	0	3	57	0	0
8	31142311	.	C	T	23	32	55	0	2	57	0	0
8	31145897	.	C	T	25	35	60	0	2	62	0	0
8	31145940	.	G	C	35	27	62	0	2	64	0	0
8	31145948	.	G	A	39	22	61	0	3	64	0	0
8	31146748	.	G	A	18	32	50	0	0	50	0	0
8	31146805	.	T	C	24	30	54	0	1	55	0	0
8	31146862	.	T	A	32	23	55	0	0	56	1	0
8	31146913	.	G	A	17	28	45	0	2	47	0	0
8	31147159	.	C	T	28	40	68	0	1	69	0	0
8	31147208	.	C	A	31	36	67	0	1	68	0	0
8	31147241	.	A	T	33	26	59	0	1	60	0	0
8	31147315	.	C	T	22	21	43	0	2	45	0	0
8	31147380	.	T	G	28	20	48	0	1	49	0	0
8	31147651	.	C	T	17	28	45	0	4	49	0	0
8	31147898	.	G	A	28	23	51	0	1	52	0	0
8	31250357	.	A	G	30	0	30	0	12	42	0	0
8	31250384	.	T	G	25	9	34	0	3	37	0	0
8	31251354	.	T	C	17	20	37	0	3	40	0	0
8	31251426	.	T	C	19	13	32	0	0	32	0	0
8	31251510	.	C	A	26	15	41	0	2	43	0	0
8	31251555	.	G	A	3	20	23	0	26	49	0	0
8	31251792	.	G	C	2	20	22	0	21	43	0	0
8	31251873	.	T	C	15	16	31	0	1	32	0	0
8	31253582	.	C	T	22	18	40	0	0	40	0	0
8	31253729	.	T	A	12	8	20	0	0	20	0	0
8	31253911	.	A	G	5	3	8	0	0	8	0	0
8	31254046	.	C	A	9	13	22	1	0	23	0	0
8	31254163	.	G	A	22	18	40	0	1	41	0	0
8	31254176	.	A	T	25	11	36	0	0	36	0	0
8	31367747	.	T	C	2	2	4	0	1	5	0	0
8	31368279	.	T	G	6	10	16	0	0	16	0	0
8	31368557	.	A	G	18	7	25	0	0	25	0	0
8	31368611	.	T	C	9	7	16	0	1	17	0	0
8	31368865	.	T	A	7	6	13	0	0	13	0	0
8	31375338	.	T	C	3	5	8	0	0	8	0	0
8	31375405	.	T	C	10	2	12	0	0	12	0	0
8	31375434	.	T	A	12	8	20	0	0	20	0	0
8	31375524	.	G	C	10	11	21	2	0	23	0	0
8	31375529	.	T	C	10	11	21	2	1	24	0	0
8	31375670	.	T	G	13	17	30	0	1	31	0	0
8	31375928	.	A	G	5	6	11	0	0	11	0	0
8	31375988	.	A	G	2	2	4	0	1	5	0	0
8	31376011	.	T	A	2	3	5	0	0	5	0	0
8	31376045	.	T	A	2	2	4	0	0	4	0	0
8	31376117	.	T	G	2	11	13	0	0	13	0	0
8	31376125	.	A	T	3	10	13	0	1	14	0	0
8	31381731	.	T	A	10	15	25	0	2	27	0	0
8	31387695	.	A	G	10	4	14	0	0	14	0	0
8	31387728	.	T	G	11	8	19	0	0	19	0	0
8	31388280	.	C	T	7	7	14	0	1	15	0	0
8	31390061	.	T	C	7	6	13	0	0	13	0	0
8	31393376	.	G	A	6	3	9	0	1	10	0	0
8	31395587	.	C	A	0	12	12	0	6	18	0	0
8	31395606	.	C	T	3	12	15	0	6	22	1	0
8	31395644	.	T	C	6	6	12	0	1	13	0	0
8	31395713	.	C	A	4	4	8	0	0	8	0	0
8	31395884	.	A	G	14	11	25	0	0	25	0	0
8	31400775	.	A	G	4	6	10	0	1	11	0	0
8	31407168	.	C	A	9	10	19	0	0	19	0	0
8	31407294	.	A	G	6	11	17	0	2	19	0	0
8	31411089	.	C	T	0	9	9	0	7	16	0	0
8	31411545	.	A	T	10	11	21	0	1	22	0	0
8	31411578	.	G	A	12	10	22	0	2	24	0	0
8	31411646	.	T	A	10	9	19	0	0	20	1	0
8	31416691	.	C	T	3	2	5	0	0	5	0	0
8	31437626	.	C	T	23	21	44	0	0	44	0	0
8	31437768	.	C	G	14	27	41	0	2	43	0	0
8	31441698	.	C	A	24	24	48	1	1	50	0	0
8	31441814	.	G	A	26	31	57	0	2	59	0	0
8	31441850	.	T	C	31	25	56	0	3	59	0	0
8	31441870	.	T	C	27	27	54	0	0	54	0	0
8	31442000	.	G	A	34	27	61	0	1	62	0	0
8	31442523	.	C	G	14	16	30	0	2	32	0	0
8	31442595	.	G	A	23	13	36	0	2	38	0	0
8	31442648	.	C	T	32	20	52	0	0	52	0	0
8	31442794	.	G	T	12	24	36	0	0	36	0	0
8	31442886	.	T	C	24	22	46	0	1	47	0	0
8	31704761	.	G	A	10	3	13	0	0	13	0	0
8	31711411	.	T	C	11	0	11	0	17	28	0	0
8	31716001	.	G	T	12	19	31	0	1	32	0	0
8	31719059	.	C	T	17	19	36	0	0	36	0	0
8	31730419	.	G	T	21	23	44	0	0	44	0	0
8	31730762	.	C	A	9	25	34	0	0	34	0	0
8	31730771	.	C	T	10	23	33	0	2	35	0	0
8	31730801	.	C	T	14	20	34	0	1	35	0	0
8	31733870	.	C	T	14	23	37	0	0	37	0	0
8	31735854	.	C	A	21	20	41	1	4	46	0	0
8	31756640	.	A	G	19	22	41	1	2	44	0	0
8	31760785	.	C	T	23	17	40	0	2	42	0	0
8	31765077	.	C	T	18	25	43	0	0	43	0	0
8	31817931	.	A	C	17	20	37	0	2	39	0	0
8	31818018	.	T	C	14	16	30	0	0	30	0	0
8	31818022	.	G	A	1	17	18	0	13	31	0	0
8	31818083	.	A	T	17	23	40	0	0	40	0	0
8	31818196	.	G	A	20	26	46	0	1	47	0	0
8	31818267	.	T	G	16	20	36	0	0	36	0	0
8	31818273	.	T	A	16	20	36	0	0	36	0	0
8	31818335	.	G	A	11	14	25	0	0	25	0	0
8	31818425	.	A	C	11	8	19	0	1	20	0	0
8	31818456	.	A	G	6	9	15	0	0	15	0	0
8	31818460	.	A	G	6	9	15	0	1	16	0	0
8	31818748	.	T	C	4	7	11	0	0	11	0	0
8	31818800	.	G	A	5	4	9	1	1	11	0	0
8	31818835	.	T	G	11	6	17	3	0	20	0	0
8	31851336	.	A	G	24	7	31	0	2	33	0	0
8	31851582	.	A	G	21	23	44	0	1	45	0	0
8	31851594	.	T	C	19	23	42	0	0	42	0	0
8	31861425	.	A	G	17	21	38	0	2	40	0	0
8	31861479	.	C	T	21	14	35	0	0	36	1	0
8	31861580	.	G	C	17	21	38	0	0	38	0	0
8	31861616	.	T	A	19	22	41	0	0	41	0	0
8	31862063	.	T	C	24	13	37	0	0	37	0	0
8	31862165	.	C	T	15	14	29	0	0	29	0	0
8	31862384	.	A	G	11	24	35	0	0	35	0	0
8	31862407	.	G	A	18	20	38	0	1	39	0	0
8	31862670	.	T	A	15	11	26	0	3	29	0	0
8	31885731	.	C	T	1	2	3	0	0	3	0	0
8	31885742	.	T	C	1	2	3	0	0	3	0	0
8	31887845	.	G	A	0	2	2	0	1	3	0	0
8	31898671	.	A	G	2	2	4	0	4	8	0	0
8	31898706	.	C	T	1	3	4	0	0	4	0	0
8	31899124	.	A	T	1	5	6	0	0	6	0	0
8	31901659	.	A	G	7	13	20	0	1	21	0	0
8	31901757	.	T	C	8	7	15	0	0	15	0	0
8	31906886	.	G	A	13	18	31	0	2	33	0	0
8	31906910	.	C	A	20	17	37	0	1	38	0	0
8	31914427	.	A	T	14	19	33	0	2	36	1	0
8	31919101	.	G	C	15	19	34	0	1	35	0	0
8	31919110	.	A	C	17	0	17	0	16	33	0	0
8	31919548	.	C	T	14	17	31	0	0	31	0	0
8	31919558	.	A	C	14	15	29	0	2	31	0	0
8	31941853	.	C	T	4	12	16	0	0	16	0	0
8	31942723	.	G	A	12	8	20	0	0	20	0	0
8	31943357	.	T	C	1	4	5	0	1	6	0	0
8	32028856	.	G	T	6	4	10	0	1	11	0	0
8	32028921	.	T	A	4	3	7	1	2	10	0	0
8	32029044	.	T	G	7	6	13	0	0	13	0	0
8	32029258	.	T	C	5	3	8	0	0	8	0	0
8	32029481	.	A	G	3	2	5	0	0	5	0	0
8	32029810	.	G	C	3	2	5	0	1	6	0	0
8	32029843	.	T	C	4	3	7	0	0	7	0	0
8	32030107	.	G	A	2	2	4	0	0	4	0	0
8	32030144	.	A	G	2	6	8	0	0	8	0	0
8	32030341	.	A	G	9	3	12	0	0	12	0	0
8	32030538	.	G	A	3	2	5	0	0	5	0	0
8	32030545	.	G	A	3	1	4	0	0	4	0	0
8	32030771	.	T	G	3	8	11	0	0	11	0	0
8	32191744	.	G	A	3	3	6	0	0	6	0	0
8	32193059	.	A	G	1	5	6	0	0	6	0	0
8	32247811	.	T	C	4	2	6	0	0	6	0	0
8	32269480	.	A	G	4	5	9	0	1	10	0	0
8	32270345	.	T	C	6	0	6	0	4	10	0	0
8	32354596	.	G	A	2	3	5	0	0	5	0	0
8	32389941	.	T	C	1	2	3	0	0	3	0	0
8	32483905	.	G	C	10	17	27	0	2	29	0	0
8	32486956	.	C	T	2	14	16	0	14	30	0	0
8	32502932	.	C	T	6	4	10	0	1	11	0	0
8	32506134	.	T	C	4	3	7	0	0	7	0	0
8	32506175	.	G	T	6	4	10	0	0	10	0	0
8	32506215	.	T	C	4	0	4	0	3	7	0	0
8	32516233	.	T	C	5	4	9	0	0	9	0	0
8	32516240	.	G	A	5	4	9	0	0	9	0	0
8	32516331	.	C	T	6	4	10	0	0	10	0	0
8	32516557	.	T	C	7	5	12	0	0	12	0	0
8	32516629	.	A	C	8	5	13	0	0	13	0	0
8	32588542	.	G	T	0	6	6	0	10	16	0	0
8	32596634	.	A	T	4	5	9	0	0	9	0	0
8	32598963	.	C	A	5	7	12	0	1	14	1	0
8	32599121	.	G	T	4	8	12	0	1	13	0	0
8	32599147	.	G	A	4	12	16	0	1	17	0	0
8	32599288	.	T	C	3	5	8	0	0	8	0	0
8	32599295	.	A	G	4	6	10	0	0	10	0	0
8	32599363	.	T	C	4	10	14	0	0	14	0	0
8	32599421	.	T	C	7	9	16	0	3	19	0	0
8	32599432	.	T	G	10	11	21	0	1	22	0	0
8	32599484	.	C	T	11	8	19	0	1	20	0	0
8	32599556	.	C	G	4	7	11	0	0	11	0	0
8	32599743	.	A	G	5	4	9	0	0	9	0	0
8	32599795	.	G	A	1	5	6	0	1	7	0	0
8	32599805	.	T	C	1	5	6	0	0	6	0	0
8	32784855	.	C	T	1	2	3	0	0	3	0	0
8	32784889	.	A	G	1	3	4	0	0	4	0	0
8	32914748	.	G	T	9	21	30	0	0	30	0	0
8	32914853	.	C	T	8	6	14	0	2	16	0	0
8	32916957	.	T	A	18	19	37	0	0	37	0	0
8	32925670	.	T	G	10	12	22	0	1	23	0	0
8	32925721	.	A	G	10	11	21	0	0	21	0	0
8	32930789	.	A	G	4	15	19	0	1	20	0	0
8	32930837	.	C	T	7	16	23	0	2	25	0	0
8	32939561	.	T	C	9	11	20	0	1	21	0	0
8	32939573	.	T	C	10	0	10	0	9	19	0	0
8	33113932	.	A	G	12	14	26	0	0	26	0	0
8	33114094	.	T	A	8	13	21	0	1	22	0	0
8	33133145	.	C	T	0	3	3	0	2	5	0	0
8	33896463	.	A	T	6	12	18	0	1	19	0	0
8	33896471	.	T	A	10	5	15	0	2	17	0	0
8	33896524	.	G	T	11	6	17	0	1	18	0	0
8	33896964	.	T	G	14	16	30	0	1	31	0	0
8	33910008	.	G	A	34	23	57	3	3	63	0	0
8	33918520	.	C	T	28	20	48	0	1	49	0	0
8	33918631	.	C	T	21	27	48	1	2	51	0	0
8	33924333	.	G	T	18	26	44	0	4	48	0	0
8	34051619	.	G	T	24	17	41	0	1	42	0	0
8	34051719	.	G	A	24	17	41	0	2	43	0	0
8	34051795	.	T	C	22	14	36	0	2	38	0	0
8	34342123	.	G	C	11	0	11	0	16	27	0	0
8	34342376	.	G	A	9	8	17	0	2	19	0	0
8	34345285	.	G	A	20	16	36	0	1	37	0	0
8	34345556	.	A	G	18	12	30	0	0	30	0	0
8	34348958	.	A	C	6	7	13	0	0	13	0	0
8	34376669	.	A	G	10	9	19	0	0	19	0	0
8	34376728	.	G	A	8	8	16	0	1	17	0	0
8	34394513	.	G	A	7	7	14	0	0	14	0	0
8	34396859	.	T	A	7	4	11	0	0	11	0	0
8	34396902	.	A	G	3	5	8	0	0	8	0	0
8	34397046	.	C	T	11	8	19	0	0	19	0	0
8	34402691	.	G	A	7	8	15	0	1	16	0	0
8	35212878	.	G	A	2	1	3	0	0	3	0	0
8	35213047	.	C	T	2	4	6	0	0	6	0	0
8	35357594	.	A	G	1	0	1	0	3	4	0	0
8	35759276	.	G	A	0	9	9	0	4	13	0	0
8	35759444	.	C	T	3	2	5	0	0	5	0	0
8	35759999	.	C	T	8	5	13	0	0	13	0	0
8	35810082	.	G	A	2	2	4	0	1	5	0	0
8	35810115	.	T	C	1	0	1	0	5	6	0	0
8	35964671	.	C	T	1	3	4	0	0	4	0	0
8	36061676	.	T	G	0	3	3	0	2	5	0	0
8	36061678	.	T	C	1	0	1	0	4	5	0	0
8	36081948	.	G	A	1	1	2	0	1	3	0	0
8	36110449	.	G	A	2	3	5	0	0	5	0	0
8	36466904	.	T	A	12	6	18	1	0	19	0	0
8	36473183	.	G	A	11	4	15	0	0	15	0	0
8	36473189	.	G	A	11	4	15	0	0	15	0	0
8	36473313	.	G	A	3	6	9	0	1	10	0	0
8	36473319	.	T	C	3	5	8	0	1	9	0	0
8	36474230	.	T	G	6	17	23	0	0	23	0	0
8	36474411	.	A	G	7	20	27	0	0	27	0	0
8	36500330	.	T	A	9	2	11	0	0	11	0	0
8	36504356	.	T	A	6	4	10	0	1	11	0	0
8	36504380	.	A	T	3	7	10	0	0	10	0	0
8	36504392	.	C	T	2	5	7	0	0	7	0	0
8	36504422	.	T	A	1	4	5	0	0	5	0	0
8	36504620	.	A	G	2	6	8	0	0	8	0	0
8	36504728	.	T	G	7	5	12	0	1	13	0	0
8	36507344	.	C	T	2	6	8	0	1	9	0	0
8	36507567	.	C	A	7	8	15	0	0	15	0	0
8	36507770	.	G	A	1	4	5	0	3	8	0	0
8	36512716	.	G	A	1	3	4	0	6	10	0	0
8	36512869	.	T	A	3	4	7	0	0	7	0	0
8	36512888	.	G	T	2	2	4	0	0	4	0	0
8	36515721	.	A	G	8	3	11	0	0	11	0	0
8	36561939	.	C	T	20	7	27	0	2	29	0	0
8	36561942	.	A	T	18	10	28	0	3	31	0	0
8	36561987	.	C	T	24	13	37	0	2	39	0	0
8	36562262	.	T	C	24	9	33	0	1	34	0	0
8	36562293	.	C	T	29	9	38	0	0	38	0	0
8	36562328	.	C	T	19	6	25	0	1	26	0	0
8	36563192	.	G	A	21	12	33	0	1	34	0	0
8	36566182	.	T	C	26	9	35	0	2	37	0	0
8	36566353	.	T	C	25	11	36	0	3	39	0	0
8	36567193	.	T	A	24	19	43	0	2	45	0	0
8	36567208	.	A	T	26	19	45	0	3	48	0	0
8	36567316	.	T	C	30	18	48	0	2	50	0	0
8	36567349	.	A	C	25	18	43	0	6	49	0	0
8	36568304	.	C	T	16	16	32	0	1	33	0	0
8	36568492	.	T	C	15	6	21	0	2	23	0	0
8	36568561	.	A	G	23	9	32	0	1	33	0	0
8	36568755	.	T	C	18	6	24	0	0	24	0	0
8	36570147	.	T	C	4	3	7	0	0	7	0	0
8	36571187	.	A	G	6	2	8	0	0	8	0	0
8	36573418	.	T	C	5	7	12	0	2	14	0	0
8	36573429	.	A	C	8	5	13	0	0	13	0	0
8	36577187	.	G	T	1	3	4	0	1	5	0	0
8	36582989	.	T	C	13	11	24	0	0	24	0	0
8	36583834	.	T	C	6	6	12	0	1	13	0	0
8	36583877	.	C	A	11	4	15	0	1	16	0	0
8	36587934	.	A	G	12	13	25	0	0	25	0	0
8	36587936	.	A	G	12	1	13	0	12	25	0	0
8	36587970	.	C	A	8	13	21	0	2	23	0	0
8	36587981	.	G	T	7	15	22	0	0	22	0	0
8	36588600	.	G	T	2	12	14	0	11	25	0	0
8	36589226	.	T	C	11	4	15	0	0	15	0	0
8	36591823	.	A	T	1	2	3	0	0	3	0	0
8	36592011	.	A	G	4	8	12	0	0	12	0	0
8	36592018	.	A	G	5	7	12	0	0	12	0	0
8	36592101	.	T	C	5	0	5	0	7	12	0	0
8	36592237	.	T	C	3	9	12	0	1	13	0	0
8	36592374	.	A	G	9	15	24	1	0	25	0	0
8	36600801	.	C	G	12	8	20	0	0	20	0	0
8	36600803	.	T	G	11	8	19	0	0	19	0	0
8	36602459	.	C	T	9	11	20	0	2	22	0	0
8	36613882	.	G	T	6	11	17	0	0	17	0	0
8	36617635	.	C	G	5	5	10	0	0	10	0	0
8	36617669	.	A	G	6	6	12	0	0	12	0	0
8	36743200	.	C	A	5	3	8	0	0	8	0	0
8	36743530	.	G	A	0	4	4	0	5	9	0	0
8	36746770	.	T	A	6	2	8	0	0	8	0	0
8	36746967	.	T	C	1	2	3	0	0	3	0	0
8	36750282	.	A	C	2	2	4	0	0	4	0	0
8	36781596	.	A	G	2	0	2	0	11	13	0	0
8	36781722	.	C	T	8	8	16	0	0	16	0	0
8	36785572	.	A	C	7	9	16	0	0	16	0	0
8	36785599	.	T	C	10	8	18	0	0	18	0	0
8	36803574	.	C	A	18	22	40	0	0	40	0	0
8	36803850	.	T	C	15	18	33	0	2	35	0	0
8	36951346	.	C	T	20	17	37	0	2	39	0	0
8	36951481	.	C	T	18	22	40	0	2	42	0	0
8	36951610	.	T	C	10	16	26	0	0	26	0	0
8	36952015	.	A	G	18	1	19	0	31	50	0	0
8	36953884	.	A	G	12	18	30	0	1	31	0	0
8	36953947	.	C	T	14	21	35	0	1	36	0	0
8	36953950	.	G	C	14	22	36	0	0	36	0	0
8	36956254	.	C	T	19	22	41	0	0	41	0	0
8	36956269	.	T	C	19	19	38	0	1	39	0	0
8	36956516	.	G	A	12	7	19	0	1	20	0	0
8	36956540	.	C	A	13	11	24	0	0	24	0	0
8	36964126	.	G	A	16	18	34	0	2	36	0	0
8	36974076	.	C	A	30	26	56	0	2	58	0	0
8	36976089	.	T	C	9	6	15	0	0	15	0	0
8	36976557	.	G	A	22	12	34	0	1	35	0	0
8	36976966	.	C	T	26	19	45	0	2	47	0	0
8	36977170	.	C	T	15	23	38	0	1	39	0	0
8	36994205	.	T	C	9	5	14	0	0	14	0	0
8	36994223	.	A	G	10	3	13	0	0	13	0	0
8	37001591	.	T	A	10	5	15	0	0	15	0	0
8	37007527	.	T	C	19	7	26	0	0	26	0	0
8	37010662	.	T	C	11	14	25	0	0	25	0	0
8	37010668	.	C	T	10	11	21	0	4	25	0	0
8	37012762	.	T	A	8	11	19	0	0	19	0	0
8	37012825	.	C	T	10	7	17	0	0	17	0	0
8	37012872	.	C	G	11	12	23	0	3	26	0	0
8	37013093	.	A	G	7	13	20	0	0	20	0	0
8	37013210	.	G	A	10	7	17	0	0	17	0	0
8	37013255	.	T	C	9	6	15	0	0	15	0	0
8	37013282	.	T	C	7	4	11	0	0	11	0	0
8	37013833	.	C	T	10	11	21	0	0	21	0	0
8	37013877	.	A	T	11	6	17	0	0	17	0	0
8	37014535	.	G	C	11	9	20	0	0	20	0	0
8	37014582	.	T	C	9	13	22	0	0	22	0	0
8	37016584	.	G	T	0	14	14	0	18	32	0	0
8	37016658	.	C	A	12	8	20	0	4	24	0	0
8	37016752	.	A	G	14	21	35	0	1	36	0	0
8	37016790	.	T	C	15	16	31	0	1	32	0	0
8	37017149	.	G	A	16	8	24	0	2	26	0	0
8	37017159	.	C	T	19	11	30	0	2	32	0	0
8	37018877	.	A	G	18	13	31	0	0	31	0	0
8	37018901	.	T	C	20	15	35	0	1	36	0	0
8	37019059	.	G	A	20	14	34	0	2	36	0	0
8	37019113	.	G	A	16	18	34	0	0	34	0	0
8	37025566	.	C	T	24	13	37	0	0	37	0	0
8	37025576	.	A	T	24	11	35	0	0	35	0	0
8	37025614	.	T	A	23	14	37	0	0	37	0	0
8	37025633	.	A	G	15	0	15	0	18	33	0	0
8	37025896	.	T	C	6	12	18	0	5	23	0	0
8	37038912	.	T	C	1	3	4	0	0	4	0	0
8	37038963	.	G	A	3	2	5	0	0	5	0	0
8	37038990	.	C	T	3	2	5	1	0	6	0	0
8	37059952	.	A	G	1	4	5	0	0	5	0	0
8	37060149	.	G	T	2	2	4	0	0	4	0	0
8	37060234	.	T	A	6	2	8	0	0	8	0	0
8	37060305	.	C	T	0	4	4	0	5	9	0	0
8	37060412	.	C	T	1	4	5	0	5	10	0	0
8	37060434	.	C	A	5	4	9	0	0	9	0	0
8	37060580	.	G	A	10	5	15	0	0	15	0	0
8	37060595	.	A	T	11	6	17	0	0	17	0	0
8	37060702	.	C	T	3	7	10	0	0	10	0	0
8	37068600	.	T	G	2	2	4	0	1	5	0	0
8	37072775	.	G	C	1	2	3	0	0	3	0	0
8	37075536	.	A	G	3	4	7	0	1	8	0	0
8	37075583	.	T	C	2	3	5	0	1	6	0	0
8	37082888	.	C	A	1	5	6	0	0	6	0	0
8	37082927	.	A	G	1	3	4	0	0	4	0	0
8	37086959	.	C	T	6	7	13	0	0	13	0	0
8	37101346	.	T	C	7	3	10	0	0	10	0	0
8	37101370	.	G	C	6	3	9	0	0	9	0	0
8	37230569	.	T	C	1	2	3	0	0	3	0	0
8	37232135	.	G	C	3	0	3	0	10	13	0	0
8	37232289	.	T	A	12	7	19	0	1	20	0	0
8	37232312	.	G	C	14	7	21	0	1	22	0	0
8	37232419	.	G	A	12	12	24	0	1	25	0	0
8	37232487	.	A	C	16	24	40	0	4	44	0	0
8	37238801	.	C	G	7	16	23	0	0	23	0	0
8	37280748	.	T	C	15	8	23	0	0	23	0	0
8	37280752	.	C	T	16	7	23	0	0	23	0	0
8	37280809	.	G	T	14	14	28	0	0	28	0	0
8	37280845	.	G	A	12	14	26	0	0	26	0	0
8	37280865	.	C	T	15	15	30	0	0	30	0	0
8	37280923	.	T	A	16	8	24	0	4	28	0	0
8	37281109	.	T	C	19	10	29	0	1	30	0	0
8	37281382	.	A	T	3	5	8	3	0	11	0	0
8	37281440	.	T	A	11	14	25	0	2	27	0	0
8	37281444	.	T	A	13	17	30	0	0	30	0	0
8	37281547	.	G	A	15	23	38	0	2	40	0	0
8	37282088	.	C	T	20	9	29	0	1	30	0	0
8	37282126	.	G	T	20	9	29	0	0	29	0	0
8	37282407	.	G	A	20	22	42	0	0	42	0	0
8	37282848	.	C	T	17	29	46	0	2	48	0	0
8	37282888	.	G	A	12	21	33	0	3	36	0	0
8	37282986	.	G	A	19	12	31	0	0	31	0	0
8	37283016	.	T	A	18	17	35	0	0	35	0	0
8	37283452	.	C	T	9	4	13	0	0	13	0	0
8	37283486	.	A	G	12	5	17	0	1	18	0	0
8	37283487	.	A	C	11	6	17	0	0	17	0	0
8	37283663	.	C	T	17	12	29	0	3	32	0	0
8	37283743	.	A	G	19	6	25	0	2	27	0	0
8	37283748	.	G	T	19	6	25	0	2	27	0	0
8	37284018	.	A	T	1	4	5	0	0	5	0	0
8	37284386	.	A	G	27	29	56	0	1	57	0	0
8	37284428	.	T	G	30	29	59	0	3	62	0	0
8	37284478	.	A	G	32	25	57	0	0	57	0	0
8	37294894	.	A	T	26	16	42	0	4	46	0	0
8	37294930	.	A	G	13	10	23	0	16	39	0	0
8	37295395	.	C	T	2	23	25	0	23	48	0	0
8	37303244	.	G	A	22	20	42	0	0	42	0	0
8	37303271	.	A	C	15	0	15	0	17	32	0	0
8	37303673	.	T	C	12	10	22	0	2	24	0	0
8	37303891	.	G	A	11	13	24	0	1	25	0	0
8	37305515	.	G	C	15	7	22	0	1	23	0	0
8	37306114	.	A	G	20	8	28	0	3	31	0	0
8	37317224	.	G	A	14	9	23	0	1	24	0	0
8	37317248	.	G	A	12	9	21	0	2	23	0	0
8	37317290	.	G	T	12	7	19	0	8	27	0	0
8	37320810	.	A	T	15	13	28	0	0	28	0	0
8	37390950	.	T	A	18	17	35	0	0	35	0	0
8	37447751	.	C	T	5	6	11	0	0	11	0	0
8	37453403	.	A	G	7	8	15	0	1	16	0	0
8	37453430	.	T	A	5	8	13	0	1	14	0	0
8	37453646	.	T	A	8	5	13	0	1	14	0	0
8	37456801	.	T	A	9	7	16	0	0	16	0	0
8	37456826	.	C	A	9	9	18	0	0	18	0	0
8	37460616	.	A	T	8	7	15	0	0	15	0	0
8	37460998	.	T	C	1	2	3	0	1	4	0	0
8	37461060	.	C	T	2	3	5	0	1	6	0	0
8	37948754	.	C	A	1	4	5	0	2	7	0	0
8	37948762	.	T	C	1	6	7	0	0	7	0	0
8	38051806	.	T	C	2	2	4	0	0	4	0	0
8	38051818	.	G	A	2	2	4	0	0	4	0	0
8	38190640	.	G	A	2	2	4	0	0	4	0	0
8	38191659	.	T	G	4	5	9	0	0	9	0	0
8	38317720	.	G	T	1	2	3	0	0	3	0	0
8	38319999	.	T	G	2	5	7	0	0	7	0	0
8	38320072	.	A	G	1	3	4	0	0	4	0	0
8	38321464	.	A	T	3	4	7	0	0	7	0	0
8	38326274	.	G	A	2	1	3	0	1	4	0	0
8	38421515	.	C	A	6	5	11	0	1	12	0	0
8	38421627	.	T	A	3	5	8	0	0	8	0	0
8	38421640	.	A	T	2	5	7	0	0	7	0	0
8	38421820	.	C	T	10	11	21	0	0	21	0	0
8	38422058	.	G	A	10	7	17	0	0	17	0	0
8	38422439	.	G	A	6	6	12	0	0	12	0	0
8	38422748	.	C	G	4	6	10	0	0	10	0	0
8	38423170	.	T	C	3	0	3	0	5	8	0	0
8	38423210	.	A	G	6	5	11	0	2	13	0	0
8	38423250	.	G	A	7	8	15	0	1	16	0	0
8	38423297	.	A	G	9	8	17	0	0	17	0	0
8	38423373	.	A	T	10	7	17	0	0	17	0	0
8	38423462	.	A	G	7	13	20	0	0	20	0	0
8	38423529	.	C	G	0	7	7	0	10	17	0	0
8	38423617	.	C	T	11	9	20	0	1	21	0	0
8	38423641	.	A	G	4	10	14	0	1	15	0	0
8	38427977	.	T	C	3	6	9	0	0	9	0	0
8	38430297	.	G	A	12	4	16	0	0	16	0	0
8	38448065	.	G	A	4	4	8	0	0	8	0	0
8	38505695	.	A	G	5	2	7	0	0	7	0	0
8	38565008	.	A	G	9	8	17	0	1	18	0	0
8	38565040	.	C	T	9	10	19	0	0	19	0	0
8	38571041	.	T	A	4	4	8	0	0	8	0	0
8	38572620	.	C	T	5	6	11	0	2	13	0	0
8	38572885	.	T	C	2	2	4	0	2	6	0	0
8	39646024	.	A	T	7	3	10	0	0	10	0	0
8	39646768	.	G	A	9	8	17	0	0	17	0	0
8	39646781	.	T	C	8	6	14	0	2	16	0	0
8	39647008	.	A	C	6	3	9	0	1	10	0	0
8	39676552	.	C	T	9	5	14	0	0	14	0	0
8	39693130	.	C	T	17	13	30	1	0	31	0	0
8	39703277	.	T	C	7	6	13	0	0	13	0	0
8	39703321	.	G	A	5	2	7	0	0	7	0	0
8	39760860	.	C	T	35	36	71	0	1	72	0	0
8	39765798	.	A	G	31	34	65	0	5	70	0	0
8	39781340	.	T	A	4	2	6	0	0	6	0	0
8	39781351	.	C	A	4	2	6	0	0	6	0	0
8	39781427	.	T	A	3	2	5	0	0	5	0	0
8	39781450	.	A	G	5	2	7	0	0	7	0	0
8	39786378	.	T	G	4	4	8	0	0	8	0	0
8	39816887	.	C	G	3	3	6	0	0	6	0	0
8	39816992	.	C	T	1	6	7	0	1	8	0	0
8	39817011	.	A	G	4	6	10	0	1	11	0	0
8	39817031	.	T	G	3	7	10	0	1	11	0	0
8	39817054	.	A	T	4	7	11	0	0	11	0	0
8	39821755	.	T	C	2	3	5	0	1	6	0	0
8	39849336	.	A	G	3	4	7	0	1	8	0	0
8	39849439	.	G	T	7	3	10	0	0	10	0	0
8	39849686	.	C	G	3	5	8	0	1	9	0	0
8	39850251	.	C	T	6	5	11	0	0	11	0	0
8	39851046	.	T	C	3	2	5	0	0	5	0	0
8	39851067	.	A	G	2	2	4	0	0	4	0	0
8	39859520	.	T	C	8	0	8	0	8	16	0	0
8	39870765	.	C	T	0	9	9	0	4	13	0	0
8	39870857	.	C	T	2	2	4	0	0	4	0	0
8	39876378	.	G	A	7	2	9	0	0	9	0	0
8	39878550	.	C	T	6	2	8	0	1	9	0	0
8	39884127	.	A	T	10	10	20	0	0	20	0	0
8	39884352	.	G	A	8	3	11	0	0	11	0	0
8	39890197	.	T	C	15	5	20	0	0	20	0	0
8	39901781	.	A	G	14	5	19	0	0	19	0	0
8	39951571	.	G	A	14	8	22	0	1	23	0	0
8	39976817	.	C	T	19	13	32	0	1	33	0	0
8	39976850	.	G	C	18	1	19	0	11	30	0	0
8	39977153	.	C	G	25	22	47	0	0	47	0	0
8	39977333	.	G	A	16	20	36	0	1	37	0	0
8	39978559	.	A	G	21	9	30	0	0	30	0	0
8	40025733	.	C	T	3	3	6	0	0	6	0	0
8	40081408	.	G	C	18	10	28	0	0	28	0	0
8	40081462	.	T	G	20	14	34	0	1	35	0	0
8	40081718	.	T	C	12	13	25	0	0	25	0	0
8	40163223	.	C	T	22	15	37	0	0	37	0	0
8	40177928	.	A	G	1	2	3	0	0	3	0	0
8	40186747	.	A	G	5	6	11	0	0	11	0	0
8	40186982	.	A	T	3	6	9	0	0	9	0	0
8	40187080	.	G	A	1	4	5	0	0	5	0	0
8	40189693	.	T	C	1	0	1	0	3	4	0	0
8	40189738	.	A	T	3	2	5	0	0	5	0	0
8	40192696	.	T	A	6	3	9	0	1	10	0	0
8	40196220	.	T	C	5	4	9	0	1	10	0	0
8	40196570	.	G	A	2	2	4	0	0	4	0	0
8	40199093	.	A	G	3	2	5	0	0	5	0	0
8	40201496	.	G	A	1	2	3	0	0	3	0	0
8	40204675	.	C	T	3	2	5	0	0	5	0	0
8	40204726	.	C	T	6	2	8	0	0	8	0	0
8	40217948	.	G	A	3	3	6	0	2	8	0	0
8	40226297	.	T	C	1	7	8	0	0	8	0	0
8	40234764	.	C	T	9	5	14	0	0	14	0	0
8	40234830	.	A	G	5	8	13	0	0	13	0	0
8	40234831	.	T	A	5	8	13	0	0	13	0	0
8	40235348	.	G	C	5	5	10	0	0	10	0	0
8	40236453	.	A	T	4	2	6	0	0	6	0	0
8	40240922	.	C	G	4	10	14	0	0	14	0	0
8	40241161	.	A	G	12	11	23	0	3	26	0	0
8	40241304	.	C	T	3	21	24	0	13	37	0	0
8	40241364	.	T	G	21	21	42	0	1	43	0	0
8	40241441	.	A	G	19	8	27	11	1	39	0	0
8	40241446	.	A	G	17	10	27	11	1	39	0	0
8	40241640	.	A	T	15	9	24	4	1	29	0	0
8	40241681	.	A	G	17	12	29	0	2	31	0	0
8	40241695	.	T	A	17	12	29	0	2	31	0	0
8	40241718	.	T	C	23	8	31	0	1	32	0	0
8	40241748	.	G	A	26	7	33	1	0	34	0	0
8	40241976	.	C	A	20	19	39	0	1	40	0	0
8	40242005	.	T	G	20	19	39	0	2	41	0	0
8	40242107	.	A	T	13	14	27	0	2	29	0	0
8	40242131	.	A	C	12	15	27	0	3	30	0	0
8	40242243	.	A	C	14	11	25	0	2	27	0	0
8	40242424	.	T	A	13	8	21	0	0	21	0	0
8	40242453	.	G	A	11	11	22	0	0	22	0	0
8	40242613	.	T	A	8	8	16	0	0	16	0	0
8	40242653	.	C	T	5	4	9	0	1	10	0	0
8	40242683	.	A	C	3	3	6	0	1	7	0	0
8	40243052	.	G	C	15	13	28	0	1	29	0	0
8	40243148	.	T	C	15	18	33	0	0	33	0	0
8	40248373	.	T	G	16	15	31	0	1	32	0	0
8	40248673	.	T	C	16	12	28	0	0	28	0	0
8	40248976	.	G	T	18	15	33	0	1	34	0	0
8	40250747	.	C	A	3	15	18	0	18	36	0	0
8	40250798	.	G	A	10	18	28	0	2	30	0	0
8	40251045	.	A	T	19	14	33	0	0	33	0	0
8	40251380	.	G	T	12	19	31	0	1	32	0	0
8	40251700	.	C	G	20	12	32	0	1	33	0	0
8	40254366	.	A	G	10	18	28	0	0	28	0	0
8	40254375	.	T	G	12	17	29	0	0	29	0	0
8	40254499	.	T	C	17	0	17	0	21	38	0	0
8	40270856	.	G	A	16	10	26	0	0	26	0	0
8	40270905	.	A	G	20	13	33	0	0	33	0	0
8	40325798	.	C	T	12	6	18	0	0	18	0	0
8	40325945	.	T	G	10	4	14	0	0	14	0	0
8	40326072	.	A	T	14	12	26	0	3	29	0	0
8	40326087	.	A	T	15	11	26	0	2	28	0	0
8	40326128	.	C	T	13	11	24	0	0	24	0	0
8	40326736	.	A	G	12	10	22	0	0	22	0	0
8	40327126	.	C	G	9	3	12	0	1	13	0	0
8	40327227	.	A	G	4	8	12	0	0	12	0	0
8	40427384	.	A	T	2	3	5	0	0	5	0	0
8	40428486	.	C	A	1	3	4	0	0	4	0	0
8	40430599	.	T	A	2	2	4	0	1	5	0	0
8	40433871	.	C	T	2	2	4	0	0	4	0	0
8	40433946	.	C	A	2	2	4	0	0	4	0	0
8	40525271	.	G	A	1	2	3	0	0	3	0	0
8	40629193	.	G	A	1	2	3	0	0	3	0	0
8	40629350	.	C	T	5	3	8	0	1	9	0	0
8	40631442	.	C	G	5	3	8	0	0	8	0	0
8	40632014	.	T	C	4	8	12	0	0	12	0	0
8	40632305	.	C	T	4	7	11	0	0	11	0	0
8	40632313	.	C	G	6	4	10	0	2	12	0	0
8	40632499	.	T	C	4	4	8	0	0	9	1	0
8	40632509	.	C	A	7	6	13	0	0	13	0	0
8	40632534	.	G	A	7	10	17	0	0	17	0	0
8	40632545	.	C	T	7	6	13	0	0	13	0	0
8	40645113	.	C	T	7	8	15	0	0	15	0	0
8	40645524	.	A	T	6	7	13	0	0	13	0	0
8	40645602	.	A	G	10	19	29	0	2	31	0	0
8	40645723	.	G	A	14	14	28	0	0	28	0	0
8	40646283	.	C	T	5	9	14	0	1	15	0	0
8	41173066	.	A	T	1	2	3	0	0	3	0	0
8	41173067	.	C	A	1	2	3	0	0	3	0	0
8	41186524	.	C	T	1	5	6	0	2	8	0	0
8	41193270	.	G	A	1	2	3	0	0	3	0	0
8	41194542	.	C	G	2	2	4	1	1	6	0	0
8	41197155	.	A	G	2	2	4	0	1	5	0	0
8	41228407	.	G	A	2	2	4	0	0	4	0	0
8	41229240	.	T	C	4	4	8	0	0	8	0	0
8	41235767	.	G	T	5	6	11	0	0	11	0	0
8	41235780	.	A	C	4	4	8	0	0	8	0	0
8	41238110	.	G	A	0	3	3	0	6	9	0	0
8	41243315	.	A	G	10	6	16	0	0	16	0	0
8	41243772	.	T	C	9	11	20	0	0	20	0	0
8	41249879	.	A	G	8	11	19	0	1	20	0	0
8	41249882	.	T	C	9	9	18	0	1	19	0	0
8	41249942	.	T	C	10	13	23	0	1	24	0	0
8	41255346	.	C	T	6	12	18	0	1	19	0	0
8	41255439	.	G	A	12	10	22	0	2	24	0	0
8	41255615	.	C	T	6	8	14	0	0	14	0	0
8	41260534	.	C	T	20	12	32	0	0	32	0	0
8	41260634	.	A	G	22	23	45	0	1	46	0	0
8	41260668	.	A	G	22	19	41	0	0	41	0	0
8	41260823	.	G	C	18	19	37	0	0	38	1	0
8	41260877	.	A	G	29	21	50	0	0	50	0	0
8	41260880	.	T	C	29	1	30	0	20	50	0	0
8	41260923	.	T	A	23	21	44	0	2	46	0	0
8	41261002	.	A	G	29	20	49	0	3	52	0	0
8	41261092	.	T	A	17	24	41	0	1	42	0	0
8	41261178	.	T	C	19	22	41	0	3	44	0	0
8	41261190	.	A	G	24	23	47	0	0	47	0	0
8	41261294	.	A	G	19	21	40	0	0	40	0	0
8	41263005	.	A	G	24	27	51	0	1	52	0	0
8	41263085	.	G	A	31	22	53	0	2	55	0	0
8	41263206	.	A	G	22	20	42	0	1	43	0	0
8	41263220	.	T	C	21	19	40	0	4	44	0	0
8	41264447	.	A	T	15	25	40	0	6	46	0	0
8	41264549	.	C	G	38	17	55	0	1	56	0	0
8	41264786	.	A	C	35	20	55	0	4	59	0	0
8	41264788	.	T	A	33	20	53	0	6	59	0	0
8	41265180	.	T	C	30	20	50	0	2	52	0	0
8	41265264	.	G	A	20	37	57	0	0	57	0	0
8	41265549	.	T	C	24	20	44	0	2	46	0	0
8	41266567	.	T	C	19	19	38	1	1	40	0	0
8	41266573	.	A	T	20	18	38	1	1	40	0	0
8	41267976	.	C	T	20	28	48	0	3	51	0	0
8	41462497	.	A	G	3	0	3	2	13	18	0	0
8	41462515	.	A	G	13	7	20	3	1	24	0	0
8	42138863	.	C	T	11	8	19	0	0	19	0	0
8	42138878	.	G	A	14	8	22	0	1	23	0	0
8	42139010	.	G	A	9	11	20	0	1	21	0	0
8	42238507	.	A	G	4	4	8	0	0	8	0	0
8	42238508	.	C	A	4	4	8	0	0	8	0	0
8	42642058	.	A	T	6	8	14	0	1	15	0	0
8	42642139	.	T	C	13	12	25	0	0	25	0	0
8	42642199	.	T	G	10	11	21	0	1	22	0	0
8	42642235	.	A	G	17	9	26	0	0	26	0	0
8	42642247	.	G	C	16	10	26	0	0	26	0	0
8	42642434	.	C	T	10	5	15	0	2	17	0	0
8	42642641	.	A	T	5	4	9	0	0	9	0	0
8	42642671	.	T	A	6	4	10	0	0	10	0	0
8	42642803	.	A	C	2	5	7	0	2	9	0	0
8	42642833	.	A	G	7	4	11	0	0	11	0	0
8	42643153	.	G	T	7	7	14	0	0	14	0	0
8	42649431	.	G	C	10	6	16	0	0	16	0	0
8	42649485	.	G	A	9	7	16	0	1	17	0	0
8	42650538	.	T	C	8	6	14	0	0	14	0	0
8	42650613	.	T	C	8	6	14	0	2	16	0	0
8	42653344	.	A	T	9	9	18	0	0	18	0	0
8	42653389	.	A	G	7	8	15	0	1	16	0	0
8	43379779	.	T	C	9	20	29	0	1	30	0	0
8	43380067	.	G	A	19	16	35	0	0	35	0	0
8	43380290	.	A	T	13	14	27	0	0	27	0	0
8	43380543	.	T	G	14	6	20	0	1	21	0	0
8	43380781	.	C	T	2	9	11	0	10	21	0	0
8	43380905	.	A	T	11	11	22	1	0	23	0	0
8	43380923	.	C	T	1	10	11	0	10	21	0	0
8	43381239	.	A	T	15	12	27	0	0	27	0	0
8	43381306	.	A	T	17	21	38	0	2	40	0	0
8	43381417	.	T	G	11	11	22	0	0	22	0	0
8	43381500	.	A	G	8	14	22	0	1	23	0	0
8	43381664	.	A	T	12	13	25	0	0	26	1	0
8	43382046	.	A	T	21	21	42	0	4	46	0	0
8	43386194	.	G	A	15	22	37	0	3	40	0	0
8	43386677	.	T	A	11	14	25	0	4	29	0	0
8	43393575	.	C	A	2	24	26	0	14	40	0	0
8	43400484	.	A	G	11	17	28	0	1	29	0	0
8	43400820	.	G	A	20	10	30	0	0	30	0	0
8	43400880	.	G	A	14	15	29	0	1	30	0	0
8	43401134	.	A	G	10	15	25	0	0	25	0	0
8	43401161	.	T	C	11	0	11	0	14	25	0	0
8	43401423	.	G	A	9	7	16	0	1	17	0	0
8	43413787	.	C	T	1	13	14	0	16	30	0	0
8	43419175	.	C	T	1	7	8	0	13	21	0	0
8	43419763	.	A	C	8	13	21	0	1	22	0	0
8	43423931	.	C	T	7	9	16	0	1	17	0	0
8	43424006	.	C	T	9	9	18	0	2	20	0	0
8	43424205	.	C	T	12	6	18	0	1	19	0	0
8	43455875	.	G	A	6	6	12	0	0	12	0	0
8	43486712	.	T	C	9	7	16	0	2	18	0	0
8	43501983	.	T	G	5	9	14	0	1	15	0	0
8	43574555	.	A	T	11	7	18	0	0	18	0	0
8	43668521	.	A	G	13	11	24	0	1	25	0	0
8	43668716	.	T	G	16	17	33	0	2	35	0	0
8	43671871	.	C	T	14	14	28	0	2	30	0	0
8	43675370	.	G	A	12	6	18	0	2	20	0	0
8	43675698	.	T	A	10	7	17	0	2	19	0	0
8	43677718	.	T	C	13	5	18	0	0	18	0	0
8	43677736	.	A	C	10	6	16	0	1	17	0	0
8	43680438	.	A	G	11	9	20	0	3	23	0	0
8	43680469	.	T	G	9	12	21	0	2	23	0	0
8	43680500	.	T	C	8	6	14	0	1	15	0	0
8	43680510	.	A	G	10	7	17	0	0	17	0	0
8	43682544	.	A	G	8	6	14	0	1	15	0	0
8	43683133	.	G	A	5	9	14	0	1	15	0	0
8	43688536	.	A	G	11	4	15	0	1	16	0	0
8	43688847	.	G	A	9	6	15	0	1	16	0	0
8	43693140	.	A	C	10	5	15	0	2	17	0	0
8	43693392	.	A	G	8	6	14	1	1	16	0	0
8	43700886	.	T	C	3	0	3	0	12	15	0	0
8	43700901	.	T	A	4	9	13	0	0	13	0	0
8	43700951	.	G	T	8	6	14	0	0	14	0	0
8	43701731	.	A	G	5	5	10	0	0	10	0	0
8	43703589	.	T	G	7	8	15	0	1	16	0	0
8	43703664	.	G	A	6	5	11	0	0	11	0	0
8	43706201	.	A	G	3	3	6	0	0	6	0	0
8	43708257	.	A	C	5	5	10	0	0	10	0	0
8	43708440	.	C	T	1	4	5	0	7	12	0	0
8	43708637	.	A	G	4	3	7	0	0	7	0	0
8	43711819	.	G	T	5	6	11	0	1	12	0	0
8	43712187	.	G	A	2	2	4	0	1	5	0	0
8	43712309	.	A	C	11	6	17	0	0	17	0	0
8	43717174	.	A	T	5	6	11	0	0	11	0	0
8	43717198	.	T	A	6	4	10	0	0	10	0	0
8	43720121	.	C	T	2	6	8	0	0	8	0	0
8	43720325	.	T	C	3	5	8	0	0	8	0	0
8	43720343	.	T	C	4	7	11	0	0	11	0	0
8	43720373	.	T	G	3	8	11	0	1	12	0	0
8	43720778	.	A	T	3	3	6	0	0	6	0	0
8	43720811	.	A	G	2	4	6	0	0	6	0	0
8	43736215	.	A	C	2	3	5	0	0	5	0	0
8	43934966	.	G	A	2	5	7	0	1	8	0	0
8	43935120	.	A	G	23	12	35	0	0	35	0	0
8	43935351	.	A	T	3	4	7	0	0	7	0	0
8	43935481	.	C	T	8	11	19	0	1	20	0	0
8	43935552	.	A	G	5	14	19	0	0	19	0	0
8	43935679	.	A	T	2	5	7	0	0	7	0	0
8	43935680	.	A	C	2	4	6	0	1	7	0	0
8	43935879	.	C	G	7	11	18	0	1	19	0	0
8	43944366	.	C	T	6	4	10	0	0	10	0	0
8	43960570	.	T	C	7	5	12	0	0	12	0	0
8	43967218	.	A	G	6	10	16	0	1	17	0	0
8	43967698	.	A	G	8	3	11	0	0	11	0	0
8	43974538	.	T	A	5	6	11	1	1	13	0	0
8	43991452	.	G	C	2	4	6	0	1	7	0	0
8	44003950	.	A	G	9	7	16	0	0	16	0	0
8	44004004	.	A	C	4	4	8	0	0	8	0	0
8	45396028	.	T	C	8	0	8	0	7	15	0	0
8	45427189	.	C	A	29	21	50	0	3	53	0	0
8	45428039	.	C	T	22	21	43	0	0	43	0	0
8	45430757	.	G	A	19	33	52	0	3	55	0	0
8	45608699	.	C	T	3	2	5	0	0	5	0	0
8	45755078	.	A	G	2	3	5	0	0	5	0	0
8	45755732	.	C	T	35	19	54	0	5	59	0	0
8	45755973	.	C	G	36	34	70	0	2	72	0	0
8	45759960	.	C	T	33	26	59	0	3	62	0	0
8	45760071	.	A	C	16	0	16	0	9	25	0	0
8	45763511	.	T	G	2	4	6	0	2	8	0	0
8	45763537	.	A	T	9	9	18	0	0	18	0	0
8	45763562	.	G	A	10	16	26	0	0	26	0	0
8	45763670	.	C	T	22	10	32	0	2	34	0	0
8	45763872	.	T	A	13	11	24	0	3	27	0	0
8	45763991	.	A	G	14	22	36	0	0	36	0	0
8	45764006	.	G	C	24	10	34	0	0	34	0	0
8	45764665	.	G	C	13	0	13	0	12	25	0	0
8	45765170	.	C	T	4	32	36	0	33	69	0	0
8	45765188	.	A	T	33	33	66	0	2	68	0	0
8	45765326	.	G	A	31	28	59	0	4	63	0	0
8	45772961	.	G	C	23	12	35	0	0	35	0	0
8	45774471	.	C	T	1	16	17	0	20	37	0	0
8	45775089	.	C	T	14	15	29	0	1	30	0	0
8	45779729	.	A	C	19	15	34	0	2	36	0	0
8	45786186	.	C	T	0	22	22	0	10	32	0	0
8	45786612	.	G	T	13	16	29	0	0	29	0	0
8	45786615	.	A	G	12	15	27	0	2	29	0	0
8	45787137	.	A	G	18	20	38	0	0	38	0	0
8	45788941	.	T	G	14	18	32	0	1	33	0	0
8	45789130	.	T	C	15	12	27	0	1	28	0	0
8	45793550	.	A	C	15	16	31	0	1	32	0	0
8	45797305	.	G	A	16	16	32	0	0	32	0	0
8	45834940	.	G	A	12	16	28	0	1	29	0	0
8	45838228	.	C	T	7	9	16	0	0	16	0	0
8	45838347	.	T	C	3	2	5	0	0	5	0	0
8	45838370	.	A	G	2	2	4	0	0	4	0	0
8	45838449	.	G	A	2	1	3	0	1	4	0	0
8	45838455	.	A	G	1	1	2	0	1	3	0	0
8	45852874	.	C	A	1	3	4	0	1	5	0	0
8	45853475	.	G	A	1	4	5	0	0	5	0	0
8	45853533	.	T	C	1	6	7	0	4	11	0	0
8	45853574	.	A	G	8	7	15	0	0	15	0	0
8	45853626	.	G	A	7	10	17	0	0	17	0	0
8	45859500	.	A	G	12	15	27	0	0	27	0	0
8	45862402	.	A	G	14	13	27	0	0	27	0	0
8	45864652	.	G	C	14	11	25	0	0	25	0	0
8	45875593	.	T	C	4	5	9	0	0	9	0	0
8	45879493	.	T	C	4	0	4	0	5	9	0	0
8	45880074	.	T	A	8	6	14	0	1	16	1	0
8	45880125	.	G	A	10	4	14	0	0	14	0	0
8	45883767	.	C	T	0	5	5	0	7	12	0	0
8	45896997	.	T	C	3	0	3	0	6	9	0	0
8	45898077	.	A	G	2	5	7	0	0	7	0	0
8	45907117	.	C	T	3	3	6	0	1	7	0	0
8	45911899	.	C	T	2	5	7	0	1	8	0	0
8	45939385	.	G	A	5	6	11	0	0	11	0	0
8	45939398	.	A	G	5	7	12	0	0	12	0	0
8	45939533	.	G	C	4	5	9	0	0	9	0	0
8	45939585	.	G	A	7	5	12	0	1	13	0	0
8	45939607	.	A	G	8	10	18	0	0	18	0	0
8	45939648	.	C	G	5	5	10	0	0	16	6	0
8	45944896	.	T	A	12	7	19	0	0	19	0	0
8	45948718	.	G	A	11	8	19	0	5	24	0	0
8	45952072	.	C	G	2	4	6	0	0	6	0	0
8	45952231	.	T	C	11	4	15	0	1	16	0	0
8	45952352	.	G	C	6	5	11	0	0	11	0	0
8	45952423	.	A	G	7	4	11	0	0	11	0	0
8	45952500	.	A	G	2	0	2	0	4	6	0	0
8	45961935	.	A	G	1	2	3	0	0	3	0	0
8	45961976	.	T	A	1	2	3	0	0	3	0	0
8	45962391	.	G	C	2	2	4	0	1	5	0	0
8	45962432	.	G	T	1	4	5	0	0	5	0	0
8	45965749	.	G	A	2	2	4	0	0	4	0	0
8	46005284	.	T	A	2	2	4	0	0	4	0	0
8	46077757	.	C	T	8	8	16	0	0	16	0	0
8	46077819	.	G	A	12	5	17	0	0	17	0	0
8	46077879	.	C	A	8	4	12	0	1	13	0	0
8	46078264	.	A	T	6	10	16	0	0	16	0	0
8	46078287	.	A	G	6	11	17	0	0	17	0	0
8	46078309	.	C	T	8	6	14	0	0	14	0	0
8	46078342	.	C	G	8	4	12	0	0	12	0	0
8	46078415	.	T	G	6	3	9	0	0	9	0	0
8	46078423	.	C	T	3	3	6	0	4	10	0	0
8	46085480	.	A	T	16	12	28	0	0	28	0	0
8	46089037	.	G	T	14	19	33	0	3	36	0	0
8	46089052	.	T	C	18	20	38	0	1	39	0	0
8	46089634	.	C	T	15	18	33	0	0	33	0	0
8	46094790	.	G	A	6	11	17	0	0	17	0	0
8	46123731	.	G	A	10	9	19	0	0	19	0	0
8	46125509	.	G	A	5	7	12	0	2	14	0	0
8	46132662	.	G	C	6	0	6	0	7	13	0	0
8	46160980	.	C	T	0	9	9	0	11	20	0	0
8	46188003	.	A	G	6	12	18	0	0	18	0	0
8	46188018	.	A	G	8	8	16	0	1	17	0	0
8	46218095	.	A	G	1	4	5	0	0	5	0	0
8	46220826	.	C	T	2	10	12	0	0	12	0	0
8	46220848	.	A	C	1	11	12	0	0	12	0	0
8	46228719	.	C	T	1	14	15	0	7	22	0	0
8	46231128	.	A	G	7	11	18	0	0	18	0	0
8	46233594	.	C	T	5	8	13	0	2	15	0	0
8	46233600	.	T	C	4	0	4	0	10	14	0	0
8	46247717	.	T	C	5	5	10	0	0	10	0	0
8	46258216	.	A	G	10	6	16	0	0	16	0	0
8	46286410	.	T	C	4	5	9	0	1	10	0	0
8	46286443	.	G	A	1	5	6	0	1	7	0	0
8	46296796	.	G	A	9	6	15	0	1	16	0	0
8	46296830	.	A	G	6	6	12	0	0	12	0	0
8	46296851	.	T	C	3	6	9	0	0	9	0	0
8	46310717	.	G	A	3	7	10	0	1	11	0	0
8	46310897	.	A	G	5	5	10	0	0	10	0	0
8	46337310	.	A	G	4	2	6	0	2	8	0	0
8	46340777	.	A	G	4	0	4	0	4	8	0	0
8	46346713	.	C	T	7	4	11	0	0	11	0	0
8	46346728	.	T	C	6	5	11	0	1	12	0	0
8	46346857	.	T	C	11	8	19	0	1	20	0	0
8	46347060	.	A	G	8	3	11	0	0	11	0	0
8	46347099	.	A	T	7	6	13	0	0	13	0	0
8	46347445	.	C	T	3	2	5	0	0	5	0	0
8	46348083	.	A	T	5	4	9	0	0	9	0	0
8	46348121	.	G	A	0	2	2	0	5	7	0	0
8	46348178	.	A	G	5	2	7	0	0	7	0	0
8	46348391	.	T	A	2	3	5	0	0	5	0	0
8	46353290	.	G	C	1	3	4	0	0	4	0	0
8	46356282	.	G	A	4	3	7	0	2	9	0	0
8	46362082	.	G	A	3	2	5	0	1	6	0	0
8	46362083	.	G	T	3	2	5	0	1	6	0	0
8	47834998	.	G	A	6	3	9	0	0	9	0	0
8	47835146	.	T	C	6	6	12	0	1	13	0	0
8	47835148	.	C	T	8	5	13	0	0	13	0	0
8	47835307	.	A	T	6	5	11	0	0	11	0	0
8	47835337	.	A	G	4	4	8	0	0	8	0	0
8	47843557	.	T	A	4	4	8	0	1	9	0	0
8	47843962	.	A	T	6	3	9	0	1	10	0	0
8	47844022	.	A	G	4	4	8	0	0	8	0	0
8	47911031	.	C	G	9	0	9	0	14	23	0	0
8	47917304	.	C	T	11	12	23	0	1	24	0	0
8	47927814	.	C	T	14	7	21	0	0	21	0	0
8	47928187	.	T	A	10	7	17	0	1	19	1	0
8	47932409	.	C	T	13	12	25	0	2	27	0	0
8	47932442	.	G	A	12	14	26	0	2	28	0	0
8	47937152	.	T	C	15	16	31	0	2	33	0	0
8	47937156	.	A	G	17	0	17	0	17	34	0	0
8	47937263	.	T	C	20	23	43	0	1	44	0	0
8	47946517	.	T	C	20	9	29	0	4	33	0	0
8	47946674	.	G	A	5	7	12	0	1	13	0	0
8	47946753	.	C	T	13	10	23	0	0	23	0	0
8	47946776	.	T	C	11	13	24	0	0	24	0	0
8	47946833	.	A	G	11	17	28	0	2	30	0	0
8	47946846	.	A	G	11	14	25	0	2	27	0	0
8	47947052	.	A	C	10	6	16	0	1	17	0	0
8	47947297	.	C	T	8	12	20	0	1	21	0	0
8	47947341	.	C	A	12	7	19	0	1	20	0	0
8	47947649	.	T	A	18	7	25	1	1	27	0	0
8	47947772	.	A	G	10	1	11	0	17	28	0	0
8	47947996	.	T	G	16	14	30	0	0	30	0	0
8	47948102	.	T	A	15	14	29	0	2	31	0	0
8	47948602	.	G	A	1	15	16	0	12	28	0	0
8	47948755	.	C	T	14	12	26	0	1	27	0	0
8	47948820	.	A	C	12	6	18	0	0	18	0	0
8	47948866	.	C	A	2	5	7	0	0	7	0	0
8	48093139	.	T	C	1	1	2	0	1	3	0	0
8	48492578	.	G	C	1	2	3	0	0	3	0	0
8	48494896	.	G	A	1	3	4	0	0	4	0	0
8	48603552	.	T	C	16	6	22	0	0	22	0	0
8	48603788	.	G	C	2	6	8	0	3	11	0	0
8	48603978	.	T	A	4	8	12	0	0	12	0	0
8	48629640	.	T	A	6	8	14	0	1	15	0	0
8	48629668	.	G	A	9	4	13	0	1	14	0	0
8	48629797	.	C	A	9	12	21	0	0	21	0	0
8	48629946	.	A	T	8	5	13	0	4	17	0	0
8	48629969	.	T	C	10	0	10	0	10	20	0	0
8	48630017	.	A	G	10	5	15	0	0	15	0	0
8	48642433	.	G	A	10	12	22	0	0	22	0	0
8	48642496	.	A	G	15	5	20	0	0	20	0	0
8	48646053	.	A	G	2	5	7	0	0	7	0	0
8	48646089	.	G	A	2	4	6	0	0	6	0	0
8	48649106	.	A	C	6	7	13	0	0	13	0	0
8	48656268	.	C	A	2	3	5	0	0	5	0	0
8	48658757	.	T	A	4	2	6	0	2	8	0	0
8	48660930	.	G	A	5	3	8	0	0	8	0	0
8	48801508	.	C	T	4	17	21	0	2	23	0	0
8	48801553	.	C	T	12	7	19	0	0	19	0	0
8	48801678	.	C	T	11	7	18	0	0	18	0	0
8	48809531	.	C	G	9	4	13	0	2	15	0	0
8	48809570	.	G	A	5	8	13	0	0	13	0	0
8	48809587	.	T	G	5	4	9	0	0	9	0	0
8	48809678	.	A	C	10	11	21	0	1	22	0	0
8	48816438	.	T	G	2	1	3	0	0	3	0	0
8	48816447	.	C	T	0	2	2	0	2	4	0	0
8	48816474	.	G	A	2	4	6	0	0	6	0	0
8	48823807	.	A	G	2	1	3	0	1	4	0	0
8	48958468	.	C	T	3	4	7	0	2	9	0	0
8	48958637	.	A	G	8	5	13	0	0	13	0	0
8	48958822	.	C	T	16	8	24	0	0	24	0	0
8	48959047	.	G	A	3	11	14	0	1	15	0	0
8	48965853	.	C	G	5	4	9	0	0	9	0	0
8	48966140	.	C	G	9	5	14	0	0	14	0	0
8	48991948	.	C	T	7	7	14	0	0	14	0	0
8	49003785	.	A	G	10	0	10	0	11	21	0	0
8	49009822	.	C	A	10	12	22	1	1	24	0	0
8	49009829	.	C	T	14	8	22	1	1	24	0	0
8	49009917	.	T	C	7	7	14	0	2	16	0	0
8	49021126	.	C	T	5	4	9	0	1	10	0	0
8	49034320	.	A	G	2	7	9	0	0	9	0	0
8	49067166	.	G	C	2	3	5	0	0	5	0	0
8	49067363	.	A	T	1	1	2	0	0	2	0	0
8	49067370	.	A	T	1	2	3	0	0	3	0	0
8	49073099	.	T	C	2	4	6	0	0	6	0	0
8	49078792	.	G	A	0	5	5	0	3	8	0	0
8	49086105	.	G	T	5	2	7	0	0	7	0	0
8	49092063	.	T	A	6	8	14	0	0	14	0	0
8	49092108	.	C	T	14	7	21	0	0	21	0	0
8	49092129	.	C	T	14	4	18	0	0	18	0	0
8	49096541	.	G	T	9	8	17	1	0	18	0	0
8	49108347	.	A	T	10	20	30	0	2	32	0	0
8	49170366	.	T	A	32	35	67	0	3	70	0	0
8	49172338	.	A	G	37	31	68	0	2	70	0	0
8	49310830	.	C	T	6	12	18	0	0	18	0	0
8	49310925	.	T	C	8	3	11	0	2	13	0	0
8	49310928	.	T	C	2	10	12	0	0	12	0	0
8	49311090	.	C	T	15	17	32	0	0	32	0	0
8	49311242	.	G	A	10	5	15	0	3	18	0	0
8	49311355	.	T	C	16	23	39	1	1	41	0	0
8	49311396	.	C	A	20	17	37	1	0	38	0	0
8	49311398	.	G	C	20	16	36	1	1	38	0	0
8	49345116	.	C	T	19	19	38	0	1	39	0	0
8	49345191	.	T	C	18	24	42	0	1	43	0	0
8	49345212	.	G	T	18	17	35	0	1	36	0	0
8	49345272	.	A	G	23	18	41	0	5	46	0	0
8	49404152	.	G	T	19	14	33	1	2	36	0	0
8	49404262	.	C	T	31	23	54	1	4	59	0	0
8	49404502	.	C	T	30	39	69	0	2	71	0	0
8	49404928	.	C	T	40	31	71	0	1	72	0	0
8	49405199	.	C	T	4	2	6	0	0	6	0	0
8	49405214	.	G	C	4	3	7	0	0	7	0	0
8	49406014	.	G	A	1	4	5	0	1	6	0	0
8	49406035	.	G	A	2	5	7	0	0	7	0	0
8	49413417	.	G	T	41	38	79	0	7	86	0	0
8	49413444	.	G	A	37	32	69	0	6	75	0	0
8	49413459	.	G	A	36	31	67	0	5	72	0	0
8	49415718	.	G	C	31	29	60	0	2	62	0	0
8	49435964	.	C	G	19	9	28	0	1	29	0	0
8	49443191	.	A	G	19	0	19	0	17	36	0	0
8	49447519	.	G	A	3	9	12	0	0	12	0	0
8	49447559	.	G	T	2	8	10	0	2	12	0	0
8	49447574	.	T	G	2	9	11	0	0	11	0	0
8	49478413	.	C	T	0	1	1	0	2	3	0	0
8	49623131	.	G	A	2	4	6	0	0	6	0	0
8	50835254	.	A	G	3	6	9	0	2	11	0	0
8	50949903	.	A	G	26	0	26	0	20	46	0	0
8	51228659	.	G	A	1	4	5	0	0	5	0	0
8	51244397	.	C	T	3	3	6	0	0	6	0	0
8	51247891	.	G	C	3	4	7	0	0	7	0	0
8	51309145	.	T	G	21	13	34	0	0	34	0	0
8	51309311	.	A	G	14	19	33	0	0	33	0	0
8	51314087	.	G	A	23	14	37	0	0	37	0	0
8	51320547	.	C	T	13	9	22	0	4	27	1	0
8	51320652	.	C	T	8	13	21	0	0	21	0	0
8	51325510	.	T	G	15	15	30	0	1	31	0	0
8	51330776	.	T	C	16	7	23	0	0	23	0	0
8	51330836	.	A	T	9	10	19	0	2	21	0	0
8	51351121	.	C	T	7	11	18	0	0	18	0	0
8	51351155	.	T	A	5	4	9	0	0	9	0	0
8	51351200	.	A	T	7	10	17	0	2	19	0	0
8	51352480	.	A	G	12	17	29	0	0	29	0	0
8	51352525	.	A	T	14	13	27	0	4	31	0	0
8	51358769	.	G	A	13	13	26	0	3	29	0	0
8	51364515	.	T	C	7	7	14	0	1	15	0	0
8	51364644	.	C	A	0	13	13	0	16	29	0	0
8	51364665	.	T	C	14	9	23	0	3	26	0	0
8	51364696	.	C	G	18	5	23	0	1	24	0	0
8	51364713	.	C	A	1	5	6	0	17	23	0	0
8	51367178	.	A	T	14	10	24	0	0	24	0	0
8	51367206	.	C	T	10	10	20	0	0	20	0	0
8	51367217	.	C	T	11	11	22	0	1	23	0	0
8	51367267	.	A	T	8	11	19	0	2	21	0	0
8	51375405	.	T	G	16	17	33	0	2	35	0	0
8	51379609	.	G	A	8	14	22	0	0	22	0	0
8	51379699	.	G	A	11	19	30	0	0	30	0	0
8	51379741	.	A	T	16	20	36	0	0	36	0	0
8	51379747	.	G	A	15	20	35	0	0	35	0	0
8	51383765	.	C	T	9	20	29	0	3	32	0	0
8	51431396	.	C	T	0	8	8	0	9	17	0	0
8	51431741	.	T	C	2	5	7	0	0	7	0	0
8	51431879	.	C	T	1	4	5	0	0	5	0	0
8	51432097	.	T	C	9	3	12	0	0	12	0	0
8	51433141	.	G	T	2	2	4	0	0	4	0	0
8	51433511	.	T	G	1	2	3	0	1	4	0	0
8	51433512	.	G	T	1	3	4	0	0	4	0	0
8	51434384	.	C	T	1	2	3	0	2	5	0	0
8	51437284	.	G	A	4	5	9	0	0	9	0	0
8	51439541	.	T	C	1	0	1	0	6	7	0	0
8	51445912	.	G	A	4	2	6	0	0	6	0	0
8	51482050	.	A	G	2	6	8	0	0	8	0	0
8	51485239	.	C	A	3	2	5	0	0	5	0	0
8	51485935	.	T	C	4	2	6	0	0	6	0	0
8	51507161	.	C	T	1	3	4	0	0	4	0	0
8	51524151	.	C	T	1	3	4	0	0	4	0	0
8	51573130	.	T	C	3	3	6	0	0	6	0	0
8	51573166	.	G	A	4	2	6	0	0	6	0	0
8	51573167	.	C	T	4	1	5	0	1	6	0	0
8	51573283	.	T	C	1	0	1	0	2	3	0	0
8	51573293	.	A	G	1	2	3	0	0	3	0	0
8	51576907	.	C	T	1	4	5	0	2	7	0	0
8	51576997	.	T	G	2	5	7	0	0	7	0	0
8	51587259	.	A	G	2	2	4	0	0	4	0	0
8	51634935	.	T	C	2	0	2	0	3	5	0	0
8	51635358	.	A	G	2	2	4	0	0	4	0	0
8	51723249	.	A	G	7	5	12	1	0	13	0	0
8	51723285	.	G	A	1	17	18	2	6	26	0	0
8	51723320	.	A	G	9	12	21	2	2	25	0	0
8	51779797	.	C	T	0	6	6	0	1	7	0	0
8	51781307	.	G	T	4	2	6	0	1	7	0	0
8	51782044	.	A	G	8	13	21	0	2	23	0	0
8	51826625	.	C	T	0	4	4	1	6	11	0	0
8	51827243	.	C	T	8	7	15	0	0	15	0	0
8	51932251	.	G	C	1	3	4	0	0	4	0	0
8	51945796	.	A	G	2	2	4	0	0	4	0	0
8	51951977	.	G	A	1	2	3	0	0	3	0	0
8	51992501	.	G	T	6	4	10	0	0	10	0	0
8	51996707	.	A	G	9	9	18	0	0	18	0	0
8	51996727	.	A	G	8	10	18	0	0	18	0	0
8	52001776	.	C	T	1	19	20	0	9	29	0	0
8	52001785	.	A	G	11	16	27	0	2	29	0	0
8	52002903	.	C	T	1	18	19	0	10	29	0	0
8	52002945	.	T	A	15	15	30	0	1	31	0	0
8	52005582	.	A	C	9	12	21	0	0	21	0	0
8	52006139	.	C	T	0	13	13	0	6	19	0	0
8	52010799	.	T	C	5	8	13	0	0	13	0	0
8	52012737	.	T	A	7	4	11	0	0	11	0	0
8	52015712	.	G	T	15	6	21	0	0	21	0	0
8	52016041	.	G	A	8	7	15	0	0	15	0	0
8	52016101	.	T	C	7	8	15	1	1	17	0	0
8	52016128	.	G	A	8	7	15	1	2	18	0	0
8	52026702	.	C	A	5	5	10	0	0	10	0	0
8	52029849	.	T	C	6	9	15	0	0	15	0	0
8	52029852	.	G	A	6	9	15	0	0	15	0	0
8	52029978	.	C	T	0	6	6	0	6	12	0	0
8	52030185	.	G	A	9	6	15	0	0	15	0	0
8	52031962	.	A	G	7	4	11	0	0	11	0	0
8	52031965	.	A	G	6	4	10	0	0	10	0	0
8	52032016	.	T	A	4	8	12	0	0	12	0	0
8	52034720	.	G	A	9	7	16	0	0	16	0	0
8	52036344	.	G	C	8	5	13	0	0	13	0	0
8	52036359	.	A	G	5	5	10	0	0	10	0	0
8	52036392	.	A	G	5	2	7	0	0	7	0	0
8	52037800	.	A	G	2	3	5	0	0	5	0	0
8	52037830	.	C	A	1	3	4	0	0	4	0	0
8	52039233	.	A	G	5	3	8	0	2	10	0	0
8	52042175	.	T	C	11	0	11	0	5	16	0	0
8	52042206	.	G	A	5	5	10	0	0	10	0	0
8	52042293	.	C	G	1	4	5	0	5	10	0	0
8	52042891	.	T	C	5	3	8	0	0	8	0	0
8	52042893	.	G	A	4	3	7	0	0	7	0	0
8	52043119	.	T	A	3	4	7	0	0	7	0	0
8	52050643	.	T	A	5	8	13	0	0	13	0	0
8	52065100	.	A	C	2	0	2	0	7	9	0	0
8	52070341	.	T	C	5	0	5	0	3	8	0	0
8	52070944	.	G	T	2	4	6	0	0	6	0	0
8	52073386	.	G	A	1	4	5	0	0	5	0	0
8	52073392	.	G	A	1	4	5	0	0	5	0	0
8	52077323	.	T	G	4	4	8	1	2	11	0	0
8	52079212	.	C	T	4	4	8	0	0	8	0	0
8	52079217	.	G	A	2	3	5	0	2	7	0	0
8	52081269	.	G	A	1	3	4	0	0	4	0	0
8	52081491	.	G	T	4	4	8	0	0	8	0	0
8	52083106	.	G	A	7	3	10	0	0	10	0	0
8	52083125	.	C	T	5	5	10	0	0	10	0	0
8	52083264	.	T	C	3	3	6	0	0	6	0	0
8	52108373	.	T	C	3	0	3	0	5	8	0	0
8	52108512	.	T	A	3	2	5	0	0	5	0	0
8	52108533	.	G	A	4	2	6	0	0	6	0	0
8	52108611	.	T	G	1	2	3	0	0	3	0	0
8	52108621	.	C	A	2	2	4	0	1	5	0	0
8	52108665	.	T	C	7	4	11	0	0	11	0	0
8	52109133	.	T	C	3	2	5	0	0	5	0	0
8	52109499	.	T	A	3	4	7	0	0	7	0	0
8	52109581	.	A	G	7	4	11	0	0	11	0	0
8	52109686	.	T	G	9	5	14	1	0	15	0	0
8	52109730	.	T	G	6	8	14	0	1	15	0	0
8	52143086	.	A	G	3	4	7	0	0	7	0	0
8	52226378	.	A	C	4	2	6	0	0	6	0	0
8	52292515	.	T	C	10	8	18	0	1	19	0	0
8	52297140	.	G	A	1	3	4	0	6	10	0	0
8	52297230	.	C	A	5	2	7	0	0	7	0	0
8	52297287	.	A	G	3	5	8	0	0	8	0	0
8	52297301	.	A	G	1	4	5	0	0	5	0	0
8	52314602	.	G	A	3	3	6	0	0	6	0	0
8	52314637	.	G	T	0	8	8	0	10	18	0	0
8	52322189	.	C	G	4	0	4	0	10	14	0	0
8	52324918	.	A	G	5	9	14	0	0	14	0	0
8	52325721	.	A	G	12	0	12	0	13	25	0	0
8	52334574	.	G	A	2	2	4	0	0	4	0	0
8	52336870	.	T	C	10	8	18	0	4	22	0	0
8	52342586	.	A	C	8	10	18	0	2	20	0	0
8	52345733	.	T	C	8	9	17	0	4	21	0	0
8	52345751	.	T	C	8	11	19	0	4	23	0	0
8	52345915	.	T	C	11	8	19	0	1	20	0	0
8	52346035	.	T	C	6	10	16	0	2	18	0	0
8	52346072	.	A	T	5	8	13	0	0	13	0	0
8	52346111	.	A	C	5	7	12	0	1	14	1	0
8	52346225	.	A	T	3	5	8	0	1	9	0	0
8	52347199	.	A	G	8	4	12	0	0	12	0	0
8	52347208	.	A	G	9	3	12	0	0	13	1	0
8	52347460	.	C	T	7	8	15	0	0	15	0	0
8	52348575	.	A	G	4	5	9	0	0	9	0	0
8	52348576	.	A	G	4	5	9	0	0	9	0	0
8	52348685	.	T	C	9	9	18	0	0	18	0	0
8	52350026	.	A	T	2	7	9	0	1	10	0	0
8	52350101	.	A	G	12	0	12	0	8	24	4	0
8	52350146	.	A	G	16	0	16	0	10	26	0	0
8	52350251	.	A	G	6	12	18	0	0	18	0	0
8	52350322	.	T	G	2	4	6	0	0	6	0	0
8	52408619	.	G	A	28	25	53	0	1	54	0	0
8	52411451	.	T	C	21	24	45	0	0	45	0	0
8	52412982	.	A	G	17	20	37	1	2	40	0	0
8	52412985	.	C	G	17	20	37	1	0	38	0	0
8	52453432	.	A	C	6	3	9	0	0	9	0	0
8	52453862	.	T	A	11	11	22	0	2	24	0	0
8	52455588	.	A	G	6	11	17	0	0	17	0	0
8	52455610	.	A	G	6	12	18	0	0	18	0	0
8	52455638	.	C	G	8	9	17	0	2	19	0	0
8	52463828	.	T	A	6	8	14	0	1	15	0	0
8	52463855	.	C	T	0	7	7	0	4	11	0	0
8	52472930	.	C	G	9	7	16	1	0	17	0	0
8	52472955	.	C	T	0	5	5	1	7	13	0	0
8	52472997	.	T	C	4	4	8	0	0	8	0	0
8	52473043	.	C	G	1	3	4	0	0	4	0	0
8	52473054	.	G	T	1	3	4	0	0	4	0	0
8	52491586	.	G	A	9	7	16	0	0	16	0	0
8	52509568	.	C	A	4	4	8	0	0	8	0	0
8	52509624	.	G	A	3	3	6	0	1	7	0	0
8	52509762	.	A	T	3	5	8	0	0	8	0	0
8	52509859	.	C	T	4	5	9	0	1	10	0	0
8	52521261	.	T	C	6	6	12	0	1	13	0	0
8	52521280	.	T	G	5	7	12	0	0	12	0	0
8	52524436	.	A	T	8	9	17	0	1	18	0	0
8	52528607	.	A	G	1	0	1	0	6	7	0	0
8	52528665	.	A	G	7	4	11	0	1	12	0	0
8	52528717	.	A	G	7	17	24	0	0	24	0	0
8	52528856	.	C	G	7	4	11	0	0	11	0	0
8	52529123	.	C	T	7	5	12	0	0	12	0	0
8	52529206	.	T	C	8	8	16	0	0	16	0	0
8	52529235	.	G	A	7	9	16	0	1	17	0	0
8	52529397	.	A	G	10	4	14	0	0	14	0	0
8	52529549	.	T	C	3	3	6	0	0	6	0	0
8	52534158	.	A	G	3	4	7	0	0	7	0	0
8	52538056	.	G	A	0	3	3	0	5	8	0	0
8	52538062	.	G	A	0	3	3	0	5	8	0	0
8	52547038	.	T	G	8	4	12	0	1	13	0	0
8	52547091	.	T	C	6	8	14	0	0	14	0	0
8	52547356	.	A	G	4	7	11	1	0	12	0	0
8	52547519	.	C	G	3	0	3	0	3	6	0	0
8	52547569	.	T	A	2	2	4	0	0	4	0	0
8	52547727	.	G	C	4	5	9	0	0	9	0	0
8	52547787	.	T	A	1	3	4	0	1	5	0	0
8	52550361	.	C	T	6	5	11	0	0	11	0	0
8	52550373	.	T	C	6	0	6	0	5	11	0	0
8	52550462	.	A	G	3	5	8	0	0	8	0	0
8	52553126	.	G	T	12	8	20	0	1	22	1	0
8	52553162	.	G	A	7	11	18	0	0	18	0	0
8	52553193	.	A	T	4	10	14	0	1	15	0	0
8	52553197	.	A	G	3	10	13	0	0	13	0	0
8	52554799	.	T	A	5	5	10	0	1	11	0	0
8	52555050	.	G	A	11	7	18	0	0	18	0	0
8	52555077	.	C	G	9	8	17	0	0	17	0	0
8	52555137	.	G	A	3	10	13	0	1	14	0	0
8	52557454	.	G	T	6	8	14	1	0	15	0	0
8	52559996	.	G	T	2	3	5	0	0	5	0	0
8	52560034	.	T	C	7	9	16	0	1	17	0	0
8	52560058	.	T	C	8	7	15	0	1	16	0	0
8	52561397	.	C	T	9	4	13	0	1	14	0	0
8	52561421	.	C	A	8	4	12	0	1	13	0	0
8	52561477	.	C	A	8	5	13	0	0	13	0	0
8	52563316	.	T	G	3	9	12	0	1	13	0	0
8	52563364	.	C	T	7	11	18	0	0	18	0	0
8	52563427	.	C	T	2	5	7	0	7	14	0	0
8	52565319	.	T	C	3	6	9	0	1	10	0	0
8	52580094	.	A	G	4	6	10	0	0	10	0	0
8	52580169	.	A	G	2	6	8	0	0	8	0	0
8	52584168	.	C	T	3	7	10	0	0	10	0	0
8	52584246	.	T	A	7	3	10	0	1	11	0	0
8	52584249	.	A	T	7	3	10	0	1	11	0	0
8	52591539	.	G	A	4	3	7	0	0	7	0	0
8	52594076	.	C	T	3	2	5	0	0	5	0	0
8	52601365	.	T	C	1	2	3	0	0	3	0	0
8	52628101	.	C	G	4	2	6	0	0	6	0	0
8	52628114	.	T	C	2	2	4	0	0	4	0	0
8	52630113	.	T	C	0	2	2	0	1	3	0	0
8	52713677	.	T	G	33	42	75	0	0	75	0	0
8	52713776	.	G	A	47	22	69	0	6	75	0	0
8	52713932	.	G	A	47	32	79	0	4	83	0	0
8	52713974	.	A	G	37	27	64	0	7	71	0	0
8	52713989	.	G	A	35	30	65	0	2	67	0	0
8	52714343	.	T	G	43	29	72	0	2	74	0	0
8	52714441	.	G	T	1	2	3	0	0	3	0	0
8	52715532	.	A	T	1	2	3	0	0	3	0	0
8	52715543	.	T	C	1	2	3	0	0	3	0	0
8	52715821	.	C	T	32	22	54	0	0	54	0	0
8	52800505	.	C	T	1	2	3	0	1	4	0	0
8	52802246	.	G	C	1	3	4	0	1	5	0	0
8	52824680	.	T	C	7	2	9	0	0	9	0	0
8	53126073	.	A	G	8	3	11	0	3	14	0	0
8	53148976	.	T	C	10	5	15	0	0	15	0	0
8	53150423	.	T	C	3	2	5	0	1	6	0	0
8	53150708	.	T	C	9	2	11	0	0	11	0	0
8	53150736	.	T	C	8	3	11	0	0	11	0	0
8	53150805	.	T	C	1	2	3	1	1	5	0	0
8	53150807	.	T	C	3	2	5	1	0	6	0	0
8	53398545	.	A	G	13	5	18	0	0	18	0	0
8	53518352	.	A	G	5	2	7	0	0	7	0	0
8	54221074	.	T	C	32	13	45	1	3	49	0	0
8	54221390	.	T	C	26	11	37	0	4	41	0	0
9	83092	.	C	T	1	7	8	0	0	8	0	0
9	83785	.	T	C	6	8	14	0	0	14	0	0
9	168760	.	T	C	1	7	8	0	0	8	0	0
9	168974	.	T	C	4	2	6	0	1	7	0	0
9	266875	.	T	C	32	9	41	0	6	47	0	0
9	448756	.	G	A	3	3	6	0	0	6	0	0
9	448794	.	A	G	3	2	5	0	0	5	0	0
9	462959	.	T	G	18	3	21	0	3	24	0	0
9	527734	.	C	A	2	3	5	0	1	6	0	0
9	527777	.	T	C	2	2	4	0	0	4	0	0
9	528441	.	T	G	4	3	7	0	1	8	0	0
9	528545	.	G	A	0	2	2	0	2	4	0	0
9	528553	.	A	G	2	2	4	0	0	4	0	0
9	529012	.	G	T	3	4	7	0	0	7	0	0
9	529036	.	G	A	0	4	4	0	3	7	0	0
9	529121	.	A	C	5	2	7	0	0	7	0	0
9	529156	.	G	A	7	3	10	1	0	11	0	0
9	529675	.	A	G	2	1	3	0	1	4	0	0
9	529849	.	G	A	0	3	3	0	2	5	0	0
9	529930	.	G	A	2	4	6	0	0	6	0	0
9	585887	.	A	G	5	9	14	0	0	14	0	0
9	595354	.	G	A	5	11	16	0	0	16	0	0
9	604848	.	A	G	10	6	16	0	3	19	0	0
9	606794	.	T	A	5	4	9	0	0	9	0	0
9	607208	.	G	A	6	5	11	0	1	12	0	0
9	609001	.	A	G	4	5	9	0	0	9	0	0
9	611470	.	G	C	6	2	8	0	0	8	0	0
9	612647	.	C	G	7	3	10	0	2	12	0	0
9	701934	.	T	C	5	7	12	0	3	15	0	0
9	704662	.	T	A	2	5	7	0	0	7	0	0
9	707293	.	A	G	1	1	2	0	1	3	0	0
9	708075	.	T	C	18	2	20	0	37	57	0	0
9	712883	.	C	T	8	3	11	0	1	12	0	0
9	712898	.	T	C	12	8	20	0	0	20	0	0
9	716225	.	A	G	9	9	18	0	0	18	0	0
9	717849	.	T	C	15	13	28	0	2	30	0	0
9	719825	.	A	G	10	4	14	1	1	16	0	0
9	723428	.	T	A	12	5	17	0	2	19	0	0
9	724664	.	G	C	17	5	22	0	0	22	0	0
9	724670	.	A	C	17	4	21	0	0	21	0	0
9	732227	.	C	T	12	12	24	0	0	24	0	0
9	734643	.	T	G	11	7	18	0	0	18	0	0
9	735860	.	A	G	5	5	10	1	0	11	0	0
9	740907	.	C	T	5	3	8	0	1	9	0	0
9	746040	.	A	G	7	6	13	0	0	13	0	0
9	746071	.	T	C	10	7	17	0	1	18	0	0
9	748018	.	T	C	6	6	12	0	1	13	0	0
9	751441	.	A	G	7	6	13	0	0	13	0	0
9	784508	.	G	A	1	2	3	0	0	3	0	0
9	796093	.	G	A	2	2	4	0	0	4	0	0
9	844275	.	G	T	3	3	6	0	0	6	0	0
9	848860	.	G	A	3	2	5	0	0	5	0	0
9	848875	.	G	C	3	2	5	0	0	5	0	0
9	849013	.	T	C	2	0	2	0	3	5	0	0
9	881905	.	A	C	16	5	21	0	0	21	0	0
9	881999	.	C	T	11	5	16	0	0	16	0	0
9	887854	.	A	G	8	5	13	0	0	13	0	0
9	889433	.	G	A	13	4	17	0	0	17	0	0
9	889514	.	G	C	8	4	12	0	0	12	0	0
9	889520	.	A	T	6	4	10	0	0	10	0	0
9	900592	.	G	A	1	6	7	0	0	7	0	0
9	901137	.	A	G	9	11	20	0	1	21	0	0
9	902877	.	A	G	4	9	13	0	0	13	0	0
9	904118	.	A	T	5	9	14	0	1	15	0	0
9	907564	.	A	G	16	31	47	0	0	47	0	0
9	910882	.	C	T	25	26	51	0	3	54	0	0
9	913874	.	T	C	19	27	46	0	4	50	0	0
9	913882	.	C	T	22	30	52	0	0	52	0	0
9	913909	.	G	A	2	26	28	0	12	40	0	0
9	914190	.	C	T	8	3	11	0	0	11	0	0
9	914282	.	A	G	3	2	5	0	0	5	0	0
9	914291	.	T	C	4	2	6	0	0	6	0	0
9	914403	.	A	G	4	3	7	0	1	8	0	0
9	914410	.	A	G	8	2	10	0	0	10	0	0
9	914445	.	T	C	7	3	10	2	0	12	0	0
9	914675	.	C	T	14	2	16	1	1	18	0	0
9	914702	.	A	T	19	4	23	1	1	25	0	0
9	920664	.	A	C	3	2	5	0	0	5	0	0
9	920915	.	G	A	1	2	3	0	0	3	0	0
9	921795	.	T	C	1	2	3	0	0	3	0	0
9	921859	.	T	A	2	2	4	0	0	4	0	0
9	963731	.	C	T	5	7	12	0	0	12	0	0
9	963851	.	C	G	7	4	11	0	1	12	0	0
9	1003493	.	A	G	2	2	4	0	0	4	0	0
9	1003502	.	C	G	2	0	2	0	3	5	0	0
9	1187877	.	G	A	1	2	3	0	1	4	0	0
9	1197286	.	G	A	1	2	3	0	0	3	0	0
9	1366691	.	A	T	6	7	13	0	0	13	0	0
9	1368428	.	T	A	9	6	15	0	0	15	0	0
9	1371190	.	C	G	7	8	15	0	1	16	0	0
9	1371362	.	C	T	7	6	13	0	2	15	0	0
9	1373000	.	A	G	3	5	8	0	0	8	0	0
9	1373075	.	T	G	5	13	18	0	1	19	0	0
9	1373144	.	C	A	8	11	19	0	2	21	0	0
9	1404971	.	A	G	2	4	6	0	0	6	0	0
9	1434585	.	G	A	1	2	3	0	0	3	0	0
9	1459861	.	G	A	2	6	8	0	0	8	0	0
9	1463287	.	T	C	2	4	6	0	0	6	0	0
9	1465005	.	G	A	4	2	6	0	0	6	0	0
9	1479290	.	G	T	2	3	5	0	0	5	0	0
9	1483810	.	T	C	3	3	6	0	0	6	0	0
9	1536441	.	T	C	1	3	4	0	0	4	0	0
9	1543604	.	T	C	3	3	6	1	0	7	0	0
9	1565242	.	C	T	3	4	7	0	1	8	0	0
9	1574234	.	A	G	5	8	13	0	1	14	0	0
9	1576074	.	T	C	2	2	4	0	1	5	0	0
9	1576417	.	A	G	3	4	7	0	0	7	0	0
9	1577542	.	C	A	10	19	29	0	0	29	0	0
9	1579792	.	T	C	5	3	8	0	0	8	0	0
9	1589799	.	A	G	3	4	7	0	1	8	0	0
9	1596615	.	G	T	8	5	13	0	1	14	0	0
9	1617833	.	G	A	6	3	9	0	0	9	0	0
9	1617851	.	A	G	7	3	10	0	0	10	0	0
9	1623066	.	A	C	3	3	6	0	0	6	0	0
9	1626333	.	G	A	5	3	8	0	0	8	0	0
9	1626357	.	A	G	4	2	6	0	0	6	0	0
9	1627499	.	A	G	4	2	6	0	0	6	0	0
9	1642862	.	T	G	1	2	3	0	0	3	0	0
9	1644148	.	A	C	3	2	5	0	0	5	0	0
9	1644349	.	T	C	6	3	9	0	0	9	0	0
9	1673601	.	C	T	5	6	11	0	2	13	0	0
9	1679360	.	A	C	1	3	4	0	0	4	0	0
9	1679969	.	C	A	2	3	5	0	1	6	0	0
9	1680126	.	A	C	5	2	7	0	0	7	0	0
9	1680636	.	A	G	4	7	11	0	0	11	0	0
9	1680660	.	T	A	5	6	11	0	1	12	0	0
9	1680700	.	T	A	7	3	10	0	0	10	0	0
9	1680809	.	A	C	5	2	7	0	1	8	0	0
9	1682489	.	G	A	2	2	4	1	0	5	0	0
9	1682647	.	A	T	4	4	8	0	0	8	0	0
9	1682740	.	G	C	1	6	7	0	8	15	0	0
9	1693082	.	A	C	7	6	13	0	1	14	0	0
9	1693092	.	G	A	10	7	17	0	0	17	0	0
9	1693443	.	G	A	8	10	18	0	0	18	0	0
9	1693494	.	T	G	15	4	19	0	0	19	0	0
9	1693585	.	C	T	0	2	2	1	12	15	0	0
9	1694277	.	A	G	14	4	18	0	1	19	0	0
9	1937440	.	A	T	2	5	7	0	0	7	0	0
9	1938788	.	A	G	5	4	9	0	0	9	0	0
9	1948722	.	G	A	1	3	4	0	0	4	0	0
9	1948976	.	G	A	1	3	4	0	0	4	0	0
9	1950476	.	C	T	2	2	4	0	0	4	0	0
9	1950477	.	T	A	0	2	2	0	2	4	0	0
9	2003431	.	C	A	3	3	6	0	0	6	0	0
9	2045125	.	T	G	4	4	8	0	0	8	0	0
9	2334127	.	T	A	2	2	4	0	0	4	0	0
9	2334164	.	C	T	19	19	38	2	2	42	0	0
9	2336682	.	A	G	27	0	27	0	28	55	0	0
9	2337291	.	C	T	27	24	51	0	5	56	0	0
9	2340561	.	G	A	29	25	54	1	4	59	0	0
9	2340564	.	G	A	29	25	54	1	3	58	0	0
9	2340618	.	C	T	30	27	57	0	3	60	0	0
9	2340776	.	C	T	30	39	69	0	3	72	0	0
9	2341035	.	T	C	12	16	28	0	1	29	0	0
9	2341053	.	T	C	8	14	22	0	0	22	0	0
9	2351723	.	G	C	7	3	10	0	1	11	0	0
9	2351795	.	C	G	6	5	11	0	1	12	0	0
9	2365092	.	T	C	2	6	8	0	0	8	0	0
9	2365125	.	T	C	4	7	11	0	0	11	0	0
9	2404624	.	A	C	11	5	16	0	0	16	0	0
9	2421012	.	T	A	4	8	12	0	0	12	0	0
9	2423047	.	C	T	7	6	13	0	1	14	0	0
9	2423092	.	C	A	8	10	18	0	0	18	0	0
9	2423119	.	C	T	11	10	21	0	0	21	0	0
9	2452697	.	T	C	14	21	35	0	3	38	0	0
9	2510519	.	T	C	4	2	6	0	0	6	0	0
9	2510549	.	C	T	1	3	4	0	0	4	0	0
9	2533027	.	A	C	1	2	3	0	0	3	0	0
9	2538987	.	C	T	1	2	3	0	0	3	0	0
9	2555239	.	C	T	2	5	7	0	2	9	0	0
9	2555535	.	A	T	1	3	4	0	1	5	0	0
9	2556068	.	A	T	3	2	5	0	0	5	0	0
9	2556339	.	T	C	3	2	5	0	1	6	0	0
9	2556415	.	T	A	5	2	7	0	1	8	0	0
9	2556516	.	A	T	4	3	7	0	0	7	0	0
9	2556849	.	G	A	0	1	1	0	3	4	0	0
9	2558355	.	G	T	1	2	3	0	0	3	0	0
9	2558649	.	G	A	4	8	12	0	0	12	0	0
9	2559047	.	G	A	1	2	3	0	0	3	0	0
9	2559177	.	C	T	2	2	4	0	0	4	0	0
9	2559204	.	C	T	4	6	10	0	0	10	0	0
9	2559792	.	G	A	1	4	5	0	0	5	0	0
9	2559856	.	A	C	2	6	8	0	0	8	0	0
9	2559875	.	T	C	7	3	10	0	0	10	0	0
9	2559912	.	A	C	1	7	8	0	2	10	0	0
9	2560765	.	C	T	1	6	7	0	0	7	0	0
9	2561182	.	A	G	2	5	7	0	0	7	0	0
9	2561205	.	G	T	5	6	11	0	0	11	0	0
9	2561225	.	T	A	3	4	7	0	0	7	0	0
9	2561604	.	C	T	21	7	28	0	2	30	0	0
9	2561632	.	A	T	19	11	30	0	0	30	0	0
9	2564178	.	C	A	24	11	35	0	1	36	0	0
9	2564699	.	A	G	18	6	24	0	1	25	0	0
9	2564788	.	A	T	14	13	27	0	1	28	0	0
9	2567323	.	G	A	24	15	39	0	0	39	0	0
9	2568670	.	T	A	19	14	33	0	1	34	0	0
9	2568768	.	G	T	24	13	37	0	1	38	0	0
9	2568777	.	C	T	15	23	38	0	1	39	0	0
9	2569372	.	T	G	8	18	26	0	0	26	0	0
9	2572316	.	G	A	17	6	23	0	2	25	0	0
9	2574159	.	T	C	2	6	8	0	1	9	0	0
9	2574225	.	T	C	8	14	22	0	0	22	0	0
9	2574227	.	A	G	8	14	22	0	0	22	0	0
9	2576099	.	T	C	14	8	22	0	0	22	0	0
9	2579867	.	C	T	11	12	23	0	0	23	0	0
9	2582003	.	G	A	6	14	20	0	0	20	0	0
9	2592246	.	C	T	13	9	22	0	1	23	0	0
9	2592933	.	T	C	14	11	25	0	0	25	0	0
9	2592984	.	C	A	1	13	14	0	12	26	0	0
9	2767719	.	G	T	1	3	4	0	0	4	0	0
9	2768083	.	G	T	3	2	5	0	0	5	0	0
9	2770832	.	T	C	3	3	6	0	0	6	0	0
9	2776703	.	T	C	1	5	6	0	0	6	0	0
9	2908811	.	A	G	2	2	4	0	0	4	0	0
9	2909623	.	G	A	1	2	3	0	0	3	0	0
9	2949273	.	G	A	5	3	8	0	0	8	0	0
9	2949344	.	T	C	6	2	8	0	1	9	0	0
9	2949374	.	T	A	6	2	8	0	1	9	0	0
9	2949522	.	G	A	2	2	4	0	0	4	0	0
9	2949640	.	T	C	2	6	8	0	0	8	0	0
9	2953489	.	G	T	2	4	6	0	0	6	0	0
9	2964172	.	C	T	0	2	2	1	1	4	0	0
9	2966006	.	C	T	0	3	3	0	3	6	0	0
9	2966295	.	A	T	1	2	3	0	0	3	0	0
9	3056194	.	C	T	1	2	3	0	1	4	0	0
9	3106194	.	T	C	1	2	3	0	0	3	0	0
9	3106198	.	C	T	1	2	3	0	0	3	0	0
9	3135171	.	T	C	11	0	11	0	20	31	0	0
9	3135794	.	A	G	12	15	27	0	2	29	0	0
9	3135809	.	A	G	14	12	26	0	1	27	0	0
9	3136107	.	C	T	1	12	13	0	9	22	0	0
9	3149541	.	T	C	13	12	25	0	1	26	0	0
9	3149661	.	C	T	9	7	16	0	2	18	0	0
9	3170116	.	G	A	5	2	7	0	1	8	0	0
9	3228214	.	C	T	4	2	6	0	0	6	0	0
9	3231378	.	C	A	0	18	18	0	0	18	0	0
9	3231396	.	C	G	4	14	18	0	2	20	0	0
9	3231675	.	C	T	1	4	5	0	0	5	0	0
9	3231778	.	G	T	0	9	9	0	3	12	0	0
9	3231795	.	T	C	5	6	11	0	1	12	0	0
9	3231832	.	A	T	2	5	7	0	0	7	0	0
9	3231978	.	C	A	5	4	9	0	0	9	0	0
9	3232180	.	T	A	3	4	7	0	0	7	0	0
9	3232198	.	C	T	5	5	10	0	0	10	0	0
9	3232523	.	T	G	11	4	15	0	0	15	0	0
9	3232607	.	T	A	7	4	11	0	1	12	0	0
9	3232672	.	C	T	6	2	8	0	0	8	0	0
9	3232949	.	A	G	2	2	4	0	0	4	0	0
9	3284007	.	G	C	1	9	10	0	6	16	0	0
9	3286386	.	G	A	5	10	15	0	0	15	0	0
9	3313920	.	G	T	11	11	22	0	0	22	0	0
9	3388974	.	C	T	14	4	18	0	0	18	0	0
9	3389545	.	G	A	12	5	17	0	1	18	0	0
9	3389921	.	A	G	18	1	19	0	19	38	0	0
9	3390035	.	G	A	17	16	33	0	0	33	0	0
9	3397648	.	A	C	5	5	10	0	1	11	0	0
9	3398243	.	T	A	8	7	15	0	1	16	0	0
9	3398247	.	G	A	10	7	17	0	0	17	0	0
9	3398328	.	C	A	0	15	15	0	17	32	0	0
9	3398354	.	T	C	14	0	14	0	15	29	0	0
9	3400331	.	A	G	6	10	16	0	0	16	0	0
9	3400361	.	G	A	9	7	16	0	0	16	0	0
9	3429791	.	C	G	1	0	1	0	4	5	0	0
9	3448768	.	T	C	2	3	5	0	1	6	0	0
9	3448810	.	G	C	4	2	6	0	0	7	1	0
9	3455742	.	G	A	5	4	9	0	0	9	0	0
9	3456590	.	C	T	4	4	8	0	0	8	0	0
9	3457410	.	G	A	1	4	5	0	1	6	0	0
9	3463198	.	T	C	0	4	4	1	1	6	0	0
9	3463212	.	G	A	0	4	4	0	2	6	0	0
9	3463247	.	C	A	2	5	7	0	0	7	0	0
9	3464229	.	G	T	1	4	5	0	1	6	0	0
9	3464254	.	A	G	2	0	2	0	7	9	0	0
9	3465279	.	G	A	5	9	14	0	1	15	0	0
9	3465285	.	T	C	3	11	14	0	0	14	0	0
9	3471076	.	C	T	5	5	10	0	1	11	0	0
9	3471077	.	A	G	5	6	11	0	0	11	0	0
9	3473361	.	T	A	3	7	10	0	0	10	0	0
9	3474856	.	T	C	2	8	10	0	0	10	0	0
9	3477113	.	T	G	4	12	16	0	0	16	0	0
9	3480057	.	A	G	8	8	16	0	0	16	0	0
9	3480076	.	C	T	7	5	12	0	1	13	0	0
9	3483164	.	T	C	9	6	15	0	0	15	0	0
9	3485822	.	G	A	0	7	7	0	3	10	0	0
9	3485867	.	A	T	2	5	7	0	0	7	0	0
9	3485868	.	T	C	2	4	6	0	1	7	0	0
9	3486134	.	T	G	2	6	8	0	0	8	0	0
9	3486220	.	C	T	4	2	6	0	0	6	0	0
9	3486223	.	C	T	4	1	5	0	0	5	0	0
9	3491044	.	A	G	1	2	3	0	0	3	0	0
9	3505885	.	T	A	1	2	3	0	0	3	0	0
9	3508669	.	G	A	2	3	5	0	0	5	0	0
9	3509076	.	A	G	3	4	7	0	0	7	0	0
9	3509096	.	T	C	3	2	5	0	0	5	0	0
9	3514447	.	A	G	1	3	4	0	0	4	0	0
9	3517399	.	C	G	1	2	3	0	0	3	0	0
9	3517407	.	C	T	0	2	2	0	2	4	0	0
9	3524316	.	C	T	4	3	7	0	0	7	0	0
9	3532562	.	C	A	1	3	4	0	1	5	0	0
9	3534748	.	G	A	1	6	7	0	0	7	0	0
9	3569470	.	C	A	3	11	14	0	1	15	0	0
9	3605652	.	C	T	9	9	18	0	1	19	0	0
9	3605682	.	A	G	13	0	13	0	12	25	0	0
9	3608867	.	T	A	11	17	28	0	0	28	0	0
9	3621980	.	T	C	9	15	24	0	0	24	0	0
9	3627189	.	T	C	12	10	22	0	0	22	0	0
9	3630017	.	T	C	17	0	17	0	13	30	0	0
9	3635791	.	G	A	11	12	23	0	0	23	0	0
9	3646864	.	A	G	9	11	20	0	2	22	0	0
9	3653187	.	G	C	12	13	25	0	0	25	0	0
9	3666458	.	G	A	4	3	7	0	0	7	0	0
9	3666469	.	C	T	6	2	8	0	1	9	0	0
9	3666494	.	C	T	8	6	14	0	0	14	0	0
9	3666511	.	A	G	8	8	16	0	1	17	0	0
9	3666541	.	A	C	4	7	11	0	0	11	0	0
9	3666601	.	A	T	6	5	11	0	1	12	0	0
9	3666666	.	T	C	7	9	16	0	0	16	0	0
9	3666947	.	G	A	2	5	7	0	0	7	0	0
9	3666948	.	T	C	1	0	1	0	6	7	0	0
9	3667136	.	G	A	7	8	15	0	1	16	0	0
9	3667338	.	T	A	10	7	17	0	0	17	0	0
9	3667377	.	C	A	11	3	14	0	0	14	0	0
9	3667398	.	C	A	10	3	13	0	0	13	0	0
9	3667459	.	C	T	6	5	11	0	0	11	0	0
9	3667496	.	C	T	7	2	9	0	0	9	0	0
9	3667497	.	T	G	6	2	8	0	0	8	0	0
9	3797218	.	A	G	1	2	3	0	0	3	0	0
9	3815351	.	G	C	3	3	6	0	0	6	0	0
9	3864716	.	G	A	1	2	3	0	0	3	0	0
9	3898275	.	T	C	3	4	7	0	0	7	0	0
9	3898276	.	T	C	3	0	3	0	4	7	0	0
9	3901007	.	A	T	4	4	8	0	0	8	0	0
9	3901081	.	C	T	9	5	14	0	0	14	0	0
9	3901118	.	A	C	7	5	12	0	1	13	0	0
9	3901187	.	T	A	5	5	10	0	0	10	0	0
9	3907834	.	C	G	5	9	14	0	0	14	0	0
9	3912739	.	G	A	6	6	12	0	0	12	0	0
9	3928332	.	C	A	7	7	14	0	0	14	0	0
9	3932238	.	T	G	5	4	9	0	1	10	0	0
9	4000799	.	G	A	5	3	8	0	0	8	0	0
9	4254304	.	T	C	8	8	16	1	0	17	0	0
9	4266699	.	C	T	5	4	9	0	0	9	0	0
9	4266744	.	G	A	9	4	13	0	0	13	0	0
9	4266854	.	C	G	8	8	16	0	2	18	0	0
9	4267062	.	T	C	11	6	17	0	0	17	0	0
9	4267072	.	T	C	9	5	14	0	0	14	0	0
9	4267101	.	C	G	4	7	11	0	0	11	0	0
9	4272316	.	T	C	9	7	16	0	0	16	0	0
9	4277014	.	G	A	0	2	2	0	8	10	0	0
9	4277125	.	C	T	3	7	10	0	2	12	0	0
9	4282581	.	G	A	0	10	10	0	2	12	0	0
9	4310069	.	C	T	11	6	17	0	0	17	0	0
9	4310096	.	G	A	10	6	16	0	0	16	0	0
9	4323147	.	C	T	10	7	17	0	2	19	0	0
9	4323249	.	C	T	5	9	14	0	2	16	0	0
9	4332223	.	C	T	14	17	31	0	0	31	0	0
9	4333299	.	C	T	13	14	27	0	1	28	0	0
9	4336543	.	A	G	11	15	26	0	0	26	0	0
9	4336585	.	T	C	17	11	28	0	0	28	0	0
9	4344553	.	C	T	15	9	24	0	0	24	0	0
9	4506242	.	T	C	3	3	6	0	0	6	0	0
9	4721500	.	G	T	4	4	8	1	1	10	0	0
9	5042784	.	A	G	3	4	7	0	0	7	0	0
9	5044370	.	G	T	5	5	10	0	0	10	0	0
9	5045284	.	C	G	0	4	4	0	6	10	0	0
9	5345770	.	G	A	3	4	7	0	0	7	0	0
9	5345827	.	C	T	0	4	4	0	2	6	0	0
9	5346115	.	T	G	5	2	7	0	1	8	0	0
9	5346148	.	A	G	6	5	11	0	0	11	0	0
9	5350909	.	G	T	5	2	7	0	0	7	0	0
9	5904817	.	G	A	5	5	10	0	0	10	0	0
9	5904957	.	G	A	3	3	6	0	1	7	0	0
9	5908920	.	T	A	4	5	9	0	0	9	0	0
9	6009282	.	C	T	19	19	38	0	3	41	0	0
9	6083012	.	G	A	2	7	9	0	27	36	0	0
9	6083026	.	C	T	19	10	29	0	2	31	0	0
9	6083113	.	C	T	15	14	29	0	0	29	0	0
9	6083169	.	C	T	15	10	25	0	0	25	0	0
9	6083262	.	G	C	2	8	10	0	0	10	0	0
9	6083401	.	G	A	22	17	39	0	1	40	0	0
9	6109544	.	A	G	8	17	25	0	2	27	0	0
9	6118842	.	G	A	2	3	5	0	0	5	0	0
9	6123441	.	G	A	19	16	35	1	1	37	0	0
9	6123490	.	G	T	16	17	33	0	0	33	0	0
9	6123742	.	A	C	11	21	32	0	0	32	0	0
9	6123857	.	C	T	8	11	19	0	1	20	0	0
9	6124057	.	G	A	1	12	13	0	9	22	0	0
9	6124100	.	T	C	8	13	21	0	1	22	0	0
9	6124201	.	G	A	1	8	9	0	7	16	0	0
9	6124393	.	C	T	6	4	10	0	0	10	0	0
9	6124478	.	G	A	15	8	23	0	2	25	0	0
9	6124759	.	T	A	21	11	32	0	0	32	0	0
9	6124761	.	T	G	12	19	31	0	0	31	0	0
9	6124884	.	T	C	5	9	14	0	2	16	0	0
9	6125346	.	T	A	2	5	7	0	2	9	0	0
9	6125427	.	G	C	6	7	13	0	0	13	0	0
9	6125501	.	A	C	4	6	10	0	1	11	0	0
9	6125588	.	A	C	1	4	5	0	0	5	0	0
9	6125707	.	T	C	3	9	12	1	1	14	0	0
9	6125732	.	C	T	8	2	10	0	1	11	0	0
9	6125859	.	T	A	8	13	21	0	1	22	0	0
9	6126074	.	T	A	12	13	25	0	0	25	0	0
9	6126288	.	A	C	20	10	30	0	1	31	0	0
9	6126410	.	G	A	17	18	35	1	0	36	0	0
9	6126469	.	G	A	21	18	39	0	0	39	0	0
9	6126781	.	T	G	17	13	30	0	0	30	0	0
9	6126900	.	C	T	7	10	17	0	1	18	0	0
9	6126911	.	C	A	8	5	13	0	1	14	0	0
9	6127075	.	G	A	1	23	24	0	26	50	0	0
9	6127346	.	C	A	13	7	20	0	2	22	0	0
9	6127357	.	C	T	9	12	21	0	1	22	0	0
9	6256165	.	C	T	10	3	13	0	1	14	0	0
9	6256184	.	C	T	11	4	15	0	0	15	0	0
9	6256349	.	A	T	7	4	11	0	1	12	0	0
9	6256541	.	G	A	2	9	11	0	8	19	0	0
9	6362976	.	G	A	14	9	23	0	1	24	0	0
9	6395679	.	C	G	10	10	20	0	1	21	0	0
9	6395713	.	G	A	12	10	22	0	0	22	0	0
9	6395792	.	T	A	13	5	18	0	0	18	0	0
9	6395859	.	G	A	8	7	15	0	0	15	0	0
9	6395998	.	T	C	4	0	4	0	10	14	0	0
9	6396003	.	C	T	4	9	13	0	0	13	0	0
9	6396181	.	G	A	4	12	16	0	1	17	0	0
9	6396235	.	A	G	10	7	17	0	0	17	0	0
9	6396242	.	G	A	11	6	17	0	0	17	0	0
9	6396477	.	A	G	9	7	16	1	0	17	0	0
9	6399592	.	C	T	1	6	7	0	9	16	0	0
9	6399610	.	A	G	6	11	17	0	0	17	0	0
9	6399721	.	T	C	13	0	13	0	10	23	0	0
9	6399762	.	C	T	8	7	15	0	0	15	0	0
9	6399784	.	A	G	5	7	12	0	0	12	0	0
9	6399949	.	A	G	1	7	8	0	0	8	0	0
9	6400191	.	G	A	4	7	11	0	0	11	0	0
9	6400240	.	C	T	2	7	9	0	4	13	0	0
9	6400251	.	G	A	6	6	12	0	0	12	0	0
9	6415385	.	G	A	11	8	19	0	1	20	0	0
9	7092424	.	T	C	8	6	14	0	0	14	0	0
9	7094141	.	T	C	12	5	17	0	0	17	0	0
9	7094898	.	T	C	17	11	28	0	0	28	0	0
9	9561906	.	C	T	0	2	2	0	0	2	0	0
9	9561911	.	G	A	0	1	1	0	0	1	0	0
9	9736493	.	T	C	6	10	16	0	1	17	0	0
9	10239383	.	T	A	1	8	9	0	0	9	0	0
9	14041192	.	A	T	4	2	6	0	0	6	0	0
9	16867489	.	C	T	2	3	5	0	0	5	0	0
9	16867495	.	G	C	3	3	6	0	0	6	0	0
9	16867634	.	C	T	8	3	11	1	0	12	0	0
9	16867646	.	G	A	6	2	8	1	2	11	0	0
9	16867806	.	A	G	15	10	25	0	0	25	0	0
9	16867909	.	A	G	11	15	26	0	0	26	0	0
9	16868233	.	A	G	19	13	32	0	0	32	0	0
9	16868242	.	G	A	17	14	31	0	0	31	0	0
9	16868326	.	T	C	11	0	11	0	22	33	0	0
9	16872592	.	G	A	11	8	19	0	1	20	0	0
9	16872764	.	T	C	19	10	29	0	1	30	0	0
9	16872767	.	T	C	20	10	30	0	1	31	0	0
9	16877287	.	C	T	12	6	18	0	0	18	0	0
9	16877408	.	G	A	20	12	32	0	0	32	0	0
9	17046020	.	T	C	21	16	37	0	0	37	0	0
9	17046736	.	A	G	21	14	35	0	3	38	0	0
9	17047014	.	A	G	18	14	32	2	0	34	0	0
9	17057365	.	T	C	18	16	34	0	3	37	0	0
9	17060311	.	G	A	19	14	33	0	0	33	0	0
9	17067934	.	C	T	27	17	44	0	0	44	0	0
9	17068057	.	T	G	21	18	39	0	1	40	0	0
9	17073498	.	T	C	21	16	37	0	5	42	0	0
9	17074714	.	T	C	21	13	34	0	0	34	0	0
9	17074720	.	T	C	19	14	33	0	0	33	0	0
9	17074792	.	G	A	23	14	37	0	0	37	0	0
9	17077376	.	A	G	15	15	30	0	0	30	0	0
9	17077430	.	C	T	2	18	20	0	13	33	0	0
9	17077439	.	A	G	16	19	35	0	2	37	0	0
9	17080224	.	G	T	18	17	35	0	3	38	0	0
9	17080517	.	G	A	22	17	39	0	1	40	0	0
9	17080970	.	A	G	11	11	22	0	0	22	0	0
9	17082273	.	A	T	15	19	34	0	1	35	0	0
9	17082926	.	G	T	14	13	27	0	0	27	0	0
9	17083053	.	G	A	13	15	28	0	0	28	0	0
9	17083221	.	T	C	9	15	24	0	2	26	0	0
9	17083278	.	G	A	15	16	31	0	1	32	0	0
9	17083296	.	T	A	15	15	30	0	0	30	0	0
9	17083434	.	C	T	17	12	29	0	1	30	0	0
9	17083581	.	G	T	15	13	28	0	0	28	0	0
9	17083908	.	T	C	7	1	8	0	15	23	0	0
9	17083989	.	G	A	12	10	22	0	0	22	0	0
9	17084127	.	T	C	13	0	13	0	14	27	0	0
9	17084229	.	T	C	16	0	16	0	13	29	0	0
9	17084253	.	G	A	16	9	25	0	0	25	0	0
9	17094362	.	A	T	13	11	24	0	1	25	0	0
9	17119143	.	G	A	5	11	16	0	0	16	0	0
9	17119789	.	G	A	12	11	23	0	1	24	0	0
9	17119982	.	A	G	17	5	22	0	1	23	0	0
9	17127011	.	G	T	11	9	20	0	0	20	0	0
9	17127025	.	C	T	10	10	20	0	2	22	0	0
9	17129876	.	A	G	13	6	19	0	0	19	0	0
9	17130282	.	G	A	12	11	23	0	1	24	0	0
9	17139140	.	A	C	11	8	19	0	0	19	0	0
9	17139350	.	A	T	13	6	19	0	1	20	0	0
9	17139378	.	T	C	9	0	9	0	7	16	0	0
9	17145472	.	T	C	6	10	16	0	1	17	0	0
9	17145508	.	T	C	5	6	11	0	1	12	0	0
9	17148204	.	G	A	6	4	10	0	0	10	0	0
9	17167397	.	A	T	8	8	16	0	0	16	0	0
9	17169430	.	A	C	9	3	12	0	1	13	0	0
9	17169681	.	G	A	10	5	15	0	0	15	0	0
9	17169741	.	G	C	7	7	14	0	0	14	0	0
9	17182513	.	C	T	8	8	16	0	0	16	0	0
9	17193186	.	A	G	9	7	16	0	0	16	0	0
9	17193434	.	G	T	5	11	16	0	2	18	0	0
9	17193462	.	G	A	5	7	12	0	2	14	0	0
9	17217519	.	G	A	8	6	14	0	3	17	0	0
9	17219850	.	A	G	8	7	15	0	2	17	0	0
9	17221785	.	A	G	9	3	12	0	1	13	0	0
9	17221884	.	T	C	5	4	9	0	0	9	0	0
9	17221974	.	T	C	4	4	8	0	0	8	0	0
9	17248228	.	A	G	4	4	8	0	1	9	0	0
9	17248464	.	G	T	6	6	12	0	0	12	0	0
9	17349073	.	T	C	9	7	16	0	0	16	0	0
9	17349103	.	G	T	2	8	10	0	6	16	0	0
9	17349125	.	G	A	1	7	8	0	8	16	0	0
9	17349272	.	C	T	5	10	15	0	0	15	0	0
9	17364337	.	C	G	11	7	18	0	1	19	0	0
9	17365117	.	C	T	7	3	10	0	1	11	0	0
9	17365231	.	G	A	8	10	18	0	0	18	0	0
9	17368889	.	A	C	15	12	27	0	1	28	0	0
9	17368904	.	C	T	13	12	25	0	0	25	0	0
9	17369071	.	G	A	15	10	25	0	3	28	0	0
9	17378203	.	A	G	13	18	31	0	0	31	0	0
9	17379954	.	C	T	15	9	24	0	0	24	0	0
9	17386152	.	C	A	7	7	14	0	1	15	0	0
9	17386154	.	C	T	7	8	15	0	0	15	0	0
9	17386338	.	A	G	5	0	5	0	2	7	0	0
9	17386341	.	G	T	5	2	7	0	0	7	0	0
9	17424198	.	T	C	4	3	7	0	0	7	0	0
9	17424639	.	T	G	2	2	4	0	0	4	0	0
9	17425308	.	T	C	2	4	6	0	0	6	0	0
9	17431469	.	A	G	3	0	3	0	5	8	0	0
9	17431499	.	T	C	3	9	12	0	0	12	0	0
9	17431798	.	A	G	5	8	13	0	0	13	0	0
9	17431818	.	C	T	6	6	12	0	1	13	0	0
9	17431925	.	A	T	2	3	5	0	1	6	0	0
9	17431938	.	A	G	2	3	5	0	0	5	0	0
9	17432023	.	T	C	1	2	3	0	0	3	0	0
9	17432068	.	A	C	3	3	6	0	0	6	0	0
9	17432155	.	C	T	3	2	5	0	0	5	0	0
9	17432170	.	T	C	2	3	5	0	0	5	0	0
9	17432297	.	G	T	3	4	7	0	1	8	0	0
9	17432484	.	C	A	1	4	5	0	1	6	0	0
9	17432681	.	G	T	1	3	4	0	0	4	0	0
9	17432962	.	A	C	6	2	8	0	0	8	0	0
9	17433483	.	A	G	3	0	3	0	0	6	3	0
9	17433983	.	T	G	2	3	5	0	0	5	0	0
9	17445217	.	A	G	5	9	14	0	0	14	0	0
9	17445268	.	T	C	13	12	25	0	0	25	0	0
9	17548502	.	T	C	7	7	14	1	0	15	0	0
9	17560343	.	A	G	4	8	12	0	0	12	0	0
9	17563067	.	C	T	2	7	9	0	0	9	0	0
9	17583192	.	G	A	4	6	10	0	0	10	0	0
9	17641518	.	C	T	3	3	6	0	1	7	0	0
9	17646993	.	G	T	3	2	5	0	1	6	0	0
9	17647072	.	C	A	8	4	12	0	1	13	0	0
9	17659262	.	C	A	2	3	5	0	1	6	0	0
9	17668432	.	T	C	4	1	5	0	2	7	0	0
9	17668443	.	T	C	4	2	6	0	2	8	0	0
9	17669180	.	T	A	2	4	6	0	2	8	0	0
9	17669184	.	C	T	1	4	5	0	2	7	0	0
9	17728684	.	C	G	0	5	5	0	3	8	0	0
9	17745246	.	T	C	5	3	8	0	1	9	0	0
9	17745261	.	T	C	5	4	9	0	0	9	0	0
9	17747795	.	T	C	3	0	3	0	7	10	0	0
9	17757490	.	G	A	2	4	6	0	0	6	0	0
9	17766253	.	C	T	4	5	9	0	0	9	0	0
9	17766300	.	C	T	1	3	4	0	1	5	0	0
9	17770836	.	C	T	2	2	4	0	0	4	0	0
9	17770972	.	A	G	2	4	6	0	1	7	0	0
9	17772268	.	C	T	1	2	3	0	0	3	0	0
9	17772295	.	A	G	1	2	3	0	0	3	0	0
9	17783482	.	A	G	5	4	9	0	0	9	0	0
9	17830270	.	T	G	5	10	15	0	0	15	0	0
9	17899179	.	G	A	2	9	11	0	14	25	0	0
9	17907587	.	A	T	10	11	21	0	1	22	0	0
9	17907768	.	G	A	9	11	20	0	0	20	0	0
9	17908898	.	A	G	11	8	19	0	1	20	0	0
9	17908958	.	A	C	17	15	32	0	1	33	0	0
9	17912372	.	C	G	12	12	24	0	1	25	0	0
9	17918428	.	A	G	12	16	28	0	0	28	0	0
9	17918485	.	A	G	8	13	21	0	0	21	0	0
9	17918681	.	G	A	8	12	20	0	0	20	0	0
9	17922172	.	T	A	14	16	30	0	0	30	0	0
9	17922191	.	G	C	17	10	27	0	0	27	0	0
9	17934202	.	T	G	13	10	23	0	1	24	0	0
9	17979350	.	A	C	8	23	31	0	1	32	0	0
9	17979389	.	G	A	6	15	21	0	0	21	0	0
9	17979603	.	T	A	3	8	11	1	0	12	0	0
9	17984914	.	G	T	11	13	24	0	0	24	0	0
9	17987998	.	A	G	15	22	37	0	0	37	0	0
9	17988011	.	C	A	14	17	31	0	1	32	0	0
9	17988072	.	A	C	13	15	28	0	1	29	0	0
9	17988091	.	A	G	10	16	26	0	0	26	0	0
9	18001161	.	T	G	19	29	48	0	1	49	0	0
9	18001200	.	A	C	25	20	45	0	1	46	0	0
9	18003664	.	T	C	22	23	45	0	0	45	0	0
9	18003684	.	C	G	14	26	40	0	0	40	0	0
9	18003807	.	C	T	19	25	44	0	3	47	0	0
9	18003856	.	T	G	23	0	23	0	20	43	0	0
9	18004476	.	A	C	15	25	40	0	3	43	0	0
9	18005023	.	C	T	19	17	36	0	3	39	0	0
9	18005065	.	C	T	19	22	41	0	1	42	0	0
9	18005217	.	A	T	5	14	19	0	1	20	0	0
9	18005245	.	T	C	7	13	20	0	0	20	0	0
9	18005507	.	C	T	10	11	21	0	1	22	0	0
9	18005806	.	A	G	18	8	26	0	1	27	0	0
9	18005864	.	G	A	15	20	35	0	0	35	0	0
9	18005879	.	T	A	17	17	34	0	3	37	0	0
9	18005977	.	T	C	16	18	34	0	0	34	0	0
9	18006144	.	T	A	24	15	39	0	2	41	0	0
9	18006282	.	C	T	23	30	53	0	3	56	0	0
9	18229592	.	A	G	15	0	15	0	11	26	0	0
9	18235383	.	A	G	12	16	28	0	0	28	0	0
9	18278463	.	A	G	1	2	3	0	0	3	0	0
9	18310309	.	G	A	6	9	15	0	1	16	0	0
9	18320009	.	G	A	8	5	13	0	0	13	0	0
9	18333107	.	A	G	11	8	19	0	1	21	1	0
9	18390631	.	T	C	7	9	16	0	0	16	0	0
9	18392777	.	T	G	9	4	13	0	0	13	0	0
9	18392903	.	C	A	9	3	12	0	0	12	0	0
9	18392924	.	G	A	8	3	11	0	0	11	0	0
9	18568860	.	C	T	1	7	8	0	13	21	0	0
9	18721152	.	A	G	6	11	17	0	0	17	0	0
9	18732543	.	T	A	9	7	16	0	0	16	0	0
9	18732878	.	C	T	3	24	27	0	20	47	0	0
9	18732899	.	G	A	19	27	46	0	1	47	0	0
9	18733592	.	T	C	41	6	47	0	38	85	0	0
9	18735081	.	A	G	29	26	55	0	2	57	0	0
9	18812765	.	A	G	17	11	28	0	0	28	0	0
9	18812960	.	A	G	12	13	25	0	3	28	0	0
9	18813462	.	G	A	12	15	27	0	0	27	0	0
9	18813467	.	A	G	11	14	25	0	1	26	0	0
9	18813624	.	G	A	14	10	24	0	0	24	0	0
9	18813650	.	T	C	10	8	18	0	0	18	0	0
9	18813755	.	T	C	4	9	13	0	1	14	0	0
9	18814056	.	C	T	5	6	11	0	0	11	0	0
9	18814328	.	A	G	7	8	15	0	0	15	0	0
9	18814379	.	A	G	8	9	17	0	0	17	0	0
9	18814598	.	T	C	9	14	23	0	1	24	0	0
9	18876332	.	A	T	19	9	28	0	0	28	0	0
9	18876545	.	G	T	16	15	31	0	0	31	0	0
9	18876937	.	C	G	2	14	16	0	22	38	0	0
9	18877051	.	G	A	18	17	35	0	1	36	0	0
9	18877078	.	G	A	16	15	31	0	1	32	0	0
9	18877485	.	T	C	17	0	17	0	20	37	0	0
9	18909235	.	A	T	2	3	5	0	0	5	0	0
9	18909242	.	A	T	2	3	5	0	0	5	0	0
9	18909748	.	A	C	4	3	7	0	0	7	0	0
9	18911575	.	G	A	2	6	8	0	0	8	0	0
9	18911593	.	A	C	1	2	3	0	0	3	0	0
9	19027536	.	T	A	2	3	5	0	0	5	0	0
9	19027560	.	G	C	3	2	5	0	0	5	0	0
9	19027748	.	T	C	6	5	11	0	0	11	0	0
9	19074628	.	T	C	2	6	8	0	0	8	0	0
9	19074642	.	G	T	3	5	8	0	0	8	0	0
9	19074800	.	A	G	2	2	4	0	0	4	0	0
9	19080384	.	G	A	3	2	5	0	0	5	0	0
9	19086473	.	C	T	2	2	4	0	0	4	0	0
9	19090497	.	G	T	1	2	3	0	0	3	0	0
9	19109043	.	C	T	4	3	7	0	0	7	0	0
9	19118853	.	T	C	3	6	9	0	0	9	0	0
9	19118903	.	T	G	3	0	3	0	8	11	0	0
9	19118929	.	G	A	4	5	9	0	0	9	0	0
9	19118990	.	G	A	1	5	6	0	0	6	0	0
9	19119000	.	G	A	1	6	7	0	0	7	0	0
9	19119214	.	A	G	1	5	6	0	0	6	0	0
9	19119285	.	T	C	1	6	7	0	0	7	0	0
9	19299531	.	G	T	0	4	4	0	3	7	0	0
9	19307064	.	C	T	1	3	4	0	0	4	0	0
9	19364025	.	G	A	1	3	4	0	0	4	0	0
9	19366353	.	A	T	1	3	4	0	0	4	0	0
9	19368167	.	A	C	4	4	8	0	1	9	0	0
9	19368168	.	A	C	4	4	8	0	1	9	0	0
9	19368235	.	T	C	3	3	6	0	0	6	0	0
9	19368270	.	A	T	3	2	5	0	0	5	0	0
9	19368286	.	A	G	3	0	3	0	2	5	0	0
9	19378884	.	T	C	2	4	6	0	0	6	0	0
9	19393557	.	T	C	2	2	4	0	0	4	0	0
9	19393566	.	T	G	2	3	5	0	0	5	0	0
9	19394111	.	A	G	4	3	7	0	0	7	0	0
9	19405989	.	C	G	5	1	6	0	5	11	0	0
9	19406355	.	T	C	8	0	8	0	0	8	0	0
9	19406564	.	A	T	3	3	6	0	0	6	0	0
9	19406607	.	T	C	2	4	6	0	0	6	0	0
9	19407187	.	A	C	2	2	4	0	0	4	0	0
9	19407546	.	G	T	1	4	5	0	1	6	0	0
9	19407614	.	G	T	2	2	4	0	1	5	0	0
9	19408248	.	A	G	3	4	7	0	1	8	0	0
9	19442817	.	A	C	6	3	9	0	1	10	0	0
9	19469175	.	C	T	5	2	7	0	2	9	0	0
9	19471377	.	A	G	5	5	10	0	1	11	0	0
9	19477792	.	C	T	1	3	4	0	0	4	0	0
9	19477979	.	A	G	5	6	11	0	1	12	0	0
9	19480893	.	T	C	3	2	5	0	0	5	0	0
9	19490058	.	G	C	24	16	40	0	1	41	0	0
9	19496907	.	T	A	3	3	6	0	0	6	0	0
9	19504678	.	C	T	26	15	41	0	0	41	0	0
9	19510730	.	T	G	9	7	16	0	0	16	0	0
9	19510773	.	A	G	6	4	10	0	1	11	0	0
9	19510887	.	T	C	2	4	6	0	2	8	0	0
9	19518690	.	A	T	2	8	10	0	0	10	0	0
9	19527883	.	T	C	14	7	21	0	0	21	0	0
9	19534822	.	A	T	10	5	15	0	0	15	0	0
9	19534824	.	A	G	10	0	10	0	5	15	0	0
9	19539222	.	C	T	5	4	9	0	1	10	0	0
9	19539770	.	C	A	6	10	16	0	1	17	0	0
9	19539800	.	T	C	7	7	14	2	1	17	0	0
9	19539840	.	T	C	8	8	16	2	0	18	0	0
9	19545511	.	T	G	5	6	11	0	1	12	0	0
9	19545529	.	T	C	5	7	12	0	0	12	0	0
9	19545550	.	T	C	6	7	13	0	0	13	0	0
9	19549346	.	A	G	12	0	12	0	7	19	0	0
9	19549349	.	G	C	10	7	17	0	1	18	0	0
9	19549620	.	C	T	5	4	9	0	0	9	0	0
9	19549868	.	A	T	3	5	8	0	0	8	0	0
9	19549958	.	C	A	5	3	8	0	0	8	0	0
9	19623931	.	T	C	2	7	9	0	0	9	0	0
9	19636514	.	G	A	0	11	11	0	5	16	0	0
9	19639402	.	A	G	4	5	9	0	0	9	0	0
9	19639420	.	T	G	5	4	9	0	1	10	0	0
9	19640924	.	G	A	0	7	7	0	5	12	0	0
9	19640933	.	T	A	5	7	12	0	0	12	0	0
9	19641135	.	A	T	2	7	9	0	0	9	0	0
9	19641138	.	C	A	1	6	7	0	1	8	0	0
9	19642724	.	T	C	3	7	10	0	0	10	0	0
9	19646511	.	A	G	6	7	13	0	0	13	0	0
9	19648295	.	T	C	10	5	15	0	0	15	0	0
9	19652691	.	A	C	16	3	19	0	0	19	0	0
9	19653200	.	C	T	5	8	13	0	0	13	0	0
9	19696586	.	G	A	1	2	3	0	0	3	0	0
9	19696593	.	G	A	1	2	3	0	0	3	0	0
9	20076691	.	G	C	8	15	23	0	0	23	0	0
9	20076799	.	A	G	13	18	31	0	1	32	0	0
9	20076847	.	A	G	10	13	23	0	1	24	0	0
9	20076850	.	A	G	9	14	23	0	1	24	0	0
9	20076913	.	T	C	9	0	9	0	22	31	0	0
9	20078034	.	G	A	15	11	26	0	3	29	0	0
9	20095725	.	C	G	11	9	20	0	1	21	0	0
9	20160291	.	T	A	15	5	20	0	3	23	0	0
9	20160387	.	C	T	14	11	25	0	2	27	0	0
9	20174733	.	G	C	12	6	18	0	1	19	0	0
9	20191222	.	A	T	11	7	18	0	0	18	0	0
9	20191377	.	T	C	2	0	2	0	11	13	0	0
9	20191488	.	C	A	8	6	14	0	0	14	0	0
9	20315458	.	G	C	12	10	22	0	0	22	0	0
9	20315497	.	A	G	17	8	25	0	0	25	0	0
9	20315509	.	G	A	17	8	25	0	0	25	0	0
9	20315614	.	A	G	9	13	22	0	0	22	0	0
9	20372940	.	C	T	7	6	13	0	1	14	0	0
9	20487876	.	G	A	1	4	5	0	0	5	0	0
9	20498553	.	T	G	1	3	4	0	0	4	0	0
9	20498560	.	T	G	1	0	1	0	3	4	0	0
9	20498592	.	C	T	2	3	5	0	0	5	0	0
9	20498630	.	A	T	1	2	3	0	0	3	0	0
9	20498644	.	T	G	3	2	5	0	0	5	0	0
9	20499727	.	T	C	2	2	4	0	0	4	0	0
9	20499758	.	G	A	1	3	4	0	0	4	0	0
9	20500687	.	G	C	3	2	5	0	0	5	0	0
9	20500692	.	A	C	2	1	3	0	0	3	0	0
9	20501090	.	C	T	2	1	3	0	1	4	0	0
9	20501096	.	C	A	3	2	5	0	0	5	0	0
9	20623998	.	G	A	5	14	19	0	1	20	0	0
9	20700073	.	T	C	9	12	21	0	0	21	0	0
9	20700130	.	T	C	6	9	15	0	0	15	0	0
9	20731284	.	G	A	2	10	12	0	18	30	0	0
9	20731311	.	A	G	18	11	29	0	1	30	0	0
9	20763517	.	C	T	17	21	38	0	1	39	0	0
9	20763564	.	C	T	17	27	44	0	0	44	0	0
9	20763585	.	C	T	17	24	41	0	3	44	0	0
9	20763877	.	C	T	10	11	21	0	1	22	0	0
9	20763907	.	A	T	14	14	28	0	0	28	0	0
9	20764019	.	T	A	18	13	31	0	0	31	0	0
9	20764276	.	A	G	16	0	16	0	19	35	0	0
9	20764468	.	C	T	18	11	29	0	1	30	0	0
9	20764685	.	C	T	13	16	29	0	1	30	0	0
9	20764795	.	T	A	10	8	18	0	1	19	0	0
9	20764877	.	T	C	11	12	23	0	0	24	1	0
9	20765065	.	T	A	13	3	16	0	0	16	0	0
9	20765104	.	A	G	6	8	14	0	0	14	0	0
9	20765131	.	C	A	5	4	9	0	1	10	0	0
9	20765193	.	A	G	6	6	12	0	1	13	0	0
9	20806460	.	T	C	1	1	2	0	2	4	0	0
9	20806648	.	A	T	4	2	6	0	0	6	0	0
9	20806657	.	A	G	5	2	7	0	0	7	0	0
9	20806925	.	C	T	3	6	9	0	1	10	0	0
9	20806942	.	C	T	7	5	12	0	0	12	0	0
9	20807171	.	C	T	7	6	13	0	1	14	0	0
9	20807216	.	T	C	5	0	5	0	5	10	0	0
9	20831162	.	T	G	7	6	13	0	0	13	0	0
9	20831177	.	A	G	5	6	11	0	0	11	0	0
9	20846506	.	A	G	5	4	9	0	0	9	0	0
9	20850584	.	A	G	3	2	5	0	1	6	0	0
9	20850647	.	C	A	5	6	11	0	0	11	0	0
9	20850664	.	C	T	4	6	10	0	0	10	0	0
9	20850693	.	G	A	4	4	8	0	0	8	0	0
9	20853336	.	C	A	0	3	3	0	2	5	0	0
9	20856381	.	C	T	1	3	4	0	0	4	0	0
9	20859226	.	A	T	1	3	4	0	0	4	0	0
9	20859690	.	A	G	3	3	6	0	0	6	0	0
9	20860161	.	G	C	1	6	7	0	0	7	0	0
9	20863342	.	T	C	7	6	13	0	0	13	0	0
9	20868978	.	T	A	1	4	5	0	0	5	0	0
9	20869156	.	G	T	1	4	5	0	0	5	0	0
9	20870520	.	T	C	4	4	8	0	0	8	0	0
9	20870521	.	T	C	3	4	7	0	1	8	0	0
9	20870779	.	T	C	3	9	12	0	0	12	0	0
9	20872390	.	G	A	1	2	3	0	0	3	0	0
9	21084729	.	G	A	2	2	4	0	0	4	0	0
9	21084858	.	A	C	3	2	5	0	1	6	0	0
9	21084894	.	G	C	1	3	4	0	1	5	0	0
9	21204063	.	T	G	3	5	8	0	0	8	0	0
9	21204244	.	T	G	8	8	16	0	1	17	0	0
9	21205138	.	A	G	4	9	13	0	0	13	0	0
9	21205469	.	T	A	1	3	4	0	0	4	0	0
9	21216897	.	T	C	7	19	26	0	0	26	0	0
9	21216898	.	T	C	7	18	25	0	1	26	0	0
9	21217302	.	C	T	9	15	24	0	0	24	0	0
9	21217438	.	A	G	8	18	26	0	1	27	0	0
9	21221874	.	G	A	5	23	28	0	4	32	0	0
9	21221932	.	T	A	5	24	29	0	0	29	0	0
9	21222749	.	G	A	1	21	22	0	8	30	0	0
9	21222750	.	T	A	9	21	30	0	1	31	0	0
9	21224505	.	A	G	7	3	10	0	13	23	0	0
9	21224671	.	A	C	4	11	15	0	0	15	0	0
9	21224703	.	T	C	5	12	17	0	0	17	0	0
9	21224753	.	G	A	7	16	23	0	0	23	0	0
9	21224768	.	T	G	7	17	24	0	0	24	0	0
9	21224963	.	T	C	10	9	19	0	0	19	0	0
9	21225011	.	C	A	5	3	8	0	0	8	0	0
9	21225256	.	A	G	4	2	6	0	0	6	0	0
9	21225440	.	A	T	2	3	5	0	0	5	0	0
9	21225461	.	C	A	3	3	6	0	0	6	0	0
9	21225503	.	G	T	1	2	3	0	3	6	0	0
9	21225550	.	G	A	3	7	10	0	1	11	0	0
9	21235770	.	A	T	2	7	9	0	1	10	0	0
9	21266763	.	A	T	2	2	4	0	0	4	0	0
9	21266854	.	A	G	16	5	21	0	0	21	0	0
9	21266878	.	C	T	1	5	6	0	15	21	0	0
9	21267097	.	T	A	27	24	51	0	2	53	0	0
9	21267133	.	C	T	26	20	46	0	2	48	0	0
9	21269818	.	C	T	3	2	5	0	0	5	0	0
9	21270223	.	C	T	1	2	3	0	1	4	0	0
9	21270738	.	C	A	4	2	6	0	0	6	0	0
9	21271539	.	G	T	4	3	7	0	0	7	0	0
9	21271573	.	C	G	8	5	13	0	0	13	0	0
9	21271922	.	G	A	1	3	4	0	0	4	0	0
9	21271938	.	C	T	3	2	5	0	0	5	0	0
9	21272667	.	T	C	1	3	4	0	0	4	0	0
9	21272998	.	T	C	1	4	5	0	0	5	0	0
9	21295844	.	A	G	1	2	3	0	0	3	0	0
9	21295874	.	T	A	2	2	4	0	0	4	0	0
9	21336793	.	G	A	0	3	3	0	1	4	0	0
9	21339110	.	C	T	2	2	4	0	1	5	0	0
9	21341077	.	C	T	3	3	6	0	0	6	0	0
9	21341312	.	C	T	6	4	10	0	1	11	0	0
9	21342427	.	T	G	3	4	7	0	0	7	0	0
9	21347189	.	G	T	5	6	11	0	0	11	0	0
9	21347234	.	G	A	6	4	10	0	0	10	0	0
9	21349193	.	A	G	3	0	3	0	2	5	0	0
9	21349540	.	C	T	5	2	7	0	0	7	0	0
9	21351552	.	C	T	2	4	6	0	0	6	0	0
9	21356621	.	G	A	3	7	10	0	7	17	0	0
9	21357526	.	A	C	1	4	5	0	0	5	0	0
9	21358995	.	C	T	3	5	8	1	0	9	0	0
9	21361507	.	C	T	7	3	10	0	0	10	0	0
9	21361564	.	A	C	3	4	7	0	0	7	0	0
9	21362858	.	A	G	2	4	6	0	0	6	0	0
9	21363323	.	T	C	3	3	6	0	0	6	0	0
9	21366340	.	G	A	12	14	26	0	2	28	0	0
9	21366346	.	A	G	11	15	26	0	0	26	0	0
9	21369378	.	T	C	7	10	17	1	2	20	0	0
9	21374039	.	G	A	14	10	24	0	3	27	0	0
9	21374336	.	G	A	12	16	28	0	1	29	0	0
9	21374354	.	A	C	14	12	26	0	1	28	1	0
9	21375928	.	G	A	6	10	16	0	0	16	0	0
9	21375997	.	G	A	11	8	19	0	0	19	0	0
9	21376217	.	C	T	8	7	15	0	1	16	0	0
9	21376279	.	G	A	11	6	17	0	0	17	0	0
9	21376280	.	A	G	11	6	17	0	0	17	0	0
9	21379041	.	C	T	8	9	17	0	0	17	0	0
9	21383354	.	C	T	5	5	10	0	0	10	0	0
9	21383375	.	G	A	4	3	7	0	0	7	0	0
9	21383474	.	T	A	1	2	3	0	0	3	0	0
9	21383725	.	G	A	5	6	11	0	0	11	0	0
9	21383758	.	G	A	7	13	20	0	0	20	0	0
9	21384297	.	T	C	4	8	12	0	0	12	0	0
9	21385937	.	C	T	5	10	15	0	0	15	0	0
9	21385956	.	A	G	8	0	8	0	6	14	0	0
9	21388976	.	A	G	5	7	12	0	0	12	0	0
9	21391949	.	C	T	7	3	10	0	0	10	0	0
9	21399392	.	T	G	3	2	5	0	1	6	0	0
9	21399508	.	T	C	1	2	3	0	0	3	0	0
9	21430889	.	T	C	8	12	20	0	1	21	0	0
9	21437038	.	C	T	4	5	9	0	0	9	0	0
9	21437060	.	G	A	7	8	15	0	0	15	0	0
9	21437094	.	A	G	3	8	11	0	0	11	0	0
9	21437349	.	G	A	7	6	13	0	0	13	0	0
9	21440071	.	A	G	5	4	9	0	1	10	0	0
9	21443744	.	G	A	8	4	12	0	0	12	0	0
9	21446041	.	C	G	1	5	6	0	1	7	0	0
9	21448023	.	T	G	4	8	12	0	0	12	0	0
9	21449792	.	G	C	7	0	7	0	5	12	0	0
9	21449914	.	A	T	7	3	10	0	0	10	0	0
9	21453954	.	G	A	5	6	11	0	0	11	0	0
9	21453986	.	G	A	10	4	14	0	2	16	0	0
9	21462651	.	T	C	10	6	16	0	0	16	0	0
9	21462692	.	C	T	0	8	8	0	8	16	0	0
9	21463152	.	C	T	1	12	13	0	12	25	0	0
9	21463333	.	T	A	6	8	14	0	0	14	0	0
9	21470362	.	A	G	11	13	24	0	0	24	0	0
9	21470446	.	T	C	8	12	20	0	0	20	0	0
9	21471685	.	T	C	10	7	17	0	0	17	0	0
9	21472758	.	G	T	13	11	24	0	1	25	0	0
9	21476284	.	T	C	7	6	13	0	2	15	0	0
9	21476307	.	T	G	7	6	13	0	1	14	0	0
9	21478881	.	C	T	1	13	14	0	9	23	0	0
9	21478935	.	T	C	8	9	17	0	0	17	0	0
9	21479115	.	C	T	2	12	14	0	11	25	0	0
9	21479295	.	G	A	12	11	23	0	2	25	0	0
9	21488925	.	C	G	1	3	4	0	0	4	0	0
9	21495866	.	T	G	2	4	6	0	0	6	0	0
9	21496505	.	T	A	1	4	5	0	1	6	0	0
9	21496662	.	T	C	4	3	7	0	0	7	0	0
9	21497001	.	T	C	5	0	5	0	3	8	0	0
9	21497956	.	C	T	2	3	5	0	0	5	0	0
9	21504569	.	G	T	5	2	7	0	0	7	0	0
9	21535963	.	A	G	17	2	19	0	15	34	0	0
9	21550306	.	T	C	18	16	34	0	0	34	0	0
9	21554226	.	A	G	10	14	24	0	0	24	0	0
9	21558019	.	G	A	10	15	25	0	2	27	0	0
9	21558276	.	T	C	16	11	27	0	0	27	0	0
9	21558279	.	A	G	20	2	22	0	9	31	0	0
9	21559394	.	C	T	1	2	3	0	0	3	0	0
9	21560580	.	G	A	12	19	31	0	0	31	0	0
9	21560749	.	T	C	27	25	52	0	1	53	0	0
9	21561709	.	A	T	16	21	37	0	5	42	0	0
9	21563194	.	T	C	22	13	35	0	1	36	0	0
9	21566268	.	T	G	1	3	4	0	0	4	0	0
9	21722951	.	T	C	16	18	34	0	0	34	0	0
9	21723202	.	C	A	15	14	29	0	1	30	0	0
9	21724003	.	G	A	3	13	16	0	14	30	0	0
9	21802933	.	A	T	2	2	4	0	1	5	0	0
9	21802978	.	T	C	4	2	6	0	0	6	0	0
9	21802981	.	C	T	3	3	6	0	0	6	0	0
9	21803062	.	A	T	4	4	8	0	0	8	0	0
9	21804695	.	A	T	4	3	7	0	0	7	0	0
9	21805160	.	T	C	3	2	5	0	1	6	0	0
9	21808049	.	T	C	2	7	9	0	0	9	0	0
9	21808345	.	A	T	2	2	4	0	1	5	0	0
9	21810866	.	C	T	4	5	9	0	1	10	0	0
9	21810899	.	G	A	7	5	12	0	0	12	0	0
9	21811157	.	A	G	5	2	7	0	0	7	0	0
9	21811829	.	T	C	11	10	21	0	0	21	0	0
9	21811872	.	T	G	11	13	24	0	0	24	0	0
9	21812480	.	C	T	5	6	11	0	0	11	0	0
9	21821061	.	T	C	17	16	33	0	2	35	0	0
9	21821362	.	A	G	17	0	17	0	23	40	0	0
9	21821437	.	C	T	17	20	37	0	2	39	0	0
9	21824069	.	C	G	13	0	13	0	9	22	0	0
9	21824124	.	G	A	2	6	8	0	11	19	0	0
9	21824510	.	T	C	13	16	29	0	1	30	0	0
9	21824564	.	A	C	9	8	17	0	2	19	0	0
9	21824588	.	G	T	4	2	6	0	1	7	0	0
9	21824788	.	G	A	0	10	10	0	0	10	0	0
9	21824847	.	T	C	8	20	28	0	2	30	0	0
9	21825345	.	C	T	15	20	35	0	0	35	0	0
9	21825632	.	G	A	15	13	28	0	2	30	0	0
9	21825819	.	C	A	13	18	31	0	0	31	0	0
9	21825844	.	A	G	9	12	21	0	0	21	0	0
9	21826752	.	T	A	1	2	3	0	0	3	0	0
9	21826817	.	C	T	10	10	20	0	1	21	0	0
9	21826893	.	G	A	3	10	13	0	1	14	0	0
9	21829505	.	C	T	7	10	17	0	1	18	0	0
9	21831293	.	T	A	4	6	10	0	1	12	1	0
9	21834021	.	T	C	1	2	3	0	0	3	0	0
9	21843991	.	C	T	17	22	39	0	0	39	0	0
9	21844190	.	C	A	9	6	15	0	0	15	0	0
9	21844438	.	T	A	15	11	26	0	2	28	0	0
9	21844702	.	A	G	3	9	12	0	0	12	0	0
9	21844944	.	T	C	20	14	34	0	1	35	0	0
9	21845038	.	C	A	6	9	15	0	1	16	0	0
9	21845142	.	G	A	12	16	28	0	3	31	0	0
9	21845208	.	G	A	14	9	23	0	0	23	0	0
9	21845365	.	G	C	10	9	19	0	0	19	0	0
9	21845366	.	G	A	10	9	19	0	0	19	0	0
9	21845541	.	T	C	10	8	18	0	0	18	0	0
9	21893856	.	A	G	3	3	6	0	0	6	0	0
9	21893862	.	G	A	4	4	8	0	0	8	0	0
9	21894057	.	T	G	8	3	11	0	0	11	0	0
9	21899687	.	T	C	16	11	27	0	1	28	0	0
9	21899795	.	T	C	14	0	14	0	12	26	0	0
9	21899973	.	G	A	11	14	25	0	3	28	0	0
9	21900123	.	C	A	16	6	22	0	0	22	0	0
9	21904770	.	C	T	15	8	23	0	0	23	0	0
9	21904973	.	G	A	11	16	27	0	0	27	0	0
9	21908363	.	A	T	12	8	20	0	1	21	0	0
9	21914170	.	A	G	8	5	13	0	1	14	0	0
9	21914184	.	C	G	1	6	7	0	8	15	0	0
9	21919162	.	G	C	8	7	15	0	2	17	0	0
9	21919908	.	G	T	12	4	16	0	1	17	0	0
9	21927072	.	C	T	3	5	8	0	1	9	0	0
9	21927241	.	T	C	5	0	5	0	6	11	0	0
9	21927288	.	C	T	8	4	12	0	0	12	0	0
9	21927420	.	A	T	3	4	7	0	0	7	0	0
9	21930120	.	G	T	7	4	11	0	2	13	0	0
9	21931277	.	G	C	6	3	9	0	0	9	0	0
9	21931295	.	A	G	6	4	10	0	0	10	0	0
9	21931796	.	C	G	4	3	7	0	0	7	0	0
9	21969874	.	A	T	2	2	4	0	0	4	0	0
9	21974246	.	T	C	12	18	30	0	1	31	0	0
9	21974252	.	A	C	15	17	32	0	0	32	0	0
9	21976540	.	T	C	4	14	18	0	3	21	0	0
9	22447527	.	C	A	3	3	6	0	0	6	0	0
9	22481474	.	A	C	1	2	3	0	0	3	0	0
9	22483715	.	G	C	2	9	11	0	0	12	1	0
9	22483724	.	G	A	1	8	9	0	5	14	0	0
9	22483856	.	G	A	2	5	7	0	5	12	0	0
9	22483862	.	C	T	5	4	9	0	3	12	0	0
9	22485458	.	A	G	4	3	7	0	0	7	0	0
9	22488933	.	C	A	2	5	7	0	1	8	0	0
9	22489047	.	A	G	1	6	7	0	0	7	0	0
9	22489092	.	A	C	2	3	5	0	0	5	0	0
9	22613315	.	C	T	9	3	12	0	1	13	0	0
9	22613357	.	A	G	5	3	8	0	1	9	0	0
9	22613379	.	C	T	4	3	7	0	0	7	0	0
9	22634324	.	T	C	20	24	44	0	0	44	0	0
9	22636747	.	C	T	19	33	52	0	3	56	1	0
9	22636988	.	C	T	26	25	51	0	0	51	0	0
9	22637031	.	C	G	24	29	53	0	2	55	0	0
9	22637082	.	A	T	23	26	49	0	3	52	0	0
9	22638738	.	C	G	21	19	40	0	0	40	0	0
9	22647331	.	T	C	20	26	46	0	0	46	0	0
9	22647373	.	A	G	23	1	24	0	25	49	0	0
9	22647391	.	C	T	22	23	45	0	1	46	0	0
9	22647607	.	A	T	20	27	47	0	0	47	0	0
9	22647754	.	A	T	16	19	35	0	2	37	0	0
9	22647755	.	A	T	17	22	39	0	0	39	0	0
9	22648004	.	A	G	12	1	13	0	14	27	0	0
9	22648010	.	G	A	2	17	19	0	13	32	0	0
9	22648051	.	T	C	17	17	34	0	1	35	0	0
9	22648355	.	A	T	23	22	45	0	1	46	0	0
9	22648747	.	T	G	18	25	43	0	0	43	0	0
9	22677597	.	T	G	4	3	7	0	1	8	0	0
9	22677684	.	G	C	2	4	6	0	0	6	0	0
9	22694612	.	T	C	8	2	10	0	0	10	0	0
9	22694621	.	G	A	6	3	9	0	0	9	0	0
9	22695715	.	T	C	3	2	5	0	0	5	0	0
9	22707105	.	T	C	5	3	8	0	1	9	0	0
9	22707477	.	C	T	8	4	12	0	0	12	0	0
9	22707493	.	C	A	9	6	15	0	0	15	0	0
9	22747419	.	A	G	10	0	10	0	8	18	0	0
9	22747557	.	A	G	6	4	10	0	1	11	0	0
9	22747644	.	G	A	1	4	5	0	13	18	0	0
9	22747811	.	G	T	7	5	12	0	0	12	0	0
9	22747865	.	A	C	2	3	5	0	0	5	0	0
9	22747943	.	G	T	0	4	4	0	2	6	0	0
9	22781047	.	T	G	3	4	7	0	0	7	0	0
9	22781062	.	C	A	4	4	8	0	0	8	0	0
9	22787232	.	T	A	3	2	5	0	0	5	0	0
9	22788756	.	C	T	6	5	11	0	0	11	0	0
9	22797500	.	G	A	3	2	5	0	0	5	0	0
9	22797816	.	C	A	7	7	14	0	0	14	0	0
9	22797962	.	A	C	7	6	13	0	0	13	0	0
9	22798087	.	C	T	3	5	8	0	0	8	0	0
9	22798180	.	C	A	7	8	15	0	0	15	0	0
9	22798715	.	A	G	9	6	15	0	2	17	0	0
9	22798736	.	G	T	6	8	14	0	0	14	0	0
9	22798765	.	A	G	5	6	11	0	0	11	0	0
9	22798789	.	C	T	7	6	13	0	0	13	0	0
9	22799115	.	T	A	9	5	14	0	0	14	0	0
9	22799157	.	G	A	4	3	7	0	0	7	0	0
9	22799193	.	T	C	5	2	7	0	0	7	0	0
9	22799195	.	A	T	3	2	5	0	2	7	0	0
9	22799456	.	G	C	2	9	11	0	2	13	0	0
9	22799508	.	T	C	6	7	13	0	1	14	0	0
9	22799810	.	A	G	8	5	13	0	0	13	0	0
9	22799883	.	C	T	12	7	19	0	0	19	0	0
9	22800271	.	T	C	2	7	9	0	2	11	0	0
9	22801205	.	C	T	12	9	21	0	1	22	0	0
9	22801527	.	C	T	4	4	8	0	0	8	0	0
9	22801746	.	A	G	8	5	13	0	0	13	0	0
9	22801785	.	A	G	6	1	7	0	5	12	0	0
9	22801860	.	C	A	3	5	8	0	0	8	0	0
9	22801929	.	A	G	3	4	7	0	0	7	0	0
9	22802045	.	A	G	9	0	9	0	3	12	0	0
9	22802066	.	G	A	1	3	4	0	5	9	0	0
9	22902938	.	A	T	1	2	3	0	0	3	0	0
9	22902997	.	G	A	1	5	6	0	0	6	0	0
9	22903012	.	T	G	1	4	5	0	0	5	0	0
9	22903166	.	C	T	1	15	16	0	13	29	0	0
9	22903270	.	A	T	8	10	18	0	3	21	0	0
9	22906425	.	C	T	6	6	12	0	1	13	0	0
9	22909003	.	T	C	10	8	18	0	3	21	0	0
9	22932366	.	T	G	7	11	18	0	0	18	0	0
9	22937852	.	G	A	7	12	19	0	0	19	0	0
9	22938719	.	A	T	6	5	11	0	0	11	0	0
9	22938828	.	T	G	5	6	11	0	0	11	0	0
9	22938932	.	T	G	12	0	12	0	8	21	1	0
9	22938967	.	T	G	11	6	17	0	1	18	0	0
9	22939068	.	A	G	6	10	16	0	1	17	0	0
9	22939201	.	C	G	3	5	8	0	0	8	0	0
9	22941166	.	C	A	5	7	12	0	0	12	0	0
9	22941285	.	G	T	8	6	14	0	1	15	0	0
9	22946494	.	G	A	3	3	6	0	0	6	0	0
9	22949353	.	C	T	6	3	9	0	2	11	0	0
9	22953228	.	G	A	4	4	8	0	0	8	0	0
9	22963427	.	C	T	0	2	2	0	2	4	0	0
9	23004411	.	C	A	2	4	6	0	0	6	0	0
9	23009721	.	C	G	2	2	4	0	2	6	0	0
9	23009730	.	T	C	3	4	7	0	1	8	0	0
9	23009923	.	G	A	4	6	10	0	0	10	0	0
9	23016482	.	T	A	7	4	11	0	0	11	0	0
9	23016698	.	C	T	4	3	7	0	1	8	0	0
9	23016709	.	G	A	6	4	10	0	1	11	0	0
9	23018709	.	C	A	7	8	15	0	1	16	0	0
9	23022763	.	A	T	12	4	16	0	0	16	0	0
9	23023047	.	A	T	8	8	16	0	1	17	0	0
9	23023064	.	C	T	9	9	18	0	2	20	0	0
9	23023103	.	G	C	10	5	15	0	7	22	0	0
9	23023254	.	G	A	0	3	3	0	2	5	0	0
9	23026337	.	C	T	1	2	3	0	2	5	0	0
9	23026412	.	A	T	7	5	12	0	0	12	0	0
9	23026901	.	C	T	20	8	28	0	2	30	0	0
9	23033771	.	T	C	7	0	7	0	7	14	0	0
9	23049577	.	A	G	7	0	7	0	13	20	0	0
9	23051913	.	G	T	1	7	8	0	5	13	0	0
9	23055635	.	C	T	10	17	27	0	0	27	0	0
9	23055644	.	A	G	9	16	25	0	1	26	0	0
9	23055674	.	G	C	13	12	25	0	0	25	0	0
9	23055986	.	A	C	4	2	6	0	1	7	0	0
9	23056148	.	A	T	1	4	5	0	0	5	0	0
9	23071272	.	A	G	2	3	5	0	0	5	0	0
9	23071353	.	C	G	2	2	4	0	0	4	0	0
9	23071579	.	G	A	1	3	4	0	1	5	0	0
9	23185674	.	A	G	19	20	39	0	3	42	0	0
9	23185786	.	A	C	17	20	37	0	1	38	0	0
9	23185801	.	T	A	17	17	34	0	1	36	1	0
9	23186163	.	A	C	10	12	22	0	3	25	0	0
9	23187985	.	T	C	7	3	10	0	1	11	0	0
9	23188003	.	C	T	6	5	11	0	0	11	0	0
9	23194587	.	G	A	9	13	22	0	0	22	0	0
9	23194608	.	A	T	14	15	29	0	0	29	0	0
9	23198166	.	C	T	11	9	20	0	0	20	0	0
9	23202123	.	C	T	5	7	12	0	1	13	0	0
9	23202433	.	A	T	7	7	14	0	2	16	0	0
9	23202743	.	G	A	9	5	14	0	0	14	0	0
9	23216991	.	G	T	4	7	11	0	0	11	0	0
9	23216995	.	A	T	3	8	11	0	0	11	0	0
9	23217093	.	C	T	10	7	17	0	0	17	0	0
9	23234567	.	T	C	12	0	12	0	9	21	0	0
9	23234777	.	C	T	1	15	16	0	5	21	0	0
9	23236339	.	T	C	11	9	20	0	1	21	0	0
9	23236465	.	G	C	15	15	30	0	0	30	0	0
9	23236515	.	G	A	15	15	30	0	1	31	0	0
9	23236531	.	C	T	1	15	16	0	17	33	0	0
9	23357134	.	A	G	8	4	12	0	0	12	0	0
9	23357142	.	G	C	6	0	6	0	4	10	0	0
9	23357194	.	C	T	6	8	14	0	0	14	0	0
9	23357200	.	T	C	5	6	11	0	2	13	0	0
9	23357234	.	C	G	7	8	15	0	3	18	0	0
9	23357528	.	C	T	8	6	14	0	1	15	0	0
9	23372041	.	C	T	3	3	6	0	0	6	0	0
9	23382531	.	T	C	3	0	3	0	1	4	0	0
9	23382541	.	G	A	2	2	4	0	0	4	0	0
9	23550362	.	T	C	1	2	3	0	0	3	0	0
9	23555976	.	G	A	2	3	5	0	0	5	0	0
9	23558562	.	C	T	1	5	6	0	0	6	0	0
9	23568996	.	C	T	1	5	6	0	0	6	0	0
9	23569002	.	C	G	1	6	7	0	0	7	0	0
9	23569083	.	A	G	2	3	5	0	0	5	0	0
9	23575804	.	T	C	3	2	5	0	0	5	0	0
9	23575869	.	A	G	1	2	3	0	0	3	0	0
9	23589297	.	A	T	3	5	8	0	0	8	0	0
9	23590549	.	G	T	5	3	8	0	0	8	0	0
9	23590551	.	A	G	5	3	8	0	0	8	0	0
9	23597979	.	A	C	2	1	3	0	1	4	0	0
9	23607087	.	G	A	0	3	3	0	7	10	0	0
9	23718577	.	T	A	1	2	3	0	0	3	0	0
9	23740555	.	G	C	6	4	10	0	0	10	0	0
9	23740676	.	A	G	19	8	27	0	1	28	0	0
9	23745176	.	C	T	3	16	19	0	17	36	0	0
9	23745201	.	T	A	21	13	34	0	3	37	0	0
9	23745471	.	C	A	16	13	29	0	2	31	0	0
9	23745504	.	A	G	20	9	29	0	0	29	0	0
9	23745531	.	C	T	22	14	36	0	1	37	0	0
9	23745558	.	T	C	21	0	21	0	16	37	0	0
9	23745570	.	G	A	18	18	36	0	0	36	0	0
9	23746628	.	A	G	17	20	37	0	0	37	0	0
9	23746676	.	G	A	20	12	32	0	0	32	0	0
9	23747111	.	T	C	21	15	36	0	0	36	0	0
9	23747118	.	G	A	20	15	35	0	1	36	0	0
9	23747226	.	A	C	11	6	17	0	0	17	0	0
9	23748417	.	C	G	11	10	21	0	0	21	0	0
9	23748421	.	A	G	10	12	22	0	1	23	0	0
9	23748993	.	G	C	5	8	13	0	0	13	0	0
9	23750634	.	T	C	11	12	23	0	1	24	0	0
9	23750643	.	C	T	12	13	25	0	0	25	0	0
9	23754905	.	T	C	12	11	23	0	1	24	0	0
9	23754989	.	C	A	3	13	16	0	0	16	0	0
9	23755024	.	A	T	3	8	11	0	1	12	0	0
9	23755083	.	C	G	5	4	9	0	1	10	0	0
9	23755531	.	G	A	7	3	10	0	0	10	0	0
9	23755774	.	G	A	2	6	8	0	0	8	0	0
9	23756108	.	G	C	5	10	15	0	1	16	0	0
9	23756268	.	G	A	7	7	14	0	0	14	0	0
9	23756377	.	G	A	5	5	10	0	0	10	0	0
9	23756519	.	C	T	5	6	11	0	0	11	0	0
9	23756552	.	C	T	5	5	10	0	0	10	0	0
9	23756584	.	T	C	5	3	8	0	0	8	0	0
9	23756636	.	T	A	9	5	14	0	1	15	0	0
9	23756640	.	C	G	8	5	13	0	2	15	0	0
9	23757103	.	G	T	3	2	5	0	0	5	0	0
9	23757145	.	C	T	4	2	6	0	0	6	0	0
9	23757157	.	G	A	4	2	6	0	0	6	0	0
9	23757196	.	G	C	4	2	6	0	0	6	0	0
9	23757197	.	G	A	4	2	6	0	0	6	0	0
9	23810426	.	A	G	7	4	11	0	0	11	0	0
9	23814104	.	G	C	14	14	28	0	0	28	0	0
9	23823895	.	A	G	22	11	33	0	0	33	0	0
9	23824141	.	T	G	2	2	4	0	0	4	0	0
9	23824150	.	C	A	0	2	2	0	2	4	0	0
9	23825708	.	G	T	2	4	6	0	0	6	0	0
9	23826525	.	A	G	2	5	7	0	0	7	0	0
9	23826534	.	G	A	1	6	7	0	1	8	0	0
9	23832209	.	G	A	1	2	3	0	0	3	0	0
9	23832650	.	C	A	2	3	5	0	0	5	0	0
9	23832689	.	C	T	3	8	11	0	0	11	0	0
9	23836415	.	T	C	8	4	12	0	0	12	0	0
9	23838898	.	C	T	6	7	13	0	0	13	0	0
9	23840554	.	G	A	2	5	7	0	0	7	0	0
9	23840775	.	G	C	4	7	11	0	1	12	0	0
9	23840824	.	C	T	8	7	15	0	0	15	0	0
9	23841037	.	T	G	4	3	7	0	0	7	0	0
9	23841088	.	G	A	3	7	10	0	1	11	0	0
9	23841139	.	T	C	2	9	11	0	0	11	0	0
9	23841239	.	T	A	3	3	6	0	0	6	0	0
9	23841240	.	G	C	3	3	6	0	0	6	0	0
9	23841507	.	C	G	1	5	6	0	0	6	0	0
9	23843116	.	A	G	1	2	3	2	0	5	0	0
9	23846251	.	C	T	2	2	4	0	0	4	0	0
9	23846257	.	G	A	1	2	3	0	0	3	0	0
9	23869832	.	A	G	1	2	3	0	0	3	0	0
9	23905834	.	A	C	5	5	10	0	0	10	0	0
9	23905848	.	G	T	5	5	10	0	0	10	0	0
9	23914555	.	T	C	4	9	13	0	0	13	0	0
9	23914684	.	C	G	1	2	3	0	0	3	0	0
9	23914696	.	G	C	2	2	4	0	0	4	0	0
9	24026088	.	G	T	4	2	6	0	0	6	0	0
9	24026116	.	C	A	1	2	3	0	0	3	0	0
9	24026332	.	G	T	3	5	8	0	0	8	0	0
9	24026397	.	G	A	8	8	16	0	0	16	0	0
9	24026400	.	G	A	8	8	16	0	0	16	0	0
9	24045922	.	G	A	1	2	3	0	0	3	0	0
9	24107215	.	G	A	2	7	9	0	0	9	0	0
9	24114126	.	C	T	4	4	8	0	0	8	0	0
9	24114655	.	G	C	0	3	3	0	7	10	0	0
9	24114867	.	T	G	5	2	7	0	0	7	0	0
9	24114994	.	G	A	3	4	7	0	0	7	0	0
9	24115004	.	C	T	3	4	7	0	0	7	0	0
9	24115129	.	G	A	1	6	7	0	0	7	0	0
9	24116814	.	G	A	4	2	6	0	0	6	0	0
9	24117048	.	C	A	0	5	5	0	6	11	0	0
9	24122676	.	C	T	9	8	17	0	1	18	0	0
9	24122715	.	G	T	0	10	10	0	8	18	0	0
9	24123504	.	T	C	1	5	6	0	0	6	0	0
9	24133922	.	C	T	1	2	3	0	0	3	0	0
9	24140229	.	C	A	1	3	4	0	0	4	0	0
9	24143567	.	A	C	5	3	8	0	1	9	0	0
9	24159634	.	G	A	1	6	7	0	8	15	0	0
9	24159805	.	C	A	10	6	16	0	1	17	0	0
9	24162994	.	A	G	8	5	13	0	0	13	0	0
9	24165519	.	C	T	5	4	9	0	1	10	0	0
9	24165555	.	C	T	7	6	13	0	1	14	0	0
9	24166575	.	T	C	4	9	13	0	0	13	0	0
9	24166729	.	T	C	8	9	17	0	0	17	0	0
9	24166825	.	T	C	5	6	11	0	2	13	0	0
9	24166846	.	C	T	3	9	12	0	1	13	0	0
9	24166867	.	A	G	3	7	10	0	1	11	0	0
9	24167180	.	A	G	8	0	8	0	10	18	0	0
9	24178660	.	G	A	15	11	26	0	1	27	0	0
9	24183438	.	T	C	7	11	18	0	0	18	0	0
9	24183603	.	C	T	10	10	20	0	0	20	0	0
9	24186269	.	G	A	7	10	17	0	0	17	0	0
9	24187510	.	C	A	11	9	20	0	0	20	0	0
9	24187675	.	T	G	9	7	16	0	0	16	0	0
9	24187805	.	C	G	10	17	27	0	1	28	0	0
9	24187967	.	A	G	12	0	12	0	22	34	0	0
9	24188100	.	A	T	7	7	14	0	0	14	0	0
9	24188110	.	A	T	7	10	17	0	0	17	0	0
9	24188729	.	C	G	7	10	17	0	1	18	0	0
9	24188969	.	T	G	13	6	19	0	1	20	0	0
9	24189179	.	T	G	13	9	22	1	0	23	0	0
9	24189198	.	A	G	12	9	21	1	0	22	0	0
9	24189283	.	G	A	12	5	17	0	0	17	0	0
9	24189407	.	A	G	20	13	33	0	1	34	0	0
9	24189757	.	C	A	14	12	26	0	1	27	0	0
9	24189825	.	T	A	13	10	23	0	0	23	0	0
9	24189946	.	C	T	11	8	19	0	1	20	0	0
9	24189977	.	A	G	13	6	19	0	0	19	0	0
9	24190010	.	G	A	14	5	19	0	0	19	0	0
9	24190020	.	G	A	16	9	25	0	1	26	0	0
9	24190048	.	T	C	20	13	33	0	1	34	0	0
9	24190139	.	A	G	13	15	28	0	3	31	0	0
9	24190295	.	T	C	13	8	21	0	1	22	0	0
9	24190302	.	A	G	12	6	18	0	2	20	0	0
9	24190419	.	G	A	18	14	32	0	1	33	0	0
9	24190466	.	G	T	15	8	23	0	1	24	0	0
9	24190489	.	C	G	12	5	17	0	0	17	0	0
9	24190547	.	C	A	13	6	19	0	1	20	0	0
9	24190630	.	G	C	12	4	16	0	1	17	0	0
9	24190642	.	T	A	11	9	20	0	1	21	0	0
9	24190748	.	G	T	5	4	9	0	0	9	0	0
9	24190792	.	A	G	11	7	18	0	0	18	0	0
9	24191053	.	T	A	17	14	31	1	0	32	0	0
9	24191462	.	G	A	13	17	30	0	0	30	0	0
9	24192423	.	T	C	4	3	7	0	0	7	0	0
9	24192746	.	C	G	5	4	9	0	0	9	0	0
9	24197435	.	G	A	0	2	2	0	5	7	0	0
9	24197447	.	T	C	4	7	11	0	0	11	0	0
9	24198574	.	G	T	4	5	9	0	1	10	0	0
9	24200608	.	C	T	6	10	16	0	0	16	0	0
9	24204218	.	C	T	2	3	5	0	0	5	0	0
9	24204231	.	A	T	3	4	7	0	0	7	0	0
9	24204661	.	T	A	8	4	12	0	1	13	0	0
9	24204723	.	T	A	10	3	13	0	0	13	0	0
9	24204749	.	T	A	10	6	16	0	0	16	0	0
9	24204762	.	A	G	9	8	17	0	0	17	0	0
9	24204806	.	T	C	6	0	6	0	8	14	0	0
9	24204905	.	T	A	8	9	17	0	0	17	0	0
9	24204913	.	G	C	10	6	16	0	1	17	0	0
9	24204947	.	A	C	5	7	12	0	0	13	1	0
9	24205136	.	G	A	5	6	11	0	0	11	0	0
9	24205242	.	C	G	7	3	10	0	1	11	0	0
9	24205260	.	C	T	2	7	9	0	0	9	0	0
9	24205292	.	C	T	4	2	6	0	0	6	0	0
9	24205318	.	A	G	6	3	9	0	1	10	0	0
9	24205391	.	T	C	7	6	13	0	0	13	0	0
9	24205484	.	A	G	6	5	11	0	0	11	0	0
9	24205596	.	C	T	4	11	15	0	0	15	0	0
9	24205681	.	G	T	11	8	19	0	0	19	0	0
9	24205818	.	G	T	6	11	17	0	1	18	0	0
9	24205916	.	G	A	11	15	26	0	3	29	0	0
9	24208774	.	T	C	3	12	15	0	1	16	0	0
9	24208779	.	T	A	6	11	17	0	1	18	0	0
9	24208825	.	T	C	10	4	14	0	7	21	0	0
9	24209052	.	G	A	5	3	8	0	1	9	0	0
9	24209941	.	A	G	2	3	5	0	0	5	0	0
9	24210083	.	A	G	2	0	2	0	4	6	0	0
9	24210244	.	T	C	4	5	9	0	0	9	0	0
9	24210449	.	C	T	5	3	8	0	0	8	0	0
9	24210485	.	C	T	5	4	9	0	0	9	0	0
9	24211081	.	T	C	3	3	6	1	0	7	0	0
9	24212157	.	C	T	1	4	5	0	6	11	0	0
9	24212277	.	C	T	8	6	14	0	0	14	0	0
9	24212299	.	G	A	5	6	11	0	1	12	0	0
9	24212552	.	G	A	0	3	3	0	4	7	0	0
9	24212585	.	A	C	4	3	7	0	1	8	0	0
9	24212629	.	T	A	6	4	10	0	0	10	0	0
9	24212654	.	T	A	4	5	9	0	0	9	0	0
9	24212748	.	T	C	2	2	4	0	0	4	0	0
9	24214709	.	C	A	1	3	4	0	4	8	0	0
9	24214792	.	C	T	11	8	19	0	0	19	0	0
9	24216417	.	C	T	5	6	11	0	0	11	0	0
9	24217459	.	G	A	6	10	16	0	0	16	0	0
9	24217801	.	T	A	2	6	8	0	0	8	0	0
9	24217894	.	T	A	3	6	9	0	0	9	0	0
9	24217910	.	T	C	7	3	10	0	0	10	0	0
9	24249396	.	T	G	15	18	33	0	0	34	1	0
9	24249414	.	T	C	12	2	14	0	18	32	0	0
9	24252457	.	C	T	2	24	26	0	22	48	0	0
9	24252490	.	T	C	17	1	18	0	24	42	0	0
9	24255690	.	G	T	18	21	39	0	2	41	0	0
9	24366142	.	G	A	21	12	33	0	2	35	0	0
9	24412781	.	A	G	15	19	34	0	3	37	0	0
9	24412790	.	A	G	18	19	37	0	1	38	0	0
9	24949110	.	T	A	4	3	7	0	0	7	0	0
9	24950385	.	C	T	2	2	4	0	0	4	0	0
9	24950389	.	C	T	2	2	4	0	0	4	0	0
9	24950910	.	G	A	10	2	12	0	1	13	0	0
9	25123436	.	A	C	12	9	21	0	2	23	0	0
9	25132315	.	C	A	4	4	8	0	0	8	0	0
9	25132516	.	C	T	8	9	17	0	2	19	0	0
9	25139179	.	A	C	4	6	10	0	2	12	0	0
9	25140796	.	T	C	4	8	12	0	0	12	0	0
9	25148540	.	C	A	9	9	18	0	0	18	0	0
9	25154390	.	T	G	12	5	17	0	1	18	0	0
9	25154910	.	T	A	11	10	21	0	3	24	0	0
9	25167271	.	C	T	5	2	7	0	0	7	0	0
9	25167404	.	T	A	6	2	8	0	0	8	0	0
9	25167588	.	T	C	3	2	5	0	2	7	0	0
9	25168500	.	A	T	1	6	7	0	0	7	0	0
9	25168569	.	A	C	3	3	6	0	0	6	0	0
9	25169295	.	T	A	6	4	10	0	0	10	0	0
9	25169380	.	A	G	8	6	14	0	0	14	0	0
9	25169399	.	T	A	9	5	14	0	0	14	0	0
9	25169444	.	T	G	6	4	10	0	0	10	0	0
9	25169738	.	G	A	8	3	11	0	0	11	0	0
9	25177600	.	A	G	9	5	14	0	0	14	0	0
9	25177642	.	A	G	10	6	16	0	0	16	0	0
9	25180196	.	G	A	11	7	18	0	1	19	0	0
9	25181285	.	A	T	6	3	9	0	1	10	0	0
9	25181286	.	A	T	7	3	10	0	0	10	0	0
9	25198560	.	T	C	2	3	5	1	0	6	0	0
9	25198606	.	T	G	6	2	8	1	0	9	0	0
9	25210606	.	C	T	1	3	4	0	0	4	0	0
9	25210612	.	T	A	0	3	3	0	1	4	0	0
9	25210753	.	A	T	4	5	9	0	1	10	0	0
9	25320799	.	C	T	3	4	7	0	1	8	0	0
9	25320812	.	C	T	2	6	8	0	0	8	0	0
9	25320862	.	G	A	1	3	4	0	0	4	0	0
9	25320914	.	T	A	3	2	5	0	0	5	0	0
9	25320980	.	A	T	7	6	13	1	0	14	0	0
9	25321538	.	G	A	4	9	13	0	1	14	0	0
9	25323773	.	C	T	4	8	12	0	2	14	0	0
9	25326386	.	G	A	3	8	11	0	1	12	0	0
9	25326482	.	C	T	1	3	4	0	4	8	0	0
9	25337468	.	C	T	5	5	10	0	0	10	0	0
9	25337499	.	G	A	4	6	10	0	0	10	0	0
9	25337529	.	G	A	3	4	7	0	0	7	0	0
9	25345948	.	A	G	6	3	9	0	1	10	0	0
9	25345974	.	A	G	3	3	6	0	1	7	0	0
9	25346001	.	G	T	1	5	6	0	3	9	0	0
9	25347908	.	T	A	1	5	6	0	1	7	0	0
9	25347916	.	G	T	2	5	7	0	0	7	0	0
9	25349838	.	G	A	5	11	16	0	0	16	0	0
9	25353387	.	C	T	0	6	6	0	9	15	0	0
9	25356838	.	A	G	10	9	19	0	0	19	0	0
9	25381021	.	A	G	20	12	32	0	0	32	0	0
9	25381150	.	A	G	18	14	32	0	0	32	0	0
9	25382028	.	T	C	9	0	9	0	11	20	0	0
9	25382097	.	T	C	12	5	17	0	0	17	0	0
9	25382322	.	C	G	9	12	21	0	0	21	0	0
9	25382478	.	C	A	11	5	16	0	0	16	0	0
9	25383046	.	C	A	11	17	28	0	0	28	0	0
9	25383124	.	T	C	12	0	12	0	14	26	0	0
9	25383421	.	G	A	13	7	20	0	2	22	0	0
9	25383780	.	A	C	16	7	23	0	1	24	0	0
9	25384091	.	G	A	10	17	27	0	2	29	0	0
9	25388150	.	T	C	9	0	9	0	18	27	0	0
9	25389823	.	G	A	14	11	25	0	2	27	0	0
9	25389931	.	G	A	10	5	15	0	0	15	0	0
9	25392985	.	C	T	9	11	20	0	2	22	0	0
9	25393036	.	T	C	14	10	24	0	0	24	0	0
9	25419211	.	C	G	15	11	26	0	0	26	0	0
9	25443163	.	T	A	4	13	17	0	1	18	0	0
9	25443330	.	A	T	6	11	17	0	0	17	0	0
9	25443352	.	A	T	8	10	18	0	0	18	0	0
9	25443419	.	G	T	5	4	9	0	0	9	0	0
9	25443575	.	A	T	9	7	16	0	0	16	0	0
9	25443650	.	C	T	7	5	12	0	0	12	0	0
9	25443667	.	A	G	5	7	12	0	1	13	0	0
9	25443702	.	T	C	7	4	11	0	0	11	0	0
9	25443874	.	T	A	6	3	9	0	0	9	0	0
9	25443908	.	C	T	6	3	9	0	0	9	0	0
9	25443957	.	G	A	8	3	11	0	1	12	0	0
9	25444055	.	T	G	2	4	6	1	0	7	0	0
9	25837206	.	A	T	3	2	5	0	0	5	0	0
9	25837213	.	A	T	7	3	10	0	1	11	0	0
9	27381934	.	A	C	2	4	6	0	0	6	0	0
9	27381941	.	A	G	3	3	6	0	1	7	0	0
9	27692005	.	C	A	3	2	5	0	0	5	0	0
9	27692017	.	T	C	3	3	6	0	0	6	0	0
9	27692075	.	G	T	2	5	7	0	0	7	0	0
9	27692121	.	C	A	0	2	2	0	3	5	0	0
9	27692325	.	A	G	6	8	14	0	1	15	0	0
9	27692329	.	G	T	6	9	15	0	1	16	0	0
9	27692389	.	A	G	10	6	16	0	2	18	0	0
9	27692402	.	G	T	9	8	17	0	1	18	0	0
9	27692471	.	C	T	1	5	6	0	4	10	0	0
9	27692699	.	C	G	0	10	10	0	5	15	0	0
9	27694630	.	T	C	2	8	10	0	0	10	0	0
9	27694690	.	C	A	0	4	4	0	4	8	0	0
9	27716762	.	A	G	3	9	12	0	0	12	0	0
9	27716974	.	A	G	9	8	17	0	0	17	0	0
9	27720032	.	G	A	2	5	7	0	1	8	0	0
9	27741482	.	T	G	2	2	4	0	0	4	0	0
9	27741555	.	T	A	1	4	5	0	1	6	0	0
9	27757831	.	C	T	11	23	34	0	1	35	0	0
9	27757893	.	A	G	26	0	26	0	19	45	0	0
9	27860507	.	G	C	1	2	3	0	0	3	0	0
9	27860734	.	C	T	1	6	7	0	10	17	0	0
9	27861186	.	G	T	2	3	5	0	1	6	0	0
9	27861293	.	C	G	1	6	7	0	15	22	0	0
9	27863828	.	G	T	6	4	10	0	0	10	0	0
9	27876169	.	T	C	4	4	8	0	0	8	0	0
9	27884383	.	G	T	3	3	6	0	0	6	0	0
9	27886614	.	T	C	5	8	13	0	1	14	0	0
9	27887864	.	C	T	6	2	8	0	0	8	0	0
9	27888461	.	G	T	1	7	8	0	0	8	0	0
9	27894444	.	G	T	4	6	10	0	1	11	0	0
9	27894656	.	T	C	4	4	8	0	1	9	0	0
9	27897012	.	T	C	5	7	12	0	0	12	0	0
9	27901012	.	A	T	3	3	6	0	0	6	0	0
9	27901013	.	C	T	3	3	6	0	0	6	0	0
9	27909933	.	C	T	5	12	17	0	1	18	0	0
9	27912848	.	G	A	5	3	8	0	5	13	0	0
9	27912962	.	G	A	7	10	17	0	0	17	0	0
9	27912995	.	A	G	7	8	15	0	0	15	0	0
9	27920595	.	T	A	10	6	16	0	0	16	0	0
9	27920649	.	G	A	7	8	15	0	1	16	0	0
9	27954620	.	G	A	5	3	8	0	1	9	0	0
9	27954782	.	A	G	7	4	11	0	0	11	0	0
9	27966379	.	T	C	4	5	9	0	0	9	0	0
9	27967351	.	T	C	4	3	7	0	0	7	0	0
9	27975589	.	G	A	3	6	9	0	0	9	0	0
9	28115886	.	A	G	11	0	11	0	6	17	0	0
9	28115901	.	A	G	9	5	14	0	6	20	0	0
9	28116064	.	T	C	10	12	22	0	1	23	0	0
9	28124661	.	G	A	8	7	15	0	1	16	0	0
9	28124775	.	A	G	14	0	14	0	17	31	0	0
9	28127334	.	A	G	11	0	11	0	17	28	0	0
9	28127471	.	A	G	12	9	21	0	5	26	0	0
9	28127513	.	A	C	13	9	22	0	0	22	0	0
9	28127532	.	A	C	8	6	14	0	1	15	0	0
9	28127573	.	A	G	11	6	17	0	0	17	0	0
9	28150855	.	G	C	5	7	12	0	0	12	0	0
9	28150896	.	C	T	4	2	6	0	0	6	0	0
9	28150987	.	G	T	2	5	7	0	0	7	0	0
9	28151141	.	C	T	2	5	7	0	0	7	0	0
9	28160479	.	T	C	1	2	3	0	0	3	0	0
9	28160821	.	C	T	5	9	14	0	0	14	0	0
9	28195905	.	T	A	2	5	7	0	0	7	0	0
9	28195920	.	G	A	2	3	5	0	0	5	0	0
9	28204464	.	C	A	5	8	13	0	0	13	0	0
9	28204594	.	C	T	2	3	5	0	1	7	1	0
9	28204698	.	C	T	0	3	3	0	1	4	0	0
9	28204700	.	A	G	0	3	3	0	1	4	0	0
9	28204872	.	T	A	3	4	7	0	1	8	0	0
9	28205342	.	G	A	2	2	4	0	0	4	0	0
9	28205357	.	T	A	2	2	4	0	0	4	0	0
9	28205432	.	A	G	3	2	5	0	0	5	0	0
9	28205464	.	G	A	1	2	3	0	0	3	0	0
9	28205703	.	T	C	1	4	5	0	0	5	0	0
9	28205743	.	T	C	2	4	6	0	0	6	0	0
9	28205786	.	C	A	4	2	6	0	1	7	0	0
9	28206947	.	A	T	3	5	8	0	0	8	0	0
9	28207024	.	A	G	2	6	8	0	0	8	0	0
9	28207339	.	T	A	2	4	6	0	0	6	0	0
9	28238302	.	C	T	11	13	24	0	0	24	0	0
9	28238305	.	C	T	2	14	16	0	11	27	0	0
9	28245874	.	G	A	11	17	28	0	2	30	0	0
9	28254633	.	C	T	9	16	25	0	1	26	0	0
9	28254783	.	C	T	0	10	10	0	17	27	0	0
9	28254810	.	G	A	10	10	20	0	1	21	0	0
9	28254909	.	G	A	5	5	10	1	1	12	0	0
9	28263971	.	C	T	13	7	20	0	0	20	0	0
9	28264469	.	T	C	9	0	9	0	10	19	0	0
9	28267158	.	G	A	10	15	25	0	2	27	0	0
9	28268543	.	G	A	9	15	24	0	1	25	0	0
9	28270529	.	A	C	7	0	7	0	5	12	0	0
9	28271181	.	T	C	13	7	20	0	1	21	0	0
9	28341330	.	C	A	0	3	3	0	7	10	0	0
9	28341337	.	G	A	6	2	8	0	1	9	0	0
9	28341382	.	G	A	10	4	14	0	1	15	0	0
9	28341591	.	C	A	12	16	28	1	1	30	0	0
9	28341593	.	T	A	12	16	28	1	0	29	0	0
9	28342963	.	G	A	10	12	22	0	1	23	0	0
9	28343054	.	G	A	14	14	28	0	0	28	0	0
9	28343100	.	A	G	9	13	22	0	0	22	0	0
9	28343121	.	T	G	10	17	27	0	0	27	0	0
9	28343549	.	C	T	6	4	10	0	0	10	0	0
9	28343590	.	G	A	5	5	10	0	0	10	0	0
9	28343629	.	C	T	5	6	11	0	1	12	0	0
9	28344026	.	T	C	6	8	14	0	0	14	0	0
9	28344126	.	A	C	9	12	21	0	0	21	0	0
9	28344320	.	T	G	9	3	12	5	1	18	0	0
9	28344453	.	G	A	7	4	11	1	1	13	0	0
9	28345531	.	T	C	13	11	24	2	2	28	0	0
9	28363208	.	G	A	12	10	22	0	0	22	0	0
9	28398942	.	G	C	8	6	14	0	0	14	0	0
9	28688956	.	C	G	8	0	8	0	7	15	0	0
9	28688965	.	A	G	11	5	16	0	0	16	0	0
9	28689032	.	G	A	13	10	23	0	0	23	0	0
9	28689033	.	C	A	10	10	20	0	2	22	0	0
9	28691645	.	T	C	5	4	9	0	2	11	0	0
9	28693734	.	A	T	2	2	4	0	0	4	0	0
9	28693737	.	C	T	2	2	4	0	0	4	0	0
9	28696610	.	A	C	3	11	14	0	0	14	0	0
9	28696643	.	A	G	3	5	8	0	1	9	0	0
9	28816388	.	C	T	2	2	4	0	0	4	0	0
9	28816407	.	T	G	2	2	4	0	0	4	0	0
9	28818498	.	A	T	7	7	14	0	1	15	0	0
9	28839811	.	T	C	5	7	12	0	1	13	0	0
9	28839859	.	G	A	7	10	17	0	1	18	0	0
9	28839879	.	T	A	9	12	21	0	1	22	0	0
9	28867390	.	T	C	12	0	12	0	7	19	0	0
9	28867421	.	A	C	6	4	10	0	0	10	0	0
9	28867426	.	A	C	6	4	10	0	0	10	0	0
9	28867459	.	C	T	6	4	10	0	1	11	0	0
9	28867555	.	G	A	2	5	7	0	0	7	0	0
9	28871367	.	A	T	3	4	7	0	0	7	0	0
9	28872253	.	T	G	2	4	6	0	2	8	0	0
9	28872341	.	G	A	6	3	9	0	1	10	0	0
9	28875319	.	C	T	8	6	14	0	1	15	0	0
9	28879348	.	C	T	8	9	17	0	3	20	0	0
9	28889977	.	T	C	4	5	9	0	0	9	0	0
9	28890020	.	A	C	4	2	6	0	0	6	0	0
9	28919301	.	A	T	1	3	4	0	0	4	0	0
9	28922866	.	G	A	3	4	7	0	0	7	0	0
9	28940998	.	G	A	8	12	20	0	0	20	0	0
9	28941003	.	T	C	8	0	8	0	11	19	0	0
9	28941061	.	A	C	6	15	21	0	0	21	0	0
9	28941179	.	A	G	8	5	13	0	0	13	0	0
9	28941189	.	G	A	7	4	11	0	2	13	0	0
9	28941234	.	C	T	9	5	14	0	0	14	0	0
9	28941414	.	A	G	17	6	23	0	2	25	0	0
9	28941446	.	A	G	13	12	25	0	2	27	0	0
9	28941488	.	T	A	13	10	23	0	0	23	0	0
9	28941498	.	C	G	13	8	21	0	1	22	0	0
9	28941629	.	G	A	5	4	9	0	0	9	0	0
9	28941630	.	G	A	5	4	9	0	0	9	0	0
9	28941684	.	C	G	6	3	9	0	1	10	0	0
9	28941709	.	G	C	6	3	9	0	0	9	0	0
9	28941723	.	A	G	6	3	9	0	0	9	0	0
9	28941795	.	C	T	4	4	8	0	0	8	0	0
9	28941832	.	A	G	5	7	12	0	0	12	0	0
9	28941879	.	A	T	3	2	5	0	0	5	0	0
9	28941897	.	T	G	2	3	5	0	0	5	0	0
9	28942018	.	G	A	7	3	10	0	0	10	0	0
9	28942111	.	A	G	3	3	6	0	0	6	0	0
9	28942542	.	T	A	11	11	22	0	2	24	0	0
9	28942553	.	T	A	14	8	22	0	1	23	0	0
9	28946132	.	A	T	13	13	26	0	0	26	0	0
9	28952959	.	G	A	7	7	14	0	0	14	0	0
9	28955543	.	A	G	7	7	14	0	2	16	0	0
9	28964849	.	C	A	12	13	25	0	0	25	0	0
9	28967048	.	A	G	12	6	18	0	0	18	0	0
9	28972347	.	A	C	4	5	9	0	0	9	0	0
9	28983790	.	C	A	0	7	7	0	6	13	0	0
9	28989543	.	C	T	6	4	10	0	2	12	0	0
9	28989549	.	G	A	5	5	10	0	1	11	0	0
9	29029545	.	T	A	5	3	8	0	1	9	0	0
9	29029761	.	A	G	3	3	6	0	0	6	0	0
9	29035572	.	T	C	6	7	13	0	0	13	0	0
9	29035575	.	A	G	6	6	12	0	0	12	0	0
9	29035614	.	A	C	2	3	5	0	1	6	0	0
9	29035744	.	A	T	1	2	3	0	0	3	0	0
9	29035776	.	T	C	5	3	8	0	0	8	0	0
9	29035977	.	A	G	2	3	5	0	0	5	0	0
9	29036073	.	G	A	7	3	10	0	0	10	0	0
9	29036245	.	A	G	4	6	10	0	1	11	0	0
9	29040544	.	G	A	5	3	8	0	0	8	0	0
9	29122231	.	T	G	2	4	6	0	1	7	0	0
9	29122536	.	T	A	1	7	8	0	0	9	1	0
9	29122725	.	C	T	4	5	9	0	0	9	0	0
9	29122849	.	A	G	6	4	10	0	0	10	0	0
9	29195268	.	A	G	2	1	3	0	1	4	0	0
9	29225281	.	G	A	2	5	7	0	0	7	0	0
9	29230754	.	A	G	7	3	10	0	0	10	0	0
9	29339133	.	G	C	3	5	8	0	0	8	0	0
9	29339139	.	A	T	3	6	9	0	1	10	0	0
9	29431764	.	A	G	3	0	3	0	5	8	0	0
9	29433347	.	C	T	2	3	5	0	0	5	0	0
9	29434622	.	T	C	3	2	5	0	0	5	0	0
9	29438398	.	C	T	4	3	7	0	0	7	0	0
9	29443370	.	C	A	3	3	6	0	0	6	0	0
9	29443840	.	T	C	3	5	8	0	0	9	1	0
9	29448320	.	A	G	2	6	8	0	0	8	0	0
9	29448372	.	T	G	5	12	17	0	1	18	0	0
9	29448703	.	T	G	2	0	2	0	7	9	0	0
9	29448727	.	C	A	4	4	8	0	0	8	0	0
9	29455415	.	T	C	4	4	8	0	1	9	0	0
9	29458550	.	A	C	3	3	6	0	0	6	0	0
9	29458562	.	T	C	3	3	6	0	0	6	0	0
9	29465051	.	C	T	4	3	7	0	0	7	0	0
9	29473879	.	T	A	7	9	16	0	0	16	0	0
9	29477021	.	G	C	6	10	16	0	1	17	0	0
9	29481518	.	T	C	10	7	17	0	0	17	0	0
9	29481708	.	A	G	6	4	10	0	1	11	0	0
9	29481732	.	A	G	5	4	9	0	0	9	0	0
9	29481747	.	G	A	0	7	7	0	5	12	0	0
9	29481795	.	T	C	3	7	10	0	0	10	0	0
9	29484238	.	G	A	4	4	8	0	1	9	0	0
9	29487130	.	C	T	3	4	7	0	0	7	0	0
9	29487163	.	C	T	5	4	9	0	0	9	0	0
9	29489797	.	A	G	8	4	12	0	0	12	0	0
9	29492571	.	A	G	1	3	4	0	0	4	0	0
9	29520819	.	A	G	14	13	27	0	5	32	0	0
9	29523552	.	T	G	13	0	13	0	12	25	0	0
9	29602959	.	T	C	10	7	17	0	2	19	0	0
9	29607543	.	C	T	11	12	23	0	0	23	0	0
9	29615087	.	C	G	14	22	36	0	1	37	0	0
9	29615238	.	T	A	15	12	27	1	1	29	0	0
9	29615575	.	C	T	16	8	24	0	0	24	0	0
9	29647469	.	G	A	37	19	56	0	1	57	0	0
9	29647470	.	C	T	34	19	53	0	2	55	0	0
9	29649571	.	C	A	24	19	43	0	2	45	0	0
9	29731041	.	T	C	10	18	28	0	2	30	0	0
9	29992145	.	A	G	5	0	5	0	12	17	0	0
9	29992332	.	G	A	4	3	7	0	0	7	0	0
9	30028016	.	C	T	0	8	8	0	6	14	0	0
9	30028056	.	T	C	2	0	2	0	6	8	0	0
9	30048300	.	G	C	1	4	5	0	0	5	0	0
9	30105956	.	G	A	3	4	7	0	0	7	0	0
9	30106009	.	G	A	7	9	16	1	0	17	0	0
9	30106090	.	T	A	2	2	4	0	0	4	0	0
9	30107428	.	C	T	1	6	7	1	0	8	0	0
9	30108779	.	T	C	11	6	17	0	0	17	0	0
9	30110026	.	T	C	8	4	12	0	0	12	0	0
9	30110217	.	T	C	11	8	19	0	0	19	0	0
9	30112544	.	A	G	15	0	15	0	25	40	0	0
9	30114853	.	A	G	11	12	23	0	1	24	0	0
9	30121155	.	C	A	20	19	39	1	1	41	0	0
9	30121167	.	C	T	15	16	31	1	3	35	0	0
9	30126136	.	A	G	32	0	32	0	24	56	0	0
9	30128084	.	C	G	31	24	55	0	1	56	0	0
9	30128085	.	C	T	33	23	56	0	1	57	0	0
9	30218140	.	C	T	4	6	10	0	0	10	0	0
9	30218310	.	G	A	3	4	7	0	2	9	0	0
9	30218323	.	A	G	3	6	9	0	0	9	0	0
9	30220931	.	C	T	3	2	5	0	0	5	0	0
9	30220968	.	T	A	6	7	13	0	0	13	0	0
9	30220975	.	C	T	6	7	13	0	0	13	0	0
9	30226583	.	T	C	4	0	4	0	6	10	0	0
9	30231309	.	G	A	3	4	7	0	0	7	0	0
9	30231360	.	A	C	1	0	1	0	3	4	0	0
9	30231557	.	A	G	2	4	6	0	0	6	0	0
9	30231586	.	A	G	1	4	5	0	1	6	0	0
9	30231616	.	T	C	1	0	1	0	3	4	0	0
9	30231659	.	A	T	3	1	4	0	1	5	0	0
9	30231664	.	C	T	0	3	3	0	3	6	0	0
9	30233169	.	A	T	2	2	4	0	1	5	0	0
9	30233386	.	T	C	1	5	6	0	1	7	0	0
9	30236090	.	A	C	3	5	8	0	1	9	0	0
9	30236303	.	A	G	2	2	4	0	0	4	0	0
9	30236417	.	C	A	0	2	2	0	6	8	0	0
9	30240979	.	A	G	2	6	8	0	0	8	0	0
9	30249039	.	C	T	0	3	3	0	2	6	1	0
9	30251977	.	A	G	3	3	6	0	0	6	0	0
9	30259418	.	C	G	5	3	8	0	0	8	0	0
9	30316447	.	C	T	1	2	3	0	0	3	0	0
9	30326347	.	G	A	12	7	19	0	0	19	0	0
9	30326377	.	A	G	9	7	16	0	1	17	0	0
9	30340154	.	A	G	9	9	18	0	0	18	0	0
9	30342030	.	T	C	3	0	3	0	8	11	0	0
9	30342072	.	T	C	1	0	1	0	5	6	0	0
9	30344279	.	A	G	5	15	20	0	0	20	0	0
9	30346237	.	T	C	8	5	13	0	0	13	0	0
9	30346243	.	T	G	8	4	12	0	0	12	0	0
9	30375117	.	A	C	3	5	8	0	0	8	0	0
9	30375261	.	A	G	1	2	3	0	0	3	0	0
9	30375391	.	T	C	4	3	7	0	0	7	0	0
9	30375470	.	A	T	14	6	20	0	0	20	0	0
9	30377562	.	C	T	0	5	5	0	3	8	0	0
9	30377582	.	G	T	3	4	7	0	0	7	0	0
9	30381921	.	A	C	3	1	4	0	4	8	0	0
9	30384860	.	T	C	3	2	5	0	0	5	0	0
9	30384865	.	A	T	3	2	5	0	0	5	0	0
9	30384952	.	C	A	2	2	4	0	0	4	0	0
9	30424220	.	G	A	1	2	3	0	0	3	0	0
9	30484621	.	C	A	3	5	8	0	2	10	0	0
9	30489813	.	A	G	6	2	8	0	0	8	0	0
9	30490106	.	G	A	1	3	4	0	0	4	0	0
9	30490669	.	G	A	9	3	12	0	1	13	0	0
9	30490673	.	A	G	10	3	13	0	0	13	0	0
9	30490949	.	G	T	8	4	12	0	0	12	0	0
9	30491053	.	T	C	5	6	11	0	0	11	0	0
9	30491197	.	G	A	4	3	7	0	0	7	0	0
9	30491560	.	C	T	1	8	9	0	6	15	0	0
9	30494225	.	T	C	7	6	13	0	0	13	0	0
9	30494498	.	C	G	2	8	10	0	6	16	0	0
9	30494839	.	A	G	6	9	15	0	0	15	0	0
9	30494854	.	T	A	6	8	14	0	1	15	0	0
9	30494965	.	G	A	13	5	18	0	1	19	0	0
9	30495139	.	C	T	1	10	11	0	9	20	0	0
9	30496325	.	C	T	3	6	9	0	1	10	0	0
9	30496377	.	A	G	7	4	11	0	0	11	0	0
9	30496436	.	A	G	8	4	12	0	0	12	0	0
9	30496446	.	G	T	8	3	11	0	0	11	0	0
9	30496952	.	A	G	6	2	8	0	0	8	0	0
9	30562611	.	T	C	1	5	6	0	0	6	0	0
9	30562689	.	A	T	5	2	7	0	1	8	0	0
9	30562911	.	T	A	4	3	7	0	0	7	0	0
9	30562947	.	A	G	7	3	10	0	0	10	0	0
9	30563034	.	A	T	2	4	6	0	0	6	0	0
9	30563056	.	C	T	2	2	4	0	1	5	0	0
9	30563126	.	C	T	3	2	5	0	0	5	0	0
9	30563541	.	T	C	5	0	5	0	3	8	0	0
9	30565867	.	G	A	4	4	8	0	2	10	0	0
9	30566872	.	T	C	4	5	9	0	2	11	0	0
9	30566878	.	G	T	5	6	11	0	0	11	0	0
9	30578018	.	A	G	3	4	7	0	0	7	0	0
9	30578122	.	C	G	3	2	5	0	0	5	0	0
9	30581779	.	G	C	6	15	21	0	0	21	0	0
9	30581942	.	C	T	9	8	17	0	0	17	0	0
9	30599935	.	G	A	2	4	6	0	0	6	0	0
9	30599954	.	G	A	0	3	3	0	4	7	0	0
9	30628808	.	T	A	1	3	4	0	0	4	0	0
9	30636682	.	A	G	0	2	2	0	1	3	0	0
9	30636727	.	T	C	1	5	6	0	0	6	0	0
9	30638865	.	A	G	2	2	4	0	0	4	0	0
9	30638922	.	A	G	2	2	4	0	1	5	0	0
9	30639047	.	A	T	4	2	6	0	0	6	0	0
9	30639079	.	T	C	4	2	6	0	0	6	0	0
9	30639191	.	C	G	2	3	5	0	0	5	0	0
9	30764489	.	A	T	5	3	8	0	0	8	0	0
9	30780786	.	G	A	0	4	4	0	4	8	0	0
9	30780813	.	A	G	3	6	9	0	0	9	0	0
9	30783316	.	T	C	9	2	11	0	0	11	0	0
9	30783321	.	A	T	8	3	11	0	0	11	0	0
9	30783661	.	A	G	5	3	8	0	0	8	0	0
9	30783676	.	C	T	7	2	9	0	0	9	0	0
9	30783828	.	A	T	4	2	6	0	2	8	0	0
9	30806492	.	A	G	7	4	11	0	0	11	0	0
9	30806642	.	G	T	6	5	11	0	0	11	0	0
9	30806662	.	T	G	4	7	11	0	0	11	0	0
9	30807902	.	T	C	7	3	10	0	0	10	0	0
9	30807944	.	C	T	4	12	16	0	0	16	0	0
9	30990731	.	T	C	9	6	15	0	1	16	0	0
9	30990845	.	A	G	12	12	24	0	1	25	0	0
9	31042584	.	T	C	25	16	41	1	1	43	0	0
9	31062518	.	T	A	17	14	31	0	0	32	1	0
9	31062588	.	G	A	23	13	36	0	1	37	0	0
9	31062589	.	G	A	24	14	38	0	0	38	0	0
9	31167733	.	C	T	1	2	3	0	1	4	0	0
9	31214307	.	T	G	10	6	16	0	0	16	0	0
9	31214442	.	A	C	4	5	9	0	1	10	0	0
9	31239258	.	A	G	4	0	4	1	6	11	0	0
9	31248923	.	C	T	9	13	22	0	1	23	0	0
9	31258832	.	G	A	12	6	18	0	0	18	0	0
9	31268856	.	G	T	4	3	7	0	0	7	0	0
9	31274993	.	T	C	14	0	14	1	12	27	0	0
9	31276912	.	C	T	20	17	37	0	3	40	0	0
9	31510724	.	T	A	7	7	14	0	0	14	0	0
9	31524405	.	G	A	5	5	10	0	0	10	0	0
9	31524406	.	T	C	5	5	10	0	0	10	0	0
9	31524633	.	G	T	4	3	7	0	0	7	0	0
9	31524956	.	C	A	4	7	11	0	0	11	0	0
9	31540855	.	T	C	1	2	3	0	0	3	0	0
9	31556806	.	T	C	2	2	4	0	0	4	0	0
9	31586434	.	G	A	1	5	6	0	0	6	0	0
9	31595634	.	C	T	21	21	42	0	2	44	0	0
9	31604943	.	G	A	11	10	21	0	0	21	0	0
9	31605235	.	A	G	18	7	25	0	0	25	0	0
9	31605281	.	C	A	2	7	9	0	15	24	0	0
9	31606333	.	C	T	12	9	21	0	1	22	0	0
9	31612184	.	C	T	7	12	19	0	0	19	0	0
9	31617687	.	A	G	8	12	20	0	0	20	0	0
9	31619998	.	A	G	9	11	20	0	0	20	0	0
9	31639107	.	C	T	0	9	9	0	11	20	0	0
9	31715887	.	A	G	10	6	16	0	1	17	0	0
9	31716932	.	G	A	12	9	21	0	2	23	0	0
9	31735673	.	A	G	10	8	18	0	1	19	0	0
9	31735676	.	A	C	10	8	18	0	0	18	0	0
9	31736102	.	G	A	5	10	15	0	1	16	0	0
9	32169182	.	A	G	24	26	50	0	1	51	0	0
9	32169287	.	G	A	28	24	52	0	4	56	0	0
9	32187866	.	A	T	6	4	10	0	0	10	0	0
9	32286858	.	C	T	3	3	6	0	2	8	0	0
9	32287162	.	A	G	15	11	26	0	2	28	0	0
9	32287208	.	A	C	16	18	34	0	0	34	0	0
9	32287418	.	A	G	17	15	32	0	1	33	0	0
9	32287419	.	A	G	17	16	33	0	0	33	0	0
9	32287481	.	T	C	16	15	31	0	2	33	0	0
9	32287688	.	A	G	18	18	36	0	2	38	0	0
9	32289064	.	C	A	2	18	20	0	18	38	0	0
9	32289281	.	G	A	25	13	38	0	2	40	0	0
9	32290957	.	G	A	18	15	33	0	0	33	0	0
9	32297376	.	G	A	8	11	19	0	0	19	0	0
9	32297472	.	T	C	16	12	28	0	2	30	0	0
9	32297487	.	C	T	19	15	34	0	0	34	0	0
9	32301503	.	G	A	1	2	3	0	0	3	0	0
9	32304476	.	G	A	12	5	17	0	0	17	0	0
9	32304643	.	C	T	3	2	5	0	0	6	1	0
9	32304655	.	A	G	3	2	5	0	0	5	0	0
9	32304951	.	T	G	2	4	6	0	0	6	0	0
9	32307717	.	T	C	25	23	48	0	0	48	0	0
9	32308523	.	A	C	17	20	37	0	0	37	0	0
9	32312472	.	C	T	32	27	59	0	0	59	0	0
9	32312600	.	A	G	25	0	25	0	22	47	0	0
9	32312683	.	C	A	14	15	29	0	0	29	0	0
9	32313260	.	T	C	6	4	10	0	0	10	0	0
9	32313626	.	C	T	7	5	12	0	1	13	0	0
9	32313689	.	A	G	6	4	10	0	0	10	0	0
9	32313875	.	G	T	9	5	14	0	0	14	0	0
9	32313964	.	G	A	7	5	12	0	0	12	0	0
9	32316788	.	G	T	4	2	6	0	0	6	0	0
9	32320286	.	T	C	4	4	8	0	0	8	0	0
9	32343547	.	T	A	4	2	6	0	0	6	0	0
9	32343562	.	T	A	4	2	6	0	0	6	0	0
9	32432199	.	T	G	3	0	3	1	6	10	0	0
9	32432613	.	T	A	6	2	8	0	0	8	0	0
9	32432640	.	A	G	8	4	12	0	0	12	0	0
9	32433925	.	C	T	12	10	22	0	0	22	0	0
9	32433957	.	A	T	7	10	17	0	0	17	0	0
9	32434098	.	T	G	10	4	14	0	1	15	0	0
9	32435052	.	G	A	10	6	16	0	0	16	0	0
9	32435121	.	T	A	10	5	15	0	0	15	0	0
9	32435127	.	T	A	8	4	12	0	0	12	0	0
9	32435256	.	T	G	9	6	15	0	2	17	0	0
9	32441761	.	A	G	11	0	11	0	15	26	0	0
9	32441800	.	T	C	15	10	25	0	0	25	0	0
9	32457192	.	C	T	21	18	39	0	1	40	0	0
9	32641131	.	T	A	3	7	10	0	0	10	0	0
9	32641175	.	T	G	6	11	17	0	0	17	0	0
9	32641278	.	A	T	6	10	16	0	0	16	0	0
9	32641294	.	G	T	5	13	18	0	1	19	0	0
9	32641424	.	G	A	11	6	17	0	2	19	0	0
9	32641442	.	G	C	10	8	18	0	1	19	0	0
9	32641548	.	T	A	8	7	15	0	0	15	0	0
9	32641600	.	A	G	6	10	16	0	0	16	0	0
9	32641682	.	A	G	3	17	20	0	1	21	0	0
9	32641731	.	C	A	9	9	18	0	1	19	0	0
9	32641737	.	A	G	10	9	19	0	1	20	0	0
9	32641802	.	T	C	14	10	24	0	0	24	0	0
9	32641805	.	A	G	12	9	21	0	1	22	0	0
9	32642342	.	A	G	7	20	27	0	1	28	0	0
9	32643643	.	G	A	8	15	23	0	0	23	0	0
9	32645615	.	G	C	14	18	32	0	1	33	0	0
9	32645939	.	T	C	13	10	23	0	2	25	0	0
9	32649147	.	C	T	4	4	8	0	0	8	0	0
9	32651241	.	A	T	5	6	11	0	1	12	0	0
9	32651527	.	C	A	3	4	7	0	0	7	0	0
9	32651648	.	A	G	4	4	8	0	0	8	0	0
9	32651665	.	T	C	6	7	13	0	0	13	0	0
9	32651826	.	T	C	4	5	9	0	0	9	0	0
9	32652072	.	T	C	1	2	3	0	1	4	0	0
9	32681804	.	A	T	2	3	5	0	0	5	0	0
9	32681877	.	A	C	2	6	8	0	0	8	0	0
9	32681880	.	A	C	2	4	6	0	2	8	0	0
9	32728969	.	A	G	12	10	22	0	1	23	0	0
9	32728984	.	C	A	9	8	17	0	2	19	0	0
9	32729022	.	T	C	6	6	12	0	2	14	0	0
9	32729072	.	G	A	4	11	15	0	0	15	0	0
9	32729183	.	T	G	4	7	11	0	0	11	0	0
9	32729908	.	C	A	4	8	12	0	1	13	0	0
9	32751579	.	A	G	3	6	9	0	0	9	0	0
9	32751640	.	A	G	11	11	22	0	0	22	0	0
9	32751812	.	A	G	13	14	27	0	0	27	0	0
9	32751825	.	C	T	12	14	26	0	0	26	0	0
9	32752272	.	C	T	22	19	41	0	1	42	0	0
9	32752555	.	C	T	22	18	40	0	4	44	0	0
9	32752794	.	A	C	20	0	20	0	18	38	0	0
9	32752824	.	G	T	15	24	39	0	1	40	0	0
9	32752864	.	G	T	15	21	36	0	1	37	0	0
9	32752995	.	T	C	11	16	27	0	1	28	0	0
9	32753016	.	C	G	16	20	36	0	0	36	0	0
9	32804802	.	C	T	11	9	20	0	1	21	0	0
9	32804898	.	C	A	0	5	5	0	7	12	0	0
9	32860395	.	A	C	7	3	10	0	1	11	0	0
9	32860396	.	A	C	7	4	11	0	0	11	0	0
9	32863357	.	G	A	7	5	12	0	0	12	0	0
9	32863381	.	T	C	4	3	7	0	0	7	0	0
9	32870757	.	G	A	7	5	12	0	0	12	0	0
9	32870793	.	A	G	4	4	8	0	0	8	0	0
9	32870886	.	T	C	3	4	7	0	0	7	0	0
9	32870922	.	T	C	5	4	9	0	0	9	0	0
9	32871441	.	A	G	6	2	8	0	0	8	0	0
9	32871509	.	A	G	10	5	15	0	1	16	0	0
9	32871514	.	T	C	11	5	16	0	0	16	0	0
9	32871562	.	G	A	8	3	11	0	0	11	0	0
9	32872881	.	G	A	4	7	11	0	0	11	0	0
9	32872932	.	T	C	5	6	11	0	1	12	0	0
9	32873025	.	G	A	4	5	9	0	0	9	0	0
9	32873040	.	C	T	6	6	12	0	0	12	0	0
9	32873064	.	T	C	6	4	10	0	0	10	0	0
9	32873127	.	G	T	3	6	9	0	0	9	0	0
9	32873151	.	G	A	1	4	5	0	3	8	0	0
9	32873544	.	G	T	2	12	14	0	17	31	0	0
9	32873788	.	C	A	7	6	13	0	1	14	0	0
9	32873792	.	C	A	8	6	14	0	2	16	0	0
9	32873834	.	A	T	10	10	20	0	0	20	0	0
9	32873940	.	G	A	7	8	15	0	0	15	0	0
9	32874222	.	T	G	10	12	22	0	0	22	0	0
9	32874603	.	G	A	1	9	10	0	11	21	0	0
9	32895294	.	A	T	4	4	8	0	0	8	0	0
9	32895297	.	T	C	3	0	3	0	5	8	0	0
9	32897304	.	C	T	8	6	14	0	0	14	0	0
9	32899796	.	C	T	9	7	16	0	1	17	0	0
9	32900000	.	T	C	2	0	2	0	8	10	0	0
9	32900267	.	C	T	0	10	10	0	7	17	0	0
9	32900453	.	A	G	13	11	24	0	0	24	0	0
9	32900628	.	G	A	9	7	16	0	1	17	0	0
9	32900768	.	A	G	8	4	12	0	0	12	0	0
9	32900849	.	G	A	14	10	24	0	0	24	0	0
9	32901173	.	A	G	6	12	18	0	0	18	0	0
9	32901176	.	T	A	6	11	17	0	1	18	0	0
9	32901275	.	G	A	7	8	15	0	1	16	0	0
9	32909664	.	T	C	11	4	15	0	1	16	0	0
9	32909683	.	A	G	8	4	12	0	0	12	0	0
9	32912464	.	A	G	3	4	7	0	0	7	0	0
9	32980561	.	T	A	4	4	8	0	0	8	0	0
9	32980971	.	G	A	2	3	5	0	0	5	0	0
9	32981252	.	C	T	4	10	14	0	1	15	0	0
9	32981302	.	C	T	3	5	8	0	1	9	0	0
9	32981317	.	T	C	1	6	7	0	1	8	0	0
9	33411227	.	C	A	12	13	25	0	0	25	0	0
9	33411228	.	A	G	11	13	24	0	0	24	0	0
9	33661399	.	A	G	11	15	26	0	0	26	0	0
9	33661424	.	G	A	12	10	22	0	2	24	0	0
9	33661645	.	A	T	10	6	16	0	1	17	0	0
9	33661691	.	A	T	9	3	12	0	0	12	0	0
9	33661714	.	G	A	5	5	10	0	1	11	0	0
9	33661765	.	C	T	8	8	16	0	1	17	0	0
9	33661773	.	A	C	9	8	17	0	0	17	0	0
9	33661939	.	T	A	13	9	22	0	2	24	0	0
9	33662043	.	A	G	6	4	10	0	0	10	0	0
9	33662134	.	C	T	13	3	16	0	2	18	0	0
9	33662158	.	A	G	12	8	20	0	0	20	0	0
9	33662175	.	T	G	12	10	22	0	0	22	0	0
9	33662223	.	A	T	10	6	16	1	0	17	0	0
9	33662250	.	A	T	5	7	12	1	0	13	0	0
9	33662273	.	A	C	5	7	12	1	0	13	0	0
9	33663176	.	T	A	6	4	10	0	1	11	0	0
9	33663300	.	G	A	7	13	20	0	0	20	0	0
9	33663331	.	A	G	8	13	21	0	0	21	0	0
9	33663455	.	A	G	10	14	24	0	0	24	0	0
9	33663816	.	T	C	8	1	9	0	5	14	0	0
9	33669020	.	C	A	10	13	23	0	1	24	0	0
9	33678095	.	G	A	7	11	18	0	2	20	0	0
9	33678124	.	A	G	11	8	19	0	3	22	0	0
9	33678164	.	T	G	8	11	19	0	0	19	0	0
9	33678191	.	T	C	5	0	5	0	7	12	0	0
9	33741738	.	C	T	2	2	4	0	1	5	0	0
9	33783800	.	A	T	7	7	14	0	0	14	0	0
9	33783822	.	T	A	10	6	16	0	1	17	0	0
9	33783956	.	T	C	28	18	46	0	2	48	0	0
9	33784689	.	T	G	30	23	53	0	5	59	1	0
9	33816267	.	C	T	5	6	11	0	0	11	0	0
9	33816289	.	C	T	7	7	14	0	0	14	0	0
9	33853510	.	A	G	7	0	7	0	13	20	0	0
9	33857776	.	C	T	8	7	15	0	1	16	0	0
9	33858088	.	G	A	7	9	16	0	1	17	0	0
9	33858111	.	T	C	8	10	18	0	0	18	0	0
9	33861813	.	A	T	2	3	5	0	0	5	0	0
9	33861865	.	C	T	11	4	15	0	4	19	0	0
9	34090223	.	G	C	4	5	9	0	1	10	0	0
9	34102431	.	G	A	2	2	4	0	0	4	0	0
9	34112636	.	G	A	1	1	2	0	1	3	0	0
9	34112981	.	T	C	4	4	8	0	0	8	0	0
9	34113008	.	A	T	6	3	9	0	2	11	0	0
9	34113140	.	G	A	2	2	4	0	1	5	0	0
9	34117293	.	A	C	5	6	11	0	0	11	0	0
9	34117578	.	C	G	5	4	9	0	2	11	0	0
9	34119936	.	A	G	4	7	11	0	0	11	0	0
9	34120207	.	T	A	2	4	6	0	0	6	0	0
9	34120732	.	C	T	0	2	2	0	3	5	0	0
9	34120863	.	C	A	4	3	7	0	1	9	1	0
9	34147568	.	A	G	2	3	5	0	1	6	0	0
9	34148871	.	A	G	2	2	4	0	0	4	0	0
9	34151616	.	T	A	2	3	5	0	0	5	0	0
9	34151666	.	G	T	2	4	6	0	2	8	0	0
9	34154365	.	T	G	4	0	4	0	4	8	0	0
9	34154428	.	A	C	3	4	7	0	0	7	0	0
9	34154515	.	T	C	3	2	5	0	0	5	0	0
9	34155005	.	T	G	6	2	8	0	0	8	0	0
9	34161749	.	G	A	4	7	11	0	0	11	0	0
9	34161933	.	C	T	2	4	6	1	1	8	0	0
9	34170057	.	G	A	15	8	23	0	0	23	0	0
9	34174561	.	C	T	7	11	18	0	0	18	0	0
9	34174682	.	G	A	6	9	15	0	1	16	0	0
9	34191597	.	G	A	9	8	17	0	0	17	0	0
9	34200253	.	T	A	6	9	15	0	0	15	0	0
9	34201156	.	G	A	6	4	10	0	1	11	0	0
9	34205537	.	A	G	7	5	12	0	0	12	0	0
9	34218953	.	A	G	2	3	5	0	0	5	0	0
9	34219058	.	G	T	6	7	13	0	1	14	0	0
9	34219241	.	A	G	12	8	20	0	0	20	0	0
9	34222113	.	C	T	24	16	40	0	2	42	0	0
9	34225055	.	A	G	18	18	36	0	1	37	0	0
9	34225316	.	G	C	23	21	44	0	1	45	0	0
9	34226884	.	G	A	19	27	46	0	1	47	0	0
9	34226960	.	A	C	21	26	47	0	1	48	0	0
9	34227016	.	A	T	13	20	33	0	2	35	0	0
9	34227020	.	C	G	15	19	34	0	1	35	0	0
9	34227054	.	C	T	10	16	26	0	1	27	0	0
9	34227074	.	C	A	9	13	22	0	1	23	0	0
9	34232612	.	G	T	8	4	12	0	0	12	0	0
9	34232672	.	T	C	6	2	8	0	0	8	0	0
9	34232718	.	G	T	5	4	9	0	0	9	0	0
9	34238849	.	C	T	9	5	14	0	0	14	0	0
9	34238858	.	C	A	10	7	17	0	0	17	0	0
9	34238915	.	T	C	6	7	13	0	0	13	0	0
9	34239119	.	T	C	3	3	6	0	0	6	0	0
9	34242397	.	T	C	4	2	6	0	1	7	0	0
9	34243122	.	G	C	5	7	12	0	1	13	0	0
9	34246473	.	G	A	5	2	7	0	1	8	0	0
9	34246524	.	G	A	11	7	18	0	1	19	0	0
9	34246555	.	T	G	6	10	16	0	0	16	0	0
9	34246628	.	G	A	8	4	12	0	0	12	0	0
9	34246710	.	G	A	10	5	15	0	2	17	0	0
9	34246932	.	A	G	11	13	24	0	1	25	0	0
9	34247356	.	G	A	17	6	23	0	0	23	0	0
9	34251632	.	G	A	14	9	23	0	2	25	0	0
9	34251707	.	C	G	18	9	27	0	0	28	1	0
9	34251752	.	G	A	14	8	22	0	2	24	0	0
9	34251764	.	G	A	18	8	26	0	1	27	0	0
9	34251963	.	A	G	15	13	28	0	0	28	0	0
9	34254678	.	A	G	12	8	20	0	0	20	0	0
9	34254685	.	G	A	11	10	21	0	0	21	0	0
9	34254851	.	A	G	14	7	21	0	1	22	0	0
9	34254896	.	G	A	11	8	19	0	1	20	0	0
9	34256016	.	A	C	13	7	20	0	0	20	0	0
9	34258384	.	A	G	11	9	20	0	1	21	0	0
9	34258565	.	T	G	5	13	18	0	0	18	0	0
9	34258580	.	C	T	0	8	8	0	9	17	0	0
9	34259406	.	T	A	11	8	19	0	0	19	0	0
9	34259418	.	T	A	10	10	20	0	0	20	0	0
9	34260164	.	C	T	6	4	10	0	1	11	0	0
9	34274698	.	A	G	2	2	4	0	0	4	0	0
9	34334173	.	T	G	14	0	14	0	12	26	0	0
9	34338283	.	C	T	9	9	18	0	1	19	0	0
9	34338325	.	G	A	5	8	13	0	1	14	0	0
9	34349379	.	T	C	11	8	19	0	0	19	0	0
9	34352271	.	G	A	11	6	17	0	0	17	0	0
9	34380503	.	T	A	12	23	35	0	0	35	0	0
9	34380525	.	T	A	14	21	35	0	3	38	0	0
9	34382946	.	A	T	18	22	40	0	1	41	0	0
9	34385183	.	A	G	7	14	21	0	1	22	0	0
9	34385396	.	A	G	18	0	18	1	19	38	0	0
9	34388882	.	G	A	9	14	23	0	1	24	0	0
9	34389101	.	C	G	5	14	19	0	1	20	0	0
9	34389288	.	T	G	9	16	25	0	0	25	0	0
9	34389299	.	T	G	10	0	10	0	14	24	0	0
9	34389427	.	C	T	14	11	25	0	1	26	0	0
9	34389602	.	A	G	12	0	12	0	24	36	0	0
9	34389666	.	A	G	8	14	22	0	3	26	1	0
9	34389701	.	A	T	11	15	26	0	0	26	0	0
9	34389704	.	G	C	9	13	22	0	3	25	0	0
9	34389743	.	G	T	8	12	20	0	0	22	2	0
9	34389748	.	A	C	9	16	25	0	0	25	0	0
9	34389791	.	A	G	7	6	13	0	0	13	0	0
9	34397996	.	G	A	1	3	4	0	7	11	0	0
9	34398163	.	T	C	5	3	8	0	0	8	0	0
9	34404827	.	C	T	7	5	12	0	0	12	0	0
9	34404830	.	T	G	7	5	12	0	0	12	0	0
9	34405078	.	A	T	2	6	8	0	1	9	0	0
9	34405155	.	A	G	3	5	8	0	1	9	0	0
9	34408154	.	C	T	4	3	7	0	0	7	0	0
9	34409576	.	C	T	6	10	16	0	0	16	0	0
9	34409578	.	G	A	6	9	15	0	1	16	0	0
9	34410156	.	G	A	5	6	11	0	0	11	0	0
9	34410237	.	T	C	10	8	18	0	0	18	0	0
9	34415308	.	T	C	7	11	18	0	1	19	0	0
9	34416575	.	A	T	6	9	15	0	0	15	0	0
9	34423397	.	C	A	10	7	17	1	3	21	0	0
9	34423415	.	T	A	6	12	18	0	0	18	0	0
9	34423468	.	T	A	6	5	11	0	0	11	0	0
9	34423474	.	A	G	5	0	5	0	8	13	0	0
9	34423822	.	T	A	2	3	5	0	0	5	0	0
9	34425920	.	C	T	4	13	17	0	0	17	0	0
9	34491034	.	C	A	3	6	9	0	0	9	0	0
9	34647349	.	T	C	17	16	33	0	0	33	0	0
9	34647352	.	G	A	18	16	34	0	1	35	0	0
9	34647415	.	A	G	13	0	13	0	16	29	0	0
9	34647427	.	A	C	17	12	29	0	0	29	0	0
9	34866579	.	T	G	16	12	28	0	1	29	0	0
9	34866684	.	T	A	11	7	18	0	1	19	0	0
9	34866888	.	C	T	14	17	31	0	1	32	0	0
9	34867007	.	C	A	1	15	16	0	17	33	0	0
9	34867015	.	T	C	17	3	20	0	15	35	0	0
9	34869699	.	A	G	20	21	41	0	1	42	0	0
9	34869813	.	G	A	14	21	35	0	0	35	0	0
9	34869945	.	G	A	21	12	33	0	2	35	0	0
9	34871796	.	G	C	21	9	30	0	1	31	0	0
9	34877024	.	G	A	2	3	5	0	0	5	0	0
9	34877042	.	G	A	2	3	5	0	0	5	0	0
9	34877074	.	C	T	2	2	4	0	0	4	0	0
9	34878371	.	T	C	2	2	4	0	0	4	0	0
9	34880471	.	T	C	1	3	4	0	0	4	0	0
9	34880634	.	G	A	2	2	4	0	0	4	0	0
9	34903218	.	T	G	27	20	47	0	0	47	0	0
9	34906337	.	C	G	23	31	54	0	1	55	0	0
9	34912626	.	A	T	23	20	43	0	1	44	0	0
9	34912695	.	T	C	20	0	20	0	19	39	0	0
9	34912895	.	T	A	19	25	44	0	1	45	0	0
9	34920149	.	A	G	4	2	6	0	1	7	0	0
9	34920395	.	G	A	5	6	11	0	0	11	0	0
9	34922898	.	A	G	4	3	7	0	0	7	0	0
9	34937099	.	G	A	2	2	4	0	1	5	0	0
9	34937145	.	C	G	2	2	4	0	0	4	0	0
9	34937154	.	A	T	2	2	4	0	0	4	0	0
9	34938795	.	C	T	6	9	15	0	0	15	0	0
9	34939336	.	A	G	14	14	28	0	2	30	0	0
9	34939800	.	T	C	14	5	19	0	2	21	0	0
9	34967565	.	A	G	6	7	13	0	0	13	0	0
9	34967647	.	C	T	4	5	9	0	0	9	0	0
9	34967649	.	C	T	3	5	8	0	0	8	0	0
9	34967733	.	A	G	7	5	12	0	0	12	0	0
9	34967743	.	A	C	6	7	13	0	1	14	0	0
9	34968005	.	A	G	1	2	3	0	0	3	0	0
9	35014847	.	C	G	5	3	8	0	2	10	0	0
9	35024459	.	G	C	1	3	4	0	10	14	0	0
9	35025183	.	C	T	4	7	11	0	0	11	0	0
9	35025243	.	A	T	1	6	7	0	0	7	0	0
9	35026736	.	T	A	34	28	62	0	2	64	0	0
9	35026941	.	T	C	32	29	61	0	3	64	0	0
9	35027262	.	A	G	34	28	62	0	3	65	0	0
9	35027309	.	T	C	36	1	37	0	30	67	0	0
9	35027333	.	A	G	37	23	60	0	2	62	0	0
9	35027365	.	G	T	40	25	65	0	3	68	0	0
9	35027371	.	G	T	39	26	65	0	4	69	0	0
9	35027402	.	G	A	43	26	69	0	2	71	0	0
9	35027549	.	T	G	34	27	61	1	0	62	0	0
9	35027705	.	G	A	27	3	30	0	1	39	8	0
9	35028086	.	T	C	48	9	57	0	27	84	0	0
9	35028282	.	T	C	45	4	49	0	34	83	0	0
9	35030977	.	G	A	30	30	60	1	4	65	0	0
9	35032640	.	A	G	35	32	67	0	2	69	0	0
9	35032643	.	A	G	32	30	62	0	6	68	0	0
9	35033347	.	C	T	39	22	61	0	5	66	0	0
9	35039175	.	T	C	33	32	65	0	4	69	0	0
9	35048839	.	G	C	32	37	69	0	2	71	0	0
9	35048840	.	A	C	30	37	67	0	3	70	0	0
9	35170671	.	G	A	10	12	22	0	0	22	0	0
9	35176030	.	A	G	23	22	45	0	0	45	0	0
9	35228165	.	G	A	19	11	30	0	0	30	0	0
9	35230740	.	G	A	17	10	27	0	0	27	0	0
9	35254679	.	G	A	12	10	22	0	0	22	0	0
9	35266330	.	C	T	2	10	12	1	11	24	0	0
9	35296835	.	C	T	7	13	20	0	0	20	0	0
9	35836674	.	T	G	2	8	10	0	0	10	0	0
9	35836721	.	T	A	6	7	13	0	0	13	0	0
9	35837194	.	C	G	9	0	9	0	10	19	0	0
9	35837404	.	C	A	10	8	18	0	0	18	0	0
9	35838477	.	T	A	18	10	28	0	1	29	0	0
9	35840713	.	G	A	5	4	9	0	1	10	0	0
9	35840782	.	T	C	11	10	21	0	0	21	0	0
9	35840900	.	T	A	21	7	28	0	6	34	0	0
9	35841279	.	G	T	6	6	12	0	0	12	0	0
9	35841282	.	A	G	6	6	12	0	0	12	0	0
9	35841663	.	G	T	9	9	18	0	1	19	0	0
9	35841879	.	T	A	17	8	25	0	2	27	0	0
9	35841994	.	A	G	6	4	10	0	1	11	0	0
9	35842164	.	T	A	8	7	15	0	0	15	0	0
9	35842209	.	G	T	3	10	13	0	0	14	1	0
9	35843866	.	C	T	3	4	7	0	0	7	0	0
9	35860982	.	G	A	12	8	20	0	0	20	0	0
9	35860983	.	A	T	12	8	20	0	0	20	0	0
9	35862184	.	A	T	17	13	30	0	1	31	0	0
9	35862299	.	G	A	16	12	28	0	2	30	0	0
9	35863132	.	C	T	19	17	36	0	2	38	0	0
9	35863555	.	T	C	15	18	33	0	2	35	0	0
9	35863603	.	T	C	16	17	33	0	0	33	0	0
9	35863798	.	C	T	21	23	44	0	2	46	0	0
9	35863968	.	A	T	12	11	23	0	1	25	1	0
9	35864155	.	A	T	10	8	18	0	1	19	0	0
9	35864210	.	C	T	12	5	17	0	0	17	0	0
9	35864266	.	C	A	7	7	14	0	1	15	0	0
9	35864277	.	C	T	4	8	12	0	0	12	0	0
9	35864356	.	A	G	2	4	6	0	0	6	0	0
9	35864416	.	A	C	1	4	5	0	0	5	0	0
9	35864486	.	C	T	2	5	7	0	2	9	0	0
9	35864565	.	A	G	9	4	13	0	0	13	0	0
9	35864598	.	C	T	5	5	10	0	1	11	0	0
9	35865073	.	C	T	17	14	31	0	2	33	0	0
9	35865162	.	G	T	13	4	17	0	3	20	0	0
9	35865270	.	C	G	18	13	31	0	1	32	0	0
9	35872993	.	A	T	8	4	12	0	0	12	0	0
9	35873884	.	A	G	2	5	7	0	0	7	0	0
9	35901598	.	G	C	5	5	10	0	0	10	0	0
9	35901654	.	T	A	7	14	21	0	2	23	0	0
9	35906533	.	C	A	1	4	5	0	0	5	0	0
9	35907553	.	C	T	11	10	21	0	0	21	0	0
9	35909794	.	T	C	6	15	21	0	0	21	0	0
9	35909842	.	A	G	6	16	22	0	0	22	0	0
9	35910390	.	C	G	18	16	34	0	0	34	0	0
9	35912447	.	A	T	8	9	17	0	1	18	0	0
9	35912459	.	G	A	7	9	16	0	1	17	0	0
9	35912661	.	G	C	10	11	21	0	0	21	0	0
9	35915327	.	C	A	10	9	19	0	1	20	0	0
9	35915548	.	C	T	10	20	30	0	0	30	0	0
9	35915557	.	G	A	1	18	19	0	12	31	0	0
9	35916518	.	T	G	18	25	43	0	3	46	0	0
9	35916786	.	G	A	16	22	38	0	2	40	0	0
9	35922046	.	T	G	13	26	39	2	1	42	0	0
9	35922115	.	T	C	4	12	16	0	2	18	0	0
9	36119175	.	A	G	7	4	11	0	0	11	0	0
9	36393805	.	C	T	1	2	3	0	0	3	0	0
9	36395397	.	A	T	1	2	3	0	1	4	0	0
9	36395421	.	T	C	1	2	3	0	0	3	0	0
9	36426844	.	G	C	1	2	3	0	0	3	0	0
9	36444285	.	C	T	3	3	6	0	0	6	0	0
9	36460573	.	C	T	2	2	4	0	0	4	0	0
9	36487835	.	T	C	2	2	4	0	0	4	0	0
9	36500551	.	G	A	0	3	3	0	3	6	0	0
9	36527309	.	G	A	1	2	3	0	0	3	0	0
9	36539660	.	T	C	1	6	7	0	0	7	0	0
9	36540309	.	C	T	1	2	3	0	0	3	0	0
9	36559940	.	C	T	4	3	7	0	0	7	0	0
9	36580205	.	A	G	2	3	5	0	0	5	0	0
9	36585992	.	G	A	1	5	6	0	6	12	0	0
9	36595278	.	G	A	2	2	4	0	0	4	0	0
9	36595536	.	G	A	1	3	4	0	0	4	0	0
9	36610163	.	T	C	3	3	6	0	0	6	0	0
9	36610202	.	C	T	3	2	5	0	1	6	0	0
9	36613178	.	C	T	4	4	8	0	1	9	0	0
9	36613202	.	C	T	5	3	8	0	0	8	0	0
9	36656011	.	A	G	8	4	12	0	0	12	0	0
9	36659702	.	T	G	7	7	14	0	0	14	0	0
9	36896761	.	C	A	0	4	4	0	4	8	0	0
9	36896791	.	C	T	4	5	9	0	0	9	0	0
9	36898724	.	C	T	10	13	23	2	1	26	0	0
9	36899065	.	C	T	0	10	10	0	8	18	0	0
9	36967506	.	T	C	4	3	7	0	0	7	0	0
9	36972858	.	A	G	2	0	2	0	3	5	0	0
9	36973515	.	G	A	3	2	5	0	0	5	0	0
9	36973751	.	T	C	3	5	8	0	0	8	0	0
9	36973841	.	C	G	2	1	3	0	1	4	0	0
9	36974170	.	G	T	4	3	7	0	0	7	0	0
9	36974191	.	T	C	4	4	8	0	0	8	0	0
9	36974233	.	A	T	6	5	11	0	1	12	0	0
9	36974460	.	C	T	2	3	5	0	0	5	0	0
9	37294435	.	A	G	1	3	4	0	0	4	0	0
9	37296075	.	T	G	4	2	6	0	0	6	0	0
9	37341551	.	T	C	1	2	3	0	0	3	0	0
9	37341554	.	T	C	1	2	3	0	0	3	0	0
9	37345228	.	T	C	1	2	3	0	0	3	0	0
9	37348530	.	A	G	2	2	4	0	0	4	0	0
9	37354360	.	C	T	0	2	2	0	2	4	0	0
9	37360840	.	A	C	1	2	3	0	0	3	0	0
9	37367358	.	A	G	6	7	13	0	0	13	0	0
9	37371515	.	A	T	6	5	11	0	0	11	0	0
9	37390314	.	C	T	10	8	18	0	0	18	0	0
9	37416605	.	C	T	6	12	18	0	0	18	0	0
9	37416617	.	C	T	4	13	17	0	0	17	0	0
9	37431935	.	G	A	0	4	4	0	11	15	0	0
9	37451809	.	A	G	12	12	24	0	3	27	0	0
9	37452012	.	A	T	14	11	25	0	1	26	0	0
9	37452223	.	C	T	5	6	11	0	1	12	0	0
9	37452432	.	G	A	10	11	21	0	0	21	0	0
9	37452499	.	T	G	15	9	24	0	0	24	0	0
9	37452515	.	G	T	13	12	25	0	1	26	0	0
9	37452616	.	T	G	16	8	24	0	0	24	0	0
9	37452790	.	T	A	9	3	12	0	1	13	0	0
9	37452819	.	G	C	10	3	13	0	1	14	0	0
9	37452862	.	T	C	8	6	14	0	0	14	0	0
9	37452924	.	C	G	3	9	12	0	1	13	0	0
9	37492798	.	G	A	4	8	12	0	0	12	0	0
9	37492807	.	A	G	4	6	10	0	2	12	0	0
9	37497510	.	C	T	1	3	4	0	4	8	0	0
9	37508255	.	T	C	4	5	9	0	0	9	0	0
9	37521992	.	A	G	1	3	4	0	0	4	0	0
9	37573890	.	C	G	1	4	5	0	0	5	0	0
9	37754913	.	G	A	1	4	5	0	0	5	0	0
9	37771849	.	A	G	4	3	7	0	0	7	0	0
9	37815520	.	A	T	5	2	7	0	2	9	0	0
9	37839770	.	G	A	0	2	2	0	2	4	0	0
9	37839776	.	A	T	3	1	4	0	0	4	0	0
9	37840024	.	G	T	5	2	7	0	0	7	0	0
9	37850479	.	G	C	5	4	9	0	1	10	0	0
9	37850559	.	T	A	9	4	13	0	0	13	0	0
9	37850574	.	A	G	7	0	7	0	4	11	0	0
9	37853970	.	A	C	10	4	14	0	0	14	0	0
9	37856541	.	C	T	9	12	21	0	1	22	0	0
9	37856895	.	T	A	7	8	15	0	2	17	0	0
9	37859807	.	G	T	12	11	23	0	3	26	0	0
9	37859881	.	T	G	13	12	25	0	1	26	0	0
9	37860116	.	T	C	5	5	10	1	2	13	0	0
9	37861560	.	A	G	2	1	3	0	6	9	0	0
9	37862065	.	T	G	3	0	3	0	7	10	0	0
9	37941602	.	C	T	6	5	11	0	1	12	0	0
9	38021242	.	C	T	3	6	9	0	0	9	0	0
9	38021291	.	A	T	2	3	5	0	0	5	0	0
9	38021487	.	T	C	4	3	7	0	6	13	0	0
9	38030131	.	A	T	21	11	32	0	0	32	0	0
9	38030366	.	A	T	12	5	17	0	3	20	0	0
9	38030485	.	A	T	10	8	18	0	0	18	0	0
9	38030503	.	C	T	0	7	7	0	13	20	0	0
9	38030574	.	G	A	8	11	19	0	0	19	0	0
9	38033363	.	T	C	7	0	7	0	17	24	0	0
9	38033578	.	A	G	17	14	31	0	2	33	0	0
9	38042752	.	G	A	7	9	16	0	0	16	0	0
9	38043476	.	T	C	4	5	9	0	0	9	0	0
9	38057075	.	A	G	2	5	7	0	1	8	0	0
9	38058608	.	T	C	7	7	14	1	0	15	0	0
9	38059042	.	C	T	6	4	10	0	0	10	0	0
9	38061311	.	G	A	8	7	15	0	0	15	0	0
9	38061525	.	G	T	1	13	14	0	9	23	0	0
9	38061699	.	T	C	10	9	19	0	0	19	0	0
9	38061788	.	T	C	16	10	26	0	0	26	0	0
9	38063688	.	C	A	11	11	22	0	0	22	0	0
9	38063689	.	C	A	10	11	21	0	1	22	0	0
9	38064165	.	A	T	3	8	11	0	0	11	0	0
9	38064268	.	T	C	4	3	7	0	1	8	0	0
9	38064420	.	T	G	4	6	10	0	1	11	0	0
9	38064421	.	C	A	4	7	11	0	0	11	0	0
9	38064672	.	A	C	5	4	9	0	1	10	0	0
9	38074140	.	A	T	1	5	6	0	0	6	0	0
9	38129312	.	C	G	5	6	11	0	0	11	0	0
9	38140963	.	C	A	0	2	2	0	2	4	0	0
9	38161177	.	A	G	2	0	2	0	9	11	0	0
9	38161842	.	C	T	2	4	6	0	0	6	0	0
9	38167747	.	T	G	7	4	11	0	0	11	0	0
9	38167761	.	G	A	8	3	11	0	1	12	0	0
9	38167782	.	G	A	6	2	8	0	0	8	0	0
9	38168005	.	A	G	2	0	2	0	5	7	0	0
9	38168065	.	G	A	0	5	5	0	5	10	0	0
9	38205480	.	G	T	0	7	7	0	5	12	0	0
9	38207504	.	C	T	11	7	18	0	0	18	0	0
9	38207964	.	G	A	6	10	16	0	1	17	0	0
9	38238917	.	G	A	1	7	8	0	11	19	0	0
9	38251409	.	T	C	10	11	21	0	0	21	0	0
9	38266131	.	T	C	7	6	13	0	1	14	0	0
9	38269630	.	A	G	10	8	18	0	0	18	0	0
9	38273171	.	G	A	14	17	31	0	2	34	1	0
9	38273264	.	T	A	25	14	39	0	0	39	0	0
9	38276558	.	T	G	9	1	10	0	6	16	0	0
9	38277513	.	A	G	19	9	28	0	2	30	0	0
9	38278121	.	A	G	23	11	34	0	2	36	0	0
9	38278289	.	C	T	18	14	32	0	1	33	0	0
9	38278301	.	T	C	20	17	37	0	0	37	0	0
9	38278337	.	T	C	19	13	32	0	1	33	0	0
9	38283647	.	G	A	14	5	19	0	1	20	0	0
9	38283659	.	C	T	16	6	22	0	0	22	0	0
9	38284317	.	A	G	21	0	21	0	18	39	0	0
9	38285598	.	A	G	20	13	33	0	0	33	0	0
9	38286823	.	G	A	23	14	37	0	0	37	0	0
9	38290165	.	C	T	13	12	25	0	2	27	0	0
9	38290210	.	A	G	12	11	23	0	1	24	0	0
9	38290220	.	T	G	11	0	11	0	17	28	0	0
9	38290245	.	C	T	11	15	26	0	0	26	0	0
9	38290414	.	A	G	14	5	19	0	1	20	0	0
9	38290517	.	A	C	13	8	21	0	1	23	1	0
9	38290530	.	A	T	11	9	20	1	0	21	0	0
9	38290561	.	C	T	12	8	20	2	0	22	0	0
9	38290777	.	G	T	2	13	15	0	13	28	0	0
9	38290959	.	A	C	13	24	37	0	1	38	0	0
9	38291439	.	G	T	20	10	30	0	1	31	0	0
9	38291616	.	C	T	10	11	21	0	1	22	0	0
9	38291737	.	C	A	5	5	10	0	2	12	0	0
9	38315128	.	T	G	5	7	12	0	0	12	0	0
9	38315827	.	C	G	6	8	14	0	0	14	0	0
9	38316758	.	G	A	5	7	12	0	0	12	0	0
9	38316769	.	T	C	3	6	9	0	0	9	0	0
9	38348252	.	G	A	1	4	5	0	0	5	0	0
9	38348458	.	G	A	7	12	19	0	0	19	0	0
9	38351016	.	T	C	5	6	11	0	1	12	0	0
9	38354000	.	T	C	13	10	23	0	0	23	0	0
9	38354224	.	A	G	11	12	23	0	1	24	0	0
9	38354689	.	G	A	12	5	17	0	0	17	0	0
9	38359027	.	A	C	10	0	10	0	10	20	0	0
9	38359737	.	G	A	9	8	17	0	0	17	0	0
9	38360102	.	C	T	0	14	14	0	8	22	0	0
9	38362354	.	G	A	10	11	21	0	0	21	0	0
9	38362380	.	C	T	4	11	15	0	1	16	0	0
9	38366653	.	T	C	2	3	5	0	1	6	0	0
9	38366656	.	C	A	0	4	4	0	3	7	0	0
9	38366826	.	A	G	1	5	6	0	1	7	0	0
9	38366883	.	C	G	1	3	4	0	1	5	0	0
9	38368055	.	A	G	8	5	13	0	0	13	0	0
9	38372264	.	C	T	2	5	7	0	0	7	0	0
9	38375890	.	T	G	2	2	4	0	0	4	0	0
9	38376006	.	G	A	2	6	8	0	1	9	0	0
9	38376129	.	A	T	4	3	7	0	0	7	0	0
9	38376231	.	T	C	2	3	5	0	0	5	0	0
9	38376248	.	A	T	3	3	6	0	1	7	0	0
9	38385734	.	G	A	5	4	9	0	0	9	0	0
9	38386066	.	A	G	2	0	2	0	5	7	0	0
9	38386205	.	C	T	5	7	12	0	0	12	0	0
9	38386615	.	C	A	6	3	9	0	0	9	0	0
9	38388492	.	C	T	9	7	16	0	0	16	0	0
9	38388493	.	C	T	6	7	13	0	3	16	0	0
9	38388703	.	T	C	5	4	9	0	2	11	0	0
9	38389026	.	T	A	3	4	7	0	0	7	0	0
9	38389194	.	C	T	5	11	16	0	0	16	0	0
9	38389263	.	T	A	3	7	10	0	2	12	0	0
9	38389426	.	G	A	15	5	20	0	0	20	0	0
9	38389603	.	A	G	10	0	10	0	8	18	0	0
9	38389616	.	C	T	14	6	20	0	0	20	0	0
9	38389644	.	A	T	9	7	16	0	0	16	0	0
9	38389886	.	C	T	5	9	14	0	0	14	0	0
9	38390973	.	A	G	3	2	5	0	0	5	0	0
9	38390976	.	G	A	3	2	5	0	0	5	0	0
9	38391549	.	C	T	4	3	7	0	0	7	0	0
9	38391991	.	T	C	2	2	4	0	0	4	0	0
9	38392045	.	T	G	4	2	6	0	0	6	0	0
9	38392097	.	T	C	4	4	8	0	0	8	0	0
9	38392563	.	G	T	1	3	4	0	0	4	0	0
9	38393592	.	A	C	2	2	4	0	0	4	0	0
9	38400169	.	A	C	4	2	6	0	0	6	0	0
9	38400232	.	T	A	2	2	4	0	2	6	0	0
9	38400233	.	T	C	3	2	5	0	1	6	0	0
9	38413298	.	C	T	10	6	16	0	1	17	0	0
9	38418864	.	T	C	6	3	9	0	0	9	0	0
9	38429874	.	G	A	2	2	4	4	0	8	0	0
9	38456782	.	C	T	2	6	8	0	1	9	0	0
9	38457917	.	T	C	3	2	5	0	0	5	0	0
9	38458204	.	A	C	5	4	9	0	1	10	0	0
9	38458220	.	T	A	8	5	13	0	0	13	0	0
9	38458334	.	T	A	3	2	5	0	0	5	0	0
9	38458369	.	A	C	1	3	4	0	0	4	0	0
9	38458530	.	A	C	1	3	4	0	0	4	0	0
9	38458629	.	A	G	1	4	5	0	1	6	0	0
9	38458670	.	T	A	1	4	5	0	0	5	0	0
9	38458687	.	C	T	2	4	6	0	0	6	0	0
9	38458714	.	T	C	2	4	6	0	0	6	0	0
9	38458759	.	A	G	2	0	2	0	3	5	0	0
9	38459282	.	G	A	1	2	3	0	0	3	0	0
9	38459558	.	G	A	4	3	7	0	3	10	0	0
9	38463762	.	A	T	1	4	5	0	1	6	0	0
9	38466332	.	T	G	2	2	4	0	1	5	0	0
9	38470376	.	C	T	4	5	9	0	0	9	0	0
9	38470665	.	T	G	5	3	8	0	0	8	0	0
9	38473937	.	T	C	2	2	4	0	0	4	0	0
9	38473973	.	C	T	2	2	4	0	1	5	0	0
9	38476650	.	A	C	2	5	7	0	1	8	0	0
9	38476748	.	G	A	3	3	6	0	0	6	0	0
9	38476780	.	G	C	3	5	8	0	0	8	0	0
9	38476810	.	T	G	3	2	5	0	1	6	0	0
9	38476842	.	G	T	0	3	3	0	5	8	0	0
9	38478424	.	T	C	6	3	9	0	0	9	0	0
9	38478477	.	G	A	1	2	3	0	2	5	0	0
9	38478643	.	A	T	6	3	9	0	0	9	0	0
9	38479579	.	A	G	6	0	6	0	7	13	0	0
9	38485168	.	A	T	2	2	4	0	0	4	0	0
9	38494774	.	G	A	1	3	4	0	0	4	0	0
9	38495985	.	C	T	3	3	6	0	0	6	0	0
9	38497393	.	C	T	4	3	7	0	0	7	0	0
9	38500149	.	A	T	1	2	3	0	0	3	0	0
9	38502640	.	A	G	6	2	8	0	0	8	0	0
9	38502683	.	A	T	3	3	6	0	1	7	0	0
9	38502734	.	T	A	2	3	5	0	0	5	0	0
9	38503838	.	C	T	4	2	6	0	0	6	0	0
9	38503872	.	A	C	2	4	6	0	0	6	0	0
9	38505586	.	G	C	1	2	3	0	0	3	0	0
9	38513135	.	C	T	1	3	4	0	0	4	0	0
9	38525125	.	T	C	2	3	5	0	1	6	0	0
9	38526390	.	T	C	3	2	5	0	0	5	0	0
9	38532695	.	C	T	4	2	6	0	0	6	0	0
9	38532778	.	T	C	2	2	4	0	0	4	0	0
9	38542252	.	C	T	2	5	7	0	0	7	0	0
9	38543815	.	G	A	1	3	4	0	1	5	0	0
9	38550910	.	T	C	8	5	13	0	0	13	0	0
9	38600006	.	G	A	1	3	4	0	1	5	0	0
9	38603338	.	A	T	15	12	27	0	0	27	0	0
9	38603742	.	T	C	10	11	21	0	1	22	0	0
9	38620058	.	C	T	11	7	18	0	0	18	0	0
9	38620308	.	C	A	6	7	13	0	0	13	0	0
9	38620673	.	A	G	15	17	32	0	1	33	0	0
9	38624628	.	T	C	4	5	9	0	0	9	0	0
9	38624629	.	C	T	4	5	9	0	0	9	0	0
9	38629997	.	T	A	6	4	10	0	0	10	0	0
9	38634508	.	A	G	1	3	4	0	0	4	0	0
9	38635435	.	G	A	3	6	9	0	0	9	0	0
9	38635564	.	G	A	1	2	3	0	0	3	0	0
9	38636152	.	A	G	5	0	5	0	8	13	0	0
9	38636170	.	A	G	5	5	10	0	0	10	0	0
9	38636413	.	G	T	0	8	8	0	2	10	0	0
9	38636722	.	T	C	5	5	10	0	1	11	0	0
9	38636797	.	T	C	10	11	21	0	0	21	0	0
9	38637072	.	G	T	1	3	4	0	0	4	0	0
9	38637438	.	T	A	5	4	9	0	0	9	0	0
9	38637445	.	A	G	5	0	5	0	4	9	0	0
9	38637879	.	A	C	2	6	8	0	0	8	0	0
9	38638197	.	C	T	5	7	12	0	0	12	0	0
9	38638452	.	A	T	9	12	21	0	0	21	0	0
9	38638461	.	C	G	11	11	22	0	0	22	0	0
9	38638492	.	A	G	9	0	9	0	9	18	0	0
9	38638518	.	T	C	12	7	19	0	1	20	0	0
9	38638743	.	T	C	9	7	16	0	0	16	0	0
9	38638862	.	C	T	2	9	11	0	0	11	0	0
9	38638863	.	C	A	3	9	12	0	0	12	0	0
9	38638970	.	G	A	5	2	7	0	0	7	0	0
9	38639799	.	T	C	8	6	14	0	0	14	0	0
9	38639846	.	C	T	7	4	11	0	1	12	0	0
9	38639907	.	A	C	5	6	11	0	1	12	0	0
9	38640114	.	T	A	5	9	14	0	1	15	0	0
9	38640186	.	T	C	5	8	13	0	1	14	0	0
9	38640193	.	T	C	3	8	11	0	0	11	0	0
9	38640598	.	A	G	5	0	5	0	6	11	0	0
9	38640773	.	A	T	3	2	5	0	0	5	0	0
9	38641111	.	C	T	2	4	6	0	0	6	0	0
9	38684920	.	T	A	3	2	5	0	0	5	0	0
9	38693178	.	C	T	1	3	4	0	0	4	0	0
9	38706282	.	G	C	4	2	6	0	0	6	0	0
9	38706894	.	T	A	1	3	4	0	0	4	0	0
9	38707164	.	T	C	4	3	7	0	0	7	0	0
9	38753592	.	G	T	3	3	6	0	0	6	0	0
9	38753606	.	C	G	3	2	5	0	0	5	0	0
9	38763108	.	A	T	2	2	4	0	0	4	0	0
9	38764749	.	T	C	2	3	5	0	0	5	0	0
9	38764752	.	A	G	2	3	5	0	0	5	0	0
9	38888025	.	A	T	15	15	30	0	2	32	0	0
9	40928199	.	T	C	4	4	8	0	0	8	0	0
9	40928245	.	T	C	8	3	11	0	1	12	0	0
9	40928650	.	T	C	3	5	8	0	1	9	0	0
9	40928669	.	T	C	2	4	6	0	0	6	0	0
9	40928706	.	T	C	3	3	6	0	0	6	0	0
9	40930319	.	T	C	5	4	9	0	0	9	0	0
9	40930914	.	T	C	4	0	4	0	8	12	0	0
9	40930931	.	T	C	5	4	9	0	1	10	0	0
9	41479972	.	A	G	1	2	3	0	0	3	0	0
9	42360743	.	C	G	6	7	13	0	0	13	0	0
9	42360893	.	C	T	0	3	3	0	11	14	0	0
9	42360899	.	G	A	10	3	13	0	0	13	0	0
9	42372354	.	T	A	3	7	10	0	1	11	0	0
9	42372423	.	G	A	5	2	7	0	0	7	0	0
9	42421027	.	G	A	7	2	9	0	0	9	0	0
9	42421044	.	G	T	5	3	8	0	1	9	0	0
9	42430057	.	C	A	3	1	4	0	0	4	0	0
9	42430064	.	G	C	3	2	5	0	0	5	0	0
9	42644892	.	A	G	11	2	13	0	8	21	0	0
9	42649636	.	T	A	2	5	7	0	1	8	0	0
9	42649653	.	T	C	4	5	9	0	0	9	0	0
9	42649739	.	C	T	7	7	14	0	0	14	0	0
9	42649743	.	A	G	7	7	14	0	0	14	0	0
9	42649923	.	A	G	4	4	8	0	0	8	0	0
9	42657418	.	A	T	7	2	9	0	0	9	0	0
9	42658788	.	A	G	4	3	7	0	0	7	0	0
9	42660036	.	T	C	1	3	4	0	0	4	0	0
9	42660732	.	G	A	3	2	5	0	0	5	0	0
9	42660771	.	G	A	4	3	7	0	0	7	0	0
9	42662977	.	A	T	6	5	11	0	0	11	0	0
9	42670046	.	A	C	4	0	4	0	4	8	0	0
9	42730591	.	A	G	1	4	5	0	0	5	0	0
9	42730602	.	A	G	1	4	5	0	0	5	0	0
9	42733509	.	G	A	2	2	4	0	0	4	0	0
9	43082373	.	A	T	6	2	8	0	0	8	0	0
9	43082398	.	A	G	4	3	7	0	0	7	0	0
9	43082717	.	T	G	3	4	7	0	0	7	0	0
9	43085369	.	G	T	3	3	6	0	0	6	0	0
9	43085527	.	A	T	4	2	6	0	1	7	0	0
9	43085728	.	A	C	4	4	8	0	0	8	0	0
9	43085879	.	C	T	6	4	10	0	0	10	0	0
9	43088841	.	C	A	3	6	9	0	1	10	0	0
9	43088870	.	T	A	2	6	8	0	1	9	0	0
9	43088884	.	G	A	2	5	7	0	2	9	0	0
9	43088910	.	A	T	4	3	7	0	0	7	0	0
9	43088984	.	A	G	6	3	9	1	0	10	0	0
9	43089038	.	C	G	4	3	7	0	0	7	0	0
9	43091409	.	T	C	3	0	3	0	3	6	0	0
9	43092297	.	C	T	1	5	6	0	0	6	0	0
9	43092306	.	A	G	1	4	5	0	0	5	0	0
9	43107246	.	A	G	2	5	7	0	0	7	0	0
9	43110354	.	T	C	1	4	5	0	0	5	0	0
9	43113358	.	T	A	1	2	3	0	0	3	0	0
9	43113372	.	A	C	2	1	3	0	0	3	0	0
9	43113395	.	C	T	1	1	2	0	0	2	0	0
9	43113607	.	T	A	4	4	8	0	1	9	0	0
9	43116589	.	C	A	2	3	5	0	0	5	0	0
9	43150018	.	T	A	10	3	13	0	2	15	0	0
9	43150278	.	T	G	10	9	19	0	1	20	0	0
9	43150604	.	A	G	18	19	37	4	0	41	0	0
9	43150817	.	C	T	2	18	20	0	13	33	0	0
9	43153287	.	C	T	18	12	30	0	0	30	0	0
9	43154841	.	C	T	12	15	27	0	2	29	0	0
9	43175527	.	C	T	2	19	21	0	10	31	0	0
9	43202097	.	T	C	12	1	13	0	14	27	0	0
9	43207727	.	G	A	11	16	27	0	0	27	0	0
9	43261951	.	T	A	6	9	15	0	1	16	0	0
9	43287748	.	G	A	11	8	19	0	1	20	0	0
9	43375122	.	G	A	9	9	18	0	0	18	0	0
9	43552604	.	C	A	1	3	4	0	0	4	0	0
9	43552687	.	A	C	3	8	11	3	0	14	0	0
9	43553036	.	G	T	13	8	21	0	1	22	0	0
9	43559501	.	A	C	10	6	16	0	0	16	0	0
9	43612482	.	T	G	5	7	12	0	1	13	0	0
9	43617899	.	A	G	9	9	18	0	0	18	0	0
9	43617962	.	A	G	7	6	13	0	0	13	0	0
9	43630057	.	C	T	1	3	4	0	10	14	0	0
9	43630216	.	G	C	3	2	5	0	0	5	0	0
9	44097854	.	C	T	0	3	3	0	4	7	0	0
9	44109260	.	A	G	4	2	6	0	1	7	0	0
9	44109589	.	T	C	3	0	3	0	3	6	0	0
9	44109595	.	T	C	3	0	3	0	2	5	0	0
9	44192300	.	G	A	3	3	6	0	0	6	0	0
9	44221162	.	A	G	4	2	6	0	1	7	0	0
9	44221174	.	C	T	4	2	6	0	0	6	0	0
9	44249852	.	T	C	1	2	3	0	0	3	0	0
9	44249897	.	C	T	1	2	3	0	0	3	0	0
9	44292285	.	A	C	26	0	26	0	23	49	0	0
9	44292737	.	T	C	27	22	49	0	2	51	0	0
9	44292909	.	C	T	1	27	28	0	28	56	0	0
9	44293488	.	C	T	27	30	57	0	1	58	0	0
9	44294792	.	A	G	16	16	32	0	0	32	0	0
9	44357340	.	G	A	1	3	4	0	0	4	0	0
9	44391277	.	T	C	1	4	5	0	2	7	0	0
9	44391309	.	T	C	6	6	12	0	1	13	0	0
9	44391339	.	T	G	6	4	10	0	2	12	0	0
9	44391395	.	G	A	2	3	5	0	0	5	0	0
9	44391664	.	T	C	8	5	13	0	0	13	0	0
9	44391666	.	G	A	8	5	13	0	0	13	0	0
9	44391780	.	G	A	1	6	7	0	6	13	0	0
9	44391831	.	A	G	4	3	7	0	0	7	0	0
9	44398141	.	G	A	5	6	11	0	0	11	0	0
9	44399446	.	C	A	6	3	9	0	0	9	0	0
9	44399472	.	A	G	3	1	4	0	5	9	0	0
9	44399521	.	C	T	5	6	11	0	0	11	0	0
9	44400091	.	T	G	4	4	8	0	2	10	0	0
9	44400119	.	G	A	7	6	13	0	0	13	0	0
9	44400580	.	G	A	11	15	26	0	2	28	0	0
9	44400706	.	C	A	7	7	14	0	0	14	0	0
9	44411647	.	A	G	10	11	21	0	1	22	0	0
9	44411652	.	C	A	13	6	19	0	5	24	0	0
9	44411828	.	A	C	13	12	25	0	1	26	0	0
9	44419652	.	T	A	12	9	21	0	0	21	0	0
9	44419793	.	C	A	4	10	14	0	1	15	0	0
9	44431117	.	G	A	7	5	12	0	0	12	0	0
9	44443998	.	T	C	26	10	36	0	0	36	0	0
9	44469318	.	A	G	21	0	21	0	22	43	0	0
9	44486011	.	A	G	5	3	8	0	1	9	0	0
9	44488578	.	T	A	7	9	16	0	0	16	0	0
9	44488620	.	G	A	2	5	7	0	6	13	0	0
9	44489843	.	G	A	0	5	5	0	3	8	0	0
9	44489844	.	T	A	3	5	8	0	0	8	0	0
9	44498332	.	T	C	8	9	17	0	1	18	0	0
9	44509181	.	G	A	11	10	21	0	1	22	0	0
9	44511218	.	C	T	8	6	14	0	1	15	0	0
9	44515937	.	G	A	4	14	18	0	0	18	0	0
9	44526546	.	G	A	6	13	19	0	2	21	0	0
9	44641974	.	A	T	10	13	23	0	1	24	0	0
9	44642017	.	G	A	8	8	16	0	1	17	0	0
9	44642057	.	T	C	11	0	11	0	16	27	0	0
9	44961166	.	A	G	6	3	9	0	0	9	0	0
9	44961379	.	A	G	2	1	3	0	0	3	0	0
9	44961397	.	T	C	1	2	3	0	0	3	0	0
9	45428086	.	C	T	3	5	8	0	0	8	0	0
9	45504135	.	G	A	1	4	5	0	5	10	0	0
9	45504199	.	C	T	3	4	7	0	0	7	0	0
9	45504357	.	A	C	6	7	13	0	0	13	0	0
9	45504485	.	A	G	6	3	9	0	1	10	0	0
9	45504819	.	A	G	8	0	8	0	10	18	0	0
9	45504888	.	G	A	0	9	9	0	7	16	0	0
9	45523190	.	G	A	8	5	13	0	2	15	0	0
9	45536096	.	A	G	5	4	9	0	0	9	0	0
9	45541036	.	C	A	6	8	14	0	0	14	0	0
9	45541069	.	T	C	6	7	13	0	0	13	0	0
9	45541239	.	G	A	6	8	14	0	0	14	0	0
9	45551273	.	T	C	9	9	18	2	2	22	0	0
9	45552338	.	T	G	10	8	18	0	0	19	1	0
9	45552364	.	G	A	2	4	6	0	7	13	0	0
9	45552386	.	C	G	10	6	16	0	0	16	0	0
9	45552567	.	G	A	1	12	13	0	15	28	0	0
9	45552715	.	C	T	10	9	19	0	4	23	0	0
9	45552806	.	G	A	0	10	10	0	8	18	0	0
9	45552881	.	T	C	8	14	22	0	1	23	0	0
9	45552924	.	C	A	10	11	21	0	1	22	0	0
9	45552957	.	C	T	12	11	23	0	1	24	0	0
9	45617551	.	T	C	4	4	8	0	0	8	0	0
9	45623346	.	C	T	4	8	12	0	0	12	0	0
9	45633108	.	C	G	4	3	7	0	0	7	0	0
9	45637002	.	C	G	3	0	3	0	5	8	0	0
9	45637090	.	G	A	7	3	10	0	0	10	0	0
9	45666600	.	G	A	5	3	8	0	1	9	0	0
9	45667103	.	C	T	3	3	6	0	1	7	0	0
9	45667473	.	C	T	1	2	3	0	0	3	0	0
9	45884426	.	C	T	2	4	6	1	0	7	0	0
9	45884711	.	G	A	6	8	14	0	0	14	0	0
9	45884768	.	T	G	6	5	11	0	2	13	0	0
9	45934065	.	A	G	3	5	8	0	0	8	0	0
9	45945935	.	A	C	2	4	6	0	0	6	0	0
9	45968318	.	A	G	6	8	14	0	0	14	0	0
9	45969254	.	C	T	1	6	7	0	9	16	0	0
9	45975846	.	C	T	1	9	10	0	7	17	0	0
9	45997103	.	G	A	14	6	20	0	1	21	0	0
9	46029269	.	G	T	5	7	12	0	0	12	0	0
9	46029344	.	G	A	10	6	16	0	1	17	0	0
9	46409427	.	C	T	1	2	3	0	3	6	0	0
9	46409442	.	A	G	2	2	4	0	0	4	0	0
9	46409589	.	T	A	2	4	6	0	0	6	0	0
9	46410117	.	T	C	1	1	2	0	3	5	0	0
9	46525673	.	A	G	4	12	16	0	1	17	0	0
9	46598134	.	T	C	10	6	16	0	1	17	0	0
9	46603999	.	A	G	2	0	2	0	10	12	0	0
9	46604056	.	T	C	4	6	10	0	0	10	0	0
9	46604068	.	A	G	4	1	5	0	3	8	0	0
9	46650764	.	T	C	4	4	8	0	0	8	0	0
9	46656990	.	G	C	0	4	4	0	5	9	0	0
9	46657128	.	T	C	5	5	10	0	0	10	0	0
9	46667831	.	A	T	3	2	5	0	1	6	0	0
9	46670756	.	A	T	4	6	10	0	0	10	0	0
9	46671108	.	G	A	0	6	6	0	5	11	0	0
9	46671174	.	C	T	7	4	11	0	0	11	0	0
9	46676385	.	C	T	5	8	13	0	0	13	0	0
9	46676393	.	C	G	5	4	9	0	0	9	0	0
9	46678159	.	A	C	9	11	20	0	0	20	0	0
9	46678196	.	C	T	9	5	14	0	1	15	0	0
9	46678255	.	T	C	8	6	14	0	2	16	0	0
9	46678279	.	A	T	6	7	13	0	0	14	1	0
9	46683760	.	C	A	5	7	12	0	1	13	0	0
9	46683861	.	A	C	10	8	18	0	0	18	0	0
9	46684000	.	A	C	4	4	8	0	0	8	0	0
9	46684175	.	C	A	2	2	4	0	0	4	0	0
9	46684311	.	A	G	2	2	4	0	0	4	0	0
9	46684356	.	A	C	5	3	8	0	0	8	0	0
9	46692261	.	T	G	15	18	33	0	0	33	0	0
9	46745653	.	A	G	12	10	22	0	0	22	0	0
9	46784333	.	G	A	9	7	16	0	0	16	0	0
9	46799102	.	T	C	9	8	17	0	0	17	0	0
9	46820808	.	C	T	1	2	3	0	0	3	0	0
9	46821464	.	C	T	8	10	18	0	1	19	0	0
9	46821685	.	A	G	4	6	10	0	0	10	0	0
9	46821741	.	A	G	1	4	5	0	1	6	0	0
9	46821853	.	G	A	1	6	7	0	0	7	0	0
9	46821855	.	G	T	1	6	7	0	0	7	0	0
9	46821905	.	A	G	8	9	17	0	0	17	0	0
9	46821916	.	A	T	9	9	18	0	0	18	0	0
9	46822002	.	T	C	9	3	12	5	0	17	0	0
9	46822079	.	C	T	8	8	16	0	0	16	0	0
9	46822120	.	C	T	0	10	10	0	5	15	0	0
9	46822144	.	T	C	6	10	16	0	0	16	0	0
9	46822417	.	C	T	1	6	7	0	7	14	0	0
9	46823198	.	C	T	11	19	30	0	0	30	0	0
9	46823325	.	G	A	6	14	20	0	1	21	0	0
9	46823366	.	T	C	10	17	27	0	0	27	0	0
9	46823524	.	A	G	9	18	27	0	0	27	0	0
9	46824110	.	A	G	12	16	28	0	1	29	0	0
9	46824160	.	T	A	15	13	28	0	1	29	0	0
9	46825094	.	A	T	7	12	19	0	0	19	0	0
9	46841787	.	C	G	9	5	14	0	0	14	0	0
9	47459398	.	C	T	5	5	10	0	0	10	0	0
9	47464728	.	A	G	5	5	10	0	0	10	0	0
9	47464731	.	C	T	0	5	5	0	5	10	0	0
9	47465010	.	A	G	2	5	7	0	0	7	0	0
9	47485067	.	C	T	2	2	4	0	1	5	0	0
9	47485109	.	G	A	2	2	4	0	0	4	0	0
9	47485179	.	A	C	1	0	1	0	3	4	0	0
9	47501794	.	G	C	3	1	4	0	2	6	0	0
9	47502293	.	A	T	1	5	6	0	1	7	0	0
9	47502415	.	G	A	1	6	7	0	0	7	0	0
9	47502446	.	G	C	2	6	8	0	1	9	0	0
9	47502658	.	A	G	5	4	9	0	0	9	0	0
9	47502964	.	A	G	3	8	11	0	0	11	0	0
9	48054753	.	G	A	30	19	49	0	2	51	0	0
9	48060592	.	G	C	23	21	44	0	3	47	0	0
9	48076973	.	C	T	26	25	51	0	2	53	0	0
9	48123109	.	C	G	3	2	5	0	0	5	0	0
9	48123142	.	G	A	5	7	12	0	0	12	0	0
9	48123222	.	G	C	5	2	7	0	0	7	0	0
9	48127200	.	G	A	6	6	12	0	0	12	0	0
9	48128027	.	G	T	0	2	2	0	4	6	0	0
9	48131637	.	T	A	3	2	5	0	0	5	0	0
9	48131814	.	A	T	3	4	7	0	0	7	0	0
9	48131865	.	G	A	5	3	8	0	0	8	0	0
9	48131883	.	A	G	4	2	6	1	1	8	0	0
9	48131997	.	C	T	2	4	6	0	7	13	0	0
9	48132029	.	T	C	5	1	6	0	6	12	0	0
9	48132037	.	T	A	7	5	12	0	0	12	0	0
9	48132095	.	A	C	4	5	9	0	0	9	0	0
9	48132156	.	A	C	6	7	13	0	0	13	0	0
9	48132176	.	C	T	5	5	10	0	0	10	0	0
9	48132194	.	G	T	3	3	6	0	0	6	0	0
9	48132309	.	G	T	4	4	8	0	0	8	0	0
9	48132336	.	C	T	4	5	9	0	6	15	0	0
9	48132439	.	G	A	5	7	12	0	0	12	0	0
9	48132441	.	A	G	5	7	12	0	0	12	0	0
9	48132592	.	G	T	12	3	15	0	0	15	0	0
9	48132795	.	A	G	3	4	7	0	0	7	0	0
9	48133013	.	T	C	2	1	3	0	3	6	0	0
9	48133105	.	G	T	7	5	12	0	0	12	0	0
9	48133541	.	T	C	3	5	8	0	0	8	0	0
9	48133687	.	A	G	3	5	8	0	0	8	0	0
9	48133900	.	G	T	7	6	13	0	0	13	0	0
9	48134012	.	T	A	2	3	5	0	0	5	0	0
9	48134201	.	A	T	6	3	9	0	0	9	0	0
9	48134568	.	G	A	3	6	9	0	4	13	0	0
9	48134678	.	A	T	7	5	12	0	0	12	0	0
9	48178506	.	C	G	4	3	7	0	0	7	0	0
9	48178817	.	G	A	1	2	3	0	0	3	0	0
9	48178850	.	A	G	2	2	4	0	0	4	0	0
9	48178975	.	A	G	2	3	5	0	0	5	0	0
9	48178990	.	C	T	0	2	2	0	2	4	0	0
9	48184354	.	A	C	1	3	4	0	0	4	0	0
9	48186519	.	C	A	1	2	3	0	0	3	0	0
9	48189403	.	C	G	1	4	5	0	7	12	0	0
9	48189411	.	T	C	7	3	10	0	0	10	0	0
9	48197877	.	T	A	4	2	6	0	0	6	0	0
9	48197935	.	T	A	2	3	5	0	1	6	0	0
9	48197944	.	A	G	1	5	6	0	0	6	0	0
9	48203947	.	C	G	0	3	3	0	3	6	0	0
9	48214157	.	T	A	5	3	8	0	0	8	0	0
9	48219649	.	T	G	1	0	1	0	3	4	0	0
9	48225779	.	T	C	2	3	5	0	0	5	0	0
9	48226073	.	A	G	2	2	4	0	1	5	0	0
9	48226082	.	G	A	2	2	4	0	1	5	0	0
9	48227847	.	T	A	2	5	7	0	0	7	0	0
9	48227885	.	T	G	2	4	6	0	0	6	0	0
9	48227953	.	T	C	3	3	6	0	0	6	0	0
9	48230669	.	C	T	4	4	8	0	0	8	0	0
9	48232611	.	A	G	4	4	8	0	0	8	0	0
9	48239975	.	C	T	2	2	4	0	0	4	0	0
9	48246968	.	A	C	2	1	3	0	0	3	0	0
9	48246976	.	G	A	0	2	2	0	2	4	0	0
9	48247050	.	G	A	1	3	4	0	0	4	0	0
9	48252167	.	C	T	3	2	5	0	0	5	0	0
9	48252171	.	G	C	0	2	2	0	3	5	0	0
9	48255357	.	G	A	0	4	4	0	4	8	0	0
9	48264034	.	C	T	2	2	4	0	0	4	0	0
9	48266182	.	C	T	1	2	3	0	0	3	0	0
9	48267524	.	C	T	1	1	2	0	0	2	0	0
9	48267532	.	T	A	1	2	3	0	0	3	0	0
9	48284901	.	T	C	11	8	19	0	1	20	0	0
9	48284917	.	C	A	1	8	9	0	12	21	0	0
9	48286702	.	G	A	6	8	14	0	0	14	0	0
9	48287441	.	G	A	11	7	18	0	2	20	0	0
9	48289758	.	G	A	4	6	10	0	0	10	0	0
9	48289797	.	A	T	4	5	9	0	0	9	0	0
9	48289961	.	A	G	10	6	16	0	0	16	0	0
9	48289991	.	T	C	7	4	11	0	1	12	0	0
9	48295210	.	G	A	4	7	11	0	0	11	0	0
9	48295211	.	T	G	4	7	11	0	0	11	0	0
9	48296346	.	C	T	1	11	12	0	9	21	0	0
9	48387014	.	T	C	1	2	3	0	0	3	0	0
9	48390858	.	G	T	5	4	9	0	0	9	0	0
9	48407342	.	C	T	1	5	6	0	1	7	0	0
9	48407365	.	T	G	1	4	5	0	0	5	0	0
9	48598916	.	A	G	1	2	3	0	0	3	0	0
9	48606235	.	C	T	1	2	3	0	0	3	0	0
9	48653675	.	A	G	3	4	7	0	0	7	0	0
9	48665419	.	A	T	1	3	4	0	1	5	0	0
9	48665654	.	G	A	5	3	8	0	0	8	0	0
9	48668834	.	C	G	5	7	12	0	1	13	0	0
9	48670113	.	G	A	0	2	2	0	2	4	0	0
9	48670395	.	A	C	1	2	3	0	0	3	0	0
9	48670454	.	T	G	2	5	7	0	0	7	0	0
9	48670660	.	G	A	0	2	2	0	2	4	0	0
9	48670747	.	T	G	1	0	1	0	2	3	0	0
9	48670748	.	T	C	1	2	3	0	0	3	0	0
9	48718225	.	C	A	0	3	3	0	4	7	0	0
9	48718229	.	C	G	3	4	7	0	0	7	0	0
9	48721088	.	C	T	4	3	7	0	1	8	0	0
9	48721107	.	C	T	4	4	8	0	0	8	0	0
9	48721172	.	A	G	5	2	7	0	0	7	0	0
9	48721265	.	T	C	5	3	8	0	1	9	0	0
9	48870578	.	T	C	9	0	9	0	13	22	0	0
9	48870593	.	A	T	9	11	20	0	1	21	0	0
9	48870627	.	T	A	5	10	15	0	0	15	0	0
9	48870680	.	A	G	3	7	10	0	0	10	0	0
9	48870886	.	C	T	9	6	15	0	1	16	0	0
9	48871080	.	G	C	7	5	12	0	0	12	0	0
9	48871610	.	A	T	9	3	12	2	0	14	0	0
9	48871966	.	T	G	12	4	16	5	0	21	0	0
9	48871973	.	A	C	7	7	14	6	0	20	0	0
9	48872039	.	C	G	0	6	6	2	10	18	0	0
9	48872050	.	C	T	9	4	13	0	0	13	0	0
9	48872688	.	A	T	6	2	8	0	0	8	0	0
9	48872694	.	A	G	6	2	8	0	0	8	0	0
9	48872890	.	C	A	6	3	9	1	1	11	0	0
9	48872924	.	A	G	6	7	13	1	0	14	0	0
9	48872926	.	C	T	0	5	5	1	6	12	0	0
9	48872960	.	A	G	10	2	12	0	0	12	0	0
9	48873092	.	G	C	8	2	10	0	0	10	0	0
9	48873144	.	A	G	4	7	11	0	0	11	0	0
9	48873150	.	C	T	1	4	5	0	8	13	0	0
9	48873302	.	T	C	4	6	10	0	0	10	0	0
9	48873371	.	A	G	3	5	8	0	0	8	0	0
9	48873522	.	C	G	5	4	9	0	0	9	0	0
9	48873853	.	G	A	2	2	4	0	1	5	0	0
9	48874562	.	G	A	11	11	22	0	0	22	0	0
9	48874577	.	G	A	11	10	21	0	0	21	0	0
9	48874728	.	T	C	6	4	10	0	1	11	0	0
9	48875208	.	C	G	5	5	10	0	0	10	0	0
9	48875218	.	G	T	6	5	11	0	0	11	0	0
9	48875510	.	T	C	5	4	9	0	0	9	0	0
9	48875516	.	G	A	4	5	9	0	0	9	0	0
9	48875595	.	A	C	1	2	3	0	1	4	0	0
9	48875598	.	T	A	3	2	5	0	0	5	0	0
9	48875674	.	A	G	1	7	8	0	0	8	0	0
9	48875716	.	T	A	2	4	6	0	0	6	0	0
9	48876199	.	T	C	3	2	5	0	0	5	0	0
9	48876544	.	C	T	3	8	11	0	0	11	0	0
9	48876587	.	A	G	11	4	15	1	1	17	0	0
9	48877005	.	A	C	2	3	5	0	0	5	0	0
9	48877129	.	T	C	3	1	4	0	4	8	0	0
9	48877132	.	G	A	4	4	8	0	0	8	0	0
9	48877348	.	A	G	6	3	9	0	0	9	0	0
9	48937081	.	G	C	4	3	7	0	0	7	0	0
9	49713606	.	G	T	5	3	8	1	0	9	0	0
9	50194661	.	T	C	1	3	4	0	0	4	0	0
9	50194927	.	C	A	1	3	4	0	0	4	0	0
9	50194933	.	T	A	1	2	3	0	1	4	0	0
9	50195138	.	C	G	1	2	3	0	0	3	0	0
9	50195221	.	C	T	4	4	8	0	0	8	0	0
9	50195745	.	A	G	2	2	4	0	0	4	0	0
9	50196047	.	A	C	2	3	5	0	0	5	0	0
9	50196064	.	C	T	3	3	6	0	0	6	0	0
9	51302422	.	A	G	29	20	49	0	1	50	0	0
9	51307387	.	G	T	15	17	32	0	2	34	0	0
9	51345386	.	C	A	11	11	22	0	1	23	0	0
9	51430606	.	C	G	1	2	3	0	0	3	0	0
9	51430737	.	C	T	1	5	6	0	2	8	0	0
9	51430886	.	G	C	1	2	3	0	1	4	0	0
9	51431179	.	C	G	12	5	17	0	0	17	0	0
9	51431642	.	A	C	6	0	6	0	10	16	0	0
9	51431843	.	C	G	0	2	2	0	4	6	0	0
9	51432279	.	T	G	8	5	13	0	0	13	0	0
9	51432381	.	C	T	1	2	3	0	10	13	0	0
9	51433816	.	C	T	1	10	11	0	10	21	0	0
9	51433944	.	G	A	10	8	18	0	1	19	0	0
9	51521620	.	G	A	1	2	3	0	0	3	0	0
9	51695610	.	C	T	4	2	6	0	0	6	0	0
9	51791393	.	G	A	0	3	3	0	4	7	0	0
9	51804777	.	C	T	4	3	7	0	1	8	0	0
9	51996212	.	A	T	3	5	8	0	0	8	0	0
9	51996246	.	C	T	1	3	4	0	5	9	0	0
9	51996280	.	T	A	4	5	9	0	0	9	0	0
9	51996281	.	G	A	4	5	9	0	0	9	0	0
9	51996444	.	T	G	10	10	20	0	0	20	0	0
9	51996469	.	C	T	1	11	12	0	10	22	0	0
9	51996788	.	A	G	4	2	6	1	0	7	0	0
9	51996876	.	A	G	4	5	9	0	0	9	0	0
9	51997231	.	T	A	1	2	3	1	0	4	0	0
9	51997232	.	C	A	0	2	2	1	1	4	0	0
9	51997286	.	C	A	5	3	8	0	0	8	0	0
9	51998330	.	T	C	5	3	8	0	0	8	0	0
9	51998539	.	G	T	8	2	10	0	1	11	0	0
9	51998547	.	C	T	7	3	10	0	0	10	0	0
9	51998648	.	C	T	7	7	14	0	0	14	0	0
9	51998761	.	C	G	5	3	8	0	0	8	0	0
9	51998784	.	T	G	4	4	8	0	0	8	0	0
9	51998841	.	G	T	10	3	13	0	0	13	0	0
9	51998887	.	T	G	4	4	8	0	0	8	0	0
9	51999842	.	C	G	11	4	15	0	1	16	0	0
9	51999855	.	T	G	15	4	19	0	0	19	0	0
9	51999991	.	A	G	7	5	12	0	0	12	0	0
9	52000032	.	C	T	0	5	5	0	7	12	0	0
9	52000088	.	G	A	7	11	18	0	1	19	0	0
9	52000127	.	C	G	6	6	12	0	0	12	0	0
9	52000248	.	T	A	10	3	13	0	0	13	0	0
9	52000335	.	A	T	11	4	15	0	0	15	0	0
9	52000623	.	C	T	3	4	7	0	8	15	0	0
9	52000665	.	A	G	8	7	15	0	0	15	0	0
9	52000861	.	A	C	7	3	10	0	0	10	0	0
9	52000869	.	G	C	3	0	3	0	6	9	0	0
9	52001016	.	C	T	0	6	6	0	6	12	0	0
9	52001241	.	C	T	2	5	7	0	11	18	0	0
9	52003427	.	T	C	1	0	1	0	9	10	0	0
9	52040746	.	A	G	2	3	5	0	0	5	0	0
9	52057356	.	T	C	5	0	5	0	3	8	0	0
9	52057378	.	C	A	0	4	4	0	5	9	0	0
9	52057708	.	C	T	8	8	16	0	0	16	0	0
9	52062698	.	T	C	3	7	10	0	0	10	0	0
9	52062710	.	T	G	3	5	8	0	1	9	0	0
9	52100664	.	G	A	1	2	3	0	0	3	0	0
9	52100697	.	A	G	3	6	9	0	0	9	0	0
9	52145852	.	C	T	0	3	3	0	3	6	0	0
9	52378682	.	C	T	22	6	28	0	1	29	0	0
9	52378697	.	A	G	20	11	31	0	0	31	0	0
9	52378832	.	T	A	25	11	36	1	0	37	0	0
9	52428661	.	A	G	2	0	2	0	3	5	0	0
9	52432669	.	T	C	1	3	4	0	0	4	0	0
9	52433174	.	A	C	4	5	9	0	0	9	0	0
9	52439166	.	G	A	1	2	3	0	0	3	0	0
9	52439171	.	C	A	1	2	3	0	0	3	0	0
9	52479199	.	T	C	1	5	6	0	0	6	0	0
9	52479901	.	C	T	2	8	10	0	2	12	0	0
9	52487535	.	T	C	3	0	3	1	6	10	0	0
9	52489838	.	C	A	1	5	6	0	0	6	0	0
9	52490015	.	A	G	4	3	7	0	1	8	0	0
9	52490046	.	C	T	0	2	2	0	4	6	0	0
9	52490053	.	T	A	3	2	5	0	0	5	0	0
9	52492641	.	A	C	9	5	14	0	2	16	0	0
9	52492688	.	C	G	23	0	23	0	12	35	0	0
9	52492705	.	A	G	11	24	35	0	2	37	0	0
9	52493059	.	A	T	17	7	24	0	1	25	0	0
9	52493231	.	A	T	10	16	26	0	2	28	0	0
9	52493406	.	C	T	15	7	22	0	1	23	0	0
9	52539290	.	G	A	1	9	10	0	21	31	0	0
9	52539453	.	C	T	19	18	37	0	3	40	0	0
9	52539629	.	C	T	13	15	28	0	2	30	0	0
9	52564578	.	T	C	5	1	6	0	6	12	0	0
9	52564622	.	T	C	6	5	11	0	0	11	0	0
9	52572573	.	G	A	7	6	13	0	0	13	0	0
9	52572609	.	C	G	11	5	16	0	0	16	0	0
9	52574737	.	C	G	4	3	7	0	0	7	0	0
9	52589588	.	G	A	5	3	8	0	0	8	0	0
9	52594558	.	G	C	3	3	6	0	2	8	0	0
9	52595710	.	C	T	1	3	4	0	0	4	0	0
9	52608059	.	T	A	3	4	7	0	0	7	0	0
9	52608099	.	C	T	0	4	4	0	3	7	0	0
9	52608324	.	G	A	2	2	4	0	0	4	0	0
9	52609094	.	G	A	5	2	7	0	0	7	0	0
9	52609133	.	A	T	5	2	7	0	1	8	0	0
9	52609157	.	C	T	2	4	6	0	0	6	0	0
9	52629113	.	C	T	7	12	19	0	0	19	0	0
9	52629119	.	C	T	11	8	19	0	1	20	0	0
9	52629155	.	T	C	13	8	21	0	2	23	0	0
9	52631620	.	G	A	13	10	23	0	0	23	0	0
9	52633151	.	C	T	11	3	14	0	0	14	0	0
9	52633184	.	C	G	7	5	12	0	1	13	0	0
9	52642012	.	G	A	14	8	22	0	0	22	0	0
9	52645687	.	C	T	0	6	6	0	6	12	0	0
9	52649704	.	C	T	0	7	7	0	8	15	0	0
9	52649740	.	C	A	2	9	11	0	6	17	0	0
9	52649758	.	T	A	8	10	18	0	0	18	0	0
9	52649794	.	A	G	7	6	13	0	1	14	0	0
9	52649941	.	G	A	6	9	15	0	0	15	0	0
9	52651985	.	T	C	5	14	19	0	0	19	0	0
9	52652015	.	A	G	10	6	16	0	0	16	0	0
9	52735000	.	A	T	13	1	14	0	2	16	0	0
9	52770748	.	C	T	1	2	3	0	7	10	0	0
9	52920243	.	T	C	2	0	2	0	2	4	0	0
9	53276550	.	A	C	8	5	13	0	0	13	0	0
9	53276681	.	G	A	3	8	11	0	10	21	0	0
9	53276976	.	C	T	14	7	21	0	1	22	0	0
9	53276978	.	A	G	7	14	21	0	1	22	0	0
9	53277068	.	C	G	7	0	7	0	9	16	0	0
9	53277131	.	A	T	4	10	14	0	0	14	0	0
9	53277493	.	A	T	4	6	10	0	2	13	1	0
9	53535896	.	G	A	1	3	4	0	1	5	0	0
9	53707485	.	G	C	2	4	6	0	0	6	0	0
9	53707638	.	G	C	0	3	3	0	5	8	0	0
9	53707653	.	A	T	3	5	8	0	0	8	0	0
9	53707761	.	A	G	4	7	11	0	0	11	0	0
9	53707995	.	C	T	6	6	12	0	0	12	0	0
9	53708037	.	G	A	7	3	10	0	0	10	0	0
9	53708316	.	G	A	1	4	5	0	2	7	0	0
9	53709003	.	C	T	8	8	16	0	0	16	0	0
9	53709184	.	T	C	6	6	12	0	1	13	0	0
9	53709365	.	C	T	8	8	16	0	0	16	0	0
9	53715525	.	G	A	7	5	12	0	0	12	0	0
9	53719342	.	T	C	13	11	24	0	1	25	0	0
9	53843404	.	C	T	10	12	22	0	1	23	0	0
9	53843590	.	A	T	7	8	15	0	0	15	0	0
9	53843813	.	G	A	5	3	8	0	0	8	0	0
9	53844188	.	T	C	7	1	8	0	3	11	0	0
9	53845537	.	A	G	8	8	16	0	1	17	0	0
9	53849389	.	T	C	10	0	10	0	13	23	0	0
9	53849440	.	G	A	7	6	13	0	0	13	0	0
9	53851676	.	C	T	9	9	18	0	0	18	0	0
9	53853662	.	G	C	9	0	9	0	8	17	0	0
9	53864227	.	A	C	5	10	15	0	0	15	0	0
9	53869247	.	G	A	4	2	6	1	2	9	0	0
9	53869344	.	T	C	6	9	15	0	0	15	0	0
9	53882893	.	C	A	1	4	5	1	8	14	0	0
9	53890327	.	C	A	4	2	6	0	0	6	0	0
9	53890345	.	G	T	4	2	6	0	0	6	0	0
9	53896187	.	C	T	1	8	9	0	9	18	0	0
9	53909815	.	C	A	0	3	3	0	1	4	0	0
9	53964776	.	C	T	3	2	5	0	0	5	0	0
9	53964889	.	G	A	2	3	5	0	0	5	0	0
9	54105713	.	T	C	7	5	12	0	1	13	0	0
9	54112469	.	T	C	8	13	21	0	2	23	0	0
9	54112526	.	T	A	6	11	17	0	0	17	0	0
9	54112571	.	A	G	8	6	14	0	0	14	0	0
9	54112669	.	A	G	5	2	7	0	0	7	0	0
9	54112779	.	G	T	1	6	7	0	0	7	0	0
9	54112781	.	G	A	1	6	7	0	1	8	0	0
9	54113324	.	C	T	5	4	9	0	1	10	0	0
9	54113481	.	C	T	8	6	14	0	0	14	0	0
9	54114050	.	A	G	5	0	5	0	17	22	0	0
9	54114242	.	T	G	6	0	6	0	3	10	1	0
9	54671438	.	G	A	0	2	2	0	2	4	0	0
9	54671451	.	C	T	2	2	4	0	0	4	0	0
9	54711020	.	G	T	7	6	13	0	0	13	0	0
9	54711721	.	A	T	20	14	34	2	2	40	2	0
9	54711729	.	C	G	21	14	35	5	0	40	0	0
9	54712650	.	T	C	6	16	22	0	4	26	0	0
9	54712704	.	A	G	15	11	26	0	0	26	0	0
9	54712745	.	T	C	14	19	33	0	1	35	1	0
9	54712751	.	C	T	12	20	32	0	1	33	0	0
9	54712917	.	A	T	8	15	23	0	2	25	0	0
9	54712945	.	G	A	12	10	22	0	0	22	0	0
9	54712985	.	A	C	13	11	24	0	2	26	0	0
9	54715157	.	T	C	9	10	19	0	1	20	0	0
9	54716349	.	G	A	13	9	22	0	3	25	0	0
9	54716542	.	A	G	2	3	5	0	0	5	0	0
9	54719218	.	T	G	1	2	3	0	0	3	0	0
9	54722532	.	T	G	1	0	1	0	4	5	0	0
9	54722553	.	T	C	1	6	7	0	0	7	0	0
9	54723323	.	G	A	2	4	6	0	0	6	0	0
9	54725256	.	G	A	2	3	5	0	0	5	0	0
9	54725631	.	C	T	8	4	12	0	1	13	0	0
9	54728274	.	T	A	4	4	8	0	0	8	0	0
9	54728780	.	A	G	1	3	4	0	0	4	0	0
9	54730650	.	G	C	3	3	6	0	1	7	0	0
9	54734620	.	G	C	3	2	5	0	0	5	0	0
9	54738987	.	C	T	4	4	8	0	1	9	0	0
9	54739015	.	A	T	5	4	9	0	0	9	0	0
9	54739105	.	A	G	3	0	3	0	4	7	0	0
9	54739539	.	C	A	5	2	7	0	1	8	0	0
9	54739605	.	C	A	4	5	9	0	0	9	0	0
9	54751450	.	T	C	8	3	11	0	0	11	0	0
9	54751753	.	T	C	5	6	11	0	0	11	0	0
9	54763880	.	C	A	13	16	29	0	0	29	0	0
9	54763930	.	A	T	13	4	17	0	0	18	1	0
9	54763977	.	T	A	11	7	18	0	9	27	0	0
9	54764102	.	C	T	11	6	17	0	2	19	0	0
9	54764143	.	G	A	15	9	24	0	2	26	0	0
9	54764349	.	G	A	19	18	37	0	0	37	0	0
9	54769705	.	T	C	10	0	10	0	21	31	0	0
9	54770768	.	G	A	6	8	14	0	1	15	0	0
9	54770792	.	A	G	6	10	16	0	0	16	0	0
9	54775967	.	A	G	7	12	19	0	0	19	0	0
9	54775995	.	G	A	5	13	18	0	0	18	0	0
9	54776055	.	T	C	7	0	7	0	9	16	0	0
9	54776075	.	G	A	9	14	23	0	1	24	0	0
9	55056405	.	G	A	5	2	7	0	0	7	0	0
9	55382313	.	A	G	2	10	12	0	0	12	0	0
9	55382350	.	T	C	3	8	11	0	0	11	0	0
9	55382368	.	A	G	6	3	9	0	1	10	0	0
9	55382620	.	G	C	0	6	6	0	1	7	0	0
9	55392811	.	A	G	5	0	5	0	7	12	0	0
9	55392913	.	C	T	4	2	6	0	0	6	0	0
9	55413245	.	A	G	9	0	9	0	9	18	0	0
9	55413395	.	C	A	7	5	12	0	0	12	0	0
9	55413485	.	C	A	5	7	12	0	0	12	0	0
9	55413677	.	C	T	10	10	20	0	0	20	0	0
9	55417638	.	G	A	1	13	14	0	7	21	0	0
9	55418025	.	G	A	1	8	9	0	9	18	0	0
9	55418067	.	C	T	9	8	17	0	1	18	0	0
9	55418095	.	A	G	9	6	15	0	0	15	0	0
9	55577659	.	G	A	1	2	3	0	0	3	0	0
9	55585545	.	G	A	3	2	5	0	0	5	0	0
9	55585548	.	G	A	3	2	5	0	0	5	0	0
9	55588489	.	A	G	3	3	6	0	0	6	0	0
9	55666354	.	A	T	5	2	7	0	1	8	0	0
9	55730341	.	G	A	1	1	2	0	1	3	0	0
9	55748586	.	T	C	1	2	3	1	2	6	0	0
9	55748855	.	C	A	1	6	7	0	0	7	0	0
9	55749083	.	T	C	6	0	6	0	7	13	0	0
9	55749108	.	T	C	7	6	13	0	0	13	0	0
9	55750092	.	G	T	3	5	8	0	0	8	0	0
9	55750255	.	C	G	0	3	3	0	6	9	0	0
9	55750306	.	C	T	2	5	7	0	0	7	0	0
9	55750357	.	A	C	2	0	2	0	2	4	0	0
9	55750367	.	G	A	1	2	3	0	0	3	0	0
9	55750470	.	G	A	2	2	4	0	0	4	0	0
9	55750490	.	C	T	4	2	6	0	1	7	0	0
9	55750649	.	G	C	5	5	10	0	0	10	0	0
9	55750756	.	C	T	7	6	13	1	3	17	0	0
9	55750792	.	C	T	0	6	6	0	10	16	0	0
9	55771721	.	G	C	2	3	5	0	1	6	0	0
9	55771841	.	C	T	6	2	8	0	0	8	0	0
9	55784001	.	C	T	0	4	4	0	9	13	0	0
9	55784148	.	C	T	7	3	10	0	1	11	0	0
9	55784256	.	G	T	3	3	6	0	0	6	0	0
9	55860096	.	G	A	1	5	6	0	3	9	0	0
9	55860127	.	C	T	6	5	11	0	1	12	0	0
9	55870475	.	G	A	0	3	3	0	2	5	0	0
9	55870562	.	C	A	7	7	14	0	1	15	0	0
9	55874397	.	A	C	9	3	12	0	0	12	0	0
9	55874548	.	A	T	8	7	15	0	1	16	0	0
9	55874753	.	T	G	4	3	7	0	1	8	0	0
9	55896168	.	T	C	1	0	1	0	5	6	0	0
9	55896258	.	A	G	2	3	5	0	0	5	0	0
9	55896288	.	C	G	2	4	6	0	1	7	0	0
9	55907368	.	T	G	2	2	4	0	1	5	0	0
9	55910395	.	A	G	2	2	4	0	0	4	0	0
9	55929700	.	T	G	1	2	3	0	0	3	0	0
9	55929706	.	T	C	0	2	2	0	0	2	0	0
9	56146336	.	C	T	2	3	5	0	0	5	0	0
9	56197522	.	G	A	2	2	4	0	0	4	0	0
9	56219139	.	T	C	0	4	4	0	0	4	0	0
9	56225740	.	T	A	9	9	18	0	1	19	0	0
9	56226132	.	T	C	3	2	5	0	1	6	0	0
9	56230655	.	A	G	32	39	71	1	2	74	0	0
9	56230676	.	G	T	34	33	67	1	3	71	0	0
9	56231322	.	T	C	35	29	64	2	7	73	0	0
9	56231325	.	A	G	39	31	70	2	2	74	0	0
9	56232588	.	C	G	6	7	13	0	0	13	0	0
9	56232646	.	C	A	5	9	14	0	0	14	0	0
9	56235538	.	C	T	8	6	14	0	1	15	0	0
9	56237883	.	T	C	10	9	19	0	0	19	0	0
9	56244635	.	G	T	5	10	15	1	1	17	0	0
9	56251467	.	C	T	0	7	7	0	5	12	0	0
9	56350968	.	C	T	0	9	9	0	4	13	0	0
9	56351059	.	C	T	11	9	20	0	0	20	0	0
9	56353479	.	G	A	10	14	24	0	1	25	0	0
9	56363292	.	T	A	6	12	18	0	1	19	0	0
9	56369168	.	G	T	14	11	25	0	3	28	0	0
9	56369252	.	G	A	19	13	32	0	0	32	0	0
9	56369319	.	C	A	9	13	22	0	1	23	0	0
9	56389303	.	A	G	12	16	28	0	1	29	0	0
9	56457309	.	A	T	2	8	10	0	1	11	0	0
