contig	position	variantID	refAllele	altAllele	refCount	altCount	totalCount	lowMAPQDepth	lowBaseQDepth	rawDepth	otherBases	improperPairs
1	6698	.	G	A	16	17	33	0	3	36	0	0
1	6746	.	T	C	23	4	27	1	34	62	0	0
1	10093	.	C	T	43	30	73	0	7	80	0	0
1	14083	.	G	A	0	7	7	0	5	12	0	0
1	15050	.	G	A	1	10	11	0	12	23	0	0
1	15772	.	G	A	2	6	8	0	11	19	0	0
1	15828	.	G	A	0	6	6	0	11	17	0	0
1	16050	.	C	A	3	0	3	0	3	6	0	0
1	16072	.	C	T	2	3	5	0	0	5	0	0
1	32450	.	T	C	8	11	19	0	2	21	0	0
1	33036	.	C	T	15	5	20	0	2	22	0	0
1	38106	.	C	T	12	10	22	0	2	24	0	0
1	38814	.	G	A	2	18	20	0	15	35	0	0
1	39620	.	C	A	0	4	4	0	3	7	0	0
1	39621	.	G	C	3	4	7	0	0	7	0	0
1	39717	.	T	G	2	8	10	0	1	11	0	0
1	41287	.	C	T	0	5	5	0	3	8	0	0
1	41560	.	G	A	5	4	9	0	1	10	0	0
1	42590	.	G	A	4	2	6	0	1	7	0	0
1	42698	.	G	A	1	4	5	0	0	5	0	0
1	46082	.	A	G	2	2	4	0	0	4	0	0
1	46097	.	G	A	2	3	5	0	0	5	0	0
1	62771	.	G	A	1	6	7	0	0	7	0	0
1	62838	.	C	T	4	3	7	0	0	7	0	0
1	118739	.	A	C	1	3	4	0	0	4	0	0
1	153527	.	A	G	3	12	15	0	0	15	0	0
1	154104	.	G	C	8	3	11	0	0	11	0	0
1	154113	.	G	A	7	4	11	0	0	11	0	0
1	154140	.	C	A	1	6	7	0	7	14	0	0
1	157915	.	T	A	1	7	8	0	1	9	0	0
1	160229	.	G	A	3	4	7	0	0	7	0	0
1	176642	.	C	T	10	6	16	0	0	16	0	0
1	176774	.	C	T	7	8	15	0	1	16	0	0
1	177349	.	A	G	6	2	8	0	6	14	0	0
1	177352	.	T	C	8	3	11	0	4	15	0	0
1	181717	.	T	C	20	10	30	0	2	32	0	0
1	181754	.	C	T	10	19	29	0	1	30	0	0
1	181763	.	A	G	9	16	25	0	1	26	0	0
1	185057	.	G	A	2	3	5	0	0	5	0	0
1	185191	.	C	T	2	4	6	0	0	6	0	0
1	186864	.	G	A	2	5	7	0	0	7	0	0
1	191914	.	C	G	5	3	8	0	0	8	0	0
1	208262	.	G	A	8	3	11	1	1	13	0	0
1	208265	.	G	A	9	3	12	1	1	14	0	0
1	208564	.	T	C	10	7	17	1	0	18	0	0
1	208570	.	T	C	5	13	18	1	0	19	0	0
1	209063	.	T	C	5	13	18	0	0	18	0	0
1	209113	.	T	C	3	11	14	0	2	16	0	0
1	212162	.	G	A	8	6	14	0	0	15	1	0
1	213203	.	G	C	12	1	13	0	12	25	0	0
1	220983	.	G	A	3	2	5	0	0	5	0	0
1	223511	.	T	C	6	2	8	0	0	8	0	0
1	223516	.	T	C	6	2	8	0	0	8	0	0
1	225044	.	G	A	0	9	9	0	12	21	0	0
1	225083	.	C	T	8	8	16	0	2	18	0	0
1	442456	.	T	C	3	2	5	1	0	6	0	0
1	443155	.	G	T	6	1	7	0	1	8	0	0
1	474321	.	A	G	3	5	8	0	1	9	0	0
1	474398	.	C	A	0	2	2	0	8	10	0	0
1	474465	.	C	T	11	4	15	0	2	17	0	0
1	474473	.	A	G	11	6	17	0	0	17	0	0
1	476034	.	G	A	7	4	11	0	1	12	0	0
1	477001	.	C	T	1	4	5	0	10	15	0	0
1	477109	.	C	T	0	8	8	0	3	11	0	0
1	477817	.	C	T	9	2	11	0	0	11	0	0
1	477823	.	G	C	9	3	12	0	0	12	0	0
1	477951	.	C	T	4	4	8	0	2	10	0	0
1	479986	.	A	G	2	2	4	0	3	7	0	0
1	483820	.	T	A	7	3	10	0	1	11	0	0
1	483821	.	C	T	5	4	9	0	1	10	0	0
1	483862	.	A	T	3	4	7	0	2	9	0	0
1	483873	.	C	T	4	4	8	0	0	8	0	0
1	484094	.	G	A	6	3	9	0	0	9	0	0
1	484590	.	C	T	2	5	7	0	0	7	0	0
1	486475	.	G	C	7	2	9	0	1	10	0	0
1	486667	.	T	C	4	0	4	0	3	7	0	0
1	486775	.	T	C	2	3	5	0	0	5	0	0
1	492141	.	T	C	2	3	5	0	0	5	0	0
1	492222	.	C	T	1	2	3	0	5	8	0	0
1	492231	.	C	A	1	6	7	0	0	7	0	0
1	496303	.	A	G	7	6	13	0	1	14	0	0
1	496305	.	A	C	8	6	14	0	0	14	0	0
1	496760	.	A	G	3	0	3	0	6	9	0	0
1	499220	.	A	G	5	5	10	0	0	10	0	0
1	501303	.	G	A	1	4	5	0	3	8	0	0
1	501381	.	T	A	5	4	9	0	1	10	0	0
1	502079	.	C	A	8	11	19	0	1	20	0	0
1	503900	.	C	T	9	11	20	0	0	20	0	0
1	504073	.	A	G	6	0	6	0	13	19	0	0
1	504663	.	C	G	13	5	18	0	1	19	0	0
1	504696	.	A	G	11	1	12	0	12	24	0	0
1	504912	.	C	A	5	3	8	1	2	11	0	0
1	505013	.	A	G	5	7	12	0	0	12	0	0
1	505178	.	G	A	8	8	16	1	0	17	0	0
1	505260	.	A	G	7	0	7	0	6	13	0	0
1	505298	.	C	T	9	7	16	0	1	17	0	0
1	505499	.	C	G	1	8	9	0	0	9	0	0
1	509222	.	T	G	1	5	6	0	0	6	0	0
1	509387	.	A	G	8	3	11	0	0	11	0	0
1	509769	.	G	T	6	4	10	0	0	10	0	0
1	511525	.	G	A	4	6	10	0	1	11	0	0
1	511544	.	C	T	5	8	13	0	0	13	0	0
1	511957	.	G	A	5	4	9	0	0	9	0	0
1	511968	.	A	T	3	3	6	0	0	6	0	0
1	512127	.	C	T	4	4	8	0	0	8	0	0
1	514114	.	G	A	0	2	2	0	4	6	0	0
1	514202	.	C	T	4	2	6	0	0	6	0	0
1	515549	.	G	A	2	3	5	0	1	6	0	0
1	515575	.	G	C	8	2	10	0	1	11	0	0
1	517515	.	C	T	7	10	17	0	0	17	0	0
1	524806	.	G	A	14	9	23	0	4	27	0	0
1	524828	.	C	T	12	11	23	0	1	24	0	0
1	528522	.	G	A	0	14	14	0	11	25	0	0
1	528552	.	A	C	14	12	26	0	1	27	0	0
1	530497	.	T	A	7	10	17	0	0	17	0	0
1	541062	.	A	G	1	2	3	0	0	3	0	0
1	546147	.	A	G	1	2	3	0	0	3	0	0
1	546198	.	C	T	1	3	4	0	0	4	0	0
1	552881	.	C	G	2	3	5	0	0	5	0	0
1	586161	.	G	A	2	6	8	0	7	15	0	0
1	586165	.	C	T	6	5	11	0	0	11	0	0
1	586765	.	C	T	3	4	7	0	0	7	0	0
1	587200	.	G	T	17	10	27	0	1	28	0	0
1	589044	.	A	T	14	11	25	0	2	27	0	0
1	589056	.	C	T	18	13	31	0	1	32	0	0
1	589115	.	G	A	2	13	15	0	17	32	0	0
1	601873	.	C	T	1	1	2	0	1	3	0	0
1	601882	.	G	A	1	3	4	0	0	4	0	0
1	603292	.	A	G	7	6	13	0	1	14	0	0
1	606128	.	A	C	4	11	15	0	2	17	0	0
1	610491	.	T	G	4	10	14	0	0	14	0	0
1	610507	.	T	C	6	0	6	0	10	16	0	0
1	610556	.	T	G	2	14	16	0	0	16	0	0
1	610722	.	T	C	10	17	27	0	0	27	0	0
1	611267	.	T	C	40	20	60	1	3	64	0	0
1	614568	.	C	G	1	17	18	0	13	31	0	0
1	617950	.	C	T	2	27	29	0	29	58	0	0
1	618190	.	A	C	33	2	35	0	28	63	0	0
1	618210	.	G	A	29	32	61	0	2	63	0	0
1	618277	.	A	G	21	31	52	0	4	56	0	0
1	618434	.	C	T	35	25	60	0	10	70	0	0
1	618760	.	C	T	0	12	12	0	15	27	0	0
1	618776	.	C	A	14	17	31	0	0	31	0	0
1	618826	.	C	T	17	11	28	0	1	29	0	0
1	618918	.	A	T	22	36	58	0	4	62	0	0
1	618932	.	A	G	25	37	62	0	2	64	0	0
1	619679	.	T	A	13	17	30	0	0	30	0	0
1	619703	.	C	T	3	16	19	0	19	38	0	0
1	620244	.	A	T	36	26	62	0	3	65	0	0
1	620314	.	G	A	26	31	57	0	3	60	0	0
1	620516	.	A	T	18	41	59	0	2	61	0	0
1	620517	.	T	G	18	41	59	0	2	61	0	0
1	621027	.	C	T	2	27	29	0	20	49	0	0
1	621063	.	T	A	18	19	37	0	0	38	1	0
1	621069	.	G	A	17	18	35	0	0	35	0	0
1	621102	.	A	T	14	13	27	0	6	33	0	0
1	621141	.	T	A	13	19	32	1	2	35	0	0
1	621283	.	C	T	3	28	31	0	19	50	0	0
1	621336	.	G	A	21	29	50	0	4	54	0	0
1	621440	.	C	T	27	25	52	0	2	54	0	0
1	626601	.	G	A	22	18	40	0	7	47	0	0
1	629610	.	G	A	23	11	34	0	0	34	0	0
1	629619	.	A	G	24	11	35	0	1	36	0	0
1	634882	.	T	C	20	12	32	1	3	36	0	0
1	634933	.	T	C	21	6	27	2	1	32	2	0
1	638431	.	C	T	4	14	18	0	22	40	0	0
1	692338	.	A	G	1	2	3	0	0	3	0	0
1	5273712	.	A	T	1	2	3	0	0	3	0	0
1	5273826	.	G	A	6	2	8	0	0	8	0	0
1	5273889	.	C	A	7	2	9	0	0	9	0	0
1	5275892	.	G	A	3	3	6	0	0	6	0	0
1	5276343	.	G	A	4	4	8	0	0	8	0	0
1	5276982	.	A	G	3	1	4	0	2	6	0	0
1	5354765	.	C	A	16	29	45	0	1	46	0	0
1	5354768	.	A	G	13	28	41	0	3	44	0	0
1	5354929	.	T	C	20	22	42	0	1	43	0	0
1	5355024	.	G	T	27	20	47	0	0	47	0	0
1	5355334	.	G	A	28	26	54	0	3	57	0	0
1	5355435	.	C	T	3	14	17	5	39	61	0	0
1	5355514	.	G	A	34	28	62	1	3	66	0	0
1	5355707	.	T	A	25	32	57	2	1	60	0	0
1	5355804	.	C	T	4	33	37	0	29	66	0	0
1	5356001	.	C	A	18	27	45	0	1	46	0	0
1	5356002	.	A	C	17	0	17	0	29	46	0	0
1	5356075	.	A	T	20	17	37	2	2	41	0	0
1	5356087	.	C	T	21	20	41	3	1	45	0	0
1	5356268	.	T	G	26	9	35	6	2	43	0	0
1	5356455	.	T	G	16	9	25	0	4	29	0	0
1	5356497	.	C	A	16	15	31	0	1	32	0	0
1	5356499	.	G	T	14	16	30	0	0	30	0	0
1	5356667	.	A	T	20	14	34	0	1	35	0	0
1	5356681	.	T	C	22	0	22	0	16	38	0	0
1	5357053	.	T	C	21	11	32	0	3	35	0	0
1	5357083	.	T	C	10	5	15	16	1	32	0	0
1	5357405	.	T	C	3	18	21	0	0	21	0	0
1	5357528	.	C	G	16	15	31	0	1	32	0	0
1	5357541	.	T	C	14	13	27	0	7	34	0	0
1	5357742	.	C	A	22	19	41	0	2	43	0	0
1	5357772	.	C	G	25	16	41	2	1	44	0	0
1	5357845	.	C	A	28	21	49	0	1	50	0	0
1	5357967	.	T	G	21	14	35	0	0	35	0	0
1	5358265	.	C	T	1	19	20	0	15	35	0	0
1	5358448	.	A	G	9	11	20	0	1	21	0	0
1	5358480	.	G	T	8	8	16	0	1	17	0	0
1	5358528	.	T	C	4	4	8	0	0	8	0	0
1	5358531	.	A	C	3	1	4	0	3	7	0	0
1	5358792	.	C	A	14	14	28	0	2	30	0	0
1	5365350	.	G	A	17	17	34	0	2	36	0	0
1	5365368	.	C	T	17	16	33	0	0	33	0	0
1	5375285	.	C	T	16	14	30	0	0	30	0	0
1	5378957	.	T	G	7	16	23	0	3	26	0	0
1	5402605	.	T	A	8	11	19	0	0	19	0	0
1	5414300	.	T	C	5	8	13	0	1	14	0	0
1	5414327	.	C	T	7	13	20	0	0	20	0	0
1	5415859	.	T	C	12	13	25	0	1	26	0	0
1	5415970	.	C	G	12	12	24	0	1	25	0	0
1	5418692	.	C	T	18	18	36	0	0	36	0	0
1	5418971	.	A	T	17	13	30	0	3	34	1	0
1	5419043	.	G	T	9	8	17	0	0	17	0	0
1	5422518	.	G	T	1	4	5	0	0	5	0	0
1	5425428	.	G	C	2	4	6	0	0	6	0	0
1	5430819	.	C	A	3	7	10	0	1	11	0	0
1	5433554	.	C	T	7	8	15	1	0	16	0	0
1	5433709	.	C	T	6	7	13	0	0	13	0	0
1	5433712	.	T	C	8	7	15	0	0	15	0	0
1	5433890	.	T	C	3	4	7	0	1	8	0	0
1	5503809	.	T	C	3	2	5	0	1	6	0	0
1	5503828	.	T	C	3	6	9	0	0	9	0	0
1	5503961	.	A	T	4	2	6	0	0	6	0	0
1	5507298	.	A	G	1	2	3	0	0	3	0	0
1	5606790	.	C	A	17	15	32	0	0	32	0	0
1	5607137	.	G	T	10	7	17	0	0	17	0	0
1	5607181	.	A	G	11	12	23	0	0	23	0	0
1	5607276	.	C	T	2	4	6	0	1	7	0	0
1	5607349	.	T	A	4	4	8	0	0	8	0	0
1	5607597	.	G	A	8	6	14	0	1	15	0	0
1	5607668	.	T	C	14	12	26	1	2	29	0	0
1	5607914	.	G	T	7	8	15	0	0	15	0	0
1	5607929	.	C	A	7	4	11	0	2	13	0	0
1	5607970	.	T	C	5	4	9	0	0	9	0	0
1	5608215	.	G	T	5	8	13	0	0	13	0	0
1	5631812	.	A	G	3	10	13	0	0	13	0	0
1	5631815	.	G	C	3	0	3	0	11	14	0	0
1	5641049	.	G	A	6	7	13	1	0	14	0	0
1	5671710	.	A	G	1	3	4	0	0	4	0	0
1	5675514	.	A	G	2	2	4	0	0	4	0	0
1	5681042	.	C	T	0	3	3	0	1	4	0	0
1	5681072	.	G	A	1	5	6	0	0	6	0	0
1	6137629	.	G	A	0	2	2	0	1	3	0	0
1	6144223	.	A	G	3	2	5	0	0	5	0	0
1	6146514	.	C	T	1	2	3	0	0	3	0	0
1	6149942	.	T	C	1	3	4	0	0	4	0	0
1	6153451	.	G	A	4	3	7	0	0	7	0	0
1	6158360	.	G	T	0	4	4	0	3	7	0	0
1	6158557	.	T	G	1	3	4	0	0	4	0	0
1	6165150	.	A	G	11	6	17	0	0	17	0	0
1	6165213	.	C	T	12	8	20	0	0	20	0	0
1	6165318	.	A	C	10	5	15	0	0	15	0	0
1	6167421	.	A	G	7	0	7	0	4	11	0	0
1	6168346	.	T	A	13	11	24	0	1	25	0	0
1	6168411	.	G	C	10	9	19	0	0	19	0	0
1	6168417	.	G	T	1	11	12	0	10	22	0	0
1	6168568	.	C	G	9	7	16	0	1	17	0	0
1	6168858	.	A	G	14	0	14	0	7	21	0	0
1	6168875	.	G	A	13	9	22	2	0	24	0	0
1	6168925	.	T	C	14	5	19	2	0	21	0	0
1	6169155	.	C	T	8	7	15	0	0	15	0	0
1	6169208	.	C	T	6	10	16	0	2	18	0	0
1	6169232	.	T	C	4	7	11	0	3	14	0	0
1	6169279	.	G	A	6	5	11	0	2	13	0	0
1	6169317	.	C	T	8	7	15	0	0	15	0	0
1	6169378	.	C	T	10	8	18	0	0	18	0	0
1	6169387	.	G	C	12	10	22	0	0	22	0	0
1	6169462	.	T	C	19	10	29	0	1	30	0	0
1	6169494	.	A	G	13	0	13	0	6	19	0	0
1	6169542	.	T	C	4	3	7	0	0	7	0	0
1	6169688	.	A	T	4	3	7	0	0	7	0	0
1	6169691	.	C	T	4	2	6	0	1	7	0	0
1	6173631	.	T	C	3	5	8	0	0	8	0	0
1	6175280	.	G	A	0	3	3	0	8	11	0	0
1	6185218	.	A	G	10	6	16	0	0	16	0	0
1	6185236	.	T	G	6	6	12	0	0	12	0	0
1	6185259	.	T	G	9	9	18	0	0	18	0	0
1	6185280	.	T	A	11	10	21	0	0	21	0	0
1	6185320	.	T	A	13	7	20	0	2	22	0	0
1	6185326	.	A	C	16	5	21	0	0	21	0	0
1	6185411	.	C	T	5	3	8	0	1	9	0	0
1	6190003	.	A	G	2	8	10	0	0	10	0	0
1	6190127	.	A	G	5	9	14	0	0	14	0	0
1	6201976	.	C	T	7	5	12	0	0	12	0	0
1	6206978	.	C	T	7	9	16	0	0	16	0	0
1	6207041	.	A	G	4	9	13	0	0	13	0	0
1	6209632	.	G	A	1	4	5	0	6	11	0	0
1	6209662	.	T	G	8	7	15	0	1	16	0	0
1	6209743	.	A	T	6	9	15	0	0	15	0	0
1	6209746	.	G	A	3	7	10	0	6	16	0	0
1	6210190	.	T	G	1	0	1	0	5	6	0	0
1	6210243	.	T	C	6	11	17	0	0	17	0	0
1	6210471	.	T	C	3	5	8	0	0	8	0	0
1	6225945	.	G	A	2	2	4	0	0	4	0	0
1	6226084	.	A	G	2	4	6	0	0	6	0	0
1	6231293	.	T	C	4	2	6	0	0	6	0	0
1	6231305	.	G	A	5	2	7	0	0	7	0	0
1	6236844	.	A	G	4	0	4	0	7	11	0	0
1	6236899	.	T	C	6	7	13	0	1	14	0	0
1	6238639	.	C	T	1	2	3	0	0	3	0	0
1	6241379	.	G	T	1	9	10	0	8	18	0	0
1	6244279	.	A	T	1	3	4	0	0	4	0	0
1	6244281	.	G	C	1	3	4	0	0	4	0	0
1	6252839	.	T	C	1	2	3	0	0	3	0	0
1	6254769	.	A	G	1	2	3	0	1	4	0	0
1	6257010	.	A	C	0	2	2	0	1	3	0	0
1	6262842	.	G	A	0	4	4	0	1	5	0	0
1	6264973	.	C	A	6	2	8	0	0	8	0	0
1	6269116	.	T	C	1	6	7	0	1	8	0	0
1	6271664	.	A	G	9	3	12	0	0	12	0	0
1	6271712	.	T	C	10	4	14	0	0	14	0	0
1	6271764	.	A	C	5	6	11	0	0	11	0	0
1	6272026	.	G	A	4	2	6	0	0	6	0	0
1	6272029	.	C	T	4	2	6	0	0	6	0	0
1	6357164	.	A	C	5	3	8	0	0	8	0	0
1	6357840	.	A	G	5	6	11	0	0	11	0	0
1	6364196	.	T	C	8	3	11	0	0	11	0	0
1	6365673	.	A	G	5	5	10	0	0	10	0	0
1	6365793	.	A	C	2	5	7	0	0	7	0	0
1	6366000	.	T	A	3	2	5	0	0	5	0	0
1	6366024	.	A	C	1	3	4	0	0	4	0	0
1	6404145	.	G	C	5	3	8	0	0	8	0	0
1	6429608	.	A	G	4	2	6	0	0	6	0	0
1	6429646	.	A	G	4	3	7	0	0	7	0	0
1	6494215	.	T	G	2	2	4	0	0	4	0	0
1	6494227	.	C	T	0	2	2	0	2	4	0	0
1	6646688	.	T	G	5	0	5	0	7	12	0	0
1	6648724	.	T	C	3	4	7	0	0	7	0	0
1	6662858	.	A	T	11	9	20	0	1	21	0	0
1	6663617	.	T	C	3	2	5	0	0	5	0	0
1	6663623	.	C	A	3	2	5	0	0	5	0	0
1	6663946	.	A	G	6	9	15	0	0	15	0	0
1	6667440	.	T	A	1	2	3	0	0	3	0	0
1	6909761	.	T	C	1	3	4	0	0	4	0	0
1	6918865	.	G	A	3	2	5	0	2	7	0	0
1	6924361	.	A	G	5	6	11	0	0	11	0	0
1	6924578	.	C	T	3	2	5	0	0	5	0	0
1	6924761	.	G	A	0	6	6	0	5	11	0	0
1	6924858	.	G	C	5	4	9	0	1	10	0	0
1	7518644	.	C	T	13	21	34	0	0	34	0	0
1	7522455	.	T	C	11	8	19	0	1	20	0	0
1	7523258	.	A	C	18	9	27	0	0	27	0	0
1	7523264	.	C	T	19	8	27	0	0	27	0	0
1	7526839	.	G	A	17	14	31	0	0	31	0	0
1	7528289	.	G	C	1	20	21	0	21	42	0	0
1	7529723	.	T	C	25	21	46	0	1	47	0	0
1	7529752	.	G	A	27	23	50	0	2	52	0	0
1	7529833	.	G	C	5	28	33	0	24	57	0	0
1	7530123	.	C	T	20	35	55	0	4	59	0	0
1	7538822	.	C	T	33	15	48	0	0	48	0	0
1	7539053	.	G	C	25	11	36	0	0	36	0	0
1	7559902	.	G	A	3	15	18	1	32	51	0	0
1	7632221	.	C	T	3	4	7	0	0	7	0	0
1	7662571	.	T	C	19	23	42	0	0	42	0	0
1	7662628	.	G	A	24	20	44	0	0	44	0	0
1	7662723	.	T	A	11	26	37	0	0	37	0	0
1	7662728	.	G	A	12	25	37	0	1	38	0	0
1	7662880	.	A	T	25	19	44	0	0	44	0	0
1	7670535	.	C	T	19	29	48	0	1	49	0	0
1	7672794	.	T	C	25	28	53	0	3	56	0	0
1	7672809	.	C	T	27	29	56	0	4	60	0	0
1	7673070	.	C	T	26	15	41	0	4	45	0	0
1	7673129	.	C	A	15	18	33	0	1	34	0	0
1	7673198	.	A	G	13	19	32	0	1	33	0	0
1	7682949	.	G	A	6	8	14	0	0	14	0	0
1	7874950	.	A	G	1	4	5	0	0	5	0	0
1	7874992	.	A	G	1	3	4	0	0	4	0	0
1	7875057	.	G	A	3	2	5	0	0	5	0	0
1	8022495	.	C	T	9	13	22	0	0	22	0	0
1	8022532	.	A	G	17	14	31	0	0	31	0	0
1	8022606	.	T	C	8	10	18	0	1	19	0	0
1	8022682	.	C	T	1	17	18	0	10	28	0	0
1	8023433	.	C	T	18	8	26	0	0	26	0	0
1	8023587	.	A	G	13	18	31	0	0	31	0	0
1	8023730	.	C	T	17	17	34	0	1	35	0	0
1	8024087	.	G	A	11	22	33	1	0	34	0	0
1	8025863	.	C	T	21	17	38	0	1	39	0	0
1	8026146	.	C	T	11	17	28	0	5	33	0	0
1	8026148	.	T	G	10	19	29	0	4	33	0	0
1	8026293	.	G	T	25	10	35	0	1	36	0	0
1	8026345	.	C	T	20	11	31	0	2	33	0	0
1	8026415	.	C	T	1	17	18	0	16	34	0	0
1	8026521	.	C	A	1	22	23	0	15	38	0	0
1	8026565	.	C	T	15	16	31	0	1	32	0	0
1	8026924	.	T	A	11	5	16	0	2	18	0	0
1	8028177	.	T	A	12	8	20	0	2	22	0	0
1	8028652	.	G	A	16	9	25	0	2	27	0	0
1	8028688	.	C	A	13	19	32	0	2	34	0	0
1	8028727	.	G	A	13	13	26	0	2	28	0	0
1	8028811	.	C	T	0	12	12	0	20	32	0	0
1	8032800	.	T	C	9	5	14	0	1	15	0	0
1	8032947	.	G	A	10	14	24	0	0	24	0	0
1	8032986	.	A	G	9	8	17	0	0	17	0	0
1	8047508	.	C	T	7	3	10	0	0	10	0	0
1	8049495	.	C	T	1	10	11	0	6	17	0	0
1	8051513	.	G	A	9	8	17	0	0	17	0	0
1	8055927	.	T	C	10	0	10	0	8	18	0	0
1	8055954	.	A	G	9	5	14	0	1	15	0	0
1	8058005	.	A	G	8	5	13	0	0	13	0	0
1	8129107	.	C	T	0	3	3	0	1	4	0	0
1	8129571	.	A	G	3	2	5	0	0	5	0	0
1	8129606	.	C	T	2	2	4	0	0	4	0	0
1	8129610	.	G	A	2	2	4	0	0	4	0	0
1	8159982	.	C	T	3	2	5	0	0	5	0	0
1	8165443	.	A	C	7	3	10	0	3	13	0	0
1	8165609	.	C	T	10	5	15	0	0	15	0	0
1	8165643	.	T	C	5	3	8	0	1	9	0	0
1	8166788	.	A	T	13	11	24	0	0	24	0	0
1	8166992	.	A	G	10	6	16	0	4	20	0	0
1	8167118	.	C	A	5	4	9	0	1	10	0	0
1	8167368	.	G	A	10	4	14	0	0	14	0	0
1	8167508	.	A	G	11	12	23	0	0	23	0	0
1	8167526	.	C	T	11	8	19	0	1	20	0	0
1	8167570	.	C	G	11	4	15	0	0	15	0	0
1	8167668	.	G	A	12	13	25	0	0	25	0	0
1	8169262	.	C	T	9	8	17	0	1	18	0	0
1	8169268	.	C	T	9	7	16	0	0	16	0	0
1	8169361	.	G	A	9	7	16	0	1	17	0	0
1	8185072	.	G	A	16	6	22	0	1	23	0	0
1	8185103	.	G	A	14	12	26	0	0	26	0	0
1	8189518	.	G	T	9	5	14	0	0	14	0	0
1	8192188	.	C	G	1	8	9	0	0	9	0	0
1	8192192	.	A	G	1	8	9	0	0	9	0	0
1	8192344	.	A	C	11	12	23	0	0	23	0	0
1	8192382	.	T	A	4	4	8	0	0	8	0	0
1	8403299	.	G	A	0	2	2	0	1	3	0	0
1	8403608	.	C	T	2	3	5	0	0	5	0	0
1	8416565	.	T	A	36	25	61	0	4	65	0	0
1	8416629	.	T	G	26	26	52	0	0	53	1	0
1	8416820	.	C	T	3	6	9	0	0	9	0	0
1	8417896	.	T	C	18	25	43	0	0	43	0	0
1	8417943	.	A	G	18	11	29	0	3	32	0	0
1	8418118	.	C	G	10	6	16	0	1	17	0	0
1	8418126	.	A	C	7	0	7	0	8	15	0	0
1	8422521	.	A	G	18	23	41	0	2	43	0	0
1	8424738	.	C	T	3	27	30	0	13	43	0	0
1	8424804	.	C	T	12	19	31	0	5	36	0	0
1	8424813	.	A	G	10	21	31	0	2	33	0	0
1	8508755	.	G	A	2	6	8	0	5	13	0	0
1	8508809	.	G	T	8	9	17	0	0	18	1	0
1	8508950	.	T	C	5	8	13	0	2	15	0	0
1	8511602	.	C	T	11	9	20	0	0	20	0	0
1	8511778	.	G	T	0	13	13	0	13	26	0	0
1	8516407	.	G	A	2	15	17	0	15	32	0	0
1	8516443	.	C	G	15	14	29	0	1	30	0	0
1	8516552	.	A	G	8	7	15	0	2	17	0	0
1	8530336	.	G	A	0	2	2	0	2	4	0	0
1	8530943	.	G	A	0	2	2	0	1	3	0	0
1	8531224	.	A	C	2	2	4	0	0	4	0	0
1	8531249	.	G	T	3	5	8	0	1	9	0	0
1	8531260	.	A	G	5	5	10	0	0	10	0	0
1	8531485	.	T	G	2	5	7	0	0	7	0	0
1	8531494	.	A	G	2	3	5	0	0	5	0	0
1	8531797	.	G	A	2	6	8	0	0	8	0	0
1	8531852	.	G	A	2	3	5	0	0	5	0	0
1	8531866	.	G	T	1	3	4	0	0	4	0	0
1	8543337	.	T	A	4	4	8	0	0	8	0	0
1	8543380	.	G	A	3	5	8	0	0	8	0	0
1	8543390	.	C	T	3	3	6	0	1	7	0	0
1	8543707	.	A	G	3	6	9	0	0	9	0	0
1	8544457	.	C	T	3	5	8	0	2	10	0	0
1	8544483	.	G	A	4	6	10	0	0	10	0	0
1	8546565	.	C	A	0	3	3	0	1	4	0	0
1	8547315	.	G	C	3	0	3	0	3	6	0	0
1	8550143	.	T	C	2	1	3	0	3	6	0	0
1	8550146	.	T	C	2	4	6	0	0	6	0	0
1	8555582	.	C	G	8	2	10	0	0	10	0	0
1	8557099	.	C	T	0	3	3	0	6	9	0	0
1	8559950	.	G	T	5	2	7	0	0	7	0	0
1	8559967	.	A	G	5	2	7	0	0	7	0	0
1	8560072	.	A	G	5	3	8	0	0	8	0	0
1	8560208	.	G	A	4	3	7	0	0	7	0	0
1	8560237	.	C	T	4	4	8	0	0	8	0	0
1	8560266	.	C	T	2	3	5	0	0	5	0	0
1	8563728	.	C	T	6	3	9	0	1	10	0	0
1	8563755	.	A	G	3	5	8	0	0	8	0	0
1	8563792	.	G	A	5	2	7	0	1	8	0	0
1	8564058	.	C	T	2	6	8	0	0	8	0	0
1	8566545	.	T	C	1	3	4	0	0	4	0	0
1	8601971	.	A	T	6	4	10	0	2	12	0	0
1	8601990	.	A	T	9	7	16	0	1	17	0	0
1	8606561	.	C	T	1	8	9	0	0	9	0	0
1	8606611	.	T	C	4	2	6	0	0	6	0	0
1	8606644	.	G	A	3	3	6	0	1	7	0	0
1	8607487	.	C	T	5	11	16	0	0	16	0	0
1	8607547	.	C	T	5	6	11	0	0	11	0	0
1	8607556	.	T	C	6	7	13	0	0	13	0	0
1	8608008	.	T	C	10	3	13	0	0	13	0	0
1	8610451	.	G	A	0	14	14	0	9	23	0	0
1	8638537	.	T	G	2	4	6	0	0	6	0	0
1	8639877	.	G	A	4	4	8	1	1	10	0	0
1	8639883	.	G	A	3	5	8	1	0	9	0	0
1	8642824	.	A	T	3	2	5	0	0	5	0	0
1	8642938	.	A	G	4	3	7	0	0	7	0	0
1	8642953	.	C	T	4	5	9	0	0	9	0	0
1	8643661	.	T	A	1	2	3	0	0	3	0	0
1	8649726	.	A	G	36	38	74	2	4	80	0	0
1	8649865	.	C	T	44	25	69	1	1	71	0	0
1	8649988	.	A	G	40	29	69	1	2	72	0	0
1	8649994	.	A	T	40	30	70	0	4	74	0	0
1	8650317	.	G	A	32	29	61	0	4	66	1	0
1	8650371	.	C	T	34	31	65	1	1	67	0	0
1	8651036	.	G	A	33	31	64	0	0	64	0	0
1	8651060	.	T	C	34	31	65	0	2	67	0	0
1	8651576	.	G	A	26	39	65	2	1	68	0	0
1	8662553	.	G	A	19	17	36	0	2	38	0	0
1	8663048	.	G	A	2	12	14	0	12	26	0	0
1	8663195	.	T	G	22	9	31	0	3	34	0	0
1	8663295	.	T	C	17	20	37	0	1	38	0	0
1	8667377	.	G	A	22	14	36	0	1	37	0	0
1	8667606	.	C	T	19	24	43	0	1	44	0	0
1	8668166	.	T	C	32	19	51	0	0	51	0	0
1	8668238	.	G	T	32	25	57	0	2	59	0	0
1	8669669	.	A	G	18	16	34	0	1	35	0	0
1	8669673	.	A	G	25	9	34	0	0	34	0	0
1	8669717	.	T	G	15	21	36	0	1	37	0	0
1	8669718	.	T	C	13	22	35	0	1	36	0	0
1	8669753	.	T	A	14	20	34	1	0	35	0	0
1	8669847	.	G	T	28	20	48	0	6	54	0	0
1	8670031	.	T	C	32	28	60	0	2	62	0	0
1	8670032	.	G	T	3	31	34	0	30	64	0	0
1	8670159	.	T	C	30	22	52	0	2	54	0	0
1	8670180	.	T	C	24	30	54	0	3	57	0	0
1	8670402	.	G	A	24	16	40	0	2	42	0	0
1	8694404	.	G	A	15	16	31	0	1	32	0	0
1	8698765	.	T	C	21	19	40	0	3	43	0	0
1	8701548	.	A	G	18	0	18	0	27	45	0	0
1	8702325	.	G	T	17	18	35	0	0	35	0	0
1	8702400	.	T	C	28	22	50	0	1	51	0	0
1	8764123	.	C	T	6	9	15	0	1	16	0	0
1	8765028	.	G	A	6	12	18	0	2	20	0	0
1	8765491	.	T	A	16	15	31	2	1	34	0	0
1	8765493	.	G	T	9	15	24	2	3	29	0	0
1	8766453	.	C	T	22	16	38	0	0	38	0	0
1	8766471	.	C	T	0	14	14	0	19	33	0	0
1	8766501	.	C	T	16	11	27	0	2	29	0	0
1	8766693	.	G	A	16	9	25	0	0	25	0	0
1	8766903	.	G	C	15	4	19	0	0	19	0	0
1	8771020	.	T	G	5	5	10	0	1	11	0	0
1	8773257	.	G	A	2	5	7	0	0	7	0	0
1	8773269	.	T	C	9	3	12	0	0	12	0	0
1	8777796	.	C	A	3	4	7	0	0	7	0	0
1	8917623	.	C	T	5	3	8	0	0	8	0	0
1	9044526	.	C	T	6	14	20	0	4	24	0	0
1	9044745	.	C	T	10	8	18	0	3	22	1	0
1	9051092	.	T	C	20	11	31	0	0	31	0	0
1	9064781	.	T	G	6	2	8	0	0	8	0	0
1	9064791	.	C	A	3	6	9	0	1	10	0	0
1	9064885	.	C	A	4	2	6	0	0	6	0	0
1	9074335	.	C	T	16	14	30	0	0	30	0	0
1	9118497	.	T	A	23	21	44	0	3	47	0	0
1	9123289	.	C	G	15	15	30	3	1	34	0	0
1	9156228	.	T	C	1	3	4	0	0	4	0	0
1	9161236	.	A	T	2	2	4	0	0	4	0	0
1	9161423	.	G	A	0	3	3	0	3	6	0	0
1	9161472	.	G	A	2	2	4	0	0	4	0	0
1	9261903	.	A	C	11	0	11	0	9	20	0	0
1	9261930	.	G	A	11	7	18	0	0	18	0	0
1	9262173	.	G	A	23	19	42	0	0	42	0	0
1	9262221	.	A	G	14	8	22	0	2	24	0	0
1	9265578	.	T	C	4	8	12	0	1	13	0	0
1	9270885	.	G	A	6	8	14	0	0	14	0	0
1	9270933	.	C	T	10	7	17	0	0	17	0	0
1	9273011	.	C	T	5	7	12	0	1	13	0	0
1	9273037	.	A	G	7	7	14	0	0	14	0	0
1	9273173	.	G	A	10	5	15	0	0	15	0	0
1	9273347	.	A	G	6	6	12	1	1	14	0	0
1	9278150	.	G	A	8	7	15	0	0	15	0	0
1	9290319	.	A	G	3	11	14	0	1	15	0	0
1	9290432	.	T	A	9	3	12	0	0	13	1	0
1	9292975	.	A	T	4	6	10	0	0	10	0	0
1	9293002	.	T	C	5	4	9	0	2	11	0	0
1	9293495	.	A	G	12	12	24	0	2	26	0	0
1	9499764	.	C	T	14	7	21	0	1	22	0	0
1	9500312	.	A	T	5	9	14	0	0	14	0	0
1	9500332	.	T	C	4	2	6	0	1	9	2	0
1	9500455	.	T	C	1	2	3	0	1	4	0	0
1	9500585	.	T	G	3	9	12	0	0	12	0	0
1	9500598	.	T	G	4	7	11	0	0	11	0	0
1	9500699	.	T	C	5	4	9	0	1	10	0	0
1	9500835	.	A	G	8	6	14	0	0	14	0	0
1	9500947	.	G	T	7	6	13	0	0	13	0	0
1	9500984	.	A	T	4	4	8	0	0	8	0	0
1	9501011	.	T	C	4	2	6	0	0	6	0	0
1	9501229	.	C	T	13	7	20	0	1	21	0	0
1	9501231	.	G	A	7	13	20	0	0	20	0	0
1	9501365	.	T	C	16	0	16	0	10	26	0	0
1	9501394	.	T	A	10	14	24	0	0	24	0	0
1	9508752	.	T	A	7	9	16	0	0	16	0	0
1	9510571	.	A	G	6	4	10	0	0	10	0	0
1	9510574	.	G	A	6	3	9	0	2	11	0	0
1	9512342	.	C	T	5	8	13	0	1	14	0	0
1	9516905	.	A	C	4	3	7	0	0	7	0	0
1	9523283	.	C	T	0	3	3	0	1	4	0	0
1	9527076	.	T	A	1	2	3	1	0	4	0	0
1	9557456	.	T	C	1	4	5	0	0	5	0	0
1	9618201	.	C	T	1	2	3	1	0	4	0	0
1	9618241	.	A	G	1	3	4	1	0	5	0	0
1	9709500	.	G	A	2	2	4	0	1	5	0	0
1	9710759	.	C	T	4	2	6	0	1	7	0	0
1	9710853	.	T	C	3	3	6	0	1	7	0	0
1	9711593	.	A	C	4	5	9	0	0	9	0	0
1	9711740	.	G	C	5	4	9	0	1	10	0	0
1	9711956	.	A	G	7	3	10	0	0	10	0	0
1	9712111	.	G	A	1	5	6	0	4	10	0	0
1	9793219	.	C	T	1	4	5	0	0	5	0	0
1	9793220	.	T	C	1	4	5	0	0	5	0	0
1	9793286	.	C	T	3	2	5	0	0	5	0	0
1	9808324	.	A	G	4	4	8	0	1	9	0	0
1	9808345	.	T	A	4	4	8	0	0	8	0	0
1	9808365	.	C	T	3	3	6	0	1	7	0	0
1	9858447	.	C	T	0	3	3	0	1	4	0	0
1	9858451	.	G	A	1	3	4	0	0	4	0	0
1	9865364	.	G	T	2	2	4	0	0	4	0	0
1	9873485	.	G	A	7	3	10	0	0	10	0	0
1	9873509	.	G	A	9	3	12	0	0	12	0	0
1	9873538	.	G	A	10	4	14	0	0	14	0	0
1	9873607	.	A	T	5	5	10	0	3	13	0	0
1	9873616	.	T	C	0	1	1	0	13	14	0	0
1	9873787	.	G	A	6	6	12	0	1	13	0	0
1	9877335	.	A	G	3	2	5	0	0	5	0	0
1	9885305	.	G	T	2	2	4	0	0	4	0	0
1	9893616	.	T	C	1	1	2	0	1	3	0	0
1	9909819	.	T	C	4	2	6	0	0	6	0	0
1	9909867	.	C	A	2	2	4	0	0	4	0	0
1	9914164	.	C	T	3	2	5	0	0	5	0	0
1	9920359	.	G	A	5	3	8	0	1	9	0	0
1	9920631	.	G	A	5	4	9	0	0	9	0	0
1	10646944	.	A	G	1	2	3	1	0	4	0	0
1	10646981	.	C	T	1	2	3	0	0	3	0	0
1	10646983	.	G	T	1	1	2	0	1	3	0	0
1	10675629	.	A	T	3	3	6	0	0	6	0	0
1	10680513	.	A	G	2	2	4	0	0	4	0	0
1	10680518	.	C	T	0	2	2	0	2	4	0	0
1	10683868	.	A	T	14	11	25	0	2	27	0	0
1	10683955	.	A	G	20	12	32	0	2	34	0	0
1	10683974	.	A	C	16	16	32	0	0	32	0	0
1	10684037	.	A	G	12	0	12	0	17	29	0	0
1	10684105	.	G	A	4	12	16	0	19	35	0	0
1	10688731	.	T	G	15	1	16	0	11	27	0	0
1	10692078	.	T	C	23	11	34	1	0	35	0	0
1	10692090	.	G	A	22	12	34	0	1	35	0	0
1	10736181	.	G	A	29	27	56	0	0	56	0	0
1	10738177	.	A	G	16	13	29	1	0	30	0	0
1	10738509	.	T	C	36	27	63	0	2	65	0	0
1	10738535	.	G	A	40	29	69	0	1	70	0	0
1	10738568	.	A	G	38	2	40	0	28	68	0	0
1	10738863	.	C	A	23	37	60	0	12	72	0	0
1	10739190	.	A	G	44	14	58	1	6	65	0	0
1	10841254	.	T	C	6	12	18	0	1	19	0	0
1	10841275	.	T	C	8	9	17	0	0	17	0	0
1	10841356	.	G	A	4	6	10	0	0	10	0	0
1	10885173	.	A	C	1	3	4	0	0	4	0	0
1	10885266	.	T	A	4	4	8	0	0	8	0	0
1	10897373	.	A	G	2	2	4	0	0	4	0	0
1	10912132	.	C	T	1	2	3	0	1	4	0	0
1	10950594	.	C	T	0	2	2	0	1	3	0	0
1	11125074	.	T	A	3	4	7	0	0	7	0	0
1	11125237	.	G	A	6	4	10	0	0	10	0	0
1	11125249	.	A	C	7	6	13	0	1	14	0	0
1	11127938	.	G	A	2	5	7	0	0	7	0	0
1	11128515	.	C	A	0	3	3	0	3	6	0	0
1	11132905	.	C	T	0	2	2	0	1	3	0	0
1	11136648	.	G	A	4	2	6	0	0	6	0	0
1	11139245	.	C	G	0	2	2	0	1	3	0	0
1	11141082	.	C	T	5	4	9	0	1	10	0	0
1	11144295	.	T	C	2	6	8	0	0	8	0	0
1	11155084	.	A	T	2	2	4	0	0	4	0	0
1	11216633	.	A	G	3	3	6	0	0	6	0	0
1	11275073	.	A	G	4	3	7	0	0	7	0	0
1	11671042	.	T	C	4	3	7	0	1	8	0	0
1	11671059	.	A	G	4	5	9	0	0	9	0	0
1	11671355	.	C	A	8	8	16	0	0	16	0	0
1	11671527	.	G	A	5	10	15	0	1	16	0	0
1	11671580	.	C	T	7	5	12	0	1	13	0	0
1	11671651	.	A	C	3	5	8	0	1	9	0	0
1	11695068	.	C	A	3	0	3	0	0	3	0	0
1	11783504	.	T	C	19	11	30	0	1	31	0	0
1	11783650	.	T	C	20	18	38	0	0	38	0	0
1	11784522	.	T	C	32	16	48	0	2	50	0	0
1	15254249	.	A	G	8	0	8	0	8	16	0	0
1	17534734	.	C	T	1	5	6	0	0	6	0	0
1	17535295	.	A	G	5	2	7	0	0	7	0	0
1	17535859	.	A	G	4	4	8	0	0	8	0	0
1	19609625	.	T	C	2	2	4	0	1	5	0	0
1	21341577	.	T	C	13	25	38	2	2	42	0	0
1	21610764	.	T	C	2	1	3	0	3	6	0	0
1	21611043	.	T	C	5	1	6	0	1	7	0	0
1	22806206	.	T	C	2	6	8	1	0	9	0	0
1	22807110	.	T	C	13	0	13	0	9	22	0	0
1	23943726	.	G	A	1	8	9	0	0	9	0	0
1	26094122	.	A	G	5	2	7	0	0	7	0	0
1	26385225	.	A	G	7	4	11	0	1	12	0	0
1	28834552	.	T	C	3	2	5	0	1	6	0	0
1	29174928	.	G	A	1	2	3	5	0	8	0	0
1	31072037	.	C	T	3	8	11	0	0	11	0	0
1	31083171	.	A	T	1	5	6	0	2	8	0	0
1	32098373	.	A	G	5	2	7	0	0	7	0	0
1	34233301	.	A	G	13	0	13	0	10	23	0	0
1	34233312	.	A	G	12	6	18	0	1	19	0	0
1	34540342	.	T	C	1	2	3	0	1	4	0	0
1	34686269	.	T	C	1	5	6	0	0	6	0	0
1	37083706	.	C	T	0	2	2	0	4	6	0	0
1	37083817	.	C	T	0	4	4	0	2	6	0	0
1	37196220	.	T	A	4	4	8	0	0	8	0	0
1	37196228	.	A	G	3	4	7	0	0	7	0	0
1	37212301	.	T	A	2	6	8	0	0	8	0	0
1	37212331	.	C	T	1	3	4	0	1	5	0	0
1	37284382	.	C	T	7	5	12	0	0	12	0	0
1	37287291	.	A	T	6	5	11	0	1	12	0	0
1	37287294	.	G	A	7	7	14	0	0	14	0	0
1	37291884	.	A	C	13	4	17	0	1	18	0	0
1	37304354	.	C	A	19	9	28	0	2	30	0	0
1	37304439	.	C	T	14	10	24	0	0	24	0	0
1	37304494	.	T	A	13	8	21	0	0	21	0	0
1	37304510	.	T	G	14	8	22	0	0	22	0	0
1	37304536	.	G	A	11	6	17	0	0	17	0	0
1	37304929	.	G	A	5	6	11	1	5	17	0	0
1	37305225	.	A	G	7	4	11	0	0	11	0	0
1	37306726	.	G	T	1	15	16	0	20	36	0	0
1	37306913	.	T	A	15	11	26	0	2	28	0	0
1	37306942	.	A	C	17	10	27	0	1	28	0	0
1	37339689	.	T	C	1	3	4	0	0	4	0	0
1	37344832	.	T	C	7	4	11	0	0	11	0	0
1	37353355	.	C	T	4	4	8	0	0	8	0	0
1	37355591	.	G	A	6	4	10	0	0	10	0	0
1	37355606	.	C	T	4	3	7	0	1	8	0	0
1	37359071	.	C	T	4	3	7	0	0	7	0	0
1	37359221	.	G	C	5	6	11	0	1	12	0	0
1	37359352	.	A	G	4	7	11	0	1	12	0	0
1	37361554	.	A	G	4	8	12	0	0	12	0	0
1	37361759	.	C	T	12	8	20	0	1	22	1	0
1	37361879	.	T	A	5	6	11	0	0	11	0	0
1	37361919	.	T	C	3	2	5	0	1	6	0	0
1	37361960	.	C	T	2	3	5	0	0	5	0	0
1	37399725	.	G	C	1	1	2	0	0	2	0	0
1	37399731	.	A	G	1	0	1	0	2	3	0	0
1	37752392	.	A	G	4	0	4	0	4	8	0	0
1	37752478	.	G	C	3	6	9	0	0	9	0	0
1	38125431	.	C	A	13	8	21	0	0	21	0	0
1	38125684	.	T	C	19	14	33	0	0	33	0	0
1	38131058	.	C	T	22	13	35	0	0	35	0	0
1	38131073	.	T	C	12	21	33	0	0	33	0	0
1	38131094	.	G	A	21	11	32	0	2	34	0	0
1	38131360	.	G	A	23	32	55	0	2	57	0	0
1	38131486	.	G	A	19	15	34	0	1	35	0	0
1	38131812	.	T	C	1	3	4	0	0	4	0	0
1	38131873	.	C	T	4	3	7	0	1	8	0	0
1	38132245	.	A	C	3	3	6	0	0	6	0	0
1	38132254	.	A	C	1	3	4	0	0	4	0	0
1	38142998	.	G	T	6	5	11	0	1	12	0	0
1	38150605	.	A	C	7	4	11	0	1	12	0	0
1	38163017	.	C	T	9	10	19	0	1	20	0	0
1	38163132	.	G	A	8	16	24	0	2	26	0	0
1	38166009	.	G	C	7	11	18	0	0	18	0	0
1	38166268	.	A	C	11	14	25	0	3	28	0	0
1	38166429	.	T	C	22	17	39	0	1	40	0	0
1	38166431	.	T	G	23	17	40	0	0	40	0	0
1	38166520	.	A	G	14	12	26	0	3	29	0	0
1	38169972	.	T	G	18	16	34	0	3	37	0	0
1	38170553	.	G	A	14	15	29	0	2	31	0	0
1	38346162	.	C	T	0	7	7	1	6	14	0	0
1	38346475	.	C	T	0	6	6	0	2	8	0	0
1	38346578	.	G	T	3	3	6	0	1	7	0	0
1	38346649	.	C	T	2	4	6	0	4	10	0	0
1	38346739	.	G	A	3	9	12	0	1	13	0	0
1	38416477	.	G	A	2	3	5	0	0	5	0	0
1	38417116	.	A	T	2	2	4	0	0	4	0	0
1	38417268	.	A	T	7	8	15	0	0	15	0	0
1	38417332	.	A	G	4	9	13	0	0	13	0	0
1	38417370	.	G	A	13	5	18	0	0	18	0	0
1	38417531	.	G	T	3	9	12	0	0	12	0	0
1	38417571	.	G	T	2	6	8	0	0	8	0	0
1	38417588	.	T	G	6	4	10	0	0	10	0	0
1	38417617	.	A	T	6	3	9	0	0	9	0	0
1	38417625	.	A	T	4	5	9	0	2	11	0	0
1	38417680	.	T	A	4	3	7	0	0	7	0	0
1	38417757	.	G	A	4	1	5	0	1	6	0	0
1	38417758	.	T	C	4	2	6	0	0	6	0	0
1	38418087	.	C	T	6	6	12	0	0	12	0	0
1	38418243	.	A	G	4	4	8	0	1	9	0	0
1	38418294	.	G	T	6	5	11	0	0	11	0	0
1	38466714	.	G	A	2	3	5	0	0	5	0	0
1	38649340	.	A	G	31	34	65	0	0	65	0	0
1	38649947	.	G	A	42	24	66	0	2	68	0	0
1	38650132	.	G	T	29	32	61	0	2	63	0	0
1	38650298	.	G	A	26	29	55	0	0	55	0	0
1	38650382	.	G	C	35	22	57	0	6	63	0	0
1	38650467	.	A	G	30	29	59	1	8	68	0	0
1	38650510	.	G	C	30	30	60	0	4	65	1	0
1	38650516	.	T	C	33	34	67	0	2	69	0	0
1	38650545	.	T	C	34	36	70	0	3	73	0	0
1	38651063	.	G	T	45	31	76	0	2	78	0	0
1	38651065	.	T	A	45	31	76	0	3	79	0	0
1	38651361	.	C	T	22	15	37	0	0	37	0	0
1	38651370	.	G	A	18	15	33	0	3	36	0	0
1	38651469	.	C	A	14	21	35	0	3	38	0	0
1	38651822	.	G	A	7	9	16	0	1	17	0	0
1	38655522	.	C	T	5	28	33	2	33	68	0	0
1	38657689	.	G	A	30	26	56	0	2	58	0	0
1	38660240	.	T	C	31	2	33	0	28	61	0	0
1	38660252	.	A	G	27	32	59	0	2	61	0	0
1	38660369	.	G	A	27	30	57	0	0	57	0	0
1	38709351	.	A	C	11	0	11	1	9	21	0	0
1	38709381	.	G	C	8	5	13	1	0	14	0	0
1	38709480	.	G	A	6	9	15	0	0	15	0	0
1	38709535	.	T	A	6	11	17	0	0	17	0	0
1	38784551	.	A	T	4	3	7	0	0	7	0	0
1	38787039	.	C	T	5	2	7	0	0	7	0	0
1	38791569	.	C	T	11	8	19	0	1	20	0	0
1	38793983	.	G	A	6	9	15	0	0	15	0	0
1	38797663	.	A	C	9	15	24	0	1	25	0	0
1	38799513	.	G	A	14	14	28	0	0	28	0	0
1	38799585	.	A	G	10	9	19	0	1	20	0	0
1	38799588	.	T	A	11	10	21	0	1	22	0	0
1	38802537	.	G	A	10	14	24	0	0	24	0	0
1	38802703	.	A	G	13	13	26	0	4	30	0	0
1	38802718	.	G	A	16	15	31	0	2	33	0	0
1	38802747	.	A	G	12	0	12	0	11	23	0	0
1	38802855	.	C	A	12	5	17	0	1	18	0	0
1	38803033	.	T	C	6	2	8	0	1	9	0	0
1	38803042	.	A	C	6	2	8	0	0	8	0	0
1	38803092	.	C	T	10	7	17	1	0	18	0	0
1	38803127	.	C	T	11	8	19	1	0	20	0	0
1	38803154	.	T	A	10	6	16	0	0	16	0	0
1	38803205	.	A	T	11	8	19	0	3	22	0	0
1	38803404	.	A	G	8	11	19	0	2	21	0	0
1	38805128	.	G	T	8	2	10	0	0	10	0	0
1	38805135	.	C	T	7	3	10	0	0	10	0	0
1	38805439	.	G	A	18	9	27	0	0	27	0	0
1	38805450	.	A	G	19	10	29	0	0	29	0	0
1	38805506	.	G	A	21	17	38	0	0	38	0	0
1	38807255	.	G	C	17	9	26	0	2	28	0	0
1	38808259	.	C	A	9	9	18	0	0	18	0	0
1	38808379	.	C	T	1	9	10	0	8	18	0	0
1	38808723	.	T	A	9	9	18	0	0	18	0	0
1	38810061	.	T	G	11	9	20	0	1	21	0	0
1	38820219	.	G	A	0	10	10	0	7	17	0	0
1	38822092	.	A	T	11	6	17	0	3	20	0	0
1	39482532	.	C	T	1	2	3	0	1	4	0	0
1	39680794	.	C	A	3	2	5	0	0	5	0	0
1	39700498	.	T	C	8	4	12	0	0	12	0	0
1	39732544	.	C	T	5	3	8	0	0	8	0	0
1	39735491	.	T	C	3	8	11	0	0	11	0	0
1	39770416	.	C	T	8	6	14	0	1	15	0	0
1	39771429	.	T	A	10	12	22	0	0	22	0	0
1	39772010	.	T	C	5	8	13	0	0	13	0	0
1	39772042	.	A	G	3	3	6	0	1	7	0	0
1	39772135	.	C	A	7	6	13	0	0	13	0	0
1	39772225	.	C	T	16	13	29	0	3	32	0	0
1	39774096	.	C	T	12	11	23	0	0	23	0	0
1	39774225	.	C	T	9	16	25	0	0	25	0	0
1	39774363	.	G	A	7	9	16	0	0	16	0	0
1	39774618	.	A	G	15	10	25	0	0	25	0	0
1	39774690	.	A	G	9	11	20	0	1	21	0	0
1	39774727	.	C	A	12	9	21	0	0	21	0	0
1	39774891	.	C	T	18	14	32	0	0	32	0	0
1	39774915	.	G	A	15	18	33	0	2	35	0	0
1	39775089	.	C	T	14	11	25	0	0	25	0	0
1	39775131	.	C	T	17	12	29	0	2	31	0	0
1	39775227	.	C	T	14	10	24	0	1	25	0	0
1	39776356	.	A	C	21	17	38	0	2	40	0	0
1	39777089	.	G	A	13	14	27	0	2	29	0	0
1	39777836	.	G	A	1	11	12	0	13	25	0	0
1	39777975	.	A	T	16	11	27	0	1	28	0	0
1	39778047	.	A	G	15	2	17	0	17	34	0	0
1	39778075	.	T	G	13	18	31	0	0	31	0	0
1	39778332	.	G	C	28	22	50	0	0	50	0	0
1	39778661	.	G	A	12	7	19	0	1	20	0	0
1	39778663	.	G	A	12	8	20	0	0	20	0	0
1	39778949	.	G	C	15	22	37	0	0	37	0	0
1	39779225	.	G	C	9	13	22	0	0	22	0	0
1	39779468	.	A	T	5	4	9	0	0	9	0	0
1	39869917	.	T	A	4	3	7	0	0	7	0	0
1	39869974	.	G	A	5	6	11	0	0	11	0	0
1	39870008	.	T	C	4	2	6	0	0	6	0	0
1	39876596	.	C	A	1	2	3	0	0	3	0	0
1	39881107	.	A	G	0	2	2	0	1	3	0	0
1	39882764	.	A	T	1	6	7	0	0	7	0	0
1	39882899	.	A	G	2	3	5	0	0	5	0	0
1	39882906	.	T	A	4	3	7	0	0	7	0	0
1	39883143	.	C	A	2	2	4	0	0	4	0	0
1	39883146	.	G	A	2	2	4	0	0	4	0	0
1	39883259	.	C	G	2	2	4	0	0	5	1	0
1	39899477	.	G	C	21	22	43	0	2	45	0	0
1	39899494	.	A	G	22	19	41	0	3	44	0	0
1	39899663	.	G	A	22	22	44	0	0	44	0	0
1	39900056	.	G	A	18	28	46	0	2	48	0	0
1	39900129	.	G	A	21	26	47	0	1	48	0	0
1	39900137	.	G	T	23	22	45	0	0	45	0	0
1	39900360	.	G	A	12	15	27	0	1	28	0	0
1	39900432	.	C	T	0	16	16	0	6	22	0	0
1	39900750	.	C	T	1	11	12	0	14	26	0	0
1	39901269	.	G	A	6	2	8	0	1	9	0	0
1	39901378	.	T	A	9	6	15	0	0	15	0	0
1	39901500	.	T	C	12	7	19	0	0	19	0	0
1	39901501	.	G	A	12	7	19	0	0	19	0	0
1	39901729	.	T	C	19	0	19	0	18	37	0	0
1	39907291	.	A	C	9	5	14	0	0	14	0	0
1	39907492	.	T	C	19	1	20	0	11	31	0	0
1	39907611	.	C	T	1	3	4	0	3	7	0	0
1	39908047	.	G	A	10	7	17	0	2	19	0	0
1	39908680	.	C	T	8	10	18	0	0	18	0	0
1	39908854	.	A	G	13	5	18	0	1	19	0	0
1	39908881	.	C	T	15	7	22	0	2	24	0	0
1	39908926	.	A	G	8	8	16	0	1	17	0	0
1	39909003	.	A	T	11	13	24	0	0	24	0	0
1	39909247	.	A	T	19	15	34	0	1	35	0	0
1	39909274	.	A	T	19	15	34	0	1	35	0	0
1	39977098	.	G	A	2	3	5	1	0	6	0	0
1	39981794	.	A	G	7	5	12	0	0	12	0	0
1	39995100	.	C	T	10	6	16	0	0	16	0	0
1	39998875	.	G	A	7	10	17	0	0	17	0	0
1	40001853	.	A	T	11	9	20	0	2	22	0	0
1	40001873	.	C	A	11	11	22	0	0	22	0	0
1	40002113	.	G	A	10	9	19	0	3	22	0	0
1	40002148	.	C	G	11	11	22	0	0	22	0	0
1	40008905	.	T	C	19	18	37	0	1	38	0	0
1	40008906	.	G	A	21	18	39	0	0	39	0	0
1	40009227	.	T	A	21	17	38	0	1	39	0	0
1	40009258	.	C	T	14	20	34	0	0	34	0	0
1	40009291	.	A	G	10	14	24	0	2	26	0	0
1	40009382	.	G	A	25	9	34	0	0	34	0	0
1	40009526	.	T	C	5	7	12	0	0	12	0	0
1	40009625	.	T	C	7	11	18	0	0	18	0	0
1	40009671	.	C	A	9	9	18	0	3	21	0	0
1	40009697	.	C	T	8	7	15	0	1	16	0	0
1	40015189	.	A	G	5	7	12	0	2	14	0	0
1	40015219	.	C	T	11	10	21	0	0	21	0	0
1	40015265	.	C	T	3	6	9	0	13	22	0	0
1	40015553	.	A	G	9	4	13	0	0	13	0	0
1	40015697	.	A	G	8	6	14	0	2	16	0	0
1	40027564	.	C	A	3	4	7	0	1	8	0	0
1	40028424	.	C	T	7	4	11	0	1	12	0	0
1	40028508	.	C	T	3	11	14	1	0	15	0	0
1	40028568	.	G	T	7	4	11	0	0	11	0	0
1	40028613	.	G	A	2	7	9	0	0	9	0	0
1	40028637	.	C	T	7	5	12	0	0	12	0	0
1	40028680	.	G	A	7	7	14	0	0	14	0	0
1	40041528	.	C	T	7	7	14	0	0	14	0	0
1	40042241	.	G	A	5	3	8	0	0	8	0	0
1	40044175	.	G	C	6	3	9	0	0	9	0	0
1	40044562	.	G	A	9	5	14	0	1	15	0	0
1	40044578	.	C	T	9	11	20	0	0	20	0	0
1	40046859	.	G	A	7	7	14	0	1	15	0	0
1	40047070	.	T	A	7	7	14	0	1	15	0	0
1	40051918	.	T	C	6	10	16	1	0	17	0	0
1	40051923	.	G	C	6	8	14	1	1	16	0	0
1	40051988	.	G	C	1	10	11	0	17	28	0	0
1	40052033	.	A	G	11	9	20	0	2	22	0	0
1	40052066	.	G	C	15	7	22	0	1	23	0	0
1	40052083	.	G	A	16	9	25	0	1	26	0	0
1	40052481	.	A	C	10	8	18	0	0	18	0	0
1	40052550	.	A	C	5	10	15	0	0	15	0	0
1	40052562	.	A	G	3	7	10	0	2	12	0	0
1	40057604	.	A	G	2	7	9	0	1	10	0	0
1	40057655	.	C	T	6	3	9	0	0	9	0	0
1	40057805	.	C	T	5	13	18	0	1	19	0	0
1	40060836	.	T	A	1	3	4	0	0	4	0	0
1	40060860	.	T	C	1	2	3	0	0	3	0	0
1	40060968	.	A	C	5	6	11	0	1	12	0	0
1	40060992	.	C	T	0	4	4	0	8	12	0	0
1	40061061	.	C	T	1	3	4	0	3	7	0	0
1	40061169	.	G	A	9	6	15	0	0	15	0	0
1	40062593	.	T	G	5	2	7	0	0	7	0	0
1	40107874	.	T	G	4	8	12	0	0	12	0	0
1	40107961	.	C	T	2	6	8	0	0	8	0	0
1	40111679	.	C	G	12	14	26	0	0	26	0	0
1	40111702	.	T	G	12	14	26	0	3	29	0	0
1	40111737	.	A	C	17	13	30	0	3	33	0	0
1	40111738	.	G	A	19	11	30	0	4	34	0	0
1	40111776	.	C	T	11	17	28	0	3	31	0	0
1	40111918	.	C	T	14	8	22	0	1	23	0	0
1	40112206	.	T	C	7	4	11	0	7	18	0	0
1	40112347	.	C	T	3	6	9	0	0	9	0	0
1	40112410	.	C	T	8	5	13	0	5	18	0	0
1	40112510	.	T	C	3	6	9	0	0	9	0	0
1	40112713	.	A	G	2	0	2	0	3	5	0	0
1	40112760	.	T	A	8	11	19	0	1	20	0	0
1	40112822	.	A	T	12	7	19	0	5	24	0	0
1	40112837	.	C	T	6	13	19	0	1	20	0	0
1	40112869	.	C	T	15	8	23	0	1	24	0	0
1	40112879	.	A	G	13	7	20	0	0	20	0	0
1	40112938	.	G	C	7	6	13	0	1	14	0	0
1	40113374	.	T	A	3	2	5	0	0	5	0	0
1	40114044	.	A	G	3	5	8	0	3	11	0	0
1	40114070	.	G	A	2	6	8	0	1	9	0	0
1	40115018	.	A	T	3	3	6	0	0	6	0	0
1	40115065	.	T	C	2	4	6	0	0	6	0	0
1	40116648	.	A	G	3	6	9	0	0	9	0	0
1	40116747	.	G	A	11	6	17	0	1	18	0	0
1	40116889	.	G	A	1	2	3	0	0	3	0	0
1	40116915	.	T	G	3	2	5	0	0	5	0	0
1	40116946	.	C	T	1	6	7	0	6	13	0	0
1	40117345	.	G	A	13	15	28	0	0	28	0	0
1	40123964	.	C	T	0	4	4	0	7	11	0	0
1	40132692	.	G	C	2	4	6	0	0	6	0	0
1	40210865	.	G	T	13	17	30	0	0	30	0	0
1	40211048	.	C	T	0	12	12	0	7	19	0	0
1	40211065	.	T	C	5	9	14	0	1	15	0	0
1	40211217	.	A	C	12	7	19	0	1	20	0	0
1	40211465	.	T	C	7	0	7	0	9	16	0	0
1	40211645	.	C	G	0	15	15	0	10	25	0	0
1	40212065	.	C	T	14	11	25	0	0	25	0	0
1	40212084	.	C	A	1	11	12	0	15	27	0	0
1	40212305	.	C	T	9	22	31	0	2	33	0	0
1	40219516	.	G	A	2	10	12	0	0	12	0	0
1	40221359	.	A	G	5	8	13	0	1	14	0	0
1	40226289	.	G	A	6	5	11	0	0	11	0	0
1	40226292	.	G	C	4	5	9	0	1	10	0	0
1	40227029	.	T	G	7	5	12	0	1	13	0	0
1	40242922	.	C	A	1	3	4	0	0	4	0	0
1	40248173	.	C	T	1	5	6	0	0	6	0	0
1	40248383	.	C	T	5	7	12	0	0	12	0	0
1	40252219	.	T	A	13	5	18	0	2	20	0	0
1	40257577	.	A	G	15	6	21	0	0	21	0	0
1	40257631	.	C	T	15	7	22	0	1	23	0	0
1	40257751	.	C	T	7	14	21	0	0	21	0	0
1	40257834	.	T	G	12	0	12	0	7	19	0	0
1	40266618	.	C	T	18	36	54	0	3	58	1	0
1	40270054	.	C	T	37	17	54	0	6	60	0	0
1	40270094	.	G	A	2	23	25	0	30	55	0	0
1	40270095	.	G	A	30	22	52	0	4	56	0	0
1	40336234	.	C	G	6	3	9	0	0	9	0	0
1	40336789	.	G	A	5	2	7	0	0	7	0	0
1	40337314	.	C	T	7	7	14	0	0	14	0	0
1	40337464	.	C	A	2	8	10	0	8	18	0	0
1	40340571	.	C	T	5	6	11	0	0	11	0	0
1	40410608	.	C	T	1	6	7	0	5	12	0	0
1	40410839	.	A	T	5	7	12	0	0	12	0	0
1	40410908	.	C	T	7	4	11	0	0	11	0	0
1	40411091	.	T	A	4	4	8	0	0	8	0	0
1	40411928	.	T	C	3	2	5	0	0	5	0	0
1	40567094	.	G	A	5	13	18	0	0	18	0	0
1	40568601	.	G	A	13	8	21	0	1	22	0	0
1	40568707	.	A	G	9	0	9	0	9	18	0	0
1	40568883	.	G	A	2	18	20	0	13	33	0	0
1	40568990	.	A	G	16	14	30	0	1	31	0	0
1	40569153	.	C	T	11	2	13	0	1	14	0	0
1	40569168	.	C	T	11	3	14	0	0	14	0	0
1	40569231	.	G	A	11	7	18	0	0	18	0	0
1	40569295	.	A	T	13	7	20	0	3	23	0	0
1	40569386	.	T	A	15	6	21	6	2	29	0	0
1	40569466	.	A	T	23	12	35	0	0	35	0	0
1	40569538	.	G	A	14	9	23	0	1	24	0	0
1	40569548	.	T	C	13	9	22	0	0	22	0	0
1	40573703	.	G	T	22	25	47	0	1	48	0	0
1	40590967	.	T	G	24	24	48	0	0	48	0	0
1	40591262	.	T	C	17	23	40	0	2	42	0	0
1	40591272	.	T	C	17	23	40	0	0	40	0	0
1	40594373	.	C	T	18	14	32	0	1	33	0	0
1	40594415	.	C	T	1	12	13	0	16	29	0	0
1	40594517	.	T	C	17	0	17	1	23	41	0	0
1	40594526	.	G	A	18	19	37	1	2	40	0	0
1	40597332	.	A	C	15	0	15	0	26	41	0	0
1	40600992	.	A	T	11	10	21	0	2	23	0	0
1	40601547	.	G	A	15	10	25	0	0	25	0	0
1	40601595	.	G	C	16	0	16	0	5	21	0	0
1	40618861	.	C	T	4	3	7	0	0	7	0	0
1	40627291	.	G	A	2	5	7	0	0	7	0	0
1	40638246	.	A	T	6	6	12	0	0	12	0	0
1	40795213	.	C	A	3	5	8	0	0	8	0	0
1	40795231	.	A	T	5	2	7	0	0	7	0	0
1	40796779	.	G	T	5	6	11	0	0	11	0	0
1	40796791	.	G	A	7	5	12	0	0	12	0	0
1	40796942	.	C	T	1	4	5	0	0	5	0	0
1	40910231	.	T	C	1	2	3	0	0	3	0	0
1	40992716	.	T	A	10	10	20	0	2	22	0	0
1	40992823	.	A	G	4	8	12	0	0	12	0	0
1	40992878	.	C	G	8	5	13	0	0	13	0	0
1	40993349	.	C	T	0	9	9	0	6	15	0	0
1	40993714	.	G	A	7	4	11	0	1	12	0	0
1	41131608	.	C	T	7	12	19	1	0	20	0	0
1	41133944	.	G	A	7	6	13	0	0	13	0	0
1	41136245	.	T	C	15	10	25	0	2	27	0	0
1	41138638	.	A	G	14	14	28	0	0	28	0	0
1	41138641	.	C	T	16	14	30	0	1	31	0	0
1	41140465	.	T	C	11	20	31	0	2	33	0	0
1	41140640	.	C	T	8	16	24	1	0	25	0	0
1	41140787	.	T	A	8	12	20	0	3	23	0	0
1	41215289	.	T	A	9	6	15	0	2	17	0	0
1	41215312	.	T	G	13	6	19	0	1	20	0	0
1	41215547	.	G	A	14	7	21	0	1	22	0	0
1	41215746	.	T	A	3	7	10	0	1	11	0	0
1	41215868	.	T	G	12	5	17	0	1	18	0	0
1	41215869	.	G	T	6	12	18	0	0	18	0	0
1	41215998	.	T	C	9	3	12	0	1	13	0	0
1	41222341	.	T	C	1	5	6	0	0	6	0	0
1	41230927	.	C	T	3	6	9	0	0	9	0	0
1	41294719	.	A	G	10	16	26	0	0	26	0	0
1	41294760	.	T	C	13	9	22	0	4	26	0	0
1	41294790	.	G	T	11	8	19	0	1	20	0	0
1	41297453	.	C	T	0	6	6	0	5	11	0	0
1	41297495	.	G	A	11	10	21	0	0	21	0	0
1	41297561	.	C	T	6	14	20	0	0	20	0	0
1	41297564	.	A	T	15	5	20	0	0	20	0	0
1	41300133	.	C	T	7	9	16	0	0	16	0	0
1	41309208	.	C	G	3	6	9	0	0	9	0	0
1	41310074	.	A	G	6	7	13	0	0	13	0	0
1	41312210	.	G	A	3	8	11	0	0	11	0	0
1	41318203	.	T	G	1	3	4	0	0	4	0	0
1	41320781	.	A	G	1	7	8	0	0	8	0	0
1	41324327	.	C	T	1	2	3	0	7	10	0	0
1	41324444	.	C	T	0	3	3	0	1	4	0	0
1	41327484	.	A	T	1	4	5	0	0	5	0	0
1	41330594	.	G	C	2	3	5	0	0	5	0	0
1	41331692	.	G	A	2	2	4	0	0	4	0	0
1	41332989	.	T	C	1	0	1	0	2	3	0	0
1	41333321	.	A	G	2	2	4	0	0	4	0	0
1	41335270	.	G	A	1	3	4	0	0	4	0	0
1	41337314	.	G	A	2	2	4	0	0	4	0	0
1	41337997	.	G	A	2	2	4	0	0	4	0	0
1	41340128	.	C	G	3	2	5	0	0	5	0	0
1	41340133	.	T	G	3	2	5	0	0	5	0	0
1	41342427	.	C	A	2	2	4	0	0	4	0	0
1	41470524	.	T	C	24	25	49	0	3	52	0	0
1	41471529	.	T	C	28	25	53	0	2	55	0	0
1	41487811	.	C	T	4	5	9	0	0	9	0	0
1	41487960	.	A	T	2	4	6	0	0	6	0	0
1	41487973	.	T	C	1	3	4	0	0	4	0	0
1	41488643	.	A	C	6	2	8	0	0	8	0	0
1	41489068	.	C	T	3	4	7	0	0	7	0	0
1	41489274	.	G	C	4	2	6	0	0	6	0	0
1	41489433	.	C	T	1	2	3	0	0	3	0	0
1	41530370	.	C	T	2	3	5	0	0	5	0	0
1	41596182	.	A	G	2	2	4	0	1	5	0	0
1	41596291	.	C	T	3	5	8	0	0	8	0	0
1	41600339	.	T	C	4	3	7	0	0	7	0	0
1	41600533	.	A	G	1	3	4	0	0	4	0	0
1	41604931	.	C	G	6	0	6	0	5	11	0	0
1	41604934	.	C	G	6	0	6	0	5	11	0	0
1	41604985	.	G	A	0	4	4	0	8	12	0	0
1	41605011	.	T	C	8	3	11	0	1	12	0	0
1	41605065	.	C	A	4	6	10	0	0	10	0	0
1	41605149	.	T	C	1	5	6	0	0	6	0	0
1	41605203	.	C	T	1	6	7	0	0	7	0	0
1	41615874	.	C	T	6	2	8	0	0	8	0	0
1	41615904	.	T	C	4	5	9	0	2	11	0	0
1	41615949	.	T	C	3	7	10	0	0	10	0	0
1	41616081	.	T	G	2	5	7	0	2	9	0	0
1	41616186	.	A	C	3	5	8	0	0	8	0	0
1	41690506	.	C	T	8	6	14	0	0	14	0	0
1	41730609	.	C	T	8	8	16	0	1	17	0	0
1	41730669	.	G	A	11	10	21	0	0	21	0	0
1	41744103	.	C	T	11	9	20	0	0	20	0	0
1	41755157	.	C	T	17	6	23	0	0	23	0	0
1	41755158	.	A	T	17	6	23	0	0	23	0	0
1	41755195	.	C	T	6	11	17	1	1	19	0	0
1	41770847	.	T	A	8	10	18	0	2	20	0	0
1	41770872	.	T	C	11	9	20	0	0	20	0	0
1	41770959	.	T	C	6	9	15	1	0	16	0	0
1	41817556	.	G	A	5	2	7	0	0	7	0	0
1	41817574	.	T	C	5	2	7	0	0	7	0	0
1	41817678	.	C	T	3	3	6	0	0	6	0	0
1	41849293	.	A	G	5	6	11	0	1	12	0	0
1	41849310	.	A	G	7	7	14	0	2	16	0	0
1	41865471	.	C	T	18	18	36	0	4	40	0	0
1	41950085	.	T	A	1	2	3	0	0	3	0	0
1	41958356	.	C	T	3	4	7	0	0	7	0	0
1	42375005	.	C	A	6	5	11	0	0	11	0	0
1	42375071	.	C	T	10	9	19	0	0	19	0	0
1	42386349	.	T	C	8	6	14	0	0	14	0	0
1	42386364	.	C	A	6	6	12	0	0	12	0	0
1	42388351	.	T	C	3	6	9	0	1	10	0	0
1	42391172	.	T	C	6	8	14	0	1	15	0	0
1	42391194	.	T	C	5	9	14	0	0	14	0	0
1	42391214	.	G	A	4	8	12	0	1	13	0	0
1	42776652	.	T	C	25	15	40	0	4	44	0	0
1	42776806	.	A	T	31	21	52	0	0	52	0	0
1	42776853	.	T	C	30	20	50	0	0	50	0	0
1	42776906	.	A	G	26	16	42	0	1	43	0	0
1	42777116	.	G	A	16	20	36	0	2	38	0	0
1	42777146	.	C	G	1	19	20	0	16	36	0	0
1	42777383	.	A	G	23	15	38	0	0	38	0	0
1	42777593	.	T	G	16	13	29	0	2	31	0	0
1	42777674	.	G	A	16	8	24	0	1	25	0	0
1	42882955	.	C	T	4	8	12	0	0	12	0	0
1	43023630	.	G	A	15	16	31	0	0	31	0	0
1	43034947	.	C	T	21	17	38	0	1	39	0	0
1	43035178	.	T	C	12	21	33	1	1	35	0	0
1	43035546	.	T	A	8	12	20	0	1	21	0	0
1	43994567	.	G	A	1	9	10	0	0	10	0	0
1	44228705	.	C	T	8	4	12	0	1	13	0	0
1	44559553	.	A	C	2	2	4	0	14	18	0	0
1	44571202	.	T	C	10	4	14	0	1	15	0	0
1	45095019	.	T	C	2	5	7	1	0	8	0	0
1	45868178	.	C	T	12	14	26	33	0	59	0	0
1	47120622	.	G	C	6	9	15	0	0	15	0	0
1	47120627	.	C	T	4	11	15	0	0	15	0	0
1	47170717	.	A	G	4	2	6	0	0	6	0	0
1	47170732	.	A	G	6	2	8	0	0	8	0	0
1	48582091	.	T	C	3	2	5	0	0	5	0	0
1	48583000	.	T	C	11	7	18	1	0	19	0	0
1	49271317	.	G	A	27	30	57	0	3	60	0	0
1	49289729	.	C	G	33	2	35	0	29	65	1	0
1	49293808	.	T	C	30	18	48	0	0	48	0	0
1	49293954	.	C	T	38	12	50	0	3	53	0	0
1	49294032	.	A	T	17	9	26	0	1	28	1	0
1	49294686	.	A	G	11	16	27	0	0	27	0	0
1	49374392	.	A	G	4	3	7	0	0	7	0	0
1	49418156	.	T	C	3	2	5	0	0	5	0	0
1	49418197	.	A	T	1	5	6	0	0	6	0	0
1	49483555	.	T	C	17	5	22	1	0	23	0	0
1	49483583	.	C	T	12	7	19	1	1	21	0	0
1	49814674	.	T	C	12	10	22	0	1	23	0	0
1	49814732	.	C	T	14	10	24	0	0	24	0	0
1	49814844	.	C	T	9	8	17	0	0	17	0	0
1	49869672	.	G	A	13	24	37	0	1	38	0	0
1	49912665	.	C	T	10	12	22	0	0	22	0	0
1	49912841	.	C	A	1	12	13	0	6	19	0	0
1	49912866	.	C	T	0	7	7	0	5	12	0	0
1	49913071	.	G	A	11	17	28	0	2	30	0	0
1	49915231	.	C	T	9	8	17	0	0	17	0	0
1	49915278	.	G	C	7	10	17	0	0	17	0	0
1	49915598	.	C	T	15	6	21	0	0	21	0	0
1	49929579	.	G	A	2	6	8	0	0	8	0	0
1	49929693	.	T	C	6	3	9	0	0	9	0	0
1	49929726	.	A	G	3	2	5	0	0	5	0	0
1	49929798	.	T	C	2	0	2	0	2	4	0	0
1	50051814	.	C	A	3	5	8	0	0	8	0	0
1	50061614	.	C	A	2	3	5	0	0	5	0	0
1	50164729	.	T	C	1	2	3	0	0	3	0	0
1	50171219	.	T	C	2	7	9	0	1	10	0	0
1	50172815	.	A	G	6	8	14	0	0	14	0	0
1	50178612	.	T	C	5	9	14	0	1	15	0	0
1	50178643	.	A	G	5	0	5	0	11	16	0	0
1	50178829	.	C	A	13	14	27	0	0	27	0	0
1	50178963	.	G	A	6	7	13	0	0	13	0	0
1	50185244	.	G	A	1	16	17	0	5	22	0	0
1	50187511	.	C	T	10	9	19	0	1	20	0	0
1	50187733	.	A	T	6	5	11	0	0	11	0	0
1	50187782	.	A	G	4	7	11	0	0	11	0	0
1	50187836	.	T	G	1	5	6	0	1	7	0	0
1	50187866	.	A	G	2	0	2	0	5	7	0	0
1	50198815	.	C	T	0	5	5	0	5	10	0	0
1	50199365	.	A	T	8	11	19	0	0	19	0	0
1	50199368	.	G	A	8	10	18	0	0	18	0	0
1	50199416	.	G	A	4	7	11	0	0	11	0	0
1	50221045	.	G	A	7	5	12	0	0	12	0	0
1	50245894	.	G	C	3	4	7	0	0	7	0	0
1	50257749	.	T	C	5	0	5	0	4	9	0	0
1	50261274	.	A	G	3	2	5	0	0	5	0	0
1	50270154	.	G	A	1	3	4	0	0	4	0	0
1	50270166	.	A	G	1	3	4	0	0	4	0	0
1	50270234	.	C	G	0	3	3	0	2	5	0	0
1	50270241	.	T	A	1	2	3	0	2	5	0	0
1	50272240	.	T	A	2	7	9	0	1	10	0	0
1	50273295	.	G	A	2	7	9	0	0	9	0	0
1	50293876	.	A	G	2	2	4	0	0	4	0	0
1	50301833	.	A	G	12	13	25	0	1	26	0	0
1	50303960	.	C	T	9	11	20	0	2	22	0	0
1	50303989	.	G	A	1	7	8	0	12	20	0	0
1	50317687	.	G	A	2	8	10	0	12	22	0	0
1	50317723	.	A	C	13	6	19	0	0	19	0	0
1	50319584	.	A	G	1	4	5	0	1	6	0	0
1	50437929	.	C	A	1	1	2	0	1	3	0	0
1	50437939	.	G	A	2	2	4	0	0	4	0	0
1	50487762	.	G	C	10	0	10	0	10	20	0	0
1	50487837	.	C	A	10	6	16	0	0	16	0	0
1	50487844	.	G	A	9	5	14	0	0	14	0	0
1	50488002	.	A	G	8	10	18	1	0	19	0	0
1	50496598	.	A	G	11	8	19	0	0	19	0	0
1	50502852	.	C	T	0	2	2	0	2	4	0	0
1	50503237	.	G	A	3	3	6	0	1	7	0	0
1	50520003	.	A	G	4	2	6	0	0	6	0	0
1	50521790	.	T	C	1	2	3	0	0	3	0	0
1	50521871	.	G	T	2	4	6	0	1	7	0	0
1	50594239	.	T	A	17	17	34	0	0	34	0	0
1	50594647	.	G	A	9	9	18	0	1	19	0	0
1	50594670	.	A	T	10	12	22	1	3	26	0	0
1	50594771	.	C	A	16	10	26	0	1	27	0	0
1	50594777	.	C	T	14	10	24	0	1	25	0	0
1	50594986	.	T	C	10	0	10	0	15	25	0	0
1	50595289	.	G	A	15	13	28	0	0	28	0	0
1	50595387	.	C	T	13	12	25	0	0	25	0	0
1	50595476	.	G	A	12	12	24	0	0	24	0	0
1	50595530	.	A	G	11	9	20	0	1	21	0	0
1	50595608	.	G	C	12	12	24	0	0	24	0	0
1	50595748	.	T	C	12	13	25	0	1	26	0	0
1	50595805	.	G	A	9	11	20	1	2	24	1	0
1	50596748	.	G	T	13	12	25	0	3	28	0	0
1	50598793	.	C	T	3	15	18	0	12	30	0	0
1	50598848	.	G	A	9	13	22	0	0	22	0	0
1	50602955	.	G	A	2	3	5	0	0	5	0	0
1	50608505	.	T	C	6	5	11	0	0	11	0	0
1	50608584	.	G	A	12	15	27	0	0	27	0	0
1	50611013	.	G	A	3	4	7	0	0	7	0	0
1	50657117	.	C	A	4	3	7	0	0	7	0	0
1	50659858	.	G	A	0	3	3	0	2	5	0	0
1	50660378	.	A	T	5	2	7	0	0	7	0	0
1	50668798	.	G	A	0	3	3	0	7	10	0	0
1	50673749	.	G	A	0	3	3	0	4	7	0	0
1	50691194	.	G	C	0	2	2	0	3	6	1	0
1	50694993	.	T	C	13	14	27	0	1	28	0	0
1	50694994	.	G	T	13	15	28	0	0	28	0	0
1	50698089	.	G	A	3	5	8	0	0	8	0	0
1	50796098	.	T	A	1	4	5	0	0	5	0	0
1	50848484	.	C	T	16	10	26	0	1	27	0	0
1	50848555	.	A	G	10	14	24	0	1	25	0	0
1	50849078	.	A	T	15	15	30	0	2	32	0	0
1	50849199	.	T	C	15	0	15	0	13	28	0	0
1	50849839	.	T	C	3	5	8	0	1	9	0	0
1	50849938	.	T	A	18	7	25	0	0	25	0	0
1	50849942	.	G	A	17	9	26	0	1	27	0	0
1	50850041	.	T	A	18	8	26	0	0	26	0	0
1	50929137	.	C	T	1	2	3	0	0	3	0	0
1	50969209	.	G	A	17	9	26	0	2	28	0	0
1	50977072	.	C	A	7	4	11	0	0	11	0	0
1	50977089	.	C	T	14	13	27	0	0	27	0	0
1	50977569	.	A	C	3	4	7	0	0	7	0	0
1	50977607	.	G	A	7	4	11	0	0	11	0	0
1	50977640	.	G	T	4	5	9	0	0	9	0	0
1	50977707	.	G	A	4	55	59	1	46	106	0	0
1	50983906	.	T	C	36	22	58	0	5	63	0	0
1	50985169	.	C	T	38	31	69	0	1	70	0	0
1	50987742	.	C	A	37	31	68	0	1	69	0	0
1	50990605	.	G	A	34	20	54	0	0	54	0	0
1	50990698	.	A	T	35	24	59	1	3	63	0	0
1	50990709	.	T	C	21	29	50	3	2	62	7	0
1	50990815	.	G	A	23	26	49	0	5	54	0	0
1	51015493	.	G	A	4	3	7	0	0	7	0	0
1	51021591	.	C	A	8	8	16	0	0	16	0	0
1	51023877	.	C	T	3	10	13	0	0	13	0	0
1	51031291	.	T	C	3	0	3	0	3	6	0	0
1	51038819	.	A	G	3	2	5	0	0	5	0	0
1	51040428	.	T	C	27	29	56	0	1	57	0	0
1	51041363	.	G	A	0	11	11	0	19	31	1	0
1	51042230	.	G	C	13	7	20	0	0	20	0	0
1	51052276	.	C	T	5	5	10	0	0	10	0	0
1	51052279	.	T	C	5	5	10	0	1	11	0	0
1	51053971	.	A	G	5	3	8	0	0	8	0	0
1	51105411	.	T	A	2	2	4	0	0	4	0	0
1	51105448	.	T	C	2	0	2	0	2	4	0	0
1	51192069	.	C	T	3	2	5	0	0	5	0	0
1	51192074	.	C	A	3	2	5	0	0	5	0	0
1	51196071	.	G	C	2	4	6	0	0	6	0	0
1	51196095	.	G	A	2	4	6	0	0	6	0	0
1	51196161	.	C	T	1	3	4	0	0	4	0	0
1	51197082	.	G	A	1	3	4	0	0	4	0	0
1	51197316	.	A	G	3	3	6	0	1	7	0	0
1	51207210	.	A	C	9	10	19	0	0	19	0	0
1	51210562	.	T	C	4	5	9	0	0	9	0	0
1	51211052	.	A	G	8	6	14	0	1	15	0	0
1	51211393	.	T	A	2	4	6	0	0	6	0	0
1	51211394	.	C	T	2	4	6	0	0	6	0	0
1	51215290	.	G	A	2	3	5	0	0	5	0	0
1	51217048	.	C	A	2	4	6	0	0	6	0	0
1	51217063	.	C	A	0	5	5	0	2	7	0	0
1	51217156	.	T	A	5	6	11	0	0	11	0	0
1	51217822	.	T	C	2	6	8	0	0	8	0	0
1	51221347	.	A	G	4	0	4	0	9	13	0	0
1	51221349	.	A	T	5	9	14	0	0	14	0	0
1	51229355	.	C	T	3	5	8	0	1	9	0	0
1	51229464	.	C	G	7	4	11	0	0	11	0	0
1	51229471	.	C	T	1	4	5	0	7	12	0	0
1	51229833	.	T	C	6	14	20	0	1	21	0	0
1	51229839	.	T	C	8	12	20	0	0	20	0	0
1	51230277	.	C	G	7	8	15	0	0	15	0	0
1	51230324	.	G	A	3	10	13	0	1	14	0	0
1	51230328	.	C	A	4	10	14	0	0	14	0	0
1	51230404	.	A	G	6	3	9	0	0	9	0	0
1	51230427	.	A	G	3	2	5	0	1	6	0	0
1	51230467	.	T	C	3	3	6	0	0	6	0	0
1	51230564	.	C	T	6	4	10	0	0	10	0	0
1	51230573	.	C	T	5	4	9	0	1	10	0	0
1	51230957	.	C	A	0	5	5	0	7	12	0	0
1	51233996	.	C	T	0	4	4	0	7	11	0	0
1	51242401	.	G	T	2	4	6	0	1	7	0	0
1	51244814	.	C	T	3	5	8	0	0	8	0	0
1	51246693	.	T	C	5	5	10	0	0	10	0	0
1	51263352	.	C	T	2	2	4	0	0	4	0	0
1	51263367	.	C	G	2	1	3	0	0	3	0	0
1	51349146	.	G	A	0	4	4	0	1	5	0	0
1	51355086	.	G	A	1	3	4	0	0	4	0	0
1	51365630	.	T	C	2	2	4	0	0	4	0	0
1	51365672	.	C	T	1	3	4	0	1	5	0	0
1	51368776	.	C	A	1	2	3	0	1	4	0	0
1	51372742	.	C	T	2	3	5	0	0	5	0	0
1	51373730	.	A	C	11	4	15	0	0	15	0	0
1	51373808	.	C	T	4	4	8	0	2	10	0	0
1	51373904	.	A	G	5	6	11	0	1	12	0	0
1	51373952	.	A	C	5	3	8	0	0	8	0	0
1	51374009	.	T	C	1	2	3	0	0	3	0	0
1	51374844	.	C	T	2	7	9	0	1	10	0	0
1	51374905	.	A	G	3	8	11	0	0	11	0	0
1	51374976	.	G	A	6	4	10	0	0	10	0	0
1	51375149	.	T	C	5	3	8	0	0	8	0	0
1	51375170	.	A	T	6	5	11	0	0	11	0	0
1	51375301	.	A	G	2	5	7	0	0	7	0	0
1	51377558	.	T	C	2	3	5	0	0	5	0	0
1	51377757	.	C	T	9	5	14	0	1	15	0	0
1	51395366	.	G	T	7	4	11	0	0	11	0	0
1	51398024	.	C	T	11	9	20	0	0	20	0	0
1	51403088	.	C	T	7	8	15	0	0	15	0	0
1	51403499	.	C	A	5	7	12	0	0	12	0	0
1	51403544	.	G	C	3	8	11	0	1	12	0	0
1	51403562	.	C	T	5	10	15	0	0	15	0	0
1	51403872	.	T	C	2	3	5	0	0	5	0	0
1	51405253	.	T	A	3	4	7	0	0	7	0	0
1	51405323	.	C	A	7	5	12	0	2	15	1	0
1	51405499	.	G	A	1	2	3	0	2	5	0	0
1	51406288	.	C	T	9	13	22	0	0	22	0	0
1	51406521	.	G	A	1	4	5	0	0	5	0	0
1	51413315	.	T	C	14	8	22	0	0	22	0	0
1	51416963	.	C	T	7	10	17	0	0	17	0	0
1	51417125	.	C	G	6	0	6	0	9	15	0	0
1	51424779	.	A	T	9	10	19	0	1	20	0	0
1	51424813	.	G	A	0	8	8	0	9	17	0	0
1	51424937	.	T	A	2	3	5	0	0	10	5	0
1	51425221	.	G	T	1	3	4	0	7	11	0	0
1	51425296	.	G	A	6	8	14	0	0	14	0	0
1	51426983	.	T	A	2	3	5	0	1	6	0	0
1	51427152	.	G	T	12	6	18	0	0	18	0	0
1	51427153	.	G	T	10	6	16	0	2	18	0	0
1	51427671	.	G	T	14	16	30	0	0	30	0	0
1	51427779	.	T	C	10	14	24	0	0	24	0	0
1	51427837	.	A	C	16	13	29	0	0	29	0	0
1	51445437	.	A	T	7	6	13	0	0	13	0	0
1	51445450	.	A	T	10	8	18	0	0	18	0	0
1	51445732	.	A	G	12	10	22	0	1	23	0	0
1	51446230	.	T	A	5	6	11	0	0	11	0	0
1	51446451	.	C	T	5	5	10	0	0	10	0	0
1	51446462	.	C	T	6	5	11	0	0	11	0	0
1	51446511	.	G	A	5	3	8	0	0	8	0	0
1	51446597	.	A	T	6	5	11	0	0	11	0	0
1	51448249	.	C	A	4	6	10	0	0	10	0	0
1	51448485	.	C	T	6	6	12	0	1	13	0	0
1	51448517	.	C	T	10	4	14	0	0	14	0	0
1	51448781	.	A	G	3	3	6	0	0	6	0	0
1	51449298	.	T	C	5	4	9	0	0	9	0	0
1	51449720	.	G	A	8	5	13	0	0	13	0	0
1	51450018	.	C	T	1	5	6	0	4	10	0	0
1	51450180	.	C	T	1	4	5	0	4	9	0	0
1	51450713	.	G	A	4	4	8	0	0	8	0	0
1	51450752	.	G	A	4	4	8	0	1	9	0	0
1	51557817	.	G	T	4	2	6	0	0	6	0	0
1	51557903	.	C	T	0	17	17	0	18	35	0	0
1	51558133	.	G	T	14	10	24	0	2	26	0	0
1	51558150	.	A	T	8	12	20	0	1	21	0	0
1	51558354	.	T	A	12	13	25	1	4	30	0	0
1	51558463	.	G	A	36	12	48	0	3	51	0	0
1	51558730	.	G	T	32	15	47	0	2	49	0	0
1	51558897	.	T	A	21	25	46	0	2	49	1	0
1	51558903	.	A	C	25	21	46	0	0	46	0	0
1	51559269	.	G	C	18	22	40	0	0	40	0	0
1	51559815	.	C	T	23	24	47	0	1	48	0	0
1	51562803	.	T	C	16	22	38	0	3	41	0	0
1	51593925	.	A	C	6	4	10	0	1	11	0	0
1	51593926	.	C	T	1	4	5	0	6	11	0	0
1	51594058	.	A	T	7	7	14	0	1	15	0	0
1	51594068	.	A	C	10	6	16	0	2	18	0	0
1	51594453	.	A	G	23	22	45	0	1	46	0	0
1	51594690	.	C	G	1	17	18	0	26	44	0	0
1	51594701	.	C	T	3	23	26	0	22	48	0	0
1	51594883	.	C	T	1	16	17	0	20	37	0	0
1	51606302	.	C	G	17	30	47	0	1	48	0	0
1	51612371	.	G	T	15	20	35	0	2	37	0	0
1	51612408	.	C	G	15	18	33	0	1	34	0	0
1	51615110	.	T	C	13	0	13	0	23	36	0	0
1	51703824	.	C	T	4	6	10	0	1	11	0	0
1	51710007	.	C	T	8	4	12	0	2	14	0	0
1	51713077	.	G	A	8	8	16	0	0	16	0	0
1	51713468	.	C	T	4	5	9	0	1	10	0	0
1	51721923	.	T	G	13	18	31	0	1	32	0	0
1	51723093	.	T	G	12	1	13	0	25	38	0	0
1	51726524	.	C	T	24	26	50	0	2	52	0	0
1	51727432	.	C	A	28	24	52	0	2	54	0	0
1	51729605	.	G	A	15	18	33	0	1	34	0	0
1	51729608	.	G	T	15	17	32	0	1	33	0	0
1	51729645	.	A	C	16	16	32	1	1	34	0	0
1	51729687	.	C	T	19	14	33	2	0	35	0	0
1	51729697	.	C	A	18	14	32	2	2	36	0	0
1	51729735	.	C	A	23	9	32	0	1	33	0	0
1	51729798	.	A	C	15	9	24	0	0	24	0	0
1	51729825	.	C	T	4	3	7	0	0	7	0	0
1	51733129	.	T	A	11	7	18	0	0	18	0	0
1	51733284	.	T	A	8	13	21	0	1	22	0	0
1	51960576	.	G	C	2	4	6	0	0	6	0	0
1	52054116	.	A	G	3	3	6	0	0	6	0	0
1	52073807	.	C	G	6	11	17	0	2	19	0	0
1	52113225	.	T	C	4	0	4	0	6	10	0	0
1	52113251	.	G	A	3	4	7	0	0	7	0	0
1	52115862	.	C	T	0	4	4	0	7	11	0	0
1	52115880	.	G	C	5	10	15	0	1	16	0	0
1	52117007	.	T	C	5	0	5	0	11	16	0	0
1	52121275	.	G	T	8	6	14	0	1	15	0	0
1	52121311	.	A	G	8	3	11	0	0	11	0	0
1	52121450	.	C	T	2	6	8	0	6	14	0	0
1	52124240	.	C	T	0	8	8	0	8	16	0	0
1	52130268	.	G	A	2	7	9	0	16	25	0	0
1	52130328	.	T	C	7	6	13	0	7	20	0	0
1	52130339	.	A	G	11	7	18	0	2	20	0	0
1	52130431	.	G	A	14	14	28	0	1	29	0	0
1	52134992	.	G	A	9	11	20	0	1	21	0	0
1	52135254	.	T	C	26	9	35	0	2	37	0	0
1	52135303	.	T	C	12	13	25	0	0	25	0	0
1	52135513	.	G	A	6	2	8	1	1	10	0	0
1	52135840	.	C	A	14	6	20	0	3	23	0	0
1	52135972	.	A	T	14	4	18	0	0	18	0	0
1	52136027	.	T	C	16	8	24	0	1	25	0	0
1	52136117	.	A	C	16	10	26	0	1	27	0	0
1	52136294	.	T	C	9	7	16	0	0	16	0	0
1	52136454	.	A	C	11	10	21	0	0	21	0	0
1	52136641	.	A	G	6	6	12	0	0	12	0	0
1	52136759	.	A	T	15	15	30	0	1	31	0	0
1	52136762	.	A	C	14	15	29	0	1	30	0	0
1	52136868	.	A	G	10	10	20	0	0	20	0	0
1	52136894	.	T	C	13	15	28	0	1	29	0	0
1	52136917	.	A	C	14	14	28	0	1	29	0	0
1	52137013	.	T	A	7	9	16	0	3	19	0	0
1	52137639	.	A	G	11	5	16	0	2	18	0	0
1	52146021	.	A	T	12	9	21	0	0	21	0	0
1	52149554	.	A	T	16	22	38	0	6	44	0	0
1	52149794	.	A	G	14	13	27	0	0	27	0	0
1	52149952	.	A	G	13	2	15	0	15	30	0	0
1	52149977	.	T	A	17	10	27	0	0	27	0	0
1	52150029	.	T	C	11	15	26	0	1	27	0	0
1	52150152	.	G	A	9	19	28	0	0	28	0	0
1	52150182	.	G	T	2	19	21	0	17	38	0	0
1	52150231	.	C	T	20	19	39	0	0	39	0	0
1	52150812	.	A	G	8	13	21	0	1	22	0	0
1	52150974	.	A	G	9	7	16	0	1	17	0	0
1	52151649	.	A	G	21	8	29	0	1	30	0	0
1	52151865	.	T	C	15	3	18	1	1	20	0	0
1	52151882	.	A	G	15	7	22	1	0	23	0	0
1	52152043	.	A	G	2	7	9	0	0	9	0	0
1	52152202	.	A	G	12	6	18	0	1	19	0	0
1	52152300	.	A	T	5	12	17	0	0	17	0	0
1	52152398	.	T	C	11	18	29	0	0	29	0	0
1	52152406	.	A	C	10	21	31	0	1	32	0	0
1	52152488	.	A	G	15	13	28	0	0	28	0	0
1	52179066	.	C	T	0	5	5	0	11	16	0	0
1	52198224	.	T	C	4	2	6	0	1	7	0	0
1	52452275	.	G	T	6	6	12	0	3	15	0	0
1	52452332	.	C	T	9	8	17	0	0	17	0	0
1	52455908	.	G	A	12	8	20	0	2	22	0	0
1	52455960	.	C	T	10	18	28	0	1	29	0	0
1	52456002	.	G	A	12	13	25	0	0	25	0	0
1	52460737	.	C	T	8	5	13	0	1	14	0	0
1	52460739	.	T	C	8	6	14	0	0	14	0	0
1	52460906	.	T	C	7	5	12	0	0	12	0	0
1	52460944	.	G	T	7	3	10	0	0	10	0	0
1	52471621	.	A	G	1	5	6	0	0	6	0	0
1	52474010	.	C	T	3	4	7	0	1	8	0	0
1	52474335	.	G	A	1	3	4	0	4	8	0	0
1	52478381	.	C	T	2	2	4	0	0	4	0	0
1	52482756	.	C	T	2	3	5	0	0	5	0	0
1	52483416	.	A	T	1	2	3	0	0	3	0	0
1	52485216	.	T	C	5	3	8	0	1	9	0	0
1	52486125	.	T	C	3	2	5	0	0	5	0	0
1	52486198	.	A	G	4	0	4	0	4	8	0	0
1	52486209	.	A	G	3	6	9	0	1	10	0	0
1	52489974	.	G	A	0	4	4	0	4	8	0	0
1	52495045	.	C	T	1	3	4	0	4	8	0	0
1	52495082	.	C	G	1	2	3	2	0	5	0	0
1	52495088	.	G	A	1	2	3	2	0	5	0	0
1	52501213	.	A	C	4	0	4	0	6	10	0	0
1	52501794	.	T	C	4	2	6	0	0	6	0	0
1	52501800	.	G	A	5	2	7	0	0	7	0	0
1	52535674	.	C	T	1	2	3	0	0	3	0	0
1	52538170	.	G	T	1	2	3	0	0	3	0	0
1	52538330	.	A	G	2	2	4	0	0	4	0	0
1	52538341	.	C	A	3	2	5	0	0	5	0	0
1	52595043	.	C	A	2	3	5	0	0	5	0	0
1	52603345	.	T	C	1	5	6	0	0	6	0	0
1	52609221	.	G	A	1	4	5	0	0	5	0	0
1	52611769	.	G	T	0	2	2	0	5	7	0	0
1	52611963	.	A	G	2	4	6	0	0	6	0	0
1	52613216	.	G	T	5	5	10	0	0	10	0	0
1	52614253	.	C	T	6	4	10	0	1	11	0	0
1	52614377	.	C	T	3	5	8	0	0	8	0	0
1	52615031	.	C	T	3	4	7	0	1	8	0	0
1	52618405	.	C	T	14	7	21	0	1	22	0	0
1	52621542	.	C	T	8	4	12	0	1	13	0	0
1	52621545	.	C	T	8	4	12	0	1	13	0	0
1	52623591	.	G	A	14	7	21	0	1	22	0	0
1	52625747	.	C	G	8	1	9	0	8	17	0	0
1	52626826	.	T	A	5	5	10	0	1	11	0	0
1	52627572	.	G	A	2	16	18	1	15	34	0	0
1	52627678	.	A	T	21	19	40	0	1	41	0	0
1	52627679	.	C	T	20	19	39	0	2	41	0	0
1	52627794	.	G	A	16	11	27	0	0	27	0	0
1	52627984	.	T	C	11	11	22	0	0	22	0	0
1	52628253	.	G	T	9	6	15	0	0	15	0	0
1	52628322	.	A	T	2	4	6	0	0	6	0	0
1	52656201	.	C	A	0	4	4	0	8	12	0	0
1	52673464	.	A	T	2	3	5	0	0	5	0	0
1	52676405	.	A	G	5	2	7	0	0	7	0	0
1	52679345	.	A	G	1	3	4	0	0	4	0	0
1	52680016	.	C	T	1	3	4	0	0	4	0	0
1	52681185	.	G	A	2	4	6	0	0	6	0	0
1	52681296	.	C	A	3	6	9	0	0	9	0	0
1	52685099	.	G	A	0	5	5	0	2	7	0	0
1	52685145	.	A	C	8	3	11	0	0	11	0	0
1	52688151	.	C	T	7	8	15	0	1	16	0	0
1	52688223	.	G	A	1	4	5	0	6	11	0	0
1	52688355	.	C	T	5	8	13	0	0	13	0	0
1	52698944	.	G	T	14	10	24	1	1	26	0	0
1	52698955	.	C	T	12	11	23	1	1	25	0	0
1	52764824	.	A	T	6	6	12	0	0	12	0	0
1	52773239	.	G	A	15	16	31	0	1	32	0	0
1	52773311	.	A	G	6	12	18	0	1	19	0	0
1	52775649	.	A	G	7	14	21	0	1	22	0	0
1	52779785	.	G	A	11	6	17	0	0	17	0	0
1	52782161	.	G	A	9	11	20	0	2	22	0	0
1	52782220	.	G	T	8	7	15	0	4	19	0	0
1	52784483	.	C	A	5	4	9	0	1	10	0	0
1	52784527	.	C	T	1	4	5	0	7	12	0	0
1	52784549	.	A	T	7	3	10	0	0	10	0	0
1	52784600	.	G	A	6	2	8	0	0	8	0	0
1	52784679	.	G	C	4	9	13	0	0	13	0	0
1	52784702	.	G	A	7	8	15	0	1	16	0	0
1	52792476	.	C	A	3	5	8	0	0	8	0	0
1	52796142	.	T	C	5	3	8	0	0	8	0	0
1	52796148	.	A	G	4	3	7	0	0	7	0	0
1	52796844	.	T	G	11	7	18	0	0	18	0	0
1	52796850	.	C	T	9	6	15	0	0	15	0	0
1	52797128	.	C	T	8	4	12	0	0	12	0	0
1	52797152	.	T	C	5	4	9	0	0	9	0	0
1	52797239	.	C	T	3	2	5	0	0	5	0	0
1	52798991	.	T	C	10	5	15	0	0	15	0	0
1	52798994	.	C	T	8	5	13	0	0	13	0	0
1	52799789	.	C	T	7	4	11	0	0	11	0	0
1	52812162	.	G	A	16	7	23	0	1	24	0	0
1	52812219	.	C	G	19	8	27	0	1	28	0	0
1	52813633	.	A	T	16	14	30	0	1	31	0	0
1	52817949	.	C	G	18	13	31	0	2	33	0	0
1	53007935	.	A	G	13	6	19	0	0	19	0	0
1	53025666	.	C	T	7	10	17	0	0	17	0	0
1	53025708	.	C	G	10	7	17	0	2	21	2	0
1	53025711	.	C	T	13	8	21	0	1	22	0	0
1	53132860	.	T	C	14	6	20	0	0	20	0	0
1	53156324	.	A	G	13	12	25	0	4	29	0	0
1	53156413	.	C	T	11	8	19	0	0	19	0	0
1	53166094	.	A	G	13	17	30	0	3	33	0	0
1	53168227	.	A	G	18	0	18	0	13	31	0	0
1	53185877	.	A	C	22	13	35	0	1	36	0	0
1	53185906	.	T	C	19	13	32	0	3	35	0	0
1	53185945	.	T	C	17	7	24	0	2	26	0	0
1	53238395	.	G	A	5	3	8	0	0	8	0	0
1	53238404	.	G	T	3	3	6	0	1	7	0	0
1	53238434	.	A	G	5	2	7	0	0	7	0	0
1	53267026	.	A	C	2	0	2	0	7	9	0	0
1	53267349	.	A	G	11	5	16	0	1	17	0	0
1	53269670	.	A	C	8	13	21	0	1	22	0	0
1	53269694	.	A	G	6	8	14	0	0	14	0	0
1	53273488	.	A	G	4	6	10	0	0	10	0	0
1	53273524	.	G	A	10	8	18	0	0	18	0	0
1	53277043	.	T	C	4	2	6	0	4	10	0	0
1	53277064	.	C	T	5	5	10	0	0	10	0	0
1	53296759	.	T	A	1	3	4	0	0	4	0	0
1	53296818	.	A	G	2	2	4	0	1	5	0	0
1	53298561	.	C	T	5	4	9	0	1	10	0	0
1	53298665	.	G	A	1	2	3	0	1	4	0	0
1	53334460	.	C	T	3	7	10	0	0	10	0	0
1	53338551	.	T	C	8	3	11	0	1	12	0	0
1	53340349	.	T	G	4	2	6	0	2	8	0	0
1	53341634	.	A	G	2	2	4	0	0	4	0	0
1	53341664	.	A	G	2	2	4	0	0	4	0	0
1	53343124	.	G	A	3	4	7	0	0	7	0	0
1	53344200	.	T	C	2	4	6	0	3	9	0	0
1	53344204	.	T	G	5	4	9	0	0	9	0	0
1	53348920	.	A	G	4	6	10	0	0	10	0	0
1	53352481	.	T	C	6	6	12	0	1	13	0	0
1	53353593	.	C	T	3	9	12	0	1	13	0	0
1	53359002	.	C	T	8	4	12	0	0	12	0	0
1	53359867	.	T	G	8	7	15	0	0	15	0	0
1	53360153	.	T	C	13	10	23	0	0	23	0	0
1	53360308	.	G	A	9	14	23	0	0	23	0	0
1	53360342	.	C	T	12	12	24	0	0	24	0	0
1	53360369	.	C	T	8	9	17	0	2	19	0	0
1	53360459	.	C	T	17	13	30	0	1	31	0	0
1	53360549	.	T	C	16	10	26	0	1	27	0	0
1	53360871	.	G	A	7	7	14	0	0	14	0	0
1	53387779	.	T	G	3	3	6	0	0	6	0	0
1	53387786	.	C	T	3	3	6	0	0	6	0	0
1	53387829	.	C	T	2	2	4	0	0	4	0	0
1	53387990	.	T	C	2	2	4	0	0	4	0	0
1	53388005	.	T	C	3	3	6	0	0	6	0	0
1	53388135	.	A	C	4	7	11	0	0	11	0	0
1	53388309	.	G	C	7	4	11	0	0	11	0	0
1	53388476	.	A	C	2	3	5	0	1	6	0	0
1	53388540	.	T	A	6	12	18	0	0	18	0	0
1	53388590	.	T	G	6	10	16	0	1	17	0	0
1	53388861	.	A	G	6	3	9	0	1	10	0	0
1	53391669	.	A	C	19	12	31	0	1	32	0	0
1	53391729	.	T	C	20	0	20	2	13	35	0	0
1	53391860	.	G	T	11	2	13	0	0	14	1	0
1	53391916	.	C	T	9	4	13	0	0	13	0	0
1	53391959	.	T	A	11	5	16	0	1	17	0	0
1	53392002	.	A	T	10	11	21	0	1	22	0	0
1	53392064	.	T	C	13	0	13	0	18	31	0	0
1	53392161	.	T	C	15	9	24	0	0	24	0	0
1	53392220	.	C	A	1	6	7	0	6	13	0	0
1	53392227	.	A	T	7	4	11	0	1	12	0	0
1	53394536	.	A	T	1	3	4	0	0	4	0	0
1	53394847	.	T	C	2	2	4	0	0	4	0	0
1	53395627	.	T	C	6	5	11	0	0	11	0	0
1	53395688	.	G	A	10	7	17	0	0	17	0	0
1	53395710	.	G	C	7	7	14	0	0	14	0	0
1	53395828	.	G	A	10	10	20	0	1	21	0	0
1	53401794	.	T	C	2	3	5	0	0	5	0	0
1	53403876	.	T	A	4	5	9	0	0	9	0	0
1	53491563	.	A	G	18	0	18	1	0	19	0	0
1	53491937	.	A	G	9	5	14	0	0	14	0	0
1	53491964	.	T	A	10	8	18	0	1	19	0	0
1	53492000	.	C	A	11	6	17	0	0	17	0	0
1	53668926	.	C	A	3	4	7	0	0	7	0	0
1	53669651	.	A	G	3	3	6	0	2	8	0	0
1	53670917	.	G	T	3	4	7	0	1	8	0	0
1	53672795	.	G	A	2	5	7	0	0	7	0	0
1	53673609	.	C	T	0	2	2	0	6	8	0	0
1	53674825	.	G	A	8	4	12	0	0	12	0	0
1	53684982	.	T	C	1	2	3	0	1	4	0	0
1	53701875	.	A	G	17	8	25	0	3	28	0	0
1	53701905	.	T	G	23	13	36	0	3	39	0	0
1	53703149	.	G	A	17	18	35	1	2	38	0	0
1	53703194	.	G	T	18	25	43	1	4	48	0	0
1	53704485	.	C	A	24	30	54	0	1	55	0	0
1	53705191	.	G	A	21	21	42	0	1	43	0	0
1	53705203	.	G	A	22	21	43	0	2	45	0	0
1	53705266	.	A	G	24	22	46	0	3	49	0	0
1	53709732	.	C	A	3	15	18	0	14	32	0	0
1	53709762	.	C	T	20	12	32	0	0	32	0	0
1	53713449	.	G	T	10	18	28	0	0	28	0	0
1	53714586	.	A	G	9	8	17	0	1	19	1	0
1	53714592	.	T	G	12	9	21	0	1	22	0	0
1	53714790	.	T	A	14	19	33	0	0	33	0	0
1	53714974	.	T	A	6	5	11	1	0	12	0	0
1	53714977	.	T	G	6	0	6	1	5	12	0	0
1	53715069	.	T	G	1	0	1	0	4	5	0	0
1	53718266	.	A	G	2	3	5	0	0	5	0	0
1	53718294	.	A	T	1	4	5	0	0	5	0	0
1	53719831	.	T	C	2	3	5	0	0	5	0	0
1	53720360	.	T	G	5	5	10	0	0	10	0	0
1	53724724	.	T	A	2	6	8	0	0	8	0	0
1	53726457	.	G	A	4	8	12	0	0	12	0	0
1	53726662	.	G	A	8	6	14	0	0	14	0	0
1	53727755	.	C	T	8	6	14	0	1	15	0	0
1	53729934	.	G	A	5	2	7	0	0	7	0	0
1	53730412	.	A	G	1	2	3	0	0	3	0	0
1	53735245	.	C	T	18	6	24	0	0	24	0	0
1	53735249	.	C	T	17	6	23	0	0	23	0	0
1	53735648	.	A	G	19	14	33	0	0	33	0	0
1	53735702	.	T	G	19	9	28	0	1	29	0	0
1	53735712	.	G	A	18	12	30	0	0	30	0	0
1	53739397	.	G	A	11	9	20	0	1	21	0	0
1	53756723	.	C	T	1	11	12	0	16	28	0	0
1	53866223	.	A	T	8	5	13	0	0	13	0	0
1	53871326	.	T	A	5	8	13	2	0	15	0	0
1	53871383	.	A	G	6	5	11	0	1	13	1	0
1	53872031	.	C	A	13	9	22	0	0	22	0	0
1	53873112	.	T	C	9	0	9	0	8	17	0	0
1	53879314	.	T	A	3	5	8	0	0	8	0	0
1	53879353	.	C	T	0	8	8	0	3	11	0	0
1	53879397	.	C	T	3	4	7	0	0	7	0	0
1	53879731	.	T	C	4	0	4	0	3	7	0	0
1	53879767	.	G	A	3	2	5	0	0	5	0	0
1	53912019	.	G	A	1	3	4	0	0	4	0	0
1	53912307	.	A	G	1	8	9	0	0	9	0	0
1	53912418	.	G	T	4	5	9	0	1	10	0	0
1	53912607	.	T	C	2	0	2	0	2	4	0	0
1	53912637	.	A	G	1	2	3	0	0	3	0	0
1	53919228	.	G	T	1	2	3	0	2	5	0	0
1	53926940	.	G	T	3	6	9	0	0	9	0	0
1	53929218	.	G	A	4	2	6	0	1	7	0	0
1	53929219	.	C	A	4	3	7	0	0	7	0	0
1	53932271	.	A	G	4	5	9	0	0	9	0	0
1	53935236	.	G	A	3	5	8	0	0	8	0	0
1	53935248	.	G	T	0	4	4	0	3	7	0	0
1	53935287	.	A	G	7	0	7	0	5	12	0	0
1	53935314	.	T	C	7	7	14	0	1	15	0	0
1	53935335	.	C	T	7	5	12	0	1	13	0	0
1	53937423	.	C	T	7	3	10	0	2	12	0	0
1	53939430	.	A	G	1	4	5	0	1	6	0	0
1	53939604	.	C	T	8	6	14	0	0	14	0	0
1	53954314	.	G	A	2	6	8	0	5	13	0	0
1	53954361	.	C	A	9	6	15	0	0	15	0	0
1	53954385	.	A	C	9	6	15	0	0	15	0	0
1	53955055	.	G	A	7	10	17	0	1	18	0	0
1	53958136	.	G	A	1	8	9	0	17	26	0	0
1	53958263	.	C	T	17	13	30	0	0	30	0	0
1	53962227	.	A	T	7	12	19	0	0	19	0	0
1	53962264	.	T	C	9	6	15	0	2	17	0	0
1	53962490	.	T	G	10	4	14	0	1	15	0	0
1	53962860	.	G	A	0	5	5	1	12	18	0	0
1	53962863	.	C	T	12	7	19	1	0	20	0	0
1	53962900	.	T	A	11	8	19	1	1	21	0	0
1	53962961	.	C	T	6	3	9	0	0	9	0	0
1	53963108	.	C	A	7	12	19	0	1	20	0	0
1	53963159	.	C	T	16	9	25	0	1	26	0	0
1	53963782	.	A	G	9	9	18	0	1	19	0	0
1	53980446	.	C	T	2	2	4	0	0	4	0	0
1	53987605	.	G	A	2	3	5	0	0	5	0	0
1	54048674	.	A	G	3	0	3	0	3	6	0	0
1	54048689	.	C	T	4	5	9	0	0	9	0	0
1	54048786	.	G	A	1	3	4	0	0	4	0	0
1	54062754	.	G	A	20	22	42	0	1	43	0	0
1	54062858	.	A	G	20	19	39	0	1	40	0	0
1	54063478	.	C	T	1	2	3	0	0	3	0	0
1	54077472	.	T	C	1	4	5	0	0	5	0	0
1	54080067	.	A	T	1	2	3	0	1	4	0	0
1	54080189	.	T	G	5	0	5	0	4	9	0	0
1	54080516	.	T	C	2	2	4	0	0	4	0	0
1	54084473	.	G	C	2	5	7	2	0	9	0	0
1	54084613	.	G	A	1	1	2	0	3	7	2	0
1	54084616	.	C	T	5	2	7	0	0	7	0	0
1	54097446	.	A	G	3	3	6	0	0	6	0	0
1	54137238	.	A	G	7	6	13	0	0	13	0	0
1	54140472	.	A	T	4	8	12	0	0	12	0	0
1	54142097	.	T	C	6	11	17	0	0	17	0	0
1	54142130	.	G	T	0	15	15	0	5	20	0	0
1	54144024	.	T	G	9	8	17	0	0	17	0	0
1	54146383	.	C	T	14	11	25	0	0	25	0	0
1	54146416	.	T	C	14	8	22	0	2	24	0	0
1	54154371	.	T	C	6	0	6	0	2	8	0	0
1	54154383	.	T	G	5	3	8	0	0	8	0	0
1	54158479	.	A	G	6	3	9	0	0	9	0	0
1	54167596	.	G	T	1	3	4	0	0	4	0	0
1	54178755	.	G	C	4	10	14	0	1	15	0	0
1	54182416	.	T	A	3	3	6	0	0	6	0	0
1	54182419	.	A	G	3	3	6	0	0	6	0	0
1	54184468	.	C	T	5	3	8	0	1	9	0	0
1	54189094	.	T	C	3	3	6	0	0	6	0	0
1	54190801	.	G	A	1	2	3	0	0	3	0	0
1	54194875	.	G	A	0	2	2	0	1	3	0	0
1	54199009	.	G	A	1	3	4	0	0	4	0	0
1	54209203	.	T	C	4	2	6	0	0	6	0	0
1	54210220	.	A	G	3	4	7	0	0	7	0	0
1	54244432	.	T	C	2	7	9	0	1	10	0	0
1	54245914	.	G	A	5	6	11	0	0	11	0	0
1	54248366	.	A	C	5	6	11	0	3	14	0	0
1	54253768	.	G	A	0	10	10	0	12	22	0	0
1	54255651	.	C	T	12	5	17	0	0	17	0	0
1	54262843	.	G	A	8	9	17	1	0	18	0	0
1	54282327	.	T	G	1	3	4	0	0	4	0	0
1	54674027	.	A	T	1	2	3	0	0	3	0	0
1	54674388	.	A	G	4	9	13	0	1	14	0	0
1	54674430	.	A	G	6	0	6	0	10	16	0	0
1	54683743	.	C	T	9	9	18	0	0	18	0	0
1	54685590	.	A	G	10	4	14	0	1	15	0	0
1	54685610	.	T	C	10	4	14	0	0	14	0	0
1	54687580	.	C	T	5	3	8	0	0	8	0	0
1	54687649	.	G	T	6	7	13	0	0	13	0	0
1	54687715	.	C	A	7	6	13	1	0	14	0	0
1	54687928	.	G	T	11	6	17	0	0	17	0	0
1	54687981	.	A	G	4	6	10	0	3	13	0	0
1	54689329	.	T	C	9	6	15	0	0	15	0	0
1	54701201	.	C	G	6	8	14	0	7	21	0	0
1	54701231	.	G	A	7	7	14	0	5	19	0	0
1	54703469	.	C	T	2	3	5	0	9	14	0	0
1	54707977	.	G	A	31	29	60	0	2	62	0	0
1	54708098	.	G	T	38	22	60	0	3	63	0	0
1	54708191	.	C	A	32	29	61	0	1	62	0	0
1	54708253	.	G	A	33	30	63	0	3	66	0	0
1	54708281	.	A	T	36	29	65	0	4	69	0	0
1	54708301	.	A	C	44	29	73	0	0	73	0	0
1	54708317	.	C	T	40	27	67	0	1	68	0	0
1	54708359	.	C	T	34	26	60	0	3	63	0	0
1	54709171	.	T	C	10	10	20	0	1	21	0	0
1	54709334	.	G	A	29	23	52	0	3	55	0	0
1	54731890	.	A	C	1	4	5	1	0	6	0	0
1	54737506	.	C	A	5	3	8	0	2	10	0	0
1	54737684	.	A	G	5	1	6	0	5	11	0	0
1	54747720	.	T	C	1	3	4	0	1	5	0	0
1	54747729	.	A	G	2	0	2	0	3	5	0	0
1	54748062	.	T	G	0	0	0	0	3	3	0	0
1	54750254	.	A	G	2	0	2	0	3	5	0	0
1	54750500	.	G	A	2	2	4	0	1	5	0	0
1	54753095	.	T	G	6	0	6	0	5	11	0	0
1	54753101	.	T	C	5	5	10	0	1	11	0	0
1	54753167	.	A	G	2	6	8	0	1	9	0	0
1	54753173	.	G	C	0	5	5	0	3	8	0	0
1	54753615	.	G	A	6	2	8	0	0	8	0	0
1	54753623	.	T	G	4	2	6	0	0	6	0	0
1	54753982	.	G	T	6	2	8	1	1	10	0	0
1	54754356	.	C	T	10	5	15	0	1	16	0	0
1	54754482	.	T	G	7	8	15	0	1	16	0	0
1	54754503	.	G	A	8	7	15	0	2	17	0	0
1	54754623	.	A	T	3	8	11	0	0	11	0	0
1	54754626	.	T	A	3	8	11	0	0	11	0	0
1	54754744	.	C	T	4	5	9	0	1	10	0	0
1	54754754	.	T	C	3	6	9	0	0	9	0	0
1	54754834	.	C	T	6	16	22	0	0	22	0	0
1	54754839	.	C	T	6	17	23	0	0	23	0	0
1	54755349	.	A	T	2	3	5	0	0	5	0	0
1	54758624	.	A	T	8	7	15	0	0	15	0	0
1	54758725	.	C	T	4	16	20	0	14	34	0	0
1	54758810	.	C	T	13	18	31	0	0	31	0	0
1	54758975	.	T	C	12	19	31	0	3	34	0	0
1	54759065	.	G	A	16	12	28	1	1	30	0	0
1	54762947	.	G	A	17	16	33	0	0	33	0	0
1	54762997	.	G	T	12	22	34	0	3	37	0	0
1	54763022	.	G	C	10	23	33	0	2	35	0	0
1	54763070	.	C	G	1	13	14	0	7	21	0	0
1	54763106	.	A	G	7	5	12	0	0	12	0	0
1	54763133	.	T	C	3	5	8	0	1	9	0	0
1	54763182	.	A	G	18	6	24	0	1	25	0	0
1	54763187	.	G	A	19	7	26	0	1	27	0	0
1	54763298	.	G	A	11	11	22	0	1	23	0	0
1	54765216	.	A	C	16	0	16	0	14	30	0	0
1	54765218	.	C	T	0	14	14	0	16	30	0	0
1	54772474	.	C	T	1	1	2	2	0	4	0	0
1	54772483	.	A	C	0	3	3	3	0	6	0	0
1	54777350	.	T	G	4	0	4	0	2	6	0	0
1	54777359	.	C	A	4	3	7	0	0	7	0	0
1	54893126	.	C	G	3	3	6	0	0	6	0	0
1	54893140	.	G	A	0	3	3	0	3	6	0	0
1	54893198	.	G	A	0	2	2	0	3	5	0	0
1	54893265	.	G	C	4	2	6	0	1	7	0	0
1	54895011	.	G	A	0	2	2	0	4	6	0	0
1	54897256	.	C	T	6	6	12	0	1	13	0	0
1	54897288	.	C	T	2	9	11	0	0	11	0	0
1	54898178	.	G	A	0	4	4	0	3	7	0	0
1	54906069	.	T	C	8	3	11	0	0	11	0	0
1	54906162	.	G	A	1	5	6	0	1	7	0	0
1	54906192	.	T	C	4	5	9	0	0	9	0	0
1	54906476	.	G	C	1	8	9	0	7	16	0	0
1	54906619	.	T	A	7	6	13	0	0	13	0	0
1	54907021	.	G	A	11	7	18	0	0	18	0	0
1	54907367	.	T	G	3	6	9	0	0	9	0	0
1	54907502	.	A	G	4	5	9	0	1	10	0	0
1	54907549	.	T	C	8	12	20	0	0	20	0	0
1	54907585	.	G	C	16	7	23	0	0	23	0	0
1	54907600	.	A	T	18	6	24	0	1	25	0	0
1	54907622	.	T	C	18	7	25	0	0	25	0	0
1	54927198	.	T	C	15	16	31	0	2	33	0	0
1	54929168	.	G	A	11	14	25	5	0	30	0	0
1	54929256	.	T	C	8	18	26	0	0	26	0	0
1	54929281	.	G	A	1	15	16	0	8	24	0	0
1	54929293	.	C	T	9	15	24	0	2	26	0	0
1	54929373	.	C	G	7	4	11	0	1	12	0	0
1	54929994	.	T	C	7	6	13	1	1	15	0	0
1	54930026	.	G	A	7	5	12	0	0	12	0	0
1	54930316	.	G	A	1	2	3	0	0	3	0	0
1	54930428	.	T	A	8	12	20	0	0	20	0	0
1	54930486	.	G	A	7	6	13	0	1	14	0	0
1	54930598	.	A	G	6	14	20	0	1	21	0	0
1	54930693	.	T	C	5	7	12	0	1	13	0	0
1	54930711	.	G	A	7	7	14	0	0	14	0	0
1	54930776	.	A	G	12	10	22	0	1	23	0	0
1	54930868	.	C	A	12	10	22	0	1	23	0	0
1	54931111	.	T	C	8	7	15	0	0	15	0	0
1	54931122	.	G	A	0	5	5	0	8	13	0	0
1	54931211	.	A	T	11	13	24	0	0	24	0	0
1	54931230	.	T	A	11	11	22	0	1	23	0	0
1	54931791	.	G	C	1	9	10	0	17	27	0	0
1	54936235	.	G	T	9	10	19	0	0	19	0	0
1	54936471	.	T	C	10	0	10	0	10	20	0	0
1	54938274	.	T	C	4	5	9	0	0	9	0	0
1	54939536	.	A	T	2	5	7	0	0	7	0	0
1	54943139	.	G	A	1	4	5	0	1	6	0	0
1	54943160	.	A	G	2	2	4	0	0	4	0	0
1	54943178	.	G	A	0	1	1	0	2	3	0	0
1	54950534	.	T	C	11	11	22	0	0	22	0	0
1	54950572	.	G	A	7	14	21	0	2	23	0	0
1	54950661	.	G	A	10	6	16	0	0	16	0	0
1	54950745	.	G	T	9	10	19	0	0	19	0	0
1	54950801	.	A	G	7	6	13	0	0	13	0	0
1	54955207	.	G	A	13	8	21	0	0	21	0	0
1	54955234	.	A	G	19	6	25	0	0	25	0	0
1	54958033	.	G	A	0	2	2	0	7	9	0	0
1	54958123	.	A	G	6	4	10	0	2	12	0	0
1	54958146	.	T	A	7	4	11	0	2	13	0	0
1	54960328	.	A	G	10	9	19	0	0	19	0	0
1	54960368	.	T	G	15	15	30	0	1	31	0	0
1	54960416	.	A	C	19	16	35	0	0	35	0	0
1	54960563	.	T	A	20	13	33	2	6	41	0	0
1	54960881	.	A	G	15	13	28	4	5	37	0	0
1	54962466	.	A	G	19	21	40	0	0	40	0	0
1	54963314	.	A	G	12	19	31	0	0	31	0	0
1	54964724	.	A	G	15	12	27	0	0	27	0	0
1	54968253	.	A	T	6	5	11	0	0	11	0	0
1	54974437	.	C	A	13	5	18	0	1	19	0	0
1	54974438	.	A	G	14	5	19	0	0	19	0	0
1	54974477	.	G	A	13	5	18	0	1	19	0	0
1	54974500	.	T	A	10	9	19	0	0	19	0	0
1	54974538	.	A	G	9	8	17	0	0	17	0	0
1	54974660	.	T	C	10	7	17	1	2	20	0	0
1	54974774	.	G	A	5	12	17	0	1	18	0	0
1	54974810	.	G	T	14	7	21	0	3	24	0	0
1	54975431	.	C	T	8	4	12	0	1	13	0	0
1	54975484	.	G	T	9	7	16	0	1	17	0	0
1	54975636	.	C	T	15	7	22	0	0	22	0	0
1	54975658	.	A	G	14	7	21	0	0	21	0	0
1	54975762	.	A	T	6	8	14	0	0	14	0	0
1	54975884	.	A	G	10	4	14	0	3	17	0	0
1	54975911	.	G	A	9	4	13	0	2	15	0	0
1	54976026	.	T	A	6	11	17	0	0	17	0	0
1	54976035	.	T	A	5	8	13	0	1	14	0	0
1	54976178	.	T	C	12	0	12	0	13	25	0	0
1	54976353	.	A	G	16	12	28	2	0	30	0	0
1	54976359	.	T	C	14	10	24	2	0	26	0	0
1	54976497	.	T	C	13	6	19	0	0	19	0	0
1	54976731	.	C	T	6	2	8	0	1	9	0	0
1	54976732	.	A	G	7	2	9	0	0	9	0	0
1	54976784	.	T	A	4	3	7	0	1	8	0	0
1	54976798	.	C	A	5	2	7	0	1	8	0	0
1	54977268	.	T	C	7	5	12	0	0	12	0	0
1	54977572	.	G	A	8	6	14	0	1	15	0	0
1	54977618	.	G	A	6	7	13	0	1	14	0	0
1	54977697	.	G	A	11	6	17	0	2	19	0	0
1	54977719	.	T	A	8	5	13	0	0	13	0	0
1	54977767	.	A	T	2	4	6	0	0	6	0	0
1	54977781	.	A	G	3	4	7	0	0	7	0	0
1	54978022	.	T	G	8	11	19	0	1	20	0	0
1	54978023	.	C	T	0	11	11	0	9	20	0	0
1	54978478	.	T	C	5	4	9	0	0	9	0	0
1	54981628	.	G	A	6	5	11	0	1	12	0	0
1	54984172	.	A	G	3	8	11	0	0	11	0	0
1	54984206	.	T	C	3	0	3	0	6	9	0	0
1	54984587	.	C	T	8	6	14	0	1	15	0	0
1	54987539	.	A	G	10	5	15	0	0	15	0	0
1	54988190	.	T	G	4	3	7	0	0	7	0	0
1	54988259	.	G	A	7	9	16	0	0	16	0	0
1	54997275	.	T	C	9	0	9	0	5	14	0	0
1	54997327	.	T	C	5	2	7	0	0	7	0	0
1	55008322	.	A	G	15	7	22	0	2	25	1	0
1	55008382	.	C	T	16	10	26	0	1	27	0	0
1	55008405	.	G	A	15	10	25	0	1	26	0	0
1	55008594	.	A	T	10	8	18	0	2	20	0	0
1	55008772	.	T	C	13	10	23	0	3	26	0	0
1	55011353	.	G	C	6	4	10	0	0	10	0	0
1	55011514	.	C	T	5	10	15	0	0	15	0	0
1	55011539	.	A	T	3	10	13	0	0	13	0	0
1	55011550	.	G	A	2	11	13	0	2	15	0	0
1	55011692	.	C	T	1	6	7	0	2	9	0	0
1	55018941	.	A	G	2	2	4	0	0	4	0	0
1	55018954	.	A	G	3	2	5	0	0	5	0	0
1	55021862	.	A	T	1	3	4	0	0	4	0	0
1	55021886	.	G	A	1	3	4	0	1	5	0	0
1	55021952	.	G	A	3	2	5	0	0	5	0	0
1	55022075	.	T	C	2	0	2	0	2	4	0	0
1	55022162	.	T	A	5	2	7	0	0	8	1	0
1	55032909	.	A	G	3	2	5	0	1	6	0	0
1	55046509	.	G	A	2	2	4	0	0	4	0	0
1	55046541	.	A	G	1	4	5	0	0	5	0	0
1	55049427	.	C	A	0	3	3	0	2	5	0	0
1	55080832	.	A	G	3	1	4	0	0	4	0	0
1	55080840	.	A	G	4	0	4	0	2	6	0	0
1	55080893	.	G	C	5	3	8	0	0	8	0	0
1	55080905	.	A	G	5	4	9	0	0	9	0	0
1	55085782	.	A	G	1	0	1	0	5	6	0	0
1	55085830	.	A	T	1	4	5	0	0	5	0	0
1	55087823	.	G	C	1	3	4	0	0	4	0	0
1	55087925	.	T	A	2	2	4	0	0	4	0	0
1	55087926	.	C	T	2	2	4	0	0	4	0	0
1	55088467	.	T	A	1	4	5	0	0	5	0	0
1	55088490	.	C	A	1	2	3	0	0	3	0	0
1	55088871	.	A	G	3	0	3	0	2	5	0	0
1	55089078	.	T	A	9	5	14	0	0	14	0	0
1	55089115	.	G	T	1	3	4	0	2	7	1	0
1	55089120	.	G	T	4	3	7	0	0	7	0	0
1	55089396	.	C	T	5	9	14	0	0	14	0	0
1	55089449	.	G	A	1	2	3	0	0	3	0	0
1	55089877	.	C	T	1	3	4	0	0	4	0	0
1	55099316	.	T	C	6	10	16	0	0	16	0	0
1	55099411	.	G	A	9	8	17	0	0	17	0	0
1	55099880	.	C	G	5	6	11	0	1	12	0	0
1	55100378	.	G	A	0	7	7	0	7	14	0	0
1	55100397	.	G	C	5	7	12	0	1	13	0	0
1	55100422	.	T	A	11	5	16	0	0	16	0	0
1	55101439	.	C	A	14	13	27	0	1	28	0	0
1	55103163	.	A	C	15	10	25	0	0	25	0	0
1	55109717	.	A	T	9	8	17	0	1	18	0	0
1	55113410	.	G	A	2	3	5	0	0	5	0	0
1	55126626	.	A	C	7	0	7	0	7	14	0	0
1	55126635	.	G	A	7	5	12	0	0	12	0	0
1	55127910	.	C	T	7	6	13	0	0	13	0	0
1	55131337	.	A	T	14	10	24	0	2	26	0	0
1	55131359	.	A	T	13	7	20	0	2	22	0	0
1	55161252	.	T	C	3	0	3	0	5	8	0	0
1	55169244	.	G	C	6	4	10	0	0	10	0	0
1	55169260	.	G	A	3	8	11	0	0	11	0	0
1	55169349	.	G	C	10	6	16	0	0	16	0	0
1	55169658	.	T	A	16	9	25	0	1	26	0	0
1	55169830	.	T	C	8	6	14	1	3	18	0	0
1	55170051	.	T	A	10	8	18	1	0	19	0	0
1	55170328	.	C	A	12	5	17	2	0	19	0	0
1	55170366	.	C	T	11	6	17	1	2	20	0	0
1	55170384	.	G	A	11	9	20	0	1	21	0	0
1	55170856	.	T	C	6	0	6	1	8	15	0	0
1	55170866	.	T	C	6	0	6	1	7	14	0	0
1	55170920	.	C	T	4	2	6	0	0	6	0	0
1	55171249	.	G	A	15	11	26	0	1	27	0	0
1	55179434	.	C	T	10	7	17	0	0	17	0	0
1	55179470	.	C	T	6	6	12	0	0	12	0	0
1	55182808	.	C	T	5	4	9	0	0	9	0	0
1	55183074	.	G	A	8	5	13	0	1	14	0	0
1	55191256	.	A	T	5	6	11	0	1	12	0	0
1	55191471	.	T	C	14	0	14	0	5	19	0	0
1	55191559	.	G	A	5	6	11	0	3	14	0	0
1	55191675	.	A	G	17	6	23	0	2	25	0	0
1	55195384	.	G	T	8	8	16	0	2	18	0	0
1	55196024	.	G	T	12	6	18	0	0	18	0	0
1	55223001	.	A	C	2	0	2	0	9	11	0	0
1	55223241	.	G	C	4	2	6	0	0	6	0	0
1	55228562	.	C	G	0	3	3	0	2	5	0	0
1	55229456	.	A	G	1	2	3	0	0	3	0	0
1	55229531	.	T	A	4	3	7	0	0	7	0	0
1	55229767	.	T	C	3	3	6	0	0	6	0	0
1	55233436	.	C	T	2	6	8	0	0	8	0	0
1	55233785	.	G	T	1	2	3	0	0	3	0	0
1	55233824	.	G	A	3	2	5	0	0	5	0	0
1	55233833	.	C	T	3	2	5	0	0	5	0	0
1	55234200	.	G	C	2	2	4	0	0	4	0	0
1	55236239	.	G	A	3	2	5	0	0	5	0	0
1	55236308	.	G	A	4	3	7	0	0	7	0	0
1	55746029	.	G	T	2	2	4	0	0	4	0	0
1	55746054	.	T	A	2	3	5	0	0	5	0	0
1	55746216	.	C	T	1	3	4	0	0	4	0	0
1	55749954	.	C	T	1	1	2	0	1	3	0	0
1	55776909	.	A	C	21	6	27	0	2	31	2	0
1	55785527	.	C	A	5	29	34	0	31	65	0	0
1	55785654	.	C	T	20	18	38	1	1	40	0	0
1	55785697	.	C	T	2	10	12	0	0	12	0	0
1	55817658	.	T	C	6	0	6	0	5	11	0	0
1	55817661	.	A	T	6	4	10	0	0	10	0	0
1	55818319	.	T	C	4	2	6	0	0	6	0	0
1	55824892	.	C	G	5	6	11	0	1	12	0	0
1	55833139	.	G	C	5	7	12	0	0	12	0	0
1	55833185	.	G	A	4	8	12	0	1	13	0	0
1	55833276	.	C	T	3	3	6	0	0	6	0	0
1	55833281	.	C	T	3	2	5	0	0	5	0	0
1	55839011	.	C	G	2	2	4	0	0	4	0	0
1	55843902	.	C	T	16	20	36	0	3	39	0	0
1	55843968	.	G	A	21	12	33	0	1	34	0	0
1	55844044	.	T	A	18	16	34	0	0	34	0	0
1	55844401	.	A	G	18	20	38	0	0	38	0	0
1	55849463	.	T	C	13	0	13	2	15	30	0	0
1	55853320	.	G	A	7	18	25	0	0	25	0	0
1	55872892	.	C	G	12	12	24	1	1	26	0	0
1	55873073	.	C	T	11	15	26	0	0	26	0	0
1	55878243	.	C	T	1	2	3	0	1	4	0	0
1	55878400	.	C	T	2	4	6	0	4	10	0	0
1	55878496	.	T	C	8	1	9	0	5	14	0	0
1	55878624	.	T	A	3	5	8	0	0	8	0	0
1	55878626	.	A	C	3	4	7	0	1	8	0	0
1	55878761	.	T	G	7	0	7	0	7	14	0	0
1	55885148	.	C	T	2	9	11	0	13	24	0	0
1	55888632	.	T	C	9	0	9	0	4	13	0	0
1	55888690	.	A	G	5	2	7	0	0	7	0	0
1	55888693	.	T	A	5	2	7	0	0	7	0	0
1	55888906	.	T	A	4	3	7	0	0	7	0	0
1	56217450	.	G	T	7	5	12	0	2	14	0	0
1	56217510	.	A	G	23	30	53	0	1	54	0	0
1	56217925	.	G	A	41	24	65	0	8	73	0	0
1	56218141	.	A	G	36	40	76	0	2	79	1	0
1	56218189	.	C	T	2	34	36	0	33	69	0	0
1	56218360	.	G	C	36	1	37	0	31	68	0	0
1	56223902	.	T	G	1	2	3	0	0	3	0	0
1	56424791	.	C	T	1	11	12	0	5	17	0	0
1	56424794	.	T	C	5	0	5	0	11	16	0	0
1	56425843	.	T	C	11	0	11	0	5	16	0	0
1	56428320	.	G	A	5	11	16	0	1	17	0	0
1	57278282	.	T	G	4	5	9	0	0	9	0	0
1	57278325	.	A	C	8	2	10	0	1	11	0	0
1	57278525	.	A	G	1	2	3	0	0	3	0	0
1	57278610	.	T	G	1	4	5	0	0	5	0	0
1	57278690	.	G	A	6	5	11	0	2	13	0	0
1	57278714	.	C	T	0	5	5	0	4	9	0	0
1	57280184	.	G	T	2	5	7	0	0	7	0	0
1	57280292	.	T	C	2	4	6	0	0	6	0	0
1	57280400	.	G	A	2	5	7	0	0	7	0	0
1	57280502	.	T	C	5	5	10	0	0	10	0	0
1	57331951	.	G	A	0	3	3	0	2	5	0	0
1	57331957	.	C	T	1	2	3	0	0	3	0	0
1	57334741	.	T	C	6	4	10	0	0	10	0	0
1	57337107	.	T	C	2	7	9	0	0	10	1	0
1	57337110	.	C	T	3	7	10	0	0	10	0	0
1	57338226	.	G	A	0	3	3	0	5	8	0	0
1	57338268	.	G	A	0	6	6	0	6	12	0	0
1	57340164	.	T	A	1	2	3	0	1	4	0	0
1	57347987	.	G	T	5	3	8	0	0	8	0	0
1	57364312	.	G	A	4	3	7	0	0	7	0	0
1	57364579	.	A	G	1	0	1	0	3	4	0	0
1	57364588	.	A	G	0	3	3	0	0	3	0	0
1	57364655	.	A	T	2	2	4	0	0	4	0	0
1	57364666	.	G	A	2	3	5	0	0	5	0	0
1	57365026	.	A	G	1	0	1	0	3	4	0	0
1	57381763	.	C	T	1	2	3	0	0	3	0	0
1	57381768	.	C	T	1	2	3	0	0	3	0	0
1	57758217	.	A	G	1	2	3	0	0	3	0	0
1	58013423	.	C	T	2	4	6	0	11	17	0	0
1	58013474	.	T	C	2	0	2	0	3	5	0	0
1	58013554	.	G	A	3	4	7	0	0	7	0	0
1	58015532	.	T	G	2	4	6	0	0	6	0	0
1	58015556	.	T	C	3	0	3	0	4	7	0	0
1	58017698	.	T	A	1	2	3	0	0	3	0	0
1	58018622	.	G	A	2	3	5	0	0	5	0	0
1	58019888	.	A	T	6	3	9	0	0	10	1	0
1	58545734	.	C	G	5	4	9	0	0	9	0	0
1	58547354	.	C	A	5	2	7	0	0	7	0	0
1	58547783	.	T	C	3	4	7	0	0	7	0	0
1	58548428	.	T	C	4	7	11	0	0	11	0	0
1	58548491	.	T	C	6	3	9	0	0	9	0	0
1	58564408	.	T	C	4	0	4	0	3	7	0	0
1	58593731	.	G	A	4	2	6	0	0	6	0	0
1	58593833	.	C	A	4	4	8	0	0	8	0	0
1	58593835	.	T	C	4	3	7	0	1	8	0	0
1	58593912	.	C	T	2	7	9	0	0	9	0	0
1	58594442	.	T	C	3	9	12	0	1	13	0	0
1	58594470	.	T	C	6	8	14	0	0	14	0	0
1	58594611	.	T	G	4	5	9	0	0	9	0	0
1	58595018	.	C	T	12	6	18	0	0	18	0	0
1	58595198	.	A	G	5	10	15	0	0	15	0	0
1	58595386	.	G	A	2	5	7	0	1	8	0	0
1	58595455	.	G	A	6	3	9	0	0	9	0	0
1	58595545	.	T	C	3	6	9	0	0	9	0	0
1	58598802	.	T	C	1	0	1	0	7	8	0	0
1	58598830	.	A	T	2	3	5	0	0	5	0	0
1	58601615	.	G	A	4	6	10	0	0	10	0	0
1	58601620	.	T	C	4	6	10	0	0	10	0	0
1	58605222	.	G	A	0	2	2	1	1	4	0	0
1	58606230	.	T	C	2	2	4	0	0	4	0	0
1	58612519	.	T	C	5	5	10	0	0	10	0	0
1	58612762	.	A	G	8	3	11	0	0	11	0	0
1	58613091	.	A	C	6	2	8	0	0	8	0	0
1	58617410	.	T	C	1	3	4	0	0	4	0	0
1	58617987	.	T	C	5	4	9	0	0	9	0	0
1	58618014	.	C	T	8	3	11	0	0	11	0	0
1	58618035	.	C	T	3	5	8	0	1	9	0	0
1	58618411	.	A	G	1	3	4	1	0	5	0	0
1	58631261	.	C	T	3	2	5	0	0	5	0	0
1	58631374	.	A	G	1	4	5	0	0	5	0	0
1	58631609	.	C	T	2	3	5	0	0	5	0	0
1	58631695	.	A	T	1	3	4	0	1	5	0	0
1	58631923	.	C	T	1	3	4	1	0	5	0	0
1	58677839	.	T	C	6	7	13	0	0	13	0	0
1	58677856	.	C	T	6	6	12	0	1	13	0	0
1	58677993	.	A	G	2	7	9	0	0	9	0	0
1	58678017	.	T	C	2	5	7	0	1	8	0	0
1	58680432	.	T	A	3	6	9	0	1	10	0	0
1	58680499	.	C	A	8	16	24	0	1	25	0	0
1	58680708	.	T	C	10	11	21	0	1	22	0	0
1	58680718	.	C	G	10	9	19	0	0	19	0	0
1	58680792	.	T	C	8	7	15	0	1	16	0	0
1	58680913	.	T	C	12	8	20	0	0	20	0	0
1	58681068	.	C	T	7	7	14	0	1	15	0	0
1	58681419	.	A	T	7	15	22	0	0	26	4	0
1	58681491	.	T	C	11	11	22	0	0	22	0	0
1	58762985	.	T	G	4	8	12	0	0	12	0	0
1	58766341	.	G	A	3	6	9	0	0	9	0	0
1	58846670	.	C	A	1	3	4	0	0	4	0	0
1	58850562	.	C	T	5	4	9	0	1	10	0	0
1	58982147	.	G	A	0	9	9	0	4	13	0	0
1	58982195	.	C	G	9	6	15	0	0	15	0	0
1	58984368	.	G	A	0	7	7	0	10	17	0	0
1	58984478	.	T	C	7	6	13	0	1	14	0	0
1	58984640	.	C	T	8	6	14	0	0	14	0	0
1	58985530	.	G	A	8	9	17	0	1	18	0	0
1	58985579	.	T	G	7	15	22	0	1	23	0	0
1	58993039	.	T	G	1	3	4	0	0	4	0	0
1	58993894	.	T	C	2	4	6	0	0	6	0	0
1	59009732	.	A	G	22	0	22	0	17	39	0	0
1	59010618	.	G	A	17	20	37	0	3	40	0	0
1	59019006	.	C	G	6	5	11	0	1	12	0	0
1	59019084	.	T	A	4	4	8	0	0	8	0	0
1	59019093	.	A	G	3	5	8	0	0	8	0	0
1	59062665	.	T	C	26	25	51	0	3	54	0	0
1	59065889	.	G	A	3	17	20	0	12	32	0	0
1	59141415	.	C	A	5	6	11	0	0	12	1	0
1	59143004	.	T	C	2	5	7	0	0	7	0	0
1	59146013	.	C	T	1	3	4	0	0	4	0	0
1	59146790	.	A	G	2	7	9	0	0	9	0	0
1	59148341	.	T	C	5	6	11	0	0	11	0	0
1	59149117	.	C	T	11	12	23	0	1	24	0	0
1	59149968	.	T	C	11	14	25	0	0	25	0	0
1	59150450	.	A	G	6	13	19	0	0	19	0	0
1	59150482	.	G	T	5	10	15	0	0	15	0	0
1	59150518	.	T	C	10	12	22	0	1	23	0	0
1	59150559	.	T	G	9	17	26	0	1	27	0	0
1	59150583	.	T	A	2	21	23	0	0	23	0	0
1	59150683	.	T	C	4	15	19	0	0	19	0	0
1	59150737	.	T	C	7	15	22	0	1	23	0	0
1	59150762	.	G	T	8	14	22	0	0	22	0	0
1	59150781	.	T	C	10	14	24	0	0	24	0	0
1	59156827	.	T	G	6	7	13	0	0	13	0	0
1	59157536	.	T	C	12	6	18	0	0	18	0	0
1	59157856	.	T	A	12	10	22	0	2	24	0	0
1	59157888	.	T	C	15	14	29	0	1	30	0	0
1	59157977	.	A	C	11	14	25	0	3	28	0	0
1	59158035	.	C	A	15	17	32	0	0	32	0	0
1	59158062	.	A	T	15	16	31	0	1	32	0	0
1	59158070	.	G	A	13	18	31	0	0	31	0	0
1	59172876	.	A	G	8	17	25	0	1	26	0	0
1	59172900	.	A	G	9	20	29	0	1	30	0	0
1	59172969	.	G	A	13	14	27	0	0	27	0	0
1	59173358	.	G	T	15	12	27	0	0	27	0	0
1	59173563	.	C	T	12	12	24	0	2	26	0	0
1	59173701	.	G	T	15	13	28	0	1	29	0	0
1	59173758	.	A	G	11	12	23	0	1	24	0	0
1	59173896	.	T	C	13	0	13	0	14	27	0	0
1	59174387	.	A	G	8	6	14	0	3	17	0	0
1	59174408	.	G	A	9	5	14	0	1	15	0	0
1	59174492	.	T	G	13	8	21	0	3	24	0	0
1	59174525	.	A	C	15	8	23	0	0	23	0	0
1	59174576	.	C	T	10	8	18	0	0	18	0	0
1	59174645	.	G	A	10	11	21	0	2	23	0	0
1	59174797	.	A	C	16	13	29	0	2	31	0	0
1	59174962	.	T	C	18	9	27	0	0	27	0	0
1	59175511	.	T	C	5	13	18	0	0	18	0	0
1	59175572	.	A	G	7	11	18	0	0	18	0	0
1	59175626	.	G	A	9	9	18	0	1	19	0	0
1	59175635	.	G	A	10	8	18	0	0	18	0	0
1	59175740	.	G	T	9	8	17	0	0	17	0	0
1	59175983	.	T	C	9	3	12	0	1	13	0	0
1	59175989	.	A	G	8	4	12	0	0	12	0	0
1	59176636	.	C	T	7	4	11	0	0	11	0	0
1	59176887	.	G	T	12	6	18	0	0	18	0	0
1	59176935	.	A	C	5	1	6	0	13	19	0	0
1	59218594	.	A	G	11	11	22	0	1	23	0	0
1	59226049	.	T	C	20	30	50	0	4	54	0	0
1	59226052	.	A	G	23	30	53	0	4	57	0	0
1	59228311	.	G	A	27	25	52	0	1	53	0	0
1	59228322	.	C	T	25	29	54	0	6	60	0	0
1	59228569	.	A	C	23	1	24	0	31	55	0	0
1	59232206	.	A	G	6	26	32	0	0	32	0	0
1	59232509	.	G	A	14	18	32	0	2	34	0	0
1	59235016	.	T	G	15	16	31	0	3	34	0	0
1	59238037	.	T	C	2	2	4	0	1	5	0	0
1	59238038	.	A	C	2	3	5	0	0	5	0	0
1	59244635	.	A	T	10	26	36	0	0	36	0	0
1	59244916	.	T	A	38	21	59	3	1	63	0	0
1	59244928	.	C	T	37	22	59	3	3	65	0	0
1	59245142	.	C	G	30	26	56	0	1	57	0	0
1	59245658	.	G	A	16	17	33	0	2	35	0	0
1	59245873	.	T	C	9	19	28	0	1	29	0	0
1	59245900	.	C	T	12	19	31	0	0	31	0	0
1	59246189	.	T	C	10	2	12	0	16	28	0	0
1	59246363	.	A	T	3	5	8	0	0	8	0	0
1	59247893	.	T	G	18	6	24	0	1	25	0	0
1	59247944	.	C	T	16	6	22	0	1	23	0	0
1	59248138	.	T	A	11	12	23	0	0	23	0	0
1	59251658	.	C	G	11	8	19	0	1	20	0	0
1	59251839	.	T	C	18	0	18	0	12	30	0	0
1	59298069	.	T	C	3	3	6	0	0	6	0	0
1	59298207	.	C	T	2	6	8	0	0	8	0	0
1	59302210	.	G	A	0	12	12	0	7	19	0	0
1	59302276	.	C	T	9	9	18	0	1	19	0	0
1	59302372	.	T	G	4	5	9	1	1	11	0	0
1	59302673	.	G	A	1	2	3	0	0	3	0	0
1	59302813	.	C	A	1	6	7	0	0	7	0	0
1	59303024	.	C	A	4	3	7	0	0	7	0	0
1	59303294	.	C	G	1	0	1	0	3	4	0	0
1	59303334	.	A	G	2	4	6	0	0	6	0	0
1	59304816	.	C	T	2	2	4	0	1	5	0	0
1	59305116	.	T	C	8	0	8	0	9	17	0	0
1	59305200	.	T	C	6	6	12	0	0	12	0	0
1	59313365	.	T	C	1	3	4	0	0	4	0	0
1	59314966	.	A	G	10	14	24	0	0	24	0	0
1	59318886	.	A	G	7	1	8	0	7	15	0	0
1	59320111	.	C	T	14	8	22	0	1	23	0	0
1	59321447	.	A	G	9	1	10	0	18	28	0	0
1	59324067	.	T	C	11	17	28	0	1	29	0	0
1	59328110	.	T	G	4	0	4	1	3	8	0	0
1	59328287	.	C	T	3	10	13	0	0	13	0	0
1	59328486	.	C	T	7	7	14	0	1	15	0	0
1	59329950	.	A	G	3	7	10	0	0	10	0	0
1	59329957	.	T	C	4	6	10	0	0	10	0	0
1	59330135	.	T	C	8	4	12	0	0	12	0	0
1	59330169	.	C	T	4	4	8	0	0	8	0	0
1	59406628	.	C	T	1	7	8	0	0	8	0	0
1	59409266	.	G	A	2	4	6	0	0	6	0	0
1	59409321	.	C	G	3	6	9	0	1	10	0	0
1	59409455	.	A	G	2	7	9	0	2	11	0	0
1	59422800	.	T	C	2	0	2	0	2	4	0	0
1	59542739	.	A	T	1	2	3	1	0	4	0	0
1	59562375	.	A	G	1	3	4	0	0	4	0	0
1	59565427	.	A	C	1	3	4	0	0	4	0	0
10	116619	.	G	C	1	7	8	0	0	8	0	0
10	215566	.	C	T	4	2	6	0	1	7	0	0
10	590925	.	A	G	14	4	18	0	0	18	0	0
10	590949	.	A	G	10	3	13	1	1	15	0	0
10	591476	.	A	G	12	0	12	0	5	17	0	0
10	1226809	.	T	C	4	3	7	0	0	7	0	0
10	1479456	.	G	A	8	6	14	0	0	14	0	0
10	1515816	.	C	T	8	4	12	0	0	12	0	0
10	1541477	.	C	T	16	6	22	0	0	22	0	0
10	1541499	.	C	T	4	20	24	0	0	24	0	0
10	1549179	.	A	G	15	4	19	0	0	19	0	0
10	1549189	.	A	G	15	4	19	0	1	20	0	0
10	1597332	.	A	G	3	4	7	0	0	7	0	0
10	1597396	.	G	A	13	6	19	0	0	19	0	0
10	1599468	.	C	T	1	3	4	0	0	4	0	0
10	1603967	.	T	C	3	3	6	0	0	6	0	0
10	1619723	.	G	A	2	5	7	0	0	7	0	0
10	1648044	.	T	C	2	7	9	0	0	9	0	0
10	1649691	.	T	C	3	3	6	0	0	6	0	0
10	1652260	.	G	C	1	3	4	0	2	6	0	0
10	1656257	.	C	T	3	5	8	0	2	10	0	0
10	1658184	.	T	C	5	4	9	0	0	9	0	0
10	1663101	.	T	C	3	7	10	0	1	11	0	0
10	1666500	.	A	G	10	0	10	0	5	15	0	0
10	1666525	.	G	A	0	6	6	0	9	15	0	0
10	1668159	.	C	T	13	14	27	0	2	29	0	0
10	1671442	.	A	T	10	11	21	0	1	22	0	0
10	1674291	.	C	T	10	15	25	0	0	25	0	0
10	1681712	.	A	T	6	10	16	1	0	17	0	0
10	1684563	.	T	G	9	13	22	0	0	22	0	0
10	1687547	.	C	T	16	24	40	0	2	42	0	0
10	1694456	.	T	A	11	12	23	0	1	24	0	0
10	1708197	.	T	A	19	31	50	0	2	52	0	0
10	1708230	.	T	C	26	20	46	0	2	48	0	0
10	1708239	.	A	T	20	26	46	0	0	46	0	0
10	1708412	.	A	T	41	23	64	0	1	65	0	0
10	1709165	.	T	A	28	35	63	0	1	64	0	0
10	1709331	.	T	G	34	24	58	0	5	63	0	0
10	1709731	.	G	A	37	27	64	0	1	65	0	0
10	1709783	.	G	A	29	34	63	0	3	66	0	0
10	1709836	.	T	G	41	20	61	1	1	63	0	0
10	1709855	.	C	T	36	19	55	1	5	61	0	0
10	1709871	.	G	A	37	16	53	0	5	58	0	0
10	1710270	.	A	G	20	28	48	1	1	50	0	0
10	1710358	.	C	T	23	15	38	0	4	42	0	0
10	1710493	.	T	C	24	8	32	1	4	37	0	0
10	1711061	.	T	C	20	1	21	0	23	44	0	0
10	1711136	.	T	C	30	34	64	0	0	64	0	0
10	1711188	.	T	A	29	21	50	0	3	53	0	0
10	1711211	.	C	T	21	17	38	0	4	42	0	0
10	1711599	.	T	C	10	0	10	1	18	29	0	0
10	1711623	.	G	A	9	23	32	1	1	34	0	0
10	1711711	.	G	A	23	19	42	2	1	45	0	0
10	1711780	.	C	T	5	21	26	0	14	40	0	0
10	1711854	.	G	T	6	9	15	0	13	28	0	0
10	1712091	.	G	A	8	14	22	0	6	28	0	0
10	1712100	.	T	A	12	13	25	1	2	29	1	0
10	1712306	.	G	A	13	21	34	0	2	36	0	0
10	1712316	.	C	T	10	19	29	0	1	30	0	0
10	1712457	.	C	A	21	6	27	5	3	35	0	0
10	1712468	.	G	A	25	3	28	5	2	35	0	0
10	1712658	.	G	A	21	16	37	0	3	40	0	0
10	1712757	.	A	G	21	23	44	0	1	45	0	0
10	1712899	.	A	T	28	19	47	0	5	52	0	0
10	1712964	.	T	G	51	4	55	0	3	58	0	0
10	1713418	.	T	C	14	27	41	0	4	45	0	0
10	1718294	.	C	A	21	24	45	0	4	49	0	0
10	1745541	.	A	T	4	3	7	0	1	8	0	0
10	1745738	.	T	A	10	7	17	0	0	17	0	0
10	1752113	.	T	A	2	5	7	0	1	8	0	0
10	1752122	.	C	A	6	4	10	0	0	10	0	0
10	1798869	.	T	G	2	2	4	0	0	4	0	0
10	1869266	.	G	A	7	5	12	0	0	12	0	0
10	1869313	.	G	T	8	5	13	0	0	13	0	0
10	1871634	.	G	T	1	3	4	0	5	9	0	0
10	1880734	.	C	T	2	2	4	0	1	5	0	0
10	1885891	.	A	C	2	11	13	0	0	13	0	0
10	1886113	.	G	A	0	3	3	0	4	7	0	0
10	1886119	.	T	G	3	3	6	0	0	6	0	0
10	1886182	.	C	T	2	8	10	0	0	10	0	0
10	1886265	.	C	G	5	3	8	0	1	9	0	0
10	1886587	.	T	C	4	8	12	0	1	13	0	0
10	1886590	.	T	A	6	10	16	0	1	17	0	0
10	1887238	.	C	T	7	9	16	0	0	16	0	0
10	1887364	.	C	T	8	6	14	0	1	15	0	0
10	1887496	.	A	G	8	0	8	0	12	20	0	0
10	1887811	.	A	G	5	8	13	0	3	16	0	0
10	1888135	.	G	C	10	11	21	0	1	22	0	0
10	1888222	.	C	T	12	12	24	0	0	24	0	0
10	1888225	.	G	A	12	12	24	0	0	24	0	0
10	1888303	.	C	T	7	10	17	0	2	19	0	0
10	1888414	.	T	C	10	6	16	0	0	16	0	0
10	1888438	.	C	T	11	11	22	0	1	23	0	0
10	1888487	.	T	C	10	11	21	0	2	23	0	0
10	1888515	.	C	T	9	11	20	0	1	21	0	0
10	1888824	.	C	T	17	13	30	0	0	30	0	0
10	1888893	.	C	T	12	5	17	0	0	17	0	0
10	1889171	.	G	T	14	16	30	0	0	30	0	0
10	1889179	.	A	G	15	0	15	0	12	27	0	0
10	1889255	.	C	T	12	11	23	0	0	23	0	0
10	1889296	.	C	T	12	9	21	0	0	21	0	0
10	1889882	.	A	C	9	11	20	0	2	22	0	0
10	1890313	.	A	G	23	13	36	0	1	37	0	0
10	1890949	.	T	C	24	7	31	0	0	31	0	0
10	1890961	.	G	A	22	12	34	0	1	35	0	0
10	1891018	.	G	A	1	15	16	0	14	30	0	0
10	1891660	.	G	C	19	21	40	0	1	41	0	0
10	1891724	.	G	C	27	21	48	0	4	52	0	0
10	1892516	.	G	A	17	16	33	0	3	36	0	0
10	2234379	.	C	T	4	3	7	0	1	8	0	0
10	2255014	.	T	C	1	3	4	0	1	5	0	0
10	2261897	.	A	T	2	3	5	0	1	6	0	0
10	2261921	.	G	C	1	3	4	0	1	5	0	0
10	2288974	.	A	G	1	2	3	0	0	3	0	0
10	2292380	.	G	T	3	3	6	0	0	6	0	0
10	2294325	.	G	A	5	8	13	0	1	14	0	0
10	2328740	.	C	A	4	9	13	0	0	13	0	0
10	2339274	.	C	T	10	6	16	2	1	19	0	0
10	2354973	.	C	A	4	4	8	0	0	8	0	0
10	2393715	.	G	A	20	11	31	0	1	32	0	0
10	2393763	.	G	C	19	19	38	0	0	38	0	0
10	2504174	.	G	T	14	14	28	0	0	28	0	0
10	2504210	.	C	T	2	19	21	0	16	37	0	0
10	2506081	.	G	A	13	22	35	0	0	35	0	0
10	2508347	.	T	C	11	1	12	0	14	26	0	0
10	2510397	.	C	G	0	9	9	0	14	23	0	0
10	2515351	.	T	G	10	5	15	0	1	16	0	0
10	2515447	.	T	C	12	0	12	0	16	28	0	0
10	2526413	.	A	G	7	10	17	0	0	17	0	0
10	2533537	.	T	C	1	2	3	0	0	3	0	0
10	2575204	.	A	G	8	0	8	0	13	21	0	0
10	2575369	.	T	C	10	7	17	0	1	18	0	0
10	2681622	.	C	T	2	6	8	0	1	9	0	0
10	2681771	.	G	A	7	6	13	0	0	13	0	0
10	2681800	.	C	T	1	9	10	0	5	15	0	0
10	2704653	.	C	T	5	7	12	0	0	12	0	0
10	2704752	.	G	T	3	6	9	0	1	10	0	0
10	2759276	.	G	A	17	14	31	0	1	32	0	0
10	2759329	.	T	G	8	9	17	0	2	19	0	0
10	2759381	.	G	C	8	16	24	0	3	27	0	0
10	2759391	.	A	T	17	17	34	0	0	34	0	0
10	2772036	.	G	A	8	6	14	1	2	17	0	0
10	2772057	.	G	A	9	8	17	1	0	18	0	0
10	2778444	.	G	A	10	6	16	0	0	16	0	0
10	2782761	.	G	A	4	3	7	0	0	7	0	0
10	2788649	.	A	T	7	9	16	0	0	16	0	0
10	2850533	.	A	G	2	3	5	0	0	5	0	0
10	2850536	.	A	G	2	0	2	0	3	5	0	0
10	2888166	.	C	A	11	6	17	0	0	17	0	0
10	2891905	.	G	A	4	9	13	0	0	13	0	0
10	2894148	.	G	C	5	8	13	0	0	13	0	0
10	2894193	.	T	G	5	0	5	0	7	12	0	0
10	2894545	.	C	T	6	13	19	0	0	19	0	0
10	2897110	.	A	C	11	7	18	0	0	18	0	0
10	2897720	.	T	A	6	10	16	0	0	16	0	0
10	2897817	.	T	G	8	0	8	0	8	16	0	0
10	2897897	.	A	G	5	4	9	0	0	9	0	0
10	2897911	.	G	T	4	3	7	0	0	7	0	0
10	2898269	.	C	T	5	3	8	0	2	10	0	0
10	2898346	.	T	A	5	5	10	0	1	11	0	0
10	2898390	.	A	T	1	3	4	0	1	5	0	0
10	2899496	.	T	A	2	2	4	0	0	4	0	0
10	2904624	.	C	T	1	2	3	0	0	3	0	0
10	2904638	.	G	C	1	2	3	0	0	3	0	0
10	2907353	.	A	G	3	1	4	0	0	4	0	0
10	2907362	.	T	C	2	2	4	0	0	4	0	0
10	2907413	.	A	G	1	3	4	0	0	4	0	0
10	2907422	.	T	C	1	3	4	0	1	5	0	0
10	2910591	.	G	T	4	5	9	0	0	9	0	0
10	2915399	.	G	A	8	6	14	0	0	14	0	0
10	2915412	.	A	G	7	7	14	0	0	14	0	0
10	2915462	.	G	A	0	3	3	0	8	11	0	0
10	2915495	.	C	T	4	2	6	0	1	7	0	0
10	2920987	.	C	G	1	2	3	0	0	3	0	0
10	2921236	.	T	C	2	4	6	0	0	6	0	0
10	2983715	.	C	T	1	3	4	0	0	4	0	0
10	2983736	.	A	G	1	3	4	0	0	4	0	0
10	2984902	.	T	C	2	2	4	0	0	4	0	0
10	2984924	.	G	T	3	3	6	0	0	6	0	0
10	2984945	.	G	A	0	3	3	0	3	6	0	0
10	2985032	.	G	T	0	6	6	0	1	7	0	0
10	3016263	.	T	C	4	4	8	0	0	8	0	0
10	3024637	.	C	G	8	5	13	0	0	13	0	0
10	3024706	.	C	T	10	5	15	0	0	15	0	0
10	3026376	.	A	G	6	8	14	0	0	14	0	0
10	3031670	.	T	C	10	0	10	0	5	15	0	0
10	3031760	.	A	G	5	9	14	0	0	14	0	0
10	3032353	.	T	A	5	3	8	0	0	8	0	0
10	3085411	.	G	T	1	2	3	0	0	3	0	0
10	3308482	.	G	A	1	5	6	0	6	12	0	0
10	3311737	.	T	G	7	5	12	0	2	14	0	0
10	3311845	.	G	A	5	4	9	0	0	9	0	0
10	3314596	.	T	C	11	14	25	0	0	25	0	0
10	3317976	.	G	A	0	9	9	0	4	13	0	0
10	3318005	.	G	C	2	10	12	0	5	17	0	0
10	3318060	.	G	A	7	10	17	0	0	17	0	0
10	3318201	.	A	G	1	10	11	0	2	13	0	0
10	3318211	.	C	T	1	9	10	0	0	10	0	0
10	3318295	.	G	T	5	2	7	0	0	7	0	0
10	3318322	.	A	T	3	3	6	0	1	7	0	0
10	3319873	.	A	G	8	0	8	0	11	19	0	0
10	3319890	.	G	T	0	12	12	0	12	24	0	0
10	3319938	.	C	T	15	10	25	0	0	25	0	0
10	3320007	.	C	G	8	7	15	0	1	16	0	0
10	3320015	.	T	C	8	11	19	0	0	19	0	0
10	3320151	.	A	G	19	15	34	0	0	34	0	0
10	3320194	.	G	A	18	14	32	0	1	33	0	0
10	3320229	.	G	A	11	17	28	0	0	28	0	0
10	3320287	.	T	G	16	8	24	0	0	24	0	0
10	3320465	.	C	G	14	11	25	0	1	26	0	0
10	3320495	.	A	T	15	14	29	0	2	31	0	0
10	3320506	.	C	T	16	14	30	0	2	32	0	0
10	3320705	.	G	A	22	17	39	0	0	39	0	0
10	3320776	.	C	T	13	22	35	0	1	36	0	0
10	3320850	.	C	T	13	22	35	0	1	36	0	0
10	3321262	.	A	G	17	23	40	0	1	41	0	0
10	3321416	.	T	G	17	7	24	0	2	26	0	0
10	3322194	.	A	G	24	0	24	1	10	35	0	0
10	3341412	.	C	T	5	3	8	0	0	8	0	0
10	3353607	.	C	T	8	10	18	0	1	19	0	0
10	3353622	.	A	G	7	8	15	0	0	15	0	0
10	3354048	.	A	G	11	7	18	0	2	20	0	0
10	3358897	.	A	T	8	10	18	0	1	19	0	0
10	3364772	.	A	T	11	6	17	0	1	18	0	0
10	3365063	.	C	T	1	13	14	0	14	28	0	0
10	3365312	.	T	C	6	9	15	0	0	15	0	0
10	3365726	.	A	C	25	0	25	1	1	27	0	0
10	3365834	.	A	T	12	9	21	0	1	22	0	0
10	3366095	.	C	T	1	9	10	0	14	24	0	0
10	3366199	.	C	T	0	9	9	0	10	19	0	0
10	3370571	.	T	C	2	0	2	0	7	9	0	0
10	3370680	.	G	A	10	3	13	0	0	13	0	0
10	3371866	.	G	A	7	4	11	0	2	13	0	0
10	3379107	.	T	C	1	0	1	0	2	3	0	0
10	3381744	.	A	G	1	3	4	0	0	4	0	0
10	3388200	.	T	G	4	5	9	0	0	9	0	0
10	3400093	.	T	C	2	5	7	0	1	8	0	0
10	3400126	.	A	T	7	4	11	0	0	11	0	0
10	3400216	.	C	T	4	2	6	0	0	6	0	0
10	3400225	.	T	C	4	3	7	0	0	7	0	0
10	3408009	.	G	A	1	2	3	0	0	3	0	0
10	3420097	.	A	T	13	19	32	0	0	32	0	0
10	3426363	.	G	A	17	20	37	0	0	37	0	0
10	3428230	.	G	C	5	3	8	0	0	8	0	0
10	3434883	.	C	T	4	3	7	0	0	7	0	0
10	3434910	.	C	T	7	2	9	0	0	9	0	0
10	3435321	.	T	A	2	2	4	0	0	4	0	0
10	3436370	.	C	T	6	2	8	0	1	9	0	0
10	3438991	.	T	C	2	3	5	0	0	5	0	0
10	3439018	.	A	G	2	3	5	0	1	6	0	0
10	3441973	.	T	C	3	8	11	0	0	11	0	0
10	3445818	.	C	T	5	6	11	0	1	12	0	0
10	3451091	.	G	A	6	3	9	0	0	9	0	0
10	3451429	.	G	A	1	8	9	0	9	18	0	0
10	3451672	.	A	G	6	4	10	0	0	10	0	0
10	3451688	.	C	T	5	5	10	0	0	10	0	0
10	3451848	.	G	A	0	5	5	0	3	8	0	0
10	3451864	.	C	T	5	2	7	0	0	7	0	0
10	3452045	.	G	A	5	7	12	0	0	12	0	0
10	3452073	.	A	G	7	8	15	0	0	15	0	0
10	3452124	.	A	G	11	12	23	0	0	23	0	0
10	3532257	.	T	C	1	2	3	0	0	3	0	0
10	3532264	.	A	G	1	2	3	0	0	3	0	0
10	3942996	.	T	A	3	3	6	0	0	6	0	0
10	3943026	.	A	G	2	0	2	0	4	6	0	0
10	3969491	.	G	T	3	4	7	0	0	7	0	0
10	3979744	.	G	T	3	6	9	0	0	9	0	0
10	3979870	.	G	A	8	4	12	0	1	13	0	0
10	3979876	.	C	A	7	4	11	0	1	12	0	0
10	3987505	.	T	C	4	4	8	0	0	8	0	0
10	4010345	.	G	T	0	4	4	0	2	6	0	0
10	4029455	.	C	T	3	3	6	0	0	6	0	0
10	4029507	.	T	C	2	6	8	0	0	8	0	0
10	4029634	.	A	G	1	4	5	0	0	5	0	0
10	4030211	.	A	T	3	2	5	0	0	5	0	0
10	4030349	.	C	T	7	2	9	0	0	9	0	0
10	4030352	.	C	A	7	2	9	0	0	9	0	0
10	4032623	.	C	T	5	5	10	0	0	10	0	0
10	4037287	.	G	A	8	4	12	0	2	14	0	0
10	4038772	.	G	A	13	10	23	0	0	23	0	0
10	4038898	.	A	G	10	10	20	0	0	20	0	0
10	4039123	.	C	T	18	15	33	0	2	35	0	0
10	4039129	.	C	T	18	15	33	0	0	34	1	0
10	4240887	.	T	C	22	10	32	0	0	32	0	0
10	4240899	.	C	T	22	9	31	0	0	31	0	0
10	4279695	.	T	C	5	5	10	0	0	10	0	0
10	4279800	.	A	G	2	4	6	0	0	6	0	0
10	4289764	.	G	A	1	3	4	0	0	4	0	0
10	4290174	.	T	A	2	3	5	0	1	6	0	0
10	4501609	.	C	T	4	4	8	0	0	8	0	0
10	4501733	.	G	A	7	3	10	0	0	10	0	0
10	4503291	.	G	T	14	6	20	0	0	20	0	0
10	4503736	.	C	T	9	9	18	0	1	19	0	0
10	4503901	.	C	G	13	11	24	0	2	26	0	0
10	4505886	.	T	A	22	12	34	0	1	35	0	0
10	4505887	.	T	A	23	12	35	0	1	36	0	0
10	4508492	.	T	A	21	10	31	0	0	31	0	0
10	4508518	.	G	T	3	9	12	0	18	30	0	0
10	4888457	.	A	G	2	2	4	0	0	4	0	0
10	4888582	.	A	G	3	0	3	0	3	6	0	0
10	4888666	.	A	G	1	0	1	0	3	4	0	0
10	4888808	.	C	T	1	4	5	0	0	5	0	0
10	4889119	.	A	T	2	2	4	0	0	4	0	0
10	4889704	.	A	G	5	4	9	0	1	10	0	0
10	4889923	.	A	G	1	0	1	0	6	7	0	0
10	4890082	.	G	C	3	3	6	0	0	6	0	0
10	4896742	.	G	A	3	3	6	0	0	6	0	0
10	4896766	.	G	A	2	2	4	0	0	4	0	0
10	4940895	.	A	G	4	6	10	0	0	10	0	0
10	4941113	.	A	G	4	6	10	0	0	10	0	0
10	4941342	.	G	C	10	4	14	0	1	15	0	0
10	4941421	.	T	G	5	13	18	0	1	19	0	0
10	4950824	.	G	T	13	6	19	0	0	19	0	0
10	4956906	.	C	T	5	1	6	0	1	7	0	0
10	4966683	.	G	A	0	17	17	0	16	33	0	0
10	4968900	.	G	C	10	15	25	0	2	27	0	0
10	4969014	.	T	A	5	11	16	0	2	18	0	0
10	4969036	.	T	G	5	0	5	0	12	17	0	0
10	4969069	.	C	A	5	11	16	0	0	16	0	0
10	5000719	.	C	T	0	6	6	5	16	27	0	0
10	5000753	.	C	T	1	5	6	0	19	25	0	0
10	5004215	.	C	T	2	3	5	0	0	5	0	0
10	5010287	.	G	A	22	17	39	0	3	42	0	0
10	5010344	.	T	G	24	23	47	0	1	48	0	0
10	5010407	.	G	A	17	17	34	0	1	35	0	0
10	5016797	.	G	A	24	23	47	0	3	50	0	0
10	5016917	.	C	G	31	20	51	0	0	51	0	0
10	5016922	.	A	G	27	23	50	0	0	50	0	0
10	5020320	.	G	A	36	27	63	0	3	66	0	0
10	5020326	.	T	C	27	36	63	0	4	67	0	0
10	5024410	.	C	T	32	26	58	0	3	61	0	0
10	5025848	.	C	A	9	9	18	0	1	19	0	0
10	5026058	.	C	T	8	9	17	0	1	18	0	0
10	5028877	.	A	G	10	8	18	0	0	18	0	0
10	5031869	.	T	C	17	10	27	0	0	27	0	0
10	5036521	.	G	A	1	10	11	0	13	24	0	0
10	5036522	.	A	G	14	10	24	0	0	24	0	0
10	5036729	.	C	T	7	8	15	0	0	15	0	0
10	5036881	.	A	G	3	2	5	0	2	7	0	0
10	5037119	.	T	A	11	4	15	0	1	16	0	0
10	5037147	.	C	T	4	10	14	0	0	14	0	0
10	5037181	.	T	G	9	8	17	0	0	17	0	0
10	5037372	.	A	T	15	6	21	0	0	21	0	0
10	5042034	.	A	C	2	6	8	0	0	8	0	0
10	5042113	.	C	T	4	5	9	0	0	9	0	0
10	5042217	.	A	G	4	4	8	0	0	8	0	0
10	5042239	.	G	A	5	3	8	0	0	8	0	0
10	5042469	.	G	A	7	4	11	0	3	14	0	0
10	5047452	.	A	G	10	8	18	0	0	18	0	0
10	5053556	.	T	C	5	3	8	0	0	8	0	0
10	5092764	.	T	C	6	4	10	5	1	16	0	0
10	5092772	.	A	G	4	4	8	6	0	14	0	0
10	5093140	.	T	C	6	4	10	2	0	12	0	0
10	5093157	.	T	C	3	9	12	1	2	15	0	0
10	5093222	.	A	G	11	3	14	0	0	14	0	0
10	5093240	.	C	A	9	3	12	0	0	12	0	0
10	5093274	.	A	G	1	5	6	0	0	6	0	0
10	5093592	.	G	C	6	4	10	0	0	10	0	0
10	5094649	.	C	A	3	4	7	0	0	7	0	0
10	5094778	.	G	T	5	7	12	0	0	12	0	0
10	5097478	.	G	A	6	4	10	0	0	10	0	0
10	5097520	.	A	G	5	5	10	0	0	10	0	0
10	5110656	.	T	C	4	6	10	0	2	12	0	0
10	5119482	.	G	A	1	3	4	0	0	4	0	0
10	5124214	.	A	T	1	2	3	0	0	3	0	0
10	5147130	.	A	G	2	1	3	0	0	3	0	0
10	5203569	.	G	A	10	8	18	0	0	18	0	0
10	5216204	.	T	C	7	7	14	0	0	14	0	0
10	5216249	.	A	G	10	8	18	0	0	18	0	0
10	5220608	.	C	T	15	9	24	0	0	24	0	0
10	5220835	.	G	A	3	4	7	0	7	14	0	0
10	5220940	.	T	A	6	9	15	0	2	17	0	0
10	5220992	.	C	T	10	8	18	0	2	20	0	0
10	5220997	.	C	A	8	12	20	0	1	21	0	0
10	5221039	.	G	A	16	8	24	0	1	25	0	0
10	5221292	.	C	A	9	8	17	0	0	17	0	0
10	5221297	.	T	G	8	7	15	0	1	16	0	0
10	5221336	.	G	C	6	5	11	0	1	12	0	0
10	5245194	.	C	G	2	0	2	0	3	5	0	0
10	5248247	.	T	C	1	3	4	0	1	5	0	0
10	5257980	.	C	T	2	5	7	1	0	8	0	0
10	5258914	.	T	A	2	12	14	0	1	15	0	0
10	5264280	.	A	G	5	7	12	0	1	13	0	0
10	5264310	.	G	A	7	7	14	0	0	14	0	0
10	5264458	.	G	A	12	11	23	0	1	24	0	0
10	5264534	.	C	A	7	3	10	0	0	10	0	0
10	5414339	.	C	T	3	3	6	0	0	6	0	0
10	5417669	.	T	A	7	4	11	0	0	11	0	0
10	5417841	.	A	C	1	2	3	0	1	4	0	0
10	5418509	.	A	G	5	4	9	0	0	9	0	0
10	5418569	.	C	T	4	5	9	0	0	9	0	0
10	5429905	.	G	A	2	5	7	0	5	12	0	0
10	5432576	.	T	C	4	5	9	0	1	10	0	0
10	5461988	.	C	A	7	6	13	0	0	13	0	0
10	5461994	.	T	A	6	6	12	0	0	12	0	0
10	5475206	.	G	C	10	4	14	0	1	15	0	0
10	5475214	.	T	G	11	7	18	1	0	19	0	0
10	5475406	.	A	T	2	2	4	0	0	4	0	0
10	5475436	.	A	G	6	2	8	0	0	8	0	0
10	5475526	.	T	C	9	6	15	0	0	15	0	0
10	5534483	.	T	C	9	5	14	0	0	14	0	0
10	5534487	.	C	T	2	4	6	0	10	16	0	0
10	5534527	.	G	T	12	3	15	0	4	19	0	0
10	5534539	.	G	A	11	5	16	0	1	17	0	0
10	5534611	.	C	T	10	7	17	0	1	18	0	0
10	5534612	.	A	G	9	7	16	0	1	17	0	0
10	5534646	.	A	G	4	12	16	0	2	18	0	0
10	5534878	.	C	T	11	11	22	0	2	24	0	0
10	5534946	.	A	G	10	13	23	0	1	24	0	0
10	5534950	.	A	T	11	13	24	0	1	25	0	0
10	5535047	.	A	T	10	2	12	2	0	14	0	0
10	5535048	.	C	G	10	2	12	2	0	14	0	0
10	5535359	.	A	T	12	6	18	0	1	20	1	0
10	5535368	.	T	A	10	8	18	0	0	18	0	0
10	5535436	.	C	T	5	5	10	0	4	14	0	0
10	5535445	.	T	C	7	6	13	0	2	15	0	0
10	5535483	.	A	T	8	7	15	0	1	16	0	0
10	5535540	.	T	G	5	9	14	0	1	15	0	0
10	5535561	.	T	A	4	9	13	0	0	13	0	0
10	5536240	.	T	C	7	4	11	0	0	11	0	0
10	5536256	.	G	A	6	5	11	0	0	11	0	0
10	5536294	.	A	C	5	4	9	0	0	9	0	0
10	5536301	.	A	G	5	3	8	0	0	8	0	0
10	5536534	.	T	A	4	2	6	0	0	6	0	0
10	5537048	.	G	T	10	3	13	0	0	13	0	0
10	5538302	.	T	G	7	10	17	0	2	19	0	0
10	5542152	.	T	C	3	5	8	0	2	10	0	0
10	5545438	.	C	T	7	8	15	0	0	15	0	0
10	5545465	.	T	C	9	6	15	0	0	15	0	0
10	5568128	.	G	T	5	4	9	0	0	9	0	0
10	5568155	.	T	G	4	5	9	0	1	10	0	0
10	5568212	.	G	A	5	6	11	0	0	11	0	0
10	5568319	.	A	C	5	6	11	0	0	11	0	0
10	5568329	.	A	G	7	5	12	0	0	12	0	0
10	5667439	.	A	T	1	3	4	0	0	4	0	0
10	5667467	.	T	A	3	6	9	0	2	11	0	0
10	5667605	.	C	T	2	3	5	0	0	5	0	0
10	5668103	.	C	T	3	2	5	0	0	5	0	0
10	5668135	.	G	A	6	4	10	0	0	10	0	0
10	5668218	.	G	C	5	6	11	0	0	11	0	0
10	5676520	.	T	A	1	3	4	0	0	4	0	0
10	5724095	.	T	C	8	11	19	0	0	19	0	0
10	5737757	.	G	A	15	10	25	0	0	25	0	0
10	5744934	.	C	T	13	11	24	0	0	24	0	0
10	5745015	.	C	A	17	14	31	0	1	33	1	0
10	5745290	.	T	C	14	19	33	0	0	33	0	0
10	5745299	.	C	T	14	14	28	0	1	29	0	0
10	5760455	.	T	C	18	11	29	0	0	29	0	0
10	5760461	.	A	G	19	10	29	0	1	30	0	0
10	5766958	.	A	G	25	20	45	0	1	46	0	0
10	5769541	.	G	T	18	23	41	0	1	42	0	0
10	5772568	.	A	G	20	30	50	0	2	52	0	0
10	5782337	.	C	T	43	23	66	0	0	66	0	0
10	5788755	.	A	C	3	5	8	0	0	8	0	0
10	5788806	.	G	A	2	9	11	0	0	11	0	0
10	5788877	.	G	A	3	4	7	0	1	8	0	0
10	5789155	.	G	T	3	5	8	0	1	9	0	0
10	5789758	.	G	T	2	5	7	0	0	7	0	0
10	5789905	.	T	A	5	3	8	0	1	9	0	0
10	5789920	.	T	C	4	3	7	0	1	8	0	0
10	5790001	.	C	A	3	4	7	0	0	7	0	0
10	5790080	.	A	G	5	10	15	0	0	15	0	0
10	5790097	.	G	A	5	7	12	0	0	12	0	0
10	5790570	.	A	C	6	4	10	0	0	10	0	0
10	5790640	.	T	G	6	2	8	0	0	8	0	0
10	5790913	.	A	C	2	4	6	0	0	6	0	0
10	5790922	.	C	A	3	5	8	0	0	8	0	0
10	5790956	.	C	G	0	5	5	0	9	14	0	0
10	5791030	.	A	G	5	7	12	0	1	13	0	0
10	5791044	.	C	T	2	7	9	0	3	12	0	0
10	5791184	.	G	A	6	7	13	1	2	16	0	0
10	5791224	.	C	G	8	5	13	0	0	13	0	0
10	5791377	.	A	T	9	10	19	0	0	19	0	0
10	5791387	.	G	A	10	8	18	0	0	18	0	0
10	5791417	.	C	T	2	7	9	0	8	17	0	0
10	5791454	.	T	A	6	4	10	0	2	12	0	0
10	5791459	.	C	A	6	3	9	0	2	11	0	0
10	5791743	.	A	T	1	2	3	1	0	4	0	0
10	5791852	.	A	G	3	3	6	0	0	6	0	0
10	5792512	.	A	T	4	7	11	0	0	12	1	0
10	5792533	.	A	T	7	5	12	0	0	12	0	0
10	5792615	.	A	G	3	2	5	0	1	6	0	0
10	5792667	.	G	A	5	3	8	0	0	8	0	0
10	5792722	.	T	C	4	1	5	0	7	12	0	0
10	5792757	.	A	G	4	5	9	0	0	9	0	0
10	5793376	.	G	A	3	3	6	0	1	7	0	0
10	5794423	.	C	G	1	3	4	0	0	4	0	0
10	5796929	.	C	T	0	5	5	0	1	6	0	0
10	5810940	.	A	G	1	3	4	0	0	4	0	0
10	5828645	.	A	G	6	5	11	0	0	11	0	0
10	5828660	.	A	G	5	5	10	0	0	10	0	0
10	5828704	.	C	A	1	8	9	0	7	16	0	0
10	5828840	.	A	G	3	5	8	0	0	8	0	0
10	5828945	.	A	G	3	5	8	0	0	8	0	0
10	5834171	.	C	T	5	7	12	0	1	13	0	0
10	5834242	.	G	A	1	3	4	0	0	4	0	0
10	5837337	.	G	A	1	4	5	0	0	5	0	0
10	5844763	.	A	G	1	2	3	0	0	3	0	0
10	5847821	.	G	T	1	3	4	0	1	5	0	0
10	6016242	.	G	A	4	2	6	0	0	6	0	0
10	6016545	.	G	T	2	2	4	0	1	5	0	0
10	6023750	.	A	G	3	2	5	0	0	5	0	0
10	6023946	.	T	C	3	6	9	0	0	9	0	0
10	6023958	.	G	A	5	5	10	0	1	11	0	0
10	6024159	.	A	T	2	5	7	0	0	7	0	0
10	6032880	.	A	G	10	0	10	0	5	15	0	0
10	6032886	.	G	A	9	3	12	0	1	13	0	0
10	6033452	.	T	C	2	3	5	0	0	5	0	0
10	6033469	.	A	C	3	3	6	0	0	6	0	0
10	6033612	.	G	A	0	7	7	0	5	12	0	0
10	6033627	.	A	T	4	9	13	0	0	13	0	0
10	6034194	.	A	T	5	12	17	0	0	17	0	0
10	6275517	.	G	A	2	3	5	0	0	5	0	0
10	6275577	.	C	T	1	4	5	0	0	5	0	0
10	6278202	.	A	G	2	3	5	0	0	5	0	0
10	6280939	.	G	A	0	2	2	0	1	3	0	0
10	6280948	.	G	A	0	2	2	0	2	4	0	0
10	6281946	.	A	G	2	0	2	0	5	7	0	0
10	6301828	.	C	T	6	9	15	0	1	16	0	0
10	6301930	.	C	T	11	9	20	0	0	20	0	0
10	6313643	.	C	T	4	2	6	0	0	6	0	0
10	6348571	.	C	A	9	10	19	2	0	21	0	0
10	6372501	.	C	T	10	11	21	0	1	22	0	0
10	6372915	.	G	A	10	9	19	0	1	20	0	0
10	6372964	.	T	C	6	8	14	0	1	15	0	0
10	6373003	.	T	C	4	6	10	0	1	11	0	0
10	6373079	.	C	G	4	3	7	0	0	7	0	0
10	6373332	.	A	T	7	3	10	0	1	11	0	0
10	6373336	.	C	G	6	3	9	0	2	11	0	0
10	6373378	.	A	C	5	2	7	0	3	10	0	0
10	6373472	.	T	A	3	4	7	0	0	7	0	0
10	6373522	.	A	T	1	7	8	0	1	11	2	0
10	6373679	.	A	G	13	5	18	0	1	19	0	0
10	6373708	.	A	G	13	0	13	0	10	23	0	0
10	6373758	.	A	C	6	12	18	0	1	19	0	0
10	6374017	.	A	G	8	10	18	0	0	18	0	0
10	6374041	.	A	T	8	13	21	0	0	21	0	0
10	6374068	.	G	T	8	10	18	0	2	20	0	0
10	6374235	.	T	C	12	17	29	0	2	31	0	0
10	6374279	.	G	A	0	23	23	0	11	34	0	0
10	6374352	.	C	T	17	14	31	0	0	31	0	0
10	6374372	.	A	G	12	20	32	0	0	32	0	0
10	6374388	.	C	T	17	15	32	0	1	33	0	0
10	6374501	.	A	G	8	10	18	0	0	18	0	0
10	6403398	.	T	C	1	1	2	0	0	2	0	0
10	6404764	.	G	C	1	3	4	0	0	4	0	0
10	6405321	.	A	G	3	4	7	0	0	7	0	0
10	6406143	.	A	G	2	3	5	0	0	5	0	0
10	6407408	.	T	C	1	3	4	0	0	4	0	0
10	6407449	.	C	T	4	4	8	0	0	8	0	0
10	6407475	.	G	A	1	4	5	0	3	8	0	0
10	6407559	.	A	T	5	4	9	0	1	10	0	0
10	6407605	.	C	A	2	4	6	0	0	6	0	0
10	6407733	.	A	G	3	2	5	0	1	6	0	0
10	6407744	.	A	T	1	4	5	0	0	6	1	0
10	6407833	.	T	C	7	3	10	2	0	12	0	0
10	6407904	.	C	T	6	6	12	1	0	13	0	0
10	6408955	.	T	G	6	0	6	0	8	14	0	0
10	6408986	.	A	G	5	6	11	0	2	13	0	0
10	6409095	.	G	A	1	7	8	0	11	19	0	0
10	6409120	.	G	A	7	6	13	0	0	13	0	0
10	6409145	.	G	C	4	5	9	0	0	9	0	0
10	6409267	.	C	A	8	7	15	0	0	15	0	0
10	6409379	.	A	G	6	6	12	0	0	12	0	0
10	6409448	.	C	T	4	7	11	0	0	11	0	0
10	6409455	.	T	A	7	5	12	0	0	12	0	0
10	6409506	.	A	G	4	9	13	0	0	13	0	0
10	6409583	.	C	T	6	3	9	0	0	9	0	0
10	6473544	.	T	C	8	16	24	0	1	25	0	0
10	6473685	.	T	C	8	10	18	0	1	19	0	0
10	6473704	.	C	G	10	9	19	0	1	20	0	0
10	6473851	.	A	G	9	13	22	0	0	22	0	0
10	6473862	.	C	T	2	13	15	0	10	25	0	0
10	6473908	.	A	G	14	9	23	0	0	23	0	0
10	6473996	.	T	C	10	11	21	0	0	21	0	0
10	6474057	.	T	A	11	14	25	0	2	27	0	0
10	6479444	.	T	C	10	0	10	0	21	31	0	0
10	6479471	.	C	T	1	13	14	0	13	27	0	0
10	6510756	.	T	C	19	27	46	0	1	47	0	0
10	6510786	.	T	G	26	21	47	0	1	48	0	0
10	6510825	.	T	C	26	27	53	0	2	55	0	0
10	6517593	.	T	A	22	31	53	0	3	56	0	0
10	6517663	.	A	G	17	0	17	0	24	41	0	0
10	6517726	.	C	T	19	28	47	0	3	50	0	0
10	6517959	.	A	G	20	14	34	0	1	35	0	0
10	6522267	.	A	T	6	6	12	0	1	13	0	0
10	6528005	.	A	G	9	3	12	0	0	12	0	0
10	6531002	.	A	G	4	6	10	0	0	10	0	0
10	6531297	.	T	C	8	4	12	0	0	12	0	0
10	6533850	.	T	A	5	6	11	0	0	11	0	0
10	6546929	.	C	A	1	2	3	0	5	8	0	0
10	6573538	.	C	T	1	2	3	0	0	3	0	0
10	6582875	.	C	T	2	2	4	0	0	4	0	0
10	6781239	.	G	A	7	2	9	0	2	11	0	0
10	6781278	.	T	A	7	10	17	0	1	18	0	0
10	6781286	.	G	T	8	10	18	0	1	19	0	0
10	6781362	.	G	A	12	14	26	0	1	27	0	0
10	6781372	.	T	A	18	17	35	0	0	36	1	0
10	6781450	.	T	C	16	13	29	0	1	30	0	0
10	6781506	.	A	T	9	14	23	0	4	28	1	0
10	6781664	.	A	T	12	15	27	0	1	28	0	0
10	6781742	.	G	T	7	10	17	0	1	18	0	0
10	6781786	.	A	T	8	11	19	0	0	19	0	0
10	6781867	.	C	A	4	14	18	0	1	19	0	0
10	6781903	.	T	G	4	20	24	0	0	24	0	0
10	6781918	.	A	T	4	21	25	0	0	25	0	0
10	6782020	.	G	C	12	13	25	0	0	25	0	0
10	6782036	.	T	C	11	0	11	0	13	24	0	0
10	6782163	.	T	C	19	7	26	0	0	26	0	0
10	6782220	.	A	G	8	6	14	2	1	17	0	0
10	6782267	.	T	A	12	4	16	4	0	20	0	0
10	6782279	.	A	C	12	5	17	4	0	21	0	0
10	6782454	.	C	G	10	24	34	0	0	34	0	0
10	6782489	.	T	G	12	18	30	1	2	33	0	0
10	6782624	.	A	G	16	21	37	0	3	40	0	0
10	6782636	.	T	A	17	25	42	0	1	43	0	0
10	6782664	.	A	G	19	24	43	0	1	44	0	0
10	6786326	.	C	T	2	21	23	0	10	33	0	0
10	6786564	.	A	G	16	27	43	0	1	44	0	0
10	6804756	.	T	C	7	0	7	0	12	19	0	0
10	6824761	.	A	C	9	7	16	0	1	17	0	0
10	6824845	.	A	T	7	11	18	0	0	18	0	0
10	6824877	.	T	G	7	11	18	0	0	18	0	0
10	6831298	.	C	T	1	6	7	0	3	10	0	0
10	6831446	.	T	C	6	6	12	0	1	13	0	0
10	6834065	.	A	T	5	6	11	0	0	11	0	0
10	6834341	.	G	A	5	5	10	0	1	11	0	0
10	6834380	.	C	A	0	11	11	0	8	19	0	0
10	6851184	.	C	A	8	4	12	0	0	12	0	0
10	6853641	.	A	G	3	8	11	0	1	12	0	0
10	6944334	.	C	A	1	3	4	0	0	4	0	0
10	7210001	.	G	A	2	20	22	0	23	46	1	0
10	7221810	.	A	G	15	21	36	0	0	36	0	0
10	7222213	.	T	C	14	19	33	0	2	35	0	0
10	7224964	.	A	G	19	27	46	0	2	48	0	0
10	7231728	.	T	C	21	23	44	0	0	44	0	0
10	7231821	.	T	A	27	25	52	0	2	54	0	0
10	7231964	.	G	C	24	24	48	0	1	49	0	0
10	7232043	.	T	A	24	11	35	0	4	39	0	0
10	7232058	.	G	T	2	13	15	0	19	34	0	0
10	7232104	.	A	T	17	17	34	0	1	35	0	0
10	7232309	.	C	T	6	7	13	0	0	13	0	0
10	7232416	.	T	C	18	18	36	0	1	37	0	0
10	7232420	.	T	C	20	19	39	0	0	39	0	0
10	7233038	.	T	C	21	14	35	0	3	38	0	0
10	7233218	.	A	G	29	20	49	0	2	51	0	0
10	7233440	.	A	T	27	35	62	0	1	63	0	0
10	7233457	.	C	G	30	33	63	0	2	65	0	0
10	7233518	.	T	C	27	21	48	0	2	50	0	0
10	7233854	.	A	T	17	14	31	0	3	34	0	0
10	7233939	.	C	T	9	3	12	0	0	12	0	0
10	7284182	.	T	A	6	6	12	0	0	12	0	0
10	7284403	.	C	T	10	5	15	0	1	16	0	0
10	7284520	.	A	G	8	5	13	0	1	14	0	0
10	7284556	.	T	A	8	4	12	0	2	14	0	0
10	7284629	.	T	C	9	9	18	0	0	18	0	0
10	7311979	.	G	A	2	5	7	0	1	8	0	0
10	7311997	.	T	G	1	2	3	0	2	5	0	0
10	7312057	.	A	G	3	10	13	1	0	14	0	0
10	7483649	.	G	C	4	0	4	0	7	11	0	0
10	7483671	.	A	G	6	5	11	0	0	11	0	0
10	7483708	.	T	A	4	2	6	0	0	6	0	0
10	7493909	.	C	T	3	2	5	0	0	5	0	0
10	7500099	.	G	A	1	2	3	0	0	3	0	0
10	7500101	.	T	A	1	2	3	0	0	3	0	0
10	7564294	.	C	T	9	9	18	0	5	23	0	0
10	7593246	.	A	T	6	13	19	0	1	20	0	0
10	7593349	.	C	A	12	14	26	0	2	28	0	0
10	7617113	.	A	T	28	26	54	0	4	58	0	0
10	7617126	.	T	C	30	32	62	0	2	64	0	0
10	7617242	.	G	A	31	34	65	0	5	70	0	0
10	7617327	.	A	C	18	23	41	0	12	53	0	0
10	7617350	.	A	T	18	31	49	0	15	64	0	0
10	7617636	.	A	G	19	2	21	0	18	39	0	0
10	7629422	.	C	T	2	3	5	0	0	5	0	0
10	7629453	.	T	C	3	4	7	0	0	7	0	0
10	7635245	.	C	T	1	4	5	0	0	5	0	0
10	7640501	.	C	T	15	31	46	0	2	48	0	0
10	7640676	.	G	A	18	18	36	0	2	38	0	0
10	7671368	.	T	C	9	11	20	0	0	20	0	0
10	7671425	.	G	A	7	11	18	0	1	19	0	0
10	7672832	.	A	C	7	11	18	1	0	19	0	0
10	7672853	.	G	A	8	10	18	1	1	20	0	0
10	7673819	.	C	G	5	4	9	0	0	9	0	0
10	7673849	.	A	G	6	4	10	0	0	10	0	0
10	7673887	.	C	G	2	2	4	0	0	4	0	0
10	7674079	.	T	G	3	3	6	0	2	8	0	0
10	7674429	.	C	T	1	4	5	0	0	5	0	0
10	7674506	.	A	G	3	8	11	0	0	11	0	0
10	7678121	.	T	C	11	8	19	0	1	20	0	0
10	7678154	.	C	T	1	8	9	0	6	15	0	0
10	7678525	.	C	T	1	8	9	0	14	23	0	0
10	7696900	.	G	A	2	5	7	0	0	7	0	0
10	7700564	.	T	G	4	4	8	0	0	8	0	0
10	7700615	.	A	G	5	7	12	0	0	12	0	0
10	7700676	.	G	A	3	6	9	0	0	9	0	0
10	7701852	.	A	C	6	0	6	0	7	13	0	0
10	7704548	.	C	T	3	4	7	0	0	7	0	0
10	7709761	.	T	C	3	9	12	0	1	13	0	0
10	7709975	.	A	G	6	5	11	0	0	11	0	0
10	7709978	.	T	C	5	5	10	0	0	10	0	0
10	7712180	.	T	A	5	8	13	0	0	13	0	0
10	7712206	.	G	A	6	8	14	0	0	14	0	0
10	7712228	.	C	T	5	7	12	0	1	13	0	0
10	7713924	.	A	G	3	0	3	0	6	9	0	0
10	7721459	.	A	G	8	9	17	0	0	17	0	0
10	7721746	.	G	A	10	6	16	0	1	17	0	0
10	7722595	.	A	G	5	4	9	0	3	12	0	0
10	7722649	.	C	T	1	2	3	0	1	4	0	0
10	7722653	.	C	T	2	2	4	0	0	4	0	0
10	7723004	.	T	C	5	2	7	0	0	7	0	0
10	7723061	.	C	A	7	5	12	0	0	12	0	0
10	7723157	.	A	G	16	13	29	0	0	29	0	0
10	7723218	.	T	C	9	15	24	0	1	25	0	0
10	7723275	.	C	A	15	17	32	0	0	32	0	0
10	7723337	.	C	G	7	8	15	0	2	17	0	0
10	7727393	.	T	C	1	3	4	0	1	5	0	0
10	7727598	.	A	T	2	9	11	0	0	11	0	0
10	7727704	.	T	A	6	7	13	1	1	15	0	0
10	7734401	.	G	A	6	7	13	0	0	13	0	0
10	7734465	.	C	T	6	9	15	0	0	15	0	0
10	7770200	.	A	G	1	5	6	0	0	6	0	0
10	7770201	.	G	A	1	4	5	0	1	6	0	0
10	7770467	.	C	T	0	4	4	0	2	6	0	0
10	7771634	.	T	A	1	4	5	0	1	6	0	0
10	7771735	.	A	C	4	3	7	0	0	7	0	0
10	7771769	.	C	T	2	4	6	0	0	6	0	0
10	7771778	.	G	A	3	4	7	0	0	7	0	0
10	7772012	.	T	G	10	4	14	0	0	14	0	0
10	7772272	.	C	T	7	7	14	0	0	14	0	0
10	7804460	.	T	C	1	2	3	0	0	3	0	0
10	7804461	.	T	C	1	2	3	0	0	3	0	0
10	7810461	.	A	T	26	19	45	0	0	45	0	0
10	7810565	.	G	A	15	21	36	0	0	36	0	0
10	7811062	.	T	A	7	4	11	0	0	11	0	0
10	7811075	.	T	C	7	3	10	0	0	10	0	0
10	7811935	.	A	G	9	16	25	0	0	25	0	0
10	7815118	.	G	A	15	11	26	0	1	27	0	0
10	7815187	.	G	A	17	13	30	0	0	30	0	0
10	7843465	.	A	G	2	4	6	0	0	6	0	0
10	7847200	.	C	T	1	4	5	0	0	5	0	0
10	7901101	.	C	T	1	2	3	0	2	5	0	0
10	7901261	.	G	C	2	2	4	0	0	4	0	0
10	7901754	.	T	A	4	3	7	0	0	7	0	0
10	7902030	.	T	A	3	5	8	0	0	8	0	0
10	7902045	.	T	G	2	5	7	0	0	7	0	0
10	7902300	.	C	T	1	2	3	0	0	3	0	0
10	7909269	.	C	A	2	2	4	0	0	4	0	0
10	7916836	.	A	C	13	12	25	0	0	25	0	0
10	7916930	.	C	A	8	12	20	0	2	22	0	0
10	7917036	.	A	T	11	12	23	0	1	24	0	0
10	7917114	.	T	C	12	18	30	0	2	32	0	0
10	7917411	.	C	A	1	12	13	0	10	23	0	0
10	7917483	.	C	A	11	5	16	0	1	17	0	0
10	7917510	.	A	T	12	2	14	0	3	17	0	0
10	7917551	.	A	G	19	18	37	0	0	37	0	0
10	7917592	.	T	C	19	21	40	0	2	42	0	0
10	7917686	.	T	C	19	19	38	0	1	39	0	0
10	7917690	.	A	T	20	19	39	0	1	40	0	0
10	7920910	.	T	G	22	22	44	0	1	45	0	0
10	7920913	.	C	T	24	20	44	0	2	46	0	0
10	7922210	.	G	T	11	23	34	0	1	35	0	0
10	7922294	.	C	A	13	13	26	0	1	27	0	0
10	7926899	.	A	G	16	18	34	0	0	34	0	0
10	7929647	.	T	C	9	1	10	0	5	15	0	0
10	7936283	.	T	G	14	16	30	0	0	30	0	0
10	7938629	.	C	T	15	9	24	0	2	26	0	0
10	7938659	.	A	G	11	11	22	0	0	22	0	0
10	7938683	.	T	C	10	10	20	0	1	21	0	0
10	7959655	.	T	A	10	6	16	0	1	17	0	0
10	7968160	.	G	T	3	4	7	0	1	8	0	0
10	7968274	.	G	T	2	3	5	0	2	7	0	0
10	7984677	.	A	T	18	17	35	0	0	35	0	0
10	7986217	.	T	C	15	13	28	0	4	32	0	0
10	7986307	.	C	T	4	14	18	0	20	38	0	0
10	7986432	.	C	T	1	18	19	0	22	41	0	0
10	7989000	.	C	T	1	4	5	0	1	6	0	0
10	7989162	.	T	G	4	4	8	0	0	8	0	0
10	7989237	.	G	A	7	11	18	0	0	18	0	0
10	7989287	.	G	A	12	9	21	0	1	22	0	0
10	7989348	.	C	T	9	9	18	0	2	20	0	0
10	7989576	.	C	T	9	10	19	0	1	20	0	0
10	7992197	.	T	C	9	15	24	0	4	28	0	0
10	7996021	.	G	A	8	6	14	0	2	16	0	0
10	8001365	.	A	G	5	5	10	0	0	10	0	0
10	8005785	.	T	A	5	5	10	0	1	11	0	0
10	8009996	.	A	C	6	3	9	0	0	9	0	0
10	8032838	.	G	A	4	5	9	0	0	9	0	0
10	8032910	.	C	T	0	5	5	0	3	8	0	0
10	8033259	.	C	T	2	2	4	0	0	4	0	0
10	8034855	.	C	T	5	2	7	0	0	7	0	0
10	8034890	.	T	C	3	2	5	0	0	5	0	0
10	8035058	.	T	G	5	5	10	0	0	10	0	0
10	8035093	.	G	A	4	3	7	0	0	7	0	0
10	8035195	.	T	A	4	3	7	0	1	8	0	0
10	8035262	.	C	T	0	4	4	0	5	9	0	0
10	8035510	.	C	T	2	2	4	0	4	8	0	0
10	8035556	.	T	A	3	2	5	0	0	5	0	0
10	8035604	.	C	T	0	2	2	0	7	9	0	0
10	8035702	.	C	T	6	3	9	0	1	10	0	0
10	8035752	.	A	T	1	2	3	0	0	3	0	0
10	8037351	.	C	T	1	4	5	0	0	5	0	0
10	8037425	.	A	G	4	2	6	0	0	6	0	0
10	8037820	.	A	T	2	2	4	0	0	4	0	0
10	8040536	.	T	C	4	5	9	0	0	9	0	0
10	8041806	.	T	C	2	2	4	0	0	4	0	0
10	8097929	.	C	G	21	11	32	0	2	34	0	0
10	8154892	.	C	T	4	10	14	0	0	14	0	0
10	8160813	.	T	G	4	9	13	0	0	13	0	0
10	8160888	.	G	A	4	8	12	0	1	13	0	0
10	8160891	.	T	C	5	0	5	0	9	14	0	0
10	8161027	.	A	G	6	7	13	0	1	14	0	0
10	8163440	.	G	A	7	6	13	0	0	13	0	0
10	8170083	.	C	A	3	6	9	0	0	9	0	0
10	8170468	.	C	A	0	4	4	0	1	5	0	0
10	8175123	.	T	C	4	4	8	0	1	9	0	0
10	8175164	.	C	A	4	6	10	0	0	10	0	0
10	8177748	.	A	G	2	3	5	0	2	7	0	0
10	8190734	.	C	T	1	4	5	0	1	6	0	0
10	8202517	.	C	T	5	2	7	0	0	7	0	0
10	8202523	.	C	T	6	2	8	0	0	8	0	0
10	8208610	.	G	A	3	3	6	0	0	6	0	0
10	8217056	.	T	C	1	3	4	0	1	5	0	0
10	8235946	.	A	G	2	0	2	0	5	7	0	0
10	8236775	.	T	C	4	9	13	0	0	13	0	0
10	8239318	.	T	C	4	5	9	0	1	10	0	0
10	8263045	.	G	A	10	7	17	0	0	17	0	0
10	8263081	.	T	C	10	9	19	0	0	19	0	0
10	8263919	.	C	T	6	3	9	0	0	9	0	0
10	8266383	.	A	G	19	16	35	0	0	35	0	0
10	8269377	.	G	A	8	13	21	0	1	22	0	0
10	8269459	.	T	C	2	1	3	0	1	4	0	0
10	8269470	.	G	C	2	2	4	0	0	4	0	0
10	8269515	.	T	C	4	4	8	0	1	9	0	0
10	8278160	.	T	C	5	12	17	0	4	21	0	0
10	8278214	.	A	G	14	11	25	0	1	26	0	0
10	8295026	.	C	T	1	6	7	0	3	10	0	0
10	8295196	.	T	G	3	6	9	0	1	10	0	0
10	8295295	.	C	A	2	5	7	0	2	9	0	0
10	8306677	.	G	C	1	2	3	0	0	3	0	0
10	8335402	.	A	G	3	4	7	0	0	7	0	0
10	8418671	.	A	G	2	5	7	0	1	8	0	0
10	8419132	.	G	A	0	2	2	0	1	3	0	0
10	8437947	.	T	C	4	4	8	0	0	8	0	0
10	8629373	.	T	C	3	2	5	0	0	5	0	0
10	8629847	.	A	G	2	0	2	0	5	7	0	0
10	8630402	.	G	T	0	10	10	0	10	20	0	0
10	8630428	.	A	G	9	10	19	0	0	19	0	0
10	8630452	.	G	T	12	10	22	0	0	22	0	0
10	8630527	.	G	A	9	10	19	0	0	19	0	0
10	8630618	.	C	T	6	5	11	0	1	12	0	0
10	8630631	.	T	C	9	5	14	0	0	14	0	0
10	8630702	.	T	C	4	10	14	1	0	15	0	0
10	8630914	.	A	G	4	4	8	0	0	8	0	0
10	8631152	.	A	T	9	3	12	0	1	13	0	0
10	8660722	.	C	T	11	6	17	0	2	19	0	0
10	8670139	.	G	A	9	10	19	0	1	20	0	0
10	8819572	.	C	A	1	2	3	0	0	3	0	0
10	8825313	.	A	G	2	3	5	0	0	5	0	0
10	8825349	.	G	A	0	2	2	0	1	3	0	0
10	8835208	.	G	A	0	4	4	0	1	5	0	0
10	8840343	.	A	G	4	3	7	0	0	7	0	0
10	8950022	.	T	C	4	0	4	0	3	7	0	0
10	8950055	.	G	A	4	3	7	0	0	7	0	0
10	8950108	.	A	G	2	5	7	0	0	7	0	0
10	8952018	.	T	C	3	8	11	0	0	11	0	0
10	8952601	.	A	G	5	5	10	0	0	10	0	0
10	8955356	.	C	A	2	2	4	0	0	4	0	0
10	8976417	.	G	A	1	4	5	0	1	6	0	0
10	9006634	.	T	C	10	16	26	0	1	27	0	0
10	9089524	.	A	C	5	0	5	0	6	11	0	0
10	9089569	.	T	A	9	8	17	0	1	18	0	0
10	9089602	.	T	C	7	0	7	0	6	13	0	0
10	9164807	.	T	C	5	4	9	0	2	11	0	0
10	9168991	.	C	T	3	3	6	0	0	6	0	0
10	9173473	.	A	G	4	3	7	0	0	7	0	0
10	9173485	.	G	T	0	4	4	0	5	9	0	0
10	9177363	.	T	C	13	5	18	0	0	18	0	0
10	9181508	.	T	A	11	9	20	0	1	21	0	0
10	9184326	.	T	A	5	6	11	1	1	13	0	0
10	9184533	.	C	T	7	8	15	0	1	16	0	0
10	9209311	.	A	T	2	3	5	0	0	6	1	0
10	9209342	.	T	G	2	0	2	0	2	4	0	0
10	9234236	.	T	C	2	4	6	0	0	6	0	0
10	9255670	.	G	A	3	11	14	0	1	15	0	0
10	9269228	.	G	A	4	10	14	0	0	14	0	0
10	9305277	.	G	A	3	6	9	0	0	9	0	0
10	9305433	.	A	G	3	4	7	0	0	7	0	0
10	9305534	.	A	C	7	7	14	0	1	15	0	0
10	9305543	.	C	T	8	7	15	0	0	15	0	0
10	9308057	.	C	T	8	3	11	0	1	12	0	0
10	9308092	.	G	A	3	7	10	0	0	10	0	0
10	9308133	.	G	A	2	4	6	0	0	6	0	0
10	9346253	.	T	A	2	4	6	0	1	7	0	0
10	9361037	.	C	T	9	2	11	0	1	12	0	0
10	9361891	.	G	A	6	6	12	0	0	12	0	0
10	9361924	.	G	C	2	6	8	0	1	9	0	0
10	9369466	.	A	G	3	3	6	0	0	6	0	0
10	9370121	.	A	T	7	4	11	0	0	11	0	0
10	9370274	.	G	A	5	9	14	0	0	14	0	0
10	9370755	.	A	G	6	5	11	0	1	12	0	0
10	9390726	.	C	T	2	8	10	0	0	10	0	0
10	9393537	.	T	A	5	3	8	0	1	9	0	0
10	9393836	.	G	A	3	2	5	0	0	5	0	0
10	9395012	.	C	T	7	8	15	0	0	15	0	0
10	9419821	.	G	A	16	15	31	0	2	33	0	0
10	9419901	.	T	A	11	11	22	0	0	22	0	0
10	9419902	.	A	G	11	11	22	0	0	22	0	0
10	9595693	.	C	T	6	2	8	0	0	8	0	0
10	9618055	.	G	A	0	3	3	0	3	6	0	0
10	9618295	.	G	A	2	3	5	0	1	6	0	0
10	9626934	.	A	T	2	4	6	0	0	6	0	0
10	9626988	.	C	T	6	5	11	0	0	11	0	0
10	9627603	.	T	C	3	3	6	0	0	6	0	0
10	9632265	.	G	A	0	5	5	0	6	11	0	0
10	9632336	.	A	G	7	0	7	0	3	10	0	0
10	9638888	.	A	G	7	4	11	0	1	12	0	0
10	9639172	.	T	C	5	2	7	0	1	8	0	0
10	9642674	.	T	A	4	5	9	0	1	10	0	0
10	9644669	.	T	C	4	5	9	4	0	13	0	0
10	9697243	.	C	A	3	8	11	0	0	11	0	0
10	9697270	.	A	T	6	7	13	0	0	13	0	0
10	9701905	.	C	T	5	4	9	0	0	9	0	0
10	9714771	.	T	C	9	7	16	0	0	16	0	0
10	9714801	.	C	T	6	4	10	0	0	10	0	0
10	9714819	.	A	G	8	4	12	0	0	12	0	0
10	9729611	.	G	A	0	10	10	0	7	17	0	0
10	9771749	.	G	T	1	4	5	0	7	12	0	0
10	9776699	.	C	T	10	12	22	0	1	23	0	0
10	9781455	.	G	A	15	11	26	0	4	30	0	0
10	9781509	.	G	A	20	19	39	0	2	41	0	0
10	9784087	.	C	T	17	17	34	0	1	35	0	0
10	9784238	.	G	A	3	21	24	0	19	43	0	0
10	9789262	.	C	T	22	16	38	0	1	39	0	0
10	9800719	.	G	T	25	16	41	1	1	43	0	0
10	9802771	.	T	C	25	15	40	0	1	41	0	0
10	9802804	.	C	T	12	16	28	0	4	32	0	0
10	9806731	.	A	G	16	1	17	0	20	37	0	0
10	9807014	.	T	G	21	10	31	0	1	32	0	0
10	9807203	.	G	A	23	16	39	0	0	39	0	0
10	9837191	.	A	G	9	3	12	0	1	13	0	0
10	9846240	.	A	G	19	10	29	0	0	29	0	0
10	9846261	.	G	A	19	13	32	0	0	32	0	0
10	9846285	.	T	G	10	16	26	0	5	31	0	0
10	9846602	.	C	G	0	6	6	0	11	17	0	0
10	9856390	.	T	C	2	0	2	0	14	16	0	0
10	9861038	.	A	T	3	5	8	0	0	8	0	0
10	9895348	.	G	A	4	4	8	0	1	9	0	0
10	9899215	.	G	T	4	3	7	0	0	7	0	0
10	9899302	.	G	A	9	5	14	0	0	14	0	0
10	9899308	.	G	A	6	7	13	0	0	13	0	0
10	10254913	.	G	A	1	4	5	0	4	9	0	0
10	10261887	.	G	C	7	12	19	0	0	19	0	0
10	10261893	.	C	A	8	12	20	0	0	20	0	0
10	10262013	.	T	C	13	6	19	0	1	20	0	0
10	10262157	.	A	G	4	5	9	0	0	9	0	0
10	10269930	.	T	C	4	10	14	0	1	15	0	0
10	10317392	.	A	T	3	9	12	0	1	13	0	0
10	10325451	.	T	C	10	3	13	0	0	13	0	0
10	10380074	.	G	A	1	5	6	0	0	6	0	0
10	10561156	.	T	A	4	5	9	0	0	9	0	0
10	10567262	.	A	G	3	2	5	0	0	5	0	0
10	10636263	.	A	G	6	4	10	0	0	10	0	0
10	10636283	.	T	C	8	4	12	0	0	12	0	0
10	10636558	.	A	T	2	3	5	0	0	5	0	0
10	10636799	.	C	A	3	6	9	0	0	9	0	0
10	10636896	.	G	A	0	9	9	0	5	14	0	0
10	10636946	.	A	G	8	5	13	0	2	15	0	0
10	11267530	.	C	A	3	6	9	0	0	9	0	0
10	11276479	.	C	T	3	5	8	0	1	9	0	0
10	11279555	.	G	A	7	9	16	0	1	17	0	0
10	11280118	.	C	T	7	10	17	0	2	19	0	0
10	11280146	.	C	T	10	12	22	0	0	22	0	0
10	11280999	.	A	G	2	2	4	0	0	4	0	0
10	11281005	.	T	C	2	2	4	0	0	4	0	0
10	11281086	.	A	G	1	4	5	0	0	5	0	0
10	11281087	.	A	G	1	3	4	0	2	6	0	0
10	11281148	.	G	A	3	2	5	0	0	5	0	0
10	11282072	.	G	A	1	4	5	0	1	6	0	0
10	11282194	.	A	G	6	2	8	0	0	8	0	0
10	11282933	.	T	A	8	9	17	0	0	17	0	0
10	11286830	.	C	T	3	9	12	0	1	13	0	0
10	11287343	.	A	G	12	0	12	0	8	20	0	0
10	11298651	.	G	A	2	4	6	0	1	7	0	0
10	11298652	.	A	C	2	5	7	0	0	7	0	0
10	11298852	.	G	A	6	11	17	0	1	18	0	0
10	11298864	.	A	G	7	10	17	0	1	18	0	0
10	11298955	.	T	C	5	3	8	0	0	8	0	0
10	11298975	.	C	T	6	2	8	0	1	9	0	0
10	11309859	.	C	G	7	1	8	0	7	15	0	0
10	11310500	.	G	A	4	5	9	0	0	9	0	0
10	11310501	.	C	A	4	5	9	0	0	9	0	0
10	11310618	.	A	C	7	5	12	0	0	12	0	0
10	11322985	.	T	C	9	6	15	0	1	16	0	0
10	11323032	.	G	A	8	4	12	0	1	13	0	0
10	11323092	.	G	A	5	8	13	0	0	13	0	0
10	11327364	.	A	G	1	2	3	0	0	3	0	0
10	11327429	.	G	A	3	3	6	0	0	6	0	0
10	11327466	.	G	A	5	4	9	0	0	9	0	0
10	11327484	.	C	T	1	6	7	0	8	15	0	0
10	11327703	.	C	T	7	5	12	0	0	12	0	0
10	11328246	.	G	C	3	4	7	1	0	8	0	0
10	11328263	.	G	A	7	2	9	0	0	9	0	0
10	11331922	.	C	T	2	5	7	0	6	13	0	0
10	11332206	.	A	G	3	2	5	0	0	5	0	0
10	11334397	.	T	C	2	0	2	0	4	6	0	0
10	11334415	.	C	A	0	4	4	0	3	7	0	0
10	11339235	.	G	A	2	6	8	0	0	8	0	0
10	11339319	.	C	T	1	5	6	0	8	14	0	0
10	11343169	.	C	T	4	4	8	0	2	10	0	0
10	11347909	.	A	G	3	11	14	0	0	14	0	0
10	11347929	.	T	G	4	11	15	0	0	16	1	0
10	11359991	.	A	G	8	0	8	0	7	15	0	0
10	11362275	.	C	T	23	23	46	0	3	49	0	0
10	11368116	.	G	T	14	4	18	0	0	18	0	0
10	11398168	.	T	G	3	0	3	0	3	6	0	0
10	11403954	.	T	C	5	6	11	0	1	12	0	0
10	11790947	.	T	C	10	7	17	0	1	18	0	0
10	11805601	.	T	C	2	3	5	0	1	6	0	0
10	12517216	.	T	C	1	3	4	0	0	4	0	0
10	12517256	.	G	C	0	3	3	0	2	5	0	0
10	12616330	.	T	G	1	3	4	0	0	4	0	0
10	12616396	.	A	G	1	4	5	0	0	5	0	0
10	12656045	.	C	T	2	2	4	0	0	4	0	0
10	12656075	.	T	C	2	2	4	0	0	4	0	0
10	12729361	.	C	T	5	5	10	0	1	11	0	0
10	12730352	.	T	C	5	7	12	0	0	12	0	0
10	12730433	.	C	T	2	3	5	0	1	6	0	0
10	13063542	.	G	T	1	3	4	0	0	4	0	0
10	13063775	.	C	T	1	3	4	0	0	4	0	0
10	13283660	.	C	A	6	3	9	0	1	10	0	0
10	13283720	.	C	T	5	4	9	0	0	9	0	0
10	13286472	.	T	C	9	5	14	0	0	14	0	0
10	13286677	.	A	G	2	6	8	0	0	8	0	0
10	13286778	.	G	A	0	2	2	0	5	7	0	0
10	13286803	.	A	T	3	3	6	0	0	6	0	0
10	13460494	.	A	C	8	5	13	0	0	13	0	0
10	13460671	.	G	A	17	7	24	0	1	25	0	0
10	13460691	.	T	C	16	10	26	0	0	26	0	0
10	13460745	.	C	A	1	11	12	0	19	32	1	0
10	13460765	.	C	T	20	12	32	0	1	33	0	0
10	13460814	.	A	T	22	15	37	0	0	37	0	0
10	13461080	.	T	C	18	0	18	0	21	39	0	0
10	13476010	.	A	G	13	20	33	0	1	34	0	0
10	13529250	.	C	G	19	8	27	0	0	27	0	0
10	13529270	.	T	C	16	10	26	0	0	26	0	0
10	13536790	.	T	C	6	0	6	0	4	10	0	0
10	14470434	.	C	T	2	2	4	0	0	4	0	0
10	14478899	.	A	G	3	6	9	0	0	9	0	0
10	14478929	.	A	G	3	4	7	0	0	7	0	0
10	14491139	.	C	T	16	14	30	0	0	30	0	0
10	14532271	.	T	C	6	9	15	0	0	15	0	0
10	14532398	.	T	C	11	1	12	0	7	19	0	0
10	14533352	.	A	G	7	9	16	0	1	17	0	0
10	14536393	.	G	A	2	7	9	0	0	9	0	0
10	14545572	.	A	G	13	18	31	0	1	32	0	0
10	14871245	.	T	A	11	9	20	1	2	23	0	0
10	14871758	.	C	G	15	4	19	0	0	20	1	0
10	14871768	.	A	G	13	8	21	0	1	22	0	0
10	14871801	.	A	C	16	10	26	0	1	27	0	0
10	14873175	.	T	G	20	8	28	0	0	28	0	0
10	14873220	.	A	G	21	12	33	0	2	35	0	0
10	14878863	.	C	G	14	9	23	0	0	23	0	0
10	14878890	.	T	C	12	0	12	0	12	24	0	0
10	14879027	.	G	A	5	11	16	0	1	17	0	0
10	14885337	.	A	G	10	10	20	0	2	22	0	0
10	14885957	.	C	A	0	9	9	1	8	18	0	0
10	14892211	.	C	T	3	12	15	0	10	25	0	0
10	14920909	.	G	A	7	3	10	0	0	10	0	0
10	14920912	.	T	C	8	0	8	0	3	11	0	0
10	15277481	.	T	C	15	5	20	0	0	20	0	0
10	15285696	.	C	T	11	13	24	0	0	24	0	0
10	15285852	.	T	G	8	0	8	0	9	17	0	0
10	15287463	.	T	C	9	11	20	0	1	21	0	0
10	15287883	.	C	A	8	12	20	0	0	20	0	0
10	15287933	.	C	T	11	17	28	0	0	28	0	0
10	15291157	.	G	A	0	18	18	0	15	33	0	0
10	15295913	.	T	C	14	8	22	0	1	23	0	0
10	15296219	.	G	A	2	15	17	0	20	37	0	0
10	15298458	.	G	C	12	14	26	0	0	26	0	0
10	15298518	.	G	A	18	18	36	0	2	38	0	0
10	15303975	.	A	T	22	23	45	0	4	49	0	0
10	15304167	.	A	G	6	12	18	0	1	19	0	0
10	15304331	.	C	A	9	19	28	0	0	28	0	0
10	15304782	.	A	G	17	23	40	0	2	42	0	0
10	15338917	.	T	G	2	5	7	0	0	7	0	0
10	15372708	.	G	T	12	8	20	0	0	20	0	0
10	15372726	.	G	A	11	7	18	0	1	19	0	0
10	15372889	.	G	A	21	12	33	0	2	35	0	0
10	15381782	.	C	G	4	6	10	0	1	11	0	0
10	15381784	.	A	C	4	6	10	0	1	11	0	0
10	15382352	.	A	G	12	11	23	0	2	25	0	0
10	15382546	.	A	G	10	14	24	0	1	25	0	0
10	15382669	.	G	A	16	18	34	0	0	34	0	0
10	15382681	.	A	T	15	19	34	0	4	38	0	0
10	15400027	.	G	A	25	20	45	0	0	45	0	0
10	15400692	.	T	G	11	27	38	0	0	38	0	0
10	15405509	.	T	G	2	4	6	0	0	6	0	0
10	15434330	.	T	C	1	3	4	0	0	4	0	0
10	15434345	.	T	C	1	5	6	0	0	6	0	0
10	15438403	.	T	C	2	3	5	0	0	5	0	0
10	15438418	.	G	C	1	4	5	0	3	8	0	0
10	15438451	.	G	A	2	4	6	0	1	7	0	0
10	15511974	.	C	T	1	5	6	0	0	6	0	0
10	15533107	.	T	C	3	2	5	0	0	5	0	0
10	15551580	.	C	T	1	2	3	0	0	3	0	0
10	15553178	.	A	G	3	3	6	0	0	6	0	0
10	15569027	.	G	A	0	4	4	0	6	10	0	0
10	15575364	.	C	T	3	4	7	0	0	7	0	0
10	15580988	.	T	G	5	0	5	0	6	11	0	0
10	15581078	.	G	A	5	2	7	0	0	7	0	0
10	15582744	.	A	C	8	9	17	0	0	17	0	0
10	15582746	.	A	T	8	8	16	0	1	17	0	0
10	15582799	.	C	T	6	8	14	0	0	14	0	0
10	15582906	.	C	T	8	9	17	0	0	17	0	0
10	15583060	.	C	T	1	3	4	0	0	4	0	0
10	15583105	.	C	T	3	4	7	0	0	7	0	0
10	15583153	.	G	C	6	6	12	0	0	12	0	0
10	15596503	.	A	C	6	7	13	0	1	14	0	0
10	15596752	.	C	T	9	9	18	0	0	18	0	0
10	15596767	.	C	G	6	8	14	0	0	14	0	0
10	15596958	.	G	C	7	8	15	0	0	15	0	0
10	15596995	.	C	T	8	9	17	0	0	17	0	0
10	15597103	.	T	A	5	11	16	0	0	16	0	0
10	15597662	.	G	C	6	5	11	1	0	12	0	0
10	15597822	.	G	A	2	5	7	0	0	7	0	0
10	15597834	.	A	T	1	5	6	0	1	7	0	0
10	15598303	.	A	T	3	7	10	0	0	10	0	0
10	15598358	.	T	G	6	10	16	0	0	16	0	0
10	15598412	.	T	C	7	5	12	0	1	13	0	0
10	15598598	.	T	G	8	3	11	0	0	11	0	0
10	15598681	.	G	A	1	8	9	0	9	18	0	0
10	15598921	.	T	A	10	7	17	0	3	20	0	0
10	15608373	.	T	C	19	8	27	0	1	28	0	0
10	15608756	.	T	C	20	18	38	0	1	39	0	0
10	15612238	.	C	T	8	14	22	0	3	25	0	0
10	15612602	.	G	A	25	8	33	1	1	35	0	0
10	15612641	.	A	T	19	6	25	1	8	34	0	0
10	15612675	.	T	A	20	12	32	0	2	34	0	0
10	15612705	.	C	T	18	14	32	0	2	34	0	0
10	15612758	.	G	A	21	15	36	0	0	36	0	0
10	15612859	.	G	T	2	17	19	0	17	36	0	0
10	15613076	.	G	A	1	5	6	0	15	21	0	0
10	15613174	.	A	C	6	2	8	0	0	8	0	0
10	15618411	.	A	G	3	7	10	0	0	10	0	0
10	15618606	.	A	G	4	7	11	0	0	11	0	0
10	15621499	.	A	G	5	7	12	0	0	12	0	0
10	15621529	.	C	T	0	5	5	0	4	9	0	0
10	15623124	.	T	C	1	6	7	0	0	7	0	0
10	15631408	.	C	T	0	3	3	0	4	7	0	0
10	15637405	.	C	T	1	4	5	0	0	5	0	0
10	15637696	.	T	C	2	2	4	0	0	4	0	0
10	15637860	.	G	A	2	3	5	0	0	5	0	0
10	15644841	.	A	C	1	4	5	0	0	5	0	0
10	15658893	.	C	G	1	3	4	0	0	4	0	0
10	15783637	.	A	G	8	1	9	0	15	24	0	0
10	15783721	.	A	G	6	10	16	0	3	19	0	0
10	15783777	.	G	A	9	11	20	0	0	20	0	0
10	15783934	.	T	C	9	10	19	1	0	20	0	0
10	15784613	.	G	A	1	9	10	0	9	19	0	0
10	15788562	.	A	T	10	11	21	0	1	22	0	0
10	15795197	.	A	G	12	0	12	0	12	24	0	0
10	15809215	.	C	T	8	17	25	0	3	28	0	0
10	15812950	.	A	G	14	0	14	0	21	35	0	0
10	15816029	.	T	A	2	3	5	0	0	5	0	0
10	15816852	.	C	G	0	3	3	0	2	5	0	0
10	15824645	.	A	G	4	3	7	0	0	7	0	0
10	15824648	.	A	G	4	3	7	0	0	7	0	0
10	15824684	.	C	A	0	4	4	0	2	6	0	0
10	15838597	.	G	A	1	3	4	0	0	4	0	0
10	15839104	.	A	T	2	2	4	0	1	5	0	0
10	15881732	.	G	T	11	3	14	0	2	16	0	0
10	15881819	.	T	G	6	8	14	0	1	15	0	0
10	15884833	.	G	A	5	12	17	0	0	17	0	0
10	15884872	.	T	C	6	0	6	0	10	16	0	0
10	15893297	.	A	T	5	6	11	0	0	11	0	0
10	15893347	.	G	A	7	4	11	0	0	11	0	0
10	15893372	.	G	T	8	5	13	0	1	14	0	0
10	15919753	.	T	A	4	3	7	0	0	7	0	0
10	15960967	.	T	A	8	7	15	0	1	16	0	0
10	15967713	.	T	A	5	4	9	0	0	9	0	0
10	15967715	.	G	A	5	4	9	0	0	9	0	0
10	15980805	.	A	T	5	9	14	0	0	14	0	0
10	15984366	.	C	T	5	5	10	0	0	10	0	0
10	15992664	.	G	A	5	10	15	0	1	16	0	0
10	15992712	.	T	A	10	8	18	0	0	18	0	0
10	15992731	.	A	T	10	11	21	0	1	22	0	0
10	15992968	.	A	C	12	11	23	0	2	25	0	0
10	15997600	.	A	G	4	0	4	0	8	12	0	0
10	15997729	.	C	T	11	9	20	0	1	21	0	0
10	15997804	.	G	A	0	11	11	0	12	23	0	0
10	16015332	.	G	A	10	10	20	0	0	20	0	0
10	16015509	.	C	A	0	8	8	0	9	17	0	0
10	16017676	.	A	T	11	13	24	0	0	24	0	0
10	16019482	.	G	A	9	12	21	0	0	21	0	0
10	16019881	.	A	G	3	4	7	0	2	9	0	0
10	16019902	.	C	T	5	5	10	0	0	10	0	0
10	16031378	.	T	C	10	14	24	0	2	26	0	0
10	16031555	.	C	T	7	9	16	0	0	16	0	0
10	16031648	.	C	G	10	7	17	0	1	18	0	0
10	16031690	.	A	G	13	9	22	0	0	22	0	0
10	16034782	.	A	G	2	5	7	0	0	7	0	0
10	16034796	.	C	T	2	5	7	0	0	7	0	0
10	16034887	.	G	A	2	7	9	0	0	9	0	0
10	16034901	.	A	C	5	5	10	0	0	10	0	0
10	16035084	.	G	A	5	7	12	0	1	13	0	0
10	16036615	.	T	C	8	5	13	0	0	13	0	0
10	16036818	.	C	T	2	3	5	0	1	6	0	0
10	16043700	.	A	G	3	0	3	0	9	12	0	0
10	16052536	.	T	C	4	6	10	0	1	11	0	0
10	16055878	.	C	T	7	8	15	0	0	15	0	0
10	16055906	.	C	T	6	9	15	0	0	15	0	0
10	16056137	.	T	A	4	4	8	0	0	8	0	0
10	16056145	.	A	G	5	3	8	0	1	9	0	0
10	16056181	.	T	A	9	8	17	0	1	18	0	0
10	16056511	.	T	C	15	8	23	0	1	24	0	0
10	16173354	.	A	G	3	2	5	0	0	5	0	0
10	16173552	.	G	A	2	7	9	0	0	9	0	0
10	16176685	.	G	A	1	3	4	0	1	5	0	0
10	16176720	.	C	T	4	5	9	0	0	9	0	0
10	16178474	.	A	T	7	2	9	0	0	9	0	0
10	16181904	.	T	C	3	2	5	0	1	6	0	0
10	16185500	.	T	C	8	9	17	1	0	18	0	0
10	16185611	.	A	G	8	0	8	0	10	18	0	0
10	16185685	.	A	G	6	4	10	0	0	10	0	0
10	16185915	.	T	G	8	7	15	0	0	15	0	0
10	16185927	.	C	G	9	7	16	0	1	17	0	0
10	16185984	.	T	G	7	4	11	0	0	11	0	0
10	16186158	.	T	C	5	6	11	0	0	11	0	0
10	16186405	.	T	A	5	5	10	0	0	10	0	0
10	16192385	.	G	A	5	5	10	0	0	10	0	0
10	16225603	.	A	T	6	0	6	0	0	6	0	0
10	16225872	.	C	T	4	2	6	0	0	6	0	0
10	16226250	.	A	C	7	3	10	0	1	11	0	0
10	16264257	.	A	T	2	2	4	0	0	4	0	0
10	16273333	.	C	T	2	3	5	0	0	5	0	0
10	16273683	.	C	T	4	3	7	0	0	7	0	0
10	16303060	.	A	T	10	7	17	0	0	17	0	0
10	16307128	.	A	G	3	0	3	0	2	5	0	0
10	16307651	.	T	A	11	16	27	0	1	28	0	0
10	16307679	.	T	A	11	13	24	0	2	26	0	0
10	16307952	.	A	G	4	12	16	0	0	16	0	0
10	16307979	.	A	T	3	8	11	0	0	11	0	0
10	16308206	.	T	C	6	5	11	0	0	11	0	0
10	16308272	.	A	G	9	9	18	0	0	18	0	0
10	16308643	.	G	A	1	11	12	0	11	23	0	0
10	16308648	.	G	T	2	11	13	0	9	22	0	0
10	16308923	.	G	A	1	14	15	0	15	30	0	0
10	16309001	.	T	A	11	10	21	5	0	26	0	0
10	16309017	.	G	A	10	7	17	5	2	24	0	0
10	16309167	.	T	C	13	18	31	0	0	31	0	0
10	16309364	.	A	G	2	2	4	0	0	4	0	0
10	16309434	.	T	C	2	2	4	0	1	5	0	0
10	16309498	.	C	T	8	8	16	0	3	19	0	0
10	16476113	.	C	T	2	2	4	0	0	4	0	0
10	16476122	.	G	A	2	2	4	0	0	4	0	0
10	16476480	.	G	A	1	2	3	0	0	3	0	0
10	16477049	.	T	C	2	0	2	0	5	7	0	0
10	16563035	.	A	C	1	2	3	0	0	3	0	0
10	16746334	.	A	G	6	3	9	0	0	9	0	0
10	16746706	.	C	A	4	6	10	0	0	10	0	0
10	16746790	.	C	T	8	4	12	0	0	12	0	0
10	16747280	.	T	C	4	4	8	0	0	8	0	0
10	16747281	.	A	C	4	4	8	0	0	8	0	0
10	16747465	.	A	C	9	9	18	0	0	18	0	0
10	16867505	.	G	T	2	5	7	0	1	8	0	0
10	17102971	.	C	T	25	39	64	0	1	65	0	0
10	17132501	.	C	T	23	31	54	0	3	57	0	0
10	17166889	.	C	T	2	12	14	0	15	29	0	0
10	17166955	.	A	G	15	20	35	0	0	35	0	0
10	17167637	.	A	G	32	27	59	0	3	62	0	0
10	17167733	.	T	C	27	36	63	0	3	66	0	0
10	17167757	.	G	A	30	31	61	0	1	62	0	0
10	17168039	.	C	T	27	18	45	0	3	48	0	0
10	17168096	.	A	G	28	28	56	0	0	56	0	0
10	17169948	.	C	G	24	27	51	0	1	52	0	0
10	17179400	.	G	A	2	3	5	0	0	5	0	0
10	17179557	.	C	T	5	2	7	0	0	7	0	0
10	17183147	.	T	A	4	3	7	0	0	7	0	0
10	17224218	.	G	A	5	6	11	0	1	12	0	0
10	17282810	.	C	G	5	5	10	0	0	10	0	0
10	17282903	.	G	A	6	8	14	0	1	15	0	0
10	17283170	.	A	G	10	9	19	0	2	21	0	0
10	17283386	.	A	G	8	12	20	0	1	21	0	0
10	17283720	.	T	A	7	8	15	0	0	15	0	0
10	17283905	.	A	G	9	7	16	0	0	16	0	0
10	17283955	.	G	A	8	8	16	0	0	16	0	0
10	17372187	.	G	A	2	4	6	0	5	11	0	0
10	17552889	.	A	T	7	10	17	0	0	17	0	0
10	17552976	.	T	C	1	5	6	0	0	6	0	0
10	17552994	.	T	C	1	4	5	0	0	5	0	0
10	17553184	.	T	C	8	5	13	0	0	13	0	0
10	17553271	.	G	A	8	6	14	0	1	15	0	0
10	17560030	.	G	A	8	6	14	0	0	14	0	0
10	17560390	.	T	C	3	6	9	0	1	10	0	0
10	17562978	.	G	C	3	4	7	0	1	8	0	0
10	17563180	.	A	G	5	5	10	0	2	12	0	0
10	17563279	.	C	T	4	6	10	0	1	11	0	0
10	17568855	.	T	C	2	2	4	0	0	4	0	0
10	17568878	.	C	T	2	1	3	0	2	5	0	0
10	17572866	.	C	A	0	5	5	0	2	7	0	0
10	17579465	.	C	T	1	3	4	0	3	7	0	0
10	17579715	.	A	C	4	6	10	0	1	11	0	0
10	17579948	.	T	A	1	4	5	0	1	6	0	0
10	17583426	.	T	C	4	1	5	0	5	10	0	0
10	17587553	.	G	A	2	2	4	0	0	4	0	0
10	17587789	.	G	A	3	2	5	0	0	5	0	0
10	17587795	.	T	C	9	0	9	0	2	11	0	0
10	17638857	.	A	G	1	0	1	0	2	3	0	0
10	17642514	.	A	G	1	2	3	0	0	3	0	0
10	17681174	.	A	T	7	6	13	0	1	14	0	0
10	17681183	.	T	A	9	8	17	0	0	17	0	0
10	17681252	.	G	A	5	6	11	0	0	11	0	0
10	17684736	.	C	T	10	9	19	0	0	19	0	0
10	17684739	.	C	T	9	10	19	0	0	19	0	0
10	17686174	.	T	C	9	8	17	0	0	17	0	0
10	17686216	.	T	C	15	8	23	0	1	24	0	0
10	17690998	.	C	T	8	4	12	0	0	12	0	0
10	17691127	.	T	G	6	4	10	0	1	11	0	0
10	17700237	.	T	C	2	0	2	0	8	10	0	0
10	17700365	.	A	T	7	8	15	0	1	16	0	0
10	17700458	.	T	C	6	6	12	0	2	14	0	0
10	17700484	.	A	T	3	8	11	0	0	11	0	0
10	17700753	.	C	A	6	4	10	0	0	10	0	0
10	17700775	.	G	A	4	2	6	0	0	6	0	0
10	17701002	.	C	G	10	9	19	0	1	20	0	0
10	17701003	.	C	A	1	9	10	0	10	20	0	0
10	17701222	.	C	T	2	9	11	0	12	23	0	0
10	17850975	.	C	T	1	2	3	0	0	3	0	0
10	17851033	.	T	G	4	4	8	0	2	10	0	0
10	17876862	.	A	G	18	0	18	0	8	26	0	0
10	17890850	.	G	A	13	9	22	0	0	22	0	0
10	17911220	.	C	T	10	5	15	0	0	15	0	0
10	17913424	.	A	C	14	12	26	0	0	26	0	0
10	17922444	.	A	G	22	19	41	1	0	42	0	0
10	17922540	.	A	T	22	20	42	0	0	42	0	0
10	17922582	.	C	T	17	17	34	0	1	35	0	0
10	17922651	.	G	C	22	14	36	0	2	38	0	0
10	17922718	.	C	T	15	12	27	0	0	27	0	0
10	17922807	.	A	G	20	0	20	0	13	33	0	0
10	17922894	.	T	G	6	14	20	0	1	21	0	0
10	17922955	.	A	T	8	13	21	0	2	23	0	0
10	17922973	.	T	C	8	9	17	0	2	19	0	0
10	17923490	.	A	T	14	12	26	0	0	26	0	0
10	17923867	.	A	C	5	6	11	0	0	11	0	0
10	17923912	.	T	A	5	2	7	0	0	7	0	0
10	17924341	.	A	G	4	9	13	0	0	13	0	0
10	17924398	.	A	C	6	7	13	0	2	15	0	0
10	17924420	.	T	C	4	7	11	0	1	12	0	0
10	17924740	.	T	G	12	12	24	0	1	25	0	0
10	17924779	.	G	A	13	13	26	0	1	27	0	0
10	17924836	.	T	A	15	12	27	0	2	29	0	0
10	17925146	.	T	C	11	23	34	0	2	36	0	0
10	17925301	.	T	A	14	7	21	0	0	21	0	0
10	17925302	.	G	T	14	6	20	0	1	21	0	0
10	17940303	.	G	A	1	9	10	0	32	42	0	0
10	17940352	.	G	A	32	22	54	0	1	55	0	0
10	17940356	.	A	G	32	19	51	0	4	55	0	0
10	17943696	.	G	A	38	22	60	0	0	60	0	0
10	17943714	.	T	C	41	22	63	0	0	63	0	0
10	17944017	.	C	T	31	23	54	0	4	58	0	0
10	17945447	.	A	G	26	18	44	0	3	47	0	0
10	17945522	.	C	T	21	17	38	3	0	41	0	0
10	17945581	.	G	T	26	28	54	0	2	56	0	0
10	17945629	.	T	C	31	28	59	0	0	59	0	0
10	17945725	.	A	G	25	23	48	0	1	49	0	0
10	17945738	.	T	A	27	22	49	0	0	50	1	0
10	17945779	.	T	A	24	13	37	0	0	37	0	0
10	17946030	.	A	T	5	4	9	0	0	9	0	0
10	18887816	.	C	T	6	11	17	0	1	18	0	0
10	18896228	.	A	C	8	13	21	0	1	22	0	0
10	18924407	.	C	G	7	10	17	0	0	17	0	0
10	18927910	.	C	T	7	10	17	1	1	19	0	0
10	18930403	.	T	C	8	13	21	0	0	21	0	0
10	18934119	.	A	T	4	3	7	0	1	8	0	0
10	18934291	.	T	C	17	10	27	0	0	27	0	0
10	18934393	.	T	G	5	0	5	0	11	16	0	0
10	18934409	.	T	A	5	8	13	0	1	14	0	0
10	18934590	.	A	C	8	13	21	0	2	23	0	0
10	18934683	.	T	C	11	14	25	0	1	26	0	0
10	18934963	.	G	A	0	8	8	0	9	17	0	0
10	18935271	.	C	T	16	17	33	0	1	34	0	0
10	18935874	.	T	A	5	5	10	0	0	10	0	0
10	18973124	.	A	G	10	0	10	0	4	14	0	0
10	18983512	.	C	A	14	9	23	0	1	24	0	0
10	18989018	.	C	G	8	15	23	0	1	24	0	0
10	18989047	.	T	C	9	11	20	0	1	21	0	0
10	19020475	.	A	G	14	8	22	0	0	22	0	0
10	19021032	.	C	A	2	6	8	0	0	8	0	0
10	19021102	.	C	G	9	8	17	0	0	17	0	0
10	19021192	.	A	G	4	7	11	0	0	11	0	0
10	19021243	.	G	A	1	3	4	0	0	4	0	0
10	19338938	.	T	G	1	3	4	0	1	5	0	0
10	19339364	.	G	A	1	2	3	0	6	9	0	0
10	19339367	.	T	C	7	2	9	0	0	9	0	0
10	19339538	.	G	C	2	6	8	0	9	17	0	0
10	19339647	.	C	T	3	8	11	0	2	13	0	0
10	19339859	.	C	G	5	8	13	0	0	13	0	0
10	19428830	.	A	C	2	1	3	0	2	5	0	0
10	19428835	.	C	A	0	3	3	0	2	5	0	0
10	19429634	.	A	T	2	3	5	0	0	5	0	0
10	19429713	.	T	C	1	2	3	0	0	3	0	0
10	19429718	.	A	G	1	2	3	0	0	3	0	0
10	19554673	.	A	T	14	22	36	0	0	36	0	0
10	19558489	.	C	A	24	19	43	0	2	45	0	0
10	19558558	.	T	A	20	14	34	0	1	35	0	0
10	19559235	.	A	G	15	18	33	0	0	33	0	0
10	19562006	.	T	G	27	22	49	0	2	51	0	0
10	19562015	.	A	T	30	23	53	0	1	54	0	0
10	19562945	.	C	T	28	30	58	0	3	61	0	0
10	19565704	.	A	T	18	26	44	4	5	53	0	0
10	19565771	.	T	C	23	34	57	1	1	59	0	0
10	19565782	.	A	C	21	36	57	1	2	60	0	0
10	19566400	.	T	A	10	18	28	0	0	28	0	0
10	19566445	.	T	C	6	7	13	0	0	13	0	0
10	19801737	.	C	A	8	6	14	0	0	14	0	0
10	19801759	.	A	C	4	6	10	0	0	10	0	0
10	19801779	.	C	T	2	6	8	0	0	8	0	0
10	19801808	.	A	G	3	3	6	0	0	6	0	0
10	20082011	.	T	G	2	3	5	0	0	5	0	0
10	20083200	.	C	T	6	5	11	0	0	11	0	0
10	20085200	.	A	C	3	5	8	0	0	8	0	0
10	20087260	.	A	G	1	4	5	0	0	5	0	0
10	20087263	.	C	T	0	4	4	0	0	4	0	0
10	20093368	.	C	T	8	7	15	0	1	16	0	0
10	20093914	.	C	T	7	7	14	0	1	15	0	0
10	20093959	.	A	G	9	11	20	0	0	20	0	0
10	20100534	.	A	C	2	1	3	0	11	14	0	0
10	20103429	.	A	T	4	5	9	0	0	9	0	0
10	20103448	.	A	G	5	5	10	1	0	11	0	0
10	20103601	.	G	T	4	10	14	0	2	16	0	0
10	20103639	.	A	G	2	7	9	0	0	9	0	0
10	20103662	.	C	T	2	5	7	0	0	7	0	0
10	20103731	.	C	T	6	8	14	0	0	14	0	0
10	20105347	.	A	G	12	16	28	0	0	28	0	0
10	20108575	.	T	A	15	12	27	0	0	27	0	0
10	20113892	.	T	C	1	2	3	0	0	3	0	0
10	20136107	.	T	C	12	16	28	0	1	29	0	0
10	20137862	.	A	G	8	12	20	0	0	20	0	0
10	20141059	.	A	G	2	0	2	0	3	5	0	0
10	20143850	.	T	A	4	4	8	0	1	9	0	0
10	20147452	.	A	G	9	1	10	0	17	27	0	0
10	20218342	.	C	G	9	12	21	0	0	21	0	0
10	20221281	.	C	T	14	9	23	0	1	24	0	0
10	20270867	.	T	C	5	4	9	0	1	10	0	0
10	20270919	.	C	T	0	2	2	0	4	6	0	0
10	20276923	.	T	C	3	2	5	0	0	5	0	0
10	20339024	.	C	T	8	3	11	0	0	11	0	0
10	20351930	.	T	C	3	2	5	0	0	5	0	0
10	20351978	.	A	G	2	5	7	0	0	7	0	0
10	20356700	.	C	T	3	3	6	0	0	6	0	0
10	20364395	.	T	G	2	2	4	0	0	4	0	0
10	20368883	.	C	T	12	17	29	0	0	29	0	0
10	20371675	.	A	T	16	14	30	0	0	30	0	0
10	20371715	.	T	C	9	11	20	0	0	20	0	0
10	20371723	.	A	C	10	11	21	0	1	22	0	0
10	20371827	.	C	T	14	8	22	0	1	23	0	0
10	20393164	.	C	T	2	3	5	0	0	5	0	0
10	20401613	.	C	A	8	3	11	0	0	11	0	0
10	20462884	.	G	A	16	12	28	0	2	30	0	0
10	20463890	.	G	A	10	12	22	0	1	23	0	0
10	20464238	.	A	G	15	10	25	0	1	26	0	0
10	20464245	.	A	G	14	8	22	0	1	23	0	0
10	20468868	.	T	C	13	0	13	0	9	22	0	0
10	20468952	.	G	A	7	10	17	0	0	17	0	0
10	20472600	.	G	T	10	6	16	0	1	17	0	0
10	20473517	.	G	T	12	7	19	0	1	20	0	0
10	20481740	.	T	C	3	7	10	0	0	10	0	0
10	20505261	.	G	A	5	3	8	0	0	8	0	0
10	20506482	.	T	A	3	7	10	0	0	10	0	0
10	20515512	.	A	G	4	3	7	0	0	7	0	0
10	20517889	.	A	G	2	3	5	0	0	5	0	0
10	20519543	.	T	C	3	3	6	0	0	6	0	0
10	20519549	.	T	C	2	0	2	0	2	4	0	0
10	20527639	.	G	A	10	6	16	0	0	16	0	0
10	20527653	.	C	T	10	3	13	0	0	13	0	0
10	20529384	.	G	A	12	5	17	0	1	18	0	0
10	20529389	.	G	T	11	6	17	0	0	17	0	0
10	20529450	.	T	C	16	0	16	0	10	26	0	0
10	20532762	.	C	T	0	7	7	0	8	15	0	0
10	20533079	.	A	C	6	4	10	0	0	10	0	0
10	20543294	.	T	C	5	1	6	0	7	13	0	0
10	20543336	.	G	A	10	7	17	0	1	18	0	0
10	20546548	.	C	T	7	10	17	0	2	19	0	0
10	20563086	.	T	C	6	9	15	0	0	15	0	0
10	20586463	.	A	T	5	3	8	0	0	8	0	0
10	20596178	.	C	G	8	7	15	0	0	15	0	0
10	20598267	.	A	G	9	8	17	1	0	18	0	0
10	20598345	.	C	G	14	5	19	9	1	29	0	0
10	20604555	.	T	C	18	16	34	0	0	34	0	0
10	20605150	.	C	T	14	9	23	0	2	25	0	0
10	20636027	.	C	T	9	16	25	0	1	26	0	0
10	20636072	.	A	C	15	18	33	0	0	33	0	0
10	20636082	.	C	T	13	15	28	0	3	31	0	0
10	20636168	.	A	T	12	9	21	0	1	22	0	0
10	20636177	.	G	T	11	8	19	0	1	20	0	0
10	20636211	.	G	A	5	8	13	0	0	13	0	0
10	20636262	.	T	A	8	16	24	0	0	24	0	0
10	20636273	.	T	C	10	0	10	0	16	26	0	0
10	20636346	.	T	C	8	9	17	0	0	17	0	0
10	20636479	.	T	C	2	5	7	0	0	7	0	0
10	20637069	.	C	T	14	17	31	0	1	32	0	0
10	20643844	.	T	A	1	2	3	0	0	3	0	0
10	20660387	.	G	A	5	4	9	0	0	9	0	0
10	20661288	.	A	G	4	8	12	0	1	13	0	0
10	20696449	.	A	G	1	2	3	0	1	4	0	0
10	20920664	.	A	G	7	13	20	0	0	20	0	0
10	20971685	.	A	G	13	14	27	0	1	28	0	0
10	21043461	.	G	A	16	15	31	0	1	32	0	0
10	21043902	.	G	A	5	10	15	0	1	16	0	0
10	21043934	.	A	G	5	11	16	0	0	16	0	0
10	21043944	.	A	G	4	11	15	0	0	15	0	0
10	21044037	.	G	A	3	8	11	0	1	12	0	0
10	21044094	.	T	A	2	8	10	0	2	12	0	0
10	21044136	.	G	A	9	11	20	0	0	20	0	0
10	21044193	.	A	G	6	4	10	0	0	10	0	0
10	21044235	.	A	C	6	4	10	0	1	11	0	0
10	21044316	.	A	G	1	5	6	0	0	6	0	0
10	21044645	.	G	A	4	3	7	0	0	7	0	0
10	21044964	.	T	A	4	5	9	0	1	10	0	0
10	21045126	.	T	C	4	1	5	0	8	13	0	0
10	21053520	.	G	C	1	2	3	0	0	3	0	0
10	21436810	.	T	C	8	6	14	0	0	14	0	0
10	21437255	.	A	G	7	0	7	0	6	13	0	0
10	21440173	.	T	C	9	5	14	0	0	14	0	0
10	21440486	.	T	A	16	10	26	0	1	27	0	0
10	21440786	.	A	G	12	11	23	0	1	24	0	0
10	21441305	.	C	T	9	13	22	0	1	23	0	0
10	21442229	.	T	C	15	11	26	0	0	26	0	0
10	21442994	.	T	A	24	17	41	0	0	41	0	0
10	21443476	.	T	C	21	13	34	0	2	36	0	0
10	21451996	.	C	T	8	9	17	0	0	17	0	0
10	21452340	.	T	C	11	7	18	0	1	19	0	0
10	21456498	.	T	C	8	9	17	0	0	17	0	0
10	21459403	.	G	A	2	13	15	0	12	27	0	0
10	21459439	.	G	A	18	10	28	0	0	29	1	0
10	21462585	.	A	G	13	14	27	0	0	27	0	0
10	21469977	.	G	A	4	23	27	0	15	42	0	0
10	21469997	.	A	C	18	20	38	0	1	39	0	0
10	21514191	.	T	C	2	4	6	0	0	6	0	0
10	21523014	.	C	T	5	2	7	0	1	8	0	0
10	21523578	.	C	A	1	2	3	0	0	3	0	0
10	21523720	.	T	C	3	3	6	0	1	7	0	0
10	21523827	.	A	G	4	5	9	0	0	9	0	0
10	21524244	.	C	A	9	7	16	0	1	17	0	0
10	21524319	.	G	T	8	6	14	0	0	14	0	0
10	21524337	.	C	T	6	7	13	0	0	13	0	0
10	21524472	.	C	T	5	3	8	0	1	9	0	0
10	21524682	.	G	A	3	11	14	0	0	14	0	0
10	21524805	.	T	C	6	4	10	0	0	10	0	0
10	21524811	.	A	C	6	3	9	0	0	9	0	0
10	21564251	.	C	A	2	2	4	0	0	4	0	0
10	21622317	.	G	A	39	24	63	4	3	70	0	0
10	21645994	.	G	A	29	24	53	1	4	58	0	0
10	21646033	.	C	T	32	24	56	1	2	59	0	0
10	21646216	.	T	C	30	9	39	0	2	41	0	0
10	21646225	.	G	A	30	12	42	0	2	44	0	0
10	21646400	.	C	G	22	29	51	0	2	53	0	0
10	21646844	.	A	G	30	22	52	0	1	53	0	0
10	21646848	.	A	G	27	23	50	0	1	51	0	0
10	21646908	.	C	A	25	23	48	0	0	48	0	0
10	21647008	.	A	C	26	22	48	0	0	48	0	0
10	21647200	.	C	T	32	26	58	0	0	58	0	0
10	21647241	.	T	G	28	22	50	0	5	55	0	0
10	21647291	.	G	A	2	22	24	0	32	56	0	0
10	21647539	.	T	C	39	23	62	0	3	65	0	0
10	21647582	.	C	A	34	32	66	0	0	66	0	0
10	21647614	.	A	C	36	30	66	0	7	73	0	0
10	21647898	.	C	T	30	24	54	1	4	59	0	0
10	21657070	.	T	C	1	2	3	0	1	4	0	0
10	21720833	.	A	G	4	3	7	0	0	7	0	0
10	21723083	.	G	A	1	1	2	0	1	3	0	0
10	21723742	.	G	A	1	4	5	0	0	5	0	0
10	21724901	.	T	C	8	3	11	0	1	12	0	0
10	21729235	.	T	C	5	2	7	0	1	8	0	0
10	21738068	.	C	T	2	2	4	0	0	4	0	0
10	21739919	.	T	A	1	2	3	4	0	7	0	0
10	21776952	.	T	C	2	4	6	0	0	6	0	0
10	21776997	.	G	A	2	3	5	0	0	5	0	0
10	21777141	.	T	G	4	2	6	0	0	6	0	0
10	21777416	.	A	C	1	2	3	0	0	3	0	0
10	21777889	.	A	C	1	3	4	0	0	4	0	0
10	21777903	.	A	C	1	2	3	0	0	3	0	0
10	21778089	.	C	A	2	2	4	0	1	5	0	0
10	21778098	.	C	G	2	3	5	0	0	5	0	0
10	21778614	.	A	C	4	2	6	0	0	6	0	0
10	21778980	.	C	T	4	5	9	6	0	15	0	0
10	21779067	.	C	T	3	2	5	0	1	6	0	0
10	21779073	.	T	A	3	2	5	0	1	6	0	0
10	21780310	.	G	A	1	5	6	2	5	13	0	0
10	21780576	.	C	T	5	7	12	0	0	14	2	0
10	21780612	.	A	G	4	8	12	0	2	15	1	0
10	21780615	.	A	C	5	12	17	0	0	17	0	0
10	21780741	.	A	G	5	0	5	0	10	15	0	0
10	21780747	.	G	T	0	10	10	0	5	15	0	0
10	21781185	.	C	A	12	9	21	0	0	21	0	0
10	21781313	.	C	T	8	6	14	5	0	19	0	0
10	21781722	.	G	C	8	8	16	0	2	22	4	0
10	21783523	.	A	G	7	2	9	0	0	9	0	0
10	21783525	.	A	G	7	7	14	3	0	17	0	0
10	21783560	.	C	A	13	9	22	4	0	26	0	0
10	21783596	.	G	C	8	12	20	4	0	24	0	0
10	21784029	.	C	T	8	2	10	0	0	10	0	0
10	21784033	.	C	A	8	1	9	0	0	9	0	0
10	21784186	.	A	G	10	4	14	0	0	14	0	0
10	21785311	.	C	A	2	3	5	18	0	23	0	0
10	21786741	.	T	C	4	2	6	0	1	7	0	0
10	21790076	.	A	C	10	7	17	0	0	17	0	0
10	21790295	.	A	T	5	4	9	0	0	9	0	0
10	21790486	.	G	A	4	2	6	0	0	6	0	0
10	21790499	.	C	T	5	2	7	0	0	7	0	0
10	21790648	.	T	C	6	9	15	0	0	15	0	0
10	21790769	.	A	G	10	0	10	0	9	19	0	0
10	21790775	.	A	C	10	6	16	0	1	17	0	0
10	21790934	.	T	C	10	6	16	0	0	16	0	0
10	21791090	.	G	A	14	6	20	0	0	20	0	0
10	21791690	.	G	A	0	6	6	12	8	26	0	0
10	21791699	.	T	C	8	8	16	11	0	27	0	0
10	21791745	.	G	A	8	9	17	2	0	19	0	0
10	21791927	.	A	T	7	6	13	3	2	18	0	0
10	21792024	.	A	C	16	5	21	10	0	31	0	0
10	21794285	.	G	A	2	3	5	0	0	5	0	0
10	21797266	.	C	T	4	4	8	0	0	8	0	0
10	21797769	.	T	G	3	3	6	0	1	7	0	0
10	21797914	.	G	A	7	3	10	0	0	10	0	0
10	21798157	.	C	T	7	2	9	0	0	9	0	0
10	21798215	.	C	A	2	8	10	2	0	12	0	0
10	21798333	.	C	T	2	4	6	0	0	6	0	0
10	21798348	.	A	T	2	4	6	0	0	6	0	0
10	21798372	.	G	A	5	5	10	0	0	10	0	0
10	21798571	.	C	A	4	3	7	0	0	7	0	0
10	21798975	.	C	T	3	2	5	5	1	11	0	0
10	21798987	.	T	A	2	2	4	18	0	22	0	0
10	21799320	.	A	C	5	2	7	10	0	17	0	0
10	21799343	.	T	A	5	4	9	3	0	12	0	0
10	21799374	.	T	A	12	5	17	1	0	18	0	0
10	21799408	.	T	A	9	3	12	9	2	23	0	0
10	21799575	.	G	T	3	7	10	18	0	28	0	0
10	21801256	.	C	G	2	6	8	0	0	8	0	0
10	21801267	.	C	T	2	8	10	0	0	11	1	0
10	21801339	.	T	G	10	0	10	0	7	17	0	0
10	21801352	.	T	C	12	10	22	0	1	23	0	0
10	21801590	.	A	C	4	4	8	0	0	8	0	0
10	21801611	.	G	T	5	7	12	0	0	12	0	0
10	21801718	.	G	A	1	10	11	0	7	18	0	0
10	21802057	.	A	G	9	7	16	0	1	17	0	0
10	21802086	.	A	G	12	10	22	0	0	22	0	0
10	21802291	.	C	T	10	8	18	0	1	19	0	0
10	21802326	.	C	A	14	7	21	0	0	21	0	0
10	21802355	.	C	A	10	3	13	0	0	13	0	0
10	21802380	.	G	A	1	6	7	0	8	15	0	0
10	21802530	.	A	T	8	4	12	0	0	12	0	0
10	21802539	.	C	T	8	6	14	0	0	14	0	0
10	21802566	.	T	C	7	7	14	0	1	15	0	0
10	21802661	.	C	T	12	8	20	0	2	22	0	0
10	21802962	.	G	A	13	6	19	12	0	31	0	0
10	21803003	.	A	T	18	7	25	1	1	27	0	0
10	21803031	.	G	A	13	7	20	0	2	22	0	0
10	21804785	.	G	T	0	4	4	0	3	7	0	0
10	21804786	.	G	T	2	4	6	0	1	7	0	0
10	21805085	.	A	C	1	2	3	0	0	3	0	0
10	21805090	.	G	A	1	3	4	0	0	4	0	0
10	21805251	.	T	G	2	3	5	0	0	5	0	0
10	21805447	.	G	A	2	8	10	0	0	10	0	0
10	21805762	.	C	T	3	6	9	0	1	10	0	0
10	21805870	.	A	G	2	0	2	0	3	5	0	0
10	21806060	.	G	A	5	3	8	0	0	8	0	0
10	21806984	.	T	A	6	4	10	4	0	14	0	0
10	21808897	.	G	A	0	2	2	0	2	4	0	0
10	21809227	.	T	C	1	2	3	0	0	3	0	0
10	21818522	.	C	T	50	37	87	0	1	88	0	0
10	21818595	.	T	G	38	33	71	0	3	74	0	0
10	21818762	.	A	C	36	18	54	0	0	54	0	0
10	21818978	.	G	T	30	32	62	0	1	63	0	0
10	21819577	.	C	T	33	29	62	1	7	70	0	0
10	21819772	.	T	C	30	36	66	0	2	68	0	0
10	21819966	.	A	T	8	4	12	0	0	12	0	0
10	21944941	.	C	T	1	2	3	0	0	3	0	0
10	21944971	.	A	G	1	2	3	0	0	3	0	0
10	22003847	.	T	C	19	21	40	0	2	42	0	0
10	22003874	.	A	G	13	19	32	0	1	33	0	0
10	22030827	.	G	A	27	23	50	0	0	50	0	0
10	22030881	.	A	T	26	19	45	0	2	47	0	0
10	22030887	.	T	G	28	22	50	0	0	50	0	0
10	22030985	.	T	C	18	25	43	0	3	46	0	0
10	22030986	.	C	T	20	24	44	0	3	47	0	0
10	22031034	.	C	T	25	20	45	0	3	48	0	0
10	22031493	.	G	A	23	26	49	0	2	51	0	0
10	22031572	.	A	G	21	30	51	0	0	51	0	0
10	22031635	.	A	G	14	25	39	0	2	41	0	0
10	22031666	.	A	G	19	17	36	0	0	36	0	0
10	22031755	.	T	C	23	8	31	0	2	33	0	0
10	22031759	.	T	C	25	8	33	0	1	34	0	0
10	22031805	.	G	C	14	14	28	0	0	28	0	0
10	22031806	.	G	A	13	12	25	0	3	28	0	0
10	22036033	.	A	G	5	0	5	0	3	8	0	0
10	22036169	.	A	G	7	6	13	0	0	13	0	0
10	22041529	.	G	A	7	8	15	0	0	15	0	0
10	22041546	.	C	T	9	9	18	0	0	18	0	0
10	22044921	.	T	G	2	6	8	0	0	8	0	0
10	22051436	.	A	G	2	4	6	0	0	6	0	0
10	22051465	.	G	C	2	3	5	0	0	5	0	0
10	22051933	.	A	G	1	3	4	0	0	4	0	0
10	22054149	.	T	C	3	4	7	0	0	7	0	0
10	22054158	.	A	G	4	2	6	0	1	7	0	0
10	22054257	.	T	C	1	2	3	0	0	3	0	0
10	22137372	.	C	A	3	3	6	0	0	6	0	0
10	22137374	.	C	A	4	2	6	0	1	7	0	0
10	22162187	.	T	C	10	1	11	0	19	30	0	0
10	22163144	.	A	T	5	8	13	0	0	13	0	0
10	22163165	.	A	G	4	7	11	0	0	11	0	0
10	22163235	.	C	T	0	7	7	0	5	12	0	0
10	22163244	.	C	G	5	6	11	0	0	11	0	0
10	22163660	.	C	T	3	9	12	0	0	12	0	0
10	22163801	.	A	T	6	8	14	0	0	14	0	0
10	22163867	.	T	C	5	3	8	0	0	8	0	0
10	22163928	.	C	A	7	9	16	0	0	16	0	0
10	22164144	.	A	T	4	3	7	0	0	7	0	0
10	22164421	.	T	A	5	5	10	0	1	11	0	0
10	22164518	.	T	A	7	4	11	0	0	11	0	0
10	22164621	.	T	G	4	3	7	0	0	7	0	0
10	22164622	.	G	A	4	3	7	0	0	7	0	0
10	22164672	.	G	A	7	5	12	0	0	12	0	0
10	22164686	.	A	T	7	6	13	0	0	13	0	0
10	22164756	.	T	C	5	5	10	0	0	10	0	0
10	22165383	.	C	G	6	3	9	2	0	11	0	0
10	22165607	.	T	G	6	4	10	0	1	11	0	0
10	22165644	.	T	C	1	6	7	0	1	8	0	0
10	22165709	.	G	A	2	2	4	0	0	4	0	0
10	22165719	.	C	A	0	3	3	0	2	5	0	0
10	22165768	.	T	A	5	5	10	0	0	10	0	0
10	22165879	.	T	A	6	2	8	0	0	8	0	0
10	22165880	.	T	C	5	2	7	0	1	8	0	0
10	22165953	.	C	T	2	4	6	0	1	7	0	0
10	22166010	.	T	A	6	7	13	0	0	13	0	0
10	22166128	.	C	T	3	4	7	0	0	7	0	0
10	22166182	.	A	C	8	0	8	0	5	13	0	0
10	22166184	.	G	A	8	5	13	0	0	13	0	0
10	22166504	.	C	T	7	2	9	0	1	10	0	0
10	22205038	.	G	A	7	4	11	0	0	11	0	0
10	22381847	.	A	G	4	3	7	0	0	7	0	0
10	22381897	.	C	G	6	4	10	0	0	10	0	0
10	22381984	.	A	T	5	4	9	0	0	9	0	0
10	22475736	.	G	A	6	8	14	0	0	14	0	0
10	22475799	.	G	A	2	12	14	0	11	25	0	0
10	22476535	.	C	T	8	8	16	0	2	18	0	0
10	22477229	.	A	G	13	11	24	0	1	25	0	0
10	22477580	.	C	T	12	4	16	0	0	16	0	0
10	22477610	.	A	G	12	0	12	0	6	18	0	0
10	22477661	.	C	T	7	4	11	0	1	12	0	0
10	22510550	.	C	A	3	4	7	0	2	9	0	0
10	22516643	.	C	G	9	8	17	0	0	17	0	0
10	22516758	.	T	C	5	9	14	0	0	14	0	0
10	22516903	.	A	G	3	6	9	0	1	10	0	0
10	22516957	.	T	C	3	6	9	0	0	9	0	0
10	22518293	.	C	T	13	4	17	0	3	20	0	0
10	22518294	.	C	T	13	4	17	0	2	19	0	0
10	22519465	.	A	G	6	5	11	0	0	11	0	0
10	22519668	.	A	T	9	8	17	0	1	18	0	0
10	22519737	.	C	T	4	5	9	0	2	11	0	0
10	22519749	.	G	C	8	2	10	0	0	10	0	0
10	22519931	.	C	T	4	2	6	0	0	6	0	0
10	22530058	.	A	C	7	8	15	0	0	15	0	0
10	22530136	.	A	G	2	1	3	0	8	11	0	0
10	22530732	.	T	G	5	3	8	1	0	9	0	0
10	22531105	.	A	T	5	4	9	0	2	11	0	0
10	22531906	.	A	C	16	13	29	0	1	30	0	0
10	22531946	.	T	G	13	12	25	0	0	25	0	0
10	22532139	.	C	T	10	15	25	0	2	27	0	0
10	22532211	.	G	A	12	9	21	0	0	21	0	0
10	22532547	.	T	A	14	9	23	0	2	25	0	0
10	22532817	.	C	G	13	18	31	0	2	33	0	0
10	24326236	.	C	T	9	21	30	0	1	31	0	0
10	24334810	.	G	A	16	17	33	0	1	34	0	0
10	24335002	.	C	T	21	18	39	0	1	40	0	0
10	24335402	.	C	T	20	16	36	0	3	39	0	0
10	24373137	.	C	T	2	2	4	0	0	4	0	0
10	24373429	.	T	A	4	6	10	0	0	10	0	0
10	24373647	.	C	T	1	3	4	0	0	4	0	0
10	24373657	.	A	C	1	6	7	0	0	7	0	0
10	24373845	.	G	A	1	1	2	0	1	3	0	0
10	24373963	.	C	T	2	2	4	0	0	4	0	0
10	24374895	.	A	G	1	2	3	0	0	3	0	0
10	24422052	.	C	T	13	8	21	0	0	21	0	0
10	24422205	.	G	A	10	7	17	0	4	21	0	0
10	24422236	.	C	T	13	10	23	0	1	24	0	0
10	24422311	.	G	A	8	9	17	0	2	19	0	0
10	24424363	.	G	C	1	11	12	0	9	21	0	0
10	24425653	.	A	G	8	7	15	0	0	15	0	0
10	24426038	.	A	T	4	5	9	0	3	12	0	0
10	24429357	.	T	C	7	5	12	0	1	13	0	0
10	24431762	.	C	T	5	10	15	0	2	17	0	0
10	24435656	.	G	T	21	10	31	0	0	31	0	0
10	24435662	.	A	G	20	0	20	0	13	33	0	0
10	24442466	.	C	T	6	3	9	0	0	9	0	0
10	24442490	.	A	G	2	0	2	0	2	4	0	0
10	24563892	.	T	G	8	7	15	0	1	16	0	0
10	24564904	.	G	A	0	9	9	0	4	13	0	0
10	24564935	.	C	A	2	7	9	0	1	10	0	0
10	24565366	.	A	T	9	9	18	0	0	18	0	0
10	24565424	.	G	A	11	6	17	0	0	17	0	0
10	24565435	.	G	T	0	5	5	0	10	15	0	0
10	24565587	.	C	A	7	5	12	0	1	13	0	0
10	24566124	.	T	C	6	11	17	0	1	18	0	0
10	24573740	.	G	A	0	12	12	0	7	19	0	0
10	24600128	.	A	G	9	7	16	0	1	17	0	0
10	24605406	.	A	C	3	6	9	0	2	11	0	0
10	24609362	.	C	A	11	5	16	0	0	16	0	0
10	24614505	.	A	T	12	9	21	0	0	21	0	0
10	24614636	.	A	G	13	0	13	0	8	21	0	0
10	24621354	.	A	G	19	8	27	0	0	27	0	0
10	24621543	.	G	A	10	12	22	0	2	24	0	0
10	24621687	.	G	A	2	4	6	0	0	6	0	0
10	24621730	.	A	T	4	5	9	0	0	9	0	0
10	24621757	.	T	A	5	4	9	0	2	11	0	0
10	24649813	.	T	G	5	5	10	0	0	10	0	0
10	24650192	.	A	G	3	4	7	0	0	7	0	0
10	24650668	.	A	G	1	2	3	0	0	3	0	0
10	24650769	.	T	C	2	0	2	0	4	6	0	0
10	24650889	.	T	A	7	5	12	0	0	12	0	0
10	24654501	.	C	T	0	3	3	0	5	8	0	0
10	24654607	.	A	T	2	6	8	0	0	8	0	0
10	24654765	.	C	T	5	4	9	0	0	9	0	0
10	24654906	.	T	C	8	0	8	0	5	13	0	0
10	24655146	.	A	T	10	10	20	0	0	20	0	0
10	24655984	.	C	T	6	2	8	0	1	9	0	0
10	24656449	.	T	A	10	5	15	0	0	15	0	0
10	24659661	.	A	C	7	3	10	0	0	10	0	0
10	24659717	.	G	C	3	2	5	0	0	5	0	0
10	24660629	.	T	A	3	3	6	0	0	6	0	0
10	24666069	.	A	C	6	6	12	0	2	14	0	0
10	24677091	.	T	G	5	0	5	0	4	9	0	0
10	24685576	.	G	C	1	2	3	0	0	3	0	0
10	24710313	.	G	T	3	4	7	0	0	7	0	0
10	24710981	.	T	G	2	3	5	0	0	5	0	0
10	24725724	.	G	A	3	2	5	0	0	5	0	0
10	24726211	.	T	A	3	5	8	0	0	8	0	0
10	24726264	.	G	A	4	5	9	0	0	9	0	0
10	24726302	.	A	G	2	5	7	0	1	8	0	0
10	24726413	.	C	T	2	2	4	0	3	7	0	0
10	24726551	.	T	C	1	3	4	0	0	4	0	0
10	24726712	.	T	G	3	2	5	0	0	5	0	0
10	24726809	.	A	G	4	4	8	0	0	8	0	0
10	24727127	.	A	G	6	2	8	0	0	8	0	0
10	24762377	.	G	A	3	4	7	0	0	7	0	0
10	24762462	.	T	C	9	0	9	0	4	13	0	0
10	24762510	.	A	G	11	5	16	0	0	16	0	0
10	24762723	.	A	G	6	4	10	0	0	10	0	0
10	24765589	.	A	C	8	4	12	0	0	12	0	0
10	24765893	.	A	G	7	3	10	0	2	12	0	0
10	25068718	.	G	A	5	2	7	0	0	7	0	0
10	25109156	.	T	G	1	3	4	0	0	4	0	0
10	25109225	.	A	C	4	4	8	0	0	8	0	0
10	25136897	.	C	G	1	2	3	0	0	3	0	0
10	25205354	.	A	C	8	6	14	0	1	15	0	0
10	25212215	.	C	G	19	1	20	0	15	36	1	0
10	25219804	.	A	C	4	2	6	0	0	6	0	0
10	25219805	.	A	G	4	0	4	0	2	6	0	0
10	25250493	.	T	A	5	2	7	0	0	7	0	0
10	25252426	.	G	A	3	4	7	0	1	8	0	0
10	25252474	.	C	T	9	5	14	0	0	14	0	0
10	25252591	.	A	G	6	5	11	0	1	12	0	0
10	25261968	.	A	C	11	6	17	0	0	17	0	0
10	25262150	.	T	A	9	4	13	0	1	14	0	0
10	25262336	.	C	T	15	10	25	0	0	25	0	0
10	25267952	.	T	C	11	15	26	0	1	27	0	0
10	25268389	.	T	C	11	10	21	0	1	22	0	0
10	25268827	.	C	T	1	2	3	0	0	3	0	0
10	25269148	.	G	A	3	3	6	0	0	6	0	0
10	25269170	.	C	A	3	4	7	0	0	7	0	0
10	25269245	.	C	T	15	4	19	0	1	20	0	0
10	25269413	.	A	G	16	20	36	0	3	39	0	0
10	25269592	.	A	G	33	1	34	0	14	48	0	0
10	25269599	.	C	T	35	12	47	0	2	49	0	0
10	25269747	.	T	A	22	8	30	0	4	34	0	0
10	25269983	.	A	G	45	12	57	0	8	65	0	0
10	25270044	.	C	A	19	19	38	0	4	42	0	0
10	25270096	.	T	C	25	19	44	0	2	46	0	0
10	25270432	.	A	G	13	12	25	0	1	26	0	0
10	25270471	.	A	G	6	13	19	0	0	19	0	0
10	25270618	.	C	G	14	14	28	0	0	28	0	0
10	25270942	.	G	C	18	15	33	0	0	33	0	0
10	25270958	.	C	T	21	15	36	0	0	36	0	0
10	25271051	.	T	A	12	14	26	0	3	29	0	0
10	25271338	.	T	C	12	15	27	0	3	30	0	0
10	25312733	.	T	G	7	8	15	0	0	15	0	0
10	25312889	.	T	A	1	6	7	0	0	7	0	0
10	25313204	.	G	A	6	8	14	0	1	15	0	0
10	25321344	.	C	T	2	4	6	0	0	6	0	0
10	25325361	.	A	G	6	3	9	0	0	9	0	0
10	25329811	.	C	A	2	26	28	0	35	63	0	0
10	25333961	.	C	T	3	24	27	0	25	52	0	0
10	25334178	.	T	C	19	17	36	0	1	37	0	0
10	25342889	.	A	G	17	13	30	0	2	32	0	0
10	25381349	.	G	C	1	4	5	0	0	5	0	0
10	25382006	.	A	T	1	2	3	0	0	3	0	0
10	25382045	.	G	A	1	2	3	0	0	3	0	0
10	25383998	.	C	A	1	2	3	0	0	3	0	0
10	25403280	.	C	G	0	6	6	0	6	12	0	0
10	25410276	.	T	C	10	0	10	0	8	18	0	0
10	25410288	.	A	G	10	7	17	0	1	18	0	0
10	25426586	.	C	T	3	3	6	0	0	6	0	0
10	25435335	.	G	C	6	0	6	0	5	11	0	0
10	25436518	.	C	A	4	5	9	0	1	10	0	0
10	25462325	.	A	T	2	2	4	0	1	5	0	0
10	25573333	.	G	A	13	13	26	0	3	29	0	0
10	25573393	.	T	C	7	0	7	0	12	19	0	0
10	25573410	.	T	C	5	8	13	0	1	14	0	0
10	25573436	.	C	G	7	8	15	0	1	16	0	0
10	25574092	.	T	C	6	0	6	0	8	14	0	0
10	25574127	.	T	A	3	6	9	0	1	10	0	0
10	25574159	.	T	C	3	5	8	0	1	9	0	0
10	25574171	.	A	G	5	5	10	0	0	10	0	0
10	25581999	.	G	A	7	2	9	0	0	9	0	0
10	25582029	.	A	G	8	6	14	0	0	14	0	0
10	25582101	.	G	A	3	8	11	0	2	13	0	0
10	25582854	.	G	A	4	2	6	0	1	7	0	0
10	25585179	.	A	G	5	5	10	0	0	10	0	0
10	25601711	.	A	G	5	2	7	0	0	7	0	0
10	25601799	.	T	C	5	2	7	0	0	7	0	0
10	25601838	.	G	A	1	4	5	0	0	5	0	0
10	25615597	.	A	G	3	2	5	0	0	5	0	0
10	25694637	.	G	A	24	17	41	0	2	43	0	0
10	25694844	.	G	A	21	30	51	1	2	54	0	0
10	25694848	.	C	T	23	30	53	1	2	56	0	0
10	25701659	.	G	C	12	8	20	0	1	21	0	0
10	25701781	.	T	C	7	3	10	2	4	16	0	0
10	25701928	.	T	C	4	1	5	0	4	9	0	0
10	25704345	.	C	T	6	12	18	0	1	19	0	0
10	25706228	.	G	A	3	3	6	0	0	6	0	0
10	25709379	.	A	G	1	3	4	0	0	4	0	0
10	25712724	.	C	T	0	2	2	0	3	5	0	0
10	25831924	.	A	G	5	5	10	0	0	10	0	0
10	26126921	.	A	T	3	2	5	0	0	5	0	0
10	26225398	.	T	C	4	0	4	0	3	7	0	0
10	26225479	.	T	C	3	0	3	0	3	6	0	0
10	26269728	.	G	A	3	5	8	0	0	8	0	0
10	26269842	.	T	C	5	2	7	0	0	7	0	0
10	26270847	.	T	C	10	0	10	0	6	16	0	0
10	26271018	.	G	C	6	0	6	0	5	11	0	0
10	26271357	.	C	A	1	4	5	0	0	5	0	0
10	26271522	.	T	C	8	7	15	0	0	15	0	0
10	26271672	.	G	C	2	3	5	0	0	5	0	0
10	26272338	.	C	G	0	3	3	0	3	6	0	0
10	26272842	.	G	A	0	3	3	0	1	4	0	0
10	26272941	.	A	T	1	2	3	0	0	3	0	0
10	26505202	.	T	C	2	0	2	0	2	4	0	0
10	26505211	.	G	T	2	2	4	0	0	4	0	0
10	26508775	.	A	C	1	0	1	0	2	3	0	0
10	26517569	.	G	A	1	3	4	0	2	6	0	0
10	26540432	.	A	G	4	3	7	0	6	13	0	0
10	26541145	.	G	A	12	9	21	0	0	21	0	0
10	26551191	.	T	A	18	8	26	0	1	27	0	0
10	26551492	.	A	G	13	18	31	0	8	39	0	0
10	26558704	.	C	T	30	13	43	1	1	45	0	0
10	26560166	.	T	C	21	16	37	0	3	40	0	0
10	26560366	.	G	A	6	6	12	1	29	42	0	0
10	26560392	.	C	A	28	16	44	1	1	46	0	0
10	26565704	.	T	C	30	26	56	0	3	59	0	0
10	26565760	.	G	A	7	24	31	0	28	59	0	0
10	26566054	.	G	C	3	22	25	0	16	41	0	0
10	26566267	.	T	C	26	23	49	0	1	51	1	0
10	26566354	.	A	T	15	15	30	0	1	31	0	0
10	26566369	.	A	T	12	14	26	0	0	26	0	0
10	26566749	.	G	A	18	4	22	0	1	23	0	0
10	26566785	.	T	A	14	10	24	0	0	24	0	0
10	26566787	.	A	T	15	10	25	0	0	25	0	0
10	26566855	.	A	G	21	0	21	0	15	36	0	0
10	26566970	.	T	G	22	0	22	0	20	42	0	0
10	26567127	.	G	A	1	21	22	0	14	36	0	0
10	26567238	.	A	G	16	24	40	0	1	41	0	0
10	26567337	.	C	T	17	26	43	0	1	45	1	0
10	26567376	.	C	G	18	26	44	0	1	45	0	0
10	26567500	.	C	T	23	18	41	0	4	45	0	0
10	26567656	.	G	C	21	14	35	0	3	38	0	0
10	26567889	.	T	A	18	5	23	0	0	23	0	0
10	26567958	.	T	A	16	11	27	0	0	27	0	0
10	26568154	.	A	T	18	16	34	0	1	35	0	0
10	26568166	.	C	T	15	13	28	0	1	29	0	0
10	26568201	.	A	G	8	7	15	0	1	16	0	0
10	26568239	.	C	T	8	5	13	0	0	13	0	0
10	26568429	.	A	C	25	17	42	0	1	43	0	0
10	26568498	.	T	C	25	28	53	0	0	53	0	0
10	26568523	.	G	T	22	27	49	0	2	51	0	0
10	26568726	.	A	G	15	32	47	0	3	50	0	0
10	26569098	.	A	G	20	1	21	0	21	42	0	0
10	26569099	.	A	C	19	21	40	0	2	42	0	0
10	26569248	.	C	A	18	13	31	0	0	31	0	0
10	26574004	.	T	C	1	6	7	0	0	7	0	0
10	26583978	.	C	G	10	10	20	0	0	20	0	0
10	26589072	.	C	T	20	16	36	0	0	36	0	0
10	26596020	.	T	A	23	22	45	0	3	48	0	0
10	26596075	.	C	T	20	23	43	0	1	44	0	0
10	26596080	.	T	C	17	21	38	0	2	40	0	0
10	26596268	.	A	G	3	5	8	0	1	9	0	0
10	26656135	.	A	C	10	8	18	0	4	22	0	0
10	26656240	.	C	T	5	12	17	0	1	18	0	0
10	26656500	.	G	A	11	7	18	0	0	18	0	0
10	26656527	.	A	G	13	7	20	0	0	20	0	0
10	26659245	.	C	T	12	15	27	0	1	28	0	0
10	26661469	.	T	C	14	18	32	0	0	32	0	0
10	26662046	.	G	A	18	14	32	0	2	34	0	0
10	26666823	.	C	T	20	18	38	1	0	39	0	0
10	26666839	.	T	C	18	18	36	1	1	38	0	0
10	26692303	.	C	T	3	2	5	0	0	5	0	0
10	26692309	.	A	G	3	0	3	0	4	7	0	0
10	26717156	.	T	A	8	17	25	0	0	25	0	0
10	26717246	.	G	A	12	13	25	0	0	25	0	0
10	26717740	.	A	G	12	14	26	0	3	29	0	0
10	26717963	.	G	A	15	13	28	1	0	29	0	0
10	26729687	.	T	C	13	11	24	0	0	24	0	0
10	26744012	.	A	G	7	6	13	0	0	13	0	0
10	26753156	.	G	A	4	3	7	0	1	8	0	0
10	26753173	.	C	T	1	1	2	0	4	6	0	0
10	26753483	.	C	T	2	2	4	0	0	4	0	0
10	26762841	.	C	A	7	11	18	0	1	19	0	0
10	26765526	.	T	C	9	6	15	0	2	17	0	0
10	26766092	.	T	A	1	3	4	0	0	4	0	0
10	26766154	.	C	T	7	4	11	0	0	11	0	0
10	26774709	.	T	G	9	6	15	0	0	15	0	0
10	26774943	.	G	A	3	9	12	0	0	12	0	0
10	26777572	.	A	G	2	3	5	0	0	5	0	0
10	26780983	.	T	C	6	3	9	0	0	9	0	0
10	26781140	.	T	C	4	3	7	0	0	7	0	0
10	26781419	.	T	C	4	1	5	0	5	10	0	0
10	26783968	.	C	T	3	3	6	0	0	6	0	0
10	26790603	.	G	A	3	6	9	0	0	9	0	0
10	26791027	.	G	A	4	3	7	0	1	8	0	0
10	26835004	.	G	A	5	9	14	0	1	15	0	0
10	26835024	.	T	C	5	7	12	0	0	12	0	0
10	26835066	.	A	C	3	11	14	0	1	15	0	0
10	26835081	.	T	A	3	6	9	0	0	9	0	0
10	26835172	.	T	C	1	4	5	1	0	6	0	0
10	26835299	.	G	A	6	13	19	0	0	19	0	0
10	26835595	.	G	A	10	10	20	0	5	25	0	0
10	26836990	.	G	A	10	22	32	0	1	33	0	0
10	26907402	.	T	A	2	2	4	0	0	4	0	0
10	26914186	.	C	T	2	3	5	0	0	5	0	0
10	26922450	.	T	C	3	3	6	0	0	6	0	0
10	26925040	.	G	A	0	2	2	0	4	6	0	0
10	26929291	.	A	T	18	16	34	0	1	35	0	0
10	26929459	.	C	T	20	12	32	0	1	33	0	0
10	26930061	.	C	A	14	17	31	0	2	33	0	0
10	26932632	.	C	T	12	21	33	0	0	33	0	0
10	26958150	.	G	C	8	5	13	0	0	13	0	0
10	26959424	.	T	C	4	2	6	0	1	7	0	0
10	26959662	.	T	G	3	4	7	0	2	9	0	0
10	26959894	.	C	A	1	2	3	0	0	3	0	0
10	26959992	.	G	T	7	3	10	0	0	10	0	0
10	26960212	.	A	T	1	7	8	0	0	8	0	0
10	26960281	.	A	G	5	4	9	0	0	9	0	0
10	26960333	.	T	A	2	2	4	0	1	5	0	0
10	26962406	.	T	C	1	2	3	0	0	3	0	0
10	26963839	.	T	A	2	2	4	0	0	4	0	0
10	26965668	.	C	G	2	2	4	0	0	4	0	0
10	26966130	.	T	C	3	3	6	0	0	6	0	0
10	26966316	.	A	G	3	6	9	0	0	9	0	0
10	26971782	.	C	T	2	7	9	0	1	11	1	0
10	26972064	.	T	C	10	12	22	0	0	22	0	0
10	26972152	.	T	C	11	8	19	0	0	19	0	0
10	26972321	.	T	A	3	5	8	0	1	9	0	0
10	26972349	.	T	C	2	8	10	0	0	10	0	0
10	26972364	.	T	C	2	6	8	0	2	10	0	0
10	26972409	.	G	A	3	7	10	0	0	10	0	0
10	26972429	.	A	T	2	5	7	0	1	8	0	0
10	26972877	.	C	G	5	3	8	0	0	8	0	0
10	26973454	.	T	G	2	0	2	0	5	7	0	0
10	26974414	.	T	C	2	3	5	0	1	6	0	0
10	26976990	.	G	A	1	7	8	0	0	8	0	0
10	26982532	.	G	T	2	2	4	0	0	4	0	0
10	26987399	.	T	C	17	0	17	0	13	30	0	0
10	26989818	.	A	T	14	10	24	0	3	27	0	0
10	26989843	.	A	T	11	9	20	0	0	20	0	0
10	26990173	.	C	T	9	7	16	0	0	16	0	0
10	26990287	.	C	T	11	8	19	0	0	19	0	0
10	26990333	.	G	C	4	7	11	0	1	12	0	0
10	26991487	.	T	C	11	18	29	0	2	31	0	0
10	26991514	.	C	T	6	20	26	0	0	26	0	0
10	26991556	.	C	T	12	14	26	0	1	27	0	0
10	26991785	.	C	G	6	3	9	0	0	9	0	0
10	26997147	.	C	A	13	8	21	0	0	21	0	0
10	26997218	.	G	A	9	11	20	0	0	20	0	0
10	26997222	.	A	T	9	9	18	0	2	20	0	0
10	26999165	.	T	C	17	1	18	0	13	31	0	0
10	27006367	.	A	G	14	11	25	0	3	28	0	0
10	27006386	.	G	A	15	15	30	0	2	32	0	0
10	27006413	.	A	C	12	16	28	0	1	29	0	0
10	27006447	.	T	C	14	9	23	0	0	23	0	0
10	27006490	.	A	G	15	14	29	0	0	29	0	0
10	27006721	.	T	C	21	28	49	0	3	52	0	0
10	28470322	.	A	G	2	2	4	0	0	4	0	0
10	28483585	.	T	C	2	4	6	0	0	6	0	0
10	28483631	.	C	T	0	4	4	0	3	7	0	0
10	28483781	.	G	T	4	3	7	0	0	7	0	0
10	28483869	.	T	C	2	3	5	0	0	5	0	0
10	28696336	.	C	A	5	3	8	0	0	8	0	0
10	28724220	.	G	A	5	4	9	0	1	10	0	0
10	28727461	.	C	T	6	4	10	0	0	10	0	0
10	28729808	.	G	C	1	2	3	0	0	3	0	0
10	28730128	.	C	T	6	2	8	0	0	8	0	0
10	28730216	.	C	T	5	4	9	0	1	10	0	0
10	28730249	.	C	T	3	4	7	0	1	8	0	0
10	28730345	.	T	A	6	8	14	0	1	15	0	0
10	28730446	.	A	C	9	11	20	0	1	21	0	0
10	28730880	.	T	A	4	12	16	0	1	17	0	0
10	28730913	.	G	A	18	4	22	0	1	23	0	0
10	28731001	.	C	T	10	14	24	0	0	24	0	0
10	28731072	.	C	T	11	12	23	0	1	24	0	0
10	28731155	.	A	T	10	9	19	0	2	21	0	0
10	28731289	.	T	C	6	10	16	0	2	18	0	0
10	28731333	.	C	T	4	7	11	0	1	12	0	0
10	28731372	.	G	A	0	6	6	0	7	13	0	0
10	28732003	.	C	A	16	19	35	0	1	36	0	0
10	28732104	.	T	C	16	6	22	0	1	23	0	0
10	28732601	.	C	T	0	16	16	0	16	32	0	0
10	28732785	.	T	C	21	13	34	0	4	38	0	0
10	28733067	.	G	T	16	18	34	0	1	35	0	0
10	28743800	.	T	A	11	9	20	0	0	21	1	0
10	28745833	.	G	A	8	7	15	0	0	15	0	0
10	28748741	.	C	T	0	13	13	0	5	18	0	0
10	28749053	.	A	G	9	8	17	0	0	17	0	0
10	28761022	.	C	T	4	4	8	0	0	8	0	0
10	28761049	.	C	T	6	3	9	0	1	10	0	0
10	28761094	.	G	A	4	3	7	0	4	11	0	0
10	28761100	.	G	A	3	8	11	0	1	12	0	0
10	28835701	.	A	T	6	5	11	0	0	11	0	0
10	29166445	.	A	G	9	5	14	0	0	14	0	0
10	29185800	.	C	G	20	1	21	0	16	37	0	0
10	29185863	.	T	A	15	17	32	0	0	32	0	0
10	29187908	.	C	T	11	11	22	1	2	25	0	0
10	29201671	.	C	T	13	7	20	0	0	20	0	0
10	29205655	.	A	T	16	15	31	0	1	32	0	0
10	29205679	.	G	T	3	15	18	0	15	33	0	0
10	29224364	.	C	T	3	10	13	0	4	17	0	0
10	29224484	.	G	A	11	14	25	0	1	26	0	0
10	29224598	.	A	T	19	24	43	0	0	43	0	0
10	29224651	.	C	A	23	12	35	0	2	37	0	0
10	29225032	.	A	G	8	1	9	0	12	21	0	0
10	29266376	.	C	T	21	24	45	0	1	46	0	0
10	29268551	.	T	A	3	2	5	0	0	5	0	0
10	29268669	.	T	C	3	2	5	1	1	7	0	0
10	29270092	.	A	C	3	4	7	0	0	7	0	0
10	29270225	.	C	T	7	4	11	0	0	11	0	0
10	29271915	.	C	T	11	7	18	0	0	18	0	0
10	29271980	.	A	C	6	0	6	0	9	15	0	0
10	29272693	.	C	T	10	7	17	0	1	18	0	0
10	29561191	.	A	G	8	8	16	0	0	16	0	0
10	29575542	.	C	T	5	5	10	0	0	10	0	0
10	29578478	.	C	T	12	7	19	0	2	21	0	0
10	29578738	.	C	T	5	5	10	0	1	11	0	0
10	29578756	.	G	T	4	6	10	0	2	12	0	0
10	29678313	.	G	A	7	10	17	0	1	18	0	0
10	29701347	.	C	T	4	9	13	0	1	14	0	0
10	29701405	.	G	A	1	13	14	0	3	17	0	0
10	29702103	.	G	A	9	9	18	0	0	18	0	0
10	29708080	.	C	T	11	14	25	0	0	25	0	0
10	29708095	.	T	A	14	17	31	0	1	32	0	0
10	29708154	.	A	G	12	0	12	0	15	27	0	0
10	29736255	.	G	C	2	8	10	0	0	10	0	0
10	29736314	.	C	T	0	7	7	0	3	10	0	0
10	29736736	.	T	C	14	1	15	0	11	26	0	0
10	29736895	.	T	A	12	7	19	0	0	19	0	0
10	29738555	.	C	T	4	8	12	0	1	13	0	0
10	29742656	.	C	T	13	4	17	0	0	17	0	0
10	29742795	.	T	C	10	9	19	0	0	19	0	0
10	29751221	.	T	C	3	0	3	0	5	8	0	0
10	29751638	.	G	T	12	19	31	0	0	31	0	0
10	29754464	.	G	T	9	13	22	0	0	22	0	0
10	29759186	.	A	G	10	6	16	0	3	19	0	0
10	29761405	.	C	T	6	6	12	0	0	12	0	0
10	29763146	.	A	G	9	6	15	0	0	15	0	0
10	29767470	.	G	A	3	2	5	0	0	5	0	0
10	29767566	.	C	A	1	3	4	0	1	5	0	0
10	29768405	.	G	T	6	2	8	0	0	8	0	0
10	29770277	.	C	T	1	5	6	0	0	6	0	0
10	29772167	.	A	G	1	6	7	0	0	7	0	0
10	29778375	.	A	G	3	0	3	0	4	7	0	0
10	29778396	.	C	T	2	2	4	0	0	4	0	0
10	29785682	.	C	A	6	7	13	0	3	16	0	0
10	29820495	.	G	A	4	6	10	0	0	10	0	0
10	29823484	.	G	A	9	9	18	0	0	18	0	0
10	29828696	.	T	G	4	10	14	0	0	14	0	0
10	29831556	.	G	A	4	2	6	0	0	6	0	0
10	29853684	.	A	G	7	4	11	4	14	29	0	0
10	29892382	.	C	T	3	2	5	0	0	5	0	0
10	30540800	.	C	T	1	6	7	0	0	7	0	0
10	30576004	.	T	C	7	10	17	0	0	17	0	0
10	30618121	.	C	T	3	6	9	0	0	9	0	0
10	30623408	.	G	A	3	6	9	0	1	10	0	0
10	30627092	.	A	T	6	5	11	0	0	11	0	0
10	30785055	.	T	G	5	3	8	0	0	8	0	0
10	31020810	.	A	G	5	6	11	0	0	11	0	0
10	31021450	.	C	T	6	7	13	0	0	13	0	0
10	31021553	.	G	A	9	13	22	0	0	22	0	0
10	31021611	.	C	T	12	11	23	0	1	24	0	0
10	31021676	.	G	A	14	10	24	0	0	24	0	0
10	31021811	.	C	T	1	14	15	0	17	32	0	0
10	31023824	.	C	T	16	6	22	0	1	23	0	0
10	31031543	.	C	T	1	12	13	0	3	16	0	0
10	31032043	.	T	C	6	9	15	0	0	15	0	0
10	31034999	.	C	T	1	9	10	0	7	17	0	0
10	31035030	.	G	A	9	7	16	0	0	16	0	0
10	31035129	.	C	T	9	9	18	0	0	18	0	0
10	31040778	.	T	C	1	1	2	0	7	9	0	0
10	31040834	.	G	A	1	4	5	0	0	5	0	0
10	31276808	.	T	C	2	2	4	0	1	5	0	0
10	31280293	.	G	A	1	2	3	0	0	3	0	0
10	31306727	.	C	T	3	15	18	0	18	36	0	0
10	31306956	.	C	G	1	12	13	0	17	30	0	0
10	31315631	.	C	T	0	18	18	0	10	28	0	0
10	31317976	.	T	C	10	18	28	0	0	28	0	0
10	31317978	.	A	G	11	17	28	0	1	29	0	0
10	31325248	.	C	A	11	7	18	0	0	18	0	0
10	31326235	.	T	C	4	0	4	0	8	12	0	0
10	31328373	.	A	T	2	12	14	0	1	15	0	0
10	31328531	.	C	T	8	8	16	0	1	17	0	0
10	31328609	.	G	A	3	5	8	0	0	8	0	0
10	31328612	.	A	C	5	3	8	0	0	8	0	0
10	31337822	.	G	A	3	7	10	0	0	10	0	0
10	31354096	.	A	G	2	7	9	0	0	9	0	0
10	31624750	.	G	A	3	3	6	0	1	7	0	0
10	31628325	.	A	C	5	6	11	0	0	11	0	0
10	31628397	.	C	T	4	6	10	0	0	10	0	0
10	31628406	.	C	T	3	7	10	0	0	10	0	0
10	31632313	.	G	C	6	6	12	0	0	12	0	0
10	31632691	.	G	A	5	5	10	0	0	10	0	0
10	31632758	.	A	T	4	6	10	0	0	10	0	0
10	31632829	.	A	G	5	8	13	0	0	13	0	0
10	31632838	.	C	T	7	5	12	0	0	12	0	0
10	31633640	.	G	A	2	8	10	0	0	10	0	0
10	31725404	.	C	T	1	4	5	0	0	5	0	0
10	31725473	.	G	A	0	2	2	0	1	3	0	0
10	31725697	.	C	T	6	5	11	0	0	11	0	0
10	31738616	.	A	G	9	6	15	0	1	16	0	0
10	31739346	.	G	T	36	29	65	0	1	66	0	0
10	31757307	.	C	T	29	24	53	0	3	56	0	0
10	31772112	.	A	G	22	28	50	1	1	52	0	0
10	31800313	.	A	G	9	11	20	0	0	20	0	0
10	31803651	.	G	A	4	4	8	0	0	8	0	0
10	31805648	.	C	T	4	5	9	0	0	9	0	0
10	31805736	.	G	A	2	2	4	0	0	4	0	0
10	31951383	.	G	A	2	6	8	0	0	8	0	0
10	31953627	.	T	C	1	3	4	0	0	4	0	0
10	31953744	.	C	A	4	3	7	0	1	8	0	0
10	32036978	.	G	A	1	1	2	0	1	3	0	0
10	32037208	.	T	A	1	3	4	0	0	4	0	0
10	32037418	.	C	T	1	2	3	0	0	3	0	0
10	32037428	.	T	C	2	3	5	0	0	5	0	0
10	32062657	.	G	A	1	2	3	0	0	3	0	0
10	32063266	.	T	A	2	2	4	0	1	5	0	0
10	32063275	.	A	G	3	0	3	0	2	5	0	0
10	32063401	.	C	T	3	3	6	0	0	6	0	0
10	32063752	.	G	A	4	4	8	0	0	8	0	0
10	32063809	.	A	G	2	5	7	0	1	8	0	0
10	32064138	.	C	T	6	4	10	0	0	10	0	0
10	32071029	.	G	A	1	4	5	0	0	5	0	0
10	32106223	.	G	A	0	2	2	0	1	3	0	0
10	32122465	.	A	T	3	2	5	0	0	5	0	0
10	32561338	.	G	A	3	4	7	0	0	7	0	0
10	32561392	.	A	T	11	5	16	0	1	17	0	0
10	32561398	.	G	A	1	6	7	0	13	20	0	0
10	32561427	.	A	C	18	6	24	0	0	24	0	0
10	32561437	.	T	A	18	5	23	0	0	23	0	0
10	32561615	.	C	G	12	7	19	0	0	19	0	0
10	32562267	.	C	T	23	15	38	0	0	38	0	0
10	32577621	.	G	A	17	10	27	1	1	29	0	0
10	32581221	.	G	A	9	14	23	0	0	23	0	0
10	32600809	.	A	G	5	0	5	1	7	13	0	0
10	32600810	.	T	C	6	6	12	1	0	13	0	0
10	32600927	.	C	T	32	16	48	0	2	50	0	0
10	32648649	.	C	T	2	2	4	0	0	4	0	0
10	32648799	.	C	T	2	3	5	0	0	5	0	0
10	32657586	.	A	G	5	2	7	0	0	7	0	0
10	32657591	.	C	A	2	5	7	0	0	7	0	0
10	32657893	.	G	A	13	17	30	0	1	31	0	0
10	32657980	.	A	G	7	12	19	0	4	23	0	0
10	32660658	.	A	C	4	2	6	0	1	7	0	0
10	32780271	.	A	C	10	5	15	0	2	17	0	0
10	32783974	.	A	C	10	8	18	0	0	18	0	0
10	32787910	.	C	T	6	2	8	0	0	8	0	0
10	32788457	.	A	T	5	7	12	0	1	13	0	0
10	32788504	.	A	T	3	6	9	0	0	9	0	0
10	32788633	.	T	C	11	7	18	0	0	18	0	0
10	32788663	.	T	C	11	10	21	0	1	22	0	0
10	32809986	.	G	C	21	10	31	0	0	31	0	0
10	32810279	.	T	A	13	5	18	0	1	19	0	0
10	32810340	.	A	T	18	10	28	0	0	28	0	0
10	32810579	.	T	C	3	0	3	0	6	9	0	0
10	32810593	.	A	T	2	2	4	0	0	4	0	0
10	32811010	.	C	T	0	3	3	0	8	11	0	0
10	32811102	.	T	A	10	8	18	0	0	18	0	0
10	32817924	.	C	A	2	5	7	0	9	16	0	0
10	32820412	.	A	G	10	4	14	0	0	14	0	0
10	32820426	.	T	A	10	2	12	0	2	14	0	0
10	32820451	.	G	T	11	7	18	0	1	19	0	0
10	32820577	.	T	C	11	0	11	0	7	18	0	0
10	32823131	.	C	T	8	7	15	0	0	15	0	0
10	32823146	.	G	A	11	6	17	0	1	18	0	0
10	32831269	.	G	A	10	11	21	0	1	22	0	0
10	32831671	.	T	C	10	0	10	0	6	16	0	0
10	32831683	.	C	G	7	7	14	0	0	14	0	0
10	32840835	.	C	T	1	8	9	0	7	16	0	0
10	32843827	.	C	G	2	5	7	0	0	7	0	0
10	32851687	.	C	G	5	6	11	0	1	12	0	0
10	32856993	.	C	A	4	1	5	0	0	5	0	0
10	32856999	.	T	A	5	2	7	0	0	7	0	0
10	32857034	.	C	G	7	3	10	0	2	12	0	0
10	32857329	.	T	C	26	0	26	0	5	31	0	0
10	32857557	.	T	C	14	12	26	0	0	26	0	0
10	32857738	.	A	G	13	7	20	0	0	20	0	0
10	32857746	.	A	T	8	10	18	0	1	19	0	0
10	32857898	.	C	T	6	10	16	0	2	19	1	0
10	32857948	.	T	G	7	6	13	0	3	16	0	0
10	32858020	.	C	T	16	6	22	1	0	23	0	0
10	32858023	.	C	T	6	16	22	1	0	23	0	0
10	32858107	.	A	G	15	9	24	1	2	27	0	0
10	32858132	.	T	C	14	0	14	0	15	29	0	0
10	32858158	.	C	G	11	16	27	1	2	30	0	0
10	32858215	.	T	A	13	15	28	0	1	29	0	0
10	32858361	.	T	C	16	10	26	0	2	28	0	0
10	32858425	.	G	C	11	20	31	1	1	33	0	0
10	32858607	.	C	T	20	10	30	0	1	31	0	0
10	32858612	.	T	A	11	18	29	0	0	29	0	0
10	32858642	.	G	C	9	17	26	0	1	27	0	0
10	32861106	.	G	A	16	16	32	0	1	33	0	0
10	32861118	.	T	G	18	14	32	0	2	34	0	0
10	32874849	.	G	A	13	14	27	0	4	31	0	0
10	32881787	.	C	T	3	14	17	0	15	32	0	0
10	32881823	.	G	A	18	12	30	0	1	31	0	0
10	32881884	.	C	T	15	11	26	0	2	28	0	0
10	32881904	.	A	G	14	9	23	0	1	24	0	0
10	32882022	.	A	G	4	6	10	0	0	10	0	0
10	32882056	.	G	A	5	6	11	0	0	11	0	0
10	32882080	.	A	T	7	11	18	0	1	19	0	0
10	32882156	.	T	G	23	14	37	0	1	38	0	0
10	32882495	.	T	C	4	8	12	0	0	12	0	0
10	32882515	.	C	T	5	8	13	0	0	13	0	0
10	32882683	.	G	T	12	15	27	0	0	27	0	0
10	32882686	.	A	T	12	14	26	0	0	26	0	0
10	32882732	.	C	A	14	10	24	0	2	26	0	0
10	32882977	.	C	A	1	10	11	0	13	24	0	0
10	32890201	.	C	T	0	8	8	0	17	25	0	0
10	32899276	.	T	A	10	10	20	0	0	20	0	0
10	32899807	.	T	C	3	3	6	4	0	10	0	0
10	32899986	.	T	G	10	13	23	0	0	23	0	0
10	32899988	.	T	C	8	0	8	0	15	23	0	0
10	32900021	.	T	C	10	10	20	0	0	20	0	0
10	32900469	.	T	G	6	7	13	0	0	13	0	0
10	32900642	.	A	T	7	12	19	0	0	19	0	0
10	32901915	.	A	T	9	5	14	0	0	15	1	0
10	32902159	.	T	C	3	0	3	0	3	6	0	0
10	32902481	.	G	C	4	2	6	0	0	6	0	0
10	32903589	.	C	T	2	8	10	0	8	18	0	0
10	32907193	.	G	T	1	2	3	1	3	7	0	0
10	32912847	.	T	G	5	2	7	0	0	7	0	0
10	32912883	.	C	G	3	4	7	0	0	7	0	0
10	32920415	.	A	G	3	4	7	0	0	7	0	0
10	32920529	.	C	A	0	3	3	0	4	7	0	0
10	32920574	.	G	T	6	2	8	0	0	8	0	0
10	32939399	.	C	T	0	2	2	0	4	6	0	0
10	32939516	.	C	T	2	2	4	0	0	4	0	0
10	32944113	.	A	T	3	5	8	0	0	8	0	0
10	32944156	.	A	C	2	2	4	0	0	4	0	0
10	32950508	.	C	T	0	3	3	0	3	6	0	0
10	32963501	.	C	T	1	5	6	0	2	8	0	0
10	32963546	.	A	G	4	3	7	0	0	7	0	0
10	32963555	.	T	C	2	3	5	0	1	6	0	0
10	32963722	.	C	A	4	3	7	0	0	7	0	0
10	32963924	.	G	A	6	3	9	0	0	9	0	0
10	32964089	.	C	T	1	3	4	0	2	6	0	0
10	33244529	.	C	T	0	3	3	0	1	4	0	0
10	33244534	.	T	C	1	3	4	0	0	4	0	0
10	33244931	.	A	G	1	2	3	0	0	3	0	0
10	33255113	.	G	A	9	4	13	0	1	14	0	0
10	33260487	.	G	T	3	2	5	0	0	5	0	0
10	33260681	.	G	T	3	4	7	0	0	7	0	0
10	33260682	.	G	A	4	3	7	0	0	7	0	0
10	33261404	.	C	T	5	4	9	0	0	9	0	0
10	33265240	.	T	C	2	0	2	0	4	6	0	0
10	33314237	.	T	A	1	2	3	0	0	3	0	0
10	33325241	.	T	C	0	2	2	0	1	3	0	0
10	33340827	.	T	C	1	2	3	0	0	3	0	0
10	33340828	.	G	T	1	2	3	0	0	3	0	0
10	33369860	.	T	A	7	6	13	0	0	13	0	0
10	33369973	.	C	A	16	13	29	0	1	30	0	0
10	33373568	.	C	G	2	7	9	0	10	19	0	0
10	33375478	.	C	T	11	13	24	0	0	24	0	0
10	33385363	.	G	A	31	14	45	0	7	52	0	0
10	33389469	.	A	G	29	0	29	0	20	49	0	0
10	33391844	.	G	A	25	31	56	0	4	60	0	0
10	33391930	.	G	A	21	24	45	0	6	51	0	0
10	33392071	.	T	C	15	17	32	1	0	33	0	0
10	33392103	.	G	A	10	22	32	1	0	33	0	0
10	33392199	.	A	G	7	17	24	0	2	26	0	0
10	33392263	.	A	G	14	19	33	3	0	36	0	0
10	33392264	.	C	T	20	13	33	3	0	36	0	0
10	33392370	.	T	C	23	13	36	1	2	39	0	0
10	33392805	.	C	A	8	3	11	0	0	11	0	0
10	33392815	.	C	T	7	2	9	0	0	9	0	0
10	33403149	.	A	T	2	6	8	0	0	8	0	0
10	33540054	.	G	C	1	2	3	1	1	5	0	0
10	33573861	.	A	T	3	2	5	0	1	6	0	0
10	33573866	.	A	T	4	4	8	0	0	8	0	0
10	33574250	.	T	G	4	0	4	0	6	10	0	0
10	33574332	.	A	T	6	3	9	0	0	9	0	0
10	33576423	.	T	C	8	6	14	0	0	14	0	0
10	33576509	.	T	C	7	3	10	0	0	10	0	0
10	33576518	.	T	C	6	4	10	0	0	10	0	0
10	33576551	.	T	C	7	2	9	0	0	9	0	0
10	33578719	.	A	T	2	5	7	0	0	7	0	0
10	33578816	.	T	A	7	3	10	0	1	11	0	0
10	33615008	.	G	A	6	2	8	0	0	8	0	0
10	33618584	.	G	A	2	1	3	0	2	5	0	0
10	33626437	.	A	C	1	3	4	0	0	4	0	0
10	33626475	.	A	G	4	2	6	0	1	7	0	0
10	33646917	.	G	T	0	2	2	0	1	3	0	0
10	33646957	.	G	A	2	2	4	0	0	4	0	0
10	33659230	.	C	T	3	2	5	0	0	5	0	0
10	33861127	.	C	T	2	2	4	0	0	4	0	0
10	33863568	.	G	A	2	3	5	0	0	5	0	0
10	33866987	.	T	A	10	7	17	0	1	18	0	0
10	33867032	.	G	A	6	4	10	0	2	12	0	0
10	33867365	.	C	T	6	4	10	0	2	12	0	0
10	33867394	.	G	A	7	5	12	0	0	12	0	0
10	33908183	.	C	A	3	3	6	0	0	6	0	0
10	33921928	.	A	G	2	3	5	0	0	5	0	0
10	33924255	.	G	A	1	4	5	0	2	7	0	0
10	33930351	.	T	C	8	3	11	0	0	11	0	0
10	33930780	.	T	G	4	5	9	0	0	9	0	0
10	33948176	.	C	T	2	6	8	0	0	8	0	0
10	33956690	.	G	A	1	2	3	0	6	9	0	0
10	33957780	.	C	T	10	7	17	0	1	18	0	0
10	33958750	.	T	C	10	3	13	0	0	13	0	0
10	33958813	.	T	C	4	4	8	0	0	8	0	0
10	33960943	.	C	T	10	13	23	0	0	23	0	0
10	33961048	.	G	A	0	14	14	0	6	20	0	0
10	33961093	.	A	T	3	7	10	0	3	13	0	0
10	33982165	.	G	A	20	20	40	0	0	40	0	0
10	33983870	.	A	G	25	12	37	0	1	38	0	0
10	33989820	.	G	A	16	16	32	1	0	33	0	0
10	33994424	.	A	G	17	21	38	0	1	39	0	0
10	33994445	.	A	G	16	19	35	0	2	37	0	0
10	33994475	.	C	T	12	27	39	0	0	39	0	0
10	34025077	.	T	C	5	5	10	0	0	10	0	0
10	34025104	.	C	T	7	5	12	0	0	12	0	0
10	34378110	.	T	G	7	0	7	0	5	12	0	0
10	34383783	.	A	T	4	5	9	0	0	9	0	0
10	34383843	.	G	A	3	6	9	0	0	9	0	0
10	34383858	.	A	G	4	5	9	0	0	9	0	0
10	34388882	.	T	G	5	3	8	0	0	8	0	0
10	34388888	.	G	A	5	3	8	0	0	8	0	0
10	34394653	.	G	A	5	7	12	0	1	13	0	0
10	34396026	.	G	A	6	5	11	0	1	12	0	0
10	34402980	.	T	A	3	3	6	0	1	7	0	0
10	34403615	.	A	G	4	12	16	0	0	16	0	0
10	34403668	.	A	T	10	15	25	0	1	26	0	0
10	34403980	.	A	G	12	0	12	0	3	15	0	0
10	34404015	.	G	A	8	6	14	0	1	15	0	0
10	34404028	.	T	G	3	6	9	0	1	10	0	0
10	34404154	.	T	C	4	2	6	0	0	6	0	0
10	34404593	.	T	C	5	3	8	0	0	8	0	0
10	34588818	.	G	T	0	3	3	0	5	8	0	0
10	34606549	.	T	C	5	4	9	0	0	9	0	0
10	34657676	.	C	T	8	5	13	0	0	13	0	0
10	34661857	.	A	G	5	6	11	0	1	12	0	0
10	34662184	.	C	T	2	4	6	0	0	6	0	0
10	34662334	.	T	C	2	4	6	0	0	6	0	0
10	34662349	.	C	T	6	2	8	0	0	8	0	0
10	34662437	.	C	T	3	2	5	0	0	5	0	0
10	34662481	.	A	T	2	5	7	0	0	7	0	0
10	34664906	.	G	A	5	6	11	0	0	11	0	0
10	34665053	.	G	A	1	4	5	0	8	13	0	0
10	34673597	.	C	T	6	8	14	0	1	15	0	0
10	34676338	.	C	T	3	5	8	0	1	9	0	0
10	34677614	.	C	A	5	2	7	0	2	9	0	0
10	34699238	.	C	T	5	10	15	0	0	15	0	0
10	34709708	.	G	C	14	7	21	0	0	21	0	0
10	34709940	.	C	T	11	13	24	0	0	24	0	0
10	34714789	.	C	T	9	17	26	0	1	27	0	0
10	34724906	.	C	T	15	9	24	0	0	24	0	0
10	34729552	.	G	A	21	14	35	0	3	38	0	0
10	34729693	.	C	T	24	9	33	0	1	34	0	0
10	34733566	.	A	G	33	15	48	0	1	49	0	0
10	34733661	.	C	T	16	19	35	0	5	40	0	0
10	34733883	.	A	T	23	19	42	0	5	47	0	0
10	34734714	.	A	T	31	24	55	0	3	58	0	0
10	34734743	.	T	G	25	21	46	0	2	48	0	0
10	34734785	.	G	T	13	11	24	4	1	29	0	0
10	34737919	.	T	C	23	18	41	0	3	44	0	0
10	34738213	.	C	T	2	23	25	0	35	60	0	0
10	34754660	.	C	T	23	14	37	0	1	38	0	0
10	34768418	.	G	A	3	2	5	0	0	5	0	0
10	34813299	.	T	C	6	10	16	0	1	17	0	0
10	34867466	.	C	T	8	3	11	0	0	11	0	0
10	34870579	.	C	T	4	10	14	0	0	14	0	0
10	34913407	.	G	A	1	4	5	0	0	5	0	0
10	34961309	.	A	G	15	9	24	0	3	27	0	0
10	34961311	.	T	C	15	11	26	0	0	26	0	0
10	34961403	.	T	C	6	5	11	1	0	12	0	0
10	34961405	.	C	T	5	5	10	1	0	11	0	0
10	34961480	.	C	A	4	3	7	0	0	7	0	0
10	34961520	.	T	C	7	4	11	0	0	11	0	0
10	34961669	.	A	G	7	11	18	0	1	19	0	0
10	34962155	.	G	A	3	2	5	0	0	5	0	0
10	34989149	.	T	C	6	0	6	0	10	16	0	0
10	34992565	.	A	G	15	9	24	0	0	24	0	0
10	34998281	.	G	C	8	5	13	0	0	13	0	0
10	35002653	.	C	A	5	2	7	0	0	7	0	0
10	35002655	.	T	A	5	2	7	0	0	7	0	0
10	35006385	.	C	T	3	7	10	1	0	11	0	0
10	35008963	.	C	T	6	10	16	0	0	16	0	0
10	35023235	.	C	T	4	2	6	0	1	7	0	0
10	35025832	.	G	C	4	3	7	0	0	7	0	0
10	35029172	.	G	A	4	6	10	0	1	11	0	0
10	35032792	.	A	G	4	2	6	0	1	7	0	0
10	35046093	.	C	T	1	3	4	0	1	5	0	0
10	35063944	.	C	T	5	2	7	0	0	7	0	0
10	35064268	.	T	G	1	3	4	0	0	4	0	0
10	35108561	.	A	G	3	2	5	0	0	5	0	0
10	35153051	.	G	T	6	2	8	0	0	8	0	0
10	35156268	.	C	T	2	3	5	0	1	6	0	0
10	35156315	.	G	A	3	5	8	0	0	8	0	0
10	35156431	.	C	T	4	4	8	0	0	8	0	0
10	35160454	.	T	G	1	0	1	0	3	4	0	0
10	35163358	.	T	A	3	5	8	0	0	8	0	0
10	35163406	.	G	A	2	5	7	0	1	8	0	0
10	35169884	.	T	C	6	6	12	0	2	14	0	0
10	35170265	.	A	G	4	3	7	0	1	8	0	0
10	35177270	.	A	T	2	6	8	0	2	10	0	0
10	35177324	.	A	G	11	7	18	0	1	19	0	0
10	35177357	.	G	A	11	5	16	0	0	16	0	0
10	35177375	.	G	C	8	0	8	0	8	16	0	0
10	35177537	.	G	A	2	3	5	0	1	6	0	0
10	35178440	.	A	T	11	3	14	0	0	14	0	0
10	35178518	.	A	T	7	3	10	0	1	11	0	0
10	35180253	.	G	C	3	4	7	0	0	7	0	0
10	35180273	.	C	T	2	4	6	0	0	6	0	0
10	35180627	.	C	T	1	5	6	0	7	13	0	0
10	35182580	.	A	T	1	2	3	0	0	3	0	0
10	35220214	.	C	T	3	2	5	0	0	5	0	0
10	35236801	.	T	G	1	3	4	0	0	4	0	0
10	35241646	.	A	T	8	5	13	0	1	14	0	0
10	35242113	.	C	G	4	8	12	0	0	12	0	0
10	35245939	.	T	A	5	4	9	0	0	9	0	0
10	35245951	.	C	T	6	4	10	0	0	10	0	0
10	35247387	.	T	C	4	2	6	0	1	7	0	0
10	35247905	.	G	A	2	4	6	0	0	6	0	0
10	35247980	.	G	C	2	1	3	0	2	5	0	0
10	35248047	.	C	G	2	2	4	0	0	4	0	0
10	35248433	.	G	A	4	4	8	0	2	10	0	0
10	35250755	.	T	A	1	2	3	0	0	3	0	0
10	35265206	.	T	A	2	3	5	0	0	5	0	0
10	35272436	.	C	T	4	2	6	0	0	6	0	0
10	35281335	.	C	T	2	5	7	0	0	7	0	0
10	35281388	.	T	C	1	2	3	0	0	3	0	0
10	35292112	.	G	A	1	5	6	0	6	12	0	0
10	35298732	.	A	G	5	2	7	0	0	7	0	0
10	35304002	.	G	A	10	11	21	0	0	21	0	0
10	35304014	.	C	T	10	10	20	0	1	21	0	0
10	35307579	.	C	T	11	6	17	0	1	18	0	0
10	35311926	.	C	G	21	10	31	0	0	31	0	0
10	35312253	.	C	T	6	7	13	0	2	15	0	0
10	35312412	.	G	T	7	3	10	0	1	11	0	0
10	35312682	.	C	G	2	8	10	0	0	10	0	0
10	35538349	.	A	C	23	11	34	0	0	34	0	0
10	35538350	.	C	A	24	11	35	0	0	35	0	0
10	35590076	.	T	A	12	5	17	0	0	17	0	0
10	35592817	.	A	G	3	9	12	0	2	14	0	0
10	35592830	.	G	A	4	12	16	0	1	17	0	0
10	35595653	.	C	T	10	10	20	0	0	20	0	0
10	35595669	.	T	A	7	12	19	0	2	21	0	0
10	35600397	.	T	C	8	5	13	0	1	14	0	0
10	35600529	.	G	T	3	2	5	0	1	6	0	0
10	35602535	.	G	T	3	3	6	0	1	7	0	0
10	35602756	.	T	C	2	3	5	0	0	5	0	0
10	35603233	.	A	G	1	3	4	0	0	4	0	0
10	35606506	.	C	A	5	3	8	0	0	8	0	0
10	35610961	.	T	G	1	4	5	0	1	6	0	0
10	35611227	.	G	T	2	2	4	0	0	4	0	0
10	35611436	.	C	T	1	2	3	0	0	3	0	0
10	35668427	.	A	T	1	2	3	0	0	3	0	0
10	35668514	.	G	T	1	2	3	0	0	3	0	0
10	35668545	.	G	T	1	2	3	0	0	3	0	0
10	35959133	.	C	A	3	3	6	0	0	6	0	0
10	35959223	.	T	C	10	4	14	0	0	14	0	0
10	36029893	.	T	C	19	41	60	0	4	64	0	0
10	36031298	.	A	C	2	2	4	0	0	4	0	0
10	36031316	.	C	A	2	3	5	0	0	5	0	0
10	36040404	.	T	C	1	3	4	0	0	4	0	0
10	36049738	.	G	A	1	4	5	0	0	5	0	0
10	36054226	.	C	T	8	5	13	0	1	14	0	0
10	36095614	.	T	C	2	2	4	0	0	4	0	0
10	36095725	.	T	A	1	3	4	0	1	5	0	0
10	36096022	.	T	A	3	7	10	0	0	10	0	0
10	36098253	.	A	C	2	2	4	0	0	4	0	0
10	36098342	.	A	G	2	3	5	0	0	5	0	0
10	36101022	.	A	G	3	0	3	0	4	7	0	0
10	36155710	.	A	T	1	2	3	0	0	3	0	0
10	36155719	.	T	G	1	0	1	0	2	3	0	0
10	36155767	.	C	A	2	2	4	0	0	4	0	0
10	36156139	.	T	A	1	2	3	0	0	3	0	0
10	36156369	.	G	A	2	3	5	0	0	5	0	0
10	36159276	.	C	G	3	2	5	0	1	6	0	0
10	36159292	.	A	G	2	0	2	0	4	6	0	0
10	36363557	.	A	G	15	14	29	0	0	29	0	0
10	36363611	.	C	T	16	15	31	0	1	32	0	0
10	36363818	.	G	T	10	11	21	0	3	24	0	0
10	36363937	.	G	A	28	16	44	0	0	44	0	0
10	36363971	.	C	T	3	12	15	0	24	39	0	0
10	36364172	.	A	G	21	9	30	0	1	31	0	0
10	36405921	.	C	T	15	14	29	0	1	30	0	0
10	36406039	.	G	T	13	16	29	0	1	30	0	0
10	36406106	.	T	A	6	5	11	0	1	12	0	0
10	36406210	.	G	A	20	7	27	0	0	27	0	0
10	36443018	.	T	C	13	7	20	0	2	22	0	0
10	36443541	.	T	C	18	11	29	0	2	31	0	0
10	36443818	.	T	G	14	1	15	0	4	19	0	0
10	36446799	.	A	T	7	8	15	0	0	15	0	0
10	36451615	.	T	C	20	10	30	0	1	31	0	0
10	36451661	.	G	A	19	16	35	0	2	37	0	0
10	36454567	.	C	A	12	19	31	0	0	31	0	0
10	36454649	.	A	G	13	0	13	0	22	35	0	0
10	36454650	.	C	A	19	14	33	0	3	36	0	0
10	36454902	.	G	T	17	19	36	0	1	37	0	0
10	36455146	.	C	T	16	18	34	0	0	34	0	0
10	36455215	.	T	C	17	13	30	0	0	30	0	0
10	36455229	.	C	G	18	13	31	0	0	31	0	0
10	36455344	.	A	G	15	15	30	0	4	34	0	0
10	36455847	.	G	A	0	6	6	0	8	14	0	0
10	36476481	.	C	T	4	18	22	0	16	38	0	0
10	36476529	.	C	T	9	15	24	0	1	25	0	0
10	36476639	.	C	T	1	11	12	0	15	27	0	0
10	36476717	.	A	G	9	21	30	0	1	31	0	0
10	36476834	.	G	A	12	20	32	0	0	32	0	0
10	36476852	.	A	G	14	20	34	0	1	35	0	0
10	36476922	.	C	T	20	8	28	0	1	29	0	0
10	36481915	.	A	C	10	13	23	0	2	25	0	0
10	36482588	.	G	A	6	16	22	0	1	23	0	0
10	36487530	.	G	A	3	8	11	0	0	11	0	0
10	36489882	.	A	G	10	6	16	0	0	16	0	0
10	36489893	.	A	G	9	6	15	0	0	15	0	0
10	36492091	.	C	T	5	2	7	0	0	7	0	0
10	36494336	.	G	A	3	4	7	0	1	8	0	0
10	36494590	.	C	G	7	10	17	0	0	17	0	0
10	36495580	.	T	G	5	6	11	0	0	11	0	0
10	36496544	.	A	G	8	10	18	0	0	18	0	0
10	36496595	.	G	A	7	10	17	0	1	18	0	0
10	36498246	.	G	A	3	8	11	0	0	11	0	0
10	36498379	.	C	T	0	8	8	0	3	11	0	0
10	36498397	.	G	A	5	7	12	0	0	12	0	0
10	36500581	.	C	T	7	3	10	0	0	10	0	0
10	36500674	.	G	A	2	6	8	0	0	8	0	0
10	36504163	.	C	T	1	4	5	0	2	7	0	0
10	36506103	.	G	A	3	2	5	0	0	5	0	0
10	36506290	.	C	T	0	3	3	0	4	7	0	0
10	36506630	.	T	A	2	3	5	0	0	5	0	0
10	36518643	.	C	T	5	2	7	0	0	7	0	0
10	36520711	.	G	A	4	4	8	0	1	9	0	0
10	36520945	.	A	G	3	4	7	0	1	8	0	0
10	36521605	.	C	T	1	3	4	0	1	5	0	0
10	36558839	.	A	G	7	13	20	0	0	20	0	0
10	36558895	.	G	A	15	13	28	0	3	31	0	0
10	36570469	.	A	G	9	16	25	0	2	27	0	0
10	36572622	.	G	A	15	11	26	0	0	26	0	0
10	36572640	.	C	A	1	10	11	0	10	21	0	0
10	36572814	.	A	T	8	7	15	0	0	15	0	0
10	36575980	.	G	A	3	5	8	0	1	9	0	0
10	36575992	.	C	T	5	1	6	0	1	7	0	0
10	36584462	.	T	C	4	3	7	0	0	7	0	0
10	36613095	.	T	C	9	7	16	0	1	17	0	0
10	36613145	.	G	T	8	8	16	0	2	18	0	0
10	36613164	.	C	T	1	7	8	0	11	19	0	0
10	36613276	.	C	T	8	9	17	0	0	18	1	0
10	36615367	.	G	A	11	3	14	1	0	15	0	0
10	36615907	.	C	A	12	4	16	0	1	17	0	0
10	36618787	.	C	T	11	12	23	0	0	23	0	0
10	36625258	.	C	A	3	4	7	0	7	14	0	0
10	36625534	.	G	A	6	5	11	1	1	13	0	0
10	36625602	.	C	G	14	7	21	0	0	21	0	0
10	36625761	.	T	A	7	9	16	0	1	18	1	0
10	36626201	.	C	T	4	2	6	0	0	6	0	0
10	36627009	.	G	C	2	5	7	0	0	7	0	0
10	36627209	.	A	G	3	3	6	0	0	6	0	0
10	36627210	.	C	T	0	3	3	0	3	6	0	0
10	36627314	.	C	T	6	3	9	0	1	10	0	0
10	36627390	.	A	G	3	6	9	0	1	10	0	0
10	36627414	.	C	A	3	2	5	0	0	5	0	0
10	36627517	.	C	T	4	6	10	0	0	10	0	0
10	36627820	.	C	T	2	7	9	0	0	9	0	0
10	36628804	.	G	T	2	2	4	0	1	5	0	0
10	36665829	.	C	T	1	2	3	0	0	3	0	0
10	36670106	.	T	C	3	3	6	0	0	6	0	0
10	36673237	.	G	T	1	3	4	0	0	4	0	0
10	36688455	.	C	T	6	6	12	0	1	13	0	0
10	36689850	.	G	T	5	5	10	0	1	11	0	0
10	36689893	.	A	G	6	8	14	0	0	14	0	0
10	36691372	.	C	A	0	11	11	0	4	15	0	0
10	36695781	.	G	C	10	4	14	0	0	14	0	0
10	36695785	.	C	T	8	4	12	0	0	12	0	0
10	36704842	.	A	G	20	10	30	2	0	32	0	0
10	36706217	.	T	A	12	19	31	0	3	34	0	0
10	36708401	.	A	G	16	0	16	0	27	43	0	0
10	36710559	.	A	C	13	18	31	0	3	34	0	0
10	36710599	.	C	T	20	15	35	0	2	37	0	0
10	36710871	.	G	A	1	20	21	0	20	41	0	0
10	36710893	.	G	T	1	20	21	0	22	43	0	0
10	36711260	.	T	A	2	4	6	0	0	6	0	0
10	36711329	.	T	A	7	7	14	0	0	14	0	0
10	36711613	.	C	T	4	11	15	0	0	15	0	0
10	36778293	.	C	T	3	2	5	0	1	6	0	0
10	36778302	.	C	A	4	2	6	0	0	6	0	0
10	36778469	.	A	G	5	3	8	0	0	8	0	0
10	36785062	.	A	G	1	0	1	0	2	3	0	0
10	36796131	.	T	A	4	4	8	0	0	8	0	0
10	36800465	.	G	A	7	9	16	0	2	18	0	0
10	36800518	.	C	T	6	7	13	0	1	14	0	0
10	36800600	.	G	A	8	3	11	0	0	11	0	0
10	36800642	.	A	G	5	7	12	0	0	12	0	0
10	36807986	.	G	A	8	10	18	0	0	18	0	0
10	36808032	.	G	A	8	7	15	0	1	16	0	0
10	36808096	.	A	G	2	2	4	0	0	4	0	0
10	36811815	.	A	G	10	3	13	0	0	13	0	0
10	36812214	.	A	C	16	7	23	0	1	24	0	0
10	36814912	.	G	A	10	9	19	0	1	20	0	0
10	36815330	.	T	C	5	1	6	0	4	10	0	0
10	36817197	.	A	C	7	3	10	0	1	12	1	0
10	36817355	.	C	T	0	7	7	0	4	11	0	0
10	36817530	.	C	T	9	7	16	0	0	16	0	0
10	36817940	.	T	C	11	6	17	0	0	17	0	0
10	36817979	.	T	G	10	10	20	0	0	20	0	0
10	36819664	.	G	T	6	6	12	0	1	13	0	0
10	36819671	.	C	T	7	7	14	0	0	14	0	0
10	36820601	.	C	T	0	3	3	0	5	8	0	0
10	36820611	.	A	G	3	5	8	0	0	8	0	0
10	36820664	.	C	T	4	5	9	0	1	10	0	0
10	36820688	.	C	G	0	4	4	0	7	11	0	0
10	36820736	.	G	A	6	3	9	0	0	9	0	0
10	36820769	.	T	A	6	6	12	0	1	13	0	0
10	36820892	.	G	A	5	5	10	0	0	10	0	0
10	36825818	.	T	C	1	3	4	0	0	4	0	0
10	36825880	.	G	A	1	6	7	0	1	8	0	0
10	36828227	.	T	C	3	14	17	0	0	17	0	0
10	36828265	.	G	A	13	8	21	0	1	22	0	0
10	36828295	.	G	T	7	5	12	0	4	16	0	0
10	36828469	.	T	C	8	1	9	0	14	23	0	0
10	36828475	.	C	T	15	9	24	0	0	24	0	0
10	36835641	.	A	T	3	6	9	0	1	10	0	0
10	36835740	.	G	A	5	3	8	0	0	8	0	0
10	36841230	.	G	T	6	5	11	0	0	11	0	0
10	36843114	.	C	G	3	4	7	0	0	7	0	0
10	36848872	.	G	A	3	3	6	0	0	6	0	0
10	36848938	.	A	G	3	2	5	0	0	5	0	0
10	36850674	.	C	T	0	2	2	0	5	7	0	0
10	36850752	.	A	G	2	2	4	0	0	4	0	0
10	36878340	.	G	T	1	3	4	0	0	4	0	0
10	36878568	.	C	T	4	4	8	0	0	8	0	0
10	36878638	.	T	C	2	1	3	0	3	6	0	0
10	36950935	.	A	T	7	5	12	0	0	12	0	0
10	36951044	.	A	T	6	10	16	0	0	16	0	0
10	36951076	.	G	C	6	10	16	0	0	16	0	0
10	36951223	.	A	C	4	12	16	0	0	16	0	0
10	36951378	.	A	G	2	3	5	0	0	5	0	0
10	36951582	.	C	G	12	11	23	0	1	24	0	0
10	36951660	.	T	A	11	9	20	0	0	22	2	0
10	36954141	.	C	T	2	3	5	0	0	5	0	0
10	36963456	.	G	A	8	8	16	0	1	17	0	0
10	36967206	.	T	C	17	12	29	0	2	31	0	0
10	36969510	.	T	C	8	8	16	0	1	17	0	0
10	36969519	.	A	G	6	9	15	0	0	15	0	0
10	36974901	.	G	A	5	7	12	0	1	13	0	0
10	36976271	.	C	T	0	11	11	0	4	15	0	0
10	36976296	.	A	G	11	1	12	0	0	12	0	0
10	36976318	.	G	A	8	3	11	0	0	11	0	0
10	36987831	.	T	G	5	3	8	0	0	8	0	0
10	36999951	.	A	G	4	7	11	0	0	11	0	0
10	37007508	.	G	C	6	4	10	0	1	11	0	0
10	37011570	.	G	T	6	3	9	0	0	9	0	0
10	37137549	.	G	A	1	5	6	0	13	19	0	0
10	37145178	.	G	A	8	8	16	0	1	17	0	0
10	37152081	.	G	A	18	20	38	0	2	40	0	0
10	37152105	.	A	G	22	1	23	0	18	42	1	0
10	37163252	.	C	A	16	10	26	0	1	27	0	0
10	37167151	.	G	C	13	8	21	0	0	21	0	0
10	37227524	.	C	T	4	6	10	0	1	11	0	0
10	37234093	.	A	G	3	0	3	0	8	11	0	0
10	37236672	.	T	G	3	0	3	0	5	8	0	0
10	37239229	.	G	A	8	4	12	0	0	12	0	0
10	37248682	.	T	C	3	2	5	0	0	5	0	0
10	37252054	.	G	A	3	8	11	0	8	19	0	0
10	37253986	.	A	G	11	9	20	0	1	21	0	0
10	37298354	.	G	C	1	2	3	0	0	3	0	0
10	37334291	.	G	T	1	2	3	0	1	4	0	0
10	37361681	.	G	A	0	2	2	0	4	6	0	0
10	37367451	.	T	C	1	4	5	0	0	5	0	0
10	37378252	.	A	T	3	2	5	0	0	5	0	0
10	37385317	.	T	C	3	2	5	0	0	5	0	0
10	37394478	.	G	A	4	4	8	0	1	9	0	0
10	37394486	.	G	A	3	5	8	0	1	9	0	0
10	37394535	.	C	T	4	4	8	0	0	8	0	0
10	37764473	.	C	T	15	6	21	2	0	23	0	0
10	37779765	.	A	C	13	7	20	0	1	21	0	0
10	37779778	.	T	A	12	6	18	0	2	21	1	0
10	37783114	.	A	G	8	11	19	0	0	19	0	0
10	37783179	.	A	G	14	0	14	0	14	28	0	0
10	37783323	.	A	G	15	11	26	1	0	27	0	0
10	37783575	.	C	A	0	2	2	0	1	4	1	0
10	37992653	.	C	T	3	5	8	0	0	8	0	0
10	37992679	.	G	A	1	3	4	0	5	9	0	0
10	37992839	.	A	T	3	4	7	0	0	7	0	0
10	37994630	.	C	T	7	4	11	0	0	11	0	0
10	37997567	.	C	G	3	7	10	0	0	10	0	0
10	38000082	.	C	G	3	5	8	0	0	8	0	0
10	38000084	.	G	T	0	3	3	0	5	8	0	0
10	38003011	.	A	G	12	9	21	0	0	21	0	0
10	38006136	.	A	T	2	2	4	0	0	4	0	0
10	38040372	.	A	G	10	14	24	0	1	25	0	0
10	38040378	.	A	G	16	9	25	0	2	27	0	0
10	38041451	.	G	A	10	7	17	1	1	19	0	0
10	38074570	.	G	T	8	10	18	0	2	20	0	0
10	38149713	.	C	A	2	4	6	0	6	12	0	0
10	38149715	.	A	G	5	4	9	0	1	10	0	0
10	38170737	.	G	A	8	5	13	0	0	13	0	0
10	38171149	.	G	C	12	0	12	0	7	19	0	0
10	38171196	.	G	A	6	8	14	0	4	18	0	0
10	38171207	.	C	A	9	10	19	0	0	19	0	0
10	38171356	.	A	T	7	15	22	0	0	22	0	0
10	38171490	.	T	A	16	6	22	0	1	23	0	0
10	38173383	.	C	A	3	12	15	0	12	27	0	0
10	38177999	.	C	T	3	8	11	0	13	24	0	0
10	38178357	.	G	A	8	10	18	0	2	20	0	0
10	38180732	.	A	T	5	9	14	0	0	14	0	0
10	38199097	.	G	A	6	5	11	0	0	11	0	0
10	38199169	.	T	C	11	7	18	0	0	18	0	0
10	38205149	.	T	C	2	0	2	0	6	8	0	0
10	38211810	.	C	G	8	5	13	0	0	13	0	0
10	38218990	.	C	T	0	2	2	0	2	4	0	0
10	38231165	.	C	T	1	2	3	0	6	9	0	0
10	38235957	.	G	C	3	5	8	0	0	8	0	0
10	38243543	.	G	A	5	2	7	0	0	7	0	0
10	38257295	.	G	A	4	7	11	0	2	13	0	0
10	38257509	.	C	G	1	4	5	0	9	14	0	0
10	38257870	.	T	C	12	11	23	0	2	25	0	0
10	38258729	.	C	G	15	15	30	0	0	30	0	0
10	38259033	.	C	T	9	7	16	0	1	17	0	0
10	38259034	.	A	G	7	7	14	0	2	17	1	0
10	38259217	.	A	G	10	3	13	0	0	13	0	0
10	38259268	.	G	C	4	7	11	1	0	12	0	0
10	38259276	.	A	G	9	4	13	1	0	14	0	0
10	38259339	.	A	T	3	7	10	0	0	10	0	0
10	38259449	.	A	C	7	0	7	0	10	17	0	0
10	38259451	.	A	G	7	10	17	0	0	17	0	0
10	38259900	.	T	C	5	0	5	0	5	10	0	0
10	38260002	.	G	A	9	5	14	0	0	14	0	0
10	38260210	.	T	A	8	10	18	0	0	18	0	0
10	38260626	.	A	T	11	4	15	0	4	19	0	0
10	38261085	.	T	G	2	3	5	0	0	5	0	0
10	38261485	.	C	T	3	2	5	0	1	6	0	0
10	38261495	.	T	G	4	2	6	0	0	6	0	0
10	38261696	.	C	T	1	5	6	0	0	6	0	0
10	38432902	.	A	G	1	1	2	0	1	3	0	0
10	38665994	.	C	T	15	13	28	0	1	29	0	0
10	38666063	.	T	C	11	11	22	0	2	24	0	0
10	38686126	.	T	C	23	17	40	0	2	42	0	0
10	38695152	.	A	C	33	14	47	0	0	47	0	0
10	38695510	.	A	G	28	7	35	0	0	35	0	0
10	38695656	.	A	G	13	7	20	0	0	20	0	0
10	38695877	.	C	T	8	9	17	0	0	17	0	0
10	38695888	.	C	T	7	7	14	0	0	14	0	0
10	38712403	.	A	G	0	0	0	0	3	3	0	0
10	38712431	.	C	T	1	2	3	0	0	3	0	0
10	38723491	.	T	C	2	5	7	0	0	7	0	0
10	38723539	.	T	C	1	3	4	0	0	4	0	0
10	38724101	.	C	T	3	2	5	0	0	5	0	0
10	38726441	.	C	T	1	3	4	0	0	4	0	0
10	38885821	.	T	C	3	3	6	0	0	6	0	0
10	38922043	.	G	A	1	9	10	0	4	14	0	0
10	38924557	.	C	T	4	10	14	0	0	14	0	0
10	38924560	.	T	C	2	10	12	0	2	14	0	0
10	38934391	.	A	G	4	9	13	0	0	13	0	0
10	38940232	.	A	G	8	9	17	0	1	18	0	0
10	38943265	.	C	G	8	15	23	0	0	23	0	0
10	38950115	.	T	C	7	11	18	0	0	18	0	0
10	38950430	.	G	A	0	10	10	0	13	23	0	0
10	38950484	.	A	G	10	15	25	0	1	26	0	0
10	38950538	.	T	C	10	20	30	0	0	30	0	0
10	38954126	.	C	T	15	11	26	0	0	26	0	0
10	38954141	.	T	C	15	13	28	0	1	29	0	0
10	38954798	.	T	C	14	16	30	0	2	32	0	0
10	38954801	.	C	T	14	19	33	0	1	34	0	0
10	38957061	.	T	C	14	15	29	0	4	34	1	0
10	38957127	.	G	A	0	18	18	0	17	35	0	0
10	38957193	.	C	T	19	11	30	0	0	30	0	0
10	38957748	.	A	C	14	14	28	0	0	28	0	0
10	38957754	.	A	C	16	13	29	0	0	29	0	0
10	38969552	.	A	C	33	15	48	0	4	53	1	0
10	38969598	.	A	C	27	27	54	0	1	55	0	0
10	38969629	.	C	T	20	32	52	0	0	52	0	0
10	38969685	.	A	G	28	25	53	0	1	54	0	0
10	38969778	.	C	T	16	27	43	0	2	45	0	0
10	39011484	.	C	T	20	18	38	0	0	38	0	0
10	39086382	.	C	T	40	22	62	0	1	63	0	0
10	39086981	.	G	A	24	19	43	0	1	44	0	0
10	39087391	.	A	G	32	0	32	1	30	63	0	0
10	39087625	.	T	A	29	26	55	0	2	57	0	0
10	39087659	.	T	A	28	25	53	0	1	54	0	0
10	39091684	.	C	A	3	3	6	0	1	7	0	0
10	39091792	.	A	G	3	0	3	0	5	8	0	0
10	39098798	.	C	T	4	6	10	0	0	10	0	0
10	39102672	.	G	C	6	4	10	0	0	10	0	0
10	39102776	.	T	C	5	7	12	0	0	12	0	0
10	39115595	.	G	T	5	6	11	0	0	11	0	0
10	39115596	.	T	C	4	6	10	0	1	11	0	0
10	39120132	.	T	C	7	7	14	0	1	15	0	0
10	39130460	.	C	T	44	25	69	0	3	72	0	0
10	39136385	.	A	G	5	2	7	2	0	9	0	0
10	39140465	.	A	G	7	5	12	0	0	12	0	0
10	39140741	.	T	C	8	4	12	0	1	13	0	0
10	39152038	.	A	G	1	2	3	0	0	3	0	0
10	39153599	.	T	A	1	3	4	0	0	4	0	0
10	39175418	.	T	C	6	3	9	0	0	9	0	0
10	39175452	.	C	T	5	2	7	0	0	7	0	0
10	39179696	.	C	T	4	2	6	0	0	6	0	0
10	39179925	.	T	A	1	2	3	0	0	3	0	0
10	39179992	.	G	C	4	6	10	0	0	10	0	0
10	39181040	.	G	T	5	3	8	0	1	9	0	0
10	39181417	.	G	T	5	4	9	0	0	9	0	0
10	39181424	.	T	C	6	4	10	0	0	10	0	0
10	39182173	.	A	G	6	12	18	0	1	19	0	0
10	39182310	.	C	A	4	9	13	0	0	13	0	0
10	39182342	.	A	T	3	4	7	0	1	8	0	0
10	39182401	.	C	A	12	6	18	0	0	18	0	0
10	39182497	.	C	T	9	4	13	0	1	14	0	0
10	39182602	.	G	A	0	6	6	0	5	11	0	0
10	39182640	.	T	A	4	5	9	0	1	10	0	0
10	39182659	.	G	T	4	6	10	0	0	10	0	0
10	39182703	.	T	G	4	0	4	0	3	7	0	0
10	39199639	.	G	A	0	5	5	0	7	12	0	0
10	39205256	.	C	G	6	4	10	0	0	10	0	0
10	39206945	.	A	G	2	2	4	0	0	4	0	0
10	39207104	.	C	A	7	3	10	0	1	11	0	0
10	39207114	.	C	A	8	3	11	0	0	11	0	0
10	39212932	.	G	A	4	3	7	0	0	7	0	0
10	39216625	.	C	T	8	5	13	0	0	13	0	0
10	39219390	.	T	C	3	10	13	0	0	13	0	0
10	39219540	.	T	A	7	17	24	0	1	25	0	0
10	39222134	.	A	C	11	9	20	0	6	26	0	0
10	39222182	.	A	G	14	11	25	0	2	27	0	0
10	39225504	.	A	C	12	15	27	0	1	28	0	0
10	39225555	.	T	C	8	18	26	0	1	27	0	0
10	39231387	.	G	A	19	17	36	0	2	38	0	0
10	39249061	.	G	T	2	2	4	0	0	4	0	0
10	39265717	.	C	T	1	2	3	0	0	3	0	0
10	39265733	.	C	T	2	2	4	0	0	4	0	0
10	39265766	.	G	A	1	2	3	0	0	3	0	0
10	39265954	.	G	A	4	2	6	0	0	6	0	0
10	39266017	.	T	G	3	0	3	0	2	5	0	0
10	39266350	.	G	T	0	2	2	0	2	4	0	0
10	39266669	.	A	C	4	3	7	0	0	7	0	0
10	39266702	.	A	G	5	0	5	0	5	10	0	0
10	39266756	.	A	G	3	2	5	0	0	5	0	0
10	39266758	.	G	A	3	2	5	0	0	5	0	0
10	39266862	.	T	C	3	3	6	0	0	6	0	0
10	39270672	.	G	A	1	2	3	0	0	4	1	0
10	39270674	.	A	G	1	3	4	0	0	4	0	0
10	39277087	.	C	G	2	2	4	0	1	5	0	0
10	39284032	.	A	G	2	2	4	0	0	4	0	0
10	39284092	.	T	G	4	0	4	0	3	7	0	0
10	39284104	.	C	G	3	0	3	0	2	5	0	0
10	39286967	.	C	T	3	3	6	0	0	6	0	0
10	39287100	.	C	T	2	7	9	0	0	9	0	0
10	39289006	.	A	G	2	0	2	0	4	6	0	0
10	39289036	.	A	C	4	3	7	0	0	7	0	0
10	39292988	.	A	G	1	2	3	0	0	3	0	0
10	39293705	.	A	G	5	3	8	0	2	10	0	0
10	39293707	.	A	T	8	2	10	0	1	11	0	0
10	39476639	.	A	G	2	2	4	0	0	4	0	0
10	39904774	.	G	A	0	9	9	0	5	14	0	0
10	39904780	.	C	T	6	9	15	0	1	16	0	0
10	39904851	.	A	T	5	5	10	0	0	10	0	0
10	39904915	.	A	G	6	10	16	0	0	16	0	0
10	39904966	.	T	C	8	6	14	0	0	14	0	0
10	39905085	.	A	T	5	9	14	0	1	15	0	0
10	39905089	.	T	G	5	9	14	0	1	15	0	0
10	40086018	.	A	G	1	4	5	0	0	5	0	0
10	40086024	.	T	C	2	3	5	0	0	5	0	0
10	40109378	.	C	T	8	6	14	0	0	14	0	0
10	40109439	.	G	A	2	7	9	0	7	16	0	0
10	40110226	.	T	C	3	2	5	0	0	5	0	0
10	40110243	.	A	T	2	3	5	0	1	6	0	0
10	40110599	.	G	A	1	2	3	0	2	5	0	0
10	40110616	.	G	T	4	2	6	0	0	6	0	0
10	40110666	.	T	A	6	3	9	0	0	9	0	0
10	40110714	.	C	T	3	2	5	0	1	6	0	0
10	40110726	.	C	A	3	3	6	0	0	6	0	0
10	40110853	.	A	T	3	2	5	0	0	5	0	0
10	40110869	.	A	T	1	2	3	0	1	4	0	0
10	40110907	.	A	G	1	2	3	1	0	4	0	0
10	40111437	.	T	A	3	3	6	0	0	6	0	0
10	40111549	.	T	C	2	3	5	0	0	5	0	0
10	40111666	.	G	C	4	2	6	0	0	6	0	0
10	40111706	.	A	G	3	4	7	0	0	7	0	0
10	40111732	.	C	T	2	4	6	0	2	8	0	0
10	40111952	.	C	T	3	3	6	0	0	6	0	0
10	40111964	.	C	A	4	3	7	0	0	7	0	0
10	40112096	.	C	A	3	3	6	0	0	6	0	0
10	40112121	.	A	G	3	3	6	0	0	6	0	0
10	40112157	.	G	A	3	3	6	0	0	6	0	0
10	40112159	.	T	A	3	3	6	0	0	6	0	0
10	40112347	.	A	T	4	5	9	0	0	9	0	0
10	40112476	.	T	A	3	4	7	0	1	8	0	0
10	40112638	.	C	T	7	3	10	0	1	11	0	0
10	40112834	.	G	A	6	3	9	0	2	11	0	0
10	40113032	.	T	A	2	3	5	1	0	6	0	0
10	40113045	.	A	G	4	3	7	1	0	8	0	0
10	40113161	.	C	A	2	5	7	0	2	9	0	0
10	40113197	.	G	A	1	7	8	0	1	9	0	0
10	40113408	.	A	G	2	7	9	0	0	9	0	0
10	40113446	.	T	C	1	5	6	0	0	6	0	0
10	40113508	.	A	T	3	2	5	0	0	5	0	0
10	40113643	.	G	T	1	2	3	0	0	3	0	0
10	40113713	.	A	G	3	2	5	0	0	5	0	0
10	40204788	.	A	G	1	3	4	0	0	4	0	0
10	40236068	.	A	G	6	0	6	0	11	17	0	0
10	40262052	.	T	C	4	5	9	0	0	9	0	0
10	40262338	.	T	C	1	4	5	0	0	5	0	0
10	40262347	.	A	G	1	0	1	0	4	5	0	0
10	40266160	.	A	G	4	5	9	0	0	9	0	0
10	40266259	.	A	C	6	2	8	0	0	8	0	0
10	40274411	.	G	A	6	5	11	0	2	13	0	0
10	40274541	.	G	A	3	13	16	0	5	21	0	0
10	40274626	.	C	T	7	7	14	0	0	14	0	0
10	40275055	.	G	C	0	4	4	0	5	9	0	0
10	40275070	.	T	G	4	3	7	0	0	7	0	0
10	40275158	.	G	A	0	2	2	0	6	8	0	0
10	40296841	.	G	A	0	2	2	0	2	4	0	0
10	40296896	.	C	T	4	2	6	0	0	6	0	0
10	40303924	.	G	C	2	5	7	0	0	7	0	0
10	40303980	.	A	G	3	6	9	0	0	9	0	0
10	40307553	.	T	C	3	5	8	0	0	8	0	0
10	40311286	.	G	T	0	5	5	0	6	11	0	0
10	40314046	.	T	C	2	4	6	0	1	7	0	0
10	40314060	.	T	A	3	3	6	0	1	7	0	0
10	40314126	.	C	T	8	4	12	0	0	12	0	0
10	40314175	.	A	C	7	6	13	0	0	13	0	0
10	40314177	.	A	C	7	6	13	0	0	13	0	0
10	40314296	.	C	A	1	2	3	0	0	3	0	0
10	40314302	.	A	G	1	0	1	0	3	4	0	0
10	40314350	.	A	G	3	2	5	0	0	5	0	0
10	40316519	.	A	C	1	8	9	0	0	9	0	0
10	40316528	.	G	A	2	7	9	0	1	10	0	0
10	40317095	.	G	T	10	6	16	0	0	16	0	0
10	40317285	.	A	T	4	9	13	0	0	13	0	0
10	40317323	.	A	G	2	1	3	0	4	7	0	0
10	40317341	.	A	G	2	3	5	0	0	5	0	0
10	40822252	.	C	T	1	15	16	0	9	25	0	0
10	40825192	.	T	C	12	9	21	0	1	22	0	0
10	40826436	.	A	G	5	5	10	0	1	11	0	0
10	40826494	.	A	G	9	7	16	0	0	16	0	0
10	40826516	.	A	G	15	5	20	0	0	20	0	0
10	40826589	.	C	T	19	5	24	0	0	24	0	0
10	40826590	.	A	G	16	5	21	0	2	23	0	0
10	40859722	.	A	G	2	2	4	0	1	5	0	0
10	40859885	.	A	G	9	4	13	0	1	14	0	0
10	40859968	.	T	C	8	5	13	0	0	13	0	0
10	40860070	.	G	C	8	0	8	0	4	12	0	0
10	40861563	.	C	A	6	5	11	0	0	11	0	0
10	40866244	.	T	C	2	0	2	0	2	4	0	0
10	40951965	.	G	A	1	2	3	0	0	3	0	0
10	40951983	.	A	G	1	2	3	0	0	3	0	0
10	41089380	.	A	G	11	10	21	0	0	21	0	0
10	41099458	.	A	G	1	4	5	0	2	7	0	0
10	41112076	.	T	C	5	0	5	0	5	10	0	0
10	41115360	.	C	A	7	5	12	0	0	12	0	0
10	41126435	.	G	T	3	5	8	0	1	9	0	0
10	41156693	.	A	G	2	2	4	0	0	4	0	0
10	41279962	.	T	C	2	4	6	0	0	6	0	0
10	41279966	.	C	G	2	4	6	2	0	8	0	0
10	41362665	.	G	A	9	13	22	0	0	22	0	0
10	41362763	.	C	G	12	21	33	1	0	34	0	0
10	41362771	.	C	T	3	10	13	1	17	31	0	0
10	41362839	.	A	G	14	12	26	0	1	27	0	0
10	41362986	.	T	A	11	19	30	0	3	33	0	0
10	41379918	.	G	C	9	7	16	0	2	18	0	0
10	41397380	.	G	T	7	5	12	0	0	12	0	0
10	41397404	.	G	A	5	9	14	0	0	14	0	0
10	41397443	.	G	A	3	10	13	0	2	15	0	0
10	41397533	.	A	G	9	7	16	0	0	16	0	0
10	41397712	.	A	G	4	2	6	0	0	6	0	0
10	41399919	.	G	A	7	7	14	0	0	14	0	0
10	41399968	.	G	T	7	10	17	0	1	18	0	0
10	41409578	.	T	A	3	2	5	0	0	5	0	0
10	41409781	.	C	T	2	4	6	0	0	6	0	0
10	41419075	.	C	T	7	5	12	0	2	14	0	0
10	41607449	.	A	G	3	0	3	0	4	7	0	0
10	41607966	.	T	C	1	2	3	0	0	3	0	0
10	41608561	.	A	T	1	7	8	0	0	8	0	0
10	41608827	.	C	T	2	3	5	0	0	5	0	0
10	41735272	.	C	T	1	2	3	0	0	3	0	0
10	41765973	.	C	T	8	5	13	0	0	13	0	0
10	41766022	.	A	G	11	0	11	0	6	17	0	0
10	41801475	.	C	T	4	3	7	0	0	7	0	0
10	41816988	.	C	T	10	6	16	0	0	16	0	0
10	41816991	.	G	A	10	6	16	0	0	16	0	0
10	41817054	.	T	C	4	7	11	0	1	12	0	0
10	41817094	.	C	A	3	5	8	0	0	8	0	0
10	41830403	.	G	A	22	6	28	0	0	28	0	0
10	41830435	.	C	T	17	9	26	0	3	29	0	0
10	41832092	.	C	A	9	13	22	0	0	22	0	0
10	41834276	.	G	T	14	13	27	0	1	28	0	0
10	41834300	.	C	T	13	10	23	0	3	26	0	0
10	41835199	.	C	T	3	10	13	0	0	13	0	0
10	41835283	.	G	T	5	4	9	0	1	10	0	0
10	41841119	.	G	A	6	15	21	1	3	25	0	0
10	41841178	.	G	T	12	8	20	0	0	20	0	0
10	41841214	.	G	C	8	8	16	0	0	16	0	0
10	41865722	.	G	A	8	4	12	0	1	13	0	0
10	41894738	.	T	A	1	3	4	0	1	5	0	0
10	41902778	.	A	C	3	0	3	0	2	5	0	0
10	41921284	.	T	C	2	2	4	0	0	4	0	0
10	41921293	.	G	A	2	2	4	0	0	4	0	0
10	41953948	.	C	T	4	2	6	0	0	6	0	0
10	41959448	.	A	G	1	2	3	0	0	3	0	0
10	41983482	.	A	C	5	7	12	0	1	13	0	0
10	41984544	.	C	G	2	3	5	0	0	5	0	0
10	41985141	.	C	A	2	2	4	0	0	4	0	0
10	41995252	.	C	T	2	1	3	0	1	4	0	0
10	41995555	.	C	T	2	2	4	0	0	4	0	0
10	41995573	.	C	T	3	2	5	0	1	6	0	0
10	41995624	.	A	G	2	3	5	0	0	5	0	0
10	41995644	.	A	T	1	5	6	0	0	6	0	0
10	41995678	.	A	G	1	5	6	0	0	6	0	0
10	41995741	.	A	G	1	0	1	0	3	4	0	0
10	42002429	.	G	A	0	2	2	0	2	4	0	0
10	42010719	.	A	T	3	4	7	0	1	8	0	0
10	42011054	.	T	C	2	2	4	0	0	4	0	0
10	42011060	.	G	T	3	2	5	0	0	5	0	0
10	42011128	.	T	C	1	4	5	0	0	5	0	0
10	42017620	.	C	T	3	7	10	0	1	11	0	0
10	42017854	.	C	T	3	2	5	0	0	5	0	0
10	42019966	.	A	C	3	4	7	0	0	7	0	0
10	42020205	.	T	A	2	3	5	0	0	5	0	0
10	42020451	.	C	T	6	6	12	0	0	12	0	0
10	42020565	.	C	T	8	4	12	0	1	13	0	0
10	42020592	.	G	T	4	8	12	0	0	12	0	0
10	42021321	.	G	A	3	4	7	0	0	7	0	0
10	42021384	.	T	C	5	6	11	0	0	11	0	0
10	42021485	.	A	T	5	5	10	0	3	13	0	0
10	42021515	.	T	A	5	2	7	0	1	10	2	0
10	42021543	.	T	C	4	3	7	0	0	7	0	0
10	42021611	.	C	A	5	7	12	0	0	12	0	0
10	42022425	.	A	G	5	0	5	0	3	8	0	0
10	42030956	.	C	T	5	4	9	0	1	10	0	0
10	42031279	.	C	T	0	3	3	0	2	5	0	0
10	42036689	.	G	T	1	5	6	0	0	6	0	0
10	42044409	.	A	G	7	13	20	0	2	22	0	0
10	42044480	.	G	A	17	17	34	0	2	36	0	0
10	42044859	.	G	A	19	9	28	0	0	28	0	0
10	42045041	.	G	C	17	17	34	0	2	36	0	0
10	42045254	.	C	T	2	10	12	0	8	20	0	0
10	42045300	.	G	C	7	9	16	0	0	16	0	0
10	42045370	.	G	A	3	11	14	0	0	14	0	0
10	42045578	.	C	T	1	2	3	1	0	4	0	0
10	42045922	.	T	C	1	3	4	0	0	4	0	0
10	42046689	.	A	C	1	3	4	0	0	4	0	0
10	42048557	.	G	A	2	4	6	0	0	6	0	0
10	42089968	.	T	A	1	3	4	0	0	4	0	0
10	42090214	.	A	G	9	11	20	0	0	20	0	0
10	42090222	.	A	G	10	10	20	1	0	21	0	0
10	42090315	.	T	C	14	10	24	0	1	25	0	0
10	42093928	.	A	G	8	14	22	0	2	24	0	0
10	42101122	.	A	G	2	8	10	0	0	10	0	0
10	42104371	.	C	T	1	5	6	0	8	14	0	0
10	42105921	.	C	T	4	5	9	0	0	9	0	0
10	42107853	.	C	T	3	6	9	0	0	9	0	0
10	42107884	.	C	T	0	3	3	0	1	4	0	0
10	42108029	.	G	A	6	6	12	0	1	13	0	0
10	42108077	.	T	A	5	4	9	0	1	10	0	0
10	42111601	.	G	A	9	5	14	0	0	14	0	0
10	42111610	.	A	T	7	6	13	0	0	13	0	0
10	42111669	.	C	A	9	9	18	0	0	18	0	0
10	42111673	.	G	A	9	8	17	0	1	18	0	0
10	42111883	.	C	T	0	3	3	0	3	6	0	0
10	42111895	.	G	A	3	2	5	0	0	5	0	0
10	42112227	.	G	T	7	9	16	0	0	16	0	0
10	42114366	.	G	A	11	12	23	0	0	23	0	0
10	42119810	.	C	T	5	4	9	0	1	10	0	0
10	42119816	.	A	G	5	5	10	0	0	10	0	0
10	42123309	.	C	G	1	3	4	0	0	4	0	0
10	42123334	.	T	C	0	0	0	0	6	6	0	0
10	42123388	.	A	G	3	8	11	0	1	12	0	0
10	42125549	.	C	T	3	3	6	0	0	6	0	0
10	42125702	.	C	T	3	3	6	0	0	6	0	0
10	42131297	.	A	T	8	5	13	0	0	13	0	0
10	42134447	.	C	G	2	3	5	0	0	5	0	0
10	42135035	.	C	T	3	3	6	0	0	6	0	0
10	42135415	.	T	C	3	4	7	0	0	7	0	0
10	42136526	.	A	C	3	0	3	0	4	7	0	0
10	42136645	.	C	T	0	2	2	1	2	5	0	0
10	42136663	.	T	C	1	0	1	1	4	6	0	0
10	42136939	.	T	C	2	0	2	0	4	6	0	0
10	42136942	.	T	C	4	2	6	0	1	7	0	0
10	42136993	.	T	C	9	0	9	0	4	13	0	0
10	42136998	.	G	C	9	2	11	0	1	12	0	0
10	42137036	.	T	C	5	3	8	1	0	9	0	0
10	42137050	.	G	C	4	2	6	1	0	7	0	0
10	42137594	.	A	C	1	3	4	0	0	4	0	0
10	42138221	.	C	T	1	6	7	0	2	9	0	0
10	42196404	.	T	C	4	0	4	0	6	10	0	0
10	42196524	.	A	G	7	5	12	0	0	12	0	0
10	42199981	.	C	T	2	3	5	0	0	5	0	0
10	42202418	.	C	T	4	2	6	0	0	6	0	0
10	42378334	.	A	T	46	28	74	0	2	76	0	0
10	42463797	.	T	G	1	2	3	0	0	3	0	0
10	42501067	.	A	G	8	8	16	0	0	16	0	0
10	42501175	.	T	A	5	6	11	0	0	11	0	0
10	42501365	.	A	G	15	16	31	0	0	31	0	0
10	42505845	.	T	C	12	10	22	0	2	24	0	0
10	42507081	.	T	C	5	9	14	0	1	15	0	0
10	42507120	.	T	C	6	5	11	0	0	11	0	0
10	42507141	.	A	G	7	4	11	0	1	12	0	0
10	42519641	.	C	T	15	11	26	0	0	26	0	0
10	42522016	.	T	C	8	6	14	0	0	14	0	0
10	42526213	.	C	T	8	23	31	0	0	31	0	0
10	42531713	.	C	T	15	12	27	0	1	28	0	0
10	42539630	.	C	T	32	30	62	0	0	62	0	0
10	42539849	.	C	T	24	26	50	0	0	50	0	0
10	42539955	.	T	C	21	17	38	2	0	40	0	0
10	42540132	.	A	T	14	22	36	0	1	37	0	0
10	42540172	.	A	C	14	22	36	0	1	37	0	0
10	42540726	.	A	G	6	6	12	0	0	12	0	0
10	42542568	.	A	C	8	3	11	0	1	12	0	0
10	42542660	.	A	C	2	3	5	0	0	5	0	0
10	42542883	.	C	T	5	4	9	0	0	9	0	0
10	42548210	.	A	T	11	3	14	0	0	14	0	0
10	42548213	.	A	G	11	0	11	0	2	13	0	0
10	42549515	.	A	G	6	0	6	0	7	13	0	0
10	42550828	.	C	T	4	3	7	1	1	9	0	0
10	42555504	.	A	G	7	0	7	0	4	11	0	0
10	42555728	.	G	A	0	2	2	0	1	3	0	0
10	42555732	.	G	T	1	4	5	0	0	5	0	0
10	42555764	.	C	A	4	6	10	0	0	10	0	0
10	42656885	.	A	G	1	3	4	0	0	4	0	0
10	42694552	.	C	A	4	8	12	0	2	14	0	0
10	42700932	.	C	T	11	6	17	0	0	17	0	0
10	42701129	.	A	G	5	0	5	0	5	10	0	0
10	42701216	.	C	T	6	7	13	0	0	13	0	0
10	42701315	.	T	A	4	2	6	0	0	6	0	0
10	42704608	.	T	G	9	5	14	0	0	14	0	0
10	42704622	.	A	T	7	5	12	0	1	13	0	0
10	42704848	.	T	C	6	5	11	0	0	11	0	0
10	42704929	.	C	T	9	5	14	0	0	14	0	0
10	42709610	.	T	C	6	5	11	0	0	11	0	0
10	42709634	.	T	C	9	5	14	0	1	15	0	0
10	42716271	.	T	C	3	3	6	0	1	7	0	0
10	42716278	.	T	G	4	0	4	0	3	7	0	0
10	42733678	.	A	G	6	7	13	0	0	13	0	0
10	42738132	.	T	A	8	7	15	0	1	16	0	0
10	42740302	.	T	A	15	7	22	0	0	22	0	0
10	42741347	.	T	G	24	16	40	0	10	50	0	0
10	42741417	.	T	A	22	24	46	0	4	50	0	0
10	42741519	.	G	T	28	20	48	0	1	49	0	0
10	42741528	.	G	T	22	22	44	0	3	47	0	0
10	42741661	.	C	A	20	7	27	1	5	33	0	0
10	42741662	.	G	A	7	22	29	1	2	32	0	0
10	42741840	.	T	A	15	26	41	1	3	45	0	0
10	42741872	.	A	G	17	27	44	1	1	46	0	0
10	42741918	.	C	T	19	15	34	2	2	38	0	0
10	42741938	.	A	C	13	1	14	1	17	32	0	0
10	42742101	.	T	A	4	2	6	0	0	6	0	0
10	42742104	.	T	A	2	3	5	0	0	5	0	0
10	42742318	.	T	A	12	3	15	0	0	15	0	0
10	42742319	.	A	T	3	12	15	0	0	15	0	0
10	42742472	.	C	G	15	12	27	0	1	28	0	0
10	42742511	.	G	A	22	7	29	0	0	29	0	0
10	42742544	.	T	C	5	19	24	0	1	25	0	0
10	42742560	.	T	C	13	14	27	0	1	28	0	0
10	42742835	.	C	T	9	4	13	0	1	14	0	0
10	42742851	.	G	A	5	3	8	0	0	8	0	0
10	42743337	.	C	T	1	2	3	0	1	4	0	0
10	42743608	.	A	C	0	5	5	1	0	6	0	0
10	42743624	.	T	G	3	2	5	1	0	6	0	0
10	42743666	.	G	T	4	7	11	31	1	43	0	0
10	42744720	.	G	C	8	6	14	0	1	15	0	0
10	42745003	.	A	G	2	4	6	0	2	8	0	0
10	42745018	.	T	A	4	3	7	0	1	8	0	0
10	42745151	.	C	T	6	8	14	0	0	14	0	0
10	42748084	.	A	T	19	15	34	0	1	35	0	0
10	42748096	.	A	G	20	14	34	0	0	34	0	0
10	42748120	.	A	G	17	10	27	0	1	28	0	0
10	42775877	.	A	C	3	1	4	0	8	12	0	0
10	42775891	.	C	A	4	8	12	0	0	12	0	0
10	42873937	.	T	C	2	3	5	0	0	5	0	0
10	42874041	.	T	G	3	3	6	0	0	6	0	0
10	42874199	.	A	G	2	2	4	0	0	4	0	0
10	42880688	.	C	T	2	1	3	0	1	4	0	0
10	42880694	.	T	A	2	2	4	0	0	4	0	0
10	42880805	.	T	C	1	2	3	0	0	3	0	0
10	42881138	.	C	T	3	2	5	0	0	5	0	0
10	42899020	.	C	T	4	5	9	0	0	9	0	0
10	42901192	.	G	A	2	2	4	0	0	4	0	0
10	42901207	.	C	T	3	2	5	0	0	5	0	0
10	42901228	.	C	A	2	3	5	0	0	5	0	0
10	42902792	.	T	C	1	3	4	0	0	4	0	0
10	42903629	.	G	A	2	6	8	0	0	8	0	0
10	42930776	.	T	C	6	0	6	0	6	12	0	0
10	42930781	.	T	C	4	0	4	0	8	12	0	0
10	42930828	.	T	C	3	14	17	0	1	18	0	0
10	42930933	.	T	C	3	3	6	0	1	7	0	0
10	42931224	.	T	A	1	2	3	0	0	3	0	0
10	42931278	.	T	C	5	5	10	0	0	10	0	0
10	42931315	.	T	A	5	5	10	0	0	10	0	0
10	42935346	.	C	T	1	6	7	0	7	14	0	0
10	42992877	.	T	C	4	6	10	0	0	10	0	0
10	42992977	.	T	C	5	0	5	0	7	12	0	0
10	43044188	.	G	T	3	5	8	0	0	8	0	0
10	43044206	.	T	C	1	3	4	0	0	4	0	0
10	43073049	.	C	T	1	3	4	0	0	4	0	0
10	43073103	.	A	G	0	3	3	0	0	3	0	0
10	43117724	.	C	T	3	3	6	0	0	6	0	0
10	43127066	.	T	G	4	0	4	0	3	7	0	0
10	43151516	.	G	A	1	5	6	0	4	10	0	0
10	43157401	.	C	G	6	3	9	0	1	10	0	0
10	43157426	.	C	A	2	6	8	0	0	8	0	0
10	43225179	.	G	A	1	2	3	0	0	3	0	0
10	43231279	.	A	G	1	0	1	0	3	4	0	0
10	43231919	.	G	A	1	4	5	0	0	5	0	0
10	43270445	.	G	A	2	6	8	0	0	8	0	0
10	43372493	.	G	A	2	7	9	0	1	10	0	0
10	43375407	.	T	A	2	5	7	0	0	8	1	0
10	43375468	.	G	A	6	5	11	0	0	11	0	0
10	43499966	.	C	T	2	2	4	0	0	4	0	0
10	43545434	.	G	C	5	12	17	0	0	17	0	0
10	43545446	.	T	A	12	4	16	0	1	17	0	0
10	43545577	.	C	A	0	7	7	0	3	10	0	0
10	43546593	.	C	T	1	5	6	9	4	19	0	0
10	43547190	.	A	G	5	2	7	0	0	7	0	0
10	43547724	.	G	A	3	2	5	0	0	5	0	0
10	43547763	.	G	A	2	3	5	0	0	5	0	0
10	43547905	.	G	A	6	2	8	0	0	8	0	0
10	43547937	.	A	G	10	3	13	0	0	13	0	0
10	43547972	.	T	C	9	0	9	0	4	13	0	0
10	43548087	.	T	A	14	3	17	1	0	18	0	0
10	43548088	.	T	C	14	3	17	1	0	18	0	0
10	43548194	.	C	A	5	4	9	0	1	10	0	0
10	43548195	.	C	A	4	5	9	0	1	10	0	0
10	43548297	.	G	A	1	5	6	0	1	7	0	0
10	43549060	.	G	A	3	4	7	0	1	8	0	0
10	43549393	.	C	T	2	5	7	1	0	8	0	0
10	43549403	.	T	C	2	6	8	0	0	8	0	0
10	43549502	.	A	C	2	0	2	0	7	9	0	0
10	43549559	.	G	C	2	4	6	0	0	6	0	0
10	43549782	.	G	A	2	3	5	0	0	5	0	0
10	43549798	.	G	A	2	1	3	0	1	4	0	0
10	43549991	.	G	T	2	3	5	0	0	5	0	0
10	43799795	.	C	T	5	4	9	0	0	9	0	0
10	43999328	.	G	A	1	2	3	0	0	3	0	0
10	43999372	.	G	A	3	3	6	0	0	6	0	0
10	43999374	.	G	A	3	3	6	0	0	6	0	0
10	43999448	.	G	A	6	2	8	0	0	8	0	0
10	43999511	.	T	C	5	4	9	0	1	10	0	0
10	43999628	.	T	C	8	4	12	0	0	12	0	0
10	43999640	.	G	T	6	7	13	0	1	14	0	0
10	43999718	.	T	A	8	5	13	0	0	13	0	0
10	44002836	.	G	A	7	9	16	0	0	16	0	0
10	44011744	.	A	G	1	5	6	1	0	7	0	0
10	44057318	.	C	T	5	4	9	0	0	9	0	0
10	44131346	.	A	G	4	5	9	0	0	9	0	0
10	44146313	.	C	T	10	11	21	0	1	22	0	0
10	44155428	.	C	T	10	11	21	0	2	23	0	0
10	44170593	.	G	T	10	10	20	0	0	21	1	0
10	44180299	.	C	T	10	11	21	0	0	21	0	0
10	44189322	.	G	A	6	12	18	0	1	19	0	0
10	44314569	.	C	T	10	7	17	0	2	19	0	0
10	44314579	.	A	G	9	9	18	0	0	18	0	0
10	44320823	.	G	C	6	7	13	0	0	13	0	0
10	44340944	.	C	T	4	3	7	0	0	7	0	0
10	44346449	.	T	C	2	0	2	0	3	5	0	0
10	44363242	.	G	T	8	8	16	0	0	16	0	0
10	44364604	.	A	T	10	5	15	0	0	15	0	0
10	44364610	.	C	T	11	6	17	0	0	17	0	0
10	44371710	.	G	T	2	15	17	0	9	26	0	0
10	44375738	.	T	G	9	0	9	0	5	14	0	0
10	44375785	.	G	A	0	8	8	0	7	15	0	0
10	44410082	.	C	T	8	3	11	0	0	11	0	0
10	44410088	.	G	A	2	8	10	0	1	11	0	0
10	44437145	.	T	C	16	13	29	0	1	30	0	0
10	44466844	.	G	A	6	3	9	0	0	9	0	0
10	44503882	.	G	A	6	7	13	0	0	13	0	0
10	44506313	.	C	T	0	2	2	0	4	6	0	0
10	44513232	.	T	C	5	3	8	0	0	8	0	0
10	44513270	.	T	C	5	0	5	0	3	8	0	0
10	44513307	.	T	C	6	2	8	0	1	9	0	0
10	44513402	.	T	C	7	0	7	0	8	15	0	0
10	44513421	.	C	T	0	8	8	0	5	13	0	0
10	44516001	.	C	T	0	4	4	0	3	7	0	0
10	44516270	.	G	T	2	4	6	0	0	6	0	0
10	44516559	.	T	C	1	0	1	0	2	3	0	0
10	44517092	.	G	A	2	2	4	0	0	4	0	0
10	44517170	.	C	T	0	2	2	0	3	5	0	0
10	44581983	.	C	G	3	5	8	0	0	8	0	0
10	44640688	.	A	C	4	11	15	0	1	16	0	0
10	44640700	.	C	T	5	10	15	0	0	15	0	0
10	44640725	.	C	A	12	3	15	0	0	15	0	0
10	44640742	.	G	A	0	2	2	0	8	10	0	0
10	44640832	.	G	A	4	3	7	0	0	7	0	0
10	44640910	.	A	C	2	3	5	0	0	5	0	0
10	44641025	.	G	A	4	8	12	0	0	12	0	0
10	44648115	.	G	T	1	3	4	0	6	10	0	0
10	44648627	.	C	T	5	3	8	0	1	9	0	0
10	44650913	.	G	A	2	6	8	0	9	17	0	0
10	44652561	.	G	A	0	8	8	0	10	18	0	0
10	44656821	.	C	G	7	6	13	0	0	13	0	0
10	44656863	.	C	T	7	3	10	0	0	10	0	0
10	44656926	.	C	T	8	7	15	0	0	15	0	0
10	44659668	.	A	G	5	6	11	0	2	13	0	0
10	44663082	.	A	G	19	14	33	0	0	33	0	0
10	44665345	.	G	T	0	13	13	0	7	20	0	0
10	44665536	.	A	T	9	10	19	0	2	21	0	0
10	44665620	.	C	T	9	7	16	0	0	16	0	0
10	44667125	.	T	C	11	11	22	0	0	22	0	0
10	44669263	.	G	A	10	13	23	0	1	24	0	0
10	44671799	.	G	A	1	15	16	0	16	32	0	0
10	44671818	.	A	C	13	15	28	0	1	29	0	0
10	44672036	.	T	A	24	16	40	0	2	42	0	0
10	44672228	.	G	A	11	4	15	0	0	15	0	0
10	44692308	.	A	T	9	16	25	0	0	25	0	0
10	44692314	.	C	A	11	17	28	0	2	30	0	0
10	44693523	.	T	G	35	2	37	2	28	68	1	0
10	44693556	.	C	T	12	16	28	16	7	51	0	0
10	44693769	.	C	T	31	18	49	31	17	97	0	0
10	44693799	.	T	C	17	9	26	55	4	86	1	0
10	44693868	.	G	A	31	8	39	19	3	61	0	0
10	44694096	.	A	G	32	7	39	34	4	77	0	0
10	44694354	.	G	A	45	11	56	18	11	85	0	0
10	44738221	.	G	A	0	2	2	0	5	7	0	0
10	44738290	.	C	T	5	4	9	0	0	9	0	0
10	44745730	.	A	G	2	0	2	1	3	6	0	0
10	44900001	.	T	C	2	3	5	0	0	5	0	0
10	44900254	.	G	A	2	3	5	0	0	5	0	0
10	44900592	.	G	A	1	2	3	0	0	3	0	0
10	44900901	.	T	G	1	3	4	0	0	4	0	0
10	44905224	.	A	G	7	3	10	0	0	10	0	0
10	44914623	.	A	G	2	0	2	0	6	8	0	0
10	44914685	.	G	T	6	8	14	0	0	14	0	0
10	44914761	.	T	A	5	9	14	0	0	14	0	0
10	44940952	.	G	T	0	1	1	0	2	3	0	0
10	44941825	.	G	C	0	2	2	0	2	4	0	0
10	44979593	.	A	T	2	3	5	1	0	6	0	0
10	44979767	.	A	G	2	4	6	0	1	7	0	0
10	44979792	.	T	C	4	3	7	0	0	7	0	0
10	44980379	.	T	C	2	5	7	0	0	7	0	0
10	44980391	.	C	T	6	3	9	0	0	9	0	0
10	44980638	.	G	C	5	2	7	0	0	7	0	0
10	44980913	.	C	T	7	2	9	0	1	10	0	0
10	44989378	.	C	T	21	23	44	0	1	45	0	0
10	44989384	.	T	C	23	25	48	0	1	49	0	0
10	44990917	.	C	T	33	20	53	0	0	53	0	0
10	45046809	.	T	C	1	3	4	0	0	4	0	0
10	45053620	.	C	A	1	3	4	0	0	4	0	0
10	45055879	.	G	A	13	15	28	0	0	28	0	0
10	45055948	.	G	A	15	9	24	0	0	24	0	0
10	45059822	.	C	T	1	6	7	0	0	7	0	0
10	45064957	.	C	T	9	9	18	0	0	18	0	0
10	45085679	.	C	T	8	5	13	0	0	13	0	0
10	45089826	.	A	G	2	0	2	0	2	4	0	0
10	45099498	.	T	C	2	3	5	0	1	6	0	0
10	45099522	.	T	C	5	2	7	0	0	7	0	0
10	45101543	.	G	A	0	4	4	0	2	6	0	0
10	45103519	.	C	T	6	7	13	0	1	14	0	0
10	45105244	.	T	C	5	8	13	0	0	13	0	0
10	45175496	.	G	A	1	3	4	0	0	4	0	0
10	45179688	.	A	C	1	4	5	0	0	5	0	0
10	45180294	.	C	T	1	2	3	0	0	3	0	0
10	45180335	.	C	T	1	3	4	0	0	4	0	0
10	45187450	.	T	C	1	4	5	0	0	5	0	0
10	45187537	.	A	G	2	2	4	0	0	4	0	0
10	45190629	.	C	T	1	3	4	0	0	4	0	0
10	45203109	.	T	C	4	7	11	0	1	12	0	0
10	45203154	.	A	G	7	5	12	0	1	13	0	0
10	45203271	.	T	A	5	7	12	0	1	13	0	0
10	45203385	.	T	A	3	4	7	0	0	7	0	0
10	45203700	.	A	C	10	4	14	0	0	14	0	0
10	45203704	.	T	G	9	3	12	0	1	13	0	0
10	45203793	.	G	A	0	6	6	0	6	12	0	0
10	45204024	.	A	G	5	2	7	0	0	7	0	0
10	45204029	.	A	T	4	3	7	0	0	7	0	0
10	45204185	.	T	C	5	2	7	0	0	7	0	0
10	45204218	.	A	G	4	0	4	0	5	9	0	0
10	45204527	.	A	G	5	6	11	0	0	11	0	0
10	45204568	.	G	T	4	3	7	0	0	7	0	0
10	45205166	.	A	C	12	6	18	0	1	19	0	0
10	45205175	.	A	G	12	0	12	0	7	19	0	0
10	45205226	.	A	G	8	0	8	0	9	17	0	0
10	45205237	.	C	G	7	0	7	0	12	19	0	0
10	45205284	.	A	C	9	11	20	0	2	22	0	0
10	45205295	.	A	G	11	0	11	0	13	24	0	0
10	45205400	.	C	A	6	5	11	0	1	12	0	0
10	45205506	.	A	C	3	5	8	0	0	8	0	0
10	45205518	.	T	G	4	5	9	0	0	9	0	0
10	45206103	.	C	G	4	5	9	0	2	13	2	0
10	45206289	.	G	C	7	0	7	0	9	16	0	0
10	45206326	.	G	T	3	2	5	0	3	8	0	0
10	45206450	.	T	C	10	0	10	0	11	21	0	0
10	45208153	.	A	G	5	9	14	0	1	15	0	0
10	45208667	.	C	T	0	2	2	0	4	6	0	0
10	45208875	.	G	A	3	7	10	0	0	10	0	0
10	45208899	.	C	A	3	5	8	0	0	8	0	0
10	45213798	.	C	T	0	7	7	0	3	10	0	0
10	45248527	.	A	C	7	6	13	0	0	13	0	0
10	45248548	.	T	A	6	7	13	0	0	13	0	0
10	45248638	.	G	A	3	4	7	0	0	7	0	0
10	45313560	.	C	T	5	5	10	0	0	10	0	0
10	45313623	.	G	A	0	6	6	0	6	12	0	0
10	45313671	.	C	T	5	7	12	0	1	13	0	0
10	45322668	.	A	G	5	0	5	0	6	11	0	0
10	45325302	.	G	A	0	5	5	0	9	14	0	0
10	45336565	.	T	C	8	12	20	0	1	21	0	0
10	45340105	.	G	T	0	9	9	0	3	12	0	0
10	45340654	.	A	G	2	4	6	1	1	8	0	0
10	45340835	.	G	C	4	6	10	0	0	10	0	0
10	45341452	.	T	G	5	5	10	0	0	10	0	0
10	45341537	.	A	C	5	17	22	0	0	22	0	0
10	45341546	.	A	C	3	17	20	0	0	20	0	0
10	45341572	.	G	C	0	20	20	0	4	24	0	0
10	45341596	.	C	T	6	11	17	0	0	17	0	0
10	45341762	.	A	T	3	8	11	0	0	11	0	0
10	45349924	.	G	A	39	38	77	0	2	79	0	0
10	45351037	.	C	T	45	36	81	0	1	82	0	0
10	45352231	.	C	T	16	20	36	0	2	38	0	0
10	45375714	.	G	T	13	11	24	0	1	25	0	0
10	45375732	.	C	T	12	11	23	0	1	24	0	0
11	356174	.	C	T	7	11	18	0	0	18	0	0
11	356255	.	T	C	11	3	14	0	1	15	0	0
11	359403	.	A	G	15	0	15	0	6	21	0	0
11	359710	.	G	T	5	2	7	0	0	7	0	0
11	359740	.	T	A	3	2	5	0	0	5	0	0
11	359747	.	T	A	3	4	7	0	0	7	0	0
11	359775	.	A	C	2	3	5	0	0	5	0	0
11	410915	.	A	G	1	3	4	0	1	5	0	0
11	410965	.	C	T	1	2	3	0	0	3	0	0
11	411119	.	C	T	3	7	10	0	0	10	0	0
11	411207	.	A	T	2	6	8	0	0	8	0	0
11	411260	.	C	T	0	3	3	0	8	11	0	0
11	411424	.	T	C	7	7	14	0	0	14	0	0
11	411437	.	T	G	8	4	12	0	0	13	1	0
11	413080	.	A	G	2	5	7	1	0	8	0	0
11	413129	.	C	T	4	4	8	2	1	11	0	0
11	413180	.	T	G	7	5	12	1	0	13	0	0
11	413184	.	A	G	9	3	12	1	0	13	0	0
11	421405	.	G	A	1	2	3	0	0	3	0	0
11	421491	.	T	G	2	3	5	0	3	8	0	0
11	421513	.	G	T	5	3	8	0	0	8	0	0
11	421673	.	T	A	2	2	4	0	0	4	0	0
11	422609	.	G	C	1	2	3	0	0	3	0	0
11	429940	.	G	A	1	2	3	0	0	3	0	0
11	445266	.	C	T	1	5	6	0	2	8	0	0
11	446323	.	G	A	2	3	5	0	0	5	0	0
11	446351	.	A	G	3	0	3	0	3	6	0	0
11	447294	.	G	C	2	3	5	0	0	5	0	0
11	447386	.	C	T	2	3	5	0	0	5	0	0
11	448839	.	A	T	2	2	4	0	0	4	0	0
11	448845	.	T	C	2	2	4	0	0	4	0	0
11	449008	.	T	A	2	2	4	0	1	5	0	0
11	449161	.	C	A	2	4	6	0	1	7	0	0
11	449398	.	T	A	1	2	3	0	0	3	0	0
11	449409	.	A	T	1	2	3	0	0	3	0	0
11	449573	.	G	A	0	3	3	0	4	7	0	0
11	449752	.	A	G	2	1	3	0	5	8	0	0
11	457707	.	C	T	1	17	18	0	13	31	0	0
11	458062	.	G	A	12	16	28	0	1	29	0	0
11	458083	.	A	G	11	17	28	0	1	29	0	0
11	460665	.	C	T	1	8	9	0	7	16	0	0
11	460752	.	G	A	8	13	21	0	1	22	0	0
11	474556	.	C	T	1	3	4	0	0	4	0	0
11	474578	.	A	G	1	3	4	0	0	4	0	0
11	474619	.	A	T	1	4	5	0	1	6	0	0
11	474622	.	G	T	1	4	5	0	0	5	0	0
11	474662	.	C	G	2	6	8	0	0	8	0	0
11	474676	.	A	T	4	4	8	0	0	8	0	0
11	474917	.	C	A	4	9	13	0	0	13	0	0
11	474949	.	A	T	2	8	10	0	0	10	0	0
11	475112	.	T	C	2	6	8	0	0	8	0	0
11	475152	.	A	G	1	3	4	0	0	4	0	0
11	475314	.	C	T	2	5	7	0	0	7	0	0
11	475359	.	A	G	1	5	6	0	0	6	0	0
11	475376	.	T	A	1	4	5	0	0	5	0	0
11	475399	.	G	A	3	2	5	0	0	5	0	0
11	475524	.	G	A	2	4	6	0	0	6	0	0
11	475534	.	C	T	2	6	8	0	0	8	0	0
11	475603	.	G	C	1	4	5	0	0	5	0	0
11	475911	.	G	T	2	3	5	0	0	5	0	0
11	476145	.	G	T	4	2	6	0	1	7	0	0
11	480611	.	G	A	7	4	11	0	0	11	0	0
11	481943	.	A	T	11	7	18	0	0	18	0	0
11	482574	.	T	G	1	3	4	0	0	4	0	0
11	492659	.	C	T	2	34	36	0	23	59	0	0
11	494399	.	T	C	25	37	62	0	1	63	0	0
11	494405	.	A	G	24	36	60	0	5	65	0	0
11	495003	.	T	C	33	34	67	0	3	70	0	0
11	497532	.	T	C	2	2	4	0	1	5	0	0
11	517546	.	G	A	2	3	5	0	1	6	0	0
11	527956	.	C	T	11	4	15	1	0	16	0	0
11	532542	.	G	A	9	3	12	0	1	13	0	0
11	537386	.	G	A	0	2	2	0	2	4	0	0
11	537443	.	C	T	5	5	10	0	0	10	0	0
11	539425	.	T	C	7	11	18	0	1	19	0	0
11	539470	.	G	A	2	6	8	0	5	13	0	0
11	539573	.	A	C	11	4	15	1	1	17	0	0
11	539586	.	C	T	8	9	17	1	1	19	0	0
11	539899	.	T	C	5	3	8	0	1	9	0	0
11	539924	.	A	T	4	2	6	0	1	7	0	0
11	566562	.	G	A	6	13	19	30	0	49	0	0
11	570881	.	T	C	2	0	2	0	5	7	0	0
11	570942	.	C	T	6	4	10	0	0	10	0	0
11	570979	.	C	T	5	6	11	0	0	11	0	0
11	580812	.	A	T	9	4	13	1	0	14	0	0
11	588201	.	A	G	2	5	7	0	0	7	0	0
11	589785	.	C	T	6	7	13	0	0	13	0	0
11	592630	.	A	G	2	5	7	0	0	7	0	0
11	675382	.	G	C	32	22	54	1	2	57	0	0
11	675477	.	G	A	26	23	49	0	2	51	0	0
11	676888	.	G	A	27	23	50	0	2	52	0	0
11	676899	.	A	T	25	25	50	0	3	53	0	0
11	677089	.	A	T	15	17	32	0	2	34	0	0
11	687501	.	G	A	22	11	33	1	1	35	0	0
11	690601	.	C	T	3	18	21	0	20	41	0	0
11	691863	.	C	T	1	15	16	0	18	34	0	0
11	714954	.	G	A	0	4	4	0	1	5	0	0
11	717979	.	C	T	2	2	4	0	0	4	0	0
11	719800	.	G	T	15	21	36	0	3	39	0	0
11	1529657	.	A	G	13	4	17	0	0	17	0	0
11	1529838	.	A	G	11	10	21	0	0	21	0	0
11	1530234	.	A	G	29	7	36	0	1	37	0	0
11	1920009	.	C	T	0	2	2	0	1	3	0	0
11	2217510	.	T	C	5	2	7	0	0	7	0	0
11	2253154	.	G	A	6	3	9	0	4	13	0	0
11	2255025	.	T	G	4	6	10	0	1	11	0	0
11	2255027	.	T	G	5	6	11	0	0	11	0	0
11	2462734	.	A	G	8	4	12	0	2	14	0	0
11	2681998	.	A	G	1	2	3	0	0	3	0	0
11	2682700	.	A	G	10	3	13	0	0	13	0	0
11	2705657	.	A	G	11	7	18	0	2	20	0	0
11	2759425	.	A	G	2	2	4	1	1	6	0	0
11	2759461	.	T	C	5	10	15	0	0	15	0	0
11	2759475	.	G	T	6	15	21	0	0	21	0	0
11	2759498	.	G	A	7	17	24	2	1	27	0	0
11	2759541	.	C	A	3	14	17	3	2	22	0	0
11	2911501	.	C	T	2	3	5	2	0	7	0	0
11	3170359	.	A	G	2	0	2	0	2	4	0	0
11	3211974	.	G	C	2	2	4	0	0	4	0	0
11	3212009	.	T	C	2	4	6	0	0	6	0	0
11	3217970	.	C	T	2	2	4	0	0	4	0	0
11	3222192	.	T	C	1	3	4	0	0	4	0	0
11	3227343	.	G	A	1	3	4	0	0	4	0	0
11	3230284	.	G	A	2	4	6	0	1	7	0	0
11	3233455	.	T	G	2	3	5	0	0	5	0	0
11	3235516	.	G	A	2	3	5	0	0	5	0	0
11	3235543	.	C	T	2	2	4	0	0	4	0	0
11	3237023	.	T	C	1	5	6	0	0	6	0	0
11	3238720	.	T	C	7	4	11	0	2	13	0	0
11	3243316	.	T	C	5	9	14	0	0	14	0	0
11	3246120	.	A	G	5	8	13	0	0	13	0	0
11	3249158	.	A	G	2	0	2	0	5	7	0	0
11	3249253	.	C	T	1	6	7	0	0	7	0	0
11	3249268	.	T	C	2	4	6	0	0	6	0	0
11	3249334	.	T	C	6	4	10	0	0	10	0	0
11	3249346	.	C	T	6	4	10	0	0	10	0	0
11	3249370	.	A	G	5	0	5	0	5	10	0	0
11	3312137	.	T	C	18	8	26	0	0	26	0	0
11	3317226	.	T	C	14	16	30	0	0	30	0	0
11	3317229	.	G	T	13	16	29	0	0	29	0	0
11	3323411	.	A	G	4	6	10	0	0	10	0	0
11	3323414	.	G	A	4	6	10	0	0	10	0	0
11	3327445	.	G	C	2	3	5	0	0	5	0	0
11	3337038	.	A	G	32	38	70	0	4	74	0	0
11	3337253	.	A	G	33	38	71	0	1	72	0	0
11	3337256	.	T	C	35	3	38	0	35	73	0	0
11	3337698	.	T	A	31	19	50	0	0	50	0	0
11	3337718	.	G	C	24	21	45	0	2	47	0	0
11	3338060	.	C	G	30	23	53	0	1	54	0	0
11	3338144	.	T	C	35	27	62	1	3	66	0	0
11	3338236	.	T	C	41	0	41	0	23	64	0	0
11	3338288	.	T	A	49	17	66	0	0	66	0	0
11	3338299	.	T	G	42	16	58	0	1	59	0	0
11	3338431	.	C	T	2	39	41	0	22	63	0	0
11	3338491	.	G	A	23	29	52	0	5	57	0	0
11	3338514	.	C	A	31	28	59	0	4	63	0	0
11	3338624	.	G	A	32	26	58	0	5	63	0	0
11	3338638	.	A	G	35	27	62	0	2	64	0	0
11	3338708	.	A	G	37	28	65	0	3	68	0	0
11	3338813	.	T	C	32	0	32	0	26	58	0	0
11	3338933	.	A	G	30	22	52	0	2	54	0	0
11	3339107	.	C	T	1	25	26	0	18	44	0	0
11	3339425	.	G	A	28	39	67	0	0	67	0	0
11	3340306	.	G	A	23	15	38	0	1	39	0	0
11	3341350	.	C	G	2	21	23	0	21	44	0	0
11	3345676	.	A	G	5	5	10	0	0	10	0	0
11	3345716	.	T	C	6	5	11	0	1	12	0	0
11	3345779	.	T	C	4	2	6	0	0	6	0	0
11	3345877	.	T	C	4	2	6	0	0	6	0	0
11	3345900	.	G	A	5	4	9	0	0	9	0	0
11	3345952	.	T	C	6	6	12	0	0	12	0	0
11	3346128	.	T	G	4	3	7	0	0	7	0	0
11	3346797	.	T	C	1	0	1	0	4	5	0	0
11	3346806	.	A	T	4	2	6	0	0	6	0	0
11	3346919	.	C	T	1	3	4	0	7	11	0	0
11	3346952	.	A	G	3	6	9	0	0	9	0	0
11	3347085	.	C	T	2	3	5	0	0	5	0	0
11	3347108	.	A	G	5	2	7	0	0	7	0	0
11	3347324	.	G	A	4	2	6	0	0	6	0	0
11	3347326	.	G	T	4	2	6	0	0	6	0	0
11	3347414	.	C	A	2	3	5	0	2	7	0	0
11	3347717	.	T	C	4	0	4	0	1	5	0	0
11	3347727	.	T	C	2	0	2	0	2	4	0	0
11	3347779	.	C	T	2	3	5	0	0	5	0	0
11	3348185	.	A	G	3	3	6	0	0	6	0	0
11	3348194	.	A	C	3	2	5	0	1	6	0	0
11	3367686	.	C	A	1	3	4	0	1	5	0	0
11	3367924	.	G	C	12	11	23	0	2	25	0	0
11	3369891	.	A	G	4	10	14	0	0	14	0	0
11	3373418	.	A	G	7	10	17	0	2	19	0	0
11	3377127	.	T	C	1	0	1	0	11	12	0	0
11	3379999	.	G	T	1	12	13	0	1	14	0	0
11	3380012	.	C	G	2	11	13	0	1	14	0	0
11	3380135	.	A	G	4	6	10	0	0	10	0	0
11	3381243	.	T	A	3	4	7	0	0	7	0	0
11	3381261	.	C	A	2	5	7	0	0	7	0	0
11	3381290	.	A	G	2	4	6	0	0	6	0	0
11	3395069	.	G	A	17	6	23	0	2	25	0	0
11	3395070	.	A	T	18	5	23	0	2	25	0	0
11	3395303	.	G	A	17	10	27	0	0	27	0	0
11	3395324	.	C	T	14	12	26	0	1	27	0	0
11	3395501	.	A	G	13	6	19	0	1	20	0	0
11	3395693	.	A	T	10	7	17	0	0	17	0	0
11	3395699	.	G	A	10	7	17	0	0	17	0	0
11	3398738	.	A	C	6	0	6	0	8	14	0	0
11	3401899	.	C	A	5	8	13	0	0	13	0	0
11	3422086	.	T	C	2	3	5	0	0	5	0	0
11	3425136	.	G	A	3	6	9	0	0	9	0	0
11	3425175	.	G	A	7	8	15	0	0	15	0	0
11	3499197	.	G	A	4	2	6	0	0	6	0	0
11	3499204	.	G	T	4	2	6	0	0	6	0	0
11	3510055	.	G	A	0	3	3	0	2	5	0	0
11	3510067	.	A	G	2	3	5	0	0	5	0	0
11	3520631	.	A	G	1	2	3	0	0	3	0	0
11	3523493	.	G	A	11	8	19	0	0	19	0	0
11	3523976	.	A	C	8	0	8	0	10	18	0	0
11	3524111	.	G	A	12	10	22	0	1	23	0	0
11	3524196	.	A	G	16	17	33	0	2	35	0	0
11	3524236	.	C	T	17	15	32	0	0	32	0	0
11	3524591	.	G	A	4	7	11	0	3	14	0	0
11	3524715	.	A	C	5	5	10	0	0	10	0	0
11	3526443	.	T	C	12	5	17	0	1	18	0	0
11	3526458	.	A	G	13	6	19	0	0	19	0	0
11	3526521	.	A	G	9	8	17	0	0	17	0	0
11	3526605	.	C	G	10	10	20	0	0	20	0	0
11	3528320	.	A	T	10	12	22	0	2	24	0	0
11	3530443	.	G	T	3	5	8	0	1	9	0	0
11	3530991	.	T	C	1	0	1	0	5	6	0	0
11	3532836	.	A	G	6	2	8	0	0	8	0	0
11	3533330	.	T	C	2	1	3	0	4	7	0	0
11	3533345	.	T	C	2	0	2	0	5	7	0	0
11	3551074	.	T	C	25	27	52	0	1	53	0	0
11	3551309	.	A	G	34	22	56	0	2	58	0	0
11	3551944	.	G	A	25	29	54	0	4	58	0	0
11	3551986	.	C	T	2	21	23	0	18	41	0	0
11	3563644	.	C	T	1	2	3	0	2	5	0	0
11	3563647	.	G	A	3	1	4	0	0	4	0	0
11	3593309	.	T	C	4	7	11	0	0	11	0	0
11	3593490	.	A	C	7	11	18	0	3	21	0	0
11	3593693	.	T	C	1	12	13	5	0	18	0	0
11	3593716	.	C	T	17	7	24	0	1	25	0	0
11	3593748	.	A	G	18	11	29	0	0	29	0	0
11	3593778	.	T	C	12	4	16	0	0	16	0	0
11	3593806	.	T	C	6	10	16	0	0	16	0	0
11	3593872	.	T	C	10	0	10	0	9	19	0	0
11	3593878	.	T	C	7	0	7	0	8	15	0	0
11	3594147	.	A	T	11	5	16	0	0	16	0	0
11	3594277	.	T	G	3	13	16	0	2	18	0	0
11	3594321	.	T	C	5	1	6	0	12	18	0	0
11	3594327	.	T	A	7	10	17	0	0	17	0	0
11	3594366	.	A	G	10	10	20	0	1	21	0	0
11	3594452	.	T	G	7	3	10	0	16	26	0	0
11	3594541	.	A	T	7	6	13	0	0	13	0	0
11	3594573	.	A	T	7	3	10	0	1	11	0	0
11	3594618	.	G	A	5	3	8	0	0	8	0	0
11	3594649	.	T	G	3	5	8	0	0	8	0	0
11	3595140	.	A	C	3	1	4	0	1	5	0	0
11	3595308	.	G	A	8	7	15	0	0	15	0	0
11	3595579	.	A	G	10	7	17	0	0	17	0	0
11	3602382	.	T	C	7	7	14	0	0	14	0	0
11	3606914	.	T	C	5	0	5	0	4	9	0	0
11	3609448	.	A	T	1	2	3	0	0	3	0	0
11	3609535	.	A	C	2	3	5	0	1	6	0	0
11	3848656	.	C	T	16	14	30	0	1	31	0	0
11	3858318	.	A	G	11	15	26	0	1	27	0	0
11	3860104	.	C	G	1	3	4	0	0	4	0	0
11	3860149	.	G	T	2	2	4	0	0	4	0	0
11	3860524	.	C	G	5	2	7	0	0	7	0	0
11	3893429	.	A	C	16	26	42	1	1	44	0	0
11	3893564	.	A	G	21	14	35	0	5	40	0	0
11	3893635	.	C	T	17	14	31	0	1	32	0	0
11	3893636	.	T	G	18	14	32	0	0	32	0	0
11	3893928	.	G	C	18	18	36	0	0	36	0	0
11	3893933	.	G	C	19	15	34	0	1	35	0	0
11	3894023	.	T	C	17	26	43	0	0	43	0	0
11	3898787	.	C	T	2	16	18	0	15	33	0	0
11	3899066	.	C	A	2	12	14	0	16	30	0	0
11	3901375	.	C	A	1	11	12	0	16	28	0	0
11	3901414	.	C	T	15	9	24	0	2	26	0	0
11	3901733	.	C	G	3	19	22	0	9	31	0	0
11	3904517	.	C	G	2	12	14	0	14	28	0	0
11	3904674	.	T	G	10	12	22	0	1	23	0	0
11	3905928	.	A	G	6	5	11	0	1	12	0	0
11	3910103	.	T	C	10	15	25	0	2	27	0	0
11	3910304	.	G	A	27	17	44	0	0	44	0	0
11	3910310	.	C	T	26	18	44	0	0	44	0	0
11	3913213	.	C	T	12	15	27	0	4	31	0	0
11	3917723	.	A	G	13	21	34	0	1	35	0	0
11	3922983	.	G	A	13	9	22	0	1	23	0	0
11	3925822	.	T	C	16	0	16	0	13	29	0	0
11	3925906	.	A	G	10	8	18	1	1	21	1	0
11	3925939	.	T	C	16	10	26	1	1	28	0	0
11	3927859	.	G	A	10	7	17	0	0	17	0	0
11	3928044	.	A	T	6	6	12	0	0	12	0	0
11	3928168	.	T	C	3	6	9	0	3	12	0	0
11	3934190	.	A	G	5	8	13	0	0	13	0	0
11	3934319	.	T	G	9	5	14	0	0	14	0	0
11	3936378	.	T	A	3	8	11	0	0	11	0	0
11	3941634	.	A	G	5	3	8	0	0	8	0	0
11	3941649	.	G	T	6	3	9	0	0	9	0	0
11	3941697	.	A	T	4	6	10	0	0	10	0	0
11	3954572	.	T	C	5	0	5	0	5	10	0	0
11	3959435	.	T	C	2	6	8	0	2	10	0	0
11	3962979	.	A	C	4	4	8	0	0	8	0	0
11	3963581	.	C	T	3	3	6	0	0	6	0	0
11	3963608	.	G	T	3	6	9	0	0	9	0	0
11	3963639	.	T	A	4	8	12	0	0	12	0	0
11	3965870	.	C	T	4	5	9	0	0	9	0	0
11	3965984	.	T	A	5	7	12	0	0	12	0	0
11	3967408	.	A	G	5	0	5	0	5	10	0	0
11	3967445	.	A	G	5	3	8	0	1	9	0	0
11	3968877	.	G	A	7	7	14	0	0	14	0	0
11	3968915	.	T	G	8	4	12	0	0	12	0	0
11	3968934	.	G	C	6	6	12	0	1	13	0	0
11	3970713	.	T	A	2	2	4	0	0	4	0	0
11	3972263	.	T	C	1	4	5	0	2	7	0	0
11	3972540	.	A	C	3	2	5	0	1	6	0	0
11	3972541	.	G	A	4	2	6	0	0	6	0	0
11	3975229	.	T	G	3	2	5	0	1	6	0	0
11	3989472	.	A	G	24	0	24	0	15	39	0	0
11	3993452	.	G	A	0	6	6	0	7	13	0	0
11	3995468	.	T	C	2	3	5	0	0	5	0	0
11	3995515	.	A	G	5	4	9	0	0	9	0	0
11	4006924	.	C	T	1	4	5	0	5	10	0	0
11	4006956	.	C	T	2	2	4	0	0	4	0	0
11	4010744	.	C	G	3	4	7	0	0	7	0	0
11	4010752	.	T	G	2	2	4	0	1	5	0	0
11	4010895	.	C	T	3	4	7	0	0	7	0	0
11	4011001	.	T	C	2	0	2	0	2	4	0	0
11	4014758	.	T	C	1	0	1	0	4	5	0	0
11	4026308	.	C	T	5	6	11	0	0	11	0	0
11	4113807	.	C	T	2	5	7	0	0	7	0	0
11	4131070	.	A	T	2	3	5	0	0	5	0	0
11	4131080	.	A	G	3	0	3	0	2	5	0	0
11	4131150	.	G	A	5	2	7	0	2	9	0	0
11	4131300	.	A	T	11	4	15	0	0	15	0	0
11	4131313	.	C	T	13	5	18	0	0	18	0	0
11	4131933	.	T	A	10	10	20	0	0	20	0	0
11	4132159	.	C	A	21	12	33	0	2	35	0	0
11	4132229	.	A	G	21	18	39	1	1	41	0	0
11	4132295	.	C	T	29	25	54	0	1	55	0	0
11	4132296	.	A	C	29	26	55	0	1	56	0	0
11	4132378	.	G	C	17	10	27	1	2	30	0	0
11	4132440	.	A	G	16	8	24	0	2	26	0	0
11	5635052	.	T	C	3	3	6	0	0	6	0	0
11	5640605	.	A	T	2	4	6	0	0	6	0	0
11	5646331	.	C	T	7	4	11	0	0	11	0	0
11	5648643	.	C	T	3	5	8	0	0	8	0	0
11	5658587	.	T	A	8	5	13	0	0	13	0	0
11	5658751	.	A	G	6	8	14	0	0	14	0	0
11	5658889	.	A	G	1	3	4	0	0	4	0	0
11	5659139	.	C	A	7	3	10	0	0	10	0	0
11	5659143	.	T	C	9	3	12	0	0	12	0	0
11	5659177	.	T	A	6	4	10	0	0	10	0	0
11	5666471	.	A	G	8	3	11	0	0	11	0	0
11	5669671	.	T	C	7	5	12	0	1	13	0	0
11	5669722	.	G	A	1	4	5	0	8	13	0	0
11	5669907	.	G	A	1	5	6	0	6	12	0	0
11	5669917	.	A	T	8	4	12	0	0	12	0	0
11	5669950	.	T	C	7	5	12	0	1	13	0	0
11	5674134	.	G	A	3	11	14	0	0	14	0	0
11	5674150	.	A	G	6	10	16	0	0	16	0	0
11	5674183	.	G	C	9	13	22	0	0	22	0	0
11	5674731	.	T	G	5	0	5	0	7	12	0	0
11	5799712	.	T	A	1	2	3	0	0	3	0	0
11	5817345	.	T	C	6	11	17	0	1	18	0	0
11	5817397	.	A	T	7	5	12	0	0	12	0	0
11	5817472	.	C	A	7	8	15	0	3	18	0	0
11	5821096	.	C	G	7	9	16	0	3	19	0	0
11	5825477	.	T	C	8	9	17	0	0	17	0	0
11	5836012	.	G	A	6	14	20	0	0	20	0	0
11	5836049	.	A	C	11	6	17	0	1	18	0	0
11	5843388	.	T	C	33	24	57	0	1	58	0	0
11	5844303	.	T	A	21	36	57	0	3	60	0	0
11	5844333	.	T	C	33	19	52	0	0	52	0	0
11	5844525	.	G	A	19	33	52	0	5	57	0	0
11	5844579	.	G	A	3	29	32	0	25	57	0	0
11	5847511	.	G	A	37	25	62	0	2	64	0	0
11	5852424	.	G	T	2	31	33	2	24	59	0	0
11	5865356	.	A	C	1	0	1	0	3	4	0	0
11	5923138	.	T	C	2	0	2	0	10	12	0	0
11	5923335	.	C	A	16	16	32	0	2	34	0	0
11	5923515	.	G	A	1	3	4	0	3	7	0	0
11	5945410	.	A	T	0	3	3	0	0	3	0	0
11	5945836	.	A	T	2	4	6	0	0	6	0	0
11	5945840	.	G	A	2	5	7	0	0	7	0	0
11	5945919	.	T	A	5	9	14	0	0	14	0	0
11	5946023	.	T	A	14	14	28	0	2	30	0	0
11	5946564	.	T	C	14	14	28	0	1	29	0	0
11	5946854	.	G	C	13	19	32	0	2	34	0	0
11	5947191	.	T	G	13	15	28	0	0	28	0	0
11	5953436	.	G	T	12	8	20	0	0	20	0	0
11	5953521	.	T	C	10	0	10	0	6	16	0	0
11	5953547	.	C	T	1	6	7	0	14	21	0	0
11	5965671	.	T	G	0	3	3	0	2	5	0	0
11	5965674	.	T	C	1	4	5	0	0	5	0	0
11	5966209	.	G	A	1	4	5	0	0	5	0	0
11	5966215	.	G	A	1	4	5	0	0	5	0	0
11	5967285	.	T	G	6	3	9	0	0	9	0	0
11	5991089	.	G	A	1	2	3	0	0	3	0	0
11	6051362	.	C	G	2	4	6	0	0	6	0	0
11	6051431	.	G	A	11	4	15	0	1	16	0	0
11	6051632	.	G	A	10	5	15	0	0	15	0	0
11	6051648	.	C	T	0	5	5	0	9	14	0	0
11	6051679	.	C	T	12	5	17	0	1	18	0	0
11	6051880	.	A	C	7	2	9	0	12	21	0	0
11	6057335	.	G	A	6	10	16	0	1	17	0	0
11	6062107	.	T	A	7	5	12	0	0	13	1	0
11	6064265	.	C	T	3	3	6	0	0	6	0	0
11	6072558	.	A	G	2	2	4	0	0	4	0	0
11	6096310	.	G	T	1	2	3	0	0	3	0	0
11	6115824	.	T	C	1	2	3	0	0	3	0	0
11	6124566	.	A	G	3	0	3	0	2	5	0	0
11	6133293	.	G	C	6	3	9	0	0	9	0	0
11	6139323	.	A	G	1	2	3	0	0	3	0	0
11	6144450	.	T	C	4	4	8	0	0	8	0	0
11	6144604	.	A	T	3	2	5	0	1	6	0	0
11	6144607	.	T	G	3	3	6	0	0	6	0	0
11	6144776	.	T	C	4	2	6	0	0	6	0	0
11	6163570	.	C	T	2	2	4	0	0	4	0	0
11	6170596	.	C	A	3	3	6	0	0	6	0	0
11	6172327	.	G	A	3	2	5	0	1	6	0	0
11	6172366	.	T	G	4	4	8	0	1	9	0	0
11	6183030	.	T	C	18	12	30	0	0	30	0	0
11	6187412	.	C	G	3	12	15	0	9	24	0	0
11	6197446	.	A	T	3	5	8	0	1	9	0	0
11	6197495	.	C	T	2	6	8	0	8	16	0	0
11	6262189	.	T	C	3	3	6	0	0	6	0	0
11	6290039	.	C	T	4	2	6	0	0	6	0	0
11	6290147	.	C	T	1	2	3	0	0	3	0	0
11	6307055	.	A	G	2	0	2	0	2	4	0	0
11	6307059	.	A	T	2	2	4	0	0	4	0	0
11	6428893	.	G	T	17	17	34	0	0	34	0	0
11	6443604	.	A	G	8	2	10	0	1	11	0	0
11	6456177	.	C	T	9	8	17	0	1	18	0	0
11	6456447	.	C	T	4	4	8	0	0	8	0	0
11	6456677	.	T	C	18	16	34	0	0	34	0	0
11	6456829	.	C	T	17	26	43	0	0	43	0	0
11	6457442	.	G	A	12	7	19	0	6	25	0	0
11	6457473	.	C	A	10	7	17	0	3	20	0	0
11	6457500	.	A	T	13	6	19	0	0	19	0	0
11	6457518	.	T	C	18	7	25	0	0	25	0	0
11	6457594	.	C	A	4	6	10	0	1	11	0	0
11	6457619	.	T	C	3	6	9	0	0	9	0	0
11	6977580	.	G	A	3	3	6	0	1	7	0	0
11	6980178	.	A	C	1	2	3	0	0	3	0	0
11	6985237	.	A	G	1	3	4	0	0	4	0	0
11	9521168	.	T	G	2	2	4	0	2	6	0	0
11	9521169	.	A	G	3	3	6	0	0	6	0	0
11	9564328	.	T	G	7	10	17	0	1	18	0	0
11	9564746	.	G	A	3	4	7	0	0	7	0	0
11	9808328	.	A	T	1	2	3	0	0	3	0	0
11	9948161	.	G	C	1	3	4	0	0	4	0	0
11	9948356	.	G	A	1	2	3	0	0	3	0	0
11	10402081	.	G	A	8	4	12	0	0	12	0	0
11	10468079	.	G	T	5	2	7	0	0	7	0	0
11	10468268	.	T	C	1	2	3	0	0	3	0	0
11	10468756	.	T	C	5	2	7	0	0	7	0	0
11	10469401	.	G	A	1	4	5	0	0	5	0	0
11	10483198	.	A	C	1	3	4	0	0	4	0	0
11	10658836	.	T	G	1	2	3	0	0	3	0	0
11	10658845	.	A	G	1	0	1	0	2	3	0	0
11	10658906	.	T	G	4	2	6	0	0	6	0	0
11	10669933	.	G	T	30	29	59	0	1	61	1	0
11	10670112	.	T	A	20	15	35	0	2	37	0	0
11	10670394	.	C	T	23	26	49	0	2	51	0	0
11	10670435	.	T	C	37	2	39	0	12	51	0	0
11	10670439	.	T	C	21	22	43	0	5	50	2	0
11	10671525	.	A	G	20	27	47	1	0	48	0	0
11	10671546	.	A	G	16	22	38	1	0	39	0	0
11	10671578	.	A	T	18	17	35	1	0	36	0	0
11	10671636	.	C	T	1	9	10	0	11	21	0	0
11	10672136	.	C	T	5	4	9	0	2	11	0	0
11	10672250	.	T	C	4	1	5	0	3	8	0	0
11	10672260	.	T	G	3	3	6	0	0	6	0	0
11	10672707	.	T	G	17	13	30	0	1	31	0	0
11	10672726	.	T	A	20	11	31	0	2	33	0	0
11	10672750	.	T	C	18	11	29	0	1	30	0	0
11	10713757	.	G	A	5	9	14	0	0	14	0	0
11	10713796	.	C	T	3	4	7	0	0	7	0	0
11	10720178	.	C	T	8	10	18	0	1	19	0	0
11	10720232	.	G	C	9	10	19	0	0	19	0	0
11	10720271	.	C	T	0	8	8	0	4	12	0	0
11	10720295	.	A	G	2	6	8	0	0	8	0	0
11	10832957	.	G	T	20	17	37	0	1	38	0	0
11	10835571	.	T	C	15	0	15	0	21	36	0	0
11	10842537	.	T	C	13	1	14	0	16	30	0	0
11	10842714	.	A	C	7	0	7	0	14	21	0	0
11	10909461	.	G	A	0	7	7	0	7	14	0	0
11	10958321	.	A	G	8	1	9	0	4	13	0	0
11	10958507	.	A	G	7	0	7	0	4	11	0	0
11	10959499	.	T	A	8	6	14	0	0	15	1	0
11	11516279	.	T	C	7	0	7	0	3	10	0	0
11	11517450	.	T	G	1	2	3	0	0	3	0	0
11	11517480	.	G	C	1	3	4	0	0	4	0	0
11	11597221	.	T	C	2	2	4	0	1	5	0	0
11	11597374	.	A	G	10	17	27	0	0	27	0	0
11	11597401	.	C	A	9	22	31	0	1	32	0	0
11	11597523	.	A	G	19	12	31	0	1	32	0	0
11	11597798	.	A	T	17	18	35	0	1	36	0	0
11	11597985	.	A	T	12	5	17	0	3	20	0	0
11	11598334	.	G	C	12	18	30	0	1	31	0	0
11	11598692	.	C	A	21	19	40	0	0	40	0	0
11	11605172	.	T	C	12	0	12	0	13	25	0	0
11	11605744	.	C	T	2	11	13	0	15	28	0	0
11	11607492	.	G	A	5	15	20	0	0	20	0	0
11	11607498	.	C	G	4	15	19	0	1	20	0	0
11	11607579	.	A	C	4	2	6	0	13	19	0	0
11	11607594	.	G	A	7	17	24	0	1	25	0	0
11	11607705	.	C	T	12	7	19	0	0	19	0	0
11	11614681	.	T	G	5	10	15	0	0	15	0	0
11	11624909	.	C	T	3	2	5	0	1	6	0	0
11	11777535	.	A	T	1	2	3	0	0	3	0	0
11	11777540	.	G	A	1	2	3	0	0	3	0	0
11	11780816	.	A	T	0	4	4	0	1	5	0	0
11	11875643	.	C	T	1	2	3	0	1	4	0	0
11	11918439	.	T	C	6	0	6	0	5	11	0	0
11	11932967	.	C	T	0	4	4	0	2	6	0	0
11	11932998	.	A	G	3	4	7	0	0	7	0	0
11	11933117	.	G	A	1	2	3	0	0	3	0	0
11	11979494	.	A	G	5	2	7	0	0	7	0	0
11	11979495	.	C	T	0	1	1	0	6	7	0	0
11	11983710	.	T	C	9	1	10	0	7	17	0	0
11	11983713	.	A	C	9	7	16	0	2	18	0	0
11	11983748	.	A	C	10	0	10	0	5	15	0	0
11	11983789	.	G	T	6	7	13	0	0	13	0	0
11	11983827	.	C	T	9	3	12	0	0	12	0	0
11	11983937	.	T	C	9	4	13	0	1	14	0	0
11	11984043	.	T	A	4	4	8	0	1	9	0	0
11	11984227	.	G	A	3	3	6	0	1	7	0	0
11	11984408	.	A	C	14	10	24	0	0	24	0	0
11	11984409	.	G	C	14	10	24	0	0	24	0	0
11	11984480	.	T	C	8	0	8	0	4	12	0	0
11	11984505	.	G	A	6	4	10	0	1	11	0	0
11	11984522	.	A	G	8	4	12	0	1	13	0	0
11	11984548	.	C	T	8	8	16	0	1	17	0	0
11	11984666	.	A	G	12	9	21	0	0	21	0	0
11	12004040	.	T	C	7	5	12	0	1	13	0	0
11	12004070	.	A	G	5	7	12	0	1	13	0	0
11	12004277	.	A	G	5	8	13	0	0	13	0	0
11	12004304	.	G	T	7	6	13	0	1	14	0	0
11	12011325	.	G	A	5	6	11	0	0	11	0	0
11	12016638	.	A	G	16	9	25	0	1	26	0	0
11	12050039	.	T	C	6	4	10	0	0	10	0	0
11	12050265	.	A	G	3	4	7	0	0	7	0	0
11	12050291	.	G	A	4	2	6	0	0	6	0	0
11	12051505	.	G	T	5	9	14	0	0	14	0	0
11	12118079	.	C	T	16	16	32	0	1	33	0	0
11	12118097	.	T	A	18	16	34	0	0	34	0	0
11	12136025	.	A	C	5	2	7	0	11	19	1	0
11	12141467	.	T	C	5	7	12	0	1	13	0	0
11	12141482	.	A	G	7	6	13	0	0	13	0	0
11	12145328	.	G	A	5	7	12	0	0	12	0	0
11	12158243	.	G	A	3	2	5	0	0	5	0	0
11	12727225	.	A	G	19	19	38	0	0	38	0	0
11	12727446	.	C	T	14	32	46	0	2	48	0	0
11	12727504	.	A	G	17	32	49	0	1	50	0	0
11	12727708	.	C	A	10	13	23	0	1	24	0	0
11	12727829	.	T	A	5	5	10	0	1	11	0	0
11	12727990	.	T	A	15	15	30	0	0	30	0	0
11	12727999	.	C	T	15	12	27	0	1	28	0	0
11	12732505	.	A	T	1	6	7	0	0	7	0	0
11	12732521	.	T	C	2	0	2	0	4	6	0	0
11	12732556	.	G	C	5	5	10	0	0	10	0	0
11	12732638	.	G	A	5	2	7	0	0	7	0	0
11	12732792	.	C	T	2	1	3	0	0	3	0	0
11	12732802	.	C	T	0	2	2	0	2	4	0	0
11	12733004	.	C	T	2	2	4	0	0	4	0	0
11	12733443	.	T	A	1	2	3	0	0	3	0	0
11	12733502	.	C	T	2	2	4	0	0	4	0	0
11	12733741	.	C	T	2	3	5	0	0	5	0	0
11	12733743	.	G	A	2	3	5	0	0	5	0	0
11	12733815	.	C	T	5	7	12	0	0	12	0	0
11	12733824	.	T	C	4	0	4	0	5	9	0	0
11	12733965	.	C	T	3	3	6	0	0	6	0	0
11	12734072	.	G	A	7	4	11	0	0	11	0	0
11	12734223	.	G	A	3	2	5	0	1	6	0	0
11	12743172	.	T	C	3	4	7	0	1	8	0	0
11	12743801	.	T	G	2	2	4	0	0	4	0	0
11	12743983	.	C	T	2	4	6	0	0	6	0	0
11	12744740	.	T	C	7	7	14	0	0	14	0	0
11	12751500	.	G	A	10	2	12	0	1	13	0	0
11	12751831	.	T	C	5	9	14	0	0	14	0	0
11	12759409	.	G	A	4	8	12	1	0	13	0	0
11	12759728	.	G	T	9	10	19	0	1	20	0	0
11	12759737	.	C	T	12	9	21	0	1	22	0	0
11	12767982	.	T	C	5	7	12	0	0	12	0	0
11	12768214	.	G	A	0	15	15	0	12	27	0	0
11	12768299	.	C	T	11	6	17	0	0	17	0	0
11	12782503	.	G	A	5	6	11	0	0	11	0	0
11	12782524	.	A	C	6	6	12	0	0	12	0	0
11	12782593	.	T	C	5	0	5	0	7	12	0	0
11	12782897	.	T	A	7	4	11	0	0	11	0	0
11	12782908	.	T	G	6	4	10	0	0	10	0	0
11	12783139	.	T	A	2	5	7	0	0	7	0	0
11	12784430	.	A	T	2	2	4	0	0	4	0	0
11	12833895	.	A	G	1	0	1	0	2	3	0	0
11	12839413	.	T	C	2	2	4	0	0	4	0	0
11	12845066	.	A	G	7	7	14	0	0	14	0	0
11	12845101	.	T	A	5	7	12	0	0	12	0	0
11	12845150	.	T	C	1	7	8	0	0	8	0	0
11	12845160	.	G	A	1	7	8	0	1	9	0	0
11	12858777	.	C	T	1	3	4	0	0	4	0	0
11	12858798	.	G	A	1	3	4	0	3	7	0	0
11	12858832	.	T	G	4	2	6	0	0	6	0	0
11	12860900	.	G	A	2	2	4	0	0	4	0	0
11	12864070	.	C	T	9	3	12	0	0	12	0	0
11	12864361	.	A	G	6	0	6	0	4	10	0	0
11	12987786	.	G	A	4	2	6	0	0	6	0	0
11	12988038	.	G	A	2	4	6	0	0	6	0	0
11	13055748	.	T	C	1	4	5	0	0	5	0	0
11	13062000	.	T	C	4	3	7	0	0	7	0	0
11	13062201	.	C	G	5	3	8	0	0	8	0	0
11	13067750	.	A	T	9	4	13	0	1	14	0	0
11	13071855	.	C	T	12	3	15	0	0	15	0	0
11	13079183	.	C	A	6	3	9	0	3	12	0	0
11	13082107	.	C	T	12	7	19	0	0	19	0	0
11	13085294	.	G	A	13	16	29	0	0	29	0	0
11	13088062	.	G	T	2	11	13	0	7	20	0	0
11	13094203	.	C	T	14	12	26	0	1	27	0	0
11	13094247	.	A	G	10	16	26	0	2	28	0	0
11	13094581	.	C	T	3	15	18	0	28	46	0	0
11	13094884	.	G	A	16	20	36	0	4	40	0	0
11	13094913	.	A	G	19	25	44	0	2	46	0	0
11	13094938	.	G	T	21	22	43	0	2	45	0	0
11	13101333	.	C	T	8	8	16	0	1	17	0	0
11	13101378	.	A	G	7	13	20	0	0	20	0	0
11	13104057	.	C	A	0	4	4	0	4	8	0	0
11	13176674	.	C	A	2	6	8	0	0	8	0	0
11	13181747	.	G	A	0	2	2	0	2	4	0	0
11	13182847	.	C	T	2	3	5	0	0	5	0	0
11	13186133	.	C	T	2	2	4	0	0	4	0	0
11	13186134	.	G	A	0	2	2	0	2	4	0	0
11	13188413	.	C	T	3	2	5	0	0	5	0	0
11	13189079	.	T	A	1	2	3	0	0	3	0	0
11	13208839	.	C	G	35	39	74	0	1	75	0	0
11	13209037	.	T	G	30	34	64	0	1	65	0	0
11	13209085	.	G	C	35	31	66	0	5	71	0	0
11	13210604	.	G	A	27	36	63	0	1	64	0	0
11	13210667	.	C	T	36	27	63	0	2	65	0	0
11	13210906	.	C	T	27	33	60	0	4	64	0	0
11	13212186	.	A	T	43	32	75	0	6	81	0	0
11	13212234	.	T	C	41	37	78	0	1	79	0	0
11	13212333	.	T	C	33	25	58	0	3	61	0	0
11	13212357	.	T	C	32	30	62	0	2	65	1	0
11	13212567	.	T	C	30	31	61	0	3	64	0	0
11	13212908	.	T	A	23	34	57	0	0	57	0	0
11	13280565	.	T	C	15	0	15	1	17	33	0	0
11	13280580	.	A	G	21	10	31	1	0	32	0	0
11	13281238	.	A	G	5	8	13	5	1	19	0	0
11	13281398	.	G	C	5	6	11	0	1	13	1	0
11	13281653	.	C	T	22	15	37	0	0	37	0	0
11	13281734	.	G	A	13	11	24	0	0	24	0	0
11	13282130	.	T	C	11	8	19	0	2	21	0	0
11	13282660	.	C	T	8	6	14	0	1	15	0	0
11	13282881	.	T	C	8	4	12	0	1	13	0	0
11	13282883	.	A	G	8	4	12	0	1	13	0	0
11	13283156	.	T	A	6	12	18	0	1	19	0	0
11	13283181	.	C	T	8	9	17	0	1	18	0	0
11	13283220	.	C	G	0	11	11	0	6	17	0	0
11	13283243	.	T	C	4	0	4	0	12	16	0	0
11	13283335	.	A	G	13	7	20	0	0	20	0	0
11	13283398	.	G	C	5	6	11	0	0	11	0	0
11	13283569	.	G	A	10	5	15	0	0	15	0	0
11	13292012	.	C	T	3	6	9	0	0	9	0	0
11	13292027	.	A	T	3	3	6	0	1	7	0	0
11	13297711	.	T	C	8	7	15	0	0	15	0	0
11	13304426	.	G	A	3	4	7	0	0	7	0	0
11	13305874	.	T	C	2	5	7	0	1	8	0	0
11	13305949	.	G	A	3	6	9	0	1	10	0	0
11	13341189	.	G	A	1	3	4	0	0	4	0	0
11	13341342	.	G	A	3	3	6	0	0	6	0	0
11	13341346	.	A	C	3	3	6	0	0	6	0	0
11	13445981	.	T	C	1	3	4	0	0	4	0	0
11	13446004	.	C	T	4	1	5	0	0	5	0	0
11	13446023	.	C	T	2	2	4	0	0	4	0	0
11	13480257	.	A	T	2	4	6	0	0	6	0	0
11	13485098	.	G	A	5	4	9	0	0	9	0	0
11	13485112	.	C	T	6	3	9	0	0	9	0	0
11	13503124	.	T	G	3	0	3	0	3	6	0	0
11	13504473	.	A	T	4	3	7	0	0	7	0	0
11	13505186	.	C	A	8	5	13	0	0	13	0	0
11	13505247	.	A	T	7	2	9	0	0	9	0	0
11	13530399	.	A	C	2	2	4	0	1	5	0	0
11	13530498	.	G	A	3	4	7	0	0	7	0	0
11	13531730	.	C	T	6	3	9	0	0	9	0	0
11	13531954	.	C	T	7	6	13	0	1	14	0	0
11	13532567	.	T	C	4	5	9	0	2	11	0	0
11	13533072	.	A	G	4	5	9	0	0	9	0	0
11	13533214	.	A	G	8	0	8	0	4	12	0	0
11	13533388	.	T	A	7	12	19	0	0	19	0	0
11	14015532	.	G	A	1	2	3	0	1	4	0	0
11	14017690	.	C	T	1	2	3	0	1	4	0	0
11	14061966	.	A	C	2	3	5	0	0	5	0	0
11	14061976	.	G	A	0	2	2	0	1	3	0	0
11	14062453	.	C	G	1	2	3	0	0	3	0	0
11	14063678	.	T	A	5	4	9	0	0	9	0	0
11	14063679	.	T	A	5	4	9	0	0	9	0	0
11	14064419	.	A	G	5	3	8	0	1	9	0	0
11	14064454	.	A	G	7	5	12	0	0	12	0	0
11	14064487	.	G	C	5	6	11	0	0	11	0	0
11	14073049	.	T	A	4	7	11	0	0	11	0	0
11	14073241	.	T	C	4	3	7	0	0	7	0	0
11	14073444	.	C	T	11	7	18	0	2	20	0	0
11	14073631	.	T	C	11	8	19	0	1	20	0	0
11	14073639	.	T	C	10	9	19	0	1	20	0	0
11	14073667	.	T	C	10	5	15	0	3	18	0	0
11	14073857	.	C	A	11	6	17	0	0	17	0	0
11	14073858	.	A	T	11	6	17	0	0	17	0	0
11	14074174	.	T	C	8	8	16	0	0	16	0	0
11	14074397	.	A	G	5	8	13	0	0	13	0	0
11	14074843	.	A	C	7	7	14	0	2	16	0	0
11	14119690	.	C	G	2	3	5	0	1	6	0	0
11	14137901	.	C	A	8	5	13	0	0	13	0	0
11	14137988	.	C	T	2	9	11	0	1	12	0	0
11	14138006	.	T	G	2	8	10	0	0	10	0	0
11	14143498	.	T	C	1	3	4	0	0	4	0	0
11	14148179	.	A	G	8	5	13	0	0	13	0	0
11	14148341	.	T	A	14	6	20	0	0	20	0	0
11	14159425	.	C	T	20	16	36	0	0	36	0	0
11	14159513	.	A	G	18	13	31	0	1	32	0	0
11	14159555	.	A	G	19	5	24	0	1	25	0	0
11	14159622	.	T	C	18	13	31	0	0	31	0	0
11	14159979	.	T	C	18	19	37	0	1	38	0	0
11	14160131	.	A	G	23	19	42	0	3	45	0	0
11	14160464	.	A	C	6	0	6	0	32	38	0	0
11	14160941	.	C	A	7	6	13	0	0	13	0	0
11	14161073	.	A	G	15	15	30	0	0	30	0	0
11	14161077	.	C	A	14	13	27	0	3	30	0	0
11	14161291	.	A	T	21	15	36	0	0	36	0	0
11	14161304	.	A	G	22	12	34	0	1	35	0	0
11	14199913	.	G	C	3	14	17	0	11	28	0	0
11	14249012	.	A	G	3	11	14	0	0	14	0	0
11	14267236	.	A	G	7	0	7	0	4	11	0	0
11	14310584	.	C	A	1	3	4	0	1	5	0	0
11	14318637	.	A	G	4	4	8	0	0	8	0	0
11	14318647	.	C	G	5	4	9	0	0	9	0	0
11	14338460	.	G	A	5	4	9	0	0	9	0	0
11	14340928	.	C	T	2	2	4	0	0	4	0	0
11	14340971	.	T	A	1	2	3	0	0	3	0	0
11	14341498	.	T	A	5	4	9	0	0	9	0	0
11	14341510	.	A	C	4	4	8	0	0	8	0	0
11	14341557	.	G	A	6	3	9	0	0	9	0	0
11	14341610	.	C	A	2	3	5	0	1	6	0	0
11	14341843	.	A	T	1	2	3	0	0	3	0	0
11	14343567	.	A	C	5	3	8	0	0	8	0	0
11	14343612	.	T	G	1	2	3	0	0	3	0	0
11	14344976	.	G	T	2	2	4	0	0	4	0	0
11	14344989	.	G	A	0	2	2	0	2	4	0	0
11	14345062	.	T	A	1	6	7	0	0	7	0	0
11	14345064	.	C	T	1	5	6	0	1	7	0	0
11	14345562	.	T	G	5	7	12	0	1	13	0	0
11	14345638	.	C	T	9	5	14	0	0	14	0	0
11	14345753	.	A	G	3	10	13	0	0	13	0	0
11	14345830	.	T	C	6	6	12	0	0	12	0	0
11	14345884	.	T	G	3	4	7	0	0	7	0	0
11	14345910	.	A	T	2	3	5	0	0	5	0	0
11	14346039	.	A	G	2	2	4	0	0	4	0	0
11	14431519	.	G	C	2	2	4	0	0	4	0	0
11	14639030	.	T	C	11	8	19	0	0	19	0	0
11	14640002	.	G	T	0	5	5	0	3	8	0	0
11	14676340	.	T	C	3	4	7	0	1	8	0	0
11	14676365	.	G	T	4	6	10	0	0	10	0	0
11	14676500	.	G	T	3	2	5	0	0	5	0	0
11	14676541	.	A	G	2	0	2	0	3	5	0	0
11	14676604	.	A	T	3	3	6	0	0	6	0	0
11	14749156	.	G	A	5	5	10	0	1	11	0	0
11	14751068	.	T	C	4	10	14	0	1	15	0	0
11	14956525	.	A	G	5	2	7	0	1	8	0	0
11	14957155	.	A	T	17	10	27	1	1	29	0	0
11	15000991	.	C	A	20	15	35	0	1	36	0	0
11	15018051	.	A	G	1	2	3	0	0	3	0	0
11	15250544	.	T	C	16	6	22	0	2	24	0	0
11	15586740	.	C	A	3	5	8	0	0	8	0	0
11	15586757	.	T	C	3	4	7	0	0	7	0	0
11	15586792	.	T	G	2	7	9	0	0	9	0	0
11	15833846	.	T	C	5	3	8	0	2	10	0	0
11	15915274	.	G	T	3	4	7	0	0	7	0	0
11	15972599	.	T	C	1	3	4	0	0	4	0	0
11	15972646	.	C	A	3	2	5	0	2	7	0	0
11	15975556	.	C	T	6	6	12	0	0	12	0	0
11	16005711	.	C	T	7	7	14	0	1	15	0	0
11	16005985	.	A	T	1	3	4	0	2	6	0	0
11	16006016	.	C	T	1	4	5	0	0	5	0	0
11	16006030	.	C	T	1	6	7	0	0	7	0	0
11	16006246	.	A	T	4	2	6	1	0	7	0	0
11	16006249	.	T	C	5	2	7	1	0	8	0	0
11	16006740	.	G	C	2	2	4	0	0	4	0	0
11	16006854	.	C	A	4	7	11	0	0	11	0	0
11	16007461	.	A	G	5	2	7	1	1	9	0	0
11	16010502	.	A	G	6	1	7	0	7	14	0	0
11	16010656	.	T	C	12	4	16	0	1	17	0	0
11	16010788	.	C	A	7	4	11	0	0	11	0	0
11	16010799	.	G	C	8	4	12	0	1	13	0	0
11	16010842	.	C	T	9	4	13	0	2	15	0	0
11	16010849	.	A	G	9	0	9	0	6	15	0	0
11	16010978	.	G	A	8	3	11	0	0	11	0	0
11	16010986	.	A	T	6	2	8	0	1	9	0	0
11	16011185	.	C	A	4	4	8	0	2	10	0	0
11	16011622	.	T	C	5	9	14	0	0	14	0	0
11	16011632	.	T	G	6	0	6	0	9	15	0	0
11	16011705	.	T	C	10	8	18	0	4	22	0	0
11	16011745	.	C	G	13	10	23	0	3	26	0	0
11	16011770	.	T	C	15	15	30	0	0	30	0	0
11	16011807	.	T	C	16	10	26	0	1	27	0	0
11	16011895	.	A	C	20	8	28	0	0	28	0	0
11	16012021	.	G	A	12	5	17	0	2	19	0	0
11	16012117	.	G	T	2	11	13	0	8	21	0	0
11	16012140	.	G	A	0	9	9	0	14	23	0	0
11	16012152	.	A	G	9	0	9	0	13	22	0	0
11	16012191	.	C	T	8	14	22	0	1	23	0	0
11	16012201	.	C	T	8	14	22	0	0	22	0	0
11	16012251	.	T	A	7	14	21	0	1	22	0	0
11	16012256	.	C	T	7	14	21	0	1	22	0	0
11	16012316	.	T	G	7	12	19	0	1	20	0	0
11	16012364	.	G	T	1	7	8	0	6	14	0	0
11	16012414	.	T	C	5	3	8	0	0	8	0	0
11	16012654	.	A	G	5	0	5	0	6	11	0	0
11	16012785	.	T	G	9	13	22	0	1	23	0	0
11	16012786	.	A	G	9	14	23	0	0	23	0	0
11	16012829	.	G	T	9	18	27	0	1	28	0	0
11	16012882	.	G	A	12	8	20	0	5	25	0	0
11	16013018	.	T	C	7	3	10	0	0	10	0	0
11	16013036	.	T	A	2	2	4	0	0	4	0	0
11	16064128	.	C	T	3	2	5	0	0	5	0	0
11	16099700	.	G	A	6	8	14	0	0	14	0	0
11	16104175	.	T	C	6	10	16	0	0	16	0	0
11	16115692	.	C	T	3	3	6	0	1	7	0	0
11	16143781	.	T	C	25	20	45	0	1	46	0	0
11	16143829	.	T	C	21	22	43	0	2	45	0	0
11	16152718	.	A	T	2	6	8	0	0	8	0	0
11	16153290	.	C	T	6	9	15	0	1	16	0	0
11	16158555	.	G	A	11	15	26	0	1	27	0	0
11	16159056	.	A	G	11	5	16	0	0	16	0	0
11	16159316	.	C	T	9	8	17	0	1	18	0	0
11	16159875	.	T	C	10	6	16	0	0	16	0	0
11	16159903	.	C	T	12	6	18	0	0	18	0	0
11	16160137	.	A	G	15	0	15	0	18	33	0	0
11	16165293	.	T	C	7	9	16	0	1	17	0	0
11	16165298	.	G	A	1	7	8	0	7	15	0	0
11	16165605	.	T	A	11	8	19	0	1	21	1	0
11	16165665	.	A	G	18	13	31	0	0	31	0	0
11	16165710	.	T	A	11	7	18	0	0	18	0	0
11	16165756	.	G	A	8	4	12	0	3	15	0	0
11	16180033	.	G	A	28	25	53	0	0	53	0	0
11	16184739	.	A	G	29	18	47	0	2	49	0	0
11	16184865	.	A	T	15	13	28	1	2	31	0	0
11	16237915	.	C	G	3	5	8	0	0	8	0	0
11	16585694	.	A	G	5	4	9	0	0	9	0	0
11	16585724	.	C	A	2	5	7	0	0	7	0	0
11	16585807	.	C	A	1	3	4	0	0	4	0	0
11	16586331	.	A	G	4	3	7	0	0	7	0	0
11	16586747	.	A	G	2	3	5	0	0	5	0	0
11	16738655	.	C	T	3	2	5	0	0	5	0	0
11	16738755	.	T	A	3	3	6	0	0	6	0	0
11	16739039	.	C	T	2	8	10	0	8	18	0	0
11	16849887	.	T	G	2	2	4	0	0	4	0	0
11	16849896	.	G	A	1	1	2	0	0	2	0	0
11	17511788	.	T	C	11	12	23	0	0	23	0	0
11	17511902	.	C	A	6	5	11	0	0	11	0	0
11	17511964	.	C	G	5	0	5	0	17	22	0	0
11	17512139	.	T	C	8	14	22	0	0	22	0	0
11	17512289	.	T	C	15	7	22	0	5	27	0	0
11	17512831	.	T	A	2	2	4	0	1	5	0	0
11	17513174	.	A	G	3	2	5	0	0	5	0	0
11	17513328	.	A	G	2	0	2	0	3	5	0	0
11	17513371	.	G	T	4	2	6	0	1	7	0	0
11	17513405	.	C	T	5	2	7	0	0	7	0	0
11	17513424	.	T	A	5	4	9	0	0	9	0	0
11	17513440	.	A	G	3	3	6	0	0	6	0	0
11	17513554	.	T	A	3	2	5	0	0	5	0	0
11	17597424	.	G	A	6	3	9	0	0	9	0	0
11	17713672	.	T	C	2	4	6	0	0	6	0	0
11	17726651	.	A	T	1	2	3	0	0	4	1	0
11	17757767	.	T	C	8	10	18	0	0	18	0	0
11	17757859	.	T	C	8	4	12	0	0	12	0	0
11	17757931	.	T	C	10	5	15	0	1	16	0	0
11	17758113	.	T	A	5	4	9	0	0	9	0	0
11	17763137	.	A	G	10	14	24	0	1	25	0	0
11	17763160	.	T	C	13	16	29	0	0	29	0	0
11	17763173	.	C	A	12	15	27	0	1	28	0	0
11	17763393	.	C	T	10	13	23	0	1	24	0	0
11	17765170	.	C	T	8	8	16	1	0	17	0	0
11	17765618	.	T	C	7	0	7	0	6	13	0	0
11	17769238	.	C	T	15	12	27	0	0	27	0	0
11	17769801	.	A	T	7	10	17	0	0	17	0	0
11	17770594	.	C	T	5	11	16	0	0	16	0	0
11	17770627	.	T	C	5	10	15	0	0	15	0	0
11	17771185	.	T	C	7	6	13	0	0	13	0	0
11	17771248	.	T	C	3	5	8	0	1	10	1	0
11	17771478	.	C	T	9	5	14	0	0	14	0	0
11	17774893	.	G	A	10	4	14	0	0	14	0	0
11	17774917	.	T	C	7	6	13	0	0	13	0	0
11	17774970	.	G	T	5	6	11	0	0	11	0	0
11	17778492	.	T	A	3	2	5	0	0	5	0	0
11	17778528	.	T	C	4	0	4	0	2	6	0	0
11	17778597	.	A	G	3	2	5	0	0	5	0	0
11	17778618	.	T	G	2	2	4	0	1	5	0	0
11	17778690	.	G	T	4	8	12	0	2	14	0	0
11	17778819	.	G	A	1	3	4	0	0	4	0	0
11	17778846	.	G	A	1	3	4	0	0	4	0	0
11	17779159	.	A	G	6	2	8	0	0	8	0	0
11	17779197	.	A	T	6	3	9	0	0	9	0	0
11	17779279	.	C	A	6	3	9	0	1	10	0	0
11	17779599	.	A	T	4	3	7	0	1	8	0	0
11	17779630	.	G	A	6	4	10	0	1	11	0	0
11	17779656	.	C	T	0	3	3	0	4	7	0	0
11	17782529	.	A	C	3	0	3	0	3	6	0	0
11	17782683	.	G	A	5	2	7	0	0	7	0	0
11	17782699	.	G	C	5	3	8	0	0	8	0	0
11	17782738	.	A	G	2	2	4	0	0	4	0	0
11	17785402	.	T	G	19	14	33	0	1	34	0	0
11	17785412	.	C	A	19	13	32	0	1	33	0	0
11	17785591	.	A	G	12	8	20	0	0	20	0	0
11	17789069	.	G	T	16	13	29	0	1	30	0	0
11	17789210	.	T	C	13	14	27	0	0	27	0	0
11	17789550	.	A	G	8	14	22	0	0	22	0	0
11	17792991	.	C	T	0	8	8	0	7	15	0	0
11	17793676	.	G	A	8	7	15	0	0	15	0	0
11	17796869	.	C	T	0	7	7	0	5	12	0	0
11	17797280	.	G	A	5	7	12	0	0	12	0	0
11	17984308	.	T	C	2	2	4	0	0	4	0	0
11	17984405	.	G	A	1	4	5	0	1	6	0	0
11	17984426	.	G	C	1	1	2	0	3	5	0	0
11	17984459	.	G	T	3	2	5	0	0	5	0	0
11	17987289	.	C	A	4	2	6	0	0	6	0	0
11	18223383	.	C	T	7	4	11	0	0	11	0	0
11	18238076	.	C	T	8	9	17	0	0	17	0	0
11	18244388	.	T	C	6	8	14	0	2	16	0	0
11	18271303	.	G	A	5	6	11	0	0	11	0	0
11	18277370	.	C	T	0	2	2	0	7	9	0	0
11	18277388	.	G	A	4	2	6	0	1	7	0	0
11	18283013	.	G	A	3	3	6	0	0	6	0	0
11	18283525	.	T	C	1	0	1	0	4	5	0	0
11	18287693	.	A	G	11	7	18	0	0	18	0	0
11	18287779	.	G	A	4	3	7	0	1	8	0	0
11	18287895	.	T	G	3	7	10	0	1	12	1	0
11	18287940	.	A	T	3	10	13	0	1	14	0	0
11	18288018	.	T	C	10	5	15	0	1	16	0	0
11	18288212	.	T	C	11	9	20	0	0	20	0	0
11	18289425	.	T	G	12	4	16	0	1	18	1	0
11	18290095	.	G	A	12	3	15	0	0	15	0	0
11	18291865	.	A	G	15	10	25	0	0	25	0	0
11	18291961	.	C	T	1	6	7	0	5	12	0	0
11	18292595	.	C	T	1	8	9	0	10	19	0	0
11	18292633	.	A	G	9	8	17	0	0	17	0	0
11	18292699	.	T	A	6	4	10	0	1	11	0	0
11	18293166	.	A	G	7	3	10	0	0	10	0	0
11	18294857	.	A	G	5	6	11	0	0	11	0	0
11	18295057	.	T	C	5	4	9	0	0	9	0	0
11	18299674	.	A	G	5	4	9	0	0	9	0	0
11	18304271	.	T	A	4	6	10	0	2	12	0	0
11	18305756	.	G	A	5	2	7	0	0	7	0	0
11	18305804	.	C	G	4	4	8	0	0	8	0	0
11	18309570	.	T	C	2	2	4	0	0	4	0	0
11	18315937	.	G	A	3	3	6	0	0	6	0	0
11	18315955	.	C	T	5	3	8	0	0	8	0	0
11	18345887	.	C	G	2	6	8	0	0	8	0	0
11	18346243	.	T	C	3	2	5	0	0	5	0	0
11	18346384	.	A	G	4	2	6	0	0	6	0	0
11	18346440	.	A	C	2	1	3	0	2	5	0	0
11	18346470	.	T	A	2	2	4	0	0	4	0	0
11	18397105	.	T	C	1	2	3	0	0	3	0	0
11	18397744	.	T	C	1	3	4	0	0	4	0	0
11	18398441	.	T	C	1	0	1	0	5	6	0	0
11	18398443	.	T	C	4	2	6	0	0	6	0	0
11	18398944	.	T	C	1	0	1	0	2	3	0	0
11	18535666	.	C	T	20	16	36	0	0	36	0	0
11	18535761	.	G	C	15	20	35	0	0	35	0	0
11	18537180	.	A	G	4	13	17	0	0	17	0	0
11	18537244	.	G	A	14	3	17	0	3	20	0	0
11	18537447	.	T	C	12	7	19	0	0	19	0	0
11	18537561	.	T	A	6	8	14	0	1	15	0	0
11	18538219	.	A	T	11	8	19	0	0	19	0	0
11	18538259	.	G	T	9	10	19	0	0	19	0	0
11	18538336	.	A	C	9	0	9	0	16	25	0	0
11	18538362	.	T	C	10	0	10	0	12	22	0	0
11	18542168	.	T	C	3	4	7	0	0	7	0	0
11	18542585	.	A	G	8	5	13	0	0	13	0	0
11	18543870	.	A	G	8	3	11	0	0	11	0	0
11	18546088	.	G	T	2	2	4	0	0	4	0	0
11	18546378	.	T	A	5	3	8	0	0	8	0	0
11	18547125	.	A	G	11	14	25	0	1	26	0	0
11	18551011	.	C	A	0	6	6	0	7	13	0	0
11	18551077	.	G	A	7	4	11	0	0	11	0	0
11	18551089	.	G	A	4	8	12	0	0	12	0	0
11	18551605	.	C	T	1	6	7	0	6	13	0	0
11	18552231	.	A	T	6	3	9	0	0	9	0	0
11	18568971	.	G	A	9	7	16	0	0	16	0	0
11	18572364	.	T	C	8	0	8	0	20	28	0	0
11	18572574	.	G	A	11	14	25	0	1	26	0	0
11	18572586	.	C	T	14	15	29	0	0	29	0	0
11	18572640	.	T	G	12	9	21	0	2	23	0	0
11	18572648	.	G	A	14	8	22	0	1	23	0	0
11	18572751	.	G	A	15	7	22	0	0	22	0	0
11	18575095	.	C	A	3	7	10	1	1	12	0	0
11	18575161	.	C	G	4	8	12	0	0	12	0	0
11	18575173	.	G	T	4	6	10	0	1	11	0	0
11	18575258	.	T	G	2	10	12	0	1	13	0	0
11	18575326	.	G	T	6	3	9	0	0	9	0	0
11	18577787	.	A	G	8	6	14	0	1	15	0	0
11	18579921	.	C	T	0	5	5	0	4	9	0	0
11	18580293	.	T	C	5	0	5	0	5	10	0	0
11	18586264	.	T	C	8	1	9	0	4	13	0	0
11	18592065	.	A	G	3	3	6	0	0	6	0	0
11	18665791	.	A	T	1	3	4	0	0	4	0	0
11	18678321	.	T	C	2	4	6	0	0	6	0	0
11	18678344	.	T	G	1	4	5	0	0	5	0	0
11	18680982	.	G	C	2	3	5	0	0	5	0	0
11	18681382	.	A	G	3	0	3	0	2	5	0	0
11	18681547	.	A	G	1	0	1	0	2	3	0	0
11	18681607	.	G	A	6	6	12	0	0	12	0	0
11	18682694	.	A	G	4	8	12	0	0	12	0	0
11	18682826	.	T	C	5	3	8	0	0	8	0	0
11	18697720	.	A	G	8	7	15	1	2	18	0	0
11	18697817	.	T	G	8	8	16	0	0	16	0	0
11	18697822	.	A	G	9	0	9	0	9	18	0	0
11	18698184	.	G	A	1	6	7	0	4	11	0	0
11	18698221	.	A	C	5	2	7	0	1	8	0	0
11	18698526	.	G	A	7	5	12	0	1	13	0	0
11	18699104	.	T	C	11	10	21	0	2	23	0	0
11	18704378	.	G	C	8	0	8	0	3	11	0	0
11	18704500	.	G	A	11	11	22	0	0	22	0	0
11	18704620	.	C	T	3	9	12	0	13	25	0	0
11	18705108	.	A	G	13	9	22	0	1	23	0	0
11	18784949	.	A	T	9	5	14	0	0	14	0	0
11	18785130	.	A	G	16	20	36	0	1	37	0	0
11	18785250	.	C	T	1	25	26	0	18	44	0	0
11	18785294	.	T	G	15	19	34	0	2	36	0	0
11	18785296	.	C	T	14	21	35	0	0	35	0	0
11	18785346	.	A	T	19	18	37	0	0	37	0	0
11	18785410	.	G	A	10	20	30	0	1	31	0	0
11	18785421	.	A	G	7	20	27	0	0	27	0	0
11	18785570	.	T	A	5	7	12	0	0	12	0	0
11	18785600	.	A	T	7	4	11	0	0	11	0	0
11	18785623	.	A	T	5	4	9	0	0	9	0	0
11	18785749	.	C	G	3	2	5	0	0	5	0	0
11	18785921	.	G	A	6	18	24	0	0	24	0	0
11	18785975	.	T	C	12	13	25	0	3	28	0	0
11	18785997	.	T	A	9	13	22	0	1	23	0	0
11	18786085	.	A	T	11	10	21	0	1	22	0	0
11	18786250	.	A	C	20	22	42	0	1	43	0	0
11	18786329	.	C	A	1	24	25	0	18	43	0	0
11	18794157	.	C	A	0	9	9	0	6	15	0	0
11	18799800	.	C	T	5	10	15	0	0	15	0	0
11	18802815	.	G	C	4	3	7	0	0	7	0	0
11	18802865	.	C	G	4	3	7	0	0	7	0	0
11	18802879	.	A	G	5	3	8	0	0	8	0	0
11	18803621	.	A	G	5	3	8	0	0	8	0	0
11	18806030	.	A	G	3	3	6	0	1	7	0	0
11	18809354	.	G	A	2	3	5	0	0	5	0	0
11	18814506	.	T	G	1	2	3	0	0	3	0	0
11	18815957	.	C	T	2	2	4	0	0	4	0	0
11	19512520	.	T	C	2	0	2	0	3	5	0	0
11	19736506	.	A	G	6	2	8	0	0	8	0	0
11	20017802	.	A	G	7	5	12	0	0	12	0	0
11	21281657	.	T	C	22	7	29	0	0	29	0	0
11	21281673	.	T	C	19	9	28	0	0	28	0	0
11	21408243	.	T	C	11	6	17	1	0	18	0	0
11	21408328	.	T	C	10	4	14	0	1	15	0	0
11	22926272	.	C	A	12	4	16	0	1	17	0	0
11	23856440	.	A	G	2	6	8	1	1	10	0	0
11	23881683	.	A	T	2	2	4	0	0	4	0	0
11	24672292	.	C	T	1	3	4	0	0	4	0	0
11	25713768	.	T	C	8	8	16	0	0	16	0	0
11	25713820	.	T	C	6	7	13	0	1	14	0	0
11	25713821	.	T	C	10	3	13	0	1	14	0	0
11	25713913	.	T	C	3	11	14	0	0	14	0	0
11	26193327	.	C	T	6	2	8	0	0	8	0	0
11	26229587	.	T	C	7	4	11	0	3	14	0	0
11	26233522	.	A	T	2	4	6	0	2	8	0	0
11	26545779	.	A	G	3	3	6	0	0	6	0	0
11	26545819	.	A	G	4	4	8	0	0	8	0	0
11	29577968	.	C	T	5	2	7	0	1	8	0	0
11	29577970	.	T	C	4	2	6	0	2	8	0	0
11	29918069	.	T	C	4	10	14	1	1	16	0	0
11	29918070	.	T	C	3	12	15	1	0	16	0	0
11	29918168	.	T	C	5	8	13	0	0	13	0	0
11	29918203	.	T	C	3	7	10	0	1	11	0	0
11	30366816	.	T	A	5	2	7	0	0	7	0	0
11	30640826	.	A	G	1	0	1	0	2	3	0	0
11	30642164	.	A	G	6	5	11	0	0	11	0	0
11	31024887	.	A	G	7	8	15	0	1	16	0	0
11	31558251	.	G	A	0	2	2	0	9	11	0	0
11	31558634	.	C	A	15	7	22	0	0	22	0	0
11	31558782	.	C	T	9	7	16	0	2	18	0	0
11	31602828	.	G	T	7	17	24	0	0	24	0	0
11	31603346	.	G	A	0	6	6	0	5	11	0	0
11	31621001	.	C	G	1	1	2	0	0	2	0	0
11	31621018	.	T	C	1	2	3	0	0	3	0	0
11	31647283	.	A	C	13	7	20	0	1	21	0	0
11	31649781	.	G	A	1	13	14	0	12	26	0	0
11	31653670	.	T	G	10	1	11	0	7	18	0	0
11	31653700	.	T	C	9	4	13	0	0	13	0	0
11	31664070	.	T	C	11	7	18	0	0	18	0	0
11	31664108	.	T	C	10	10	20	0	1	21	0	0
11	31667490	.	C	A	10	10	20	0	0	20	0	0
11	31667592	.	C	T	13	14	27	0	0	27	0	0
11	31667658	.	C	T	15	14	29	0	1	30	0	0
11	31667946	.	G	A	10	16	26	0	2	28	0	0
11	31668186	.	A	G	6	4	10	0	0	14	4	0
11	31668191	.	A	T	6	2	8	0	0	12	4	0
11	31668330	.	C	A	10	13	23	0	1	24	0	0
11	31668394	.	T	G	6	9	15	0	0	15	0	0
11	31668540	.	T	A	3	7	10	0	0	10	0	0
11	31668824	.	T	A	12	5	17	0	2	19	0	0
11	31668849	.	A	T	8	5	13	0	0	13	0	0
11	31668893	.	T	C	4	3	7	0	0	7	0	0
11	31669343	.	A	G	4	0	4	0	6	10	0	0
11	31669637	.	G	A	1	3	4	0	10	14	0	0
11	31670216	.	A	T	7	5	12	1	0	13	0	0
11	31670605	.	T	A	3	5	8	0	0	8	0	0
11	31670610	.	A	T	3	7	10	0	0	10	0	0
11	31670724	.	A	G	6	0	6	0	5	11	0	0
11	31670749	.	C	A	4	5	9	0	1	10	0	0
11	31670789	.	C	T	5	7	12	0	0	12	0	0
11	31670808	.	C	A	5	8	13	0	0	13	0	0
11	31670830	.	T	C	7	9	16	0	0	16	0	0
11	31670868	.	T	C	9	6	15	0	0	15	0	0
11	31670881	.	T	A	9	7	16	0	0	16	0	0
11	31670920	.	G	A	0	5	5	0	11	16	0	0
11	31670935	.	G	A	9	4	13	0	0	13	0	0
11	31671326	.	G	T	0	12	12	0	4	16	0	0
11	31671328	.	T	G	4	11	15	0	1	16	0	0
11	32576695	.	C	T	9	2	11	0	2	13	0	0
11	32577076	.	T	A	2	7	9	0	0	9	0	0
11	32577258	.	C	T	3	7	10	0	13	23	0	0
11	32577404	.	A	G	10	20	30	0	3	33	0	0
11	32577439	.	G	A	15	10	25	2	4	31	0	0
11	32577800	.	G	A	20	11	31	0	1	32	0	0
11	32577830	.	G	A	21	12	33	0	2	35	0	0
11	32578082	.	C	T	18	14	32	0	3	35	0	0
11	32578172	.	G	A	23	10	33	0	0	33	0	0
11	32720124	.	C	T	21	16	37	0	0	37	0	0
11	32720427	.	A	T	13	10	23	0	0	23	0	0
11	32720730	.	C	G	10	7	17	0	0	17	0	0
11	32721057	.	T	A	8	6	14	0	0	14	0	0
11	32721144	.	A	G	8	7	15	0	0	15	0	0
11	32721168	.	A	G	8	9	17	0	1	18	0	0
11	32721333	.	A	G	3	10	13	0	1	14	0	0
11	32721492	.	A	C	5	0	5	0	5	10	0	0
11	32721498	.	T	G	7	3	10	0	0	10	0	0
11	32721765	.	A	G	5	5	10	0	1	11	0	0
11	32721843	.	G	A	4	5	9	0	0	9	0	0
11	32722547	.	A	G	2	4	6	0	1	7	0	0
11	33426583	.	C	T	1	2	3	0	0	3	0	0
11	33517742	.	T	C	3	2	5	0	0	5	0	0
11	33530220	.	A	G	2	2	4	0	2	6	0	0
11	33532289	.	A	G	3	3	6	0	0	6	0	0
11	33537289	.	G	T	0	2	2	0	1	3	0	0
11	33537327	.	A	G	1	2	3	0	1	4	0	0
11	33537435	.	C	T	3	4	7	0	0	7	0	0
11	33539693	.	T	C	3	3	6	0	0	6	0	0
11	33551200	.	T	C	9	17	26	0	1	27	0	0
11	33553873	.	T	C	6	10	16	0	0	16	0	0
11	33554087	.	G	A	9	4	13	0	1	14	0	0
11	33554116	.	G	A	9	9	18	0	2	20	0	0
11	33554535	.	T	C	6	6	12	0	0	12	0	0
11	33598972	.	A	G	1	2	3	0	0	3	0	0
11	33599038	.	T	C	6	4	10	0	1	11	0	0
11	33599148	.	T	C	13	9	22	0	0	22	0	0
11	33599187	.	T	C	11	0	11	0	8	19	0	0
11	33599223	.	A	G	12	10	22	0	1	23	0	0
11	33599240	.	A	T	12	10	22	0	2	24	0	0
11	33599464	.	C	T	1	7	8	0	8	16	0	0
11	33599535	.	T	G	2	3	5	0	1	6	0	0
11	33599542	.	G	A	1	3	4	0	2	6	0	0
11	33599900	.	C	T	1	5	6	0	6	12	0	0
11	33599938	.	T	C	3	4	7	0	0	7	0	0
11	33599943	.	T	C	4	2	6	0	0	6	0	0
11	33600742	.	A	T	7	4	11	0	2	13	0	0
11	33600862	.	G	A	6	2	8	0	1	9	0	0
11	33605227	.	A	G	4	4	8	0	0	8	0	0
11	33760460	.	A	G	3	2	5	0	0	5	0	0
11	33767093	.	A	G	2	0	2	0	3	5	0	0
11	33827023	.	G	A	5	6	11	0	0	11	0	0
11	33829443	.	A	G	6	7	13	0	1	14	0	0
11	33829515	.	A	G	5	8	13	0	1	14	0	0
11	33832679	.	C	T	4	12	16	0	1	17	0	0
11	33834700	.	A	G	10	13	23	0	0	23	0	0
11	33835385	.	C	A	4	16	20	0	0	20	0	0
11	33835542	.	T	C	6	10	16	0	1	17	0	0
11	33839169	.	C	T	10	16	26	0	0	26	0	0
11	33841788	.	C	T	9	24	33	0	2	35	0	0
11	33841984	.	C	T	7	12	19	0	1	20	0	0
11	33842542	.	C	T	5	8	13	0	0	13	0	0
11	33846519	.	T	C	7	7	14	0	2	16	0	0
11	33846657	.	G	A	4	3	7	0	1	8	0	0
11	33846729	.	T	C	7	0	7	0	6	13	0	0
11	33847080	.	T	G	4	2	6	0	1	7	0	0
11	33847123	.	C	T	4	3	7	0	1	8	0	0
11	33847293	.	G	A	5	5	10	0	1	11	0	0
11	33855666	.	G	A	5	3	8	0	1	9	0	0
11	33855703	.	C	T	6	3	9	0	0	9	0	0
11	33857576	.	A	C	2	7	9	0	0	9	0	0
11	33857580	.	G	A	2	7	9	0	0	9	0	0
11	33870464	.	A	T	4	3	7	0	0	7	0	0
11	33871343	.	G	T	4	9	13	0	0	13	0	0
11	33871358	.	G	T	6	8	14	0	1	15	0	0
11	33871378	.	G	T	8	10	18	0	1	19	0	0
11	33871466	.	A	G	26	9	35	3	0	38	0	0
11	33871575	.	A	G	30	14	44	0	0	44	0	0
11	33871897	.	C	T	18	4	22	1	3	26	0	0
11	33871931	.	G	C	21	3	24	1	0	25	0	0
11	33871932	.	C	A	20	3	23	1	1	25	0	0
11	33872029	.	C	T	1	7	8	1	15	24	0	0
11	33872038	.	G	C	9	0	9	1	11	21	0	0
11	33872289	.	T	C	14	0	14	0	8	22	0	0
11	33872411	.	A	C	13	8	21	0	0	21	0	0
11	33872442	.	A	G	13	4	17	0	0	17	0	0
11	33872564	.	G	T	18	11	29	1	0	30	0	0
11	33872699	.	A	G	15	6	21	0	0	21	0	0
11	33872759	.	A	G	10	6	16	0	0	16	0	0
11	33872763	.	A	C	9	5	14	0	1	15	0	0
11	33872829	.	C	T	1	10	11	0	10	21	0	0
11	33873539	.	C	T	0	8	8	0	9	17	0	0
11	33873578	.	A	C	13	8	21	0	1	22	0	0
11	33880086	.	A	G	9	5	14	0	0	14	0	0
11	33880089	.	C	T	0	5	5	0	10	15	0	0
11	33886999	.	C	T	8	2	10	0	0	10	0	0
11	33888884	.	G	A	6	5	11	0	0	11	0	0
11	33902072	.	T	C	2	2	4	0	0	4	0	0
11	33921537	.	A	T	1	3	4	0	0	4	0	0
11	33996829	.	G	C	1	2	3	0	0	3	0	0
11	33998436	.	A	T	3	2	5	0	0	5	0	0
11	33998560	.	G	T	2	2	4	0	1	5	0	0
11	34147172	.	C	T	2	2	4	0	0	4	0	0
11	34220012	.	C	T	0	2	2	0	1	3	0	0
11	34220022	.	T	C	1	1	2	0	1	3	0	0
11	34220083	.	G	A	1	2	3	0	1	4	0	0
11	34220129	.	C	T	6	4	10	0	0	10	0	0
11	34220436	.	T	C	6	0	6	0	4	10	0	0
11	34228050	.	C	T	1	2	3	0	1	4	0	0
11	34228108	.	G	A	3	2	5	0	0	5	0	0
11	34232662	.	A	G	2	4	6	0	0	6	0	0
11	34235427	.	C	A	9	12	21	0	0	21	0	0
11	34235498	.	C	G	7	6	13	0	0	13	0	0
11	34235528	.	T	C	5	5	10	0	0	10	0	0
11	34235825	.	A	T	13	16	29	0	0	29	0	0
11	34235858	.	A	C	12	13	25	0	0	25	0	0
11	34235918	.	A	G	18	0	18	0	11	29	0	0
11	34236092	.	G	T	11	5	16	0	1	17	0	0
11	34237150	.	C	T	6	6	12	0	1	13	0	0
11	34237217	.	A	G	6	6	12	0	1	13	0	0
11	34504122	.	T	C	3	0	3	0	2	5	0	0
11	34780009	.	T	C	6	2	8	0	4	12	0	0
11	34780333	.	G	A	6	3	9	0	2	11	0	0
11	34824331	.	G	A	4	2	6	0	0	6	0	0
11	34899393	.	A	G	10	3	13	1	1	15	0	0
11	34900464	.	C	T	4	5	9	0	1	10	0	0
11	34900516	.	A	G	5	3	8	0	0	8	0	0
11	34900521	.	C	T	5	3	8	0	0	8	0	0
11	34907287	.	G	C	3	6	9	0	1	10	0	0
11	34907649	.	T	G	1	2	3	0	0	3	0	0
11	34907682	.	A	G	1	2	3	0	0	3	0	0
11	34907726	.	T	A	3	3	6	0	1	7	0	0
11	34907876	.	T	A	2	6	8	0	0	8	0	0
11	34908165	.	C	T	3	5	8	0	0	8	0	0
11	34908187	.	G	C	3	8	11	0	0	11	0	0
11	34908201	.	C	T	2	7	9	0	0	9	0	0
11	34908431	.	G	A	6	8	14	0	0	14	0	0
11	34908448	.	T	A	10	6	16	0	0	16	0	0
11	34908516	.	C	A	6	7	13	0	1	14	0	0
11	34908545	.	A	T	2	5	7	0	0	7	0	0
11	34908597	.	T	C	4	3	7	0	0	7	0	0
11	34909268	.	T	A	7	8	15	0	0	15	0	0
11	34909288	.	G	T	0	6	6	0	6	12	0	0
11	34909353	.	C	A	6	5	11	0	0	11	0	0
11	34909489	.	A	G	4	2	6	0	1	7	0	0
11	34909513	.	G	T	2	4	6	0	0	6	0	0
11	34909618	.	A	G	4	5	9	0	0	9	0	0
11	34909868	.	C	T	8	3	11	0	0	11	0	0
11	34909916	.	C	T	4	7	11	0	0	11	0	0
11	34909997	.	G	T	5	11	16	0	2	18	0	0
11	34910349	.	C	T	15	5	20	0	0	20	0	0
11	34910468	.	T	C	9	9	18	0	1	19	0	0
11	34910487	.	T	C	12	9	21	0	1	22	0	0
11	34910503	.	C	T	11	10	21	0	0	21	0	0
11	34910644	.	C	T	3	3	6	0	0	6	0	0
11	34910654	.	C	T	6	3	9	0	0	9	0	0
11	34910867	.	T	A	8	4	12	0	2	14	0	0
11	34910897	.	A	G	6	5	11	0	2	13	0	0
11	34911229	.	G	A	15	7	22	1	1	24	0	0
11	34911445	.	A	G	8	13	21	0	0	21	0	0
11	34911451	.	T	A	8	13	21	0	0	21	0	0
11	34912481	.	G	A	16	20	36	0	1	37	0	0
11	34912616	.	G	A	18	19	37	0	0	37	0	0
11	34912850	.	G	A	16	15	31	1	0	32	0	0
11	34913101	.	C	A	9	9	18	0	0	18	0	0
11	34913307	.	T	A	15	8	23	0	0	23	0	0
11	34913370	.	T	A	15	22	37	0	3	40	0	0
11	34913454	.	G	A	6	5	11	0	1	12	0	0
11	34914190	.	G	A	18	21	39	0	0	39	0	0
11	35019847	.	C	T	8	10	18	0	1	19	0	0
11	35034669	.	G	A	18	12	30	0	0	30	0	0
11	35038124	.	G	C	0	12	12	0	7	19	0	0
11	35451765	.	A	G	1	7	8	0	1	9	0	0
11	36046521	.	T	A	2	2	4	0	0	4	0	0
11	36046523	.	A	C	2	2	4	0	0	4	0	0
11	36180612	.	C	T	2	5	7	0	0	7	0	0
11	36180666	.	C	T	1	2	3	0	0	3	0	0
11	36180876	.	C	A	1	2	3	0	0	3	0	0
11	36208199	.	G	A	5	7	12	0	1	13	0	0
11	36208328	.	G	A	0	4	4	0	6	10	0	0
11	36214517	.	C	T	16	10	26	0	2	28	0	0
11	36214601	.	G	A	0	23	23	0	13	36	0	0
11	36214815	.	G	A	1	10	11	0	16	27	0	0
11	36215346	.	G	A	14	15	29	0	0	29	0	0
11	36215459	.	A	G	9	8	17	0	1	18	0	0
11	36215584	.	G	C	5	3	8	0	0	8	0	0
11	36224573	.	G	A	4	3	7	0	0	7	0	0
11	36227568	.	C	A	2	3	5	0	0	5	0	0
11	36258658	.	T	C	1	2	3	0	0	3	0	0
11	36258699	.	A	G	3	3	6	0	0	6	0	0
11	36258951	.	A	G	14	9	23	0	0	23	0	0
11	36263954	.	A	G	11	12	23	0	2	25	0	0
11	36269682	.	G	A	8	7	15	0	0	15	0	0
11	36269768	.	A	G	10	7	17	0	1	18	0	0
11	36281881	.	A	G	4	8	12	0	0	12	0	0
11	36281939	.	T	G	3	5	8	0	1	9	0	0
11	36281943	.	G	A	4	4	8	0	0	8	0	0
11	36282081	.	A	T	7	10	17	0	0	17	0	0
11	36282636	.	A	C	2	4	6	0	0	6	0	0
11	36282647	.	A	C	1	5	6	0	0	6	0	0
11	36282809	.	T	C	1	2	3	0	0	3	0	0
11	36283433	.	C	A	3	2	5	0	0	5	0	0
11	36293926	.	G	A	1	2	3	0	0	3	0	0
11	36340801	.	C	T	2	3	5	0	0	5	0	0
11	36343167	.	G	C	19	18	37	0	1	38	0	0
11	36346572	.	A	T	16	9	25	0	1	26	0	0
11	36347775	.	C	T	7	17	24	0	0	24	0	0
11	36372889	.	G	A	1	2	3	0	0	3	0	0
11	36373353	.	A	T	2	7	9	1	1	11	0	0
11	36689068	.	T	C	2	4	6	0	1	7	0	0
11	36689254	.	C	T	1	4	5	0	4	9	0	0
11	36689328	.	G	C	8	3	11	0	0	11	0	0
11	36689344	.	A	G	7	2	9	0	1	10	0	0
11	36689372	.	T	G	4	3	7	0	0	7	0	0
11	36689426	.	T	C	3	5	8	0	2	10	0	0
11	36691478	.	T	C	6	0	6	0	9	15	0	0
11	36691538	.	T	A	4	3	7	0	0	7	0	0
11	36695076	.	A	G	5	3	8	0	0	8	0	0
11	36711355	.	G	A	1	2	3	0	0	3	0	0
11	36711376	.	T	C	1	2	3	0	0	3	0	0
11	36788527	.	T	A	12	12	24	0	0	24	0	0
11	36793616	.	A	C	6	4	10	0	1	11	0	0
11	36793730	.	T	G	11	9	20	0	0	20	0	0
11	36793760	.	A	C	11	4	15	0	1	16	0	0
11	36795564	.	G	T	12	7	19	0	1	20	0	0
11	36810576	.	A	G	6	8	14	1	2	17	0	0
11	36816163	.	T	C	10	3	13	0	1	14	0	0
11	36816171	.	T	C	5	7	12	0	0	12	0	0
11	36818832	.	G	T	7	2	9	0	0	9	0	0
11	36845432	.	T	C	1	0	1	0	4	6	1	0
11	36847101	.	T	G	5	2	7	0	0	8	1	0
11	36852890	.	G	A	1	2	3	0	0	3	0	0
11	36989853	.	T	A	2	4	6	0	0	6	0	0
11	36995476	.	C	T	3	4	7	0	0	7	0	0
11	37002607	.	C	T	6	5	11	0	0	11	0	0
11	37002616	.	G	A	6	7	13	0	0	13	0	0
11	37004565	.	G	A	1	4	5	0	0	5	0	0
11	37015968	.	T	C	3	6	9	0	0	9	0	0
11	37020807	.	G	T	2	4	6	0	1	7	0	0
11	37023776	.	T	C	2	7	9	0	1	11	1	0
11	37026948	.	T	C	7	2	9	1	0	10	0	0
11	37031950	.	C	T	6	3	9	0	0	9	0	0
11	37032250	.	A	G	1	3	4	0	0	4	0	0
11	37032391	.	A	G	2	1	3	0	2	5	0	0
11	37032474	.	A	G	6	2	8	0	1	9	0	0
11	37032880	.	G	T	5	5	10	0	0	10	0	0
11	37033356	.	G	T	4	3	7	0	0	7	0	0
11	37033431	.	G	A	2	2	4	0	0	4	0	0
11	37033552	.	A	G	1	0	1	0	5	6	0	0
11	37033676	.	C	T	5	7	12	0	0	12	0	0
11	37033813	.	C	G	2	9	11	0	0	11	0	0
11	37033846	.	G	C	8	9	17	0	0	17	0	0
11	37033855	.	T	A	8	9	17	0	0	17	0	0
11	37033900	.	A	T	3	4	7	0	1	8	0	0
11	37035069	.	A	C	3	6	9	0	1	10	0	0
11	37035176	.	A	T	6	4	10	0	0	10	0	0
11	37049792	.	A	G	5	2	7	0	0	7	0	0
11	37070083	.	T	C	3	2	5	0	0	5	0	0
11	37084157	.	T	C	4	5	9	0	0	9	0	0
11	37088693	.	C	T	0	2	2	0	1	3	0	0
11	37088827	.	C	T	2	3	5	0	1	6	0	0
11	37088847	.	A	T	2	5	7	0	1	8	0	0
11	37101377	.	A	G	1	3	4	0	0	4	0	0
11	37144704	.	C	T	1	6	7	0	0	7	0	0
11	37152069	.	G	A	1	4	5	0	0	5	0	0
11	37152812	.	G	C	5	5	10	0	0	10	0	0
11	37153681	.	C	T	2	2	4	0	0	4	0	0
11	37155215	.	A	G	3	0	3	0	8	11	0	0
11	37155247	.	A	T	3	7	10	0	2	12	0	0
11	37155394	.	A	G	8	8	16	0	2	18	0	0
11	37158818	.	T	C	8	6	14	0	0	14	0	0
11	37158932	.	A	T	6	9	15	0	1	16	0	0
11	37158947	.	C	A	7	7	14	0	2	16	0	0
11	37159289	.	T	A	10	11	21	0	1	22	0	0
11	37159517	.	T	A	3	8	11	0	2	13	0	0
11	37159961	.	A	T	3	3	6	0	0	6	0	0
11	37159977	.	A	T	4	5	9	0	0	9	0	0
11	37160052	.	T	A	7	8	15	0	0	15	0	0
11	37162529	.	G	A	9	3	12	0	0	12	0	0
11	37162563	.	C	A	10	6	16	0	0	16	0	0
11	37162564	.	A	T	8	5	13	0	3	16	0	0
11	37162657	.	C	A	16	4	20	0	0	20	0	0
11	37162666	.	G	T	13	3	16	0	1	17	0	0
11	37163760	.	T	C	1	8	9	0	0	9	0	0
11	37163997	.	T	A	8	12	20	0	0	20	0	0
11	37164456	.	G	A	10	5	15	0	0	15	0	0
11	37167402	.	A	G	7	0	7	0	4	11	0	0
11	37167603	.	A	G	6	5	11	0	0	11	0	0
11	37167669	.	C	T	11	5	16	0	0	16	0	0
11	37167699	.	A	T	9	6	15	0	0	15	0	0
11	37167834	.	T	C	11	11	22	0	0	22	0	0
11	37168039	.	A	T	11	5	16	0	1	17	0	0
11	37170054	.	T	A	6	2	8	0	0	8	0	0
11	37170109	.	T	C	3	4	7	0	0	7	0	0
11	37170409	.	A	G	20	0	20	0	23	43	0	0
11	37297678	.	C	T	21	12	33	0	1	34	0	0
11	37297681	.	A	G	20	12	32	0	1	36	3	0
11	37297811	.	A	T	17	27	44	0	2	46	0	0
11	37298499	.	C	T	15	24	39	0	0	39	0	0
11	37298569	.	A	G	20	22	42	1	2	45	0	0
11	37298755	.	G	A	12	12	24	0	1	25	0	0
11	37298882	.	G	A	16	13	29	0	1	30	0	0
11	37299378	.	A	T	18	17	35	0	2	37	0	0
11	37313177	.	C	T	6	10	16	0	3	19	0	0
11	37315716	.	G	C	2	5	7	0	0	7	0	0
11	37352035	.	A	C	3	2	5	0	0	5	0	0
11	37352044	.	C	T	3	2	5	0	0	5	0	0
11	37425317	.	C	T	1	2	3	0	0	3	0	0
11	37431953	.	C	T	30	23	53	1	2	56	0	0
11	37434533	.	A	G	17	20	37	0	1	38	0	0
11	37440957	.	A	C	25	24	49	0	1	50	0	0
11	37440990	.	A	G	20	21	41	0	3	44	0	0
11	37441021	.	G	A	21	26	47	0	1	48	0	0
11	37441053	.	C	G	1	18	19	0	22	41	0	0
11	37441086	.	A	G	19	17	36	0	3	39	0	0
11	37441257	.	T	G	26	23	49	0	1	50	0	0
11	37442134	.	G	A	14	15	29	0	0	29	0	0
11	37442671	.	G	A	13	14	27	0	0	27	0	0
11	37442752	.	C	G	13	6	19	0	0	19	0	0
11	37442772	.	G	T	12	5	17	0	0	17	0	0
11	37445219	.	A	G	16	8	24	0	2	26	0	0
11	37445327	.	G	A	16	9	25	0	1	26	0	0
11	37445502	.	T	C	12	1	13	0	20	33	0	0
11	37445680	.	C	T	13	8	21	0	1	22	0	0
11	37445774	.	G	A	9	6	15	0	0	15	0	0
11	37447402	.	T	G	2	3	5	0	1	6	0	0
11	37447595	.	C	G	1	5	6	0	6	12	0	0
11	37448374	.	G	A	3	6	9	0	0	9	0	0
11	37448396	.	T	C	2	7	9	0	0	9	0	0
11	37448894	.	G	A	5	4	9	0	0	9	0	0
11	37449089	.	C	T	0	3	3	0	5	8	0	0
11	37449415	.	T	A	1	3	4	0	4	8	0	0
11	37449599	.	C	T	5	2	7	0	0	7	0	0
11	37451120	.	G	A	4	4	8	0	0	8	0	0
11	37451201	.	C	T	1	3	4	0	0	4	0	0
11	37548492	.	A	G	6	3	9	0	0	9	0	0
11	37548618	.	A	T	5	4	9	0	1	10	0	0
11	37548646	.	A	G	5	3	8	0	0	8	0	0
11	37613515	.	G	A	27	18	45	0	0	45	0	0
11	37613572	.	C	T	12	19	31	0	0	31	0	0
11	37613633	.	G	A	1	17	18	0	12	30	0	0
11	37613641	.	A	G	18	13	31	0	0	31	0	0
11	37616372	.	T	A	17	19	36	0	1	37	0	0
11	37622121	.	G	T	18	19	37	0	0	37	0	0
11	37628230	.	C	T	40	21	61	0	0	61	0	0
11	37628595	.	T	C	26	15	41	0	2	43	0	0
11	37628816	.	T	C	17	22	39	0	1	40	0	0
11	37628831	.	C	T	18	20	38	0	3	41	0	0
11	37628863	.	T	A	19	20	39	0	0	39	0	0
11	37629046	.	G	A	21	22	43	0	1	44	0	0
11	37709119	.	C	T	6	10	16	1	0	17	0	0
11	37709133	.	G	A	8	5	13	1	1	15	0	0
11	37709222	.	C	T	10	10	20	1	0	21	0	0
11	37709359	.	C	T	3	4	7	0	0	7	0	0
11	37710096	.	C	T	3	3	6	0	0	6	0	0
11	37711582	.	T	C	2	6	8	0	0	8	0	0
11	37717543	.	C	T	1	2	3	0	4	7	0	0
11	37717702	.	G	T	4	3	7	0	0	7	0	0
11	37720622	.	C	A	15	10	25	0	6	31	0	0
11	37720658	.	G	A	18	17	35	0	2	37	0	0
11	37720671	.	A	G	15	12	27	0	1	28	0	0
11	37722445	.	G	A	13	28	41	0	0	41	0	0
11	37828866	.	T	C	1	3	4	0	0	4	0	0
11	37829740	.	C	T	1	3	4	0	0	4	0	0
11	37829859	.	A	C	4	3	7	0	0	7	0	0
11	37831034	.	T	C	4	4	8	0	0	8	0	0
11	37831360	.	C	A	3	2	5	0	0	5	0	0
11	37854047	.	T	G	1	2	3	0	0	3	0	0
11	37868358	.	C	T	5	2	7	0	0	7	0	0
11	38033189	.	A	G	4	3	7	0	0	7	0	0
11	38033520	.	A	G	2	2	4	0	1	5	0	0
11	38048821	.	G	A	3	4	7	0	0	7	0	0
11	38048875	.	C	A	5	4	9	0	1	10	0	0
11	38051016	.	G	A	2	2	4	0	0	4	0	0
11	38055477	.	G	A	1	3	4	0	0	4	0	0
11	38055627	.	C	T	0	4	4	0	2	6	0	0
11	38055653	.	T	C	4	2	6	0	0	6	0	0
11	38332405	.	T	A	7	4	11	0	0	11	0	0
11	38375925	.	C	G	6	0	6	0	5	11	0	0
11	38393213	.	G	A	0	6	6	0	12	18	0	0
11	38413037	.	G	A	13	9	22	0	0	22	0	0
11	38477156	.	A	C	1	4	5	0	0	5	0	0
11	38480665	.	A	G	2	2	4	0	0	4	0	0
11	38480718	.	C	G	1	2	3	0	0	3	0	0
11	38505453	.	T	C	5	3	8	0	0	8	0	0
11	38505781	.	A	G	3	6	9	0	1	10	0	0
11	38506401	.	A	T	2	8	10	0	0	10	0	0
11	38506463	.	T	C	2	2	4	0	1	5	0	0
11	38506543	.	A	G	1	4	5	0	0	5	0	0
11	38506571	.	A	C	1	2	3	0	0	3	0	0
11	38506790	.	A	T	3	6	9	0	0	9	0	0
11	38506794	.	T	C	3	6	9	0	0	9	0	0
11	38507918	.	A	G	3	4	7	0	0	7	0	0
11	38508269	.	A	G	1	3	4	0	0	4	0	0
11	38509205	.	G	A	2	2	4	0	0	4	0	0
11	38509219	.	T	C	2	2	4	0	0	4	0	0
11	38509901	.	A	C	2	3	5	0	0	5	0	0
11	38510019	.	G	A	1	2	3	0	0	3	0	0
11	38540870	.	G	A	28	12	40	0	1	41	0	0
11	38541063	.	T	A	16	21	37	0	1	38	0	0
11	38541100	.	A	C	16	21	37	0	0	37	0	0
11	38541371	.	T	C	25	1	26	0	17	43	0	0
11	38541401	.	C	G	20	22	42	0	1	43	0	0
11	38541484	.	A	G	18	11	29	5	1	35	0	0
11	38541708	.	A	C	9	16	25	0	0	25	0	0
11	38542003	.	G	A	20	19	39	1	1	41	0	0
11	38542088	.	A	T	15	20	35	0	0	35	0	0
11	38542171	.	G	T	17	16	33	0	1	34	0	0
11	38542218	.	G	A	14	17	31	0	3	34	0	0
11	38542305	.	C	T	29	19	48	0	0	48	0	0
11	38542308	.	G	A	28	18	46	0	0	46	0	0
11	38542655	.	T	C	21	1	22	0	24	46	0	0
11	38545826	.	G	T	22	23	45	0	1	46	0	0
11	38545874	.	C	G	5	23	28	0	23	51	0	0
11	38808113	.	C	T	5	6	11	0	0	11	0	0
11	38846046	.	C	T	6	9	15	0	1	16	0	0
11	38846301	.	T	G	5	0	5	0	9	14	0	0
11	38846316	.	T	A	12	4	16	0	0	16	0	0
11	38850244	.	G	A	1	5	6	0	9	15	0	0
11	38853397	.	A	T	8	13	21	0	0	21	0	0
11	38853511	.	A	G	10	6	16	0	0	16	0	0
11	38868012	.	G	T	19	12	31	0	0	31	0	0
11	38874937	.	G	A	24	16	40	0	2	42	0	0
11	38875221	.	A	G	15	16	31	0	1	32	0	0
11	38875283	.	A	T	20	19	39	0	2	41	0	0
11	38875352	.	G	A	15	21	36	0	1	37	0	0
11	38875397	.	T	G	14	21	35	0	0	35	0	0
11	38875484	.	A	C	12	16	28	0	0	28	0	0
11	38875498	.	C	A	16	13	29	0	1	30	0	0
11	38875660	.	T	C	14	19	33	0	1	34	0	0
11	38875867	.	T	C	2	8	10	0	0	10	0	0
11	38875897	.	T	C	2	5	7	0	0	7	0	0
11	38875912	.	A	G	3	3	6	0	0	6	0	0
11	38876156	.	T	A	0	2	2	0	1	3	0	0
11	39014553	.	G	A	12	4	16	0	2	18	0	0
11	39076138	.	C	T	0	3	3	0	7	10	0	0
11	39080933	.	G	A	1	4	5	0	0	5	0	0
11	39107156	.	C	T	6	8	14	0	0	14	0	0
11	39109555	.	C	T	6	6	12	0	1	13	0	0
11	39110046	.	C	T	7	6	13	0	2	15	0	0
11	39112035	.	A	G	7	8	15	0	1	16	0	0
11	39112068	.	C	T	6	4	10	0	0	10	0	0
11	39113887	.	G	A	3	3	6	0	0	6	0	0
11	39113899	.	T	C	1	4	5	0	0	5	0	0
11	39113986	.	C	T	1	2	3	0	2	5	0	0
11	39114037	.	G	A	4	2	6	0	0	6	0	0
11	39114678	.	T	C	0	2	2	0	1	3	0	0
11	39114682	.	C	T	1	2	3	0	0	3	0	0
11	39115165	.	G	T	1	2	3	0	0	3	0	0
11	39135393	.	C	T	25	20	45	0	0	45	0	0
11	39141527	.	A	G	22	28	50	0	2	52	0	0
11	39141732	.	T	G	10	11	21	0	0	21	0	0
11	39141924	.	G	T	14	9	23	0	1	24	0	0
11	39147065	.	T	C	11	16	27	0	1	28	0	0
11	39147085	.	C	T	12	14	26	0	1	27	0	0
11	39147387	.	T	C	15	15	30	0	2	32	0	0
11	39147445	.	G	C	16	17	33	1	5	39	0	0
11	39147857	.	G	C	13	16	29	0	3	32	0	0
11	39147905	.	C	A	17	16	33	0	1	34	0	0
11	39147906	.	A	T	17	16	33	0	1	34	0	0
11	39147989	.	T	C	25	15	40	0	4	44	0	0
11	39148015	.	C	T	17	18	35	0	5	40	0	0
11	39877711	.	C	T	5	5	10	0	0	10	0	0
11	39878200	.	A	G	7	0	7	0	9	16	0	0
11	39878442	.	A	C	14	9	23	0	0	23	0	0
11	39878503	.	C	A	13	4	17	0	0	17	0	0
11	39878558	.	A	C	6	8	14	0	1	15	0	0
11	39878740	.	G	A	9	8	17	0	0	17	0	0
11	39878788	.	T	A	6	9	15	0	0	15	0	0
11	39878882	.	A	T	2	8	10	0	1	11	0	0
11	39878980	.	C	T	10	6	16	0	0	16	0	0
11	39879009	.	C	G	6	8	14	0	0	14	0	0
11	39879242	.	C	A	9	6	15	0	1	16	0	0
11	39879316	.	A	G	7	9	16	0	0	16	0	0
11	39888410	.	T	A	6	7	13	0	0	13	0	0
11	39905164	.	C	T	13	11	24	0	0	24	0	0
11	39906110	.	C	T	10	19	29	0	1	30	0	0
11	39907021	.	C	G	19	14	33	0	1	34	0	0
11	39907585	.	G	A	7	15	22	0	2	24	0	0
11	39907618	.	C	G	10	19	29	0	0	29	0	0
11	39908020	.	T	G	15	14	29	0	1	30	0	0
11	39916450	.	G	A	6	14	20	0	3	23	0	0
11	39922402	.	G	A	2	23	25	0	16	41	0	0
11	39922407	.	G	A	20	22	42	0	0	42	0	0
11	39922714	.	A	C	17	14	31	0	0	31	0	0
11	39923551	.	T	A	22	19	41	0	0	41	0	0
11	39923653	.	C	T	17	18	35	0	3	38	0	0
11	39924083	.	A	T	20	25	45	0	1	46	0	0
11	39924235	.	G	C	17	9	26	0	1	27	0	0
11	39924243	.	G	T	18	7	25	0	3	28	0	0
11	39924341	.	C	G	12	19	31	0	0	31	0	0
11	39924358	.	T	C	11	22	33	0	1	34	0	0
11	39924413	.	G	A	17	20	37	0	0	37	0	0
11	39924639	.	C	T	25	22	47	0	1	48	0	0
11	39924652	.	C	T	21	25	46	0	2	48	0	0
11	39924711	.	A	T	17	24	41	0	1	42	0	0
11	39924736	.	A	G	16	19	35	0	3	38	0	0
11	39924783	.	T	A	17	23	40	0	2	42	0	0
11	39924784	.	A	T	17	23	40	0	3	43	0	0
11	39924929	.	G	A	13	11	24	1	4	29	0	0
11	39924946	.	C	T	15	18	33	1	1	35	0	0
11	39924989	.	G	T	21	23	44	0	0	44	0	0
11	39924999	.	C	T	23	20	43	0	0	43	0	0
11	39925225	.	C	A	19	24	43	0	2	45	0	0
11	39925458	.	G	A	22	14	36	0	4	40	0	0
11	39925529	.	C	T	25	19	44	0	2	46	0	0
11	39926041	.	C	T	30	20	50	0	1	51	0	0
11	39926216	.	A	G	11	21	32	0	2	34	0	0
11	39941661	.	A	G	11	0	11	0	8	19	0	0
11	39949703	.	C	T	8	5	13	0	0	13	0	0
11	39954026	.	T	G	7	8	15	0	1	16	0	0
11	39954319	.	G	A	3	6	9	0	8	17	0	0
11	39969082	.	A	T	2	4	6	0	0	6	0	0
11	39969102	.	C	T	2	3	5	0	0	5	0	0
11	39969123	.	T	A	2	2	4	0	1	5	0	0
11	39969260	.	A	C	1	3	4	0	0	4	0	0
11	39976568	.	G	T	3	2	5	0	0	5	0	0
11	39985311	.	A	G	2	2	4	0	1	5	0	0
11	39992283	.	T	C	2	2	4	0	0	4	0	0
11	39998695	.	T	G	5	4	9	0	0	9	0	0
11	39998697	.	T	G	5	0	5	0	4	9	0	0
11	40001792	.	T	C	4	3	7	0	0	7	0	0
11	40002096	.	A	T	5	5	10	0	0	10	0	0
11	40002228	.	T	G	4	5	9	0	0	9	0	0
11	40004643	.	G	A	2	2	4	0	0	4	0	0
11	40004887	.	C	A	4	4	8	0	0	8	0	0
11	40009040	.	T	C	3	5	8	0	1	9	0	0
11	40014079	.	A	G	11	5	16	0	1	17	0	0
11	40014346	.	G	A	5	7	12	0	0	12	0	0
11	40014961	.	G	A	7	3	10	0	0	10	0	0
11	40015113	.	G	A	6	7	13	0	1	14	0	0
11	40015380	.	C	G	4	2	6	0	0	6	0	0
11	40015529	.	T	C	7	2	9	0	0	9	0	0
11	40015537	.	G	A	7	3	10	0	0	10	0	0
11	40015696	.	C	T	4	3	7	0	0	7	0	0
11	40015797	.	A	G	3	2	5	0	1	6	0	0
11	40015849	.	A	C	4	4	8	0	0	8	0	0
11	40016032	.	A	G	10	8	18	0	0	18	0	0
11	40016253	.	C	T	4	3	7	0	0	7	0	0
11	40016261	.	A	T	3	4	7	0	1	8	0	0
11	40016477	.	T	C	6	3	9	0	0	9	0	0
11	40016524	.	G	A	0	5	5	0	2	7	0	0
11	40016528	.	T	C	1	6	7	0	0	7	0	0
11	40016649	.	A	C	5	6	11	0	0	12	1	0
11	40017183	.	G	T	9	8	17	1	0	18	0	0
11	40017290	.	G	C	7	7	14	0	0	14	0	0
11	40017501	.	A	T	8	4	12	0	0	12	0	0
11	40017504	.	T	A	7	7	14	0	0	14	0	0
11	40017604	.	T	C	3	9	12	0	0	12	0	0
11	40017698	.	T	C	13	7	20	0	0	20	0	0
11	40017829	.	A	G	6	6	12	0	2	14	0	0
11	40017865	.	T	A	3	7	10	0	0	10	0	0
11	40017885	.	G	A	3	8	11	0	0	11	0	0
11	40017949	.	A	T	12	6	18	0	0	18	0	0
11	40017994	.	T	C	18	6	24	0	2	26	0	0
11	40018042	.	T	C	17	15	32	0	0	32	0	0
11	40018633	.	G	A	6	5	11	0	0	11	0	0
11	40018799	.	G	T	0	4	4	0	11	15	0	0
11	40019076	.	G	A	3	5	8	0	0	8	0	0
11	40019078	.	A	G	4	0	4	1	5	10	0	0
11	40019276	.	A	C	11	6	17	0	2	19	0	0
11	40019278	.	T	A	11	5	16	0	3	19	0	0
11	40019411	.	C	T	5	8	13	2	2	17	0	0
11	40019422	.	G	T	6	4	10	2	1	13	0	0
11	40020303	.	A	G	15	4	19	0	1	20	0	0
11	40020304	.	G	C	15	4	19	0	1	20	0	0
11	40020441	.	G	A	5	3	8	0	0	8	0	0
11	40020460	.	T	C	5	4	9	0	0	9	0	0
11	40020683	.	G	T	9	16	25	0	0	25	0	0
11	40020928	.	G	A	16	10	26	0	1	27	0	0
11	40020950	.	A	G	9	6	15	0	0	15	0	0
11	40653819	.	G	A	4	3	7	0	0	7	0	0
11	40657839	.	G	A	12	9	21	0	8	29	0	0
11	40657905	.	G	A	10	8	18	0	5	23	0	0
11	40658022	.	C	T	21	6	27	0	0	27	0	0
11	40658232	.	C	T	8	11	19	0	1	20	0	0
11	40658322	.	T	G	6	2	8	0	0	8	0	0
11	40658352	.	G	A	0	8	8	0	4	12	0	0
11	40661378	.	T	C	7	12	19	1	1	21	0	0
11	40665494	.	C	T	10	9	19	0	0	19	0	0
11	40665602	.	G	T	2	16	18	0	13	31	0	0
11	40673658	.	T	G	11	28	39	0	2	41	0	0
11	40673797	.	C	T	13	20	33	0	1	34	0	0
11	40677967	.	T	C	39	16	55	0	2	57	0	0
11	40678445	.	A	C	32	0	32	0	36	68	0	0
11	40714942	.	A	C	1	1	2	0	2	4	0	0
11	40714945	.	G	A	1	2	3	0	0	3	0	0
11	40840238	.	T	C	6	6	12	0	0	12	0	0
11	40843028	.	A	G	3	2	5	0	2	7	0	0
11	40843055	.	G	T	1	8	9	0	5	14	0	0
11	40843064	.	C	A	3	8	11	0	1	12	0	0
11	40843439	.	A	G	4	0	4	0	3	7	0	0
11	40843502	.	C	T	9	8	17	0	1	18	0	0
11	40843835	.	G	A	2	5	7	0	9	16	0	0
11	40844085	.	T	G	3	3	6	0	0	6	0	0
11	40844094	.	C	T	4	2	6	0	0	6	0	0
11	40845006	.	C	T	20	10	30	0	4	34	0	0
11	40845071	.	C	T	8	6	14	0	0	14	0	0
11	40845080	.	G	A	1	4	5	0	6	11	0	0
11	40845117	.	T	C	3	4	7	0	0	7	0	0
11	41066190	.	T	G	17	0	17	0	13	30	0	0
11	41066871	.	C	T	11	11	22	0	2	24	0	0
11	41066888	.	C	T	8	13	21	0	1	22	0	0
11	41066950	.	A	G	7	18	25	0	1	26	0	0
11	41067275	.	G	A	5	14	19	0	0	19	0	0
11	41067430	.	A	T	5	7	12	0	2	14	0	0
11	41067442	.	C	T	6	9	15	0	1	16	0	0
11	41067488	.	A	C	2	13	15	0	0	15	0	0
11	41078522	.	C	A	5	4	9	0	1	10	0	0
11	41078578	.	A	T	11	5	16	0	1	17	0	0
11	41078762	.	A	T	14	15	29	0	1	30	0	0
11	41084325	.	T	G	18	12	30	0	3	33	0	0
11	41089631	.	G	T	1	4	5	0	0	5	0	0
11	41090478	.	A	C	2	3	5	0	0	5	0	0
11	41090479	.	A	C	1	3	4	0	0	4	0	0
11	41101666	.	A	G	9	8	17	0	2	19	0	0
11	41101760	.	A	T	4	3	7	0	0	7	0	0
11	41101866	.	C	T	3	7	10	0	1	11	0	0
11	41101910	.	G	A	3	5	8	0	0	8	0	0
11	41101918	.	C	T	3	6	9	0	0	9	0	0
11	41101948	.	A	G	1	1	2	0	7	9	0	0
11	41102013	.	A	G	3	0	3	0	4	7	0	0
11	41102026	.	T	C	3	2	5	0	1	6	0	0
11	41102205	.	A	G	7	3	10	0	1	11	0	0
11	41104549	.	A	G	5	8	13	0	0	13	0	0
11	41104934	.	G	A	6	9	15	0	1	16	0	0
11	41104954	.	C	T	9	11	20	0	2	22	0	0
11	41105030	.	G	A	0	9	9	0	5	14	0	0
11	41105144	.	T	G	5	0	5	0	6	11	0	0
11	41111301	.	A	G	12	10	22	0	0	22	0	0
11	41111334	.	T	C	11	10	21	0	0	21	0	0
11	41111370	.	C	T	8	9	17	0	0	17	0	0
11	41111422	.	A	G	4	7	11	0	1	12	0	0
11	41111431	.	A	C	3	5	8	0	0	8	0	0
11	41111603	.	T	A	1	5	6	0	0	6	0	0
11	41111735	.	G	A	4	4	8	0	0	8	0	0
11	41114055	.	C	T	0	3	3	0	3	6	0	0
11	41114090	.	G	T	3	6	9	0	1	10	0	0
11	41114186	.	A	C	5	5	10	0	0	10	0	0
11	41119769	.	A	G	1	5	6	0	1	7	0	0
11	41132195	.	A	G	6	5	11	0	0	11	0	0
11	41216254	.	C	G	0	3	3	0	2	5	0	0
11	41216315	.	C	T	1	4	5	0	4	9	0	0
11	41216445	.	A	C	4	5	9	0	0	9	0	0
11	41216455	.	T	C	5	0	5	0	6	11	0	0
11	41216505	.	G	C	3	7	10	0	0	10	0	0
11	41216586	.	C	T	5	4	9	0	0	9	0	0
11	41222940	.	A	G	10	14	24	0	0	24	0	0
11	41284762	.	C	T	4	7	11	0	1	12	0	0
11	41306035	.	G	A	1	2	3	0	5	8	0	0
11	41363814	.	T	C	8	10	18	0	0	18	0	0
11	41459981	.	G	C	2	22	24	0	24	48	0	0
11	41461369	.	T	C	23	24	47	0	1	48	0	0
11	41461417	.	C	G	35	13	48	0	2	50	0	0
11	41463534	.	C	G	23	21	44	3	2	49	0	0
11	41468791	.	C	T	13	28	41	2	3	46	0	0
11	41474041	.	T	A	7	8	15	0	2	17	0	0
11	41474042	.	G	T	8	8	16	0	0	16	0	0
11	41651124	.	G	T	1	7	8	0	3	11	0	0
11	41666612	.	A	C	2	3	5	0	0	5	0	0
11	41699856	.	C	G	4	5	9	0	1	10	0	0
11	41838873	.	G	A	2	2	4	0	0	4	0	0
11	41838877	.	T	A	3	2	5	0	0	5	0	0
11	41838999	.	G	T	5	7	12	0	1	13	0	0
11	41840490	.	A	G	3	0	3	0	5	8	0	0
11	41840493	.	T	C	4	4	8	0	1	9	0	0
11	41844192	.	C	A	5	8	13	0	0	13	0	0
11	41844342	.	T	C	7	12	19	0	1	20	0	0
11	41844396	.	A	G	4	1	5	0	9	14	0	0
11	41845849	.	G	A	0	3	3	0	6	9	0	0
11	41846057	.	G	C	1	2	3	0	0	3	0	0
11	41846151	.	C	A	5	3	8	0	2	10	0	0
11	41846429	.	C	A	10	9	19	0	1	20	0	0
11	41846430	.	C	A	1	8	9	0	11	20	0	0
11	41849977	.	C	T	0	6	6	0	10	16	0	0
11	41850058	.	A	G	4	5	9	0	0	9	0	0
11	41850559	.	G	A	10	6	16	0	0	16	0	0
11	41850565	.	G	A	9	5	14	0	1	15	0	0
11	41859518	.	G	A	1	2	3	0	0	3	0	0
11	41938594	.	G	A	8	2	10	0	0	10	0	0
11	41940293	.	G	A	3	3	6	0	0	6	0	0
11	41942440	.	T	C	2	4	6	0	1	7	0	0
11	41946225	.	A	G	2	6	8	1	0	9	0	0
11	41948344	.	C	T	3	3	6	0	0	6	0	0
11	41952555	.	C	T	3	4	7	0	0	7	0	0
11	41958013	.	C	T	7	4	11	0	0	11	0	0
11	41958058	.	C	T	12	5	17	0	0	17	0	0
11	41958278	.	A	T	11	9	20	0	0	20	0	0
11	41958317	.	T	C	9	7	16	0	0	16	0	0
11	41960058	.	A	C	4	17	21	0	0	21	0	0
11	41960059	.	C	T	4	16	20	0	1	21	0	0
11	41960101	.	A	G	7	18	25	0	0	25	0	0
11	41960111	.	C	T	7	17	24	0	0	24	0	0
11	41982546	.	G	A	0	3	3	0	1	4	0	0
11	42128555	.	T	A	5	5	10	0	0	10	0	0
11	42128561	.	G	A	5	5	10	0	0	10	0	0
11	42134733	.	C	G	3	3	6	0	0	6	0	0
11	42305824	.	C	T	7	7	14	0	1	15	0	0
11	42305868	.	C	A	0	6	6	0	6	12	0	0
11	42306057	.	C	T	7	5	12	2	1	15	0	0
11	42307344	.	T	G	9	13	22	0	1	23	0	0
11	42307671	.	G	A	14	10	24	0	0	24	0	0
11	42307816	.	C	T	1	10	11	0	19	30	0	0
11	42315366	.	G	C	8	12	20	0	0	20	0	0
11	42315414	.	A	C	11	0	11	0	7	18	0	0
11	42319372	.	C	A	10	12	22	0	0	22	0	0
11	42325520	.	G	A	10	9	19	0	1	20	0	0
11	42325535	.	C	T	12	6	18	0	0	18	0	0
11	42329113	.	C	T	11	12	23	0	2	25	0	0
11	42338894	.	T	C	6	1	7	0	18	25	0	0
11	42350787	.	G	A	14	6	20	0	1	21	0	0
11	42350793	.	G	A	13	6	19	0	1	20	0	0
11	42350847	.	C	T	6	8	14	0	1	15	0	0
11	42353054	.	G	A	11	12	23	0	1	24	0	0
11	42356032	.	C	T	5	9	14	0	0	14	0	0
11	42363236	.	G	A	7	8	15	0	0	15	0	0
11	42385761	.	A	T	5	2	7	0	0	7	0	0
11	42417409	.	T	C	2	5	7	0	0	7	0	0
11	42417956	.	C	T	0	3	3	0	2	5	0	0
11	42418042	.	G	A	3	4	7	0	0	7	0	0
11	42418246	.	C	T	5	8	13	0	0	13	0	0
11	42418268	.	A	G	7	11	18	0	0	18	0	0
11	42418310	.	A	T	5	5	10	0	0	10	0	0
11	42447389	.	C	T	1	2	3	0	0	3	0	0
11	42457216	.	C	T	3	5	8	0	0	8	0	0
11	42457261	.	T	C	2	4	6	0	0	6	0	0
11	42457328	.	A	C	2	3	5	0	0	5	0	0
11	42457503	.	T	C	2	2	4	0	0	4	0	0
11	42457645	.	C	T	1	2	3	0	0	3	0	0
11	42458482	.	A	G	6	2	8	0	0	8	0	0
11	42500584	.	C	G	1	2	3	0	0	3	0	0
11	42500619	.	G	T	2	2	4	0	0	4	0	0
11	42500950	.	A	G	1	3	4	0	0	4	0	0
11	42502031	.	C	T	4	6	10	0	1	11	0	0
11	42502080	.	G	A	1	8	9	0	6	15	0	0
11	42502108	.	T	A	3	5	8	0	0	8	0	0
11	42502212	.	A	G	4	7	11	0	0	11	0	0
11	42502261	.	T	C	0	6	6	0	0	6	0	0
11	42502313	.	G	T	5	2	7	0	0	7	0	0
11	42502328	.	C	T	2	4	6	0	0	6	0	0
11	42502349	.	A	G	0	0	0	0	5	5	0	0
11	42521958	.	T	A	2	4	6	0	0	6	0	0
11	42521985	.	G	A	5	4	9	0	1	10	0	0
11	42521999	.	G	A	6	4	10	0	1	11	0	0
11	42522076	.	C	A	1	2	3	0	1	4	0	0
11	42522162	.	A	T	4	4	8	0	0	8	0	0
11	42522304	.	G	A	1	2	3	0	0	3	0	0
11	42532938	.	G	C	3	2	5	0	1	6	0	0
11	42532943	.	C	T	3	2	5	0	0	5	0	0
11	42533180	.	C	G	0	8	8	0	5	13	0	0
11	42533237	.	G	A	9	9	18	0	2	20	0	0
11	42537988	.	G	C	3	4	7	0	0	7	0	0
11	42560439	.	G	A	27	30	57	0	2	59	0	0
11	42560475	.	C	T	33	26	59	0	3	62	0	0
11	42561212	.	C	A	5	4	9	0	0	9	0	0
11	42600818	.	G	T	0	2	2	0	3	5	0	0
11	42600856	.	A	T	3	3	6	0	0	6	0	0
11	42600867	.	A	T	3	3	6	0	0	6	0	0
11	42608394	.	T	C	4	5	9	0	0	9	0	0
11	42613179	.	G	T	1	3	4	0	2	6	0	0
11	42618675	.	A	G	8	0	8	0	8	16	0	0
11	42618726	.	C	T	5	5	10	0	1	11	0	0
11	42621491	.	G	A	1	3	4	0	6	10	0	0
11	42626276	.	C	T	3	11	14	0	0	14	0	0
11	42730834	.	C	G	19	20	39	0	1	40	0	0
11	42730895	.	C	T	18	11	29	0	2	31	0	0
11	42730901	.	C	T	19	13	32	0	1	33	0	0
11	42730931	.	C	T	18	19	37	0	1	38	0	0
11	42730974	.	T	A	13	19	32	0	3	35	0	0
11	42730982	.	T	C	14	19	33	0	2	35	0	0
11	42731172	.	G	C	15	16	31	0	2	33	0	0
11	42731173	.	G	T	15	18	33	0	0	33	0	0
11	42732575	.	A	G	2	3	5	0	1	6	0	0
11	42732602	.	T	C	1	2	3	0	0	3	0	0
11	42783922	.	G	A	0	2	2	0	1	3	0	0
11	42798519	.	A	G	2	0	2	0	4	6	0	0
11	42801451	.	A	T	4	3	7	0	2	9	0	0
11	42808988	.	C	T	6	9	15	0	1	16	0	0
11	42809115	.	T	C	4	2	6	0	3	9	0	0
11	42809117	.	G	A	1	2	3	0	6	9	0	0
11	42809162	.	G	A	1	2	3	0	6	9	0	0
11	42809233	.	A	G	3	7	10	0	2	12	0	0
11	42809288	.	T	C	2	6	8	0	0	8	0	0
11	42809300	.	T	C	2	5	7	0	0	7	0	0
11	42809345	.	T	C	5	2	7	0	0	7	0	0
11	42809438	.	G	C	6	2	8	5	0	13	0	0
11	42809558	.	A	G	8	5	13	0	1	14	0	0
11	42809579	.	T	G	9	5	14	0	0	14	0	0
11	42809657	.	G	T	0	5	5	0	3	8	0	0
11	42809717	.	G	A	0	4	4	0	5	9	0	0
11	42815207	.	C	A	6	4	10	0	0	10	0	0
11	42817257	.	T	G	1	9	10	0	0	10	0	0
11	42817459	.	A	T	11	9	20	0	0	20	0	0
11	42817476	.	G	C	0	6	6	0	9	15	0	0
11	42817534	.	G	A	8	7	15	0	0	15	0	0
11	42817552	.	A	G	7	7	14	0	3	17	0	0
11	42817604	.	G	T	3	4	7	0	0	7	0	0
11	42912098	.	T	C	2	5	7	0	0	7	0	0
11	42912126	.	A	G	3	3	6	0	0	6	0	0
11	42912723	.	A	G	2	2	4	0	0	4	0	0
11	42912870	.	G	C	3	3	6	0	0	6	0	0
11	42915022	.	T	A	1	2	3	0	0	3	0	0
11	42917357	.	G	T	2	3	5	0	0	5	0	0
11	42917366	.	G	A	1	3	4	0	0	4	0	0
11	42933167	.	G	A	4	4	8	0	1	9	0	0
11	42933696	.	A	G	12	3	15	0	0	15	0	0
11	42933703	.	T	C	11	3	14	0	0	14	0	0
11	42933813	.	A	G	4	6	10	0	0	10	0	0
11	42933832	.	C	T	5	6	11	0	0	11	0	0
11	42940748	.	C	T	5	6	11	0	1	12	0	0
11	42942852	.	T	C	5	8	13	0	0	13	0	0
11	42942930	.	G	A	7	8	15	0	0	15	0	0
11	42947471	.	A	G	6	10	16	0	0	16	0	0
11	42947480	.	G	A	8	8	16	0	0	16	0	0
11	42949086	.	T	C	6	0	6	0	5	11	0	0
11	42949819	.	G	A	2	4	6	0	0	6	0	0
11	42949828	.	T	G	0	3	3	0	1	4	0	0
11	42954479	.	G	A	4	10	14	0	1	15	0	0
11	42956694	.	A	G	2	3	5	0	0	5	0	0
11	42959258	.	A	G	3	3	6	0	0	6	0	0
11	42971336	.	A	G	6	2	8	0	0	8	0	0
11	42971408	.	A	C	4	0	4	0	6	10	0	0
11	42971441	.	C	T	3	6	9	0	0	9	0	0
11	42974959	.	G	T	3	3	6	0	0	6	0	0
11	42974962	.	G	A	3	3	6	0	0	6	0	0
11	42975395	.	A	T	3	3	6	0	0	6	0	0
11	42975432	.	C	G	4	2	6	0	0	6	0	0
11	43045604	.	G	A	7	6	13	0	1	14	0	0
11	43115998	.	C	T	3	2	5	0	0	5	0	0
11	43137659	.	C	T	27	23	50	0	1	51	0	0
11	43151260	.	C	T	25	21	46	0	1	47	0	0
11	43164302	.	G	T	13	12	25	0	3	28	0	0
11	43170699	.	A	G	23	20	43	0	1	44	0	0
11	43170804	.	G	A	17	20	37	0	1	38	0	0
11	43170924	.	A	G	19	18	37	0	0	37	0	0
11	43170992	.	G	T	19	15	34	0	3	37	0	0
11	43171230	.	T	A	5	12	17	0	2	19	0	0
11	43171263	.	G	A	13	6	19	0	1	20	0	0
11	43171281	.	A	G	9	15	24	0	1	25	0	0
11	43171314	.	A	G	15	11	26	0	3	29	0	0
11	43178811	.	T	A	20	11	31	0	5	36	0	0
11	43178823	.	G	A	24	9	33	0	2	35	0	0
11	43178958	.	C	T	14	6	20	0	0	20	0	0
11	43178991	.	G	A	10	9	19	0	1	20	0	0
11	43179248	.	T	G	12	9	21	0	1	22	0	0
11	43179639	.	G	A	12	10	22	0	0	22	0	0
11	43179651	.	A	G	9	11	20	0	1	21	0	0
11	43189115	.	G	A	7	5	12	0	0	12	0	0
11	43189118	.	G	A	7	6	13	0	0	13	0	0
11	43190846	.	G	A	11	9	20	0	0	20	0	0
11	43200419	.	T	A	8	11	19	0	0	19	0	0
11	43411231	.	C	T	4	6	10	0	1	11	0	0
11	43470337	.	T	C	3	2	5	0	0	6	1	0
11	43470530	.	T	C	2	2	4	0	0	4	0	0
11	43782303	.	T	C	2	5	7	0	0	7	0	0
11	44019868	.	A	G	4	6	10	0	1	11	0	0
11	44023888	.	A	G	0	8	8	0	0	8	0	0
11	44025903	.	T	A	5	5	10	0	1	11	0	0
11	44026179	.	A	G	6	4	10	0	1	11	0	0
11	44027836	.	T	G	5	6	11	0	0	11	0	0
11	44030913	.	G	T	2	2	4	0	1	5	0	0
11	44144697	.	T	C	3	2	5	0	0	5	0	0
11	44144749	.	A	C	9	16	25	0	1	26	0	0
11	44144820	.	A	G	21	15	36	0	3	39	0	0
11	44144928	.	G	A	20	25	45	0	2	47	0	0
11	44145001	.	T	A	38	22	60	1	0	61	0	0
11	44148453	.	A	G	25	22	47	0	1	48	0	0
11	44149701	.	T	C	16	0	16	0	20	36	0	0
11	44152693	.	T	G	23	18	41	0	1	42	0	0
11	44152750	.	A	G	29	20	49	0	0	49	0	0
11	44153038	.	G	A	16	14	30	0	0	30	0	0
11	44155583	.	T	C	8	13	21	0	1	22	0	0
11	44155640	.	C	A	9	11	20	0	2	22	0	0
11	44155703	.	C	A	8	11	19	0	0	19	0	0
11	44155766	.	G	T	9	4	13	0	2	15	0	0
11	44157752	.	G	A	15	8	23	0	0	23	0	0
11	44157872	.	C	T	9	13	22	0	0	22	0	0
11	44159320	.	G	C	12	12	24	0	1	25	0	0
11	44161525	.	A	G	13	7	20	0	1	21	0	0
11	44226545	.	G	T	0	3	3	0	3	7	1	0
11	44236394	.	A	G	6	4	10	0	0	10	0	0
11	44244880	.	T	C	5	5	10	0	0	10	0	0
11	44244895	.	T	C	4	5	9	0	0	9	0	0
11	44267086	.	C	T	0	4	4	0	2	6	0	0
11	44304360	.	G	A	1	14	15	0	9	24	0	0
11	44324817	.	C	T	10	5	15	25	0	40	0	0
11	44329172	.	C	T	22	14	36	0	0	36	0	0
11	44329208	.	G	A	18	20	38	0	1	39	0	0
11	44334915	.	C	T	18	15	33	0	2	35	0	0
11	44337158	.	A	G	2	3	5	0	0	5	0	0
11	44340326	.	G	A	1	2	3	0	0	3	0	0
11	44347262	.	C	T	0	2	2	0	1	3	0	0
11	44356772	.	T	A	12	12	24	0	2	26	0	0
11	44356791	.	A	G	12	12	24	0	2	26	0	0
11	44358904	.	C	T	10	13	23	0	1	24	0	0
11	44359735	.	C	T	17	16	33	0	1	34	0	0
11	44361689	.	C	G	7	4	11	0	0	11	0	0
11	44361701	.	C	T	9	7	16	0	1	17	0	0
11	44400918	.	G	A	8	8	16	0	0	16	0	0
11	44400960	.	G	T	7	6	13	0	1	14	0	0
11	44442494	.	C	T	1	12	13	0	0	13	0	0
11	44445500	.	G	A	5	2	7	0	1	8	0	0
11	44445733	.	A	G	17	0	17	1	7	25	0	0
11	44445736	.	C	T	16	6	22	1	1	24	0	0
11	44445828	.	T	C	6	4	10	0	1	11	0	0
11	44452668	.	G	A	5	7	12	0	1	13	0	0
11	44452732	.	T	C	9	10	19	0	0	19	0	0
11	44452849	.	G	A	3	12	15	0	1	16	0	0
11	44452886	.	A	G	11	15	26	1	0	27	0	0
11	44455901	.	C	T	15	11	26	0	0	26	0	0
11	44457239	.	G	A	8	14	22	0	2	24	0	0
11	44457254	.	A	G	9	11	20	0	3	23	0	0
11	44461386	.	G	C	12	14	26	0	1	27	0	0
11	44461458	.	G	A	9	16	25	0	0	25	0	0
11	44466931	.	T	C	2	6	8	0	0	8	0	0
11	44468838	.	G	A	2	8	10	0	0	10	0	0
11	44468842	.	T	C	1	10	11	0	0	11	0	0
11	44478403	.	T	C	6	3	9	0	1	10	0	0
11	44483622	.	G	T	1	4	5	0	0	5	0	0
11	44483647	.	G	T	1	3	4	0	0	4	0	0
11	44484497	.	T	C	2	3	5	0	0	5	0	0
11	44606732	.	T	C	2	2	4	0	0	4	0	0
11	44606844	.	G	T	6	14	20	0	0	20	0	0
11	44607019	.	T	A	10	4	14	0	0	14	0	0
11	44607052	.	G	A	17	6	23	0	0	23	0	0
11	44612357	.	A	G	9	4	13	0	0	13	0	0
11	44624723	.	A	C	4	2	6	0	0	6	0	0
11	44633294	.	T	C	11	10	21	0	0	21	0	0
11	44634908	.	G	A	1	4	5	0	7	12	0	0
11	44637569	.	T	A	8	4	12	0	0	12	0	0
11	44637950	.	A	G	21	33	54	1	5	60	0	0
11	44643882	.	C	T	28	19	47	0	2	49	0	0
11	44647227	.	A	C	29	0	29	0	29	58	0	0
11	44647269	.	T	G	21	15	36	0	0	36	0	0
11	44723130	.	C	G	10	13	23	0	2	25	0	0
11	44723353	.	G	A	0	13	13	0	17	30	0	0
11	44723374	.	T	C	15	17	32	0	2	34	0	0
11	44723416	.	T	G	16	0	16	0	19	35	0	0
11	44723653	.	T	G	20	14	34	0	3	37	0	0
11	44723746	.	A	G	19	20	39	0	4	43	0	0
11	44725596	.	C	T	20	27	47	0	2	49	0	0
11	44725926	.	G	A	2	21	23	0	26	49	0	0
11	44805701	.	G	A	7	2	9	0	0	9	0	0
11	44834268	.	G	A	0	3	3	0	5	8	0	0
11	44838743	.	G	A	0	7	7	0	6	13	0	0
11	44843706	.	A	G	2	0	2	0	2	4	0	0
11	44852248	.	A	G	6	0	6	0	4	10	0	0
11	44852732	.	G	A	0	2	2	0	2	4	0	0
11	44852756	.	A	T	3	2	5	0	0	5	0	0
11	44852771	.	T	A	4	5	9	0	0	9	0	0
11	44852988	.	T	A	3	3	6	0	0	6	0	0
11	44853172	.	C	A	9	3	12	0	1	13	0	0
11	44853325	.	T	C	2	3	5	0	0	5	0	0
11	44853670	.	C	T	5	3	8	0	0	8	0	0
11	44853761	.	A	T	3	5	8	0	0	8	0	0
11	44853908	.	A	T	5	6	11	0	0	11	0	0
11	44854631	.	C	T	4	5	9	0	0	9	0	0
11	44854636	.	G	T	3	5	8	0	0	8	0	0
11	44854894	.	T	G	5	7	12	0	0	12	0	0
11	44854918	.	G	A	0	11	11	0	5	16	0	0
11	44854996	.	T	C	12	9	21	0	1	22	0	0
11	44855027	.	G	A	0	9	9	0	11	20	0	0
11	44880288	.	A	G	14	12	26	0	2	28	0	0
11	44880291	.	T	A	14	14	28	0	1	29	0	0
11	44880332	.	G	A	15	16	31	0	2	33	0	0
11	44880345	.	C	G	14	14	28	0	1	29	0	0
11	44887200	.	G	A	13	25	38	0	2	40	0	0
11	44887224	.	T	C	27	0	27	0	15	42	0	0
11	44887612	.	G	T	19	21	40	0	1	41	0	0
11	44891507	.	G	A	15	22	37	0	1	38	0	0
11	44892859	.	T	A	20	15	35	0	2	37	0	0
11	44892883	.	G	A	16	14	30	0	2	32	0	0
11	44892943	.	G	A	14	10	24	0	0	24	0	0
11	44892979	.	T	A	8	11	19	0	3	22	0	0
11	44894409	.	T	C	12	0	12	2	7	22	1	0
11	44897584	.	C	T	13	9	22	0	2	24	0	0
11	44897647	.	A	C	13	10	23	0	1	24	0	0
11	44901315	.	C	T	3	10	13	0	8	21	0	0
11	44901373	.	C	A	31	36	67	0	2	69	0	0
11	44906468	.	A	G	3	3	6	0	0	6	0	0
11	44910758	.	T	G	17	11	28	0	0	28	0	0
11	44912485	.	C	A	0	7	7	0	7	14	0	0
11	44912992	.	C	T	1	4	5	0	8	13	0	0
11	44913176	.	C	A	0	8	8	0	8	16	0	0
11	44914943	.	G	C	10	6	16	0	0	16	0	0
11	44927159	.	C	A	1	5	6	0	0	6	0	0
11	44927833	.	G	T	6	10	16	0	0	16	0	0
11	44935375	.	A	G	5	11	16	0	1	17	0	0
11	44953608	.	C	T	2	3	5	0	0	5	0	0
11	44953880	.	G	T	7	3	10	0	0	11	1	0
11	44960620	.	G	A	7	3	10	0	0	10	0	0
11	45094773	.	C	T	1	2	3	1	0	4	0	0
11	45097652	.	G	A	1	2	3	0	0	3	0	0
11	45122734	.	A	G	1	2	3	0	0	3	0	0
11	45125627	.	T	C	9	4	13	0	1	14	0	0
11	45125829	.	C	T	5	3	8	0	0	8	0	0
11	45125831	.	A	T	4	3	7	0	1	8	0	0
11	45126658	.	C	T	0	9	9	0	13	22	0	0
11	45126913	.	A	T	3	5	8	0	1	9	0	0
11	45126985	.	A	G	2	4	6	0	0	6	0	0
11	45127191	.	G	A	11	4	15	0	2	17	0	0
11	45127266	.	A	G	9	4	13	0	2	15	0	0
11	45127329	.	G	A	3	8	11	0	0	11	0	0
11	45127335	.	C	T	2	3	5	0	4	9	0	0
11	45127374	.	G	A	3	4	7	0	0	7	0	0
11	45129287	.	G	A	3	7	10	0	0	10	0	0
11	45129347	.	C	A	2	12	14	0	0	14	0	0
11	45130909	.	G	A	4	8	12	0	0	12	0	0
11	45131119	.	C	T	4	5	9	0	1	10	0	0
11	45139754	.	G	A	5	2	7	0	0	7	0	0
11	45139866	.	C	A	3	2	5	0	0	5	0	0
11	45140001	.	A	T	5	5	10	1	1	12	0	0
11	45140020	.	T	G	5	3	8	1	2	11	0	0
11	45140116	.	C	G	5	7	12	0	0	12	0	0
11	45140210	.	G	C	6	8	14	0	2	16	0	0
11	45141286	.	T	C	11	11	22	0	1	23	0	0
11	45143417	.	G	T	5	9	14	0	0	14	0	0
11	45148705	.	T	C	10	0	10	0	4	14	0	0
11	45227084	.	G	T	0	3	3	0	1	4	0	0
11	45234021	.	G	A	0	2	2	0	1	3	0	0
11	45235063	.	A	G	2	0	2	0	4	6	0	0
11	45242360	.	T	C	5	7	12	0	4	16	0	0
11	45242912	.	T	C	11	9	20	0	1	21	0	0
11	45244372	.	C	T	4	3	7	0	0	7	0	0
11	45245862	.	G	A	4	8	12	0	0	12	0	0
11	45246045	.	C	T	3	3	6	0	0	6	0	0
11	45262079	.	C	T	18	6	24	0	1	25	0	0
11	45262138	.	C	G	8	0	8	0	9	17	0	0
11	45262178	.	C	T	9	8	17	0	0	17	0	0
11	45262186	.	G	A	2	9	11	0	6	17	0	0
11	45262342	.	C	T	9	12	21	0	1	22	0	0
11	45265898	.	C	T	3	4	7	0	0	7	0	0
11	45269752	.	T	C	15	16	31	0	3	34	0	0
11	45272686	.	G	A	0	6	6	0	6	12	0	0
11	45287575	.	G	A	2	3	5	0	2	7	0	0
11	45290463	.	A	G	6	8	14	0	1	15	0	0
11	45291926	.	G	A	9	6	15	0	2	17	0	0
11	45294619	.	A	G	2	0	2	0	2	4	0	0
11	45294966	.	T	C	8	7	15	2	2	19	0	0
11	45294968	.	T	C	9	4	13	2	4	19	0	0
11	45295005	.	T	G	6	10	16	0	0	16	0	0
11	45327030	.	G	A	0	3	3	0	1	4	0	0
11	45327056	.	T	C	1	5	6	0	1	7	0	0
11	45327272	.	T	C	1	2	3	0	0	3	0	0
11	45327456	.	C	T	4	2	6	0	0	6	0	0
11	45327493	.	T	G	3	2	5	0	0	5	0	0
11	45327609	.	T	C	3	2	5	0	1	6	0	0
11	45328046	.	C	T	3	3	6	0	0	6	0	0
11	45328166	.	C	T	2	6	8	0	0	8	0	0
11	45342334	.	A	G	1	0	1	0	3	4	0	0
11	45343231	.	T	A	5	2	7	0	0	7	0	0
11	45343264	.	A	T	5	5	10	0	0	10	0	0
11	45343492	.	G	C	0	3	3	0	3	6	0	0
11	45344090	.	C	T	1	2	3	0	0	3	0	0
11	45348465	.	G	A	3	6	9	0	0	9	0	0
11	45351717	.	G	T	8	3	11	0	0	11	0	0
11	45351794	.	T	C	5	1	6	0	1	7	0	0
11	45355022	.	C	G	13	11	24	0	0	24	0	0
11	45355155	.	C	T	2	7	9	0	1	10	0	0
11	45355436	.	C	G	15	18	33	0	2	35	0	0
11	45355473	.	C	T	1	19	20	0	15	35	0	0
11	45355717	.	A	G	23	5	28	0	0	28	0	0
11	45356041	.	T	A	7	3	10	2	4	16	0	0
11	45356042	.	G	A	12	2	14	2	5	21	0	0
11	45356114	.	G	A	7	9	16	1	1	18	0	0
11	45356352	.	G	A	7	4	11	0	0	11	0	0
11	45356666	.	A	G	13	16	29	0	1	30	0	0
11	45359878	.	C	T	9	9	18	0	1	19	0	0
11	45362172	.	A	T	2	12	14	0	1	15	0	0
11	45362862	.	T	C	7	5	12	0	0	12	0	0
11	45366720	.	C	T	4	2	6	0	1	7	0	0
11	45370259	.	G	A	6	7	13	0	0	13	0	0
11	45370529	.	G	A	4	6	10	0	0	10	0	0
11	45371831	.	A	G	2	4	6	0	0	6	0	0
11	45371868	.	A	G	5	4	9	0	0	9	0	0
11	45375266	.	G	T	3	2	5	0	0	5	0	0
11	45389891	.	G	A	6	3	9	0	1	10	0	0
11	45389922	.	G	A	2	5	7	0	0	7	0	0
11	45390057	.	G	A	8	10	18	0	0	18	0	0
11	45391683	.	G	A	2	12	14	0	14	28	0	0
11	45391725	.	A	G	13	6	19	0	0	19	0	0
11	45391727	.	T	C	12	6	18	0	0	18	0	0
11	45391788	.	C	T	11	7	18	0	0	18	0	0
11	45393395	.	C	T	20	18	38	1	3	42	0	0
11	45393520	.	A	C	7	4	11	0	47	58	0	0
11	45398744	.	A	G	33	31	64	0	1	65	0	0
11	45398804	.	T	C	44	21	65	0	0	65	0	0
11	45399589	.	A	G	31	17	48	0	1	49	0	0
11	45399799	.	G	T	15	15	30	0	0	30	0	0
11	45402861	.	G	A	16	10	26	0	0	26	0	0
11	45402945	.	G	A	12	19	31	0	2	33	0	0
11	45403209	.	A	T	16	23	39	0	3	42	0	0
11	45403712	.	G	A	17	15	32	0	3	35	0	0
11	45403733	.	G	A	14	17	31	0	1	32	0	0
11	45403854	.	G	A	18	20	38	0	0	38	0	0
11	45403866	.	G	A	20	20	40	0	1	42	1	0
11	45403914	.	C	T	0	19	19	0	23	42	0	0
11	45407215	.	G	A	12	18	30	0	0	30	0	0
11	45410613	.	A	G	11	17	28	0	1	29	0	0
11	45419948	.	C	G	0	7	7	0	16	23	0	0
11	45428466	.	A	T	7	3	10	0	0	10	0	0
11	45439858	.	C	A	1	5	6	0	0	6	0	0
11	45448187	.	G	A	4	4	8	0	2	10	0	0
11	45448277	.	G	A	0	3	3	0	4	7	0	0
11	45448289	.	C	T	5	3	8	0	0	8	0	0
11	45452373	.	C	T	9	3	12	0	0	12	0	0
11	45452786	.	G	A	0	5	5	0	4	9	0	0
11	45460337	.	G	A	7	3	10	0	0	10	0	0
11	45463352	.	T	C	13	9	22	0	0	22	0	0
11	45463490	.	G	T	3	16	19	0	16	35	0	0
11	45463730	.	G	A	1	5	6	0	21	27	0	0
11	45464041	.	T	C	4	3	7	0	0	7	0	0
11	45464188	.	G	C	4	9	13	0	0	13	0	0
11	45464673	.	C	T	10	3	13	0	0	13	0	0
11	45465080	.	T	A	13	8	21	0	0	21	0	0
11	45468821	.	A	C	2	4	6	0	0	6	0	0
11	45468899	.	C	T	2	2	4	0	5	9	0	0
11	45468906	.	T	A	2	5	7	0	0	7	0	0
11	45469020	.	G	A	2	2	4	0	0	4	0	0
11	45469766	.	A	G	9	3	12	0	0	12	0	0
11	45469868	.	T	C	8	2	10	0	0	10	0	0
11	45469914	.	G	T	3	3	6	0	0	6	0	0
11	45470243	.	C	T	1	9	10	0	2	12	0	0
11	45470277	.	C	T	3	7	10	0	6	16	0	0
11	45470279	.	C	A	5	9	14	0	4	18	0	0
12	497223	.	A	G	17	0	17	0	5	22	0	0
12	1524539	.	C	T	2	2	4	0	0	4	0	0
12	3059829	.	C	A	4	2	6	0	0	6	0	0
12	3060341	.	G	C	4	2	6	0	0	6	0	0
12	3266372	.	G	A	0	5	5	0	1	6	0	0
12	3270513	.	G	T	7	2	9	0	0	9	0	0
12	3271027	.	A	G	4	1	5	1	0	6	0	0
12	3271553	.	G	A	8	5	13	0	0	13	0	0
12	3271646	.	T	A	6	2	8	1	0	9	0	0
12	3271747	.	A	G	5	4	9	1	1	11	0	0
12	3272148	.	A	G	7	3	10	0	0	10	0	0
12	3272719	.	A	G	3	2	5	2	0	7	0	0
12	3287895	.	G	A	8	2	10	0	1	11	0	0
12	3571986	.	C	T	18	7	25	0	2	27	0	0
12	3574348	.	G	A	12	19	31	0	1	32	0	0
12	3714183	.	G	A	6	2	8	0	1	9	0	0
12	3714213	.	T	A	5	9	14	0	0	14	0	0
12	3714315	.	C	T	4	6	10	0	0	10	0	0
12	3714330	.	A	T	6	7	13	0	0	13	0	0
12	3714425	.	C	A	11	11	22	0	0	22	0	0
12	3714578	.	T	C	8	0	8	0	5	13	0	0
12	3714602	.	T	C	6	2	8	0	0	8	0	0
12	3714731	.	T	C	1	2	3	0	0	3	0	0
12	3715016	.	A	G	6	5	11	0	1	12	0	0
12	3715095	.	T	C	5	2	7	1	0	8	0	0
12	3715134	.	G	A	5	2	7	1	0	8	0	0
12	3715192	.	G	A	8	3	11	0	1	12	0	0
12	3715196	.	C	T	0	4	4	0	9	13	0	0
12	3715292	.	T	G	5	11	16	0	1	18	1	0
12	3715327	.	C	A	3	4	7	0	2	9	0	0
12	3715329	.	C	G	4	5	9	0	0	9	0	0
12	3715365	.	T	C	5	4	9	0	0	9	0	0
12	3715544	.	T	C	6	6	12	0	0	12	0	0
12	3715588	.	C	A	4	3	7	0	2	9	0	0
12	3716621	.	G	C	6	10	16	0	1	17	0	0
12	3723786	.	C	G	8	7	15	0	1	16	0	0
12	3723963	.	G	A	0	11	11	0	10	21	0	0
12	3726646	.	T	A	5	8	13	0	3	16	0	0
12	3740717	.	C	A	6	13	19	0	0	19	0	0
12	3740724	.	T	A	8	14	22	0	1	23	0	0
12	3740784	.	C	T	10	17	27	0	0	27	0	0
12	3740803	.	G	A	9	17	26	0	0	26	0	0
12	3740961	.	C	A	0	8	8	0	7	15	0	0
12	3749502	.	A	G	8	3	11	0	0	11	0	0
12	3749505	.	C	T	0	3	3	0	8	11	0	0
12	3753166	.	C	T	1	10	11	0	7	18	0	0
12	3756297	.	G	T	6	3	9	0	0	9	0	0
12	3770991	.	G	A	2	4	6	0	0	6	0	0
12	3778422	.	A	G	5	3	8	0	0	8	0	0
12	3789435	.	C	A	0	4	4	0	4	8	0	0
12	3789489	.	T	A	3	4	7	0	0	7	0	0
12	3789772	.	T	G	4	5	9	0	0	9	0	0
12	3806732	.	C	T	3	5	8	0	0	8	0	0
12	3807876	.	G	A	4	2	6	0	0	6	0	0
12	3808038	.	T	C	3	3	6	0	0	6	0	0
12	3808832	.	G	A	8	3	11	0	0	11	0	0
12	3840324	.	C	T	3	5	8	0	0	8	0	0
12	3840637	.	A	C	1	3	4	0	0	4	0	0
12	3860624	.	G	A	0	4	4	0	5	9	0	0
12	3860893	.	G	A	1	2	3	0	0	3	0	0
12	3875667	.	A	G	3	4	7	0	0	7	0	0
12	3880661	.	A	G	6	1	7	0	5	12	0	0
12	3889922	.	C	T	3	5	8	0	0	8	0	0
12	3920279	.	T	C	2	2	4	0	0	4	0	0
12	3920309	.	G	A	1	2	3	0	3	6	0	0
12	3921094	.	A	T	2	1	3	0	0	3	0	0
12	3921119	.	C	A	1	2	3	0	0	3	0	0
12	3921813	.	G	A	3	6	9	0	2	11	0	0
12	3921894	.	T	C	3	6	9	0	1	10	0	0
12	3922047	.	A	G	3	4	7	0	2	9	0	0
12	3922068	.	A	T	5	5	10	0	0	10	0	0
12	3922086	.	A	C	5	5	10	0	0	10	0	0
12	3922536	.	A	G	1	9	10	0	1	11	0	0
12	3922549	.	G	A	1	5	6	0	4	10	0	0
12	3922844	.	G	A	1	3	4	0	0	4	0	0
12	3944488	.	C	G	0	21	21	0	31	52	0	0
12	3944543	.	A	G	26	38	64	0	5	69	0	0
12	3946833	.	G	A	24	34	58	0	1	59	0	0
12	3947276	.	A	G	14	21	35	0	1	36	0	0
12	3947484	.	A	G	14	28	42	0	1	43	0	0
12	3947902	.	G	A	23	18	41	0	1	42	0	0
12	3947929	.	A	G	24	18	42	0	3	45	0	0
12	3948593	.	C	T	22	18	40	0	1	41	0	0
12	3948701	.	G	A	27	19	46	0	2	48	0	0
12	3949194	.	A	G	13	29	42	0	2	44	0	0
12	3953155	.	T	A	8	15	23	0	2	25	0	0
12	3953946	.	A	G	9	17	26	0	1	27	0	0
12	3954003	.	T	G	5	8	13	0	1	14	0	0
12	3956864	.	A	G	18	13	31	0	2	33	0	0
12	3957973	.	A	G	19	16	35	0	0	35	0	0
12	3964631	.	G	A	13	15	28	1	1	30	0	0
12	3964770	.	A	G	11	19	30	0	0	30	0	0
12	3964937	.	C	G	19	15	34	0	0	34	0	0
12	3965002	.	G	T	9	13	22	0	4	26	0	0
12	3965168	.	T	C	15	20	35	0	1	36	0	0
12	3967756	.	A	G	17	11	28	0	1	29	0	0
12	3971655	.	A	G	5	6	11	0	0	11	0	0
12	3974755	.	C	T	0	5	5	0	8	13	0	0
12	3998925	.	T	A	2	5	7	0	0	7	0	0
12	3998943	.	T	C	1	4	5	0	0	5	0	0
12	3998961	.	A	T	3	4	7	0	0	7	0	0
12	3999002	.	A	G	1	3	4	0	0	4	0	0
12	4002615	.	A	T	1	5	6	0	0	6	0	0
12	4002709	.	A	G	5	4	9	0	0	9	0	0
12	4004344	.	C	T	7	5	12	0	1	13	0	0
12	4004448	.	C	T	0	3	3	0	5	8	0	0
12	4009150	.	G	A	2	2	4	0	0	4	0	0
12	4009165	.	A	G	1	4	5	0	0	5	0	0
12	4009337	.	G	A	1	5	6	0	0	6	0	0
12	4009392	.	C	A	0	4	4	0	2	6	0	0
12	4009462	.	A	T	3	5	8	0	0	8	0	0
12	4024104	.	T	C	1	4	5	0	0	5	0	0
12	4144290	.	A	T	1	2	3	0	0	3	0	0
12	4220656	.	T	C	1	5	6	0	0	6	0	0
12	4226080	.	C	T	2	2	4	0	0	4	0	0
12	4226089	.	G	A	2	2	4	0	0	4	0	0
12	4226155	.	A	G	3	0	3	0	2	5	0	0
12	4226483	.	T	A	2	2	4	0	0	4	0	0
12	4226492	.	G	C	0	1	1	0	3	4	0	0
12	4227365	.	G	A	4	3	7	0	0	7	0	0
12	4227374	.	A	G	4	3	7	0	0	7	0	0
12	4227632	.	G	A	0	4	4	0	3	7	0	0
12	4231775	.	A	G	5	3	8	0	0	8	0	0
12	4231776	.	G	A	4	3	7	0	0	7	0	0
12	4231990	.	A	G	5	2	7	0	0	7	0	0
12	4232313	.	A	G	3	0	3	0	6	9	0	0
12	4232320	.	C	T	4	6	10	0	1	11	0	0
12	4232425	.	G	A	4	11	15	0	1	16	0	0
12	4232434	.	C	A	6	11	17	0	1	18	0	0
12	4234489	.	G	C	8	11	19	0	0	19	0	0
12	4238122	.	T	C	2	7	9	0	1	10	0	0
12	4238704	.	T	A	5	2	7	0	0	7	0	0
12	4601361	.	G	A	5	4	9	0	1	10	0	0
12	4601769	.	A	G	26	20	46	0	2	48	0	0
12	4602047	.	T	A	14	10	24	1	2	27	0	0
12	4602245	.	G	A	20	18	38	0	2	40	0	0
12	4602399	.	A	T	17	19	36	0	1	37	0	0
12	4602436	.	A	T	17	15	32	0	2	34	0	0
12	4606669	.	C	T	16	18	34	1	4	39	0	0
12	4609143	.	C	T	20	12	32	0	0	32	0	0
12	4609343	.	C	G	0	15	15	0	13	28	0	0
12	4609364	.	A	G	14	14	28	0	2	30	0	0
12	4609391	.	T	C	15	15	30	0	1	31	0	0
12	4609409	.	C	T	18	16	34	0	1	35	0	0
12	4611092	.	C	T	2	20	22	0	16	38	0	0
12	4611128	.	C	T	16	21	37	0	0	37	0	0
12	4611521	.	T	C	17	0	17	0	22	39	0	0
12	4615281	.	T	C	9	0	9	0	13	22	0	0
12	4616967	.	C	G	8	12	20	0	2	22	0	0
12	4616974	.	G	A	8	12	20	0	0	20	0	0
12	4617024	.	G	T	11	8	19	0	0	19	0	0
12	4617065	.	G	A	19	10	29	0	0	29	0	0
12	4617070	.	T	C	17	10	27	0	2	29	0	0
12	4617102	.	G	C	18	0	18	0	11	29	0	0
12	4617243	.	G	A	15	22	37	0	0	37	0	0
12	4617274	.	G	A	16	13	29	0	1	30	0	0
12	4617286	.	T	C	16	0	16	0	14	30	0	0
12	4619179	.	A	G	7	3	10	0	2	12	0	0
12	4619230	.	G	T	12	8	20	0	1	21	0	0
12	4619553	.	C	T	8	8	16	0	1	17	0	0
12	4621108	.	A	T	5	3	8	0	0	8	0	0
12	4621480	.	G	A	3	4	7	0	2	9	0	0
12	4621618	.	A	G	6	13	19	0	2	21	0	0
12	4621782	.	A	G	6	4	10	0	0	10	0	0
12	4621909	.	G	T	5	3	8	0	1	9	0	0
12	4622224	.	T	C	6	0	6	0	4	10	0	0
12	4622344	.	G	A	4	3	7	0	0	7	0	0
12	4622884	.	G	A	3	5	8	0	1	9	0	0
12	4631531	.	A	G	3	2	5	0	0	5	0	0
12	4644028	.	A	C	2	3	5	0	0	5	0	0
12	4645291	.	G	T	8	5	13	0	1	14	0	0
12	4648491	.	C	T	7	4	11	0	1	12	0	0
12	4648530	.	G	A	9	5	14	0	0	14	0	0
12	4653986	.	C	T	1	6	7	0	4	11	0	0
12	4661329	.	A	G	2	4	6	0	0	6	0	0
12	4686524	.	G	A	4	3	7	0	0	7	0	0
12	4690311	.	A	G	5	3	8	0	2	10	0	0
12	4690425	.	G	A	0	5	5	0	3	8	0	0
12	4690572	.	T	C	4	2	6	0	0	6	0	0
12	4690668	.	G	C	2	3	5	0	0	5	0	0
12	4690785	.	T	C	1	5	6	0	1	7	0	0
12	4691043	.	G	A	0	2	2	0	4	6	0	0
12	4691146	.	A	G	3	5	8	0	0	8	0	0
12	4712234	.	T	C	4	7	11	0	0	11	0	0
12	4713010	.	C	A	5	11	16	0	1	17	0	0
12	4715953	.	A	G	9	0	9	1	9	19	0	0
12	4715968	.	G	A	9	11	20	1	1	22	0	0
12	4716061	.	A	C	5	8	13	0	0	13	0	0
12	4716064	.	T	G	5	1	6	0	7	13	0	0
12	4716361	.	A	G	3	7	10	0	0	10	0	0
12	4716375	.	T	C	2	6	8	0	0	8	0	0
12	4720264	.	T	C	9	9	18	0	0	18	0	0
12	4721721	.	C	G	7	15	22	0	2	24	0	0
12	4721727	.	A	G	6	0	6	0	17	23	0	0
12	4724397	.	A	T	11	12	23	0	0	23	0	0
12	4724455	.	A	G	18	1	19	0	6	25	0	0
12	4724464	.	T	C	16	9	25	0	0	25	0	0
12	4724553	.	G	A	10	8	18	0	1	19	0	0
12	4724634	.	G	A	1	4	5	0	3	8	0	0
12	4724710	.	G	A	3	5	8	0	0	8	0	0
12	4724787	.	T	G	5	10	15	0	0	15	0	0
12	4724983	.	G	A	9	10	19	0	0	19	0	0
12	4725170	.	A	T	14	9	23	0	0	23	0	0
12	4725371	.	A	G	9	10	19	0	1	20	0	0
12	4733899	.	T	C	3	2	5	0	1	6	0	0
12	4733968	.	C	T	9	12	21	0	0	21	0	0
12	4734008	.	G	T	12	16	28	0	2	30	0	0
12	4734068	.	G	T	9	23	32	0	2	34	0	0
12	4734306	.	A	T	15	25	40	0	2	42	0	0
12	4734312	.	A	G	14	26	40	0	0	40	0	0
12	4734418	.	T	G	23	16	39	0	1	40	0	0
12	4734476	.	T	C	17	0	17	0	21	38	0	0
12	4734925	.	C	T	31	24	55	0	0	55	0	0
12	4734967	.	G	A	31	17	48	0	1	49	0	0
12	4734979	.	C	T	4	21	25	0	25	50	0	0
12	4751860	.	C	T	18	15	33	0	0	33	0	0
12	4752981	.	G	A	10	16	26	0	0	26	0	0
12	4753014	.	A	G	15	14	29	0	1	30	0	0
12	4753020	.	A	G	14	14	28	0	2	30	0	0
12	4753095	.	C	T	14	27	41	0	0	41	0	0
12	4753104	.	C	T	3	28	31	0	13	44	0	0
12	4754639	.	G	T	9	16	25	0	0	25	0	0
12	4935876	.	G	A	1	2	3	0	0	3	0	0
12	4941627	.	C	T	1	2	3	0	0	3	0	0
12	4944911	.	G	A	0	2	2	0	1	3	0	0
12	4949825	.	A	G	2	0	2	0	2	4	0	0
12	4949876	.	T	C	3	3	6	0	0	6	0	0
12	4950356	.	C	T	2	4	6	0	0	6	0	0
12	4957095	.	A	G	4	9	13	1	0	14	0	0
12	4960631	.	A	G	1	3	4	0	1	5	0	0
12	4960634	.	A	G	0	3	3	0	2	5	0	0
12	4961256	.	A	G	2	4	6	0	0	6	0	0
12	4961333	.	A	C	2	2	4	0	0	4	0	0
12	4961955	.	A	C	3	4	7	0	0	7	0	0
12	4962195	.	A	G	4	0	4	0	5	9	0	0
12	4962640	.	C	A	2	4	6	0	0	6	0	0
12	4962643	.	G	T	0	3	3	0	2	5	0	0
12	5021183	.	A	G	1	0	1	0	8	9	0	0
12	5038141	.	C	T	2	2	4	0	2	6	0	0
12	5038363	.	A	C	4	2	6	0	0	6	0	0
12	5044104	.	A	G	10	0	10	0	3	13	0	0
12	5044106	.	G	A	9	3	12	0	0	12	0	0
12	5044221	.	A	C	7	2	9	0	1	10	0	0
12	5044273	.	T	C	2	3	5	0	0	5	0	0
12	5044396	.	T	C	5	2	7	0	0	7	0	0
12	5044462	.	A	T	2	3	5	0	0	6	1	0
12	5044737	.	A	G	7	0	7	0	4	11	0	0
12	5059829	.	A	G	2	0	2	0	4	6	0	0
12	5059868	.	C	G	2	4	6	0	0	6	0	0
12	5070229	.	A	C	1	4	5	0	0	5	0	0
12	5070290	.	G	A	4	4	8	0	0	8	0	0
12	5071104	.	T	A	1	4	5	0	0	5	0	0
12	5084514	.	C	T	11	5	16	0	1	17	0	0
12	5090591	.	T	C	11	13	24	0	3	27	0	0
12	5091368	.	A	T	10	7	17	0	1	19	1	0
12	5116192	.	A	G	19	25	44	0	2	46	0	0
12	5119802	.	T	C	11	7	18	0	1	19	0	0
12	5156507	.	G	A	1	2	3	0	0	3	0	0
12	5156671	.	A	G	1	2	3	0	1	4	0	0
12	5180489	.	G	A	4	4	8	0	1	9	0	0
12	5180626	.	G	A	5	3	8	0	0	8	0	0
12	5180662	.	T	A	7	5	12	0	0	12	0	0
12	5182460	.	T	C	4	4	8	0	1	9	0	0
12	5182718	.	G	A	3	3	6	0	0	6	0	0
12	5185627	.	G	A	2	4	6	0	0	6	0	0
12	5383940	.	C	T	1	3	4	0	0	4	0	0
12	5388630	.	T	C	1	2	3	0	0	3	0	0
12	5389889	.	G	A	3	3	6	1	0	7	0	0
12	5389940	.	T	C	4	2	6	1	0	7	0	0
12	5398386	.	T	A	1	2	3	0	1	4	0	0
12	5399803	.	G	A	1	4	5	0	0	5	0	0
12	5399832	.	G	C	3	6	9	0	1	10	0	0
12	5404160	.	T	C	6	0	6	0	3	9	0	0
12	5404181	.	G	C	7	0	7	0	3	10	0	0
12	5404403	.	C	T	0	3	3	0	5	8	0	0
12	5407930	.	A	T	4	4	8	0	0	8	0	0
12	5414913	.	T	C	2	0	2	0	2	4	0	0
12	5424239	.	G	A	2	3	5	0	0	5	0	0
12	5424264	.	A	G	2	2	4	0	0	4	0	0
12	5424383	.	T	A	7	2	9	0	0	9	0	0
12	5424385	.	C	T	6	2	8	0	0	8	0	0
12	5424785	.	A	T	3	2	5	1	1	7	0	0
12	5427456	.	T	A	9	8	17	0	0	17	0	0
12	5427491	.	T	G	10	9	19	0	0	19	0	0
12	5434072	.	G	A	1	7	8	0	0	8	0	0
12	5434794	.	G	T	2	2	4	0	0	4	0	0
12	5452625	.	A	G	4	4	8	0	0	8	0	0
12	5458981	.	T	A	2	3	5	0	0	5	0	0
12	5459296	.	T	A	1	2	3	0	0	3	0	0
12	5459297	.	C	T	1	2	3	0	0	3	0	0
12	5459629	.	A	G	1	2	3	0	0	3	0	0
12	6576298	.	C	T	1	5	6	0	0	6	0	0
12	6690770	.	T	C	2	2	4	0	0	4	0	0
12	7610969	.	T	C	10	8	18	0	0	18	0	0
12	7611106	.	T	C	2	2	4	0	0	4	0	0
12	7611205	.	T	C	10	3	13	0	0	13	0	0
12	7611286	.	T	C	2	6	8	0	1	9	0	0
12	7611318	.	T	C	6	0	6	0	4	10	0	0
12	7611526	.	T	C	5	6	11	0	1	12	0	0
12	7611527	.	T	C	6	0	6	0	6	12	0	0
12	9883549	.	A	G	51	13	64	1	4	69	0	0
12	10412169	.	T	C	2	2	4	0	0	4	0	0
12	10446953	.	T	C	1	5	6	0	0	6	0	0
12	10492349	.	C	T	1	4	5	0	1	6	0	0
12	11389185	.	T	C	14	4	18	0	1	19	0	0
12	11389226	.	T	C	6	4	10	0	1	11	0	0
12	11389229	.	T	C	6	3	9	0	1	10	0	0
12	11390274	.	T	C	8	3	11	0	1	12	0	0
12	11390365	.	T	C	3	4	7	0	0	7	0	0
12	11390556	.	T	C	4	2	6	0	0	6	0	0
12	12789944	.	A	G	4	2	6	0	2	8	0	0
12	13473142	.	A	G	1	3	4	0	0	4	0	0
12	13473179	.	A	G	3	2	5	0	1	6	0	0
12	13473280	.	A	G	6	2	8	0	0	8	0	0
12	13473314	.	A	G	4	4	8	0	0	8	0	0
12	13473693	.	A	G	6	0	6	0	6	12	0	0
12	13474461	.	A	G	18	7	25	0	0	25	0	0
12	14166722	.	T	A	5	3	8	0	0	8	0	0
12	17118348	.	A	G	5	2	7	0	0	7	0	0
12	17616990	.	T	C	2	2	4	0	0	4	0	0
12	18529360	.	A	T	2	3	5	0	0	5	0	0
12	18692675	.	T	C	4	5	9	0	1	10	0	0
12	18694220	.	A	C	3	7	10	0	0	10	0	0
12	18698557	.	C	T	7	3	10	0	0	10	0	0
12	18701608	.	C	T	2	2	4	0	2	6	0	0
12	18713926	.	C	T	7	3	10	0	0	10	0	0
12	18714000	.	C	T	17	14	31	0	0	31	0	0
12	18716985	.	C	T	11	8	19	0	0	19	0	0
12	18717085	.	A	G	9	10	19	0	0	19	0	0
12	18779450	.	T	A	5	6	11	0	0	11	0	0
12	18779648	.	T	C	9	10	19	0	0	19	0	0
12	18782763	.	G	A	2	11	13	0	1	14	0	0
12	18786773	.	T	C	4	12	16	0	0	16	0	0
12	18786917	.	T	C	13	13	26	0	0	26	0	0
12	18787009	.	G	A	9	8	17	0	2	19	0	0
12	18787205	.	C	T	9	6	15	0	0	15	0	0
12	18795943	.	T	C	2	0	2	0	2	4	0	0
12	18804573	.	G	A	2	2	4	0	1	5	0	0
12	18913584	.	A	G	9	4	13	0	0	13	0	0
12	18913602	.	A	G	6	5	11	0	2	13	0	0
12	18913850	.	A	G	13	2	15	0	1	16	0	0
12	18913852	.	A	G	12	3	15	0	0	15	0	0
12	19064796	.	A	T	8	4	12	0	3	15	0	0
12	19317745	.	G	A	21	21	42	0	1	43	0	0
12	19317791	.	G	A	21	31	52	0	1	53	0	0
12	19317875	.	G	A	19	20	39	0	2	41	0	0
12	19317930	.	G	T	3	19	22	0	19	42	1	0
12	19318157	.	T	C	21	20	41	0	0	41	0	0
12	19318158	.	G	A	20	20	40	0	1	41	0	0
12	19318194	.	G	C	19	18	37	0	1	38	0	0
12	19318210	.	T	C	23	16	39	0	1	40	0	0
12	19318441	.	A	T	5	7	12	0	1	13	0	0
12	19318475	.	G	A	5	6	11	0	0	11	0	0
12	19318487	.	C	A	6	5	11	0	0	11	0	0
12	19318539	.	G	A	7	14	21	0	0	21	0	0
12	19318615	.	A	T	15	12	27	0	1	28	0	0
12	19318823	.	A	G	11	1	12	0	15	27	0	0
12	19318855	.	C	T	15	17	32	0	0	32	0	0
12	19319085	.	T	G	1	3	4	0	0	4	0	0
12	19320741	.	G	A	2	2	4	0	0	4	0	0
12	19320778	.	G	A	3	3	6	0	0	6	0	0
12	19320821	.	C	A	2	2	4	0	0	4	0	0
12	19323174	.	A	C	1	2	3	0	0	3	0	0
12	19333787	.	G	T	3	2	5	0	0	5	0	0
12	19337850	.	G	A	6	4	10	0	0	10	0	0
12	19338003	.	G	T	1	6	7	0	0	7	0	0
12	19338032	.	T	A	1	3	4	0	0	4	0	0
12	19338280	.	G	A	4	5	9	0	1	10	0	0
12	19338387	.	T	G	10	3	13	0	2	15	0	0
12	19338935	.	T	C	3	4	7	0	0	7	0	0
12	19339065	.	G	T	2	3	5	0	1	6	0	0
12	19339403	.	C	A	5	3	8	0	0	8	0	0
12	19339490	.	T	A	6	3	9	0	2	11	0	0
12	19339492	.	C	T	7	4	11	0	0	11	0	0
12	19340086	.	A	G	6	4	10	0	0	10	0	0
12	19341869	.	G	A	20	21	41	0	0	41	0	0
12	19348622	.	A	G	17	23	40	0	1	41	0	0
12	19348678	.	T	C	13	14	27	0	1	28	0	0
12	19353091	.	C	T	20	24	44	0	2	46	0	0
12	19353174	.	C	T	16	16	32	0	1	33	0	0
12	19353203	.	A	C	19	20	39	0	1	40	0	0
12	19353513	.	A	G	12	10	22	0	1	23	0	0
12	19353622	.	A	T	14	21	35	0	1	36	0	0
12	19362500	.	C	T	5	7	12	0	1	13	0	0
12	19362624	.	A	G	2	6	8	0	1	9	0	0
12	19369292	.	G	A	10	16	26	0	0	26	0	0
12	19369414	.	A	G	8	7	15	0	0	15	0	0
12	19371801	.	A	G	3	0	3	0	5	8	0	0
12	19373175	.	G	A	8	6	14	0	2	16	0	0
12	19375729	.	T	C	11	6	17	0	0	17	0	0
12	19375741	.	C	T	10	6	16	0	0	16	0	0
12	19379564	.	G	C	0	9	9	0	7	16	0	0
12	19379642	.	C	T	8	7	15	0	3	18	0	0
12	19380120	.	A	G	8	8	16	0	0	16	0	0
12	19383137	.	A	G	7	7	14	0	1	15	0	0
12	19383139	.	T	C	6	7	13	0	2	15	0	0
12	19383217	.	T	C	10	6	16	0	1	17	0	0
12	19383242	.	T	A	9	7	16	0	0	16	0	0
12	19383260	.	A	T	8	9	17	0	0	17	0	0
12	19383417	.	T	C	10	12	22	0	0	22	0	0
12	19383539	.	C	T	9	10	19	0	2	21	0	0
12	19383843	.	G	A	4	4	8	0	0	8	0	0
12	19385072	.	G	A	10	8	18	0	1	19	0	0
12	19385287	.	T	C	8	3	11	0	0	11	0	0
12	19385664	.	C	T	5	9	14	0	1	15	0	0
12	19408650	.	G	T	0	3	3	0	2	5	0	0
12	19422112	.	C	T	3	2	5	0	0	5	0	0
12	19422124	.	G	A	3	3	6	0	0	6	0	0
12	19422271	.	T	C	3	3	6	0	0	6	0	0
12	19422319	.	T	C	4	2	6	0	0	6	0	0
12	19422410	.	G	A	0	3	3	0	7	10	0	0
12	19430068	.	G	A	0	3	3	0	1	4	0	0
12	19430143	.	G	A	8	3	11	0	1	12	0	0
12	19430154	.	A	G	10	4	14	0	0	14	0	0
12	19433542	.	C	G	3	3	6	0	1	7	0	0
12	19433953	.	T	C	5	5	10	0	0	10	0	0
12	19637039	.	T	G	9	7	16	1	1	18	0	0
12	19658488	.	G	T	1	5	6	0	0	6	0	0
12	19658505	.	T	C	2	4	6	0	0	6	0	0
12	19658587	.	A	G	4	2	6	0	0	6	0	0
12	19658626	.	C	T	5	2	7	0	0	7	0	0
12	19658691	.	A	G	5	0	5	0	5	10	0	0
12	19658735	.	A	T	7	7	14	0	1	15	0	0
12	19658836	.	G	A	7	10	17	0	1	18	0	0
12	19792566	.	T	C	8	11	19	0	1	20	0	0
12	19792945	.	C	G	18	8	26	0	3	29	0	0
12	19792970	.	G	A	21	13	34	0	1	35	0	0
12	19793001	.	G	A	21	10	31	0	0	31	0	0
12	19793039	.	T	A	19	8	27	0	1	28	0	0
12	19793470	.	C	G	21	20	41	0	0	41	0	0
12	19793534	.	T	A	22	17	39	0	1	40	0	0
12	19793657	.	G	A	19	19	38	0	0	38	0	0
12	19793693	.	A	G	14	18	32	0	0	32	0	0
12	19865090	.	T	C	12	0	12	0	9	21	0	0
12	19865347	.	C	T	11	7	18	0	1	19	0	0
12	19865567	.	G	A	10	8	18	0	0	18	0	0
12	19866983	.	A	G	2	4	6	0	0	6	0	0
12	19877890	.	A	G	2	0	2	0	2	4	0	0
12	19907100	.	A	T	3	2	5	0	0	5	0	0
12	19931572	.	A	T	2	1	3	0	1	4	0	0
12	19931970	.	A	T	5	4	9	0	0	9	0	0
12	19932072	.	T	C	1	3	4	0	1	5	0	0
12	19932122	.	C	A	2	2	4	0	0	4	0	0
12	19932195	.	A	T	3	5	8	0	0	8	0	0
12	19970250	.	G	A	5	5	10	0	0	10	0	0
12	19970362	.	T	A	2	4	6	0	0	6	0	0
12	19970562	.	A	G	0	0	0	0	3	3	0	0
12	19973531	.	A	G	5	0	5	0	7	12	0	0
12	19973564	.	T	C	6	7	13	0	0	13	0	0
12	19973939	.	A	G	6	0	6	0	4	10	0	0
12	19973942	.	A	G	6	4	10	0	0	10	0	0
12	19974092	.	G	A	1	3	4	0	2	6	0	0
12	19974196	.	G	A	2	3	5	0	1	6	0	0
12	20026573	.	T	G	2	2	4	0	0	4	0	0
12	20026597	.	G	A	2	2	4	0	0	4	0	0
12	20029667	.	T	C	3	3	6	0	0	6	0	0
12	20034735	.	T	C	4	5	9	0	0	9	0	0
12	20034744	.	T	C	4	3	7	0	0	7	0	0
12	20036061	.	T	G	1	0	1	0	2	3	0	0
12	20040321	.	C	A	2	2	4	0	0	4	0	0
12	20043897	.	G	C	3	2	5	0	0	5	0	0
12	20044684	.	T	A	1	2	3	0	0	3	0	0
12	20099085	.	A	G	15	9	24	0	1	25	0	0
12	20099478	.	A	G	12	10	22	0	1	23	0	0
12	20099657	.	T	C	18	16	34	1	0	35	0	0
12	20099708	.	T	A	10	13	23	0	0	23	0	0
12	20100109	.	A	G	17	18	35	0	2	37	0	0
12	20100169	.	A	G	18	17	35	0	0	35	0	0
12	20100190	.	T	C	14	0	14	0	16	30	0	0
12	20100391	.	G	A	19	20	39	0	1	40	0	0
12	20122600	.	G	C	5	3	8	0	0	8	0	0
12	20122709	.	A	T	10	11	21	0	0	21	0	0
12	20122785	.	T	C	8	5	13	0	0	13	0	0
12	20123320	.	G	A	6	3	9	0	0	9	0	0
12	20123881	.	A	C	10	5	15	0	0	15	0	0
12	20125561	.	A	G	6	0	6	0	3	9	0	0
12	20145111	.	A	C	14	7	21	0	1	22	0	0
12	20147218	.	G	C	24	12	36	0	0	36	0	0
12	20147229	.	A	G	23	9	32	0	0	32	0	0
12	20147428	.	G	A	20	13	33	1	1	35	0	0
12	20147486	.	A	G	18	1	19	0	19	38	0	0
12	20147504	.	T	C	13	25	38	0	0	38	0	0
12	20147564	.	A	T	9	17	26	0	0	26	0	0
12	20155804	.	T	A	1	3	4	0	0	4	0	0
12	20156707	.	C	T	2	2	4	0	0	4	0	0
12	20227724	.	A	G	2	2	4	0	0	4	0	0
12	20227766	.	C	T	0	2	2	0	4	6	0	0
12	20231828	.	T	C	1	2	3	0	0	3	0	0
12	20379356	.	A	C	4	3	7	0	0	7	0	0
12	20379586	.	G	C	6	8	14	0	0	14	0	0
12	20380050	.	C	G	5	15	20	0	0	20	0	0
12	20396459	.	T	A	12	12	24	0	1	25	0	0
12	20407789	.	A	G	6	5	11	0	0	11	0	0
12	20409495	.	G	T	4	6	10	0	0	10	0	0
12	20409523	.	A	G	7	5	12	0	0	12	0	0
12	20409600	.	A	G	3	4	7	0	0	7	0	0
12	20409680	.	T	A	10	3	13	0	1	14	0	0
12	20478509	.	G	A	1	2	3	0	1	4	0	0
12	20478586	.	T	C	1	1	2	0	1	3	0	0
12	20478606	.	C	A	2	1	3	0	1	4	0	0
12	20607308	.	C	T	6	5	11	0	1	12	0	0
12	20607417	.	C	T	8	7	15	0	0	15	0	0
12	20607515	.	G	A	5	4	9	0	1	10	0	0
12	20607711	.	G	C	5	6	11	0	0	11	0	0
12	20608248	.	A	T	4	2	6	0	0	6	0	0
12	20608370	.	T	A	4	4	8	0	0	8	0	0
12	20608397	.	G	A	1	8	9	0	0	9	0	0
12	20608518	.	C	T	2	4	6	0	0	6	0	0
12	20651441	.	G	A	1	2	3	0	0	3	0	0
12	20652284	.	T	C	1	3	4	0	0	4	0	0
12	20653128	.	C	T	2	8	10	0	0	10	0	0
12	20653159	.	G	A	7	3	10	0	0	10	0	0
12	20653244	.	A	T	7	3	10	0	0	10	0	0
12	20658037	.	T	C	6	5	11	0	1	12	0	0
12	20676252	.	C	T	8	7	15	0	0	15	0	0
12	20676345	.	C	T	1	4	5	0	0	5	0	0
12	20677202	.	C	A	7	5	12	0	1	13	0	0
12	20677874	.	A	G	6	3	9	0	0	9	0	0
12	20777733	.	C	T	3	3	6	1	0	7	0	0
12	21539855	.	T	C	26	16	42	0	1	43	0	0
12	21549172	.	G	A	12	18	30	0	9	39	0	0
12	21684306	.	A	G	5	0	5	0	9	14	0	0
12	21687757	.	T	C	18	8	26	0	3	29	0	0
12	21799194	.	G	T	1	4	5	0	0	5	0	0
12	21855246	.	G	A	1	2	3	0	0	3	0	0
12	22310722	.	T	C	3	3	6	0	1	7	0	0
12	22311500	.	G	A	7	4	11	0	0	11	0	0
12	22339573	.	A	G	3	2	5	0	0	5	0	0
12	22372902	.	A	G	1	3	4	0	0	4	0	0
12	22407867	.	G	C	1	4	5	0	0	5	0	0
12	22410014	.	C	T	1	4	5	0	0	5	0	0
12	22410077	.	G	T	5	4	9	0	0	9	0	0
12	22412290	.	T	C	7	4	11	0	0	11	0	0
12	22412630	.	A	G	2	3	5	0	0	5	0	0
12	22415849	.	T	C	3	2	5	0	0	5	0	0
12	22418297	.	T	C	2	9	11	0	1	12	0	0
12	22420645	.	A	G	5	5	10	0	0	10	0	0
12	22420669	.	T	C	6	5	11	0	2	13	0	0
12	22431304	.	G	A	4	12	16	0	0	16	0	0
12	22433246	.	G	A	0	5	5	0	4	9	0	0
12	22435203	.	T	C	11	6	17	0	0	17	0	0
12	22437160	.	T	C	8	9	17	0	2	19	0	0
12	22444470	.	C	T	5	9	14	0	0	14	0	0
12	22444613	.	A	T	9	13	22	0	0	22	0	0
12	22451304	.	T	C	4	5	9	0	1	10	0	0
12	22451793	.	A	C	5	15	20	0	0	20	0	0
12	22451811	.	A	G	6	14	20	0	1	21	0	0
12	22456934	.	A	G	9	9	18	0	2	20	0	0
12	22460101	.	C	G	8	3	11	0	0	11	0	0
12	22460316	.	G	T	6	7	13	0	0	13	0	0
12	22462021	.	C	G	1	3	4	0	6	10	0	0
12	22467995	.	C	T	2	5	7	0	1	8	0	0
12	22468075	.	G	A	6	4	10	0	1	11	0	0
12	22468118	.	A	T	3	5	8	0	0	8	0	0
12	22468286	.	C	G	2	2	4	0	1	5	0	0
12	22470282	.	T	C	5	2	7	0	0	7	0	0
12	22470303	.	T	C	3	3	6	0	0	6	0	0
12	22473380	.	C	G	5	2	7	0	0	7	0	0
12	22473434	.	T	C	3	2	5	0	0	5	0	0
12	22473640	.	A	G	4	2	6	0	0	6	0	0
12	22473736	.	G	A	3	2	5	0	0	5	0	0
12	22480599	.	A	G	3	5	8	0	0	8	0	0
12	22480610	.	A	G	3	5	8	0	0	8	0	0
12	22480850	.	T	C	2	4	6	0	0	6	0	0
12	22480862	.	T	C	2	4	6	0	0	6	0	0
12	22481012	.	C	T	4	2	6	0	1	7	0	0
12	22487415	.	T	C	5	2	7	0	1	8	0	0
12	22487472	.	T	C	3	0	3	0	2	5	0	0
12	22528869	.	G	A	16	18	34	0	2	36	0	0
12	22529407	.	C	T	20	14	34	0	4	38	0	0
12	22529456	.	T	G	12	25	37	0	7	44	0	0
12	22529457	.	A	C	10	29	39	0	4	43	0	0
12	22529560	.	T	A	24	22	46	0	3	49	0	0
12	22529655	.	C	G	20	18	38	0	1	39	0	0
12	22530053	.	A	G	12	8	20	1	1	22	0	0
12	22530056	.	G	A	12	8	20	1	1	22	0	0
12	22530352	.	G	A	18	22	40	0	3	43	0	0
12	22530362	.	C	T	3	26	29	0	20	49	0	0
12	22530849	.	C	G	14	11	25	0	0	25	0	0
12	22531212	.	T	A	14	10	24	0	1	25	0	0
12	22531505	.	A	T	13	15	28	0	1	29	0	0
12	22531929	.	T	A	14	17	31	0	2	33	0	0
12	22532594	.	C	T	16	12	28	0	7	35	0	0
12	22532595	.	G	A	19	13	32	0	1	33	0	0
12	22533054	.	G	A	22	16	38	0	1	39	0	0
12	22533806	.	C	T	2	12	14	0	16	30	0	0
12	22533908	.	G	A	14	8	22	0	0	22	0	0
12	22534383	.	A	G	8	18	26	0	0	26	0	0
12	22534389	.	T	C	7	0	7	0	17	24	0	0
12	22535197	.	A	G	6	14	20	0	2	22	0	0
12	22535380	.	C	T	1	6	7	0	5	12	0	0
12	22535498	.	T	C	7	5	12	0	1	13	0	0
12	22535546	.	A	T	13	7	20	0	1	21	0	0
12	22535567	.	T	C	14	9	23	0	0	23	0	0
12	22535631	.	T	G	9	6	15	0	0	15	0	0
12	22536188	.	C	T	2	4	6	0	11	17	0	0
12	22536609	.	T	G	6	16	22	0	0	22	0	0
12	22536621	.	G	C	6	18	24	0	1	25	0	0
12	22536969	.	C	T	4	8	12	0	1	13	0	0
12	22562581	.	T	C	0	1	1	0	2	3	0	0
12	22562906	.	G	A	3	3	6	0	0	6	0	0
12	22563882	.	T	C	1	2	3	0	0	3	0	0
12	22565015	.	T	C	2	2	4	0	0	4	0	0
12	22565764	.	A	G	1	2	3	0	1	4	0	0
12	22566413	.	A	G	1	2	3	0	0	3	0	0
12	22570814	.	T	C	16	11	27	0	4	31	0	0
12	22571368	.	G	C	12	7	19	0	0	19	0	0
12	22571628	.	G	A	8	3	11	0	0	11	0	0
12	22572199	.	C	G	21	11	32	0	0	32	0	0
12	22572287	.	A	C	15	14	29	0	0	29	0	0
12	22572367	.	C	T	12	21	33	0	1	34	0	0
12	22572585	.	G	A	14	17	31	0	1	32	0	0
12	22572650	.	T	C	7	10	17	0	1	18	0	0
12	22572660	.	G	A	8	12	20	0	1	21	0	0
12	22572756	.	C	T	18	13	31	0	1	32	0	0
12	22572814	.	A	G	8	0	8	0	14	22	0	0
12	22572937	.	C	T	23	9	32	1	1	34	0	0
12	22573080	.	T	A	22	11	33	0	2	35	0	0
12	22573185	.	G	A	6	5	11	0	0	11	0	0
12	22573239	.	A	C	3	2	5	0	0	5	0	0
12	22628983	.	G	A	1	2	3	0	0	3	0	0
12	22634834	.	C	T	1	4	5	0	0	5	0	0
12	22640923	.	T	C	4	6	10	0	0	10	0	0
12	22644038	.	C	A	2	6	8	1	1	10	0	0
12	22644406	.	C	T	1	3	4	0	0	4	0	0
12	22644687	.	T	G	7	8	15	0	0	15	0	0
12	22644800	.	G	A	5	2	7	0	0	7	0	0
12	22644993	.	C	T	3	2	5	0	0	5	0	0
12	22644998	.	A	G	4	2	6	0	0	6	0	0
12	22648423	.	A	T	2	2	4	0	0	4	0	0
12	22657163	.	A	G	3	2	5	0	0	5	0	0
12	22670217	.	A	T	1	3	4	0	0	4	0	0
12	22680352	.	C	A	2	4	6	0	0	6	0	0
12	22774261	.	C	T	1	4	5	0	0	5	0	0
12	22774439	.	A	G	5	3	8	0	0	8	0	0
12	22774778	.	C	T	2	3	5	0	1	6	0	0
12	22774793	.	C	T	3	4	7	0	0	7	0	0
12	22785874	.	G	A	0	2	2	0	3	5	0	0
12	22800097	.	A	G	7	8	15	0	0	15	0	0
12	22803813	.	C	T	10	5	15	0	0	15	0	0
12	22809614	.	C	T	3	6	9	0	1	10	0	0
12	22814990	.	T	C	15	4	19	0	1	20	0	0
12	22815097	.	T	C	9	3	12	0	1	13	0	0
12	22815203	.	G	A	11	7	18	0	0	18	0	0
12	22815365	.	C	T	17	9	26	0	2	28	0	0
12	22815647	.	G	A	4	4	8	0	0	8	0	0
12	22815672	.	G	A	3	5	8	0	2	10	0	0
12	22815724	.	G	T	7	5	12	0	0	12	0	0
12	22815767	.	A	T	9	3	12	0	0	12	0	0
12	22915400	.	A	G	1	2	3	0	0	3	0	0
12	22932087	.	C	T	11	8	19	0	1	20	0	0
12	22932090	.	G	C	10	8	18	0	0	19	1	0
12	22932674	.	T	A	12	11	23	0	2	25	0	0
12	22932675	.	A	T	15	11	26	0	1	27	0	0
12	22932852	.	G	T	2	11	13	0	9	22	0	0
12	22932875	.	G	T	15	10	25	0	1	26	0	0
12	22962211	.	A	T	4	6	10	0	0	10	0	0
12	22962764	.	T	C	0	17	17	0	1	18	0	0
12	22962864	.	G	A	4	5	9	0	1	10	0	0
12	22963141	.	G	C	4	3	7	0	1	8	0	0
12	22963443	.	T	A	2	1	3	0	0	3	0	0
12	22991383	.	C	T	2	2	4	0	1	5	0	0
12	23008540	.	C	A	3	3	6	0	1	7	0	0
12	23009215	.	G	A	4	4	8	0	0	8	0	0
12	23385168	.	G	A	7	9	16	0	0	16	0	0
12	23389675	.	G	A	12	9	21	0	0	22	1	0
12	23400392	.	C	T	15	20	35	0	1	36	0	0
12	23411287	.	C	T	16	17	33	0	2	35	0	0
12	23415347	.	C	T	18	16	34	0	0	34	0	0
12	23415370	.	C	T	21	17	38	0	0	38	0	0
12	23415662	.	G	A	18	15	33	1	3	37	0	0
12	23415672	.	C	A	17	21	38	0	0	38	0	0
12	23415878	.	G	A	14	7	21	0	1	22	0	0
12	23415897	.	A	T	12	5	17	0	2	19	0	0
12	23429619	.	G	A	2	2	4	0	0	4	0	0
12	23429685	.	C	T	5	3	8	0	0	8	0	0
12	23430003	.	C	A	2	3	5	0	0	5	0	0
12	23430091	.	G	A	5	4	9	0	0	9	0	0
12	23430092	.	T	A	5	4	9	0	0	9	0	0
12	23665119	.	A	G	1	0	1	0	2	3	0	0
12	23674165	.	A	T	3	2	5	0	0	5	0	0
12	23784266	.	C	A	3	4	7	0	0	7	0	0
12	23787358	.	T	G	2	3	5	0	0	5	0	0
12	23787904	.	A	T	6	5	11	0	0	11	0	0
12	23789838	.	A	C	8	4	12	0	0	12	0	0
12	23790148	.	A	T	3	8	11	0	1	12	0	0
12	23793990	.	A	T	2	4	6	0	0	6	0	0
12	23794148	.	A	T	4	6	10	0	0	10	0	0
12	23794884	.	G	A	1	3	4	0	0	4	0	0
12	23795834	.	G	A	1	3	4	0	0	4	0	0
12	23795912	.	T	G	2	3	5	0	0	5	0	0
12	23925093	.	A	G	8	5	13	0	0	13	0	0
12	24007733	.	A	C	2	4	6	0	0	6	0	0
12	24023704	.	T	A	4	2	6	0	0	6	0	0
12	24030454	.	C	T	3	4	7	0	0	7	0	0
12	24030458	.	G	A	3	3	6	0	0	6	0	0
12	24034771	.	C	T	1	4	5	0	1	6	0	0
12	24041169	.	A	G	4	1	5	0	6	11	0	0
12	24041253	.	G	T	2	4	6	0	0	6	0	0
12	24041254	.	T	A	2	4	6	0	0	6	0	0
12	24041367	.	A	T	4	5	9	0	0	9	0	0
12	24041600	.	A	G	4	0	4	0	5	9	0	0
12	24043703	.	C	T	3	5	8	0	0	8	0	0
12	24043736	.	C	T	3	8	11	0	0	11	0	0
12	24043909	.	C	T	8	2	10	0	0	10	0	0
12	24043942	.	C	T	4	5	9	0	1	10	0	0
12	24051894	.	G	T	6	2	8	0	1	9	0	0
12	24051944	.	T	G	5	5	10	0	0	10	0	0
12	24052578	.	C	T	7	11	18	0	1	19	0	0
12	24052684	.	G	A	14	10	24	0	1	25	0	0
12	24056500	.	G	T	1	3	4	0	0	4	0	0
12	24056539	.	G	A	1	4	5	0	1	6	0	0
12	24056716	.	G	T	1	4	5	0	0	5	0	0
12	24056738	.	G	A	1	5	6	0	0	6	0	0
12	24056755	.	T	A	1	4	5	0	0	5	0	0
12	24057198	.	G	T	1	4	5	0	0	5	0	0
12	24057368	.	G	A	2	3	5	0	0	5	0	0
12	24060008	.	A	G	5	6	11	0	1	12	0	0
12	24061312	.	G	T	0	2	2	0	4	6	0	0
12	24070858	.	C	T	3	3	6	0	0	6	0	0
12	24342518	.	T	A	3	2	5	0	1	6	0	0
12	24342531	.	G	A	0	4	4	0	1	5	0	0
12	24342556	.	T	C	3	2	5	0	0	5	0	0
12	24345427	.	C	A	5	7	12	0	0	12	0	0
12	24345832	.	G	A	2	12	14	0	5	19	0	0
12	24447515	.	G	A	1	7	8	0	6	14	0	0
12	24465454	.	C	T	15	10	25	0	0	25	0	0
12	24465466	.	T	C	15	9	24	0	0	24	0	0
12	24465565	.	T	C	13	11	24	0	1	25	0	0
12	24465712	.	T	C	16	11	27	0	0	27	0	0
12	24465875	.	A	C	13	10	23	0	0	23	0	0
12	24484083	.	A	C	7	13	20	1	0	21	0	0
12	24484084	.	C	T	7	13	20	1	0	21	0	0
12	24484131	.	G	T	17	12	29	0	1	30	0	0
12	24484134	.	C	T	18	11	29	0	2	31	0	0
12	24484215	.	T	C	15	5	20	0	1	21	0	0
12	24562338	.	C	T	2	4	6	0	1	7	0	0
12	24562410	.	A	G	1	3	4	0	0	4	0	0
12	24606963	.	C	T	29	18	47	0	1	48	0	0
12	24607140	.	G	A	3	28	31	0	35	66	0	0
12	24607215	.	G	A	28	33	61	0	4	65	0	0
12	24635925	.	A	G	37	3	40	0	25	65	0	0
12	24636261	.	C	A	26	21	47	0	7	54	0	0
12	24636746	.	A	G	33	18	51	1	3	55	0	0
12	24636997	.	T	G	29	24	53	0	0	53	0	0
12	24637148	.	G	T	5	2	7	0	0	7	0	0
12	24796653	.	G	A	2	6	8	0	0	8	0	0
12	24796734	.	C	A	3	6	9	0	1	10	0	0
12	24797128	.	A	T	13	8	21	0	0	21	0	0
12	24797351	.	C	T	8	18	26	0	2	28	0	0
12	24797541	.	G	A	18	15	33	0	0	33	0	0
12	24797603	.	T	C	10	9	19	0	3	22	0	0
12	24797908	.	C	T	12	4	16	0	2	18	0	0
12	24797999	.	G	C	8	4	12	1	0	13	0	0
12	24798235	.	A	G	7	10	17	0	0	17	0	0
12	24798237	.	T	G	7	10	17	0	0	17	0	0
12	24798358	.	A	G	9	9	18	0	0	18	0	0
12	24811369	.	G	A	6	10	16	0	0	16	0	0
12	24811423	.	G	A	2	5	7	0	1	8	0	0
12	24811489	.	A	G	7	4	11	0	1	12	0	0
12	24811558	.	T	C	6	0	6	0	4	10	0	0
12	24832098	.	G	A	5	7	12	0	0	12	0	0
12	24841945	.	A	G	12	7	19	0	2	21	0	0
12	24842119	.	A	G	11	15	26	0	2	28	0	0
12	24842267	.	T	G	11	16	27	0	1	28	0	0
12	24842597	.	C	T	0	4	4	0	3	7	0	0
12	24843292	.	C	T	1	18	19	0	16	35	0	0
12	24848651	.	C	T	6	4	10	0	0	10	0	0
12	24848678	.	A	G	6	8	14	0	0	14	0	0
12	24848687	.	A	G	5	8	13	0	0	13	0	0
12	24848765	.	T	C	4	7	11	0	0	11	0	0
12	24857033	.	G	A	1	8	9	0	1	10	0	0
12	24904842	.	T	C	4	5	9	0	0	9	0	0
12	24910116	.	C	G	6	3	9	0	0	9	0	0
12	24910492	.	A	C	4	3	7	0	0	7	0	0
12	24910546	.	T	A	3	6	9	0	0	9	0	0
12	24913442	.	C	G	4	5	9	0	0	9	0	0
12	24913535	.	G	C	1	4	5	0	0	5	0	0
12	25094200	.	T	C	7	5	12	0	0	12	0	0
12	25094201	.	T	C	4	6	10	0	3	13	0	0
12	25094282	.	T	C	6	3	9	0	0	9	0	0
12	25094359	.	T	C	5	9	14	0	0	14	0	0
12	25094516	.	T	C	5	0	5	0	10	15	0	0
12	25094520	.	T	C	9	6	15	0	0	15	0	0
12	25094722	.	T	A	2	1	3	0	1	4	0	0
12	25224073	.	A	T	4	3	7	0	0	7	0	0
12	25768836	.	T	C	7	8	15	0	2	17	0	0
12	25770231	.	A	T	1	2	3	0	0	3	0	0
12	25894625	.	T	G	0	22	22	0	3	25	0	0
12	27128481	.	T	C	4	2	6	0	1	7	0	0
12	28072821	.	C	G	20	12	32	0	2	34	0	0
12	28948117	.	T	C	7	3	10	0	0	10	0	0
12	28949067	.	A	G	5	5	10	0	0	10	0	0
12	28949112	.	C	A	5	4	9	0	1	10	0	0
12	28950678	.	G	T	2	4	6	0	0	6	0	0
12	28951019	.	C	T	1	2	3	0	6	9	0	0
12	28952139	.	T	C	5	7	12	0	0	12	0	0
12	28955614	.	T	C	2	0	2	0	4	6	0	0
12	28960284	.	T	C	7	5	12	0	0	12	0	0
12	28960321	.	G	A	6	8	14	0	1	15	0	0
12	28960357	.	G	A	0	8	8	0	5	13	0	0
12	28960441	.	C	T	5	2	7	0	0	7	0	0
12	28960481	.	A	G	3	3	6	0	1	7	0	0
12	28962884	.	C	T	1	2	3	0	0	3	0	0
12	29063346	.	G	A	6	4	10	0	0	10	0	0
12	29084032	.	T	C	4	8	12	0	0	12	0	0
12	29102585	.	T	C	12	4	16	0	2	18	0	0
12	29103004	.	T	C	1	4	5	0	0	5	0	0
12	29103041	.	T	A	6	6	12	0	0	12	0	0
12	29105508	.	A	T	4	5	9	1	1	11	0	0
12	29105510	.	A	T	4	6	10	1	0	11	0	0
12	29207533	.	T	C	7	5	12	0	0	12	0	0
12	29207590	.	G	A	3	9	12	0	4	16	0	0
12	29207683	.	G	T	7	12	19	0	2	21	0	0
12	29208099	.	T	G	8	3	11	0	1	12	0	0
12	29209834	.	G	A	4	5	9	0	1	10	0	0
12	29209840	.	A	T	5	5	10	0	0	10	0	0
12	29210371	.	C	A	7	9	16	0	0	16	0	0
12	29210435	.	C	G	8	9	17	0	0	17	0	0
12	29210600	.	C	T	11	7	18	0	0	18	0	0
12	29210719	.	T	A	10	14	24	0	1	25	0	0
12	29210917	.	T	C	3	6	9	0	0	9	0	0
12	29211017	.	C	T	3	2	5	0	1	6	0	0
12	29211082	.	G	A	11	6	17	0	1	18	0	0
12	29211195	.	T	A	9	9	18	0	1	19	0	0
12	29211232	.	G	A	0	16	16	0	13	29	0	0
12	29211289	.	T	A	21	20	41	0	0	41	0	0
12	29211292	.	A	G	16	16	32	0	6	38	0	0
12	29223498	.	A	G	4	6	10	0	0	10	0	0
12	29223612	.	T	G	3	4	7	0	1	8	0	0
12	29223751	.	G	C	2	2	4	0	0	4	0	0
12	29223811	.	C	A	2	4	6	0	0	6	0	0
12	29223921	.	G	A	4	4	8	0	0	8	0	0
12	29224182	.	T	C	2	3	5	0	0	5	0	0
12	29224250	.	T	G	5	2	7	0	0	7	0	0
12	29224310	.	A	G	4	2	6	0	0	6	0	0
12	29224326	.	T	G	4	1	5	0	1	6	0	0
12	29224521	.	A	T	1	3	4	0	0	4	0	0
12	29226152	.	T	C	3	4	7	0	0	7	0	0
12	29227014	.	T	G	3	2	5	0	0	5	0	0
12	29227350	.	G	T	2	2	4	0	0	4	0	0
12	29229047	.	G	C	1	3	4	0	0	4	0	0
12	29244139	.	T	C	1	2	3	0	0	3	0	0
12	29251251	.	T	C	5	5	10	0	0	10	0	0
12	29251520	.	A	G	3	4	7	0	0	7	0	0
12	29260865	.	A	G	1	5	6	0	0	6	0	0
12	29262564	.	A	G	4	0	4	0	3	7	0	0
12	29266917	.	T	C	6	7	13	0	1	14	0	0
12	29269576	.	C	A	2	4	6	0	0	6	0	0
12	29269689	.	G	A	4	3	7	0	0	7	0	0
12	29269695	.	A	G	5	0	5	0	4	9	0	0
12	29269726	.	C	G	3	5	8	0	0	8	0	0
12	29269770	.	G	T	0	7	7	0	4	11	0	0
12	29269774	.	T	G	3	7	10	0	0	10	0	0
12	29269830	.	T	A	1	3	4	0	1	5	0	0
12	29351320	.	A	G	11	13	24	0	1	25	0	0
12	29351810	.	A	G	15	20	35	0	3	38	0	0
12	29358277	.	T	C	19	10	29	0	1	30	0	0
12	29358370	.	G	C	12	0	12	0	12	24	0	0
12	29358384	.	A	G	11	11	22	0	1	23	0	0
12	29358418	.	A	G	13	14	27	0	1	28	0	0
12	29624017	.	G	A	6	21	27	0	0	27	0	0
12	29624272	.	C	A	4	5	9	0	1	10	0	0
12	29624611	.	T	C	2	0	2	0	4	6	0	0
12	29801179	.	T	C	2	3	5	0	0	5	0	0
12	29801600	.	T	A	3	2	5	0	0	5	0	0
12	29811009	.	A	G	2	0	2	0	5	7	0	0
12	29843460	.	A	G	13	14	27	0	0	27	0	0
12	29844434	.	T	C	7	8	15	0	0	15	0	0
12	29873273	.	C	G	8	13	21	0	0	21	0	0
12	29921114	.	T	G	6	8	14	0	1	15	0	0
12	29947132	.	A	G	5	7	12	0	1	13	0	0
12	29947147	.	C	A	6	9	15	0	0	15	0	0
12	29957074	.	C	T	5	10	15	0	0	15	0	0
12	29957164	.	C	T	8	3	11	0	0	11	0	0
12	29965655	.	G	A	5	4	9	0	1	10	0	0
12	29965724	.	G	A	5	2	7	0	0	7	0	0
12	29968087	.	T	C	3	0	3	0	4	7	0	0
12	29973800	.	G	A	5	3	8	0	0	8	0	0
12	29976936	.	G	A	4	4	8	0	0	8	0	0
12	29976978	.	T	C	1	4	5	0	0	5	0	0
12	30031290	.	C	A	1	1	2	0	1	3	0	0
12	30031531	.	T	A	1	2	3	0	0	3	0	0
12	30031677	.	T	C	1	2	3	0	0	3	0	0
12	30031680	.	T	C	1	2	3	0	0	3	0	0
12	30031795	.	G	A	1	3	4	0	0	4	0	0
12	30036661	.	G	T	1	2	3	0	0	3	0	0
12	30129351	.	C	T	1	2	3	0	0	3	0	0
12	30153772	.	T	C	1	3	4	0	0	4	0	0
12	30156449	.	T	C	1	2	3	0	0	3	0	0
12	30192526	.	A	T	6	11	17	0	0	17	0	0
12	30200741	.	C	T	5	8	13	0	0	13	0	0
12	30207912	.	G	A	5	8	13	0	0	13	0	0
12	30208905	.	T	C	3	8	11	0	1	12	0	0
12	30211165	.	T	A	5	5	10	0	0	10	0	0
12	30216034	.	C	A	3	1	4	0	1	5	0	0
12	30216090	.	G	T	3	2	5	0	1	6	0	0
12	30216248	.	C	T	6	7	13	0	0	13	0	0
12	30216436	.	T	C	7	4	11	0	0	11	0	0
12	30216490	.	T	C	4	6	10	0	0	10	0	0
12	30216693	.	C	T	4	4	8	0	0	8	0	0
12	30216697	.	G	A	0	5	5	0	4	9	0	0
12	30217423	.	T	C	2	2	4	0	0	4	0	0
12	30217569	.	A	G	1	5	6	0	1	7	0	0
12	30217589	.	A	T	4	8	12	0	0	12	0	0
12	30217705	.	G	A	0	3	3	0	5	8	0	0
12	30217893	.	C	A	4	5	9	0	0	9	0	0
12	30217898	.	T	A	3	6	9	0	0	9	0	0
12	30217966	.	G	A	8	4	12	0	0	12	0	0
12	30217986	.	C	T	4	4	8	0	0	8	0	0
12	30218135	.	C	A	4	4	8	0	0	8	0	0
12	30218150	.	G	A	6	7	13	0	0	13	0	0
12	30218173	.	C	T	9	7	16	0	0	16	0	0
12	30219306	.	A	T	15	20	35	0	4	39	0	0
12	30219687	.	T	A	5	7	12	1	0	13	0	0
12	30219694	.	A	T	4	9	13	1	0	14	0	0
12	30219739	.	G	A	12	9	21	0	1	22	0	0
12	30219804	.	C	T	15	8	23	2	0	25	0	0
12	30292275	.	G	A	0	5	5	0	2	7	0	0
12	30302941	.	A	T	6	12	18	0	0	18	0	0
12	30307010	.	C	T	3	12	15	0	0	15	0	0
12	30382341	.	C	T	5	5	10	0	0	10	0	0
12	30382705	.	G	A	2	4	6	0	4	10	0	0
12	30385562	.	C	T	6	8	14	0	0	14	0	0
12	30391136	.	G	A	5	5	10	0	0	10	0	0
12	30418108	.	T	C	10	4	14	0	3	17	0	0
12	30418513	.	C	G	11	8	19	0	0	19	0	0
12	30419123	.	A	T	9	6	15	0	2	17	0	0
12	30419134	.	C	A	5	9	14	0	0	14	0	0
12	30419260	.	T	G	11	12	23	0	0	23	0	0
12	30419646	.	T	C	7	4	11	0	0	11	0	0
12	30419655	.	T	C	6	5	11	0	1	12	0	0
12	30419695	.	T	C	7	4	11	0	0	11	0	0
12	30442406	.	C	A	3	6	9	0	0	9	0	0
12	30442783	.	G	A	10	8	18	0	0	18	0	0
12	30443462	.	T	C	3	4	7	0	0	7	0	0
12	30459404	.	G	A	1	3	4	0	0	4	0	0
12	30459503	.	T	A	2	4	6	0	0	6	0	0
12	30459532	.	A	T	6	3	9	0	0	9	0	0
12	30459538	.	A	G	6	3	9	0	0	9	0	0
12	30460333	.	C	A	4	4	8	0	0	8	0	0
12	30461249	.	T	C	1	0	1	0	2	3	0	0
12	30467666	.	G	T	1	4	5	0	0	5	0	0
12	30712031	.	T	G	1	4	5	0	0	5	0	0
12	30712099	.	T	A	4	2	6	0	0	6	0	0
12	30737025	.	T	C	2	2	4	0	0	4	0	0
12	30741328	.	T	G	1	2	3	0	0	3	0	0
12	30796306	.	C	T	1	4	5	0	0	5	0	0
12	30796322	.	C	A	5	2	7	0	0	7	0	0
12	30796967	.	T	A	3	4	7	0	1	8	0	0
12	30798079	.	G	A	7	5	12	0	0	12	0	0
12	30798085	.	A	T	6	7	13	0	0	13	0	0
12	30800128	.	G	A	3	2	5	0	0	5	0	0
12	30803166	.	G	A	0	4	4	0	9	13	0	0
12	30803196	.	T	C	8	5	13	0	0	13	0	0
12	30803629	.	A	G	4	7	11	0	1	12	0	0
12	30805359	.	T	C	11	4	15	0	0	15	0	0
12	30805455	.	C	T	5	3	8	0	1	9	0	0
12	30806928	.	G	T	1	6	7	0	6	13	0	0
12	30807038	.	A	G	7	14	21	0	0	21	0	0
12	30807245	.	A	G	4	3	7	0	1	8	0	0
12	30807290	.	A	G	2	4	6	0	0	6	0	0
12	30807330	.	T	A	4	3	7	0	0	7	0	0
12	30807458	.	C	T	8	4	12	0	0	12	0	0
12	30807494	.	G	A	5	8	13	0	0	13	0	0
12	30807504	.	A	C	7	10	17	0	0	17	0	0
12	30807789	.	A	C	1	5	6	0	1	7	0	0
12	30808094	.	C	T	7	5	12	0	0	12	0	0
12	30808150	.	T	A	8	4	12	0	0	12	0	0
12	30808342	.	A	T	5	10	15	0	0	15	0	0
12	30808531	.	G	C	8	7	15	0	1	16	0	0
12	30808766	.	C	T	5	4	9	0	1	10	0	0
12	30808812	.	A	G	4	0	4	0	3	7	0	0
12	30808817	.	T	G	3	4	7	0	0	7	0	0
12	30979815	.	A	C	11	12	23	0	2	25	0	0
12	30980566	.	G	A	27	19	46	0	4	50	0	0
12	30981795	.	G	A	24	25	49	0	2	51	0	0
12	30986452	.	G	A	29	26	55	1	1	57	0	0
12	31102981	.	A	G	2	10	12	0	0	12	0	0
12	31435977	.	T	A	10	8	18	0	1	19	0	0
12	31438056	.	G	T	7	6	13	0	0	13	0	0
12	31438352	.	A	T	2	2	4	0	2	6	0	0
12	31438440	.	C	A	1	3	4	0	0	4	0	0
12	31516149	.	T	C	4	3	7	0	0	7	0	0
12	31520603	.	T	C	3	2	5	0	0	5	0	0
12	31523203	.	T	C	1	3	4	0	0	4	0	0
12	31528714	.	G	A	5	2	7	0	0	7	0	0
12	31532342	.	A	C	5	6	11	0	0	11	0	0
12	31532371	.	G	A	0	6	6	0	6	12	0	0
12	31532397	.	G	C	6	5	11	0	0	11	0	0
12	31532410	.	C	A	9	0	9	0	1	10	0	0
12	31532577	.	T	C	8	4	12	0	1	13	0	0
12	31532638	.	A	C	9	7	16	0	0	16	0	0
12	31532715	.	T	C	7	4	11	0	0	11	0	0
12	31629611	.	C	T	3	8	11	0	0	11	0	0
12	31630829	.	G	A	0	6	6	0	12	18	0	0
12	31631082	.	T	C	1	3	4	0	0	4	0	0
12	31664770	.	T	A	2	3	5	0	0	5	0	0
12	31664846	.	A	T	1	4	5	0	0	5	0	0
12	31689567	.	T	A	1	3	4	0	0	4	0	0
12	31694713	.	C	T	1	5	6	0	0	6	0	0
12	31704077	.	A	C	8	5	13	0	0	13	0	0
12	31704548	.	T	C	3	2	5	0	0	5	0	0
12	31708020	.	C	T	6	3	9	0	0	9	0	0
12	31708025	.	G	A	5	3	8	0	0	8	0	0
12	31708082	.	G	A	5	3	8	0	0	8	0	0
12	31708125	.	C	A	5	5	10	0	0	10	0	0
12	31709964	.	G	T	1	6	7	0	0	7	0	0
12	31720799	.	C	T	19	23	42	0	0	42	0	0
12	31721486	.	G	A	13	4	17	0	0	17	0	0
12	31722593	.	G	T	10	11	21	0	3	24	0	0
12	31722811	.	G	T	13	5	18	0	1	19	0	0
12	31722875	.	A	C	20	1	21	0	21	42	0	0
12	31724245	.	A	C	25	27	52	0	1	53	0	0
12	31724252	.	C	T	26	27	53	0	2	55	0	0
12	31729236	.	G	A	12	7	19	0	2	21	0	0
12	31729441	.	A	C	5	6	11	0	0	11	0	0
12	31729455	.	G	T	5	5	10	0	0	10	0	0
12	31740733	.	T	C	5	2	7	0	0	7	0	0
12	31740822	.	C	T	4	5	9	0	0	9	0	0
12	31741463	.	C	T	7	8	15	0	0	15	0	0
12	31743995	.	C	T	4	7	11	0	0	11	0	0
12	31753752	.	C	T	13	8	21	0	2	23	0	0
12	31753755	.	C	T	13	10	23	0	1	24	0	0
12	31764523	.	T	C	10	10	20	0	0	20	0	0
12	31764526	.	C	A	11	9	20	0	1	21	0	0
12	31765407	.	G	A	10	10	20	0	2	22	0	0
12	31765485	.	G	A	13	5	18	0	1	19	0	0
12	31783185	.	G	A	2	2	4	0	0	4	0	0
12	31787394	.	G	C	6	3	9	0	0	9	0	0
12	31789799	.	C	T	17	13	30	0	2	32	0	0
12	31794655	.	G	A	10	14	24	0	1	25	0	0
12	31909755	.	T	C	3	3	6	0	0	6	0	0
12	31909921	.	T	C	2	5	7	0	0	7	0	0
12	32039527	.	A	G	9	9	18	0	0	18	0	0
12	32039546	.	G	A	13	10	23	0	0	23	0	0
12	32039635	.	A	C	18	12	30	0	1	31	0	0
12	32039678	.	C	T	20	21	41	0	2	43	0	0
12	32039937	.	G	A	16	23	39	0	2	41	0	0
12	32039958	.	T	C	17	0	17	0	23	40	0	0
12	32040093	.	G	A	23	14	37	0	0	37	0	0
12	32045155	.	G	A	14	17	31	0	1	32	0	0
12	32045212	.	T	C	11	0	11	0	17	28	0	0
12	32051434	.	C	A	12	12	24	0	2	26	0	0
12	32051488	.	G	A	12	16	28	0	0	28	0	0
12	32066061	.	C	A	9	7	16	0	1	17	0	0
12	32068700	.	A	T	1	2	3	0	0	3	0	0
12	32115234	.	A	G	1	0	1	0	2	3	0	0
12	32125405	.	G	A	3	3	6	0	1	7	0	0
12	32159335	.	A	G	7	4	11	0	0	11	0	0
12	32159384	.	A	T	4	2	6	0	0	6	0	0
12	32160773	.	A	G	10	0	10	0	7	17	0	0
12	32160839	.	A	G	9	9	18	0	0	18	0	0
12	32160971	.	T	C	6	12	18	0	1	19	0	0
12	32161043	.	T	C	7	8	15	0	1	16	0	0
12	32162360	.	T	C	5	5	10	0	0	10	0	0
12	32162411	.	T	A	7	7	14	0	0	14	0	0
12	32186374	.	A	G	1	3	4	0	0	4	0	0
12	32373490	.	C	T	3	2	5	0	0	5	0	0
12	32373637	.	G	A	2	6	8	0	0	8	0	0
12	32373844	.	T	C	3	4	7	0	0	7	0	0
12	32374015	.	G	A	1	2	3	0	1	4	0	0
12	32389692	.	C	T	3	2	5	0	1	6	0	0
12	32389713	.	G	T	2	2	4	0	0	4	0	0
12	32976148	.	T	C	14	5	19	0	0	19	0	0
12	33151402	.	G	A	1	15	16	0	14	30	0	0
12	33151453	.	C	T	15	11	26	0	4	30	0	0
12	33245427	.	G	A	10	10	20	0	4	24	0	0
12	33245677	.	G	A	12	4	16	0	0	16	0	0
12	33245688	.	G	T	6	11	17	0	0	17	0	0
12	33246010	.	A	T	10	10	20	0	0	20	0	0
12	33247295	.	T	C	14	20	34	0	0	34	0	0
12	33247611	.	T	A	21	14	35	0	0	35	0	0
12	33248025	.	G	A	3	18	21	0	21	42	0	0
12	33248193	.	C	A	30	21	51	1	1	53	0	0
12	33248343	.	G	A	4	18	22	0	24	46	0	0
12	33248502	.	C	T	3	3	6	0	0	6	0	0
12	33248503	.	A	T	3	4	7	0	0	7	0	0
12	33320944	.	C	T	11	9	20	0	0	20	0	0
12	33329791	.	C	G	13	19	32	0	1	33	0	0
12	33331496	.	C	A	15	11	26	0	3	29	0	0
12	33331523	.	T	C	13	8	21	0	4	25	0	0
12	33331541	.	A	C	5	8	13	0	10	24	1	0
12	33331691	.	T	G	14	18	32	0	4	36	0	0
12	33331724	.	C	T	23	11	34	0	0	34	0	0
12	33335714	.	A	C	18	15	33	0	0	33	0	0
12	33335739	.	C	T	11	14	25	0	1	26	0	0
12	33335770	.	G	A	1	8	9	0	15	24	0	0
12	33335904	.	T	G	12	15	27	0	3	30	0	0
12	33335949	.	C	T	14	13	27	0	1	28	0	0
12	33336044	.	T	G	16	0	16	0	31	47	0	0
12	33336073	.	G	A	0	24	24	0	16	40	0	0
12	33336119	.	A	C	9	1	10	0	17	27	0	0
12	33336203	.	G	A	21	26	47	3	1	51	0	0
12	33336271	.	G	A	3	13	16	0	14	30	0	0
12	33351441	.	T	A	4	5	9	0	0	9	0	0
12	33352595	.	C	T	8	3	11	0	0	11	0	0
12	33352601	.	C	T	6	2	8	0	0	8	0	0
12	33352709	.	A	G	6	2	8	0	0	8	0	0
12	33352862	.	C	T	1	3	4	0	0	4	0	0
12	33354265	.	A	G	1	2	3	0	1	4	0	0
12	33354286	.	G	A	2	3	5	0	0	5	0	0
12	33359588	.	T	C	1	0	1	0	3	4	0	0
12	33371628	.	G	A	1	5	6	0	0	6	0	0
12	33372076	.	T	C	2	2	4	0	0	4	0	0
12	33386449	.	C	T	1	5	6	0	0	6	0	0
12	33391442	.	G	A	1	4	5	0	0	5	0	0
12	33391457	.	G	A	1	4	5	0	0	5	0	0
12	33411239	.	A	C	1	2	3	0	0	3	0	0
12	33411695	.	C	T	3	2	5	0	1	6	0	0
12	33420467	.	C	A	3	5	8	0	0	8	0	0
12	33420482	.	T	C	3	3	6	0	0	6	0	0
12	33428311	.	A	G	4	2	6	0	1	7	0	0
12	33428636	.	T	C	2	5	7	0	0	7	0	0
12	33431014	.	G	A	3	2	5	0	0	5	0	0
12	33434946	.	G	A	7	5	12	0	1	13	0	0
12	33434970	.	C	G	7	6	13	0	0	13	0	0
12	33435048	.	C	T	3	3	6	0	0	6	0	0
12	33435834	.	A	G	4	5	9	0	0	9	0	0
12	33437562	.	A	G	9	4	13	0	1	14	0	0
12	33437882	.	G	A	0	9	9	0	12	21	0	0
12	33438250	.	G	A	1	12	13	0	8	21	0	0
12	33439860	.	C	A	9	9	18	0	1	19	0	0
12	33440022	.	C	T	5	11	16	0	0	16	0	0
12	33440025	.	T	C	5	10	15	0	1	16	0	0
12	33440135	.	A	G	13	14	27	0	0	27	0	0
12	33440146	.	A	G	12	0	12	0	14	26	0	0
12	33440200	.	C	T	13	12	25	0	0	25	0	0
12	33442578	.	C	T	11	11	22	0	0	22	0	0
12	33442675	.	G	A	7	11	18	0	1	19	0	0
12	33442924	.	G	A	12	6	18	0	1	19	0	0
12	33444839	.	T	C	13	15	28	0	0	28	0	0
12	33448124	.	T	A	20	22	42	0	1	43	0	0
12	33448253	.	C	T	21	4	25	0	2	27	0	0
12	33448411	.	C	T	6	3	9	0	0	9	0	0
12	33448418	.	C	G	5	3	8	0	0	8	0	0
12	33448528	.	C	G	3	5	8	0	0	8	0	0
12	33449047	.	G	A	14	5	19	0	0	19	0	0
12	33449229	.	T	A	20	22	42	0	1	43	0	0
12	33449519	.	G	A	6	11	17	0	0	17	0	0
12	33449553	.	A	G	5	13	18	0	1	19	0	0
12	33449578	.	C	T	7	12	19	1	1	21	0	0
12	33449902	.	T	A	16	8	24	1	3	28	0	0
12	33449924	.	A	G	17	1	18	0	13	31	0	0
12	33450194	.	G	A	3	14	17	0	19	36	0	0
12	33450332	.	T	C	12	17	29	0	3	32	0	0
12	33450368	.	T	A	16	5	21	0	1	22	0	0
12	33450435	.	A	G	2	1	3	0	6	9	0	0
12	33453699	.	G	C	4	2	6	0	0	6	0	0
12	33453734	.	T	A	4	4	8	0	0	8	0	0
12	33460912	.	T	C	2	2	4	0	0	4	0	0
12	33460960	.	T	C	4	2	6	0	0	6	0	0
12	33467556	.	A	C	3	5	8	0	0	8	0	0
12	33469083	.	T	C	1	8	9	0	0	9	0	0
12	33472148	.	A	T	8	11	19	0	0	19	0	0
12	33473481	.	G	A	2	10	12	0	10	22	0	0
12	33473486	.	C	T	9	9	18	0	3	21	0	0
12	33473806	.	C	A	4	8	12	0	1	13	0	0
12	33473844	.	C	T	4	4	8	0	0	8	0	0
12	33473874	.	A	T	2	6	8	0	0	8	0	0
12	33536717	.	C	T	2	3	5	0	1	6	0	0
12	33536722	.	A	C	3	3	6	0	0	6	0	0
12	33536754	.	A	G	3	5	8	0	0	8	0	0
12	33536881	.	A	G	1	2	3	0	1	4	0	0
12	33552253	.	A	T	5	4	9	0	0	9	0	0
12	33553959	.	C	G	1	4	5	0	0	5	0	0
12	33554124	.	C	T	4	3	7	0	0	7	0	0
12	33561661	.	C	A	9	6	15	0	1	16	0	0
12	33561662	.	C	T	9	6	15	0	1	16	0	0
12	33564746	.	G	T	3	3	6	0	0	6	0	0
12	33568017	.	A	G	6	14	20	0	1	21	0	0
12	33570318	.	G	A	12	7	19	0	1	20	0	0
12	33572799	.	C	T	6	7	13	0	0	13	0	0
12	33573002	.	G	T	4	9	13	0	0	13	0	0
12	33574748	.	G	A	5	9	14	0	0	14	0	0
12	33574787	.	C	T	5	8	13	0	0	13	0	0
12	33579159	.	C	T	1	3	4	0	3	7	0	0
12	33602776	.	C	T	9	12	21	0	1	22	0	0
12	33603386	.	G	T	3	4	7	0	0	7	0	0
12	33603611	.	C	T	10	15	25	0	1	26	0	0
12	33604298	.	A	G	6	11	17	0	0	17	0	0
12	33604445	.	G	A	1	4	5	0	0	5	0	0
12	33609377	.	C	G	2	4	6	0	0	6	0	0
12	33618002	.	C	T	0	3	3	0	4	7	0	0
12	33629704	.	G	T	2	2	4	0	0	4	0	0
12	33629797	.	G	A	1	4	5	0	0	5	0	0
12	33738927	.	T	G	4	3	7	0	0	7	0	0
12	33738956	.	A	C	2	3	5	0	0	5	0	0
12	33743789	.	A	G	2	2	4	0	0	4	0	0
12	33744549	.	G	A	2	3	5	0	1	6	0	0
12	33748709	.	C	T	3	3	6	0	0	6	0	0
12	33761985	.	C	G	1	4	5	0	1	6	0	0
12	33763334	.	T	C	1	1	2	0	3	5	0	0
12	33788935	.	A	T	1	2	3	0	0	3	0	0
12	33794600	.	G	T	1	2	3	0	0	3	0	0
12	33794681	.	G	A	1	3	4	0	0	4	0	0
12	33806819	.	T	A	5	2	7	0	0	7	0	0
12	33813071	.	G	A	2	5	7	0	0	7	0	0
12	33813260	.	A	T	1	4	5	0	0	5	0	0
12	33817399	.	A	T	8	13	21	0	0	21	0	0
12	33818654	.	A	G	6	11	17	0	0	17	0	0
12	33818925	.	C	T	3	2	5	0	0	5	0	0
12	33832148	.	A	G	1	4	5	0	0	5	0	0
12	33832286	.	G	A	1	7	8	0	0	8	0	0
12	33832529	.	G	A	2	2	4	0	0	4	0	0
12	33832747	.	A	T	4	2	6	0	1	7	0	0
12	33832952	.	T	G	1	2	3	0	0	3	0	0
12	33832985	.	G	A	3	2	5	0	0	5	0	0
12	33912518	.	G	C	0	4	4	0	1	5	0	0
12	33912635	.	T	C	4	6	10	0	0	10	0	0
12	33912656	.	C	T	4	8	12	0	0	12	0	0
12	33912758	.	C	A	4	8	12	0	1	13	0	0
12	33912946	.	C	A	3	8	11	0	0	11	0	0
12	33912982	.	G	T	6	6	12	0	1	13	0	0
12	33913000	.	G	A	7	3	10	0	0	10	0	0
12	33913154	.	G	A	2	5	7	0	0	7	0	0
12	33913578	.	G	A	0	3	3	0	3	6	0	0
12	33913698	.	T	A	6	7	13	0	0	13	0	0
12	33913705	.	T	C	6	6	12	0	0	12	0	0
12	33913759	.	G	A	7	7	14	0	0	14	0	0
12	33913805	.	C	A	6	3	9	0	1	10	0	0
12	33913964	.	T	G	2	11	13	0	1	14	0	0
12	33914967	.	A	C	3	5	8	0	0	8	0	0
12	33919640	.	T	A	6	7	13	0	0	13	0	0
12	33919851	.	C	T	5	4	9	0	0	9	0	0
12	33920483	.	G	A	6	7	13	0	0	13	0	0
12	33920627	.	T	C	4	4	8	0	0	8	0	0
12	33920693	.	G	T	2	10	12	0	0	12	0	0
12	33920826	.	T	C	15	16	31	0	0	31	0	0
12	33933495	.	A	G	9	0	9	0	10	19	0	0
12	33933979	.	C	T	12	13	25	0	2	27	0	0
12	33934082	.	G	A	0	14	14	0	22	36	0	0
12	33934099	.	G	A	0	16	16	0	21	37	0	0
12	33934768	.	G	T	20	19	39	0	0	40	1	0
12	33935010	.	C	A	14	8	22	0	0	22	0	0
12	33935019	.	G	T	1	6	7	0	13	20	0	0
12	33966470	.	G	A	9	9	18	0	0	18	0	0
12	33966499	.	C	T	1	15	16	0	12	28	0	0
12	33966886	.	A	G	18	26	44	0	1	45	0	0
12	33967603	.	T	C	5	9	14	0	0	14	0	0
12	33967604	.	T	C	8	5	13	0	1	14	0	0
12	33967724	.	G	C	1	2	3	0	0	3	0	0
12	33967738	.	G	A	1	2	3	0	0	3	0	0
12	33967897	.	A	C	1	2	3	0	1	4	0	0
12	33967918	.	A	G	2	4	6	0	0	6	0	0
12	33967968	.	T	G	9	12	21	0	1	22	0	0
12	33968027	.	T	A	13	22	35	0	1	36	0	0
12	33968073	.	T	A	13	24	37	0	2	39	0	0
12	33968145	.	C	T	19	14	33	0	2	35	0	0
12	33968419	.	C	A	1	25	26	0	29	55	0	0
12	33971461	.	T	C	11	20	31	0	1	32	0	0
12	33972294	.	G	T	30	17	47	0	3	50	0	0
12	33972748	.	G	A	21	10	31	0	1	32	0	0
12	33987978	.	A	T	3	5	8	0	0	8	0	0
12	33988615	.	A	G	3	0	3	0	2	5	0	0
12	33988623	.	G	C	4	3	7	0	0	7	0	0
12	33988685	.	G	A	1	2	3	0	0	3	0	0
12	33988764	.	G	A	0	3	3	0	2	5	0	0
12	33991622	.	T	C	13	13	26	0	1	27	0	0
12	33992208	.	A	C	15	5	20	0	6	26	0	0
12	33992376	.	A	G	7	12	19	0	1	20	0	0
12	33992418	.	G	T	18	22	40	0	0	40	0	0
12	33992813	.	C	A	20	23	43	0	3	46	0	0
12	33993008	.	T	A	18	18	36	5	2	43	0	0
12	33997285	.	C	T	19	10	29	1	0	30	0	0
12	33997303	.	T	A	12	18	30	1	1	32	0	0
12	34167972	.	C	T	3	4	7	0	0	7	0	0
12	34179962	.	C	T	7	6	13	0	0	13	0	0
12	34180771	.	C	T	11	5	16	1	0	17	0	0
12	34187335	.	C	T	10	15	25	0	0	25	0	0
12	34187341	.	G	T	0	15	15	0	11	26	0	0
12	34192762	.	C	T	2	11	13	0	0	13	0	0
12	34216726	.	C	G	1	2	3	0	3	6	0	0
12	34381182	.	G	A	2	2	4	0	0	4	0	0
12	34427449	.	T	C	1	2	3	0	0	3	0	0
12	34564123	.	A	G	8	4	12	0	0	12	0	0
12	34564322	.	T	G	3	2	5	0	1	6	0	0
12	34564343	.	C	T	3	4	7	0	0	7	0	0
12	34564416	.	A	G	3	3	6	0	0	6	0	0
12	34564904	.	A	T	11	8	19	0	0	19	0	0
12	34565200	.	A	C	3	4	7	0	0	7	0	0
12	34565223	.	T	C	3	2	5	0	0	5	0	0
12	34565311	.	C	T	2	4	6	0	0	6	0	0
12	34565354	.	C	G	3	5	8	0	0	8	0	0
12	34565441	.	A	G	3	5	8	0	1	9	0	0
12	34565504	.	A	G	3	3	6	0	0	6	0	0
12	34566022	.	C	T	4	4	8	0	3	11	0	0
12	34568383	.	T	C	3	2	5	0	0	5	0	0
12	34580552	.	A	G	5	5	10	0	0	10	0	0
12	34581049	.	C	T	4	0	4	0	2	6	0	0
12	34581051	.	C	T	4	2	6	0	0	6	0	0
12	34597779	.	C	T	0	4	4	0	2	6	0	0
12	34606935	.	C	A	2	2	4	0	0	4	0	0
12	34617041	.	C	T	2	2	4	0	0	4	0	0
12	34732841	.	C	A	3	3	6	0	0	6	0	0
12	34810833	.	A	G	1	3	4	0	0	4	0	0
12	34820046	.	A	G	2	1	3	0	0	3	0	0
12	34820760	.	C	T	2	2	4	0	0	4	0	0
12	34821051	.	C	T	2	2	4	0	0	4	0	0
12	34821135	.	T	C	0	5	5	0	1	6	0	0
12	34821394	.	G	T	2	2	4	0	0	4	0	0
12	34821513	.	G	T	1	3	4	0	0	4	0	0
12	34825187	.	T	C	3	2	5	0	0	5	0	0
12	34840201	.	C	T	4	4	8	0	0	8	0	0
12	34840207	.	T	G	4	2	6	0	1	7	0	0
12	34840421	.	C	T	5	2	7	0	0	7	0	0
12	34841852	.	C	T	4	4	8	0	3	11	0	0
12	34841897	.	C	G	3	5	8	0	1	9	0	0
12	34841996	.	A	G	1	0	1	0	3	4	0	0
12	34845615	.	C	A	3	4	7	0	0	7	0	0
12	34845669	.	T	G	5	3	8	0	1	9	0	0
12	34846091	.	G	A	1	5	6	0	1	7	0	0
12	34847004	.	C	A	4	2	6	0	0	6	0	0
12	34847091	.	T	A	5	2	7	0	0	7	0	0
12	34847137	.	T	C	1	2	3	0	0	3	0	0
12	34847139	.	G	T	2	2	4	0	0	4	0	0
12	34847211	.	G	A	6	3	9	0	0	9	0	0
12	34847234	.	A	T	5	4	9	0	0	9	0	0
12	34847247	.	T	C	6	5	11	0	0	11	0	0
12	34847977	.	A	G	7	6	13	0	2	15	0	0
12	34858581	.	C	T	2	5	7	0	0	7	0	0
12	34876420	.	G	A	2	2	4	0	0	4	0	0
12	34876827	.	A	G	3	3	6	0	0	6	0	0
12	34876837	.	G	A	3	2	5	0	0	5	0	0
12	34877048	.	T	A	11	7	18	0	1	19	0	0
12	34877064	.	G	A	12	5	17	0	0	17	0	0
12	34883640	.	G	A	4	2	6	0	0	6	0	0
12	34884018	.	T	C	2	4	6	0	0	6	0	0
12	34884446	.	C	T	1	4	5	0	4	9	0	0
12	34891681	.	C	T	9	9	18	0	1	19	0	0
12	34891780	.	G	A	2	5	7	0	4	11	0	0
12	34892087	.	C	A	7	6	13	0	0	13	0	0
12	34892089	.	C	T	7	6	13	0	0	13	0	0
12	34892590	.	T	A	9	11	20	0	0	20	0	0
12	34953641	.	G	T	0	5	5	0	8	13	0	0
12	35008681	.	A	G	8	11	19	0	1	20	0	0
12	35012040	.	C	T	13	12	25	0	2	27	0	0
12	35012127	.	T	C	14	6	20	0	2	22	0	0
12	35018127	.	C	T	18	16	34	0	0	34	0	0
12	35018519	.	G	T	4	2	6	0	1	7	0	0
12	35046821	.	A	G	19	16	35	0	0	35	0	0
12	35046875	.	C	T	14	11	25	0	2	27	0	0
12	35046900	.	G	A	12	13	25	0	2	27	0	0
12	35046928	.	T	C	15	10	25	0	1	26	0	0
12	35046956	.	T	G	19	7	26	0	0	26	0	0
12	35046965	.	G	T	17	8	25	0	1	26	0	0
12	35047014	.	A	G	6	10	16	0	0	16	0	0
12	35051250	.	A	G	12	13	25	0	1	26	0	0
12	35099509	.	C	T	0	3	3	0	1	4	0	0
12	35099532	.	G	T	1	2	3	0	0	3	0	0
12	35099571	.	G	A	2	3	5	0	0	5	0	0
12	35099601	.	C	T	2	6	8	0	0	8	0	0
12	35099805	.	G	A	7	8	15	0	0	15	0	0
12	35103606	.	T	C	4	0	4	0	5	9	0	0
12	35103665	.	C	T	8	4	12	0	1	13	0	0
12	35103710	.	G	C	3	3	6	0	1	7	0	0
12	35105596	.	G	C	6	6	12	0	0	12	0	0
12	35146537	.	G	A	0	2	2	0	3	5	0	0
12	35149868	.	G	A	6	3	9	0	0	9	0	0
12	35158344	.	C	T	7	5	12	0	0	12	0	0
12	35167333	.	A	G	10	8	18	0	1	19	0	0
12	35178914	.	G	A	8	9	17	0	0	17	0	0
12	35189264	.	G	T	8	8	16	0	1	17	0	0
12	35189295	.	C	T	9	13	22	0	0	22	0	0
12	35189306	.	A	G	10	10	20	0	1	21	0	0
12	35189402	.	A	G	15	0	15	0	8	23	0	0
12	35189471	.	T	A	10	7	17	0	2	20	1	0
12	35191080	.	A	T	16	17	33	0	1	34	0	0
12	35191856	.	C	T	16	9	25	0	0	25	0	0
12	35270573	.	G	A	0	2	2	0	1	3	0	0
12	35317222	.	A	G	1	3	4	0	0	4	0	0
12	35317294	.	A	G	3	0	3	0	4	7	0	0
12	35317520	.	C	A	5	4	9	0	0	9	0	0
12	35317609	.	C	T	5	4	9	0	0	9	0	0
12	35317654	.	C	T	3	5	8	0	0	8	0	0
12	35328139	.	C	T	5	6	11	0	0	11	0	0
12	35330107	.	C	T	7	3	10	0	1	11	0	0
12	35332283	.	T	A	3	5	8	0	0	8	0	0
12	35334652	.	C	G	6	8	14	0	0	14	0	0
12	35339212	.	A	G	7	4	11	0	0	11	0	0
12	35339263	.	A	T	9	4	13	0	0	13	0	0
12	35346498	.	G	A	21	28	49	0	0	49	0	0
12	35346597	.	A	T	31	27	58	0	5	63	0	0
12	35346842	.	T	C	24	22	46	0	1	47	0	0
12	35346873	.	C	T	23	27	50	0	2	52	0	0
12	35347002	.	A	T	22	26	48	0	1	49	0	0
12	35347078	.	G	A	29	29	58	0	2	60	0	0
12	35347084	.	C	T	3	27	30	0	31	61	0	0
12	35347318	.	C	T	27	33	60	0	1	61	0	0
12	35347485	.	T	G	27	23	50	0	4	54	0	0
12	35347795	.	C	T	1	9	10	0	11	21	0	0
12	35347951	.	A	G	27	18	45	0	0	45	0	0
12	35350686	.	G	A	25	16	41	0	2	43	0	0
12	35351392	.	G	T	17	20	37	1	3	41	0	0
12	35381726	.	T	C	24	2	26	0	11	37	0	0
12	35381729	.	T	C	8	2	10	0	23	33	0	0
12	35386919	.	A	G	21	11	32	0	0	32	0	0
12	35543736	.	T	G	8	14	22	0	1	23	0	0
12	35543971	.	T	G	10	11	21	0	3	24	0	0
12	35544320	.	T	G	7	8	15	0	0	15	0	0
12	35544460	.	A	G	6	13	19	0	1	20	0	0
12	35544596	.	C	A	6	5	11	0	0	11	0	0
12	35544968	.	A	G	12	12	24	0	0	24	0	0
12	35551120	.	G	A	3	2	5	0	1	6	0	0
12	35556821	.	G	C	2	2	4	0	0	4	0	0
12	35559614	.	T	G	2	5	7	0	0	7	0	0
12	35568231	.	G	A	5	5	10	0	0	10	0	0
12	35568249	.	C	T	1	6	7	0	4	11	0	0
12	35568270	.	T	A	4	3	7	0	0	7	0	0
12	35568303	.	C	G	6	3	9	0	0	9	0	0
12	35593188	.	C	T	25	14	39	0	2	41	0	0
12	35593469	.	T	A	9	8	17	0	1	18	0	0
12	35593729	.	A	G	11	0	11	0	9	20	0	0
12	35594069	.	T	A	19	12	31	0	3	34	0	0
12	35594154	.	C	T	18	8	26	0	0	26	0	0
12	35594169	.	C	T	16	8	24	0	1	25	0	0
12	35594436	.	C	T	17	10	27	0	0	27	0	0
12	35594474	.	A	G	17	15	32	0	2	34	0	0
12	35594495	.	G	A	2	15	17	0	16	33	0	0
12	35594512	.	T	C	18	13	31	0	0	31	0	0
12	35594541	.	C	A	18	11	29	0	1	30	0	0
12	35594605	.	C	T	23	13	36	0	0	36	0	0
12	35594623	.	T	A	22	13	35	0	0	35	0	0
12	35674952	.	G	A	15	9	24	0	1	25	0	0
12	35689209	.	C	T	20	11	31	1	1	33	0	0
12	35689210	.	A	G	14	11	25	1	7	33	0	0
12	35704426	.	G	T	30	17	47	0	1	48	0	0
12	35704435	.	G	T	32	18	50	0	0	50	0	0
12	35704735	.	A	G	15	19	34	0	2	36	0	0
12	35704852	.	G	A	13	19	32	0	1	33	0	0
12	35704921	.	A	C	19	13	32	0	4	36	0	0
12	35704996	.	T	G	24	16	40	0	3	43	0	0
12	35705131	.	C	T	15	20	35	0	6	41	0	0
12	35705140	.	A	C	16	1	17	0	24	41	0	0
12	35705224	.	A	G	15	25	40	0	2	42	0	0
12	35705252	.	T	G	13	24	37	0	0	37	0	0
12	35705323	.	G	A	17	15	32	0	0	32	0	0
12	35705367	.	C	T	0	16	16	0	18	34	0	0
12	35705565	.	C	T	1	8	9	0	11	20	0	0
12	35705606	.	A	T	13	6	19	0	1	20	0	0
12	35705661	.	T	C	11	13	24	0	1	25	0	0
12	35705926	.	C	T	21	20	41	0	2	43	0	0
12	35706091	.	C	T	8	15	23	0	1	24	0	0
12	35706124	.	A	G	10	15	25	0	1	26	0	0
12	35706253	.	A	T	8	12	20	0	2	22	0	0
12	35706304	.	A	G	14	13	27	0	0	27	0	0
12	35706524	.	G	A	15	17	32	0	1	33	0	0
12	35706568	.	C	T	7	19	26	0	1	27	0	0
12	35706859	.	C	T	1	8	9	0	14	23	0	0
12	35706970	.	G	T	6	12	18	0	0	18	0	0
12	35707155	.	C	T	11	10	21	0	0	21	0	0
12	35707171	.	T	C	9	10	19	0	0	19	0	0
12	35707225	.	G	A	9	9	18	0	0	18	0	0
12	35707537	.	A	G	4	5	9	0	1	10	0	0
12	35707636	.	G	A	5	6	11	0	2	13	0	0
12	35707660	.	A	C	3	7	10	0	1	11	0	0
12	35707747	.	A	G	6	5	11	0	0	11	0	0
12	35707963	.	T	C	12	0	12	0	5	17	0	0
12	35707987	.	G	A	11	6	17	0	1	18	0	0
12	35708139	.	T	G	3	8	11	0	0	11	0	0
12	35708235	.	A	G	3	8	11	0	0	11	0	0
12	35708272	.	C	T	7	6	13	0	1	14	0	0
12	35708950	.	G	A	7	9	16	0	0	16	0	0
12	35709007	.	G	A	9	6	15	0	0	15	0	0
12	35709028	.	A	G	6	5	11	0	0	11	0	0
12	35710837	.	T	C	10	3	13	0	0	13	0	0
12	35715339	.	A	G	6	6	12	0	1	13	0	0
12	35716116	.	T	G	6	4	10	0	0	10	0	0
12	35837354	.	C	T	1	4	5	0	6	11	0	0
12	35837425	.	T	A	3	3	6	0	1	7	0	0
12	35837499	.	G	C	10	3	13	0	0	13	0	0
12	35837503	.	T	G	11	3	14	0	0	14	0	0
12	35837751	.	G	A	5	7	12	0	0	12	0	0
12	35838672	.	C	A	0	4	4	0	1	5	0	0
12	35838683	.	A	G	2	4	6	0	0	6	0	0
12	35838882	.	A	C	2	2	4	0	0	4	0	0
12	35839063	.	A	T	7	3	10	0	0	10	0	0
12	35839090	.	C	T	0	3	3	0	1	4	0	0
12	35839159	.	C	T	4	3	7	0	1	8	0	0
12	35839165	.	C	G	4	4	8	0	0	8	0	0
12	35839261	.	C	A	6	9	15	0	0	15	0	0
12	35839680	.	G	A	6	2	8	0	1	9	0	0
12	35839879	.	C	A	0	7	7	0	4	11	0	0
12	35839919	.	C	G	1	2	3	0	4	7	0	0
12	35840003	.	T	C	2	0	2	0	3	5	0	0
12	35840008	.	C	A	3	2	5	0	0	5	0	0
12	35840483	.	G	A	2	3	5	0	0	5	0	0
12	35840543	.	A	C	4	3	7	0	0	7	0	0
12	35840717	.	A	G	5	4	9	0	0	9	0	0
12	35840800	.	T	G	1	2	3	0	0	3	0	0
12	35841457	.	G	A	2	1	3	0	3	6	0	0
12	35847493	.	A	T	2	6	8	0	0	8	0	0
12	35847535	.	T	C	2	8	10	0	1	11	0	0
12	35847538	.	C	T	3	7	10	0	0	10	0	0
12	35853732	.	C	A	3	4	7	0	0	7	0	0
12	35865689	.	C	T	4	3	7	0	1	8	0	0
12	35867935	.	G	A	1	2	3	0	0	3	0	0
12	35868203	.	A	G	2	2	4	0	0	4	0	0
12	35963575	.	T	C	5	9	14	0	0	14	0	0
12	35976771	.	C	A	4	4	8	0	1	9	0	0
12	35980632	.	T	C	3	2	5	0	0	5	0	0
12	35980758	.	C	T	1	7	8	1	0	9	0	0
12	35980764	.	T	C	1	6	7	1	1	9	0	0
12	35980817	.	T	A	3	4	7	0	2	9	0	0
12	35980917	.	T	G	5	4	9	0	0	9	0	0
12	35981206	.	T	C	8	1	9	0	6	15	0	0
12	35981260	.	T	A	5	7	12	0	0	12	0	0
12	35981303	.	T	G	2	2	4	0	0	4	0	0
12	35981304	.	G	C	2	2	4	0	0	4	0	0
12	35981478	.	A	G	6	8	14	0	0	14	0	0
12	35981627	.	C	T	4	9	13	0	2	15	0	0
12	35981713	.	C	T	0	6	6	0	3	9	0	0
12	35981795	.	T	A	5	9	14	0	1	15	0	0
12	35988544	.	A	G	8	10	18	0	0	18	0	0
12	35988553	.	G	A	5	8	13	0	2	15	0	0
12	36158056	.	A	C	17	16	33	0	0	33	0	0
12	36158098	.	G	C	10	16	26	0	2	28	0	0
12	36158099	.	T	C	12	15	27	0	1	28	0	0
12	36158225	.	T	C	18	14	32	0	0	32	0	0
12	36158538	.	C	T	9	5	14	0	0	14	0	0
12	36159597	.	C	G	9	7	16	0	0	16	0	0
12	36413937	.	A	T	5	7	12	0	1	13	0	0
12	36416669	.	T	C	0	1	1	0	1	2	0	0
12	36416675	.	T	C	1	2	3	0	0	3	0	0
12	36420141	.	T	C	1	5	6	0	1	7	0	0
12	36420420	.	G	A	7	3	10	0	0	10	0	0
12	36424613	.	G	A	3	8	11	0	0	11	0	0
12	36424618	.	G	A	8	4	12	0	0	12	0	0
12	36462038	.	G	A	1	2	3	0	0	3	0	0
12	36471810	.	A	G	1	3	4	0	0	4	0	0
12	36670336	.	A	C	2	2	4	0	0	4	0	0
12	36671369	.	A	G	1	3	4	0	0	4	0	0
12	36671433	.	G	A	1	2	3	0	0	3	0	0
12	36739638	.	A	G	1	2	3	0	0	3	0	0
12	36891583	.	C	T	2	5	7	0	0	7	0	0
12	36895025	.	A	G	7	7	14	0	1	15	0	0
12	36895057	.	T	C	6	6	12	0	0	12	0	0
12	36895067	.	G	A	5	5	10	0	1	11	0	0
12	36952648	.	T	G	5	0	5	2	5	12	0	0
12	36952744	.	C	T	2	5	7	0	0	7	0	0
12	36960197	.	T	C	4	7	11	0	0	11	0	0
12	36960200	.	A	T	4	7	11	0	0	11	0	0
12	37002664	.	G	A	1	2	3	0	0	3	0	0
12	37002668	.	A	G	0	2	2	0	1	3	0	0
12	37003282	.	C	T	4	3	7	0	0	7	0	0
12	37003291	.	A	G	7	3	10	0	0	10	0	0
12	37003332	.	A	G	4	2	6	0	0	6	0	0
12	37003739	.	G	C	0	2	2	0	1	3	0	0
12	37004478	.	A	G	1	2	3	0	0	3	0	0
12	37004922	.	T	C	2	2	4	0	0	4	0	0
12	37005350	.	T	C	0	2	2	0	1	3	0	0
12	37005586	.	A	G	3	0	3	0	2	5	0	0
12	37275601	.	C	T	4	3	7	0	0	7	0	0
12	37408706	.	T	C	2	0	2	2	2	6	0	0
12	37408737	.	T	C	2	2	4	2	1	7	0	0
12	37410974	.	G	A	1	1	2	0	0	2	0	0
12	38561258	.	C	A	12	9	21	1	2	24	0	0
12	38672470	.	A	T	3	3	6	0	1	7	0	0
12	38802875	.	T	C	5	4	9	0	0	9	0	0
12	38803168	.	A	G	2	5	7	0	2	9	0	0
12	38803291	.	A	G	3	0	3	0	3	6	0	0
12	38803295	.	A	T	3	3	6	0	0	6	0	0
12	38803377	.	G	A	1	3	4	0	3	7	0	0
12	38803411	.	A	G	6	0	6	0	3	9	0	0
12	38803649	.	G	C	5	2	7	0	1	8	0	0
12	38804005	.	G	T	6	7	13	0	0	13	0	0
12	38804027	.	A	G	5	7	12	0	2	14	0	0
12	38804561	.	C	G	4	6	10	0	0	10	0	0
12	38809283	.	C	T	1	2	3	0	0	3	0	0
12	38842158	.	G	A	1	4	5	0	0	5	0	0
12	38850889	.	C	T	3	2	5	0	1	6	0	0
12	38906961	.	T	C	1	2	3	0	0	3	0	0
12	39744954	.	G	C	1	7	8	0	9	17	0	0
12	40348899	.	G	T	0	2	2	0	5	7	0	0
12	40478325	.	A	C	1	4	5	0	0	5	0	0
12	40502531	.	G	A	1	5	6	0	1	7	0	0
12	40502547	.	C	T	2	4	6	0	1	7	0	0
12	40502610	.	G	A	1	6	7	0	5	12	0	0
12	40518088	.	C	T	8	13	21	0	1	22	0	0
12	40518094	.	T	C	7	14	21	0	0	21	0	0
12	40518217	.	C	T	3	8	11	0	1	12	0	0
12	41437046	.	G	A	5	9	14	0	0	14	0	0
12	41455861	.	T	C	7	2	9	0	0	9	0	0
12	41461030	.	C	T	6	11	17	0	1	18	0	0
12	41461051	.	C	T	8	13	21	0	0	21	0	0
12	41466801	.	C	G	17	1	18	0	12	30	0	0
12	41467003	.	C	T	18	16	34	0	0	34	0	0
12	41467207	.	C	A	9	7	16	0	2	18	0	0
12	41525833	.	C	T	5	8	13	0	0	13	0	0
12	41528206	.	C	T	8	6	14	0	0	14	0	0
12	41528230	.	A	T	6	8	14	0	1	15	0	0
12	41535830	.	G	A	0	8	8	0	5	13	0	0
12	41535844	.	C	T	5	8	13	0	0	13	0	0
12	41535886	.	A	C	7	9	16	0	0	16	0	0
12	41535898	.	C	T	8	9	17	0	1	18	0	0
12	41535937	.	T	A	11	12	23	0	0	23	0	0
12	41539059	.	G	A	10	6	16	0	0	16	0	0
12	41539161	.	C	T	15	15	30	0	0	30	0	0
12	41539464	.	G	A	10	9	19	0	1	20	0	0
12	41549214	.	G	A	3	14	17	0	12	29	0	0
12	41549386	.	G	A	14	16	30	0	1	32	1	0
12	41549404	.	C	G	17	14	31	0	2	33	0	0
12	41549434	.	C	G	19	16	35	0	0	35	0	0
12	41549443	.	A	G	17	2	19	0	16	35	0	0
12	41580940	.	G	T	6	3	9	0	0	9	0	0
12	41581092	.	A	G	8	6	14	0	0	14	0	0
12	41584666	.	G	A	13	8	21	0	0	21	0	0
12	41584755	.	C	T	13	8	21	0	3	24	0	0
12	41589789	.	T	G	11	13	24	0	2	26	0	0
12	41593093	.	T	A	12	12	24	0	1	25	0	0
12	41618820	.	G	A	5	7	12	0	0	12	0	0
12	41618846	.	A	C	3	1	4	0	5	9	0	0
12	41631703	.	A	T	3	8	11	0	0	11	0	0
12	41631964	.	C	G	11	16	27	0	2	29	0	0
12	41632117	.	A	G	9	27	36	0	1	37	0	0
12	41643214	.	C	T	10	12	22	0	1	23	0	0
12	41643217	.	G	A	11	12	23	0	1	24	0	0
12	41647273	.	T	C	13	8	21	0	3	24	0	0
12	41653155	.	C	T	8	3	11	0	0	11	0	0
12	41653678	.	A	G	12	10	22	0	0	22	0	0
12	41656554	.	G	A	15	8	23	0	0	23	0	0
12	41698040	.	A	T	10	26	36	0	2	38	0	0
12	41698070	.	T	A	22	16	38	0	1	39	0	0
12	41702044	.	A	C	18	26	44	0	3	47	0	0
12	41723482	.	G	A	6	9	15	0	0	15	0	0
12	41723608	.	T	A	14	7	21	0	4	25	0	0
12	41732013	.	C	T	1	9	10	0	7	17	0	0
12	41735790	.	T	C	8	3	11	0	2	13	0	0
12	41739297	.	G	T	4	11	15	0	2	17	0	0
12	42364809	.	G	A	4	2	6	0	1	7	0	0
12	42366219	.	A	C	1	0	1	0	3	4	0	0
12	42369668	.	G	T	11	10	21	0	0	21	0	0
12	42378970	.	T	C	15	17	32	0	1	33	0	0
12	42405713	.	G	T	1	2	3	0	0	3	0	0
12	42405741	.	T	G	2	2	4	0	0	4	0	0
12	42406178	.	C	T	1	3	4	0	0	4	0	0
12	42406811	.	A	T	2	2	4	0	0	4	0	0
12	42406820	.	C	A	3	2	5	0	0	5	0	0
12	42406855	.	G	C	1	3	4	0	0	4	0	0
12	42577252	.	G	T	16	14	30	0	4	36	2	0
12	42577492	.	T	G	13	17	30	0	0	30	0	0
12	42578024	.	G	A	2	16	18	0	13	31	0	0
12	42578127	.	T	A	14	7	21	0	2	23	0	0
12	42578505	.	A	T	23	23	46	0	2	48	0	0
12	42578698	.	A	G	7	0	7	0	9	16	0	0
12	42578996	.	T	A	19	12	31	0	5	36	0	0
12	45216701	.	A	T	7	36	43	1	2	46	0	0
12	45216702	.	A	C	1	36	37	1	4	42	0	0
12	46630927	.	G	T	12	7	19	0	1	20	0	0
12	46630946	.	C	A	9	9	18	0	1	19	0	0
12	46688007	.	C	T	7	6	13	0	0	13	0	0
12	46688275	.	A	G	10	9	19	0	0	19	0	0
12	46693103	.	C	T	11	9	20	0	1	21	0	0
12	46698280	.	G	T	0	4	4	0	1	5	0	0
12	46698283	.	T	A	1	5	6	0	0	6	0	0
12	46699492	.	A	G	1	0	1	0	6	7	0	0
12	46852982	.	C	T	9	6	15	0	1	16	0	0
12	46855065	.	A	G	8	0	8	0	8	16	0	0
12	46857326	.	A	C	3	6	9	0	0	9	0	0
12	46857386	.	A	G	4	0	4	0	13	17	0	0
12	46863553	.	C	T	10	12	22	0	1	23	0	0
12	46915452	.	T	C	4	3	7	0	0	7	0	0
12	46930412	.	G	C	3	4	7	0	0	7	0	0
12	46937292	.	A	C	5	8	13	1	0	14	0	0
12	46937351	.	T	C	7	7	14	0	0	14	0	0
12	46937422	.	A	T	6	3	9	0	2	12	1	0
12	46937461	.	G	A	5	8	13	0	0	13	0	0
12	46937711	.	A	G	5	0	5	0	9	14	0	0
12	46950966	.	T	C	3	0	3	0	7	10	0	0
12	46950976	.	G	T	4	7	11	0	1	12	0	0
12	46953609	.	C	A	3	3	6	0	0	6	0	0
12	46955943	.	G	A	4	6	10	0	0	10	0	0
12	46959885	.	T	G	2	3	5	0	0	5	0	0
12	46959935	.	T	C	4	6	10	0	1	11	0	0
12	46969557	.	C	T	10	10	20	0	1	21	0	0
12	46976021	.	C	T	16	11	27	0	0	27	0	0
12	46978207	.	A	G	10	0	10	7	12	29	0	0
12	46978237	.	C	T	4	6	10	16	1	27	0	0
12	46985509	.	C	A	8	8	16	0	0	16	0	0
12	46985666	.	T	C	5	2	7	0	1	8	0	0
12	46985884	.	G	T	6	6	12	0	0	12	0	0
12	46985886	.	C	A	6	6	12	0	0	12	0	0
12	47044800	.	A	T	5	3	8	0	0	9	1	0
12	47055306	.	A	G	9	13	22	1	6	29	0	0
12	47055546	.	C	T	8	9	17	0	1	18	0	0
12	47055609	.	A	G	13	0	13	0	10	23	0	0
12	47062488	.	C	T	19	10	29	0	0	29	0	0
12	47062548	.	T	C	9	16	25	0	2	27	0	0
12	47063007	.	G	A	9	14	23	0	2	25	0	0
12	47064418	.	T	C	23	17	40	0	1	41	0	0
12	47064615	.	G	A	2	20	22	0	9	31	0	0
12	47068624	.	C	T	15	11	26	0	1	27	0	0
12	47068657	.	A	G	18	1	19	0	8	27	0	0
12	47068738	.	C	T	12	12	24	0	0	24	0	0
12	47109480	.	C	T	1	2	3	0	0	3	0	0
12	47188248	.	A	G	1	2	3	0	0	3	0	0
12	47199750	.	C	G	3	2	5	0	0	5	0	0
12	47208338	.	C	G	2	2	4	0	0	4	0	0
12	47225058	.	C	T	3	2	5	0	0	5	0	0
12	47233215	.	C	A	3	4	7	0	0	7	0	0
12	47233541	.	G	A	2	2	4	0	1	5	0	0
12	47240374	.	G	A	2	3	5	0	0	5	0	0
12	47240404	.	G	A	2	4	6	0	0	6	0	0
12	47240410	.	G	A	1	4	5	0	2	7	0	0
12	47241459	.	A	G	3	0	3	0	3	6	0	0
12	47241639	.	T	C	1	5	6	0	0	6	0	0
12	47247816	.	C	T	3	2	5	0	0	5	0	0
12	47247963	.	G	T	0	5	5	0	3	8	0	0
12	47248184	.	G	A	0	4	4	0	2	6	0	0
12	47258993	.	T	G	6	0	6	0	4	10	0	0
12	47261099	.	C	T	5	6	11	0	1	12	0	0
12	47262817	.	C	T	5	6	11	0	1	12	0	0
12	47267408	.	C	T	6	4	10	0	0	10	0	0
12	47275118	.	T	A	8	10	18	0	0	18	0	0
12	47275233	.	A	G	7	0	7	0	5	12	0	0
12	47276192	.	C	T	5	4	9	0	1	10	0	0
12	47281118	.	C	A	6	6	12	0	1	13	0	0
12	47282104	.	G	A	0	4	4	0	8	12	0	0
12	47283544	.	G	C	3	5	8	0	0	8	0	0
12	47291529	.	G	C	0	4	4	0	8	12	0	0
12	47291703	.	G	A	5	6	11	0	4	15	0	0
12	47295523	.	C	T	5	6	11	0	0	11	0	0
12	47295939	.	C	T	9	12	21	0	3	24	0	0
12	47296596	.	C	T	10	12	22	0	0	22	0	0
12	47296608	.	T	A	11	10	21	0	0	21	0	0
12	47302786	.	G	A	2	6	8	0	12	20	0	0
12	47302828	.	C	T	10	9	19	0	3	22	0	0
12	47302831	.	G	A	12	11	23	0	1	24	0	0
12	47325323	.	G	T	0	8	8	0	8	16	0	0
12	47327631	.	C	T	10	16	26	0	0	26	0	0
12	47331855	.	C	T	8	7	15	0	3	18	0	0
12	47331864	.	C	T	10	11	21	0	1	22	0	0
12	47332134	.	A	T	11	11	22	0	1	23	0	0
12	47332236	.	A	G	11	17	28	0	0	28	0	0
12	47332326	.	C	A	13	9	22	0	0	22	0	0
12	47332575	.	A	G	15	10	25	0	3	28	0	0
12	47332635	.	G	A	15	19	34	0	1	35	0	0
12	47332827	.	C	T	18	18	36	0	1	37	0	0
12	47335257	.	C	T	13	15	28	0	2	30	0	0
12	47338311	.	A	G	18	24	42	0	0	42	0	0
12	47344423	.	T	C	24	24	48	0	1	49	0	0
12	47355211	.	C	T	21	19	40	0	2	42	0	0
12	47449121	.	G	A	2	2	4	0	4	8	0	0
12	47449784	.	A	G	4	1	5	0	4	9	0	0
12	47449793	.	C	A	6	6	12	0	0	12	0	0
12	47449967	.	G	A	7	8	15	0	0	15	0	0
12	47449997	.	G	A	8	10	18	0	1	19	0	0
12	47480434	.	A	G	7	1	8	0	7	15	0	0
12	47480469	.	A	T	10	5	15	0	1	16	0	0
12	47480565	.	T	A	10	7	17	0	1	18	0	0
12	47510101	.	T	C	10	7	17	0	0	17	0	0
12	47523795	.	A	C	17	17	34	0	0	34	0	0
12	47536254	.	C	T	21	24	45	0	0	45	0	0
12	47540999	.	A	C	14	15	29	0	1	30	0	0
12	47589212	.	C	T	1	3	4	0	6	10	0	0
12	47593325	.	G	C	7	0	7	0	7	14	0	0
12	47593373	.	G	A	7	7	14	0	0	14	0	0
12	47595848	.	C	A	4	4	8	0	0	8	0	0
12	47641659	.	C	T	1	16	17	11	10	38	0	0
12	47645851	.	G	A	20	13	33	0	0	33	0	0
12	47646485	.	G	A	15	12	27	0	2	29	0	0
12	47732236	.	G	A	1	2	3	0	0	3	0	0
12	47734588	.	T	C	1	2	3	0	0	3	0	0
12	47780306	.	T	C	2	2	4	0	0	4	0	0
12	47802663	.	C	A	1	2	3	0	0	3	0	0
12	47808289	.	C	A	4	2	6	0	0	6	0	0
12	47816586	.	C	A	1	2	3	0	0	3	0	0
12	47836055	.	C	A	1	2	3	0	0	3	0	0
12	47838894	.	G	A	2	2	4	0	0	4	0	0
12	47842232	.	T	C	1	8	9	0	0	9	0	0
12	47847414	.	G	C	2	3	5	0	1	6	0	0
12	47851950	.	T	C	1	3	4	0	1	5	0	0
12	48156303	.	G	A	1	4	5	0	0	5	0	0
12	48419359	.	T	G	5	2	7	0	0	7	0	0
12	48419420	.	A	G	5	5	10	0	0	10	0	0
12	48419520	.	T	A	2	5	7	0	0	7	0	0
12	48419805	.	C	T	4	2	6	0	1	7	0	0
12	48436863	.	T	C	5	0	5	0	6	11	0	0
12	48440328	.	A	G	2	3	5	0	2	7	0	0
12	48451923	.	A	G	2	2	4	0	0	4	0	0
12	48469825	.	C	T	13	10	23	0	3	26	0	0
12	48470519	.	T	C	5	2	7	0	0	7	0	0
12	48476965	.	A	T	28	18	46	0	2	48	0	0
12	48476995	.	T	C	16	0	16	0	9	25	0	0
12	48480740	.	G	A	7	7	14	0	0	14	0	0
12	48522778	.	C	T	2	5	7	0	0	7	0	0
12	48522793	.	T	C	2	5	7	0	1	8	0	0
12	48525046	.	G	A	9	4	13	0	0	13	0	0
12	48529757	.	C	T	10	10	20	0	4	24	0	0
12	48532581	.	A	G	8	7	15	0	4	19	0	0
12	48611652	.	C	G	1	0	1	0	1	2	0	0
12	48619421	.	C	T	3	2	5	0	0	5	0	0
12	48623030	.	C	A	1	3	4	0	0	4	0	0
12	48626349	.	A	C	3	2	5	0	1	6	0	0
12	48680110	.	C	G	7	8	15	0	0	15	0	0
12	48680163	.	A	T	9	6	15	0	1	16	0	0
12	48681826	.	A	T	7	6	13	0	1	14	0	0
12	48681827	.	T	A	7	7	14	0	0	14	0	0
12	48682002	.	A	G	3	5	8	0	0	8	0	0
12	48682530	.	G	C	5	3	8	0	0	8	0	0
12	48796993	.	T	C	3	8	11	0	1	12	0	0
12	48799261	.	C	T	6	8	14	0	0	14	0	0
12	48803126	.	G	C	8	13	21	0	0	21	0	0
12	48804074	.	G	C	15	14	29	0	1	30	0	0
12	48810338	.	C	T	17	15	32	1	1	34	0	0
12	48810557	.	G	T	2	12	14	0	19	33	0	0
12	48810558	.	C	T	19	11	30	0	2	33	1	0
12	48810865	.	C	T	8	5	13	0	1	14	0	0
12	48811035	.	T	C	12	4	16	0	2	18	0	0
12	48816218	.	A	G	12	0	12	0	7	19	0	0
12	48826364	.	C	T	16	14	30	0	2	32	0	0
12	48826518	.	G	A	0	5	5	0	4	9	0	0
12	48828194	.	G	T	7	5	12	0	1	13	0	0
12	48828350	.	C	T	4	5	9	0	4	13	0	0
12	48828356	.	C	G	7	8	15	0	0	15	0	0
12	48828431	.	G	A	0	4	4	0	5	9	0	0
12	48828461	.	C	T	7	5	12	0	0	12	0	0
12	48828467	.	G	A	0	7	7	0	6	13	0	0
12	48829379	.	T	C	11	4	15	0	0	15	0	0
12	48829397	.	T	C	5	10	15	0	0	15	0	0
12	48833090	.	T	C	10	12	22	0	1	23	0	0
12	48833165	.	C	T	17	8	25	0	0	25	0	0
12	48836348	.	A	G	16	8	24	0	2	26	0	0
12	48836482	.	G	A	17	13	30	0	3	33	0	0
12	48871942	.	G	C	1	3	4	0	0	4	0	0
12	48902278	.	T	C	2	0	2	0	5	7	0	0
12	48943420	.	C	T	1	3	4	0	3	7	0	0
12	48959393	.	A	G	2	4	6	0	1	7	0	0
12	48974534	.	A	G	1	3	4	0	0	4	0	0
12	48975613	.	G	A	1	4	5	0	3	8	0	0
12	48979161	.	T	C	6	0	6	0	5	11	0	0
12	48979219	.	T	C	5	0	5	0	6	11	0	0
12	48979234	.	T	C	3	0	3	0	6	9	0	0
12	48979362	.	A	C	9	0	9	0	7	16	0	0
12	48979609	.	C	T	0	4	4	0	11	15	0	0
12	48979648	.	C	T	6	7	13	0	0	13	0	0
12	48982536	.	T	C	8	0	8	0	3	11	0	0
12	48982539	.	C	T	1	3	4	0	7	11	0	0
12	48984334	.	T	C	1	0	1	0	2	3	0	0
12	49004058	.	C	T	1	21	22	0	16	38	0	0
12	49004071	.	C	T	1	19	20	0	16	36	0	0
12	49005119	.	G	T	11	21	32	2	0	34	0	0
12	49008358	.	G	T	1	3	4	0	0	4	0	0
12	49034603	.	C	T	10	3	13	0	1	14	0	0
12	49035182	.	G	A	0	12	12	0	4	16	0	0
12	49038051	.	A	T	2	3	5	0	0	5	0	0
12	49100585	.	G	C	2	2	4	0	0	4	0	0
12	49114550	.	G	T	2	8	10	0	14	24	0	0
12	49114592	.	A	G	8	0	8	0	7	15	0	0
12	49125593	.	G	A	0	4	4	0	3	7	0	0
12	49148399	.	A	G	16	16	32	0	1	33	0	0
12	49149457	.	C	T	0	8	8	0	11	19	0	0
12	49154238	.	C	A	0	2	2	0	1	3	0	0
12	49158090	.	T	C	5	0	5	0	6	11	0	0
12	49158990	.	G	A	14	18	32	1	5	38	0	0
12	49159802	.	A	G	15	9	24	14	0	38	0	0
12	49160120	.	G	A	12	17	29	6	3	38	0	0
12	49161825	.	A	G	3	3	6	28	0	34	0	0
12	49161860	.	T	C	12	13	25	14	3	42	0	0
12	49166926	.	C	T	8	11	19	0	2	21	0	0
13	10935	.	C	T	6	6	12	0	0	12	0	0
13	11043	.	G	C	9	8	17	0	0	17	0	0
13	12252	.	C	G	15	13	28	0	1	29	0	0
13	40668	.	T	C	1	0	1	0	2	3	0	0
13	40676	.	A	C	0	1	1	0	1	2	0	0
13	40868	.	A	T	6	13	19	0	1	20	0	0
13	40965	.	T	G	8	3	11	0	2	13	0	0
13	41161	.	C	T	1	10	11	0	4	15	0	0
13	42182	.	C	G	5	3	8	0	0	8	0	0
13	42771	.	C	T	2	4	6	0	0	6	0	0
13	42870	.	T	C	2	0	2	0	6	8	0	0
13	46625	.	T	C	11	2	13	0	13	26	0	0
13	46637	.	G	A	11	16	27	0	0	27	0	0
13	49070	.	T	G	13	10	23	0	1	24	0	0
13	214111	.	C	G	9	10	19	0	0	19	0	0
13	216407	.	T	C	2	0	2	0	5	7	0	0
13	216562	.	A	G	5	17	22	0	1	23	0	0
13	217848	.	A	C	27	16	43	0	2	45	0	0
13	220842	.	T	C	15	0	15	0	19	34	0	0
13	220874	.	T	A	18	14	32	0	2	34	0	0
13	221131	.	C	A	15	12	27	0	2	29	0	0
13	221478	.	G	C	16	19	35	1	0	36	0	0
13	226047	.	G	C	3	3	6	0	0	6	0	0
13	237954	.	T	C	25	15	40	0	1	41	0	0
13	269861	.	C	T	2	6	8	0	9	17	0	0
13	270083	.	G	A	8	11	19	0	0	19	0	0
13	270110	.	C	T	1	9	10	0	14	24	0	0
13	271736	.	G	A	9	7	16	0	0	16	0	0
13	279420	.	G	A	1	4	5	0	0	5	0	0
13	280692	.	T	C	3	3	6	0	0	6	0	0
13	281330	.	T	C	29	26	55	1	0	56	0	0
13	281405	.	T	G	27	0	27	0	32	59	0	0
13	321752	.	C	T	0	11	11	0	13	24	0	0
13	322033	.	G	A	6	6	12	0	0	12	0	0
13	329835	.	G	C	3	3	6	8	0	14	0	0
13	329876	.	C	T	7	11	18	3	0	21	0	0
13	329922	.	G	A	6	7	13	0	1	14	0	0
13	343336	.	G	T	5	5	10	0	0	10	0	0
13	343363	.	T	C	4	0	4	0	5	9	0	0
13	343510	.	C	T	1	6	7	0	0	7	0	0
13	343567	.	G	T	1	2	3	0	0	3	0	0
13	343604	.	C	T	1	2	3	1	0	4	0	0
13	353214	.	T	C	1	4	5	0	0	5	0	0
13	353225	.	A	G	1	3	4	0	0	4	0	0
13	353686	.	C	T	5	3	8	0	0	8	0	0
13	353728	.	A	C	1	0	1	0	4	5	0	0
13	353755	.	A	G	3	9	12	0	0	12	0	0
13	356834	.	C	G	0	5	5	0	6	11	0	0
13	357664	.	G	C	2	0	2	0	5	7	0	0
13	360461	.	C	T	0	3	3	0	1	4	0	0
13	364549	.	A	G	1	3	4	0	0	4	0	0
13	421350	.	G	T	1	14	15	0	18	33	0	0
13	422990	.	T	C	5	12	17	0	0	17	0	0
13	425044	.	G	C	14	11	25	0	1	26	0	0
13	425063	.	C	T	13	12	25	0	0	25	0	0
13	425087	.	C	T	10	16	26	0	1	27	0	0
13	428646	.	G	A	15	18	33	0	2	35	0	0
13	428766	.	C	T	12	8	20	0	1	21	0	0
13	428841	.	C	T	27	10	37	0	1	38	0	0
13	429087	.	C	T	16	18	34	0	1	35	0	0
13	429144	.	A	G	17	1	18	0	21	39	0	0
13	429429	.	A	G	16	2	18	0	23	41	0	0
13	429514	.	C	T	21	13	34	0	1	35	0	0
13	429846	.	C	A	19	14	33	0	0	33	0	0
13	450040	.	C	T	0	7	7	0	4	11	0	0
13	450101	.	C	T	16	10	26	0	3	29	0	0
13	452598	.	C	A	9	16	25	0	1	26	0	0
13	452615	.	G	T	16	9	25	0	1	27	1	0
13	454846	.	C	A	1	10	11	0	8	19	0	0
13	454919	.	A	G	10	7	17	0	2	19	0	0
13	455473	.	G	A	2	8	10	0	1	11	0	0
13	460740	.	T	C	5	0	5	0	4	9	0	0
13	460821	.	C	T	0	8	8	0	7	15	0	0
13	460845	.	C	T	9	7	16	0	0	16	0	0
13	460875	.	G	A	6	7	13	0	0	13	0	0
13	462042	.	C	A	0	4	4	0	2	6	0	0
13	462347	.	C	T	6	5	11	0	0	11	0	0
13	462368	.	G	A	4	7	11	0	2	13	0	0
13	462904	.	T	G	5	3	8	0	0	8	0	0
13	463687	.	C	T	7	4	11	0	0	11	0	0
13	465329	.	T	A	3	5	8	0	0	8	0	0
13	465535	.	C	T	2	3	5	0	2	7	0	0
13	465538	.	C	A	1	3	4	0	3	7	0	0
13	466475	.	G	A	1	3	4	0	0	4	0	0
13	467509	.	G	A	5	3	8	0	1	9	0	0
13	478485	.	G	A	2	2	4	0	1	5	0	0
13	483021	.	A	G	9	12	21	0	1	22	0	0
13	489773	.	T	C	9	7	16	0	0	16	0	0
13	490479	.	C	G	10	0	10	0	13	23	0	0
13	514385	.	C	T	24	15	39	0	0	39	0	0
13	514664	.	G	A	8	12	20	1	1	22	0	0
13	514790	.	T	A	3	6	9	0	0	9	0	0
13	516347	.	G	C	4	5	9	0	0	9	0	0
13	516358	.	T	G	4	6	10	0	0	10	0	0
13	517163	.	G	T	9	4	13	0	0	13	0	0
13	518113	.	T	C	10	1	11	0	10	21	0	0
13	518915	.	G	A	9	8	17	0	0	17	0	0
13	522036	.	G	T	5	6	11	0	0	11	0	0
13	526943	.	G	A	7	4	11	0	0	11	0	0
13	527832	.	C	T	4	4	8	0	0	8	0	0
13	529348	.	T	C	6	0	6	0	4	10	0	0
13	533133	.	T	A	1	2	3	0	0	3	0	0
13	543275	.	T	C	3	3	6	0	1	7	0	0
13	555325	.	C	T	15	18	33	0	1	34	0	0
13	555326	.	G	A	19	15	34	0	0	34	0	0
13	556027	.	A	C	8	3	11	1	0	12	0	0
13	556397	.	T	C	8	13	21	0	0	21	0	0
13	556398	.	T	C	9	13	22	0	0	22	0	0
13	556437	.	T	C	11	0	11	0	6	17	0	0
13	556461	.	T	C	10	2	12	0	1	13	0	0
13	556572	.	A	G	8	11	19	0	0	19	0	0
13	556601	.	A	T	8	11	19	0	0	19	0	0
13	556658	.	C	A	7	9	16	0	0	16	0	0
13	556729	.	G	T	6	11	17	0	0	17	0	0
13	561575	.	T	A	11	7	18	0	0	18	0	0
13	561587	.	A	T	7	7	14	0	2	16	0	0
13	562966	.	C	T	2	6	8	0	6	14	0	0
13	563089	.	G	A	6	2	8	0	0	8	0	0
13	563116	.	G	A	6	5	11	0	1	12	0	0
13	565622	.	C	T	2	6	8	0	6	14	0	0
13	565641	.	T	C	7	0	7	0	7	14	0	0
13	565660	.	G	A	6	8	14	0	0	14	0	0
13	566046	.	G	A	2	7	9	0	0	9	0	0
13	566569	.	G	A	5	5	10	0	2	12	0	0
13	566604	.	T	C	5	0	5	0	9	14	0	0
13	583962	.	G	T	7	4	11	0	0	11	0	0
13	586283	.	C	A	0	3	3	0	3	6	0	0
13	587902	.	A	G	4	3	7	0	0	7	0	0
13	592473	.	G	A	2	5	7	0	0	7	0	0
13	615213	.	C	T	0	4	4	0	2	6	0	0
13	638303	.	C	A	4	1	5	0	1	6	0	0
13	638362	.	C	T	1	3	4	0	0	4	0	0
13	638447	.	C	T	1	2	3	0	0	3	0	0
13	652340	.	G	A	2	3	5	0	1	6	0	0
13	658429	.	G	T	0	6	6	0	2	8	0	0
13	658872	.	C	T	3	3	6	0	0	6	0	0
13	660254	.	C	T	3	3	6	0	0	6	0	0
13	662635	.	C	A	2	5	7	0	0	7	0	0
13	662727	.	G	A	1	3	4	0	0	4	0	0
13	663532	.	T	A	4	3	7	0	0	7	0	0
13	663558	.	T	A	1	4	5	0	2	7	0	0
13	663573	.	G	A	0	4	4	0	5	9	0	0
13	663719	.	C	T	7	3	10	0	0	10	0	0
13	663752	.	A	G	2	0	2	0	5	7	0	0
13	663791	.	A	T	3	3	6	0	0	6	0	0
13	664012	.	G	A	2	9	11	0	0	11	0	0
13	664139	.	C	T	9	3	12	0	0	12	0	0
13	664143	.	C	T	9	3	12	0	0	12	0	0
13	664196	.	A	G	3	0	3	0	6	9	0	0
13	664307	.	G	A	1	5	6	0	0	6	0	0
13	675139	.	C	A	3	8	11	0	0	11	0	0
13	677454	.	T	C	3	3	6	0	0	6	0	0
13	706679	.	C	G	3	2	5	0	0	5	0	0
13	706687	.	C	A	3	2	5	0	0	5	0	0
13	709018	.	C	T	1	3	4	0	0	4	0	0
13	709673	.	C	T	3	2	5	0	0	5	0	0
13	714117	.	C	G	4	8	12	0	1	13	0	0
13	718183	.	T	C	8	5	13	0	1	14	0	0
13	719316	.	C	T	9	6	15	0	0	15	0	0
13	719334	.	C	G	6	10	16	0	0	16	0	0
13	721290	.	C	T	11	13	24	0	0	24	0	0
13	721332	.	G	A	14	15	29	0	0	29	0	0
13	721617	.	C	T	9	13	22	0	1	23	0	0
13	724060	.	A	G	6	0	6	0	6	12	0	0
13	724249	.	C	T	2	3	5	0	0	5	0	0
13	733557	.	A	G	1	2	3	0	0	3	0	0
13	748105	.	T	C	5	2	7	0	0	7	0	0
13	748129	.	G	T	0	4	4	0	3	7	0	0
13	751302	.	C	T	5	2	7	0	1	8	0	0
13	755685	.	T	A	3	4	7	0	0	7	0	0
13	760241	.	G	T	2	4	6	0	0	6	0	0
13	760298	.	C	T	3	2	5	0	1	6	0	0
13	760472	.	C	A	3	4	7	0	0	7	0	0
13	761063	.	T	C	3	2	5	0	0	5	0	0
13	761135	.	C	T	2	5	7	0	0	7	0	0
13	761228	.	A	T	6	6	12	0	0	12	0	0
13	762321	.	T	C	6	3	9	0	2	11	0	0
13	762322	.	G	A	7	4	11	0	0	11	0	0
13	763775	.	A	C	5	5	10	0	0	10	0	0
13	774300	.	T	C	3	2	5	0	0	5	0	0
13	774304	.	C	G	3	2	5	0	0	5	0	0
13	785074	.	T	G	5	5	10	0	0	10	0	0
13	793529	.	G	C	1	6	7	0	4	11	0	0
13	793631	.	C	T	3	8	11	0	0	11	0	0
13	802925	.	C	T	8	7	15	0	0	15	0	0
13	808361	.	A	G	4	6	10	0	0	10	0	0
13	808530	.	A	C	8	4	12	0	0	12	0	0
13	808638	.	G	A	11	5	16	0	0	16	0	0
13	808648	.	G	A	8	8	16	0	0	16	0	0
13	809369	.	G	T	6	5	11	0	0	11	0	0
13	809615	.	G	T	3	4	7	0	0	7	0	0
13	809992	.	C	T	9	5	14	0	2	16	0	0
13	810008	.	G	C	7	9	16	0	1	17	0	0
13	810120	.	T	G	7	5	12	0	0	12	0	0
13	810158	.	A	G	6	0	6	0	5	11	0	0
13	810726	.	C	T	8	4	12	0	0	12	0	0
13	814038	.	G	A	12	6	18	0	1	19	0	0
13	814191	.	G	C	4	8	12	0	1	13	0	0
13	814290	.	G	C	11	7	18	0	1	19	0	0
13	814459	.	G	A	6	9	15	0	1	16	0	0
13	814501	.	T	C	5	4	9	0	1	10	0	0
13	814719	.	G	A	20	10	30	0	1	31	0	0
13	814791	.	C	G	0	3	3	0	3	6	0	0
13	814793	.	G	A	2	3	5	0	1	6	0	0
13	817238	.	G	A	5	5	10	0	0	10	0	0
13	821506	.	A	G	4	2	6	0	1	7	0	0
13	824485	.	T	C	7	0	7	0	8	15	0	0
13	826134	.	A	G	19	12	31	0	3	34	0	0
13	854419	.	G	A	10	11	21	0	1	22	0	0
13	854458	.	T	C	10	8	18	0	1	19	0	0
13	854588	.	A	C	11	0	11	0	9	20	0	0
13	854627	.	G	A	11	8	19	0	4	23	0	0
13	912171	.	A	G	11	10	21	0	2	23	0	0
13	912212	.	C	T	11	7	18	0	0	18	0	0
13	950859	.	T	C	8	15	23	0	0	23	0	0
13	957336	.	A	C	11	19	30	0	1	31	0	0
13	977619	.	A	G	13	10	23	0	2	25	0	0
13	1090246	.	T	C	3	7	10	0	0	10	0	0
13	1095173	.	T	C	3	9	12	0	1	13	0	0
13	1096496	.	G	A	0	5	5	0	3	8	0	0
13	1096613	.	C	G	2	7	9	0	0	9	0	0
13	1107013	.	C	T	20	18	38	0	2	40	0	0
13	1115091	.	C	T	26	33	59	0	0	59	0	0
13	1115106	.	C	T	24	34	58	0	1	59	0	0
13	1125197	.	C	T	4	12	16	0	0	16	0	0
13	1125199	.	C	A	3	11	14	0	2	16	0	0
13	1125292	.	T	A	5	11	16	0	1	17	0	0
13	1125331	.	G	C	13	12	25	0	0	25	0	0
13	1125410	.	T	C	14	1	15	0	14	29	0	0
13	1129255	.	G	C	12	11	23	0	0	23	0	0
13	1129261	.	T	C	13	12	25	0	1	26	0	0
13	1129902	.	T	C	15	15	30	0	1	31	0	0
13	1135581	.	G	A	1	10	11	0	0	11	0	0
13	1135584	.	A	C	1	10	11	0	0	11	0	0
13	1138282	.	T	G	4	0	4	0	3	7	0	0
13	1138357	.	C	T	7	3	10	0	0	10	0	0
13	1139908	.	A	C	1	6	7	0	0	7	0	0
13	1140659	.	C	G	3	6	9	0	1	10	0	0
13	1140987	.	G	T	9	3	12	0	0	12	0	0
13	1140992	.	C	T	8	2	10	0	1	11	0	0
13	1141064	.	T	C	1	3	4	0	0	4	0	0
13	1141067	.	T	C	1	3	4	0	0	4	0	0
13	1142775	.	G	C	9	7	16	0	0	16	0	0
13	1142839	.	C	A	3	15	18	0	10	28	0	0
13	1142841	.	T	A	9	16	25	0	2	27	0	0
13	1142918	.	G	A	17	17	34	0	3	37	0	0
13	1146062	.	A	G	16	27	43	0	4	47	0	0
13	1146101	.	C	T	22	19	41	0	6	47	0	0
13	1149953	.	T	C	16	0	16	0	22	38	0	0
13	1167932	.	A	C	1	2	3	0	0	3	0	0
13	1167984	.	A	G	3	2	5	0	0	5	0	0
13	1169006	.	C	A	2	2	4	0	0	4	0	0
13	1169025	.	G	T	1	3	4	0	0	4	0	0
13	1169695	.	G	A	1	3	4	1	0	5	0	0
13	1170418	.	T	G	1	0	1	0	3	4	0	0
13	1205411	.	G	A	3	2	5	0	1	6	0	0
13	1205564	.	G	A	0	2	2	0	1	3	0	0
13	1208354	.	C	T	4	5	9	0	0	9	0	0
13	1208813	.	T	A	1	2	3	0	1	4	0	0
13	1305970	.	G	A	2	3	5	0	0	5	0	0
13	1368968	.	A	G	3	2	5	0	0	5	0	0
13	1368976	.	C	A	1	4	5	0	0	5	0	0
13	1374455	.	T	C	8	4	12	0	1	13	0	0
13	1374680	.	C	G	6	2	8	0	0	8	0	0
13	1374690	.	C	T	4	2	6	0	0	6	0	0
13	1374773	.	T	C	3	2	5	0	1	6	0	0
13	1382002	.	C	A	1	1	2	0	0	2	0	0
13	1382019	.	C	T	2	4	6	0	0	6	0	0
13	1382148	.	G	C	0	6	6	2	2	10	0	0
13	1382152	.	G	T	0	2	2	2	6	10	0	0
13	1382298	.	A	T	5	4	9	0	0	9	0	0
13	1394582	.	G	C	3	5	8	0	0	8	0	0
13	1394938	.	G	A	0	2	2	0	3	5	0	0
13	1394941	.	G	A	3	2	5	0	0	5	0	0
13	1415315	.	C	G	1	8	9	0	6	15	0	0
13	1415511	.	A	T	8	11	19	0	0	19	0	0
13	1416074	.	C	A	6	8	14	0	0	14	0	0
13	1416098	.	G	A	6	12	18	0	1	19	0	0
13	1421341	.	T	C	9	0	9	0	3	12	0	0
13	1422111	.	G	A	5	6	11	0	0	11	0	0
13	1423520	.	G	A	6	4	10	0	1	11	0	0
13	1423568	.	G	A	9	3	12	1	0	13	0	0
13	1425462	.	T	G	8	5	13	1	0	14	0	0
13	1430204	.	T	C	2	2	4	0	0	4	0	0
13	1430246	.	T	A	0	2	2	0	2	4	0	0
13	1538689	.	T	A	3	2	5	0	1	6	0	0
13	1540688	.	C	T	3	6	9	0	2	11	0	0
13	1540707	.	C	A	3	3	6	0	3	9	0	0
13	1542540	.	C	T	4	2	6	0	0	6	0	0
13	1542630	.	T	C	1	3	4	0	0	4	0	0
13	1542763	.	G	T	4	2	6	0	1	7	0	0
13	1543833	.	A	C	3	2	5	0	0	5	0	0
13	1577695	.	T	C	7	6	13	0	0	13	0	0
13	1577716	.	A	G	4	9	13	0	0	13	0	0
13	1577746	.	A	T	5	4	9	0	0	9	0	0
13	1577755	.	A	G	5	5	10	0	0	10	0	0
13	1577896	.	G	A	5	3	8	0	0	8	0	0
13	1577904	.	C	T	6	3	9	0	0	9	0	0
13	1577997	.	T	A	9	7	16	0	1	17	0	0
13	1585125	.	G	A	2	6	8	0	0	8	0	0
13	1585203	.	C	T	4	5	9	0	0	9	0	0
13	1585679	.	G	A	1	2	3	0	0	3	0	0
13	1588052	.	A	G	7	1	8	0	6	14	0	0
13	1588073	.	T	C	6	6	12	0	0	12	0	0
13	1590235	.	G	A	0	6	6	0	2	8	0	0
13	1590321	.	G	C	5	4	9	0	1	10	0	0
13	1592342	.	G	A	6	3	9	0	0	9	0	0
13	1592362	.	G	A	7	4	11	0	0	11	0	0
13	1592401	.	A	G	7	8	15	0	1	16	0	0
13	1592710	.	A	G	6	0	6	0	10	16	0	0
13	1595642	.	G	A	0	4	4	0	7	11	0	0
13	1595749	.	T	C	7	3	10	0	1	11	0	0
13	1595898	.	A	G	5	2	7	0	0	7	0	0
13	1595938	.	A	G	3	5	8	0	1	9	0	0
13	1599692	.	A	G	7	7	14	0	1	15	0	0
13	1599825	.	G	T	3	7	10	0	6	16	0	0
13	1600001	.	G	T	7	5	12	0	0	12	0	0
13	1600264	.	T	A	10	7	17	0	0	17	0	0
13	1600582	.	G	T	1	7	8	0	6	14	0	0
13	1627605	.	G	A	9	12	21	0	1	22	0	0
13	1632106	.	G	A	11	12	23	0	0	23	0	0
13	1634479	.	A	G	10	9	19	1	0	20	0	0
13	1641762	.	C	T	9	5	14	0	0	14	0	0
13	1641827	.	A	G	2	5	7	0	1	8	0	0
13	1643933	.	C	T	12	12	24	0	2	26	0	0
13	1648470	.	G	A	10	9	19	0	0	19	0	0
13	1649725	.	C	T	15	10	25	0	0	25	0	0
13	1650683	.	A	G	16	12	28	0	0	28	0	0
13	1650938	.	G	C	7	18	25	0	0	25	0	0
13	1651706	.	A	G	20	1	21	0	12	33	0	0
13	1651727	.	C	T	16	15	31	0	1	32	0	0
13	1655426	.	T	C	11	13	24	0	2	26	0	0
13	1655767	.	T	C	11	14	25	0	0	25	0	0
13	1655905	.	G	A	12	11	23	0	3	26	0	0
13	1661740	.	A	G	12	16	28	0	0	30	2	0
13	1666388	.	A	G	10	0	10	0	14	24	0	0
13	1666412	.	A	G	8	0	8	0	14	22	0	0
13	1666451	.	T	C	11	13	24	0	1	25	0	0
13	1667865	.	T	A	21	13	34	0	2	36	0	0
13	1676895	.	G	A	1	24	25	0	9	34	0	0
13	1677009	.	G	T	1	10	11	0	13	24	0	0
13	1677859	.	G	T	15	16	31	0	0	31	0	0
13	1677913	.	C	T	12	14	26	0	1	27	0	0
13	1677958	.	A	G	16	1	17	0	15	32	0	0
13	1682856	.	T	C	12	11	23	0	1	24	0	0
13	1685150	.	G	C	14	15	29	0	0	29	0	0
13	1685192	.	A	T	13	22	35	0	3	38	0	0
13	1691983	.	T	A	24	17	41	0	3	45	1	0
13	1693284	.	G	A	2	17	19	0	23	42	0	0
13	1693312	.	C	A	23	19	42	0	2	44	0	0
13	1693386	.	C	T	19	20	39	0	0	39	0	0
13	1693392	.	C	T	21	21	42	0	0	42	0	0
13	1694395	.	C	A	17	14	31	0	1	32	0	0
13	1694417	.	C	A	18	13	31	0	1	32	0	0
13	1702940	.	A	C	4	2	6	0	1	7	0	0
13	1707294	.	T	C	25	19	44	0	2	46	0	0
13	1714981	.	T	C	4	2	6	0	0	6	0	0
13	1719777	.	G	A	1	25	26	0	20	46	0	0
13	1897405	.	C	A	1	3	4	0	0	4	0	0
13	1940790	.	C	G	6	3	9	0	0	9	0	0
13	2038267	.	G	A	2	4	6	0	0	6	0	0
13	2254607	.	A	T	1	2	3	0	0	3	0	0
13	2254751	.	T	A	2	2	4	0	0	4	0	0
13	2254753	.	G	C	2	0	2	0	2	4	0	0
13	2255239	.	G	A	1	2	3	0	0	3	0	0
13	2273835	.	G	A	1	2	3	0	0	3	0	0
13	2357927	.	A	G	7	3	10	0	1	11	0	0
13	2366936	.	G	A	6	6	12	0	0	12	0	0
13	2370529	.	G	T	0	6	6	0	3	9	0	0
13	2370556	.	G	T	0	8	8	0	6	14	0	0
13	2375550	.	G	A	1	6	7	0	8	15	0	0
13	2384958	.	A	G	7	8	15	0	1	16	0	0
13	2385812	.	G	A	13	5	18	0	2	20	0	0
13	2391803	.	A	G	16	1	17	0	15	32	0	0
13	2391818	.	A	G	12	15	27	0	4	31	0	0
13	2391964	.	G	C	11	10	21	0	1	22	0	0
13	2391965	.	A	T	12	10	22	0	0	22	0	0
13	2392342	.	G	A	8	10	18	0	1	19	0	0
13	2392397	.	G	A	14	6	20	0	0	20	0	0
13	2392459	.	A	G	11	0	11	0	8	19	0	0
13	2416172	.	T	C	2	3	5	0	0	5	0	0
13	2416221	.	G	A	4	2	6	0	0	6	0	0
13	2416807	.	A	G	1	2	3	0	0	3	0	0
13	2416987	.	A	G	1	2	3	0	0	3	0	0
13	2427026	.	G	A	6	3	9	0	0	9	0	0
13	2427174	.	C	T	9	7	16	0	0	16	0	0
13	2427175	.	T	G	7	7	14	0	0	15	1	0
13	2427251	.	T	A	4	4	8	0	0	8	0	0
13	2427569	.	T	C	15	1	16	0	16	32	0	0
13	2427702	.	T	C	31	3	34	0	20	54	0	0
13	2436227	.	T	A	16	22	38	0	3	41	0	0
13	2439886	.	C	T	19	20	39	0	1	40	0	0
13	2468112	.	G	A	1	3	4	0	0	4	0	0
13	2477812	.	C	T	2	3	5	0	0	5	0	0
13	2478271	.	G	A	2	2	4	0	0	4	0	0
13	2483134	.	A	G	2	2	4	0	0	4	0	0
13	2483989	.	C	T	2	2	4	0	0	4	0	0
13	2485928	.	C	T	3	4	7	0	0	7	0	0
13	2495872	.	C	T	5	5	10	0	0	10	0	0
13	2496334	.	C	T	6	3	9	0	0	9	0	0
13	2496496	.	T	A	2	5	7	0	0	7	0	0
13	2520778	.	G	A	19	10	29	0	2	31	0	0
13	2520834	.	C	T	11	13	24	0	0	24	0	0
13	2746311	.	A	C	4	10	14	0	0	14	0	0
13	2819432	.	C	T	12	10	22	0	1	23	0	0
13	2827605	.	G	T	12	25	37	0	1	38	0	0
13	2827670	.	C	T	17	9	26	0	2	28	0	0
13	2827808	.	A	G	0	9	9	0	0	9	0	0
13	2827832	.	G	T	26	4	30	0	1	31	0	0
13	2827918	.	A	T	7	5	12	1	0	13	0	0
13	2882422	.	T	C	2	2	4	0	0	4	0	0
13	2882614	.	A	G	5	3	8	0	0	8	0	0
13	2882632	.	C	T	5	2	7	0	0	7	0	0
13	2887553	.	A	G	1	0	1	0	2	3	0	0
13	2899483	.	G	A	5	5	10	0	0	10	0	0
13	2913822	.	C	T	12	16	28	0	1	29	0	0
13	2927676	.	C	T	1	5	6	0	10	16	0	0
13	2927832	.	T	A	10	9	19	0	10	29	0	0
13	2932666	.	G	C	6	7	13	0	0	13	0	0
13	3109186	.	C	A	2	3	5	0	0	5	0	0
13	3109195	.	G	C	3	3	6	0	0	6	0	0
13	3133582	.	T	A	3	3	6	0	0	6	0	0
13	3133588	.	G	A	2	4	6	0	0	6	0	0
13	3133645	.	T	G	1	4	5	0	0	5	0	0
13	3154901	.	T	A	3	5	8	0	0	8	0	0
13	3154956	.	G	C	1	4	5	0	1	6	0	0
13	3155196	.	T	A	1	2	3	0	1	4	0	0
13	3263932	.	T	C	3	0	3	0	8	11	0	0
13	3263990	.	G	A	2	8	10	0	0	10	0	0
13	3264012	.	G	A	3	9	12	0	0	12	0	0
13	3264063	.	G	C	4	0	4	0	15	19	0	0
13	3269340	.	G	A	6	11	17	0	0	17	0	0
13	3270110	.	C	T	1	9	10	0	4	14	0	0
13	3272706	.	C	A	0	5	5	0	2	7	0	0
13	3272735	.	G	C	1	6	7	0	0	7	0	0
13	3278079	.	A	G	2	9	11	0	0	11	0	0
13	3279525	.	A	G	2	2	4	0	0	4	0	0
13	3279591	.	G	A	3	3	6	0	1	7	0	0
13	3284747	.	G	A	1	2	3	0	0	3	0	0
13	3284780	.	C	T	0	4	4	0	2	6	0	0
13	3287096	.	C	T	2	3	5	0	3	8	0	0
13	3287268	.	C	A	3	2	5	0	0	5	0	0
13	3289120	.	T	C	2	2	4	0	0	4	0	0
13	3289513	.	T	C	2	2	4	0	0	4	0	0
13	3291953	.	G	A	3	2	5	0	0	5	0	0
13	3321859	.	C	T	3	2	5	0	0	5	0	0
13	3354930	.	C	T	5	3	8	0	0	8	0	0
13	3357683	.	C	T	2	4	6	0	3	9	0	0
13	3420158	.	G	T	3	4	7	0	0	7	0	0
13	3474261	.	A	C	3	3	6	0	0	6	0	0
13	3874427	.	A	G	3	4	7	0	0	7	0	0
13	3874618	.	T	C	7	7	14	0	0	14	0	0
13	3874815	.	T	C	4	0	4	0	3	7	0	0
13	3874831	.	T	C	3	6	9	0	0	9	0	0
13	3874903	.	C	A	1	3	4	0	3	7	0	0
13	3874909	.	G	A	3	3	6	0	0	6	0	0
13	3874983	.	A	G	3	3	6	0	0	6	0	0
13	3875113	.	C	G	1	2	3	0	1	4	0	0
13	3881204	.	T	C	4	10	14	1	0	15	0	0
13	3881208	.	G	T	4	9	13	1	0	14	0	0
13	3881269	.	C	G	3	8	11	1	0	12	0	0
13	3885350	.	A	C	5	5	10	1	0	11	0	0
13	3885359	.	G	T	4	6	10	1	0	11	0	0
13	3916150	.	A	G	22	10	32	0	2	34	0	0
13	3916198	.	A	G	18	6	24	0	0	24	0	0
13	3916377	.	G	A	17	19	36	0	0	36	0	0
13	3919020	.	T	C	19	0	19	0	13	32	0	0
13	3919057	.	A	C	19	11	30	0	1	31	0	0
13	3919136	.	A	T	14	8	22	0	1	23	0	0
13	3919167	.	A	G	15	10	25	0	1	26	0	0
13	3919555	.	T	C	14	12	26	0	2	28	0	0
13	3919632	.	A	G	12	9	21	0	0	21	0	0
13	3919672	.	T	G	8	9	17	0	0	17	0	0
13	3919686	.	G	A	9	7	16	0	1	17	0	0
13	3919843	.	T	A	11	5	16	0	1	17	0	0
13	3920759	.	C	T	2	7	9	0	12	21	0	0
13	3922791	.	T	C	6	8	14	0	1	15	0	0
13	3927916	.	T	C	4	2	6	0	1	7	0	0
13	3936482	.	C	G	8	12	20	0	0	20	0	0
13	3938574	.	C	A	11	6	17	0	1	18	0	0
13	3938619	.	C	A	16	10	26	0	0	26	0	0
13	3942055	.	G	A	0	12	12	0	9	21	0	0
13	3949847	.	G	A	9	12	21	0	1	22	0	0
13	3949978	.	T	G	10	0	10	0	7	17	0	0
13	3950007	.	G	A	7	11	18	0	0	19	1	0
13	3950074	.	A	T	12	14	26	0	2	28	0	0
13	3950181	.	T	C	15	14	29	0	1	30	0	0
13	3950497	.	G	T	9	3	12	0	4	16	0	0
13	3954611	.	C	T	4	7	11	0	1	12	0	0
13	3958895	.	C	T	2	7	9	0	0	9	0	0
13	3962845	.	C	T	3	6	9	0	3	12	0	0
13	3965966	.	G	A	9	19	28	0	1	29	0	0
13	3982036	.	T	G	1	3	4	0	0	4	0	0
13	3982155	.	A	C	2	0	2	0	2	4	0	0
13	3982190	.	G	A	3	3	6	0	0	6	0	0
13	3983112	.	G	C	1	2	3	0	0	3	0	0
13	4205733	.	C	T	2	2	4	0	0	4	0	0
13	4213300	.	C	T	3	5	8	0	0	8	0	0
13	4213594	.	G	T	2	1	3	0	0	3	0	0
13	4213598	.	C	T	2	2	4	0	0	4	0	0
13	4213804	.	G	A	6	10	16	0	0	16	0	0
13	4226664	.	C	A	17	16	33	0	2	35	0	0
13	4231438	.	T	A	13	15	28	0	2	30	0	0
13	4231590	.	A	G	1	4	5	0	1	6	0	0
13	4231787	.	A	G	9	9	18	0	3	21	0	0
13	4231819	.	G	A	12	10	22	1	1	24	0	0
13	4231954	.	T	A	10	6	16	0	0	16	0	0
13	4232003	.	A	G	5	3	8	0	0	8	0	0
13	4232051	.	G	A	6	4	10	0	1	11	0	0
13	4232054	.	A	T	5	5	10	0	0	10	0	0
13	4232171	.	C	T	24	15	39	0	0	39	0	0
13	4232280	.	T	C	31	21	52	0	2	54	0	0
13	4232284	.	T	C	34	21	55	0	1	56	0	0
13	4232324	.	T	G	35	15	50	0	1	51	0	0
13	4232718	.	G	A	13	12	25	0	3	28	0	0
13	4233030	.	C	T	2	25	27	0	11	38	0	0
13	4233033	.	G	A	27	11	38	0	0	38	0	0
13	4233167	.	T	A	22	9	31	2	1	34	0	0
13	4233361	.	G	T	10	17	27	0	0	27	0	0
13	4233365	.	G	A	18	9	27	0	0	27	0	0
13	4233625	.	T	A	10	9	19	0	3	22	0	0
13	4233779	.	G	A	19	14	33	0	2	35	0	0
13	4233889	.	G	A	8	6	14	0	1	15	0	0
13	4233911	.	G	C	15	6	21	0	0	21	0	0
13	4233952	.	T	G	15	11	26	0	1	27	0	0
13	4234337	.	G	A	16	12	28	0	0	28	0	0
13	4234349	.	G	T	12	13	25	0	0	25	0	0
13	4234655	.	G	A	18	17	35	1	0	36	0	0
13	4251236	.	G	A	7	2	9	0	0	9	0	0
13	4256617	.	A	G	9	12	21	0	0	21	0	0
13	4307752	.	A	G	10	9	19	0	0	19	0	0
13	4307782	.	C	T	14	14	28	0	1	29	0	0
13	4307934	.	T	C	19	18	37	0	0	37	0	0
13	4308269	.	G	A	16	11	27	0	0	27	0	0
13	4308841	.	T	G	14	12	26	0	0	26	0	0
13	4309166	.	T	G	15	10	25	0	0	25	0	0
13	4310247	.	G	A	10	10	20	0	1	21	0	0
13	4310440	.	G	C	23	0	23	0	19	42	0	0
13	4310511	.	C	T	2	7	9	0	25	34	0	0
13	4310565	.	G	A	21	16	37	0	2	39	0	0
13	4310568	.	A	T	16	16	32	0	9	41	0	0
13	4310610	.	C	T	18	13	31	0	0	31	0	0
13	4311081	.	T	C	9	5	14	0	2	16	0	0
13	4311578	.	T	C	15	1	16	0	8	24	0	0
13	4311699	.	G	T	15	9	24	0	0	24	0	0
13	4311912	.	C	T	11	2	13	0	1	14	0	0
13	4317628	.	C	T	1	4	5	0	2	7	0	0
13	4317721	.	T	C	3	3	6	0	0	6	0	0
13	4320905	.	T	C	3	3	6	0	2	8	0	0
13	4321153	.	T	C	7	6	13	0	0	13	0	0
13	4321382	.	C	T	4	4	8	0	0	8	0	0
13	4321507	.	A	C	2	0	2	0	8	10	0	0
13	4321741	.	T	G	3	3	6	0	0	6	0	0
13	4325167	.	G	C	3	0	3	0	3	6	0	0
13	4330282	.	A	T	1	3	4	0	0	4	0	0
13	4335370	.	T	G	3	4	7	0	0	7	0	0
13	4335376	.	C	T	2	4	6	0	1	7	0	0
13	4339382	.	C	T	10	5	15	0	1	16	0	0
13	4343183	.	C	T	1	7	8	0	6	14	0	0
13	4343216	.	A	T	7	8	15	0	2	17	0	0
13	4343221	.	T	A	6	9	15	0	0	15	0	0
13	4343490	.	G	A	10	7	17	0	1	18	0	0
13	4343931	.	G	A	4	5	9	0	0	9	0	0
13	4344100	.	C	G	4	3	7	0	0	7	0	0
13	4344159	.	C	G	3	4	7	0	0	7	0	0
13	4344800	.	T	C	6	5	11	0	1	12	0	0
13	4347627	.	C	A	2	4	6	0	0	6	0	0
13	4350442	.	A	G	2	3	5	0	0	5	0	0
13	4352724	.	C	T	1	2	3	0	0	3	0	0
13	4360724	.	C	T	1	5	6	0	4	10	0	0
13	4366911	.	C	T	1	3	4	0	0	4	0	0
13	4368536	.	T	C	5	4	9	0	0	9	0	0
13	4398802	.	A	G	9	0	9	0	12	21	0	0
13	4399618	.	A	G	4	2	6	0	1	7	0	0
13	4399667	.	G	A	4	6	10	0	0	10	0	0
13	4399786	.	T	C	4	8	12	0	0	12	0	0
13	4399909	.	T	G	1	2	3	1	0	4	0	0
13	4400462	.	A	C	4	4	8	2	0	10	0	0
13	4400464	.	C	G	4	4	8	2	0	10	0	0
13	4406090	.	T	A	22	11	33	0	1	34	0	0
13	4406816	.	T	C	19	16	35	2	2	39	0	0
13	4406937	.	T	A	11	10	21	0	0	21	0	0
13	4600689	.	A	G	3	2	5	0	0	5	0	0
13	4602243	.	G	A	2	2	4	0	0	4	0	0
13	4608152	.	T	C	6	2	8	0	0	8	0	0
13	4611061	.	C	T	7	2	9	0	1	10	0	0
13	4615169	.	T	C	3	3	6	0	0	6	0	0
13	4657394	.	T	C	2	2	4	0	0	4	0	0
13	4663444	.	A	G	13	4	17	0	1	18	0	0
13	4712660	.	C	G	3	3	6	0	0	6	0	0
13	4713152	.	G	C	11	8	19	0	1	20	0	0
13	4713193	.	C	G	9	11	20	0	0	20	0	0
13	4713310	.	A	T	8	7	15	0	1	16	0	0
13	4713373	.	T	A	8	10	18	0	1	19	0	0
13	4713478	.	G	A	5	7	12	0	0	12	0	0
13	4713694	.	T	C	10	3	13	0	0	13	0	0
13	4714045	.	T	C	5	6	11	0	0	11	0	0
13	4872079	.	G	A	6	7	13	0	1	14	0	0
13	4872121	.	C	T	6	5	11	0	1	12	0	0
13	4888273	.	G	A	1	8	9	0	12	21	0	0
13	4899623	.	A	G	7	8	15	0	1	16	0	0
13	4945804	.	C	T	9	13	22	0	2	24	0	0
13	4948345	.	G	A	12	15	27	0	0	27	0	0
13	4968421	.	A	G	18	13	31	0	3	34	0	0
13	4968583	.	T	A	12	15	27	0	1	28	0	0
13	4968727	.	G	A	18	13	31	0	0	31	0	0
13	4968890	.	T	C	13	15	28	0	2	30	0	0
13	4968931	.	T	A	14	16	30	1	3	34	0	0
13	4969432	.	A	G	13	0	13	0	6	19	0	0
13	4973556	.	T	A	4	4	8	0	1	9	0	0
13	4978680	.	A	G	8	12	20	0	0	20	0	0
13	4978885	.	T	C	13	8	21	0	1	22	0	0
13	4978887	.	C	A	15	8	23	0	0	23	0	0
13	4979190	.	T	C	9	7	16	0	0	16	0	0
13	4979339	.	C	T	3	6	9	0	0	9	0	0
13	4979420	.	T	C	7	5	12	0	2	14	0	0
13	4979471	.	T	C	5	10	15	0	1	16	0	0
13	4979607	.	G	T	11	11	22	0	0	22	0	0
13	4979653	.	A	G	7	9	16	1	0	17	0	0
13	4979754	.	A	G	7	11	18	0	1	19	0	0
13	4979799	.	T	C	8	0	8	0	3	11	0	0
13	4981965	.	A	T	1	4	5	0	0	5	0	0
13	4982061	.	T	G	1	3	4	0	1	5	0	0
13	4982284	.	G	A	2	5	7	0	0	7	0	0
13	4983110	.	A	T	2	3	5	0	0	5	0	0
13	4983113	.	C	A	1	3	4	0	2	6	0	0
13	5000490	.	G	A	2	15	17	0	7	24	0	0
13	5000560	.	A	G	9	10	19	0	0	19	0	0
13	5004996	.	C	T	7	11	18	0	1	19	0	0
13	5013671	.	A	G	9	12	21	0	3	24	0	0
13	5016700	.	G	A	9	17	26	0	3	29	0	0
13	5016758	.	G	C	21	10	31	0	0	31	0	0
13	5017657	.	A	C	12	23	35	0	1	36	0	0
13	5017680	.	G	A	16	24	40	0	1	41	0	0
13	5017699	.	G	A	17	24	41	0	2	43	0	0
13	5026131	.	C	T	25	21	46	0	5	51	0	0
13	5028224	.	T	G	26	30	56	0	4	60	0	0
13	5028407	.	G	A	30	20	50	0	3	53	0	0
13	5028414	.	T	C	29	21	50	0	3	53	0	0
13	5028499	.	A	T	24	31	55	1	4	60	0	0
13	5028711	.	C	T	27	31	58	0	2	60	0	0
13	5028912	.	C	T	18	14	32	1	0	33	0	0
13	5031526	.	C	T	1	3	4	0	0	4	0	0
13	5031689	.	T	A	1	2	3	0	0	3	0	0
13	5048306	.	A	G	2	2	4	0	0	4	0	0
13	5049730	.	A	G	3	2	5	0	0	5	0	0
13	5246113	.	G	A	3	2	5	0	0	5	0	0
13	5251237	.	G	A	1	3	4	0	0	4	0	0
13	5871084	.	C	A	4	4	8	0	0	8	0	0
13	5871321	.	G	A	4	3	7	0	0	7	0	0
13	5871340	.	G	C	4	5	9	0	0	9	0	0
13	5871445	.	G	A	1	2	3	0	0	3	0	0
13	5871834	.	C	T	0	6	6	0	3	9	0	0
13	5871928	.	G	A	2	4	6	0	0	6	0	0
13	5871967	.	A	G	2	3	5	0	0	5	0	0
13	5872300	.	G	A	2	3	5	0	1	6	0	0
13	5872717	.	A	G	3	5	8	0	0	8	0	0
13	5936945	.	T	G	8	9	17	0	0	17	0	0
13	5959654	.	T	C	7	5	12	0	0	12	0	0
13	5978865	.	T	C	11	8	19	0	0	19	0	0
13	5999159	.	G	A	4	3	7	0	0	7	0	0
13	6077003	.	G	T	1	2	3	0	0	3	0	0
13	6091985	.	T	C	1	3	4	0	0	4	0	0
13	6092064	.	G	A	1	1	2	0	2	4	0	0
13	6092065	.	A	C	1	3	4	0	0	4	0	0
13	6092108	.	C	G	4	3	7	0	0	7	0	0
13	6095996	.	A	C	3	2	5	0	0	5	0	0
13	6096001	.	T	C	2	3	5	0	0	5	0	0
13	6099644	.	G	T	2	4	6	0	0	6	0	0
13	6119843	.	A	G	1	6	7	0	0	7	0	0
13	6119865	.	C	T	1	7	8	0	0	8	0	0
13	6125154	.	T	C	3	6	9	0	1	10	0	0
13	6125207	.	A	T	4	2	6	0	1	7	0	0
13	6125217	.	G	A	0	5	5	0	2	7	0	0
13	6189925	.	T	G	10	0	10	0	9	19	0	0
13	6191523	.	C	A	9	7	16	0	0	16	0	0
13	6192433	.	C	A	4	5	9	0	1	10	0	0
13	6194867	.	T	A	8	8	16	0	1	17	0	0
13	6195043	.	T	G	5	0	5	0	14	19	0	0
13	6195055	.	A	T	14	4	18	0	2	20	0	0
13	6199336	.	G	A	0	8	8	0	7	15	0	0
13	6199375	.	T	C	10	4	14	0	1	15	0	0
13	6204583	.	G	A	14	11	25	0	0	25	0	0
13	6204957	.	T	C	8	5	13	0	0	13	0	0
13	6205004	.	C	T	10	5	15	0	2	17	0	0
13	6205311	.	G	A	3	9	12	0	0	12	0	0
13	6226012	.	G	C	2	5	7	0	0	7	0	0
13	6233482	.	A	C	2	4	6	0	1	7	0	0
13	6236772	.	G	A	6	4	10	0	0	10	0	0
13	6236796	.	C	T	5	6	11	0	0	11	0	0
13	6236901	.	G	A	15	7	22	0	0	22	0	0
13	6238204	.	G	A	10	9	19	0	0	19	0	0
13	6238466	.	T	C	7	14	21	0	1	22	0	0
13	6238658	.	G	T	0	13	13	0	13	26	0	0
13	6238762	.	A	G	5	12	17	0	1	18	0	0
13	6238883	.	A	G	10	5	15	0	0	15	0	0
13	6238972	.	G	A	8	6	14	0	0	14	0	0
13	6239031	.	C	T	1	7	8	0	0	8	0	0
13	6239091	.	A	T	4	5	9	0	0	9	0	0
13	6239112	.	A	G	4	6	10	0	0	10	0	0
13	6259813	.	C	T	0	3	3	0	1	4	0	0
13	6271263	.	C	T	1	2	3	0	0	3	0	0
13	6279243	.	T	C	2	3	5	0	0	5	0	0
13	7062963	.	T	G	2	2	4	0	0	4	0	0
13	7063602	.	C	G	8	6	14	0	1	15	0	0
13	7063644	.	C	T	9	5	14	0	0	14	0	0
13	7063757	.	C	G	3	5	8	0	1	9	0	0
13	7148075	.	G	A	0	4	4	0	1	5	0	0
13	7170250	.	C	T	2	3	5	0	0	5	0	0
13	7170279	.	C	G	1	4	5	0	0	5	0	0
13	7171183	.	G	A	1	2	3	0	0	3	0	0
13	7177264	.	A	G	1	2	3	0	0	3	0	0
13	7179881	.	T	C	1	4	5	0	0	5	0	0
13	7179992	.	T	C	2	0	2	0	3	5	0	0
13	7184446	.	G	A	1	2	3	0	0	3	0	0
13	7305715	.	A	G	3	2	5	0	0	5	0	0
13	7307082	.	A	G	2	3	5	0	0	5	0	0
13	7307512	.	T	C	3	2	5	0	1	6	0	0
13	7310628	.	A	C	5	2	7	0	0	7	0	0
13	7311089	.	C	T	3	2	5	0	0	5	0	0
13	7311101	.	G	A	3	3	6	0	0	6	0	0
13	7311133	.	C	T	1	3	4	0	0	4	0	0
13	7311154	.	T	G	1	0	1	0	3	4	0	0
13	7311218	.	A	G	3	4	7	0	0	7	0	0
13	7311263	.	G	A	1	4	5	0	2	7	0	0
13	7311420	.	C	A	8	4	12	0	1	13	0	0
13	7311849	.	C	T	3	4	7	0	0	7	0	0
13	7311986	.	A	C	7	6	13	0	1	14	0	0
13	7312015	.	T	A	7	7	14	0	0	14	0	0
13	7312201	.	T	A	8	3	11	0	1	12	0	0
13	7312225	.	G	C	10	4	14	0	0	14	0	0
13	7312323	.	A	T	6	3	9	0	0	9	0	0
13	7312372	.	G	T	5	4	9	0	1	10	0	0
13	7312585	.	T	C	6	8	14	0	0	14	0	0
13	7312675	.	C	T	4	4	8	0	3	11	0	0
13	7312713	.	T	A	9	5	14	0	0	14	0	0
13	7312991	.	T	C	7	11	18	0	0	18	0	0
13	7313020	.	G	A	1	7	8	0	5	13	0	0
13	7313185	.	T	C	10	6	16	0	0	16	0	0
13	7313304	.	A	G	10	5	15	0	0	15	0	0
13	7313546	.	A	G	8	3	11	0	1	12	0	0
13	7313641	.	C	A	10	5	15	0	1	16	0	0
13	7313827	.	C	T	7	10	17	0	0	17	0	0
13	7314049	.	T	C	14	5	19	0	1	20	0	0
13	7314080	.	G	A	13	6	19	0	1	20	0	0
13	7314823	.	C	T	13	12	25	0	0	25	0	0
13	7314856	.	G	A	16	7	23	0	3	26	0	0
13	7314859	.	C	A	17	9	26	0	0	26	0	0
13	7315015	.	C	T	15	8	23	0	1	24	0	0
13	7315234	.	A	G	28	10	38	0	1	39	0	0
13	7315424	.	G	A	1	11	12	0	16	28	0	0
13	7316042	.	C	A	13	11	24	0	3	27	0	0
13	7316157	.	G	T	15	12	27	0	0	27	0	0
13	7316484	.	A	T	11	3	14	0	0	14	0	0
13	7316532	.	C	A	12	5	17	0	0	17	0	0
13	7322456	.	T	A	8	4	12	0	0	12	0	0
13	7322524	.	C	T	11	6	17	0	0	17	0	0
13	7346864	.	A	G	35	9	44	0	0	44	0	0
13	7347125	.	G	A	7	4	11	0	0	11	0	0
13	7347142	.	A	G	5	3	8	0	0	8	0	0
13	7689546	.	C	A	2	3	5	0	0	5	0	0
13	7690025	.	G	A	3	3	6	0	0	6	0	0
13	7690033	.	T	A	4	3	7	0	0	7	0	0
13	7690060	.	G	A	3	2	5	0	0	5	0	0
13	7693225	.	T	A	2	2	4	0	0	4	0	0
13	7693648	.	A	T	1	2	3	0	0	3	0	0
13	7693681	.	C	T	2	2	4	0	0	4	0	0
13	7725965	.	C	T	3	9	12	0	0	12	0	0
13	7737020	.	G	A	0	2	2	0	4	6	0	0
13	7737101	.	G	A	0	4	4	0	2	6	0	0
13	7744319	.	A	G	4	7	11	0	0	11	0	0
13	7744443	.	G	A	15	9	24	0	2	26	0	0
13	7745463	.	C	G	3	5	8	0	3	11	0	0
13	7745544	.	C	T	12	6	18	0	1	19	0	0
13	7745705	.	G	A	5	5	10	0	0	10	0	0
13	7745814	.	C	A	7	5	12	0	1	13	0	0
13	7745866	.	A	G	3	0	3	0	7	10	0	0
13	7745962	.	A	G	1	5	6	0	0	6	0	0
13	7745979	.	T	C	1	4	5	0	0	5	0	0
13	7747299	.	A	G	1	3	4	0	1	5	0	0
13	7747513	.	C	G	8	7	15	0	0	15	0	0
13	7747738	.	T	C	13	11	24	0	1	25	0	0
13	7747760	.	T	C	14	10	24	0	2	26	0	0
13	7748021	.	G	T	11	8	19	0	0	19	0	0
13	7748424	.	T	C	10	11	21	0	1	22	0	0
13	7748497	.	T	G	8	5	13	0	0	13	0	0
13	7748533	.	T	G	5	7	12	0	4	16	0	0
13	7748794	.	G	A	2	14	16	0	14	30	0	0
13	7748882	.	A	T	14	17	31	0	0	31	0	0
13	7748995	.	T	A	9	9	18	0	1	19	0	0
13	7749000	.	G	C	8	10	18	0	0	18	0	0
13	7755764	.	A	C	18	1	19	0	26	45	0	0
13	7755875	.	T	C	23	0	23	0	27	50	0	0
13	7759403	.	T	C	32	18	50	0	0	50	0	0
13	7763810	.	A	G	22	14	36	0	0	36	0	0
13	7766936	.	C	T	2	11	13	0	15	28	0	0
13	7767013	.	C	T	1	3	4	0	0	4	0	0
13	8169620	.	T	C	1	2	3	0	0	3	0	0
13	8261168	.	A	G	1	0	1	0	2	3	0	0
13	8270424	.	T	C	2	4	6	0	0	6	0	0
13	8270437	.	T	A	2	4	6	0	0	6	0	0
13	8281619	.	C	A	7	8	15	0	1	16	0	0
13	8281655	.	A	C	7	7	14	0	0	14	0	0
13	8290811	.	A	G	4	3	7	0	1	8	0	0
13	8294201	.	C	T	0	2	2	0	2	4	0	0
13	8294222	.	A	T	1	2	3	0	0	3	0	0
13	8320785	.	G	A	2	4	6	0	0	6	0	0
13	8323740	.	A	C	6	4	10	0	0	10	0	0
13	8326274	.	T	C	6	3	9	0	0	9	0	0
13	8333500	.	C	T	2	3	5	0	0	5	0	0
13	8333942	.	G	A	4	2	6	0	0	6	0	0
13	8347708	.	C	T	1	2	3	0	0	3	0	0
13	8348158	.	G	A	2	3	5	0	0	5	0	0
13	8375857	.	T	C	4	2	6	0	6	12	0	0
13	8375932	.	A	T	22	16	38	0	0	38	0	0
13	8375935	.	C	A	20	16	36	0	2	38	0	0
13	8375981	.	A	G	22	24	46	0	3	49	0	0
13	8376064	.	A	G	9	15	24	0	0	24	0	0
13	8376077	.	C	G	12	14	26	0	0	26	0	0
13	8376184	.	C	T	7	16	23	0	0	23	0	0
13	8376187	.	G	A	10	16	26	0	0	26	0	0
13	8376301	.	A	T	10	4	14	0	0	14	0	0
13	8376317	.	T	A	11	5	16	0	0	16	0	0
13	8376355	.	C	T	9	5	14	0	2	16	0	0
13	8376613	.	T	G	10	7	17	0	1	18	0	0
13	8376675	.	C	A	0	10	10	0	9	19	0	0
13	8376727	.	T	A	9	7	16	0	0	16	0	0
13	8376731	.	C	T	9	7	16	0	0	16	0	0
13	8376765	.	C	A	8	8	16	0	1	17	0	0
13	8376845	.	A	G	12	9	21	0	0	21	0	0
13	8376882	.	C	T	0	9	9	0	6	15	0	0
13	8376896	.	T	C	5	6	11	0	0	11	0	0
13	8376972	.	G	A	6	3	9	0	1	10	0	0
13	8377327	.	A	G	3	4	7	0	1	8	0	0
13	8377334	.	A	G	3	5	8	0	0	8	0	0
13	8377852	.	A	G	2	1	3	0	1	4	0	0
13	8377853	.	T	A	1	1	2	0	2	4	0	0
13	8378018	.	A	C	3	4	7	0	1	8	0	0
13	8378354	.	A	G	1	4	5	0	0	5	0	0
13	8378400	.	T	C	1	4	5	0	1	6	0	0
13	8378511	.	A	T	2	2	4	0	0	4	0	0
13	8378519	.	A	G	1	2	3	0	0	3	0	0
13	8378588	.	C	A	1	3	4	0	3	7	0	0
13	8378601	.	T	C	3	4	7	0	0	7	0	0
13	8378635	.	T	G	2	3	5	0	0	5	0	0
13	8380477	.	T	C	3	5	8	0	0	8	0	0
13	8600097	.	A	G	1	1	2	0	1	3	0	0
13	8600654	.	A	T	1	4	5	0	0	5	0	0
13	8600706	.	G	T	1	5	6	0	0	6	0	0
13	8601011	.	A	G	1	2	3	0	0	3	0	0
13	8621955	.	T	C	2	2	4	0	0	4	0	0
13	8622003	.	A	C	2	3	5	0	0	5	0	0
13	8622084	.	A	G	1	6	7	0	2	9	0	0
13	8622382	.	G	A	5	5	10	0	0	10	0	0
13	8623343	.	T	A	1	4	5	0	0	5	0	0
13	8623348	.	A	G	1	2	3	0	1	4	0	0
13	8623387	.	T	C	3	4	7	0	0	7	0	0
13	8623483	.	A	G	3	0	3	0	8	11	0	0
13	8623517	.	A	C	3	6	9	0	0	9	0	0
13	8623521	.	G	C	2	5	7	0	0	7	0	0
13	8623659	.	A	C	2	2	4	0	0	4	0	0
13	8623806	.	T	C	2	2	4	0	0	4	0	0
13	8623836	.	C	T	2	2	4	0	1	5	0	0
13	8624140	.	A	C	2	2	4	0	0	4	0	0
13	8624143	.	C	A	2	1	3	0	1	4	0	0
13	8624760	.	T	A	4	3	7	0	0	7	0	0
13	8624996	.	T	C	2	3	5	0	1	6	0	0
13	8625050	.	A	G	3	0	3	0	5	8	0	0
13	8625167	.	T	C	6	6	12	0	1	13	0	0
13	8625210	.	C	G	6	3	9	0	4	13	0	0
13	8626645	.	T	A	5	5	10	0	0	10	0	0
13	8626786	.	G	A	1	2	3	0	7	10	0	0
13	8627626	.	G	A	1	4	5	0	9	14	0	0
13	8627634	.	T	A	9	4	13	0	1	14	0	0
13	8627677	.	G	A	10	13	23	0	0	23	0	0
13	8627819	.	T	C	5	3	8	0	0	8	0	0
13	8627883	.	T	C	3	3	6	0	0	6	0	0
13	8683992	.	A	G	2	5	7	0	0	7	0	0
13	8684253	.	T	A	1	6	7	0	0	7	0	0
13	8684295	.	T	G	3	4	7	0	0	7	0	0
13	8684402	.	G	A	3	5	8	0	0	8	0	0
13	8684403	.	A	G	3	5	8	0	0	8	0	0
13	8685176	.	C	T	6	7	13	0	0	13	0	0
13	8685217	.	A	T	4	9	13	0	0	13	0	0
13	8685272	.	C	T	6	4	10	0	0	10	0	0
13	8685417	.	G	A	7	4	11	0	1	12	0	0
13	8685542	.	G	A	10	5	15	0	0	15	0	0
13	8685622	.	T	C	2	4	6	0	0	6	0	0
13	8692368	.	C	T	0	4	4	0	5	9	0	0
13	8692776	.	T	G	10	9	19	0	0	19	0	0
13	8692827	.	T	G	3	5	8	0	0	8	0	0
13	8707939	.	A	G	1	0	1	0	2	3	0	0
13	8755678	.	A	C	3	3	6	0	1	7	0	0
13	8755727	.	G	A	1	4	5	0	0	5	0	0
13	8777682	.	C	T	20	11	31	0	3	34	0	0
13	8777701	.	G	A	19	14	33	0	1	34	0	0
13	8778501	.	G	T	30	22	52	8	4	64	0	0
13	8781087	.	G	T	1	1	2	0	1	3	0	0
13	8781222	.	T	C	4	4	8	0	0	8	0	0
13	8782424	.	A	T	3	3	6	0	0	6	0	0
13	8903804	.	C	T	2	3	5	0	0	5	0	0
13	8903809	.	G	A	0	3	3	0	2	5	0	0
13	8926213	.	A	G	1	0	1	0	3	4	0	0
13	8937231	.	T	G	1	1	2	0	1	3	0	0
13	8937373	.	G	A	2	2	4	0	0	4	0	0
13	8945361	.	G	C	1	3	4	0	0	4	0	0
13	8945365	.	C	T	1	3	4	0	0	4	0	0
13	8945406	.	G	A	2	4	6	0	0	6	0	0
13	8945700	.	T	C	2	6	8	0	0	8	0	0
13	8947046	.	G	A	3	2	5	0	2	7	0	0
13	8947095	.	C	T	4	4	8	0	0	8	0	0
13	8950686	.	G	A	6	3	9	0	1	10	0	0
13	8950783	.	C	G	10	5	15	0	0	15	0	0
13	8950829	.	A	G	7	3	10	0	0	10	0	0
13	8951259	.	T	G	2	4	6	0	1	7	0	0
13	9299796	.	A	G	3	2	5	0	0	5	0	0
13	9299881	.	C	G	3	2	5	0	0	5	0	0
13	9300177	.	A	G	5	3	8	0	1	9	0	0
13	9300204	.	G	A	4	4	8	0	0	8	0	0
13	9300224	.	C	T	0	4	4	0	4	8	0	0
13	9300239	.	G	T	4	2	6	0	0	6	0	0
13	9307646	.	T	C	14	16	30	0	1	31	0	0
13	9311156	.	C	A	13	11	24	0	1	25	0	0
13	9313806	.	C	T	3	17	20	0	23	43	0	0
13	9313858	.	A	T	41	17	58	0	4	62	0	0
13	9313975	.	T	C	38	36	74	0	3	77	0	0
13	9314024	.	C	A	45	26	71	0	0	71	0	0
13	9314040	.	T	A	40	23	63	0	2	65	0	0
13	9314238	.	G	A	46	23	69	0	2	71	0	0
13	9314338	.	C	T	41	31	72	0	2	74	0	0
13	9314532	.	T	C	48	3	51	0	27	78	0	0
13	9314580	.	A	T	36	32	68	0	4	72	0	0
13	9314620	.	C	T	39	33	72	0	1	73	0	0
13	9314630	.	C	T	2	24	26	0	45	71	0	0
13	9314710	.	G	A	42	37	79	0	1	80	0	0
13	9315004	.	C	T	39	40	79	0	3	82	0	0
13	9315019	.	T	C	33	39	72	0	5	78	1	0
13	9315045	.	C	G	44	34	78	0	0	79	1	0
13	9315384	.	G	A	38	30	68	1	3	72	0	0
13	9315406	.	A	G	42	29	71	1	4	76	0	0
13	9315424	.	G	A	39	34	73	0	2	75	0	0
13	9315686	.	C	T	7	35	42	0	36	78	0	0
13	9315730	.	A	G	47	26	73	0	10	83	0	0
13	9317915	.	T	C	48	33	81	0	3	84	0	0
13	9317945	.	C	T	54	30	84	0	3	87	0	0
13	9318003	.	C	T	6	34	40	0	42	82	0	0
13	9318116	.	T	C	49	35	84	0	2	86	0	0
13	9318125	.	C	T	51	43	94	0	0	94	0	0
13	9318263	.	C	T	42	37	79	0	7	86	0	0
13	9318446	.	T	C	33	46	79	0	5	84	0	0
13	9318521	.	A	G	38	34	72	0	3	75	0	0
13	9340019	.	C	T	4	4	8	0	0	8	0	0
13	9340609	.	C	A	1	10	11	0	9	20	0	0
13	9343329	.	T	C	14	14	28	0	0	28	0	0
13	9345182	.	A	C	15	10	25	0	2	28	1	0
13	9356123	.	G	T	10	3	13	0	0	13	0	0
13	9358449	.	C	T	13	5	18	0	1	19	0	0
13	9358457	.	T	G	12	7	19	0	0	19	0	0
13	9361825	.	T	C	6	8	14	0	0	14	0	0
13	9367562	.	T	A	12	6	18	0	2	20	0	0
13	9374116	.	C	T	2	4	6	0	0	6	0	0
13	9374370	.	T	C	1	2	3	0	0	3	0	0
13	9375081	.	C	T	2	3	5	0	0	5	0	0
13	9375797	.	A	C	2	3	5	0	0	5	0	0
13	9375990	.	A	G	1	2	3	0	0	3	0	0
13	9376045	.	A	G	1	2	3	0	0	3	0	0
13	9384590	.	A	G	3	2	5	0	0	5	0	0
13	9384997	.	C	G	2	2	4	0	0	4	0	0
13	9384998	.	G	A	0	2	2	0	2	4	0	0
13	9385060	.	C	T	4	4	8	0	0	8	0	0
13	9385127	.	G	T	1	3	4	0	2	6	0	0
13	9385129	.	G	A	1	3	4	0	2	6	0	0
13	9385561	.	G	A	1	4	5	0	0	5	0	0
13	9392020	.	G	A	3	6	9	0	0	9	0	0
13	9392047	.	G	A	2	4	6	0	1	7	0	0
13	9392068	.	A	G	1	3	4	0	0	4	0	0
13	9392260	.	G	A	0	4	4	0	2	6	0	0
13	9394684	.	A	T	4	6	10	0	0	10	0	0
13	9394716	.	A	G	4	5	9	0	0	9	0	0
13	9395458	.	G	T	5	4	9	0	0	9	0	0
13	9554410	.	T	C	1	2	3	0	0	3	0	0
13	9554761	.	T	C	1	2	3	0	0	3	0	0
13	9554825	.	T	G	4	4	8	0	0	8	0	0
13	9554828	.	T	C	4	5	9	0	0	9	0	0
13	9556178	.	C	T	2	2	4	0	1	5	0	0
13	9556194	.	T	C	3	2	5	0	0	5	0	0
13	9556322	.	A	G	4	0	4	0	5	9	0	0
13	9556734	.	C	G	2	2	4	0	0	4	0	0
13	9557534	.	T	A	2	2	4	0	0	4	0	0
13	9557638	.	T	A	2	5	7	0	0	7	0	0
13	9558312	.	T	A	1	2	3	0	0	3	0	0
13	9558321	.	T	C	1	2	3	0	0	3	0	0
13	9559476	.	T	A	3	2	5	0	0	5	0	0
13	9559527	.	A	C	5	9	14	0	1	15	0	0
13	9559542	.	A	G	6	0	6	0	13	19	0	0
13	9560897	.	T	C	4	4	8	0	0	8	0	0
13	9565065	.	G	A	1	7	8	0	9	17	0	0
13	9568821	.	C	T	2	2	4	0	0	4	0	0
13	9568857	.	G	A	0	3	3	0	4	7	0	0
13	9568861	.	T	C	5	4	9	0	0	9	0	0
13	9570532	.	A	T	5	5	10	0	1	11	0	0
13	9570598	.	A	G	8	6	14	0	0	14	0	0
13	9570967	.	A	G	3	4	7	0	2	9	0	0
13	9571695	.	C	T	7	4	11	0	0	11	0	0
13	9571949	.	T	C	15	9	24	0	0	24	0	0
13	9571972	.	G	A	15	6	21	0	0	21	0	0
13	9571996	.	T	G	16	9	25	0	0	25	0	0
13	9572036	.	G	A	9	8	17	0	0	17	0	0
13	9572196	.	T	C	3	2	5	0	1	6	0	0
13	9575779	.	T	G	1	2	3	0	0	3	0	0
13	9740055	.	T	C	1	2	3	0	0	3	0	0
13	9760013	.	A	G	1	0	1	0	2	3	0	0
13	9760021	.	A	G	1	2	3	0	0	3	0	0
13	9760195	.	A	C	1	2	3	0	0	3	0	0
13	9760567	.	T	G	1	3	4	0	0	4	0	0
13	9760850	.	G	A	1	2	3	0	0	3	0	0
13	9760868	.	A	T	1	3	4	0	0	4	0	0
13	9828568	.	A	T	3	4	7	0	1	8	0	0
13	9828572	.	G	A	2	4	6	0	3	9	0	0
13	9828933	.	G	T	3	7	10	0	0	10	0	0
13	9829007	.	A	G	1	6	7	0	0	7	0	0
13	9829013	.	C	T	1	6	7	0	0	7	0	0
13	9829232	.	T	C	1	3	4	0	0	4	0	0
13	9829252	.	T	A	1	2	3	0	0	3	0	0
13	9829274	.	C	A	4	2	6	0	0	6	0	0
13	9829289	.	T	C	4	3	7	0	0	7	0	0
13	9829406	.	A	C	1	3	4	0	0	4	0	0
13	9829408	.	G	A	1	3	4	0	0	4	0	0
13	9829722	.	T	G	2	0	2	0	2	4	0	0
13	9829855	.	C	T	2	8	10	0	0	10	0	0
13	9830089	.	T	C	7	4	11	0	0	11	0	0
13	9830399	.	C	T	0	2	2	0	1	3	0	0
13	9830417	.	C	A	1	3	4	0	0	4	0	0
13	9830518	.	A	T	3	3	6	0	1	7	0	0
13	9830521	.	A	C	4	3	7	0	0	7	0	0
13	9830554	.	A	G	5	4	9	0	0	9	0	0
13	9830597	.	C	A	3	3	6	0	1	7	0	0
13	9831056	.	G	C	3	2	5	0	0	5	0	0
13	9831116	.	A	G	6	8	14	0	0	14	0	0
13	9836485	.	A	T	1	4	5	0	0	5	0	0
13	9839813	.	G	A	5	6	11	0	1	12	0	0
13	9840152	.	G	A	4	9	13	0	0	13	0	0
13	9841702	.	T	A	7	13	20	0	0	20	0	0
13	9844527	.	A	G	12	0	12	0	12	24	0	0
13	9844746	.	T	C	19	22	41	0	0	41	0	0
13	9855508	.	G	T	10	9	19	0	0	20	1	0
13	9855874	.	G	A	15	16	31	0	0	31	0	0
13	9856143	.	G	A	11	5	16	0	1	17	0	0
13	9856192	.	A	G	14	12	26	0	1	27	0	0
13	9856493	.	A	T	20	17	37	0	1	39	1	0
13	9856816	.	G	A	12	10	22	0	2	24	0	0
13	9866857	.	G	A	4	3	7	0	0	7	0	0
13	9999459	.	G	A	4	2	6	0	0	6	0	0
13	10004064	.	A	G	1	3	4	1	0	5	0	0
13	10895731	.	T	G	9	12	21	0	0	21	0	0
13	10906719	.	G	A	17	10	27	0	3	30	0	0
13	10906817	.	T	C	15	15	30	0	1	31	0	0
13	10910423	.	G	T	2	21	23	0	14	37	0	0
13	10922497	.	T	G	6	3	9	0	0	9	0	0
13	10922568	.	T	C	1	0	1	0	1	2	0	0
13	10922613	.	A	T	5	11	16	0	1	17	0	0
13	10922660	.	G	A	7	11	18	0	0	18	0	0
13	10970732	.	G	T	3	2	5	0	0	5	0	0
13	10975980	.	G	A	1	2	3	0	1	4	0	0
13	10976428	.	T	C	1	1	2	0	0	2	0	0
13	10976431	.	A	G	1	2	3	0	0	3	0	0
13	10978512	.	A	T	1	4	5	0	0	5	0	0
13	10978526	.	C	T	1	5	6	0	0	6	0	0
13	10981896	.	T	A	2	3	5	0	1	6	0	0
13	10982404	.	C	T	18	9	27	0	1	28	0	0
13	10982444	.	G	A	18	7	25	0	0	25	0	0
13	10982472	.	T	G	10	16	26	0	0	26	0	0
13	10982966	.	A	T	12	17	29	0	0	29	0	0
13	10983231	.	G	A	6	5	11	0	0	11	0	0
13	10983421	.	C	A	5	7	12	0	0	12	0	0
13	10983482	.	T	A	9	5	14	0	0	14	0	0
13	10983788	.	T	C	8	12	20	0	0	20	0	0
13	10984205	.	G	A	15	14	29	0	4	33	0	0
13	10990959	.	G	A	6	7	13	0	0	13	0	0
13	10990973	.	T	C	7	0	7	0	10	17	0	0
13	10994107	.	A	G	5	6	11	0	1	12	0	0
13	10997566	.	A	G	8	6	14	0	0	14	0	0
13	11001998	.	A	G	2	7	9	0	0	9	0	0
13	11002013	.	A	C	3	1	4	0	6	10	0	0
13	11002052	.	A	G	6	5	11	0	1	12	0	0
13	11002234	.	C	T	0	3	3	0	6	9	0	0
13	11002247	.	G	A	5	4	9	0	0	9	0	0
13	11002541	.	A	G	0	5	5	0	1	6	0	0
13	11002697	.	A	G	4	3	7	0	2	9	0	0
13	11002778	.	T	C	9	4	13	0	0	13	0	0
13	11002922	.	C	T	4	2	6	0	1	7	0	0
13	11003297	.	C	T	0	4	4	0	2	6	0	0
13	11007087	.	G	A	4	3	7	0	1	8	0	0
13	11012312	.	G	T	1	3	4	2	0	6	0	0
13	11012469	.	T	C	3	4	7	0	1	8	0	0
13	11029585	.	G	T	3	4	7	0	0	7	0	0
13	11035406	.	A	G	1	2	3	0	0	3	0	0
13	11035409	.	G	A	1	2	3	0	0	3	0	0
13	11073409	.	T	G	3	2	5	0	0	5	0	0
13	11077508	.	C	A	1	3	4	0	0	4	0	0
13	11077921	.	G	A	3	2	5	0	0	5	0	0
13	11119837	.	A	G	1	7	8	0	0	8	0	0
13	11166435	.	G	A	3	2	5	0	1	6	0	0
13	11166467	.	A	G	3	2	5	0	0	5	0	0
13	11166524	.	A	T	1	2	3	0	0	3	0	0
13	11166560	.	C	T	1	2	3	0	0	3	0	0
13	11166570	.	T	A	1	2	3	0	0	3	0	0
13	11175605	.	G	A	2	3	5	0	0	5	0	0
13	11176079	.	A	G	5	2	7	0	0	7	0	0
13	11176295	.	T	C	1	2	3	0	0	3	0	0
13	11184784	.	G	A	14	5	19	0	0	19	0	0
13	11233520	.	G	C	5	2	7	0	1	8	0	0
13	11441080	.	T	A	9	15	24	0	3	27	0	0
13	11442090	.	A	T	17	14	31	0	1	33	1	0
13	11443457	.	T	A	23	20	43	0	1	44	0	0
13	11443881	.	C	T	23	11	34	0	0	34	0	0
13	11444022	.	A	T	16	16	32	0	1	33	0	0
13	11444263	.	G	A	3	22	25	0	20	45	0	0
13	11444295	.	C	T	27	23	50	0	2	52	0	0
13	11444801	.	T	A	11	10	21	0	1	22	0	0
13	11489965	.	T	C	6	13	19	0	1	20	0	0
13	11489999	.	C	A	11	10	21	0	0	21	0	0
13	11490035	.	A	G	13	8	21	0	0	21	0	0
13	11490065	.	G	A	11	6	17	0	1	18	0	0
13	11490084	.	G	A	8	8	16	0	1	17	0	0
13	11490214	.	A	C	4	2	6	0	0	6	0	0
13	11490300	.	G	T	4	3	7	0	2	9	0	0
13	11490626	.	G	A	13	5	18	0	0	18	0	0
13	11500299	.	T	C	14	0	14	0	8	22	0	0
13	11503682	.	G	A	7	2	9	0	2	11	0	0
13	11536901	.	T	A	7	7	14	0	0	14	0	0
13	11550734	.	G	T	1	6	7	0	5	12	0	0
13	11550741	.	T	C	4	6	10	0	1	11	0	0
13	11675148	.	G	A	5	4	9	0	0	9	0	0
13	11675185	.	A	G	6	5	11	0	0	11	0	0
13	11675270	.	G	A	4	2	6	0	0	6	0	0
13	11675343	.	C	G	5	5	10	0	0	10	0	0
13	11675378	.	T	C	5	2	7	0	0	7	0	0
13	11675584	.	C	T	3	2	5	0	1	6	0	0
13	11675855	.	T	G	1	7	8	0	0	8	0	0
13	11675912	.	A	T	1	5	6	0	0	6	0	0
13	11676639	.	G	A	2	2	4	0	0	4	0	0
13	11677621	.	T	G	1	0	1	0	1	2	0	0
13	11678444	.	T	C	1	1	2	0	1	3	0	0
13	11718751	.	C	T	1	2	3	0	0	3	0	0
13	11718761	.	T	C	1	2	3	0	1	4	0	0
13	11739900	.	A	G	1	2	3	0	0	3	0	0
13	11746459	.	C	A	18	15	33	0	0	33	0	0
13	11751402	.	G	A	19	16	35	0	0	35	0	0
13	11767651	.	T	C	4	4	8	0	0	8	0	0
13	11767768	.	A	G	6	3	9	0	0	9	0	0
13	11775095	.	G	A	2	2	4	0	2	6	0	0
13	11836187	.	C	T	2	3	5	0	0	5	0	0
13	11852302	.	C	T	7	2	9	0	0	9	0	0
13	11860525	.	T	C	5	4	9	0	0	9	0	0
13	11868812	.	A	G	2	4	6	0	0	6	0	0
13	11869049	.	G	T	10	4	14	0	1	15	0	0
13	11869219	.	G	T	3	3	6	0	0	6	0	0
13	11869220	.	G	T	3	3	6	0	0	6	0	0
13	11869357	.	G	T	3	5	8	0	0	8	0	0
13	11876698	.	T	G	1	6	7	0	0	7	0	0
13	11876841	.	G	A	3	4	7	0	0	7	0	0
13	11876850	.	G	A	2	6	8	0	0	8	0	0
13	11911904	.	A	G	7	7	14	1	1	16	0	0
13	11923834	.	G	C	11	6	17	0	1	18	0	0
13	11926692	.	C	G	9	10	19	0	2	21	0	0
13	11927341	.	C	G	7	7	14	0	1	15	0	0
13	11927347	.	T	A	8	7	15	0	0	15	0	0
13	11927491	.	T	C	11	10	21	0	0	21	0	0
13	11927603	.	A	G	7	3	10	0	0	10	0	0
13	11927735	.	T	C	5	4	9	0	1	10	0	0
13	11927829	.	A	T	4	4	8	0	4	12	0	0
13	11927830	.	T	G	6	4	10	0	2	12	0	0
13	11977394	.	A	T	9	6	15	0	0	15	0	0
13	11984768	.	A	C	4	9	13	0	2	15	0	0
13	11984857	.	T	A	5	6	11	0	0	11	0	0
13	11989171	.	G	C	2	3	5	0	17	23	1	0
13	11989357	.	T	C	19	10	29	0	2	31	0	0
13	11989468	.	A	C	16	15	31	1	1	33	0	0
13	11989554	.	A	G	24	18	42	0	1	43	0	0
13	11989629	.	C	T	27	18	45	0	0	45	0	0
13	11989633	.	T	C	26	14	40	0	0	40	0	0
13	11989698	.	C	T	20	9	29	0	1	30	0	0
13	11990118	.	G	A	23	14	37	0	1	38	0	0
13	11990175	.	T	C	22	0	22	0	14	36	0	0
13	11990294	.	A	G	15	11	26	0	2	28	0	0
13	11990329	.	T	G	14	18	32	0	2	34	0	0
13	11990389	.	G	T	18	10	28	0	1	29	0	0
13	11993451	.	A	T	14	11	25	0	1	26	0	0
13	12000699	.	T	C	6	6	12	0	0	12	0	0
13	12000700	.	G	C	6	6	12	0	0	12	0	0
13	12000906	.	T	A	8	7	15	0	0	15	0	0
13	12001110	.	T	C	7	4	11	0	1	12	0	0
13	12005859	.	T	A	2	4	6	0	0	6	0	0
13	12045797	.	A	T	5	3	8	0	0	8	0	0
13	12087528	.	G	A	2	13	15	0	17	32	0	0
13	12088223	.	C	G	19	19	38	0	0	38	0	0
13	12088255	.	A	G	16	12	28	0	0	29	1	0
13	12088327	.	A	G	11	16	27	0	1	28	0	0
13	12088406	.	T	C	8	14	22	0	1	23	0	0
13	12088795	.	T	C	1	3	4	0	0	4	0	0
13	12124063	.	G	A	1	2	3	0	0	3	0	0
13	12142001	.	G	A	2	2	4	0	0	4	0	0
13	12142007	.	T	C	2	2	4	0	0	4	0	0
13	12142204	.	G	A	3	2	5	0	0	5	0	0
13	12150892	.	C	T	4	2	6	0	0	6	0	0
13	12202096	.	A	T	2	2	4	0	0	4	0	0
13	12207170	.	A	T	10	7	17	0	1	19	1	0
13	12207583	.	G	T	6	7	13	0	1	14	0	0
13	12207591	.	A	T	6	7	13	0	0	13	0	0
13	12207656	.	C	T	4	7	11	0	1	12	0	0
13	12329553	.	C	T	1	3	4	0	1	5	0	0
13	12370839	.	A	G	3	4	7	0	1	8	0	0
13	12370952	.	T	A	1	3	4	1	0	5	0	0
13	12371317	.	A	C	1	2	3	0	0	3	0	0
13	12372008	.	A	G	3	2	5	0	1	6	0	0
13	12372247	.	T	C	5	3	8	0	1	9	0	0
13	12372501	.	C	A	9	6	15	0	0	15	0	0
13	12372552	.	C	A	8	5	13	0	1	14	0	0
13	12372596	.	C	G	10	6	16	0	0	16	0	0
13	12372609	.	C	G	11	6	17	0	0	17	0	0
13	12373033	.	A	G	5	0	5	0	5	10	0	0
13	12373059	.	T	C	4	8	12	0	0	12	0	0
13	12373093	.	A	T	5	5	10	0	0	10	0	0
13	12373126	.	T	G	7	2	9	0	0	9	0	0
13	12373262	.	C	T	10	6	16	0	1	17	0	0
13	12373274	.	A	T	12	5	17	0	0	17	0	0
13	12373430	.	T	A	12	5	17	0	0	17	0	0
13	12373460	.	A	G	8	5	13	0	0	13	0	0
13	12373514	.	A	G	2	3	5	0	1	6	0	0
13	12373572	.	C	T	3	3	6	0	0	6	0	0
13	12373679	.	T	C	2	9	11	0	0	11	0	0
13	12374414	.	A	G	6	12	18	0	0	18	0	0
13	12374585	.	T	G	5	4	9	0	0	9	0	0
13	12374710	.	A	G	4	1	5	0	14	19	0	0
13	12374771	.	A	G	10	8	18	0	0	18	0	0
13	12374775	.	T	G	10	8	18	0	0	18	0	0
13	12374901	.	C	A	7	11	18	0	0	19	1	0
13	12374910	.	G	A	1	11	12	0	8	20	0	0
13	12374954	.	A	C	6	4	10	0	2	12	0	0
13	12375198	.	A	G	15	8	23	0	1	24	0	0
13	12375348	.	C	A	6	4	10	0	1	11	0	0
13	12375389	.	A	G	7	4	11	0	0	11	0	0
13	12378142	.	G	T	4	2	6	0	1	7	0	0
13	12378315	.	T	A	6	6	12	0	1	13	0	0
13	12378356	.	T	G	11	12	23	0	0	23	0	0
13	12378407	.	T	C	9	8	17	0	0	17	0	0
13	12385182	.	A	G	8	7	15	0	0	15	0	0
13	12385538	.	G	T	10	11	21	0	0	21	0	0
13	12387658	.	G	A	12	8	20	0	0	20	0	0
13	12419787	.	C	T	2	4	6	0	0	6	0	0
13	12441437	.	A	G	1	3	4	0	0	4	0	0
13	12443951	.	C	T	6	5	11	0	0	11	0	0
13	12444014	.	T	C	2	2	4	0	0	4	0	0
13	12444218	.	A	T	1	7	8	0	1	9	0	0
13	12447952	.	T	C	6	6	12	0	1	13	0	0
13	12447961	.	A	C	7	6	13	0	0	13	0	0
13	12450980	.	G	T	5	4	9	0	0	9	0	0
13	12451397	.	T	C	4	2	6	0	0	6	0	0
13	12479382	.	C	A	2	3	5	0	2	7	0	0
13	12479490	.	G	A	6	14	20	0	1	21	0	0
13	12482650	.	A	C	17	10	27	0	2	29	0	0
13	12485035	.	G	A	15	13	28	0	1	29	0	0
13	12489232	.	G	A	6	4	10	0	0	10	0	0
13	12489360	.	A	G	2	10	12	0	0	12	0	0
13	12489553	.	T	A	3	2	5	0	1	6	0	0
13	12632260	.	A	G	10	0	10	0	14	24	0	0
13	12632946	.	T	A	9	7	16	0	1	17	0	0
13	12632967	.	T	C	6	7	13	0	0	13	0	0
13	12633014	.	C	G	3	4	7	0	1	8	0	0
13	12633376	.	T	A	3	3	6	0	0	6	0	0
13	12633387	.	C	A	2	3	5	0	1	6	0	0
13	12635974	.	T	C	1	3	4	0	1	5	0	0
13	12657744	.	T	G	3	2	5	0	0	5	0	0
13	12664917	.	T	C	2	3	5	0	0	5	0	0
13	12665126	.	A	G	9	4	13	2	1	16	0	0
13	12665328	.	C	A	2	3	5	0	2	7	0	0
13	12665411	.	T	A	2	3	5	0	0	5	0	0
13	12665546	.	T	C	7	8	15	0	2	17	0	0
13	12665587	.	C	T	1	7	8	0	9	17	0	0
13	12665699	.	T	C	4	2	6	0	2	8	0	0
13	12665704	.	T	C	5	2	7	0	0	7	0	0
13	12665945	.	A	C	7	6	13	0	0	13	0	0
13	12665963	.	A	G	6	4	10	0	0	10	0	0
13	12665990	.	C	A	6	2	8	0	0	8	0	0
13	12666017	.	T	C	7	1	8	0	2	10	0	0
13	12666183	.	G	A	3	7	10	0	1	11	0	0
13	12666362	.	A	G	3	3	6	0	2	8	0	0
13	12675939	.	A	G	4	2	6	0	0	6	0	0
13	12681150	.	T	C	2	4	6	0	0	6	0	0
13	12739444	.	G	T	2	6	8	0	1	9	0	0
13	12739555	.	A	G	3	3	6	0	0	6	0	0
13	12739630	.	C	G	2	0	2	0	4	6	0	0
13	12739894	.	T	A	3	2	5	0	0	5	0	0
13	12740113	.	A	T	4	5	9	0	2	11	0	0
13	12740263	.	T	G	13	0	13	0	4	17	0	0
13	12740566	.	A	G	6	13	19	0	0	19	0	0
13	12740599	.	C	T	6	14	20	0	2	22	0	0
13	12740674	.	G	A	12	8	20	0	1	21	0	0
13	12740782	.	C	T	8	14	22	0	0	22	0	0
13	12740794	.	G	A	0	14	14	0	8	22	0	0
13	12740971	.	T	G	12	18	30	0	0	30	0	0
13	12762350	.	G	A	3	2	5	0	0	5	0	0
13	12762978	.	C	T	2	3	5	0	0	5	0	0
13	12765738	.	T	G	5	6	11	0	2	13	0	0
13	12834071	.	G	A	1	2	3	0	0	3	0	0
13	12868447	.	T	C	1	2	3	0	0	3	0	0
13	12868492	.	A	G	2	5	7	0	0	7	0	0
13	12874972	.	G	A	3	3	6	0	0	6	0	0
13	12875014	.	A	G	2	0	2	0	2	4	0	0
13	12875022	.	A	C	2	2	4	0	0	4	0	0
13	12883634	.	C	T	3	4	7	0	0	7	0	0
13	12883652	.	C	T	3	3	6	0	1	7	0	0
13	12883703	.	G	A	2	1	3	0	3	6	0	0
13	12899383	.	C	T	2	3	5	0	0	5	0	0
13	12902958	.	C	T	3	2	5	0	0	5	0	0
13	12904675	.	G	C	2	3	5	0	1	6	0	0
13	12904726	.	G	A	7	3	10	0	0	10	0	0
13	12904744	.	G	T	7	5	12	0	0	12	0	0
13	12904840	.	C	A	1	3	4	0	0	4	0	0
13	12911384	.	G	A	0	3	3	0	4	7	0	0
13	12916199	.	A	G	3	4	7	0	1	8	0	0
13	12917382	.	C	T	4	4	8	0	0	8	0	0
13	12918191	.	T	C	4	7	11	0	1	12	0	0
13	12918194	.	T	C	4	7	11	0	2	13	0	0
13	12919196	.	C	T	4	4	8	0	0	8	0	0
13	12920645	.	A	C	6	3	9	0	0	9	0	0
13	12920651	.	A	T	5	5	10	0	0	10	0	0
13	12940138	.	C	T	6	4	10	0	1	11	0	0
13	12943630	.	G	A	6	9	15	0	0	15	0	0
13	12949644	.	A	G	8	0	8	0	6	14	0	0
13	12949674	.	T	G	10	5	15	0	0	15	0	0
13	12955278	.	T	C	5	9	14	0	0	14	0	0
13	12955413	.	C	T	8	7	15	0	0	15	0	0
13	12955615	.	T	C	6	8	14	0	1	15	0	0
13	12957817	.	G	A	9	21	30	0	0	30	0	0
13	12961126	.	T	A	15	16	31	0	1	32	0	0
13	12961141	.	C	T	12	12	24	0	0	24	0	0
13	12962979	.	G	A	0	9	9	0	7	16	0	0
13	12967432	.	G	C	9	12	21	0	3	24	0	0
13	12967438	.	C	T	8	14	22	0	0	22	0	0
13	12970797	.	C	T	10	16	26	0	0	26	0	0
13	12971757	.	A	C	9	21	30	0	0	30	0	0
13	12971763	.	A	G	9	1	10	0	21	31	0	0
13	12971856	.	G	A	20	14	34	0	0	34	0	0
13	12974602	.	A	G	19	17	36	0	0	36	0	0
13	12985114	.	C	T	18	18	36	0	0	36	0	0
13	12985193	.	T	A	15	15	30	0	1	31	0	0
13	12985376	.	G	A	3	13	16	0	24	40	0	0
13	12985822	.	T	G	12	5	17	2	0	19	0	0
13	12994199	.	C	A	5	3	8	0	0	8	0	0
13	12994364	.	A	G	7	7	14	0	0	14	0	0
13	12994395	.	A	G	5	7	12	0	1	13	0	0
13	12994738	.	A	T	13	8	21	0	1	22	0	0
13	12994801	.	A	G	11	10	21	0	1	22	0	0
13	12994802	.	G	T	11	10	21	0	1	22	0	0
13	12997845	.	C	T	6	10	16	0	2	18	0	0
13	12997966	.	A	G	4	7	11	0	1	12	0	0
13	12999701	.	G	T	5	6	11	0	0	11	0	0
13	13011804	.	A	G	3	3	6	0	1	7	0	0
13	13012030	.	G	C	1	2	3	0	0	3	0	0
13	13019148	.	C	T	4	3	7	0	1	8	0	0
13	13026758	.	G	C	2	2	4	0	0	4	0	0
13	13027068	.	A	C	1	2	3	0	0	3	0	0
13	13052481	.	A	C	3	7	10	0	0	10	0	0
13	13052741	.	C	T	1	2	3	0	0	3	0	0
13	13052831	.	G	A	0	3	3	0	4	7	0	0
13	13074974	.	T	G	5	0	5	0	6	11	0	0
13	13075034	.	T	C	5	3	8	0	0	8	0	0
13	13091046	.	C	A	7	3	10	0	0	10	0	0
13	13091079	.	T	C	6	6	12	0	2	14	0	0
13	13094050	.	T	A	5	4	9	0	1	10	0	0
13	13213678	.	A	G	3	5	8	0	0	8	0	0
13	13214279	.	C	A	3	2	5	0	0	5	0	0
13	13214412	.	G	A	7	9	16	0	1	17	0	0
13	13214462	.	T	A	11	11	22	0	0	22	0	0
13	13215426	.	T	G	4	4	8	0	0	8	0	0
13	13215937	.	A	G	2	1	3	0	0	3	0	0
13	13215942	.	G	A	2	2	4	0	1	5	0	0
13	13215984	.	T	C	1	6	7	0	1	8	0	0
13	13216092	.	G	A	7	3	10	0	0	10	0	0
13	13216251	.	G	A	6	4	10	0	0	10	0	0
13	13216381	.	T	A	4	5	9	0	0	9	0	0
13	13216424	.	T	C	1	0	1	0	3	4	0	0
13	13221482	.	C	T	1	2	3	0	0	3	0	0
13	13693781	.	A	T	10	10	20	0	1	21	0	0
13	13697957	.	G	A	0	4	4	0	12	16	0	0
13	13698411	.	T	C	15	9	24	0	0	24	0	0
13	13698433	.	T	C	15	7	22	0	0	22	0	0
13	13700335	.	A	C	10	5	15	0	0	15	0	0
13	13704011	.	T	G	14	11	25	0	0	25	0	0
13	13713106	.	C	G	19	6	25	0	0	25	0	0
13	13724919	.	T	A	21	8	29	0	0	29	0	0
13	13737474	.	G	C	34	18	52	0	0	52	0	0
13	13737514	.	A	G	36	1	37	0	15	52	0	0
13	13737524	.	G	A	37	16	53	0	1	54	0	0
13	13737612	.	G	C	3	17	20	0	33	53	0	0
13	13771020	.	G	A	2	3	5	0	0	5	0	0
13	13796754	.	A	C	9	4	13	0	0	13	0	0
13	13824580	.	A	G	1	3	4	0	0	4	0	0
13	13882099	.	T	C	2	5	7	0	0	7	0	0
13	13882367	.	A	C	1	6	7	0	0	7	0	0
13	13913140	.	G	C	1	4	5	0	9	14	0	0
13	13917991	.	C	T	8	6	14	0	1	15	0	0
13	13933605	.	G	T	5	6	11	0	0	11	0	0
13	13938461	.	G	A	0	4	4	0	2	6	0	0
13	13942151	.	T	C	3	4	7	0	0	7	0	0
13	13943959	.	T	C	4	5	9	0	1	10	0	0
13	13943983	.	A	G	5	5	10	0	0	10	0	0
13	13982700	.	A	G	5	2	7	0	1	8	0	0
13	13988395	.	A	C	1	3	4	0	0	4	0	0
13	13988647	.	G	A	2	4	6	0	0	6	0	0
13	13997101	.	C	T	3	2	5	0	0	5	0	0
13	13997299	.	C	T	5	6	11	0	0	11	0	0
13	13997481	.	T	C	3	4	7	0	0	7	0	0
13	13997536	.	T	C	3	4	7	0	0	7	0	0
13	13997545	.	G	A	4	4	8	0	0	8	0	0
13	13999037	.	A	T	2	2	4	0	0	4	0	0
13	14002979	.	G	T	7	2	9	0	0	9	0	0
13	14003099	.	A	G	9	4	13	0	0	13	0	0
13	14004161	.	T	C	9	6	15	0	1	16	0	0
13	14004209	.	C	T	9	4	13	0	1	14	0	0
13	14004276	.	C	T	6	3	9	0	0	9	0	0
13	14023838	.	G	A	0	2	2	0	2	4	0	0
13	14092489	.	C	T	5	5	10	0	0	10	0	0
13	14092573	.	G	A	5	4	9	0	1	10	0	0
13	14094441	.	G	A	6	2	8	0	2	10	0	0
13	14098156	.	T	C	3	2	5	0	1	6	0	0
13	14104076	.	T	C	5	4	9	0	1	10	0	0
13	14137061	.	C	T	6	10	16	0	2	18	0	0
13	14181750	.	C	T	12	9	21	0	0	21	0	0
13	14181952	.	T	C	6	7	13	0	1	14	0	0
13	14190780	.	C	T	1	11	12	0	22	34	0	0
13	14191033	.	T	C	10	11	21	0	1	22	0	0
13	14191045	.	G	C	13	12	25	0	0	25	0	0
13	14191528	.	A	G	15	11	26	0	0	26	0	0
13	14191553	.	A	G	18	7	25	0	1	26	0	0
13	14191724	.	G	A	20	5	25	0	3	28	0	0
13	14191769	.	T	C	25	11	36	0	2	38	0	0
13	14191797	.	A	G	21	14	35	0	0	35	0	0
13	14192110	.	T	C	11	11	22	0	1	23	0	0
13	14192131	.	G	A	9	16	25	0	0	25	0	0
13	14192178	.	A	T	5	17	22	0	0	22	0	0
13	14192414	.	A	G	5	10	15	0	0	15	0	0
13	14192448	.	A	C	6	14	20	0	0	20	0	0
13	14192506	.	G	A	7	8	15	0	0	15	0	0
13	14192511	.	A	T	8	7	15	0	0	15	0	0
13	14192561	.	G	T	7	4	11	0	0	11	0	0
13	14194055	.	C	G	6	7	13	0	8	21	0	0
13	14194109	.	C	G	1	4	5	0	1	6	0	0
13	14194110	.	C	A	1	4	5	0	1	6	0	0
13	14194484	.	C	T	8	12	20	0	2	22	0	0
13	14194571	.	G	A	12	10	22	0	0	22	0	0
13	14194573	.	C	A	10	10	20	0	2	22	0	0
13	14194611	.	T	G	9	10	19	0	2	21	0	0
13	14194660	.	G	A	6	10	16	0	0	16	0	0
13	14194904	.	T	C	7	7	14	0	1	15	0	0
13	14199190	.	A	G	12	8	20	0	2	22	0	0
13	14220900	.	G	A	5	7	12	1	1	14	0	0
13	14251280	.	C	T	0	4	4	0	3	7	0	0
13	14487445	.	T	C	3	0	3	0	4	7	0	0
13	14902500	.	C	A	7	5	12	0	0	12	0	0
13	14902507	.	T	C	8	5	13	0	1	14	0	0
13	14902546	.	C	T	7	6	13	0	0	13	0	0
13	14902702	.	G	A	10	4	14	0	1	15	0	0
13	14906587	.	G	C	9	9	18	0	0	18	0	0
13	14906614	.	G	A	9	7	16	0	0	16	0	0
13	14906754	.	A	G	11	5	16	0	1	17	0	0
13	14908880	.	A	G	4	2	6	0	0	6	0	0
13	14908903	.	T	C	4	5	9	0	0	9	0	0
13	14915618	.	A	T	2	3	5	0	0	5	0	0
13	14915669	.	G	A	2	3	5	0	0	5	0	0
13	15109657	.	T	G	4	2	6	0	0	6	0	0
13	15141803	.	A	T	2	5	7	0	0	7	0	0
13	15194509	.	A	G	2	2	4	0	0	4	0	0
13	15210469	.	C	A	2	2	4	0	0	4	0	0
13	15210557	.	C	T	3	2	5	0	0	5	0	0
13	15212395	.	G	T	3	3	6	0	0	6	0	0
13	15212460	.	G	C	0	2	2	0	1	3	0	0
13	15212749	.	A	G	4	0	4	0	3	7	0	0
13	15212962	.	T	A	4	4	8	0	0	8	0	0
13	15213130	.	A	T	3	2	5	0	1	6	0	0
13	15213441	.	C	T	2	2	4	0	0	4	0	0
13	15215789	.	A	T	14	20	34	0	1	35	0	0
13	15580864	.	T	A	16	14	30	0	2	32	0	0
13	15580879	.	T	G	17	0	17	0	15	32	0	0
13	15580948	.	G	T	12	9	21	0	2	23	0	0
13	15647444	.	A	G	13	13	26	0	0	26	0	0
13	15657987	.	A	G	25	24	49	0	3	52	0	0
13	15668124	.	A	T	7	8	15	0	1	16	0	0
13	15696717	.	T	G	1	2	3	0	0	3	0	0
13	15725435	.	C	G	2	0	2	0	3	5	0	0
13	15762306	.	T	C	1	0	1	0	3	4	0	0
13	15762320	.	A	C	1	5	6	0	0	6	0	0
13	15762515	.	T	C	5	9	14	0	0	14	0	0
13	15763061	.	G	T	2	5	7	0	0	7	0	0
13	15763233	.	T	C	2	0	2	0	3	5	0	0
13	15763733	.	T	C	5	3	8	0	0	8	0	0
13	15778124	.	T	C	3	1	4	0	3	7	0	0
13	15778128	.	C	T	3	3	6	0	1	7	0	0
13	15800977	.	T	G	5	4	9	0	0	9	0	0
13	15801705	.	T	A	4	15	19	0	0	19	0	0
13	15801726	.	T	C	2	12	14	0	0	14	0	0
13	15814429	.	A	G	8	9	17	1	0	19	1	0
13	15814724	.	T	A	2	5	7	0	0	7	0	0
13	15816637	.	G	A	18	12	30	0	0	30	0	0
13	15848817	.	A	G	16	12	28	0	0	28	0	0
13	15848901	.	A	G	19	8	27	1	2	30	0	0
13	15849541	.	T	C	22	13	35	0	0	35	0	0
13	15869322	.	A	G	16	23	39	1	0	40	0	0
13	15872256	.	A	G	18	25	43	0	0	43	0	0
13	15880940	.	T	G	22	24	46	0	0	46	0	0
13	15882860	.	A	C	25	17	42	1	2	45	0	0
13	15897090	.	C	T	2	4	6	0	0	6	0	0
13	15897108	.	A	G	1	4	5	0	0	5	0	0
13	15897141	.	A	G	3	4	7	0	0	7	0	0
13	15928805	.	T	C	3	2	5	0	0	5	0	0
13	15929121	.	C	A	1	5	6	0	0	6	0	0
13	15929182	.	G	A	2	3	5	1	0	6	0	0
13	16186182	.	G	A	6	4	10	0	0	10	0	0
13	16186209	.	T	C	6	0	6	0	9	15	0	0
13	16191517	.	A	T	9	4	13	0	0	13	0	0
13	16191580	.	A	G	9	3	12	0	1	13	0	0
13	16300670	.	T	C	1	3	4	0	0	4	0	0
13	16311465	.	A	G	1	3	4	0	0	4	0	0
13	16326333	.	G	T	2	4	6	0	0	6	0	0
13	16413366	.	T	C	4	3	7	0	0	7	0	0
13	16420480	.	T	A	5	3	8	1	1	10	0	0
13	16420799	.	A	G	2	6	8	0	0	8	0	0
13	16425241	.	C	T	5	4	9	0	0	9	0	0
13	16425350	.	T	C	6	2	8	0	0	8	0	0
13	16428604	.	T	C	4	3	7	0	0	7	0	0
13	16436353	.	C	T	2	4	6	0	1	7	0	0
13	16436524	.	A	G	2	4	6	0	3	9	0	0
13	16436531	.	A	G	2	0	2	0	6	8	0	0
13	16436686	.	C	T	1	2	3	0	2	5	0	0
13	16436786	.	T	C	4	5	9	0	0	9	0	0
13	16448511	.	G	A	0	4	4	0	3	7	0	0
13	16474382	.	A	G	4	0	4	0	10	14	0	0
13	16479914	.	T	A	12	6	18	0	0	18	0	0
13	16496254	.	T	C	7	5	12	0	0	12	0	0
13	16496770	.	T	A	12	10	22	0	1	24	1	0
13	16522533	.	C	G	2	2	4	0	0	4	0	0
13	16522880	.	C	T	5	6	11	0	0	11	0	0
13	16759638	.	A	G	4	3	7	0	0	7	0	0
13	16809610	.	T	C	6	9	15	0	0	15	0	0
13	16852953	.	G	A	8	8	16	0	1	17	0	0
13	16855387	.	C	A	6	10	16	0	0	16	0	0
13	16856045	.	T	A	10	10	20	0	0	20	0	0
13	16871830	.	A	C	9	8	17	0	1	18	0	0
13	16878895	.	A	C	15	16	31	0	5	36	0	0
13	16886040	.	C	T	15	13	28	1	0	29	0	0
13	16886068	.	C	T	12	10	22	0	0	22	0	0
13	17702657	.	C	T	4	4	8	0	0	8	0	0
13	17702802	.	C	T	8	5	13	0	0	13	0	0
13	17703097	.	A	G	4	1	5	0	7	12	0	0
13	17703308	.	G	A	6	4	10	0	0	10	0	0
13	17703453	.	T	A	12	5	17	0	1	18	0	0
13	17703454	.	C	A	11	5	16	0	1	17	0	0
13	17703548	.	C	T	9	7	16	0	0	16	0	0
13	17703557	.	G	C	1	6	7	0	9	16	0	0
13	17705633	.	C	T	10	8	18	0	1	19	0	0
13	17705669	.	C	T	9	14	23	0	0	23	0	0
13	17705681	.	C	T	16	12	28	0	0	28	0	0
13	17714510	.	G	T	21	29	50	0	1	52	1	0
13	17714530	.	C	A	33	19	52	0	4	57	1	0
13	17714881	.	C	T	19	21	40	0	6	46	0	0
13	17714905	.	T	C	26	19	45	0	1	46	0	0
13	17752932	.	A	T	11	5	16	0	0	16	0	0
13	17752993	.	C	A	8	8	16	0	1	17	0	0
13	17753104	.	C	T	4	2	6	0	0	6	0	0
13	17754275	.	G	T	8	6	14	0	0	14	0	0
13	17754510	.	T	C	2	2	4	1	1	6	0	0
13	17754571	.	C	G	3	5	8	1	0	9	0	0
13	17754794	.	T	C	1	0	1	0	7	8	0	0
13	17754897	.	C	T	1	8	9	0	2	11	0	0
13	17755618	.	T	C	8	5	13	0	0	13	0	0
13	17755743	.	G	A	4	7	11	0	0	11	0	0
13	17755898	.	G	A	7	4	11	0	0	11	0	0
13	17755980	.	G	A	8	5	13	0	0	13	0	0
13	17756043	.	G	A	4	8	12	0	0	12	0	0
13	17781556	.	A	G	6	2	8	0	0	8	0	0
13	17800661	.	T	C	5	0	5	0	5	10	0	0
13	17943175	.	G	T	4	3	7	0	1	8	0	0
13	18011158	.	G	T	3	4	7	0	0	7	0	0
13	18019724	.	T	C	3	3	6	0	0	6	0	0
13	18019758	.	C	T	0	2	2	0	2	4	0	0
13	18019786	.	C	T	0	2	2	0	5	7	0	0
13	18032872	.	C	T	0	3	3	0	6	9	0	0
13	18032941	.	A	G	4	4	8	0	0	8	0	0
13	18032960	.	G	A	4	4	8	0	0	8	0	0
13	18033053	.	A	G	3	3	6	0	1	7	0	0
13	18038643	.	G	A	2	2	4	0	0	4	0	0
13	18069338	.	C	A	4	2	6	0	0	6	0	0
13	18073433	.	A	G	12	13	25	0	0	25	0	0
13	18073460	.	C	T	17	12	29	0	2	31	0	0
13	18073557	.	C	A	8	7	15	0	1	16	0	0
13	18073706	.	G	A	11	10	21	0	1	22	0	0
13	18076710	.	T	G	8	9	17	0	1	18	0	0
13	18076722	.	G	T	10	11	21	0	0	21	0	0
13	18076818	.	G	A	13	8	21	0	2	23	0	0
13	18077056	.	G	T	21	11	32	0	2	34	0	0
13	18077116	.	G	A	16	11	27	0	1	28	0	0
13	18077206	.	C	T	16	14	30	0	1	31	0	0
13	18083210	.	G	T	7	14	21	0	0	21	0	0
13	18083415	.	G	A	9	5	14	0	1	15	0	0
13	18087918	.	G	A	10	8	18	0	0	18	0	0
13	18088276	.	T	G	8	12	20	0	0	20	0	0
13	18088283	.	C	T	1	9	10	0	10	20	0	0
13	18092062	.	G	T	2	7	9	0	1	10	0	0
13	18102984	.	A	G	4	3	7	0	0	7	0	0
13	18104881	.	C	T	1	4	5	0	7	12	0	0
13	18104890	.	C	T	4	6	10	0	0	10	0	0
13	18105007	.	A	G	4	5	9	1	0	10	0	0
13	18105023	.	T	G	5	5	10	1	0	11	0	0
13	18105136	.	C	A	0	5	5	1	4	10	0	0
13	18105175	.	G	A	5	2	7	1	1	9	0	0
13	18105382	.	A	G	4	2	6	0	0	6	0	0
13	18110003	.	T	C	7	0	7	0	5	12	0	0
13	18110284	.	C	T	0	3	3	0	5	8	0	0
13	18119378	.	C	G	1	6	7	0	0	7	0	0
13	18119488	.	T	C	5	4	9	0	1	10	0	0
13	18119489	.	C	T	6	4	10	0	0	10	0	0
13	18179151	.	C	A	5	2	7	0	0	7	0	0
13	18179500	.	G	C	6	2	8	0	0	8	0	0
13	18179733	.	T	A	16	11	27	0	4	31	0	0
13	18179859	.	C	A	13	18	31	0	1	32	0	0
13	18189874	.	G	A	5	5	10	0	1	11	0	0
13	18276559	.	G	C	1	3	4	0	0	4	0	0
13	18295212	.	C	T	1	5	6	0	0	6	0	0
13	18295423	.	G	A	0	5	5	0	4	9	0	0
13	18295468	.	C	T	6	4	10	0	1	11	0	0
13	18295680	.	T	C	5	6	11	0	0	11	0	0
13	18321156	.	T	C	15	5	20	0	1	21	0	0
13	18323464	.	A	G	8	10	18	0	2	20	0	0
13	18323595	.	G	A	2	11	13	0	21	34	0	0
13	18323653	.	A	G	20	1	21	0	12	33	0	0
13	18323787	.	T	A	14	11	25	0	1	26	0	0
13	18358680	.	G	A	17	9	26	0	0	26	0	0
13	18358890	.	G	C	14	23	37	0	0	37	0	0
13	18359112	.	G	C	11	15	26	0	0	26	0	0
13	18359176	.	C	A	24	13	37	0	1	38	0	0
13	18359202	.	C	T	17	9	26	0	1	27	0	0
13	18359507	.	A	T	7	7	14	0	0	14	0	0
13	18359551	.	T	C	3	8	11	0	0	11	0	0
13	18359554	.	A	G	3	8	11	0	0	11	0	0
13	18375465	.	C	A	2	3	5	0	0	5	0	0
13	18375512	.	T	A	2	6	8	0	1	9	0	0
13	18382192	.	T	C	4	2	6	0	0	6	0	0
13	18385497	.	C	T	1	6	7	0	1	8	0	0
13	18385749	.	G	A	0	3	3	0	3	6	0	0
13	18394755	.	T	A	11	9	20	0	0	20	0	0
13	18397416	.	G	C	3	6	9	0	0	9	0	0
13	18401308	.	C	T	3	4	7	0	0	7	0	0
13	18410799	.	G	C	1	3	4	0	2	6	0	0
13	18418390	.	C	T	2	6	8	0	2	10	0	0
13	18418528	.	G	A	10	7	17	0	0	17	0	0
13	18428103	.	A	G	17	12	29	0	0	29	0	0
13	18431301	.	C	T	5	14	19	0	0	19	0	0
13	18431430	.	C	T	7	6	13	0	1	14	0	0
13	18434075	.	A	G	2	0	2	0	6	8	0	0
13	18434085	.	C	T	3	5	8	0	1	9	0	0
13	18434150	.	T	C	7	7	14	0	0	14	0	0
13	18434427	.	C	T	5	10	15	0	1	16	0	0
13	18434519	.	C	A	6	7	13	0	1	14	0	0
13	18434520	.	G	C	0	7	7	0	7	14	0	0
13	18434570	.	C	G	16	5	21	0	0	21	0	0
13	18434615	.	A	G	15	0	15	0	8	23	0	0
13	18434794	.	C	A	10	6	16	0	1	17	0	0
13	18434902	.	C	T	6	10	16	0	1	17	0	0
13	18434957	.	G	A	3	7	10	0	1	11	0	0
13	18434962	.	A	G	3	7	10	0	0	10	0	0
13	18499590	.	A	C	2	2	4	0	0	4	0	0
13	18499660	.	C	T	5	2	7	0	1	8	0	0
13	18499747	.	C	T	2	3	5	0	0	5	0	0
13	18499773	.	A	T	3	3	6	0	0	6	0	0
13	18503647	.	C	T	1	1	2	0	1	3	0	0
13	18507715	.	A	C	12	12	24	0	0	24	0	0
13	18509592	.	G	A	1	11	12	0	8	20	0	0
13	18510033	.	C	G	16	0	16	0	10	26	0	0
13	18510204	.	T	C	7	13	20	0	0	20	0	0
13	18510324	.	A	G	8	16	24	0	0	24	0	0
13	18511023	.	C	T	12	17	29	0	2	31	0	0
13	18511140	.	A	G	16	0	16	0	13	29	0	0
13	18511637	.	A	C	11	5	16	0	2	19	1	0
13	18512082	.	C	G	11	16	27	0	1	28	0	0
13	18663103	.	G	A	4	2	6	0	0	6	0	0
13	18663156	.	G	A	1	5	6	0	2	8	0	0
13	18669200	.	G	T	10	16	26	0	1	27	0	0
13	18680027	.	G	A	5	8	13	0	1	15	1	0
13	18685673	.	G	A	5	11	16	0	0	16	0	0
13	18689043	.	C	T	13	8	21	0	1	22	0	0
13	18801566	.	G	A	5	5	10	0	0	10	0	0
13	18801615	.	G	A	6	3	9	0	0	9	0	0
13	18863177	.	C	A	0	3	3	0	1	4	0	0
13	19304688	.	A	G	18	18	36	0	0	36	0	0
13	19316930	.	G	C	9	12	21	0	1	22	0	0
13	19317016	.	T	A	4	7	11	0	1	12	0	0
13	19317018	.	C	G	4	8	12	0	0	12	0	0
13	19317051	.	T	G	4	9	13	0	0	13	0	0
13	19317499	.	G	C	8	5	13	0	1	14	0	0
13	19610625	.	C	T	2	2	4	0	3	7	0	0
13	19627150	.	A	G	5	4	9	0	0	9	0	0
13	19627266	.	A	C	1	5	6	0	0	6	0	0
13	19629266	.	C	G	5	3	8	0	0	8	0	0
13	19639198	.	A	G	4	2	6	0	0	6	0	0
13	19639205	.	G	A	4	3	7	0	1	8	0	0
13	19639238	.	T	C	1	5	6	0	2	8	0	0
13	19639256	.	T	C	3	0	3	0	6	9	0	0
13	19768396	.	G	T	10	16	26	3	0	29	0	0
13	19799192	.	A	G	11	14	25	1	2	28	0	0
13	19799467	.	G	A	10	10	20	0	1	21	0	0
13	19799611	.	C	A	1	15	16	0	7	23	0	0
13	19799623	.	T	C	14	8	22	0	2	24	0	0
13	19799646	.	C	A	1	11	12	0	14	26	0	0
13	20053641	.	C	T	2	2	4	0	0	4	0	0
13	20392670	.	G	C	10	0	10	0	12	22	0	0
13	20392704	.	G	A	13	12	25	0	0	25	0	0
13	20392714	.	G	T	16	10	26	0	1	27	0	0
13	20392788	.	A	G	18	11	29	0	1	30	0	0
13	20401263	.	C	A	3	19	22	0	20	42	0	0
13	20401267	.	T	C	16	21	37	0	6	43	0	0
13	20401392	.	C	T	15	16	31	0	2	33	0	0
13	20425191	.	A	G	6	6	12	0	0	12	0	0
13	20425396	.	C	T	1	9	10	0	12	22	0	0
13	20518608	.	A	T	5	8	13	0	1	14	0	0
13	20518620	.	C	T	1	7	8	0	5	13	0	0
13	20518757	.	G	A	3	4	7	0	1	8	0	0
13	21638955	.	C	A	9	4	13	0	0	13	0	0
13	21639011	.	G	C	1	7	8	0	0	8	0	0
13	21674509	.	T	C	4	2	6	0	0	6	0	0
13	21677961	.	G	A	7	2	9	0	0	9	0	0
13	21680844	.	A	T	2	5	7	0	0	8	1	0
13	21683057	.	A	C	4	5	9	0	0	9	0	0
13	21683068	.	T	A	5	2	7	0	0	7	0	0
13	21683546	.	C	T	13	14	27	0	1	28	0	0
13	21683636	.	G	A	14	19	33	0	1	34	0	0
13	21683762	.	C	T	4	9	13	0	20	33	0	0
13	21683928	.	G	A	23	24	47	0	1	48	0	0
13	21689373	.	G	A	6	2	8	0	0	8	0	0
13	21689883	.	T	G	5	14	19	0	1	20	0	0
13	21689982	.	G	A	3	5	8	0	0	8	0	0
13	21690053	.	T	A	1	4	5	0	0	5	0	0
13	21690104	.	C	T	1	3	4	0	5	9	0	0
13	21690229	.	A	C	9	6	15	0	0	15	0	0
13	21690507	.	T	A	6	14	20	0	2	22	0	0
13	21690877	.	A	C	7	0	7	0	8	15	0	0
13	21691386	.	G	A	4	2	6	0	0	6	0	0
13	21691609	.	C	T	2	2	4	0	1	5	0	0
13	21691671	.	G	A	3	7	10	0	1	11	0	0
13	21691695	.	T	A	6	5	11	0	0	11	0	0
13	21691787	.	C	G	9	12	21	0	0	21	0	0
13	21691843	.	G	A	7	8	15	0	0	15	0	0
13	21691935	.	A	G	11	4	15	0	0	15	0	0
13	21692084	.	T	A	6	5	11	0	1	12	0	0
13	21692085	.	C	A	6	5	11	0	0	11	0	0
13	21692328	.	C	A	7	6	13	0	0	13	0	0
13	21692338	.	C	T	7	9	16	0	0	16	0	0
13	21712507	.	G	A	11	19	30	0	0	30	0	0
13	21712526	.	G	A	10	17	27	0	2	29	0	0
13	21712755	.	G	C	8	13	21	0	1	22	0	0
13	21716581	.	T	C	7	7	14	0	0	14	0	0
13	21722470	.	G	A	4	18	22	0	2	24	0	0
13	21723323	.	G	A	3	11	14	0	0	14	0	0
13	21723514	.	G	C	9	7	16	0	2	18	0	0
13	21725457	.	T	A	10	4	14	0	0	14	0	0
13	21727796	.	T	A	3	8	11	0	1	12	0	0
13	21735278	.	C	T	2	2	4	0	1	5	0	0
13	21739036	.	A	T	4	3	7	0	0	7	0	0
13	21776082	.	A	G	2	0	2	0	4	6	0	0
13	21818449	.	G	A	2	3	5	0	1	6	0	0
13	21818472	.	C	A	3	4	7	0	1	8	0	0
13	21818793	.	C	T	2	2	4	0	0	4	0	0
13	21819629	.	A	T	2	3	5	0	0	5	0	0
13	21819997	.	G	A	2	3	5	0	0	5	0	0
13	21820499	.	C	T	1	2	3	0	0	3	0	0
13	21820802	.	A	T	8	3	11	0	0	11	0	0
13	21821299	.	G	T	2	3	5	0	0	5	0	0
13	21826203	.	G	T	1	3	4	0	0	4	0	0
13	21851617	.	C	T	1	3	4	0	0	4	0	0
13	21852008	.	G	A	0	3	3	0	3	6	0	0
13	21856576	.	A	T	8	3	11	0	0	11	0	0
13	21856849	.	G	A	0	2	2	0	2	4	0	0
13	21860111	.	G	A	2	5	7	0	0	7	0	0
13	21861775	.	A	C	5	6	11	0	3	14	0	0
13	21861777	.	G	A	9	6	15	0	0	15	0	0
13	21862288	.	T	A	7	8	15	0	1	16	0	0
13	21866052	.	C	T	6	4	10	0	0	10	0	0
13	21866324	.	C	T	4	5	9	0	0	9	0	0
13	21866357	.	A	C	8	7	15	0	1	16	0	0
13	21870319	.	G	C	7	5	12	0	1	13	0	0
13	21870323	.	T	C	7	4	11	0	1	12	0	0
13	21870374	.	G	A	1	7	8	0	14	22	0	0
13	21870467	.	G	C	0	20	20	0	14	34	0	0
13	21870575	.	A	G	16	1	17	0	17	34	0	0
13	21870608	.	A	T	9	15	24	0	2	26	0	0
13	21870629	.	C	T	15	12	27	0	1	28	0	0
13	21874107	.	C	T	21	10	31	1	0	32	0	0
13	21874128	.	G	T	13	16	29	1	1	31	0	0
13	21874149	.	G	T	2	13	15	1	17	33	0	0
13	21884298	.	C	T	16	17	33	0	1	34	0	0
13	21884407	.	T	C	6	12	18	0	1	19	0	0
13	21884408	.	C	T	6	11	17	0	1	19	1	0
13	21884467	.	C	T	10	6	16	0	1	17	0	0
13	21884979	.	T	C	11	6	17	0	1	18	0	0
13	21884980	.	C	T	12	5	17	0	1	18	0	0
13	21885250	.	C	T	15	21	36	0	1	37	0	0
13	21888330	.	A	C	1	2	3	0	0	3	0	0
13	21888331	.	A	T	1	2	3	0	0	3	0	0
13	22065089	.	G	A	2	7	9	0	0	9	0	0
13	22065148	.	G	A	0	9	9	0	3	12	0	0
13	22065793	.	A	G	2	0	2	0	4	6	0	0
13	22065904	.	T	G	3	6	9	0	0	9	0	0
13	22084034	.	C	T	8	9	17	0	0	17	0	0
13	22087988	.	C	T	4	19	23	0	0	23	0	0
13	22088061	.	T	G	5	0	5	0	11	16	0	0
13	22088105	.	G	A	9	15	24	0	0	24	0	0
13	22094800	.	T	C	7	10	17	0	0	17	0	0
13	22094871	.	T	G	3	14	17	0	0	17	0	0
13	22095340	.	C	T	5	13	18	0	1	19	0	0
13	22095589	.	G	A	3	9	12	0	1	13	0	0
13	22095594	.	T	A	4	6	10	0	1	11	0	0
13	22119935	.	T	C	12	14	26	1	0	27	0	0
13	22206667	.	A	T	23	8	31	0	1	32	0	0
13	22238209	.	T	C	19	15	34	0	0	34	0	0
13	22238233	.	G	A	18	14	32	0	0	32	0	0
13	22241027	.	G	A	28	17	45	0	0	45	0	0
13	22241123	.	G	T	1	12	13	0	22	35	0	0
13	22241374	.	A	C	21	19	40	0	4	44	0	0
13	22241482	.	G	C	15	11	26	0	2	28	0	0
13	22241648	.	T	G	14	26	40	0	3	43	0	0
13	22241821	.	T	C	28	9	37	0	1	38	0	0
13	22242394	.	C	G	22	25	47	0	0	47	0	0
13	22242837	.	T	G	25	22	47	0	0	47	0	0
13	22316792	.	A	G	1	0	1	0	5	6	0	0
13	22317347	.	A	G	2	3	5	0	0	5	0	0
13	22328560	.	G	A	1	4	5	0	0	5	0	0
13	22328575	.	C	T	1	5	6	0	0	6	0	0
13	22340444	.	C	T	5	3	8	0	0	8	0	0
13	22340456	.	G	A	6	2	8	0	0	8	0	0
13	22347506	.	C	T	4	2	6	0	0	6	0	0
13	22351910	.	A	G	2	4	6	0	0	6	0	0
13	22357105	.	C	A	5	6	11	0	0	11	0	0
13	22357236	.	T	G	5	9	14	0	1	15	0	0
13	22357823	.	C	T	3	5	8	0	1	9	0	0
13	22357850	.	A	G	2	0	2	0	7	9	0	0
13	22358021	.	A	G	7	5	12	0	0	12	0	0
13	22358174	.	G	A	1	7	8	0	9	17	0	0
13	22361332	.	G	A	5	7	12	0	2	14	0	0
13	22361718	.	A	C	6	7	13	0	0	13	0	0
13	22364908	.	T	C	8	18	26	0	0	26	0	0
13	22365016	.	C	T	22	15	37	0	1	38	0	0
13	22365404	.	C	T	14	8	22	0	0	22	0	0
13	22365461	.	A	G	10	11	21	0	5	26	0	0
13	22367600	.	C	A	13	14	27	0	2	29	0	0
13	22369295	.	T	C	5	15	20	0	0	20	0	0
13	22372075	.	T	C	20	13	33	0	1	34	0	0
13	22372154	.	T	C	13	26	39	0	0	39	0	0
13	22372175	.	A	G	9	27	36	0	2	38	0	0
13	22372205	.	A	G	13	19	32	0	2	34	0	0
13	22372737	.	C	T	11	8	19	0	1	20	0	0
13	22373241	.	G	A	0	15	15	0	18	33	0	0
13	22373336	.	C	A	14	12	26	0	0	28	2	0
13	22373931	.	C	T	6	8	14	0	1	15	0	0
13	22373940	.	A	G	4	9	13	0	2	15	0	0
13	22602420	.	G	A	1	2	3	0	0	3	0	0
13	22602422	.	G	A	1	2	3	0	0	3	0	0
13	22617913	.	T	G	1	0	1	0	2	3	0	0
13	22618320	.	A	G	2	0	2	0	1	3	0	0
13	22618393	.	T	A	3	3	6	0	0	6	0	0
13	22659195	.	C	G	14	1	15	0	17	32	0	0
13	22672354	.	A	T	28	20	48	0	3	51	0	0
13	22672952	.	G	A	4	9	13	0	2	15	0	0
13	22673006	.	A	C	3	6	9	0	0	9	0	0
13	22673068	.	A	T	4	8	12	0	1	13	0	0
13	22679537	.	C	G	2	3	5	0	0	5	0	0
13	22679837	.	G	A	5	3	8	0	0	8	0	0
13	22683416	.	A	T	7	2	9	0	0	9	0	0
13	22688510	.	G	A	3	3	6	0	0	6	0	0
13	22705687	.	G	A	2	3	5	0	1	6	0	0
13	22705697	.	G	A	3	1	4	0	0	4	0	0
13	22712773	.	T	C	4	2	6	0	0	6	0	0
13	22714987	.	A	T	1	2	3	0	0	3	0	0
13	22735063	.	T	C	5	4	9	0	0	9	0	0
13	22735139	.	A	G	9	6	15	0	2	17	0	0
13	22742791	.	G	A	7	10	17	0	0	17	0	0
13	22744359	.	A	G	7	8	15	0	0	15	0	0
13	22866026	.	A	G	1	3	4	0	0	4	0	0
13	22867888	.	G	A	1	3	4	0	12	16	0	0
13	22867910	.	A	G	9	4	13	0	0	13	0	0
13	22867953	.	G	T	3	4	7	0	1	8	0	0
13	22868017	.	G	A	5	2	7	0	1	8	0	0
13	22871989	.	A	G	2	4	6	0	0	6	0	0
13	22872433	.	A	G	2	2	4	0	0	4	0	0
13	22872862	.	A	G	1	3	4	0	0	4	0	0
13	22876576	.	T	C	7	0	7	0	8	15	0	0
13	22876623	.	G	A	7	11	18	0	0	18	0	0
13	22876678	.	A	T	4	6	10	0	1	11	0	0
13	22877076	.	C	T	16	8	24	0	0	24	0	0
13	22877130	.	G	T	18	11	29	0	1	30	0	0
13	22878754	.	G	A	16	19	35	0	4	39	0	0
13	22879149	.	A	T	11	7	18	0	1	19	0	0
13	22890835	.	A	C	17	0	17	0	18	35	0	0
13	22898042	.	A	G	15	15	30	0	0	30	0	0
13	22900733	.	G	A	8	13	21	0	0	21	0	0
13	22900742	.	A	T	7	14	21	0	0	21	0	0
13	22902882	.	A	C	9	6	15	0	0	15	0	0
13	22902987	.	G	A	11	5	16	0	0	16	0	0
13	22925915	.	G	T	1	3	4	0	0	4	0	0
13	22970533	.	A	G	1	0	1	0	2	3	0	0
13	22970534	.	T	C	1	2	3	0	0	3	0	0
13	22970688	.	T	C	1	2	3	0	0	3	0	0
13	22970750	.	T	C	2	2	4	0	0	4	0	0
13	22971227	.	C	T	1	2	3	0	0	3	0	0
13	22973314	.	A	G	30	22	52	0	1	53	0	0
13	22973348	.	A	G	26	23	49	0	0	49	0	0
13	22973531	.	T	C	24	2	26	0	23	49	0	0
13	22973895	.	A	G	28	16	44	0	0	44	0	0
13	22974033	.	A	G	27	27	54	0	2	56	0	0
13	22974108	.	C	T	31	15	46	0	0	46	0	0
13	22976067	.	C	A	21	18	39	0	1	40	0	0
13	22976070	.	G	A	19	18	37	0	1	38	0	0
13	22976383	.	T	C	14	0	14	0	19	33	0	0
13	22977283	.	G	A	21	24	45	0	4	49	0	0
13	22977319	.	A	G	26	22	48	0	0	48	0	0
13	22977343	.	A	G	19	21	40	0	1	41	0	0
13	22978059	.	T	C	21	0	21	0	18	39	0	0
13	22978062	.	G	A	21	16	37	0	1	38	0	0
13	22983106	.	A	G	6	17	23	0	0	23	0	0
13	22983109	.	A	G	7	16	23	0	1	24	0	0
13	23002697	.	G	A	2	5	7	0	0	7	0	0
13	23007677	.	A	G	2	2	4	0	1	5	0	0
13	23037831	.	C	A	8	6	14	0	0	14	0	0
13	23042676	.	A	G	5	11	16	0	0	16	0	0
13	23042745	.	G	A	12	5	17	0	0	17	0	0
13	23043112	.	T	C	2	3	5	0	0	5	0	0
13	23043117	.	A	G	2	4	6	0	0	6	0	0
13	23045229	.	G	A	7	2	9	0	0	9	0	0
13	23064735	.	T	C	6	5	11	0	1	12	0	0
13	23070787	.	C	T	3	2	5	0	0	5	0	0
13	23070895	.	T	C	9	5	14	0	3	17	0	0
13	23084177	.	C	G	20	13	33	2	3	38	0	0
13	23084841	.	G	C	11	13	24	0	0	24	0	0
13	23090190	.	A	C	15	18	33	0	0	33	0	0
13	23094356	.	T	C	8	0	8	0	12	20	0	0
13	23094895	.	G	T	14	12	26	1	2	29	0	0
13	23107928	.	T	C	1	2	3	0	0	3	0	0
13	23117009	.	A	G	1	3	4	0	0	4	0	0
13	23128675	.	A	G	3	0	3	0	2	5	0	0
13	23128685	.	A	G	2	2	4	0	0	4	0	0
13	23169172	.	G	T	1	1	2	0	1	3	0	0
13	23196207	.	C	T	5	6	11	0	3	14	0	0
13	23201307	.	T	A	4	6	10	0	0	10	0	0
13	23204849	.	A	C	6	8	14	0	1	15	0	0
13	23211195	.	A	T	11	4	15	0	1	16	0	0
13	23212821	.	A	G	10	9	19	0	1	20	0	0
13	23223122	.	A	G	2	3	5	0	0	5	0	0
13	23223158	.	G	T	3	2	5	0	0	5	0	0
13	23223469	.	T	A	7	5	12	0	0	12	0	0
13	23223486	.	C	T	7	5	12	0	0	12	0	0
13	23223567	.	C	T	7	4	11	0	1	12	0	0
13	23223572	.	C	T	8	3	11	0	2	13	0	0
13	23223875	.	C	A	5	3	8	0	0	8	0	0
13	23224087	.	G	A	5	5	10	0	0	10	0	0
13	23224360	.	A	G	9	5	14	0	0	14	0	0
13	23224363	.	T	G	9	5	14	0	0	14	0	0
13	23224427	.	C	T	10	5	15	0	0	15	0	0
13	23224470	.	G	A	9	7	16	0	0	16	0	0
13	23224605	.	G	T	9	7	16	0	1	17	0	0
13	23224727	.	C	T	6	8	14	0	0	14	0	0
13	23224735	.	A	G	6	8	14	0	1	15	0	0
13	23224821	.	T	A	10	9	19	0	0	19	0	0
13	23224860	.	T	A	16	12	28	0	0	28	0	0
13	23225541	.	T	C	11	9	20	0	0	20	0	0
13	23225776	.	T	A	11	8	19	0	0	19	0	0
13	23226114	.	G	A	1	13	14	1	8	23	0	0
13	23234621	.	C	A	7	2	9	0	0	9	0	0
13	23234675	.	C	A	2	2	4	0	0	4	0	0
13	23234680	.	C	T	2	2	4	0	0	4	0	0
13	23241260	.	A	G	2	2	4	0	1	5	0	0
13	23314904	.	T	G	9	14	23	1	0	24	0	0
13	23382393	.	G	A	14	6	20	0	0	20	0	0
13	23382572	.	T	C	19	25	44	0	0	44	0	0
13	23387252	.	T	C	6	13	19	0	0	19	0	0
13	23669870	.	T	G	6	3	9	0	2	11	0	0
13	23669916	.	C	A	2	8	10	0	0	10	0	0
13	23675183	.	C	T	7	4	11	0	0	11	0	0
13	23675510	.	T	C	3	6	9	0	0	9	0	0
13	23675892	.	G	C	0	7	7	0	4	11	0	0
13	23676856	.	G	A	0	4	4	0	6	10	0	0
13	23676913	.	C	A	10	5	15	0	0	15	0	0
13	23678001	.	G	A	2	4	6	0	2	8	0	0
13	23678024	.	T	C	6	2	8	0	0	8	0	0
13	23679546	.	G	A	0	5	5	0	6	11	0	0
13	23679888	.	G	A	6	4	10	0	0	10	0	0
13	23685075	.	G	A	4	3	7	0	0	7	0	0
13	23685301	.	G	A	2	4	6	0	1	7	0	0
13	23685361	.	T	G	7	0	7	0	3	10	0	0
13	23692515	.	C	T	9	11	20	0	1	21	0	0
13	23692572	.	C	T	11	10	21	0	0	21	0	0
13	23703048	.	G	C	13	10	23	0	0	23	0	0
13	23703053	.	T	C	13	7	20	0	2	22	0	0
13	23709532	.	C	T	10	10	20	0	1	21	0	0
13	23709562	.	T	C	13	17	30	0	1	31	0	0
13	23709592	.	A	G	17	17	34	0	0	34	0	0
13	23711937	.	G	A	14	24	38	2	3	43	0	0
13	23728490	.	T	A	4	2	6	0	2	8	0	0
13	23730801	.	G	A	5	7	12	0	0	12	0	0
13	23876610	.	A	G	2	0	2	0	2	4	0	0
13	23876697	.	T	C	1	3	4	0	0	4	0	0
13	23876784	.	C	T	1	3	4	0	0	4	0	0
13	23882377	.	A	G	1	3	4	0	0	4	0	0
13	23882615	.	T	C	6	7	13	0	2	15	0	0
13	23882629	.	T	C	8	5	13	0	0	13	0	0
13	23882686	.	C	T	7	3	10	0	0	10	0	0
13	23882946	.	A	G	1	2	3	0	0	3	0	0
13	23882952	.	C	G	0	2	2	0	1	3	0	0
13	23898045	.	T	G	15	16	31	0	2	33	0	0
13	23901334	.	C	T	11	8	19	0	1	20	0	0
13	23901349	.	T	C	12	11	23	0	0	23	0	0
13	23901502	.	A	G	8	11	19	0	0	19	0	0
13	23901555	.	A	G	10	1	11	0	7	18	0	0
13	23901570	.	T	C	9	8	17	0	1	18	0	0
13	23920791	.	A	G	16	10	26	0	0	26	0	0
13	23931192	.	T	C	4	1	5	0	5	10	0	0
13	23940708	.	T	C	6	1	7	0	12	19	0	0
13	23940754	.	C	A	2	14	16	0	0	16	0	0
13	23943040	.	T	G	7	4	11	0	0	11	0	0
13	23999129	.	G	A	2	6	8	0	0	8	0	0
13	23999264	.	G	C	6	6	12	0	0	12	0	0
13	23999274	.	T	A	5	7	12	0	0	12	0	0
13	24000394	.	G	A	8	3	11	0	0	11	0	0
13	24014578	.	T	C	3	2	5	0	0	5	0	0
13	24023036	.	G	T	5	4	9	0	0	9	0	0
13	24033958	.	G	T	1	5	6	0	1	7	0	0
13	24034158	.	A	G	5	4	9	0	0	9	0	0
13	24034206	.	A	G	4	4	8	0	1	9	0	0
13	24034215	.	G	A	3	3	6	0	0	6	0	0
13	24045342	.	C	T	4	5	9	0	0	9	0	0
13	24046953	.	G	A	1	4	5	0	4	9	0	0
13	24056221	.	C	T	6	13	19	0	0	19	0	0
13	24068790	.	C	T	2	19	21	0	2	23	0	0
13	24069624	.	C	A	14	6	20	0	1	21	0	0
13	24069902	.	A	T	8	15	23	0	1	24	0	0
13	24070242	.	C	T	0	10	10	0	7	17	0	0
13	24070730	.	C	T	5	8	13	0	2	15	0	0
13	24096437	.	G	T	8	4	12	0	0	12	0	0
13	24234815	.	C	A	7	3	10	0	0	10	0	0
13	24275663	.	G	A	0	6	6	0	4	10	0	0
13	24292398	.	G	A	6	5	11	0	0	11	0	0
13	24292419	.	G	A	6	5	11	0	1	12	0	0
13	24292796	.	T	A	12	12	24	0	0	24	0	0
13	24292800	.	A	T	12	12	24	0	0	24	0	0
13	24292866	.	C	A	4	11	15	0	11	26	0	0
13	24293162	.	C	A	18	15	33	0	0	33	0	0
13	24293218	.	T	A	21	11	32	0	0	32	0	0
13	24293220	.	G	C	21	11	32	0	1	33	0	0
13	24293448	.	A	G	20	15	35	0	1	36	0	0
13	24293465	.	C	T	4	12	16	0	20	36	0	0
13	24293615	.	G	A	12	20	32	0	7	39	0	0
13	24293691	.	G	A	14	14	28	0	0	28	0	0
13	24293698	.	C	T	15	11	26	0	0	26	0	0
13	24293940	.	G	A	9	16	25	0	1	26	0	0
13	24294046	.	A	G	8	15	23	0	1	24	0	0
13	24296013	.	C	T	6	5	11	0	0	11	0	0
13	24296215	.	C	T	0	2	2	0	2	4	0	0
13	24296312	.	G	A	1	1	2	0	0	2	0	0
13	24296430	.	C	A	5	6	11	0	0	11	0	0
13	24303667	.	C	A	12	9	21	0	0	21	0	0
13	24305975	.	T	G	5	13	18	0	0	18	0	0
13	24309321	.	A	T	4	8	12	0	1	13	0	0
13	24372197	.	C	T	5	2	7	0	0	7	0	0
13	24372392	.	A	G	1	2	3	0	0	3	0	0
13	24372771	.	C	T	2	3	5	0	0	5	0	0
13	24372900	.	A	C	1	0	1	0	2	3	0	0
13	24372943	.	C	T	1	3	4	0	0	4	0	0
13	24373003	.	G	A	4	3	7	0	0	7	0	0
13	24373081	.	A	G	1	2	3	0	0	3	0	0
13	24378833	.	C	A	0	2	2	0	3	5	0	0
13	24378834	.	G	T	3	2	5	0	0	5	0	0
13	24378978	.	A	T	2	3	5	0	0	5	0	0
13	24379015	.	A	G	5	2	7	0	0	7	0	0
13	24382510	.	C	A	3	4	7	0	0	7	0	0
13	24382539	.	T	C	7	4	11	0	0	11	0	0
13	24382578	.	G	A	5	6	11	0	1	12	0	0
13	24383589	.	T	G	1	2	3	0	0	3	0	0
13	24384282	.	G	C	1	5	6	0	0	6	0	0
13	24384425	.	A	T	11	8	19	0	0	19	0	0
13	24384807	.	G	A	7	3	10	0	0	10	0	0
13	24387484	.	G	T	8	5	13	0	0	13	0	0
13	24395371	.	A	G	2	4	6	0	0	6	0	0
13	24395373	.	G	A	6	2	8	0	0	8	0	0
13	24401824	.	T	G	2	3	5	0	0	5	0	0
13	24401860	.	A	C	1	2	3	0	0	3	0	0
13	24402490	.	G	A	0	9	9	0	11	20	0	0
13	24402560	.	T	C	5	8	13	0	2	15	0	0
13	24411553	.	T	C	20	11	31	0	2	33	0	0
13	24423602	.	C	T	0	2	2	0	2	4	0	0
13	24424014	.	C	T	3	4	7	0	0	7	0	0
13	24424511	.	A	C	1	0	1	0	3	4	0	0
13	24424724	.	T	C	4	4	8	0	0	8	0	0
13	24424875	.	C	A	4	6	10	0	0	10	0	0
13	24425019	.	G	A	3	6	9	0	1	10	0	0
13	24425112	.	T	C	1	0	1	0	3	4	0	0
13	24425133	.	G	A	2	3	5	0	0	5	0	0
13	24431784	.	T	G	11	25	36	0	1	37	0	0
13	24432162	.	G	C	6	14	20	0	3	23	0	0
13	24432212	.	T	C	13	0	13	0	12	25	0	0
13	24432350	.	C	T	1	15	16	0	11	27	0	0
13	24436054	.	G	A	10	5	15	0	0	15	0	0
13	24437225	.	G	A	4	11	15	0	1	16	0	0
13	24447364	.	G	C	6	5	11	0	0	11	0	0
13	24519762	.	T	C	2	2	4	0	0	4	0	0
13	24519798	.	G	A	0	2	2	0	1	3	0	0
13	24519911	.	G	A	1	3	4	0	0	4	0	0
13	24519921	.	G	T	0	3	3	0	1	4	0	0
13	24520311	.	C	T	2	2	4	0	0	4	0	0
13	24521173	.	C	A	1	3	4	0	1	5	0	0
13	24521292	.	T	C	5	2	7	0	0	7	0	0
13	24521927	.	G	A	3	3	6	0	0	6	0	0
13	24522570	.	G	T	3	6	9	0	1	10	0	0
13	24523321	.	G	A	5	8	13	0	0	15	2	0
13	24523425	.	A	G	3	3	6	0	1	7	0	0
13	24524206	.	G	A	7	4	11	0	0	11	0	0
13	24579187	.	A	T	14	18	32	0	1	33	0	0
13	24580372	.	G	A	15	20	35	1	2	38	0	0
13	24580411	.	G	A	17	21	38	1	0	39	0	0
13	24580441	.	A	G	20	0	20	0	11	31	0	0
13	24580705	.	C	T	12	12	24	0	0	24	0	0
13	24580869	.	T	C	11	12	23	0	0	23	0	0
13	24580941	.	T	C	13	8	21	0	1	22	0	0
13	24581274	.	G	A	20	18	38	0	0	38	0	0
13	24581316	.	C	A	21	16	37	0	3	40	0	0
13	24581334	.	G	C	22	18	40	0	0	40	0	0
13	24581358	.	T	C	23	19	42	0	1	43	0	0
13	24581748	.	A	C	11	13	24	0	2	26	0	0
13	24581798	.	T	A	13	5	18	0	1	19	0	0
13	24581840	.	T	G	15	14	29	0	2	31	0	0
13	24581854	.	C	T	19	17	36	0	1	37	0	0
13	24581982	.	G	A	1	24	25	0	8	33	0	0
13	24582047	.	A	G	10	15	25	0	1	26	0	0
13	24582110	.	C	T	11	9	20	0	0	20	0	0
13	24582122	.	T	C	9	8	17	0	0	17	0	0
13	24582211	.	C	T	3	4	7	0	1	8	0	0
13	24663625	.	C	A	2	2	4	0	0	4	0	0
13	24663828	.	C	A	2	1	3	0	1	4	0	0
13	24665869	.	C	T	4	4	8	0	0	8	0	0
13	24702092	.	C	T	10	7	17	0	0	17	0	0
13	24702180	.	A	T	6	2	8	0	0	8	0	0
13	24702198	.	T	C	5	3	8	0	0	8	0	0
13	24702275	.	C	T	2	4	6	0	1	7	0	0
13	24702383	.	G	A	8	10	18	0	0	18	0	0
13	24702415	.	T	C	5	8	13	0	0	13	0	0
13	24702743	.	C	T	7	4	11	0	0	11	0	0
13	24702822	.	A	C	11	11	22	0	1	23	0	0
13	24702883	.	A	T	10	8	18	0	0	18	0	0
13	24702974	.	T	C	4	9	13	0	0	13	0	0
13	24702996	.	G	A	6	9	15	0	0	15	0	0
13	24703319	.	C	T	2	6	8	0	2	10	0	0
13	24703325	.	A	T	2	6	8	0	1	9	0	0
13	24703354	.	C	A	5	2	7	0	0	7	0	0
13	24703362	.	C	A	4	1	5	0	1	6	0	0
13	24703827	.	T	C	1	1	2	0	0	2	0	0
13	24704032	.	A	G	2	2	4	0	0	4	0	0
13	24704102	.	C	A	6	4	10	0	0	10	0	0
13	24704191	.	A	T	7	3	10	0	2	12	0	0
13	24716363	.	T	C	6	3	9	0	1	10	0	0
13	24716375	.	A	T	6	4	10	0	1	11	0	0
13	24733743	.	A	G	1	2	3	0	0	3	0	0
13	24733749	.	A	G	1	2	3	0	0	3	0	0
13	24742835	.	G	A	2	2	4	0	0	4	0	0
13	24742836	.	T	A	1	2	3	0	1	4	0	0
13	24745024	.	T	C	2	2	4	0	0	4	0	0
13	24745049	.	G	T	1	2	3	0	0	3	0	0
13	24781605	.	T	C	17	9	26	0	2	28	0	0
13	24785591	.	C	A	18	14	32	0	0	32	0	0
13	24804224	.	G	C	2	5	7	0	0	7	0	0
13	24804321	.	T	C	2	4	6	0	0	6	0	0
13	24804765	.	C	T	2	3	5	0	1	6	0	0
13	24805068	.	A	C	4	6	10	0	1	11	0	0
13	24805257	.	T	C	1	0	1	0	5	6	0	0
13	24825972	.	G	A	1	2	3	0	0	3	0	0
13	24826248	.	C	A	0	2	2	0	3	5	0	0
13	24834358	.	A	G	15	5	20	0	0	20	0	0
13	24836958	.	C	T	12	7	19	0	0	19	0	0
13	24837246	.	T	C	4	10	14	0	0	14	0	0
13	24837253	.	T	A	4	11	15	0	0	15	0	0
13	24837392	.	A	G	18	9	27	0	3	30	0	0
13	24837407	.	T	A	22	8	30	0	0	30	0	0
13	24871485	.	C	T	13	11	24	0	0	24	0	0
13	24872733	.	G	A	4	10	14	0	0	14	0	0
13	24873141	.	C	A	0	11	11	0	9	20	0	0
13	24873186	.	A	T	9	4	13	0	0	13	0	0
13	24873267	.	G	A	16	11	27	0	0	27	0	0
13	24873480	.	A	G	9	9	18	0	0	18	0	0
13	24873579	.	C	T	5	6	11	0	0	11	0	0
13	24873597	.	G	T	5	5	10	0	2	12	0	0
13	24873990	.	A	G	7	12	19	0	1	20	0	0
13	24873995	.	T	G	6	11	17	0	0	17	0	0
13	24874837	.	A	G	9	6	15	0	1	16	0	0
13	24874894	.	T	A	8	12	20	0	0	20	0	0
13	24874934	.	A	G	8	7	15	0	0	15	0	0
13	24905815	.	G	A	6	4	10	0	0	10	0	0
13	24919010	.	C	A	5	4	9	0	0	9	0	0
13	24919317	.	C	T	7	3	10	0	0	10	0	0
13	24919428	.	G	A	10	3	13	0	0	13	0	0
13	24920098	.	C	T	9	7	16	0	1	17	0	0
13	24986203	.	G	A	7	6	13	0	3	16	0	0
13	24986238	.	G	T	6	7	13	0	0	13	0	0
13	24986272	.	T	C	5	0	5	0	5	10	0	0
13	25204704	.	T	C	2	3	5	0	0	5	0	0
13	25207064	.	G	C	3	1	4	0	0	4	0	0
13	25207068	.	C	T	3	3	6	0	0	6	0	0
13	25207368	.	A	G	1	4	5	0	0	5	0	0
13	25208501	.	G	T	3	5	8	0	0	8	0	0
13	25208545	.	T	A	1	3	4	0	0	4	0	0
13	25212540	.	C	A	2	2	4	0	0	4	0	0
13	25212657	.	A	G	2	6	8	0	0	8	0	0
13	25284312	.	A	C	1	0	1	0	2	3	0	0
13	25364846	.	T	A	5	3	8	0	0	8	0	0
13	25364915	.	A	T	4	4	8	0	0	8	0	0
13	25366749	.	T	A	6	3	9	0	0	9	0	0
13	25369165	.	C	T	13	6	19	0	0	19	0	0
13	25369449	.	C	T	3	5	8	0	1	9	0	0
13	25371436	.	A	G	6	8	14	0	1	15	0	0
13	25372806	.	G	A	14	9	23	0	2	25	0	0
13	25378590	.	G	A	2	15	17	0	12	30	1	0
13	25378924	.	T	G	11	6	17	0	0	17	0	0
13	25379263	.	A	T	16	13	29	0	1	30	0	0
13	25379304	.	A	G	10	1	11	0	11	22	0	0
13	25379352	.	A	C	6	9	15	0	1	16	0	0
13	25383915	.	C	T	7	4	11	1	0	12	0	0
13	25384145	.	A	G	2	10	12	0	2	14	0	0
13	25384223	.	A	G	9	12	21	0	0	21	0	0
13	25386904	.	C	T	6	10	16	0	0	16	0	0
13	25388389	.	G	A	9	4	13	0	1	14	0	0
13	25388644	.	T	C	5	7	12	0	5	17	0	0
13	25388658	.	T	A	5	9	14	0	2	16	0	0
13	25388708	.	G	T	5	7	12	0	0	12	0	0
13	25403606	.	G	A	1	3	4	0	0	4	0	0
13	25428952	.	C	G	10	11	21	0	0	21	0	0
13	25429048	.	T	A	3	9	12	0	2	14	0	0
13	25429079	.	C	T	9	4	13	0	2	15	0	0
13	25429145	.	G	A	9	4	13	0	0	13	0	0
13	25436336	.	A	T	10	11	21	0	0	21	0	0
13	25436360	.	A	T	10	7	17	0	1	18	0	0
13	25436381	.	G	A	15	3	18	0	2	20	0	0
13	25449867	.	C	A	3	3	6	0	0	6	0	0
13	25472735	.	G	A	21	9	30	0	2	32	0	0
13	25472756	.	T	C	12	17	29	0	3	32	0	0
13	25472859	.	G	A	19	16	35	0	2	37	0	0
13	25473039	.	C	T	26	18	44	0	1	45	0	0
13	25473325	.	G	A	22	16	38	0	2	40	0	0
13	25475889	.	C	T	14	15	29	0	1	30	0	0
13	25475904	.	A	G	13	19	32	0	1	33	0	0
13	25477249	.	G	A	10	16	26	0	0	26	0	0
13	25478749	.	A	T	3	3	6	0	0	6	0	0
13	25484638	.	G	T	15	12	27	0	2	29	0	0
13	25492923	.	A	T	6	7	13	0	0	13	0	0
13	25492992	.	C	G	5	10	15	0	2	17	0	0
13	25497320	.	A	G	9	0	9	0	17	26	0	0
13	25497575	.	T	C	5	6	11	0	0	11	0	0
13	25497581	.	C	T	5	6	11	0	1	12	0	0
13	25497700	.	G	C	8	8	16	0	0	16	0	0
13	25497880	.	T	C	5	9	14	0	0	14	0	0
13	25516204	.	T	C	2	5	7	0	0	7	0	0
13	25519063	.	G	A	1	4	5	0	5	10	0	0
13	25523608	.	C	T	6	2	8	0	0	8	0	0
13	25523629	.	T	C	4	5	9	0	0	9	0	0
13	25523677	.	G	A	0	3	3	0	6	9	0	0
13	25530063	.	C	T	4	10	14	0	1	15	0	0
13	25532352	.	C	T	13	17	30	0	1	31	0	0
13	25532509	.	T	A	18	14	32	0	0	32	0	0
13	25532574	.	C	A	18	11	29	0	1	30	0	0
13	25532706	.	T	C	11	4	15	0	1	16	0	0
13	25533175	.	T	C	15	19	34	0	0	34	0	0
13	25533233	.	G	A	15	14	29	0	1	30	0	0
13	25533258	.	T	A	11	15	26	0	1	27	0	0
13	25533657	.	C	G	9	1	10	0	11	21	0	0
13	25534165	.	T	C	10	6	16	0	1	17	0	0
13	25534407	.	C	T	13	18	31	0	2	33	0	0
13	25534787	.	A	G	2	2	4	0	0	4	0	0
13	25549516	.	A	G	3	0	3	0	5	8	0	0
13	25551781	.	C	A	4	2	6	0	0	6	0	0
13	25551865	.	T	C	4	2	6	0	1	8	1	0
13	25552219	.	T	C	6	4	10	0	0	10	0	0
13	25554553	.	T	G	3	0	3	0	2	5	0	0
13	25559610	.	G	A	3	7	10	0	0	10	0	0
13	25560416	.	C	T	3	8	11	0	0	11	0	0
13	25563221	.	C	A	8	5	13	0	0	13	0	0
13	25565379	.	T	C	5	13	18	0	0	19	1	0
13	25566025	.	A	T	5	2	7	0	0	7	0	0
13	25566205	.	A	T	6	4	10	0	1	11	0	0
13	25566222	.	C	T	7	3	10	0	0	10	0	0
13	25569865	.	A	G	3	6	9	0	0	9	0	0
13	25569874	.	A	G	4	8	12	0	1	13	0	0
13	25569940	.	A	C	8	4	12	0	3	15	0	0
13	25570008	.	T	C	8	4	12	0	1	13	0	0
13	25570013	.	C	T	8	4	12	0	1	13	0	0
13	25570104	.	C	T	5	9	14	0	0	14	0	0
13	25570108	.	T	A	4	9	13	0	1	14	0	0
13	25570341	.	T	C	3	0	3	0	5	8	0	0
13	25570427	.	T	A	15	8	23	0	0	23	0	0
13	25570561	.	A	C	3	5	8	0	0	8	0	0
13	25570715	.	C	T	6	10	16	0	0	16	0	0
13	25571113	.	A	T	3	3	6	0	0	6	0	0
13	25571274	.	C	T	8	8	16	0	1	17	0	0
13	25573189	.	G	A	6	2	8	0	1	9	0	0
13	25575396	.	C	T	6	5	11	0	2	13	0	0
13	25575411	.	A	C	5	5	10	0	1	11	0	0
13	25575453	.	G	A	7	7	14	0	0	14	0	0
13	25584993	.	A	T	2	2	4	0	0	4	0	0
13	25586289	.	G	A	1	2	3	0	0	3	0	0
13	25586448	.	G	A	2	5	7	0	0	7	0	0
13	25589241	.	G	A	4	4	8	0	0	8	0	0
13	25724747	.	G	A	3	7	10	0	1	11	0	0
13	25726378	.	C	G	2	3	5	0	1	6	0	0
13	25728037	.	G	A	5	8	13	0	0	13	0	0
13	25728453	.	A	C	1	3	4	0	1	5	0	0
13	25728606	.	A	T	3	3	6	0	0	6	0	0
13	25728738	.	A	C	3	3	6	0	0	6	0	0
13	25728747	.	A	G	1	2	3	0	0	3	0	0
13	25728836	.	T	C	2	6	8	0	0	8	0	0
13	25729108	.	G	A	3	2	5	0	0	5	0	0
13	25730774	.	C	T	5	3	8	0	0	8	0	0
13	25735128	.	G	A	1	2	3	0	0	3	0	0
13	25740472	.	G	A	1	3	4	0	0	4	0	0
13	25763187	.	A	T	1	2	3	0	0	3	0	0
13	25824616	.	T	A	12	14	26	1	1	28	0	0
13	25824718	.	C	T	17	14	31	0	2	33	0	0
13	25825016	.	G	A	17	18	35	0	1	36	0	0
13	25825263	.	A	T	4	5	9	0	0	9	0	0
13	25826362	.	T	C	8	0	8	0	14	22	0	0
13	25827129	.	T	G	13	9	22	0	2	24	0	0
13	25827421	.	G	A	10	13	23	0	1	24	0	0
13	25846994	.	C	A	10	10	20	0	0	20	0	0
13	25847136	.	T	A	7	8	15	0	0	15	0	0
13	25847144	.	G	T	6	7	13	0	0	13	0	0
13	25847176	.	G	A	11	7	18	0	0	18	0	0
13	25847226	.	T	G	11	6	17	0	0	17	0	0
13	25847297	.	T	A	7	2	9	0	0	9	0	0
13	25847973	.	G	T	3	3	6	0	0	6	0	0
13	25848093	.	T	C	2	2	4	0	0	4	0	0
13	25849234	.	T	G	2	7	9	0	1	10	0	0
13	25849294	.	T	G	3	3	6	0	1	7	0	0
13	25849511	.	T	C	3	0	3	0	2	5	0	0
13	25849572	.	G	A	1	4	5	0	0	5	0	0
13	25850874	.	G	A	4	6	10	0	0	10	0	0
13	25851321	.	G	A	3	3	6	0	0	6	0	0
13	25851332	.	T	A	4	2	6	0	0	6	0	0
13	25851412	.	C	G	4	5	9	0	0	9	0	0
13	25851753	.	C	T	3	5	8	0	0	8	0	0
13	25852558	.	T	A	1	3	4	0	1	5	0	0
13	26186175	.	T	A	1	2	3	0	0	3	0	0
13	26210284	.	A	G	2	2	4	0	0	4	0	0
13	26794324	.	A	G	2	2	4	0	0	4	0	0
13	26796325	.	A	T	1	2	3	0	0	3	0	0
13	26799045	.	T	G	1	2	3	0	0	3	0	0
13	27000394	.	C	T	0	5	5	0	11	16	0	0
13	27036582	.	T	C	6	0	6	0	3	9	0	0
13	27036660	.	T	C	7	11	18	0	0	18	0	0
13	27036766	.	G	A	2	5	7	0	0	7	0	0
13	27036847	.	C	T	6	6	12	0	1	13	0	0
13	27036898	.	T	C	10	8	18	0	0	18	0	0
13	27037942	.	A	G	9	8	17	0	0	17	0	0
13	27042994	.	C	A	1	2	3	0	0	3	0	0
13	27043005	.	C	G	1	2	3	0	0	3	0	0
13	27107520	.	C	T	9	7	16	0	1	17	0	0
13	27189877	.	A	T	6	4	10	0	0	10	0	0
13	27189898	.	C	T	5	6	11	0	0	11	0	0
13	27201606	.	T	C	2	7	9	0	0	9	0	0
13	27204440	.	T	A	14	10	24	0	0	24	0	0
13	27207707	.	G	T	7	14	21	0	0	21	0	0
13	27209754	.	T	C	14	8	22	0	2	25	1	0
13	27209852	.	T	C	17	10	27	0	0	27	0	0
13	27227407	.	C	A	5	5	10	0	0	10	0	0
13	27227449	.	A	G	4	3	7	0	1	8	0	0
13	27296415	.	T	A	3	4	7	0	0	7	0	0
13	27298741	.	A	G	4	2	6	0	0	6	0	0
13	27309080	.	C	T	4	8	12	0	0	12	0	0
13	27309128	.	T	G	5	0	5	0	9	14	0	0
13	27309143	.	C	T	5	9	14	0	0	14	0	0
13	27313044	.	A	C	1	1	2	1	3	6	0	0
13	27313066	.	G	T	3	5	8	1	0	9	0	0
13	27313236	.	A	G	9	5	14	0	0	14	0	0
13	27313258	.	G	T	7	11	18	0	0	18	0	0
13	27313310	.	T	A	3	7	10	0	0	10	0	0
13	27316778	.	G	T	1	2	3	0	0	3	0	0
13	27316874	.	G	T	7	3	10	0	0	10	0	0
13	27317026	.	C	T	23	21	44	0	1	45	0	0
13	27317499	.	C	T	33	17	50	0	0	50	0	0
13	27320574	.	T	C	35	28	63	0	0	63	0	0
13	27320583	.	C	T	30	28	58	0	1	59	0	0
13	27320628	.	T	A	35	20	55	0	4	59	0	0
13	27320849	.	T	C	23	25	48	0	1	49	0	0
13	27320996	.	G	A	6	16	22	0	39	61	0	0
13	27321271	.	G	A	4	21	25	0	34	59	0	0
13	27323970	.	G	A	4	25	29	0	39	68	0	0
13	27632915	.	C	T	4	15	19	0	19	38	0	0
13	27633628	.	G	A	16	18	34	0	2	36	0	0
13	27633833	.	A	G	14	17	31	0	1	32	0	0
13	27633906	.	A	G	17	13	30	0	3	33	0	0
13	27634324	.	T	C	18	15	33	0	2	35	0	0
13	27634634	.	A	G	15	14	29	0	4	33	0	0
13	27634670	.	G	T	17	22	39	0	0	39	0	0
13	27634678	.	G	T	16	23	39	0	1	41	1	0
13	27634726	.	T	C	20	1	21	0	28	49	0	0
13	27634903	.	A	G	12	30	42	0	0	42	0	0
13	27641472	.	T	C	15	14	29	2	0	31	0	0
13	27650537	.	G	A	14	17	31	0	1	32	0	0
13	27653458	.	C	A	2	16	18	0	16	34	0	0
13	27668056	.	G	T	16	15	31	0	1	32	0	0
13	27674408	.	C	T	12	14	26	0	6	32	0	0
13	27677945	.	C	T	0	9	9	0	11	20	0	0
13	27685233	.	G	A	12	7	19	0	4	23	0	0
13	27686259	.	C	T	12	13	25	0	1	26	0	0
13	27686405	.	G	A	22	17	39	0	0	39	0	0
13	27770575	.	T	C	21	6	27	0	0	27	0	0
13	27771607	.	T	G	12	0	12	0	4	16	0	0
13	27776846	.	A	G	13	6	19	0	0	20	1	0
13	27782086	.	C	A	4	11	15	0	0	15	0	0
13	27782297	.	A	G	1	2	3	0	0	3	0	0
13	27782402	.	A	T	5	7	12	0	0	12	0	0
13	27782449	.	T	G	6	4	10	0	1	11	0	0
13	27782480	.	G	A	7	3	10	0	1	11	0	0
13	27951827	.	G	A	3	4	7	0	9	16	0	0
13	27951883	.	A	G	8	0	8	0	11	19	0	0
13	27951989	.	A	C	16	6	22	0	1	24	1	0
13	27952156	.	C	T	17	12	29	0	3	32	0	0
13	27952207	.	G	A	15	15	30	0	0	30	0	0
13	27952330	.	G	T	9	19	28	0	1	29	0	0
13	27952414	.	A	G	16	13	29	0	2	31	0	0
13	27952441	.	G	T	23	17	40	0	1	41	0	0
13	27963912	.	T	C	23	18	41	0	1	42	0	0
13	28009302	.	G	A	1	20	21	0	14	35	0	0
13	28010183	.	G	A	24	27	51	0	7	58	0	0
13	28010572	.	C	A	26	24	50	0	4	54	0	0
13	28062552	.	T	G	14	12	26	0	2	28	0	0
13	28176651	.	T	C	14	15	29	0	2	31	0	0
13	28513036	.	T	C	2	3	5	0	1	6	0	0
13	28561304	.	T	A	7	5	12	0	3	15	0	0
13	28596162	.	C	A	5	2	7	0	0	7	0	0
13	28601876	.	C	A	1	2	3	0	0	3	0	0
13	28618147	.	A	G	5	3	8	0	0	8	0	0
13	28642816	.	A	C	3	5	8	0	0	8	0	0
13	28642825	.	C	A	6	3	9	0	0	9	0	0
13	28643087	.	C	T	4	4	8	0	0	8	0	0
13	28649848	.	A	C	11	9	20	0	2	22	0	0
13	28650239	.	A	T	20	10	30	0	1	31	0	0
13	28650349	.	A	T	12	12	24	0	0	24	0	0
13	28650731	.	A	C	12	4	16	0	13	29	0	0
13	28651214	.	C	A	1	20	21	0	28	49	0	0
13	28651365	.	A	G	19	20	39	0	2	41	0	0
13	28668942	.	G	C	5	3	8	0	0	8	0	0
13	28676034	.	G	A	10	7	17	0	0	17	0	0
13	28676083	.	A	C	5	5	10	0	3	13	0	0
13	28676134	.	G	C	10	7	17	0	0	17	0	0
13	28676241	.	A	G	8	3	11	0	0	11	0	0
13	28676358	.	G	A	4	7	11	0	0	11	0	0
13	28678176	.	C	G	14	6	20	0	0	20	0	0
13	28680634	.	T	A	6	6	12	0	2	14	0	0
13	28680681	.	G	A	8	3	11	0	0	11	0	0
13	28680847	.	T	A	3	7	10	0	0	10	0	0
13	28680879	.	T	C	5	9	14	0	0	14	0	0
13	28694384	.	C	A	11	7	18	0	0	18	0	0
13	28694390	.	C	T	10	4	14	0	1	15	0	0
13	28694447	.	G	A	8	2	10	0	2	12	0	0
13	28732278	.	G	A	1	2	3	0	0	3	0	0
13	28741042	.	A	T	13	17	30	0	2	32	0	0
13	28743835	.	C	T	17	18	35	0	0	35	0	0
13	28744061	.	C	A	8	4	12	0	0	12	0	0
13	28744141	.	A	T	11	5	16	0	0	16	0	0
13	28744159	.	G	A	4	7	11	0	2	13	0	0
13	28744495	.	G	A	2	15	17	0	13	30	0	0
13	28744690	.	C	T	16	15	31	0	3	34	0	0
13	28744775	.	C	T	10	11	21	0	1	22	0	0
13	28744976	.	C	T	3	3	6	0	0	6	0	0
13	28745188	.	G	A	18	9	27	0	1	28	0	0
13	28745899	.	A	G	10	11	21	0	0	21	0	0
13	28745934	.	C	A	10	8	18	0	0	18	0	0
13	28745963	.	C	T	13	8	21	0	0	21	0	0
13	28746033	.	G	A	10	11	21	1	2	24	0	0
13	28746083	.	T	C	2	5	7	0	0	7	0	0
13	28746129	.	T	A	1	2	3	0	0	3	0	0
13	28786409	.	G	A	8	5	13	0	2	15	0	0
13	28786555	.	G	A	2	7	9	0	0	9	0	0
13	28786583	.	A	G	1	5	6	0	0	6	0	0
13	28848209	.	C	G	9	10	19	1	1	21	0	0
13	28848220	.	G	A	12	13	25	1	0	26	0	0
13	28848473	.	C	T	11	11	22	0	0	22	0	0
13	28865700	.	T	C	21	18	39	0	5	44	0	0
13	28866413	.	A	T	26	16	42	0	1	43	0	0
13	28866485	.	A	G	13	22	35	0	2	37	0	0
13	28866553	.	A	G	21	23	44	0	0	44	0	0
13	28866810	.	G	A	21	18	39	0	3	42	0	0
13	28867071	.	G	T	26	15	41	0	1	42	0	0
13	28867159	.	G	A	6	26	32	0	25	57	0	0
13	28867367	.	C	T	29	16	45	0	3	48	0	0
13	28870698	.	A	T	30	25	55	1	2	58	0	0
13	28870917	.	T	C	33	29	62	0	4	66	0	0
13	28871055	.	T	C	23	28	51	0	1	52	0	0
13	28901463	.	T	A	32	22	54	0	1	55	0	0
13	28901957	.	A	G	13	24	37	0	0	37	0	0
13	28901996	.	T	C	15	20	35	0	1	36	0	0
13	28902169	.	C	T	22	18	40	0	0	40	0	0
13	28902170	.	C	G	22	18	40	0	0	40	0	0
13	28902215	.	T	C	25	17	42	0	0	42	0	0
13	29226749	.	C	T	1	1	2	0	0	2	0	0
13	29296096	.	G	C	1	2	3	0	1	4	0	0
13	29298856	.	G	T	0	2	2	0	2	4	0	0
13	29300574	.	A	G	2	0	2	0	3	5	0	0
13	29341522	.	C	T	6	6	12	0	0	12	0	0
13	29347034	.	A	G	3	7	10	0	2	12	0	0
13	29347156	.	G	A	1	2	3	0	5	8	0	0
13	29347170	.	G	A	7	2	9	0	0	9	0	0
13	29347265	.	T	A	4	3	7	0	0	7	0	0
13	29347745	.	A	C	4	13	17	0	0	17	0	0
13	29374153	.	G	A	0	3	3	0	4	7	0	0
13	29374165	.	G	A	6	3	9	0	1	10	0	0
13	29381011	.	C	T	6	5	11	0	0	11	0	0
13	29385831	.	G	A	7	5	12	0	1	13	0	0
13	29392261	.	G	A	12	8	20	0	2	22	0	0
13	29395207	.	C	A	6	11	17	0	0	17	0	0
13	29395236	.	C	T	9	11	20	0	2	22	0	0
13	29402681	.	A	C	14	13	27	0	1	28	0	0
13	29403953	.	A	C	15	7	22	0	3	25	0	0
13	29404003	.	G	A	10	14	24	0	1	25	0	0
13	29404323	.	G	T	17	21	38	0	3	41	0	0
13	29404576	.	A	G	16	22	38	0	1	39	0	0
13	29404633	.	C	T	25	18	43	0	0	43	0	0
13	29404660	.	T	G	22	1	23	0	20	43	0	0
13	29404809	.	G	A	1	2	3	0	5	8	0	0
13	29404832	.	A	T	5	2	7	0	0	7	0	0
13	29407196	.	C	T	10	7	17	0	0	17	0	0
13	29407397	.	C	A	0	7	7	0	6	13	0	0
13	29407802	.	T	G	8	10	18	0	1	19	0	0
13	29408009	.	G	T	2	5	7	1	0	8	0	0
13	29408052	.	G	T	8	7	15	0	0	15	0	0
13	29408192	.	T	A	6	7	13	0	3	16	0	0
13	29408226	.	T	C	12	7	19	0	0	19	0	0
13	29408499	.	G	A	10	10	20	0	0	20	0	0
13	29408530	.	C	T	10	3	13	0	0	13	0	0
13	29408677	.	T	A	12	12	24	0	0	24	0	0
13	29409265	.	C	T	1	9	10	0	5	15	0	0
13	29409530	.	G	A	16	8	24	0	0	24	0	0
13	29409558	.	G	A	13	7	20	0	1	21	0	0
13	29411895	.	T	G	7	4	11	0	0	11	0	0
13	29412299	.	G	A	6	9	15	0	2	17	0	0
13	29412379	.	G	T	10	8	18	0	0	18	0	0
13	29414482	.	A	T	5	7	12	0	1	13	0	0
13	29414509	.	G	A	8	9	17	0	0	17	0	0
13	29414546	.	A	G	12	8	20	0	2	22	0	0
13	29415184	.	A	T	8	9	17	0	1	18	0	0
13	29416798	.	A	T	11	8	19	0	0	19	0	0
13	29417091	.	G	A	11	10	21	0	0	21	0	0
13	29417792	.	T	C	4	5	9	0	1	10	0	0
13	29417814	.	G	A	2	2	4	0	0	4	0	0
13	29420849	.	A	T	3	4	7	0	0	7	0	0
13	29422112	.	G	A	1	2	3	0	0	3	0	0
13	29422511	.	T	A	8	4	12	0	0	12	0	0
13	29450479	.	T	C	2	3	5	0	0	5	0	0
13	29455199	.	C	T	3	2	5	0	0	5	0	0
13	29455573	.	A	G	3	2	5	0	0	5	0	0
13	29485762	.	A	C	1	0	1	0	2	3	0	0
13	29802607	.	C	A	9	10	19	0	3	22	0	0
13	29802633	.	A	G	4	5	9	0	2	11	0	0
13	29803253	.	C	T	6	4	10	0	0	10	0	0
13	29803801	.	G	A	5	3	8	0	0	8	0	0
13	29803832	.	T	C	6	2	8	0	0	8	0	0
13	29804075	.	T	C	3	2	5	0	0	5	0	0
13	29804800	.	G	A	2	2	4	0	0	4	0	0
13	30009021	.	T	A	8	4	12	0	0	12	0	0
13	31925701	.	A	G	3	6	9	0	1	10	0	0
13	31933666	.	A	G	5	5	10	0	1	11	0	0
13	31933684	.	G	A	4	6	10	0	0	10	0	0
13	31935288	.	C	T	0	2	2	0	2	4	0	0
13	31936488	.	T	A	2	3	5	0	0	5	0	0
13	31936700	.	G	T	1	3	4	0	0	4	0	0
13	31936707	.	T	A	1	3	4	0	0	4	0	0
13	31936907	.	T	C	1	0	1	0	2	3	0	0
13	32150038	.	G	A	0	4	4	0	1	5	0	0
13	32150081	.	C	A	1	4	5	0	0	5	0	0
13	32446278	.	G	A	5	4	9	0	0	9	0	0
13	32452658	.	C	T	4	3	7	0	0	7	0	0
13	32452924	.	G	T	1	5	6	0	0	6	0	0
13	32452949	.	T	G	2	6	8	0	0	8	0	0
13	32453227	.	G	T	2	2	4	0	0	4	0	0
13	32453582	.	A	G	2	2	4	0	0	4	0	0
13	32454381	.	A	T	7	9	16	0	0	16	0	0
13	32454565	.	T	A	3	4	7	0	0	7	0	0
13	32455739	.	C	A	4	8	12	0	0	12	0	0
13	32455943	.	A	G	5	4	9	0	2	11	0	0
13	32456312	.	C	G	7	9	16	0	0	16	0	0
13	32456350	.	G	A	6	5	11	0	0	11	0	0
13	32456736	.	G	T	3	4	7	0	0	7	0	0
13	32575859	.	T	G	3	3	6	0	0	6	0	0
13	32576310	.	T	C	1	3	4	0	0	4	0	0
13	32580556	.	T	G	9	3	12	0	0	12	0	0
13	32583915	.	G	A	12	5	17	0	0	17	0	0
13	32583930	.	A	G	10	5	15	0	0	15	0	0
13	32588892	.	A	G	14	8	22	0	0	22	0	0
13	32592973	.	C	T	6	2	8	0	0	8	0	0
13	32593009	.	T	C	3	1	4	1	3	8	0	0
13	32595257	.	C	T	6	4	10	0	0	10	0	0
13	32638668	.	C	T	6	12	18	0	0	18	0	0
13	32638670	.	T	C	7	12	19	0	0	19	0	0
13	32638991	.	T	C	8	14	22	0	0	22	0	0
13	32640975	.	C	A	7	8	15	0	1	16	0	0
13	32641165	.	G	A	3	2	5	0	0	5	0	0
13	32641480	.	T	C	1	2	3	0	0	3	0	0
13	32641979	.	C	T	3	3	6	0	1	7	0	0
13	32642185	.	A	G	3	2	5	0	0	5	0	0
13	32642215	.	A	G	3	4	7	0	0	7	0	0
13	32642238	.	A	G	4	5	9	0	0	9	0	0
13	32642251	.	G	A	6	5	11	0	0	11	0	0
13	32642284	.	C	A	7	3	10	0	0	10	0	0
13	32642369	.	T	C	6	2	8	0	0	8	0	0
13	32642410	.	G	T	7	5	12	0	1	13	0	0
13	32642488	.	A	G	6	10	16	0	0	16	0	0
13	32642528	.	A	T	7	11	18	0	1	19	0	0
13	32642568	.	A	T	6	7	13	0	1	14	0	0
13	32642618	.	T	A	5	4	9	0	1	10	0	0
13	32643073	.	A	G	2	3	5	0	0	5	0	0
13	32643143	.	G	A	2	2	4	0	0	4	0	0
13	32643414	.	A	T	1	2	3	0	0	3	0	0
13	32643840	.	A	G	6	3	9	0	0	9	0	0
13	32660774	.	T	C	3	2	5	0	0	5	0	0
13	32665008	.	A	C	5	5	10	0	0	10	0	0
13	32665035	.	G	A	5	4	9	0	0	9	0	0
13	32726095	.	G	T	2	4	6	0	0	6	0	0
13	32726099	.	G	A	2	4	6	0	0	6	0	0
13	32726152	.	G	C	2	3	5	0	0	5	0	0
13	32754282	.	C	T	4	2	6	0	0	6	0	0
13	32794413	.	T	C	5	3	8	0	1	9	0	0
13	32795387	.	T	C	3	5	8	0	0	8	0	0
13	32795882	.	A	C	1	2	3	0	0	3	0	0
13	32807491	.	C	T	1	3	4	0	0	4	0	0
13	32812521	.	C	G	2	2	4	0	0	4	0	0
13	32815765	.	C	T	5	4	9	0	0	9	0	0
13	32825086	.	C	T	12	9	21	0	1	22	0	0
13	32825143	.	A	C	15	0	15	0	8	23	0	0
13	32825149	.	T	C	13	0	13	0	13	26	0	0
13	32827410	.	T	C	3	7	10	0	0	10	0	0
13	32827754	.	A	G	6	10	16	0	0	16	0	0
13	32833326	.	T	C	9	5	14	0	0	14	0	0
13	32833359	.	A	G	6	9	15	0	0	15	0	0
13	32833364	.	A	C	7	9	16	0	0	16	0	0
13	32838217	.	T	C	3	5	8	0	0	8	0	0
13	32838241	.	C	A	5	7	12	0	0	12	0	0
13	32838254	.	C	T	5	5	10	0	0	10	0	0
13	32838276	.	T	A	5	5	10	0	1	11	0	0
13	32838468	.	A	G	4	13	17	0	0	17	0	0
13	32838507	.	T	A	6	8	14	0	2	16	0	0
13	32841314	.	A	G	2	2	4	0	0	4	0	0
13	32841598	.	A	G	5	2	7	0	1	8	0	0
13	32844777	.	C	T	0	2	2	0	3	5	0	0
13	32902537	.	T	G	3	2	5	0	1	6	0	0
13	32902545	.	G	A	2	3	5	0	0	5	0	0
13	32993962	.	C	T	2	10	12	0	10	22	0	0
13	32994526	.	T	C	12	8	20	0	2	22	0	0
13	32994565	.	T	A	10	5	15	0	0	16	1	0
13	32994697	.	G	T	3	10	13	0	1	14	0	0
13	32994736	.	A	G	7	11	18	0	2	20	0	0
13	32994841	.	A	G	8	10	18	0	1	19	0	0
13	32997196	.	A	T	7	9	16	0	0	16	0	0
13	32997224	.	C	A	8	12	20	0	0	20	0	0
13	32997260	.	T	C	5	11	16	0	1	17	0	0
13	32997424	.	G	T	10	14	24	1	0	25	0	0
13	32997517	.	T	A	9	18	27	1	1	29	0	0
13	33000574	.	C	T	1	22	23	0	8	31	0	0
13	33000586	.	T	C	5	24	29	0	1	30	0	0
13	33005284	.	T	C	18	20	38	0	0	38	0	0
13	33005346	.	G	A	21	31	52	0	0	52	0	0
13	33007766	.	C	T	14	40	54	0	0	54	0	0
13	33020054	.	T	C	5	0	5	0	5	10	0	0
13	33021814	.	G	T	2	6	8	0	1	9	0	0
13	33024599	.	C	A	1	4	5	0	0	5	0	0
13	33024743	.	A	C	6	4	10	0	1	11	0	0
13	33024789	.	G	C	16	12	28	0	0	28	0	0
13	33029576	.	A	T	17	12	29	0	1	30	0	0
13	33029594	.	G	A	3	14	17	0	13	30	0	0
13	33029624	.	G	T	3	15	18	0	13	31	0	0
13	33031915	.	A	G	22	22	44	0	0	44	0	0
13	33033330	.	C	T	26	21	47	0	1	48	0	0
13	33033354	.	A	G	21	19	40	0	3	43	0	0
13	33033688	.	T	C	22	23	45	0	1	46	0	0
13	33040738	.	A	C	1	2	3	0	0	3	0	0
13	33040753	.	C	T	1	1	2	0	1	3	0	0
13	33041038	.	A	T	1	2	3	0	0	3	0	0
13	33041118	.	C	A	7	2	9	0	0	9	0	0
13	33041157	.	T	G	3	2	5	0	2	7	0	0
13	33048095	.	T	C	6	2	8	0	2	10	0	0
13	33048096	.	G	A	7	2	9	0	1	10	0	0
13	33054706	.	G	A	5	3	8	0	0	8	0	0
13	33059179	.	C	T	11	12	23	0	0	23	0	0
13	33059257	.	T	C	7	15	22	0	0	22	0	0
13	33059260	.	A	G	7	14	21	0	1	22	0	0
13	33062352	.	G	C	8	15	23	0	0	23	0	0
13	33062367	.	C	T	10	13	23	0	1	24	0	0
13	33065614	.	A	C	15	13	28	0	0	28	0	0
13	33066629	.	T	C	4	3	7	0	0	7	0	0
13	33066691	.	C	A	0	9	9	0	5	14	0	0
13	33066882	.	A	C	2	2	4	0	0	4	0	0
13	33066893	.	A	T	2	2	4	0	0	4	0	0
13	33067116	.	T	A	4	3	7	0	1	8	0	0
13	33067129	.	A	T	5	3	8	0	0	8	0	0
13	33067157	.	T	G	2	2	4	0	0	4	0	0
13	33067622	.	T	C	4	3	7	0	0	7	0	0
13	33080071	.	T	C	1	2	3	0	0	3	0	0
13	33083461	.	T	G	1	2	3	0	0	3	0	0
13	33093724	.	G	T	1	3	4	0	1	5	0	0
13	33094995	.	T	C	1	0	1	0	2	3	0	0
13	33122141	.	T	C	5	2	7	0	0	7	0	0
13	33122276	.	T	A	2	5	7	0	0	7	0	0
13	33122312	.	C	A	3	7	10	0	1	11	0	0
13	33122429	.	C	G	5	18	23	0	0	23	0	0
13	33122519	.	T	C	12	7	19	0	0	19	0	0
13	33122626	.	A	T	14	9	23	0	1	24	0	0
13	33122642	.	G	A	12	10	22	0	2	24	0	0
13	33122847	.	T	G	12	0	12	0	11	23	0	0
13	33122853	.	C	A	12	11	23	0	1	24	0	0
13	33174533	.	G	A	7	2	9	0	0	9	0	0
13	33174645	.	G	A	2	3	5	0	0	5	0	0
13	33174681	.	G	A	4	3	7	0	0	7	0	0
13	33174865	.	T	G	5	6	11	0	1	12	0	0
13	33174964	.	T	C	7	0	7	0	5	12	0	0
13	33175097	.	A	C	3	5	8	0	0	8	0	0
13	33175126	.	C	A	6	3	9	0	0	9	0	0
13	33175190	.	A	G	5	7	12	0	0	12	0	0
13	33175202	.	T	C	4	0	4	0	5	9	0	0
13	33177425	.	G	T	9	6	15	0	2	17	0	0
13	33177682	.	C	G	0	6	6	1	7	14	0	0
13	33190416	.	G	A	5	12	17	0	1	18	0	0
13	33192619	.	C	A	4	2	6	0	0	6	0	0
13	33194490	.	A	C	4	8	12	0	0	12	0	0
13	33194527	.	G	C	5	5	10	0	0	10	0	0
13	33194854	.	A	T	5	3	8	0	0	8	0	0
13	33195500	.	T	G	2	3	5	0	0	5	0	0
13	33195529	.	T	C	1	3	4	0	0	4	0	0
13	33196656	.	A	G	2	2	4	0	0	4	0	0
13	33196698	.	A	G	1	3	4	0	0	4	0	0
13	33196730	.	G	A	2	3	5	0	0	5	0	0
13	33197897	.	C	T	2	2	4	0	0	4	0	0
13	33197959	.	G	C	1	2	3	0	0	3	0	0
13	33199999	.	T	C	3	2	5	0	0	5	0	0
13	33211397	.	T	A	5	4	9	0	0	9	0	0
13	33211445	.	A	T	7	8	15	0	0	15	0	0
13	33214664	.	C	T	1	6	7	0	8	15	0	0
13	33214706	.	C	T	12	4	16	0	0	16	0	0
13	33214709	.	T	C	13	4	17	0	1	18	0	0
13	33216341	.	G	A	9	13	22	0	0	22	0	0
13	33218214	.	C	T	5	9	14	0	0	14	0	0
13	33219988	.	C	A	2	7	9	0	7	16	0	0
13	33220164	.	A	G	13	13	26	0	0	26	0	0
13	33222342	.	C	A	1	7	8	0	4	12	0	0
13	33222396	.	G	A	10	6	16	0	0	16	0	0
13	33224742	.	G	T	8	9	17	0	1	18	0	0
13	33224932	.	C	T	1	3	4	0	10	14	0	0
13	33225029	.	G	A	5	7	12	0	0	12	0	0
13	33229502	.	T	G	9	8	17	0	1	18	0	0
13	33229739	.	T	C	16	13	29	0	0	29	0	0
13	33229753	.	C	T	15	10	25	0	2	27	0	0
13	33230024	.	A	T	19	17	36	0	1	37	0	0
13	33230163	.	G	C	17	12	29	0	1	30	0	0
13	33230177	.	G	A	14	13	27	0	0	27	0	0
13	33230436	.	C	A	5	20	25	0	1	26	0	0
13	33230518	.	T	C	7	0	7	0	19	26	0	0
13	33234522	.	C	T	1	15	16	0	15	31	0	0
13	33234866	.	T	C	14	10	24	0	0	24	0	0
13	33236111	.	T	C	18	7	25	0	1	26	0	0
13	33236482	.	G	T	12	13	25	0	3	28	0	0
13	33236691	.	A	G	13	13	26	0	1	27	0	0
13	33239219	.	G	A	11	12	23	0	2	25	0	0
13	33242878	.	C	T	9	6	15	0	2	17	0	0
13	33246227	.	T	A	4	10	14	0	0	14	0	0
13	33246249	.	T	A	4	17	21	0	1	22	0	0
13	33247147	.	A	C	1	3	4	0	0	4	0	0
13	33248351	.	C	T	3	11	14	0	0	14	0	0
13	33248677	.	T	A	7	12	19	0	0	19	0	0
13	33250992	.	T	A	11	15	26	0	0	26	0	0
13	33251058	.	C	G	11	0	11	0	13	24	0	0
13	33251718	.	A	G	1	2	3	0	0	3	0	0
13	33252236	.	C	T	1	3	4	0	0	4	0	0
13	33261198	.	A	G	19	18	37	0	1	38	0	0
13	33261228	.	C	T	21	29	50	0	1	51	0	0
13	33261303	.	A	T	18	26	44	0	1	45	0	0
13	33261326	.	A	T	19	30	49	0	3	52	0	0
13	33261340	.	C	T	20	29	49	0	3	52	0	0
13	33261389	.	T	G	27	14	41	0	2	43	0	0
13	33261577	.	C	G	24	27	51	0	0	51	0	0
13	33261620	.	T	C	27	18	45	0	1	46	0	0
13	33261637	.	G	T	24	10	34	0	1	42	7	0
13	33262044	.	C	A	32	26	58	0	2	60	0	0
13	33262721	.	A	T	18	12	30	0	3	33	0	0
13	33262749	.	A	C	23	14	37	0	1	38	0	0
13	33262909	.	G	T	17	26	43	0	0	43	0	0
13	33262944	.	C	G	25	19	44	0	1	45	0	0
13	33263503	.	G	T	14	11	25	0	4	29	0	0
13	33263862	.	A	C	16	0	16	0	0	16	0	0
13	33263985	.	C	A	15	13	28	0	1	29	0	0
13	33264001	.	G	A	15	16	31	0	0	31	0	0
13	33264315	.	T	C	25	14	39	0	2	41	0	0
13	33264318	.	C	T	25	15	40	0	3	43	0	0
13	33264470	.	A	G	18	22	40	1	1	42	0	0
13	33264483	.	T	A	15	17	32	1	0	33	0	0
13	33264635	.	A	T	9	14	23	0	0	23	0	0
13	33264772	.	A	T	11	20	31	0	0	31	0	0
13	33265061	.	G	T	19	11	30	0	2	32	0	0
13	33265062	.	G	T	20	14	34	0	0	34	0	0
13	33265128	.	T	C	16	1	17	0	17	34	0	0
13	33265210	.	T	G	18	23	41	0	1	42	0	0
13	33265323	.	A	C	16	22	38	0	0	38	0	0
13	33265364	.	G	T	19	26	45	0	0	45	0	0
13	33267095	.	T	C	24	23	47	0	1	48	0	0
13	33268757	.	A	T	3	2	5	0	0	5	0	0
13	33273081	.	C	A	1	4	5	0	0	5	0	0
13	33273106	.	C	T	2	3	5	0	0	5	0	0
13	33276048	.	T	C	2	8	10	0	0	10	0	0
13	33276106	.	T	C	5	5	10	0	0	10	0	0
13	33280769	.	C	A	3	4	7	0	0	7	0	0
13	33282130	.	G	A	5	2	7	0	0	7	0	0
13	33282227	.	G	A	5	8	13	0	0	13	0	0
13	33282236	.	A	G	6	7	13	0	0	13	0	0
13	33293037	.	A	G	3	5	8	0	1	9	0	0
13	33298909	.	T	C	2	2	4	0	0	4	0	0
13	33300228	.	A	G	2	2	4	0	0	4	0	0
13	33314521	.	C	T	2	2	4	0	1	5	0	0
13	33314821	.	T	G	2	3	5	0	0	5	0	0
13	33314840	.	A	T	3	3	6	0	0	6	0	0
13	33314863	.	T	C	3	4	7	0	0	7	0	0
13	33314946	.	T	C	5	5	10	0	1	11	0	0
13	33315112	.	C	G	6	6	12	0	1	13	0	0
13	33316844	.	C	T	9	3	12	0	0	12	0	0
13	33317238	.	A	T	1	2	3	0	0	3	0	0
13	33368512	.	A	T	2	3	5	0	0	5	0	0
13	33368531	.	C	T	1	3	4	0	0	4	0	0
13	33394476	.	A	C	20	15	35	0	0	35	0	0
13	33394887	.	G	A	19	24	43	0	0	43	0	0
13	33394976	.	T	C	12	19	31	0	0	31	0	0
13	33395174	.	C	G	18	14	32	0	2	34	0	0
13	33395256	.	T	G	11	12	23	0	0	23	0	0
13	33396026	.	A	C	11	0	11	0	9	20	0	0
13	33396343	.	C	T	3	6	9	0	6	15	0	0
13	33398365	.	C	T	19	20	39	0	0	39	0	0
13	33398498	.	G	A	8	5	13	0	1	14	0	0
13	33411068	.	C	T	1	3	4	0	0	4	0	0
13	33411082	.	G	A	1	2	3	0	1	4	0	0
13	33445279	.	G	A	1	2	3	0	1	4	0	0
13	33445288	.	C	T	1	2	3	0	0	3	0	0
13	33447169	.	G	A	2	4	6	0	0	6	0	0
13	33447389	.	T	C	5	4	9	0	0	9	0	0
13	33447527	.	A	C	1	3	4	0	0	4	0	0
13	33448134	.	A	G	1	2	3	0	0	3	0	0
13	33609129	.	T	C	3	3	6	0	2	8	0	0
13	33612347	.	C	T	6	6	12	0	0	12	0	0
13	33619849	.	A	G	5	4	9	0	1	10	0	0
13	33633271	.	T	A	4	2	6	0	0	6	0	0
13	33633344	.	G	A	4	3	7	0	0	7	0	0
13	33636548	.	T	C	3	0	3	0	3	6	0	0
13	33636597	.	G	A	5	2	7	0	0	7	0	0
13	33636971	.	C	T	2	2	4	0	0	4	0	0
13	33645567	.	C	T	6	5	11	0	2	13	0	0
13	33645649	.	A	T	10	3	13	0	1	14	0	0
13	33645892	.	C	T	3	7	10	0	1	11	0	0
13	33646059	.	A	G	1	3	4	0	1	5	0	0
13	33646123	.	T	A	5	5	10	0	0	10	0	0
13	33646132	.	A	T	6	4	10	0	0	10	0	0
13	33646333	.	T	C	2	0	2	0	2	4	0	0
13	33649184	.	T	G	2	4	6	0	0	6	0	0
13	33652588	.	A	G	2	7	9	0	0	9	0	0
13	33655480	.	C	T	2	2	4	0	0	4	0	0
13	33667743	.	A	T	1	2	3	0	0	3	0	0
13	33682023	.	C	T	8	15	23	0	0	23	0	0
13	33682052	.	T	C	14	14	28	0	3	32	1	0
13	33682068	.	A	C	17	24	41	0	1	42	0	0
13	33682216	.	C	T	16	14	30	1	0	31	0	0
13	33682217	.	A	T	16	12	28	1	2	31	0	0
13	33682379	.	C	A	6	7	13	0	1	14	0	0
13	33682731	.	G	A	24	23	47	0	0	47	0	0
13	33683824	.	A	C	19	30	49	0	1	50	0	0
13	33683829	.	A	T	18	26	44	0	4	48	0	0
13	33813428	.	A	C	13	6	19	0	2	21	0	0
13	33813452	.	T	G	15	7	22	0	2	24	0	0
13	33813792	.	C	T	7	12	19	0	0	19	0	0
13	33814644	.	A	C	5	5	10	0	1	11	0	0
13	33814647	.	T	A	5	5	10	0	0	10	0	0
13	33814773	.	C	T	11	10	21	0	0	21	0	0
13	33815863	.	C	A	7	9	16	0	1	17	0	0
13	33815992	.	C	T	9	6	15	0	0	15	0	0
13	33816442	.	C	T	1	3	4	0	0	4	0	0
13	33816509	.	A	G	5	3	8	0	0	8	0	0
13	33816518	.	T	C	5	1	6	0	1	7	0	0
13	33968506	.	T	C	16	13	29	0	0	29	0	0
13	34483567	.	G	A	1	11	12	0	15	27	0	0
13	34488737	.	T	G	16	10	26	0	0	26	0	0
13	34519607	.	T	A	20	17	37	0	2	39	0	0
13	34556374	.	C	A	20	12	32	0	3	35	0	0
13	34697636	.	T	G	3	2	5	0	0	5	0	0
13	34703994	.	T	C	3	6	9	0	1	10	0	0
13	34746752	.	A	G	6	0	6	0	7	13	0	0
13	34746847	.	A	G	1	2	3	0	0	3	0	0
13	34746941	.	A	G	2	0	2	0	2	4	0	0
13	34747058	.	G	A	6	3	9	0	0	9	0	0
13	34747137	.	G	A	0	5	5	0	1	6	0	0
13	34747160	.	A	C	1	4	5	0	0	5	0	0
13	34747254	.	C	T	6	3	9	0	0	9	0	0
13	34747260	.	G	T	7	1	8	0	1	9	0	0
13	34747556	.	T	G	1	3	4	0	0	4	0	0
13	34747617	.	A	G	2	2	4	0	0	4	0	0
13	34747734	.	A	G	3	0	3	0	1	4	0	0
13	34747916	.	A	C	2	4	6	0	0	6	0	0
13	34748086	.	G	T	4	6	10	0	0	10	0	0
13	34748199	.	C	A	4	5	9	0	0	9	0	0
13	34748479	.	A	G	2	6	8	0	0	8	0	0
13	34748516	.	C	T	2	6	8	0	1	9	0	0
13	34748959	.	A	T	8	4	12	0	1	13	0	0
13	34748990	.	T	A	6	4	10	0	0	10	0	0
13	34749530	.	G	T	0	2	2	0	7	9	0	0
13	34749542	.	A	G	6	2	8	0	0	8	0	0
13	34749616	.	C	T	4	6	10	0	1	11	0	0
13	34749743	.	G	T	11	5	16	0	0	17	1	0
13	34749751	.	C	T	9	6	15	0	1	16	0	0
13	34749819	.	C	T	8	15	23	0	0	23	0	0
13	34749833	.	A	G	8	14	22	0	1	23	0	0
13	34749936	.	T	A	6	6	12	0	0	12	0	0
13	34765383	.	G	A	4	2	6	0	0	6	0	0
13	34765639	.	G	A	5	3	8	0	0	8	0	0
13	34765690	.	A	G	2	5	7	0	0	7	0	0
13	35042138	.	C	T	14	21	35	0	0	35	0	0
13	35042237	.	G	A	18	20	38	0	5	43	0	0
13	35042279	.	G	A	18	23	41	0	1	42	0	0
13	35042354	.	G	T	17	16	33	0	1	34	0	0
13	35049461	.	A	G	5	8	13	0	0	13	0	0
13	35051624	.	C	T	1	13	14	0	10	24	0	0
13	35051786	.	T	C	9	15	24	0	1	25	0	0
13	35051880	.	G	A	5	6	11	0	0	11	0	0
13	35478781	.	T	A	3	3	6	0	0	6	0	0
13	35481419	.	C	T	3	2	5	0	0	5	0	0
13	35481452	.	T	C	4	2	6	0	0	6	0	0
13	35511074	.	A	G	3	4	7	0	0	7	0	0
13	35719007	.	A	C	4	2	6	0	0	6	0	0
13	35720956	.	A	G	4	0	4	0	3	7	0	0
13	35720987	.	C	T	5	5	10	0	0	10	0	0
13	35723419	.	T	A	2	2	4	0	0	4	0	0
13	35723453	.	G	A	2	2	4	0	0	4	0	0
13	35724324	.	T	G	2	0	2	0	2	4	0	0
13	35726735	.	G	C	2	2	4	0	0	4	0	0
13	35728714	.	A	G	1	4	5	0	0	5	0	0
13	35730449	.	A	G	3	6	9	0	0	9	0	0
13	35732304	.	C	T	1	2	3	0	0	3	0	0
13	35744431	.	T	A	1	3	4	0	0	4	0	0
13	35745657	.	T	C	6	8	14	0	1	15	0	0
13	35746343	.	A	G	10	0	10	0	7	17	0	0
13	35746637	.	C	T	8	8	16	0	0	16	0	0
13	35746838	.	T	C	5	8	13	0	0	13	0	0
13	35747177	.	T	G	12	14	26	0	3	29	0	0
13	35747690	.	A	G	13	1	14	0	19	33	0	0
13	35747918	.	T	C	24	24	48	0	0	48	0	0
13	35747954	.	T	C	19	26	45	0	0	45	0	0
13	35748096	.	C	G	14	0	14	0	15	29	0	0
13	35748249	.	G	A	14	12	26	0	0	26	0	0
13	35748319	.	T	C	18	15	33	0	1	34	0	0
13	35751047	.	T	C	1	3	4	0	0	4	0	0
13	35751211	.	T	C	9	10	19	0	0	19	0	0
13	35752964	.	T	C	8	8	16	0	0	16	0	0
13	35753242	.	G	A	7	6	13	0	1	14	0	0
13	35756029	.	G	T	7	8	15	0	1	16	0	0
13	35757338	.	T	G	5	7	12	0	1	13	0	0
13	35758093	.	T	C	6	0	6	0	12	18	0	0
13	35758111	.	G	T	2	9	11	0	0	11	0	0
13	35759904	.	G	A	13	8	21	0	2	23	0	0
13	35788302	.	A	C	8	12	20	0	3	23	0	0
13	35788313	.	T	C	12	11	23	0	1	24	0	0
13	35788507	.	G	A	17	13	30	0	2	32	0	0
13	35788562	.	C	G	3	12	15	0	14	29	0	0
13	35791419	.	C	G	11	14	25	0	0	25	0	0
13	35791539	.	G	A	14	8	22	0	0	22	0	0
13	35796882	.	C	T	11	9	20	0	3	23	0	0
13	35796894	.	G	A	12	11	23	0	1	24	0	0
13	35796924	.	C	T	0	16	16	0	11	27	0	0
13	35798915	.	A	G	8	9	17	0	1	18	0	0
13	35798960	.	T	C	12	6	18	0	1	19	0	0
13	35798966	.	G	C	11	7	18	0	1	19	0	0
13	35799146	.	G	A	10	8	18	0	1	19	0	0
13	35799194	.	C	T	7	8	15	0	1	16	0	0
13	35799230	.	A	G	6	10	16	0	1	17	0	0
13	35801258	.	G	A	4	11	15	0	0	15	0	0
13	35801452	.	A	G	7	8	15	0	0	15	0	0
13	35801473	.	A	G	9	8	17	0	0	17	0	0
13	35801501	.	T	C	9	0	9	0	5	14	0	0
13	35808949	.	T	C	6	3	9	0	0	9	0	0
13	35811400	.	A	G	5	6	11	0	0	11	0	0
13	35811852	.	C	G	3	3	6	0	0	6	0	0
13	35811907	.	A	G	2	3	5	0	0	5	0	0
13	35813549	.	A	G	4	5	9	0	0	9	0	0
13	35813666	.	C	T	0	7	7	0	7	14	0	0
13	35824806	.	A	G	1	3	4	0	0	4	0	0
13	35856539	.	G	T	5	7	12	0	0	12	0	0
13	35856826	.	T	C	7	4	11	0	1	12	0	0
13	35872207	.	C	T	5	5	10	0	0	10	0	0
13	35872373	.	T	C	3	2	5	0	0	5	0	0
13	35872375	.	A	C	3	2	5	0	0	5	0	0
13	35872493	.	T	A	3	4	7	0	0	7	0	0
13	35872495	.	C	A	3	4	7	0	0	7	0	0
13	35905265	.	A	G	3	5	8	0	0	8	0	0
13	35950431	.	A	G	6	4	10	0	1	11	0	0
13	35950440	.	C	T	5	4	9	0	1	10	0	0
13	35950720	.	G	A	7	6	13	0	0	13	0	0
13	35950753	.	C	A	12	5	17	0	0	17	0	0
13	35953558	.	G	A	5	4	9	0	0	9	0	0
13	36039938	.	G	A	19	26	45	0	2	48	1	0
13	36040061	.	G	T	24	16	40	0	1	41	0	0
13	36040127	.	A	T	28	21	49	0	3	52	0	0
13	36040278	.	T	C	16	0	16	0	19	35	0	0
13	36040473	.	A	C	4	5	9	0	0	9	0	0
13	36040611	.	C	T	1	9	10	3	12	25	0	0
13	36040635	.	C	A	16	8	24	4	1	29	0	0
13	36042020	.	T	A	16	20	36	0	0	36	0	0
13	36042057	.	C	T	19	18	37	0	1	38	0	0
13	36042091	.	G	C	16	18	34	0	0	34	0	0
13	36043781	.	T	A	16	21	37	0	1	38	0	0
13	36043796	.	T	C	16	1	17	0	22	39	0	0
13	36043820	.	T	C	14	0	14	0	21	35	0	0
13	36045705	.	G	A	18	15	33	0	0	33	0	0
13	36048931	.	A	G	6	8	14	0	0	14	0	0
13	36048981	.	C	T	12	11	23	0	1	24	0	0
13	36054962	.	T	C	19	12	31	0	0	31	0	0
13	36057124	.	C	T	8	12	20	1	1	22	0	0
13	36060640	.	G	A	16	12	28	0	4	32	0	0
13	36060679	.	T	G	17	15	32	0	2	34	0	0
13	36062661	.	T	A	8	7	15	0	2	17	0	0
13	36067938	.	A	G	6	2	8	0	0	8	0	0
13	36072451	.	C	T	0	5	5	0	7	12	0	0
13	36074176	.	G	A	5	3	8	0	1	9	0	0
13	36079205	.	G	A	4	2	6	0	0	6	0	0
13	36086415	.	G	A	3	5	8	0	0	8	0	0
13	36088851	.	A	G	5	6	11	0	1	12	0	0
13	36091887	.	C	T	0	4	4	0	1	5	0	0
13	36098899	.	C	A	1	5	6	0	0	6	0	0
13	36102706	.	C	T	1	1	2	0	1	3	0	0
13	36103492	.	G	A	1	2	3	0	0	3	0	0
13	36104207	.	G	A	1	3	4	0	0	4	0	0
13	36104209	.	T	C	1	1	2	0	2	4	0	0
13	36135416	.	A	G	6	5	11	0	1	12	0	0
13	36136585	.	A	G	12	9	21	0	2	23	0	0
13	36136669	.	C	G	1	11	12	0	11	23	0	0
13	36146596	.	G	A	14	9	23	0	2	25	0	0
13	36151407	.	G	C	5	10	15	0	0	15	0	0
13	36151462	.	G	A	12	10	22	0	0	22	0	0
13	36151635	.	T	C	13	12	25	0	0	25	0	0
13	36151636	.	C	T	13	11	24	0	1	25	0	0
13	36151894	.	G	C	16	19	35	0	0	35	0	0
13	36151929	.	C	T	16	15	31	0	1	32	0	0
13	36152364	.	T	C	25	26	51	0	3	54	0	0
13	36152402	.	C	T	27	27	54	0	2	56	0	0
13	36152415	.	A	G	27	30	57	0	0	57	0	0
13	36152440	.	T	G	26	4	30	0	22	52	0	0
13	36152700	.	T	A	18	19	37	0	2	39	0	0
13	36152733	.	A	G	14	15	29	0	0	29	0	0
13	36152778	.	A	G	16	13	29	0	1	30	0	0
13	36152795	.	A	C	16	8	24	0	2	26	0	0
13	36152838	.	A	G	12	0	12	0	7	19	0	0
13	36152874	.	C	T	7	3	10	0	0	10	0	0
13	36153057	.	A	T	3	2	5	0	0	5	0	0
13	36153313	.	T	C	7	16	23	0	2	25	0	0
13	36153382	.	C	T	19	21	40	0	2	42	0	0
13	36168770	.	C	T	3	2	5	0	0	5	0	0
13	36168836	.	G	A	5	5	10	0	0	10	0	0
13	36168861	.	G	T	3	4	7	0	0	7	0	0
13	36179661	.	G	C	4	2	6	0	2	8	0	0
13	36179697	.	C	T	2	4	6	0	0	6	0	0
13	36179838	.	C	T	2	3	5	0	0	5	0	0
13	36179844	.	A	T	2	2	4	0	0	4	0	0
13	36263596	.	T	C	1	3	4	0	0	4	0	0
13	36312080	.	T	C	1	2	3	0	0	3	0	0
13	36312103	.	C	G	1	2	3	0	0	3	0	0
13	36312193	.	G	T	12	6	18	0	0	18	0	0
13	36312361	.	C	A	3	3	6	0	1	8	1	0
13	36312447	.	A	G	6	4	10	0	0	10	0	0
13	36312469	.	T	G	6	3	9	0	0	9	0	0
13	36312497	.	C	T	1	3	4	0	5	9	0	0
13	36312682	.	G	A	12	9	21	0	1	22	0	0
13	36321256	.	C	T	1	5	6	0	0	6	0	0
13	36322099	.	C	T	1	5	6	0	16	22	0	0
13	36322133	.	A	G	17	10	27	0	0	27	0	0
13	36330642	.	G	A	7	9	16	0	1	17	0	0
13	36335033	.	G	A	4	4	8	0	0	8	0	0
13	36335057	.	A	G	4	4	8	0	0	8	0	0
13	36335206	.	A	G	7	4	11	0	0	11	0	0
13	36337349	.	T	C	3	0	3	0	7	10	0	0
13	36338262	.	A	G	4	7	11	0	0	11	0	0
13	36349674	.	G	A	3	4	7	1	0	8	0	0
13	36409233	.	A	T	7	3	10	0	0	10	0	0
13	36409246	.	C	T	6	3	9	0	1	10	0	0
13	36409522	.	T	C	3	0	3	0	5	9	1	0
13	36409691	.	A	G	6	6	12	0	1	13	0	0
13	36410339	.	T	C	6	11	17	0	0	17	0	0
13	36410671	.	T	C	2	2	4	0	0	4	0	0
13	36418648	.	G	T	4	4	8	0	0	8	0	0
13	36438831	.	C	T	4	2	6	0	0	6	0	0
13	36450109	.	C	T	4	3	7	0	3	10	0	0
13	36466321	.	C	G	1	3	4	0	0	4	0	0
13	36467504	.	G	A	3	4	7	0	1	8	0	0
13	36467558	.	G	A	2	2	4	0	0	4	0	0
13	36557236	.	C	T	8	2	10	0	0	10	0	0
13	37076269	.	T	C	16	8	24	0	1	25	0	0
13	37076337	.	T	C	15	4	19	0	2	21	0	0
13	37421625	.	T	A	8	3	11	0	3	14	0	0
13	37421642	.	C	A	10	3	13	0	1	14	0	0
13	37668470	.	T	C	6	2	8	0	1	9	0	0
13	38304824	.	A	G	6	7	13	0	0	13	0	0
13	38446709	.	A	G	7	0	7	0	8	15	0	0
13	38466196	.	G	A	9	5	14	0	3	17	0	0
13	38466247	.	C	T	4	11	15	0	1	16	0	0
13	38466343	.	T	C	9	13	22	0	1	23	0	0
13	38566611	.	A	G	17	0	17	0	13	30	0	0
13	38583699	.	C	A	21	14	35	0	1	36	0	0
13	38583714	.	A	G	17	17	34	0	1	35	0	0
13	38593559	.	A	G	23	28	51	0	2	53	0	0
13	38593574	.	A	T	26	25	51	0	3	54	0	0
13	38621607	.	G	T	2	2	4	0	0	4	0	0
13	38622184	.	C	T	2	6	8	0	10	18	0	0
13	38666128	.	G	A	11	16	27	0	1	28	0	0
13	39111169	.	A	T	1	3	4	0	0	4	0	0
13	39112210	.	C	T	3	2	5	0	0	5	0	0
13	39112211	.	A	G	3	2	5	0	0	5	0	0
13	39112434	.	C	T	2	3	5	0	0	5	0	0
13	39112550	.	A	G	1	5	6	0	0	6	0	0
13	39112612	.	G	A	0	3	3	0	1	4	0	0
13	39113415	.	G	A	1	3	4	0	0	4	0	0
13	39114444	.	C	A	6	4	10	0	0	10	0	0
13	39114474	.	G	T	5	7	12	0	0	12	0	0
13	39115534	.	A	G	5	0	5	0	4	9	0	0
13	39214527	.	A	G	1	5	6	0	1	7	0	0
13	39214557	.	G	A	2	9	11	0	0	11	0	0
13	39217377	.	C	T	6	4	10	0	2	12	0	0
13	39217506	.	C	T	3	5	8	0	0	8	0	0
13	39217657	.	C	T	4	5	9	0	0	9	0	0
13	39217887	.	T	G	6	0	6	0	4	10	0	0
13	39218060	.	T	C	7	3	10	0	2	12	0	0
13	39218097	.	A	G	4	7	11	0	2	13	0	0
13	39218133	.	C	A	4	7	11	0	0	11	0	0
13	39218292	.	C	T	6	9	15	0	2	17	0	0
13	39218602	.	A	G	9	0	9	0	9	18	0	0
13	39218706	.	T	C	4	8	12	0	1	13	0	0
13	39218843	.	G	A	0	6	6	0	12	18	0	0
13	39221960	.	T	C	3	8	11	0	0	11	0	0
13	39223774	.	A	G	10	8	18	1	0	19	0	0
13	39224003	.	C	T	12	14	26	0	1	27	0	0
13	39226666	.	T	C	8	9	17	0	1	18	0	0
13	39227275	.	G	A	1	6	7	0	12	19	0	0
13	39228272	.	G	A	3	2	5	0	1	6	0	0
13	39277414	.	T	C	1	2	3	0	0	3	0	0
13	39302539	.	C	T	2	1	3	0	1	4	0	0
13	39303070	.	A	G	1	2	3	0	1	4	0	0
13	39303161	.	A	C	3	2	5	0	0	5	0	0
13	39304213	.	A	G	5	3	8	0	0	8	0	0
13	39360613	.	C	T	0	3	3	0	1	4	0	0
13	39657068	.	A	G	8	4	12	0	0	12	0	0
13	39657140	.	C	T	1	3	4	0	6	10	0	0
13	39657156	.	T	G	3	5	8	0	0	8	0	0
13	39657625	.	A	C	5	4	9	0	0	9	0	0
13	39657652	.	A	G	2	4	6	0	0	6	0	0
13	40335087	.	T	G	6	6	12	0	0	12	0	0
13	40335135	.	T	G	7	0	7	0	8	15	0	0
13	40344258	.	C	T	9	4	13	0	0	13	0	0
13	40344303	.	G	A	1	5	6	0	9	15	0	0
13	40351869	.	G	A	13	11	24	0	1	25	0	0
13	40351914	.	G	A	1	13	14	0	7	21	0	0
13	40351953	.	C	T	6	9	15	0	0	15	0	0
13	40352345	.	C	T	13	15	28	0	1	29	0	0
13	40352349	.	C	G	13	16	29	0	1	30	0	0
13	40352415	.	T	G	11	15	26	0	1	27	0	0
13	40352476	.	A	G	9	9	18	0	0	18	0	0
13	40353512	.	G	T	16	11	27	0	1	28	0	0
13	40353736	.	A	C	11	9	20	0	0	20	0	0
13	40354235	.	C	T	7	6	13	0	2	15	0	0
13	40445253	.	C	T	18	19	37	0	3	40	0	0
13	40463048	.	T	A	5	8	13	0	0	13	0	0
13	40463116	.	C	T	2	2	4	0	0	4	0	0
13	40463242	.	T	G	1	3	4	0	0	4	0	0
13	40463310	.	C	A	5	3	8	0	0	8	0	0
13	40463732	.	C	T	2	11	13	0	6	19	0	0
13	40463784	.	G	C	7	0	7	0	5	12	0	0
13	40481324	.	A	T	6	8	14	0	1	15	0	0
13	40486656	.	G	A	2	4	6	0	0	6	0	0
13	40497631	.	G	A	4	3	7	0	1	8	0	0
13	40497928	.	C	T	1	4	5	0	0	5	0	0
13	40498129	.	C	G	0	5	5	0	3	8	0	0
13	40498267	.	A	G	5	6	11	0	1	12	0	0
13	40498294	.	G	A	3	8	11	0	0	11	0	0
13	40714800	.	G	T	1	2	3	0	0	3	0	0
13	40746930	.	C	A	0	2	2	0	1	3	0	0
13	40746971	.	G	T	2	5	7	0	0	7	0	0
13	40747151	.	T	C	5	6	11	0	0	11	0	0
13	40747256	.	T	A	7	11	18	0	0	18	0	0
13	40747274	.	T	C	6	0	6	0	12	18	0	0
13	40747337	.	T	A	6	8	14	0	2	16	0	0
13	40747397	.	C	A	7	4	11	0	1	12	0	0
13	40747398	.	C	A	6	5	11	0	1	12	0	0
13	40747467	.	C	T	0	3	3	0	6	9	0	0
13	40747607	.	G	T	1	8	9	0	0	9	0	0
13	40747791	.	G	C	2	3	5	0	1	6	0	0
13	40748032	.	C	T	4	3	7	0	0	7	0	0
13	40748074	.	A	G	3	3	6	0	1	7	0	0
13	40748246	.	A	C	5	2	7	0	0	8	1	0
13	40748248	.	C	A	5	2	7	0	0	7	0	0
13	40748310	.	T	G	3	7	10	0	1	11	0	0
13	40748356	.	G	T	6	9	15	0	0	15	0	0
13	40748408	.	C	T	6	9	15	0	0	15	0	0
13	40748431	.	G	A	6	6	12	0	2	14	0	0
13	40748582	.	G	A	8	2	10	0	1	11	0	0
13	40749082	.	T	C	4	3	7	1	0	8	0	0
13	40749104	.	T	C	4	2	6	0	1	7	0	0
13	40749138	.	A	C	1	4	5	0	0	5	0	0
13	40749142	.	C	T	0	4	4	0	0	4	0	0
13	40749445	.	G	A	3	2	5	0	0	5	0	0
13	40749577	.	G	A	3	6	9	0	1	10	0	0
13	40754367	.	T	G	4	4	8	0	1	9	0	0
13	40754433	.	A	T	6	6	12	0	3	15	0	0
13	40754441	.	G	T	7	6	13	0	0	13	0	0
13	41125475	.	C	T	7	6	13	0	4	17	0	0
13	41125652	.	C	T	6	11	17	0	0	17	0	0
13	41125766	.	A	G	8	8	16	0	0	16	0	0
13	41128286	.	G	A	10	8	18	0	0	18	0	0
13	41214782	.	A	G	4	2	6	0	0	6	0	0
13	41214812	.	G	A	2	3	5	0	0	5	0	0
13	41214863	.	G	A	5	3	8	0	0	8	0	0
13	41222908	.	G	A	2	3	5	0	0	5	0	0
13	41222971	.	A	G	3	3	6	0	0	6	0	0
13	41249277	.	T	C	4	2	6	1	0	7	0	0
13	41279989	.	G	A	1	3	4	0	0	4	0	0
13	41288990	.	A	G	2	2	4	0	0	4	0	0
13	41289112	.	C	T	1	4	5	0	2	7	0	0
13	41306803	.	G	T	3	3	6	0	0	6	0	0
13	41320070	.	G	C	3	5	8	0	0	8	0	0
13	41546643	.	A	G	3	2	5	0	0	5	0	0
13	41910428	.	G	A	5	5	10	0	1	11	0	0
13	41911090	.	G	A	24	16	40	0	1	41	0	0
13	41911092	.	C	A	15	23	38	0	2	40	0	0
13	41911265	.	G	A	9	12	21	0	1	22	0	0
13	41911276	.	T	C	10	15	25	0	0	25	0	0
13	41911932	.	A	G	11	4	15	0	1	16	0	0
13	41915604	.	A	G	21	16	37	0	0	37	0	0
13	41917003	.	C	A	10	4	14	0	0	14	0	0
13	41940198	.	G	A	0	2	2	0	2	4	0	0
13	41944446	.	T	G	2	2	4	0	0	4	0	0
13	41944815	.	C	A	1	5	6	0	5	11	0	0
13	41945455	.	C	T	9	3	12	0	0	12	0	0
13	41945464	.	C	T	0	7	7	0	4	11	0	0
13	41945632	.	C	T	0	5	5	0	2	7	0	0
13	41945762	.	T	A	2	2	4	0	0	4	0	0
13	41947874	.	C	T	3	5	8	0	1	9	0	0
13	41947882	.	C	T	0	5	5	0	4	9	0	0
13	42016282	.	C	G	1	2	3	0	0	3	0	0
13	42142194	.	C	A	10	7	17	0	1	18	0	0
13	42142296	.	T	C	5	14	19	0	1	20	0	0
13	42142854	.	G	A	12	12	24	0	1	25	0	0
13	42143118	.	G	A	3	6	9	0	16	25	0	0
13	42143285	.	A	T	10	12	22	0	1	23	0	0
13	42143294	.	T	G	12	12	24	0	0	24	0	0
13	42143572	.	T	A	4	2	6	0	0	6	0	0
13	42320084	.	G	C	1	6	7	0	0	7	0	0
13	42321831	.	G	A	4	3	7	0	0	7	0	0
13	42349499	.	C	T	4	5	9	0	0	9	0	0
13	42349683	.	C	T	9	6	15	0	1	16	0	0
13	42361795	.	A	G	9	11	20	0	0	20	0	0
13	42365043	.	A	G	5	11	16	0	1	17	0	0
13	42365121	.	T	C	7	5	12	0	0	12	0	0
13	42365139	.	T	C	7	1	8	0	5	13	0	0
13	42365374	.	C	T	11	10	21	0	1	22	0	0
13	42400391	.	T	A	7	9	16	0	1	17	0	0
13	42400473	.	C	T	6	11	17	0	0	17	0	0
13	42407519	.	C	T	2	2	4	0	3	7	0	0
13	42407526	.	A	G	5	2	7	0	0	7	0	0
13	42431007	.	A	G	1	5	6	0	0	6	0	0
13	42443487	.	T	C	2	4	6	0	0	6	0	0
13	42443517	.	T	C	1	7	8	0	0	8	0	0
13	42467430	.	T	C	5	4	9	0	0	9	0	0
13	42481256	.	A	G	9	9	18	0	1	19	0	0
13	42481267	.	G	A	11	8	19	0	0	19	0	0
13	42481306	.	T	C	6	8	14	0	3	17	0	0
13	42481512	.	A	G	8	24	32	0	0	32	0	0
13	42481538	.	A	G	17	19	36	0	1	37	0	0
13	42481575	.	T	C	15	13	28	0	1	29	0	0
13	42481599	.	A	G	14	14	28	0	4	32	0	0
13	42483050	.	A	G	8	14	22	1	1	24	0	0
13	42483082	.	A	G	8	11	19	1	2	22	0	0
13	42483089	.	T	C	8	14	22	1	0	23	0	0
13	42488440	.	C	T	6	6	12	0	1	13	0	0
13	42490778	.	T	C	6	8	14	0	0	14	0	0
13	42491406	.	G	A	4	6	10	1	0	11	0	0
13	42491448	.	C	T	1	7	8	1	4	13	0	0
13	42500370	.	A	G	2	3	5	0	0	5	0	0
13	42500513	.	A	T	3	3	6	0	1	7	0	0
13	42502659	.	T	A	2	5	7	0	0	7	0	0
13	42516915	.	C	G	0	4	4	0	1	5	0	0
13	42517113	.	C	T	3	3	6	0	1	7	0	0
13	42517188	.	G	A	1	2	3	0	1	4	0	0
13	42536843	.	T	C	2	3	5	0	0	5	0	0
13	42610961	.	A	T	1	3	4	0	0	4	0	0
13	42611019	.	T	C	1	5	6	0	0	6	0	0
13	42611117	.	G	C	2	3	5	0	0	5	0	0
13	42614968	.	G	T	0	6	6	0	2	8	0	0
13	42615004	.	A	T	3	3	6	0	2	8	0	0
13	42615073	.	T	G	2	4	6	0	0	6	0	0
13	42615094	.	G	A	2	3	5	0	0	5	0	0
13	42616301	.	A	C	5	3	8	0	0	8	0	0
13	42621864	.	A	G	6	3	9	0	0	9	0	0
13	42621870	.	A	C	6	2	8	0	0	8	0	0
13	42622006	.	C	T	5	6	11	0	1	12	0	0
13	42622013	.	C	T	6	6	12	0	0	12	0	0
13	42626622	.	C	T	1	4	5	0	4	9	0	0
13	42626763	.	C	T	2	3	5	0	0	5	0	0
13	42626766	.	T	A	3	2	5	0	0	5	0	0
13	42632966	.	A	G	3	4	7	0	0	7	0	0
13	42672885	.	T	G	2	5	7	0	0	7	0	0
13	42676262	.	T	A	11	16	27	0	2	29	0	0
13	42681759	.	G	T	6	9	15	0	0	15	0	0
13	42681856	.	T	G	10	16	26	0	2	28	0	0
13	42682033	.	T	A	14	16	30	0	0	30	0	0
13	42686420	.	G	T	4	4	8	0	1	9	0	0
13	42691482	.	G	T	5	4	9	0	1	10	0	0
13	42693030	.	G	A	4	9	13	0	1	14	0	0
13	42702811	.	T	G	4	2	6	0	0	6	0	0
13	42721011	.	G	A	3	3	6	0	0	6	0	0
13	43223679	.	G	A	14	13	27	0	0	27	0	0
13	43223722	.	T	G	16	19	35	0	3	38	0	0
13	43225093	.	C	T	18	24	42	0	1	43	0	0
13	43225201	.	T	C	16	0	16	0	14	30	0	0
13	43226423	.	T	A	18	10	28	0	3	31	0	0
13	43226429	.	C	T	1	9	10	0	20	30	0	0
13	43229872	.	A	C	12	21	33	0	0	33	0	0
13	43229923	.	G	A	14	12	26	0	0	26	0	0
13	43237237	.	T	C	9	9	18	0	0	18	0	0
13	43237255	.	A	C	9	2	11	0	4	15	0	0
13	43238513	.	C	A	12	13	25	0	1	26	0	0
13	43307280	.	T	C	3	5	8	0	0	8	0	0
13	43507468	.	T	C	4	0	4	0	5	9	0	0
13	43507470	.	A	G	4	5	9	0	0	9	0	0
13	43507520	.	A	G	6	8	14	0	0	14	0	0
13	43507541	.	A	G	11	11	22	0	0	22	0	0
13	43507711	.	A	T	5	6	11	0	0	11	0	0
13	43507747	.	A	G	6	6	12	0	1	13	0	0
13	43507797	.	A	C	4	5	9	0	1	10	0	0
13	43507889	.	G	A	11	20	31	0	0	31	0	0
13	43508696	.	A	G	11	21	32	0	0	32	0	0
13	43508868	.	G	A	14	11	25	0	1	26	0	0
13	43508986	.	A	G	10	8	18	0	0	18	0	0
13	43508987	.	T	A	10	7	17	0	1	18	0	0
13	43509386	.	G	A	22	15	37	0	0	37	0	0
13	43509443	.	A	T	15	10	25	0	1	26	0	0
13	43509537	.	A	G	3	17	20	0	2	22	0	0
13	43509600	.	T	A	14	11	25	0	0	25	0	0
13	43509609	.	G	A	14	10	24	0	0	24	0	0
13	43512915	.	T	C	6	7	13	0	1	14	0	0
13	43659298	.	C	T	8	3	11	0	1	12	0	0
13	44340254	.	C	T	6	3	9	0	0	9	0	0
13	44355466	.	C	A	2	2	4	0	0	4	0	0
13	45431684	.	C	T	3	3	6	0	0	6	0	0
13	45468451	.	G	T	13	8	21	0	1	22	0	0
13	45468567	.	A	T	19	34	53	4	1	58	0	0
13	45468827	.	G	C	42	2	44	0	28	72	0	0
13	45470601	.	A	G	28	27	55	2	4	61	0	0
13	45470764	.	T	C	35	21	56	0	4	60	0	0
13	45470831	.	G	T	34	21	55	0	2	57	0	0
13	45470865	.	G	A	30	21	51	0	4	55	0	0
13	45470867	.	C	A	30	20	50	0	4	54	0	0
13	45470982	.	C	T	15	9	24	0	1	25	0	0
13	45470983	.	A	G	14	10	24	0	0	24	0	0
13	45471048	.	A	G	10	6	16	0	0	16	0	0
13	45471052	.	A	G	10	9	19	0	1	20	0	0
13	45471201	.	T	C	26	0	26	0	26	52	0	0
13	45471243	.	G	A	29	21	50	0	1	51	0	0
13	45471367	.	A	T	26	20	46	0	1	47	0	0
13	45471615	.	A	G	29	27	56	0	2	58	0	0
13	45471624	.	T	C	28	26	54	0	2	56	0	0
13	45471888	.	C	T	1	16	17	0	19	36	0	0
13	45472124	.	T	G	13	7	20	0	0	20	0	0
13	45472793	.	T	C	41	4	45	0	29	74	0	0
13	45473011	.	G	A	32	30	62	0	3	65	0	0
13	45475204	.	T	C	33	19	52	0	1	53	0	0
13	45475208	.	A	C	33	16	49	0	1	50	0	0
13	45475241	.	A	G	22	6	28	0	2	30	0	0
13	45476400	.	C	T	14	14	28	0	0	28	0	0
13	45476731	.	A	T	14	16	30	0	3	33	0	0
13	45481475	.	G	A	17	14	31	0	0	31	0	0
13	45481618	.	A	G	16	6	22	0	2	24	0	0
13	45481622	.	A	G	16	6	22	0	2	24	0	0
13	45481792	.	A	G	3	5	8	0	0	8	0	0
13	45488209	.	A	G	12	14	26	1	0	27	0	0
13	45494573	.	C	T	20	20	40	0	3	43	0	0
13	45494757	.	G	A	18	19	37	0	1	38	0	0
13	45494769	.	C	A	17	21	38	0	0	38	0	0
13	45495189	.	G	T	2	18	20	0	19	39	0	0
13	45524500	.	T	C	3	8	11	0	0	11	0	0
13	45557259	.	G	A	0	12	12	0	9	21	0	0
13	45565646	.	G	A	1	13	14	0	12	26	0	0
13	45570300	.	A	C	7	9	16	0	0	16	0	0
13	45786228	.	T	C	4	0	4	0	4	8	0	0
13	45786231	.	T	C	4	4	8	0	0	8	0	0
13	45794407	.	C	T	0	3	3	0	2	5	0	0
13	45794475	.	C	T	4	2	6	0	0	6	0	0
13	45794488	.	G	A	3	2	5	0	0	5	0	0
13	45810790	.	C	A	2	2	4	0	0	4	0	0
13	45810792	.	C	T	0	2	2	0	2	4	0	0
13	45991772	.	T	C	25	25	50	0	1	51	0	0
13	45991801	.	C	T	28	24	52	0	0	52	0	0
13	45999530	.	G	A	3	20	23	0	14	37	0	0
13	45999723	.	C	T	25	17	42	0	3	45	0	0
13	46000060	.	G	A	1	2	3	0	3	6	0	0
13	46179682	.	C	T	32	25	57	0	6	63	0	0
13	46179689	.	G	A	32	26	58	0	2	60	0	0
13	46179806	.	T	A	35	25	60	0	3	64	1	0
13	46179814	.	A	G	33	27	60	0	4	64	0	0
13	46298763	.	C	T	3	4	7	0	0	7	0	0
13	46298775	.	T	G	3	2	5	0	1	6	0	0
13	46299016	.	C	G	2	2	4	0	0	4	0	0
13	46299025	.	C	T	3	2	5	0	0	5	0	0
13	46299909	.	C	T	0	5	5	0	4	9	0	0
13	46300247	.	A	T	3	4	7	0	1	8	0	0
13	46520899	.	T	G	2	2	4	0	0	4	0	0
13	46520985	.	G	A	5	4	9	1	0	10	0	0
13	46521542	.	C	T	0	6	6	0	4	10	0	0
13	46521633	.	G	A	11	7	18	0	1	19	0	0
13	46521664	.	C	A	8	4	12	0	1	13	0	0
13	46552414	.	G	T	4	3	7	0	0	8	1	0
13	46552429	.	G	A	5	5	10	0	0	10	0	0
13	46832566	.	T	C	5	0	5	0	4	9	0	0
13	46834414	.	T	C	2	2	4	0	0	4	0	0
13	46834415	.	T	C	2	2	4	0	0	4	0	0
13	46988414	.	C	T	12	16	28	0	3	31	0	0
13	46988445	.	C	T	12	16	28	0	2	30	0	0
13	46988457	.	C	A	2	17	19	0	14	33	0	0
13	46990974	.	C	A	0	18	18	0	10	28	0	0
13	47831531	.	T	C	1	3	4	0	0	4	0	0
13	47834276	.	C	A	3	5	8	0	1	9	0	0
13	47835127	.	A	G	3	0	3	0	7	10	0	0
13	47835137	.	A	G	6	0	6	0	6	12	0	0
13	47835598	.	A	C	2	6	8	0	1	9	0	0
13	47838024	.	G	A	3	3	6	0	0	6	0	0
13	47838650	.	G	C	2	5	7	0	0	7	0	0
13	47839071	.	C	T	5	3	8	0	0	8	0	0
13	47839119	.	A	T	8	6	14	0	0	14	0	0
13	48067195	.	G	T	5	5	10	0	0	10	0	0
13	48067223	.	C	T	0	3	3	0	9	12	0	0
13	48086469	.	A	C	5	6	11	0	0	11	0	0
13	48100564	.	C	T	8	3	11	0	1	12	0	0
13	48104890	.	A	G	5	5	10	0	0	10	0	0
13	48105417	.	T	C	4	6	10	0	0	10	0	0
13	48105447	.	C	T	4	5	9	0	0	9	0	0
13	48105520	.	C	T	6	4	10	0	0	10	0	0
13	48105627	.	T	C	5	4	9	0	0	9	0	0
13	48105669	.	C	T	1	4	5	0	5	10	0	0
13	48105953	.	T	A	5	11	16	0	0	16	0	0
13	48106177	.	C	A	4	2	6	0	0	6	0	0
13	48106535	.	G	A	3	7	10	0	0	10	0	0
13	48106547	.	C	T	3	4	7	0	0	7	0	0
13	48107120	.	T	A	5	4	9	0	0	9	0	0
13	48107224	.	A	C	1	3	4	0	0	4	0	0
13	48107292	.	C	T	2	4	6	0	0	6	0	0
13	48107293	.	C	A	1	5	6	0	0	6	0	0
13	48107560	.	A	G	1	4	5	0	0	5	0	0
13	48107706	.	G	A	5	4	9	0	0	9	0	0
13	48107818	.	T	C	4	4	8	0	0	8	0	0
13	48107890	.	A	G	3	3	6	0	0	6	0	0
13	48107927	.	A	T	2	2	4	0	0	4	0	0
13	48107947	.	C	G	1	2	3	0	0	3	0	0
13	48108012	.	C	T	2	2	4	0	0	4	0	0
13	48108015	.	G	C	2	2	4	0	0	4	0	0
13	48108453	.	A	G	2	3	5	0	0	5	0	0
13	48108541	.	C	T	1	2	3	0	2	5	0	0
13	48112752	.	G	T	1	2	3	0	0	3	0	0
13	48112756	.	T	C	1	2	3	0	0	3	0	0
13	48533161	.	A	G	2	2	4	0	1	5	0	0
13	48549008	.	C	T	1	2	3	0	1	4	0	0
13	48755035	.	A	G	2	5	7	0	0	7	0	0
13	48755122	.	T	C	7	3	10	0	0	10	0	0
13	48759105	.	A	T	1	3	4	0	0	4	0	0
13	48763258	.	T	C	1	2	3	0	0	3	0	0
13	48766270	.	C	T	2	6	8	0	0	8	0	0
13	49153896	.	T	C	4	1	5	0	2	7	0	0
13	49153904	.	T	C	3	5	8	0	0	8	0	0
13	49443868	.	T	C	23	0	23	0	24	47	0	0
13	49444210	.	C	G	19	22	41	0	0	41	0	0
13	49444446	.	C	A	12	18	30	0	2	32	0	0
13	49444517	.	G	A	15	10	25	0	1	26	0	0
13	49544560	.	T	A	1	3	4	0	0	4	0	0
13	49544833	.	C	T	15	15	30	0	3	33	0	0
13	49544873	.	T	A	18	21	39	0	3	42	0	0
13	49545039	.	A	G	18	32	50	1	1	52	0	0
13	49575322	.	A	G	23	29	52	0	2	54	0	0
13	49585301	.	T	C	15	26	41	0	1	42	0	0
13	49585341	.	T	A	10	22	32	0	0	32	0	0
13	49585344	.	A	T	9	19	28	0	3	31	0	0
13	49585384	.	T	G	3	6	9	0	0	9	0	0
13	49597294	.	T	C	7	0	7	0	7	14	0	0
13	49597306	.	T	C	7	0	7	0	5	12	0	0
13	49605897	.	T	C	4	0	4	0	5	9	0	0
13	49605904	.	A	G	3	4	7	0	0	7	0	0
13	49608858	.	G	A	1	2	3	0	0	3	0	0
13	49608981	.	C	T	4	3	7	0	0	7	0	0
13	49608990	.	C	T	3	3	6	0	0	6	0	0
13	49636194	.	C	T	3	3	6	0	0	6	0	0
13	49636198	.	C	T	0	1	1	0	4	5	0	0
13	49638771	.	A	G	1	2	3	1	1	5	0	0
13	49948760	.	A	G	3	2	5	0	0	5	0	0
13	50159722	.	G	T	3	2	5	0	0	5	0	0
13	50166759	.	T	A	4	2	6	0	0	6	0	0
13	50166768	.	C	T	2	3	5	0	0	5	0	0
13	50168735	.	C	T	6	1	7	0	1	8	0	0
13	50168744	.	T	A	7	2	9	0	0	9	0	0
13	50168991	.	T	A	15	6	21	0	0	21	0	0
13	50169193	.	G	T	4	7	11	0	1	12	0	0
13	50169618	.	A	G	10	8	18	0	0	18	0	0
13	50169649	.	C	T	9	6	15	0	0	15	0	0
13	50170092	.	G	A	3	2	5	0	0	5	0	0
13	50170142	.	A	C	1	2	3	0	0	3	0	0
13	50170147	.	C	T	1	2	3	0	0	3	0	0
13	50236399	.	T	C	2	0	2	0	4	6	0	0
13	50236410	.	C	T	4	4	8	0	1	9	0	0
13	50236437	.	C	T	7	7	14	0	1	15	0	0
13	50236475	.	C	T	1	3	4	0	6	10	0	0
13	50243381	.	C	A	10	13	23	0	2	25	0	0
13	50243387	.	A	C	16	8	24	0	0	24	0	0
13	50349475	.	A	C	10	13	23	0	3	26	0	0
13	50349532	.	G	A	13	12	25	0	1	26	0	0
13	50349586	.	C	T	11	7	18	1	3	23	1	0
13	50352535	.	G	A	6	7	13	0	1	14	0	0
13	50352538	.	T	C	7	5	12	0	0	12	0	0
13	50352780	.	G	C	5	7	12	0	0	12	0	0
13	50353171	.	A	G	6	6	12	0	1	13	0	0
13	50353192	.	A	G	5	7	12	0	1	13	0	0
13	50361983	.	G	A	3	5	8	0	0	8	0	0
13	50364761	.	G	A	3	6	9	0	1	10	0	0
13	50364767	.	C	T	5	6	11	0	0	11	0	0
13	50366708	.	C	T	6	7	13	0	0	13	0	0
13	50371951	.	A	G	8	10	18	0	0	18	0	0
13	50372903	.	C	T	4	4	8	0	1	9	0	0
13	50387503	.	G	A	4	4	8	0	0	8	0	0
13	50397388	.	G	A	2	2	4	0	0	4	0	0
13	50421749	.	C	A	0	2	2	0	1	3	0	0
13	50670846	.	A	T	4	8	12	0	2	14	0	0
13	50670911	.	G	C	6	11	17	0	0	17	0	0
13	50670959	.	C	G	8	3	11	0	1	12	0	0
13	50712066	.	G	T	4	4	8	0	1	9	0	0
13	50714961	.	C	T	1	2	3	0	0	3	0	0
13	50715527	.	G	A	3	7	10	0	0	10	0	0
13	51147038	.	G	A	17	15	32	0	2	34	0	0
13	51147152	.	G	A	13	11	24	0	0	24	0	0
13	51147164	.	A	G	11	11	22	0	1	23	0	0
13	51147736	.	G	A	6	10	16	0	1	17	0	0
13	51162561	.	A	G	14	11	25	0	0	25	0	0
13	51162579	.	T	G	13	8	21	0	0	21	0	0
13	51169874	.	C	G	10	3	13	2	0	15	0	0
13	51719661	.	G	C	8	5	13	0	1	14	0	0
13	51719871	.	T	C	5	7	12	0	0	12	0	0
13	51720057	.	T	C	3	3	6	0	0	6	0	0
13	51720142	.	A	G	2	6	8	0	1	9	0	0
13	51720240	.	T	C	7	12	19	0	2	21	0	0
13	51720704	.	G	A	8	5	13	0	2	15	0	0
13	51728165	.	G	C	12	15	27	1	0	28	0	0
13	51728227	.	G	A	9	10	19	0	1	20	0	0
13	51728597	.	A	G	14	0	14	0	8	22	0	0
13	51728902	.	A	C	8	5	13	0	0	13	0	0
13	51893754	.	A	T	5	11	16	0	0	16	0	0
13	51893777	.	A	T	12	11	23	0	1	24	0	0
13	51893891	.	G	A	12	8	20	0	0	20	0	0
13	51893902	.	T	G	8	23	31	1	3	35	0	0
13	51894142	.	T	C	10	8	18	0	1	19	0	0
13	51894215	.	A	T	20	20	40	1	3	44	0	0
13	51898991	.	C	G	16	10	26	0	1	27	0	0
13	51899138	.	C	A	1	9	10	0	18	28	0	0
13	51899707	.	C	T	15	20	35	0	1	36	0	0
13	51899727	.	G	A	14	19	33	0	2	35	0	0
13	51903034	.	A	G	8	5	13	23	0	36	0	0
13	51903040	.	A	G	5	4	9	23	0	32	0	0
13	51903095	.	C	T	0	2	2	0	4	6	0	0
13	51950896	.	C	G	1	3	4	0	0	4	0	0
13	51956414	.	T	C	6	3	9	0	1	10	0	0
13	51956418	.	G	A	7	4	11	0	0	11	0	0
13	51956482	.	C	G	7	5	12	0	1	13	0	0
13	51961978	.	C	T	6	8	14	1	0	15	0	0
13	51962023	.	G	T	6	4	10	1	0	11	0	0
13	51962752	.	G	A	2	11	13	0	6	19	0	0
13	51962754	.	G	A	0	12	12	0	6	18	0	0
13	51962802	.	G	A	6	10	16	0	1	17	0	0
13	51962892	.	C	A	10	15	25	0	1	26	0	0
13	51962961	.	C	G	11	11	22	0	3	25	0	0
13	51962993	.	T	C	10	8	18	0	1	19	0	0
13	51963383	.	C	T	5	8	13	0	0	13	0	0
13	51969086	.	G	C	5	3	8	0	0	8	0	0
13	51969126	.	A	G	4	4	8	0	0	8	0	0
13	51969219	.	A	G	2	6	8	0	1	9	0	0
13	51982730	.	A	G	11	1	12	0	24	36	0	0
13	51982742	.	A	G	11	0	11	0	28	39	0	0
13	51982853	.	C	A	15	17	32	0	2	34	0	0
13	51984964	.	C	T	15	13	28	0	2	30	0	0
13	52010822	.	C	T	2	3	5	0	0	5	0	0
13	52011693	.	C	T	1	3	4	0	0	4	0	0
13	52011926	.	G	C	1	3	4	0	4	8	0	0
13	52012027	.	G	A	1	3	4	0	5	9	0	0
13	52012029	.	A	G	1	0	1	0	7	8	0	0
13	52014032	.	G	C	4	3	7	0	0	7	0	0
13	52014050	.	C	T	6	4	10	0	0	10	0	0
13	52014156	.	A	C	4	3	7	0	1	8	0	0
13	52014359	.	A	G	5	0	5	0	4	9	0	0
13	52014364	.	T	A	5	3	8	0	0	8	0	0
13	52101416	.	A	T	3	4	7	0	0	7	0	0
13	52108464	.	C	G	1	2	3	0	2	5	0	0
13	52108574	.	A	G	3	4	7	0	0	7	0	0
14	547170	.	A	G	1	4	5	0	0	5	0	0
14	548928	.	C	T	5	2	7	0	0	7	0	0
14	606255	.	A	G	3	3	6	0	0	6	0	0
14	616648	.	G	A	5	2	7	0	1	8	0	0
14	620200	.	C	A	6	4	10	0	0	10	0	0
14	684179	.	G	A	17	16	33	0	1	34	0	0
14	715123	.	G	C	4	3	7	0	0	7	0	0
14	715126	.	T	C	4	3	7	0	0	7	0	0
14	715201	.	C	T	3	4	7	0	0	7	0	0
14	715207	.	A	G	3	0	3	0	4	7	0	0
14	717845	.	G	A	0	5	5	0	5	10	0	0
14	717927	.	G	A	3	6	9	0	1	10	0	0
14	718194	.	A	C	8	3	11	0	0	11	0	0
14	719447	.	A	G	3	7	10	0	1	11	0	0
14	719926	.	A	G	3	6	9	0	1	10	0	0
14	723539	.	T	C	4	13	17	0	0	17	0	0
14	723542	.	T	C	4	10	14	0	3	17	0	0
14	729870	.	G	T	1	4	5	0	3	8	0	0
14	758581	.	T	C	3	0	3	0	2	5	0	0
14	758583	.	T	C	3	2	5	0	0	5	0	0
14	758637	.	A	G	1	2	3	0	0	3	0	0
14	761064	.	A	G	2	2	4	0	0	4	0	0
14	791067	.	C	G	4	2	6	0	3	9	0	0
14	791696	.	T	A	2	5	7	0	0	7	0	0
14	791707	.	T	A	3	6	9	0	0	9	0	0
14	792346	.	C	T	2	2	4	0	0	4	0	0
14	792350	.	A	G	2	0	2	0	2	4	0	0
14	792499	.	C	G	5	0	5	0	4	9	0	0
14	792536	.	A	C	6	4	10	0	0	10	0	0
14	863515	.	T	C	5	0	5	0	4	9	0	0
14	863767	.	A	G	7	6	13	0	1	14	0	0
14	863807	.	A	T	16	5	21	0	0	21	0	0
14	863868	.	G	T	16	11	27	0	2	29	0	0
14	863949	.	T	C	9	5	14	0	2	16	0	0
14	868838	.	G	A	13	16	29	0	0	29	0	0
14	868855	.	A	G	10	17	27	0	0	27	0	0
14	937345	.	G	A	1	2	3	0	0	3	0	0
14	937399	.	A	T	1	5	6	0	0	6	0	0
14	937849	.	A	C	1	2	3	0	1	4	0	0
14	937937	.	C	T	0	4	4	0	3	7	0	0
14	938531	.	A	C	2	2	4	0	0	4	0	0
14	938683	.	C	T	0	5	5	0	2	7	0	0
14	938688	.	T	C	2	6	8	0	0	8	0	0
14	940424	.	G	A	1	2	3	0	0	3	0	0
14	942065	.	C	T	1	2	3	0	0	3	0	0
14	942066	.	C	T	1	2	3	0	0	3	0	0
14	993835	.	A	G	4	2	6	0	0	6	0	0
14	994353	.	G	T	0	2	2	0	2	4	0	0
14	994437	.	T	C	5	4	9	0	0	9	0	0
14	997012	.	C	A	2	3	5	0	0	5	0	0
14	997273	.	T	A	6	3	9	0	0	9	0	0
14	997603	.	T	C	4	3	7	0	0	7	0	0
14	997705	.	C	A	4	5	9	0	3	12	0	0
14	997783	.	A	G	3	1	4	0	1	5	0	0
14	997853	.	C	T	2	4	6	0	0	6	0	0
14	997931	.	G	C	2	2	4	0	0	4	0	0
14	1119225	.	C	T	2	4	6	0	1	7	0	0
14	1119993	.	T	C	2	2	4	0	0	4	0	0
14	1120017	.	T	C	1	1	2	0	1	3	0	0
14	1120072	.	C	A	4	4	8	0	0	8	0	0
14	1120154	.	T	C	2	4	6	0	0	6	0	0
14	1120178	.	C	T	4	3	7	0	0	7	0	0
14	1120196	.	T	G	1	0	1	0	2	3	0	0
14	1120364	.	T	A	2	2	4	0	0	4	0	0
14	1120811	.	T	C	1	2	3	0	0	3	0	0
14	1120816	.	G	C	0	2	2	0	0	2	0	0
14	1121029	.	A	G	2	3	5	0	0	5	0	0
14	1121068	.	C	T	2	2	4	0	0	4	0	0
14	1121297	.	T	G	4	3	7	0	0	7	0	0
14	1121303	.	G	C	3	4	7	0	1	8	0	0
14	1121413	.	C	T	1	4	5	0	0	5	0	0
14	1124602	.	C	G	3	5	8	0	0	8	0	0
14	1127693	.	G	A	3	3	6	0	0	6	0	0
14	1128800	.	C	G	10	5	15	0	0	15	0	0
14	1128836	.	A	C	7	7	14	0	0	14	0	0
14	1138611	.	C	A	2	3	5	0	0	5	0	0
14	1138626	.	G	A	0	3	3	0	4	7	0	0
14	1139509	.	C	T	3	5	8	0	1	9	0	0
14	1142796	.	G	A	0	2	2	0	4	6	0	0
14	1146630	.	G	A	3	5	8	0	0	8	0	0
14	1150594	.	A	G	7	11	18	0	2	20	0	0
14	1152544	.	C	A	13	13	26	0	2	28	0	0
14	1153665	.	T	C	13	5	18	0	1	19	0	0
14	1153830	.	T	A	16	5	21	0	0	21	0	0
14	1159869	.	A	G	12	0	12	0	15	27	0	0
14	1160427	.	T	G	11	14	25	0	2	27	0	0
14	1171023	.	T	C	5	3	8	0	0	8	0	0
14	1171052	.	T	A	5	7	12	0	0	12	0	0
14	1171081	.	T	A	4	8	12	0	0	12	0	0
14	1177865	.	A	G	9	4	13	0	3	16	0	0
14	1192448	.	G	A	8	8	16	0	0	16	0	0
14	1192681	.	C	T	2	9	11	0	2	13	0	0
14	1194090	.	C	T	1	7	8	0	6	14	0	0
14	1194133	.	G	A	11	5	16	0	1	17	0	0
14	1194154	.	C	T	1	3	4	0	13	17	0	0
14	1196658	.	T	G	7	5	12	0	0	12	0	0
14	1200460	.	T	G	5	6	11	0	0	11	0	0
14	1200545	.	G	T	5	9	14	0	0	14	0	0
14	1200615	.	A	G	2	3	5	0	0	5	0	0
14	1200842	.	A	C	2	3	5	0	0	5	0	0
14	1203713	.	A	G	24	14	38	0	4	42	0	0
14	1203770	.	G	T	23	18	41	0	0	41	0	0
14	1204197	.	A	T	16	23	39	0	2	41	0	0
14	1204299	.	G	A	12	17	29	0	2	31	0	0
14	1225227	.	C	T	1	7	8	0	5	13	0	0
14	1956470	.	C	T	6	5	11	0	0	11	0	0
14	2123168	.	G	A	2	11	13	1	0	14	0	0
14	2205444	.	T	C	1	2	3	0	0	3	0	0
14	2262893	.	A	G	1	3	4	1	0	5	0	0
14	2351565	.	A	T	5	3	8	2	0	10	0	0
14	2351566	.	G	T	5	3	8	2	0	10	0	0
14	2351762	.	G	A	4	5	9	2	0	11	0	0
14	2351982	.	G	A	1	2	3	0	0	3	0	0
14	2360116	.	T	A	9	8	17	4	0	21	0	0
14	3576057	.	T	C	14	1	15	4	1	32	12	0
14	3576058	.	A	T	11	13	24	6	4	36	2	0
14	3576277	.	G	C	9	1	10	0	3	13	0	0
14	4047966	.	A	G	2	4	6	3	0	9	0	0
14	4183633	.	A	G	1	4	5	2	0	7	0	0
14	4193501	.	T	C	4	3	7	0	0	7	0	0
14	4290946	.	A	G	4	2	6	0	0	6	0	0
14	4291556	.	A	G	5	2	7	0	0	7	0	0
14	4809811	.	G	A	1	4	5	0	1	6	0	0
14	4813124	.	A	G	5	5	10	0	1	11	0	0
14	5589963	.	T	A	1	1	2	0	1	3	0	0
14	6000413	.	A	G	4	3	7	0	0	7	0	0
14	6000428	.	A	G	4	4	8	0	0	8	0	0
14	6003119	.	G	A	0	2	2	2	1	5	0	0
14	6332869	.	A	C	8	2	10	0	2	12	0	0
14	6332872	.	T	C	5	5	10	0	2	12	0	0
14	6333022	.	T	C	7	9	16	0	1	17	0	0
14	6338776	.	A	G	7	2	9	0	0	9	0	0
14	6342088	.	G	A	5	4	9	1	1	11	0	0
14	6342102	.	A	G	4	4	8	1	2	11	0	0
14	6342165	.	C	T	0	3	3	1	1	5	0	0
14	6342201	.	T	C	1	5	6	0	0	6	0	0
14	6624621	.	A	G	6	27	33	0	1	34	0	0
14	6625002	.	A	C	33	13	46	4	7	57	0	0
14	6625521	.	G	C	21	35	56	1	3	60	0	0
14	6625794	.	A	G	5	17	22	0	1	23	0	0
14	6625805	.	A	G	16	7	23	0	0	23	0	0
14	7020391	.	C	T	0	2	2	0	1	3	0	0
14	7170558	.	T	C	2	19	21	0	0	21	0	0
14	7170559	.	T	C	2	19	21	0	0	21	0	0
14	7171828	.	T	C	8	4	12	0	0	12	0	0
14	7176728	.	T	G	1	12	13	0	0	13	0	0
14	7186690	.	C	T	0	2	2	0	2	4	0	0
14	7916052	.	A	G	6	7	13	0	1	14	0	0
14	7916066	.	A	G	4	4	8	0	0	8	0	0
14	8268449	.	A	G	5	2	7	0	0	7	0	0
14	8270284	.	C	T	1	2	3	0	2	5	0	0
14	8436475	.	C	T	7	3	10	0	0	10	0	0
14	8495668	.	A	T	2	2	4	0	0	4	0	0
14	8571298	.	T	C	0	9	9	0	0	9	0	0
14	8571299	.	C	G	1	0	1	0	9	10	0	0
14	8571928	.	A	G	11	4	15	0	0	15	0	0
14	8770425	.	A	G	9	4	13	0	2	15	0	0
14	8770436	.	A	C	8	6	14	0	2	16	0	0
14	8770589	.	C	T	5	3	8	0	0	8	0	0
14	8806587	.	A	C	1	0	1	0	6	7	0	0
14	8806590	.	A	G	2	5	7	0	0	7	0	0
14	8806680	.	T	C	9	6	15	0	0	15	0	0
14	8806722	.	A	G	13	4	17	0	1	18	0	0
14	8806730	.	G	T	11	5	16	0	1	17	0	0
14	8809693	.	A	G	10	9	19	0	8	27	0	0
14	8816113	.	T	C	6	7	13	0	0	13	0	0
14	8816135	.	A	T	9	7	16	0	1	17	0	0
14	8816194	.	C	T	7	11	18	0	1	19	0	0
14	8816261	.	G	A	16	2	18	0	1	19	0	0
14	8816283	.	T	G	12	5	17	0	0	17	0	0
14	8816457	.	A	G	5	7	12	0	0	12	0	0
14	8816482	.	A	T	5	7	12	0	0	12	0	0
14	8816695	.	C	G	4	6	10	0	0	10	0	0
14	8816755	.	A	C	9	2	11	1	6	18	0	0
14	8816782	.	G	A	11	9	20	0	1	21	0	0
14	8816848	.	A	G	13	11	24	2	3	29	0	0
14	8816877	.	C	A	1	5	6	2	14	22	0	0
14	8819082	.	T	C	10	0	10	0	6	16	0	0
14	8821677	.	G	A	5	7	12	0	1	13	0	0
14	8830236	.	G	T	8	6	14	0	0	14	0	0
14	8830302	.	C	T	0	7	7	0	3	10	0	0
14	8832736	.	A	C	3	2	5	0	0	5	0	0
14	8836160	.	G	A	3	7	10	0	0	10	0	0
14	8836298	.	T	C	4	5	9	0	0	9	0	0
14	8841352	.	A	T	7	7	14	0	0	14	0	0
14	8844045	.	G	A	3	5	8	0	0	8	0	0
14	8947464	.	A	T	13	6	19	0	0	19	0	0
14	8947497	.	C	A	8	6	14	0	0	14	0	0
14	8951108	.	A	G	1	0	1	0	4	5	0	0
14	8982390	.	C	T	8	13	21	0	0	21	0	0
14	8991718	.	A	T	10	16	26	0	1	27	0	0
14	8991823	.	T	C	7	15	22	0	1	23	0	0
14	9001411	.	G	A	12	16	28	0	0	28	0	0
14	9001426	.	C	T	13	17	30	0	0	30	0	0
14	9001752	.	C	G	7	3	10	0	19	29	0	0
14	9001875	.	T	C	12	17	29	0	0	29	0	0
14	9033783	.	G	A	3	8	11	0	0	11	0	0
14	9034114	.	A	G	2	3	5	0	0	5	0	0
14	9034128	.	T	G	4	4	8	0	0	8	0	0
14	9034161	.	C	T	3	4	7	0	0	7	0	0
14	9034307	.	G	A	4	10	14	0	0	14	0	0
14	9034430	.	T	C	16	5	21	0	0	21	0	0
14	9034701	.	C	T	0	6	6	0	7	13	0	0
14	9034742	.	C	T	9	6	15	0	1	16	0	0
14	9034743	.	T	C	8	0	8	0	8	16	0	0
14	9035051	.	C	G	8	8	16	0	0	16	0	0
14	9035100	.	C	T	9	10	19	0	1	20	0	0
14	9035110	.	C	T	0	7	7	0	11	18	0	0
14	9035175	.	G	A	5	2	7	0	0	7	0	0
14	9035249	.	G	T	4	4	8	0	0	8	0	0
14	9035740	.	A	G	8	7	15	0	0	15	0	0
14	9035786	.	C	G	7	4	11	0	1	12	0	0
14	9035866	.	A	G	8	4	12	0	1	13	0	0
14	9035873	.	T	C	11	5	16	0	0	16	0	0
14	9036134	.	C	G	7	3	10	0	1	11	0	0
14	9036219	.	A	T	6	4	10	0	0	10	0	0
14	9036255	.	T	C	5	3	8	0	0	8	0	0
14	9036480	.	C	T	1	2	3	0	0	3	0	0
14	9040928	.	C	A	5	9	14	0	3	17	0	0
14	9142412	.	A	T	9	8	17	0	0	17	0	0
14	9142602	.	A	T	24	26	50	0	2	52	0	0
14	9142795	.	T	C	21	18	39	0	1	40	0	0
14	9142893	.	T	C	17	0	17	0	15	32	0	0
14	9142911	.	T	C	22	0	22	0	15	37	0	0
14	9142952	.	C	T	4	19	23	0	17	40	0	0
14	9143081	.	G	C	24	0	24	0	26	50	0	0
14	9143150	.	A	C	28	1	29	2	10	41	0	0
14	9143179	.	C	T	1	15	16	2	28	46	0	0
14	9143427	.	A	T	19	20	39	0	1	40	0	0
14	9143446	.	T	C	15	1	16	0	14	30	0	0
14	9143878	.	T	C	25	13	38	1	4	43	0	0
14	9144099	.	T	C	20	23	43	0	2	45	0	0
14	9144191	.	A	G	20	18	38	0	2	40	0	0
14	9144248	.	A	G	8	14	22	0	0	22	0	0
14	9144361	.	A	G	7	15	22	0	1	23	0	0
14	9144658	.	A	G	7	10	17	0	0	17	0	0
14	9145050	.	G	A	18	20	38	0	0	38	0	0
14	9157880	.	T	A	15	20	35	0	2	37	0	0
14	9158367	.	A	G	22	9	31	0	3	34	0	0
14	9159845	.	A	G	18	19	37	0	1	38	0	0
14	9159860	.	G	C	20	0	20	0	17	37	0	0
14	9163286	.	G	A	17	15	32	0	2	34	0	0
14	9173909	.	C	T	21	6	27	0	1	28	0	0
14	9177619	.	G	A	15	11	26	0	0	26	0	0
14	9344247	.	G	A	14	8	22	0	0	22	0	0
14	9344250	.	C	T	15	9	24	0	0	24	0	0
14	9344366	.	T	G	4	6	10	0	2	12	0	0
14	9346881	.	C	T	3	2	5	0	0	5	0	0
14	9405728	.	G	C	8	0	8	0	9	17	0	0
14	9405760	.	T	C	2	11	13	0	0	13	0	0
14	9406070	.	A	G	2	2	4	0	0	4	0	0
14	9406320	.	T	C	7	0	7	0	8	15	0	0
14	9406453	.	A	T	9	5	14	0	0	14	0	0
14	9406485	.	A	G	11	6	17	0	1	18	0	0
14	9406509	.	T	C	12	8	20	0	0	20	0	0
14	9406607	.	T	C	4	7	11	0	1	12	0	0
14	9406773	.	T	A	5	6	11	0	0	11	0	0
14	9406791	.	A	G	3	9	12	0	0	12	0	0
14	9407074	.	A	T	5	4	9	0	1	10	0	0
14	9407707	.	C	T	2	5	7	0	0	7	0	0
14	9407763	.	A	G	5	2	7	0	0	7	0	0
14	9408260	.	C	G	8	8	16	0	0	16	0	0
14	9408320	.	T	G	5	9	14	0	0	14	0	0
14	9420810	.	G	A	2	4	6	0	0	6	0	0
14	9420871	.	C	A	4	6	10	0	0	10	0	0
14	9469559	.	T	C	2	2	4	0	0	4	0	0
14	9475490	.	G	C	5	2	7	0	0	7	0	0
14	9475716	.	A	T	1	3	4	0	0	4	0	0
14	9475717	.	G	T	1	3	4	0	0	4	0	0
14	9481647	.	C	A	5	4	9	0	0	9	0	0
14	9481924	.	C	T	5	4	9	0	1	10	0	0
14	9481926	.	G	T	5	5	10	0	0	10	0	0
14	9482062	.	A	G	3	3	6	0	1	7	0	0
14	9485121	.	A	T	5	3	8	0	1	9	0	0
14	9485366	.	T	A	5	7	12	0	0	12	0	0
14	9494939	.	A	G	8	1	9	0	8	17	0	0
14	9495107	.	G	A	0	8	8	0	11	19	0	0
14	9498163	.	C	T	5	7	12	0	0	12	0	0
14	9498308	.	G	A	6	6	12	0	0	12	0	0
14	9498570	.	C	T	13	4	17	0	0	17	0	0
14	9498728	.	A	T	7	5	12	0	0	12	0	0
14	9498841	.	C	G	16	7	23	0	1	24	0	0
14	9498879	.	T	A	12	10	22	0	0	22	0	0
14	9499048	.	G	T	8	8	16	0	0	16	0	0
14	9581982	.	G	A	2	2	4	0	0	4	0	0
14	9587639	.	A	G	4	2	6	0	0	6	0	0
14	9588145	.	G	A	2	4	6	0	0	6	0	0
14	9588210	.	G	A	0	2	2	0	2	4	0	0
14	9588221	.	G	C	2	2	4	0	0	4	0	0
14	9589627	.	C	T	4	2	6	0	0	6	0	0
14	9589719	.	G	A	1	5	6	0	0	6	0	0
14	9589731	.	G	T	1	6	7	0	1	8	0	0
14	9590716	.	T	C	3	3	6	0	0	6	0	0
14	9590879	.	G	A	4	2	6	1	1	8	0	0
14	9590909	.	A	G	4	3	7	0	0	7	0	0
14	9591144	.	T	C	2	2	4	0	0	4	0	0
14	9592756	.	T	C	1	2	3	0	0	3	0	0
14	9593505	.	A	G	29	15	44	0	3	47	0	0
14	9593610	.	T	A	18	14	32	0	1	33	0	0
14	9593622	.	A	T	17	16	33	0	0	33	0	0
14	9593974	.	C	T	22	10	32	0	1	33	0	0
14	9594380	.	G	A	4	12	16	1	0	17	0	0
14	9594466	.	G	A	7	10	17	0	2	19	0	0
14	9594577	.	C	T	9	12	21	0	0	21	0	0
14	9594578	.	A	G	9	12	21	0	0	21	0	0
14	9594623	.	C	T	10	7	17	0	1	18	0	0
14	9594677	.	G	C	11	6	17	0	0	17	0	0
14	9595086	.	A	C	15	4	19	0	1	20	0	0
14	9595119	.	G	A	11	12	23	0	0	23	0	0
14	9595330	.	T	C	9	12	21	0	2	23	0	0
14	9595373	.	T	C	13	6	19	0	1	20	0	0
14	9595401	.	A	G	5	7	12	0	0	12	0	0
14	9595427	.	C	T	1	9	10	0	0	10	0	0
14	9595593	.	T	G	2	4	6	0	0	6	0	0
14	9595890	.	C	T	9	14	23	0	0	23	0	0
14	9595992	.	C	A	16	15	31	0	1	32	0	0
14	9596338	.	C	T	15	8	23	0	0	23	0	0
14	9717978	.	C	A	0	11	11	0	5	16	0	0
14	9739987	.	G	T	4	6	10	0	1	11	0	0
14	9821794	.	C	T	0	2	2	0	3	5	0	0
14	10338670	.	G	A	2	2	4	0	0	4	0	0
14	10338942	.	A	G	5	4	9	0	0	9	0	0
14	10339325	.	T	G	7	3	10	0	1	11	0	0
14	10339333	.	T	G	9	3	12	0	0	12	0	0
14	10339883	.	A	C	19	13	32	0	0	32	0	0
14	10339943	.	A	G	13	12	25	0	1	26	0	0
14	10340068	.	G	A	12	11	23	0	1	24	0	0
14	10340096	.	G	A	6	15	21	0	0	21	0	0
14	10340189	.	T	A	17	9	26	0	1	27	0	0
14	10340193	.	C	G	19	8	27	0	0	27	0	0
14	10340250	.	A	T	14	5	19	0	1	20	0	0
14	10340288	.	C	A	12	6	18	0	0	18	0	0
14	10340358	.	G	A	10	11	21	0	0	21	0	0
14	10340606	.	A	G	18	5	23	0	2	25	0	0
14	10340642	.	T	A	19	7	26	0	0	26	0	0
14	10340840	.	C	A	20	16	36	0	0	36	0	0
14	10341237	.	A	T	5	2	7	0	0	7	0	0
14	10341586	.	C	T	2	9	11	0	6	17	0	0
14	10341627	.	A	T	9	11	20	0	1	21	0	0
14	10341690	.	G	T	8	11	19	0	0	19	0	0
14	10341703	.	T	C	7	1	8	0	7	15	0	0
14	10341966	.	A	C	8	10	18	0	1	19	0	0
14	10342066	.	A	G	6	3	9	3	1	13	0	0
14	10342076	.	T	C	7	4	11	3	0	14	0	0
14	10342246	.	G	T	1	3	4	0	0	4	0	0
14	10342379	.	A	C	5	1	6	0	9	15	0	0
14	10342570	.	G	A	11	6	17	0	0	17	0	0
14	10342591	.	C	A	0	7	7	0	12	19	0	0
14	10342726	.	A	G	2	5	7	0	0	7	0	0
14	10342926	.	G	A	8	2	10	0	1	11	0	0
14	10342929	.	T	A	9	3	12	0	0	12	0	0
14	10342971	.	G	T	6	4	10	1	0	11	0	0
14	10343050	.	C	T	6	2	8	0	0	8	0	0
14	10343052	.	C	G	5	2	7	0	0	7	0	0
14	10343112	.	C	T	3	3	6	0	0	6	0	0
14	10343678	.	A	T	8	5	13	0	0	13	0	0
14	10343686	.	T	C	5	0	5	0	5	10	0	0
14	10343866	.	G	A	6	7	13	0	1	14	0	0
14	10344032	.	A	C	7	2	9	0	0	9	0	0
14	10344075	.	C	A	7	2	9	0	0	9	0	0
14	10344218	.	G	A	4	5	9	0	0	9	0	0
14	10344451	.	C	T	12	3	15	0	1	16	0	0
14	10348091	.	T	C	4	4	8	0	2	10	0	0
14	10356817	.	A	C	4	0	4	0	2	6	0	0
14	10356826	.	G	C	5	3	8	0	0	8	0	0
14	10365510	.	T	C	7	2	9	0	0	9	0	0
14	10374973	.	T	A	1	2	3	0	0	3	0	0
14	10379652	.	G	A	6	4	10	0	1	11	0	0
14	10384529	.	C	T	4	2	6	0	0	6	0	0
14	10384607	.	T	A	2	4	6	0	1	7	0	0
14	10387371	.	G	T	1	2	3	0	0	3	0	0
14	10987761	.	C	A	1	3	4	0	0	4	0	0
14	11002504	.	T	C	2	2	4	0	0	4	0	0
14	11044444	.	A	G	1	7	8	0	1	9	0	0
14	11048599	.	A	G	1	7	8	0	0	8	0	0
14	11053934	.	G	C	5	6	11	0	0	11	0	0
14	11069560	.	C	T	10	7	17	0	2	19	0	0
14	11069593	.	C	T	10	7	17	0	0	17	0	0
14	11070008	.	C	T	4	4	8	0	0	8	0	0
14	11070018	.	T	A	3	4	7	0	0	7	0	0
14	11234718	.	G	A	3	2	5	0	0	5	0	0
14	11261691	.	C	T	4	2	6	0	0	6	0	0
14	11261718	.	T	C	4	3	7	0	0	7	0	0
14	11262084	.	T	C	3	3	6	0	0	6	0	0
14	11263017	.	A	G	2	0	2	0	4	6	0	0
14	11263096	.	C	A	2	4	6	0	0	6	0	0
14	11263479	.	T	A	2	4	6	0	0	6	0	0
14	11263899	.	A	G	3	0	3	0	5	8	0	0
14	11264058	.	C	T	3	5	8	0	0	8	0	0
14	11264726	.	A	T	9	6	15	0	3	18	0	0
14	11265310	.	A	G	5	6	11	0	0	11	0	0
14	11265312	.	T	C	5	6	11	0	0	11	0	0
14	11265567	.	C	T	4	9	13	0	0	13	0	0
14	11265966	.	A	G	2	3	5	0	0	5	0	0
14	11266153	.	C	T	4	10	14	0	0	14	0	0
14	11266644	.	A	T	5	6	11	0	0	11	0	0
14	11267900	.	A	T	20	6	26	0	0	26	0	0
14	11290986	.	T	C	2	4	6	0	0	6	0	0
14	11300058	.	T	C	9	4	13	0	0	13	0	0
14	11300154	.	G	A	3	4	7	0	1	8	0	0
14	11300179	.	T	G	3	3	6	0	0	6	0	0
14	11300238	.	G	A	5	4	9	0	0	9	0	0
14	11300298	.	C	T	5	3	8	0	0	8	0	0
14	11301027	.	G	A	10	8	18	0	2	20	0	0
14	11301069	.	A	G	13	0	13	0	9	22	0	0
14	11302190	.	C	A	7	7	14	0	1	15	0	0
14	11302492	.	G	A	3	2	5	0	0	5	0	0
14	11302518	.	A	G	2	2	4	0	0	4	0	0
14	11302565	.	T	A	1	3	4	0	0	4	0	0
14	11302662	.	C	A	2	2	4	0	0	4	0	0
14	11303025	.	A	G	3	0	3	0	4	7	0	0
14	11303157	.	A	C	4	3	7	0	0	7	0	0
14	11303867	.	G	T	2	2	4	0	0	4	0	0
14	11303895	.	G	T	2	2	4	0	0	4	0	0
14	11303973	.	C	T	2	2	4	0	0	4	0	0
14	11979548	.	A	G	6	3	9	0	0	9	0	0
14	12003430	.	T	G	2	2	4	0	0	4	0	0
14	12021308	.	C	G	8	6	14	1	0	15	0	0
14	12021366	.	T	C	5	2	7	0	1	8	0	0
14	12021610	.	T	G	1	3	4	0	0	4	0	0
14	12021926	.	A	T	11	4	15	0	0	15	0	0
14	12022056	.	C	T	4	6	10	0	0	10	0	0
14	12036538	.	C	G	4	4	8	0	0	8	0	0
14	12036731	.	A	G	4	5	9	0	1	10	0	0
14	12036768	.	A	C	4	0	4	0	8	12	0	0
14	12050577	.	T	C	3	3	6	0	0	6	0	0
14	12069754	.	C	T	27	9	36	2	2	40	0	0
14	12071446	.	A	G	12	13	25	0	1	26	0	0
14	12077109	.	C	T	7	4	11	0	0	11	0	0
14	12085165	.	T	C	7	13	20	0	0	20	0	0
14	12085267	.	G	A	10	7	17	0	1	18	0	0
14	12089512	.	G	T	5	3	8	0	0	8	0	0
14	12110744	.	A	G	2	0	2	0	2	4	0	0
14	12110887	.	A	C	2	2	4	0	0	4	0	0
14	12111019	.	C	T	3	2	5	0	0	5	0	0
14	12157456	.	C	T	13	10	23	0	0	23	0	0
14	12159384	.	C	G	17	17	34	0	0	34	0	0
14	12162692	.	C	T	20	16	36	0	3	39	0	0
14	12162731	.	A	C	19	18	37	0	3	40	0	0
14	12164364	.	C	A	24	36	60	0	1	61	0	0
14	12166656	.	A	G	26	24	50	0	0	50	0	0
14	12166956	.	C	T	17	23	40	0	0	40	0	0
14	12166974	.	A	G	16	22	38	0	2	40	0	0
14	12167321	.	T	A	20	20	40	0	2	42	0	0
14	12167615	.	G	A	1	4	5	0	14	19	0	0
14	12175914	.	A	G	1	2	3	0	0	3	0	0
14	12179114	.	T	C	6	2	8	0	0	8	0	0
14	12179124	.	T	A	5	2	7	0	0	7	0	0
14	12189019	.	T	C	2	3	5	0	0	5	0	0
14	12189856	.	C	T	7	4	11	0	0	11	0	0
14	12191579	.	T	A	10	10	20	0	0	20	0	0
14	12191615	.	A	G	10	0	10	0	10	20	0	0
14	12205329	.	T	C	11	5	16	0	0	16	0	0
14	12205521	.	C	T	14	6	20	0	1	25	4	0
14	12205566	.	T	C	13	12	25	0	4	29	0	0
14	12428324	.	G	T	3	5	8	0	0	8	0	0
14	12436937	.	T	C	3	3	6	0	1	7	0	0
14	12452477	.	C	T	3	6	9	0	1	10	0	0
14	12452516	.	G	A	0	7	7	0	9	16	0	0
14	12465519	.	C	A	4	10	14	0	2	16	0	0
14	12472233	.	C	T	12	7	19	0	2	21	0	0
14	12473599	.	T	A	6	7	13	1	1	15	0	0
14	12473932	.	T	C	6	7	13	0	1	14	0	0
14	12473992	.	A	T	2	5	7	0	1	8	0	0
14	12474159	.	T	C	6	6	12	0	1	13	0	0
14	12481591	.	C	T	5	4	9	0	0	9	0	0
14	12481600	.	T	C	3	3	6	0	0	6	0	0
14	12486294	.	C	T	4	4	8	0	4	12	0	0
14	12535403	.	T	G	24	20	44	0	1	45	0	0
14	12535622	.	G	T	27	17	44	0	3	47	0	0
14	12535775	.	G	T	13	9	22	0	1	23	0	0
14	12536420	.	T	G	25	23	48	0	7	55	0	0
14	12554812	.	T	C	7	22	29	0	0	30	1	0
14	12605791	.	T	C	12	5	17	0	0	17	0	0
14	12605900	.	T	C	12	6	18	0	1	19	0	0
14	12608172	.	A	G	4	2	6	0	0	6	0	0
14	12635951	.	T	C	6	3	9	0	0	9	0	0
14	12636012	.	A	T	2	3	5	0	0	5	0	0
14	12837003	.	C	T	4	5	9	0	0	9	0	0
14	12837079	.	A	G	6	5	11	0	1	12	0	0
14	13524092	.	A	G	2	5	7	0	1	8	0	0
14	13525082	.	A	G	4	6	10	0	1	11	0	0
14	14094032	.	C	T	1	2	3	0	1	4	0	0
14	14225233	.	C	G	6	6	12	0	0	12	0	0
14	14225257	.	C	T	11	2	13	0	0	13	0	0
14	14315233	.	C	T	2	4	6	0	0	6	0	0
14	14502450	.	C	T	7	3	10	0	0	10	0	0
14	14502708	.	T	C	11	7	18	0	0	18	0	0
14	14502846	.	C	T	9	6	15	0	0	15	0	0
14	14502885	.	C	T	6	12	18	0	0	18	0	0
14	14532450	.	T	C	15	18	33	0	2	35	0	0
14	14532696	.	T	G	23	24	47	0	3	50	0	0
14	14532831	.	A	G	12	7	19	0	2	21	0	0
14	14534219	.	G	A	11	8	19	0	0	19	0	0
14	14593175	.	T	C	6	3	9	0	0	9	0	0
14	14593624	.	A	G	2	4	6	0	1	7	0	0
14	14595535	.	A	G	1	4	5	0	0	5	0	0
14	14595576	.	T	G	3	4	7	0	0	7	0	0
14	14595695	.	A	C	3	3	6	0	0	6	0	0
14	14595734	.	C	G	7	5	12	0	1	13	0	0
14	14596121	.	T	G	7	4	11	0	0	11	0	0
14	14596176	.	T	C	8	3	11	0	1	12	0	0
14	14604525	.	G	A	2	3	5	0	0	5	0	0
14	14617631	.	C	A	2	2	4	0	1	5	0	0
14	14617666	.	G	A	0	2	2	0	2	4	0	0
14	14662597	.	A	T	22	22	44	0	1	45	0	0
14	14662606	.	A	G	17	24	41	0	2	43	0	0
14	14662663	.	C	T	20	12	32	0	1	34	1	0
14	14662684	.	C	T	19	14	33	0	4	37	0	0
14	14664974	.	T	C	4	16	20	0	2	22	0	0
14	14664998	.	G	A	6	14	20	0	0	20	0	0
14	14665175	.	T	C	21	12	33	0	1	34	0	0
14	14665432	.	A	G	1	2	3	0	0	3	0	0
14	14665502	.	C	G	3	3	6	0	0	6	0	0
14	14666173	.	A	T	8	6	14	0	1	15	0	0
14	14666394	.	G	A	11	9	20	0	0	20	0	0
14	14690710	.	G	T	14	13	27	2	2	31	0	0
14	14690831	.	C	A	7	9	16	36	0	52	0	0
14	14690837	.	G	A	5	7	12	38	1	51	0	0
14	14694930	.	A	G	17	22	39	0	2	41	0	0
14	14695136	.	A	G	19	11	30	1	2	33	0	0
14	14695181	.	A	G	15	20	35	1	0	36	0	0
14	14695864	.	T	C	14	0	14	0	13	27	0	0
14	14722530	.	A	T	8	9	17	0	1	18	0	0
14	14722556	.	T	C	8	12	20	0	0	20	0	0
14	14723302	.	T	C	4	8	12	0	1	13	0	0
14	14723331	.	T	C	7	5	12	0	2	14	0	0
14	14723381	.	A	T	8	8	16	0	0	16	0	0
14	14723410	.	G	T	6	7	13	0	0	14	1	0
14	14724026	.	C	T	5	2	7	0	1	8	0	0
14	14724951	.	G	A	30	25	55	0	1	56	0	0
14	14724953	.	A	G	33	21	54	0	4	58	0	0
14	14724987	.	G	A	26	29	55	0	1	56	0	0
14	14725132	.	A	T	32	11	43	2	6	51	0	0
14	14725314	.	G	A	33	26	59	0	2	61	0	0
14	14728192	.	G	T	18	8	26	31	3	60	0	0
14	14729069	.	G	A	30	23	53	1	3	57	0	0
14	14739116	.	T	C	4	12	16	0	2	18	0	0
14	14836656	.	T	C	4	4	8	0	0	8	0	0
14	14837693	.	T	C	6	2	8	0	0	8	0	0
14	14837729	.	A	C	4	2	6	0	1	7	0	0
14	14844658	.	T	G	7	3	10	0	0	10	0	0
14	14845532	.	G	A	1	4	5	0	1	6	0	0
14	14852142	.	T	A	3	3	6	0	1	7	0	0
14	14854654	.	G	A	0	2	2	0	6	8	0	0
14	14855017	.	T	C	6	2	8	0	0	8	0	0
14	14855057	.	C	T	3	3	6	0	1	7	0	0
14	14855205	.	C	G	7	4	11	0	1	12	0	0
14	15070912	.	A	G	3	4	7	0	0	7	0	0
14	15071502	.	C	T	5	5	10	1	0	11	0	0
14	15086220	.	G	A	6	4	10	0	1	11	0	0
14	15099780	.	T	C	3	2	5	0	0	5	0	0
14	15155845	.	T	A	3	2	5	0	0	5	0	0
14	15155901	.	A	G	6	1	7	0	4	11	0	0
14	15155955	.	T	G	2	4	6	0	0	6	0	0
14	15662795	.	G	C	12	6	18	0	0	18	0	0
14	15662836	.	A	T	7	6	13	0	0	14	1	0
14	15663014	.	C	T	4	6	10	1	0	11	0	0
14	15663178	.	T	C	3	1	4	0	0	4	0	0
14	15663184	.	T	C	3	2	5	0	0	5	0	0
14	15663237	.	T	C	6	3	9	0	0	9	0	0
14	15664251	.	T	A	6	7	13	0	1	14	0	0
14	15664263	.	T	C	5	7	12	0	1	13	0	0
14	15664288	.	C	T	4	5	9	0	2	11	0	0
14	15664942	.	T	C	1	0	1	0	2	3	0	0
14	15677790	.	C	T	0	2	2	0	6	8	0	0
14	15677831	.	G	A	5	2	7	0	1	8	0	0
14	15677882	.	C	T	2	3	5	0	1	6	0	0
14	15677907	.	A	G	1	2	3	0	0	3	0	0
14	15678362	.	G	A	5	3	8	0	1	9	0	0
14	15800616	.	C	A	3	2	5	0	0	5	0	0
14	15800625	.	C	A	3	2	5	0	0	5	0	0
14	15812577	.	A	G	5	4	9	0	0	9	0	0
14	15812685	.	C	T	2	2	4	0	0	4	0	0
14	15812732	.	A	C	1	3	4	0	0	4	0	0
14	15812762	.	T	A	2	2	4	0	0	4	0	0
14	15813702	.	G	T	6	7	13	0	1	14	0	0
14	15813792	.	C	T	1	2	3	0	0	3	0	0
14	15814770	.	C	T	4	4	8	0	0	8	0	0
14	15814856	.	A	T	1	4	5	0	1	6	0	0
14	15814887	.	T	G	2	2	4	0	1	5	0	0
14	15973920	.	G	A	4	8	12	0	1	13	0	0
14	15973981	.	C	A	4	2	6	0	1	7	0	0
14	15974188	.	T	A	3	3	6	0	0	6	0	0
14	15974232	.	G	A	5	4	9	0	0	9	0	0
14	15974313	.	A	G	5	8	13	0	0	13	0	0
14	15980828	.	T	A	2	3	5	0	0	5	0	0
14	15983590	.	T	C	3	2	5	0	0	5	0	0
14	15983792	.	G	A	3	4	7	0	0	7	0	0
14	15983824	.	C	A	0	4	4	0	1	5	0	0
14	16042530	.	C	A	9	5	14	0	0	14	0	0
14	16069264	.	A	C	5	3	8	0	0	8	0	0
14	16084339	.	C	T	2	4	6	0	0	6	0	0
14	16090261	.	C	T	10	9	19	0	0	19	0	0
14	16090764	.	T	C	6	10	16	0	0	16	0	0
14	16090939	.	A	C	12	14	26	0	0	26	0	0
14	16091586	.	T	A	10	10	20	0	1	22	1	0
14	16091709	.	T	G	7	7	14	0	1	16	1	0
14	16093983	.	G	A	15	5	20	0	3	23	0	0
14	16095683	.	A	G	8	9	17	0	0	17	0	0
14	16097204	.	T	A	6	7	13	0	0	13	0	0
14	16115353	.	A	G	8	7	15	0	1	16	0	0
14	16122866	.	T	C	25	15	40	0	0	40	0	0
14	16122913	.	G	A	1	15	16	0	16	32	0	0
14	16127308	.	C	T	9	7	16	0	0	16	0	0
14	16127346	.	G	T	8	5	13	0	3	16	0	0
14	16127362	.	C	A	2	7	9	0	10	19	0	0
14	16130167	.	C	G	20	11	31	0	1	32	0	0
14	16145112	.	T	A	2	4	6	0	1	7	0	0
14	16178079	.	A	G	1	3	4	0	0	4	0	0
14	16435150	.	G	A	24	24	48	0	0	48	0	0
14	16484713	.	A	G	1	6	7	0	0	7	0	0
14	16484763	.	C	T	0	3	3	0	2	5	0	0
14	16485222	.	C	T	1	12	13	0	4	17	0	0
14	16606649	.	C	A	1	5	6	0	5	11	0	0
14	16754060	.	C	T	0	4	4	0	1	5	0	0
14	16754192	.	A	C	4	5	9	0	0	9	0	0
14	16769067	.	A	G	12	12	24	0	2	26	0	0
14	16769109	.	T	C	16	13	29	0	0	29	0	0
14	16769189	.	C	T	12	10	22	0	2	24	0	0
14	16769246	.	C	T	8	10	18	0	2	20	0	0
14	16769478	.	A	G	17	5	22	0	1	23	0	0
14	16769481	.	T	C	15	8	23	0	0	23	0	0
14	16769550	.	A	G	12	0	12	0	19	31	0	0
14	16770338	.	T	A	17	13	30	0	0	30	0	0
14	16770646	.	C	A	17	15	32	0	0	32	0	0
14	16770847	.	C	T	18	17	35	0	1	36	0	0
14	16770959	.	T	A	10	10	20	0	1	21	0	0
14	16771194	.	A	T	4	3	7	0	0	7	0	0
14	16771265	.	A	T	7	5	12	0	2	14	0	0
14	16771339	.	T	C	6	6	12	0	0	12	0	0
14	16771340	.	A	G	5	0	5	0	7	12	0	0
14	16777708	.	T	C	1	2	3	0	0	3	0	0
14	16777743	.	T	G	1	3	4	0	0	4	0	0
14	16778086	.	G	A	3	4	7	0	0	7	0	0
14	16790722	.	A	T	1	4	5	0	0	5	0	0
14	16814007	.	C	T	6	2	8	0	2	10	0	0
14	16907721	.	C	T	2	2	4	0	0	4	0	0
14	16947242	.	G	A	7	4	11	0	0	11	0	0
14	16968227	.	T	C	3	3	6	0	0	6	0	0
14	16968260	.	C	T	3	2	5	0	1	6	0	0
14	16968302	.	T	C	3	3	6	0	1	7	0	0
14	16996869	.	T	C	3	3	6	0	0	6	0	0
14	16996870	.	G	A	3	3	6	0	0	6	0	0
14	17003333	.	G	A	2	8	10	0	1	11	0	0
14	17003628	.	G	A	5	7	12	0	0	12	0	0
14	17016650	.	C	T	14	6	20	0	0	20	0	0
14	17025109	.	A	T	15	5	20	0	0	20	0	0
14	17025116	.	G	A	12	3	15	0	1	16	0	0
14	17025176	.	C	A	8	7	15	0	1	16	0	0
14	17025200	.	G	A	4	5	9	0	1	10	0	0
14	17025472	.	T	A	8	5	13	0	1	14	0	0
14	17025538	.	A	G	10	2	12	1	2	15	0	0
14	17025539	.	A	G	12	2	14	1	0	15	0	0
14	17025579	.	A	G	6	5	11	0	0	11	0	0
14	17025586	.	C	T	6	4	10	0	0	10	0	0
14	17025807	.	T	C	8	8	16	0	0	16	0	0
14	17026103	.	G	A	9	3	12	1	1	14	0	0
14	17026534	.	G	A	4	8	12	0	1	13	0	0
14	17026550	.	C	T	5	10	15	0	0	15	0	0
14	17026724	.	T	C	13	13	26	0	1	27	0	0
14	17026840	.	T	C	9	3	12	0	2	14	0	0
14	17066253	.	T	C	5	4	9	0	0	9	0	0
14	17197240	.	A	C	3	10	13	0	0	13	0	0
14	17198928	.	A	G	13	6	19	0	0	19	0	0
14	17198953	.	G	A	9	6	15	0	0	15	0	0
14	17198988	.	T	G	7	5	12	0	2	14	0	0
14	17199349	.	C	T	15	16	31	0	1	32	0	0
14	17199990	.	A	G	20	20	40	0	1	41	0	0
14	17200159	.	C	T	15	13	28	0	0	28	0	0
14	17200174	.	G	T	0	13	13	0	18	31	0	0
14	17200407	.	C	A	7	11	18	0	0	18	0	0
14	17200482	.	T	C	13	11	24	0	0	24	0	0
14	17200653	.	A	C	8	15	23	0	0	23	0	0
14	17230601	.	A	G	10	5	15	0	0	15	0	0
14	17233541	.	C	T	16	18	34	0	1	35	0	0
14	17240569	.	G	T	5	8	13	0	0	13	0	0
14	17240587	.	A	G	5	9	14	0	0	14	0	0
14	17266013	.	A	T	10	8	18	0	1	19	0	0
14	17275609	.	T	A	8	11	19	0	0	19	0	0
14	17275708	.	C	G	5	11	16	0	0	16	0	0
14	17278972	.	C	T	9	9	18	0	0	18	0	0
14	17279197	.	G	A	5	5	10	0	0	10	0	0
14	17279305	.	T	C	6	8	14	0	2	16	0	0
14	17281713	.	G	A	5	5	10	0	0	10	0	0
14	17281727	.	C	G	8	6	14	0	0	14	0	0
14	17281818	.	T	C	3	2	5	0	1	6	0	0
14	17281831	.	G	A	2	2	4	0	0	4	0	0
14	17282058	.	G	A	7	4	11	0	0	11	0	0
14	17282061	.	C	T	7	5	12	0	1	13	0	0
14	17282095	.	C	G	5	6	11	0	0	11	0	0
14	17282100	.	C	T	2	4	6	0	5	11	0	0
14	17282160	.	C	T	3	5	8	0	0	8	0	0
14	17329967	.	A	T	2	2	4	0	0	4	0	0
14	17348286	.	T	C	3	2	5	0	0	5	0	0
14	17349069	.	G	C	5	7	12	0	0	12	0	0
14	17349104	.	G	T	2	12	14	0	0	14	0	0
14	17349171	.	T	G	3	4	7	0	0	7	0	0
14	17349464	.	T	C	9	4	13	0	0	13	0	0
14	17349472	.	C	T	9	6	15	0	0	15	0	0
14	17349639	.	T	C	7	2	9	0	0	9	0	0
14	17349757	.	C	T	7	4	11	0	0	11	0	0
14	17349924	.	C	T	4	2	6	0	0	6	0	0
14	17349931	.	T	C	1	2	3	0	0	3	0	0
14	17444047	.	A	C	1	2	3	0	0	3	0	0
14	17567779	.	A	C	8	2	10	2	0	12	0	0
14	17568072	.	T	A	4	6	10	0	1	11	0	0
14	17568099	.	A	G	3	5	8	0	1	9	0	0
14	17572743	.	T	C	7	5	12	0	0	12	0	0
14	17575834	.	C	G	8	17	25	0	0	25	0	0
14	17575868	.	G	A	12	17	29	0	3	32	0	0
14	17575872	.	C	T	9	20	29	0	2	31	0	0
14	17580662	.	G	A	9	14	23	0	2	25	0	0
14	17580917	.	G	A	33	24	57	0	2	59	0	0
14	17580922	.	C	A	34	25	59	0	0	59	0	0
14	17581036	.	C	A	24	10	34	0	1	35	0	0
14	17586527	.	A	G	20	12	32	0	3	35	0	0
14	17586693	.	G	A	13	18	31	0	1	32	0	0
14	17588131	.	G	T	14	21	35	0	1	36	0	0
14	17593654	.	T	A	4	4	8	0	0	8	0	0
14	17593685	.	G	C	7	5	12	0	1	13	0	0
14	17593767	.	A	T	13	11	24	1	1	26	0	0
14	17593783	.	T	A	18	11	29	1	0	30	0	0
14	17593803	.	A	T	18	8	26	0	2	28	0	0
14	17593823	.	A	T	21	8	29	0	1	30	0	0
14	17593992	.	T	A	5	7	12	0	0	12	0	0
14	17594556	.	C	T	2	7	9	0	0	9	0	0
14	17595264	.	T	A	5	6	11	0	0	11	0	0
14	18667559	.	T	C	16	16	32	0	1	33	0	0
14	18667852	.	T	C	13	12	25	0	1	26	0	0
14	18668731	.	A	G	6	7	13	0	0	13	0	0
14	18669481	.	C	A	21	11	32	0	0	32	0	0
14	18670446	.	C	T	12	12	24	0	0	24	0	0
14	18670582	.	T	A	15	9	24	0	0	24	0	0
14	18670665	.	A	G	10	8	18	0	0	18	0	0
14	18671011	.	A	T	11	6	17	0	0	17	0	0
14	18672491	.	C	T	9	9	18	0	0	18	0	0
14	19258995	.	C	T	6	6	12	0	0	12	0	0
14	19259292	.	A	G	10	7	17	0	1	18	0	0
14	19260261	.	A	G	14	13	27	0	6	33	0	0
14	19261044	.	C	T	19	13	32	1	0	33	0	0
14	20159151	.	T	C	6	7	13	0	0	13	0	0
14	20188941	.	G	A	0	12	12	0	20	32	0	0
14	20189180	.	T	C	17	11	28	0	0	28	0	0
14	20189188	.	G	A	19	9	28	0	2	30	0	0
14	20190023	.	A	C	12	9	21	0	1	22	0	0
14	20190297	.	C	G	17	24	41	0	6	47	0	0
14	20190494	.	G	T	0	15	15	0	16	31	0	0
14	20190532	.	G	A	14	16	30	0	5	35	0	0
14	20342750	.	C	T	2	4	6	0	1	7	0	0
14	20694640	.	A	C	2	2	4	0	0	4	0	0
14	20706109	.	A	C	2	2	4	0	0	4	0	0
14	20728633	.	A	G	2	2	4	0	0	4	0	0
14	20730855	.	T	A	3	1	4	0	0	4	0	0
14	20730865	.	T	A	2	3	5	0	0	5	0	0
14	20730907	.	T	A	3	2	5	0	1	6	0	0
14	20730958	.	A	T	3	2	5	0	1	6	0	0
14	20731633	.	A	T	1	3	4	0	1	5	0	0
14	20731656	.	T	A	4	2	6	0	0	6	0	0
14	20731756	.	G	A	4	2	6	0	1	7	0	0
14	20731797	.	C	T	3	6	9	0	0	9	0	0
14	20732546	.	G	C	3	4	7	0	0	7	0	0
14	20733016	.	A	G	4	3	7	0	0	7	0	0
14	20733078	.	A	G	4	4	8	0	0	8	0	0
14	20733854	.	A	C	6	3	9	0	0	10	1	0
14	20735388	.	T	G	14	18	32	0	0	32	0	0
14	20735481	.	T	C	14	6	20	1	1	22	0	0
14	20735525	.	T	A	11	3	14	1	1	16	0	0
14	20735585	.	G	T	2	2	4	0	0	4	0	0
14	20735626	.	G	T	4	2	6	0	0	6	0	0
14	20735841	.	A	G	7	0	7	0	12	19	0	0
14	20736251	.	A	G	11	6	17	0	0	17	0	0
14	20869943	.	T	C	3	0	3	0	7	10	0	0
14	20869949	.	G	A	4	5	9	0	0	9	0	0
14	20870141	.	G	T	5	3	8	0	0	8	0	0
14	20870153	.	A	G	4	5	9	0	1	10	0	0
14	20870257	.	A	G	4	7	11	0	0	11	0	0
14	20870321	.	G	T	2	10	12	0	0	12	0	0
14	20879947	.	T	G	5	5	10	0	1	11	0	0
14	20881464	.	C	A	4	4	8	0	0	8	0	0
14	20881493	.	C	T	3	5	8	0	0	8	0	0
14	20896049	.	T	G	2	0	2	0	5	7	0	0
14	20896058	.	C	T	2	6	8	0	0	8	0	0
14	20898296	.	C	T	5	2	7	0	0	7	0	0
14	20988121	.	T	C	1	4	5	0	0	5	0	0
14	20994047	.	A	G	2	0	2	0	3	5	0	0
14	20994051	.	G	A	0	3	3	0	2	5	0	0
14	20994167	.	C	T	3	3	6	0	0	6	0	0
14	20994695	.	G	A	3	2	5	0	0	5	0	0
14	20994967	.	T	C	1	6	7	0	0	7	0	0
14	20996393	.	C	T	2	4	6	0	0	6	0	0
14	20996394	.	A	T	2	4	6	0	0	6	0	0
14	21000109	.	T	C	2	3	5	1	0	6	0	0
14	21000170	.	C	G	2	6	8	1	1	10	0	0
14	21000193	.	T	C	6	3	9	0	2	11	0	0
14	21000323	.	T	A	2	3	5	0	0	5	0	0
14	21000325	.	G	A	0	3	3	0	2	5	0	0
14	21000375	.	A	G	1	0	1	0	3	4	0	0
14	21067455	.	G	A	4	5	9	0	1	10	0	0
14	21067935	.	A	G	12	4	16	0	0	16	0	0
14	21067938	.	T	C	12	4	16	0	0	16	0	0
14	21071965	.	T	C	7	9	16	0	3	19	0	0
14	21072037	.	G	A	18	7	25	0	1	26	0	0
14	21072729	.	A	G	12	14	26	0	0	26	0	0
14	21072792	.	C	T	10	10	20	0	0	20	0	0
14	21072834	.	C	T	8	5	13	0	0	13	0	0
14	21072852	.	G	A	7	5	12	0	0	12	0	0
14	21078274	.	G	A	4	4	8	0	0	8	0	0
14	21078277	.	T	C	4	3	7	0	0	7	0	0
14	21087521	.	C	A	5	4	9	0	0	9	0	0
14	21090848	.	A	C	5	1	6	0	3	9	0	0
14	21098305	.	A	G	4	4	8	0	0	8	0	0
14	21098316	.	A	C	4	2	6	0	0	6	0	0
14	21124321	.	T	C	7	6	13	0	1	14	0	0
14	21124360	.	G	T	4	7	11	0	0	11	0	0
14	21124469	.	A	G	5	3	8	0	0	8	0	0
14	21129362	.	T	G	8	11	19	0	5	24	0	0
14	21129629	.	G	T	8	10	18	0	2	20	0	0
14	21132180	.	G	A	6	7	13	0	0	13	0	0
14	21159943	.	T	G	5	0	5	0	9	14	0	0
14	21159949	.	A	T	6	9	15	0	1	16	0	0
14	21183865	.	G	A	17	12	29	0	0	29	0	0
14	21183910	.	A	G	9	14	23	0	0	23	0	0
14	21187563	.	C	T	14	13	27	0	2	29	0	0
14	21187631	.	C	T	12	15	27	0	0	27	0	0
14	21195795	.	C	T	17	25	42	0	2	44	0	0
14	21198328	.	A	C	23	21	44	0	3	47	0	0
14	21198349	.	T	A	23	16	39	0	1	40	0	0
14	21198391	.	A	C	17	17	34	0	5	39	0	0
14	21198403	.	T	C	17	21	38	0	5	43	0	0
14	21198689	.	T	A	16	12	28	0	1	29	0	0
14	21198818	.	C	T	17	20	37	0	0	37	0	0
14	21199092	.	G	T	5	10	15	0	1	16	0	0
14	21204542	.	G	A	4	2	6	0	0	6	0	0
14	21204553	.	T	A	4	2	6	0	0	6	0	0
14	21204814	.	T	A	4	13	17	0	0	17	0	0
14	21205297	.	T	C	3	4	7	0	0	7	0	0
14	21205429	.	T	C	7	0	7	0	19	26	0	0
14	21205471	.	G	A	11	18	29	0	0	29	0	0
14	21205623	.	G	T	8	15	23	0	0	23	0	0
14	21211802	.	A	C	6	9	15	0	1	16	0	0
14	21211859	.	T	A	7	7	14	0	2	16	0	0
14	21219450	.	A	G	6	7	13	0	1	14	0	0
14	21238759	.	T	C	12	6	18	0	4	22	0	0
14	21238782	.	T	A	10	8	18	0	0	18	0	0
14	21241695	.	G	A	3	13	16	0	13	29	0	0
14	21241870	.	T	A	6	6	12	0	0	12	0	0
14	21241899	.	A	G	4	7	11	0	2	13	0	0
14	21242082	.	T	A	17	7	24	1	0	25	0	0
14	21242148	.	C	T	5	7	12	0	1	13	0	0
14	21245180	.	T	G	4	5	9	0	0	9	0	0
14	21245616	.	A	G	1	2	3	0	0	3	0	0
14	21245657	.	A	C	1	3	4	0	0	4	0	0
14	21332964	.	G	A	21	33	54	0	3	57	0	0
14	21333795	.	G	A	30	36	66	0	4	70	0	0
14	21333867	.	C	A	10	31	41	0	33	74	0	0
14	21333957	.	G	A	40	37	77	0	3	80	0	0
14	21334257	.	G	T	32	34	66	0	1	67	0	0
14	21334338	.	A	G	32	34	66	0	2	68	0	0
14	21334840	.	G	C	26	33	59	0	5	64	0	0
14	21334968	.	G	A	29	24	53	0	3	56	0	0
14	21334985	.	G	T	31	19	50	0	3	53	0	0
14	21597044	.	A	G	22	16	38	0	3	41	0	0
14	21597140	.	C	A	36	17	53	0	7	60	0	0
14	21597264	.	G	A	19	18	37	0	1	38	0	0
14	21597363	.	A	G	21	17	38	0	2	40	0	0
14	21597451	.	T	C	5	5	10	0	0	10	0	0
14	21597469	.	T	C	3	5	8	0	0	8	0	0
14	21597671	.	T	C	11	16	27	0	1	28	0	0
14	21597730	.	C	T	21	18	39	0	2	41	0	0
14	21597755	.	T	A	20	17	37	2	0	39	0	0
14	21597814	.	C	T	16	16	32	1	0	33	0	0
14	21598035	.	C	T	19	14	33	0	2	35	0	0
14	21598354	.	T	C	20	0	20	0	16	36	0	0
14	21598372	.	G	A	26	9	35	0	0	35	0	0
14	21598402	.	C	A	23	8	31	0	1	32	0	0
14	21598488	.	C	T	18	15	33	0	1	34	0	0
14	21598724	.	T	G	18	17	35	0	1	36	0	0
14	21598831	.	G	T	29	15	44	0	2	46	0	0
14	21603294	.	G	C	22	25	47	0	2	49	0	0
14	21603335	.	A	G	26	28	54	1	2	57	0	0
14	21609707	.	A	G	23	18	41	0	1	42	0	0
14	21609733	.	A	G	19	21	40	0	2	42	0	0
14	21616066	.	T	C	13	4	17	0	1	18	0	0
14	21617939	.	G	A	16	10	26	0	1	27	0	0
14	21617947	.	G	C	16	10	26	0	0	26	0	0
14	21623128	.	A	T	12	9	21	0	0	21	0	0
14	21623324	.	C	T	4	9	13	0	1	14	0	0
14	21630153	.	A	G	12	19	31	0	1	32	0	0
14	21636953	.	G	A	18	12	30	0	0	30	0	0
14	21636965	.	A	G	17	14	31	0	1	32	0	0
14	21639583	.	A	G	8	6	14	0	0	14	0	0
14	21643647	.	T	A	6	7	13	0	0	13	0	0
14	21646054	.	C	T	9	4	13	0	1	14	0	0
14	21646110	.	G	A	6	9	15	0	2	17	0	0
14	21652399	.	G	T	3	5	8	0	0	8	0	0
14	21652864	.	C	T	4	3	7	0	2	9	0	0
14	21654600	.	G	A	2	6	8	0	1	9	0	0
14	21654748	.	G	C	5	5	10	0	1	11	0	0
14	21655086	.	C	T	0	4	4	0	3	7	0	0
14	21655177	.	T	C	5	2	7	0	0	7	0	0
14	21655274	.	A	G	2	4	6	0	0	6	0	0
14	21655284	.	T	A	1	3	4	0	1	5	0	0
14	21656452	.	C	G	1	2	3	0	0	3	0	0
14	21660484	.	A	G	2	4	6	0	0	6	0	0
14	21685744	.	T	G	1	3	4	0	0	4	0	0
14	21689852	.	C	T	26	27	53	0	2	55	0	0
14	21693251	.	G	A	38	36	74	0	2	76	0	0
14	21693584	.	T	G	22	36	58	0	2	60	0	0
14	21745784	.	G	A	6	2	8	0	0	8	0	0
14	21745871	.	C	A	5	2	7	0	1	8	0	0
14	21745879	.	A	T	4	3	7	0	1	8	0	0
14	21745917	.	G	C	2	2	4	0	1	5	0	0
14	21746076	.	C	T	4	2	6	0	0	6	0	0
14	21746096	.	A	T	3	2	5	0	0	5	0	0
14	21746148	.	T	C	2	2	4	0	0	4	0	0
14	21746226	.	T	G	3	3	6	0	1	7	0	0
14	21750970	.	C	T	2	8	10	0	1	11	0	0
14	21766410	.	C	T	2	2	4	0	0	4	0	0
14	21766428	.	A	G	3	3	6	0	0	6	0	0
14	21768244	.	G	A	0	3	3	0	1	4	0	0
14	21768418	.	G	A	0	3	3	0	2	5	0	0
14	21771915	.	G	A	2	3	5	0	1	6	0	0
14	21772412	.	C	T	5	6	11	0	1	12	0	0
14	21779102	.	C	T	7	6	13	0	1	14	0	0
14	21779141	.	G	A	2	7	9	1	8	18	0	0
14	21779241	.	G	A	10	11	21	0	0	21	0	0
14	21779518	.	C	T	9	7	16	0	0	16	0	0
14	21779551	.	A	G	10	3	13	0	0	13	0	0
14	21779633	.	T	C	1	3	4	0	0	4	0	0
14	21780206	.	A	G	11	9	20	0	0	20	0	0
14	21780274	.	A	C	1	4	5	0	0	5	0	0
14	21780321	.	T	C	2	6	8	0	0	8	0	0
14	21790748	.	C	T	6	11	17	0	0	17	0	0
14	21801383	.	G	A	8	16	24	0	0	24	0	0
14	21804912	.	T	C	13	7	20	0	1	21	0	0
14	21806190	.	C	T	16	15	31	0	0	31	0	0
14	21806196	.	G	C	0	14	14	0	14	28	0	0
14	21813696	.	G	A	17	22	39	0	3	42	0	0
14	21816388	.	T	C	13	5	18	0	2	20	0	0
14	21834912	.	C	T	10	8	18	0	1	19	0	0
14	21838379	.	T	C	10	11	21	1	0	22	0	0
14	21840858	.	A	G	8	0	8	0	10	18	0	0
14	21842804	.	T	C	21	17	38	0	3	41	0	0
14	21844187	.	T	A	19	10	29	0	1	30	0	0
14	21844486	.	C	T	6	11	17	0	1	18	0	0
14	21924273	.	A	G	6	3	9	0	0	9	0	0
14	21924382	.	A	G	9	3	12	0	0	12	0	0
14	21924547	.	G	A	6	2	8	0	1	9	0	0
14	22012883	.	G	A	2	2	4	0	1	5	0	0
14	22104906	.	T	C	12	12	24	0	2	26	0	0
14	22104948	.	G	A	16	13	29	0	0	29	0	0
14	22108215	.	C	T	13	9	22	0	2	24	0	0
14	22132510	.	A	T	10	22	32	0	2	34	0	0
14	22132536	.	A	T	22	13	35	0	1	36	0	0
14	22134069	.	G	A	12	16	28	0	3	31	0	0
14	22139160	.	T	C	31	22	53	0	2	55	0	0
14	22139194	.	C	T	28	24	52	0	2	54	0	0
14	22139254	.	G	A	28	25	53	0	2	55	0	0
14	22139308	.	C	T	22	34	56	0	0	56	0	0
14	22139358	.	G	A	27	19	46	0	1	47	0	0
14	22139392	.	G	T	27	21	48	0	0	48	0	0
14	22139668	.	G	A	3	23	26	0	31	57	0	0
14	22139816	.	G	A	4	21	25	0	26	51	0	0
14	22140417	.	T	C	9	4	13	0	0	13	0	0
14	22140542	.	G	A	13	11	24	0	0	24	0	0
14	22151827	.	A	T	7	12	19	0	1	20	0	0
14	22151913	.	C	T	7	14	21	0	3	24	0	0
14	22151958	.	T	A	17	8	25	0	1	26	0	0
14	22151966	.	A	C	17	7	24	0	0	24	0	0
14	22152004	.	T	G	5	3	8	0	0	8	0	0
14	22172138	.	C	T	13	16	29	0	0	29	0	0
14	22249344	.	G	A	16	13	29	0	0	29	0	0
14	22254184	.	T	C	20	28	48	1	2	51	0	0
14	22272340	.	G	A	22	21	43	0	2	45	0	0
14	22272351	.	G	A	23	21	44	0	2	47	1	0
14	22272749	.	A	G	16	1	17	0	25	42	0	0
14	22366619	.	G	A	0	2	2	0	1	3	0	0
14	22369791	.	G	A	1	2	3	0	0	3	0	0
14	22426797	.	G	A	1	2	3	0	0	3	0	0
14	22426800	.	G	A	0	2	2	0	1	3	0	0
14	22426836	.	C	T	1	2	3	0	0	3	0	0
14	22432007	.	C	G	3	0	3	0	3	6	0	0
14	22434387	.	C	T	2	3	5	0	0	5	0	0
14	22437413	.	G	T	4	2	6	0	0	6	0	0
14	22438924	.	A	G	1	6	7	0	0	7	0	0
14	22439183	.	C	G	2	5	7	0	1	8	0	0
14	22439210	.	G	T	4	6	10	0	0	10	0	0
14	22439258	.	G	T	4	4	8	0	0	8	0	0
14	22439455	.	A	T	1	2	3	0	0	3	0	0
14	22440004	.	G	T	0	3	3	0	1	4	0	0
14	22440022	.	A	G	1	4	5	0	0	5	0	0
14	22440047	.	C	T	1	2	3	0	0	3	0	0
14	22440063	.	C	A	1	2	3	0	0	3	0	0
14	22440173	.	A	G	1	2	3	0	0	3	0	0
14	22440174	.	A	G	1	2	3	0	0	3	0	0
14	22440842	.	C	T	0	2	2	0	1	3	0	0
14	22440897	.	C	A	6	2	8	0	0	8	0	0
14	22440918	.	G	A	3	3	6	0	0	6	0	0
14	22441000	.	G	C	2	4	6	1	1	8	0	0
14	22441057	.	T	C	3	6	9	0	1	10	0	0
14	22441110	.	G	A	3	4	7	0	0	7	0	0
14	22441532	.	T	C	7	7	14	0	1	15	0	0
14	22441581	.	C	A	7	6	13	0	1	14	0	0
14	22441793	.	G	A	2	7	9	0	2	11	0	0
14	22441873	.	T	C	3	6	9	0	0	9	0	0
14	22452886	.	A	C	2	2	4	4	0	8	0	0
14	22467967	.	G	A	1	2	3	0	0	3	0	0
14	22469807	.	C	T	2	2	4	0	0	4	0	0
14	22469900	.	C	T	2	1	3	0	1	4	0	0
14	22469954	.	C	A	3	3	6	0	0	6	0	0
14	22469978	.	A	G	1	4	5	0	0	5	0	0
14	22470154	.	T	C	3	2	5	0	0	5	0	0
14	22470213	.	T	C	2	2	4	0	0	4	0	0
14	22478282	.	G	A	2	3	5	0	0	5	0	0
14	22478454	.	C	T	1	3	4	0	1	5	0	0
14	22482233	.	C	T	1	3	4	0	0	4	0	0
14	22515896	.	C	T	7	4	11	0	0	11	0	0
14	22523476	.	A	G	8	6	14	0	1	15	0	0
14	22523584	.	A	G	2	6	8	0	0	8	0	0
14	22523608	.	C	A	3	3	6	0	0	6	0	0
14	22523633	.	T	C	5	3	8	0	0	8	0	0
14	22523644	.	C	T	5	2	7	0	0	7	0	0
14	22708325	.	A	G	3	7	10	0	0	10	0	0
14	22708389	.	C	T	9	6	15	0	0	15	0	0
14	22708401	.	C	A	9	6	15	0	0	15	0	0
14	22708446	.	C	T	6	6	12	0	1	13	0	0
14	23409971	.	A	G	1	3	4	0	0	4	0	0
14	23411619	.	C	G	4	0	4	0	7	12	1	0
14	23411712	.	G	T	0	4	4	0	6	10	0	0
14	23455989	.	G	A	10	5	15	0	0	15	0	0
14	23463681	.	G	A	0	8	8	0	6	14	0	0
14	23463708	.	A	G	6	6	12	0	0	12	0	0
14	23463717	.	A	G	5	1	6	0	5	11	0	0
14	23463760	.	C	A	6	4	10	0	0	10	0	0
14	23478997	.	G	C	5	8	13	0	2	15	0	0
14	23609772	.	C	T	3	2	5	0	0	5	0	0
14	23615480	.	G	A	3	3	6	0	0	6	0	0
14	23628158	.	C	T	3	6	9	0	0	9	0	0
14	23663911	.	G	C	9	6	15	0	0	15	0	0
14	23664063	.	T	G	6	7	13	0	1	14	0	0
14	23665987	.	G	A	6	12	18	0	0	18	0	0
14	23666203	.	T	C	11	8	19	0	0	19	0	0
14	23666227	.	G	A	2	11	13	0	7	20	0	0
14	23666266	.	C	A	12	9	21	0	1	22	0	0
14	23666431	.	G	A	10	10	20	0	0	20	0	0
14	23666451	.	A	G	8	13	21	0	0	21	0	0
14	23666625	.	C	T	8	13	21	0	0	21	0	0
14	23668714	.	T	C	9	9	18	0	0	18	0	0
14	23668724	.	C	A	9	7	16	0	1	18	1	0
14	23671197	.	A	G	11	1	12	0	13	25	0	0
14	23671248	.	T	C	11	14	25	0	3	28	0	0
14	23671361	.	C	G	20	8	28	0	2	30	0	0
14	23673373	.	G	A	1	17	18	0	18	36	0	0
14	23673499	.	A	G	11	5	16	5	1	22	0	0
14	23673514	.	G	A	5	13	18	5	0	23	0	0
14	23679205	.	C	T	3	2	5	0	1	6	0	0
14	23679564	.	T	C	4	5	9	0	0	9	0	0
14	23679592	.	T	C	2	4	6	0	0	6	0	0
14	23679671	.	G	A	2	3	5	0	0	5	0	0
14	23679674	.	T	G	3	3	6	0	0	6	0	0
14	23679784	.	T	G	4	2	6	0	0	6	0	0
14	23679789	.	G	A	4	2	6	0	0	6	0	0
14	23679842	.	A	G	2	3	5	0	0	5	0	0
14	23679843	.	A	T	2	3	5	0	0	5	0	0
14	23680031	.	C	T	4	3	7	0	1	8	0	0
14	23687872	.	G	C	7	7	14	0	1	15	0	0
14	23689974	.	A	T	2	6	8	0	1	9	0	0
14	23693914	.	T	C	5	5	10	0	1	11	0	0
14	23700121	.	T	C	20	19	39	0	0	39	0	0
14	23700142	.	G	T	22	19	41	0	1	42	0	0
14	23702730	.	G	A	17	20	37	0	1	38	0	0
14	23717277	.	A	T	19	21	40	0	0	40	0	0
14	23717289	.	A	T	15	26	41	0	1	42	0	0
14	23720196	.	A	T	30	27	57	0	2	59	0	0
14	23725824	.	T	A	15	9	24	0	0	24	0	0
14	23726124	.	G	T	27	22	49	0	2	51	0	0
14	23726413	.	G	A	37	23	60	1	3	64	0	0
14	23726547	.	C	T	20	30	50	0	2	52	0	0
14	23732056	.	C	A	1	5	6	1	0	7	0	0
14	23732117	.	T	C	3	10	13	0	0	13	0	0
14	23732134	.	C	T	2	13	15	0	0	15	0	0
14	23732167	.	C	A	5	9	14	0	0	14	0	0
14	23732299	.	C	T	0	6	6	0	13	19	0	0
14	23732324	.	T	C	11	0	11	0	6	17	0	0
14	23732368	.	C	A	0	10	10	0	10	20	0	0
14	23732396	.	A	G	7	12	19	0	0	19	0	0
14	23732444	.	G	T	6	18	24	0	0	24	0	0
14	23732497	.	C	A	10	13	23	0	1	24	0	0
14	23732547	.	T	A	3	11	14	0	1	15	0	0
14	23732639	.	G	A	4	6	10	0	0	10	0	0
14	23732718	.	A	G	5	7	12	0	1	13	0	0
14	23732734	.	G	A	4	7	11	0	1	12	0	0
14	23732916	.	C	T	1	4	5	0	0	5	0	0
14	23733097	.	A	G	6	7	13	0	0	13	0	0
14	23733220	.	G	A	7	12	19	0	1	20	0	0
14	23737569	.	A	T	12	9	21	1	1	23	0	0
14	23748654	.	A	G	16	11	27	0	3	30	0	0
14	23756637	.	A	G	9	3	12	0	0	12	0	0
14	23756680	.	A	G	8	3	11	0	1	12	0	0
14	23756752	.	T	G	8	10	18	0	2	20	0	0
14	23756809	.	G	T	8	18	26	0	1	27	0	0
14	23765748	.	T	C	6	6	12	0	2	14	0	0
14	23798649	.	C	G	3	8	11	0	0	11	0	0
14	23798675	.	G	C	3	3	6	0	0	6	0	0
14	23798699	.	A	C	3	5	8	0	1	9	0	0
14	23798963	.	G	A	3	3	6	0	0	6	0	0
14	23799076	.	G	T	4	7	11	0	0	11	0	0
14	23799095	.	G	T	4	5	9	0	1	10	0	0
14	23811956	.	T	C	4	2	6	0	0	6	0	0
14	23812444	.	C	A	5	2	7	0	0	7	0	0
14	23812581	.	C	T	4	3	7	0	0	7	0	0
14	23947586	.	A	G	1	0	1	0	3	4	0	0
14	23963652	.	C	T	3	4	7	0	0	7	0	0
14	23963688	.	C	T	2	2	4	0	0	4	0	0
14	23966629	.	A	C	2	5	7	0	0	7	0	0
14	23966674	.	G	A	2	4	6	0	0	6	0	0
14	23966689	.	C	T	1	3	4	0	0	4	0	0
14	23968254	.	A	C	1	2	3	0	0	3	0	0
14	23968263	.	A	C	1	4	5	0	0	5	0	0
14	23968319	.	A	G	2	3	5	0	0	5	0	0
14	23968348	.	C	T	2	4	6	0	0	6	0	0
14	23968612	.	A	T	2	3	5	0	0	5	0	0
14	23968619	.	T	A	2	4	6	0	0	6	0	0
14	23968678	.	T	G	3	6	9	0	1	10	0	0
14	23968743	.	C	T	9	8	17	0	1	18	0	0
14	23968774	.	T	C	9	6	15	0	1	16	0	0
14	23968781	.	C	A	9	5	14	0	0	14	0	0
14	23968815	.	A	G	6	3	9	0	0	9	0	0
14	23968843	.	A	T	7	3	10	0	0	10	0	0
14	23969374	.	A	C	3	4	7	0	1	8	0	0
14	23969378	.	G	A	3	5	8	0	0	8	0	0
14	23969443	.	G	C	7	6	13	0	0	13	0	0
14	23969446	.	T	C	8	6	14	0	0	14	0	0
14	23969485	.	G	A	11	4	15	0	0	15	0	0
14	23969779	.	C	G	4	3	7	0	0	7	0	0
14	23970887	.	T	C	9	16	25	0	1	26	0	0
14	23972572	.	G	A	7	11	18	0	1	19	0	0
14	23972587	.	C	T	8	8	16	0	2	18	0	0
14	23976245	.	C	T	13	13	26	0	0	26	0	0
14	23981999	.	T	C	23	18	41	0	1	42	0	0
14	23982623	.	A	T	19	19	38	0	2	40	0	0
14	23991507	.	C	T	19	19	38	1	2	41	0	0
14	23991588	.	G	A	15	21	36	0	3	39	0	0
14	23993952	.	A	G	27	20	47	0	1	48	0	0
14	23993958	.	G	A	23	19	42	0	6	48	0	0
14	23999002	.	G	C	16	20	36	0	0	36	0	0
14	23999086	.	G	A	22	21	43	0	1	44	0	0
14	23999112	.	A	G	23	21	44	0	1	45	0	0
14	23999225	.	A	G	18	19	37	0	1	38	0	0
14	23999239	.	G	C	2	16	18	0	13	31	0	0
14	23999466	.	C	A	4	7	11	0	1	13	1	0
14	24302439	.	G	A	1	6	7	0	0	7	0	0
14	24303102	.	A	G	11	3	14	0	0	14	0	0
14	24303103	.	A	G	11	2	13	0	1	14	0	0
14	24316809	.	A	T	8	9	17	0	1	18	0	0
14	24317301	.	G	T	27	31	58	0	1	60	1	0
14	24317314	.	T	C	33	24	57	0	2	59	0	0
14	24317508	.	T	C	37	27	64	0	1	65	0	0
14	24317685	.	T	A	21	29	50	0	1	51	0	0
14	24317717	.	T	A	17	34	51	0	2	53	0	0
14	24318087	.	A	T	28	19	47	0	2	49	0	0
14	24318102	.	A	T	21	22	43	0	2	45	0	0
14	24318160	.	T	G	22	10	32	1	2	35	0	0
14	24318196	.	G	A	13	16	29	1	2	32	0	0
14	24318232	.	G	C	16	15	31	2	2	35	0	0
14	24318335	.	G	T	18	16	34	0	2	36	0	0
14	24318479	.	A	T	21	28	49	0	2	51	0	0
14	24318631	.	C	T	22	21	43	0	0	43	0	0
14	24318652	.	G	A	27	17	44	0	0	44	0	0
14	24318709	.	A	T	27	13	40	0	0	40	0	0
14	24318723	.	T	C	20	15	35	0	4	39	0	0
14	24318868	.	T	C	27	28	55	0	2	57	0	0
14	24325537	.	T	C	32	21	53	0	1	54	0	0
14	24332817	.	A	T	22	21	43	0	0	43	0	0
14	24333761	.	A	G	17	15	32	1	1	34	0	0
14	24391361	.	A	G	13	13	26	0	0	26	0	0
14	24391397	.	G	A	14	10	24	0	0	24	0	0
14	24401077	.	C	T	1	10	11	0	14	25	0	0
14	24401209	.	T	G	7	8	15	0	2	17	0	0
14	24401393	.	A	G	9	7	16	0	1	17	0	0
14	24401700	.	C	A	1	19	20	0	17	37	0	0
14	24401844	.	T	A	8	19	27	0	3	30	0	0
14	24410373	.	G	A	12	9	21	0	1	22	0	0
14	24410384	.	T	C	9	0	9	0	13	22	0	0
14	24410553	.	C	A	13	13	26	0	0	26	0	0
14	24410556	.	T	C	11	12	23	0	2	25	0	0
14	24492051	.	G	C	6	3	9	0	1	10	0	0
14	24492225	.	G	A	3	7	10	0	0	10	0	0
14	24492666	.	C	A	3	3	6	0	1	7	0	0
14	24492667	.	T	A	3	4	7	0	0	7	0	0
14	24492792	.	A	G	2	4	6	0	0	6	0	0
14	24497832	.	G	T	5	4	9	0	0	9	0	0
14	24497904	.	T	C	3	0	3	0	2	5	0	0
14	24509941	.	T	C	4	4	8	0	0	8	0	0
14	24512802	.	T	A	4	2	6	0	2	8	0	0
14	24544362	.	A	T	1	4	5	0	0	5	0	0
14	24560629	.	G	C	3	2	5	0	0	5	0	0
14	24873121	.	A	G	1	0	1	0	3	4	0	0
14	24873487	.	A	G	2	2	4	0	0	4	0	0
14	24978975	.	T	C	6	7	13	0	2	15	0	0
14	24984979	.	T	C	5	6	11	0	2	13	0	0
14	24984997	.	C	T	5	6	11	0	1	12	0	0
14	24985324	.	A	G	3	4	7	0	0	7	0	0
14	24987643	.	G	T	6	9	15	0	1	16	0	0
14	24990795	.	A	G	8	7	15	0	0	15	0	0
14	24994819	.	G	A	0	7	7	0	5	12	0	0
14	24997871	.	C	T	8	6	14	0	1	15	0	0
14	24998002	.	T	C	14	8	22	0	0	22	0	0
14	24998019	.	A	T	14	10	24	0	3	27	0	0
14	24998076	.	A	G	12	1	13	0	17	30	0	0
14	24998345	.	C	A	14	10	24	0	0	24	0	0
14	24998395	.	C	T	16	12	28	0	2	30	0	0
14	24998430	.	G	A	1	9	10	0	12	22	0	0
14	24998565	.	T	C	18	12	30	0	2	32	0	0
14	24998737	.	A	C	11	17	28	0	0	28	0	0
14	24998804	.	A	G	11	2	13	0	5	18	0	0
14	24999546	.	T	A	16	17	33	0	0	33	0	0
14	24999722	.	T	C	8	16	24	0	1	25	0	0
14	25000623	.	A	C	9	18	27	0	0	27	0	0
14	25000686	.	T	A	10	14	24	0	0	24	0	0
14	25000803	.	T	G	15	15	30	0	0	30	0	0
14	25034940	.	C	T	0	2	2	0	2	4	0	0
14	25063558	.	A	T	1	2	3	0	0	3	0	0
14	25063617	.	A	G	9	9	18	0	0	18	0	0
14	25066002	.	C	A	4	23	27	0	23	50	0	0
14	25066010	.	T	A	29	20	49	0	2	51	0	0
14	25066722	.	T	A	29	15	44	0	2	47	1	0
14	25067471	.	C	T	23	13	36	0	0	36	0	0
14	25067665	.	C	T	17	13	30	0	3	33	0	0
14	25067700	.	C	A	16	18	34	0	1	35	0	0
14	25067857	.	G	A	16	12	28	0	0	28	0	0
14	25067862	.	A	C	17	11	28	0	1	29	0	0
14	25067984	.	C	T	18	8	26	0	1	27	0	0
14	25068007	.	G	C	21	6	27	0	0	27	0	0
14	25068206	.	G	T	18	8	26	0	1	27	0	0
14	25068215	.	T	G	20	9	29	0	1	30	0	0
14	25071338	.	C	T	4	14	18	0	16	34	0	0
14	25072307	.	G	T	23	9	32	0	2	34	0	0
14	25072351	.	C	T	25	12	37	0	2	39	0	0
14	25072843	.	A	T	13	4	17	0	1	18	0	0
14	25073511	.	C	T	10	11	21	1	1	23	0	0
14	25075173	.	G	A	7	6	13	0	1	14	0	0
14	25080035	.	A	G	23	17	40	0	3	43	0	0
14	25084872	.	A	G	24	14	38	0	0	38	0	0
14	25090031	.	C	T	15	7	22	0	0	22	0	0
14	25091043	.	C	G	14	12	26	0	2	28	0	0
14	25091063	.	A	G	17	13	30	0	0	30	0	0
14	25091453	.	C	T	12	8	20	0	2	22	0	0
14	25091467	.	C	T	12	8	20	0	2	22	0	0
14	25093710	.	G	A	12	11	23	0	1	24	0	0
14	25101097	.	T	C	2	0	2	0	3	5	0	0
14	25101126	.	A	G	2	2	4	0	0	4	0	0
14	25101400	.	A	T	2	3	5	3	0	8	0	0
14	25105715	.	A	C	3	0	3	0	2	5	0	0
14	25480153	.	T	C	1	4	5	0	0	5	0	0
14	25482568	.	T	G	3	6	9	0	1	10	0	0
14	25495021	.	T	A	2	4	6	0	0	6	0	0
14	25496045	.	A	T	6	1	7	0	1	8	0	0
14	25496052	.	G	C	5	2	7	0	0	7	0	0
14	25499928	.	A	G	2	2	4	0	0	4	0	0
14	25501772	.	C	T	8	6	14	0	0	14	0	0
14	25501870	.	C	A	9	9	18	0	0	18	0	0
14	25510803	.	A	G	6	3	9	0	0	9	0	0
14	25534862	.	G	T	15	1	16	0	0	16	0	0
14	25534863	.	T	G	13	1	14	0	2	16	0	0
14	25535003	.	C	T	1	4	5	0	3	8	0	0
14	25535005	.	T	C	2	4	6	0	2	8	0	0
14	25535167	.	T	G	7	11	18	0	1	19	0	0
14	25535607	.	G	A	16	33	49	0	1	50	0	0
14	25535706	.	G	T	19	30	49	0	0	49	0	0
14	25535742	.	T	A	15	21	36	1	1	38	0	0
14	25535768	.	G	T	8	15	23	5	1	29	0	0
14	25535820	.	C	T	2	6	8	0	8	16	0	0
14	25536132	.	T	C	19	10	29	0	1	30	0	0
14	25536148	.	G	A	19	11	30	0	0	30	0	0
14	25536531	.	T	G	22	12	34	0	1	35	0	0
14	25536577	.	G	C	21	13	34	0	1	35	0	0
14	25536619	.	A	G	17	23	40	0	3	43	0	0
14	25536657	.	A	C	23	25	48	0	3	51	0	0
14	25536770	.	A	T	29	16	45	0	1	46	0	0
14	25536782	.	C	T	0	12	12	0	29	41	0	0
14	25537019	.	C	A	13	14	27	0	2	29	0	0
14	25537068	.	G	A	17	15	32	0	0	32	0	0
14	25537136	.	T	C	18	15	33	0	1	34	0	0
14	25537145	.	G	A	18	16	34	0	0	34	0	0
14	25537189	.	A	T	21	12	33	0	0	33	0	0
14	25537200	.	C	T	21	12	33	0	0	33	0	0
14	25537231	.	T	C	26	7	33	0	1	34	0	0
14	25537307	.	A	T	15	11	26	0	1	27	0	0
14	25537332	.	T	A	15	11	26	0	0	26	0	0
14	25537345	.	A	G	13	10	23	0	0	23	0	0
14	25537405	.	A	G	7	16	23	0	1	24	0	0
14	25537700	.	C	T	1	16	17	0	13	30	0	0
14	25537975	.	G	T	14	16	30	0	0	30	0	0
14	25538121	.	T	C	8	21	29	0	1	30	0	0
14	25538402	.	G	A	6	12	18	0	1	19	0	0
14	25538433	.	T	A	3	11	14	0	0	14	0	0
14	25538618	.	T	A	10	14	24	0	0	24	0	0
14	25538803	.	T	A	8	8	16	0	1	17	0	0
14	25539283	.	T	C	4	1	5	0	7	12	0	0
14	25539290	.	T	C	2	9	11	0	0	11	0	0
14	25539423	.	C	T	1	14	15	0	12	27	0	0
14	25591134	.	A	G	6	7	13	0	0	13	0	0
14	25591176	.	T	G	3	8	11	0	1	12	0	0
14	25591182	.	C	T	0	7	7	0	4	11	0	0
14	25904781	.	C	T	6	5	11	0	0	11	0	0
14	25904868	.	C	T	9	5	14	0	0	14	0	0
14	25905091	.	C	T	6	3	9	0	0	9	0	0
14	25905584	.	G	T	2	2	4	0	0	4	0	0
14	25906074	.	A	G	2	5	7	0	1	8	0	0
14	25906135	.	G	A	3	2	5	0	0	5	0	0
14	25906315	.	T	G	2	4	6	0	0	6	0	0
14	25906344	.	T	A	5	3	8	0	0	9	1	0
14	25906350	.	T	A	7	3	10	0	0	10	0	0
14	25906577	.	A	T	1	4	5	0	1	6	0	0
14	25906652	.	G	T	12	8	20	0	1	21	0	0
14	25906891	.	C	T	3	4	7	0	0	7	0	0
14	25906981	.	T	C	7	3	10	0	0	10	0	0
14	25907170	.	G	C	7	4	11	0	0	11	0	0
14	25907194	.	A	G	9	0	9	0	5	14	0	0
14	25907282	.	C	T	3	3	6	0	0	6	0	0
14	25907283	.	A	G	4	2	6	0	0	6	0	0
14	25907610	.	A	G	3	4	7	0	2	9	0	0
14	25907704	.	T	C	5	2	7	0	0	7	0	0
14	25907893	.	G	A	0	8	8	1	2	11	0	0
14	25908030	.	A	G	1	5	6	0	0	6	0	0
14	25908113	.	A	C	3	2	5	0	0	5	0	0
14	25908659	.	G	C	2	2	4	0	1	5	0	0
14	25908680	.	A	T	5	4	9	0	0	9	0	0
14	25908753	.	A	C	4	7	11	0	4	15	0	0
14	25909047	.	T	A	7	8	15	0	0	15	0	0
14	25909048	.	A	T	7	8	15	0	0	15	0	0
14	25909213	.	C	T	8	8	16	0	0	16	0	0
14	25909656	.	A	G	7	2	9	0	0	9	0	0
14	25909696	.	C	T	5	4	9	0	0	9	0	0
14	25909699	.	G	T	4	4	8	0	1	9	0	0
14	25910106	.	C	A	5	2	7	0	0	7	0	0
14	25910126	.	T	A	9	6	15	0	0	15	0	0
14	25910186	.	C	A	5	8	13	0	0	13	0	0
14	25910249	.	G	A	11	11	22	0	0	22	0	0
14	25910276	.	C	T	14	9	23	0	0	23	0	0
14	25910296	.	A	G	15	10	25	0	0	25	0	0
14	25910373	.	T	C	10	7	17	0	1	18	0	0
14	25910407	.	A	G	9	8	17	0	1	18	0	0
14	25910414	.	C	G	11	7	18	0	0	18	0	0
14	25910542	.	C	T	18	14	32	0	2	34	0	0
14	25910715	.	T	C	9	18	27	0	3	30	0	0
14	25910747	.	C	T	12	15	27	0	1	28	0	0
14	25910834	.	T	A	16	19	35	0	0	37	2	0
14	25911097	.	C	T	9	17	26	0	0	26	0	0
14	25923458	.	T	A	2	4	6	0	0	6	0	0
14	25923729	.	T	A	4	7	11	0	0	11	0	0
14	25923745	.	G	A	3	8	11	0	0	11	0	0
14	25923771	.	A	G	3	10	13	0	0	13	0	0
14	25923809	.	G	A	2	4	6	0	1	7	0	0
14	25923829	.	C	T	0	6	6	0	1	7	0	0
14	25923844	.	T	G	1	4	5	0	0	5	0	0
14	25923971	.	T	A	2	5	7	0	0	7	0	0
14	25924369	.	T	A	3	6	9	0	0	10	1	0
14	25924384	.	A	G	3	7	10	0	0	10	0	0
14	25924475	.	A	T	2	3	5	0	0	5	0	0
14	25924495	.	A	C	1	4	5	0	0	5	0	0
14	25924625	.	A	T	2	6	8	0	0	8	0	0
14	25924764	.	A	T	4	8	12	0	0	12	0	0
14	25924928	.	T	A	7	4	11	0	0	11	0	0
14	25924931	.	G	A	7	4	11	0	0	11	0	0
14	25925079	.	G	C	3	2	5	0	0	5	0	0
14	25925118	.	A	T	3	2	5	0	0	5	0	0
14	25925154	.	C	T	2	3	5	0	0	5	0	0
14	25925552	.	C	A	4	4	8	0	0	8	0	0
14	25925600	.	C	T	5	2	7	0	0	7	0	0
14	25926041	.	G	A	7	10	17	0	0	17	0	0
14	25926048	.	C	T	1	11	12	0	6	18	0	0
14	25926195	.	G	A	13	14	27	0	1	28	0	0
14	25926351	.	G	A	14	17	31	0	1	32	0	0
14	25939358	.	A	C	9	2	11	0	0	11	0	0
14	25939360	.	C	A	8	3	11	0	0	11	0	0
14	25939493	.	T	C	6	13	19	0	0	19	0	0
14	25939622	.	G	A	15	5	20	0	0	20	0	0
14	25983160	.	G	A	7	7	14	0	0	14	0	0
14	25983210	.	T	A	16	17	33	0	0	33	0	0
14	25985448	.	A	C	15	8	23	0	2	25	0	0
14	25994776	.	C	T	2	2	4	0	0	4	0	0
14	26008943	.	A	G	5	0	5	0	3	8	0	0
14	26008951	.	G	A	0	2	2	0	4	6	0	0
14	26009201	.	T	C	3	2	5	0	0	5	0	0
14	26009202	.	C	T	3	2	5	0	0	5	0	0
14	26009267	.	G	A	0	8	8	0	2	10	0	0
14	26011987	.	G	A	1	5	6	0	4	10	0	0
14	26012017	.	G	A	4	5	9	0	0	9	0	0
14	26012026	.	A	G	4	0	4	0	5	9	0	0
14	26065321	.	T	C	3	6	9	0	0	9	0	0
14	26065391	.	G	A	7	7	14	0	0	14	0	0
14	26065479	.	G	A	5	7	12	0	1	13	0	0
14	26065490	.	G	A	5	8	13	0	2	15	0	0
14	26065860	.	C	T	2	8	10	0	0	10	0	0
14	26065876	.	C	T	3	6	9	0	0	9	0	0
14	26066198	.	T	G	0	9	9	0	1	10	0	0
14	26066204	.	C	T	1	7	8	0	0	8	0	0
14	26066969	.	T	C	2	3	5	0	0	5	0	0
14	26067337	.	A	G	2	2	4	0	0	4	0	0
14	26067563	.	A	G	2	2	4	0	0	4	0	0
14	26067685	.	G	T	3	7	10	0	0	10	0	0
14	26067697	.	G	A	4	5	9	0	0	9	0	0
14	26067757	.	T	A	3	6	9	0	0	9	0	0
14	26103511	.	T	G	4	8	12	0	0	12	0	0
14	26103547	.	T	A	10	10	20	0	2	22	0	0
14	26104293	.	G	A	13	20	33	0	2	35	0	0
14	26104299	.	A	G	14	18	32	0	1	33	0	0
14	26104350	.	C	A	1	15	16	0	16	32	0	0
14	26104442	.	C	T	25	12	37	0	0	37	0	0
14	26104503	.	C	T	12	16	28	0	2	30	0	0
14	26104674	.	A	T	9	3	12	0	0	12	0	0
14	26104679	.	A	C	8	1	9	0	3	12	0	0
14	26104710	.	G	T	6	6	12	0	2	14	0	0
14	26104801	.	C	A	5	7	12	0	1	13	0	0
14	26104829	.	A	G	5	7	12	0	1	13	0	0
14	26104854	.	C	T	4	6	10	0	1	11	0	0
14	26104973	.	T	A	4	3	7	0	0	7	0	0
14	26105074	.	A	C	12	7	19	0	1	20	0	0
14	26105086	.	A	C	13	7	20	0	2	22	0	0
14	26105136	.	G	A	12	7	19	0	0	19	0	0
14	26105164	.	C	A	17	7	24	0	1	25	0	0
14	26105183	.	G	T	16	5	21	0	0	21	0	0
14	26105268	.	C	T	7	3	10	0	0	10	0	0
14	26105488	.	G	A	10	3	13	0	0	13	0	0
14	26105492	.	T	A	9	4	13	0	1	14	0	0
14	26105699	.	T	A	4	8	12	0	0	12	0	0
14	26105762	.	A	T	7	4	11	0	5	16	0	0
14	26105952	.	G	T	3	3	6	0	9	15	0	0
14	26105958	.	A	G	4	3	7	0	4	11	0	0
14	26106163	.	G	T	17	9	26	0	0	26	0	0
14	26106500	.	C	A	14	16	30	0	0	30	0	0
14	26106892	.	A	G	17	17	34	0	2	36	0	0
14	26108958	.	T	G	18	18	36	0	0	36	0	0
14	26109353	.	T	G	11	14	25	0	0	25	0	0
14	26109356	.	G	A	10	12	22	0	0	22	0	0
14	26109430	.	A	G	14	10	24	0	0	24	0	0
14	26114037	.	A	T	9	2	11	0	1	12	0	0
14	26114044	.	A	C	9	4	13	0	1	14	0	0
14	26114200	.	G	A	6	8	14	0	3	17	0	0
14	26114277	.	G	A	13	9	22	0	0	22	0	0
14	26127373	.	G	A	8	12	20	0	0	20	0	0
14	26127375	.	T	A	8	12	20	0	0	20	0	0
14	26127561	.	G	A	8	13	21	0	2	23	0	0
14	26127754	.	T	A	6	8	14	0	0	14	0	0
14	26135471	.	G	A	7	3	10	0	0	10	0	0
14	26135489	.	A	G	5	2	7	0	0	7	0	0
14	26135846	.	T	A	10	7	17	0	0	17	0	0
14	26135894	.	A	G	8	7	15	0	1	16	0	0
14	26147181	.	A	G	5	5	10	0	0	10	0	0
14	26149915	.	G	T	4	11	15	0	2	17	0	0
14	26152543	.	A	C	6	6	12	0	1	13	0	0
14	26152550	.	T	C	8	5	13	0	0	13	0	0
14	26152616	.	G	A	3	3	6	0	0	6	0	0
14	26153285	.	T	A	4	4	8	0	0	8	0	0
14	26153357	.	T	A	4	2	6	0	0	6	0	0
14	26153397	.	A	G	6	3	9	0	0	9	0	0
14	26153450	.	G	A	4	3	7	0	2	9	0	0
14	26153680	.	T	C	1	2	3	0	0	3	0	0
14	26154095	.	A	G	2	3	5	0	0	5	0	0
14	26154533	.	G	A	5	2	7	0	0	7	0	0
14	26154623	.	T	C	3	0	3	0	6	9	0	0
14	26156860	.	A	G	1	5	6	0	0	6	0	0
14	26157915	.	C	T	1	1	2	0	1	3	0	0
14	26164964	.	A	T	3	2	5	0	0	5	0	0
14	26165027	.	A	G	3	2	5	0	0	5	0	0
14	26165223	.	G	A	1	2	3	0	0	3	0	0
14	26169339	.	T	C	1	3	4	0	0	4	0	0
14	26169345	.	A	G	1	3	4	0	0	4	0	0
14	26224731	.	A	G	3	2	5	0	0	5	0	0
14	26381406	.	A	G	1	3	4	0	1	5	0	0
14	26385496	.	G	A	5	5	10	0	0	10	0	0
14	26386005	.	A	G	2	2	4	0	0	4	0	0
14	26386109	.	A	G	3	3	6	0	0	6	0	0
14	26391786	.	C	A	3	2	5	0	1	6	0	0
14	26391855	.	C	A	2	2	4	0	0	4	0	0
14	26392076	.	A	G	5	5	10	0	1	11	0	0
14	26405027	.	G	A	10	7	17	0	2	19	0	0
14	26405077	.	G	A	9	7	16	0	1	17	0	0
14	26405153	.	A	G	8	3	11	0	1	12	0	0
14	26405205	.	A	G	6	4	10	0	1	11	0	0
14	26405269	.	T	A	2	6	8	0	2	10	0	0
14	26405323	.	G	A	2	4	6	0	1	7	0	0
14	26405457	.	G	A	11	9	20	0	0	20	0	0
14	26405686	.	A	C	17	14	31	0	2	33	0	0
14	26405861	.	C	T	9	8	17	0	0	17	0	0
14	26411104	.	T	C	15	5	20	0	1	21	0	0
14	26411688	.	G	A	11	4	15	0	1	16	0	0
14	26413617	.	A	T	11	7	18	0	1	19	0	0
14	26413636	.	G	T	15	5	20	0	0	20	0	0
14	26413681	.	A	C	19	9	28	2	1	31	0	0
14	26413771	.	C	T	14	20	34	0	1	35	0	0
14	26413800	.	G	T	14	18	32	0	1	33	0	0
14	26413895	.	T	C	7	8	15	0	0	15	0	0
14	26413896	.	T	A	6	7	13	0	2	15	0	0
14	26414115	.	C	A	17	15	32	0	2	34	0	0
14	26414157	.	C	T	13	22	35	0	2	37	0	0
14	26414205	.	G	T	19	11	30	0	0	31	1	0
14	26414226	.	C	G	16	15	31	0	0	31	0	0
14	26414692	.	C	T	9	15	24	0	1	25	0	0
14	26415876	.	G	C	12	12	24	0	0	24	0	0
14	26427058	.	T	A	1	4	5	0	0	5	0	0
14	26427836	.	T	A	7	3	10	0	1	11	0	0
14	26428125	.	G	C	1	2	3	0	0	3	0	0
14	26450421	.	T	A	1	3	4	0	0	4	0	0
14	26453167	.	G	C	9	5	14	0	1	15	0	0
14	26453375	.	C	T	8	9	17	0	0	17	0	0
14	26456225	.	A	G	10	5	15	0	2	17	0	0
14	26456274	.	T	C	9	7	16	0	2	18	0	0
14	26456379	.	G	A	13	5	18	0	0	18	0	0
14	26458019	.	C	T	10	8	18	0	1	19	0	0
14	26458040	.	A	G	12	5	17	0	0	17	0	0
14	26460891	.	A	G	5	3	8	0	0	8	0	0
14	26467657	.	G	T	4	2	6	0	0	6	0	0
14	26511360	.	A	C	2	2	4	0	1	5	0	0
14	26511605	.	G	A	7	7	14	0	2	16	0	0
14	26511798	.	G	A	4	3	7	0	0	7	0	0
14	26715764	.	C	T	9	3	12	0	1	13	0	0
14	26716118	.	T	A	7	3	10	0	1	11	0	0
14	26716139	.	T	C	11	3	14	0	0	14	0	0
14	26718058	.	T	C	7	7	14	0	0	14	0	0
14	26718240	.	A	G	6	2	8	0	0	8	0	0
14	26718753	.	T	G	18	5	23	0	1	24	0	0
14	26729141	.	C	A	19	16	35	0	1	36	0	0
14	26796049	.	G	T	5	6	11	0	1	12	0	0
14	26805963	.	C	A	7	4	11	0	1	12	0	0
14	26836144	.	T	G	10	0	10	0	6	16	0	0
14	26995454	.	T	C	11	15	26	0	3	29	0	0
14	26995551	.	T	A	10	12	22	0	0	22	0	0
14	26995773	.	G	A	17	13	30	0	0	30	0	0
14	26995988	.	G	T	12	4	16	0	0	16	0	0
14	26996299	.	C	A	2	10	12	0	4	16	0	0
14	26996301	.	A	T	5	10	15	0	1	16	0	0
14	26996434	.	G	A	4	3	7	0	0	7	0	0
14	26996543	.	A	C	7	8	15	0	1	16	0	0
14	26996709	.	C	T	6	4	10	0	0	10	0	0
14	26996738	.	C	T	9	6	15	0	0	15	0	0
14	26996851	.	A	T	4	12	16	0	0	16	0	0
14	26996926	.	T	A	6	6	12	0	0	12	0	0
14	26996954	.	G	C	5	7	12	0	0	12	0	0
14	26996974	.	A	C	6	9	15	0	0	15	0	0
14	26997003	.	G	A	3	10	13	0	1	14	0	0
14	26997051	.	G	C	3	4	7	0	0	7	0	0
14	26997060	.	G	T	4	2	6	0	0	6	0	0
14	26997143	.	C	A	1	3	4	0	0	4	0	0
14	26997192	.	A	T	5	3	8	0	1	9	0	0
14	26997208	.	A	G	5	3	8	0	1	9	0	0
14	26997272	.	C	A	2	2	4	0	0	5	1	0
14	26998140	.	G	A	3	5	8	0	0	8	0	0
14	26998507	.	G	A	7	8	15	0	0	15	0	0
14	26998520	.	G	A	6	8	14	0	0	14	0	0
14	26998605	.	C	T	0	11	11	0	11	22	0	0
14	26998828	.	A	T	1	4	5	0	0	5	0	0
14	26998961	.	T	G	4	8	12	0	1	13	0	0
14	26999437	.	G	A	5	5	10	0	0	10	0	0
14	27000158	.	T	C	6	0	6	0	8	14	0	0
14	27000602	.	A	G	7	4	11	0	0	11	0	0
14	27121666	.	C	T	4	5	9	0	1	10	0	0
14	27121690	.	C	T	3	6	9	0	0	9	0	0
14	27121711	.	G	T	4	6	10	0	1	11	0	0
14	27121828	.	G	A	5	3	8	0	0	8	0	0
14	27282913	.	A	G	4	7	11	0	0	11	0	0
14	27282961	.	G	A	5	5	10	0	0	10	0	0
14	27283114	.	G	A	5	6	11	0	0	11	0	0
14	27288491	.	C	T	2	7	9	0	0	9	0	0
14	27998933	.	T	A	21	19	40	1	1	42	0	0
14	27999422	.	G	T	22	19	41	0	2	43	0	0
14	27999471	.	C	T	12	22	34	0	5	39	0	0
14	27999591	.	G	A	16	19	35	0	2	37	0	0
14	28001696	.	G	A	9	16	25	0	0	25	0	0
14	28052187	.	G	A	5	2	7	0	0	7	0	0
14	28282150	.	G	A	2	6	8	0	6	14	0	0
14	28282528	.	A	G	3	5	8	0	0	8	0	0
14	28351739	.	C	T	12	8	20	0	0	20	0	0
14	28351793	.	C	T	7	8	15	0	1	16	0	0
14	28366021	.	A	G	13	5	18	0	3	21	0	0
14	28433011	.	T	C	14	16	30	0	0	30	0	0
14	28438975	.	G	A	5	5	10	0	0	10	0	0
14	28448811	.	A	T	5	9	14	0	1	15	0	0
14	28453158	.	T	C	12	10	22	0	0	22	0	0
14	28453257	.	A	C	10	12	22	0	0	22	0	0
14	28453269	.	C	T	12	12	24	0	0	24	0	0
14	28454613	.	A	T	19	17	36	0	0	36	0	0
14	28457968	.	G	A	2	21	23	0	16	39	0	0
14	28458175	.	G	A	17	12	29	0	1	30	0	0
14	28458270	.	T	C	14	12	26	0	1	27	0	0
14	28458345	.	G	A	2	16	18	0	9	27	0	0
14	28458456	.	C	A	11	6	17	0	0	17	0	0
14	28458974	.	A	G	4	5	9	0	3	12	0	0
14	28459292	.	G	C	4	12	16	0	13	29	0	0
14	28459324	.	T	A	11	15	26	0	1	28	1	0
14	28459613	.	T	A	7	3	10	0	0	10	0	0
14	28459664	.	A	G	6	10	16	0	0	16	0	0
14	28459703	.	C	A	1	9	10	0	7	17	0	0
14	28463466	.	G	A	3	6	9	0	4	13	0	0
14	28463598	.	C	A	0	13	13	0	5	18	0	0
14	28464895	.	T	A	3	3	6	0	0	6	0	0
14	28473556	.	C	T	2	4	6	0	0	6	0	0
14	28476731	.	C	A	5	4	9	0	1	10	0	0
14	28476977	.	C	T	6	6	12	0	0	12	0	0
14	28477018	.	A	G	3	5	8	0	0	8	0	0
14	28477115	.	A	G	6	4	10	0	3	13	0	0
14	28477384	.	C	T	3	4	7	0	0	7	0	0
14	28477400	.	A	G	3	0	3	0	4	7	0	0
14	28480476	.	A	G	5	3	8	0	1	9	0	0
14	28481362	.	C	T	6	4	10	0	1	11	0	0
14	28482808	.	C	T	5	12	17	0	0	17	0	0
14	28482883	.	G	A	5	6	11	0	1	12	0	0
14	28482920	.	G	A	6	3	9	0	0	9	0	0
14	28486356	.	T	G	3	8	11	0	0	11	0	0
14	28486357	.	C	T	3	8	11	0	0	11	0	0
14	28492984	.	C	T	5	3	8	0	0	8	0	0
14	28497490	.	C	T	2	2	4	0	0	4	0	0
14	28502502	.	G	A	2	4	6	0	0	6	0	0
14	28502783	.	C	T	4	4	8	0	1	9	0	0
14	28512717	.	C	T	6	15	21	0	1	22	0	0
14	28514142	.	T	C	9	6	15	0	0	15	0	0
14	28514328	.	C	G	4	4	8	0	0	8	0	0
14	28515941	.	C	T	14	13	27	0	0	27	0	0
14	28518305	.	G	A	0	17	17	0	17	34	0	0
14	28525002	.	A	C	7	12	19	0	0	19	0	0
14	28525353	.	C	T	7	15	22	0	0	22	0	0
14	28525367	.	G	A	16	8	24	0	0	24	0	0
14	28525969	.	A	G	12	5	17	0	1	18	0	0
14	28526046	.	C	T	13	8	21	0	2	23	0	0
14	28526815	.	G	T	14	11	25	0	0	25	0	0
14	28527130	.	T	G	10	18	28	0	0	28	0	0
14	29693070	.	T	G	2	0	2	0	2	4	0	0
14	29729456	.	G	A	0	3	3	0	2	5	0	0
14	29729948	.	C	T	2	3	5	0	0	5	0	0
14	29746323	.	T	C	1	2	3	0	1	4	0	0
14	29746419	.	T	C	1	4	5	0	1	6	0	0
14	29746497	.	A	G	0	5	5	0	1	6	0	0
14	29746533	.	A	G	4	2	6	0	0	6	0	0
14	29746609	.	T	C	4	5	9	0	0	9	0	0
14	29746621	.	A	G	5	5	10	0	0	10	0	0
14	29746740	.	G	A	0	2	2	0	4	6	0	0
14	29746987	.	A	C	2	7	9	0	0	9	0	0
14	29747118	.	T	C	5	5	10	0	0	10	0	0
14	29747130	.	A	G	7	6	13	0	0	13	0	0
14	29750758	.	C	T	2	6	8	0	0	8	0	0
14	29752254	.	G	A	5	4	9	0	0	9	0	0
14	29754477	.	C	A	5	4	9	0	1	10	0	0
14	29754762	.	C	A	8	9	17	0	1	18	0	0
14	29757958	.	A	T	14	13	27	0	2	29	0	0
14	29758103	.	C	T	15	17	32	0	3	35	0	0
14	29758333	.	G	A	4	16	20	0	15	35	0	0
14	29758526	.	T	C	10	8	18	0	5	23	0	0
14	29759439	.	A	T	1	5	6	0	0	6	0	0
14	29759570	.	A	T	3	5	8	0	0	8	0	0
14	29780555	.	G	A	0	2	2	0	0	2	0	0
14	29783671	.	T	C	2	2	4	0	0	4	0	0
14	29807562	.	T	C	8	7	15	0	0	15	0	0
14	29808086	.	C	T	7	3	10	0	0	10	0	0
14	29808109	.	C	A	7	3	10	0	1	11	0	0
14	29808195	.	G	A	10	5	15	0	0	15	0	0
14	29808222	.	G	A	7	5	12	0	0	12	0	0
14	29808251	.	C	A	8	5	13	0	0	13	0	0
14	29808436	.	T	C	3	5	8	0	1	9	0	0
14	29808473	.	C	T	5	6	11	0	2	13	0	0
14	29808743	.	C	T	0	9	9	0	6	15	0	0
14	29808785	.	C	A	2	5	7	0	8	15	0	0
14	29808812	.	T	C	13	5	18	0	0	18	0	0
14	29810430	.	C	T	10	6	16	0	0	16	0	0
14	29821164	.	G	A	5	8	13	0	1	14	0	0
14	29822513	.	T	A	6	6	12	0	1	13	0	0
14	29823306	.	C	T	4	6	10	0	0	10	0	0
14	29825100	.	A	G	2	4	6	0	2	8	0	0
14	29825136	.	C	T	0	4	4	0	6	10	0	0
14	29825265	.	T	C	5	5	10	0	0	10	0	0
14	29825412	.	C	T	5	3	8	0	3	11	0	0
14	29825421	.	T	A	5	6	11	0	0	11	0	0
14	29825694	.	G	C	3	4	7	0	0	7	0	0
14	29825706	.	T	G	2	4	6	0	1	7	0	0
14	29825810	.	A	G	4	2	6	0	1	7	0	0
14	29826029	.	C	T	4	3	7	0	0	7	0	0
14	29826552	.	G	T	2	5	7	0	0	7	0	0
14	29827271	.	A	G	2	6	8	0	0	8	0	0
14	29836412	.	G	C	6	0	6	0	5	11	0	0
14	29841103	.	T	C	2	2	4	0	0	4	0	0
14	29843189	.	C	G	0	3	3	0	4	7	0	0
14	29883233	.	C	T	0	3	3	0	2	5	0	0
14	30105929	.	C	T	1	2	3	0	0	3	0	0
14	30108096	.	T	A	2	2	4	0	0	4	0	0
14	30158168	.	C	T	0	2	2	0	3	5	0	0
14	30158174	.	C	T	3	1	4	0	1	5	0	0
14	30158323	.	G	A	2	2	4	0	0	4	0	0
14	30158352	.	G	A	3	2	5	0	0	5	0	0
14	30158365	.	A	G	2	4	6	0	0	6	0	0
14	30158528	.	T	C	2	2	4	0	0	4	0	0
14	30158875	.	A	G	1	7	8	0	0	8	0	0
14	30159101	.	T	C	2	2	4	0	0	4	0	0
14	30159105	.	T	C	2	2	4	0	0	4	0	0
14	30159536	.	C	T	3	5	8	0	1	9	0	0
14	30161897	.	A	G	4	2	6	0	0	6	0	0
14	30164324	.	T	A	1	2	3	0	0	3	0	0
14	30164325	.	A	C	1	2	3	0	0	3	0	0
14	30186229	.	T	C	1	0	1	0	2	3	0	0
14	30272965	.	C	A	2	4	6	0	1	7	0	0
14	30274044	.	A	C	3	1	4	0	1	5	0	0
14	30274051	.	A	T	3	2	5	0	0	5	0	0
14	30274548	.	G	T	1	2	3	0	2	5	0	0
14	30276294	.	A	G	5	2	7	0	0	7	0	0
14	30276438	.	A	C	9	3	12	0	0	12	0	0
14	30276522	.	A	G	6	0	6	0	4	10	0	0
14	30356616	.	A	T	1	3	4	0	0	4	0	0
14	30356947	.	T	A	2	3	5	0	0	5	0	0
14	30357204	.	C	T	3	3	6	0	0	6	0	0
14	30359276	.	C	T	1	2	3	0	1	4	0	0
14	30360991	.	G	A	1	4	5	0	0	5	0	0
14	30361051	.	A	G	1	4	5	0	0	5	0	0
14	30361057	.	C	T	1	4	5	0	0	5	0	0
14	30363022	.	C	G	1	1	2	0	2	4	0	0
14	30369572	.	C	T	13	4	17	0	0	17	0	0
14	30398618	.	G	A	9	3	12	0	0	12	0	0
14	30398723	.	G	A	2	2	4	0	0	4	0	0
14	30399386	.	G	T	3	6	9	0	0	9	0	0
14	30401100	.	C	T	5	5	10	0	0	10	0	0
14	30403613	.	T	C	6	6	12	0	0	12	0	0
14	30403716	.	T	C	6	4	10	0	0	10	0	0
14	30403813	.	A	G	14	5	19	0	0	19	0	0
14	30407577	.	G	C	1	5	6	0	7	13	0	0
14	30407638	.	C	A	8	9	17	0	0	17	0	0
14	30409289	.	C	T	14	8	22	0	0	22	0	0
14	30410882	.	G	A	2	14	16	0	12	28	0	0
14	30410911	.	G	A	10	15	25	0	1	26	0	0
14	30411143	.	C	T	11	9	20	0	1	21	0	0
14	30411292	.	T	C	12	18	30	0	1	31	0	0
14	30411739	.	C	T	3	3	6	0	0	6	0	0
14	30411825	.	G	A	6	2	8	0	0	8	0	0
14	30424213	.	C	A	3	3	6	0	0	6	0	0
14	30424342	.	G	C	0	2	2	0	2	4	0	0
14	30424500	.	G	A	1	2	3	0	0	3	0	0
14	30424517	.	C	A	1	2	3	0	0	3	0	0
14	30427682	.	T	C	2	3	5	0	0	5	0	0
14	30427688	.	A	G	2	3	5	0	0	5	0	0
14	30427770	.	A	G	0	6	6	0	0	6	0	0
14	30427780	.	C	A	2	4	6	0	0	6	0	0
14	30427834	.	G	A	1	5	6	0	0	6	0	0
14	30428031	.	C	T	2	4	6	0	0	6	0	0
14	30428319	.	A	G	5	6	11	0	0	11	0	0
14	30428322	.	A	G	5	5	10	0	0	10	0	0
14	30452140	.	G	T	4	2	6	0	1	7	0	0
14	30454651	.	T	A	3	2	5	0	0	5	0	0
14	30454917	.	C	T	0	3	3	0	3	6	0	0
14	30454979	.	A	T	3	2	5	0	0	5	0	0
14	30455121	.	C	T	4	4	8	0	0	8	0	0
14	30455134	.	T	A	4	5	9	0	0	9	0	0
14	30456243	.	G	A	9	3	12	0	1	13	0	0
14	30456373	.	T	G	2	11	13	0	2	15	0	0
14	30551452	.	A	T	9	8	17	0	0	17	0	0
14	30551488	.	C	T	9	8	17	0	0	17	0	0
14	30580906	.	A	G	1	6	7	0	0	7	0	0
14	30581000	.	A	C	7	0	7	0	6	13	0	0
14	30581152	.	G	A	9	4	13	0	0	13	0	0
14	30581245	.	A	T	4	6	10	0	0	10	0	0
14	30581308	.	C	T	0	6	6	0	5	11	0	0
14	30581329	.	C	A	6	6	12	0	0	12	0	0
14	30581485	.	C	T	2	6	8	0	3	11	0	0
14	30588022	.	C	A	5	3	8	0	1	9	0	0
14	30613469	.	C	A	13	17	30	0	0	30	0	0
14	30637988	.	C	T	4	19	23	0	27	50	0	0
14	30638071	.	G	A	23	18	41	0	1	42	0	0
14	30638087	.	G	A	24	15	39	0	4	43	0	0
14	30639165	.	A	G	21	26	47	0	5	52	0	0
14	30641256	.	G	A	15	10	25	0	3	28	0	0
14	30641872	.	A	G	20	16	36	0	1	37	0	0
14	30642594	.	T	G	6	7	13	0	0	13	0	0
14	30642618	.	G	A	11	9	20	0	0	20	0	0
14	30680038	.	A	C	2	0	2	0	2	4	0	0
14	30713964	.	T	C	22	19	41	0	2	43	0	0
14	30717305	.	T	C	7	12	19	0	0	19	0	0
14	30720073	.	T	C	7	0	7	0	16	23	0	0
14	30720354	.	C	T	0	12	12	0	7	19	0	0
14	30720399	.	C	T	0	9	9	0	9	18	0	0
14	30731175	.	G	T	1	14	15	0	16	31	0	0
14	30731849	.	A	C	8	8	16	0	0	16	0	0
14	30732064	.	C	G	19	18	37	0	0	37	0	0
14	30732136	.	C	G	17	12	29	0	1	30	0	0
14	30732229	.	T	C	17	18	35	0	1	36	0	0
14	30732899	.	C	T	8	12	20	0	0	20	0	0
14	30733237	.	T	G	16	1	17	0	15	32	0	0
14	30733279	.	C	A	6	14	20	0	1	21	0	0
14	30733411	.	A	G	10	11	21	0	0	21	0	0
14	30733779	.	G	A	0	12	12	0	9	21	0	0
14	30733990	.	T	C	24	16	40	0	2	42	0	0
14	30734215	.	A	T	16	18	34	0	0	34	0	0
14	30734221	.	A	G	15	1	16	0	19	35	0	0
14	30734295	.	A	G	14	21	35	0	4	39	0	0
14	30734347	.	A	G	18	19	37	0	2	39	0	0
14	30734389	.	A	T	16	14	30	0	2	32	0	0
14	30734390	.	T	A	16	15	31	0	0	31	0	0
14	30734516	.	T	C	18	22	40	0	2	42	0	0
14	30740370	.	C	G	1	3	4	0	0	4	0	0
14	30741186	.	C	T	0	3	3	0	2	5	0	0
14	30741803	.	C	T	1	3	4	0	0	4	0	0
14	30741843	.	T	C	1	2	3	0	0	3	0	0
14	30742071	.	G	A	1	2	3	0	0	3	0	0
14	30754639	.	T	G	2	0	2	0	3	5	0	0
14	30757309	.	C	T	2	4	6	0	0	6	0	0
14	30793472	.	C	T	3	2	5	0	0	5	0	0
14	30793618	.	T	A	1	4	5	0	0	5	0	0
14	30795633	.	T	C	28	32	60	0	0	60	0	0
14	30799000	.	T	C	35	27	62	0	3	65	0	0
14	30800809	.	A	C	38	21	59	0	6	65	0	0
14	30801043	.	C	A	46	21	67	0	1	68	0	0
14	30802958	.	G	A	2	2	4	0	0	4	0	0
14	30803058	.	C	A	0	2	2	0	2	4	0	0
14	30803072	.	A	G	3	2	5	0	0	5	0	0
14	30854710	.	A	T	19	22	41	0	2	43	0	0
14	30854808	.	G	A	19	3	22	1	4	27	0	0
14	30855117	.	A	C	31	27	58	0	1	59	0	0
14	30855218	.	A	G	16	25	41	0	1	42	0	0
14	30855303	.	C	T	2	18	20	1	21	42	0	0
14	30855668	.	A	T	30	13	43	0	0	44	1	0
14	30855973	.	T	G	10	7	17	7	0	24	0	0
14	30876422	.	A	C	10	13	23	0	0	23	0	0
14	30878357	.	C	A	2	2	4	0	0	4	0	0
14	30878587	.	G	A	6	4	10	0	1	11	0	0
14	30878604	.	C	T	7	2	9	0	2	11	0	0
14	30879257	.	T	C	3	0	3	0	3	6	0	0
14	30879274	.	T	G	3	3	6	0	0	6	0	0
14	30879573	.	C	T	4	3	7	0	1	8	0	0
14	30879619	.	A	G	6	4	10	0	0	10	0	0
14	30879620	.	A	C	6	3	9	0	1	10	0	0
14	30879698	.	T	A	3	2	5	0	0	5	0	0
14	30879736	.	T	C	2	3	5	0	0	5	0	0
14	30880248	.	T	G	9	6	15	0	0	15	0	0
14	30880361	.	A	G	9	4	13	0	0	13	0	0
14	30880534	.	A	G	4	5	9	0	0	9	0	0
14	30880645	.	A	G	2	3	5	0	0	5	0	0
14	30880817	.	A	G	7	6	13	0	0	13	0	0
14	30880846	.	T	C	4	4	8	0	1	9	0	0
14	30880916	.	T	C	4	0	4	0	3	7	0	0
14	30880918	.	A	G	4	3	7	0	0	7	0	0
14	30880973	.	G	A	2	5	7	0	0	7	0	0
14	30881073	.	A	T	1	4	5	0	0	5	0	0
14	30881327	.	A	G	2	5	7	0	0	7	0	0
14	30883084	.	G	T	3	2	5	0	1	6	0	0
14	30912058	.	T	C	3	4	7	0	0	7	0	0
14	30912993	.	T	C	1	2	3	0	0	3	0	0
14	30913423	.	G	A	2	2	4	0	0	4	0	0
14	30915322	.	G	A	2	2	4	0	0	4	0	0
14	30915608	.	T	A	5	2	7	0	0	7	0	0
14	30915627	.	G	T	0	2	2	0	5	7	0	0
14	30916113	.	A	G	1	1	2	0	2	4	0	0
14	30922349	.	T	C	9	5	14	0	1	15	0	0
14	30929774	.	T	C	2	0	2	0	4	6	0	0
14	30967975	.	T	G	3	3	6	0	2	8	0	0
14	30970834	.	A	C	3	12	15	0	0	15	0	0
14	30971156	.	G	A	5	6	11	0	0	11	0	0
14	30978589	.	G	T	18	11	29	0	1	30	0	0
14	30978700	.	T	C	12	13	25	0	5	30	0	0
14	30978706	.	G	A	15	13	28	0	2	30	0	0
14	30982248	.	T	C	23	0	23	0	7	30	0	0
14	30987702	.	T	A	21	14	35	0	1	36	0	0
14	30987930	.	G	A	22	9	31	0	2	33	0	0
14	30987985	.	A	G	21	16	37	0	3	40	0	0
14	30988627	.	A	G	17	12	29	0	2	31	0	0
14	30988664	.	C	T	18	9	27	0	0	27	0	0
14	30988707	.	T	G	7	8	15	0	0	15	0	0
14	30989292	.	C	G	0	8	8	0	3	11	0	0
14	30989908	.	A	G	6	10	16	0	0	16	0	0
14	30990321	.	T	A	20	9	29	0	1	30	0	0
14	30991060	.	C	T	8	5	13	0	1	14	0	0
14	30991272	.	C	T	1	15	16	0	8	24	0	0
14	30992079	.	T	A	4	2	6	0	0	6	0	0
14	30992515	.	A	T	1	3	4	0	1	5	0	0
14	30992593	.	A	G	2	3	5	0	0	5	0	0
14	31014047	.	G	A	8	5	13	0	0	13	0	0
14	31014113	.	T	A	11	8	19	0	0	19	0	0
14	31024053	.	A	G	10	5	15	0	0	15	0	0
14	31024077	.	C	A	5	4	9	0	1	10	0	0
14	31026727	.	A	G	4	3	7	0	0	7	0	0
14	31059281	.	C	A	6	2	8	0	0	8	0	0
14	31059577	.	C	A	2	2	4	0	0	4	0	0
14	31082058	.	C	T	1	2	3	0	0	3	0	0
14	31082249	.	C	T	5	5	10	0	0	10	0	0
14	31082400	.	T	C	9	7	16	0	0	17	1	0
14	31082501	.	T	G	6	3	9	0	2	11	0	0
14	31082519	.	C	T	0	4	4	0	8	12	0	0
14	31082569	.	C	T	6	4	10	0	2	12	0	0
14	31082857	.	C	T	13	7	20	0	1	21	0	0
14	31082975	.	A	G	5	8	13	0	1	14	0	0
14	31083110	.	C	A	7	10	17	0	0	17	0	0
14	31083227	.	G	A	6	6	12	0	0	12	0	0
14	31083242	.	C	A	1	5	6	0	6	12	0	0
14	31087245	.	T	A	5	6	11	0	0	11	0	0
14	31087750	.	T	C	4	2	6	0	0	6	0	0
14	31090259	.	C	T	1	3	4	0	0	4	0	0
14	31092404	.	G	A	0	2	2	0	1	3	0	0
14	31177140	.	G	C	1	0	1	0	2	3	0	0
14	31177220	.	T	C	2	2	4	0	0	4	0	0
14	31177651	.	G	A	1	4	5	0	0	6	1	0
14	31177704	.	A	G	3	2	5	0	0	5	0	0
14	31263527	.	T	A	3	3	6	0	1	7	0	0
14	31325256	.	C	T	1	1	2	0	1	3	0	0
14	31474374	.	T	G	1	2	3	0	0	3	0	0
14	31479169	.	A	T	2	3	5	0	0	5	0	0
14	31493317	.	C	T	7	4	11	0	1	12	0	0
14	31497559	.	C	T	10	9	19	0	2	21	0	0
14	31498413	.	T	C	15	7	22	0	1	23	0	0
14	31507444	.	G	A	9	6	15	0	2	17	0	0
14	31509944	.	C	G	4	4	8	0	0	8	0	0
14	31510055	.	G	A	0	6	6	0	15	21	0	0
14	31514373	.	T	C	16	7	23	0	0	23	0	0
14	31516506	.	A	G	9	7	16	0	0	16	0	0
14	31516509	.	G	A	2	7	9	0	8	17	0	0
14	31518812	.	T	A	10	8	18	0	0	18	0	0
14	31518856	.	T	A	6	7	13	0	1	14	0	0
14	31519018	.	A	C	12	5	17	0	0	17	0	0
14	31519051	.	A	G	11	7	18	0	3	21	0	0
14	31519241	.	A	G	8	12	20	0	2	22	0	0
14	31519340	.	G	A	9	11	20	0	1	21	0	0
14	31519590	.	G	A	2	4	6	0	0	6	0	0
14	31519616	.	A	T	3	2	5	0	0	5	0	0
14	31519730	.	T	A	6	9	15	0	0	15	0	0
14	31519777	.	T	A	7	12	19	0	0	19	0	0
14	31519948	.	T	C	4	10	14	0	0	14	0	0
14	31520061	.	G	A	12	5	17	0	0	17	0	0
14	31520094	.	T	C	13	5	18	3	1	22	0	0
14	31520119	.	T	C	10	10	20	3	0	23	0	0
14	31520316	.	G	A	2	4	6	0	0	6	0	0
14	31520336	.	A	G	2	0	2	0	5	7	0	0
14	31520371	.	A	T	7	4	11	0	0	11	0	0
14	31520483	.	T	C	4	14	18	0	0	18	0	0
14	31520555	.	T	C	6	12	18	0	0	18	0	0
14	31520936	.	T	C	1	2	3	0	0	3	0	0
14	31521442	.	G	A	4	4	8	0	0	8	0	0
14	31521446	.	T	C	5	3	8	0	0	8	0	0
14	31521936	.	A	G	4	2	6	0	0	6	0	0
14	31530186	.	A	G	6	6	12	0	0	12	0	0
14	31530350	.	A	G	7	9	16	0	0	16	0	0
14	31530388	.	T	C	8	10	18	0	3	21	0	0
14	31530421	.	G	A	9	14	23	0	0	23	0	0
14	31541318	.	C	T	18	18	36	0	0	36	0	0
14	31544922	.	A	T	14	18	32	0	1	34	1	0
14	31544947	.	C	T	13	19	32	0	1	33	0	0
14	31546470	.	A	T	11	8	19	0	1	20	0	0
14	31546493	.	A	G	10	1	11	0	7	18	0	0
14	31556263	.	T	C	12	12	24	0	0	24	0	0
14	31556344	.	A	G	8	14	22	0	0	22	0	0
14	31558943	.	A	G	10	8	18	0	1	19	0	0
14	31559000	.	T	G	10	8	18	0	1	19	0	0
14	31559062	.	A	G	8	7	15	0	2	17	0	0
14	31562713	.	G	A	9	11	20	0	2	22	0	0
14	31603318	.	A	C	2	0	2	0	2	4	0	0
14	31603320	.	G	A	2	2	4	0	0	4	0	0
14	31605874	.	A	G	2	2	4	0	1	5	0	0
14	31608076	.	G	T	6	2	8	0	0	8	0	0
14	31616186	.	C	T	15	6	21	0	0	21	0	0
14	31633328	.	C	T	1	4	5	0	0	5	0	0
14	31635358	.	T	C	5	6	11	0	0	11	0	0
14	31636382	.	T	C	4	7	11	0	0	11	0	0
14	31636502	.	T	G	5	3	8	0	0	8	0	0
14	31641769	.	C	T	9	9	18	0	0	18	0	0
14	31642476	.	T	G	5	5	10	0	1	11	0	0
14	31642712	.	C	T	3	4	7	0	0	7	0	0
14	31642965	.	A	T	4	5	9	0	0	9	0	0
14	31642991	.	C	T	3	3	6	0	0	6	0	0
14	31643257	.	T	C	2	3	5	0	0	5	0	0
14	31643411	.	A	T	4	7	11	0	0	11	0	0
14	31643645	.	A	C	7	5	12	0	0	12	0	0
14	31643849	.	A	G	9	3	12	0	0	12	0	0
14	31644218	.	T	C	14	15	29	0	0	29	0	0
14	31644229	.	C	G	10	0	10	0	19	29	0	0
14	31644488	.	T	C	10	10	20	0	0	20	0	0
14	31644646	.	A	G	6	6	12	1	1	14	0	0
14	31644805	.	C	T	6	7	13	0	1	14	0	0
14	31645022	.	C	T	2	7	9	0	3	12	0	0
14	31645082	.	A	G	17	10	27	0	1	28	0	0
14	31645683	.	A	T	5	5	10	0	0	10	0	0
14	31645891	.	C	T	8	8	16	1	1	18	0	0
14	31645989	.	T	A	4	2	6	0	0	6	0	0
14	31646039	.	C	A	4	5	9	0	0	9	0	0
14	31646121	.	G	A	6	7	13	0	1	14	0	0
14	31646217	.	C	A	4	15	19	0	0	19	0	0
14	31646224	.	G	A	6	12	18	0	2	20	0	0
14	31646407	.	C	T	1	4	5	0	0	5	0	0
14	31646650	.	A	G	20	1	21	0	4	25	0	0
14	31646655	.	T	C	20	4	24	0	1	25	0	0
14	31646869	.	A	G	11	6	17	0	1	18	0	0
14	31647135	.	A	T	13	11	24	0	0	24	0	0
14	31647217	.	A	G	9	7	16	0	2	18	0	0
14	31647291	.	G	C	18	9	27	0	0	27	0	0
14	31647335	.	G	T	20	8	28	0	0	28	0	0
14	31647682	.	A	G	6	7	13	0	1	14	0	0
14	31647730	.	T	C	7	10	17	0	2	19	0	0
14	31647829	.	C	A	8	3	11	0	1	12	0	0
14	31667011	.	G	A	0	2	2	0	2	4	0	0
14	31668859	.	T	A	12	7	19	4	1	24	0	0
14	31669103	.	A	T	5	7	12	0	0	12	0	0
14	31669304	.	C	A	4	5	9	0	0	9	0	0
14	31669551	.	T	C	11	14	25	0	0	25	0	0
14	31669558	.	C	A	13	11	24	0	2	26	0	0
14	31670044	.	C	G	4	5	9	0	0	9	0	0
14	31673775	.	A	G	2	4	6	0	1	7	0	0
14	31675852	.	G	T	6	5	11	0	0	11	0	0
14	31682168	.	T	C	9	12	21	0	0	21	0	0
14	31800369	.	T	C	4	0	4	0	4	8	0	0
14	31800371	.	A	G	4	4	8	0	0	8	0	0
14	31800589	.	G	A	8	7	15	0	0	15	0	0
14	31800875	.	G	A	5	8	13	0	0	13	0	0
14	31801428	.	C	G	7	8	15	0	1	16	0	0
14	31801454	.	C	T	1	5	6	0	7	13	0	0
14	31801483	.	A	G	7	3	10	0	0	10	0	0
14	31801904	.	A	G	6	8	14	0	0	14	0	0
14	31801979	.	T	C	5	7	12	0	2	14	0	0
14	31802067	.	A	T	7	7	14	0	0	14	0	0
14	31802156	.	T	C	5	3	8	0	2	10	0	0
14	31802507	.	C	T	1	4	5	0	0	5	0	0
14	31803044	.	C	A	4	5	9	0	1	10	0	0
14	31803150	.	T	C	3	7	10	0	0	10	0	0
14	31803337	.	G	A	5	3	8	0	0	8	0	0
14	31814000	.	C	G	3	4	7	0	1	8	0	0
14	31814089	.	T	C	5	0	5	0	4	9	0	0
14	31822530	.	A	G	1	3	4	0	0	4	0	0
14	31856891	.	G	T	11	13	24	0	1	25	0	0
14	31857773	.	T	A	11	17	28	0	0	28	0	0
14	31858123	.	G	A	15	27	42	0	1	43	0	0
14	31858492	.	T	G	6	11	17	0	0	17	0	0
14	31860525	.	C	T	15	17	32	1	9	42	0	0
14	31861179	.	A	G	13	13	26	0	1	27	0	0
14	31875637	.	T	C	1	2	3	0	0	3	0	0
14	31881740	.	A	G	3	5	8	0	0	8	0	0
14	31881791	.	G	T	1	4	5	0	0	5	0	0
14	31882159	.	T	C	3	4	7	0	0	7	0	0
14	31882246	.	G	T	0	3	3	0	3	6	0	0
14	31882339	.	G	T	2	2	4	0	3	7	0	0
14	31882340	.	C	T	5	2	7	0	0	7	0	0
14	31882422	.	T	C	4	4	8	0	0	8	0	0
14	31882481	.	A	G	0	0	0	0	5	5	0	0
14	31882507	.	T	C	1	3	4	0	0	4	0	0
14	31882587	.	T	C	4	4	8	0	0	8	0	0
14	31882656	.	C	T	8	4	12	0	1	13	0	0
14	31882709	.	A	T	4	3	7	0	0	7	0	0
14	31882714	.	A	T	4	2	6	0	0	6	0	0
14	31882817	.	T	A	4	3	7	0	0	7	0	0
14	31883188	.	A	T	1	4	5	0	0	5	0	0
14	31883472	.	A	C	4	2	6	0	0	6	0	0
14	31883475	.	A	T	4	2	6	0	0	6	0	0
14	31890622	.	A	G	3	4	7	0	1	8	0	0
14	31890748	.	T	C	2	0	2	0	4	6	0	0
14	31890817	.	G	A	1	2	3	0	0	3	0	0
14	31893726	.	C	G	2	4	6	0	0	6	0	0
14	32011834	.	C	A	12	7	19	0	2	21	0	0
14	32011929	.	C	G	4	15	19	0	16	35	0	0
14	32011993	.	T	C	7	12	19	0	5	24	0	0
14	32013167	.	C	A	1	8	9	0	10	19	0	0
14	32023213	.	T	C	3	5	8	0	1	9	0	0
14	32025140	.	A	T	3	5	8	0	1	9	0	0
14	32025381	.	T	C	4	4	8	0	1	9	0	0
14	32057378	.	T	C	3	3	6	0	0	6	0	0
14	32072741	.	T	A	2	2	4	0	0	4	0	0
14	32088525	.	G	A	1	3	4	0	0	4	0	0
14	32184937	.	C	T	18	11	29	0	2	31	0	0
14	32185199	.	A	G	10	10	20	0	1	21	0	0
14	32185374	.	C	T	8	11	19	0	1	20	0	0
14	32254558	.	C	T	7	2	9	0	0	9	0	0
14	32254770	.	C	T	3	4	7	0	0	7	0	0
14	32255068	.	G	T	6	3	9	0	0	9	0	0
14	32255124	.	C	T	3	2	5	0	0	5	0	0
14	32403594	.	G	C	10	7	17	0	1	18	0	0
14	32403754	.	G	A	3	2	5	0	0	5	0	0
14	32443169	.	A	C	3	3	6	0	0	6	0	0
14	32443516	.	C	A	6	1	7	0	0	7	0	0
14	32443522	.	G	A	6	3	9	0	0	9	0	0
14	32443552	.	T	A	11	6	17	0	1	18	0	0
14	32443572	.	A	C	9	9	18	0	0	18	0	0
14	32443696	.	A	G	14	14	28	0	0	28	0	0
14	32443727	.	C	T	1	12	13	0	16	29	0	0
14	32443734	.	A	T	17	10	27	0	0	27	0	0
14	32443841	.	A	T	18	15	33	0	2	35	0	0
14	32444064	.	C	G	19	14	33	0	0	33	0	0
14	32444114	.	C	G	18	17	35	0	1	36	0	0
14	32444121	.	C	T	15	17	32	0	1	33	0	0
14	32444392	.	C	T	10	5	15	0	0	15	0	0
14	32444614	.	G	A	24	9	33	0	3	36	0	0
14	32444615	.	T	C	23	9	32	0	4	36	0	0
14	32444651	.	G	A	16	15	31	0	1	32	0	0
14	32444854	.	G	T	8	7	15	0	3	18	0	0
14	32444878	.	C	A	5	10	15	0	0	15	0	0
14	32447862	.	G	A	14	12	26	0	0	26	0	0
14	32447915	.	T	C	15	0	15	0	6	21	0	0
14	32448068	.	T	C	16	7	23	0	0	23	0	0
14	32455602	.	T	C	9	0	9	0	5	14	0	0
14	32477810	.	T	C	8	0	8	0	7	15	0	0
14	32479378	.	G	A	9	6	15	0	0	15	0	0
14	32486680	.	A	G	2	3	5	0	0	5	0	0
14	32507833	.	T	C	6	1	7	0	9	16	0	0
14	32518873	.	C	T	8	6	14	0	0	14	0	0
14	32524969	.	T	A	0	2	2	0	1	3	0	0
14	32534834	.	G	A	4	6	10	0	0	10	0	0
14	32743736	.	G	A	4	6	10	0	1	11	0	0
14	32857704	.	G	A	1	11	12	0	0	12	0	0
14	32857812	.	A	C	4	6	10	0	0	10	0	0
14	32858004	.	G	C	2	10	12	1	10	23	0	0
14	32858012	.	C	T	11	11	22	1	1	24	0	0
14	32858080	.	C	A	9	12	21	0	0	21	0	0
14	32858244	.	T	C	15	17	32	0	2	34	0	0
14	32858301	.	C	T	17	11	28	0	2	30	0	0
14	32858364	.	C	T	8	18	26	0	1	27	0	0
14	32858570	.	C	T	12	16	28	0	1	29	0	0
14	32858578	.	C	G	16	12	28	0	1	29	0	0
14	32858638	.	G	A	10	12	22	0	0	22	0	0
14	32858701	.	C	T	13	10	23	0	1	24	0	0
14	32859554	.	C	T	14	11	25	0	0	25	0	0
14	32859908	.	G	T	7	11	18	2	0	20	0	0
14	32860374	.	T	C	14	0	14	0	17	31	0	0
14	32860434	.	C	T	15	18	33	0	1	34	0	0
14	32860692	.	T	A	17	15	32	0	2	34	0	0
14	32860704	.	G	A	15	15	30	0	2	32	0	0
14	32865916	.	G	A	19	8	27	0	0	27	0	0
14	32866234	.	C	T	12	10	22	0	2	24	0	0
14	32870048	.	A	T	1	3	4	0	1	5	0	0
14	32884065	.	C	T	1	12	13	0	15	28	0	0
14	32885221	.	A	T	5	2	7	0	0	7	0	0
14	32885319	.	T	A	5	2	7	0	0	7	0	0
14	32885453	.	G	T	3	4	7	0	0	7	0	0
14	32945536	.	C	T	2	2	4	0	0	4	0	0
14	32952043	.	C	T	7	3	10	0	1	11	0	0
14	32952148	.	C	T	2	4	6	0	0	6	0	0
14	32952180	.	T	A	4	2	6	0	0	6	0	0
14	32952312	.	A	T	4	2	6	0	2	8	0	0
14	32952576	.	C	T	9	8	17	0	1	18	0	0
14	32952665	.	C	T	3	5	8	0	12	20	0	0
14	32952857	.	T	A	8	4	12	0	1	13	0	0
14	32956430	.	A	G	3	4	7	0	0	7	0	0
14	32984047	.	G	A	3	5	8	0	0	8	0	0
14	32984084	.	G	A	4	3	7	0	0	7	0	0
14	32984128	.	C	A	7	7	14	0	0	14	0	0
14	32984239	.	G	A	8	4	12	0	1	13	0	0
14	32984414	.	G	T	4	2	6	0	1	7	0	0
14	32984627	.	C	G	1	2	3	0	0	3	0	0
14	32995014	.	C	T	0	2	2	0	1	3	0	0
14	33070588	.	C	A	1	14	15	0	26	47	6	0
14	33071522	.	A	G	21	20	41	0	4	45	0	0
14	33071814	.	G	A	20	23	43	0	1	44	0	0
14	33073954	.	G	A	14	20	34	0	0	34	0	0
14	33120461	.	G	A	12	14	26	0	0	26	0	0
14	33177681	.	A	G	18	7	25	0	1	26	0	0
14	33177949	.	G	C	12	1	13	0	11	24	0	0
14	33220216	.	A	G	2	3	5	0	0	5	0	0
14	33267946	.	T	C	14	20	34	0	0	34	0	0
14	33268211	.	T	A	4	4	8	0	2	10	0	0
14	33268330	.	C	A	6	8	14	0	1	15	0	0
14	33281240	.	T	A	27	28	55	0	4	59	0	0
14	33282050	.	C	T	30	14	44	0	2	46	0	0
14	33282119	.	A	G	21	35	56	0	6	62	0	0
14	33282245	.	A	T	34	14	48	0	1	49	0	0
14	33282246	.	A	C	34	13	47	0	2	49	0	0
14	33282347	.	C	T	6	20	26	0	31	57	0	0
14	33292079	.	A	G	26	15	41	0	0	41	0	0
14	33298637	.	C	T	25	25	50	0	1	51	0	0
14	33299087	.	T	C	18	17	35	0	2	37	0	0
14	33302380	.	T	C	3	0	3	0	2	5	0	0
14	33302416	.	A	T	3	3	6	0	0	6	0	0
14	33302745	.	T	C	4	2	6	0	0	6	0	0
14	33306505	.	C	T	21	24	45	0	0	45	0	0
14	33306583	.	T	C	21	26	47	0	1	48	0	0
14	33314102	.	G	A	25	25	50	0	2	52	0	0
14	33316828	.	A	G	20	13	33	1	1	35	0	0
14	33339530	.	G	A	3	2	5	0	0	5	0	0
14	33339761	.	G	C	3	4	7	0	0	7	0	0
14	33340099	.	C	T	3	7	10	0	2	12	0	0
14	33344536	.	T	G	3	3	6	0	1	7	0	0
14	33414168	.	C	T	38	36	74	0	1	75	0	0
14	33414885	.	C	T	22	15	37	0	1	38	0	0
14	33414894	.	C	T	22	15	37	0	0	37	0	0
14	33415120	.	G	C	1	7	8	0	9	17	0	0
14	33415210	.	A	G	16	11	27	0	1	28	0	0
14	33415337	.	C	T	7	9	16	0	0	16	0	0
14	33415410	.	T	G	5	0	5	0	3	8	0	0
14	33418525	.	G	C	6	7	13	0	2	15	0	0
14	33418766	.	A	G	14	16	30	0	0	30	0	0
14	33423037	.	C	T	11	15	26	0	0	26	0	0
14	33424854	.	A	C	29	0	29	0	23	52	0	0
14	33424869	.	C	T	25	28	53	0	2	55	0	0
14	33425008	.	A	T	12	19	31	0	0	31	0	0
14	33425013	.	C	T	3	19	22	0	9	31	0	0
14	33431337	.	G	T	1	3	4	0	1	5	0	0
14	33431674	.	G	A	3	2	5	0	0	5	0	0
14	33434976	.	T	C	3	5	8	0	0	8	0	0
14	33435231	.	G	A	2	12	14	0	0	14	0	0
14	33435306	.	T	G	6	3	9	0	0	9	0	0
14	33435311	.	A	G	6	3	9	0	0	9	0	0
14	33435384	.	G	A	7	9	16	0	0	16	0	0
14	33435460	.	G	T	7	9	16	0	0	16	0	0
14	33435540	.	T	A	8	12	20	0	0	20	0	0
14	33435573	.	T	A	7	11	18	0	0	18	0	0
14	33435598	.	C	T	10	12	22	0	0	22	0	0
14	33435686	.	T	C	5	4	9	0	0	9	0	0
14	33435714	.	G	A	4	2	6	0	0	6	0	0
14	33435893	.	C	T	1	7	8	0	1	9	0	0
14	33435916	.	T	G	8	7	15	0	0	15	0	0
14	33435948	.	G	A	13	9	22	0	0	22	0	0
14	33435967	.	C	T	19	7	26	0	0	26	0	0
14	33436091	.	A	T	10	16	26	0	0	26	0	0
14	33436311	.	A	G	15	21	36	0	1	37	0	0
14	33436650	.	A	T	13	16	29	0	4	33	0	0
14	33437248	.	C	T	20	21	41	0	2	43	0	0
14	33437262	.	T	G	26	22	48	0	2	50	0	0
14	33441928	.	C	T	30	27	57	0	1	58	0	0
14	33442006	.	A	G	31	25	56	0	2	58	0	0
14	33442066	.	T	C	24	24	48	0	3	51	0	0
14	33454561	.	T	C	15	0	15	0	17	32	0	0
14	33454570	.	C	T	2	16	18	0	15	33	0	0
14	33469026	.	C	A	14	11	25	0	0	25	0	0
14	33469094	.	T	A	15	12	27	0	2	29	0	0
14	33469177	.	C	A	12	13	25	0	1	26	0	0
14	33469180	.	A	G	12	0	12	0	13	25	0	0
14	33469241	.	A	G	6	0	6	0	5	11	0	0
14	33469281	.	G	A	7	6	13	0	0	13	0	0
14	33469356	.	C	T	2	2	4	0	0	4	0	0
14	33469370	.	C	T	1	1	2	0	0	2	0	0
14	33469609	.	C	T	5	2	7	0	0	7	0	0
14	33474119	.	C	A	3	3	6	0	1	7	0	0
14	33474168	.	G	A	7	3	10	0	1	11	0	0
14	33474745	.	T	C	15	0	15	0	14	29	0	0
14	33474762	.	G	C	17	13	30	0	1	31	0	0
14	33474809	.	T	C	10	0	10	0	10	20	0	0
14	33474869	.	A	C	3	1	4	0	9	13	0	0
14	33475273	.	G	C	2	2	4	0	0	4	0	0
14	33475767	.	C	T	5	8	13	0	0	13	0	0
14	33486539	.	A	C	9	6	15	0	1	16	0	0
14	33486543	.	C	G	8	7	15	0	1	16	0	0
14	33487022	.	A	T	5	6	11	0	0	11	0	0
14	33499239	.	A	T	12	13	25	0	0	25	0	0
14	33501772	.	C	A	10	10	20	0	1	21	0	0
14	33501922	.	A	G	12	7	19	0	1	20	0	0
14	33504572	.	A	G	14	9	23	0	0	23	0	0
14	33504657	.	A	G	11	12	23	0	1	24	0	0
14	33504669	.	T	A	10	15	25	0	1	26	0	0
14	33505058	.	A	G	10	0	10	0	13	23	0	0
14	33505500	.	A	C	4	19	23	0	1	24	0	0
14	33507743	.	C	T	14	8	22	0	2	24	0	0
14	33517936	.	A	G	1	3	4	0	2	6	0	0
14	33549786	.	G	A	10	5	15	0	0	15	0	0
14	33549834	.	T	C	6	8	14	0	1	15	0	0
14	33554764	.	C	T	6	10	16	0	0	16	0	0
14	33557503	.	C	A	4	3	7	0	0	7	0	0
14	33557521	.	C	T	3	4	7	0	0	7	0	0
14	33562482	.	C	T	12	15	27	0	2	29	0	0
14	33562504	.	G	C	16	14	30	0	1	31	0	0
14	33564955	.	C	T	15	15	30	0	1	31	0	0
14	33564956	.	T	G	16	15	31	0	1	32	0	0
14	33564994	.	A	G	14	12	26	0	0	26	0	0
14	33565054	.	C	A	11	6	17	0	3	20	0	0
14	33565153	.	T	C	10	12	22	0	1	23	0	0
14	33565170	.	C	T	12	16	28	0	0	28	0	0
14	33565209	.	C	T	13	12	25	0	2	27	0	0
14	33565275	.	C	A	17	8	25	0	1	26	0	0
14	33565296	.	C	A	13	9	22	0	0	22	0	0
14	33565477	.	G	T	8	6	14	0	0	14	0	0
14	33565665	.	T	C	9	10	19	1	0	20	0	0
14	33565675	.	T	G	8	2	10	0	0	10	0	0
14	33565794	.	A	C	8	3	11	0	0	11	0	0
14	33565797	.	T	G	10	0	10	0	2	12	0	0
14	33566052	.	G	T	9	5	14	0	0	14	0	0
14	33566058	.	A	C	9	4	13	0	0	13	0	0
14	33566515	.	G	A	1	13	14	0	12	26	0	0
14	33566617	.	C	T	13	11	24	0	0	24	0	0
14	33566651	.	A	G	9	10	19	0	1	20	0	0
14	33566744	.	G	T	19	16	35	0	2	37	0	0
14	33567023	.	T	A	13	12	25	0	1	26	0	0
14	33567024	.	T	A	13	13	26	0	0	26	0	0
14	33744608	.	T	C	9	8	17	0	1	18	0	0
14	33754000	.	C	T	10	9	19	0	0	19	0	0
14	33754476	.	G	A	1	7	8	0	16	24	0	0
14	33754581	.	C	T	11	8	19	0	1	20	0	0
14	33754587	.	C	T	14	8	22	0	0	22	0	0
14	33754710	.	T	G	20	10	30	0	2	32	0	0
14	33754766	.	T	C	22	12	34	0	0	34	0	0
14	33754793	.	T	A	26	10	36	0	1	37	0	0
14	33755394	.	A	C	13	12	25	0	0	25	0	0
14	33755590	.	T	C	14	17	31	0	1	32	0	0
14	33757169	.	A	C	31	33	64	0	0	64	0	0
14	33826267	.	A	T	8	8	16	0	1	17	0	0
14	33826305	.	G	A	7	9	16	0	0	16	0	0
14	33826371	.	T	C	9	13	22	0	3	25	0	0
14	33826385	.	A	G	12	14	26	0	1	27	0	0
14	33826453	.	G	A	6	9	15	0	1	16	0	0
14	33826580	.	T	A	7	6	13	2	1	16	0	0
14	33826767	.	T	A	4	5	9	1	0	10	0	0
14	33827170	.	T	C	8	4	12	0	0	13	1	0
14	33827188	.	C	T	9	6	15	0	3	18	0	0
14	33827584	.	C	G	12	4	16	0	0	16	0	0
14	33827698	.	A	T	11	5	16	0	1	17	0	0
14	33827732	.	C	A	10	6	16	0	0	16	0	0
14	33828002	.	C	T	0	3	3	0	2	5	0	0
14	33828086	.	G	T	4	3	7	0	2	9	0	0
14	33828777	.	C	A	6	6	12	0	1	14	1	0
14	33828919	.	A	G	5	6	11	0	0	11	0	0
14	33836543	.	A	G	1	2	3	0	0	3	0	0
14	33836567	.	T	C	0	2	2	0	1	3	0	0
14	33858132	.	A	C	2	1	3	0	1	4	0	0
14	33858138	.	A	G	2	1	3	0	0	3	0	0
14	33860183	.	G	C	2	3	5	0	0	5	0	0
14	33860250	.	T	A	11	4	15	0	2	17	0	0
14	33860262	.	C	T	1	14	15	0	5	20	0	0
14	33860480	.	C	G	16	21	37	0	1	38	0	0
14	33860567	.	C	A	27	17	44	0	1	45	0	0
14	33865704	.	A	G	17	20	37	0	1	38	0	0
14	33865764	.	C	T	21	10	31	0	4	35	0	0
14	33868606	.	G	A	10	11	21	0	0	21	0	0
14	33868723	.	G	A	15	17	32	0	1	33	0	0
14	33872087	.	G	A	3	3	6	0	0	6	0	0
14	33872095	.	G	C	2	3	5	0	0	5	0	0
14	33883090	.	T	G	6	4	10	0	0	10	0	0
14	33883098	.	C	T	9	4	13	0	0	13	0	0
14	33883191	.	T	A	5	4	9	0	0	9	0	0
14	33889544	.	T	C	5	4	9	0	0	9	0	0
14	33891229	.	G	A	8	14	22	0	1	23	0	0
14	33891981	.	A	T	1	5	6	0	1	7	0	0
14	33892044	.	A	T	3	7	10	0	0	10	0	0
14	33892126	.	A	T	9	16	25	0	0	25	0	0
14	33892153	.	T	C	12	13	25	0	0	25	0	0
14	33892441	.	C	G	5	6	11	0	0	11	0	0
14	33892490	.	G	A	7	7	14	0	2	16	0	0
14	33893776	.	A	G	3	3	6	0	0	6	0	0
14	33899529	.	T	C	16	6	22	0	3	25	0	0
14	33899629	.	C	T	21	19	40	0	7	47	0	0
14	33899674	.	T	C	21	0	21	0	17	38	0	0
14	33899705	.	T	C	14	7	21	0	7	28	0	0
14	33899786	.	G	A	14	16	30	0	0	30	0	0
14	33899912	.	C	A	1	22	23	0	16	39	0	0
14	33900155	.	T	C	18	1	19	0	15	34	0	0
14	33900229	.	C	A	7	12	19	0	1	20	0	0
14	33900552	.	A	T	7	17	24	0	4	28	0	0
14	33900575	.	A	T	18	9	27	0	1	28	0	0
14	33900611	.	G	A	17	19	36	0	2	38	0	0
14	33900663	.	T	A	25	14	39	0	1	40	0	0
14	33900955	.	A	T	9	21	30	1	0	31	0	0
14	33901129	.	C	T	15	16	31	3	4	38	0	0
14	33901217	.	T	A	13	8	21	2	0	23	0	0
14	33901221	.	T	C	13	7	20	2	1	23	0	0
14	33901293	.	A	C	19	13	32	0	0	32	0	0
14	33901445	.	T	G	3	8	11	1	0	12	0	0
14	33901591	.	T	C	7	6	13	0	1	14	0	0
14	33901617	.	G	A	15	7	22	0	0	22	0	0
14	33901704	.	G	A	18	10	28	3	0	31	0	0
14	33901766	.	G	C	19	13	32	0	0	32	0	0
14	33901790	.	C	G	4	9	13	0	20	33	0	0
14	33901807	.	A	G	22	6	28	0	3	31	0	0
14	33901865	.	C	A	18	16	34	0	2	36	0	0
14	33901907	.	G	A	11	15	26	0	4	30	0	0
14	33901946	.	A	T	8	17	25	0	2	27	0	0
14	33901957	.	C	A	21	8	29	0	1	30	0	0
14	33901993	.	G	A	11	18	29	0	0	29	0	0
14	33902094	.	G	A	14	13	27	0	0	27	0	0
14	33903006	.	C	A	12	16	28	0	1	29	0	0
14	33903090	.	G	A	12	14	26	0	1	27	0	0
14	33909978	.	C	T	12	8	20	0	0	20	0	0
14	33910014	.	T	A	10	15	25	0	0	25	0	0
14	33916050	.	A	G	9	9	18	0	3	21	0	0
14	33916539	.	G	A	10	10	20	0	1	21	0	0
14	33916671	.	C	T	1	11	12	0	15	27	0	0
14	33916861	.	G	A	17	9	26	0	1	28	1	0
14	33936366	.	A	T	9	9	18	0	1	19	0	0
14	33941274	.	T	C	3	7	10	0	0	10	0	0
14	33941436	.	C	T	1	4	5	0	6	11	0	0
14	33943652	.	G	A	1	3	4	0	1	5	0	0
14	33945094	.	T	A	2	2	4	0	0	4	0	0
14	33945285	.	C	A	3	3	6	0	1	7	0	0
14	33983741	.	G	T	8	9	17	0	0	17	0	0
14	33983904	.	T	C	29	24	53	0	0	53	0	0
14	33983966	.	G	A	22	30	52	0	0	52	0	0
14	33984300	.	A	G	14	10	24	1	4	29	0	0
14	33984402	.	G	A	7	6	13	0	1	14	0	0
14	33984610	.	A	G	29	20	49	1	1	51	0	0
14	33989580	.	G	A	20	27	47	0	2	49	0	0
14	33991784	.	G	A	22	10	32	1	2	35	0	0
14	33991799	.	G	T	25	8	33	1	3	37	0	0
14	33997606	.	G	A	11	4	15	0	1	16	0	0
14	33997861	.	A	G	7	9	16	0	0	16	0	0
14	33997873	.	G	A	10	10	20	0	0	20	0	0
14	33998078	.	G	A	16	11	27	0	0	27	0	0
14	33998156	.	A	G	11	10	21	0	0	21	0	0
14	34000502	.	G	A	4	7	11	0	0	11	0	0
14	34002325	.	G	A	10	7	17	0	1	18	0	0
14	34002547	.	A	G	10	9	19	0	3	22	0	0
14	34002571	.	T	A	14	8	22	0	0	22	0	0
14	34003447	.	G	A	12	11	23	0	1	24	0	0
14	34013059	.	G	A	3	6	9	0	1	10	0	0
14	34064313	.	C	T	5	4	9	0	0	9	0	0
14	34064371	.	A	T	11	6	17	0	1	18	0	0
14	34065115	.	A	T	8	11	19	0	0	19	0	0
14	34065178	.	G	A	9	8	17	0	1	18	0	0
14	34065290	.	T	C	9	4	13	0	1	14	0	0
14	34065454	.	G	A	14	9	23	0	0	23	0	0
14	34065568	.	C	G	8	0	8	0	14	22	0	0
14	34065586	.	G	A	8	8	16	0	1	17	0	0
14	34068110	.	A	G	10	6	16	0	1	17	0	0
14	34068458	.	C	T	5	3	8	0	0	8	0	0
14	34075094	.	T	G	4	0	4	0	8	12	0	0
14	34077401	.	C	A	10	13	23	0	1	25	1	0
14	34077406	.	A	T	13	11	24	0	0	24	0	0
14	34079322	.	C	T	11	18	29	0	0	29	0	0
14	34079362	.	G	A	13	13	26	0	2	28	0	0
14	34082287	.	G	A	12	14	26	0	0	26	0	0
14	34082311	.	G	A	12	11	23	0	3	26	0	0
14	34082628	.	C	A	14	6	20	0	1	21	0	0
14	34082694	.	T	A	8	16	24	0	1	25	0	0
14	34089653	.	G	A	17	15	32	0	0	32	0	0
14	34089676	.	C	T	14	16	30	0	0	30	0	0
14	34089707	.	T	C	15	14	29	0	1	30	0	0
14	34089864	.	C	T	7	14	21	0	0	21	0	0
14	34089900	.	G	A	8	14	22	0	0	22	0	0
14	34089941	.	A	G	16	19	35	0	0	35	0	0
14	34090001	.	G	T	0	17	17	0	12	29	0	0
14	34090169	.	T	C	11	8	19	0	1	20	0	0
14	34090248	.	C	G	6	13	19	0	1	20	0	0
14	34090342	.	G	A	10	11	21	1	1	23	0	0
14	34091123	.	G	T	2	11	13	0	0	13	0	0
14	34091134	.	A	C	12	3	15	0	3	18	0	0
14	34091238	.	C	A	6	20	26	0	1	27	0	0
14	34091423	.	C	T	15	13	28	0	1	29	0	0
14	34091461	.	G	T	13	17	30	0	0	30	0	0
14	34091787	.	T	A	9	18	27	0	1	28	0	0
14	34091805	.	C	A	15	8	23	0	3	26	0	0
14	34091851	.	C	T	15	11	26	0	0	26	0	0
14	34091971	.	G	A	15	13	28	0	0	28	0	0
14	34092369	.	C	T	12	15	27	0	1	28	0	0
14	34092507	.	T	G	8	18	26	0	3	29	0	0
14	34125983	.	T	A	2	4	6	0	0	6	0	0
14	34126353	.	A	T	26	27	53	0	0	54	1	0
14	34127403	.	A	G	1	4	5	0	0	5	0	0
14	34127445	.	A	G	3	14	17	0	1	18	0	0
14	34127457	.	C	T	6	15	21	0	0	21	0	0
14	34127492	.	G	T	10	16	26	0	1	27	0	0
14	34127507	.	T	G	8	11	19	0	2	21	0	0
14	34127675	.	A	G	3	6	9	1	2	12	0	0
14	34127686	.	A	T	0	8	8	1	2	11	0	0
14	34127925	.	T	A	11	3	14	0	0	14	0	0
14	34128023	.	C	T	2	2	4	0	1	5	0	0
14	34128063	.	A	G	2	2	4	0	0	4	0	0
14	34128314	.	A	T	16	4	20	0	1	21	0	0
14	34128349	.	C	A	17	6	23	0	0	23	0	0
14	34128371	.	G	T	13	10	23	0	2	25	0	0
14	34128477	.	A	C	14	1	15	0	11	26	0	0
14	34128516	.	C	T	12	13	25	0	1	26	0	0
14	34128565	.	T	G	18	13	31	0	0	31	0	0
14	34128796	.	G	T	14	11	25	0	0	25	0	0
14	34128930	.	G	T	14	5	19	0	1	20	0	0
14	34128967	.	G	A	9	6	15	0	0	15	0	0
14	34128969	.	T	C	8	6	14	0	0	14	0	0
14	34129103	.	A	G	11	11	22	0	2	24	0	0
14	34129159	.	T	C	14	10	24	0	0	24	0	0
14	34129338	.	A	T	14	9	23	0	2	25	0	0
14	34129353	.	T	C	13	0	13	0	9	22	0	0
14	34129377	.	G	T	14	10	24	0	1	25	0	0
14	34129545	.	G	A	8	8	16	0	1	17	0	0
14	34129558	.	A	T	12	7	19	0	1	20	0	0
14	34130171	.	A	G	3	2	5	0	1	6	0	0
14	34130176	.	T	C	2	3	5	0	1	6	0	0
14	34131056	.	T	C	12	9	21	0	0	21	0	0
14	34153801	.	A	G	6	4	10	0	1	11	0	0
14	34154746	.	C	T	1	6	7	0	8	15	0	0
14	34154815	.	A	G	13	7	20	0	0	20	0	0
14	34180461	.	A	G	3	6	9	0	0	9	0	0
14	34180491	.	G	A	5	5	10	0	0	10	0	0
14	34180530	.	T	C	4	0	4	0	4	8	0	0
14	34180557	.	T	G	4	3	7	0	1	8	0	0
14	34182101	.	C	T	4	8	12	0	0	12	0	0
14	34182107	.	A	T	3	7	10	0	1	11	0	0
14	34191157	.	G	A	2	3	5	0	0	5	0	0
14	34194564	.	A	G	4	5	9	0	0	9	0	0
14	34547661	.	G	A	2	3	5	0	0	5	0	0
14	34556534	.	T	C	2	6	8	0	0	8	0	0
14	34556826	.	C	G	9	8	17	0	0	17	0	0
14	34634415	.	T	A	6	4	10	0	0	10	0	0
14	34634584	.	C	A	8	3	11	0	0	11	0	0
14	34634732	.	A	G	3	5	8	0	0	8	0	0
14	34634788	.	G	A	2	3	5	0	0	5	0	0
14	34635144	.	C	T	3	2	5	0	1	6	0	0
14	34635565	.	G	A	4	6	10	0	0	10	0	0
14	34658139	.	G	T	3	3	6	0	0	6	0	0
14	34670750	.	C	G	4	2	6	0	1	7	0	0
14	34672611	.	C	T	7	7	14	0	0	14	0	0
14	34797734	.	C	A	5	9	14	0	1	16	1	0
14	35009791	.	A	C	4	1	5	0	1	11	5	0
14	35804833	.	A	G	28	15	43	0	1	44	0	0
14	35895960	.	C	A	2	3	5	1	1	7	0	0
14	35896005	.	T	C	4	2	6	0	0	6	0	0
14	36226685	.	G	A	0	3	3	0	3	6	0	0
14	36229211	.	T	A	6	4	10	0	0	10	0	0
14	36229227	.	T	G	7	4	11	0	0	11	0	0
14	36229415	.	C	T	2	3	5	0	0	5	0	0
14	36246854	.	C	T	14	8	22	0	0	22	0	0
14	36259377	.	G	A	2	12	14	0	9	23	0	0
14	36267395	.	C	A	24	12	36	0	1	37	0	0
14	36268152	.	C	T	22	9	31	0	0	31	0	0
14	36268339	.	C	T	13	20	33	0	1	34	0	0
14	36268426	.	T	C	18	8	26	0	0	26	0	0
14	36329023	.	C	A	0	4	4	0	3	7	0	0
14	36329402	.	G	T	3	8	11	0	0	11	0	0
14	36720985	.	A	G	6	3	9	0	1	10	0	0
14	37785336	.	A	G	1	0	1	0	6	7	0	0
14	38656962	.	T	C	1	6	7	0	0	7	0	0
14	38656976	.	A	C	3	5	8	0	0	8	0	0
14	38659002	.	G	A	1	2	3	0	0	3	0	0
14	38668543	.	G	C	0	6	6	0	4	10	0	0
14	38668546	.	T	C	4	6	10	0	0	10	0	0
14	38668815	.	C	T	3	3	6	0	0	6	0	0
14	38668863	.	T	C	1	5	6	0	0	6	0	0
14	38669487	.	A	G	1	3	4	0	0	4	0	0
14	38669562	.	G	T	0	5	5	0	3	8	0	0
14	38670016	.	C	T	4	5	9	0	0	9	0	0
14	38672310	.	A	G	5	0	5	0	5	10	0	0
14	38672521	.	G	T	2	8	10	0	1	11	0	0
14	38688730	.	G	A	6	4	10	0	0	10	0	0
14	38688794	.	A	T	5	2	7	0	1	8	0	0
14	38688829	.	G	C	3	7	10	0	1	11	0	0
14	38689332	.	A	G	5	9	14	0	0	14	0	0
14	38689409	.	A	C	5	9	14	0	0	14	0	0
14	38689428	.	G	C	6	8	14	0	2	16	0	0
14	38763334	.	A	C	11	20	31	0	1	32	0	0
14	38763381	.	G	A	23	15	38	0	1	39	0	0
14	38763394	.	G	A	18	19	37	0	1	38	0	0
14	38783272	.	T	C	16	8	24	1	0	25	0	0
14	38796156	.	C	G	11	4	15	0	1	16	0	0
14	38799419	.	G	A	2	4	6	0	0	6	0	0
14	38802884	.	C	T	5	7	12	0	0	12	0	0
14	38802904	.	A	T	5	9	14	0	0	14	0	0
14	38802960	.	G	A	10	6	16	0	0	16	0	0
14	38802967	.	T	G	9	5	14	0	0	14	0	0
14	38803085	.	G	A	5	2	7	0	1	8	0	0
14	38803088	.	C	T	1	4	5	0	2	7	0	0
14	38806916	.	G	T	6	4	10	0	0	10	0	0
14	38809356	.	G	A	1	6	7	0	0	7	0	0
14	38809512	.	C	T	3	6	9	0	0	9	0	0
14	38809528	.	T	C	4	3	7	0	0	7	0	0
14	38845762	.	T	C	9	16	25	0	0	25	0	0
14	38845912	.	A	G	38	20	58	0	2	60	0	0
14	38846587	.	A	T	40	19	59	0	2	61	0	0
14	38847235	.	A	G	19	12	31	0	1	32	0	0
14	38847497	.	A	G	4	0	4	0	4	8	0	0
14	38849729	.	C	T	28	23	51	0	1	52	0	0
14	38849946	.	A	C	27	29	56	0	1	58	1	0
14	38853381	.	C	G	7	6	13	0	1	14	0	0
14	38853397	.	A	G	7	8	15	0	0	15	0	0
14	38853821	.	C	T	5	3	8	0	0	8	0	0
14	38862589	.	A	G	5	4	9	0	0	9	0	0
14	38862598	.	A	G	5	6	11	0	1	12	0	0
14	38865589	.	C	T	5	6	11	0	0	11	0	0
14	38872410	.	C	T	10	3	13	0	0	13	0	0
14	38872454	.	T	C	4	5	9	0	1	10	0	0
14	38875416	.	T	C	1	0	1	1	3	5	0	0
14	38875551	.	C	G	2	1	3	0	1	4	0	0
14	38878552	.	T	C	5	4	9	0	0	9	0	0
14	38881266	.	G	T	12	8	20	1	0	21	0	0
14	38881281	.	T	A	10	6	16	1	2	19	0	0
14	38881363	.	G	A	0	5	5	0	2	7	0	0
14	38937085	.	T	C	1	0	1	0	4	5	0	0
14	38937099	.	T	C	3	4	7	0	0	7	0	0
14	38941498	.	A	G	3	2	5	0	0	5	0	0
14	39002433	.	G	C	8	4	12	0	1	13	0	0
14	39002555	.	C	T	4	7	11	0	0	11	0	0
14	39002562	.	C	T	3	7	10	0	2	12	0	0
14	39002698	.	C	A	6	3	9	0	0	9	0	0
14	39002739	.	G	C	14	0	14	0	4	18	0	0
14	39002752	.	A	G	12	4	16	0	0	16	0	0
14	39002820	.	A	T	7	9	16	0	1	17	0	0
14	39002883	.	A	G	16	7	23	0	1	24	0	0
14	39003039	.	T	G	4	6	10	0	0	10	0	0
14	39651358	.	G	C	2	2	4	0	0	4	0	0
14	39876050	.	G	C	3	3	6	0	1	7	0	0
14	39955206	.	T	A	4	1	5	0	0	5	0	0
14	39956669	.	A	T	1	4	5	0	1	6	0	0
14	40746227	.	C	T	2	2	4	0	0	4	0	0
14	40746261	.	G	C	1	2	3	0	0	3	0	0
14	40852670	.	A	T	5	8	13	0	2	15	0	0
14	40852732	.	T	C	14	2	16	0	1	17	0	0
14	40853268	.	C	G	11	11	22	0	1	23	0	0
14	40857654	.	T	G	13	8	21	0	3	24	0	0
14	40857711	.	G	A	15	12	27	0	0	27	0	0
14	40857881	.	T	C	13	12	25	0	1	26	0	0
14	40857977	.	C	T	10	9	19	0	0	19	0	0
14	40859179	.	A	G	10	1	11	0	18	29	0	0
14	40860291	.	T	A	18	15	33	0	2	35	0	0
14	40860354	.	C	T	20	20	40	0	1	41	0	0
14	40863062	.	A	G	19	16	35	1	1	37	0	0
14	40863161	.	T	C	25	8	33	0	2	35	0	0
14	40863176	.	A	G	25	9	34	0	4	38	0	0
14	40869331	.	C	A	25	14	39	0	3	42	0	0
14	40869895	.	T	C	16	25	41	0	2	43	0	0
14	40874026	.	G	T	2	3	5	0	0	5	0	0
14	40929383	.	C	T	1	2	3	0	0	3	0	0
14	41276516	.	T	A	2	11	13	0	4	17	0	0
14	41276608	.	G	A	8	8	16	0	0	16	0	0
14	41277391	.	A	T	9	11	20	0	1	21	0	0
14	41277424	.	C	A	6	16	22	0	1	23	0	0
14	41277556	.	A	G	31	20	51	0	1	53	1	0
14	41277624	.	A	T	28	22	50	0	1	51	0	0
14	41278238	.	T	A	26	18	44	1	1	46	0	0
14	41278255	.	A	G	19	20	39	1	2	42	0	0
14	41278754	.	C	G	6	6	12	0	2	14	0	0
14	41278946	.	T	C	2	4	6	1	0	7	0	0
14	41279133	.	C	T	12	14	26	1	2	29	0	0
14	41279214	.	C	T	18	16	34	4	1	39	0	0
14	41279277	.	G	C	21	25	46	0	4	50	0	0
14	41279479	.	T	A	11	11	22	0	0	22	0	0
14	41279527	.	C	T	1	8	9	0	15	24	0	0
14	41279542	.	C	A	1	15	16	2	14	32	0	0
14	41279974	.	T	G	20	15	35	0	1	36	0	0
14	41279977	.	G	T	20	17	37	0	0	37	0	0
14	41280013	.	G	A	21	18	39	1	3	43	0	0
14	41280149	.	G	A	23	17	40	0	6	46	0	0
14	41280228	.	A	G	24	21	45	0	1	46	0	0
14	41280517	.	G	C	17	15	32	0	1	33	0	0
14	41318507	.	C	T	2	2	4	0	0	4	0	0
14	41318672	.	G	C	2	2	4	0	0	4	0	0
14	41339309	.	T	C	2	5	7	0	0	7	0	0
14	41339820	.	G	C	5	9	14	0	0	14	0	0
14	41339972	.	G	A	0	2	2	0	1	3	0	0
14	41340042	.	A	C	2	4	6	0	0	6	0	0
14	41340054	.	T	A	2	5	7	0	0	7	0	0
14	41340081	.	A	T	2	4	6	0	0	6	0	0
14	41340172	.	A	C	7	5	12	0	0	12	0	0
14	41340231	.	G	A	4	5	9	0	0	9	0	0
14	41340284	.	C	T	2	3	5	0	0	5	0	0
14	41340681	.	T	A	1	2	3	0	0	3	0	0
14	41361985	.	C	T	2	10	12	0	8	20	0	0
14	41362007	.	G	A	14	11	25	0	1	26	0	0
14	41362060	.	C	T	15	12	27	0	1	28	0	0
14	41366823	.	G	A	22	14	36	0	1	37	0	0
14	41366889	.	C	A	16	14	30	0	2	32	0	0
14	41385823	.	G	A	13	9	22	0	0	22	0	0
14	41385895	.	C	T	1	6	7	0	9	16	0	0
14	41388120	.	G	A	9	5	14	0	0	14	0	0
14	41388136	.	C	T	2	3	5	0	0	5	0	0
14	41414242	.	C	A	3	2	5	0	0	5	0	0
14	41414483	.	C	A	1	2	3	0	0	3	0	0
14	41414756	.	C	G	3	0	3	0	5	8	0	0
14	41428500	.	C	T	5	7	12	0	1	13	0	0
14	41435662	.	C	T	5	7	12	0	0	12	0	0
14	41436773	.	T	A	3	10	13	0	0	13	0	0
14	41436943	.	C	T	4	12	16	0	1	17	0	0
14	41466483	.	T	A	3	5	8	0	1	9	0	0
14	41466522	.	G	A	12	9	21	0	1	22	0	0
14	41466922	.	T	A	16	9	25	0	1	26	0	0
14	41467152	.	T	C	16	16	32	0	0	32	0	0
14	41467155	.	C	T	16	15	31	0	4	35	0	0
14	41467356	.	C	G	15	12	27	1	0	28	0	0
14	41469827	.	T	C	2	2	4	0	0	4	0	0
14	41469829	.	T	C	2	2	4	0	0	4	0	0
14	41469925	.	T	A	3	3	6	0	0	6	0	0
14	41469935	.	C	T	1	4	5	0	0	5	0	0
14	41470032	.	C	T	0	3	3	0	3	6	0	0
14	41470037	.	A	T	3	3	6	0	1	7	0	0
14	41514842	.	C	T	1	4	5	1	0	6	0	0
14	41515048	.	C	A	1	2	3	0	1	4	0	0
14	41601248	.	A	G	2	2	4	0	0	4	0	0
14	41601375	.	A	G	2	4	6	0	0	6	0	0
14	42172389	.	A	C	5	2	7	0	0	7	0	0
14	42172457	.	T	A	5	4	9	0	3	12	0	0
14	42172459	.	G	C	0	5	5	0	7	12	0	0
14	42172527	.	G	A	0	3	3	0	6	9	0	0
14	42172732	.	G	A	1	5	6	0	4	10	0	0
14	42172745	.	C	T	7	4	11	0	1	12	0	0
14	42172951	.	G	A	1	4	5	0	6	11	0	0
14	42173803	.	C	T	7	2	9	0	0	9	0	0
14	42174247	.	G	A	1	6	7	0	12	19	0	0
14	42174401	.	C	T	4	7	11	0	0	11	0	0
14	42174645	.	A	T	7	13	20	0	3	23	0	0
14	42178503	.	C	T	17	18	35	0	0	35	0	0
14	42178728	.	G	A	13	7	20	0	1	21	0	0
14	42178974	.	G	A	15	16	31	0	0	31	0	0
14	42978975	.	A	G	20	12	32	0	3	35	0	0
14	42978980	.	A	C	16	15	31	0	0	31	0	0
14	42979030	.	T	C	12	1	13	0	10	23	0	0
14	42979087	.	A	T	5	11	16	0	0	16	0	0
14	42979090	.	T	A	5	10	15	0	1	16	0	0
14	42979655	.	A	G	20	15	35	0	5	40	0	0
14	42997943	.	G	A	18	17	35	0	0	35	0	0
14	42998353	.	G	A	6	4	10	0	1	11	0	0
14	42998879	.	G	A	3	10	13	0	2	15	0	0
14	42999314	.	C	T	5	6	11	0	0	11	0	0
14	42999524	.	C	T	8	5	13	0	0	13	0	0
14	43000785	.	A	T	4	7	11	0	1	12	0	0
14	43577346	.	C	T	0	4	4	0	12	16	0	0
14	43577704	.	G	A	2	9	11	0	1	12	0	0
14	43577916	.	G	A	3	5	8	0	1	9	0	0
14	43580985	.	G	T	4	11	15	0	0	15	0	0
14	43582551	.	C	G	14	8	22	0	0	22	0	0
14	43582567	.	G	A	14	10	24	0	0	24	0	0
14	43582602	.	C	T	10	8	18	0	0	18	0	0
14	43591152	.	G	T	5	8	13	0	1	14	0	0
14	43591188	.	G	A	5	12	17	0	1	18	0	0
14	43605462	.	C	T	4	6	10	0	0	10	0	0
14	43605498	.	T	C	6	0	6	0	8	14	0	0
14	43605510	.	G	A	6	6	12	0	1	13	0	0
14	44013794	.	C	A	2	7	9	0	1	10	0	0
14	44589624	.	C	T	12	11	23	0	0	23	0	0
14	44589834	.	A	G	8	16	24	0	0	24	0	0
14	44589972	.	T	A	10	5	15	0	1	16	0	0
14	44589978	.	G	A	10	5	15	0	1	16	0	0
14	44590297	.	G	C	14	8	22	0	0	22	0	0
14	44590301	.	A	G	12	0	12	0	11	23	0	0
14	44590644	.	C	T	14	18	32	0	1	33	0	0
14	44590838	.	T	A	12	12	24	1	1	26	0	0
14	44590935	.	G	A	1	13	14	0	9	23	0	0
14	44590992	.	A	G	13	12	25	0	0	25	0	0
14	44825436	.	T	A	5	5	10	0	0	10	0	0
14	45295547	.	A	G	10	4	14	0	0	14	0	0
14	45435437	.	C	T	1	4	5	0	0	5	0	0
14	45435444	.	G	A	1	5	6	0	1	7	0	0
14	45636070	.	G	A	7	24	31	1	33	65	0	0
14	45926910	.	C	T	1	3	4	0	0	4	0	0
14	45927130	.	T	G	1	0	1	0	5	6	0	0
14	45927282	.	A	T	2	3	5	0	0	5	0	0
14	45927849	.	C	T	1	3	4	0	0	4	0	0
14	45927861	.	T	C	1	3	4	0	0	4	0	0
14	45928333	.	T	G	1	2	3	0	1	4	0	0
14	45928432	.	T	C	3	3	6	0	0	6	0	0
14	45928603	.	T	A	2	6	8	0	0	8	0	0
14	45928614	.	A	G	6	3	9	0	0	9	0	0
14	45929100	.	A	T	2	2	4	0	0	4	0	0
14	45929837	.	T	A	2	4	6	0	0	6	0	0
14	45929974	.	T	C	3	3	6	0	0	6	0	0
14	45930135	.	T	C	3	5	8	0	0	8	0	0
14	45930196	.	A	C	4	3	7	0	0	7	0	0
14	45930399	.	C	T	4	3	7	0	0	7	0	0
14	45930572	.	A	G	6	3	9	1	2	12	0	0
14	45930573	.	T	G	6	4	10	1	0	11	0	0
14	45930690	.	A	G	4	3	7	0	0	7	0	0
14	45930735	.	T	A	4	5	9	0	0	12	3	0
14	45930744	.	A	G	3	8	11	0	0	11	0	0
14	45930794	.	G	A	3	6	9	0	0	9	0	0
14	45931079	.	C	G	8	5	13	0	0	13	0	0
14	45931194	.	G	T	9	6	15	1	1	17	0	0
14	45931504	.	C	G	13	8	21	0	0	21	0	0
14	45931637	.	C	T	16	9	25	0	0	25	0	0
14	45931899	.	C	T	9	11	20	0	0	20	0	0
14	45932123	.	G	C	10	1	11	0	0	11	0	0
14	45932128	.	T	G	10	2	12	0	1	13	0	0
14	46007306	.	A	G	9	6	15	0	0	15	0	0
14	46007321	.	G	A	7	8	15	0	0	15	0	0
14	46009611	.	G	A	8	8	16	0	1	17	0	0
14	46009683	.	A	T	4	2	6	0	1	7	0	0
14	46010711	.	C	T	12	5	17	0	0	17	0	0
14	46010909	.	T	C	12	6	18	0	0	18	0	0
14	46012960	.	T	C	6	7	13	0	0	13	0	0
14	46013121	.	A	T	11	10	21	0	0	21	0	0
14	46013402	.	C	T	16	10	26	0	1	27	0	0
14	46015888	.	C	A	12	15	27	0	1	28	0	0
14	46016107	.	A	G	14	20	34	0	1	35	0	0
14	46017969	.	G	A	16	9	25	0	0	25	0	0
14	46018029	.	C	T	10	17	27	0	3	30	0	0
14	46028329	.	G	T	3	5	8	0	0	8	0	0
14	46028330	.	T	A	3	5	8	0	0	8	0	0
14	46028548	.	G	C	1	3	4	0	3	7	0	0
14	46039751	.	T	C	2	5	7	0	0	7	0	0
14	46040318	.	T	C	4	7	11	0	0	11	0	0
14	46041800	.	C	T	6	3	9	0	0	9	0	0
14	46041861	.	A	T	8	7	15	0	1	16	0	0
14	46048396	.	A	G	8	5	13	0	0	13	0	0
14	46048644	.	C	T	0	13	13	0	14	27	0	0
14	46048704	.	C	G	1	16	17	0	13	30	0	0
14	46048875	.	T	C	10	18	28	0	3	31	0	0
14	46052172	.	T	A	6	8	14	0	2	16	0	0
14	46052244	.	G	T	7	5	12	0	1	13	0	0
14	46067317	.	A	T	6	5	11	0	0	11	0	0
14	46074433	.	C	T	8	3	11	0	0	11	0	0
14	46075085	.	T	C	4	2	6	0	0	6	0	0
14	46075640	.	A	C	6	3	9	0	0	9	0	0
14	46075749	.	A	G	2	5	7	0	2	9	0	0
14	46076858	.	T	C	3	6	9	0	0	9	0	0
14	46077677	.	T	C	3	2	5	0	0	5	0	0
14	46077997	.	T	C	1	5	6	0	0	6	0	0
14	46078000	.	T	A	0	5	5	0	1	6	0	0
14	46088595	.	T	A	2	2	4	0	1	5	0	0
14	46088921	.	A	G	11	9	20	0	0	20	0	0
14	46089176	.	C	T	8	8	16	0	1	17	0	0
14	46089297	.	A	C	6	4	10	0	0	10	0	0
14	46089433	.	T	G	7	5	12	0	2	14	0	0
14	46089515	.	T	C	2	6	8	0	0	8	0	0
14	46089532	.	T	C	4	4	8	0	2	10	0	0
14	46089632	.	T	C	3	0	3	0	2	5	0	0
14	46090015	.	G	A	5	9	14	0	0	14	0	0
14	46090106	.	T	C	6	2	8	0	0	8	0	0
14	46090156	.	T	C	2	0	2	0	2	4	0	0
14	46090636	.	A	G	1	7	8	0	0	8	0	0
14	46090653	.	T	A	1	4	5	0	0	5	0	0
14	46091627	.	T	C	5	7	12	0	2	14	0	0
14	46094922	.	C	T	10	10	20	0	1	21	0	0
14	46095043	.	A	G	29	22	51	0	1	52	0	0
14	46095058	.	A	G	32	18	50	0	3	53	0	0
14	46095108	.	A	G	31	27	58	0	3	61	0	0
14	46104150	.	C	T	33	17	50	0	6	56	0	0
14	46104222	.	C	T	2	26	28	0	28	56	0	0
14	46104935	.	G	A	29	20	49	0	2	51	0	0
14	46113296	.	T	G	23	18	41	0	1	42	0	0
14	46113309	.	C	G	0	14	14	0	18	32	0	0
14	46114929	.	G	A	17	11	28	0	2	30	0	0
14	46116576	.	A	G	23	15	38	0	1	39	0	0
14	46117279	.	G	T	12	6	18	0	2	20	0	0
14	46117300	.	C	T	2	5	7	0	0	7	0	0
14	46118986	.	T	C	6	2	8	0	0	8	0	0
14	46128948	.	A	C	3	2	5	0	0	5	0	0
14	46129955	.	C	A	6	5	11	0	0	11	0	0
14	46140707	.	C	G	4	4	8	0	0	8	0	0
14	46140812	.	C	A	5	4	9	0	0	9	0	0
14	46146715	.	G	A	9	3	12	0	1	13	0	0
14	46146730	.	G	A	8	2	10	0	2	12	0	0
14	46154358	.	C	A	12	9	21	0	0	21	0	0
14	46154713	.	A	G	8	8	16	0	1	17	0	0
14	46154899	.	A	C	5	7	12	0	1	13	0	0
14	46154966	.	T	A	4	4	8	0	1	9	0	0
14	46154969	.	T	A	3	4	7	0	2	9	0	0
14	46183683	.	A	G	8	5	13	0	0	13	0	0
14	46184640	.	A	G	2	0	2	0	2	4	0	0
14	46184647	.	A	G	1	3	4	0	0	4	0	0
14	46187317	.	A	G	1	7	8	0	0	8	0	0
14	46679356	.	T	C	7	4	11	0	1	12	0	0
14	46679370	.	T	C	6	5	11	0	0	11	0	0
14	46680729	.	T	C	4	4	8	0	0	8	0	0
14	46681861	.	T	C	5	2	7	0	0	7	0	0
14	46681867	.	T	C	3	5	8	0	1	9	0	0
14	46683549	.	T	C	2	3	5	0	0	5	0	0
14	46683558	.	T	C	3	2	5	0	0	5	0	0
14	46684372	.	T	C	4	4	8	0	0	8	0	0
14	46684373	.	T	C	5	3	8	0	0	8	0	0
14	47003023	.	T	G	12	11	23	0	0	23	0	0
14	47003330	.	A	C	16	24	40	0	0	40	0	0
14	47003696	.	G	T	18	18	36	1	1	38	0	0
14	47003908	.	C	T	2	18	20	0	15	35	0	0
14	47003958	.	T	A	22	12	34	0	3	38	1	0
14	47004090	.	T	G	19	14	33	0	1	34	0	0
14	47004187	.	C	A	17	15	32	0	1	33	0	0
14	47004365	.	G	A	19	8	27	0	1	28	0	0
14	47004734	.	G	A	19	12	31	0	1	32	0	0
14	47004959	.	T	G	13	13	26	1	0	27	0	0
14	47027767	.	G	A	15	16	31	1	1	33	0	0
14	47066764	.	G	A	5	5	10	0	1	11	0	0
14	47074234	.	A	G	4	7	11	0	1	12	0	0
14	47085624	.	A	G	10	11	21	0	1	22	0	0
14	47096209	.	T	C	5	0	5	0	3	8	0	0
14	47131242	.	T	G	7	4	11	0	0	11	0	0
14	47131260	.	G	A	8	5	13	0	0	13	0	0
14	47142032	.	C	T	7	7	14	0	0	14	0	0
14	47265031	.	A	G	1	3	4	0	0	4	0	0
14	48108171	.	A	T	1	7	8	0	0	8	0	0
14	48108172	.	A	T	1	7	8	0	0	8	0	0
14	48934630	.	C	G	18	20	38	0	1	39	0	0
14	48934639	.	T	C	25	0	25	0	11	36	0	0
14	49022071	.	A	G	9	0	9	0	6	15	0	0
14	49029169	.	A	G	5	5	10	0	0	10	0	0
14	49030054	.	A	G	1	7	8	0	0	8	0	0
14	49030348	.	A	G	2	6	8	0	0	8	0	0
14	49030378	.	A	G	2	3	5	0	0	5	0	0
14	49053391	.	G	A	1	7	8	0	1	9	0	0
14	49079067	.	A	C	1	4	5	0	0	5	0	0
14	49210955	.	A	G	2	9	11	0	1	12	0	0
14	49211281	.	A	G	4	3	7	0	0	7	0	0
14	49212708	.	A	G	4	2	6	0	0	6	0	0
14	49212718	.	A	G	2	2	4	0	0	4	0	0
14	49430817	.	A	G	7	8	15	0	1	16	0	0
14	49430862	.	A	G	26	0	26	1	9	36	0	0
14	49734011	.	C	G	3	4	7	0	0	7	0	0
14	49738310	.	G	A	0	2	2	0	1	3	0	0
14	49738358	.	C	T	3	2	5	0	0	5	0	0
14	49756700	.	A	T	3	4	7	0	0	7	0	0
14	49757225	.	G	A	1	5	6	0	0	6	0	0
14	49757320	.	A	G	2	6	8	0	0	8	0	0
14	49757359	.	C	G	4	0	4	0	4	8	0	0
14	49757491	.	A	G	3	0	3	0	2	5	0	0
14	49759805	.	G	A	1	3	4	0	0	4	0	0
14	50964260	.	C	T	2	5	7	0	0	7	0	0
14	50968017	.	T	C	1	3	4	0	0	4	0	0
14	50972787	.	C	G	5	1	6	0	1	7	0	0
14	50972921	.	G	A	0	2	2	0	2	4	0	0
14	50973374	.	C	A	2	3	5	0	0	5	0	0
14	50973437	.	T	C	7	2	9	0	2	11	0	0
14	50974729	.	G	A	5	4	9	0	0	9	0	0
14	50974739	.	G	A	1	4	5	0	5	10	0	0
14	50974874	.	C	T	5	4	9	0	0	9	0	0
14	50975094	.	A	G	5	5	10	0	0	10	0	0
14	50975501	.	G	A	0	3	3	1	1	5	0	0
14	50994282	.	A	C	4	5	9	0	0	9	0	0
14	50994361	.	A	G	6	7	13	0	0	13	0	0
14	50994687	.	G	T	18	16	34	0	2	36	0	0
14	50994695	.	G	C	19	17	36	0	1	37	0	0
14	50999698	.	A	G	7	11	18	1	2	21	0	0
14	51002874	.	G	A	10	16	26	0	3	29	0	0
14	51014221	.	T	G	3	10	13	0	0	13	0	0
14	51017771	.	G	A	1	20	21	0	16	37	0	0
14	51017841	.	A	G	10	10	20	0	1	21	0	0
14	51017952	.	G	A	1	5	6	0	7	13	0	0
14	51017990	.	T	A	3	2	5	0	0	5	0	0
14	51829341	.	G	A	40	33	73	0	3	76	0	0
14	51829377	.	A	G	29	37	66	0	4	70	0	0
14	51830952	.	G	A	37	32	69	0	1	70	0	0
14	52357035	.	A	G	3	5	8	0	0	8	0	0
14	52358842	.	A	C	1	3	4	0	0	4	0	0
14	52358971	.	G	C	4	7	11	0	1	12	0	0
14	52361399	.	C	T	5	10	15	0	2	17	0	0
14	52366401	.	G	A	12	4	16	0	0	16	0	0
14	52366464	.	C	T	7	6	13	0	1	14	0	0
14	52369558	.	C	A	4	10	14	0	0	14	0	0
14	52369644	.	C	G	2	6	8	0	0	8	0	0
14	52376418	.	G	A	1	3	4	0	2	6	0	0
14	52379686	.	G	A	4	3	7	1	0	8	0	0
14	52379732	.	C	A	8	8	16	0	0	16	0	0
14	52379740	.	T	A	8	8	16	0	0	16	0	0
14	52379876	.	T	C	10	4	14	0	0	14	0	0
14	52379992	.	C	A	3	5	8	0	2	10	0	0
14	52381762	.	G	A	6	12	18	4	1	23	0	0
14	52383817	.	G	A	21	18	39	0	0	39	0	0
14	52383871	.	G	A	17	11	28	0	0	28	0	0
14	52386667	.	G	A	12	14	26	0	1	27	0	0
14	52386736	.	C	T	15	20	35	0	0	35	0	0
14	52386750	.	G	A	15	20	35	0	3	38	0	0
14	52388115	.	G	A	6	9	15	0	0	15	0	0
14	52388136	.	G	C	7	7	14	0	2	16	0	0
14	52388297	.	T	C	10	0	10	0	6	16	0	0
14	52391664	.	G	A	7	11	18	0	0	18	0	0
14	52392238	.	G	A	5	5	10	0	5	15	0	0
14	52395438	.	T	C	5	0	5	0	12	17	0	0
14	52395492	.	G	A	4	4	8	0	0	8	0	0
14	52395552	.	C	T	6	10	16	0	0	16	0	0
14	52395558	.	G	A	6	10	16	0	0	16	0	0
14	52397293	.	C	T	4	5	9	0	0	9	0	0
14	52399977	.	A	G	7	7	14	0	0	14	0	0
14	52400426	.	G	C	4	3	7	0	0	7	0	0
14	52404637	.	G	A	4	4	8	4	0	12	0	0
14	52408723	.	T	C	2	5	7	0	1	8	0	0
14	52411315	.	C	G	7	12	19	0	0	19	0	0
14	52413205	.	G	A	0	7	7	0	4	11	0	0
14	52414357	.	A	G	7	0	7	0	10	17	0	0
14	52417462	.	T	A	2	3	5	0	1	6	0	0
14	52417470	.	A	T	3	4	7	0	1	8	0	0
14	52418274	.	C	A	6	6	12	0	0	12	0	0
14	52418565	.	T	G	9	2	11	0	9	20	0	0
14	52418701	.	C	G	9	2	11	0	8	19	0	0
14	52418772	.	G	T	10	5	15	0	0	15	0	0
14	52418818	.	A	G	3	8	11	0	3	14	0	0
14	52418943	.	A	T	6	2	8	0	0	8	0	0
14	52419007	.	C	G	2	2	4	0	0	4	0	0
14	52419048	.	T	A	1	2	3	0	0	3	0	0
14	52494686	.	T	C	1	4	5	0	0	5	0	0
14	52512529	.	G	A	3	6	9	0	4	13	0	0
14	52513561	.	C	T	2	8	10	0	0	10	0	0
14	52517733	.	A	C	2	0	2	0	16	18	0	0
14	52517782	.	T	A	8	2	10	0	1	11	0	0
14	52517784	.	A	C	7	3	10	0	1	11	0	0
14	52517870	.	A	G	8	8	16	0	1	17	0	0
14	52517957	.	T	C	12	14	26	1	1	28	0	0
14	52518002	.	A	G	10	12	22	0	1	23	0	0
14	52518030	.	G	A	2	10	12	0	10	22	0	0
14	52518125	.	C	A	5	13	18	0	0	18	0	0
14	52518375	.	C	T	7	2	9	0	2	11	0	0
14	52520270	.	G	A	7	2	9	0	0	9	0	0
14	52520367	.	T	C	10	7	17	0	0	17	0	0
14	52520528	.	G	T	3	2	5	0	0	5	0	0
14	52520540	.	G	A	4	2	6	0	0	6	0	0
14	52520626	.	T	A	1	3	4	0	0	4	0	0
14	52522820	.	T	C	13	9	22	0	1	23	0	0
14	52522822	.	C	T	13	10	23	0	0	23	0	0
14	52522876	.	C	T	10	10	20	0	1	21	0	0
14	52523223	.	A	C	5	1	6	0	5	11	0	0
14	52523237	.	G	C	6	9	15	0	0	15	0	0
14	52523290	.	C	T	2	7	9	0	4	13	0	0
14	52523493	.	T	C	13	13	26	1	1	28	0	0
14	52523522	.	T	C	18	0	18	1	9	28	0	0
14	52523529	.	T	C	10	15	25	1	1	27	0	0
14	52523648	.	G	T	7	11	18	0	0	18	0	0
14	52523707	.	A	G	12	4	16	0	2	18	0	0
14	52524072	.	T	C	2	3	5	0	0	5	0	0
14	52524091	.	A	G	3	3	6	0	0	6	0	0
14	52524110	.	A	G	4	3	7	0	1	8	0	0
14	52524364	.	C	T	1	5	6	0	11	18	1	0
14	52524525	.	A	T	7	2	9	0	0	9	0	0
14	52524651	.	A	T	7	5	12	0	0	12	0	0
14	52524653	.	G	T	7	5	12	0	0	12	0	0
14	52524687	.	T	A	5	9	14	1	0	15	0	0
14	52524767	.	A	G	7	7	14	0	0	14	0	0
14	52524792	.	A	G	9	4	13	0	1	14	0	0
14	52525016	.	C	T	1	11	12	0	8	20	0	0
14	52525673	.	G	A	6	15	21	0	0	21	0	0
14	52525812	.	C	T	1	17	18	0	11	29	0	0
14	52528210	.	G	A	8	11	19	0	1	20	0	0
14	52533500	.	G	A	13	10	23	0	1	24	0	0
14	52536303	.	G	C	12	6	18	0	2	20	0	0
14	52538887	.	G	A	9	7	16	0	0	16	0	0
14	52552852	.	A	G	17	10	27	0	0	28	1	0
14	52552863	.	G	A	15	16	31	1	3	35	0	0
14	52571225	.	C	A	3	2	5	0	0	5	0	0
14	52574434	.	C	G	1	2	3	0	0	3	0	0
14	52574497	.	C	A	2	3	5	0	0	5	0	0
14	52574979	.	C	T	1	6	7	0	0	7	0	0
14	52575754	.	T	C	5	8	13	0	0	13	0	0
14	52575878	.	A	G	1	8	9	0	1	10	0	0
14	52575879	.	T	A	1	9	10	0	0	10	0	0
14	52576173	.	C	T	0	6	6	0	8	14	0	0
14	52577036	.	G	A	5	2	7	0	0	7	0	0
14	52577042	.	A	G	5	2	7	0	0	7	0	0
14	52580608	.	G	A	2	3	5	0	1	6	0	0
14	52580849	.	G	A	5	2	7	0	0	7	0	0
15	634266	.	A	G	1	2	3	0	1	4	0	0
15	784368	.	G	C	1	4	5	1	0	6	0	0
15	785772	.	C	T	1	2	3	1	0	4	0	0
15	827432	.	T	A	1	3	4	0	0	4	0	0
15	870082	.	A	G	1	2	3	1	1	5	0	0
15	870083	.	T	G	1	3	4	1	0	5	0	0
15	893426	.	A	G	1	0	1	2	2	5	0	0
15	894804	.	G	A	0	2	2	3	7	12	0	0
15	909646	.	A	G	2	3	5	0	0	5	0	0
15	920853	.	T	C	4	2	6	0	0	6	0	0
15	1026224	.	T	G	3	3	6	0	0	6	0	0
15	1026462	.	G	A	2	2	4	0	0	4	0	0
15	1029379	.	G	C	2	2	4	0	0	4	0	0
15	1033435	.	A	T	3	5	8	0	0	8	0	0
15	1033479	.	T	G	1	4	5	0	1	6	0	0
15	1033564	.	G	T	4	9	13	0	1	14	0	0
15	1033853	.	A	G	5	7	12	0	0	12	0	0
15	1033955	.	C	T	0	6	6	0	2	8	0	0
15	1036677	.	C	T	0	2	2	0	4	6	0	0
15	1036825	.	T	C	5	5	10	0	0	10	0	0
15	1148129	.	A	G	2	3	5	0	0	5	0	0
15	1152067	.	T	C	4	5	9	0	0	9	0	0
15	1167166	.	G	A	0	3	3	0	5	8	0	0
15	1173016	.	A	G	4	0	4	0	10	14	0	0
15	1173067	.	C	T	5	5	10	0	0	10	0	0
15	1173542	.	C	T	10	7	17	0	1	18	0	0
15	1176447	.	G	A	1	8	9	0	5	14	0	0
15	1178927	.	C	A	5	10	15	0	1	16	0	0
15	1183930	.	G	T	1	5	6	0	0	6	0	0
15	1186181	.	A	G	6	3	9	0	0	9	0	0
15	1186202	.	C	T	0	4	4	0	7	11	0	0
15	1189664	.	C	T	17	7	24	0	1	25	0	0
15	1191750	.	A	G	19	10	29	0	2	31	0	0
15	1191792	.	G	A	3	8	11	0	12	23	0	0
15	1191822	.	A	G	14	0	14	0	10	24	0	0
15	1194590	.	A	G	18	5	23	0	0	23	0	0
15	1194670	.	G	A	20	6	26	0	1	27	0	0
15	1194739	.	G	T	9	8	17	0	0	17	0	0
15	1194754	.	T	C	6	8	14	0	1	15	0	0
15	1417032	.	G	A	0	14	14	0	16	30	0	0
15	1417104	.	C	T	16	14	30	0	1	31	0	0
15	1430434	.	A	T	17	14	31	0	3	34	0	0
15	1434192	.	T	A	24	12	36	0	1	37	0	0
15	1434228	.	T	C	25	15	40	0	1	41	0	0
15	1434556	.	A	C	1	1	2	0	0	2	0	0
15	1434885	.	T	C	19	16	35	0	2	37	0	0
15	1435024	.	T	C	23	16	39	2	0	41	0	0
15	1435047	.	A	G	20	23	43	0	0	43	0	0
15	1435176	.	A	G	17	0	17	0	25	42	0	0
15	1435368	.	T	A	18	12	30	0	3	33	0	0
15	1435462	.	G	A	1	12	13	0	28	42	1	0
15	1435626	.	G	A	17	7	24	0	2	26	0	0
15	1435680	.	T	A	19	8	27	0	3	30	0	0
15	1435699	.	A	T	19	8	27	0	3	30	0	0
15	1436041	.	C	A	13	9	22	0	0	22	0	0
15	1436072	.	T	A	20	18	38	0	1	39	0	0
15	1436154	.	T	C	8	34	42	0	1	43	0	0
15	1436386	.	G	A	3	23	26	4	29	59	0	0
15	1436457	.	C	A	20	12	32	1	17	50	0	0
15	1436461	.	A	G	22	14	36	1	9	46	0	0
15	1436537	.	C	T	20	16	36	0	0	36	0	0
15	1436629	.	T	C	5	3	8	0	0	8	0	0
15	1453067	.	C	A	1	4	5	0	0	5	0	0
15	1453118	.	C	T	1	3	4	0	0	4	0	0
15	1471550	.	C	T	0	2	2	0	1	3	0	0
15	1495037	.	C	A	3	9	12	0	10	22	0	0
15	1495040	.	C	T	10	6	16	0	3	19	0	0
15	1497353	.	G	A	15	9	24	0	0	24	0	0
15	1497398	.	C	G	11	6	17	0	1	18	0	0
15	1497443	.	A	G	8	6	14	0	1	15	0	0
15	1497982	.	T	A	7	7	14	0	2	16	0	0
15	1499732	.	C	T	3	3	6	2	0	8	0	0
15	1502474	.	A	C	6	4	10	0	0	10	0	0
15	1506392	.	A	G	5	3	8	0	0	8	0	0
15	1506503	.	C	T	0	6	6	0	7	13	0	0
15	1602952	.	A	G	14	12	26	0	3	29	0	0
15	1606802	.	G	C	14	0	14	0	18	32	0	0
15	1607707	.	G	A	20	13	33	0	2	35	0	0
15	1612770	.	T	C	9	13	22	0	2	24	0	0
15	1612845	.	C	T	1	7	8	0	11	19	0	0
15	1614119	.	G	A	7	9	16	0	0	16	0	0
15	1614128	.	C	T	0	11	11	0	7	18	0	0
15	1617111	.	G	A	9	10	19	0	0	19	0	0
15	1622341	.	C	T	11	15	26	0	0	26	0	0
15	1622390	.	G	C	12	1	13	0	16	29	0	0
15	1631004	.	C	A	5	2	7	0	0	7	0	0
15	1631086	.	T	C	3	3	6	0	0	6	0	0
15	1631209	.	T	C	7	0	7	0	11	18	0	0
15	1631241	.	C	G	11	4	15	0	2	17	0	0
15	1631336	.	A	T	16	9	25	0	1	26	0	0
15	1631345	.	C	T	15	11	26	0	0	26	0	0
15	1631408	.	C	T	0	26	26	0	6	32	0	0
15	1631528	.	G	A	4	21	25	2	4	31	0	0
15	1633353	.	A	G	5	15	20	0	2	22	0	0
15	1651295	.	G	A	3	22	25	0	2	27	0	0
15	1651298	.	A	G	3	22	25	0	2	27	0	0
15	1651634	.	C	A	4	12	16	0	1	17	0	0
15	1654506	.	G	A	1	3	4	0	1	5	0	0
15	1655608	.	C	T	1	4	5	0	1	6	0	0
15	1661732	.	T	C	8	5	13	0	0	13	0	0
15	1667813	.	T	C	6	3	9	0	1	10	0	0
15	1667991	.	A	G	7	0	7	0	6	13	0	0
15	1669719	.	C	T	10	10	20	0	2	22	0	0
15	1672050	.	G	A	2	8	10	0	9	19	0	0
15	1672060	.	G	A	8	9	17	0	1	18	0	0
15	1672130	.	C	T	5	4	9	0	0	9	0	0
15	1680090	.	C	T	3	4	7	0	0	7	0	0
15	1680092	.	A	C	3	4	7	0	0	7	0	0
15	1681700	.	A	G	5	3	8	0	1	9	0	0
15	1719144	.	C	T	2	4	6	0	0	6	0	0
15	1719161	.	A	G	3	6	9	0	0	9	0	0
15	1719371	.	C	T	0	4	4	0	3	7	0	0
15	1719389	.	A	G	4	2	6	0	0	6	0	0
15	1719413	.	C	T	0	4	4	0	4	8	0	0
15	1719476	.	C	T	1	6	7	0	4	11	0	0
15	1721514	.	T	C	2	0	2	0	3	5	0	0
15	1721523	.	A	G	2	2	4	0	1	5	0	0
15	1730643	.	A	G	6	2	8	0	0	8	0	0
15	1750044	.	G	C	6	6	12	0	0	12	0	0
15	1750047	.	A	C	6	6	12	0	0	12	0	0
15	1753501	.	A	G	2	8	10	0	2	12	0	0
15	1756009	.	G	A	1	6	7	0	0	7	0	0
15	1758037	.	C	T	6	7	13	0	0	13	0	0
15	1758058	.	G	A	5	7	12	0	0	12	0	0
15	1758636	.	G	A	3	7	10	0	0	10	0	0
15	1758675	.	T	C	1	0	1	0	7	8	0	0
15	1766675	.	C	T	12	5	17	0	0	17	0	0
15	1774417	.	T	C	6	3	9	0	1	10	0	0
15	1778714	.	A	T	7	2	9	0	0	9	0	0
15	1778720	.	C	T	7	1	8	0	1	9	0	0
15	1782156	.	T	C	7	6	13	0	0	13	0	0
15	1789281	.	T	A	14	15	29	0	1	30	0	0
15	1789302	.	T	C	11	11	22	0	0	22	0	0
15	1792532	.	T	G	7	16	23	0	1	24	0	0
15	1828388	.	C	T	8	7	15	0	1	16	0	0
15	1829166	.	C	T	24	18	42	0	5	47	0	0
15	1829310	.	A	G	25	20	45	0	1	46	0	0
15	1830452	.	G	A	12	13	25	0	2	27	0	0
15	1831210	.	A	G	23	15	38	0	4	42	0	0
15	1834326	.	A	G	14	13	27	0	0	27	0	0
15	1837854	.	T	G	13	14	27	0	0	27	0	0
15	1837878	.	G	T	12	11	23	0	2	25	0	0
15	1841328	.	T	C	14	11	25	0	1	26	0	0
15	1847299	.	G	A	6	4	10	0	1	11	0	0
15	1847310	.	T	A	4	6	10	0	1	11	0	0
15	1847358	.	A	G	6	8	14	0	0	14	0	0
15	1847533	.	C	T	4	5	9	0	1	10	0	0
15	1847679	.	A	G	4	4	8	0	0	8	0	0
15	1847728	.	G	A	7	5	12	0	0	12	0	0
15	1847755	.	G	T	9	5	14	0	2	16	0	0
15	1847908	.	A	C	8	7	15	0	1	16	0	0
15	1847931	.	G	A	6	8	14	0	2	16	0	0
15	1847951	.	G	A	5	4	9	0	0	9	0	0
15	1848062	.	T	C	10	3	13	0	0	13	0	0
15	1848098	.	T	C	6	7	13	0	0	13	0	0
15	1848121	.	T	C	9	4	13	0	0	13	0	0
15	1848135	.	T	C	8	0	8	0	3	11	0	0
15	1848188	.	T	C	3	0	3	0	11	14	0	0
15	1848202	.	G	T	3	7	10	0	3	13	0	0
15	1848308	.	G	A	2	5	7	0	0	7	0	0
15	1848320	.	G	A	1	4	5	0	0	5	0	0
15	1848349	.	A	C	2	2	4	0	0	4	0	0
15	1848612	.	G	C	2	0	2	0	2	4	0	0
15	1850540	.	A	C	2	1	3	0	2	5	0	0
15	1858625	.	A	G	5	6	11	0	0	11	0	0
15	1858638	.	C	G	4	5	9	0	0	9	0	0
15	1862015	.	A	T	3	1	4	0	0	4	0	0
15	1862024	.	C	T	0	3	3	0	3	6	0	0
15	1871916	.	A	T	1	2	3	0	0	3	0	0
15	1871919	.	G	T	1	2	3	0	0	3	0	0
15	1893323	.	G	A	1	9	10	0	16	26	0	0
15	1893356	.	A	G	12	0	12	0	9	21	0	0
15	1897928	.	T	A	1	3	4	0	0	4	0	0
15	1898051	.	A	C	4	3	7	0	1	8	0	0
15	1898173	.	T	A	3	4	7	0	0	7	0	0
15	1898187	.	C	A	1	5	6	0	0	6	0	0
15	1898359	.	G	T	4	8	12	0	0	12	0	0
15	1898384	.	T	C	2	6	8	0	0	8	0	0
15	1898699	.	G	C	1	2	3	3	0	6	0	0
15	1898860	.	A	G	2	2	4	0	0	4	0	0
15	1899401	.	A	T	10	5	15	0	0	15	0	0
15	1899831	.	G	A	8	21	29	0	2	31	0	0
15	1899878	.	T	C	7	11	18	0	0	18	0	0
15	1902259	.	A	G	8	9	17	0	0	17	0	0
15	1902271	.	C	T	6	8	14	0	0	14	0	0
15	1903029	.	A	G	9	11	20	0	0	20	0	0
15	1905364	.	T	G	4	5	9	0	0	9	0	0
15	1905412	.	T	C	4	8	12	0	1	13	0	0
15	1908147	.	G	C	3	3	6	0	1	7	0	0
15	1914743	.	G	A	4	3	7	0	1	8	0	0
15	1926926	.	A	T	7	2	9	0	1	10	0	0
15	1933275	.	G	A	2	4	6	0	0	6	0	0
15	1940985	.	A	G	1	3	4	0	0	4	0	0
15	2414007	.	A	G	2	2	4	0	0	4	0	0
15	2414021	.	A	G	1	3	4	0	0	4	0	0
15	2414764	.	A	G	4	2	6	0	0	6	0	0
15	2414798	.	A	G	5	3	8	0	0	8	0	0
15	2414871	.	A	G	2	6	8	0	0	8	0	0
15	2415227	.	A	G	3	4	7	0	1	8	0	0
15	2415256	.	A	G	1	1	2	0	4	6	0	0
15	2729971	.	T	C	5	5	10	0	1	11	0	0
15	2730289	.	T	C	4	13	17	0	0	17	0	0
15	2730358	.	T	C	8	12	20	0	0	20	0	0
15	2730735	.	T	C	7	2	9	0	1	10	0	0
15	3161891	.	A	T	4	2	6	0	0	6	0	0
15	3377050	.	C	G	3	5	8	0	3	12	1	0
15	3377106	.	C	T	3	3	6	0	2	8	0	0
15	3921346	.	A	G	2	0	2	0	3	5	0	0
15	3922509	.	T	C	2	2	4	0	0	4	0	0
15	3922638	.	C	T	2	4	6	0	0	6	0	0
15	3922752	.	C	A	4	4	8	0	0	8	0	0
15	3923082	.	T	G	1	3	4	0	0	4	0	0
15	3923135	.	A	G	1	0	1	0	3	4	0	0
15	3923193	.	A	G	1	4	5	0	0	5	0	0
15	3924349	.	C	G	4	3	7	0	0	7	0	0
15	3925206	.	G	T	1	5	6	0	3	9	0	0
15	3928759	.	C	A	0	2	2	0	1	3	0	0
15	3930076	.	C	T	1	2	3	0	0	3	0	0
15	4104889	.	T	A	3	2	5	0	0	5	0	0
15	4105009	.	A	G	8	3	11	0	0	11	0	0
15	4105164	.	C	T	0	9	9	0	4	13	0	0
15	4105262	.	A	G	7	4	11	0	0	11	0	0
15	4105328	.	A	G	7	5	12	0	0	12	0	0
15	4105416	.	G	T	4	5	9	0	0	9	0	0
15	4111649	.	T	C	5	5	10	0	0	10	0	0
15	4111821	.	A	G	11	6	17	0	0	17	0	0
15	4123660	.	T	G	4	2	6	0	0	6	0	0
15	4172458	.	C	T	5	5	10	0	0	10	0	0
15	4172470	.	A	G	5	3	8	0	0	8	0	0
15	4174147	.	T	G	4	5	9	0	1	10	0	0
15	4174174	.	C	T	5	4	9	0	0	9	0	0
15	4174191	.	G	T	3	3	6	0	0	6	0	0
15	4177160	.	C	A	8	4	12	0	1	13	0	0
15	4180093	.	C	A	0	6	6	0	3	9	0	0
15	4182667	.	T	C	6	0	6	0	10	16	0	0
15	4182718	.	A	G	4	4	8	0	1	9	0	0
15	4190893	.	T	A	2	3	5	0	0	5	0	0
15	4202321	.	C	T	1	4	5	0	0	5	0	0
15	4207587	.	G	C	4	4	8	0	0	8	0	0
15	4314014	.	C	A	2	2	4	0	0	4	0	0
15	4353311	.	G	T	33	15	48	0	1	49	0	0
15	4353333	.	T	C	32	1	33	0	12	51	6	0
15	4353965	.	G	A	34	33	67	0	7	74	0	0
15	4354082	.	G	A	33	37	70	0	3	73	0	0
15	4371833	.	T	C	26	23	49	1	1	51	0	0
15	4371863	.	C	T	31	21	52	1	2	55	0	0
15	4376110	.	C	T	3	26	29	0	16	45	0	0
15	4415864	.	G	C	11	5	16	0	0	16	0	0
15	4422222	.	A	G	3	2	5	0	0	5	0	0
15	4422293	.	G	C	3	0	3	0	2	5	0	0
15	4422383	.	A	T	2	4	6	0	0	6	0	0
15	4422394	.	G	A	2	4	6	0	0	6	0	0
15	4422514	.	G	C	1	4	5	0	0	5	0	0
15	4426474	.	C	T	4	3	7	0	1	8	0	0
15	4429003	.	C	T	1	2	3	0	3	6	0	0
15	4429004	.	G	A	3	2	5	0	1	6	0	0
15	6234255	.	G	A	5	4	9	0	0	9	0	0
15	6529942	.	C	G	0	2	2	0	3	5	0	0
15	6529953	.	T	C	2	4	6	0	0	6	0	0
15	6541406	.	A	G	3	3	6	0	0	6	0	0
15	6553665	.	C	T	1	2	3	0	0	3	0	0
15	6652600	.	T	C	10	15	25	0	0	25	0	0
15	6653094	.	T	G	11	16	27	0	0	27	0	0
15	6653209	.	G	T	1	12	13	0	15	28	0	0
15	6653282	.	C	G	9	6	15	0	0	15	0	0
15	6654524	.	T	G	8	11	19	0	2	21	0	0
15	6654587	.	C	A	20	12	32	0	0	32	0	0
15	6659159	.	G	A	15	9	24	0	1	25	0	0
15	6661390	.	G	A	16	19	35	0	0	35	0	0
15	6661449	.	T	C	15	14	29	0	3	32	0	0
15	6661499	.	G	A	21	15	36	0	2	38	0	0
15	6726548	.	A	T	1	4	5	0	0	5	0	0
15	6778483	.	A	G	3	4	7	0	0	7	0	0
15	6778813	.	A	G	3	3	6	0	0	6	0	0
15	6778825	.	A	G	2	4	6	0	1	7	0	0
15	6778856	.	C	A	9	3	12	0	0	12	0	0
15	6778877	.	A	G	7	4	11	0	1	12	0	0
15	6784093	.	T	C	1	3	4	0	0	4	0	0
15	6784118	.	C	T	1	3	4	0	0	4	0	0
15	6789675	.	T	C	5	10	15	0	0	15	0	0
15	6799903	.	G	A	5	9	14	0	0	14	0	0
15	6806712	.	G	C	13	22	35	0	1	36	0	0
15	6806836	.	G	A	15	17	32	0	0	32	0	0
15	6806912	.	T	G	10	13	23	0	0	23	0	0
15	6806931	.	T	G	9	10	19	0	0	19	0	0
15	6807014	.	A	T	6	4	10	0	0	10	0	0
15	6807406	.	C	A	6	3	9	0	0	9	0	0
15	6807500	.	C	G	10	16	26	0	0	26	0	0
15	6807514	.	G	A	10	14	24	0	1	25	0	0
15	6807563	.	A	T	11	16	27	0	1	28	0	0
15	6807874	.	C	T	4	8	12	0	0	12	0	0
15	6838043	.	C	A	3	2	5	0	1	6	0	0
15	6838554	.	T	C	5	0	5	0	4	9	0	0
15	6838580	.	G	C	5	6	11	0	0	11	0	0
15	6838668	.	A	G	5	2	7	0	0	7	0	0
15	6838693	.	A	G	6	2	8	0	0	8	0	0
15	6838771	.	T	C	5	6	11	0	0	11	0	0
15	6838786	.	T	C	5	7	12	0	0	12	0	0
15	6841506	.	G	T	5	10	15	0	0	15	0	0
15	6845567	.	A	G	3	4	7	0	0	7	0	0
15	6862665	.	G	C	4	2	6	0	0	6	0	0
15	6863048	.	C	T	0	5	5	0	2	7	0	0
15	6863102	.	G	A	1	5	6	0	0	6	0	0
15	6957221	.	C	G	11	6	17	0	1	18	0	0
15	9235461	.	T	G	36	29	65	0	2	67	0	0
15	9369509	.	T	C	5	2	7	0	0	7	0	0
15	13107454	.	T	A	6	2	8	0	0	8	0	0
15	13107498	.	C	T	7	6	13	0	0	13	0	0
15	13107561	.	T	C	11	7	18	0	0	18	0	0
15	13107562	.	G	A	11	7	18	0	0	18	0	0
15	13127035	.	A	G	5	20	25	0	1	26	0	0
15	13127248	.	T	C	6	14	20	0	1	21	0	0
15	13129937	.	A	G	7	15	22	0	0	22	0	0
15	13138074	.	A	C	4	4	8	0	0	8	0	0
15	13207497	.	C	T	2	7	9	0	0	9	0	0
15	13207561	.	T	G	2	4	6	0	0	6	0	0
15	13207597	.	C	T	0	4	4	0	3	7	0	0
15	13207828	.	T	A	6	5	11	0	0	11	0	0
15	13207858	.	G	C	9	6	15	0	0	15	0	0
15	13207870	.	A	G	9	6	15	0	0	15	0	0
15	13208218	.	T	C	3	1	4	0	4	8	0	0
15	13985123	.	C	A	4	6	10	0	2	12	0	0
15	13985578	.	T	C	2	8	10	0	0	10	0	0
15	13985644	.	C	T	6	7	13	0	0	13	0	0
15	13985827	.	C	G	4	2	6	0	0	6	0	0
15	13986009	.	T	C	5	3	8	0	0	8	0	0
15	13986233	.	G	T	6	3	9	0	0	9	0	0
15	13986279	.	A	T	6	3	9	0	0	9	0	0
15	13986586	.	C	T	4	3	7	0	5	12	0	0
15	14076223	.	A	T	2	2	4	0	0	4	0	0
15	14076329	.	T	G	6	8	14	0	0	14	0	0
15	14076376	.	C	T	4	9	13	0	0	13	0	0
15	14076550	.	G	T	1	3	4	0	0	4	0	0
15	14076710	.	T	A	3	3	6	0	0	6	0	0
15	14079784	.	G	A	5	3	8	0	1	9	0	0
15	14079974	.	G	C	5	4	9	0	2	11	0	0
15	14082347	.	G	T	8	16	24	0	1	25	0	0
15	14083023	.	T	G	15	7	22	0	0	22	0	0
15	14085276	.	T	G	4	2	6	0	0	6	0	0
15	14085800	.	T	C	2	3	5	0	1	6	0	0
15	14085847	.	G	T	4	3	7	0	1	8	0	0
15	14085914	.	G	A	8	8	16	0	0	16	0	0
15	14088146	.	G	A	14	10	24	0	1	25	0	0
15	14088252	.	G	A	3	6	9	0	1	10	0	0
15	14088270	.	C	T	6	6	12	0	0	12	0	0
15	14092805	.	G	A	7	5	12	0	1	13	0	0
15	14092819	.	C	A	6	3	9	0	1	10	0	0
15	14093020	.	G	A	9	4	13	0	0	13	0	0
15	14093032	.	A	G	8	6	14	0	1	15	0	0
15	14093110	.	T	A	6	5	11	0	0	11	0	0
15	14093197	.	C	T	6	3	9	0	0	9	0	0
15	14098221	.	G	A	3	7	10	0	1	11	0	0
15	14183934	.	A	G	1	3	4	0	1	5	0	0
15	14206359	.	A	C	2	5	7	0	2	9	0	0
15	14206430	.	T	C	3	2	5	0	0	5	0	0
15	14206438	.	G	A	4	2	6	0	1	7	0	0
15	14206480	.	A	G	4	5	9	0	0	9	0	0
15	14206505	.	T	C	2	6	8	0	0	8	0	0
15	14206593	.	C	T	0	2	2	0	4	6	0	0
15	14206594	.	G	A	3	3	6	0	0	6	0	0
15	14206789	.	G	A	3	3	6	0	0	6	0	0
15	14207871	.	C	T	2	2	4	0	0	4	0	0
15	14207874	.	C	G	2	2	4	0	0	4	0	0
15	14208556	.	T	C	1	2	3	0	0	3	0	0
15	14208871	.	G	A	1	2	3	0	0	3	0	0
15	14317040	.	G	A	9	6	15	0	0	15	0	0
15	14321321	.	C	G	8	2	10	0	0	10	0	0
15	14385123	.	A	G	1	0	1	0	2	3	0	0
15	14388411	.	G	A	0	2	2	0	3	5	0	0
15	14388555	.	T	C	3	2	5	0	0	5	0	0
15	14388588	.	C	T	1	2	3	0	0	3	0	0
15	14419221	.	A	G	3	2	5	0	2	7	0	0
15	14420177	.	C	T	3	6	9	0	0	9	0	0
15	14436811	.	C	T	0	6	6	0	5	11	0	0
15	14437204	.	A	G	7	4	11	0	1	12	0	0
15	14437239	.	T	A	6	6	12	0	2	14	0	0
15	14443567	.	G	A	1	2	3	0	0	3	0	0
15	14446565	.	A	C	3	0	3	0	2	5	0	0
15	14554634	.	G	A	6	5	11	0	0	11	0	0
15	14554769	.	C	T	3	10	13	0	8	21	0	0
15	14557015	.	G	A	8	6	14	0	1	15	0	0
15	14557047	.	T	G	7	8	15	0	1	16	0	0
15	14558180	.	A	T	5	3	8	0	0	8	0	0
15	14561658	.	C	T	4	5	9	0	0	9	0	0
15	14564294	.	T	A	4	3	7	0	0	7	0	0
15	14571106	.	G	T	2	4	6	0	0	6	0	0
15	14571139	.	G	A	3	2	5	0	0	5	0	0
15	14571193	.	T	G	1	2	3	0	0	3	0	0
15	14571194	.	C	T	1	2	3	0	0	3	0	0
15	14592987	.	C	A	3	3	6	0	0	6	0	0
15	14597312	.	C	G	1	2	3	0	1	4	0	0
15	14597342	.	G	A	2	3	5	0	1	6	0	0
15	14597518	.	A	G	7	5	12	0	0	12	0	0
15	14597589	.	G	T	5	6	11	0	0	11	0	0
15	14597670	.	T	A	1	2	3	0	1	4	0	0
15	14597991	.	T	C	1	5	6	0	1	7	0	0
15	14598192	.	G	A	1	4	5	0	0	5	0	0
15	14598321	.	G	A	0	2	2	0	3	5	0	0
15	14598327	.	G	A	3	1	4	0	0	4	0	0
15	14598403	.	G	A	4	6	10	0	0	10	0	0
15	14598708	.	C	T	5	3	8	0	0	8	0	0
15	14598930	.	G	A	0	5	5	0	14	19	0	0
15	14599152	.	T	C	7	8	15	0	0	15	0	0
15	14599167	.	G	A	2	7	9	0	9	18	0	0
15	14599203	.	A	G	12	7	19	0	0	19	0	0
15	14599486	.	G	A	2	4	6	0	1	7	0	0
15	14630829	.	T	A	8	3	11	0	2	13	0	0
15	14630830	.	C	T	1	4	5	0	8	13	0	0
15	14630941	.	T	C	5	0	5	0	6	11	0	0
15	14631242	.	A	G	4	4	8	0	0	8	0	0
15	14631258	.	C	T	3	4	7	0	0	7	0	0
15	14631289	.	T	C	5	7	12	0	2	14	0	0
15	14631314	.	G	A	8	7	15	0	0	15	0	0
15	14631531	.	T	C	2	0	2	0	6	8	0	0
15	14631535	.	T	C	2	6	8	0	0	8	0	0
15	14631665	.	A	G	5	3	8	0	1	9	0	0
15	14631743	.	T	A	2	3	5	0	0	5	0	0
15	14631772	.	T	C	4	2	6	0	0	6	0	0
15	14631930	.	T	C	1	6	7	0	0	7	0	0
15	14631969	.	A	G	10	7	17	0	0	17	0	0
15	14632135	.	C	T	2	16	18	0	10	28	0	0
15	14632160	.	A	T	14	9	23	0	0	23	0	0
15	14632189	.	T	C	10	9	19	0	1	20	0	0
15	14632197	.	G	T	10	8	18	0	0	18	0	0
15	14632244	.	A	T	9	8	17	0	0	17	0	0
15	14632293	.	T	A	9	5	14	0	1	15	0	0
15	14632510	.	G	A	12	3	15	0	0	15	0	0
15	14632543	.	C	T	12	3	15	0	3	18	0	0
15	14632561	.	T	C	12	0	12	0	6	18	0	0
15	14632834	.	G	C	9	0	9	0	3	12	0	0
15	14632842	.	G	A	9	3	12	0	0	12	0	0
15	14633002	.	A	C	5	7	12	0	1	13	0	0
15	14633011	.	T	C	6	0	6	0	7	13	0	0
15	14633041	.	T	C	5	0	5	0	7	12	0	0
15	14633077	.	T	C	7	0	7	0	6	13	0	0
15	14633404	.	C	T	0	8	8	0	11	19	0	0
15	14633659	.	C	T	4	3	7	0	1	8	0	0
15	14633815	.	A	G	3	4	7	0	0	7	0	0
15	14633875	.	C	T	1	4	5	0	4	9	0	0
15	14633905	.	T	G	7	5	12	0	0	12	0	0
15	14633982	.	A	G	4	5	9	0	2	11	0	0
15	14634166	.	T	C	7	8	15	0	1	16	0	0
15	14634199	.	A	G	7	5	12	0	0	12	0	0
15	14634394	.	T	A	7	4	11	0	0	11	0	0
15	14634501	.	A	G	4	4	8	0	0	8	0	0
15	14636343	.	G	A	2	7	9	0	1	10	0	0
15	14636447	.	G	A	6	3	9	0	1	10	0	0
15	14636475	.	G	T	3	4	7	0	0	7	0	0
15	14638572	.	C	T	5	7	12	0	0	12	0	0
15	14638584	.	A	C	5	6	11	0	0	11	0	0
15	14639435	.	G	A	1	4	5	0	1	6	0	0
15	14641761	.	T	G	4	4	8	0	0	8	0	0
15	14641823	.	T	G	5	2	7	0	0	7	0	0
15	14642048	.	G	A	3	3	6	0	0	6	0	0
15	14642904	.	G	C	4	3	7	0	0	7	0	0
15	14660641	.	T	G	2	4	6	0	0	6	0	0
15	14665761	.	T	C	2	3	5	0	1	6	0	0
15	14855219	.	C	A	5	4	9	0	0	10	1	0
15	14855291	.	A	G	4	9	13	0	0	13	0	0
15	14856739	.	A	G	4	0	4	0	9	13	0	0
15	14856803	.	A	T	9	8	17	0	0	17	0	0
15	15349693	.	C	T	30	31	61	0	3	64	0	0
15	15349780	.	C	T	32	29	61	0	3	64	0	0
15	15349860	.	T	A	27	28	55	0	5	60	0	0
15	15403584	.	T	C	3	2	5	0	0	5	0	0
15	15407505	.	T	G	1	2	3	0	1	4	0	0
15	15407536	.	T	A	1	2	3	0	0	3	0	0
15	15415903	.	C	G	3	2	5	0	0	5	0	0
15	15431591	.	G	C	13	4	17	0	0	17	0	0
15	15431600	.	C	T	14	3	17	0	1	18	0	0
15	15445690	.	G	C	6	0	6	0	4	10	0	0
15	15445763	.	T	C	6	2	8	0	0	8	0	0
15	15445767	.	T	C	3	0	3	0	4	7	0	0
15	15445860	.	T	C	1	0	1	0	3	4	0	0
15	15445876	.	T	C	0	5	5	0	1	6	0	0
15	15445899	.	T	C	4	7	11	0	0	11	0	0
15	15446104	.	T	C	15	10	25	0	1	26	0	0
15	15446484	.	C	T	1	15	16	0	8	24	0	0
15	15446590	.	G	A	8	9	17	0	1	18	0	0
15	15446609	.	C	A	6	8	14	0	0	14	0	0
15	15447005	.	T	A	7	4	11	0	0	11	0	0
15	15447037	.	C	T	1	6	7	0	6	13	0	0
15	15447109	.	G	A	7	9	16	0	0	16	0	0
15	15447118	.	T	C	8	0	8	0	9	17	0	0
15	15447236	.	A	G	3	2	5	0	1	6	0	0
15	15448975	.	A	G	4	5	9	0	0	9	0	0
15	15449191	.	G	A	2	3	5	0	1	6	0	0
15	15449395	.	G	C	7	4	11	0	0	11	0	0
15	15460593	.	A	G	1	3	4	0	0	4	0	0
15	15587093	.	C	T	13	8	21	0	0	21	0	0
15	15587117	.	C	T	15	7	22	0	0	22	0	0
15	15589504	.	C	T	13	21	34	0	1	35	0	0
15	15591868	.	T	A	11	8	19	0	0	19	0	0
15	15592318	.	G	A	19	16	35	0	1	37	1	0
15	15592332	.	C	G	14	1	15	0	20	35	0	0
15	15592504	.	C	T	14	16	30	0	1	31	0	0
15	15592537	.	A	T	19	13	32	0	2	34	0	0
15	15592629	.	T	C	15	12	27	0	0	27	0	0
15	15592641	.	C	G	17	0	17	0	10	27	0	0
15	15592784	.	C	A	15	13	28	0	0	28	0	0
15	15592879	.	C	T	8	16	24	0	3	27	0	0
15	15592991	.	G	A	20	16	36	0	0	36	0	0
15	15593128	.	G	A	16	6	22	0	3	25	0	0
15	15786270	.	C	T	5	3	8	0	0	8	0	0
15	15786463	.	A	C	4	6	10	0	0	10	0	0
15	15789683	.	G	A	4	2	6	0	0	6	0	0
15	15810922	.	G	C	0	9	9	0	13	22	0	0
15	15811281	.	G	T	11	5	16	0	0	16	0	0
15	15813810	.	C	T	8	8	16	0	0	16	0	0
15	15819345	.	C	T	3	9	12	0	0	12	0	0
15	15856342	.	T	A	10	12	22	0	0	22	0	0
15	15876974	.	T	C	10	11	21	0	3	24	0	0
15	15877019	.	T	C	13	12	25	0	0	25	0	0
15	15877600	.	G	A	14	6	20	0	1	21	0	0
15	15877616	.	G	C	10	10	20	0	0	20	0	0
15	15886202	.	C	A	6	10	16	0	0	16	0	0
15	15886346	.	A	G	6	8	14	0	0	14	0	0
15	15886461	.	A	T	2	11	13	0	0	13	0	0
15	15886564	.	A	G	5	7	12	0	0	12	0	0
15	15886697	.	T	C	3	4	7	0	1	8	0	0
15	15886701	.	C	T	1	4	5	0	4	9	0	0
15	15886803	.	C	T	3	8	11	0	15	26	0	0
15	15886806	.	T	C	11	14	25	0	1	26	0	0
15	15906718	.	G	A	8	15	23	0	1	24	0	0
15	15906766	.	C	T	8	15	23	0	2	25	0	0
15	15916216	.	G	A	14	11	25	0	1	26	0	0
15	15923499	.	G	A	10	14	24	0	0	24	0	0
15	15923577	.	G	A	5	5	10	0	0	10	0	0
15	15923616	.	G	A	6	6	12	0	0	12	0	0
15	15923628	.	C	G	2	7	9	0	6	15	0	0
15	15923697	.	T	G	8	5	13	0	0	13	0	0
15	15944045	.	C	T	1	4	5	0	6	11	0	0
15	15944102	.	G	A	6	7	13	0	0	13	0	0
15	15944129	.	G	A	8	7	15	0	0	15	0	0
15	15944287	.	G	A	7	2	9	0	0	9	0	0
15	15944435	.	G	A	7	6	13	0	1	14	0	0
15	15944465	.	A	G	5	7	12	0	0	12	0	0
15	15947041	.	G	T	6	7	13	0	0	13	0	0
15	15947042	.	C	G	6	7	13	0	0	13	0	0
15	15947466	.	G	A	5	3	8	0	0	8	0	0
15	15950223	.	A	C	5	4	9	0	0	9	0	0
15	15953681	.	C	A	4	3	7	0	0	7	0	0
15	16066453	.	A	G	23	22	45	0	0	45	0	0
15	16066459	.	C	T	24	20	44	0	3	47	0	0
15	16066508	.	C	T	4	22	26	0	29	55	0	0
15	16067051	.	G	A	30	26	56	0	3	59	0	0
15	16072281	.	A	C	20	20	40	0	2	42	0	0
15	16072690	.	T	C	24	20	44	0	1	45	0	0
15	16072822	.	T	A	18	16	34	0	3	37	0	0
15	16073046	.	C	A	8	12	20	0	3	23	0	0
15	16073055	.	A	C	7	11	18	0	3	21	0	0
15	16076221	.	A	C	13	16	29	0	0	29	0	0
15	16079709	.	T	G	19	20	39	0	0	39	0	0
15	16079733	.	G	T	23	23	46	0	0	46	0	0
15	16080258	.	G	A	32	28	60	0	4	64	0	0
15	16086528	.	G	A	29	26	55	0	1	56	0	0
15	16086600	.	G	T	30	30	60	0	4	64	0	0
15	16094383	.	G	A	25	18	43	0	1	44	0	0
15	16094672	.	C	T	2	21	23	0	19	42	0	0
15	16123356	.	C	T	11	4	15	0	0	15	0	0
15	16123358	.	A	G	4	10	14	0	1	15	0	0
15	16123735	.	G	C	7	10	17	0	0	17	0	0
15	16123921	.	T	C	6	5	11	0	0	11	0	0
15	16124008	.	T	A	8	7	15	0	2	17	0	0
15	16124125	.	G	A	5	4	9	0	0	9	0	0
15	16124210	.	C	T	1	13	14	0	2	16	0	0
15	16125799	.	T	C	2	10	12	0	0	12	0	0
15	16127139	.	C	T	6	14	20	0	0	20	0	0
15	16130244	.	G	A	7	3	10	0	0	10	0	0
15	16136073	.	A	G	8	4	12	0	0	12	0	0
15	16139042	.	T	C	5	3	8	0	0	8	0	0
15	16142225	.	C	T	2	3	5	0	0	5	0	0
15	16142340	.	T	C	6	0	6	0	4	10	0	0
15	16144013	.	G	A	4	4	8	0	0	8	0	0
15	16144086	.	G	A	3	2	5	0	0	5	0	0
15	16148355	.	A	G	2	3	5	0	0	5	0	0
15	16149660	.	C	T	1	4	5	0	0	5	0	0
15	16150254	.	C	T	4	3	7	0	0	7	0	0
15	16156514	.	C	A	1	2	3	0	0	3	0	0
15	16156533	.	C	A	0	2	2	0	1	3	0	0
15	16183479	.	C	T	13	11	24	0	0	24	0	0
15	16191781	.	A	G	3	0	3	0	3	6	0	0
15	16194155	.	A	T	13	7	20	0	0	20	0	0
15	16194208	.	G	A	7	7	14	0	0	14	0	0
15	16194222	.	G	T	7	5	12	0	0	12	0	0
15	16194254	.	G	C	9	5	14	0	1	15	0	0
15	16194369	.	G	A	13	12	25	0	2	27	0	0
15	16194741	.	T	A	14	18	32	0	0	32	0	0
15	16226577	.	A	G	9	4	13	0	0	13	0	0
15	16226598	.	G	A	6	5	11	0	1	12	0	0
15	16323480	.	A	G	5	5	10	0	0	10	0	0
15	16323568	.	T	A	8	4	12	0	0	12	0	0
15	16328623	.	C	T	12	13	25	0	2	27	0	0
15	16332592	.	C	T	11	14	25	0	2	27	0	0
15	16332643	.	T	A	9	9	18	0	0	18	0	0
15	16332844	.	C	A	10	11	21	0	0	21	0	0
15	16377555	.	C	T	7	7	14	0	1	15	0	0
15	16378545	.	C	T	5	2	7	0	1	8	0	0
15	16378885	.	C	T	0	2	2	0	1	3	0	0
15	16379399	.	T	A	2	6	8	0	0	8	0	0
15	16381808	.	G	C	1	3	4	0	0	4	0	0
15	16398241	.	T	G	9	11	20	0	1	21	0	0
15	16398265	.	T	C	4	10	14	0	0	14	0	0
15	16401668	.	A	G	8	11	19	0	0	19	0	0
15	16406279	.	T	C	11	11	22	0	1	23	0	0
15	16407354	.	A	G	12	12	24	0	0	24	0	0
15	16407575	.	G	T	13	7	20	0	0	20	0	0
15	16407723	.	G	A	18	11	29	0	0	29	0	0
15	16935759	.	G	T	10	11	21	0	0	21	0	0
15	16935806	.	C	T	8	5	13	0	1	14	0	0
15	16935867	.	C	T	10	9	19	0	1	20	0	0
15	16936271	.	C	T	1	2	3	0	1	4	0	0
15	16936495	.	A	T	5	11	16	0	0	16	0	0
15	16936716	.	C	T	6	7	13	0	0	13	0	0
15	16937179	.	T	C	9	10	19	0	0	19	0	0
15	16937203	.	T	C	8	14	22	0	0	22	0	0
15	16937328	.	T	C	1	9	10	0	0	10	0	0
15	16937375	.	T	C	4	9	13	0	1	14	0	0
15	16937653	.	T	C	2	5	7	0	0	7	0	0
15	16937662	.	T	C	1	0	1	0	7	8	0	0
15	16937688	.	T	C	7	3	10	0	0	10	0	0
15	16937702	.	T	C	7	0	7	0	2	9	0	0
15	16938166	.	A	G	2	4	6	0	1	7	0	0
15	16939218	.	G	C	5	0	5	0	3	8	0	0
15	16939266	.	C	T	3	3	6	0	2	8	0	0
15	16939271	.	C	A	3	5	8	0	0	8	0	0
15	16939588	.	G	A	6	2	8	0	1	9	0	0
15	16944167	.	T	C	10	7	17	0	1	18	0	0
15	16944173	.	T	C	10	6	16	0	2	18	0	0
15	16944350	.	T	C	7	7	14	0	0	14	0	0
15	16946113	.	T	C	6	8	14	0	0	14	0	0
15	16946533	.	A	G	5	2	7	0	2	9	0	0
15	16946592	.	A	G	9	4	13	0	0	13	0	0
15	16948565	.	T	C	1	0	1	0	6	7	0	0
15	16965453	.	G	A	6	6	12	0	0	12	0	0
15	17081226	.	T	C	4	4	8	0	0	8	0	0
15	17085012	.	T	A	14	10	24	0	0	24	0	0
15	17091003	.	C	T	7	6	13	0	0	13	0	0
15	17091030	.	G	A	7	7	14	0	1	15	0	0
15	17091418	.	G	A	1	11	12	0	15	27	0	0
15	17095457	.	C	T	23	11	34	0	2	36	0	0
15	17112155	.	C	T	1	2	3	0	0	3	0	0
15	17114640	.	A	T	7	7	14	0	1	15	0	0
15	17117724	.	T	C	8	3	11	0	0	11	0	0
15	17117949	.	A	G	3	2	5	0	1	6	0	0
15	17122535	.	A	C	3	5	8	0	2	10	0	0
15	17122563	.	T	C	3	5	8	0	0	8	0	0
15	17122673	.	C	T	4	4	8	0	0	8	0	0
15	17122935	.	A	G	10	0	10	0	12	22	0	0
15	17123012	.	T	C	9	5	14	0	0	14	0	0
15	17123040	.	G	T	7	4	11	0	0	11	0	0
15	17123063	.	A	G	4	4	8	0	0	8	0	0
15	17123191	.	A	G	5	7	12	0	0	12	0	0
15	17123193	.	A	G	4	7	11	0	1	12	0	0
15	17123290	.	A	G	13	4	17	0	0	17	0	0
15	17123937	.	T	A	18	7	25	0	0	25	0	0
15	17123968	.	C	A	17	9	26	0	0	26	0	0
15	17124011	.	A	G	14	9	23	0	2	25	0	0
15	17124012	.	C	G	15	9	24	0	0	24	0	0
15	17124084	.	A	G	10	5	15	0	0	15	0	0
15	17124124	.	C	A	7	10	17	0	0	17	0	0
15	17124246	.	A	G	7	7	14	0	0	14	0	0
15	17124253	.	G	T	9	3	12	0	0	12	0	0
15	17124283	.	A	G	14	4	18	0	0	18	0	0
15	17124437	.	A	C	3	3	6	0	0	6	0	0
15	17124439	.	T	G	3	3	6	0	0	6	0	0
15	17124484	.	T	A	2	3	5	0	1	6	0	0
15	17124580	.	A	G	13	3	16	0	0	16	0	0
15	17124586	.	C	T	15	5	20	0	0	20	0	0
15	17124654	.	T	G	8	5	13	1	0	14	0	0
15	17124768	.	G	C	6	13	19	0	0	19	0	0
15	17124884	.	T	C	5	3	8	0	0	8	0	0
15	17125033	.	A	G	5	3	8	0	0	8	0	0
15	17125102	.	A	T	6	2	8	0	2	10	0	0
15	17125108	.	C	T	6	3	9	0	1	10	0	0
15	17128418	.	T	C	4	1	5	0	13	18	0	0
15	17128468	.	G	A	4	18	22	0	1	23	0	0
15	17131785	.	C	T	17	19	36	0	0	36	0	0
15	17134701	.	C	T	0	8	8	0	19	27	0	0
15	17147012	.	A	G	8	13	21	0	0	21	0	0
15	17147400	.	G	A	8	10	18	0	0	18	0	0
15	17151085	.	T	A	4	4	8	0	1	9	0	0
15	17156953	.	G	A	3	4	7	0	0	7	0	0
15	17168668	.	G	A	2	3	5	0	0	5	0	0
15	17258305	.	G	A	2	2	4	0	0	4	0	0
15	17268091	.	G	A	3	2	5	0	0	5	0	0
15	17299682	.	T	C	10	16	26	0	0	26	0	0
15	17308206	.	C	A	7	6	13	0	0	13	0	0
15	17308378	.	T	C	10	5	15	0	2	17	0	0
15	17312080	.	T	C	12	13	25	0	0	25	0	0
15	17312299	.	G	A	13	17	30	0	3	33	0	0
15	17312386	.	G	A	3	12	15	0	13	28	0	0
15	17314889	.	C	T	9	7	16	0	1	17	0	0
15	17317008	.	T	A	9	13	22	0	2	24	0	0
15	17317044	.	C	T	8	13	21	0	2	23	0	0
15	17317089	.	T	A	5	19	24	0	2	26	0	0
15	17318566	.	T	C	21	19	40	0	2	42	0	0
15	17319345	.	C	T	25	19	44	0	1	45	0	0
15	17320851	.	T	C	20	22	42	1	1	44	0	0
15	17321164	.	A	G	18	20	38	0	2	40	0	0
15	17321302	.	A	T	22	18	40	0	1	41	0	0
15	17324793	.	C	T	27	22	49	0	3	52	0	0
15	17327501	.	C	T	27	28	55	0	4	59	0	0
15	17339078	.	C	T	36	27	63	0	1	64	0	0
15	17339719	.	T	C	23	26	49	0	0	50	1	0
15	17340104	.	A	C	13	7	20	0	1	21	0	0
15	17348035	.	T	C	3	4	7	0	0	7	0	0
15	17350319	.	G	A	4	3	7	0	0	7	0	0
15	17356708	.	A	G	3	0	3	0	2	5	0	0
15	17372580	.	C	A	10	8	18	0	0	18	0	0
15	17372934	.	C	T	12	9	21	0	1	22	0	0
15	17423913	.	A	C	9	11	20	0	1	21	0	0
15	17424011	.	T	C	12	9	21	0	3	24	0	0
15	17424185	.	T	G	5	12	17	0	0	17	0	0
15	17424397	.	G	A	10	4	14	0	0	14	0	0
15	17424472	.	A	T	8	8	16	0	0	16	0	0
15	17424493	.	T	C	6	8	14	0	0	14	0	0
15	17424515	.	A	T	4	8	12	0	1	13	0	0
15	17424581	.	A	T	6	3	9	0	0	9	0	0
15	17443677	.	T	C	3	2	5	0	0	5	0	0
15	17443968	.	G	A	3	2	5	0	0	5	0	0
15	17443969	.	T	G	3	2	5	0	0	5	0	0
15	17444203	.	T	C	6	6	12	0	0	12	0	0
15	17444227	.	A	G	5	7	12	0	2	14	0	0
15	17444262	.	G	C	8	6	14	0	1	15	0	0
15	17444284	.	A	C	9	5	14	0	1	16	1	0
15	17444385	.	A	C	2	5	7	0	0	7	0	0
15	17444428	.	C	T	4	5	9	0	0	9	0	0
15	17444533	.	A	C	6	8	14	0	0	14	0	0
15	17444569	.	C	T	7	5	12	0	0	12	0	0
15	17444632	.	T	C	5	2	7	0	0	7	0	0
15	17445606	.	G	A	8	9	17	0	1	18	0	0
15	17445618	.	T	A	8	11	19	0	0	19	0	0
15	17446854	.	C	T	4	7	11	0	2	13	0	0
15	17486317	.	A	C	9	11	20	0	0	20	0	0
15	17486388	.	G	T	5	12	17	0	1	18	0	0
15	17486576	.	C	A	7	11	18	0	1	19	0	0
15	17486715	.	C	T	9	5	14	0	0	14	0	0
15	17486725	.	G	T	8	5	13	0	0	13	0	0
15	17487277	.	A	G	6	5	11	0	0	11	0	0
15	17487293	.	A	G	5	5	10	0	0	10	0	0
15	17487386	.	C	T	10	3	13	0	1	14	0	0
15	17487544	.	A	G	12	5	17	0	1	18	0	0
15	17487717	.	T	A	14	9	23	0	1	24	0	0
15	17488513	.	C	T	7	13	20	0	0	20	0	0
15	17488672	.	A	G	15	10	25	0	0	25	0	0
15	17488698	.	A	T	14	11	25	0	2	27	0	0
15	17488834	.	A	C	20	7	27	0	0	27	0	0
15	17489033	.	C	T	12	4	16	0	2	18	0	0
15	17489049	.	A	T	12	3	15	0	0	15	0	0
15	17489165	.	G	A	3	8	11	0	11	22	0	0
15	17489191	.	A	G	9	0	9	0	4	13	0	0
15	17489203	.	G	A	1	5	6	0	6	12	0	0
15	17489360	.	A	C	7	23	30	0	0	31	1	0
15	17489440	.	G	C	16	15	31	0	1	32	0	0
15	17489505	.	G	A	13	7	20	0	0	20	0	0
15	17489573	.	G	T	6	3	9	0	0	9	0	0
15	17489575	.	C	G	5	3	8	0	1	9	0	0
15	17866976	.	T	C	14	16	30	0	1	31	0	0
15	17867929	.	A	G	12	12	24	0	4	28	0	0
15	17868250	.	G	A	11	9	20	0	1	21	0	0
15	17868448	.	T	C	7	10	17	0	2	19	0	0
15	17868601	.	T	G	15	12	27	0	0	27	0	0
15	17948534	.	C	T	3	5	8	0	0	8	0	0
15	17948616	.	C	G	6	6	12	0	0	12	0	0
15	17948786	.	C	G	7	7	14	0	0	14	0	0
15	17948852	.	G	C	4	4	8	0	0	8	0	0
15	17948898	.	T	C	3	2	5	0	0	5	0	0
15	17949100	.	C	T	1	4	5	0	0	5	0	0
15	17949142	.	C	G	1	7	8	0	0	8	0	0
15	17949163	.	C	T	4	9	13	0	0	13	0	0
15	17949252	.	A	G	3	3	6	0	1	7	0	0
15	17960032	.	C	T	2	2	4	0	0	4	0	0
15	17966672	.	C	T	1	2	3	0	0	3	0	0
15	18102357	.	T	C	5	4	9	0	1	10	0	0
15	18102777	.	C	G	13	6	19	0	1	20	0	0
15	18102898	.	T	C	8	9	17	0	1	18	0	0
15	18103009	.	T	A	9	7	16	0	0	16	0	0
15	18103248	.	T	C	10	9	19	0	1	20	0	0
15	18103363	.	G	A	20	8	28	0	0	28	0	0
15	18106754	.	A	G	8	8	16	0	0	16	0	0
15	18107049	.	A	G	3	6	9	0	0	9	0	0
15	18107081	.	G	A	3	4	7	0	1	8	0	0
15	18111448	.	C	T	0	6	6	0	8	14	0	0
15	18115551	.	T	C	6	4	10	0	2	12	0	0
15	18130119	.	G	A	9	8	17	0	1	18	0	0
15	18130190	.	A	G	13	11	24	0	1	25	0	0
15	18130202	.	A	G	10	0	10	0	14	24	0	0
15	18130305	.	T	C	11	10	21	0	4	25	0	0
15	18141117	.	G	A	13	15	28	0	1	29	0	0
15	18143688	.	G	A	12	14	26	0	2	28	0	0
15	18146717	.	G	A	14	12	26	0	1	27	0	0
15	18148889	.	G	A	19	22	41	1	2	44	0	0
15	18148892	.	A	G	21	23	44	1	0	45	0	0
15	18148928	.	A	G	20	0	20	0	21	41	0	0
15	18151095	.	G	A	29	17	46	0	2	48	0	0
15	18155273	.	C	T	11	19	30	0	2	32	0	0
15	18155297	.	T	C	11	14	25	0	1	26	0	0
15	18155322	.	G	T	11	14	25	0	1	26	0	0
15	18155342	.	T	A	10	13	23	0	1	24	0	0
15	18155392	.	G	A	15	10	25	0	1	26	0	0
15	18155394	.	C	T	17	10	27	0	0	27	0	0
15	18155588	.	C	T	17	8	25	0	0	25	0	0
15	18155638	.	G	A	22	19	41	0	0	41	0	0
15	18155730	.	A	G	29	21	50	0	1	51	0	0
15	18253900	.	G	A	10	5	15	0	0	15	0	0
15	18254148	.	G	A	14	5	19	0	0	19	0	0
15	18254777	.	C	G	1	11	12	0	8	20	0	0
15	18254821	.	T	A	11	8	19	0	2	21	0	0
15	18254985	.	C	T	14	9	23	0	1	24	0	0
15	18255292	.	A	G	9	15	24	0	1	25	0	0
15	18255802	.	C	T	5	6	11	0	0	11	0	0
15	18256138	.	A	G	10	3	13	0	0	13	0	0
15	18256261	.	T	A	5	2	7	0	0	7	0	0
15	18256541	.	T	A	7	5	12	0	0	12	0	0
15	18256847	.	C	T	0	2	2	0	5	7	0	0
15	18257692	.	A	T	4	4	8	0	1	9	0	0
15	18257743	.	T	C	3	4	7	0	0	7	0	0
15	18257754	.	A	G	4	4	8	0	0	8	0	0
15	18258045	.	C	T	1	2	3	0	1	4	0	0
15	18258227	.	A	G	3	3	6	0	0	6	0	0
15	18258279	.	G	A	5	2	7	1	0	8	0	0
15	18258352	.	A	G	1	2	3	0	0	3	0	0
15	18258947	.	A	C	3	0	3	0	2	5	0	0
15	18259036	.	T	G	3	5	8	0	0	8	0	0
15	18259143	.	G	A	3	3	6	0	0	6	0	0
15	18259269	.	A	T	3	2	5	0	0	5	0	0
15	18259585	.	G	T	1	2	3	0	0	3	0	0
15	18358435	.	G	A	6	2	8	0	1	9	0	0
15	18371336	.	A	T	9	5	14	0	2	16	0	0
15	18371418	.	T	A	7	7	14	0	0	14	0	0
15	18371509	.	C	T	12	8	20	0	0	20	0	0
15	18371522	.	A	G	12	6	18	0	0	18	0	0
15	18371789	.	T	C	12	0	12	0	8	20	0	0
15	18389548	.	T	C	2	3	5	0	0	5	0	0
15	18389662	.	C	A	0	2	2	0	2	4	0	0
15	18401240	.	G	T	5	7	12	0	0	12	0	0
15	18401270	.	A	G	6	9	15	0	0	16	1	0
15	18426315	.	G	A	4	7	11	0	0	11	0	0
15	18469599	.	A	G	6	9	15	0	1	16	0	0
15	18482944	.	G	A	2	3	5	0	0	5	0	0
15	18574608	.	C	T	1	3	4	0	0	4	0	0
15	19037405	.	G	A	1	1	2	0	1	3	0	0
15	19037534	.	A	G	13	10	23	0	2	25	0	0
15	19037618	.	A	G	21	8	29	0	0	29	0	0
15	19037626	.	G	C	19	8	27	0	1	28	0	0
15	19037895	.	T	C	3	9	12	0	0	12	0	0
15	19038143	.	G	T	4	15	19	0	0	19	0	0
15	19038218	.	G	A	11	11	22	0	0	22	0	0
15	19039025	.	A	G	5	7	12	0	0	12	0	0
15	19039667	.	T	C	9	0	9	0	5	14	0	0
15	19039830	.	C	A	0	3	3	0	6	9	0	0
15	19039874	.	A	G	6	8	14	0	0	14	0	0
15	19039985	.	C	A	6	4	10	0	0	10	0	0
15	19042070	.	C	T	5	2	7	0	1	8	0	0
15	19042213	.	A	C	7	4	11	0	0	11	0	0
15	19042347	.	C	T	1	4	5	0	5	10	0	0
15	19045649	.	A	G	4	4	8	0	0	8	0	0
15	19045871	.	C	T	5	2	7	0	0	7	0	0
15	19045886	.	T	C	4	2	6	0	1	7	0	0
15	19132077	.	A	G	12	20	32	0	8	40	0	0
15	19132178	.	G	A	15	15	30	0	1	31	0	0
15	19132203	.	A	T	15	16	31	0	3	34	0	0
15	19132659	.	G	T	8	6	14	0	2	16	0	0
15	19132667	.	T	C	10	0	10	0	8	18	0	0
15	19132724	.	G	A	3	5	8	0	1	9	0	0
15	19133310	.	C	T	17	12	29	0	2	31	0	0
15	19133374	.	G	T	16	13	29	0	1	30	0	0
15	19133437	.	A	T	17	13	30	0	1	31	0	0
15	19133647	.	C	T	15	26	41	1	0	42	0	0
15	19133750	.	A	G	17	14	31	0	0	31	0	0
15	19134109	.	T	C	10	0	10	0	18	28	0	0
15	19134710	.	G	A	4	3	7	0	0	7	0	0
15	19134905	.	C	A	8	6	14	0	0	14	0	0
15	19135009	.	T	C	1	5	6	0	2	8	0	0
15	19135304	.	T	C	9	9	18	0	0	18	0	0
15	19135351	.	G	A	8	8	16	0	0	16	0	0
15	19139757	.	C	T	0	3	3	0	11	14	0	0
15	19147330	.	G	A	5	3	8	0	0	8	0	0
15	19170879	.	C	T	3	5	8	0	1	9	0	0
15	19175049	.	T	C	4	0	4	0	5	9	0	0
15	19175055	.	T	C	5	0	5	0	6	11	0	0
15	19250469	.	G	C	2	3	5	0	1	6	0	0
15	19293919	.	G	T	11	6	17	0	0	17	0	0
15	19293920	.	G	T	11	6	17	0	0	17	0	0
15	19311505	.	G	T	2	4	6	0	8	14	0	0
15	19311631	.	C	T	9	11	20	0	1	21	0	0
15	19312545	.	G	A	9	13	22	0	0	22	0	0
15	19316573	.	T	C	8	2	10	0	0	10	0	0
15	19317065	.	G	A	0	2	2	0	5	7	0	0
15	19317301	.	A	C	2	2	4	0	0	4	0	0
15	19318408	.	T	C	5	4	9	0	0	9	0	0
15	19318445	.	T	G	4	0	4	0	5	9	0	0
15	19318513	.	T	A	6	2	8	0	0	8	0	0
15	19318795	.	G	A	1	3	4	0	1	5	0	0
15	19319128	.	A	C	6	6	12	0	0	12	0	0
15	19319227	.	C	G	5	9	14	0	0	14	0	0
15	19319250	.	T	C	6	9	15	0	1	16	0	0
15	19319272	.	G	C	7	8	15	0	0	15	0	0
15	19319376	.	C	T	7	7	14	0	0	14	0	0
15	19319613	.	A	G	7	5	12	0	1	13	0	0
15	19324762	.	T	A	4	6	10	0	0	11	1	0
15	19327602	.	C	G	6	5	11	0	1	12	0	0
15	19327665	.	G	A	0	8	8	0	3	11	0	0
15	19328334	.	G	A	12	5	17	0	0	17	0	0
15	19329908	.	G	A	10	6	16	0	0	16	0	0
15	19329962	.	T	C	8	11	19	0	0	19	0	0
15	19330408	.	C	T	10	7	17	0	0	17	0	0
15	19330607	.	T	A	5	4	9	0	1	10	0	0
15	19330745	.	T	A	5	2	7	0	0	7	0	0
15	19330748	.	C	A	5	2	7	0	0	7	0	0
15	19330897	.	A	C	2	5	7	0	0	7	0	0
15	19331762	.	A	C	1	1	2	0	2	4	0	0
15	19332719	.	C	T	2	4	6	0	1	7	0	0
15	19337247	.	A	C	4	2	6	0	1	7	0	0
15	19339789	.	T	A	6	8	14	0	0	14	0	0
15	19472290	.	G	A	2	4	6	0	1	7	0	0
15	19482724	.	C	T	4	5	9	0	0	9	0	0
15	19482748	.	C	T	5	5	10	0	0	10	0	0
15	19482877	.	A	C	3	5	8	0	1	9	0	0
15	19522052	.	C	T	2	2	4	0	0	4	0	0
15	19577072	.	C	T	6	4	10	0	0	10	0	0
15	19577242	.	G	A	6	5	11	0	0	11	0	0
15	19583841	.	C	T	12	8	20	0	0	20	0	0
15	19584132	.	G	T	10	11	21	0	0	21	0	0
15	19584187	.	T	C	9	12	21	0	0	21	0	0
15	19595508	.	C	T	19	12	31	0	4	35	0	0
15	19595509	.	T	G	12	2	14	0	19	33	0	0
15	19595782	.	G	A	12	19	31	0	2	33	0	0
15	19600214	.	C	T	6	15	21	0	0	21	0	0
15	19661664	.	T	A	15	5	20	0	0	20	0	0
15	19661756	.	T	A	22	7	29	0	0	29	0	0
15	19661820	.	G	T	19	12	31	0	1	32	0	0
15	19668105	.	C	T	1	15	16	0	13	29	0	0
15	19668276	.	C	T	1	4	5	0	5	10	0	0
15	19668375	.	G	A	10	4	14	0	0	14	0	0
15	19668638	.	T	G	7	4	11	0	1	12	0	0
15	19727982	.	A	G	4	3	7	1	0	8	0	0
15	19727992	.	G	C	3	2	5	1	0	6	0	0
15	19728127	.	A	T	4	10	14	0	0	14	0	0
15	19728307	.	C	T	22	16	38	0	2	40	0	0
15	19728853	.	T	A	2	16	18	0	1	19	0	0
15	19875030	.	G	A	0	3	3	0	3	6	0	0
15	19878064	.	T	G	0	2	2	0	1	3	0	0
15	19878869	.	G	A	3	3	6	0	0	6	0	0
15	19878877	.	C	A	2	3	5	0	1	6	0	0
15	19884717	.	T	C	3	3	6	0	0	6	0	0
15	19891082	.	A	T	5	4	9	0	0	9	0	0
15	19891939	.	T	C	9	4	13	0	3	16	0	0
15	19892083	.	G	A	0	8	8	0	6	14	0	0
15	19893876	.	G	T	0	6	6	0	6	12	0	0
15	19893952	.	T	G	4	2	6	0	0	6	0	0
15	19894898	.	T	G	3	0	3	0	8	11	0	0
15	19895304	.	T	A	7	10	17	0	1	18	0	0
15	19896052	.	A	C	9	11	20	0	2	22	0	0
15	19896072	.	C	A	10	7	17	0	0	18	1	0
15	19896589	.	C	T	11	3	14	0	0	14	0	0
15	19900319	.	A	T	3	2	5	0	0	5	0	0
15	19906969	.	A	C	1	4	5	0	0	5	0	0
15	19907233	.	T	C	2	2	4	0	0	4	0	0
15	19907914	.	C	T	2	2	4	0	0	4	0	0
15	19908328	.	T	A	3	3	6	0	0	6	0	0
15	19908777	.	A	T	5	4	9	0	0	9	0	0
15	19916014	.	C	A	7	10	17	0	0	17	0	0
15	19925978	.	G	A	6	4	10	0	1	11	0	0
15	19932674	.	G	A	1	13	14	0	21	35	0	0
15	19991372	.	G	C	1	1	2	0	2	4	0	0
15	20003130	.	G	A	5	3	8	0	1	9	0	0
15	20005301	.	A	G	9	3	12	0	0	12	0	0
15	20005665	.	C	A	4	4	8	0	0	8	0	0
15	20005863	.	T	A	6	10	16	0	2	18	0	0
15	20007033	.	T	A	6	4	10	0	0	10	0	0
15	20008357	.	C	T	6	5	11	0	0	11	0	0
15	20008513	.	C	T	3	2	5	0	1	6	0	0
15	20012049	.	G	T	4	3	7	0	0	7	0	0
15	20012199	.	G	T	3	7	10	0	0	10	0	0
15	20061367	.	G	A	8	8	16	0	3	19	0	0
15	20065029	.	T	C	6	7	13	0	0	13	0	0
15	20065074	.	G	A	6	6	12	0	0	12	0	0
15	20065125	.	A	G	7	11	18	0	2	20	0	0
15	20066656	.	A	T	12	2	14	0	2	16	0	0
15	20071596	.	G	A	3	4	7	0	0	7	0	0
15	20074138	.	G	A	14	7	21	0	1	22	0	0
15	20074261	.	T	A	11	12	23	0	1	24	0	0
15	20076928	.	C	T	2	3	5	0	0	5	0	0
15	20081275	.	T	A	5	4	9	0	0	9	0	0
15	20081731	.	G	A	5	6	11	0	1	12	0	0
15	20081903	.	G	A	5	6	11	0	0	11	0	0
15	20086508	.	C	A	1	3	4	0	0	4	0	0
15	20094707	.	G	T	6	2	8	0	0	8	0	0
15	20204794	.	A	G	1	4	5	0	0	5	0	0
15	20204850	.	T	G	3	5	8	0	0	8	0	0
15	20204873	.	C	T	4	2	6	0	0	6	0	0
15	20205014	.	G	A	1	2	3	0	0	3	0	0
15	20205220	.	C	T	1	3	4	0	0	4	0	0
15	20352400	.	G	A	1	2	3	0	0	3	0	0
15	20361874	.	G	A	3	3	6	0	0	6	0	0
15	20363005	.	C	G	2	2	4	0	0	4	0	0
15	20363063	.	T	G	1	4	5	0	0	5	0	0
15	20363339	.	C	T	1	3	4	0	0	4	0	0
15	20367662	.	C	T	8	9	17	0	1	18	0	0
15	20374712	.	G	A	0	4	4	0	2	6	0	0
15	20376393	.	A	G	11	9	20	0	1	21	0	0
15	20377873	.	A	T	8	11	19	0	0	19	0	0
15	20378479	.	T	C	8	4	12	0	0	12	0	0
15	20380144	.	C	A	5	9	14	0	0	14	0	0
15	20382472	.	C	T	9	8	17	0	1	18	0	0
15	20383967	.	G	T	12	11	23	0	2	25	0	0
15	20384310	.	A	G	24	17	41	0	4	45	0	0
15	20386212	.	A	G	20	25	45	0	0	45	0	0
15	20394788	.	G	A	1	16	17	2	7	26	0	0
15	20394877	.	G	A	12	16	28	1	5	34	0	0
15	20394915	.	G	A	3	15	18	0	20	39	1	0
15	20463909	.	A	G	1	3	4	0	0	4	0	0
15	20475865	.	G	A	6	5	11	0	0	11	0	0
15	20476016	.	C	G	4	13	17	0	0	17	0	0
15	20476058	.	A	G	7	15	22	0	0	22	0	0
15	20476075	.	A	G	10	12	22	0	0	22	0	0
15	20478820	.	G	A	13	14	27	0	0	27	0	0
15	20489854	.	C	T	8	6	14	0	0	14	0	0
15	20535445	.	T	C	2	3	5	0	1	6	0	0
15	20535475	.	C	T	3	3	6	0	1	7	0	0
15	20637832	.	C	T	2	6	8	0	0	8	0	0
15	20640100	.	T	A	4	2	6	0	0	6	0	0
15	20643476	.	G	A	2	5	7	0	4	11	0	0
15	20652744	.	A	G	5	4	9	0	1	10	0	0
15	20652746	.	G	A	5	4	9	0	0	9	0	0
15	20652787	.	G	A	12	8	20	1	0	21	0	0
15	20653005	.	T	A	17	20	37	0	2	39	0	0
15	20653048	.	A	T	11	10	21	1	1	23	0	0
15	20653074	.	T	A	14	3	17	1	0	18	0	0
15	20653258	.	T	A	24	22	46	1	2	49	0	0
15	20655888	.	A	C	25	22	47	1	2	50	0	0
15	20709058	.	G	A	15	10	25	0	0	25	0	0
15	20709184	.	T	A	8	10	18	0	0	18	0	0
15	20709292	.	A	C	12	19	31	0	0	31	0	0
15	20731260	.	G	C	19	12	31	0	0	31	0	0
15	20731345	.	A	C	1	0	1	0	4	5	0	0
15	20731512	.	A	T	3	2	5	0	1	6	0	0
15	20808163	.	G	A	3	2	5	0	0	5	0	0
15	20831091	.	T	C	3	5	8	0	0	8	0	0
15	20831105	.	C	T	3	5	8	0	0	8	0	0
15	20835105	.	T	C	1	2	3	0	0	3	0	0
15	20836008	.	A	G	6	3	9	0	0	9	0	0
15	20838334	.	C	T	0	2	2	0	3	5	0	0
15	20843441	.	C	T	3	2	5	0	0	5	0	0
15	20843859	.	G	C	0	5	5	0	2	7	0	0
15	20844074	.	A	C	2	3	5	0	1	6	0	0
15	20883238	.	C	A	13	14	27	0	1	28	0	0
15	20884503	.	T	G	10	0	10	0	5	15	0	0
15	20884551	.	T	C	6	10	16	0	1	17	0	0
15	20891154	.	T	A	8	8	16	0	2	18	0	0
15	20893300	.	C	A	11	9	20	0	0	20	0	0
15	20893320	.	C	A	20	1	21	0	1	22	0	0
15	20893481	.	A	G	8	12	20	0	1	21	0	0
15	20893592	.	C	T	14	9	23	0	0	23	0	0
15	20893644	.	A	G	14	15	29	0	0	29	0	0
15	20894094	.	A	G	8	0	8	0	25	33	0	0
15	20894129	.	C	G	15	16	31	0	2	33	0	0
15	20894464	.	T	C	19	18	37	0	2	39	0	0
15	20894604	.	C	T	16	10	26	0	2	28	0	0
15	20901009	.	C	T	18	16	34	0	0	34	0	0
15	20901053	.	T	C	22	18	40	0	1	41	0	0
15	20901133	.	A	G	16	10	26	0	3	29	0	0
15	20901261	.	G	T	16	20	36	0	2	38	0	0
15	20901358	.	A	G	22	15	37	0	2	39	0	0
15	20901366	.	T	A	15	22	37	0	1	38	0	0
15	20901540	.	C	T	3	11	14	0	7	21	0	0
15	20901562	.	G	A	12	9	21	0	3	24	0	0
15	20907603	.	A	G	12	11	23	0	1	24	0	0
15	20907648	.	A	G	6	8	14	0	3	17	0	0
15	20907651	.	C	T	11	3	14	0	1	15	0	0
15	20907958	.	C	T	17	9	26	0	1	27	0	0
15	20907970	.	C	T	1	9	10	0	16	26	0	0
15	20941485	.	A	T	6	4	10	0	0	10	0	0
15	20943064	.	T	C	4	6	10	0	0	10	0	0
15	20943072	.	G	A	4	6	10	0	0	10	0	0
15	20943248	.	G	T	7	8	15	0	0	15	0	0
15	20943651	.	T	C	6	3	9	0	0	9	0	0
15	20943760	.	T	A	7	11	18	0	0	18	0	0
15	20944004	.	T	A	4	3	7	0	0	7	0	0
15	20944005	.	G	T	4	3	7	0	0	7	0	0
15	20944217	.	C	A	1	4	5	0	1	6	0	0
15	20944856	.	G	A	11	9	20	0	0	20	0	0
15	20945060	.	C	T	7	7	14	0	0	14	0	0
15	20948139	.	G	C	2	3	5	0	1	6	0	0
15	20948694	.	C	A	0	3	3	0	7	10	0	0
15	20954495	.	A	C	1	5	6	0	0	6	0	0
15	20956305	.	A	C	3	0	3	0	8	11	0	0
15	20956348	.	A	C	1	3	4	0	0	4	0	0
15	21255145	.	T	C	3	13	16	0	2	18	0	0
15	21258288	.	C	T	12	10	22	0	0	22	0	0
15	21262094	.	A	G	3	3	6	0	0	6	0	0
15	21262268	.	C	T	6	3	9	0	0	9	0	0
15	21263036	.	G	A	4	3	7	0	2	9	0	0
15	21266018	.	A	G	3	6	9	0	0	9	0	0
15	21267514	.	A	G	1	0	1	0	6	7	0	0
15	21269869	.	A	T	4	4	8	0	0	8	0	0
15	21272916	.	A	T	5	7	12	0	0	12	0	0
15	21307477	.	C	T	2	6	8	0	1	9	0	0
15	21316996	.	A	T	4	6	10	0	0	10	0	0
15	21317192	.	G	A	7	4	11	0	1	12	0	0
15	21319739	.	T	A	4	8	12	0	0	12	0	0
15	21320097	.	T	C	9	9	18	0	0	18	0	0
15	21320329	.	A	G	12	9	21	0	2	23	0	0
15	21320475	.	A	T	5	7	12	0	0	12	0	0
15	21541201	.	C	T	6	10	16	0	1	17	0	0
15	21541620	.	C	T	9	3	12	2	3	17	0	0
15	21541670	.	G	A	9	1	10	0	3	13	0	0
15	21541695	.	T	G	3	5	8	1	0	10	1	0
15	21542210	.	G	C	3	0	3	0	5	8	0	0
15	21542542	.	T	C	9	15	24	0	1	25	0	0
15	21542559	.	C	A	10	14	24	2	2	28	0	0
15	21542884	.	C	A	1	17	18	1	8	27	0	0
15	21545866	.	C	T	2	13	15	0	1	16	0	0
15	21546399	.	A	G	8	10	18	0	1	19	0	0
15	21548403	.	C	T	4	13	17	0	0	17	0	0
15	21552410	.	T	A	4	5	9	0	0	9	0	0
15	21554103	.	T	C	2	2	4	0	0	4	0	0
15	21554115	.	G	A	1	4	5	0	1	6	0	0
15	21554239	.	A	G	1	6	7	0	1	8	0	0
15	21556036	.	C	T	0	3	3	0	2	5	0	0
15	21556274	.	G	A	8	8	16	0	2	18	0	0
15	21557122	.	A	T	7	8	15	0	0	15	0	0
15	21557403	.	G	C	3	9	12	0	0	12	0	0
15	21557418	.	C	T	0	6	6	0	5	11	0	0
15	21558334	.	A	C	6	5	11	0	0	11	0	0
15	21561817	.	A	G	5	5	10	0	0	10	0	0
15	21561823	.	G	A	5	5	10	0	0	10	0	0
15	21571206	.	G	A	3	4	7	0	1	8	0	0
15	21575741	.	G	A	1	2	3	0	0	3	0	0
15	21579997	.	C	T	1	1	2	0	1	3	0	0
15	21587176	.	A	G	2	4	6	0	0	6	0	0
15	21669462	.	G	C	4	2	6	0	0	6	0	0
15	21669470	.	T	A	3	2	5	0	0	5	0	0
15	21684510	.	C	T	4	3	7	0	0	7	0	0
15	21684546	.	T	A	6	4	10	0	1	11	0	0
15	21684558	.	C	G	7	5	12	0	0	12	0	0
15	21684701	.	T	C	3	3	6	0	0	6	0	0
15	21684704	.	T	G	3	2	5	0	0	5	0	0
15	21684933	.	A	G	9	11	20	0	1	21	0	0
15	21685195	.	T	A	17	13	30	0	1	31	0	0
15	21685217	.	C	T	2	14	16	0	20	36	0	0
15	21685357	.	G	A	19	13	32	0	2	34	0	0
15	21685418	.	C	T	15	13	28	0	1	29	0	0
15	21685484	.	A	G	22	10	32	0	3	35	0	0
15	21712570	.	G	A	2	2	4	0	0	4	0	0
15	21712577	.	A	G	2	0	2	0	2	4	0	0
15	21715339	.	C	T	3	6	9	0	0	9	0	0
15	21715381	.	G	A	2	7	9	0	0	9	0	0
15	21716360	.	A	G	1	2	3	0	0	3	0	0
15	21717158	.	A	T	1	2	3	0	0	3	0	0
15	21719412	.	G	A	1	1	2	0	1	3	0	0
15	21747981	.	T	C	11	12	23	0	0	24	1	0
15	21757433	.	C	T	12	17	29	0	1	30	0	0
15	21769619	.	T	C	13	21	34	0	0	34	0	0
15	21769640	.	G	A	14	21	35	0	1	36	0	0
15	21771835	.	A	T	26	23	49	0	0	49	0	0
15	21772073	.	T	C	25	25	50	0	4	54	0	0
15	21772112	.	T	C	35	22	57	0	1	58	0	0
15	21772174	.	T	C	39	24	63	0	0	63	0	0
15	21772208	.	T	C	29	21	50	0	1	51	0	0
15	21772689	.	C	A	21	24	45	0	3	48	0	0
15	21782020	.	G	A	30	16	46	0	0	46	0	0
15	21782028	.	G	A	30	16	46	0	1	47	0	0
15	21782057	.	T	C	28	13	41	0	1	42	0	0
15	21782154	.	C	A	0	17	17	0	6	23	0	0
15	21782171	.	G	A	7	17	24	0	1	25	0	0
15	21782238	.	A	G	8	8	16	0	0	16	0	0
15	21782385	.	G	T	4	5	9	0	0	9	0	0
15	21782946	.	C	G	16	14	30	0	1	31	0	0
15	21783681	.	G	A	8	10	18	0	0	18	0	0
15	21784042	.	G	T	15	14	29	0	3	32	0	0
15	21784226	.	T	C	18	1	19	0	19	38	0	0
15	21784352	.	T	C	15	12	27	0	0	27	0	0
15	21784525	.	C	G	2	12	14	0	9	23	0	0
15	21789819	.	G	T	11	4	15	0	0	15	0	0
15	21791872	.	G	T	12	13	25	0	2	27	0	0
15	21791878	.	C	T	2	15	17	0	8	25	0	0
15	21792220	.	C	T	3	11	14	0	6	20	0	0
15	21798394	.	T	C	10	6	16	0	1	17	0	0
15	21798447	.	T	C	3	3	6	0	1	7	0	0
15	21798540	.	G	T	4	5	9	0	0	9	0	0
15	21813430	.	G	T	6	3	9	0	0	9	0	0
15	21813451	.	G	A	10	3	13	0	0	13	0	0
15	21836607	.	A	G	8	7	15	0	0	15	0	0
15	21842433	.	T	C	1	2	3	0	0	3	0	0
15	22046900	.	A	G	5	4	9	0	0	9	0	0
15	22047389	.	T	C	5	4	9	0	1	10	0	0
15	22074011	.	T	C	5	2	7	0	0	7	0	0
15	22133987	.	A	C	9	0	9	0	7	16	0	0
15	22143027	.	G	A	12	6	18	0	0	18	0	0
15	22147174	.	C	G	10	10	20	0	1	21	0	0
15	22147186	.	G	T	9	9	18	0	0	18	0	0
15	22319856	.	T	C	1	2	3	0	0	6	3	0
15	22324529	.	A	T	4	6	10	0	1	11	0	0
15	22324538	.	T	A	4	8	12	0	0	12	0	0
15	22324760	.	A	G	9	14	23	0	1	24	0	0
15	22324948	.	T	C	8	7	15	0	0	15	0	0
15	22325007	.	C	T	6	2	8	0	1	9	0	0
15	22325118	.	C	A	2	2	4	0	0	4	0	0
15	22325278	.	A	G	5	0	5	0	7	12	0	0
15	22325617	.	G	T	10	9	19	1	0	20	0	0
15	22325687	.	A	C	5	5	10	0	0	10	0	0
15	22435473	.	G	A	4	3	7	0	0	7	0	0
15	22435565	.	T	G	3	0	3	0	6	9	0	0
15	22435632	.	C	G	4	5	9	0	0	9	0	0
15	22435655	.	C	T	2	2	4	0	1	5	0	0
15	22441639	.	C	T	3	4	7	0	0	7	0	0
15	22441744	.	A	G	5	3	8	0	0	8	0	0
15	22441852	.	A	G	4	0	4	0	3	7	0	0
15	22441855	.	C	T	4	4	8	0	0	8	0	0
15	22441900	.	T	C	7	4	11	0	0	11	0	0
15	22441972	.	G	A	5	9	14	0	1	15	0	0
15	22442713	.	A	T	3	7	10	0	1	11	0	0
15	22442875	.	G	A	1	7	8	0	8	16	0	0
15	22443048	.	T	G	4	2	6	0	1	7	0	0
15	22443136	.	C	T	4	5	9	0	0	9	0	0
15	22443282	.	C	T	12	2	14	0	0	14	0	0
15	22443289	.	A	T	12	1	13	0	1	14	0	0
15	22443460	.	G	A	1	8	9	0	14	23	0	0
15	22443462	.	A	G	14	0	14	0	9	23	0	0
15	22443520	.	A	G	14	10	24	0	0	24	0	0
15	22443615	.	G	A	8	12	20	0	1	21	0	0
15	22443630	.	G	T	1	14	15	0	14	29	0	0
15	22443798	.	A	G	17	23	40	0	1	41	0	0
15	22443858	.	A	G	11	20	31	0	2	33	0	0
15	22443934	.	G	A	3	17	20	0	16	36	0	0
15	22444062	.	A	G	13	20	33	0	1	34	0	0
15	22444239	.	G	A	3	14	17	0	14	31	0	0
15	22444266	.	A	G	21	10	31	0	2	33	0	0
15	22444310	.	T	A	19	12	31	0	1	32	0	0
15	22444331	.	G	A	7	15	22	0	0	22	0	0
15	22444483	.	T	G	8	0	8	0	8	17	1	0
15	22444486	.	A	T	9	8	17	0	1	18	0	0
15	22444524	.	T	C	7	6	13	0	0	13	0	0
15	22502831	.	C	A	1	2	3	0	0	3	0	0
15	22510996	.	G	A	2	4	6	0	0	6	0	0
15	22516625	.	G	A	2	4	6	0	0	6	0	0
15	22524099	.	C	A	7	3	10	0	0	10	0	0
15	22526258	.	C	T	8	3	11	0	0	11	0	0
15	22526463	.	G	C	1	4	5	0	3	8	0	0
15	22533518	.	G	A	3	4	7	0	1	8	0	0
15	22536756	.	C	T	3	3	6	0	0	6	0	0
15	22536795	.	G	C	0	5	5	0	5	10	0	0
15	22722694	.	C	T	1	4	5	0	0	5	0	0
15	22945140	.	G	A	3	5	8	0	0	8	0	0
15	22976939	.	T	C	2	2	4	0	0	4	0	0
15	22976943	.	T	C	2	1	3	0	0	3	0	0
15	23181511	.	C	A	4	5	9	0	0	9	0	0
15	23187879	.	T	A	3	10	13	0	1	14	0	0
15	23187902	.	T	G	9	0	9	0	9	18	0	0
15	23188188	.	T	G	7	8	15	0	0	15	0	0
15	23188190	.	C	T	6	8	14	0	0	14	0	0
15	23208223	.	G	C	1	2	3	0	0	3	0	0
15	23243797	.	T	C	1	2	3	0	0	3	0	0
15	23243860	.	G	A	0	3	3	0	1	4	0	0
15	23255643	.	T	C	4	2	6	0	0	6	0	0
15	23256320	.	C	T	4	10	14	0	2	16	0	0
15	23256449	.	T	C	8	5	13	0	1	14	0	0
15	23256674	.	C	T	4	4	8	0	0	8	0	0
15	23256779	.	G	A	2	4	6	0	6	12	0	0
15	23264471	.	G	A	0	11	11	2	3	16	0	0
15	23264547	.	G	A	1	6	7	0	7	14	0	0
15	23265217	.	C	T	3	3	6	0	0	6	0	0
15	23273262	.	G	A	4	2	6	0	0	6	0	0
15	23282959	.	T	C	1	2	3	0	0	3	0	0
15	23282961	.	G	C	1	2	3	0	0	3	0	0
15	23284990	.	A	G	1	2	3	0	0	3	0	0
15	23357870	.	G	T	0	3	3	0	1	4	0	0
15	23357915	.	G	A	2	5	7	0	0	7	0	0
15	23357957	.	G	C	5	5	10	0	0	10	0	0
15	23358185	.	A	T	4	3	7	0	1	8	0	0
15	23358186	.	A	T	5	2	7	0	1	8	0	0
15	23358455	.	G	C	2	3	5	0	0	5	0	0
15	23382243	.	C	T	0	4	4	0	3	7	0	0
15	23386976	.	C	T	2	4	6	0	6	12	0	0
15	23387010	.	A	G	9	5	14	0	0	14	0	0
15	23387334	.	G	A	5	9	14	0	0	14	0	0
15	23387567	.	G	A	5	7	12	0	2	14	0	0
15	23387577	.	G	A	6	5	11	0	0	11	0	0
15	23388471	.	G	T	5	6	11	0	4	15	0	0
15	23388609	.	C	T	4	3	7	0	1	8	0	0
15	23389139	.	C	G	3	3	6	0	0	6	0	0
15	23389689	.	A	G	5	4	9	0	0	9	0	0
15	23389809	.	G	A	4	2	6	0	0	6	0	0
15	23391110	.	C	T	2	3	5	0	0	5	0	0
15	23391196	.	G	A	3	2	5	0	0	5	0	0
15	23391411	.	A	G	1	5	6	0	0	6	0	0
15	23391741	.	A	G	4	8	12	0	0	12	0	0
15	23397588	.	A	G	3	4	7	0	2	9	0	0
15	23397614	.	C	T	0	2	2	0	4	6	0	0
15	23400770	.	G	A	4	2	6	0	0	6	0	0
15	23400954	.	G	A	2	2	4	0	0	4	0	0
15	23400961	.	A	G	2	2	4	0	0	4	0	0
15	23403071	.	G	A	3	4	7	0	0	7	0	0
15	23403097	.	A	G	4	5	9	0	1	10	0	0
15	23423674	.	C	T	4	5	9	0	0	9	0	0
15	23423724	.	G	A	4	4	8	0	1	9	0	0
15	23426717	.	T	A	11	12	23	0	0	23	0	0
15	23427075	.	G	A	5	2	7	0	3	10	0	0
15	23429593	.	G	A	8	3	11	0	0	12	1	0
15	23429915	.	G	A	9	9	18	0	0	18	0	0
15	23431734	.	C	T	0	2	2	0	11	13	0	0
15	23434037	.	G	A	3	3	6	0	0	6	0	0
15	23434242	.	C	T	6	2	8	0	1	9	0	0
15	23434251	.	G	A	3	9	12	0	0	12	0	0
15	23437095	.	C	T	5	8	13	0	0	13	0	0
15	23437162	.	T	A	2	6	8	0	1	9	0	0
15	23440676	.	T	C	3	2	5	0	0	5	0	0
15	23442571	.	T	C	2	0	2	0	2	4	0	0
15	23442577	.	G	A	2	2	4	0	0	4	0	0
15	23442929	.	C	A	3	3	6	0	0	6	0	0
15	23442930	.	T	A	3	3	6	0	0	6	0	0
15	23468383	.	G	T	3	2	5	0	0	5	0	0
15	23468501	.	G	T	4	2	6	0	0	6	0	0
15	23468522	.	A	T	5	2	7	0	0	7	0	0
15	23468965	.	A	T	3	4	7	0	0	7	0	0
15	23472735	.	C	T	2	4	6	0	0	6	0	0
15	23474815	.	C	G	2	5	7	0	2	9	0	0
15	23475487	.	A	G	3	3	6	0	0	6	0	0
15	23512017	.	C	A	2	3	5	0	0	5	0	0
15	23516184	.	G	A	1	4	5	0	0	5	0	0
15	23520048	.	C	T	1	3	4	0	0	4	0	0
15	23526525	.	A	T	1	2	3	0	0	3	0	0
15	23529203	.	A	G	1	2	3	0	0	3	0	0
15	23529212	.	T	C	1	2	3	0	0	3	0	0
15	23531933	.	G	A	4	4	8	0	0	8	0	0
15	23532146	.	A	T	4	6	10	0	0	10	0	0
15	23540536	.	T	C	2	2	4	0	0	4	0	0
15	23540705	.	G	A	3	3	6	0	0	6	0	0
15	23541943	.	T	G	1	2	3	0	0	3	0	0
15	23551218	.	G	A	0	3	3	0	5	8	0	0
15	23551272	.	C	T	3	3	6	0	0	6	0	0
15	23551704	.	G	A	0	7	7	0	2	9	0	0
15	23551769	.	T	G	4	0	4	0	4	8	0	0
15	23551775	.	C	T	4	4	8	0	0	8	0	0
15	23617364	.	G	A	1	9	10	0	7	17	0	0
15	23617612	.	G	T	4	8	12	0	3	15	0	0
15	23619093	.	G	A	1	15	16	0	9	25	0	0
15	23620453	.	T	G	13	6	19	0	0	19	0	0
15	23620511	.	G	A	13	10	23	0	1	24	0	0
15	23620541	.	C	T	17	13	30	0	0	30	0	0
15	23627514	.	G	A	14	11	25	0	5	30	0	0
15	23640374	.	T	A	14	11	25	0	6	31	0	0
15	23640678	.	A	C	6	1	7	0	32	39	0	0
15	23640807	.	C	T	17	15	32	0	0	32	0	0
15	23641057	.	C	T	12	9	21	0	1	22	0	0
15	23641102	.	T	G	11	13	24	0	0	24	0	0
15	23641107	.	G	C	15	10	25	0	0	25	0	0
15	23641426	.	G	A	9	14	23	0	1	24	0	0
15	23675921	.	A	G	1	0	1	0	3	4	0	0
15	23684232	.	C	T	7	2	9	0	0	9	0	0
15	23686877	.	G	A	2	2	4	0	0	4	0	0
15	23689030	.	C	T	2	2	4	0	0	4	0	0
15	23689643	.	G	A	2	3	5	0	0	5	0	0
15	23709660	.	G	A	4	2	6	0	1	7	0	0
15	23709925	.	T	C	4	2	6	0	1	7	0	0
15	23709937	.	G	A	3	1	4	0	1	5	0	0
15	23710339	.	T	C	8	11	19	0	0	19	0	0
15	23710465	.	C	T	9	10	19	0	0	19	0	0
15	23710490	.	G	T	4	9	13	0	0	13	0	0
15	23710515	.	G	A	2	7	9	0	0	9	0	0
15	23710539	.	T	C	3	7	10	0	0	10	0	0
15	23710811	.	A	G	5	4	9	0	0	9	0	0
15	23711890	.	C	T	0	2	2	0	8	10	0	0
15	23711953	.	G	A	6	4	10	0	0	10	0	0
15	23712082	.	A	G	14	11	25	0	1	26	0	0
15	23713116	.	C	T	0	3	3	0	3	6	0	0
15	23713158	.	A	G	3	7	10	0	0	10	0	0
15	23713174	.	G	C	5	6	11	0	0	11	0	0
15	23713679	.	T	G	3	3	6	0	3	9	0	0
15	23713923	.	C	T	3	4	7	0	0	7	0	0
15	23718008	.	G	A	4	4	8	0	0	8	0	0
15	23718403	.	C	T	5	2	7	0	0	7	0	0
15	23723607	.	T	A	4	2	6	0	0	6	0	0
15	23724153	.	G	A	4	1	5	0	2	7	0	0
15	23730816	.	C	A	2	5	7	0	0	7	0	0
15	23738914	.	C	T	12	8	20	0	0	20	0	0
15	23738915	.	G	C	1	8	9	0	12	21	0	0
15	23745952	.	C	T	1	2	3	0	0	3	0	0
15	23780791	.	A	T	1	5	6	0	0	6	0	0
15	23780834	.	G	T	1	3	4	0	0	4	0	0
15	23781122	.	T	A	2	4	6	0	0	6	0	0
15	23783669	.	C	T	2	2	4	0	0	4	0	0
15	23784896	.	C	T	4	6	10	0	2	12	0	0
15	23788266	.	G	A	8	6	14	0	0	14	0	0
15	23789947	.	T	G	1	2	3	0	0	3	0	0
15	23793070	.	C	T	7	9	16	0	0	16	0	0
15	23793206	.	C	T	4	11	15	0	0	15	0	0
15	23817403	.	T	A	14	7	21	0	0	21	0	0
15	23817517	.	G	A	12	9	21	0	0	21	0	0
15	23817901	.	C	T	1	10	11	0	10	21	0	0
15	23818313	.	T	A	11	5	16	0	0	16	0	0
15	23818422	.	T	C	11	6	17	0	1	18	0	0
15	23818542	.	T	A	4	6	10	0	0	10	0	0
15	23818575	.	T	C	3	6	9	0	0	9	0	0
15	23818765	.	G	A	4	6	10	0	0	10	0	0
15	23819248	.	T	A	7	6	13	0	0	13	0	0
15	23819253	.	C	T	7	5	12	0	2	14	0	0
15	23819423	.	G	A	12	11	23	0	2	25	0	0
15	23823508	.	C	T	4	5	9	0	1	10	0	0
15	23823638	.	G	C	7	5	12	0	0	12	0	0
15	23829245	.	C	T	3	3	6	0	0	6	0	0
15	23841498	.	G	A	2	5	7	0	0	7	0	0
15	23841516	.	C	T	0	3	3	0	3	6	0	0
15	23860840	.	G	A	1	1	2	0	0	2	0	0
15	23860849	.	G	A	1	2	3	0	0	3	0	0
15	23911793	.	C	G	2	3	5	0	0	5	0	0
15	23917998	.	G	C	2	3	5	0	0	5	0	0
15	23918333	.	G	C	2	3	5	0	0	5	0	0
15	23918365	.	C	T	5	2	7	0	0	7	0	0
15	23922714	.	G	A	18	15	33	0	1	34	0	0
15	23922994	.	G	T	12	5	17	0	0	19	2	0
15	23923261	.	T	G	12	12	24	0	1	25	0	0
15	23925372	.	G	C	18	6	24	0	0	24	0	0
15	23927992	.	G	T	11	16	27	0	3	30	0	0
15	23931187	.	A	G	10	11	21	0	1	22	0	0
15	23931454	.	A	G	11	9	20	0	1	21	0	0
15	23942804	.	T	G	8	11	19	0	0	19	0	0
15	24036108	.	T	C	1	3	4	0	0	4	0	0
15	24084737	.	T	A	8	6	14	0	2	16	0	0
15	24084773	.	C	T	5	9	14	0	0	14	0	0
15	24094697	.	T	C	8	7	15	0	1	16	0	0
15	24096474	.	G	A	9	7	16	0	1	17	0	0
15	24096657	.	C	A	15	8	23	0	0	23	0	0
15	24104648	.	C	T	10	16	26	0	0	26	0	0
15	24106821	.	C	T	9	12	21	0	0	21	0	0
15	24119372	.	A	G	8	10	18	0	0	18	0	0
15	24119391	.	C	T	7	9	16	0	0	16	0	0
15	24119571	.	T	C	14	12	26	0	0	26	0	0
15	24120490	.	G	A	0	10	10	3	5	18	0	0
15	24120588	.	C	T	18	7	25	0	0	25	0	0
15	24388860	.	C	T	2	4	6	0	0	6	0	0
15	24389369	.	A	C	4	3	7	0	0	7	0	0
15	24389483	.	G	A	0	7	7	0	3	10	0	0
15	24391755	.	G	A	0	3	3	0	8	11	0	0
15	24439290	.	G	A	3	2	5	0	1	6	0	0
15	24439382	.	T	C	3	5	8	0	0	8	0	0
15	24489776	.	G	A	4	4	8	0	0	8	0	0
15	24500648	.	G	A	6	4	10	0	0	10	0	0
15	24525815	.	A	G	3	0	3	0	6	9	0	0
15	24525890	.	T	C	5	4	9	0	1	10	0	0
15	24530477	.	G	A	0	5	5	0	13	18	0	0
15	24535495	.	C	T	11	8	19	0	2	21	0	0
15	24543991	.	C	T	14	11	25	0	0	25	0	0
15	24544305	.	T	A	5	6	11	0	0	11	0	0
15	24544325	.	G	A	7	6	13	0	0	13	0	0
15	24544653	.	A	T	6	13	19	0	0	19	0	0
15	24544657	.	A	G	7	0	7	0	13	20	0	0
15	24549609	.	T	C	3	5	8	0	0	8	0	0
15	24554786	.	C	A	2	4	6	0	0	6	0	0
15	24557540	.	G	A	6	7	13	0	1	14	0	0
15	24557810	.	A	C	8	4	12	0	0	12	0	0
15	24561055	.	T	C	12	9	21	0	0	21	0	0
15	24561414	.	G	A	10	12	22	0	1	23	0	0
15	24561501	.	C	T	9	3	12	0	2	14	0	0
15	24562188	.	A	G	4	4	8	0	0	8	0	0
15	24568588	.	T	C	3	2	5	0	0	5	0	0
15	24583854	.	G	T	1	2	3	0	0	3	0	0
15	24583933	.	C	G	2	3	5	0	0	5	0	0
15	24584335	.	T	C	2	2	4	0	0	4	0	0
15	24661329	.	C	T	1	2	3	0	0	3	0	0
15	24670940	.	C	T	1	3	4	0	0	4	0	0
15	24673524	.	A	C	1	2	3	0	0	3	0	0
15	24673723	.	T	A	5	9	14	0	0	14	0	0
15	24673997	.	A	G	8	10	18	0	0	18	0	0
15	24679744	.	T	C	7	6	13	0	1	14	0	0
15	24679944	.	T	C	8	7	15	0	0	15	0	0
15	24683236	.	A	G	7	8	15	0	1	16	0	0
15	24686282	.	C	T	14	11	25	0	2	27	0	0
15	24686450	.	G	A	2	10	12	0	5	17	0	0
15	24686636	.	T	C	1	2	3	0	0	3	0	0
15	24689592	.	G	A	1	11	12	0	15	27	0	0
15	24689701	.	G	A	2	12	14	0	13	27	0	0
15	24689948	.	T	C	5	11	16	0	0	16	0	0
15	24691290	.	A	G	2	1	3	0	4	7	0	0
15	24691534	.	A	G	3	0	3	0	2	5	0	0
15	24691551	.	A	G	1	0	1	0	2	3	0	0
15	24692351	.	A	T	3	3	6	0	0	6	0	0
15	24692359	.	G	A	2	5	7	0	1	8	0	0
15	24692716	.	T	A	6	2	8	0	2	10	0	0
15	24733569	.	G	A	7	9	16	0	1	17	0	0
15	24733689	.	G	A	12	14	26	0	0	26	0	0
15	24733791	.	T	G	10	10	20	0	1	21	0	0
15	24733896	.	G	A	7	7	14	0	0	14	0	0
15	24733932	.	T	C	9	6	15	0	0	15	0	0
15	24735111	.	G	T	6	6	12	0	0	12	0	0
15	24735163	.	C	G	9	6	15	0	1	16	0	0
15	24735219	.	C	T	13	5	18	0	0	18	0	0
15	24735341	.	C	T	5	11	16	0	1	17	0	0
15	24735472	.	T	C	1	4	5	0	0	5	0	0
15	24735677	.	G	T	12	11	23	0	2	25	0	0
15	24736187	.	G	A	4	3	7	0	1	8	0	0
15	24736244	.	A	T	2	3	5	0	1	6	0	0
15	24736525	.	A	G	11	3	14	0	0	14	0	0
15	24737745	.	A	G	8	12	20	0	3	23	0	0
15	24742930	.	G	A	3	15	18	0	20	38	0	0
15	24743843	.	G	A	9	4	13	0	0	13	0	0
15	24744691	.	G	C	15	9	24	0	2	26	0	0
15	24744724	.	A	T	12	10	22	0	2	24	0	0
15	24749895	.	G	A	3	29	32	0	29	61	0	0
15	24751322	.	C	T	36	31	67	0	5	72	0	0
15	24754361	.	A	T	11	8	19	0	0	19	0	0
15	24754524	.	G	A	15	11	26	0	1	27	0	0
15	24772558	.	A	G	1	1	2	0	2	4	0	0
15	24791806	.	G	C	3	5	8	0	1	9	0	0
15	24791911	.	G	C	2	2	4	0	0	4	0	0
15	24792183	.	G	A	4	6	10	0	0	10	0	0
15	24792418	.	C	T	3	2	5	0	0	5	0	0
15	24793007	.	G	A	1	4	5	0	0	5	0	0
15	24793432	.	A	G	2	4	6	0	0	6	0	0
15	24794104	.	C	T	7	5	12	0	0	12	0	0
15	24794441	.	T	A	3	5	8	1	0	9	0	0
15	24798529	.	G	A	10	8	18	0	2	20	0	0
15	24806288	.	G	A	10	6	16	0	0	16	0	0
15	24837105	.	G	A	0	8	8	0	8	16	0	0
15	24837402	.	C	T	4	9	13	0	1	14	0	0
15	24837474	.	A	G	7	8	15	0	0	15	0	0
15	24845205	.	G	A	21	14	35	0	2	37	0	0
15	24845460	.	C	T	0	7	7	0	6	13	0	0
15	24845500	.	G	T	10	10	20	0	1	21	0	0
15	24846070	.	G	A	8	7	15	0	2	17	0	0
15	24846186	.	T	C	5	5	10	0	0	10	0	0
15	24846311	.	T	A	8	4	12	0	0	12	0	0
15	24846594	.	T	C	7	0	7	0	10	17	0	0
15	24869405	.	T	C	3	0	3	1	6	10	0	0
15	24869684	.	G	A	3	3	6	0	0	6	0	0
15	24946807	.	C	T	0	8	8	0	2	10	0	0
15	24946864	.	A	G	5	5	10	0	0	10	0	0
15	24946887	.	C	T	6	6	12	0	0	12	0	0
15	24947006	.	A	C	3	2	5	0	0	5	0	0
15	24948537	.	C	G	7	4	11	0	0	11	0	0
15	24949088	.	G	A	2	2	4	0	0	4	0	0
15	24959965	.	G	T	1	2	3	0	0	3	0	0
15	25091506	.	C	T	0	3	3	0	1	4	0	0
15	25096386	.	G	T	1	4	5	0	2	7	0	0
15	25096677	.	T	C	3	9	12	0	0	12	0	0
15	25097001	.	A	G	2	2	4	0	0	4	0	0
15	25097022	.	C	T	3	2	5	0	0	5	0	0
15	25097043	.	A	T	2	3	5	0	0	5	0	0
15	25097179	.	T	A	1	2	3	0	1	4	0	0
15	25097290	.	C	T	3	2	5	0	0	5	0	0
15	25099206	.	C	T	2	2	4	0	0	4	0	0
15	25101042	.	C	T	8	7	15	0	3	18	0	0
15	25101083	.	A	G	2	8	10	0	2	12	0	0
15	25101085	.	T	G	3	8	11	0	1	12	0	0
15	25101260	.	T	C	9	6	15	0	0	15	0	0
15	25101267	.	A	G	9	6	15	0	0	15	0	0
15	25101302	.	G	A	9	8	17	0	2	19	0	0
15	25101538	.	G	A	3	17	20	0	0	20	0	0
15	25101619	.	A	G	9	10	19	0	0	19	0	0
15	25101740	.	C	A	8	18	26	0	0	26	0	0
15	25101990	.	A	G	14	15	29	0	1	30	0	0
15	25121504	.	T	G	6	4	10	0	0	10	0	0
15	25121522	.	A	G	6	4	10	0	1	11	0	0
15	25127854	.	A	G	4	8	12	0	0	12	0	0
15	25152294	.	A	C	3	0	3	0	3	6	0	0
15	25153250	.	C	A	3	3	6	0	2	8	0	0
15	25153294	.	G	A	2	4	6	0	0	6	0	0
15	25173015	.	C	T	1	4	5	0	1	6	0	0
15	25173494	.	A	C	9	9	18	0	1	19	0	0
15	25173759	.	T	C	7	8	15	0	2	17	0	0
15	25173877	.	C	T	3	2	5	1	0	6	0	0
15	25173898	.	G	A	4	3	7	1	0	8	0	0
15	25173920	.	G	A	5	5	10	0	0	10	0	0
15	25175811	.	A	C	1	3	4	0	0	4	0	0
15	25176075	.	C	T	5	5	10	0	0	10	0	0
15	25176191	.	G	C	7	1	8	0	13	21	0	0
15	25176527	.	C	T	0	4	4	0	15	19	0	0
15	25214384	.	A	G	5	8	13	0	1	14	0	0
15	25229156	.	A	G	2	3	5	0	0	5	0	0
15	25238885	.	G	A	1	2	3	0	0	3	0	0
15	25238903	.	G	A	1	2	3	0	0	3	0	0
15	25267804	.	G	A	2	3	5	0	0	5	0	0
15	25273187	.	C	T	16	22	38	0	0	38	0	0
15	25274918	.	T	G	19	21	40	0	0	40	0	0
15	25278986	.	A	G	14	14	28	0	2	30	0	0
15	25281387	.	G	A	10	7	17	0	3	20	0	0
15	25283846	.	A	C	9	1	10	0	12	23	1	0
15	25283963	.	A	G	9	5	14	0	2	16	0	0
15	25304678	.	C	A	13	9	22	0	0	22	0	0
15	25321973	.	G	A	10	7	17	0	0	17	0	0
15	25321982	.	A	C	9	9	18	0	1	19	0	0
15	25322410	.	C	A	0	6	6	0	7	13	0	0
15	25322607	.	T	G	11	12	23	0	2	25	0	0
15	25322783	.	G	A	10	14	24	0	1	25	0	0
15	25322853	.	C	T	13	9	22	0	1	23	0	0
15	25323064	.	G	C	11	12	23	0	0	23	0	0
15	25333922	.	C	T	1	5	6	0	9	15	0	0
15	25349844	.	C	T	4	6	10	0	1	11	0	0
15	25351846	.	C	T	2	3	5	0	0	5	0	0
15	25351870	.	C	A	1	3	4	0	0	4	0	0
15	25352011	.	C	T	1	5	6	0	0	6	0	0
15	25352062	.	C	A	3	3	6	0	0	6	0	0
15	25353973	.	T	G	2	3	5	0	0	5	0	0
15	25357191	.	A	G	2	2	4	0	0	4	0	0
15	25357510	.	G	A	1	2	3	0	0	3	0	0
15	25367067	.	C	T	1	2	3	0	0	3	0	0
15	25375950	.	C	A	5	2	7	0	0	7	0	0
15	25376190	.	T	C	1	3	4	0	1	5	0	0
15	25376212	.	T	G	4	4	8	0	0	8	0	0
15	25376332	.	A	T	2	6	8	0	0	8	0	0
15	25376506	.	G	A	2	2	4	0	0	4	0	0
15	25376842	.	A	G	2	2	4	0	0	4	0	0
15	25377137	.	C	T	0	3	3	0	6	9	0	0
15	25377155	.	C	T	0	4	4	0	5	9	0	0
15	25377218	.	C	A	3	4	7	0	0	7	0	0
15	25398276	.	T	G	2	2	4	0	1	5	0	0
15	25398406	.	A	C	5	2	7	0	1	8	0	0
15	25399414	.	A	G	1	2	3	0	0	3	0	0
15	25400018	.	A	G	4	3	7	0	0	7	0	0
15	25400120	.	T	C	3	5	8	0	0	8	0	0
15	25452128	.	A	T	1	3	4	0	0	4	0	0
15	25452131	.	C	T	1	3	4	0	0	4	0	0
15	25485155	.	A	G	1	0	1	0	4	5	0	0
15	25485594	.	T	A	1	2	3	0	0	3	0	0
15	25498515	.	G	T	1	12	13	0	5	18	0	0
15	25498645	.	G	C	0	4	4	0	8	13	1	0
15	25498718	.	C	A	9	5	14	0	0	14	0	0
15	25498946	.	C	T	6	6	12	0	1	13	0	0
15	25499171	.	A	G	2	2	4	0	0	4	0	0
15	25504064	.	A	G	4	3	7	0	1	8	0	0
15	25504397	.	A	C	8	0	8	1	4	13	0	0
15	25504399	.	T	A	9	4	13	1	0	14	0	0
15	25504902	.	C	G	0	4	4	0	2	6	0	0
15	25507942	.	A	T	4	15	19	0	2	21	0	0
15	25508539	.	T	G	8	11	19	0	2	21	0	0
15	25508852	.	T	G	6	7	13	0	1	14	0	0
15	25509414	.	C	A	0	6	6	0	6	12	0	0
15	25509498	.	G	A	6	7	13	0	1	14	0	0
15	25509500	.	C	T	1	7	8	0	6	14	0	0
15	25510372	.	G	T	10	7	17	0	0	17	0	0
15	25512525	.	T	C	7	0	7	0	8	15	0	0
15	25515702	.	G	A	8	8	16	0	0	16	0	0
15	25517116	.	C	T	3	6	9	0	0	9	0	0
15	25532219	.	C	T	2	5	7	0	0	7	0	0
15	25534200	.	T	C	4	2	6	0	0	6	0	0
15	25537641	.	C	A	8	4	12	0	0	12	0	0
15	25537860	.	C	A	4	4	8	0	0	8	0	0
15	25538178	.	A	G	10	7	17	0	0	17	0	0
15	25538381	.	T	C	9	3	12	0	0	12	0	0
15	25538793	.	G	A	2	8	10	0	7	17	0	0
15	25588805	.	A	G	18	14	32	0	1	33	0	0
15	25588836	.	A	C	19	24	43	0	0	43	0	0
15	25588840	.	T	C	20	1	21	0	24	45	0	0
15	25589119	.	G	T	8	11	19	0	0	19	0	0
15	25589197	.	T	A	19	15	34	0	4	38	0	0
15	25589280	.	G	T	17	15	32	0	1	33	0	0
15	25589321	.	A	G	16	9	25	0	0	25	0	0
15	25589438	.	C	G	10	18	28	0	1	29	0	0
15	25589582	.	G	C	8	16	24	0	0	24	0	0
15	25589624	.	C	T	11	15	26	0	0	26	0	0
15	25589640	.	T	C	9	16	25	0	1	26	0	0
15	25589708	.	A	G	13	12	25	0	1	26	0	0
15	25589812	.	A	T	11	11	22	0	0	22	0	0
15	25589838	.	A	G	15	11	26	0	1	27	0	0
15	25589979	.	T	A	11	15	26	0	0	26	0	0
15	25589983	.	C	T	9	12	21	0	2	23	0	0
15	25590022	.	A	G	8	11	19	0	0	19	0	0
15	25590129	.	A	G	9	17	26	0	1	27	0	0
15	25590155	.	T	C	11	16	27	0	1	28	0	0
15	25590235	.	A	G	6	3	9	0	4	13	0	0
15	25590240	.	A	G	7	5	12	0	0	12	0	0
15	25590297	.	A	G	7	11	18	0	0	18	0	0
15	25590394	.	T	A	11	11	22	0	1	23	0	0
15	25590474	.	G	A	4	10	14	1	0	15	0	0
15	25590585	.	G	T	9	10	19	0	1	20	0	0
15	25590820	.	A	G	4	8	12	0	0	12	0	0
15	25591541	.	A	T	14	10	24	0	0	24	0	0
15	25591553	.	A	C	10	12	22	0	5	27	0	0
15	25591807	.	C	G	13	9	22	0	0	22	0	0
15	25591820	.	A	T	12	5	17	0	1	18	0	0
15	25591846	.	A	G	8	3	11	0	0	11	0	0
15	25592064	.	C	T	1	2	3	0	1	4	0	0
15	25592080	.	C	T	0	4	4	0	3	7	0	0
15	25592126	.	C	G	3	4	7	0	0	7	0	0
15	25592223	.	A	G	3	5	8	0	0	8	0	0
15	25592606	.	T	A	3	4	7	0	0	7	0	0
15	25592710	.	T	C	3	7	10	0	2	12	0	0
15	25592713	.	T	C	8	7	15	0	0	15	0	0
15	25592853	.	C	T	0	4	4	0	1	5	0	0
15	25593187	.	T	G	6	5	11	0	0	11	0	0
15	25594091	.	A	G	3	7	10	0	0	10	0	0
15	25594345	.	C	T	0	3	3	0	7	10	0	0
15	25594511	.	G	C	1	0	1	0	5	6	0	0
15	25594810	.	A	C	4	2	6	0	0	6	0	0
15	25595187	.	T	C	2	6	8	0	0	8	0	0
15	25598873	.	T	A	8	6	14	0	0	14	0	0
15	25598963	.	G	A	6	7	13	0	0	13	0	0
15	25599071	.	C	T	6	10	16	0	2	18	0	0
15	25602628	.	G	A	4	8	12	0	0	12	0	0
15	25602843	.	T	C	5	4	9	0	1	10	0	0
15	25602846	.	G	A	5	4	9	0	1	10	0	0
15	25602915	.	A	G	2	6	8	0	0	8	0	0
15	25603017	.	G	A	5	3	8	0	0	8	0	0
15	25605041	.	A	G	3	6	9	0	0	9	0	0
15	25635424	.	C	T	4	4	8	0	0	8	0	0
15	25638600	.	G	A	1	4	5	0	0	5	0	0
15	25640533	.	T	C	1	4	5	0	1	6	0	0
15	25640540	.	A	G	1	1	2	0	4	6	0	0
15	25640891	.	C	T	2	6	8	0	0	8	0	0
15	25640892	.	T	G	2	6	8	0	0	8	0	0
15	25641002	.	C	G	4	3	7	0	0	7	0	0
15	25649944	.	G	A	4	3	7	0	2	9	0	0
15	25650100	.	T	G	3	3	6	0	0	6	0	0
15	25653349	.	A	G	5	3	8	0	2	10	0	0
15	25656103	.	C	T	9	6	15	0	1	16	0	0
15	25656175	.	A	G	9	5	14	0	1	15	0	0
15	25910655	.	A	C	5	5	10	0	0	10	0	0
15	25910696	.	G	A	6	5	11	0	0	11	0	0
15	25961996	.	C	T	1	3	4	0	0	4	0	0
15	26399801	.	T	C	4	6	10	0	0	10	0	0
15	26400117	.	C	T	5	3	8	0	1	9	0	0
15	26400297	.	G	C	7	6	13	0	2	15	0	0
15	26400300	.	A	C	7	8	15	0	1	16	0	0
15	26400743	.	T	G	3	5	8	0	0	8	0	0
15	26400766	.	A	G	8	8	16	0	1	17	0	0
15	26400819	.	A	G	15	10	25	0	0	25	0	0
15	26400836	.	G	A	10	6	16	0	1	17	0	0
15	26400876	.	G	A	4	8	12	0	1	13	0	0
15	26400900	.	C	T	5	6	11	0	1	12	0	0
15	26400924	.	A	T	10	6	16	0	1	17	0	0
15	26401194	.	T	G	9	4	13	0	0	13	0	0
15	26401200	.	C	T	11	3	14	0	0	14	0	0
15	26401259	.	A	C	8	6	14	0	0	14	0	0
15	26401623	.	A	T	8	5	13	0	0	13	0	0
15	26401779	.	A	G	13	7	20	0	0	20	0	0
15	26401888	.	G	C	3	6	9	0	0	9	0	0
15	26402167	.	G	A	20	11	31	0	0	31	0	0
15	26498400	.	T	G	1	5	6	0	0	6	0	0
15	26498455	.	A	T	4	8	12	0	1	13	0	0
15	26498615	.	C	T	7	15	22	0	0	22	0	0
15	26498621	.	C	A	7	16	23	0	2	25	0	0
15	26498716	.	A	G	10	12	22	0	1	23	0	0
15	26498749	.	A	T	11	16	27	0	1	28	0	0
15	26498820	.	T	G	10	14	24	0	1	25	0	0
15	26505495	.	C	A	13	11	24	0	0	24	0	0
15	26515021	.	C	T	0	17	17	0	8	25	0	0
15	26538874	.	A	G	6	2	8	0	1	9	0	0
15	26538885	.	G	A	6	3	9	0	0	9	0	0
15	26553093	.	A	T	10	10	20	0	0	20	0	0
15	26553095	.	T	C	9	10	19	0	1	20	0	0
15	26554162	.	A	G	5	3	8	0	0	8	0	0
15	26554181	.	T	C	3	3	6	0	1	7	0	0
15	26554442	.	C	T	1	3	4	0	0	4	0	0
15	26554686	.	G	A	5	3	8	0	0	8	0	0
15	26561407	.	C	G	4	2	6	0	0	6	0	0
15	26561526	.	C	T	1	2	3	0	1	4	0	0
15	26561610	.	A	T	3	2	5	0	2	7	0	0
15	26563456	.	C	T	0	2	2	0	2	4	0	0
15	26563537	.	T	C	2	0	2	0	4	6	0	0
15	26564209	.	G	A	2	3	5	0	0	5	0	0
15	26564267	.	G	A	4	4	8	0	0	8	0	0
15	26616179	.	T	G	2	2	4	0	0	4	0	0
15	26616188	.	T	C	2	0	2	0	2	4	0	0
15	26616225	.	C	T	2	2	4	0	0	4	0	0
15	26678917	.	C	A	0	5	5	1	5	11	0	0
15	26678932	.	T	A	5	5	10	0	0	10	0	0
15	26679070	.	T	A	4	2	6	0	0	6	0	0
15	26679908	.	C	T	1	7	8	0	9	17	0	0
15	26680080	.	G	C	4	3	7	0	2	9	0	0
15	26683504	.	A	G	8	6	14	0	1	15	0	0
15	26683758	.	G	A	12	8	20	0	1	21	0	0
15	26683764	.	G	A	10	9	19	0	2	21	0	0
15	26686828	.	A	T	1	4	5	0	0	31	26	0
15	26699885	.	G	A	3	3	6	1	0	7	0	0
15	26707518	.	G	A	3	6	9	0	0	9	0	0
15	26707569	.	G	T	3	6	9	0	0	9	0	0
15	26710306	.	G	A	9	3	12	0	0	12	0	0
15	26720581	.	C	T	1	3	4	0	4	9	1	0
15	26729480	.	G	A	2	7	9	0	0	9	0	0
15	26751709	.	C	G	1	2	3	0	1	4	0	0
15	26843956	.	A	G	4	5	9	0	0	9	0	0
15	26844074	.	T	G	2	3	5	0	1	6	0	0
15	26844077	.	A	T	3	4	7	0	0	7	0	0
15	26849351	.	A	G	3	2	5	0	0	5	0	0
15	26849890	.	G	A	2	6	8	0	0	8	0	0
15	26855019	.	A	G	2	2	4	0	0	4	0	0
15	26855159	.	T	G	1	5	6	0	0	6	0	0
15	26873946	.	G	A	3	4	7	0	0	7	0	0
15	26904779	.	G	A	3	5	8	0	0	8	0	0
15	26904838	.	A	G	2	5	7	0	0	7	0	0
15	26904989	.	C	A	2	3	5	0	0	5	0	0
15	26905002	.	C	T	3	3	6	0	0	6	0	0
15	26905088	.	A	G	3	4	7	0	0	7	0	0
15	26905118	.	T	G	5	5	10	0	0	10	0	0
15	26915384	.	T	A	9	9	18	0	3	21	0	0
15	26915531	.	A	G	11	7	18	0	1	19	0	0
15	26915568	.	G	A	11	10	21	0	0	21	0	0
15	26915633	.	C	T	8	5	13	0	0	13	0	0
15	26915651	.	T	C	9	4	13	0	1	14	0	0
15	26919255	.	T	C	4	10	14	0	0	14	0	0
15	26921873	.	T	C	3	8	11	0	2	13	0	0
15	26922139	.	A	G	10	6	16	0	0	16	0	0
15	26922162	.	T	G	9	6	15	0	0	15	0	0
15	26924056	.	T	C	8	8	16	0	1	17	0	0
15	26924080	.	C	G	1	6	7	0	6	13	0	0
15	26926474	.	G	A	4	4	8	0	0	8	0	0
15	26926653	.	A	C	1	8	9	0	2	11	0	0
15	26935032	.	A	T	4	2	6	0	1	7	0	0
15	26935696	.	G	A	5	4	9	0	0	9	0	0
15	26938324	.	A	C	5	4	9	0	0	9	0	0
15	26939031	.	C	A	8	7	15	0	2	17	0	0
15	26939224	.	G	T	7	5	12	0	0	12	0	0
15	26939233	.	A	C	3	7	10	0	0	10	0	0
15	26939279	.	G	A	1	6	7	0	3	10	0	0
15	26993973	.	C	A	2	2	4	0	0	4	0	0
15	27071096	.	C	G	9	1	10	0	0	10	0	0
15	27071099	.	A	G	8	2	10	0	0	11	1	0
15	27071735	.	G	A	8	2	10	0	0	10	0	0
15	27071792	.	T	G	1	6	7	0	0	7	0	0
15	27071849	.	G	A	10	7	17	0	1	18	0	0
15	27087813	.	C	T	9	5	14	0	0	14	0	0
15	27328142	.	T	G	6	0	6	0	9	15	0	0
15	27352608	.	G	A	3	3	6	0	0	6	0	0
15	27353481	.	G	A	5	3	8	0	0	8	0	0
15	27353950	.	T	C	7	3	10	0	0	10	0	0
15	27354412	.	T	A	20	14	34	0	0	34	0	0
15	27703845	.	A	G	16	14	30	0	2	32	0	0
15	27704220	.	C	A	4	15	19	0	14	33	0	0
15	27710392	.	A	G	4	4	8	0	0	8	0	0
15	27710396	.	C	T	3	4	7	0	0	7	0	0
15	28085382	.	T	C	2	3	5	0	0	5	0	0
15	28085422	.	G	A	1	4	5	0	0	5	0	0
15	28124642	.	C	T	5	7	12	0	1	13	0	0
15	28124913	.	T	C	4	5	9	0	2	11	0	0
15	28125146	.	A	G	2	0	2	0	7	9	0	0
15	28125186	.	A	G	2	7	9	0	1	10	0	0
15	28182704	.	G	A	0	1	1	0	0	1	0	0
15	28182716	.	C	A	1	1	2	0	1	3	0	0
15	28182837	.	A	G	4	2	6	0	1	7	0	0
15	28188849	.	T	A	5	2	7	0	0	7	0	0
15	28189029	.	T	A	7	8	15	0	0	15	0	0
15	28189046	.	T	G	5	8	13	0	2	15	0	0
15	28189409	.	A	C	6	4	10	0	0	10	0	0
15	28189589	.	T	C	6	0	6	0	11	17	0	0
15	28189591	.	T	C	7	10	17	0	0	17	0	0
15	28189945	.	T	G	8	11	19	0	1	20	0	0
15	28192706	.	A	G	9	10	19	0	0	19	0	0
15	28194669	.	T	C	7	12	19	0	1	20	0	0
15	28194708	.	A	G	7	9	16	0	0	16	0	0
15	28195515	.	A	T	3	8	11	0	0	11	0	0
15	28199233	.	G	A	0	3	3	0	1	4	0	0
15	28199431	.	A	G	3	3	6	0	0	6	0	0
15	28199437	.	A	T	2	3	5	0	0	5	0	0
15	28199574	.	T	C	2	3	5	0	0	5	0	0
15	28199707	.	G	A	1	3	4	0	0	4	0	0
15	28199860	.	T	C	1	0	1	0	3	4	0	0
15	28199861	.	T	G	1	3	4	0	0	4	0	0
15	28202657	.	A	G	1	0	1	0	4	5	0	0
15	28207488	.	A	G	1	2	3	0	1	4	0	0
15	28230738	.	G	A	1	3	4	0	0	4	0	0
15	28247443	.	A	C	2	3	5	0	0	5	0	0
15	28247465	.	C	G	2	3	5	0	0	5	0	0
15	28249301	.	G	T	4	4	8	0	0	8	0	0
15	28251094	.	T	A	12	23	35	0	1	36	0	0
15	28252597	.	T	C	11	11	22	0	4	26	0	0
15	28252599	.	A	G	16	11	27	0	0	27	0	0
15	28253171	.	C	A	0	9	9	0	12	21	0	0
15	28253522	.	C	T	5	6	11	0	0	11	0	0
15	28253773	.	C	T	1	4	5	0	1	6	0	0
15	28254202	.	G	T	7	4	11	0	1	12	0	0
15	28257277	.	A	G	1	4	5	0	0	5	0	0
15	28259321	.	T	C	2	4	6	0	0	6	0	0
15	28259971	.	G	A	1	2	3	0	0	3	0	0
15	28260007	.	C	T	2	3	5	0	0	5	0	0
15	28260031	.	A	G	2	4	6	0	0	6	0	0
15	28260381	.	A	T	2	3	5	0	0	5	0	0
15	28260522	.	T	A	3	3	6	0	0	6	0	0
15	28343332	.	A	G	2	2	4	0	0	4	0	0
15	28343667	.	C	T	7	4	11	0	0	11	0	0
15	28350079	.	C	G	2	4	6	0	0	6	0	0
15	28350095	.	C	T	2	2	4	0	2	6	0	0
15	28351089	.	C	G	9	3	12	0	0	12	0	0
15	28351132	.	G	A	6	7	13	0	0	13	0	0
15	28352138	.	T	C	15	7	22	0	0	22	0	0
15	28352168	.	C	A	13	5	18	0	0	18	0	0
15	28368884	.	G	A	2	4	6	0	0	6	0	0
15	28401905	.	A	T	2	2	4	0	0	4	0	0
15	28403365	.	C	T	5	5	10	0	0	10	0	0
15	28432697	.	C	A	10	24	34	0	1	36	1	0
15	28432739	.	C	T	13	11	24	0	2	26	0	0
15	28432741	.	A	T	12	13	25	0	1	26	0	0
15	28432871	.	T	C	14	7	21	0	2	23	0	0
15	28432993	.	C	T	1	9	10	0	13	23	0	0
15	28433073	.	A	G	9	9	18	0	0	18	0	0
15	28433102	.	C	A	9	4	13	0	3	16	0	0
15	28433161	.	T	C	10	7	17	0	1	18	0	0
15	28433282	.	G	A	8	15	23	0	1	24	0	0
15	28433947	.	A	G	7	14	21	0	2	23	0	0
15	28437178	.	G	T	3	4	7	0	0	7	0	0
15	28439441	.	G	A	10	7	17	0	0	17	0	0
15	28446791	.	A	T	7	6	13	0	1	14	0	0
15	28452844	.	A	G	4	8	12	0	0	12	0	0
15	28453081	.	C	A	0	5	5	0	6	11	0	0
15	28453102	.	C	T	6	7	13	0	0	13	0	0
15	28463609	.	C	T	1	4	5	0	7	12	0	0
15	28483230	.	C	T	4	2	6	0	0	6	0	0
15	28483333	.	A	C	1	6	7	1	0	8	0	0
15	28509840	.	G	A	1	5	6	1	0	7	0	0
15	28515428	.	C	A	4	2	6	0	0	6	0	0
15	28520856	.	A	G	5	0	5	0	9	14	0	0
15	28526386	.	A	T	9	7	16	0	1	17	0	0
15	28537810	.	T	A	7	7	14	0	1	15	0	0
15	28537852	.	T	C	9	5	14	0	1	15	0	0
15	28537872	.	G	A	0	4	4	0	6	10	0	0
15	28537906	.	A	C	9	3	12	0	0	12	0	0
15	28537965	.	T	A	4	6	10	0	0	10	0	0
15	28538012	.	G	A	0	4	4	0	8	12	0	0
15	28538097	.	A	G	10	0	10	0	7	17	0	0
15	28538173	.	G	A	4	4	8	0	0	8	0	0
15	28538199	.	T	C	7	6	13	0	0	13	0	0
15	28538239	.	G	T	9	5	14	0	0	14	0	0
15	28538405	.	T	C	4	13	17	0	0	17	0	0
15	28538602	.	A	T	4	7	11	0	2	13	0	0
15	28538605	.	G	A	0	8	8	0	5	13	0	0
15	28538667	.	A	G	5	4	9	0	0	9	0	0
15	28538761	.	A	G	14	9	23	0	0	23	0	0
15	28538765	.	C	T	15	7	22	0	0	23	1	0
15	28539022	.	C	A	10	5	15	0	0	15	0	0
15	28539112	.	C	T	12	8	20	0	0	20	0	0
15	28539160	.	T	C	13	10	23	0	1	24	0	0
15	28539232	.	C	T	9	6	15	0	0	15	0	0
15	28539381	.	A	T	2	7	9	0	0	9	0	0
15	28539383	.	A	T	3	7	10	0	0	10	0	0
15	28539523	.	T	C	9	9	18	0	0	18	0	0
15	28539556	.	G	A	8	9	17	0	2	19	0	0
15	28539649	.	T	A	8	4	12	0	1	13	0	0
15	28549003	.	G	A	4	5	9	0	0	9	0	0
15	28549347	.	G	T	6	8	14	0	0	14	0	0
15	28549348	.	T	A	6	7	13	0	1	14	0	0
15	28549392	.	A	C	11	6	17	0	0	17	0	0
15	28549665	.	T	C	1	0	1	0	3	4	0	0
15	28549965	.	G	C	3	6	9	0	0	9	0	0
15	28551281	.	G	A	4	2	6	0	1	7	0	0
15	28551285	.	G	A	5	2	7	0	0	7	0	0
15	28551498	.	A	G	2	2	4	0	0	4	0	0
15	28609097	.	G	A	6	4	10	0	1	11	0	0
15	28634719	.	G	A	12	10	22	0	0	22	0	0
15	28646687	.	G	A	8	9	17	0	0	17	0	0
15	28646696	.	T	C	10	0	10	0	12	22	0	0
15	28646886	.	G	A	9	7	16	0	0	16	0	0
15	28646931	.	C	G	5	7	12	0	0	12	0	0
15	28672508	.	T	G	5	4	9	0	0	9	0	0
15	28677558	.	T	A	4	4	8	0	2	10	0	0
15	28686433	.	A	T	12	14	26	0	4	30	0	0
15	28758907	.	G	C	2	12	14	0	24	38	0	0
15	28758988	.	C	T	11	15	26	0	1	27	0	0
15	28759171	.	T	G	11	0	11	0	22	33	0	0
15	28759246	.	G	C	1	14	15	0	14	29	0	0
15	28759558	.	C	G	10	0	10	0	10	20	0	0
15	28759639	.	G	A	7	7	14	0	1	15	0	0
15	28760090	.	T	C	23	16	39	0	1	40	0	0
15	28760675	.	A	T	16	19	35	0	0	35	0	0
15	28761031	.	T	C	11	18	29	0	0	29	0	0
15	28761173	.	T	C	15	15	30	0	4	34	0	0
15	28761284	.	T	A	16	14	30	0	2	32	0	0
15	28762440	.	C	T	25	18	43	0	2	45	0	0
15	28763124	.	T	C	17	22	39	0	0	39	0	0
15	28763134	.	T	C	17	21	38	0	0	38	0	0
15	28763677	.	C	A	23	19	42	0	1	43	0	0
15	28763770	.	T	C	23	27	50	0	0	51	1	0
15	28763927	.	G	A	1	24	25	0	24	49	0	0
15	28763986	.	G	A	4	32	36	0	15	51	0	0
15	28764206	.	G	T	1	20	21	0	16	37	0	0
15	28764252	.	A	G	25	1	26	0	29	55	0	0
15	28766069	.	A	G	4	4	8	0	1	9	0	0
15	28787262	.	T	A	3	3	6	0	1	7	0	0
15	28792399	.	C	A	2	2	4	0	0	4	0	0
15	28802136	.	A	T	1	2	3	0	0	3	0	0
15	28881717	.	G	A	15	11	26	0	0	26	0	0
15	28882675	.	T	A	11	10	21	0	1	22	0	0
15	28882687	.	A	G	9	13	22	0	0	22	0	0
15	28886531	.	G	C	2	7	9	0	0	9	0	0
15	28886882	.	A	T	2	4	6	0	0	6	0	0
15	28887280	.	G	T	9	8	17	0	1	18	0	0
15	28887667	.	A	G	8	3	11	0	0	11	0	0
15	28972971	.	A	G	2	2	4	0	1	5	0	0
15	28973341	.	C	A	2	1	3	0	1	4	0	0
15	29000989	.	C	T	18	10	28	0	2	30	0	0
15	29001556	.	C	T	15	13	28	1	2	31	0	0
15	29001583	.	T	C	14	20	34	2	0	36	0	0
15	29004485	.	A	G	21	22	43	0	3	46	0	0
15	29005346	.	T	A	16	13	29	0	0	29	0	0
15	29005363	.	A	C	8	8	16	0	4	20	0	0
15	29005564	.	T	G	15	13	28	0	0	28	0	0
15	29005600	.	A	C	17	13	30	0	2	32	0	0
15	29005862	.	T	A	25	8	33	0	3	36	0	0
15	29005869	.	A	T	24	12	36	0	1	37	0	0
15	29005935	.	C	T	17	20	37	0	0	37	0	0
15	29005984	.	C	T	19	15	34	0	1	35	0	0
15	29005996	.	C	A	14	14	28	0	3	31	0	0
15	29006097	.	C	T	18	20	38	0	0	38	0	0
15	29006142	.	G	A	3	21	24	0	20	44	0	0
15	29089143	.	T	A	20	22	42	0	1	43	0	0
15	29089279	.	C	A	23	12	35	0	3	38	0	0
15	29089317	.	A	G	24	19	43	0	1	44	0	0
15	29089392	.	A	G	14	17	31	0	2	33	0	0
15	29089524	.	T	C	28	18	46	0	5	51	0	0
15	29089788	.	G	A	23	21	44	0	1	45	0	0
15	29089827	.	G	T	5	22	27	0	22	49	0	0
15	29089870	.	C	T	27	22	49	0	5	54	0	0
15	29090181	.	A	G	23	26	49	0	6	55	0	0
15	29091565	.	G	A	25	16	41	0	1	42	0	0
15	29093073	.	C	A	4	5	9	0	0	9	0	0
15	29097468	.	T	C	16	12	28	0	1	29	0	0
15	29097640	.	A	G	10	11	21	0	2	23	0	0
15	29100574	.	T	G	7	8	15	1	2	18	0	0
15	29100623	.	G	A	9	7	16	1	2	19	0	0
15	29100934	.	C	G	9	12	21	0	0	21	0	0
15	29104050	.	G	A	11	4	15	0	1	16	0	0
15	29106691	.	T	C	4	7	11	0	0	11	0	0
15	29108812	.	T	C	5	4	9	0	0	9	0	0
15	29108872	.	A	G	6	6	12	0	0	12	0	0
15	29108896	.	A	G	6	4	10	0	0	10	0	0
15	29111682	.	T	C	5	0	5	0	5	10	0	0
15	29111902	.	A	C	6	0	6	0	7	13	0	0
15	29111969	.	C	T	5	3	8	0	0	8	0	0
15	29111970	.	T	C	5	3	8	0	0	8	0	0
15	29112164	.	C	T	4	3	7	0	1	8	0	0
15	29114361	.	A	T	3	2	5	0	2	7	0	0
15	29116177	.	T	C	3	8	11	0	0	11	0	0
15	29116264	.	A	G	14	18	32	0	4	36	0	0
15	29116658	.	C	G	9	2	11	0	0	11	0	0
15	29116659	.	A	G	9	2	11	0	0	11	0	0
15	29119813	.	A	C	11	15	26	0	1	27	0	0
15	29119829	.	A	C	13	14	27	0	0	27	0	0
15	29122072	.	T	A	19	14	33	0	1	34	0	0
15	29136127	.	A	T	10	5	15	0	0	15	0	0
15	29148674	.	T	C	4	4	8	0	0	8	0	0
15	29148675	.	T	G	3	1	4	0	4	8	0	0
15	29149292	.	C	T	9	5	14	0	0	14	0	0
15	29152041	.	G	T	3	6	9	0	0	9	0	0
15	29297752	.	G	A	2	2	4	0	0	4	0	0
15	29311995	.	G	C	3	6	9	0	3	12	0	0
15	29312303	.	C	A	4	4	8	0	0	8	0	0
15	29312333	.	T	C	4	3	7	0	0	7	0	0
15	29312748	.	T	C	6	4	10	0	1	11	0	0
15	29312763	.	C	T	5	6	11	0	0	11	0	0
15	29316951	.	C	A	6	2	8	0	1	9	0	0
15	29317007	.	G	A	4	2	6	0	0	6	0	0
15	29344206	.	G	T	2	2	4	0	0	4	0	0
15	29344848	.	G	A	1	2	3	0	0	3	0	0
15	29454352	.	G	A	7	6	13	0	1	14	0	0
15	29456387	.	A	G	7	6	13	0	0	13	0	0
15	29456410	.	C	T	8	10	18	0	0	18	0	0
15	29459013	.	A	G	12	11	23	0	0	23	0	0
15	29459046	.	G	A	10	7	17	0	1	18	0	0
15	29465874	.	T	C	12	4	16	0	1	17	0	0
15	29467216	.	T	A	8	11	19	0	0	19	0	0
15	29467254	.	A	G	11	1	12	0	13	25	0	0
15	29467339	.	A	G	7	7	14	1	1	16	0	0
15	29469851	.	G	T	10	8	18	0	1	19	0	0
15	29481884	.	A	G	18	6	24	0	0	24	0	0
15	29481921	.	G	A	1	9	10	0	14	24	0	0
15	29482286	.	G	C	15	11	26	0	0	26	0	0
15	29482439	.	A	G	9	6	15	0	1	16	0	0
15	29483095	.	T	G	3	4	7	0	0	7	0	0
15	29483434	.	G	C	16	5	21	0	1	22	0	0
15	29483608	.	A	T	10	7	17	0	1	18	0	0
15	29483815	.	C	A	13	5	18	0	3	21	0	0
15	29483851	.	G	T	16	10	26	0	1	27	0	0
15	29549677	.	T	A	9	6	15	0	0	15	0	0
15	29556667	.	T	C	3	3	6	0	0	6	0	0
15	29709048	.	G	T	4	2	6	0	0	6	0	0
15	29710065	.	A	G	3	4	7	0	1	8	0	0
15	29712127	.	C	A	6	9	15	0	0	15	0	0
15	29712210	.	G	A	1	3	4	0	14	18	0	0
15	29712221	.	C	T	10	6	16	0	0	16	0	0
15	29712405	.	G	A	8	13	21	0	2	23	0	0
15	29772299	.	T	A	5	4	9	0	0	9	0	0
15	29775134	.	A	G	8	1	9	0	3	12	0	0
15	30127451	.	T	C	2	6	8	0	0	8	0	0
15	30130530	.	A	C	7	7	14	0	0	14	0	0
15	30130664	.	G	A	2	3	5	0	8	13	0	0
15	30131482	.	G	A	9	9	18	0	0	18	0	0
15	30131585	.	C	T	6	6	12	0	0	12	0	0
15	30131803	.	G	A	3	5	8	0	0	8	0	0
15	30134489	.	G	A	5	9	14	0	0	14	0	0
15	30134679	.	C	G	2	5	7	0	0	7	0	0
15	30134779	.	G	T	6	7	13	0	0	13	0	0
15	30135016	.	T	A	7	5	12	0	0	12	0	0
15	30135206	.	G	A	2	7	9	0	5	14	0	0
15	30135300	.	A	T	9	9	18	0	3	21	0	0
15	30135572	.	A	G	8	0	8	0	10	18	0	0
15	30135920	.	A	G	5	5	10	0	1	11	0	0
15	30135948	.	G	A	2	5	7	0	1	8	0	0
15	30136472	.	A	G	2	5	7	0	0	7	0	0
15	30136512	.	T	A	3	3	6	0	0	6	0	0
15	30136962	.	A	G	6	0	6	0	14	20	0	0
15	30137561	.	C	T	16	14	30	0	2	32	0	0
15	30157713	.	A	G	4	1	5	0	4	9	0	0
15	30158096	.	G	T	0	6	6	0	8	14	0	0
15	30159050	.	A	T	6	7	13	0	3	17	1	0
15	30252414	.	T	C	2	9	11	0	0	11	0	0
15	30265017	.	C	T	8	12	20	0	0	20	0	0
15	30300771	.	A	C	3	1	4	0	11	15	0	0
15	30301196	.	G	A	0	7	7	0	9	16	0	0
15	30301239	.	G	A	0	8	8	0	6	14	0	0
15	30301320	.	T	C	5	15	20	0	1	21	0	0
15	30301447	.	G	A	9	5	14	0	0	14	0	0
15	30301474	.	G	A	6	4	10	0	0	10	0	0
15	30311016	.	C	T	5	5	10	0	0	10	0	0
15	30311062	.	G	T	0	9	9	0	5	14	0	0
15	30311616	.	T	G	5	4	9	0	0	9	0	0
15	30350666	.	A	T	4	4	8	0	0	8	0	0
15	30354513	.	G	T	8	9	17	0	0	17	0	0
15	30354603	.	A	T	4	6	10	0	1	11	0	0
15	30424673	.	C	T	1	10	11	0	9	20	0	0
15	30425704	.	T	C	4	1	5	0	1	6	0	0
15	30425705	.	C	T	3	3	6	0	0	6	0	0
15	30425936	.	G	A	6	4	10	0	0	10	0	0
15	30838455	.	C	G	12	6	18	0	0	18	0	0
15	30838777	.	G	A	17	17	34	0	0	34	0	0
15	30838867	.	C	T	15	12	27	0	0	27	0	0
15	30839168	.	A	T	11	10	21	0	2	23	0	0
15	30852433	.	G	A	6	3	9	0	0	9	0	0
15	30852598	.	T	C	7	5	12	0	0	12	0	0
15	30853039	.	G	T	9	5	14	0	0	14	0	0
15	30853096	.	T	A	4	8	12	0	1	13	0	0
15	30861987	.	C	A	0	5	5	0	5	10	0	0
15	30862251	.	A	T	4	7	11	0	0	11	0	0
15	30862449	.	A	G	6	4	10	0	1	11	0	0
15	30862452	.	G	T	6	4	10	0	0	10	0	0
15	30862517	.	G	A	2	4	6	0	0	6	0	0
15	30862712	.	G	A	10	13	23	0	0	23	0	0
15	30862785	.	C	T	3	9	12	0	1	13	0	0
15	30862814	.	A	G	6	9	15	0	1	16	0	0
15	30862997	.	T	G	6	2	8	0	0	8	0	0
15	30863059	.	T	C	4	1	5	0	6	11	0	0
15	30863117	.	T	C	7	8	15	0	0	15	0	0
15	30863123	.	A	C	8	8	16	0	0	16	0	0
15	30863242	.	T	C	5	8	13	0	1	14	0	0
15	30863354	.	C	T	7	5	12	0	0	12	0	0
15	30863535	.	G	T	11	12	23	0	3	26	0	0
15	30863569	.	G	A	12	19	31	0	3	34	0	0
15	30863799	.	T	C	4	0	4	0	6	10	0	0
15	30863834	.	G	T	4	6	10	0	0	10	0	0
15	30863850	.	T	C	5	4	9	0	0	9	0	0
15	30864072	.	T	G	5	6	11	0	1	12	0	0
15	30864308	.	C	A	11	6	17	0	0	17	0	0
15	30864354	.	T	C	9	0	9	0	4	13	0	0
15	30874327	.	A	G	11	4	15	0	1	16	0	0
15	30874387	.	G	A	7	12	19	0	1	20	0	0
15	30887163	.	G	A	3	2	5	0	0	5	0	0
15	30889297	.	T	C	6	4	10	0	0	10	0	0
15	30889544	.	T	C	1	3	4	0	0	4	0	0
15	30891636	.	C	T	2	3	5	0	0	5	0	0
15	30891645	.	G	A	2	2	4	0	1	5	0	0
15	30900478	.	A	G	5	2	7	0	0	7	0	0
15	30904802	.	G	A	2	2	4	0	0	4	0	0
15	30907811	.	A	G	6	8	14	0	1	15	0	0
15	30907818	.	G	A	0	5	5	0	8	13	0	0
15	30907884	.	C	A	9	3	12	0	0	12	0	0
15	30907888	.	A	G	9	0	9	0	3	12	0	0
15	30909175	.	C	G	10	0	10	0	13	23	0	0
15	30909308	.	G	A	1	12	13	0	10	23	0	0
15	30909572	.	C	A	12	9	21	0	0	21	0	0
15	30909639	.	A	G	10	12	22	0	0	22	0	0
15	30909663	.	G	A	9	7	16	0	2	18	0	0
15	30909707	.	A	T	5	9	14	0	3	17	0	0
15	30909771	.	T	C	7	9	16	0	1	17	0	0
15	30909798	.	A	G	8	1	9	0	7	16	0	0
15	30909824	.	A	C	7	5	12	0	0	12	0	0
15	30910022	.	G	A	10	7	17	0	4	21	0	0
15	30910042	.	C	A	20	6	26	0	4	30	0	0
15	30917436	.	C	T	2	3	5	0	0	5	0	0
15	30917695	.	T	G	7	0	7	0	5	12	0	0
15	30917715	.	A	G	7	4	11	0	1	12	0	0
15	30917737	.	C	T	6	2	8	0	0	8	0	0
15	30917750	.	A	T	8	4	12	0	1	13	0	0
15	30919478	.	C	T	7	6	13	0	0	13	0	0
15	30919595	.	T	C	7	12	19	0	0	19	0	0
15	30919676	.	G	T	14	6	20	0	0	20	0	0
15	30919784	.	A	G	15	5	20	0	0	20	0	0
15	30919854	.	T	G	7	6	13	0	0	13	0	0
15	30920135	.	A	G	7	3	10	0	0	10	0	0
15	30920242	.	A	C	7	8	15	0	0	15	0	0
15	30920698	.	C	A	13	13	26	0	0	26	0	0
15	30920780	.	T	C	4	10	14	0	0	14	0	0
15	30920795	.	A	G	5	8	13	0	0	13	0	0
15	30955191	.	A	G	1	3	4	0	0	4	0	0
15	31162074	.	T	A	10	20	30	0	0	30	0	0
15	31162122	.	A	G	14	12	26	0	3	29	0	0
15	31162186	.	G	C	12	16	28	0	3	31	0	0
15	31162795	.	G	A	19	10	29	0	1	30	0	0
15	31162836	.	A	G	12	10	22	0	3	25	0	0
15	31163089	.	G	A	6	11	17	0	0	17	0	0
15	31163148	.	T	A	15	14	29	0	2	31	0	0
15	31163335	.	A	T	11	12	23	0	4	27	0	0
15	31163621	.	T	A	20	23	43	0	1	44	0	0
15	31166755	.	C	A	9	10	19	0	3	22	0	0
15	31166788	.	A	G	8	7	15	0	1	16	0	0
15	31167449	.	A	G	2	3	5	0	0	5	0	0
15	31173414	.	G	A	7	4	11	0	2	13	0	0
15	31177053	.	A	G	5	6	11	0	0	11	0	0
15	31177054	.	T	A	4	5	9	0	1	11	1	0
15	31177214	.	T	G	6	6	12	0	0	12	0	0
15	31203002	.	A	G	2	10	12	0	0	12	0	0
15	31205723	.	A	G	2	10	12	0	0	12	0	0
15	31213017	.	T	C	1	0	1	0	7	8	0	0
15	31213105	.	C	T	0	5	5	0	2	7	0	0
15	31213171	.	A	G	1	6	7	0	0	7	0	0
15	31237173	.	T	C	1	3	4	0	0	4	0	0
15	31244339	.	A	T	1	3	4	0	1	5	0	0
15	31244412	.	C	T	0	4	4	0	5	9	0	0
15	31250527	.	A	T	1	5	6	0	0	6	0	0
15	31513561	.	G	A	22	33	55	0	3	58	0	0
15	31513842	.	A	G	36	28	64	0	5	69	0	0
15	31513848	.	T	C	38	34	72	0	1	73	0	0
15	31513893	.	C	A	1	26	27	0	39	66	0	0
15	31514325	.	A	G	27	28	55	0	3	58	0	0
15	31516046	.	G	A	2	3	5	0	1	6	0	0
15	31564314	.	G	A	2	5	7	0	1	8	0	0
15	31564691	.	A	G	1	2	3	0	0	3	0	0
15	31564864	.	G	T	6	2	8	0	0	8	0	0
15	31564885	.	A	G	8	3	11	0	0	11	0	0
15	31564946	.	T	C	7	6	13	0	0	13	0	0
15	31568159	.	C	T	0	3	3	0	5	8	0	0
15	31571496	.	A	G	5	2	7	0	0	7	0	0
15	31573941	.	C	G	0	4	4	0	3	7	0	0
15	31574035	.	T	C	6	0	6	0	3	9	0	0
15	31574100	.	T	C	1	0	1	0	5	6	0	0
15	31574119	.	A	G	1	3	4	0	0	4	0	0
15	31574320	.	C	T	1	2	3	0	0	3	0	0
15	31674120	.	G	T	3	1	4	0	1	5	0	0
15	31694928	.	G	A	0	6	6	0	6	12	0	0
15	31700738	.	C	T	6	3	9	0	1	10	0	0
15	31706200	.	G	C	1	6	7	0	0	7	0	0
15	31712529	.	C	T	1	4	5	0	0	5	0	0
15	31732502	.	A	G	17	5	22	3	1	26	0	0
15	31862250	.	T	C	5	2	7	0	0	7	0	0
15	31870694	.	G	A	2	2	4	0	0	4	0	0
15	31877363	.	C	T	2	2	4	0	0	4	0	0
15	31881873	.	G	A	1	3	4	0	2	6	0	0
15	31881954	.	T	C	3	3	6	0	0	6	0	0
15	31882269	.	G	A	3	5	8	0	0	8	0	0
15	31882272	.	A	G	4	5	9	0	0	9	0	0
15	31884219	.	A	C	1	2	3	0	0	3	0	0
15	31889086	.	A	G	1	6	7	0	0	7	0	0
15	31889332	.	C	T	6	3	9	0	0	9	0	0
15	31890902	.	T	G	2	3	5	0	1	6	0	0
15	31893536	.	A	C	4	9	13	0	2	15	0	0
15	31893599	.	C	T	8	5	13	0	2	15	0	0
15	31895248	.	A	G	6	0	6	0	6	12	0	0
15	31905040	.	G	A	24	6	30	0	3	33	0	0
15	31905097	.	A	G	12	17	29	0	3	32	0	0
15	31909454	.	A	C	7	16	23	0	1	24	0	0
15	31921725	.	T	A	1	2	3	0	0	3	0	0
15	32194630	.	C	A	2	2	4	0	0	4	0	0
15	32195395	.	T	C	1	2	3	0	0	3	0	0
15	32195521	.	T	C	5	4	9	0	0	9	0	0
15	32196655	.	A	C	2	2	4	0	0	4	0	0
15	32249188	.	G	A	15	18	33	0	1	34	0	0
15	32259056	.	G	A	5	6	11	0	0	11	0	0
15	32261461	.	G	C	1	10	11	2	11	24	0	0
15	32261464	.	T	C	12	10	22	2	1	25	0	0
15	32265889	.	T	C	18	11	29	0	2	31	0	0
15	32266557	.	A	T	14	10	24	0	0	24	0	0
15	32266921	.	G	A	0	17	17	0	14	31	0	0
15	32267078	.	A	G	9	4	13	0	1	14	0	0
15	32349398	.	G	T	7	3	10	0	0	10	0	0
15	32349871	.	A	G	2	0	2	0	3	5	0	0
15	32350051	.	A	G	4	3	7	23	0	30	0	0
15	32350116	.	G	T	8	6	14	1	1	16	0	0
15	32350779	.	A	G	15	2	17	0	1	18	0	0
15	32887799	.	A	G	6	7	13	0	0	13	0	0
15	32887803	.	A	G	9	0	9	0	5	14	0	0
15	32887858	.	A	G	3	7	10	0	0	10	0	0
15	33853701	.	C	T	4	4	8	0	1	9	0	0
15	33864266	.	G	A	3	2	5	0	1	6	0	0
15	33864585	.	G	A	6	6	12	0	1	13	0	0
15	33891825	.	G	A	21	16	37	0	0	37	0	0
15	33891826	.	G	A	21	16	37	0	0	37	0	0
15	33891869	.	G	T	17	10	27	0	2	29	0	0
15	33896117	.	G	T	28	16	44	0	1	45	0	0
15	33896177	.	T	C	15	24	39	0	0	39	0	0
15	33896213	.	T	C	12	2	14	0	24	38	0	0
15	33896303	.	T	A	21	12	33	0	0	33	0	0
15	33896306	.	A	G	12	18	30	0	0	30	0	0
15	33896832	.	T	C	13	8	21	0	0	21	0	0
15	33899556	.	C	G	15	8	23	0	3	26	0	0
15	33899808	.	T	A	13	14	27	0	6	33	0	0
15	33902388	.	C	G	0	4	4	0	7	11	0	0
15	33910546	.	G	C	9	7	16	0	0	16	0	0
15	33970841	.	A	G	19	0	19	0	19	38	0	0
15	33970854	.	C	T	16	18	34	0	1	35	0	0
15	33970907	.	C	T	18	20	38	0	1	39	0	0
15	33971097	.	G	C	11	24	35	0	4	39	0	0
15	33977716	.	A	T	12	17	29	0	3	32	0	0
15	33977760	.	A	G	9	0	9	0	24	33	0	0
15	33977942	.	A	C	10	10	20	0	0	20	0	0
15	34074558	.	C	T	5	2	7	0	0	7	0	0
15	34174532	.	T	A	11	15	26	0	0	26	0	0
15	34174744	.	A	T	6	4	10	0	1	11	0	0
15	34175101	.	T	C	27	13	40	0	0	40	0	0
15	34175359	.	G	A	7	4	11	0	0	11	0	0
15	34175426	.	T	A	9	8	17	0	1	18	0	0
15	34175718	.	G	A	3	8	11	0	1	12	0	0
15	34175917	.	C	T	6	9	15	2	0	17	0	0
15	34175929	.	C	T	13	6	19	1	0	20	0	0
15	34176203	.	A	T	9	10	19	0	1	20	0	0
15	34176214	.	C	T	10	5	15	0	1	16	0	0
15	34176379	.	A	C	8	7	15	0	1	16	0	0
15	34176841	.	A	T	5	10	15	0	0	15	0	0
15	34176993	.	G	A	9	9	18	0	1	19	0	0
15	34182135	.	G	A	6	5	11	0	1	12	0	0
15	34186690	.	A	T	11	8	19	0	1	20	0	0
15	34189452	.	G	A	11	8	19	0	1	20	0	0
15	34212903	.	G	A	1	5	6	0	0	6	0	0
15	34223260	.	A	G	1	3	4	0	0	4	0	0
15	34239165	.	C	T	2	2	4	0	0	4	0	0
15	34326178	.	G	A	1	2	3	0	0	3	0	0
15	34534245	.	C	G	5	4	9	0	0	9	0	0
15	34534265	.	C	T	5	6	11	0	0	11	0	0
15	34558428	.	G	A	4	5	9	0	0	9	0	0
15	34558438	.	G	T	3	2	5	0	0	5	0	0
15	34573337	.	C	T	1	3	4	0	0	4	0	0
15	34573597	.	A	T	6	5	11	0	0	11	0	0
15	34573664	.	G	T	3	3	6	0	0	6	0	0
15	34573952	.	T	A	4	4	8	0	0	8	0	0
15	34573959	.	A	T	5	5	10	0	0	10	0	0
15	34574116	.	G	A	11	8	19	0	1	20	0	0
15	34577749	.	G	A	7	11	18	0	1	19	0	0
15	34585286	.	C	A	2	2	4	0	0	4	0	0
15	34590772	.	A	G	3	3	6	0	0	6	0	0
15	34618456	.	T	G	9	7	16	0	0	16	0	0
15	34618669	.	A	T	10	17	27	0	0	27	0	0
15	34618906	.	C	A	17	16	33	0	2	35	0	0
15	34618948	.	T	G	15	13	28	0	3	31	0	0
15	34618958	.	G	A	13	13	26	0	2	28	0	0
15	34621868	.	G	A	14	20	34	0	0	34	0	0
15	34621875	.	G	A	20	17	37	0	0	37	0	0
15	34627792	.	T	A	11	6	17	0	0	17	0	0
15	34627874	.	T	C	14	13	27	0	1	28	0	0
15	34635321	.	C	A	3	6	9	0	0	9	0	0
15	34635336	.	A	C	4	0	4	0	6	10	0	0
15	34637582	.	C	T	1	5	6	1	10	17	0	0
15	34638847	.	C	T	1	9	10	0	8	18	0	0
15	34641276	.	G	A	1	2	3	0	0	3	0	0
15	34641300	.	G	A	1	6	7	0	0	7	0	0
15	34641384	.	G	A	8	8	16	0	1	17	0	0
15	34657370	.	C	T	3	2	5	0	0	5	0	0
15	34657919	.	T	A	1	3	4	0	0	4	0	0
15	35075831	.	G	A	0	6	6	0	1	7	0	0
15	35076003	.	C	T	7	2	9	0	0	9	0	0
15	35091591	.	A	G	2	2	4	0	0	4	0	0
15	35092114	.	A	G	11	2	13	0	1	14	0	0
15	35102653	.	G	A	2	2	4	0	0	4	0	0
15	35103256	.	A	G	1	5	6	0	0	6	0	0
15	35103263	.	G	A	1	6	7	0	0	7	0	0
15	35115699	.	A	G	2	3	5	5	0	10	0	0
15	35156554	.	T	G	2	1	3	0	1	4	0	0
15	35156573	.	A	T	3	2	5	0	0	5	0	0
15	35157052	.	T	A	5	7	12	0	0	12	0	0
15	35157054	.	G	A	5	7	12	0	0	12	0	0
15	35158661	.	T	G	8	11	19	0	0	19	0	0
15	35163492	.	T	G	8	10	18	0	2	20	0	0
15	35163523	.	C	T	7	10	17	0	0	17	0	0
15	35167298	.	A	G	3	3	6	0	0	6	0	0
15	35212147	.	C	G	0	6	6	0	1	7	0	0
15	35212177	.	G	A	4	4	8	0	0	8	0	0
15	35212386	.	T	C	5	4	9	0	0	9	0	0
15	35212418	.	G	C	5	2	7	0	0	7	0	0
15	35214784	.	T	A	4	9	13	0	0	13	0	0
15	35214859	.	A	C	9	0	9	0	9	18	0	0
15	35214901	.	G	A	12	10	22	0	1	23	0	0
15	35217424	.	G	A	7	6	13	0	0	13	0	0
15	35217475	.	T	C	13	5	18	0	0	18	0	0
15	35217487	.	C	A	0	6	6	0	12	18	0	0
15	35221304	.	A	T	8	5	13	0	0	13	0	0
15	35224269	.	G	C	8	9	17	0	2	19	0	0
15	35227221	.	A	T	12	3	15	0	1	16	0	0
15	35247678	.	A	T	18	17	35	0	5	40	0	0
15	35247687	.	A	G	18	23	41	0	1	42	0	0
15	35247729	.	A	G	17	21	38	0	0	38	0	0
15	35247762	.	T	C	14	15	29	0	1	30	0	0
15	35709988	.	C	T	2	2	4	0	0	4	0	0
15	35718398	.	A	C	5	2	7	0	0	7	0	0
15	35737680	.	T	C	5	5	10	0	1	11	0	0
15	35760664	.	C	T	5	4	9	0	1	10	0	0
15	35760925	.	T	C	2	4	6	0	1	7	0	0
15	35760943	.	C	T	2	4	6	0	1	7	0	0
15	35760970	.	G	A	3	5	8	0	1	9	0	0
15	35761024	.	T	C	7	6	13	0	0	13	0	0
15	35761027	.	A	G	5	5	10	0	0	10	0	0
15	35761126	.	G	A	0	4	4	0	8	12	0	0
15	35761225	.	G	A	3	2	5	0	1	6	0	0
15	35761516	.	T	C	6	3	9	0	0	9	0	0
15	35889474	.	G	A	3	3	6	0	0	6	0	0
15	35889516	.	A	C	5	3	8	0	0	8	0	0
15	35889517	.	C	A	1	3	4	0	4	8	0	0
15	35889826	.	C	T	2	2	4	0	1	5	0	0
15	35889865	.	A	G	3	3	6	0	0	6	0	0
15	35890046	.	G	A	3	3	6	0	0	6	0	0
15	35890148	.	C	T	1	1	2	0	1	3	0	0
15	35891639	.	T	A	4	4	8	0	0	8	0	0
15	35892879	.	T	C	1	3	4	0	0	4	0	0
15	36999358	.	C	T	4	2	6	0	2	8	0	0
15	37222589	.	T	C	28	30	58	0	2	60	0	0
15	37227033	.	T	G	33	28	61	0	3	64	0	0
15	37227059	.	A	G	30	2	32	0	31	63	0	0
15	37227509	.	A	G	33	0	33	0	29	62	0	0
15	37227714	.	A	G	31	0	31	0	28	59	0	0
15	37227770	.	G	A	32	17	49	0	1	50	0	0
15	37228164	.	A	G	28	27	55	0	1	56	0	0
15	37228236	.	C	T	22	25	47	0	3	50	0	0
15	37228266	.	T	C	25	21	46	0	2	48	0	0
15	37228301	.	T	A	25	29	54	0	1	55	0	0
15	37228338	.	T	A	28	17	45	0	0	46	1	0
15	37228620	.	G	C	28	9	37	0	2	39	0	0
15	37228626	.	G	A	33	5	38	0	2	40	0	0
15	37228665	.	C	G	26	31	57	0	1	58	0	0
15	37228809	.	T	G	54	0	54	1	15	70	0	0
15	37228843	.	T	A	49	19	68	2	1	71	0	0
15	37228845	.	T	G	48	19	67	2	0	69	0	0
15	37229199	.	A	G	20	0	20	10	7	37	0	0
15	37229871	.	A	T	27	36	63	0	5	68	0	0
15	37229991	.	C	A	29	37	66	0	5	71	0	0
15	37230038	.	G	A	33	33	66	0	0	66	0	0
15	37230100	.	G	A	41	29	70	0	1	71	0	0
15	37459049	.	T	C	7	0	7	0	6	13	0	0
15	37459062	.	T	C	4	0	4	0	6	10	0	0
15	37459369	.	T	C	5	4	9	0	0	9	0	0
15	37459438	.	T	C	6	0	6	0	2	8	0	0
15	37459443	.	T	C	4	4	8	0	0	8	0	0
15	37459819	.	T	C	11	3	14	0	0	14	0	0
15	37459828	.	T	C	7	4	11	0	2	13	0	0
15	37459979	.	T	C	1	5	6	0	0	6	0	0
15	37459988	.	T	C	3	0	3	0	4	7	0	0
15	37460217	.	T	C	4	3	7	0	0	7	0	0
15	37460405	.	T	C	4	3	7	0	0	7	0	0
15	38296467	.	A	G	14	4	18	0	1	19	0	0
15	38296535	.	A	G	23	6	29	0	1	30	0	0
15	38892060	.	T	C	3	2	5	0	0	5	0	0
15	39140121	.	C	A	13	10	23	0	0	23	0	0
15	39140568	.	G	A	1	6	7	0	7	14	0	0
15	39141465	.	T	C	8	9	17	0	3	20	0	0
15	39208133	.	C	A	16	9	25	0	0	25	0	0
15	39208150	.	C	T	14	9	23	0	1	24	0	0
15	39208201	.	C	A	11	13	24	0	0	24	0	0
15	39208211	.	C	T	11	13	24	0	1	25	0	0
15	39208258	.	C	T	16	8	24	0	2	26	0	0
15	39228174	.	A	G	16	16	32	0	1	34	1	0
15	39278501	.	G	T	11	8	19	0	0	19	0	0
15	39281923	.	A	G	9	9	18	0	3	21	0	0
15	39282007	.	G	C	13	1	14	0	13	27	0	0
15	39282070	.	A	G	14	10	24	0	0	24	0	0
15	39282091	.	G	A	4	13	17	0	4	21	0	0
15	39294391	.	C	T	13	6	19	0	1	20	0	0
15	39296706	.	A	G	11	9	20	0	1	21	0	0
15	39296730	.	G	A	4	9	13	0	1	14	0	0
15	39297051	.	G	A	15	8	23	0	1	24	0	0
15	39297081	.	A	G	9	9	18	0	2	20	0	0
15	39305598	.	G	A	4	7	11	0	0	11	0	0
15	39312461	.	G	A	4	3	7	0	0	7	0	0
15	39326986	.	C	T	6	4	10	0	1	11	0	0
15	39339460	.	T	A	2	2	4	0	0	5	1	0
15	39339511	.	C	G	0	2	2	0	2	4	0	0
15	39342891	.	C	T	2	2	4	0	0	4	0	0
15	39345641	.	G	A	3	2	5	0	0	5	0	0
15	39354726	.	G	A	1	2	3	0	0	3	0	0
15	39368871	.	T	G	1	3	4	0	0	4	0	0
15	39967275	.	G	A	32	36	68	0	2	70	0	0
15	39969923	.	T	G	36	28	64	0	1	65	0	0
15	39977542	.	T	C	5	2	7	0	0	7	0	0
15	39986125	.	C	A	7	5	12	0	0	12	0	0
15	39987655	.	C	T	6	7	13	0	1	14	0	0
15	39987691	.	T	C	10	6	16	0	0	16	0	0
15	39992053	.	C	T	5	3	8	0	0	8	0	0
15	40000966	.	C	A	7	9	16	0	1	17	0	0
15	40000981	.	A	T	5	10	15	0	1	16	0	0
15	40002242	.	C	T	5	14	19	0	1	20	0	0
15	40002319	.	C	T	12	8	20	0	2	22	0	0
15	40002325	.	C	T	10	11	21	0	1	22	0	0
15	40002534	.	A	T	3	5	8	0	0	8	0	0
15	40004820	.	G	A	3	6	9	0	0	9	0	0
15	40005279	.	C	T	1	3	4	0	0	4	0	0
15	40005297	.	A	C	4	2	6	0	0	6	0	0
15	40005318	.	T	A	5	5	10	0	1	11	0	0
15	40005466	.	C	T	6	18	24	0	1	25	0	0
15	40005545	.	T	C	12	8	20	0	1	21	0	0
15	40006090	.	A	C	16	10	26	0	0	26	0	0
15	40008449	.	C	T	12	19	31	0	0	31	0	0
15	40008498	.	C	T	18	13	31	0	1	32	0	0
15	40008544	.	C	A	22	25	47	0	0	47	0	0
15	40018239	.	G	A	5	21	26	0	31	57	0	0
15	40018290	.	C	T	32	23	55	0	1	56	0	0
15	40027138	.	C	T	33	34	67	0	4	71	0	0
15	40027279	.	T	C	53	31	84	0	0	84	0	0
15	40027484	.	T	G	20	0	20	0	36	56	0	0
15	40027540	.	A	C	35	22	57	0	3	60	0	0
15	40027717	.	A	G	30	21	51	0	2	53	0	0
15	40028457	.	T	G	40	27	67	0	3	70	0	0
15	40028568	.	G	A	39	22	61	0	5	66	0	0
15	40028574	.	A	G	35	28	63	0	5	68	0	0
15	40091068	.	C	T	6	4	10	0	0	10	0	0
15	40099812	.	C	T	8	3	11	0	1	12	0	0
15	40099844	.	T	C	10	5	15	0	0	15	0	0
15	40104028	.	T	C	5	6	11	0	1	12	0	0
15	40108886	.	T	C	13	13	26	0	1	27	0	0
15	40108898	.	C	T	9	14	23	0	1	24	0	0
15	40115610	.	A	T	6	13	19	0	2	21	0	0
15	40115676	.	C	T	12	12	24	0	0	24	0	0
15	40122221	.	A	G	8	15	23	0	1	24	0	0
15	40122625	.	G	A	5	13	18	0	1	19	0	0
15	40126698	.	A	G	15	0	15	0	16	31	0	0
15	40128979	.	C	G	12	22	34	0	1	35	0	0
15	40129543	.	G	C	22	11	33	0	3	36	0	0
15	40129594	.	T	G	22	15	37	0	1	38	0	0
15	40129604	.	A	T	17	14	31	0	6	37	0	0
15	40129810	.	A	C	10	16	26	0	0	26	0	0
15	40130181	.	G	A	1	6	7	0	7	14	0	0
15	40130208	.	G	A	6	5	11	0	0	12	1	0
15	40130631	.	A	G	11	4	15	0	0	15	0	0
15	40130759	.	A	G	2	12	14	0	4	18	0	0
15	40131001	.	G	A	1	4	5	0	8	13	0	0
15	40131060	.	A	G	8	7	15	0	0	15	0	0
15	40131112	.	C	A	11	16	27	0	0	28	1	0
15	40131139	.	T	A	18	18	36	0	0	36	0	0
15	40131157	.	A	G	14	11	25	0	3	28	0	0
15	40131216	.	G	A	12	5	17	0	0	17	0	0
15	40131232	.	C	T	13	5	18	0	0	18	0	0
15	40131276	.	C	G	15	9	24	0	2	26	0	0
15	40131297	.	C	G	18	14	32	0	0	32	0	0
15	40131316	.	C	A	22	8	30	0	1	31	0	0
15	40131363	.	G	T	2	13	15	0	23	38	0	0
15	40131498	.	A	G	12	0	12	0	28	40	0	0
15	40131500	.	A	G	13	28	41	0	0	41	0	0
15	40131547	.	T	C	13	20	33	0	1	34	0	0
15	40131560	.	T	A	13	20	33	0	1	34	0	0
15	40131586	.	C	T	12	21	33	0	4	37	0	0
15	40131619	.	T	C	16	27	43	0	0	43	0	0
15	40131624	.	T	A	16	26	42	0	3	45	0	0
15	40131769	.	T	C	10	14	24	0	1	25	0	0
15	40202354	.	T	G	27	17	44	0	1	45	0	0
15	40202393	.	C	T	24	29	53	0	4	57	0	0
15	40211507	.	T	C	45	12	57	0	1	58	0	0
15	40211591	.	A	C	27	17	44	0	6	50	0	0
15	40211618	.	A	G	31	0	31	0	18	49	0	0
15	40211741	.	C	G	23	30	53	0	0	53	0	0
15	40212022	.	A	T	5	2	7	0	0	7	0	0
15	40217543	.	T	C	1	3	4	0	0	4	0	0
15	40217890	.	T	C	3	2	5	0	0	5	0	0
15	40830376	.	C	T	3	3	6	0	0	6	0	0
15	40830448	.	G	A	1	2	3	0	0	3	0	0
15	40894244	.	A	G	1	0	1	0	4	5	0	0
15	40914244	.	C	T	1	4	5	0	0	5	0	0
15	40914253	.	A	G	1	0	1	0	4	5	0	0
15	40930419	.	G	A	2	5	7	0	0	7	0	0
15	40933339	.	T	C	3	6	9	0	1	10	0	0
15	40933369	.	G	A	0	4	4	0	1	5	0	0
15	40936283	.	A	G	3	1	4	0	1	5	0	0
15	40938072	.	C	T	5	3	8	0	0	8	0	0
15	40938119	.	G	A	5	3	8	0	2	10	0	0
15	40938305	.	C	T	3	4	7	0	0	7	0	0
15	40938498	.	T	C	3	6	9	0	0	9	0	0
15	40941322	.	G	A	3	4	7	0	1	8	0	0
15	40945690	.	T	C	2	3	5	0	0	5	0	0
15	40952226	.	A	G	4	6	10	0	0	10	0	0
15	40962160	.	T	C	4	3	7	0	1	8	0	0
15	40962186	.	C	T	4	2	6	0	0	6	0	0
15	40962280	.	G	C	0	2	2	0	4	6	0	0
15	40988189	.	T	C	9	5	14	0	4	18	0	0
15	40988228	.	C	T	8	6	14	0	1	15	0	0
15	40988565	.	A	G	11	6	17	0	0	17	0	0
15	40988659	.	C	A	2	3	5	0	0	5	0	0
15	40989053	.	T	G	2	3	5	0	0	5	0	0
15	40989320	.	C	G	3	0	3	0	3	6	0	0
15	40989327	.	A	G	3	4	7	0	0	7	0	0
15	40989801	.	A	G	2	0	2	0	6	8	0	0
15	41170289	.	A	G	20	17	37	0	0	37	0	0
15	41170445	.	G	T	17	17	34	0	1	35	0	0
15	41170710	.	G	A	19	13	32	0	0	32	0	0
15	41170992	.	G	A	15	9	24	0	1	25	0	0
15	41171081	.	T	C	20	0	20	0	13	33	0	0
15	41171135	.	A	G	9	15	24	0	0	24	0	0
15	41171335	.	A	T	13	21	34	0	4	38	0	0
15	41171448	.	A	C	23	11	34	0	0	34	0	0
15	41171471	.	G	T	19	10	29	0	3	32	0	0
15	41171516	.	C	A	2	14	16	0	26	42	0	0
15	41172103	.	G	A	8	15	23	0	0	23	0	0
15	41172427	.	T	C	7	8	15	0	0	15	0	0
15	41172649	.	T	A	4	2	6	0	0	6	0	0
15	41172801	.	G	C	5	3	8	0	1	9	0	0
15	41172893	.	A	C	10	6	16	0	0	16	0	0
15	41172904	.	G	C	9	8	17	0	1	18	0	0
15	41173093	.	A	T	12	8	20	0	0	20	0	0
15	41173109	.	C	T	13	6	19	0	0	19	0	0
15	41173142	.	G	A	8	3	11	0	0	11	0	0
15	41173261	.	T	G	9	10	19	0	1	20	0	0
15	41173326	.	C	T	15	19	34	0	1	35	0	0
15	41173620	.	G	A	7	13	20	0	0	20	0	0
15	41768450	.	T	C	3	2	5	0	0	5	0	0
15	41769077	.	T	C	2	3	5	1	0	6	0	0
15	41947772	.	A	T	3	3	6	2	1	9	0	0
15	41948761	.	A	G	3	2	5	0	0	5	0	0
15	42767880	.	G	A	0	3	3	0	1	4	0	0
15	42920208	.	G	A	2	3	5	0	0	5	0	0
15	42920218	.	G	A	0	3	3	0	3	6	0	0
15	42920246	.	T	G	0	3	3	0	0	3	0	0
15	42920257	.	G	A	3	2	5	0	1	6	0	0
15	42933283	.	C	T	2	2	4	0	0	4	0	0
15	42947700	.	C	A	2	2	4	0	0	4	0	0
15	42958701	.	C	T	3	2	5	0	0	5	0	0
15	42976197	.	C	G	4	6	10	0	1	11	0	0
15	42976368	.	C	T	4	3	7	0	0	7	0	0
15	42976371	.	C	A	4	2	6	0	1	7	0	0
15	42981069	.	C	T	5	4	9	0	1	10	0	0
15	42981137	.	C	A	5	6	11	0	0	11	0	0
15	42981223	.	A	G	6	9	15	0	2	17	0	0
15	42981281	.	A	T	7	6	13	0	3	16	0	0
15	42981321	.	G	A	3	3	6	0	1	7	0	0
15	43604224	.	G	A	2	2	4	0	0	4	0	0
15	43604903	.	C	G	5	3	8	0	0	8	0	0
15	43604928	.	A	G	4	2	6	0	0	6	0	0
15	43604988	.	G	C	2	6	8	0	0	8	0	0
15	43604996	.	A	G	2	5	7	0	0	7	0	0
15	43605435	.	A	G	5	5	10	0	0	10	0	0
15	43605483	.	C	T	3	5	8	0	3	11	0	0
15	43605503	.	G	C	8	3	11	0	0	11	0	0
15	43605610	.	C	T	6	2	8	0	2	10	0	0
15	43656619	.	C	T	1	3	4	0	0	4	0	0
15	43663061	.	C	T	1	2	3	0	1	4	0	0
15	43931161	.	C	T	1	3	4	0	1	5	0	0
15	43931233	.	G	A	1	8	9	0	0	9	0	0
15	43966993	.	C	T	3	2	5	0	0	5	0	0
15	43982517	.	T	C	2	3	5	0	0	5	0	0
15	43988698	.	T	A	0	2	2	0	0	2	0	0
15	43988716	.	C	T	1	2	3	0	0	3	0	0
15	43988767	.	G	T	3	2	5	0	0	5	0	0
15	44072776	.	T	C	4	0	4	2	13	19	0	0
15	44072782	.	G	A	13	6	19	2	0	21	0	0
15	44074653	.	A	G	4	6	10	0	2	12	0	0
15	44075125	.	C	T	0	6	6	0	9	15	0	0
15	44077766	.	A	T	7	10	17	0	0	17	0	0
15	44140324	.	T	G	3	0	3	0	2	5	0	0
15	44140360	.	G	A	2	3	5	0	1	6	0	0
15	44140458	.	G	A	1	4	5	0	2	7	0	0
15	44140666	.	C	T	3	2	5	0	0	5	0	0
15	44140780	.	A	G	3	5	8	0	0	8	0	0
15	44140991	.	T	C	5	5	10	0	0	10	0	0
15	44141644	.	A	C	4	5	9	0	0	9	0	0
15	44209147	.	T	G	3	2	5	0	0	5	0	0
15	44254986	.	A	C	3	7	10	0	0	10	0	0
15	44255001	.	G	A	2	7	9	0	0	9	0	0
15	44255130	.	A	T	5	8	13	0	0	13	0	0
15	44255212	.	A	C	4	3	7	0	0	7	0	0
15	44255438	.	A	G	3	0	3	0	3	6	0	0
15	44274343	.	A	G	3	2	5	0	0	5	0	0
15	44274353	.	A	G	3	1	4	0	1	5	0	0
15	44290546	.	C	T	4	2	6	0	0	6	0	0
15	44295044	.	G	A	2	4	6	0	0	6	0	0
15	44323349	.	T	C	6	5	11	0	0	11	0	0
15	44323436	.	G	A	2	3	5	0	7	12	0	0
15	44323442	.	G	A	7	3	10	0	0	10	0	0
15	44336923	.	A	T	7	4	11	0	1	12	0	0
15	44340093	.	C	T	2	2	4	0	0	4	0	0
15	44344283	.	G	A	0	2	2	0	3	5	0	0
15	44345243	.	T	A	2	5	7	0	1	8	0	0
15	44370890	.	C	A	5	3	8	0	0	8	0	0
15	44371058	.	T	C	13	4	17	0	0	17	0	0
15	44371076	.	C	T	3	11	14	0	1	15	0	0
15	44371129	.	C	T	10	7	17	0	0	17	0	0
15	44371289	.	C	T	5	4	9	0	0	9	0	0
15	44371484	.	T	C	5	6	11	0	0	11	0	0
15	44384695	.	A	G	0	8	8	0	0	8	0	0
15	44384728	.	C	T	7	5	12	0	0	12	0	0
15	44440314	.	G	T	2	3	5	0	0	5	0	0
15	44440352	.	G	A	4	4	8	0	1	9	0	0
15	44465628	.	T	C	4	2	6	0	0	6	0	0
15	44499653	.	T	A	16	21	37	0	2	40	1	0
15	44530288	.	T	C	6	0	6	0	14	20	0	0
15	44534976	.	G	A	9	8	17	0	1	18	0	0
15	44559576	.	C	G	6	13	19	0	1	20	0	0
15	44559636	.	T	C	10	0	10	0	8	18	0	0
15	44559646	.	T	A	8	5	13	0	0	13	0	0
15	44559749	.	A	G	6	4	10	0	0	10	0	0
15	44560414	.	T	G	15	6	21	0	0	21	0	0
15	44565727	.	T	A	12	10	22	0	0	22	0	0
15	44625286	.	G	A	2	3	5	0	0	5	0	0
15	44646664	.	G	A	11	11	22	0	1	23	0	0
15	44646676	.	T	C	10	10	20	0	0	20	0	0
15	44647485	.	A	G	6	4	10	0	0	10	0	0
15	44660651	.	C	T	3	3	6	0	1	7	0	0
15	44663021	.	G	A	6	5	11	0	0	11	0	0
15	44676968	.	G	A	3	6	9	0	2	11	0	0
15	44714650	.	A	G	4	2	6	0	0	6	0	0
15	44721553	.	G	A	3	2	5	0	0	5	0	0
15	44721559	.	G	A	3	2	5	0	0	5	0	0
15	44755886	.	C	T	2	5	7	0	3	10	0	0
15	45090360	.	C	A	3	2	5	0	1	6	0	0
15	45118611	.	G	A	3	2	5	0	0	5	0	0
15	45118674	.	A	C	1	0	1	0	2	3	0	0
15	45122487	.	T	G	2	2	4	0	0	4	0	0
15	45133393	.	C	T	1	2	3	0	0	3	0	0
15	45418610	.	G	A	20	13	33	0	2	35	0	0
15	45510169	.	T	A	15	13	28	0	6	35	1	0
15	45527282	.	C	T	1	2	3	0	0	3	0	0
15	45544630	.	T	C	5	7	12	0	1	13	0	0
15	45544687	.	C	T	5	6	11	0	2	13	0	0
15	45555001	.	G	A	0	3	3	0	5	8	0	0
15	45555208	.	A	T	5	12	17	0	1	18	0	0
15	45591739	.	G	C	11	5	16	0	1	17	0	0
15	45591753	.	C	G	11	5	16	0	1	17	0	0
15	45595456	.	A	T	8	9	17	0	1	18	0	0
15	45602730	.	T	C	10	7	17	0	0	17	0	0
15	45602878	.	G	A	11	8	19	0	1	20	0	0
15	45607352	.	G	A	3	5	8	0	0	8	0	0
15	45612497	.	G	A	0	5	5	0	10	15	0	0
15	45621750	.	C	T	6	5	11	0	0	11	0	0
15	45628074	.	G	A	6	9	15	0	0	15	0	0
15	45634793	.	G	A	21	18	39	0	1	40	0	0
15	45634864	.	T	G	14	12	26	0	3	29	0	0
15	45634865	.	C	T	16	10	26	0	3	29	0	0
15	45634995	.	T	C	8	4	12	0	2	14	0	0
15	45635375	.	A	G	1	4	5	0	0	5	0	0
15	45635848	.	C	T	9	10	19	0	0	19	0	0
15	45635952	.	T	C	6	6	12	0	0	12	0	0
15	45635999	.	G	A	6	12	18	0	0	18	0	0
15	45636160	.	C	A	2	2	4	0	1	5	0	0
15	45636504	.	G	T	9	3	12	0	0	12	0	0
15	45637224	.	A	G	17	17	34	0	1	35	0	0
15	45637406	.	C	T	3	2	5	0	1	6	0	0
15	45994139	.	G	T	2	5	7	0	0	7	0	0
15	45994177	.	C	T	4	5	9	0	0	9	0	0
15	46034372	.	T	C	1	6	7	0	0	7	0	0
15	46108696	.	T	C	9	5	14	0	0	14	0	0
15	46108922	.	A	G	9	0	9	0	8	17	0	0
15	46111047	.	T	A	10	6	16	0	1	17	0	0
15	46111152	.	A	G	10	0	10	0	5	15	0	0
15	46111254	.	A	G	9	3	12	0	0	12	0	0
15	46111410	.	A	G	5	3	8	0	0	8	0	0
15	46116133	.	G	A	8	9	17	0	1	18	0	0
15	46116136	.	T	G	7	0	7	0	10	17	0	0
15	46116352	.	A	G	4	13	17	0	2	19	0	0
15	46643768	.	T	C	14	18	32	0	3	35	0	0
15	46649525	.	A	G	10	21	31	0	3	34	0	0
15	46652124	.	A	G	9	9	18	0	0	18	0	0
15	46662011	.	G	T	18	7	25	2	3	31	1	0
15	46662143	.	C	T	10	10	20	0	1	21	0	0
15	46662353	.	T	C	9	12	21	0	1	22	0	0
15	46666181	.	T	C	5	1	6	1	7	14	0	0
15	46668250	.	T	A	8	11	19	0	2	21	0	0
15	46687210	.	G	A	5	6	11	0	0	11	0	0
15	46687234	.	T	C	3	0	3	0	10	13	0	0
15	46687290	.	A	C	2	6	8	0	0	8	0	0
15	46687341	.	T	G	3	6	9	0	0	9	0	0
15	46687586	.	A	G	5	3	8	0	1	9	0	0
15	46691237	.	A	G	3	3	6	0	0	6	0	0
15	46699268	.	G	A	1	5	6	0	0	6	0	0
15	46704595	.	T	C	1	3	4	0	0	4	0	0
15	46722651	.	G	A	3	3	6	0	1	7	0	0
15	46726371	.	T	C	5	8	13	0	1	14	0	0
15	46727382	.	G	A	6	2	8	0	0	8	0	0
15	47063594	.	C	T	3	1	4	0	1	5	0	0
15	47083980	.	G	A	0	2	2	0	2	4	0	0
15	47100599	.	C	T	1	4	5	0	4	9	0	0
15	47107256	.	A	G	6	5	11	0	0	11	0	0
15	47113654	.	T	G	3	6	9	0	1	10	0	0
15	47336295	.	G	A	15	13	28	0	2	30	0	0
15	47338768	.	C	A	1	3	4	0	0	4	0	0
15	47386982	.	T	A	11	13	24	2	2	28	0	0
15	47418607	.	G	A	2	16	18	0	8	26	0	0
15	47418627	.	G	A	12	14	26	0	3	29	0	0
15	47419090	.	G	A	2	15	17	0	19	36	0	0
15	47419096	.	C	T	14	24	38	0	0	38	0	0
15	47419240	.	C	T	24	17	41	0	3	44	0	0
15	47419394	.	C	T	18	15	33	0	1	34	0	0
15	47419395	.	A	T	19	15	34	0	0	34	0	0
15	47420838	.	T	A	29	25	54	0	3	57	0	0
15	47420920	.	G	C	2	32	34	2	1	37	0	0
15	47421203	.	T	C	16	13	29	0	0	29	0	0
15	47421329	.	A	G	13	13	26	1	0	27	0	0
15	47421669	.	C	T	9	21	30	0	1	31	0	0
15	47421675	.	G	C	21	9	30	0	0	30	0	0
15	47448596	.	G	C	3	4	7	1	0	8	0	0
15	47448720	.	T	G	1	7	8	0	1	9	0	0
15	47448721	.	T	A	1	6	7	0	2	9	0	0
15	47774375	.	T	G	15	0	15	0	16	31	0	0
15	47830665	.	C	T	2	2	4	0	0	4	0	0
15	47830783	.	C	T	6	2	8	0	0	8	0	0
15	47830837	.	G	T	5	4	9	1	2	12	0	0
15	47830973	.	C	A	9	6	15	0	0	15	0	0
15	47831096	.	C	T	7	14	21	0	3	24	0	0
15	47831195	.	G	C	11	11	22	0	0	22	0	0
15	47831249	.	C	T	8	6	14	0	0	14	0	0
15	47831265	.	T	A	6	7	13	0	0	13	0	0
15	47831495	.	C	G	15	11	26	0	0	26	0	0
15	47831511	.	C	T	1	12	13	0	14	27	0	0
15	47831565	.	C	A	14	13	27	0	0	27	0	0
15	47831869	.	G	A	3	10	13	0	0	13	0	0
15	47831899	.	A	G	2	7	9	0	0	9	0	0
15	47831983	.	G	A	1	3	4	0	1	5	0	0
15	47831992	.	A	T	2	3	5	0	0	5	0	0
15	47832424	.	T	G	2	2	4	0	0	4	0	0
15	47832930	.	C	T	11	3	14	2	1	17	0	0
15	47832931	.	C	T	2	4	6	2	9	17	0	0
15	47833083	.	G	A	7	9	16	3	1	20	0	0
15	47833392	.	G	A	12	5	17	0	1	18	0	0
15	47833395	.	C	T	2	5	7	0	11	18	0	0
15	47833436	.	C	T	1	3	4	0	8	12	0	0
15	47833493	.	C	T	0	3	3	0	6	9	0	0
15	47833662	.	C	T	6	3	9	0	0	9	0	0
15	47833814	.	C	T	2	6	8	0	0	8	0	0
15	47834202	.	T	C	10	0	10	0	6	16	0	0
15	47834327	.	C	G	7	3	10	0	0	10	0	0
15	47834487	.	C	T	0	7	7	0	5	12	0	0
15	47834559	.	G	A	2	5	7	0	0	7	0	0
15	47845404	.	G	T	7	2	9	0	0	9	0	0
15	47845908	.	A	G	19	19	38	0	0	38	0	0
15	47847180	.	T	C	12	0	12	0	20	32	0	0
15	47847373	.	G	A	20	20	40	0	0	40	0	0
15	47848495	.	C	T	21	15	36	0	2	38	0	0
15	47851205	.	T	A	29	27	56	0	0	56	0	0
15	47851342	.	C	G	48	18	66	1	2	69	0	0
15	47851455	.	T	G	35	29	64	0	0	64	0	0
15	47851486	.	G	A	33	26	59	0	3	62	0	0
15	47851522	.	C	T	2	29	31	0	31	62	0	0
15	47851751	.	A	G	33	16	49	0	3	52	0	0
15	47851828	.	G	A	20	18	38	0	2	40	0	0
15	47852049	.	G	T	10	11	21	0	3	24	0	0
15	47855085	.	A	G	36	19	55	1	2	58	0	0
15	47855169	.	G	A	42	13	55	3	0	58	0	0
15	47856351	.	T	C	26	1	27	14	9	50	0	0
15	47856418	.	T	C	45	23	68	2	4	74	0	0
15	47860443	.	C	T	1	15	16	0	14	30	0	0
16	50458	.	C	A	6	3	9	0	0	9	0	0
16	51458	.	C	T	7	11	18	0	0	18	0	0
16	68254	.	A	G	6	7	13	0	1	14	0	0
16	68355	.	T	C	6	11	17	1	0	18	0	0
16	68356	.	C	T	6	10	16	1	1	18	0	0
16	68404	.	A	G	6	10	16	0	1	17	0	0
16	68477	.	G	A	1	8	9	0	5	14	0	0
16	68513	.	G	C	1	5	6	0	9	15	0	0
16	68635	.	A	G	5	4	9	0	0	9	0	0
16	68812	.	A	G	12	5	17	0	1	18	0	0
16	68854	.	T	C	9	11	20	0	2	22	0	0
16	69005	.	T	A	18	5	23	0	3	26	0	0
16	69428	.	A	C	9	9	18	0	1	19	0	0
16	70697	.	T	C	14	9	23	0	1	24	0	0
16	70839	.	A	G	8	0	8	0	12	20	0	0
16	70881	.	A	G	5	4	9	0	5	14	0	0
16	162767	.	T	C	0	2	2	0	1	3	0	0
16	221747	.	G	A	32	29	61	0	1	62	0	0
16	221828	.	C	T	20	26	46	0	1	47	0	0
16	224707	.	A	G	26	26	52	0	1	53	0	0
16	224734	.	C	G	22	25	47	0	2	49	0	0
16	224743	.	C	A	20	28	48	0	3	51	0	0
16	224837	.	A	C	31	21	52	1	1	54	0	0
16	224886	.	G	A	2	21	23	0	35	58	0	0
16	224974	.	A	T	32	22	54	0	1	55	0	0
16	225005	.	T	C	31	28	59	0	2	61	0	0
16	225304	.	C	A	25	25	50	0	3	53	0	0
16	225564	.	T	C	29	24	53	0	1	54	0	0
16	225615	.	A	G	24	28	52	0	2	54	0	0
16	225660	.	C	G	27	23	50	0	1	52	1	0
16	225998	.	G	A	26	21	47	0	4	51	0	0
16	226027	.	T	A	31	18	49	0	2	51	0	0
16	226141	.	A	G	15	1	16	0	22	38	0	0
16	226177	.	A	G	22	21	43	0	2	45	0	0
16	226361	.	C	G	25	21	46	0	2	48	0	0
16	226374	.	T	A	27	23	50	0	1	51	0	0
16	226526	.	A	G	10	17	27	0	0	27	0	0
16	227797	.	T	C	5	1	6	0	4	10	0	0
16	250422	.	T	A	10	8	18	0	1	19	0	0
16	257920	.	G	A	1	2	3	0	0	3	0	0
16	257961	.	A	T	3	3	6	0	0	6	0	0
16	277917	.	T	C	10	0	10	0	9	19	0	0
16	277949	.	G	T	13	6	19	0	2	21	0	0
16	278750	.	C	T	2	8	10	0	7	17	0	0
16	278978	.	A	G	6	7	13	0	0	13	0	0
16	280286	.	T	A	8	4	12	0	0	12	0	0
16	559050	.	T	A	2	7	9	0	2	11	0	0
16	560755	.	G	A	5	4	9	0	3	12	0	0
16	1884215	.	C	T	3	2	5	0	0	5	0	0
16	1884218	.	C	T	3	2	5	0	0	5	0	0
16	1906682	.	C	A	7	4	11	0	0	11	0	0
16	1996533	.	A	G	2	4	6	0	0	6	0	0
16	1996569	.	A	C	3	4	7	0	0	7	0	0
16	1996577	.	C	T	4	3	7	0	0	7	0	0
16	2009844	.	T	G	4	6	10	0	0	10	0	0
16	2033947	.	A	G	2	0	2	0	7	9	0	0
16	2043021	.	C	T	14	8	22	0	0	22	0	0
16	2043122	.	G	C	1	11	12	0	13	25	0	0
16	2071535	.	G	A	1	7	8	0	7	15	0	0
16	2103052	.	C	T	13	3	16	0	0	16	0	0
16	2103058	.	G	T	12	3	15	0	1	16	0	0
16	2103167	.	C	T	9	9	18	0	1	19	0	0
16	2103209	.	C	T	10	12	22	0	0	22	0	0
16	2103241	.	T	A	8	10	18	0	0	18	0	0
16	2103268	.	A	T	7	11	18	0	0	18	0	0
16	2103307	.	T	C	14	6	20	0	1	21	0	0
16	2103714	.	A	T	2	6	8	0	3	11	0	0
16	2103783	.	A	T	2	4	6	0	0	6	0	0
16	2104114	.	T	A	2	2	4	0	0	4	0	0
16	2104312	.	A	C	7	15	22	0	0	22	0	0
16	2104400	.	T	C	14	7	21	0	2	23	0	0
16	2104597	.	T	C	26	18	44	0	3	47	0	0
16	2104604	.	A	G	26	0	26	0	22	48	0	0
16	2105035	.	A	G	6	3	9	0	1	10	0	0
16	2353020	.	C	A	3	3	6	0	1	7	0	0
16	2353023	.	T	C	4	2	6	0	1	7	0	0
16	2353191	.	C	A	7	6	13	0	0	13	0	0
16	2360324	.	C	T	5	3	8	0	0	8	0	0
16	2368422	.	T	C	7	0	7	0	3	10	0	0
16	2380596	.	T	G	1	2	3	0	0	3	0	0
16	2382011	.	G	T	1	2	3	0	0	3	0	0
16	2388306	.	T	A	3	5	8	0	0	8	0	0
16	2388309	.	A	T	3	5	8	0	0	8	0	0
16	2472263	.	G	A	11	9	20	0	0	20	0	0
16	2472284	.	T	C	12	9	21	0	2	23	0	0
16	2484064	.	C	T	1	14	15	0	11	26	0	0
16	2485904	.	G	A	12	13	25	0	0	25	0	0
16	2494323	.	T	C	12	0	12	0	8	20	0	0
16	2495649	.	G	C	3	5	8	0	0	8	0	0
16	2517184	.	G	T	8	7	15	0	0	15	0	0
16	2519056	.	T	C	10	8	18	0	1	19	0	0
16	2519071	.	T	C	9	5	14	0	1	15	0	0
16	2525891	.	A	G	4	4	8	0	0	8	0	0
16	2526035	.	C	T	9	4	13	0	1	14	0	0
16	2528209	.	A	G	7	5	12	0	1	13	0	0
16	2539405	.	G	A	3	2	5	0	0	5	0	0
16	2540235	.	G	A	2	4	6	0	0	6	0	0
16	2542782	.	G	C	7	7	14	0	0	14	0	0
16	2544487	.	G	T	6	7	13	0	0	13	0	0
16	2544505	.	A	G	7	6	13	0	0	13	0	0
16	2545290	.	C	T	2	4	6	0	0	6	0	0
16	2557990	.	A	G	2	4	6	0	0	6	0	0
16	2558252	.	G	C	2	5	7	0	0	7	0	0
16	2558549	.	G	A	2	2	4	0	0	4	0	0
16	2567316	.	A	G	8	0	8	0	11	19	0	0
16	2568847	.	G	A	0	12	12	0	16	28	0	0
16	2574963	.	C	T	8	8	16	0	2	18	0	0
16	2577717	.	T	A	13	9	22	0	0	22	0	0
16	2580255	.	T	A	11	9	20	0	2	22	0	0
16	2580340	.	G	A	3	3	6	0	1	7	0	0
16	2637673	.	T	C	1	0	1	0	4	5	0	0
16	2637703	.	C	A	1	3	4	0	0	4	0	0
16	2638472	.	A	C	1	2	3	0	0	3	0	0
16	2638507	.	G	C	1	2	3	0	0	3	0	0
16	2640406	.	G	A	2	2	4	0	1	5	0	0
16	2647737	.	A	T	1	2	3	0	0	3	0	0
16	4115237	.	A	G	2	3	5	0	0	5	0	0
16	4117843	.	A	G	6	4	10	0	1	11	0	0
16	4119048	.	C	T	3	6	9	0	0	9	0	0
16	4126903	.	C	A	5	3	8	0	1	9	0	0
16	4138698	.	G	A	1	3	4	0	0	4	0	0
16	4163450	.	A	C	4	4	8	0	0	8	0	0
16	4163503	.	C	T	4	2	6	0	0	6	0	0
16	4163705	.	C	T	3	4	7	0	0	7	0	0
16	4185521	.	T	C	2	2	4	0	0	4	0	0
16	4189867	.	G	A	0	2	2	0	1	3	0	0
16	4190052	.	A	T	2	4	6	0	0	6	0	0
16	4190091	.	T	A	4	4	8	0	1	9	0	0
16	4190094	.	C	A	4	4	8	0	0	8	0	0
16	4197130	.	T	A	5	7	12	0	1	13	0	0
16	4202038	.	C	T	6	12	18	0	0	18	0	0
16	4202081	.	T	C	6	14	20	0	1	21	0	0
16	4287757	.	C	G	3	2	5	0	0	5	0	0
16	4287936	.	C	T	0	4	4	0	6	10	0	0
16	4289022	.	A	T	7	4	11	0	0	11	0	0
16	4309183	.	A	G	7	2	9	0	0	9	0	0
16	4309192	.	T	G	6	2	8	0	0	8	0	0
16	4317343	.	A	T	2	4	6	0	1	7	0	0
16	4317534	.	T	A	3	3	6	0	0	6	0	0
16	4317799	.	T	A	3	5	8	0	0	8	0	0
16	4513775	.	A	G	3	3	6	0	0	6	0	0
16	4513876	.	A	T	6	8	14	0	0	14	0	0
16	4513901	.	T	C	7	6	13	0	0	13	0	0
16	4513920	.	C	G	8	5	13	0	0	13	0	0
16	4514114	.	T	C	7	0	7	0	5	12	0	0
16	4514353	.	T	C	4	0	4	0	4	8	0	0
16	4514439	.	G	A	2	3	5	0	3	8	0	0
16	4514467	.	A	T	4	5	9	0	1	10	0	0
16	4514592	.	A	C	8	7	15	0	0	15	0	0
16	4514594	.	T	A	7	7	14	0	1	15	0	0
16	4514633	.	T	C	12	7	19	0	0	19	0	0
16	4514666	.	T	C	10	0	10	0	5	15	0	0
16	4514795	.	T	C	4	2	6	0	0	6	0	0
16	4515614	.	G	T	1	3	4	0	0	4	0	0
16	4515660	.	C	T	0	2	2	0	4	6	0	0
16	4515665	.	G	A	3	2	5	0	1	6	0	0
16	4517354	.	A	T	2	2	4	0	0	4	0	0
16	4517606	.	A	G	7	6	13	0	0	13	0	0
16	4517704	.	C	T	8	4	12	0	0	12	0	0
16	4531827	.	A	G	4	7	11	0	0	11	0	0
16	4533768	.	T	C	11	9	20	0	2	22	0	0
16	4538422	.	A	G	15	9	24	0	1	25	0	0
16	4540805	.	G	T	15	13	28	1	4	33	0	0
16	4540864	.	G	C	4	3	7	0	0	7	0	0
16	4541022	.	A	C	8	5	13	0	1	14	0	0
16	4541061	.	T	G	6	8	14	0	0	14	0	0
16	4541085	.	T	C	11	4	15	0	1	16	0	0
16	4541167	.	A	C	7	2	9	5	0	15	1	0
16	4541171	.	G	A	5	2	7	5	2	14	0	0
16	4541233	.	T	C	14	12	26	0	0	26	0	0
16	4541250	.	C	T	12	13	25	0	0	26	1	0
16	4541281	.	A	T	8	10	18	0	1	19	0	0
16	4541931	.	A	C	9	4	13	0	1	14	0	0
16	4541936	.	G	C	8	5	13	0	1	14	0	0
16	4542377	.	C	G	5	4	9	0	1	10	0	0
16	4542518	.	C	T	1	17	18	1	14	33	0	0
16	4545454	.	T	C	8	13	21	1	2	24	0	0
16	4546606	.	A	C	8	0	8	0	11	19	0	0
16	4546651	.	G	A	3	8	11	0	0	11	0	0
16	4573450	.	G	T	5	5	10	0	0	10	0	0
16	4573458	.	C	T	5	6	11	0	0	11	0	0
16	4573556	.	A	T	2	5	7	0	0	7	0	0
16	4573588	.	A	G	3	4	7	0	1	8	0	0
16	4587184	.	C	T	2	4	6	1	1	8	0	0
16	4587187	.	G	A	2	5	7	1	0	8	0	0
16	4594818	.	A	G	2	3	5	0	0	5	0	0
16	4615993	.	C	A	3	6	9	0	0	9	0	0
16	4616071	.	A	T	5	7	12	0	0	12	0	0
16	4619598	.	A	T	6	13	19	0	2	21	0	0
16	4619614	.	A	G	5	13	18	0	0	18	0	0
16	4695172	.	G	C	1	4	5	0	8	13	0	0
16	4695323	.	A	C	4	2	6	0	0	6	0	0
16	4695368	.	T	A	2	3	5	0	1	6	0	0
16	4695530	.	A	G	3	5	8	0	1	9	0	0
16	4697599	.	A	G	3	1	4	0	5	9	0	0
16	4697713	.	A	G	5	1	6	0	6	12	0	0
16	4697821	.	G	A	6	5	11	0	0	11	0	0
16	4697829	.	C	G	6	4	10	0	0	10	0	0
16	4700766	.	T	C	9	7	16	0	0	16	0	0
16	4707211	.	G	T	2	5	7	0	7	14	0	0
16	4707480	.	G	A	3	4	7	0	0	7	0	0
16	4707544	.	G	A	5	2	7	0	0	7	0	0
16	4711553	.	T	C	1	3	4	0	0	4	0	0
16	4711613	.	G	A	1	4	5	0	0	5	0	0
16	4711616	.	T	C	1	0	1	0	5	6	0	0
16	4755816	.	A	T	6	5	11	0	2	13	0	0
16	4759113	.	G	A	3	6	9	0	0	9	0	0
16	4761133	.	T	C	9	0	9	0	4	13	0	0
16	4772837	.	G	A	0	3	3	0	2	5	0	0
16	4782335	.	C	T	2	3	5	0	0	5	0	0
16	4784020	.	T	C	2	5	7	0	0	7	0	0
16	4835778	.	C	G	1	2	3	0	0	3	0	0
16	4842203	.	T	A	8	5	13	0	0	13	0	0
16	4842308	.	A	G	3	2	5	0	0	5	0	0
16	4858456	.	T	C	4	3	7	0	0	7	0	0
16	4861083	.	T	C	7	14	21	0	0	21	0	0
16	4864771	.	G	A	2	6	8	0	1	9	0	0
16	4867445	.	C	T	11	7	18	0	1	19	0	0
16	4867487	.	C	T	10	10	20	0	2	23	1	0
16	4867496	.	A	G	13	13	26	0	0	26	0	0
16	4869973	.	G	A	7	9	16	0	0	16	0	0
16	4870180	.	C	T	7	8	15	0	1	16	0	0
16	4872260	.	C	T	6	7	13	0	0	13	0	0
16	4872320	.	G	A	5	4	9	0	1	10	0	0
16	4872453	.	C	T	5	7	12	0	0	12	0	0
16	4875198	.	A	G	5	4	9	0	1	10	0	0
16	4882945	.	G	A	11	5	16	0	1	17	0	0
16	4885458	.	T	A	14	8	22	0	2	24	0	0
16	4895423	.	T	C	14	14	28	0	1	29	0	0
16	5086725	.	G	A	9	9	18	0	3	21	0	0
16	5091076	.	G	A	5	6	11	0	0	11	0	0
16	5105119	.	T	G	6	12	18	0	0	18	0	0
16	5145459	.	T	C	13	10	23	0	2	25	0	0
16	5145599	.	C	A	14	21	35	0	0	35	0	0
16	5145622	.	G	A	19	19	38	0	1	39	0	0
16	5149298	.	T	C	16	14	30	0	1	31	0	0
16	5153956	.	T	C	20	11	31	0	0	31	0	0
16	5153996	.	T	G	8	3	11	0	0	11	0	0
16	5156563	.	G	A	2	8	10	0	6	16	0	0
16	5159283	.	A	G	5	6	11	0	2	13	0	0
16	5159289	.	C	T	5	7	12	0	1	13	0	0
16	5159328	.	T	C	4	8	12	0	1	13	0	0
16	5163275	.	T	C	5	3	8	0	0	8	0	0
16	5164569	.	C	T	11	8	19	0	0	19	0	0
16	5166015	.	G	A	2	15	17	0	12	29	0	0
16	5166030	.	C	T	12	16	28	0	0	28	0	0
16	5166288	.	G	A	20	10	30	0	1	31	0	0
16	5166332	.	T	A	18	16	34	0	1	35	0	0
16	5166351	.	T	C	16	18	34	0	3	37	0	0
16	5166546	.	G	A	16	9	25	0	1	26	0	0
16	5166645	.	A	C	15	18	33	3	0	36	0	0
16	5166719	.	A	G	7	7	14	0	1	15	0	0
16	5166805	.	A	G	15	0	15	0	7	22	0	0
16	5166889	.	G	T	10	11	21	0	1	22	0	0
16	5166977	.	G	T	6	10	16	0	0	16	0	0
16	5167010	.	A	G	5	0	5	0	9	14	0	0
16	5167030	.	G	A	7	7	14	0	0	14	0	0
16	5167050	.	A	G	10	0	10	0	4	14	0	0
16	5167257	.	A	G	8	5	13	0	3	16	0	0
16	5188029	.	A	C	6	8	14	0	0	14	0	0
16	5190168	.	C	T	1	7	8	0	0	8	0	0
16	5190210	.	C	T	3	5	8	0	1	9	0	0
16	5193644	.	G	A	4	4	8	0	0	8	0	0
16	5193682	.	C	T	6	5	11	0	0	11	0	0
16	5196813	.	C	A	5	6	11	0	0	11	0	0
16	5199381	.	C	T	4	5	9	0	0	9	0	0
16	5199399	.	C	T	4	4	8	0	0	8	0	0
16	5199442	.	C	T	4	2	6	0	0	6	0	0
16	5199503	.	C	T	8	6	14	0	1	15	0	0
16	5216548	.	G	A	8	6	14	0	0	14	0	0
16	5221622	.	T	A	9	6	15	0	0	15	0	0
16	5221680	.	A	C	5	4	9	0	0	9	0	0
16	5221888	.	T	C	7	11	18	0	0	18	0	0
16	5223206	.	G	A	13	11	24	0	0	24	0	0
16	5223740	.	C	T	3	15	18	0	0	18	0	0
16	5223880	.	G	C	1	11	12	0	13	25	0	0
16	5224375	.	G	C	1	22	23	0	16	39	0	0
16	5224429	.	A	T	14	24	38	0	1	39	0	0
16	5230627	.	G	A	3	14	17	0	8	25	0	0
16	5230782	.	A	T	6	10	16	0	1	17	0	0
16	5496522	.	T	C	5	4	9	0	1	10	0	0
16	5496874	.	C	A	4	4	8	0	0	8	0	0
16	5496904	.	T	G	4	4	8	0	0	8	0	0
16	5601737	.	G	T	1	4	5	0	0	5	0	0
16	5604846	.	T	C	1	2	3	0	0	3	0	0
16	5604865	.	A	G	1	2	3	0	0	3	0	0
16	5604915	.	C	T	1	4	5	0	0	5	0	0
16	5612617	.	A	T	6	6	12	0	0	12	0	0
16	5612631	.	A	T	6	6	12	0	0	12	0	0
16	5623120	.	T	C	1	2	3	0	0	3	0	0
16	5624209	.	C	T	5	2	7	0	1	8	0	0
16	5633503	.	G	C	0	8	8	0	2	10	0	0
16	5687499	.	T	C	4	4	8	0	0	8	0	0
16	5687520	.	G	A	2	3	5	0	1	6	0	0
16	5697039	.	C	T	5	2	7	0	0	7	0	0
16	5700534	.	C	T	5	4	9	0	1	10	0	0
16	5700577	.	T	A	5	5	10	0	2	12	0	0
16	5700578	.	T	C	5	7	12	0	0	12	0	0
16	5702807	.	C	T	3	5	8	0	0	8	0	0
16	5702891	.	T	G	12	4	16	0	0	16	0	0
16	5702906	.	T	C	12	4	16	0	0	16	0	0
16	5710369	.	C	T	2	4	6	0	0	6	0	0
16	5710627	.	G	T	2	3	5	0	0	5	0	0
16	5776274	.	T	C	27	15	42	0	0	42	0	0
16	5776356	.	C	T	18	19	37	0	0	37	0	0
16	5776371	.	T	G	19	17	36	0	1	37	0	0
16	5778882	.	A	G	19	20	39	0	1	40	0	0
16	5778913	.	T	C	20	20	40	0	2	42	0	0
16	5786889	.	C	T	5	3	8	0	1	9	0	0
16	5786890	.	A	G	5	3	8	0	1	9	0	0
16	5786945	.	G	A	8	4	12	0	0	12	0	0
16	5786989	.	C	T	1	5	6	0	12	18	0	0
16	5787185	.	A	T	8	3	11	0	3	14	0	0
16	5787396	.	A	G	7	4	11	0	6	17	0	0
16	5787399	.	T	A	6	9	15	0	3	18	0	0
16	5787435	.	T	C	5	12	17	0	1	18	0	0
16	5787506	.	T	A	9	7	16	0	1	17	0	0
16	5787562	.	G	A	11	6	17	0	1	18	0	0
16	5787671	.	G	C	6	4	10	0	2	12	0	0
16	5787870	.	T	G	5	4	9	0	0	9	0	0
16	5787872	.	A	T	4	4	8	0	1	9	0	0
16	5787931	.	A	G	6	5	11	0	0	11	0	0
16	5787981	.	T	C	10	5	15	0	0	15	0	0
16	5788163	.	T	A	7	3	10	0	0	10	0	0
16	5788405	.	A	T	5	11	16	0	1	17	0	0
16	5788410	.	A	T	6	10	16	0	0	16	0	0
16	5788655	.	T	C	3	7	10	0	0	10	0	0
16	5788705	.	T	C	3	8	11	0	0	11	0	0
16	5788716	.	C	T	0	8	8	0	3	11	0	0
16	5795721	.	C	T	2	8	10	0	3	13	0	0
16	5808802	.	A	G	4	3	7	0	0	7	0	0
16	5808910	.	T	C	4	7	11	0	1	12	0	0
16	5808931	.	G	A	5	5	10	0	0	10	0	0
16	5812703	.	G	A	3	3	6	0	1	7	0	0
16	5819209	.	T	A	2	4	6	0	1	7	0	0
16	5819970	.	T	A	6	3	9	0	0	9	0	0
16	6183022	.	A	C	29	12	41	0	3	44	0	0
16	6183658	.	T	G	37	36	73	0	4	77	0	0
16	6191622	.	C	G	30	33	63	1	2	66	0	0
16	6192811	.	A	G	18	25	43	0	2	45	0	0
16	6197212	.	T	C	27	21	48	0	1	49	0	0
16	6197593	.	G	A	29	22	51	0	1	52	0	0
16	6387037	.	G	A	24	21	45	0	1	46	0	0
16	6387121	.	G	A	25	28	53	0	0	53	0	0
16	6387143	.	A	C	31	2	33	0	28	61	0	0
16	6387157	.	A	C	31	27	58	0	5	63	0	0
16	6395740	.	T	A	2	4	6	0	0	6	0	0
16	6650631	.	C	A	1	3	4	0	0	4	0	0
16	6653587	.	T	A	2	3	5	0	0	5	0	0
16	6653875	.	G	T	2	2	4	0	0	4	0	0
16	6653883	.	A	G	1	2	3	0	0	3	0	0
16	6740784	.	C	T	3	2	5	0	0	5	0	0
16	6742797	.	T	C	2	4	6	0	0	6	0	0
16	6762166	.	A	C	2	2	4	0	0	4	0	0
16	6764962	.	T	C	2	2	4	0	0	4	0	0
16	6769286	.	A	G	1	3	4	0	0	4	0	0
16	6770411	.	A	G	1	0	1	0	4	5	0	0
16	6770455	.	G	A	1	2	3	0	0	3	0	0
16	6771841	.	T	C	2	5	7	0	0	7	0	0
16	6782680	.	T	C	1	4	5	0	0	5	0	0
16	6782896	.	A	T	1	3	4	0	0	4	0	0
16	6784609	.	C	G	3	2	5	0	0	5	0	0
16	6784791	.	T	C	2	2	4	0	0	4	0	0
16	6787491	.	G	A	1	4	5	0	5	10	0	0
16	6793312	.	C	T	9	5	14	0	2	16	0	0
16	6793333	.	C	G	8	5	13	0	0	13	0	0
16	6796096	.	C	T	8	5	13	0	0	13	0	0
16	6796105	.	G	A	2	4	6	0	9	15	0	0
16	6796195	.	A	G	5	3	8	0	0	8	0	0
16	6796279	.	T	C	4	3	7	0	0	7	0	0
16	6800033	.	G	A	5	6	11	0	1	12	0	0
16	6803725	.	T	C	28	18	46	0	0	46	0	0
16	6803736	.	G	C	24	21	45	0	4	49	0	0
16	6803887	.	A	G	24	15	39	0	0	39	0	0
16	6809872	.	A	G	30	13	43	0	1	44	0	0
16	6820725	.	G	A	14	11	25	0	0	25	0	0
16	6821332	.	A	G	11	9	20	0	1	21	0	0
16	6821465	.	C	T	0	10	10	0	10	20	0	0
16	6821995	.	T	C	11	0	11	0	14	25	0	0
16	6849625	.	A	G	2	8	10	0	2	12	0	0
16	6864716	.	T	C	2	2	4	0	0	4	0	0
16	6923646	.	A	T	2	4	6	0	3	9	0	0
16	6923824	.	A	G	8	0	8	0	4	12	0	0
16	6923836	.	A	G	10	4	14	0	0	14	0	0
16	6926751	.	C	T	5	3	8	0	0	8	0	0
16	6929670	.	C	A	7	2	9	0	0	9	0	0
16	6929671	.	A	T	6	2	8	0	1	9	0	0
16	6929812	.	C	T	5	4	9	0	0	9	0	0
16	6929832	.	G	A	5	2	7	0	1	8	0	0
16	6929860	.	G	A	1	2	3	0	0	3	0	0
16	6932384	.	A	T	4	2	6	0	0	6	0	0
16	6932420	.	G	A	5	3	8	0	0	8	0	0
16	6932423	.	C	T	5	3	8	0	0	8	0	0
16	6932477	.	G	A	2	4	6	0	0	6	0	0
16	6932920	.	T	A	2	3	5	0	0	5	0	0
16	6933016	.	T	C	11	3	14	0	1	15	0	0
16	6933037	.	C	G	10	4	14	0	0	14	0	0
16	6933057	.	T	C	10	2	12	0	1	13	0	0
16	6937543	.	T	C	1	0	1	0	2	3	0	0
16	6938038	.	A	T	1	3	4	0	0	4	0	0
16	6938057	.	C	T	0	2	2	0	1	3	0	0
16	6938552	.	G	A	1	3	4	0	0	4	0	0
16	6943985	.	G	T	2	2	4	0	1	5	0	0
16	6944720	.	A	G	2	6	8	0	1	9	0	0
16	6944766	.	T	C	10	14	24	0	0	24	0	0
16	6947998	.	T	C	20	18	38	0	1	39	0	0
16	7376900	.	A	G	6	3	9	0	0	9	0	0
16	7385689	.	C	T	6	4	10	0	0	10	0	0
16	7385705	.	A	G	6	4	10	0	0	10	0	0
16	7385807	.	C	T	7	6	13	0	0	13	0	0
16	7415215	.	G	A	15	10	25	0	1	26	0	0
16	7415254	.	T	A	15	12	27	0	1	28	0	0
16	7415423	.	C	A	14	9	23	0	0	23	0	0
16	7415435	.	G	A	15	6	21	0	0	21	0	0
16	7415542	.	A	T	8	6	14	0	4	18	0	0
16	7415559	.	C	A	9	4	13	0	1	14	0	0
16	7415761	.	G	A	14	13	27	0	1	28	0	0
16	7415793	.	G	A	14	7	21	0	2	23	0	0
16	7416236	.	C	T	10	7	17	0	0	17	0	0
16	7416320	.	C	T	12	7	19	0	1	20	0	0
16	7416352	.	T	A	4	6	10	0	0	11	1	0
16	7626589	.	T	C	17	14	31	0	0	31	0	0
16	7630612	.	T	C	18	17	35	0	0	35	0	0
16	7635527	.	C	T	19	18	37	0	2	39	0	0
16	7635721	.	T	A	19	15	34	0	2	36	0	0
16	7638788	.	T	C	21	10	31	0	1	32	0	0
16	7638815	.	A	T	30	8	38	0	1	39	0	0
16	7638828	.	A	G	27	0	27	0	8	36	1	0
16	7638979	.	C	T	17	21	38	0	1	39	0	0
16	7638984	.	C	A	18	16	34	0	4	38	0	0
16	7639085	.	A	C	16	21	37	0	2	40	1	0
16	7639100	.	T	A	21	22	43	0	3	47	1	0
16	7639125	.	A	G	39	12	51	0	3	54	0	0
16	7639262	.	G	A	3	13	16	3	28	47	0	0
16	7639401	.	A	C	35	20	55	1	3	59	0	0
16	7639527	.	C	T	22	11	33	0	3	36	0	0
16	7639534	.	G	C	2	13	15	2	21	38	0	0
16	7639621	.	C	T	21	19	40	0	1	41	0	0
16	7639643	.	A	T	21	21	42	0	2	44	0	0
16	7639684	.	A	G	18	18	36	0	3	39	0	0
16	7639774	.	T	A	19	11	30	0	1	31	0	0
16	7639856	.	T	C	21	17	38	0	1	39	0	0
16	7640116	.	A	G	17	29	46	0	1	47	0	0
16	7640127	.	G	A	3	26	29	0	16	45	0	0
16	7640390	.	C	T	29	11	40	1	2	43	0	0
16	7640410	.	A	G	26	18	44	1	0	45	0	0
16	7640425	.	T	A	22	25	47	1	2	50	0	0
16	7640757	.	T	A	21	8	29	0	1	31	1	0
16	7640999	.	G	A	1	4	5	0	0	5	0	0
16	7673160	.	A	T	2	2	4	0	0	4	0	0
16	7673175	.	C	G	1	2	3	0	0	3	0	0
16	7705796	.	T	C	3	2	5	0	0	5	0	0
16	7711556	.	C	A	3	5	8	0	0	8	0	0
16	7716184	.	C	G	1	2	3	0	0	3	0	0
16	7725555	.	A	T	3	8	11	0	0	11	0	0
16	7728408	.	C	T	2	7	9	0	0	9	0	0
16	7743398	.	C	T	1	3	4	0	3	7	0	0
16	7743687	.	A	G	3	3	6	0	0	6	0	0
16	7745027	.	C	A	4	4	8	0	0	8	0	0
16	7745053	.	C	G	5	5	10	0	0	10	0	0
16	7745464	.	T	G	2	3	5	0	0	5	0	0
16	7746152	.	A	T	2	5	7	0	1	8	0	0
16	7746153	.	G	A	2	5	7	0	1	8	0	0
16	7746193	.	G	A	3	3	6	0	0	6	0	0
16	7746947	.	G	A	1	2	3	0	0	3	0	0
16	7748211	.	G	A	2	2	4	0	0	4	0	0
16	7758386	.	C	T	2	3	5	0	0	5	0	0
16	7803023	.	T	C	8	8	16	0	0	16	0	0
16	7803298	.	T	C	3	6	9	0	0	9	0	0
16	7803418	.	G	C	4	4	8	0	0	8	0	0
16	7803560	.	A	G	12	7	19	0	1	20	0	0
16	7803627	.	T	A	7	5	12	0	0	12	0	0
16	7803765	.	C	G	7	6	13	0	0	13	0	0
16	7803782	.	C	A	1	7	8	0	5	13	0	0
16	7803825	.	A	T	8	5	13	0	0	13	0	0
16	7803859	.	A	C	6	3	9	0	0	9	0	0
16	7803905	.	G	C	2	0	2	0	4	6	0	0
16	7803923	.	T	A	1	7	8	0	0	8	0	0
16	7803971	.	T	A	5	5	10	0	0	10	0	0
16	7804081	.	T	A	5	2	7	0	0	7	0	0
16	7804269	.	A	T	7	2	9	0	0	9	0	0
16	7804270	.	C	T	7	2	9	0	0	9	0	0
16	7804355	.	C	G	7	3	10	0	0	10	0	0
16	7804458	.	A	C	4	2	6	0	0	6	0	0
16	7804569	.	C	A	1	2	3	0	0	3	0	0
16	7804588	.	C	A	1	3	4	0	0	4	0	0
16	7804914	.	C	T	2	2	4	0	0	4	0	0
16	7804990	.	A	C	2	2	4	0	0	4	0	0
16	7805423	.	C	T	0	6	6	0	6	12	0	0
16	7821241	.	C	T	4	4	8	0	1	9	0	0
16	7821244	.	G	A	5	4	9	0	0	9	0	0
16	7985896	.	T	A	3	4	7	0	0	7	0	0
16	7994808	.	T	G	2	2	4	0	0	4	0	0
16	7999368	.	A	G	2	3	5	0	0	5	0	0
16	7999499	.	C	A	1	1	2	0	2	4	0	0
16	8001064	.	C	A	3	3	6	0	0	6	0	0
16	8040833	.	C	G	5	7	12	0	1	13	0	0
16	8041173	.	G	A	6	5	11	0	0	11	0	0
16	8041179	.	A	G	7	6	13	0	0	13	0	0
16	8041234	.	G	A	0	4	4	0	3	7	0	0
16	8041261	.	T	A	1	2	3	0	0	3	0	0
16	8051941	.	T	C	17	0	17	0	12	29	0	0
16	8052033	.	T	C	7	10	17	0	0	17	0	0
16	8052049	.	G	A	8	10	18	1	0	19	0	0
16	8052145	.	C	A	23	15	38	0	1	39	0	0
16	8052537	.	C	T	13	9	22	0	2	24	0	0
16	8052606	.	T	C	8	0	8	0	13	21	0	0
16	8052651	.	T	C	18	13	31	0	2	33	0	0
16	8052673	.	G	C	20	1	21	0	14	35	0	0
16	8052747	.	A	G	15	6	21	0	1	22	0	0
16	8052831	.	T	A	12	10	22	0	1	23	0	0
16	8052866	.	C	A	1	5	6	4	11	21	0	0
16	8052884	.	T	C	11	4	15	7	0	22	0	0
16	8052909	.	T	A	3	7	10	7	0	17	0	0
16	8052982	.	T	C	5	15	20	1	0	21	0	0
16	8053206	.	T	G	9	9	18	0	0	18	0	0
16	8053403	.	C	T	14	8	22	0	2	24	0	0
16	8053485	.	C	T	11	9	20	0	0	20	0	0
16	8053716	.	A	G	16	12	28	0	2	30	0	0
16	8053717	.	T	C	15	13	28	0	2	30	0	0
16	8054389	.	C	T	1	7	8	0	1	9	0	0
16	8054434	.	T	C	3	0	3	0	12	15	0	0
16	8055037	.	A	G	8	4	12	0	0	12	0	0
16	8059585	.	T	C	6	9	15	0	1	16	0	0
16	8066237	.	A	C	13	7	20	0	1	21	0	0
16	8119672	.	G	A	5	8	13	0	2	15	0	0
16	8120033	.	G	A	8	8	16	0	1	17	0	0
16	8120171	.	C	T	7	8	15	0	0	15	0	0
16	8139585	.	G	A	3	3	6	0	0	6	0	0
16	8160589	.	T	C	1	4	5	0	0	5	0	0
16	8161555	.	C	T	4	5	9	0	1	10	0	0
16	8161573	.	C	A	4	7	11	0	0	11	0	0
16	8161591	.	G	A	2	9	11	0	1	12	0	0
16	8161708	.	G	A	0	5	5	0	6	11	0	0
16	8161875	.	C	T	2	4	6	0	0	6	0	0
16	8162024	.	G	A	0	3	3	0	1	4	0	0
16	8162046	.	G	A	0	2	2	0	1	3	0	0
16	8298607	.	C	T	2	2	4	0	0	4	0	0
16	8298642	.	T	C	2	3	5	0	0	5	0	0
16	8298915	.	T	C	1	4	5	0	0	5	0	0
16	8299025	.	T	A	8	2	10	0	0	10	0	0
16	8299037	.	A	T	9	2	11	0	0	11	0	0
16	8299123	.	T	A	6	5	11	0	0	11	0	0
16	8299302	.	G	A	4	3	7	0	0	7	0	0
16	8299308	.	T	A	4	3	7	0	0	7	0	0
16	8299410	.	T	A	3	2	5	0	0	5	0	0
16	8299705	.	G	A	2	3	5	0	0	5	0	0
16	8299793	.	T	A	6	4	10	0	0	10	0	0
16	8299794	.	G	A	6	4	10	0	0	10	0	0
16	8299968	.	G	A	3	2	5	0	0	5	0	0
16	8299970	.	G	A	3	2	5	0	0	5	0	0
16	8300218	.	T	A	3	2	5	0	0	5	0	0
16	8300225	.	C	T	0	2	2	0	3	5	0	0
16	8300823	.	T	A	5	3	8	0	1	9	0	0
16	8300989	.	A	G	3	4	7	0	1	8	0	0
16	8310813	.	A	G	1	2	3	0	0	3	0	0
16	8530992	.	A	T	1	3	4	0	0	4	0	0
16	8531299	.	C	T	4	2	6	0	1	7	0	0
16	8531571	.	A	G	4	3	7	0	0	7	0	0
16	8532240	.	G	C	2	2	4	0	0	4	0	0
16	8535966	.	C	T	1	3	4	0	1	5	0	0
16	8539523	.	C	T	2	3	5	0	0	5	0	0
16	8752017	.	T	A	17	18	35	0	1	36	0	0
16	8752091	.	A	G	18	14	32	0	1	33	0	0
16	8752223	.	C	T	11	10	21	0	0	21	0	0
16	8752316	.	G	T	19	14	33	0	1	34	0	0
16	8752334	.	C	T	2	16	18	0	13	31	0	0
16	8759975	.	G	A	14	18	32	0	1	33	0	0
16	8788386	.	T	C	7	5	12	0	0	12	0	0
16	8788446	.	A	G	6	11	17	0	1	18	0	0
16	8788629	.	T	C	10	1	11	1	8	20	0	0
16	8788659	.	G	C	8	9	17	1	0	18	0	0
16	8816122	.	G	A	3	5	8	0	2	10	0	0
16	8818958	.	T	C	5	5	10	0	1	11	0	0
16	8819113	.	T	C	4	5	9	0	0	9	0	0
16	8834219	.	G	T	4	4	8	0	1	9	0	0
16	8845738	.	T	G	5	7	12	0	0	12	0	0
16	8847272	.	T	C	2	5	7	0	0	7	0	0
16	8862269	.	G	A	6	7	13	0	0	13	0	0
16	9276038	.	T	A	11	11	22	0	0	22	0	0
16	9281297	.	T	C	9	6	15	0	1	16	0	0
16	9281534	.	G	A	9	9	18	0	0	18	0	0
16	9286987	.	A	G	2	4	6	0	0	6	0	0
16	9292698	.	T	C	6	0	6	0	7	13	0	0
16	9299700	.	C	T	3	2	5	0	0	5	0	0
16	9313279	.	G	A	3	2	5	0	0	5	0	0
16	9348891	.	C	T	1	4	5	0	0	5	0	0
16	9383456	.	T	A	3	2	5	0	1	6	0	0
16	9410978	.	C	G	1	2	3	0	1	4	0	0
16	9411737	.	T	G	1	5	6	0	0	6	0	0
16	9411749	.	G	A	1	5	6	0	0	6	0	0
16	9412024	.	A	T	2	5	7	0	0	7	0	0
16	9412048	.	T	C	6	4	10	0	0	10	0	0
16	9412125	.	A	G	2	4	6	0	0	6	0	0
16	9412151	.	T	C	2	4	6	0	0	6	0	0
16	9412302	.	C	T	8	4	12	0	0	12	0	0
16	9412348	.	C	T	6	2	8	0	0	8	0	0
16	9412350	.	C	T	4	2	6	0	2	8	0	0
16	9412401	.	C	T	4	3	7	0	0	7	0	0
16	9415749	.	G	A	2	7	9	0	0	9	0	0
16	9415793	.	C	T	4	2	6	0	0	6	0	0
16	9416017	.	A	G	2	4	6	0	1	7	0	0
16	9433915	.	C	T	0	4	4	0	5	9	0	0
16	9434023	.	G	A	6	3	9	0	1	10	0	0
16	9434036	.	G	A	6	4	10	0	1	11	0	0
16	9437789	.	G	A	7	13	20	0	0	20	0	0
16	9438075	.	A	G	5	5	10	0	0	10	0	0
16	9440440	.	T	C	2	6	8	0	0	8	0	0
16	9526186	.	G	A	1	4	5	0	0	5	0	0
16	9581981	.	T	C	2	3	5	0	0	5	0	0
16	9584145	.	A	G	3	2	5	0	0	5	0	0
16	9585301	.	A	C	0	3	3	0	1	4	0	0
16	9585373	.	G	T	0	4	4	0	1	5	0	0
16	9590394	.	G	T	4	3	7	0	0	7	0	0
16	9590406	.	A	G	5	3	8	0	0	8	0	0
16	9590588	.	A	G	1	4	5	0	0	5	0	0
16	9596127	.	C	T	1	4	5	0	0	5	0	0
16	9603382	.	T	C	3	6	9	0	1	10	0	0
16	9605806	.	A	G	2	6	8	0	0	8	0	0
16	9605947	.	A	G	9	10	19	0	2	21	0	0
16	9714080	.	G	A	3	6	9	0	0	9	0	0
16	9714474	.	T	G	4	2	6	0	0	6	0	0
16	9714483	.	A	G	6	3	9	0	0	9	0	0
16	9716237	.	C	A	1	4	5	0	1	6	0	0
16	9716258	.	T	C	3	4	7	0	0	7	0	0
16	9724575	.	T	C	4	2	6	0	0	6	0	0
16	9724585	.	A	C	2	2	4	0	0	4	0	0
16	9724878	.	A	T	5	6	11	0	1	12	0	0
16	9724909	.	T	A	4	6	10	0	0	10	0	0
16	9725137	.	A	T	3	8	11	0	1	12	0	0
16	9725196	.	C	G	1	2	3	0	0	3	0	0
16	9751693	.	A	C	5	4	9	0	2	11	0	0
16	9752999	.	A	G	4	5	9	0	0	9	0	0
16	9753005	.	C	G	4	6	10	0	0	10	0	0
16	9753083	.	A	T	2	3	5	0	0	5	0	0
16	9755701	.	G	A	6	3	9	0	0	9	0	0
16	9755719	.	G	T	0	4	4	0	6	10	0	0
16	9758164	.	C	T	9	4	13	1	1	15	0	0
16	9758561	.	T	C	2	3	5	0	0	5	0	0
16	9758944	.	G	A	1	5	6	0	6	12	0	0
16	9758958	.	T	C	7	3	10	0	2	12	0	0
16	9759244	.	A	G	5	6	11	0	2	13	0	0
16	9759336	.	C	T	6	4	10	0	0	10	0	0
16	9759376	.	C	T	5	7	12	0	0	12	0	0
16	9759464	.	C	G	9	7	16	0	0	16	0	0
16	9759554	.	G	A	0	5	5	0	9	14	0	0
16	9759605	.	A	T	7	6	13	0	0	13	0	0
16	9759820	.	T	A	9	4	13	0	0	14	1	0
16	9760006	.	C	T	6	8	14	0	0	14	0	0
16	9760564	.	C	T	3	7	10	0	1	11	0	0
16	9760597	.	A	G	2	0	2	0	5	7	0	0
16	9760718	.	T	C	3	4	7	0	0	7	0	0
16	9761004	.	A	G	3	9	12	0	1	13	0	0
16	9761141	.	G	A	0	7	7	0	7	14	0	0
16	9761339	.	A	C	7	5	12	0	2	14	0	0
16	9766586	.	A	C	4	7	11	0	0	11	0	0
16	9769846	.	C	T	10	9	19	0	0	19	0	0
16	9777613	.	A	G	12	15	27	0	1	28	0	0
16	9781031	.	T	C	20	15	35	0	4	39	0	0
16	9785860	.	G	A	17	16	33	0	5	38	0	0
16	9785868	.	T	G	21	21	42	0	1	43	0	0
16	9785990	.	G	A	18	7	25	0	0	25	0	0
16	9787392	.	T	A	16	4	20	0	0	20	0	0
16	9787620	.	G	A	5	3	8	0	0	8	0	0
16	9787642	.	C	A	5	4	9	0	0	9	0	0
16	9788005	.	C	T	18	19	37	0	0	37	0	0
16	9788019	.	T	A	16	17	33	0	2	35	0	0
16	9788110	.	C	T	5	2	7	0	0	7	0	0
16	9788486	.	G	A	12	12	24	0	0	24	0	0
16	9789007	.	A	T	18	10	28	2	0	30	0	0
16	9789317	.	T	C	3	7	10	0	1	11	0	0
16	9789984	.	T	C	13	13	26	0	1	27	0	0
16	9807425	.	C	A	3	6	9	0	0	9	0	0
16	9807463	.	A	G	2	5	7	0	1	8	0	0
16	9807475	.	C	T	2	7	9	0	0	9	0	0
16	9811675	.	G	A	1	2	3	0	0	3	0	0
16	9813388	.	G	A	1	3	4	0	0	4	0	0
16	9813415	.	C	T	1	4	5	0	0	5	0	0
16	9833887	.	T	A	27	11	38	0	1	39	0	0
16	9833889	.	C	A	26	11	37	0	2	39	0	0
16	9833936	.	A	G	25	24	49	0	2	51	0	0
16	9833974	.	G	A	28	19	47	0	1	48	0	0
16	9834135	.	A	C	24	20	44	0	0	44	0	0
16	9835250	.	C	G	20	24	44	0	1	45	0	0
16	9847182	.	T	C	20	19	39	0	0	39	0	0
16	9868953	.	C	T	22	22	44	0	2	46	0	0
16	9980299	.	A	T	11	12	23	0	0	23	0	0
16	10027167	.	G	C	4	0	4	0	5	9	0	0
16	10055557	.	C	T	0	3	3	0	1	4	0	0
16	10055838	.	C	T	1	2	3	0	0	3	0	0
16	10055952	.	A	G	4	4	8	0	0	8	0	0
16	10055956	.	G	C	4	0	4	0	4	8	0	0
16	10056127	.	T	G	10	6	16	0	0	16	0	0
16	10097362	.	T	C	3	0	3	0	3	6	0	0
16	10199573	.	C	A	3	4	7	0	0	7	0	0
16	10199654	.	G	A	1	2	3	0	0	3	0	0
16	10199957	.	A	G	1	2	3	0	0	3	0	0
16	10207205	.	G	A	1	3	4	0	0	4	0	0
16	10210208	.	C	T	2	6	8	0	0	8	0	0
16	10275625	.	C	T	1	2	3	0	0	3	0	0
16	10275694	.	C	T	1	2	3	0	0	3	0	0
16	10284582	.	A	T	4	5	9	0	1	10	0	0
16	10284593	.	T	A	6	4	10	0	0	10	0	0
16	10287677	.	T	G	2	3	5	0	0	5	0	0
16	10287699	.	A	G	3	2	5	0	0	5	0	0
16	10288859	.	A	T	1	4	5	0	0	5	0	0
16	10288882	.	T	A	2	6	8	0	0	8	0	0
16	10288951	.	G	A	3	3	6	0	0	6	0	0
16	10292782	.	A	G	2	3	5	0	0	5	0	0
16	10325723	.	G	A	0	5	5	0	10	15	0	0
16	10325732	.	T	C	7	7	14	0	0	14	0	0
16	10325870	.	C	T	14	15	29	0	1	30	0	0
16	10325960	.	G	A	1	14	15	0	15	30	0	0
16	10326305	.	G	A	2	24	26	0	16	42	0	0
16	10326704	.	C	T	33	19	52	0	1	53	0	0
16	10326737	.	A	G	24	28	52	0	0	52	0	0
16	10326990	.	G	A	4	28	32	0	13	45	0	0
16	10326993	.	A	T	26	11	37	0	5	42	0	0
16	10327128	.	C	T	21	12	33	0	2	35	0	0
16	10327530	.	C	A	16	8	24	0	0	24	0	0
16	10337471	.	C	T	2	2	4	0	0	4	0	0
16	10338166	.	A	C	1	2	3	0	0	3	0	0
16	10338255	.	C	G	2	3	5	0	0	5	0	0
16	10338290	.	G	A	0	3	3	0	2	5	0	0
16	10338384	.	G	A	0	2	2	0	1	3	0	0
16	10338593	.	A	G	1	5	6	0	1	7	0	0
16	10339436	.	T	C	1	5	6	0	0	6	0	0
16	10339682	.	G	A	5	2	7	0	0	7	0	0
16	10339872	.	G	T	3	5	8	0	0	8	0	0
16	10340008	.	C	G	5	2	7	0	0	7	0	0
16	10340349	.	G	A	2	2	4	0	1	5	0	0
16	10340399	.	A	T	4	5	9	0	0	9	0	0
16	10340840	.	G	A	4	8	12	0	1	13	0	0
16	10340935	.	G	C	5	6	11	0	1	12	0	0
16	10340941	.	T	C	6	4	10	0	1	11	0	0
16	10341355	.	G	A	1	2	3	0	0	3	0	0
16	10341452	.	G	A	4	2	6	0	0	6	0	0
16	10341470	.	G	A	4	3	7	0	1	8	0	0
16	10341778	.	C	A	4	6	10	0	0	10	0	0
16	10341816	.	A	C	8	3	11	0	0	11	0	0
16	10341881	.	A	G	5	4	9	0	1	10	0	0
16	10342275	.	C	T	5	4	9	0	1	10	0	0
16	10345223	.	T	C	3	6	9	0	1	10	0	0
16	10345720	.	A	G	8	5	13	0	0	13	0	0
16	10346378	.	A	T	8	5	13	0	0	13	0	0
16	10360935	.	T	C	1	4	5	0	0	5	0	0
16	10367171	.	G	A	8	3	11	0	0	11	0	0
16	10367475	.	C	A	9	8	17	0	1	18	0	0
16	10367499	.	C	T	8	9	17	0	0	17	0	0
16	10367674	.	C	T	11	5	16	0	2	18	0	0
16	10397645	.	A	T	1	1	2	0	1	3	0	0
16	10397646	.	T	A	1	2	3	0	0	3	0	0
16	10413777	.	T	A	1	5	6	0	0	6	0	0
16	10413815	.	C	A	8	6	14	0	0	14	0	0
16	10413957	.	T	C	7	9	16	0	0	16	0	0
16	10417124	.	G	C	7	5	12	1	1	14	0	0
16	10423046	.	C	T	3	2	5	0	1	6	0	0
16	10425842	.	C	T	2	2	4	0	0	4	0	0
16	10426530	.	T	A	5	2	7	0	1	8	0	0
16	10426975	.	A	T	2	4	6	0	0	6	0	0
16	10427021	.	T	C	1	2	3	0	0	3	0	0
16	10427590	.	G	C	6	2	8	0	0	8	0	0
16	10427722	.	A	T	5	3	8	0	0	8	0	0
16	10427746	.	T	G	4	5	9	0	2	11	0	0
16	10428853	.	C	T	1	3	4	0	0	4	0	0
16	10432015	.	C	A	1	2	3	0	0	3	0	0
16	10434856	.	G	T	1	3	4	0	0	4	0	0
16	10439032	.	A	C	4	5	9	0	0	9	0	0
16	10440612	.	G	A	1	2	3	0	3	6	0	0
16	10444033	.	C	A	2	4	6	0	0	6	0	0
16	10447409	.	A	G	2	5	7	0	1	8	0	0
16	10447477	.	T	C	1	5	6	0	0	6	0	0
16	10447923	.	C	A	3	3	6	0	0	6	0	0
16	10447983	.	C	T	4	3	7	0	0	7	0	0
16	10458749	.	A	G	5	4	9	0	0	9	0	0
16	10459006	.	C	A	5	4	9	0	0	9	0	0
16	10464534	.	A	C	7	5	12	0	0	12	0	0
16	10464570	.	T	C	6	8	14	0	0	14	0	0
16	10464571	.	C	T	8	6	14	0	0	14	0	0
16	10464609	.	A	G	9	4	13	0	2	15	0	0
16	10468283	.	T	C	6	7	13	0	1	14	0	0
16	10472192	.	T	C	11	9	20	0	0	20	0	0
16	10475006	.	C	T	14	16	30	0	0	30	0	0
16	10475645	.	C	T	12	10	22	0	0	22	0	0
16	10477905	.	A	G	13	8	21	0	0	21	0	0
16	10478061	.	G	T	16	11	27	0	3	30	0	0
16	10481425	.	C	T	17	8	25	0	1	26	0	0
16	10485445	.	G	A	18	18	36	0	2	38	0	0
16	10502065	.	A	G	8	14	22	0	0	22	0	0
16	10502069	.	A	G	14	8	22	0	0	22	0	0
16	10502169	.	G	A	11	4	15	0	1	16	0	0
16	10557948	.	C	T	2	3	5	0	0	5	0	0
16	10617265	.	T	C	3	3	6	0	0	6	0	0
16	10620018	.	G	A	3	3	6	0	1	7	0	0
16	10620111	.	G	A	2	5	7	0	1	8	0	0
16	10620129	.	T	C	3	5	8	0	2	10	0	0
16	10620183	.	T	C	2	6	8	0	0	8	0	0
16	10633215	.	A	G	3	2	5	0	2	7	0	0
16	10633287	.	C	A	5	8	13	0	1	15	1	0
16	10634013	.	A	G	9	0	9	0	6	15	0	0
16	10634027	.	A	G	1	0	1	0	15	16	0	0
16	10634460	.	T	C	5	2	7	1	0	8	0	0
16	10634510	.	C	T	4	5	9	0	1	10	0	0
16	10634568	.	A	T	4	2	6	0	0	6	0	0
16	10634818	.	T	C	1	3	4	0	0	4	0	0
16	10634846	.	T	C	2	3	5	0	0	5	0	0
16	10634950	.	T	A	2	4	6	0	2	8	0	0
16	10635927	.	A	G	10	4	14	0	0	14	0	0
16	10635942	.	A	G	12	5	17	0	1	18	0	0
16	10635995	.	C	A	5	12	17	0	1	18	0	0
16	10636003	.	A	G	11	6	17	0	0	17	0	0
16	10636168	.	C	T	12	6	18	0	1	19	0	0
16	10636577	.	G	A	10	10	20	0	0	20	0	0
16	10636658	.	T	G	11	6	17	0	2	19	0	0
16	10636947	.	T	G	11	1	12	0	5	17	0	0
16	10637050	.	C	T	12	10	22	0	3	25	0	0
16	10637259	.	A	G	11	11	22	0	0	22	0	0
16	10637510	.	T	C	10	5	15	0	1	16	0	0
16	10637701	.	T	A	4	10	14	0	1	15	0	0
16	10637705	.	A	C	5	10	15	0	0	15	0	0
16	10724845	.	G	C	2	3	5	0	0	5	0	0
16	10724876	.	G	A	1	3	4	0	1	5	0	0
16	10724883	.	A	G	1	4	5	0	0	5	0	0
16	10724995	.	C	G	3	0	3	0	2	5	0	0
16	10731333	.	C	T	5	5	10	0	0	10	0	0
16	10731388	.	G	C	6	4	10	0	0	10	0	0
16	10731717	.	C	G	5	5	10	0	0	10	0	0
16	10731819	.	T	G	1	4	5	0	0	5	0	0
16	10731995	.	G	A	1	3	4	1	0	5	0	0
16	10732218	.	T	C	3	2	5	0	0	5	0	0
16	10732313	.	C	A	4	4	8	0	1	9	0	0
16	10732407	.	G	A	0	1	1	0	2	3	0	0
16	10733751	.	A	G	1	3	4	0	0	4	0	0
16	10733829	.	G	C	3	3	6	0	0	6	0	0
16	10776922	.	A	C	16	10	26	0	0	26	0	0
16	10777005	.	A	G	1	2	3	0	1	4	0	0
16	10777025	.	G	A	2	2	4	0	0	4	0	0
16	10795620	.	G	A	17	17	34	0	1	35	0	0
16	10795647	.	T	C	19	18	37	0	0	37	0	0
16	10798995	.	A	T	18	16	34	0	1	35	0	0
16	10801121	.	G	A	16	19	35	0	1	36	0	0
16	10801374	.	T	C	22	17	39	0	0	39	0	0
16	10801422	.	G	A	23	13	36	0	1	37	0	0
16	10801682	.	C	T	16	15	31	0	2	33	0	0
16	10801772	.	C	T	25	16	41	1	2	44	0	0
16	10804843	.	T	C	28	25	53	0	2	55	0	0
16	10804862	.	A	T	28	24	52	0	1	53	0	0
16	10804878	.	C	T	30	23	53	0	2	55	0	0
16	10806318	.	C	T	25	23	48	1	0	49	0	0
16	10807471	.	A	G	27	23	50	0	2	52	0	0
16	10813138	.	A	C	37	31	68	0	1	69	0	0
16	10815877	.	T	C	33	31	64	0	6	70	0	0
16	10815907	.	A	G	38	1	39	0	32	71	0	0
16	10820667	.	T	C	45	24	69	0	1	70	0	0
16	10829019	.	T	C	4	17	21	0	1	22	0	0
16	10829139	.	A	G	11	13	24	0	1	25	0	0
16	10829256	.	T	A	11	4	15	0	3	18	0	0
16	10829276	.	T	A	13	4	17	0	0	17	0	0
16	10829569	.	A	T	26	3	29	2	2	33	0	0
16	10829872	.	G	C	6	10	16	0	1	17	0	0
16	10829968	.	T	G	19	10	29	0	0	29	0	0
16	10830309	.	T	A	12	9	21	0	1	22	0	0
16	10830431	.	G	A	9	17	26	0	0	26	0	0
16	10832217	.	C	T	5	3	8	0	1	9	0	0
16	10833987	.	G	A	9	3	12	0	3	15	0	0
16	10833993	.	C	T	1	11	12	0	6	18	0	0
16	10834715	.	A	C	9	19	28	0	1	29	0	0
16	10841177	.	A	G	6	6	12	0	0	12	0	0
16	10843402	.	A	G	13	0	13	0	15	28	0	0
16	10856130	.	A	G	7	7	14	0	2	16	0	0
16	10859434	.	C	T	28	18	46	0	1	47	0	0
16	10859435	.	T	C	26	19	45	0	2	47	0	0
16	10862159	.	T	A	16	13	29	0	0	29	0	0
16	10862162	.	T	A	15	11	26	0	0	26	0	0
16	10862279	.	A	G	22	5	27	0	0	27	0	0
16	10862280	.	G	T	22	4	26	0	2	28	0	0
16	10862331	.	C	G	10	14	24	1	2	27	0	0
16	10862773	.	T	C	22	19	41	0	1	42	0	0
16	10919100	.	G	A	0	3	3	0	2	5	0	0
16	10919104	.	A	G	3	0	3	0	2	5	0	0
16	10919317	.	C	T	1	5	6	0	1	7	0	0
16	10919482	.	C	A	2	3	5	0	2	7	0	0
16	10979825	.	C	A	1	2	3	0	0	3	0	0
16	10979967	.	C	G	1	0	1	0	2	3	0	0
16	10987970	.	A	C	3	3	6	0	0	6	0	0
16	10990445	.	T	A	2	2	4	0	0	4	0	0
16	10990490	.	G	A	1	3	4	0	0	4	0	0
16	10990633	.	A	G	2	3	5	0	0	5	0	0
16	10990944	.	C	A	2	4	6	0	0	6	0	0
16	11140431	.	A	G	13	6	19	0	0	19	0	0
16	11140994	.	A	G	3	2	5	0	0	5	0	0
16	11142340	.	A	C	1	0	1	0	5	6	0	0
16	11142345	.	T	G	3	0	3	0	5	8	0	0
16	11222031	.	T	A	12	16	28	4	1	33	0	0
16	11774560	.	T	C	8	4	12	0	0	12	0	0
16	11965673	.	G	T	25	19	44	3	3	50	0	0
16	11965803	.	G	T	31	19	50	0	0	50	0	0
16	11965931	.	T	C	23	3	26	0	14	40	0	0
16	11970239	.	C	T	8	14	22	0	0	22	0	0
16	11974658	.	G	A	14	13	27	0	0	27	0	0
16	11974703	.	G	A	8	12	20	0	0	20	0	0
16	11974720	.	G	T	9	4	13	0	1	14	0	0
16	11978045	.	G	A	10	11	21	0	4	25	0	0
16	11980484	.	C	T	1	6	7	0	9	16	0	0
16	11982471	.	G	A	11	6	17	1	0	18	0	0
16	11982519	.	G	T	9	8	17	1	0	18	0	0
16	11985606	.	C	T	6	6	12	0	2	14	0	0
16	12054138	.	C	T	0	2	2	0	1	3	0	0
16	12060324	.	C	T	0	2	2	0	1	3	0	0
16	12064946	.	C	T	15	4	19	0	0	19	0	0
16	12065025	.	G	A	9	7	16	0	0	16	0	0
16	12065201	.	C	T	23	11	34	0	0	34	0	0
16	12065392	.	G	A	16	14	30	0	2	32	0	0
16	12073577	.	G	A	9	5	14	0	0	14	0	0
16	12078916	.	A	G	9	4	13	0	0	13	0	0
16	12078976	.	C	T	8	9	17	0	0	17	0	0
16	12078982	.	C	T	8	9	17	0	0	17	0	0
16	12092428	.	A	G	6	5	11	0	0	11	0	0
16	12095043	.	G	A	2	5	7	0	0	7	0	0
16	12095076	.	C	T	4	2	6	0	0	6	0	0
16	12097292	.	G	T	4	3	7	0	0	7	0	0
16	12097325	.	G	A	5	6	11	0	1	12	0	0
16	12097354	.	G	T	7	7	14	0	1	15	0	0
16	12102412	.	A	T	20	12	32	0	1	33	0	0
16	12102671	.	T	C	21	37	58	0	5	63	0	0
16	12102708	.	A	G	30	40	70	0	2	72	0	0
16	12103083	.	T	C	32	4	36	0	27	63	0	0
16	12103331	.	T	A	38	21	59	0	1	60	0	0
16	12103344	.	A	G	28	33	61	0	1	62	0	0
16	12103530	.	G	A	22	29	51	0	4	55	0	0
16	12103540	.	G	A	32	20	52	0	2	54	0	0
16	12103598	.	G	A	27	21	48	0	3	51	0	0
16	12103732	.	C	T	3	14	17	0	12	29	0	0
16	12103749	.	C	T	15	11	26	0	2	28	0	0
16	12103982	.	G	A	21	35	56	0	4	60	0	0
16	12104042	.	C	T	26	35	61	0	1	62	0	0
16	12104043	.	A	T	26	35	61	0	0	61	0	0
16	12104083	.	C	T	30	27	57	2	0	59	0	0
16	12104209	.	A	C	33	21	54	2	1	57	0	0
16	12104316	.	T	A	24	19	43	2	0	45	0	0
16	12104601	.	G	A	36	23	59	2	2	63	0	0
16	12104665	.	A	G	40	16	56	1	2	59	0	0
16	12104794	.	C	T	28	12	40	3	0	43	0	0
16	12105206	.	A	G	22	19	41	0	0	41	0	0
16	12105443	.	A	T	7	2	9	1	1	11	0	0
16	12105689	.	C	T	0	19	19	0	20	39	0	0
16	12105796	.	C	T	4	26	30	0	21	51	0	0
16	12114975	.	G	A	22	23	45	0	3	48	0	0
16	12117537	.	G	A	13	18	31	0	2	33	0	0
16	12117645	.	G	A	24	17	41	0	0	41	0	0
16	12117648	.	G	A	22	16	38	0	1	39	0	0
16	12118207	.	G	A	16	17	33	0	2	35	0	0
16	12118210	.	C	T	17	17	34	0	0	34	0	0
16	12135754	.	G	A	12	14	26	0	1	28	1	0
16	12138841	.	G	A	13	13	26	0	1	27	0	0
16	12138940	.	A	G	14	9	23	0	1	24	0	0
16	12143710	.	C	T	5	8	13	0	2	15	0	0
16	12150856	.	C	A	0	11	11	0	4	15	0	0
16	12162370	.	A	C	7	0	7	0	6	13	0	0
16	12173511	.	T	A	4	8	12	0	1	13	0	0
16	12174949	.	G	T	2	4	6	0	0	6	0	0
16	12175483	.	A	G	2	4	6	0	0	6	0	0
16	12175594	.	A	G	2	6	8	0	0	8	0	0
16	12245751	.	T	C	30	28	58	0	5	63	0	0
16	12245954	.	C	T	29	34	63	0	2	65	0	0
16	12254457	.	C	T	34	33	67	0	2	70	1	0
16	12254469	.	T	C	40	27	67	0	2	69	0	0
16	12254592	.	T	C	33	23	56	0	5	61	0	0
16	12254674	.	C	T	33	19	52	0	2	54	0	0
16	12254776	.	A	T	31	20	51	0	1	52	0	0
16	12256585	.	C	T	14	7	21	0	1	22	0	0
16	12256614	.	G	A	20	16	36	0	2	38	0	0
16	12256629	.	A	G	23	20	43	0	2	45	0	0
16	12256681	.	C	A	6	33	39	0	24	63	0	0
16	12256801	.	C	T	31	18	49	0	5	54	0	0
16	12256816	.	G	T	28	14	42	0	6	48	0	0
16	12257154	.	T	C	18	26	44	0	1	45	0	0
16	12257216	.	A	T	22	21	43	0	2	45	0	0
16	12257315	.	T	A	24	8	32	1	3	36	0	0
16	12257319	.	A	T	31	5	36	1	3	40	0	0
16	12257506	.	G	A	19	21	40	0	0	40	0	0
16	12257904	.	C	T	21	28	49	0	1	50	0	0
16	12257921	.	T	G	17	23	40	0	7	47	0	0
16	12258044	.	C	T	13	8	21	0	3	24	0	0
16	12258128	.	A	T	8	7	15	0	1	16	0	0
16	12258264	.	G	C	9	10	19	0	0	19	0	0
16	12258268	.	C	T	11	12	23	0	0	23	0	0
16	12258302	.	A	T	8	10	18	0	0	18	0	0
16	12258593	.	T	G	7	9	16	0	1	17	0	0
16	12258733	.	A	T	10	13	23	1	0	24	0	0
16	12258999	.	G	C	14	23	37	0	0	37	0	0
16	12259298	.	G	C	18	15	33	0	1	34	0	0
16	12259302	.	A	T	18	16	34	0	1	35	0	0
16	12259589	.	G	A	15	18	33	0	1	34	0	0
16	12259678	.	T	C	17	13	30	0	1	31	0	0
16	12259737	.	A	T	11	19	30	0	2	32	0	0
16	12260002	.	T	G	16	14	30	0	4	34	0	0
16	12260134	.	A	T	17	5	22	0	0	22	0	0
16	12260291	.	G	T	19	14	33	0	1	34	0	0
16	12261211	.	A	G	7	13	20	0	1	21	0	0
16	12261625	.	A	G	11	11	22	0	2	24	0	0
16	12262453	.	T	G	9	10	19	0	1	20	0	0
16	12262762	.	T	A	6	9	15	0	0	15	0	0
16	12263047	.	C	T	4	22	26	0	11	37	0	0
16	12263385	.	G	A	17	7	24	0	4	28	0	0
16	12264912	.	A	T	18	14	32	0	0	32	0	0
16	12264999	.	T	C	10	2	12	0	16	28	0	0
16	12265237	.	A	G	10	12	22	0	1	23	0	0
16	12265917	.	C	G	8	11	19	0	1	20	0	0
16	12266073	.	G	A	12	6	18	0	1	19	0	0
16	12267706	.	C	G	1	2	3	0	0	3	0	0
16	12276030	.	G	A	20	19	39	2	0	41	0	0
16	12276033	.	A	T	18	21	39	2	0	41	0	0
16	12276065	.	A	T	15	10	25	2	2	29	0	0
16	12276102	.	G	A	6	7	13	0	0	13	0	0
16	12286264	.	C	A	7	14	21	0	2	24	1	0
16	12292467	.	G	A	0	29	29	0	16	45	0	0
16	12292599	.	T	C	13	31	44	0	3	47	0	0
16	12292622	.	G	A	19	24	43	0	2	45	0	0
16	12292648	.	T	C	19	22	41	0	2	43	0	0
16	12294316	.	C	A	1	4	5	1	0	6	0	0
16	12367016	.	C	G	1	2	3	0	0	3	0	0
16	12367100	.	A	G	1	2	3	0	1	4	0	0
16	12367103	.	G	A	1	3	4	0	0	4	0	0
16	12475274	.	G	A	1	2	3	0	0	3	0	0
16	12475290	.	C	T	1	2	3	0	0	3	0	0
16	12475429	.	G	T	3	2	5	0	0	5	0	0
16	12475434	.	T	A	3	2	5	0	0	5	0	0
16	12475737	.	T	C	2	2	4	0	0	4	0	0
16	12475750	.	A	G	2	2	4	0	0	4	0	0
16	12487610	.	A	G	1	2	3	0	0	3	0	0
16	12632593	.	G	C	2	3	5	0	0	5	0	0
16	12632664	.	T	C	2	5	7	0	1	8	0	0
16	12636347	.	T	C	6	6	12	0	0	12	0	0
16	12636546	.	T	C	4	5	9	0	0	9	0	0
16	12637271	.	G	A	2	3	5	0	1	6	0	0
16	12637284	.	T	C	2	3	5	0	0	5	0	0
16	12637552	.	A	T	1	5	6	0	0	6	0	0
16	12637681	.	T	G	6	4	10	0	0	10	0	0
16	12637779	.	C	T	7	9	16	0	2	18	0	0
16	12637822	.	T	C	5	7	12	0	0	12	0	0
16	12637824	.	G	A	1	7	8	0	4	12	0	0
16	12638062	.	A	G	5	3	8	0	0	8	0	0
16	12638612	.	C	G	10	5	15	0	1	16	0	0
16	12638622	.	A	G	8	7	15	0	0	15	0	0
16	12639125	.	A	T	10	5	15	0	0	15	0	0
16	12639184	.	C	G	4	6	10	1	2	13	0	0
16	12639285	.	T	A	6	4	10	0	1	11	0	0
16	12639291	.	C	T	4	6	10	0	1	11	0	0
16	12639320	.	C	G	4	5	9	0	0	9	0	0
16	12639488	.	G	A	2	3	5	1	0	6	0	0
16	12730380	.	A	G	6	14	20	0	0	20	0	0
16	12738324	.	G	A	10	6	16	0	2	18	0	0
16	12738351	.	T	C	5	8	13	0	1	14	0	0
16	12740779	.	C	T	7	11	18	0	0	18	0	0
16	12740949	.	C	G	4	14	18	0	1	19	0	0
16	12743927	.	G	A	1	11	12	0	9	21	0	0
16	12744270	.	T	C	1	2	3	0	0	3	0	0
16	12748058	.	A	G	2	0	2	1	18	21	0	0
16	12748078	.	A	G	17	4	21	1	1	23	0	0
16	12748944	.	A	G	19	5	24	0	4	28	0	0
16	12755992	.	C	T	23	17	40	0	3	43	0	0
16	12756094	.	A	C	15	15	30	0	0	30	0	0
16	12756255	.	C	T	10	12	22	0	0	22	0	0
16	12756376	.	T	A	3	2	5	0	0	5	0	0
16	12764221	.	G	A	3	2	5	0	0	5	0	0
16	12794075	.	C	G	3	7	10	0	1	11	0	0
16	12807038	.	G	A	6	3	9	0	0	9	0	0
16	12807129	.	C	G	2	9	11	0	0	11	0	0
16	12812496	.	T	C	6	3	9	0	0	9	0	0
16	12814102	.	A	T	6	10	16	0	2	18	0	0
16	12816486	.	T	C	8	7	15	0	1	16	0	0
16	12816745	.	A	C	7	9	16	0	0	16	0	0
16	12816975	.	G	A	10	6	16	0	1	17	0	0
16	12818220	.	G	T	13	23	36	0	1	37	0	0
16	12820952	.	C	T	5	9	14	0	5	19	0	0
16	12821091	.	C	A	24	15	39	0	1	40	0	0
16	12821106	.	C	T	18	22	40	0	0	40	0	0
16	12821221	.	G	A	14	18	32	0	2	34	0	0
16	12821300	.	G	C	1	17	18	0	12	30	0	0
16	12821449	.	G	A	21	20	41	0	0	41	0	0
16	12821459	.	A	G	19	20	39	0	4	43	0	0
16	12882612	.	C	T	1	19	20	0	31	51	0	0
16	12883126	.	G	A	12	20	32	2	8	42	0	0
16	12883618	.	C	T	20	13	33	0	2	35	0	0
16	12884054	.	A	T	13	25	38	0	3	41	0	0
16	12884510	.	A	T	10	12	22	0	0	22	0	0
16	12884513	.	G	A	13	10	23	0	0	23	0	0
16	12953670	.	C	T	8	8	16	0	2	18	0	0
16	12963274	.	A	T	6	4	10	0	1	11	0	0
16	12963368	.	G	A	18	9	27	0	0	27	0	0
16	12963384	.	C	T	0	10	10	0	20	30	0	0
16	12963975	.	A	G	16	29	45	0	2	47	0	0
16	12967855	.	G	A	11	13	24	1	1	26	0	0
16	12981637	.	G	A	13	7	20	0	1	21	0	0
16	12984488	.	C	G	11	10	21	0	1	22	0	0
16	13023601	.	A	G	1	3	4	0	0	4	0	0
16	13049162	.	A	G	2	2	4	0	0	4	0	0
16	13179335	.	G	A	5	3	8	0	0	8	0	0
16	13180389	.	T	C	2	3	5	0	0	5	0	0
16	13181465	.	T	C	10	7	17	0	0	17	0	0
16	13568841	.	A	G	1	3	4	0	0	4	0	0
16	13568844	.	A	T	1	2	3	0	1	4	0	0
16	13600354	.	G	A	7	3	10	0	0	10	0	0
16	13600680	.	A	C	13	14	27	2	1	30	0	0
16	13601013	.	A	G	11	14	25	0	0	25	0	0
16	13601026	.	T	C	10	12	22	0	1	23	0	0
16	13601286	.	G	T	2	2	4	0	0	4	0	0
16	13601964	.	T	C	5	1	6	0	13	19	0	0
16	13602164	.	T	C	7	11	18	0	1	19	0	0
16	13602454	.	T	A	13	9	22	0	0	22	0	0
16	13602488	.	T	C	7	10	17	0	0	17	0	0
16	13602800	.	T	A	9	6	15	0	1	16	0	0
16	13603007	.	T	G	12	9	21	0	4	25	0	0
16	13606896	.	A	T	9	7	16	0	1	17	0	0
16	13610651	.	A	T	14	13	27	0	0	27	0	0
16	13610966	.	A	G	12	4	16	0	0	16	0	0
16	13611035	.	G	A	7	14	21	0	0	21	0	0
16	13612999	.	T	A	8	4	12	0	1	13	0	0
16	13613104	.	T	C	3	3	6	0	0	6	0	0
16	13613148	.	C	T	4	3	7	0	0	7	0	0
16	13613208	.	A	T	3	4	7	0	1	8	0	0
16	13613210	.	C	A	3	4	7	0	1	8	0	0
16	13616698	.	A	T	8	12	20	0	0	20	0	0
16	13616862	.	G	C	9	5	14	0	0	14	0	0
16	13617152	.	C	T	9	16	25	0	1	26	0	0
16	13617291	.	G	A	7	9	16	0	1	17	0	0
16	13618172	.	C	G	7	12	19	0	2	21	0	0
16	13618374	.	A	T	9	13	22	0	2	24	0	0
16	13618662	.	T	A	13	12	25	0	4	29	0	0
16	13620832	.	T	C	3	4	7	0	0	7	0	0
16	13621056	.	G	A	5	3	8	0	0	8	0	0
16	13621998	.	G	C	5	0	5	0	3	8	0	0
16	13622769	.	T	A	2	3	5	0	0	5	0	0
16	13622770	.	G	T	2	3	5	0	0	5	0	0
16	13623642	.	T	A	5	2	7	0	1	8	0	0
16	13643504	.	C	T	0	22	22	0	16	38	0	0
16	13643974	.	C	T	1	11	12	0	11	23	0	0
16	13645495	.	C	T	7	11	18	0	1	19	0	0
16	13673142	.	T	C	10	3	13	0	2	15	0	0
16	13673143	.	T	C	3	11	14	0	1	15	0	0
16	13673660	.	T	A	3	2	5	0	0	5	0	0
16	13673734	.	A	C	5	7	12	0	0	12	0	0
16	13674176	.	T	G	10	12	22	0	0	22	0	0
16	13679037	.	A	G	2	3	5	0	0	5	0	0
16	13680487	.	T	G	4	4	8	0	2	10	0	0
16	13685800	.	G	A	9	7	16	0	0	16	0	0
16	13701482	.	C	T	6	14	20	0	0	20	0	0
16	13701599	.	A	G	3	6	9	0	0	9	0	0
16	13706207	.	G	C	5	13	18	0	1	19	0	0
16	13721408	.	C	T	6	10	16	0	0	16	0	0
16	13729810	.	C	T	6	14	20	0	2	22	0	0
16	13741610	.	G	A	5	8	13	0	0	13	0	0
16	13743390	.	G	A	9	6	15	0	1	16	0	0
16	13780375	.	G	A	3	5	8	0	1	9	0	0
16	13789765	.	G	A	9	5	14	0	1	15	0	0
16	13810372	.	G	A	2	2	4	0	0	4	0	0
16	13810528	.	C	T	1	2	3	0	0	3	0	0
16	13818640	.	T	A	4	2	6	0	0	6	0	0
16	13818644	.	G	A	3	2	5	0	0	5	0	0
16	13826195	.	C	T	5	8	13	0	1	14	0	0
16	13833484	.	T	A	3	3	6	0	0	6	0	0
16	13841360	.	T	A	11	8	19	0	0	19	0	0
16	13845350	.	G	A	18	9	27	0	0	27	0	0
16	13845368	.	G	A	0	14	14	0	9	23	0	0
16	13845571	.	T	A	7	11	18	0	0	18	0	0
16	13855121	.	C	T	5	8	13	0	1	14	0	0
16	13855142	.	T	C	11	8	19	0	0	19	0	0
16	13855179	.	A	G	8	2	10	0	5	15	0	0
16	13855482	.	T	A	5	9	14	0	1	15	0	0
16	13858356	.	C	A	16	13	29	0	4	33	0	0
16	13858436	.	C	A	17	14	31	0	0	31	0	0
16	13858570	.	C	T	6	18	24	0	0	24	0	0
16	13858673	.	T	C	11	18	29	0	1	30	0	0
16	13858866	.	T	A	15	13	28	1	2	31	0	0
16	13858889	.	C	T	12	13	25	1	1	27	0	0
16	13860459	.	G	A	2	3	5	0	5	10	0	0
16	13866763	.	G	A	5	2	7	0	0	7	0	0
16	13883968	.	C	A	7	7	14	0	0	14	0	0
16	13883980	.	A	C	8	9	17	0	1	18	0	0
16	14010210	.	G	T	4	2	6	0	0	6	0	0
16	14010241	.	C	A	8	2	10	0	1	11	0	0
16	14010693	.	G	T	6	5	11	0	0	11	0	0
16	14021817	.	G	T	8	9	17	0	0	17	0	0
16	14022252	.	G	A	1	8	9	0	6	15	0	0
16	14022520	.	G	A	9	5	14	0	1	15	0	0
16	14023087	.	A	C	0	3	3	0	1	4	0	0
16	14029329	.	A	T	7	9	16	0	1	17	0	0
16	14029424	.	A	C	8	13	21	0	0	21	0	0
16	14029437	.	T	C	10	12	22	0	0	22	0	0
16	14055048	.	G	C	11	7	18	0	0	18	0	0
16	14055284	.	A	T	12	13	25	0	3	28	0	0
16	14095097	.	C	T	1	8	9	0	10	19	0	0
16	14115928	.	G	T	10	12	22	0	3	25	0	0
16	14115931	.	G	A	10	12	22	0	3	25	0	0
16	14133851	.	G	A	12	10	22	0	1	23	0	0
16	14133907	.	C	T	8	3	11	0	0	11	0	0
16	14154240	.	T	A	4	7	11	0	1	12	0	0
16	14154798	.	C	T	1	8	9	0	5	14	0	0
16	14154870	.	A	G	10	5	15	0	0	15	0	0
16	14154944	.	C	T	9	4	13	0	0	13	0	0
16	14155169	.	C	T	5	3	8	0	0	8	0	0
16	14155400	.	A	G	8	4	12	0	1	13	0	0
16	14155563	.	T	C	3	4	7	0	4	11	0	0
16	14155684	.	G	A	5	6	11	0	0	11	0	0
16	14155686	.	C	T	5	5	10	0	1	11	0	0
16	14156157	.	T	C	4	4	8	0	1	9	0	0
16	14156518	.	T	A	4	3	7	0	0	7	0	0
16	14156646	.	G	A	1	3	4	0	1	5	0	0
16	14156775	.	C	A	0	6	6	0	1	7	0	0
16	14157371	.	G	A	4	7	11	0	1	12	0	0
16	14157508	.	G	A	2	3	5	0	0	5	0	0
16	14158417	.	G	A	1	2	3	0	0	3	0	0
16	14158490	.	G	A	3	2	5	0	1	6	0	0
16	14202197	.	T	A	9	11	20	0	3	23	0	0
16	14206289	.	G	A	6	8	14	0	2	16	0	0
16	14209195	.	G	A	8	18	26	0	1	27	0	0
16	14209348	.	T	C	11	15	26	0	1	27	0	0
16	14210949	.	A	C	13	6	19	0	3	22	0	0
16	14212079	.	G	C	1	5	6	0	12	18	0	0
16	14214534	.	G	A	6	6	12	0	0	12	0	0
16	14214543	.	A	G	5	6	11	0	0	11	0	0
16	14216766	.	G	A	0	2	2	0	1	3	0	0
16	14227913	.	C	T	2	5	7	0	0	7	0	0
16	14228033	.	A	G	6	1	7	0	4	11	0	0
16	14228668	.	A	G	4	4	8	0	1	9	0	0
16	14228677	.	C	T	5	4	9	0	1	10	0	0
16	14228743	.	C	T	3	3	6	0	0	6	0	0
16	14228902	.	C	T	3	6	9	0	0	9	0	0
16	14228979	.	A	G	1	2	3	0	0	3	0	0
16	14229031	.	T	A	4	5	9	0	0	9	0	0
16	14229167	.	G	C	2	3	5	0	0	5	0	0
16	14229169	.	T	C	2	3	5	0	0	5	0	0
16	14229539	.	C	T	3	4	7	0	0	7	0	0
16	14229585	.	G	A	0	6	6	0	5	11	0	0
16	14229946	.	T	C	7	3	10	0	0	10	0	0
16	14229947	.	A	T	6	3	9	0	1	10	0	0
16	14230071	.	A	G	10	0	10	0	6	16	0	0
16	14230111	.	C	G	3	5	8	0	0	10	2	0
16	14230329	.	G	C	1	2	3	0	0	3	0	0
16	14230719	.	A	T	1	3	4	0	0	4	0	0
16	14230778	.	A	G	2	2	4	0	1	5	0	0
16	14230820	.	A	G	2	0	2	0	4	6	0	0
16	14230834	.	T	C	2	4	6	0	0	6	0	0
16	14231038	.	A	G	10	8	18	0	0	18	0	0
16	14231063	.	G	A	0	9	9	0	8	17	0	0
16	14231079	.	G	A	1	9	10	0	7	17	0	0
16	14231135	.	G	A	0	7	7	0	6	13	0	0
16	14231138	.	C	T	6	5	11	0	2	13	0	0
16	14231207	.	T	A	2	2	4	0	0	4	0	0
16	14231941	.	A	G	17	7	24	0	1	25	0	0
16	14231952	.	A	T	17	7	24	0	0	24	0	0
16	14232005	.	G	A	17	12	29	0	1	30	0	0
16	14255815	.	A	G	2	3	5	0	0	6	1	0
16	14269885	.	G	A	2	2	4	0	0	4	0	0
16	14269906	.	G	A	2	2	4	0	1	5	0	0
16	14277577	.	G	A	4	2	6	0	1	7	0	0
16	14416520	.	C	T	2	3	5	0	1	6	0	0
16	14416599	.	C	T	2	7	9	0	1	10	0	0
16	14416876	.	T	G	5	5	10	0	1	11	0	0
16	14417003	.	T	A	4	3	7	0	0	7	0	0
16	14417005	.	C	G	2	3	5	0	2	7	0	0
16	14417258	.	G	A	2	3	5	0	0	5	0	0
16	14417299	.	A	T	1	4	5	0	0	5	0	0
16	14588209	.	G	A	3	6	9	0	2	11	0	0
16	14588301	.	A	G	1	1	2	0	0	2	0	0
16	14588311	.	G	A	1	2	3	0	0	3	0	0
16	14627207	.	T	C	5	4	9	0	0	9	0	0
16	14638413	.	G	A	7	3	10	1	0	11	0	0
16	14664767	.	T	A	6	8	14	0	1	15	0	0
16	14670990	.	A	G	2	0	2	0	7	9	0	0
16	14670994	.	T	A	7	2	9	0	0	9	0	0
16	14671097	.	A	T	3	4	7	0	0	7	0	0
16	14671099	.	A	T	4	3	7	0	0	7	0	0
16	14671135	.	A	G	4	3	7	0	0	7	0	0
16	14675373	.	A	C	10	4	14	0	2	16	0	0
16	14675413	.	G	T	2	6	8	0	10	18	0	0
16	14675572	.	G	A	14	6	20	0	0	20	0	0
16	14800416	.	T	C	1	2	3	0	0	3	0	0
16	14871176	.	T	C	2	2	4	0	0	4	0	0
16	14908825	.	C	T	1	4	5	0	0	5	0	0
16	14973890	.	G	A	0	4	4	0	5	9	0	0
16	14973968	.	A	T	4	3	7	0	0	7	0	0
16	14973989	.	A	T	6	4	10	0	0	10	0	0
16	15019105	.	T	G	5	0	5	0	5	10	0	0
16	15031839	.	C	T	6	4	10	0	0	10	0	0
16	15034797	.	G	A	0	10	10	0	11	21	0	0
16	15037778	.	C	T	9	12	21	0	1	22	0	0
16	15048737	.	A	T	6	5	11	0	0	11	0	0
16	15050135	.	C	T	5	2	7	0	0	7	0	0
16	15050277	.	G	A	6	4	10	0	1	11	0	0
16	15050623	.	C	T	12	10	22	0	0	22	0	0
16	15141050	.	C	T	1	4	5	0	0	5	0	0
16	15165262	.	G	A	2	4	6	0	0	6	0	0
16	15184543	.	C	T	1	2	3	0	3	6	0	0
16	15262854	.	G	T	3	4	7	0	0	7	0	0
16	15262870	.	G	A	2	3	5	0	0	5	0	0
16	15944980	.	A	T	6	2	8	0	1	9	0	0
16	16041698	.	A	T	10	5	15	0	0	15	0	0
16	16042240	.	G	A	5	6	11	0	1	12	0	0
16	16043191	.	T	G	7	6	13	0	1	14	0	0
16	16043218	.	A	G	8	4	12	0	1	13	0	0
16	16069884	.	A	G	6	3	9	0	1	10	0	0
16	16103927	.	C	T	3	4	7	0	1	8	0	0
16	16113853	.	G	A	5	4	9	0	0	9	0	0
16	16120849	.	C	T	5	2	7	0	0	7	0	0
16	16165179	.	T	A	34	26	60	0	0	60	0	0
16	16165418	.	C	T	32	36	68	0	0	68	0	0
16	16182195	.	T	C	29	34	63	0	2	65	0	0
16	16210469	.	T	A	5	4	9	0	0	9	0	0
16	16210784	.	T	C	3	4	7	0	0	7	0	0
16	16232902	.	A	T	9	6	15	0	1	16	0	0
16	16232911	.	A	G	11	7	18	0	1	19	0	0
16	16233250	.	T	G	12	12	24	0	2	26	0	0
16	16233447	.	T	C	10	8	18	0	1	19	0	0
16	16233448	.	G	A	10	9	19	0	0	19	0	0
16	16233520	.	C	T	9	7	16	1	0	17	0	0
16	16233538	.	A	T	6	7	13	1	3	17	0	0
16	16233715	.	T	C	6	0	6	0	7	13	0	0
16	16233907	.	A	T	5	10	15	0	1	16	0	0
16	16233937	.	G	T	5	16	21	0	1	22	0	0
16	16233952	.	C	A	0	15	15	0	10	25	0	0
16	16234297	.	C	T	9	5	14	0	0	14	0	0
16	16234309	.	C	A	0	5	5	0	6	11	0	0
16	16234516	.	A	C	9	4	13	0	0	13	0	0
16	16234633	.	T	C	5	0	5	0	9	14	0	0
16	16234642	.	C	T	5	7	12	0	0	12	0	0
16	16234747	.	T	A	11	6	17	0	0	17	0	0
16	16234948	.	C	T	0	5	5	0	6	11	0	0
16	16235056	.	G	C	9	12	21	0	0	21	0	0
16	16267602	.	A	T	1	2	3	0	0	3	0	0
16	16267673	.	C	T	3	2	5	0	0	5	0	0
16	16267895	.	G	A	0	5	5	0	1	6	0	0
16	16267903	.	A	G	2	2	4	0	1	5	0	0
16	16267956	.	A	T	2	2	4	0	0	4	0	0
16	16268764	.	A	T	0	3	3	0	1	4	0	0
16	16268791	.	C	T	1	3	4	0	0	4	0	0
16	16269089	.	A	G	1	2	3	0	0	3	0	0
16	16269118	.	C	T	2	2	4	0	0	4	0	0
16	16269383	.	G	A	0	3	3	0	2	5	0	0
16	16269593	.	G	C	2	6	8	0	0	8	0	0
16	16269690	.	G	A	0	6	6	0	4	10	0	0
16	16269724	.	G	A	3	7	10	0	0	10	0	0
16	16269964	.	T	C	1	3	4	0	0	4	0	0
16	16270163	.	C	A	3	2	5	0	0	5	0	0
16	16271683	.	G	A	1	2	3	0	0	3	0	0
16	16276678	.	G	A	5	2	7	0	1	8	0	0
16	16276938	.	T	C	4	2	6	0	0	6	0	0
16	16277810	.	G	A	6	4	10	0	0	10	0	0
16	16277954	.	G	A	6	6	12	0	0	12	0	0
16	16278013	.	A	T	6	6	12	0	0	12	0	0
16	16278043	.	T	C	5	6	11	0	0	11	0	0
16	16278755	.	G	C	6	4	10	0	0	10	0	0
16	16278756	.	C	A	6	4	10	0	0	10	0	0
16	16281479	.	A	C	6	8	14	0	0	14	0	0
16	16281740	.	A	C	9	6	15	0	1	16	0	0
16	16281869	.	T	A	9	7	16	0	0	16	0	0
16	16283643	.	G	A	23	0	23	1	0	24	0	0
16	16283667	.	A	G	12	1	13	1	4	18	0	0
16	16284057	.	T	C	8	12	20	0	0	20	0	0
16	16284159	.	G	A	1	12	13	0	12	25	0	0
16	16284192	.	C	A	10	10	20	0	0	20	0	0
16	16289121	.	C	T	13	16	29	0	2	31	0	0
16	16297057	.	G	A	10	9	19	0	3	22	0	0
16	16302166	.	T	C	8	6	14	0	0	14	0	0
16	16302244	.	A	G	11	0	11	0	10	21	0	0
16	16302247	.	A	T	11	10	21	0	0	21	0	0
16	16302371	.	A	C	8	9	17	0	2	19	0	0
16	16302426	.	T	A	9	8	17	0	1	18	0	0
16	16302477	.	G	A	0	5	5	0	9	14	0	0
16	16302835	.	T	C	14	9	23	0	0	23	0	0
16	16303025	.	C	T	15	13	28	0	0	28	0	0
16	16303065	.	A	G	14	11	25	0	2	27	0	0
16	16303086	.	T	A	13	13	26	0	1	27	0	0
16	16303163	.	G	A	1	11	12	0	11	23	0	0
16	16303196	.	A	G	13	1	14	0	8	22	0	0
16	16303293	.	T	G	7	9	16	0	0	16	0	0
16	16547388	.	C	T	10	13	23	0	0	23	0	0
16	16553899	.	C	T	9	11	20	0	1	21	0	0
16	16554693	.	A	T	1	2	3	0	0	3	0	0
16	16554695	.	T	C	1	2	3	0	0	3	0	0
16	16555484	.	A	C	11	7	18	0	1	19	0	0
16	16555611	.	A	G	6	10	16	0	1	17	0	0
16	16555628	.	A	T	9	11	20	0	1	21	0	0
16	16555975	.	T	A	7	10	17	0	1	18	0	0
16	16556223	.	C	A	7	11	18	0	0	18	0	0
16	16565998	.	C	T	11	7	18	0	2	20	0	0
16	16569578	.	C	G	8	7	15	0	0	15	0	0
16	16586232	.	C	T	12	4	16	0	3	19	0	0
16	16586290	.	G	A	15	11	26	0	0	26	0	0
16	16589462	.	G	A	5	4	9	0	0	9	0	0
16	16589552	.	G	A	5	3	8	0	0	8	0	0
16	16590439	.	C	T	0	14	14	0	6	20	0	0
16	16597649	.	C	T	0	2	2	0	1	3	0	0
16	16597660	.	T	C	1	1	2	0	1	3	0	0
16	16597939	.	A	T	3	3	6	0	0	6	0	0
16	16597961	.	C	G	3	3	6	0	1	7	0	0
16	16598146	.	T	C	2	3	5	0	0	5	0	0
16	16603081	.	C	A	2	3	5	0	0	5	0	0
16	16849326	.	C	T	1	3	4	0	0	4	0	0
16	16908229	.	C	T	5	2	7	0	0	7	0	0
16	16908238	.	G	A	5	2	7	0	0	7	0	0
16	16912252	.	T	G	3	5	8	0	0	8	0	0
16	16913096	.	C	T	4	7	11	0	0	11	0	0
16	16913102	.	G	A	8	3	11	0	0	11	0	0
16	16920424	.	C	T	5	3	8	0	0	8	0	0
16	16921088	.	C	T	4	3	7	0	1	8	0	0
16	16928396	.	T	C	6	4	10	0	0	10	0	0
16	16928424	.	A	G	5	3	8	0	0	8	0	0
16	16928437	.	C	T	5	4	9	0	0	9	0	0
16	16932986	.	C	T	7	4	11	0	0	11	0	0
16	16939462	.	C	T	1	4	5	0	0	5	0	0
16	16940700	.	A	G	2	5	7	0	0	7	0	0
16	16940824	.	A	C	7	8	15	0	2	17	0	0
16	16941019	.	T	C	4	10	14	0	1	15	0	0
16	16941162	.	T	C	9	9	18	0	0	18	0	0
16	16941270	.	G	A	0	11	11	0	7	18	0	0
16	16941343	.	G	A	2	11	13	0	1	14	0	0
16	16941527	.	A	C	8	6	14	0	1	15	0	0
16	16941533	.	G	T	9	6	15	0	0	15	0	0
16	16941741	.	C	T	16	8	24	0	0	24	0	0
16	16941776	.	A	T	5	12	17	0	0	17	0	0
16	16941979	.	C	A	6	7	13	0	4	17	0	0
16	16942001	.	G	A	0	6	6	0	8	14	0	0
16	16942293	.	T	A	5	11	16	0	0	16	0	0
16	16942906	.	C	G	9	15	24	2	0	26	0	0
16	16943024	.	C	T	7	9	16	0	1	17	0	0
16	16943111	.	A	G	12	7	19	0	1	20	0	0
16	16943348	.	C	A	11	13	24	0	0	24	0	0
16	16943720	.	G	A	7	12	19	0	0	19	0	0
16	16944259	.	A	T	10	9	19	0	1	20	0	0
16	16944260	.	C	T	10	9	19	0	1	20	0	0
16	16944348	.	G	A	17	8	25	0	1	26	0	0
16	16944941	.	G	T	16	6	22	0	0	22	0	0
16	16945128	.	T	G	6	7	13	0	0	13	0	0
16	16945208	.	C	T	1	3	4	0	0	4	0	0
16	16945261	.	A	G	3	6	9	0	0	9	0	0
16	16985499	.	C	T	34	24	58	0	4	62	0	0
16	16985511	.	A	T	36	27	63	1	1	65	0	0
16	17070845	.	A	G	1	2	3	0	0	3	0	0
16	17120136	.	C	T	13	15	28	0	2	30	0	0
16	17122132	.	C	A	2	5	7	0	8	15	0	0
16	17137034	.	T	A	3	6	9	0	0	9	0	0
16	17161580	.	T	C	7	0	7	0	9	16	0	0
16	17161739	.	G	A	6	8	14	0	0	14	0	0
16	17161877	.	A	G	11	11	22	0	0	22	0	0
16	17162558	.	G	A	4	4	8	0	1	9	0	0
16	17162788	.	A	T	6	2	8	0	0	8	0	0
16	17207612	.	G	A	27	15	42	0	3	45	0	0
16	17235251	.	G	A	5	4	9	0	1	10	0	0
16	17252774	.	G	T	5	9	14	0	3	17	0	0
16	17253023	.	G	A	0	9	9	0	11	20	0	0
16	17253105	.	C	A	8	9	17	0	0	17	0	0
16	17253161	.	A	G	2	7	9	0	0	9	0	0
16	17253223	.	A	G	3	7	10	0	0	10	0	0
16	17253293	.	C	T	10	4	14	0	0	14	0	0
16	17253377	.	C	T	11	2	13	0	0	13	0	0
16	17256113	.	C	T	5	7	12	0	0	12	0	0
16	17302526	.	T	C	8	5	13	0	0	13	0	0
16	17302821	.	A	G	9	7	16	0	0	16	0	0
16	17305481	.	T	C	5	5	10	0	1	11	0	0
16	17305579	.	G	A	6	7	13	0	0	13	0	0
16	17305597	.	C	T	7	5	12	0	0	12	0	0
16	17305620	.	A	G	5	8	13	0	0	13	0	0
16	17311420	.	A	G	2	3	5	0	0	5	0	0
16	17316782	.	G	A	4	5	9	0	1	10	0	0
16	17465977	.	T	A	8	10	18	0	0	18	0	0
16	17466824	.	A	T	4	8	12	0	1	13	0	0
16	17466839	.	T	G	3	7	10	0	1	11	0	0
16	17548995	.	C	A	1	2	3	0	0	3	0	0
16	17550202	.	T	C	6	1	7	0	1	8	0	0
16	17550954	.	T	A	1	2	3	0	0	3	0	0
16	17580036	.	C	T	3	6	9	0	0	9	0	0
16	17580300	.	G	T	2	5	7	0	0	7	0	0
16	17585730	.	T	A	4	3	7	0	1	8	0	0
16	17646269	.	T	C	11	7	18	0	0	18	0	0
16	17798055	.	T	C	6	3	9	0	0	9	0	0
16	17798056	.	C	T	5	3	8	0	0	8	0	0
16	18087402	.	A	T	1	4	5	0	0	5	0	0
16	18142776	.	A	G	2	2	4	0	1	5	0	0
16	18535689	.	G	A	7	6	13	0	0	13	0	0
16	18568933	.	C	T	9	5	14	0	1	17	2	0
16	19100141	.	C	T	4	3	7	0	0	7	0	0
16	19100144	.	T	A	4	3	7	0	0	7	0	0
16	19124404	.	T	C	5	9	14	0	0	14	0	0
16	19124452	.	A	G	5	4	9	0	0	9	0	0
16	19126439	.	A	G	6	0	6	0	3	9	0	0
16	19136123	.	A	G	3	6	9	0	0	9	0	0
16	19136328	.	C	T	2	5	7	0	0	7	0	0
16	19141337	.	T	C	5	8	13	0	1	14	0	0
16	19143578	.	T	C	4	4	8	0	0	8	0	0
16	19145102	.	C	T	8	5	13	0	0	13	0	0
16	19150643	.	A	T	8	4	12	0	3	15	0	0
16	19150678	.	C	T	5	6	11	0	2	13	0	0
16	19151174	.	C	A	7	2	9	0	1	10	0	0
16	19151534	.	T	C	5	6	11	0	1	12	0	0
16	19151656	.	G	T	3	8	11	0	0	11	0	0
16	19840562	.	T	C	9	9	18	0	1	19	0	0
16	19840645	.	T	A	13	9	22	0	2	24	0	0
16	19840658	.	A	C	13	12	25	0	2	27	0	0
16	19840792	.	C	T	17	18	35	0	0	35	0	0
16	19841213	.	G	A	13	14	27	0	1	28	0	0
16	19841215	.	C	T	14	13	27	0	1	28	0	0
16	19841443	.	G	C	3	5	8	0	0	8	0	0
16	19841501	.	T	C	3	10	13	0	1	14	0	0
16	19841591	.	A	G	16	7	23	0	1	24	0	0
16	19841720	.	A	G	13	7	20	0	0	20	0	0
16	19841786	.	A	T	6	8	14	0	0	15	1	0
16	19841890	.	G	A	6	5	11	0	0	11	0	0
16	19842493	.	G	A	13	10	23	1	1	25	0	0
16	19842530	.	A	G	10	8	18	1	2	21	0	0
16	19843053	.	G	T	7	16	23	0	0	24	1	0
16	19843056	.	G	T	17	5	22	0	0	23	1	0
16	19850746	.	G	A	15	15	30	0	1	31	0	0
16	19853074	.	G	A	19	18	37	0	1	38	0	0
16	19853098	.	C	T	20	14	34	0	6	40	0	0
16	19853125	.	A	T	19	13	32	0	2	34	0	0
16	19853230	.	A	C	16	8	24	0	1	25	0	0
16	19854886	.	C	T	1	6	7	0	5	12	0	0
16	19861463	.	A	G	13	10	23	0	0	23	0	0
16	19861475	.	G	A	11	10	21	0	1	22	0	0
16	19864588	.	G	T	4	6	10	0	0	10	0	0
16	19878856	.	G	A	6	7	13	0	1	14	0	0
16	20055989	.	T	C	2	2	4	0	1	5	0	0
16	20126448	.	G	T	0	3	3	0	2	5	0	0
16	20134015	.	A	G	4	3	7	0	0	7	0	0
16	20140877	.	T	G	3	5	8	0	0	8	0	0
16	20151309	.	C	T	12	9	21	0	1	22	0	0
16	20151397	.	C	T	12	6	18	0	1	19	0	0
16	20151460	.	C	T	8	7	15	0	0	15	0	0
16	20151841	.	T	C	9	6	15	0	0	15	0	0
16	20151991	.	G	A	16	8	24	0	1	25	0	0
16	20152044	.	C	A	8	4	12	0	0	15	3	0
16	20152128	.	G	A	0	6	6	0	5	11	0	0
16	20152474	.	A	G	6	4	10	0	0	10	0	0
16	20161823	.	G	A	2	1	3	0	1	4	0	0
16	20187253	.	G	T	3	2	5	0	0	5	0	0
16	20236877	.	C	T	1	2	3	0	0	3	0	0
16	20265655	.	T	C	0	6	6	0	3	9	0	0
16	20265928	.	C	T	3	3	6	0	1	7	0	0
16	20266055	.	T	C	2	4	6	0	0	6	0	0
16	20266321	.	T	C	4	2	6	0	0	6	0	0
16	20266799	.	A	C	4	11	15	0	0	15	0	0
16	20266840	.	T	A	8	6	14	0	0	14	0	0
16	20267424	.	A	T	4	2	6	1	0	7	0	0
16	20267604	.	T	A	0	3	3	0	0	3	0	0
16	20267909	.	A	T	4	6	10	0	2	12	0	0
16	20268143	.	T	A	5	4	9	0	0	9	0	0
16	20268145	.	T	A	5	4	9	0	0	9	0	0
16	20268322	.	A	G	2	3	5	0	0	5	0	0
16	20268328	.	A	T	2	3	5	0	0	5	0	0
16	20268470	.	C	T	1	3	4	0	0	4	0	0
16	20289511	.	T	C	1	5	6	0	0	6	0	0
16	20289537	.	T	C	3	4	7	0	0	7	0	0
16	20324870	.	C	T	5	8	13	0	0	13	0	0
16	20324891	.	A	G	11	5	16	0	1	17	0	0
16	20328092	.	C	T	0	4	4	0	7	11	0	0
16	20402034	.	A	C	3	0	3	0	13	16	0	0
16	20497242	.	C	T	2	3	5	0	0	5	0	0
16	20499829	.	G	A	1	2	3	0	0	3	0	0
16	20499859	.	G	A	3	2	5	0	0	5	0	0
16	20512387	.	G	C	3	4	7	0	0	7	0	0
16	20512408	.	A	C	4	3	7	0	0	7	0	0
16	20512661	.	T	C	7	6	13	0	0	13	0	0
16	20513103	.	T	G	18	1	19	0	7	26	0	0
16	20513152	.	A	G	7	9	16	0	1	17	0	0
16	20514738	.	G	A	4	3	7	0	0	7	0	0
16	20800347	.	C	T	21	8	29	0	0	29	0	0
16	20806487	.	C	T	25	19	44	0	5	49	0	0
16	20813628	.	C	T	2	14	16	0	28	44	0	0
16	20822881	.	T	C	15	17	32	0	0	32	0	0
16	20824508	.	C	G	14	12	26	0	0	26	0	0
16	20824566	.	C	T	14	9	23	0	0	23	0	0
16	20826697	.	T	C	16	24	40	0	1	41	0	0
16	20826703	.	G	A	22	17	39	0	1	40	0	0
16	20836206	.	C	T	15	19	34	0	0	34	0	0
16	20836218	.	G	A	19	12	31	0	1	32	0	0
16	20855582	.	G	A	18	7	25	0	0	25	0	0
16	20855636	.	C	T	13	13	26	0	0	26	0	0
16	20889325	.	C	T	5	3	8	0	1	9	0	0
16	21038585	.	A	T	4	6	10	0	0	10	0	0
16	21038697	.	A	C	5	3	8	0	1	9	0	0
16	21038801	.	T	A	9	9	18	0	0	18	0	0
16	21038832	.	T	A	10	12	22	0	1	23	0	0
16	21038924	.	G	A	8	7	15	0	0	15	0	0
16	21039939	.	G	C	5	6	11	0	1	12	0	0
16	21144811	.	C	G	1	2	3	0	0	3	0	0
16	21166857	.	C	T	3	2	5	0	0	5	0	0
16	21444126	.	A	T	1	2	3	0	0	3	0	0
16	21444560	.	T	G	2	2	4	0	0	4	0	0
16	21444572	.	T	G	1	2	3	0	2	5	0	0
16	21548456	.	C	T	3	3	6	0	1	7	0	0
16	21548547	.	G	A	9	4	13	0	0	13	0	0
16	21548556	.	G	A	9	3	12	0	0	12	0	0
16	21548776	.	C	T	4	6	10	0	0	10	0	0
16	21548881	.	T	C	8	2	10	0	2	12	0	0
16	21548891	.	A	T	9	3	12	0	0	12	0	0
16	21549520	.	C	T	0	6	6	0	7	13	0	0
16	21549539	.	A	C	4	5	9	0	1	10	0	0
16	21549924	.	C	T	2	5	7	0	0	7	0	0
16	21549984	.	C	T	2	3	5	0	2	7	0	0
16	21550124	.	G	A	1	2	3	0	0	3	0	0
16	21550251	.	C	A	5	3	8	0	0	8	0	0
16	21550255	.	T	A	5	3	8	0	0	8	0	0
16	21550318	.	C	T	4	3	7	0	0	7	0	0
16	21551749	.	T	G	3	2	5	1	0	6	0	0
16	21552026	.	C	T	0	1	1	0	4	5	0	0
16	21552029	.	T	C	3	2	5	0	0	5	0	0
16	21552107	.	G	T	1	3	4	0	0	4	0	0
16	21553079	.	C	T	1	2	3	0	1	4	0	0
16	21556328	.	T	C	3	2	5	0	0	5	0	0
16	21570198	.	C	T	0	2	2	0	1	3	0	0
16	21651780	.	T	C	4	0	4	0	9	13	0	0
16	21652059	.	T	A	19	9	28	0	0	28	0	0
16	21655336	.	C	T	10	4	14	0	0	14	0	0
16	21655611	.	G	A	6	8	14	0	0	14	0	0
16	21663023	.	G	A	2	7	9	0	0	9	0	0
16	21665605	.	G	T	9	3	12	0	0	12	0	0
16	21668067	.	T	C	2	0	2	0	5	7	0	0
16	21673726	.	A	G	2	2	4	0	0	4	0	0
16	21673735	.	G	A	3	2	5	0	0	5	0	0
16	21691065	.	T	G	2	4	6	0	0	6	0	0
16	21711829	.	G	A	2	3	5	0	0	5	0	0
16	21734574	.	A	G	3	4	7	0	0	7	0	0
16	21738666	.	A	T	20	8	28	0	2	30	0	0
16	21739233	.	G	A	19	11	30	0	3	33	0	0
16	21763843	.	G	A	14	19	33	0	2	35	0	0
16	21769044	.	G	A	17	13	30	0	0	30	0	0
16	21777508	.	G	C	9	0	9	0	7	16	0	0
16	21780023	.	G	A	3	2	5	0	0	5	0	0
16	21782076	.	C	A	6	2	8	0	0	8	0	0
16	21892304	.	T	C	15	0	15	0	5	20	0	0
16	21892312	.	C	A	15	4	19	0	2	21	0	0
16	21898159	.	T	A	6	5	11	0	0	11	0	0
16	21898267	.	A	T	6	3	9	0	0	9	0	0
16	21898279	.	C	T	7	6	13	0	1	14	0	0
16	21899211	.	C	T	6	8	14	0	1	15	0	0
16	21899384	.	C	G	1	8	9	0	6	15	0	0
16	21900294	.	A	G	7	11	18	0	0	18	0	0
16	21900333	.	C	A	0	12	12	0	14	26	0	0
16	21902949	.	G	A	6	5	11	0	0	11	0	0
16	21903803	.	A	G	7	7	14	0	0	14	0	0
16	21903845	.	C	T	6	4	10	0	2	12	0	0
16	21903911	.	C	A	0	5	5	0	3	8	0	0
16	21904091	.	G	A	3	4	7	0	1	8	0	0
16	21905681	.	A	G	7	4	11	0	2	13	0	0
16	21905814	.	G	A	10	11	21	0	1	22	0	0
16	21906282	.	A	C	8	0	8	0	8	16	0	0
16	21907744	.	A	G	1	3	4	0	0	4	0	0
16	21908775	.	T	C	2	2	4	0	0	4	0	0
16	21909747	.	A	T	1	2	3	0	0	3	0	0
16	21912189	.	A	G	4	2	6	0	0	6	0	0
16	21912963	.	C	A	4	4	8	0	0	8	0	0
16	21912997	.	G	A	10	6	16	0	0	16	0	0
16	21913069	.	T	A	5	3	8	0	1	9	0	0
16	21913091	.	T	A	4	6	10	0	0	10	0	0
16	21913221	.	A	C	2	2	4	0	0	4	0	0
16	21913227	.	G	C	2	3	5	0	0	5	0	0
16	21917148	.	A	C	4	5	9	0	1	10	0	0
16	21922245	.	T	G	1	3	4	0	0	4	0	0
16	21922530	.	C	G	1	0	1	0	3	4	0	0
16	21928360	.	G	A	1	3	4	0	1	5	0	0
16	21928619	.	A	T	3	2	5	0	0	5	0	0
16	21933946	.	G	A	0	4	4	0	3	7	0	0
16	21937616	.	C	G	2	3	5	0	0	5	0	0
16	21937712	.	T	C	2	2	4	0	0	4	0	0
16	21937745	.	C	T	1	2	3	0	0	3	0	0
16	21937834	.	C	G	4	4	8	0	0	8	0	0
16	21937991	.	G	T	1	3	4	0	1	5	0	0
16	22064488	.	T	C	1	2	3	0	0	3	0	0
16	22217835	.	T	C	6	0	6	0	3	9	0	0
16	22218117	.	A	G	2	2	4	0	0	4	0	0
16	22218355	.	C	A	3	2	5	0	0	5	0	0
16	22222804	.	G	A	1	3	4	0	0	4	0	0
16	22222813	.	C	T	1	3	4	0	0	4	0	0
16	22224698	.	A	G	2	3	5	0	0	5	0	0
16	22224707	.	C	G	2	3	5	0	0	5	0	0
16	22354677	.	A	G	3	4	7	0	1	8	0	0
16	22358841	.	T	A	4	8	12	0	0	12	0	0
16	22358944	.	A	T	7	3	10	0	1	11	0	0
16	22358947	.	T	A	8	4	12	0	0	12	0	0
16	22360552	.	G	A	5	11	16	0	2	18	0	0
16	22360577	.	G	A	7	10	17	0	4	21	0	0
16	22361101	.	T	C	12	8	20	0	3	23	0	0
16	22363956	.	G	A	13	4	17	0	1	18	0	0
16	22363957	.	G	A	13	5	18	0	0	18	0	0
16	22364064	.	C	T	15	11	26	0	0	26	0	0
16	22364067	.	T	G	16	11	27	0	0	27	0	0
16	22364241	.	A	C	21	15	36	1	2	39	0	0
16	22364501	.	A	C	2	5	7	0	1	8	0	0
16	22365562	.	C	G	5	2	7	1	0	8	0	0
16	22368962	.	T	A	6	5	11	0	3	14	0	0
16	22659905	.	A	G	4	6	10	0	0	10	0	0
16	22660094	.	C	A	5	3	8	0	0	8	0	0
16	22673219	.	C	T	7	13	20	0	0	20	0	0
16	22673234	.	C	T	9	13	22	0	0	22	0	0
16	22673528	.	C	G	7	13	20	0	1	21	0	0
16	22673804	.	G	T	6	9	15	0	0	15	0	0
16	22673817	.	G	T	7	8	15	0	0	15	0	0
16	22674181	.	A	C	4	3	7	0	0	7	0	0
16	22674317	.	A	G	8	8	16	0	0	16	0	0
16	22674427	.	C	T	5	6	11	0	1	12	0	0
16	22674490	.	G	A	5	3	8	0	0	8	0	0
16	22675081	.	T	A	5	9	14	0	0	14	0	0
16	22675110	.	A	T	5	10	15	0	0	15	0	0
16	22675253	.	C	T	7	4	11	0	1	12	0	0
16	22675310	.	T	A	4	3	7	0	0	7	0	0
16	22675367	.	C	A	6	9	15	0	0	15	0	0
16	22675418	.	T	C	9	13	22	0	1	23	0	0
16	22675574	.	T	C	9	11	20	0	0	20	0	0
16	22675663	.	T	C	10	8	18	0	0	18	0	0
16	22675795	.	G	A	0	4	4	0	4	8	0	0
16	22676478	.	G	C	3	3	6	0	0	6	0	0
16	22676527	.	C	T	6	2	8	0	0	8	0	0
16	22676589	.	G	T	9	9	18	2	0	20	0	0
16	22676671	.	T	A	9	9	18	0	4	22	0	0
16	22677037	.	C	A	8	10	18	0	0	18	0	0
16	22677086	.	G	A	11	14	25	0	2	27	0	0
16	22677206	.	C	A	18	8	26	0	0	26	0	0
16	22677276	.	A	G	15	11	26	0	1	27	0	0
16	22677537	.	A	G	4	9	13	0	0	13	0	0
16	22750244	.	A	T	5	6	11	0	0	11	0	0
16	22750506	.	A	G	16	17	33	0	0	33	0	0
16	22750566	.	G	A	20	12	32	0	0	32	0	0
16	22750579	.	A	G	16	12	28	0	2	30	0	0
16	22750610	.	A	T	17	13	30	0	0	30	0	0
16	22750693	.	G	A	24	8	32	0	1	33	0	0
16	22750718	.	A	T	18	6	24	0	1	25	0	0
16	22750754	.	G	A	6	9	15	0	0	15	0	0
16	22750781	.	A	G	10	7	17	0	1	18	0	0
16	22750839	.	A	G	5	7	12	0	0	12	0	0
16	22751093	.	C	A	9	7	16	0	1	17	0	0
16	22751101	.	C	T	6	5	11	0	1	12	0	0
16	22751129	.	T	A	6	3	9	0	1	10	0	0
16	22751376	.	A	C	3	4	7	0	1	8	0	0
16	22751426	.	T	C	6	4	10	0	0	10	0	0
16	22751926	.	C	T	5	4	9	0	0	9	0	0
16	22752009	.	T	C	9	0	9	1	4	14	0	0
16	22752154	.	G	A	14	15	29	0	1	30	0	0
16	22752182	.	G	T	13	9	22	0	5	27	0	0
16	22752274	.	G	C	13	5	18	0	1	21	2	0
16	22752279	.	T	C	10	5	15	0	3	18	0	0
16	22752328	.	G	A	5	5	10	0	1	11	0	0
16	22752345	.	C	T	4	5	9	0	0	9	0	0
16	22752399	.	G	A	6	3	9	0	0	9	0	0
16	22752531	.	T	C	5	6	11	0	0	11	0	0
16	22752624	.	C	T	4	8	12	0	0	12	0	0
16	22752625	.	G	A	8	3	11	0	0	11	0	0
16	22752779	.	A	G	5	5	10	0	0	10	0	0
16	22752804	.	T	C	8	4	12	0	1	13	0	0
16	22752829	.	C	A	8	9	17	0	0	17	0	0
16	22752868	.	C	T	8	6	14	0	2	16	0	0
16	22752889	.	G	A	8	6	14	0	1	15	0	0
16	22752954	.	T	C	7	6	13	0	2	15	0	0
16	22753017	.	G	A	3	4	7	0	0	7	0	0
16	22753116	.	C	A	2	6	8	1	8	17	0	0
16	22753185	.	C	T	8	6	14	0	0	14	0	0
16	22753380	.	T	G	18	11	29	0	1	30	0	0
16	22753452	.	G	A	16	8	24	0	1	25	0	0
16	22753574	.	C	T	1	14	15	1	10	26	0	0
16	22753583	.	T	C	9	0	9	1	17	27	0	0
16	22753626	.	C	T	17	13	30	1	1	32	0	0
16	22753631	.	C	T	14	12	26	0	3	29	0	0
16	22753784	.	T	C	15	0	15	0	10	25	0	0
16	22767597	.	A	G	5	7	12	0	0	12	0	0
16	22767646	.	G	A	7	8	15	0	0	15	0	0
16	22767732	.	A	G	3	3	6	0	0	6	0	0
16	22767796	.	C	G	1	5	6	0	0	6	0	0
16	22771212	.	T	A	2	4	6	0	1	7	0	0
16	22782175	.	G	T	3	3	6	0	0	6	0	0
16	22782306	.	A	T	9	10	19	0	1	20	0	0
16	22782308	.	A	T	9	10	19	0	1	20	0	0
16	22782422	.	C	T	1	9	10	0	11	21	0	0
16	22782443	.	A	T	8	13	21	0	0	21	0	0
16	22782458	.	T	C	9	11	20	0	0	20	0	0
16	22782682	.	T	G	10	6	16	0	0	16	0	0
16	22782904	.	G	C	9	13	22	0	0	22	0	0
16	22783338	.	C	G	1	6	7	0	9	16	0	0
16	22783978	.	A	G	10	11	21	0	0	21	0	0
16	22783995	.	T	C	10	0	10	0	10	20	0	0
16	22796434	.	T	G	8	6	14	0	0	14	0	0
16	22866015	.	T	C	2	2	4	0	2	6	0	0
16	22866017	.	C	A	3	3	6	0	0	6	0	0
16	22868973	.	T	C	1	4	5	0	0	5	0	0
16	22872602	.	G	A	11	3	14	0	0	14	0	0
16	22872657	.	A	C	13	4	17	0	2	19	0	0
16	22872693	.	T	C	13	5	18	0	1	19	0	0
16	22872694	.	C	T	13	6	19	0	0	19	0	0
16	22872927	.	T	C	12	9	21	0	0	21	0	0
16	22878965	.	T	A	6	5	11	0	3	14	0	0
16	22879035	.	A	G	4	0	4	0	5	9	0	0
16	22879055	.	G	T	6	3	9	0	0	9	0	0
16	22879071	.	A	G	6	2	8	0	2	10	0	0
16	22879104	.	T	A	5	3	8	0	0	8	0	0
16	22879128	.	G	C	2	2	4	0	0	4	0	0
16	23087656	.	G	A	3	2	5	0	0	5	0	0
16	23961950	.	C	A	13	6	19	0	0	19	0	0
16	23962010	.	T	C	11	10	21	0	1	22	0	0
16	23963246	.	C	T	17	18	35	0	0	35	0	0
16	23963315	.	G	T	18	19	37	0	2	39	0	0
16	23972939	.	G	A	16	4	20	0	1	21	0	0
16	23973477	.	G	A	16	22	38	0	2	40	0	0
16	24135445	.	T	C	3	4	7	0	0	7	0	0
16	24190674	.	C	T	3	2	5	0	0	5	0	0
16	24190746	.	G	C	1	2	3	0	0	3	0	0
16	24190817	.	T	A	2	3	5	0	0	5	0	0
16	24190879	.	A	G	0	3	3	0	1	4	0	0
16	24213444	.	T	A	18	15	33	1	2	36	0	0
16	24213446	.	T	A	19	16	35	1	1	37	0	0
16	24213538	.	G	T	29	13	42	0	6	48	0	0
16	24213657	.	G	A	19	24	43	0	1	44	0	0
16	24213666	.	T	G	20	26	46	0	2	48	0	0
16	24213793	.	T	C	21	25	46	0	3	49	0	0
16	24214023	.	A	G	31	26	57	0	6	63	0	0
16	24214106	.	T	C	31	1	32	0	23	55	0	0
16	24214468	.	T	C	38	28	66	0	2	68	0	0
16	24261594	.	C	G	19	14	33	0	0	33	0	0
16	24277750	.	C	T	17	17	34	0	1	35	0	0
16	24302164	.	G	A	8	16	24	1	0	25	0	0
16	24552024	.	A	T	2	3	5	0	0	5	0	0
16	24552032	.	G	A	4	2	6	0	0	6	0	0
16	24552081	.	C	T	5	4	9	0	0	9	0	0
16	24553018	.	G	T	4	4	8	0	1	9	0	0
16	24553082	.	T	A	3	4	7	0	0	7	0	0
16	24553141	.	T	A	6	2	8	0	0	8	0	0
16	24553450	.	T	C	5	9	14	0	1	15	0	0
16	24553621	.	C	T	4	2	6	0	1	7	0	0
16	24553633	.	A	G	3	5	8	0	0	8	0	0
16	24554438	.	T	A	4	3	7	0	1	8	0	0
16	24554475	.	A	G	8	6	14	0	3	17	0	0
16	24590767	.	T	A	19	18	37	0	3	40	0	0
16	24590823	.	C	T	19	16	35	0	3	38	0	0
16	24591172	.	A	G	12	22	34	0	0	34	0	0
16	24591245	.	A	T	7	11	18	0	2	20	0	0
16	24591258	.	A	G	8	11	19	0	1	20	0	0
16	24591287	.	C	T	4	8	12	0	12	24	0	0
16	24591330	.	A	G	22	10	32	1	0	33	0	0
16	24591360	.	G	A	18	6	24	1	1	26	0	0
16	24591410	.	G	A	5	5	10	0	2	12	0	0
16	24591693	.	G	C	27	21	48	0	2	50	0	0
16	24591751	.	C	T	26	13	39	0	3	43	1	0
16	24591794	.	G	T	10	31	41	0	1	42	0	0
16	24632121	.	G	T	5	7	12	0	0	12	0	0
16	24632231	.	C	T	13	14	27	2	0	29	0	0
16	24645448	.	C	G	15	9	24	0	1	25	0	0
16	24645620	.	T	G	6	10	16	0	0	16	0	0
16	24695160	.	G	T	14	21	35	0	1	36	0	0
16	24695301	.	T	C	29	24	53	0	2	55	0	0
16	24695322	.	G	T	0	24	24	0	29	53	0	0
16	24695520	.	G	A	36	36	72	0	1	73	0	0
16	24695525	.	A	C	33	35	68	0	3	71	0	0
16	24695681	.	A	T	27	29	56	0	3	59	0	0
16	24730634	.	C	A	8	9	17	0	0	17	0	0
16	24732602	.	A	G	10	0	10	0	6	16	0	0
16	24820061	.	A	G	1	2	3	0	0	3	0	0
16	24872681	.	G	T	3	2	5	0	0	5	0	0
16	24916108	.	T	C	1	6	7	0	0	7	0	0
16	24918478	.	C	T	1	4	5	0	0	5	0	0
16	24918564	.	A	G	3	2	5	0	0	5	0	0
16	24918604	.	T	C	1	3	4	0	0	4	0	0
16	24918619	.	C	T	1	3	4	0	0	4	0	0
16	24990141	.	G	A	1	3	4	0	1	5	0	0
16	24990255	.	T	A	4	3	7	0	0	7	0	0
16	24990261	.	A	G	3	3	6	0	0	6	0	0
16	24990850	.	C	T	4	5	9	0	0	9	0	0
16	24991225	.	C	G	9	5	14	0	0	14	0	0
16	24991239	.	G	A	1	5	6	0	9	15	0	0
16	24991333	.	T	C	4	8	12	0	0	12	0	0
16	24991593	.	A	T	11	7	18	0	0	18	0	0
16	24991636	.	G	A	5	5	10	0	1	11	0	0
16	24991637	.	C	T	5	6	11	0	0	11	0	0
16	24991741	.	T	C	7	4	11	0	0	11	0	0
16	24991763	.	G	C	3	3	6	0	1	7	0	0
16	24991919	.	T	A	4	5	9	0	1	10	0	0
16	24991940	.	T	A	7	4	11	0	0	11	0	0
16	24992017	.	A	C	3	6	9	0	0	9	0	0
16	24992080	.	A	G	2	2	4	0	0	4	0	0
16	25012143	.	T	A	2	1	3	0	0	3	0	0
16	25012935	.	T	A	2	4	6	0	0	6	0	0
16	25033173	.	G	A	4	4	8	0	1	9	0	0
16	25033191	.	C	T	1	4	5	0	1	6	0	0
16	25033809	.	G	A	5	6	11	0	0	11	0	0
16	25034683	.	A	T	6	8	14	0	1	15	0	0
16	25034715	.	C	T	7	12	19	0	0	19	0	0
16	25036217	.	C	T	11	7	18	0	0	18	0	0
16	25038185	.	A	T	8	5	13	0	0	13	0	0
16	25038429	.	C	T	5	8	13	0	0	13	0	0
16	25068507	.	C	T	1	2	3	0	0	3	0	0
16	25070393	.	A	C	4	5	9	0	0	9	0	0
16	25071019	.	G	A	5	10	15	0	0	15	0	0
16	25071614	.	C	T	14	8	22	0	1	23	0	0
16	25071782	.	G	A	2	9	11	0	11	22	0	0
16	25072355	.	G	A	11	5	16	0	0	16	0	0
16	25076919	.	G	C	5	5	10	0	2	12	0	0
16	25077608	.	C	T	4	6	10	0	0	10	0	0
16	25078397	.	G	T	8	3	11	0	0	11	0	0
16	25078715	.	A	G	6	7	13	1	0	14	0	0
16	25078907	.	T	A	4	3	7	0	0	7	0	0
16	25079407	.	A	C	1	2	3	0	1	4	0	0
16	25079434	.	A	C	6	3	9	0	0	9	0	0
16	25079467	.	C	T	10	3	13	0	0	13	0	0
16	25080042	.	G	T	1	3	4	0	1	5	0	0
16	25080190	.	T	A	3	2	5	0	0	5	0	0
16	25080207	.	C	T	2	3	5	0	1	6	0	0
16	25080306	.	T	C	2	4	6	0	0	6	0	0
16	25080367	.	G	A	4	3	7	0	0	7	0	0
16	25104031	.	T	C	15	17	32	0	2	34	0	0
16	25104454	.	C	G	9	21	30	0	4	34	0	0
16	25104543	.	C	T	14	9	23	0	0	23	0	0
16	25104850	.	A	C	12	11	23	0	0	23	0	0
16	25104899	.	T	G	16	11	27	0	0	27	0	0
16	25104941	.	T	C	21	8	29	0	1	30	0	0
16	25111665	.	C	A	3	3	6	0	0	6	0	0
16	25111794	.	G	A	5	3	8	0	0	8	0	0
16	25111899	.	G	A	5	3	8	0	0	8	0	0
16	25112001	.	A	G	1	4	5	0	0	5	0	0
16	25112769	.	C	T	6	9	15	0	0	15	0	0
16	25113741	.	G	A	0	3	3	0	4	7	0	0
16	25119126	.	C	T	1	4	5	0	0	5	0	0
16	25119142	.	A	C	0	4	4	0	0	4	0	0
16	25121970	.	C	T	3	4	7	0	1	8	0	0
16	25122387	.	C	T	8	3	11	0	0	11	0	0
16	25122798	.	C	T	9	3	12	0	0	12	0	0
16	25123037	.	G	A	4	2	6	0	0	6	0	0
16	25123058	.	A	G	6	2	8	0	0	8	0	0
16	25123075	.	A	G	6	0	6	0	2	8	0	0
16	25123382	.	G	T	5	8	13	0	0	13	0	0
16	25123505	.	A	T	1	2	3	0	1	4	0	0
16	25123506	.	C	T	2	2	4	0	0	4	0	0
16	25123832	.	A	G	4	3	7	0	1	8	0	0
16	25123843	.	T	A	6	3	9	0	1	10	0	0
16	25123884	.	C	G	5	3	8	0	1	9	0	0
16	25124662	.	G	T	5	3	8	0	1	9	0	0
16	25124750	.	G	A	3	5	8	0	0	8	0	0
16	25124832	.	C	T	4	2	6	0	0	6	0	0
16	25142389	.	G	T	1	2	3	0	0	3	0	0
16	25146020	.	T	C	1	3	4	0	0	4	0	0
16	25146203	.	G	A	1	3	4	0	0	4	0	0
16	25149018	.	A	T	1	2	3	0	0	3	0	0
16	25149191	.	G	A	1	5	6	0	0	6	0	0
16	25149228	.	C	T	1	5	6	0	0	6	0	0
16	25149254	.	G	T	1	4	5	0	1	6	0	0
16	25149294	.	T	A	3	2	5	0	0	5	0	0
16	25149654	.	T	C	6	6	12	0	0	12	0	0
16	25149797	.	C	G	3	7	10	0	1	11	0	0
16	25149819	.	T	A	2	1	3	0	0	7	4	0
16	25149889	.	A	G	3	4	7	0	1	8	0	0
16	25151012	.	T	C	4	2	6	0	0	6	0	0
16	25151553	.	T	C	2	2	4	0	0	4	0	0
16	25151573	.	T	C	1	3	4	0	0	4	0	0
16	25154081	.	A	C	5	5	10	0	0	10	0	0
16	25154115	.	C	T	5	6	11	0	0	11	0	0
16	25160985	.	G	A	0	3	3	0	4	7	0	0
16	25161315	.	T	C	12	8	20	0	0	20	0	0
16	25161461	.	A	G	3	0	3	0	3	6	0	0
16	25161693	.	G	A	8	4	12	0	1	13	0	0
16	25161873	.	G	A	3	10	13	0	6	19	0	0
16	25161876	.	T	C	11	7	18	0	0	18	0	0
16	25164326	.	C	A	5	7	12	0	1	13	0	0
16	25168548	.	G	A	8	8	16	0	2	18	0	0
16	25168765	.	C	A	14	16	30	0	1	31	0	0
16	25169336	.	G	A	8	10	18	0	2	20	0	0
16	25169595	.	C	T	0	2	2	0	0	2	0	0
16	25169616	.	A	T	3	5	8	0	1	9	0	0
16	25171900	.	G	A	0	0	0	0	2	2	0	0
16	25173993	.	T	A	3	3	6	0	2	8	0	0
16	25176510	.	G	A	5	4	9	0	0	9	0	0
16	25180658	.	C	A	4	4	8	0	0	8	0	0
16	25180674	.	T	A	5	6	11	0	0	11	0	0
16	25180737	.	C	T	4	4	8	0	0	8	0	0
16	25180913	.	A	G	4	0	4	0	4	8	0	0
16	25181046	.	A	G	4	3	7	0	0	7	0	0
16	25181095	.	C	T	3	8	11	0	0	11	0	0
16	25181194	.	G	C	5	6	11	0	0	11	0	0
16	25181213	.	A	G	5	4	9	0	0	9	0	0
16	25181256	.	G	A	4	3	7	0	0	7	0	0
16	25181291	.	T	C	2	2	4	0	0	4	0	0
16	25181350	.	A	T	1	3	4	0	0	4	0	0
16	25232203	.	T	C	0	3	3	0	1	4	0	0
16	25232288	.	C	A	0	3	3	0	5	8	0	0
16	25232421	.	T	C	8	4	12	0	0	12	0	0
16	25232433	.	C	T	0	6	6	0	4	10	0	0
16	25259477	.	T	A	1	3	4	0	1	5	0	0
16	25272148	.	G	T	0	4	4	0	3	7	0	0
16	25272149	.	A	G	3	4	7	0	0	7	0	0
16	25272196	.	C	G	1	4	5	0	0	5	0	0
16	25272529	.	A	C	2	2	4	0	1	5	0	0
16	25275909	.	A	C	4	16	20	0	0	20	0	0
16	25275957	.	C	T	16	6	22	0	2	24	0	0
16	25276281	.	G	A	12	15	27	0	0	27	0	0
16	25276387	.	T	A	13	12	25	0	1	26	0	0
16	25285506	.	G	A	30	14	44	0	2	46	0	0
16	25285507	.	G	A	32	14	46	0	0	46	0	0
16	25308516	.	C	T	3	3	6	0	0	6	0	0
16	25308986	.	G	A	2	2	4	0	0	4	0	0
16	25311772	.	G	A	5	5	10	0	0	10	0	0
16	25314682	.	C	T	7	9	16	0	0	16	0	0
16	25317000	.	G	A	8	4	12	0	0	12	0	0
16	25327155	.	C	A	14	6	20	0	0	20	0	0
16	25327181	.	C	T	13	8	21	0	0	22	1	0
16	25327202	.	G	A	14	13	27	0	0	27	0	0
16	25327730	.	C	T	3	6	9	0	0	9	0	0
16	25329319	.	C	T	6	5	11	0	1	12	0	0
16	25333270	.	A	G	13	11	24	0	1	25	0	0
16	25337248	.	C	A	20	15	35	0	6	42	1	0
16	25337286	.	C	T	20	21	41	0	2	43	0	0
16	25337319	.	G	A	9	19	28	0	0	28	0	0
16	25345961	.	A	G	2	2	4	0	0	4	0	0
16	25349471	.	C	T	3	6	9	0	0	9	0	0
16	25349581	.	G	T	5	3	8	0	0	8	0	0
16	25354571	.	A	G	5	1	6	0	7	13	0	0
16	25360557	.	T	A	9	5	14	0	1	15	0	0
16	25364479	.	T	C	9	7	16	0	1	17	0	0
16	25364589	.	T	C	7	7	14	0	0	14	0	0
16	25364742	.	T	C	6	0	6	0	9	15	0	0
16	25365156	.	C	T	3	4	7	0	1	8	0	0
16	25367503	.	G	A	4	4	8	0	0	8	0	0
16	25367674	.	A	T	3	7	10	0	1	11	0	0
16	25367683	.	A	G	4	5	9	0	0	9	0	0
16	25367788	.	A	G	4	4	8	0	0	8	0	0
16	25367902	.	C	T	2	3	5	0	4	9	0	0
16	25367917	.	C	G	3	5	8	0	0	8	0	0
16	25367938	.	G	C	5	0	5	0	7	12	0	0
16	25373979	.	T	A	6	5	11	1	0	12	0	0
16	25374275	.	T	C	5	4	9	0	1	10	0	0
16	25374507	.	T	C	9	0	9	0	8	17	0	0
16	25375019	.	T	C	6	0	6	0	5	11	0	0
16	25375521	.	C	A	2	3	5	0	0	5	0	0
16	25376046	.	T	A	5	6	11	0	1	12	0	0
16	25376528	.	C	T	2	2	4	0	0	4	0	0
16	25389094	.	G	A	5	13	18	0	0	18	0	0
16	25389106	.	C	T	3	13	16	0	0	16	0	0
16	25395154	.	G	T	6	7	13	0	1	14	0	0
16	25395702	.	G	T	4	9	13	0	1	14	0	0
16	25399585	.	A	T	2	4	6	0	1	7	0	0
16	25399588	.	A	T	2	6	8	0	0	8	0	0
16	25400055	.	G	C	1	5	6	0	0	6	0	0
16	25400061	.	A	T	1	4	5	0	0	5	0	0
16	25445746	.	G	A	7	3	10	0	1	11	0	0
16	25454790	.	C	T	3	3	6	0	0	6	0	0
16	25454829	.	G	T	0	3	3	0	6	9	0	0
16	25463401	.	C	A	5	3	8	0	0	8	0	0
16	25470975	.	A	G	5	3	8	0	1	9	0	0
16	25477428	.	G	A	4	4	8	0	0	8	0	0
16	25477736	.	A	G	1	6	7	0	0	7	0	0
16	25487307	.	T	A	2	3	5	0	0	5	0	0
16	25487775	.	C	T	5	4	9	0	1	10	0	0
16	25490833	.	A	G	3	0	3	0	3	6	0	0
16	25492951	.	C	T	1	3	4	0	0	4	0	0
16	25500137	.	A	G	3	5	8	0	3	11	0	0
16	25500223	.	T	C	3	6	9	0	0	9	0	0
16	25504192	.	G	C	17	9	26	0	2	28	0	0
16	25504337	.	G	A	18	5	23	0	1	24	0	0
16	25504466	.	C	T	17	11	28	0	0	28	0	0
16	25504467	.	G	A	12	16	28	0	1	29	0	0
16	25504792	.	G	C	36	16	52	0	0	52	0	0
16	25504900	.	G	A	31	20	51	0	2	53	0	0
16	25507696	.	T	C	2	2	4	0	0	4	0	0
16	25535229	.	C	T	1	5	6	0	3	9	0	0
16	25556650	.	T	A	15	8	23	0	2	25	0	0
16	25556697	.	A	G	13	10	23	0	0	23	0	0
16	25556710	.	C	T	12	8	20	0	0	20	0	0
16	25556766	.	C	G	2	7	9	0	5	14	0	0
16	25556780	.	A	G	10	8	18	0	0	18	0	0
16	25556802	.	C	A	9	5	14	1	0	15	0	0
16	25556930	.	A	G	8	6	14	0	0	14	0	0
16	25556966	.	T	A	10	12	22	0	0	22	0	0
16	25557400	.	A	G	5	3	8	0	0	8	0	0
16	25557403	.	T	C	5	3	8	0	0	8	0	0
16	25557690	.	C	T	4	4	8	0	1	9	0	0
16	25557806	.	C	T	11	8	19	0	0	19	0	0
16	25558135	.	C	T	10	8	18	0	0	18	0	0
16	25558223	.	A	G	7	5	12	0	2	14	0	0
16	25558351	.	C	T	1	8	9	0	7	16	0	0
16	25558439	.	G	T	12	8	20	0	0	20	0	0
16	25558595	.	C	T	3	14	17	0	3	20	0	0
16	25558597	.	G	A	15	4	19	0	1	20	0	0
16	25558704	.	T	G	5	5	10	0	2	12	0	0
16	25558829	.	C	T	6	6	12	0	1	13	0	0
16	25558892	.	G	A	6	4	10	0	0	10	0	0
16	25558986	.	A	G	12	5	17	0	0	17	0	0
16	25559028	.	A	C	8	4	12	0	0	12	0	0
16	25559193	.	A	G	5	6	11	0	0	11	0	0
16	25559632	.	G	A	9	4	13	0	0	13	0	0
16	25560135	.	T	C	3	0	3	0	3	6	0	0
16	25560184	.	A	G	4	3	7	0	1	8	0	0
16	25560322	.	G	A	4	4	8	0	1	9	0	0
16	25560526	.	T	C	6	3	9	0	0	9	0	0
16	25561175	.	A	G	7	2	9	0	0	9	0	0
16	25561471	.	C	G	3	5	8	0	1	9	0	0
16	25561795	.	C	A	6	9	15	0	0	15	0	0
16	25562480	.	G	A	6	6	12	0	0	12	0	0
16	25562549	.	G	A	3	5	8	0	0	8	0	0
16	25642663	.	G	A	13	10	23	0	0	23	0	0
16	25642673	.	C	T	13	13	26	0	0	26	0	0
16	25643038	.	G	A	8	8	16	0	0	16	0	0
16	25643041	.	G	A	4	8	12	0	5	17	0	0
16	25643113	.	G	C	17	9	26	0	1	27	0	0
16	25643452	.	T	A	6	5	11	0	1	12	0	0
16	25643818	.	G	T	9	5	14	0	1	15	0	0
16	25644357	.	C	A	7	5	12	0	0	12	0	0
16	25644378	.	A	T	6	6	12	0	0	12	0	0
16	25673249	.	T	A	10	6	16	0	0	16	0	0
16	25683018	.	T	C	6	8	14	0	1	15	0	0
16	25683387	.	C	T	0	10	10	0	11	21	0	0
16	25698449	.	A	C	4	4	8	0	0	8	0	0
16	26043044	.	T	A	7	8	15	0	0	15	0	0
16	26141688	.	T	A	10	3	13	0	0	13	0	0
16	26141689	.	G	T	8	3	11	0	2	13	0	0
16	26141785	.	C	A	1	6	7	0	6	13	0	0
16	26141817	.	T	G	10	7	17	0	1	18	0	0
16	26142105	.	C	T	9	4	13	0	0	13	0	0
16	26142311	.	A	C	9	6	15	0	0	15	0	0
16	26142773	.	G	A	10	4	14	0	0	14	0	0
16	26142779	.	C	T	10	3	13	0	0	13	0	0
16	26142900	.	T	C	6	0	6	0	5	11	0	0
16	26143332	.	T	C	10	5	15	0	1	16	0	0
16	26143371	.	T	G	6	8	14	0	1	15	0	0
16	26143538	.	C	T	6	5	11	0	1	12	0	0
16	26143561	.	C	T	5	7	12	0	0	12	0	0
16	26146736	.	G	A	6	5	11	0	0	11	0	0
16	26148741	.	C	T	8	3	11	0	1	12	0	0
16	26148962	.	C	A	5	3	8	0	1	9	0	0
16	26148963	.	C	A	4	4	8	0	0	8	0	0
16	26149005	.	A	T	4	6	10	0	0	10	0	0
16	26169515	.	T	G	2	4	6	0	0	6	0	0
16	26170400	.	A	G	1	5	6	0	0	6	0	0
16	26170412	.	G	A	2	6	8	0	0	8	0	0
16	26234975	.	A	T	1	2	3	0	0	3	0	0
16	26236259	.	C	T	6	4	10	0	1	11	0	0
16	26378382	.	T	C	1	3	4	0	0	4	0	0
16	26378655	.	T	C	3	0	3	0	3	6	0	0
16	26378665	.	G	T	3	3	6	0	0	6	0	0
16	26378706	.	G	T	1	2	3	0	0	3	0	0
16	26379249	.	T	A	2	3	5	0	0	5	0	0
16	26379397	.	G	A	3	2	5	0	0	5	0	0
16	26380784	.	C	T	2	11	13	0	8	21	0	0
16	26380866	.	G	A	11	9	20	0	0	20	0	0
16	26381192	.	T	G	10	13	23	0	1	24	0	0
16	26381271	.	C	T	10	10	20	0	0	20	0	0
16	26381344	.	T	G	11	7	18	0	3	21	0	0
16	26381416	.	C	T	3	18	21	0	12	33	0	0
16	26381463	.	C	T	2	16	18	0	14	32	0	0
16	26381768	.	C	T	1	7	8	0	16	24	0	0
16	26382084	.	T	C	13	9	22	0	1	23	0	0
16	26382225	.	A	T	12	10	22	0	5	27	0	0
16	26382243	.	G	A	18	13	31	0	0	31	0	0
16	26382308	.	T	C	16	16	32	0	2	34	0	0
16	26382585	.	A	G	2	3	5	0	0	5	0	0
16	26382942	.	T	C	16	8	24	0	2	26	0	0
16	26383016	.	C	T	2	16	18	0	22	40	0	0
16	26384188	.	C	G	10	4	14	0	1	15	0	0
16	26384219	.	G	A	5	9	14	0	1	15	0	0
16	26384417	.	G	A	5	3	8	0	2	10	0	0
16	26386817	.	T	C	7	7	14	0	0	14	0	0
16	26388840	.	A	G	7	2	9	0	1	10	0	0
16	26391447	.	A	G	5	2	7	0	0	7	0	0
16	26391450	.	C	T	5	2	7	0	0	7	0	0
16	26391970	.	C	A	0	3	3	0	2	5	0	0
16	26393459	.	G	T	2	2	4	0	0	4	0	0
16	26396381	.	A	C	5	3	8	0	0	8	0	0
16	26398488	.	G	A	2	2	4	0	0	4	0	0
16	26408847	.	C	T	1	2	3	0	0	3	0	0
16	26408967	.	G	A	1	1	2	0	1	3	0	0
16	26439809	.	T	G	3	3	6	0	1	7	0	0
16	26440252	.	G	A	8	3	11	0	0	11	0	0
16	26441526	.	T	A	2	1	3	0	0	3	0	0
16	26441532	.	T	C	2	1	3	0	1	4	0	0
16	26441624	.	A	T	1	5	6	0	0	6	0	0
16	26443958	.	A	T	2	6	8	0	1	9	0	0
16	26443976	.	C	T	8	4	12	0	0	12	0	0
16	26444135	.	T	C	1	4	5	0	0	5	0	0
16	26444165	.	A	T	2	4	6	0	0	6	0	0
16	26444431	.	T	A	4	2	6	0	2	8	0	0
16	26444443	.	A	G	5	4	9	0	1	10	0	0
16	26444505	.	C	T	5	8	13	0	1	14	0	0
16	26444668	.	C	T	2	3	5	0	0	5	0	0
16	26444776	.	G	A	5	3	8	0	0	8	0	0
16	26444830	.	G	A	2	8	10	0	3	13	0	0
16	26445484	.	T	C	5	3	8	0	0	8	0	0
16	26445512	.	A	C	3	3	6	0	0	6	0	0
16	26510997	.	G	A	1	3	4	0	0	4	0	0
16	26517226	.	G	A	1	4	5	0	0	5	0	0
16	26517227	.	T	G	1	4	5	0	0	5	0	0
16	26643598	.	G	C	5	4	9	0	0	9	0	0
16	26689957	.	G	A	3	2	5	0	0	5	0	0
16	26691240	.	G	A	1	2	3	0	0	3	0	0
16	26691491	.	C	T	1	4	5	0	0	5	0	0
16	26691622	.	G	A	3	2	5	0	0	5	0	0
16	26691880	.	C	T	1	2	3	0	0	3	0	0
16	26694669	.	C	T	2	4	6	0	0	6	0	0
16	26702648	.	A	C	1	2	3	0	0	3	0	0
16	26702780	.	G	T	1	7	8	0	3	11	0	0
16	26702786	.	G	A	0	7	7	0	7	14	0	0
16	26706875	.	C	T	6	3	9	0	4	13	0	0
16	26707494	.	A	G	8	8	16	0	0	16	0	0
16	26710900	.	C	A	19	5	24	0	2	26	0	0
16	26710954	.	A	T	17	9	26	0	0	26	0	0
16	26710957	.	G	A	16	9	25	0	1	26	0	0
16	26713964	.	G	T	11	15	26	0	2	28	0	0
16	26717318	.	C	T	3	11	14	0	2	16	0	0
16	26717457	.	C	A	7	6	13	0	0	13	0	0
16	26766475	.	C	T	1	2	3	0	0	3	0	0
16	26766508	.	A	T	3	2	5	0	0	5	0	0
16	26766926	.	G	A	3	4	7	0	0	7	0	0
16	26769118	.	C	T	4	2	6	0	0	6	0	0
16	26769167	.	T	G	7	1	8	0	0	8	0	0
16	26769173	.	G	T	5	3	8	0	1	9	0	0
16	26816799	.	A	G	16	4	20	0	0	20	0	0
16	26816806	.	G	T	14	3	17	0	3	20	0	0
16	26816852	.	G	T	5	8	13	0	1	14	0	0
16	26816885	.	A	G	14	3	17	0	0	17	0	0
16	26816918	.	T	A	12	6	18	0	1	19	0	0
16	26817046	.	T	G	11	4	15	0	1	16	0	0
16	26817069	.	C	T	0	12	12	0	5	17	0	0
16	26817178	.	T	A	5	7	12	0	0	12	0	0
16	26817358	.	C	T	5	11	16	0	0	17	1	0
16	26817631	.	C	T	0	3	3	0	2	5	0	0
16	26817754	.	C	T	0	8	8	0	4	12	0	0
16	26818147	.	G	A	2	3	5	0	0	5	0	0
16	26850638	.	C	T	1	2	3	0	0	3	0	0
16	26850833	.	C	T	4	6	10	0	0	10	0	0
16	26850845	.	T	C	6	7	13	0	0	13	0	0
16	26850885	.	C	T	7	9	16	0	0	16	0	0
16	26851025	.	C	G	3	5	8	0	0	8	0	0
16	26851036	.	T	A	4	2	6	0	2	8	0	0
16	26851110	.	A	C	2	5	7	0	0	7	0	0
16	26851161	.	C	T	1	2	3	0	2	5	0	0
16	26851191	.	C	T	4	5	9	0	1	10	0	0
16	26851236	.	C	T	2	5	7	0	8	15	0	0
16	26851445	.	T	A	6	11	17	0	0	17	0	0
16	26855729	.	C	A	9	12	21	0	1	22	0	0
16	26855786	.	G	A	13	9	22	0	0	22	0	0
16	26855833	.	C	A	1	7	8	0	10	18	0	0
16	26855859	.	C	A	1	8	9	0	12	21	0	0
16	27064864	.	A	G	9	5	14	0	0	14	0	0
16	27069608	.	A	G	10	0	10	0	8	18	0	0
16	27072488	.	G	A	0	5	5	0	6	11	0	0
16	27080221	.	T	C	5	5	10	0	0	10	0	0
16	27089100	.	T	G	4	8	12	0	0	12	0	0
16	27098305	.	T	C	8	15	23	0	0	23	0	0
16	27098530	.	A	G	5	13	18	0	1	19	0	0
16	27098549	.	A	T	6	13	19	0	0	19	0	0
16	27099121	.	A	T	3	4	7	0	0	7	0	0
16	27099508	.	G	A	7	8	15	0	0	15	0	0
16	27100133	.	A	C	12	11	23	0	0	23	0	0
16	27100139	.	A	T	13	10	23	0	0	23	0	0
16	27100198	.	T	A	18	15	33	0	2	35	0	0
16	27100222	.	T	C	17	15	32	0	1	33	0	0
16	27126647	.	C	T	0	12	12	0	6	18	0	0
16	27126998	.	A	G	6	7	13	0	0	13	0	0
16	27126999	.	T	A	5	7	12	0	0	12	0	0
16	27127157	.	G	C	18	16	34	0	0	34	0	0
16	27127158	.	C	A	19	15	34	0	1	35	0	0
16	27127576	.	T	C	19	18	37	0	0	37	0	0
16	27127959	.	G	A	24	15	39	1	1	41	0	0
16	27131005	.	C	T	1	9	10	0	5	15	0	0
16	27136541	.	A	G	12	8	20	0	0	20	0	0
16	27138207	.	C	G	14	7	21	0	0	21	0	0
16	27138391	.	C	G	14	9	23	0	1	24	0	0
16	27148691	.	C	T	10	6	16	0	0	16	0	0
16	27148861	.	G	T	7	6	13	0	2	15	0	0
16	27158741	.	A	T	3	11	14	0	1	15	0	0
16	27159124	.	G	C	5	0	5	0	7	12	0	0
16	27161089	.	G	A	1	4	5	0	0	5	0	0
16	27169529	.	G	A	9	13	22	0	0	22	0	0
16	27169586	.	G	A	11	12	23	0	3	26	0	0
16	27169664	.	A	T	5	16	21	0	0	21	0	0
16	27169809	.	G	A	11	9	20	0	3	23	0	0
16	27170206	.	A	G	8	13	21	0	1	22	0	0
16	27216207	.	C	G	1	3	4	0	0	4	0	0
16	27216353	.	G	A	5	5	10	0	0	10	0	0
16	27216701	.	C	T	4	7	11	0	0	11	0	0
16	27216845	.	C	T	2	4	6	0	4	10	0	0
16	27217103	.	G	C	3	3	6	0	1	7	0	0
16	27223056	.	G	A	4	5	9	0	0	9	0	0
16	27224450	.	G	C	19	16	35	1	1	37	0	0
16	27225215	.	C	A	17	18	35	0	2	37	0	0
16	27231337	.	T	A	19	29	48	1	0	49	0	0
16	27231416	.	C	T	18	28	46	0	4	50	0	0
16	27367834	.	A	C	2	0	2	0	12	14	0	0
16	27368175	.	G	A	3	5	8	0	0	8	0	0
16	27368290	.	G	A	0	6	6	0	5	11	0	0
16	27368315	.	G	A	1	6	7	0	6	13	0	0
16	27368577	.	A	G	6	4	10	0	0	10	0	0
16	27368688	.	A	C	6	5	11	0	2	13	0	0
16	27368756	.	A	G	7	7	14	0	0	14	0	0
16	27368823	.	T	G	5	5	10	0	1	11	0	0
16	27368863	.	C	T	5	7	12	0	0	12	0	0
16	27392680	.	C	T	1	1	2	0	1	3	0	0
16	27417415	.	C	A	3	5	8	0	0	8	0	0
16	27417573	.	T	C	13	9	22	0	2	24	0	0
16	27417659	.	T	G	13	13	26	0	1	27	0	0
16	27417925	.	A	T	16	14	30	0	2	32	0	0
16	27427064	.	A	G	8	6	14	0	0	14	0	0
16	27427760	.	G	A	11	8	19	0	0	19	0	0
16	27428048	.	G	A	2	4	6	0	1	7	0	0
16	27430189	.	G	A	4	7	11	0	1	12	0	0
16	27431597	.	G	A	8	9	17	1	0	18	0	0
16	27493437	.	C	T	4	2	6	0	0	6	0	0
16	27493614	.	G	A	5	2	7	0	0	7	0	0
16	27493804	.	T	C	1	3	4	0	0	4	0	0
16	27513694	.	T	C	2	5	7	0	1	8	0	0
16	27524890	.	A	T	6	9	15	0	0	15	0	0
16	27524893	.	A	T	6	9	15	0	0	15	0	0
16	27529856	.	G	A	1	5	6	0	1	7	0	0
16	27532506	.	C	T	0	4	4	0	2	6	0	0
16	27536631	.	T	C	3	4	7	0	0	7	0	0
16	27539462	.	G	T	2	4	6	0	0	6	0	0
16	27539501	.	G	A	1	2	3	0	0	3	0	0
16	27542452	.	C	G	6	2	8	0	0	8	0	0
16	27542489	.	C	T	2	5	7	0	0	7	0	0
16	27554909	.	C	G	11	10	21	0	2	23	0	0
16	27555010	.	T	C	15	12	27	0	0	27	0	0
16	27555011	.	A	C	15	12	27	0	0	27	0	0
16	27555069	.	C	T	11	19	30	0	2	32	0	0
16	27555221	.	C	T	23	9	32	0	0	32	0	0
16	27555395	.	G	A	4	12	16	0	3	19	0	0
16	27564387	.	C	T	1	3	4	0	0	4	0	0
16	27578391	.	T	C	8	4	12	0	0	12	0	0
16	27578538	.	C	A	6	5	11	0	0	11	0	0
16	27621786	.	A	T	16	8	24	0	0	24	0	0
16	27622109	.	G	A	2	2	4	0	0	4	0	0
16	27626240	.	A	G	36	20	56	0	1	57	0	0
16	27626566	.	G	T	23	22	45	0	4	49	0	0
16	27627051	.	T	C	31	21	52	0	0	52	0	0
16	27629038	.	C	T	4	24	28	0	22	50	0	0
16	27629343	.	A	G	22	19	41	0	2	43	0	0
16	27629365	.	G	T	15	25	40	0	2	42	0	0
16	27629639	.	C	A	24	23	47	0	1	48	0	0
16	27629798	.	A	T	24	16	40	0	1	41	0	0
16	27630174	.	A	T	16	16	32	0	0	32	0	0
16	27630207	.	C	T	15	14	29	0	1	30	0	0
16	27630302	.	A	T	25	13	38	0	0	38	0	0
16	27630552	.	G	A	10	13	23	0	0	23	0	0
16	27630663	.	G	A	15	19	34	0	2	36	0	0
16	27631229	.	A	T	8	9	17	0	1	18	0	0
16	27631585	.	T	A	13	18	31	0	0	31	0	0
16	27631690	.	T	G	11	8	19	0	0	19	0	0
16	27631695	.	T	C	9	11	20	0	0	20	0	0
16	27631741	.	C	A	11	7	18	0	1	19	0	0
16	27631751	.	T	A	8	7	15	0	2	17	0	0
16	27632153	.	C	T	11	10	21	0	0	21	0	0
16	27632189	.	G	A	10	7	17	0	1	18	0	0
16	27632228	.	C	T	10	4	14	0	1	15	0	0
16	27632520	.	A	T	9	7	16	0	1	17	0	0
16	27632814	.	G	A	9	3	12	0	1	13	0	0
16	27632934	.	T	C	4	8	12	0	0	12	0	0
16	27633180	.	C	T	0	6	6	0	8	14	0	0
16	27633812	.	C	T	6	7	13	0	1	14	0	0
16	27633839	.	T	C	8	0	8	0	6	14	0	0
16	27633950	.	G	T	4	5	9	0	0	9	0	0
16	27669917	.	T	G	5	5	10	0	1	11	0	0
16	27670010	.	A	T	3	4	7	0	0	7	0	0
16	27670032	.	T	C	7	4	11	0	0	11	0	0
16	27675704	.	C	G	1	2	3	0	1	4	0	0
16	27675705	.	T	C	2	2	4	0	0	4	0	0
16	27676054	.	C	T	2	1	3	0	1	4	0	0
16	27676055	.	A	T	2	2	4	0	0	4	0	0
16	28112556	.	C	T	1	2	3	0	0	3	0	0
16	28112706	.	A	T	4	3	7	0	0	7	0	0
16	28112772	.	G	A	6	4	10	0	0	10	0	0
16	28245545	.	G	A	7	7	14	0	0	14	0	0
16	28256800	.	G	T	11	5	16	0	1	17	0	0
16	28263526	.	G	A	2	3	5	0	1	6	0	0
16	28264350	.	C	T	5	2	7	0	0	7	0	0
16	28265687	.	T	C	3	3	6	0	0	6	0	0
16	28268273	.	C	A	3	2	5	0	0	5	0	0
16	28270067	.	G	T	0	3	3	0	3	6	0	0
16	28270118	.	C	T	4	4	8	0	0	8	0	0
16	28270561	.	C	T	1	4	5	0	1	6	0	0
16	28270695	.	G	A	4	2	6	0	0	6	0	0
16	28272554	.	T	C	3	6	9	0	0	9	0	0
16	28272555	.	G	A	3	6	9	0	0	9	0	0
16	28276389	.	C	T	11	10	21	0	0	21	0	0
16	28278360	.	T	C	5	4	9	0	1	10	0	0
16	28280057	.	T	C	3	4	7	0	0	7	0	0
16	28305482	.	G	T	7	4	11	0	0	11	0	0
16	28370872	.	T	A	3	4	7	0	0	7	0	0
16	28370943	.	A	T	15	5	20	0	1	21	0	0
16	28573229	.	C	T	7	4	11	0	0	11	0	0
16	28573256	.	C	T	4	2	6	0	1	7	0	0
16	28573265	.	G	A	3	2	5	0	1	6	0	0
16	28573328	.	G	C	0	3	3	0	3	6	0	0
16	28573665	.	C	A	8	4	12	0	0	12	0	0
16	28573871	.	A	C	8	6	14	0	1	15	0	0
16	28573928	.	C	T	3	3	6	0	0	6	0	0
16	28573957	.	T	A	1	3	4	0	0	4	0	0
16	28574403	.	C	T	4	10	14	0	0	14	0	0
16	28574531	.	T	G	8	9	17	0	0	17	0	0
16	28574664	.	G	A	4	3	7	0	1	8	0	0
16	28591186	.	T	A	8	11	19	0	1	20	0	0
16	28591277	.	A	G	9	25	34	0	1	35	0	0
16	28591312	.	G	A	4	15	19	0	22	41	0	0
16	28591353	.	A	C	13	16	29	0	1	30	0	0
16	28591385	.	C	G	7	10	17	0	1	18	0	0
16	28592667	.	G	C	4	1	5	0	3	8	0	0
16	28592758	.	A	T	3	10	13	0	0	14	1	0
16	28592817	.	T	C	1	2	3	0	2	5	0	0
16	28593430	.	G	A	7	3	10	0	0	10	0	0
16	28593679	.	T	C	3	0	3	0	4	7	0	0
16	28593705	.	C	T	5	2	7	0	0	7	0	0
16	28620694	.	T	A	1	4	5	0	0	5	0	0
16	28626282	.	G	A	5	5	10	0	0	10	0	0
16	28626629	.	G	A	0	5	5	0	2	7	0	0
16	28626997	.	C	T	4	4	8	0	0	8	0	0
16	28627005	.	C	T	4	4	8	0	0	8	0	0
16	28627127	.	C	T	2	2	4	0	1	5	0	0
16	28627341	.	T	G	2	3	5	0	0	5	0	0
16	28627342	.	T	A	2	3	5	0	0	5	0	0
16	28629299	.	C	T	0	5	5	0	8	13	0	0
16	28629504	.	C	T	3	4	7	0	0	7	0	0
16	28664970	.	T	G	6	3	9	0	1	10	0	0
16	28665912	.	G	T	3	2	5	0	0	5	0	0
16	28665925	.	C	T	3	2	5	0	0	5	0	0
16	28842438	.	C	T	18	17	35	0	2	37	0	0
16	28856026	.	G	A	16	16	32	0	0	32	0	0
16	28971711	.	G	A	1	2	3	0	2	5	0	0
16	28983644	.	G	A	6	3	9	0	1	10	0	0
16	28983689	.	G	A	2	3	5	0	0	5	0	0
16	28983897	.	G	A	3	2	5	0	0	5	0	0
16	28990523	.	C	G	4	4	8	0	0	8	0	0
16	28991213	.	C	T	2	2	4	0	1	5	0	0
16	28991214	.	C	T	3	2	5	0	0	5	0	0
16	28994776	.	C	A	2	3	5	0	0	5	0	0
16	29003349	.	C	T	1	2	3	0	0	3	0	0
16	29009092	.	G	T	3	3	6	0	0	6	0	0
16	29010125	.	C	T	2	3	5	0	0	5	0	0
16	29010155	.	T	A	2	3	5	0	1	6	0	0
16	29010293	.	T	G	4	0	4	0	6	10	0	0
16	29010333	.	T	G	3	0	3	0	4	7	0	0
16	29012933	.	G	T	1	4	5	0	10	15	0	0
16	29012961	.	C	T	13	5	18	0	1	19	0	0
16	29012992	.	A	G	8	0	8	0	4	12	0	0
16	29013039	.	C	G	2	5	7	0	2	9	0	0
16	29013188	.	C	T	2	2	4	0	0	4	0	0
16	29013377	.	C	T	12	4	16	0	2	18	0	0
16	29014091	.	A	T	4	3	7	0	0	7	0	0
16	29014109	.	T	C	5	5	10	0	0	10	0	0
16	29016659	.	C	T	7	7	14	0	1	15	0	0
16	29016904	.	T	C	5	4	9	0	0	9	0	0
16	29017221	.	T	C	5	6	11	0	3	14	0	0
16	29019039	.	G	A	10	7	17	0	1	18	0	0
16	29020482	.	G	T	18	17	35	0	1	36	0	0
16	29022955	.	C	A	14	10	24	0	2	26	0	0
16	29023266	.	A	T	10	5	15	0	0	15	0	0
16	29024181	.	A	G	8	6	14	0	0	14	0	0
16	29024280	.	T	G	11	1	12	0	5	17	0	0
16	29024341	.	T	C	5	2	7	0	1	8	0	0
16	29024405	.	C	T	5	6	11	0	0	11	0	0
16	29024409	.	C	T	6	7	13	0	0	13	0	0
16	29024512	.	A	T	6	13	19	0	1	20	0	0
16	29024551	.	A	T	6	8	14	0	0	14	0	0
16	29024552	.	T	G	6	8	14	0	0	14	0	0
16	29027161	.	C	T	3	8	11	0	0	11	0	0
16	29029392	.	G	A	1	2	3	0	0	3	0	0
16	29029476	.	A	G	2	2	4	0	0	4	0	0
16	29029596	.	T	A	2	7	9	0	1	10	0	0
16	29052120	.	A	G	1	3	4	0	1	5	0	0
16	29052137	.	A	G	1	4	5	0	0	5	0	0
16	29052156	.	A	G	0	2	2	0	0	2	0	0
16	29052653	.	A	T	3	6	9	0	0	9	0	0
16	29052914	.	G	A	2	2	4	0	1	5	0	0
16	29052991	.	C	T	4	4	8	0	0	8	0	0
16	29053045	.	T	A	3	4	7	0	1	8	0	0
16	29053668	.	A	G	1	5	6	0	0	6	0	0
16	29053673	.	A	G	4	5	9	0	0	9	0	0
16	29054122	.	G	A	2	2	4	0	0	4	0	0
16	29054129	.	T	G	3	2	5	0	0	5	0	0
16	29054160	.	A	G	3	3	6	0	0	6	0	0
16	29054173	.	C	T	2	3	5	0	0	5	0	0
16	29073621	.	T	A	6	3	9	0	3	12	0	0
16	29074254	.	G	A	25	25	50	0	3	53	0	0
16	29074459	.	T	A	8	15	23	1	3	27	0	0
16	29075137	.	C	T	12	17	29	1	3	33	0	0
16	29075195	.	A	G	14	17	31	0	1	32	0	0
16	29075222	.	T	A	9	10	19	0	4	23	0	0
16	29075305	.	G	A	16	7	23	0	1	24	0	0
16	29075343	.	G	A	8	16	24	0	1	25	0	0
16	29075347	.	C	G	19	6	25	0	0	25	0	0
16	29075674	.	C	A	17	11	28	0	2	30	0	0
16	29075870	.	G	T	7	22	29	0	0	29	0	0
16	29075959	.	C	T	12	11	23	0	1	24	0	0
16	29075962	.	C	T	11	12	23	0	1	24	0	0
16	29076270	.	G	T	18	17	35	1	8	44	0	0
16	29076407	.	C	T	1	22	23	0	20	43	0	0
16	29076471	.	G	A	20	13	33	0	1	34	0	0
16	29076575	.	C	G	1	15	16	0	19	35	0	0
16	29076633	.	G	A	19	16	35	0	2	37	0	0
16	29076669	.	A	G	18	17	35	0	1	36	0	0
16	29076678	.	T	C	13	1	14	0	18	32	0	0
16	29111066	.	T	C	8	1	9	0	13	22	0	0
16	29225873	.	C	G	7	9	16	0	0	16	0	0
16	29226129	.	A	T	3	6	9	1	0	10	0	0
16	29226151	.	C	A	4	3	7	1	0	8	0	0
16	29226588	.	A	T	0	2	2	0	1	3	0	0
16	29265958	.	A	G	5	2	7	0	0	7	0	0
16	29265992	.	A	C	4	2	6	0	0	6	0	0
16	29266014	.	G	T	3	3	6	0	0	6	0	0
16	29266042	.	G	A	2	3	5	0	0	5	0	0
16	29310206	.	A	G	11	4	15	0	0	15	0	0
16	29310213	.	C	A	14	3	17	0	0	17	0	0
16	29310455	.	C	T	20	7	27	0	0	27	0	0
16	29310530	.	C	A	15	10	25	0	0	26	1	0
16	29310541	.	A	G	15	7	22	0	0	22	0	0
16	29310760	.	C	A	19	10	29	0	2	31	0	0
16	29310893	.	G	A	17	5	22	1	2	25	0	0
16	29311381	.	G	A	10	9	19	0	0	19	0	0
16	29311493	.	A	G	15	12	27	0	1	28	0	0
16	29313828	.	T	C	10	5	15	0	2	17	0	0
16	29314147	.	C	A	14	6	20	0	0	20	0	0
16	29320647	.	A	G	11	7	18	0	0	18	0	0
16	29320674	.	T	G	9	5	14	0	1	15	0	0
16	29323394	.	T	C	5	3	8	0	0	8	0	0
16	29323864	.	C	T	1	2	3	0	6	9	0	0
16	29324828	.	T	C	2	2	4	0	2	6	0	0
16	29370972	.	A	G	1	2	3	0	0	3	0	0
16	29371029	.	C	T	4	2	6	0	0	6	0	0
16	29374075	.	A	C	2	4	6	0	0	6	0	0
16	29380991	.	C	T	4	3	7	0	0	7	0	0
16	29380992	.	G	A	4	4	8	0	0	8	0	0
16	29381123	.	G	A	0	2	2	0	3	5	0	0
16	29381125	.	A	G	3	2	5	0	0	5	0	0
16	29381204	.	G	T	3	5	8	0	2	10	0	0
16	29381369	.	G	A	1	2	3	0	0	3	0	0
16	29381391	.	T	C	2	3	5	0	0	5	0	0
16	29384090	.	T	C	5	6	11	0	0	11	0	0
16	29384099	.	T	A	4	4	8	0	0	8	0	0
16	29384139	.	G	A	4	2	6	0	0	6	0	0
16	29384182	.	C	T	3	2	5	0	0	5	0	0
16	29389149	.	G	A	1	4	5	0	0	5	0	0
16	29390875	.	A	G	2	2	4	0	0	4	0	0
16	29407754	.	C	T	5	5	10	1	0	11	0	0
16	29407791	.	C	A	13	10	23	1	0	24	0	0
16	29408024	.	A	C	29	11	40	0	1	41	0	0
16	29408926	.	A	T	24	10	34	0	1	35	0	0
16	29408948	.	T	A	11	16	27	0	2	29	0	0
16	29409134	.	A	G	8	3	11	0	0	11	0	0
16	29409181	.	T	A	3	3	6	0	0	6	0	0
16	29409341	.	T	C	27	8	35	0	0	35	0	0
16	29409476	.	T	C	40	9	49	0	2	51	0	0
16	29409480	.	T	C	38	10	48	0	3	51	0	0
16	29409646	.	T	G	22	24	46	0	1	47	0	0
16	29410425	.	A	G	26	25	51	0	0	51	0	0
16	29410520	.	A	G	22	18	40	0	2	42	0	0
16	29411209	.	G	A	28	28	56	0	0	56	0	0
16	29412264	.	T	A	3	3	6	0	0	6	0	0
16	29413193	.	C	T	1	16	17	0	17	34	0	0
16	29414004	.	A	C	1	8	9	0	0	9	0	0
16	29419266	.	T	C	15	7	22	0	0	22	0	0
16	29421026	.	C	T	6	7	13	0	0	13	0	0
16	29424985	.	T	A	4	5	9	0	0	9	0	0
16	29425278	.	G	A	4	10	14	0	0	14	0	0
16	29427615	.	T	A	7	6	13	0	0	13	0	0
16	29456411	.	C	A	3	2	5	0	0	5	0	0
16	29456966	.	G	A	8	7	15	0	1	16	0	0
16	29456996	.	A	G	4	9	13	0	0	13	0	0
16	29457158	.	A	G	8	9	17	0	1	18	0	0
16	29457473	.	T	A	9	9	18	0	0	18	0	0
16	29457819	.	C	T	2	5	7	0	3	10	0	0
16	29458226	.	C	G	6	7	13	0	0	13	0	0
16	29458388	.	T	C	4	0	4	0	4	8	0	0
16	29460996	.	C	T	7	2	9	0	0	9	0	0
16	29526886	.	C	A	1	3	4	0	0	4	0	0
16	29586680	.	A	G	4	12	16	0	0	16	0	0
16	29587672	.	G	A	0	2	2	0	4	6	0	0
16	29642184	.	T	C	9	13	22	0	0	22	0	0
16	29644223	.	C	T	12	8	20	0	0	20	0	0
16	29686304	.	A	G	1	2	3	0	0	3	0	0
16	29686355	.	G	C	2	3	5	0	0	5	0	0
16	29686370	.	G	T	1	4	5	0	1	6	0	0
16	29689921	.	A	G	3	2	5	0	0	5	0	0
16	29691190	.	A	G	1	0	1	0	3	4	0	0
16	29693999	.	A	G	3	5	8	0	1	9	0	0
16	29695845	.	T	C	2	3	5	0	0	5	0	0
16	29696626	.	T	A	1	4	5	0	0	5	0	0
16	29696627	.	C	T	1	4	5	0	0	5	0	0
16	30036531	.	T	A	2	3	5	0	0	5	0	0
16	30036561	.	A	T	2	2	4	0	0	4	0	0
16	30174474	.	A	G	1	2	3	0	0	3	0	0
16	30202951	.	T	C	3	2	5	0	0	5	0	0
16	30266844	.	G	A	6	3	9	0	1	10	0	0
16	30267228	.	A	G	12	2	14	0	9	23	0	0
16	30267841	.	T	C	5	6	11	0	0	11	0	0
16	30268145	.	C	T	9	5	14	0	0	14	0	0
16	30268242	.	T	C	11	8	19	0	2	21	0	0
16	30268290	.	G	A	6	9	15	0	2	17	0	0
16	30268633	.	C	T	9	6	15	0	1	16	0	0
16	30268660	.	A	G	7	11	18	0	0	18	0	0
16	30268675	.	C	T	10	6	16	0	0	16	0	0
16	30269159	.	A	C	6	5	11	0	1	12	0	0
16	30270332	.	G	T	1	5	6	1	7	14	0	0
16	30270381	.	T	G	10	6	16	0	1	17	0	0
16	30270601	.	C	T	14	14	28	0	0	28	0	0
16	30316564	.	C	G	1	2	3	0	0	3	0	0
16	30316568	.	T	C	1	1	2	0	0	2	0	0
16	30319470	.	C	G	2	3	5	0	0	5	0	0
16	30322796	.	C	T	3	2	5	0	0	5	0	0
16	30408725	.	A	T	2	3	5	0	0	5	0	0
16	30408765	.	T	A	1	2	3	0	0	3	0	0
16	30408786	.	A	T	2	3	5	0	0	5	0	0
16	30408917	.	A	G	21	26	47	0	1	48	0	0
16	30409055	.	A	T	34	22	56	0	2	58	0	0
16	30409313	.	A	T	26	27	53	0	0	53	0	0
16	30415027	.	C	T	18	23	41	0	1	42	0	0
16	30417511	.	A	G	19	24	43	0	0	43	0	0
16	30417977	.	A	G	18	17	35	0	2	37	0	0
16	30417986	.	A	G	20	15	35	0	1	36	0	0
16	30419504	.	A	G	12	15	27	0	1	28	0	0
16	30420547	.	C	T	19	14	33	0	1	34	0	0
16	30422582	.	C	G	10	10	20	0	0	20	0	0
16	30422807	.	T	C	8	0	8	0	17	25	0	0
16	30422891	.	G	A	12	3	15	0	2	17	0	0
16	30423224	.	T	C	2	0	2	0	5	7	0	0
16	30423680	.	G	C	5	7	12	0	0	12	0	0
16	30423953	.	G	A	12	9	21	0	0	21	0	0
16	30426496	.	T	A	5	7	12	0	0	12	0	0
16	30427042	.	A	G	3	5	8	0	0	8	0	0
16	30429159	.	A	G	5	4	9	0	0	9	0	0
16	30429384	.	G	A	4	2	6	0	0	6	0	0
16	30432287	.	A	G	2	4	6	0	0	6	0	0
16	30434127	.	A	G	3	3	6	0	1	7	0	0
16	30434156	.	C	T	3	4	7	0	2	9	0	0
16	30434215	.	T	A	3	4	7	0	0	7	0	0
16	30521244	.	C	A	1	2	3	0	0	3	0	0
16	30521704	.	A	T	4	10	14	1	1	16	0	0
16	30522108	.	T	A	1	7	8	0	0	8	0	0
16	30522109	.	T	G	1	7	8	0	0	8	0	0
16	30522176	.	G	C	7	8	15	0	0	15	0	0
16	30522317	.	G	C	6	6	12	0	0	12	0	0
16	30522334	.	C	T	6	4	10	0	0	10	0	0
16	30522391	.	T	C	5	3	8	0	1	9	0	0
16	30522565	.	T	G	1	2	3	0	0	3	0	0
16	30522577	.	A	T	1	4	5	0	0	5	0	0
16	30522688	.	A	T	1	3	4	0	0	4	0	0
16	30522724	.	T	C	1	2	3	0	0	3	0	0
16	30522852	.	G	A	3	2	5	0	0	5	0	0
16	30522862	.	T	C	5	0	5	0	1	6	0	0
16	30522923	.	C	T	0	10	10	0	3	13	0	0
16	30523253	.	C	G	2	6	8	0	1	9	0	0
16	30525371	.	T	C	3	0	3	0	5	8	0	0
16	30525458	.	A	G	6	2	8	0	1	9	0	0
16	30525499	.	A	G	9	3	12	0	2	14	0	0
16	30530401	.	C	T	3	2	5	0	1	6	0	0
16	30531304	.	C	T	5	7	12	0	0	12	0	0
16	30531358	.	T	C	2	11	13	0	1	14	0	0
16	30562816	.	T	G	2	4	6	0	0	6	0	0
16	30562862	.	G	A	2	2	4	0	0	4	0	0
16	30562958	.	C	T	2	5	7	0	0	7	0	0
16	30583108	.	C	T	1	2	3	0	0	3	0	0
16	30737594	.	A	G	17	7	24	0	1	25	0	0
16	30737638	.	C	T	14	11	25	0	0	25	0	0
16	30737770	.	A	G	19	19	38	0	1	39	0	0
16	30738108	.	C	T	0	12	12	0	18	30	0	0
16	30740719	.	T	G	10	12	22	0	1	23	0	0
16	30760879	.	A	C	5	0	5	0	8	13	0	0
16	30772417	.	C	T	0	9	9	0	10	19	0	0
16	30785451	.	T	C	10	7	17	0	1	18	0	0
16	30788182	.	A	G	5	5	10	0	0	10	0	0
16	30794822	.	T	G	6	6	12	0	0	12	0	0
16	30800501	.	G	A	11	5	16	0	0	16	0	0
16	30808411	.	T	C	8	8	16	0	0	16	0	0
16	30826525	.	A	G	5	3	8	0	1	9	0	0
16	30826614	.	A	C	9	3	12	0	1	13	0	0
16	30869597	.	C	G	0	2	2	0	4	6	0	0
16	30869623	.	A	T	6	4	10	0	1	11	0	0
16	30908705	.	G	C	1	3	4	0	0	4	0	0
16	30908825	.	A	C	1	3	4	0	0	4	0	0
16	30909201	.	A	G	5	3	8	0	0	8	0	0
16	30910338	.	T	G	1	3	4	0	0	4	0	0
16	30919193	.	C	T	0	2	2	0	2	4	0	0
16	30919222	.	C	T	2	1	3	0	2	5	0	0
16	30919291	.	T	A	1	2	3	0	0	3	0	0
16	30927218	.	T	C	2	0	2	0	2	4	0	0
16	30948583	.	A	C	1	6	7	0	0	7	0	0
16	30948634	.	T	G	1	3	4	0	0	4	0	0
16	30948644	.	A	T	1	1	2	0	1	3	0	0
16	30949402	.	T	C	3	2	5	0	0	5	0	0
16	30980453	.	C	T	1	2	3	0	0	3	0	0
16	30983131	.	C	T	0	3	3	0	2	5	0	0
16	30983137	.	T	A	1	3	4	0	0	4	0	0
16	30984581	.	G	A	1	2	3	0	0	3	0	0
16	31186236	.	C	A	5	2	7	0	0	7	0	0
16	31186631	.	A	T	7	16	23	0	0	23	0	0
16	31187097	.	C	T	0	6	6	0	6	12	0	0
16	31187322	.	A	G	14	5	19	0	0	19	0	0
16	31188481	.	G	A	4	3	7	0	3	10	0	0
16	31188654	.	G	A	6	3	9	0	0	9	0	0
16	31260754	.	G	A	3	5	8	0	0	8	0	0
16	31261003	.	A	T	9	7	16	0	0	16	0	0
16	31261213	.	C	A	1	10	11	0	5	16	0	0
16	31261344	.	C	T	5	10	15	0	0	15	0	0
16	31266548	.	G	A	4	6	10	0	0	10	0	0
16	31268860	.	G	C	7	0	7	0	10	17	0	0
16	31268893	.	C	A	10	10	20	0	1	21	0	0
16	31272424	.	C	G	10	8	18	0	0	18	0	0
16	31274289	.	T	A	4	8	12	0	0	12	0	0
16	31274491	.	G	A	3	7	10	0	0	10	0	0
16	31274554	.	G	A	1	6	7	0	0	7	0	0
16	31274571	.	A	G	3	7	10	0	0	10	0	0
16	31280355	.	G	A	8	7	15	0	1	16	0	0
16	31303616	.	T	C	0	0	0	0	3	3	0	0
16	31306646	.	A	G	6	3	9	0	0	9	0	0
16	31314157	.	G	A	2	3	5	0	1	6	0	0
16	31342344	.	C	T	3	4	7	0	0	7	0	0
16	31429409	.	A	G	5	2	7	0	0	7	0	0
16	31435306	.	A	T	1	3	4	0	0	4	0	0
16	31436507	.	G	A	2	1	3	0	0	3	0	0
16	31437115	.	A	G	8	8	16	0	0	16	0	0
16	31437955	.	A	G	33	24	57	2	3	62	0	0
16	31444428	.	G	A	19	13	32	0	1	33	0	0
16	31444843	.	A	T	18	12	30	0	1	31	0	0
16	31445516	.	T	C	13	10	23	0	1	24	0	0
16	31454548	.	A	G	1	3	4	0	1	5	0	0
16	31516398	.	A	G	1	4	5	0	0	5	0	0
16	31516536	.	T	C	2	3	5	0	0	5	0	0
16	31602170	.	A	G	7	7	14	0	1	15	0	0
16	31608012	.	A	G	5	8	13	0	0	13	0	0
16	31608101	.	C	T	1	3	4	0	5	9	0	0
16	31608967	.	G	T	6	3	9	0	0	9	0	0
16	31609241	.	C	T	0	9	9	0	7	16	0	0
16	31610375	.	C	T	9	6	15	0	1	16	0	0
16	31613619	.	A	G	3	2	5	0	1	6	0	0
16	31614272	.	C	G	4	8	12	0	0	12	0	0
16	31614918	.	G	A	5	5	10	0	0	10	0	0
16	31615114	.	G	A	6	4	10	0	1	11	0	0
16	31762960	.	C	T	18	9	27	0	0	27	0	0
16	31763316	.	T	C	16	17	33	0	0	33	0	0
16	31763318	.	C	T	15	16	31	0	2	33	0	0
16	31763668	.	C	G	9	14	23	0	2	25	0	0
16	31763743	.	T	A	20	23	43	0	2	45	0	0
16	31763751	.	A	C	20	26	46	0	2	48	0	0
16	31763785	.	G	A	21	20	41	0	1	42	0	0
16	31763786	.	C	A	22	20	42	0	1	43	0	0
16	31763880	.	A	G	18	21	39	0	0	39	0	0
16	31764987	.	C	T	9	16	25	0	2	27	0	0
16	31766937	.	T	A	16	8	24	0	2	26	0	0
16	31767116	.	T	C	12	2	14	0	7	21	0	0
16	31767152	.	A	G	12	12	24	1	0	25	0	0
16	31767163	.	G	A	13	10	23	1	0	25	1	0
16	31767191	.	T	C	15	10	25	1	0	26	0	0
16	31768343	.	C	G	11	7	18	0	0	18	0	0
16	31768394	.	T	C	13	9	22	0	0	22	0	0
16	31768436	.	T	C	14	11	25	0	1	26	0	0
16	31769317	.	G	A	20	8	28	0	2	30	0	0
16	31769395	.	A	G	9	12	21	0	2	23	0	0
16	31769428	.	G	A	11	4	15	0	2	17	0	0
16	31770050	.	T	C	9	0	9	0	9	18	0	0
16	31776125	.	C	T	12	5	17	0	0	17	0	0
16	31780108	.	C	T	0	3	3	0	5	8	0	0
16	31782938	.	C	T	2	2	4	0	0	4	0	0
16	31789327	.	C	T	5	5	10	0	0	10	0	0
16	31790262	.	C	T	6	7	13	0	0	13	0	0
16	31812498	.	C	A	1	2	3	0	0	3	0	0
16	31815638	.	C	T	20	9	29	0	0	29	0	0
16	31815878	.	G	A	3	10	13	0	0	13	0	0
16	31816005	.	C	A	14	6	20	0	1	21	0	0
16	31816205	.	C	T	9	3	12	0	0	12	0	0
16	31816336	.	C	T	0	8	8	0	3	11	0	0
16	31816596	.	C	T	10	14	24	1	0	25	0	0
16	31827642	.	T	A	20	15	35	0	1	37	1	0
16	31827703	.	C	T	13	22	35	0	0	35	0	0
16	31832606	.	A	G	19	3	22	0	33	55	0	0
16	31853932	.	T	A	10	8	18	1	0	19	0	0
16	31854325	.	C	A	4	6	10	0	0	10	0	0
16	31855271	.	T	C	3	2	5	0	2	7	0	0
16	31855327	.	G	A	4	7	11	0	0	11	0	0
16	31855351	.	G	C	7	3	10	0	1	11	0	0
16	31855575	.	C	T	11	5	16	0	1	17	0	0
16	31855576	.	C	T	11	6	17	0	0	17	0	0
16	31855814	.	T	G	10	0	10	0	6	16	0	0
16	31856239	.	A	G	4	2	6	0	0	6	0	0
16	31856276	.	G	A	0	3	3	0	9	12	0	0
16	31859227	.	T	C	18	15	33	0	2	35	0	0
16	31859310	.	A	G	31	9	40	1	5	46	0	0
16	31859341	.	C	T	17	27	44	1	3	48	0	0
16	31859371	.	T	C	23	26	49	2	0	51	0	0
16	31859416	.	T	C	9	23	32	0	5	37	0	0
16	31859686	.	G	A	9	7	16	0	0	16	0	0
16	31868443	.	G	A	12	19	31	0	0	31	0	0
16	31922892	.	A	G	25	35	60	0	1	61	0	0
16	31923083	.	G	A	38	24	62	0	4	66	0	0
16	31923435	.	A	G	31	33	64	0	1	65	0	0
16	31924485	.	T	C	23	27	50	0	2	52	0	0
16	31924501	.	A	C	22	28	50	0	2	53	1	0
16	31925035	.	A	G	1	4	5	0	0	5	0	0
16	31925727	.	G	A	4	3	7	0	0	7	0	0
16	31926853	.	A	G	3	4	7	0	0	7	0	0
16	31928878	.	T	C	2	3	5	0	1	6	0	0
16	31951694	.	G	C	3	3	6	0	0	6	0	0
16	31955226	.	C	G	2	2	4	0	0	4	0	0
16	31959225	.	G	A	5	3	8	0	0	8	0	0
16	31959231	.	A	T	5	3	8	0	0	8	0	0
16	31959277	.	A	T	4	3	7	0	0	7	0	0
16	31959428	.	C	T	3	3	6	0	0	6	0	0
16	31959612	.	G	A	2	2	4	0	1	5	0	0
16	31959845	.	A	G	1	0	1	0	4	5	0	0
16	31960037	.	G	A	0	3	3	0	7	10	0	0
16	31960064	.	G	C	6	4	10	0	0	10	0	0
16	31960145	.	C	T	7	6	13	0	2	15	0	0
16	31960152	.	C	T	5	5	10	0	2	12	0	0
16	32009736	.	A	T	2	5	7	0	0	7	0	0
16	32011649	.	C	T	5	5	10	0	0	10	0	0
16	32011673	.	A	G	6	5	11	0	1	12	0	0
16	32013272	.	G	A	7	6	13	0	0	13	0	0
16	32013766	.	T	G	1	3	4	0	0	4	0	0
16	32013861	.	G	A	4	2	6	0	0	6	0	0
16	32013891	.	G	A	3	2	5	0	1	6	0	0
16	32014627	.	T	A	2	2	4	0	0	4	0	0
16	32014633	.	A	T	2	0	2	0	2	4	0	0
16	32023124	.	T	A	7	4	11	0	0	11	0	0
16	32025648	.	T	A	6	12	18	0	1	19	0	0
16	32025978	.	G	A	8	6	14	0	0	14	0	0
16	32025987	.	T	A	11	7	18	0	0	18	0	0
16	32026105	.	T	A	10	5	15	2	0	17	0	0
16	32026154	.	T	G	2	2	4	0	0	4	0	0
16	32052004	.	T	G	8	13	21	0	1	22	0	0
16	32052283	.	T	A	8	9	17	0	1	18	0	0
16	32052307	.	T	C	6	9	15	0	0	15	0	0
16	32052328	.	T	A	8	7	15	0	1	16	0	0
16	32052404	.	G	T	0	10	10	0	13	24	1	0
16	32055726	.	T	G	5	14	19	0	3	22	0	0
16	32057809	.	T	C	10	5	15	0	0	15	0	0
16	32057853	.	G	A	3	6	9	0	6	15	0	0
16	32060121	.	G	T	4	2	6	0	1	7	0	0
16	32060130	.	C	A	3	3	6	0	0	6	0	0
16	32063433	.	C	T	7	3	10	0	0	10	0	0
16	32066465	.	T	C	1	2	3	0	0	3	0	0
16	32067316	.	A	C	2	4	6	0	0	6	0	0
16	32068332	.	G	A	3	5	8	0	0	8	0	0
16	32068452	.	C	A	6	6	12	0	1	13	0	0
16	32068503	.	T	C	5	5	10	0	2	12	0	0
16	32069310	.	T	A	12	11	23	0	2	25	0	0
16	32069653	.	A	G	13	5	18	0	1	19	0	0
16	32070489	.	A	G	8	0	8	0	9	17	0	0
16	32070570	.	C	T	10	14	24	0	0	24	0	0
16	32070981	.	G	C	14	12	26	0	0	26	0	0
16	32071965	.	G	C	7	7	14	0	2	16	0	0
16	32071997	.	C	A	8	7	15	0	2	17	0	0
16	32072334	.	A	G	15	9	24	0	0	24	0	0
16	32073301	.	A	C	14	20	34	0	3	37	0	0
16	32073507	.	A	C	19	19	38	0	0	38	0	0
16	32073555	.	A	G	26	21	47	0	0	47	0	0
16	32073760	.	G	A	21	17	38	0	0	38	0	0
16	32074041	.	G	A	12	18	30	0	2	32	0	0
16	32074257	.	A	G	22	1	23	0	18	41	0	0
16	32074293	.	T	A	22	18	40	0	1	41	0	0
16	32074294	.	A	G	24	18	42	0	0	42	0	0
16	32080069	.	G	T	2	13	15	0	6	21	0	0
16	32080099	.	G	A	6	3	9	0	1	10	0	0
16	32080196	.	T	C	4	2	6	0	0	6	0	0
16	32080206	.	T	C	4	2	6	0	0	6	0	0
16	32080306	.	T	A	12	2	14	0	0	14	0	0
16	32080508	.	T	A	14	12	26	0	0	26	0	0
16	32082397	.	T	C	12	9	21	0	1	22	0	0
16	32082589	.	G	A	11	4	15	0	0	15	0	0
16	32082597	.	G	A	9	6	15	0	2	17	0	0
16	32082642	.	G	A	6	7	13	0	2	15	0	0
16	32085319	.	T	A	6	12	18	0	0	18	0	0
16	32085631	.	A	G	5	9	14	0	2	16	0	0
16	32085778	.	A	C	3	4	7	0	0	7	0	0
16	32086136	.	C	T	10	4	14	0	0	14	0	0
16	32088580	.	T	A	9	9	18	0	0	18	0	0
16	32090425	.	G	C	12	6	18	0	1	19	0	0
16	32110659	.	A	G	9	14	23	0	0	23	0	0
16	32111246	.	G	T	13	15	28	0	2	30	0	0
16	32113155	.	G	A	11	13	24	0	1	25	0	0
16	32113218	.	G	A	10	11	21	1	0	22	0	0
16	32116790	.	A	T	10	9	19	0	0	19	0	0
16	32117345	.	T	A	8	11	19	0	2	21	0	0
16	32119581	.	C	A	3	6	9	0	0	9	0	0
16	32119618	.	C	T	2	6	8	0	0	8	0	0
16	32119895	.	G	T	10	8	18	0	0	18	0	0
16	32120138	.	G	T	7	7	14	0	1	15	0	0
16	32120141	.	T	C	6	0	6	0	8	14	0	0
16	32120173	.	G	A	6	9	15	0	0	15	0	0
16	32120204	.	G	T	4	10	14	0	2	16	0	0
16	32120279	.	A	C	8	7	15	0	3	18	0	0
16	32128259	.	T	A	3	4	7	0	0	7	0	0
16	32140638	.	G	C	1	4	5	0	0	5	0	0
16	32140977	.	C	T	1	2	3	0	1	4	0	0
16	32141036	.	G	A	1	2	3	0	0	3	0	0
16	32141058	.	A	G	1	3	4	0	0	4	0	0
16	32141075	.	G	A	1	6	7	0	0	7	0	0
16	32141544	.	A	G	13	0	13	0	9	22	0	0
16	32141565	.	A	C	10	4	14	0	2	16	0	0
16	32141604	.	A	T	6	5	11	0	1	12	0	0
16	32144337	.	T	C	6	6	12	0	0	12	0	0
16	32144377	.	T	C	6	4	10	0	1	11	0	0
16	32144854	.	G	T	0	4	4	0	3	7	0	0
16	32144989	.	T	C	3	5	8	0	0	8	0	0
16	32145160	.	T	A	5	6	11	0	0	11	0	0
16	32145547	.	T	C	1	3	4	0	0	4	0	0
16	32145636	.	A	G	8	5	13	0	0	13	0	0
16	32184563	.	T	C	1	2	3	0	0	3	0	0
16	32197969	.	C	T	13	15	28	0	0	28	0	0
16	32241591	.	C	T	1	3	4	0	1	5	0	0
16	32257179	.	T	A	1	4	5	0	0	5	0	0
16	32267128	.	G	A	5	3	8	0	0	8	0	0
16	32267203	.	G	A	0	6	6	0	3	9	0	0
16	32273066	.	G	T	3	7	10	0	0	10	0	0
16	32273192	.	G	A	1	5	6	0	7	13	0	0
16	32274935	.	G	A	9	7	16	0	1	17	0	0
16	32275601	.	T	A	4	6	10	0	1	11	0	0
16	32275628	.	A	T	8	7	15	0	1	16	0	0
16	32285260	.	A	T	2	2	4	0	0	4	0	0
16	32285404	.	G	A	1	2	3	0	0	3	0	0
16	32561581	.	T	A	2	4	6	0	0	6	0	0
16	32562038	.	A	T	8	3	11	0	1	12	0	0
16	32562817	.	A	T	6	2	8	0	1	9	0	0
16	33027082	.	C	T	11	3	14	0	0	14	0	0
16	33595717	.	G	T	4	2	6	0	0	6	0	0
16	33735481	.	G	A	3	4	7	0	0	7	0	0
16	33735503	.	C	T	4	2	6	0	0	6	0	0
16	33902151	.	C	T	2	5	7	0	0	7	0	0
16	33905018	.	C	T	1	4	5	0	0	5	0	0
16	33910329	.	T	A	1	3	4	0	0	4	0	0
16	33923421	.	G	T	4	2	6	0	1	7	0	0
16	33923448	.	G	T	5	7	12	0	0	12	0	0
16	33923514	.	G	A	8	8	16	0	0	16	0	0
16	33925132	.	G	C	5	7	12	0	0	12	0	0
16	33925356	.	G	A	3	4	7	0	7	14	0	0
16	33925565	.	T	G	4	5	9	0	0	9	0	0
16	33933213	.	C	T	7	7	14	0	0	14	0	0
16	33933498	.	C	T	2	7	9	0	0	9	0	0
16	33933732	.	G	A	1	4	5	0	9	14	0	0
16	33939824	.	T	C	11	4	15	0	0	15	0	0
16	33939859	.	C	T	5	3	8	0	0	8	0	0
16	33940364	.	A	G	7	0	7	0	4	11	0	0
16	33940379	.	T	A	8	7	15	0	0	15	0	0
16	33953652	.	T	A	7	2	9	0	0	9	0	0
16	33953968	.	C	T	6	3	9	0	0	9	0	0
16	33971993	.	G	A	1	4	5	0	3	8	0	0
16	33972008	.	G	A	5	3	8	0	0	8	0	0
16	33972037	.	A	C	6	6	12	0	0	12	0	0
16	33972067	.	A	G	3	5	8	0	3	11	0	0
16	33972193	.	G	A	2	6	8	0	4	12	0	0
16	33972242	.	G	T	9	7	16	0	0	16	0	0
16	33972249	.	C	T	8	8	16	0	0	16	0	0
16	33972454	.	C	T	9	4	13	0	0	13	0	0
16	33978019	.	A	G	5	0	5	0	6	11	0	0
16	33979746	.	A	T	3	2	5	0	0	5	0	0
16	33981439	.	C	T	5	3	8	0	1	9	0	0
16	33981873	.	A	G	5	0	5	0	8	13	0	0
16	33983784	.	T	G	7	10	17	0	1	18	0	0
16	33983904	.	C	T	9	6	15	0	0	15	0	0
16	33984178	.	C	T	4	5	9	0	1	10	0	0
16	33984190	.	C	T	5	5	10	0	1	11	0	0
16	33985050	.	G	T	0	18	18	0	11	29	0	0
16	33985362	.	C	T	16	8	24	0	1	26	1	0
16	33986179	.	A	T	15	11	26	0	2	28	0	0
16	33986452	.	T	G	21	17	38	0	2	40	0	0
16	33987912	.	A	G	1	3	4	0	0	4	0	0
16	33987913	.	A	T	1	3	4	0	0	4	0	0
16	33987965	.	T	C	2	2	4	0	0	4	0	0
16	33989381	.	G	A	2	1	3	0	0	3	0	0
16	33989391	.	A	G	2	0	2	0	2	4	0	0
16	33992799	.	C	G	1	2	3	0	0	3	0	0
16	33994640	.	G	A	0	3	3	0	2	5	0	0
16	33996739	.	C	T	1	2	3	0	0	3	0	0
16	34004562	.	G	A	0	7	7	0	4	11	0	0
16	34004595	.	T	C	5	8	13	0	1	14	0	0
16	34004862	.	C	T	2	5	7	0	0	7	0	0
16	34005290	.	C	T	4	2	6	0	0	6	0	0
16	34005415	.	C	T	5	10	15	0	0	15	0	0
16	34005577	.	A	G	5	3	8	0	0	8	0	0
16	34005669	.	C	T	3	6	9	0	1	10	0	0
16	34005686	.	C	T	5	4	9	0	0	9	0	0
16	34005812	.	T	A	8	2	10	0	0	10	0	0
16	34006020	.	G	C	7	2	9	0	0	9	0	0
16	34053917	.	A	G	1	3	4	0	0	4	0	0
16	34054141	.	A	G	4	2	6	0	0	6	0	0
16	34054171	.	A	G	5	2	7	0	0	7	0	0
16	34054464	.	C	A	1	7	8	0	0	8	0	0
16	34054712	.	T	G	6	0	6	0	4	10	0	0
16	34054778	.	G	A	6	2	8	0	0	8	0	0
16	34056204	.	T	A	3	2	5	0	1	6	0	0
16	34160860	.	T	G	2	2	4	0	0	4	0	0
16	34172916	.	G	A	1	3	4	0	0	4	0	0
16	34173331	.	G	A	4	9	13	0	1	14	0	0
16	34185906	.	A	T	5	8	13	0	0	13	0	0
16	34200704	.	C	T	26	21	47	0	1	48	0	0
16	34201023	.	A	G	29	14	43	0	0	43	0	0
16	34208582	.	T	C	22	1	23	0	18	41	0	0
16	34208696	.	A	G	22	12	34	0	2	36	0	0
16	34212477	.	A	G	17	17	34	0	1	35	0	0
16	34212516	.	A	G	18	17	35	0	1	36	0	0
16	34212565	.	G	A	15	16	31	0	2	33	0	0
16	34212567	.	G	C	14	16	30	0	1	31	0	0
16	34212630	.	T	C	26	2	28	0	21	49	0	0
16	34212676	.	G	C	15	3	18	0	10	28	0	0
16	34222439	.	T	G	18	16	34	0	6	40	0	0
16	34225173	.	T	C	21	11	32	0	2	34	0	0
16	34225392	.	A	G	14	12	26	0	2	28	0	0
16	34225472	.	G	A	20	13	33	0	1	34	0	0
16	34267938	.	C	T	2	9	11	0	9	20	0	0
16	34267991	.	G	C	16	10	26	0	1	27	0	0
16	34321568	.	A	T	6	5	11	0	0	11	0	0
16	34322036	.	G	T	6	6	12	0	0	12	0	0
16	34322346	.	G	A	16	9	25	0	0	25	0	0
16	34322372	.	C	T	1	14	15	0	17	32	0	0
16	34331489	.	A	G	7	10	17	0	2	19	0	0
16	34337976	.	A	T	12	8	20	0	0	21	1	0
16	34338475	.	A	G	11	7	18	0	1	19	0	0
16	34339168	.	A	C	8	8	16	0	2	18	0	0
16	34339432	.	A	T	12	10	22	0	0	22	0	0
16	34339693	.	C	T	8	3	11	0	1	12	0	0
16	34339808	.	A	G	4	7	11	0	1	12	0	0
16	34339857	.	T	G	8	5	13	0	0	13	0	0
16	34340311	.	T	C	8	0	8	0	4	12	0	0
16	34340397	.	A	C	7	5	12	0	0	12	0	0
16	34340520	.	G	T	7	2	9	0	3	12	0	0
16	34340538	.	C	T	8	5	13	0	0	13	0	0
16	34341012	.	C	T	1	5	6	0	1	7	0	0
16	34341021	.	C	T	2	6	8	0	1	9	0	0
16	34341080	.	T	C	1	3	4	0	3	7	0	0
16	34342182	.	T	C	8	8	16	0	0	16	0	0
16	34497550	.	T	C	7	3	10	0	0	10	0	0
16	34499400	.	A	G	3	2	5	0	0	5	0	0
16	34499701	.	G	A	0	2	2	0	1	3	0	0
16	34499940	.	A	G	8	3	11	0	0	11	0	0
16	34500542	.	G	C	8	9	17	0	2	19	0	0
16	34500582	.	G	A	6	4	10	0	2	12	0	0
16	34500589	.	G	C	1	4	5	0	6	11	0	0
16	34500899	.	G	A	13	14	27	0	1	28	0	0
16	34501348	.	C	T	9	8	17	1	0	18	0	0
16	34501380	.	C	T	6	11	17	1	1	19	0	0
16	34501496	.	G	A	2	8	10	0	11	21	0	0
16	34525621	.	C	A	52	34	86	0	2	88	0	0
16	34526092	.	C	G	35	30	65	0	3	68	0	0
16	34526093	.	A	C	27	30	57	0	10	67	0	0
16	34526795	.	A	T	20	46	66	0	2	68	0	0
16	34526926	.	A	T	23	29	52	2	15	69	0	0
16	34532040	.	C	T	6	5	11	0	0	11	0	0
16	34532205	.	G	A	0	12	12	0	10	22	0	0
16	34532782	.	C	G	4	8	12	0	0	12	0	0
16	34532843	.	T	C	7	5	12	0	0	12	0	0
16	34930635	.	A	G	5	10	15	0	1	16	0	0
16	34930719	.	C	T	1	12	13	0	9	22	0	0
16	34948262	.	C	T	12	7	19	0	0	19	0	0
16	34953166	.	C	T	8	9	17	0	1	18	0	0
16	34975908	.	A	G	8	14	22	0	0	22	0	0
16	34989800	.	C	T	0	8	8	0	6	14	0	0
16	34993814	.	T	C	2	0	2	0	6	8	0	0
16	35022679	.	G	A	4	7	11	0	0	11	0	0
16	35023920	.	C	T	4	6	10	0	0	10	0	0
16	35023934	.	T	C	4	7	11	0	0	11	0	0
16	35023967	.	T	A	7	8	15	0	0	15	0	0
16	35043863	.	C	T	8	4	12	0	1	13	0	0
16	35053907	.	C	G	1	3	4	0	0	4	0	0
16	35372069	.	C	T	1	4	5	0	0	5	0	0
16	35409483	.	C	T	1	15	16	0	20	36	0	0
16	35409783	.	G	A	24	8	32	0	1	33	0	0
16	35414455	.	A	G	13	10	23	0	0	23	0	0
16	35414470	.	T	C	7	16	23	0	0	23	0	0
16	35414991	.	C	T	14	21	35	0	1	36	0	0
16	35416113	.	A	G	7	18	25	0	3	28	0	0
16	35416158	.	C	T	20	14	34	0	2	36	0	0
16	35416786	.	A	G	18	20	38	0	1	39	0	0
16	35418744	.	T	C	18	0	18	0	18	36	0	0
16	35420600	.	T	C	12	0	12	0	18	30	0	0
16	35423585	.	C	T	4	7	11	0	11	22	0	0
16	35426998	.	T	C	9	0	9	0	7	16	0	0
16	35536574	.	C	A	11	11	22	0	4	26	0	0
16	35536576	.	G	A	3	12	15	0	11	26	0	0
16	35536848	.	G	A	6	8	14	0	1	15	0	0
16	35536900	.	A	G	5	2	7	0	1	8	0	0
16	35536960	.	T	C	12	10	22	0	0	22	0	0
16	35536990	.	C	T	12	12	24	1	2	27	0	0
16	35537153	.	G	A	11	3	14	0	1	15	0	0
16	35537270	.	C	A	12	9	21	0	0	22	1	0
16	35556192	.	C	T	0	2	2	0	2	4	0	0
16	35556303	.	C	T	1	4	5	0	0	5	0	0
16	35556819	.	A	T	1	2	3	0	0	3	0	0
16	35562804	.	A	G	1	3	4	0	0	4	0	0
16	35662078	.	T	G	5	4	9	0	0	9	0	0
16	35662132	.	A	C	5	3	8	0	0	8	0	0
16	35718538	.	A	G	5	6	11	0	2	13	0	0
16	35728994	.	G	A	5	7	12	0	0	12	0	0
16	35743849	.	A	T	7	8	15	0	0	15	0	0
16	35750714	.	T	A	12	16	28	0	2	30	0	0
16	35752670	.	C	T	10	8	18	0	0	18	0	0
16	35752785	.	T	C	11	15	26	0	1	27	0	0
16	35762009	.	C	A	12	12	24	0	0	24	0	0
16	35762010	.	A	C	12	12	24	0	0	24	0	0
16	35764580	.	C	T	6	15	21	0	1	22	0	0
16	35773005	.	A	G	10	6	16	0	1	17	0	0
16	36041247	.	G	A	12	11	23	0	0	23	0	0
16	36062265	.	T	C	8	0	8	0	5	13	0	0
16	36075201	.	A	T	3	2	5	1	0	6	0	0
16	36075293	.	T	C	2	7	9	0	2	11	0	0
16	36075312	.	T	C	7	6	13	0	0	13	0	0
16	36075471	.	G	A	7	7	14	0	2	16	0	0
16	36075478	.	T	A	6	8	14	0	0	14	0	0
16	36075677	.	C	A	11	6	17	0	0	17	0	0
16	36075999	.	A	G	10	6	16	0	1	17	0	0
16	36076082	.	G	A	12	6	18	0	0	18	0	0
16	36080364	.	C	T	14	12	26	0	0	26	0	0
16	36080376	.	A	C	11	11	22	0	0	22	0	0
16	36087550	.	A	C	2	0	2	0	7	9	0	0
16	36118070	.	T	C	5	1	6	0	12	18	0	0
16	36118166	.	T	C	5	0	5	0	5	10	0	0
16	36150674	.	A	G	5	11	16	1	3	20	0	0
16	36150707	.	C	T	6	11	17	0	0	17	0	0
16	36150949	.	C	T	17	15	32	0	2	34	0	0
16	36150964	.	C	T	19	15	34	0	2	36	0	0
16	36151000	.	C	A	21	13	34	0	1	35	0	0
16	36159928	.	T	C	15	19	34	0	2	36	0	0
16	36162013	.	C	T	19	14	33	0	1	34	0	0
16	36162201	.	A	G	8	10	18	0	0	18	0	0
16	36162584	.	G	C	2	7	9	0	10	19	0	0
16	36162650	.	T	C	14	13	27	0	0	27	0	0
16	36162727	.	A	G	14	7	21	0	1	22	0	0
16	36162754	.	A	G	18	9	27	0	0	27	0	0
16	36162938	.	G	T	15	6	21	0	0	21	0	0
16	36163005	.	G	A	10	5	15	0	0	15	0	0
16	36163006	.	A	C	10	5	15	0	0	15	0	0
16	36168251	.	C	T	5	6	11	0	0	11	0	0
16	36168317	.	G	C	6	7	13	0	0	13	0	0
16	36168416	.	T	C	10	4	14	0	0	14	0	0
16	36168450	.	A	T	7	3	10	0	0	10	0	0
16	36168510	.	A	T	7	3	10	0	0	10	0	0
16	36168575	.	T	G	7	3	10	0	1	11	0	0
16	36168729	.	T	C	1	0	1	1	3	5	0	0
16	36168747	.	T	C	4	4	8	0	0	8	0	0
16	36168994	.	C	T	4	3	7	0	0	7	0	0
16	36169007	.	T	C	4	3	7	0	0	7	0	0
16	36169057	.	T	G	3	3	6	0	0	6	0	0
16	36169098	.	T	C	4	3	7	0	1	8	0	0
16	36169150	.	T	C	4	5	9	0	0	9	0	0
16	36169568	.	G	T	4	4	8	0	0	8	0	0
16	36169868	.	A	C	3	0	3	0	2	5	0	0
16	36171552	.	A	G	2	5	7	0	0	7	0	0
16	36172961	.	A	G	4	6	10	0	1	11	0	0
16	36172982	.	C	T	4	4	8	0	0	8	0	0
16	36173406	.	A	T	6	5	11	0	0	11	0	0
16	36180540	.	G	A	1	3	4	0	0	4	0	0
16	36180591	.	A	G	2	3	5	0	0	5	0	0
16	36183047	.	A	G	4	3	7	0	0	7	0	0
16	36185315	.	G	A	3	4	7	0	0	7	0	0
16	36189865	.	G	A	3	3	6	0	0	6	0	0
16	36195921	.	C	T	2	2	4	0	1	5	0	0
16	36195942	.	C	T	4	2	6	0	0	6	0	0
16	36196524	.	C	T	1	2	3	0	0	3	0	0
16	36721560	.	A	T	3	7	10	0	2	12	0	0
16	36721589	.	T	G	4	7	11	0	0	11	0	0
16	36724010	.	C	G	1	14	15	1	9	25	0	0
16	36729322	.	A	T	7	3	10	0	3	13	0	0
16	36729352	.	G	T	4	10	14	0	0	14	0	0
16	36729373	.	A	G	2	12	14	0	0	14	0	0
16	36731307	.	A	G	7	6	13	0	0	13	0	0
16	36735751	.	T	C	6	5	11	0	0	11	0	0
16	36735760	.	T	C	6	0	6	0	5	11	0	0
16	36743328	.	G	A	6	7	13	0	0	13	0	0
16	36743351	.	G	A	7	5	12	0	0	12	0	0
16	36743757	.	T	C	1	3	4	0	0	4	0	0
16	36743787	.	A	G	1	3	4	0	0	4	0	0
16	36745973	.	C	T	0	5	5	0	1	6	0	0
16	36746466	.	G	A	1	4	5	0	0	5	0	0
16	36746484	.	A	G	3	2	5	0	0	5	0	0
16	36748366	.	T	C	1	0	1	0	5	6	0	0
16	36751410	.	C	T	1	2	3	0	0	3	0	0
16	36751413	.	C	G	1	3	4	0	0	4	0	0
16	36752254	.	A	G	1	2	3	0	0	3	0	0
16	36759756	.	A	G	3	1	4	0	1	5	0	0
16	36759763	.	G	T	3	2	5	0	0	5	0	0
16	36759812	.	A	G	1	1	2	0	4	6	0	0
16	36759834	.	T	C	1	4	5	0	0	5	0	0
16	36766180	.	T	G	26	10	36	0	0	36	0	0
16	36766467	.	G	T	13	9	22	0	3	25	0	0
16	36766497	.	T	G	4	2	6	0	19	25	0	0
16	36908630	.	C	T	6	4	10	0	0	10	0	0
16	36908844	.	C	A	4	5	9	0	0	9	0	0
16	36918992	.	G	A	6	5	11	0	0	11	0	0
16	36923298	.	C	T	6	5	11	0	1	12	0	0
16	36925462	.	G	A	2	6	8	0	9	17	0	0
16	36926775	.	C	A	12	8	20	0	0	20	0	0
16	36926779	.	A	C	12	5	17	0	1	18	0	0
16	36928169	.	A	T	6	13	19	0	1	20	0	0
16	36928179	.	A	C	7	15	22	0	0	22	0	0
16	36928429	.	A	G	20	17	37	0	1	38	0	0
16	36931728	.	T	C	17	13	30	0	0	30	0	0
16	36931822	.	T	C	13	6	19	3	0	22	0	0
16	36934340	.	C	A	0	6	6	0	4	10	0	0
16	36939973	.	T	C	3	0	3	1	10	14	0	0
16	36939982	.	A	G	4	10	14	1	0	15	0	0
16	36940045	.	C	T	9	7	16	0	0	16	0	0
16	36941706	.	T	C	7	8	15	0	1	16	0	0
16	36941790	.	T	C	5	6	11	0	0	11	0	0
16	36941961	.	T	C	8	0	8	0	8	16	0	0
16	36942068	.	C	A	6	8	14	0	1	15	0	0
16	36945182	.	T	G	7	7	14	0	0	14	0	0
16	36945564	.	T	C	9	3	12	0	0	12	0	0
16	36945566	.	T	A	8	3	11	0	0	11	0	0
16	36974719	.	T	C	5	3	8	0	0	8	0	0
16	36975141	.	G	A	18	14	32	0	0	32	0	0
16	36975146	.	C	T	1	12	13	0	19	32	0	0
16	36975183	.	G	C	17	15	32	0	1	33	0	0
16	36975318	.	T	A	11	12	23	0	0	23	0	0
16	36976721	.	A	G	6	9	15	0	0	15	0	0
16	36977387	.	A	G	3	5	8	0	0	8	0	0
16	36979518	.	G	A	13	11	24	0	0	24	0	0
16	36979521	.	A	G	13	11	24	0	0	24	0	0
16	37167442	.	G	C	3	15	18	0	0	18	0	0
16	37167545	.	T	A	3	8	11	1	0	12	0	0
16	37167589	.	T	G	3	11	14	0	1	15	0	0
16	37167784	.	C	G	4	7	11	0	1	12	0	0
16	37167968	.	G	A	3	12	15	0	0	15	0	0
16	37306905	.	G	A	12	5	17	0	1	18	0	0
16	37323594	.	A	C	10	8	18	0	0	19	1	0
16	37470964	.	T	C	2	2	4	0	0	4	0	0
16	37471169	.	A	T	2	3	5	0	0	5	0	0
16	37521301	.	G	C	0	2	2	0	3	5	0	0
16	37543114	.	T	C	3	2	5	0	0	5	0	0
16	37552348	.	A	C	3	3	6	0	0	6	0	0
16	37552966	.	G	A	6	7	13	0	0	13	0	0
16	37554821	.	C	T	4	13	17	0	0	17	0	0
16	37563601	.	G	A	4	5	9	0	0	9	0	0
16	37563643	.	T	G	9	0	9	0	9	18	0	0
16	37565676	.	C	G	5	9	14	0	0	14	0	0
16	37593444	.	G	A	7	13	20	0	1	21	0	0
16	37596645	.	C	T	4	5	9	0	0	9	0	0
16	37596669	.	G	A	5	7	12	0	1	13	0	0
16	37614071	.	A	G	5	11	16	0	2	18	0	0
16	37617219	.	A	G	11	0	11	0	17	28	0	0
16	37617304	.	A	G	18	0	18	0	14	32	0	0
16	37617738	.	T	C	22	17	39	0	0	39	0	0
16	37627218	.	T	G	14	11	25	0	2	27	0	0
16	37627762	.	G	A	3	20	23	0	13	36	0	0
16	37627997	.	T	G	21	20	41	0	0	41	0	0
16	37933955	.	C	T	2	3	5	0	0	5	0	0
16	37947769	.	T	C	4	3	7	0	0	7	0	0
16	37948242	.	C	G	2	4	6	0	0	6	0	0
16	37948256	.	G	T	2	3	5	0	0	5	0	0
16	37948355	.	C	T	12	7	19	0	1	20	0	0
16	37963955	.	T	A	4	8	12	0	0	12	0	0
16	37964100	.	C	T	4	2	6	0	0	6	0	0
16	37964222	.	T	A	4	8	12	1	2	15	0	0
16	38017652	.	G	A	2	3	5	0	0	5	0	0
16	38019553	.	C	G	1	2	3	0	0	3	0	0
16	38020295	.	G	A	4	2	6	0	0	6	0	0
16	38020307	.	A	G	3	2	5	0	1	6	0	0
16	38067881	.	G	A	1	2	3	0	0	3	0	0
16	38121981	.	C	T	3	2	5	0	0	5	0	0
16	38124907	.	T	G	3	0	3	0	2	5	0	0
16	38129427	.	T	A	3	2	5	0	0	5	0	0
16	38130661	.	T	C	4	3	7	0	1	8	0	0
16	38135699	.	T	C	5	5	10	0	0	10	0	0
16	38135763	.	A	G	7	5	12	0	0	12	0	0
16	38136117	.	C	T	5	7	12	0	1	13	0	0
16	38136278	.	C	T	12	13	25	0	1	26	0	0
16	38136317	.	G	A	7	11	18	0	1	19	0	0
16	38136346	.	C	T	13	4	17	0	0	17	0	0
16	38136491	.	G	C	4	6	10	0	0	10	0	0
16	38159817	.	C	A	3	4	7	0	1	8	0	0
16	38167511	.	C	T	2	3	5	0	0	5	0	0
16	38168009	.	A	G	8	7	15	0	0	15	0	0
16	38168095	.	G	A	0	3	3	0	4	7	0	0
16	38188955	.	G	A	2	4	6	0	5	11	0	0
16	38189099	.	T	C	12	4	16	0	1	17	0	0
16	38191645	.	C	T	3	3	6	0	2	8	0	0
16	38194017	.	T	C	7	8	15	0	1	16	0	0
16	38199647	.	G	A	2	5	7	0	0	7	0	0
16	38261183	.	G	A	1	2	3	0	0	3	0	0
16	38261193	.	C	T	1	2	3	0	0	3	0	0
16	38266188	.	T	A	1	2	3	0	0	3	0	0
16	38266221	.	A	C	2	3	5	0	1	6	0	0
16	38266242	.	T	C	1	3	4	0	1	5	0	0
16	38351061	.	T	A	1	3	4	0	0	4	0	0
16	38355299	.	G	A	7	7	14	0	1	15	0	0
16	38556912	.	G	A	15	13	28	0	1	29	0	0
16	38556922	.	C	G	0	10	10	0	16	26	0	0
16	38557876	.	G	C	26	0	26	0	25	51	0	0
16	38568644	.	G	C	22	12	34	0	1	35	0	0
16	38729548	.	G	A	3	9	12	0	0	12	0	0
16	38729551	.	G	T	0	3	3	0	9	12	0	0
16	38943253	.	C	T	9	8	17	0	0	17	0	0
16	39146871	.	A	C	12	9	21	0	2	23	0	0
16	39147060	.	C	G	20	0	20	0	6	26	0	0
16	39147355	.	G	C	26	12	38	0	1	39	0	0
16	39147386	.	C	A	31	15	46	0	1	47	0	0
16	39154953	.	G	A	19	9	28	0	1	29	0	0
16	39157751	.	C	A	15	20	35	0	1	36	0	0
16	39157885	.	T	A	20	23	43	0	3	48	2	0
16	39160458	.	A	C	23	23	46	0	0	46	0	0
16	39162786	.	C	T	16	22	38	0	3	41	0	0
16	39164213	.	G	A	22	21	43	0	3	46	0	0
16	39166773	.	C	T	21	18	39	0	1	40	0	0
16	39166854	.	C	T	18	30	48	0	1	49	0	0
16	39167028	.	C	A	19	10	29	0	2	31	0	0
16	39167088	.	C	T	14	8	22	0	0	22	0	0
16	39185580	.	G	A	12	10	22	0	1	23	0	0
16	39191557	.	T	C	18	1	19	0	10	29	0	0
16	39196850	.	A	C	1	4	5	0	1	6	0	0
16	39196890	.	A	C	1	6	7	0	0	7	0	0
16	39196956	.	A	G	1	4	5	0	0	5	0	0
16	39213237	.	G	A	0	2	2	0	2	4	0	0
16	39213314	.	G	A	1	3	4	0	1	5	0	0
16	39232788	.	C	A	1	2	3	0	0	3	0	0
16	39238437	.	A	C	1	0	1	0	5	6	0	0
16	39238539	.	A	T	1	1	2	0	1	3	0	0
16	39238547	.	A	T	1	2	3	0	0	3	0	0
16	39238630	.	G	A	3	2	5	1	0	6	0	0
16	39244286	.	T	C	26	17	43	0	0	43	0	0
16	39248745	.	T	A	5	7	12	2	0	14	0	0
16	39248765	.	G	C	6	7	13	0	0	13	0	0
16	39248811	.	C	G	8	6	14	0	0	14	0	0
16	39248813	.	T	A	8	6	14	0	0	14	0	0
16	39248864	.	G	A	5	5	10	0	0	10	0	0
16	39248886	.	C	A	3	4	7	0	0	7	0	0
16	39248976	.	G	A	9	6	15	0	1	16	0	0
16	39249056	.	G	A	10	7	17	0	0	17	0	0
16	39249229	.	C	T	6	8	14	0	0	14	0	0
16	39249350	.	A	C	5	2	7	0	0	7	0	0
16	39249475	.	C	A	3	7	10	0	0	10	0	0
16	39249506	.	G	A	3	5	8	0	0	8	0	0
16	39249527	.	A	T	4	3	7	0	0	7	0	0
16	39250111	.	G	A	2	4	6	0	0	6	0	0
16	39250258	.	C	T	4	2	6	0	0	6	0	0
16	39250259	.	A	G	4	2	6	0	0	6	0	0
16	39250574	.	G	A	5	3	8	0	0	8	0	0
16	39253200	.	G	A	5	6	11	0	0	11	0	0
16	39271329	.	A	C	8	3	11	0	2	13	0	0
16	39271394	.	G	C	3	5	8	0	0	8	0	0
16	39297336	.	C	A	4	5	9	0	2	11	0	0
16	39297344	.	A	T	5	4	9	0	1	10	0	0
16	39297378	.	C	T	3	3	6	0	0	6	0	0
16	39323626	.	T	G	4	0	4	0	5	9	0	0
16	39323716	.	C	T	2	9	11	0	0	11	0	0
16	39323809	.	T	C	7	4	11	0	0	11	0	0
16	39325084	.	A	G	7	0	7	0	5	12	0	0
16	39325121	.	G	A	7	4	11	0	1	12	0	0
16	39361889	.	C	T	5	3	8	0	0	8	0	0
16	39372345	.	G	A	6	9	15	0	1	16	0	0
16	39372372	.	T	C	4	11	15	0	2	17	0	0
16	39372735	.	G	C	1	7	8	0	11	19	0	0
16	39372780	.	C	A	12	11	23	0	0	23	0	0
16	39378744	.	A	G	17	1	18	0	6	24	0	0
16	39382047	.	C	G	10	5	15	0	0	15	0	0
16	39382084	.	C	T	12	11	23	0	0	23	0	0
16	39382098	.	G	A	12	12	24	0	0	24	0	0
16	39382208	.	T	C	6	6	12	0	1	13	0	0
16	39382467	.	C	G	4	6	10	0	0	10	0	0
16	39382482	.	G	A	4	5	9	0	0	9	0	0
16	39385568	.	T	G	6	0	6	0	0	6	0	0
16	39385755	.	T	C	13	0	13	0	14	27	0	0
16	39386184	.	T	C	22	7	29	0	2	31	0	0
16	39386239	.	T	A	15	15	30	0	2	32	0	0
16	39386915	.	C	T	18	17	35	0	0	35	0	0
16	39390139	.	T	C	21	0	21	0	16	37	0	0
16	39390175	.	G	A	19	18	37	0	1	38	0	0
16	39393370	.	A	G	12	17	29	0	3	32	0	0
16	39394630	.	A	G	13	15	28	0	5	33	0	0
16	39399140	.	A	C	10	1	11	0	6	17	0	0
16	39413514	.	C	T	7	6	13	0	0	13	0	0
16	39505310	.	A	T	4	2	6	0	0	6	0	0
16	39742484	.	A	G	2	2	4	0	0	4	0	0
16	39901274	.	G	A	3	2	5	0	0	5	0	0
16	40026573	.	A	G	3	0	3	0	3	6	0	0
16	40031649	.	A	G	2	5	7	0	1	8	0	0
16	40066964	.	C	T	2	4	6	0	0	6	0	0
16	40131552	.	T	A	2	2	4	0	0	4	0	0
16	40131556	.	T	G	2	2	4	0	0	4	0	0
16	40153313	.	G	C	4	3	7	0	0	7	0	0
16	40340844	.	C	A	3	3	6	0	0	6	0	0
16	40340847	.	A	G	3	0	3	0	3	6	0	0
16	40340953	.	C	G	3	0	3	0	3	6	0	0
16	40340967	.	A	G	3	4	7	0	0	7	0	0
16	40341024	.	T	C	3	2	5	0	1	6	0	0
16	40341255	.	C	G	0	2	2	0	1	3	0	0
16	40341264	.	C	T	1	2	3	0	0	3	0	0
16	40343747	.	T	C	5	1	6	0	2	8	0	0
16	40347546	.	T	A	1	4	5	0	1	6	0	0
16	40491931	.	A	G	11	10	21	0	1	22	0	0
16	40495482	.	C	T	3	5	8	0	3	11	0	0
16	40503994	.	G	A	9	9	18	0	1	19	0	0
16	40523798	.	A	G	1	0	1	0	2	3	0	0
16	40530380	.	G	A	1	3	4	0	0	4	0	0
16	40560713	.	C	T	3	3	6	0	1	7	0	0
16	40563673	.	G	T	3	2	5	0	1	6	0	0
16	40563811	.	G	A	2	2	4	0	0	4	0	0
16	40568162	.	A	G	2	0	2	0	2	4	0	0
16	40568274	.	G	A	1	6	7	0	2	9	0	0
16	40568336	.	A	G	6	0	6	0	4	10	0	0
16	40569558	.	A	C	2	2	4	0	0	4	0	0
16	40583149	.	C	A	2	2	4	0	0	4	0	0
16	40606844	.	T	A	2	5	7	0	0	7	0	0
16	40607436	.	C	T	1	5	6	0	0	6	0	0
16	40610727	.	C	T	4	5	9	0	3	12	0	0
16	40616864	.	G	A	2	2	4	0	0	4	0	0
16	40619643	.	C	A	2	2	4	0	0	4	0	0
16	40622799	.	G	A	2	2	4	0	0	4	0	0
16	40632787	.	A	C	2	0	2	0	3	5	0	0
16	40634820	.	A	G	2	3	5	0	0	5	0	0
16	40672891	.	C	T	1	2	3	0	0	3	0	0
16	40673981	.	C	T	0	5	5	0	2	7	0	0
16	40840699	.	T	A	1	3	4	0	0	4	0	0
16	40954538	.	C	T	5	4	9	0	0	9	0	0
16	40954866	.	T	C	6	11	17	0	0	17	0	0
16	40954983	.	A	C	7	9	16	0	1	17	0	0
16	40955515	.	G	T	9	5	14	0	1	15	0	0
16	40955525	.	C	T	10	6	16	0	0	16	0	0
16	40955722	.	G	C	1	4	5	0	0	5	0	0
16	40992113	.	G	C	2	3	5	0	0	5	0	0
16	40992277	.	C	A	2	2	4	0	0	4	0	0
16	40992490	.	A	G	8	7	15	0	0	15	0	0
16	40992529	.	G	A	7	3	10	0	0	10	0	0
16	41003665	.	T	C	2	0	2	0	2	4	0	0
16	41003845	.	G	T	1	2	3	0	0	3	0	0
16	41003923	.	G	A	1	2	3	0	1	4	0	0
16	41029443	.	G	A	7	6	13	0	0	13	0	0
16	41029626	.	G	T	2	2	4	0	0	4	0	0
16	41029649	.	T	C	2	2	4	0	0	4	0	0
16	41029692	.	T	A	1	0	1	0	1	2	0	0
16	41030017	.	A	C	2	7	9	0	0	9	0	0
16	41030137	.	A	G	9	3	12	0	1	13	0	0
16	41084891	.	C	T	1	3	4	0	0	4	0	0
16	41112493	.	C	T	4	8	12	0	1	13	0	0
16	41112571	.	T	C	3	4	7	0	1	8	0	0
16	41112861	.	G	C	8	0	8	0	4	12	0	0
16	41113676	.	T	G	7	9	16	0	1	17	0	0
16	41113698	.	A	T	7	8	15	0	0	15	0	0
16	41113752	.	G	A	8	11	19	0	0	19	0	0
16	41113755	.	C	T	11	8	19	0	0	19	0	0
16	41114779	.	G	A	9	3	12	0	0	12	0	0
16	41114800	.	A	T	2	7	9	0	1	10	0	0
16	41114976	.	G	T	8	6	14	1	0	15	0	0
16	41115079	.	T	G	4	5	9	0	0	9	0	0
16	41115997	.	A	T	7	7	14	0	1	15	0	0
16	41115998	.	C	T	1	7	8	0	7	15	0	0
16	41116367	.	G	A	2	7	9	0	0	9	0	0
16	41116548	.	G	A	4	5	9	0	0	9	0	0
16	41116571	.	G	A	3	5	8	0	0	8	0	0
16	41116783	.	C	T	3	2	5	0	0	5	0	0
16	41119347	.	T	C	3	3	6	0	0	6	0	0
16	41345674	.	A	T	8	7	15	0	1	16	0	0
16	41345826	.	G	T	6	6	12	0	1	13	0	0
16	41346007	.	C	A	1	7	8	0	12	20	0	0
16	41353140	.	G	A	9	10	19	0	1	20	0	0
16	41393773	.	C	T	8	9	17	0	0	17	0	0
16	41468848	.	T	G	3	4	7	0	1	8	0	0
16	41469008	.	G	A	3	3	6	0	0	6	0	0
16	41469029	.	C	A	1	2	3	0	0	3	0	0
16	41471881	.	C	T	1	2	3	0	2	5	0	0
16	41473099	.	G	T	1	2	3	0	0	3	0	0
16	41533866	.	G	A	4	3	7	0	0	7	0	0
16	41585743	.	C	T	1	5	6	0	2	8	0	0
16	41589214	.	A	G	5	4	9	0	0	9	0	0
16	41599917	.	C	T	9	4	13	0	0	13	0	0
16	41620163	.	T	C	1	5	6	0	0	6	0	0
16	41646081	.	C	T	2	3	5	0	0	5	0	0
16	41704050	.	A	G	1	2	3	0	0	3	0	0
16	41704056	.	T	A	1	1	2	0	1	3	0	0
16	41717479	.	G	A	8	4	12	0	0	12	0	0
16	41717482	.	A	G	8	3	11	0	1	12	0	0
16	41717666	.	G	A	1	9	10	1	17	28	0	0
16	41720533	.	G	T	12	6	18	0	1	19	0	0
16	41720536	.	T	G	13	7	20	0	1	21	0	0
16	41720587	.	T	C	9	13	22	0	1	23	0	0
16	41723228	.	T	G	14	0	14	0	13	27	0	0
16	41723280	.	A	G	10	0	10	0	11	21	0	0
16	41723778	.	C	G	6	1	7	0	5	12	0	0
16	41725215	.	T	C	6	5	11	0	0	11	0	0
16	41725238	.	T	C	7	7	14	0	0	14	0	0
16	41727162	.	T	G	6	15	21	0	0	21	0	0
16	41727376	.	C	A	14	12	26	0	2	28	0	0
16	41730407	.	G	A	15	13	28	0	1	29	0	0
16	41730625	.	C	G	15	18	33	0	1	34	0	0
16	41731928	.	A	T	9	4	13	0	0	13	0	0
16	41731929	.	C	A	7	4	11	0	1	12	0	0
16	41732009	.	G	T	5	3	8	0	1	9	0	0
16	41732031	.	G	T	0	3	3	0	4	7	0	0
16	41732067	.	T	C	5	5	10	0	0	10	0	0
16	41732158	.	C	A	4	8	12	0	0	12	0	0
16	41732166	.	C	T	4	8	12	0	0	12	0	0
16	41732262	.	T	C	6	9	15	0	1	16	0	0
16	41732295	.	G	T	6	7	13	0	1	14	0	0
16	41740704	.	A	T	6	9	15	0	0	15	0	0
16	41740815	.	T	A	2	3	5	0	1	6	0	0
16	41740924	.	A	G	3	1	4	0	2	6	0	0
16	41741050	.	C	T	0	4	4	0	3	7	0	0
16	41794900	.	C	A	0	17	17	0	11	28	0	0
16	41801525	.	G	T	12	16	28	0	2	30	0	0
16	41873717	.	T	A	16	14	30	0	0	30	0	0
16	41873797	.	G	A	13	8	21	0	0	21	0	0
16	41873992	.	C	T	6	6	12	0	1	13	0	0
16	41874039	.	G	C	5	8	13	0	1	14	0	0
16	41882490	.	G	T	0	3	3	0	5	8	0	0
16	41891572	.	C	T	18	20	38	0	0	38	0	0
16	41891662	.	A	C	15	10	25	0	0	25	0	0
16	41896361	.	G	A	12	15	27	0	2	29	0	0
16	41897244	.	A	G	12	14	26	0	2	28	0	0
16	41897332	.	A	G	11	12	23	0	2	25	0	0
16	41897347	.	G	A	19	8	27	0	2	29	0	0
16	41897375	.	A	T	21	14	35	0	0	35	0	0
16	41897452	.	C	A	17	15	32	1	1	34	0	0
16	41897599	.	A	T	3	6	9	0	1	10	0	0
16	41903475	.	A	T	7	15	22	0	0	22	0	0
16	41903686	.	G	A	11	18	29	0	1	30	0	0
16	41903770	.	T	C	9	14	23	1	1	25	0	0
16	41903801	.	T	G	8	14	22	1	1	24	0	0
16	41903957	.	T	C	12	7	19	0	1	20	0	0
16	41904121	.	T	G	13	12	25	0	1	26	0	0
16	41904209	.	T	C	15	8	23	0	1	24	0	0
16	41904261	.	G	A	8	15	23	0	0	23	0	0
16	41904430	.	C	A	14	14	28	0	2	30	0	0
16	41904440	.	C	A	3	8	11	0	14	25	0	0
16	41904615	.	T	C	13	0	13	0	11	24	0	0
16	41904650	.	G	A	16	5	21	0	1	22	0	0
16	41904680	.	A	T	14	2	16	1	0	17	0	0
16	41904828	.	T	C	4	2	6	0	1	7	0	0
16	41904879	.	A	T	2	10	12	0	0	12	0	0
16	41904961	.	A	G	9	12	21	0	0	21	0	0
16	41905631	.	A	G	9	9	18	0	2	20	0	0
16	41905666	.	A	G	10	5	15	0	1	16	0	0
16	41905682	.	G	T	13	7	20	0	0	20	0	0
16	41905720	.	T	A	6	5	11	0	3	14	0	0
16	41905807	.	G	C	8	8	16	0	0	16	0	0
16	41912225	.	G	A	8	11	19	0	1	20	0	0
16	41916819	.	A	G	12	14	26	0	0	26	0	0
16	41925227	.	G	C	20	0	20	0	13	33	0	0
16	41933222	.	A	C	9	5	14	0	1	15	0	0
16	41933411	.	G	A	3	10	13	0	0	13	0	0
16	42072207	.	T	A	18	15	33	1	2	36	0	0
16	42072719	.	A	C	17	20	37	0	1	38	0	0
16	42073086	.	A	G	4	9	13	0	0	13	0	0
16	42073488	.	T	C	14	1	15	0	21	36	0	0
16	42083039	.	G	A	6	14	20	0	0	20	0	0
16	42091814	.	A	G	15	15	30	0	1	31	0	0
16	42151633	.	T	C	3	4	7	0	0	7	0	0
16	42156619	.	C	T	2	2	4	0	0	4	0	0
16	42161312	.	G	A	2	2	4	0	0	4	0	0
16	42177840	.	C	T	6	2	8	0	1	9	0	0
16	42178002	.	C	T	0	5	5	1	10	16	0	0
16	42178012	.	A	G	15	4	19	1	0	20	0	0
16	42179879	.	C	A	23	7	30	0	0	30	0	0
16	42180079	.	A	G	14	6	20	0	0	20	0	0
16	42180271	.	G	A	16	7	23	0	1	24	0	0
16	42186022	.	G	A	1	4	5	0	1	6	0	0
16	42186043	.	A	T	2	4	6	0	1	7	0	0
16	42186063	.	A	G	2	3	5	0	0	5	0	0
16	42193194	.	T	A	2	2	4	0	0	4	0	0
16	42207600	.	A	G	3	3	6	0	0	6	0	0
16	42300453	.	C	G	0	2	2	0	1	3	0	0
16	42322458	.	T	G	39	37	76	1	1	78	0	0
16	42373933	.	A	C	23	23	46	0	4	50	0	0
16	42374020	.	C	T	2	27	29	0	21	50	0	0
16	42374080	.	G	T	22	27	49	0	3	52	0	0
16	42374254	.	C	T	16	30	46	0	1	47	0	0
16	42374290	.	G	A	21	26	47	0	1	48	0	0
16	42374425	.	A	G	18	24	42	0	0	42	0	0
16	42374434	.	A	C	21	17	38	0	2	40	0	0
16	42390176	.	T	C	12	0	12	0	18	30	0	0
16	42424189	.	G	A	15	16	31	0	2	33	0	0
16	42424240	.	G	A	9	13	22	0	1	23	0	0
16	42424348	.	T	C	17	9	26	0	0	26	0	0
16	42424352	.	G	A	17	8	25	0	1	26	0	0
16	42424504	.	C	A	4	11	15	0	0	15	0	0
16	42424505	.	A	C	4	11	15	0	0	15	0	0
16	42424653	.	G	C	9	5	14	0	1	15	0	0
16	42424762	.	G	A	19	7	26	1	2	29	0	0
16	42441986	.	T	C	9	5	14	0	0	14	0	0
16	42443965	.	G	A	5	5	10	0	1	11	0	0
16	42452554	.	T	C	0	9	9	0	1	10	0	0
16	42452557	.	G	A	1	8	9	0	1	10	0	0
16	42452591	.	C	G	3	7	10	0	1	11	0	0
16	42452592	.	T	A	3	8	11	0	0	11	0	0
16	42453542	.	C	T	0	2	2	0	5	7	0	0
16	42459378	.	T	C	2	3	5	0	0	5	0	0
16	42461066	.	A	G	1	4	5	0	1	6	0	0
16	42461121	.	T	C	4	0	4	0	9	13	0	0
16	42472146	.	G	T	1	3	4	0	0	4	0	0
16	42472715	.	C	T	4	2	6	0	0	6	0	0
16	42487947	.	A	G	3	13	16	0	10	26	0	0
16	42490255	.	C	T	9	6	15	0	1	16	0	0
16	42490264	.	T	C	7	9	16	0	0	16	0	0
16	42493796	.	G	C	1	15	16	0	15	31	0	0
16	42493900	.	A	T	8	6	14	2	1	17	0	0
16	42494084	.	G	A	0	6	6	0	9	15	0	0
16	42494143	.	A	T	5	2	7	0	1	9	1	0
16	42681270	.	G	C	3	2	5	0	0	5	0	0
16	42833084	.	T	C	12	7	19	0	0	19	0	0
16	42842991	.	G	C	17	10	27	0	0	27	0	0
16	42842995	.	A	G	16	10	26	0	1	27	0	0
16	42843128	.	G	A	7	2	9	0	0	9	0	0
16	42938992	.	G	T	6	3	9	0	0	9	0	0
16	42939061	.	A	T	3	2	5	0	0	5	0	0
16	42939088	.	C	A	1	4	5	0	0	5	0	0
16	42939124	.	T	A	3	6	9	0	0	9	0	0
16	42939343	.	C	T	0	9	9	0	19	28	0	0
16	42939351	.	T	C	11	11	22	0	2	24	0	0
16	42939411	.	G	C	0	2	2	0	9	11	0	0
16	42939443	.	A	C	7	1	8	0	18	26	0	0
16	42939479	.	A	G	19	11	30	0	2	32	0	0
16	42939480	.	C	T	3	11	14	0	19	33	0	0
16	42939561	.	G	C	20	9	29	0	1	30	0	0
16	42939695	.	A	G	9	10	19	0	0	19	0	0
16	42940157	.	G	A	4	5	9	0	0	9	0	0
16	42940259	.	A	G	4	4	8	0	0	8	0	0
16	42940490	.	T	C	2	4	6	0	0	6	0	0
16	42940551	.	C	G	3	2	5	0	0	5	0	0
16	42940554	.	G	A	2	2	4	0	0	4	0	0
16	42940916	.	G	A	2	2	4	0	1	5	0	0
16	42941189	.	C	A	4	8	12	0	0	12	0	0
16	42949149	.	G	A	6	3	9	0	0	9	0	0
16	42949151	.	C	T	0	4	4	0	4	8	0	0
16	43001246	.	G	C	6	0	6	0	13	19	0	0
16	43001354	.	C	T	1	23	24	0	9	33	0	0
16	43003080	.	A	G	11	17	28	0	1	29	0	0
16	43026164	.	G	T	4	4	8	0	0	8	0	0
16	43026201	.	G	T	4	8	12	0	0	12	0	0
16	43028153	.	T	A	3	3	6	0	0	6	0	0
16	43028156	.	G	A	4	3	7	0	0	7	0	0
16	43028542	.	A	T	7	11	18	0	0	18	0	0
16	43028546	.	C	T	6	8	14	0	2	16	0	0
16	43028626	.	A	C	6	6	12	0	0	12	0	0
16	43031834	.	C	G	4	4	8	0	0	8	0	0
16	43032146	.	A	C	2	1	3	0	1	4	0	0
16	43032175	.	C	A	2	2	4	0	0	4	0	0
16	43126424	.	A	T	4	2	6	0	0	6	0	0
16	43126425	.	C	T	4	2	6	0	0	6	0	0
16	43126502	.	G	T	3	4	7	0	0	7	0	0
16	43126546	.	A	C	4	0	4	0	5	9	0	0
16	43126566	.	G	A	7	3	10	0	0	10	0	0
16	43126603	.	A	T	3	4	7	0	0	7	0	0
16	43126886	.	A	G	9	10	19	0	0	19	0	0
16	43126887	.	C	T	0	7	7	0	12	19	0	0
16	43145812	.	T	C	2	3	5	0	0	5	0	0
16	43149664	.	C	T	3	2	5	0	0	5	0	0
16	43149687	.	C	G	3	2	5	0	0	5	0	0
16	43198921	.	C	T	4	2	6	0	2	8	0	0
16	43228942	.	C	T	3	8	11	0	0	11	0	0
16	43228945	.	T	C	2	7	9	0	1	10	0	0
16	43229315	.	T	C	1	0	1	0	8	9	0	0
16	43971245	.	T	C	7	9	16	0	0	16	0	0
16	43971248	.	G	A	7	9	16	0	1	17	0	0
16	44044497	.	C	T	2	8	10	0	0	10	0	0
16	44338921	.	T	A	23	32	55	0	1	56	0	0
16	44339284	.	C	T	2	18	20	0	24	44	0	0
16	44339466	.	A	G	18	29	47	0	4	51	0	0
16	44339475	.	A	G	21	34	55	0	1	56	0	0
16	44342679	.	C	T	30	19	49	0	0	49	0	0
16	44379120	.	A	G	16	9	25	0	2	27	0	0
16	44379168	.	T	C	23	12	35	0	1	36	0	0
16	44379219	.	T	A	17	13	30	0	1	31	0	0
16	46091247	.	T	C	6	2	8	0	0	8	0	0
16	46198406	.	A	G	22	21	43	0	2	45	0	0
16	46200655	.	G	A	2	58	60	0	9	69	0	0
16	46200745	.	A	G	54	12	66	0	2	68	0	0
16	46399586	.	T	C	4	7	11	0	1	12	0	0
16	46399587	.	T	C	5	1	6	0	6	12	0	0
16	46464219	.	G	A	16	5	21	3	2	27	1	0
16	46464279	.	G	A	18	5	23	1	0	24	0	0
16	46464423	.	A	G	7	2	9	0	3	12	0	0
16	49463122	.	A	G	2	1	3	0	4	7	0	0
16	49463130	.	C	G	1	1	2	0	5	7	0	0
16	51183892	.	A	T	5	4	9	0	2	11	0	0
16	51244308	.	T	A	1	2	3	0	1	4	0	0
16	51244464	.	T	C	4	2	6	0	1	7	0	0
16	51244487	.	T	C	1	3	4	0	1	5	0	0
16	51244500	.	T	C	2	2	4	0	1	5	0	0
16	51559317	.	T	G	1	0	1	0	3	4	0	0
16	51559527	.	C	T	4	5	9	0	0	9	0	0
16	51950940	.	G	A	6	41	47	0	3	50	0	0
16	51951344	.	T	C	27	9	36	0	0	36	0	0
16	51951690	.	T	C	4	15	19	0	1	20	0	0
16	51951691	.	T	C	13	7	20	0	2	22	0	0
16	52208238	.	C	T	3	4	7	0	0	7	0	0
16	52214476	.	C	T	7	4	11	0	1	12	0	0
16	52218769	.	C	T	2	4	6	0	1	7	0	0
16	52223760	.	C	G	2	4	6	0	0	6	0	0
16	53213713	.	C	T	2	4	6	0	0	6	0	0
16	53224473	.	G	C	0	6	6	0	4	10	0	0
16	53247109	.	T	A	2	3	5	0	0	5	0	0
16	53278406	.	A	G	3	0	3	0	2	5	0	0
16	53278513	.	A	G	4	1	5	0	4	9	0	0
16	53290842	.	G	A	0	5	5	0	1	6	0	0
16	53390799	.	C	A	2	2	4	0	0	4	0	0
16	53390832	.	C	T	2	2	4	0	0	4	0	0
16	53390838	.	C	T	2	2	4	0	0	4	0	0
16	53430381	.	C	T	1	4	5	0	0	5	0	0
16	53443714	.	C	T	1	5	6	0	0	6	0	0
16	53449799	.	C	G	4	1	5	0	1	6	0	0
16	53495455	.	G	A	0	2	2	0	1	3	0	0
16	53495521	.	C	T	5	4	9	0	0	9	0	0
16	53502390	.	C	T	8	3	11	0	1	12	0	0
16	53513549	.	C	T	12	4	16	0	1	17	0	0
16	53513618	.	C	G	10	0	10	0	7	17	0	0
16	53516147	.	T	G	16	7	23	0	0	23	0	0
16	53516232	.	G	A	15	8	23	0	1	24	0	0
16	53516303	.	T	C	6	3	9	1	1	11	0	0
16	53519091	.	T	G	4	4	8	0	0	8	0	0
16	53529665	.	T	C	2	2	4	0	0	4	0	0
16	53530047	.	G	C	0	2	2	0	4	6	0	0
16	53530490	.	A	T	3	6	9	0	0	9	0	0
16	53538806	.	G	A	2	9	11	0	4	15	0	0
16	53539389	.	G	A	6	8	14	0	1	15	0	0
16	53539399	.	T	C	11	6	17	0	2	19	0	0
16	53541879	.	A	G	5	7	12	0	0	12	0	0
16	53541963	.	T	A	6	9	15	0	0	15	0	0
16	53590609	.	C	T	3	2	5	0	1	6	0	0
16	53591872	.	G	A	13	5	18	0	0	18	0	0
16	53591908	.	C	G	5	14	19	0	0	19	0	0
16	53592058	.	T	A	12	7	19	0	3	22	0	0
16	53592373	.	A	T	1	14	15	0	6	21	0	0
16	53592375	.	C	T	10	8	18	0	4	22	0	0
16	53596689	.	C	T	6	7	13	0	0	13	0	0
16	53596872	.	C	T	5	4	9	0	0	9	0	0
16	53601486	.	A	G	3	1	4	0	17	21	0	0
16	53609415	.	A	G	2	3	5	0	0	5	0	0
16	53610102	.	C	T	3	3	6	0	0	6	0	0
16	53621578	.	A	G	5	0	5	0	10	15	0	0
16	53623357	.	G	A	2	2	4	0	3	7	0	0
16	53626832	.	T	C	3	3	6	0	1	7	0	0
16	53626853	.	T	C	5	3	8	0	0	8	0	0
16	53629202	.	G	A	4	6	10	0	1	11	0	0
16	53633125	.	G	A	0	4	4	0	6	10	0	0
16	53701171	.	A	C	32	32	64	0	6	70	0	0
16	53708312	.	C	G	29	35	64	0	4	68	0	0
16	53708537	.	G	T	4	3	7	1	0	8	0	0
16	53708564	.	T	C	2	3	5	1	1	7	0	0
16	53734044	.	C	T	2	2	4	0	1	5	0	0
16	53734064	.	T	A	1	3	4	0	0	4	0	0
16	53734226	.	C	T	0	3	3	0	2	5	0	0
16	53734454	.	G	T	2	3	5	0	0	5	0	0
16	53734522	.	A	C	4	2	6	0	0	6	0	0
16	54186911	.	C	T	4	4	8	0	2	10	0	0
16	54217347	.	A	C	4	2	6	0	1	7	0	0
16	54217408	.	G	A	0	8	8	0	2	10	0	0
16	54222433	.	T	C	2	3	5	0	0	5	0	0
16	54222448	.	G	A	2	4	6	0	0	6	0	0
16	54239233	.	C	T	4	5	9	0	2	11	0	0
16	54245609	.	C	T	2	5	7	0	0	7	0	0
16	54303499	.	G	A	2	1	3	0	1	4	0	0
16	54303742	.	G	C	2	4	6	0	0	6	0	0
16	54313643	.	T	A	3	5	8	0	0	8	0	0
16	54314226	.	G	A	0	7	7	0	3	10	0	0
16	54320243	.	A	G	5	3	8	0	0	8	0	0
16	54349042	.	A	G	2	2	4	0	0	4	0	0
16	54829650	.	C	T	23	29	52	0	2	54	0	0
16	54829656	.	A	G	23	29	52	0	3	55	0	0
16	54837250	.	T	C	33	31	64	0	7	71	0	0
16	54843723	.	C	T	35	34	69	0	2	71	0	0
16	54843798	.	A	G	37	3	40	0	38	78	0	0
16	54846250	.	G	A	7	25	32	0	34	66	0	0
16	54930903	.	A	G	2	5	7	0	0	7	0	0
16	54930916	.	T	A	2	4	6	0	0	6	0	0
16	54932914	.	C	A	2	3	5	0	0	5	0	0
16	54947827	.	T	G	3	3	6	0	0	6	0	0
16	54947978	.	G	A	10	4	14	0	0	14	0	0
16	54948227	.	A	G	4	9	13	2	2	17	0	0
16	54948369	.	T	A	2	4	6	0	0	6	0	0
16	54948467	.	C	A	11	6	17	0	0	17	0	0
16	54948483	.	T	A	12	5	17	0	0	17	0	0
16	54948511	.	C	A	1	4	5	0	10	15	0	0
16	54949140	.	G	A	22	10	32	0	0	32	0	0
16	54952935	.	G	A	12	16	28	0	1	29	0	0
16	54953031	.	C	T	1	17	18	0	11	29	0	0
16	54953067	.	G	A	11	19	30	0	1	31	0	0
16	54956620	.	C	T	5	10	15	0	0	15	0	0
16	54956777	.	T	C	3	4	7	0	0	7	0	0
16	54957387	.	A	G	10	10	20	0	0	20	0	0
16	54957388	.	C	G	10	10	20	0	0	20	0	0
16	54958913	.	G	A	5	4	9	0	0	9	0	0
16	54960951	.	A	C	5	8	13	0	0	13	0	0
16	54964146	.	A	G	4	6	10	0	0	10	0	0
16	55004634	.	C	A	4	4	8	0	0	8	0	0
16	55004655	.	A	T	7	11	18	0	0	18	0	0
16	55004716	.	T	C	11	0	11	0	14	25	0	0
16	55007670	.	G	A	8	15	23	0	0	23	0	0
16	55083392	.	G	T	4	4	8	0	1	9	0	0
16	55095692	.	T	A	5	4	9	0	1	11	1	0
16	55102314	.	T	C	6	2	8	0	0	8	0	0
16	55102320	.	C	G	6	3	9	0	0	9	0	0
16	55102387	.	C	T	8	3	11	0	2	13	0	0
16	55102467	.	G	A	4	2	6	0	0	6	0	0
16	55102568	.	T	C	1	3	4	0	0	4	0	0
16	55106207	.	T	C	8	11	19	0	0	19	0	0
16	55106223	.	A	G	7	10	17	0	1	18	0	0
16	55106279	.	C	A	19	12	31	0	2	33	0	0
16	55106367	.	A	C	15	14	29	0	0	29	0	0
16	55106405	.	G	A	12	6	18	0	0	18	0	0
16	55106443	.	C	T	6	10	16	0	1	17	0	0
16	55106474	.	C	T	0	8	8	0	3	11	0	0
16	55108828	.	C	T	13	25	38	0	1	39	0	0
16	55122779	.	T	C	16	19	35	0	1	36	0	0
16	55174925	.	T	C	2	2	4	0	0	4	0	0
16	55181458	.	C	A	3	2	5	0	0	5	0	0
16	55181459	.	C	G	2	2	4	0	0	4	0	0
16	55181824	.	T	A	2	3	5	0	0	5	0	0
17	1069048	.	G	T	3	2	5	0	0	5	0	0
17	1353930	.	A	G	1	0	1	0	3	4	0	0
17	1353966	.	A	G	2	2	4	0	0	4	0	0
17	1354412	.	A	G	1	4	5	0	0	5	0	0
17	1510179	.	T	G	1	2	3	6	0	9	0	0
17	2698074	.	A	T	2	2	4	0	0	4	0	0
17	2698077	.	A	T	3	1	4	0	1	5	0	0
17	3281934	.	A	G	3	6	9	0	0	9	0	0
17	3282307	.	C	T	5	2	7	0	1	8	0	0
17	3288101	.	A	G	4	5	9	0	1	10	0	0
17	3290657	.	G	C	2	0	2	0	2	4	0	0
17	3290771	.	A	T	1	6	7	0	0	7	0	0
17	3446847	.	T	C	5	7	12	0	0	12	0	0
17	3556184	.	C	A	9	4	13	0	0	13	0	0
17	3566811	.	A	G	9	7	16	0	0	16	0	0
17	3566844	.	T	A	9	9	18	0	1	19	0	0
17	3569047	.	T	C	6	7	13	0	0	13	0	0
17	3569050	.	A	C	4	8	12	0	2	14	0	0
17	3569169	.	A	G	5	9	14	0	1	15	0	0
17	3569264	.	A	C	9	6	15	0	1	16	0	0
17	3569298	.	A	G	1	8	9	0	3	12	0	0
17	3841153	.	A	G	6	4	10	1	1	12	0	0
17	3850524	.	G	A	10	7	17	0	0	17	0	0
17	3854266	.	T	C	12	13	25	0	0	25	0	0
17	3854287	.	C	T	2	10	12	0	12	24	0	0
17	3855403	.	G	A	7	4	11	0	1	12	0	0
17	3855436	.	T	C	6	0	6	0	5	11	0	0
17	3855697	.	C	T	1	8	9	0	7	16	0	0
17	3860794	.	C	G	8	4	12	0	3	15	0	0
17	3860797	.	T	C	8	0	8	0	6	14	0	0
17	3868759	.	A	C	9	0	9	0	4	13	0	0
17	3868765	.	T	C	8	1	9	0	3	12	0	0
17	4002659	.	C	A	1	3	4	0	0	4	0	0
17	4017277	.	T	C	1	4	5	0	0	5	0	0
17	4046651	.	G	T	0	2	2	0	1	3	0	0
17	4239711	.	A	G	17	6	23	0	0	23	0	0
17	4245126	.	A	G	8	4	12	0	0	12	0	0
17	4297546	.	C	T	21	16	37	0	3	40	0	0
17	4297551	.	A	C	22	13	35	0	2	37	0	0
17	4297600	.	T	C	21	11	32	0	0	32	0	0
17	4297608	.	G	C	20	0	20	0	14	34	0	0
17	4297697	.	A	T	9	13	22	0	0	22	0	0
17	4297957	.	G	C	24	0	24	0	15	39	0	0
17	4298174	.	C	T	21	19	40	0	1	41	0	0
17	4298190	.	T	A	21	21	42	0	1	43	0	0
17	4298221	.	T	A	23	11	34	0	1	35	0	0
17	4298307	.	A	T	24	3	27	1	1	29	0	0
17	4298326	.	T	G	20	12	32	1	5	38	0	0
17	4298349	.	T	A	25	12	37	1	5	43	0	0
17	4298768	.	T	G	5	5	10	0	2	12	0	0
17	4298945	.	G	A	14	5	19	1	0	20	0	0
17	4298990	.	A	G	17	7	24	0	2	26	0	0
17	4298996	.	C	T	17	8	25	0	2	27	0	0
17	4299030	.	C	G	16	15	31	0	0	31	0	0
17	4299031	.	C	T	15	15	30	0	1	31	0	0
17	4304841	.	G	A	14	37	51	0	0	51	0	0
17	4307242	.	T	C	19	0	19	0	23	42	0	0
17	4313342	.	G	A	8	12	20	0	1	21	0	0
17	4356752	.	C	T	1	3	4	0	0	4	0	0
17	4368935	.	A	T	3	3	6	0	0	6	0	0
17	4368968	.	G	A	1	4	5	0	1	6	0	0
17	4369199	.	A	T	1	3	4	0	1	5	0	0
17	4369200	.	C	T	2	3	5	0	0	5	0	0
17	4369379	.	G	T	1	3	4	0	0	4	0	0
17	4378210	.	G	A	7	4	11	1	2	14	0	0
17	4378219	.	C	T	6	6	12	1	1	14	0	0
17	4385860	.	C	T	3	8	11	0	0	11	0	0
17	4385871	.	T	C	3	8	11	0	0	11	0	0
17	5061184	.	G	C	4	8	12	0	0	12	0	0
17	5617306	.	G	A	0	2	2	0	1	3	0	0
17	5662984	.	T	C	1	2	3	0	0	3	0	0
17	5662996	.	A	G	1	2	3	0	0	3	0	0
17	5768776	.	A	C	1	2	3	0	0	3	0	0
17	5768792	.	C	T	1	2	3	0	0	3	0	0
17	5818129	.	T	G	1	0	1	0	2	3	0	0
17	5818501	.	G	T	2	2	4	0	0	4	0	0
17	5820083	.	C	T	6	5	11	0	0	11	0	0
17	5820170	.	C	T	2	2	4	0	0	4	0	0
17	5820572	.	A	G	2	5	7	0	0	7	0	0
17	5821130	.	C	T	2	3	5	0	1	6	0	0
17	5821134	.	A	G	3	3	6	0	0	6	0	0
17	5821476	.	G	A	3	5	8	0	0	8	0	0
17	5895704	.	G	C	1	5	6	0	0	6	0	0
17	5896025	.	G	A	16	12	28	0	1	29	0	0
17	5916392	.	A	G	21	11	32	0	2	34	0	0
17	5926722	.	T	C	16	20	36	0	0	36	0	0
17	5926981	.	A	T	22	11	33	0	1	34	0	0
17	5927085	.	C	A	13	14	27	0	1	28	0	0
17	5927101	.	T	C	13	8	21	0	1	23	1	0
17	5927172	.	G	A	3	4	7	0	0	7	0	0
17	5927214	.	G	A	0	2	2	0	4	6	0	0
17	6100980	.	G	A	1	3	4	0	0	4	0	0
17	6101565	.	G	A	5	3	8	0	0	8	0	0
17	6279806	.	C	A	13	9	22	0	2	24	0	0
17	6279876	.	G	T	1	13	14	0	19	33	0	0
17	6394106	.	C	T	5	2	7	0	0	7	0	0
17	6394301	.	C	T	0	8	8	0	4	12	0	0
17	6394744	.	C	T	6	4	10	0	0	10	0	0
17	6395560	.	T	C	9	0	9	0	5	14	0	0
17	6395971	.	G	T	2	4	6	0	0	6	0	0
17	6396090	.	G	A	3	3	6	0	0	6	0	0
17	6397618	.	C	T	3	3	6	0	0	6	0	0
17	6397926	.	C	A	2	4	6	0	0	6	0	0
17	6398570	.	G	A	1	2	3	0	0	3	0	0
17	6398704	.	G	T	1	2	3	0	0	3	0	0
17	6438226	.	C	T	2	2	4	0	0	4	0	0
17	6438334	.	A	G	4	1	5	0	1	6	0	0
17	6438630	.	T	A	7	12	19	0	0	19	0	0
17	6444514	.	T	A	5	7	12	0	1	13	0	0
17	6447234	.	A	G	5	3	8	0	0	8	0	0
17	6447418	.	G	T	5	3	8	0	1	9	0	0
17	6449404	.	C	T	1	3	4	0	6	10	0	0
17	6451511	.	G	A	3	2	5	0	0	5	0	0
17	6451687	.	A	G	1	3	4	0	0	4	0	0
17	6451702	.	A	G	1	3	4	0	0	4	0	0
17	6462023	.	A	T	11	9	20	0	0	20	0	0
17	6462390	.	T	A	1	2	3	0	0	3	0	0
17	6544615	.	T	C	2	3	5	0	0	5	0	0
17	6715755	.	T	A	22	27	49	0	2	51	0	0
17	6716412	.	G	T	36	29	65	0	0	65	0	0
17	6716472	.	G	A	33	34	67	0	2	69	0	0
17	6730114	.	G	A	34	28	62	1	2	65	0	0
17	6737970	.	C	A	2	32	34	0	28	62	0	0
17	6738212	.	C	A	1	4	5	0	4	9	0	0
17	6754428	.	C	T	0	9	9	0	4	13	0	0
17	6754437	.	T	C	4	8	12	0	1	13	0	0
17	6758867	.	T	G	8	16	24	0	0	24	0	0
17	6808341	.	A	G	13	4	17	0	2	19	0	0
17	6808796	.	A	G	3	22	25	0	1	26	0	0
17	6808808	.	A	G	6	17	23	0	1	24	0	0
17	7781458	.	T	A	1	4	5	0	0	5	0	0
17	7781609	.	A	T	1	4	5	0	2	7	0	0
17	7783524	.	G	C	2	2	4	0	0	4	0	0
17	7802799	.	A	G	3	4	7	0	0	7	0	0
17	7818872	.	T	A	3	5	8	0	0	8	0	0
17	7845364	.	G	C	14	15	29	0	2	31	0	0
17	7845412	.	T	C	17	17	34	0	0	34	0	0
17	7845566	.	C	T	15	16	31	1	1	33	0	0
17	7861124	.	C	T	18	18	36	0	1	37	0	0
17	7868632	.	G	A	26	17	43	0	2	45	0	0
17	7879348	.	T	C	12	19	31	0	1	32	0	0
17	7882941	.	G	A	20	20	40	0	1	41	0	0
17	7882998	.	G	A	12	19	31	0	3	34	0	0
17	7885662	.	A	G	10	16	26	0	1	27	0	0
17	7894976	.	T	A	11	11	22	0	0	22	0	0
17	7895023	.	G	A	15	13	28	0	1	29	0	0
17	7896356	.	C	T	3	16	19	0	23	42	0	0
17	7896390	.	C	T	2	14	16	0	24	40	0	0
17	7896478	.	C	T	14	13	27	1	0	28	0	0
17	7901137	.	C	T	24	15	39	0	0	39	0	0
17	7906568	.	G	T	13	10	23	0	2	25	0	0
17	7906610	.	C	T	11	10	21	0	1	22	0	0
17	7906612	.	G	A	12	9	21	0	2	23	0	0
17	7906646	.	T	A	9	13	22	0	0	22	0	0
17	7907851	.	C	T	15	6	21	0	0	21	0	0
17	7917997	.	G	A	9	9	18	0	0	18	0	0
17	7926040	.	G	A	6	8	14	0	1	15	0	0
17	7926076	.	C	T	8	4	12	0	1	13	0	0
17	7928263	.	A	G	10	7	17	0	0	17	0	0
17	7928600	.	C	A	0	4	4	0	10	14	0	0
17	7931737	.	G	A	8	4	12	0	0	12	0	0
17	7942122	.	G	A	7	7	14	0	0	14	0	0
17	7942127	.	T	C	8	7	15	0	0	15	0	0
17	7942191	.	T	G	9	8	17	0	0	17	0	0
17	7942366	.	T	G	9	6	15	0	5	20	0	0
17	7945421	.	C	G	6	8	14	0	0	14	0	0
17	7945485	.	A	G	3	10	13	0	1	14	0	0
17	7949042	.	G	A	5	5	10	0	0	10	0	0
17	7949066	.	G	A	6	5	11	0	0	11	0	0
17	7950372	.	C	T	7	8	15	0	0	15	0	0
17	7963202	.	G	C	2	2	4	0	0	4	0	0
17	7963236	.	G	A	3	2	5	0	0	5	0	0
17	7963282	.	G	A	6	5	11	0	0	11	0	0
17	7963294	.	G	A	6	6	12	0	1	13	0	0
17	7974804	.	T	C	6	5	11	0	0	11	0	0
17	7977746	.	A	T	2	4	6	0	0	6	0	0
17	7977806	.	C	T	1	2	3	0	0	3	0	0
17	7978112	.	T	G	3	3	6	0	0	6	0	0
17	7978533	.	G	A	1	2	3	0	0	3	0	0
17	7983068	.	A	G	3	6	9	1	0	10	0	0
17	7985543	.	A	G	1	2	3	0	0	3	0	0
17	7988467	.	C	T	0	3	3	0	1	4	0	0
17	7991338	.	G	A	4	5	9	0	0	9	0	0
17	7995790	.	C	A	1	2	3	0	1	4	0	0
17	8000122	.	C	A	4	5	9	0	0	9	0	0
17	8002895	.	G	T	1	4	5	0	0	5	0	0
17	8002928	.	C	G	1	4	5	0	0	5	0	0
17	8015404	.	G	A	4	2	6	0	0	6	0	0
17	8024283	.	A	T	3	2	5	0	0	5	0	0
17	8032895	.	C	T	3	4	7	0	0	7	0	0
17	8054851	.	G	T	1	3	4	0	0	4	0	0
17	8056251	.	A	T	2	3	5	0	0	5	0	0
17	8068432	.	G	A	1	2	3	0	0	3	0	0
17	8086538	.	C	G	2	2	4	0	0	4	0	0
17	8188963	.	G	T	0	5	5	0	5	10	0	0
17	8191475	.	A	G	3	3	6	0	1	7	0	0
17	8197141	.	G	A	5	7	12	0	0	12	0	0
17	8197569	.	C	A	5	4	9	0	0	9	0	0
17	8199812	.	C	T	2	4	6	0	0	6	0	0
17	8202712	.	G	A	0	11	11	0	6	17	0	0
17	8202742	.	G	A	2	9	11	0	10	21	0	0
17	8202778	.	T	C	14	14	28	0	0	28	0	0
17	8203468	.	G	A	13	7	20	0	0	20	0	0
17	8203498	.	G	A	16	6	22	0	0	22	0	0
17	8204086	.	G	C	13	6	19	0	1	20	0	0
17	8204087	.	C	T	11	6	17	0	2	19	0	0
17	8204248	.	A	G	9	0	9	0	17	26	0	0
17	8204533	.	C	T	17	13	30	0	0	30	0	0
17	8204755	.	A	G	21	21	42	0	0	42	0	0
17	8204818	.	A	G	17	19	36	0	1	37	0	0
17	8204935	.	T	C	19	19	38	0	1	39	0	0
17	8204962	.	C	T	14	21	35	0	0	35	0	0
17	8205340	.	A	T	26	20	46	0	0	46	0	0
17	8205697	.	A	G	13	17	30	0	2	32	0	0
17	8209315	.	T	C	15	7	22	0	0	22	0	0
17	8209327	.	C	T	6	12	18	0	0	18	0	0
17	8209837	.	T	A	14	13	27	0	1	28	0	0
17	8209931	.	C	A	12	7	19	0	1	20	0	0
17	8209944	.	A	G	11	9	20	0	0	20	0	0
17	8210203	.	G	A	8	7	15	0	0	15	0	0
17	8210411	.	A	G	3	11	14	0	1	15	0	0
17	8210466	.	A	G	7	0	7	0	9	16	0	0
17	8246121	.	C	T	1	5	6	0	0	6	0	0
17	8246281	.	G	A	1	8	9	0	0	9	0	0
17	8246329	.	T	C	0	3	3	0	1	4	0	0
17	8246341	.	A	G	1	3	4	0	0	4	0	0
17	8249153	.	A	T	3	2	5	0	0	5	0	0
17	8253267	.	A	G	4	3	7	0	0	7	0	0
17	8254979	.	C	T	0	4	4	0	2	6	0	0
17	8256663	.	G	A	2	3	5	0	0	5	0	0
17	8256711	.	G	A	2	4	6	0	0	6	0	0
17	8261762	.	C	T	4	3	7	0	1	8	0	0
17	8261769	.	G	A	5	3	8	0	0	8	0	0
17	8261864	.	A	T	3	2	5	0	0	5	0	0
17	8265406	.	G	A	1	2	3	0	0	3	0	0
17	8286764	.	C	T	3	3	6	0	1	7	0	0
17	8286789	.	G	A	2	2	4	0	0	4	0	0
17	8286877	.	A	G	3	2	5	0	0	5	0	0
17	8286879	.	C	A	3	2	5	0	0	5	0	0
17	8287050	.	T	C	1	2	3	0	0	3	0	0
17	8287082	.	A	C	2	3	5	0	0	5	0	0
17	8450188	.	C	T	1	2	3	0	0	3	0	0
17	8498844	.	A	T	4	2	6	0	0	6	0	0
17	8498845	.	A	T	3	2	5	0	1	6	0	0
17	8502883	.	G	A	7	2	9	0	1	10	0	0
17	8502934	.	A	G	6	3	9	0	0	9	0	0
17	8514511	.	G	A	1	3	4	0	0	4	0	0
17	8514634	.	G	A	3	2	5	0	0	5	0	0
17	8514648	.	A	G	3	2	5	0	0	5	0	0
17	8514709	.	G	A	1	2	3	0	1	4	0	0
17	8519109	.	A	G	2	2	4	0	0	4	0	0
17	8562349	.	A	G	2	3	5	0	0	5	0	0
17	8597174	.	T	A	17	7	24	0	2	26	0	0
17	8597702	.	A	T	14	12	26	0	1	27	0	0
17	8597965	.	T	A	26	14	40	1	1	42	0	0
17	8611580	.	G	A	16	16	32	0	0	32	0	0
17	8623396	.	G	A	13	13	26	0	1	27	0	0
17	8623456	.	T	C	16	14	30	0	1	31	0	0
17	8692684	.	A	G	2	2	4	0	0	4	0	0
17	8754343	.	T	C	1	3	4	0	0	4	0	0
17	8754388	.	C	T	2	3	5	0	1	6	0	0
17	8766176	.	G	A	1	2	3	0	0	3	0	0
17	8770161	.	C	G	3	2	5	0	1	6	0	0
17	8772665	.	C	T	6	2	8	0	0	8	0	0
17	8780716	.	G	A	1	2	3	0	0	3	0	0
17	8784682	.	T	C	4	6	10	0	1	11	0	0
17	8784742	.	G	A	0	3	3	0	4	7	0	0
17	8785801	.	T	C	1	2	3	0	0	3	0	0
17	8785804	.	T	C	0	3	3	0	0	3	0	0
17	8789449	.	G	A	3	2	5	0	0	5	0	0
17	8791468	.	A	G	2	6	8	0	1	9	0	0
17	8791573	.	A	T	5	4	9	0	0	9	0	0
17	8791863	.	C	T	2	4	6	0	0	6	0	0
17	8791907	.	A	G	5	0	5	0	5	10	0	0
17	8795736	.	C	T	1	2	3	0	0	3	0	0
17	8795747	.	G	T	1	2	3	0	0	3	0	0
17	8927638	.	A	G	10	11	21	0	1	22	0	0
17	8927641	.	A	G	9	11	20	0	1	21	0	0
17	8934223	.	G	A	19	23	42	0	2	44	0	0
17	8934307	.	C	T	11	17	28	0	0	28	0	0
17	8937918	.	G	A	10	12	22	0	1	23	0	0
17	8937954	.	G	A	14	11	25	0	2	27	0	0
17	8938023	.	C	T	19	10	29	0	1	30	0	0
17	8938249	.	T	C	15	18	33	0	1	34	0	0
17	8938269	.	G	A	21	13	34	0	4	38	0	0
17	8938305	.	T	A	14	25	39	0	1	40	0	0
17	8941309	.	T	C	7	8	15	0	3	18	0	0
17	8941320	.	C	T	7	7	14	0	2	16	0	0
17	8951516	.	C	A	4	6	10	1	0	11	0	0
17	8951606	.	C	G	0	11	11	0	17	28	0	0
17	8951644	.	C	T	2	19	21	0	11	32	0	0
17	8951655	.	T	C	13	18	31	0	3	34	0	0
17	8951867	.	C	T	2	16	18	0	20	38	0	0
17	8964520	.	G	A	8	8	16	0	2	18	0	0
17	8969278	.	A	G	9	13	22	0	2	24	0	0
17	8969296	.	G	A	13	12	25	0	1	26	0	0
17	9041364	.	C	T	1	3	4	0	0	4	0	0
17	9041916	.	C	G	1	0	1	0	2	3	0	0
17	9042447	.	C	T	6	3	9	0	0	9	0	0
17	9042608	.	G	C	4	5	9	0	0	9	0	0
17	9042652	.	T	C	7	4	11	0	1	12	0	0
17	9143323	.	G	A	3	3	6	0	0	6	0	0
17	9225184	.	G	A	0	4	4	0	7	11	0	0
17	9225223	.	A	G	7	7	14	0	0	14	0	0
17	9253504	.	A	T	6	7	13	0	0	13	0	0
17	9253705	.	T	C	7	6	13	0	0	13	0	0
17	9254269	.	T	A	2	3	5	0	1	6	0	0
17	9255196	.	G	A	1	12	13	0	7	20	0	0
17	9255547	.	G	C	12	9	21	0	0	21	0	0
17	9255703	.	C	T	8	13	21	0	2	23	0	0
17	9266298	.	C	T	15	19	34	0	1	35	0	0
17	9266501	.	G	T	0	13	13	0	18	31	0	0
17	9501615	.	G	A	0	2	2	0	2	4	0	0
17	9847212	.	C	T	6	2	8	0	1	9	0	0
17	9847215	.	C	T	3	6	9	0	0	9	0	0
17	9884342	.	A	G	4	2	6	0	0	6	0	0
17	9888958	.	C	G	8	8	16	0	1	17	0	0
17	9889127	.	T	A	9	3	12	1	7	20	0	0
17	9889223	.	C	T	9	12	21	0	1	22	0	0
17	9889313	.	T	A	7	2	9	0	1	10	0	0
17	9889427	.	G	A	9	6	15	0	0	15	0	0
17	9889728	.	A	T	5	6	11	0	2	13	0	0
17	9889745	.	A	G	8	0	8	0	8	16	0	0
17	9944848	.	T	A	8	7	15	0	0	15	0	0
17	9944996	.	G	T	2	2	4	0	0	4	0	0
17	9944999	.	G	A	2	2	4	0	0	4	0	0
17	9951885	.	G	A	6	5	11	0	1	12	0	0
17	9952033	.	C	T	0	7	7	0	7	14	0	0
17	9955952	.	C	T	5	5	10	0	0	10	0	0
17	9957913	.	T	A	6	5	11	0	0	11	0	0
17	9962399	.	C	A	4	3	7	0	0	7	0	0
17	9963519	.	G	A	4	2	6	0	0	6	0	0
17	9963996	.	C	A	8	3	11	0	0	11	0	0
17	9964072	.	A	G	4	2	6	2	0	8	0	0
17	9964091	.	C	A	2	2	4	2	0	6	0	0
17	9964359	.	T	C	1	2	3	0	1	4	0	0
17	9964361	.	A	G	2	0	2	0	2	4	0	0
17	9964437	.	A	T	3	3	6	0	0	6	0	0
17	9964573	.	T	A	0	0	0	0	1	3	2	0
17	9964912	.	G	A	2	5	7	0	0	7	0	0
17	9981995	.	A	G	2	1	3	0	1	4	0	0
17	10143994	.	A	G	4	2	6	0	1	7	0	0
17	10318127	.	A	T	1	2	3	1	0	4	0	0
17	12021802	.	C	T	1	2	3	0	1	4	0	0
17	12021813	.	C	T	0	2	2	0	3	5	0	0
17	12058522	.	G	T	0	7	7	0	9	16	0	0
17	12060478	.	G	A	0	4	4	0	3	7	0	0
17	12060545	.	C	T	4	1	5	0	1	6	0	0
17	12060587	.	A	G	5	6	11	0	0	11	0	0
17	12060627	.	C	T	4	10	14	0	0	14	0	0
17	12060631	.	G	A	0	4	4	0	10	14	0	0
17	12060799	.	A	G	5	6	11	0	0	11	0	0
17	12072890	.	C	T	10	7	17	0	0	17	0	0
17	12072977	.	T	C	11	12	23	0	0	23	0	0
17	12073037	.	C	T	5	6	11	0	0	11	0	0
17	12073324	.	G	A	1	2	3	0	0	3	0	0
17	12088799	.	G	A	0	2	2	0	1	3	0	0
17	12134673	.	T	G	3	5	8	0	0	8	0	0
17	12134693	.	C	A	4	2	6	0	1	7	0	0
17	12134709	.	C	T	5	5	10	0	0	10	0	0
17	12135206	.	G	A	3	3	6	0	0	6	0	0
17	12135322	.	A	T	2	4	6	0	1	7	0	0
17	12135432	.	A	G	1	3	4	0	1	5	0	0
17	12221666	.	T	C	5	3	8	0	0	8	0	0
17	12221788	.	C	A	0	3	3	0	2	5	0	0
17	12221891	.	G	A	4	5	9	0	1	10	0	0
17	12221903	.	C	T	0	4	4	0	5	9	0	0
17	12222005	.	T	G	2	10	12	0	0	12	0	0
17	12222226	.	A	G	10	5	15	0	0	15	0	0
17	12222235	.	G	T	9	7	16	0	0	16	0	0
17	12223514	.	G	A	11	6	17	0	0	17	0	0
17	12223743	.	G	A	12	10	22	0	0	22	0	0
17	12223883	.	C	G	8	5	13	0	0	13	0	0
17	12223884	.	T	A	8	5	13	0	0	13	0	0
17	12223971	.	G	A	6	9	15	0	0	15	0	0
17	12223989	.	C	A	0	11	11	0	5	16	0	0
17	12224581	.	T	C	4	0	4	0	8	12	0	0
17	12224976	.	G	A	17	8	25	0	0	25	0	0
17	12225070	.	G	A	14	5	19	0	1	20	0	0
17	12225271	.	G	A	3	7	10	0	0	10	0	0
17	12225292	.	C	T	1	5	6	0	3	9	0	0
17	12225418	.	T	G	6	4	10	0	2	12	0	0
17	12225756	.	C	A	4	4	8	0	0	8	0	0
17	12226404	.	C	T	2	7	9	0	0	9	0	0
17	12226594	.	G	A	5	4	9	0	1	10	0	0
17	12227340	.	T	A	2	3	5	0	1	6	0	0
17	12227730	.	G	C	2	0	2	0	2	4	0	0
17	12228177	.	G	A	2	2	4	0	1	5	0	0
17	12228304	.	C	T	2	2	4	0	0	4	0	0
17	12236457	.	G	T	5	2	7	0	0	7	0	0
17	12236460	.	G	A	2	5	7	0	0	7	0	0
17	12298106	.	G	T	32	26	58	0	6	64	0	0
17	12302409	.	G	A	28	41	69	0	2	71	0	0
17	12408447	.	C	T	13	6	19	0	1	20	0	0
17	12408454	.	G	C	6	11	17	0	1	18	0	0
17	12418130	.	C	A	11	10	21	0	1	22	0	0
17	12422810	.	A	G	6	0	6	0	9	15	0	0
17	12422850	.	T	A	7	5	12	0	0	12	0	0
17	12658472	.	G	A	3	5	8	0	0	8	0	0
17	12700653	.	A	G	18	30	48	0	2	50	0	0
17	12702780	.	C	T	22	12	34	0	0	34	0	0
17	12702801	.	A	G	18	1	19	0	17	36	0	0
17	12702831	.	C	A	23	23	46	0	0	46	0	0
17	12708393	.	A	G	2	2	4	0	0	4	0	0
17	12708404	.	C	A	3	2	5	0	0	5	0	0
17	12708903	.	T	C	14	20	34	0	2	36	0	0
17	12709244	.	T	G	2	13	15	1	0	16	0	0
17	12741500	.	T	C	4	3	7	0	0	7	0	0
17	12741518	.	C	T	4	3	7	0	1	8	0	0
17	12742971	.	A	G	3	3	6	0	1	7	0	0
17	12742974	.	C	T	4	3	7	0	0	7	0	0
17	12753792	.	G	A	11	10	21	0	1	22	0	0
17	12753823	.	A	G	12	7	19	0	1	20	0	0
17	12753916	.	T	A	6	7	13	0	0	13	0	0
17	12753940	.	A	T	9	10	19	0	0	19	0	0
17	12754071	.	A	G	12	11	23	0	0	23	0	0
17	12754158	.	A	T	6	5	11	0	0	11	0	0
17	12754198	.	A	T	11	5	16	0	0	16	0	0
17	12758823	.	T	C	8	6	14	0	1	15	0	0
17	12759072	.	G	A	8	11	19	0	0	19	0	0
17	12759135	.	C	T	13	5	18	0	0	18	0	0
17	12761221	.	G	C	12	7	19	0	1	20	0	0
17	12762852	.	T	C	12	5	17	0	1	18	0	0
17	12764004	.	C	T	4	10	14	0	16	30	0	0
17	12764090	.	G	T	16	6	22	0	0	22	0	0
17	12797241	.	C	G	2	3	5	0	0	5	0	0
17	12797280	.	C	T	2	4	6	0	0	6	0	0
17	12799132	.	C	T	1	3	4	0	0	4	0	0
17	12806340	.	C	G	2	2	4	0	0	4	0	0
17	12806360	.	C	T	3	3	6	0	0	6	0	0
17	12806381	.	T	C	1	2	3	0	0	3	0	0
17	12809332	.	T	C	1	2	3	0	0	3	0	0
17	12818580	.	T	C	3	6	9	0	0	9	0	0
17	12818664	.	A	G	7	4	11	0	0	11	0	0
17	12818718	.	C	A	5	5	10	0	1	11	0	0
17	12825732	.	C	T	4	3	7	0	0	7	0	0
17	12825741	.	G	A	0	3	3	0	6	9	0	0
17	12851473	.	T	G	8	5	13	0	0	13	0	0
17	12851518	.	G	A	0	5	5	0	8	13	0	0
17	12851831	.	T	G	6	5	11	0	0	11	0	0
17	12858173	.	C	T	4	9	13	0	1	14	0	0
17	12858658	.	G	C	10	11	21	1	0	22	0	0
17	12858765	.	A	G	14	8	22	0	0	22	0	0
17	12865807	.	C	T	6	11	17	0	0	17	0	0
17	12867975	.	G	A	11	6	17	0	0	17	0	0
17	12881532	.	G	A	11	13	24	0	1	25	0	0
17	12881590	.	G	A	2	13	15	0	12	27	0	0
17	12922410	.	A	T	15	13	28	0	1	30	1	0
17	12922678	.	A	G	4	6	10	0	0	10	0	0
17	12923028	.	A	G	22	13	35	0	0	35	0	0
17	12923131	.	A	G	8	1	9	0	16	25	0	0
17	12923303	.	A	G	15	0	15	1	11	27	0	0
17	12923509	.	A	T	8	5	13	0	1	14	0	0
17	12925020	.	G	A	8	5	13	0	0	13	0	0
17	12958744	.	G	A	18	9	27	0	0	27	0	0
17	12963487	.	A	C	11	0	11	0	14	25	0	0
17	12963571	.	G	A	17	16	33	0	0	33	0	0
17	12965499	.	A	G	9	6	15	0	0	15	0	0
17	12972969	.	A	G	2	2	4	0	0	4	0	0
17	12977682	.	T	C	6	0	6	0	5	11	0	0
17	13013109	.	T	C	6	4	10	0	1	11	0	0
17	13019988	.	T	A	11	19	30	0	2	32	0	0
17	13020090	.	G	A	11	8	19	0	1	20	0	0
17	13020187	.	A	C	11	8	19	0	0	19	0	0
17	13020472	.	T	C	8	12	20	0	1	21	0	0
17	13020476	.	T	A	10	12	22	0	0	22	0	0
17	13020601	.	C	T	0	7	7	0	11	18	0	0
17	13020733	.	C	G	8	18	26	1	2	29	0	0
17	13023022	.	G	A	9	13	22	0	1	23	0	0
17	13023289	.	T	C	5	12	17	0	0	17	0	0
17	13023407	.	A	C	12	13	25	0	0	25	0	0
17	13026599	.	A	T	3	10	13	0	0	13	0	0
17	13032557	.	A	G	8	0	8	0	6	14	0	0
17	13032558	.	A	G	9	5	14	0	0	14	0	0
17	13045540	.	G	T	10	5	15	0	0	15	0	0
17	13045559	.	A	C	11	6	17	0	0	17	0	0
17	13045794	.	T	A	7	16	23	0	0	23	0	0
17	13045882	.	A	T	9	11	20	0	1	21	0	0
17	13045980	.	T	C	2	3	5	0	0	5	0	0
17	13046058	.	T	G	9	6	15	0	0	15	0	0
17	13046099	.	G	A	10	10	20	0	1	21	0	0
17	13052081	.	C	T	0	5	5	0	11	16	0	0
17	13057986	.	T	A	5	6	11	0	1	12	0	0
17	13058349	.	T	A	4	10	14	0	1	15	0	0
17	13058354	.	G	A	4	10	14	0	1	15	0	0
17	13061715	.	G	A	8	7	15	0	1	16	0	0
17	13061726	.	G	T	7	8	15	0	0	15	0	0
17	13061839	.	T	C	5	0	5	0	5	10	0	0
17	13061849	.	C	G	7	6	13	0	0	13	0	0
17	13064531	.	C	T	7	5	12	0	3	15	0	0
17	13066963	.	T	A	4	10	14	0	0	14	0	0
17	13067015	.	G	C	4	5	9	0	1	10	0	0
17	13067018	.	C	T	1	6	7	0	4	11	0	0
17	13068561	.	G	A	3	8	11	0	0	11	0	0
17	13070504	.	T	C	3	3	6	0	0	6	0	0
17	13071678	.	T	A	1	5	6	0	1	7	0	0
17	13091660	.	T	G	9	9	18	0	0	18	0	0
17	13094135	.	G	A	5	10	15	0	0	15	0	0
17	13097239	.	C	T	2	2	4	0	0	4	0	0
17	13102057	.	A	G	15	16	31	0	2	33	0	0
17	13107061	.	A	G	10	0	10	0	13	23	0	0
17	13108626	.	G	T	24	15	39	0	0	39	0	0
17	13109010	.	A	G	23	19	42	0	0	42	0	0
17	13109042	.	T	C	21	10	31	6	1	38	0	0
17	13109097	.	A	T	12	13	25	1	3	29	0	0
17	13109409	.	C	T	22	16	38	0	3	41	0	0
17	13109793	.	A	C	11	8	19	0	1	20	0	0
17	13109818	.	T	C	16	8	24	0	0	24	0	0
17	13109910	.	A	G	15	0	15	1	16	32	0	0
17	13109928	.	G	T	1	18	19	1	16	36	0	0
17	13109990	.	T	A	12	21	33	0	2	35	0	0
17	13110003	.	C	G	13	19	32	0	4	36	0	0
17	13110043	.	C	T	14	6	20	0	1	21	0	0
17	15633377	.	T	C	5	22	27	0	1	28	0	0
17	15633379	.	T	C	4	23	27	0	1	28	0	0
17	15633530	.	C	T	6	2	8	0	0	8	0	0
17	15633721	.	T	C	5	11	16	0	0	16	0	0
17	15635459	.	A	T	1	2	3	0	0	3	0	0
17	16026690	.	A	T	1	7	8	0	0	8	0	0
17	18179927	.	T	C	10	6	16	1	4	21	0	0
17	19420197	.	C	T	10	15	25	0	0	25	0	0
17	19420434	.	C	T	2	6	8	0	8	16	0	0
17	19420563	.	T	G	16	9	25	0	2	27	0	0
17	19421109	.	C	G	8	5	13	1	1	15	0	0
17	19421248	.	T	G	15	6	21	0	0	21	0	0
17	19421636	.	T	C	11	0	11	0	13	24	0	0
17	19421667	.	A	G	10	12	22	0	0	22	0	0
17	19421948	.	C	T	5	12	17	0	1	18	0	0
17	19421955	.	A	T	5	13	18	0	0	18	0	0
17	19422452	.	C	T	0	3	3	0	4	7	0	0
17	19423145	.	C	T	4	4	8	0	0	8	0	0
17	19423334	.	C	T	4	4	8	0	0	8	0	0
17	19423375	.	A	T	5	3	8	0	1	9	0	0
17	19423586	.	A	T	3	4	7	0	0	7	0	0
17	19429290	.	T	C	10	0	10	0	8	18	0	0
17	19431175	.	C	A	2	8	10	0	7	17	0	0
17	19431481	.	G	A	5	3	8	0	0	8	0	0
17	19431718	.	G	A	2	10	12	0	0	12	0	0
17	19440149	.	T	G	2	2	4	0	0	4	0	0
17	19440233	.	C	T	0	2	2	0	3	5	0	0
17	19440460	.	T	C	5	0	5	0	9	14	0	0
17	19440492	.	G	A	7	7	14	0	1	15	0	0
17	19440500	.	T	G	9	7	16	0	0	16	0	0
17	19443394	.	A	G	1	6	7	0	1	8	0	0
17	19448792	.	C	T	4	2	6	0	0	6	0	0
17	19451844	.	G	A	3	2	5	0	0	5	0	0
17	19451892	.	C	A	0	2	2	0	1	3	0	0
17	19454491	.	A	G	4	2	6	0	0	6	0	0
17	19455358	.	G	C	1	4	5	0	0	5	0	0
17	19455386	.	C	G	1	4	5	0	0	5	0	0
17	19460274	.	T	G	1	1	2	0	1	3	0	0
17	19502407	.	T	C	4	5	9	0	0	9	0	0
17	19506474	.	C	T	3	5	8	0	0	8	0	0
17	19506575	.	A	C	2	1	3	0	1	4	0	0
17	19506934	.	G	A	1	4	5	0	3	8	0	0
17	19506943	.	A	C	3	6	9	0	0	9	0	0
17	19510714	.	G	A	9	3	12	0	1	13	0	0
17	19607654	.	A	T	2	7	9	0	0	9	0	0
17	19607835	.	T	A	3	6	9	0	0	9	0	0
17	19607950	.	C	G	2	3	5	0	1	6	0	0
17	19608741	.	A	G	4	4	8	0	0	8	0	0
17	19608758	.	C	T	3	4	7	0	0	7	0	0
17	19609013	.	C	T	0	4	4	0	3	7	0	0
17	19609092	.	C	T	2	7	9	0	0	9	0	0
17	19609276	.	C	T	2	2	4	0	0	4	0	0
17	19609286	.	T	A	2	2	4	0	0	4	0	0
17	19692573	.	A	C	6	5	11	0	1	12	0	0
17	19715899	.	T	C	14	14	28	0	1	29	0	0
17	19754456	.	G	A	1	2	3	0	0	3	0	0
17	19755032	.	C	T	1	2	3	0	1	4	0	0
17	19755102	.	C	T	4	1	5	0	1	6	0	0
17	19755158	.	C	G	0	5	5	0	3	8	0	0
17	19756126	.	A	G	1	3	4	0	0	4	0	0
17	19756186	.	C	A	0	4	4	0	2	6	0	0
17	19756277	.	A	G	2	3	5	0	0	5	0	0
17	19756332	.	C	G	1	3	4	0	0	4	0	0
17	19757450	.	G	T	1	2	3	0	0	3	0	0
17	19757456	.	C	T	1	3	4	0	0	4	0	0
17	19831968	.	T	C	2	2	4	0	0	4	0	0
17	19831980	.	A	T	2	2	4	0	0	4	0	0
17	19833029	.	G	A	4	2	6	0	0	6	0	0
17	19833222	.	A	G	2	3	5	0	1	6	0	0
17	20122156	.	T	G	1	2	3	0	0	3	0	0
17	20122174	.	G	A	1	3	4	0	0	4	0	0
17	20147693	.	A	G	1	4	5	0	0	5	0	0
17	20147732	.	C	A	0	6	6	0	1	7	0	0
17	20147756	.	A	C	3	4	7	0	0	7	0	0
17	20147771	.	A	G	4	5	9	0	0	9	0	0
17	20147804	.	C	A	4	3	7	0	1	8	0	0
17	20148867	.	G	A	2	3	5	0	0	5	0	0
17	20149668	.	G	A	5	4	9	0	0	9	0	0
17	20151769	.	G	T	2	2	4	0	0	4	0	0
17	20185614	.	A	G	1	2	3	0	0	3	0	0
17	20188929	.	C	T	0	8	8	0	4	12	0	0
17	20189047	.	A	T	6	13	19	0	1	20	0	0
17	20191569	.	T	C	4	0	4	0	8	12	0	0
17	20191941	.	A	G	8	3	11	0	0	11	0	0
17	20191956	.	A	G	3	7	10	0	0	10	0	0
17	20196809	.	A	G	2	1	3	0	1	4	0	0
17	20198764	.	G	T	4	3	7	0	0	7	0	0
17	20200047	.	C	T	2	2	4	0	0	4	0	0
17	20202365	.	C	G	0	4	4	0	1	5	0	0
17	20202391	.	G	A	4	3	7	0	0	7	0	0
17	20202650	.	T	G	3	3	6	0	0	6	0	0
17	20214757	.	T	C	5	4	9	0	1	10	0	0
17	20214766	.	T	C	4	0	4	0	6	10	0	0
17	20215498	.	G	A	5	3	8	0	1	9	0	0
17	20215570	.	A	C	4	0	4	0	3	7	0	0
17	20215739	.	T	C	2	2	4	0	0	4	0	0
17	20218318	.	T	C	1	0	1	0	2	3	0	0
17	20222925	.	T	G	2	2	4	0	0	4	0	0
17	20232526	.	G	T	2	4	6	0	0	6	0	0
17	20243035	.	A	G	17	1	18	0	16	34	0	0
17	20243375	.	C	A	32	17	49	0	3	52	0	0
17	20243564	.	G	A	17	12	29	0	1	30	0	0
17	20243611	.	G	A	14	16	30	0	0	30	0	0
17	20248398	.	A	G	23	24	47	0	0	47	0	0
17	20248455	.	A	T	19	14	33	0	2	35	0	0
17	20248479	.	T	C	24	11	35	0	2	37	0	0
17	20248500	.	C	G	3	13	16	0	16	32	0	0
17	20248705	.	T	C	19	2	21	0	13	34	0	0
17	20251902	.	C	T	18	5	23	0	0	23	0	0
17	20251987	.	T	C	12	15	27	0	1	28	0	0
17	20256603	.	A	C	10	5	15	0	0	15	0	0
17	20256669	.	A	G	11	14	25	0	0	25	0	0
17	20256894	.	T	C	2	9	11	0	0	11	0	0
17	20256921	.	A	G	5	4	9	0	0	9	0	0
17	20256948	.	G	C	6	0	6	0	8	14	0	0
17	20259679	.	A	C	3	6	9	0	0	9	0	0
17	20264097	.	C	T	7	5	12	0	0	12	0	0
17	20268379	.	G	A	8	5	13	0	0	13	0	0
17	20268442	.	C	T	8	8	16	0	0	16	0	0
17	20287338	.	C	T	4	6	10	0	0	10	0	0
17	20321569	.	G	A	2	3	5	0	0	5	0	0
17	20321614	.	C	T	0	4	4	0	4	8	0	0
17	20324012	.	T	C	8	3	11	0	2	13	0	0
17	20324036	.	C	T	1	3	4	0	9	13	0	0
17	20324051	.	A	G	8	4	12	0	1	13	0	0
17	20324084	.	T	C	9	0	9	0	7	16	0	0
17	20324114	.	C	T	2	9	11	0	10	21	0	0
17	20324144	.	G	A	13	8	21	0	0	21	0	0
17	20336983	.	G	A	1	3	4	0	0	4	0	0
17	20372168	.	G	A	3	3	6	0	0	6	0	0
17	20372205	.	C	A	2	2	4	0	0	4	0	0
17	20380992	.	G	A	4	2	6	0	0	6	0	0
17	20429758	.	G	A	2	2	4	0	0	4	0	0
17	20517926	.	A	G	2	2	4	0	0	4	0	0
17	20517968	.	G	A	2	2	4	0	0	4	0	0
17	20517973	.	G	A	0	2	2	0	1	3	0	0
17	20518147	.	G	A	1	3	4	0	0	4	0	0
17	20582140	.	T	C	2	2	4	0	0	4	0	0
17	20585284	.	C	T	1	2	3	0	0	3	0	0
17	20585362	.	T	C	1	17	18	0	1	19	0	0
17	20587321	.	A	C	4	2	6	0	0	6	0	0
17	20587947	.	T	A	3	4	7	0	0	7	0	0
17	20674063	.	C	T	4	6	10	0	0	10	0	0
17	20674489	.	T	C	16	1	17	0	15	32	0	0
17	20674794	.	C	T	7	10	17	0	1	18	0	0
17	20674889	.	T	A	11	15	26	0	1	27	0	0
17	20684685	.	A	T	19	15	34	0	3	38	1	0
17	20695604	.	G	A	14	5	19	0	0	19	0	0
17	20695941	.	C	A	0	6	6	0	8	14	0	0
17	20701602	.	A	G	21	23	44	0	2	46	0	0
17	20701999	.	G	A	19	25	44	0	2	46	0	0
17	20702030	.	C	T	1	19	20	0	16	36	0	0
17	20702056	.	G	A	21	17	38	0	0	38	0	0
17	20719067	.	G	C	11	14	25	0	0	25	0	0
17	20719232	.	A	G	14	10	24	0	0	24	0	0
17	20719248	.	C	T	6	9	15	0	2	17	0	0
17	20719746	.	G	T	10	4	14	0	1	15	0	0
17	20720046	.	C	T	4	16	20	0	13	33	0	0
17	20720121	.	G	T	10	12	22	0	3	25	0	0
17	20720334	.	C	T	15	14	29	0	1	30	0	0
17	20720581	.	G	A	16	10	26	0	1	27	0	0
17	20720739	.	G	T	14	9	23	0	3	26	0	0
17	20721597	.	A	G	8	6	14	0	1	15	0	0
17	20722113	.	C	A	8	7	15	0	1	16	0	0
17	20722389	.	A	G	3	4	7	0	1	8	0	0
17	20722955	.	A	G	8	8	16	0	0	16	0	0
17	20723081	.	A	T	4	10	14	0	0	14	0	0
17	20723407	.	A	G	7	10	17	0	1	18	0	0
17	20724187	.	A	T	7	3	10	0	1	11	0	0
17	20724318	.	C	T	6	5	11	0	0	11	0	0
17	20724675	.	A	G	9	6	15	0	1	16	0	0
17	20725107	.	G	A	6	7	13	0	0	13	0	0
17	20725296	.	T	C	9	8	17	0	1	18	0	0
17	20725474	.	A	C	11	6	17	0	0	17	0	0
17	20725554	.	G	A	6	6	12	0	1	13	0	0
17	20729433	.	C	T	6	3	9	0	0	9	0	0
17	20731097	.	C	T	6	3	9	0	0	9	0	0
17	20734207	.	G	A	2	3	5	0	1	6	0	0
17	20763022	.	C	T	0	8	8	0	5	13	0	0
17	20772115	.	C	T	1	2	3	0	1	4	0	0
17	20772383	.	A	G	2	2	4	0	0	4	0	0
17	20782062	.	G	A	1	2	3	0	0	3	0	0
17	20784676	.	G	A	3	2	5	0	0	5	0	0
17	20784718	.	G	A	1	3	4	0	0	4	0	0
17	20795953	.	G	A	3	3	6	0	0	6	0	0
17	20796115	.	C	T	0	2	2	0	5	7	0	0
17	20806988	.	C	T	4	3	7	0	0	7	0	0
17	20849868	.	C	T	0	2	2	1	3	6	0	0
17	20926037	.	A	C	1	2	3	0	0	3	0	0
17	20926046	.	T	C	1	2	3	0	0	3	0	0
17	20926793	.	G	A	2	2	4	0	0	4	0	0
17	20928860	.	G	A	4	2	6	0	0	6	0	0
17	20963653	.	T	C	12	19	31	0	0	31	0	0
17	20963664	.	T	C	12	18	30	0	1	31	0	0
17	20964611	.	G	A	7	12	19	0	0	19	0	0
17	20964669	.	A	G	10	8	18	0	0	18	0	0
17	20964978	.	A	G	11	9	20	0	1	21	0	0
17	20965143	.	G	A	13	12	25	0	1	26	0	0
17	20965182	.	C	T	2	15	17	0	22	39	0	0
17	20965194	.	G	T	21	16	37	0	3	40	0	0
17	20965295	.	T	G	18	18	36	1	1	38	0	0
17	20978673	.	A	G	16	12	28	0	2	30	0	0
17	20978823	.	G	A	3	7	10	1	0	11	0	0
17	20978972	.	G	A	7	6	13	0	1	14	0	0
17	20979056	.	A	T	5	3	8	0	0	8	0	0
17	21102352	.	T	A	7	2	9	0	1	10	0	0
17	21102367	.	G	A	5	6	11	1	1	13	0	0
17	21104883	.	A	G	5	5	10	0	0	10	0	0
17	21107316	.	T	C	3	3	6	0	0	6	0	0
17	21120781	.	G	A	11	5	16	0	5	21	0	0
17	21123435	.	G	A	3	5	8	0	1	9	0	0
17	21123461	.	A	T	4	4	8	0	2	10	0	0
17	21123537	.	T	C	4	2	6	0	0	6	0	0
17	21141630	.	G	A	7	3	10	0	0	10	0	0
17	21147021	.	C	T	1	4	5	0	0	5	0	0
17	21151945	.	C	A	5	6	11	0	0	11	0	0
17	21151996	.	C	T	1	4	5	0	0	5	0	0
17	21152094	.	A	G	3	3	6	0	0	6	0	0
17	21152106	.	G	A	3	4	7	0	0	7	0	0
17	21152145	.	A	C	3	5	8	0	0	8	0	0
17	21154691	.	A	G	3	3	6	0	1	7	0	0
17	21154957	.	C	A	11	6	17	0	0	17	0	0
17	21155425	.	C	A	12	9	21	0	2	23	0	0
17	21155625	.	T	G	1	3	4	0	0	4	0	0
17	21155636	.	T	A	1	2	3	0	0	3	0	0
17	21155817	.	T	C	13	9	22	0	1	23	0	0
17	21156091	.	A	G	3	3	6	0	1	7	0	0
17	21156140	.	G	T	6	1	7	0	5	12	0	0
17	21156162	.	A	G	11	5	16	0	1	17	0	0
17	21156207	.	A	C	17	7	24	0	1	25	0	0
17	21156220	.	C	T	17	9	26	0	0	26	0	0
17	21156265	.	T	A	11	7	18	0	1	19	0	0
17	21156299	.	T	C	5	0	5	0	5	10	0	0
17	21156342	.	C	T	2	2	4	0	0	4	0	0
17	21156497	.	T	C	1	3	4	0	0	4	0	0
17	21156501	.	G	T	1	3	4	0	0	4	0	0
17	21156720	.	A	C	9	4	13	0	0	13	0	0
17	21156808	.	A	T	7	4	11	0	0	11	0	0
17	21158227	.	G	T	0	7	7	0	0	7	0	0
17	21158231	.	T	A	2	6	8	0	0	8	0	0
17	21158291	.	A	T	4	7	11	0	0	11	0	0
17	21158438	.	C	A	2	2	4	0	0	4	0	0
17	21158439	.	C	A	2	2	4	0	0	4	0	0
17	21158629	.	C	G	4	5	9	0	0	9	0	0
17	21160083	.	G	A	6	6	12	0	0	12	0	0
17	21160107	.	G	A	5	5	10	0	0	10	0	0
17	21162573	.	T	C	2	6	8	0	0	8	0	0
17	21245326	.	A	G	7	5	12	0	0	12	0	0
17	21245410	.	T	C	7	1	8	0	5	13	0	0
17	21372616	.	C	T	2	12	14	0	20	34	0	0
17	21372810	.	G	T	29	31	60	0	1	61	0	0
17	21373062	.	G	A	17	25	42	0	0	42	0	0
17	21373105	.	C	G	0	20	20	0	19	39	0	0
17	21377133	.	G	A	19	19	38	0	4	42	0	0
17	21396399	.	A	G	9	16	25	0	0	25	0	0
17	21396444	.	A	G	8	8	16	0	1	17	0	0
17	21396462	.	A	G	9	8	17	0	1	18	0	0
17	21433074	.	G	A	5	8	13	0	0	13	0	0
17	21433396	.	C	T	1	3	4	0	6	10	0	0
17	21433680	.	C	A	6	9	15	0	0	15	0	0
17	21433750	.	C	T	0	6	6	0	6	12	0	0
17	21434317	.	C	T	0	2	2	0	4	6	0	0
17	21547779	.	A	G	1	5	6	0	0	6	0	0
17	21550216	.	T	C	3	4	7	0	0	7	0	0
17	21560706	.	A	T	5	3	8	0	0	8	0	0
17	21560738	.	A	G	3	6	9	0	0	9	0	0
17	21560763	.	T	C	3	5	8	0	0	8	0	0
17	21562542	.	T	G	3	2	5	0	0	5	0	0
17	21562568	.	A	T	2	3	5	0	0	5	0	0
17	21562932	.	A	G	2	3	5	0	0	5	0	0
17	21607781	.	C	T	3	3	6	0	0	6	0	0
17	21791668	.	T	C	10	0	10	0	9	19	0	0
17	21817552	.	G	C	3	2	5	0	0	5	0	0
17	21817682	.	G	C	4	3	7	0	0	7	0	0
17	21817686	.	T	G	3	3	6	0	0	6	0	0
17	21820366	.	C	T	7	7	14	0	1	15	0	0
17	21820378	.	C	T	6	6	12	0	0	12	0	0
17	21820583	.	G	A	7	3	10	0	0	10	0	0
17	21820657	.	C	A	7	3	10	0	3	13	0	0
17	21820744	.	A	T	8	4	12	0	1	13	0	0
17	21820772	.	A	G	9	5	14	0	1	15	0	0
17	21820879	.	C	T	9	15	24	0	0	24	0	0
17	21821381	.	A	G	10	4	14	0	2	16	0	0
17	21821405	.	T	C	5	14	19	0	0	19	0	0
17	21821627	.	C	T	3	4	7	0	1	8	0	0
17	21821653	.	T	C	2	3	5	0	0	5	0	0
17	21821856	.	C	T	11	8	19	0	2	21	0	0
17	21821958	.	C	T	6	2	8	0	0	8	0	0
17	21904009	.	G	A	0	11	11	0	17	28	0	0
17	21905752	.	A	C	11	7	18	5	1	24	0	0
17	21911999	.	T	C	22	15	37	0	0	37	0	0
17	21912381	.	T	C	8	11	19	0	1	20	0	0
17	21912489	.	T	C	11	14	25	0	0	25	0	0
17	21912517	.	T	C	14	4	18	0	1	19	0	0
17	21912597	.	C	A	12	4	16	0	1	17	0	0
17	21912622	.	C	A	11	4	15	0	1	16	0	0
17	21912676	.	A	T	8	7	15	0	1	16	0	0
17	21912708	.	T	A	15	12	27	0	0	27	0	0
17	21912797	.	T	C	11	11	22	0	1	23	0	0
17	21912874	.	A	G	16	17	33	0	0	33	0	0
17	21912890	.	G	T	15	18	33	0	0	33	0	0
17	21935871	.	T	C	2	2	4	0	0	4	0	0
17	21952787	.	G	A	0	5	5	0	2	7	0	0
17	21954957	.	C	T	8	3	11	0	1	12	0	0
17	21955115	.	T	C	5	9	14	0	0	14	0	0
17	21958945	.	A	G	6	0	6	0	7	13	0	0
17	21959239	.	A	T	3	6	9	0	1	10	0	0
17	21959338	.	C	T	2	2	4	0	2	6	0	0
17	21959342	.	A	T	2	4	6	0	0	6	0	0
17	21975525	.	G	A	1	8	9	0	14	23	0	0
17	21975528	.	C	G	14	6	20	0	0	20	0	0
17	22003324	.	A	T	1	3	4	0	0	4	0	0
17	22003417	.	C	T	0	3	3	0	1	4	0	0
17	22032345	.	T	A	10	4	14	0	0	14	0	0
17	22033020	.	G	A	7	4	11	0	0	11	0	0
17	22033142	.	T	C	5	0	5	0	4	9	0	0
17	22035770	.	T	C	9	0	9	0	9	18	0	0
17	22035945	.	C	T	1	8	9	0	11	20	0	0
17	22036427	.	C	T	7	4	11	0	2	13	0	0
17	22036460	.	C	A	6	6	12	0	1	13	0	0
17	22036602	.	A	C	11	0	11	0	6	17	0	0
17	22036659	.	G	T	5	4	9	0	0	9	0	0
17	22036686	.	A	G	6	4	10	0	0	10	0	0
17	22036896	.	G	A	3	3	6	0	0	6	0	0
17	22037014	.	G	A	4	2	6	0	0	6	0	0
17	22044272	.	T	C	5	1	6	0	8	14	0	0
17	22047883	.	C	T	0	7	7	0	10	17	0	0
17	22051176	.	A	G	7	6	13	0	2	15	0	0
17	22052074	.	G	A	7	3	10	0	0	10	0	0
17	22058188	.	C	T	9	8	17	0	1	18	0	0
17	22062275	.	C	T	8	8	16	0	0	16	0	0
17	22072375	.	G	A	2	2	4	0	0	4	0	0
17	22072435	.	T	G	1	4	5	0	0	5	0	0
17	22074970	.	A	G	2	2	4	0	0	4	0	0
17	22074998	.	C	A	3	2	5	0	0	5	0	0
17	22085070	.	C	T	2	3	5	0	0	5	0	0
17	22088716	.	T	G	1	3	4	0	0	4	0	0
17	22090897	.	T	G	5	0	5	0	7	12	0	0
17	22091044	.	T	G	3	5	8	0	0	8	0	0
17	22091067	.	G	A	5	3	8	0	2	10	0	0
17	22091118	.	T	A	6	4	10	0	0	10	0	0
17	22091120	.	A	T	5	5	10	0	0	10	0	0
17	22108065	.	G	A	12	6	18	0	2	20	0	0
17	22108207	.	A	T	7	6	13	0	0	13	0	0
17	22111379	.	T	G	8	6	14	0	0	14	0	0
17	22111386	.	T	C	8	0	8	0	5	13	0	0
17	22111610	.	G	A	8	6	14	0	1	15	0	0
17	22113050	.	T	C	5	6	11	0	0	11	0	0
17	22381310	.	T	G	2	2	4	0	0	4	0	0
17	22382652	.	G	A	0	3	3	0	2	5	0	0
17	22382726	.	C	T	1	3	4	0	0	4	0	0
17	22382870	.	T	C	6	2	8	0	0	8	0	0
17	22382885	.	A	G	6	0	6	0	5	11	0	0
17	22471649	.	G	A	0	5	5	0	10	15	0	0
17	22489033	.	A	C	6	3	9	0	0	9	0	0
17	22500507	.	C	A	14	8	22	0	4	26	0	0
17	22500600	.	G	A	8	13	21	0	0	21	0	0
17	22500627	.	C	T	10	9	19	0	1	20	0	0
17	22500898	.	T	G	7	0	7	0	6	13	0	0
17	22500937	.	G	A	0	7	7	0	7	14	0	0
17	22500972	.	A	C	12	10	22	0	0	22	0	0
17	22501063	.	G	A	0	11	11	0	9	20	0	0
17	22501309	.	G	A	6	8	14	0	1	15	0	0
17	22501353	.	G	A	5	14	19	0	1	20	0	0
17	22501447	.	T	A	8	9	17	0	2	19	0	0
17	22501490	.	T	C	7	13	20	0	0	20	0	0
17	22501493	.	C	A	6	12	18	0	1	19	0	0
17	22501547	.	C	A	4	21	25	0	0	25	0	0
17	22501645	.	G	T	9	6	15	0	0	15	0	0
17	22501858	.	C	T	6	2	8	0	0	8	0	0
17	22524581	.	T	C	5	10	15	1	0	16	0	0
17	22582313	.	C	T	13	16	29	0	1	30	0	0
17	22584847	.	G	A	26	14	40	0	1	41	0	0
17	22585264	.	T	A	30	10	40	0	2	42	0	0
17	22585273	.	C	T	12	30	42	0	0	42	0	0
17	22585337	.	T	A	22	14	36	0	0	36	0	0
17	22619289	.	C	T	3	2	5	0	0	5	0	0
17	22630058	.	A	G	2	2	4	0	0	4	0	0
17	22632033	.	T	C	1	4	5	0	0	5	0	0
17	22646861	.	T	C	1	3	4	0	0	4	0	0
17	22647001	.	C	T	4	4	8	0	0	8	0	0
17	22648087	.	T	C	1	4	5	0	0	5	0	0
17	22649721	.	G	A	1	5	6	0	4	10	0	0
17	22649838	.	C	T	4	3	7	0	0	7	0	0
17	22650586	.	C	T	4	9	13	0	0	13	0	0
17	22650641	.	C	A	2	5	7	0	1	8	0	0
17	22650760	.	C	T	7	3	10	0	0	10	0	0
17	22650979	.	C	T	3	3	6	0	0	6	0	0
17	22651351	.	C	T	4	6	10	0	0	10	0	0
17	22651375	.	T	C	8	6	14	0	1	15	0	0
17	22652799	.	T	A	5	8	13	0	1	14	0	0
17	22652825	.	G	T	7	8	15	0	1	16	0	0
17	22653491	.	C	T	8	5	13	0	0	13	0	0
17	22653710	.	C	T	6	11	17	0	0	17	0	0
17	22654096	.	C	T	9	6	15	0	0	15	0	0
17	22659176	.	G	T	1	8	9	0	7	16	0	0
17	22659206	.	G	A	5	10	15	0	0	15	0	0
17	22659957	.	A	G	7	0	7	0	6	13	0	0
17	22662759	.	T	C	9	6	15	0	0	15	0	0
17	22669012	.	G	A	2	9	11	0	12	23	0	0
17	22669060	.	C	T	18	13	31	0	0	31	0	0
17	22669511	.	A	C	5	10	15	0	0	15	0	0
17	22687408	.	C	A	11	11	22	0	1	23	0	0
17	22687409	.	C	G	12	11	23	0	0	23	0	0
17	22687451	.	T	C	12	10	22	0	0	22	0	0
17	22687500	.	T	G	16	10	26	0	0	26	0	0
17	22687558	.	T	A	20	11	31	0	2	33	0	0
17	22687561	.	G	A	20	13	33	0	2	35	0	0
17	22687729	.	T	C	15	23	38	0	2	40	0	0
17	22687842	.	T	A	19	20	39	0	1	40	0	0
17	22713696	.	C	T	14	17	31	0	2	33	0	0
17	22723479	.	T	C	11	12	23	0	1	24	0	0
17	22723515	.	C	T	16	6	22	0	1	23	0	0
17	22729079	.	T	C	13	12	25	0	0	25	0	0
17	22729772	.	T	A	12	10	22	0	0	22	0	0
17	22729796	.	G	A	2	9	11	0	17	28	0	0
17	22729886	.	C	T	14	6	20	1	1	22	0	0
17	22738350	.	G	A	14	12	26	0	1	27	0	0
17	22741070	.	G	A	1	6	7	0	13	20	0	0
17	22741096	.	A	T	9	7	16	0	0	16	0	0
17	22741437	.	A	T	17	9	26	0	0	26	0	0
17	22760817	.	T	A	5	3	8	0	0	8	0	0
17	22782653	.	G	A	0	3	3	0	4	7	0	0
17	22804934	.	A	T	4	3	7	0	0	7	0	0
17	22916905	.	C	T	6	6	12	0	0	12	0	0
17	22918230	.	G	A	2	2	4	0	1	5	0	0
17	22918258	.	A	G	6	3	9	0	0	9	0	0
17	22937684	.	A	T	6	10	16	0	0	16	0	0
17	22937719	.	A	T	3	9	12	0	0	12	0	0
17	22944875	.	A	G	9	6	15	0	0	15	0	0
17	22944887	.	A	G	10	6	16	0	0	16	0	0
17	23185251	.	G	A	0	4	4	0	1	5	0	0
17	23185253	.	G	A	0	4	4	0	1	5	0	0
17	23212811	.	G	A	5	4	9	0	2	11	0	0
17	23213219	.	G	A	2	3	5	0	0	5	0	0
17	23215411	.	T	C	4	6	10	0	1	11	0	0
17	23215612	.	G	A	4	4	8	0	1	9	0	0
17	23216461	.	C	T	1	3	4	0	0	4	0	0
17	23220627	.	A	G	6	5	11	0	1	12	0	0
17	23220698	.	T	A	5	7	12	0	1	13	0	0
17	23222460	.	C	G	5	9	14	0	0	14	0	0
17	23223166	.	C	G	12	8	20	0	1	21	0	0
17	23224626	.	C	T	10	9	19	0	2	21	0	0
17	23224680	.	G	A	9	9	18	0	5	23	0	0
17	23224743	.	A	G	11	1	12	0	15	27	0	0
17	23224800	.	G	A	7	12	19	0	0	19	0	0
17	23226667	.	C	T	8	11	19	0	1	20	0	0
17	23231130	.	C	T	25	12	37	0	2	39	0	0
17	23300837	.	C	G	2	2	4	0	0	4	0	0
17	23300879	.	G	A	2	4	6	0	0	6	0	0
17	23300888	.	T	C	2	5	7	0	0	7	0	0
17	23301102	.	C	T	3	5	8	0	3	11	0	0
17	23301303	.	G	A	12	10	22	0	1	23	0	0
17	23301372	.	C	T	8	13	21	0	0	21	0	0
17	23301390	.	G	A	1	7	8	0	9	17	0	0
17	23301433	.	G	T	11	10	21	0	0	21	0	0
17	23301484	.	G	A	13	6	19	0	0	19	0	0
17	23312303	.	T	C	1	2	3	0	0	3	0	0
17	23434216	.	G	A	9	8	17	0	0	17	0	0
17	23434264	.	A	G	10	10	20	0	0	20	0	0
17	23434389	.	T	C	4	0	4	0	7	11	0	0
17	23437102	.	A	G	3	6	9	0	0	9	0	0
17	23437629	.	C	A	6	3	9	0	0	9	0	0
17	23437641	.	A	G	5	2	7	0	3	10	0	0
17	23437677	.	C	G	2	5	7	0	0	7	0	0
17	23441680	.	C	T	6	6	12	0	0	12	0	0
17	23441698	.	A	G	5	8	13	0	0	13	0	0
17	23444362	.	G	C	3	5	8	0	0	8	0	0
17	23444415	.	A	G	5	6	11	0	1	12	0	0
17	23446653	.	T	G	1	3	4	0	6	10	0	0
17	23542264	.	T	A	5	4	9	0	0	9	0	0
17	23542322	.	C	A	2	5	7	0	1	8	0	0
17	23542677	.	G	A	1	3	4	0	0	4	0	0
17	23542770	.	A	G	2	2	4	0	0	4	0	0
17	23543088	.	C	T	2	3	5	0	0	5	0	0
17	23549232	.	A	G	1	0	1	0	6	7	0	0
17	23549293	.	A	G	3	0	3	0	3	6	0	0
17	23549710	.	G	T	2	6	8	0	1	9	0	0
17	23551512	.	T	C	4	2	6	0	1	7	0	0
17	23551536	.	C	T	3	5	8	0	0	8	0	0
17	23551928	.	G	A	0	2	2	0	1	3	0	0
17	23554980	.	T	C	2	3	5	0	1	6	0	0
17	23555032	.	T	C	1	3	4	0	0	4	0	0
17	23555278	.	A	T	5	2	7	0	1	8	0	0
17	23555403	.	A	T	7	5	12	0	0	12	0	0
17	23574682	.	G	A	2	4	6	0	1	7	0	0
17	23656034	.	A	C	27	2	29	0	28	57	0	0
17	23656112	.	C	T	2	16	18	0	21	39	0	0
17	23659853	.	C	T	24	21	45	0	0	45	0	0
17	23711184	.	A	T	7	6	13	0	0	13	0	0
17	23711421	.	A	C	10	11	21	0	0	21	0	0
17	23711775	.	C	T	0	7	7	0	14	21	0	0
17	23722882	.	A	T	5	8	13	0	0	13	0	0
17	23727637	.	G	T	5	5	10	0	0	10	0	0
17	23757541	.	G	A	0	2	2	0	4	6	0	0
17	23762847	.	G	A	0	2	2	0	3	5	0	0
17	23762900	.	T	A	3	3	6	0	0	6	0	0
17	23764591	.	T	C	3	2	5	0	0	5	0	0
17	23820614	.	A	G	6	6	12	0	0	12	0	0
17	23821410	.	C	T	8	8	16	0	0	16	0	0
17	23822235	.	G	T	2	2	4	0	1	5	0	0
17	23822749	.	C	T	4	6	10	0	0	10	0	0
17	23823650	.	G	A	2	4	6	0	1	7	0	0
17	23824504	.	A	G	3	4	7	0	0	7	0	0
17	23894598	.	G	A	2	2	4	0	0	4	0	0
17	23929692	.	A	G	4	0	4	0	3	7	0	0
17	23937626	.	T	G	9	15	24	0	0	24	0	0
17	23940102	.	C	A	5	23	28	0	2	30	0	0
17	23948365	.	A	G	25	8	33	0	0	33	0	0
17	23948396	.	C	T	26	10	36	0	1	37	0	0
17	23952672	.	G	C	9	26	35	0	1	36	0	0
17	23954987	.	C	G	2	4	6	0	0	6	0	0
17	23956882	.	G	A	8	18	26	0	3	29	0	0
17	23956925	.	G	A	0	15	15	0	7	22	0	0
17	23964690	.	T	A	3	6	9	0	0	9	0	0
17	23964719	.	A	G	3	6	9	0	1	10	0	0
17	23964732	.	T	C	3	7	10	0	0	10	0	0
17	23965241	.	G	T	3	7	10	0	0	10	0	0
17	23965283	.	T	A	8	7	15	0	1	16	0	0
17	23965475	.	G	C	7	7	14	0	0	14	0	0
17	23965694	.	A	C	4	6	10	0	0	10	0	0
17	23965983	.	C	A	6	4	10	0	0	10	0	0
17	23986153	.	A	G	8	0	8	0	11	19	0	0
17	23986585	.	T	C	10	18	28	0	2	30	0	0
17	24111400	.	G	A	0	3	3	0	5	8	0	0
17	24177150	.	T	C	2	3	5	0	0	5	0	0
17	24178449	.	G	C	3	9	12	0	0	12	0	0
17	24182184	.	T	A	5	3	8	0	1	9	0	0
17	24186029	.	C	T	7	4	11	0	0	11	0	0
17	24186042	.	T	C	6	5	11	0	0	11	0	0
17	24186129	.	C	T	4	6	10	0	0	10	0	0
17	24222649	.	G	A	13	7	20	0	1	21	0	0
17	24222730	.	T	A	14	13	27	0	0	27	0	0
17	24222752	.	A	T	14	10	24	0	0	24	0	0
17	24222771	.	G	T	17	7	24	0	0	24	0	0
17	24247670	.	G	T	8	6	14	0	0	14	0	0
17	24254467	.	G	A	0	5	5	0	10	15	0	0
17	24268278	.	G	A	8	11	19	0	1	20	0	0
17	24313778	.	C	T	6	3	9	0	1	10	0	0
17	24314331	.	A	G	7	10	17	1	0	18	0	0
17	24314468	.	A	T	9	3	12	0	0	12	0	0
17	24314986	.	G	A	2	7	9	0	13	22	0	0
17	24319071	.	A	C	7	4	11	0	0	11	0	0
17	24339217	.	G	T	4	3	7	0	0	7	0	0
17	24364368	.	G	A	1	3	4	0	0	4	0	0
17	24398751	.	T	A	1	3	4	0	0	4	0	0
17	24439623	.	T	A	1	2	3	0	0	3	0	0
17	24440579	.	G	A	2	5	7	0	0	7	0	0
17	24442526	.	G	A	0	11	11	0	7	18	0	0
17	24442888	.	C	T	4	15	19	0	0	19	0	0
17	24443182	.	G	C	4	2	6	0	0	6	0	0
17	24452168	.	A	G	5	4	9	0	1	10	0	0
17	24463526	.	G	A	9	8	17	1	0	18	0	0
17	24464939	.	A	C	14	13	27	0	0	27	0	0
17	24464987	.	A	T	14	8	22	0	1	23	0	0
17	24469255	.	G	A	8	8	16	0	0	16	0	0
17	24469752	.	A	C	19	10	29	0	1	30	0	0
17	24470146	.	C	A	13	16	29	0	3	32	0	0
17	24484184	.	T	A	2	2	4	0	1	5	0	0
17	24484202	.	G	T	2	2	4	0	0	4	0	0
17	24487410	.	A	T	3	3	6	0	2	9	1	0
17	24537442	.	G	T	5	3	8	0	0	8	0	0
17	24537450	.	T	A	5	4	9	0	0	9	0	0
17	24540672	.	G	T	3	3	6	0	0	6	0	0
17	24550311	.	G	A	2	2	4	0	0	4	0	0
17	24550541	.	G	A	2	3	5	0	0	5	0	0
17	24551263	.	C	T	2	3	5	0	0	5	0	0
17	24579134	.	A	C	1	0	1	0	7	8	0	0
17	24579158	.	T	C	1	8	9	0	0	9	0	0
17	24579293	.	T	C	1	4	5	0	0	5	0	0
17	24579422	.	G	A	3	5	8	0	0	8	0	0
17	24579587	.	A	G	1	3	4	0	1	5	0	0
17	24580268	.	G	A	2	2	4	0	1	5	0	0
17	24580328	.	A	C	5	0	5	0	5	10	0	0
17	24597853	.	T	C	1	3	4	0	0	4	0	0
17	24598879	.	G	T	1	1	2	0	0	2	0	0
17	24599488	.	C	G	2	2	4	0	0	4	0	0
17	24599509	.	T	G	2	3	5	0	0	5	0	0
17	24599746	.	C	A	3	3	6	0	0	6	0	0
17	24600150	.	A	C	1	2	3	0	0	3	0	0
17	24600595	.	G	A	0	6	6	0	4	10	0	0
17	24600767	.	G	A	3	3	6	0	0	6	0	0
17	24600976	.	G	A	8	5	13	0	1	14	0	0
17	24601072	.	G	A	0	4	4	0	8	12	0	0
17	24601579	.	T	A	9	9	18	0	1	19	0	0
17	24601924	.	C	T	7	10	17	0	1	18	0	0
17	24604523	.	A	T	2	5	7	0	0	7	0	0
17	24604619	.	G	T	0	2	2	0	5	7	0	0
17	24612661	.	G	T	7	5	12	0	0	12	0	0
17	24612726	.	A	G	10	5	15	0	1	16	0	0
17	24614468	.	C	T	28	37	65	0	3	68	0	0
17	24615205	.	A	G	14	5	19	0	0	19	0	0
17	24617888	.	C	A	6	19	25	0	4	29	0	0
17	24618912	.	C	T	7	6	13	0	0	13	0	0
17	24618945	.	C	T	8	7	15	0	0	15	0	0
17	24619650	.	A	G	2	4	6	0	1	7	0	0
17	24619693	.	A	G	4	0	4	0	11	15	0	0
17	24622623	.	G	T	13	14	27	0	0	27	0	0
17	24622644	.	G	A	11	14	25	0	0	25	0	0
17	24624477	.	G	C	3	4	7	0	0	7	0	0
17	24624612	.	G	A	3	2	5	0	0	5	0	0
17	24644783	.	G	A	2	4	6	0	0	6	0	0
17	24652987	.	C	T	10	4	14	0	1	15	0	0
17	24653089	.	C	T	1	2	3	0	0	3	0	0
17	24684823	.	G	A	2	5	7	0	0	7	0	0
17	24684844	.	T	G	7	11	18	0	0	18	0	0
17	24685850	.	C	T	22	6	28	0	2	30	0	0
17	24686352	.	C	T	6	7	13	0	0	13	0	0
17	24686443	.	A	T	11	3	14	0	0	14	0	0
17	24686574	.	A	G	1	4	5	0	0	5	0	0
17	24686575	.	C	G	0	3	3	0	2	5	0	0
17	24687392	.	C	A	5	2	7	0	0	7	0	0
17	24687602	.	G	C	2	7	9	0	1	10	0	0
17	24687693	.	G	T	2	4	6	0	0	6	0	0
17	24690050	.	G	A	1	3	4	0	5	9	0	0
17	24690119	.	C	T	4	5	9	0	0	9	0	0
17	24691987	.	C	T	5	5	10	0	0	10	0	0
17	24692030	.	A	C	2	3	5	0	1	6	0	0
17	24693207	.	T	C	7	12	19	0	0	19	0	0
17	24694145	.	A	G	8	4	12	0	1	13	0	0
17	24694573	.	T	A	3	4	7	0	0	7	0	0
17	24694877	.	C	G	3	5	8	0	0	8	0	0
17	24695096	.	C	A	2	3	5	1	0	6	0	0
17	24695683	.	T	A	2	5	7	0	3	10	0	0
17	24695815	.	G	C	6	0	6	0	11	17	0	0
17	24695968	.	G	C	8	13	21	0	0	21	0	0
17	24696047	.	G	T	18	9	27	0	0	27	0	0
17	24696142	.	A	C	7	5	12	0	1	13	0	0
17	24696658	.	C	A	11	9	20	0	2	22	0	0
17	24696716	.	A	G	7	14	21	0	0	21	0	0
17	24699483	.	G	A	9	8	17	0	1	18	0	0
17	24701496	.	C	T	6	2	8	0	0	8	0	0
17	24701767	.	T	C	7	4	11	0	1	12	0	0
17	24701793	.	C	G	0	4	4	0	8	12	0	0
17	24702981	.	T	C	5	4	9	0	0	9	0	0
17	24709204	.	C	T	15	10	25	1	0	26	0	0
17	24709292	.	T	C	5	0	5	0	8	13	0	0
17	24709443	.	T	G	11	8	19	0	0	19	0	0
17	24712929	.	C	T	4	3	7	0	1	8	0	0
17	24712985	.	C	T	1	6	7	0	7	14	0	0
17	24715189	.	A	G	11	9	20	0	0	20	0	0
17	24720907	.	T	C	9	8	17	1	1	19	0	0
17	24720964	.	G	C	8	14	22	0	0	22	0	0
17	24721345	.	G	A	12	12	24	0	2	26	0	0
17	24721378	.	C	A	10	7	17	0	0	17	0	0
17	24721384	.	G	A	8	6	14	0	2	16	0	0
17	24721462	.	G	A	1	9	10	0	8	18	0	0
17	24722402	.	C	T	6	3	9	0	2	11	0	0
17	24722441	.	A	G	6	7	13	0	0	13	0	0
17	24725877	.	C	A	19	14	33	0	0	33	0	0
17	24726035	.	A	T	19	20	39	0	0	39	0	0
17	24726134	.	A	G	7	0	7	0	21	28	0	0
17	24726239	.	G	T	13	10	23	0	0	23	0	0
17	24726276	.	A	G	16	9	25	0	1	26	0	0
17	24726533	.	T	A	20	8	28	0	1	29	0	0
17	24726585	.	C	T	11	10	21	0	2	23	0	0
17	24726613	.	G	A	10	11	21	0	0	21	0	0
17	24726637	.	A	G	7	11	18	0	1	19	0	0
17	24726737	.	T	C	12	15	27	0	2	29	0	0
17	24726753	.	G	A	12	9	21	0	7	28	0	0
17	24726996	.	A	G	17	9	26	0	0	26	0	0
17	24727037	.	C	T	19	9	28	0	2	30	0	0
17	24727130	.	T	G	10	0	10	0	6	16	0	0
17	24727186	.	C	G	4	4	8	0	1	9	0	0
17	24747328	.	A	C	2	6	8	0	0	8	0	0
17	24747412	.	C	T	3	5	8	0	0	8	0	0
17	24747485	.	C	T	2	5	7	0	0	7	0	0
17	24757422	.	T	G	7	1	8	0	5	13	0	0
17	24757443	.	G	A	1	6	7	0	4	11	0	0
17	24757572	.	G	C	9	3	12	0	1	13	0	0
17	24775642	.	A	G	2	5	7	0	0	7	0	0
17	24787248	.	G	A	6	5	11	0	2	13	0	0
17	24787519	.	G	A	5	9	14	0	0	14	0	0
17	24787736	.	C	A	2	4	6	0	0	6	0	0
17	24787774	.	A	T	1	6	7	0	1	8	0	0
17	24817636	.	A	G	2	3	5	0	0	5	0	0
17	24820044	.	C	T	4	4	8	0	0	8	0	0
17	24820052	.	T	C	4	3	7	0	0	7	0	0
17	24820134	.	T	C	2	5	7	0	0	7	0	0
17	24820136	.	G	C	1	5	6	0	1	7	0	0
17	24820469	.	T	C	3	2	5	0	1	6	0	0
17	24820502	.	G	T	1	4	5	0	0	5	0	0
17	24820621	.	G	T	1	1	2	0	1	3	0	0
17	24820683	.	T	A	3	2	5	0	1	6	0	0
17	24821697	.	T	C	9	7	16	0	0	16	0	0
17	24821720	.	G	A	8	3	11	0	0	11	0	0
17	24834743	.	C	T	11	7	18	0	2	20	0	0
17	24835158	.	A	T	11	11	22	0	2	25	1	0
17	24835251	.	G	C	7	8	15	0	0	15	0	0
17	24835547	.	A	T	4	5	9	0	0	9	0	0
17	24855867	.	T	G	5	4	9	0	1	10	0	0
17	24856019	.	G	A	21	12	33	0	2	35	0	0
17	24856088	.	C	G	11	19	30	0	1	31	0	0
17	24856338	.	T	C	4	4	8	0	1	9	0	0
17	24856648	.	G	T	6	5	11	0	1	12	0	0
17	24858939	.	A	C	7	0	7	0	6	13	0	0
17	24861176	.	C	T	1	15	16	0	13	29	0	0
17	24861252	.	G	A	10	11	21	0	0	21	0	0
17	24861558	.	A	G	6	12	18	0	2	20	0	0
17	24863929	.	C	G	12	9	21	0	0	21	0	0
17	24866585	.	G	T	10	7	17	0	2	19	0	0
17	24869963	.	G	A	3	2	5	0	0	5	0	0
17	24872642	.	G	A	5	3	8	0	1	9	0	0
17	24872714	.	T	A	2	6	8	0	0	8	0	0
17	24880613	.	G	A	6	5	11	0	0	11	0	0
17	24887419	.	G	A	1	2	3	0	0	3	0	0
17	24889365	.	C	A	1	2	3	0	2	5	0	0
17	24926357	.	A	G	1	3	4	0	0	4	0	0
17	24929215	.	A	T	3	3	6	0	0	6	0	0
17	24932994	.	T	A	4	5	9	0	0	9	0	0
17	24936154	.	A	T	3	2	5	0	0	5	0	0
17	24936160	.	G	A	1	2	3	0	0	3	0	0
17	24937235	.	G	A	3	2	5	0	0	5	0	0
17	24937420	.	C	G	2	2	4	0	0	4	0	0
17	24937429	.	T	C	2	2	4	0	0	4	0	0
17	25105119	.	C	T	3	3	6	0	0	6	0	0
17	25125576	.	A	G	1	1	2	0	3	5	0	0
17	25125612	.	T	C	4	2	6	0	0	6	0	0
17	25155779	.	C	T	2	4	6	0	0	6	0	0
17	25173643	.	A	G	4	0	4	0	10	14	0	0
17	25173803	.	T	C	3	2	5	0	1	6	0	0
17	25173899	.	A	T	4	5	9	0	0	9	0	0
17	25174031	.	C	A	2	3	5	0	0	5	0	0
17	25174052	.	A	G	3	0	3	0	3	6	0	0
17	25174222	.	C	A	1	2	3	0	0	3	0	0
17	25174673	.	C	T	5	5	10	0	0	10	0	0
17	25174688	.	T	C	4	4	8	0	0	8	0	0
17	25175002	.	T	A	1	3	4	0	0	4	0	0
17	25175072	.	C	T	2	5	7	0	0	7	0	0
17	25175100	.	T	A	3	2	5	0	0	5	0	0
17	25175134	.	T	C	6	3	9	0	0	9	0	0
17	25175326	.	A	C	2	2	4	0	0	4	0	0
17	25191343	.	C	T	2	2	4	0	0	4	0	0
17	25191706	.	A	C	3	3	6	0	0	6	0	0
17	25192169	.	A	G	3	0	3	0	5	8	0	0
17	25192202	.	A	T	2	2	4	0	0	4	0	0
17	25254376	.	A	G	2	0	2	0	2	4	0	0
17	25289571	.	C	A	5	10	15	0	0	15	0	0
17	25289889	.	C	T	7	6	13	0	0	13	0	0
17	25289905	.	A	G	6	5	11	0	0	11	0	0
17	25289930	.	A	T	7	7	14	0	0	14	0	0
17	25289955	.	C	T	6	7	13	0	0	13	0	0
17	25290396	.	C	T	11	6	17	0	0	17	0	0
17	25290481	.	G	A	2	6	8	0	7	15	0	0
17	25290657	.	C	T	9	9	18	0	0	18	0	0
17	25291068	.	A	G	17	1	18	0	7	25	0	0
17	25297908	.	C	T	4	2	6	0	0	6	0	0
17	25298003	.	T	G	2	6	8	0	0	8	0	0
17	25301622	.	C	T	2	3	5	0	0	5	0	0
17	25302891	.	G	A	2	4	6	0	0	6	0	0
17	25302909	.	G	A	5	4	9	0	1	10	0	0
17	25306107	.	G	A	7	10	17	0	0	17	0	0
17	25336507	.	T	C	5	2	7	0	0	7	0	0
17	25337466	.	C	T	5	2	7	0	0	7	0	0
17	25341745	.	T	A	1	2	3	0	0	3	0	0
17	25341751	.	A	C	1	3	4	0	0	4	0	0
17	25341932	.	C	G	3	2	5	0	0	5	0	0
17	25341977	.	A	T	3	5	8	0	0	8	0	0
17	25342003	.	T	A	4	2	6	0	0	6	0	0
17	25392917	.	G	A	1	5	6	0	0	6	0	0
17	25393034	.	A	C	8	7	15	0	0	15	0	0
17	25395198	.	G	C	5	2	7	0	0	7	0	0
17	25395199	.	C	A	5	2	7	0	0	7	0	0
17	25412123	.	T	C	1	12	13	0	1	14	0	0
17	25412133	.	G	A	1	11	12	0	0	12	0	0
17	25412386	.	G	C	1	4	5	0	0	5	0	0
17	25418707	.	T	G	3	2	5	0	1	6	0	0
17	25418727	.	C	A	0	3	3	0	1	4	0	0
17	25420042	.	A	C	1	3	4	0	1	5	0	0
17	25420065	.	T	C	2	2	4	0	1	5	0	0
17	25420151	.	A	G	4	6	10	0	0	10	0	0
17	25420937	.	C	T	12	7	19	0	1	20	0	0
17	25424205	.	C	A	9	13	22	0	0	22	0	0
17	25424239	.	C	T	9	12	21	0	2	23	0	0
17	25424330	.	T	A	9	11	20	0	0	20	0	0
17	25424331	.	C	A	11	11	22	0	0	22	0	0
17	25424568	.	A	G	14	8	22	0	2	24	0	0
17	25424597	.	C	T	14	14	28	0	0	28	0	0
17	25424664	.	G	A	13	11	24	0	1	25	0	0
17	25424770	.	G	A	0	4	4	0	4	8	0	0
17	25424771	.	A	G	3	4	7	0	1	8	0	0
17	25425081	.	G	T	2	7	9	0	0	9	0	0
17	25425094	.	A	G	2	5	7	0	0	7	0	0
17	25425146	.	T	A	9	13	22	0	1	23	0	0
17	25428842	.	A	C	1	3	4	0	0	4	0	0
17	25431447	.	C	T	3	4	7	0	0	7	0	0
17	25431492	.	G	A	3	4	7	0	0	7	0	0
17	25431493	.	A	T	3	4	7	0	0	7	0	0
17	25434250	.	G	T	14	20	34	0	2	36	0	0
17	25435992	.	A	G	28	26	54	0	2	56	0	0
17	25436073	.	T	C	26	25	51	0	2	53	0	0
17	25436591	.	A	T	30	18	48	1	0	49	0	0
17	25437384	.	A	G	14	0	14	0	30	44	0	0
17	25439909	.	G	A	23	22	45	0	0	45	0	0
17	25439949	.	C	T	27	16	43	2	2	47	0	0
17	25439950	.	C	A	28	16	44	2	1	47	0	0
17	25474195	.	A	G	4	4	8	0	0	8	0	0
17	25474261	.	C	T	6	2	8	0	0	8	0	0
17	25475601	.	C	T	4	2	6	0	0	6	0	0
17	25478710	.	A	G	3	4	7	0	1	8	0	0
17	25478896	.	C	T	8	5	13	0	0	13	0	0
17	25478897	.	T	G	8	5	13	0	0	13	0	0
17	25479147	.	T	A	9	3	12	0	0	12	0	0
17	25479151	.	A	C	6	3	9	0	0	9	0	0
17	25479200	.	T	C	3	3	6	0	2	8	0	0
17	25479640	.	A	G	7	8	15	0	7	22	0	0
17	25479792	.	G	A	20	7	27	0	1	28	0	0
17	25479874	.	T	A	17	5	22	0	1	23	0	0
17	25479920	.	A	G	14	4	18	0	0	18	0	0
17	25479980	.	C	T	8	4	12	0	1	13	0	0
17	25480129	.	T	G	7	6	13	0	0	13	0	0
17	25480158	.	G	T	5	0	5	1	7	13	0	0
17	25548992	.	G	A	0	2	2	0	2	4	0	0
17	25549001	.	G	T	2	3	5	0	0	5	0	0
17	25550006	.	C	T	0	4	4	0	1	5	0	0
17	25550029	.	A	C	1	3	4	0	0	4	0	0
17	25550449	.	G	A	8	2	10	0	1	11	0	0
17	25550450	.	G	A	8	3	11	0	0	11	0	0
17	25555209	.	G	A	9	7	16	0	0	16	0	0
17	25558916	.	G	A	12	8	20	0	1	21	0	0
17	25559491	.	A	G	9	9	18	0	0	18	0	0
17	25562160	.	A	G	4	6	10	0	1	11	0	0
17	25562198	.	G	T	7	4	11	0	1	12	0	0
17	25563524	.	T	A	6	6	12	0	1	13	0	0
17	25563542	.	G	A	7	6	13	0	0	13	0	0
17	25563667	.	C	T	0	4	4	0	3	7	0	0
17	25563738	.	G	A	4	3	7	0	0	7	0	0
17	25565040	.	C	T	1	3	4	0	0	4	0	0
17	25565058	.	G	A	1	2	3	0	0	3	0	0
17	25585750	.	G	T	1	4	5	0	0	5	0	0
17	25585755	.	A	C	1	5	6	0	0	6	0	0
17	25585926	.	G	A	1	3	4	0	0	4	0	0
17	25590202	.	T	A	1	4	5	0	0	5	0	0
17	25593705	.	G	A	0	3	3	0	2	5	0	0
17	25593945	.	G	A	2	4	6	0	1	7	0	0
17	25594390	.	C	A	7	3	10	0	0	10	0	0
17	25595611	.	A	G	3	0	3	0	8	11	0	0
17	25595618	.	G	A	3	7	10	0	0	10	0	0
17	25595653	.	G	A	0	3	3	0	4	7	0	0
17	25595674	.	G	A	4	2	6	0	1	7	0	0
17	25595697	.	G	A	6	2	8	0	0	8	0	0
17	25595731	.	T	C	6	3	9	0	0	9	0	0
17	25596801	.	C	T	4	3	7	0	1	8	0	0
17	25600571	.	G	A	7	3	10	0	0	10	0	0
17	25602744	.	C	T	6	3	9	0	1	10	0	0
17	25606154	.	G	A	4	15	19	0	17	36	0	0
17	25606161	.	C	T	17	15	32	0	1	33	0	0
17	25606421	.	T	A	10	6	16	0	1	17	0	0
17	25610895	.	G	T	10	14	24	0	0	24	0	0
17	25610975	.	C	T	3	7	10	0	14	24	0	0
17	25610989	.	C	T	13	6	19	0	1	20	0	0
17	25611011	.	A	G	10	7	17	0	0	17	0	0
17	25611067	.	A	C	8	4	12	0	1	13	0	0
17	25611091	.	C	A	1	4	5	0	4	9	0	0
17	25612941	.	G	C	11	8	19	0	0	19	0	0
17	25612978	.	G	A	5	7	12	0	0	13	1	0
17	25615493	.	A	G	3	6	9	0	0	9	0	0
17	25615609	.	T	A	5	8	13	0	0	13	0	0
17	25615894	.	A	G	3	7	10	0	1	11	0	0
17	25616374	.	C	T	4	7	11	0	1	12	0	0
17	25617760	.	G	T	1	3	4	0	1	6	1	0
17	25617950	.	G	T	6	3	9	0	1	10	0	0
17	25617967	.	T	A	5	2	7	0	1	8	0	0
17	25618850	.	G	T	6	6	12	0	1	13	0	0
17	25618961	.	C	A	4	7	11	0	0	11	0	0
17	25621178	.	C	T	1	1	2	0	2	4	0	0
17	25623841	.	A	T	2	4	6	0	0	6	0	0
17	25630550	.	C	T	3	3	6	0	0	6	0	0
17	25636167	.	G	A	28	13	41	1	2	44	0	0
17	25636412	.	A	G	37	25	62	0	2	64	0	0
17	25636539	.	T	C	38	6	44	0	37	81	0	0
17	25636594	.	C	T	5	40	45	0	36	81	0	0
17	25636679	.	C	T	3	34	37	0	34	71	0	0
17	25637106	.	A	C	33	33	66	0	7	73	0	0
17	25637676	.	T	C	33	3	36	0	21	57	0	0
17	25640476	.	G	A	28	23	51	0	2	53	0	0
17	25738601	.	T	C	1	1	2	0	1	3	0	0
17	25765287	.	A	G	1	2	3	0	0	3	0	0
17	25765683	.	G	A	2	2	4	0	0	4	0	0
17	25814073	.	A	C	1	0	1	0	3	4	0	0
17	25819315	.	C	A	1	2	3	0	0	3	0	0
17	25819316	.	A	G	1	2	3	0	0	3	0	0
17	25858362	.	A	G	2	3	5	0	0	5	0	0
17	25858581	.	G	T	3	2	5	0	0	5	0	0
17	25861496	.	A	G	2	3	5	0	0	5	0	0
17	25861501	.	C	T	1	3	4	0	0	4	0	0
17	25861682	.	T	G	1	3	4	0	0	4	0	0
17	25861766	.	A	C	2	2	4	0	0	4	0	0
17	25871375	.	G	A	0	2	2	0	1	3	0	0
17	25877526	.	A	G	1	3	4	0	1	5	0	0
17	25877694	.	G	A	0	2	2	0	2	4	0	0
17	25878173	.	A	G	1	7	8	0	0	8	0	0
17	25885103	.	A	G	4	0	4	0	3	7	0	0
17	25885415	.	T	A	2	6	8	0	2	10	0	0
17	25885418	.	C	G	2	6	8	0	2	10	0	0
17	26208866	.	T	C	1	2	3	0	0	3	0	0
17	26285347	.	A	G	3	0	3	0	2	5	0	0
17	26285350	.	G	T	3	2	5	0	0	5	0	0
17	26335000	.	G	A	6	5	11	0	0	11	0	0
17	26346175	.	T	A	6	7	13	0	0	13	0	0
17	26362130	.	G	A	11	5	16	0	1	17	0	0
17	26362500	.	C	T	8	4	12	0	0	12	0	0
17	26362512	.	A	C	4	9	13	0	0	13	0	0
17	26362539	.	C	T	5	7	12	0	1	13	0	0
17	26362741	.	C	T	5	4	9	0	0	10	1	0
17	26477795	.	A	C	11	7	18	0	0	18	0	0
17	26477857	.	T	C	11	16	27	0	0	27	0	0
17	26477860	.	C	T	12	16	28	0	1	29	0	0
17	26478023	.	T	C	11	6	17	0	2	19	0	0
17	26478403	.	T	G	4	8	12	0	2	14	0	0
17	26478592	.	A	G	16	9	25	0	1	26	0	0
17	26478818	.	T	C	14	0	14	0	10	24	0	0
17	26478952	.	G	A	8	8	16	0	0	16	0	0
17	26478986	.	A	G	5	12	17	0	1	18	0	0
17	26479063	.	A	G	11	10	21	1	1	23	0	0
17	26479145	.	T	C	11	13	24	0	1	25	0	0
17	26479916	.	G	T	6	5	11	0	1	12	0	0
17	26479960	.	C	T	3	3	6	0	1	7	0	0
17	26479997	.	A	T	2	2	4	0	0	4	0	0
17	26480421	.	A	G	7	3	10	0	0	10	0	0
17	26480423	.	T	C	6	3	9	0	0	9	0	0
17	26480622	.	A	T	6	4	10	0	1	11	0	0
17	26480926	.	T	G	2	2	4	0	0	4	0	0
17	26502013	.	A	G	4	9	13	0	3	16	0	0
17	26502047	.	A	C	6	0	6	0	5	11	0	0
17	26502107	.	G	A	2	5	7	0	0	7	0	0
17	26507294	.	G	A	1	5	6	0	0	6	0	0
17	26516745	.	G	C	5	4	9	0	0	9	0	0
17	26516748	.	G	C	5	5	10	0	0	10	0	0
17	26517366	.	G	A	1	2	3	0	0	3	0	0
17	26519364	.	A	G	1	3	4	0	0	4	0	0
17	26519475	.	T	C	1	0	1	0	2	3	0	0
17	26519681	.	C	T	3	3	6	0	0	6	0	0
17	26519823	.	T	C	1	0	1	0	4	5	0	0
17	26520183	.	T	A	3	2	5	0	0	5	0	0
17	26520205	.	C	A	4	3	7	0	0	7	0	0
17	26577293	.	T	C	3	6	9	0	0	9	0	0
17	26585135	.	G	T	4	5	9	0	0	9	0	0
17	26585163	.	A	T	3	5	8	0	1	9	0	0
17	26585298	.	G	T	0	5	5	0	5	10	0	0
17	26585316	.	C	T	6	3	9	0	1	10	0	0
17	26585646	.	C	T	18	6	24	0	0	24	0	0
17	26585727	.	C	T	9	19	28	0	0	28	0	0
17	26585748	.	A	G	18	0	18	0	9	27	0	0
17	26585763	.	T	A	20	8	28	0	2	30	0	0
17	26590001	.	T	G	13	8	21	0	1	22	0	0
17	26590091	.	C	T	1	9	10	0	2	12	0	0
17	26590330	.	T	C	11	5	16	0	0	16	0	0
17	26590495	.	A	G	5	2	7	0	0	7	0	0
17	26590650	.	G	T	6	5	11	0	0	11	0	0
17	26594968	.	G	C	6	11	17	0	0	17	0	0
17	26599208	.	C	T	4	4	8	0	7	15	0	0
17	26600555	.	T	A	4	7	11	0	0	11	0	0
17	26600639	.	G	A	10	6	16	0	0	16	0	0
17	26600667	.	C	T	5	8	13	0	1	14	0	0
17	26600785	.	G	A	2	7	9	0	0	9	0	0
17	26600881	.	G	A	4	3	7	0	1	8	0	0
17	26603369	.	A	T	4	2	6	0	0	6	0	0
17	26604572	.	A	G	4	3	7	0	1	8	0	0
17	26604751	.	G	C	3	2	5	0	1	6	0	0
17	26604758	.	C	T	3	3	6	0	1	7	0	0
17	26604801	.	C	A	4	5	9	0	0	9	0	0
17	26604917	.	G	A	2	2	4	0	1	5	0	0
17	26630909	.	C	T	3	9	12	0	0	12	0	0
17	26639659	.	C	T	17	9	26	0	1	27	0	0
17	26639725	.	A	G	10	0	10	0	5	15	0	0
17	26642775	.	C	A	4	9	13	0	2	15	0	0
17	26642817	.	T	G	6	0	6	0	8	14	0	0
17	26642818	.	T	C	5	8	13	0	1	14	0	0
17	26657852	.	T	C	12	18	30	0	1	31	0	0
17	26662347	.	C	T	12	9	21	0	1	22	0	0
17	26683466	.	T	C	19	8	27	0	0	27	0	0
17	26683526	.	C	T	20	14	34	0	4	38	0	0
17	26689753	.	G	A	19	25	44	0	4	48	0	0
17	26689768	.	C	A	27	16	43	0	1	44	0	0
17	26689792	.	C	A	12	19	31	0	1	33	1	0
17	26690112	.	T	A	22	8	30	0	2	32	0	0
17	26690250	.	C	T	3	11	14	1	0	15	0	0
17	26690276	.	C	T	10	10	20	0	2	22	0	0
17	26690478	.	C	T	12	16	28	0	0	28	0	0
17	26690558	.	G	A	1	10	11	0	14	25	0	0
17	26714009	.	C	T	32	24	56	0	8	64	0	0
17	26741254	.	T	C	2	3	5	0	0	5	0	0
17	26744174	.	G	A	1	2	3	0	0	3	0	0
17	26744706	.	T	C	2	3	5	0	0	5	0	0
17	26744748	.	T	A	3	2	5	0	0	5	0	0
17	26744927	.	A	G	5	3	8	0	1	9	0	0
17	26744930	.	A	C	4	3	7	0	1	8	0	0
17	26744981	.	C	T	7	2	9	0	0	9	0	0
17	26745106	.	T	C	1	2	3	0	0	3	0	0
17	26745203	.	C	A	2	2	4	0	0	4	0	0
17	26747348	.	A	G	4	6	10	0	0	10	0	0
17	26747392	.	G	T	7	4	11	0	0	11	0	0
17	26747552	.	G	C	6	5	11	0	0	11	0	0
17	26749836	.	G	A	1	2	3	0	0	3	0	0
17	26749889	.	C	T	1	2	3	0	0	3	0	0
17	26771084	.	G	A	1	2	3	0	0	3	0	0
17	26810380	.	C	T	17	23	40	0	0	40	0	0
17	26813285	.	T	C	6	19	25	1	5	31	0	0
17	26831861	.	G	A	4	3	7	0	0	7	0	0
17	26832713	.	C	T	1	2	3	0	0	3	0	0
17	26832738	.	A	G	2	2	4	0	0	4	0	0
17	26846203	.	C	T	9	7	16	0	0	16	0	0
17	26846650	.	G	A	4	9	13	0	3	16	0	0
17	26846707	.	G	A	0	2	2	0	4	6	0	0
17	26846901	.	T	G	10	5	15	0	0	15	0	0
17	26879854	.	A	C	14	15	29	0	2	31	0	0
17	26879869	.	A	G	19	10	29	0	3	32	0	0
17	26879893	.	A	G	18	22	40	0	1	41	0	0
17	26880107	.	G	A	19	19	38	0	0	38	0	0
17	26880231	.	T	C	32	30	62	0	0	62	0	0
17	26880424	.	T	C	35	22	57	0	1	58	0	0
17	26880687	.	T	C	26	6	32	0	1	33	0	0
17	26880692	.	T	C	11	19	30	0	0	30	0	0
17	26880926	.	T	C	18	0	18	0	26	44	0	0
17	26880964	.	A	G	26	24	50	0	3	53	0	0
17	26881131	.	T	A	25	21	46	0	1	47	0	0
17	26881354	.	A	G	23	19	42	0	2	44	0	0
17	26881777	.	A	G	33	13	46	4	1	51	0	0
17	26911747	.	A	G	18	18	36	0	2	38	0	0
17	26928994	.	C	T	4	4	8	0	0	8	0	0
17	26929005	.	T	C	9	2	11	0	0	11	0	0
17	26929029	.	G	A	1	10	11	0	0	11	0	0
17	26929475	.	T	C	2	9	11	0	0	11	0	0
17	26929577	.	C	A	8	8	16	0	0	16	0	0
17	26929649	.	A	G	8	9	17	0	0	17	0	0
17	26929654	.	T	A	10	7	17	0	0	17	0	0
17	26929776	.	C	T	7	3	10	0	0	10	0	0
17	26929893	.	G	A	9	5	14	0	0	14	0	0
17	26933328	.	C	T	2	2	4	0	0	4	0	0
17	26935254	.	G	T	5	4	9	0	0	9	0	0
17	26935274	.	G	T	10	5	15	0	0	15	0	0
17	26985158	.	G	A	1	7	8	0	12	20	0	0
17	26985544	.	T	A	6	6	12	0	4	16	0	0
17	26985561	.	T	G	6	0	6	0	10	16	0	0
17	26985586	.	C	T	3	12	15	0	0	15	0	0
17	26985638	.	T	G	3	6	9	0	0	9	0	0
17	26985656	.	T	A	4	3	7	0	1	8	0	0
17	26985692	.	G	T	5	5	10	0	0	10	0	0
17	27064523	.	T	A	6	3	9	0	0	9	0	0
17	27064725	.	T	C	4	5	9	0	0	9	0	0
17	27152597	.	T	C	3	6	9	0	0	9	0	0
17	27154580	.	C	A	4	8	12	0	0	12	0	0
17	27154695	.	A	G	3	4	7	0	0	7	0	0
17	27158692	.	C	T	6	4	10	0	1	11	0	0
17	27160846	.	C	T	3	6	9	0	0	9	0	0
17	27160912	.	G	A	5	4	9	0	1	10	0	0
17	27162479	.	C	T	8	4	12	0	0	12	0	0
17	27163266	.	T	C	4	3	7	0	1	8	0	0
17	27164497	.	T	C	3	4	7	0	1	8	0	0
17	27164530	.	C	T	5	4	9	0	0	9	0	0
17	27166221	.	T	C	7	7	14	0	3	17	0	0
17	27166257	.	T	C	5	4	9	0	1	10	0	0
17	27166521	.	C	T	5	8	13	0	1	14	0	0
17	27168957	.	G	T	1	7	8	0	10	18	0	0
17	27169561	.	T	G	9	8	17	1	2	20	0	0
17	27169783	.	A	C	7	5	12	0	0	12	0	0
17	27170017	.	G	A	2	2	4	0	8	12	0	0
17	27170153	.	A	T	5	7	12	0	3	15	0	0
17	27170390	.	G	T	3	3	6	0	0	6	0	0
17	27170516	.	G	A	0	12	12	0	5	17	0	0
17	27170549	.	G	A	6	9	15	0	0	15	0	0
17	27170605	.	T	G	7	7	14	0	1	15	0	0
17	27170678	.	C	A	5	9	14	0	0	14	0	0
17	27170730	.	T	G	10	8	18	0	0	18	0	0
17	27170746	.	A	T	8	8	16	0	2	18	0	0
17	27171314	.	A	C	1	4	5	0	0	5	0	0
17	27176640	.	G	A	3	3	6	0	0	6	0	0
17	27176871	.	G	A	4	7	11	0	1	12	0	0
17	27176967	.	G	C	3	5	8	0	0	8	0	0
17	27176991	.	C	T	4	7	11	0	0	11	0	0
17	27177064	.	C	T	4	9	13	0	0	13	0	0
17	27177083	.	G	A	1	9	10	0	5	15	0	0
17	27177251	.	A	G	2	4	6	0	0	6	0	0
17	27177745	.	G	A	2	4	6	0	0	6	0	0
17	27177776	.	G	T	1	5	6	0	0	6	0	0
17	27177808	.	G	T	3	2	5	0	0	5	0	0
17	27177945	.	G	T	3	7	10	0	1	11	0	0
17	27178024	.	T	A	4	4	8	0	1	9	0	0
17	27178191	.	G	A	2	3	5	0	0	5	0	0
17	27178232	.	A	G	4	4	8	0	0	8	0	0
17	27178254	.	C	A	6	5	11	0	0	11	0	0
17	27178273	.	G	T	4	6	10	0	0	10	0	0
17	27178296	.	G	A	0	3	3	0	5	8	0	0
17	27178356	.	T	A	3	6	9	0	1	10	0	0
17	27178383	.	C	G	4	3	7	0	0	7	0	0
17	27178401	.	C	T	9	3	12	0	0	12	0	0
17	27178557	.	C	T	7	9	16	0	0	16	0	0
17	27178638	.	C	G	4	2	6	0	0	6	0	0
17	27178730	.	C	A	5	6	11	0	0	11	0	0
17	27178870	.	T	C	5	4	9	0	0	9	0	0
17	27179189	.	A	G	7	6	13	0	0	13	0	0
17	27179203	.	G	T	0	5	5	0	4	9	0	0
17	27179434	.	G	T	8	7	15	0	0	15	0	0
17	27179848	.	A	G	1	3	4	0	0	4	0	0
17	27180054	.	A	T	2	2	4	0	0	4	0	0
17	27180407	.	T	A	4	5	9	0	0	9	0	0
17	27180847	.	A	G	3	10	13	0	0	13	0	0
17	27181021	.	T	C	7	13	20	0	0	20	0	0
17	27181048	.	C	G	11	11	22	0	1	23	0	0
17	27181129	.	G	A	11	11	22	0	1	23	0	0
17	27181130	.	G	A	10	12	22	0	1	23	0	0
17	27181257	.	A	C	9	12	21	0	0	21	0	0
17	27181323	.	A	G	13	0	13	0	8	21	0	0
17	27181411	.	A	G	7	1	8	0	8	16	0	0
17	27181427	.	C	T	6	7	13	0	0	13	0	0
17	27181618	.	C	A	5	2	7	0	0	7	0	0
17	27181829	.	A	G	11	6	17	0	1	18	0	0
17	27182006	.	G	T	19	8	27	0	0	27	0	0
17	27182039	.	T	C	17	11	28	0	1	29	0	0
17	27182114	.	A	G	6	18	24	0	1	25	0	0
17	27182146	.	C	T	4	11	15	0	0	15	0	0
17	27182331	.	T	G	4	9	13	0	0	13	0	0
17	27182340	.	C	T	3	7	10	0	1	11	0	0
17	27182449	.	G	T	11	5	16	0	0	16	0	0
17	27182484	.	T	C	12	12	24	0	0	24	0	0
17	27182645	.	G	T	23	12	35	0	0	35	0	0
17	27182649	.	A	G	22	12	34	0	0	34	0	0
17	27182769	.	A	G	6	9	15	0	1	16	0	0
17	27182894	.	T	C	4	11	15	0	2	17	0	0
17	27182925	.	A	T	4	6	10	0	0	10	0	0
17	27182979	.	C	T	9	7	16	0	0	16	0	0
17	27194669	.	C	T	1	2	3	0	0	3	0	0
17	27272913	.	T	C	7	5	12	0	2	14	0	0
17	27273013	.	C	T	8	8	16	0	0	16	0	0
17	27401038	.	A	T	11	4	15	0	6	21	0	0
17	27408386	.	A	G	9	16	25	0	1	26	0	0
17	27408472	.	C	T	11	22	33	0	1	34	0	0
17	27408523	.	G	T	8	10	18	0	0	18	0	0
17	27408531	.	T	A	5	8	13	0	2	15	0	0
17	27408637	.	T	C	4	0	4	0	8	12	0	0
17	27408836	.	T	G	8	12	20	0	2	22	0	0
17	27408889	.	T	C	14	12	26	0	1	27	0	0
17	27413564	.	T	C	8	12	20	0	1	21	0	0
17	27413705	.	T	C	11	7	18	0	0	18	0	0
17	27414035	.	G	A	5	5	10	0	2	12	0	0
17	27414098	.	C	A	11	10	21	0	1	22	0	0
17	27414203	.	G	A	9	15	24	0	1	25	0	0
17	27414215	.	C	T	2	11	13	0	14	27	0	0
17	27414367	.	A	G	11	11	22	0	0	22	0	0
17	27414658	.	T	C	5	7	12	0	1	13	0	0
17	27414701	.	A	G	4	9	13	0	0	13	0	0
17	27414791	.	A	G	7	4	11	0	0	11	0	0
17	27414815	.	G	A	6	6	12	0	1	13	0	0
17	27415010	.	C	T	1	5	6	0	8	14	0	0
17	27723800	.	G	T	11	12	23	0	2	25	0	0
17	27807455	.	T	C	13	17	30	0	1	31	0	0
17	27808335	.	A	G	23	9	32	0	0	32	0	0
17	27808686	.	G	A	4	7	11	0	0	11	0	0
17	27808700	.	G	A	5	7	12	0	0	12	0	0
17	27808987	.	G	T	2	18	20	0	29	49	0	0
17	27809135	.	C	G	9	0	9	0	28	37	0	0
17	27809548	.	T	A	12	12	24	0	2	26	0	0
17	27809631	.	G	T	3	7	10	0	12	22	0	0
17	27809779	.	C	A	29	21	50	0	0	50	0	0
17	27809885	.	A	G	19	25	44	0	0	44	0	0
17	27811199	.	T	A	8	3	11	0	0	11	0	0
17	27811209	.	A	G	9	4	13	0	0	13	0	0
17	27811254	.	T	C	5	5	10	0	0	10	0	0
17	27811277	.	C	G	4	3	7	0	1	8	0	0
17	27811824	.	A	T	2	2	4	0	0	4	0	0
17	27812525	.	A	C	22	5	27	0	2	29	0	0
17	27812562	.	G	A	1	11	12	0	18	30	0	0
17	27812702	.	A	T	16	7	23	0	0	23	0	0
17	27812885	.	C	T	3	4	7	0	1	8	0	0
17	27813221	.	C	T	11	8	19	0	0	19	0	0
17	27813222	.	A	G	11	8	19	0	0	19	0	0
17	28049663	.	A	T	3	3	6	0	0	6	0	0
17	28049804	.	G	T	6	2	8	0	0	8	0	0
17	28050500	.	T	A	4	9	13	0	0	13	0	0
17	28050530	.	A	G	6	9	15	0	0	15	0	0
17	28050954	.	G	A	3	5	8	0	0	8	0	0
17	28051073	.	C	T	1	2	3	0	0	3	0	0
17	28051129	.	G	A	1	2	3	0	0	3	0	0
17	28051465	.	T	C	3	3	6	0	0	6	0	0
17	28051504	.	G	T	5	7	12	0	1	13	0	0
17	28051739	.	A	G	5	7	12	0	0	12	0	0
17	28052322	.	C	A	5	8	13	0	0	13	0	0
17	28067389	.	C	T	9	9	18	0	1	19	0	0
17	28067472	.	A	C	7	10	17	0	1	18	0	0
17	28067618	.	A	G	5	9	14	0	0	14	0	0
17	28067856	.	C	T	15	4	19	0	0	19	0	0
17	28068083	.	T	C	3	7	10	0	1	11	0	0
17	28068087	.	G	T	3	8	11	0	1	12	0	0
17	28068168	.	G	A	2	5	7	0	0	7	0	0
17	28068262	.	T	G	5	0	5	0	6	11	0	0
17	28068276	.	C	T	4	6	10	0	0	10	0	0
17	28068507	.	A	G	8	5	13	0	0	13	0	0
17	28068514	.	T	C	8	5	13	0	0	13	0	0
17	28068832	.	T	A	4	2	6	0	0	6	0	0
17	28068916	.	C	T	5	5	10	0	0	10	0	0
17	28069170	.	G	A	11	11	22	0	0	22	0	0
17	28069341	.	G	T	9	9	18	0	0	18	0	0
17	28069342	.	T	C	9	9	18	0	1	19	0	0
17	28069645	.	G	T	11	13	24	0	0	24	0	0
17	28069716	.	G	C	25	17	42	0	1	43	0	0
17	28069787	.	G	A	3	12	15	0	23	38	0	0
17	28070078	.	G	C	12	9	21	0	1	22	0	0
17	28070167	.	C	T	12	14	26	0	0	26	0	0
17	28070284	.	G	A	8	6	14	0	1	15	0	0
17	28070286	.	A	C	8	6	14	0	1	15	0	0
17	28070481	.	T	A	9	18	27	0	1	28	0	0
17	28070600	.	C	A	12	7	19	0	3	22	0	0
17	28070840	.	G	A	5	4	9	0	0	9	0	0
17	28071029	.	A	T	5	2	7	0	0	7	0	0
17	28071194	.	C	T	7	3	10	0	1	11	0	0
17	28071260	.	A	G	9	10	19	0	1	20	0	0
17	28084592	.	C	T	5	5	10	0	2	12	0	0
17	28084733	.	T	C	13	17	30	6	1	37	0	0
17	28084869	.	A	C	28	12	40	0	0	40	0	0
17	28084996	.	A	T	22	17	39	0	0	39	0	0
17	28097235	.	G	A	8	12	20	0	0	20	0	0
17	28097672	.	T	C	10	9	19	0	0	19	0	0
17	28100598	.	C	T	1	7	8	0	17	25	0	0
17	28166980	.	C	T	4	4	8	0	0	8	0	0
17	28167235	.	T	C	4	0	4	0	5	9	0	0
17	28167439	.	G	A	11	6	17	0	0	17	0	0
17	28168054	.	A	G	5	4	9	0	0	9	0	0
17	28168363	.	G	A	5	2	7	0	1	8	0	0
17	28168366	.	G	A	4	3	7	0	0	7	0	0
17	28408024	.	A	C	3	2	5	0	1	6	0	0
17	28440296	.	T	C	5	3	8	0	0	8	0	0
17	28461857	.	G	A	0	5	5	0	2	7	0	0
17	28466228	.	T	C	6	3	9	0	0	9	0	0
17	28466273	.	C	T	5	4	9	0	0	9	0	0
17	28497878	.	T	C	4	6	10	0	1	11	0	0
17	28560736	.	T	C	7	5	12	0	0	12	0	0
17	28563725	.	G	A	10	14	24	0	1	25	0	0
17	28608088	.	G	T	3	2	5	0	0	5	0	0
17	28639333	.	T	G	1	2	3	0	0	3	0	0
17	28640690	.	G	T	1	2	3	0	0	3	0	0
17	28642220	.	C	G	1	2	3	0	0	3	0	0
17	28643635	.	C	T	1	2	3	0	0	3	0	0
17	28655195	.	G	A	0	2	2	0	2	4	0	0
17	28657421	.	G	T	1	4	5	0	0	5	0	0
17	28661628	.	C	G	2	0	2	0	3	5	0	0
17	28661931	.	G	T	0	4	4	0	2	6	0	0
17	28666381	.	C	T	0	4	4	0	1	5	0	0
17	28668465	.	T	C	6	3	9	0	0	9	0	0
17	28668627	.	C	T	2	2	4	0	0	4	0	0
17	28680051	.	C	T	3	4	7	0	0	7	0	0
17	28680634	.	G	A	2	4	6	0	0	6	0	0
17	28695753	.	C	T	6	10	16	0	0	16	0	0
17	28701100	.	G	A	11	6	17	0	0	17	0	0
17	28707268	.	T	A	6	9	15	0	1	16	0	0
17	28724530	.	A	G	6	0	6	0	10	16	0	0
17	28724539	.	A	T	5	10	15	0	0	15	0	0
17	28724833	.	T	C	8	8	16	0	0	16	0	0
17	28725346	.	A	G	8	0	8	0	8	16	0	0
17	28730705	.	C	T	10	7	17	0	1	18	0	0
17	28738387	.	C	T	9	4	13	0	0	13	0	0
17	28738675	.	A	G	12	0	12	0	12	24	0	0
17	28741442	.	G	A	5	18	23	0	0	23	0	0
17	28741540	.	A	G	15	0	15	0	9	25	1	0
17	28741752	.	C	T	15	9	24	0	0	24	0	0
17	28741934	.	C	T	5	9	14	0	0	14	0	0
17	28742263	.	G	C	13	18	31	0	0	31	0	0
17	28742385	.	T	A	12	9	21	0	3	24	0	0
17	28742505	.	T	G	15	21	36	0	0	36	0	0
17	28742559	.	C	T	20	18	38	0	0	38	0	0
17	28742681	.	C	T	4	6	10	0	1	11	0	0
17	28742755	.	C	A	2	3	5	0	0	5	0	0
17	28761498	.	A	T	1	2	3	0	1	4	0	0
17	28771228	.	T	A	11	15	26	0	0	26	0	0
17	28778186	.	C	T	10	8	18	0	1	19	0	0
17	28784090	.	G	T	14	4	18	0	2	20	0	0
17	28785010	.	G	A	13	10	23	0	0	23	0	0
17	28786873	.	G	A	12	12	24	0	1	25	0	0
17	28789014	.	C	T	0	8	8	0	11	19	0	0
17	28939316	.	T	C	1	3	4	0	0	4	0	0
17	28948905	.	G	A	6	3	9	0	0	9	0	0
17	28968461	.	T	C	23	15	38	0	0	38	0	0
17	29117355	.	G	A	3	3	6	0	0	6	0	0
17	29228114	.	G	A	2	3	5	0	0	5	0	0
17	29228222	.	A	G	6	5	11	0	0	11	0	0
17	29251810	.	G	C	5	6	11	1	0	12	0	0
17	29252043	.	C	T	2	5	7	0	0	7	0	0
17	29252122	.	C	A	10	12	22	0	1	23	0	0
17	29252218	.	C	T	4	5	9	0	0	9	0	0
17	29252254	.	C	T	5	3	8	0	0	8	0	0
17	29252295	.	T	C	5	7	12	0	0	12	0	0
17	29252308	.	T	G	5	8	13	0	0	13	0	0
17	29252352	.	C	T	5	4	9	0	1	10	0	0
17	29252754	.	C	G	0	7	7	0	6	13	0	0
17	29257146	.	C	T	9	2	11	0	0	11	0	0
17	29270939	.	C	T	0	6	6	0	5	11	0	0
17	29283126	.	T	A	1	5	6	0	0	6	0	0
17	29283380	.	T	A	1	5	6	0	1	7	0	0
17	29283688	.	G	C	2	4	6	0	3	9	0	0
17	29283723	.	A	T	5	5	10	0	1	11	0	0
17	29283866	.	T	C	4	3	7	0	0	7	0	0
17	29283902	.	G	A	5	8	13	0	0	13	0	0
17	29283920	.	A	C	5	0	5	0	7	12	0	0
17	29283943	.	A	G	5	12	17	0	1	18	0	0
17	29283962	.	A	G	10	12	22	0	0	22	0	0
17	29288057	.	G	T	3	6	9	0	0	9	0	0
17	29288718	.	A	G	6	10	16	0	0	16	0	0
17	29297901	.	A	G	6	2	8	0	1	9	0	0
17	29297907	.	C	A	0	2	2	0	7	9	0	0
17	29298224	.	A	G	6	2	8	0	0	8	0	0
17	29334520	.	T	A	6	11	17	0	2	19	0	0
17	29335645	.	G	A	10	6	16	0	1	17	0	0
17	29339149	.	T	G	18	15	33	0	2	35	0	0
17	29341079	.	C	T	13	10	23	0	1	24	0	0
17	29341118	.	C	T	17	13	30	0	0	30	0	0
17	29341597	.	T	C	9	16	25	0	1	26	0	0
17	29342904	.	G	A	1	6	7	0	3	10	0	0
17	29342947	.	C	T	10	8	18	0	0	18	0	0
17	29343143	.	T	C	14	14	28	0	1	29	0	0
17	29343153	.	G	A	15	11	26	0	0	26	0	0
17	29343358	.	A	G	11	12	23	0	0	23	0	0
17	29343494	.	A	G	6	9	15	0	0	15	0	0
17	29345725	.	T	G	3	8	11	0	1	12	0	0
17	29349739	.	G	A	1	5	6	0	2	8	0	0
17	29364518	.	G	A	6	12	18	0	0	18	0	0
17	29364713	.	C	T	3	4	7	0	1	8	0	0
17	29367320	.	T	C	7	9	16	0	2	18	0	0
17	29369029	.	C	T	11	14	25	0	0	25	0	0
17	29369072	.	T	C	4	10	14	0	0	14	0	0
17	29369114	.	T	C	8	6	14	0	0	14	0	0
17	29369213	.	T	G	11	8	19	0	1	20	0	0
17	29369414	.	G	A	8	11	19	0	0	19	0	0
17	29369612	.	A	G	9	8	17	0	0	17	0	0
17	29369713	.	A	C	11	7	18	0	2	20	0	0
17	29369748	.	C	T	10	13	23	0	1	24	0	0
17	29369780	.	C	A	6	7	13	0	0	13	0	0
17	29369823	.	C	T	4	2	6	0	1	7	0	0
17	29370260	.	T	A	3	2	5	0	1	6	0	0
17	29798098	.	A	G	4	7	11	0	0	11	0	0
17	29798312	.	C	A	0	15	15	0	11	26	0	0
17	29804291	.	G	C	11	6	17	0	1	18	0	0
17	29841590	.	A	T	10	10	20	0	3	23	0	0
17	29877079	.	C	T	1	3	4	0	2	6	0	0
17	29877094	.	A	G	1	2	3	0	0	3	0	0
17	30411474	.	C	T	2	3	5	0	0	5	0	0
17	30411498	.	C	T	2	2	4	0	0	4	0	0
17	30414430	.	C	T	2	2	4	0	0	4	0	0
17	30458569	.	C	T	1	3	4	0	0	4	0	0
17	30459602	.	C	A	2	3	5	0	0	5	0	0
17	30460216	.	T	C	1	3	4	0	0	4	0	0
17	30460217	.	G	C	1	3	4	0	0	4	0	0
17	30464806	.	A	T	7	4	11	0	2	13	0	0
17	30465779	.	T	A	4	3	7	0	1	8	0	0
17	30466186	.	G	A	8	2	10	0	0	10	0	0
17	30468428	.	C	T	7	7	14	0	1	15	0	0
17	30468730	.	G	T	2	2	4	0	1	5	0	0
17	30469200	.	C	A	4	5	9	0	2	11	0	0
17	30469350	.	A	T	4	2	6	0	1	7	0	0
17	30469364	.	T	C	2	2	4	0	0	4	0	0
17	30474161	.	A	G	2	2	4	0	1	5	0	0
17	30474226	.	A	G	5	3	8	0	0	8	0	0
17	30476978	.	A	G	6	5	11	0	0	11	0	0
17	30478808	.	A	G	6	4	10	0	0	10	0	0
17	30478897	.	G	A	2	5	7	0	0	7	0	0
17	30479161	.	A	G	3	6	9	0	0	9	0	0
17	30479359	.	T	C	2	4	6	0	1	7	0	0
17	30486671	.	T	C	4	1	5	0	9	14	0	0
17	30486971	.	G	A	3	1	4	0	1	5	0	0
17	30487094	.	G	C	6	7	13	0	0	13	0	0
17	30492088	.	C	T	1	3	4	0	0	4	0	0
17	30492999	.	A	C	5	0	5	0	3	8	0	0
17	30493290	.	T	C	4	3	7	0	0	7	0	0
17	30493478	.	T	G	1	2	3	0	0	3	0	0
17	30494073	.	T	G	4	2	6	0	1	7	0	0
17	30498084	.	C	T	3	3	6	0	2	8	0	0
17	30505439	.	T	C	2	0	2	0	3	5	0	0
17	30506896	.	A	G	4	2	6	0	0	6	0	0
17	30506899	.	G	A	4	1	5	0	1	6	0	0
17	30583641	.	A	T	2	2	4	0	0	4	0	0
17	30584232	.	C	A	1	2	3	0	0	3	0	0
17	30584338	.	C	A	1	3	4	0	0	4	0	0
17	30584341	.	G	A	0	2	2	0	1	3	0	0
17	30584929	.	A	C	1	2	3	0	0	3	0	0
17	30585604	.	C	T	2	7	9	0	0	9	0	0
17	30585682	.	A	T	5	2	7	0	0	7	0	0
17	30586485	.	C	T	6	4	10	0	0	10	0	0
17	30586521	.	A	G	7	0	7	0	6	13	0	0
17	30587288	.	T	C	4	4	8	0	0	8	0	0
17	30587324	.	T	G	5	0	5	0	8	13	0	0
17	30587325	.	A	G	5	8	13	0	0	13	0	0
17	30589166	.	T	C	3	7	10	0	0	10	0	0
17	30589379	.	A	G	5	6	11	0	1	12	0	0
17	30589623	.	T	A	1	5	6	0	0	6	0	0
17	30590020	.	A	G	10	6	16	0	0	16	0	0
17	30590271	.	G	T	10	8	18	0	0	18	0	0
17	30590273	.	C	G	10	8	18	0	0	18	0	0
17	30590325	.	C	T	12	7	19	0	1	20	0	0
17	30590367	.	G	A	6	8	14	0	0	14	0	0
17	30590515	.	C	A	4	3	7	0	1	8	0	0
17	30590541	.	C	T	3	2	5	0	0	5	0	0
17	30590838	.	T	C	11	6	17	0	0	17	0	0
17	30590842	.	C	A	10	6	16	0	0	16	0	0
17	30784396	.	A	G	2	0	2	0	4	6	0	0
17	30784400	.	C	T	2	3	5	0	1	6	0	0
17	30816937	.	T	C	6	5	11	0	0	11	0	0
17	30817044	.	G	A	3	4	7	0	0	7	0	0
17	30817119	.	T	A	2	3	5	0	0	5	0	0
17	30857288	.	A	G	17	13	30	0	1	31	0	0
17	30858809	.	C	T	3	17	20	0	12	33	1	0
17	30860630	.	G	T	12	13	25	0	1	26	0	0
17	30862909	.	A	G	6	8	14	0	0	14	0	0
17	30912562	.	C	A	8	13	21	0	0	21	0	0
17	30936802	.	C	T	0	7	7	0	7	14	0	0
17	30979170	.	T	C	12	12	24	0	1	25	0	0
17	30979208	.	T	C	7	14	21	0	1	22	0	0
17	30979339	.	T	C	6	10	16	0	0	16	0	0
17	30979391	.	T	C	9	0	9	0	11	20	0	0
17	30979518	.	G	A	6	8	14	0	0	14	0	0
17	30980336	.	A	G	13	10	23	0	2	25	0	0
17	30986665	.	T	C	14	8	22	0	1	23	0	0
17	30986712	.	G	T	9	9	18	0	0	18	0	0
17	30992178	.	T	C	4	9	13	0	1	14	0	0
17	30995008	.	G	A	4	6	10	0	1	11	0	0
17	31014189	.	G	A	8	7	15	0	1	16	0	0
17	31014192	.	T	C	7	9	16	0	1	17	0	0
17	31058673	.	T	A	3	5	8	0	0	8	0	0
17	31058772	.	G	A	2	6	8	0	2	10	0	0
17	31058780	.	G	C	2	7	9	0	0	9	0	0
17	31058807	.	C	A	2	6	8	0	1	9	0	0
17	31195800	.	G	T	0	5	5	0	3	8	0	0
17	31195824	.	T	C	5	3	8	0	0	8	0	0
17	31199717	.	G	A	0	3	3	0	6	9	0	0
17	31200222	.	T	C	11	4	15	0	0	15	0	0
17	31200247	.	C	A	10	5	15	0	0	15	0	0
17	31200394	.	G	C	8	4	12	0	1	13	0	0
17	31200475	.	A	T	7	8	15	0	0	15	0	0
17	31200481	.	C	T	7	7	14	0	0	14	0	0
17	31200621	.	C	T	5	4	9	0	1	10	0	0
17	31201207	.	C	T	9	8	17	0	0	17	0	0
17	31201348	.	A	G	15	0	15	0	6	21	0	0
17	31201523	.	A	T	10	8	18	0	0	18	0	0
17	31201894	.	A	C	9	13	22	0	1	23	0	0
17	31201954	.	A	G	16	14	30	0	0	30	0	0
17	31205217	.	A	G	2	2	4	0	0	4	0	0
17	31205360	.	G	A	5	2	7	0	0	7	0	0
17	31205375	.	T	A	4	2	6	0	0	6	0	0
17	31205508	.	G	A	2	2	4	0	0	4	0	0
17	31205579	.	G	A	3	4	7	0	0	7	0	0
17	31205600	.	T	C	6	0	6	0	4	10	0	0
17	31205614	.	G	A	5	4	9	0	0	9	0	0
17	31205775	.	T	C	3	2	5	0	0	5	0	0
17	31205826	.	A	G	6	3	9	0	0	9	0	0
17	31205841	.	G	A	7	4	11	0	0	11	0	0
17	31205865	.	G	A	6	3	9	0	2	11	0	0
17	31212357	.	T	C	3	0	3	0	2	5	0	0
17	31214459	.	A	T	5	5	10	0	1	11	0	0
17	31217113	.	T	A	7	7	14	0	1	15	0	0
17	31219208	.	T	C	5	0	5	0	6	11	0	0
17	31222505	.	A	T	18	11	29	0	0	29	0	0
17	31228767	.	G	C	16	11	27	0	0	27	0	0
17	31228801	.	C	T	10	8	18	0	0	18	0	0
17	31228837	.	G	A	2	7	9	0	8	17	0	0
17	31228900	.	T	C	6	10	16	0	1	17	0	0
17	31277169	.	A	T	7	9	16	0	2	18	0	0
17	31277443	.	A	G	13	16	29	0	2	31	0	0
17	31277758	.	A	T	2	3	5	0	0	5	0	0
17	31277820	.	C	A	9	7	16	0	1	17	0	0
17	31277855	.	G	A	16	10	26	0	2	28	0	0
17	31277987	.	T	C	10	1	11	0	10	21	0	0
17	31278022	.	G	A	8	11	19	0	1	20	0	0
17	31278433	.	C	A	16	12	28	0	0	28	0	0
17	31283510	.	C	G	0	9	9	0	3	12	0	0
17	31286221	.	G	A	6	9	15	0	1	16	0	0
17	31297284	.	G	A	7	10	17	0	0	17	0	0
17	31297746	.	C	T	0	5	5	0	4	9	0	0
17	31297768	.	G	T	3	7	10	0	0	10	0	0
17	31297791	.	C	T	3	4	7	0	1	8	0	0
17	31298349	.	C	T	1	4	5	0	4	9	0	0
17	31307882	.	T	C	2	3	5	0	0	5	0	0
17	31346575	.	A	G	1	2	3	0	0	3	0	0
17	31346582	.	T	C	1	2	3	0	1	4	0	0
17	31346653	.	C	T	3	9	12	0	0	12	0	0
17	31346695	.	A	G	5	11	16	0	0	16	0	0
17	31346712	.	G	A	5	10	15	0	1	16	0	0
17	31346840	.	A	G	11	12	23	0	0	23	0	0
17	31347029	.	T	A	16	18	34	0	0	34	0	0
17	31347046	.	T	G	17	17	34	0	0	34	0	0
17	31347193	.	A	C	20	15	35	0	1	36	0	0
17	31347254	.	A	G	11	25	36	0	0	36	0	0
17	31347344	.	C	G	11	10	21	0	0	21	0	0
17	31355841	.	C	T	7	11	18	0	1	19	0	0
17	31357531	.	C	T	7	10	17	0	0	17	0	0
17	31360631	.	T	C	5	12	17	0	0	17	0	0
17	31360786	.	G	A	6	3	9	1	1	11	0	0
17	31360804	.	C	T	10	7	17	1	2	20	0	0
17	31360854	.	G	A	7	11	18	0	1	19	0	0
17	31393730	.	A	T	2	3	5	0	0	5	0	0
17	31393786	.	T	C	3	2	5	0	0	5	0	0
17	31393962	.	A	T	1	2	3	0	0	3	0	0
17	31394023	.	T	C	2	3	5	0	0	5	0	0
17	31400853	.	C	T	0	1	1	0	3	4	0	0
17	31400856	.	G	C	2	2	4	0	0	4	0	0
17	31535967	.	A	G	3	2	5	0	0	5	0	0
17	31540138	.	C	T	0	2	2	0	3	5	0	0
17	31545776	.	C	G	1	5	6	0	2	8	0	0
17	31545935	.	A	G	3	2	5	0	0	5	0	0
17	31545971	.	C	A	0	4	4	0	2	6	0	0
17	31548807	.	G	A	2	4	6	0	0	6	0	0
17	31591070	.	G	T	1	0	1	0	1	2	0	0
17	31591078	.	A	C	1	2	3	0	0	3	0	0
17	31611947	.	T	C	8	6	14	0	0	14	0	0
17	31612019	.	A	G	7	3	10	0	0	10	0	0
17	31612027	.	A	G	7	0	7	0	2	9	0	0
17	31616799	.	T	C	12	14	26	0	0	26	0	0
17	31618624	.	C	T	17	12	29	0	1	30	0	0
17	31618636	.	T	C	15	13	28	0	2	30	0	0
17	31618953	.	T	C	19	18	37	0	1	38	0	0
17	31618962	.	A	G	21	15	36	0	1	37	0	0
17	31621894	.	C	T	7	3	10	0	0	10	0	0
17	31621921	.	C	A	6	3	9	0	1	10	0	0
17	31622024	.	C	A	10	10	20	0	1	21	0	0
17	31622083	.	A	C	10	15	25	0	0	25	0	0
17	31622123	.	C	A	11	17	28	0	0	28	0	0
17	31622233	.	T	A	11	8	19	0	0	19	0	0
17	31622367	.	A	G	13	10	23	0	0	23	0	0
17	31622662	.	C	T	10	10	20	0	1	21	0	0
17	31622690	.	A	C	5	4	9	0	0	9	0	0
17	31622995	.	G	A	3	2	5	0	0	5	0	0
17	31623588	.	A	G	8	4	12	0	0	12	0	0
17	31623635	.	C	T	6	4	10	0	0	10	0	0
17	31623646	.	A	G	6	7	13	0	0	13	0	0
17	31623829	.	G	C	17	7	24	0	2	26	0	0
17	31624119	.	A	T	4	4	8	0	1	9	0	0
17	31624604	.	A	G	10	9	19	0	0	19	0	0
17	31624652	.	C	T	0	7	7	0	11	18	0	0
17	31624682	.	A	G	10	9	19	0	1	20	0	0
17	31624716	.	T	A	9	14	23	0	0	23	0	0
17	31628812	.	C	A	1	9	10	0	7	17	0	0
17	31628953	.	G	T	10	6	16	0	0	16	0	0
17	31632288	.	T	C	5	4	9	0	0	9	0	0
17	31632330	.	A	G	9	6	15	0	0	15	0	0
17	31632751	.	C	T	5	8	13	0	1	14	0	0
17	31633027	.	A	G	5	5	10	0	1	11	0	0
17	31633186	.	C	T	12	8	20	0	2	22	0	0
17	31639014	.	C	T	1	2	3	0	9	12	0	0
17	31639721	.	T	C	6	4	10	0	0	10	0	0
17	31668688	.	G	A	4	3	7	0	0	7	0	0
17	31697126	.	G	T	1	2	3	0	0	3	0	0
17	31697158	.	A	G	1	3	4	0	0	4	0	0
17	31699931	.	A	G	2	3	5	0	0	5	0	0
17	31700087	.	T	C	4	4	8	0	0	8	0	0
17	31704999	.	G	A	4	5	9	0	0	9	0	0
17	31711974	.	G	T	3	4	7	0	0	7	0	0
17	31721451	.	G	A	0	8	8	0	5	13	0	0
17	31739475	.	C	T	12	6	18	0	0	18	0	0
17	31743088	.	T	C	4	6	10	0	0	10	0	0
17	31743419	.	T	C	2	2	4	0	0	4	0	0
17	31744553	.	G	A	1	8	9	0	5	14	0	0
17	31744849	.	C	T	1	6	7	0	0	7	0	0
17	31745597	.	C	A	4	7	11	0	0	11	0	0
17	31746341	.	T	A	13	10	23	0	3	26	0	0
17	31746553	.	T	C	11	10	21	0	1	22	0	0
17	31746833	.	G	A	7	11	18	0	0	18	0	0
17	31796240	.	C	T	12	9	21	0	1	22	0	0
17	31796481	.	T	G	13	8	21	0	2	23	0	0
17	31796576	.	G	A	9	4	13	0	2	15	0	0
17	31796821	.	T	A	7	7	14	0	0	14	0	0
17	31806207	.	A	T	2	4	6	0	0	6	0	0
17	31806994	.	T	A	8	4	12	0	2	14	0	0
17	31807063	.	G	A	7	3	10	0	0	10	0	0
17	31807085	.	G	A	4	4	8	0	0	8	0	0
17	31809546	.	G	T	2	5	7	0	0	7	0	0
17	31820605	.	T	C	12	9	21	0	0	21	0	0
17	31935226	.	C	T	3	3	6	0	0	6	0	0
17	31935600	.	T	C	3	2	5	0	0	5	0	0
17	31935889	.	A	G	2	4	6	0	0	6	0	0
17	32322173	.	T	G	3	2	5	0	0	5	0	0
17	32322192	.	T	C	4	2	6	0	0	6	0	0
17	32332491	.	C	G	2	3	5	0	0	5	0	0
17	32333693	.	T	A	1	3	4	0	0	4	0	0
17	32333694	.	T	G	1	3	4	0	0	4	0	0
17	32359449	.	T	C	2	2	4	0	0	4	0	0
17	32366387	.	A	G	4	8	12	0	1	13	0	0
17	32366543	.	A	G	6	4	10	0	0	10	0	0
17	32367193	.	A	G	2	3	5	0	0	5	0	0
17	32367238	.	A	C	2	7	9	0	0	9	0	0
17	32401112	.	T	A	1	2	3	0	0	3	0	0
17	32500495	.	G	A	29	17	46	0	7	53	0	0
17	32503110	.	G	A	2	32	34	1	34	69	0	0
17	32516973	.	T	C	34	23	57	0	2	59	0	0
17	32524654	.	C	T	30	21	51	0	2	53	0	0
17	32524851	.	T	G	38	36	74	0	2	76	0	0
17	32532056	.	A	G	2	1	3	0	1	4	0	0
17	32532062	.	A	C	3	2	5	0	0	5	0	0
17	32532099	.	G	A	0	2	2	0	1	3	0	0
17	32532794	.	G	T	2	2	4	0	1	5	0	0
17	32532795	.	C	T	2	3	5	0	0	5	0	0
17	32535977	.	T	C	4	3	7	0	0	7	0	0
17	32536067	.	G	C	4	2	6	0	1	7	0	0
17	32536401	.	C	T	4	2	6	0	0	6	0	0
17	32538638	.	A	G	4	2	6	0	0	6	0	0
17	32542518	.	A	C	2	4	6	0	0	6	0	0
17	32542884	.	C	T	4	4	8	0	0	8	0	0
17	32549402	.	T	C	3	7	10	0	0	10	0	0
17	32549416	.	G	A	4	5	9	0	0	9	0	0
17	32612329	.	G	A	1	2	3	0	0	3	0	0
17	32623004	.	T	G	17	1	18	0	12	30	0	0
17	32623009	.	T	G	17	12	29	0	1	30	0	0
17	32624451	.	C	T	9	13	22	0	1	23	0	0
17	32624460	.	T	C	5	13	18	0	1	19	0	0
17	32624653	.	A	C	10	9	19	0	0	19	0	0
17	32624668	.	A	T	6	6	12	0	2	14	0	0
17	32624707	.	T	C	7	3	10	0	1	11	0	0
17	32624725	.	C	T	6	4	10	0	0	10	0	0
17	32624910	.	T	C	12	9	21	0	0	21	0	0
17	32624916	.	A	T	12	8	20	0	0	20	0	0
17	32629918	.	G	T	23	6	29	0	1	30	0	0
17	32631400	.	C	T	12	6	18	0	1	19	0	0
17	32631513	.	A	T	15	6	21	0	0	21	0	0
17	32631533	.	A	G	12	12	24	0	0	24	0	0
17	32631560	.	G	T	11	19	30	0	0	30	0	0
17	32631603	.	C	G	7	17	24	0	0	24	0	0
17	32634254	.	C	T	8	8	16	0	1	17	0	0
17	32636025	.	A	T	3	6	9	0	1	10	0	0
17	32636179	.	T	C	4	0	4	0	5	9	0	0
17	33306088	.	A	G	2	5	7	0	1	8	0	0
17	33306121	.	A	G	2	9	11	0	0	11	0	0
17	34105333	.	G	A	0	13	13	0	6	19	0	0
17	34141488	.	T	G	10	6	16	0	1	17	0	0
17	34157059	.	T	C	14	8	22	0	1	23	0	0
17	34158945	.	G	A	7	8	15	0	1	16	0	0
17	34162932	.	G	C	14	14	28	0	1	29	0	0
17	34173297	.	C	T	18	14	32	1	0	33	0	0
17	34182672	.	G	A	2	12	14	0	12	26	0	0
17	34182949	.	C	T	20	9	29	0	0	29	0	0
17	34183002	.	T	C	19	12	31	0	0	31	0	0
17	34183320	.	T	G	37	28	65	0	4	70	1	0
17	34183497	.	T	C	20	15	35	0	5	40	0	0
17	34183512	.	A	T	22	13	35	0	6	41	0	0
17	34244437	.	G	T	12	8	20	0	0	20	0	0
17	34246289	.	T	C	3	7	10	0	0	10	0	0
17	34246295	.	A	G	3	7	10	0	0	10	0	0
17	34254065	.	A	G	5	7	12	0	0	12	0	0
17	34807498	.	T	A	22	21	43	0	1	44	0	0
17	34807781	.	C	T	5	2	7	0	3	10	0	0
17	34807836	.	A	C	7	5	12	0	0	12	0	0
17	34807961	.	G	A	6	3	9	0	0	9	0	0
17	34808024	.	T	C	6	5	11	0	0	11	0	0
17	34970088	.	A	G	2	4	6	0	0	6	0	0
17	35189322	.	T	C	3	8	11	0	1	12	0	0
17	35193156	.	C	T	3	3	6	0	0	6	0	0
17	35198102	.	C	T	3	6	9	0	0	9	0	0
17	35198161	.	T	A	3	5	8	0	0	8	0	0
17	35198221	.	G	A	0	6	6	0	1	7	0	0
17	35199296	.	A	G	2	1	3	0	3	6	0	0
17	35203236	.	T	C	4	4	8	0	0	8	0	0
17	35203398	.	T	C	4	2	6	0	0	6	0	0
17	35208080	.	T	C	4	4	8	0	2	10	0	0
17	35210724	.	T	C	3	11	14	0	0	14	0	0
17	35210811	.	T	C	9	13	22	0	0	22	0	0
17	35210853	.	A	G	5	13	18	0	1	19	0	0
17	35210868	.	C	A	6	10	16	0	0	16	0	0
17	35213989	.	G	A	7	12	19	0	0	19	0	0
17	35222582	.	G	A	1	9	10	0	4	14	0	0
17	35222762	.	C	A	6	6	12	0	1	13	0	0
17	35222864	.	G	A	9	10	19	0	1	20	0	0
17	35222883	.	T	C	10	9	19	0	0	19	0	0
17	35222994	.	A	T	10	7	17	0	2	19	0	0
17	35223051	.	A	T	7	10	17	0	1	18	0	0
17	35223057	.	A	G	6	9	15	0	1	16	0	0
17	35223151	.	T	C	6	5	11	0	0	11	0	0
17	35223195	.	C	T	8	5	13	0	0	13	0	0
17	35223368	.	G	A	1	8	9	0	7	16	0	0
17	35226377	.	G	A	11	7	18	0	0	18	0	0
17	35229163	.	T	A	9	7	16	0	0	16	0	0
17	35244404	.	C	G	2	3	5	0	0	5	0	0
17	35244431	.	T	C	3	6	9	0	0	9	0	0
17	35246383	.	G	A	1	3	4	0	0	4	0	0
17	35247203	.	G	A	2	2	4	0	0	4	0	0
17	35247838	.	T	C	11	14	25	0	1	26	0	0
17	35248038	.	C	T	8	10	18	0	0	18	0	0
17	35248121	.	T	A	5	8	13	1	2	16	0	0
17	35248264	.	G	A	12	5	17	0	1	18	0	0
17	35248577	.	T	C	3	5	8	0	0	8	0	0
17	35248589	.	T	C	2	3	5	0	0	5	0	0
17	35248989	.	A	T	1	2	3	0	0	3	0	0
17	35249136	.	G	A	4	2	6	0	0	6	0	0
17	35249141	.	T	G	4	2	6	0	0	6	0	0
17	35249206	.	C	A	2	4	6	0	0	6	0	0
17	35249230	.	T	G	5	2	7	0	0	7	0	0
17	35249422	.	A	C	16	9	25	0	0	25	0	0
17	35249688	.	A	G	9	4	13	0	1	14	0	0
17	35249795	.	T	C	8	0	8	0	8	16	0	0
17	35250060	.	C	A	0	8	8	0	4	12	0	0
17	35250300	.	C	T	9	16	25	0	0	25	0	0
17	35250328	.	G	A	14	13	27	0	2	29	0	0
17	35260787	.	A	G	4	2	6	0	0	6	0	0
17	35261077	.	T	C	6	3	9	0	0	9	0	0
17	35267038	.	G	T	4	3	7	0	1	8	0	0
17	35267068	.	A	T	5	3	8	0	1	9	0	0
17	35269992	.	A	G	6	4	10	0	0	10	0	0
17	35275631	.	T	C	4	0	4	0	4	8	0	0
17	35275904	.	T	A	3	3	6	0	1	7	0	0
17	35276147	.	C	G	3	7	10	0	3	13	0	0
17	35278679	.	A	G	3	6	9	0	0	9	0	0
17	35287371	.	C	T	7	6	13	0	0	13	0	0
17	35287600	.	A	G	1	2	3	0	0	3	0	0
17	35287621	.	C	T	4	5	9	0	0	9	0	0
17	35295189	.	G	A	1	3	4	0	0	4	0	0
17	35302531	.	G	T	2	2	4	0	0	4	0	0
17	35360486	.	T	A	4	4	8	0	0	8	0	0
17	35360516	.	G	A	3	2	5	0	0	5	0	0
17	35881126	.	G	T	19	20	39	0	4	43	0	0
17	35881148	.	T	C	16	16	32	0	2	34	0	0
17	36489654	.	A	C	0	2	2	0	1	3	0	0
17	36588754	.	C	T	4	4	8	0	2	10	0	0
17	36589295	.	C	T	8	3	11	1	2	14	0	0
17	36589435	.	C	A	4	5	9	0	0	9	0	0
17	36589554	.	G	A	2	2	4	0	4	8	0	0
17	36867298	.	C	T	0	9	9	0	15	24	0	0
17	36867355	.	T	C	12	10	22	0	1	23	0	0
17	36867450	.	T	C	9	8	17	0	1	18	0	0
17	36867471	.	G	A	8	13	21	0	2	23	0	0
17	36867558	.	T	C	11	0	11	0	10	21	0	0
17	36867568	.	A	G	9	12	21	0	1	22	0	0
17	36867738	.	T	C	13	1	14	0	6	20	0	0
17	36867915	.	A	G	19	13	32	0	0	32	0	0
17	36867945	.	T	C	10	0	10	0	21	31	0	0
17	36867951	.	A	G	13	17	30	0	1	31	0	0
17	36872564	.	C	T	3	10	13	0	7	20	0	0
17	36884529	.	A	G	7	14	21	0	0	21	0	0
17	36896480	.	C	T	13	6	19	0	0	19	0	0
17	36899746	.	A	T	22	17	39	0	1	40	0	0
17	36899760	.	T	A	23	18	41	0	0	41	0	0
17	36899853	.	T	C	21	21	42	0	2	44	0	0
17	36905905	.	A	G	23	15	38	0	1	39	0	0
17	36905998	.	A	G	24	16	40	1	2	43	0	0
17	36906007	.	G	C	24	0	24	1	19	44	0	0
17	36909904	.	C	T	2	18	20	0	13	33	0	0
17	36911113	.	T	C	26	1	27	0	19	46	0	0
17	36914689	.	C	T	2	9	11	0	14	25	0	0
17	36915353	.	A	G	12	9	21	0	2	23	0	0
17	36929111	.	T	C	15	10	25	0	0	25	0	0
17	36929198	.	C	T	17	12	29	0	1	30	0	0
17	36937975	.	G	A	27	14	41	0	1	42	0	0
17	36938035	.	C	T	17	14	31	0	0	31	0	0
17	36938761	.	T	A	17	14	31	0	0	31	0	0
17	36938819	.	G	A	12	16	28	0	0	28	0	0
17	36938979	.	A	G	8	9	17	0	1	18	0	0
17	36939029	.	A	G	8	12	20	0	1	21	0	0
17	36939064	.	A	G	9	12	21	0	0	21	0	0
17	36939400	.	T	A	5	4	9	0	1	10	0	0
17	36939493	.	G	A	6	4	10	0	1	11	0	0
17	36939574	.	A	G	10	9	19	0	0	19	0	0
17	36939698	.	G	C	13	10	23	0	1	24	0	0
17	36939736	.	C	T	14	10	24	0	1	25	0	0
17	36940074	.	T	C	12	4	16	0	2	18	0	0
17	36940236	.	T	C	6	0	6	0	7	13	0	0
17	36940424	.	C	A	4	7	11	0	0	11	0	0
17	36940451	.	G	A	2	4	6	0	0	6	0	0
17	36940974	.	T	G	2	5	7	0	2	9	0	0
17	36940977	.	T	C	7	5	12	0	0	12	0	0
17	36941065	.	C	T	13	3	16	1	2	19	0	0
17	36941121	.	A	C	8	5	13	1	1	15	0	0
17	36941291	.	C	T	1	6	7	0	10	17	0	0
17	36941523	.	A	G	8	3	11	0	2	13	0	0
17	36941788	.	G	T	6	4	10	0	0	10	0	0
17	36941812	.	G	A	6	4	10	0	0	10	0	0
17	36947137	.	T	C	10	3	13	0	0	13	0	0
17	36947218	.	G	A	4	5	9	0	0	9	0	0
17	36951602	.	C	A	9	3	12	0	0	12	0	0
17	36956946	.	A	G	4	2	6	0	0	6	0	0
17	36957029	.	T	C	4	3	7	0	0	7	0	0
17	36962179	.	G	A	6	3	9	0	0	9	0	0
17	36970705	.	A	G	8	4	12	0	0	12	0	0
17	36970937	.	T	C	9	4	13	0	0	13	0	0
17	37013465	.	A	G	4	4	8	0	0	8	0	0
17	37070262	.	G	C	12	3	15	0	0	15	0	0
17	37070310	.	G	A	7	3	10	0	0	10	0	0
17	37070497	.	T	C	11	0	11	0	10	21	0	0
17	37070550	.	C	G	12	13	25	0	1	27	1	0
17	37073530	.	G	A	10	9	19	0	0	19	0	0
17	37076276	.	C	A	1	8	9	0	13	22	0	0
17	37086637	.	A	T	16	15	31	0	2	33	0	0
17	37086670	.	C	T	0	15	15	0	14	29	0	0
17	37088463	.	T	C	9	0	9	0	9	18	0	0
17	37088514	.	G	A	10	18	28	0	0	28	0	0
17	37134165	.	G	T	9	13	22	0	0	22	0	0
17	37143651	.	A	G	11	9	20	0	0	20	0	0
17	37143669	.	C	G	13	11	24	0	0	24	0	0
17	37156496	.	G	T	7	7	14	0	0	14	0	0
17	37156512	.	T	A	6	5	11	0	0	11	0	0
17	37162645	.	G	T	1	3	4	0	1	5	0	0
17	37162878	.	A	G	3	2	5	0	0	5	0	0
17	37162953	.	A	T	2	5	7	0	0	7	0	0
17	37163699	.	A	G	1	2	3	0	1	4	0	0
17	37164035	.	G	A	2	3	5	0	0	5	0	0
17	37164182	.	A	G	4	4	8	0	0	8	0	0
17	37164754	.	T	C	2	0	2	0	2	4	0	0
17	37165483	.	C	G	3	2	5	0	0	5	0	0
17	37165516	.	C	T	1	2	3	0	0	3	0	0
17	37183710	.	G	A	1	1	2	0	1	3	0	0
17	37195040	.	G	A	2	2	4	0	0	4	0	0
17	37204273	.	A	C	5	6	11	0	0	11	0	0
17	37204417	.	G	A	17	17	34	0	0	34	0	0
17	37204484	.	T	C	16	0	16	0	19	35	0	0
17	37210305	.	C	T	1	20	21	0	27	48	0	0
17	37212127	.	A	G	12	11	23	0	1	24	0	0
17	37212154	.	T	C	11	15	26	0	0	26	0	0
17	37212485	.	T	A	11	17	28	0	2	30	0	0
17	37212592	.	T	G	12	16	28	0	0	28	0	0
17	37212616	.	G	T	9	21	30	0	0	30	0	0
17	37212634	.	C	T	9	18	27	0	1	28	0	0
17	37212725	.	T	C	17	16	33	0	0	33	0	0
17	37212757	.	T	C	22	15	37	0	0	37	0	0
17	37212832	.	G	A	11	11	22	0	1	23	0	0
17	37213231	.	C	T	12	13	25	0	1	26	0	0
17	37213416	.	G	T	5	9	14	0	0	14	0	0
17	37213887	.	G	A	10	13	23	0	1	24	0	0
17	37213900	.	C	A	10	16	26	0	0	26	0	0
17	37213928	.	T	C	12	11	23	0	2	25	0	0
17	37213999	.	A	G	17	11	28	0	1	29	0	0
17	37214022	.	C	T	15	10	25	0	2	27	0	0
17	37228020	.	C	A	3	9	12	0	0	12	0	0
17	37230921	.	G	A	1	2	3	0	1	4	0	0
17	37230939	.	T	C	5	2	7	0	0	7	0	0
17	37237230	.	T	C	8	5	13	0	1	14	0	0
17	37239402	.	T	G	6	6	12	0	0	12	0	0
17	37239981	.	C	T	9	17	26	0	0	26	0	0
17	37241661	.	A	G	10	12	22	1	0	23	0	0
17	37241676	.	T	G	9	0	9	1	11	21	0	0
17	37241700	.	C	T	7	8	15	0	0	15	0	0
17	37252299	.	T	A	10	7	17	0	4	21	0	0
17	37252352	.	G	A	7	10	17	0	1	18	0	0
17	37252374	.	G	T	0	11	11	0	16	27	0	0
17	37252441	.	A	T	10	8	18	0	3	21	0	0
17	37252716	.	G	A	3	12	15	0	5	20	0	0
17	37253832	.	C	G	2	0	2	0	6	8	0	0
17	37263068	.	T	C	1	2	3	0	0	3	0	0
17	37263101	.	T	G	1	0	1	0	3	4	0	0
17	37267740	.	A	G	3	0	3	0	3	6	0	0
17	37268036	.	A	G	3	3	6	0	0	6	0	0
17	37268063	.	A	G	3	4	7	0	0	7	0	0
17	37273585	.	C	T	3	3	6	0	0	6	0	0
17	37280857	.	A	C	3	2	5	0	0	5	0	0
17	37280860	.	A	G	3	2	5	0	1	6	0	0
17	37280950	.	A	T	3	4	7	0	0	7	0	0
17	37280974	.	C	T	1	6	7	0	0	7	0	0
17	37281303	.	A	C	2	4	6	0	0	6	0	0
17	37281309	.	G	A	3	3	6	0	0	6	0	0
17	37291158	.	T	A	7	3	10	0	0	10	0	0
17	37291504	.	T	C	4	2	6	0	0	6	0	0
17	37299334	.	G	T	2	3	5	0	1	6	0	0
17	37316713	.	C	T	2	2	4	0	0	4	0	0
17	37316719	.	C	T	3	2	5	0	0	5	0	0
17	37317028	.	T	A	1	4	5	0	0	5	0	0
17	37317165	.	A	G	1	1	2	0	1	3	0	0
17	37317171	.	A	T	2	2	4	0	0	4	0	0
17	37317636	.	G	A	3	3	6	0	0	6	0	0
17	37317809	.	T	C	5	4	9	0	2	11	0	0
17	37317922	.	G	A	2	2	4	0	2	6	0	0
17	37317945	.	A	G	3	3	6	0	0	6	0	0
17	37318011	.	A	G	2	4	6	0	0	6	0	0
17	37320150	.	C	G	7	8	15	0	0	15	0	0
17	37320153	.	T	C	7	9	16	0	0	16	0	0
17	37323060	.	T	G	5	0	5	0	11	17	1	0
17	37323168	.	G	A	0	5	5	0	5	10	0	0
17	37350708	.	C	T	9	3	12	0	1	13	0	0
17	37352961	.	C	A	2	7	9	0	1	10	0	0
17	37353043	.	T	C	5	7	12	0	0	12	0	0
17	37361173	.	G	A	1	3	4	0	0	4	0	0
17	37361233	.	C	T	4	8	12	0	0	12	0	0
17	37361349	.	C	T	5	6	11	0	0	11	0	0
17	37361556	.	T	A	3	8	11	1	1	13	0	0
17	37361605	.	G	A	0	5	5	0	3	8	0	0
17	37361669	.	C	T	5	2	7	0	0	7	0	0
17	37362139	.	C	G	6	2	8	0	1	9	0	0
17	37362153	.	G	T	7	3	10	0	0	10	0	0
17	37362181	.	C	T	4	4	8	0	0	8	0	0
17	37362198	.	C	T	4	2	6	0	0	6	0	0
17	37362249	.	G	A	4	3	7	0	1	8	0	0
17	37362258	.	T	A	4	4	8	0	0	8	0	0
17	37362298	.	C	G	3	6	9	0	1	10	0	0
17	37362380	.	C	A	3	3	6	1	0	7	0	0
17	37362506	.	T	C	1	2	3	0	0	3	0	0
17	37362574	.	T	A	2	7	9	0	0	9	0	0
17	37363309	.	C	G	2	4	6	0	0	6	0	0
17	37363406	.	G	C	3	4	7	0	1	8	0	0
17	37363802	.	T	A	7	10	17	0	0	17	0	0
17	37363809	.	C	T	7	10	17	0	0	17	0	0
17	37363938	.	A	G	4	0	4	0	4	8	0	0
17	37364061	.	G	T	4	10	14	0	0	14	0	0
17	37364517	.	C	T	8	14	22	0	0	22	0	0
17	37364533	.	T	C	11	10	21	0	1	22	0	0
17	37364620	.	C	T	8	9	17	0	0	17	0	0
17	37364676	.	A	C	6	9	15	0	0	15	0	0
17	37365020	.	A	G	11	14	25	0	0	25	0	0
17	37385920	.	T	A	2	2	4	0	1	5	0	0
17	37388782	.	G	A	2	6	8	0	0	8	0	0
17	37446790	.	A	C	16	3	19	0	4	23	0	0
17	38887156	.	C	T	1	2	3	0	2	5	0	0
17	38887271	.	T	G	3	5	8	0	1	9	0	0
17	38927932	.	T	C	8	3	11	0	1	12	0	0
17	38928073	.	A	T	1	6	7	0	0	7	0	0
17	38928775	.	C	T	4	3	7	0	0	7	0	0
17	38928947	.	A	T	2	3	5	0	1	6	0	0
17	38929142	.	T	G	6	5	11	0	0	11	0	0
17	38929437	.	C	T	3	4	7	0	0	7	0	0
17	38946528	.	G	A	1	3	4	0	0	4	0	0
17	39703380	.	C	A	3	3	6	0	0	6	0	0
17	39707421	.	C	T	3	4	7	0	0	7	0	0
17	39717616	.	T	C	5	5	10	0	1	11	0	0
17	39717645	.	A	G	5	0	5	0	6	11	0	0
17	39720791	.	T	C	5	7	12	0	1	13	0	0
17	39728239	.	C	T	6	15	21	0	0	21	0	0
17	39728261	.	G	T	4	16	20	0	1	21	0	0
17	39728423	.	T	A	10	12	22	0	0	22	0	0
17	39729014	.	G	A	7	11	18	0	0	18	0	0
17	39732512	.	C	T	10	15	25	0	0	25	0	0
17	39732573	.	C	A	9	9	18	0	0	18	0	0
17	39732584	.	G	A	6	7	13	0	1	14	0	0
17	39736088	.	T	A	15	6	21	0	1	22	0	0
17	39736103	.	G	A	16	6	22	0	0	22	0	0
17	39736130	.	T	C	11	6	17	0	2	19	0	0
17	39739842	.	A	T	4	8	12	0	2	14	0	0
17	39863633	.	C	T	4	4	8	1	0	9	0	0
17	40223456	.	G	A	3	6	9	0	0	9	0	0
17	40223457	.	G	A	3	6	9	0	0	9	0	0
17	40883361	.	T	A	5	2	7	0	1	8	0	0
17	40883596	.	C	T	5	4	9	0	0	9	0	0
17	40887272	.	T	C	2	4	6	0	0	6	0	0
17	40888907	.	A	C	4	3	7	0	0	7	0	0
17	40888909	.	G	C	2	3	5	0	2	7	0	0
17	40889697	.	A	G	4	2	6	0	0	6	0	0
17	40890396	.	C	T	2	4	6	0	0	6	0	0
17	40890433	.	G	A	1	6	7	0	0	7	0	0
17	40890443	.	C	T	2	5	7	0	0	7	0	0
17	40893919	.	A	T	5	3	8	0	0	8	0	0
17	40899489	.	A	C	2	3	5	0	0	5	0	0
17	40900354	.	C	T	2	2	4	0	1	5	0	0
17	40900465	.	T	C	3	2	5	0	1	6	0	0
17	40900686	.	T	G	3	3	6	0	1	7	0	0
17	40901609	.	G	A	5	6	11	0	0	11	0	0
17	40901695	.	G	C	6	10	16	0	0	16	0	0
17	40901712	.	C	G	6	11	17	0	1	18	0	0
17	40901752	.	G	A	3	7	10	0	0	10	0	0
17	40902005	.	C	A	9	5	14	1	4	19	0	0
17	40902065	.	G	A	2	4	6	0	1	7	0	0
17	40902148	.	G	T	3	6	9	0	0	9	0	0
17	40902256	.	G	T	5	4	9	0	0	9	0	0
17	40902297	.	A	G	3	10	13	0	0	13	0	0
17	40902347	.	C	T	10	7	17	0	0	17	0	0
17	40902368	.	T	G	7	7	14	0	1	15	0	0
17	40902598	.	G	A	8	6	14	0	0	14	0	0
17	40902629	.	A	T	5	8	13	0	0	13	0	0
17	40902657	.	A	C	9	4	13	0	0	13	0	0
17	40902724	.	A	G	11	0	11	0	9	20	0	0
17	40902830	.	A	T	9	12	21	0	0	21	0	0
17	40903162	.	C	T	5	3	8	0	0	8	0	0
17	40932307	.	A	G	2	2	4	0	0	4	0	0
17	40955529	.	G	C	2	2	4	0	0	4	0	0
17	40955577	.	A	T	1	2	3	0	0	3	0	0
17	40990061	.	T	A	9	20	29	0	0	29	0	0
17	40990097	.	T	A	18	14	32	0	0	32	0	0
17	40999460	.	A	G	15	10	25	0	2	27	0	0
17	40999697	.	C	G	8	6	14	0	0	14	0	0
17	40999700	.	C	A	8	6	14	0	0	14	0	0
17	40999732	.	A	G	5	8	13	0	0	13	0	0
17	41084623	.	C	T	7	4	11	0	0	11	0	0
17	41084670	.	T	C	6	7	13	0	1	14	0	0
17	41092465	.	C	T	8	3	11	0	0	11	0	0
17	41121783	.	C	G	7	6	13	0	1	14	0	0
17	41220064	.	T	A	5	2	7	0	0	7	0	0
17	41254741	.	C	T	8	7	15	0	2	17	0	0
17	41264045	.	T	A	6	9	15	0	0	15	0	0
17	41264054	.	G	A	7	6	13	0	0	13	0	0
17	41264165	.	C	A	8	4	12	0	0	12	0	0
17	41314040	.	G	T	1	5	6	0	11	17	0	0
17	41314097	.	T	C	10	11	21	0	1	22	0	0
17	41314471	.	G	A	11	7	18	0	1	19	0	0
17	41314501	.	A	G	2	10	12	1	0	13	0	0
17	41317234	.	A	G	5	0	5	0	11	16	0	0
17	41317494	.	G	A	11	11	22	0	5	27	0	0
17	41317999	.	G	A	16	13	29	0	3	32	0	0
17	41318310	.	A	G	14	7	21	0	0	21	0	0
17	41318392	.	G	A	3	2	5	0	0	5	0	0
17	41364799	.	G	T	1	2	3	0	0	3	0	0
17	41368111	.	T	A	1	3	4	0	0	4	0	0
17	41368114	.	C	T	1	3	4	0	0	4	0	0
17	41368768	.	A	G	2	0	2	0	2	4	0	0
17	41464090	.	G	A	2	4	6	0	5	11	0	0
17	41465504	.	A	C	9	8	17	0	0	17	0	0
17	41465922	.	G	A	3	3	6	0	0	6	0	0
17	41475863	.	T	C	8	18	26	0	0	26	0	0
17	41476104	.	T	C	13	0	13	0	23	36	0	0
17	41476161	.	A	G	16	20	36	0	4	40	0	0
17	41476279	.	G	A	21	17	38	0	0	38	0	0
17	41476298	.	T	A	20	14	34	0	1	35	0	0
17	41476393	.	G	T	13	4	17	0	3	20	0	0
17	41476833	.	T	C	3	5	8	0	1	9	0	0
17	41476906	.	A	C	9	0	9	0	8	17	0	0
17	41476917	.	C	T	1	7	8	0	10	18	0	0
17	41476970	.	T	C	10	7	17	0	0	17	0	0
17	41476994	.	G	A	8	9	17	0	0	17	0	0
17	41477007	.	C	T	0	8	8	0	9	17	0	0
17	41477157	.	T	C	6	8	14	0	2	16	0	0
17	41477324	.	G	A	9	7	16	0	1	17	0	0
17	41558269	.	G	C	6	4	10	0	0	10	0	0
17	41571328	.	T	A	10	5	15	0	1	16	0	0
17	41583555	.	C	G	2	6	8	0	3	11	0	0
17	41583747	.	G	T	12	6	18	0	2	20	0	0
17	41583768	.	T	C	3	0	3	0	14	17	0	0
17	41583786	.	A	G	6	10	16	0	0	16	0	0
17	41601633	.	G	A	3	3	6	1	0	7	0	0
17	41601916	.	G	A	7	6	13	0	0	13	0	0
17	41610991	.	G	A	1	4	5	0	0	5	0	0
17	41631083	.	C	A	0	2	2	0	1	3	0	0
17	41659641	.	C	T	1	2	3	0	1	4	0	0
17	41798753	.	C	T	2	2	4	0	0	4	0	0
17	41992262	.	T	G	5	0	5	1	3	9	0	0
17	41994768	.	G	T	3	5	8	0	0	8	0	0
17	41994868	.	A	G	1	0	1	0	7	8	0	0
17	42027915	.	C	T	4	7	11	0	0	11	0	0
17	42030083	.	A	G	12	0	12	0	9	21	0	0
17	42032119	.	T	C	12	5	17	0	0	17	0	0
17	42095539	.	A	T	1	3	4	0	0	4	0	0
17	42096960	.	C	G	0	4	4	0	3	7	0	0
17	42871419	.	G	T	17	10	27	0	4	31	0	0
17	43013675	.	G	A	40	23	63	0	1	64	0	0
17	43017672	.	C	T	14	12	26	0	3	29	0	0
17	43017687	.	G	A	17	11	28	0	1	29	0	0
17	43017830	.	A	G	11	6	17	0	0	17	0	0
17	43017863	.	A	C	13	6	19	0	2	21	0	0
17	43018037	.	G	A	4	9	13	0	13	26	0	0
17	43018124	.	A	G	23	0	23	0	10	33	0	0
17	43018273	.	G	A	13	20	33	0	3	36	0	0
17	43018382	.	T	G	18	18	36	0	2	38	0	0
17	43018502	.	T	A	19	19	38	0	0	38	0	0
17	43018638	.	A	T	25	11	36	0	1	37	0	0
17	43018815	.	A	G	15	17	32	0	2	34	0	0
17	43018899	.	T	A	15	21	36	0	0	36	0	0
17	43030696	.	T	C	4	3	7	0	0	7	0	0
17	43030737	.	T	G	9	11	20	0	0	20	0	0
17	43030828	.	G	A	12	6	18	0	1	19	0	0
17	43031495	.	G	A	9	3	12	0	0	12	0	0
17	43033177	.	G	A	7	18	25	0	4	29	0	0
17	43035798	.	T	C	11	25	36	0	1	37	0	0
17	43035996	.	G	T	15	10	25	0	2	27	0	0
17	43036025	.	A	G	9	12	21	0	1	22	0	0
17	43040422	.	T	A	4	5	9	0	1	10	0	0
17	43075560	.	G	T	3	2	5	0	0	5	0	0
17	43075561	.	G	A	3	2	5	0	0	5	0	0
17	43082871	.	G	A	1	4	5	0	1	6	0	0
17	43082976	.	A	T	6	8	14	0	0	14	0	0
17	43087252	.	A	T	2	3	5	0	0	5	0	0
17	43104590	.	T	A	3	4	7	0	2	9	0	0
17	43146607	.	G	C	2	2	4	0	0	4	0	0
17	43220001	.	A	G	1	2	3	0	0	3	0	0
17	43297946	.	G	C	8	17	25	0	1	26	0	0
17	43298011	.	G	A	16	11	27	0	1	28	0	0
17	43298068	.	G	A	11	7	18	0	1	19	0	0
17	43302492	.	G	A	12	6	18	0	1	19	0	0
17	43309095	.	A	G	11	10	21	0	0	21	0	0
17	43309164	.	C	T	0	10	10	0	8	18	0	0
17	43315085	.	C	T	9	7	16	0	0	16	0	0
17	43391434	.	G	T	3	4	7	0	1	8	0	0
17	43391442	.	C	T	5	6	11	0	0	11	0	0
17	43436782	.	T	C	30	2	32	1	20	53	0	0
17	43437305	.	G	C	40	18	58	1	1	60	0	0
17	43437365	.	C	G	31	26	57	0	1	58	0	0
17	43439720	.	G	T	18	24	42	1	4	47	0	0
17	43441575	.	A	T	26	15	41	0	0	41	0	0
17	43453507	.	T	C	13	14	27	0	1	28	0	0
17	43453531	.	G	A	11	10	21	0	1	22	0	0
17	43456825	.	C	T	7	18	25	0	1	26	0	0
17	43456900	.	G	A	12	8	20	0	0	20	0	0
17	43456921	.	T	C	8	12	20	0	0	20	0	0
17	43461181	.	G	A	11	5	16	0	2	18	0	0
17	43469204	.	A	C	10	7	17	0	0	17	0	0
17	43469377	.	G	A	6	9	15	0	2	17	0	0
17	43473913	.	T	C	14	14	28	0	0	28	0	0
17	43475577	.	G	A	0	9	9	0	9	18	0	0
17	43475619	.	A	G	11	0	11	0	9	20	0	0
17	43475691	.	T	A	4	5	9	0	1	10	0	0
17	43475712	.	A	G	1	0	1	0	4	5	0	0
17	43476046	.	C	T	5	3	8	0	0	8	0	0
17	43476137	.	T	A	4	8	12	0	0	12	0	0
17	43497404	.	A	T	3	11	14	0	1	15	0	0
17	43513109	.	G	A	15	9	24	0	1	25	0	0
17	43516464	.	T	A	10	3	13	0	0	13	0	0
17	43516502	.	G	T	6	4	10	0	2	12	0	0
17	43516506	.	A	C	8	5	13	0	0	13	0	0
17	43516548	.	A	G	9	12	21	0	0	21	0	0
17	43516579	.	T	C	6	0	6	0	14	20	0	0
17	43520103	.	G	A	1	5	6	0	0	6	0	0
17	43520136	.	G	A	1	4	5	0	0	5	0	0
17	43522776	.	A	G	6	3	9	0	0	9	0	0
17	43522782	.	T	C	3	0	3	0	5	8	0	0
17	43537865	.	C	T	7	9	16	0	0	16	0	0
17	43538018	.	A	C	8	7	15	0	0	15	0	0
17	43538035	.	C	T	0	7	7	0	8	15	0	0
17	43538081	.	G	A	6	6	12	0	0	12	0	0
17	43538097	.	C	T	5	5	10	0	0	10	0	0
17	43538131	.	G	A	3	5	8	0	0	8	0	0
17	43551547	.	G	T	6	8	14	0	0	14	0	0
17	43551835	.	A	G	3	3	6	0	0	6	0	0
17	43551841	.	G	C	4	2	6	0	0	6	0	0
17	43558275	.	T	A	2	3	5	0	0	5	0	0
17	43565680	.	A	T	4	5	9	0	0	9	0	0
17	43565697	.	C	A	5	5	10	0	1	11	0	0
17	43575585	.	C	A	4	3	7	0	0	7	0	0
17	43575956	.	C	T	2	4	6	0	0	6	0	0
17	43623744	.	T	G	4	2	6	0	0	6	0	0
17	43623882	.	C	A	2	2	4	0	0	4	0	0
17	43623892	.	G	T	1	1	2	0	1	3	0	0
17	43623955	.	G	T	2	2	4	0	0	4	0	0
17	43629223	.	C	T	5	2	7	0	0	7	0	0
17	43629295	.	C	T	3	2	5	0	1	6	0	0
17	43629319	.	C	A	2	6	8	0	0	8	0	0
17	43629342	.	T	C	4	5	9	0	0	9	0	0
17	43629388	.	G	T	2	3	5	0	1	6	0	0
17	43660232	.	G	A	9	16	25	0	0	25	0	0
17	43660779	.	T	C	16	5	21	0	0	21	0	0
17	43661106	.	T	G	7	4	11	0	0	11	0	0
17	43661278	.	A	G	3	1	4	0	1	8	3	0
17	43663611	.	T	G	4	5	9	0	1	10	0	0
17	43663789	.	A	C	17	14	31	0	2	33	0	0
17	43663870	.	G	A	18	18	36	0	4	40	0	0
17	43664128	.	G	C	19	23	42	0	1	43	0	0
17	43664580	.	A	G	10	10	20	0	0	20	0	0
17	43664605	.	G	A	11	6	17	0	2	19	0	0
17	43708546	.	C	T	8	6	14	0	0	14	0	0
17	43708563	.	A	G	6	7	13	0	0	13	0	0
17	43708608	.	C	T	13	6	19	0	0	19	0	0
17	43708649	.	T	C	7	14	21	0	0	21	0	0
17	43711557	.	C	T	0	5	5	0	3	8	0	0
17	43715607	.	C	T	2	3	5	0	0	5	0	0
17	43715851	.	T	C	6	4	10	0	0	10	0	0
17	43716633	.	C	T	3	3	6	0	0	6	0	0
17	43716648	.	T	A	3	3	6	0	0	6	0	0
17	43717878	.	G	T	4	2	6	0	0	6	0	0
17	43851013	.	A	G	13	16	29	0	0	29	0	0
17	43853538	.	G	A	15	19	34	0	2	36	0	0
17	43853767	.	A	G	22	11	33	1	0	34	0	0
17	43853778	.	C	T	1	20	21	1	11	33	0	0
17	43854007	.	G	A	11	9	20	0	1	21	0	0
17	43854010	.	T	G	11	12	23	0	1	24	0	0
17	43856232	.	T	C	7	7	14	0	0	14	0	0
17	43859282	.	T	C	6	10	16	0	0	16	0	0
17	43863609	.	A	C	14	14	28	0	2	30	0	0
17	43863655	.	G	C	7	8	15	0	1	16	0	0
17	43863656	.	C	T	7	9	16	0	0	16	0	0
17	43871440	.	T	A	1	2	3	0	0	3	0	0
17	43926650	.	C	A	5	3	8	0	1	9	0	0
17	43946901	.	C	T	3	6	9	0	0	9	0	0
17	43951868	.	G	T	11	7	18	0	0	18	0	0
17	43952984	.	C	T	4	4	8	0	1	9	0	0
17	43953000	.	G	A	1	4	5	0	5	10	0	0
17	43954926	.	A	C	5	6	11	0	0	11	0	0
17	43987048	.	A	G	11	17	28	0	0	28	0	0
17	43996483	.	G	A	15	19	34	0	3	37	0	0
17	43996485	.	G	A	16	19	35	0	3	38	0	0
17	43996620	.	A	T	22	18	40	0	2	42	0	0
17	43996667	.	G	A	23	16	39	0	3	42	0	0
17	44001540	.	A	G	18	15	33	0	2	35	0	0
17	44001584	.	T	C	20	16	36	0	1	37	0	0
17	44002032	.	A	T	3	10	13	0	5	18	0	0
17	44006088	.	C	T	0	3	3	0	3	6	0	0
17	44006756	.	T	A	2	2	4	0	0	4	0	0
17	44007314	.	G	C	1	0	1	0	2	3	0	0
17	44007316	.	G	T	0	2	2	0	1	3	0	0
17	44007351	.	T	C	4	3	7	0	0	7	0	0
17	44030764	.	T	A	2	1	3	0	1	4	0	0
17	44030943	.	C	T	3	2	5	0	0	5	0	0
17	44171231	.	C	T	1	5	6	0	0	6	0	0
17	44413925	.	C	T	7	3	10	0	0	10	0	0
17	44413980	.	G	A	4	5	9	0	0	10	1	0
17	44414030	.	A	G	6	7	13	0	0	13	0	0
17	44420201	.	G	A	6	5	11	0	1	12	0	0
17	44420406	.	T	C	3	4	7	0	0	7	0	0
17	44422527	.	G	T	2	4	6	0	0	6	0	0
17	44423058	.	G	A	1	3	4	0	0	4	0	0
17	44423059	.	T	C	0	3	3	0	0	3	0	0
17	44430544	.	A	G	2	2	4	0	0	4	0	0
17	44430586	.	C	T	0	3	3	0	2	5	0	0
17	44443817	.	C	A	2	2	4	0	0	4	0	0
17	44443867	.	T	C	2	3	5	0	0	5	0	0
17	44443885	.	A	T	2	1	3	0	1	4	0	0
17	44444017	.	T	G	1	3	4	0	0	4	0	0
17	44444035	.	A	T	1	3	4	0	0	4	0	0
17	44444127	.	C	T	4	2	6	0	0	6	0	0
17	44444188	.	C	T	1	4	5	0	0	5	0	0
17	44444246	.	G	T	2	4	6	0	0	6	0	0
17	44444396	.	G	A	1	2	3	0	1	4	0	0
17	44446397	.	T	C	1	2	3	0	1	4	0	0
17	44446400	.	T	G	1	0	1	0	3	4	0	0
17	44451094	.	A	G	5	3	8	0	0	8	0	0
17	44453771	.	G	A	0	3	3	0	4	7	0	0
17	44463892	.	A	G	3	3	6	0	1	7	0	0
17	44463903	.	G	T	4	3	7	0	0	7	0	0
17	44473954	.	G	C	12	5	17	0	0	17	0	0
17	44474284	.	G	A	4	2	6	0	1	7	0	0
17	44474392	.	A	G	9	6	15	0	0	15	0	0
17	44474445	.	C	A	6	10	16	0	0	16	0	0
17	44474592	.	T	G	6	2	8	1	2	11	0	0
17	44474658	.	A	G	4	0	4	0	12	16	0	0
17	44475047	.	T	G	3	4	7	0	0	7	0	0
17	44475093	.	C	G	5	4	9	0	0	9	0	0
17	44475940	.	C	G	7	3	10	0	0	10	0	0
17	44476075	.	G	T	7	5	12	0	0	12	0	0
17	44502836	.	A	G	2	6	8	0	0	8	0	0
17	44542577	.	A	G	3	4	7	0	0	7	0	0
17	44542598	.	G	C	1	3	4	0	0	4	0	0
17	44756390	.	G	A	0	2	2	0	5	7	0	0
17	44756895	.	A	C	1	2	3	0	0	3	0	0
17	44756986	.	C	T	2	3	5	0	0	5	0	0
17	44760273	.	T	G	3	0	3	0	4	7	0	0
17	44760544	.	C	A	6	2	8	0	0	8	0	0
17	44760618	.	C	T	6	8	14	0	0	14	0	0
17	44760774	.	C	T	5	5	10	0	0	10	0	0
17	44760858	.	A	G	5	4	9	0	0	9	0	0
17	44761011	.	A	G	5	4	9	0	0	9	0	0
17	44761103	.	G	T	2	2	4	0	0	4	0	0
17	44761140	.	G	T	3	2	5	0	0	5	0	0
17	44761349	.	G	A	8	6	14	0	0	14	0	0
17	44761356	.	G	T	7	5	12	0	1	13	0	0
17	44769039	.	T	A	4	2	6	0	0	6	0	0
17	44769379	.	A	G	3	5	8	0	0	8	0	0
17	44770850	.	A	G	3	5	8	0	0	8	0	0
17	44771236	.	C	G	3	2	5	0	0	5	0	0
17	44771353	.	A	C	6	5	11	0	1	12	0	0
17	44775971	.	C	T	4	2	6	0	0	6	0	0
17	44776034	.	T	A	2	3	5	0	0	5	0	0
17	44833808	.	G	A	3	2	5	0	0	5	0	0
17	44857662	.	C	T	1	2	3	0	0	3	0	0
17	44860885	.	C	G	7	2	9	0	0	9	0	0
17	44860887	.	C	A	7	2	9	0	0	9	0	0
17	44862308	.	G	C	5	2	7	0	0	7	0	0
17	44865421	.	G	A	0	4	4	0	2	6	0	0
17	44871033	.	A	T	2	8	10	0	0	10	0	0
17	44873988	.	C	T	3	5	8	0	0	8	0	0
17	44878504	.	G	T	10	3	13	0	1	14	0	0
17	44884946	.	C	T	2	2	4	0	0	4	0	0
17	44884955	.	G	A	0	2	2	0	3	5	0	0
17	44884997	.	C	T	6	3	9	0	0	9	0	0
17	44899562	.	G	A	1	8	9	0	7	16	0	0
17	44911803	.	A	G	7	4	11	0	1	12	0	0
17	44921955	.	G	A	1	8	9	0	6	15	0	0
17	44921992	.	A	G	11	0	11	0	9	20	0	0
17	44922442	.	C	T	7	4	11	0	1	12	0	0
17	44922685	.	G	T	9	9	18	0	1	19	0	0
17	44922743	.	G	A	10	12	22	0	1	23	0	0
17	44922788	.	C	A	9	9	18	0	1	19	0	0
17	44922819	.	A	T	10	9	19	0	0	19	0	0
17	44922866	.	C	T	12	13	25	0	0	25	0	0
17	44923053	.	C	T	2	4	6	0	0	6	0	0
17	44923083	.	T	A	3	6	9	0	0	9	0	0
17	44923322	.	T	A	7	3	10	0	0	10	0	0
17	44923345	.	T	C	5	8	13	0	1	14	0	0
17	44923389	.	G	A	9	4	13	0	0	13	0	0
17	44962056	.	G	A	16	15	31	0	1	32	0	0
17	44962502	.	A	T	2	7	9	0	0	9	0	0
17	44962507	.	A	G	7	3	10	0	0	10	0	0
17	44962575	.	G	T	12	4	16	0	1	17	0	0
17	44962693	.	T	C	7	6	13	0	0	13	0	0
17	44962826	.	C	T	1	4	5	0	0	5	0	0
17	44962860	.	T	G	6	3	9	0	0	9	0	0
17	44962861	.	A	T	3	6	9	0	0	9	0	0
17	44967819	.	G	A	23	11	34	0	0	34	0	0
17	44968095	.	C	T	12	14	26	0	3	29	0	0
17	44981154	.	G	A	2	2	4	0	1	5	0	0
17	44981175	.	T	C	3	5	8	0	0	8	0	0
17	44981636	.	G	A	9	8	17	0	0	17	0	0
17	44981689	.	A	G	9	6	15	0	0	15	0	0
17	44981693	.	C	G	8	5	13	0	0	13	0	0
17	45002540	.	C	A	3	3	6	0	0	6	0	0
17	45002782	.	T	G	2	2	4	0	0	4	0	0
17	45002812	.	G	A	4	3	7	0	0	7	0	0
17	45005038	.	G	T	4	2	6	0	0	6	0	0
17	45007013	.	C	T	4	2	6	0	0	6	0	0
17	45010190	.	A	C	5	4	9	0	0	9	0	0
17	45010337	.	C	T	7	9	16	0	1	17	0	0
17	45010338	.	T	A	7	9	16	0	1	17	0	0
17	45018030	.	C	T	7	3	10	0	0	10	0	0
17	45018207	.	A	G	5	4	9	0	2	11	0	0
17	45022535	.	T	G	7	0	7	0	4	11	0	0
17	45028213	.	G	C	1	6	7	0	1	8	0	0
17	45028248	.	G	A	1	5	6	0	0	6	0	0
17	45073467	.	T	A	1	6	7	0	0	7	0	0
17	45073490	.	C	A	0	6	6	0	2	8	0	0
17	45076111	.	A	G	24	15	39	0	3	42	0	0
17	45082331	.	T	G	10	12	22	0	0	22	0	0
17	45082406	.	A	G	12	17	29	0	0	29	0	0
17	45082466	.	C	A	0	11	11	0	13	24	0	0
17	45085085	.	G	A	13	14	27	0	0	27	0	0
17	45085100	.	C	T	14	14	28	0	2	30	0	0
17	45093134	.	G	T	14	12	26	0	1	27	0	0
17	45093155	.	G	A	10	14	24	0	0	24	0	0
17	45099141	.	C	A	10	6	16	0	0	16	0	0
17	45106747	.	A	T	1	3	4	0	0	4	0	0
17	45138048	.	C	G	12	10	22	0	0	22	0	0
17	45138255	.	C	A	0	12	12	0	9	21	0	0
17	45138329	.	A	C	17	10	27	0	0	27	0	0
17	45138391	.	G	T	12	6	18	0	6	26	2	0
17	45138446	.	C	T	2	10	12	0	8	20	0	0
17	45138733	.	T	C	12	9	21	0	0	21	0	0
17	45138741	.	T	C	17	7	24	0	0	24	0	0
17	45139291	.	T	C	9	3	12	0	3	15	0	0
17	45139503	.	C	A	21	4	25	0	0	25	0	0
17	45139506	.	G	T	22	4	26	0	0	26	0	0
17	45139609	.	T	A	7	3	10	0	1	11	0	0
17	45139750	.	C	T	7	9	16	0	0	16	0	0
17	45139805	.	A	T	13	8	21	0	0	21	0	0
17	45139879	.	C	T	12	13	25	0	0	25	0	0
17	45139881	.	G	A	10	12	22	0	2	24	0	0
17	45140148	.	A	T	2	2	4	0	0	4	0	0
17	45140376	.	A	T	3	4	7	0	1	8	0	0
17	45145056	.	A	G	1	10	11	0	0	11	0	0
17	45145065	.	T	C	2	0	2	0	10	12	0	0
17	45145143	.	T	C	4	0	4	0	5	9	0	0
17	45148190	.	G	T	4	8	12	0	1	13	0	0
17	45148302	.	T	A	3	8	11	0	0	11	0	0
17	45148303	.	A	G	3	8	11	0	0	11	0	0
17	45216125	.	C	T	5	4	9	0	1	10	0	0
17	45216312	.	C	T	0	3	3	0	8	11	0	0
17	45216388	.	G	A	3	3	6	0	0	6	0	0
17	45232733	.	G	C	6	3	9	0	0	9	0	0
17	45233056	.	T	A	4	3	7	0	0	7	0	0
17	45233125	.	T	A	1	2	3	0	0	3	0	0
17	45234663	.	T	A	2	5	7	0	0	7	0	0
17	45234816	.	G	C	3	2	5	0	0	5	0	0
17	45235370	.	C	A	3	4	7	0	0	7	0	0
17	45235379	.	A	T	3	2	5	0	1	6	0	0
17	45247199	.	A	G	4	4	8	0	0	8	0	0
17	45254339	.	C	T	3	3	6	0	0	6	0	0
17	45295673	.	C	T	3	2	5	0	0	5	0	0
17	45302346	.	A	T	2	2	4	0	0	4	0	0
17	45348243	.	G	A	5	6	11	0	0	11	0	0
17	45348585	.	T	A	1	4	5	0	0	5	0	0
17	45348824	.	T	C	1	3	4	0	0	4	0	0
17	45349518	.	G	T	1	2	3	0	0	3	0	0
17	45350346	.	C	T	1	2	3	0	1	4	0	0
17	45352841	.	T	G	2	5	7	0	0	7	0	0
17	45363768	.	C	T	1	2	3	0	0	3	0	0
17	45402377	.	A	T	1	2	3	0	1	4	0	0
17	45402384	.	G	A	2	3	5	0	0	5	0	0
17	45402422	.	A	G	2	3	5	0	0	5	0	0
17	45402811	.	A	G	1	2	3	0	0	3	0	0
17	45455365	.	C	T	2	2	4	0	0	4	0	0
17	45455398	.	A	T	2	3	5	0	0	5	0	0
17	45532532	.	T	A	19	19	38	0	0	38	0	0
17	45532637	.	A	T	18	9	27	0	2	29	0	0
17	45639367	.	G	A	0	2	2	0	7	9	0	0
17	45639601	.	A	C	1	7	8	0	0	8	0	0
17	45639926	.	C	A	2	5	7	0	0	7	0	0
17	45646604	.	T	C	1	4	5	0	0	5	0	0
17	45646633	.	T	A	2	2	4	0	0	4	0	0
17	45646639	.	G	A	1	1	2	0	1	3	0	0
17	45732589	.	A	G	8	7	15	0	2	18	1	0
17	45732601	.	G	A	7	6	13	0	0	13	0	0
17	45732765	.	A	T	12	12	24	0	1	25	0	0
17	45732785	.	T	C	12	13	25	0	2	27	0	0
17	45732802	.	G	T	12	13	25	0	0	25	0	0
17	45733537	.	A	G	3	4	7	0	0	7	0	0
17	45733664	.	G	A	5	6	11	0	1	12	0	0
17	45733752	.	G	A	7	6	13	0	0	13	0	0
17	45734170	.	A	G	9	5	14	1	0	15	0	0
17	45744138	.	C	T	4	5	9	0	0	9	0	0
17	45751385	.	C	T	8	5	13	0	0	13	0	0
17	45756547	.	C	T	7	6	13	0	1	14	0	0
17	45759087	.	C	T	8	13	21	0	1	22	0	0
17	45762487	.	G	A	6	12	18	0	0	18	0	0
17	45765222	.	C	T	7	7	14	0	0	14	0	0
17	45774378	.	G	A	1	5	6	0	7	13	0	0
17	45774425	.	C	A	4	3	7	0	0	7	0	0
17	45988243	.	A	G	2	2	4	0	0	4	0	0
17	45989032	.	G	T	2	3	5	0	2	7	0	0
17	46387253	.	G	T	2	3	5	0	4	9	0	0
17	46387490	.	C	T	4	3	7	0	0	7	0	0
17	46387499	.	A	G	4	3	7	0	0	7	0	0
17	46436172	.	A	T	4	3	7	0	0	7	0	0
17	46457321	.	G	C	16	13	29	0	0	29	0	0
17	46457326	.	C	A	1	13	14	0	12	26	0	0
17	46852240	.	A	G	2	7	9	11	0	20	0	0
17	47134996	.	C	T	2	2	4	0	0	4	0	0
17	47135071	.	G	T	4	2	6	0	0	6	0	0
17	47164707	.	T	C	1	4	5	0	0	5	0	0
17	47169612	.	A	T	4	5	9	0	0	9	0	0
17	47169660	.	G	C	0	2	2	0	5	7	0	0
17	47175456	.	G	A	4	6	10	0	0	10	0	0
17	47175569	.	G	A	6	5	11	0	0	11	0	0
17	47176050	.	A	T	2	2	4	0	0	4	0	0
17	47176319	.	C	A	3	4	7	0	0	7	0	0
17	47176322	.	T	A	3	2	5	0	0	5	0	0
17	47188800	.	T	A	14	3	17	0	0	17	0	0
17	47188932	.	C	T	2	9	11	0	10	21	0	0
17	47188984	.	G	A	10	6	16	0	0	16	0	0
17	47189003	.	A	G	8	5	13	0	0	13	0	0
17	47189129	.	C	A	5	6	11	0	0	11	0	0
17	47189243	.	T	C	12	2	14	0	1	15	0	0
17	47189258	.	G	T	11	5	16	0	0	16	0	0
17	47189684	.	G	A	9	9	18	0	0	18	0	0
17	47189741	.	G	T	9	5	14	0	0	14	0	0
17	47189790	.	A	G	3	3	6	0	0	6	0	0
17	47189810	.	C	T	1	3	4	0	6	10	0	0
17	47189919	.	G	T	9	9	18	0	0	18	0	0
17	47189937	.	T	A	8	11	19	0	1	20	0	0
17	47190032	.	C	T	7	12	19	0	2	21	0	0
17	47190045	.	C	A	0	10	10	0	16	26	0	0
17	47190118	.	A	G	7	6	13	0	0	13	0	0
17	47190149	.	G	C	10	4	14	0	0	14	0	0
17	47190492	.	G	A	5	4	9	0	0	9	0	0
17	47190892	.	T	C	1	0	1	0	4	5	0	0
17	47190904	.	G	A	3	5	8	0	0	8	0	0
17	47190967	.	T	G	5	3	8	0	0	8	0	0
17	47191101	.	A	G	4	4	8	0	1	9	0	0
17	47191186	.	T	A	3	2	5	0	0	5	0	0
17	47191780	.	T	C	3	2	5	0	0	5	0	0
17	47192047	.	T	C	5	2	7	0	0	7	0	0
17	47192178	.	C	T	4	3	7	0	0	7	0	0
17	47193180	.	T	A	6	3	9	0	0	9	0	0
17	47193200	.	A	G	4	6	10	0	0	10	0	0
17	47193359	.	T	G	5	3	8	0	3	11	0	0
17	47193651	.	A	G	2	4	6	0	0	6	0	0
17	47193692	.	C	T	2	6	8	0	0	8	0	0
17	47193857	.	T	C	5	0	5	0	4	9	0	0
17	47193872	.	C	T	5	0	5	0	3	8	0	0
17	47193941	.	T	G	7	5	12	0	1	13	0	0
17	47193995	.	T	C	6	4	10	0	0	10	0	0
17	47196179	.	G	C	2	2	4	0	0	4	0	0
17	47196584	.	T	G	1	3	4	0	0	4	0	0
17	47196587	.	G	A	1	3	4	0	0	4	0	0
17	47219192	.	C	T	1	2	3	0	0	3	0	0
17	47220857	.	C	A	5	3	8	0	0	8	0	0
17	47238604	.	T	A	1	3	4	0	0	4	0	0
17	48906437	.	G	C	1	8	9	0	1	10	0	0
17	48908803	.	C	T	2	5	7	0	11	18	0	0
17	48911097	.	T	G	4	9	13	1	0	14	0	0
17	48915349	.	T	C	5	3	8	0	0	8	0	0
17	48915387	.	A	T	7	9	16	0	2	18	0	0
17	48923299	.	T	C	3	1	4	0	1	5	0	0
17	49006619	.	A	T	3	3	6	0	0	6	0	0
17	49008376	.	A	G	4	5	9	0	0	9	0	0
17	49010727	.	T	C	3	5	8	0	0	8	0	0
17	49011627	.	T	C	3	2	5	0	1	6	0	0
17	49014085	.	A	G	11	6	17	0	0	17	0	0
17	49014663	.	G	T	0	11	11	0	13	24	0	0
17	49018023	.	G	A	1	10	11	0	15	26	0	0
17	49018107	.	C	T	3	12	15	0	3	18	0	0
17	49018113	.	A	T	4	12	16	0	2	18	0	0
17	49018164	.	A	C	9	11	20	0	3	23	0	0
17	49018508	.	C	G	9	12	21	0	1	22	0	0
17	49018899	.	C	T	20	8	28	0	2	30	0	0
17	49018935	.	A	C	18	15	33	0	1	34	0	0
17	49019101	.	T	C	14	18	32	0	0	32	0	0
17	49019288	.	A	C	21	14	35	0	1	37	1	0
17	49019299	.	A	T	19	11	30	0	4	34	0	0
17	49019380	.	G	A	0	7	7	0	7	14	0	0
17	49137269	.	G	T	2	2	4	0	2	6	0	0
17	49137355	.	G	A	1	1	2	0	1	3	0	0
17	49199317	.	C	G	1	0	1	0	3	4	0	0
17	49208766	.	C	T	2	3	5	0	0	5	0	0
17	49208775	.	A	T	2	4	6	0	0	6	0	0
17	49212630	.	G	C	1	4	5	0	3	8	0	0
17	49217106	.	T	A	4	8	12	0	0	12	0	0
17	49217209	.	G	A	1	4	5	0	4	9	0	0
17	49217466	.	T	C	3	4	7	0	1	8	0	0
17	49217507	.	C	T	6	4	10	0	0	10	0	0
17	49217577	.	C	T	3	4	7	0	0	7	0	0
17	49217658	.	G	T	5	4	9	0	0	9	0	0
17	49217703	.	C	A	3	8	11	0	0	11	0	0
17	49217887	.	A	G	5	2	7	0	0	7	0	0
17	49416327	.	T	C	13	8	21	0	2	23	0	0
17	49416396	.	G	T	10	10	20	0	0	20	0	0
17	49418225	.	G	A	8	4	12	0	0	12	0	0
17	49418765	.	G	A	6	4	10	0	0	10	0	0
17	49418792	.	C	T	4	3	7	0	0	7	0	0
17	49419182	.	T	A	2	4	6	0	0	6	0	0
17	49419188	.	C	T	2	3	5	0	0	5	0	0
17	49419247	.	T	C	2	6	8	0	0	8	0	0
17	49419590	.	T	C	3	5	8	0	0	8	0	0
17	49419761	.	G	T	3	5	8	0	0	8	0	0
17	49419887	.	C	T	0	3	3	0	5	8	0	0
17	49419954	.	C	T	2	3	5	0	0	5	0	0
17	49420049	.	T	G	3	3	6	0	1	7	0	0
17	49420454	.	A	T	3	3	6	0	0	6	0	0
17	49420655	.	A	C	3	2	5	0	0	5	0	0
17	49420677	.	G	A	3	2	5	0	0	5	0	0
17	49429844	.	T	C	2	2	4	0	1	5	0	0
17	49481635	.	C	G	13	10	23	0	0	23	0	0
17	49481638	.	T	C	10	0	10	0	11	21	0	0
17	49503569	.	G	T	5	5	10	0	0	10	0	0
17	49503632	.	G	A	5	4	9	0	1	10	0	0
17	49503647	.	C	T	6	3	9	0	0	9	0	0
17	49503940	.	G	A	6	3	9	0	0	9	0	0
17	49507155	.	C	T	4	4	8	0	0	8	0	0
17	49509606	.	G	A	5	5	10	0	0	10	0	0
17	49518977	.	C	T	3	8	11	0	0	11	0	0
17	49519061	.	C	T	2	4	6	0	0	6	0	0
17	49519070	.	T	A	4	5	9	0	0	9	0	0
17	49522248	.	G	A	12	6	18	0	1	19	0	0
17	49526584	.	T	C	10	11	21	0	2	23	0	0
17	49526839	.	A	G	5	5	10	0	0	10	0	0
17	49527099	.	T	G	3	2	5	0	0	5	0	0
17	49527115	.	T	C	5	2	7	0	0	7	0	0
17	49527357	.	A	T	6	8	14	0	0	14	0	0
17	49527588	.	A	G	8	2	10	1	1	12	0	0
17	49528082	.	C	G	13	11	24	1	0	25	0	0
17	49528291	.	A	G	9	0	9	0	8	17	0	0
17	49631878	.	A	T	3	3	6	0	1	7	0	0
17	49631901	.	G	C	1	2	3	0	0	3	0	0
17	49632191	.	A	G	1	4	5	0	0	5	0	0
17	49632693	.	C	A	3	2	5	0	0	5	0	0
17	49632825	.	A	G	4	4	8	0	0	8	0	0
17	49640938	.	A	T	8	3	11	0	0	11	0	0
17	49641136	.	A	G	2	3	5	0	0	5	0	0
17	49641698	.	T	C	1	6	7	0	0	7	0	0
17	49983202	.	A	T	8	6	14	0	2	16	0	0
17	49983273	.	C	T	22	20	42	0	2	44	0	0
17	49983315	.	C	T	20	31	51	0	2	53	0	0
17	49992629	.	G	A	26	36	62	0	2	64	0	0
17	49998171	.	T	C	20	7	27	0	0	27	0	0
17	49998221	.	G	A	16	6	22	0	0	22	0	0
17	49998658	.	G	A	7	2	9	0	0	9	0	0
17	49998734	.	G	A	19	20	39	0	2	41	0	0
17	49998804	.	C	A	22	22	44	0	2	46	0	0
17	49999037	.	G	T	19	26	45	0	0	45	0	0
17	50002381	.	A	G	23	26	49	0	0	50	1	0
17	50007340	.	G	A	9	21	30	0	0	30	0	0
17	50009829	.	T	C	15	1	16	0	14	30	0	0
17	50009832	.	T	A	13	15	28	0	1	29	0	0
17	50010078	.	T	C	16	17	33	0	0	34	1	0
17	50010087	.	C	A	3	20	23	0	14	37	0	0
17	50100027	.	C	T	3	2	5	0	0	5	0	0
17	50101438	.	C	A	3	6	9	0	0	9	0	0
17	50107391	.	G	A	7	2	9	0	1	10	0	0
17	50107394	.	C	A	2	7	9	0	0	9	0	0
17	50110215	.	C	T	3	6	9	0	1	10	0	0
17	50110391	.	G	T	5	8	13	0	0	13	0	0
17	50110479	.	C	G	3	6	9	0	0	9	0	0
17	50110574	.	A	G	1	0	1	0	2	3	0	0
17	50110787	.	G	A	3	3	6	0	0	6	0	0
17	50110838	.	C	T	1	3	4	0	0	4	0	0
17	50111397	.	A	G	2	9	11	0	1	12	0	0
17	50111406	.	G	A	9	3	12	0	0	12	0	0
17	50111497	.	A	G	3	0	3	0	3	6	0	0
17	50111528	.	A	G	2	2	4	0	0	4	0	0
17	50111549	.	A	G	5	4	9	0	0	9	0	0
17	50111573	.	C	T	10	3	13	0	0	13	0	0
17	50111680	.	A	T	3	5	8	0	0	8	0	0
17	50111722	.	C	A	3	3	6	0	0	6	0	0
17	50111746	.	A	T	2	2	4	0	0	4	0	0
17	50112390	.	C	G	4	2	6	0	0	6	0	0
17	50112396	.	G	A	4	4	8	0	0	8	0	0
17	50113141	.	G	A	10	5	15	0	1	16	0	0
17	50113148	.	C	T	7	10	17	0	1	18	0	0
17	50113336	.	C	T	2	3	5	0	2	7	0	0
17	50113404	.	C	T	3	2	5	0	0	5	0	0
17	50141759	.	A	T	7	7	14	0	3	17	0	0
17	50141766	.	T	A	6	6	12	0	2	14	0	0
17	50141806	.	A	G	7	0	7	0	7	14	0	0
17	50141904	.	A	T	5	16	21	0	1	22	0	0
17	50172581	.	T	G	11	10	21	0	1	22	0	0
17	50176483	.	G	A	11	8	19	0	1	20	0	0
17	50176519	.	C	A	10	8	18	0	0	18	0	0
17	50180672	.	C	T	11	11	22	1	0	23	0	0
17	50185665	.	T	A	12	15	27	0	1	28	0	0
17	50185841	.	A	T	15	9	24	0	1	25	0	0
17	50185930	.	T	C	13	9	22	0	2	24	0	0
17	50185964	.	G	A	1	7	8	0	14	22	0	0
17	50186011	.	G	A	1	11	12	0	6	18	0	0
17	50186097	.	G	A	10	6	16	0	1	17	0	0
17	50229135	.	A	C	8	13	21	0	0	21	0	0
17	50229301	.	G	T	9	14	23	0	1	24	0	0
17	50229718	.	A	G	6	17	23	0	0	23	0	0
17	50245400	.	G	A	5	9	14	0	0	14	0	0
17	50245580	.	G	A	13	14	27	0	0	27	0	0
17	50245673	.	T	C	19	18	37	0	1	38	0	0
17	50245715	.	C	G	18	26	44	0	0	44	0	0
17	50245772	.	C	T	11	16	27	0	0	27	0	0
17	50247886	.	T	C	13	0	13	1	22	36	0	0
17	50247988	.	A	T	11	3	14	0	0	14	0	0
17	50272729	.	G	A	4	5	9	0	0	9	0	0
17	50275229	.	C	A	9	5	14	0	1	15	0	0
17	50278271	.	G	A	9	9	18	0	0	18	0	0
17	50278808	.	C	T	5	15	20	0	1	21	0	0
17	50278884	.	C	A	10	3	13	0	0	13	0	0
17	50284899	.	T	A	15	17	32	0	0	32	0	0
17	50285009	.	A	T	6	8	14	0	2	16	0	0
17	50285052	.	C	T	5	6	11	0	2	13	0	0
17	50285221	.	A	T	9	9	18	0	0	18	0	0
17	50285401	.	A	C	12	0	12	0	0	12	0	0
17	50415805	.	C	A	3	3	6	0	2	8	0	0
17	50415806	.	G	A	2	5	7	0	1	8	0	0
17	50415844	.	C	T	4	9	13	0	1	14	0	0
17	50415858	.	A	G	8	7	15	0	1	16	0	0
17	50416052	.	C	G	2	4	6	0	0	6	0	0
17	50416238	.	C	T	0	2	2	0	6	8	0	0
17	50416269	.	C	T	1	4	5	0	7	12	0	0
17	50416392	.	T	C	2	2	4	0	0	4	0	0
17	50416414	.	T	A	3	3	6	0	0	6	0	0
17	50416456	.	C	T	4	4	8	0	0	8	0	0
17	50416525	.	A	G	8	3	11	0	0	11	0	0
17	50416593	.	T	C	2	2	4	0	1	5	0	0
17	50416790	.	T	C	2	0	2	0	3	5	0	0
17	50417310	.	T	C	1	4	5	0	0	5	0	0
17	50417534	.	C	T	2	3	5	0	0	5	0	0
17	50417537	.	C	T	3	2	5	0	0	5	0	0
17	50417613	.	T	C	1	3	4	0	0	4	0	0
17	50424419	.	C	G	0	2	2	0	3	5	0	0
17	50424455	.	T	C	4	0	4	0	5	9	0	0
17	50424555	.	A	T	4	5	9	0	0	9	0	0
17	50424556	.	A	T	2	5	7	0	1	8	0	0
17	50424596	.	A	T	3	4	7	0	1	8	0	0
17	50424662	.	A	G	3	8	11	1	0	12	0	0
17	50424663	.	A	G	3	7	10	1	1	12	0	0
17	50424697	.	A	G	5	11	16	1	1	18	0	0
17	50425042	.	C	G	4	8	12	0	0	12	0	0
17	50425083	.	A	G	3	6	9	0	0	9	0	0
17	50425171	.	A	T	1	6	7	0	0	7	0	0
17	50425260	.	A	G	3	2	5	0	0	5	0	0
17	50425854	.	C	T	0	4	4	0	5	9	0	0
17	50425858	.	T	A	3	5	8	0	1	9	0	0
17	50425899	.	A	G	2	4	6	0	0	6	0	0
17	50425992	.	A	T	1	2	3	0	0	3	0	0
17	50426043	.	T	C	1	3	4	0	0	4	0	0
17	50426194	.	C	A	1	3	4	0	0	4	0	0
17	50436183	.	G	T	3	2	5	1	0	6	0	0
17	50449961	.	C	T	1	2	3	0	1	4	0	0
17	50450202	.	A	G	3	3	6	0	0	6	0	0
17	50450315	.	C	G	2	2	4	0	0	4	0	0
17	50460650	.	G	A	1	2	3	0	0	3	0	0
17	50460657	.	G	A	1	2	3	0	0	3	0	0
17	50460694	.	G	A	1	5	6	0	0	6	0	0
17	50461380	.	T	C	1	3	4	0	0	4	0	0
17	50478771	.	G	C	1	2	3	0	0	3	0	0
17	50483920	.	G	A	1	2	3	0	1	4	0	0
17	50657067	.	C	T	1	2	3	0	0	3	0	0
17	50657321	.	T	C	1	2	3	0	0	3	0	0
17	50657663	.	G	A	2	3	5	0	0	5	0	0
17	50657829	.	T	C	2	2	4	0	0	4	0	0
17	50664473	.	A	C	2	4	6	0	0	6	0	0
17	50679790	.	C	T	3	3	6	0	0	6	0	0
17	50679791	.	T	A	3	3	6	0	0	6	0	0
17	50682945	.	C	T	6	3	9	0	1	10	0	0
17	50688480	.	T	C	5	5	10	0	0	10	0	0
17	50689787	.	T	A	4	3	7	0	1	8	0	0
17	50689811	.	A	C	4	4	8	0	0	8	0	0
17	50689842	.	A	G	7	4	11	1	0	12	0	0
17	50839928	.	C	T	1	4	5	0	0	5	0	0
17	50976567	.	C	T	22	11	33	0	1	34	0	0
17	51020214	.	A	G	6	8	14	0	2	16	0	0
17	51206396	.	G	A	12	9	21	0	0	21	0	0
17	51206825	.	T	C	20	0	20	0	12	32	0	0
17	51206951	.	T	A	14	6	20	0	2	22	0	0
17	51207200	.	G	C	10	5	15	0	0	15	0	0
17	51209442	.	G	A	19	10	29	0	0	29	0	0
17	51213963	.	C	T	3	10	13	0	0	13	0	0
17	51214185	.	C	T	1	4	5	0	0	5	0	0
17	51218418	.	G	A	5	4	9	0	0	9	0	0
17	51224484	.	G	A	0	4	4	0	5	9	0	0
17	51226592	.	G	A	1	2	3	0	1	4	0	0
17	51226879	.	C	T	2	3	5	0	0	5	0	0
17	51229397	.	C	A	2	2	4	0	0	4	0	0
17	51229413	.	T	C	3	3	6	0	1	7	0	0
17	51229451	.	A	G	4	2	6	0	0	6	0	0
17	51229632	.	C	A	2	4	6	0	0	6	0	0
17	51229647	.	G	A	5	2	7	0	0	7	0	0
17	51231538	.	T	C	5	8	13	0	2	15	0	0
17	51231629	.	T	C	7	9	16	0	1	17	0	0
17	51231633	.	T	C	11	5	16	1	2	19	0	0
17	51231980	.	T	C	6	11	17	0	1	18	0	0
17	51232188	.	T	C	5	2	7	0	0	7	0	0
17	51232193	.	T	C	2	2	4	0	0	4	0	0
17	51232759	.	C	T	2	18	20	0	15	36	1	0
17	51234540	.	A	C	7	0	7	2	7	16	0	0
17	51253919	.	T	C	6	8	14	0	1	15	0	0
17	51256927	.	C	T	0	2	2	0	2	4	0	0
17	51256933	.	C	G	1	4	5	0	0	5	0	0
17	51257376	.	C	T	1	9	10	0	7	17	0	0
17	51276021	.	G	A	9	9	18	0	3	21	0	0
17	51301246	.	T	C	7	8	15	0	1	16	0	0
17	51303112	.	C	T	15	10	25	0	2	27	0	0
17	51303241	.	G	A	17	7	24	0	0	24	0	0
17	51305458	.	G	C	16	8	24	0	0	24	0	0
17	51797531	.	T	G	8	9	17	0	0	17	0	0
17	51823617	.	G	T	15	5	20	0	0	20	0	0
17	51824061	.	G	A	13	6	19	0	0	19	0	0
17	51824759	.	C	T	0	5	5	0	3	8	0	0
17	52940880	.	T	C	3	3	6	0	1	7	0	0
17	52940898	.	T	C	2	3	5	0	0	5	0	0
18	106898	.	T	G	21	0	21	0	7	28	0	0
18	298740	.	C	T	2	3	5	0	0	5	0	0
18	302902	.	C	T	8	10	18	0	0	18	0	0
18	303136	.	G	T	0	8	8	0	10	18	0	0
18	316039	.	C	T	11	12	23	0	2	25	0	0
18	318821	.	T	C	14	10	24	0	1	25	0	0
18	318824	.	C	T	14	13	27	0	0	27	0	0
18	319731	.	G	A	10	11	21	0	1	22	0	0
18	321802	.	T	C	8	13	21	0	2	23	0	0
18	321820	.	C	T	12	10	22	0	0	22	0	0
18	321934	.	C	T	9	5	14	0	1	15	0	0
18	323840	.	G	A	1	7	8	0	7	15	0	0
18	324190	.	T	C	9	4	13	0	1	14	0	0
18	324243	.	G	A	7	3	10	0	2	12	0	0
18	324317	.	G	A	8	10	18	0	0	18	0	0
18	324325	.	A	G	10	9	19	0	1	20	0	0
18	324380	.	T	G	12	13	25	0	1	26	0	0
18	324409	.	C	T	9	12	21	0	0	21	0	0
18	324465	.	T	C	13	11	24	1	0	25	0	0
18	324692	.	A	T	16	13	29	0	0	29	0	0
18	324834	.	T	G	15	1	16	0	17	33	0	0
18	324835	.	G	T	14	17	31	0	2	33	0	0
18	325044	.	A	G	18	20	38	0	0	38	0	0
18	325189	.	C	T	15	21	36	0	5	41	0	0
18	325290	.	G	A	2	22	24	0	17	41	0	0
18	325312	.	G	T	22	19	41	0	0	41	0	0
18	325407	.	T	G	11	18	29	0	1	30	0	0
18	328795	.	G	C	11	5	16	0	1	17	0	0
18	330474	.	A	G	11	4	15	0	0	15	0	0
18	333765	.	T	C	8	11	19	0	0	19	0	0
18	334018	.	C	T	8	10	18	0	0	18	0	0
18	334049	.	A	T	11	6	17	0	0	17	0	0
18	334163	.	T	C	4	4	8	0	0	8	0	0
18	334361	.	T	C	4	2	6	0	0	6	0	0
18	334431	.	T	G	6	3	9	0	0	9	0	0
18	334436	.	G	T	5	5	10	0	0	10	0	0
18	334560	.	T	C	4	2	6	0	0	6	0	0
18	334634	.	G	A	7	7	14	0	0	14	0	0
18	334649	.	T	C	10	3	13	0	0	13	0	0
18	334872	.	C	T	0	7	7	0	8	15	0	0
18	334876	.	T	A	8	8	16	0	0	16	0	0
18	336586	.	T	C	16	5	21	0	2	23	0	0
18	336607	.	T	G	12	9	21	0	2	23	0	0
18	344332	.	G	A	1	6	7	0	0	7	0	0
18	344515	.	C	T	0	2	2	0	4	6	0	0
18	344581	.	T	C	6	4	10	0	0	10	0	0
18	344587	.	C	T	6	3	9	0	1	10	0	0
18	357011	.	C	T	0	2	2	0	1	3	0	0
18	370129	.	C	T	0	2	2	0	1	3	0	0
18	422953	.	C	T	1	3	4	0	0	4	0	0
18	422992	.	G	A	0	2	2	0	3	5	0	0
18	438311	.	T	A	1	2	3	0	0	3	0	0
18	507789	.	A	T	2	2	4	0	0	4	0	0
18	580961	.	G	A	0	5	5	0	1	6	0	0
18	581075	.	G	A	1	2	3	0	1	4	0	0
18	606232	.	A	G	5	0	5	0	3	8	0	0
18	606277	.	A	T	2	3	5	1	3	9	0	0
18	609280	.	G	A	5	4	9	0	0	9	0	0
18	609301	.	A	G	5	3	8	0	0	8	0	0
18	609365	.	A	G	4	2	6	0	0	6	0	0
18	609399	.	A	G	4	2	6	0	0	6	0	0
18	609545	.	T	A	2	3	5	0	0	5	0	0
18	609559	.	C	A	2	4	6	0	0	6	0	0
18	609658	.	T	A	10	3	13	0	0	13	0	0
18	609667	.	C	G	12	3	15	0	0	15	0	0
18	609877	.	G	A	10	5	15	0	0	15	0	0
18	610327	.	A	G	6	0	6	0	6	12	0	0
18	610395	.	T	C	6	5	11	0	0	11	0	0
18	610397	.	T	C	6	5	11	0	0	11	0	0
18	660752	.	G	C	0	4	4	0	1	5	0	0
18	939430	.	C	T	24	30	54	0	1	55	0	0
18	948938	.	C	T	43	29	72	1	0	73	0	0
18	950849	.	C	T	45	37	82	0	3	85	0	0
18	951327	.	T	C	28	34	62	0	8	70	0	0
18	951391	.	C	T	30	21	51	3	1	55	0	0
18	951536	.	C	T	12	11	23	0	3	26	0	0
18	955705	.	A	G	1	2	3	0	0	3	0	0
18	1152125	.	T	C	2	8	10	0	0	10	0	0
18	1152141	.	A	C	2	0	2	0	8	10	0	0
18	1161054	.	T	A	12	6	18	0	0	18	0	0
18	1173819	.	G	A	26	23	49	0	4	53	0	0
18	1173856	.	G	A	30	26	56	0	7	63	0	0
18	1189420	.	G	A	16	20	36	0	2	38	0	0
18	1197218	.	G	T	12	19	31	0	0	31	0	0
18	1251122	.	T	C	1	2	3	0	0	3	0	0
18	1292668	.	T	C	11	0	11	0	10	21	0	0
18	1293121	.	G	A	8	8	16	0	0	16	0	0
18	1293182	.	G	A	5	7	12	0	0	12	0	0
18	1293242	.	G	A	9	5	14	0	1	15	0	0
18	1294572	.	T	C	4	0	4	0	6	10	0	0
18	1386296	.	C	T	1	2	3	0	1	4	0	0
18	1404683	.	G	A	9	8	17	0	0	17	0	0
18	1513214	.	C	T	1	2	3	0	0	3	0	0
18	2180636	.	C	T	1	3	4	0	0	4	0	0
18	2190731	.	G	A	2	4	6	0	1	7	0	0
18	2205302	.	T	A	8	7	15	0	1	16	0	0
18	2208642	.	A	C	8	4	12	0	1	13	0	0
18	2210570	.	C	T	7	6	13	0	1	14	0	0
18	2211091	.	T	C	7	3	10	0	0	10	0	0
18	2214873	.	A	G	3	4	7	0	1	8	0	0
18	2215557	.	C	T	5	2	7	0	0	7	0	0
18	2225632	.	C	T	10	18	28	1	0	29	0	0
18	2225661	.	C	T	17	14	31	1	1	33	0	0
18	2377645	.	T	C	14	0	14	0	15	29	0	0
18	2377860	.	G	A	13	10	23	0	1	24	0	0
18	2378687	.	A	C	8	8	16	0	1	17	0	0
18	2378713	.	T	G	9	7	16	0	2	18	0	0
18	2378722	.	C	T	0	8	8	0	10	18	0	0
18	2379073	.	G	A	4	3	7	1	1	9	0	0
18	2408886	.	G	A	8	9	17	0	1	18	0	0
18	2412660	.	T	C	3	8	11	0	0	11	0	0
18	2414993	.	T	C	10	5	15	0	0	15	0	0
18	2533358	.	T	C	1	3	4	0	0	4	0	0
18	2922770	.	T	A	14	0	14	1	4	19	0	0
18	3043779	.	C	T	38	26	64	0	2	66	0	0
18	3049796	.	G	A	6	3	9	0	0	9	0	0
18	3078648	.	G	A	3	7	10	0	0	10	0	0
18	3078684	.	C	T	6	4	10	0	1	11	0	0
18	3081803	.	T	C	4	5	9	0	0	9	0	0
18	3084033	.	T	C	3	4	7	0	0	7	0	0
18	3094913	.	T	C	11	9	20	0	1	21	0	0
18	3094920	.	C	A	12	9	21	0	0	21	0	0
18	3096914	.	A	C	4	2	6	0	0	6	0	0
18	3097194	.	T	C	3	6	9	0	1	10	0	0
18	3100651	.	A	G	7	6	13	0	1	14	0	0
18	3140747	.	G	A	3	4	7	0	0	7	0	0
18	3140975	.	A	G	4	6	10	0	1	11	0	0
18	3142685	.	A	G	6	7	13	0	0	13	0	0
18	3149565	.	T	G	3	11	14	0	1	15	0	0
18	3158150	.	C	G	1	2	3	0	0	3	0	0
18	3158172	.	G	T	1	2	3	0	0	3	0	0
18	3158237	.	C	T	1	6	7	0	1	8	0	0
18	3158245	.	T	A	1	7	8	0	0	9	1	0
18	3158273	.	G	A	6	2	8	0	0	8	0	0
18	3158375	.	C	T	0	2	2	0	5	7	0	0
18	3158588	.	A	C	12	7	19	0	0	19	0	0
18	3158739	.	A	G	5	12	17	0	0	17	0	0
18	3158776	.	G	A	10	7	17	0	1	18	0	0
18	3158801	.	G	A	14	7	21	0	0	21	0	0
18	3158896	.	C	T	7	7	14	1	1	16	0	0
18	3159140	.	C	A	9	3	12	0	0	12	0	0
18	3159324	.	C	G	5	2	7	0	0	7	0	0
18	3159326	.	C	A	5	2	7	0	0	7	0	0
18	3159861	.	T	C	6	5	11	0	0	11	0	0
18	3160148	.	C	G	0	4	4	1	3	8	0	0
18	3160188	.	A	T	5	6	11	0	0	11	0	0
18	3160218	.	C	T	1	8	9	0	9	18	0	0
18	3160308	.	A	G	8	4	12	0	0	12	0	0
18	3160354	.	C	T	0	9	9	0	2	11	0	0
18	3166246	.	T	A	1	4	5	0	1	6	0	0
18	3166413	.	C	G	5	3	8	0	0	8	0	0
18	3166414	.	C	A	2	3	5	0	3	8	0	0
18	3259807	.	C	A	12	24	36	1	2	39	0	0
18	3276085	.	G	C	14	32	46	0	0	46	0	0
18	3276187	.	A	G	15	1	16	0	18	34	0	0
18	3278976	.	G	A	20	16	36	0	1	37	0	0
18	3283412	.	G	A	8	18	26	0	1	27	0	0
18	3283546	.	A	G	27	0	27	0	19	46	0	0
18	3283631	.	G	T	18	16	34	0	2	36	0	0
18	3283686	.	T	C	14	24	38	3	1	42	0	0
18	3283882	.	T	C	25	24	49	0	0	49	0	0
18	3284182	.	G	A	1	2	3	0	0	3	0	0
18	3284183	.	C	A	1	2	3	0	0	3	0	0
18	3327571	.	G	A	0	3	3	0	3	6	0	0
18	3334581	.	G	C	5	7	12	0	0	12	0	0
18	3335472	.	A	T	5	2	7	0	0	7	0	0
18	3345141	.	T	A	4	4	8	0	1	9	0	0
18	3536883	.	A	G	9	18	27	0	0	27	0	0
18	3536937	.	T	C	13	13	26	0	0	26	0	0
18	3540027	.	C	T	10	10	20	0	0	20	0	0
18	3542204	.	G	A	10	7	17	0	1	18	0	0
18	3556542	.	A	G	12	7	19	0	1	20	0	0
18	3556626	.	C	T	1	8	9	0	13	22	0	0
18	3556710	.	G	A	9	6	15	0	0	15	0	0
18	3556743	.	G	A	2	9	11	0	0	11	0	0
18	3556935	.	C	T	5	6	11	0	0	11	0	0
18	3562409	.	A	C	6	0	6	0	5	11	0	0
18	3575938	.	C	A	12	5	17	1	0	18	0	0
18	3575984	.	G	A	11	9	20	0	1	21	0	0
18	3576104	.	C	T	10	11	21	0	1	22	0	0
18	3576185	.	T	A	4	4	8	0	1	9	0	0
18	3616233	.	A	T	1	3	4	0	0	4	0	0
18	3616246	.	T	G	1	0	1	0	3	4	0	0
18	3618015	.	C	G	3	5	8	0	0	8	0	0
18	3620535	.	C	T	4	2	6	0	0	6	0	0
18	3620556	.	A	C	2	4	6	0	0	6	0	0
18	3635419	.	A	G	4	1	5	0	0	5	0	0
18	3635443	.	C	G	3	2	5	0	0	5	0	0
18	5087632	.	A	G	2	2	4	0	0	4	0	0
18	5094876	.	A	C	17	0	17	0	16	33	0	0
18	5095537	.	G	T	16	18	34	0	1	35	0	0
18	5140128	.	C	T	16	14	30	0	0	30	0	0
18	5142338	.	C	T	10	27	37	2	1	40	0	0
18	5167232	.	T	C	38	21	59	0	2	61	0	0
18	5167374	.	A	G	37	20	57	0	0	57	0	0
18	5167437	.	T	C	33	18	51	0	0	51	0	0
18	5167689	.	A	G	16	20	36	1	3	40	0	0
18	5169635	.	C	T	7	33	40	0	1	41	0	0
18	5169779	.	T	C	27	29	56	1	2	59	0	0
18	5170016	.	C	G	25	30	55	0	1	56	0	0
18	5170063	.	A	G	30	17	47	0	3	50	0	0
18	5170069	.	A	G	15	2	17	0	32	50	1	0
18	5170123	.	C	A	19	28	47	0	2	49	0	0
18	5245467	.	G	A	1	5	6	0	0	6	0	0
18	5245480	.	G	A	1	5	6	0	0	6	0	0
18	5245503	.	G	A	1	6	7	0	0	7	0	0
18	5519138	.	A	G	11	4	15	0	1	16	0	0
18	5519749	.	A	T	1	8	9	0	0	9	0	0
18	5537489	.	G	A	2	2	4	0	0	4	0	0
18	5911551	.	T	A	8	3	11	0	0	11	0	0
18	5911732	.	C	A	1	2	3	0	0	3	0	0
18	5911749	.	G	T	2	2	4	0	0	4	0	0
18	5911794	.	C	A	1	2	3	0	0	3	0	0
18	5962151	.	A	C	2	3	5	0	3	8	0	0
18	5962163	.	G	A	1	4	5	0	3	8	0	0
18	6056879	.	G	A	0	2	2	0	1	3	0	0
18	6056880	.	A	T	1	2	3	0	0	3	0	0
18	6075821	.	T	G	1	2	3	0	0	3	0	0
18	6076429	.	G	A	1	2	3	0	0	3	0	0
18	6076992	.	C	T	3	3	6	0	2	8	0	0
18	6077555	.	C	A	2	3	5	0	0	5	0	0
18	6077645	.	A	T	4	2	6	0	0	6	0	0
18	6077861	.	G	T	0	2	2	0	1	3	0	0
18	6078032	.	T	A	2	2	4	0	1	5	0	0
18	6078059	.	G	A	2	2	4	0	0	4	0	0
18	6079374	.	G	T	4	6	10	0	1	11	0	0
18	6079864	.	T	C	7	12	19	0	0	19	0	0
18	6080197	.	A	T	6	5	11	0	0	11	0	0
18	6080272	.	A	G	2	5	7	0	0	7	0	0
18	6080334	.	A	G	4	0	4	0	3	7	0	0
18	6082054	.	C	T	11	8	19	0	0	19	0	0
18	6431858	.	G	A	5	5	10	0	0	10	0	0
18	6433116	.	G	A	0	5	5	0	1	6	0	0
18	6443966	.	G	T	3	3	6	0	0	6	0	0
18	6443971	.	A	G	2	4	6	0	0	6	0	0
18	6447147	.	C	T	0	2	2	0	1	3	0	0
18	6458416	.	C	G	2	3	5	0	0	5	0	0
18	6458437	.	G	C	2	0	2	0	3	5	0	0
18	6458488	.	G	A	4	4	8	0	0	8	0	0
18	6458516	.	G	T	5	3	8	0	1	9	0	0
18	6458653	.	G	A	4	4	8	0	0	8	0	0
18	6458729	.	T	G	3	4	7	0	0	7	0	0
18	6490751	.	T	C	7	8	15	0	0	15	0	0
18	6498963	.	G	A	0	4	4	0	5	9	0	0
18	6499118	.	A	C	6	6	12	0	0	12	0	0
18	6499129	.	C	T	4	4	8	0	3	11	0	0
18	6536402	.	G	A	17	18	35	0	5	40	0	0
18	6536439	.	G	T	17	18	35	0	3	38	0	0
18	6536459	.	T	C	18	15	33	0	0	33	0	0
18	6536475	.	A	T	14	16	30	0	2	32	0	0
18	6536548	.	G	A	12	10	22	0	0	22	0	0
18	6536640	.	C	T	9	10	19	0	1	20	0	0
18	6536689	.	G	A	8	10	18	0	1	19	0	0
18	6536704	.	T	A	10	5	15	0	1	16	0	0
18	6537731	.	T	C	7	5	12	0	1	13	0	0
18	6537755	.	C	T	9	6	15	0	1	16	0	0
18	6538916	.	C	T	12	15	27	0	1	28	0	0
18	6546164	.	C	T	20	19	39	0	4	43	0	0
18	6549378	.	A	T	18	25	43	0	2	45	0	0
18	6549381	.	T	A	19	24	43	0	0	43	0	0
18	6549778	.	T	A	24	12	36	0	2	38	0	0
18	6549810	.	G	A	19	11	30	0	4	34	0	0
18	6549816	.	C	T	16	18	34	0	0	34	0	0
18	6639142	.	G	C	4	3	7	1	0	8	0	0
18	6642428	.	A	G	6	0	6	1	7	14	0	0
18	6644128	.	C	T	5	6	11	0	0	11	0	0
18	6646411	.	C	T	8	14	22	0	0	22	0	0
18	6657152	.	G	A	11	3	14	1	0	15	0	0
18	6657180	.	C	T	3	13	16	1	1	18	0	0
18	6676868	.	A	C	11	11	22	0	2	24	0	0
18	6679429	.	A	T	14	15	29	0	2	31	0	0
18	6682072	.	C	T	12	13	25	0	0	25	0	0
18	6699939	.	C	T	12	18	30	0	0	30	0	0
18	6699999	.	G	A	15	20	35	0	3	38	0	0
18	6702530	.	G	A	14	28	42	1	1	44	0	0
18	6702966	.	T	C	14	18	32	0	0	32	0	0
18	6703023	.	G	A	2	13	15	0	15	30	0	0
18	6703181	.	A	C	12	21	33	0	0	33	0	0
18	6703328	.	G	A	11	24	35	0	0	35	0	0
18	6724713	.	T	C	0	2	2	0	1	3	0	0
18	6727443	.	C	A	1	2	3	0	0	3	0	0
18	6727469	.	T	C	2	3	5	0	0	5	0	0
18	6727558	.	C	T	4	5	9	0	1	10	0	0
18	6727559	.	T	G	5	5	10	0	0	10	0	0
18	6727612	.	A	G	4	5	9	0	0	9	0	0
18	6727613	.	T	A	5	4	9	0	0	9	0	0
18	6727689	.	C	A	5	4	9	0	0	9	0	0
18	6815876	.	A	G	6	4	10	0	1	11	0	0
18	6815938	.	C	A	1	4	5	0	1	6	0	0
18	6815950	.	A	G	3	3	6	0	0	6	0	0
18	6822082	.	A	G	4	6	10	0	0	10	0	0
18	6822085	.	A	G	4	6	10	0	0	10	0	0
18	6822202	.	C	T	5	5	10	0	1	11	0	0
18	6823672	.	G	A	6	6	12	0	0	12	0	0
18	6823951	.	G	A	7	10	17	0	1	18	0	0
18	6824496	.	C	A	8	4	12	0	0	12	0	0
18	6827174	.	T	C	5	7	12	0	0	12	0	0
18	6827183	.	A	G	4	8	12	0	2	14	0	0
18	6828898	.	T	A	5	4	9	0	2	12	1	0
18	6830465	.	C	G	6	4	10	0	0	10	0	0
18	6833196	.	G	A	7	5	12	0	0	12	0	0
18	6835836	.	A	C	7	3	10	0	2	12	0	0
18	6842193	.	G	A	5	7	12	0	0	12	0	0
18	6851388	.	A	G	2	7	9	0	0	9	0	0
18	6857229	.	C	A	24	17	41	0	3	44	0	0
18	6860756	.	T	C	16	20	36	0	0	36	0	0
18	6863034	.	T	C	18	20	38	5	1	44	0	0
18	6866414	.	A	G	24	0	24	0	20	44	0	0
18	6868176	.	G	C	18	22	40	0	1	41	0	0
18	6868188	.	A	G	17	17	34	0	3	37	0	0
18	6868224	.	A	G	20	2	22	0	16	38	0	0
18	6868297	.	A	T	20	17	37	0	2	39	0	0
18	6868623	.	G	A	18	26	44	0	3	47	0	0
18	6868928	.	G	A	22	29	51	0	9	60	0	0
18	6868969	.	G	A	6	31	37	1	29	67	0	0
18	6868971	.	A	G	24	7	31	1	34	66	0	0
18	6869022	.	T	C	25	35	60	1	6	67	0	0
18	6869035	.	C	T	39	25	64	0	2	66	0	0
18	6869410	.	A	G	3	6	9	0	10	19	0	0
18	7015600	.	T	C	4	2	6	0	0	6	0	0
18	7099981	.	A	G	3	3	6	0	0	6	0	0
18	7101377	.	A	G	2	1	3	0	0	3	0	0
18	7101394	.	T	G	0	3	3	0	0	3	0	0
18	7102356	.	T	A	1	5	6	0	0	6	0	0
18	7562237	.	T	C	1	7	8	0	0	8	0	0
18	7562243	.	A	T	6	2	8	0	1	9	0	0
18	7571381	.	C	T	1	3	4	0	0	4	0	0
18	7571412	.	A	G	1	2	3	0	0	3	0	0
18	7571548	.	T	C	1	4	5	0	0	5	0	0
18	7571628	.	C	T	2	5	7	0	2	9	0	0
18	7571657	.	A	G	5	2	7	1	0	8	0	0
18	8337707	.	C	T	2	10	12	0	0	12	0	0
18	9566183	.	G	A	3	2	5	0	0	5	0	0
18	10693123	.	C	T	3	6	9	0	0	9	0	0
18	10693322	.	A	T	5	3	8	0	0	8	0	0
18	10698083	.	T	C	9	6	15	0	2	17	0	0
18	10698161	.	T	G	5	7	12	0	1	13	0	0
18	10703669	.	A	G	3	6	9	0	0	9	0	0
18	10708346	.	G	A	2	3	5	0	0	5	0	0
18	10710190	.	C	T	0	3	3	0	2	5	0	0
18	10713310	.	T	C	1	3	4	0	0	4	0	0
18	10820428	.	A	C	4	5	9	0	0	9	0	0
18	10825951	.	A	G	4	10	14	0	0	14	0	0
18	10840094	.	C	A	7	2	9	1	1	11	0	0
18	10840722	.	C	G	1	8	9	0	0	10	1	0
18	10846601	.	T	C	11	8	19	0	0	19	0	0
18	10847743	.	C	T	9	8	17	0	0	17	0	0
18	10847872	.	A	G	10	7	17	0	2	19	0	0
18	10867181	.	A	C	12	5	17	0	0	18	1	0
18	10870806	.	T	C	10	11	21	0	1	22	0	0
18	10877499	.	G	A	10	8	18	0	0	18	0	0
18	10879495	.	G	A	6	2	8	1	1	10	0	0
18	10887826	.	A	G	3	10	13	0	0	13	0	0
18	10888245	.	A	C	1	6	7	0	0	7	0	0
18	10888551	.	T	C	8	4	12	0	0	12	0	0
18	10888836	.	T	C	8	9	17	0	0	17	0	0
18	10889049	.	C	G	3	0	3	0	8	11	0	0
18	10889901	.	T	A	7	3	10	0	1	11	0	0
18	10889951	.	G	A	6	7	13	1	0	14	0	0
18	10890432	.	G	A	10	10	20	0	0	20	0	0
18	10921408	.	A	T	13	8	21	0	1	22	0	0
18	10921630	.	A	T	6	10	16	0	0	16	0	0
18	10921734	.	T	C	11	10	21	0	2	23	0	0
18	10921791	.	T	C	9	15	24	0	3	27	0	0
18	10921855	.	T	C	10	7	17	0	2	19	0	0
18	10921857	.	G	A	2	7	9	0	11	20	0	0
18	10921927	.	C	T	14	8	22	0	0	22	0	0
18	11016209	.	G	A	2	2	4	0	0	4	0	0
18	11184522	.	G	A	1	4	5	0	0	5	0	0
18	11507263	.	G	A	2	6	8	0	0	8	0	0
18	11515830	.	C	T	5	3	8	0	0	8	0	0
18	11537535	.	T	C	2	2	4	0	0	4	0	0
18	11541046	.	A	G	7	3	10	0	0	10	0	0
18	12058480	.	T	A	4	4	8	0	0	8	0	0
18	12105432	.	T	C	2	4	6	0	1	7	0	0
18	12105548	.	G	A	0	2	2	0	4	6	0	0
18	12111431	.	A	C	5	2	7	0	0	7	0	0
18	12111772	.	A	C	3	3	6	0	0	6	0	0
18	12111784	.	G	T	4	3	7	0	0	7	0	0
18	12111925	.	G	A	2	6	8	0	0	8	0	0
18	12112153	.	T	C	2	4	6	0	0	6	0	0
18	12112219	.	C	T	6	7	13	0	1	14	0	0
18	12112246	.	A	G	5	0	5	0	12	17	0	0
18	12112726	.	C	T	9	6	15	0	0	15	0	0
18	12112750	.	G	A	8	5	13	0	1	14	0	0
18	12113515	.	C	A	9	8	17	0	1	19	1	0
18	12113516	.	C	T	9	8	17	0	2	19	0	0
18	12171277	.	C	T	3	4	7	0	0	7	0	0
18	12171313	.	A	G	4	1	5	0	4	9	0	0
18	12196939	.	G	A	0	3	3	0	4	7	0	0
18	12207046	.	A	G	3	7	10	0	0	10	0	0
18	12207070	.	C	A	8	4	12	0	0	12	0	0
18	12214299	.	A	G	9	5	14	0	0	14	0	0
18	12228217	.	C	A	10	4	14	0	0	14	0	0
18	12228758	.	C	T	5	7	12	0	0	12	0	0
18	12228834	.	G	C	4	10	14	0	1	15	0	0
18	12229120	.	A	T	5	6	11	0	0	11	0	0
18	12229223	.	A	C	2	3	5	0	1	6	0	0
18	12229245	.	C	T	3	3	6	0	0	6	0	0
18	12229405	.	G	A	8	4	12	0	0	12	0	0
18	12236113	.	G	A	1	4	5	0	0	5	0	0
18	12236351	.	C	T	4	12	16	0	0	16	0	0
18	12238082	.	G	A	8	7	15	0	0	15	0	0
18	12238296	.	A	G	7	8	15	0	1	16	0	0
18	12240681	.	C	T	10	4	14	0	0	14	0	0
18	12240740	.	G	C	9	4	13	0	1	14	0	0
18	12242967	.	C	T	1	7	8	0	7	15	0	0
18	12244667	.	G	A	4	3	7	0	0	7	0	0
18	12245576	.	A	G	4	3	7	0	1	8	0	0
18	12250727	.	G	A	5	4	9	0	0	9	0	0
18	12255012	.	T	C	1	5	6	0	0	6	0	0
18	12256647	.	A	G	3	4	7	0	0	7	0	0
18	12259919	.	G	A	1	2	3	0	0	3	0	0
18	12276859	.	C	T	15	9	24	0	0	24	0	0
18	12277052	.	A	G	9	6	15	0	2	17	0	0
18	12277206	.	G	C	13	13	26	0	2	28	0	0
18	12277490	.	G	A	28	14	42	0	1	43	0	0
18	12280269	.	C	T	26	21	47	0	2	49	0	0
18	12292017	.	G	A	24	15	39	0	0	40	1	0
18	12327321	.	C	A	0	4	4	0	5	9	0	0
18	12364876	.	G	A	5	2	7	0	0	7	0	0
18	12366097	.	G	T	1	2	3	0	0	3	0	0
18	12366171	.	C	G	4	4	8	0	0	8	0	0
18	12370573	.	T	G	1	2	3	0	1	4	0	0
18	12464867	.	C	A	7	2	9	0	0	9	0	0
18	12465290	.	G	A	11	6	17	0	0	17	0	0
18	12465316	.	C	T	10	7	17	0	0	17	0	0
18	12467834	.	G	C	6	0	6	0	6	12	0	0
18	12470013	.	G	T	6	7	13	0	0	13	0	0
18	12470136	.	G	A	8	9	17	0	1	18	0	0
18	12470148	.	A	G	9	8	17	0	2	19	0	0
18	12470211	.	C	T	3	5	8	0	6	14	0	0
18	12471210	.	T	C	3	5	8	0	0	8	0	0
18	12495185	.	C	T	5	6	11	0	0	11	0	0
18	12612031	.	C	T	1	4	5	0	1	6	0	0
18	12612160	.	A	G	3	2	5	0	0	5	0	0
18	12653846	.	G	C	2	4	6	0	0	6	0	0
18	12659197	.	C	T	5	2	7	0	0	7	0	0
18	12659226	.	C	T	3	2	5	0	0	5	0	0
18	12776727	.	C	T	5	3	8	0	1	9	0	0
18	12779357	.	T	A	5	9	14	0	1	15	0	0
18	12828500	.	C	T	6	5	11	0	1	12	0	0
18	12833894	.	A	G	5	5	10	0	0	10	0	0
18	12833983	.	A	T	1	6	7	0	0	7	0	0
18	12867505	.	A	G	3	4	7	0	0	7	0	0
18	12867594	.	C	T	0	6	6	0	3	9	0	0
18	12867807	.	G	A	2	4	6	0	0	6	0	0
18	12871545	.	G	T	7	9	16	0	0	16	0	0
18	12871605	.	C	T	0	6	6	0	6	12	0	0
18	12871650	.	G	A	7	3	10	0	1	11	0	0
18	12907570	.	T	C	2	4	6	0	1	7	0	0
18	12949899	.	A	G	3	2	5	0	0	5	0	0
18	12949932	.	C	T	1	2	3	0	1	4	0	0
18	12979864	.	C	T	3	3	6	0	0	6	0	0
18	13063534	.	G	A	17	8	25	0	1	26	0	0
18	13085721	.	C	T	3	2	5	0	0	5	0	0
18	13121754	.	G	A	11	4	15	0	1	16	0	0
18	13125829	.	G	A	8	4	12	0	0	12	0	0
18	13125836	.	G	T	5	5	10	0	0	10	0	0
18	13133040	.	C	T	6	6	12	0	1	13	0	0
18	13196113	.	A	G	2	2	4	0	0	4	0	0
18	13196274	.	T	C	4	0	4	0	5	9	0	0
18	13196285	.	A	G	4	4	8	0	0	8	0	0
18	13215966	.	G	A	24	20	44	0	3	47	0	0
18	13216051	.	C	T	15	13	28	0	3	31	0	0
18	13216566	.	T	A	8	10	18	0	0	18	0	0
18	13238078	.	G	A	1	2	3	0	5	8	0	0
18	13240208	.	T	A	3	3	6	0	1	7	0	0
18	13245795	.	G	A	9	5	14	0	2	16	0	0
18	13245803	.	A	G	9	7	16	0	0	16	0	0
18	13324391	.	G	A	17	12	29	0	0	29	0	0
18	13324416	.	T	C	13	17	30	0	0	30	0	0
18	13324473	.	G	A	20	24	44	0	0	44	0	0
18	13324494	.	T	C	23	0	23	0	19	42	0	0
18	13324747	.	A	G	27	21	48	0	1	49	0	0
18	13325224	.	A	G	18	20	38	0	3	41	0	0
18	13325225	.	C	T	21	17	38	0	3	41	0	0
18	13325451	.	G	T	16	23	39	0	2	41	0	0
18	13325492	.	C	T	21	13	34	0	0	34	0	0
18	13325679	.	C	T	2	10	12	0	11	23	0	0
18	13325912	.	G	A	15	8	23	0	0	23	0	0
18	13326124	.	A	C	11	0	11	0	13	24	0	0
18	13326178	.	G	T	12	10	22	0	0	22	0	0
18	13326400	.	C	T	1	5	6	0	7	13	0	0
18	13326593	.	G	C	17	19	36	0	0	36	0	0
18	13336278	.	G	A	10	6	16	0	0	16	0	0
18	13339013	.	T	A	7	2	9	0	0	9	0	0
18	13345001	.	C	G	12	7	19	0	0	19	0	0
18	13345088	.	G	A	8	13	21	0	0	21	0	0
18	13345166	.	A	C	10	0	10	0	16	26	0	0
18	13347733	.	G	A	8	9	17	0	0	17	0	0
18	13356438	.	A	G	13	7	20	0	2	22	0	0
18	13888370	.	A	T	5	6	11	0	4	15	0	0
18	13888406	.	G	A	6	9	15	0	0	15	0	0
18	14041036	.	C	T	10	11	21	0	2	23	0	0
18	14075262	.	A	G	20	11	31	1	0	32	0	0
18	14114915	.	G	A	13	11	24	0	2	26	0	0
18	14114930	.	C	T	12	14	26	0	1	27	0	0
18	14115011	.	A	G	24	13	37	0	1	38	0	0
18	14115083	.	G	C	24	25	49	0	2	51	0	0
18	14132006	.	G	A	5	22	27	0	25	52	0	0
18	14132077	.	A	T	37	18	55	0	2	57	0	0
18	14132360	.	G	A	1	25	26	0	16	42	0	0
18	14132836	.	A	G	25	10	35	0	0	35	0	0
18	14132892	.	T	C	29	13	42	0	2	44	0	0
18	14244428	.	T	A	1	2	3	0	0	3	0	0
18	14244437	.	G	C	1	2	3	0	0	3	0	0
18	14244508	.	C	T	1	1	2	0	1	3	0	0
18	14334468	.	A	T	15	7	22	0	3	25	0	0
18	14337320	.	T	A	24	23	47	0	0	47	0	0
18	14529721	.	T	C	1	2	3	0	1	4	0	0
18	14529971	.	A	T	3	4	7	0	0	7	0	0
18	14530273	.	T	A	4	2	6	0	0	6	0	0
18	14632896	.	T	C	3	2	5	0	0	5	0	0
18	14632905	.	A	T	4	2	6	0	0	6	0	0
18	14633131	.	T	C	7	3	10	0	0	10	0	0
18	14637888	.	T	C	2	7	9	0	1	10	0	0
18	14642018	.	T	C	1	4	5	0	0	5	0	0
18	14642970	.	A	C	3	3	6	0	0	6	0	0
18	14647432	.	C	T	3	7	10	0	0	10	0	0
18	14648859	.	C	A	8	5	13	0	0	13	0	0
18	14649227	.	G	A	0	7	7	0	7	14	0	0
18	14649408	.	A	T	5	6	11	0	0	11	0	0
18	14652676	.	A	G	3	0	3	0	5	8	0	0
18	14660205	.	C	G	6	3	9	2	0	11	0	0
18	14672230	.	G	A	2	3	5	0	1	6	0	0
18	14672353	.	A	G	6	6	12	0	0	12	0	0
18	14672542	.	A	T	3	4	7	0	0	7	0	0
18	14688757	.	A	G	6	2	8	0	0	8	0	0
18	14690967	.	G	A	4	3	7	0	0	7	0	0
18	14691037	.	T	C	5	3	8	0	0	8	0	0
18	14691133	.	T	C	3	5	8	0	0	8	0	0
18	14691269	.	A	T	4	4	8	0	1	9	0	0
18	14691634	.	G	C	4	6	10	0	0	10	0	0
18	14698371	.	C	T	8	6	14	0	2	16	0	0
18	14698538	.	A	G	6	16	22	0	2	25	1	0
18	14698860	.	A	C	10	8	18	1	2	21	0	0
18	14698928	.	G	T	10	9	19	0	0	19	0	0
18	14699012	.	T	A	9	7	16	0	3	19	0	0
18	14700684	.	A	G	8	2	10	0	6	16	0	0
18	14700731	.	A	T	14	9	23	0	0	23	0	0
18	14702427	.	G	A	6	15	21	0	5	26	0	0
18	14702439	.	T	C	7	18	25	0	0	25	0	0
18	14702511	.	G	T	4	10	14	0	18	32	0	0
18	14705287	.	T	C	14	10	24	0	1	25	0	0
18	14705308	.	A	G	13	12	25	0	1	26	0	0
18	14705371	.	T	C	13	14	27	0	1	28	0	0
18	14705518	.	G	A	1	11	12	0	8	20	0	0
18	14705578	.	G	T	6	3	9	0	0	9	0	0
18	14731967	.	T	C	16	0	16	0	16	32	0	0
18	14732128	.	G	A	14	8	22	0	0	22	0	0
18	14732809	.	T	C	6	6	12	0	2	14	0	0
18	14732840	.	T	G	11	6	17	0	3	20	0	0
18	14732859	.	C	T	2	5	7	0	13	20	0	0
18	14732885	.	T	C	17	9	26	0	1	27	0	0
18	14732903	.	T	A	16	9	25	0	0	25	0	0
18	14732923	.	G	A	13	9	22	0	0	22	0	0
18	14732996	.	T	C	6	9	15	0	0	15	0	0
18	14733019	.	C	A	7	10	17	0	1	18	0	0
18	14733114	.	A	T	7	4	11	0	3	14	0	0
18	14733362	.	G	A	7	6	13	0	0	13	0	0
18	14733402	.	C	T	6	6	12	0	0	12	0	0
18	14733561	.	A	T	6	8	14	0	0	14	0	0
18	14733638	.	A	G	13	4	17	0	0	17	0	0
18	14733839	.	A	G	1	4	5	0	0	5	0	0
18	14734651	.	C	T	4	4	8	0	0	8	0	0
18	14772889	.	A	G	2	6	8	0	0	8	0	0
18	14772957	.	A	T	7	6	13	0	1	14	0	0
18	14773020	.	T	A	7	4	11	0	1	12	0	0
18	14773140	.	C	T	13	7	20	0	0	20	0	0
18	14779135	.	T	C	2	0	2	0	6	8	0	0
18	14779171	.	G	A	4	6	10	0	0	10	0	0
18	14779192	.	A	G	5	6	11	0	0	11	0	0
18	14780608	.	G	T	5	4	9	0	1	10	0	0
18	14780644	.	A	G	6	3	9	0	0	9	0	0
18	14780650	.	G	C	5	3	8	0	1	9	0	0
18	14836628	.	C	G	1	2	3	0	0	3	0	0
18	14836678	.	C	T	2	5	7	1	0	8	0	0
18	14836684	.	G	A	2	5	7	1	0	8	0	0
18	14836744	.	T	C	2	3	5	0	0	5	0	0
18	14863675	.	A	G	3	4	7	0	0	7	0	0
18	14863680	.	T	A	3	4	7	0	0	7	0	0
18	14866506	.	G	A	2	8	10	0	0	10	0	0
18	14866536	.	C	A	5	7	12	0	0	12	0	0
18	14867044	.	T	C	7	0	7	0	8	15	0	0
18	14867144	.	A	C	11	0	11	0	4	15	0	0
18	14878673	.	A	C	2	2	4	0	0	4	0	0
18	14878724	.	C	T	1	1	2	0	4	6	0	0
18	14878790	.	A	G	2	3	5	0	0	5	0	0
18	14886018	.	G	A	1	6	7	0	0	7	0	0
18	14886129	.	C	T	1	2	3	0	0	3	0	0
18	14893764	.	A	G	1	3	4	0	0	4	0	0
18	14900455	.	A	T	1	2	3	0	0	3	0	0
18	14909768	.	G	A	9	5	14	0	1	15	0	0
18	14909831	.	A	T	5	4	9	0	0	9	0	0
18	14910929	.	A	G	5	2	7	0	0	7	0	0
18	14911370	.	A	G	1	2	3	0	1	4	0	0
18	14911379	.	T	A	2	2	4	0	0	4	0	0
18	14917016	.	T	C	2	0	2	0	3	5	0	0
18	14928654	.	C	T	3	2	5	0	0	5	0	0
18	14928681	.	T	C	3	3	6	0	0	6	0	0
18	14928703	.	C	T	0	2	2	0	2	4	0	0
18	14969931	.	C	A	0	2	2	0	2	4	0	0
18	14979139	.	G	A	2	2	4	0	0	4	0	0
18	14984213	.	G	T	1	2	3	0	0	3	0	0
18	15100693	.	G	A	1	2	3	0	0	3	0	0
18	15101254	.	G	A	2	2	4	0	0	4	0	0
18	15121465	.	G	A	0	2	2	0	4	6	0	0
18	15122894	.	C	T	3	3	6	0	0	6	0	0
18	15122915	.	G	A	0	3	3	0	4	7	0	0
18	15123008	.	C	A	2	6	8	0	2	10	0	0
18	15123011	.	A	G	4	6	10	0	0	10	0	0
18	15125122	.	G	A	6	5	11	0	0	11	0	0
18	15125193	.	A	C	4	5	9	0	0	9	0	0
18	15125418	.	C	A	8	7	15	0	0	15	0	0
18	15128960	.	T	C	6	5	11	0	0	11	0	0
18	15129522	.	T	A	1	2	3	0	0	3	0	0
18	15132372	.	T	C	4	6	10	0	0	10	0	0
18	15132383	.	T	C	4	6	10	0	0	10	0	0
18	15134001	.	A	G	4	2	6	0	0	6	0	0
18	15136657	.	A	G	3	0	3	0	4	7	0	0
18	15139004	.	T	A	3	6	9	0	0	9	0	0
18	15139049	.	A	G	6	0	6	0	6	12	0	0
18	15139540	.	C	T	8	7	15	0	1	16	0	0
18	15139757	.	G	A	9	6	15	0	0	15	0	0
18	15139784	.	T	C	4	4	8	0	1	9	0	0
18	15148248	.	T	C	4	4	8	0	2	10	0	0
18	15148259	.	A	C	6	4	10	0	0	10	0	0
18	15148290	.	A	C	3	3	6	0	0	6	0	0
18	15148304	.	T	C	2	0	2	0	3	5	0	0
18	15148886	.	G	A	6	2	8	0	0	8	0	0
18	15148912	.	A	G	3	3	6	0	1	7	0	0
18	15148954	.	T	C	3	4	7	0	0	7	0	0
18	15148985	.	A	G	2	4	6	0	0	6	0	0
18	15149475	.	T	C	5	0	5	0	3	8	0	0
18	15149813	.	T	A	4	2	6	0	0	6	0	0
18	15150207	.	G	A	4	2	6	0	0	6	0	0
18	15150442	.	C	T	1	2	3	0	0	3	0	0
18	15285346	.	C	T	3	2	5	0	0	5	0	0
18	15285508	.	T	C	1	3	4	0	0	4	0	0
18	15287709	.	A	G	4	6	10	0	0	10	0	0
18	15289737	.	T	C	4	3	7	0	0	7	0	0
18	15289895	.	G	A	1	2	3	0	3	6	0	0
18	15295925	.	C	T	0	7	7	0	12	19	0	0
18	15296062	.	G	A	11	4	15	0	0	15	0	0
18	15320831	.	T	C	3	0	3	0	5	8	0	0
18	15383683	.	C	T	6	3	9	0	0	9	0	0
18	15393324	.	G	A	2	2	4	0	1	5	0	0
18	15393787	.	C	G	6	2	8	0	0	8	0	0
18	15395535	.	A	G	5	4	9	0	0	9	0	0
18	15410687	.	G	A	2	3	5	0	0	5	0	0
18	15459835	.	T	A	3	5	8	1	0	9	0	0
18	15459871	.	C	T	3	2	5	0	0	5	0	0
18	15469907	.	T	C	6	5	11	0	1	12	0	0
18	15470114	.	T	G	4	3	7	0	2	9	0	0
18	15478597	.	A	G	3	3	6	0	0	6	0	0
18	15481364	.	T	G	1	3	4	0	0	4	0	0
18	15481636	.	C	T	5	4	9	0	0	9	0	0
18	15483994	.	C	T	3	2	5	0	0	5	0	0
18	15571032	.	A	G	4	2	6	0	0	6	0	0
18	15573490	.	G	T	3	1	4	0	1	5	0	0
18	15792294	.	T	G	20	12	32	0	2	34	0	0
18	15792368	.	G	C	22	19	41	0	3	44	0	0
18	15792459	.	A	C	22	22	44	0	1	45	0	0
18	15792596	.	T	A	28	20	48	0	1	49	0	0
18	15792611	.	A	G	29	17	46	0	2	48	0	0
18	15792743	.	T	A	24	16	40	0	1	41	0	0
18	15793064	.	A	G	5	8	13	0	0	13	0	0
18	15829588	.	A	G	5	6	11	0	0	11	0	0
18	15836835	.	A	G	7	4	11	1	0	12	0	0
18	15836917	.	A	G	7	6	13	0	2	15	0	0
18	15836961	.	C	T	7	8	15	0	0	15	0	0
18	15858916	.	G	A	1	3	4	0	0	4	0	0
18	15863558	.	G	A	1	1	2	0	1	3	0	0
18	15865154	.	T	C	2	2	4	0	0	4	0	0
18	15865196	.	C	G	2	5	7	0	0	7	0	0
18	15866874	.	T	G	1	3	4	0	0	4	0	0
18	15866876	.	G	T	1	3	4	0	0	4	0	0
18	15869816	.	C	A	4	3	7	0	0	7	0	0
18	15869854	.	T	G	4	0	4	0	4	8	0	0
18	15872092	.	A	G	2	2	4	0	0	4	0	0
18	15872397	.	G	C	2	3	5	0	0	5	0	0
18	15872435	.	A	G	2	4	6	0	0	6	0	0
18	15872452	.	G	A	2	2	4	0	0	4	0	0
18	15875196	.	G	A	10	5	15	0	0	15	0	0
18	16111354	.	T	G	1	3	4	0	0	4	0	0
18	16127885	.	A	G	17	12	29	0	5	34	0	0
18	16127927	.	A	C	16	14	30	0	2	32	0	0
18	16128427	.	T	A	4	4	8	0	0	8	0	0
18	16128730	.	A	G	12	6	18	0	0	18	0	0
18	16128960	.	T	G	19	17	36	0	0	36	0	0
18	16129149	.	C	T	4	16	20	0	1	21	0	0
18	16129210	.	A	C	27	9	36	0	1	38	1	0
18	16129583	.	T	A	13	25	38	0	2	40	0	0
18	16129862	.	C	T	19	15	34	0	1	35	0	0
18	16133772	.	C	G	9	6	15	0	1	16	0	0
18	16133773	.	T	A	9	7	16	0	0	16	0	0
18	16133822	.	T	C	5	8	13	0	1	14	0	0
18	16140047	.	G	A	12	4	16	0	0	16	0	0
18	16140337	.	G	T	2	19	21	0	17	38	0	0
18	16145618	.	T	G	30	17	47	0	2	49	0	0
18	16145621	.	C	T	28	17	45	0	2	47	0	0
18	16145994	.	C	G	3	3	6	0	0	6	0	0
18	16151809	.	T	A	6	3	9	0	0	9	0	0
18	16151936	.	G	A	6	7	13	0	0	13	0	0
18	16152149	.	G	A	11	4	15	0	0	15	0	0
18	16153487	.	T	C	7	0	7	0	10	17	0	0
18	16158279	.	G	T	3	4	7	0	0	7	0	0
18	16388195	.	G	A	3	8	11	0	0	11	0	0
18	16388342	.	G	A	2	4	6	0	1	7	0	0
18	16388747	.	T	C	1	2	3	0	1	4	0	0
18	16388825	.	A	G	3	3	6	0	0	6	0	0
18	16391712	.	G	A	2	5	7	0	0	7	0	0
18	16490700	.	A	C	3	2	5	0	0	5	0	0
18	16719963	.	T	C	9	10	19	0	2	21	0	0
18	16720197	.	G	A	9	9	18	0	1	19	0	0
18	16721705	.	G	A	21	20	41	0	1	42	0	0
18	16721741	.	G	A	17	21	38	0	2	40	0	0
18	16722124	.	G	A	26	17	43	0	0	44	1	0
18	16722584	.	G	A	17	12	29	0	1	30	0	0
18	16723514	.	T	C	17	19	36	0	0	36	0	0
18	16723520	.	A	G	15	0	15	0	19	34	0	0
18	16723785	.	A	G	14	1	15	0	17	32	0	0
18	16725225	.	G	A	2	23	25	0	17	42	0	0
18	16725917	.	A	G	14	10	24	0	0	24	0	0
18	16726011	.	C	T	8	13	21	0	1	22	0	0
18	16755962	.	C	A	23	18	41	0	1	42	0	0
18	16756001	.	C	T	18	14	32	0	1	33	0	0
18	16756058	.	T	A	12	14	26	0	0	26	0	0
18	16756065	.	G	A	13	11	24	0	1	25	0	0
18	16876903	.	A	G	2	8	10	0	0	10	0	0
18	16885979	.	T	G	10	4	14	0	0	14	0	0
18	16886079	.	C	T	7	5	12	0	0	12	0	0
18	16894571	.	T	A	8	5	13	0	1	14	0	0
18	16894594	.	T	G	7	7	14	0	0	14	0	0
18	16894630	.	A	G	4	5	9	0	1	10	0	0
18	16918725	.	G	A	1	2	3	0	0	3	0	0
18	16918760	.	C	A	1	2	3	0	0	3	0	0
18	16929772	.	G	A	9	13	22	1	0	23	0	0
18	16936429	.	G	A	2	2	4	0	0	4	0	0
18	16936562	.	G	A	2	3	5	0	0	5	0	0
18	16936787	.	A	G	6	2	8	0	0	8	0	0
18	16961046	.	A	G	24	10	34	3	0	37	0	0
18	16962778	.	A	G	13	6	19	0	2	21	0	0
18	16962783	.	C	T	13	7	20	0	0	20	0	0
18	16962823	.	C	T	10	10	20	0	1	21	0	0
18	16963091	.	C	G	12	12	24	0	0	24	0	0
18	16966911	.	T	C	13	15	28	0	0	28	0	0
18	16968314	.	T	C	20	14	34	0	1	35	0	0
18	16970059	.	G	A	6	3	9	0	0	9	0	0
18	16970455	.	A	T	13	6	19	0	0	19	0	0
18	16970459	.	G	A	1	7	8	0	13	21	0	0
18	16970598	.	C	T	17	5	22	0	0	22	0	0
18	16970747	.	A	C	1	1	2	0	2	4	0	0
18	16970795	.	A	T	4	4	8	0	0	8	0	0
18	16970912	.	T	C	13	4	17	0	0	17	0	0
18	16970916	.	T	C	13	4	17	0	0	17	0	0
18	16970997	.	G	C	3	11	14	0	15	29	0	0
18	16971129	.	C	T	15	13	28	0	0	28	0	0
18	16971155	.	A	T	7	6	13	0	1	14	0	0
18	16971255	.	T	A	2	2	4	0	0	4	0	0
18	16990122	.	C	T	1	2	3	0	0	3	0	0
18	16990150	.	G	T	2	2	4	0	0	4	0	0
18	16990385	.	A	C	5	0	5	0	6	11	0	0
18	16990520	.	C	T	4	3	7	0	1	8	0	0
18	16993352	.	A	T	2	3	5	0	0	5	0	0
18	17002614	.	T	C	6	1	7	0	6	13	0	0
18	17002653	.	A	G	11	7	18	0	0	18	0	0
18	17003602	.	A	G	6	8	14	0	0	14	0	0
18	17005917	.	T	C	3	3	6	0	0	6	0	0
18	17016613	.	G	A	3	4	7	0	0	7	0	0
18	17021805	.	C	T	1	1	2	0	1	3	0	0
18	17062226	.	G	A	5	2	7	0	0	7	0	0
18	17062227	.	G	A	4	2	6	0	1	7	0	0
18	17062336	.	T	C	1	2	3	0	0	3	0	0
18	17062364	.	T	G	1	4	5	0	0	5	0	0
18	17062487	.	G	T	3	2	5	0	0	5	0	0
18	17067757	.	G	C	2	2	4	0	0	4	0	0
18	17067826	.	G	C	1	0	1	0	3	4	0	0
18	17078593	.	T	C	2	4	6	0	0	6	0	0
18	17078946	.	A	G	1	2	3	0	0	3	0	0
18	17079541	.	T	C	17	12	29	2	0	31	0	0
18	17079724	.	C	T	2	7	9	0	6	15	0	0
18	17080089	.	G	C	6	11	17	0	0	17	0	0
18	17080122	.	A	G	6	8	14	0	1	15	0	0
18	17080131	.	T	C	4	0	4	0	13	17	0	0
18	17084489	.	C	T	1	7	8	0	8	16	0	0
18	17097893	.	T	C	9	10	19	0	1	20	0	0
18	17098317	.	T	A	2	10	12	0	1	13	0	0
18	17098562	.	T	A	12	10	22	0	0	22	0	0
18	17102046	.	C	T	0	5	5	0	7	12	0	0
18	17131006	.	A	G	8	6	14	0	0	14	0	0
18	17134780	.	A	G	2	4	6	0	0	6	0	0
18	17144659	.	C	T	2	1	3	0	1	4	0	0
18	17144909	.	T	A	6	5	11	0	0	11	0	0
18	17410317	.	G	A	1	2	3	0	0	3	0	0
18	17535741	.	A	T	0	10	10	0	0	10	0	0
18	17535748	.	A	T	5	2	7	0	5	12	0	0
18	19419200	.	A	T	7	12	19	0	2	21	0	0
18	19419307	.	C	T	13	10	23	0	0	23	0	0
18	19441492	.	C	G	13	20	33	0	0	33	0	0
18	19441561	.	T	C	14	13	27	0	2	29	0	0
18	19441585	.	C	A	18	13	31	0	1	32	0	0
18	19450486	.	T	C	29	31	60	0	1	61	0	0
18	19450563	.	A	T	25	43	68	0	1	69	0	0
18	19450642	.	A	T	16	27	43	0	4	47	0	0
18	19450692	.	A	G	22	15	37	2	3	42	0	0
18	19450755	.	A	G	31	27	58	2	4	64	0	0
18	19451023	.	C	T	17	22	39	0	0	39	0	0
18	19451117	.	C	T	8	9	17	0	4	21	0	0
18	19451427	.	G	A	52	25	77	0	3	81	1	0
18	19451430	.	T	C	51	5	56	0	23	79	0	0
18	19451477	.	G	A	28	44	72	0	7	79	0	0
18	19452126	.	T	A	42	28	70	0	1	71	0	0
18	19452594	.	G	A	27	37	64	0	5	69	0	0
18	19452639	.	A	G	20	44	64	0	2	66	0	0
18	19487779	.	G	A	20	14	34	0	1	35	0	0
18	19490515	.	C	T	18	23	41	0	2	43	0	0
18	19648878	.	T	C	1	2	3	0	0	3	0	0
18	19698539	.	C	T	3	2	5	1	0	6	0	0
18	19698833	.	T	C	2	3	5	0	0	5	0	0
18	19805440	.	T	C	2	6	8	0	0	8	0	0
18	19805464	.	C	T	1	4	5	0	0	5	0	0
18	19806135	.	T	G	1	4	5	0	0	5	0	0
18	19812874	.	T	C	5	12	17	0	2	19	0	0
18	19812943	.	A	T	13	12	25	0	0	25	0	0
18	19813002	.	A	G	11	11	22	0	2	24	0	0
18	19814181	.	A	G	8	6	14	0	1	15	0	0
18	19815743	.	A	T	7	7	14	0	0	14	0	0
18	19817682	.	G	A	5	6	11	0	1	12	0	0
18	19817717	.	G	A	5	3	8	0	0	8	0	0
18	19879866	.	A	G	1	2	3	0	0	3	0	0
18	19883812	.	G	T	1	10	11	0	10	21	0	0
18	19981553	.	G	A	2	3	5	0	0	5	0	0
18	20006910	.	C	T	1	3	4	0	0	4	0	0
18	20017114	.	T	C	1	7	8	0	0	8	0	0
18	20020108	.	A	T	3	2	5	0	1	6	0	0
18	20022806	.	T	C	5	5	10	0	0	10	0	0
18	20024856	.	T	C	4	3	7	0	2	9	0	0
18	20024889	.	G	A	1	7	8	0	0	8	0	0
18	20041825	.	T	C	18	9	27	0	1	28	0	0
18	20042088	.	C	T	20	12	32	0	0	32	0	0
18	20044847	.	T	C	8	7	15	0	0	15	0	0
18	20045197	.	T	C	2	2	4	0	0	4	0	0
18	20440913	.	T	A	1	2	3	0	0	3	0	0
18	20468514	.	G	T	0	5	5	0	6	11	0	0
18	20479008	.	A	G	5	3	8	0	1	9	0	0
18	20482471	.	C	G	1	4	5	0	0	5	0	0
18	20483701	.	C	A	2	2	4	0	0	4	0	0
18	20488465	.	G	C	2	2	4	0	0	4	0	0
18	20488492	.	C	T	1	2	3	0	1	4	0	0
18	20489011	.	T	C	1	5	6	0	0	6	0	0
18	20489348	.	G	A	1	2	3	0	1	4	0	0
18	20489580	.	G	A	1	2	3	0	0	3	0	0
18	20490370	.	A	C	3	2	5	0	0	5	0	0
18	20490493	.	G	A	4	1	5	0	0	5	0	0
18	20490510	.	A	T	3	2	5	0	1	6	0	0
18	20490544	.	T	A	4	2	6	0	0	6	0	0
18	20490672	.	G	A	2	3	5	0	0	5	0	0
18	20490690	.	A	T	2	3	5	0	0	5	0	0
18	20490715	.	A	G	0	1	1	0	0	1	0	0
18	20490768	.	A	T	2	2	4	0	0	4	0	0
18	20490872	.	A	C	1	2	3	0	0	3	0	0
18	20516907	.	T	C	2	0	2	0	4	6	0	0
18	20516911	.	A	G	0	6	6	0	0	6	0	0
18	20518915	.	C	G	3	4	7	0	0	7	0	0
18	20521053	.	T	G	3	4	7	0	0	7	0	0
18	20521431	.	A	T	1	3	4	0	0	4	0	0
18	20521515	.	C	G	4	4	8	0	0	8	0	0
18	20521713	.	G	A	2	2	4	0	1	5	0	0
18	20533934	.	G	A	8	5	13	0	0	13	0	0
18	20535074	.	T	A	11	7	18	0	2	20	0	0
18	20536533	.	A	G	7	0	7	0	5	12	0	0
18	20539548	.	G	A	1	7	8	0	6	14	0	0
18	20539844	.	T	A	3	2	5	0	0	5	0	0
18	20539979	.	T	A	3	8	11	0	0	11	0	0
18	20540313	.	G	T	4	3	7	0	0	7	0	0
18	20540581	.	G	T	5	3	8	0	0	8	0	0
18	20540606	.	A	T	3	3	6	0	1	7	0	0
18	20541575	.	A	C	3	4	7	0	1	8	0	0
18	20541863	.	C	G	1	3	4	0	0	4	0	0
18	20542214	.	A	T	3	2	5	0	2	7	0	0
18	20542503	.	G	A	16	8	24	0	0	24	0	0
18	20542526	.	G	A	16	7	23	0	1	24	0	0
18	20542647	.	C	T	12	8	20	0	0	20	0	0
18	20542899	.	T	A	6	11	17	0	0	17	0	0
18	20542929	.	T	C	8	11	19	0	1	20	0	0
18	20542988	.	T	G	9	6	15	0	0	15	0	0
18	20544883	.	G	A	8	3	11	0	0	11	0	0
18	20544901	.	G	C	5	9	14	0	0	14	0	0
18	20559571	.	G	A	7	3	10	0	0	10	0	0
18	20581942	.	A	G	1	2	3	0	0	3	0	0
18	20582629	.	T	C	3	12	15	0	0	15	0	0
18	20582943	.	G	A	5	4	9	0	0	9	0	0
18	20583398	.	C	T	3	6	9	0	1	10	0	0
18	20583479	.	T	C	5	3	8	0	0	8	0	0
18	20583551	.	T	C	4	0	4	0	3	7	0	0
18	20583610	.	A	T	4	2	6	0	0	6	0	0
18	20583639	.	A	G	2	3	5	0	0	5	0	0
18	20583763	.	A	G	3	8	11	0	0	11	0	0
18	20583820	.	A	T	1	2	3	0	1	4	0	0
18	20584077	.	G	A	2	2	4	0	0	4	0	0
18	20584797	.	G	A	4	6	10	0	0	10	0	0
18	20584801	.	C	T	4	4	8	0	2	10	0	0
18	20584986	.	T	G	2	2	4	0	0	4	0	0
18	20585314	.	C	T	11	9	20	0	1	21	0	0
18	20585435	.	T	C	6	0	6	1	3	10	0	0
18	20585495	.	C	T	3	4	7	0	0	7	0	0
18	20585837	.	G	A	5	5	10	0	0	10	0	0
18	20594104	.	G	A	5	3	8	0	0	8	0	0
18	20594149	.	G	A	2	2	4	0	0	4	0	0
18	20598263	.	C	T	3	2	5	0	0	5	0	0
18	20598286	.	T	C	2	2	4	0	0	4	0	0
18	20726232	.	T	C	27	4	31	0	20	51	0	0
18	20730583	.	G	A	11	16	27	0	1	28	0	0
18	20735371	.	C	T	15	16	31	0	1	32	0	0
18	20735413	.	C	T	2	16	18	0	12	30	0	0
18	20738244	.	T	A	8	15	23	0	2	25	0	0
18	20738262	.	A	G	9	13	22	0	1	23	0	0
18	20738298	.	G	A	10	10	20	0	1	21	0	0
18	20738383	.	G	A	15	15	30	0	1	31	0	0
18	20739298	.	C	T	9	10	19	0	1	20	0	0
18	20742025	.	G	A	13	15	28	0	0	28	0	0
18	20752879	.	C	T	1	10	11	0	10	22	1	0
18	20760425	.	C	T	13	11	24	0	0	24	0	0
18	20768686	.	C	T	9	10	19	0	1	20	0	0
18	20768818	.	T	A	9	9	18	0	0	18	0	0
18	20771078	.	T	C	5	0	5	0	4	9	0	0
18	20771085	.	A	G	5	4	9	0	0	9	0	0
18	20859790	.	A	G	2	1	3	0	1	4	0	0
18	20859802	.	A	G	1	1	2	0	2	4	0	0
18	20860321	.	C	T	1	5	6	0	1	7	0	0
18	20868503	.	C	G	2	3	5	0	0	5	0	0
18	20882098	.	C	T	2	2	4	0	0	4	0	0
18	20882195	.	T	A	1	3	4	0	0	4	0	0
18	20882237	.	C	G	4	3	7	0	0	7	0	0
18	20898711	.	G	C	2	2	4	0	0	4	0	0
18	20917327	.	T	G	1	2	3	0	0	3	0	0
18	20917352	.	T	C	2	2	4	0	0	4	0	0
18	20917407	.	T	C	1	2	3	0	1	4	0	0
18	21071085	.	A	G	5	0	5	0	8	13	0	0
18	21072834	.	C	T	2	2	4	0	0	4	0	0
18	21102019	.	A	C	7	4	11	0	1	12	0	0
18	21102023	.	C	T	0	4	4	0	6	10	0	0
18	21102764	.	C	T	0	4	4	0	2	6	0	0
18	21102914	.	G	A	1	2	3	0	1	4	0	0
18	21102994	.	G	A	0	3	3	0	0	3	0	0
18	21102995	.	A	T	1	2	3	0	1	4	0	0
18	21103043	.	G	A	4	3	7	0	0	7	0	0
18	21103079	.	G	A	3	4	7	0	0	7	0	0
18	21105927	.	A	G	5	2	7	0	0	7	0	0
18	21105945	.	G	A	5	2	7	0	0	7	0	0
18	21113533	.	G	A	1	3	4	0	1	5	0	0
18	21114475	.	T	C	4	5	9	0	0	9	0	0
18	21115175	.	C	T	6	4	10	0	0	10	0	0
18	21116381	.	C	A	13	4	17	0	0	17	0	0
18	21117801	.	C	T	8	14	22	0	0	22	0	0
18	21118232	.	C	G	15	6	21	0	1	22	0	0
18	21119498	.	G	A	10	3	13	0	0	13	0	0
18	21119654	.	G	A	7	10	17	0	1	18	0	0
18	21119751	.	C	T	13	12	25	0	0	25	0	0
18	21119854	.	T	C	4	7	11	0	1	12	0	0
18	21123001	.	A	G	6	0	6	0	4	10	0	0
18	21136729	.	C	T	11	12	23	0	0	23	0	0
18	21136948	.	C	T	16	15	31	0	0	31	0	0
18	21143473	.	A	T	19	15	34	0	1	35	0	0
18	21143787	.	C	A	9	14	23	0	1	24	0	0
18	21143938	.	C	G	13	20	33	0	0	33	0	0
18	21143998	.	C	T	16	15	31	0	1	32	0	0
18	21144005	.	C	A	17	9	26	0	1	27	0	0
18	21144060	.	G	A	1	12	13	0	22	35	0	0
18	21144748	.	T	C	4	2	6	0	0	6	0	0
18	21144758	.	C	A	5	3	8	0	0	8	0	0
18	21144800	.	A	T	1	6	7	0	0	7	0	0
18	21144823	.	C	A	6	2	8	0	2	10	0	0
18	21144852	.	A	G	14	6	20	0	1	21	0	0
18	21144880	.	G	T	11	17	28	0	1	29	0	0
18	21145142	.	A	G	10	11	21	0	2	23	0	0
18	21145290	.	G	T	9	5	14	0	0	14	0	0
18	21178836	.	C	T	2	6	8	0	0	8	0	0
18	21178865	.	T	G	7	2	9	0	1	10	0	0
18	21179135	.	T	C	4	4	8	0	0	8	0	0
18	21179158	.	G	C	6	7	13	0	0	13	0	0
18	21179181	.	A	T	7	8	15	0	1	16	0	0
18	21179228	.	G	C	5	9	14	0	0	14	0	0
18	21179369	.	T	C	19	16	35	0	1	36	0	0
18	21179484	.	G	A	16	13	29	0	1	30	0	0
18	21179566	.	T	C	12	11	23	0	3	26	0	0
18	21179709	.	A	C	8	8	16	3	0	19	0	0
18	21179730	.	A	G	8	12	20	3	0	23	0	0
18	21182879	.	A	G	8	7	15	0	1	16	0	0
18	21185167	.	A	G	12	10	22	0	0	22	0	0
18	21198961	.	G	T	12	17	29	0	0	29	0	0
18	21199165	.	G	T	19	8	27	0	3	30	0	0
18	21201953	.	G	A	21	24	45	0	1	46	0	0
18	21203739	.	C	T	19	14	33	0	3	36	0	0
18	21257600	.	A	T	11	9	20	0	0	20	0	0
18	21257623	.	A	G	13	9	22	0	1	23	0	0
18	21257757	.	G	A	9	9	18	0	0	18	0	0
18	21257786	.	G	A	7	6	13	0	1	14	0	0
18	21257816	.	G	T	8	6	14	0	0	14	0	0
18	21257946	.	C	T	10	9	19	0	1	20	0	0
18	21257951	.	T	A	8	9	17	0	1	18	0	0
18	21258083	.	G	A	6	9	15	0	1	16	0	0
18	21263268	.	C	T	0	6	6	0	3	9	0	0
18	21399913	.	T	A	1	2	3	0	0	3	0	0
18	21409113	.	A	T	16	18	34	0	0	34	0	0
18	21492325	.	T	C	20	12	32	0	0	32	0	0
18	21617864	.	G	A	3	25	28	0	28	56	0	0
18	21618343	.	C	T	16	24	40	0	2	42	0	0
18	21618379	.	A	G	18	22	40	0	2	42	0	0
18	21618496	.	G	A	19	19	38	0	0	38	0	0
18	21618659	.	C	A	13	13	26	0	2	28	0	0
18	21618731	.	G	T	19	23	42	0	2	44	0	0
18	21618910	.	G	T	26	23	49	1	1	51	0	0
18	21619011	.	C	T	11	20	31	0	2	33	0	0
18	21619018	.	A	T	15	18	33	0	2	35	0	0
18	21619055	.	G	T	20	17	37	0	0	37	0	0
18	21619260	.	C	T	25	17	42	0	3	45	0	0
18	21619284	.	G	T	19	24	43	0	1	44	0	0
18	21619672	.	A	G	25	16	41	3	3	47	0	0
18	21619686	.	G	A	21	17	38	4	3	45	0	0
18	21619777	.	A	G	35	25	60	2	1	63	0	0
18	21619799	.	T	G	33	26	59	0	1	60	0	0
18	21619948	.	C	T	18	20	38	1	2	41	0	0
18	21620082	.	A	T	30	12	42	0	4	46	0	0
18	21620376	.	A	C	21	26	47	0	0	47	0	0
18	21645492	.	G	A	9	5	14	0	0	14	0	0
18	21645627	.	A	G	9	6	15	0	0	15	0	0
18	21645902	.	G	C	17	0	17	0	16	33	0	0
18	21645965	.	G	A	15	13	28	0	2	30	0	0
18	21645989	.	T	G	13	15	28	0	1	29	0	0
18	21647419	.	T	C	6	6	12	0	0	12	0	0
18	21648522	.	C	T	5	10	15	0	0	15	0	0
18	21648582	.	A	G	6	9	15	0	1	16	0	0
18	21648627	.	C	T	3	7	10	0	0	10	0	0
18	21648633	.	A	T	2	7	9	0	1	10	0	0
18	21653937	.	C	T	11	13	24	0	1	25	0	0
18	21654375	.	C	A	5	8	13	0	0	13	0	0
18	21654432	.	T	C	4	7	11	0	0	11	0	0
18	21654489	.	C	T	9	12	21	0	1	22	0	0
18	21656211	.	C	T	2	6	8	0	0	8	0	0
18	21656217	.	G	A	4	3	7	0	1	8	0	0
18	21656271	.	C	A	3	4	7	0	1	8	0	0
18	21656274	.	G	A	4	3	7	0	1	8	0	0
18	21656605	.	C	T	4	8	12	0	0	12	0	0
18	21657642	.	T	G	3	3	6	0	1	7	0	0
18	21674320	.	G	T	2	2	4	0	0	4	0	0
18	21678723	.	G	A	5	5	10	0	1	11	0	0
18	21689043	.	G	C	2	13	15	0	1	16	0	0
18	21689052	.	A	G	4	11	15	0	0	15	0	0
18	21689079	.	G	A	14	8	22	0	0	22	0	0
18	21693120	.	A	G	7	3	10	0	0	10	0	0
18	21693213	.	G	A	4	11	15	0	0	15	0	0
18	21693441	.	G	A	10	4	14	0	0	14	0	0
18	21697776	.	C	T	5	9	14	0	2	16	0	0
18	21698855	.	G	T	4	10	14	0	0	14	0	0
18	21699581	.	A	T	1	6	7	0	0	7	0	0
18	21704559	.	G	T	1	3	4	0	0	4	0	0
18	21724407	.	C	T	6	2	8	0	0	8	0	0
18	21782362	.	T	G	1	4	5	0	0	5	0	0
18	21782445	.	T	G	3	4	7	0	0	7	0	0
18	21782467	.	A	C	2	2	4	0	0	4	0	0
18	21783049	.	G	C	2	2	4	0	0	4	0	0
18	21783077	.	C	T	3	3	6	0	0	6	0	0
18	21783087	.	G	A	3	3	6	0	0	6	0	0
18	21783257	.	G	T	2	6	8	0	1	9	0	0
18	21783279	.	G	A	7	2	9	0	0	9	0	0
18	21783325	.	A	T	8	5	13	0	0	13	0	0
18	21783368	.	G	A	10	5	15	0	0	15	0	0
18	21860755	.	C	T	9	8	17	0	1	18	0	0
18	21861134	.	T	A	4	14	18	0	1	19	0	0
18	21861225	.	T	A	12	18	30	0	0	30	0	0
18	21861381	.	G	T	5	9	14	0	0	14	0	0
18	21861497	.	A	T	7	5	12	0	0	12	0	0
18	21861688	.	C	A	8	6	14	0	0	14	0	0
18	21861779	.	G	T	5	3	8	1	0	9	0	0
18	21861934	.	C	T	6	3	9	0	1	10	0	0
18	21862000	.	G	C	11	3	14	0	2	16	0	0
18	21862076	.	C	T	1	5	6	0	18	24	0	0
18	21862141	.	T	C	11	0	11	0	8	19	0	0
18	21862237	.	G	T	5	3	8	0	0	8	0	0
18	21862346	.	T	A	10	7	17	0	0	17	0	0
18	21880098	.	T	C	9	0	9	0	9	18	0	0
18	21880191	.	T	C	5	1	6	0	8	14	0	0
18	21884647	.	T	A	1	2	3	13	0	16	0	0
18	21888256	.	C	T	4	3	7	0	0	7	0	0
18	21891024	.	G	T	4	2	6	0	0	6	0	0
18	21900961	.	G	A	1	3	4	0	0	4	0	0
18	21906745	.	G	A	4	2	6	0	0	6	0	0
18	21913799	.	A	T	11	16	27	0	1	28	0	0
18	21913907	.	G	C	15	13	28	0	1	29	0	0
18	21913988	.	C	A	19	11	30	1	1	32	0	0
18	21914018	.	C	A	11	14	25	1	0	26	0	0
18	21914225	.	C	T	0	14	14	0	9	23	0	0
18	21914281	.	G	A	14	10	24	0	1	25	0	0
18	21914283	.	C	A	14	10	24	0	1	25	0	0
18	21941285	.	A	T	1	1	2	0	1	3	0	0
18	22002476	.	G	A	4	5	9	0	0	9	0	0
18	22002508	.	C	T	5	10	15	0	0	15	0	0
18	22029828	.	A	C	5	0	5	0	5	10	0	0
18	22030435	.	C	T	1	3	4	0	0	4	0	0
18	22082366	.	T	C	8	4	12	0	0	12	0	0
18	22233010	.	G	A	0	2	2	0	2	4	0	0
18	22255005	.	C	T	3	4	7	0	0	7	0	0
18	22261064	.	C	A	5	2	7	0	0	7	0	0
18	22272969	.	C	A	4	8	12	0	3	15	0	0
18	22275051	.	T	C	5	8	13	0	0	13	0	0
18	22282766	.	A	T	12	3	15	0	0	15	0	0
18	22282809	.	A	T	8	11	19	0	0	19	0	0
18	22282923	.	G	T	11	16	27	0	0	27	0	0
18	22282960	.	C	T	14	15	29	0	0	29	0	0
18	22282961	.	A	G	14	15	29	0	0	29	0	0
18	22283087	.	C	A	6	10	16	0	0	16	0	0
18	22283116	.	T	A	7	7	14	0	0	14	0	0
18	22288650	.	T	C	10	5	15	0	0	15	0	0
18	22288659	.	C	T	8	4	12	0	2	14	0	0
18	22289075	.	T	C	10	5	15	0	0	15	0	0
18	22289314	.	C	T	18	8	26	0	0	26	0	0
18	22290900	.	G	A	17	13	30	0	1	31	0	0
18	22290933	.	C	T	16	10	26	0	1	27	0	0
18	22292215	.	A	T	12	13	25	0	1	26	0	0
18	22292286	.	G	A	21	10	31	0	1	32	0	0
18	22292339	.	A	T	15	15	30	0	1	31	0	0
18	22356816	.	A	C	1	2	3	0	0	3	0	0
18	22356989	.	C	T	18	12	30	0	0	30	0	0
18	22377096	.	A	T	25	14	39	0	3	42	0	0
18	22377372	.	G	A	1	26	27	0	21	48	0	0
18	22377471	.	C	T	22	14	36	0	0	36	0	0
18	22385900	.	G	A	25	19	44	0	9	53	0	0
18	22405895	.	A	T	7	4	11	0	0	11	0	0
18	22406187	.	T	A	4	2	6	0	0	6	0	0
18	22406311	.	T	A	1	7	8	0	0	8	0	0
18	22406324	.	G	A	0	6	6	0	1	7	0	0
18	22406375	.	T	A	2	2	4	0	0	4	0	0
18	22406797	.	A	T	1	4	5	0	0	5	0	0
18	22407365	.	C	T	0	1	1	0	2	3	0	0
18	22410983	.	G	A	1	4	5	0	0	5	0	0
18	22414504	.	A	C	6	6	12	0	0	12	0	0
18	22414542	.	T	G	5	7	12	0	1	13	0	0
18	22417058	.	C	T	6	4	10	0	0	10	0	0
18	22417082	.	G	A	2	5	7	0	6	13	0	0
18	22417103	.	C	A	7	6	13	0	0	13	0	0
18	22420551	.	A	T	5	6	11	0	0	11	0	0
18	22420558	.	C	A	6	5	11	0	1	12	0	0
18	22424532	.	T	C	2	11	13	0	1	14	0	0
18	22424536	.	A	G	3	0	3	0	12	15	0	0
18	22424601	.	A	G	10	0	10	0	10	20	0	0
18	22486579	.	A	T	2	2	4	0	1	5	0	0
18	22669708	.	C	G	1	3	4	0	0	4	0	0
18	22679339	.	C	T	3	3	6	0	0	6	0	0
18	22679684	.	G	A	3	2	5	0	0	5	0	0
18	22679852	.	C	T	3	3	6	0	1	7	0	0
18	22685266	.	G	A	0	8	8	0	9	17	0	0
18	22685278	.	C	T	13	5	18	0	0	18	0	0
18	22685329	.	T	C	9	9	18	0	0	18	0	0
18	22685380	.	A	T	13	5	18	0	0	18	0	0
18	22685608	.	C	A	9	10	19	0	0	19	0	0
18	22686269	.	A	T	10	9	19	0	0	19	0	0
18	22686320	.	G	A	4	7	11	0	2	13	0	0
18	22686358	.	G	A	2	2	4	0	0	4	0	0
18	22686588	.	C	A	10	4	14	0	0	14	0	0
18	22686723	.	C	T	7	10	17	0	0	17	0	0
18	22686789	.	G	A	12	7	19	0	1	20	0	0
18	22686795	.	C	G	11	7	18	0	1	19	0	0
18	22686927	.	G	A	0	5	5	0	0	5	0	0
18	22687312	.	G	A	11	18	29	0	1	30	0	0
18	22687527	.	G	C	15	15	30	0	0	30	0	0
18	22687575	.	T	A	19	17	36	0	3	39	0	0
18	22687599	.	A	T	20	19	39	0	0	39	0	0
18	22687666	.	C	T	18	16	34	1	0	35	0	0
18	22728794	.	A	G	17	12	29	0	0	29	0	0
18	22732391	.	A	G	11	12	23	0	0	23	0	0
18	22743514	.	G	A	2	3	5	0	0	5	0	0
18	22921942	.	C	T	22	25	47	0	3	50	0	0
18	22921950	.	T	C	23	21	44	0	4	48	0	0
18	22975090	.	T	C	28	36	64	0	0	64	0	0
18	22975297	.	A	C	33	23	56	0	1	57	0	0
18	23071396	.	T	G	3	2	5	0	0	5	0	0
18	23249388	.	G	A	0	2	2	0	1	3	0	0
18	23270093	.	C	T	5	3	8	0	0	8	0	0
18	23869134	.	C	T	22	20	42	0	1	43	0	0
18	23869784	.	T	A	20	22	42	0	1	43	0	0
18	23870092	.	G	A	20	23	43	0	2	45	0	0
18	23870837	.	C	T	12	14	26	0	1	27	0	0
18	24922149	.	G	A	7	2	9	0	1	10	0	0
18	24929460	.	G	A	0	11	11	0	13	24	0	0
18	24929465	.	T	C	12	13	25	0	1	26	0	0
18	24930189	.	G	A	9	13	22	0	1	23	0	0
18	24930530	.	T	C	12	8	20	0	3	23	0	0
18	24930758	.	T	C	12	16	28	0	0	28	0	0
18	24931044	.	T	A	15	19	34	0	2	36	0	0
18	24931634	.	A	G	23	24	47	0	1	48	0	0
18	24931660	.	G	T	22	20	42	0	0	42	0	0
18	24934333	.	A	T	4	12	16	0	1	17	0	0
18	24934456	.	G	A	15	14	29	0	0	29	0	0
18	24934692	.	C	A	4	6	10	0	0	10	0	0
18	24935099	.	A	G	17	9	26	0	0	26	0	0
18	24938712	.	A	G	4	10	14	0	0	14	0	0
18	24938805	.	A	G	9	8	17	0	0	17	0	0
18	24938871	.	T	C	9	8	17	0	0	17	0	0
18	24938919	.	C	T	6	5	11	0	1	12	0	0
18	24944039	.	A	T	10	5	15	0	0	15	0	0
18	24944045	.	T	C	9	4	13	0	0	13	0	0
18	24946727	.	T	A	5	5	10	0	1	11	0	0
18	24947618	.	G	A	7	6	13	0	0	13	0	0
18	24952245	.	T	G	9	3	12	0	0	12	0	0
18	24959289	.	G	A	2	4	6	0	1	7	0	0
18	24966110	.	G	A	1	4	5	0	0	5	0	0
18	24968639	.	C	T	1	7	8	0	0	8	0	0
18	24969445	.	A	G	1	4	5	0	0	5	0	0
18	24988707	.	T	A	4	3	7	0	0	7	0	0
18	24989243	.	C	G	1	1	2	0	1	3	0	0
18	25003359	.	A	T	14	12	26	0	1	27	0	0
18	25003448	.	G	C	12	8	20	0	0	21	1	0
18	25009326	.	C	A	11	10	21	0	1	22	0	0
18	25009352	.	G	A	12	12	24	0	0	24	0	0
18	25009487	.	A	G	7	3	10	0	0	10	0	0
18	25084441	.	C	T	1	2	3	0	0	3	0	0
18	25754551	.	G	A	6	5	11	0	0	11	0	0
18	25754580	.	G	T	5	3	8	0	0	8	0	0
18	25783752	.	G	A	7	3	10	0	1	11	0	0
18	25784146	.	C	A	0	2	2	0	1	3	0	0
18	26089254	.	A	T	2	5	7	0	0	7	0	0
18	26089305	.	G	C	4	3	7	0	0	7	0	0
18	26094421	.	C	T	6	3	9	0	0	9	0	0
18	26094491	.	A	C	3	5	8	0	0	8	0	0
18	26097091	.	G	T	34	32	66	0	1	67	0	0
18	26097428	.	G	A	37	27	64	0	5	70	1	0
18	26126046	.	C	T	3	2	5	0	1	6	0	0
18	26338420	.	C	T	10	5	15	0	0	15	0	0
18	26362401	.	A	G	7	13	20	0	1	21	0	0
18	26393716	.	C	A	25	20	45	0	0	45	0	0
18	26401680	.	T	C	21	16	37	0	1	39	1	0
18	26401719	.	T	C	30	13	43	0	2	45	0	0
18	26401743	.	C	T	13	26	39	0	4	43	0	0
18	26405271	.	G	A	18	27	45	0	1	46	0	0
18	26422751	.	G	C	2	4	6	0	0	6	0	0
18	26425376	.	G	A	3	3	6	0	2	8	0	0
18	26426448	.	G	A	4	2	6	0	0	6	0	0
18	26445228	.	C	T	1	3	4	0	0	4	0	0
18	26460594	.	G	A	3	3	6	0	0	6	0	0
18	26460822	.	G	C	3	7	10	0	0	10	0	0
18	26460846	.	C	A	6	7	13	0	0	13	0	0
18	26474249	.	A	G	8	3	11	0	0	11	0	0
18	26476133	.	C	T	5	6	11	0	0	11	0	0
18	26480081	.	C	T	2	3	5	0	0	5	0	0
18	26502584	.	A	G	2	3	5	1	0	6	0	0
18	26776182	.	A	G	6	4	10	0	0	10	0	0
18	26778264	.	A	G	1	3	4	0	1	5	0	0
18	26793948	.	G	A	18	16	34	0	1	35	0	0
18	26800167	.	C	G	9	10	19	0	0	19	0	0
18	26800198	.	T	C	6	8	14	0	1	15	0	0
18	26800280	.	G	A	12	13	25	0	0	25	0	0
18	26800418	.	T	C	12	11	23	0	1	24	0	0
18	26804233	.	T	A	6	5	11	0	2	13	0	0
18	26811801	.	T	G	1	4	5	0	0	5	0	0
18	26863666	.	T	C	4	0	4	0	3	7	0	0
18	26863681	.	T	C	6	0	6	0	5	11	0	0
18	26870137	.	G	A	4	2	6	0	1	7	0	0
18	26870191	.	G	A	6	1	7	0	0	7	0	0
18	26870194	.	G	A	5	2	7	0	0	7	0	0
18	26870469	.	G	C	5	3	8	0	0	8	0	0
18	26874553	.	G	A	3	5	8	0	0	8	0	0
18	26876449	.	A	C	2	6	8	0	0	8	0	0
18	26885718	.	C	T	5	2	7	0	1	8	0	0
18	26894677	.	G	A	0	3	3	0	1	4	0	0
18	26896277	.	T	C	10	5	15	0	1	16	0	0
18	26896571	.	C	T	8	5	13	0	0	13	0	0
18	26909470	.	G	A	2	20	22	0	14	36	0	0
18	26913949	.	C	T	28	25	53	0	2	55	0	0
18	26919226	.	C	T	11	7	18	2	1	21	0	0
18	26919989	.	T	A	22	20	42	0	3	45	0	0
18	26920116	.	T	C	1	4	5	0	0	5	0	0
18	26968799	.	G	A	6	5	11	0	0	11	0	0
18	26971731	.	A	G	3	4	7	0	0	7	0	0
18	26971899	.	C	G	2	2	4	0	1	5	0	0
18	27063809	.	C	T	1	2	3	0	0	3	0	0
18	27066063	.	C	T	3	3	6	0	0	6	0	0
18	27072144	.	A	C	3	5	8	0	1	9	0	0
18	27072226	.	C	A	5	2	7	0	0	8	1	0
18	27072690	.	C	T	2	2	4	0	0	4	0	0
18	27072697	.	G	A	3	2	5	0	0	5	0	0
18	27085408	.	G	A	1	1	2	0	1	3	0	0
18	27252533	.	G	A	1	4	5	0	0	5	0	0
18	27254538	.	G	A	1	3	4	0	0	4	0	0
18	27254726	.	T	C	3	3	6	0	2	8	0	0
18	27254774	.	T	C	2	2	4	0	0	4	0	0
18	27254998	.	T	A	2	2	4	0	1	5	0	0
18	27281673	.	T	G	4	4	8	0	0	8	0	0
18	27281679	.	A	G	3	0	3	0	5	8	0	0
18	27285337	.	C	T	4	4	8	0	0	8	0	0
18	27309517	.	A	G	6	8	14	0	2	16	0	0
18	27309555	.	G	A	6	8	14	0	0	14	0	0
18	27309713	.	C	A	4	3	7	0	1	8	0	0
18	27309716	.	G	A	5	2	7	0	1	8	0	0
18	27335597	.	G	A	3	5	8	0	2	10	0	0
18	27335740	.	T	A	12	8	20	0	0	20	0	0
18	27335780	.	A	T	6	8	14	0	0	14	0	0
18	27341170	.	C	T	4	2	6	0	0	6	0	0
18	27358319	.	G	C	1	3	4	0	0	4	0	0
18	27568352	.	A	G	14	4	18	0	0	18	0	0
18	27732389	.	T	C	13	8	21	0	0	21	0	0
18	27802795	.	C	T	13	14	27	0	0	27	0	0
18	27812400	.	T	G	18	0	18	0	18	36	0	0
18	27812429	.	T	C	17	18	35	0	0	35	0	0
18	27812618	.	T	A	15	21	36	0	0	36	0	0
18	27904555	.	C	T	2	3	5	0	0	5	0	0
18	27927639	.	A	G	2	2	4	0	0	4	0	0
18	27970182	.	A	T	3	3	6	0	0	6	0	0
18	27981137	.	A	C	4	5	9	0	0	9	0	0
18	27982320	.	A	G	5	4	9	0	1	10	0	0
18	27988481	.	G	C	6	2	8	0	0	8	0	0
18	27988509	.	T	C	3	4	7	0	2	9	0	0
18	27993392	.	T	G	6	5	11	0	0	12	1	0
18	28106305	.	T	A	7	4	11	0	0	11	0	0
18	28106790	.	A	G	4	0	4	0	5	9	0	0
18	28123612	.	T	C	1	6	7	0	0	7	0	0
18	28564674	.	T	A	1	7	8	0	0	8	0	0
18	28564737	.	T	C	4	3	7	0	1	8	0	0
18	28564923	.	G	A	3	3	6	0	3	9	0	0
18	28565025	.	C	T	1	2	3	0	1	4	0	0
18	28606134	.	C	A	1	4	5	0	0	5	0	0
18	28606191	.	A	G	3	0	3	0	7	10	0	0
18	28852198	.	A	T	4	2	6	0	0	6	0	0
18	28852204	.	A	G	4	3	7	0	0	7	0	0
18	28876524	.	C	G	6	12	18	0	1	19	0	0
18	28876569	.	A	G	6	1	7	0	10	17	0	0
18	28879736	.	G	T	0	6	6	0	2	8	0	0
18	28879758	.	C	G	4	7	11	0	0	11	0	0
18	28879847	.	G	T	4	6	10	0	0	10	0	0
18	29008407	.	C	T	11	10	21	0	5	26	0	0
18	29058989	.	C	T	6	4	10	0	0	11	1	0
18	29059150	.	C	T	8	4	12	0	4	16	0	0
18	29059194	.	A	G	8	8	16	0	0	16	0	0
18	29403241	.	G	T	0	2	2	0	1	3	0	0
18	29403433	.	G	T	1	2	3	0	1	4	0	0
18	29886272	.	G	A	6	3	9	0	0	9	0	0
18	29886275	.	C	T	6	3	9	0	0	9	0	0
18	29887226	.	T	C	3	3	6	0	0	6	0	0
18	29887283	.	C	G	2	2	4	0	0	4	0	0
18	29889484	.	T	A	5	2	7	0	0	7	0	0
18	29889548	.	A	G	1	2	3	0	0	3	0	0
18	29898173	.	A	C	8	8	16	0	0	16	0	0
18	29898187	.	T	A	5	7	12	0	0	12	0	0
18	29898341	.	A	G	2	4	6	0	0	6	0	0
18	29953405	.	T	C	2	2	4	0	0	4	0	0
18	29953867	.	G	A	1	3	4	0	1	5	0	0
18	29954445	.	T	A	2	4	6	0	1	7	0	0
18	29954824	.	C	A	7	5	12	0	1	13	0	0
18	29954918	.	C	T	6	7	13	0	0	13	0	0
18	29954929	.	T	C	6	6	12	0	0	12	0	0
18	29958874	.	G	A	2	2	4	0	0	4	0	0
18	29958943	.	G	A	6	2	8	0	0	8	0	0
18	29959241	.	T	C	2	2	4	0	0	4	0	0
18	29959268	.	A	C	5	2	7	0	0	7	0	0
18	29969920	.	A	T	4	5	9	0	1	10	0	0
18	29970458	.	C	G	16	9	25	0	0	25	0	0
18	29970559	.	T	G	15	15	30	0	0	30	0	0
18	29970781	.	T	A	3	3	6	0	0	6	0	0
18	29970809	.	A	T	2	4	6	0	0	6	0	0
18	29970817	.	G	A	2	4	6	0	0	6	0	0
18	29976560	.	C	A	7	6	13	0	0	13	0	0
18	29976561	.	A	T	7	6	13	0	0	13	0	0
18	29977423	.	C	T	9	6	15	0	0	15	0	0
18	29977753	.	C	T	7	9	16	0	0	16	0	0
18	29977784	.	T	A	9	8	17	0	0	17	0	0
18	29977789	.	C	T	6	9	15	0	1	16	0	0
18	29978794	.	A	T	6	4	10	0	0	10	0	0
18	29978848	.	A	G	3	6	9	0	0	9	0	0
18	29979860	.	A	G	5	5	10	0	0	10	0	0
18	29980474	.	A	G	3	3	6	0	1	7	0	0
18	29980560	.	A	G	6	2	8	0	0	8	0	0
18	30012520	.	G	A	3	6	9	0	0	9	0	0
18	30021313	.	C	A	4	2	6	0	0	6	0	0
18	30441825	.	G	A	0	6	6	0	7	13	0	0
18	30463346	.	C	T	5	8	13	0	1	14	0	0
18	30466712	.	A	T	4	12	16	0	1	17	0	0
18	30470471	.	A	G	8	11	19	0	0	19	0	0
18	30470929	.	T	C	13	13	26	0	1	27	0	0
18	30470930	.	G	A	13	14	27	0	0	27	0	0
18	30473905	.	A	G	8	0	8	0	17	25	0	0
18	30476837	.	G	A	13	14	27	0	0	27	0	0
18	30477289	.	G	T	10	8	18	0	1	19	0	0
18	30477469	.	C	T	15	9	24	0	0	24	0	0
18	30477495	.	T	G	12	5	17	0	0	17	0	0
18	30477616	.	A	G	11	12	23	0	1	24	0	0
18	30477625	.	C	T	12	13	25	0	1	26	0	0
18	30477889	.	C	T	16	16	32	0	1	33	0	0
18	30478113	.	A	G	21	0	21	0	12	33	0	0
18	30478156	.	C	T	24	19	43	0	3	46	0	0
18	30500912	.	G	T	1	3	4	0	0	4	0	0
18	30500952	.	T	C	1	3	4	0	0	4	0	0
18	30501194	.	T	C	3	4	7	0	0	7	0	0
18	30501298	.	C	A	11	3	14	0	1	15	0	0
18	30501393	.	G	A	5	3	8	0	0	8	0	0
18	30501639	.	A	G	13	9	22	0	1	23	0	0
18	30501701	.	T	C	5	12	17	0	1	18	0	0
18	30503562	.	T	C	8	0	8	0	9	17	0	0
18	30504366	.	C	T	7	9	16	0	0	16	0	0
18	30556895	.	G	A	4	3	7	0	0	7	0	0
18	30564142	.	T	A	3	6	9	0	3	12	0	0
18	30564199	.	A	G	4	0	4	0	4	8	0	0
18	30564240	.	A	T	4	5	9	0	0	9	0	0
18	30564301	.	C	A	4	6	10	0	0	10	0	0
18	30564334	.	T	G	8	7	15	0	0	15	0	0
18	30564342	.	G	T	10	7	17	0	0	17	0	0
18	30564385	.	T	G	9	6	15	0	0	15	0	0
18	30564443	.	A	T	4	4	8	0	0	8	0	0
18	30564451	.	G	C	0	4	4	0	3	7	0	0
18	30949449	.	C	T	3	2	5	0	1	6	0	0
18	30949488	.	G	A	3	4	7	0	0	7	0	0
18	31033267	.	C	T	0	8	8	0	10	18	0	0
18	31036721	.	A	T	5	4	9	0	1	10	0	0
18	31036722	.	C	A	6	4	10	0	0	10	0	0
18	31041640	.	G	A	5	7	12	0	0	12	0	0
18	31058647	.	G	A	1	2	3	0	1	4	0	0
18	31064706	.	A	G	4	0	4	0	8	12	0	0
18	31064734	.	G	A	6	5	11	0	1	12	0	0
18	31068392	.	A	C	8	5	13	0	0	13	0	0
18	31068463	.	A	G	5	5	10	0	0	10	0	0
18	31105257	.	G	A	8	14	22	0	0	22	0	0
18	31151851	.	G	A	4	7	11	0	0	11	0	0
18	31152920	.	A	G	2	3	5	0	0	5	0	0
18	31152946	.	C	A	2	2	4	0	0	4	0	0
18	31201750	.	T	C	4	8	12	0	0	12	0	0
18	31281034	.	G	C	1	15	16	0	6	22	0	0
18	31281161	.	T	A	12	11	23	0	0	23	0	0
18	31281186	.	T	C	10	15	25	0	2	27	0	0
18	31281254	.	G	A	11	13	24	0	2	26	0	0
18	31775711	.	G	A	1	9	10	0	9	19	0	0
18	33729756	.	T	G	2	3	5	1	0	6	0	0
18	33982078	.	G	T	2	6	8	0	2	10	0	0
18	33982331	.	G	T	6	4	10	0	0	10	0	0
18	33982340	.	G	A	6	3	9	0	1	10	0	0
18	33982423	.	A	C	18	6	24	0	0	24	0	0
18	33982591	.	T	C	13	8	21	0	0	21	0	0
18	33982811	.	C	T	1	14	15	0	14	29	0	0
18	33983154	.	G	A	15	23	38	0	0	38	0	0
18	33983165	.	T	C	12	21	33	0	2	35	0	0
18	33983300	.	A	C	10	0	10	0	13	23	0	0
18	33983564	.	T	A	10	9	19	0	0	19	0	0
18	33983641	.	T	C	18	10	28	3	1	32	0	0
18	33983771	.	A	C	12	10	22	0	0	22	0	0
18	33984153	.	A	G	11	9	20	0	0	20	0	0
18	33984191	.	C	A	10	9	19	0	0	19	0	0
18	33984215	.	G	T	11	7	18	0	0	18	0	0
18	33984235	.	T	A	10	7	17	0	0	17	0	0
18	33984596	.	G	A	8	10	18	0	0	18	0	0
18	33984801	.	A	C	8	13	21	0	1	22	0	0
18	33985249	.	T	C	14	10	24	0	1	25	0	0
18	33985414	.	T	C	7	0	7	0	19	26	0	0
18	33985953	.	C	T	9	11	20	0	0	20	0	0
18	33986027	.	A	G	7	20	27	0	0	27	0	0
18	33986199	.	C	T	14	11	25	0	0	25	0	0
18	33986391	.	C	T	7	7	14	0	0	14	0	0
18	33986395	.	A	G	7	8	15	0	0	15	0	0
18	33986470	.	T	C	5	8	13	0	0	13	0	0
18	33988590	.	C	T	2	6	8	0	6	14	0	0
18	33988743	.	A	C	9	0	9	0	5	14	0	0
18	33999714	.	C	G	6	5	11	0	0	11	0	0
18	34015365	.	T	C	3	2	5	0	1	6	0	0
18	34043325	.	G	A	2	4	6	1	0	7	0	0
18	34046381	.	C	T	4	2	6	0	0	6	0	0
18	34050813	.	A	G	1	4	5	0	0	5	0	0
18	34146406	.	A	C	1	2	3	0	0	3	0	0
18	34160136	.	G	T	4	2	6	0	0	6	0	0
18	34189368	.	C	T	1	5	6	0	1	7	0	0
18	34189614	.	G	A	0	2	2	0	2	4	0	0
18	34195231	.	A	G	7	4	11	0	0	11	0	0
18	34195318	.	C	A	4	5	9	0	1	11	1	0
18	34195336	.	A	T	5	5	10	0	2	12	0	0
18	34196270	.	G	C	2	6	8	0	0	8	0	0
18	34207700	.	G	A	6	8	14	0	2	16	0	0
18	34213351	.	C	T	5	3	8	0	2	10	0	0
18	34213378	.	A	T	4	7	11	0	2	13	0	0
18	34213414	.	T	C	3	6	9	1	0	10	0	0
18	34213426	.	T	C	2	6	8	1	0	9	0	0
18	34213530	.	G	A	1	4	5	1	10	16	0	0
18	34213995	.	A	T	11	9	20	0	0	20	0	0
18	34214054	.	C	T	5	11	16	0	0	16	0	0
18	34214141	.	T	G	10	4	14	0	0	14	0	0
18	34214280	.	A	T	13	10	23	0	0	23	0	0
18	34214288	.	G	T	15	8	23	0	0	23	0	0
18	34214478	.	A	G	14	0	14	0	8	22	0	0
18	34214754	.	C	G	16	20	36	0	0	36	0	0
18	34214894	.	T	C	14	6	20	0	2	22	0	0
18	34534807	.	G	T	8	4	12	1	1	14	0	0
18	34535184	.	A	G	4	2	6	0	0	6	0	0
18	34535235	.	C	T	9	4	13	0	0	13	0	0
18	34535423	.	A	G	5	3	8	0	0	8	0	0
18	34542620	.	C	A	15	6	21	0	1	22	0	0
18	34601008	.	C	A	10	3	13	0	1	14	0	0
18	34601042	.	A	C	9	6	15	0	0	15	0	0
18	34601323	.	T	G	3	8	11	0	0	11	0	0
18	34601468	.	G	T	3	13	16	0	0	16	0	0
18	34601471	.	A	T	2	11	13	0	1	14	0	0
18	34601828	.	T	C	1	3	4	0	0	4	0	0
18	34641352	.	A	C	10	16	26	0	6	32	0	0
18	34641439	.	T	C	12	17	29	0	0	29	0	0
18	34641442	.	T	C	14	18	32	0	0	32	0	0
18	34641622	.	C	G	17	16	33	0	1	34	0	0
18	34641633	.	T	C	13	20	33	0	2	35	0	0
18	35143298	.	C	T	1	5	6	0	0	6	0	0
18	35181970	.	G	A	2	2	4	0	0	4	0	0
18	35182349	.	A	C	3	4	7	0	0	7	0	0
18	35238247	.	T	C	2	2	4	0	0	4	0	0
18	35238632	.	G	T	1	3	4	0	3	7	0	0
18	35246809	.	G	A	3	3	6	0	0	6	0	0
18	35251214	.	A	C	4	4	8	0	0	8	0	0
18	35251249	.	T	C	2	3	5	0	0	5	0	0
18	35251258	.	G	A	0	3	3	0	2	5	0	0
18	35251321	.	T	C	2	3	5	0	0	5	0	0
18	35251323	.	C	A	2	3	5	0	0	5	0	0
18	35405389	.	T	C	14	0	14	0	16	30	0	0
18	35406987	.	G	A	14	8	22	0	0	22	0	0
18	35411572	.	C	A	1	3	4	0	0	4	0	0
18	35429879	.	G	C	2	3	5	0	0	5	0	0
18	35430184	.	A	T	1	3	4	0	0	4	0	0
18	35430195	.	C	T	1	4	5	0	0	5	0	0
18	35440658	.	A	G	1	2	3	0	0	3	0	0
18	35491518	.	A	T	19	18	37	0	2	39	0	0
18	35497031	.	A	C	13	17	30	0	0	30	0	0
18	35501357	.	G	A	15	14	29	0	2	31	0	0
18	35503636	.	A	G	7	14	21	0	1	22	0	0
18	35503654	.	C	T	8	12	20	0	0	20	0	0
18	35503705	.	A	G	5	15	20	0	0	20	0	0
18	35508139	.	C	A	1	11	12	0	8	20	0	0
18	35508151	.	A	T	9	11	20	0	0	20	0	0
18	35508304	.	C	T	10	11	21	1	3	25	0	0
18	35509705	.	G	A	6	7	13	0	0	13	0	0
18	35510290	.	G	T	4	6	10	0	1	11	0	0
18	35510590	.	C	A	4	6	10	0	0	10	0	0
18	35510812	.	G	A	4	5	9	0	0	9	0	0
18	35520248	.	G	A	6	11	17	0	0	17	0	0
18	35520281	.	T	C	5	0	5	0	15	20	0	0
18	35528859	.	C	T	4	8	12	0	0	12	0	0
18	35529482	.	T	G	8	5	13	0	0	13	0	0
18	35561469	.	A	C	1	0	1	0	6	7	0	0
18	35561496	.	T	G	1	6	7	0	0	7	0	0
18	35562303	.	C	T	2	3	5	0	0	5	0	0
18	35565108	.	A	G	4	4	8	0	0	8	0	0
18	35582682	.	C	T	4	3	7	0	0	7	0	0
18	35582718	.	C	T	6	3	9	0	1	10	0	0
18	35583885	.	G	C	2	0	2	0	4	6	0	0
18	35583888	.	G	A	2	4	6	0	0	6	0	0
18	35583933	.	A	G	0	3	3	0	1	4	0	0
18	35802235	.	G	A	1	2	3	0	0	3	0	0
18	35807902	.	A	T	5	2	7	0	0	7	0	0
18	35808137	.	C	T	2	6	8	0	0	8	0	0
18	35808223	.	G	A	7	9	16	0	0	16	0	0
18	35808320	.	A	G	17	12	29	0	2	31	0	0
18	35814745	.	T	G	22	16	38	0	2	41	1	0
18	35827185	.	C	T	7	6	13	0	0	13	0	0
18	35832858	.	G	T	9	11	20	0	0	20	0	0
18	35832896	.	G	A	10	11	21	0	1	22	0	0
18	35832911	.	G	A	11	7	18	0	3	21	0	0
18	35832931	.	C	T	11	9	20	0	1	21	0	0
18	35837643	.	A	G	6	5	11	0	0	11	0	0
18	35839375	.	A	T	1	3	4	0	3	7	0	0
18	35839384	.	A	G	3	4	7	0	0	7	0	0
18	35839461	.	T	C	4	11	15	0	0	15	0	0
18	35839512	.	A	G	11	6	17	0	1	18	0	0
18	35839658	.	T	C	8	7	15	0	0	15	0	0
18	35839673	.	A	G	8	6	14	0	0	14	0	0
18	35839730	.	T	C	10	5	15	0	1	16	0	0
18	35839832	.	G	A	13	3	16	0	1	17	0	0
18	35842419	.	T	C	11	4	15	0	0	15	0	0
18	35842440	.	C	T	2	7	9	0	10	19	0	0
18	35842476	.	C	T	12	11	23	0	0	23	0	0
18	36037258	.	T	C	4	2	6	0	1	7	0	0
18	36065768	.	T	G	5	3	8	0	0	8	0	0
18	36066480	.	A	T	2	4	6	0	0	6	0	0
18	36070870	.	T	C	5	3	8	0	0	8	0	0
18	36071039	.	G	T	1	6	7	0	9	16	0	0
18	36071217	.	C	G	9	0	9	0	6	15	0	0
18	36071223	.	G	A	9	4	13	0	0	13	0	0
18	36080616	.	G	T	18	11	29	0	1	30	0	0
18	36080688	.	A	G	15	19	34	0	1	35	0	0
18	36080931	.	T	G	14	10	24	0	1	26	1	0
18	36081009	.	A	C	6	12	18	0	0	18	0	0
18	36081018	.	G	A	3	14	17	0	0	17	0	0
18	36081513	.	C	T	12	16	28	0	0	28	0	0
18	36081792	.	T	C	3	4	7	0	1	8	0	0
18	36081864	.	G	A	1	2	3	0	0	3	0	0
18	36106031	.	T	C	11	14	25	0	0	25	0	0
18	36114463	.	T	A	7	4	11	0	0	11	0	0
18	36114464	.	A	C	7	4	11	0	0	11	0	0
18	36129218	.	G	A	9	8	17	0	0	17	0	0
18	36591488	.	G	T	1	2	3	0	0	3	0	0
18	36593772	.	A	G	2	0	2	0	2	4	0	0
18	36593874	.	C	T	3	2	5	0	0	5	0	0
18	36597757	.	A	G	6	3	9	0	0	9	0	0
18	36597952	.	C	T	8	4	12	0	0	12	0	0
18	36598075	.	G	A	2	3	5	0	2	7	0	0
18	36598076	.	T	A	5	3	8	0	0	8	0	0
18	36598337	.	A	G	7	3	10	0	0	10	0	0
18	36598476	.	G	A	4	5	9	0	0	9	0	0
18	36620186	.	C	T	8	4	12	0	0	12	0	0
18	36623275	.	C	T	10	9	19	0	0	19	0	0
18	36630740	.	T	A	8	13	21	0	0	21	0	0
18	36630867	.	C	T	12	12	24	0	1	25	0	0
18	36631169	.	A	G	2	3	5	0	0	5	0	0
18	36647721	.	T	C	1	2	3	0	0	3	0	0
18	36647855	.	C	T	4	3	7	0	0	7	0	0
18	36647925	.	T	G	1	3	4	0	0	4	0	0
18	36790413	.	C	T	1	5	6	0	0	6	0	0
18	36799167	.	A	C	9	3	12	0	1	13	0	0
18	36799477	.	C	T	2	2	4	0	0	4	0	0
18	36799767	.	T	C	2	4	6	0	0	6	0	0
18	36799780	.	G	A	4	3	7	0	0	7	0	0
18	36799922	.	T	C	4	3	7	0	0	7	0	0
18	36800002	.	C	T	4	2	6	0	0	6	0	0
18	36806632	.	A	T	16	10	26	0	1	27	0	0
18	36806657	.	T	A	8	8	16	0	3	19	0	0
18	36806681	.	T	C	4	12	16	0	2	18	0	0
18	36806707	.	C	T	4	12	16	0	0	16	0	0
18	36806727	.	C	T	5	9	14	0	1	15	0	0
18	36806749	.	A	G	6	7	13	0	0	13	0	0
18	36858200	.	T	C	2	10	12	0	1	13	0	0
18	36869052	.	A	G	4	3	7	0	0	7	0	0
18	36869120	.	T	G	6	8	14	0	0	14	0	0
18	36869131	.	G	A	0	8	8	0	8	16	0	0
18	36869180	.	T	C	5	13	18	0	0	18	0	0
18	36869530	.	C	G	17	15	32	0	0	32	0	0
18	36869676	.	A	G	20	10	30	0	3	33	0	0
18	36869677	.	A	G	21	8	29	0	5	34	0	0
18	36869863	.	G	A	14	14	28	0	3	31	0	0
18	36869879	.	G	T	15	18	33	0	0	33	0	0
18	36870068	.	G	A	13	8	21	0	3	24	0	0
18	36870174	.	G	A	15	13	28	0	1	29	0	0
18	36870278	.	G	A	18	14	32	0	0	32	0	0
18	36870378	.	A	G	8	0	8	0	14	22	0	0
18	36870448	.	C	G	9	16	25	0	4	29	0	0
18	36870460	.	T	C	9	20	29	0	0	29	0	0
18	36870702	.	A	T	20	14	34	0	0	34	0	0
18	36949014	.	G	A	3	2	5	0	0	5	0	0
18	36949178	.	A	G	5	4	9	0	1	10	0	0
18	36951823	.	G	A	7	2	9	0	0	9	0	0
18	36951829	.	T	C	6	2	8	0	0	8	0	0
18	36954186	.	A	G	6	3	9	0	0	9	0	0
18	36954230	.	C	T	4	2	6	0	0	6	0	0
18	36954305	.	G	T	3	3	6	0	0	6	0	0
18	36954314	.	C	T	0	3	3	0	3	6	0	0
18	36954662	.	A	G	1	4	5	0	2	7	0	0
18	36956672	.	G	A	3	3	6	0	0	6	0	0
18	36957310	.	T	C	4	3	7	0	0	7	0	0
18	36959656	.	A	T	7	2	9	0	0	9	0	0
18	36959746	.	T	G	4	3	7	0	0	7	0	0
18	36959767	.	T	C	5	4	9	0	0	9	0	0
18	36963204	.	A	G	4	3	7	0	0	7	0	0
18	36963315	.	T	A	2	5	7	0	1	8	0	0
18	36963563	.	A	G	1	3	4	0	0	4	0	0
18	36964110	.	A	G	1	2	3	0	0	3	0	0
18	37007251	.	C	T	1	7	8	0	0	8	0	0
18	37121185	.	C	T	2	3	5	0	0	5	0	0
18	37121202	.	G	T	2	2	4	0	0	4	0	0
18	37133566	.	G	A	4	3	7	0	0	7	0	0
18	37143773	.	T	C	3	2	5	0	0	5	0	0
18	37153325	.	A	G	2	1	3	0	0	3	0	0
18	37153334	.	T	A	2	2	4	0	0	4	0	0
18	37190979	.	A	T	2	3	5	0	0	5	0	0
18	37191246	.	C	T	5	2	7	0	0	7	0	0
18	37191286	.	G	A	4	2	6	0	0	6	0	0
18	37191396	.	G	C	2	6	8	0	0	8	0	0
18	37197464	.	T	C	1	2	3	0	0	3	0	0
18	37200052	.	A	C	2	3	5	0	0	5	0	0
18	37219558	.	T	C	2	2	4	0	0	4	0	0
18	37227090	.	T	G	5	2	7	0	0	7	0	0
18	37230433	.	A	G	8	10	18	0	1	19	0	0
18	37230456	.	C	G	5	9	14	0	0	14	0	0
18	37230629	.	T	C	4	6	10	0	1	11	0	0
18	37234081	.	T	C	5	5	10	0	0	10	0	0
18	37234574	.	T	A	2	5	7	0	0	7	0	0
18	37259911	.	A	G	18	19	37	0	4	41	0	0
18	37260192	.	A	G	24	0	24	0	17	41	0	0
18	37267398	.	C	A	27	10	37	0	2	39	0	0
18	37267464	.	G	A	20	15	35	0	1	36	0	0
18	37267529	.	G	A	25	20	45	1	1	47	0	0
18	37269904	.	A	G	24	19	43	0	1	44	0	0
18	37270225	.	A	G	18	20	38	0	0	38	0	0
18	37270498	.	C	T	15	15	30	0	2	32	0	0
18	37270598	.	T	G	13	7	20	0	2	22	0	0
18	37837371	.	C	T	4	13	17	0	18	35	0	0
18	37837511	.	A	G	16	12	28	0	1	29	0	0
18	37837536	.	T	C	17	12	29	0	6	35	0	0
18	37837655	.	A	G	14	18	32	0	2	34	0	0
18	37837706	.	A	C	8	14	22	0	2	24	0	0
18	37837708	.	T	A	8	15	23	0	0	23	0	0
18	37837879	.	G	T	15	15	30	0	0	30	0	0
18	37838160	.	G	T	20	17	37	0	2	40	1	0
18	37838250	.	G	C	20	6	26	3	1	30	0	0
18	37840290	.	A	G	23	16	39	4	0	43	0	0
18	37866417	.	C	T	2	12	14	0	17	31	0	0
18	38194336	.	C	A	2	4	6	0	0	6	0	0
18	38199482	.	A	G	5	8	13	0	1	14	0	0
18	38206907	.	A	G	10	3	13	0	0	13	0	0
18	38209562	.	T	G	3	6	9	0	1	10	0	0
18	38209586	.	C	G	5	4	9	0	1	10	0	0
18	38209597	.	T	C	4	3	7	0	0	7	0	0
18	38209776	.	A	G	3	8	11	0	0	11	0	0
18	38210029	.	G	T	2	2	4	0	0	4	0	0
18	38217181	.	A	G	13	8	21	0	0	21	0	0
18	38222514	.	A	G	7	8	15	0	0	15	0	0
18	38223448	.	A	G	4	3	7	0	1	8	0	0
18	38223735	.	A	G	2	7	9	0	0	9	0	0
18	38225491	.	A	G	3	4	7	0	0	7	0	0
18	38225547	.	G	A	1	3	4	0	0	4	0	0
18	38235716	.	T	G	4	4	8	0	0	8	0	0
18	38235726	.	A	T	5	4	9	0	0	9	0	0
18	38238072	.	T	C	2	2	4	0	0	4	0	0
18	38238833	.	C	A	2	3	5	0	0	5	0	0
18	38238866	.	A	T	3	4	7	0	0	7	0	0
18	38239034	.	A	G	3	4	7	0	0	7	0	0
18	38239040	.	A	G	3	4	7	0	0	7	0	0
18	38239073	.	C	T	4	3	7	0	0	7	0	0
18	38240682	.	T	A	5	2	7	0	0	7	0	0
18	38240685	.	A	G	6	2	8	0	0	8	0	0
18	38248121	.	T	C	5	9	14	0	1	15	0	0
18	38250924	.	A	G	24	19	43	0	1	44	0	0
18	38256265	.	T	C	13	0	13	0	5	18	0	0
18	38256668	.	A	G	16	12	28	0	2	30	0	0
18	38260152	.	T	C	12	10	22	0	0	22	0	0
18	38260330	.	A	G	7	11	18	0	3	21	0	0
18	38260352	.	C	A	8	8	16	0	0	16	0	0
18	38260377	.	C	T	10	7	17	0	1	18	0	0
18	38263910	.	G	C	8	4	12	0	0	12	0	0
18	38266979	.	C	T	9	7	16	0	2	18	0	0
18	38270559	.	T	C	4	10	14	0	0	14	0	0
18	38296046	.	C	G	8	13	21	0	0	21	0	0
18	38296089	.	G	T	4	8	12	0	1	13	0	0
18	39104846	.	T	C	8	7	15	0	0	15	0	0
18	39293066	.	A	G	10	15	25	0	3	28	0	0
18	39319441	.	C	T	1	11	12	0	0	12	0	0
18	39523000	.	G	T	3	2	5	0	0	5	0	0
18	39523002	.	T	C	1	3	4	0	1	5	0	0
18	41267668	.	A	G	2	2	4	0	1	5	0	0
18	41267988	.	T	A	4	2	6	0	1	7	0	0
18	41278299	.	G	A	6	6	12	0	1	13	0	0
18	41278644	.	T	C	4	4	8	0	0	8	0	0
18	41284700	.	C	T	7	7	14	0	0	14	0	0
18	41293901	.	A	T	2	3	5	0	1	6	0	0
18	41295246	.	C	T	9	13	22	0	1	23	0	0
18	41297082	.	C	T	11	6	17	0	1	18	0	0
18	41305867	.	C	T	5	6	11	0	1	12	0	0
18	41309305	.	G	A	24	18	42	0	1	43	0	0
18	41309583	.	T	G	1	0	1	0	7	8	0	0
18	41309584	.	T	G	2	0	2	0	6	8	0	0
18	41310196	.	A	G	4	0	4	0	3	7	0	0
18	41310464	.	G	A	0	15	15	0	12	27	0	0
18	41364527	.	C	G	1	2	3	0	1	4	0	0
18	41365011	.	A	G	3	3	6	0	0	6	0	0
18	41365023	.	C	T	2	2	4	0	1	5	0	0
18	41365051	.	A	T	4	4	8	0	0	8	0	0
18	41365125	.	G	A	2	5	7	0	0	7	0	0
18	41365482	.	C	T	2	2	4	0	0	4	0	0
18	41365649	.	G	T	2	3	5	0	0	5	0	0
18	41372193	.	G	A	2	2	4	0	0	4	0	0
18	41431891	.	G	T	2	2	4	0	0	4	0	0
18	41495859	.	A	G	15	20	35	0	1	36	0	0
18	41495865	.	A	T	13	15	28	0	5	33	0	0
18	41499590	.	T	C	17	14	31	0	2	33	0	0
18	41499679	.	A	G	14	5	19	0	1	20	0	0
18	41499683	.	T	C	12	5	17	0	1	18	0	0
18	41499789	.	C	T	15	10	25	0	2	27	0	0
18	41503578	.	C	A	26	16	42	0	1	43	0	0
18	41505624	.	A	G	25	0	25	0	19	44	0	0
18	41509564	.	C	G	20	7	27	0	0	27	0	0
18	41509716	.	G	T	17	9	26	0	0	26	0	0
18	41512217	.	C	T	9	12	21	0	1	22	0	0
18	41512370	.	G	A	8	7	15	0	0	15	0	0
18	41514977	.	C	A	4	3	7	0	0	7	0	0
18	41524354	.	G	A	23	26	49	0	2	51	0	0
18	41524364	.	C	A	22	25	47	0	2	49	0	0
18	41525864	.	T	C	20	23	43	0	1	44	0	0
18	41525880	.	G	A	1	21	22	0	20	42	0	0
18	41526014	.	C	G	11	0	11	0	21	32	0	0
18	41526026	.	A	G	14	17	31	0	1	32	0	0
18	41526247	.	T	A	17	17	34	0	1	35	0	0
18	41526299	.	T	A	8	15	23	0	2	25	0	0
18	41526318	.	A	G	10	11	21	0	1	22	0	0
18	41526380	.	C	T	3	5	8	0	0	8	0	0
18	41526381	.	T	C	5	3	8	0	2	10	0	0
18	41533072	.	C	T	5	10	15	0	1	16	0	0
18	41538770	.	G	A	4	10	14	0	0	14	0	0
18	41542632	.	A	G	4	3	7	0	0	7	0	0
18	41542661	.	A	T	3	3	6	0	0	6	0	0
18	41542669	.	T	A	2	4	6	0	0	6	0	0
18	41542712	.	T	C	2	3	5	0	0	5	0	0
18	41542790	.	T	G	4	6	10	0	0	10	0	0
18	41543076	.	C	T	6	6	12	0	0	12	0	0
18	41546938	.	C	G	2	5	7	0	1	8	0	0
18	41556239	.	G	A	0	7	7	0	7	14	0	0
18	41558711	.	C	T	5	4	9	0	0	9	0	0
18	41559074	.	C	T	1	2	3	0	0	3	0	0
18	41561057	.	C	A	3	2	5	0	0	5	0	0
18	41561248	.	C	T	2	3	5	0	1	6	0	0
18	41565746	.	G	A	0	3	3	0	6	9	0	0
18	41572445	.	T	C	0	3	3	0	1	4	0	0
18	41573681	.	T	C	4	4	8	0	0	8	0	0
18	41573696	.	A	G	5	3	8	0	1	9	0	0
18	41573948	.	G	A	0	4	4	0	3	7	0	0
18	41574287	.	T	C	4	2	6	0	0	6	0	0
18	41574340	.	C	T	2	2	4	0	0	4	0	0
18	41574557	.	T	C	2	6	8	0	0	8	0	0
18	41574608	.	T	C	6	7	13	0	0	13	0	0
18	41579975	.	T	A	7	8	15	0	0	15	0	0
18	41580151	.	A	T	5	6	11	0	0	11	0	0
18	41586440	.	T	C	7	8	15	0	1	16	0	0
18	41588148	.	A	G	4	1	5	0	12	17	0	0
18	41588166	.	C	T	5	10	15	0	0	15	0	0
18	41589613	.	A	C	7	7	14	0	1	15	0	0
18	41591256	.	G	T	9	2	11	0	0	11	0	0
18	41649061	.	C	T	8	10	18	0	0	18	0	0
18	41649571	.	A	G	5	7	12	0	0	12	0	0
18	41757350	.	C	A	15	14	29	0	2	31	0	0
18	41757449	.	G	A	19	22	41	0	1	42	0	0
18	41757454	.	G	A	15	25	40	0	3	43	0	0
18	41757669	.	C	T	26	26	52	0	4	56	0	0
18	41764434	.	G	A	19	30	49	0	0	49	0	0
18	41764452	.	G	C	19	0	19	0	34	53	0	0
18	41808695	.	T	C	3	4	7	0	0	7	0	0
18	42151412	.	A	C	18	1	19	0	15	34	0	0
18	42165295	.	A	C	5	6	11	0	0	11	0	0
18	42171988	.	T	C	6	0	6	0	5	11	0	0
18	42189660	.	G	A	8	7	15	1	2	18	0	0
18	42189675	.	A	C	9	0	9	1	7	17	0	0
18	42201141	.	C	G	9	9	18	0	0	18	0	0
18	42313749	.	T	C	2	3	5	0	0	5	0	0
18	43162650	.	T	C	12	8	20	0	1	21	0	0
18	43183845	.	T	C	9	11	20	0	3	23	0	0
18	43225614	.	T	C	14	20	34	0	0	34	0	0
18	43225650	.	C	T	18	20	38	0	1	39	0	0
18	43225683	.	C	T	17	23	40	0	1	41	0	0
18	43225896	.	C	T	20	22	42	0	2	44	0	0
18	44321063	.	A	G	1	4	5	0	1	6	0	0
18	44321260	.	T	A	14	5	19	0	0	19	0	0
18	44321323	.	C	T	7	2	9	1	0	10	0	0
18	44321424	.	A	C	1	2	3	0	0	3	0	0
18	44321812	.	A	T	4	3	7	0	0	7	0	0
18	44321909	.	G	A	1	4	5	0	1	6	0	0
18	44321949	.	T	C	1	4	5	0	0	5	0	0
18	44322043	.	T	A	2	3	5	0	1	6	0	0
18	44322377	.	T	C	5	3	8	0	1	9	0	0
18	44322381	.	T	A	3	6	9	0	0	9	0	0
18	44322481	.	C	T	0	6	6	0	11	17	0	0
18	44325470	.	A	G	5	12	17	0	0	17	0	0
18	44327944	.	A	G	4	9	13	0	1	14	0	0
18	44327953	.	G	A	4	8	12	0	1	13	0	0
18	44331117	.	G	C	4	5	9	0	0	9	0	0
18	44332725	.	C	T	5	6	11	0	0	11	0	0
18	44334889	.	C	T	3	2	5	0	0	5	0	0
18	44345920	.	T	C	1	0	1	0	4	5	0	0
18	44346150	.	C	A	0	3	3	0	1	4	0	0
18	44364647	.	C	A	23	24	47	0	2	49	0	0
18	44365064	.	C	A	29	29	58	0	2	60	0	0
18	44365114	.	T	A	35	30	65	0	1	66	0	0
18	44365650	.	T	C	19	22	41	0	1	42	0	0
18	44365714	.	C	A	28	30	58	0	0	58	0	0
18	44365717	.	A	G	27	30	57	0	0	57	0	0
18	44365977	.	T	C	12	25	37	0	1	38	0	0
18	44365987	.	T	A	14	25	39	0	1	40	0	0
18	44366079	.	T	A	2	4	6	0	0	6	0	0
18	44367241	.	A	T	12	17	29	0	3	32	0	0
18	44367426	.	C	T	30	17	47	0	2	49	0	0
18	44367488	.	G	A	23	25	48	0	4	52	0	0
18	44377404	.	C	A	25	8	33	0	2	35	0	0
18	44377417	.	C	T	24	9	33	0	0	33	0	0
18	44388421	.	C	T	19	12	31	0	2	33	0	0
18	44397330	.	G	A	13	11	24	0	2	26	0	0
18	44404609	.	C	T	20	17	37	0	1	38	0	0
18	44404872	.	C	T	11	21	32	0	2	34	0	0
18	44408841	.	G	A	13	15	28	3	1	32	0	0
18	44418164	.	C	T	10	13	23	0	1	24	0	0
18	44425093	.	A	G	10	14	24	0	2	26	0	0
18	44425105	.	C	T	9	15	24	0	0	24	0	0
18	44425150	.	A	C	8	12	20	0	0	20	0	0
18	44453365	.	G	A	6	9	15	0	0	15	0	0
18	44453377	.	G	C	9	1	10	0	5	15	0	0
18	44564123	.	C	T	1	2	3	0	0	3	0	0
18	44564180	.	G	A	0	2	2	0	1	3	0	0
18	44567471	.	A	C	1	3	4	0	0	4	0	0
18	44574263	.	C	T	1	5	6	0	0	6	0	0
18	44576790	.	C	T	3	3	6	0	0	6	0	0
18	44576845	.	C	T	3	2	5	0	0	5	0	0
18	44579965	.	G	A	3	4	7	0	1	8	0	0
18	44587696	.	C	A	3	2	5	0	0	5	0	0
18	44587777	.	C	A	1	6	7	0	0	7	0	0
18	44589770	.	G	C	6	3	9	0	1	10	0	0
18	44597048	.	G	A	3	3	6	0	0	6	0	0
18	44597308	.	C	A	24	24	48	0	5	53	0	0
18	44597850	.	A	G	15	9	24	0	0	24	0	0
18	44598234	.	C	T	2	11	13	0	17	30	0	0
18	44598371	.	C	T	12	7	19	0	0	19	0	0
18	44599837	.	G	A	22	21	43	2	1	46	0	0
18	44606194	.	G	A	11	5	16	0	0	16	0	0
18	44615685	.	G	A	9	5	14	0	1	15	0	0
18	44615770	.	G	A	9	16	25	0	0	25	0	0
18	44615819	.	T	C	9	15	24	1	0	25	0	0
18	44615861	.	A	T	9	9	18	1	1	20	0	0
18	44618795	.	G	T	15	23	38	0	1	39	0	0
18	44619049	.	T	G	10	19	29	0	2	31	0	0
18	44623527	.	G	A	11	14	25	0	1	26	0	0
18	44633387	.	G	A	0	2	2	0	3	5	0	0
18	44633642	.	A	G	1	0	1	0	4	5	0	0
18	44637835	.	A	T	4	2	6	0	2	8	0	0
18	44637898	.	G	A	5	4	9	0	0	9	0	0
18	44638087	.	G	T	1	7	8	0	1	9	0	0
18	44640464	.	C	T	6	6	12	0	0	12	0	0
18	44640663	.	C	G	9	3	12	0	0	12	0	0
18	44642287	.	A	G	1	0	1	0	3	4	0	0
18	44645008	.	A	T	7	7	14	0	2	16	0	0
18	44645485	.	A	G	4	3	7	0	1	8	0	0
18	44645617	.	G	A	0	5	5	0	10	15	0	0
18	44645782	.	G	C	16	7	23	0	1	24	0	0
18	44645870	.	T	A	14	10	24	0	0	24	0	0
18	44646048	.	C	T	2	3	5	0	0	5	0	0
18	44646467	.	A	C	9	11	20	0	0	20	0	0
18	44646504	.	C	T	10	7	17	0	1	18	0	0
18	44646587	.	G	A	1	9	10	0	16	26	0	0
18	44646678	.	C	T	14	13	27	0	1	28	0	0
18	44646781	.	A	G	10	6	16	0	0	16	0	0
18	44682569	.	A	C	1	3	4	0	0	4	0	0
18	44692777	.	T	C	5	2	7	0	1	8	0	0
18	44696096	.	C	T	7	3	10	0	0	10	0	0
18	44696319	.	A	C	5	5	10	0	0	10	0	0
18	44757735	.	C	T	1	4	5	0	0	5	0	0
18	44757869	.	C	T	2	2	4	0	0	4	0	0
18	44757915	.	T	G	1	0	1	0	3	4	0	0
18	44763419	.	T	C	2	3	5	0	0	5	0	0
18	44764392	.	A	T	4	4	8	0	0	8	0	0
18	44765491	.	A	G	1	0	1	0	4	5	0	0
18	44770632	.	C	T	1	2	3	0	0	3	0	0
18	44779219	.	C	A	3	2	5	0	1	6	0	0
18	44781653	.	A	G	4	0	4	0	3	7	0	0
18	44782401	.	T	A	3	1	4	0	2	6	0	0
18	44782413	.	G	A	4	2	6	0	1	7	0	0
18	44783771	.	C	T	2	2	4	0	1	5	0	0
18	44790635	.	A	G	4	3	7	0	0	7	0	0
18	44790722	.	G	A	4	3	7	0	0	7	0	0
18	44791251	.	A	C	4	2	6	0	0	6	0	0
18	44826427	.	C	T	2	10	12	1	12	25	0	0
18	44826554	.	T	G	11	14	25	1	0	26	0	0
18	44826735	.	G	T	2	4	6	0	0	6	0	0
18	44826910	.	C	T	10	9	19	2	1	22	0	0
18	44830217	.	C	T	11	14	25	0	0	25	0	0
18	44830247	.	G	A	9	9	18	0	2	20	0	0
18	44830283	.	G	A	10	10	20	0	0	20	0	0
18	44832693	.	C	A	12	11	23	0	0	23	0	0
18	44834165	.	T	C	9	0	9	0	5	14	0	0
18	44837085	.	T	C	5	9	14	0	1	15	0	0
18	44838285	.	G	A	13	12	25	0	1	26	0	0
18	44838342	.	G	A	13	12	25	1	2	28	0	0
18	44840994	.	C	T	15	8	23	0	0	23	0	0
18	44843407	.	G	A	10	13	23	0	1	24	0	0
18	44843531	.	C	A	14	8	22	0	0	22	0	0
18	44849876	.	G	T	0	3	3	0	2	5	0	0
18	44857803	.	C	A	8	6	14	0	1	15	0	0
18	44866841	.	C	T	17	10	27	0	1	28	0	0
18	44870505	.	G	A	0	9	9	0	9	18	0	0
18	44870526	.	G	A	1	7	8	0	11	19	0	0
18	44870541	.	G	A	2	8	10	0	13	23	0	0
18	44873083	.	C	T	12	10	22	0	2	24	0	0
18	44873993	.	G	T	19	12	31	0	1	32	0	0
18	44874249	.	T	G	8	0	8	0	13	21	0	0
18	44874252	.	C	T	10	13	23	0	0	23	0	0
18	44913653	.	G	T	6	7	13	0	0	13	0	0
18	44913760	.	A	G	3	6	9	0	1	10	0	0
18	44913993	.	T	C	3	1	4	0	3	7	0	0
18	45231137	.	G	A	2	4	6	0	0	6	0	0
18	45235903	.	G	T	0	3	3	0	5	8	0	0
18	45235924	.	T	C	5	3	8	0	1	9	0	0
18	45248042	.	T	G	2	3	5	0	0	5	0	0
18	45257475	.	C	T	7	3	10	0	0	10	0	0
18	45259886	.	T	C	4	8	12	0	0	12	0	0
18	45259930	.	C	T	6	7	13	0	1	14	0	0
18	45260228	.	T	C	4	7	11	0	0	12	1	0
18	45260316	.	A	C	5	4	9	0	0	9	0	0
18	45260321	.	G	T	0	5	5	0	5	10	0	0
18	45260529	.	G	A	1	6	7	0	4	11	0	0
18	45260925	.	C	G	6	2	8	0	0	8	0	0
18	45261319	.	A	T	9	3	12	0	0	12	0	0
18	45261369	.	G	T	8	5	13	0	0	13	0	0
18	45261438	.	G	A	4	9	13	0	1	14	0	0
18	45261501	.	G	C	4	3	7	1	0	8	0	0
18	45261845	.	T	A	7	6	13	0	0	13	0	0
18	45261882	.	T	C	7	6	13	0	2	15	0	0
18	45262351	.	C	T	9	5	14	0	1	15	0	0
18	45262687	.	G	T	15	4	19	0	0	19	0	0
18	45262855	.	A	C	8	12	20	0	0	20	0	0
18	45262865	.	T	C	10	12	22	0	0	22	0	0
18	45550831	.	G	C	1	14	15	1	13	29	0	0
18	45550839	.	A	C	18	12	30	3	0	33	0	0
18	45561677	.	G	T	12	14	26	0	1	27	0	0
18	45569037	.	G	A	3	9	12	1	13	26	0	0
18	45569075	.	C	A	14	10	24	0	1	25	0	0
18	45569092	.	A	G	11	0	11	0	8	19	0	0
18	45574140	.	A	G	16	12	28	0	0	28	0	0
18	45574275	.	A	T	13	13	26	0	0	26	0	0
18	45575079	.	G	A	1	9	10	0	14	24	0	0
18	45581704	.	C	A	22	8	30	0	1	32	1	0
18	45581784	.	C	T	17	13	30	0	3	33	0	0
18	45583038	.	A	C	22	16	38	0	1	39	0	0
18	45583042	.	G	A	1	17	18	0	22	40	0	0
18	45584036	.	C	T	13	10	23	0	1	24	0	0
18	45584368	.	T	C	20	17	37	0	3	40	0	0
18	45588336	.	C	T	19	22	41	0	1	42	0	0
18	45591836	.	A	T	8	22	30	0	0	31	1	0
18	45591929	.	G	A	6	15	21	0	1	22	0	0
18	45647838	.	G	A	3	18	21	0	7	28	0	0
18	45647940	.	C	T	10	8	18	0	2	20	0	0
18	45649613	.	C	T	13	15	28	0	0	28	0	0
18	45649658	.	G	T	13	14	27	0	1	28	0	0
18	45651032	.	C	T	19	15	34	0	1	35	0	0
18	45651559	.	T	A	17	17	34	0	1	35	0	0
18	45656062	.	T	C	11	14	25	0	1	26	0	0
18	45656089	.	T	C	18	12	30	0	0	30	0	0
18	45684539	.	T	A	2	3	5	0	0	5	0	0
18	45684977	.	T	C	1	3	4	0	0	4	0	0
18	45685695	.	G	C	2	3	5	0	1	6	0	0
18	45685700	.	C	A	2	4	6	0	0	6	0	0
18	45686267	.	G	A	1	4	5	0	0	5	0	0
18	45686500	.	A	G	1	4	5	0	0	5	0	0
18	45686840	.	T	C	5	5	10	0	1	11	0	0
18	45686882	.	G	A	0	4	4	0	3	7	0	0
18	45687097	.	A	G	2	4	6	0	1	7	0	0
18	45687882	.	C	T	4	9	13	0	0	13	0	0
18	45689081	.	C	T	3	5	8	0	0	8	0	0
18	45691123	.	G	A	3	5	8	0	0	8	0	0
18	45697623	.	A	G	9	3	12	0	1	13	0	0
18	45697833	.	A	T	3	8	11	0	0	11	0	0
18	45697999	.	T	C	1	5	6	0	0	6	0	0
18	45698032	.	A	G	8	0	8	0	4	12	0	0
18	45734477	.	T	C	5	11	16	0	0	16	0	0
18	45742051	.	C	A	12	12	24	0	0	24	0	0
18	45742059	.	G	A	13	9	22	0	1	23	0	0
18	45743004	.	G	C	7	0	7	0	9	16	0	0
18	45743518	.	G	A	10	4	14	0	0	14	0	0
18	45743522	.	G	A	9	3	12	0	0	12	0	0
18	45743555	.	C	A	7	4	11	0	0	11	0	0
18	45745504	.	A	T	7	4	11	0	0	11	0	0
18	45750912	.	A	C	6	0	6	0	11	17	0	0
18	45750915	.	A	G	8	10	18	0	0	18	0	0
18	45752094	.	C	T	1	4	5	0	5	10	0	0
18	45759309	.	G	T	12	11	23	0	0	23	0	0
18	45784225	.	A	G	28	39	67	0	4	71	0	0
18	45807903	.	C	G	6	1	7	0	8	15	0	0
18	45807942	.	G	C	3	8	11	0	10	21	0	0
18	45809872	.	A	G	4	0	4	0	9	13	0	0
18	45809892	.	T	C	5	4	9	0	3	12	0	0
18	45818602	.	C	T	20	5	25	0	3	28	0	0
18	45820510	.	G	A	1	5	6	0	15	21	0	0
18	45820588	.	A	G	13	9	22	0	0	22	0	0
18	45824315	.	C	T	10	11	21	0	2	23	0	0
18	45824467	.	G	A	2	9	11	0	17	28	0	0
18	45824607	.	G	A	19	10	29	0	1	30	0	0
18	45835115	.	C	T	19	9	28	0	4	32	0	0
18	45840471	.	T	A	13	17	30	0	0	30	0	0
18	45840504	.	C	T	14	17	31	0	0	31	0	0
18	45842491	.	T	C	17	19	36	0	0	36	0	0
18	45842679	.	G	A	1	24	25	0	25	50	0	0
18	45844458	.	C	T	22	15	37	0	0	37	0	0
18	45844473	.	A	T	24	16	40	0	0	40	0	0
18	45848355	.	C	T	21	18	39	0	1	40	0	0
18	45849283	.	C	T	15	23	38	0	2	40	0	0
18	45851540	.	G	A	1	19	20	0	25	45	0	0
18	45887626	.	G	T	0	2	2	0	1	3	0	0
18	45914958	.	C	A	1	4	5	0	0	5	0	0
18	45934691	.	G	T	1	4	5	0	0	5	0	0
18	45936773	.	G	A	3	3	6	0	0	6	0	0
18	45947835	.	C	T	2	4	6	0	0	6	0	0
18	45947880	.	C	A	4	3	7	0	0	7	0	0
18	45947946	.	C	T	2	2	4	0	0	4	0	0
18	45948349	.	A	G	3	4	7	0	0	7	0	0
18	45962500	.	A	G	23	19	42	0	1	43	0	0
18	45962581	.	T	C	23	10	33	2	2	37	0	0
18	45962593	.	G	C	22	11	33	2	3	38	0	0
18	45962668	.	C	T	20	20	40	0	2	42	0	0
18	45969252	.	C	A	24	18	42	0	1	43	0	0
18	45979887	.	C	T	21	20	41	0	1	42	0	0
18	45983268	.	A	C	20	14	34	0	5	40	1	0
18	46005023	.	T	A	1	5	6	0	0	6	0	0
18	46012631	.	C	T	7	4	11	0	0	11	0	0
18	46015830	.	G	A	6	2	8	0	0	8	0	0
18	46057023	.	G	T	8	3	11	0	0	11	0	0
18	46059425	.	A	C	2	4	6	0	2	8	0	0
18	46061242	.	G	A	7	4	11	0	0	11	0	0
18	46061326	.	C	A	8	7	15	0	2	17	0	0
18	46063648	.	C	T	4	7	11	0	0	11	0	0
18	46367691	.	G	C	14	11	25	0	0	25	0	0
18	46367733	.	G	A	8	10	18	0	2	20	0	0
18	46367772	.	C	G	0	11	11	0	12	23	0	0
18	46368513	.	T	C	7	0	7	0	8	15	0	0
18	46368771	.	C	T	0	2	2	0	3	5	0	0
18	46417181	.	C	T	14	11	25	0	2	27	0	0
18	46417342	.	A	G	28	11	39	0	3	42	0	0
18	46417402	.	G	A	19	12	31	0	1	32	0	0
18	46417624	.	T	C	17	8	25	0	1	26	0	0
18	46417714	.	G	C	18	13	31	0	0	31	0	0
18	46417775	.	T	C	21	0	21	0	10	31	0	0
18	46418632	.	G	A	8	11	19	0	0	19	0	0
18	46418818	.	C	A	9	9	18	0	1	19	0	0
18	46418860	.	C	T	2	6	8	0	9	17	0	0
18	46418932	.	T	A	12	5	17	0	0	17	0	0
18	46419124	.	T	C	7	7	14	0	1	15	0	0
18	46419275	.	T	C	7	11	18	0	0	18	0	0
18	46419451	.	A	T	6	4	10	0	0	10	0	0
18	46419616	.	T	C	2	3	5	0	0	5	0	0
18	46634622	.	T	C	5	4	9	0	0	9	0	0
18	46635323	.	G	T	5	7	12	0	1	13	0	0
18	46635390	.	G	C	9	4	13	0	2	15	0	0
18	46635591	.	C	T	10	7	17	0	1	18	0	0
18	46635805	.	C	G	11	6	17	0	1	18	0	0
18	46653344	.	G	A	6	6	12	0	2	14	0	0
18	46684230	.	A	T	3	7	10	0	0	10	0	0
18	46684258	.	G	T	4	3	7	0	1	8	0	0
18	46699773	.	G	A	31	17	48	0	2	50	0	0
18	46702492	.	G	A	19	24	43	0	0	43	0	0
18	46714896	.	A	G	8	13	21	0	0	21	0	0
18	46729044	.	A	G	7	5	12	0	0	12	0	0
18	46729321	.	A	G	13	7	20	0	1	21	0	0
18	46732406	.	C	G	6	10	16	0	0	16	0	0
18	46732417	.	T	A	4	12	16	0	1	17	0	0
18	46735972	.	T	C	2	4	6	0	0	6	0	0
18	46738862	.	C	A	0	11	11	0	8	19	0	0
18	46738955	.	A	C	11	13	24	0	0	24	0	0
18	46738990	.	A	T	9	7	16	0	2	18	0	0
18	47095635	.	G	A	1	2	3	0	0	3	0	0
18	47301204	.	T	C	1	6	7	0	1	8	0	0
18	47305433	.	A	G	7	6	13	0	0	13	0	0
18	47523393	.	A	G	2	3	5	0	0	5	0	0
18	47566919	.	A	T	1	4	5	0	1	6	0	0
18	47567902	.	C	T	1	4	5	0	0	5	0	0
18	48620495	.	C	T	3	4	7	0	1	8	0	0
18	48640143	.	G	C	0	6	6	0	4	10	0	0
18	48640155	.	G	C	0	5	5	0	5	10	0	0
18	48640284	.	C	G	6	0	6	0	5	11	0	0
18	48640317	.	G	T	0	6	6	0	6	12	0	0
18	48640348	.	A	G	2	0	2	0	8	10	0	0
18	48640417	.	G	C	5	1	6	0	2	8	0	0
18	48640420	.	A	G	4	1	5	0	2	7	0	0
18	48641451	.	T	A	1	3	4	0	0	4	0	0
18	48642077	.	T	A	2	4	6	0	0	6	0	0
18	48642161	.	A	T	3	2	5	0	0	5	0	0
18	48642821	.	C	T	8	3	11	0	0	11	0	0
18	48642868	.	A	T	7	2	9	0	0	9	0	0
18	48707463	.	T	C	2	0	2	0	2	4	0	0
18	48759970	.	A	C	2	9	11	0	1	12	0	0
18	48803191	.	C	T	2	3	5	0	1	6	0	0
18	48807623	.	C	T	0	2	2	0	1	3	0	0
18	48808043	.	A	G	2	2	4	0	0	4	0	0
18	48808099	.	A	G	3	3	6	0	0	6	0	0
18	48808552	.	T	C	3	4	7	0	0	7	0	0
18	48808659	.	G	A	0	3	3	0	2	5	0	0
18	48809226	.	G	A	9	6	15	0	0	15	0	0
18	48809268	.	T	A	5	2	7	0	1	8	0	0
18	48809276	.	A	G	5	0	5	0	2	7	0	0
18	48864856	.	T	C	5	11	16	0	0	16	0	0
18	48864944	.	C	T	7	9	16	0	0	16	0	0
18	48898641	.	C	T	10	4	14	0	0	14	0	0
18	48928230	.	C	T	11	16	27	0	1	28	0	0
18	48928240	.	A	G	13	0	13	0	18	31	0	0
18	48928342	.	A	G	8	1	9	0	17	26	0	0
18	48928387	.	T	A	10	17	27	0	2	30	1	0
18	48934524	.	T	C	12	15	27	0	2	29	0	0
18	48934593	.	T	C	11	19	30	0	1	31	0	0
18	48934805	.	A	G	15	5	20	0	2	22	0	0
18	48934833	.	T	C	15	9	24	0	0	24	0	0
18	48935170	.	G	A	16	21	37	0	3	40	0	0
18	48935279	.	T	G	24	16	40	1	1	42	0	0
18	48935282	.	T	G	23	16	39	1	1	41	0	0
18	48935394	.	A	T	8	16	24	0	0	24	0	0
18	48935709	.	A	G	19	15	34	0	3	37	0	0
18	48935907	.	T	C	2	6	8	0	0	8	0	0
18	48957845	.	T	A	2	2	4	0	0	4	0	0
18	48968436	.	C	G	4	0	4	0	3	7	0	0
18	48971165	.	T	C	5	8	13	0	0	13	0	0
18	48971192	.	A	G	6	12	18	0	0	18	0	0
18	48972490	.	A	T	7	11	18	0	0	18	0	0
18	49154079	.	A	G	10	3	13	0	0	13	0	0
18	49154207	.	A	G	13	5	18	0	3	21	0	0
18	49155520	.	A	G	7	11	18	0	1	19	0	0
18	49156077	.	A	G	15	0	15	0	6	21	0	0
18	49156370	.	A	G	1	3	4	0	0	4	0	0
18	49156437	.	T	A	0	6	6	0	1	7	0	0
18	49266171	.	A	G	1	4	5	1	0	6	0	0
18	49266182	.	A	G	1	3	4	0	0	4	0	0
18	49266589	.	A	G	5	7	12	0	0	12	0	0
18	49266932	.	A	G	3	6	9	0	0	9	0	0
18	49266944	.	A	G	3	7	10	0	2	12	0	0
18	49266998	.	A	G	5	10	15	0	1	16	0	0
18	49267605	.	A	G	7	4	11	6	0	17	0	0
18	50038325	.	G	T	0	8	8	0	2	10	0	0
18	50038375	.	G	T	1	2	3	0	2	5	0	0
18	50040012	.	A	T	4	3	7	0	0	7	0	0
18	50538289	.	T	C	13	8	21	0	1	22	0	0
18	50538340	.	T	C	8	9	17	0	0	17	0	0
18	50538442	.	T	C	9	5	14	0	0	14	0	0
18	50538598	.	T	C	6	5	11	0	0	11	0	0
18	50823336	.	A	G	2	0	2	0	4	6	0	0
18	50911943	.	C	G	8	3	11	5	0	16	0	0
18	50911951	.	T	C	3	6	9	5	0	14	0	0
19	372765	.	A	G	9	0	9	0	8	17	0	0
19	372776	.	A	G	9	3	12	0	0	12	0	0
19	433735	.	T	C	0	3	3	0	0	3	0	0
19	433736	.	T	C	0	3	3	0	0	3	0	0
19	1013150	.	T	C	7	4	11	0	0	11	0	0
19	1185281	.	G	A	8	3	11	0	1	12	0	0
19	1561476	.	T	C	4	2	6	0	0	6	0	0
19	1562607	.	T	C	3	2	5	0	0	5	0	0
19	1995441	.	A	G	10	3	13	0	0	13	0	0
19	2001557	.	T	C	1	8	9	0	0	9	0	0
19	2001618	.	A	C	2	6	8	0	0	8	0	0
19	2002992	.	A	G	3	0	3	0	5	8	0	0
19	2003150	.	T	C	3	7	10	0	1	11	0	0
19	2003158	.	C	T	3	9	12	0	1	13	0	0
19	2003634	.	T	C	1	3	4	0	0	4	0	0
19	2003767	.	C	T	10	7	17	0	0	17	0	0
19	2003902	.	A	T	9	9	18	0	0	18	0	0
19	2003962	.	G	T	1	7	8	0	8	16	0	0
19	2004046	.	G	C	7	7	14	0	0	14	0	0
19	2019147	.	C	T	0	4	4	0	3	7	0	0
19	2019480	.	C	T	1	3	4	0	5	9	0	0
19	2064629	.	G	A	1	2	3	0	0	3	0	0
19	2064762	.	G	C	3	4	7	0	0	7	0	0
19	2071672	.	A	G	2	2	4	0	0	4	0	0
19	2083254	.	C	T	1	2	3	0	0	3	0	0
19	2093318	.	G	A	2	3	5	0	0	5	0	0
19	2279284	.	C	T	9	5	14	0	0	14	0	0
19	2292831	.	T	C	4	2	6	0	0	6	0	0
19	2294971	.	G	C	4	8	12	0	0	12	0	0
19	2307248	.	C	A	5	6	11	0	0	11	0	0
19	2307268	.	C	T	4	6	10	0	0	10	0	0
19	2315666	.	A	G	3	2	5	0	0	5	0	0
19	2315707	.	A	G	0	1	1	1	1	3	0	0
19	2316510	.	T	C	2	3	5	0	0	5	0	0
19	2395383	.	T	C	1	2	3	0	0	3	0	0
19	2396022	.	C	T	2	5	7	0	0	7	0	0
19	2396647	.	C	T	2	2	4	0	1	5	0	0
19	2396743	.	A	G	3	3	6	0	0	6	0	0
19	2396898	.	G	A	1	2	3	0	0	3	0	0
19	2397381	.	G	C	4	2	6	0	0	6	0	0
19	2397559	.	T	C	1	4	5	0	0	5	0	0
19	2400403	.	G	A	6	4	10	0	0	10	0	0
19	2400519	.	C	T	1	5	6	0	0	6	0	0
19	2402609	.	T	A	6	6	12	0	0	12	0	0
19	2402611	.	T	A	6	5	11	0	1	12	0	0
19	2403906	.	T	C	3	0	3	0	4	7	0	0
19	2550676	.	G	A	8	3	11	0	1	12	0	0
19	2550839	.	C	T	6	4	10	0	1	11	0	0
19	2551178	.	A	G	4	5	9	0	0	9	0	0
19	2551214	.	C	T	4	6	10	0	0	10	0	0
19	2551727	.	C	T	8	4	12	0	0	12	0	0
19	2560950	.	A	G	10	6	16	0	0	16	0	0
19	2561048	.	A	C	4	8	12	0	0	12	0	0
19	2561328	.	T	A	3	5	8	0	1	9	0	0
19	2561445	.	C	A	9	0	9	1	0	10	0	0
19	2561624	.	C	T	3	3	6	1	11	18	0	0
19	2561739	.	G	A	1	8	9	0	9	18	0	0
19	2561861	.	A	G	7	5	12	0	0	12	0	0
19	2561873	.	A	G	1	5	6	0	0	6	0	0
19	2562472	.	A	G	5	8	13	0	1	14	0	0
19	2602934	.	G	A	4	10	14	0	0	14	0	0
19	2645115	.	C	T	2	8	10	0	1	11	0	0
19	2651272	.	A	G	8	4	12	0	1	13	0	0
19	2651344	.	G	A	0	8	8	0	9	17	0	0
19	2654388	.	A	T	10	3	13	0	0	13	0	0
19	2654424	.	C	T	10	5	15	0	1	16	0	0
19	2663609	.	A	G	4	14	18	0	0	18	0	0
19	2664125	.	G	A	6	6	12	0	3	15	0	0
19	2664394	.	C	T	15	10	25	0	0	25	0	0
19	2664613	.	T	C	11	8	19	0	1	20	0	0
19	2685839	.	T	C	4	5	9	0	0	9	0	0
19	2695030	.	T	C	17	17	34	0	2	36	0	0
19	2695314	.	G	A	9	8	17	0	0	17	0	0
19	2695351	.	A	G	6	0	6	0	7	13	0	0
19	2695358	.	G	A	6	5	11	0	1	12	0	0
19	2731100	.	C	T	7	6	13	0	2	15	0	0
19	2732833	.	C	T	2	5	7	0	0	7	0	0
19	2732836	.	G	A	3	5	8	0	0	8	0	0
19	2744169	.	C	G	5	6	11	0	0	11	0	0
19	2746008	.	G	A	1	6	7	0	7	14	0	0
19	2746134	.	C	T	8	6	14	0	1	15	0	0
19	2750162	.	G	A	1	14	15	0	9	24	0	0
19	2750973	.	C	T	10	8	18	0	2	20	0	0
19	2846815	.	C	T	1	2	3	0	0	3	0	0
19	2857957	.	G	C	2	2	4	0	0	4	0	0
19	2871511	.	A	G	6	8	14	0	0	14	0	0
19	2871553	.	C	T	7	8	15	0	0	15	0	0
19	2871559	.	G	A	8	7	15	0	0	15	0	0
19	2874618	.	T	C	5	2	7	0	0	7	0	0
19	2880138	.	C	T	2	3	5	0	0	5	0	0
19	2884207	.	C	T	2	2	4	0	0	4	0	0
19	2886952	.	G	A	3	3	6	0	0	6	0	0
19	2887046	.	G	C	0	2	2	0	1	3	0	0
19	2930451	.	G	A	2	2	4	0	0	4	0	0
19	2930521	.	T	C	3	3	6	0	0	6	0	0
19	2930597	.	A	G	8	4	12	0	1	13	0	0
19	2934321	.	A	G	2	5	7	0	0	7	0	0
19	2965923	.	A	G	2	2	4	0	0	4	0	0
19	2967894	.	A	G	1	2	3	0	0	3	0	0
19	3002047	.	G	A	1	2	3	0	1	4	0	0
19	3052828	.	A	G	4	2	6	0	0	6	0	0
19	3052836	.	A	T	5	2	7	0	0	7	0	0
19	3053041	.	C	T	2	2	4	0	0	4	0	0
19	3056629	.	C	T	4	4	8	0	0	8	0	0
19	3080477	.	A	G	12	4	16	0	2	18	0	0
19	3080572	.	G	A	2	2	4	0	0	4	0	0
19	3080712	.	T	A	6	8	14	0	0	14	0	0
19	3080938	.	A	G	4	2	6	0	0	6	0	0
19	3081025	.	A	G	10	3	13	0	1	14	0	0
19	3081096	.	A	T	2	2	4	0	0	4	0	0
19	3081154	.	G	C	3	2	5	0	0	5	0	0
19	3081206	.	G	T	4	4	8	0	1	9	0	0
19	3081388	.	A	G	5	0	5	0	5	10	0	0
19	3081394	.	A	G	3	6	9	0	0	9	0	0
19	3081628	.	T	C	4	3	7	2	0	9	0	0
19	3081927	.	G	A	9	3	12	0	1	13	0	0
19	3081933	.	G	A	3	4	7	0	8	15	0	0
19	3081995	.	T	C	12	6	18	0	1	19	0	0
19	3081997	.	C	T	12	7	19	0	0	19	0	0
19	3082044	.	A	G	13	5	18	0	0	18	0	0
19	3082053	.	T	C	10	7	17	0	0	17	0	0
19	3082102	.	C	T	8	4	12	0	1	13	0	0
19	3082159	.	C	G	11	3	14	0	0	14	0	0
19	3087025	.	A	G	1	5	6	0	0	6	0	0
19	3096448	.	C	T	0	3	3	0	1	4	0	0
19	3105398	.	A	G	2	2	4	0	0	4	0	0
19	3137727	.	C	T	2	29	31	1	22	54	0	0
19	3137761	.	C	A	24	25	49	1	1	51	0	0
19	3137803	.	A	T	22	16	38	0	4	42	0	0
19	3137888	.	T	C	21	0	21	0	17	38	0	0
19	3138325	.	A	C	18	15	33	0	1	34	0	0
19	3138355	.	T	G	21	14	35	0	2	37	0	0
19	3138638	.	T	C	10	0	10	0	13	23	0	0
19	3142240	.	T	C	7	11	18	0	0	18	0	0
19	3142260	.	T	C	10	0	10	0	9	19	0	0
19	3142286	.	C	G	7	6	13	0	0	13	0	0
19	3144567	.	A	G	8	9	17	0	0	17	0	0
19	3144841	.	T	A	11	8	19	0	0	19	0	0
19	3144859	.	C	T	7	4	11	0	1	12	0	0
19	3206382	.	G	A	14	11	25	0	0	25	0	0
19	3215468	.	A	G	7	10	17	0	1	18	0	0
19	3222241	.	G	A	6	10	16	0	1	17	0	0
19	3229424	.	A	G	7	8	15	0	0	15	0	0
19	3238395	.	T	A	16	20	36	0	4	40	0	0
19	3238425	.	T	C	24	24	48	0	0	48	0	0
19	3238721	.	T	A	37	29	66	0	2	68	0	0
19	3240409	.	G	C	27	22	49	0	1	50	0	0
19	3379718	.	A	G	1	3	4	0	1	5	0	0
19	3386258	.	T	A	18	12	30	0	0	30	0	0
19	3386358	.	A	G	6	10	16	0	2	18	0	0
19	3386485	.	C	A	10	12	22	0	0	22	0	0
19	3386873	.	C	T	16	11	27	0	5	32	0	0
19	3387040	.	C	A	3	18	21	0	8	30	1	0
19	3387068	.	A	C	13	20	33	0	0	33	0	0
19	3387097	.	C	G	15	19	34	0	1	35	0	0
19	3387506	.	G	A	20	11	31	0	1	32	0	0
19	3387713	.	G	A	17	24	41	0	3	44	0	0
19	3388376	.	T	C	23	15	38	0	4	42	0	0
19	3388467	.	T	C	20	19	39	0	0	39	0	0
19	3388617	.	G	A	14	10	24	0	1	25	0	0
19	3390203	.	G	A	13	17	30	0	1	31	0	0
19	3390283	.	G	T	12	8	20	0	0	20	0	0
19	3390506	.	C	G	12	15	27	0	0	27	0	0
19	3391530	.	G	T	6	2	8	0	1	9	0	0
19	3391608	.	T	A	4	5	9	0	0	9	0	0
19	3391669	.	A	G	5	4	9	0	0	9	0	0
19	3391805	.	T	G	11	10	21	0	0	21	0	0
19	3392127	.	G	A	6	10	16	0	0	16	0	0
19	3392178	.	C	T	5	7	12	0	2	14	0	0
19	3392415	.	G	T	8	7	15	0	0	15	0	0
19	3392481	.	A	G	6	14	20	0	0	20	0	0
19	3393128	.	A	T	10	7	17	0	0	17	0	0
19	3393343	.	G	C	10	5	15	0	0	15	0	0
19	3393437	.	T	A	6	2	8	0	0	8	0	0
19	3395277	.	C	G	0	3	3	0	5	8	0	0
19	3395763	.	T	A	1	3	4	0	0	4	0	0
19	3396288	.	T	C	3	2	5	0	0	5	0	0
19	3539605	.	G	A	3	3	6	0	0	6	0	0
19	3573912	.	A	T	3	7	10	0	0	10	0	0
19	3573971	.	A	G	1	4	5	0	3	8	0	0
19	3577885	.	C	G	1	3	4	0	0	4	0	0
19	3577907	.	C	A	1	3	4	0	0	4	0	0
19	3577953	.	A	C	2	4	6	0	0	6	0	0
19	3577994	.	A	G	2	6	8	0	0	8	0	0
19	3577997	.	A	G	2	6	8	0	0	8	0	0
19	3653989	.	C	T	3	2	5	0	0	5	0	0
19	3654052	.	T	A	2	2	4	0	0	4	0	0
19	3681077	.	T	C	4	2	6	0	0	6	0	0
19	3702509	.	G	C	1	1	2	0	2	4	0	0
19	3702941	.	G	A	0	6	6	0	4	10	0	0
19	3703149	.	A	G	5	3	8	0	1	9	0	0
19	3703178	.	C	T	3	5	8	0	0	8	0	0
19	3706875	.	C	T	4	4	8	0	0	8	0	0
19	3706902	.	C	G	4	0	4	0	3	7	0	0
19	3707235	.	A	G	8	8	16	0	0	16	0	0
19	3707334	.	G	A	3	3	6	0	0	6	0	0
19	3707562	.	T	A	2	4	6	0	0	6	0	0
19	3707576	.	C	T	3	4	7	0	0	7	0	0
19	3707625	.	G	A	2	4	6	0	5	11	0	0
19	3718222	.	G	A	15	16	31	0	1	32	0	0
19	3718251	.	C	A	16	16	32	0	1	33	0	0
19	3718330	.	G	A	26	11	37	0	0	37	0	0
19	3718415	.	G	T	21	17	38	0	4	42	0	0
19	3718675	.	C	A	16	15	31	0	0	31	0	0
19	3865928	.	C	T	2	8	10	0	12	23	1	0
19	3866029	.	C	T	7	13	20	0	0	20	0	0
19	3866031	.	G	A	7	13	20	0	0	20	0	0
19	3866075	.	T	C	20	9	29	0	1	30	0	0
19	3866102	.	A	G	17	12	29	0	0	29	0	0
19	3866289	.	C	G	7	12	19	0	0	19	0	0
19	3866424	.	A	T	13	16	29	0	2	31	0	0
19	3866727	.	C	T	1	6	7	0	21	28	0	0
19	3868535	.	T	C	9	12	21	0	2	23	0	0
19	3868541	.	C	T	3	12	15	0	10	25	0	0
19	3872386	.	G	A	4	7	11	0	0	11	0	0
19	3872419	.	C	T	7	5	12	0	1	13	0	0
19	3872833	.	C	T	8	14	22	0	6	28	0	0
19	3873019	.	C	T	10	10	20	0	1	21	0	0
19	3873055	.	C	T	10	8	18	0	0	18	0	0
19	3873847	.	A	C	6	5	11	0	0	11	0	0
19	3873955	.	G	A	6	7	13	0	1	14	0	0
19	3874195	.	A	G	8	3	11	0	0	11	0	0
19	3874277	.	C	A	8	7	15	0	0	15	0	0
19	3874339	.	G	A	5	5	10	0	0	10	0	0
19	3876226	.	T	G	5	5	10	0	0	10	0	0
19	3876227	.	C	T	1	4	5	0	5	10	0	0
19	3876296	.	C	T	5	5	10	0	1	11	0	0
19	3878548	.	C	T	3	7	10	0	0	10	0	0
19	3878565	.	G	C	3	3	6	0	0	6	0	0
19	3937971	.	T	C	13	37	50	0	4	54	0	0
19	3939887	.	C	T	29	18	47	0	1	48	0	0
19	3939902	.	G	T	28	20	48	0	0	48	0	0
19	3940022	.	C	T	2	20	22	1	25	48	0	0
19	3945750	.	G	T	21	22	43	0	7	50	0	0
19	4010175	.	C	A	9	7	16	0	1	17	0	0
19	4024467	.	T	C	4	3	7	0	0	7	0	0
19	4089843	.	A	C	8	0	8	0	3	11	0	0
19	4089974	.	T	C	5	2	7	0	0	7	0	0
19	4127217	.	G	A	2	3	5	0	0	5	0	0
19	4130082	.	C	T	1	4	5	0	0	5	0	0
19	4137043	.	G	A	4	2	6	0	0	6	0	0
19	4137044	.	A	G	4	2	6	0	0	6	0	0
19	4142717	.	T	C	1	2	3	0	0	3	0	0
19	4279835	.	A	C	5	5	10	0	0	10	0	0
19	4291716	.	C	T	3	5	8	0	1	9	0	0
19	4341539	.	T	C	7	7	14	0	1	15	0	0
19	4443334	.	T	C	3	7	10	0	0	10	0	0
19	4443403	.	T	C	4	6	10	0	0	10	0	0
19	4445154	.	T	C	9	5	14	0	0	14	0	0
19	4445222	.	A	T	2	5	7	0	1	8	0	0
19	4445269	.	T	C	3	5	8	0	0	8	0	0
19	4447347	.	G	A	7	3	10	0	2	12	0	0
19	4447403	.	A	T	12	10	22	0	0	22	0	0
19	4447502	.	T	A	14	5	19	0	1	20	0	0
19	4464173	.	C	T	1	2	3	0	0	3	0	0
19	4464232	.	G	A	0	2	2	0	2	4	0	0
19	4828379	.	T	G	3	3	6	0	0	6	0	0
19	4828463	.	A	G	3	6	9	0	1	10	0	0
19	4828464	.	A	T	3	7	10	0	0	10	0	0
19	4833274	.	A	G	4	4	8	0	0	8	0	0
19	4833322	.	G	A	3	2	5	0	0	5	0	0
19	4857547	.	G	A	7	4	11	0	0	11	0	0
19	4857910	.	A	G	8	6	14	0	0	14	0	0
19	4857967	.	T	C	6	9	15	0	0	15	0	0
19	4866919	.	T	C	8	16	24	0	2	26	0	0
19	4867128	.	C	T	13	13	26	0	0	26	0	0
19	4867132	.	G	A	1	10	11	0	16	27	0	0
19	4875595	.	A	G	7	10	17	0	1	18	0	0
19	4877141	.	T	C	8	4	12	0	1	13	0	0
19	4878742	.	G	T	4	6	10	0	0	10	0	0
19	4878751	.	C	T	6	4	10	0	0	10	0	0
19	4881345	.	G	T	10	10	20	0	0	20	0	0
19	4888756	.	G	A	0	12	12	0	12	24	0	0
19	4892154	.	G	A	17	13	30	0	2	32	0	0
19	4892292	.	A	C	8	3	11	0	11	22	0	0
19	4892530	.	G	T	0	12	12	0	19	31	0	0
19	4892590	.	C	T	2	5	7	0	0	7	0	0
19	4892946	.	A	T	12	6	18	0	1	19	0	0
19	4903907	.	C	T	12	6	18	0	1	19	0	0
19	4903971	.	A	T	20	11	31	0	0	31	0	0
19	4904041	.	C	T	7	10	17	0	2	19	0	0
19	4904042	.	A	T	8	5	13	0	5	18	0	0
19	4904429	.	G	A	2	3	5	0	0	5	0	0
19	4904503	.	C	T	2	3	5	0	0	5	0	0
19	4904529	.	T	A	3	2	5	0	0	5	0	0
19	4905088	.	G	T	12	8	20	0	0	20	0	0
19	4905239	.	C	T	11	5	16	1	2	19	0	0
19	4951138	.	C	T	7	10	17	3	0	20	0	0
19	4951183	.	C	A	5	5	10	3	0	13	0	0
19	4955335	.	C	A	3	4	7	2	0	9	0	0
19	4961950	.	A	T	9	10	19	0	0	19	0	0
19	4961977	.	A	T	7	8	15	0	0	15	0	0
19	4962019	.	C	T	6	2	8	0	0	8	0	0
19	4970776	.	C	T	3	7	10	0	0	10	0	0
19	4973136	.	G	A	0	2	2	0	7	9	0	0
19	4976906	.	C	T	5	2	7	0	1	8	0	0
19	4976925	.	C	G	5	2	7	0	0	7	0	0
19	4977053	.	A	G	3	0	3	0	5	8	0	0
19	4978704	.	C	G	0	3	3	0	0	3	0	0
19	4978716	.	A	G	2	4	6	0	0	6	0	0
19	4981062	.	C	A	1	5	6	0	1	7	0	0
19	4984668	.	T	G	3	7	10	0	0	10	0	0
19	4984739	.	G	A	3	5	8	0	0	8	0	0
19	5001119	.	C	T	2	8	10	1	23	34	0	0
19	5003359	.	T	G	17	21	38	0	3	41	0	0
19	5007465	.	G	A	14	16	30	0	0	30	0	0
19	5007549	.	G	A	14	22	36	0	2	38	0	0
19	5009353	.	G	A	14	14	28	0	0	28	0	0
19	5009489	.	G	A	15	15	30	0	1	31	0	0
19	5016257	.	G	C	9	0	9	0	15	24	0	0
19	5018307	.	A	G	10	9	19	0	0	19	0	0
19	5019697	.	G	C	12	11	23	0	0	23	0	0
19	5019712	.	A	T	8	12	20	0	1	21	0	0
19	5019736	.	A	G	9	11	20	0	0	20	0	0
19	5022301	.	C	T	10	15	25	0	0	25	0	0
19	5024424	.	G	A	9	3	12	0	2	14	0	0
19	5024436	.	C	T	10	5	15	0	1	16	0	0
19	5024541	.	C	T	9	15	24	0	0	24	0	0
19	5024685	.	T	C	3	11	14	0	0	14	0	0
19	5025813	.	T	C	5	0	5	0	3	8	0	0
19	5030032	.	T	C	7	6	13	0	0	13	0	0
19	5030214	.	G	T	3	6	9	0	0	9	0	0
19	5030274	.	G	A	4	11	15	0	0	15	0	0
19	5031461	.	G	A	3	4	7	0	0	7	0	0
19	5034965	.	G	A	10	4	14	0	1	15	0	0
19	5037382	.	T	C	4	0	4	0	7	11	0	0
19	5048954	.	T	A	4	5	9	0	1	10	0	0
19	5058188	.	C	T	0	3	3	0	4	7	0	0
19	5058763	.	G	A	2	3	5	0	0	5	0	0
19	5077167	.	A	G	21	23	44	0	1	45	0	0
19	5077173	.	C	T	19	20	39	0	4	44	1	0
19	5080112	.	A	C	31	31	62	0	4	66	0	0
19	5081758	.	T	C	30	29	59	0	1	60	0	0
19	5089900	.	C	G	36	2	38	0	29	67	0	0
19	5090035	.	C	G	26	28	54	0	2	56	0	0
19	5091587	.	G	C	24	32	56	0	3	59	0	0
19	5091688	.	T	C	2	2	4	0	0	4	0	0
19	5094389	.	C	T	8	5	13	0	1	14	0	0
19	5094405	.	C	A	1	8	9	0	9	18	0	0
19	5094471	.	T	C	9	14	23	0	0	23	0	0
19	5094504	.	A	G	11	13	24	0	2	26	0	0
19	5094591	.	C	T	6	16	22	0	0	22	0	0
19	5094616	.	C	T	2	10	12	0	17	29	0	0
19	5100191	.	G	A	20	20	40	0	4	44	0	0
19	5135247	.	T	G	4	8	12	0	1	13	0	0
19	5135258	.	C	G	4	8	12	0	1	13	0	0
19	5146708	.	C	T	10	9	19	0	1	20	0	0
19	5149867	.	C	T	10	12	22	0	1	23	0	0
19	5158572	.	G	A	33	24	57	5	9	71	0	0
19	5158657	.	G	A	44	36	80	0	4	84	0	0
19	5158795	.	A	G	37	37	74	0	3	77	0	0
19	5159120	.	C	T	50	33	83	0	4	87	0	0
19	5159399	.	T	A	28	33	61	0	1	62	0	0
19	5160048	.	C	G	43	28	71	0	4	75	0	0
19	5160121	.	T	C	35	1	36	0	24	60	0	0
19	5160133	.	C	A	4	25	29	0	31	60	0	0
19	5160201	.	A	G	32	26	58	0	4	62	0	0
19	5160302	.	T	C	32	1	33	0	21	54	0	0
19	5160310	.	C	T	2	22	24	0	32	56	0	0
19	5160379	.	T	A	39	20	59	0	4	63	0	0
19	5160996	.	A	T	27	24	51	1	3	55	0	0
19	5161750	.	A	G	27	27	54	0	2	56	0	0
19	5162521	.	G	A	21	23	44	0	0	44	0	0
19	5162679	.	A	G	24	28	52	0	1	53	0	0
19	5163409	.	G	A	20	28	48	0	3	51	0	0
19	5163910	.	T	C	34	21	55	0	1	56	0	0
19	5300120	.	T	C	4	2	6	0	0	6	0	0
19	5302463	.	A	C	5	3	8	0	1	9	0	0
19	5305025	.	C	T	6	3	9	0	0	9	0	0
19	5305193	.	T	C	10	7	17	0	1	18	0	0
19	5305418	.	A	G	4	6	10	0	2	12	0	0
19	5305870	.	G	C	3	3	6	0	0	6	0	0
19	5316439	.	T	C	8	7	15	0	1	16	0	0
19	5611772	.	G	A	16	21	37	0	4	41	0	0
19	5611856	.	A	T	12	17	29	0	4	34	1	0
19	5619892	.	G	A	19	11	30	0	0	30	0	0
19	5619926	.	G	A	2	11	13	0	14	27	0	0
19	5620094	.	A	T	19	6	25	0	2	27	0	0
19	5620175	.	T	G	9	8	17	0	1	18	0	0
19	5620208	.	G	T	11	9	20	0	1	21	0	0
19	5620370	.	T	C	19	12	31	0	0	31	0	0
19	5620419	.	G	A	16	18	34	0	2	36	0	0
19	5620459	.	T	C	14	18	32	0	2	34	0	0
19	5620636	.	T	G	18	7	25	0	1	26	0	0
19	5620640	.	G	T	11	10	21	0	2	23	0	0
19	5621165	.	G	A	17	11	28	0	1	29	0	0
19	5621269	.	C	T	2	3	5	0	1	6	0	0
19	5779151	.	A	G	4	4	8	0	1	9	0	0
19	5779170	.	C	T	7	3	10	0	0	10	0	0
19	5779271	.	A	G	6	9	15	0	1	16	0	0
19	5779829	.	G	T	9	7	16	0	3	19	0	0
19	5779835	.	C	T	11	9	20	0	0	20	0	0
19	5779897	.	T	C	18	10	28	0	0	28	0	0
19	5780032	.	C	G	2	6	8	0	8	16	0	0
19	5780293	.	A	T	15	11	26	0	2	28	0	0
19	5780312	.	A	T	16	12	28	0	0	28	0	0
19	5780989	.	G	A	14	7	21	1	0	22	0	0
19	5781259	.	A	T	5	6	11	0	1	12	0	0
19	5781316	.	G	T	4	3	7	0	0	7	0	0
19	5781367	.	T	C	6	4	10	0	1	11	0	0
19	5793484	.	C	G	10	3	13	0	1	14	0	0
19	5793532	.	T	C	5	9	14	0	0	14	0	0
19	5801151	.	G	A	10	11	21	0	0	21	0	0
19	5805833	.	G	A	9	4	13	0	1	14	0	0
19	5805839	.	G	A	9	5	14	0	0	14	0	0
19	6060281	.	T	A	10	15	25	0	0	25	0	0
19	6060309	.	A	T	11	16	27	0	1	28	0	0
19	6060415	.	C	A	0	6	6	0	9	15	0	0
19	6076813	.	C	A	6	6	12	0	0	12	0	0
19	6083524	.	G	A	5	8	13	0	0	13	0	0
19	6086441	.	C	G	14	14	28	0	1	29	0	0
19	6086577	.	C	T	2	14	16	0	18	34	0	0
19	6087130	.	T	A	11	11	22	0	0	22	0	0
19	6087146	.	C	T	1	12	13	0	11	24	0	0
19	6087186	.	A	T	12	14	26	0	0	26	0	0
19	6087619	.	T	C	10	0	10	0	6	16	0	0
19	6087894	.	G	A	15	8	23	0	1	24	0	0
19	6087948	.	A	T	9	10	19	1	1	21	0	0
19	6088000	.	C	T	1	14	15	1	14	30	0	0
19	6088166	.	T	C	10	13	23	0	0	23	0	0
19	6088259	.	A	C	12	7	19	0	1	20	0	0
19	6088368	.	A	G	11	19	30	0	0	30	0	0
19	6090702	.	T	C	12	9	21	0	1	22	0	0
19	6090732	.	T	A	14	8	22	0	2	24	0	0
19	6094162	.	A	C	16	10	26	0	0	26	0	0
19	6097473	.	C	A	14	15	29	0	0	29	0	0
19	6100295	.	A	G	11	9	20	0	1	21	0	0
19	6102594	.	A	T	6	14	20	0	0	20	0	0
19	6102732	.	T	C	11	12	23	0	0	23	0	0
19	6105528	.	A	T	3	10	13	2	1	16	0	0
19	6111085	.	G	A	8	6	14	0	1	15	0	0
19	6111214	.	A	G	13	9	22	0	1	23	0	0
19	6111223	.	A	G	13	9	22	0	0	22	0	0
19	6111268	.	G	A	9	8	17	0	4	21	0	0
19	6111724	.	T	C	4	5	9	0	0	9	0	0
19	6111793	.	G	A	10	5	15	0	0	15	0	0
19	6116477	.	A	G	6	5	11	0	0	11	0	0
19	6116638	.	A	G	5	4	9	0	0	9	0	0
19	6122614	.	A	G	3	9	12	0	0	12	0	0
19	6124000	.	T	C	7	0	7	0	9	16	0	0
19	6125329	.	G	T	3	6	9	0	0	9	0	0
19	6125350	.	A	G	2	8	10	0	0	10	0	0
19	6125425	.	A	T	3	11	14	0	1	15	0	0
19	6125656	.	G	C	5	8	13	0	0	13	0	0
19	6125926	.	G	A	6	5	11	0	2	13	0	0
19	6125941	.	C	T	7	7	14	0	1	15	0	0
19	6126001	.	G	A	5	11	16	0	2	18	0	0
19	6126046	.	A	T	4	7	11	0	8	19	0	0
19	6126403	.	C	G	4	3	7	0	0	7	0	0
19	6126544	.	A	G	2	2	4	0	2	6	0	0
19	6126645	.	T	C	4	3	7	0	1	8	0	0
19	6127108	.	C	A	3	4	7	0	0	7	0	0
19	6127669	.	C	A	3	2	5	0	1	6	0	0
19	6127764	.	A	G	2	3	5	0	0	5	0	0
19	6127768	.	A	G	2	3	5	0	0	5	0	0
19	6127847	.	G	T	1	4	5	0	1	6	0	0
19	6128416	.	G	A	3	5	8	0	0	8	0	0
19	6142187	.	C	A	1	5	6	0	4	10	0	0
19	6142669	.	T	A	15	7	22	0	1	23	0	0
19	6142714	.	A	T	11	6	17	0	0	17	0	0
19	6142802	.	G	T	10	7	17	0	1	18	0	0
19	6142803	.	A	G	9	8	17	0	1	18	0	0
19	6143263	.	C	T	4	2	6	0	0	6	0	0
19	6143608	.	C	T	0	5	5	0	7	12	0	0
19	6143825	.	C	T	5	4	9	0	0	9	0	0
19	6143919	.	T	C	6	3	9	0	2	11	0	0
19	6144722	.	C	T	1	4	5	0	1	6	0	0
19	6145382	.	T	A	1	3	4	0	0	4	0	0
19	6145406	.	G	A	2	5	7	0	0	7	0	0
19	6145736	.	G	A	5	3	8	0	0	8	0	0
19	6145964	.	A	G	4	2	6	0	0	6	0	0
19	6214598	.	G	A	6	6	12	0	0	12	0	0
19	6214884	.	T	A	3	5	8	0	0	8	0	0
19	6217133	.	T	A	6	3	9	0	0	9	0	0
19	6217667	.	A	G	3	2	5	0	1	6	0	0
19	6232242	.	T	C	1	0	1	0	2	3	0	0
19	6233690	.	C	A	0	4	4	0	4	8	0	0
19	6242954	.	T	C	2	2	4	0	0	4	0	0
19	6328442	.	T	C	51	9	60	0	28	88	0	0
19	6328514	.	A	C	44	39	83	0	0	83	0	0
19	6328533	.	A	G	45	45	90	0	4	94	0	0
19	6328830	.	T	G	40	36	76	0	8	84	0	0
19	6328859	.	G	A	37	32	69	0	2	72	1	0
19	6328889	.	C	T	6	33	39	0	38	77	0	0
19	6328906	.	G	A	48	29	77	0	2	79	0	0
19	6328963	.	T	C	49	22	71	0	3	74	0	0
19	6329062	.	A	T	28	27	55	3	2	60	0	0
19	6329381	.	A	T	39	31	70	0	1	71	0	0
19	6329382	.	T	G	37	31	68	0	3	71	0	0
19	6329533	.	C	T	5	35	40	0	33	73	0	0
19	6329813	.	G	A	49	28	77	0	0	77	0	0
19	6330194	.	A	C	47	2	49	0	33	82	0	0
19	6330239	.	C	A	6	37	43	0	42	85	0	0
19	6332767	.	A	C	35	0	35	0	40	75	0	0
19	6332902	.	C	A	3	30	33	0	37	70	0	0
19	6332947	.	C	T	6	34	40	0	34	74	0	0
19	6332973	.	G	A	37	32	69	0	1	70	0	0
19	6338207	.	A	G	32	26	58	0	5	63	0	0
19	6338261	.	A	G	26	28	54	0	1	55	0	0
19	6342278	.	G	T	34	29	63	0	2	65	0	0
19	6344522	.	G	C	34	2	36	0	23	59	0	0
19	6346506	.	C	G	19	26	45	0	1	46	0	0
19	6346587	.	C	T	3	17	20	0	24	44	0	0
19	6347662	.	C	T	18	24	42	0	3	45	0	0
19	6352379	.	A	G	16	13	29	1	5	35	0	0
19	6352448	.	G	A	20	8	28	0	2	30	0	0
19	6352511	.	G	A	27	21	48	0	2	50	0	0
19	6358232	.	A	G	14	12	26	0	1	27	0	0
19	6365777	.	G	A	25	15	40	0	2	42	0	0
19	6606673	.	T	A	1	5	6	0	2	8	0	0
19	6606725	.	T	C	7	5	12	0	0	12	0	0
19	6606764	.	A	T	9	5	14	0	0	14	0	0
19	6612432	.	T	C	2	3	5	0	0	5	0	0
19	6872539	.	T	C	2	3	5	0	0	5	0	0
19	6872595	.	C	T	1	3	4	0	0	4	0	0
19	6901116	.	A	T	2	3	5	0	0	5	0	0
19	6901174	.	G	T	0	2	2	0	1	3	0	0
19	6901269	.	T	C	2	2	4	0	0	4	0	0
19	6901270	.	T	A	2	2	4	0	0	4	0	0
19	6908495	.	A	T	3	1	4	0	1	5	0	0
19	6908520	.	T	C	4	2	6	0	0	6	0	0
19	6908650	.	T	C	2	2	4	0	0	4	0	0
19	6908651	.	T	C	2	2	4	0	0	4	0	0
19	6914145	.	G	A	3	2	5	0	0	5	0	0
19	6914280	.	A	T	4	2	6	0	0	6	0	0
19	6914370	.	A	C	1	2	3	0	0	3	0	0
19	6914706	.	T	G	2	0	2	0	4	6	0	0
19	6915030	.	T	C	3	3	6	0	0	6	0	0
19	6915114	.	C	T	3	3	6	0	0	6	0	0
19	6915175	.	A	C	3	9	12	1	1	14	0	0
19	6915177	.	A	G	3	9	12	1	1	14	0	0
19	6915234	.	G	A	3	2	5	0	1	6	0	0
19	6915869	.	A	C	1	3	4	0	0	4	0	0
19	6915890	.	G	A	1	4	5	0	0	5	0	0
19	6916019	.	T	C	1	1	2	0	0	2	0	0
19	6916029	.	G	A	1	3	4	0	0	4	0	0
19	6916158	.	C	A	2	5	7	0	0	7	0	0
19	6922883	.	A	G	0	0	0	0	3	3	0	0
19	6922936	.	G	A	1	2	3	1	0	4	0	0
19	6922938	.	A	G	1	2	3	1	0	4	0	0
19	6928494	.	A	C	1	2	3	0	0	3	0	0
19	6933253	.	G	A	2	3	5	3	0	8	0	0
19	6933469	.	G	A	3	2	5	1	0	6	0	0
19	6933808	.	G	C	1	3	4	0	0	4	0	0
19	6934005	.	C	T	4	2	6	0	0	6	0	0
19	6938364	.	A	T	9	9	18	0	0	18	0	0
19	6938377	.	A	T	10	10	20	0	0	20	0	0
19	6940213	.	C	T	15	4	19	0	0	19	0	0
19	6949256	.	G	A	1	17	18	0	19	37	0	0
19	6949316	.	C	A	17	18	35	0	3	38	0	0
19	6950393	.	G	A	22	11	33	0	1	34	0	0
19	6952600	.	T	C	18	17	35	0	1	36	0	0
19	6955061	.	C	T	17	14	31	0	0	31	0	0
19	6955130	.	C	T	18	9	27	0	3	30	0	0
19	6955131	.	C	T	18	10	28	0	2	30	0	0
19	6955198	.	C	A	21	10	31	0	0	31	0	0
19	6955411	.	C	T	8	12	20	0	0	20	0	0
19	6955475	.	T	C	3	8	11	0	0	11	0	0
19	6955609	.	C	G	14	10	24	0	0	25	1	0
19	6955620	.	G	A	1	10	11	0	13	24	0	0
19	6955920	.	G	A	15	10	25	0	1	26	0	0
19	6956058	.	T	C	16	18	34	1	1	36	0	0
19	6956060	.	G	A	17	18	35	1	1	37	0	0
19	6956665	.	C	A	11	11	22	0	1	23	0	0
19	6956728	.	T	A	20	13	33	0	1	34	0	0
19	6956829	.	T	A	13	10	23	0	3	26	0	0
19	6956835	.	C	G	14	10	24	0	0	24	0	0
19	6956881	.	T	C	15	6	21	0	0	21	0	0
19	6956892	.	T	A	11	6	17	0	1	18	0	0
19	6957127	.	A	T	26	17	43	0	2	45	0	0
19	6957131	.	C	A	27	17	44	0	3	47	0	0
19	6960653	.	C	A	8	4	12	0	1	13	0	0
19	6961211	.	T	C	4	2	6	3	1	10	0	0
19	6961421	.	T	A	11	3	14	0	0	14	0	0
19	6961610	.	G	A	7	6	13	1	0	14	0	0
19	6961674	.	A	G	7	7	14	0	0	14	0	0
19	6962349	.	G	A	8	4	12	0	0	12	0	0
19	6963020	.	C	T	7	4	11	0	0	11	0	0
19	6963175	.	A	T	8	5	13	0	0	13	0	0
19	6963966	.	G	A	2	3	5	0	0	5	0	0
19	6963996	.	G	A	2	4	6	0	0	6	0	0
19	6964273	.	C	A	7	5	12	0	2	14	0	0
19	6964364	.	C	T	4	7	11	0	1	12	0	0
19	6964381	.	T	C	5	5	10	0	1	11	0	0
19	6964417	.	A	G	5	3	8	0	0	8	0	0
19	6964636	.	C	T	4	5	9	0	0	9	0	0
19	6964641	.	T	C	3	0	3	0	5	8	0	0
19	6965382	.	A	T	2	2	4	0	0	4	0	0
19	6965420	.	A	T	3	3	6	0	0	6	0	0
19	6965717	.	A	G	2	5	7	0	0	7	0	0
19	6965752	.	A	T	2	3	5	0	0	5	0	0
19	6965767	.	G	A	2	2	4	0	0	4	0	0
19	6965894	.	C	A	0	2	2	0	5	7	0	0
19	6965897	.	C	T	5	2	7	0	0	7	0	0
19	6966208	.	G	A	4	3	7	0	1	8	0	0
19	6966781	.	A	T	3	5	8	0	0	8	0	0
19	6977067	.	T	C	4	0	4	0	6	10	0	0
19	6980493	.	C	T	5	2	7	0	0	7	0	0
19	6988778	.	T	C	2	3	5	1	0	6	0	0
19	6995922	.	C	T	1	2	3	0	0	3	0	0
19	6998429	.	T	G	1	0	1	0	3	4	0	0
19	7004841	.	G	A	0	4	4	0	3	7	0	0
19	7005198	.	A	G	1	3	4	0	0	4	0	0
19	7005282	.	T	C	1	3	4	0	0	4	0	0
19	7005821	.	A	G	1	4	5	0	0	5	0	0
19	7005881	.	C	T	2	3	5	0	0	5	0	0
19	7006037	.	C	A	1	2	3	0	0	3	0	0
19	7014778	.	T	A	5	3	8	0	0	8	0	0
19	7014815	.	C	T	6	3	9	0	1	10	0	0
19	7014909	.	C	A	5	3	8	0	0	8	0	0
19	7014912	.	G	A	5	3	8	0	0	8	0	0
19	7020179	.	G	A	3	6	9	0	0	9	0	0
19	7022107	.	G	A	7	3	10	0	0	10	0	0
19	7022128	.	G	A	7	2	9	0	0	9	0	0
19	7024591	.	T	G	9	5	14	0	0	14	0	0
19	7024593	.	C	T	9	3	12	0	2	14	0	0
19	7024627	.	T	C	4	3	7	0	3	10	0	0
19	7027810	.	A	T	1	4	5	0	0	5	0	0
19	7027927	.	G	A	3	3	6	0	1	7	0	0
19	7029806	.	C	G	2	1	3	0	0	3	0	0
19	7029811	.	G	A	2	2	4	0	0	4	0	0
19	7029883	.	C	A	1	3	4	0	0	5	1	0
19	7029915	.	A	G	2	2	4	0	0	4	0	0
19	7068980	.	G	C	1	2	3	0	0	3	0	0
19	7068998	.	C	T	0	3	3	0	1	4	0	0
19	7069019	.	A	G	1	2	3	0	0	3	0	0
19	7097328	.	C	T	7	3	10	0	2	12	0	0
19	7100564	.	A	T	10	3	13	0	0	13	0	0
19	7117733	.	C	A	2	2	4	0	0	4	0	0
19	7120539	.	G	A	2	2	4	0	0	4	0	0
19	7120577	.	T	A	1	2	3	0	0	3	0	0
19	7152971	.	G	T	0	8	8	0	8	16	0	0
19	7152974	.	G	A	7	9	16	0	1	17	0	0
19	7154729	.	A	G	22	16	38	0	2	40	0	0
19	7154770	.	A	C	24	14	38	0	0	38	0	0
19	7155001	.	A	T	8	20	28	0	0	29	1	0
19	7155034	.	A	G	12	21	33	0	1	34	0	0
19	7155065	.	T	C	11	22	33	0	1	34	0	0
19	7158469	.	C	T	5	8	13	0	0	13	0	0
19	7158546	.	A	G	11	0	11	0	8	19	0	0
19	7159062	.	G	A	2	8	10	0	10	20	0	0
19	7159107	.	T	C	7	7	14	0	1	15	0	0
19	7161452	.	G	A	3	8	11	0	1	12	0	0
19	7161527	.	A	G	6	0	6	0	4	10	0	0
19	7161539	.	G	T	4	5	9	0	0	9	0	0
19	7163872	.	C	T	7	6	13	0	0	13	0	0
19	7163908	.	A	G	7	8	15	0	0	15	0	0
19	7164022	.	G	A	7	16	23	0	0	23	0	0
19	7166211	.	C	T	10	10	20	0	1	21	0	0
19	7166454	.	C	A	6	8	14	0	2	16	0	0
19	7169204	.	A	C	14	12	26	0	4	30	0	0
19	7169228	.	C	T	15	11	26	0	2	28	0	0
19	7169304	.	G	A	10	6	16	0	1	17	0	0
19	7169587	.	A	G	4	4	8	0	1	9	0	0
19	7169588	.	G	A	4	5	9	0	0	9	0	0
19	7169770	.	A	C	13	7	20	1	0	21	0	0
19	7169809	.	C	T	13	5	18	0	1	19	0	0
19	7169880	.	T	C	6	12	18	0	0	18	0	0
19	7169886	.	G	A	8	11	19	0	0	19	0	0
19	7169929	.	G	A	10	11	21	0	0	21	0	0
19	7170014	.	A	C	2	10	12	0	1	13	0	0
19	7170015	.	T	C	3	9	12	0	1	13	0	0
19	7170128	.	A	G	2	7	9	0	1	10	0	0
19	7170191	.	A	C	9	10	19	0	1	20	0	0
19	7170228	.	A	T	11	9	20	0	0	20	0	0
19	7170489	.	C	T	11	3	14	0	0	14	0	0
19	7170509	.	C	T	9	2	11	0	0	11	0	0
19	7174417	.	C	A	4	2	6	0	0	6	0	0
19	7174669	.	T	C	7	2	9	0	0	9	0	0
19	7249800	.	A	G	9	12	21	0	0	21	0	0
19	7249811	.	T	C	10	13	23	0	0	23	0	0
19	7250372	.	T	C	6	5	11	0	0	11	0	0
19	7258085	.	A	G	6	7	13	0	0	13	0	0
19	7258118	.	C	T	4	10	14	0	0	14	0	0
19	7265377	.	T	C	5	3	8	0	0	8	0	0
19	7270102	.	G	A	3	5	8	0	0	8	0	0
19	7270156	.	C	A	1	4	5	0	4	9	0	0
19	7272224	.	C	A	11	3	14	0	0	14	0	0
19	7272935	.	G	A	6	7	13	0	1	14	0	0
19	7276063	.	A	T	1	5	6	0	1	7	0	0
19	7276106	.	G	A	9	20	29	0	0	29	0	0
19	7276149	.	A	G	15	26	41	0	2	43	0	0
19	7276194	.	T	A	27	31	58	0	2	60	0	0
19	7276559	.	G	A	42	32	74	0	2	76	0	0
19	7276610	.	G	A	38	36	74	0	4	78	0	0
19	7279235	.	A	G	25	36	61	3	2	66	0	0
19	7279721	.	A	G	34	18	52	0	5	57	0	0
19	7282541	.	C	T	29	32	61	0	2	63	0	0
19	7282554	.	G	A	29	30	59	0	3	62	0	0
19	7283427	.	C	A	31	23	54	0	4	58	0	0
19	7283499	.	A	G	33	18	51	2	2	55	0	0
19	7284840	.	C	T	1	24	25	0	30	55	0	0
19	7286301	.	A	G	23	27	50	0	2	52	0	0
19	7286355	.	A	G	28	24	52	0	0	52	0	0
19	7286421	.	T	A	28	23	51	0	1	52	0	0
19	7286742	.	A	G	28	17	45	0	2	47	0	0
19	7287600	.	T	C	17	22	39	0	2	41	0	0
19	7287603	.	G	A	18	19	37	0	1	38	0	0
19	7288195	.	A	G	19	23	42	0	2	44	0	0
19	7290175	.	A	G	21	19	40	0	2	42	0	0
19	7290214	.	A	G	22	23	45	0	1	46	0	0
19	7291642	.	A	T	20	17	37	0	1	39	1	0
19	7292565	.	C	A	1	2	3	0	0	3	0	0
19	7292621	.	G	A	4	2	6	0	0	6	0	0
19	7292636	.	A	T	3	4	7	0	1	8	0	0
19	7293138	.	A	G	3	3	6	0	0	6	0	0
19	7295279	.	G	A	5	8	13	0	0	13	0	0
19	7295572	.	G	C	6	4	10	0	0	10	0	0
19	7295843	.	T	A	3	2	5	0	0	5	0	0
19	7309154	.	G	A	11	11	22	0	1	23	0	0
19	7309391	.	C	A	21	22	43	0	2	45	0	0
19	7309522	.	G	C	21	26	47	0	1	48	0	0
19	7309556	.	T	A	19	16	35	0	0	35	0	0
19	7309557	.	T	A	19	15	34	0	1	35	0	0
19	7309754	.	T	G	10	13	23	0	2	25	0	0
19	7309929	.	A	T	19	10	29	0	0	29	0	0
19	7309968	.	G	T	20	14	34	0	0	34	0	0
19	7310117	.	T	C	17	2	19	0	19	38	0	0
19	7310131	.	C	T	16	17	33	0	1	34	0	0
19	7310154	.	A	T	14	18	32	0	0	32	0	0
19	7311678	.	T	G	15	15	30	0	0	31	1	0
19	7313933	.	C	G	30	19	49	0	1	50	0	0
19	7327462	.	A	G	11	14	25	0	1	26	0	0
19	7327519	.	C	T	8	11	19	0	1	20	0	0
19	7327564	.	G	T	13	11	24	0	0	24	0	0
19	7327570	.	T	C	12	10	22	0	0	22	0	0
19	7337862	.	C	A	10	7	17	0	0	17	0	0
19	7338033	.	C	T	1	12	13	0	12	25	0	0
19	7338125	.	C	T	9	11	20	0	2	22	0	0
19	7338150	.	G	A	7	9	16	0	1	17	0	0
19	7338218	.	A	T	6	6	12	0	0	12	0	0
19	7338309	.	C	T	1	7	8	0	9	17	0	0
19	7338402	.	C	T	0	5	5	0	11	16	0	0
19	7338425	.	T	C	7	8	15	0	1	16	0	0
19	7338444	.	T	C	11	0	11	0	7	18	0	0
19	7338969	.	C	T	14	8	22	0	0	22	0	0
19	7338978	.	T	C	15	0	15	0	6	21	0	0
19	7339008	.	T	G	10	5	15	0	2	17	0	0
19	7341300	.	G	A	8	7	15	0	2	17	0	0
19	7341385	.	A	G	5	7	12	0	0	12	0	0
19	7358131	.	A	G	10	6	16	0	1	17	0	0
19	7379601	.	C	T	2	6	8	0	0	8	0	0
19	7379637	.	T	C	3	0	3	0	8	11	0	0
19	7408360	.	T	G	6	6	12	0	0	12	0	0
19	7409904	.	C	T	4	5	9	0	1	10	0	0
19	7409961	.	A	G	4	4	8	0	0	8	0	0
19	7412062	.	T	C	7	6	13	0	1	14	0	0
19	7412320	.	C	T	9	11	20	0	0	20	0	0
19	7412358	.	A	T	9	11	20	0	0	20	0	0
19	7412490	.	T	C	4	4	8	0	0	8	0	0
19	7412586	.	T	C	1	2	3	0	0	3	0	0
19	7424794	.	G	A	10	10	20	0	2	22	0	0
19	7426637	.	C	T	6	6	12	0	0	12	0	0
19	7426814	.	C	T	5	4	9	0	1	10	0	0
19	7426832	.	G	A	8	6	14	0	0	14	0	0
19	7426967	.	T	C	11	8	19	0	0	19	0	0
19	7427099	.	C	A	12	10	22	0	0	22	0	0
19	7430160	.	T	C	9	9	18	0	0	18	0	0
19	7430607	.	G	A	2	11	13	0	11	24	0	0
19	7430652	.	C	T	11	13	24	0	3	27	0	0
19	7430700	.	A	G	1	1	2	0	8	10	0	0
19	7430715	.	C	A	2	8	10	0	0	10	0	0
19	7432922	.	G	A	2	2	4	0	0	4	0	0
19	7433068	.	T	A	3	2	5	0	0	5	0	0
19	7433454	.	G	A	3	4	7	0	0	7	0	0
19	7434139	.	T	C	5	5	10	0	2	12	0	0
19	7434161	.	G	T	4	5	9	0	1	10	0	0
19	7434310	.	T	C	1	2	3	0	0	3	0	0
19	7434611	.	G	C	5	2	7	0	1	8	0	0
19	7434770	.	T	C	4	2	6	0	2	8	0	0
19	7434813	.	G	A	3	2	5	0	1	6	0	0
19	7434881	.	C	T	1	2	3	0	4	7	0	0
19	7435440	.	C	T	0	4	4	0	4	8	0	0
19	7435535	.	C	A	4	6	10	0	0	10	0	0
19	7435605	.	T	C	2	2	4	0	0	4	0	0
19	7437053	.	A	G	3	4	7	0	0	7	0	0
19	7439799	.	C	T	1	3	4	0	0	4	0	0
19	7441832	.	T	A	2	5	7	0	0	7	0	0
19	7445676	.	G	A	7	6	13	3	1	17	0	0
19	7445897	.	C	T	37	25	62	0	0	63	1	0
19	7446050	.	T	C	30	30	60	0	1	61	0	0
19	7446137	.	G	T	20	33	53	0	2	55	0	0
19	7446286	.	G	T	21	30	51	0	1	52	0	0
19	7446495	.	G	T	31	27	58	0	7	65	0	0
19	7446621	.	C	A	31	34	65	0	4	69	0	0
19	7446702	.	T	C	35	36	71	0	3	74	0	0
19	7450572	.	G	A	29	36	65	0	4	69	0	0
19	7450658	.	T	C	12	13	25	0	0	25	0	0
19	7450750	.	A	G	5	5	10	0	0	10	0	0
19	7450783	.	C	T	0	4	4	0	5	9	0	0
19	7456364	.	T	C	3	2	5	0	0	5	0	0
19	7456371	.	A	C	3	3	6	0	1	7	0	0
19	7456722	.	C	G	7	5	12	0	0	12	0	0
19	7456793	.	A	G	3	5	8	0	1	9	0	0
19	7456816	.	C	G	3	3	6	0	0	6	0	0
19	7468556	.	G	T	4	7	11	0	0	11	0	0
19	7468580	.	C	T	3	7	10	0	0	10	0	0
19	7468746	.	T	A	5	8	13	0	0	13	0	0
19	7474242	.	T	C	7	5	12	0	4	16	0	0
19	7474245	.	T	G	10	0	10	0	6	16	0	0
19	7478159	.	A	G	11	14	25	0	0	25	0	0
19	7478283	.	C	T	4	8	12	0	0	12	0	0
19	7478356	.	G	A	4	6	10	0	0	10	0	0
19	7482931	.	C	T	3	8	11	0	1	12	0	0
19	7482970	.	C	T	6	2	8	0	1	11	2	0
19	7482993	.	G	A	5	7	12	0	0	12	0	0
19	7483059	.	A	T	4	6	10	0	0	10	0	0
19	7483469	.	T	G	4	3	7	0	1	9	1	0
19	7484313	.	T	A	6	3	9	0	1	11	1	0
19	7484433	.	A	G	3	2	5	0	0	5	0	0
19	7484434	.	C	G	2	2	4	0	1	5	0	0
19	7484536	.	G	T	4	2	6	0	1	7	0	0
19	7484668	.	A	T	2	3	5	2	1	8	0	0
19	7484834	.	A	G	2	3	5	0	0	5	0	0
19	7484856	.	C	G	0	2	2	0	2	4	0	0
19	7484990	.	G	T	6	2	8	0	0	8	0	0
19	7485117	.	C	T	4	5	9	0	0	9	0	0
19	7485457	.	C	T	1	3	4	0	1	5	0	0
19	7485503	.	G	A	2	4	6	0	0	6	0	0
19	7485839	.	G	T	1	2	3	0	1	4	0	0
19	7486791	.	T	C	2	2	4	0	0	4	0	0
19	7487096	.	G	A	5	3	8	0	0	8	0	0
19	7487103	.	G	A	4	4	8	0	0	8	0	0
19	7487321	.	C	T	2	4	6	0	1	7	0	0
19	7487592	.	T	A	4	2	6	0	0	6	0	0
19	7489552	.	G	A	2	3	5	0	1	6	0	0
19	7490873	.	T	A	3	2	5	0	0	5	0	0
19	7495867	.	A	T	12	16	28	0	2	30	0	0
19	7498046	.	T	C	12	13	25	0	1	26	0	0
19	7498079	.	A	G	8	15	23	0	5	28	0	0
19	7498103	.	A	G	7	17	24	0	0	24	0	0
19	7505591	.	A	G	11	21	32	0	1	33	0	0
19	7505907	.	A	G	15	0	15	0	13	28	0	0
19	7506036	.	A	G	7	0	7	0	7	14	0	0
19	7507833	.	A	T	9	3	12	0	3	15	0	0
19	7510223	.	T	C	8	9	17	0	0	17	0	0
19	7510348	.	T	C	18	7	25	0	1	26	0	0
19	7510501	.	G	A	0	8	8	0	11	19	0	0
19	7510567	.	C	T	11	8	19	0	1	20	0	0
19	7512406	.	C	G	14	8	22	0	1	23	0	0
19	7513085	.	C	T	12	9	21	0	0	22	1	0
19	7513291	.	A	C	9	13	22	0	0	22	0	0
19	7513406	.	A	T	6	11	17	0	0	17	0	0
19	7513511	.	A	G	7	3	10	0	1	11	0	0
19	7513631	.	A	G	4	8	12	0	1	13	0	0
19	7513651	.	A	G	7	4	11	0	1	12	0	0
19	7514025	.	T	C	10	4	14	1	0	15	0	0
19	7514512	.	T	C	7	3	10	0	1	11	0	0
19	7514538	.	C	G	9	2	11	0	1	12	0	0
19	7514693	.	A	G	7	6	13	0	1	14	0	0
19	7514697	.	A	G	5	0	5	0	9	14	0	0
19	7515336	.	A	T	7	10	17	0	1	18	0	0
19	7515356	.	G	A	5	16	21	0	1	22	0	0
19	7515423	.	A	G	7	6	13	0	1	14	0	0
19	7515458	.	A	G	10	7	17	0	0	17	0	0
19	7515468	.	T	G	10	5	15	0	2	17	0	0
19	7515787	.	A	T	8	6	14	0	3	17	0	0
19	7515829	.	C	T	8	12	20	0	1	21	0	0
19	7515845	.	A	T	9	13	22	0	3	25	0	0
19	7516035	.	A	G	8	9	17	0	0	17	0	0
19	7516063	.	A	C	17	9	26	0	1	27	0	0
19	7516169	.	C	A	10	11	21	0	0	21	0	0
19	7516183	.	T	G	7	8	15	0	0	15	0	0
19	7525222	.	T	G	3	3	6	0	2	8	0	0
19	7525337	.	C	A	5	4	9	0	0	9	0	0
19	7525381	.	G	A	3	2	5	0	0	5	0	0
19	7525386	.	G	C	3	2	5	0	0	5	0	0
19	7530813	.	T	A	1	2	3	0	0	3	0	0
19	7531082	.	A	G	1	2	3	0	0	3	0	0
19	7531094	.	T	C	1	0	1	0	2	3	0	0
19	7534401	.	A	G	1	2	3	0	0	3	0	0
19	7540354	.	C	T	0	1	1	0	3	4	0	0
19	7549916	.	G	A	9	15	24	0	0	24	0	0
19	7552736	.	C	G	15	5	20	0	0	20	0	0
19	7552737	.	G	T	2	5	7	0	13	20	0	0
19	7552875	.	G	C	0	9	9	0	14	23	0	0
19	7552887	.	A	G	9	10	19	0	3	22	0	0
19	7553368	.	T	C	6	9	15	0	0	15	0	0
19	7553416	.	C	T	4	6	10	0	0	10	0	0
19	7557447	.	C	A	8	6	14	1	4	19	0	0
19	7557538	.	T	C	13	12	25	0	1	26	0	0
19	7557589	.	T	G	17	0	17	0	9	26	0	0
19	7557619	.	A	T	16	14	30	0	3	33	0	0
19	7557773	.	A	T	15	24	39	1	1	41	0	0
19	7557793	.	G	C	18	19	37	2	2	41	0	0
19	7557992	.	C	T	13	11	24	0	0	24	0	0
19	7558009	.	G	A	15	13	28	0	0	28	0	0
19	7559818	.	G	T	12	11	23	0	1	24	0	0
19	7559905	.	A	G	15	13	28	0	0	28	0	0
19	7564073	.	A	G	12	6	18	0	1	19	0	0
19	7565142	.	G	A	24	19	43	0	0	43	0	0
19	7565244	.	A	G	17	23	40	0	1	41	0	0
19	7567021	.	T	A	18	18	36	0	0	36	0	0
19	7568342	.	A	G	1	0	1	0	2	3	0	0
19	7568348	.	T	G	1	0	1	0	2	3	0	0
19	7630359	.	T	A	3	2	5	0	0	5	0	0
19	7630689	.	A	T	5	7	12	0	0	12	0	0
19	7630785	.	C	T	1	2	3	0	0	3	0	0
19	7631700	.	G	A	3	21	24	0	11	35	0	0
19	7631784	.	A	G	8	10	18	0	1	19	0	0
19	7631829	.	C	A	11	8	19	0	0	19	0	0
19	7631860	.	T	C	15	5	20	0	0	20	0	0
19	7632056	.	C	T	12	4	16	0	1	17	0	0
19	7632216	.	C	T	9	7	16	0	1	17	0	0
19	7632348	.	G	A	2	10	12	0	10	22	0	0
19	7632470	.	C	T	8	8	16	0	2	18	0	0
19	7632526	.	T	C	14	9	23	0	0	23	0	0
19	7632837	.	C	T	8	6	14	0	0	14	0	0
19	7678900	.	A	G	3	2	5	0	1	6	0	0
19	7761855	.	C	T	5	10	15	0	0	15	0	0
19	7765259	.	G	A	5	4	9	0	0	9	0	0
19	7771431	.	G	A	0	4	4	0	10	14	0	0
19	7784681	.	T	A	23	9	32	0	5	37	0	0
19	7784684	.	T	A	21	10	31	0	4	36	1	0
19	7785138	.	C	T	24	20	44	0	0	44	0	0
19	7794887	.	C	T	19	24	43	0	1	44	0	0
19	7796398	.	C	T	23	22	45	0	1	46	0	0
19	7796888	.	G	A	20	13	33	0	1	34	0	0
19	7797259	.	T	A	16	17	33	0	0	33	0	0
19	7797534	.	C	T	29	11	40	0	1	41	0	0
19	7797651	.	G	T	6	7	13	0	1	14	0	0
19	7802700	.	G	A	8	10	18	0	0	18	0	0
19	7802873	.	G	A	5	10	15	0	0	15	0	0
19	7803424	.	C	A	11	4	15	0	0	15	0	0
19	7803685	.	C	A	11	5	16	0	0	16	0	0
19	7804785	.	A	C	11	11	22	0	1	23	0	0
19	7819991	.	G	A	13	9	22	0	0	22	0	0
19	7820031	.	T	A	12	11	23	0	0	23	0	0
19	7820040	.	T	C	9	9	18	0	1	19	0	0
19	7820079	.	T	A	7	10	17	0	0	17	0	0
19	7820107	.	G	A	5	4	9	0	2	11	0	0
19	7820466	.	C	A	1	7	8	0	5	13	0	0
19	7820665	.	T	A	16	10	26	0	0	26	0	0
19	7820980	.	C	T	2	8	10	0	0	10	0	0
19	7822581	.	T	C	7	0	7	0	5	12	0	0
19	7823285	.	G	A	11	8	19	0	0	19	0	0
19	7823306	.	G	A	12	7	19	0	0	19	0	0
19	7827016	.	G	A	10	10	20	0	1	21	0	0
19	7827031	.	T	G	14	10	24	0	1	25	0	0
19	7827377	.	C	T	0	10	10	0	7	17	0	0
19	7827579	.	G	A	4	3	7	0	0	7	0	0
19	7827672	.	G	C	4	8	12	0	1	13	0	0
19	7828576	.	G	A	5	6	11	0	0	11	0	0
19	7828621	.	C	A	4	3	7	0	0	7	0	0
19	7828672	.	C	G	3	3	6	0	0	6	0	0
19	7828674	.	G	A	3	3	6	0	0	6	0	0
19	7828774	.	A	G	2	4	6	0	0	6	0	0
19	7828912	.	G	A	8	6	14	0	0	14	0	0
19	7828930	.	T	G	8	7	15	0	0	15	0	0
19	7829080	.	G	A	7	4	11	0	0	11	0	0
19	7829124	.	T	C	4	0	4	0	4	8	0	0
19	7829333	.	C	A	1	2	3	0	0	3	0	0
19	7830295	.	G	A	1	2	3	0	0	3	0	0
19	7830622	.	C	T	3	5	8	0	0	8	0	0
19	7830625	.	C	T	5	3	8	0	0	8	0	0
19	7830700	.	G	A	4	3	7	0	0	7	0	0
19	7835774	.	G	A	2	4	6	0	0	6	0	0
19	7837810	.	T	C	1	1	2	0	1	3	0	0
19	7837811	.	A	T	1	2	3	0	0	3	0	0
19	7837859	.	G	T	1	2	3	0	0	3	0	0
19	7966500	.	A	C	1	4	5	0	0	5	0	0
19	8144609	.	G	A	2	8	10	0	0	10	0	0
19	8315244	.	T	C	11	7	18	0	1	19	0	0
19	8315385	.	A	G	5	0	5	0	4	9	0	0
19	8315418	.	G	A	6	3	9	0	5	14	0	0
19	8315478	.	C	T	8	4	12	0	1	13	0	0
19	8336054	.	A	G	5	0	5	0	9	14	0	0
19	8336208	.	C	T	6	5	11	0	1	12	0	0
19	8336335	.	C	A	5	4	9	0	3	12	0	0
19	8336642	.	C	T	9	10	19	0	0	19	0	0
19	8336689	.	G	A	8	5	13	0	0	13	0	0
19	8338559	.	A	G	4	3	7	0	1	8	0	0
19	8338616	.	T	A	6	12	18	0	2	20	0	0
19	8338649	.	T	A	6	11	17	0	0	17	0	0
19	8338711	.	C	G	6	4	10	0	0	10	0	0
19	8339202	.	T	A	20	9	29	0	0	29	0	0
19	8500928	.	A	T	2	2	4	0	1	5	0	0
19	8500960	.	A	T	5	3	8	0	0	8	0	0
19	8501019	.	G	A	1	6	7	0	9	16	0	0
19	8501218	.	G	A	2	10	12	0	0	12	0	0
19	8501490	.	G	T	5	5	10	0	4	14	0	0
19	8501660	.	G	T	0	3	3	0	7	10	0	0
19	8501663	.	C	T	8	4	12	0	0	12	0	0
19	8501703	.	A	C	7	3	10	1	1	12	0	0
19	8501961	.	G	A	2	2	4	0	8	12	0	0
19	8501962	.	G	A	9	2	11	0	0	11	0	0
19	8502104	.	C	G	5	10	15	0	0	15	0	0
19	8502133	.	C	T	9	6	15	0	0	15	0	0
19	8502166	.	G	T	1	13	14	0	8	22	0	0
19	8502225	.	T	A	7	8	15	0	1	16	0	0
19	8502244	.	G	A	10	7	17	0	1	18	0	0
19	8534126	.	G	C	6	3	9	0	0	9	0	0
19	8534996	.	A	G	9	5	14	0	2	16	0	0
19	8535005	.	T	G	8	2	10	0	3	13	0	0
19	8582763	.	T	C	8	8	16	0	0	16	0	0
19	8583065	.	A	G	14	10	24	0	0	24	0	0
19	8583131	.	G	A	9	6	15	0	1	16	0	0
19	8583170	.	G	T	8	3	11	0	1	12	0	0
19	8587075	.	T	C	5	0	5	0	3	8	0	0
19	8589693	.	C	T	8	9	17	0	0	17	0	0
19	8589714	.	C	T	2	5	7	0	0	7	0	0
19	8592973	.	T	A	4	5	9	0	1	10	0	0
19	8598667	.	A	G	6	3	9	0	1	10	0	0
19	8600156	.	G	A	1	5	6	0	0	6	0	0
19	8604154	.	A	G	1	3	4	0	0	4	0	0
19	8612981	.	G	C	0	9	9	0	4	13	0	0
19	8628830	.	G	T	1	8	9	0	0	9	0	0
19	8637657	.	T	C	7	5	12	0	0	12	0	0
19	8638539	.	C	A	6	6	12	0	1	13	0	0
19	8645192	.	A	C	8	11	19	0	3	22	0	0
19	8647747	.	T	A	4	8	12	0	0	12	0	0
19	8680745	.	A	T	3	2	5	0	0	5	0	0
19	8681317	.	A	T	6	3	9	0	0	9	0	0
19	8681443	.	A	G	3	4	7	0	0	7	0	0
19	8681470	.	G	A	5	4	9	0	0	9	0	0
19	8681509	.	G	A	2	3	5	0	1	6	0	0
19	8689882	.	T	A	1	5	6	0	0	6	0	0
19	8747688	.	G	A	34	38	72	0	0	72	0	0
19	8775362	.	A	T	2	5	7	0	0	7	0	0
19	8816925	.	G	C	2	2	4	0	0	5	1	0
19	8817121	.	C	A	5	10	15	0	0	15	0	0
19	8817608	.	G	A	26	22	48	0	0	48	0	0
19	8831895	.	T	C	18	0	18	0	13	31	0	0
19	8831907	.	C	T	2	18	20	0	12	32	0	0
19	8834529	.	A	G	20	16	36	1	0	37	0	0
19	8834583	.	T	C	18	20	38	0	1	39	0	0
19	8836805	.	C	T	18	11	29	0	3	32	0	0
19	8880614	.	C	G	13	12	25	0	0	25	0	0
19	8894119	.	T	A	9	6	15	0	0	15	0	0
19	8894138	.	A	G	6	9	15	0	0	15	0	0
19	8895514	.	C	A	2	4	6	0	6	12	0	0
19	8895546	.	C	T	3	8	11	0	2	13	0	0
19	8895630	.	C	T	3	6	9	0	1	10	0	0
19	8897625	.	A	C	3	0	3	0	3	6	0	0
19	8897649	.	A	T	5	5	10	0	0	10	0	0
19	8898184	.	G	A	9	3	12	0	0	12	0	0
19	8898188	.	G	A	8	3	11	0	0	11	0	0
19	8898597	.	A	C	1	0	1	0	5	7	1	0
19	8904026	.	A	G	1	2	3	0	0	3	0	0
19	8928718	.	G	A	6	3	9	0	1	10	0	0
19	8928767	.	G	C	16	10	26	0	0	26	0	0
19	8929057	.	G	A	3	3	6	0	0	6	0	0
19	8929839	.	G	A	7	9	16	0	0	16	0	0
19	8929860	.	T	C	7	9	16	0	1	17	0	0
19	8932643	.	T	C	1	0	1	0	6	7	0	0
19	8939917	.	C	T	7	9	16	0	1	17	0	0
19	8958658	.	A	C	2	3	5	0	0	5	0	0
19	8958797	.	C	T	10	7	17	0	0	17	0	0
19	8958892	.	A	G	19	15	34	0	1	35	0	0
19	8962835	.	C	T	11	11	22	0	2	24	0	0
19	8985221	.	G	A	7	4	11	0	0	11	0	0
19	8985408	.	C	T	8	4	12	0	0	12	0	0
19	8985564	.	G	A	0	7	7	0	9	16	0	0
19	8989992	.	G	A	1	9	10	0	12	22	0	0
19	8997629	.	G	A	11	10	21	0	1	22	0	0
19	8997903	.	C	T	14	22	36	0	2	38	0	0
19	9000665	.	C	T	21	24	45	0	2	47	0	0
19	9000674	.	T	C	20	27	47	0	1	48	0	0
19	9000907	.	A	G	16	0	16	0	13	29	0	0
19	9001058	.	C	T	20	14	34	0	1	35	0	0
19	9001100	.	C	T	13	16	29	2	1	32	0	0
19	9001151	.	C	T	12	17	29	2	0	31	0	0
19	9001246	.	C	T	16	11	27	0	0	27	0	0
19	9001315	.	C	T	16	11	27	0	1	28	0	0
19	9001317	.	G	A	10	16	26	0	1	28	1	0
19	9033383	.	A	T	2	2	4	0	0	4	0	0
19	9043035	.	C	T	2	3	5	0	0	5	0	0
19	9045651	.	A	T	8	3	11	0	0	11	0	0
19	9046119	.	G	C	1	7	8	0	0	8	0	0
19	9046230	.	T	G	2	2	4	0	2	6	0	0
19	9046327	.	C	T	6	6	12	0	0	12	0	0
19	9046383	.	T	A	2	3	5	0	4	9	0	0
19	9046467	.	G	A	5	6	11	0	1	12	0	0
19	9046542	.	A	C	3	8	11	0	2	13	0	0
19	9046551	.	T	C	3	8	11	0	0	11	0	0
19	9047004	.	G	A	0	2	2	0	4	6	0	0
19	9047283	.	A	G	1	8	9	0	1	10	0	0
19	9047392	.	T	C	6	2	8	0	0	8	0	0
19	9047806	.	T	A	7	12	19	0	3	22	0	0
19	9048345	.	C	T	4	6	10	0	2	12	0	0
19	9048538	.	A	C	5	6	11	0	1	12	0	0
19	9048614	.	C	T	11	5	16	0	0	16	0	0
19	9050305	.	G	A	14	12	26	0	1	27	0	0
19	9050319	.	C	T	14	15	29	0	0	29	0	0
19	9050737	.	G	C	6	9	15	0	0	15	0	0
19	9050745	.	A	G	6	7	13	0	0	13	0	0
19	9055793	.	C	T	11	10	21	0	1	22	0	0
19	9058454	.	T	C	13	10	23	0	1	24	0	0
19	9064759	.	T	C	3	16	19	0	1	20	0	0
19	9064777	.	C	A	8	15	23	0	0	23	0	0
19	9064822	.	A	G	13	10	23	0	2	25	0	0
19	9064853	.	T	C	11	12	23	0	1	24	0	0
19	9064885	.	G	A	12	11	23	0	0	23	0	0
19	9067211	.	G	A	11	16	27	0	1	28	0	0
19	9070546	.	T	G	12	0	12	0	7	19	0	0
19	9072451	.	C	T	8	10	18	0	1	19	0	0
19	9077465	.	C	T	13	13	26	0	0	26	0	0
19	9084688	.	T	C	17	14	31	0	1	32	0	0
19	9085359	.	A	T	13	3	16	0	1	17	0	0
19	9085423	.	G	A	11	13	24	0	1	25	0	0
19	9085730	.	A	G	8	0	8	0	2	14	4	0
19	9085757	.	A	C	12	18	30	0	1	31	0	0
19	9086084	.	T	A	17	19	36	0	3	39	0	0
19	9086132	.	C	A	18	19	37	1	1	39	0	0
19	9086429	.	G	T	2	5	7	1	0	8	0	0
19	9116534	.	A	G	4	0	4	0	4	8	0	0
19	9117473	.	T	G	3	4	7	0	1	8	0	0
19	9123493	.	C	T	3	2	5	0	0	5	0	0
19	9130205	.	T	A	5	3	8	0	1	9	0	0
19	9135053	.	C	T	6	9	15	0	1	16	0	0
19	9135754	.	A	T	13	9	22	0	0	22	0	0
19	9138850	.	C	A	10	6	16	0	1	17	0	0
19	9140507	.	A	G	17	11	28	0	0	28	0	0
19	9140618	.	C	T	18	9	27	0	1	28	0	0
19	9140675	.	A	T	8	17	25	1	2	28	0	0
19	9144234	.	C	T	3	3	6	0	1	7	0	0
19	9161595	.	G	A	14	22	36	0	1	37	0	0
19	9161621	.	C	T	23	16	39	0	1	40	0	0
19	9161631	.	T	G	23	20	43	0	1	44	0	0
19	9161824	.	T	C	18	15	33	0	0	33	0	0
19	9161830	.	C	T	16	19	35	0	0	35	0	0
19	9166374	.	G	A	18	19	37	1	1	39	0	0
19	9168513	.	C	T	19	30	49	0	1	50	0	0
19	9168622	.	C	T	17	18	35	2	1	38	0	0
19	9168947	.	G	T	2	18	20	0	17	37	0	0
19	9169099	.	G	A	14	11	25	0	0	25	0	0
19	9169162	.	G	C	6	8	14	1	2	17	0	0
19	9216201	.	T	A	17	7	24	0	9	33	0	0
19	9216221	.	A	C	14	12	26	0	3	29	0	0
19	9216367	.	G	A	17	13	30	0	1	31	0	0
19	9217143	.	C	T	19	19	38	0	2	40	0	0
19	9218405	.	G	A	19	15	34	0	0	34	0	0
19	9220813	.	C	T	16	15	31	0	2	33	0	0
19	9220828	.	C	T	17	14	31	0	0	31	0	0
19	9220849	.	T	C	16	20	36	0	2	38	0	0
19	9220939	.	T	C	16	14	30	0	1	31	0	0
19	9223369	.	T	C	21	24	45	0	0	45	0	0
19	9228196	.	T	G	32	13	45	0	1	46	0	0
19	9228378	.	A	G	21	0	21	0	8	29	0	0
19	9228380	.	C	T	21	8	29	0	1	30	0	0
19	9240536	.	C	T	1	3	4	0	0	4	0	0
19	9241530	.	C	T	2	3	5	0	1	6	0	0
19	9245752	.	A	G	3	2	5	0	1	6	0	0
19	9255906	.	C	T	1	1	2	0	0	2	0	0
19	9257536	.	G	A	1	2	3	0	0	3	0	0
19	9257885	.	A	G	1	2	3	0	1	4	0	0
19	9262904	.	C	T	2	2	4	0	0	4	0	0
19	9265417	.	C	T	3	3	6	0	1	7	0	0
19	9265429	.	G	T	4	4	8	0	0	8	0	0
19	9265516	.	A	C	2	2	4	0	1	5	0	0
19	9265517	.	G	A	2	2	4	0	1	5	0	0
19	9266121	.	T	C	5	2	7	0	0	7	0	0
19	9266326	.	C	T	4	9	13	0	0	13	0	0
19	9266793	.	A	C	1	4	5	0	0	5	0	0
19	9266963	.	C	T	1	4	5	0	0	5	0	0
19	9268379	.	G	A	1	3	4	0	0	4	0	0
19	9268433	.	C	T	2	7	9	0	0	9	0	0
19	9268458	.	G	A	2	5	7	0	0	7	0	0
19	9268468	.	A	C	3	3	6	0	0	6	0	0
19	9268589	.	A	G	1	0	1	0	3	4	0	0
19	9268619	.	C	A	2	3	5	0	0	5	0	0
19	9273768	.	T	A	12	9	21	0	0	21	0	0
19	9274070	.	G	A	1	5	6	0	5	11	0	0
19	9274095	.	G	T	6	5	11	0	0	11	0	0
19	9274500	.	T	C	5	5	10	0	0	10	0	0
19	9274574	.	C	T	3	5	8	0	0	8	0	0
19	9274666	.	T	C	3	7	10	0	1	11	0	0
19	9274705	.	C	T	6	6	12	0	0	12	0	0
19	9274844	.	A	C	6	10	16	0	0	16	0	0
19	9458166	.	A	G	17	2	19	0	24	43	0	0
19	9458181	.	A	C	18	18	36	0	2	38	0	0
19	9458304	.	G	A	10	13	23	0	1	24	0	0
19	9458328	.	T	C	9	16	25	0	2	27	0	0
19	9458421	.	G	A	17	15	32	0	1	33	0	0
19	9458463	.	C	T	16	22	38	0	1	39	0	0
19	9459325	.	T	A	26	10	36	1	2	39	0	0
19	9459330	.	C	T	26	3	29	0	2	31	0	0
19	9459378	.	A	G	24	0	24	0	22	46	0	0
19	9459597	.	G	A	2	17	19	0	22	41	0	0
19	9459673	.	G	A	1	18	19	0	21	40	0	0
19	9459820	.	T	C	20	18	38	0	0	38	0	0
19	9460128	.	A	C	20	10	30	0	0	30	0	0
19	9460196	.	A	G	18	17	35	0	1	36	0	0
19	9460499	.	A	G	21	20	41	0	0	41	0	0
19	9460531	.	G	T	29	24	53	0	1	54	0	0
19	9461072	.	A	G	43	16	59	0	0	59	0	0
19	9461141	.	T	G	22	29	51	0	0	51	0	0
19	9461376	.	A	G	33	30	63	0	3	66	0	0
19	9461841	.	A	G	37	29	66	0	5	71	0	0
19	9462810	.	T	A	31	44	75	1	1	77	0	0
19	9471066	.	G	A	38	32	70	0	1	71	0	0
19	9472865	.	G	A	20	29	49	0	1	50	0	0
19	9481729	.	T	C	2	3	5	0	0	5	0	0
19	9481781	.	T	G	3	7	10	0	0	10	0	0
19	9481834	.	C	A	3	3	6	0	0	6	0	0
19	9481838	.	T	A	2	3	5	0	1	6	0	0
19	9482033	.	A	C	1	3	4	0	0	4	0	0
19	9482071	.	A	G	1	5	6	0	1	7	0	0
19	9482261	.	A	G	6	7	13	0	0	13	0	0
19	9485543	.	A	G	6	8	14	0	0	14	0	0
19	9502229	.	T	G	5	7	12	0	1	13	0	0
19	9502456	.	A	C	3	5	8	0	1	9	0	0
19	9502640	.	T	C	14	11	25	0	0	25	0	0
19	9502656	.	A	G	13	9	22	0	1	23	0	0
19	9502968	.	C	T	10	5	15	0	1	16	0	0
19	9503303	.	A	G	4	4	8	0	0	8	0	0
19	9503356	.	T	G	4	3	7	0	0	7	0	0
19	9513443	.	T	C	6	8	14	0	0	14	0	0
19	9513572	.	A	C	6	9	15	0	1	16	0	0
19	9513863	.	A	C	14	15	29	0	1	30	0	0
19	9513869	.	A	C	16	17	33	0	0	33	0	0
19	9516869	.	A	G	9	10	19	0	0	19	0	0
19	9519284	.	G	A	6	11	17	0	1	18	0	0
19	9533299	.	C	G	3	4	7	1	1	9	0	0
19	9585421	.	C	T	6	2	8	0	0	8	0	0
19	9585436	.	G	A	7	2	9	0	0	9	0	0
19	9598053	.	C	T	9	7	16	0	1	17	0	0
19	9598080	.	A	G	12	7	19	0	1	20	0	0
19	9598119	.	C	A	14	7	21	0	0	21	0	0
19	9603062	.	C	T	6	6	12	0	3	15	0	0
19	9603160	.	G	A	0	15	15	0	8	23	0	0
19	9603233	.	G	T	1	9	10	0	8	18	0	0
19	9603425	.	C	T	10	14	24	0	0	24	0	0
19	9603432	.	T	A	10	12	22	0	2	25	1	0
19	9603752	.	C	T	2	4	6	0	1	7	0	0
19	9603975	.	G	T	1	2	3	0	1	4	0	0
19	9604050	.	T	A	5	6	11	0	1	12	0	0
19	9604073	.	T	A	6	9	15	0	0	15	0	0
19	9685506	.	A	G	14	17	31	0	1	32	0	0
19	9685695	.	A	G	26	23	49	0	1	50	0	0
19	9686123	.	G	T	12	6	18	0	2	20	0	0
19	9686128	.	A	G	15	9	24	0	0	24	0	0
19	9686160	.	T	C	19	9	28	0	0	28	0	0
19	9686163	.	C	A	20	9	29	0	0	29	0	0
19	9686421	.	G	T	12	16	28	0	0	28	0	0
19	9686515	.	T	A	13	12	25	1	1	27	0	0
19	9686519	.	G	A	11	12	23	1	2	26	0	0
19	9686615	.	T	C	11	16	27	0	2	29	0	0
19	9686627	.	T	C	10	20	30	0	0	30	0	0
19	9686678	.	T	A	13	15	28	0	0	28	0	0
19	9686806	.	T	C	6	5	11	1	0	12	0	0
19	9686807	.	C	T	7	5	12	1	0	13	0	0
19	9687001	.	T	G	8	7	15	1	0	16	0	0
19	9687146	.	T	C	19	18	37	0	1	38	0	0
19	9687206	.	T	A	13	22	35	0	5	40	0	0
19	9687306	.	G	A	21	22	43	0	3	46	0	0
19	9691780	.	A	G	20	14	34	0	0	34	0	0
19	9700886	.	T	C	5	0	5	0	4	9	0	0
19	9711421	.	T	C	7	3	10	0	0	10	0	0
19	9711444	.	G	A	10	6	16	0	0	16	0	0
19	9712337	.	G	A	10	3	13	0	1	14	0	0
19	9712357	.	T	A	12	3	15	0	1	16	0	0
19	9712444	.	G	A	4	7	11	0	1	12	0	0
19	9712514	.	C	T	6	5	11	0	0	11	0	0
19	9813942	.	A	G	6	9	15	0	1	16	0	0
19	9814291	.	C	T	1	27	28	0	21	49	0	0
19	9814336	.	T	C	21	25	46	0	0	46	0	0
19	9814423	.	A	G	22	22	44	0	1	45	0	0
19	9814444	.	G	A	24	16	40	0	3	43	0	0
19	9814504	.	G	A	25	21	46	0	2	48	0	0
19	9814516	.	A	G	23	27	50	0	0	50	0	0
19	9814549	.	T	C	15	34	49	0	1	50	0	0
19	9814611	.	A	G	6	7	13	0	1	14	0	0
19	9814621	.	C	T	0	5	5	0	7	12	0	0
19	9822566	.	G	C	13	11	24	0	2	26	0	0
19	9822610	.	G	A	11	13	24	0	6	30	0	0
19	9840924	.	C	T	10	14	24	0	0	24	0	0
19	9841006	.	A	G	8	22	30	0	2	32	0	0
19	9841035	.	G	A	6	14	20	0	1	21	0	0
19	9841054	.	T	C	8	1	9	0	9	18	0	0
19	9841203	.	A	T	9	13	22	0	2	24	0	0
19	9841450	.	C	G	11	8	19	0	0	19	0	0
19	9841523	.	G	A	6	17	23	0	0	23	0	0
19	9842252	.	T	C	16	25	41	0	0	41	0	0
19	9859170	.	A	G	6	5	11	0	0	11	0	0
19	9866930	.	C	G	5	6	11	0	0	11	0	0
19	9910842	.	G	A	8	11	19	1	0	20	0	0
19	9911566	.	T	A	5	4	9	0	1	10	0	0
19	9911587	.	T	G	6	8	14	0	0	14	0	0
19	9911904	.	A	T	4	4	8	0	0	8	0	0
19	9911948	.	G	A	4	4	8	0	0	8	0	0
19	9911955	.	T	A	5	3	8	0	0	8	0	0
19	9912040	.	G	A	11	5	16	1	1	18	0	0
19	9912113	.	A	C	8	8	16	0	1	17	0	0
19	9912117	.	C	T	8	8	16	0	1	17	0	0
19	9912425	.	A	G	2	3	5	0	0	5	0	0
19	9912487	.	A	T	2	4	6	0	1	7	0	0
19	9912496	.	A	G	3	4	7	0	0	7	0	0
19	9912561	.	A	C	4	3	7	0	0	8	1	0
19	9912663	.	G	C	10	0	10	0	5	15	0	0
19	9912665	.	G	T	10	5	15	0	0	15	0	0
19	9912844	.	A	C	4	3	7	1	1	9	0	0
19	9913270	.	T	C	1	2	3	0	0	3	0	0
19	9914424	.	T	A	6	3	9	0	1	10	0	0
19	9914866	.	T	A	6	5	11	0	5	16	0	0
19	9916597	.	C	T	3	2	5	0	2	7	0	0
19	9916786	.	A	G	8	3	11	0	0	11	0	0
19	9916840	.	G	A	5	4	9	0	2	11	0	0
19	9917581	.	G	A	2	6	8	0	0	8	0	0
19	9921785	.	G	A	1	2	3	0	0	3	0	0
19	10177382	.	C	A	18	17	35	0	1	36	0	0
19	10177951	.	A	G	15	16	31	0	1	32	0	0
19	10190085	.	A	G	4	3	7	0	0	7	0	0
19	10195375	.	C	G	4	7	11	0	0	11	0	0
19	10195376	.	A	C	4	0	4	0	7	11	0	0
19	10195432	.	T	C	3	6	9	0	1	10	0	0
19	10196049	.	T	A	4	8	12	0	0	12	0	0
19	10201566	.	T	G	8	12	20	0	0	20	0	0
19	10201719	.	A	G	13	18	31	0	1	32	0	0
19	10202598	.	T	C	12	0	12	0	11	23	0	0
19	10203420	.	T	C	12	12	24	0	0	24	0	0
19	10203480	.	C	T	2	8	10	0	14	24	0	0
19	10203936	.	T	G	9	7	16	0	0	16	0	0
19	10204023	.	G	A	13	11	24	0	1	25	0	0
19	10204476	.	C	T	3	4	7	0	0	7	0	0
19	10205409	.	T	A	5	4	9	0	2	11	0	0
19	10205804	.	T	C	1	0	1	0	2	3	0	0
19	10205813	.	T	C	3	2	5	0	0	5	0	0
19	10205949	.	G	A	5	4	9	0	1	10	0	0
19	10206414	.	G	A	6	3	9	0	0	9	0	0
19	10206420	.	G	A	3	6	9	0	0	9	0	0
19	10206552	.	A	G	4	3	7	0	0	7	0	0
19	10207704	.	A	T	2	3	5	0	0	5	0	0
19	10218136	.	T	A	17	12	29	0	2	31	0	0
19	10218807	.	C	T	1	8	9	0	4	13	0	0
19	10219051	.	T	A	14	8	22	0	0	22	0	0
19	10219186	.	C	A	15	19	34	0	0	34	0	0
19	10219209	.	T	G	15	13	28	0	4	32	0	0
19	10219387	.	T	C	16	16	32	0	4	36	0	0
19	10220013	.	G	A	22	26	48	1	1	50	0	0
19	10220283	.	T	G	23	15	38	0	1	39	0	0
19	10235373	.	T	C	21	13	34	0	0	35	1	0
19	10235899	.	G	C	24	16	40	0	0	40	0	0
19	10236249	.	C	T	3	11	14	0	1	15	0	0
19	10236490	.	C	A	11	6	17	0	1	18	0	0
19	10236569	.	T	C	2	10	12	0	2	14	0	0
19	10236853	.	A	G	6	4	10	0	0	10	0	0
19	10237198	.	G	C	7	5	12	0	0	12	0	0
19	10237241	.	G	A	5	5	10	0	0	10	0	0
19	10237394	.	A	G	12	14	26	0	0	26	0	0
19	10237446	.	A	T	16	18	34	0	1	35	0	0
19	10237950	.	T	C	7	0	7	0	8	15	0	0
19	10238011	.	G	C	4	0	4	0	13	17	0	0
19	10238045	.	C	G	6	13	19	0	0	19	0	0
19	10238301	.	G	C	3	0	3	0	7	10	0	0
19	10238303	.	T	C	3	6	9	0	1	10	0	0
19	10238348	.	G	A	2	3	5	0	1	6	0	0
19	10238350	.	C	G	1	3	4	0	2	6	0	0
19	10238580	.	G	A	7	4	11	0	0	11	0	0
19	10252413	.	T	C	9	9	18	0	0	18	0	0
19	10252630	.	G	C	2	0	2	0	3	5	0	0
19	10252650	.	A	G	2	2	4	0	0	4	0	0
19	10252679	.	A	T	2	4	6	0	0	6	0	0
19	10252999	.	A	G	3	3	6	0	0	6	0	0
19	10253019	.	T	C	3	3	6	0	1	7	0	0
19	10253058	.	A	T	2	8	10	0	1	11	0	0
19	10253087	.	T	G	2	8	10	0	0	10	0	0
19	10253140	.	A	T	1	7	8	0	0	8	0	0
19	10253160	.	G	A	2	7	9	0	0	9	0	0
19	10253759	.	A	G	5	5	10	0	1	11	0	0
19	10253812	.	T	A	2	6	8	0	0	8	0	0
19	10253915	.	T	C	2	3	5	0	0	5	0	0
19	10253977	.	T	C	3	0	3	0	2	5	0	0
19	10253985	.	G	A	3	2	5	0	0	5	0	0
19	10254048	.	C	T	3	5	8	0	0	8	0	0
19	10254063	.	T	A	2	4	6	0	0	6	0	0
19	10254128	.	T	G	1	2	3	0	0	3	0	0
19	10254146	.	A	C	0	2	2	0	1	3	0	0
19	10254690	.	A	C	4	8	12	0	0	12	0	0
19	10254772	.	C	T	2	4	6	0	0	6	0	0
19	10254840	.	C	T	0	3	3	0	3	6	0	0
19	10255680	.	G	A	8	6	14	0	0	14	0	0
19	10255702	.	A	C	7	5	12	0	0	12	0	0
19	10264727	.	T	G	4	2	6	0	0	6	0	0
19	10272707	.	A	G	1	2	3	0	1	4	0	0
19	10274118	.	T	C	0	3	3	0	1	4	0	0
19	10281958	.	C	T	0	3	3	0	1	4	0	0
19	10299174	.	A	C	13	13	26	0	0	26	0	0
19	10299383	.	G	A	16	20	36	0	0	36	0	0
19	10299579	.	C	A	9	10	19	0	0	19	0	0
19	10299593	.	A	G	8	6	14	0	0	14	0	0
19	10299706	.	C	T	0	19	19	0	12	31	0	0
19	10301236	.	T	C	11	19	30	0	2	32	0	0
19	10318746	.	G	A	1	2	3	0	0	3	0	0
19	10376210	.	T	G	3	3	6	0	0	6	0	0
19	10376610	.	A	C	18	13	31	0	3	34	0	0
19	10377097	.	C	T	13	23	36	0	3	39	0	0
19	10377534	.	G	T	18	12	30	0	0	30	0	0
19	10377597	.	T	C	24	1	25	0	8	33	0	0
19	10377599	.	T	C	21	10	31	0	1	32	0	0
19	10377633	.	A	G	20	13	33	1	1	35	0	0
19	10377777	.	T	C	21	9	30	0	1	31	0	0
19	10377815	.	A	C	16	23	39	0	2	41	0	0
19	10377892	.	A	C	19	14	33	2	2	37	0	0
19	10377911	.	A	T	18	16	34	2	0	36	0	0
19	10378192	.	G	A	15	24	39	0	2	41	0	0
19	10378457	.	A	T	10	8	18	0	3	21	0	0
19	10378544	.	C	T	24	11	35	0	1	36	0	0
19	10378599	.	T	C	19	10	29	0	0	29	0	0
19	10378618	.	C	T	12	11	23	0	3	26	0	0
19	10378700	.	A	G	8	11	19	0	1	20	0	0
19	10378848	.	C	T	8	15	23	0	0	23	0	0
19	10378868	.	T	C	13	0	13	0	10	23	0	0
19	10378889	.	C	T	11	12	23	0	1	24	0	0
19	10378959	.	C	A	15	15	30	0	1	31	0	0
19	10379011	.	T	C	11	5	16	0	1	17	0	0
19	10379183	.	C	A	10	9	19	0	0	19	0	0
19	10379192	.	C	T	11	11	22	0	0	22	0	0
19	10379314	.	C	T	3	13	16	0	11	27	0	0
19	10379321	.	C	T	13	12	25	0	0	25	0	0
19	10379369	.	C	T	14	8	22	0	0	22	0	0
19	10379475	.	A	G	19	9	28	0	0	28	0	0
19	10379555	.	T	G	12	14	26	0	2	28	0	0
19	10379575	.	A	G	13	15	28	0	0	28	0	0
19	10379821	.	T	A	16	19	35	0	1	36	0	0
19	10379833	.	T	G	17	14	31	0	1	32	0	0
19	10379873	.	A	G	18	8	26	0	1	27	0	0
19	10379965	.	T	C	17	6	23	0	0	23	0	0
19	10383100	.	A	G	9	13	22	0	1	23	0	0
19	10383112	.	G	T	14	7	21	0	2	23	0	0
19	10383532	.	G	A	13	8	21	0	2	23	0	0
19	10383533	.	T	A	8	7	15	0	7	22	0	0
19	10383616	.	C	T	0	14	14	0	11	25	0	0
19	10386619	.	C	T	14	12	26	0	1	27	0	0
19	10388285	.	C	T	6	5	11	0	0	11	0	0
19	10393034	.	G	A	4	6	10	0	0	10	0	0
19	10393072	.	A	G	6	7	13	0	1	14	0	0
19	10394835	.	T	G	8	5	13	0	0	13	0	0
19	10407312	.	C	T	20	18	38	0	1	39	0	0
19	10407546	.	A	T	29	21	50	0	4	54	0	0
19	10407732	.	T	A	31	33	64	0	5	69	0	0
19	10407767	.	G	T	22	35	57	0	4	61	0	0
19	10558602	.	T	C	1	6	7	0	0	7	0	0
19	10558604	.	G	A	1	6	7	0	0	7	0	0
19	10561001	.	A	G	18	12	30	0	0	30	0	0
19	10562737	.	T	C	8	11	19	0	1	20	0	0
19	10565385	.	C	T	12	9	21	0	0	21	0	0
19	10569122	.	T	C	12	13	25	0	2	27	0	0
19	10575315	.	T	C	6	5	11	0	0	11	0	0
19	10575318	.	G	T	7	5	12	0	0	12	0	0
19	10575565	.	G	C	1	9	10	0	11	21	0	0
19	10575824	.	T	G	11	8	19	0	0	19	0	0
19	10576120	.	G	T	9	3	12	0	0	12	0	0
19	10576138	.	G	T	7	3	10	0	0	10	0	0
19	10576289	.	C	G	3	6	9	0	1	10	0	0
19	10576297	.	A	T	3	8	11	0	0	11	0	0
19	10576338	.	G	A	0	3	3	0	1	4	0	0
19	10576482	.	C	T	8	9	17	0	1	18	0	0
19	10576520	.	T	C	11	3	14	0	1	15	0	0
19	10576909	.	G	A	12	8	20	0	2	22	0	0
19	10576970	.	A	T	7	11	18	0	0	18	0	0
19	10577011	.	T	G	11	0	11	0	7	18	0	0
19	10577194	.	T	A	5	4	9	0	1	11	1	0
19	10649711	.	T	A	1	7	8	0	0	8	0	0
19	10649722	.	T	C	2	6	8	0	1	9	0	0
19	10649830	.	G	T	6	5	11	0	0	11	0	0
19	10653644	.	C	T	3	2	5	0	1	6	0	0
19	10654540	.	G	A	3	2	5	0	2	7	0	0
19	10654553	.	C	A	0	4	4	0	3	7	0	0
19	10673220	.	A	G	1	2	3	0	0	3	0	0
19	10678222	.	T	C	1	2	3	0	0	3	0	0
19	10685488	.	C	T	2	2	4	0	0	4	0	0
19	10826094	.	C	T	1	2	3	0	0	3	0	0
19	10826564	.	A	G	1	4	5	0	0	5	0	0
19	10841477	.	G	T	7	13	20	0	2	22	0	0
19	10865130	.	T	C	1	1	2	0	1	3	0	0
19	10865197	.	A	T	1	3	4	0	0	4	0	0
19	10865292	.	C	T	1	1	2	0	1	3	0	0
19	10868522	.	G	A	0	3	3	0	1	4	0	0
19	10868541	.	C	A	2	2	4	0	0	4	0	0
19	10870305	.	A	G	5	0	5	0	4	9	0	0
19	10870361	.	C	T	3	4	7	0	1	8	0	0
19	10870602	.	G	A	5	4	9	0	2	11	0	0
19	10870737	.	A	G	3	5	8	0	1	9	0	0
19	10870845	.	C	T	2	2	4	0	0	4	0	0
19	10871259	.	A	T	3	2	5	0	0	5	0	0
19	10871719	.	A	G	2	11	13	0	0	13	0	0
19	10871803	.	C	T	0	12	12	0	6	18	0	0
19	10871823	.	A	G	6	12	18	0	1	19	0	0
19	10872397	.	C	T	13	12	25	0	2	27	0	0
19	10875854	.	A	G	12	18	30	0	2	32	0	0
19	10876446	.	C	T	11	10	21	0	0	21	0	0
19	10893186	.	T	A	3	3	6	0	0	6	0	0
19	10893211	.	T	C	3	5	8	0	0	8	0	0
19	10989189	.	A	C	13	11	24	1	0	25	0	0
19	10989343	.	T	A	11	18	29	0	4	33	0	0
19	10989457	.	T	C	13	17	30	0	1	31	0	0
19	10989511	.	A	G	19	8	27	0	1	28	0	0
19	10989653	.	C	A	23	13	36	0	3	39	0	0
19	10997288	.	A	G	3	2	5	0	0	5	0	0
19	10999786	.	G	T	14	9	23	0	2	25	0	0
19	11014636	.	G	A	15	10	25	0	0	25	0	0
19	11014675	.	A	G	7	11	18	0	1	19	0	0
19	11015010	.	G	C	3	3	6	0	0	6	0	0
19	11015047	.	T	C	2	0	2	0	3	5	0	0
19	11039539	.	A	C	2	5	7	0	1	8	0	0
19	11039829	.	G	C	5	9	14	0	1	15	0	0
19	11040493	.	A	T	15	9	24	0	1	25	0	0
19	11045311	.	C	A	2	17	19	0	15	34	0	0
19	11045323	.	C	T	18	16	34	0	3	37	0	0
19	11045864	.	A	C	18	7	25	0	0	25	0	0
19	11048822	.	C	T	2	14	16	0	11	27	0	0
19	11051581	.	T	C	10	10	20	0	1	21	0	0
19	11063846	.	C	T	6	6	12	0	0	12	0	0
19	11070738	.	A	G	2	4	6	0	0	6	0	0
19	11070794	.	G	A	7	8	15	0	0	15	0	0
19	11078869	.	T	C	2	3	5	0	0	5	0	0
19	11079087	.	T	C	3	2	5	0	0	5	0	0
19	11079284	.	C	G	2	3	5	0	0	5	0	0
19	11172188	.	G	A	5	2	7	0	0	7	0	0
19	11174774	.	C	T	0	2	2	0	2	4	0	0
19	11191427	.	T	A	5	2	7	0	0	7	0	0
19	11231386	.	C	A	8	6	14	0	1	15	0	0
19	11237043	.	A	G	6	6	12	0	0	12	0	0
19	11237049	.	T	C	5	8	13	0	2	15	0	0
19	12583804	.	T	G	1	0	1	0	12	13	0	0
19	12938205	.	T	C	1	2	3	0	0	3	0	0
19	13151155	.	A	G	3	0	3	0	19	22	0	0
19	13413547	.	A	G	3	4	7	0	0	7	0	0
19	13413752	.	A	G	4	4	8	0	1	9	0	0
19	19550141	.	T	G	1	8	9	0	1	10	0	0
19	19787653	.	A	G	1	0	1	0	2	3	0	0
19	20721761	.	A	C	17	15	32	0	6	38	0	0
19	20753194	.	G	T	3	2	5	1	0	6	0	0
19	21413001	.	G	T	10	4	14	0	1	15	0	0
19	24916543	.	A	T	5	2	7	0	1	8	0	0
19	25156242	.	T	A	5	3	8	0	0	8	0	0
19	25653005	.	A	G	1	22	23	0	1	24	0	0
19	26365280	.	A	G	3	2	5	0	0	5	0	0
19	27283660	.	T	C	2	2	4	0	0	4	0	0
19	27284387	.	A	G	1	12	13	0	1	14	0	0
19	27286084	.	A	C	3	5	8	0	0	8	0	0
19	27469130	.	A	G	4	8	12	0	0	12	0	0
19	30521443	.	C	A	5	3	8	0	0	8	0	0
19	30521775	.	T	A	7	4	11	0	1	12	0	0
19	30521782	.	T	A	3	3	6	0	0	6	0	0
19	30589376	.	T	G	1	0	1	0	6	7	0	0
19	31517478	.	T	C	8	6	14	0	1	15	0	0
19	31532236	.	T	A	2	2	4	1	0	5	0	0
19	31551729	.	T	G	1	2	3	0	1	4	0	0
19	31555871	.	T	A	4	4	8	0	0	8	0	0
19	31560775	.	G	A	3	12	15	0	1	16	0	0
19	31569338	.	A	G	4	2	6	0	0	6	0	0
19	31569535	.	C	T	4	3	7	0	0	7	0	0
19	31571563	.	T	C	4	3	7	0	1	8	0	0
19	31571572	.	G	A	3	5	8	0	0	8	0	0
19	31574099	.	A	T	2	3	5	0	0	5	0	0
19	31576024	.	T	A	3	4	7	0	0	7	0	0
19	31576954	.	A	G	5	9	14	0	0	14	0	0
19	31579343	.	T	C	1	2	3	0	1	4	0	0
19	31579347	.	G	A	1	3	4	0	0	4	0	0
19	31579783	.	T	A	22	17	39	0	0	39	0	0
19	31579860	.	G	T	22	26	48	0	0	48	0	0
19	31580071	.	C	A	5	20	25	0	15	40	0	0
19	31580103	.	A	T	24	25	49	0	2	51	0	0
19	31580160	.	T	A	26	29	55	0	4	59	0	0
19	31580186	.	T	G	30	25	55	0	3	58	0	0
19	31580328	.	A	C	21	2	23	0	24	47	0	0
19	31582349	.	C	T	22	15	37	0	1	38	0	0
19	31583137	.	A	G	7	6	13	0	1	14	0	0
19	31583179	.	C	T	12	12	24	0	5	29	0	0
19	31583289	.	C	T	16	8	24	1	3	28	0	0
19	31583305	.	A	G	11	11	22	1	1	24	0	0
19	31584018	.	T	G	17	13	30	0	1	31	0	0
19	31593550	.	A	G	4	7	11	0	0	11	0	0
19	31593594	.	C	A	3	8	11	0	1	12	0	0
19	31593595	.	C	A	4	8	12	0	0	12	0	0
19	31593706	.	G	C	11	9	20	0	1	21	0	0
19	31593762	.	G	A	8	11	19	0	2	21	0	0
19	31593957	.	C	T	5	8	13	0	3	16	0	0
19	31596948	.	C	G	4	7	11	0	1	12	0	0
19	31598108	.	G	T	5	3	8	0	0	8	0	0
19	31598113	.	G	A	5	5	10	0	1	11	0	0
19	31603351	.	G	C	5	5	10	0	0	10	0	0
19	31612666	.	T	C	2	2	4	0	0	4	0	0
19	31613176	.	G	A	1	5	6	0	0	6	0	0
19	31621507	.	G	A	2	2	4	0	0	4	0	0
19	31621891	.	G	T	4	3	7	0	0	7	0	0
19	31621903	.	C	T	3	4	7	0	0	7	0	0
19	31686155	.	T	G	1	2	3	0	0	3	0	0
19	31771335	.	T	A	27	24	51	0	0	51	0	0
19	31789666	.	C	T	18	22	40	0	12	52	0	0
19	31790042	.	C	A	38	24	62	2	2	66	0	0
19	31790079	.	A	G	43	24	67	2	3	72	0	0
19	31790097	.	C	T	41	29	70	4	1	75	0	0
19	31790115	.	C	A	31	37	68	4	5	77	0	0
19	31790283	.	G	C	43	26	69	0	1	70	0	0
19	31790385	.	A	G	23	20	43	1	9	53	0	0
19	31797778	.	G	A	6	4	10	0	0	10	0	0
19	31797834	.	G	T	2	3	5	0	0	5	0	0
19	31798162	.	T	C	2	2	4	0	0	4	0	0
19	31798203	.	C	G	3	4	7	0	0	7	0	0
19	31891350	.	A	G	5	5	10	0	1	11	0	0
19	31938817	.	T	C	2	2	4	0	1	5	0	0
19	32041686	.	T	C	2	4	6	0	0	6	0	0
19	32041747	.	T	C	3	2	5	0	0	5	0	0
19	32049055	.	A	G	8	14	22	0	0	22	0	0
19	32049443	.	T	C	10	10	20	0	1	21	0	0
19	32049485	.	A	T	6	12	18	0	0	18	0	0
19	32049775	.	G	A	7	14	21	0	0	21	0	0
19	32049850	.	A	G	17	15	32	0	1	33	0	0
19	32049891	.	A	G	11	14	25	0	3	28	0	0
19	32050174	.	T	G	8	8	16	0	2	18	0	0
19	32050535	.	A	T	17	22	39	0	1	40	0	0
19	32050536	.	T	A	16	23	39	0	1	40	0	0
19	32050593	.	A	T	12	17	29	0	0	29	0	0
19	32050679	.	C	A	10	11	21	0	1	22	0	0
19	32050702	.	G	A	9	6	15	0	0	15	0	0
19	32050944	.	A	T	8	14	22	0	3	25	0	0
19	32051218	.	C	A	12	7	19	0	0	19	0	0
19	32051226	.	G	A	9	5	14	0	3	17	0	0
19	32051541	.	T	G	8	6	14	0	0	14	0	0
19	32051566	.	G	C	8	5	13	0	1	14	0	0
19	32064557	.	T	G	12	8	20	0	0	20	0	0
19	32064872	.	C	T	1	9	10	0	7	17	0	0
19	32149988	.	A	C	11	9	20	0	4	24	0	0
19	32167216	.	T	C	8	9	17	0	0	17	0	0
19	32457264	.	C	G	3	4	7	0	0	7	0	0
19	32457390	.	T	C	3	6	9	0	1	10	0	0
19	32457564	.	T	C	1	3	4	0	0	4	0	0
19	32458152	.	C	T	2	4	6	0	0	6	0	0
19	32458158	.	T	C	2	4	6	0	0	6	0	0
19	32458422	.	G	A	2	3	5	0	1	6	0	0
19	32461473	.	C	T	2	3	5	0	0	5	0	0
19	32473399	.	A	G	6	3	9	0	0	9	0	0
19	32473451	.	G	A	5	4	9	0	0	9	0	0
19	32473770	.	C	T	4	5	9	0	0	9	0	0
19	32473812	.	C	T	5	6	11	0	1	12	0	0
19	32474031	.	T	G	4	6	10	0	0	10	0	0
19	32474042	.	C	A	4	4	8	0	0	8	0	0
19	32474102	.	C	T	1	2	3	0	0	3	0	0
19	32474355	.	T	A	4	4	8	0	0	8	0	0
19	32474723	.	G	T	4	4	8	0	0	8	0	0
19	32474885	.	A	G	6	5	11	0	0	11	0	0
19	32475348	.	A	G	4	7	11	0	0	11	0	0
19	32487242	.	T	C	2	2	4	0	0	4	0	0
19	32487408	.	C	T	3	3	6	1	0	7	0	0
19	32489056	.	G	A	3	2	5	0	0	5	0	0
19	32497388	.	C	T	6	5	11	0	1	12	0	0
19	32499932	.	G	A	4	2	6	0	0	6	0	0
19	32499983	.	G	A	1	2	3	0	0	3	0	0
19	32500172	.	G	C	2	5	7	0	0	7	0	0
19	32500269	.	G	A	2	7	9	0	0	9	0	0
19	32505825	.	C	T	6	4	10	0	2	12	0	0
19	32505846	.	C	A	4	2	6	0	0	6	0	0
19	32505875	.	C	T	1	6	7	0	7	14	0	0
19	32505927	.	G	T	4	10	14	0	0	14	0	0
19	32515377	.	T	A	8	4	12	0	0	12	0	0
19	32572647	.	T	C	10	5	15	0	2	17	0	0
19	32572999	.	A	T	7	7	14	0	0	14	0	0
19	32573001	.	T	A	6	7	13	0	0	13	0	0
19	32573057	.	G	A	3	6	9	0	0	9	0	0
19	32573064	.	C	T	3	6	9	0	0	9	0	0
19	32573100	.	C	A	5	5	10	0	0	10	0	0
19	32573173	.	T	C	8	0	8	0	3	11	0	0
19	32573193	.	A	G	5	2	7	0	1	9	1	0
19	32573229	.	A	G	8	6	14	0	0	14	0	0
19	32573269	.	T	C	8	8	16	0	0	16	0	0
19	32575190	.	G	A	10	3	13	0	1	14	0	0
19	32588706	.	C	T	5	5	10	0	0	10	0	0
19	32588775	.	G	A	2	8	10	0	0	10	0	0
19	32600644	.	C	T	0	2	2	0	6	8	0	0
19	32600720	.	A	C	7	5	12	0	0	12	0	0
19	32623259	.	G	A	4	2	6	0	3	9	0	0
19	32623687	.	G	A	28	25	53	0	0	53	0	0
19	32624048	.	A	C	24	14	38	0	3	41	0	0
19	32624138	.	G	A	30	20	50	0	1	51	0	0
19	32624247	.	A	G	18	28	46	0	4	50	0	0
19	32638212	.	G	A	24	35	59	0	4	63	0	0
19	32767799	.	T	C	1	0	1	0	2	3	0	0
19	32767889	.	A	G	4	3	7	0	0	7	0	0
19	32767891	.	T	A	4	3	7	0	0	7	0	0
19	32767965	.	C	T	3	6	9	0	1	10	0	0
19	32768397	.	C	G	4	5	9	0	0	9	0	0
19	32768434	.	T	C	5	4	9	0	0	9	0	0
19	32768551	.	C	T	2	2	4	0	0	4	0	0
19	32768668	.	T	C	3	6	9	0	1	10	0	0
19	32768880	.	G	T	1	2	3	0	1	4	0	0
19	32768935	.	T	G	5	4	9	0	0	9	0	0
19	32768954	.	A	C	5	3	8	0	0	8	0	0
19	32768985	.	G	A	4	2	6	0	1	7	0	0
19	32769271	.	G	T	5	3	8	0	0	8	0	0
19	32770917	.	G	A	2	3	5	0	0	5	0	0
19	32807301	.	A	T	3	3	6	0	0	6	0	0
19	32807706	.	G	A	2	2	4	0	0	4	0	0
19	32807915	.	A	G	2	4	6	0	1	7	0	0
19	32807933	.	A	C	2	3	5	0	0	5	0	0
19	32808140	.	C	T	6	3	9	0	0	9	0	0
19	32808332	.	G	T	0	9	9	0	5	14	0	0
19	32814334	.	G	T	8	11	19	0	0	19	0	0
19	32818503	.	G	T	1	8	9	0	1	10	0	0
19	32818824	.	A	G	10	9	19	0	0	19	0	0
19	32818825	.	G	A	10	9	19	0	0	19	0	0
19	32818910	.	G	A	1	5	6	0	3	9	0	0
19	32819234	.	G	A	12	10	22	0	2	24	0	0
19	32819303	.	T	C	16	20	36	0	1	37	0	0
19	32819347	.	C	T	23	12	35	0	2	37	0	0
19	32819640	.	A	G	9	4	13	0	2	15	0	0
19	32819703	.	C	A	8	5	13	0	0	13	0	0
19	32819760	.	A	T	3	6	9	0	1	10	0	0
19	32819798	.	C	T	2	5	7	0	0	7	0	0
19	32819952	.	T	C	3	3	6	0	0	6	0	0
19	32838396	.	T	A	9	6	15	0	0	15	0	0
19	32838662	.	C	T	2	2	4	0	0	4	0	0
19	32838666	.	C	T	1	2	3	0	1	4	0	0
19	32860668	.	G	T	7	6	13	0	0	13	0	0
19	32864963	.	T	G	20	15	35	0	0	35	0	0
19	32865113	.	G	A	26	8	34	3	0	37	0	0
19	32865276	.	A	T	12	8	20	0	1	21	0	0
19	32865337	.	C	A	17	10	27	0	1	28	0	0
19	32865347	.	C	T	17	12	29	0	1	30	0	0
19	32865527	.	G	C	14	4	18	0	0	18	0	0
19	32865562	.	C	A	9	3	12	0	1	13	0	0
19	32865569	.	A	G	9	2	11	0	0	11	0	0
19	32865758	.	A	C	1	2	3	0	0	3	0	0
19	32866126	.	A	C	8	14	22	0	0	22	0	0
19	32866234	.	T	G	6	11	17	0	0	17	0	0
19	32866264	.	G	C	8	0	8	0	9	17	0	0
19	32866322	.	A	G	15	7	22	0	0	22	0	0
19	32866362	.	T	A	8	10	18	0	1	19	0	0
19	32866372	.	C	T	8	9	17	0	0	17	0	0
19	32866475	.	T	A	11	13	24	0	3	27	0	0
19	32866570	.	T	A	14	14	28	0	0	28	0	0
19	32866571	.	A	G	13	13	26	0	1	27	0	0
19	32866620	.	G	A	3	6	9	0	1	10	0	0
19	32867274	.	A	T	13	8	21	0	4	25	0	0
19	32872674	.	A	G	20	13	33	2	2	37	0	0
19	32878103	.	G	A	17	7	24	0	2	26	0	0
19	32878370	.	A	G	8	9	17	0	0	17	0	0
19	32884181	.	A	G	6	4	10	0	0	10	0	0
19	32895748	.	G	T	11	19	30	0	1	31	0	0
19	32895873	.	T	A	3	5	8	0	2	10	0	0
19	32896001	.	G	A	9	9	18	0	0	18	0	0
19	32896174	.	A	T	2	3	5	0	1	6	0	0
19	32896177	.	T	C	4	2	6	0	0	6	0	0
19	32896336	.	G	T	5	3	8	2	0	10	0	0
19	32896427	.	C	A	1	10	11	0	13	24	0	0
19	32896499	.	T	G	10	7	17	0	1	18	0	0
19	32896519	.	T	C	8	8	16	0	0	16	0	0
19	32899313	.	T	A	4	10	14	0	0	14	0	0
19	32899328	.	T	A	7	8	15	0	0	15	0	0
19	32899452	.	A	G	9	12	21	0	0	21	0	0
19	32907732	.	A	C	6	8	14	0	1	15	0	0
19	32919074	.	A	G	12	6	18	0	3	21	0	0
19	32919215	.	A	T	14	8	22	0	1	23	0	0
19	32928367	.	A	T	15	7	22	0	0	22	0	0
19	32928446	.	T	C	10	0	10	0	7	17	0	0
19	32931100	.	A	T	24	20	44	0	1	45	0	0
19	32931101	.	C	T	3	21	24	0	21	45	0	0
19	32933891	.	C	A	29	28	57	0	1	58	0	0
19	32935480	.	G	C	29	26	55	0	1	56	0	0
19	32936989	.	T	C	26	19	45	2	1	48	0	0
19	32937663	.	C	A	26	23	49	0	5	54	0	0
19	32944034	.	A	G	13	17	30	0	0	30	0	0
19	32951040	.	G	C	14	9	23	0	1	24	0	0
19	32954310	.	A	G	14	13	27	0	0	27	0	0
19	32979329	.	T	G	3	2	5	0	0	5	0	0
19	32979625	.	A	G	5	7	12	0	0	12	0	0
19	33043458	.	A	G	7	10	17	0	1	18	0	0
19	33043749	.	T	C	7	7	14	0	0	14	0	0
19	33061247	.	C	T	6	4	10	0	1	11	0	0
19	33066783	.	C	G	13	1	14	0	17	31	0	0
19	33071055	.	C	G	12	9	21	0	1	22	0	0
19	33071126	.	G	T	11	11	22	0	0	22	0	0
19	33071172	.	G	T	9	9	18	0	1	19	0	0
19	33071249	.	G	C	13	9	22	0	0	22	0	0
19	33071635	.	A	T	5	4	9	0	1	10	0	0
19	33071795	.	A	T	7	14	21	0	1	22	0	0
19	33095789	.	T	C	6	5	11	0	0	11	0	0
19	33106035	.	G	C	4	3	7	0	0	7	0	0
19	33106333	.	G	A	0	9	9	0	5	14	0	0
19	33123179	.	A	G	8	10	18	0	1	19	0	0
19	33124700	.	A	T	6	8	14	0	0	14	0	0
19	33127718	.	T	C	10	4	14	0	1	15	0	0
19	33131666	.	C	T	14	17	31	0	3	34	0	0
19	33132033	.	T	A	10	12	22	0	2	24	0	0
19	33136410	.	A	G	26	0	26	0	22	48	0	0
19	33137436	.	A	G	12	4	16	0	26	42	0	0
19	33137667	.	C	T	6	4	10	0	0	10	0	0
19	33139671	.	C	G	3	0	3	0	3	6	0	0
19	33139701	.	C	A	3	5	8	0	1	9	0	0
19	33140259	.	A	C	2	2	4	0	0	4	0	0
19	33202985	.	C	A	2	3	5	0	0	5	0	0
19	33202996	.	T	A	2	4	6	0	2	8	0	0
19	33203744	.	G	A	8	11	19	0	0	19	0	0
19	33204301	.	A	C	1	2	3	0	0	3	0	0
19	33205130	.	G	A	4	4	8	0	0	8	0	0
19	33205255	.	C	G	0	2	2	0	1	3	0	0
19	33211420	.	C	T	4	2	6	0	0	6	0	0
19	33258705	.	A	G	1	1	2	0	1	3	0	0
19	33476598	.	T	C	1	5	6	0	1	7	0	0
19	33512144	.	G	A	1	3	4	0	0	4	0	0
19	33512809	.	T	A	1	2	3	0	0	3	0	0
19	33514118	.	C	T	2	2	4	0	0	4	0	0
19	33514481	.	C	T	4	2	6	0	0	6	0	0
19	33514655	.	G	A	2	5	7	0	0	7	0	0
19	33701679	.	C	T	7	8	15	0	1	16	0	0
19	33701722	.	A	T	5	2	7	0	1	8	0	0
19	33701838	.	G	A	1	8	9	0	5	14	0	0
19	33701887	.	T	A	4	9	13	0	0	13	0	0
19	33701923	.	T	A	9	6	15	0	0	15	0	0
19	33755973	.	G	A	2	8	10	0	5	15	0	0
19	33755985	.	A	G	2	0	2	0	7	10	1	0
19	33756009	.	G	T	2	6	8	0	1	9	0	0
19	33765636	.	C	T	17	14	31	0	1	32	0	0
19	33772226	.	T	A	13	13	26	1	1	28	0	0
19	33772280	.	T	C	17	14	31	0	2	33	0	0
19	33775750	.	C	T	13	9	22	0	0	23	1	0
19	33775810	.	T	C	7	11	18	0	1	19	0	0
19	33782757	.	A	G	5	1	6	0	15	21	0	0
19	33782914	.	A	G	4	7	11	0	1	12	0	0
19	33783332	.	A	T	9	11	20	0	2	22	0	0
19	33784221	.	T	A	7	10	17	0	0	17	0	0
19	33784896	.	T	C	17	16	33	0	1	34	0	0
19	33784897	.	C	T	16	14	30	0	3	33	0	0
19	33784966	.	C	T	17	15	32	0	1	33	0	0
19	33784986	.	T	C	17	12	29	0	3	32	0	0
19	33785094	.	C	T	8	13	21	0	1	22	0	0
19	33785109	.	C	T	9	10	19	0	2	21	0	0
19	33785175	.	G	A	10	17	27	0	2	29	0	0
19	33785197	.	G	A	1	20	21	0	8	29	0	0
19	33785234	.	A	G	13	2	15	0	14	29	0	0
19	33785240	.	T	C	13	15	28	0	1	29	0	0
19	33785357	.	C	A	13	16	29	0	0	29	0	0
19	33785379	.	G	A	13	14	27	0	0	27	0	0
19	33785512	.	T	C	12	18	30	0	0	30	0	0
19	33785704	.	G	T	24	19	43	0	0	43	0	0
19	33785735	.	T	G	15	1	16	0	19	35	0	0
19	33837007	.	G	T	11	5	16	0	0	16	0	0
19	33837178	.	G	C	18	5	23	0	2	25	0	0
19	33837183	.	G	A	20	5	25	0	1	26	0	0
19	33839595	.	G	A	13	5	18	0	1	19	0	0
19	33847935	.	A	T	7	6	13	0	0	14	1	0
19	33854781	.	G	A	1	2	3	0	0	3	0	0
19	33854790	.	T	C	2	2	4	0	0	4	0	0
19	33861569	.	A	G	1	0	1	0	2	3	0	0
19	33864177	.	T	A	2	2	4	0	0	4	0	0
19	33868389	.	G	A	3	3	6	1	0	8	1	0
19	33871868	.	C	T	4	5	9	0	0	9	0	0
19	33872816	.	T	G	4	5	9	0	5	14	0	0
19	33872859	.	G	A	1	2	3	0	9	12	0	0
19	33876062	.	C	G	1	0	1	0	4	5	0	0
19	33888520	.	A	C	33	21	54	0	2	56	0	0
19	33888881	.	T	G	29	16	45	0	2	47	0	0
19	33902586	.	G	A	17	11	28	0	2	30	0	0
19	33915802	.	C	T	9	9	18	0	1	19	0	0
19	33921715	.	A	G	16	13	29	0	0	29	0	0
19	33956909	.	C	T	12	14	26	0	1	27	0	0
19	33960517	.	G	A	10	9	19	0	1	20	0	0
19	33963773	.	G	T	9	5	14	0	0	14	0	0
19	33964282	.	G	A	10	10	20	0	1	21	0	0
19	33964353	.	A	G	9	12	21	0	1	22	0	0
19	33989497	.	G	A	7	10	17	0	1	18	0	0
19	33993507	.	C	T	5	7	12	0	7	19	0	0
19	34074028	.	G	A	6	4	10	0	0	10	0	0
19	34074072	.	A	G	8	8	16	0	1	17	0	0
19	34074386	.	T	G	14	8	22	0	2	24	0	0
19	34081003	.	A	G	6	18	24	0	0	24	0	0
19	34089132	.	T	G	11	6	17	0	1	18	0	0
19	34563588	.	T	C	12	4	16	0	0	16	0	0
19	34595032	.	C	T	5	5	10	0	0	10	0	0
19	34602472	.	G	A	7	2	9	0	2	11	0	0
19	34691678	.	T	C	1	0	1	0	3	4	0	0
19	34696829	.	T	A	1	6	7	0	2	9	0	0
19	34696921	.	C	T	7	9	16	0	1	17	0	0
19	34698294	.	G	A	4	2	6	0	0	6	0	0
19	34698321	.	A	T	2	3	5	0	2	7	0	0
19	34716569	.	C	T	0	2	2	0	1	3	0	0
19	34720217	.	G	A	3	2	5	0	0	5	0	0
19	34738118	.	T	C	3	2	5	0	0	5	0	0
19	34741437	.	T	G	3	2	5	0	0	5	0	0
19	34742382	.	C	T	1	2	3	0	0	3	0	0
19	34742818	.	C	T	2	3	5	0	1	6	0	0
19	34744060	.	T	G	5	3	8	0	0	8	0	0
19	34744231	.	T	C	7	7	14	0	1	15	0	0
19	34744288	.	C	A	4	5	9	0	0	9	0	0
19	34746659	.	G	A	8	4	12	0	0	12	0	0
19	34746810	.	T	G	2	3	5	0	1	6	0	0
19	34746826	.	G	A	1	3	4	0	0	4	0	0
19	34753645	.	G	A	1	4	5	0	0	5	0	0
19	34753669	.	G	C	1	0	1	0	4	5	0	0
19	34760060	.	G	A	1	5	6	0	0	6	0	0
19	34760083	.	A	G	1	3	4	0	0	4	0	0
19	34760340	.	G	A	1	4	5	0	0	5	0	0
19	34960099	.	A	G	7	4	11	0	1	12	0	0
19	34960190	.	C	G	2	12	14	0	17	31	0	0
19	34960198	.	T	C	20	11	31	0	1	32	0	0
19	34960315	.	T	A	3	6	9	0	1	10	0	0
19	34960574	.	A	G	1	1	2	0	0	2	0	0
19	34960694	.	T	A	4	5	9	0	0	9	0	0
19	34961152	.	C	T	5	6	11	0	2	13	0	0
19	34961269	.	A	G	3	5	8	0	0	8	0	0
19	35002450	.	G	A	9	8	17	0	0	17	0	0
19	35002714	.	A	C	5	7	12	0	0	12	0	0
19	35002723	.	T	C	4	7	11	0	1	12	0	0
19	35004117	.	A	C	13	6	19	0	1	20	0	0
19	35004135	.	C	T	12	4	16	0	0	16	0	0
19	35004868	.	C	A	3	3	6	0	0	6	0	0
19	35004869	.	C	A	3	3	6	0	0	6	0	0
19	35004920	.	G	A	5	6	11	0	0	11	0	0
19	35004941	.	T	C	6	7	13	0	0	13	0	0
19	35005136	.	A	C	6	5	11	0	0	11	0	0
19	35005137	.	A	T	6	5	11	0	0	11	0	0
19	35005318	.	G	A	10	13	23	0	8	31	0	0
19	35007220	.	G	A	11	15	26	1	0	27	0	0
19	35007235	.	G	A	12	11	23	1	0	24	0	0
19	35013806	.	C	T	27	19	46	0	2	48	0	0
19	35016553	.	T	G	19	15	34	0	3	37	0	0
19	35016646	.	A	T	20	15	35	0	7	42	0	0
19	35016696	.	T	G	19	11	30	0	0	30	0	0
19	35016835	.	C	T	18	10	28	0	0	28	0	0
19	35016962	.	T	A	7	4	11	0	1	12	0	0
19	35019351	.	T	C	1	2	3	0	0	3	0	0
19	35019560	.	A	G	4	5	9	0	0	9	0	0
19	35040003	.	G	T	3	3	6	0	1	7	0	0
19	35041158	.	T	A	25	20	45	0	8	53	0	0
19	35041308	.	A	G	27	26	53	0	2	56	1	0
19	35041458	.	T	C	28	0	28	1	25	54	0	0
19	35052411	.	G	T	18	14	32	0	1	33	0	0
19	35052435	.	T	C	21	0	21	0	14	35	0	0
19	35055889	.	A	G	9	14	23	3	1	27	0	0
19	35057860	.	G	T	19	12	31	0	0	31	0	0
19	35057869	.	C	T	13	17	30	0	0	30	0	0
19	35058232	.	T	C	24	10	34	0	1	35	0	0
19	35060217	.	A	C	11	14	25	0	0	25	0	0
19	35065906	.	A	T	11	10	21	0	1	22	0	0
19	35067367	.	G	A	11	6	17	0	1	18	0	0
19	35069299	.	G	T	8	16	24	0	0	24	0	0
19	35069755	.	C	A	19	14	33	0	0	33	0	0
19	35069934	.	T	G	11	8	19	0	2	22	1	0
19	35070015	.	C	T	6	14	20	0	1	21	0	0
19	35072613	.	A	C	10	15	25	0	4	29	0	0
19	35072712	.	G	C	14	0	14	0	10	24	0	0
19	35075637	.	C	T	1	9	10	0	11	21	0	0
19	35076773	.	G	A	9	7	16	0	0	16	0	0
19	35078584	.	T	C	7	0	7	0	13	20	0	0
19	35078632	.	T	C	13	0	13	0	7	20	0	0
19	35079259	.	C	T	8	6	14	0	0	14	0	0
19	35079515	.	A	T	2	8	10	0	0	10	0	0
19	35083010	.	G	A	11	9	20	0	1	21	0	0
19	35083019	.	C	T	14	6	20	0	0	20	0	0
19	35083182	.	C	T	11	7	18	0	0	18	0	0
19	35116228	.	A	G	12	5	17	0	1	18	0	0
19	35116297	.	T	C	5	6	11	0	1	12	0	0
19	35116405	.	A	G	9	7	16	0	0	16	0	0
19	35116438	.	G	A	6	9	15	0	0	15	0	0
19	35118813	.	G	C	4	2	6	0	0	6	0	0
19	35118842	.	T	C	4	2	6	0	1	7	0	0
19	35118860	.	G	T	3	4	7	0	1	8	0	0
19	35118911	.	C	A	7	6	13	0	0	13	0	0
19	35118983	.	A	T	4	2	6	0	0	6	0	0
19	35119039	.	T	C	7	6	13	0	0	13	0	0
19	35119052	.	A	G	7	8	15	0	1	16	0	0
19	35119082	.	T	C	6	0	6	0	6	12	0	0
19	35119169	.	G	A	6	5	11	0	1	12	0	0
19	35119205	.	G	A	6	6	12	0	1	13	0	0
19	35119436	.	C	T	7	10	17	0	0	17	0	0
19	35121381	.	T	C	10	4	14	0	0	14	0	0
19	35121459	.	T	C	5	4	9	0	0	9	0	0
19	35122875	.	G	A	4	3	7	0	0	7	0	0
19	35122876	.	C	A	5	3	8	0	0	8	0	0
19	35123452	.	A	T	11	4	15	0	0	15	0	0
19	35123508	.	T	C	4	0	4	0	4	8	0	0
19	35131332	.	G	A	3	5	8	0	0	8	0	0
19	35135600	.	A	G	4	4	8	0	0	8	0	0
19	35135626	.	T	G	3	3	6	0	1	7	0	0
19	35135711	.	A	G	1	4	5	0	0	5	0	0
19	35135870	.	C	T	1	3	4	0	0	4	0	0
19	35135883	.	A	G	1	2	3	0	0	3	0	0
19	35135927	.	T	G	2	2	4	0	0	4	0	0
19	35135961	.	A	G	3	4	7	0	1	8	0	0
19	35138260	.	A	G	3	2	5	0	1	6	0	0
19	35155676	.	C	T	4	2	6	0	0	6	0	0
19	35157621	.	C	T	1	1	2	0	1	3	0	0
19	35159665	.	G	T	1	2	3	0	1	4	0	0
19	35159668	.	G	A	1	1	2	0	1	3	0	0
19	35159721	.	A	G	3	5	8	0	0	8	0	0
19	35165047	.	T	C	2	0	2	1	5	8	0	0
19	35167217	.	G	C	3	5	8	0	0	8	0	0
19	35170263	.	T	G	2	4	6	1	0	7	0	0
19	35175205	.	A	G	2	3	5	0	0	5	0	0
19	35359341	.	C	T	33	28	61	0	2	63	0	0
19	35379917	.	A	G	5	4	9	0	2	11	0	0
19	35379923	.	G	A	6	5	11	0	1	12	0	0
19	35379998	.	A	G	2	5	7	0	1	8	0	0
19	35380031	.	G	A	1	4	5	0	0	5	0	0
19	35380070	.	G	A	1	8	9	0	0	9	0	0
19	35380168	.	T	C	4	0	4	0	4	8	0	0
19	35381625	.	T	A	1	4	5	0	0	5	0	0
19	35386288	.	T	G	5	5	10	0	0	10	0	0
19	35419026	.	C	T	0	2	2	0	2	4	0	0
19	35419202	.	A	G	3	4	7	0	0	7	0	0
19	35419215	.	T	A	4	4	8	0	0	8	0	0
19	35419300	.	A	T	1	2	3	0	0	3	0	0
19	35422354	.	T	C	13	14	27	0	0	27	0	0
19	35428735	.	G	A	10	12	22	0	0	22	0	0
19	35459414	.	A	G	18	16	34	0	3	37	0	0
19	35459737	.	G	A	23	25	48	0	1	49	0	0
19	35459801	.	A	T	24	19	43	0	1	45	1	0
19	35473080	.	C	A	3	16	19	0	14	33	0	0
19	36115044	.	G	A	7	6	13	0	0	13	0	0
19	36115210	.	G	A	10	9	19	0	1	20	0	0
19	36120265	.	C	T	1	6	7	0	6	13	0	0
19	36122534	.	C	T	9	5	14	0	0	14	0	0
19	36131818	.	G	A	1	4	5	0	0	5	0	0
19	36141868	.	G	A	10	4	14	0	0	14	0	0
19	36167704	.	A	G	3	2	5	0	0	5	0	0
19	36169872	.	A	G	6	5	11	0	0	11	0	0
19	36191405	.	C	T	4	2	6	0	0	6	0	0
19	36212370	.	G	A	1	2	3	0	0	3	0	0
19	36277799	.	G	A	3	3	6	0	0	6	0	0
19	36290669	.	C	T	0	2	2	0	1	3	0	0
19	36290771	.	T	G	1	1	2	0	1	3	0	0
19	36350821	.	G	A	1	2	3	0	0	3	0	0
19	36351155	.	A	G	1	2	3	0	0	3	0	0
19	36378380	.	C	T	1	3	4	0	0	4	0	0
19	36378464	.	A	T	1	3	4	0	0	4	0	0
19	36409112	.	C	T	2	3	5	0	0	5	0	0
19	37133533	.	C	A	8	6	14	0	0	14	0	0
19	37133762	.	C	T	8	3	11	0	0	11	0	0
19	37133825	.	G	A	3	4	7	0	0	7	0	0
19	37133936	.	T	G	1	3	4	0	0	4	0	0
19	37135759	.	G	A	5	4	9	0	0	9	0	0
19	37138388	.	G	A	1	13	14	0	14	28	0	0
19	37138643	.	G	A	0	11	11	0	13	24	0	0
19	37138955	.	A	G	13	10	23	0	1	24	0	0
19	37481628	.	C	A	3	2	5	0	0	5	0	0
19	37481658	.	C	T	4	4	8	0	0	8	0	0
19	37484508	.	A	C	5	2	7	0	0	7	0	0
19	37488593	.	C	T	4	2	6	0	0	6	0	0
19	37488830	.	C	T	3	4	7	0	0	7	0	0
19	37491605	.	C	A	3	2	5	0	0	5	0	0
19	37491689	.	G	A	2	3	5	0	0	5	0	0
19	37492351	.	G	A	4	3	7	0	0	7	0	0
19	37501935	.	A	G	17	24	41	0	2	43	0	0
19	37502105	.	A	G	31	20	51	0	6	57	0	0
19	37505808	.	G	A	16	18	34	0	0	34	0	0
19	37711097	.	C	A	3	2	5	0	0	5	0	0
19	37775889	.	C	T	2	2	4	0	0	4	0	0
19	37802904	.	A	G	2	0	2	0	2	4	0	0
19	37802966	.	C	T	6	3	9	0	0	9	0	0
19	37802971	.	A	T	6	2	8	0	0	8	0	0
19	37804452	.	G	A	0	6	6	0	3	9	0	0
19	37804477	.	G	A	0	3	3	0	4	7	0	0
19	37804647	.	C	T	4	3	7	0	0	7	0	0
19	37815763	.	G	A	3	4	7	0	0	7	0	0
19	37835322	.	G	A	3	3	6	0	0	6	0	0
19	37835367	.	G	A	2	7	9	0	0	9	0	0
19	37835433	.	A	C	3	3	6	0	0	6	0	0
19	37858144	.	G	C	8	14	22	0	0	22	0	0
19	37926003	.	C	T	22	14	36	0	1	37	0	0
19	37926066	.	C	A	26	13	39	0	0	39	0	0
19	37926653	.	A	T	1	11	12	0	3	15	0	0
19	37926666	.	C	A	4	16	20	0	2	22	0	0
19	37926816	.	T	G	31	14	45	0	0	45	0	0
19	37926865	.	G	A	28	14	42	0	1	43	0	0
19	37927304	.	G	T	1	20	21	0	14	35	0	0
19	38171067	.	G	A	10	4	14	0	0	14	0	0
19	38175399	.	C	T	3	5	8	0	0	8	0	0
19	38175515	.	G	C	3	4	7	2	0	9	0	0
19	38216247	.	A	G	9	4	13	0	0	13	0	0
19	38227086	.	T	G	9	6	15	1	0	16	0	0
19	38240541	.	A	G	6	0	6	0	6	12	0	0
19	38240844	.	C	T	3	2	5	0	0	5	0	0
19	38473901	.	G	T	4	3	7	0	0	7	0	0
19	38805570	.	G	A	3	6	9	0	0	9	0	0
19	40026661	.	T	C	16	17	33	0	1	34	0	0
19	40031002	.	G	A	27	33	60	0	2	62	0	0
19	40039603	.	G	A	4	7	11	0	1	12	0	0
19	40039606	.	T	A	5	7	12	0	0	12	0	0
19	40053055	.	A	G	12	1	13	0	34	47	0	0
19	40053061	.	A	T	13	35	48	0	2	50	0	0
19	40055030	.	A	G	21	26	47	0	1	48	0	0
19	40055305	.	A	G	19	1	20	0	5	25	0	0
19	40055318	.	A	G	18	7	25	0	2	27	0	0
19	40071539	.	T	G	1	2	3	0	0	3	0	0
19	40071541	.	G	A	1	2	3	0	0	3	0	0
19	40083731	.	C	T	3	3	6	0	1	7	0	0
19	40085806	.	T	C	1	2	3	0	0	3	0	0
19	40096548	.	G	A	1	2	3	0	1	4	0	0
19	40099361	.	C	T	4	2	6	0	0	6	0	0
19	40102040	.	A	C	6	3	9	0	0	9	0	0
19	40110840	.	G	A	1	5	6	0	8	14	0	0
19	40113305	.	G	A	0	5	5	0	12	17	0	0
19	40113425	.	C	A	7	6	13	0	1	14	0	0
19	40113549	.	T	G	6	4	10	0	1	11	0	0
19	40113677	.	C	G	5	7	12	0	0	12	0	0
19	40113692	.	G	T	5	8	13	0	0	13	0	0
19	40122651	.	A	C	1	2	3	0	0	3	0	0
19	40129299	.	C	T	4	3	7	0	0	7	0	0
19	40129387	.	A	T	5	6	11	0	1	12	0	0
19	40137070	.	T	C	1	1	2	0	1	3	0	0
19	40145423	.	C	T	5	3	8	0	0	8	0	0
19	40145504	.	T	C	4	3	7	0	0	7	0	0
19	40145888	.	G	A	2	3	5	0	0	5	0	0
19	40147821	.	G	A	1	7	8	0	3	11	0	0
19	40149006	.	A	C	4	5	9	0	0	9	0	0
19	40151970	.	G	A	17	10	27	0	0	27	0	0
19	40151983	.	C	T	15	9	24	0	0	24	0	0
19	40152569	.	G	A	15	6	21	0	0	21	0	0
19	40155144	.	C	A	9	9	18	0	2	21	1	0
19	40156870	.	T	C	13	8	21	0	1	22	0	0
19	40160049	.	T	C	9	12	21	0	2	23	0	0
19	40162945	.	C	A	15	12	27	0	1	28	0	0
19	40163256	.	C	T	16	11	27	0	1	28	0	0
19	40165405	.	A	G	16	14	30	0	3	33	0	0
19	40165681	.	A	G	3	0	3	0	5	8	0	0
19	40177406	.	G	T	2	3	5	0	3	8	0	0
19	40177762	.	T	C	6	6	12	0	0	12	0	0
19	40179641	.	C	A	5	8	13	0	1	14	0	0
19	40179763	.	G	A	1	4	5	0	6	11	0	0
19	40179858	.	C	A	8	6	14	0	0	14	0	0
19	40180011	.	C	T	5	6	11	0	1	12	0	0
19	40180100	.	A	G	3	4	7	0	0	7	0	0
19	40182571	.	T	A	2	2	4	0	0	4	0	0
19	40182574	.	C	T	2	1	3	0	1	4	0	0
19	40326972	.	T	C	3	2	5	0	0	5	0	0
19	40340319	.	A	G	15	11	26	0	0	26	0	0
19	40344730	.	A	C	17	17	34	0	1	35	0	0
19	40345966	.	G	T	26	16	42	0	2	44	0	0
19	40347600	.	T	G	17	0	17	0	16	33	0	0
19	40347702	.	T	A	23	20	43	0	4	48	1	0
19	40347760	.	T	A	17	15	32	0	0	32	0	0
19	40347785	.	A	T	19	12	31	0	0	31	0	0
19	40347842	.	G	T	0	9	9	0	3	12	0	0
19	40641439	.	C	T	1	2	3	0	0	3	0	0
19	40641448	.	G	C	1	2	3	0	0	3	0	0
19	40685448	.	C	T	10	3	13	0	1	14	0	0
19	40685520	.	T	C	11	6	17	0	0	17	0	0
19	40685935	.	A	G	4	2	6	0	0	6	0	0
19	40686133	.	C	G	1	2	3	0	0	3	0	0
19	40717137	.	G	A	3	9	12	0	1	13	0	0
19	40717216	.	C	T	1	6	7	0	0	7	0	0
19	40717309	.	G	A	4	3	7	0	0	7	0	0
19	40717649	.	C	A	5	7	12	0	0	12	0	0
19	40861956	.	A	G	1	5	6	0	0	6	0	0
19	40892215	.	G	A	3	2	5	0	0	5	0	0
19	40895829	.	C	T	8	7	15	0	0	15	0	0
19	40898468	.	C	T	4	2	6	0	0	6	0	0
19	40900205	.	T	C	6	0	6	0	14	20	0	0
19	40900283	.	G	T	6	5	11	0	1	12	0	0
19	40906094	.	G	A	19	8	27	0	1	28	0	0
19	40999967	.	A	G	2	2	4	0	0	4	0	0
19	41031941	.	G	A	3	15	18	0	15	33	0	0
19	41033898	.	C	T	16	14	30	0	1	31	0	0
19	41033929	.	C	A	11	11	22	0	2	24	0	0
19	41034183	.	A	G	10	1	11	2	11	24	0	0
19	41038728	.	T	A	1	5	6	0	0	6	0	0
19	41038855	.	C	T	31	12	43	0	1	44	0	0
19	41038942	.	C	A	25	22	47	0	2	49	0	0
19	41038961	.	A	C	23	25	48	0	0	48	0	0
19	41039012	.	G	C	14	0	14	0	24	39	1	0
19	41052229	.	G	A	25	21	46	0	3	49	0	0
19	41052274	.	G	A	21	23	44	0	3	47	0	0
19	41060384	.	C	T	3	18	21	0	16	37	0	0
19	41060856	.	A	G	15	13	28	0	2	30	0	0
19	41069442	.	G	A	18	15	33	0	2	35	0	0
19	41069564	.	G	C	14	5	19	0	1	20	0	0
19	41141941	.	C	T	5	3	8	0	0	8	0	0
19	41156254	.	G	A	0	4	4	0	3	7	0	0
19	41160885	.	G	A	0	4	4	0	1	5	0	0
19	42573957	.	T	C	2	0	2	0	4	6	0	0
19	42843595	.	A	G	9	6	15	0	0	15	0	0
19	42843596	.	A	G	10	4	14	0	1	15	0	0
19	42843640	.	A	G	9	0	9	0	8	17	0	0
19	42843894	.	A	G	15	13	28	0	0	28	0	0
19	42997263	.	G	A	0	16	16	0	0	16	0	0
19	43272257	.	T	C	2	4	6	0	0	6	0	0
19	43272295	.	G	A	2	5	7	0	0	7	0	0
19	43900100	.	A	G	13	4	17	0	1	18	0	0
19	43900143	.	A	C	6	7	13	0	2	15	0	0
19	43900144	.	T	C	9	6	15	0	0	15	0	0
19	43901062	.	A	G	2	7	9	0	2	11	0	0
19	43901310	.	A	G	18	6	24	0	6	30	0	0
19	45856295	.	A	G	17	7	24	0	2	26	0	0
19	45856414	.	A	G	16	20	36	0	1	37	0	0
19	45859824	.	C	T	23	16	39	1	5	46	1	0
19	45868237	.	A	C	23	24	47	0	1	48	0	0
19	45883626	.	C	A	10	17	27	0	0	27	0	0
19	45962080	.	T	G	2	3	5	0	0	5	0	0
19	45962161	.	A	C	2	5	7	0	0	7	0	0
19	45962171	.	A	G	1	5	6	0	1	7	0	0
19	45965617	.	A	G	6	0	6	0	5	11	0	0
19	45967297	.	C	G	5	0	5	0	8	13	0	0
19	45967306	.	A	T	8	6	14	0	0	14	0	0
19	45979613	.	C	G	2	2	4	0	0	4	0	0
19	45980233	.	C	A	1	2	3	0	0	3	0	0
19	45997919	.	T	A	3	3	6	0	0	6	0	0
19	45997964	.	A	G	3	5	8	0	0	8	0	0
19	46006201	.	T	C	2	0	2	0	2	4	0	0
19	46006240	.	G	A	6	2	8	0	0	8	0	0
19	46006339	.	C	T	0	2	2	0	1	3	0	0
19	46007583	.	A	T	1	3	4	0	0	4	0	0
19	46010406	.	C	G	2	4	6	0	0	6	0	0
19	46019603	.	G	A	6	7	13	0	1	14	0	0
19	46019616	.	G	T	4	4	8	0	5	13	0	0
19	46019803	.	A	G	14	15	29	0	5	34	0	0
19	46020052	.	C	A	3	2	5	0	0	5	0	0
19	46020228	.	G	A	9	15	24	0	1	25	0	0
19	46020453	.	C	A	16	11	27	0	0	27	0	0
19	46020471	.	G	T	16	11	27	0	2	29	0	0
19	46022418	.	A	G	10	12	22	0	0	22	0	0
19	46022453	.	C	T	0	7	7	0	9	16	0	0
19	46032475	.	A	G	5	7	12	0	0	12	0	0
19	46032485	.	G	T	5	7	12	0	0	12	0	0
19	46032527	.	G	T	3	7	10	0	0	10	0	0
19	46032947	.	A	G	1	3	4	0	1	5	0	0
19	46035300	.	C	A	4	3	7	0	1	8	0	0
19	46035756	.	T	C	3	0	3	0	2	5	0	0
19	46036290	.	G	A	3	4	7	0	0	7	0	0
19	46036414	.	C	T	5	5	10	0	2	12	0	0
19	46047196	.	A	C	1	0	1	0	4	5	0	0
19	46047223	.	T	A	1	3	4	0	0	4	0	0
19	46049173	.	G	A	2	2	4	0	1	5	0	0
19	46050782	.	A	C	3	3	6	0	0	6	0	0
19	46224575	.	G	A	12	8	20	0	2	22	0	0
19	46225960	.	C	T	14	12	26	0	1	27	0	0
19	47976325	.	C	T	28	25	53	0	0	53	0	0
2	19225	.	T	C	32	28	60	0	1	61	0	0
2	19568	.	G	A	33	19	52	0	4	56	0	0
2	21074	.	A	G	27	36	63	0	1	64	0	0
2	21479	.	C	T	2	25	27	0	31	58	0	0
2	68899	.	A	G	2	3	5	0	1	6	0	0
2	71743	.	A	G	5	4	9	0	0	9	0	0
2	98451	.	A	G	1	2	3	0	0	3	0	0
2	100981	.	T	C	1	0	1	0	3	4	0	0
2	108000	.	C	T	10	14	24	0	0	24	0	0
2	108586	.	G	A	0	15	15	0	10	25	0	0
2	109030	.	G	A	13	9	22	0	2	24	0	0
2	109284	.	T	C	2	2	4	0	1	5	0	0
2	112990	.	C	T	2	2	4	0	0	4	0	0
2	113582	.	T	C	2	2	4	0	0	4	0	0
2	136352	.	C	T	7	4	11	0	0	11	0	0
2	136368	.	C	T	6	3	9	0	0	9	0	0
2	136409	.	T	G	3	3	6	0	0	6	0	0
2	136479	.	A	G	5	7	12	0	1	13	0	0
2	137169	.	T	C	5	8	13	0	0	13	0	0
2	138603	.	G	A	4	7	11	0	0	11	0	0
2	138785	.	A	G	9	3	12	0	0	12	0	0
2	141926	.	G	A	6	6	12	0	0	12	0	0
2	177241	.	G	T	16	5	21	2	3	26	0	0
2	177243	.	G	C	19	6	25	2	0	27	0	0
2	281634	.	A	G	3	4	7	0	1	8	0	0
2	1213071	.	C	T	2	3	5	0	0	5	0	0
2	1213640	.	C	T	3	4	7	0	0	7	0	0
2	1215156	.	G	A	0	4	4	0	1	5	0	0
2	1215160	.	A	G	1	4	5	0	0	5	0	0
2	1220802	.	T	C	20	12	32	0	1	33	0	0
2	1537251	.	C	T	3	2	5	0	0	5	0	0
2	1595275	.	T	C	6	13	19	1	1	21	0	0
2	1595283	.	T	C	16	5	21	1	0	22	0	0
2	1596159	.	C	T	0	9	9	0	2	11	0	0
2	1597617	.	T	C	2	6	8	0	0	8	0	0
2	2069832	.	T	C	1	2	3	0	0	3	0	0
2	2819458	.	C	T	6	2	8	0	0	8	0	0
2	2988441	.	T	A	6	3	9	0	0	9	0	0
2	3027065	.	T	A	3	3	6	0	0	6	0	0
2	3027066	.	A	T	3	3	6	0	0	6	0	0
2	3028893	.	A	G	11	8	19	0	0	19	0	0
2	3028908	.	A	T	6	8	14	0	1	15	0	0
2	3065176	.	T	C	3	2	5	0	0	5	0	0
2	3401100	.	A	C	7	8	15	0	0	15	0	0
2	4045400	.	T	C	12	4	16	0	2	18	0	0
2	4045715	.	T	C	10	5	15	0	0	15	0	0
2	4045720	.	T	C	1	12	13	0	1	14	0	0
2	4900650	.	T	C	38	10	48	0	1	49	0	0
2	4901172	.	T	C	15	0	15	0	10	25	0	0
2	4901197	.	T	C	18	6	24	0	1	25	0	0
2	5544025	.	C	G	5	3	8	0	0	8	0	0
2	5546933	.	T	C	9	4	13	0	0	13	0	0
2	5552875	.	C	T	4	4	8	0	0	8	0	0
2	5554753	.	G	T	2	5	7	0	2	9	0	0
2	5555349	.	C	A	1	3	4	1	0	5	0	0
2	5555407	.	C	G	5	2	7	0	0	7	0	0
2	5560823	.	A	G	1	4	5	0	0	5	0	0
2	5577647	.	A	G	4	0	4	0	8	12	0	0
2	5578745	.	C	T	6	6	12	0	1	13	0	0
2	5578772	.	C	T	8	5	13	0	0	13	0	0
2	5578820	.	T	A	7	9	16	0	1	17	0	0
2	5578872	.	A	G	6	1	7	0	4	11	0	0
2	5578936	.	A	T	4	4	8	0	0	8	0	0
2	5579111	.	A	G	2	2	4	0	1	5	0	0
2	5579120	.	G	A	0	3	3	0	3	6	0	0
2	5579246	.	A	G	8	6	14	0	0	14	0	0
2	5579276	.	T	C	8	4	12	0	0	12	0	0
2	5579285	.	T	A	6	3	9	0	1	10	0	0
2	5579320	.	T	A	4	2	6	0	0	6	0	0
2	5579325	.	T	C	4	1	5	0	0	5	0	0
2	5579415	.	G	A	4	6	10	2	0	12	0	0
2	5579721	.	G	A	2	3	5	0	1	6	0	0
2	5579958	.	A	G	12	0	12	0	4	16	0	0
2	5580140	.	G	A	2	6	8	0	0	8	0	0
2	5580249	.	A	G	4	7	11	0	0	11	0	0
2	5580267	.	T	G	3	6	9	0	1	10	0	0
2	5580439	.	T	C	11	9	20	0	0	20	0	0
2	5580510	.	C	T	6	10	16	0	0	16	0	0
2	5580544	.	A	G	7	8	15	0	2	17	0	0
2	5580592	.	C	T	11	8	19	0	0	19	0	0
2	5580644	.	A	G	10	0	10	2	9	21	0	0
2	5580887	.	G	T	3	10	13	3	0	16	0	0
2	5581063	.	G	A	2	4	6	0	7	13	0	0
2	5581073	.	A	G	9	4	13	0	0	13	0	0
2	5581233	.	C	T	7	17	24	0	0	24	0	0
2	5581234	.	G	T	2	15	17	0	8	25	0	0
2	5581482	.	T	A	10	9	19	0	0	19	0	0
2	5581612	.	A	G	8	4	12	1	2	15	0	0
2	5581660	.	T	A	7	9	16	1	0	17	0	0
2	5601282	.	A	T	6	4	10	0	0	10	0	0
2	5621176	.	A	T	10	6	16	0	0	16	0	0
2	5621360	.	C	T	8	9	17	0	1	19	1	0
2	5621394	.	A	C	9	12	21	0	2	23	0	0
2	5644548	.	C	T	17	8	25	0	0	25	0	0
2	5677650	.	C	T	17	17	34	0	1	35	0	0
2	5681049	.	A	C	22	17	39	0	2	41	0	0
2	5681326	.	T	A	14	17	31	0	4	35	0	0
2	5681388	.	T	G	14	2	16	0	14	30	0	0
2	5681446	.	T	C	16	15	31	0	0	31	0	0
2	5709579	.	T	C	7	0	7	1	4	12	0	0
2	5709663	.	C	G	10	10	20	0	2	22	0	0
2	5709670	.	T	A	11	12	23	0	2	25	0	0
2	5709782	.	C	T	12	3	15	0	0	15	0	0
2	5709843	.	C	A	12	13	25	0	1	26	0	0
2	5709850	.	T	G	15	15	30	0	0	30	0	0
2	5711684	.	C	A	16	16	32	0	1	33	0	0
2	5714194	.	A	G	10	11	21	0	0	21	0	0
2	5714303	.	G	T	17	19	36	0	0	37	1	0
2	5714789	.	C	T	13	13	26	0	0	26	0	0
2	5714813	.	C	T	1	10	11	0	10	21	0	0
2	5716793	.	T	C	10	13	23	0	1	24	0	0
2	5721008	.	C	T	2	9	11	0	12	23	0	0
2	5723497	.	A	G	8	10	18	0	0	18	0	0
2	5723515	.	A	G	8	11	19	0	0	19	0	0
2	5734952	.	T	C	3	5	8	0	1	9	0	0
2	5735134	.	C	T	0	7	7	0	13	20	0	0
2	5735271	.	G	A	7	3	10	0	0	10	0	0
2	5736405	.	G	A	5	6	11	0	0	11	0	0
2	5740418	.	T	A	3	5	8	0	0	8	0	0
2	5740678	.	T	C	8	4	12	0	0	12	0	0
2	5740709	.	A	G	4	6	10	0	0	10	0	0
2	5741110	.	C	G	4	6	10	0	1	11	0	0
2	5741305	.	C	G	4	4	8	0	0	8	0	0
2	5741391	.	A	G	5	7	12	0	0	12	0	0
2	5741400	.	G	C	5	5	10	0	0	10	0	0
2	5741631	.	A	G	5	4	9	0	1	10	0	0
2	5749293	.	C	T	0	3	3	0	3	6	0	0
2	5749335	.	A	G	5	4	9	0	0	9	0	0
2	5749641	.	C	T	0	7	7	0	5	12	0	0
2	5749893	.	G	A	6	4	10	0	0	10	0	0
2	5750019	.	C	T	2	3	5	0	0	5	0	0
2	5758114	.	C	A	1	4	5	0	0	5	0	0
2	5758126	.	G	T	2	4	6	0	0	6	0	0
2	5758168	.	T	A	0	4	4	0	2	6	0	0
2	5758171	.	G	A	1	4	5	0	0	5	0	0
2	5768003	.	C	G	4	2	6	0	0	6	0	0
2	5768011	.	G	A	3	1	4	0	0	4	0	0
2	5775852	.	C	G	4	2	6	0	0	6	0	0
2	5775963	.	C	A	1	4	5	0	0	5	0	0
2	5809907	.	C	A	1	2	3	0	0	3	0	0
2	5811620	.	A	C	3	2	5	0	0	5	0	0
2	5812007	.	G	A	1	5	6	1	0	7	0	0
2	5812046	.	A	G	3	6	9	0	0	9	0	0
2	5813313	.	C	T	0	5	5	0	1	6	0	0
2	5813904	.	G	T	3	3	6	0	0	6	0	0
2	5814004	.	C	T	3	2	5	0	0	5	0	0
2	5814029	.	T	A	3	4	7	0	0	7	0	0
2	5817327	.	T	G	4	5	9	0	0	9	0	0
2	5843880	.	A	T	2	3	5	0	0	5	0	0
2	5843885	.	G	A	3	2	5	0	0	5	0	0
2	5843941	.	G	T	5	2	7	0	0	7	0	0
2	5843996	.	C	T	2	2	4	0	0	4	0	0
2	5844126	.	A	T	2	4	6	0	0	6	0	0
2	5844206	.	G	A	0	2	2	0	3	5	0	0
2	5844235	.	A	G	1	3	4	0	0	4	0	0
2	5856206	.	T	C	1	3	4	0	1	5	0	0
2	5859607	.	G	A	1	3	4	0	0	4	0	0
2	5872652	.	C	T	4	7	11	0	0	11	0	0
2	5873674	.	T	C	5	6	11	0	0	11	0	0
2	5880396	.	G	A	8	6	14	0	1	15	0	0
2	5880435	.	T	C	10	5	15	0	2	17	0	0
2	5882441	.	A	G	8	0	8	0	5	13	0	0
2	5882527	.	C	T	6	4	10	0	0	10	0	0
2	5882665	.	C	T	4	2	6	0	0	6	0	0
2	5882726	.	T	C	4	7	11	0	2	13	0	0
2	5883127	.	A	G	18	5	23	0	0	23	0	0
2	5883558	.	A	T	4	4	8	0	0	8	0	0
2	5884127	.	A	C	7	6	13	0	0	13	0	0
2	5884322	.	C	T	5	16	21	0	0	21	0	0
2	5887811	.	G	T	2	2	4	0	0	4	0	0
2	5887812	.	T	A	2	2	4	0	0	4	0	0
2	5887849	.	C	G	2	3	5	0	0	5	0	0
2	5887867	.	T	A	4	1	5	0	0	5	0	0
2	5901471	.	C	T	2	3	5	0	0	5	0	0
2	5910120	.	C	G	8	0	8	0	7	15	0	0
2	5912062	.	A	G	2	5	7	0	0	7	0	0
2	5912257	.	G	A	2	4	6	0	0	6	0	0
2	5912288	.	C	G	3	0	3	0	6	9	0	0
2	5921661	.	C	T	6	4	10	0	1	11	0	0
2	5923178	.	G	C	1	5	6	0	11	17	0	0
2	5923517	.	G	C	9	8	17	0	0	17	0	0
2	5923640	.	A	T	6	4	10	0	0	10	0	0
2	5923645	.	C	T	6	4	10	0	0	10	0	0
2	5924085	.	A	T	4	3	7	0	0	7	0	0
2	5924170	.	T	A	2	4	6	0	0	6	0	0
2	5929917	.	C	T	1	3	4	0	0	4	0	0
2	5933999	.	C	A	1	4	5	0	12	17	0	0
2	5934000	.	G	A	13	4	17	0	0	17	0	0
2	5934076	.	T	A	9	6	15	1	0	16	0	0
2	5934256	.	A	T	3	10	13	0	0	13	0	0
2	5934781	.	G	A	10	9	19	0	1	20	0	0
2	5934806	.	C	T	10	13	23	0	2	25	0	0
2	5934828	.	A	T	12	17	29	0	2	32	1	0
2	5934920	.	G	C	7	16	23	0	0	23	0	0
2	5935097	.	A	G	6	5	11	0	0	11	0	0
2	5936303	.	A	G	5	3	8	0	1	9	0	0
2	5936377	.	G	A	4	3	7	0	0	7	0	0
2	5936380	.	C	T	4	3	7	0	0	7	0	0
2	5936465	.	G	T	4	3	7	0	0	7	0	0
2	5936476	.	G	C	4	2	6	0	1	7	0	0
2	5936751	.	T	G	5	5	10	0	0	10	0	0
2	5937051	.	C	T	1	3	4	0	0	4	0	0
2	5942155	.	C	T	3	3	6	0	0	6	0	0
2	6790185	.	C	T	1	5	6	0	0	6	0	0
2	6952707	.	A	G	3	4	7	0	0	7	0	0
2	7423098	.	T	C	2	3	5	0	0	5	0	0
2	7764894	.	C	T	2	15	17	0	13	30	0	0
2	7764983	.	T	C	14	0	14	0	10	24	0	0
2	7765145	.	A	G	3	4	7	0	0	7	0	0
2	7765308	.	A	T	3	2	5	0	0	5	0	0
2	7765613	.	C	T	10	10	20	0	0	20	0	0
2	7765685	.	A	G	11	8	19	0	0	19	0	0
2	7765821	.	A	G	2	3	5	0	1	6	0	0
2	7766698	.	G	A	1	2	3	2	0	5	0	0
2	7766819	.	G	C	1	0	1	0	6	7	0	0
2	7766820	.	C	G	1	6	7	0	0	7	0	0
2	7767336	.	T	A	3	3	6	0	0	6	0	0
2	7767496	.	C	A	0	3	3	0	4	7	0	0
2	7767501	.	T	A	4	3	7	0	0	7	0	0
2	7768114	.	G	T	2	4	6	0	1	7	0	0
2	7768293	.	G	A	1	2	3	0	1	4	0	0
2	7768295	.	A	G	1	2	3	0	1	4	0	0
2	7768648	.	G	T	5	4	9	0	0	9	0	0
2	7923987	.	T	C	1	2	3	0	0	3	0	0
2	7924183	.	A	T	15	14	29	0	1	30	0	0
2	7924713	.	T	C	22	20	42	0	1	43	0	0
2	7924867	.	G	A	25	22	47	0	2	49	0	0
2	7937238	.	C	T	0	10	10	0	21	31	0	0
2	7943854	.	G	A	12	14	26	0	1	27	0	0
2	7954914	.	G	A	12	13	25	0	1	26	0	0
2	7956982	.	T	C	16	11	27	0	0	27	0	0
2	7959294	.	T	C	11	18	29	0	1	30	0	0
2	7979881	.	T	C	10	10	20	0	0	20	0	0
2	7979938	.	G	A	7	6	13	0	2	15	0	0
2	7995486	.	A	G	5	7	12	0	0	12	0	0
2	8017314	.	C	T	5	6	11	0	1	12	0	0
2	8064838	.	G	A	1	2	3	0	0	3	0	0
2	8112516	.	C	T	13	21	34	0	3	37	0	0
2	8112611	.	G	A	11	8	19	0	1	20	0	0
2	8112679	.	C	A	12	16	28	0	5	33	0	0
2	8112687	.	A	T	10	15	25	0	4	29	0	0
2	8113705	.	T	C	19	16	35	0	2	37	0	0
2	8114005	.	G	T	3	19	22	0	15	37	0	0
2	8114546	.	G	A	1	8	9	0	0	9	0	0
2	8777335	.	G	A	31	7	38	0	1	39	0	0
2	10477178	.	T	C	1	3	4	0	0	4	0	0
2	10605096	.	T	G	4	2	6	0	0	6	0	0
2	10605894	.	A	C	1	4	5	0	0	5	0	0
2	10605916	.	T	C	1	2	3	0	0	3	0	0
2	10606297	.	C	T	1	3	4	0	0	4	0	0
2	10607622	.	T	A	1	2	3	0	0	3	0	0
2	10632335	.	G	T	1	2	3	0	0	3	0	0
2	10642111	.	C	T	1	2	3	0	0	3	0	0
2	10642324	.	T	C	1	3	4	0	0	4	0	0
2	10678202	.	C	T	3	2	5	0	0	5	0	0
2	10678244	.	G	T	7	4	11	0	0	11	0	0
2	10685672	.	A	G	6	0	6	0	14	20	0	0
2	10685802	.	T	G	4	5	9	0	1	10	0	0
2	10685850	.	T	C	6	6	12	1	0	13	0	0
2	10685890	.	G	C	6	5	11	1	0	12	0	0
2	10686277	.	A	C	3	5	8	0	0	8	0	0
2	10686280	.	G	A	3	5	8	0	0	8	0	0
2	10686341	.	A	C	9	9	18	0	0	18	0	0
2	10686617	.	A	G	2	0	2	0	2	4	0	0
2	10686898	.	G	C	7	6	13	0	0	13	0	0
2	10687002	.	G	T	4	3	7	0	0	7	0	0
2	10698150	.	T	C	24	22	46	0	1	47	0	0
2	10791702	.	A	G	2	3	5	0	2	7	0	0
2	10813088	.	G	A	2	3	5	0	0	5	0	0
2	10813148	.	G	C	3	2	5	0	0	5	0	0
2	10813152	.	C	T	3	2	5	0	0	5	0	0
2	10813438	.	C	G	3	2	5	0	0	5	0	0
2	10835777	.	T	A	1	2	3	0	0	3	0	0
2	10841504	.	C	T	7	7	14	0	0	14	0	0
2	10841536	.	T	A	7	8	15	0	1	16	0	0
2	10846471	.	C	T	5	8	13	0	1	14	0	0
2	10864618	.	T	A	1	1	2	0	1	3	0	0
2	10878554	.	G	C	0	4	4	0	1	5	0	0
2	10878579	.	T	C	2	2	4	0	0	4	0	0
2	10879844	.	G	C	1	2	3	0	0	3	0	0
2	10879879	.	G	A	4	4	8	0	0	8	0	0
2	10914200	.	A	C	3	3	6	0	0	6	0	0
2	10914340	.	C	A	8	8	16	0	1	17	0	0
2	10916419	.	T	C	7	9	16	0	0	16	0	0
2	10926449	.	T	C	5	14	19	0	1	20	0	0
2	10931675	.	C	G	10	8	18	0	0	18	0	0
2	10934911	.	T	C	1	0	1	0	4	5	0	0
2	10935052	.	G	A	2	3	5	0	0	5	0	0
2	10938924	.	C	T	3	3	6	0	0	6	0	0
2	10951534	.	G	T	3	2	5	1	1	7	0	0
2	10956861	.	T	G	3	2	5	0	0	5	0	0
2	11075069	.	G	C	1	0	1	0	2	3	0	0
2	11110222	.	A	G	7	9	16	0	1	17	0	0
2	11117731	.	G	T	1	8	9	0	0	9	0	0
2	11118056	.	T	G	4	2	6	0	0	6	0	0
2	11119485	.	T	C	1	2	3	0	0	3	0	0
2	11121658	.	A	G	1	0	1	0	3	4	0	0
2	11121694	.	T	C	1	3	4	0	0	4	0	0
2	11125635	.	C	G	1	8	9	0	0	9	0	0
2	11125863	.	C	T	3	3	6	0	0	6	0	0
2	11125896	.	C	A	4	3	7	0	0	7	0	0
2	11209756	.	G	A	1	4	5	0	5	10	0	0
2	11483271	.	C	T	4	2	6	0	0	6	0	0
2	11497307	.	C	T	0	2	2	0	3	5	0	0
2	11508771	.	A	G	5	8	13	0	0	13	0	0
2	11508780	.	G	A	5	10	15	0	1	16	0	0
2	11509016	.	A	G	20	11	31	0	6	37	0	0
2	11512254	.	C	T	12	9	21	0	2	23	0	0
2	11633304	.	G	C	1	2	3	0	0	3	0	0
2	11633751	.	A	C	9	0	9	0	8	17	0	0
2	11643077	.	C	T	7	4	11	0	0	11	0	0
2	11654370	.	G	A	12	12	24	0	1	25	0	0
2	11661162	.	T	C	6	12	18	0	0	18	0	0
2	11661234	.	G	A	4	13	17	0	1	18	0	0
2	11661287	.	C	T	0	5	5	0	12	17	0	0
2	11662575	.	G	T	10	10	20	0	0	20	0	0
2	11662590	.	G	T	11	8	19	0	1	20	0	0
2	11816178	.	T	C	1	2	3	0	0	3	0	0
2	11830396	.	T	C	1	2	3	1	0	4	0	0
2	11830743	.	A	T	1	2	3	0	0	3	0	0
2	11831218	.	G	A	2	2	4	0	0	4	0	0
2	11831253	.	G	A	1	2	3	0	2	5	0	0
2	11831421	.	C	T	3	4	7	0	0	7	0	0
2	11832876	.	A	C	3	6	9	0	0	10	1	0
2	11849167	.	A	G	14	13	27	0	0	27	0	0
2	11849190	.	T	C	10	13	23	0	0	23	0	0
2	11849477	.	C	T	19	7	26	0	1	27	0	0
2	11849484	.	T	A	20	8	28	0	0	28	0	0
2	11849637	.	G	A	13	5	18	0	0	18	0	0
2	11849760	.	A	C	18	3	21	3	1	25	0	0
2	11849764	.	C	A	17	3	20	3	0	23	0	0
2	11849911	.	A	T	4	2	6	1	1	8	0	0
2	11850220	.	C	A	15	7	22	0	0	22	0	0
2	11850244	.	T	A	15	13	28	0	0	28	0	0
2	11850350	.	A	T	20	7	27	1	1	29	0	0
2	11850385	.	C	T	3	12	15	1	22	38	0	0
2	11850395	.	G	A	22	15	37	1	1	39	0	0
2	11850525	.	A	G	12	7	19	2	0	21	0	0
2	11850528	.	T	C	12	0	12	2	5	19	0	0
2	11850948	.	C	A	8	5	13	0	1	14	0	0
2	11851010	.	C	T	6	5	11	0	3	14	0	0
2	11851148	.	G	T	10	6	16	0	0	16	0	0
2	11851189	.	A	C	12	13	25	0	1	26	0	0
2	11851205	.	T	A	11	16	27	0	1	28	0	0
2	11851256	.	T	G	12	13	25	0	1	26	0	0
2	11851260	.	T	G	12	10	22	0	1	24	1	0
2	11851325	.	A	G	11	8	19	0	0	19	0	0
2	11851371	.	T	C	8	5	13	0	0	13	0	0
2	11851434	.	A	C	8	4	12	0	0	12	0	0
2	11851663	.	G	A	7	5	12	0	0	12	0	0
2	11851708	.	C	T	6	6	12	0	0	12	0	0
2	11851750	.	G	A	4	4	8	0	3	11	0	0
2	11851926	.	C	A	8	4	12	0	0	12	0	0
2	11852128	.	T	C	5	0	5	0	5	10	0	0
2	11912222	.	A	G	2	4	6	0	1	7	0	0
2	11912237	.	C	G	3	4	7	0	0	7	0	0
2	11923921	.	G	A	1	3	4	0	0	4	0	0
2	11926016	.	C	T	3	2	5	0	0	5	0	0
2	11926123	.	T	C	2	3	5	0	0	5	0	0
2	11926447	.	C	G	2	0	2	0	4	6	0	0
2	11929900	.	G	A	0	4	4	0	1	5	0	0
2	11945864	.	G	C	2	2	4	0	0	4	0	0
2	11960471	.	C	T	1	2	3	0	0	3	0	0
2	11965262	.	G	A	5	10	15	0	0	15	0	0
2	11969431	.	A	G	9	10	19	0	0	19	0	0
2	11970199	.	C	T	3	11	14	0	0	14	0	0
2	11976331	.	A	G	2	3	5	0	0	5	0	0
2	11976603	.	T	C	12	1	13	0	12	25	0	0
2	11976633	.	A	G	12	10	22	0	1	23	0	0
2	11976700	.	G	T	11	7	18	0	1	19	0	0
2	11976741	.	C	T	1	4	5	0	9	14	0	0
2	11976980	.	A	G	8	5	13	0	0	13	0	0
2	11977104	.	C	T	0	9	9	0	7	16	0	0
2	11977146	.	A	T	7	5	12	0	0	12	0	0
2	11977163	.	T	C	5	6	11	0	0	11	0	0
2	11977495	.	A	G	7	3	10	0	0	10	0	0
2	11978137	.	T	A	7	5	12	0	0	12	0	0
2	11978296	.	G	A	3	2	5	0	0	5	0	0
2	11978342	.	A	G	2	2	4	0	0	4	0	0
2	11993409	.	A	G	5	3	8	0	1	9	0	0
2	11998037	.	C	T	14	13	27	0	0	27	0	0
2	11998058	.	T	C	14	10	24	0	2	26	0	0
2	12002323	.	A	G	5	0	5	0	6	11	0	0
2	12002385	.	T	A	5	3	8	0	0	8	0	0
2	12002697	.	A	T	6	6	12	0	0	12	0	0
2	12002766	.	A	G	7	5	12	0	0	12	0	0
2	12002797	.	A	G	2	4	6	0	2	8	0	0
2	12002885	.	T	C	6	3	9	0	1	10	0	0
2	12002899	.	T	G	9	4	13	0	0	13	0	0
2	12002945	.	A	T	3	3	6	0	0	6	0	0
2	12002950	.	T	C	3	3	6	0	0	6	0	0
2	12104948	.	T	A	12	12	24	0	1	25	0	0
2	12104949	.	C	T	10	12	22	0	3	25	0	0
2	12105078	.	A	T	13	12	25	0	1	26	0	0
2	12105281	.	T	A	6	3	9	0	0	9	0	0
2	12106289	.	A	G	19	15	34	0	1	35	0	0
2	12106363	.	T	C	6	12	18	0	2	20	0	0
2	12106443	.	T	C	9	12	21	0	1	22	0	0
2	12106508	.	A	T	13	9	22	0	1	23	0	0
2	12106603	.	C	T	13	7	20	2	0	22	0	0
2	12106701	.	G	T	11	10	21	0	2	23	0	0
2	12106721	.	G	A	14	16	30	0	1	31	0	0
2	12106792	.	A	G	9	13	22	1	2	25	0	0
2	12106828	.	C	T	14	8	22	1	0	23	0	0
2	12106846	.	A	T	12	6	18	0	1	19	0	0
2	12106864	.	C	T	0	7	7	0	10	17	0	0
2	12106923	.	C	T	3	9	12	0	0	12	0	0
2	12107063	.	G	A	7	5	12	0	0	12	0	0
2	12107176	.	G	A	5	4	9	0	0	9	0	0
2	12107211	.	C	T	1	5	6	0	0	6	0	0
2	12107214	.	A	C	1	5	6	0	0	6	0	0
2	12107640	.	C	T	9	8	17	0	0	17	0	0
2	12107678	.	A	T	3	7	10	0	0	10	0	0
2	12107747	.	T	G	5	6	11	0	0	11	0	0
2	12107752	.	A	T	5	6	11	0	1	12	0	0
2	12107879	.	A	T	5	6	11	0	0	11	0	0
2	12107908	.	T	C	4	0	4	1	5	10	0	0
2	12108100	.	G	A	3	2	5	0	0	5	0	0
2	12108381	.	C	T	0	4	4	0	6	10	0	0
2	12108513	.	T	A	5	6	11	0	1	12	0	0
2	12108696	.	T	A	11	12	23	0	0	23	0	0
2	12108754	.	G	C	9	12	21	0	1	22	0	0
2	12108810	.	G	T	12	6	18	0	1	19	0	0
2	12109065	.	G	A	8	9	17	0	1	18	0	0
2	12109153	.	T	A	9	7	16	0	2	18	0	0
2	12109637	.	C	T	9	3	12	0	1	13	0	0
2	12109685	.	A	G	8	7	15	0	1	16	0	0
2	12109942	.	G	C	8	5	13	0	0	13	0	0
2	12109971	.	G	A	7	3	10	0	0	10	0	0
2	12109989	.	G	A	7	5	12	0	0	12	0	0
2	12110082	.	C	A	5	5	10	0	0	10	0	0
2	12130837	.	G	A	3	6	9	0	0	9	0	0
2	12130846	.	A	G	3	5	8	0	0	8	0	0
2	12242807	.	C	G	0	2	2	0	1	3	0	0
2	12265751	.	T	C	3	2	5	0	1	6	0	0
2	12269834	.	G	T	4	2	6	0	1	7	0	0
2	12279203	.	A	G	5	3	8	0	0	8	0	0
2	12279303	.	C	T	10	2	12	0	0	12	0	0
2	12279328	.	T	C	9	4	13	0	1	14	0	0
2	12279419	.	C	T	8	6	14	0	0	14	0	0
2	12279540	.	T	C	4	2	6	0	0	6	0	0
2	12279594	.	A	C	3	2	5	0	1	6	0	0
2	12376848	.	A	T	4	5	9	0	0	9	0	0
2	12376857	.	A	G	4	6	10	0	0	10	0	0
2	12376925	.	A	G	14	6	20	0	1	21	0	0
2	12378489	.	G	A	1	6	7	0	8	15	0	0
2	12378618	.	A	G	14	10	24	0	0	24	0	0
2	12379585	.	A	C	10	15	25	0	0	25	0	0
2	12386865	.	A	G	6	12	18	0	2	20	0	0
2	12394569	.	G	A	2	16	18	0	18	36	0	0
2	12396788	.	T	G	16	1	17	0	17	34	0	0
2	12397418	.	A	G	16	14	30	0	0	30	0	0
2	12404169	.	A	C	16	29	45	0	2	47	0	0
2	12404411	.	T	C	18	17	35	0	6	41	0	0
2	12405310	.	G	A	4	13	17	0	13	30	0	0
2	12406022	.	A	T	20	15	35	0	0	35	0	0
2	12407106	.	G	A	23	19	42	0	1	43	0	0
2	12407113	.	C	G	22	17	39	0	2	41	0	0
2	12407188	.	A	C	25	12	37	0	2	39	0	0
2	12407586	.	G	T	18	12	30	0	2	32	0	0
2	12407610	.	G	A	21	15	36	0	2	38	0	0
2	12407626	.	T	A	26	12	38	0	1	39	0	0
2	12407799	.	C	T	17	23	40	0	1	41	0	0
2	12407992	.	T	C	36	22	58	1	0	59	0	0
2	12408081	.	T	G	26	18	44	1	3	49	1	0
2	12408085	.	G	A	28	17	45	1	2	48	0	0
2	12410548	.	A	G	23	26	49	0	0	49	0	0
2	12417224	.	G	T	20	11	31	0	1	33	1	0
2	12425370	.	G	A	11	11	22	0	0	22	0	0
2	12502394	.	G	A	8	12	20	0	0	20	0	0
2	12632749	.	T	C	4	4	8	0	0	8	0	0
2	12996419	.	C	A	2	2	4	0	0	4	0	0
2	12998669	.	G	T	2	2	4	0	1	5	0	0
2	12998797	.	C	T	3	5	8	0	0	8	0	0
2	13001291	.	C	G	3	2	5	0	0	5	0	0
2	13007027	.	C	T	4	5	9	0	1	10	0	0
2	13007219	.	G	T	6	2	8	0	0	8	0	0
2	13007489	.	G	A	4	6	10	0	0	10	0	0
2	13007573	.	T	A	2	8	10	0	0	10	0	0
2	13007693	.	T	C	4	3	7	0	0	7	0	0
2	13007757	.	G	C	6	8	14	0	0	14	0	0
2	13010241	.	G	T	4	6	10	0	0	10	0	0
2	13010262	.	A	C	4	5	9	0	0	9	0	0
2	13011555	.	G	T	1	8	9	0	7	16	0	0
2	13011641	.	T	C	5	5	10	0	0	10	0	0
2	13014235	.	G	T	4	4	8	0	0	8	0	0
2	13018408	.	T	C	9	3	12	0	1	13	0	0
2	13019956	.	A	T	7	11	18	0	0	18	0	0
2	13020122	.	T	A	14	8	22	0	0	22	0	0
2	13020284	.	G	C	1	8	9	0	8	17	0	0
2	13020541	.	G	A	1	5	6	0	5	11	0	0
2	13035942	.	C	A	6	10	16	0	2	18	0	0
2	13036154	.	T	A	8	13	21	0	1	22	0	0
2	13036649	.	G	C	1	5	6	0	6	12	0	0
2	13187003	.	T	A	16	12	28	0	1	29	0	0
2	13187634	.	A	G	8	10	18	0	1	19	0	0
2	13187749	.	T	A	8	6	14	0	1	16	1	0
2	13215694	.	C	A	16	15	31	0	1	32	0	0
2	13215795	.	G	T	15	6	21	0	4	25	0	0
2	13215967	.	G	A	10	11	21	0	2	23	0	0
2	13223815	.	T	A	6	6	12	0	0	12	0	0
2	13223853	.	A	G	6	6	12	0	0	12	0	0
2	13223864	.	T	A	6	5	11	0	0	11	0	0
2	13224229	.	C	T	3	2	5	0	0	5	0	0
2	13224341	.	A	G	3	3	6	0	0	6	0	0
2	13224702	.	T	C	6	6	12	0	0	12	0	0
2	13224981	.	A	G	2	2	4	0	0	4	0	0
2	13237666	.	C	T	10	7	17	0	1	18	0	0
2	13242171	.	G	A	7	5	12	0	0	12	0	0
2	13242664	.	C	T	4	6	10	0	1	11	0	0
2	13254444	.	A	G	3	2	5	0	0	5	0	0
2	13254445	.	C	A	3	2	5	0	0	5	0	0
2	13254542	.	A	G	2	3	5	0	0	5	0	0
2	13254670	.	T	C	2	0	2	0	4	6	0	0
2	13256795	.	G	C	4	3	7	0	0	7	0	0
2	13265122	.	T	A	2	8	10	0	1	11	0	0
2	13265191	.	G	A	5	5	10	0	0	10	0	0
2	13265572	.	T	G	2	3	5	0	0	5	0	0
2	13266565	.	A	G	7	6	13	0	0	13	0	0
2	13267007	.	C	T	3	3	6	0	0	6	0	0
2	13268443	.	C	A	2	6	8	0	0	8	0	0
2	13764646	.	C	G	2	0	2	0	2	4	0	0
2	14278173	.	A	T	8	3	11	0	1	12	0	0
2	14278412	.	A	C	7	16	23	0	1	24	0	0
2	14278828	.	A	C	4	0	4	0	5	9	0	0
2	14298495	.	G	A	6	7	13	0	1	14	0	0
2	14366676	.	T	A	12	11	23	0	1	24	0	0
2	14998640	.	C	T	2	6	8	0	0	8	0	0
2	14998764	.	A	G	5	3	8	0	1	9	0	0
2	15010440	.	G	A	1	3	4	0	0	4	0	0
2	15028974	.	G	A	4	2	6	0	0	6	0	0
2	15031023	.	G	A	2	5	7	0	1	8	0	0
2	15031096	.	A	C	6	0	6	0	9	15	0	0
2	15031126	.	T	C	3	6	9	0	1	10	0	0
2	15035425	.	A	G	6	7	13	0	0	13	0	0
2	15035928	.	A	T	5	4	9	0	0	9	0	0
2	15075054	.	T	C	3	1	4	0	0	4	0	0
2	15112025	.	G	T	7	7	14	0	1	15	0	0
2	15124705	.	C	T	2	2	4	0	0	4	0	0
2	15344120	.	A	G	5	2	7	0	0	7	0	0
2	15348008	.	G	A	1	2	3	0	0	3	0	0
2	15391424	.	G	A	1	2	3	0	1	4	0	0
2	15391432	.	C	A	1	5	6	0	0	6	0	0
2	15790060	.	A	G	4	4	8	0	0	8	0	0
2	15790135	.	T	G	4	2	6	0	1	7	0	0
2	15864361	.	C	T	5	3	8	0	0	8	0	0
2	15864382	.	A	C	5	3	8	0	0	8	0	0
2	15864514	.	T	C	3	5	8	0	0	8	0	0
2	15864586	.	C	T	5	5	10	0	0	10	0	0
2	15942544	.	A	G	15	12	27	0	2	29	0	0
2	15942638	.	A	G	11	2	13	0	0	13	0	0
2	15942671	.	G	A	6	11	17	0	1	18	0	0
2	15942674	.	A	T	6	9	15	0	1	16	0	0
2	15942774	.	G	A	10	10	20	0	0	20	0	0
2	15942817	.	T	C	13	12	25	0	1	26	0	0
2	15942843	.	C	T	20	11	31	0	0	31	0	0
2	15942897	.	C	G	9	14	23	0	0	23	0	0
2	15942964	.	T	C	6	11	17	0	0	17	0	0
2	15943022	.	C	T	2	10	12	0	1	13	0	0
2	15943048	.	G	T	6	7	13	0	0	13	0	0
2	15943120	.	T	G	4	9	13	0	1	14	0	0
2	15943267	.	G	A	0	8	8	0	9	17	0	0
2	15993631	.	A	G	1	2	3	0	1	4	0	0
2	15993696	.	T	A	3	3	6	0	0	6	0	0
2	15993974	.	T	C	0	0	0	0	3	3	0	0
2	16017925	.	A	T	2	4	6	0	0	6	0	0
2	16161232	.	A	G	7	9	16	0	1	17	0	0
2	16164479	.	C	T	4	12	16	0	1	17	0	0
2	16164536	.	A	G	4	7	11	0	1	12	0	0
2	16165809	.	C	A	5	11	16	0	4	20	0	0
2	16169397	.	A	G	2	11	13	0	0	13	0	0
2	16172088	.	T	G	3	4	7	0	1	8	0	0
2	16172096	.	A	T	3	6	9	0	0	9	0	0
2	16172160	.	T	C	3	5	8	0	0	8	0	0
2	16174117	.	A	C	5	5	10	0	1	11	0	0
2	16174139	.	A	C	7	6	13	0	0	13	0	0
2	16174173	.	A	T	6	3	9	0	0	9	0	0
2	16174220	.	A	T	4	1	5	0	1	6	0	0
2	16174227	.	A	C	4	2	6	0	1	7	0	0
2	16174314	.	G	C	5	7	12	0	0	12	0	0
2	16176276	.	A	G	1	4	5	0	0	5	0	0
2	16177521	.	A	G	9	3	12	0	0	12	0	0
2	16181251	.	C	T	2	2	4	0	0	4	0	0
2	16181258	.	A	G	2	2	4	0	0	4	0	0
2	16191718	.	G	A	1	14	15	0	12	27	0	0
2	16191748	.	A	G	11	10	21	0	2	23	0	0
2	16191829	.	C	T	11	8	19	0	0	19	0	0
2	16191892	.	T	G	10	0	10	0	4	14	0	0
2	16194018	.	A	G	9	0	9	0	7	16	0	0
2	16194019	.	T	C	9	7	16	0	0	16	0	0
2	16198807	.	T	C	4	3	7	0	0	7	0	0
2	16198932	.	A	G	12	20	32	0	3	35	0	0
2	16199018	.	G	A	23	30	53	0	3	56	0	0
2	16204689	.	T	G	35	21	56	1	1	58	0	0
2	16206840	.	C	T	26	22	48	0	2	50	0	0
2	16207151	.	G	A	16	9	25	0	2	27	0	0
2	16207346	.	T	C	17	18	35	0	2	37	0	0
2	16209406	.	T	C	19	17	36	0	3	39	0	0
2	16216365	.	T	C	4	0	4	0	5	9	0	0
2	16216524	.	A	T	5	5	10	0	2	12	0	0
2	16221213	.	T	C	4	0	4	0	11	15	0	0
2	16254496	.	C	A	5	8	13	0	0	13	0	0
2	16269335	.	G	A	1	2	3	0	0	3	0	0
2	16376143	.	T	C	1	5	6	0	2	8	0	0
2	16376295	.	G	A	3	4	7	0	1	8	0	0
2	16376416	.	G	C	1	4	5	0	0	5	0	0
2	16377047	.	T	G	4	5	9	0	1	10	0	0
2	16377082	.	A	G	5	6	11	0	0	11	0	0
2	16377241	.	C	T	1	2	3	0	0	3	0	0
2	16377376	.	T	G	6	3	9	0	0	9	0	0
2	16377985	.	A	G	2	2	4	0	0	4	0	0
2	16377995	.	G	A	2	3	5	0	0	5	0	0
2	16378027	.	T	C	1	3	4	0	0	4	0	0
2	16387964	.	G	A	2	5	7	0	0	7	0	0
2	16390423	.	T	C	1	6	7	0	0	7	0	0
2	16393421	.	C	T	0	3	3	0	3	6	0	0
2	16397877	.	C	T	0	2	2	0	2	4	0	0
2	16400833	.	G	A	2	3	5	0	0	5	0	0
2	16400842	.	T	G	3	2	5	0	0	5	0	0
2	16449803	.	C	T	1	6	7	0	0	7	0	0
2	16451344	.	T	C	3	2	5	0	0	5	0	0
2	16454182	.	T	A	3	4	7	0	0	7	0	0
2	16463862	.	T	C	5	9	14	0	0	14	0	0
2	16466383	.	A	G	7	0	7	0	11	18	0	0
2	16466720	.	A	G	12	1	13	0	12	25	0	0
2	16472243	.	T	C	15	9	24	0	0	24	0	0
2	16472284	.	T	C	12	12	24	0	1	25	0	0
2	16472288	.	C	G	12	0	12	0	13	25	0	0
2	16475415	.	C	G	14	2	16	0	20	36	0	0
2	16475469	.	C	A	14	15	29	0	0	29	0	0
2	16475484	.	G	A	2	15	17	0	15	32	0	0
2	16478577	.	G	A	0	6	6	0	7	13	0	0
2	16478587	.	A	G	9	5	14	0	0	14	0	0
2	16479015	.	A	G	12	18	30	0	0	30	0	0
2	16547866	.	T	C	13	8	21	0	2	23	0	0
2	16548120	.	A	T	7	7	14	0	1	15	0	0
2	16548178	.	C	T	0	6	6	0	5	11	0	0
2	16548236	.	T	G	11	8	19	0	0	19	0	0
2	16548286	.	T	C	10	0	10	0	11	21	0	0
2	16548289	.	C	T	12	11	23	0	0	23	0	0
2	16548514	.	T	C	19	8	27	0	2	29	0	0
2	16565560	.	G	T	15	10	25	0	0	25	0	0
2	16589703	.	T	G	1	3	4	0	0	4	0	0
2	16594896	.	T	A	3	5	8	0	0	8	0	0
2	16594906	.	C	T	3	5	8	0	0	8	0	0
2	16614840	.	C	T	1	2	3	0	0	3	0	0
2	16631338	.	G	A	3	4	7	0	0	7	0	0
2	16632917	.	T	C	6	5	11	0	0	11	0	0
2	16635733	.	G	A	1	3	4	0	0	4	0	0
2	16639585	.	G	A	3	1	4	0	1	5	0	0
2	16639664	.	T	A	7	7	14	0	0	14	0	0
2	16639684	.	G	A	6	5	11	0	1	12	0	0
2	16639818	.	C	T	4	2	6	0	0	6	0	0
2	16642963	.	T	C	2	4	6	1	0	7	0	0
2	16645821	.	A	C	9	4	13	0	0	13	0	0
2	16646117	.	C	T	5	3	8	0	0	8	0	0
2	16646222	.	C	T	5	3	8	0	0	8	0	0
2	16646275	.	G	C	5	2	7	0	0	7	0	0
2	16646475	.	T	C	5	10	15	0	0	15	0	0
2	16646593	.	T	C	9	4	13	0	0	13	0	0
2	16646714	.	T	A	2	2	4	0	0	4	0	0
2	16646808	.	A	C	2	5	7	0	0	7	0	0
2	16647126	.	A	T	3	5	8	0	0	8	0	0
2	16694561	.	G	A	1	3	4	0	0	4	0	0
2	16698199	.	A	G	14	5	19	0	0	19	0	0
2	16698384	.	C	A	14	11	25	0	1	26	0	0
2	16699560	.	C	T	9	16	25	0	0	25	0	0
2	16699565	.	A	T	9	17	26	0	0	26	0	0
2	16699595	.	T	C	10	22	32	0	1	33	0	0
2	16702570	.	G	A	2	11	13	0	9	22	0	0
2	16702630	.	T	C	17	12	29	0	2	31	0	0
2	16706549	.	A	C	30	19	49	0	4	53	0	0
2	16706563	.	T	C	29	26	55	0	2	57	0	0
2	16706618	.	G	A	4	24	28	0	26	54	0	0
2	16706737	.	G	A	1	16	17	0	26	43	0	0
2	16707290	.	G	T	12	7	19	0	0	19	0	0
2	16707329	.	A	C	19	8	27	0	0	27	0	0
2	16707371	.	C	T	14	15	29	0	0	29	0	0
2	16707374	.	C	A	15	13	28	0	2	30	0	0
2	16707582	.	T	A	14	8	22	0	2	24	0	0
2	16707631	.	C	G	10	7	17	0	3	20	0	0
2	16723925	.	C	G	5	4	9	0	0	9	0	0
2	16728507	.	T	C	6	4	10	0	0	10	0	0
2	16734657	.	A	G	5	4	9	0	0	9	0	0
2	16735052	.	G	T	7	7	14	0	0	14	0	0
2	16735160	.	G	A	5	9	14	0	2	16	0	0
2	16735262	.	G	A	1	7	8	0	6	14	0	0
2	16736612	.	C	T	13	8	21	2	0	23	0	0
2	16736678	.	T	C	13	9	22	0	2	24	0	0
2	16736941	.	T	A	2	8	10	0	0	10	0	0
2	16737086	.	C	T	9	12	21	0	0	21	0	0
2	16814705	.	C	G	2	4	6	0	0	6	0	0
2	16819317	.	A	G	4	6	10	0	0	10	0	0
2	16821704	.	A	T	2	2	4	0	0	4	0	0
2	16821788	.	A	T	4	5	9	0	1	10	0	0
2	16821854	.	G	A	0	5	5	0	3	8	0	0
2	16821863	.	C	T	2	4	6	0	1	7	0	0
2	16822370	.	A	C	2	3	5	0	1	6	0	0
2	16824536	.	T	C	3	2	5	0	1	6	0	0
2	16826297	.	G	A	3	12	15	0	0	15	0	0
2	16826899	.	T	C	3	2	5	0	1	6	0	0
2	16829221	.	C	A	9	7	16	0	0	16	0	0
2	16829555	.	G	A	0	2	2	0	10	12	0	0
2	16833650	.	C	A	6	6	12	0	0	12	0	0
2	16833884	.	A	T	12	8	20	0	0	20	0	0
2	16857828	.	G	A	0	4	4	0	4	8	0	0
2	16862267	.	C	T	11	7	18	0	0	18	0	0
2	16862271	.	T	C	9	6	15	0	2	17	0	0
2	16866879	.	C	G	4	6	10	0	0	10	0	0
2	16866933	.	G	A	0	6	6	0	4	10	0	0
2	16866940	.	C	A	4	6	10	0	0	10	0	0
2	16867341	.	C	A	3	3	6	0	0	6	0	0
2	16867606	.	A	T	7	6	13	1	0	14	0	0
2	16867621	.	T	G	8	6	14	1	0	15	0	0
2	16867897	.	G	A	0	5	5	0	1	6	0	0
2	16885660	.	C	T	4	2	6	0	0	6	0	0
2	16885671	.	T	C	5	2	7	0	0	7	0	0
2	16885720	.	A	G	1	2	3	0	0	3	0	0
2	16885774	.	A	T	3	4	7	0	0	7	0	0
2	16885782	.	T	A	3	3	6	0	0	6	0	0
2	16885857	.	A	C	2	4	6	0	0	6	0	0
2	16885929	.	A	C	1	4	5	0	0	5	0	0
2	16885944	.	A	G	1	3	4	0	1	5	0	0
2	16886106	.	A	T	4	4	8	0	0	8	0	0
2	16890914	.	T	C	3	2	5	0	0	5	0	0
2	16921406	.	T	A	1	2	3	0	0	3	0	0
2	17267217	.	C	T	0	2	2	0	3	5	0	0
2	17267684	.	A	G	2	5	7	0	0	7	0	0
2	17317821	.	G	A	1	2	3	0	0	3	0	0
2	17450642	.	C	T	5	3	8	0	0	8	0	0
2	17450744	.	G	A	11	3	14	0	0	14	0	0
2	17450841	.	A	T	6	4	10	0	0	10	0	0
2	17450859	.	C	A	1	5	6	0	6	12	0	0
2	17451003	.	G	A	10	4	14	0	1	15	0	0
2	17451233	.	T	C	6	7	13	0	0	13	0	0
2	17451387	.	T	C	8	6	14	0	2	16	0	0
2	17468914	.	T	C	2	3	5	0	2	7	0	0
2	17468971	.	A	G	4	7	11	0	0	11	0	0
2	17469413	.	T	C	2	0	2	0	4	6	0	0
2	17469441	.	A	G	1	3	4	0	0	4	0	0
2	17477335	.	G	T	7	7	14	0	1	15	0	0
2	17477480	.	G	T	4	7	11	0	2	13	0	0
2	17578593	.	A	G	8	23	31	0	1	32	0	0
2	17578658	.	T	A	8	22	30	0	1	31	0	0
2	17578710	.	A	G	11	23	34	0	1	35	0	0
2	17578853	.	C	T	12	20	32	0	0	33	1	0
2	17579639	.	G	A	3	9	12	0	1	13	0	0
2	17596503	.	A	G	4	7	11	0	1	12	0	0
2	17629935	.	T	C	3	18	21	0	3	24	0	0
2	17644609	.	T	C	13	0	13	0	16	29	0	0
2	17646976	.	G	A	7	16	23	0	0	23	0	0
2	17651466	.	A	G	6	19	25	0	1	26	0	0
2	17651529	.	C	T	1	26	27	0	9	36	0	0
2	17651565	.	C	T	7	20	27	0	2	29	0	0
2	17651574	.	C	T	5	17	22	0	1	23	0	0
2	17656439	.	A	T	6	11	17	0	0	17	0	0
2	17656547	.	G	A	6	9	15	0	0	15	0	0
2	17656580	.	A	C	4	10	14	0	0	14	0	0
2	17688318	.	A	C	4	0	4	0	7	11	0	0
2	17698505	.	T	C	3	6	9	0	1	10	0	0
2	17698574	.	C	A	1	5	6	0	4	10	0	0
2	17702485	.	T	A	2	6	8	0	0	8	0	0
2	17717026	.	A	G	3	6	9	0	0	9	0	0
2	17946951	.	T	C	7	0	7	0	6	13	0	0
2	17947129	.	A	G	1	7	8	0	0	8	0	0
2	18698517	.	C	A	17	22	39	0	1	40	0	0
2	18698560	.	T	A	18	16	34	0	2	36	0	0
2	18698648	.	G	A	13	12	25	0	0	25	0	0
2	18698659	.	G	T	12	9	21	0	0	21	0	0
2	18698686	.	C	T	11	9	20	0	2	22	0	0
2	18698912	.	C	G	16	18	34	0	0	34	0	0
2	18698920	.	G	A	15	22	37	0	1	38	0	0
2	18698957	.	A	T	17	18	35	0	2	37	0	0
2	18699071	.	G	A	25	12	37	0	2	39	0	0
2	18699192	.	C	T	15	9	24	0	3	27	0	0
2	18699315	.	C	G	20	16	36	0	0	36	0	0
2	18699474	.	G	T	16	23	39	0	0	39	0	0
2	18699533	.	T	A	11	21	32	0	2	34	0	0
2	18699586	.	G	T	10	14	24	0	0	24	0	0
2	18699590	.	G	T	9	15	24	0	1	25	0	0
2	18700102	.	T	A	15	6	21	1	3	25	0	0
2	18700148	.	G	A	12	14	26	0	2	28	0	0
2	18700194	.	T	A	12	13	25	0	3	28	0	0
2	18700346	.	A	T	7	11	18	0	4	22	0	0
2	18700410	.	C	A	5	8	13	0	0	13	0	0
2	18700750	.	G	A	10	9	19	0	0	19	0	0
2	18700753	.	G	A	9	9	18	0	0	18	0	0
2	18701033	.	G	A	12	13	25	0	0	25	0	0
2	18701080	.	C	T	10	4	14	0	3	17	0	0
2	18701089	.	A	T	12	2	14	0	0	14	0	0
2	18701228	.	A	G	12	5	17	0	2	19	0	0
2	18701232	.	T	C	12	6	18	0	2	20	0	0
2	18701576	.	T	C	2	12	14	0	0	14	0	0
2	18701779	.	T	C	8	9	17	0	0	17	0	0
2	18701827	.	A	C	12	11	23	0	0	23	0	0
2	18701924	.	A	T	5	6	11	0	0	11	0	0
2	18701982	.	T	A	8	10	18	0	0	18	0	0
2	18702029	.	C	T	5	6	11	0	0	11	0	0
2	18702199	.	A	T	4	11	15	0	1	16	0	0
2	18702222	.	G	T	5	9	14	0	0	14	0	0
2	18702359	.	G	T	3	2	5	3	1	9	0	0
2	18702657	.	G	T	8	15	23	0	0	23	0	0
2	18702710	.	T	C	11	0	11	0	14	25	0	0
2	18702716	.	A	C	12	13	25	0	1	26	0	0
2	18702772	.	G	A	8	13	21	0	1	22	0	0
2	18702825	.	T	G	7	11	18	0	0	18	0	0
2	18702861	.	C	A	3	7	10	0	1	11	0	0
2	18702862	.	A	G	3	8	11	0	0	11	0	0
2	18702915	.	C	A	3	3	6	0	0	6	0	0
2	18703265	.	T	A	10	8	18	0	2	20	0	0
2	18703273	.	A	G	12	8	20	0	1	21	0	0
2	18703344	.	A	T	12	15	27	0	3	30	0	0
2	18703345	.	T	G	13	18	31	0	0	31	0	0
2	18714519	.	A	G	13	19	32	0	1	33	0	0
2	18725918	.	G	A	10	13	23	0	0	23	0	0
2	18735032	.	A	G	6	9	15	0	0	15	0	0
2	18735038	.	A	G	6	7	13	0	1	14	0	0
2	18830386	.	A	G	8	8	16	0	0	16	0	0
2	18830493	.	G	A	4	7	11	0	0	11	0	0
2	18830645	.	T	A	4	6	10	0	0	10	0	0
2	18830646	.	G	A	4	6	10	0	0	10	0	0
2	18990241	.	G	C	27	18	45	0	1	46	0	0
2	18991317	.	T	C	34	18	52	0	2	54	0	0
2	18991362	.	T	C	30	23	53	0	3	56	0	0
2	18992144	.	G	C	26	21	47	0	0	47	0	0
2	19100786	.	A	T	3	11	14	0	0	14	0	0
2	19100788	.	A	T	3	11	14	0	0	14	0	0
2	19101393	.	A	T	7	5	12	0	0	12	0	0
2	19101732	.	C	G	9	8	17	1	0	18	0	0
2	19101950	.	A	G	8	5	13	0	2	15	0	0
2	19102757	.	T	A	7	4	11	0	0	11	0	0
2	19102996	.	T	A	5	2	7	0	0	7	0	0
2	19103424	.	C	A	3	3	6	0	0	6	0	0
2	19104850	.	G	A	4	6	10	0	0	10	0	0
2	19109300	.	T	A	2	2	4	0	0	4	0	0
2	19214770	.	C	G	4	0	4	0	5	9	0	0
2	19214771	.	C	A	3	4	7	0	0	8	1	0
2	19218006	.	T	A	1	2	3	0	1	4	0	0
2	19247451	.	C	A	3	2	5	0	0	5	0	0
2	19272746	.	T	C	1	2	3	0	0	3	0	0
2	19280915	.	A	T	1	1	2	0	1	3	0	0
2	19281295	.	T	G	3	2	5	0	0	5	0	0
2	19281432	.	T	A	4	5	9	0	2	11	0	0
2	19290129	.	A	G	6	5	11	0	0	11	0	0
2	19308439	.	G	C	11	7	18	0	0	18	0	0
2	19318112	.	C	A	5	2	7	0	0	7	0	0
2	19318459	.	T	C	3	4	7	0	0	7	0	0
2	19643198	.	A	G	1	6	7	0	0	7	0	0
2	19645797	.	T	A	1	2	3	0	0	3	0	0
2	19646233	.	G	A	1	2	3	0	0	3	0	0
2	19784751	.	C	T	7	4	11	0	1	12	0	0
2	19794484	.	C	T	7	9	16	0	7	23	0	0
2	19794753	.	A	G	13	12	25	0	0	25	0	0
2	19794847	.	T	G	17	0	17	0	11	28	0	0
2	19794937	.	C	T	15	19	34	0	0	34	0	0
2	19795249	.	C	T	11	9	20	0	1	21	0	0
2	19795301	.	A	G	9	12	21	0	1	22	0	0
2	19795333	.	G	C	12	12	24	0	1	25	0	0
2	19795344	.	G	A	1	8	9	0	15	24	0	0
2	19795400	.	A	G	16	9	25	0	1	26	0	0
2	19831164	.	A	G	1	3	4	0	0	4	0	0
2	19868622	.	C	G	1	2	3	0	0	3	0	0
2	20049504	.	C	T	1	3	4	0	0	4	0	0
2	20263129	.	C	T	2	2	4	0	0	4	0	0
2	20263156	.	A	G	3	2	5	0	0	5	0	0
2	20263731	.	A	T	1	1	2	1	0	3	0	0
2	20285762	.	G	A	1	2	3	0	0	3	0	0
2	20323825	.	A	G	1	1	2	0	1	3	0	0
2	20323830	.	A	T	1	3	4	0	0	4	0	0
2	20331937	.	C	A	3	2	5	0	0	5	0	0
2	20367846	.	A	C	5	10	15	0	1	16	0	0
2	20368101	.	T	C	8	6	14	0	0	14	0	0
2	20368173	.	T	C	8	6	14	0	1	15	0	0
2	20368320	.	G	A	5	3	8	0	0	8	0	0
2	20368383	.	A	G	4	0	4	0	5	9	0	0
2	20368537	.	A	C	12	14	26	0	0	26	0	0
2	20368630	.	G	A	0	12	12	0	9	21	0	0
2	20368761	.	T	C	13	11	24	0	1	25	0	0
2	20369162	.	A	C	17	8	25	0	3	28	0	0
2	20369240	.	T	G	12	13	25	0	1	26	0	0
2	20370012	.	C	T	16	13	29	0	0	29	0	0
2	20437703	.	C	A	7	10	17	0	0	17	0	0
2	20437721	.	G	A	8	9	17	0	2	19	0	0
2	20437826	.	G	A	1	11	12	0	7	19	0	0
2	20437834	.	C	T	5	10	15	0	3	18	0	0
2	20437901	.	G	T	3	9	12	0	1	13	0	0
2	20437916	.	G	T	5	7	12	0	0	12	0	0
2	20438054	.	G	A	9	13	22	0	1	23	0	0
2	20438110	.	C	A	6	13	19	0	0	19	0	0
2	20438167	.	G	A	1	12	13	0	9	22	0	0
2	20438219	.	G	A	7	22	29	0	0	29	0	0
2	20438373	.	A	G	9	9	18	0	0	18	0	0
2	20438443	.	G	A	14	10	24	0	1	25	0	0
2	20438876	.	A	C	11	16	27	0	0	27	0	0
2	20439070	.	A	G	7	0	7	0	16	23	0	0
2	20439089	.	T	C	5	13	18	0	2	20	0	0
2	20439223	.	G	T	15	23	38	0	0	38	0	0
2	20439490	.	A	G	13	25	38	0	0	38	0	0
2	20442735	.	G	A	9	33	42	0	0	42	0	0
2	20442939	.	A	G	2	2	4	0	0	4	0	0
2	20473191	.	T	G	6	3	9	0	0	9	0	0
2	20475819	.	A	G	1	2	3	0	1	4	0	0
2	20477158	.	C	T	1	4	5	0	0	5	0	0
2	20478880	.	A	T	2	4	6	0	0	6	0	0
2	20487347	.	C	A	5	3	8	0	1	9	0	0
2	20496574	.	T	C	2	4	6	0	1	7	0	0
2	20501627	.	C	A	1	3	4	0	0	4	0	0
2	20501646	.	C	T	2	2	4	0	0	4	0	0
2	20505994	.	C	T	6	14	20	0	0	20	0	0
2	20506067	.	G	A	5	8	13	0	0	13	0	0
2	20506439	.	T	C	9	7	16	0	0	16	0	0
2	20509561	.	A	G	6	11	17	0	0	17	0	0
2	20509603	.	A	T	5	12	17	0	0	17	0	0
2	20511713	.	C	A	4	7	11	0	2	13	0	0
2	20511725	.	T	C	4	10	14	0	0	14	0	0
2	20511770	.	C	T	4	12	16	0	1	17	0	0
2	20515013	.	G	A	5	8	13	0	2	15	0	0
2	20515056	.	G	A	8	8	16	0	1	17	0	0
2	20515060	.	T	G	6	7	13	0	1	14	0	0
2	20515307	.	C	T	7	10	17	0	2	19	0	0
2	20520618	.	T	C	11	15	26	0	1	27	0	0
2	20520636	.	T	C	11	13	24	0	1	25	0	0
2	20523002	.	C	T	16	11	27	0	3	30	0	0
2	20523004	.	C	T	15	12	27	0	3	30	0	0
2	20523351	.	T	A	24	20	44	0	1	45	0	0
2	20523364	.	A	G	24	18	42	0	0	42	0	0
2	20526411	.	T	C	22	20	42	0	0	42	0	0
2	20526592	.	A	G	12	0	12	0	13	25	0	0
2	20526599	.	T	A	11	14	25	0	0	25	0	0
2	20662405	.	C	G	5	3	8	0	0	8	0	0
2	20663258	.	G	A	3	5	8	0	0	8	0	0
2	20811136	.	C	A	4	3	7	0	1	8	0	0
2	20811792	.	A	C	4	7	11	0	0	11	0	0
2	20814225	.	A	T	9	18	27	0	1	28	0	0
2	20814291	.	T	G	22	7	29	0	0	29	0	0
2	20814419	.	T	C	7	7	14	0	1	15	0	0
2	20814488	.	C	T	13	15	28	0	0	28	0	0
2	20814688	.	G	C	9	0	9	0	8	17	0	0
2	20819762	.	G	T	10	6	16	0	5	21	0	0
2	20822794	.	A	G	6	11	17	0	1	18	0	0
2	20828235	.	C	T	1	5	6	0	10	16	0	0
2	20828322	.	A	G	11	10	21	0	0	21	0	0
2	20830336	.	A	G	6	8	14	0	2	16	0	0
2	20830342	.	C	T	6	11	17	0	0	17	0	0
2	20830387	.	A	G	7	10	17	0	0	17	0	0
2	20833345	.	G	A	2	10	12	0	0	12	0	0
2	20833432	.	A	C	2	0	2	0	8	10	0	0
2	20833914	.	C	T	2	3	5	0	0	5	0	0
2	20833917	.	A	C	1	4	5	0	1	6	0	0
2	20836780	.	G	A	10	4	14	0	0	14	0	0
2	20840328	.	T	C	4	3	7	0	0	7	0	0
2	20840739	.	C	T	3	3	6	0	0	6	0	0
2	20840783	.	C	T	4	3	7	0	0	7	0	0
2	20843816	.	A	G	9	3	12	0	0	12	0	0
2	20844349	.	T	C	4	2	6	0	0	6	0	0
2	20848862	.	T	C	1	2	3	0	0	3	0	0
2	20864246	.	C	T	1	3	4	0	0	4	0	0
2	20866605	.	A	T	3	2	5	0	0	5	0	0
2	20866694	.	T	C	1	2	3	1	0	4	0	0
2	20868556	.	G	T	3	3	6	0	0	6	0	0
2	20872021	.	T	C	4	5	9	0	0	9	0	0
2	20872069	.	A	T	2	4	6	0	0	6	0	0
2	20872079	.	A	G	1	2	3	0	0	3	0	0
2	20873717	.	A	G	3	0	3	0	3	6	0	0
2	20875175	.	A	G	5	8	13	0	0	13	0	0
2	20875860	.	A	G	5	8	13	0	0	13	0	0
2	20967782	.	C	G	5	7	12	0	0	12	0	0
2	20967788	.	G	A	6	3	9	0	2	11	0	0
2	20972877	.	A	G	3	6	9	0	1	10	0	0
2	20973176	.	C	T	3	3	6	0	0	6	0	0
2	20973794	.	A	T	2	9	11	0	0	11	0	0
2	20973934	.	T	C	6	3	9	0	0	9	0	0
2	20974250	.	A	G	1	11	12	0	1	13	0	0
2	20974433	.	A	C	1	3	4	0	0	4	0	0
2	20974442	.	A	T	0	3	3	0	0	3	0	0
2	20974867	.	G	A	3	3	6	0	1	7	0	0
2	20974880	.	T	C	7	3	10	0	1	11	0	0
2	20975198	.	C	G	5	3	8	0	0	8	0	0
2	20975255	.	G	C	10	6	16	0	0	16	0	0
2	20975283	.	C	T	9	7	16	0	0	16	0	0
2	20975451	.	T	C	5	4	9	0	1	10	0	0
2	20975460	.	T	C	3	4	7	0	2	9	0	0
2	20980280	.	C	G	6	6	12	0	0	12	0	0
2	20980356	.	T	C	8	9	17	0	1	18	0	0
2	21063794	.	T	A	3	6	9	0	0	9	0	0
2	21064800	.	T	A	5	4	9	0	0	9	0	0
2	21068339	.	A	T	6	3	9	0	0	9	0	0
2	21076466	.	G	T	6	6	12	0	0	12	0	0
2	21076774	.	C	T	11	3	14	0	3	17	0	0
2	21077182	.	G	A	18	13	31	0	2	33	0	0
2	21077208	.	C	G	17	17	34	1	0	35	0	0
2	21077268	.	G	T	14	13	27	1	3	31	0	0
2	21077299	.	C	T	16	15	31	0	0	31	0	0
2	21077385	.	C	T	16	6	22	0	1	23	0	0
2	21077389	.	C	T	1	6	7	0	15	22	0	0
2	21077466	.	C	A	1	3	4	0	0	4	0	0
2	21077967	.	G	A	15	24	39	0	1	40	0	0
2	21079612	.	T	C	20	24	44	0	1	45	0	0
2	21080291	.	G	A	17	20	37	0	0	38	1	0
2	21081087	.	T	A	16	17	33	0	3	36	0	0
2	21082460	.	C	A	24	16	40	0	1	41	0	0
2	21135461	.	T	C	13	7	20	0	0	20	0	0
2	21138516	.	A	G	16	11	27	0	0	27	0	0
2	21151002	.	T	C	15	10	25	0	0	25	0	0
2	21156207	.	T	C	4	5	9	0	0	9	0	0
2	21156809	.	T	A	6	4	10	0	0	10	0	0
2	21165176	.	G	A	14	7	21	0	1	22	0	0
2	21166042	.	A	G	15	14	29	0	0	29	0	0
2	21166252	.	A	G	3	15	18	0	0	18	0	0
2	21167395	.	G	A	8	8	16	0	0	16	0	0
2	21170190	.	C	T	0	7	7	0	2	9	0	0
2	21175143	.	A	G	10	1	11	0	7	18	0	0
2	21179467	.	C	T	15	10	25	0	0	25	0	0
2	21179651	.	A	G	10	16	26	0	0	26	0	0
2	21179866	.	T	G	13	14	27	0	0	27	0	0
2	21179939	.	A	G	24	17	41	0	0	41	0	0
2	21182335	.	T	C	6	10	16	0	0	16	0	0
2	21182345	.	T	C	5	8	13	0	0	13	0	0
2	21182451	.	G	T	5	9	14	0	3	17	0	0
2	21191244	.	C	T	1	2	3	0	0	3	0	0
2	21309539	.	T	A	1	2	3	0	0	3	0	0
2	21309550	.	G	T	1	2	3	0	0	3	0	0
2	21309811	.	C	T	2	2	4	0	0	4	0	0
2	21312440	.	A	C	3	3	6	0	0	6	0	0
2	21317042	.	C	T	5	8	13	0	0	13	0	0
2	21320445	.	T	C	5	5	10	0	0	10	0	0
2	21320759	.	T	A	2	5	7	0	0	7	0	0
2	21320768	.	G	A	4	6	10	0	0	10	0	0
2	21338095	.	G	A	4	2	6	0	0	6	0	0
2	21338146	.	C	A	7	4	11	0	0	11	0	0
2	21340519	.	C	T	7	4	11	0	0	11	0	0
2	21349413	.	C	T	2	2	4	0	0	4	0	0
2	21356392	.	C	T	5	4	9	0	1	10	0	0
2	21367952	.	A	G	7	3	10	0	0	10	0	0
2	21367977	.	C	T	3	2	5	0	0	5	0	0
2	21368006	.	T	C	3	4	7	0	0	7	0	0
2	21371159	.	G	A	4	6	10	0	0	10	0	0
2	21455589	.	A	G	2	2	4	0	1	5	0	0
2	21456950	.	G	A	7	3	10	0	0	10	0	0
2	21459061	.	G	A	3	6	9	0	0	9	0	0
2	21459091	.	G	T	4	6	10	0	0	10	0	0
2	21459100	.	G	A	5	7	12	0	0	12	0	0
2	21459157	.	T	C	9	7	16	0	0	16	0	0
2	21459661	.	C	G	9	5	14	0	1	15	0	0
2	21462185	.	A	G	11	7	18	0	0	18	0	0
2	21462191	.	A	G	12	6	18	0	1	19	0	0
2	21463923	.	A	T	18	17	35	0	0	35	0	0
2	21468732	.	T	G	23	10	33	0	0	33	0	0
2	21468807	.	G	A	21	20	41	0	4	45	0	0
2	21468953	.	C	T	12	15	27	0	0	27	0	0
2	21469080	.	T	G	13	4	17	0	1	18	0	0
2	21469405	.	T	C	12	16	28	0	0	28	0	0
2	21469577	.	A	G	9	6	15	0	2	17	0	0
2	21469579	.	T	G	11	6	17	0	1	18	0	0
2	21469830	.	T	A	5	6	11	1	0	12	0	0
2	21502307	.	C	T	5	5	10	0	0	10	0	0
2	21502540	.	G	C	6	12	18	0	0	18	0	0
2	21605857	.	T	C	4	6	10	0	0	10	0	0
2	21605877	.	G	A	1	3	4	0	2	6	0	0
2	21605937	.	G	T	4	3	7	0	0	7	0	0
2	21608710	.	T	A	15	12	27	0	0	27	0	0
2	21608781	.	T	G	8	4	12	0	1	13	0	0
2	21609104	.	A	T	4	4	8	0	0	8	0	0
2	21609789	.	A	T	6	2	8	0	0	8	0	0
2	21609830	.	T	G	6	3	9	0	0	10	1	0
2	21609872	.	T	A	3	3	6	0	1	7	0	0
2	21610233	.	G	A	6	7	13	0	1	14	0	0
2	21612356	.	T	G	6	5	11	0	4	15	0	0
2	21613008	.	T	C	4	4	8	0	1	9	0	0
2	21620412	.	A	G	3	5	8	0	0	8	0	0
2	21620469	.	T	C	5	0	5	0	11	16	0	0
2	21620691	.	G	A	9	11	20	0	0	20	0	0
2	21620856	.	C	T	9	7	16	0	0	16	0	0
2	21621151	.	G	A	7	4	11	0	0	11	0	0
2	21621400	.	C	T	0	7	7	0	3	10	0	0
2	21621423	.	C	T	0	5	5	0	4	9	0	0
2	21621507	.	T	C	9	5	14	0	0	14	0	0
2	21621528	.	A	G	8	4	12	0	0	12	0	0
2	21621606	.	C	T	7	3	10	0	0	10	0	0
2	21625423	.	T	G	1	4	5	0	0	5	0	0
2	21715416	.	C	G	1	0	1	0	3	4	0	0
2	21766212	.	A	G	9	6	15	0	1	16	0	0
2	21766785	.	G	A	8	12	20	0	0	20	0	0
2	21767244	.	A	T	7	6	13	0	1	14	0	0
2	21768392	.	A	C	4	4	8	0	0	8	0	0
2	21768821	.	T	A	4	6	10	0	3	13	0	0
2	21769256	.	A	G	2	4	6	0	0	6	0	0
2	21769386	.	T	A	3	2	5	0	0	5	0	0
2	21769928	.	A	G	3	3	6	0	0	6	0	0
2	21769947	.	A	G	3	4	7	0	0	7	0	0
2	21770775	.	G	A	2	3	5	0	0	5	0	0
2	21770888	.	T	C	7	8	15	0	0	15	0	0
2	21771091	.	G	T	4	4	8	0	0	8	0	0
2	21771245	.	A	T	4	6	10	0	0	10	0	0
2	21772099	.	G	A	5	3	8	0	0	8	0	0
2	21784167	.	G	A	2	3	5	0	0	5	0	0
2	21806462	.	G	T	2	2	4	0	0	4	0	0
2	21807265	.	T	G	1	4	5	0	0	5	0	0
2	21821936	.	A	G	25	26	51	0	2	53	0	0
2	21822304	.	A	G	23	16	39	0	5	44	0	0
2	21823100	.	C	A	33	34	67	0	0	67	0	0
2	21827276	.	A	G	34	23	57	0	3	60	0	0
2	21855253	.	G	A	3	8	11	0	6	17	0	0
2	21861735	.	T	G	11	1	12	0	10	22	0	0
2	21862511	.	C	T	15	7	22	0	1	23	0	0
2	21869023	.	T	C	11	16	27	0	1	28	0	0
2	21877560	.	G	A	13	8	21	0	1	22	0	0
2	21877743	.	T	G	9	9	18	0	0	18	0	0
2	21877774	.	A	G	9	9	18	0	1	19	0	0
2	21877795	.	T	C	9	5	14	0	0	14	0	0
2	21877878	.	G	A	5	3	8	0	1	9	0	0
2	21877931	.	T	A	7	5	12	0	0	12	0	0
2	21878053	.	T	C	17	9	26	0	2	28	0	0
2	21878147	.	C	T	17	9	26	0	2	28	0	0
2	21878155	.	T	A	15	11	26	0	0	26	0	0
2	21878197	.	T	C	21	14	35	0	2	37	0	0
2	21878258	.	A	T	16	15	31	0	1	32	0	0
2	21878462	.	T	C	12	14	26	0	0	26	0	0
2	21983059	.	C	T	5	10	15	0	0	15	0	0
2	21983064	.	T	G	5	0	5	0	9	14	0	0
2	22058071	.	A	G	11	0	11	0	15	26	0	0
2	22058098	.	C	T	10	14	24	0	0	24	0	0
2	22058200	.	C	T	6	8	14	0	3	17	0	0
2	22071062	.	A	C	9	16	25	0	0	25	0	0
2	22073020	.	A	G	10	16	26	0	1	27	0	0
2	22093084	.	A	G	13	0	13	0	13	26	0	0
2	22101657	.	C	T	18	25	43	0	2	45	0	0
2	22101699	.	A	C	20	25	45	0	1	46	0	0
2	22104292	.	C	T	27	13	40	0	0	40	0	0
2	22104309	.	C	G	23	12	35	0	1	36	0	0
2	22104912	.	T	C	17	15	32	0	0	32	0	0
2	22104999	.	A	G	18	20	38	0	0	38	0	0
2	22208514	.	G	T	2	5	7	0	0	7	0	0
2	22208638	.	A	G	8	10	18	0	1	19	0	0
2	22208767	.	G	A	11	7	18	0	1	19	0	0
2	22208778	.	A	G	13	10	23	0	1	24	0	0
2	22209722	.	C	T	7	11	18	0	1	19	0	0
2	22209743	.	A	G	4	10	14	0	1	15	0	0
2	22209914	.	C	T	4	12	16	0	8	24	0	0
2	22209943	.	G	C	11	16	27	0	4	31	0	0
2	22210137	.	T	C	6	0	6	0	11	17	0	0
2	22353522	.	T	C	13	0	13	0	14	27	0	0
2	22353662	.	A	C	8	16	24	0	2	26	0	0
2	22353722	.	T	A	20	26	46	0	0	46	0	0
2	22353768	.	A	C	21	25	46	1	0	47	0	0
2	22353769	.	A	C	21	25	46	1	0	47	0	0
2	22353993	.	T	C	17	18	35	0	1	36	0	0
2	22362347	.	T	C	22	0	22	0	16	38	0	0
2	22388748	.	C	T	3	2	5	0	0	5	0	0
2	22396421	.	G	A	3	3	6	0	0	6	0	0
2	22396425	.	A	G	3	3	6	0	0	6	0	0
2	22397461	.	C	T	2	5	7	0	0	7	0	0
2	22397527	.	G	T	1	6	7	0	0	7	0	0
2	22397534	.	A	G	1	4	5	0	0	5	0	0
2	22397564	.	G	A	2	4	6	0	1	7	0	0
2	22397571	.	T	C	2	4	6	0	0	6	0	0
2	22480272	.	T	C	10	0	10	0	7	17	0	0
2	22480321	.	G	T	8	4	12	0	0	12	0	0
2	22480759	.	G	A	19	16	35	0	3	38	0	0
2	22483222	.	G	A	21	15	36	0	1	37	0	0
2	22483351	.	A	G	11	14	25	0	1	26	0	0
2	22483423	.	C	T	6	11	17	0	1	18	0	0
2	22483444	.	A	G	10	9	19	0	0	19	0	0
2	22486393	.	A	G	7	6	13	0	0	13	0	0
2	22507132	.	T	A	16	9	25	0	3	28	0	0
2	22516914	.	T	C	5	2	7	0	1	8	0	0
2	22517039	.	G	A	6	2	8	0	0	8	0	0
2	22522073	.	A	G	5	2	7	0	0	7	0	0
2	22522211	.	G	T	1	3	4	0	0	4	0	0
2	22522472	.	A	G	1	3	4	0	0	4	0	0
2	22599787	.	C	T	3	7	10	0	0	10	0	0
2	22602424	.	T	C	14	7	21	0	1	22	0	0
2	22602808	.	C	T	16	19	35	0	0	35	0	0
2	22612623	.	T	C	18	10	28	0	1	29	0	0
2	22614355	.	G	A	8	9	17	0	0	17	0	0
2	22614529	.	C	T	8	8	16	0	1	17	0	0
2	22614568	.	A	G	9	7	16	2	1	19	0	0
2	22614959	.	A	T	5	10	15	0	2	17	0	0
2	22614988	.	T	C	7	13	20	0	2	22	0	0
2	22615055	.	T	A	12	11	23	0	1	24	0	0
2	22615155	.	G	A	2	3	5	0	0	5	0	0
2	22617932	.	G	A	22	27	49	1	4	54	0	0
2	22626878	.	T	A	21	16	37	1	0	38	0	0
2	22628981	.	A	G	23	14	37	0	1	38	0	0
2	22629684	.	C	T	4	13	17	0	24	41	0	0
2	22633869	.	G	A	22	24	46	0	0	46	0	0
2	22634040	.	T	G	20	19	39	1	1	41	0	0
2	22634070	.	A	G	23	18	41	1	0	42	0	0
2	22656651	.	G	A	11	9	20	0	0	20	0	0
2	22656708	.	T	C	7	5	12	0	1	13	0	0
2	22702505	.	C	G	6	6	12	0	1	13	0	0
2	22711898	.	T	G	7	9	16	0	0	16	0	0
2	22716770	.	T	C	8	12	20	0	0	20	0	0
2	22717198	.	A	G	13	5	18	0	0	18	0	0
2	22718895	.	T	A	12	13	25	0	1	26	0	0
2	22719145	.	A	G	11	0	11	0	15	26	0	0
2	22721695	.	T	C	13	13	26	0	2	28	0	0
2	22721734	.	A	T	10	12	22	0	1	23	0	0
2	22724661	.	T	C	10	5	15	0	1	16	0	0
2	22733494	.	A	T	8	5	13	0	1	14	0	0
2	22733715	.	T	C	10	12	22	0	0	22	0	0
2	22742027	.	T	A	14	12	26	0	5	31	0	0
2	22742034	.	A	C	16	14	30	0	0	30	0	0
2	22745690	.	C	T	16	11	27	1	0	28	0	0
2	22749202	.	A	C	12	15	27	0	3	30	0	0
2	22749221	.	A	G	15	0	15	0	18	33	0	0
2	22756245	.	T	G	22	26	48	0	1	49	0	0
2	22756289	.	A	G	27	22	49	0	1	50	0	0
2	22756528	.	C	T	30	16	46	0	2	48	0	0
2	22795615	.	A	G	22	15	37	0	0	37	0	0
2	22801748	.	T	C	30	26	56	0	3	59	0	0
2	22801899	.	A	T	29	15	44	0	6	50	0	0
2	22802030	.	G	A	3	28	31	2	26	59	0	0
2	22803110	.	T	A	30	18	48	0	1	50	1	0
2	22803190	.	C	T	20	26	46	0	2	48	0	0
2	22803366	.	C	T	22	30	52	0	4	56	0	0
2	22803467	.	A	G	36	2	38	0	21	59	0	0
2	22857403	.	A	G	2	2	4	0	0	4	0	0
2	22860541	.	C	T	1	2	3	0	1	4	0	0
2	22932584	.	C	T	2	3	5	0	0	5	0	0
2	22932931	.	A	G	3	2	5	0	0	5	0	0
2	22933242	.	A	G	3	5	8	0	0	8	0	0
2	22933539	.	G	A	4	6	10	0	1	11	0	0
2	22933554	.	G	A	3	9	12	0	0	12	0	0
2	22935753	.	A	G	4	5	9	0	0	9	0	0
2	22935766	.	A	T	4	3	7	0	0	7	0	0
2	22935792	.	A	G	4	4	8	0	0	8	0	0
2	22944464	.	G	A	6	4	10	0	0	10	0	0
2	22957590	.	C	T	0	2	2	0	4	6	0	0
2	22957728	.	T	C	1	3	4	0	0	4	0	0
2	22957737	.	C	T	0	3	3	0	1	4	0	0
2	22962013	.	A	G	1	2	3	0	0	3	0	0
2	22962175	.	C	T	1	2	3	0	0	3	0	0
2	22965169	.	T	C	4	2	6	0	0	6	0	0
2	22966030	.	C	T	2	2	4	0	0	4	0	0
2	22970413	.	G	A	5	7	12	0	1	13	0	0
2	22970603	.	A	C	4	4	8	0	0	8	0	0
2	22970683	.	C	G	6	2	8	0	1	9	0	0
2	22970707	.	G	A	4	2	6	0	0	6	0	0
2	22979768	.	G	T	5	4	9	0	0	9	0	0
2	22979805	.	G	A	6	3	9	0	0	9	0	0
2	22980020	.	G	C	5	0	5	0	6	11	0	0
2	22986358	.	C	A	1	7	8	0	3	11	0	0
2	22986552	.	T	C	3	2	5	0	0	5	0	0
2	22994264	.	T	G	4	4	8	0	0	8	0	0
2	22994412	.	C	T	6	9	15	0	0	15	0	0
2	22996520	.	A	T	12	6	18	0	0	18	0	0
2	23001533	.	G	A	8	9	17	0	0	17	0	0
2	23001638	.	G	T	13	17	30	0	0	30	0	0
2	23012508	.	C	T	1	3	4	0	0	4	0	0
2	23013730	.	C	A	1	4	5	0	1	6	0	0
2	23014154	.	G	A	2	4	6	0	0	6	0	0
2	23020879	.	A	C	1	3	4	0	0	4	0	0
2	23020948	.	C	T	6	2	8	0	0	8	0	0
2	23022896	.	A	G	4	7	11	0	0	11	0	0
2	23023465	.	G	A	2	4	6	0	0	6	0	0
2	23023524	.	G	T	1	3	4	0	0	4	0	0
2	23023535	.	A	T	1	2	3	0	0	3	0	0
2	23023675	.	G	A	2	2	4	0	0	4	0	0
2	23023890	.	G	T	3	4	7	0	0	7	0	0
2	23024697	.	T	A	2	3	5	0	0	5	0	0
2	23048494	.	T	G	3	12	15	0	0	15	0	0
2	23061791	.	T	C	7	9	16	0	1	17	0	0
2	23071236	.	G	A	10	12	22	0	1	23	0	0
2	23073536	.	A	G	18	11	29	1	1	31	0	0
2	23077432	.	A	G	14	8	22	2	0	24	0	0
2	23077839	.	A	C	11	15	26	0	0	26	0	0
2	23078082	.	A	G	6	6	12	0	1	13	0	0
2	23078244	.	T	C	18	27	45	0	0	45	0	0
2	23083308	.	T	C	6	3	9	0	1	10	0	0
2	23083338	.	C	T	8	4	12	0	0	12	0	0
2	23085242	.	A	G	4	0	4	0	2	6	0	0
2	23098385	.	A	T	1	3	4	1	0	5	0	0
2	23098464	.	A	G	3	2	5	0	0	5	0	0
2	23098472	.	A	T	3	2	5	0	0	5	0	0
2	23098590	.	A	G	4	0	4	0	4	8	0	0
2	23098591	.	C	G	4	4	8	0	0	8	0	0
2	23099307	.	T	C	1	2	3	0	0	3	0	0
2	23099369	.	G	C	4	3	7	0	0	7	0	0
2	23223037	.	C	T	10	11	21	0	0	21	0	0
2	23226584	.	C	T	6	16	22	0	0	22	0	0
2	23227373	.	G	A	4	5	9	0	0	9	0	0
2	23227385	.	A	G	1	5	6	0	1	7	0	0
2	23232881	.	A	G	4	8	12	0	0	12	0	0
2	23232884	.	T	C	4	8	12	0	0	12	0	0
2	23254074	.	A	G	11	6	17	0	0	17	0	0
2	23263294	.	T	A	14	7	21	0	1	22	0	0
2	23292123	.	A	T	13	12	25	0	1	26	0	0
2	23292262	.	G	A	11	8	19	0	1	20	0	0
2	23292429	.	A	T	11	12	23	0	1	24	0	0
2	23292516	.	G	A	0	9	9	0	10	19	0	0
2	23292549	.	C	A	7	10	17	0	0	17	0	0
2	23292584	.	C	A	4	8	12	0	2	14	0	0
2	23292690	.	T	A	10	7	17	0	2	19	0	0
2	23293123	.	G	C	8	9	17	0	1	18	0	0
2	23293230	.	A	T	15	7	22	0	2	24	0	0
2	23293246	.	T	C	17	6	23	0	0	23	0	0
2	23361784	.	A	T	5	3	8	0	1	9	0	0
2	23379480	.	G	C	2	2	4	0	0	4	0	0
2	23379532	.	G	A	9	3	12	0	0	12	0	0
2	23379588	.	C	T	6	7	13	0	0	13	0	0
2	23379757	.	T	A	1	3	4	0	0	4	0	0
2	23381056	.	A	G	3	8	11	0	0	11	0	0
2	23622823	.	T	C	1	2	3	0	0	3	0	0
2	23623139	.	A	T	3	3	6	0	0	6	0	0
2	23644168	.	C	T	3	3	6	0	0	6	0	0
2	23701680	.	G	A	1	5	6	0	0	6	0	0
2	23707161	.	G	T	1	2	3	0	0	3	0	0
2	23707408	.	C	A	8	6	14	0	0	14	0	0
2	23707444	.	T	A	5	8	13	0	1	14	0	0
2	23711771	.	A	G	3	0	3	0	2	5	0	0
2	23713763	.	G	A	3	7	10	0	0	10	0	0
2	23713775	.	T	C	2	6	8	0	1	9	0	0
2	23716575	.	T	C	3	6	9	0	1	10	0	0
2	23716617	.	C	T	5	8	13	0	0	13	0	0
2	23725075	.	G	A	8	4	12	0	0	12	0	0
2	23725144	.	T	C	11	6	17	0	0	17	0	0
2	23725184	.	C	A	10	5	15	0	0	15	0	0
2	23725239	.	C	T	8	4	12	0	0	12	0	0
2	23725834	.	G	C	4	4	8	0	2	10	0	0
2	23725872	.	T	C	5	4	9	0	2	11	0	0
2	23725886	.	C	A	3	4	7	0	3	10	0	0
2	23726043	.	A	G	10	4	14	0	0	14	0	0
2	23726099	.	A	T	9	10	19	0	0	19	0	0
2	23726155	.	C	A	10	10	20	0	0	20	0	0
2	23726162	.	C	A	11	11	22	0	0	22	0	0
2	23726230	.	A	T	9	4	13	0	1	14	0	0
2	23796655	.	G	A	1	2	3	0	0	3	0	0
2	23800654	.	G	A	1	3	4	0	0	4	0	0
2	23803100	.	C	T	1	3	4	0	0	4	0	0
2	23803419	.	G	C	1	2	3	0	0	3	0	0
2	23818145	.	T	C	1	2	3	0	0	3	0	0
2	23818207	.	C	A	1	2	3	0	0	3	0	0
2	23818209	.	A	T	1	2	3	0	0	3	0	0
2	23818271	.	G	A	1	4	5	0	5	10	0	0
2	23819471	.	T	G	1	0	1	0	5	6	0	0
2	23819571	.	A	G	2	2	4	0	1	5	0	0
2	23819603	.	T	C	4	4	8	0	0	8	0	0
2	23819640	.	T	A	2	4	6	0	0	6	0	0
2	23819862	.	A	C	2	3	5	0	0	5	0	0
2	23937310	.	T	C	2	2	4	0	0	4	0	0
2	23937631	.	T	G	3	4	7	0	1	8	0	0
2	24167949	.	C	T	2	2	4	0	0	4	0	0
2	24168259	.	C	T	1	4	5	0	0	5	0	0
2	24168260	.	A	G	1	4	5	0	0	5	0	0
2	24188637	.	G	A	8	4	12	0	1	13	0	0
2	24199338	.	C	A	15	23	38	0	2	40	0	0
2	24218922	.	A	T	27	19	46	0	1	47	0	0
2	24219115	.	G	A	13	22	35	0	3	38	0	0
2	24222069	.	A	C	30	30	60	0	3	63	0	0
2	24223991	.	A	G	16	25	41	0	13	54	0	0
2	24238635	.	A	T	18	25	43	0	1	44	0	0
2	24238809	.	A	G	26	18	44	0	0	44	0	0
2	24248498	.	C	T	34	25	59	0	3	62	0	0
2	24248619	.	T	G	41	18	59	0	1	60	0	0
2	24248657	.	A	G	40	12	52	0	5	57	0	0
2	24248677	.	A	T	40	13	53	0	6	59	0	0
2	24248702	.	T	C	39	17	56	0	0	56	0	0
2	24248767	.	T	C	33	15	48	0	1	49	0	0
2	24248768	.	A	G	33	1	34	0	15	49	0	0
2	24248809	.	C	T	28	21	49	0	3	52	0	0
2	24248871	.	A	G	24	0	24	0	28	52	0	0
2	24249044	.	A	C	29	24	53	0	2	55	0	0
2	24249083	.	T	A	27	9	36	0	3	39	0	0
2	24249299	.	A	G	30	26	56	0	0	56	0	0
2	24249320	.	A	G	27	0	27	0	27	54	0	0
2	24249397	.	G	T	5	24	29	0	34	63	0	0
2	24249411	.	T	A	31	25	56	0	4	61	1	0
2	24249516	.	A	G	30	2	32	0	22	54	0	0
2	24249662	.	A	G	29	19	48	0	1	49	0	0
2	24249669	.	A	G	26	0	26	0	22	48	0	0
2	24250001	.	G	T	10	15	25	0	0	25	0	0
2	24250097	.	T	C	9	21	30	0	0	30	0	0
2	24250140	.	T	C	6	17	23	0	2	25	0	0
2	24250147	.	G	A	2	15	17	0	8	25	0	0
2	24250212	.	G	C	8	5	13	0	0	13	0	0
2	24250303	.	C	T	25	10	35	0	1	36	0	0
2	24250419	.	C	T	22	20	42	0	0	44	2	0
2	24250577	.	A	T	30	26	56	0	0	56	0	0
2	24250625	.	T	A	30	20	50	0	4	54	0	0
2	24250681	.	T	C	35	22	57	0	2	59	0	0
2	24250879	.	T	G	30	30	60	2	1	63	0	0
2	24250972	.	C	A	29	27	56	0	5	61	0	0
2	24251690	.	G	A	27	31	58	0	1	59	0	0
2	24251909	.	A	T	42	28	70	0	1	73	2	0
2	24252078	.	A	T	42	17	59	0	6	65	0	0
2	24252088	.	C	T	45	16	61	0	0	61	0	0
2	24252192	.	T	A	33	18	51	0	2	53	0	0
2	24252196	.	G	T	7	15	22	0	32	54	0	0
2	24310739	.	G	T	5	9	14	0	0	14	0	0
2	24310850	.	G	C	12	12	24	0	0	24	0	0
2	24310897	.	G	A	22	19	41	0	0	41	0	0
2	24311151	.	G	A	10	3	13	0	0	13	0	0
2	24311218	.	T	A	18	9	27	0	0	27	0	0
2	24311296	.	G	C	16	14	30	0	1	31	0	0
2	24311703	.	A	G	17	20	37	0	0	37	0	0
2	24313884	.	T	C	9	9	18	0	0	18	0	0
2	24313896	.	G	A	8	11	19	0	0	19	0	0
2	24314221	.	T	C	3	7	10	0	0	10	0	0
2	24316503	.	C	T	0	8	8	0	17	25	0	0
2	24317537	.	G	A	6	12	18	0	0	18	0	0
2	24319740	.	A	G	9	15	24	0	0	24	0	0
2	24320173	.	C	T	11	6	17	0	1	18	0	0
2	24321853	.	T	C	8	2	10	0	7	17	0	0
2	24322189	.	G	C	20	9	29	0	0	29	0	0
2	24326455	.	A	G	10	14	24	0	0	24	0	0
2	24326509	.	G	A	7	5	12	0	0	12	0	0
2	24328453	.	A	T	5	4	9	0	0	9	0	0
2	24335246	.	G	A	4	7	11	0	0	11	0	0
2	24348609	.	T	G	9	5	14	0	1	15	0	0
2	24348915	.	G	A	6	4	10	0	0	10	0	0
2	24376282	.	T	A	2	3	5	0	0	5	0	0
2	24376502	.	T	C	3	6	9	0	0	9	0	0
2	24376514	.	C	T	5	4	9	0	0	9	0	0
2	24385210	.	C	T	4	2	6	0	0	6	0	0
2	24385402	.	A	G	5	5	10	0	0	10	0	0
2	24385447	.	T	C	5	8	13	0	0	13	0	0
2	24385685	.	T	C	5	5	10	0	0	10	0	0
2	24385724	.	G	A	9	3	12	0	0	12	0	0
2	24385837	.	A	G	3	0	3	1	4	8	0	0
2	24385887	.	A	T	1	1	2	1	3	8	2	0
2	24385888	.	G	T	0	5	5	1	2	8	0	0
2	24410851	.	C	T	18	15	33	0	0	33	0	0
2	24410882	.	G	A	19	15	34	0	0	34	0	0
2	24411053	.	A	G	19	16	35	0	0	35	0	0
2	24411056	.	C	T	3	16	19	0	18	37	0	0
2	24411501	.	T	G	13	18	31	0	1	32	0	0
2	24411781	.	T	A	20	16	36	0	1	37	0	0
2	24411989	.	C	T	6	4	10	0	0	10	0	0
2	24412097	.	A	G	17	21	38	0	0	38	0	0
2	24412107	.	G	C	18	1	19	0	18	37	0	0
2	24412150	.	T	C	23	0	23	0	13	36	0	0
2	24412262	.	G	A	13	19	32	0	2	34	0	0
2	24412856	.	A	G	6	6	12	0	1	13	0	0
2	24412947	.	A	T	4	4	8	0	1	9	0	0
2	24413155	.	C	T	11	14	25	0	2	27	0	0
2	24413710	.	T	C	6	10	16	0	0	16	0	0
2	24413882	.	T	C	6	11	17	0	0	17	0	0
2	24414032	.	G	C	8	10	18	0	2	20	0	0
2	24416775	.	A	G	13	21	34	0	1	35	0	0
2	24421686	.	G	A	11	9	20	0	1	21	0	0
2	24421816	.	G	A	9	8	17	0	0	17	0	0
2	24432661	.	C	T	11	11	22	0	0	22	0	0
2	24461235	.	G	A	5	3	8	0	0	8	0	0
2	24508107	.	C	T	28	30	58	0	3	61	0	0
2	24541478	.	G	A	0	2	2	0	1	3	0	0
2	24548812	.	C	T	1	2	3	0	0	3	0	0
2	24548817	.	G	A	1	2	3	0	0	3	0	0
2	24549586	.	A	T	2	2	4	0	0	4	0	0
2	24558570	.	C	T	7	7	14	0	0	14	0	0
2	24558677	.	G	A	5	6	11	0	0	11	0	0
2	24558682	.	T	A	6	5	11	0	0	11	0	0
2	24559091	.	A	T	3	2	5	0	0	5	0	0
2	24560167	.	T	C	4	0	4	0	8	12	0	0
2	24560218	.	G	C	2	1	3	0	7	10	0	0
2	24560323	.	T	A	5	5	10	0	0	10	0	0
2	24560359	.	G	A	6	9	15	0	0	15	0	0
2	24560881	.	C	T	3	2	5	0	0	5	0	0
2	24561244	.	A	G	8	3	11	0	0	11	0	0
2	24578272	.	A	G	2	4	6	0	0	6	0	0
2	24578308	.	C	T	1	5	6	0	1	7	0	0
2	24594632	.	A	T	5	4	9	0	0	9	0	0
2	24646290	.	A	G	3	0	3	0	3	6	0	0
2	24650878	.	A	T	2	4	6	0	0	6	0	0
2	24664541	.	G	A	0	2	2	0	2	4	0	0
2	24664557	.	C	T	2	2	4	0	0	4	0	0
2	24672384	.	G	A	0	7	7	0	5	12	0	0
2	24676875	.	T	C	4	6	10	0	0	10	0	0
2	24677139	.	A	G	9	7	16	0	1	17	0	0
2	24683093	.	A	G	7	6	13	0	10	23	0	0
2	24683311	.	G	A	15	16	31	0	1	32	0	0
2	24737749	.	C	T	3	6	9	0	1	10	0	0
2	24737776	.	C	T	3	7	10	0	2	12	0	0
2	24740121	.	G	C	0	7	7	0	6	13	0	0
2	24740354	.	T	C	1	3	4	0	0	4	0	0
2	24748698	.	G	T	1	3	4	0	0	4	0	0
2	24748736	.	A	G	3	2	5	0	0	5	0	0
2	24748959	.	T	A	5	4	9	0	0	9	0	0
2	24749438	.	A	G	8	3	11	0	0	11	0	0
2	24749467	.	G	A	8	5	13	0	0	13	0	0
2	24749582	.	T	C	7	8	15	0	1	16	0	0
2	24751165	.	T	C	3	4	7	0	1	8	0	0
2	24751526	.	G	A	2	3	5	0	0	5	0	0
2	24751572	.	A	G	5	9	14	0	1	15	0	0
2	24751888	.	A	G	4	0	4	0	10	14	0	0
2	24751948	.	C	T	6	8	14	0	1	15	0	0
2	24751986	.	T	G	2	1	3	0	9	12	0	0
2	24751991	.	A	G	2	8	10	0	1	11	0	0
2	24752048	.	C	T	4	8	12	0	1	13	0	0
2	24752071	.	A	G	6	6	12	0	1	13	0	0
2	24752181	.	T	A	12	5	17	0	0	17	0	0
2	24752193	.	C	T	13	6	19	0	1	20	0	0
2	24752293	.	C	T	12	5	17	0	0	17	0	0
2	24752385	.	C	T	5	13	18	0	1	19	0	0
2	24752391	.	A	G	6	14	20	0	0	20	0	0
2	24752842	.	G	T	2	7	9	0	0	9	0	0
2	24753980	.	T	A	7	2	9	0	0	9	0	0
2	24754043	.	G	T	4	3	7	0	0	7	0	0
2	24754044	.	T	A	4	3	7	0	0	7	0	0
2	24754465	.	A	G	4	4	8	0	0	8	0	0
2	24754796	.	A	C	15	12	27	0	1	28	0	0
2	24755018	.	T	C	13	13	26	0	1	27	0	0
2	24766980	.	C	T	1	7	8	0	0	8	0	0
2	24767285	.	T	C	3	2	5	0	0	5	0	0
2	24767291	.	C	T	2	2	4	0	0	4	0	0
2	24770755	.	G	C	2	5	7	0	0	7	0	0
2	24770898	.	T	C	2	2	4	0	2	6	0	0
2	24770928	.	A	G	2	0	2	0	4	6	0	0
2	24773724	.	A	G	3	2	5	0	0	5	0	0
2	24773726	.	G	A	0	2	2	0	3	5	0	0
2	24778317	.	C	T	2	3	5	0	1	6	0	0
2	24860969	.	A	G	2	2	4	0	0	4	0	0
2	24862691	.	T	C	1	3	4	0	0	4	0	0
2	24863306	.	A	T	6	3	9	0	0	9	0	0
2	24863597	.	T	C	3	4	7	0	0	7	0	0
2	24865360	.	T	C	7	6	13	0	2	15	0	0
2	24865961	.	A	G	3	6	9	0	0	9	0	0
2	24866075	.	G	C	6	10	16	0	0	16	0	0
2	24866568	.	C	T	3	4	7	0	0	7	0	0
2	24875201	.	T	C	12	12	24	0	1	25	0	0
2	24877010	.	A	G	9	9	18	0	0	18	0	0
2	24877227	.	C	T	10	15	25	0	0	25	0	0
2	24878026	.	G	T	1	17	18	0	7	25	0	0
2	24878211	.	C	T	13	12	25	0	0	25	0	0
2	24878265	.	G	T	5	6	11	0	0	11	0	0
2	24943717	.	C	T	13	6	19	0	4	23	0	0
2	24943855	.	C	A	16	12	28	0	0	28	0	0
2	24944067	.	A	G	16	0	16	0	9	25	0	0
2	24944112	.	T	G	11	21	32	0	1	33	0	0
2	24944485	.	T	G	7	9	16	0	3	19	0	0
2	24944487	.	G	A	7	12	19	0	0	19	0	0
2	24947372	.	T	C	4	0	4	0	9	13	0	0
2	24952607	.	T	C	2	4	6	0	1	7	0	0
2	24991149	.	G	A	16	9	25	0	0	25	0	0
2	24991153	.	T	C	17	9	26	0	0	26	0	0
2	24991476	.	G	A	16	15	31	0	1	32	0	0
2	24991564	.	A	C	17	1	18	0	12	31	1	0
2	24991573	.	A	G	18	13	31	0	0	31	0	0
2	24991639	.	G	A	11	10	21	0	0	21	0	0
2	24991825	.	G	A	22	12	34	0	3	37	0	0
2	24992002	.	T	C	11	0	11	0	5	16	0	0
2	24992035	.	A	C	14	6	20	0	0	20	0	0
2	24992110	.	G	A	13	15	28	0	1	29	0	0
2	24992185	.	T	C	12	13	25	0	0	25	0	0
2	24992242	.	C	T	1	15	16	0	10	26	0	0
2	24992352	.	G	A	13	13	26	0	0	26	0	0
2	24992407	.	G	A	12	13	25	0	0	25	0	0
2	24992422	.	G	A	11	20	31	0	1	32	0	0
2	24996402	.	G	C	12	9	21	0	0	21	0	0
2	25076304	.	G	A	5	2	7	0	0	7	0	0
2	25081243	.	T	C	1	2	3	0	0	3	0	0
2	25086854	.	G	A	3	6	9	0	0	9	0	0
2	25087019	.	G	T	0	6	6	0	1	7	0	0
2	25095096	.	T	C	2	2	4	0	0	4	0	0
2	25095177	.	T	C	2	5	7	0	0	7	0	0
2	25097576	.	T	G	4	6	10	0	1	11	0	0
2	25097582	.	T	C	5	5	10	0	0	10	0	0
2	25099926	.	T	C	6	4	10	0	0	10	0	0
2	25100106	.	A	G	7	1	8	0	7	15	0	0
2	25101160	.	A	G	12	0	12	0	7	19	0	0
2	25102571	.	C	T	9	3	12	0	1	13	0	0
2	25104866	.	A	G	8	8	16	0	0	16	0	0
2	25105482	.	G	A	5	5	10	0	1	11	0	0
2	25105507	.	G	C	2	3	5	0	3	8	0	0
2	25105586	.	C	T	7	5	12	0	1	13	0	0
2	25105612	.	T	C	8	6	14	0	0	14	0	0
2	25105681	.	G	T	10	5	15	0	0	15	0	0
2	25105683	.	C	T	10	5	15	0	1	16	0	0
2	25105716	.	T	C	9	12	21	0	0	21	0	0
2	25106244	.	A	T	2	6	8	0	1	9	0	0
2	25106477	.	G	A	6	12	18	0	1	19	0	0
2	25106508	.	G	C	6	10	16	0	1	17	0	0
2	25106671	.	A	C	5	2	7	0	0	7	0	0
2	25106772	.	T	A	10	8	18	0	0	18	0	0
2	25106795	.	G	A	7	9	16	0	0	16	0	0
2	25106874	.	A	C	4	6	10	0	0	10	0	0
2	25107571	.	G	T	1	3	4	0	0	4	0	0
2	25107591	.	A	G	2	3	5	0	0	5	0	0
2	25107673	.	T	G	9	6	15	0	0	15	0	0
2	25107851	.	G	A	10	12	22	0	1	23	0	0
2	25107869	.	C	T	13	13	26	0	0	26	0	0
2	25107942	.	C	A	13	6	19	0	2	21	0	0
2	25108042	.	A	G	19	6	25	0	0	25	0	0
2	25108137	.	C	T	14	11	25	0	1	26	0	0
2	25108377	.	T	A	5	14	19	0	0	19	0	0
2	25108597	.	T	A	2	3	5	0	0	5	0	0
2	25108633	.	C	T	0	8	8	0	2	10	0	0
2	25108726	.	T	C	12	0	12	0	9	21	0	0
2	25118023	.	A	G	4	4	8	0	0	8	0	0
2	25119637	.	A	G	9	10	19	0	0	19	0	0
2	25119667	.	G	T	9	8	17	0	0	17	0	0
2	25119950	.	T	G	3	7	10	0	1	11	0	0
2	25124650	.	T	G	4	3	7	0	0	7	0	0
2	25125073	.	G	A	3	3	6	0	0	6	0	0
2	25127042	.	G	T	5	3	8	0	0	8	0	0
2	25127219	.	T	C	2	4	6	0	0	6	0	0
2	25127261	.	G	T	0	6	6	0	3	9	0	0
2	25127897	.	T	C	4	3	7	0	0	7	0	0
2	25128328	.	G	A	2	3	5	0	0	5	0	0
2	25128458	.	C	T	3	3	6	0	0	6	0	0
2	25128668	.	C	T	7	6	13	0	0	13	0	0
2	25128920	.	G	T	4	3	7	0	0	7	0	0
2	25128934	.	A	G	4	7	11	0	0	11	0	0
2	25128997	.	C	G	6	1	7	0	5	12	0	0
2	25129116	.	A	T	1	4	5	0	0	5	0	0
2	25247634	.	A	G	2	4	6	0	0	6	0	0
2	25247755	.	T	A	3	3	6	0	1	7	0	0
2	25247769	.	A	C	2	3	5	0	0	5	0	0
2	25280969	.	T	C	2	5	7	0	0	7	0	0
2	25281138	.	G	A	1	3	4	0	0	4	0	0
2	25291177	.	G	T	1	5	6	0	0	6	0	0
2	25540582	.	C	T	1	2	3	0	0	3	0	0
2	25540691	.	T	A	2	2	4	0	0	4	0	0
2	25541483	.	T	C	4	4	8	0	0	8	0	0
2	25541924	.	C	T	2	2	4	0	1	5	0	0
2	25542867	.	A	T	4	4	8	0	0	8	0	0
2	25542890	.	C	A	9	2	11	0	3	14	0	0
2	25771840	.	A	G	2	6	8	0	1	9	0	0
2	25781601	.	G	A	2	2	4	0	0	4	0	0
2	25781640	.	C	T	1	4	5	0	0	5	0	0
2	25781757	.	C	T	1	3	4	0	0	4	0	0
2	25786170	.	A	C	2	4	6	0	1	7	0	0
2	25809736	.	C	T	4	3	7	0	0	7	0	0
2	25814694	.	C	T	3	6	9	0	1	10	0	0
2	25815329	.	G	C	5	7	12	0	0	12	0	0
2	25815407	.	A	T	5	4	9	0	3	12	0	0
2	25815452	.	G	A	10	4	14	0	2	16	0	0
2	25815758	.	C	T	5	7	12	0	1	13	0	0
2	25929801	.	C	T	5	4	9	0	0	9	0	0
2	25947351	.	C	T	3	9	12	0	0	12	0	0
2	25947408	.	G	T	4	4	8	0	0	8	0	0
2	25947531	.	C	T	3	2	5	0	1	6	0	0
2	25947585	.	T	C	1	5	6	0	1	7	0	0
2	25947593	.	G	A	0	5	5	0	1	6	0	0
2	25947651	.	C	T	2	3	5	0	0	5	0	0
2	25952953	.	T	C	4	7	11	0	0	11	0	0
2	25952983	.	C	T	3	7	10	0	0	10	0	0
2	25963401	.	T	A	7	5	12	0	1	13	0	0
2	25984913	.	T	C	7	5	12	0	0	12	0	0
2	25984970	.	C	T	13	6	19	0	0	19	0	0
2	25985159	.	G	A	0	6	6	0	8	14	0	0
2	25985351	.	C	G	12	8	20	0	0	20	0	0
2	25988269	.	A	G	14	13	27	0	0	27	0	0
2	25988378	.	C	A	8	16	24	0	0	24	0	0
2	25988551	.	A	T	11	7	18	6	3	27	0	0
2	25988633	.	A	G	10	7	17	0	2	19	0	0
2	25988635	.	A	G	10	8	18	0	1	19	0	0
2	25988874	.	T	C	16	14	30	0	2	32	0	0
2	25989059	.	G	A	1	6	7	0	7	14	0	0
2	25989134	.	A	G	10	12	22	0	2	24	0	0
2	25989142	.	T	G	10	11	21	0	0	21	0	0
2	25989213	.	T	G	16	12	28	0	0	28	0	0
2	25989241	.	T	C	17	14	31	0	0	31	0	0
2	25989610	.	C	T	16	17	33	0	1	34	0	0
2	25989827	.	C	T	9	12	21	0	1	23	1	0
2	25989884	.	T	A	5	8	13	0	0	13	0	0
2	25989905	.	C	A	8	5	13	0	2	15	0	0
2	25989994	.	A	G	19	13	32	0	0	32	0	0
2	25990180	.	C	T	22	18	40	0	4	44	0	0
2	25990302	.	A	G	21	13	34	0	1	35	0	0
2	25990447	.	G	A	24	17	41	0	1	42	0	0
2	25990563	.	A	G	8	8	16	0	3	19	0	0
2	26155992	.	C	T	3	4	7	0	0	7	0	0
2	26156582	.	G	A	4	2	6	0	0	6	0	0
2	26156618	.	T	A	3	2	5	0	0	5	0	0
2	26197159	.	G	C	2	5	7	0	1	8	0	0
2	26199708	.	C	T	6	4	10	0	2	12	0	0
2	26199714	.	C	T	9	5	14	0	0	14	0	0
2	26206930	.	A	G	6	8	14	0	0	14	0	0
2	26206942	.	G	T	0	5	5	0	6	11	0	0
2	26207038	.	A	C	2	7	9	0	1	10	0	0
2	26207071	.	C	T	5	8	13	0	0	13	0	0
2	26207080	.	G	C	7	6	13	0	0	13	0	0
2	26207254	.	A	G	10	8	18	0	1	19	0	0
2	26207263	.	T	A	10	8	18	0	1	19	0	0
2	26207350	.	G	A	14	5	19	0	0	19	0	0
2	26207368	.	A	G	12	7	19	0	0	19	0	0
2	26207944	.	T	C	13	8	21	0	1	22	0	0
2	26207977	.	G	A	2	6	8	0	12	20	0	0
2	26208369	.	A	G	10	5	15	0	1	16	0	0
2	26208416	.	G	A	9	8	17	0	0	17	0	0
2	26208425	.	G	A	8	7	15	0	0	15	0	0
2	26208480	.	A	C	3	9	12	0	1	13	0	0
2	26208520	.	A	G	7	6	13	0	1	14	0	0
2	26208589	.	A	G	10	10	20	0	1	21	0	0
2	26208621	.	T	C	7	11	18	0	1	19	0	0
2	26208668	.	T	G	7	0	7	0	14	21	0	0
2	26208815	.	G	T	9	6	15	0	1	16	0	0
2	26208832	.	C	G	14	0	14	0	7	21	0	0
2	26208904	.	T	C	14	15	29	0	1	30	0	0
2	26208987	.	G	A	1	9	10	0	17	27	0	0
2	26209030	.	G	A	16	6	22	0	0	22	0	0
2	26209058	.	C	T	11	8	19	0	2	21	0	0
2	26209169	.	C	T	3	9	12	0	0	12	0	0
2	26209266	.	A	C	3	3	6	0	0	6	0	0
2	26240805	.	T	C	22	18	40	0	1	41	0	0
2	26240930	.	A	T	18	28	46	0	0	46	0	0
2	26278044	.	G	A	26	25	51	0	1	52	0	0
2	26282688	.	C	T	22	28	50	0	2	52	0	0
2	26282814	.	T	C	22	22	44	0	3	47	0	0
2	26282916	.	A	G	30	1	31	0	23	54	0	0
2	26283181	.	C	T	20	18	38	0	4	42	0	0
2	26283922	.	T	G	21	23	44	0	1	45	0	0
2	26300016	.	T	C	4	6	10	0	1	11	0	0
2	26300291	.	C	T	1	2	3	0	0	3	0	0
2	26303684	.	T	A	4	5	9	0	0	9	0	0
2	26303689	.	A	T	3	5	8	0	0	8	0	0
2	26303719	.	T	A	4	5	9	0	0	9	0	0
2	26303831	.	C	T	4	2	6	0	0	6	0	0
2	26303905	.	C	A	2	9	11	0	1	12	0	0
2	26303985	.	A	G	5	4	9	0	1	10	0	0
2	26304266	.	A	G	5	5	10	0	1	11	0	0
2	26422266	.	G	T	0	2	2	0	7	9	0	0
2	26422332	.	C	T	6	9	15	0	0	15	0	0
2	26422359	.	C	T	5	8	13	0	1	14	0	0
2	26443211	.	A	C	13	11	24	0	0	25	1	0
2	26443476	.	C	T	5	5	10	0	0	10	0	0
2	26443859	.	A	G	10	5	15	0	1	16	0	0
2	26444170	.	T	C	2	5	7	0	0	7	0	0
2	26463124	.	T	G	6	2	8	0	0	9	1	0
2	26463193	.	A	C	2	0	2	0	4	6	0	0
2	26463329	.	G	A	10	4	14	0	0	14	0	0
2	26463348	.	C	G	0	5	5	0	9	14	0	0
2	26463459	.	C	T	2	11	13	0	3	16	0	0
2	26463598	.	T	C	4	0	4	0	6	10	0	0
2	26463622	.	A	G	8	6	14	0	2	16	0	0
2	26467072	.	A	G	5	6	11	0	1	12	0	0
2	26467291	.	T	C	7	11	18	1	0	19	0	0
2	26468243	.	G	A	5	5	10	0	2	12	0	0
2	26468683	.	A	G	14	6	20	0	0	20	0	0
2	26470087	.	A	G	1	7	8	0	0	8	0	0
2	26470208	.	G	A	17	19	36	0	2	38	0	0
2	26470237	.	G	T	16	14	30	0	0	30	0	0
2	26470267	.	G	A	15	8	23	0	2	25	0	0
2	26470666	.	A	G	12	22	34	0	2	36	0	0
2	26473078	.	A	G	22	16	38	0	3	41	0	0
2	26473361	.	C	T	21	18	39	0	3	42	0	0
2	26480101	.	A	G	2	0	2	0	5	7	0	0
2	26481029	.	C	T	6	2	8	0	0	8	0	0
2	26481430	.	G	A	1	9	10	0	4	14	0	0
2	26483946	.	G	T	7	5	12	0	1	13	0	0
2	26486605	.	A	G	6	4	10	0	1	11	0	0
2	26489681	.	T	C	12	4	16	0	1	17	0	0
2	26491457	.	G	C	6	7	13	0	0	13	0	0
2	26491667	.	G	A	13	10	23	0	1	24	0	0
2	26491830	.	C	G	12	5	17	0	0	17	0	0
2	26494366	.	C	T	7	4	11	0	1	12	0	0
2	26577189	.	T	C	4	5	9	0	0	9	0	0
2	26577210	.	C	T	7	6	13	0	1	14	0	0
2	26583609	.	G	A	6	9	15	0	0	15	0	0
2	26586093	.	C	T	3	3	6	0	0	6	0	0
2	26586108	.	A	G	4	2	6	0	1	7	0	0
2	26586134	.	T	C	2	0	2	0	3	5	0	0
2	26586184	.	T	C	4	0	4	0	4	8	0	0
2	26586185	.	C	G	5	3	8	0	0	8	0	0
2	26588026	.	T	C	2	4	6	0	0	6	0	0
2	26609651	.	C	A	2	2	4	0	1	5	0	0
2	26609710	.	C	T	2	2	4	0	0	4	0	0
2	26610852	.	G	A	1	2	3	0	1	4	0	0
2	26612624	.	G	C	7	3	10	0	2	12	0	0
2	26612676	.	A	T	13	10	23	0	0	23	0	0
2	26612893	.	T	C	14	9	23	0	5	28	0	0
2	26613106	.	G	A	15	30	45	0	1	46	0	0
2	26617098	.	A	G	17	12	29	0	1	30	0	0
2	26619786	.	C	T	11	18	29	1	0	30	0	0
2	26620441	.	C	T	14	11	25	0	0	25	0	0
2	26620695	.	A	G	15	9	24	0	0	24	0	0
2	26623587	.	C	T	20	15	35	0	2	37	0	0
2	26623832	.	T	C	24	22	46	0	1	47	0	0
2	26627301	.	C	A	18	16	34	0	5	39	0	0
2	26627332	.	T	A	18	15	33	0	3	36	0	0
2	26630587	.	C	T	2	18	20	0	14	34	0	0
2	26630855	.	A	G	14	14	28	0	1	29	0	0
2	26631084	.	G	A	13	12	25	0	0	25	0	0
2	26632627	.	G	C	23	15	38	0	1	39	0	0
2	26638355	.	T	G	10	7	17	0	0	17	0	0
2	26638809	.	C	T	9	7	16	0	2	18	0	0
2	26638857	.	C	T	6	3	9	0	2	11	0	0
2	26639217	.	A	G	8	13	21	0	1	22	0	0
2	26656349	.	G	A	1	6	7	0	10	17	0	0
2	26662047	.	G	C	3	3	6	0	1	7	0	0
2	26665065	.	A	G	5	8	13	0	0	13	0	0
2	26665081	.	A	G	5	7	12	0	0	12	0	0
2	26665198	.	T	C	2	8	10	0	0	10	0	0
2	26665199	.	T	C	2	7	9	0	1	10	0	0
2	26665650	.	A	G	3	5	8	0	0	8	0	0
2	26665794	.	A	G	3	8	11	0	0	11	0	0
2	26665796	.	G	A	1	7	8	0	4	12	0	0
2	26672266	.	A	G	17	17	34	0	2	36	0	0
2	26672320	.	G	A	13	9	22	0	0	22	0	0
2	26672395	.	G	A	8	10	18	0	2	20	0	0
2	26672440	.	A	G	9	7	16	0	1	17	0	0
2	26672672	.	G	A	12	8	20	0	0	20	0	0
2	26672761	.	T	G	2	0	2	0	8	10	0	0
2	26673355	.	C	G	2	0	2	0	2	4	0	0
2	26677125	.	C	G	3	4	7	0	0	7	0	0
2	26677283	.	C	G	4	5	9	0	0	9	0	0
2	26677723	.	G	A	1	7	8	0	0	8	0	0
2	26680370	.	C	T	4	2	6	0	1	7	0	0
2	26681064	.	A	T	8	5	13	0	0	13	0	0
2	26681076	.	A	G	8	5	13	0	0	13	0	0
2	26681837	.	G	A	4	8	12	0	1	13	0	0
2	26681942	.	A	C	8	8	16	0	0	16	0	0
2	26682991	.	G	C	6	2	8	0	0	8	0	0
2	26682999	.	G	A	7	2	9	0	0	9	0	0
2	26683035	.	G	A	8	2	10	0	0	10	0	0
2	26686340	.	A	T	10	8	18	0	1	19	0	0
2	26686752	.	T	C	8	10	18	0	0	18	0	0
2	26688691	.	A	T	8	5	13	0	0	13	0	0
2	26688737	.	G	A	5	7	12	0	1	13	0	0
2	26688747	.	A	G	1	1	2	0	8	10	0	0
2	26697929	.	A	G	5	3	8	0	0	8	0	0
2	26701246	.	C	T	1	4	5	0	5	10	0	0
2	26714144	.	A	G	1	1	2	0	1	3	0	0
2	26714399	.	C	T	2	2	4	0	0	4	0	0
2	26714402	.	C	T	2	2	4	0	0	4	0	0
2	27048999	.	C	A	5	3	8	0	0	8	0	0
2	27049123	.	C	A	2	4	6	0	0	6	0	0
2	27075702	.	G	A	4	5	9	0	1	10	0	0
2	27075884	.	G	A	1	7	8	0	2	10	0	0
2	27075980	.	G	A	1	8	9	0	5	14	0	0
2	27341611	.	A	T	1	2	3	0	1	4	0	0
2	27341726	.	C	T	2	3	5	0	0	5	0	0
2	27372576	.	G	A	5	4	9	0	0	9	0	0
2	27377541	.	T	A	5	3	8	0	0	8	0	0
2	27377590	.	T	C	3	5	8	0	0	8	0	0
2	27378071	.	T	A	3	4	7	0	1	8	0	0
2	27378266	.	A	G	5	5	10	0	1	11	0	0
2	27378524	.	T	A	4	4	8	0	0	8	0	0
2	27379084	.	T	A	1	2	3	0	0	3	0	0
2	27379104	.	A	G	1	0	1	0	2	3	0	0
2	27380114	.	A	G	3	2	5	0	0	5	0	0
2	27380292	.	G	T	3	6	9	0	1	10	0	0
2	27380336	.	G	A	6	6	12	0	0	12	0	0
2	27380500	.	G	T	8	3	11	0	0	11	0	0
2	27382516	.	A	G	2	3	5	0	0	5	0	0
2	27385862	.	A	G	1	4	5	0	0	5	0	0
2	27385863	.	T	C	1	4	5	0	0	5	0	0
2	27527570	.	T	C	4	3	7	0	0	7	0	0
2	27534267	.	G	A	3	3	6	0	1	7	0	0
2	27538271	.	G	A	0	4	4	0	2	6	0	0
2	27538619	.	G	A	7	7	14	0	0	14	0	0
2	27541512	.	A	G	6	5	11	0	1	12	0	0
2	27541740	.	C	T	7	7	14	0	1	15	0	0
2	27541743	.	A	G	9	6	15	0	1	16	0	0
2	27542058	.	A	G	8	0	8	0	12	20	0	0
2	27542083	.	G	A	12	8	20	0	1	21	0	0
2	27562702	.	A	G	2	2	4	0	0	4	0	0
2	27614007	.	A	G	2	5	7	0	0	7	0	0
2	27614046	.	A	G	4	7	11	0	0	11	0	0
2	27614082	.	G	C	4	6	10	0	0	10	0	0
2	27635488	.	T	C	5	2	7	0	0	7	0	0
2	27641349	.	G	T	4	2	6	0	1	7	0	0
2	27642776	.	C	G	2	2	4	0	0	4	0	0
2	27642810	.	T	C	2	4	6	0	0	6	0	0
2	27646157	.	A	C	1	7	8	0	0	8	0	0
2	27646419	.	G	A	3	6	9	0	1	10	0	0
2	27646430	.	T	A	4	4	8	0	1	9	0	0
2	27646626	.	C	G	1	4	5	0	0	5	0	0
2	27658522	.	G	A	2	5	7	0	0	7	0	0
2	27658579	.	C	T	7	3	10	0	0	10	0	0
2	27658639	.	G	A	2	7	9	0	7	16	0	0
2	27658651	.	T	C	5	7	12	0	2	14	0	0
2	27658973	.	T	G	8	7	15	0	0	15	0	0
2	27659018	.	T	C	8	10	18	0	0	18	0	0
2	27663344	.	A	G	5	8	13	0	0	13	0	0
2	27663513	.	A	G	4	5	9	0	1	10	0	0
2	27663867	.	C	T	7	10	17	0	0	17	0	0
2	27664105	.	G	C	4	6	10	0	1	11	0	0
2	27664202	.	T	C	2	6	8	0	0	8	0	0
2	27664215	.	A	C	2	4	6	0	0	6	0	0
2	27664317	.	G	T	3	5	8	0	0	8	0	0
2	27664343	.	C	T	2	4	6	0	0	6	0	0
2	27664380	.	G	A	1	3	4	0	1	5	0	0
2	27664482	.	G	C	3	5	8	0	0	8	0	0
2	27670884	.	T	G	12	13	25	0	0	26	1	0
2	27670886	.	T	C	11	0	11	0	15	26	0	0
2	27671172	.	C	T	12	12	24	1	0	25	0	0
2	27671290	.	G	T	8	8	16	0	0	16	0	0
2	27671334	.	T	C	16	10	26	0	1	27	0	0
2	27671485	.	A	T	6	8	14	0	0	14	0	0
2	27671486	.	G	A	7	7	14	0	1	15	0	0
2	27671623	.	A	T	7	11	18	0	1	19	0	0
2	27671650	.	C	A	3	5	8	0	9	17	0	0
2	27671681	.	G	T	14	8	22	0	0	22	0	0
2	27671704	.	C	T	13	8	21	0	0	21	0	0
2	27671724	.	G	A	11	11	22	0	1	23	0	0
2	27672103	.	T	C	5	5	10	0	0	10	0	0
2	27672215	.	G	T	12	9	21	0	3	24	0	0
2	27672636	.	C	T	7	3	10	0	2	12	0	0
2	27672705	.	A	G	8	10	18	0	0	18	0	0
2	27673041	.	A	G	11	7	18	0	1	19	0	0
2	27673173	.	A	G	5	10	15	0	0	15	0	0
2	27673233	.	T	C	7	3	10	0	1	11	0	0
2	27691348	.	T	C	6	0	6	0	4	10	0	0
2	27691375	.	G	A	6	4	10	0	0	10	0	0
2	27691408	.	T	C	6	9	15	0	0	15	0	0
2	27691459	.	A	G	3	7	10	0	0	10	0	0
2	27843848	.	C	T	1	4	5	0	1	6	0	0
2	27843937	.	A	G	8	5	13	0	0	13	0	0
2	27846071	.	G	A	9	7	16	0	0	16	0	0
2	27848151	.	T	G	6	7	13	0	0	13	0	0
2	27849787	.	G	A	2	3	5	0	1	6	0	0
2	27851928	.	A	T	2	2	4	0	0	4	0	0
2	27932918	.	G	A	3	3	6	0	0	6	0	0
2	27932919	.	A	G	3	2	5	0	1	6	0	0
2	27933143	.	C	T	4	3	7	0	0	7	0	0
2	27933215	.	C	A	3	4	7	0	0	7	0	0
2	27933260	.	C	A	4	2	6	0	0	6	0	0
2	27933404	.	A	G	5	0	5	0	7	12	0	0
2	27957786	.	T	A	6	3	9	0	0	9	0	0
2	27957850	.	G	T	2	2	4	0	1	5	0	0
2	27957854	.	T	G	4	3	7	0	0	7	0	0
2	27969534	.	T	C	1	2	3	0	0	3	0	0
2	27975150	.	G	A	2	2	4	0	0	4	0	0
2	28049445	.	T	C	16	15	31	0	2	33	0	0
2	28049996	.	A	G	6	4	10	0	2	12	0	0
2	28050565	.	T	A	8	3	11	0	2	14	1	0
2	28050759	.	A	G	1	3	4	0	1	5	0	0
2	28050933	.	G	A	9	5	14	0	0	14	0	0
2	28057518	.	G	A	9	6	15	0	1	16	0	0
2	28077152	.	C	A	0	4	4	0	3	7	0	0
2	28077171	.	A	G	2	3	5	0	0	5	0	0
2	28085730	.	T	A	3	4	7	0	0	7	0	0
2	28085746	.	A	G	1	3	4	0	0	4	0	0
2	28521107	.	A	C	2	2	4	0	0	4	0	0
2	28650352	.	A	C	5	5	10	0	0	10	0	0
2	28650358	.	T	A	4	5	9	0	0	9	0	0
2	28650504	.	T	C	8	6	14	0	2	16	0	0
2	28650567	.	G	T	8	2	10	0	1	11	0	0
2	28650612	.	T	G	12	4	16	0	0	16	0	0
2	28650629	.	G	T	13	7	20	0	0	20	0	0
2	28651128	.	T	A	8	11	19	0	1	20	0	0
2	28651193	.	A	G	7	11	18	0	0	18	0	0
2	28651497	.	G	A	1	4	5	0	0	5	0	0
2	28653707	.	C	G	1	2	3	0	0	3	0	0
2	28657777	.	G	A	3	3	6	0	0	6	0	0
2	28657927	.	G	T	3	2	5	0	0	5	0	0
2	28659998	.	C	G	3	4	7	0	0	7	0	0
2	28930159	.	T	C	3	10	13	0	0	13	0	0
2	28934011	.	C	T	5	8	13	0	0	13	0	0
2	28934041	.	A	G	6	0	6	0	9	15	0	0
2	29113515	.	G	A	2	1	3	0	1	4	0	0
2	29113527	.	A	G	2	2	4	0	0	4	0	0
2	29257726	.	T	C	8	3	11	0	0	11	0	0
2	29310996	.	G	A	0	8	8	0	7	15	0	0
2	29317718	.	G	A	9	5	14	0	0	14	0	0
2	29352333	.	G	A	0	12	12	0	7	19	0	0
2	29352479	.	C	T	9	10	19	0	1	20	0	0
2	29477733	.	A	T	24	14	38	0	0	38	0	0
2	29477769	.	G	T	16	14	30	0	2	32	0	0
2	29477895	.	A	T	16	15	31	0	0	31	0	0
2	29477979	.	T	G	8	4	12	0	0	12	0	0
2	29484113	.	A	G	14	10	24	0	1	25	0	0
2	29485046	.	G	A	10	12	22	0	2	24	0	0
2	29610464	.	G	A	1	3	4	0	0	4	0	0
2	29685506	.	G	A	4	4	8	0	0	8	0	0
2	29685575	.	A	G	5	1	6	0	2	8	0	0
2	29726806	.	A	T	2	2	4	0	0	4	0	0
2	29873024	.	G	A	1	2	3	0	0	3	0	0
2	29892926	.	G	A	4	3	7	0	1	8	0	0
2	29894594	.	T	A	2	2	4	0	0	4	0	0
2	29905111	.	T	A	8	5	13	0	0	13	0	0
2	29910525	.	A	G	3	4	7	0	0	7	0	0
2	29911153	.	T	C	4	3	7	0	0	7	0	0
2	29913688	.	T	C	6	1	7	0	1	8	0	0
2	29913691	.	T	C	7	0	7	0	1	8	0	0
2	29914114	.	C	G	2	3	5	0	0	5	0	0
2	29915902	.	A	G	1	4	5	0	0	5	0	0
2	29915908	.	A	G	1	4	5	0	1	6	0	0
2	29916028	.	G	A	2	3	5	0	0	5	0	0
2	29976452	.	A	T	2	3	5	0	0	5	0	0
2	29976960	.	T	A	8	3	11	0	0	11	0	0
2	30106271	.	A	G	20	14	34	0	3	37	0	0
2	30108443	.	T	C	16	13	29	0	1	30	0	0
2	30108456	.	T	C	13	10	23	0	1	24	0	0
2	30108542	.	T	G	6	3	9	0	0	9	0	0
2	30109678	.	C	T	9	10	19	0	0	19	0	0
2	30116206	.	C	T	13	7	20	0	1	21	0	0
2	30116586	.	C	A	10	5	15	0	0	15	0	0
2	30116589	.	C	T	10	5	15	0	0	15	0	0
2	30116688	.	A	C	7	5	12	0	0	12	0	0
2	30116808	.	T	A	15	5	20	1	0	21	0	0
2	30116889	.	C	A	14	5	19	0	1	20	0	0
2	30116905	.	A	G	11	5	16	0	2	18	0	0
2	30117123	.	C	A	1	5	6	0	1	7	0	0
2	30117169	.	T	C	1	3	4	0	0	4	0	0
2	30178100	.	C	T	28	16	44	0	1	45	0	0
2	30183676	.	T	A	1	3	4	0	0	4	0	0
2	30183703	.	G	A	1	3	4	0	0	4	0	0
2	30194777	.	C	T	8	7	15	0	5	20	0	0
2	30194938	.	G	A	4	6	10	0	0	10	0	0
2	30195040	.	A	G	7	3	10	0	1	11	0	0
2	30245900	.	G	C	2	8	10	0	1	11	0	0
2	30245922	.	T	C	9	8	17	0	0	17	0	0
2	30246029	.	T	A	9	14	23	0	1	24	0	0
2	30250126	.	A	T	4	6	10	0	0	10	0	0
2	30251622	.	A	G	5	4	9	0	0	9	0	0
2	30251864	.	G	T	7	8	15	0	0	15	0	0
2	30252029	.	T	C	5	8	13	0	0	13	0	0
2	30252071	.	G	A	0	6	6	0	7	13	0	0
2	30252206	.	T	C	4	3	7	0	2	9	0	0
2	30252235	.	C	T	1	2	3	0	0	3	0	0
2	30290749	.	A	G	4	7	11	0	0	11	0	0
2	30290946	.	C	T	3	2	5	0	0	5	0	0
2	30290956	.	C	T	2	2	4	0	0	4	0	0
2	30291072	.	A	C	10	7	17	0	0	17	0	0
2	30295050	.	T	A	9	8	17	0	5	22	0	0
2	30295052	.	T	G	11	9	20	0	1	22	1	0
2	30295155	.	G	C	8	8	16	0	3	19	0	0
2	30295156	.	G	A	7	1	8	0	11	19	0	0
2	30295288	.	A	G	9	15	24	0	1	25	0	0
2	30319374	.	C	T	4	8	12	0	1	13	0	0
2	30319375	.	T	G	4	8	12	0	1	13	0	0
2	30319463	.	C	G	3	4	7	0	0	7	0	0
2	30428310	.	C	G	4	4	8	0	0	8	0	0
2	30428553	.	G	A	0	5	5	0	4	9	0	0
2	30428637	.	A	G	3	0	3	0	3	6	0	0
2	30429006	.	C	T	1	2	3	0	0	3	0	0
2	30429710	.	A	T	11	3	14	0	0	14	0	0
2	30429711	.	T	C	12	3	15	0	0	15	0	0
2	30430226	.	T	A	3	4	7	0	0	7	0	0
2	30458754	.	G	A	25	9	34	0	0	34	0	0
2	30459984	.	T	A	8	2	10	0	0	10	0	0
2	30459985	.	A	C	8	2	10	0	0	10	0	0
2	30460135	.	A	G	5	4	9	0	1	10	0	0
2	30478004	.	G	A	1	2	3	0	0	3	0	0
2	30481172	.	T	G	3	3	6	0	0	6	0	0
2	30481379	.	G	A	4	5	9	0	1	10	0	0
2	30504472	.	A	G	6	3	9	0	0	9	0	0
2	30506562	.	T	C	1	3	4	0	0	4	0	0
2	30519768	.	C	T	11	13	24	0	0	24	0	0
2	30519975	.	G	A	2	9	11	0	9	20	0	0
2	30520026	.	G	T	11	8	19	0	1	20	0	0
2	30523047	.	A	G	9	9	18	0	2	20	0	0
2	30523053	.	C	T	8	10	18	0	1	19	0	0
2	30524966	.	C	T	15	13	28	0	2	30	0	0
2	30524992	.	T	C	16	18	34	0	0	34	0	0
2	30525062	.	A	G	14	14	28	0	2	30	0	0
2	30525105	.	A	G	15	13	28	0	3	31	0	0
2	30525117	.	C	T	21	14	35	0	0	35	0	0
2	30525169	.	G	T	4	14	18	3	21	42	0	0
2	30525221	.	G	A	12	7	19	1	3	23	0	0
2	30525378	.	C	A	10	9	19	0	0	19	0	0
2	30525596	.	A	G	21	0	21	0	13	34	0	0
2	30525970	.	A	G	22	9	31	0	0	31	0	0
2	30554512	.	G	A	20	12	32	0	1	33	0	0
2	30556102	.	C	A	1	16	17	0	18	35	0	0
2	30556103	.	G	T	19	14	33	0	2	35	0	0
2	30556386	.	G	A	10	15	25	0	4	29	0	0
2	30556419	.	G	T	13	13	26	0	5	31	0	0
2	30561285	.	T	C	13	10	23	0	1	24	0	0
2	30574092	.	C	T	0	7	7	1	20	28	0	0
2	30579831	.	G	A	7	7	14	0	0	14	0	0
2	30586847	.	G	C	9	5	14	0	0	14	0	0
2	30613764	.	G	A	12	13	25	0	1	26	0	0
2	30613964	.	A	G	11	11	22	0	0	22	0	0
2	30614370	.	T	G	6	6	12	0	1	13	0	0
2	30668467	.	C	G	4	5	9	0	1	10	0	0
2	30693533	.	A	G	4	4	8	0	0	8	0	0
2	30693612	.	A	G	1	2	3	0	1	4	0	0
2	30693635	.	G	A	3	2	5	0	0	5	0	0
2	30693712	.	G	A	5	5	10	0	0	10	0	0
2	30741192	.	C	T	13	11	24	0	3	27	0	0
2	30752766	.	A	G	4	2	6	0	1	7	0	0
2	30752928	.	G	A	5	2	7	0	0	7	0	0
2	30753813	.	G	A	7	8	15	0	0	15	0	0
2	30753888	.	A	G	6	6	12	0	0	12	0	0
2	30753899	.	C	T	7	7	14	0	0	14	0	0
2	30754030	.	A	T	10	9	19	0	1	20	0	0
2	30754306	.	G	A	16	16	32	0	1	33	0	0
2	30754733	.	A	G	10	8	18	0	1	19	0	0
2	30754741	.	A	G	10	8	18	0	1	19	0	0
2	30755134	.	G	A	5	3	8	0	0	8	0	0
2	30755210	.	G	A	4	3	7	0	5	12	0	0
2	30755272	.	T	C	5	0	5	0	5	10	0	0
2	30755278	.	C	A	1	5	6	0	5	11	0	0
2	30755345	.	T	G	8	11	19	0	2	21	0	0
2	30755359	.	A	T	12	12	24	0	1	25	0	0
2	30755386	.	T	C	10	1	11	0	15	26	0	0
2	30755461	.	A	G	8	6	14	0	1	15	0	0
2	30755482	.	A	T	8	6	14	0	0	14	0	0
2	30755522	.	G	T	8	4	12	0	0	12	0	0
2	30755733	.	A	T	4	6	10	0	0	10	0	0
2	30755758	.	C	A	2	5	7	0	1	8	0	0
2	30756091	.	T	C	3	2	5	0	0	5	0	0
2	30756157	.	G	T	10	4	14	0	0	14	0	0
2	30756264	.	A	G	9	8	17	0	0	17	0	0
2	30756320	.	T	A	9	4	13	0	2	15	0	0
2	30756903	.	A	G	10	10	20	0	0	20	0	0
2	30786795	.	T	C	4	13	17	0	0	17	0	0
2	30787387	.	A	C	15	30	45	3	2	50	0	0
2	30794792	.	T	C	14	19	33	0	1	34	0	0
2	30821859	.	G	A	26	25	51	0	2	53	0	0
2	30821965	.	C	T	24	26	50	0	3	53	0	0
2	30823438	.	T	G	32	2	34	1	26	61	0	0
2	30846719	.	A	G	25	13	38	0	2	40	0	0
2	30886228	.	C	T	2	3	5	0	0	5	0	0
2	30886240	.	T	C	2	2	4	0	0	4	0	0
2	30897111	.	C	T	12	18	30	0	1	31	0	0
2	30898196	.	T	C	16	10	26	0	1	27	0	0
2	30900927	.	C	A	6	8	14	0	3	18	1	0
2	30900945	.	G	C	8	7	15	0	1	16	0	0
2	30900994	.	T	A	10	19	29	0	1	30	0	0
2	30901060	.	A	G	17	0	17	0	7	24	0	0
2	30904137	.	G	A	23	18	41	0	0	41	0	0
2	30905298	.	G	A	12	15	27	0	0	27	0	0
2	30906386	.	C	T	17	7	24	0	0	24	0	0
2	30907655	.	T	A	13	15	28	1	1	30	0	0
2	30908006	.	A	T	6	2	8	0	0	8	0	0
2	30960401	.	A	G	17	4	21	0	0	21	0	0
2	30960455	.	A	G	10	0	10	0	5	15	0	0
2	30960456	.	T	C	9	5	14	0	1	15	0	0
2	30971642	.	T	C	4	9	13	0	0	13	0	0
2	30971726	.	T	C	6	3	9	0	0	9	0	0
2	30971783	.	T	C	4	5	9	0	2	11	0	0
2	30971951	.	G	A	7	5	12	0	0	12	0	0
2	30972259	.	A	G	4	0	4	0	8	12	0	0
2	30982409	.	T	C	18	14	32	0	1	33	0	0
2	30982612	.	T	C	20	17	37	0	0	37	0	0
2	30982640	.	A	G	15	12	27	0	2	29	0	0
2	30982897	.	A	G	6	8	14	0	4	18	0	0
2	30982929	.	T	A	10	10	20	0	0	20	0	0
2	30983267	.	G	A	17	12	29	0	0	29	0	0
2	30983294	.	T	C	19	12	31	0	0	31	0	0
2	31297980	.	A	G	28	19	47	0	2	49	0	0
2	31298077	.	A	G	31	20	51	0	4	55	0	0
2	31298280	.	A	G	29	21	50	0	2	52	0	0
2	31298342	.	G	A	26	26	52	0	2	54	0	0
2	31298483	.	C	A	32	22	54	0	3	57	0	0
2	31298550	.	T	C	19	19	38	0	1	39	0	0
2	31298703	.	T	G	16	28	44	0	0	44	0	0
2	31298723	.	C	T	18	20	38	0	6	44	0	0
2	31298824	.	A	C	35	29	64	0	1	65	0	0
2	31299241	.	A	C	13	11	24	0	2	26	0	0
2	31301318	.	T	C	4	4	8	0	2	10	0	0
2	31302609	.	C	T	10	4	14	1	0	15	0	0
2	31308849	.	C	T	3	3	6	0	0	6	0	0
2	31336811	.	C	T	3	3	6	0	1	7	0	0
2	31345207	.	A	C	6	3	9	0	0	9	0	0
2	31348474	.	G	A	0	3	3	0	3	6	0	0
2	31360724	.	G	A	4	4	8	0	0	8	0	0
2	31360799	.	G	A	10	11	21	0	1	22	0	0
2	31361205	.	C	T	6	5	11	0	0	11	0	0
2	31362285	.	A	G	8	5	13	0	0	13	0	0
2	31362642	.	T	C	11	6	17	0	2	19	0	0
2	31362681	.	T	C	12	6	18	0	0	18	0	0
2	31362730	.	A	T	5	4	9	0	0	9	0	0
2	31362859	.	T	A	11	5	16	0	0	16	0	0
2	31362896	.	T	C	12	11	23	0	0	23	0	0
2	31363190	.	C	T	17	12	29	0	1	30	0	0
2	31363322	.	A	T	3	4	7	0	0	7	0	0
2	31451284	.	G	A	1	4	5	0	0	5	0	0
2	31451288	.	A	G	1	4	5	0	0	5	0	0
2	31451354	.	A	T	5	2	7	0	0	7	0	0
2	31451370	.	C	G	5	2	7	0	0	7	0	0
2	31451518	.	G	A	9	5	14	0	3	17	0	0
2	31451542	.	G	A	10	6	16	0	1	17	0	0
2	31451568	.	C	T	10	6	16	0	1	17	0	0
2	31451778	.	G	T	8	16	24	0	2	26	0	0
2	31451871	.	T	A	6	14	20	0	1	21	0	0
2	31452078	.	C	T	18	21	39	0	0	39	0	0
2	31452226	.	T	C	13	24	37	0	1	38	0	0
2	31452354	.	C	T	16	18	34	0	1	35	0	0
2	31499397	.	A	G	4	4	8	0	0	8	0	0
2	31507750	.	A	T	10	5	15	0	0	15	0	0
2	31507882	.	T	C	7	8	15	0	2	17	0	0
2	31511622	.	G	A	0	8	8	0	9	17	0	0
2	31511760	.	C	A	13	7	20	0	0	20	0	0
2	31511763	.	C	T	12	7	19	0	1	20	0	0
2	31511810	.	C	A	10	11	21	0	2	23	0	0
2	31511884	.	A	C	9	10	19	0	2	21	0	0
2	31511945	.	G	A	12	6	18	0	0	18	0	0
2	31511946	.	G	A	12	6	18	0	0	18	0	0
2	31515883	.	C	G	4	2	6	0	0	6	0	0
2	31515892	.	G	T	2	2	4	0	0	4	0	0
2	31627079	.	T	A	6	3	9	0	1	11	1	0
2	31627150	.	C	A	6	8	14	0	0	14	0	0
2	31627173	.	C	T	5	4	9	0	0	9	0	0
2	31627212	.	C	G	10	2	12	0	1	13	0	0
2	31627219	.	C	T	9	4	13	0	0	13	0	0
2	31627423	.	C	G	1	3	4	0	7	11	0	0
2	31630129	.	A	T	9	10	19	0	1	20	0	0
2	31630443	.	G	A	7	7	14	0	0	14	0	0
2	31634870	.	A	G	9	6	15	0	1	16	0	0
2	31634929	.	A	C	12	7	19	0	1	20	0	0
2	31635007	.	A	T	8	9	17	0	1	18	0	0
2	31635161	.	A	G	7	5	12	0	2	14	0	0
2	31635229	.	C	T	10	7	17	0	2	19	0	0
2	31635287	.	T	C	15	9	24	0	1	25	0	0
2	31635395	.	T	G	11	11	22	0	0	22	0	0
2	31635490	.	A	T	13	11	24	0	1	25	0	0
2	31635599	.	T	C	10	7	17	0	2	19	0	0
2	31635803	.	G	T	7	3	10	0	0	10	0	0
2	31635859	.	C	T	7	2	9	0	0	9	0	0
2	31635860	.	T	C	7	2	9	0	0	9	0	0
2	31635900	.	T	C	9	4	13	0	1	14	0	0
2	31636048	.	A	G	6	7	13	0	0	13	0	0
2	31636057	.	T	C	4	0	4	0	7	11	0	0
2	31638004	.	C	T	6	3	9	0	1	10	0	0
2	31638064	.	G	A	5	6	11	0	2	13	0	0
2	31638111	.	G	T	7	6	13	0	0	13	0	0
2	31638124	.	G	A	8	6	14	0	0	14	0	0
2	31638323	.	A	C	3	0	3	0	5	8	0	0
2	31640332	.	G	A	4	6	10	0	0	10	0	0
2	31640573	.	C	A	3	3	6	0	0	6	0	0
2	31650963	.	T	G	5	4	9	0	0	9	0	0
2	31690434	.	T	A	7	13	20	0	0	20	0	0
2	31690442	.	A	C	8	11	19	0	0	19	0	0
2	31692370	.	T	C	6	7	13	0	0	13	0	0
2	31700250	.	A	C	1	7	8	0	0	8	0	0
2	31700378	.	T	G	2	12	14	0	1	15	0	0
2	31703368	.	T	A	1	8	9	0	0	9	0	0
2	31703443	.	C	T	1	4	5	0	3	8	0	0
2	31703678	.	C	T	1	3	4	0	0	4	0	0
2	31710653	.	A	T	2	2	4	0	0	4	0	0
2	31722631	.	A	T	9	11	20	0	0	20	0	0
2	31727584	.	G	C	10	9	19	0	0	19	0	0
2	31735068	.	T	G	7	8	15	0	0	15	0	0
2	31741196	.	A	T	4	3	7	0	0	7	0	0
2	31782003	.	T	C	4	4	8	0	1	9	0	0
2	31784132	.	A	T	4	4	8	0	1	10	1	0
2	31800516	.	A	G	2	2	4	0	0	4	0	0
2	31806920	.	C	T	5	3	8	0	0	8	0	0
2	31820830	.	T	C	4	11	15	1	0	16	0	0
2	31821290	.	C	A	13	14	27	0	0	27	0	0
2	31826750	.	C	T	13	18	31	0	1	33	1	0
2	31826912	.	G	A	1	3	4	0	7	11	0	0
2	31826925	.	C	A	2	4	6	0	3	9	0	0
2	31827649	.	A	G	9	12	21	0	0	21	0	0
2	31827714	.	A	G	13	0	13	0	12	25	0	0
2	31830410	.	G	A	7	6	13	0	1	14	0	0
2	31832360	.	T	C	14	5	19	0	0	19	0	0
2	31833082	.	C	T	9	9	18	0	0	18	0	0
2	31834099	.	G	T	17	11	28	0	0	28	0	0
2	31834110	.	T	C	16	9	25	0	1	26	0	0
2	31834187	.	C	T	11	12	23	0	2	25	0	0
2	31836113	.	T	G	19	12	31	0	1	32	0	0
2	31836119	.	G	T	2	14	16	0	19	35	0	0
2	31836307	.	T	A	26	9	35	0	0	35	0	0
2	31836440	.	A	G	10	0	10	0	6	16	0	0
2	31836508	.	G	A	1	2	3	0	0	3	0	0
2	31836512	.	A	G	1	0	1	0	2	3	0	0
2	31836588	.	T	C	5	2	7	0	0	7	0	0
2	31838524	.	A	G	10	9	19	0	1	20	0	0
2	31842454	.	T	G	3	8	11	0	1	12	0	0
2	31891344	.	T	A	13	14	27	1	1	29	0	0
2	31891447	.	A	T	20	15	35	0	1	36	0	0
2	31891513	.	T	C	19	18	37	0	2	39	0	0
2	31891549	.	C	A	24	20	44	0	0	44	0	0
2	31891618	.	A	G	28	25	53	0	1	54	0	0
2	31892076	.	A	G	25	19	44	0	0	44	0	0
2	31892100	.	C	T	2	19	21	1	29	51	0	0
2	31894220	.	T	C	31	17	48	0	3	51	0	0
2	31901953	.	T	C	12	13	25	0	1	26	0	0
2	31902939	.	G	A	16	12	28	0	0	28	0	0
2	31902954	.	C	T	16	13	29	0	2	31	0	0
2	31913491	.	A	G	8	11	19	0	1	20	0	0
2	31919171	.	G	A	17	8	25	0	1	26	0	0
2	31927266	.	C	T	1	16	17	0	14	31	0	0
2	31942513	.	G	A	2	3	5	0	0	5	0	0
2	31943041	.	A	G	1	4	5	0	0	5	0	0
2	31943187	.	A	G	6	3	9	0	0	9	0	0
2	31944840	.	C	T	5	6	11	0	0	11	0	0
2	31948424	.	A	G	2	3	5	0	0	5	0	0
2	31948438	.	A	G	2	4	6	0	1	7	0	0
2	31948459	.	C	T	3	6	9	0	0	9	0	0
2	31957808	.	T	C	11	7	18	0	0	18	0	0
2	31975190	.	G	C	5	3	8	0	0	8	0	0
2	31987267	.	A	G	11	11	22	0	0	22	0	0
2	31987352	.	A	C	17	9	26	0	0	26	0	0
2	31987360	.	C	T	15	10	25	0	3	28	0	0
2	31989876	.	T	C	20	15	35	0	0	35	0	0
2	31993886	.	T	C	11	15	26	1	4	31	0	0
2	32005371	.	G	A	19	23	42	0	2	44	0	0
2	32018077	.	A	C	12	5	17	0	0	17	0	0
2	32018141	.	A	G	4	1	5	0	8	13	0	0
2	32089590	.	T	C	1	3	4	0	0	4	0	0
2	32264673	.	T	C	22	0	22	0	14	36	0	0
2	32264879	.	G	A	10	15	25	0	2	27	0	0
2	32264927	.	T	A	17	10	27	0	1	28	0	0
2	32265437	.	T	A	11	11	22	0	0	22	0	0
2	32265508	.	T	C	10	12	22	0	0	22	0	0
2	32265525	.	T	C	7	0	7	0	11	18	0	0
2	32265543	.	A	T	6	12	18	0	0	19	1	0
2	32265890	.	G	T	12	11	23	0	2	25	0	0
2	32265911	.	T	C	13	8	21	0	0	21	0	0
2	32266064	.	G	C	14	11	25	0	1	26	0	0
2	32266101	.	T	G	11	11	22	3	3	28	0	0
2	32266711	.	C	T	2	16	18	0	10	28	0	0
2	32266895	.	A	G	7	10	17	0	0	17	0	0
2	32267105	.	T	G	8	19	27	0	1	28	0	0
2	32267117	.	C	T	1	19	20	0	8	28	0	0
2	32267285	.	A	G	8	18	26	0	2	28	0	0
2	32267506	.	T	C	6	15	21	0	0	21	0	0
2	32267950	.	G	A	6	6	12	0	0	12	0	0
2	32268096	.	C	T	2	9	11	0	9	20	0	0
2	32270976	.	T	C	14	6	20	0	3	23	0	0
2	32270991	.	T	C	10	0	10	0	10	20	0	0
2	32276277	.	G	A	4	11	15	0	1	16	0	0
2	32307725	.	A	G	4	4	8	0	0	8	0	0
2	32352883	.	A	G	5	4	9	0	0	9	0	0
2	32357811	.	G	A	8	14	22	0	1	23	0	0
2	32357888	.	A	G	6	7	13	0	0	13	0	0
2	32357980	.	T	C	6	1	7	0	9	16	0	0
2	32358059	.	T	C	8	1	9	0	8	17	0	0
2	32358081	.	A	T	10	10	20	0	1	21	0	0
2	32361446	.	A	T	2	4	6	0	0	6	0	0
2	32361447	.	G	T	2	4	6	0	0	6	0	0
2	32361687	.	T	C	16	2	18	0	17	35	0	0
2	32366137	.	T	C	16	16	32	0	2	34	0	0
2	32366191	.	C	T	12	17	29	0	0	29	0	0
2	32378607	.	T	C	12	10	22	0	2	24	0	0
2	32380649	.	A	G	6	8	14	0	0	14	0	0
2	32386318	.	T	C	2	3	5	0	0	5	0	0
2	32392244	.	C	G	2	2	4	0	0	4	0	0
2	32392314	.	C	T	1	4	5	0	0	5	0	0
2	32392724	.	A	G	2	2	4	0	0	4	0	0
2	32392787	.	C	A	0	3	3	0	3	6	0	0
2	32392876	.	A	T	3	3	6	0	0	6	0	0
2	32392988	.	T	C	3	3	6	0	1	7	0	0
2	32393101	.	A	G	2	3	5	0	0	5	0	0
2	32393125	.	C	T	0	3	3	0	1	4	0	0
2	32393190	.	T	C	3	4	7	0	1	8	0	0
2	32393259	.	A	G	5	3	8	0	0	8	0	0
2	32393281	.	T	A	4	4	8	0	1	9	0	0
2	32393321	.	A	G	3	2	5	0	0	5	0	0
2	32393460	.	C	T	1	3	4	0	6	10	0	0
2	32393516	.	T	C	7	0	7	0	4	11	0	0
2	32393579	.	T	C	6	3	9	0	0	9	0	0
2	32393616	.	A	G	2	2	4	0	0	4	0	0
2	32393617	.	T	G	1	2	3	0	0	3	0	0
2	32393731	.	G	A	4	4	8	0	0	8	0	0
2	32393834	.	C	T	0	5	5	0	4	9	0	0
2	32393966	.	A	G	1	2	3	0	0	3	0	0
2	32393985	.	A	G	1	2	3	0	0	3	0	0
2	32394424	.	T	C	1	3	4	0	0	4	0	0
2	32396773	.	A	G	1	4	5	0	0	5	0	0
2	32414168	.	A	G	1	3	4	0	0	4	0	0
2	32414171	.	T	G	1	3	4	0	0	4	0	0
2	32475941	.	A	T	6	2	8	0	1	9	0	0
2	32476018	.	T	G	3	5	8	0	1	9	0	0
2	32476288	.	C	T	7	23	30	0	0	30	0	0
2	32479556	.	T	C	15	0	15	0	11	26	0	0
2	32479616	.	G	A	9	15	24	0	0	24	0	0
2	32485832	.	A	G	6	10	16	0	1	17	0	0
2	32485895	.	C	T	1	8	9	0	8	17	0	0
2	32485962	.	G	A	9	11	20	0	1	21	0	0
2	32494705	.	C	T	0	10	10	0	12	22	0	0
2	32497715	.	G	A	5	2	7	0	0	7	0	0
2	32498078	.	C	T	0	2	2	0	5	7	0	0
2	32505664	.	G	A	7	6	13	0	1	14	0	0
2	32509247	.	G	A	12	10	22	0	1	23	0	0
2	32513440	.	C	T	1	9	10	0	8	18	0	0
2	32515897	.	C	T	10	5	15	1	0	16	0	0
2	32515909	.	A	C	10	5	15	1	1	17	0	0
2	32516268	.	C	A	1	19	20	0	14	34	0	0
2	32516509	.	A	T	7	12	19	0	0	19	0	0
2	32518380	.	G	A	11	8	19	0	2	21	0	0
2	32519666	.	A	G	11	6	17	0	0	17	0	0
2	32519690	.	G	A	3	7	10	0	0	10	0	0
2	32543014	.	T	A	2	5	7	0	1	8	0	0
2	32569745	.	A	G	5	8	13	0	1	14	0	0
2	32569909	.	T	C	0	0	0	0	10	10	0	0
2	32577552	.	C	A	6	5	11	0	2	13	0	0
2	32578124	.	A	T	11	10	21	0	1	22	0	0
2	32578330	.	A	G	11	4	15	0	0	15	0	0
2	32578642	.	A	G	10	19	29	0	0	29	0	0
2	32579109	.	C	T	10	8	18	2	1	21	0	0
2	32579170	.	C	A	10	0	10	1	0	12	1	0
2	32579330	.	G	T	6	5	11	1	1	13	0	0
2	32583144	.	A	G	13	8	21	0	0	21	0	0
2	32583345	.	C	T	5	7	12	0	2	14	0	0
2	32583528	.	C	T	1	7	8	0	7	15	0	0
2	32583600	.	A	G	5	7	12	0	1	13	0	0
2	32583629	.	A	C	6	0	6	0	6	12	0	0
2	32583639	.	T	C	7	0	7	0	8	15	0	0
2	32584548	.	C	T	0	2	2	0	5	7	0	0
2	32588669	.	A	G	3	5	8	0	0	8	0	0
2	32590861	.	A	G	5	4	9	0	0	9	0	0
2	32591413	.	T	C	2	0	2	0	3	5	0	0
2	32591818	.	A	G	7	6	13	0	0	13	0	0
2	32594279	.	A	G	1	4	5	0	0	5	0	0
2	32594352	.	T	A	2	4	6	0	1	7	0	0
2	32594376	.	A	G	2	6	8	0	0	8	0	0
2	32594411	.	C	G	5	4	9	0	0	9	0	0
2	32594424	.	T	A	5	4	9	0	0	9	0	0
2	32594486	.	G	A	3	4	7	0	0	7	0	0
2	32594763	.	G	A	2	3	5	0	0	5	0	0
2	32624026	.	A	T	3	2	5	0	0	5	0	0
2	32624027	.	C	T	1	2	3	0	2	5	0	0
2	32636720	.	T	C	13	4	17	0	2	19	0	0
2	32637366	.	G	A	7	3	10	0	1	11	0	0
2	32654034	.	A	G	4	4	8	0	1	9	0	0
2	32654040	.	T	C	5	0	5	0	6	11	0	0
2	32654570	.	T	C	20	17	37	0	1	38	0	0
2	32655542	.	T	C	17	1	18	0	19	37	0	0
2	32676292	.	G	A	4	6	10	0	0	10	0	0
2	32680338	.	C	T	9	6	15	0	1	16	0	0
2	32680356	.	C	T	11	11	22	0	0	22	0	0
2	32680383	.	A	C	9	0	9	0	13	22	0	0
2	32681833	.	T	A	10	8	18	0	0	18	0	0
2	32681845	.	C	A	8	8	16	0	2	18	0	0
2	32682129	.	C	T	14	9	23	0	0	23	0	0
2	32682216	.	C	T	3	7	10	0	0	10	0	0
2	32682547	.	T	G	1	3	4	0	0	4	0	0
2	32686597	.	A	G	5	2	7	0	1	8	0	0
2	32738137	.	C	T	7	7	14	0	0	14	0	0
2	32738342	.	T	G	1	4	5	0	0	5	0	0
2	32751636	.	T	C	4	4	8	0	0	8	0	0
2	32752300	.	T	C	4	2	6	0	0	6	0	0
2	32754695	.	C	T	3	3	6	0	0	6	0	0
2	32756102	.	C	T	1	3	4	0	0	4	0	0
2	32814503	.	G	A	5	3	8	0	0	8	0	0
2	32814677	.	G	C	11	4	15	0	0	15	0	0
2	32814695	.	T	C	7	6	13	0	0	13	0	0
2	32815234	.	G	A	10	4	14	0	1	15	0	0
2	32823461	.	C	T	14	4	18	0	0	18	0	0
2	32823521	.	T	C	3	3	6	0	0	6	0	0
2	32824526	.	A	G	8	9	17	0	0	17	0	0
2	32824727	.	G	A	6	7	13	0	0	13	0	0
2	32824745	.	C	A	0	6	6	0	6	12	0	0
2	32824778	.	G	A	4	2	6	0	0	6	0	0
2	32824896	.	C	T	4	4	8	0	1	9	0	0
2	32825018	.	C	G	1	6	7	0	6	13	0	0
2	32825480	.	T	G	3	7	10	0	1	11	0	0
2	32826820	.	A	C	1	3	4	0	0	4	0	0
2	32827104	.	T	G	3	3	6	0	0	6	0	0
2	32828839	.	C	A	2	2	4	0	0	4	0	0
2	32833524	.	T	C	7	3	10	0	0	10	0	0
2	32833563	.	T	G	6	7	13	0	1	14	0	0
2	32833590	.	C	T	7	6	13	0	3	16	0	0
2	33645157	.	A	G	3	7	10	0	1	11	0	0
2	33645250	.	C	A	2	3	5	0	3	8	0	0
2	33645335	.	G	A	5	5	10	0	0	10	0	0
2	33676169	.	G	T	1	2	3	0	0	3	0	0
2	33676173	.	T	C	0	1	1	0	2	3	0	0
2	33681337	.	A	T	27	22	49	0	3	53	1	0
2	33687090	.	G	A	18	14	32	0	1	33	0	0
2	33687110	.	C	A	22	17	39	0	0	39	0	0
2	34009014	.	G	A	3	4	7	0	0	7	0	0
2	34022992	.	T	A	12	4	16	0	1	17	0	0
2	34024832	.	A	G	8	7	15	0	0	15	0	0
2	34025167	.	G	A	5	9	14	0	0	14	0	0
2	34029353	.	G	A	9	10	19	0	0	19	0	0
2	34119467	.	A	C	4	3	7	0	0	7	0	0
2	34119783	.	G	A	0	10	10	0	4	14	0	0
2	34122859	.	A	G	7	12	19	0	2	21	0	0
2	34122985	.	C	T	6	10	16	0	1	17	0	0
2	34126040	.	T	C	4	7	11	0	1	12	0	0
2	34126514	.	G	T	10	4	14	0	0	14	0	0
2	34173018	.	T	A	5	4	9	0	0	9	0	0
2	34173253	.	C	T	3	7	10	0	0	10	0	0
2	34381013	.	T	G	12	15	27	0	1	28	0	0
2	34381032	.	T	C	12	12	24	0	4	28	0	0
2	34381066	.	C	T	17	12	29	0	0	29	0	0
2	34555410	.	A	G	4	7	11	0	2	13	0	0
2	34573032	.	A	T	5	7	12	0	1	13	0	0
2	34573064	.	C	T	5	3	8	0	0	8	0	0
2	34698215	.	C	A	3	8	11	0	1	12	0	0
2	34714557	.	A	G	7	0	7	0	6	13	0	0
2	34725878	.	A	G	6	3	9	0	0	9	0	0
2	34924412	.	A	G	9	20	29	0	1	30	0	0
2	35419244	.	G	A	0	3	3	0	2	5	0	0
2	35420591	.	T	A	2	3	5	0	0	5	0	0
2	35420597	.	T	A	2	3	5	0	0	5	0	0
2	35421469	.	A	G	1	0	1	0	2	3	0	0
2	35421471	.	A	G	1	2	3	0	0	3	0	0
2	35454442	.	C	T	4	3	7	0	1	8	0	0
2	35457782	.	C	T	2	3	5	0	1	6	0	0
2	35468911	.	T	C	3	7	10	0	0	10	0	0
2	35473715	.	G	A	3	6	9	0	7	16	0	0
2	35474112	.	T	C	1	5	6	1	0	7	0	0
2	35593848	.	T	C	10	8	18	0	0	18	0	0
2	35594003	.	G	A	10	10	20	0	0	20	0	0
2	35595551	.	A	T	15	18	33	0	2	35	0	0
2	35595561	.	A	G	15	18	33	0	1	34	0	0
2	35596842	.	A	G	18	17	35	0	0	35	0	0
2	35598219	.	A	T	17	13	30	0	0	30	0	0
2	35598257	.	C	G	16	15	31	0	1	32	0	0
2	35601159	.	A	G	9	0	9	0	11	20	0	0
2	35603795	.	A	G	3	10	13	0	0	13	0	0
2	35605429	.	C	T	8	5	13	0	0	13	0	0
2	35607077	.	G	C	5	12	17	0	0	17	0	0
2	35607191	.	C	T	9	11	20	0	1	21	0	0
2	35607206	.	C	T	9	11	20	0	0	20	0	0
2	35607472	.	T	C	4	8	12	0	1	13	0	0
2	35610541	.	T	C	10	24	34	0	1	35	0	0
2	35610598	.	T	C	16	19	35	0	0	35	0	0
2	35611279	.	C	T	18	12	30	0	0	30	0	0
2	35611595	.	T	G	16	14	30	0	1	31	0	0
2	35837252	.	A	C	4	7	11	0	1	12	0	0
2	35837270	.	A	G	4	6	10	0	0	10	0	0
2	35837510	.	G	A	1	2	3	0	4	7	0	0
2	35839687	.	G	A	1	5	6	0	5	11	0	0
2	35839714	.	G	A	1	4	5	0	5	10	0	0
2	35841933	.	G	A	1	6	7	0	3	10	0	0
2	35842020	.	G	A	6	10	16	0	3	19	0	0
2	35843680	.	A	G	9	5	14	0	0	14	0	0
2	35843812	.	G	A	13	11	24	0	5	29	0	0
2	35844070	.	A	G	5	0	5	0	8	13	0	0
2	35844160	.	A	C	8	10	18	0	2	20	0	0
2	35844433	.	A	G	9	8	17	0	3	20	0	0
2	35846511	.	A	G	10	0	10	0	9	19	0	0
2	35851152	.	C	T	9	4	13	0	0	13	0	0
2	35854264	.	T	C	4	3	7	0	0	7	0	0
2	35855502	.	G	A	1	4	5	0	5	10	0	0
2	35857057	.	C	T	3	3	6	0	0	6	0	0
2	35858435	.	C	T	2	4	6	0	0	6	0	0
2	35861574	.	C	T	3	5	8	0	0	8	0	0
2	35861746	.	T	C	3	7	10	0	1	11	0	0
2	35862971	.	T	C	7	8	15	0	1	16	0	0
2	35866246	.	A	T	7	11	18	1	0	19	0	0
2	35866440	.	G	T	2	4	6	0	0	6	0	0
2	35866515	.	T	G	5	10	15	0	1	16	0	0
2	35866593	.	G	A	9	6	15	0	1	16	0	0
2	35866787	.	T	C	9	6	15	0	0	15	0	0
2	35868275	.	T	G	10	6	16	0	1	17	0	0
2	35868319	.	A	G	8	4	12	0	1	13	0	0
2	35868568	.	G	A	5	8	13	0	0	13	0	0
2	35868896	.	A	G	7	10	17	0	0	17	0	0
2	35873429	.	T	A	2	2	4	0	0	4	0	0
2	36028724	.	T	G	33	20	53	0	4	57	0	0
2	36028957	.	G	A	21	26	47	0	0	47	0	0
2	36032791	.	C	T	21	28	49	0	0	49	0	0
2	36035697	.	T	C	15	21	36	0	0	36	0	0
2	36040733	.	T	C	14	27	41	0	6	47	0	0
2	36053260	.	T	C	3	7	10	0	0	10	0	0
2	36061201	.	G	A	0	3	3	0	3	6	0	0
2	36062111	.	T	C	5	3	8	0	0	8	0	0
2	36064439	.	G	A	11	7	18	0	0	18	0	0
2	36065871	.	A	G	12	9	21	0	1	22	0	0
2	36065976	.	A	G	5	0	5	0	14	19	0	0
2	36066156	.	C	T	3	7	10	0	2	12	0	0
2	36067656	.	G	A	7	13	20	0	0	20	0	0
2	36067842	.	A	C	1	10	11	0	0	11	0	0
2	36067849	.	A	G	3	0	3	0	9	12	0	0
2	36076419	.	T	G	13	15	28	0	0	28	0	0
2	36076501	.	A	G	9	0	9	0	13	22	0	0
2	36077276	.	A	G	13	0	13	0	20	33	0	0
2	36077384	.	A	G	2	5	7	0	3	10	0	0
2	36077542	.	T	C	14	15	29	0	0	29	0	0
2	36077543	.	T	G	14	0	14	0	15	29	0	0
2	36077664	.	C	T	8	14	22	0	1	23	0	0
2	36078370	.	T	G	11	10	21	0	1	22	0	0
2	36630582	.	C	T	2	2	4	0	1	5	0	0
2	36635902	.	C	T	5	3	8	0	0	8	0	0
2	36636028	.	G	A	0	2	2	0	4	6	0	0
2	36664493	.	T	G	11	15	26	0	3	29	0	0
2	36664545	.	A	G	11	18	29	0	0	29	0	0
2	36664679	.	C	G	17	16	33	0	2	35	0	0
2	36664799	.	G	T	19	14	33	0	1	34	0	0
2	36668765	.	G	A	10	9	19	0	0	19	0	0
2	36670595	.	A	G	13	9	22	0	0	22	0	0
2	36670778	.	G	A	4	4	8	0	0	8	0	0
2	36670785	.	T	G	3	4	7	0	0	7	0	0
2	36673261	.	G	A	9	4	13	0	0	13	0	0
2	36673264	.	T	C	9	4	13	0	1	14	0	0
2	36673643	.	T	A	9	7	16	0	0	16	0	0
2	36673805	.	C	T	12	8	20	0	0	20	0	0
2	36673866	.	G	T	15	14	29	0	2	31	0	0
2	37124546	.	G	A	10	4	14	0	4	18	0	0
2	37546045	.	C	A	6	2	8	0	0	8	0	0
2	38109319	.	C	T	0	2	2	0	1	3	0	0
2	38214974	.	T	G	7	6	13	30	2	45	0	0
2	38556402	.	T	C	4	2	6	0	0	6	0	0
2	38985731	.	G	A	1	2	3	0	0	3	0	0
2	39550007	.	A	G	4	3	7	0	1	8	0	0
2	39553198	.	A	G	13	4	17	0	1	18	0	0
2	39553213	.	A	G	12	2	14	0	2	16	0	0
2	39554863	.	A	G	30	6	36	0	1	37	0	0
2	41580723	.	T	C	14	0	14	0	13	27	0	0
2	41946632	.	T	C	1	0	1	2	5	8	0	0
2	42420948	.	T	C	1	2	3	0	0	3	0	0
2	43739446	.	G	C	5	0	5	0	15	20	0	0
2	43962606	.	T	C	7	2	9	0	0	9	0	0
2	43962613	.	T	C	6	3	9	0	1	10	0	0
2	44693152	.	A	G	4	4	8	0	0	8	0	0
2	44925009	.	A	G	1	5	6	0	0	6	0	0
2	44925081	.	A	G	3	3	6	0	0	6	0	0
2	44980987	.	A	G	8	3	11	0	0	11	0	0
2	44980988	.	A	G	8	3	11	0	0	11	0	0
2	47587603	.	A	G	6	2	8	0	0	8	0	0
2	50892671	.	A	G	7	7	14	0	0	14	0	0
2	50892686	.	A	G	10	0	10	0	6	16	0	0
2	52052697	.	A	G	2	0	2	0	5	7	0	0
2	52052790	.	T	C	5	10	15	0	3	18	0	0
2	52057394	.	A	G	5	0	5	0	20	25	0	0
2	52060070	.	T	G	9	7	16	0	0	16	0	0
2	52060365	.	C	T	8	6	14	0	0	14	0	0
2	52060390	.	T	C	4	6	10	0	1	11	0	0
2	52060409	.	A	G	6	3	9	0	0	9	0	0
2	52060450	.	G	A	8	5	13	1	1	15	0	0
2	52060492	.	A	T	13	5	18	1	0	19	0	0
2	52062918	.	G	A	1	10	11	0	9	20	0	0
2	52063101	.	T	A	4	4	8	0	0	8	0	0
2	52063128	.	T	C	3	1	4	1	0	5	0	0
2	52063207	.	T	C	1	4	5	0	2	7	0	0
2	52063208	.	C	T	0	6	6	0	0	6	0	0
2	52063250	.	C	G	4	5	9	0	1	10	0	0
2	52810997	.	G	T	7	6	13	0	1	14	0	0
2	52814146	.	C	T	8	12	20	0	0	20	0	0
2	52815260	.	G	A	9	9	18	0	0	18	0	0
2	52815292	.	C	T	11	8	19	0	0	19	0	0
2	52826659	.	A	G	8	7	15	0	0	15	0	0
2	52827298	.	A	G	9	7	16	0	0	16	0	0
2	53065392	.	G	A	9	4	13	0	1	14	0	0
2	53065421	.	A	G	9	4	13	0	0	13	0	0
2	53085962	.	C	T	1	2	3	0	5	8	0	0
2	53359275	.	T	A	1	2	3	1	0	4	0	0
2	53414142	.	C	T	6	4	10	0	0	10	0	0
2	53501963	.	C	T	1	2	3	0	0	3	0	0
2	53665098	.	A	G	13	9	22	0	0	22	0	0
2	53673285	.	G	A	0	18	18	0	16	34	0	0
2	53673342	.	G	A	21	13	34	0	1	35	0	0
2	53673354	.	T	G	17	12	29	0	2	31	0	0
2	53673393	.	C	A	20	21	41	0	1	42	0	0
2	53675227	.	C	T	14	10	24	0	0	24	0	0
2	54017861	.	G	T	8	3	11	0	0	11	0	0
2	54017885	.	C	A	0	2	2	0	7	9	0	0
2	54018350	.	C	T	2	9	11	0	5	16	0	0
2	54018407	.	G	A	4	7	11	0	2	13	0	0
2	54018413	.	T	A	7	5	12	0	1	13	0	0
2	54018461	.	G	A	6	3	9	0	0	9	0	0
2	54039159	.	C	T	0	2	2	0	4	6	0	0
2	54049402	.	T	C	6	4	10	0	0	10	0	0
2	54049453	.	C	A	1	4	5	0	6	11	0	0
2	54054112	.	C	T	4	2	6	0	0	6	0	0
2	54054184	.	T	A	1	5	6	0	1	7	0	0
2	54422234	.	G	A	3	3	6	0	0	6	0	0
2	54771064	.	G	A	0	6	6	0	3	9	0	0
2	54771112	.	C	T	9	6	15	0	0	15	0	0
2	54771296	.	T	G	6	6	12	0	0	12	0	0
2	54774957	.	C	T	6	3	9	0	2	11	0	0
2	54775406	.	C	T	8	12	20	0	1	21	0	0
2	54775415	.	A	G	6	13	19	0	0	19	0	0
2	54775475	.	G	A	6	12	18	0	0	18	0	0
2	54775929	.	G	C	6	6	12	0	1	13	0	0
2	54775940	.	T	C	8	5	13	0	2	15	0	0
2	54775998	.	T	C	10	6	16	0	1	17	0	0
2	54776108	.	G	T	0	5	5	0	13	18	0	0
2	54776170	.	G	T	10	7	17	0	0	17	0	0
2	54776357	.	A	C	6	7	13	0	0	13	0	0
2	54776560	.	T	C	5	7	12	0	1	13	0	0
2	54776870	.	C	T	9	9	18	0	0	18	0	0
2	54776966	.	A	G	10	7	17	0	0	17	0	0
2	54777178	.	T	G	10	10	20	0	1	21	0	0
2	54777642	.	G	A	7	4	11	0	1	12	0	0
2	54777849	.	G	A	13	8	21	0	1	22	0	0
2	54777855	.	C	A	14	9	23	0	0	23	0	0
2	54778064	.	G	A	13	12	25	0	0	25	0	0
2	54778255	.	C	T	14	11	25	0	0	25	0	0
2	54778577	.	C	G	9	13	22	0	0	22	0	0
2	54786533	.	G	A	5	5	10	0	0	10	0	0
2	54786741	.	A	C	24	6	30	0	0	30	0	0
2	54832563	.	A	T	1	3	4	0	0	4	0	0
2	54971216	.	G	T	8	3	11	0	0	11	0	0
2	54971464	.	C	T	5	2	7	0	0	7	0	0
2	54971494	.	T	C	4	4	8	0	0	8	0	0
2	54975551	.	T	C	7	4	11	0	0	11	0	0
2	54977337	.	A	G	8	0	8	0	14	22	0	0
2	54977431	.	C	T	8	10	18	0	0	18	0	0
2	54977959	.	T	G	4	0	4	0	4	8	0	0
2	54977960	.	T	A	4	4	8	0	0	8	0	0
2	54978348	.	A	G	4	4	8	0	4	12	0	0
2	54978423	.	C	T	3	3	6	0	2	8	0	0
2	54978640	.	T	G	3	0	3	0	5	8	0	0
2	54978647	.	T	A	3	5	8	0	0	8	0	0
2	54979273	.	G	C	0	5	5	0	5	10	0	0
2	55200897	.	C	T	4	2	6	0	0	6	0	0
2	55210962	.	C	T	4	9	13	0	1	14	0	0
2	55211004	.	G	A	0	8	8	0	4	12	0	0
2	55211034	.	A	G	4	0	4	0	4	8	0	0
2	55211049	.	C	G	4	0	4	0	3	7	0	0
2	55273537	.	C	T	4	3	7	0	0	7	0	0
2	55273820	.	C	G	0	2	2	0	2	4	0	0
2	55273825	.	G	A	2	2	4	0	0	4	0	0
2	55298004	.	G	A	2	4	6	0	0	6	0	0
2	55432426	.	C	T	17	8	25	1	0	26	0	0
2	55489017	.	A	G	6	0	6	0	7	13	0	0
2	55489067	.	G	T	0	6	6	0	10	16	0	0
2	55489261	.	C	T	6	12	18	1	0	19	0	0
2	55489317	.	T	A	11	23	34	0	2	36	0	0
2	55489342	.	T	G	13	20	33	0	2	35	0	0
2	55490062	.	C	T	7	9	16	0	0	16	0	0
2	55490181	.	A	G	14	22	36	0	1	37	0	0
2	55490232	.	T	C	14	18	32	1	1	34	0	0
2	55490325	.	T	A	15	21	36	0	1	37	0	0
2	55490326	.	C	T	17	20	37	0	1	38	0	0
2	55490377	.	A	G	13	13	26	0	1	27	0	0
2	55490378	.	G	A	15	12	27	0	0	27	0	0
2	55490521	.	T	C	17	17	34	0	1	35	0	0
2	55490686	.	T	A	17	13	30	0	1	31	0	0
2	55490812	.	T	C	13	13	26	0	0	26	0	0
2	55491380	.	A	G	7	16	23	0	3	26	0	0
2	55491445	.	T	G	20	18	38	0	0	38	0	0
2	55491471	.	C	T	19	19	38	0	1	39	0	0
2	55491666	.	G	A	21	13	34	0	0	34	0	0
2	55491713	.	A	G	25	8	33	0	2	35	0	0
2	55491717	.	G	A	21	14	35	0	0	35	0	0
2	55491884	.	T	C	15	24	39	0	2	41	0	0
2	55491893	.	T	C	13	25	38	0	2	40	0	0
2	55492010	.	G	A	27	17	44	0	2	46	0	0
2	55492064	.	T	C	22	9	31	0	2	33	0	0
2	55492108	.	A	G	10	0	10	0	11	21	0	0
2	55492127	.	T	A	6	9	15	0	1	16	0	0
2	55492285	.	T	C	1	3	4	0	0	4	0	0
2	55492286	.	C	T	1	3	4	0	0	4	0	0
2	55670094	.	G	A	0	3	3	0	2	5	0	0
2	55784243	.	G	T	1	4	5	0	0	5	0	0
2	55784605	.	C	T	1	4	5	0	0	5	0	0
2	55784674	.	G	A	8	3	11	1	0	12	0	0
2	55785086	.	G	T	7	3	10	0	1	11	0	0
2	55785118	.	T	A	4	8	12	0	0	12	0	0
2	55785122	.	A	T	4	8	12	0	0	12	0	0
2	55785177	.	T	A	5	2	7	0	1	8	0	0
2	55785240	.	T	G	2	2	4	0	1	5	0	0
2	55785341	.	G	T	8	5	13	0	0	13	0	0
2	55785636	.	C	A	7	8	15	0	0	15	0	0
2	55787862	.	C	T	0	7	7	0	4	11	0	0
2	55791100	.	G	A	6	3	9	0	0	9	0	0
2	55793442	.	A	G	3	2	5	0	1	6	0	0
2	55915056	.	A	G	1	4	5	0	0	5	0	0
2	55915076	.	A	T	2	3	5	0	0	5	0	0
2	55915156	.	G	C	4	2	6	0	0	6	0	0
2	55916904	.	C	G	6	3	9	0	0	9	0	0
2	55933277	.	C	T	6	7	13	0	0	13	0	0
2	55962949	.	G	A	1	2	3	0	1	4	0	0
2	55963134	.	T	G	2	0	2	0	2	4	0	0
2	55963215	.	T	C	3	4	7	0	0	7	0	0
2	55964168	.	T	C	4	2	6	0	0	6	0	0
2	55964201	.	A	G	5	4	9	0	0	9	0	0
2	55964231	.	A	T	4	4	8	0	0	8	0	0
2	55964727	.	G	A	2	3	5	0	1	6	0	0
2	55964935	.	A	T	5	3	8	0	0	8	0	0
2	55964953	.	G	A	0	3	3	0	5	8	0	0
2	55965050	.	T	C	4	6	10	0	0	10	0	0
2	55965076	.	T	C	6	7	13	0	0	13	0	0
2	55965163	.	A	T	13	7	20	0	0	20	0	0
2	55965256	.	C	T	7	10	17	0	0	17	0	0
2	55965295	.	G	A	11	7	18	0	0	18	0	0
2	55965486	.	C	T	5	6	11	0	0	11	0	0
2	55966020	.	A	C	0	0	0	0	6	6	0	0
2	55966028	.	A	C	1	5	6	0	2	8	0	0
2	55966595	.	G	C	7	3	10	0	0	10	0	0
2	55966658	.	G	A	4	6	10	0	0	10	0	0
2	55966952	.	T	C	3	3	6	0	0	6	0	0
2	55967195	.	T	C	4	5	9	0	0	9	0	0
2	55967341	.	A	T	15	6	21	2	1	24	0	0
2	55967471	.	A	T	7	18	25	0	1	26	0	0
2	55967473	.	C	T	17	10	27	0	0	27	0	0
2	55967758	.	T	C	16	13	29	1	3	33	0	0
2	55967881	.	A	T	6	3	9	2	0	11	0	0
2	55967908	.	C	A	5	3	8	0	0	8	0	0
2	55967916	.	C	A	4	3	7	0	0	7	0	0
2	55968056	.	C	A	0	4	4	0	0	4	0	0
2	55968117	.	G	A	7	7	14	0	1	15	0	0
2	55968383	.	A	C	17	13	30	0	0	30	0	0
2	55968447	.	C	T	11	15	26	0	0	26	0	0
2	55968472	.	A	G	14	1	15	0	14	29	0	0
2	55968617	.	T	A	1	2	3	0	0	3	0	0
2	56125687	.	T	C	23	19	42	0	1	43	0	0
2	56125744	.	G	C	23	0	23	0	21	44	0	0
2	56125773	.	C	T	23	22	45	0	0	45	0	0
2	56125945	.	T	C	7	2	9	0	1	10	0	0
2	56126132	.	C	G	3	4	7	0	1	8	0	0
2	56126359	.	A	G	2	1	3	0	4	7	0	0
2	56127493	.	T	C	10	12	22	0	1	23	0	0
2	56127693	.	T	G	10	13	23	0	1	24	0	0
2	56127720	.	C	G	12	15	27	0	3	30	0	0
2	56127848	.	T	A	6	10	16	0	0	16	0	0
2	56127881	.	T	A	2	6	8	0	2	10	0	0
2	56127884	.	A	T	3	6	9	0	1	10	0	0
2	56127951	.	A	T	2	5	7	0	0	7	0	0
2	56127962	.	T	C	5	8	13	0	0	13	0	0
2	56128025	.	A	G	10	21	31	0	0	31	0	0
2	56128527	.	A	G	8	11	19	0	0	19	0	0
2	56128582	.	A	G	10	10	20	0	0	20	0	0
2	56128622	.	T	C	9	7	16	0	0	16	0	0
2	56128677	.	C	T	11	4	15	0	0	15	0	0
2	56128687	.	A	T	12	6	18	0	1	19	0	0
2	56128768	.	A	T	4	3	7	0	1	8	0	0
2	56129001	.	A	G	16	8	24	0	0	24	0	0
2	56129633	.	A	G	6	10	16	0	1	17	0	0
2	56129793	.	A	G	4	6	10	0	0	10	0	0
2	56129920	.	T	A	13	4	17	0	0	17	0	0
2	56129931	.	A	G	15	4	19	0	0	19	0	0
2	56130019	.	A	C	7	10	17	0	0	17	0	0
2	56130259	.	A	G	14	11	25	0	0	25	0	0
2	56130260	.	C	A	12	11	23	0	2	25	0	0
2	56131264	.	A	T	20	17	37	0	0	37	0	0
2	56152326	.	C	A	1	2	3	0	1	4	0	0
2	56157681	.	G	A	0	3	3	0	1	4	0	0
2	56162254	.	G	C	2	5	7	0	0	7	0	0
2	56181605	.	C	T	5	4	9	0	0	9	0	0
2	56196950	.	C	T	5	3	8	0	0	8	0	0
2	56200652	.	G	A	0	4	4	0	1	5	0	0
2	56205744	.	G	A	4	3	7	0	0	7	0	0
2	56213096	.	A	G	3	0	3	0	2	5	0	0
2	56218685	.	A	G	5	12	17	0	0	17	0	0
2	56219233	.	G	A	6	7	13	0	0	13	0	0
2	56233253	.	C	T	18	6	24	0	3	27	0	0
2	56233498	.	C	G	11	4	15	0	2	17	0	0
2	56233508	.	G	T	14	8	22	0	0	22	0	0
2	56234286	.	C	T	14	17	31	0	0	31	0	0
2	56234580	.	T	G	26	9	35	1	2	38	0	0
2	56234584	.	G	T	18	9	27	1	0	28	0	0
2	56234670	.	A	T	18	23	41	0	0	41	0	0
2	56234700	.	C	T	18	12	30	0	3	33	0	0
2	56234872	.	A	T	14	10	24	0	0	24	0	0
2	56342894	.	G	A	37	34	71	0	4	75	0	0
2	56344833	.	A	G	29	31	60	0	3	63	0	0
2	56356730	.	G	T	17	17	34	0	1	36	1	0
2	56356806	.	T	C	20	6	26	0	0	26	0	0
2	56359363	.	G	A	14	9	23	0	0	23	0	0
2	56359434	.	A	G	7	7	14	0	1	15	0	0
2	56359495	.	G	A	6	8	14	0	0	14	0	0
2	56359641	.	G	A	8	4	12	0	1	13	0	0
2	56359680	.	G	A	5	7	12	0	0	12	0	0
2	56361406	.	G	A	10	4	14	0	0	14	0	0
2	56374933	.	C	A	7	4	11	0	0	11	0	0
2	56374961	.	T	G	5	7	12	0	0	12	0	0
2	56380210	.	T	C	4	4	8	0	0	8	0	0
2	56380284	.	G	T	2	7	9	0	0	9	0	0
2	56385241	.	G	A	2	3	5	0	0	5	0	0
2	56463308	.	C	T	10	18	28	2	2	32	0	0
2	56463333	.	C	A	12	18	30	0	1	31	0	0
2	56474451	.	C	T	17	25	42	0	2	44	0	0
2	56476732	.	C	T	21	20	41	0	3	45	1	0
2	56476762	.	A	G	22	11	33	0	3	36	0	0
2	56508695	.	T	C	28	13	41	0	2	43	0	0
2	56508715	.	C	G	17	21	38	0	3	41	0	0
2	56508769	.	T	G	26	13	39	0	0	39	0	0
2	56508797	.	A	T	23	13	36	0	0	36	0	0
2	56508878	.	A	G	9	13	22	0	1	23	0	0
2	56508880	.	C	T	9	13	22	0	0	22	0	0
2	56509165	.	T	C	15	9	24	1	1	26	0	0
2	56509183	.	T	C	16	8	24	0	0	24	0	0
2	56509912	.	A	T	18	20	38	0	2	40	0	0
2	56509929	.	A	C	19	22	41	0	1	42	0	0
2	56510040	.	T	C	18	1	19	0	16	35	0	0
2	56510200	.	G	A	25	9	34	2	2	38	0	0
2	56510216	.	G	A	16	24	40	2	0	42	0	0
2	56510782	.	C	T	9	11	20	0	1	21	0	0
2	56510785	.	T	C	9	13	22	0	0	22	0	0
2	56510817	.	T	C	14	1	15	0	21	36	0	0
2	56510824	.	G	T	18	20	38	0	1	39	0	0
2	56511463	.	A	C	5	3	8	0	0	8	0	0
2	56511575	.	C	T	7	13	20	0	0	20	0	0
2	56512032	.	C	T	10	5	15	0	0	15	0	0
2	56512054	.	T	C	13	1	14	0	6	20	0	0
2	56512133	.	A	T	3	7	10	2	1	13	0	0
2	56512162	.	C	T	4	11	15	0	1	16	0	0
2	56512173	.	A	C	5	13	18	0	0	18	0	0
2	56512255	.	T	G	5	11	16	0	0	16	0	0
2	56512266	.	A	T	11	4	15	0	0	15	0	0
2	56512307	.	A	G	2	5	7	0	0	7	0	0
2	56513510	.	A	C	6	6	12	0	0	12	0	0
2	56513660	.	C	T	1	13	14	0	6	20	0	0
2	56513742	.	C	A	11	17	28	1	1	30	0	0
2	56533104	.	C	G	13	14	27	0	0	27	0	0
2	56533178	.	A	C	19	1	20	0	12	32	0	0
2	56533234	.	A	T	13	11	24	0	1	25	0	0
2	56541387	.	G	A	14	9	23	0	1	24	0	0
2	56541388	.	T	C	9	0	9	0	15	24	0	0
2	56553809	.	G	T	16	10	26	0	0	26	0	0
2	56572165	.	C	A	10	6	16	0	1	17	0	0
2	56572168	.	C	A	0	7	7	0	11	18	0	0
2	56572461	.	G	A	3	3	6	0	0	6	0	0
2	56574525	.	C	T	1	9	10	0	4	14	0	0
2	56642185	.	C	G	10	8	18	0	2	20	0	0
2	56642365	.	A	T	42	12	54	0	0	54	0	0
2	56643465	.	G	A	25	27	52	0	3	55	0	0
2	56645018	.	G	A	31	31	62	0	3	65	0	0
2	56645027	.	G	A	29	31	60	0	2	62	0	0
2	57076329	.	G	T	2	2	4	0	0	4	0	0
2	57082243	.	G	A	3	2	5	0	0	5	0	0
2	57121623	.	A	T	2	2	4	0	0	4	0	0
2	57130154	.	G	A	2	4	6	0	0	6	0	0
2	57135816	.	G	A	3	2	5	0	0	5	0	0
2	57135843	.	T	A	2	3	5	0	1	6	0	0
2	57143433	.	G	A	3	4	7	0	0	7	0	0
2	57143436	.	C	T	3	4	7	0	0	7	0	0
2	57151194	.	G	A	22	25	47	0	2	49	0	0
2	57151242	.	G	T	23	22	45	0	3	48	0	0
2	57151326	.	A	G	19	2	21	0	19	40	0	0
2	57152858	.	T	G	16	27	43	0	1	44	0	0
2	57156050	.	C	A	20	22	42	0	3	45	0	0
2	57156092	.	C	A	24	20	44	0	0	44	0	0
2	57157952	.	C	T	31	19	50	0	1	51	0	0
2	57159557	.	G	A	22	28	50	0	2	52	0	0
2	57159668	.	G	A	34	31	65	0	6	71	0	0
2	57160272	.	C	T	19	26	45	0	3	48	0	0
2	57164902	.	A	G	35	22	57	0	1	58	0	0
2	57165001	.	C	T	26	33	59	0	1	60	0	0
2	57165544	.	C	T	32	31	63	0	2	65	0	0
2	57165565	.	C	T	34	29	63	0	5	68	0	0
2	57212864	.	G	A	8	7	15	0	0	15	0	0
2	57212966	.	T	C	3	0	3	0	7	10	0	0
2	57216903	.	G	A	7	5	12	0	1	13	0	0
2	57225181	.	C	T	0	2	2	0	7	9	0	0
2	57225187	.	A	G	6	2	8	0	1	9	0	0
2	57227354	.	A	C	5	7	12	0	1	13	0	0
2	57240668	.	G	T	1	4	5	0	0	5	0	0
2	57247280	.	C	A	1	7	8	0	15	23	0	0
2	57247385	.	C	G	4	4	8	0	0	8	0	0
2	57251501	.	A	T	3	7	10	0	0	10	0	0
2	57268947	.	C	A	27	24	51	0	0	51	0	0
2	57269031	.	C	G	19	29	48	0	0	48	0	0
2	57269123	.	C	A	27	25	52	0	3	55	0	0
2	57269136	.	T	A	27	26	53	0	0	53	0	0
2	57314905	.	C	T	0	1	1	0	2	3	0	0
2	57417062	.	C	T	5	4	9	0	0	9	0	0
2	57417223	.	G	A	6	5	11	0	0	11	0	0
2	57609378	.	C	T	0	2	2	0	2	4	0	0
2	57830385	.	T	C	19	0	19	1	15	35	0	0
2	57830581	.	A	G	16	15	31	0	2	33	0	0
2	57831603	.	A	T	13	12	25	0	4	29	0	0
2	57834927	.	T	C	15	12	27	0	1	28	0	0
2	57834930	.	T	C	17	14	31	0	2	33	0	0
2	57848889	.	G	C	10	7	17	0	0	17	0	0
2	57848936	.	G	C	4	10	14	0	1	15	0	0
2	57856706	.	C	T	9	7	16	0	1	17	0	0
2	57867406	.	G	A	1	8	9	0	12	21	0	0
2	57867471	.	C	T	8	9	17	0	1	18	0	0
2	57867473	.	C	T	9	9	18	0	0	18	0	0
2	57867579	.	G	T	7	6	13	0	0	13	0	0
2	57867642	.	A	T	9	4	13	0	1	14	0	0
2	57868151	.	C	T	2	4	6	0	0	6	0	0
2	57868208	.	A	G	3	5	8	0	2	10	0	0
2	57868263	.	A	G	4	3	7	0	3	10	0	0
2	57868433	.	T	C	7	8	15	4	0	19	0	0
2	57868580	.	A	G	13	16	29	0	2	31	0	0
2	57869966	.	A	T	8	6	14	0	0	14	0	0
2	57870003	.	A	G	8	8	16	0	0	16	0	0
2	57870049	.	G	A	5	3	8	3	1	12	0	0
2	57870051	.	A	G	6	1	7	3	2	12	0	0
2	57870106	.	T	C	12	4	16	4	0	20	0	0
2	57870155	.	C	T	25	8	33	2	1	36	0	0
2	57870180	.	T	C	23	12	35	0	2	37	0	0
2	57870323	.	G	T	13	8	21	0	0	21	0	0
2	57870343	.	A	G	12	2	14	0	8	22	0	0
2	57870383	.	G	A	9	10	19	0	0	19	0	0
2	57870659	.	A	T	5	4	9	0	0	9	0	0
2	57870713	.	C	G	11	5	16	0	0	16	0	0
2	57870794	.	G	T	20	19	39	0	2	41	0	0
2	57870795	.	T	A	20	18	38	0	3	41	0	0
2	57870830	.	A	G	19	16	35	0	5	40	0	0
2	57870868	.	G	A	6	16	22	0	18	40	0	0
2	57870887	.	A	G	21	2	23	0	14	37	0	0
2	57870934	.	T	C	15	9	24	0	2	26	0	0
2	57870984	.	A	T	7	6	13	0	1	14	0	0
2	57879582	.	T	C	14	19	33	0	2	35	0	0
2	57879615	.	T	C	10	1	11	0	22	33	0	0
2	57879618	.	T	C	13	22	35	0	0	35	0	0
2	57883433	.	C	T	8	27	35	0	0	35	0	0
2	57883452	.	C	T	7	27	34	0	6	40	0	0
2	57883509	.	C	T	1	31	32	0	11	43	0	0
2	57891444	.	G	A	13	19	32	0	0	32	0	0
2	57891463	.	T	C	9	7	16	0	0	16	0	0
2	57893340	.	A	T	6	4	10	8	0	18	0	0
2	57893547	.	A	G	6	2	8	0	0	8	0	0
2	57893684	.	G	A	8	4	12	0	0	12	0	0
2	57893748	.	A	G	1	3	4	1	0	5	0	0
2	57893826	.	A	G	2	4	6	0	0	6	0	0
2	57894012	.	T	C	8	0	8	0	9	17	0	0
2	57894127	.	T	G	3	6	9	0	0	9	0	0
2	57897401	.	G	A	5	2	7	2	0	9	0	0
2	57898875	.	G	A	2	3	5	4	0	9	0	0
2	57899003	.	G	A	3	2	5	0	0	5	0	0
2	57900222	.	T	C	3	3	6	0	0	6	0	0
2	57913799	.	T	C	1	3	4	0	1	5	0	0
2	57913913	.	G	A	6	2	8	0	0	8	0	0
2	57930092	.	A	T	4	2	6	0	1	7	0	0
2	57940928	.	A	G	3	4	7	0	0	7	0	0
2	58009111	.	T	C	1	6	7	0	0	7	0	0
2	58009112	.	G	C	1	5	6	0	1	7	0	0
2	58009416	.	A	G	2	5	7	1	0	8	0	0
2	58012041	.	T	G	8	8	16	0	1	17	0	0
2	58012271	.	T	C	8	6	14	0	1	15	0	0
2	58012293	.	T	C	9	5	14	0	2	16	0	0
2	58013477	.	A	G	1	2	3	0	1	5	1	0
2	58013484	.	C	T	3	2	5	0	1	6	0	0
2	58013903	.	A	G	3	0	3	0	6	9	0	0
2	58014110	.	G	T	6	5	11	0	1	12	0	0
2	58014156	.	A	T	8	7	15	0	1	16	0	0
2	58014364	.	G	A	5	6	11	0	0	11	0	0
2	58014502	.	G	A	4	4	8	0	0	8	0	0
2	58014537	.	T	C	1	4	5	0	0	5	0	0
2	58077783	.	T	G	1	5	6	0	0	6	0	0
2	58077795	.	C	A	2	5	7	0	0	7	0	0
2	58077869	.	T	C	4	3	7	0	0	7	0	0
2	58078071	.	G	C	4	3	7	0	0	7	0	0
2	58081768	.	G	A	3	6	9	0	0	9	0	0
2	58122023	.	A	T	5	7	12	0	1	13	0	0
2	58126268	.	C	T	5	9	14	0	0	14	0	0
2	58129968	.	C	G	10	4	14	0	0	14	0	0
2	58129992	.	A	G	8	3	11	0	0	11	0	0
2	58132558	.	A	C	6	4	10	0	0	10	0	0
2	58186849	.	A	T	9	2	11	0	2	13	0	0
2	58186872	.	T	C	12	5	17	0	0	17	0	0
2	58186891	.	G	T	13	5	18	0	2	20	0	0
2	58186945	.	T	C	13	9	22	0	1	23	0	0
2	58187038	.	G	A	12	4	16	0	0	16	0	0
2	58187052	.	T	A	13	4	17	0	0	17	0	0
2	58187621	.	G	T	15	6	21	0	0	21	0	0
2	58187624	.	C	T	2	5	7	0	14	21	0	0
2	58347944	.	C	T	10	7	17	0	0	17	0	0
2	58347965	.	G	C	9	4	13	0	0	13	0	0
2	58349253	.	G	A	3	2	5	0	0	5	0	0
2	58349274	.	T	C	5	2	7	0	0	7	0	0
2	58355559	.	A	C	2	0	2	0	2	4	0	0
2	58361787	.	C	G	2	4	6	0	0	6	0	0
2	58365973	.	C	T	3	3	6	0	0	6	0	0
2	58411998	.	T	C	14	27	41	1	1	43	0	0
2	58412124	.	G	A	5	21	26	0	26	52	0	0
2	58514819	.	T	C	18	15	33	0	0	33	0	0
2	58523710	.	C	A	0	3	3	1	4	8	0	0
2	58541894	.	C	T	18	11	29	0	4	33	0	0
2	58546821	.	G	T	7	14	21	0	0	21	0	0
2	58570715	.	C	G	3	3	6	0	0	6	0	0
2	58632210	.	T	C	6	0	6	0	12	18	0	0
2	58632433	.	G	A	5	3	8	0	0	8	0	0
2	58632475	.	G	A	2	5	7	0	0	7	0	0
2	58639153	.	C	T	2	2	4	0	6	10	0	0
2	58739467	.	T	C	9	11	20	0	2	22	0	0
2	58739574	.	C	T	12	10	22	0	0	22	0	0
2	58739714	.	G	A	13	16	29	0	0	29	0	0
2	58742652	.	G	A	1	8	9	0	16	25	0	0
2	58778264	.	G	A	19	13	32	0	3	35	0	0
2	58785286	.	G	A	9	13	22	0	1	23	0	0
2	58785866	.	T	C	18	9	27	0	1	28	0	0
2	58786091	.	G	A	13	9	22	0	1	23	0	0
2	58788301	.	A	G	10	7	17	0	0	17	0	0
2	58793667	.	G	A	5	9	14	0	0	14	0	0
2	58795599	.	C	T	6	3	9	0	0	9	0	0
2	58841219	.	T	C	17	30	47	0	3	50	0	0
2	58843563	.	G	A	0	12	12	19	8	39	0	0
2	58843569	.	T	C	12	9	21	13	0	34	0	0
2	58845161	.	G	T	1	10	11	1	12	24	0	0
2	58845396	.	T	C	7	20	27	0	1	28	0	0
2	58868190	.	G	A	8	7	15	0	4	19	0	0
2	58868193	.	G	A	12	6	18	0	1	19	0	0
2	58868508	.	A	C	5	0	5	0	10	15	0	0
2	58868577	.	G	C	19	0	19	0	11	30	0	0
2	58868841	.	G	A	6	5	11	0	0	11	0	0
2	58869037	.	C	G	4	2	6	0	0	6	0	0
2	58869142	.	G	A	10	12	22	0	0	22	0	0
2	58869166	.	G	A	6	6	12	0	2	14	0	0
2	58869268	.	A	G	5	7	12	0	0	12	0	0
2	58878288	.	G	A	0	3	3	0	11	14	0	0
2	58878612	.	C	T	15	7	22	0	0	22	0	0
2	58879122	.	C	G	18	1	19	0	9	28	0	0
2	58888916	.	T	A	5	2	7	1	4	12	0	0
2	58888966	.	C	A	11	8	19	0	1	20	0	0
2	58892160	.	C	T	14	11	25	0	0	25	0	0
2	58917504	.	A	T	8	3	11	0	1	12	0	0
2	58996000	.	A	T	7	4	11	0	1	12	0	0
2	59023901	.	T	C	12	4	16	0	0	16	0	0
2	59032670	.	T	C	8	12	20	0	2	22	0	0
2	59045797	.	G	A	0	6	6	0	6	12	0	0
2	59045912	.	A	G	3	1	4	0	7	11	0	0
2	59050160	.	C	T	10	5	15	0	1	16	0	0
2	59054254	.	A	G	17	16	33	0	2	35	0	0
2	59136859	.	T	C	4	2	6	0	0	6	0	0
2	59136919	.	T	G	6	7	13	0	0	13	0	0
2	59137050	.	T	A	5	8	13	3	1	17	0	0
2	59137113	.	C	T	9	6	15	0	2	17	0	0
2	59137184	.	G	T	2	6	8	0	0	8	0	0
2	59143145	.	G	A	7	5	12	0	0	12	0	0
2	59143183	.	A	G	4	6	10	0	2	12	0	0
2	59144065	.	A	G	3	2	5	0	0	5	0	0
2	59144385	.	T	G	6	2	8	0	0	8	0	0
2	59556935	.	G	T	0	3	3	0	1	4	0	0
2	59565508	.	C	T	2	4	6	0	1	7	0	0
2	59565553	.	G	C	2	5	7	0	0	7	0	0
2	59565584	.	G	A	4	5	9	0	0	9	0	0
20	66886	.	C	A	1	5	6	0	1	7	0	0
20	67388	.	C	A	4	4	8	0	0	8	0	0
20	67867	.	T	G	2	10	12	0	0	12	0	0
20	75079	.	C	A	9	10	19	0	0	19	0	0
20	75121	.	C	T	8	10	18	0	0	18	0	0
20	75148	.	T	C	5	9	14	0	2	16	0	0
20	75266	.	G	A	1	3	4	0	8	12	0	0
20	75330	.	T	A	6	6	12	0	2	14	0	0
20	75374	.	A	G	5	10	15	0	2	17	0	0
20	75376	.	G	T	2	10	12	0	7	19	0	0
20	75889	.	C	T	10	12	22	0	0	22	0	0
20	76193	.	G	A	2	11	13	0	8	21	0	0
20	76209	.	A	G	10	13	23	0	1	24	0	0
20	76285	.	C	T	12	8	20	0	1	21	0	0
20	88023	.	G	A	1	3	4	0	0	4	0	0
20	89176	.	A	G	9	13	22	0	0	22	0	0
20	89188	.	G	T	2	13	15	0	9	24	0	0
20	89351	.	C	G	5	3	8	0	1	9	0	0
20	89354	.	C	T	5	3	8	0	1	9	0	0
20	89567	.	G	A	12	19	31	0	1	32	0	0
20	89607	.	G	T	3	12	15	0	9	24	0	0
20	89625	.	T	A	16	9	25	0	0	25	0	0
20	89720	.	G	A	8	3	11	0	0	11	0	0
20	90003	.	A	T	19	17	36	0	1	38	1	0
20	90167	.	C	T	14	19	33	0	2	35	0	0
20	90242	.	T	C	13	17	30	0	1	31	0	0
20	90246	.	T	C	13	16	29	0	1	30	0	0
20	114147	.	G	A	8	11	19	0	1	20	0	0
20	114708	.	A	G	27	22	49	0	5	54	0	0
20	114776	.	A	G	29	20	49	0	5	54	0	0
20	116164	.	A	T	27	20	47	0	1	48	0	0
20	122227	.	A	T	3	2	5	0	1	6	0	0
20	122244	.	C	G	2	4	6	0	1	7	0	0
20	122601	.	G	A	3	5	8	0	0	8	0	0
20	124691	.	C	T	1	4	5	0	6	11	0	0
20	147226	.	T	C	1	2	3	0	0	3	0	0
20	147537	.	T	A	1	2	3	0	1	4	0	0
20	151846	.	C	T	20	15	35	0	2	37	0	0
20	152496	.	G	C	12	8	20	0	1	21	0	0
20	153992	.	C	T	1	3	4	0	6	10	0	0
20	186752	.	G	A	20	16	36	0	1	37	0	0
20	188449	.	A	G	17	10	27	0	0	27	0	0
20	188638	.	T	C	6	14	20	0	0	20	0	0
20	196767	.	G	A	9	7	16	0	0	16	0	0
20	196773	.	T	A	10	6	16	0	1	17	0	0
20	196838	.	G	A	12	9	21	0	2	23	0	0
20	197274	.	T	C	15	6	21	0	1	22	0	0
20	197560	.	C	G	10	8	18	0	0	18	0	0
20	197842	.	T	C	16	12	28	0	2	30	0	0
20	198040	.	G	T	14	9	23	0	2	25	0	0
20	198049	.	C	T	16	9	25	0	1	26	0	0
20	198112	.	G	T	10	22	32	0	1	33	0	0
20	198352	.	G	A	16	8	24	0	0	24	0	0
20	199168	.	C	T	1	14	15	0	9	24	0	0
20	199504	.	C	T	10	10	20	0	0	20	0	0
20	199956	.	G	A	7	3	10	0	1	11	0	0
20	199962	.	T	C	3	7	10	0	0	10	0	0
20	200302	.	C	T	4	6	10	0	0	10	0	0
20	200544	.	C	T	0	4	4	0	9	13	0	0
20	200851	.	G	A	6	8	14	0	0	14	0	0
20	201524	.	G	C	6	3	9	0	1	10	0	0
20	201718	.	G	A	4	4	8	0	1	9	0	0
20	201889	.	T	C	3	0	3	0	3	6	0	0
20	201957	.	C	G	0	3	3	0	3	6	0	0
20	202012	.	A	G	4	5	9	0	0	9	0	0
20	202480	.	T	C	6	4	10	0	0	10	0	0
20	240766	.	T	A	4	2	6	0	0	6	0	0
20	245581	.	G	A	4	2	6	0	0	6	0	0
20	247639	.	G	A	3	2	5	0	1	6	0	0
20	247648	.	G	C	2	3	5	0	0	5	0	0
20	251162	.	A	G	3	1	4	0	2	6	0	0
20	254601	.	C	T	3	6	9	0	0	9	0	0
20	255431	.	C	T	6	4	10	0	1	11	0	0
20	255433	.	C	G	6	5	11	0	0	11	0	0
20	255859	.	G	A	0	3	3	0	3	6	0	0
20	259534	.	C	T	5	7	12	0	0	12	0	0
20	259602	.	T	C	8	3	11	0	0	11	0	0
20	259625	.	T	C	8	3	11	0	0	11	0	0
20	259763	.	C	T	2	7	9	0	1	10	0	0
20	259766	.	C	A	2	7	9	0	1	10	0	0
20	329072	.	A	C	7	9	16	0	0	16	0	0
20	329113	.	G	A	4	6	10	0	0	10	0	0
20	343858	.	A	C	5	3	8	0	1	9	0	0
20	369583	.	A	G	5	0	5	0	4	9	0	0
20	384585	.	G	T	0	5	5	1	3	9	0	0
20	395704	.	C	T	4	3	7	0	1	8	0	0
20	405867	.	G	A	3	12	15	0	0	15	0	0
20	405925	.	A	C	12	4	16	0	0	16	0	0
20	405928	.	A	G	6	0	6	0	12	18	0	0
20	406264	.	T	A	3	3	6	1	0	7	0	0
20	406278	.	T	A	4	6	10	1	0	11	0	0
20	409377	.	C	A	10	4	14	0	1	15	0	0
20	409524	.	C	T	3	5	8	0	1	9	0	0
20	410832	.	A	T	11	20	31	0	0	31	0	0
20	410981	.	A	T	5	13	18	0	1	19	0	0
20	411063	.	T	A	6	6	12	0	1	13	0	0
20	423977	.	G	C	11	6	17	0	0	17	0	0
20	426390	.	T	C	7	4	11	0	0	11	0	0
20	426434	.	T	A	6	8	14	0	2	16	0	0
20	430080	.	A	G	6	3	9	0	0	9	0	0
20	430703	.	A	C	1	3	4	0	0	4	0	0
20	431851	.	C	T	6	6	12	0	0	12	0	0
20	431886	.	C	T	2	6	8	0	2	10	0	0
20	432004	.	C	T	1	4	5	0	1	6	0	0
20	432898	.	T	A	2	3	5	0	1	6	0	0
20	436661	.	T	C	4	2	6	0	0	6	0	0
20	438554	.	G	A	3	3	6	0	0	6	0	0
20	438613	.	G	A	3	2	5	0	0	5	0	0
20	463709	.	G	T	1	3	4	0	0	4	0	0
20	474341	.	C	A	3	7	10	0	1	11	0	0
20	483866	.	C	T	10	7	17	0	1	18	0	0
20	522541	.	G	A	11	4	15	0	1	16	0	0
20	522778	.	C	T	4	8	12	0	1	13	0	0
20	522811	.	T	A	6	5	11	0	0	11	0	0
20	528561	.	C	T	15	9	24	0	0	24	0	0
20	530335	.	C	T	12	9	21	0	0	21	0	0
20	530405	.	G	A	2	6	8	0	13	21	0	0
20	530408	.	C	T	13	6	19	0	1	20	0	0
20	530443	.	C	T	18	6	24	0	0	24	0	0
20	530445	.	T	G	18	6	24	0	0	24	0	0
20	530534	.	C	G	5	6	11	0	0	11	0	0
20	530536	.	C	T	7	5	12	0	0	12	0	0
20	530624	.	G	T	5	10	15	0	1	16	0	0
20	556311	.	T	C	1	2	3	0	0	3	0	0
20	565903	.	A	C	1	3	4	0	0	4	0	0
20	566083	.	G	A	2	2	4	0	0	4	0	0
20	605171	.	A	T	3	3	6	0	0	6	0	0
20	605264	.	C	T	4	2	6	0	0	6	0	0
20	605291	.	C	T	3	2	5	0	0	5	0	0
20	700683	.	C	T	10	8	18	0	0	18	0	0
20	700686	.	A	T	10	7	17	0	0	17	0	0
20	700899	.	C	A	6	11	17	0	1	18	0	0
20	707767	.	C	T	8	9	17	0	1	18	0	0
20	708026	.	G	A	8	10	18	0	0	18	0	0
20	712497	.	A	G	10	3	13	0	0	13	0	0
20	715806	.	C	A	4	3	7	0	0	7	0	0
20	742126	.	T	C	1	2	3	0	0	3	0	0
20	755725	.	G	A	2	5	7	0	2	9	0	0
20	757522	.	G	A	8	6	14	0	0	14	0	0
20	757525	.	C	A	6	7	13	0	0	13	0	0
20	761004	.	C	T	15	6	21	0	0	21	0	0
20	761006	.	G	C	8	13	21	0	1	22	0	0
20	764346	.	A	G	7	11	18	0	1	19	0	0
20	764355	.	G	A	8	7	15	0	0	15	0	0
20	764388	.	A	G	6	6	12	0	0	12	0	0
20	764436	.	T	C	8	14	22	0	0	22	0	0
20	764807	.	G	A	11	7	18	0	2	20	0	0
20	771986	.	C	G	13	4	17	0	1	18	0	0
20	772577	.	C	A	5	15	20	0	1	21	0	0
20	772700	.	C	T	17	8	25	0	0	25	0	0
20	775412	.	G	A	1	10	11	0	17	28	0	0
20	775487	.	C	T	18	9	27	0	0	27	0	0
20	775538	.	G	A	0	11	11	0	17	28	0	0
20	775562	.	C	T	16	16	32	0	1	33	0	0
20	775583	.	T	A	15	18	33	0	1	34	0	0
20	776171	.	C	T	21	17	38	0	1	39	0	0
20	776261	.	A	T	14	26	40	3	5	48	0	0
20	776630	.	G	T	12	12	24	1	1	26	0	0
20	776826	.	G	A	7	15	22	0	0	22	0	0
20	776961	.	G	T	15	4	19	1	2	22	0	0
20	847735	.	T	G	1	5	6	0	1	7	0	0
20	847758	.	T	A	2	3	5	0	0	5	0	0
20	847820	.	G	A	0	4	4	0	2	6	0	0
20	847854	.	G	A	2	3	5	0	1	6	0	0
20	847887	.	T	A	2	6	8	0	0	8	0	0
20	851699	.	G	A	2	6	8	0	0	8	0	0
20	851746	.	G	A	7	6	13	0	0	13	0	0
20	851843	.	T	C	8	12	20	0	1	21	0	0
20	851876	.	C	T	12	10	22	0	0	22	0	0
20	852184	.	A	G	13	12	25	0	1	26	0	0
20	856170	.	G	A	11	16	27	0	3	30	0	0
20	856185	.	G	A	12	19	31	0	2	33	0	0
20	875008	.	C	G	7	5	12	0	0	12	0	0
20	875042	.	G	A	5	7	12	0	0	12	0	0
20	880430	.	G	A	14	4	18	0	1	19	0	0
20	880447	.	A	G	13	5	18	0	1	19	0	0
20	880747	.	A	T	10	5	15	0	1	16	0	0
20	883163	.	C	T	0	7	7	0	7	14	0	0
20	884404	.	A	T	2	5	7	0	2	9	0	0
20	892055	.	C	T	4	5	9	0	0	9	0	0
20	902647	.	A	G	6	2	8	0	0	8	0	0
20	902671	.	G	A	4	4	8	0	0	8	0	0
20	902712	.	A	T	9	8	17	0	0	17	0	0
20	908195	.	A	G	6	6	12	0	0	12	0	0
20	908294	.	A	G	9	8	17	0	0	17	0	0
20	908641	.	C	T	2	4	6	0	0	6	0	0
20	908717	.	G	A	6	6	12	0	0	12	0	0
20	944278	.	T	C	4	0	4	0	2	6	0	0
20	944314	.	A	C	3	3	6	0	0	6	0	0
20	946681	.	G	A	13	11	24	0	0	24	0	0
20	1079035	.	G	A	7	2	9	0	1	10	0	0
20	1081952	.	G	T	4	3	7	0	0	7	0	0
20	1081960	.	G	A	4	5	9	0	0	9	0	0
20	1119975	.	C	G	4	2	6	0	0	6	0	0
20	1125057	.	A	G	8	8	16	0	1	17	0	0
20	1125135	.	G	A	1	10	11	0	5	16	0	0
20	1141668	.	A	G	2	4	6	0	0	6	0	0
20	1177879	.	A	T	6	4	10	0	1	11	0	0
20	1178040	.	T	A	8	5	13	0	0	13	0	0
20	1178041	.	T	C	9	5	14	0	0	14	0	0
20	1178725	.	A	G	5	3	8	0	0	8	0	0
20	1178759	.	G	C	10	4	14	0	0	14	0	0
20	1179196	.	T	C	4	9	13	0	0	13	0	0
20	1179404	.	T	G	3	2	5	0	0	5	0	0
20	1179485	.	T	C	3	2	5	0	0	5	0	0
20	1179577	.	C	T	0	2	2	0	5	7	0	0
20	1179613	.	G	C	10	0	10	0	4	14	0	0
20	1179660	.	G	T	8	2	10	0	2	12	0	0
20	1179715	.	A	C	6	0	6	0	4	10	0	0
20	1185942	.	G	A	2	6	8	0	1	9	0	0
20	1198485	.	C	T	7	10	17	0	0	17	0	0
20	1198558	.	A	T	6	10	16	0	0	16	0	0
20	1198819	.	T	A	11	7	18	3	2	23	0	0
20	1201917	.	A	T	7	2	9	0	0	9	0	0
20	1203897	.	T	G	6	2	8	2	0	10	0	0
20	1204020	.	T	G	6	5	11	0	0	11	0	0
20	1239529	.	T	A	2	2	4	0	1	5	0	0
20	1239539	.	C	T	0	3	3	0	2	5	0	0
20	1240552	.	A	T	6	8	14	0	0	14	0	0
20	1240684	.	G	A	5	4	9	0	0	9	0	0
20	1241318	.	C	A	1	3	4	0	1	5	0	0
20	1241409	.	A	T	6	5	11	0	1	12	0	0
20	1241478	.	A	T	5	2	7	0	0	8	1	0
20	1241535	.	T	C	5	5	10	0	0	10	0	0
20	1241596	.	T	G	1	5	6	0	1	7	0	0
20	1246870	.	C	T	4	2	6	0	0	6	0	0
20	1257193	.	G	A	2	4	6	0	0	6	0	0
20	1278796	.	G	A	6	10	16	0	0	16	0	0
20	1279033	.	G	A	6	5	11	0	0	11	0	0
20	1294012	.	T	G	17	9	26	0	1	27	0	0
20	1294062	.	C	G	9	17	26	0	2	28	0	0
20	1294863	.	T	G	14	7	21	0	2	23	0	0
20	1294903	.	C	G	14	10	24	0	1	25	0	0
20	1294970	.	A	G	13	14	27	2	0	29	0	0
20	1295009	.	T	C	11	0	11	2	5	18	0	0
20	1295302	.	T	C	3	4	7	2	0	9	0	0
20	1295840	.	G	A	17	13	30	0	1	31	0	0
20	1296022	.	G	C	9	19	28	1	1	31	1	0
20	1296114	.	G	A	12	18	30	0	1	31	0	0
20	1296139	.	A	G	16	18	34	0	0	34	0	0
20	1316764	.	A	G	3	2	5	0	0	5	0	0
20	1316860	.	G	C	0	2	2	0	3	5	0	0
20	1324404	.	G	A	5	2	7	0	0	7	0	0
20	1324976	.	C	A	6	7	13	0	1	14	0	0
20	1327545	.	A	T	9	12	21	0	0	21	0	0
20	1327776	.	C	A	2	2	4	0	0	4	0	0
20	1338988	.	T	G	5	0	5	0	3	8	0	0
20	1339066	.	G	A	1	3	4	0	4	8	0	0
20	1339084	.	G	A	3	6	9	0	0	9	0	0
20	1339657	.	T	C	7	7	14	0	0	14	0	0
20	1339843	.	C	T	2	3	5	0	2	7	0	0
20	1339924	.	G	A	5	3	8	0	1	9	0	0
20	1340015	.	G	A	0	4	4	0	8	12	0	0
20	1349264	.	A	T	4	3	7	0	0	7	0	0
20	1349357	.	G	A	1	5	6	0	4	10	0	0
20	1349947	.	G	A	1	5	6	0	2	8	0	0
20	1350101	.	G	A	0	5	5	0	2	7	0	0
20	1441815	.	A	C	24	17	41	0	0	44	3	0
20	1441825	.	T	C	25	19	44	0	0	44	0	0
20	1442358	.	G	T	11	9	20	0	2	22	0	0
20	1442468	.	G	A	12	11	23	0	1	24	0	0
20	1442515	.	A	T	14	10	24	0	2	27	1	0
20	1442522	.	C	A	11	15	26	0	1	27	0	0
20	1442582	.	G	T	13	11	24	0	0	24	0	0
20	1442624	.	C	T	18	15	33	0	1	34	0	0
20	1454065	.	T	C	18	12	30	0	4	34	0	0
20	1455104	.	G	A	11	10	21	0	2	23	0	0
20	1460979	.	C	A	9	9	18	0	0	18	0	0
20	1476772	.	C	T	9	4	13	0	0	13	0	0
20	1487612	.	T	C	3	5	8	0	1	9	0	0
20	1513605	.	A	G	6	7	13	0	1	14	0	0
20	1513617	.	G	A	6	6	12	0	2	14	0	0
20	1518414	.	G	A	8	7	15	0	1	16	0	0
20	1519699	.	A	G	6	5	11	0	0	11	0	0
20	1560842	.	C	T	0	5	5	0	5	10	0	0
20	2976077	.	A	G	21	6	27	4	0	31	0	0
20	2976094	.	A	G	17	8	25	4	0	29	0	0
20	2976909	.	C	A	22	9	31	0	5	36	0	0
20	2977257	.	C	T	42	13	55	1	4	60	0	0
20	2977417	.	C	A	29	9	38	2	2	42	0	0
20	2977418	.	C	A	26	11	37	2	2	41	0	0
20	3086745	.	A	C	1	2	3	0	0	3	0	0
20	3121475	.	T	C	1	2	3	0	0	3	0	0
20	3307467	.	T	C	5	2	7	0	0	7	0	0
20	3916456	.	T	A	9	8	17	0	1	18	0	0
20	3916464	.	C	T	10	12	22	0	0	22	0	0
20	3916621	.	T	G	4	10	14	0	1	15	0	0
20	3920746	.	T	G	6	8	14	0	0	14	0	0
20	3920873	.	T	A	8	12	20	0	0	20	0	0
20	3920875	.	G	A	9	11	20	0	1	21	0	0
20	3920977	.	G	A	0	7	7	0	14	21	0	0
20	3921127	.	A	T	8	13	21	0	0	21	0	0
20	3921184	.	G	A	13	9	22	0	0	22	0	0
20	3921202	.	T	C	15	10	25	0	1	26	0	0
20	3923735	.	C	G	4	10	14	0	1	15	0	0
20	3923983	.	G	A	2	9	11	0	15	26	0	0
20	3924098	.	A	T	14	12	26	0	0	26	0	0
20	3924349	.	G	A	11	5	16	0	2	18	0	0
20	3924430	.	G	A	2	8	10	0	7	17	0	0
20	3924528	.	C	A	3	14	17	0	0	17	0	0
20	3924824	.	A	C	7	2	9	0	0	9	0	0
20	3924884	.	G	T	5	3	8	1	0	9	0	0
20	3924943	.	T	G	11	0	11	0	12	23	0	0
20	3925146	.	A	T	7	8	15	0	0	15	0	0
20	3925537	.	T	C	12	11	23	1	1	25	0	0
20	3925544	.	T	A	17	8	25	1	2	28	0	0
20	3925604	.	A	G	19	5	24	2	0	26	0	0
20	3925889	.	C	T	18	7	25	3	0	28	0	0
20	3925907	.	T	A	5	11	16	3	1	20	0	0
20	3926020	.	C	T	12	6	18	1	1	21	1	0
20	3926337	.	C	T	2	3	5	4	0	9	0	0
20	3926721	.	T	C	21	5	26	0	1	27	0	0
20	3926736	.	T	A	21	8	29	0	0	29	0	0
20	3926907	.	T	G	23	10	33	0	1	34	0	0
20	3926928	.	T	A	20	14	34	0	2	36	0	0
20	3926951	.	A	G	22	16	38	0	1	39	0	0
20	3927267	.	C	A	24	17	41	0	3	44	0	0
20	3927326	.	A	G	13	18	31	0	1	32	0	0
20	3927446	.	C	G	8	14	22	0	1	23	0	0
20	3947006	.	T	G	6	3	9	0	0	9	0	0
20	3947058	.	C	A	4	2	6	0	0	6	0	0
20	3947100	.	C	T	4	3	7	0	0	7	0	0
20	3953593	.	T	C	4	5	9	0	0	9	0	0
20	3954813	.	G	C	5	2	7	0	0	7	0	0
20	3971246	.	G	C	2	6	8	0	0	8	0	0
20	3991392	.	G	A	2	4	6	0	0	6	0	0
20	4009409	.	C	G	3	2	5	0	0	5	0	0
20	4010256	.	T	C	2	13	15	0	0	15	0	0
20	4010462	.	C	T	3	10	13	0	1	14	0	0
20	4011135	.	G	A	2	2	4	1	0	5	0	0
20	4011161	.	C	T	2	2	4	1	0	5	0	0
20	4035837	.	G	A	9	10	19	0	1	20	0	0
20	4035858	.	G	C	9	9	18	0	0	18	0	0
20	4036272	.	G	T	2	2	4	0	0	4	0	0
20	4036587	.	T	C	2	2	4	0	0	4	0	0
20	4037221	.	C	T	1	2	3	0	0	3	0	0
20	4037222	.	A	T	1	2	3	0	0	3	0	0
20	4037349	.	T	C	0	2	2	0	1	3	0	0
20	4037409	.	T	A	3	2	5	0	1	6	0	0
20	4037461	.	G	T	3	3	6	0	0	6	0	0
20	4037500	.	C	T	1	2	3	0	1	4	0	0
20	4037823	.	G	C	1	0	1	0	5	6	0	0
20	4037824	.	T	G	1	5	6	0	0	6	0	0
20	4037942	.	C	T	1	6	7	0	0	7	0	0
20	4051818	.	C	T	3	7	10	0	0	10	0	0
20	4052313	.	T	C	3	3	6	0	0	6	0	0
20	4052854	.	G	C	3	4	7	0	0	7	0	0
20	4053012	.	G	A	1	5	6	0	3	9	0	0
20	4153436	.	A	G	6	4	10	0	0	10	0	0
20	4157066	.	A	C	3	2	5	0	0	5	0	0
20	4180728	.	A	G	1	0	1	0	3	4	0	0
20	4180743	.	C	T	3	3	6	0	0	6	0	0
20	4393624	.	T	C	4	2	6	0	0	6	0	0
20	5051320	.	A	G	4	2	6	0	0	6	0	0
20	5065552	.	C	A	1	4	5	0	0	5	0	0
20	5065553	.	C	G	1	4	5	0	0	5	0	0
20	5065776	.	T	A	6	7	13	0	0	13	0	0
20	5066007	.	T	C	3	3	6	0	0	6	0	0
20	5067424	.	A	T	3	5	8	0	0	8	0	0
20	5069500	.	T	C	6	2	8	0	0	8	0	0
20	5069565	.	G	A	3	3	6	0	0	6	0	0
20	5089011	.	C	T	2	8	10	0	0	10	0	0
20	5093882	.	G	A	3	4	7	0	1	8	0	0
20	5094207	.	G	A	0	4	4	0	4	8	0	0
20	5094283	.	A	T	6	4	10	0	0	10	0	0
20	5158742	.	A	G	1	2	3	0	1	4	0	0
20	5163286	.	C	T	6	4	10	0	0	10	0	0
20	5228120	.	A	G	5	2	7	0	0	7	0	0
20	5228516	.	G	A	5	3	8	0	0	8	0	0
20	5237440	.	C	A	1	2	3	0	0	3	0	0
20	5330859	.	C	G	9	4	13	0	2	15	0	0
20	5330875	.	A	G	5	9	14	0	0	14	0	0
20	5330990	.	T	A	3	2	5	0	0	5	0	0
20	5331095	.	A	G	6	3	9	0	0	9	0	0
20	5331668	.	T	C	1	4	5	0	0	5	0	0
20	5331685	.	A	C	4	2	6	0	0	6	0	0
20	5331726	.	A	G	3	2	5	0	0	5	0	0
20	5332145	.	C	G	6	5	11	0	0	11	0	0
20	5332551	.	G	A	4	3	7	0	0	7	0	0
20	5332901	.	T	C	3	0	3	0	4	7	0	0
20	5333066	.	T	C	3	2	5	0	1	6	0	0
20	5333317	.	A	G	5	4	9	0	0	9	0	0
20	5333405	.	T	G	5	6	11	0	0	11	0	0
20	5337006	.	G	A	2	4	6	0	1	7	0	0
20	5358482	.	A	G	1	2	3	0	0	3	0	0
20	5390784	.	A	T	14	7	21	0	1	22	0	0
20	5391138	.	G	T	13	20	33	0	1	34	0	0
20	5394584	.	G	A	7	8	15	0	0	15	0	0
20	5563947	.	A	C	1	6	7	0	0	7	0	0
20	5564233	.	T	C	1	3	4	0	0	4	0	0
20	5564292	.	A	G	1	0	1	0	5	6	0	0
20	5679786	.	T	C	4	3	7	0	1	8	0	0
20	5696935	.	C	T	3	2	5	0	0	5	0	0
20	5696971	.	C	A	3	2	5	0	0	5	0	0
20	5742118	.	C	T	5	5	10	0	0	10	0	0
20	5742169	.	T	C	3	6	9	0	0	9	0	0
20	5744339	.	T	C	3	7	10	0	0	10	0	0
20	5921278	.	T	C	13	8	21	0	0	21	0	0
20	6102729	.	G	A	1	4	5	0	0	5	0	0
20	6103222	.	G	T	3	3	6	0	0	6	0	0
20	6103258	.	T	C	2	0	2	0	2	4	0	0
20	6164060	.	A	T	6	10	16	0	1	17	0	0
20	6164432	.	T	A	9	5	14	0	2	16	0	0
20	6164484	.	T	G	16	6	22	0	2	24	0	0
20	6164569	.	A	T	11	13	24	0	2	26	0	0
20	6164608	.	C	A	23	15	38	1	1	40	0	0
20	6164923	.	C	T	16	16	32	0	0	32	0	0
20	6165289	.	A	C	15	0	15	0	20	35	0	0
20	6165412	.	T	A	11	11	22	1	0	23	0	0
20	6165675	.	T	C	15	10	25	0	1	26	0	0
20	6165684	.	G	A	15	11	26	0	1	27	0	0
20	6165825	.	A	C	18	14	32	0	2	34	0	0
20	6165864	.	A	G	12	16	28	0	1	29	0	0
20	6166595	.	T	A	11	14	25	0	1	26	0	0
20	6166757	.	C	A	9	6	15	0	0	15	0	0
20	6166907	.	A	T	4	4	8	0	1	9	0	0
20	6169916	.	G	A	16	10	26	0	2	28	0	0
20	6178530	.	C	T	10	5	15	0	1	16	0	0
20	6341343	.	C	T	12	10	22	0	0	22	0	0
20	6341346	.	C	T	1	11	12	0	10	22	0	0
20	6341427	.	C	T	7	7	14	0	0	14	0	0
20	6347143	.	G	A	5	4	9	0	0	9	0	0
20	6347246	.	C	T	9	4	13	0	0	13	0	0
20	6380081	.	T	C	5	5	10	0	0	10	0	0
20	6380084	.	T	C	5	5	10	0	0	10	0	0
20	6380203	.	C	T	7	5	12	0	0	12	0	0
20	6380210	.	G	A	7	5	12	0	0	12	0	0
20	6380258	.	A	G	5	4	9	0	0	9	0	0
20	6410812	.	C	T	2	3	5	0	0	5	0	0
20	6413071	.	C	T	0	1	1	0	2	3	0	0
20	6425187	.	C	T	0	4	4	0	4	8	0	0
20	6967185	.	T	C	3	3	6	0	0	6	0	0
20	8055260	.	A	C	2	2	4	0	0	4	0	0
20	8060310	.	G	A	3	4	7	0	0	7	0	0
20	8122772	.	A	T	4	4	8	0	0	8	0	0
20	8122938	.	T	A	2	7	9	0	0	9	0	0
20	8138389	.	C	G	5	6	11	0	0	11	0	0
20	8154178	.	G	A	5	9	14	0	1	15	0	0
20	8154562	.	A	G	2	2	4	0	1	5	0	0
20	8189652	.	C	G	0	5	5	1	2	8	0	0
20	8245716	.	G	A	3	4	7	0	0	7	0	0
20	9109195	.	T	C	4	6	10	0	1	11	0	0
20	9192902	.	T	C	0	8	8	0	0	8	0	0
20	9192903	.	T	C	4	0	4	0	5	9	0	0
20	9420974	.	A	T	18	14	32	0	4	36	0	0
20	9420976	.	C	T	21	14	35	0	2	37	0	0
20	9960798	.	A	G	3	2	5	0	0	5	0	0
20	13567503	.	T	C	8	0	8	0	3	11	0	0
20	13567556	.	T	C	5	2	7	0	0	7	0	0
20	13567574	.	T	C	3	4	7	0	0	7	0	0
20	15049603	.	T	C	10	3	13	0	0	13	0	0
20	15051470	.	C	T	1	4	5	0	0	5	0	0
20	15116193	.	T	A	1	3	4	0	1	5	0	0
20	15876778	.	A	G	15	22	37	0	1	38	0	0
20	15876812	.	G	A	17	15	32	0	2	34	0	0
20	15876824	.	C	A	2	15	17	0	15	32	0	0
20	15911808	.	A	G	10	8	18	0	0	18	0	0
20	15911880	.	C	T	12	11	23	0	0	23	0	0
20	15912102	.	T	C	6	12	18	0	0	18	0	0
20	15912167	.	A	G	5	10	15	0	0	15	0	0
20	15912192	.	C	T	0	7	7	0	3	10	0	0
20	15912906	.	T	C	11	7	18	0	0	18	0	0
20	15922331	.	T	C	10	0	10	0	5	15	0	0
20	15922364	.	C	G	15	11	26	0	2	28	0	0
20	15933168	.	G	C	8	7	15	0	0	15	0	0
20	15933223	.	C	A	11	7	18	0	2	20	0	0
20	15933229	.	T	C	12	10	22	0	0	22	0	0
20	15933258	.	C	T	13	12	25	0	0	25	0	0
20	15933289	.	G	A	14	11	25	0	4	29	0	0
20	15933424	.	T	C	10	10	20	0	0	20	0	0
20	15933566	.	G	A	14	6	20	0	0	20	0	0
20	15933659	.	C	T	7	6	13	0	0	13	0	0
20	15934456	.	G	T	9	15	24	0	1	25	0	0
20	15934474	.	A	C	7	0	7	0	13	20	0	0
20	15934592	.	T	C	8	4	12	0	1	13	0	0
20	15934868	.	A	T	3	2	5	0	0	5	0	0
20	15935078	.	T	G	4	3	7	0	0	7	0	0
20	15935185	.	G	A	1	2	3	0	0	3	0	0
20	15935650	.	A	C	5	6	11	0	0	11	0	0
20	15935892	.	C	T	2	4	6	0	1	7	0	0
20	15935955	.	A	G	1	3	4	0	2	6	0	0
20	15936067	.	T	C	3	0	3	0	4	7	0	0
20	15936079	.	T	C	3	3	6	0	0	6	0	0
20	15936989	.	G	T	6	6	12	0	0	12	0	0
20	15937029	.	A	T	6	5	11	0	1	12	0	0
20	15937165	.	A	T	0	3	3	0	0	3	0	0
20	15937178	.	C	T	0	2	2	0	1	3	0	0
20	15937200	.	T	C	1	0	1	0	4	5	0	0
20	15937445	.	G	T	3	4	7	0	0	7	0	0
20	15937567	.	G	T	3	2	5	0	0	5	0	0
20	15937647	.	A	T	10	1	11	1	0	12	0	0
20	15937649	.	A	T	9	2	11	1	0	12	0	0
20	15937735	.	A	T	5	5	10	0	0	10	0	0
20	15937763	.	A	G	10	3	13	0	0	13	0	0
20	15937839	.	T	G	5	10	15	0	0	15	0	0
20	15937849	.	G	A	3	8	11	0	1	12	0	0
20	15937883	.	G	A	4	4	8	0	0	8	0	0
20	15937926	.	C	A	3	3	6	0	0	6	0	0
20	15969993	.	T	C	2	4	6	0	0	6	0	0
20	15969999	.	G	A	2	4	6	0	0	6	0	0
20	15970150	.	A	G	3	4	7	0	0	7	0	0
20	15970177	.	C	T	3	4	7	0	0	7	0	0
20	15970243	.	C	T	0	5	5	0	1	6	0	0
20	15970249	.	T	C	1	0	1	0	5	6	0	0
20	16020682	.	A	G	2	4	6	0	0	6	0	0
20	16034724	.	G	A	5	2	7	0	1	8	0	0
20	16034879	.	T	C	1	3	4	0	0	4	0	0
20	16156347	.	A	G	1	3	4	0	0	4	0	0
20	16163282	.	C	T	4	4	8	0	1	9	0	0
20	16163333	.	T	C	7	0	7	0	11	18	0	0
20	16163384	.	A	G	13	13	26	0	0	26	0	0
20	16171203	.	A	T	6	4	10	0	0	10	0	0
20	16173957	.	T	C	2	2	4	0	0	4	0	0
20	16177754	.	A	G	5	0	5	0	4	9	0	0
20	16180064	.	C	A	5	6	11	0	2	13	0	0
20	16180070	.	G	C	0	2	2	0	8	10	0	0
20	16180127	.	T	C	2	5	7	0	0	7	0	0
20	16182806	.	C	T	4	3	7	0	0	7	0	0
20	16193658	.	T	C	9	8	17	0	0	17	0	0
20	16193776	.	A	G	6	7	13	0	1	14	0	0
20	16193899	.	C	T	8	13	21	0	0	21	0	0
20	16201015	.	C	A	11	6	17	1	3	21	0	0
20	16201111	.	G	A	3	8	11	0	6	17	0	0
20	16201200	.	C	T	16	18	34	1	2	37	0	0
20	16201394	.	G	A	11	15	26	0	0	26	0	0
20	16201709	.	A	G	9	4	13	0	1	14	0	0
20	16201759	.	T	C	7	7	14	0	0	14	0	0
20	16201812	.	A	G	4	5	9	0	0	9	0	0
20	16437895	.	A	G	4	5	9	0	0	9	0	0
20	16437958	.	A	G	3	7	10	0	2	12	0	0
20	16438097	.	G	A	14	10	24	0	0	24	0	0
20	16438119	.	T	A	12	11	23	0	0	23	0	0
20	16438252	.	G	A	13	5	18	0	3	21	0	0
20	16438557	.	A	C	11	4	15	0	2	17	0	0
20	16438837	.	T	C	7	0	7	0	10	17	0	0
20	16438854	.	T	C	7	9	16	0	1	17	0	0
20	16441658	.	C	T	11	14	25	0	1	26	0	0
20	16446685	.	A	G	11	11	22	0	0	22	0	0
20	16477856	.	T	C	1	1	2	0	2	4	0	0
20	16477884	.	A	C	4	2	6	0	0	6	0	0
20	16477963	.	A	G	2	2	4	0	0	4	0	0
20	16477973	.	A	G	2	5	7	0	0	7	0	0
20	16478011	.	A	G	3	8	11	0	1	12	0	0
20	16478146	.	A	T	4	3	7	0	0	7	0	0
20	16478273	.	T	A	6	3	9	0	0	9	0	0
20	16478577	.	G	A	5	3	8	0	1	9	0	0
20	16478612	.	T	C	2	0	2	0	6	8	0	0
20	16485863	.	T	A	6	3	9	0	0	9	0	0
20	16498566	.	T	C	3	2	5	0	0	5	0	0
20	16498590	.	T	C	3	2	5	0	0	5	0	0
20	16498623	.	A	G	6	5	11	0	1	12	0	0
20	16498767	.	A	G	5	5	10	0	0	10	0	0
20	16498932	.	C	A	1	3	4	0	0	4	0	0
20	16639964	.	G	A	0	9	9	1	7	17	0	0
20	16644943	.	A	G	9	0	9	0	15	24	0	0
20	16645004	.	T	C	8	10	18	0	5	23	0	0
20	16652964	.	G	A	0	11	11	0	8	19	0	0
20	16660327	.	G	C	14	18	32	0	4	36	0	0
20	16660462	.	A	T	15	13	28	0	0	28	0	0
20	16660567	.	G	A	11	13	24	0	0	24	0	0
20	16660652	.	G	A	6	13	19	0	1	20	0	0
20	16660707	.	G	A	0	11	11	0	11	22	0	0
20	16660808	.	C	T	3	4	7	0	1	8	0	0
20	16734343	.	C	T	18	14	32	0	0	32	0	0
20	16737512	.	C	T	16	17	33	0	1	34	0	0
20	16740834	.	G	A	12	16	28	0	0	28	0	0
20	16771318	.	C	T	33	35	68	0	5	75	2	0
20	16774970	.	T	A	29	33	62	0	4	66	0	0
20	16775173	.	C	T	24	28	52	0	0	52	0	0
20	16832788	.	G	T	15	8	23	0	0	23	0	0
20	16834572	.	C	T	2	3	5	0	6	11	0	0
20	16834778	.	T	C	5	9	14	0	2	16	0	0
20	16849100	.	C	A	0	6	6	0	7	13	0	0
20	16903806	.	T	A	7	9	16	0	2	18	0	0
20	16903878	.	T	A	6	11	17	0	1	18	0	0
20	16906564	.	C	T	10	7	17	0	0	17	0	0
20	17740215	.	G	A	9	8	17	0	1	18	0	0
20	17798906	.	T	C	6	10	16	0	2	18	0	0
20	17799127	.	C	A	15	8	23	0	0	23	0	0
20	17800493	.	T	C	14	13	27	0	1	28	0	0
20	17800843	.	A	C	10	14	24	0	0	24	0	0
20	17800867	.	T	C	12	16	28	0	1	29	0	0
20	17802895	.	G	A	22	9	31	0	0	31	0	0
20	17802964	.	A	G	13	0	13	0	16	29	0	0
20	17803572	.	T	C	13	9	22	0	2	24	0	0
20	17809141	.	T	C	16	25	41	0	1	42	0	0
20	17813702	.	C	T	27	17	44	1	5	50	0	0
20	17817433	.	T	G	28	23	51	0	0	51	0	0
20	17817886	.	T	A	19	16	35	0	1	36	0	0
20	17817926	.	G	T	14	13	27	0	4	31	0	0
20	17818129	.	G	C	17	14	31	0	0	31	0	0
20	17818159	.	A	T	12	9	21	0	2	23	0	0
20	17818177	.	A	C	15	6	21	0	3	24	0	0
20	17819008	.	T	C	28	12	40	2	1	43	0	0
20	18249646	.	T	C	10	9	19	0	0	19	0	0
20	18255673	.	G	T	9	7	16	0	0	16	0	0
20	18255748	.	A	G	10	6	16	0	1	17	0	0
20	18255755	.	A	G	11	6	17	0	0	17	0	0
20	18255929	.	A	G	17	0	17	0	7	24	0	0
20	18255931	.	A	T	15	7	22	0	2	24	0	0
20	18312860	.	C	T	14	11	25	0	0	25	0	0
20	18313822	.	G	A	1	1	2	0	1	3	0	0
20	18354627	.	C	T	3	7	10	0	0	10	0	0
20	18363238	.	T	C	7	0	7	0	5	12	0	0
20	18369979	.	G	A	4	8	12	0	2	14	0	0
20	18375257	.	A	G	2	3	5	0	0	5	0	0
20	18375278	.	G	A	2	2	4	0	0	4	0	0
20	18392845	.	C	T	19	20	39	0	0	39	0	0
20	18393128	.	G	A	9	14	23	0	3	26	0	0
20	18393132	.	A	C	12	14	26	0	1	27	0	0
20	18393249	.	T	C	15	13	28	1	0	29	0	0
20	18393359	.	A	T	19	15	34	0	0	34	0	0
20	18393376	.	C	T	19	13	32	0	0	32	0	0
20	18396134	.	A	G	18	13	31	0	0	31	0	0
20	18413987	.	T	C	5	1	6	0	12	18	0	0
20	18417768	.	G	A	8	8	16	0	0	16	0	0
20	18417777	.	T	C	8	8	16	0	0	16	0	0
20	18419377	.	G	A	3	2	5	0	1	6	0	0
20	18419383	.	T	C	3	4	7	0	0	7	0	0
20	18431770	.	T	C	8	0	8	0	8	16	0	0
20	18443489	.	T	C	0	2	2	0	3	5	0	0
20	18443543	.	C	G	1	2	3	0	4	7	0	0
20	18443554	.	C	T	0	2	2	0	5	7	0	0
20	18456785	.	C	T	5	4	9	0	2	11	0	0
20	18456791	.	T	C	3	5	8	0	1	9	0	0
20	18459961	.	G	A	8	6	14	0	0	14	0	0
20	18459976	.	C	T	6	6	12	0	1	13	0	0
20	18535350	.	G	A	2	4	6	0	0	6	0	0
20	18551728	.	T	A	21	12	33	0	1	34	0	0
20	18591704	.	G	A	23	19	42	0	1	43	0	0
20	18591716	.	A	C	21	21	42	0	2	44	0	0
20	18591743	.	A	T	17	16	33	0	2	35	0	0
20	18594958	.	C	A	25	21	46	0	2	48	0	0
20	18669605	.	T	G	3	5	8	0	0	8	0	0
20	18672033	.	G	A	8	14	22	0	1	23	0	0
20	18672064	.	C	T	8	12	20	0	1	21	0	0
20	18672094	.	T	C	6	12	18	0	0	18	0	0
20	18672162	.	G	A	7	10	17	0	0	17	0	0
20	18672610	.	C	G	8	11	19	0	0	19	0	0
20	18672733	.	A	T	5	16	21	0	0	21	0	0
20	18672970	.	G	A	3	13	16	0	0	16	0	0
20	18673132	.	C	T	7	13	20	0	2	22	0	0
20	18677343	.	G	A	4	8	12	0	1	13	0	0
20	18683158	.	T	C	7	25	32	0	1	33	0	0
20	18683177	.	A	G	7	1	8	0	23	31	0	0
20	18684760	.	G	A	14	23	37	0	1	38	0	0
20	18684769	.	G	A	12	23	35	0	0	35	0	0
20	18685235	.	C	G	8	16	24	0	0	24	0	0
20	18685256	.	G	A	8	10	18	0	1	19	0	0
20	18685279	.	G	C	0	7	7	0	4	11	0	0
20	18685323	.	G	C	1	2	3	0	1	4	0	0
20	18708770	.	T	C	19	33	52	0	1	53	0	0
20	18713016	.	C	T	29	30	59	0	2	61	0	0
20	18713067	.	T	C	39	20	59	0	3	62	0	0
20	18714052	.	A	G	2	2	4	0	0	4	0	0
20	18721788	.	C	T	18	9	27	0	1	28	0	0
20	18721910	.	G	A	14	8	22	0	2	24	0	0
20	18722565	.	A	T	22	15	37	0	1	38	0	0
20	18722652	.	T	A	4	7	11	0	1	12	0	0
20	18722860	.	A	T	7	2	9	0	0	9	0	0
20	18723105	.	C	T	7	12	19	0	2	21	0	0
20	18723277	.	T	C	8	13	21	0	1	22	0	0
20	18723327	.	T	C	13	1	14	0	9	23	0	0
20	18723362	.	T	C	13	6	19	0	0	19	0	0
20	18723383	.	A	T	12	4	16	0	0	16	0	0
20	18723401	.	T	C	2	0	2	0	11	13	0	0
20	18723459	.	T	C	3	9	12	0	0	12	0	0
20	18727506	.	T	C	13	7	20	0	1	21	0	0
20	18730498	.	G	A	10	3	13	0	0	13	0	0
20	18730840	.	T	C	7	13	20	0	0	20	0	0
20	18731068	.	C	T	14	4	18	0	0	18	0	0
20	18755283	.	C	T	1	4	5	0	0	5	0	0
20	18755774	.	C	T	2	2	4	0	0	4	0	0
20	18755972	.	C	T	3	5	8	0	0	8	0	0
20	18756032	.	A	G	3	0	3	0	2	5	0	0
20	18756047	.	A	T	5	3	8	0	0	8	0	0
20	18756069	.	A	G	4	3	7	0	0	7	0	0
20	18756628	.	A	G	3	6	9	0	0	9	0	0
20	18774169	.	A	T	1	2	3	0	0	3	0	0
20	18775947	.	A	G	1	1	2	0	1	3	0	0
20	18776150	.	A	G	1	1	2	0	1	3	0	0
20	18776480	.	T	C	1	0	1	0	5	6	0	0
20	18783282	.	A	G	1	2	3	0	0	3	0	0
20	18801644	.	G	A	1	4	5	0	0	5	0	0
20	18801670	.	G	A	2	4	6	0	0	6	0	0
20	18802438	.	A	G	1	7	8	0	0	8	0	0
20	18802567	.	T	C	2	4	6	0	0	6	0	0
20	18915249	.	C	T	5	5	10	0	0	10	0	0
20	18947388	.	A	G	8	8	16	0	1	17	0	0
20	18958090	.	G	A	1	2	3	0	5	8	0	0
20	18958106	.	C	G	8	5	13	0	0	13	0	0
20	18958420	.	T	C	11	8	19	0	0	19	0	0
20	18958433	.	G	A	1	8	9	0	9	18	0	0
20	18958477	.	G	A	1	10	11	0	8	19	0	0
20	18961838	.	C	T	8	8	16	0	0	16	0	0
20	18968826	.	C	T	7	11	18	0	1	19	0	0
20	20602167	.	T	C	5	3	8	0	0	8	0	0
20	20602187	.	T	C	6	2	8	0	0	8	0	0
20	20602232	.	T	C	8	5	13	0	0	13	0	0
20	20605071	.	T	C	1	3	4	0	1	5	0	0
20	21638431	.	C	A	4	2	6	0	0	6	0	0
20	21638575	.	T	C	5	6	11	0	1	12	0	0
20	21638903	.	T	C	2	2	4	0	0	4	0	0
20	21815659	.	G	T	9	10	19	0	1	20	0	0
20	21815986	.	C	T	0	14	14	0	17	31	0	0
20	21816061	.	C	G	18	14	32	0	0	32	0	0
20	21819062	.	T	C	21	22	43	0	3	46	0	0
20	21828117	.	T	C	10	7	17	0	0	17	0	0
20	21839504	.	G	A	6	6	12	0	0	12	0	0
20	21841312	.	G	A	15	9	24	0	2	26	0	0
20	21841316	.	G	T	14	10	24	0	1	25	0	0
20	21855195	.	T	C	12	13	25	0	0	25	0	0
20	21862963	.	C	T	2	13	15	0	14	29	0	0
20	21862975	.	C	T	2	12	14	0	12	27	1	0
20	21872990	.	G	A	4	4	8	0	1	9	0	0
20	21875162	.	G	A	6	4	10	0	1	11	0	0
20	21875165	.	T	G	7	4	11	0	0	11	0	0
20	21875411	.	C	A	5	2	7	0	2	9	0	0
20	21910005	.	C	T	0	10	10	0	8	18	0	0
20	22045260	.	A	C	7	3	10	0	0	10	0	0
20	22050420	.	T	G	5	0	5	0	5	10	0	0
20	22061949	.	C	T	1	4	5	0	0	5	0	0
20	22160859	.	T	A	2	3	5	0	1	6	0	0
20	22166199	.	G	A	3	4	7	0	1	8	0	0
20	22166512	.	A	G	7	5	12	0	0	12	0	0
20	22168567	.	C	T	3	5	8	0	1	9	0	0
20	22174303	.	T	A	2	5	7	0	0	7	0	0
20	22175326	.	G	A	3	4	7	0	0	7	0	0
20	22175625	.	T	C	2	5	7	0	1	8	0	0
20	22175815	.	T	C	8	3	11	0	0	11	0	0
20	22175830	.	G	A	5	4	9	0	1	10	0	0
20	22179962	.	T	A	10	7	17	0	0	17	0	0
20	22186632	.	G	A	7	9	16	0	0	16	0	0
20	22186738	.	G	A	12	9	21	0	0	21	0	0
20	22186765	.	C	G	11	10	21	0	1	22	0	0
20	22186886	.	A	G	7	10	17	0	1	18	0	0
20	22186914	.	A	G	7	7	14	0	0	14	0	0
20	22186971	.	C	T	12	5	17	0	0	17	0	0
20	22186973	.	C	T	12	5	17	0	0	17	0	0
20	22187233	.	T	C	11	9	20	0	0	20	0	0
20	22191361	.	A	T	12	12	24	0	0	24	0	0
20	22191376	.	A	G	10	11	21	0	0	21	0	0
20	22191493	.	T	C	12	0	12	0	7	19	0	0
20	22193013	.	C	A	1	4	5	0	10	15	0	0
20	22194285	.	C	T	2	3	5	0	7	12	0	0
20	22194385	.	A	T	5	6	11	0	1	12	0	0
20	22194395	.	G	A	7	7	14	0	0	14	0	0
20	22196960	.	T	G	5	2	7	0	0	7	0	0
20	22709610	.	C	A	16	11	27	0	1	28	0	0
20	22709685	.	T	A	15	11	26	0	2	28	0	0
20	22722200	.	C	A	13	17	30	0	3	33	0	0
20	22722255	.	G	C	12	11	23	0	0	23	0	0
20	22730689	.	C	G	23	18	41	0	0	41	0	0
20	22734031	.	G	A	3	14	17	0	22	39	0	0
20	22734052	.	G	A	3	13	16	0	21	37	0	0
20	22736673	.	C	T	24	24	48	0	3	51	0	0
20	22738204	.	C	A	21	12	33	2	2	37	0	0
20	22739946	.	C	A	24	17	41	0	4	46	1	0
20	22740056	.	C	T	17	17	34	0	1	35	0	0
20	22740140	.	C	T	16	20	36	0	4	40	0	0
20	22740230	.	A	G	27	21	48	0	0	48	0	0
20	22740533	.	A	T	15	19	34	0	1	36	1	0
20	22740567	.	A	G	23	0	23	0	18	41	0	0
20	22800759	.	G	A	3	3	6	0	0	6	0	0
20	22802259	.	C	A	4	2	6	0	0	6	0	0
20	22843640	.	A	G	4	2	6	0	1	7	0	0
20	22907915	.	C	T	4	6	10	0	0	10	0	0
20	23017227	.	T	C	6	2	8	0	0	8	0	0
20	23021287	.	G	T	2	4	6	0	0	6	0	0
20	23021292	.	A	T	2	4	6	0	0	6	0	0
20	23023364	.	G	A	6	11	17	0	2	19	0	0
20	23023471	.	C	T	11	10	21	0	0	21	0	0
20	23023482	.	A	G	11	8	19	0	0	19	0	0
20	23023623	.	G	A	8	7	15	0	0	15	0	0
20	23023641	.	A	G	2	10	12	0	0	12	0	0
20	23023670	.	T	C	8	0	8	0	7	15	0	0
20	23024096	.	G	A	3	9	12	0	0	12	0	0
20	23026133	.	C	T	0	7	7	0	5	12	0	0
20	23175425	.	A	G	10	19	29	0	0	29	0	0
20	23175479	.	C	A	12	10	22	0	1	23	0	0
20	23175495	.	C	A	14	13	27	0	0	27	0	0
20	23178078	.	T	C	14	12	26	0	0	26	0	0
20	23179753	.	A	G	19	0	19	0	19	38	0	0
20	23204754	.	C	A	15	9	24	0	4	28	0	0
20	23205102	.	T	C	20	11	31	0	0	31	0	0
20	23205868	.	T	C	16	20	36	1	2	39	0	0
20	23205879	.	G	A	20	22	42	1	2	45	0	0
20	23245852	.	C	T	2	5	7	1	2	10	0	0
20	23246105	.	G	A	4	2	6	0	0	6	0	0
20	23246215	.	G	A	5	3	8	0	0	8	0	0
20	23248635	.	T	C	6	15	21	0	3	24	0	0
20	23250530	.	C	A	9	7	16	0	1	17	0	0
20	23253455	.	G	A	7	7	14	0	2	16	0	0
20	23254585	.	A	T	1	2	3	0	0	3	0	0
20	23376342	.	C	T	2	3	5	0	0	5	0	0
20	23385556	.	G	A	5	3	8	0	0	8	0	0
20	23385922	.	T	C	4	3	7	0	1	8	0	0
20	23386198	.	A	T	8	7	15	0	0	15	0	0
20	23387775	.	C	T	5	4	9	0	0	9	0	0
20	23395404	.	C	T	4	5	9	0	4	13	0	0
20	23402554	.	A	G	9	5	14	0	2	16	0	0
20	23406545	.	T	A	12	9	21	0	0	21	0	0
20	23408734	.	T	C	8	6	14	0	0	14	0	0
20	23418228	.	G	A	16	14	30	0	2	32	0	0
20	23418291	.	C	G	15	11	26	0	1	27	0	0
20	23420784	.	A	T	11	11	22	0	8	30	0	0
20	23421695	.	T	C	19	21	40	0	4	44	0	0
20	23422061	.	T	C	18	20	38	0	0	38	0	0
20	23422205	.	A	T	12	9	21	0	1	22	0	0
20	23446698	.	G	A	7	10	17	0	0	17	0	0
20	23446854	.	C	T	4	5	9	0	0	9	0	0
20	23447086	.	T	C	13	0	13	0	10	23	0	0
20	23447540	.	C	T	10	8	18	0	0	18	0	0
20	23447564	.	C	G	10	12	22	0	1	23	0	0
20	23453642	.	C	T	4	4	8	0	0	8	0	0
20	23453671	.	C	T	5	5	10	0	0	10	0	0
20	23453802	.	G	A	1	6	7	0	0	7	0	0
20	23467400	.	C	A	0	5	5	0	2	7	0	0
20	23471742	.	G	A	3	2	5	0	0	5	0	0
20	23471859	.	C	A	2	3	5	0	0	5	0	0
20	23472036	.	C	T	5	4	9	0	0	9	0	0
20	23472039	.	C	T	3	5	8	0	1	9	0	0
20	23472186	.	T	C	4	4	8	0	0	8	0	0
20	23472239	.	C	T	0	3	3	0	5	8	0	0
20	23472259	.	G	T	6	3	9	0	0	9	0	0
20	23477436	.	C	T	8	8	16	0	1	17	0	0
20	23478231	.	C	T	2	3	5	0	0	5	0	0
20	23478469	.	C	G	2	2	4	0	0	4	0	0
20	23479857	.	C	T	0	3	3	0	2	5	0	0
20	23491899	.	C	A	1	2	3	0	0	3	0	0
20	23491902	.	A	G	1	2	3	0	0	3	0	0
20	23647541	.	C	T	2	2	4	0	0	4	0	0
20	23647669	.	C	T	1	2	3	0	0	3	0	0
20	23647770	.	C	A	4	1	5	0	1	6	0	0
20	23647869	.	T	A	3	4	7	0	1	8	0	0
20	23648724	.	T	C	5	2	7	0	1	8	0	0
20	23648828	.	G	A	10	4	14	0	0	14	0	0
20	23651156	.	C	A	3	6	9	0	0	9	0	0
20	23651254	.	G	A	5	3	8	0	1	9	0	0
20	23651294	.	C	T	3	3	6	0	0	6	0	0
20	23651350	.	C	T	1	2	3	0	1	4	0	0
20	23651503	.	T	C	5	0	5	0	9	14	0	0
20	23655749	.	A	T	5	6	11	0	0	11	0	0
20	23656226	.	T	A	8	7	15	0	0	15	0	0
20	23656454	.	A	G	8	7	15	0	0	15	0	0
20	23658923	.	A	C	2	2	4	0	0	4	0	0
20	23659278	.	G	T	1	2	3	0	0	3	0	0
20	23664970	.	G	A	0	4	4	0	1	5	0	0
20	23665041	.	G	A	0	4	4	0	3	7	0	0
20	23665086	.	C	T	1	2	3	0	0	3	0	0
20	23665185	.	A	T	3	2	5	0	1	6	0	0
20	23665455	.	T	A	2	5	7	0	0	7	0	0
20	23665793	.	G	T	1	5	6	0	6	12	0	0
20	23665863	.	G	A	1	6	7	0	10	17	0	0
20	23666055	.	T	A	1	2	3	0	0	3	0	0
20	23682761	.	A	G	1	1	2	0	1	3	0	0
20	23685062	.	G	A	4	3	7	0	0	7	0	0
20	23685106	.	A	T	6	2	8	0	0	8	0	0
20	23685259	.	G	T	5	3	8	0	2	10	0	0
20	23685270	.	T	A	5	4	9	0	0	9	0	0
20	23685529	.	T	A	2	6	8	0	1	9	0	0
20	23689192	.	G	A	2	4	6	0	0	6	0	0
20	23689902	.	T	C	4	2	6	0	0	6	0	0
20	23689933	.	G	C	3	3	6	0	0	6	0	0
20	23689996	.	G	A	4	2	6	0	1	7	0	0
20	23690051	.	A	T	3	2	5	0	0	5	0	0
20	23690077	.	C	A	1	3	4	0	0	4	0	0
20	23691059	.	A	G	2	0	2	0	2	4	0	0
20	23691911	.	T	C	9	8	17	0	1	18	0	0
20	23691917	.	C	T	9	8	17	0	1	18	0	0
20	23692094	.	T	C	8	5	13	0	0	13	0	0
20	23694005	.	C	T	4	2	6	0	1	7	0	0
20	23705719	.	G	A	7	5	12	0	0	12	0	0
20	23705743	.	A	T	8	3	11	0	0	11	0	0
20	23705974	.	G	A	8	3	11	0	1	12	0	0
20	23713122	.	G	A	1	4	5	0	5	10	0	0
20	23713197	.	A	G	7	0	7	0	3	10	0	0
20	23713266	.	G	A	0	5	5	0	4	9	0	0
20	23713512	.	A	T	2	3	5	0	0	5	0	0
20	23713535	.	A	G	6	3	9	0	0	9	0	0
20	23713763	.	G	A	4	3	7	0	0	7	0	0
20	23713824	.	A	G	5	6	11	0	1	12	0	0
20	23713858	.	T	G	3	0	3	0	6	9	0	0
20	23713883	.	A	G	3	1	4	0	6	10	0	0
20	23742684	.	T	C	4	2	6	0	0	6	0	0
20	23742692	.	G	A	3	2	5	0	0	5	0	0
20	23746885	.	G	A	1	3	4	0	0	4	0	0
20	23747167	.	A	G	3	4	7	0	0	7	0	0
20	23796406	.	T	C	4	2	6	0	0	6	0	0
20	23796493	.	C	A	2	4	6	0	1	7	0	0
20	23801024	.	C	T	2	2	4	0	0	4	0	0
20	23801069	.	G	T	1	6	7	0	3	10	0	0
20	23801255	.	G	C	1	3	4	0	4	8	0	0
20	23826955	.	G	A	2	3	5	0	0	5	0	0
20	23828102	.	G	T	7	3	10	0	0	10	0	0
20	23829131	.	A	G	1	3	4	0	0	4	0	0
20	23829161	.	A	G	1	0	1	0	4	5	0	0
20	23829170	.	C	T	4	3	7	0	0	7	0	0
20	23829413	.	A	G	5	0	5	0	5	10	0	0
20	23832884	.	G	C	3	7	10	0	1	11	0	0
20	23833193	.	G	T	5	4	9	0	0	9	0	0
20	23835228	.	C	T	6	4	10	0	0	10	0	0
20	23835472	.	C	T	7	6	13	0	0	13	0	0
20	23835549	.	C	A	5	2	7	0	1	8	0	0
20	23835591	.	G	T	3	6	9	0	0	9	0	0
20	23835988	.	C	A	2	5	7	0	0	7	0	0
20	23836009	.	G	T	2	4	6	0	0	6	0	0
20	23836037	.	G	A	0	4	4	0	3	7	0	0
20	23836422	.	A	T	1	2	3	0	0	3	0	0
20	23836685	.	A	T	3	4	7	0	0	7	0	0
20	23836688	.	C	A	4	3	7	0	0	7	0	0
20	23836756	.	G	A	1	7	8	0	4	12	0	0
20	23836880	.	C	T	3	3	6	0	0	6	0	0
20	23857214	.	G	C	12	18	30	0	1	31	0	0
20	23857407	.	C	A	21	10	31	0	0	31	0	0
20	23857559	.	G	A	12	22	34	0	1	35	0	0
20	23857592	.	C	T	13	20	33	0	2	35	0	0
20	23859383	.	G	C	23	8	31	0	2	33	0	0
20	23859386	.	A	G	24	9	33	0	0	33	0	0
20	23859425	.	G	A	3	7	10	0	20	30	0	0
20	23859458	.	A	G	20	9	29	0	5	34	0	0
20	23859486	.	G	A	2	7	9	0	23	32	0	0
20	23877623	.	G	A	5	2	7	0	0	7	0	0
20	23879673	.	C	T	6	6	12	0	0	12	0	0
20	23879879	.	G	T	8	6	14	0	1	15	0	0
20	23879903	.	C	A	5	10	15	0	0	15	0	0
20	23881731	.	C	G	4	2	6	0	0	6	0	0
20	23881739	.	T	G	0	5	5	0	0	5	0	0
20	23882437	.	C	T	5	4	9	0	1	10	0	0
20	23883008	.	T	C	5	10	15	0	0	15	0	0
20	23883351	.	T	A	6	7	13	0	0	13	0	0
20	23883599	.	T	C	9	3	12	0	0	12	0	0
20	23884479	.	T	C	3	1	4	0	9	13	0	0
20	23885402	.	T	A	5	7	12	0	1	13	0	0
20	23885925	.	G	A	5	6	11	0	0	11	0	0
20	23886277	.	A	G	12	6	18	0	0	18	0	0
20	23886358	.	A	G	5	8	13	0	0	13	0	0
20	23887034	.	C	G	4	2	6	0	0	6	0	0
20	23888878	.	C	G	3	4	7	0	0	7	0	0
20	23889403	.	T	G	3	4	7	0	0	7	0	0
20	23890306	.	T	C	2	2	4	0	0	4	0	0
20	23890307	.	C	T	2	2	4	0	0	4	0	0
20	23890376	.	C	T	1	2	3	0	5	8	0	0
20	23890478	.	C	T	1	3	4	0	0	4	0	0
20	23890489	.	C	T	1	3	4	0	0	4	0	0
20	23892006	.	G	A	7	4	11	0	0	11	0	0
20	23892059	.	G	A	1	2	3	0	0	3	0	0
20	23894213	.	G	A	2	2	4	0	0	4	0	0
20	23898417	.	G	C	1	2	3	0	0	3	0	0
20	23898904	.	C	G	1	2	3	0	0	3	0	0
20	23902097	.	A	G	1	3	4	0	0	4	0	0
20	23949153	.	G	A	2	2	4	0	0	4	0	0
20	23951412	.	C	T	2	2	4	0	0	4	0	0
20	23952628	.	T	C	5	2	7	0	0	7	0	0
20	23952632	.	A	C	5	2	7	0	0	7	0	0
20	23954847	.	G	A	0	2	2	0	3	5	0	0
20	23955171	.	G	T	2	3	5	0	0	5	0	0
20	23955237	.	C	G	3	5	8	0	1	10	1	0
20	23955326	.	G	T	0	2	2	0	2	4	0	0
20	23955384	.	A	T	4	7	11	0	0	11	0	0
20	23972997	.	C	T	0	3	3	0	7	10	0	0
20	23973358	.	T	C	2	3	5	0	0	5	0	0
20	23973433	.	T	C	6	6	12	0	0	12	0	0
20	23974834	.	T	C	4	3	7	0	0	7	0	0
20	23974953	.	T	G	4	4	8	0	0	8	0	0
20	23975055	.	T	C	3	1	4	0	5	9	0	0
20	23996985	.	C	A	1	2	3	0	0	3	0	0
20	24122740	.	G	C	8	3	11	0	0	11	0	0
20	24151599	.	C	T	1	7	8	0	11	19	0	0
20	24152098	.	G	A	6	6	12	0	2	14	0	0
20	24152821	.	G	A	9	16	25	0	2	27	0	0
20	24152822	.	G	A	17	8	25	0	2	27	0	0
20	24183288	.	G	A	4	2	6	0	0	6	0	0
20	24818673	.	G	A	12	10	22	0	2	24	0	0
20	24819091	.	A	G	16	5	21	0	1	22	0	0
20	24819152	.	C	G	5	7	12	0	2	14	0	0
20	24819582	.	C	T	2	9	11	0	16	27	0	0
20	24819646	.	C	T	10	7	17	0	2	19	0	0
20	24819698	.	G	A	9	4	13	0	1	14	0	0
20	24819858	.	T	C	8	10	18	0	0	18	0	0
20	24819929	.	T	C	8	10	18	0	1	19	0	0
20	24820032	.	T	C	6	6	12	0	0	12	0	0
20	24820885	.	C	T	0	9	9	0	13	22	0	0
20	24820962	.	T	A	14	2	16	0	0	16	0	0
20	24821048	.	C	A	11	8	19	0	0	19	0	0
20	24821072	.	A	G	10	11	21	0	1	22	0	0
20	24821604	.	G	A	11	7	18	0	0	18	0	0
20	24835754	.	C	T	0	4	4	0	3	7	0	0
20	24856399	.	C	T	5	5	10	0	0	10	0	0
20	24915538	.	G	A	6	3	9	0	0	9	0	0
20	24915591	.	T	C	5	0	5	0	6	11	0	0
20	24959732	.	A	G	4	3	7	0	0	7	0	0
20	24962956	.	G	A	1	3	4	0	1	5	0	0
20	25269827	.	T	A	1	2	3	0	0	3	0	0
20	25271410	.	A	C	2	2	4	0	0	4	0	0
20	25271444	.	C	A	2	2	4	0	0	4	0	0
20	25342397	.	C	T	2	3	5	0	0	5	0	0
20	25342721	.	C	T	4	2	6	0	0	6	0	0
20	25368785	.	A	G	3	4	7	0	0	7	0	0
20	25368871	.	C	T	1	4	5	0	1	6	0	0
20	25371869	.	A	G	3	3	6	0	0	6	0	0
20	25371914	.	C	T	0	2	2	0	7	9	0	0
20	25372057	.	A	G	5	3	8	0	0	8	0	0
20	25384473	.	A	T	2	5	7	0	0	7	0	0
20	25384494	.	G	A	4	3	7	0	0	7	0	0
20	25387850	.	T	A	9	4	13	0	2	15	0	0
20	25387865	.	A	G	5	9	14	0	0	14	0	0
20	25400778	.	A	C	2	0	2	0	3	5	0	0
20	25440724	.	G	T	7	5	12	0	1	13	0	0
20	25441033	.	G	T	8	14	22	0	0	22	0	0
20	25444929	.	A	G	6	4	10	0	0	10	0	0
20	25494132	.	T	A	1	4	5	0	0	5	0	0
20	25494432	.	G	A	2	4	6	0	1	7	0	0
20	25499412	.	A	C	4	4	8	0	0	8	0	0
20	25500859	.	A	G	9	0	9	0	3	12	0	0
20	25500922	.	C	T	6	5	11	0	1	12	0	0
20	25507789	.	G	A	6	6	12	0	0	12	0	0
20	25509772	.	C	T	10	8	18	0	0	18	0	0
20	25509842	.	C	A	12	15	27	0	1	28	0	0
20	25509851	.	A	T	9	17	26	0	1	27	0	0
20	25509934	.	T	C	6	8	14	0	1	15	0	0
20	25510234	.	A	T	8	3	11	0	0	11	0	0
20	25510256	.	T	A	4	5	9	0	0	9	0	0
20	25510270	.	G	T	6	5	11	0	0	11	0	0
20	25510331	.	A	G	17	6	23	0	0	23	0	0
20	25510481	.	A	G	4	9	13	0	0	13	0	0
20	25510586	.	A	G	7	8	15	0	0	15	0	0
20	25510630	.	G	A	5	10	15	0	0	15	0	0
20	25510739	.	C	A	5	4	9	0	1	10	0	0
20	25510769	.	T	C	4	5	9	0	0	9	0	0
20	25510897	.	G	C	2	7	9	0	0	9	0	0
20	25511312	.	T	A	7	7	14	0	2	16	0	0
20	25511609	.	T	C	12	16	28	0	1	30	1	0
20	25511940	.	G	A	0	11	11	0	4	15	0	0
20	25511957	.	A	T	11	4	15	0	0	15	0	0
20	25516185	.	C	T	1	4	5	0	0	5	0	0
20	25548780	.	C	T	0	4	4	0	4	8	0	0
20	25552412	.	A	C	2	3	5	0	0	5	0	0
20	25556585	.	G	A	0	3	3	0	3	6	0	0
20	25556598	.	C	T	2	2	4	0	0	4	0	0
20	25614813	.	T	G	1	0	1	1	2	4	0	0
20	25618336	.	A	C	14	5	19	0	0	20	1	0
20	25618601	.	T	A	5	9	14	0	1	15	0	0
20	25623770	.	A	T	8	6	14	0	0	14	0	0
20	25623778	.	A	T	5	7	12	0	0	12	0	0
20	25628390	.	C	T	0	3	3	0	3	6	0	0
20	25629072	.	A	G	1	3	4	0	2	6	0	0
20	25635207	.	G	A	1	4	5	0	1	6	0	0
20	25660033	.	T	A	3	3	6	0	0	6	0	0
20	25661199	.	A	G	13	19	32	0	0	32	0	0
20	25661509	.	G	A	20	21	41	0	2	43	0	0
20	25663590	.	T	G	21	19	40	0	5	45	0	0
20	25665101	.	G	T	11	15	26	0	0	26	0	0
20	25665115	.	G	T	11	15	26	0	1	27	0	0
20	25665144	.	G	T	13	16	29	0	2	31	0	0
20	25665195	.	G	A	11	13	24	0	1	25	0	0
20	25665325	.	T	G	6	10	16	0	1	17	0	0
20	25665506	.	C	T	13	7	20	0	1	21	0	0
20	25665515	.	C	T	12	7	19	0	0	19	0	0
20	25665627	.	T	C	8	9	17	0	0	17	0	0
20	25665822	.	G	A	6	11	17	0	1	18	0	0
20	25665927	.	T	C	9	13	22	0	0	22	0	0
20	25666142	.	C	T	7	6	13	0	0	13	0	0
20	25666277	.	G	T	8	5	13	0	0	13	0	0
20	25666812	.	T	A	11	21	32	0	2	34	0	0
20	25666947	.	C	T	11	9	20	0	2	22	0	0
20	25669567	.	T	G	4	10	14	0	0	14	0	0
20	25669888	.	C	A	5	8	13	0	1	14	0	0
20	25853228	.	T	C	3	2	5	0	0	5	0	0
20	25853767	.	A	G	17	23	40	0	1	41	0	0
20	25855561	.	G	A	19	19	38	0	1	39	0	0
20	25859494	.	C	T	11	13	24	0	1	25	0	0
20	25906391	.	T	C	3	2	5	0	0	5	0	0
20	25909276	.	T	C	2	6	8	0	1	9	0	0
20	25909330	.	C	T	4	8	12	0	0	12	0	0
20	25909462	.	T	C	9	9	18	0	0	18	0	0
20	25909699	.	C	T	11	8	19	0	2	21	0	0
20	25909765	.	A	C	6	12	18	0	1	19	0	0
20	25910133	.	G	A	7	7	14	0	0	14	0	0
20	25910298	.	A	T	2	5	7	0	0	7	0	0
20	25910366	.	A	T	5	5	10	0	0	10	0	0
20	25910368	.	A	T	6	5	11	0	0	11	0	0
20	25910522	.	G	T	3	4	7	0	0	7	0	0
20	25910531	.	G	A	4	4	8	0	0	8	0	0
20	25910574	.	T	C	4	2	6	0	1	7	0	0
20	25910586	.	C	A	3	2	5	0	0	5	0	0
20	25919371	.	T	C	12	15	27	0	1	28	0	0
20	25921009	.	C	T	13	6	19	0	1	20	0	0
20	25923747	.	T	C	10	14	24	0	0	24	0	0
20	25923960	.	T	C	9	20	29	0	1	30	0	0
20	25926048	.	A	G	9	13	22	0	4	26	0	0
20	25926474	.	G	A	6	6	12	0	0	12	0	0
20	25926505	.	T	C	6	6	12	0	1	13	0	0
20	25926540	.	T	A	6	10	16	0	0	16	0	0
20	25926792	.	T	G	1	3	4	0	0	4	0	0
20	25926793	.	T	G	1	3	4	0	0	4	0	0
20	25927126	.	C	A	17	12	29	0	0	29	0	0
20	25927259	.	C	G	18	0	18	0	21	39	0	0
20	25927283	.	T	G	22	22	44	0	0	44	0	0
20	25927310	.	A	G	23	10	33	0	1	34	0	0
20	25928098	.	C	T	19	10	29	0	0	29	0	0
20	25929576	.	A	T	8	9	17	0	0	17	0	0
20	25929913	.	T	A	19	12	31	0	1	32	0	0
20	25930671	.	T	C	21	12	33	0	2	35	0	0
20	25952800	.	T	C	2	3	5	0	0	5	0	0
20	25953365	.	G	C	1	2	3	0	0	3	0	0
20	25953682	.	T	C	2	5	7	0	0	7	0	0
20	26002683	.	T	C	4	3	7	0	3	10	0	0
20	26002900	.	C	G	6	6	12	0	0	12	0	0
20	26002970	.	A	G	9	0	9	0	3	12	0	0
20	26004160	.	T	A	11	5	16	0	2	18	0	0
20	26004251	.	A	G	7	5	12	0	0	12	0	0
20	26024196	.	G	A	13	23	36	0	3	39	0	0
20	26024432	.	C	T	16	16	32	0	1	33	0	0
20	26024434	.	A	G	16	16	32	0	1	33	0	0
20	26024565	.	G	A	2	22	24	0	14	38	0	0
20	26027048	.	C	T	2	4	6	0	6	12	0	0
20	26027434	.	G	T	12	6	18	0	0	18	0	0
20	26027630	.	C	T	6	3	9	0	0	9	0	0
20	26030641	.	G	T	12	8	20	0	1	21	0	0
20	26035649	.	A	G	3	5	8	0	2	10	0	0
20	26047462	.	G	A	14	10	24	0	1	25	0	0
20	26048474	.	T	C	1	0	1	0	3	4	0	0
20	26048815	.	C	T	4	2	6	0	0	6	0	0
20	26049961	.	G	A	4	4	8	0	0	8	0	0
20	26050226	.	T	C	8	0	8	0	5	13	0	0
20	26054485	.	T	C	3	2	5	0	0	5	0	0
20	26054503	.	A	G	3	3	6	0	0	6	0	0
20	26055709	.	A	C	2	2	4	0	0	4	0	0
20	26060088	.	G	T	3	3	6	0	0	6	0	0
20	26062837	.	T	C	3	0	3	0	4	7	0	0
20	26273194	.	T	C	1	3	4	0	0	4	0	0
20	26273680	.	C	T	1	4	5	0	0	5	0	0
20	26279961	.	A	C	1	3	4	0	0	4	0	0
20	26285606	.	G	A	2	1	3	0	2	5	0	0
20	26290451	.	G	A	3	4	7	0	0	7	0	0
20	26290738	.	A	T	4	6	10	0	0	10	0	0
20	26290739	.	T	C	4	6	10	0	0	10	0	0
20	26290778	.	A	G	4	2	6	0	0	6	0	0
20	26290855	.	G	C	2	4	6	0	0	6	0	0
20	26290947	.	A	G	2	2	4	0	0	4	0	0
20	26290962	.	C	T	2	4	6	0	0	6	0	0
20	26291016	.	G	C	3	3	6	0	1	7	0	0
20	26291147	.	T	C	1	2	3	0	0	3	0	0
20	26298380	.	G	A	3	11	14	0	0	14	0	0
20	26300495	.	A	G	4	2	6	0	0	6	0	0
20	26301092	.	C	T	3	3	6	0	0	6	0	0
20	26304317	.	A	G	2	3	5	0	0	5	0	0
20	26304918	.	G	A	2	4	6	0	0	6	0	0
20	26304921	.	G	A	3	4	7	0	0	7	0	0
20	26305019	.	A	T	7	6	13	0	0	13	0	0
20	26320288	.	T	C	14	8	22	0	0	22	0	0
20	26321073	.	G	A	7	4	11	0	1	12	0	0
20	26323356	.	T	C	7	10	17	0	0	17	0	0
20	26325671	.	A	G	6	13	19	0	0	19	0	0
20	26326345	.	T	C	9	10	19	0	2	21	0	0
20	26327719	.	C	T	7	5	12	0	2	14	0	0
20	26328051	.	C	T	10	5	15	0	1	16	0	0
20	26329035	.	G	A	6	11	17	0	1	18	0	0
20	26331595	.	A	G	20	8	28	0	0	28	0	0
20	26334446	.	C	T	13	17	30	0	1	31	0	0
20	26336921	.	C	G	9	16	25	0	4	29	0	0
20	26337036	.	C	T	10	24	34	0	2	36	0	0
20	26337733	.	C	T	22	21	43	0	0	43	0	0
20	26342889	.	C	T	15	17	32	0	0	32	0	0
20	26344835	.	A	G	9	19	28	0	2	30	0	0
20	26345856	.	T	A	24	19	43	0	7	50	0	0
20	26346710	.	C	T	22	29	51	0	3	54	0	0
20	26348838	.	G	A	2	14	16	0	17	33	0	0
20	26351914	.	T	G	18	1	19	0	13	32	0	0
20	26353751	.	T	C	24	16	40	0	1	41	0	0
20	26353770	.	A	G	24	13	37	0	2	39	0	0
20	26353793	.	T	C	25	16	41	0	2	43	0	0
20	26358574	.	T	C	28	26	54	0	1	55	0	0
20	26360192	.	C	T	5	7	12	0	0	12	0	0
20	26361403	.	G	A	3	4	7	0	0	7	0	0
20	26368750	.	G	C	2	2	4	0	0	4	0	0
20	26387181	.	G	A	11	7	18	1	1	20	0	0
20	26387288	.	T	A	8	7	15	0	0	15	0	0
20	26387413	.	A	T	7	8	15	0	2	17	0	0
20	26390906	.	C	T	2	3	5	0	0	5	0	0
20	26390912	.	G	A	2	2	4	0	0	4	0	0
20	26404281	.	A	G	3	0	3	0	2	5	0	0
20	26404361	.	C	G	4	3	7	0	0	7	0	0
20	26404696	.	G	A	1	2	3	0	3	6	0	0
20	26404860	.	T	A	5	5	10	0	0	10	0	0
20	26405406	.	T	G	2	0	2	0	2	4	0	0
20	26405669	.	C	A	3	1	4	0	1	5	0	0
20	26405808	.	T	A	1	2	3	0	0	3	0	0
20	26405857	.	G	A	1	6	7	0	2	9	0	0
20	26406160	.	G	A	1	7	8	0	8	16	0	0
20	26406352	.	T	C	3	4	7	0	0	7	0	0
20	26406369	.	G	A	3	4	7	0	0	7	0	0
20	26406551	.	A	T	2	2	4	0	0	4	0	0
20	26406640	.	G	T	0	2	2	0	5	7	0	0
20	26406806	.	C	T	2	2	4	0	0	4	0	0
20	26406978	.	A	G	7	0	7	0	3	10	0	0
20	26409194	.	T	A	7	4	11	1	0	12	0	0
20	26409261	.	C	A	1	10	11	0	2	13	0	0
20	26409295	.	C	A	10	11	21	0	1	22	0	0
20	26409310	.	A	T	11	10	21	0	1	22	0	0
20	26409403	.	A	T	15	9	24	0	0	24	0	0
20	26409471	.	C	T	2	15	17	0	10	27	0	0
20	26409599	.	C	T	21	14	35	0	2	37	0	0
20	26409922	.	T	C	15	19	34	0	0	34	0	0
20	26409931	.	C	T	17	16	33	0	4	37	0	0
20	26410224	.	G	T	5	12	17	0	0	17	0	0
20	26410275	.	G	A	13	5	18	0	1	19	0	0
20	26410341	.	A	G	16	12	28	0	0	28	0	0
20	26410344	.	A	C	16	13	29	0	0	29	0	0
20	26412372	.	T	A	10	13	23	0	3	26	0	0
20	26412479	.	C	T	12	6	18	0	0	18	0	0
20	26412501	.	G	A	12	8	20	0	0	20	0	0
20	26412579	.	C	A	10	10	20	0	0	20	0	0
20	26412830	.	G	T	20	15	35	0	0	35	0	0
20	26412831	.	G	T	20	15	35	0	0	35	0	0
20	26412876	.	G	A	15	16	31	0	0	31	0	0
20	26412968	.	T	A	17	11	28	0	3	31	0	0
20	26413057	.	G	A	15	6	21	0	2	23	0	0
20	26413181	.	T	C	7	7	14	0	1	15	0	0
20	26413269	.	C	A	8	13	21	0	2	23	0	0
20	26413280	.	A	C	10	1	11	0	14	25	0	0
20	26413311	.	C	T	10	17	27	0	0	27	0	0
20	26413470	.	G	T	7	9	16	0	1	17	0	0
20	26413584	.	G	A	6	5	11	0	0	11	0	0
20	26413923	.	C	T	5	4	9	0	0	9	0	0
20	26413998	.	A	T	11	8	19	0	0	19	0	0
20	26414724	.	C	T	0	4	4	0	6	10	0	0
20	26414747	.	C	T	5	6	11	0	0	11	0	0
20	26414832	.	C	T	5	2	7	0	0	7	0	0
20	26414844	.	G	A	4	2	6	0	0	6	0	0
20	26414919	.	A	G	4	6	10	0	0	10	0	0
20	26415021	.	G	T	5	6	11	0	0	11	0	0
20	26416114	.	A	G	4	3	7	0	0	7	0	0
20	26416353	.	T	G	2	7	9	0	3	12	0	0
20	26416469	.	C	G	3	3	6	0	1	7	0	0
20	26416514	.	T	C	5	2	7	0	1	8	0	0
20	26467216	.	C	T	3	5	8	0	1	9	0	0
20	26574266	.	C	T	9	9	18	0	1	19	0	0
20	26584155	.	A	T	5	3	8	0	0	8	0	0
20	26587834	.	A	G	11	7	18	0	1	19	0	0
20	26594516	.	G	T	5	7	12	0	0	12	0	0
20	26599709	.	C	T	8	6	14	0	1	15	0	0
20	26601222	.	G	A	7	10	17	0	0	17	0	0
20	26613462	.	A	G	9	6	15	0	1	16	0	0
20	26616241	.	G	C	6	0	6	0	5	11	0	0
20	26807385	.	G	A	11	5	16	0	0	16	0	0
20	26809059	.	A	G	12	5	17	0	1	18	0	0
20	26822449	.	A	G	10	6	16	0	0	16	0	0
20	26886291	.	C	T	2	2	4	0	0	4	0	0
20	26893058	.	C	A	1	3	4	0	0	4	0	0
20	26893097	.	G	A	1	4	5	0	0	5	0	0
20	26913236	.	G	T	6	4	10	0	0	10	0	0
20	26920805	.	G	C	3	2	5	0	0	5	0	0
20	26920879	.	C	G	5	2	7	1	0	8	0	0
20	26921031	.	C	T	4	3	7	0	0	7	0	0
20	26921043	.	A	G	5	3	8	0	0	8	0	0
20	26921313	.	T	C	8	4	12	0	0	12	0	0
20	26939926	.	C	T	10	11	21	0	2	23	0	0
20	26944106	.	G	A	11	15	26	0	4	30	0	0
20	26944311	.	G	A	20	11	31	0	6	37	0	0
20	26944576	.	C	T	7	19	26	0	1	27	0	0
20	26944762	.	C	T	12	12	24	0	0	24	0	0
20	26944971	.	G	A	6	3	9	0	1	10	0	0
20	26945180	.	T	A	4	3	7	0	0	7	0	0
20	26945394	.	C	T	11	8	19	0	0	19	0	0
20	26945735	.	C	T	6	12	18	0	0	18	0	0
20	26945913	.	T	C	13	16	29	0	0	29	0	0
20	26948033	.	A	T	4	3	7	0	0	7	0	0
20	26948161	.	A	G	9	5	14	0	1	15	0	0
20	26948347	.	T	C	4	3	7	0	1	8	0	0
20	26958737	.	C	T	8	6	14	0	2	16	0	0
20	26959139	.	G	C	3	3	6	0	0	6	0	0
20	26959605	.	T	C	9	5	14	0	1	15	0	0
20	26959624	.	C	T	8	4	12	0	2	14	0	0
20	26959829	.	C	T	8	6	14	0	0	14	0	0
20	26960032	.	G	C	9	9	18	0	0	18	0	0
20	26960540	.	A	G	3	0	3	0	8	11	0	0
20	26960619	.	A	G	7	5	12	0	0	12	0	0
20	26960802	.	T	C	8	8	16	0	1	17	0	0
20	26960877	.	G	A	1	6	7	0	9	16	0	0
20	26961079	.	G	A	1	3	4	0	4	8	0	0
20	26961469	.	A	G	3	5	8	0	3	11	0	0
20	26961758	.	A	T	8	4	12	0	0	12	0	0
20	26961799	.	C	T	5	8	13	0	0	13	0	0
20	26961832	.	T	G	7	8	15	0	1	17	1	0
20	26961907	.	A	G	10	9	19	0	1	20	0	0
20	26962077	.	G	A	0	12	12	0	8	20	0	0
20	26962095	.	T	C	8	14	22	0	1	23	0	0
20	26962385	.	T	A	13	6	19	0	0	19	0	0
20	26972810	.	C	T	1	4	5	0	0	5	0	0
20	26973296	.	T	C	2	6	8	0	1	9	0	0
20	26973754	.	T	A	1	4	5	0	0	5	0	0
20	26989248	.	T	G	2	3	5	0	0	5	0	0
20	26993506	.	C	T	4	3	7	0	0	7	0	0
20	26994703	.	T	A	1	3	4	0	0	4	0	0
20	26999506	.	T	A	11	4	15	0	0	15	0	0
20	27001816	.	A	C	9	13	22	0	1	23	0	0
20	27001864	.	T	A	11	14	25	0	0	25	0	0
20	27001867	.	C	T	11	13	24	0	0	24	0	0
20	27001903	.	C	T	16	11	27	0	0	27	0	0
20	27001915	.	T	C	15	8	23	0	1	24	0	0
20	27002007	.	A	G	12	5	17	0	0	17	0	0
20	27020221	.	G	A	6	8	14	0	1	15	0	0
20	27020294	.	T	A	20	25	45	0	1	46	0	0
20	27020346	.	A	C	7	17	24	0	1	25	0	0
20	27020442	.	G	T	12	18	30	0	4	34	0	0
20	27020446	.	G	A	15	19	34	0	1	35	0	0
20	27029685	.	A	C	30	22	52	0	0	52	0	0
20	27033700	.	C	T	29	25	54	0	1	55	0	0
20	27033847	.	A	T	27	26	53	0	1	54	0	0
20	27033914	.	A	G	28	24	52	1	5	58	0	0
20	27039364	.	G	T	5	31	36	0	30	66	0	0
20	27039400	.	G	A	25	32	57	0	3	60	0	0
20	27039498	.	C	T	31	29	60	0	2	62	0	0
20	27039550	.	A	T	27	35	62	0	0	62	0	0
20	27039577	.	C	T	22	34	56	0	5	61	0	0
20	27045649	.	T	G	22	9	31	0	39	70	0	0
20	27045703	.	A	G	17	29	46	0	2	48	0	0
20	27045719	.	T	C	14	15	29	0	3	32	0	0
20	27045875	.	T	C	6	8	14	0	1	15	0	0
20	27087569	.	C	T	4	5	9	0	0	9	0	0
20	27089717	.	C	T	1	1	2	0	1	3	0	0
20	27090401	.	C	T	3	7	10	0	0	10	0	0
20	27090551	.	A	T	1	6	7	0	0	7	0	0
20	27090648	.	C	T	1	2	3	0	0	3	0	0
20	27091064	.	G	A	4	4	8	0	0	8	0	0
20	27091143	.	G	A	6	3	9	0	2	11	0	0
20	27092182	.	C	T	11	7	18	0	1	19	0	0
20	27092245	.	A	G	14	11	25	0	0	25	0	0
20	27093198	.	A	T	6	3	9	0	0	9	0	0
20	27093286	.	C	T	1	4	5	0	0	5	0	0
20	27094693	.	T	C	3	4	7	0	0	7	0	0
20	27096092	.	A	T	16	8	24	0	1	25	0	0
20	27096469	.	G	T	2	8	10	0	11	21	0	0
20	27100005	.	T	C	11	7	18	0	1	19	0	0
20	27102325	.	C	T	10	5	15	0	0	15	0	0
20	27107173	.	A	C	10	7	17	0	0	17	0	0
20	27107241	.	C	A	7	9	16	0	0	16	0	0
20	27107545	.	G	T	2	4	6	0	9	15	0	0
20	27115030	.	T	C	1	2	3	0	0	3	0	0
20	27194883	.	C	T	1	5	6	0	0	6	0	0
20	27194884	.	C	A	1	4	5	0	1	6	0	0
20	27264482	.	G	A	1	4	5	0	1	6	0	0
20	27280808	.	G	A	3	5	8	0	1	9	0	0
20	27280840	.	G	A	0	6	6	0	1	7	0	0
20	27281203	.	A	G	5	4	9	0	0	9	0	0
20	27281624	.	T	C	7	7	14	0	0	14	0	0
20	27281678	.	A	C	6	5	11	0	0	11	0	0
20	27281780	.	T	G	3	8	11	0	0	11	0	0
20	27281814	.	T	A	3	7	10	0	1	11	0	0
20	27282267	.	A	T	2	2	4	0	1	5	0	0
20	27282340	.	A	C	2	7	9	0	0	9	0	0
20	27282437	.	A	G	8	5	13	0	0	13	0	0
20	27282438	.	G	A	8	5	13	0	0	13	0	0
20	27282561	.	T	C	8	6	14	0	1	15	0	0
20	27282592	.	A	G	10	10	20	0	0	20	0	0
20	27282598	.	T	A	7	11	18	0	1	19	0	0
20	27283206	.	C	A	7	4	11	0	0	11	0	0
20	27331149	.	G	A	6	8	14	0	0	14	0	0
20	27353982	.	A	G	13	4	17	0	1	18	0	0
20	27358777	.	C	A	12	8	20	0	1	21	0	0
20	27366122	.	G	A	10	8	18	0	0	18	0	0
20	27366597	.	T	G	13	18	31	0	1	32	0	0
20	27368882	.	A	C	15	25	40	0	0	40	0	0
20	27370340	.	G	A	23	10	33	0	3	36	0	0
20	27371629	.	T	C	13	31	44	0	3	47	0	0
20	27371642	.	A	C	15	28	43	0	3	46	0	0
20	27371693	.	T	A	8	23	31	0	1	32	0	0
20	27371735	.	A	G	5	23	28	0	0	28	0	0
20	27371737	.	T	C	6	2	8	0	21	29	0	0
20	27371821	.	C	A	16	15	31	0	1	32	0	0
20	27374961	.	C	T	25	25	50	1	3	54	0	0
20	27375008	.	C	T	3	21	24	0	28	52	0	0
20	27378174	.	C	T	24	16	40	0	1	41	0	0
20	27378252	.	A	T	27	20	47	0	0	47	0	0
20	27378321	.	G	T	21	22	43	0	2	45	0	0
20	27381508	.	G	A	19	8	27	0	0	27	0	0
20	27381529	.	T	G	17	11	28	0	2	30	0	0
20	27396384	.	T	A	7	9	16	0	1	17	0	0
20	27396385	.	A	T	8	9	17	0	0	17	0	0
20	27396478	.	A	T	5	8	13	0	0	13	0	0
20	27396489	.	C	T	5	7	12	0	0	12	0	0
20	27542371	.	G	A	0	2	2	0	5	7	0	0
20	27546071	.	A	G	4	3	7	0	0	7	0	0
20	27550063	.	G	A	2	5	7	0	0	7	0	0
20	27550104	.	G	T	2	5	7	0	1	8	0	0
20	27550148	.	C	T	2	3	5	0	0	5	0	0
20	27550150	.	A	C	1	3	4	0	1	5	0	0
20	27550915	.	T	A	6	3	9	0	0	9	0	0
20	27550977	.	G	A	1	3	4	0	1	5	0	0
20	27551005	.	T	C	3	3	6	0	0	6	0	0
20	27551113	.	A	T	4	3	7	0	0	7	0	0
20	27551253	.	A	C	4	4	8	0	1	9	0	0
20	27551329	.	A	G	2	3	5	0	2	7	0	0
20	27551563	.	T	C	3	2	5	0	0	5	0	0
20	27692545	.	A	G	1	2	3	0	0	3	0	0
20	27692934	.	T	C	2	2	4	0	0	4	0	0
20	27693194	.	G	A	0	2	2	0	1	3	0	0
20	27693204	.	T	G	2	1	3	0	0	3	0	0
20	27708016	.	G	A	2	3	5	0	1	6	0	0
20	27708181	.	C	T	2	1	3	0	1	4	0	0
20	27708306	.	A	G	2	5	7	0	1	8	0	0
20	27708943	.	G	A	1	2	3	0	0	3	0	0
20	27716086	.	G	A	0	5	5	0	3	8	0	0
20	27716093	.	C	T	3	5	8	0	0	8	0	0
20	27717055	.	T	A	4	3	7	0	0	7	0	0
20	27717884	.	G	A	1	2	3	0	0	3	0	0
20	27717923	.	A	G	1	1	2	0	1	3	0	0
20	27717945	.	C	T	1	3	4	0	0	4	0	0
20	27718292	.	T	C	3	2	5	0	0	5	0	0
20	27718304	.	T	C	3	2	5	0	0	5	0	0
20	27718549	.	T	A	2	3	5	0	1	6	0	0
20	27718578	.	A	T	3	5	8	0	0	8	0	0
20	27718824	.	C	G	2	4	6	0	0	6	0	0
20	27719763	.	G	A	5	4	9	0	3	12	0	0
20	27719859	.	T	C	3	3	6	0	0	6	0	0
20	27732628	.	A	G	6	3	9	0	1	10	0	0
20	27732832	.	A	G	6	4	10	0	0	10	0	0
20	27733034	.	G	A	7	9	16	0	2	18	0	0
20	27733611	.	T	C	6	7	13	0	1	14	0	0
20	27733631	.	G	C	5	0	5	0	5	10	0	0
20	27733650	.	C	A	0	7	7	0	6	13	0	0
20	28294732	.	G	T	2	4	6	0	0	6	0	0
20	28316845	.	G	T	4	3	7	0	0	7	0	0
20	28322943	.	C	T	2	3	5	0	0	5	0	0
20	28326508	.	T	C	4	3	7	0	0	7	0	0
20	28354549	.	T	A	5	9	14	0	0	14	0	0
20	28354588	.	A	G	9	10	19	0	0	19	0	0
20	28354951	.	A	G	3	6	9	0	0	9	0	0
20	28356989	.	T	C	6	6	12	0	0	12	0	0
20	28356998	.	G	A	7	7	14	0	1	15	0	0
20	28357028	.	A	G	10	9	19	0	1	20	0	0
20	28357184	.	A	G	2	6	8	0	0	8	0	0
20	28357190	.	C	T	1	7	8	0	1	9	0	0
20	28357463	.	A	G	10	5	15	0	0	15	0	0
20	28357538	.	G	A	8	3	11	0	1	12	0	0
20	28357570	.	A	G	7	5	12	0	2	14	0	0
20	28357610	.	A	G	4	9	13	0	0	13	0	0
20	28357688	.	T	C	4	9	13	0	0	13	0	0
20	28357718	.	T	C	2	3	5	0	0	5	0	0
20	28357733	.	G	A	2	3	5	0	0	5	0	0
20	28357769	.	A	G	3	3	6	0	0	6	0	0
20	28357823	.	T	A	4	6	10	0	0	10	0	0
20	28357883	.	C	T	1	3	4	0	0	4	0	0
20	28358060	.	C	G	4	3	7	0	0	7	0	0
20	28400232	.	A	T	4	3	7	1	1	9	0	0
20	28400455	.	A	C	6	3	9	0	0	9	0	0
20	28400481	.	A	G	6	5	11	0	0	11	0	0
20	28400619	.	G	A	11	16	27	0	0	27	0	0
20	28401147	.	A	G	10	9	19	0	1	20	0	0
20	28401298	.	C	G	3	5	8	0	0	8	0	0
20	28401309	.	C	T	4	5	9	0	0	9	0	0
20	28401639	.	T	A	2	3	5	0	1	6	0	0
20	28401664	.	C	T	2	3	5	0	1	6	0	0
20	28402253	.	G	A	6	2	8	0	0	8	0	0
20	28402426	.	G	A	7	3	10	0	0	10	0	0
20	28402456	.	A	G	9	4	13	0	1	14	0	0
20	28402470	.	G	A	7	5	12	0	0	12	0	0
20	28404191	.	A	G	2	3	5	0	1	6	0	0
20	28404247	.	T	C	1	0	1	0	5	6	0	0
20	28404270	.	T	G	4	8	12	0	0	12	0	0
20	28404342	.	G	A	4	4	8	0	0	8	0	0
20	28408028	.	C	T	2	2	4	0	0	4	0	0
20	28409601	.	C	T	2	2	4	0	0	4	0	0
20	28411204	.	A	G	1	6	7	0	1	8	0	0
20	28418730	.	A	T	6	3	9	0	0	9	0	0
20	28418939	.	T	C	8	7	15	0	1	16	0	0
20	28419015	.	A	T	8	7	15	0	1	16	0	0
20	28419133	.	A	T	3	4	7	0	0	7	0	0
20	28419755	.	G	C	4	4	8	0	0	8	0	0
20	28419767	.	C	A	6	3	9	0	0	9	0	0
20	28420438	.	C	G	13	5	18	0	1	19	0	0
20	28420496	.	C	T	4	7	11	0	1	12	0	0
20	28423035	.	G	T	8	7	15	0	0	16	1	0
20	28423062	.	G	A	9	6	15	0	1	16	0	0
20	28423072	.	A	T	9	6	15	0	1	16	0	0
20	28456574	.	T	C	8	4	12	0	0	12	0	0
20	28469982	.	A	G	10	8	18	0	1	19	0	0
20	28476107	.	T	C	10	4	14	0	0	14	0	0
20	28487287	.	T	C	4	12	16	0	1	17	0	0
20	28514841	.	A	G	3	6	9	0	1	10	0	0
20	28514878	.	T	C	6	9	15	0	1	16	0	0
20	28514955	.	C	T	11	5	16	0	0	16	0	0
20	28541670	.	A	G	3	5	8	0	2	10	0	0
20	28541754	.	A	G	8	4	12	0	0	12	0	0
20	28641940	.	A	T	5	5	10	0	0	10	0	0
20	28641997	.	T	A	3	4	7	0	0	7	0	0
20	28642007	.	G	A	2	2	4	0	0	4	0	0
20	28650323	.	T	C	17	10	27	0	2	29	0	0
20	28650328	.	A	C	19	12	31	0	0	31	0	0
20	28650945	.	A	T	16	9	25	0	0	25	0	0
20	28650946	.	T	G	16	9	25	0	0	25	0	0
20	28651194	.	C	T	25	16	41	0	2	43	0	0
20	28651239	.	A	G	20	18	38	0	2	40	0	0
20	28651454	.	G	A	23	22	45	0	0	45	0	0
20	28651709	.	T	C	17	0	17	0	10	27	0	0
20	28651958	.	T	G	13	9	22	0	2	25	1	0
20	28652449	.	G	C	13	16	29	0	1	30	0	0
20	28654339	.	G	A	16	8	24	0	2	26	0	0
20	28658666	.	A	C	14	7	21	0	3	24	0	0
20	28659924	.	A	G	8	6	14	0	0	14	0	0
20	28659969	.	G	T	6	3	9	0	0	9	0	0
20	28660050	.	G	A	6	9	15	0	0	15	0	0
20	28660729	.	T	C	9	0	9	0	7	16	0	0
20	28660795	.	G	A	6	7	13	0	0	13	0	0
20	28660828	.	G	T	7	2	9	0	1	10	0	0
20	28660837	.	T	C	6	2	8	0	0	8	0	0
20	28675587	.	C	A	1	6	7	0	10	17	0	0
20	28682989	.	T	C	5	2	7	0	0	7	0	0
20	28693295	.	C	T	2	4	6	0	0	6	0	0
20	28697073	.	C	T	0	2	2	0	2	4	0	0
20	28697848	.	T	C	1	3	4	0	0	4	0	0
20	28698284	.	T	C	4	0	4	0	3	7	0	0
20	28783046	.	T	C	13	13	26	0	0	26	0	0
20	28783502	.	C	G	15	6	21	0	0	21	0	0
20	28783607	.	T	C	7	0	7	0	7	14	0	0
20	28783627	.	T	C	9	8	17	0	0	17	0	0
20	28783688	.	C	A	16	13	29	0	0	29	0	0
20	28783781	.	A	C	13	0	13	0	9	22	0	0
20	28783999	.	G	T	7	3	10	0	4	14	0	0
20	28784045	.	G	T	11	11	22	0	0	22	0	0
20	28800961	.	A	G	17	14	31	0	0	31	0	0
20	28804089	.	G	A	10	4	14	0	0	14	0	0
20	28817492	.	A	G	2	6	8	0	0	8	0	0
20	28822696	.	T	A	7	7	14	0	1	15	0	0
20	28822735	.	T	C	7	13	20	0	3	23	0	0
20	28823116	.	T	C	10	12	22	0	0	22	0	0
20	28825375	.	C	T	14	11	25	0	0	25	0	0
20	28827208	.	A	G	14	9	23	0	0	23	0	0
20	28827350	.	T	C	15	10	25	0	1	26	0	0
20	28827388	.	C	A	8	11	19	0	1	20	0	0
20	28827416	.	C	T	5	17	22	0	0	22	0	0
20	28827433	.	A	C	3	15	18	0	1	19	0	0
20	28833245	.	C	T	16	16	32	0	0	32	0	0
20	28833312	.	C	A	16	22	38	0	2	40	0	0
20	28833793	.	A	G	21	18	39	0	2	41	0	0
20	28833878	.	T	C	17	1	18	0	18	36	0	0
20	28834008	.	C	T	25	19	44	0	3	47	0	0
20	28834674	.	T	A	3	2	5	0	0	5	0	0
20	28835101	.	T	G	2	2	4	0	0	4	0	0
20	28870806	.	C	G	25	28	53	0	4	58	1	0
20	28870843	.	T	C	41	16	57	0	2	59	0	0
20	28871830	.	G	A	36	25	61	0	6	67	0	0
20	28875824	.	T	C	16	0	16	0	18	34	0	0
20	28876996	.	T	A	8	18	26	0	1	27	0	0
20	28877028	.	C	T	6	18	24	0	1	25	0	0
20	28877085	.	T	A	7	10	17	0	2	19	0	0
20	28877136	.	A	T	5	17	22	0	2	24	0	0
20	28877696	.	T	C	17	0	17	0	21	38	0	0
20	28878097	.	T	G	5	4	9	0	2	11	0	0
20	28878229	.	T	A	4	4	8	0	0	8	0	0
20	28884768	.	T	A	11	19	30	0	1	31	0	0
20	28886159	.	A	T	10	7	17	0	4	21	0	0
20	28886311	.	T	C	15	17	32	0	0	32	0	0
20	28886531	.	C	A	17	4	21	0	3	24	0	0
20	28886608	.	C	A	4	5	9	0	1	10	0	0
20	28886618	.	C	A	2	5	7	0	0	7	0	0
20	28886735	.	T	C	11	11	22	0	2	24	0	0
20	28886771	.	A	C	9	11	20	0	2	22	0	0
20	28887303	.	A	G	13	7	20	0	0	20	0	0
20	28887498	.	T	A	16	14	30	0	0	30	0	0
20	28887590	.	G	C	8	18	26	0	1	27	0	0
20	28888012	.	C	A	3	7	10	0	0	10	0	0
20	28888041	.	A	T	6	7	13	0	4	17	0	0
20	28888198	.	G	C	5	0	5	0	10	16	1	0
20	28888331	.	T	A	8	11	19	0	0	19	0	0
20	28888514	.	C	G	2	4	6	0	0	6	0	0
20	28888743	.	T	A	9	5	14	0	1	15	0	0
20	28888856	.	A	G	5	7	12	0	0	12	0	0
20	28889248	.	G	T	6	9	15	0	0	15	0	0
20	28889306	.	A	G	6	10	16	0	1	17	0	0
20	28897255	.	G	A	2	7	9	0	0	9	0	0
20	28897595	.	A	G	11	7	18	0	0	18	0	0
20	28935902	.	A	G	2	2	4	0	0	4	0	0
20	28938417	.	C	G	3	3	6	0	0	6	0	0
20	28973655	.	A	C	8	5	13	0	1	14	0	0
20	28973834	.	T	C	4	9	13	0	0	13	0	0
20	29216103	.	G	T	5	2	7	0	0	7	0	0
20	29268179	.	A	G	6	3	9	0	0	9	0	0
20	29268260	.	A	G	2	4	6	0	0	6	0	0
20	29274435	.	G	C	18	0	18	1	12	31	0	0
20	29274441	.	C	G	19	10	29	1	1	31	0	0
20	30879211	.	C	T	4	3	7	0	0	7	0	0
20	30879494	.	G	A	3	2	5	0	0	5	0	0
20	30880195	.	A	G	1	2	3	0	1	4	0	0
20	30889723	.	A	G	3	5	8	0	1	9	0	0
20	30889754	.	T	G	2	5	7	0	0	7	0	0
20	30889792	.	T	A	2	2	4	0	1	5	0	0
20	30894333	.	T	C	3	0	3	0	2	5	0	0
20	30894496	.	G	T	4	3	7	0	0	7	0	0
20	30894510	.	T	A	4	2	6	0	0	6	0	0
20	30894630	.	A	T	3	3	6	0	0	6	0	0
20	30894686	.	T	C	3	4	7	0	0	7	0	0
20	30894688	.	C	T	3	4	7	0	0	7	0	0
20	30894830	.	T	C	4	2	6	0	0	6	0	0
20	30895007	.	A	G	2	6	8	0	0	8	0	0
20	30895013	.	A	G	3	4	7	0	0	7	0	0
20	30895070	.	A	G	3	3	6	0	0	6	0	0
20	30895091	.	G	A	3	7	10	0	0	10	0	0
20	30897944	.	G	A	3	4	7	0	0	7	0	0
20	30897948	.	G	T	1	3	4	0	1	5	0	0
20	30900837	.	A	C	3	0	3	0	5	8	0	0
20	30900880	.	A	C	5	0	5	0	4	9	0	0
20	30900928	.	C	G	1	5	6	0	2	8	0	0
20	30900969	.	T	G	1	3	4	0	0	4	0	0
20	30922687	.	G	A	7	4	11	0	2	13	0	0
20	30922688	.	A	T	9	4	13	0	0	13	0	0
20	30922808	.	T	A	5	5	10	0	2	13	1	0
20	30922836	.	C	A	7	6	13	0	0	14	1	0
20	30923101	.	T	C	15	7	22	0	0	22	0	0
20	30925253	.	T	C	9	1	10	0	5	15	0	0
20	30926205	.	T	C	5	10	15	0	1	16	0	0
20	30928174	.	T	C	4	7	11	0	0	11	0	0
20	30931021	.	A	T	6	5	11	0	1	12	0	0
20	30931108	.	G	A	2	6	8	0	1	9	0	0
20	30931671	.	G	A	13	7	20	0	1	21	0	0
20	30932277	.	T	C	22	0	22	0	21	43	0	0
20	30936755	.	T	C	10	1	11	0	13	24	0	0
20	30939177	.	T	C	10	11	21	0	1	22	0	0
20	30940566	.	C	G	22	19	41	0	3	44	0	0
20	30947353	.	T	C	29	23	52	0	4	56	0	0
20	30947433	.	T	C	11	17	28	0	1	29	0	0
20	31003145	.	T	C	4	1	5	0	1	6	0	0
20	31003147	.	C	T	4	2	6	0	0	6	0	0
20	31005200	.	T	A	2	4	6	0	1	7	0	0
20	31072938	.	C	A	1	2	3	0	0	3	0	0
20	31076504	.	T	A	1	5	6	0	0	6	0	0
20	31147609	.	G	A	6	5	11	0	0	11	0	0
20	31170202	.	G	A	6	8	14	0	0	14	0	0
20	31171010	.	G	A	3	4	7	0	0	7	0	0
20	31171079	.	A	G	6	3	9	0	0	9	0	0
20	31172725	.	A	C	9	9	18	0	0	19	1	0
20	31172996	.	C	T	6	7	13	0	0	13	0	0
20	31178425	.	G	T	11	6	17	0	0	17	0	0
20	31181050	.	A	G	8	6	14	0	1	15	0	0
20	31185594	.	C	A	8	5	13	2	0	15	0	0
20	31186253	.	T	C	10	6	16	0	1	17	0	0
20	31187975	.	G	A	13	13	26	0	2	28	0	0
20	31192304	.	A	C	13	12	25	0	0	25	0	0
20	31192720	.	C	T	10	10	20	0	1	21	0	0
20	31193762	.	G	A	1	8	9	0	18	27	0	0
20	31193826	.	C	T	18	6	24	0	0	24	0	0
20	31197217	.	G	T	20	10	30	0	2	32	0	0
20	31197307	.	G	A	1	15	16	0	19	35	0	0
20	31197465	.	T	C	10	21	31	0	2	33	0	0
20	31199655	.	G	A	19	10	29	0	0	29	0	0
20	31202316	.	C	T	8	7	15	0	1	16	0	0
20	31204173	.	T	C	9	15	24	0	0	24	0	0
20	31204191	.	A	C	11	14	25	0	3	28	0	0
20	31206649	.	A	G	15	17	32	0	0	32	0	0
20	31211701	.	T	A	14	17	31	0	1	32	0	0
20	31211710	.	A	G	10	14	24	0	5	29	0	0
20	31211846	.	G	A	3	6	9	0	16	25	0	0
20	31212156	.	G	A	2	13	15	0	19	34	0	0
20	31212390	.	G	C	5	7	12	0	0	12	0	0
20	31217612	.	T	C	6	4	10	1	0	11	0	0
20	31222978	.	T	G	5	1	6	0	13	19	0	0
20	31223282	.	C	T	10	10	20	0	0	20	0	0
20	31223336	.	C	T	11	9	20	0	0	20	0	0
20	31225875	.	C	T	9	14	23	0	0	23	0	0
20	31233199	.	C	T	0	2	2	1	2	5	0	0
20	31233214	.	T	A	3	4	7	1	0	8	0	0
20	31233329	.	C	T	0	6	6	0	6	12	0	0
20	31233463	.	T	G	1	4	5	0	1	6	0	0
20	31233566	.	T	G	1	2	3	0	0	3	0	0
20	31233623	.	T	C	2	2	4	0	0	4	0	0
20	31233679	.	A	G	3	3	6	0	0	6	0	0
20	31233780	.	T	G	3	3	6	0	0	6	0	0
20	31233837	.	G	C	6	4	10	0	0	10	0	0
20	31252532	.	G	A	3	4	7	0	1	8	0	0
20	31429700	.	T	C	25	7	32	0	0	32	0	0
20	31429917	.	T	G	2	4	6	0	0	6	0	0
20	31430115	.	A	T	7	7	14	0	0	14	0	0
20	31431345	.	C	T	3	4	7	0	1	8	0	0
20	31431457	.	T	A	6	6	12	0	0	12	0	0
20	31431501	.	G	T	5	6	11	0	0	11	0	0
20	31431561	.	A	G	5	6	11	0	1	12	0	0
20	31436483	.	C	T	9	12	21	0	2	23	0	0
20	31436504	.	T	C	11	0	11	0	7	18	0	0
20	31436984	.	C	T	6	4	10	0	0	10	0	0
20	31442308	.	C	T	1	8	9	0	2	11	0	0
20	31447356	.	A	G	1	2	3	0	0	3	0	0
20	31451649	.	A	G	1	3	4	0	0	4	0	0
20	31471068	.	G	A	3	3	6	0	0	6	0	0
20	31743161	.	C	T	1	3	4	0	0	4	0	0
20	31743684	.	T	C	1	3	4	0	0	4	0	0
20	31746212	.	T	A	1	6	7	0	0	7	0	0
20	31747695	.	G	C	15	22	37	0	1	38	0	0
20	31747860	.	C	T	1	13	14	5	9	28	0	0
20	31748183	.	C	T	20	6	26	0	2	28	0	0
20	31748448	.	A	G	13	10	23	0	2	25	0	0
20	31748518	.	C	T	10	13	23	0	0	23	0	0
20	31748755	.	G	A	5	2	7	0	3	10	0	0
20	31748803	.	A	G	11	11	22	0	1	23	0	0
20	31748845	.	A	T	13	9	22	0	0	22	0	0
20	31749118	.	A	G	13	22	35	0	4	39	0	0
20	31769469	.	A	G	6	3	9	0	1	10	0	0
20	31769523	.	T	A	6	7	13	0	0	13	0	0
20	31771899	.	G	A	10	8	18	0	0	18	0	0
20	31777192	.	C	T	1	7	8	0	7	15	0	0
20	31786688	.	T	A	4	5	9	0	0	9	0	0
20	31793840	.	T	C	1	0	1	0	8	9	0	0
20	32053122	.	G	A	11	16	27	0	3	30	0	0
20	32061596	.	G	A	9	7	16	0	0	16	0	0
20	32061611	.	C	A	1	6	7	0	3	10	0	0
20	32071494	.	A	G	8	7	15	0	2	17	0	0
20	32098046	.	A	G	12	14	26	0	0	26	0	0
20	32110172	.	T	C	4	0	4	0	7	11	0	0
20	32110331	.	G	A	5	8	13	0	0	13	0	0
20	32110370	.	T	C	5	0	5	0	12	17	0	0
20	32110790	.	T	C	6	7	13	0	0	13	0	0
20	32110898	.	A	T	8	4	12	0	0	12	0	0
20	32118658	.	A	G	8	0	8	0	11	19	0	0
20	32136584	.	T	A	8	9	17	0	1	18	0	0
20	32136588	.	G	T	11	9	20	0	0	20	0	0
20	32136847	.	C	G	6	5	11	0	0	11	0	0
20	32136953	.	C	T	9	3	12	0	0	12	0	0
20	32137529	.	A	T	4	5	9	0	0	9	0	0
20	32137752	.	G	T	18	9	27	0	1	28	0	0
20	32138171	.	T	C	11	15	26	0	2	28	0	0
20	32138478	.	A	G	15	12	27	0	0	27	0	0
20	32138692	.	G	A	15	12	27	0	3	30	0	0
20	32138723	.	A	G	16	1	17	0	9	26	0	0
20	32138754	.	T	C	18	12	30	0	0	30	0	0
20	32138828	.	C	T	20	15	35	0	2	37	0	0
20	32138977	.	G	A	1	2	3	0	2	5	0	0
20	32141822	.	A	T	2	3	5	0	1	6	0	0
20	32224485	.	C	A	9	6	15	0	2	17	0	0
20	32224532	.	T	C	7	4	11	0	0	11	0	0
20	32225711	.	G	A	7	5	12	0	0	12	0	0
20	32228863	.	G	A	15	15	30	0	4	34	0	0
20	32228936	.	A	C	13	13	26	0	2	28	0	0
20	32229004	.	G	A	24	16	40	0	0	40	0	0
20	32229053	.	C	T	19	16	35	0	1	36	0	0
20	32229095	.	T	C	18	14	32	0	1	33	0	0
20	32230168	.	T	C	14	17	31	0	0	31	0	0
20	32230376	.	T	C	11	7	18	0	0	18	0	0
20	32230574	.	T	A	18	15	33	0	0	33	0	0
20	32230592	.	T	A	18	14	32	0	1	33	0	0
20	32230620	.	C	T	16	21	37	0	5	42	0	0
20	32230680	.	A	G	9	18	27	0	0	27	0	0
20	32230720	.	C	G	9	10	19	0	1	20	0	0
20	32230776	.	G	A	12	9	21	0	1	22	0	0
20	32230781	.	G	C	14	11	25	0	1	26	0	0
20	32230836	.	T	C	12	7	19	0	1	20	0	0
20	32286800	.	C	T	2	4	6	0	12	18	0	0
20	32286877	.	A	C	24	11	35	1	1	37	0	0
20	32286923	.	A	T	17	13	30	1	1	32	0	0
20	32286960	.	A	C	15	15	30	0	1	31	0	0
20	32287181	.	C	T	2	9	11	0	11	22	0	0
20	32287317	.	C	T	8	7	15	0	0	15	0	0
20	32287943	.	A	C	5	7	12	0	0	12	0	0
20	32288318	.	T	A	8	11	19	0	0	19	0	0
20	32288372	.	T	C	10	0	10	0	9	19	0	0
20	32290149	.	T	A	7	10	17	0	2	19	0	0
20	32290222	.	G	A	14	10	24	0	0	24	0	0
20	32290435	.	A	G	8	14	22	0	0	22	0	0
20	32330687	.	G	C	4	0	4	0	8	12	0	0
20	32330924	.	T	G	4	8	12	0	1	13	0	0
20	32332298	.	T	C	5	0	5	0	5	10	0	0
20	32332463	.	A	G	4	4	8	0	0	8	0	0
20	32332494	.	A	C	1	0	1	0	2	3	0	0
20	32337734	.	A	C	4	3	7	0	0	7	0	0
20	32337918	.	A	C	4	8	12	0	1	13	0	0
20	32337927	.	G	A	3	6	9	0	0	9	0	0
20	32339847	.	A	G	5	3	8	0	0	8	0	0
20	32348548	.	T	C	4	3	7	0	1	8	0	0
20	32348568	.	C	T	5	3	8	0	0	8	0	0
20	32351844	.	A	T	2	2	4	0	0	4	0	0
20	32393267	.	T	G	3	3	6	0	0	6	0	0
20	32393289	.	G	C	3	2	5	0	0	5	0	0
20	32403599	.	A	G	1	5	6	0	0	6	0	0
20	32403611	.	C	T	1	4	5	0	0	5	0	0
20	32432315	.	G	T	14	12	26	0	1	27	0	0
20	32432657	.	A	G	12	0	12	0	10	22	0	0
20	32438446	.	A	T	1	3	4	0	0	4	0	0
20	32484600	.	C	T	2	11	13	0	0	13	0	0
20	32490004	.	G	T	5	4	9	0	0	9	0	0
20	32490047	.	A	T	6	5	11	0	0	11	0	0
20	32498345	.	A	G	1	6	7	0	0	7	0	0
20	32498635	.	C	A	3	3	6	0	0	6	0	0
20	32498639	.	C	A	2	3	5	0	0	5	0	0
20	32498771	.	C	G	4	2	6	0	0	6	0	0
20	32498813	.	A	T	2	3	5	0	0	5	0	0
20	32499166	.	G	A	2	6	8	0	2	10	0	0
20	32499199	.	T	C	2	2	4	0	0	4	0	0
20	32499263	.	T	C	1	2	3	0	0	3	0	0
20	32501840	.	T	G	8	10	18	0	0	18	0	0
20	32510813	.	A	G	3	8	11	0	0	11	0	0
20	32513235	.	G	A	2	8	10	0	2	12	0	0
20	32513256	.	G	A	3	9	12	0	0	12	0	0
20	32520330	.	T	C	14	7	21	0	0	21	0	0
20	32520351	.	A	G	12	0	12	0	12	24	0	0
20	32520365	.	A	G	13	0	13	0	16	29	0	0
20	32520615	.	T	A	8	9	17	0	0	17	0	0
20	32520673	.	A	G	6	8	14	0	0	14	0	0
20	32520815	.	A	G	3	2	5	0	7	12	0	0
20	32520852	.	A	G	3	7	10	0	0	10	0	0
20	32521203	.	C	T	9	8	17	1	1	19	0	0
20	32521377	.	C	T	7	7	14	0	0	14	0	0
20	32521686	.	A	C	18	9	27	0	1	29	1	0
20	32521719	.	A	C	10	18	28	0	3	31	0	0
20	32521742	.	G	A	14	25	39	0	1	40	0	0
20	32571781	.	C	T	5	4	9	0	1	10	0	0
20	32571913	.	T	C	7	3	10	0	0	10	0	0
20	32574127	.	A	T	9	4	13	0	0	13	0	0
20	32756790	.	G	A	1	7	8	0	4	12	0	0
20	32757807	.	C	G	7	1	8	0	10	18	0	0
20	32758490	.	A	G	13	12	25	0	1	26	0	0
20	32758558	.	T	C	12	16	28	0	1	29	0	0
20	32838484	.	T	C	1	0	1	0	2	3	0	0
20	32838551	.	A	G	2	3	5	0	0	5	0	0
20	32935624	.	G	A	2	3	5	0	0	5	0	0
20	32935630	.	A	G	2	4	6	0	0	6	0	0
20	32935681	.	G	A	1	2	3	0	0	3	0	0
20	32999053	.	G	C	4	2	6	0	0	6	0	0
20	33175232	.	A	G	10	0	10	0	6	16	0	0
20	33175351	.	G	A	11	8	19	0	0	19	0	0
20	33175504	.	T	C	1	6	7	0	0	7	0	0
20	33175549	.	C	T	5	7	12	0	1	13	0	0
20	33175948	.	A	C	7	7	14	0	0	14	0	0
20	33177904	.	C	T	10	4	14	0	1	15	0	0
20	33180111	.	T	C	5	7	12	0	0	12	0	0
20	33180295	.	G	A	2	10	12	0	0	12	0	0
20	33180547	.	C	T	4	7	11	0	0	11	0	0
20	33189326	.	T	G	9	3	12	0	12	24	0	0
20	33189631	.	G	A	5	5	10	0	1	11	0	0
20	33297776	.	A	C	6	8	14	0	0	14	0	0
20	33298651	.	G	A	9	7	16	0	0	16	0	0
20	33468040	.	T	G	17	20	37	0	0	37	0	0
20	33471085	.	G	A	9	6	15	0	1	16	0	0
20	33471127	.	A	T	11	5	16	0	0	16	0	0
20	33471166	.	C	T	1	10	11	0	12	23	0	0
20	33471199	.	T	C	11	1	12	0	14	26	0	0
20	33484083	.	G	A	6	7	13	0	0	13	0	0
20	33484387	.	T	C	7	6	13	0	0	13	0	0
20	33484438	.	G	C	7	0	7	0	4	11	0	0
20	33486989	.	T	C	3	0	3	0	3	6	0	0
20	33487143	.	G	T	2	2	4	0	0	4	0	0
20	33487152	.	A	T	4	2	6	0	0	6	0	0
20	33487238	.	C	T	3	4	7	0	1	8	0	0
20	33487370	.	T	A	1	4	5	0	0	5	0	0
20	33487374	.	G	T	1	3	4	0	0	4	0	0
20	33487603	.	C	T	3	8	11	0	0	11	0	0
20	33494064	.	A	G	10	6	16	0	2	18	0	0
20	33494436	.	C	T	26	16	42	0	1	43	0	0
20	33575634	.	G	A	10	3	13	3	0	16	0	0
20	33578957	.	G	T	5	2	7	0	0	7	0	0
20	33656178	.	C	T	3	3	6	5	0	11	0	0
20	33737482	.	T	C	1	3	4	0	1	5	0	0
20	33759014	.	C	T	11	3	14	0	0	14	0	0
20	33771521	.	G	A	4	6	10	0	2	12	0	0
20	33771605	.	A	G	7	8	15	0	1	16	0	0
20	33789729	.	T	C	5	1	6	0	3	9	0	0
20	33789927	.	C	T	0	6	6	0	5	11	0	0
20	33789965	.	G	T	8	5	13	0	1	14	0	0
20	33809464	.	C	A	3	2	5	0	0	5	0	0
20	33809783	.	C	A	6	20	26	0	0	26	0	0
20	33809846	.	G	C	17	19	36	0	0	37	1	0
20	33809927	.	T	A	11	12	23	0	0	23	0	0
20	33810496	.	G	A	2	4	6	0	1	7	0	0
20	33810775	.	T	A	5	3	8	0	1	9	0	0
20	33810845	.	C	T	10	8	18	0	0	18	0	0
20	33811230	.	T	A	2	4	6	0	2	8	0	0
20	33811257	.	T	G	3	5	8	0	0	8	0	0
20	33811400	.	A	T	6	6	12	0	1	13	0	0
20	33811435	.	G	A	9	7	16	0	0	16	0	0
20	33811436	.	C	A	10	6	16	0	1	17	0	0
20	33811622	.	A	G	16	15	31	0	1	32	0	0
20	33856416	.	A	T	3	9	12	0	2	14	0	0
20	33856421	.	T	C	3	12	15	0	0	15	0	0
20	33859788	.	A	T	9	11	20	0	1	21	0	0
20	33859869	.	C	T	0	11	11	0	12	23	0	0
20	33862741	.	G	A	8	5	13	0	0	13	0	0
20	33863932	.	T	C	1	3	4	0	1	5	0	0
20	33864772	.	A	G	9	7	16	0	0	16	0	0
20	34007589	.	G	C	2	4	6	0	0	6	0	0
20	34009363	.	G	A	0	5	5	0	4	9	0	0
20	34009947	.	A	G	10	8	18	0	0	18	0	0
20	34009952	.	C	A	9	6	15	0	1	16	0	0
20	34010028	.	A	G	3	9	12	0	0	12	0	0
20	34010108	.	A	G	1	0	1	0	2	3	0	0
20	34012916	.	A	T	5	9	14	0	2	16	0	0
20	34015845	.	C	T	7	10	17	0	3	20	0	0
20	34020861	.	T	A	5	4	9	0	1	10	0	0
20	34023551	.	T	C	2	2	4	0	0	4	0	0
20	34039194	.	C	T	1	2	3	0	0	3	0	0
20	34039408	.	A	C	4	4	8	0	0	8	0	0
20	34042070	.	A	G	9	10	19	0	3	22	0	0
20	34042209	.	A	G	14	10	24	0	0	24	0	0
20	34044813	.	G	A	8	12	20	0	1	21	0	0
20	34044845	.	A	T	9	13	22	0	0	22	0	0
20	34049141	.	G	A	8	6	14	0	2	16	0	0
20	34051417	.	G	A	13	3	16	0	2	18	0	0
20	34053787	.	T	A	5	13	18	0	1	19	0	0
20	34054401	.	C	T	7	9	16	0	0	16	0	0
20	34056227	.	C	T	3	4	7	0	1	8	0	0
20	34056656	.	A	G	7	6	13	0	1	14	0	0
20	34057305	.	T	C	5	6	11	0	0	11	0	0
20	34059175	.	A	T	1	4	5	0	0	5	0	0
20	34059259	.	C	T	5	4	9	0	0	9	0	0
20	34059433	.	C	T	2	7	9	0	2	11	0	0
20	34059440	.	G	C	2	6	8	0	1	9	0	0
20	34061250	.	C	G	1	2	3	0	3	6	0	0
20	34061286	.	A	G	2	2	4	0	0	4	0	0
20	34061784	.	C	T	2	2	4	0	0	4	0	0
20	34062718	.	T	A	2	3	5	0	0	5	0	0
20	34063517	.	A	C	1	4	5	0	0	5	0	0
20	34063986	.	T	A	2	3	5	0	0	5	0	0
20	34064061	.	C	T	3	2	5	0	0	5	0	0
20	34066128	.	G	A	1	2	3	0	0	3	0	0
20	34154118	.	T	C	9	12	21	0	0	21	0	0
20	34155025	.	C	T	11	17	28	0	2	30	0	0
20	34155134	.	G	A	6	7	13	0	2	15	0	0
20	34155339	.	C	A	16	11	27	0	0	27	0	0
20	34155428	.	A	G	16	6	22	0	0	22	0	0
20	34158154	.	C	G	1	2	3	0	0	3	0	0
20	34551246	.	G	A	6	3	9	0	0	9	0	0
20	34643392	.	G	T	6	2	8	0	0	8	0	0
20	34737886	.	T	A	1	3	4	0	0	4	0	0
20	34737944	.	G	C	3	9	12	0	0	12	0	0
20	34738198	.	G	A	17	25	42	0	5	47	0	0
20	34738314	.	G	A	10	25	35	0	2	37	0	0
20	34738397	.	G	T	5	10	15	0	1	16	0	0
20	34738473	.	T	G	10	9	19	0	1	20	0	0
20	34738756	.	A	G	9	18	27	0	1	28	0	0
20	34742840	.	G	A	19	12	31	0	2	33	0	0
20	34745872	.	A	G	16	15	31	0	0	31	0	0
20	34746019	.	G	A	11	10	21	0	0	21	0	0
20	34747208	.	T	C	6	5	11	0	2	13	0	0
20	34749747	.	G	A	9	6	15	0	0	15	0	0
20	34777607	.	C	T	1	2	3	0	0	3	0	0
20	34794668	.	T	C	2	2	4	0	3	7	0	0
20	34794939	.	C	T	32	28	60	0	2	62	0	0
20	34795111	.	C	A	41	31	72	0	1	73	0	0
20	34795126	.	A	G	37	34	71	0	3	74	0	0
20	34795296	.	T	C	33	35	68	0	2	70	0	0
20	34795379	.	T	C	44	24	68	0	0	68	0	0
20	34795473	.	C	T	3	31	34	0	30	64	0	0
20	34795689	.	C	T	51	30	81	0	4	85	0	0
20	34797252	.	G	T	46	31	77	0	4	81	0	0
20	34797598	.	A	T	35	29	64	0	2	66	0	0
20	34955791	.	C	T	51	25	76	1	2	79	0	0
20	34956159	.	A	T	22	7	29	0	1	30	0	0
20	34956164	.	T	A	22	8	30	0	1	31	0	0
20	34967476	.	T	C	1	0	1	0	5	6	0	0
20	34969773	.	A	T	15	21	36	0	3	39	0	0
20	34975831	.	G	A	12	13	25	0	0	25	0	0
20	34980452	.	T	C	12	9	21	0	1	22	0	0
20	34982018	.	C	T	7	12	19	0	0	19	0	0
20	34982323	.	T	A	10	6	16	0	0	16	0	0
20	34985368	.	C	A	2	4	6	0	3	9	0	0
20	34985384	.	C	T	2	5	7	0	5	12	0	0
20	34985424	.	T	G	5	9	14	0	0	14	0	0
20	34985462	.	A	G	4	9	13	0	1	14	0	0
20	34985480	.	A	T	7	4	11	0	0	11	0	0
20	34985499	.	A	C	6	4	10	0	1	11	0	0
20	34991739	.	T	A	6	2	8	0	0	8	0	0
20	34991804	.	C	T	1	5	6	0	2	8	0	0
20	34993974	.	G	A	1	2	3	0	0	3	0	0
20	34994019	.	G	T	2	2	4	0	0	4	0	0
20	35011946	.	C	T	7	2	9	0	0	9	0	0
20	35017831	.	C	T	1	3	4	0	0	4	0	0
20	35018537	.	G	A	2	2	4	0	0	4	0	0
20	35019436	.	G	A	1	1	2	0	2	4	0	0
20	35019437	.	A	C	1	1	2	0	2	4	0	0
20	35030748	.	A	G	1	2	3	0	0	3	0	0
20	35059085	.	G	A	0	8	8	0	10	18	0	0
20	35064469	.	T	C	14	14	28	0	2	30	0	0
20	35064808	.	C	T	18	16	34	0	1	35	0	0
20	35065345	.	G	A	2	11	13	0	27	40	0	0
20	35065573	.	A	C	17	12	29	0	10	39	0	0
20	35066821	.	G	A	2	23	25	0	26	51	0	0
20	35066935	.	G	A	1	27	28	0	25	53	0	0
20	35068064	.	A	G	18	3	21	0	35	56	0	0
20	35068790	.	A	T	7	13	20	0	1	21	0	0
20	35069063	.	A	C	4	10	14	0	1	15	0	0
20	35069756	.	A	G	10	11	21	0	1	22	0	0
20	35069963	.	A	C	16	22	38	0	0	38	0	0
20	35070176	.	C	T	18	16	34	0	1	35	0	0
20	35070217	.	T	G	23	18	41	0	3	44	0	0
20	35159500	.	C	A	4	2	6	0	2	8	0	0
20	35162012	.	T	G	3	3	6	0	1	7	0	0
20	35164811	.	A	T	1	4	5	0	1	6	0	0
20	35165533	.	G	A	5	4	9	0	0	9	0	0
20	35173653	.	C	A	1	3	4	0	0	4	0	0
20	35184413	.	T	C	7	3	10	0	1	11	0	0
20	35184419	.	T	C	6	5	11	0	1	12	0	0
20	35186620	.	C	T	3	5	8	2	1	11	0	0
20	35186629	.	G	C	0	5	5	2	2	9	0	0
20	35188776	.	G	A	3	3	6	0	0	6	0	0
20	35195535	.	A	G	6	9	15	0	2	17	0	0
20	35198810	.	A	C	10	7	17	0	1	18	0	0
20	35204702	.	A	C	2	6	8	0	0	8	0	0
20	35204729	.	T	C	2	3	5	0	0	5	0	0
20	35204773	.	C	T	4	8	12	0	0	12	0	0
20	35204814	.	A	G	4	0	4	0	8	12	0	0
20	35204848	.	T	G	7	8	15	0	0	15	0	0
20	35204944	.	G	A	6	10	16	0	1	17	0	0
20	35205061	.	C	T	6	14	20	0	0	20	0	0
20	35205182	.	T	C	5	10	15	0	0	15	0	0
20	35205361	.	T	A	8	6	14	0	0	14	0	0
20	35205552	.	T	G	8	0	8	0	11	19	0	0
20	35205600	.	A	T	9	11	20	0	1	21	0	0
20	35205680	.	A	G	10	7	17	0	0	17	0	0
20	35206101	.	A	T	8	11	19	0	1	20	0	0
20	35208046	.	A	G	3	5	8	0	0	8	0	0
20	35209012	.	G	A	5	2	7	0	0	7	0	0
20	35209080	.	T	A	6	5	11	0	1	12	0	0
20	35209201	.	C	T	8	8	16	0	0	16	0	0
20	35209405	.	C	T	16	12	28	0	1	29	0	0
20	35209481	.	G	A	18	12	30	0	0	30	0	0
20	35210175	.	C	A	12	11	23	0	0	23	0	0
20	35210212	.	G	T	5	11	16	0	0	16	0	0
20	35210229	.	A	C	4	8	12	0	0	12	0	0
20	35210538	.	C	G	5	4	9	0	0	9	0	0
20	35210575	.	C	T	2	3	5	0	0	5	0	0
20	35210649	.	A	G	8	5	13	0	0	13	0	0
20	35210690	.	A	G	3	6	9	0	0	9	0	0
20	35210781	.	A	G	4	3	7	0	0	7	0	0
20	35210853	.	A	T	4	6	10	0	1	11	0	0
20	35210909	.	T	C	4	6	10	0	0	10	0	0
20	35211062	.	A	G	1	3	4	0	0	4	0	0
20	35211153	.	A	G	1	5	6	0	0	6	0	0
20	35211225	.	A	G	4	2	6	0	0	6	0	0
20	35211399	.	G	A	3	2	5	0	0	5	0	0
20	35211515	.	C	T	1	2	3	0	6	9	0	0
20	35211760	.	G	A	7	5	12	0	0	12	0	0
20	35212168	.	A	G	3	4	7	0	0	7	0	0
20	35212366	.	T	C	9	3	12	0	1	13	0	0
20	35212398	.	A	G	7	6	13	0	0	13	0	0
20	35212860	.	A	T	4	4	8	0	1	9	0	0
20	35215671	.	C	T	2	3	5	0	0	5	0	0
20	35215680	.	T	G	1	3	4	0	1	5	0	0
20	35226665	.	T	C	0	2	2	0	3	5	0	0
20	35227256	.	C	G	2	2	4	0	1	5	0	0
20	35243721	.	T	C	1	0	1	0	3	4	0	0
20	35295208	.	C	T	4	8	12	0	0	12	0	0
20	35296980	.	T	C	8	5	13	0	0	13	0	0
20	35297212	.	T	G	7	0	7	0	6	13	0	0
20	35297417	.	T	G	13	12	25	0	0	25	0	0
20	35297539	.	A	C	13	2	15	1	2	18	0	0
20	35297693	.	G	A	5	5	10	0	1	11	0	0
20	35297699	.	A	G	4	5	9	0	0	9	0	0
20	35297870	.	T	C	3	4	7	0	0	7	0	0
20	35392100	.	C	T	31	28	59	0	3	62	0	0
20	35427409	.	G	C	26	30	56	0	2	58	0	0
20	35427676	.	T	G	28	1	29	0	34	63	0	0
20	35427745	.	A	G	24	3	27	0	37	65	1	0
20	35427782	.	T	C	31	30	61	0	1	62	0	0
20	35427907	.	C	G	21	30	51	0	1	52	0	0
20	35427946	.	A	G	24	2	26	0	28	55	1	0
20	35428035	.	A	G	34	22	56	0	2	58	0	0
20	35428436	.	G	A	34	30	64	0	8	72	0	0
20	35428633	.	T	C	37	28	65	3	6	74	0	0
20	35428735	.	A	G	7	41	48	0	0	48	0	0
20	35428802	.	A	G	20	48	68	0	3	71	0	0
20	35428910	.	A	G	29	35	64	0	0	64	0	0
20	35429017	.	T	A	31	14	45	0	1	46	0	0
20	35429054	.	A	G	37	7	44	0	36	80	0	0
20	35429610	.	A	T	42	38	80	0	3	83	0	0
20	35433311	.	A	G	20	1	21	0	25	46	0	0
20	35497048	.	A	G	1	2	3	0	0	3	0	0
20	35798370	.	G	A	17	18	35	0	4	39	0	0
20	35798697	.	A	T	6	5	11	0	0	11	0	0
20	35798973	.	T	A	7	10	17	0	0	17	0	0
20	35799001	.	A	G	10	11	21	0	0	21	0	0
20	35799135	.	G	A	9	17	26	0	0	26	0	0
20	35799175	.	T	C	9	8	17	0	1	18	0	0
20	35799192	.	T	A	13	5	18	0	0	18	0	0
20	35799291	.	G	C	3	2	5	0	0	5	0	0
20	35799534	.	T	C	6	7	13	0	2	15	0	0
20	35799612	.	A	T	13	7	20	0	1	21	0	0
20	35799673	.	T	A	11	7	18	0	2	20	0	0
20	35799729	.	T	A	16	7	23	0	1	24	0	0
20	35799803	.	T	A	10	5	15	0	1	16	0	0
20	35799889	.	A	T	9	8	17	0	1	18	0	0
20	35799913	.	T	G	13	4	17	0	1	18	0	0
20	35799931	.	A	T	17	2	19	0	1	20	0	0
20	35800032	.	G	A	17	9	26	0	8	34	0	0
20	35800042	.	T	G	18	19	37	0	4	41	0	0
20	35800098	.	G	A	15	20	35	0	2	37	0	0
20	35800338	.	T	G	2	4	6	0	0	6	0	0
20	35800349	.	C	T	4	3	7	0	0	7	0	0
20	35800520	.	G	A	6	7	13	0	0	13	0	0
20	35800557	.	G	A	7	6	13	0	0	13	0	0
20	35800564	.	T	C	6	5	11	0	0	11	0	0
20	35800749	.	G	A	8	7	15	0	0	15	0	0
20	35816533	.	A	G	2	9	11	0	1	12	0	0
20	35816534	.	A	G	3	9	12	0	0	12	0	0
20	35831719	.	C	T	6	8	14	0	1	15	0	0
20	35841393	.	C	T	4	2	6	0	0	6	0	0
20	35941146	.	G	A	0	2	2	0	1	3	0	0
20	35942981	.	T	C	2	2	4	0	0	4	0	0
20	35972539	.	T	C	1	2	3	0	0	3	0	0
20	35972544	.	G	A	1	2	3	0	0	3	0	0
20	35979899	.	G	T	2	6	8	0	0	8	0	0
20	35979910	.	T	G	1	5	6	0	0	6	0	0
20	35979983	.	G	C	1	3	4	0	0	4	0	0
20	35980009	.	A	G	1	2	3	0	0	3	0	0
20	35980021	.	C	T	1	4	5	0	0	5	0	0
20	36068980	.	G	A	1	2	3	0	0	3	0	0
20	36069388	.	G	A	1	3	4	0	0	4	0	0
20	36069553	.	A	G	1	2	3	0	0	3	0	0
20	36069562	.	A	T	1	2	3	0	0	3	0	0
20	36100546	.	G	A	1	2	3	0	0	3	0	0
20	36234084	.	C	A	7	3	10	0	0	10	0	0
20	36290217	.	C	T	4	6	10	0	0	10	0	0
20	36297356	.	G	A	1	18	19	0	19	38	0	0
20	36297418	.	C	A	14	12	26	0	0	26	0	0
20	36297871	.	A	T	7	11	18	0	1	19	0	0
20	36394619	.	T	C	1	0	1	0	2	3	0	0
20	36396098	.	G	A	3	2	5	0	0	5	0	0
20	36399539	.	T	C	1	0	1	0	2	3	0	0
20	36403693	.	A	C	1	0	1	0	2	3	0	0
20	36403697	.	C	T	1	2	3	0	0	3	0	0
20	36403820	.	T	A	2	5	7	0	0	7	0	0
20	36420218	.	A	C	9	15	24	0	1	25	0	0
20	36420713	.	C	T	4	16	20	0	12	32	0	0
20	36420753	.	T	A	16	12	28	0	0	28	0	0
20	36420804	.	G	T	16	8	24	0	3	27	0	0
20	36421219	.	G	A	17	6	23	1	0	24	0	0
20	36421238	.	C	T	11	10	21	0	3	24	0	0
20	36421530	.	A	C	11	0	11	0	8	19	0	0
20	36421757	.	C	T	1	9	10	0	18	28	0	0
20	36422098	.	C	A	17	12	29	0	3	32	0	0
20	36422146	.	G	C	13	11	24	0	1	25	0	0
20	36422291	.	G	T	15	8	23	0	0	23	0	0
20	36424252	.	T	C	12	10	22	0	0	22	0	0
20	36424273	.	G	A	13	12	25	0	1	26	0	0
20	36434308	.	A	G	10	8	18	0	0	18	0	0
20	36440113	.	C	T	2	3	5	0	23	28	0	0
20	36440170	.	C	T	2	8	10	0	15	25	0	0
20	36449286	.	G	A	10	9	19	0	0	19	0	0
20	36449385	.	C	T	11	6	17	0	0	17	0	0
20	36449442	.	A	C	8	10	18	0	2	20	0	0
20	36449601	.	C	T	6	9	15	0	0	15	0	0
20	36491016	.	T	C	15	11	26	1	0	27	0	0
20	36626195	.	A	G	15	0	15	0	11	26	0	0
20	36626218	.	C	T	12	12	24	0	2	26	0	0
20	36626248	.	G	A	13	14	27	0	1	28	0	0
20	36626335	.	C	T	11	12	23	0	0	23	0	0
20	36626354	.	C	A	11	10	21	0	1	22	0	0
20	36626465	.	C	T	2	4	6	0	0	6	0	0
20	36628293	.	T	C	1	2	3	0	0	3	0	0
20	36637604	.	T	A	9	4	13	0	0	13	0	0
20	36637657	.	A	C	3	13	16	0	1	17	0	0
20	36637829	.	T	C	2	3	5	0	1	6	0	0
20	36638033	.	G	T	6	6	12	0	0	12	0	0
20	36638169	.	T	C	2	2	4	0	0	4	0	0
20	36647133	.	C	T	1	2	3	0	0	3	0	0
20	36675294	.	G	C	4	0	4	0	6	10	0	0
20	36675456	.	G	A	9	11	20	0	0	20	0	0
20	36675468	.	C	T	7	10	17	0	1	18	0	0
20	36677457	.	C	T	5	7	12	0	2	14	0	0
20	36677574	.	G	A	9	5	14	0	0	14	0	0
20	36773807	.	A	G	1	5	6	0	0	6	0	0
20	36773918	.	A	G	3	0	3	0	6	9	0	0
20	36783480	.	C	T	3	7	10	0	0	10	0	0
20	36785477	.	G	A	3	5	8	0	0	8	0	0
20	36788775	.	C	T	3	6	9	0	0	9	0	0
20	36791885	.	C	T	4	8	12	0	0	12	0	0
20	36792123	.	T	C	7	6	13	0	0	13	0	0
20	36798128	.	T	A	2	4	6	0	0	6	0	0
20	36798154	.	C	G	2	6	8	0	1	9	0	0
20	36816471	.	G	A	2	8	10	0	1	11	0	0
20	36816522	.	G	A	7	8	15	0	0	15	0	0
20	36816961	.	A	C	6	6	12	0	0	12	0	0
20	36816972	.	C	T	5	6	11	0	0	11	0	0
20	36817368	.	G	C	4	2	6	0	0	6	0	0
20	36828833	.	T	C	8	6	14	0	0	14	0	0
20	36828948	.	A	C	4	7	11	0	0	11	0	0
20	36829040	.	T	C	15	4	19	0	0	19	0	0
20	36829208	.	T	C	3	11	14	0	1	15	0	0
20	36829517	.	T	G	8	0	8	0	12	20	0	0
20	36838717	.	C	T	8	6	14	0	0	14	0	0
20	36838805	.	C	T	6	5	11	0	0	11	0	0
20	36838871	.	C	T	6	5	11	0	0	11	0	0
20	36915481	.	G	A	12	8	20	0	3	23	0	0
20	36915529	.	G	A	17	8	25	0	0	25	0	0
20	36916004	.	G	A	10	9	19	0	1	20	0	0
20	36916050	.	A	G	8	11	19	0	0	19	0	0
20	36917631	.	C	T	5	10	15	0	0	15	0	0
20	37913866	.	A	G	4	9	13	0	1	14	0	0
20	37913867	.	A	G	12	3	15	0	0	15	0	0
20	38359258	.	G	A	1	6	7	0	1	8	0	0
20	38669780	.	C	T	4	2	6	0	0	6	0	0
20	38670024	.	A	T	6	2	8	0	0	8	0	0
20	41237086	.	T	A	1	6	7	0	1	9	1	0
20	41237731	.	G	A	1	2	3	1	0	4	0	0
20	41998507	.	T	C	13	9	22	0	0	22	0	0
20	41998516	.	T	C	13	7	20	0	0	20	0	0
20	42047386	.	C	T	5	5	10	0	0	10	0	0
20	42100882	.	G	A	5	2	7	0	1	8	0	0
20	42203254	.	C	T	4	3	7	0	0	7	0	0
20	42203407	.	G	T	4	3	7	0	0	7	0	0
20	42203461	.	T	C	12	6	18	0	0	18	0	0
20	42221216	.	C	A	0	4	4	0	3	7	0	0
20	42221387	.	A	T	4	3	7	0	0	7	0	0
20	42221438	.	C	A	2	8	10	0	0	10	0	0
20	42221439	.	A	T	2	8	10	0	0	10	0	0
20	42221555	.	C	T	22	18	40	0	0	40	0	0
20	42221731	.	T	G	9	8	17	0	1	18	0	0
20	42222113	.	A	G	1	7	8	0	0	8	0	0
20	42222546	.	A	T	7	3	10	0	1	11	0	0
20	42222549	.	A	T	7	5	12	0	0	12	0	0
20	42222769	.	T	C	8	6	14	0	1	15	0	0
20	42222770	.	T	C	2	13	15	0	0	15	0	0
20	42232554	.	A	G	6	3	9	0	0	9	0	0
20	42233955	.	G	C	8	3	11	0	1	12	0	0
20	42241224	.	T	G	5	5	10	0	1	11	0	0
20	42247018	.	G	C	5	3	8	0	0	8	0	0
20	42247180	.	T	C	4	3	7	0	1	8	0	0
20	42275441	.	G	A	1	7	8	0	7	15	0	0
20	42280782	.	C	T	7	7	14	0	0	14	0	0
20	42281000	.	G	A	1	8	9	0	9	18	0	0
20	42281068	.	C	T	8	4	12	0	0	12	0	0
20	42281236	.	G	T	5	2	7	0	1	8	0	0
20	42281408	.	G	A	0	4	4	0	4	8	0	0
20	42296893	.	C	G	3	3	6	0	0	6	0	0
20	42296908	.	C	T	2	3	5	0	0	5	0	0
20	42297611	.	T	A	0	2	2	0	1	3	0	0
20	42629329	.	C	T	1	2	3	0	0	3	0	0
20	42629473	.	G	A	4	2	6	0	0	6	0	0
20	42629476	.	C	G	2	0	2	0	4	6	0	0
20	43120256	.	T	G	12	8	20	0	1	21	0	0
20	43121501	.	T	C	7	0	7	0	3	10	0	0
20	44373025	.	T	C	3	4	7	0	1	8	0	0
20	44373112	.	T	C	13	8	21	0	2	23	0	0
20	44373117	.	T	C	11	9	20	0	2	22	0	0
20	45644152	.	G	C	16	8	24	1	0	25	0	0
20	45644163	.	G	T	19	13	32	1	0	33	0	0
20	46967563	.	T	G	1	4	5	0	0	5	0	0
20	48463242	.	G	A	1	2	3	0	0	3	0	0
20	48483184	.	T	A	1	4	5	0	0	5	0	0
20	48483921	.	C	G	7	8	15	0	0	15	0	0
20	48483989	.	A	T	3	4	7	0	0	7	0	0
20	48484411	.	A	C	4	0	4	0	15	19	0	0
20	48598493	.	C	T	6	17	23	0	0	23	0	0
20	48806088	.	A	G	1	2	3	0	1	4	0	0
20	48806166	.	T	C	1	3	4	0	1	5	0	0
20	48806586	.	C	T	1	3	4	0	0	4	0	0
20	48811384	.	G	A	5	1	6	0	3	9	0	0
20	48844050	.	T	C	13	0	13	0	8	21	0	0
20	48844134	.	A	G	9	15	24	0	1	25	0	0
20	48844259	.	G	T	13	9	22	0	0	22	0	0
20	48844295	.	C	T	0	10	10	0	12	22	0	0
20	48845298	.	A	G	9	9	18	0	0	18	0	0
20	48860755	.	G	A	5	7	12	1	0	13	0	0
20	48869895	.	G	A	8	5	13	0	0	13	0	0
20	48877311	.	G	T	8	8	16	0	0	16	0	0
20	48877475	.	G	A	3	2	5	0	0	5	0	0
20	48886005	.	C	T	6	5	11	0	1	12	0	0
20	48895103	.	G	A	7	7	14	0	1	15	0	0
20	49085648	.	G	A	3	2	5	0	0	5	0	0
20	49087720	.	A	G	3	1	4	0	5	9	0	0
20	49087762	.	G	A	1	5	6	0	0	6	0	0
20	49087768	.	G	A	0	3	3	0	1	4	0	0
20	49087816	.	G	T	1	2	3	0	0	3	0	0
20	49089237	.	C	T	9	3	12	0	0	12	0	0
20	49094970	.	C	T	4	3	7	0	1	8	0	0
20	49094973	.	T	C	5	4	9	0	0	9	0	0
20	49095141	.	C	G	7	0	7	0	2	9	0	0
20	49095147	.	C	A	5	1	6	0	2	8	0	0
20	49099900	.	A	G	6	5	11	0	0	11	0	0
20	49100237	.	C	T	5	9	14	0	1	15	0	0
20	49103131	.	G	A	10	13	23	0	1	24	0	0
20	49103164	.	G	A	8	11	19	0	0	19	0	0
20	49103217	.	A	T	4	3	7	0	0	7	0	0
20	49895249	.	T	A	2	3	5	0	0	5	0	0
20	49916653	.	T	C	2	6	8	0	0	8	0	0
20	49928292	.	C	A	2	4	6	0	1	7	0	0
20	49928295	.	A	G	2	0	2	0	5	7	0	0
20	49940895	.	G	A	9	4	13	0	0	13	0	0
20	49940969	.	G	T	12	4	16	0	0	16	0	0
20	49952738	.	A	G	11	7	18	0	1	19	0	0
20	49960314	.	A	G	2	3	5	0	0	5	0	0
20	49960328	.	A	G	2	3	5	0	1	6	0	0
20	49960880	.	T	C	2	2	4	0	0	4	0	0
20	49961402	.	T	G	2	2	4	0	0	4	0	0
20	50015754	.	C	T	3	5	8	0	0	8	0	0
20	50032187	.	G	C	4	5	9	0	0	9	0	0
20	50037402	.	T	G	3	0	3	0	4	7	0	0
20	50041707	.	A	G	2	3	5	0	1	6	0	0
20	50049036	.	G	C	31	0	31	0	27	58	0	0
20	50049078	.	C	A	44	18	62	0	3	65	0	0
20	50057348	.	C	T	5	3	8	0	0	8	0	0
20	50074077	.	C	T	2	6	8	0	0	8	0	0
20	50074173	.	C	T	4	7	11	0	0	11	0	0
20	50074212	.	C	T	4	9	13	0	0	13	0	0
20	50076480	.	G	A	1	3	4	0	1	5	0	0
20	50079019	.	C	G	2	5	7	0	0	7	0	0
20	50079067	.	T	C	4	8	12	0	0	12	0	0
20	50079070	.	A	G	3	8	11	0	1	12	0	0
20	50079154	.	T	C	6	4	10	0	0	10	0	0
20	50082425	.	A	G	6	3	9	0	0	9	0	0
20	50082861	.	T	C	6	7	13	0	0	13	0	0
20	50650253	.	G	A	0	3	3	0	1	4	0	0
20	50740230	.	G	T	3	10	13	0	4	17	0	0
20	50898883	.	T	C	11	12	23	1	1	25	0	0
20	50917646	.	T	C	9	5	14	0	0	14	0	0
20	50921211	.	T	C	8	7	15	0	2	17	0	0
20	50923848	.	G	A	9	10	19	0	1	20	0	0
20	50926713	.	A	G	11	0	11	0	12	23	0	0
20	51089236	.	T	C	22	2	24	3	24	51	0	0
20	51089243	.	T	C	10	30	40	3	2	45	0	0
20	51481739	.	G	A	0	2	2	0	1	3	0	0
20	51730662	.	T	G	1	2	3	0	0	3	0	0
20	51758602	.	A	C	4	17	21	0	1	22	0	0
20	52333070	.	A	G	1	6	7	1	0	8	0	0
20	53069778	.	C	T	2	10	12	0	15	27	0	0
20	53069784	.	G	A	16	12	28	0	1	29	0	0
20	53074615	.	T	C	5	0	5	0	3	8	0	0
20	53171938	.	C	G	0	5	5	0	2	7	0	0
20	53181091	.	G	A	0	3	3	0	3	6	0	0
20	53183510	.	C	T	3	2	5	0	0	5	0	0
20	53191016	.	G	A	5	3	8	0	0	8	0	0
20	53215338	.	A	G	8	0	8	2	8	18	0	0
20	53279495	.	G	T	0	3	3	0	1	4	0	0
20	53279543	.	C	T	3	3	6	0	0	6	0	0
20	53312604	.	G	T	7	12	19	0	0	19	0	0
20	53318814	.	G	T	7	16	23	0	0	23	0	0
20	53318884	.	C	T	0	9	9	0	12	21	0	0
20	53365862	.	C	T	5	6	11	0	0	11	0	0
20	53377661	.	A	G	7	0	7	0	8	15	0	0
20	53377691	.	G	A	5	7	12	0	0	12	0	0
20	53393594	.	T	C	5	6	11	0	1	12	0	0
20	53393669	.	C	A	7	7	14	0	2	16	0	0
20	53398784	.	T	A	7	7	14	0	3	17	0	0
20	53401771	.	T	C	16	7	23	0	0	23	0	0
20	53401778	.	A	G	13	8	21	0	0	21	0	0
20	53401887	.	T	C	4	2	6	0	1	7	0	0
20	53408394	.	A	C	1	4	5	0	0	5	0	0
20	53408532	.	G	A	1	2	3	0	2	5	0	0
20	53501202	.	A	G	1	2	3	0	0	3	0	0
20	53601067	.	C	T	2	2	4	0	0	4	0	0
20	53601313	.	C	T	1	4	5	0	0	5	0	0
20	53601323	.	T	C	1	4	5	0	0	5	0	0
20	53637686	.	G	A	2	3	5	0	0	5	0	0
20	53637818	.	C	T	2	2	4	0	1	5	0	0
20	53639152	.	C	T	3	2	5	0	0	5	0	0
20	53639358	.	C	T	2	4	6	0	0	6	0	0
20	53639391	.	C	G	3	5	8	0	0	8	0	0
20	53639462	.	T	C	1	4	5	0	0	5	0	0
20	53639876	.	T	C	1	2	3	0	0	3	0	0
20	53640039	.	C	A	7	1	8	0	1	9	0	0
20	53640040	.	T	C	5	0	5	0	3	8	0	0
20	53803637	.	C	T	13	8	21	0	1	22	0	0
20	53803783	.	T	A	12	8	20	0	3	24	1	0
20	53804306	.	A	G	6	9	15	0	1	16	0	0
20	53804342	.	A	G	10	9	19	0	1	20	0	0
20	53804439	.	A	G	8	6	14	0	1	15	0	0
20	53804470	.	G	A	7	5	12	0	2	14	0	0
20	53804618	.	G	C	4	6	10	0	0	10	0	0
20	53810197	.	A	T	18	9	27	0	0	27	0	0
20	53898735	.	T	A	13	18	31	0	0	31	0	0
20	53898770	.	C	T	2	13	15	0	13	28	0	0
20	53898930	.	G	A	4	10	14	0	0	14	0	0
20	53899023	.	G	C	17	22	39	0	0	39	0	0
20	53899035	.	G	A	15	20	35	0	4	39	0	0
20	53899655	.	T	C	15	20	35	0	5	40	0	0
20	53900860	.	C	T	2	3	5	0	1	6	0	0
20	53901183	.	A	G	3	5	8	0	2	10	0	0
20	53902151	.	G	A	7	7	14	0	1	15	0	0
20	53902155	.	G	C	6	7	13	0	0	13	0	0
20	53903830	.	T	G	2	16	18	0	0	19	1	0
20	53912151	.	T	C	8	0	8	0	3	11	0	0
20	53912208	.	C	T	0	5	5	0	3	8	0	0
20	53921147	.	T	C	2	8	10	0	1	11	0	0
20	53930457	.	G	A	4	9	13	0	0	13	0	0
20	53930466	.	C	T	1	10	11	0	6	17	0	0
20	53949741	.	A	G	1	4	5	0	0	5	0	0
20	53968105	.	A	G	29	22	51	0	4	55	0	0
20	54047577	.	C	T	1	2	3	0	0	3	0	0
20	54047592	.	T	C	1	2	3	0	0	3	0	0
20	54050873	.	A	G	1	3	4	0	0	4	0	0
20	54050877	.	T	A	1	4	5	0	0	5	0	0
20	54051059	.	C	T	2	5	7	0	0	7	0	0
20	54051096	.	T	G	3	0	3	0	4	7	0	0
20	54067345	.	A	G	13	7	20	0	3	23	0	0
20	54067399	.	G	A	7	8	15	0	1	16	0	0
20	54067414	.	G	A	6	7	13	0	2	15	0	0
20	54067714	.	A	G	7	9	16	0	1	17	0	0
20	54067894	.	G	A	6	6	12	0	0	12	0	0
20	54085851	.	T	C	22	20	42	0	2	44	0	0
20	54175011	.	A	G	1	3	4	0	0	4	0	0
20	54175056	.	G	T	1	4	5	0	0	5	0	0
20	54197221	.	A	C	18	0	18	0	20	38	0	0
20	54197287	.	A	T	22	12	34	0	4	38	0	0
20	54197383	.	G	A	13	15	28	0	1	29	0	0
20	54197473	.	A	G	13	14	27	0	3	30	0	0
20	54197485	.	C	T	1	11	12	0	16	28	0	0
20	54197751	.	A	G	9	11	20	0	0	20	0	0
20	54197752	.	G	A	9	11	20	0	0	20	0	0
20	54205704	.	C	T	31	32	63	0	3	66	0	0
20	54215073	.	C	A	9	5	14	0	2	16	0	0
20	54215081	.	T	C	12	0	12	0	8	20	0	0
20	54215133	.	A	C	10	12	22	0	1	23	0	0
20	54219286	.	T	C	23	0	23	0	21	44	0	0
20	54228003	.	A	T	21	28	49	0	2	51	0	0
20	54233207	.	T	C	9	0	9	0	17	26	0	0
20	54235969	.	G	A	14	13	27	0	0	27	0	0
20	54236421	.	A	C	10	10	20	0	3	23	0	0
20	54236423	.	G	A	11	11	22	0	1	23	0	0
20	54249577	.	G	C	20	16	36	0	1	37	0	0
20	54251406	.	T	C	20	35	55	0	0	55	0	0
20	54274561	.	G	A	7	14	21	0	2	23	0	0
20	54277241	.	A	C	14	9	23	0	0	23	0	0
20	54278129	.	T	A	11	7	18	0	1	19	0	0
20	54283833	.	T	C	13	14	27	0	1	28	0	0
20	54284869	.	A	G	25	0	25	0	17	42	0	0
20	54284986	.	A	G	25	27	52	0	0	52	0	0
20	54285758	.	T	C	20	25	45	0	6	51	0	0
20	54285799	.	C	T	18	24	42	0	0	42	0	0
20	54285804	.	C	T	16	28	44	0	0	44	0	0
20	54285853	.	A	T	17	21	38	1	0	39	0	0
20	54286016	.	G	A	16	23	39	1	2	42	0	0
20	54286097	.	A	T	25	13	38	0	1	39	0	0
20	54286454	.	C	A	13	7	20	0	0	20	0	0
20	54286666	.	C	T	22	13	35	0	0	35	0	0
20	54286682	.	G	A	23	8	31	0	1	32	0	0
20	54286797	.	G	T	9	7	16	0	0	16	0	0
20	54286798	.	A	G	9	7	16	0	0	16	0	0
20	54334478	.	C	T	10	3	13	0	1	14	0	0
20	54339998	.	C	T	4	4	8	0	0	8	0	0
20	54340018	.	G	C	4	4	8	0	1	9	0	0
20	54340285	.	C	T	6	6	12	0	1	13	0	0
20	54340700	.	T	C	1	3	4	0	0	4	0	0
20	54340865	.	C	T	1	2	3	0	0	3	0	0
20	54341082	.	A	C	7	8	15	0	0	15	0	0
20	54341108	.	G	T	0	6	6	0	5	11	0	0
20	54341130	.	C	T	5	4	9	0	0	9	0	0
20	54341154	.	A	G	3	3	6	0	0	6	0	0
20	54341203	.	T	A	2	3	5	0	0	5	0	0
20	54342530	.	G	T	4	2	6	0	0	6	0	0
20	54342674	.	T	C	3	6	9	0	0	9	0	0
20	54342715	.	C	T	4	2	6	0	1	7	0	0
20	54343566	.	G	C	0	8	8	0	10	18	0	0
20	54343639	.	C	A	3	5	8	0	0	8	0	0
20	54343682	.	T	C	8	6	14	0	0	14	0	0
20	54343695	.	A	T	8	8	16	0	0	16	0	0
20	54343866	.	G	A	10	3	13	0	1	14	0	0
20	54343928	.	A	G	8	5	13	0	0	13	0	0
20	54344711	.	A	G	6	0	6	0	11	17	0	0
20	54344748	.	T	C	5	12	17	0	0	17	0	0
20	54344795	.	G	A	14	9	23	0	0	23	0	0
20	54344815	.	G	T	16	8	24	0	0	24	0	0
20	54344910	.	C	T	8	3	11	0	1	12	0	0
20	54345226	.	C	T	2	4	6	0	0	6	0	0
20	54345378	.	G	A	1	2	3	0	0	3	0	0
20	54345808	.	T	C	11	4	15	0	0	15	0	0
20	54345955	.	A	T	15	10	25	0	0	25	0	0
20	54345979	.	A	G	12	15	27	0	1	28	0	0
20	54346012	.	G	C	1	9	10	0	18	35	7	0
20	54346124	.	A	T	13	4	17	0	3	20	0	0
20	54346159	.	G	T	0	8	8	0	16	24	0	0
20	54346178	.	G	T	20	11	31	0	1	32	0	0
20	54346239	.	A	G	10	10	20	0	1	21	0	0
20	54356452	.	G	C	15	16	31	0	3	34	0	0
20	54357955	.	C	T	15	13	28	0	1	29	0	0
20	54358656	.	T	C	3	2	5	0	0	5	0	0
20	54360143	.	G	A	3	3	6	0	0	6	0	0
20	54360148	.	G	T	0	2	2	0	1	3	0	0
20	54397812	.	T	C	6	10	16	0	0	16	0	0
20	54397846	.	A	G	8	0	8	0	11	19	0	0
20	54397897	.	G	C	10	8	18	0	0	18	0	0
20	54398242	.	C	T	13	10	23	0	0	23	0	0
20	54398380	.	T	A	9	10	19	0	0	19	0	0
20	54398443	.	A	G	7	13	20	0	0	20	0	0
20	54402157	.	G	T	2	11	13	0	15	28	0	0
20	54402346	.	G	A	9	10	19	0	2	21	0	0
20	54402489	.	G	A	19	12	31	0	0	31	0	0
20	54406699	.	A	T	13	11	24	0	1	25	0	0
20	54406813	.	A	G	11	11	22	0	1	23	0	0
20	54407401	.	G	C	18	16	34	0	1	35	0	0
20	54407456	.	T	C	20	14	34	0	1	35	0	0
20	54407556	.	C	T	6	8	14	0	0	14	0	0
20	54422636	.	G	A	24	16	40	0	0	40	0	0
20	54422780	.	C	G	18	11	29	0	1	30	0	0
20	54422830	.	T	C	17	1	18	0	5	23	0	0
20	54422909	.	C	T	12	16	28	0	1	29	0	0
20	54422929	.	G	A	16	15	31	0	0	31	0	0
20	54423005	.	T	C	14	9	23	0	0	23	0	0
20	54423027	.	C	G	8	11	19	0	3	22	0	0
20	54428696	.	A	G	11	15	26	0	2	28	0	0
20	54432835	.	T	C	17	0	17	0	15	32	0	0
20	54432855	.	T	C	16	0	16	0	18	34	0	0
20	54434895	.	G	A	12	20	32	0	4	36	0	0
20	54434918	.	C	T	11	21	32	0	0	32	0	0
20	54441757	.	A	C	28	28	56	0	1	57	0	0
20	54446877	.	G	A	20	26	46	0	3	49	0	0
20	54462151	.	G	C	25	14	39	0	1	40	0	0
20	54520149	.	T	C	3	3	6	0	0	6	0	0
20	54525439	.	T	C	5	6	11	0	0	11	0	0
20	54563425	.	A	G	9	7	16	0	2	18	0	0
20	54563866	.	C	A	3	7	10	0	0	10	0	0
20	54563995	.	G	A	5	5	10	0	1	11	0	0
20	54563998	.	G	C	5	5	10	0	1	11	0	0
20	54666245	.	G	C	2	4	6	0	0	6	0	0
20	54670746	.	T	C	5	2	7	0	1	8	0	0
20	54670770	.	T	G	3	2	5	0	1	6	0	0
20	54670836	.	C	G	1	2	3	0	1	4	0	0
20	54670904	.	C	G	2	0	2	0	3	5	0	0
20	54671032	.	A	C	4	2	6	0	0	6	0	0
20	54671864	.	T	G	5	2	7	0	0	7	0	0
20	54671989	.	G	A	0	5	5	0	3	8	0	0
20	54672009	.	A	C	4	4	8	0	0	8	0	0
20	54672839	.	A	G	4	0	4	0	8	12	0	0
20	54672869	.	T	C	6	4	10	0	0	10	0	0
20	54672891	.	T	C	4	6	10	0	0	10	0	0
20	54672974	.	G	A	0	6	6	0	7	13	0	0
20	54673175	.	T	C	6	4	10	0	0	10	0	0
20	54673198	.	T	A	6	6	12	0	1	13	0	0
20	54675294	.	T	C	6	12	18	0	0	18	0	0
20	54675308	.	C	G	5	0	5	0	10	15	0	0
20	54675356	.	C	T	4	22	26	0	0	27	1	0
20	54676529	.	A	G	4	0	4	0	12	16	0	0
20	54676532	.	T	G	4	12	16	0	1	17	0	0
20	54676583	.	C	T	10	4	14	0	0	14	0	0
20	54681734	.	G	A	5	11	16	0	1	17	0	0
20	54681797	.	T	A	4	8	12	0	2	14	0	0
20	54681944	.	A	T	9	3	12	0	0	12	0	0
20	54698791	.	C	T	6	7	13	0	1	14	0	0
20	54699133	.	C	T	10	7	17	0	0	17	0	0
20	54708193	.	T	C	12	12	24	0	2	26	0	0
20	54708277	.	G	A	0	10	10	0	9	19	0	0
20	54711535	.	G	C	5	7	12	0	0	12	0	0
20	54738249	.	C	G	5	7	12	1	0	13	0	0
20	54740904	.	G	A	10	17	27	0	1	28	0	0
20	54740907	.	A	G	10	0	10	0	19	29	0	0
20	54740955	.	C	T	13	7	20	0	2	22	0	0
20	54740976	.	G	T	1	7	8	0	15	23	0	0
20	54741763	.	G	A	7	8	15	0	1	16	0	0
20	54742277	.	C	T	5	4	9	1	0	10	0	0
20	54742641	.	C	G	14	7	21	0	1	22	0	0
20	54742714	.	C	T	11	10	21	0	3	24	0	0
20	54742750	.	A	G	8	0	8	0	16	24	0	0
20	54742765	.	A	C	10	13	23	0	1	24	0	0
20	54742912	.	A	C	10	12	22	0	0	22	0	0
20	54743565	.	T	C	19	15	34	3	3	40	0	0
20	54743917	.	G	A	29	8	37	0	2	39	0	0
20	54743937	.	C	T	19	8	27	0	1	28	0	0
20	54743981	.	A	G	10	0	10	0	9	19	0	0
20	54744230	.	C	T	15	20	35	0	0	35	0	0
20	54744314	.	A	G	19	1	20	0	15	35	0	0
20	54744363	.	A	G	17	0	17	0	11	28	0	0
20	54744419	.	A	G	18	17	35	1	1	37	0	0
20	54744451	.	A	G	18	7	25	1	1	27	0	0
20	54744469	.	A	G	20	5	25	1	2	28	0	0
20	54744486	.	A	G	12	5	17	1	0	18	0	0
21	238575	.	T	C	11	11	22	0	0	22	0	0
21	734868	.	A	G	15	0	15	0	5	20	0	0
21	734962	.	A	G	9	0	9	0	15	24	0	0
21	735222	.	A	G	35	0	35	0	34	69	0	0
21	1576168	.	T	C	8	6	14	0	1	15	0	0
21	1593916	.	T	C	3	2	5	0	1	6	0	0
21	1594125	.	T	C	4	4	8	0	0	8	0	0
21	1594167	.	T	A	3	5	8	0	1	9	0	0
21	1594228	.	T	G	3	5	8	0	0	8	0	0
21	1599017	.	T	C	1	5	6	0	0	6	0	0
21	1604351	.	G	A	0	5	5	0	8	13	0	0
21	1610473	.	C	G	9	7	16	0	1	17	0	0
21	1610673	.	A	G	4	2	6	0	0	6	0	0
21	1610719	.	A	T	2	2	4	0	0	4	0	0
21	1741801	.	C	G	2	3	5	0	0	5	0	0
21	1780912	.	A	C	3	2	5	0	0	5	0	0
21	1788234	.	A	G	2	2	4	0	0	4	0	0
21	1788255	.	T	C	4	2	6	0	0	6	0	0
21	1788474	.	G	A	3	5	8	0	0	8	0	0
21	1788621	.	G	A	2	1	3	0	1	4	0	0
21	1788624	.	G	A	2	2	4	0	0	4	0	0
21	1798961	.	C	T	3	7	10	0	0	10	0	0
21	2171521	.	T	C	1	4	5	0	0	5	0	0
21	2171532	.	T	C	2	2	4	0	0	4	0	0
21	2213286	.	A	G	6	2	8	0	0	8	0	0
21	2738221	.	C	T	24	21	45	0	0	45	0	0
21	2957874	.	T	C	2	0	2	0	2	4	0	0
21	3173498	.	A	C	8	8	16	0	0	16	0	0
21	5003125	.	T	C	2	2	4	0	0	4	0	0
21	5003129	.	T	C	2	2	4	0	0	4	0	0
21	5802898	.	T	A	4	4	8	1	1	10	0	0
21	10730820	.	G	T	7	2	9	0	0	9	0	0
21	11493661	.	A	G	46	13	59	0	2	61	0	0
21	11494536	.	A	G	16	2	18	0	53	71	0	0
21	11501975	.	A	G	28	28	56	0	2	58	0	0
21	11502056	.	A	G	40	25	65	0	2	67	0	0
21	11502143	.	A	G	9	48	57	0	5	62	0	0
21	13612494	.	T	C	4	0	4	0	6	10	0	0
21	13612502	.	T	C	4	0	4	0	4	8	0	0
21	13613001	.	T	C	2	2	4	0	1	5	0	0
21	14644344	.	T	C	2	8	10	0	0	10	0	0
21	17568543	.	A	G	7	17	24	0	2	27	1	0
21	17569133	.	A	G	6	4	10	1	2	13	0	0
21	18937216	.	C	T	12	2	14	1	0	15	0	0
21	19905261	.	G	A	1	7	8	0	0	8	0	0
21	21297979	.	A	G	4	3	7	0	0	7	0	0
21	21343123	.	A	G	2	2	4	0	1	5	0	0
21	21343266	.	A	G	3	4	7	0	0	7	0	0
21	21344067	.	A	G	1	3	4	0	0	4	0	0
21	21450735	.	A	G	1	7	8	0	0	8	0	0
21	22073477	.	A	G	2	13	15	0	0	15	0	0
21	22447329	.	A	C	2	4	6	0	0	6	0	0
21	22448380	.	C	G	5	4	9	0	0	9	0	0
21	22448574	.	A	G	2	4	6	0	1	7	0	0
21	22448597	.	T	A	2	5	7	0	0	7	0	0
21	22448808	.	A	G	5	4	9	0	0	9	0	0
21	22448961	.	C	T	6	2	8	0	2	10	0	0
21	22454381	.	T	C	4	5	9	0	0	9	0	0
21	22454396	.	A	G	4	4	8	0	0	8	0	0
21	22474446	.	C	T	1	2	3	0	0	3	0	0
21	22497259	.	C	T	1	2	3	0	0	3	0	0
21	22550187	.	T	C	1	2	3	0	0	3	0	0
21	22630324	.	C	T	5	2	7	0	0	7	0	0
21	22630712	.	T	A	3	4	7	0	0	7	0	0
21	22630715	.	A	T	4	3	7	0	0	7	0	0
21	22630864	.	G	A	11	11	22	0	0	22	0	0
21	22633734	.	A	G	17	13	30	0	0	30	0	0
21	22697107	.	C	T	4	2	6	0	0	6	0	0
21	22697161	.	T	C	7	6	13	0	1	14	0	0
21	22698790	.	T	C	7	7	14	0	0	14	0	0
21	22698809	.	C	T	5	8	13	0	0	13	0	0
21	22699471	.	T	C	7	5	12	0	1	13	0	0
21	22699491	.	T	C	7	9	16	0	0	16	0	0
21	22699512	.	T	C	9	9	18	0	1	19	0	0
21	22699556	.	A	G	9	7	16	0	1	17	0	0
21	22699563	.	C	T	7	8	15	0	3	18	0	0
21	22699595	.	C	A	6	7	13	0	2	15	0	0
21	22699608	.	T	C	4	7	11	0	0	11	0	0
21	22699853	.	G	T	2	6	8	0	7	15	0	0
21	22699916	.	G	A	8	8	16	0	2	18	0	0
21	22699956	.	T	G	3	7	10	0	0	10	0	0
21	22699986	.	T	A	5	6	11	0	0	11	0	0
21	22700015	.	A	G	4	0	4	0	6	10	0	0
21	22702551	.	A	C	6	8	14	0	3	17	0	0
21	22702804	.	C	T	12	5	17	0	0	17	0	0
21	22705087	.	C	T	5	8	13	0	1	14	0	0
21	22708876	.	C	A	0	2	2	0	1	3	0	0
21	22785326	.	C	T	5	2	7	0	0	7	0	0
21	22791122	.	T	C	2	4	6	0	0	6	0	0
21	22793229	.	A	G	5	0	5	1	6	12	0	0
21	22793238	.	A	G	6	5	11	1	0	12	0	0
21	22795009	.	T	C	6	6	12	0	0	12	0	0
21	22795107	.	G	A	2	6	8	0	6	14	0	0
21	22846973	.	C	T	8	5	13	0	0	13	0	0
21	22846986	.	T	C	11	5	16	0	0	16	0	0
21	22847022	.	A	T	14	5	19	0	1	20	0	0
21	22847136	.	C	T	10	13	23	0	0	23	0	0
21	22847163	.	A	G	10	18	28	0	0	28	0	0
21	22847174	.	G	C	10	17	27	0	3	30	0	0
21	22847207	.	A	G	15	9	24	0	2	26	0	0
21	22847284	.	A	G	18	1	19	0	11	30	0	0
21	22847750	.	C	T	20	20	40	0	5	45	0	0
21	22847969	.	C	T	19	26	45	0	6	51	0	0
21	22847984	.	A	T	25	25	50	0	2	52	0	0
21	22848011	.	G	A	24	16	40	0	4	44	0	0
21	22848047	.	C	T	24	15	39	0	0	39	0	0
21	22848173	.	C	T	15	14	29	0	2	31	0	0
21	22848403	.	T	C	13	14	27	0	1	28	0	0
21	22848424	.	C	T	12	18	30	0	0	30	0	0
21	22849817	.	A	C	20	28	48	2	2	52	0	0
21	22850949	.	G	A	21	19	40	0	1	41	0	0
21	22876955	.	A	G	2	0	2	0	5	7	0	0
21	22876976	.	T	A	3	3	6	0	1	7	0	0
21	22878844	.	A	C	2	7	9	0	0	9	0	0
21	22878856	.	G	A	3	11	14	0	0	14	0	0
21	22879338	.	C	A	4	3	7	2	1	10	0	0
21	22879458	.	A	G	10	0	10	1	6	17	0	0
21	22879559	.	A	C	4	12	16	0	0	16	0	0
21	22879733	.	G	C	0	9	9	0	3	12	0	0
21	22879824	.	A	C	5	10	15	0	0	15	0	0
21	22879909	.	C	A	4	10	14	0	0	14	0	0
21	22880016	.	A	T	11	9	20	0	0	20	0	0
21	22880079	.	C	T	8	13	21	0	0	21	0	0
21	22881477	.	G	C	7	5	12	0	0	12	0	0
21	22882138	.	T	C	3	4	7	0	0	7	0	0
21	22882354	.	G	T	4	6	10	0	0	10	0	0
21	22882386	.	T	G	4	0	4	0	6	10	0	0
21	22882587	.	A	C	7	6	13	0	0	13	0	0
21	22882761	.	C	T	5	11	16	0	0	16	0	0
21	22882801	.	G	T	5	10	15	0	0	15	0	0
21	22882818	.	A	G	6	0	6	0	7	13	0	0
21	22882866	.	T	C	9	5	14	0	0	14	0	0
21	22883182	.	C	T	10	7	17	0	0	17	0	0
21	22883363	.	T	C	6	6	12	0	0	12	0	0
21	22884361	.	T	C	9	6	15	0	1	16	0	0
21	22884412	.	C	T	19	11	30	0	0	30	0	0
21	22884556	.	G	A	2	7	9	0	14	23	0	0
21	22884661	.	T	C	11	12	23	0	4	27	0	0
21	22884769	.	C	T	11	18	29	0	0	29	0	0
21	22885083	.	G	T	11	8	19	0	1	20	0	0
21	22889928	.	C	T	0	4	4	0	1	5	0	0
21	22901119	.	G	A	2	2	4	0	0	4	0	0
21	22967106	.	A	G	3	3	6	0	0	6	0	0
21	23019589	.	T	G	8	7	15	0	0	15	0	0
21	23019679	.	C	A	21	12	33	0	2	35	0	0
21	23019836	.	T	G	18	17	35	0	1	36	0	0
21	23020095	.	A	C	16	18	34	0	2	36	0	0
21	23020126	.	A	G	21	14	35	0	3	38	0	0
21	23020440	.	A	T	18	16	34	0	3	37	0	0
21	23020523	.	T	C	20	0	20	0	16	36	0	0
21	23020558	.	C	T	3	20	23	0	18	41	0	0
21	23021145	.	C	A	11	15	26	0	1	27	0	0
21	23025233	.	G	A	7	11	18	0	0	18	0	0
21	23025349	.	G	A	16	11	27	0	1	28	0	0
21	23025352	.	C	G	0	12	12	0	15	27	0	0
21	23026978	.	C	T	1	12	13	0	8	21	0	0
21	23027017	.	C	T	11	14	25	0	0	25	0	0
21	23027023	.	A	T	12	12	24	0	5	29	0	0
21	23036459	.	A	G	4	3	7	0	0	7	0	0
21	23040577	.	A	G	5	5	10	0	1	11	0	0
21	23041283	.	G	A	9	4	13	0	0	13	0	0
21	23041602	.	T	A	3	3	6	0	0	6	0	0
21	23042616	.	C	T	2	2	4	0	3	7	0	0
21	23043953	.	T	C	2	5	7	0	0	7	0	0
21	23043978	.	A	G	2	5	7	0	1	8	0	0
21	23160851	.	A	T	20	11	31	0	2	33	0	0
21	23161651	.	C	A	9	5	14	0	1	15	0	0
21	23162023	.	C	T	13	9	22	0	2	24	0	0
21	23162127	.	A	T	14	7	21	1	0	22	0	0
21	23162395	.	T	G	7	7	14	0	1	15	0	0
21	23162618	.	C	A	14	7	21	0	0	21	0	0
21	23163534	.	T	C	12	0	12	0	11	23	0	0
21	23163564	.	T	A	19	11	30	0	0	30	0	0
21	23163841	.	A	T	9	11	20	0	0	20	0	0
21	23163884	.	A	G	14	8	22	0	0	22	0	0
21	23163885	.	A	G	14	8	22	0	0	22	0	0
21	23163938	.	G	T	19	10	29	0	0	29	0	0
21	23163990	.	A	T	16	6	22	1	0	23	0	0
21	23164090	.	C	T	2	4	6	0	0	6	0	0
21	23175440	.	C	T	14	2	16	0	3	19	0	0
21	23304314	.	G	A	4	7	11	0	1	12	0	0
21	23304539	.	T	A	2	2	4	0	1	5	0	0
21	23338168	.	A	G	9	6	15	0	0	15	0	0
21	23338241	.	G	A	6	9	15	0	0	15	0	0
21	23350240	.	A	G	9	12	21	0	1	22	0	0
21	23352629	.	A	G	11	8	19	0	1	20	0	0
21	23352707	.	A	G	8	7	15	0	1	16	0	0
21	23352749	.	G	A	4	3	7	0	0	7	0	0
21	23367200	.	C	T	22	15	37	0	2	39	0	0
21	23367218	.	T	G	23	17	40	0	0	40	0	0
21	23469825	.	T	C	6	0	6	0	10	16	0	0
21	23473213	.	G	A	9	8	17	0	1	18	0	0
21	23475195	.	G	A	3	2	5	0	0	5	0	0
21	24287537	.	C	T	6	11	17	0	1	18	0	0
21	24411429	.	C	G	19	13	32	0	1	33	0	0
21	24545622	.	A	G	3	10	13	0	0	13	0	0
21	24548355	.	A	G	4	3	7	0	0	7	0	0
21	24548563	.	G	A	4	3	7	0	0	7	0	0
21	24548695	.	C	T	0	3	3	0	3	6	0	0
21	24548716	.	C	T	3	4	7	0	1	8	0	0
21	24548838	.	A	C	3	0	3	0	7	10	0	0
21	24554450	.	C	T	2	3	5	0	0	5	0	0
21	25037521	.	G	A	1	6	7	0	3	10	0	0
21	25037557	.	C	A	3	4	7	0	0	7	0	0
21	25037572	.	T	C	3	4	7	0	1	8	0	0
21	25043681	.	C	T	4	2	6	0	0	6	0	0
21	25044153	.	A	T	4	2	6	0	0	6	0	0
21	25044196	.	C	T	2	2	4	0	0	4	0	0
21	25044433	.	T	A	3	1	4	0	1	5	0	0
21	25044434	.	C	A	3	2	5	0	0	5	0	0
21	25044523	.	G	A	0	2	2	0	3	5	0	0
21	25044532	.	C	A	3	1	4	0	0	4	0	0
21	25044848	.	C	G	4	3	7	0	0	7	0	0
21	25044876	.	A	T	3	4	7	0	0	7	0	0
21	25044885	.	G	C	3	4	7	0	0	7	0	0
21	25044968	.	G	A	0	3	3	0	6	9	0	0
21	25045517	.	C	T	2	4	6	0	1	7	0	0
21	25045521	.	T	C	2	4	6	0	1	7	0	0
21	25046179	.	A	G	3	1	4	0	6	10	0	0
21	25046210	.	G	C	5	2	7	0	0	7	0	0
21	25055553	.	T	C	5	4	9	0	1	10	0	0
21	25057140	.	G	A	0	2	2	0	4	6	0	0
21	25057217	.	G	T	8	8	16	0	0	16	0	0
21	25059752	.	G	A	1	4	5	0	9	14	0	0
21	25059941	.	G	A	6	6	12	0	0	12	0	0
21	25082995	.	G	A	3	2	5	0	0	5	0	0
21	25083046	.	C	T	2	2	4	0	0	4	0	0
21	25103457	.	G	A	6	4	10	0	2	12	0	0
21	25103676	.	T	A	16	8	24	0	1	25	0	0
21	25109986	.	A	G	17	10	27	0	0	27	0	0
21	25117588	.	A	G	12	6	18	0	0	18	0	0
21	25117626	.	A	G	13	0	13	0	8	21	0	0
21	25117777	.	T	G	18	11	29	0	1	30	0	0
21	25117959	.	G	A	15	13	28	0	0	28	0	0
21	25117974	.	A	C	12	14	26	0	2	28	0	0
21	25118065	.	G	A	15	7	22	0	0	22	0	0
21	25118108	.	T	C	11	12	23	0	0	23	0	0
21	25125110	.	C	T	1	5	6	0	1	7	0	0
21	25127542	.	G	A	2	5	7	0	1	8	0	0
21	25135777	.	A	G	7	0	7	0	6	13	0	0
21	25135789	.	C	T	7	6	13	0	1	14	0	0
21	25136093	.	T	C	4	5	9	0	1	10	0	0
21	25140596	.	A	G	10	8	18	0	0	18	0	0
21	25142536	.	T	A	8	6	14	0	0	14	0	0
21	25142635	.	A	G	12	7	19	0	0	19	0	0
21	25156379	.	C	T	7	6	13	0	2	15	0	0
21	25156486	.	C	A	9	9	18	0	1	19	0	0
21	25156487	.	C	A	9	8	17	0	1	18	0	0
21	25181296	.	C	G	2	2	4	0	1	5	0	0
21	25181299	.	A	G	2	3	5	0	0	5	0	0
21	25182091	.	C	A	15	9	24	0	2	26	0	0
21	25182207	.	A	T	16	8	24	0	2	26	0	0
21	25209223	.	G	A	7	3	10	0	1	11	0	0
21	25213423	.	G	A	5	3	8	0	0	8	0	0
21	25247308	.	G	A	3	4	7	0	0	7	0	0
21	25247533	.	T	C	8	0	8	0	13	21	0	0
21	25250497	.	C	T	0	6	6	0	6	12	0	0
21	25250632	.	G	C	3	0	3	0	3	6	0	0
21	25250836	.	G	A	1	3	4	0	0	4	0	0
21	25250986	.	G	A	3	5	8	0	0	8	0	0
21	25251013	.	G	A	8	3	11	0	0	11	0	0
21	25251034	.	G	T	10	2	12	0	0	12	0	0
21	25256907	.	C	T	4	4	8	0	0	8	0	0
21	25257059	.	T	C	4	2	6	0	1	7	0	0
21	25257086	.	C	T	2	3	5	0	1	6	0	0
21	25262612	.	A	G	1	1	2	0	1	3	0	0
21	25269653	.	G	A	1	2	3	0	0	3	0	0
21	25271522	.	T	A	1	3	4	0	0	4	0	0
21	25380817	.	T	A	5	2	7	0	0	7	0	0
21	25384076	.	T	C	20	17	37	2	1	40	0	0
21	25386752	.	T	C	21	28	49	0	2	51	0	0
21	25391290	.	C	A	22	19	41	0	3	44	0	0
21	25399339	.	T	G	4	7	11	0	1	12	0	0
21	25399423	.	C	A	15	5	20	0	3	23	0	0
21	25399909	.	T	G	17	19	36	0	1	37	0	0
21	25407216	.	C	G	21	24	45	0	1	46	0	0
21	25425773	.	C	A	13	14	27	0	0	27	0	0
21	25425798	.	T	C	11	10	21	0	1	23	1	0
21	25425826	.	G	T	13	9	22	0	3	25	0	0
21	25425848	.	C	A	0	9	9	0	11	20	0	0
21	25425873	.	A	T	9	11	20	0	0	20	0	0
21	25439974	.	T	A	3	3	6	0	16	22	0	0
21	25440049	.	G	A	23	17	40	0	1	42	1	0
21	25449464	.	G	A	15	23	38	0	1	39	0	0
21	25450846	.	G	A	13	11	24	0	0	24	0	0
21	25452558	.	G	A	12	13	25	0	0	25	0	0
21	25458902	.	T	A	16	10	26	1	0	27	0	0
21	25460713	.	G	A	10	18	28	0	3	31	0	0
21	25460734	.	G	A	11	19	30	0	5	35	0	0
21	25463338	.	A	G	11	8	19	0	1	20	0	0
21	25476597	.	G	A	7	3	10	0	1	11	0	0
21	25492981	.	C	T	10	5	15	0	0	15	0	0
21	25522674	.	C	T	0	12	12	0	6	18	0	0
21	25533882	.	G	A	7	3	10	0	0	10	0	0
21	25538219	.	A	C	5	5	10	0	0	10	0	0
21	25538237	.	G	A	0	6	6	0	5	11	0	0
21	25540822	.	C	A	1	3	4	0	0	4	0	0
21	25540846	.	A	C	1	2	3	0	0	3	0	0
21	25541272	.	A	G	4	5	9	0	1	10	0	0
21	25541473	.	C	T	5	4	9	0	0	9	0	0
21	25541704	.	T	C	2	6	8	0	0	8	0	0
21	25541893	.	A	G	8	4	12	0	0	12	0	0
21	25541902	.	C	T	6	3	9	0	1	10	0	0
21	25542356	.	C	A	6	4	10	0	0	10	0	0
21	25542703	.	G	T	2	2	4	0	0	4	0	0
21	25542966	.	G	T	2	6	8	0	0	8	0	0
21	25561775	.	T	C	24	1	25	0	24	49	0	0
21	25565215	.	T	C	8	1	9	0	13	22	0	0
21	25565268	.	C	T	15	14	29	0	1	30	0	0
21	25570042	.	A	G	12	20	32	0	0	32	0	0
21	25570275	.	G	C	10	12	22	0	2	24	0	0
21	25570416	.	C	G	1	15	16	0	13	29	0	0
21	25571377	.	A	G	6	10	16	0	0	16	0	0
21	25571392	.	G	A	4	9	13	0	1	14	0	0
21	25571436	.	T	A	4	6	10	0	0	10	0	0
21	25571446	.	G	A	5	6	11	0	0	11	0	0
21	25571488	.	T	A	3	2	5	0	0	5	0	0
21	25571919	.	T	C	5	3	8	0	0	8	0	0
21	25572145	.	C	T	4	5	9	0	0	9	0	0
21	25572156	.	C	T	2	5	7	0	2	9	0	0
21	25572785	.	G	T	2	4	6	0	0	6	0	0
21	25572930	.	C	T	0	2	2	0	3	5	0	0
21	25589318	.	T	C	1	8	9	0	0	9	0	0
21	25589667	.	T	A	2	2	4	0	0	4	0	0
21	25605515	.	T	A	1	4	5	0	1	6	0	0
21	25605597	.	T	C	3	3	6	0	0	6	0	0
21	25605647	.	A	G	7	3	10	1	0	11	0	0
21	25606796	.	C	T	7	3	10	0	0	10	0	0
21	25606819	.	C	G	0	5	5	0	6	11	0	0
21	25606971	.	A	G	7	4	11	0	0	11	0	0
21	25610512	.	T	C	11	0	11	0	6	17	0	0
21	25611659	.	A	G	9	4	13	0	0	13	0	0
21	25611931	.	T	C	9	5	14	0	0	14	0	0
21	25613128	.	T	G	4	3	7	0	0	7	0	0
21	25620446	.	T	C	2	3	5	0	0	5	0	0
21	25620573	.	A	G	4	3	7	0	0	7	0	0
21	25645217	.	A	C	9	8	17	0	2	19	0	0
21	25645555	.	T	G	10	22	32	0	1	33	0	0
21	25645655	.	G	C	9	20	29	0	0	29	0	0
21	25671377	.	T	C	1	5	6	0	0	6	0	0
21	25685385	.	G	T	1	3	4	0	1	5	0	0
21	25693141	.	G	T	7	3	10	0	1	11	0	0
21	25694895	.	G	A	1	3	4	0	0	4	0	0
21	25694896	.	G	A	1	3	4	0	0	4	0	0
21	25695070	.	A	G	2	2	4	0	0	4	0	0
21	25713908	.	T	C	9	8	17	0	0	17	0	0
21	25722719	.	C	T	4	7	11	0	0	11	0	0
21	25794648	.	G	A	2	5	7	0	0	7	0	0
21	25796628	.	G	T	2	2	4	0	0	4	0	0
21	25811263	.	C	T	4	8	12	0	0	12	0	0
21	25816780	.	G	A	2	2	4	0	0	4	0	0
21	25817230	.	A	G	4	5	9	0	0	9	0	0
21	25818170	.	G	C	3	3	6	0	0	6	0	0
21	25818193	.	T	G	3	0	3	0	2	5	0	0
21	25818430	.	G	A	0	4	4	0	1	5	0	0
21	25936329	.	A	C	1	2	3	0	0	3	0	0
21	25936341	.	G	A	1	3	4	0	1	5	0	0
21	25968253	.	C	T	4	4	8	0	0	8	0	0
21	26021662	.	T	A	2	3	5	0	1	6	0	0
21	26023146	.	G	A	7	3	10	0	0	10	0	0
21	26023147	.	T	A	5	3	8	0	2	10	0	0
21	26023209	.	G	A	2	9	11	0	0	11	0	0
21	26029021	.	T	C	7	8	15	0	0	15	0	0
21	26030687	.	T	C	2	2	4	0	0	4	0	0
21	26033800	.	C	T	6	4	10	0	0	10	0	0
21	26041741	.	C	T	7	5	12	0	0	12	0	0
21	26043333	.	A	G	8	4	12	0	0	12	0	0
21	26050097	.	C	T	8	6	14	0	0	14	0	0
21	26050115	.	C	T	10	5	15	0	2	17	0	0
21	26050415	.	T	G	9	8	17	0	0	17	0	0
21	26053710	.	T	G	17	0	17	0	18	35	0	0
21	26053929	.	C	A	14	13	27	0	1	28	0	0
21	26054453	.	A	G	17	1	18	0	20	38	0	0
21	26057490	.	T	A	11	10	21	0	0	21	0	0
21	26057707	.	C	T	8	15	23	0	7	30	0	0
21	26058121	.	C	T	9	9	18	0	0	18	0	0
21	26058275	.	G	T	11	13	24	0	5	29	0	0
21	26058378	.	C	T	6	8	14	0	2	16	0	0
21	26058386	.	C	A	8	6	14	0	4	18	0	0
21	26062621	.	T	C	1	2	3	0	0	3	0	0
21	26080402	.	A	G	9	6	15	0	0	15	0	0
21	26080633	.	G	C	6	3	9	0	1	10	0	0
21	26161272	.	G	A	5	2	7	0	0	7	0	0
21	26389462	.	C	T	28	13	41	0	2	43	0	0
21	26390614	.	G	A	11	18	29	0	3	32	0	0
21	26390620	.	A	G	13	20	33	0	0	33	0	0
21	26391964	.	T	A	7	4	11	0	0	11	0	0
21	26408340	.	A	C	12	0	12	0	18	30	0	0
21	26415195	.	C	T	13	11	24	0	1	25	0	0
21	26417389	.	A	T	8	5	13	0	0	13	0	0
21	26417854	.	A	T	7	5	12	0	1	13	0	0
21	26426274	.	C	A	1	3	4	0	0	4	0	0
21	26429227	.	G	A	2	3	5	0	0	5	0	0
21	26438770	.	A	G	1	2	3	0	0	3	0	0
21	26438785	.	C	T	1	2	3	0	0	3	0	0
21	26483092	.	A	G	3	2	5	0	0	5	0	0
21	26522682	.	G	A	7	9	16	0	0	16	0	0
21	26523233	.	C	T	3	14	17	0	2	19	0	0
21	26523454	.	A	T	8	6	14	0	0	14	0	0
21	26525311	.	C	T	5	5	10	0	1	11	0	0
21	26527782	.	G	A	2	13	15	0	5	20	0	0
21	26527808	.	A	G	6	19	25	0	1	26	0	0
21	26530332	.	G	A	0	10	10	0	10	20	0	0
21	26530663	.	T	A	14	11	25	0	0	25	0	0
21	26530737	.	G	C	8	16	24	0	3	27	0	0
21	26531014	.	G	A	3	14	17	0	1	18	0	0
21	26545469	.	C	T	6	6	12	0	1	13	0	0
21	26545622	.	T	A	5	6	11	0	0	11	0	0
21	26607004	.	T	G	1	3	4	0	0	4	0	0
21	26634042	.	C	T	19	8	27	0	0	27	0	0
21	26657476	.	C	T	27	29	56	0	1	57	0	0
21	26657484	.	C	A	28	25	53	0	1	54	0	0
21	26660055	.	G	A	4	27	31	0	25	56	0	0
21	26662745	.	G	A	22	23	45	0	2	47	0	0
21	26664824	.	G	A	8	4	12	0	0	12	0	0
21	26665046	.	G	T	5	7	12	0	1	13	0	0
21	26665092	.	C	T	1	5	6	0	6	12	0	0
21	26665141	.	A	G	7	8	15	0	0	15	0	0
21	26669386	.	C	G	7	7	14	0	0	14	0	0
21	26669394	.	C	T	7	7	14	0	0	14	0	0
21	26669421	.	T	C	6	5	11	0	1	12	0	0
21	26669480	.	C	A	6	9	15	0	0	15	0	0
21	26669495	.	G	A	9	4	13	0	0	13	0	0
21	26670145	.	T	C	9	0	9	1	6	16	0	0
21	26670306	.	T	A	4	6	10	0	0	10	0	0
21	26670858	.	G	A	5	4	9	0	0	9	0	0
21	26670860	.	C	A	4	4	8	0	1	9	0	0
21	26670900	.	C	T	3	2	5	0	0	5	0	0
21	26672014	.	G	A	2	3	5	0	1	6	0	0
21	26672160	.	C	T	2	5	7	0	0	7	0	0
21	26672184	.	C	T	2	5	7	0	1	8	0	0
21	26672434	.	C	T	2	2	4	0	1	5	0	0
21	26672611	.	G	A	3	4	7	0	0	7	0	0
21	26675240	.	C	T	0	5	5	0	1	6	0	0
21	26675363	.	T	C	4	0	4	0	3	7	0	0
21	26678649	.	C	T	4	4	8	0	1	9	0	0
21	26678650	.	C	T	4	4	8	0	1	9	0	0
21	26678838	.	C	A	5	8	13	0	0	13	0	0
21	26678965	.	C	T	1	7	8	0	12	20	0	0
21	26679023	.	T	C	16	6	22	0	0	22	0	0
21	26689875	.	T	A	6	2	8	0	1	9	0	0
21	26689934	.	A	T	7	4	11	0	0	11	0	0
21	26690151	.	T	A	3	12	15	0	1	16	0	0
21	26691889	.	T	C	5	8	13	0	4	17	0	0
21	26691898	.	A	T	7	8	15	0	1	16	0	0
21	26697686	.	G	C	41	23	64	4	2	70	0	0
21	26706581	.	C	A	38	29	67	0	1	68	0	0
21	26706583	.	G	A	37	29	66	0	2	68	0	0
21	26706646	.	C	G	23	27	50	0	4	55	1	0
21	26706662	.	T	A	27	32	59	0	2	61	0	0
21	26706846	.	T	A	31	19	50	0	1	51	0	0
21	26710071	.	A	G	16	22	38	0	0	38	0	0
21	26710194	.	T	A	27	14	41	0	5	46	0	0
21	26710239	.	G	A	27	14	41	0	1	42	0	0
21	26710496	.	C	A	26	19	45	0	1	46	0	0
21	26710514	.	A	G	27	20	47	0	1	48	0	0
21	26714361	.	C	T	3	14	17	0	21	38	0	0
21	26714373	.	C	A	17	14	31	0	5	36	0	0
21	26721385	.	C	A	3	3	6	0	0	6	0	0
21	26721400	.	G	A	2	4	6	0	5	11	0	0
21	26722269	.	C	T	9	8	17	0	1	18	0	0
21	26722347	.	G	A	6	13	19	0	0	19	0	0
21	26722431	.	T	C	14	9	23	0	0	23	0	0
21	26722625	.	C	T	9	8	17	0	0	17	0	0
21	26722688	.	T	A	6	4	10	0	0	10	0	0
21	26724649	.	A	G	20	8	28	0	2	30	0	0
21	26724833	.	A	G	20	19	39	0	0	39	0	0
21	26725247	.	C	T	22	11	33	0	0	33	0	0
21	26731344	.	G	A	41	25	66	0	3	69	0	0
21	26731364	.	T	A	38	25	63	0	2	65	0	0
21	26731765	.	C	T	39	30	69	0	6	75	0	0
21	26731925	.	C	A	31	30	61	0	2	63	0	0
21	26733455	.	G	T	1	4	5	0	0	5	0	0
21	26733517	.	A	G	2	2	4	0	0	4	0	0
21	26748198	.	A	G	3	2	5	0	0	5	0	0
21	26753714	.	G	A	1	2	3	0	0	3	0	0
21	26787786	.	T	C	1	4	5	0	0	5	0	0
21	26909169	.	C	T	15	9	24	0	2	26	0	0
21	26909177	.	C	T	14	9	23	0	2	25	0	0
21	26909228	.	A	G	16	13	29	0	3	32	0	0
21	26909425	.	C	G	9	7	16	0	2	18	0	0
21	26909560	.	A	C	11	0	11	0	4	15	0	0
21	26914870	.	T	G	15	6	21	0	1	22	0	0
21	26914915	.	T	G	13	12	25	0	0	25	0	0
21	26915086	.	G	A	10	6	16	0	0	16	0	0
21	26915203	.	A	G	6	4	10	0	0	10	0	0
21	26915355	.	G	A	9	4	13	0	0	13	0	0
21	26916238	.	C	T	1	6	7	0	3	10	0	0
21	26918601	.	C	T	6	4	10	0	1	11	0	0
21	26918684	.	G	A	1	2	3	0	0	3	0	0
21	26918703	.	A	G	1	5	6	0	0	6	0	0
21	26918762	.	C	A	1	3	4	3	1	8	0	0
21	26918767	.	G	A	2	4	6	3	0	9	0	0
21	26918892	.	A	G	5	2	7	0	0	7	0	0
21	26927201	.	C	A	3	3	6	0	1	7	0	0
21	26927255	.	T	C	3	3	6	0	1	7	0	0
21	26934419	.	G	A	8	3	11	0	0	11	0	0
21	26934888	.	C	T	11	3	14	0	1	15	0	0
21	26954405	.	G	A	3	5	8	0	0	8	0	0
21	26954430	.	T	C	3	5	8	0	1	9	0	0
21	26961015	.	A	T	9	11	20	0	2	22	0	0
21	26961084	.	A	G	9	15	24	0	1	25	0	0
21	26965918	.	A	T	13	14	27	0	2	29	0	0
21	26966025	.	T	C	7	9	16	0	0	16	0	0
21	26966047	.	A	T	7	9	16	0	0	16	0	0
21	26966079	.	A	G	8	0	8	0	5	13	0	0
21	26966088	.	A	T	7	4	11	0	1	12	0	0
21	26966287	.	G	A	0	15	15	0	12	27	0	0
21	26966315	.	G	A	13	5	18	0	3	21	0	0
21	26966681	.	A	G	11	0	11	0	11	22	0	0
21	26967230	.	C	T	7	9	16	0	2	18	0	0
21	26967265	.	T	A	10	12	22	0	1	23	0	0
21	26967551	.	A	T	13	22	35	0	1	36	0	0
21	26967906	.	T	G	25	19	44	0	2	46	0	0
21	26968042	.	G	A	14	19	33	0	1	34	0	0
21	26968344	.	G	A	12	12	24	0	0	24	0	0
21	26968499	.	T	G	6	11	17	0	0	17	0	0
21	26995869	.	G	A	4	4	8	0	1	9	0	0
21	26996849	.	C	A	3	24	27	0	28	55	0	0
21	26996893	.	T	C	22	1	23	0	27	50	0	0
21	27010406	.	T	A	17	21	38	0	2	40	0	0
21	27047839	.	A	T	12	16	28	0	0	28	0	0
21	27047955	.	G	A	14	12	26	0	1	27	0	0
21	27048320	.	C	A	4	7	11	0	1	12	0	0
21	27048423	.	G	T	6	12	18	0	0	18	0	0
21	27048534	.	G	A	10	3	13	0	1	14	0	0
21	27053061	.	G	A	2	9	11	0	0	11	0	0
21	27061097	.	C	T	7	6	13	0	0	13	0	0
21	27119735	.	T	A	10	8	18	0	0	18	0	0
21	27121852	.	G	A	4	5	9	0	1	10	0	0
21	27122362	.	G	A	4	9	13	0	2	15	0	0
21	27122596	.	A	G	5	2	7	0	0	7	0	0
21	27122620	.	C	T	5	3	8	0	0	8	0	0
21	27122797	.	A	G	2	4	6	0	1	7	0	0
21	27122908	.	C	G	1	3	4	0	3	7	0	0
21	27122980	.	C	T	0	6	6	0	1	7	0	0
21	27123024	.	T	C	3	0	3	0	11	14	0	0
21	27123089	.	G	A	4	8	12	0	0	12	0	0
21	27185479	.	T	G	3	6	9	0	1	10	0	0
21	27185545	.	A	G	2	3	5	0	2	7	0	0
21	27185840	.	T	G	4	1	5	0	1	6	0	0
21	27185849	.	G	A	4	2	6	0	0	6	0	0
21	27189802	.	G	A	0	7	7	0	9	16	0	0
21	27190038	.	G	C	6	10	16	0	1	17	0	0
21	27193010	.	G	A	1	2	3	0	0	3	0	0
21	27193024	.	C	G	1	2	3	0	0	3	0	0
21	27198405	.	C	T	13	13	26	0	1	27	0	0
21	27198628	.	T	G	3	3	6	0	0	6	0	0
21	27199687	.	T	G	5	3	8	1	24	33	0	0
21	27199893	.	G	A	9	9	18	0	1	19	0	0
21	27204648	.	C	T	8	9	17	0	0	17	0	0
21	27204669	.	T	C	10	0	10	0	10	20	0	0
21	27204713	.	T	A	14	15	29	0	0	29	0	0
21	27204747	.	C	T	17	18	35	0	3	38	0	0
21	27204942	.	G	A	11	9	20	0	1	21	0	0
21	27204957	.	G	A	9	14	23	0	0	23	0	0
21	27205050	.	G	A	10	17	27	0	1	28	0	0
21	27213209	.	A	T	13	19	32	0	2	34	0	0
21	27213287	.	T	A	13	13	26	1	0	27	0	0
21	27221206	.	G	A	11	10	21	0	1	22	0	0
21	27233048	.	C	T	2	5	7	0	0	7	0	0
21	27283782	.	G	A	3	2	5	0	0	5	0	0
21	27283926	.	A	C	1	1	2	0	8	10	0	0
21	27302868	.	A	G	10	0	10	0	14	24	0	0
21	27302943	.	C	A	13	15	28	0	0	28	0	0
21	27305739	.	T	G	17	13	30	0	0	30	0	0
21	27305972	.	A	G	14	0	14	0	15	29	0	0
21	27306203	.	C	T	17	14	31	0	4	35	0	0
21	27308671	.	C	T	18	21	39	0	1	40	0	0
21	27311230	.	C	T	9	13	22	0	0	22	0	0
21	27311450	.	C	T	15	16	31	0	2	33	0	0
21	27312950	.	C	T	19	21	40	0	3	43	0	0
21	27312962	.	G	A	25	19	44	0	1	45	0	0
21	27318274	.	G	T	19	19	38	0	2	40	0	0
21	27327836	.	C	T	1	4	5	0	0	5	0	0
21	27327875	.	A	C	2	2	4	0	0	4	0	0
21	27331984	.	G	A	1	2	3	0	0	3	0	0
21	27332720	.	T	C	1	2	3	0	0	3	0	0
21	27341444	.	C	T	3	4	7	0	0	8	1	0
21	27341453	.	G	A	0	4	4	0	4	8	0	0
21	27343611	.	C	T	4	7	11	0	0	11	0	0
21	27343637	.	T	C	7	6	13	0	0	13	0	0
21	27343814	.	G	A	1	8	9	0	3	12	0	0
21	27344065	.	A	G	3	2	5	0	0	5	0	0
21	27344125	.	T	C	4	3	7	0	0	7	0	0
21	27346260	.	T	C	2	5	7	0	0	7	0	0
21	27347994	.	C	T	5	9	14	0	0	14	0	0
21	27348033	.	A	C	3	6	9	0	1	10	0	0
21	27351316	.	T	C	10	4	14	0	1	15	0	0
21	27354112	.	A	G	15	7	22	0	2	24	0	0
21	27354142	.	C	A	13	8	21	1	1	23	0	0
21	27354147	.	T	C	15	8	23	1	1	25	0	0
21	27354434	.	C	A	5	9	14	0	0	14	0	0
21	27354505	.	T	C	7	6	13	0	0	13	0	0
21	27354602	.	G	T	5	3	8	0	0	8	0	0
21	27375247	.	C	T	8	11	19	0	0	19	0	0
21	27377354	.	C	A	16	13	29	0	6	35	0	0
21	27377815	.	G	A	0	4	4	1	5	10	0	0
21	27378011	.	A	C	11	7	18	0	1	19	0	0
21	27378269	.	T	A	7	8	15	0	0	15	0	0
21	27378388	.	T	G	5	9	14	0	0	14	0	0
21	27378607	.	T	A	9	11	20	0	2	22	0	0
21	27378663	.	G	A	0	5	5	0	11	16	0	0
21	27480718	.	C	T	2	2	4	0	0	4	0	0
21	27482324	.	G	A	2	3	5	0	0	5	0	0
21	27488954	.	A	G	2	3	5	0	0	5	0	0
21	27523049	.	G	A	0	8	8	0	6	14	0	0
21	27523079	.	T	C	11	5	16	0	0	16	0	0
21	27526405	.	C	T	7	5	12	0	0	12	0	0
21	27536026	.	G	A	3	5	8	0	6	14	0	0
21	27549702	.	G	T	10	4	14	0	0	14	0	0
21	27552349	.	A	G	8	0	8	0	13	21	0	0
21	27552667	.	A	G	10	0	10	0	13	23	0	0
21	27552699	.	C	G	13	9	22	0	0	22	0	0
21	27554837	.	T	C	7	8	15	0	1	16	0	0
21	27554858	.	C	T	11	7	18	0	0	18	0	0
21	27554904	.	A	G	11	10	21	0	0	21	0	0
21	27554939	.	G	C	7	10	17	0	0	17	0	0
21	27554986	.	C	T	3	6	9	0	1	10	0	0
21	27555051	.	G	T	8	10	18	0	1	19	0	0
21	27581311	.	G	A	3	2	5	0	0	5	0	0
21	27583508	.	A	G	1	2	3	0	0	3	0	0
21	27586827	.	C	T	0	4	4	0	3	7	0	0
21	27587211	.	T	C	1	0	1	0	2	3	0	0
21	27636438	.	C	T	26	22	48	0	1	49	0	0
21	27636664	.	C	T	1	18	19	5	23	47	0	0
21	27636733	.	C	A	22	16	38	0	0	38	0	0
21	27636739	.	G	A	23	18	41	0	0	41	0	0
21	27636867	.	C	T	11	20	31	0	1	32	0	0
21	27637534	.	C	T	29	14	43	0	0	43	0	0
21	27637912	.	G	A	16	31	47	0	3	50	0	0
21	27637951	.	A	G	23	28	51	0	2	53	0	0
21	27637993	.	G	A	20	28	48	0	5	53	0	0
21	27638260	.	A	G	16	12	28	0	3	31	0	0
21	27657331	.	T	A	16	18	34	0	1	35	0	0
21	27657475	.	A	G	14	22	36	0	1	37	0	0
21	27880547	.	G	A	5	12	17	0	2	19	0	0
21	27880607	.	C	T	1	5	6	0	6	12	0	0
21	27881043	.	G	C	6	1	7	0	3	10	0	0
21	27881474	.	C	T	2	3	5	0	1	6	0	0
21	27881577	.	A	G	3	6	9	0	4	13	0	0
21	27881609	.	C	T	0	10	10	0	5	15	0	0
21	27881729	.	C	T	1	4	5	0	10	15	0	0
21	28051119	.	A	G	5	3	8	0	0	8	0	0
21	28051332	.	C	T	4	5	9	0	1	10	0	0
21	28076575	.	A	G	5	4	9	0	0	9	0	0
21	28076668	.	G	A	4	2	6	0	0	6	0	0
21	28076770	.	T	C	2	3	5	0	0	5	0	0
21	28078711	.	G	T	1	5	6	0	0	6	0	0
21	28493796	.	C	T	1	2	3	0	0	3	0	0
21	28496276	.	T	C	23	21	44	0	0	44	0	0
21	28496332	.	C	T	34	33	67	0	4	71	0	0
21	28500561	.	C	T	41	27	68	0	1	69	0	0
21	28502369	.	G	A	10	6	16	0	0	16	0	0
21	28510226	.	C	T	17	11	28	0	1	29	0	0
21	28510258	.	A	G	16	11	27	0	1	28	0	0
21	28512800	.	G	T	9	10	19	0	0	19	0	0
21	28555214	.	G	T	5	3	8	0	0	8	0	0
21	28567343	.	G	A	4	2	6	0	0	6	0	0
21	28724148	.	C	T	8	11	19	0	0	19	0	0
21	28863254	.	A	G	5	4	9	0	2	11	0	0
21	28863810	.	A	G	16	6	22	0	0	22	0	0
21	28864246	.	G	A	12	10	22	0	1	23	0	0
21	28864475	.	C	T	1	26	27	1	18	46	0	0
21	28900913	.	T	C	1	0	1	0	1	7	5	0
21	28901022	.	C	A	0	12	12	0	18	30	0	0
21	28901037	.	G	A	20	12	32	0	1	33	0	0
21	28901078	.	T	C	11	14	25	0	1	26	0	0
21	28920111	.	C	T	1	7	8	0	10	18	0	0
21	29039214	.	C	A	16	12	28	0	1	29	0	0
21	29059819	.	G	A	1	17	18	0	11	29	0	0
21	29062843	.	G	A	4	20	24	0	18	42	0	0
21	29064692	.	T	C	20	21	41	0	1	42	0	0
21	29074438	.	C	G	26	23	49	0	1	50	0	0
21	29074439	.	T	C	25	22	47	0	3	50	0	0
21	29074492	.	A	T	21	24	45	0	3	48	0	0
21	29075233	.	T	G	24	4	28	0	0	28	0	0
21	29075234	.	T	G	21	7	28	0	0	28	0	0
21	29075332	.	G	T	19	22	41	0	1	42	0	0
21	29090879	.	C	T	1	6	7	0	13	20	0	0
21	29090935	.	C	T	1	4	5	0	3	8	0	0
21	29091012	.	C	T	29	7	36	0	1	37	0	0
21	29091053	.	T	C	26	16	42	0	0	42	0	0
21	29091054	.	G	A	25	15	40	0	2	42	0	0
21	29091362	.	C	G	18	20	38	0	4	42	0	0
21	29094676	.	T	C	16	1	17	1	22	40	0	0
21	29096390	.	A	T	14	18	32	0	4	36	0	0
21	29096709	.	T	G	20	15	35	0	3	38	0	0
21	29101744	.	G	A	1	3	4	0	0	4	0	0
21	29228027	.	A	G	2	2	4	0	0	4	0	0
21	29228144	.	A	C	3	2	5	0	0	5	0	0
21	29247636	.	C	T	5	2	7	0	0	7	0	0
21	30010042	.	T	C	8	3	11	0	0	11	0	0
21	30010146	.	C	T	9	3	12	0	1	13	0	0
21	30010299	.	C	A	4	8	12	0	0	12	0	0
21	30010332	.	G	A	0	4	4	0	5	9	0	0
21	30010462	.	C	T	6	4	10	0	0	10	0	0
21	30014066	.	C	T	5	6	11	0	0	11	0	0
21	30014318	.	C	T	6	9	15	0	0	15	0	0
21	30018856	.	T	C	12	7	19	0	0	19	0	0
21	30019225	.	C	T	8	6	14	0	0	14	0	0
21	30019250	.	C	T	7	7	14	0	0	14	0	0
21	30019385	.	C	G	4	8	12	0	0	12	0	0
21	30019586	.	T	A	2	2	4	0	0	4	0	0
21	30019930	.	C	A	3	4	7	0	0	7	0	0
21	30019953	.	A	T	1	2	3	0	2	5	0	0
21	30019992	.	T	C	5	1	6	0	3	9	0	0
21	30020062	.	T	A	6	5	11	0	0	11	0	0
21	30020097	.	A	G	7	8	15	0	0	15	0	0
21	30020123	.	T	G	9	7	16	0	3	19	0	0
21	30025205	.	T	C	7	0	7	0	10	17	0	0
21	30025514	.	G	A	4	9	13	0	0	13	0	0
21	30026162	.	C	T	0	9	9	0	6	15	0	0
21	30031126	.	G	A	5	6	11	0	0	11	0	0
21	30031316	.	G	A	7	4	11	0	4	15	0	0
21	30031987	.	G	A	9	7	16	0	0	16	0	0
21	30032045	.	C	T	6	12	18	0	0	18	0	0
21	30032513	.	A	T	2	4	6	0	0	6	0	0
21	30116508	.	G	A	8	12	20	0	0	20	0	0
21	30169705	.	T	C	4	1	5	0	3	8	0	0
21	30181216	.	G	A	9	5	14	0	1	15	0	0
21	30181662	.	T	A	7	7	14	0	0	14	0	0
21	30195389	.	C	T	7	11	18	0	2	20	0	0
21	30201092	.	G	A	16	9	25	0	0	25	0	0
21	30201235	.	C	T	9	6	15	0	0	15	0	0
21	30206393	.	A	T	5	9	14	0	1	15	0	0
21	30208255	.	G	A	1	7	8	0	7	15	0	0
21	30232112	.	T	G	18	10	28	0	0	28	0	0
21	30232187	.	C	T	10	16	26	0	2	28	0	0
21	30232212	.	C	T	16	14	30	0	0	30	0	0
21	30232304	.	C	T	19	10	29	0	1	30	0	0
21	30232307	.	C	T	21	10	31	0	0	31	0	0
21	30236791	.	C	A	2	3	5	0	0	5	0	0
21	30239975	.	A	C	11	15	26	0	0	26	0	0
21	30240378	.	C	A	16	13	29	0	1	30	0	0
21	30240400	.	T	G	14	15	29	0	2	31	0	0
21	30244739	.	G	T	14	14	28	0	4	32	0	0
21	30246684	.	A	G	14	11	25	0	0	25	0	0
21	30253692	.	A	G	12	15	27	1	1	29	0	0
21	30253884	.	A	G	8	8	16	0	0	16	0	0
21	30253942	.	A	C	6	12	18	0	0	18	0	0
21	30253954	.	A	C	5	14	19	0	0	19	0	0
21	30253982	.	T	A	15	7	22	0	0	22	0	0
21	30260961	.	C	T	1	6	7	0	11	18	0	0
21	30273366	.	C	A	12	4	16	0	0	16	0	0
21	30299416	.	T	C	14	22	36	0	2	38	0	0
21	30299561	.	T	C	13	15	28	0	0	28	0	0
21	30299679	.	A	T	5	3	8	0	1	9	0	0
21	30299735	.	C	T	6	5	11	0	0	11	0	0
21	30692609	.	A	G	7	2	9	0	0	9	0	0
21	30693348	.	A	G	4	7	11	0	0	11	0	0
21	31151144	.	G	T	0	3	3	0	3	6	0	0
21	31151264	.	A	C	10	4	14	0	0	14	0	0
21	31160054	.	T	C	3	5	8	0	0	8	0	0
21	31167452	.	T	A	12	6	18	0	0	18	0	0
21	31167528	.	G	T	5	8	13	0	1	14	0	0
21	31176240	.	A	G	6	14	20	0	0	20	0	0
21	31183375	.	G	A	11	14	25	0	1	26	0	0
21	31183501	.	T	C	15	16	31	0	1	32	0	0
21	31183734	.	T	C	10	7	17	0	1	18	0	0
21	31183837	.	A	T	11	9	20	0	1	21	0	0
21	31233103	.	T	A	10	6	16	0	0	16	0	0
21	31233389	.	A	G	5	3	8	0	0	8	0	0
21	31233579	.	G	C	9	6	15	0	0	15	0	0
21	31233657	.	G	A	13	15	28	0	3	31	0	0
21	31237428	.	A	G	13	16	29	0	1	30	0	0
21	31237941	.	A	G	6	10	16	0	2	18	0	0
21	31238439	.	T	C	11	4	15	0	0	15	0	0
21	31241015	.	T	C	8	9	17	0	1	18	0	0
21	31241079	.	G	C	15	8	23	0	0	23	0	0
21	31271962	.	A	G	2	6	8	0	0	8	0	0
21	31971127	.	T	C	5	2	7	0	0	7	0	0
21	32281076	.	G	A	7	7	14	0	0	14	0	0
21	32281122	.	G	A	13	7	20	0	0	20	0	0
21	32281155	.	G	A	10	10	20	0	0	20	0	0
21	32281680	.	C	T	17	6	23	0	2	25	0	0
21	32283519	.	G	A	8	14	22	0	0	22	0	0
21	32284398	.	A	G	5	8	13	0	1	14	0	0
21	32285080	.	C	T	4	4	8	0	0	8	0	0
21	32285135	.	T	C	1	0	1	0	8	9	0	0
21	32285161	.	A	G	1	7	8	0	0	8	0	0
21	32342458	.	G	A	3	2	5	0	1	6	0	0
21	32343230	.	C	A	11	10	21	0	1	22	0	0
21	32343248	.	C	A	15	10	25	0	1	26	0	0
21	32343316	.	T	A	17	7	24	0	2	26	0	0
21	32343453	.	C	T	12	14	26	0	0	26	0	0
21	32343577	.	T	C	12	7	19	0	0	19	0	0
21	32343649	.	C	A	12	8	20	0	0	20	0	0
21	32343721	.	T	G	10	0	10	0	6	16	0	0
21	32344021	.	C	A	10	9	19	0	0	19	0	0
21	32345162	.	T	C	10	13	23	0	0	23	0	0
21	32345318	.	G	A	2	6	8	0	7	15	0	0
21	32345499	.	A	G	12	8	20	0	0	20	0	0
21	32345607	.	C	T	10	10	20	0	0	20	0	0
21	32345724	.	A	G	9	5	14	0	0	14	0	0
21	32345749	.	A	G	7	7	14	0	0	14	0	0
21	32345774	.	A	T	5	12	17	0	0	17	0	0
21	32345827	.	C	A	6	5	11	0	0	11	0	0
21	32345899	.	G	A	0	2	2	0	4	6	0	0
21	32346021	.	A	C	1	4	5	0	1	6	0	0
21	32346273	.	G	A	17	15	32	0	3	35	0	0
21	32346603	.	G	C	11	19	30	0	1	31	0	0
21	32346630	.	T	C	14	17	31	0	2	33	0	0
21	32346674	.	T	A	19	13	32	0	0	32	0	0
21	32346689	.	A	G	16	13	29	0	1	30	0	0
21	32346799	.	G	A	13	16	29	0	1	30	0	0
21	32346800	.	T	A	14	14	28	0	3	31	0	0
21	32346899	.	A	G	24	9	33	0	0	33	0	0
21	32346901	.	A	G	21	9	30	0	2	32	0	0
21	32347134	.	T	A	14	24	38	1	0	39	0	0
21	32347569	.	G	T	19	13	32	0	1	33	0	0
21	32347855	.	T	C	14	17	31	0	0	31	0	0
21	32347966	.	A	C	7	1	8	0	21	29	0	0
21	32348230	.	A	T	7	15	22	0	1	23	0	0
21	32348449	.	G	A	10	4	14	0	1	15	0	0
21	32348484	.	G	A	7	4	11	0	1	12	0	0
21	32348523	.	G	A	10	6	16	0	1	17	0	0
21	32348600	.	C	T	17	4	21	0	0	21	0	0
21	32348667	.	G	C	14	9	23	0	1	24	0	0
21	32348919	.	C	T	2	9	11	0	14	25	0	0
21	32349000	.	G	A	13	18	31	0	1	32	0	0
21	32349023	.	G	C	15	20	35	0	0	35	0	0
21	32349055	.	C	T	14	15	29	0	1	30	0	0
21	32352459	.	C	G	17	11	28	0	0	28	0	0
21	32353049	.	G	A	11	8	19	0	0	19	0	0
21	32354980	.	A	G	5	10	15	0	0	15	0	0
21	32374460	.	A	T	5	8	13	0	1	14	0	0
21	32457252	.	A	G	2	5	7	0	0	7	0	0
21	32457785	.	T	C	9	12	21	0	0	21	0	0
21	32457923	.	C	A	20	18	38	0	1	39	0	0
21	32457931	.	T	G	20	13	33	0	1	34	0	0
21	32457983	.	G	A	12	13	25	0	1	26	0	0
21	32458261	.	A	G	21	24	45	0	0	45	0	0
21	32458315	.	T	A	16	23	39	0	1	40	0	0
21	32460912	.	A	G	27	24	51	0	2	53	0	0
21	32466140	.	G	C	15	17	32	0	1	33	0	0
21	32467660	.	A	G	19	12	31	0	1	32	0	0
21	32467724	.	T	C	14	13	27	0	2	29	0	0
21	32476760	.	A	G	24	30	54	0	2	56	0	0
21	32477584	.	T	C	23	24	47	0	1	48	0	0
21	32477967	.	C	T	26	25	51	0	3	54	0	0
21	32477987	.	A	T	25	23	48	0	9	57	0	0
21	32478227	.	G	T	29	26	55	1	3	59	0	0
21	32482797	.	C	T	29	23	52	0	3	55	0	0
21	32482854	.	T	C	27	1	28	1	19	48	0	0
21	32486997	.	A	T	2	3	5	0	1	6	0	0
21	32757787	.	C	A	5	3	8	0	0	8	0	0
21	32758254	.	G	A	11	9	20	0	0	20	0	0
21	32758351	.	C	T	6	10	16	0	2	18	0	0
21	32758584	.	G	A	10	14	24	0	0	24	0	0
21	32759421	.	C	T	16	8	24	0	0	24	0	0
21	32766389	.	G	A	12	8	20	0	0	20	0	0
21	32772450	.	G	A	5	3	8	0	2	10	0	0
21	32821159	.	G	A	5	2	7	0	0	7	0	0
21	33058940	.	G	C	11	9	20	0	0	20	0	0
21	33066214	.	T	G	11	23	34	0	2	36	0	0
21	33069896	.	A	G	12	12	24	0	1	25	0	0
21	33211506	.	T	A	14	9	23	0	2	25	0	0
21	33211568	.	C	T	8	11	19	1	1	21	0	0
21	33211664	.	T	G	7	4	11	0	3	14	0	0
21	33211720	.	A	T	9	6	15	1	2	18	0	0
21	33211809	.	A	T	14	11	25	0	2	27	0	0
21	33213315	.	C	T	9	10	19	0	3	22	0	0
21	33213384	.	G	A	6	5	11	0	1	12	0	0
21	33218312	.	T	C	9	4	13	0	0	13	0	0
21	33218405	.	G	A	6	8	14	0	0	14	0	0
21	33447251	.	A	G	17	10	27	0	1	28	0	0
21	33463486	.	A	G	4	5	9	0	0	9	0	0
21	33995223	.	G	A	3	2	5	0	0	5	0	0
21	34001982	.	C	T	14	11	25	0	1	26	0	0
21	34002041	.	C	A	14	11	25	0	0	25	0	0
21	34002154	.	A	C	6	15	21	0	0	21	0	0
21	34002155	.	A	T	4	15	19	0	1	20	0	0
21	34002333	.	T	C	5	7	12	0	0	12	0	0
21	34002455	.	G	A	10	9	19	0	1	20	0	0
21	34002507	.	A	G	6	19	25	0	0	25	0	0
21	34019822	.	A	G	5	2	7	0	0	7	0	0
21	34031232	.	G	A	4	7	11	0	1	12	0	0
21	34057611	.	T	G	3	4	7	0	1	8	0	0
21	34059079	.	A	C	3	5	8	0	1	9	0	0
21	34074618	.	A	G	5	8	13	0	0	13	0	0
21	34074684	.	G	A	7	7	14	0	0	14	0	0
21	34074712	.	T	C	7	11	18	0	0	18	0	0
21	34114410	.	G	A	8	5	13	0	0	13	0	0
21	34128660	.	A	G	14	20	34	0	1	35	0	0
21	34129007	.	C	G	24	0	24	0	20	44	0	0
21	34129073	.	G	C	16	23	39	0	2	41	0	0
21	34129195	.	G	T	15	20	35	0	1	36	0	0
21	34129279	.	A	G	9	23	32	0	2	34	0	0
21	34129401	.	T	A	5	3	8	0	0	8	0	0
21	34129629	.	A	G	4	3	7	0	0	7	0	0
21	34195790	.	T	C	2	2	4	0	1	5	0	0
21	34199704	.	T	C	1	5	6	0	0	6	0	0
21	34211093	.	G	A	1	6	7	0	12	19	0	0
21	34364472	.	T	A	10	11	21	0	4	25	0	0
21	34364595	.	G	A	10	5	15	0	0	15	0	0
21	34365167	.	T	A	14	12	26	0	1	27	0	0
21	34391104	.	C	T	10	10	20	0	3	23	0	0
21	34391155	.	T	C	9	10	19	0	0	19	0	0
21	34392843	.	C	T	10	6	16	0	0	16	0	0
21	34424086	.	C	T	0	6	6	0	8	14	0	0
21	34424116	.	A	G	5	6	11	0	0	11	0	0
21	34428080	.	G	A	9	11	20	0	0	20	0	0
21	34430544	.	A	G	5	4	9	0	0	9	0	0
21	35328124	.	T	C	4	2	6	0	0	6	0	0
21	36407608	.	A	G	1	4	5	0	0	5	0	0
21	36598347	.	T	G	2	2	4	0	1	5	0	0
21	37107035	.	T	A	21	20	41	0	2	43	0	0
21	37107307	.	G	A	9	7	16	0	0	16	0	0
21	37107432	.	A	T	9	5	14	0	2	16	0	0
21	37107614	.	T	C	7	6	13	0	1	14	0	0
21	37107861	.	T	C	8	11	19	0	1	20	0	0
21	37108022	.	A	G	11	15	26	1	0	27	0	0
21	37108204	.	A	T	14	16	30	0	0	30	0	0
21	37185420	.	T	A	0	4	4	0	0	4	0	0
21	37397952	.	A	C	1	0	1	0	8	9	0	0
21	37397958	.	T	G	3	0	3	0	4	7	0	0
21	37637792	.	G	A	8	11	19	0	3	22	0	0
21	37637794	.	A	T	7	12	19	0	3	22	0	0
21	37640005	.	G	A	10	12	22	0	1	23	0	0
21	37686849	.	C	T	7	8	15	1	0	16	0	0
21	37686850	.	A	G	7	8	15	1	0	16	0	0
21	37686913	.	G	T	7	3	10	8	0	18	0	0
21	37687042	.	T	C	2	0	2	2	4	8	0	0
21	37687099	.	C	T	6	5	11	0	1	12	0	0
21	37687523	.	G	A	8	13	21	1	2	24	0	0
21	37687590	.	C	T	6	3	9	0	1	10	0	0
21	37687729	.	C	T	5	11	16	1	1	18	0	0
21	37689192	.	T	G	2	6	8	0	0	8	0	0
21	37690002	.	T	C	2	4	6	0	0	6	0	0
21	37690468	.	T	C	3	5	8	0	0	8	0	0
21	37693648	.	T	A	4	3	7	0	0	7	0	0
21	37703499	.	G	A	6	5	11	0	0	11	0	0
21	37703502	.	C	T	7	4	11	0	1	12	0	0
21	37733096	.	C	T	2	5	7	0	0	7	0	0
21	37733199	.	G	A	5	6	11	0	0	11	0	0
21	37788147	.	G	A	1	5	6	0	0	6	0	0
21	37822681	.	G	A	4	5	9	0	0	9	0	0
21	38013631	.	T	C	1	6	7	0	0	7	0	0
21	38587378	.	T	C	10	8	18	0	1	19	0	0
21	38647131	.	G	A	1	11	12	6	2	20	0	0
21	38861810	.	A	G	2	0	2	1	2	5	0	0
21	39453940	.	G	A	4	46	50	0	9	59	0	0
21	39506072	.	T	C	5	2	7	0	1	8	0	0
21	39511323	.	A	G	1	0	1	2	1	4	0	0
21	40045441	.	T	C	2	5	7	0	0	7	0	0
21	40045569	.	G	T	6	9	15	0	1	16	0	0
21	40045665	.	G	A	16	15	31	0	2	33	0	0
21	40045701	.	G	A	17	13	30	0	0	30	0	0
21	40045754	.	G	A	11	7	18	0	1	19	0	0
21	40048981	.	C	A	1	9	10	0	10	20	0	0
21	40049524	.	A	G	7	4	11	0	2	13	0	0
21	40049556	.	T	G	4	6	10	0	0	10	0	0
21	40049606	.	T	G	1	4	5	0	0	5	0	0
21	40355063	.	A	C	8	7	15	0	0	15	0	0
21	40355102	.	G	A	9	6	15	0	0	15	0	0
21	40355539	.	G	T	13	12	25	0	0	25	0	0
21	40355710	.	A	T	14	5	19	0	0	19	0	0
21	40355764	.	C	T	10	5	15	0	0	15	0	0
21	40355968	.	T	A	8	10	18	0	1	19	0	0
21	40364758	.	C	A	11	12	23	0	0	23	0	0
21	40365356	.	G	T	5	5	10	0	0	10	0	0
21	40368568	.	A	G	2	5	7	0	0	7	0	0
21	40369108	.	C	T	0	3	3	0	6	9	0	0
21	40373048	.	G	T	4	3	7	0	0	7	0	0
21	40373049	.	G	T	3	2	5	0	1	6	0	0
21	40373086	.	A	T	4	1	5	0	2	7	0	0
21	40373137	.	C	T	1	7	8	0	3	11	0	0
21	40377861	.	A	G	1	4	5	0	1	6	0	0
21	40377895	.	A	G	3	4	7	0	0	7	0	0
21	40377904	.	G	A	4	3	7	0	0	7	0	0
21	40381967	.	C	T	5	2	7	0	0	7	0	0
21	40382278	.	C	T	0	6	6	0	1	7	0	0
21	40382300	.	A	G	6	2	8	0	0	8	0	0
21	40386061	.	C	T	2	2	4	0	0	4	0	0
21	40391928	.	G	A	1	2	3	0	0	3	0	0
21	40402621	.	G	A	3	2	5	0	0	5	0	0
21	40402659	.	A	G	5	7	12	0	0	12	0	0
21	40402864	.	C	T	0	6	6	0	15	21	0	0
21	40403423	.	A	G	11	7	18	0	0	18	0	0
21	40403465	.	G	A	14	9	23	0	1	24	0	0
21	40403581	.	G	C	14	9	23	0	0	23	0	0
21	40406796	.	C	A	5	5	10	0	0	10	0	0
21	40410983	.	T	A	5	10	15	0	0	15	0	0
21	40411034	.	G	A	9	7	16	0	0	16	0	0
21	40411505	.	G	T	2	2	4	0	0	4	0	0
21	40455087	.	G	T	4	3	7	0	0	7	0	0
21	40461930	.	T	C	2	3	5	0	1	6	0	0
21	40466711	.	G	A	1	2	3	0	3	6	0	0
21	40466893	.	C	T	5	6	11	0	0	11	0	0
21	40467039	.	C	T	7	9	16	0	0	16	0	0
21	40467126	.	G	A	0	4	4	0	8	12	0	0
21	40474875	.	G	A	5	8	13	0	3	16	0	0
21	40475127	.	C	G	4	0	4	0	7	11	0	0
21	40475427	.	C	T	2	10	12	1	1	14	0	0
21	40475563	.	C	G	9	10	19	0	0	19	0	0
21	40475579	.	G	T	10	8	18	0	0	18	0	0
21	40528986	.	C	T	20	17	37	0	2	39	0	0
21	40531316	.	C	T	13	11	24	0	1	25	0	0
21	40531615	.	G	A	13	11	24	0	2	26	0	0
21	40531971	.	A	T	7	7	14	0	0	14	0	0
21	40531993	.	G	A	8	3	11	0	0	11	0	0
21	40532147	.	A	G	6	7	13	0	0	13	0	0
21	40532204	.	A	G	3	9	12	0	0	12	0	0
21	40532584	.	T	G	3	9	12	0	1	13	0	0
21	40532665	.	T	C	7	6	13	0	1	14	0	0
21	40532848	.	G	A	14	9	23	0	1	25	1	0
21	40532891	.	A	G	5	7	12	0	0	12	0	0
21	40532931	.	G	C	4	6	10	0	0	10	0	0
21	40533039	.	T	C	5	10	15	0	0	15	0	0
21	40533165	.	A	G	9	9	18	0	1	19	0	0
21	40537149	.	C	T	9	6	15	0	3	18	0	0
21	40537152	.	G	A	10	9	19	0	1	20	0	0
21	40537188	.	A	G	8	13	21	0	1	22	0	0
21	40546922	.	T	C	10	7	17	0	0	17	0	0
21	40547729	.	G	A	9	13	22	0	0	22	0	0
21	40553356	.	G	T	5	9	14	0	0	14	0	0
21	40553365	.	C	T	5	8	13	0	0	13	0	0
21	40553667	.	C	G	4	6	10	0	1	11	0	0
21	40562600	.	G	A	4	5	9	0	0	9	0	0
21	40579746	.	C	A	1	5	6	0	0	6	0	0
21	40685948	.	A	G	4	0	4	0	10	14	0	0
21	40685964	.	A	C	6	11	17	0	0	17	0	0
21	40686109	.	G	A	9	13	22	0	0	22	0	0
21	40714691	.	C	T	27	17	44	0	0	44	0	0
21	40715622	.	A	G	30	31	61	0	0	61	0	0
21	40715730	.	T	C	25	28	53	0	1	54	0	0
21	40715808	.	A	G	24	17	41	0	3	44	0	0
21	40717637	.	G	C	4	6	10	0	1	11	0	0
21	40731482	.	A	G	3	1	4	0	1	5	0	0
21	40757528	.	G	A	1	3	4	0	0	4	0	0
21	40936544	.	G	A	6	9	15	0	1	16	0	0
21	40938322	.	A	G	4	5	9	0	1	10	0	0
21	40944757	.	G	A	0	3	3	0	1	4	0	0
21	40959280	.	A	T	3	4	7	0	0	7	0	0
21	40959490	.	T	C	1	2	3	0	1	4	0	0
21	41028902	.	A	G	4	3	7	0	0	7	0	0
21	41029033	.	A	C	3	2	5	0	0	5	0	0
21	41029134	.	A	T	3	5	8	1	0	9	0	0
21	41029328	.	C	G	1	2	3	0	0	3	0	0
21	41034863	.	A	G	2	3	5	0	0	5	0	0
21	41039914	.	T	G	3	3	6	0	0	6	0	0
21	41040346	.	T	C	1	0	1	0	4	5	0	0
21	41046647	.	T	A	7	4	11	0	2	13	0	0
21	41046745	.	T	A	7	2	9	0	1	10	0	0
21	41046746	.	G	C	8	2	10	0	0	10	0	0
21	41048725	.	G	A	0	2	2	0	1	3	0	0
21	41049005	.	G	A	1	5	6	0	1	7	0	0
21	41256821	.	C	T	1	5	6	0	8	14	0	0
21	41257136	.	A	G	33	21	54	1	0	55	0	0
21	41257157	.	C	G	29	19	48	0	0	48	0	0
21	41257228	.	T	G	35	25	60	0	1	61	0	0
21	41257256	.	T	C	27	27	54	0	4	58	0	0
21	41257357	.	G	A	32	35	67	0	0	67	0	0
21	41257374	.	C	T	36	36	72	0	1	73	0	0
21	41257599	.	T	A	37	27	64	0	0	64	0	0
21	41293435	.	G	A	28	32	60	0	3	63	0	0
21	41305128	.	G	T	30	20	50	0	3	53	0	0
21	41305269	.	C	T	19	20	39	0	4	43	0	0
21	41305271	.	C	T	25	18	43	0	1	44	0	0
21	41311009	.	C	A	5	3	8	0	0	8	0	0
21	41311605	.	A	G	22	12	34	0	2	36	0	0
21	41311922	.	G	A	9	19	28	0	0	28	0	0
21	41312058	.	A	T	12	18	30	0	2	32	0	0
21	41599060	.	T	C	9	19	28	3	0	31	0	0
21	41599147	.	G	A	16	5	21	1	0	22	0	0
21	41599208	.	T	C	11	7	18	0	0	18	0	0
21	41600346	.	T	C	2	3	5	0	0	5	0	0
21	42046969	.	G	A	14	13	27	42	1	71	1	0
21	42777611	.	T	A	1	2	3	0	1	4	0	0
21	42777772	.	T	C	1	1	2	0	1	3	0	0
21	42778937	.	G	A	7	4	11	0	0	11	0	0
21	42779096	.	C	T	3	3	6	0	0	6	0	0
21	42779684	.	G	T	1	2	3	0	0	3	0	0
21	42971463	.	T	C	31	15	46	0	11	57	0	0
21	43363939	.	A	G	4	5	9	0	1	10	0	0
21	43363957	.	G	C	4	3	7	0	0	7	0	0
21	43366064	.	C	T	3	2	5	0	1	6	0	0
21	43461082	.	T	C	6	3	9	0	2	11	0	0
21	43461123	.	T	C	11	7	18	0	0	18	0	0
21	43476276	.	T	C	17	5	22	0	0	22	0	0
21	43477593	.	T	C	17	6	23	0	4	27	0	0
21	43477856	.	T	C	11	8	19	0	0	19	0	0
21	43477858	.	T	C	10	9	19	0	0	19	0	0
21	43477894	.	T	C	16	5	21	0	0	21	0	0
21	43506238	.	T	A	3	3	6	0	0	6	0	0
21	43506245	.	T	A	1	2	3	0	1	4	0	0
21	43506620	.	A	G	3	5	8	1	0	9	0	0
21	43506980	.	G	A	1	2	3	0	0	3	0	0
21	43507055	.	A	G	6	3	9	0	0	9	0	0
21	43507058	.	C	T	5	4	9	0	0	9	0	0
21	43507114	.	T	G	3	4	7	0	1	8	0	0
21	43507142	.	A	G	2	0	2	0	5	7	0	0
21	43507204	.	T	C	4	3	7	0	0	7	0	0
21	43507768	.	C	A	3	2	5	0	0	5	0	0
21	43507954	.	A	G	4	2	6	0	0	6	0	0
21	43508293	.	A	T	2	2	4	0	1	5	0	0
21	43508297	.	C	T	4	2	6	0	0	6	0	0
21	43508356	.	C	T	5	3	8	0	0	8	0	0
21	43515692	.	C	T	0	5	5	0	1	6	0	0
21	43515698	.	C	T	0	5	5	0	1	6	0	0
21	43515778	.	A	T	1	6	7	0	0	7	0	0
21	43524271	.	G	A	8	10	18	0	1	19	0	0
21	43524778	.	T	C	8	13	21	0	1	22	0	0
21	43525429	.	T	C	9	3	12	0	0	12	0	0
21	43525522	.	A	G	4	3	7	0	0	7	0	0
21	43525618	.	T	G	9	7	16	0	1	17	0	0
21	43525861	.	G	A	4	5	9	0	0	9	0	0
21	43525909	.	C	T	0	4	4	0	3	7	0	0
21	43525978	.	G	A	2	3	5	0	0	5	0	0
21	43536532	.	A	G	8	7	15	0	0	15	0	0
21	43536592	.	G	A	16	7	23	0	0	23	0	0
21	43537073	.	C	T	3	9	12	0	8	20	0	0
21	43537082	.	G	A	10	8	18	0	0	18	0	0
21	43539461	.	G	C	9	0	9	0	11	20	0	0
21	43540090	.	G	T	9	4	13	0	0	13	0	0
21	43540358	.	T	C	5	1	6	0	1	7	0	0
21	43562237	.	G	T	1	2	3	0	0	3	0	0
21	43562534	.	C	T	4	2	6	0	0	6	0	0
21	43581478	.	A	G	12	12	24	0	3	27	0	0
21	43581505	.	T	C	16	0	16	0	7	23	0	0
21	43581606	.	A	G	18	15	33	0	1	34	0	0
21	43584745	.	G	A	16	19	35	0	2	37	0	0
21	43584822	.	A	G	19	22	41	1	2	44	0	0
21	43586774	.	C	T	2	6	8	0	19	27	0	0
21	43588112	.	T	C	7	12	19	0	1	20	0	0
21	43588136	.	G	C	8	0	8	0	11	19	0	0
21	43595318	.	G	A	12	12	24	0	0	24	0	0
21	43595384	.	C	T	12	9	21	0	0	21	0	0
21	43606392	.	T	A	11	11	22	0	2	24	0	0
21	43688806	.	C	T	5	2	7	0	0	7	0	0
21	43695580	.	T	C	2	4	6	0	0	6	0	0
21	43704161	.	T	C	6	8	14	0	0	14	0	0
21	43705848	.	G	A	1	2	3	0	6	9	0	0
21	43705866	.	G	A	7	4	11	0	0	11	0	0
21	43705893	.	C	T	5	6	11	0	0	11	0	0
21	43709743	.	T	C	3	3	6	0	1	7	0	0
21	43710834	.	A	C	4	6	10	0	0	10	0	0
21	43710842	.	A	G	5	0	5	0	5	10	0	0
21	43713566	.	A	G	7	0	7	0	6	13	0	0
21	43886134	.	T	G	3	4	7	1	0	8	0	0
21	43891376	.	A	T	1	2	3	0	0	3	0	0
21	43897365	.	C	T	27	27	54	0	2	56	0	0
21	43906670	.	G	A	15	29	44	0	4	48	0	0
21	43920541	.	A	G	13	20	33	0	2	35	0	0
21	43926773	.	C	A	16	12	28	0	0	28	0	0
21	43952949	.	G	T	8	7	15	0	2	17	0	0
21	44005548	.	G	A	4	2	6	0	0	6	0	0
21	44005583	.	G	A	9	12	21	0	2	23	0	0
21	44005587	.	A	C	11	13	24	0	1	25	0	0
21	44005637	.	T	G	21	11	32	0	1	33	0	0
21	44019151	.	C	T	15	13	28	1	2	31	0	0
21	44022008	.	T	A	18	25	43	0	4	48	1	0
21	44022014	.	A	G	19	27	46	0	1	47	0	0
21	44025907	.	A	G	16	23	39	0	1	40	0	0
21	44027975	.	A	T	21	26	47	0	3	50	0	0
21	44028691	.	G	A	24	28	52	0	2	54	0	0
21	44028755	.	C	A	15	26	41	0	0	41	0	0
21	44031139	.	T	C	30	22	52	0	0	52	0	0
21	44031145	.	T	A	29	19	48	0	1	49	0	0
21	44036872	.	A	T	1	8	9	0	0	9	0	0
21	44036912	.	A	C	5	7	12	0	1	13	0	0
21	44036984	.	T	A	6	12	18	0	2	21	1	0
21	44037011	.	T	A	6	13	19	0	3	22	0	0
21	44037040	.	G	A	1	6	7	0	3	10	0	0
21	44037046	.	A	G	6	1	7	0	6	13	0	0
21	44553806	.	A	G	8	6	14	0	0	14	0	0
21	44556241	.	C	G	1	3	4	0	0	4	0	0
21	44558697	.	T	C	1	5	6	0	0	6	0	0
21	44558898	.	T	C	12	0	12	0	8	20	0	0
21	44559095	.	C	T	24	23	47	0	2	49	0	0
21	44561900	.	A	G	19	25	44	0	2	46	0	0
21	44563129	.	T	A	28	27	55	0	4	59	0	0
21	44581845	.	A	T	5	5	10	0	0	10	0	0
21	44618620	.	G	A	0	3	3	0	2	5	0	0
21	44687941	.	A	G	14	0	14	0	15	29	0	0
21	44687949	.	T	C	14	12	26	0	0	26	0	0
21	44688711	.	G	A	15	10	25	0	1	26	0	0
21	44689277	.	A	T	12	11	23	0	0	23	0	0
21	44689476	.	C	T	14	13	27	0	0	27	0	0
21	44689503	.	A	T	19	13	32	0	0	32	0	0
21	44689528	.	A	G	20	0	20	0	12	32	0	0
21	44689655	.	C	T	20	6	26	0	1	27	0	0
21	44690520	.	A	G	11	0	11	0	13	24	0	0
21	44777084	.	G	A	1	3	4	0	2	6	0	0
21	44777617	.	G	T	1	7	8	0	6	14	0	0
21	44777713	.	T	C	12	4	16	0	0	16	0	0
21	44781745	.	A	G	14	12	26	0	2	28	0	0
21	44784156	.	A	G	9	0	9	0	12	21	0	0
21	44784223	.	A	G	10	0	10	0	6	16	0	0
21	44784493	.	G	T	7	9	16	0	1	17	0	0
21	44784589	.	T	C	5	8	13	0	0	13	0	0
21	44784663	.	C	T	5	4	9	0	0	9	0	0
21	45017302	.	C	A	4	3	7	0	0	7	0	0
21	45017303	.	G	A	0	3	3	0	4	7	0	0
21	45043527	.	G	T	5	3	8	0	3	11	0	0
21	45043548	.	G	A	5	2	7	0	2	9	0	0
21	45043590	.	T	C	5	2	7	0	4	11	0	0
21	45043611	.	A	G	5	4	9	0	2	11	0	0
21	45052584	.	G	A	13	8	21	0	1	22	0	0
21	45054887	.	G	A	10	5	15	0	0	15	0	0
21	45058331	.	T	G	11	6	17	0	1	18	0	0
21	45059466	.	T	A	6	5	11	0	0	11	0	0
21	45061877	.	G	T	2	7	9	0	0	9	0	0
21	45061889	.	G	A	5	3	8	0	0	8	0	0
21	45068223	.	T	C	4	4	8	0	0	8	0	0
21	45068478	.	A	G	3	3	6	0	0	6	0	0
21	45114489	.	G	T	0	2	2	0	3	5	0	0
21	45117537	.	C	T	8	6	14	0	0	14	0	0
21	45182311	.	A	T	3	6	9	0	0	9	0	0
21	45182345	.	A	G	2	5	7	0	0	7	0	0
21	45182566	.	C	T	7	9	16	0	0	16	0	0
21	45182687	.	T	C	8	7	15	0	1	16	0	0
21	45185829	.	A	G	15	14	29	0	0	29	0	0
21	45186939	.	A	C	5	6	11	0	1	12	0	0
21	45186984	.	A	G	7	10	17	0	0	17	0	0
21	45187123	.	C	T	13	7	20	0	0	20	0	0
21	45187248	.	A	G	10	4	14	0	1	15	0	0
21	45187258	.	G	A	13	3	16	0	0	16	0	0
21	45190704	.	A	G	29	25	54	0	3	57	0	0
21	45190709	.	T	A	30	26	56	0	1	57	0	0
21	45190754	.	C	T	6	30	36	0	24	60	0	0
21	45190766	.	T	A	27	31	58	0	1	59	0	0
21	45190861	.	A	T	22	38	60	0	2	62	0	0
21	45190884	.	G	A	24	33	57	0	0	57	0	0
21	45190975	.	C	T	22	28	50	0	5	55	0	0
21	45190984	.	T	C	23	30	53	0	2	55	0	0
21	45191163	.	A	T	34	42	76	0	0	76	0	0
21	45193260	.	A	G	30	31	61	0	3	64	0	0
21	45198712	.	C	T	5	28	33	0	28	61	0	0
21	45341958	.	A	T	27	24	51	0	3	54	0	0
21	45342043	.	G	T	28	35	63	0	1	64	0	0
21	45349469	.	G	A	35	20	55	0	1	56	0	0
21	45352216	.	A	T	27	10	37	0	1	39	1	0
21	45352217	.	T	C	24	11	35	0	3	38	0	0
21	45356811	.	T	G	27	13	40	0	2	42	0	0
21	45366268	.	C	T	4	10	14	0	0	14	0	0
21	45374375	.	A	G	7	8	15	0	0	15	0	0
21	45374439	.	C	T	16	7	23	0	0	23	0	0
21	45374475	.	A	G	14	7	21	0	0	21	0	0
21	45374725	.	G	A	6	5	11	0	0	11	0	0
21	45374749	.	C	G	5	5	10	0	0	10	0	0
21	45374928	.	A	G	12	6	18	0	1	19	0	0
21	45375144	.	G	A	3	4	7	0	0	7	0	0
21	45377546	.	G	A	11	15	26	0	1	27	0	0
21	45377685	.	G	A	20	11	31	0	2	33	0	0
21	45382032	.	G	A	24	15	39	0	0	39	0	0
21	45388336	.	T	C	1	2	3	0	0	3	0	0
21	45388369	.	T	C	1	3	4	0	1	5	0	0
21	45398081	.	G	C	3	4	7	0	0	7	0	0
21	45398178	.	T	C	2	3	5	0	0	5	0	0
21	45410019	.	G	A	0	5	5	0	4	9	0	0
21	45510699	.	A	G	1	0	1	0	2	3	0	0
21	45533729	.	A	G	2	0	2	0	2	4	0	0
21	45535881	.	A	G	5	2	7	0	0	7	0	0
21	45542246	.	A	G	3	0	3	0	3	6	0	0
21	45544108	.	C	T	2	6	8	0	0	8	0	0
21	45544384	.	A	G	2	0	2	0	8	10	0	0
21	45544709	.	A	G	3	3	6	0	0	6	0	0
21	45547147	.	C	T	6	4	10	0	0	10	0	0
21	45550004	.	C	A	12	3	15	0	1	16	0	0
21	45550066	.	G	A	0	8	8	0	7	15	0	0
21	45550122	.	A	G	7	0	7	0	6	13	0	0
21	45550244	.	C	G	5	6	11	0	0	11	0	0
21	45550354	.	C	T	5	6	11	0	0	11	0	0
21	45550450	.	C	T	4	3	7	0	0	7	0	0
21	45550734	.	T	C	5	4	9	0	0	9	0	0
21	45550736	.	C	T	5	4	9	0	0	9	0	0
21	45550928	.	A	T	6	4	10	0	0	10	0	0
21	45551011	.	T	A	5	5	10	0	1	11	0	0
21	45551014	.	T	C	4	6	10	0	1	11	0	0
21	45551095	.	A	C	6	6	12	0	1	13	0	0
21	45551096	.	G	A	8	6	14	0	0	14	0	0
21	45551386	.	G	C	1	5	6	0	0	6	0	0
21	45551391	.	A	G	1	5	6	0	0	6	0	0
21	45551421	.	T	C	1	8	9	0	0	9	0	0
21	45551606	.	T	A	6	4	10	0	1	11	0	0
21	45551620	.	C	T	8	7	15	0	0	15	0	0
21	45551785	.	G	A	4	10	14	0	1	15	0	0
21	45551845	.	C	T	6	6	12	0	0	12	0	0
21	45551972	.	G	A	0	9	9	0	11	20	0	0
21	45552187	.	T	C	13	8	21	0	0	21	0	0
21	45552282	.	T	C	7	12	19	0	3	22	0	0
21	45552286	.	C	T	8	10	18	0	3	21	0	0
21	45552676	.	G	A	8	17	25	0	0	25	0	0
21	45552924	.	C	T	6	6	12	0	0	12	0	0
21	45582048	.	T	C	17	14	31	0	2	33	0	0
21	45582907	.	A	G	13	8	21	0	6	27	0	0
21	45582931	.	G	A	7	16	23	0	5	28	0	0
21	45584817	.	C	T	13	17	30	0	1	31	0	0
21	45586600	.	A	G	7	11	18	0	0	18	0	0
21	45591105	.	A	G	9	5	14	0	1	15	0	0
21	45597559	.	A	T	11	8	19	0	1	20	0	0
21	45598671	.	G	A	6	9	15	0	0	15	0	0
21	45599059	.	G	A	10	4	14	0	1	15	0	0
21	45599335	.	C	G	6	6	12	0	1	13	0	0
21	45599379	.	G	A	4	5	9	0	0	9	0	0
21	45599413	.	G	A	9	7	16	0	1	17	0	0
21	45628374	.	G	A	1	4	5	0	0	5	0	0
21	45673667	.	T	A	21	21	42	0	9	51	0	0
21	45673826	.	G	A	20	12	32	0	0	32	0	0
21	45673960	.	C	T	0	6	6	0	26	32	0	0
21	45674321	.	T	C	11	29	40	0	5	45	0	0
21	45687940	.	T	C	3	2	5	0	1	6	0	0
21	45694166	.	C	T	3	7	10	0	0	10	0	0
21	45696135	.	C	T	4	4	8	0	0	8	0	0
21	45696164	.	G	A	0	5	5	0	4	9	0	0
21	45699347	.	T	A	3	5	8	0	1	9	0	0
21	45703316	.	T	C	7	7	14	0	0	14	0	0
21	45704975	.	C	T	7	7	14	0	0	14	0	0
21	45704999	.	C	T	7	5	12	0	0	12	0	0
21	45705267	.	T	C	7	4	11	0	1	12	0	0
21	45705276	.	T	C	8	4	12	0	1	13	0	0
21	45705375	.	A	G	8	8	16	0	2	18	0	0
21	45707154	.	T	C	9	5	14	0	0	14	0	0
21	45707734	.	T	C	6	7	13	0	0	13	0	0
21	45714390	.	T	C	20	13	33	0	0	33	0	0
21	45715241	.	T	C	22	16	38	0	3	41	0	0
21	45715271	.	G	A	12	7	19	0	30	49	0	0
21	45715558	.	G	C	11	7	18	0	0	18	0	0
21	45716112	.	A	G	1	5	6	0	0	6	0	0
21	45719205	.	T	G	18	1	19	0	13	32	0	0
21	45721245	.	T	C	6	8	14	0	0	14	0	0
21	45721246	.	C	G	6	0	6	0	8	14	0	0
21	45721760	.	G	A	9	13	22	0	2	24	0	0
21	45723174	.	G	C	6	8	14	0	1	15	0	0
21	45726391	.	C	T	11	14	25	0	0	25	0	0
21	45726600	.	C	T	9	12	21	0	0	21	0	0
21	45728723	.	T	G	10	18	28	0	0	28	0	0
21	45728774	.	T	C	14	15	29	0	1	30	0	0
21	45729365	.	C	G	16	13	29	0	1	30	0	0
21	45730150	.	G	C	26	23	49	0	0	49	0	0
21	45732018	.	C	G	17	9	26	0	2	28	0	0
21	45733905	.	C	T	21	9	30	0	1	31	0	0
21	45734044	.	T	C	9	9	18	0	0	18	0	0
21	45735918	.	G	A	1	8	9	0	7	16	0	0
21	45736157	.	T	G	16	0	16	0	16	32	0	0
21	45736179	.	T	C	15	16	31	0	1	32	0	0
21	45736244	.	T	C	15	14	29	0	3	32	0	0
21	45736463	.	T	A	20	10	30	0	3	33	0	0
21	45737960	.	T	G	9	7	16	0	0	16	0	0
21	45738043	.	T	C	10	8	18	0	0	18	0	0
21	45738046	.	T	C	10	7	17	0	0	17	0	0
21	45738125	.	C	T	11	10	21	0	1	22	0	0
21	45738525	.	G	A	2	8	10	0	25	35	0	0
21	45738592	.	T	C	16	6	22	0	0	22	0	0
21	45738658	.	A	C	16	7	23	0	2	25	0	0
21	45738775	.	A	G	14	8	22	0	1	23	0	0
21	45738852	.	G	A	17	11	28	0	2	30	0	0
21	45738856	.	C	T	19	13	32	0	0	32	0	0
21	45738945	.	A	G	13	0	13	0	16	29	0	0
21	45739074	.	A	C	13	14	27	0	1	28	0	0
21	45739087	.	A	C	14	13	27	0	1	28	0	0
21	45739125	.	A	G	24	7	31	1	1	33	0	0
21	45739139	.	C	T	22	6	28	1	1	30	0	0
21	45739169	.	T	A	22	12	34	0	1	35	0	0
21	45739235	.	T	C	13	7	20	0	7	27	0	0
21	45739519	.	C	G	16	9	25	0	1	26	0	0
21	45739613	.	A	T	9	14	23	1	1	25	0	0
21	45739642	.	G	A	0	13	13	0	13	26	0	0
21	45739724	.	A	T	22	17	39	0	3	42	0	0
21	45758525	.	T	A	4	3	7	0	0	7	0	0
21	45760767	.	G	A	1	2	3	0	3	6	0	0
21	45761690	.	A	T	2	3	5	0	0	5	0	0
21	45765797	.	A	C	1	3	4	0	0	4	0	0
21	45767676	.	A	T	3	4	7	0	1	8	0	0
21	45767758	.	C	G	1	6	7	0	1	8	0	0
21	45767848	.	T	A	2	4	6	0	0	6	0	0
21	45767884	.	T	C	2	4	6	0	0	6	0	0
21	45767920	.	G	A	0	3	3	0	3	6	0	0
21	45767965	.	A	T	2	5	7	0	0	7	0	0
21	45768031	.	G	A	0	5	5	0	5	10	0	0
21	45768043	.	T	C	8	6	14	0	0	14	0	0
21	45768114	.	G	C	9	6	15	0	0	15	0	0
21	45768220	.	A	G	4	4	8	0	1	9	0	0
21	45768260	.	T	A	2	6	8	0	1	9	0	0
21	45768317	.	A	C	2	3	5	0	0	5	0	0
21	45768462	.	A	G	7	6	13	0	1	14	0	0
21	45768597	.	G	C	7	6	13	0	0	13	0	0
21	45768787	.	A	T	1	2	3	0	0	3	0	0
21	45769130	.	C	G	14	6	20	0	0	20	0	0
21	45769199	.	C	A	14	8	22	0	0	22	0	0
21	45838304	.	C	T	17	14	31	0	1	32	0	0
21	45839258	.	A	G	15	13	28	0	1	29	0	0
21	45840307	.	C	A	2	5	7	0	13	20	0	0
21	45840317	.	G	T	12	4	16	0	1	17	0	0
21	45848701	.	T	C	5	3	8	0	1	9	0	0
21	45850905	.	G	A	0	7	7	0	14	21	0	0
21	45851180	.	T	C	11	5	16	0	0	16	0	0
21	45851563	.	A	C	19	19	38	0	2	40	0	0
21	45856614	.	G	A	14	23	37	0	1	38	0	0
21	45857425	.	G	A	13	17	30	0	2	32	0	0
21	45857954	.	T	G	23	6	29	0	2	31	0	0
21	45859589	.	C	T	12	12	24	0	3	27	0	0
21	45860602	.	A	G	16	8	24	0	1	25	0	0
21	45863053	.	G	A	15	15	30	0	2	32	0	0
21	45865174	.	C	T	9	11	20	0	0	20	0	0
21	45866065	.	G	A	9	13	22	0	0	22	0	0
21	45866066	.	G	A	9	11	20	0	2	22	0	0
21	45876230	.	T	C	8	4	12	0	0	12	0	0
21	45876253	.	A	T	6	8	14	0	1	15	0	0
21	45876638	.	A	G	16	0	16	0	0	21	5	0
21	45876642	.	C	A	3	4	7	0	14	22	1	0
21	45884210	.	A	G	6	3	9	0	0	9	0	0
21	45905088	.	T	C	9	8	17	0	0	17	0	0
21	45905257	.	C	G	11	7	18	0	0	18	0	0
21	45914107	.	C	A	4	4	8	0	0	8	0	0
21	45914182	.	A	G	7	5	12	0	0	12	0	0
21	45916436	.	C	T	6	4	10	0	0	10	0	0
21	45918519	.	C	G	1	3	4	0	0	4	0	0
21	45918698	.	A	G	2	0	2	0	3	5	0	0
21	45918705	.	T	G	4	1	5	0	0	5	0	0
21	45919139	.	G	T	10	4	14	0	1	15	0	0
22	336325	.	T	C	17	25	42	0	1	43	0	0
22	336982	.	C	T	29	14	43	0	1	44	0	0
22	337121	.	A	C	5	3	8	0	16	24	0	0
22	337127	.	A	C	7	1	8	0	18	26	0	0
22	337540	.	A	T	8	16	24	0	0	24	0	0
22	337970	.	C	G	9	8	17	0	0	17	0	0
22	338187	.	G	A	25	16	41	5	1	47	0	0
22	338199	.	G	T	4	16	20	5	20	45	0	0
22	338226	.	C	T	20	18	38	6	0	44	0	0
22	338431	.	C	T	6	7	13	1	0	14	0	0
22	338564	.	C	A	3	3	6	0	0	6	0	0
22	711071	.	A	G	28	23	51	0	3	54	0	0
22	711475	.	T	C	6	4	10	0	1	11	0	0
22	711787	.	A	T	15	30	45	0	1	46	0	0
22	712187	.	G	T	18	16	34	0	2	36	0	0
22	729619	.	C	A	6	4	10	0	0	10	0	0
22	731394	.	C	T	5	5	10	0	0	10	0	0
22	732142	.	G	A	1	6	7	0	7	14	0	0
22	732149	.	G	T	0	6	6	0	9	15	0	0
22	732271	.	A	G	3	0	3	0	2	5	0	0
22	732718	.	C	T	0	2	2	0	0	2	0	0
22	732724	.	T	A	2	2	4	0	1	5	0	0
22	745380	.	C	T	6	7	13	0	0	13	0	0
22	748837	.	C	T	3	9	12	1	0	13	0	0
22	748951	.	T	C	8	8	16	0	0	16	0	0
22	750695	.	T	C	1	6	7	0	0	7	0	0
22	750699	.	G	A	1	5	6	0	1	7	0	0
22	750759	.	C	A	4	5	9	0	0	9	0	0
22	750770	.	C	G	4	6	10	0	0	10	0	0
22	750863	.	T	C	7	7	14	0	0	14	0	0
22	751075	.	A	G	7	13	20	0	0	20	0	0
22	753210	.	C	T	8	4	12	0	0	12	0	0
22	753219	.	T	C	8	3	11	0	0	11	0	0
22	753267	.	A	G	5	0	5	0	3	8	0	0
22	774949	.	G	C	18	13	31	0	2	33	0	0
22	775044	.	T	C	11	0	11	0	16	28	1	0
22	775085	.	G	A	10	9	19	0	1	20	0	0
22	777072	.	G	A	21	17	38	0	0	38	0	0
22	780973	.	A	G	11	11	22	0	0	22	0	0
22	797117	.	G	A	9	7	16	0	0	16	0	0
22	797196	.	G	T	1	5	6	0	17	23	0	0
22	797255	.	T	C	10	8	18	0	4	22	0	0
22	799595	.	A	G	14	2	16	0	15	31	0	0
22	799712	.	C	T	14	7	21	1	0	22	0	0
22	806155	.	C	T	21	23	44	0	1	45	0	0
22	808015	.	T	A	6	10	16	0	0	17	1	0
22	808032	.	T	C	7	11	18	0	1	19	0	0
22	808069	.	T	A	10	6	16	0	1	17	0	0
22	808077	.	A	G	9	0	9	0	6	15	0	0
22	814622	.	T	G	1	2	3	0	0	4	1	0
22	819756	.	G	A	4	3	7	0	1	8	0	0
22	819787	.	G	A	4	5	9	0	0	9	0	0
22	820459	.	G	T	13	6	19	0	2	21	0	0
22	820660	.	A	G	8	15	23	0	1	24	0	0
22	822601	.	A	C	10	0	10	0	12	22	0	0
22	825091	.	T	A	11	9	20	0	0	20	0	0
22	825130	.	G	A	10	8	18	0	0	18	0	0
22	827256	.	A	T	5	9	14	0	3	17	0	0
22	827309	.	G	A	10	18	28	0	0	28	0	0
22	828235	.	C	G	3	7	10	0	0	10	0	0
22	828517	.	C	T	1	4	5	0	4	9	0	0
22	831180	.	C	T	1	5	6	0	4	10	0	0
22	831185	.	C	T	6	3	9	0	0	9	0	0
22	831482	.	C	T	0	5	5	0	7	12	0	0
22	831533	.	G	A	5	6	11	0	0	11	0	0
22	831575	.	C	T	4	5	9	0	0	9	0	0
22	831591	.	T	C	2	0	2	0	4	6	0	0
22	833928	.	G	A	1	3	4	0	0	4	0	0
22	857511	.	C	G	6	8	14	0	0	14	0	0
22	857572	.	A	T	6	8	14	0	0	14	0	0
22	857662	.	C	T	6	4	10	0	0	10	0	0
22	857720	.	A	G	8	7	15	0	0	15	0	0
22	860224	.	G	A	2	4	6	0	1	7	0	0
22	860236	.	G	A	5	4	9	0	0	9	0	0
22	862526	.	C	T	0	5	5	0	4	9	0	0
22	866064	.	C	T	5	2	7	0	0	7	0	0
22	868098	.	A	G	2	3	5	0	2	7	0	0
22	868195	.	C	A	13	7	20	0	1	21	0	0
22	868321	.	T	C	10	13	23	0	0	23	0	0
22	869514	.	C	T	1	2	3	0	0	3	0	0
22	869529	.	G	A	3	4	7	0	0	7	0	0
22	869584	.	C	T	6	8	14	0	1	15	0	0
22	869739	.	G	A	6	9	15	0	1	16	0	0
22	869793	.	C	A	10	7	17	0	1	18	0	0
22	869798	.	G	T	11	6	17	0	1	18	0	0
22	873058	.	G	C	3	4	7	0	0	7	0	0
22	875469	.	A	T	1	1	2	0	1	3	0	0
22	876959	.	C	G	1	2	3	0	4	7	0	0
22	877097	.	C	T	0	2	2	0	3	5	0	0
22	877805	.	A	G	2	4	6	0	0	6	0	0
22	877922	.	C	T	5	2	7	0	0	7	0	0
22	994433	.	G	A	1	3	4	0	0	4	0	0
22	994752	.	A	T	1	2	3	0	0	3	0	0
22	1203320	.	A	T	11	8	19	0	0	19	0	0
22	1203373	.	A	T	12	14	26	0	1	27	0	0
22	1209816	.	T	C	5	4	9	0	1	10	0	0
22	1212997	.	A	G	7	7	14	0	0	14	0	0
22	1212998	.	A	G	7	7	14	0	0	14	0	0
22	1214289	.	T	C	2	3	5	0	2	7	0	0
22	1214535	.	T	G	3	5	8	0	0	8	0	0
22	1216047	.	C	T	4	2	6	0	0	6	0	0
22	1223100	.	C	T	0	2	2	0	2	4	0	0
22	1228158	.	T	C	3	2	5	0	0	5	0	0
22	1234232	.	A	T	1	6	7	0	0	7	0	0
22	1546546	.	C	T	3	2	5	0	0	5	0	0
22	1632641	.	A	T	5	2	7	3	0	10	0	0
22	1757132	.	A	G	1	0	1	0	2	3	0	0
22	1757150	.	T	C	2	2	4	0	0	4	0	0
22	1757458	.	C	T	1	2	3	0	1	4	0	0
22	1773244	.	T	C	1	1	2	0	0	2	0	0
22	1773249	.	G	A	0	2	2	0	0	2	0	0
22	1793776	.	G	A	4	2	6	0	2	8	0	0
22	1793791	.	A	G	4	3	7	0	0	7	0	0
22	1794099	.	A	G	3	5	8	0	0	8	0	0
22	1860922	.	G	A	4	4	8	0	0	8	0	0
22	1899972	.	A	G	2	0	2	0	2	4	0	0
22	1900322	.	T	C	2	1	3	0	0	3	0	0
22	1900343	.	T	G	2	2	4	0	0	4	0	0
22	1900376	.	T	C	3	2	5	0	0	5	0	0
22	1900389	.	G	A	1	2	3	0	1	4	0	0
22	1900563	.	T	G	2	0	2	0	2	4	0	0
22	1900767	.	A	G	4	2	6	0	0	6	0	0
22	1900888	.	G	A	2	3	5	0	0	5	0	0
22	1901238	.	T	A	5	2	7	0	0	7	0	0
22	1901245	.	T	C	5	2	7	0	0	7	0	0
22	1901456	.	C	G	1	2	3	3	0	6	0	0
22	1925132	.	T	C	2	4	6	0	0	6	0	0
22	1925182	.	A	G	2	4	6	0	0	6	0	0
22	1925228	.	G	A	0	4	4	0	1	5	0	0
22	1925329	.	C	G	2	1	3	1	1	5	0	0
22	1925330	.	T	C	2	2	4	1	0	5	0	0
22	1945243	.	G	A	2	2	4	0	0	4	0	0
22	1945258	.	C	T	2	2	4	0	0	4	0	0
22	1946691	.	C	A	2	2	4	3	0	7	0	0
22	1948847	.	A	C	1	2	3	0	0	3	0	0
22	2033389	.	C	A	1	2	3	0	0	3	0	0
22	2033430	.	A	G	1	0	1	0	4	5	0	0
22	2033674	.	C	T	1	5	6	0	0	6	0	0
22	2033740	.	C	T	3	6	9	0	2	11	0	0
22	2033767	.	G	A	4	5	9	0	0	9	0	0
22	2034016	.	A	G	1	0	1	0	3	4	0	0
22	2106420	.	T	C	1	4	5	0	0	5	0	0
22	2106449	.	A	C	2	4	6	0	0	6	0	0
22	2106657	.	G	C	3	2	5	0	0	5	0	0
22	2106748	.	C	A	4	6	10	0	0	10	0	0
22	2106749	.	G	A	0	6	6	0	4	10	0	0
22	2107007	.	A	T	1	2	3	0	1	4	0	0
22	2107088	.	G	C	1	4	5	0	0	5	0	0
22	2107104	.	G	A	0	4	4	0	1	5	0	0
22	2107142	.	A	G	1	3	4	3	0	7	0	0
22	2107146	.	G	T	0	3	3	3	1	7	0	0
22	2107359	.	G	A	1	3	4	0	0	4	0	0
22	2125576	.	A	G	6	3	9	0	0	9	0	0
22	2125600	.	T	G	4	3	7	0	0	7	0	0
22	2125829	.	G	A	6	2	8	0	0	8	0	0
22	2144321	.	G	A	2	2	4	0	1	5	0	0
22	2144325	.	A	G	2	2	4	0	1	5	0	0
22	2178253	.	G	C	2	2	4	0	0	4	0	0
22	2178263	.	C	T	2	2	4	0	0	4	0	0
22	2178333	.	A	C	2	3	5	1	0	6	0	0
22	2242706	.	T	C	2	2	4	0	0	4	0	0
22	2242763	.	C	T	1	4	5	0	0	5	0	0
22	2347923	.	A	C	2	2	4	0	0	4	0	0
22	2352130	.	G	A	0	2	2	0	5	7	0	0
22	2368037	.	C	T	4	2	6	0	0	6	0	0
22	2368161	.	C	G	5	3	8	0	0	8	0	0
22	2373908	.	C	T	5	2	7	0	0	7	0	0
22	2373909	.	A	G	4	2	6	0	1	7	0	0
22	2385377	.	G	C	4	2	6	0	0	6	0	0
22	2389009	.	A	T	3	3	6	0	0	6	0	0
22	2389041	.	T	C	2	4	6	0	0	6	0	0
22	2403919	.	T	A	1	2	3	1	1	5	0	0
22	2411925	.	G	A	3	2	5	0	0	5	0	0
22	2420325	.	A	G	3	5	8	0	0	8	0	0
22	2420405	.	A	G	2	0	2	0	3	5	0	0
22	2420409	.	G	T	4	1	5	0	1	6	0	0
22	2421028	.	A	T	5	6	11	0	1	12	0	0
22	2443763	.	T	C	4	4	8	1	0	9	0	0
22	2443787	.	G	A	5	4	9	1	0	10	0	0
22	2443803	.	A	G	3	4	7	1	1	9	0	0
22	2444186	.	G	T	2	2	4	0	0	4	0	0
22	2444234	.	G	A	5	3	8	0	0	8	0	0
22	2444303	.	G	A	6	3	9	0	2	11	0	0
22	2497650	.	C	A	2	5	7	0	0	7	0	0
22	2497777	.	T	C	4	4	8	0	0	8	0	0
22	2498169	.	T	C	1	2	3	0	0	3	0	0
22	2498196	.	G	A	1	2	3	0	1	4	0	0
22	2498212	.	C	T	1	2	3	0	0	3	0	0
22	2498538	.	C	T	2	2	4	0	0	4	0	0
22	2498539	.	G	A	0	2	2	0	2	4	0	0
22	2535173	.	A	T	2	2	4	0	0	4	0	0
22	2535180	.	T	C	2	2	4	0	0	4	0	0
22	2538237	.	A	C	2	2	4	2	0	6	0	0
22	2538241	.	C	T	2	2	4	2	0	6	0	0
22	2538440	.	T	C	1	2	3	0	0	3	0	0
22	2552748	.	C	G	3	5	8	1	0	9	0	0
22	2552814	.	G	A	1	6	7	0	3	10	0	0
22	2552858	.	C	T	5	2	7	0	0	7	0	0
22	2554749	.	A	T	5	5	10	0	0	10	0	0
22	2554793	.	C	A	6	3	9	0	0	9	0	0
22	2554800	.	G	A	5	3	8	0	0	8	0	0
22	2557783	.	G	A	1	4	5	0	0	5	0	0
22	2558279	.	A	T	6	5	11	0	0	11	0	0
22	2558344	.	G	A	2	4	6	0	0	6	0	0
22	2558386	.	C	T	2	3	5	0	1	6	0	0
22	2558416	.	A	T	3	4	7	0	0	7	0	0
22	2576638	.	A	G	1	2	3	2	0	5	0	0
22	2576881	.	T	C	2	5	7	0	0	7	0	0
22	2576908	.	G	C	2	6	8	0	3	11	0	0
22	2577040	.	C	G	1	4	5	0	0	5	0	0
22	2602891	.	T	C	2	2	4	0	0	4	0	0
22	2602899	.	T	C	2	2	4	0	0	4	0	0
22	2627317	.	A	G	1	0	1	2	2	5	0	0
22	2627391	.	A	G	4	3	7	0	1	8	0	0
22	2627395	.	T	A	6	3	9	0	0	9	0	0
22	2627567	.	C	T	5	2	7	0	0	7	0	0
22	2627736	.	A	T	6	4	10	0	0	10	0	0
22	2627773	.	A	T	4	2	6	0	0	6	0	0
22	2627804	.	C	T	2	2	4	0	1	5	0	0
22	2627813	.	T	G	2	2	4	0	1	5	0	0
22	2627903	.	G	A	3	3	6	0	0	6	0	0
22	2645410	.	G	A	1	2	3	0	1	4	0	0
22	2645503	.	T	C	3	3	6	0	0	6	0	0
22	2645506	.	G	T	3	3	6	0	0	6	0	0
22	2645660	.	G	C	1	2	3	0	0	3	0	0
22	2645662	.	G	A	1	2	3	0	0	3	0	0
22	2646501	.	C	T	2	2	4	1	1	6	0	0
22	2646541	.	G	A	1	2	3	0	0	3	0	0
22	2650072	.	T	A	2	7	9	0	1	10	0	0
22	2653023	.	T	C	1	8	9	0	0	9	0	0
22	2659103	.	A	T	0	4	4	0	0	4	0	0
22	2659111	.	G	C	2	3	5	0	0	5	0	0
22	2659152	.	A	T	4	3	7	0	0	7	0	0
22	2659153	.	C	A	2	3	5	0	2	7	0	0
22	2664297	.	C	T	1	3	4	0	1	5	0	0
22	2664411	.	G	A	1	5	6	0	0	6	0	0
22	2668031	.	G	A	3	0	3	0	1	4	0	0
22	2668043	.	C	T	3	4	7	0	0	7	0	0
22	2668262	.	A	G	5	3	8	0	0	8	0	0
22	2668352	.	C	T	2	5	7	0	0	7	0	0
22	2668467	.	G	C	0	4	4	0	2	6	0	0
22	2668486	.	G	A	2	4	6	0	0	6	0	0
22	2668762	.	A	G	1	3	4	0	0	4	0	0
22	2668775	.	C	A	1	1	2	0	1	3	0	0
22	2676234	.	G	C	1	2	3	0	0	3	0	0
22	2676393	.	A	G	2	0	2	0	2	4	0	0
22	2676415	.	A	C	3	3	6	0	1	7	0	0
22	2690677	.	C	T	4	2	6	0	0	6	0	0
22	2869790	.	G	A	1	2	3	0	0	3	0	0
22	2879827	.	A	G	1	2	3	0	0	3	0	0
22	2897580	.	T	C	9	0	9	0	12	21	0	0
22	2897681	.	A	G	8	17	25	0	1	26	0	0
22	2897742	.	G	A	15	13	28	0	1	29	0	0
22	2897997	.	G	C	9	12	21	0	0	21	0	0
22	2898089	.	C	A	3	12	15	0	20	35	0	0
22	2900999	.	G	A	14	19	33	0	0	33	0	0
22	2908264	.	T	G	17	8	25	0	1	26	0	0
22	2912869	.	G	T	19	12	31	0	2	33	0	0
22	2919050	.	A	G	6	11	17	0	1	18	0	0
22	2919501	.	C	T	11	10	21	0	0	21	0	0
22	2931544	.	T	A	8	5	13	0	0	13	0	0
22	2933861	.	G	C	2	4	6	0	0	6	0	0
22	2937428	.	A	G	2	4	6	0	1	7	0	0
22	2941886	.	C	T	5	2	7	0	0	7	0	0
22	2941888	.	C	T	5	2	7	0	0	7	0	0
22	2951416	.	C	G	2	5	7	0	7	14	0	0
22	2961868	.	G	A	0	3	3	0	7	10	0	0
22	3077580	.	C	T	1	4	5	0	0	5	0	0
22	3077603	.	A	C	2	4	6	0	0	6	0	0
22	3077621	.	T	C	3	4	7	0	0	7	0	0
22	3077768	.	G	A	1	2	3	0	1	4	0	0
22	3077828	.	A	G	1	0	1	0	4	5	0	0
22	3077864	.	T	A	4	4	8	0	0	8	0	0
22	3078101	.	T	C	5	2	7	0	0	7	0	0
22	3121191	.	T	G	6	2	8	0	0	8	0	0
22	3121451	.	C	A	2	5	7	0	9	16	0	0
22	3121531	.	A	T	3	6	9	0	0	9	0	0
22	3121683	.	T	A	5	5	10	0	0	10	0	0
22	3121725	.	T	G	8	6	14	0	0	14	0	0
22	3121789	.	A	T	11	12	23	0	0	23	0	0
22	3122004	.	A	G	5	4	9	0	0	9	0	0
22	3122040	.	A	G	5	2	7	0	0	7	0	0
22	3122044	.	T	A	3	2	5	0	1	6	0	0
22	3122258	.	C	T	17	18	35	0	0	35	0	0
22	3123805	.	G	A	3	2	5	0	1	6	0	0
22	3124031	.	G	A	7	4	11	0	0	11	0	0
22	3124052	.	A	G	6	2	8	0	0	8	0	0
22	3124071	.	C	T	0	4	4	0	4	8	0	0
22	3124132	.	G	T	7	5	12	0	1	13	0	0
22	3128036	.	T	A	6	2	8	1	0	9	0	0
22	3143236	.	C	T	1	4	5	0	9	14	0	0
22	3161346	.	C	T	6	8	14	0	1	15	0	0
22	3162335	.	T	C	3	5	8	0	0	8	0	0
22	3162405	.	G	A	7	2	9	0	0	9	0	0
22	3169448	.	C	T	0	2	2	0	2	4	0	0
22	3169529	.	T	C	5	2	7	0	0	7	0	0
22	3169723	.	T	C	2	3	5	0	0	5	0	0
22	3172774	.	C	T	7	4	11	0	1	12	0	0
22	3177005	.	C	T	0	5	5	0	3	8	0	0
22	3177026	.	G	C	3	0	3	0	4	7	0	0
22	3177063	.	G	A	3	4	7	0	0	7	0	0
22	3177196	.	T	G	5	5	10	0	0	10	0	0
22	3177227	.	A	G	2	7	9	0	0	9	0	0
22	3182452	.	G	C	1	2	3	0	10	13	0	0
22	3182457	.	T	C	5	9	14	0	0	14	0	0
22	3182566	.	A	G	1	2	3	0	1	4	0	0
22	3182584	.	C	A	3	3	6	0	0	6	0	0
22	3182698	.	G	C	7	5	12	0	0	12	0	0
22	3182728	.	T	C	5	4	9	0	0	9	0	0
22	3198158	.	C	T	4	3	7	0	0	7	0	0
22	3204054	.	G	A	2	6	8	0	0	8	0	0
22	3204308	.	A	T	1	2	3	0	0	3	0	0
22	3204322	.	A	T	1	2	3	0	0	3	0	0
22	3208098	.	A	G	1	4	5	0	0	5	0	0
22	3208281	.	A	G	5	9	14	0	0	14	0	0
22	3211809	.	C	T	5	2	7	0	0	7	0	0
22	3214279	.	G	A	4	3	7	0	0	7	0	0
22	3214309	.	G	A	7	5	12	0	0	12	0	0
22	3231635	.	A	G	3	0	3	0	10	13	0	0
22	3231677	.	T	G	8	8	16	0	0	16	0	0
22	3249782	.	T	C	6	3	9	0	0	9	0	0
22	3262925	.	C	T	3	5	8	0	7	15	0	0
22	3263129	.	T	C	9	7	16	0	1	17	0	0
22	3263318	.	A	G	11	10	21	0	1	22	0	0
22	3263672	.	G	T	7	5	12	0	1	13	0	0
22	3263917	.	C	T	11	13	24	0	1	25	0	0
22	3265889	.	C	A	9	7	16	0	0	16	0	0
22	3267636	.	C	T	6	5	11	0	0	11	0	0
22	3270790	.	G	A	3	4	7	0	0	7	0	0
22	3271943	.	G	A	5	4	9	0	0	9	0	0
22	3273527	.	C	A	5	5	10	0	0	10	0	0
22	3384831	.	G	A	19	27	46	0	2	48	0	0
22	3384844	.	C	T	22	24	46	0	2	48	0	0
22	3387865	.	T	C	4	3	7	0	1	8	0	0
22	3389500	.	T	G	13	9	22	0	1	23	0	0
22	3389606	.	A	G	6	12	18	0	3	21	0	0
22	3389615	.	T	C	9	12	21	0	1	22	0	0
22	3389803	.	G	A	10	12	22	0	2	24	0	0
22	3392768	.	A	T	10	8	18	0	7	25	0	0
22	3402151	.	A	G	7	9	16	0	0	16	0	0
22	3413993	.	G	A	8	5	13	0	0	13	0	0
22	4747456	.	C	A	2	3	5	0	1	6	0	0
22	4952789	.	G	T	2	2	4	0	0	4	0	0
22	4952823	.	C	A	1	2	3	0	0	3	0	0
22	4962472	.	T	A	4	8	12	0	0	12	0	0
22	4962559	.	G	A	8	13	21	0	0	21	0	0
22	4962610	.	A	T	13	14	27	0	0	27	0	0
22	4962635	.	A	G	12	16	28	0	2	30	0	0
22	4962696	.	T	C	15	12	27	0	1	28	0	0
22	4962878	.	G	A	13	17	30	0	1	31	0	0
22	4968955	.	A	G	15	16	31	1	2	34	0	0
22	4969051	.	G	A	17	12	29	1	0	30	0	0
22	4970773	.	T	C	8	0	8	0	12	20	0	0
22	4970797	.	G	C	5	10	15	0	1	16	0	0
22	4972848	.	T	G	8	11	19	0	1	20	0	0
22	4972980	.	C	T	2	12	14	0	11	25	0	0
22	4975236	.	T	A	11	14	25	0	4	29	0	0
22	4977106	.	G	A	5	12	17	0	1	18	0	0
22	4985831	.	G	C	3	2	5	0	1	6	0	0
22	5056425	.	G	T	9	7	16	0	0	16	0	0
22	5056706	.	G	A	14	6	20	0	0	20	0	0
22	5056760	.	T	G	9	18	27	0	0	27	0	0
22	5056978	.	A	T	5	6	11	0	0	11	0	0
22	5057421	.	C	A	0	12	12	0	7	19	0	0
22	5057443	.	T	C	14	0	14	0	9	23	0	0
22	5057489	.	T	A	7	7	14	0	0	14	0	0
22	5057504	.	T	A	7	6	13	0	1	14	0	0
22	5059916	.	A	G	18	14	32	0	0	32	0	0
22	5060087	.	T	G	14	8	22	0	1	23	0	0
22	5060162	.	T	A	5	12	17	0	1	18	0	0
22	5062457	.	G	A	6	15	21	0	0	21	0	0
22	5075390	.	A	G	3	5	8	0	0	8	0	0
22	5075673	.	A	G	4	3	7	0	0	7	0	0
22	5075732	.	T	C	6	3	9	0	1	10	0	0
22	5087488	.	G	A	9	7	16	0	1	17	0	0
22	5090115	.	C	A	1	11	12	0	7	19	0	0
22	5098433	.	G	T	10	6	16	0	0	16	0	0
22	5103769	.	G	A	2	2	4	0	1	5	0	0
22	5109554	.	G	A	19	25	44	1	3	48	0	0
22	5109560	.	T	A	17	26	43	1	1	46	1	0
22	5112644	.	G	T	26	18	44	0	1	45	0	0
22	5112749	.	T	C	21	21	42	0	1	43	0	0
22	5112864	.	G	A	19	11	30	0	1	32	1	0
22	5112915	.	A	C	26	15	41	0	0	41	0	0
22	5114380	.	G	C	1	28	29	1	25	56	1	0
22	5116267	.	A	C	10	12	22	0	0	22	0	0
22	5118373	.	A	G	1	0	1	0	4	5	0	0
22	5118378	.	G	A	1	4	5	0	1	6	0	0
22	5121464	.	C	T	5	6	11	0	0	11	0	0
22	5121471	.	C	T	4	6	10	0	0	10	0	0
22	5121623	.	A	G	3	0	3	0	6	9	0	0
22	5135241	.	T	A	1	4	5	0	0	5	0	0
22	5140122	.	A	G	4	5	9	0	0	9	0	0
22	5140840	.	C	T	0	2	2	0	5	7	0	0
22	5140851	.	C	G	3	4	7	0	0	7	0	0
22	5144566	.	G	C	10	7	17	0	1	18	0	0
22	5144645	.	C	T	8	5	13	0	0	13	0	0
22	5144750	.	T	A	5	4	9	0	1	11	1	0
22	5144981	.	T	C	8	8	16	0	0	16	0	0
22	5145109	.	C	A	3	5	8	0	0	8	0	0
22	5145199	.	C	G	4	3	7	0	0	7	0	0
22	5228744	.	G	A	0	5	5	8	10	23	0	0
22	5230339	.	A	G	9	9	18	5	1	24	0	0
22	5230962	.	A	C	3	2	5	3	3	11	0	0
22	5230977	.	A	C	3	3	6	2	0	8	0	0
22	5758228	.	T	A	7	3	10	1	0	11	0	0
22	6077657	.	T	C	3	0	3	0	4	7	0	0
22	6488342	.	T	C	2	0	2	0	2	4	0	0
22	6488364	.	A	G	0	3	3	0	0	3	0	0
22	6527546	.	C	T	3	4	7	0	0	7	0	0
22	6527553	.	C	A	1	5	6	0	5	11	0	0
22	6528059	.	A	T	3	8	11	0	0	11	0	0
22	6528151	.	T	C	7	3	10	0	1	11	0	0
22	6528177	.	C	T	1	5	6	0	2	8	0	0
22	6528313	.	T	C	2	1	3	0	7	10	0	0
22	6528586	.	C	T	2	6	8	0	0	8	0	0
22	6528632	.	C	T	6	2	8	0	1	9	0	0
22	6528746	.	A	G	3	5	8	0	0	8	0	0
22	6546949	.	A	T	1	2	3	0	0	3	0	0
22	6546965	.	C	G	1	3	4	0	0	4	0	0
22	6547309	.	C	T	5	4	9	0	0	9	0	0
22	6548010	.	C	T	1	3	4	0	0	4	0	0
22	6548057	.	G	A	1	2	3	0	1	4	0	0
22	6548072	.	G	A	2	2	4	0	0	4	0	0
22	6767649	.	A	G	0	2	2	0	0	2	0	0
22	6767664	.	G	A	1	2	3	0	2	5	0	0
22	6767696	.	A	C	4	3	7	0	0	7	0	0
22	6956721	.	G	A	1	3	4	0	0	4	0	0
22	6996116	.	T	C	4	0	4	0	5	9	0	0
22	6996343	.	G	A	8	11	19	0	1	20	0	0
22	6998904	.	A	G	3	10	13	0	0	13	0	0
22	6998949	.	G	T	5	9	14	0	0	14	0	0
22	6998988	.	T	C	8	5	13	0	2	15	0	0
22	6999060	.	G	C	3	0	3	0	4	7	0	0
22	6999148	.	T	A	3	6	9	0	0	9	0	0
22	7001474	.	G	T	2	2	4	0	0	4	0	0
22	7001827	.	G	A	3	8	11	0	0	11	0	0
22	7003603	.	A	G	2	6	8	0	1	9	0	0
22	7009333	.	A	T	11	20	31	1	0	32	0	0
22	7009393	.	A	G	5	10	15	1	0	16	0	0
22	7009833	.	C	T	7	3	10	0	3	13	0	0
22	7009835	.	T	G	6	5	11	0	2	13	0	0
22	7009911	.	A	G	9	14	23	0	0	23	0	0
22	7009915	.	C	T	2	15	17	0	8	25	0	0
22	7010011	.	A	C	18	19	37	0	2	39	0	0
22	7010100	.	T	C	23	0	23	0	22	45	0	0
22	7010151	.	T	C	17	15	32	0	1	33	0	0
22	7012898	.	C	T	0	15	15	0	13	28	0	0
22	7012931	.	C	G	15	15	30	0	2	32	0	0
22	7016655	.	A	G	14	14	28	0	2	30	0	0
22	7018223	.	G	A	9	11	20	0	3	23	0	0
22	7019397	.	C	A	3	10	13	0	17	30	0	0
22	7019701	.	T	A	15	10	25	0	1	27	1	0
22	7044667	.	T	G	9	6	15	0	1	16	0	0
22	7044681	.	T	C	7	6	13	0	3	16	0	0
22	7045031	.	G	A	10	13	23	0	0	23	0	0
22	7045041	.	C	A	9	11	20	0	1	21	0	0
22	7045070	.	C	T	13	5	18	1	0	19	0	0
22	7045215	.	A	G	9	5	14	0	0	14	0	0
22	7056645	.	C	T	8	7	15	0	0	15	0	0
22	7129212	.	G	C	4	2	6	0	0	6	0	0
22	7359844	.	T	C	4	4	8	0	0	8	0	0
22	7400193	.	A	G	6	5	11	0	0	11	0	0
22	7523909	.	T	G	2	2	4	0	0	4	0	0
22	7556516	.	C	T	1	2	3	0	0	3	0	0
22	7558417	.	C	T	2	5	7	0	0	7	0	0
22	7558430	.	T	A	2	4	6	0	0	6	0	0
22	7677356	.	C	T	1	3	4	0	0	4	0	0
22	7677434	.	G	A	4	2	6	2	0	8	0	0
22	7683759	.	C	T	0	3	3	0	5	8	0	0
22	7683828	.	T	G	2	6	8	0	0	8	0	0
22	7683921	.	T	C	3	3	6	2	0	8	0	0
22	7972792	.	A	G	1	2	3	1	1	5	0	0
22	7972848	.	A	G	5	5	10	2	0	12	0	0
22	7972851	.	T	C	4	6	10	2	0	12	0	0
22	7974164	.	C	A	5	4	9	1	0	10	0	0
22	8161183	.	A	C	6	4	10	0	1	11	0	0
22	8163863	.	T	C	3	0	3	0	4	7	0	0
22	8163993	.	G	T	1	7	8	0	0	8	0	0
22	8164035	.	C	T	2	5	7	0	0	7	0	0
22	8240843	.	G	A	1	4	5	0	0	5	0	0
22	8240852	.	A	T	1	3	4	0	0	4	0	0
22	8296588	.	T	G	3	3	6	0	1	7	0	0
22	8296594	.	A	C	3	2	5	0	1	6	0	0
22	8296714	.	C	T	3	4	7	0	0	7	0	0
22	8296763	.	G	T	5	5	10	0	0	10	0	0
22	8341167	.	A	G	6	2	8	0	0	8	0	0
22	8341173	.	T	C	4	2	6	0	0	6	0	0
22	8342100	.	A	G	6	3	9	0	0	9	0	0
22	8342112	.	C	T	3	3	6	0	0	6	0	0
22	8345273	.	T	G	1	12	13	1	1	15	0	0
22	8345282	.	A	C	2	8	10	1	0	11	0	0
22	8347579	.	A	G	1	6	7	1	0	8	0	0
22	8714656	.	A	G	2	5	7	0	0	7	0	0
22	8715391	.	T	C	1	1	2	0	0	2	0	0
22	8715470	.	A	T	3	4	7	0	0	7	0	0
22	8718437	.	T	A	1	3	4	1	0	5	0	0
22	8720236	.	A	G	1	4	5	0	0	5	0	0
22	8720240	.	T	C	1	2	3	0	0	3	0	0
22	8721410	.	C	T	1	2	3	0	1	4	0	0
22	8769274	.	T	G	5	0	5	0	0	5	0	0
22	8769428	.	A	G	3	3	6	1	0	7	0	0
22	8769431	.	A	G	2	3	5	1	1	7	0	0
22	8769777	.	G	A	2	2	4	0	0	4	0	0
22	8769782	.	C	T	2	2	4	0	0	4	0	0
22	8770151	.	T	G	2	4	6	0	0	6	0	0
22	8770153	.	G	A	2	4	6	0	0	6	0	0
22	8780847	.	C	T	2	4	6	0	0	6	0	0
22	8784305	.	G	T	4	3	7	0	0	7	0	0
22	8784345	.	A	G	5	0	5	0	3	8	0	0
22	8784446	.	A	T	1	2	3	0	0	3	0	0
22	8784585	.	T	A	3	2	5	0	0	5	0	0
22	8785016	.	T	C	6	2	8	0	0	8	0	0
22	8785185	.	A	G	1	1	2	3	2	7	0	0
22	8785223	.	G	A	4	2	6	2	0	8	0	0
22	8785647	.	T	C	3	2	5	0	0	5	0	0
22	8785832	.	G	T	2	4	6	0	0	6	0	0
22	8785853	.	C	T	4	2	6	0	1	7	0	0
22	8785914	.	C	T	5	4	9	0	0	9	0	0
22	8785965	.	C	T	4	2	6	0	0	6	0	0
22	8786056	.	T	G	3	2	5	0	0	5	0	0
22	8786060	.	C	T	3	1	4	0	0	4	0	0
22	8786177	.	A	G	3	3	6	0	0	6	0	0
22	8786178	.	G	T	3	3	6	0	0	6	0	0
22	8786379	.	T	A	4	2	6	0	0	6	0	0
22	8786385	.	C	T	4	2	6	0	0	6	0	0
22	8787335	.	G	C	0	3	3	0	4	7	0	0
22	8787382	.	T	G	3	2	5	2	0	7	0	0
22	8787384	.	C	T	4	2	6	2	0	8	0	0
22	8787636	.	T	A	1	4	5	0	1	6	0	0
22	8787704	.	A	C	3	5	8	0	1	9	0	0
22	8995938	.	A	T	3	2	5	0	0	5	0	0
22	8996198	.	A	T	6	2	8	0	1	9	0	0
22	9003621	.	T	C	1	1	2	0	1	3	0	0
22	9034743	.	C	G	1	2	3	2	1	6	0	0
22	9034756	.	A	G	1	2	3	2	1	6	0	0
22	9043624	.	T	C	1	2	3	0	0	3	0	0
22	9472870	.	T	C	5	4	9	0	1	10	0	0
22	9472873	.	T	C	5	4	9	0	0	9	0	0
22	9483293	.	C	T	5	6	11	0	0	11	0	0
22	9484355	.	T	C	6	4	10	0	0	10	0	0
22	9489885	.	A	G	6	10	16	0	0	16	0	0
22	9490730	.	C	T	5	10	15	0	0	15	0	0
22	9494144	.	A	G	8	6	14	0	0	14	0	0
22	9496453	.	C	T	6	5	11	0	0	11	0	0
22	9496608	.	A	G	5	6	11	0	1	12	0	0
22	9496933	.	T	A	3	6	9	0	0	9	0	0
22	9496954	.	G	A	1	8	9	0	6	15	0	0
22	9499564	.	C	T	11	7	18	0	1	19	0	0
22	9499579	.	C	G	12	0	12	0	5	17	0	0
22	9499762	.	T	C	5	7	12	0	0	12	0	0
22	9508704	.	T	G	19	10	29	0	1	30	0	0
22	9509637	.	G	A	0	17	17	0	14	31	0	0
22	9512565	.	A	C	16	21	37	0	2	39	0	0
22	9512628	.	T	C	13	24	37	0	3	40	0	0
22	9512630	.	T	C	14	26	40	0	1	41	0	0
22	9512670	.	C	T	14	22	36	0	0	36	0	0
22	9512717	.	C	T	12	10	22	2	1	25	0	0
22	9512731	.	T	A	11	10	21	2	2	25	0	0
22	9512829	.	A	G	3	9	12	0	1	13	0	0
22	9512885	.	T	G	10	7	17	0	2	19	0	0
22	9513039	.	C	T	7	7	14	0	2	16	0	0
22	9513048	.	T	C	8	9	17	0	0	17	0	0
22	9523557	.	A	T	4	6	10	0	1	12	1	0
22	9523618	.	A	G	4	4	8	0	0	8	0	0
22	9524673	.	T	C	4	3	7	0	0	7	0	0
22	9525415	.	C	T	4	4	8	0	0	8	0	0
22	9526254	.	T	G	5	4	9	0	0	9	0	0
22	9526389	.	C	T	10	6	16	0	0	16	0	0
22	9527373	.	T	C	5	4	9	0	0	9	0	0
22	9527409	.	T	C	6	6	12	0	0	12	0	0
22	9527439	.	G	T	6	8	14	0	1	15	0	0
22	9527450	.	C	G	8	8	16	0	1	17	0	0
22	9527983	.	A	G	9	8	17	0	4	21	0	0
22	9530328	.	T	C	2	8	10	0	0	10	0	0
22	9530388	.	C	T	4	7	11	0	1	12	0	0
22	9530418	.	A	G	6	0	6	0	7	13	0	0
22	9530571	.	T	C	6	5	11	0	1	12	0	0
22	9530598	.	G	A	4	9	13	0	1	14	0	0
22	9532339	.	C	T	8	3	11	0	1	12	0	0
22	9532431	.	G	A	10	10	20	0	0	20	0	0
22	9532455	.	T	C	11	11	22	0	0	22	0	0
22	9534066	.	C	T	12	8	20	0	0	20	0	0
22	9534138	.	C	T	5	7	12	0	1	13	0	0
22	9535191	.	T	C	4	4	8	0	1	9	0	0
22	9535290	.	C	T	8	7	15	0	0	15	0	0
22	9535890	.	T	C	7	6	13	0	2	15	0	0
22	9535914	.	G	A	7	10	17	0	1	18	0	0
22	9536134	.	G	A	1	17	18	0	8	26	0	0
22	9536984	.	C	T	12	17	29	0	1	30	0	0
22	9537165	.	A	G	14	19	33	0	1	34	0	0
22	9537186	.	T	C	12	20	32	0	1	33	0	0
22	9537267	.	T	C	8	17	25	0	2	27	0	0
22	9537339	.	C	T	11	13	24	0	2	26	0	0
22	9537637	.	T	C	19	19	38	0	1	40	1	0
22	9537640	.	T	C	21	19	40	0	0	40	0	0
22	9537779	.	A	G	17	0	17	0	13	30	0	0
22	9824674	.	T	G	3	3	6	0	0	6	0	0
22	9829814	.	T	A	1	1	2	0	1	3	0	0
22	9834718	.	G	A	1	2	3	0	0	3	0	0
22	9835189	.	T	C	4	4	8	0	0	8	0	0
22	9835481	.	C	T	2	3	5	0	0	5	0	0
22	9835482	.	C	G	2	3	5	0	0	5	0	0
22	9835951	.	A	G	3	2	5	0	0	5	0	0
22	9836274	.	T	A	1	3	4	0	0	4	0	0
22	9836301	.	G	C	3	2	5	0	0	5	0	0
22	9836312	.	C	A	0	2	2	0	4	6	0	0
22	9877900	.	G	T	4	2	6	0	0	6	0	0
22	9877902	.	C	T	4	2	6	0	0	6	0	0
22	9877998	.	A	G	5	2	7	0	0	7	0	0
22	9878028	.	T	A	2	2	4	0	0	4	0	0
22	9886990	.	C	T	0	8	8	0	5	13	0	0
22	9887054	.	A	T	3	4	7	0	0	7	0	0
22	9887434	.	G	A	1	6	7	0	0	7	0	0
22	9887777	.	T	A	3	3	6	0	0	6	0	0
22	9887881	.	A	G	2	2	4	1	0	5	0	0
22	9888366	.	G	A	1	2	3	2	0	5	0	0
22	9888379	.	C	T	0	3	3	2	1	6	0	0
22	9888591	.	A	G	2	2	4	0	0	4	0	0
22	9893357	.	A	T	4	1	5	0	0	5	0	0
22	9893360	.	T	C	4	1	5	0	0	5	0	0
22	9893595	.	C	T	1	2	3	4	0	7	0	0
22	9894327	.	G	T	2	6	8	1	1	10	0	0
22	9894340	.	T	G	4	4	8	0	0	8	0	0
22	9896120	.	G	A	2	2	4	0	0	4	0	0
22	9898031	.	A	G	5	4	9	0	0	9	0	0
22	9898052	.	A	G	4	3	7	0	0	7	0	0
22	9898190	.	A	C	4	2	6	1	0	7	0	0
22	9898259	.	C	A	3	2	5	0	0	5	0	0
22	9898277	.	C	T	0	2	2	1	4	7	0	0
22	9898355	.	C	T	8	6	14	0	0	14	0	0
22	9898445	.	G	A	3	2	5	1	0	6	0	0
22	9899453	.	T	C	2	3	5	0	0	5	0	0
22	9904699	.	C	T	1	3	4	0	0	4	0	0
22	9926532	.	C	G	3	4	7	0	0	7	0	0
22	9932947	.	C	G	4	2	6	0	0	6	0	0
22	9955229	.	T	G	1	2	3	0	0	3	0	0
22	9955252	.	A	C	2	2	4	0	0	4	0	0
22	10019568	.	C	T	2	5	7	0	0	7	0	0
22	10019712	.	A	G	5	3	8	0	1	9	0	0
22	10019742	.	T	C	3	0	3	0	3	6	0	0
22	10039086	.	T	C	0	0	0	0	4	4	0	0
22	10039100	.	G	T	2	4	6	0	0	6	0	0
22	10039124	.	T	C	2	3	5	0	0	5	0	0
22	10039630	.	G	A	2	3	5	1	0	6	0	0
22	10040000	.	G	A	5	3	8	0	0	8	0	0
22	10040015	.	C	T	1	6	7	0	2	9	0	0
22	10040099	.	C	T	0	2	2	0	2	4	0	0
22	10040240	.	A	G	5	2	7	0	0	7	0	0
22	10040273	.	T	C	2	4	6	0	0	6	0	0
22	10040363	.	G	A	3	1	4	0	0	4	0	0
22	10040381	.	G	A	3	3	6	0	0	6	0	0
22	10048389	.	G	T	2	3	5	0	0	5	0	0
22	10048950	.	C	A	1	2	3	0	0	3	0	0
22	10048952	.	C	T	1	2	3	0	0	3	0	0
22	10048996	.	C	T	2	2	4	0	0	4	0	0
22	10049292	.	C	T	2	3	5	0	2	7	0	0
22	10049308	.	C	A	4	3	7	0	0	7	0	0
22	10093048	.	C	T	1	2	3	0	0	3	0	0
22	10123910	.	G	C	14	12	26	0	1	27	0	0
22	10123962	.	T	C	7	0	7	0	18	25	0	0
22	10123998	.	C	T	0	8	8	0	13	21	0	0
22	10129878	.	A	G	7	3	10	0	1	11	0	0
22	10159001	.	C	T	7	3	10	0	2	12	0	0
22	10159339	.	C	T	5	9	14	0	0	14	0	0
22	10162958	.	A	T	6	9	15	0	0	15	0	0
22	10168219	.	T	C	6	5	11	0	0	11	0	0
22	10184031	.	G	T	5	6	11	0	0	11	0	0
22	10188095	.	C	T	9	3	12	0	0	12	0	0
22	10195894	.	A	C	6	2	8	0	8	16	0	0
22	10196297	.	A	T	13	9	22	0	0	22	0	0
22	10196330	.	C	T	11	7	18	0	1	19	0	0
22	10196394	.	G	A	0	7	7	0	16	23	0	0
22	10196468	.	A	T	12	5	17	1	2	20	0	0
22	10196483	.	A	G	11	4	15	0	1	16	0	0
22	10196621	.	C	A	10	12	22	0	0	22	0	0
22	10196634	.	C	T	10	11	21	0	2	23	0	0
22	10196864	.	G	A	12	8	20	1	0	21	0	0
22	10196951	.	C	A	11	11	22	0	2	24	0	0
22	10197061	.	C	T	5	11	16	0	1	17	0	0
22	10197100	.	T	G	10	4	14	0	1	15	0	0
22	10197146	.	C	T	10	10	20	0	3	23	0	0
22	10197180	.	T	A	16	10	26	0	0	26	0	0
22	10197796	.	G	C	1	11	12	0	9	21	0	0
22	10198075	.	T	G	5	0	5	0	6	11	0	0
22	10198120	.	A	T	6	5	11	0	0	11	0	0
22	10198167	.	G	A	14	8	22	0	0	22	0	0
22	10198178	.	A	T	12	10	22	0	1	23	0	0
22	10198211	.	T	C	12	8	20	0	1	21	0	0
22	10198232	.	T	A	9	8	17	0	0	17	0	0
22	10198283	.	T	C	8	9	17	0	0	17	0	0
22	10198335	.	A	C	17	9	26	0	0	26	0	0
22	10198399	.	T	A	19	21	40	0	3	43	0	0
22	10198737	.	G	A	7	16	23	0	0	23	0	0
22	10198779	.	G	C	6	10	16	0	0	16	0	0
22	10201858	.	G	C	1	6	7	0	3	10	0	0
22	10201888	.	G	A	16	17	33	0	1	34	0	0
22	10201906	.	G	A	0	25	25	0	20	45	0	0
22	10205736	.	C	T	24	10	34	0	3	37	0	0
22	10207978	.	A	T	19	20	39	0	1	40	0	0
22	10208011	.	T	C	19	24	43	0	0	43	0	0
22	10208032	.	A	C	17	21	38	0	1	39	0	0
22	10208089	.	C	T	22	17	39	0	1	40	0	0
22	10208101	.	T	G	19	25	44	0	3	47	0	0
22	10208134	.	G	A	20	24	44	0	1	45	0	0
22	10208182	.	C	T	14	25	39	0	4	43	0	0
22	10208404	.	C	T	26	15	41	0	1	42	0	0
22	10210467	.	T	C	24	21	45	0	0	45	0	0
22	10211754	.	C	T	25	18	43	0	2	45	0	0
22	10212089	.	C	T	21	31	52	0	1	53	0	0
22	10212161	.	A	C	32	20	52	0	1	53	0	0
22	10212230	.	C	G	27	20	47	0	3	50	0	0
22	10212417	.	T	A	5	11	16	0	0	16	0	0
22	10215007	.	T	C	1	2	3	0	0	3	0	0
22	10215008	.	G	A	1	2	3	0	0	3	0	0
22	10215120	.	A	G	2	4	6	0	0	6	0	0
22	10215135	.	A	G	3	4	7	0	0	7	0	0
22	10220257	.	C	T	9	4	13	0	0	13	0	0
22	10220259	.	T	C	9	4	13	0	0	13	0	0
22	10220298	.	A	T	10	4	14	0	0	14	0	0
22	10220444	.	G	T	2	12	14	0	12	26	0	0
22	10220451	.	C	T	13	10	23	0	3	26	0	0
22	10260078	.	A	G	1	4	5	0	1	6	0	0
22	10260468	.	A	G	3	0	3	0	3	6	0	0
22	10260774	.	C	T	5	5	10	0	0	10	0	0
22	10260828	.	C	T	7	6	13	0	0	13	0	0
22	10261792	.	T	A	9	7	16	0	0	16	0	0
22	10261840	.	T	C	14	9	23	0	0	23	0	0
22	10261888	.	C	T	8	14	22	0	2	24	0	0
22	10261945	.	A	C	14	14	28	0	0	28	0	0
22	10262216	.	A	T	8	10	18	0	0	18	0	0
22	10361385	.	C	G	4	3	7	0	0	7	0	0
22	10361391	.	T	C	4	3	7	0	0	7	0	0
22	10361577	.	G	C	5	0	5	0	11	16	0	0
22	10361787	.	C	G	12	9	21	0	2	23	0	0
22	10361889	.	A	G	6	19	25	0	0	25	0	0
22	10361892	.	A	G	4	16	20	0	3	23	0	0
22	10361937	.	C	T	3	9	12	0	9	21	0	0
22	10361964	.	T	C	12	0	12	0	11	23	0	0
22	10362003	.	T	G	9	13	22	0	1	23	0	0
22	10362174	.	C	T	1	10	11	0	8	19	0	0
22	10364681	.	A	G	6	9	15	0	2	17	0	0
22	10372847	.	C	T	0	10	10	0	9	19	0	0
22	10372950	.	A	C	7	0	7	0	6	13	0	0
22	10373081	.	T	C	6	0	6	0	8	14	0	0
22	10373118	.	A	T	6	7	13	0	0	13	0	0
22	10373263	.	G	T	6	6	12	0	0	12	0	0
22	10373795	.	A	T	3	4	7	0	0	7	0	0
22	10373849	.	G	A	3	3	6	0	0	6	0	0
22	10373879	.	C	A	1	3	4	0	1	5	0	0
22	10374012	.	G	A	2	2	4	0	1	5	0	0
22	10374042	.	A	C	5	3	8	0	0	8	0	0
22	10390580	.	T	A	2	2	4	0	0	4	0	0
22	10391347	.	C	T	3	3	6	0	0	6	0	0
22	10396692	.	G	A	2	2	4	0	0	4	0	0
22	10430183	.	C	A	0	2	2	0	5	7	0	0
22	10430189	.	A	G	2	4	6	0	0	6	0	0
22	10430252	.	A	G	3	2	5	0	0	5	0	0
22	10430572	.	G	A	1	2	3	0	0	3	0	0
22	10430709	.	T	C	3	3	6	0	0	6	0	0
22	10434615	.	C	T	2	2	4	0	0	4	0	0
22	10434709	.	T	A	2	3	5	0	0	5	0	0
22	10480588	.	A	G	1	2	3	0	0	3	0	0
22	10514288	.	G	T	7	9	16	1	0	17	0	0
22	10514303	.	G	C	7	0	7	1	8	16	0	0
22	10517499	.	T	C	3	0	3	0	3	6	0	0
22	10517505	.	A	C	3	0	3	0	3	6	0	0
22	10638667	.	G	T	11	3	14	0	0	14	0	0
22	12391480	.	A	G	3	0	3	0	3	6	0	0
22	13977910	.	T	G	4	8	12	0	0	12	0	0
22	13978228	.	T	C	9	5	14	0	0	14	0	0
22	13978465	.	A	G	9	1	10	0	6	16	0	0
22	13978480	.	T	C	8	5	13	0	0	13	0	0
22	13978849	.	C	T	5	7	12	0	1	13	0	0
22	14078027	.	C	T	0	2	2	0	1	3	0	0
22	14124381	.	C	T	25	13	38	0	3	41	0	0
22	14124465	.	G	A	15	17	32	0	1	33	0	0
22	14124655	.	C	T	19	16	35	0	1	36	0	0
22	14125440	.	T	A	8	4	12	0	1	13	0	0
22	14125448	.	A	T	8	6	14	0	0	14	0	0
22	14366222	.	G	A	8	6	14	0	0	14	0	0
22	14398645	.	G	A	4	5	9	0	0	9	0	0
22	14402487	.	T	A	1	4	5	0	0	5	0	0
22	14402488	.	G	A	1	4	5	0	0	5	0	0
22	14402524	.	A	G	2	3	5	0	0	5	0	0
22	14416459	.	T	C	2	2	4	0	0	4	0	0
22	14427749	.	G	A	2	3	5	0	0	5	0	0
22	14454650	.	T	C	2	4	6	0	0	6	0	0
22	14458857	.	T	A	3	2	5	0	0	5	0	0
22	14459142	.	A	G	1	2	3	0	0	3	0	0
22	14461508	.	G	A	2	2	4	0	0	4	0	0
22	14539620	.	C	T	0	2	2	0	1	3	0	0
22	14560499	.	G	T	1	3	4	0	0	4	0	0
22	15010349	.	T	C	2	1	3	0	1	4	0	0
22	15010604	.	C	A	1	2	3	0	0	3	0	0
22	15345339	.	T	A	7	8	15	0	0	15	0	0
22	15384695	.	T	C	6	0	6	0	7	13	0	0
22	15384759	.	A	T	8	4	12	0	0	12	0	0
22	15385143	.	T	A	5	4	9	0	0	9	0	0
22	15540211	.	C	G	6	3	9	0	0	9	0	0
22	15540229	.	C	T	4	7	11	0	0	11	0	0
22	15541031	.	T	A	2	3	5	0	0	5	0	0
22	15543490	.	C	T	4	4	8	0	0	8	0	0
22	15545930	.	T	A	4	11	15	0	0	15	0	0
22	15548150	.	C	T	7	8	15	0	1	16	0	0
22	15552139	.	C	A	3	3	6	0	0	6	0	0
22	15579211	.	G	A	7	2	9	0	1	10	0	0
22	15629686	.	T	C	2	2	4	0	0	4	0	0
22	15696007	.	A	G	24	18	42	0	3	45	0	0
22	15696026	.	A	G	25	27	52	0	1	53	0	0
22	15696191	.	T	G	27	29	56	0	3	59	0	0
22	15700157	.	C	T	1	20	21	0	15	36	0	0
22	15701561	.	G	A	13	17	30	1	4	35	0	0
22	15701636	.	A	G	23	9	32	0	2	34	0	0
22	15704622	.	C	T	18	21	39	0	1	40	0	0
22	15719625	.	T	A	13	14	27	0	2	29	0	0
22	15719672	.	G	T	16	14	30	0	3	33	0	0
22	15719682	.	G	A	17	14	31	0	0	31	0	0
22	15719891	.	T	C	12	23	35	0	2	37	0	0
22	15720199	.	A	G	10	15	25	0	0	25	0	0
22	15720200	.	C	A	0	15	15	0	10	25	0	0
22	15720250	.	T	G	18	13	31	0	0	31	0	0
22	15720583	.	C	T	5	3	8	0	0	8	0	0
22	15721436	.	C	T	9	5	14	0	0	14	0	0
22	15721443	.	C	T	4	7	11	0	0	11	0	0
22	15900745	.	T	C	2	4	6	0	1	7	0	0
22	15912259	.	A	G	3	5	8	0	0	8	0	0
22	15912298	.	C	T	3	10	13	0	1	14	0	0
22	15912346	.	C	T	2	6	8	0	16	24	0	0
22	15915611	.	G	A	1	2	3	0	1	4	0	0
22	15917855	.	G	A	9	7	16	0	1	17	0	0
22	15929136	.	A	G	15	15	30	0	1	31	0	0
22	15932428	.	C	A	6	11	17	0	1	18	0	0
22	15943833	.	G	A	6	6	12	0	1	13	0	0
22	15979650	.	G	A	0	2	2	0	1	3	0	0
22	15979827	.	C	T	2	2	4	0	0	4	0	0
22	16002106	.	C	T	4	7	11	0	0	11	0	0
22	16002121	.	C	G	5	0	5	0	7	12	0	0
22	16002161	.	T	C	3	9	12	0	0	12	0	0
22	16002283	.	A	T	2	5	7	0	0	7	0	0
22	16032550	.	T	G	5	4	9	0	0	9	0	0
22	16033259	.	T	C	2	3	5	0	1	6	0	0
22	16033622	.	G	T	3	2	5	0	0	5	0	0
22	16038660	.	G	A	4	10	14	0	0	14	0	0
22	16038749	.	A	G	8	10	18	0	0	18	0	0
22	16038858	.	T	G	5	6	11	0	0	11	0	0
22	16039194	.	C	A	8	6	14	0	1	15	0	0
22	16039398	.	A	C	2	3	5	0	2	7	0	0
22	16097243	.	G	A	3	4	7	0	0	7	0	0
22	16097261	.	T	G	3	5	8	0	0	8	0	0
22	16097286	.	T	C	2	3	5	0	0	5	0	0
22	16103558	.	G	C	2	3	5	0	0	5	0	0
22	16103563	.	G	C	0	2	2	0	1	3	0	0
22	16120728	.	A	G	4	4	8	0	0	8	0	0
22	16120766	.	T	C	4	2	6	0	0	6	0	0
22	16120828	.	A	G	2	4	6	0	0	6	0	0
22	16121035	.	T	A	3	8	11	0	0	11	0	0
22	16121281	.	C	A	4	3	7	0	1	8	0	0
22	16123437	.	T	G	6	8	14	0	0	14	0	0
22	16123931	.	A	G	7	4	11	0	1	12	0	0
22	16144846	.	G	T	6	4	10	0	0	10	0	0
22	16150462	.	A	G	5	6	11	0	0	11	0	0
22	16171869	.	G	A	8	4	12	0	0	12	0	0
22	16171871	.	A	G	9	4	13	0	0	13	0	0
22	16173329	.	A	G	8	3	11	0	0	11	0	0
22	16173380	.	T	G	1	3	4	0	0	4	0	0
22	16174400	.	T	A	4	2	6	0	1	7	0	0
22	16175977	.	C	T	3	2	5	0	1	6	0	0
22	16177938	.	T	C	3	0	3	0	5	8	0	0
22	16191912	.	C	A	0	2	2	0	1	3	0	0
22	16191920	.	T	A	1	2	3	0	0	3	0	0
22	16192216	.	T	C	1	0	1	0	2	3	0	0
22	16192428	.	C	A	2	3	5	0	0	5	0	0
22	16193024	.	T	C	3	0	3	0	5	8	0	0
22	16270437	.	G	A	1	2	3	0	1	4	0	0
22	16270441	.	T	A	2	2	4	0	1	5	0	0
22	16282444	.	T	A	9	2	11	0	0	11	0	0
22	16282446	.	T	A	7	2	9	0	2	11	0	0
22	16282571	.	T	A	7	11	18	0	0	18	0	0
22	16282636	.	T	G	7	6	13	0	0	13	0	0
22	16282757	.	C	G	1	5	6	0	8	14	0	0
22	16285578	.	G	A	3	3	6	0	0	6	0	0
22	16287499	.	T	G	8	2	10	0	0	10	0	0
22	16287608	.	T	G	6	3	9	0	0	9	0	0
22	16287659	.	C	T	0	3	3	0	10	13	0	0
22	16290698	.	G	A	3	7	10	0	0	10	0	0
22	16290906	.	G	A	6	2	8	0	0	8	0	0
22	16298535	.	G	T	0	5	5	0	4	9	0	0
22	16298666	.	T	C	2	5	7	0	0	7	0	0
22	16298720	.	A	C	6	6	12	0	2	14	0	0
22	16298756	.	C	T	9	6	15	0	0	15	0	0
22	16302465	.	C	T	7	3	10	0	0	10	0	0
22	16302468	.	C	T	7	3	10	0	1	11	0	0
22	16302877	.	A	T	5	4	9	0	1	10	0	0
22	16302922	.	A	G	4	9	13	0	0	13	0	0
22	16305098	.	C	A	10	5	15	0	0	15	0	0
22	16305164	.	A	C	7	10	17	0	0	17	0	0
22	16312399	.	A	G	6	3	9	0	0	9	0	0
22	16312755	.	T	C	6	3	9	0	0	9	0	0
22	16312783	.	C	T	1	2	3	0	4	7	0	0
22	16313005	.	T	A	3	8	11	0	0	11	0	0
22	16313093	.	C	A	0	2	2	0	3	5	0	0
22	16313095	.	C	A	3	2	5	0	0	5	0	0
22	16324766	.	G	A	2	3	5	0	0	5	0	0
22	16340761	.	A	G	6	3	9	0	0	9	0	0
22	16342137	.	C	T	2	2	4	0	0	4	0	0
22	16350811	.	T	G	19	19	38	1	3	42	0	0
22	16351199	.	C	G	20	14	34	0	0	34	0	0
22	16351204	.	C	T	2	13	15	0	20	35	0	0
22	16351317	.	G	A	10	5	15	0	1	16	0	0
22	16351552	.	A	T	3	7	10	0	0	10	0	0
22	16352154	.	C	G	1	2	3	0	0	3	0	0
22	16352349	.	A	G	9	18	27	0	0	27	0	0
22	16352463	.	C	A	1	16	17	0	11	28	0	0
22	16352469	.	A	G	10	13	23	0	1	24	0	0
22	16352528	.	G	A	7	12	19	0	0	19	0	0
22	16352668	.	T	C	21	0	21	0	9	30	0	0
22	16352739	.	C	T	2	13	15	0	13	28	0	0
22	16355013	.	A	C	16	15	31	0	0	31	0	0
22	16355042	.	C	A	21	7	28	0	1	29	0	0
22	16355555	.	A	G	7	9	16	0	2	18	0	0
22	16357818	.	A	G	8	11	19	0	1	20	0	0
22	16357831	.	A	G	8	12	20	0	0	20	0	0
22	16357867	.	G	A	10	12	22	0	0	22	0	0
22	16367007	.	T	C	4	0	4	0	8	12	0	0
22	16367055	.	A	G	4	7	11	0	2	13	0	0
22	16368886	.	G	A	11	13	24	0	0	24	0	0
22	16377364	.	A	G	7	4	11	0	1	12	0	0
22	16407173	.	T	G	2	2	4	0	0	4	0	0
22	16407177	.	G	C	2	2	4	0	0	4	0	0
22	16411199	.	G	A	2	2	4	0	0	4	0	0
22	16412091	.	A	G	1	2	3	0	0	3	0	0
22	16416462	.	T	C	4	2	6	0	1	7	0	0
22	16422166	.	A	G	8	0	8	0	7	15	0	0
22	16424576	.	T	C	8	2	10	0	3	13	0	0
22	16430672	.	C	T	18	5	23	0	0	23	0	0
22	16432627	.	C	T	18	18	36	0	3	39	0	0
22	16432628	.	A	T	19	20	39	0	1	40	0	0
22	16433078	.	G	A	18	10	28	0	0	28	0	0
22	16433096	.	A	G	19	13	32	0	0	32	0	0
22	16433131	.	T	G	15	9	24	0	3	27	0	0
22	16433250	.	G	A	4	4	8	0	0	8	0	0
22	16433647	.	A	G	2	2	4	0	0	4	0	0
22	16433912	.	T	A	7	5	12	0	1	13	0	0
22	16433940	.	C	T	10	8	18	0	0	18	0	0
22	16434056	.	G	A	16	14	30	0	1	31	0	0
22	16438112	.	A	C	21	22	43	0	0	43	0	0
22	16440086	.	T	C	10	0	10	0	12	22	0	0
22	16484277	.	T	A	9	12	21	2	2	25	0	0
22	16484621	.	G	A	6	9	15	0	0	15	0	0
22	16484877	.	A	T	4	7	11	0	0	11	0	0
22	16484938	.	A	G	12	17	29	0	1	30	0	0
22	16484944	.	T	C	12	17	29	0	0	29	0	0
22	16485035	.	A	G	9	10	19	0	1	20	0	0
22	16485538	.	T	C	11	0	11	0	5	16	0	0
22	16485563	.	A	T	6	3	9	0	0	9	0	0
22	16485625	.	A	G	1	3	4	0	0	4	0	0
22	16485688	.	G	A	3	4	7	0	0	7	0	0
22	16485920	.	G	A	7	14	21	0	0	21	0	0
22	16485954	.	C	T	5	11	16	0	3	19	0	0
22	16485962	.	C	G	5	6	11	0	4	15	0	0
22	16485994	.	C	A	3	6	9	0	0	9	0	0
22	16486004	.	C	A	1	10	11	0	0	11	0	0
22	16486112	.	T	C	6	18	24	0	0	24	0	0
22	16491693	.	G	A	8	18	26	0	0	26	0	0
22	16491720	.	T	C	11	0	11	0	16	27	0	0
22	16491942	.	G	A	21	14	35	0	1	36	0	0
22	16492000	.	T	A	17	8	25	0	2	27	0	0
22	16497953	.	G	A	16	15	31	0	2	33	0	0
22	16498155	.	G	C	0	15	15	0	11	26	0	0
22	16498317	.	A	G	18	16	34	0	1	35	0	0
22	16498661	.	A	G	12	0	12	0	9	21	0	0
22	16537701	.	C	T	1	3	4	0	0	4	0	0
22	16543627	.	C	T	14	18	32	0	1	33	0	0
22	16543714	.	T	C	12	19	31	0	1	32	0	0
22	16544243	.	C	T	11	7	18	0	1	19	0	0
22	16544260	.	C	T	15	6	21	0	2	23	0	0
22	16544384	.	G	A	15	12	27	0	0	27	0	0
22	16544400	.	T	G	15	10	25	0	0	25	0	0
22	16544599	.	A	G	19	1	20	0	17	37	0	0
22	16544674	.	T	G	18	16	34	0	1	35	0	0
22	16544780	.	A	T	19	16	35	0	1	36	0	0
22	16544800	.	G	A	14	13	27	0	1	28	0	0
22	16569862	.	C	T	10	9	19	0	0	19	0	0
22	16584241	.	C	G	12	17	29	0	0	29	0	0
22	16592011	.	A	G	16	8	24	0	0	24	0	0
22	16592029	.	C	G	1	6	7	0	17	24	0	0
22	16594870	.	T	A	8	10	18	0	0	18	0	0
22	16594981	.	C	A	7	9	16	0	0	16	0	0
22	16595022	.	A	G	12	8	20	0	1	21	0	0
22	16601400	.	C	T	8	5	13	1	1	15	0	0
22	16609449	.	T	C	12	7	19	0	3	22	0	0
22	16609494	.	G	A	12	8	20	0	0	20	0	0
22	16614011	.	C	T	7	5	12	0	1	13	0	0
22	16775306	.	C	T	9	12	21	0	1	22	0	0
22	16840292	.	T	C	8	4	12	0	0	12	0	0
22	17506016	.	C	A	9	0	9	0	20	29	0	0
22	18231256	.	T	A	6	2	8	0	0	8	0	0
22	18231903	.	T	A	1	2	3	0	0	3	0	0
22	18233234	.	T	C	1	4	5	0	1	6	0	0
22	18896221	.	G	A	0	3	3	0	1	4	0	0
22	18966298	.	T	C	5	3	8	0	0	8	0	0
22	18966421	.	G	A	5	4	9	0	0	9	0	0
22	18966529	.	A	T	2	4	6	0	0	6	0	0
22	18966575	.	T	C	1	3	4	0	0	4	0	0
22	18971697	.	T	C	9	5	14	1	0	15	0	0
22	18971725	.	T	C	8	4	12	1	0	13	0	0
22	18971736	.	T	C	9	3	12	1	0	13	0	0
22	19006763	.	T	C	6	7	13	0	0	13	0	0
22	19006994	.	T	C	9	21	30	0	2	32	0	0
22	19007574	.	A	G	12	12	24	0	3	27	0	0
22	19007677	.	C	A	14	15	29	0	0	29	0	0
22	19007764	.	A	G	9	11	20	0	0	20	0	0
22	19074484	.	T	A	1	3	4	0	0	4	0	0
22	19098467	.	C	T	0	2	2	0	1	3	0	0
22	19149941	.	A	G	1	0	1	0	3	4	0	0
22	19547501	.	A	T	5	7	12	0	0	12	0	0
22	19547573	.	C	G	0	11	11	0	14	25	0	0
22	19547575	.	A	C	12	1	13	0	12	25	0	0
22	19547796	.	C	T	12	23	35	0	0	35	0	0
22	19552745	.	C	T	10	9	19	0	2	21	0	0
22	19645464	.	A	G	2	0	2	0	2	4	0	0
22	19645673	.	C	G	2	0	2	0	2	4	0	0
22	19665618	.	C	T	6	16	22	0	2	24	0	0
22	19671776	.	A	G	12	16	28	0	1	29	0	0
22	20105123	.	C	G	5	4	9	0	0	9	0	0
22	20105242	.	A	G	5	5	10	0	1	11	0	0
22	20105353	.	G	A	2	2	4	0	1	5	0	0
22	20105500	.	G	A	5	4	9	0	0	9	0	0
22	20105686	.	T	C	2	4	6	0	0	6	0	0
22	20139156	.	T	C	1	2	3	0	0	3	0	0
22	20141539	.	C	G	6	3	9	0	0	9	0	0
22	20141551	.	C	A	5	3	8	0	0	8	0	0
22	20142031	.	T	C	4	2	6	1	0	7	0	0
22	20142035	.	A	T	2	2	4	1	1	6	0	0
22	20142160	.	T	C	5	2	7	0	0	7	0	0
22	20142713	.	C	T	3	3	6	0	0	6	0	0
22	20142723	.	A	T	3	4	7	0	0	7	0	0
22	20142753	.	T	A	3	8	11	0	0	11	0	0
22	20142772	.	T	G	4	5	9	0	1	10	0	0
22	20143002	.	G	T	3	5	8	0	0	8	0	0
22	20143138	.	A	G	3	5	8	0	0	8	0	0
22	20143143	.	G	T	3	5	8	0	0	8	0	0
22	20159200	.	A	C	18	11	29	0	0	29	0	0
22	20159576	.	A	T	18	17	35	0	4	40	1	0
22	20159771	.	C	A	17	20	37	0	1	38	0	0
22	20164449	.	T	C	14	14	28	0	0	28	0	0
22	20169411	.	A	C	6	5	11	0	1	12	0	0
22	20169429	.	G	A	10	9	19	0	1	20	0	0
22	20172105	.	A	G	6	0	6	0	6	12	0	0
22	20172642	.	A	G	10	10	20	0	0	20	0	0
22	20175295	.	G	A	11	6	17	0	0	17	0	0
22	20177970	.	G	A	0	8	8	0	3	11	0	0
22	20177981	.	G	A	3	9	12	0	0	12	0	0
22	20178045	.	C	T	6	7	13	0	0	13	0	0
22	20178065	.	T	C	6	7	13	0	0	13	0	0
22	20211187	.	T	C	3	4	7	0	0	7	0	0
22	20211289	.	G	T	1	4	5	0	2	7	0	0
22	20212794	.	G	T	1	11	12	0	4	16	0	0
22	20214649	.	G	A	1	6	7	0	5	12	0	0
22	20215089	.	T	A	12	11	23	0	1	24	0	0
22	20215351	.	C	T	6	5	11	0	0	11	0	0
22	20220161	.	A	G	13	0	13	0	5	18	0	0
22	20220197	.	C	T	9	10	19	0	2	21	0	0
22	20222950	.	G	C	8	5	13	0	0	13	0	0
22	20230044	.	T	C	14	13	27	0	0	27	0	0
22	20240483	.	T	C	14	17	31	0	5	36	0	0
22	20240835	.	A	G	19	16	35	0	0	35	0	0
22	20292595	.	A	T	8	9	17	0	0	17	0	0
22	20292789	.	T	C	21	18	39	0	5	44	0	0
22	20293049	.	T	A	6	3	9	0	0	9	0	0
22	20293440	.	G	A	18	7	25	0	1	26	0	0
22	20296615	.	A	T	17	30	47	1	1	49	0	0
22	20296669	.	T	C	22	24	46	1	2	49	0	0
22	20299280	.	A	G	24	23	47	0	3	50	0	0
22	20299283	.	G	A	24	26	50	0	1	51	0	0
22	20299349	.	T	C	22	24	46	0	3	49	0	0
22	20303406	.	A	G	23	16	39	0	0	39	0	0
22	20303412	.	G	T	23	10	33	0	3	36	0	0
22	20303487	.	A	G	21	35	56	0	4	60	0	0
22	20305443	.	G	T	25	22	47	1	1	49	0	0
22	20313722	.	C	A	11	14	25	1	7	33	0	0
22	20313791	.	A	G	15	10	25	0	0	25	0	0
22	20313887	.	C	G	16	11	27	0	1	28	0	0
22	20313926	.	C	A	3	10	13	0	14	27	0	0
22	20315851	.	T	C	13	0	13	0	8	21	0	0
22	20315883	.	C	T	17	8	25	0	0	25	0	0
22	20315896	.	G	A	18	11	29	0	0	29	0	0
22	20316020	.	G	A	19	16	35	0	1	36	0	0
22	20318937	.	C	T	2	13	15	0	8	23	0	0
22	20319149	.	A	G	13	14	27	0	3	30	0	0
22	20388853	.	G	A	15	11	26	0	1	27	0	0
22	20389198	.	C	A	14	12	26	0	1	27	0	0
22	20389286	.	A	G	7	7	14	0	1	15	0	0
22	20389392	.	A	G	5	11	16	0	1	17	0	0
22	20389538	.	A	T	15	7	22	0	0	22	0	0
22	20389545	.	G	A	17	7	24	0	0	24	0	0
22	20389580	.	T	G	22	6	28	0	2	30	0	0
22	20389620	.	T	A	22	12	34	0	1	35	0	0
22	20390002	.	C	A	13	13	26	0	0	26	0	0
22	20390041	.	C	T	16	16	32	0	1	33	0	0
22	20402889	.	T	C	5	5	10	0	1	11	0	0
22	20407002	.	C	T	1	7	8	0	6	14	0	0
22	20408865	.	T	C	10	2	12	0	13	25	0	0
22	20409099	.	C	T	4	5	9	0	0	9	0	0
22	20478274	.	T	C	1	2	3	0	0	3	0	0
22	20478503	.	T	C	1	2	3	0	0	3	0	0
22	20574066	.	T	C	3	19	22	0	1	23	0	0
22	20574402	.	A	G	4	12	16	0	0	16	0	0
22	20574585	.	A	G	9	7	16	0	0	16	0	0
22	20575634	.	G	A	3	2	5	0	0	5	0	0
22	20783134	.	T	G	1	3	4	0	0	4	0	0
22	20791016	.	T	C	2	2	4	0	0	4	0	0
22	20792054	.	T	C	1	2	3	0	0	3	0	0
22	20794383	.	A	G	1	4	5	0	0	5	0	0
22	20797556	.	G	A	4	4	8	0	0	8	0	0
22	20848297	.	G	A	4	5	9	0	0	9	0	0
22	20848326	.	C	T	5	3	8	0	0	8	0	0
22	20848488	.	G	A	7	10	17	0	1	18	0	0
22	20848501	.	A	G	5	8	13	0	0	13	0	0
22	20877036	.	T	C	4	1	5	0	2	7	0	0
22	20926412	.	C	T	8	6	14	0	0	14	0	0
22	20926466	.	G	A	13	5	18	0	1	19	0	0
22	20926511	.	G	A	8	6	14	0	0	14	0	0
22	20940039	.	C	T	1	7	8	0	9	17	0	0
22	20940048	.	G	A	8	8	16	0	0	16	0	0
22	20944679	.	A	G	10	9	19	0	0	19	0	0
22	20951387	.	T	C	9	1	10	0	10	20	0	0
22	20951514	.	C	T	1	12	13	0	16	29	0	0
22	20951788	.	G	A	23	16	39	0	0	39	0	0
22	20951861	.	C	T	12	7	19	0	0	19	0	0
22	20951866	.	G	T	10	5	15	0	0	15	0	0
22	20952257	.	A	G	25	19	44	0	4	48	0	0
22	20952292	.	A	T	24	18	42	0	1	43	0	0
22	20953053	.	T	A	10	10	20	0	1	21	0	0
22	20953127	.	A	T	10	4	14	0	0	14	0	0
22	20953141	.	C	A	10	3	13	0	0	13	0	0
22	20953418	.	G	A	17	8	25	0	2	27	0	0
22	20953555	.	C	A	15	10	25	0	1	26	0	0
22	20953578	.	A	G	17	6	23	0	1	24	0	0
22	20954310	.	A	G	1	2	3	0	1	4	0	0
22	20954386	.	C	T	5	7	12	0	1	13	0	0
22	20954391	.	C	T	5	8	13	0	1	14	0	0
22	20954557	.	T	A	5	8	13	0	0	13	0	0
22	20954717	.	A	T	7	16	23	0	4	27	0	0
22	20954810	.	C	T	0	14	14	0	15	29	0	0
22	20954953	.	C	T	11	22	33	0	2	35	0	0
22	20955427	.	C	T	1	6	7	0	6	13	0	0
22	20955469	.	C	T	1	6	7	0	5	12	0	0
22	21032184	.	A	G	7	10	17	0	1	18	0	0
22	21128200	.	A	G	8	13	21	2	5	28	0	0
22	21129075	.	G	A	29	29	58	0	10	68	0	0
22	21129101	.	G	A	32	30	62	0	6	68	0	0
22	21129407	.	A	G	33	35	68	0	0	68	0	0
22	21129558	.	T	G	30	36	66	0	0	66	0	0
22	21129575	.	T	C	30	33	63	0	3	66	0	0
22	21314371	.	A	G	1	2	3	0	1	4	0	0
22	21361753	.	T	C	7	6	13	0	0	13	0	0
22	21365143	.	C	T	0	3	3	0	2	5	0	0
22	21366552	.	T	C	2	1	3	0	1	4	0	0
22	21367155	.	G	C	5	5	10	0	0	10	0	0
22	21407312	.	T	C	4	3	7	0	0	7	0	0
22	21446480	.	A	G	3	4	7	0	1	8	0	0
22	21454448	.	A	G	4	0	4	0	5	9	0	0
22	21465109	.	T	C	3	4	7	0	0	7	0	0
22	21465156	.	T	C	1	3	4	0	0	4	0	0
22	21465263	.	T	C	1	7	8	0	0	8	0	0
22	21465597	.	G	T	4	4	8	0	0	8	0	0
22	21465606	.	T	C	4	3	7	0	0	7	0	0
22	21544232	.	G	A	4	3	7	0	0	7	0	0
22	21583985	.	G	A	1	3	4	0	0	4	0	0
22	21584038	.	G	A	2	7	9	0	0	9	0	0
22	21618633	.	G	A	6	7	13	0	1	14	0	0
22	21624764	.	G	C	6	5	11	0	1	12	0	0
22	21657871	.	C	T	9	5	14	0	0	14	0	0
22	21661029	.	T	C	6	4	10	0	0	10	0	0
22	21661071	.	G	A	0	2	2	0	6	8	0	0
22	21661258	.	T	A	8	5	13	0	2	15	0	0
22	21661569	.	C	T	1	2	3	5	0	8	0	0
22	21661611	.	A	G	2	0	2	0	2	4	0	0
22	21661789	.	G	A	9	9	18	1	1	20	0	0
22	21661819	.	T	C	2	11	13	1	2	16	0	0
22	21662138	.	G	A	0	4	4	1	2	7	0	0
22	21675905	.	T	A	2	3	5	0	0	5	0	0
22	21676233	.	G	A	6	4	10	5	0	15	0	0
22	21676296	.	G	A	2	13	15	2	1	18	0	0
22	21680218	.	G	T	1	8	9	0	0	9	0	0
22	21680240	.	T	A	3	4	7	0	1	8	0	0
22	21697826	.	T	C	2	2	4	0	0	4	0	0
22	21852158	.	C	T	18	18	36	0	3	39	0	0
22	21852269	.	A	G	16	9	25	0	4	29	0	0
22	21852281	.	T	C	14	0	14	0	13	27	0	0
22	22130015	.	T	A	5	3	8	0	0	8	0	0
22	22130085	.	C	T	4	5	9	0	1	10	0	0
22	22130255	.	G	A	4	3	7	0	1	8	0	0
22	22141567	.	G	A	4	3	7	0	0	7	0	0
22	22142302	.	A	G	2	3	5	0	2	7	0	0
22	22164223	.	T	G	3	4	7	0	1	8	0	0
22	22175516	.	C	T	0	12	12	0	10	22	0	0
22	22179825	.	C	T	13	9	22	0	0	22	0	0
22	22188682	.	T	C	18	6	24	0	0	24	0	0
22	22196339	.	G	A	2	7	9	0	2	11	0	0
22	22199227	.	G	A	7	5	12	0	2	14	0	0
22	22204002	.	C	T	3	7	10	0	0	10	0	0
22	22204098	.	C	T	6	7	13	0	0	13	0	0
22	22204395	.	G	A	10	9	19	0	0	19	0	0
22	22204440	.	G	A	10	9	19	0	0	19	0	0
22	22214852	.	T	C	2	6	8	0	0	8	0	0
22	22215458	.	G	T	7	2	9	0	2	11	0	0
22	22231662	.	C	T	9	3	12	0	0	12	0	0
22	22231717	.	A	T	8	3	11	0	1	12	0	0
22	22234418	.	C	T	1	9	10	0	12	22	0	0
22	22240918	.	G	A	17	9	26	0	1	27	0	0
22	22241772	.	A	T	14	9	23	0	1	24	0	0
22	22245400	.	T	C	9	11	20	0	0	20	0	0
22	22245781	.	G	T	12	9	21	0	0	22	1	0
22	22251493	.	A	C	10	0	10	0	6	16	0	0
22	22259155	.	G	A	5	6	11	0	0	11	0	0
22	22260456	.	G	A	1	4	5	0	0	5	0	0
22	22266519	.	T	C	4	5	9	0	2	11	0	0
22	22267524	.	G	C	0	4	4	0	4	8	0	0
22	22273388	.	C	T	8	4	12	0	0	12	0	0
22	22273736	.	G	A	0	4	4	0	8	12	0	0
22	22273871	.	A	C	8	13	21	0	0	21	0	0
22	22274000	.	A	T	2	4	6	0	0	6	0	0
22	22274137	.	C	T	4	6	10	0	1	11	0	0
22	22274157	.	G	T	5	2	7	0	0	7	0	0
22	22276974	.	G	A	2	2	4	0	0	4	0	0
22	22282758	.	C	T	3	3	6	0	0	6	0	0
22	22303040	.	T	G	1	2	3	0	0	3	0	0
22	22311283	.	T	C	3	2	5	0	0	5	0	0
22	22312463	.	G	A	3	4	7	0	0	7	0	0
22	22312496	.	C	A	5	1	6	0	1	7	0	0
22	22312548	.	C	A	3	2	5	0	0	5	0	0
22	22313213	.	A	C	1	3	4	0	0	4	0	0
22	22313260	.	A	T	5	6	11	0	0	11	0	0
22	22313376	.	T	C	4	8	12	0	1	13	0	0
22	22313395	.	G	A	0	6	6	0	4	10	0	0
22	22313574	.	A	G	4	0	4	0	4	8	0	0
22	22313601	.	C	T	3	3	6	0	0	6	0	0
22	22313639	.	A	C	3	2	5	0	1	6	0	0
22	22313927	.	G	C	5	6	11	0	0	11	0	0
22	22313953	.	T	A	5	7	12	0	0	12	0	0
22	22314547	.	T	A	7	4	11	0	0	11	0	0
22	22314564	.	C	A	7	7	14	0	0	14	0	0
22	22314721	.	A	G	13	13	26	0	3	29	0	0
22	22314861	.	C	G	5	3	8	0	0	8	0	0
22	22314870	.	G	C	3	6	9	0	0	9	0	0
22	22314991	.	T	C	2	2	4	0	0	4	0	0
22	22315048	.	T	C	4	2	6	0	0	6	0	0
22	22315211	.	A	G	4	4	8	0	0	8	0	0
22	22315277	.	A	G	4	4	8	0	0	8	0	0
22	22345136	.	C	T	1	5	6	0	8	14	0	0
22	22345179	.	A	C	10	7	17	0	2	19	0	0
22	22345255	.	G	A	13	7	20	1	0	21	0	0
22	22345367	.	C	T	1	13	14	0	17	31	0	0
22	22345403	.	G	A	15	14	29	0	1	30	0	0
22	22345418	.	G	A	17	15	32	0	1	33	0	0
22	22351103	.	A	T	16	6	22	0	1	23	0	0
22	22351180	.	A	T	16	12	28	0	0	28	0	0
22	22352611	.	A	C	6	11	17	0	0	17	0	0
22	22352693	.	T	A	9	9	18	0	0	18	0	0
22	22353222	.	G	A	7	6	13	0	1	14	0	0
22	22353416	.	A	G	6	5	11	0	0	11	0	0
22	22353779	.	G	A	4	6	10	0	0	10	0	0
22	22353887	.	G	A	2	7	9	0	0	9	0	0
22	22354145	.	G	A	6	3	9	0	0	9	0	0
22	22354698	.	C	T	0	2	2	0	4	6	0	0
22	22376081	.	G	C	1	0	1	0	2	3	0	0
22	22376174	.	C	T	0	4	4	0	7	11	0	0
22	22397336	.	G	A	4	2	6	0	0	6	0	0
22	22416255	.	G	T	2	4	6	0	0	6	0	0
22	22418245	.	G	T	1	3	4	0	0	4	0	0
22	22418465	.	A	T	3	5	8	0	0	8	0	0
22	22420420	.	A	G	3	6	9	0	0	9	0	0
22	22420646	.	G	T	1	2	3	0	5	8	0	0
22	22420664	.	A	G	4	3	7	0	0	7	0	0
22	22420746	.	G	T	5	5	10	0	1	11	0	0
22	22422123	.	A	T	1	5	6	0	1	7	0	0
22	22422264	.	C	T	4	5	9	0	0	9	0	0
22	22422270	.	G	T	5	5	10	0	0	10	0	0
22	22424034	.	G	A	4	3	7	0	1	8	0	0
22	22424058	.	C	T	3	4	7	0	1	8	0	0
22	22425439	.	T	C	6	5	11	0	0	11	0	0
22	22427442	.	T	C	2	7	9	0	0	9	0	0
22	22427612	.	C	T	11	13	24	0	0	24	0	0
22	22427694	.	C	T	8	7	15	0	0	15	0	0
22	22428015	.	T	A	2	2	4	0	1	5	0	0
22	22428076	.	A	G	2	0	2	0	5	7	0	0
22	22428398	.	G	T	0	2	2	0	2	4	0	0
22	22428457	.	C	A	1	2	3	0	0	3	0	0
22	22634260	.	G	C	1	2	3	0	0	3	0	0
22	22635879	.	G	C	1	2	3	0	0	3	0	0
22	23267530	.	T	C	5	2	7	0	0	7	0	0
22	23267569	.	T	C	2	2	4	0	0	4	0	0
22	23360503	.	G	A	0	3	3	0	1	4	0	0
22	23452957	.	C	T	3	2	5	0	1	6	0	0
22	23478541	.	A	G	3	4	7	0	0	7	0	0
22	23479064	.	G	A	0	2	2	0	1	3	0	0
22	23492330	.	A	T	2	4	6	0	0	6	0	0
22	23575330	.	C	T	1	2	3	0	0	3	0	0
22	24157961	.	G	C	6	12	18	0	4	23	1	0
22	24158037	.	T	A	6	8	14	0	0	14	0	0
22	24158146	.	A	C	10	9	19	0	2	21	0	0
22	24158190	.	C	T	14	8	22	0	0	22	0	0
22	24158242	.	C	A	13	18	31	0	1	32	0	0
22	24158275	.	G	C	14	10	24	0	1	25	0	0
22	24166896	.	G	A	2	13	15	0	18	33	0	0
22	24166919	.	A	G	19	14	33	0	2	35	0	0
22	24167633	.	C	T	15	14	29	0	1	30	0	0
22	24168125	.	T	C	11	16	27	0	0	27	0	0
22	24168573	.	T	C	19	13	32	0	0	32	0	0
22	24168610	.	T	A	19	19	38	0	1	39	0	0
22	24218631	.	A	G	9	0	9	0	3	12	0	0
22	24218656	.	T	A	2	7	9	0	0	9	0	0
22	24220962	.	A	G	15	13	28	0	2	30	0	0
22	24220996	.	G	A	16	16	32	0	0	32	0	0
22	24221009	.	C	T	13	15	28	0	1	29	0	0
22	24224676	.	A	T	13	5	18	0	1	19	0	0
22	24225409	.	T	C	15	12	27	0	1	28	0	0
22	24229293	.	C	T	11	13	24	0	1	25	0	0
22	24229513	.	T	C	21	21	42	0	2	44	0	0
22	24229890	.	T	C	9	17	26	0	1	27	0	0
22	24230005	.	G	A	3	12	15	0	17	32	0	0
22	24230020	.	G	A	15	21	36	0	0	36	0	0
22	24233536	.	G	T	22	21	43	0	0	43	0	0
22	24360361	.	A	T	3	2	5	0	0	5	0	0
22	24715404	.	A	G	11	0	11	0	22	33	0	0
22	24716636	.	T	A	16	18	34	0	0	34	0	0
22	24717105	.	G	A	12	29	41	0	0	41	0	0
22	24718973	.	T	C	20	28	48	0	1	49	0	0
22	24724279	.	T	C	3	5	8	14	0	22	0	0
22	24724459	.	A	G	6	11	17	2	0	19	0	0
22	24981171	.	T	C	5	2	7	0	0	7	0	0
22	24984053	.	A	C	5	4	9	0	0	9	0	0
22	25025208	.	G	A	25	19	44	0	3	47	0	0
22	25028424	.	G	A	18	21	39	0	4	43	0	0
22	25028660	.	G	A	18	17	35	0	1	36	0	0
22	25028694	.	G	A	20	10	30	0	1	31	0	0
22	25032266	.	C	T	20	14	34	0	1	35	0	0
22	25032344	.	C	T	4	12	16	0	11	27	0	0
22	25032532	.	C	G	13	12	25	0	2	27	0	0
22	25032572	.	G	A	11	12	23	0	3	26	0	0
22	25032620	.	A	C	7	5	12	0	16	28	0	0
22	25032857	.	G	A	5	4	9	0	3	12	0	0
22	25032863	.	A	G	9	3	12	0	1	13	0	0
22	25032921	.	A	T	7	7	14	0	0	15	1	0
22	25034863	.	C	G	1	3	4	0	0	4	0	0
22	25034865	.	C	T	1	2	3	0	1	4	0	0
22	25042952	.	G	A	1	2	3	0	0	3	0	0
22	25049563	.	C	T	1	2	3	0	0	3	0	0
22	25049594	.	T	C	1	3	4	0	0	4	0	0
22	25054478	.	A	T	4	2	6	0	0	6	0	0
22	25054496	.	C	G	3	5	8	0	0	8	0	0
22	25055645	.	G	T	1	2	3	0	0	3	0	0
22	25057959	.	T	C	1	1	2	0	0	2	0	0
22	25057973	.	A	G	1	2	3	0	0	3	0	0
22	25058509	.	C	G	3	0	3	0	3	6	0	0
22	25058518	.	T	G	3	4	7	0	0	7	0	0
22	25059919	.	G	A	0	8	8	0	2	10	0	0
22	25060629	.	C	A	3	2	5	0	0	5	0	0
22	25063474	.	C	T	2	2	4	0	1	5	0	0
22	25063696	.	A	G	9	0	9	0	7	16	0	0
22	25063745	.	C	A	8	5	13	0	0	13	0	0
22	25063767	.	C	A	8	2	10	0	0	10	0	0
22	25066332	.	C	T	0	4	4	0	6	10	0	0
22	25066410	.	T	C	10	7	17	0	0	17	0	0
22	25066585	.	G	A	3	11	14	0	0	14	0	0
22	25066939	.	C	T	5	8	13	0	0	13	0	0
22	25067274	.	A	G	3	4	7	0	0	7	0	0
22	25067596	.	C	T	10	9	19	1	0	20	0	0
22	25069856	.	G	A	2	4	6	0	0	6	0	0
22	25069884	.	C	A	2	4	6	0	0	6	0	0
22	25072073	.	G	A	5	4	9	0	2	11	0	0
22	25072474	.	C	G	4	4	8	0	0	8	0	0
22	25076701	.	G	A	3	6	9	0	0	9	0	0
22	25076727	.	A	G	8	3	11	0	0	11	0	0
22	25078630	.	A	C	7	9	16	0	2	18	0	0
22	25107565	.	T	C	1	2	3	1	0	4	0	0
22	25566318	.	T	G	2	2	4	0	0	4	0	0
22	25566539	.	C	T	1	4	5	0	0	5	0	0
22	25566572	.	A	T	2	4	6	0	0	6	0	0
22	25566614	.	G	A	2	1	3	0	1	4	0	0
22	25573161	.	C	T	1	6	7	0	0	7	0	0
22	25573197	.	G	T	2	4	6	0	0	6	0	0
22	25577248	.	C	T	4	4	8	0	0	8	0	0
22	25577265	.	A	G	2	3	5	0	0	5	0	0
22	25581851	.	G	T	3	5	8	0	0	8	0	0
22	25582764	.	T	C	4	2	6	0	2	8	0	0
22	25586906	.	T	A	6	2	8	0	0	8	0	0
22	25586963	.	C	T	6	5	11	0	0	11	0	0
22	25843519	.	T	A	1	2	3	0	0	3	0	0
22	25845159	.	T	G	1	2	3	1	0	4	0	0
22	25931976	.	A	G	3	0	3	0	4	7	0	0
22	25937001	.	G	A	0	11	11	0	4	15	0	0
22	25937037	.	T	A	4	12	16	0	1	17	0	0
22	25937052	.	T	C	6	9	15	0	0	15	0	0
22	25938882	.	T	C	7	3	10	0	0	10	0	0
22	25939060	.	C	T	6	4	10	0	0	10	0	0
22	25942728	.	A	G	3	0	3	0	6	9	0	0
22	25942822	.	A	G	4	6	10	0	0	10	0	0
22	25942884	.	C	T	2	2	4	0	0	4	0	0
22	25942934	.	T	G	1	6	7	0	0	7	0	0
22	26239602	.	T	C	1	2	3	1	0	4	0	0
22	26239654	.	A	T	3	7	10	0	0	10	0	0
22	26239681	.	C	T	2	6	8	0	3	11	0	0
22	26239752	.	G	A	5	6	11	0	1	12	0	0
22	26239774	.	T	A	5	4	9	0	1	10	0	0
22	26239873	.	T	A	4	7	11	0	0	11	0	0
22	26239879	.	G	A	4	6	10	0	1	11	0	0
22	26243236	.	A	C	4	1	5	0	4	9	0	0
22	26243242	.	C	T	3	5	8	0	0	8	0	0
22	26244755	.	C	T	3	1	4	0	2	6	0	0
22	26245881	.	T	C	3	0	3	0	2	5	0	0
22	26264690	.	T	C	2	2	4	0	0	4	0	0
22	26265498	.	A	T	6	8	14	0	0	14	0	0
22	26266807	.	T	A	6	5	11	0	0	11	0	0
22	26274099	.	G	A	2	4	6	0	0	6	0	0
22	26274106	.	A	T	2	3	5	0	1	6	0	0
22	26277695	.	T	C	11	9	20	0	2	22	0	0
22	26277735	.	A	C	12	5	17	0	2	19	0	0
22	26277773	.	G	A	8	7	15	0	1	16	0	0
22	26277820	.	T	C	8	7	15	0	0	15	0	0
22	26277871	.	C	A	8	4	12	0	0	12	0	0
22	26278042	.	T	C	3	5	8	0	1	9	0	0
22	26278081	.	C	T	4	9	13	0	0	13	0	0
22	26278144	.	T	G	10	5	15	0	1	16	0	0
22	26278273	.	G	A	7	11	18	1	0	19	0	0
22	26281043	.	A	G	12	5	17	0	0	17	0	0
22	26289397	.	A	C	4	3	7	0	0	7	0	0
22	26289430	.	G	A	3	5	8	0	0	8	0	0
22	26290508	.	C	T	15	12	27	0	0	27	0	0
22	26290764	.	A	G	5	3	8	0	0	8	0	0
22	26290797	.	T	G	1	0	1	0	5	6	0	0
22	26290851	.	A	T	1	6	7	0	0	7	0	0
22	26304186	.	T	C	7	6	13	0	0	13	0	0
22	26307620	.	T	G	7	5	12	0	0	12	0	0
22	26307728	.	A	G	2	3	5	0	1	6	0	0
22	26307743	.	T	C	3	0	3	1	3	7	0	0
22	26524896	.	G	A	4	4	8	0	0	8	0	0
22	26525535	.	C	T	1	3	4	0	0	4	0	0
22	26525583	.	G	A	1	2	3	0	0	3	0	0
22	26525935	.	T	G	2	4	6	0	0	6	0	0
22	26525960	.	A	G	5	3	8	0	0	8	0	0
22	26525979	.	C	T	5	2	7	0	1	8	0	0
22	26526004	.	A	T	8	3	11	0	1	12	0	0
22	26526057	.	C	T	1	7	8	0	4	12	0	0
22	26526249	.	A	T	3	7	10	0	0	10	0	0
22	26526296	.	A	G	6	3	9	0	2	11	0	0
22	26526471	.	A	G	4	4	8	0	0	8	0	0
22	26526522	.	G	A	2	2	4	0	0	4	0	0
22	26526864	.	C	A	8	3	11	0	1	12	0	0
22	26526969	.	A	T	1	5	6	0	0	6	0	0
22	26528259	.	G	A	4	2	6	0	0	6	0	0
22	26528575	.	A	T	5	1	6	0	1	7	0	0
22	26528740	.	T	A	1	6	7	1	1	9	0	0
22	26529204	.	C	T	0	4	4	0	3	7	0	0
22	26529315	.	G	A	3	4	7	0	0	7	0	0
22	26529438	.	C	A	2	4	6	0	3	9	0	0
22	26529471	.	G	T	5	3	8	0	1	9	0	0
22	26529500	.	T	G	4	5	9	0	0	9	0	0
22	26536435	.	C	A	3	3	6	0	0	6	0	0
22	26536443	.	T	A	3	3	6	0	0	6	0	0
22	26703503	.	C	T	5	5	10	0	0	10	0	0
22	26738889	.	A	C	3	3	6	0	0	6	0	0
22	26739087	.	A	G	5	0	5	0	2	7	0	0
22	26739094	.	G	A	4	2	6	0	0	6	0	0
22	26768020	.	C	G	6	7	13	0	0	13	0	0
22	26768023	.	T	C	6	7	13	0	0	13	0	0
22	26768433	.	A	G	4	2	6	0	0	6	0	0
22	26771067	.	G	T	13	8	21	0	0	21	0	0
22	26771414	.	G	A	0	4	4	0	6	11	1	0
22	26774079	.	G	A	0	6	6	0	4	10	0	0
22	26774660	.	C	T	8	7	15	0	0	15	0	0
22	26776678	.	C	T	6	4	10	0	0	10	0	0
22	26776681	.	G	A	6	4	10	0	0	10	0	0
22	26785015	.	C	T	3	3	6	0	0	6	0	0
22	26786013	.	A	G	2	4	6	1	1	8	0	0
22	26786559	.	C	A	3	2	5	0	0	5	0	0
22	26787710	.	G	T	10	7	17	0	1	18	0	0
22	26787911	.	C	T	10	19	29	0	3	32	0	0
22	26788340	.	G	A	13	11	24	0	0	24	0	0
22	26788449	.	T	C	7	18	25	0	1	26	0	0
22	26788565	.	T	C	21	12	33	0	4	37	0	0
22	26788885	.	C	A	7	12	19	0	6	25	0	0
22	26789228	.	G	A	0	15	15	0	16	31	0	0
22	26789465	.	A	G	10	0	10	0	20	30	0	0
22	26789667	.	C	G	3	1	4	0	6	10	0	0
22	26789813	.	A	T	13	13	26	0	0	26	0	0
22	26790074	.	C	T	13	11	24	0	0	24	0	0
22	26790436	.	A	T	12	13	25	0	0	25	0	0
22	26798936	.	G	C	0	2	2	0	1	3	0	0
22	26798978	.	A	G	1	2	3	0	0	3	0	0
22	26811854	.	G	A	1	2	3	0	0	3	0	0
22	26811877	.	G	A	1	4	5	0	0	5	0	0
22	26812016	.	A	G	4	2	6	0	0	6	0	0
22	26812058	.	G	A	3	2	5	0	0	6	1	0
22	26812224	.	T	C	1	4	5	0	0	5	0	0
22	26812230	.	A	G	2	4	6	0	0	6	0	0
22	26812506	.	C	T	3	7	10	0	0	10	0	0
22	26812751	.	G	A	3	2	5	0	1	6	0	0
22	26812754	.	A	G	3	2	5	0	1	6	0	0
22	26813028	.	T	A	3	4	7	0	0	7	0	0
22	26813046	.	G	A	0	3	3	0	4	7	0	0
22	26813179	.	G	A	5	3	8	0	0	8	0	0
22	26813185	.	C	T	5	3	8	0	0	8	0	0
22	26813224	.	T	C	3	3	6	0	1	7	0	0
22	26813412	.	C	T	4	2	6	0	0	6	0	0
22	26813620	.	A	T	5	2	7	0	0	7	0	0
22	26813642	.	A	T	6	3	9	0	0	9	0	0
22	26813670	.	G	A	8	3	11	0	1	12	0	0
22	26813851	.	T	G	4	5	9	0	1	10	0	0
22	26813963	.	A	G	5	2	7	0	0	7	0	0
22	26813970	.	T	C	5	2	7	0	0	7	0	0
22	26814164	.	C	G	7	4	11	0	0	11	0	0
22	26814309	.	A	G	3	0	3	0	4	7	0	0
22	26814320	.	C	T	2	3	5	0	1	6	0	0
22	26818086	.	G	A	0	4	4	0	12	16	0	0
22	26818700	.	T	C	11	5	16	0	0	16	0	0
22	26818851	.	T	A	8	10	18	0	1	19	0	0
22	26818907	.	A	G	7	0	7	0	7	14	0	0
22	26832125	.	G	A	7	8	15	0	1	16	0	0
22	26839502	.	T	A	7	6	13	0	0	13	0	0
22	26839505	.	G	A	6	5	11	0	0	11	0	0
22	26844260	.	G	A	12	13	25	0	0	25	0	0
22	26844345	.	A	C	4	12	16	0	0	16	0	0
22	26851904	.	A	C	6	0	6	0	6	12	0	0
22	26851963	.	T	C	4	3	7	0	1	8	0	0
22	26852142	.	A	C	4	6	10	0	0	10	0	0
22	26852163	.	A	C	5	6	11	0	0	11	0	0
22	26852243	.	C	T	0	3	3	0	2	5	0	0
22	26854530	.	T	C	5	3	8	0	0	8	0	0
22	26854626	.	C	A	4	2	6	0	0	6	0	0
22	26854965	.	A	G	5	4	9	0	0	9	0	0
22	26855037	.	C	G	6	3	9	0	1	10	0	0
22	26856023	.	A	G	5	4	9	0	1	10	0	0
22	26856059	.	A	T	4	4	8	0	1	9	0	0
22	26857762	.	A	G	4	5	9	0	0	9	0	0
22	26858002	.	A	G	8	4	12	0	2	14	0	0
22	26858161	.	T	C	4	8	12	0	0	12	0	0
22	26858216	.	T	C	9	6	15	1	1	17	0	0
22	26860639	.	C	T	3	22	25	0	17	42	0	0
22	26860753	.	T	C	10	16	26	0	1	27	0	0
22	26861264	.	T	C	12	0	12	0	9	21	0	0
22	26929826	.	C	A	14	15	29	0	1	30	0	0
22	26929931	.	A	T	13	20	33	0	1	35	1	0
22	26929969	.	A	G	19	21	40	0	3	43	0	0
22	26930076	.	A	G	20	20	40	0	0	40	0	0
22	26930079	.	G	T	18	19	37	0	1	39	1	0
22	26930133	.	G	C	19	15	34	0	0	34	0	0
22	26930313	.	C	T	10	10	20	0	1	21	0	0
22	26930335	.	A	T	15	9	24	0	1	25	0	0
22	26930390	.	C	T	12	11	23	0	1	24	0	0
22	26930489	.	C	G	11	13	24	0	1	25	0	0
22	26930527	.	T	A	8	11	19	0	0	19	0	0
22	26930601	.	T	C	7	5	12	0	1	13	0	0
22	26930735	.	G	C	8	0	8	0	5	13	0	0
22	26930894	.	C	T	1	18	19	0	10	29	0	0
22	26931467	.	C	T	1	2	3	0	0	3	0	0
22	26931567	.	C	A	1	5	6	0	0	6	0	0
22	26931699	.	A	T	4	2	6	0	0	6	0	0
22	26931723	.	T	C	3	2	5	0	0	5	0	0
22	26931749	.	T	A	1	3	4	0	0	4	0	0
22	26931763	.	G	A	3	2	5	0	0	5	0	0
22	26931906	.	C	T	5	3	8	0	1	9	0	0
22	26931967	.	G	A	8	7	15	0	3	18	0	0
22	26940409	.	G	A	3	4	7	0	0	7	0	0
22	27091989	.	C	T	1	2	3	0	0	3	0	0
22	27098736	.	G	A	9	6	15	0	0	15	0	0
22	27098899	.	T	C	7	4	11	0	2	13	0	0
22	28236839	.	A	T	4	7	11	0	1	12	0	0
22	28241719	.	A	T	5	7	12	0	0	12	0	0
22	28241831	.	T	A	4	8	12	0	1	13	0	0
22	28244972	.	A	G	2	6	8	0	0	8	0	0
22	28265596	.	T	G	2	5	7	0	0	7	0	0
22	28265621	.	T	C	2	5	7	0	0	7	0	0
22	28265636	.	G	T	1	2	3	0	0	3	0	0
22	28284646	.	A	C	4	2	6	0	0	6	0	0
22	28284659	.	C	T	5	3	8	0	0	8	0	0
22	28287669	.	T	C	5	4	9	0	2	11	0	0
22	28290817	.	C	T	3	6	9	0	0	9	0	0
22	28303025	.	C	T	8	10	18	0	0	18	0	0
22	28303091	.	C	A	10	14	24	0	2	26	0	0
22	28481589	.	C	T	2	5	7	0	1	8	0	0
22	28481616	.	A	C	3	5	8	0	0	8	0	0
22	28481641	.	G	A	0	6	6	0	3	9	0	0
22	28481953	.	G	A	1	2	3	0	0	3	0	0
22	28482204	.	G	A	0	7	7	0	3	10	0	0
22	28642777	.	G	A	2	3	5	0	0	5	0	0
22	28642997	.	C	A	4	3	7	0	0	7	0	0
22	28644474	.	T	C	1	1	2	0	3	5	0	0
22	28804013	.	G	A	0	4	4	0	5	9	0	0
22	28832823	.	G	C	6	3	9	0	0	9	0	0
22	28836202	.	C	T	10	6	16	0	0	16	0	0
22	28836631	.	A	G	8	7	15	0	1	16	0	0
22	28837231	.	A	G	13	6	19	0	0	19	0	0
22	28839917	.	A	C	9	4	13	0	1	14	0	0
22	28840101	.	C	A	5	12	17	0	0	17	0	0
22	28840154	.	A	G	10	12	22	0	1	23	0	0
22	28847988	.	G	A	10	8	18	0	0	18	0	0
22	28848724	.	A	T	11	7	18	1	0	19	0	0
22	28848735	.	T	C	9	5	14	1	2	17	0	0
22	28848920	.	A	G	10	5	15	0	0	15	0	0
22	28858314	.	A	G	21	9	30	0	0	30	0	0
22	28859346	.	G	A	19	20	39	0	2	41	0	0
22	28859409	.	A	G	19	9	28	0	1	29	0	0
22	28859618	.	A	G	21	17	38	0	0	38	0	0
22	28859683	.	G	T	12	8	20	0	1	21	0	0
22	28862336	.	C	T	13	11	24	0	1	25	0	0
22	28862534	.	A	G	9	10	19	0	1	20	0	0
22	28863137	.	G	A	14	8	22	0	0	22	0	0
22	28863140	.	G	A	15	7	22	0	1	23	0	0
22	28865752	.	G	A	15	10	25	0	0	25	0	0
22	28865970	.	A	G	12	8	20	0	0	20	0	0
22	28868174	.	A	G	14	8	22	0	0	22	0	0
22	28868183	.	T	C	14	7	21	0	1	22	0	0
22	28871698	.	G	C	16	1	17	0	12	29	0	0
22	29075278	.	C	T	5	3	8	0	1	9	0	0
22	29076058	.	T	G	5	2	7	0	0	7	0	0
22	29076126	.	A	G	7	11	18	0	1	19	0	0
22	29076172	.	G	A	5	13	18	0	0	18	0	0
22	29076236	.	T	C	12	20	32	0	0	32	0	0
22	29076381	.	G	C	10	10	20	0	0	20	0	0
22	29076389	.	A	G	9	10	19	0	0	19	0	0
22	29076444	.	G	C	6	7	13	0	0	13	0	0
22	29076581	.	G	A	2	2	4	0	0	4	0	0
22	29077023	.	T	A	5	9	14	0	1	15	0	0
22	29077380	.	G	A	11	9	20	0	1	21	0	0
22	29077432	.	A	G	4	5	9	0	0	9	0	0
22	29077515	.	G	A	1	4	5	0	0	5	0	0
22	29077590	.	A	G	7	3	10	0	0	10	0	0
22	29077598	.	A	T	6	2	8	0	1	9	0	0
22	29078255	.	T	A	4	2	6	0	0	6	0	0
22	29078715	.	C	T	9	3	12	0	0	12	0	0
22	29079722	.	G	T	5	6	11	0	0	11	0	0
22	29079761	.	T	C	2	4	6	0	1	7	0	0
22	29080205	.	G	A	10	6	16	0	0	16	0	0
22	29080233	.	G	A	5	6	11	0	0	11	0	0
22	29080427	.	G	A	7	4	11	0	2	13	0	0
22	29080477	.	T	G	6	11	17	0	0	17	0	0
22	29080864	.	C	T	5	4	9	0	0	9	0	0
22	29091732	.	G	C	7	6	13	0	0	13	0	0
22	29093632	.	G	T	5	5	10	0	0	10	0	0
22	29096343	.	C	T	1	3	4	0	0	4	0	0
22	29096382	.	G	T	0	2	2	0	1	3	0	0
22	29096485	.	A	G	3	0	3	0	3	6	0	0
22	29096499	.	T	C	2	5	7	0	0	7	0	0
22	29097228	.	C	T	5	4	9	0	0	9	0	0
22	29097303	.	A	G	6	0	6	0	4	10	0	0
22	29097327	.	T	C	4	4	8	0	0	8	0	0
22	29097354	.	T	A	4	2	6	0	0	6	0	0
22	29103453	.	A	G	4	2	6	0	1	7	0	0
22	29113803	.	G	A	0	6	6	0	9	15	0	0
22	29113882	.	A	G	4	4	8	0	0	8	0	0
22	29114351	.	G	A	6	7	13	0	0	13	0	0
22	29118736	.	G	A	0	4	4	0	8	12	0	0
22	29119326	.	T	A	3	3	6	0	0	6	0	0
22	29121789	.	G	A	2	3	5	0	8	13	0	0
22	29125660	.	C	T	8	5	13	0	0	13	0	0
22	29125699	.	T	A	7	2	9	0	2	11	0	0
22	29125791	.	T	A	6	7	13	0	0	13	0	0
22	29126682	.	A	G	1	2	3	0	0	3	0	0
22	29167341	.	A	C	1	2	3	0	0	3	0	0
22	29167398	.	T	G	1	3	4	0	0	4	0	0
22	29168879	.	G	A	37	24	61	0	0	61	0	0
22	29168940	.	T	A	36	24	60	0	6	66	0	0
22	29242280	.	A	G	24	12	36	0	0	36	0	0
22	29242296	.	G	C	16	14	30	0	1	31	0	0
22	29242317	.	G	A	11	10	21	0	0	21	0	0
22	29312360	.	T	A	2	2	4	0	0	4	0	0
22	29312363	.	T	C	2	2	4	0	0	4	0	0
22	29312851	.	A	C	3	2	5	0	0	5	0	0
22	29316013	.	T	C	3	3	6	0	0	6	0	0
22	29316091	.	T	A	3	5	8	0	1	9	0	0
22	29318758	.	T	C	1	0	1	0	3	4	0	0
22	29585169	.	G	A	1	3	4	0	0	4	0	0
22	29585244	.	G	A	1	2	3	0	0	3	0	0
22	29585247	.	G	C	2	2	4	0	0	4	0	0
22	29612096	.	A	G	5	2	7	0	1	8	0	0
22	29615056	.	A	G	3	6	9	0	0	9	0	0
22	29617050	.	G	A	4	4	8	0	0	8	0	0
22	29620306	.	A	G	7	4	11	0	0	11	0	0
22	29620488	.	T	G	3	6	9	0	0	9	0	0
22	29651938	.	C	T	14	12	26	0	2	28	0	0
22	29652161	.	T	A	4	12	16	0	0	16	0	0
22	29652201	.	A	G	5	0	5	0	11	16	0	0
22	29659031	.	T	A	6	2	8	0	1	9	0	0
22	29659637	.	G	A	27	20	47	0	2	49	0	0
22	29666501	.	G	A	20	18	38	0	0	38	0	0
22	29666505	.	C	T	1	17	18	0	19	37	0	0
22	29666746	.	G	A	10	21	31	0	2	33	0	0
22	29668796	.	C	T	11	10	21	0	0	21	0	0
22	29668799	.	C	T	11	9	20	0	0	20	0	0
22	29670324	.	G	A	18	12	30	0	0	30	0	0
22	29671553	.	A	G	17	9	26	1	1	28	0	0
22	29689458	.	T	C	13	15	28	0	1	29	0	0
22	31456026	.	A	T	1	2	3	0	0	3	0	0
22	31466141	.	G	A	5	2	7	0	0	7	0	0
22	31504546	.	C	A	1	2	3	0	0	3	0	0
22	31517163	.	A	G	1	2	3	0	0	3	0	0
22	31668049	.	T	C	11	1	12	0	14	26	0	0
22	31671957	.	T	A	14	21	35	0	0	35	0	0
22	31933332	.	G	A	1	2	3	0	3	6	0	0
22	31933335	.	T	G	2	2	4	0	0	4	0	0
22	34701901	.	G	C	11	24	35	0	0	35	0	0
22	34702200	.	A	G	30	25	55	0	2	57	0	0
22	34706938	.	T	C	36	23	59	0	0	59	0	0
22	34707041	.	A	G	27	3	30	0	13	43	0	0
22	34707062	.	T	G	27	8	35	0	0	35	0	0
22	34707084	.	C	T	21	15	36	0	0	36	0	0
22	34707119	.	G	T	15	20	35	0	1	36	0	0
22	34707272	.	T	A	17	20	37	0	2	39	0	0
22	34707295	.	C	T	13	14	27	0	1	28	0	0
22	34843569	.	C	T	3	3	6	0	0	6	0	0
22	34843892	.	C	T	1	3	4	0	3	7	0	0
22	34843910	.	T	C	3	2	5	0	1	6	0	0
22	34843964	.	C	A	0	2	2	0	4	6	0	0
22	35013549	.	A	T	4	2	6	0	0	6	0	0
22	35013675	.	C	T	1	8	9	0	6	15	0	0
22	35013679	.	C	T	6	8	14	0	0	14	0	0
22	35013982	.	G	A	4	2	6	0	0	6	0	0
22	35015828	.	C	T	5	4	9	0	0	9	0	0
22	35016177	.	G	A	5	11	16	0	0	16	0	0
22	35016185	.	A	G	6	13	19	0	0	19	0	0
22	35041537	.	T	C	4	2	6	0	0	6	0	0
22	35042857	.	T	C	5	0	5	0	4	9	0	0
22	35049063	.	A	G	1	3	4	0	1	5	0	0
22	35058599	.	A	G	2	2	4	0	2	6	0	0
22	35530470	.	C	T	2	4	6	0	0	6	0	0
22	35530977	.	G	T	7	2	9	0	0	9	0	0
22	35531122	.	G	A	1	4	5	0	0	5	0	0
22	35531281	.	G	A	1	5	6	0	0	6	0	0
22	35531376	.	A	G	2	4	6	0	0	6	0	0
22	35531485	.	C	G	2	6	8	0	0	8	0	0
22	35531550	.	C	G	1	2	3	0	0	3	0	0
22	36502348	.	T	C	1	2	3	0	0	3	0	0
22	36502355	.	G	T	1	2	3	0	0	3	0	0
22	36502390	.	A	G	1	3	4	0	0	4	0	0
22	36502399	.	T	A	1	1	2	0	0	2	0	0
22	36524073	.	C	A	3	2	5	0	0	5	0	0
22	36530090	.	C	T	0	4	4	0	6	10	0	0
22	36530155	.	T	C	1	3	4	0	0	4	0	0
22	36616814	.	G	A	1	7	8	0	3	11	0	0
22	36622717	.	A	G	3	4	7	1	0	8	0	0
22	36634111	.	T	C	2	4	6	0	0	6	0	0
22	36634127	.	T	C	1	4	5	0	0	5	0	0
22	36634167	.	G	C	2	1	3	0	2	5	0	0
22	36634213	.	G	A	0	2	2	0	1	3	0	0
22	36674598	.	G	T	2	5	7	0	1	8	0	0
22	36676056	.	G	C	25	26	51	0	2	53	0	0
22	36679390	.	G	A	28	23	51	0	1	52	0	0
22	36683803	.	C	A	15	10	25	0	1	26	0	0
22	36685729	.	C	T	18	23	41	1	8	50	0	0
22	36686828	.	G	A	14	19	33	1	4	38	0	0
22	36686867	.	G	A	16	20	36	0	1	37	0	0
22	36686870	.	A	G	13	19	32	0	3	35	0	0
22	36686948	.	G	T	20	18	38	0	2	40	0	0
22	36687328	.	G	A	21	16	37	0	0	37	0	0
22	36687403	.	G	A	18	15	33	0	3	36	0	0
22	36687541	.	T	C	15	16	31	0	2	33	0	0
22	36687616	.	C	T	0	20	20	1	22	43	0	0
22	36690668	.	T	A	15	17	32	0	1	33	0	0
22	36741467	.	T	C	3	0	3	0	2	5	0	0
22	36750518	.	G	A	4	3	7	0	0	7	0	0
22	36755641	.	C	T	2	4	6	0	0	6	0	0
22	36755831	.	G	A	4	3	7	0	1	8	0	0
22	36755963	.	G	C	4	0	4	0	10	14	0	0
22	36756112	.	A	G	5	10	15	0	0	15	0	0
22	36756325	.	G	A	6	5	11	0	1	12	0	0
22	36756333	.	T	C	7	0	7	0	7	14	0	0
22	36756400	.	C	T	9	5	14	0	1	15	0	0
22	36756404	.	G	C	8	6	14	0	0	14	0	0
22	36756464	.	T	A	4	3	7	0	0	7	0	0
22	36768060	.	C	T	0	3	3	1	3	7	0	0
22	36795845	.	G	T	7	10	17	0	0	17	0	0
22	36800981	.	G	C	3	6	9	0	0	9	0	0
22	36802185	.	A	G	3	4	7	0	0	7	0	0
22	36802898	.	G	A	1	2	3	0	0	3	0	0
22	36802988	.	A	T	1	2	3	0	0	3	0	0
22	36803531	.	G	A	1	2	3	0	0	3	0	0
22	36836043	.	T	A	1	4	5	0	1	6	0	0
22	36875581	.	T	C	1	3	4	0	0	4	0	0
22	36875584	.	A	G	1	0	1	0	3	4	0	0
22	36877531	.	G	A	0	2	2	0	7	9	0	0
22	36877534	.	G	T	1	2	3	0	6	9	0	0
22	36877963	.	G	A	3	4	7	0	0	7	0	0
22	36878044	.	T	A	7	9	16	0	0	16	0	0
22	36879468	.	G	T	4	7	11	0	0	11	0	0
22	36879483	.	C	T	7	4	11	0	0	11	0	0
22	36882150	.	G	A	3	6	9	0	0	9	0	0
22	36882168	.	G	A	0	2	2	0	6	8	0	0
22	36882189	.	G	A	0	2	2	0	6	8	0	0
22	36882388	.	T	C	9	4	13	0	0	13	0	0
22	36885065	.	T	G	5	0	5	0	3	8	0	0
22	36887954	.	C	T	4	11	15	0	0	15	0	0
22	36888623	.	A	G	15	7	22	0	1	23	0	0
22	36891142	.	G	A	10	6	16	1	1	18	0	0
22	36893330	.	T	C	11	8	19	0	0	19	0	0
22	36893357	.	G	A	9	10	19	0	0	19	0	0
22	36894316	.	T	A	6	8	14	0	1	15	0	0
22	36894410	.	A	C	9	9	18	0	0	18	0	0
22	36896641	.	G	A	2	8	10	0	5	15	0	0
22	36896677	.	G	T	7	10	17	0	0	17	0	0
22	36899269	.	C	T	15	21	36	0	0	36	0	0
22	36899483	.	G	A	0	2	2	1	6	9	0	0
22	36899611	.	C	A	7	3	10	0	1	11	0	0
22	36899621	.	A	T	5	8	13	0	0	13	0	0
22	36947793	.	T	A	4	5	9	0	0	9	0	0
22	36947836	.	C	A	6	6	12	0	0	12	0	0
22	36947849	.	G	A	7	7	14	0	0	14	0	0
22	36947879	.	G	C	6	6	12	0	2	14	0	0
22	36947997	.	A	G	5	10	15	0	0	15	0	0
22	36948052	.	T	G	4	6	10	0	0	10	0	0
22	36948133	.	G	A	4	11	15	0	0	15	0	0
22	36948134	.	C	T	4	11	15	0	0	15	0	0
22	36948202	.	C	A	6	4	10	0	0	10	0	0
22	36948312	.	C	T	1	8	9	0	9	18	0	0
22	36948395	.	T	C	8	0	8	0	10	18	0	0
22	36948603	.	T	A	9	11	20	0	0	20	0	0
22	36978477	.	G	C	1	2	3	0	0	3	0	0
22	37276635	.	T	C	5	0	5	0	8	13	0	0
22	37276709	.	C	T	0	5	5	0	11	16	0	0
22	37278283	.	A	T	6	5	11	0	0	11	0	0
22	37278475	.	A	G	12	11	23	0	0	23	0	0
22	37278479	.	T	C	10	0	10	0	9	19	0	0
22	37278634	.	C	T	25	13	38	0	2	40	0	0
22	37347512	.	A	T	1	2	3	0	0	3	0	0
22	37352700	.	C	G	16	15	31	0	3	34	0	0
22	37542836	.	C	A	8	3	11	0	1	12	0	0
22	37543070	.	A	T	8	12	20	0	2	22	0	0
22	37543457	.	A	G	7	17	24	0	0	24	0	0
22	37551481	.	G	C	15	1	16	0	7	23	0	0
22	37551496	.	T	C	7	0	7	0	11	18	0	0
22	37552717	.	G	A	9	9	18	0	3	21	0	0
22	37552783	.	A	C	10	1	11	0	15	27	1	0
22	37553015	.	C	T	1	4	5	0	5	10	0	0
22	37557531	.	G	A	8	11	19	0	3	22	0	0
22	37559603	.	G	A	4	7	11	0	0	11	0	0
22	37561609	.	G	A	5	6	11	0	1	12	0	0
22	37561642	.	C	G	5	7	12	0	0	12	0	0
22	37588622	.	T	C	9	0	9	0	8	17	0	0
22	37588667	.	A	C	9	6	15	0	0	15	0	0
22	37588715	.	T	C	13	4	17	0	3	20	0	0
22	37589420	.	T	C	7	2	9	0	0	9	0	0
22	37589779	.	T	G	6	13	19	1	0	20	0	0
22	37589782	.	T	G	7	11	18	1	1	20	0	0
22	37589898	.	A	T	12	4	16	2	0	18	0	0
22	37590055	.	G	C	5	2	7	0	0	7	0	0
22	37590117	.	T	C	1	2	3	0	0	3	0	0
22	37590171	.	C	T	2	8	10	0	0	10	0	0
22	37590339	.	A	T	13	6	19	0	3	22	0	0
22	37590535	.	C	T	8	4	12	0	0	12	0	0
22	37590710	.	T	G	5	5	10	0	0	10	0	0
22	37590711	.	C	T	6	5	11	0	0	11	0	0
22	37590925	.	T	C	7	12	19	0	0	19	0	0
22	37591023	.	A	C	3	9	12	0	1	13	0	0
22	37591491	.	A	T	12	6	18	0	2	20	0	0
22	37599007	.	C	A	5	5	10	0	0	10	0	0
22	37602190	.	C	T	0	4	4	0	2	6	0	0
22	37602479	.	A	C	4	3	7	0	0	7	0	0
22	37608435	.	T	C	1	0	1	0	4	5	0	0
22	37608465	.	G	A	1	2	3	0	1	4	0	0
22	37609996	.	G	A	5	3	8	0	0	8	0	0
22	37610001	.	T	C	4	3	7	0	0	7	0	0
22	37610043	.	C	T	0	2	2	0	2	4	0	0
22	37611298	.	T	G	2	3	5	0	0	5	0	0
22	37611498	.	A	G	1	5	6	0	0	6	0	0
22	37611513	.	A	C	0	3	3	0	1	5	1	0
22	37639239	.	C	T	5	5	10	0	0	10	0	0
22	37639311	.	C	T	7	7	14	0	0	14	0	0
22	37641741	.	G	A	5	3	8	0	1	9	0	0
22	37644009	.	C	A	12	9	21	0	1	22	0	0
22	37644021	.	C	G	11	10	21	0	2	23	0	0
22	37644048	.	A	G	8	9	17	0	1	18	0	0
22	37645990	.	T	C	14	6	20	0	0	20	0	0
22	37646124	.	C	T	11	15	26	0	0	26	0	0
22	37646226	.	T	A	12	21	33	0	0	33	0	0
22	37652191	.	C	T	10	10	20	0	0	20	0	0
22	37652925	.	C	T	10	10	20	0	0	20	0	0
22	37655702	.	C	T	9	11	20	0	2	22	0	0
22	37708199	.	T	A	20	18	38	1	1	40	0	0
22	37710178	.	G	T	29	22	51	0	1	52	0	0
22	37712570	.	A	G	19	0	19	0	20	39	0	0
22	37716493	.	G	C	17	13	30	0	1	31	0	0
22	37738043	.	C	T	3	2	5	0	0	5	0	0
22	37738049	.	G	T	2	3	5	0	0	5	0	0
22	37773189	.	C	T	1	3	4	0	0	4	0	0
22	37805329	.	C	T	15	25	40	0	0	40	0	0
22	37823332	.	C	A	2	11	13	0	15	28	0	0
22	37874723	.	C	T	1	3	4	0	0	4	0	0
22	37881126	.	C	T	2	9	11	0	0	11	0	0
22	37881134	.	G	A	2	10	12	0	0	12	0	0
22	38001277	.	A	C	1	2	3	0	0	3	0	0
22	38001504	.	G	A	2	6	8	0	0	8	0	0
22	38005108	.	C	A	1	4	5	0	0	5	0	0
22	38005162	.	C	G	0	3	3	0	3	6	0	0
22	38019898	.	T	C	1	3	4	0	0	4	0	0
22	38029013	.	T	C	3	3	6	0	0	6	0	0
22	38029035	.	A	T	2	4	6	0	0	6	0	0
22	38034547	.	G	T	1	2	3	0	0	3	0	0
22	38037578	.	A	T	10	6	16	0	0	16	0	0
22	38037603	.	G	T	5	4	9	0	0	9	0	0
22	38040050	.	G	A	0	9	9	0	2	11	0	0
22	38044902	.	G	C	0	14	14	0	5	19	0	0
22	38045009	.	T	A	10	9	19	0	0	19	0	0
22	38045213	.	G	T	2	1	3	0	0	3	0	0
22	38186385	.	C	A	3	2	5	0	0	5	0	0
22	38191168	.	C	G	1	2	3	0	0	3	0	0
22	38191718	.	T	A	3	6	9	0	0	9	0	0
22	38192440	.	A	G	4	7	11	0	0	11	0	0
22	38194106	.	C	T	6	5	11	0	0	11	0	0
22	38194415	.	A	G	7	9	16	0	0	16	0	0
22	38194419	.	G	C	6	9	15	0	0	15	0	0
22	38195217	.	G	A	14	12	26	0	0	26	0	0
22	38197777	.	C	T	29	29	58	0	1	59	0	0
22	38197783	.	G	C	24	32	56	0	2	58	0	0
22	38199812	.	A	G	4	7	11	0	0	11	0	0
22	38202898	.	T	C	8	7	15	0	1	16	0	0
22	38202904	.	C	T	6	8	14	0	2	16	0	0
22	38205099	.	C	T	1	7	8	0	6	14	0	0
22	38207367	.	T	A	4	4	8	0	0	8	0	0
22	38211271	.	C	A	0	4	4	0	4	8	0	0
22	38211350	.	A	G	2	4	6	0	1	7	0	0
22	38212080	.	T	C	0	3	3	0	2	5	0	0
22	38212082	.	G	T	2	3	5	0	0	5	0	0
22	38276083	.	T	A	1	3	4	0	0	4	0	0
22	38280834	.	T	G	1	0	1	0	4	5	0	0
22	38283993	.	A	G	2	3	5	0	0	5	0	0
22	38286866	.	T	C	3	1	4	0	1	5	0	0
22	38286875	.	G	A	0	3	3	0	2	5	0	0
22	38289964	.	T	C	2	6	8	0	0	8	0	0
22	38289982	.	T	C	3	6	9	0	0	9	0	0
22	38293836	.	G	A	0	5	5	0	12	17	0	0
22	38293866	.	A	T	9	4	13	0	8	21	0	0
22	38337414	.	T	C	9	7	16	0	0	16	0	0
22	38337417	.	A	C	8	1	9	0	6	15	0	0
22	38343178	.	G	A	3	2	5	0	0	5	0	0
22	38401006	.	T	C	0	1	1	0	0	1	0	0
22	38468163	.	A	G	4	3	7	0	1	8	0	0
22	38468562	.	C	T	0	16	16	0	23	39	0	0
22	38469848	.	C	A	0	20	20	0	17	37	0	0
22	38469856	.	G	A	16	22	38	0	0	39	1	0
22	38469884	.	G	A	16	16	32	1	2	35	0	0
22	38469926	.	G	A	15	23	38	1	4	43	0	0
22	38471854	.	T	A	18	19	37	0	0	37	0	0
22	38474186	.	G	A	10	20	30	0	2	32	0	0
22	38475506	.	C	A	12	17	29	0	2	31	0	0
22	38475593	.	A	G	18	24	42	0	1	43	0	0
22	38475676	.	G	A	22	8	30	0	0	30	0	0
22	38492116	.	G	A	28	19	47	0	3	50	0	0
22	38496335	.	A	G	24	16	40	0	3	43	0	0
22	38499700	.	C	T	12	13	25	2	2	29	0	0
22	38499727	.	C	T	2	9	11	2	14	27	0	0
22	38501815	.	G	C	9	18	27	0	0	27	0	0
22	38506387	.	T	C	7	9	16	0	2	18	0	0
22	38508006	.	C	A	17	10	27	0	1	28	0	0
22	38508018	.	C	A	18	11	29	0	0	29	0	0
22	38508100	.	C	T	13	13	26	0	1	27	0	0
22	38508102	.	C	T	13	14	27	0	0	27	0	0
22	38516814	.	A	T	13	10	23	0	1	24	0	0
22	38516816	.	C	T	14	10	24	0	0	24	0	0
22	38516893	.	C	T	8	7	15	0	0	15	0	0
22	38516899	.	G	A	4	6	10	0	1	11	0	0
22	38520336	.	A	C	14	0	14	0	8	22	0	0
22	38520360	.	A	C	13	6	19	0	0	19	0	0
22	38521095	.	T	C	10	17	27	0	0	27	0	0
22	38521154	.	G	C	12	14	26	0	1	27	0	0
22	38521454	.	C	A	6	9	15	0	0	15	0	0
22	38521596	.	C	G	6	5	11	0	0	11	0	0
22	38521630	.	A	G	12	11	23	0	1	24	0	0
22	38521743	.	C	T	6	7	13	0	0	13	0	0
22	38521949	.	T	A	13	13	26	0	1	27	0	0
22	38522436	.	T	C	3	0	3	0	8	11	0	0
22	38522468	.	C	T	6	4	10	0	0	10	0	0
22	38522596	.	C	T	0	17	17	0	2	19	0	0
22	38522622	.	G	C	13	13	26	0	0	26	0	0
22	38522711	.	G	A	15	10	25	0	1	26	0	0
22	38522899	.	T	A	13	9	22	0	0	22	0	0
22	38522915	.	T	A	0	16	16	0	0	16	0	0
22	38523376	.	A	C	3	0	3	0	6	9	0	0
22	38523616	.	C	G	13	9	22	0	0	22	0	0
22	38523658	.	A	T	11	9	20	0	1	21	0	0
22	38523865	.	C	G	0	7	7	0	1	8	0	0
22	38523917	.	C	A	0	10	10	0	5	15	0	0
22	38524033	.	T	C	11	4	15	0	0	15	0	0
22	38524107	.	C	T	1	4	5	0	0	5	0	0
22	38524494	.	C	T	0	8	8	0	3	11	0	0
22	38524536	.	T	G	9	5	14	0	1	15	0	0
22	38524539	.	C	T	1	5	6	0	10	16	0	0
22	38524616	.	A	T	2	9	11	0	0	11	0	0
22	38524701	.	T	G	5	4	9	0	0	9	0	0
22	38524721	.	T	C	3	0	3	0	2	5	0	0
22	38524771	.	G	A	3	3	6	0	0	6	0	0
22	38525082	.	G	A	7	6	13	0	0	13	0	0
22	38525146	.	A	G	4	4	8	0	1	9	0	0
22	38525155	.	A	T	4	4	8	0	0	8	0	0
22	38525326	.	T	G	3	4	7	0	0	7	0	0
22	38525789	.	A	C	2	5	7	0	0	7	0	0
22	38525996	.	G	T	6	6	12	0	0	12	0	0
22	38530277	.	T	C	6	2	8	0	0	8	0	0
22	38545882	.	A	C	9	0	9	0	5	14	0	0
22	38545921	.	C	T	0	10	10	0	2	12	0	0
22	38549152	.	G	A	8	5	13	0	0	13	0	0
22	38549990	.	A	G	6	7	13	0	0	13	0	0
22	38550922	.	T	C	3	4	7	0	0	7	0	0
22	38559907	.	A	G	8	4	12	0	1	13	0	0
22	38566147	.	T	C	7	4	11	0	0	11	0	0
22	38615295	.	T	C	15	0	15	0	13	28	0	0
22	38796652	.	A	T	6	8	14	0	0	14	0	0
22	38796656	.	T	A	2	9	11	0	1	12	0	0
22	38796689	.	G	A	6	2	8	0	0	8	0	0
22	38796813	.	A	T	15	6	21	0	0	21	0	0
22	38798816	.	T	C	11	0	11	0	6	17	0	0
22	38799616	.	A	G	1	2	3	0	0	3	0	0
22	38800038	.	T	A	5	4	9	0	0	9	0	0
22	38800183	.	T	C	5	0	5	0	7	12	0	0
22	38911467	.	G	A	0	2	2	0	3	5	0	0
22	38912426	.	C	T	2	7	9	0	0	9	0	0
22	38912445	.	A	G	1	2	3	0	0	3	0	0
22	38915088	.	C	T	4	5	9	0	0	9	0	0
22	38919010	.	A	C	2	2	4	0	0	4	0	0
22	38919079	.	T	C	2	2	4	0	0	4	0	0
22	38925404	.	A	G	2	0	2	0	6	8	0	0
22	38928367	.	G	C	0	6	6	0	1	7	0	0
22	38928475	.	C	T	5	5	10	1	0	11	0	0
22	38928677	.	C	G	3	4	7	1	0	8	0	0
22	38932288	.	G	A	15	15	30	0	0	30	0	0
22	38932327	.	G	A	10	13	23	0	0	23	0	0
22	38934663	.	C	T	5	8	13	0	0	13	0	0
22	38942975	.	T	C	2	5	7	0	1	8	0	0
22	38942981	.	A	T	6	2	8	0	0	8	0	0
22	38943059	.	T	C	5	3	8	0	0	8	0	0
22	38945312	.	C	T	6	4	10	0	0	10	0	0
22	38947013	.	G	A	13	9	22	0	1	23	0	0
22	38947040	.	G	A	15	8	23	0	0	23	0	0
22	38951084	.	T	C	11	10	21	0	1	22	0	0
22	38951186	.	G	T	3	5	8	0	1	9	0	0
22	39014518	.	A	G	4	4	8	0	1	9	0	0
22	39014557	.	A	G	3	2	5	0	0	5	0	0
22	39014569	.	G	A	0	3	3	0	2	5	0	0
22	39014735	.	T	C	1	2	3	0	2	5	0	0
22	39023330	.	A	G	4	0	4	0	3	7	0	0
22	39023646	.	A	G	4	0	4	0	3	7	0	0
22	39023680	.	C	A	5	5	10	0	0	10	0	0
22	39023804	.	T	G	3	0	3	0	9	12	0	0
22	39023863	.	G	C	0	4	4	0	4	8	0	0
22	39023877	.	T	A	5	4	9	0	0	9	0	0
22	39026706	.	T	C	4	4	8	0	1	9	0	0
22	39028350	.	G	A	0	6	6	0	3	9	0	0
22	39033036	.	C	G	7	5	12	0	0	12	0	0
22	39033053	.	C	T	7	4	11	0	0	11	0	0
22	39033644	.	T	C	3	9	12	0	0	12	0	0
22	39033878	.	T	G	3	0	3	0	5	8	0	0
22	39033883	.	T	C	3	4	7	0	1	8	0	0
22	39054683	.	T	C	6	3	9	0	0	9	0	0
22	39079231	.	T	C	6	11	17	0	0	17	0	0
22	39079335	.	G	A	2	11	13	0	7	20	0	0
22	39079428	.	C	G	10	7	17	1	1	19	0	0
22	39079528	.	T	A	7	15	22	0	0	22	0	0
22	39079950	.	C	A	10	16	26	0	2	28	0	0
22	39079997	.	A	G	14	14	28	0	0	28	0	0
22	39080290	.	C	T	15	10	25	0	0	25	0	0
22	39080300	.	A	T	14	10	24	0	3	27	0	0
22	39080402	.	A	C	16	11	27	0	0	27	0	0
22	39080547	.	A	C	5	12	17	0	0	17	0	0
22	39080679	.	C	G	14	11	25	0	1	26	0	0
22	39080701	.	C	A	16	14	30	0	0	30	0	0
22	39080774	.	C	G	11	13	24	0	1	25	0	0
22	39081126	.	A	T	14	9	23	0	1	24	0	0
22	39081169	.	A	G	15	0	15	0	11	26	0	0
22	39081177	.	C	T	19	8	27	0	0	27	0	0
22	39081259	.	T	A	12	17	29	0	2	31	0	0
22	39084943	.	G	A	8	10	18	0	1	19	0	0
22	39090558	.	A	G	6	0	6	0	6	12	0	0
22	39093913	.	G	A	3	2	5	0	0	5	0	0
22	39093984	.	T	C	11	5	16	0	0	16	0	0
22	39095748	.	G	A	5	11	16	0	0	16	0	0
22	39100979	.	G	A	0	2	2	0	3	5	0	0
22	39100984	.	C	T	2	2	4	0	1	5	0	0
22	39103941	.	T	C	1	3	4	0	1	5	0	0
22	39104849	.	G	A	3	8	11	0	0	11	0	0
22	39105022	.	T	C	3	5	8	0	0	8	0	0
23	252280	.	T	C	2	0	2	0	2	4	0	0
23	252305	.	T	C	3	3	6	0	0	6	0	0
23	310662	.	G	T	12	15	27	0	1	28	0	0
23	310860	.	G	C	6	12	18	0	2	20	0	0
23	312700	.	C	A	13	10	23	0	0	23	0	0
23	312703	.	A	C	12	10	22	0	0	22	0	0
23	313274	.	G	A	11	9	20	0	0	20	0	0
23	313368	.	A	G	4	0	4	0	8	12	0	0
23	313468	.	A	G	2	5	7	0	0	7	0	0
23	313485	.	G	A	4	3	7	0	0	7	0	0
23	313559	.	G	A	2	5	7	0	0	7	0	0
23	314018	.	G	A	5	4	9	0	0	9	0	0
23	314055	.	T	C	1	5	6	0	0	6	0	0
23	314093	.	A	T	3	8	11	0	0	11	0	0
23	314370	.	T	A	6	4	10	0	0	10	0	0
23	314413	.	G	T	1	9	10	0	9	19	0	0
23	314573	.	A	G	1	4	5	0	0	5	0	0
23	314841	.	A	T	1	5	6	0	0	6	0	0
23	314910	.	C	T	2	6	8	0	0	8	0	0
23	315286	.	A	G	21	15	36	0	4	40	0	0
23	320806	.	T	C	4	3	7	0	0	7	0	0
23	320819	.	A	G	5	3	8	0	0	8	0	0
23	322290	.	A	G	3	2	5	0	0	5	0	0
23	322346	.	A	T	4	2	6	0	1	7	0	0
23	327998	.	C	T	6	5	11	0	1	12	0	0
23	328248	.	G	C	4	4	8	0	0	8	0	0
23	328251	.	T	C	4	0	4	0	4	8	0	0
23	328582	.	G	T	3	5	8	0	0	8	0	0
23	328589	.	T	A	4	5	9	0	0	9	0	0
23	328783	.	G	T	4	5	9	0	2	11	0	0
23	328806	.	C	G	8	3	11	0	0	11	0	0
23	328825	.	C	T	0	8	8	0	3	11	0	0
23	339059	.	G	A	2	4	6	0	0	6	0	0
23	341802	.	C	G	3	4	7	0	0	7	0	0
23	341820	.	T	C	1	0	1	0	5	6	0	0
23	355954	.	C	T	4	2	6	0	0	6	0	0
23	359371	.	A	T	2	3	5	0	1	6	0	0
23	359442	.	C	T	3	5	8	0	0	8	0	0
23	360316	.	C	T	4	3	7	0	0	7	0	0
23	365495	.	A	G	7	1	8	0	8	16	0	0
23	365528	.	C	T	4	6	10	0	0	10	0	0
23	366662	.	T	C	2	4	6	0	0	6	0	0
23	367431	.	T	A	5	6	11	0	2	13	0	0
23	367500	.	C	T	6	3	9	0	0	9	0	0
23	367672	.	A	T	1	2	3	0	0	3	0	0
23	423790	.	G	A	4	4	8	0	0	8	0	0
23	423802	.	C	T	3	3	6	0	1	7	0	0
23	457872	.	T	C	6	11	17	0	0	17	0	0
23	457995	.	A	T	3	3	6	0	0	6	0	0
23	458031	.	G	T	1	1	2	0	0	2	0	0
23	458042	.	C	T	2	3	5	0	0	5	0	0
23	458086	.	G	A	6	5	11	0	0	11	0	0
23	458194	.	T	A	3	6	9	0	2	11	0	0
23	458257	.	T	C	5	8	13	0	0	13	0	0
23	459671	.	C	T	0	7	7	0	6	13	0	0
23	460612	.	G	C	4	3	7	0	0	7	0	0
23	460836	.	G	A	1	2	3	0	0	3	0	0
23	460838	.	G	A	1	1	2	0	1	3	0	0
23	461177	.	T	C	2	3	5	0	2	7	0	0
23	461636	.	A	G	2	2	4	0	0	4	0	0
23	467114	.	T	G	1	2	3	0	0	3	0	0
23	468480	.	A	G	1	1	2	0	0	2	0	0
23	472853	.	A	C	2	0	2	0	3	5	0	0
23	472856	.	C	T	3	2	5	0	0	5	0	0
23	473250	.	A	G	3	2	5	0	0	5	0	0
23	473252	.	A	G	2	3	5	0	0	5	0	0
23	480551	.	C	G	10	6	16	0	0	16	0	0
23	480552	.	A	G	9	6	15	0	1	16	0	0
23	481089	.	T	G	26	19	45	0	2	47	0	0
23	484376	.	C	A	37	13	50	0	0	50	0	0
23	484588	.	G	A	17	11	28	0	0	28	0	0
23	488257	.	A	G	16	17	33	0	1	34	0	0
23	488996	.	G	A	13	7	20	0	0	20	0	0
23	491052	.	G	A	4	2	6	0	1	7	0	0
23	493127	.	A	C	3	2	5	0	3	8	0	0
23	495732	.	A	T	1	3	4	0	0	4	0	0
23	495747	.	C	T	0	3	3	0	1	4	0	0
23	496469	.	A	G	1	3	4	0	1	5	0	0
23	506078	.	C	G	3	3	6	0	0	6	0	0
23	517969	.	C	T	0	4	4	0	1	5	0	0
23	517994	.	C	T	0	3	3	0	1	4	0	0
23	527362	.	T	C	1	2	3	0	0	3	0	0
23	528234	.	T	A	5	1	6	0	1	7	0	0
23	531253	.	C	T	0	2	2	0	2	4	0	0
23	531256	.	T	C	2	0	2	0	2	4	0	0
23	539895	.	A	G	1	2	3	0	0	3	0	0
23	547870	.	T	G	2	6	8	0	0	8	0	0
23	547873	.	G	A	2	6	8	0	0	8	0	0
23	551277	.	C	T	4	2	6	0	0	6	0	0
23	584898	.	A	G	3	0	3	0	2	5	0	0
23	585825	.	A	G	12	7	19	0	0	19	0	0
23	585848	.	A	G	7	0	7	0	11	18	0	0
23	587161	.	A	G	6	7	13	0	0	13	0	0
23	804154	.	G	C	1	1	2	0	1	3	0	0
23	804164	.	A	G	1	2	3	0	0	3	0	0
23	805479	.	A	T	2	3	5	0	0	5	0	0
23	813290	.	T	C	1	5	6	0	0	6	0	0
23	825773	.	A	G	2	3	5	0	0	5	0	0
23	828372	.	C	A	2	3	5	0	0	5	0	0
23	830033	.	C	T	5	6	11	0	0	11	0	0
23	830047	.	G	C	5	5	10	0	1	11	0	0
23	831659	.	C	T	4	7	11	0	1	12	0	0
23	831749	.	T	C	5	5	10	3	2	15	0	0
23	835575	.	G	C	5	6	11	0	1	12	0	0
23	835631	.	A	G	3	5	8	0	3	11	0	0
23	835970	.	G	A	4	2	6	0	3	9	0	0
23	838285	.	C	G	5	4	9	0	0	9	0	0
23	862457	.	T	C	1	2	3	0	0	3	0	0
23	862467	.	T	C	1	0	1	0	2	3	0	0
23	862501	.	C	G	1	1	2	0	1	3	0	0
23	862782	.	T	A	6	7	13	0	0	13	0	0
23	863135	.	A	G	12	3	15	0	0	15	0	0
23	863261	.	C	A	5	2	7	0	1	8	0	0
23	863395	.	T	C	7	4	11	0	0	11	0	0
23	863673	.	T	C	13	5	18	0	0	18	0	0
23	863918	.	T	C	4	3	7	0	1	8	0	0
23	864125	.	T	C	8	2	10	0	0	10	0	0
23	864292	.	T	C	2	5	7	0	0	7	0	0
23	864307	.	T	C	2	5	7	0	0	7	0	0
23	864418	.	C	T	2	2	4	0	0	4	0	0
23	865619	.	T	C	4	7	11	0	1	12	0	0
23	865644	.	G	T	5	2	7	0	0	7	0	0
23	865999	.	C	T	2	3	5	0	3	8	0	0
23	866004	.	A	T	5	3	8	0	0	8	0	0
23	866409	.	A	G	7	6	13	0	0	13	0	0
23	866439	.	C	T	0	6	6	0	9	15	0	0
23	866444	.	T	C	9	0	9	0	7	16	0	0
23	866836	.	A	G	12	7	19	0	0	19	0	0
23	874620	.	A	G	8	7	15	0	1	16	0	0
23	874621	.	T	G	8	7	15	0	1	16	0	0
23	883062	.	C	G	1	4	5	0	5	10	0	0
23	896023	.	C	A	4	5	9	0	0	9	0	0
23	898217	.	A	G	4	2	6	0	0	6	0	0
23	898329	.	T	G	5	4	9	0	0	9	0	0
23	900387	.	T	C	0	0	0	0	3	3	0	0
23	903104	.	A	G	4	5	9	0	0	9	0	0
23	903212	.	G	C	17	7	24	0	3	27	0	0
23	903334	.	G	A	10	20	30	1	4	35	0	0
23	903415	.	T	A	11	14	25	0	0	25	0	0
23	903553	.	T	G	18	24	42	0	0	42	0	0
23	903848	.	G	A	25	14	39	0	5	44	0	0
23	906346	.	T	A	15	24	39	0	0	39	0	0
23	910357	.	A	G	16	13	29	0	3	32	0	0
23	1045755	.	G	T	4	2	6	0	1	7	0	0
23	1046815	.	T	C	1	2	3	0	0	3	0	0
23	1055314	.	T	C	1	2	3	0	0	3	0	0
23	1258878	.	T	C	3	2	5	0	0	5	0	0
23	1565155	.	A	G	1	1	2	0	1	3	0	0
23	1691708	.	G	A	0	4	4	0	3	7	0	0
23	1697238	.	T	G	14	0	14	0	4	18	0	0
23	1697242	.	C	T	15	2	17	0	2	19	0	0
23	1697329	.	G	A	1	4	5	0	6	11	0	0
23	1697434	.	C	T	3	2	5	0	0	5	0	0
23	1697689	.	A	G	5	5	10	0	0	10	0	0
23	1697690	.	A	G	5	5	10	0	0	10	0	0
23	1697860	.	C	T	10	3	13	0	0	13	0	0
23	1698116	.	T	G	15	0	15	0	7	22	0	0
23	1698139	.	T	C	17	4	21	0	0	21	0	0
23	1698329	.	T	A	2	4	6	0	1	7	0	0
23	1698358	.	G	T	0	2	2	0	1	3	0	0
23	1702648	.	C	T	4	6	10	0	0	10	0	0
23	1709724	.	C	T	8	4	12	0	0	12	0	0
23	1709740	.	A	G	8	0	8	0	5	13	0	0
23	1719384	.	A	G	9	6	15	0	0	15	0	0
23	1723720	.	A	G	5	0	5	0	8	13	0	0
23	1723748	.	G	A	6	7	13	0	0	13	0	0
23	1723992	.	C	T	5	5	10	0	2	12	0	0
23	1725456	.	T	C	11	3	14	0	0	14	0	0
23	1725664	.	G	A	8	3	11	0	1	12	0	0
23	1725785	.	G	C	7	7	14	0	0	14	0	0
23	1725803	.	G	C	3	6	9	0	1	11	1	0
23	1725959	.	C	T	14	3	17	1	1	19	0	0
23	1725974	.	T	A	16	6	22	1	0	23	0	0
23	1726467	.	T	A	5	5	10	0	0	10	0	0
23	2053305	.	A	G	2	3	5	0	0	5	0	0
23	2053414	.	A	G	4	2	6	0	2	8	0	0
23	2053418	.	C	A	4	4	8	0	0	8	0	0
23	2054010	.	C	T	5	8	13	0	2	15	0	0
23	2054175	.	G	A	5	2	7	0	0	7	0	0
23	2054316	.	C	G	6	6	12	0	0	12	0	0
23	2054505	.	G	A	4	4	8	0	0	8	0	0
23	2054584	.	G	C	3	3	6	0	0	6	0	0
23	2054613	.	A	G	4	1	5	0	0	5	0	0
23	2054622	.	T	C	3	0	3	0	2	5	0	0
23	2054760	.	G	A	4	3	7	0	0	7	0	0
23	2054838	.	C	T	0	5	5	0	2	7	0	0
23	2054952	.	T	G	2	8	10	0	0	10	0	0
23	2055162	.	G	A	2	3	5	0	1	6	0	0
23	2055219	.	T	C	2	4	6	0	0	6	0	0
23	2055240	.	T	A	3	4	7	0	0	7	0	0
23	2099158	.	A	G	1	4	5	0	0	5	0	0
23	2136417	.	T	C	6	4	10	0	0	10	0	0
23	2155134	.	T	C	7	8	15	0	0	15	0	0
23	2158054	.	T	C	7	4	11	0	0	11	0	0
23	2159114	.	G	A	5	6	11	0	1	12	0	0
23	2160242	.	T	C	5	7	12	0	0	12	0	0
23	2216256	.	T	A	2	2	4	0	0	4	0	0
23	2216281	.	C	T	3	2	5	0	0	5	0	0
23	2224276	.	T	A	2	2	4	0	0	4	0	0
23	2246656	.	T	C	3	2	5	0	0	5	0	0
23	2246662	.	C	T	3	2	5	0	0	5	0	0
23	2249537	.	A	G	1	0	1	0	2	3	0	0
23	2249589	.	G	A	0	6	6	0	3	9	0	0
23	2249633	.	T	C	2	7	9	0	0	9	0	0
23	2252812	.	G	A	6	8	14	0	0	14	0	0
23	2256142	.	G	C	4	5	9	0	0	9	0	0
23	2256348	.	C	T	3	7	10	0	0	10	0	0
23	2256349	.	A	T	3	6	9	0	1	10	0	0
23	2361516	.	A	G	4	3	7	0	1	8	0	0
23	2391852	.	G	A	0	7	7	0	5	12	0	0
23	2435776	.	G	A	16	24	40	0	0	40	0	0
23	2438388	.	G	A	16	20	36	0	1	37	0	0
23	2438463	.	G	T	1	12	13	0	10	23	0	0
23	2438641	.	A	T	17	25	42	0	3	45	0	0
23	2440698	.	G	A	19	22	41	0	1	42	0	0
23	2443160	.	C	T	22	18	40	0	3	43	0	0
23	2443613	.	C	T	15	19	34	0	0	34	0	0
23	2542247	.	T	A	1	2	3	0	1	4	0	0
23	2547556	.	A	C	4	5	9	0	0	9	0	0
23	2564339	.	T	A	10	8	18	3	2	23	0	0
23	2564420	.	T	C	5	7	12	0	0	12	0	0
23	2679634	.	G	A	1	8	9	15	11	35	0	0
23	2689807	.	T	C	20	10	30	0	1	31	0	0
23	2690659	.	C	T	17	14	31	0	4	35	0	0
23	2716519	.	C	A	6	6	12	0	0	12	0	0
23	2717852	.	A	C	16	15	31	0	3	34	0	0
23	2717867	.	T	G	12	17	29	0	3	32	0	0
23	2718009	.	C	G	10	11	21	0	0	21	0	0
23	2721539	.	A	G	17	16	33	0	0	33	0	0
23	2725095	.	A	C	7	11	18	0	2	20	0	0
23	2757841	.	C	T	3	4	7	0	1	8	0	0
23	2757876	.	T	A	4	3	7	0	0	7	0	0
23	2762007	.	A	G	5	5	10	0	1	11	0	0
23	2767194	.	G	A	0	6	6	0	3	9	0	0
23	2767227	.	C	T	3	4	7	0	0	7	0	0
23	2771736	.	A	G	8	0	8	0	2	10	0	0
23	2771737	.	C	A	8	2	10	0	0	10	0	0
23	2773310	.	C	T	7	4	11	0	1	12	0	0
23	2774812	.	G	A	4	15	19	0	0	19	0	0
23	2775033	.	G	A	1	6	7	0	0	7	0	0
23	2777534	.	G	A	6	3	9	0	0	9	0	0
23	2778827	.	A	G	4	5	9	0	0	9	0	0
23	2837155	.	T	C	6	6	12	0	0	12	0	0
23	2837188	.	C	T	7	5	12	0	0	12	0	0
23	2842292	.	G	T	0	2	2	0	5	7	0	0
23	2842407	.	C	A	5	3	8	0	0	8	0	0
23	2842409	.	G	A	4	3	7	0	1	8	0	0
23	2849307	.	G	A	1	4	5	0	4	9	0	0
23	2860937	.	T	G	10	0	10	0	5	15	0	0
23	2861990	.	C	T	12	6	18	0	0	18	0	0
23	2864186	.	A	T	9	6	15	0	0	15	0	0
23	2870732	.	T	A	18	8	26	0	0	26	0	0
23	2871264	.	C	T	10	7	17	0	0	17	0	0
23	2871699	.	G	A	14	11	25	0	0	25	0	0
23	2871908	.	A	G	18	1	19	0	2	21	0	0
23	2871994	.	T	C	12	12	24	0	1	25	0	0
23	2872206	.	T	C	9	15	24	0	0	24	0	0
23	2872338	.	T	G	29	0	29	0	14	43	0	0
23	2872517	.	G	T	24	22	46	0	4	50	0	0
23	2873327	.	A	T	4	7	11	0	0	11	0	0
23	2877144	.	C	T	0	9	9	0	5	14	0	0
23	2877519	.	T	C	2	0	2	0	3	5	0	0
23	2877603	.	A	C	6	5	11	0	0	11	0	0
23	2877792	.	C	A	1	8	9	0	3	12	0	0
23	2878041	.	C	A	1	2	3	0	4	7	0	0
23	2878401	.	A	G	4	5	9	0	0	9	0	0
23	2879040	.	A	G	1	2	3	0	0	3	0	0
23	2880000	.	A	G	1	2	3	0	1	4	0	0
23	2900767	.	A	G	6	3	9	0	0	9	0	0
23	2906312	.	A	G	11	10	21	0	0	21	0	0
23	2914612	.	A	G	4	0	4	0	4	8	0	0
23	2917463	.	T	C	4	2	6	0	0	6	0	0
23	2919264	.	A	G	5	0	5	0	5	10	0	0
23	2919276	.	T	C	3	4	7	0	0	7	0	0
23	2920448	.	C	T	2	1	3	0	1	4	0	0
23	2920753	.	G	A	2	5	7	0	0	7	0	0
23	2923068	.	G	A	0	4	4	0	4	8	0	0
23	2925086	.	T	C	5	2	7	0	1	8	0	0
23	2925137	.	C	T	6	8	14	0	0	14	0	0
23	2925238	.	A	T	0	2	2	0	1	3	0	0
23	2925357	.	T	C	4	2	6	0	0	6	0	0
23	2927117	.	A	G	4	4	8	0	1	9	0	0
23	2927144	.	A	G	4	4	8	0	0	8	0	0
23	2927175	.	C	T	5	4	9	0	0	9	0	0
23	2928559	.	G	A	7	10	17	0	1	18	0	0
23	2928583	.	A	G	5	9	14	0	1	15	0	0
23	2929180	.	A	G	3	9	12	0	0	12	0	0
23	2931288	.	T	A	8	8	16	0	0	16	0	0
23	2931321	.	G	A	8	5	13	0	3	16	0	0
23	2931329	.	C	A	9	5	14	0	0	14	0	0
23	2931358	.	C	T	3	6	9	0	0	9	0	0
23	2931409	.	C	T	11	3	14	0	0	14	0	0
23	2931461	.	A	G	7	1	8	0	10	19	1	0
23	2931732	.	C	A	6	5	11	0	1	12	0	0
23	2931836	.	C	A	6	6	12	0	3	15	0	0
23	2931970	.	T	A	9	5	14	0	0	14	0	0
23	2932241	.	A	T	5	6	11	0	1	12	0	0
23	3406094	.	C	A	4	3	7	0	0	7	0	0
23	3406708	.	T	C	15	7	22	0	0	22	0	0
23	3406729	.	A	G	16	10	26	0	0	26	0	0
23	3406811	.	T	C	15	13	28	0	1	29	0	0
23	3406950	.	T	G	8	7	15	0	0	15	0	0
23	3407285	.	T	A	11	20	31	0	3	34	0	0
23	3407305	.	C	A	10	19	29	0	2	31	0	0
23	3503614	.	C	A	1	2	3	0	0	3	0	0
23	3503622	.	A	G	1	2	3	0	0	3	0	0
23	3511291	.	T	C	3	5	8	0	0	8	0	0
23	3517582	.	T	A	1	8	9	0	0	9	0	0
23	3517621	.	T	G	5	7	12	0	0	12	0	0
23	3517800	.	C	T	2	6	8	0	0	8	0	0
23	3519953	.	A	G	7	0	7	0	9	16	0	0
23	3520120	.	C	T	13	5	18	0	2	20	0	0
23	3520932	.	G	T	9	3	12	0	0	12	0	0
23	3653478	.	G	T	16	21	37	0	0	37	0	0
23	3653846	.	T	C	15	16	31	0	0	31	0	0
23	3653859	.	G	A	13	17	30	0	0	30	0	0
23	3653953	.	T	A	11	10	21	0	0	21	0	0
23	3654034	.	A	G	11	10	21	0	0	21	0	0
23	3654106	.	C	T	4	4	8	0	1	9	0	0
23	3654134	.	A	G	2	4	6	0	0	6	0	0
23	3654356	.	C	T	6	7	13	0	0	13	0	0
23	3654490	.	A	C	21	6	27	0	1	28	0	0
23	3654747	.	C	T	2	18	20	0	17	37	0	0
23	3654774	.	G	A	20	14	34	0	0	34	0	0
23	3654989	.	A	G	28	19	47	0	0	47	0	0
23	3655082	.	C	T	4	12	16	0	21	37	0	0
23	3655139	.	T	A	22	18	40	0	2	42	0	0
23	3655207	.	T	G	23	18	41	0	0	41	0	0
23	3655220	.	A	G	28	17	45	0	2	47	0	0
23	3657557	.	T	C	27	19	46	0	2	48	0	0
23	3657602	.	T	C	32	1	33	0	21	54	0	0
23	3660060	.	C	A	6	29	35	0	15	50	0	0
23	3660674	.	A	G	29	18	47	0	3	50	0	0
23	3660713	.	G	A	23	18	41	0	2	43	0	0
23	3662210	.	G	A	29	15	44	0	1	45	0	0
23	3662246	.	C	T	3	8	11	0	22	33	0	0
23	3664306	.	A	G	15	23	38	0	2	40	0	0
23	3667257	.	T	C	18	19	37	0	3	40	0	0
23	3712002	.	G	A	8	5	13	0	0	13	0	0
23	3712062	.	C	T	6	4	10	2	1	13	0	0
23	3712719	.	A	G	4	4	8	0	0	8	0	0
23	3712723	.	C	T	4	4	8	0	0	8	0	0
23	3712884	.	C	T	1	1	2	1	0	3	0	0
23	3712905	.	A	C	1	2	3	0	0	3	0	0
23	3713321	.	A	G	4	7	11	0	0	11	0	0
23	3713363	.	A	G	8	9	17	0	1	18	0	0
23	3713388	.	C	T	9	7	16	0	0	16	0	0
23	3713400	.	A	C	8	6	14	0	0	14	0	0
23	3713452	.	T	C	9	6	15	0	1	16	0	0
23	3713453	.	G	A	10	6	16	0	0	16	0	0
23	3713491	.	G	A	11	6	17	0	1	18	0	0
23	3713622	.	A	G	9	3	12	0	0	12	0	0
23	3713968	.	C	T	6	3	9	0	1	10	0	0
23	3721131	.	T	C	11	7	18	0	1	19	0	0
23	3740379	.	T	A	4	16	20	0	4	24	0	0
23	3744621	.	C	T	16	9	25	0	1	26	0	0
23	3744654	.	A	C	11	5	16	0	1	17	0	0
23	3751965	.	A	G	18	18	36	0	0	36	0	0
23	3751990	.	A	G	16	18	34	0	1	35	0	0
23	3752305	.	C	G	14	20	34	0	2	36	0	0
23	3752394	.	C	T	1	15	16	0	21	37	0	0
23	3752992	.	T	A	18	12	30	0	2	32	0	0
23	3777916	.	T	C	2	3	5	0	0	5	0	0
23	3951804	.	T	C	7	3	10	0	1	11	0	0
23	3962692	.	A	G	3	4	7	0	0	7	0	0
23	3982480	.	G	A	4	3	7	0	1	8	0	0
23	3982588	.	G	A	2	3	5	0	0	5	0	0
23	3982936	.	G	C	1	0	1	0	2	3	0	0
23	4088188	.	T	C	1	2	3	0	0	3	0	0
23	4216221	.	G	A	1	2	3	0	0	3	0	0
23	4216241	.	C	T	1	3	4	0	0	4	0	0
23	4216363	.	T	C	4	1	5	0	4	9	0	0
23	4222119	.	A	G	3	6	9	0	0	9	0	0
23	4222149	.	G	A	2	6	8	0	1	9	0	0
23	4222164	.	G	T	2	6	8	0	0	8	0	0
23	4222275	.	C	T	1	3	4	0	0	4	0	0
23	4222437	.	C	G	3	2	5	0	0	5	0	0
23	4222503	.	C	T	3	2	5	0	0	5	0	0
23	4222509	.	G	A	4	3	7	0	0	7	0	0
23	4254105	.	G	T	0	29	29	0	23	52	0	0
23	4254192	.	A	C	16	16	32	1	3	36	0	0
23	4255566	.	C	G	25	1	26	1	26	53	0	0
23	4259194	.	A	G	21	17	38	0	0	38	0	0
23	4259369	.	T	G	22	20	42	0	4	46	0	0
23	4259626	.	G	A	22	12	34	0	1	35	0	0
23	4259635	.	G	C	4	10	14	0	21	35	0	0
23	4259674	.	G	T	11	2	13	0	2	15	0	0
23	4260629	.	G	A	5	7	12	0	1	13	0	0
23	4269780	.	C	G	14	15	29	0	2	31	0	0
23	4270928	.	T	C	21	23	44	0	2	46	0	0
23	4271333	.	A	G	29	21	50	0	0	50	0	0
23	4274411	.	G	T	1	2	3	0	1	4	0	0
23	4274423	.	C	T	3	4	7	0	0	7	0	0
23	4280877	.	A	C	5	2	7	0	0	7	0	0
23	4280888	.	G	A	5	2	7	0	0	7	0	0
23	4289066	.	C	G	5	8	13	0	0	13	0	0
23	4292251	.	C	T	5	6	11	0	0	11	0	0
23	4307737	.	C	T	18	15	33	0	1	34	0	0
23	4307740	.	T	C	17	17	34	0	0	34	0	0
23	4312033	.	T	G	12	17	29	0	0	29	0	0
23	4314691	.	G	A	15	7	22	0	1	23	0	0
23	4354330	.	C	A	1	3	4	0	1	5	0	0
23	4354363	.	C	T	1	2	3	0	0	3	0	0
23	4356128	.	C	A	1	3	4	0	0	4	0	0
23	4356932	.	C	T	2	2	4	0	0	4	0	0
23	4357124	.	T	C	2	4	6	0	0	6	0	0
23	4362847	.	C	G	1	2	3	0	0	3	0	0
23	4362874	.	T	C	1	3	4	0	0	4	0	0
23	4364914	.	C	T	8	3	11	0	2	13	0	0
23	4367390	.	T	A	6	2	8	8	0	16	0	0
23	4394600	.	G	A	2	2	4	0	0	4	0	0
23	4545389	.	T	G	1	2	3	0	0	3	0	0
23	4699483	.	A	G	13	1	14	2	2	18	0	0
23	4699485	.	G	A	7	2	9	2	2	13	0	0
23	5010006	.	C	T	2	4	6	0	0	6	0	0
23	5010178	.	C	T	1	3	4	0	0	4	0	0
23	5010722	.	C	T	6	7	13	0	0	13	0	0
23	5011064	.	T	A	6	4	10	0	0	10	0	0
23	5012826	.	C	T	3	1	4	0	1	5	0	0
23	5012832	.	T	C	3	2	5	0	0	5	0	0
23	6301287	.	T	A	11	12	23	0	1	24	0	0
23	6301332	.	T	C	4	7	11	0	1	12	0	0
23	6301413	.	A	G	11	7	18	0	0	18	0	0
23	6301416	.	T	C	11	8	19	0	0	19	0	0
23	6304243	.	A	G	15	0	15	0	7	22	0	0
23	6304249	.	T	C	15	5	20	0	0	20	0	0
23	6313752	.	T	A	14	9	23	0	2	25	0	0
23	6313801	.	T	G	13	14	27	0	1	28	0	0
23	6586608	.	A	C	1	3	4	0	0	4	0	0
23	6586974	.	C	G	1	8	9	0	1	10	0	0
23	6631499	.	G	T	6	4	10	0	0	10	0	0
23	6632043	.	G	A	2	2	4	0	0	4	0	0
23	6632044	.	A	T	2	2	4	0	0	4	0	0
23	6673724	.	C	A	2	8	10	0	7	17	0	0
23	6673956	.	A	G	18	14	32	0	1	33	0	0
23	6673991	.	A	C	17	13	30	0	0	30	0	0
23	6674970	.	T	C	1	4	5	0	0	5	0	0
23	6675100	.	C	T	7	3	10	0	0	10	0	0
23	6675135	.	G	A	2	6	8	0	1	9	0	0
23	6675325	.	G	T	9	16	25	0	1	26	0	0
23	6675537	.	G	A	19	13	32	0	1	33	0	0
23	6675550	.	A	T	16	13	29	0	1	30	0	0
23	6675835	.	G	A	12	5	17	0	0	17	0	0
23	6675959	.	C	G	10	7	17	0	4	21	0	0
23	6680521	.	T	C	13	0	13	0	11	24	0	0
23	6680805	.	G	A	12	14	26	0	0	26	0	0
23	6680880	.	C	T	19	10	29	0	1	30	0	0
23	6682025	.	C	T	8	8	16	0	0	16	0	0
23	6683992	.	C	A	2	8	10	0	4	14	0	0
23	6692100	.	T	C	4	0	4	0	6	10	0	0
23	6694340	.	G	A	8	11	19	0	0	19	0	0
23	6694341	.	A	T	8	10	18	0	1	19	0	0
23	6694608	.	A	T	11	9	20	0	0	20	0	0
23	6694634	.	G	T	7	9	16	0	1	17	0	0
23	6694929	.	C	T	1	2	3	0	2	5	0	0
23	6697466	.	A	G	3	3	6	0	0	6	0	0
23	6700626	.	C	A	8	5	13	0	1	14	0	0
23	6703099	.	G	A	5	7	12	0	0	12	0	0
23	6704783	.	C	T	1	4	5	0	0	5	0	0
23	6707243	.	T	A	5	7	12	0	0	12	0	0
23	6707357	.	G	A	4	4	8	0	0	8	0	0
23	6707724	.	C	T	5	6	11	0	0	11	0	0
23	6711172	.	C	G	1	7	8	0	4	12	0	0
23	6714146	.	T	G	5	4	9	0	1	10	0	0
23	6714412	.	T	C	5	0	5	0	4	9	0	0
23	6714810	.	G	T	2	3	5	0	0	5	0	0
23	6715806	.	G	A	1	2	3	0	0	3	0	0
23	6717050	.	G	A	4	2	6	0	0	6	0	0
23	6736121	.	T	A	10	10	20	0	0	20	0	0
23	6736166	.	C	T	1	10	11	0	12	23	0	0
23	6736265	.	C	A	7	4	11	0	0	11	0	0
23	6744328	.	C	T	10	24	34	0	1	35	0	0
23	6744385	.	C	T	16	9	25	0	0	25	0	0
23	6744576	.	T	G	14	15	29	0	2	31	0	0
23	6749754	.	C	G	11	15	26	0	0	26	0	0
23	6749783	.	T	C	6	0	6	0	9	15	0	0
23	6752944	.	T	A	2	3	5	0	0	5	0	0
23	6753002	.	A	T	3	5	8	0	1	9	0	0
23	6753191	.	A	G	3	6	9	0	0	9	0	0
23	6753309	.	C	T	6	8	14	0	1	15	0	0
23	6753363	.	C	T	14	4	18	0	0	18	0	0
23	6753414	.	C	T	4	5	9	0	0	9	0	0
23	6753462	.	G	T	0	8	8	0	8	16	0	0
23	6773374	.	T	C	12	9	21	0	1	22	0	0
23	6773392	.	G	A	13	10	23	0	0	23	0	0
23	6780803	.	A	G	14	5	19	0	0	19	0	0
23	6780856	.	G	A	2	9	11	0	15	26	0	0
23	6780859	.	G	A	14	8	22	0	2	24	0	0
23	6780895	.	A	G	14	10	24	0	1	25	0	0
23	6783957	.	C	T	16	5	21	0	0	21	0	0
23	6784176	.	C	T	16	4	20	0	0	20	0	0
23	6788768	.	T	C	3	2	5	0	0	5	0	0
23	6795737	.	A	T	7	3	10	0	1	11	0	0
23	6804831	.	T	C	2	6	8	0	1	9	0	0
23	6808515	.	C	T	7	5	12	0	0	12	0	0
23	6814119	.	T	G	8	4	12	0	0	12	0	0
23	6827511	.	C	T	9	9	18	0	1	19	0	0
23	6841005	.	T	C	14	13	27	0	0	27	0	0
23	6841021	.	G	A	2	7	9	0	15	24	0	0
23	6841138	.	C	A	8	5	13	0	0	13	0	0
23	6938413	.	C	T	6	2	8	0	1	9	0	0
23	6951157	.	C	T	0	3	3	0	1	4	0	0
23	6952261	.	T	C	6	0	6	1	8	15	0	0
23	6961424	.	G	A	2	3	5	0	0	5	0	0
23	7000229	.	C	T	3	4	7	0	0	7	0	0
23	7003572	.	G	T	15	12	27	0	1	28	0	0
23	7003744	.	C	T	11	8	19	0	3	22	0	0
23	7007879	.	C	T	9	11	20	0	0	20	0	0
23	7017443	.	A	G	6	10	16	0	1	17	0	0
23	7024631	.	T	C	10	11	21	0	0	22	1	0
23	7029585	.	G	A	13	5	18	0	0	18	0	0
23	7029600	.	G	A	11	5	16	0	1	17	0	0
23	7029741	.	G	A	3	3	6	0	1	7	0	0
23	7029916	.	A	T	3	2	5	0	0	5	0	0
23	7040725	.	G	A	7	7	14	0	1	15	0	0
23	7046813	.	G	A	10	8	18	0	0	18	0	0
23	7046816	.	G	C	9	0	9	0	10	19	0	0
23	7047072	.	T	C	4	0	4	0	7	11	0	0
23	7068334	.	A	T	4	2	6	0	0	6	0	0
23	7089569	.	A	C	1	3	4	0	0	4	0	0
23	7557382	.	C	T	8	3	11	0	0	11	0	0
23	7557383	.	G	A	3	8	11	0	0	11	0	0
23	7565426	.	C	A	4	8	12	0	2	14	0	0
23	7567105	.	A	G	7	5	12	0	0	12	0	0
23	7572445	.	A	G	5	0	5	0	5	10	0	0
23	7573845	.	T	C	7	9	16	0	0	16	0	0
23	7578710	.	T	C	5	16	21	0	2	23	0	0
23	7702128	.	A	G	1	3	4	0	0	4	0	0
23	7708956	.	G	A	1	2	3	0	1	4	0	0
23	7715282	.	G	T	3	3	6	0	0	6	0	0
23	7715873	.	G	A	6	5	11	0	0	11	0	0
23	7715909	.	T	C	5	2	7	0	0	7	0	0
23	7716023	.	T	C	4	4	8	0	0	8	0	0
23	7716281	.	T	C	6	8	14	0	0	14	0	0
23	7718359	.	C	T	6	7	13	0	0	13	0	0
23	7725252	.	T	C	4	3	7	0	0	7	0	0
23	7728594	.	T	C	5	5	10	0	0	10	0	0
23	7728606	.	C	T	4	5	9	0	0	9	0	0
23	7732649	.	C	T	4	5	9	0	0	9	0	0
23	7732651	.	T	C	3	5	8	0	1	9	0	0
23	7732761	.	C	T	3	4	7	0	0	7	0	0
23	7732866	.	C	G	5	4	9	0	1	10	0	0
23	7732874	.	C	G	4	4	8	0	1	9	0	0
23	7732918	.	G	A	6	3	9	0	0	9	0	0
23	7733043	.	C	T	2	7	9	0	1	10	0	0
23	7733047	.	G	A	7	4	11	0	0	11	0	0
23	7733081	.	A	G	6	2	8	0	1	9	0	0
23	7733118	.	A	G	7	4	11	0	3	14	0	0
23	7733269	.	C	G	2	3	5	0	0	5	0	0
23	7733374	.	C	T	8	5	13	0	0	13	0	0
23	7733732	.	T	C	1	5	6	0	0	6	0	0
23	7733861	.	A	G	3	5	8	0	0	8	0	0
23	7734321	.	C	T	5	3	8	0	0	8	0	0
23	7734331	.	C	T	3	3	6	0	0	6	0	0
23	7735360	.	T	G	1	0	1	0	4	5	0	0
23	7735384	.	C	T	4	3	7	0	0	7	0	0
23	7735423	.	G	A	2	8	10	0	0	10	0	0
23	7735428	.	G	A	1	7	8	0	1	9	0	0
23	7735464	.	T	C	3	2	5	0	0	5	0	0
23	7735695	.	C	T	6	6	12	0	3	15	0	0
23	7736064	.	T	C	3	4	7	0	0	7	0	0
23	7743748	.	G	T	6	8	14	0	1	15	0	0
23	7743871	.	C	T	1	10	11	0	7	18	0	0
23	7750495	.	A	G	5	4	9	0	0	9	0	0
23	7750552	.	G	A	4	4	8	0	0	8	0	0
23	7755088	.	T	C	4	0	4	0	4	8	0	0
23	7755112	.	A	C	4	2	6	0	1	7	0	0
23	7755165	.	G	A	5	2	7	0	0	7	0	0
23	7755215	.	T	C	2	2	4	0	0	4	0	0
23	7765955	.	G	A	7	9	16	0	0	16	0	0
23	7771378	.	A	T	5	3	8	0	0	8	0	0
23	7771440	.	G	A	7	5	12	0	0	12	0	0
23	7783606	.	C	T	4	5	9	0	1	10	0	0
23	7792567	.	A	G	5	7	12	0	0	12	0	0
23	8284903	.	C	T	4	5	9	0	0	9	0	0
23	8284991	.	G	T	9	6	15	0	0	15	0	0
23	8285220	.	G	A	9	15	24	0	2	26	0	0
23	8285236	.	G	T	12	16	28	0	1	29	0	0
23	8285332	.	C	T	21	11	32	0	1	33	0	0
23	8285365	.	G	A	17	13	30	0	1	31	0	0
23	8286192	.	T	C	10	0	10	0	14	24	0	0
23	8286261	.	C	T	1	6	7	0	8	15	0	0
23	8286333	.	G	T	6	4	10	0	0	10	0	0
23	8303831	.	A	C	1	0	1	0	3	4	0	0
23	8303897	.	C	T	2	2	4	1	1	6	0	0
23	8373535	.	T	G	4	5	9	0	0	9	0	0
23	8373641	.	A	G	5	4	9	0	1	10	0	0
23	8699593	.	C	A	2	3	5	0	0	5	0	0
23	8699686	.	C	T	0	2	2	0	1	3	0	0
23	8699949	.	T	C	4	2	6	0	0	6	0	0
23	9131416	.	A	G	1	0	1	0	2	3	0	0
23	9132108	.	C	T	3	3	6	0	1	7	0	0
23	9132150	.	T	C	2	3	5	0	1	6	0	0
23	9137628	.	T	C	3	2	5	0	0	5	0	0
23	9137644	.	A	G	2	2	4	0	0	4	0	0
23	9220531	.	T	A	1	2	3	0	0	3	0	0
23	9268466	.	T	C	2	5	7	0	0	7	0	0
23	9272674	.	C	T	2	7	9	0	0	9	0	0
23	9272984	.	T	C	4	6	10	0	0	10	0	0
23	9400848	.	G	C	5	5	10	0	0	10	0	0
23	9400902	.	G	A	7	5	12	0	0	12	0	0
23	9401107	.	C	T	1	3	4	0	0	4	0	0
23	9401344	.	G	A	6	5	11	0	0	11	0	0
23	9401439	.	T	C	5	10	15	0	0	15	0	0
23	9401470	.	C	T	7	9	16	0	0	16	0	0
23	9401918	.	A	G	6	3	9	0	0	9	0	0
23	9401954	.	G	A	4	3	7	0	0	7	0	0
23	9402065	.	T	C	2	4	6	0	0	6	0	0
23	9402326	.	G	A	3	2	5	0	0	5	0	0
23	9402459	.	G	A	2	4	6	0	1	7	0	0
23	9402564	.	G	A	6	2	8	0	1	9	0	0
23	9402857	.	C	T	3	3	6	0	0	6	0	0
23	9402915	.	G	C	5	5	10	0	0	10	0	0
23	9405689	.	A	C	2	2	4	0	0	4	0	0
23	9413159	.	G	A	1	2	3	0	0	3	0	0
23	9413456	.	C	T	1	4	5	0	0	5	0	0
23	9422123	.	T	C	3	0	3	0	3	6	0	0
23	9422161	.	T	A	4	2	6	0	0	6	0	0
23	9491414	.	A	G	2	2	4	0	0	4	0	0
23	9535312	.	C	T	3	2	5	0	0	5	0	0
23	9535327	.	C	T	3	2	5	0	0	5	0	0
23	9538742	.	A	G	5	6	11	0	1	12	0	0
23	9542588	.	T	C	3	8	11	0	0	11	0	0
23	9561030	.	A	C	2	1	3	0	0	3	0	0
23	9561035	.	T	C	5	2	7	0	0	7	0	0
23	9561099	.	C	A	10	10	20	0	0	20	0	0
23	9561695	.	G	A	10	7	17	0	0	17	0	0
23	9564268	.	T	C	11	7	18	0	0	18	0	0
23	9564283	.	C	A	7	8	15	0	0	15	0	0
23	9565948	.	T	C	24	19	43	0	1	44	0	0
23	9566370	.	T	C	15	14	29	0	0	29	0	0
23	9566375	.	G	A	1	17	18	0	12	30	0	0
23	9566471	.	T	G	18	0	18	0	20	38	0	0
23	9567122	.	C	T	16	10	26	0	1	27	0	0
23	9567532	.	T	C	1	3	4	0	0	4	0	0
23	9572424	.	A	G	3	3	6	0	2	8	0	0
23	9579168	.	T	C	1	4	5	0	1	6	0	0
23	9794868	.	T	G	21	15	36	0	1	37	0	0
23	9794959	.	T	A	15	10	25	0	1	26	0	0
23	9795057	.	A	G	18	26	44	0	1	45	0	0
23	9795434	.	C	T	1	15	16	0	13	29	0	0
23	9795663	.	A	C	9	14	23	0	1	24	0	0
23	9800761	.	T	G	12	12	24	0	2	26	0	0
23	9805838	.	A	G	5	9	14	1	0	15	0	0
23	9809863	.	A	G	10	15	25	0	0	25	0	0
23	9818057	.	A	G	11	19	30	0	0	30	0	0
23	9818153	.	C	T	11	9	20	0	0	20	0	0
23	9823221	.	T	C	12	12	24	0	0	24	0	0
23	9828634	.	C	A	1	9	10	0	6	16	0	0
23	9828762	.	G	A	9	7	16	0	2	18	0	0
23	9828765	.	C	G	0	8	8	0	9	17	0	0
23	9828838	.	T	C	11	1	12	0	6	18	0	0
23	9828925	.	G	A	9	8	17	0	1	18	0	0
23	9836778	.	G	A	5	6	11	0	0	11	0	0
23	9837018	.	G	A	8	4	12	0	0	12	0	0
23	9840669	.	G	A	2	3	5	0	0	5	0	0
23	9851839	.	C	T	4	6	10	0	1	11	0	0
23	10350549	.	T	C	5	3	8	0	0	8	0	0
23	10350591	.	G	A	3	4	7	0	0	7	0	0
23	10351405	.	T	A	4	2	6	0	0	6	0	0
23	10351661	.	A	G	1	2	3	0	0	3	0	0
23	10405703	.	G	A	12	13	25	1	1	27	0	0
23	10405707	.	A	G	14	0	14	1	11	26	0	0
23	10405742	.	G	C	3	10	13	0	12	25	0	0
23	10411562	.	A	C	5	6	11	0	0	11	0	0
23	10417484	.	T	G	8	11	19	0	2	21	0	0
23	10417502	.	C	T	9	15	24	0	0	24	0	0
23	10419933	.	A	C	11	15	26	0	0	26	0	0
23	10421216	.	A	C	12	23	35	0	0	35	0	0
23	10448606	.	G	T	4	11	15	0	17	32	0	0
23	10448642	.	G	A	24	14	38	0	1	39	0	0
23	10448936	.	C	T	7	8	15	0	0	15	0	0
23	10449063	.	T	C	9	14	23	0	0	23	0	0
23	10449136	.	A	G	11	0	11	0	15	26	0	0
23	10449185	.	C	T	11	6	17	0	0	17	0	0
23	10639121	.	G	A	2	4	6	0	0	6	0	0
23	10725320	.	T	C	10	3	13	0	0	13	0	0
23	10725334	.	T	C	10	3	13	0	0	13	0	0
23	10725638	.	A	T	6	6	12	0	0	12	0	0
23	10725919	.	C	A	4	14	18	0	2	20	0	0
23	10727563	.	G	A	11	13	24	0	1	25	0	0
23	10727614	.	C	T	7	5	12	0	1	13	0	0
23	10762922	.	G	A	10	13	23	0	0	23	0	0
23	10762972	.	T	A	4	9	13	0	0	13	0	0
23	10763070	.	G	A	5	7	12	0	0	12	0	0
23	10771991	.	C	A	1	15	16	0	12	28	0	0
23	10817179	.	G	A	3	5	8	0	1	9	0	0
23	10825591	.	C	T	7	8	15	0	3	18	0	0
23	10826427	.	C	T	17	7	24	0	0	24	0	0
23	10826718	.	C	A	14	7	21	0	0	21	0	0
23	10826754	.	C	T	9	6	15	0	0	15	0	0
23	10826856	.	A	T	3	2	5	0	0	5	0	0
23	10829164	.	A	G	3	3	6	0	0	6	0	0
23	11772230	.	A	C	1	2	3	0	0	3	0	0
23	11772310	.	C	T	3	2	5	0	0	5	0	0
23	11802582	.	C	T	4	2	6	0	0	6	0	0
23	11848645	.	C	T	6	4	10	0	0	10	0	0
23	11851459	.	C	A	4	4	8	0	0	8	0	0
23	11851467	.	C	T	4	4	8	0	0	8	0	0
23	11851545	.	T	C	3	2	5	0	0	5	0	0
23	11851603	.	C	T	1	2	3	0	0	3	0	0
23	11859294	.	C	T	7	2	9	0	0	9	0	0
23	11865055	.	T	A	12	10	22	0	0	22	0	0
23	11865934	.	C	T	17	17	34	0	1	35	0	0
23	11866086	.	G	A	18	15	33	0	1	34	0	0
23	11866183	.	G	A	17	27	44	0	2	46	0	0
23	11866259	.	T	C	20	18	38	0	2	40	0	0
23	11870203	.	A	T	12	16	28	0	2	30	0	0
23	11896251	.	G	A	8	9	17	0	0	17	0	0
23	11920705	.	G	A	2	4	6	0	0	6	0	0
23	11920712	.	C	T	4	2	6	0	0	6	0	0
23	12155166	.	G	A	3	6	9	0	0	9	0	0
23	12155298	.	G	A	4	6	10	0	0	10	0	0
23	12155319	.	G	A	4	6	10	0	0	10	0	0
23	12155391	.	G	A	7	5	12	0	0	12	0	0
23	12158643	.	A	G	2	5	7	0	0	7	0	0
23	12161145	.	T	A	2	2	4	0	0	4	0	0
23	12161148	.	G	T	3	2	5	0	0	5	0	0
23	12162034	.	G	A	3	6	9	0	0	9	0	0
23	12162073	.	T	G	5	0	5	0	9	14	0	0
23	12162099	.	G	C	7	6	13	0	0	13	0	0
23	12162163	.	C	T	1	7	8	0	0	8	0	0
23	12162386	.	A	C	2	2	4	0	2	6	0	0
23	12232873	.	G	A	5	4	9	0	1	10	0	0
23	12233117	.	G	A	10	16	26	0	1	27	0	0
23	12233121	.	C	T	0	10	10	0	17	27	0	0
23	12245797	.	G	T	1	2	3	0	0	3	0	0
23	12259026	.	C	T	1	23	24	0	12	36	0	0
23	12345695	.	G	A	12	6	18	0	0	18	0	0
23	12546823	.	C	T	3	3	6	0	1	7	0	0
23	13313801	.	G	A	3	4	7	0	0	7	0	0
23	13332153	.	A	G	1	2	3	0	0	3	0	0
23	13558711	.	C	T	3	4	7	0	1	8	0	0
23	13567257	.	G	T	2	4	6	0	0	6	0	0
23	13598094	.	C	T	3	3	6	0	0	6	0	0
23	13598632	.	T	C	7	7	14	0	0	14	0	0
23	13598679	.	C	T	7	4	11	0	2	13	0	0
23	13599008	.	G	A	4	7	11	0	1	12	0	0
23	13599079	.	G	A	1	3	4	0	1	5	0	0
23	13722416	.	C	A	6	7	13	0	0	13	0	0
23	13722728	.	G	A	0	6	6	1	3	11	1	0
23	13722755	.	C	G	4	0	4	1	8	13	0	0
23	13806408	.	C	T	13	7	20	0	2	22	0	0
23	13833376	.	T	A	17	23	40	0	0	40	0	0
23	13835932	.	C	A	8	8	16	0	1	17	0	0
23	13840297	.	G	A	8	6	14	0	0	14	0	0
23	13840362	.	C	T	0	9	9	0	5	14	0	0
23	13845114	.	A	C	5	6	11	0	0	11	0	0
23	13845131	.	G	A	7	8	15	0	1	16	0	0
23	13845149	.	T	G	9	7	16	0	0	16	0	0
23	13845201	.	A	G	6	7	13	0	0	13	0	0
23	13845247	.	G	T	2	8	10	0	0	10	0	0
23	13845389	.	C	A	4	6	10	0	0	10	0	0
23	13845411	.	G	T	8	4	12	0	0	12	0	0
23	13845447	.	T	C	9	7	16	0	1	17	0	0
23	13845493	.	T	C	4	0	4	0	3	7	0	0
23	13846482	.	G	T	5	3	8	0	0	8	0	0
23	13846627	.	G	T	3	6	9	0	0	9	0	0
23	13846631	.	C	T	6	2	8	0	0	8	0	0
23	13846742	.	T	A	3	3	6	0	0	6	0	0
23	13846783	.	T	C	4	2	6	0	0	6	0	0
23	13846854	.	C	T	2	2	4	0	0	4	0	0
23	13846885	.	A	G	2	5	7	0	0	7	0	0
23	13847142	.	G	A	4	7	11	0	3	14	0	0
23	13847220	.	T	C	4	3	7	0	0	7	0	0
23	13848537	.	G	A	3	3	6	0	0	6	0	0
23	13857114	.	G	A	4	3	7	0	0	7	0	0
23	13857170	.	G	T	2	3	5	0	0	5	0	0
23	13941275	.	C	T	9	3	12	0	2	14	0	0
23	13946174	.	C	T	2	7	9	0	3	12	0	0
23	13948993	.	G	A	9	10	19	0	0	19	0	0
23	13949110	.	C	T	0	10	10	0	8	18	0	0
23	14006105	.	G	A	5	2	7	0	0	7	0	0
23	14056306	.	C	T	1	3	4	0	0	4	0	0
23	14193676	.	A	G	10	3	13	0	1	14	0	0
23	14193777	.	C	T	10	9	19	0	2	21	0	0
23	14193923	.	A	C	13	9	22	0	1	23	0	0
23	14193940	.	C	T	10	10	20	0	4	24	0	0
23	14194035	.	C	G	8	16	24	0	2	26	0	0
23	14194058	.	G	A	9	18	27	0	1	28	0	0
23	14198137	.	G	A	18	10	28	0	1	29	0	0
23	14201512	.	T	C	13	9	22	0	1	23	0	0
23	14201521	.	T	C	12	7	19	0	2	21	0	0
23	14203829	.	T	G	11	14	25	0	1	26	0	0
23	14208718	.	A	G	8	16	24	0	0	24	0	0
23	14208817	.	A	T	11	11	22	0	0	22	0	0
23	14209024	.	T	G	6	15	21	0	1	22	0	0
23	14211707	.	C	T	14	9	23	0	0	23	0	0
23	14217799	.	G	A	5	2	7	0	0	7	0	0
23	14720234	.	G	A	1	4	5	0	2	7	0	0
23	14762403	.	G	A	1	2	3	0	0	3	0	0
23	14763325	.	T	C	2	2	4	0	0	4	0	0
23	14769407	.	G	A	2	2	4	0	0	4	0	0
23	14772079	.	G	A	2	2	4	0	0	4	0	0
23	14777039	.	A	C	4	3	7	0	0	7	0	0
23	14782599	.	C	T	1	3	4	0	0	4	0	0
23	14784150	.	G	A	1	2	3	0	0	3	0	0
23	14784237	.	A	C	2	3	5	0	0	5	0	0
23	14786347	.	T	C	2	4	6	0	0	6	0	0
23	14786429	.	A	T	5	2	7	0	1	8	0	0
23	14787318	.	T	A	5	5	10	0	0	10	0	0
23	14787409	.	G	A	1	7	8	0	2	10	0	0
23	14787426	.	G	A	2	5	7	0	1	8	0	0
23	14788082	.	A	G	9	1	10	0	11	21	0	0
23	14790429	.	G	A	5	3	8	0	0	8	0	0
23	14790611	.	C	T	3	3	6	0	0	6	0	0
23	14790827	.	G	A	6	7	13	0	0	13	0	0
23	14803409	.	C	T	3	2	5	0	0	5	0	0
23	14808490	.	G	A	6	3	9	0	0	9	0	0
23	14808537	.	G	T	4	4	8	0	0	8	0	0
23	14808545	.	A	G	3	4	7	0	0	7	0	0
23	14809613	.	C	A	1	2	3	0	1	4	0	0
23	14809673	.	G	A	4	2	6	0	0	6	0	0
23	14812065	.	A	G	1	2	3	0	0	3	0	0
23	14832549	.	A	T	3	4	7	0	0	7	0	0
23	14832677	.	G	A	25	15	40	0	1	41	0	0
23	14832774	.	G	A	32	26	58	0	0	58	0	0
23	14832835	.	C	T	32	25	57	0	4	61	0	0
23	14832866	.	C	T	22	27	49	0	6	56	1	0
23	14832926	.	A	T	29	20	49	0	0	49	0	0
23	14833032	.	C	T	36	26	62	0	2	64	0	0
23	14833142	.	A	T	24	29	53	0	1	54	0	0
23	14833143	.	A	T	25	27	52	0	2	54	0	0
23	14833189	.	A	C	27	22	49	0	1	50	0	0
23	14833552	.	T	C	38	19	57	0	3	60	0	0
23	14833581	.	T	C	34	1	35	1	23	59	0	0
23	14833664	.	G	A	37	18	55	0	3	58	0	0
23	14833765	.	G	A	32	31	63	2	4	69	0	0
23	14851621	.	A	G	32	24	56	0	0	56	0	0
23	14853221	.	G	A	22	18	40	0	1	41	0	0
23	14853342	.	G	A	29	19	48	0	3	51	0	0
23	14853411	.	C	T	29	13	42	0	1	43	0	0
23	14853414	.	C	T	2	14	16	0	26	42	0	0
23	14853833	.	C	T	32	14	46	0	0	46	0	0
23	14861941	.	T	C	23	19	42	0	2	44	0	0
23	14993089	.	G	A	13	6	19	0	1	20	0	0
23	14993140	.	T	C	5	1	6	0	15	21	0	0
23	14993200	.	A	T	11	13	24	0	1	25	0	0
23	14993393	.	C	A	8	7	15	0	1	16	0	0
23	14993936	.	A	T	6	4	10	0	0	10	0	0
23	14999053	.	C	T	13	12	25	0	0	25	0	0
23	14999095	.	C	T	2	14	16	0	14	30	0	0
23	15006653	.	C	T	0	8	8	0	20	28	0	0
23	15021985	.	A	T	6	4	10	0	0	10	0	0
23	15022206	.	T	C	13	0	13	0	5	18	0	0
23	15022526	.	C	T	3	6	9	0	2	11	0	0
23	15036698	.	G	A	5	8	13	0	1	14	0	0
23	15048070	.	A	G	2	2	4	0	1	5	0	0
23	15053352	.	A	G	3	2	5	0	0	5	0	0
23	15076070	.	T	C	5	2	7	0	0	7	0	0
23	15087634	.	T	G	3	2	5	0	0	5	0	0
23	15204222	.	C	T	1	14	15	0	21	36	0	0
23	15204321	.	T	A	20	11	31	0	1	32	0	0
23	15204324	.	T	A	20	12	32	0	0	32	0	0
23	15204417	.	A	G	8	14	22	0	1	23	0	0
23	15204936	.	G	T	12	6	18	0	2	20	0	0
23	15205428	.	A	T	19	17	36	0	2	38	0	0
23	15205487	.	C	G	22	27	49	0	1	50	0	0
23	15205994	.	G	A	29	24	53	0	3	56	0	0
23	15206057	.	A	G	20	26	46	0	0	46	0	0
23	15206061	.	G	C	17	22	39	0	4	43	0	0
23	15211253	.	G	C	26	18	44	0	1	45	0	0
23	15215796	.	T	G	17	17	34	0	3	37	0	0
23	15216314	.	G	A	20	15	35	0	2	37	0	0
23	15216644	.	T	C	13	1	14	0	14	28	0	0
23	15216664	.	G	T	12	14	26	0	0	26	0	0
23	15222572	.	G	A	10	15	25	0	0	25	0	0
23	15232380	.	T	G	12	5	17	0	0	17	0	0
23	15259821	.	G	A	9	10	19	0	0	19	0	0
23	15270775	.	G	A	10	6	16	0	0	16	0	0
23	15284590	.	C	T	4	10	14	0	2	16	0	0
23	16621314	.	C	T	6	3	9	0	0	9	0	0
23	16640852	.	A	G	7	0	7	0	8	15	0	0
23	16640925	.	A	G	8	18	26	0	1	27	0	0
23	16641012	.	A	G	10	0	10	0	9	19	0	0
23	16641017	.	A	G	13	7	20	0	1	21	0	0
23	16648950	.	T	A	13	12	25	0	2	27	0	0
23	16649008	.	T	C	10	4	14	0	1	15	0	0
23	16649012	.	C	T	8	4	12	0	1	13	0	0
23	16649054	.	C	T	11	8	19	1	0	20	0	0
23	16649599	.	G	T	14	12	26	0	5	31	0	0
23	16649855	.	T	C	17	3	20	3	19	42	0	0
23	16650074	.	G	A	24	23	47	0	2	49	0	0
23	16654424	.	A	G	21	10	31	0	1	32	0	0
23	16688448	.	G	A	13	11	24	0	0	24	0	0
23	16688565	.	A	G	26	13	39	0	0	39	0	0
23	16748903	.	A	T	7	3	10	0	0	10	0	0
23	16748915	.	T	A	7	3	10	0	0	10	0	0
23	16753735	.	T	C	7	6	13	0	0	13	0	0
23	16757528	.	G	T	5	7	12	0	0	12	0	0
23	16820643	.	G	T	1	2	3	0	0	3	0	0
23	16822464	.	G	A	0	2	2	0	7	9	0	0
23	16822469	.	T	C	6	2	8	0	1	9	0	0
23	16822707	.	G	A	0	2	2	0	4	6	0	0
23	16831207	.	A	T	6	2	8	0	0	8	0	0
23	16831822	.	G	A	0	3	3	0	6	9	0	0
23	16834080	.	G	A	5	7	12	0	0	12	0	0
23	16848866	.	G	A	2	4	6	0	0	6	0	0
23	16849056	.	T	C	8	4	12	0	2	14	0	0
23	16849183	.	A	G	3	5	8	0	0	8	0	0
23	16849259	.	A	C	2	2	4	0	0	4	0	0
23	16849341	.	C	T	6	7	13	0	1	14	0	0
23	16849383	.	A	G	5	3	8	3	1	12	0	0
23	16883535	.	C	T	3	4	7	0	0	7	0	0
23	16883749	.	T	C	3	2	5	0	0	5	0	0
23	16883764	.	A	T	3	3	6	0	0	6	0	0
23	16883822	.	G	T	5	5	10	0	0	10	0	0
23	16961404	.	G	A	1	2	3	0	0	3	0	0
23	16961626	.	T	C	2	3	5	0	0	5	0	0
23	16964089	.	C	A	0	6	6	0	5	11	0	0
23	16964113	.	C	A	3	4	7	0	1	8	0	0
23	16964518	.	T	G	1	5	6	0	0	6	0	0
23	16966364	.	T	C	3	0	3	0	2	5	0	0
23	17105324	.	C	T	4	2	6	0	1	7	0	0
23	17113706	.	C	T	9	4	13	1	1	15	0	0
23	17113831	.	G	A	1	5	6	0	4	10	0	0
23	17113842	.	A	G	3	6	9	0	0	9	0	0
23	17339044	.	C	T	3	2	5	0	0	5	0	0
23	17340346	.	G	A	1	5	6	0	2	8	0	0
23	17340355	.	G	A	2	4	6	0	0	6	0	0
23	17354563	.	C	A	2	2	4	0	0	4	0	0
23	17354662	.	T	C	2	6	8	0	0	8	0	0
23	17354693	.	G	T	4	3	7	0	0	7	0	0
23	17354718	.	A	T	4	6	10	0	0	10	0	0
23	17354853	.	G	A	2	8	10	0	0	10	0	0
23	17354868	.	C	A	3	6	9	0	0	9	0	0
23	17355063	.	C	T	8	5	13	0	0	13	0	0
23	17355109	.	C	T	4	6	10	0	0	10	0	0
23	17355174	.	C	T	4	4	8	0	1	9	0	0
23	17355498	.	G	T	5	2	7	0	0	7	0	0
23	17362473	.	G	A	5	4	9	0	0	9	0	0
23	17370877	.	C	A	4	3	7	0	0	7	0	0
23	17384755	.	G	A	7	8	15	0	0	15	0	0
23	17384981	.	A	G	5	6	11	0	0	11	0	0
23	17385050	.	T	A	6	5	11	0	0	12	1	0
23	17428153	.	C	T	37	40	77	0	3	80	0	0
23	17429632	.	C	T	4	36	40	0	27	67	0	0
23	17431644	.	A	T	33	18	51	0	1	52	0	0
23	17431707	.	T	A	17	14	31	0	2	33	0	0
23	17431734	.	C	T	16	15	31	0	2	33	0	0
23	17432036	.	T	C	18	11	29	0	2	31	0	0
23	17432133	.	A	C	8	8	16	0	0	16	0	0
23	17432169	.	T	A	10	8	18	0	0	18	0	0
23	17432412	.	T	C	13	14	27	0	0	27	0	0
23	17450623	.	T	G	12	13	25	0	1	26	0	0
23	17450660	.	T	A	12	11	23	0	0	23	0	0
23	17450661	.	A	T	12	11	23	0	0	23	0	0
23	17473278	.	C	G	12	15	27	0	0	27	0	0
23	17473365	.	T	C	8	7	15	0	0	15	0	0
23	17473398	.	G	T	8	8	16	0	0	16	0	0
23	17473590	.	C	A	11	12	23	0	0	23	0	0
23	17473611	.	C	G	8	14	22	1	0	23	0	0
23	17473779	.	G	A	22	17	39	0	2	41	0	0
23	17473795	.	A	C	23	16	39	0	5	44	0	0
23	17474167	.	G	A	6	5	11	0	0	11	0	0
23	17474285	.	A	G	2	3	5	0	1	6	0	0
23	17474532	.	T	C	9	4	13	0	1	14	0	0
23	17474590	.	T	C	16	5	21	0	0	21	0	0
23	17474592	.	G	A	16	5	21	0	0	21	0	0
23	17474862	.	C	T	24	6	30	0	5	35	0	0
23	17474928	.	C	G	19	11	30	0	2	32	0	0
23	17475043	.	C	A	23	15	38	0	1	39	0	0
23	17475074	.	A	C	14	10	24	0	2	26	0	0
23	17475329	.	G	C	9	0	9	0	2	15	4	0
23	17475349	.	A	T	12	4	16	0	0	16	0	0
23	17475378	.	C	A	11	5	16	0	1	17	0	0
23	17475389	.	T	A	8	5	13	0	1	14	0	0
23	17475552	.	G	A	9	6	15	0	1	16	0	0
23	17475553	.	T	C	6	0	6	0	9	15	0	0
23	17475702	.	C	T	15	6	21	0	0	21	0	0
23	17475808	.	G	T	11	15	26	0	1	27	0	0
23	17476213	.	C	T	0	15	15	0	5	20	0	0
23	17476453	.	T	C	7	9	16	0	0	16	0	0
23	17476459	.	G	T	6	9	15	0	0	15	0	0
23	17476491	.	A	G	5	7	12	0	0	12	0	0
23	17476792	.	A	T	2	5	7	0	1	8	0	0
23	17476834	.	A	T	3	2	5	0	0	5	0	0
23	17477252	.	C	T	11	9	20	0	1	21	0	0
23	17477384	.	A	C	21	11	32	0	1	33	0	0
23	17481905	.	C	T	0	6	6	0	8	14	0	0
23	17484484	.	A	G	3	2	5	1	1	7	0	0
23	17484492	.	T	A	2	3	5	1	0	6	0	0
23	17516945	.	G	A	20	11	31	0	0	31	0	0
23	17520025	.	C	G	13	17	30	0	2	32	0	0
23	17520086	.	A	T	13	18	31	0	0	31	0	0
23	17520245	.	T	C	20	12	32	0	1	33	0	0
23	17520311	.	T	G	15	19	34	1	0	35	0	0
23	17520338	.	G	A	15	18	33	1	2	36	0	0
23	17523056	.	C	G	2	2	4	0	0	4	0	0
23	17530937	.	C	T	1	2	3	0	0	3	0	0
23	17548579	.	G	A	3	2	5	0	2	7	0	0
23	17656044	.	A	G	12	5	17	0	0	17	0	0
23	17656477	.	G	A	14	16	30	0	0	30	0	0
23	17657130	.	T	G	9	5	14	2	1	17	0	0
23	17657265	.	G	C	7	12	19	0	0	19	0	0
23	17657325	.	A	G	9	11	20	0	2	22	0	0
23	17812711	.	C	T	29	21	50	0	0	50	0	0
23	17812720	.	T	A	25	25	50	0	3	53	0	0
23	17812755	.	G	T	22	24	46	0	0	46	0	0
23	17813057	.	G	A	26	15	41	0	1	42	0	0
23	17813161	.	T	A	13	15	28	2	3	33	0	0
23	17813717	.	G	A	31	19	50	0	2	52	0	0
23	17813924	.	A	G	12	5	17	0	0	17	0	0
23	17813952	.	G	T	17	9	26	0	0	26	0	0
23	17814056	.	G	A	20	28	48	0	0	48	0	0
23	17814223	.	C	T	18	19	37	0	5	42	0	0
23	17814281	.	G	T	23	20	43	0	0	43	0	0
23	17814299	.	A	C	21	19	40	0	0	40	0	0
23	17814408	.	A	C	21	12	33	0	0	33	0	0
23	17849044	.	T	A	1	2	3	0	0	3	0	0
23	17849275	.	T	G	5	9	14	0	3	17	0	0
23	17849296	.	C	G	2	15	17	0	7	24	0	0
23	17849627	.	C	T	7	10	17	0	0	17	0	0
23	17851768	.	C	T	0	11	11	0	10	21	0	0
23	17853145	.	T	G	5	8	13	0	0	13	0	0
23	17853396	.	A	T	3	6	9	0	2	11	0	0
23	17855427	.	C	A	3	3	6	0	0	6	0	0
23	17857831	.	G	A	6	4	10	0	0	10	0	0
23	17865973	.	T	C	4	0	4	0	6	10	0	0
23	17866146	.	T	A	1	2	3	0	0	3	0	0
23	17870758	.	G	T	0	2	2	0	2	4	0	0
23	17872334	.	A	G	2	0	2	0	2	4	0	0
23	17872338	.	C	T	2	2	4	0	0	4	0	0
23	17872443	.	G	A	5	2	7	0	1	8	0	0
23	17873750	.	C	A	37	26	63	0	3	66	0	0
23	17879066	.	C	A	6	4	10	0	0	10	0	0
23	17879107	.	C	T	1	5	6	0	0	6	0	0
23	17879152	.	A	T	2	4	6	0	0	6	0	0
23	17879153	.	A	C	3	2	5	0	1	6	0	0
23	17880800	.	C	T	3	10	13	0	1	14	0	0
23	17994354	.	T	C	3	7	10	0	0	10	0	0
23	17994897	.	C	T	4	2	6	0	0	6	0	0
23	17995469	.	G	T	7	2	9	0	0	9	0	0
23	17996051	.	A	T	3	2	5	0	0	5	0	0
23	17997033	.	A	G	2	5	7	0	1	8	0	0
23	17997043	.	T	C	4	0	4	0	5	9	0	0
23	18001836	.	A	C	6	2	8	0	0	8	0	0
23	18004297	.	A	G	2	6	8	0	0	8	0	0
23	18032772	.	G	A	2	2	4	0	1	5	0	0
23	18032912	.	A	C	5	7	12	0	0	12	0	0
23	18032924	.	T	A	5	5	10	0	1	11	0	0
23	18118653	.	A	T	2	3	5	0	0	5	0	0
23	18118922	.	G	A	22	25	47	0	1	48	0	0
23	18119166	.	C	T	27	18	45	0	1	46	0	0
23	18119192	.	T	C	15	0	15	0	20	35	0	0
23	18119399	.	A	G	23	8	31	0	3	34	0	0
23	18286781	.	G	A	5	12	17	0	0	17	0	0
23	18286782	.	C	T	5	12	17	0	0	17	0	0
23	18375847	.	G	A	11	14	25	0	1	26	0	0
23	18375853	.	T	C	17	2	19	0	11	30	0	0
23	18387709	.	T	A	32	20	52	0	1	53	0	0
23	18388004	.	G	A	19	15	34	0	1	35	0	0
23	18388166	.	T	A	9	13	22	0	1	23	0	0
23	18388476	.	G	A	9	10	19	0	0	19	0	0
23	18388555	.	A	G	13	10	23	0	2	25	0	0
23	18388620	.	A	C	10	13	23	0	0	23	0	0
23	18388685	.	G	A	11	6	17	0	3	20	0	0
23	18388764	.	G	A	8	11	19	0	1	20	0	0
23	18388858	.	T	G	12	6	18	2	0	20	0	0
23	18388954	.	G	A	8	13	21	0	0	21	0	0
23	18389594	.	G	T	11	12	23	0	2	25	0	0
23	18390402	.	G	A	10	7	17	0	0	17	0	0
23	18390635	.	G	A	11	9	20	0	1	21	0	0
23	18390758	.	T	C	9	0	9	0	11	20	0	0
23	18390780	.	C	T	12	8	20	0	0	20	0	0
23	18391490	.	G	A	6	5	11	0	0	11	0	0
23	18394401	.	T	G	11	8	19	0	0	19	0	0
23	18405812	.	C	T	3	7	10	0	0	10	0	0
23	18405862	.	A	G	4	4	8	0	0	8	0	0
23	18406479	.	G	A	4	4	8	0	0	8	0	0
23	18409242	.	C	T	5	6	11	0	0	11	0	0
23	18415329	.	G	C	5	4	9	0	0	9	0	0
23	18415493	.	C	A	0	4	4	0	4	8	0	0
23	18561289	.	T	A	20	19	39	0	1	40	0	0
23	18561434	.	C	T	1	13	14	0	12	26	0	0
23	18562299	.	A	T	2	1	3	0	1	4	0	0
23	18562427	.	C	T	6	4	10	0	0	10	0	0
23	18562484	.	G	A	11	11	22	0	0	22	0	0
23	18562522	.	A	C	12	6	18	1	0	19	0	0
23	18562623	.	C	T	11	11	22	0	0	22	0	0
23	18562911	.	C	A	2	18	20	0	14	34	0	0
23	18563951	.	G	T	10	9	19	0	1	20	0	0
23	18563952	.	T	C	11	1	12	0	8	20	0	0
23	18568144	.	G	A	6	5	11	0	0	11	0	0
23	18568206	.	G	A	4	5	9	0	2	11	0	0
23	18569380	.	T	A	13	8	21	0	0	21	0	0
23	18569399	.	C	A	1	9	10	0	5	15	0	0
23	18569543	.	T	C	16	16	32	0	0	32	0	0
23	18569625	.	A	G	18	11	29	0	6	35	0	0
23	18570887	.	C	T	12	14	26	0	0	26	0	0
23	18570941	.	A	T	11	18	29	1	2	32	0	0
23	18572547	.	T	A	10	14	24	0	1	25	0	0
23	18572618	.	G	A	2	7	9	0	1	10	0	0
23	18574353	.	G	A	16	10	26	0	0	26	0	0
23	18574720	.	T	C	18	13	31	0	1	32	0	0
23	18574800	.	C	T	5	16	21	0	14	35	0	0
23	18580933	.	C	A	16	14	30	0	1	31	0	0
23	18580939	.	C	A	1	14	15	0	16	31	0	0
23	18581065	.	A	G	16	14	30	0	2	32	0	0
23	18581835	.	G	A	13	9	22	0	1	23	0	0
23	18581933	.	T	G	19	19	38	0	0	38	0	0
23	18584225	.	G	A	13	18	31	0	0	31	0	0
23	18586793	.	C	T	2	7	9	1	14	24	0	0
23	18588969	.	C	T	9	8	17	0	0	17	0	0
23	18597667	.	G	A	7	9	16	0	0	16	0	0
23	18616517	.	A	T	12	4	16	0	1	17	0	0
23	18616880	.	T	A	11	5	16	0	1	17	0	0
23	18616980	.	C	G	10	4	14	0	0	14	0	0
23	18617300	.	G	A	7	13	20	0	0	20	0	0
23	18619766	.	C	T	11	6	17	0	1	18	0	0
23	18622541	.	T	G	13	7	20	0	0	20	0	0
23	18628460	.	T	G	11	11	22	0	0	22	0	0
23	18629024	.	T	C	3	7	10	0	0	10	0	0
23	18651789	.	G	A	10	6	16	0	0	16	0	0
23	18651918	.	C	A	10	8	18	0	1	19	0	0
23	18652067	.	T	C	6	10	16	0	1	17	0	0
23	18668440	.	T	C	6	4	10	0	0	10	0	0
23	18702862	.	A	G	1	11	12	0	0	12	0	0
23	18702863	.	G	A	1	11	12	0	0	12	0	0
23	18703204	.	T	A	1	4	5	0	1	6	0	0
23	18707455	.	T	C	1	2	3	0	2	5	0	0
23	18759802	.	C	A	3	4	7	0	0	7	0	0
23	18759827	.	T	C	5	4	9	0	0	9	0	0
23	18760004	.	G	C	6	0	6	0	8	14	0	0
23	18760049	.	T	A	11	4	15	0	1	16	0	0
23	18760223	.	T	A	9	4	13	0	0	13	0	0
23	18760256	.	C	T	6	5	11	0	0	11	0	0
23	18760519	.	T	A	7	8	15	0	0	15	0	0
23	18769161	.	T	C	3	0	3	0	2	5	0	0
23	18774122	.	T	C	4	4	8	1	0	9	0	0
23	18777816	.	C	T	2	3	5	0	0	5	0	0
23	18795620	.	A	G	23	17	40	0	1	41	0	0
23	18795721	.	C	T	15	21	36	0	0	36	0	0
23	18801275	.	G	A	13	17	30	0	2	32	0	0
23	18869550	.	C	A	1	4	5	0	8	13	0	0
23	18870235	.	A	T	5	5	10	0	0	10	0	0
23	18870245	.	T	C	3	0	3	0	9	12	0	0
23	18870716	.	G	T	7	6	13	0	0	13	0	0
23	18944489	.	A	G	5	6	11	0	0	11	0	0
23	18944543	.	G	A	0	9	9	0	10	19	0	0
23	18947344	.	C	A	7	15	22	0	2	24	0	0
23	18947385	.	G	C	12	13	25	0	0	25	0	0
23	18950968	.	T	C	9	17	26	0	1	27	0	0
23	18950970	.	T	A	10	16	26	0	1	27	0	0
23	18951010	.	G	A	8	8	16	0	2	18	0	0
23	18954023	.	A	G	7	7	14	0	1	15	0	0
23	18954100	.	A	G	7	2	9	0	2	11	0	0
23	18954151	.	G	A	6	3	9	0	1	10	0	0
23	18954759	.	T	G	15	13	28	0	1	29	0	0
23	18979342	.	C	T	18	14	32	0	0	32	0	0
23	18979561	.	G	A	11	11	22	0	0	22	0	0
23	18979756	.	T	C	10	11	21	0	1	22	0	0
23	18982375	.	G	A	10	8	18	0	0	18	0	0
23	18986338	.	G	A	11	9	20	0	2	22	0	0
23	18986344	.	G	A	9	13	22	0	1	23	0	0
23	18990914	.	C	T	3	13	16	0	11	27	0	0
23	18993525	.	T	C	12	11	23	0	1	24	0	0
23	18993827	.	C	T	2	8	10	1	12	23	0	0
23	18996030	.	C	T	7	12	19	0	0	19	0	0
23	19003263	.	A	G	7	8	15	0	0	15	0	0
23	19005426	.	G	T	5	9	14	0	0	14	0	0
23	19005486	.	T	C	7	3	10	0	1	11	0	0
23	19005758	.	C	T	6	6	12	0	1	13	0	0
23	19005761	.	C	G	8	5	13	0	0	13	0	0
23	19007389	.	G	T	5	2	7	0	1	8	0	0
23	19008149	.	C	T	2	3	5	0	0	5	0	0
23	19017421	.	C	A	7	5	12	0	3	15	0	0
23	19017466	.	G	T	7	4	11	0	1	12	0	0
23	19022534	.	G	A	2	2	4	0	1	5	0	0
23	19035542	.	A	G	1	3	4	0	0	4	0	0
23	19036052	.	C	G	1	8	9	0	0	9	0	0
23	19066873	.	G	A	1	2	3	0	0	3	0	0
23	19067116	.	G	A	1	2	3	0	0	3	0	0
23	19098900	.	G	A	1	5	6	0	1	7	0	0
23	19118372	.	G	T	6	2	8	0	1	9	0	0
23	19118960	.	G	T	3	2	5	0	0	5	0	0
23	19153221	.	A	T	3	2	5	0	0	5	0	0
23	19153225	.	T	C	3	0	3	0	1	4	0	0
23	19198348	.	A	T	4	8	12	0	1	13	0	0
23	19198588	.	A	T	6	11	17	0	0	17	0	0
23	19200168	.	G	A	8	7	15	0	2	17	0	0
23	19201103	.	C	A	6	14	20	0	0	20	0	0
23	19201148	.	G	T	3	8	11	0	1	12	0	0
23	19202958	.	A	G	3	3	6	0	0	6	0	0
23	19203952	.	C	T	4	4	8	0	0	8	0	0
23	19204126	.	C	T	4	5	9	0	0	9	0	0
23	19204130	.	T	C	5	4	9	0	0	9	0	0
23	19204597	.	G	A	6	5	11	0	0	11	0	0
23	19204738	.	C	T	3	3	6	0	0	6	0	0
23	19206052	.	C	T	1	2	3	0	0	3	0	0
23	19250418	.	G	A	1	3	4	0	0	4	0	0
23	19474823	.	G	T	12	13	25	0	2	27	0	0
23	19483010	.	C	T	0	2	2	0	5	7	0	0
23	19483497	.	A	C	3	0	3	0	2	5	0	0
23	19484584	.	C	T	0	2	2	0	1	3	0	0
23	19575044	.	G	A	1	13	14	0	5	19	0	0
23	19575134	.	C	T	9	9	18	0	2	20	0	0
23	19577464	.	G	A	4	13	17	0	19	36	0	0
23	19582481	.	T	C	12	19	31	0	0	31	0	0
23	19582559	.	G	T	14	12	26	0	1	27	0	0
23	19582668	.	T	C	13	16	29	0	1	30	0	0
23	19582678	.	C	T	14	20	34	0	1	35	0	0
23	19583208	.	G	A	0	9	9	0	13	22	0	0
23	19583252	.	C	T	16	12	28	0	0	28	0	0
23	19603630	.	T	C	25	38	63	0	3	66	0	0
23	19603753	.	T	C	37	21	58	0	3	61	0	0
23	19603803	.	T	C	19	24	43	0	0	43	0	0
23	19603880	.	A	T	24	16	40	0	6	46	0	0
23	19603994	.	G	A	25	27	52	0	2	54	0	0
23	19604263	.	A	G	13	0	13	0	19	32	0	0
23	19604351	.	G	T	13	13	26	0	0	26	0	0
23	19670185	.	A	T	8	8	16	0	1	17	0	0
23	19672720	.	T	C	5	12	17	0	0	17	0	0
23	19673170	.	C	T	16	14	30	0	0	30	0	0
23	19673376	.	C	T	11	10	21	0	0	21	0	0
23	19711791	.	A	G	1	2	3	0	0	3	0	0
23	19712898	.	G	A	28	34	62	0	1	63	0	0
23	19713291	.	A	G	28	35	63	0	4	68	1	0
23	19713324	.	A	G	31	27	58	0	8	66	0	0
23	19792737	.	C	T	1	4	5	0	1	6	0	0
23	19796643	.	A	T	2	4	6	0	0	6	0	0
23	19796651	.	G	A	2	2	4	0	1	5	0	0
23	19798168	.	T	C	1	4	5	0	0	5	0	0
23	19798174	.	A	G	1	4	5	0	0	5	0	0
23	19798216	.	T	C	2	4	6	0	0	6	0	0
23	19798493	.	T	C	3	5	8	0	0	8	0	0
23	19800228	.	T	C	7	4	11	0	0	11	0	0
23	19804543	.	C	A	6	2	8	0	1	9	0	0
23	19804743	.	A	C	1	2	3	0	0	3	0	0
23	19804744	.	T	C	1	2	3	0	0	3	0	0
23	19804878	.	T	C	5	4	9	0	0	9	0	0
23	19805577	.	A	T	3	5	8	0	0	8	0	0
23	19808022	.	C	T	14	8	22	0	0	22	0	0
23	19808078	.	T	C	15	5	20	0	0	20	0	0
23	19808691	.	G	A	1	7	8	0	10	18	0	0
23	19815467	.	G	A	4	5	9	0	0	9	0	0
23	19816699	.	A	T	3	8	11	0	0	11	0	0
23	19821136	.	A	G	5	0	5	0	20	25	0	0
23	19821150	.	C	T	8	14	22	0	2	24	0	0
23	19821277	.	A	C	11	7	18	0	0	18	0	0
23	19821408	.	C	T	7	5	12	0	0	12	0	0
23	19821447	.	G	C	2	5	7	0	0	7	0	0
23	19821470	.	G	A	0	3	3	0	2	5	0	0
23	19821489	.	A	T	3	4	7	0	0	7	0	0
23	19821549	.	C	A	2	2	4	0	2	6	0	0
23	19827641	.	A	C	5	0	5	0	3	8	0	0
23	19835308	.	T	C	35	23	58	1	1	60	0	0
23	19836260	.	C	T	25	26	51	0	3	54	0	0
23	19837080	.	T	C	26	29	55	0	2	57	0	0
23	19837503	.	G	A	18	26	44	0	1	45	0	0
23	19837939	.	A	G	12	10	22	0	1	23	0	0
23	19837974	.	G	A	12	9	21	0	0	21	0	0
23	19838100	.	C	A	25	16	41	0	0	41	0	0
23	19838295	.	T	G	6	4	10	0	1	11	0	0
23	19838312	.	A	T	5	3	8	0	0	8	0	0
23	19838387	.	A	T	9	14	23	0	1	24	0	0
23	19838388	.	T	A	6	13	19	0	5	24	0	0
23	19838458	.	A	T	12	13	25	0	0	26	1	0
23	19838459	.	A	C	11	13	24	0	2	26	0	0
23	19869132	.	G	A	18	10	28	0	0	28	0	0
23	19871615	.	A	G	26	22	48	0	0	48	0	0
23	19879576	.	C	T	2	22	24	0	24	48	0	0
23	19883318	.	T	C	9	14	23	0	1	24	0	0
23	19893409	.	A	T	16	14	30	0	1	31	0	0
23	19933542	.	A	G	9	8	17	0	0	18	1	0
23	19933578	.	G	A	11	9	20	0	1	21	0	0
23	19933742	.	G	A	13	8	21	0	1	22	0	0
23	19933850	.	A	G	8	8	16	0	0	16	0	0
23	19933896	.	A	G	9	9	18	0	0	18	0	0
23	19933952	.	A	G	5	13	18	0	0	18	0	0
23	19952743	.	C	T	1	13	14	0	11	25	0	0
23	19952869	.	T	A	7	9	16	0	0	16	0	0
23	19969710	.	G	A	5	6	11	0	0	11	0	0
23	19981510	.	G	T	8	7	15	0	1	16	0	0
23	19981554	.	T	C	5	5	10	0	0	10	0	0
23	19981608	.	A	T	5	3	8	0	3	11	0	0
23	19985054	.	A	G	9	3	12	0	0	12	0	0
23	19985201	.	A	G	3	3	6	0	0	6	0	0
23	19985210	.	G	T	2	2	4	0	0	4	0	0
23	19985403	.	T	C	6	3	9	0	0	9	0	0
23	20000716	.	A	G	2	5	7	0	3	10	0	0
23	20002339	.	G	C	3	4	7	0	0	7	0	0
23	20002373	.	T	A	1	2	3	0	1	4	0	0
23	20010481	.	A	C	3	0	3	0	3	6	0	0
23	20113599	.	T	C	14	10	24	1	1	26	0	0
23	20113848	.	G	T	21	18	39	0	0	39	0	0
23	20114327	.	C	A	35	17	52	0	0	52	0	0
23	20117625	.	C	G	1	10	11	1	20	32	0	0
23	20117830	.	A	G	17	15	32	0	1	33	0	0
23	20117938	.	A	C	13	0	13	0	20	33	0	0
23	20118597	.	T	G	14	13	27	0	1	28	0	0
23	20118730	.	T	A	13	8	21	0	1	22	0	0
23	20120646	.	T	C	15	1	16	0	7	23	0	0
23	20121265	.	T	A	19	18	37	0	0	37	0	0
23	20121270	.	G	T	18	17	35	0	1	36	0	0
23	20121326	.	G	A	14	10	24	0	0	24	0	0
23	20122190	.	A	G	9	10	19	0	1	20	0	0
23	20123375	.	G	A	14	11	25	0	0	25	0	0
23	20123386	.	G	T	11	10	21	0	1	22	0	0
23	20123575	.	C	A	7	7	14	0	0	14	0	0
23	20123576	.	C	T	7	7	14	0	0	14	0	0
23	20123629	.	A	G	10	7	17	0	1	18	0	0
23	20139320	.	T	C	2	4	6	0	0	6	0	0
23	20139362	.	T	C	2	4	6	0	0	6	0	0
23	20141748	.	C	A	3	2	5	0	0	5	0	0
23	20143177	.	G	A	1	2	3	0	0	3	0	0
23	20145420	.	T	A	18	14	32	0	1	33	0	0
23	20145823	.	T	C	7	6	13	0	0	13	0	0
23	20146080	.	A	G	9	7	16	0	0	16	0	0
23	20149630	.	G	A	2	2	4	0	0	4	0	0
23	20152477	.	T	C	10	9	19	0	0	19	0	0
23	20152640	.	G	A	11	7	18	0	0	18	0	0
23	20154486	.	A	G	4	4	8	0	0	8	0	0
23	20157790	.	G	A	7	7	14	0	1	15	0	0
23	20157923	.	G	C	4	0	4	0	3	7	0	0
23	20157930	.	T	C	4	1	5	0	3	8	0	0
23	20159225	.	C	T	0	3	3	0	8	11	0	0
23	20159234	.	G	T	7	2	9	0	0	9	0	0
23	20162522	.	C	T	0	3	3	0	6	9	0	0
23	20167966	.	G	A	4	3	7	0	0	7	0	0
23	20168111	.	T	A	8	4	12	0	1	13	0	0
23	20168127	.	C	T	1	5	6	0	8	14	0	0
23	20168404	.	C	G	4	3	7	0	0	7	0	0
23	20168568	.	T	C	1	3	4	0	0	4	0	0
23	20168573	.	A	G	2	3	5	0	0	5	0	0
23	20168642	.	G	A	3	5	8	0	2	10	0	0
23	20168739	.	T	C	2	4	6	0	0	6	0	0
23	20170945	.	T	A	4	2	6	0	0	6	0	0
23	20193272	.	T	C	1	0	1	0	2	3	0	0
23	21111170	.	A	G	6	0	6	0	8	14	0	0
23	22876775	.	G	A	2	2	4	0	0	4	0	0
23	22886149	.	C	T	6	2	8	0	0	8	0	0
23	22888817	.	G	A	5	4	9	0	0	9	0	0
23	22918609	.	A	T	11	9	20	0	0	20	0	0
23	22919817	.	C	T	13	5	18	0	0	18	0	0
23	22919883	.	T	C	11	6	17	0	2	19	0	0
23	22920221	.	T	A	11	11	22	0	4	26	0	0
23	22920594	.	C	T	18	14	32	0	1	33	0	0
23	22923021	.	A	C	15	24	39	0	3	42	0	0
23	22923057	.	A	G	15	0	15	0	26	41	0	0
23	22923093	.	C	T	14	23	37	0	2	39	0	0
23	22923147	.	C	T	20	10	30	0	0	30	0	0
23	22923198	.	C	T	13	11	24	0	1	25	0	0
23	22923537	.	C	T	11	15	26	0	0	26	0	0
23	23118653	.	A	T	3	9	12	0	0	12	0	0
23	23118815	.	C	T	1	5	6	0	1	7	0	0
23	23122178	.	G	A	2	9	11	0	8	19	0	0
23	23122381	.	C	T	6	11	17	0	0	17	0	0
23	23122412	.	G	A	2	3	5	0	3	8	0	0
23	23122528	.	C	T	4	7	11	0	0	11	0	0
23	23122898	.	A	G	6	8	14	0	0	14	0	0
23	23123146	.	G	T	6	6	12	0	0	12	0	0
23	23123420	.	G	T	5	6	11	0	0	11	0	0
23	23123715	.	C	T	4	2	6	0	2	8	0	0
23	23126621	.	T	C	4	4	8	0	0	8	0	0
23	23160057	.	C	T	2	5	7	0	0	7	0	0
23	23174059	.	G	A	1	2	3	0	0	3	0	0
23	23182145	.	C	T	7	4	11	0	0	11	0	0
23	23205469	.	A	G	2	0	2	2	18	22	0	0
23	23212257	.	C	T	6	22	28	1	0	29	0	0
23	23213068	.	A	C	2	16	18	0	1	19	0	0
23	23213069	.	A	C	2	17	19	0	0	19	0	0
23	23213219	.	T	C	4	19	23	0	2	25	0	0
23	23213437	.	G	A	0	16	16	0	6	22	0	0
23	23213864	.	T	A	3	17	20	0	0	20	0	0
23	23213880	.	G	A	1	15	16	0	4	20	0	0
23	23214417	.	C	T	8	4	12	0	1	13	0	0
23	23399987	.	T	C	3	3	6	0	2	8	0	0
23	23400032	.	A	G	3	6	9	0	0	9	0	0
23	23401093	.	T	A	2	2	4	0	0	4	0	0
23	23658766	.	C	T	2	3	5	0	0	5	0	0
23	23794656	.	T	C	7	8	15	0	0	15	0	0
23	23830985	.	C	G	7	6	13	0	0	13	0	0
23	23860113	.	T	A	6	9	15	0	0	15	0	0
23	23860117	.	G	A	6	9	15	0	0	15	0	0
23	23863569	.	G	A	6	7	13	0	0	13	0	0
23	23869182	.	T	C	16	13	29	0	1	30	0	0
23	23877088	.	A	G	16	0	16	0	12	28	0	0
23	23888136	.	G	A	1	8	9	0	20	29	0	0
23	23890928	.	T	C	19	13	32	0	1	33	0	0
23	23891535	.	C	T	23	10	33	0	0	33	0	0
23	23891551	.	G	A	2	10	12	0	22	34	0	0
23	23903278	.	G	A	2	17	19	0	8	27	0	0
23	23903308	.	C	T	14	8	22	0	1	23	0	0
23	23912720	.	G	T	11	25	36	0	1	37	0	0
23	23912723	.	C	A	10	26	36	0	2	38	0	0
23	23912881	.	C	T	17	17	34	0	2	36	0	0
23	23913054	.	T	A	13	2	15	0	1	16	0	0
23	23913240	.	G	T	16	12	28	1	3	32	0	0
23	23913417	.	T	C	20	37	57	0	1	58	0	0
23	23913818	.	A	T	15	17	32	0	4	36	0	0
23	23913832	.	G	A	19	14	33	0	5	38	0	0
23	23913858	.	A	C	23	15	38	0	5	43	0	0
23	23914176	.	A	T	14	17	31	0	2	33	0	0
23	23973724	.	T	A	5	2	7	0	0	7	0	0
23	23981262	.	T	G	3	0	3	0	3	6	0	0
23	23995111	.	G	T	3	3	6	0	0	6	0	0
23	23995375	.	C	T	6	3	9	0	0	9	0	0
23	24144860	.	A	G	2	3	5	0	0	5	0	0
23	24144872	.	T	C	2	4	6	0	0	6	0	0
23	24176425	.	C	T	3	13	16	0	23	39	0	0
23	24176474	.	A	G	21	21	42	0	1	43	0	0
23	24178789	.	C	T	1	12	13	0	9	22	0	0
23	24181913	.	G	A	11	10	21	0	1	22	0	0
23	24183523	.	A	C	13	9	22	0	0	22	0	0
23	24190677	.	C	T	9	6	15	0	2	17	0	0
23	24202734	.	C	A	0	5	5	0	2	7	0	0
23	24202754	.	A	C	3	0	3	0	6	9	0	0
23	24202833	.	G	A	8	5	13	0	1	14	0	0
23	24202859	.	A	T	4	6	10	0	0	10	0	0
23	24202985	.	T	C	9	9	18	0	0	18	0	0
23	24208208	.	G	C	4	3	7	0	1	8	0	0
23	24214381	.	G	A	2	3	5	0	1	6	0	0
23	24216339	.	A	C	2	0	2	0	5	7	0	0
23	24227400	.	G	A	11	5	16	0	2	18	0	0
23	24227537	.	A	T	16	4	20	0	1	21	0	0
23	24227538	.	C	T	15	4	19	0	2	21	0	0
23	24227696	.	C	T	21	12	33	0	1	34	0	0
23	24227702	.	T	A	20	13	33	0	0	33	0	0
23	24229110	.	G	A	12	14	26	0	1	27	0	0
23	24231596	.	T	C	16	7	23	0	1	24	0	0
23	24233831	.	A	G	13	4	17	0	0	17	0	0
23	24234181	.	T	C	3	8	11	0	0	11	0	0
23	24234232	.	T	C	7	12	19	0	1	20	0	0
23	24239009	.	C	T	9	6	15	0	1	16	0	0
23	24241090	.	C	G	1	5	6	1	8	15	0	0
23	24243168	.	G	A	4	12	16	0	0	16	0	0
23	24244694	.	C	T	3	3	6	0	7	13	0	0
23	24246864	.	A	G	6	3	9	0	0	9	0	0
23	24249227	.	C	T	4	9	13	0	1	14	0	0
23	24251531	.	C	A	7	2	9	0	1	10	0	0
23	24300958	.	T	A	1	2	3	0	0	3	0	0
23	24301297	.	C	T	4	4	8	0	0	8	0	0
23	24304648	.	T	C	2	2	4	0	0	4	0	0
23	24439480	.	G	T	14	10	24	0	2	26	0	0
23	24439580	.	T	C	19	0	19	0	20	39	0	0
23	24439780	.	G	A	13	10	23	0	1	24	0	0
23	24440273	.	G	A	4	6	10	0	1	11	0	0
23	24440414	.	C	A	7	14	21	1	0	22	0	0
23	24443161	.	G	T	7	10	17	0	1	18	0	0
23	24444279	.	C	T	7	16	23	0	0	23	0	0
23	24444803	.	T	G	9	11	20	0	0	20	0	0
23	24444861	.	G	A	10	15	25	0	0	25	0	0
23	24445112	.	G	T	12	14	26	0	0	26	0	0
23	24445584	.	A	G	11	8	19	0	0	19	0	0
23	24445906	.	G	C	10	5	15	0	0	15	0	0
23	24446040	.	T	A	7	6	13	0	0	13	0	0
23	24446411	.	C	T	8	12	20	0	0	20	0	0
23	24447113	.	C	T	6	5	11	0	0	11	0	0
23	24447534	.	C	T	0	4	4	0	5	9	0	0
23	24448071	.	T	A	8	6	14	0	0	14	0	0
23	24448568	.	T	A	3	4	7	0	0	7	0	0
23	24448621	.	G	C	1	3	4	0	0	4	0	0
23	24448630	.	G	T	2	2	4	0	0	4	0	0
23	24451083	.	A	G	1	3	4	0	0	4	0	0
23	24451283	.	A	G	2	7	9	0	0	9	0	0
23	24451920	.	T	A	2	2	4	0	0	4	0	0
23	24492415	.	T	A	1	2	3	0	0	3	0	0
23	24507550	.	A	G	15	9	24	0	1	25	0	0
23	24507555	.	T	C	16	11	27	0	0	27	0	0
23	24507668	.	A	G	5	0	5	0	9	14	0	0
23	24508422	.	T	G	6	7	13	1	0	14	0	0
23	24508500	.	C	T	9	7	16	0	1	17	0	0
23	24508630	.	T	C	15	13	28	0	0	28	0	0
23	24512720	.	C	T	2	2	4	0	0	4	0	0
23	24513096	.	C	T	0	2	2	0	2	4	0	0
23	24581809	.	G	A	9	11	20	0	1	21	0	0
23	24582165	.	G	A	5	5	10	0	0	10	0	0
23	24582185	.	C	T	2	6	8	0	0	8	0	0
23	24590068	.	G	A	1	3	4	0	0	4	0	0
23	24590709	.	G	A	0	2	2	0	1	3	0	0
23	24591045	.	G	A	3	2	5	0	0	5	0	0
23	24591051	.	A	T	2	3	5	0	0	5	0	0
23	24591447	.	G	C	1	2	3	0	1	4	0	0
23	24591764	.	G	A	2	4	6	0	0	6	0	0
23	24600513	.	C	T	9	9	18	0	0	18	0	0
23	24600947	.	T	C	12	7	19	0	0	19	0	0
23	24604042	.	C	T	10	9	19	0	1	20	0	0
23	24604323	.	C	T	10	11	21	0	1	22	0	0
23	24604461	.	A	G	12	0	12	0	10	22	0	0
23	24605243	.	T	A	7	9	16	0	1	17	0	0
23	24608805	.	G	A	14	11	25	0	0	25	0	0
23	24608847	.	G	A	1	4	5	0	21	26	0	0
23	24611786	.	G	A	0	3	3	0	6	9	0	0
23	24652909	.	G	A	1	3	4	0	3	7	0	0
23	24652929	.	G	A	1	3	4	0	2	6	0	0
23	24654287	.	G	T	3	2	5	0	0	5	0	0
23	24655227	.	T	C	2	4	6	0	0	6	0	0
23	24655478	.	C	T	2	7	9	0	0	9	0	0
23	24655761	.	T	G	2	0	2	0	4	6	0	0
23	24659777	.	C	T	4	4	8	0	0	8	0	0
23	24661851	.	C	T	13	7	20	0	0	20	0	0
23	24669319	.	A	T	9	9	18	0	0	18	0	0
23	24669381	.	C	T	0	8	8	0	11	19	0	0
23	24669561	.	A	G	11	17	28	0	1	29	0	0
23	24669633	.	T	C	14	0	14	0	13	27	0	0
23	24676192	.	G	C	7	7	14	0	1	15	0	0
23	24694096	.	C	T	13	16	29	1	0	30	0	0
23	24694184	.	G	C	15	13	28	0	2	30	0	0
23	24694242	.	C	A	15	14	29	0	7	36	0	0
23	24694387	.	A	G	16	27	43	0	3	46	0	0
23	24694756	.	C	T	16	25	41	0	0	41	0	0
23	24696943	.	A	G	16	16	32	0	0	32	0	0
23	24697036	.	G	A	14	17	31	0	0	31	0	0
23	24697287	.	A	C	16	12	28	0	1	29	0	0
23	24699281	.	T	A	20	15	35	0	0	35	0	0
23	24750010	.	C	T	1	3	4	0	0	4	0	0
23	24819831	.	C	G	3	4	7	0	1	8	0	0
23	24819936	.	G	A	7	7	14	0	2	16	0	0
23	24823899	.	T	C	9	6	15	0	0	15	0	0
23	24824048	.	C	T	4	2	6	0	1	7	0	0
23	24824056	.	G	A	4	5	9	0	0	9	0	0
23	24926470	.	G	A	7	7	14	0	1	15	0	0
23	24932979	.	G	A	4	2	6	0	1	7	0	0
23	24934567	.	T	C	9	9	18	0	1	19	0	0
23	24934597	.	C	G	4	10	14	0	0	14	0	0
23	24934646	.	G	A	2	8	10	0	1	11	0	0
23	24937143	.	T	C	14	16	30	0	4	34	0	0
23	24937357	.	T	C	13	8	21	0	0	21	0	0
23	24937676	.	T	C	4	5	9	0	0	9	0	0
23	24937750	.	T	A	7	7	14	0	0	14	0	0
23	24937813	.	G	A	2	3	5	0	1	6	0	0
23	24938172	.	A	T	4	4	8	0	1	10	1	0
23	24938173	.	C	T	5	4	9	0	1	10	0	0
23	24938401	.	G	A	12	7	19	0	0	19	0	0
23	24938446	.	T	C	9	6	15	0	0	15	0	0
23	24938559	.	T	C	11	6	17	0	1	18	0	0
23	24938627	.	G	A	5	4	9	0	1	10	0	0
23	24938642	.	C	T	7	4	11	0	1	12	0	0
23	24938791	.	A	G	2	0	2	0	2	4	0	0
23	24939008	.	T	C	2	3	5	0	1	6	0	0
23	24941300	.	A	G	2	2	4	0	0	4	0	0
23	24941572	.	G	A	1	2	3	0	0	3	0	0
23	24941714	.	T	C	5	4	9	0	2	11	0	0
23	24950420	.	C	A	0	2	2	0	2	4	0	0
23	24956985	.	A	T	1	3	4	0	1	5	0	0
23	24957161	.	G	C	5	3	8	0	0	8	0	0
23	24959374	.	G	C	1	2	3	0	0	3	0	0
23	24960393	.	T	A	6	3	9	0	0	9	0	0
23	24968676	.	C	A	4	3	7	0	0	7	0	0
23	24969026	.	G	T	10	3	13	0	0	13	0	0
23	24970331	.	A	G	8	0	8	0	7	15	0	0
23	24980093	.	A	G	2	0	2	0	4	6	0	0
23	24980415	.	G	A	2	2	4	0	0	4	0	0
23	24983536	.	A	G	2	0	2	0	4	6	0	0
23	24984588	.	T	A	4	4	8	0	0	8	0	0
23	25009935	.	C	T	5	2	7	0	0	7	0	0
23	25012510	.	G	T	3	6	9	0	0	9	0	0
23	25012584	.	T	C	7	6	13	0	0	13	0	0
23	25014445	.	G	C	6	9	15	0	1	16	0	0
23	25122283	.	T	A	6	8	14	0	0	14	0	0
23	25132264	.	G	A	10	11	21	0	0	21	0	0
23	25135944	.	T	A	7	10	17	0	0	17	0	0
23	25135945	.	T	A	7	10	17	0	0	17	0	0
23	25136039	.	G	A	0	5	5	0	2	7	0	0
23	25136067	.	G	A	6	6	12	0	0	12	0	0
23	25149777	.	C	T	15	9	24	0	0	24	0	0
23	25149921	.	A	G	9	9	18	0	1	19	0	0
23	25173282	.	C	T	1	2	3	0	0	3	0	0
23	25211392	.	T	G	6	6	12	0	1	13	0	0
23	25211419	.	C	A	7	8	15	0	0	15	0	0
23	25217774	.	C	T	4	5	9	0	0	9	0	0
23	25218647	.	C	G	8	7	15	0	1	16	0	0
23	25218728	.	G	A	7	13	20	0	0	20	0	0
23	25218779	.	C	A	12	4	16	0	0	16	0	0
23	25218784	.	G	T	13	3	16	0	0	16	0	0
23	25218850	.	A	G	8	5	13	0	1	14	0	0
23	25218854	.	A	G	8	5	13	0	0	13	0	0
23	25220160	.	A	G	14	9	23	0	3	26	0	0
23	25220217	.	T	C	13	5	18	0	1	19	0	0
23	25220226	.	G	T	13	8	21	0	1	22	0	0
23	25220262	.	T	C	9	10	19	0	0	19	0	0
23	25220286	.	C	A	11	4	15	0	5	20	0	0
23	25220545	.	C	T	12	5	17	0	0	17	0	0
23	25221198	.	G	A	5	11	16	0	0	16	0	0
23	25221264	.	G	A	12	11	23	0	0	23	0	0
23	25222196	.	C	T	18	7	25	0	0	25	0	0
23	25222214	.	G	A	1	6	7	0	17	24	0	0
23	25222578	.	G	T	10	7	17	0	0	17	0	0
23	25222585	.	A	T	8	7	15	0	0	15	0	0
23	25274450	.	T	G	1	2	3	0	0	3	0	0
23	25274483	.	G	A	1	2	3	0	0	3	0	0
23	25282883	.	T	A	2	2	4	0	0	4	0	0
23	25284824	.	C	T	5	2	7	0	0	7	0	0
23	25284867	.	C	T	2	3	5	0	0	5	0	0
23	25286802	.	A	C	4	4	8	0	0	8	0	0
23	25287292	.	A	C	6	5	11	0	0	11	0	0
23	25287308	.	G	A	0	6	6	0	8	14	0	0
23	25292000	.	G	A	14	8	22	0	0	22	0	0
23	25293908	.	A	C	6	7	13	0	0	13	0	0
23	25338908	.	T	C	2	3	5	0	0	5	0	0
23	25339950	.	T	C	5	3	8	0	0	8	0	0
23	25339986	.	G	T	3	2	5	0	1	6	0	0
23	25448554	.	T	C	3	5	8	0	0	8	0	0
23	25458584	.	G	A	12	17	29	0	0	29	0	0
23	25458615	.	G	A	9	15	24	0	2	26	0	0
23	25464156	.	A	G	8	9	17	0	1	18	0	0
23	25471197	.	G	A	8	7	15	0	0	15	0	0
23	25478208	.	G	T	5	4	9	0	0	9	0	0
23	25484859	.	G	A	9	10	19	0	0	19	0	0
23	25484886	.	G	A	8	8	16	0	0	16	0	0
23	25489885	.	G	A	4	2	6	0	0	6	0	0
23	25491895	.	T	C	2	1	3	0	1	4	0	0
23	25495443	.	A	G	2	5	7	0	0	7	0	0
23	25504804	.	G	T	4	2	6	0	1	7	0	0
23	25506564	.	A	T	1	4	5	0	0	5	0	0
23	25532166	.	T	C	5	3	8	0	0	8	0	0
23	25756641	.	A	G	2	2	4	0	0	4	0	0
23	25768133	.	C	G	1	2	3	0	1	4	0	0
23	25771107	.	G	A	7	10	17	0	0	17	0	0
23	25772648	.	A	G	4	8	12	0	0	12	0	0
23	25772799	.	G	A	5	4	9	0	0	9	0	0
23	25773469	.	G	A	7	3	10	0	0	10	0	0
23	25774855	.	A	G	5	3	8	0	1	9	0	0
23	25775017	.	C	T	0	4	4	0	3	7	0	0
23	25776811	.	G	T	3	5	8	0	0	8	0	0
23	25776879	.	A	G	3	5	8	0	0	8	0	0
23	25777206	.	G	A	1	4	5	0	0	5	0	0
23	25792923	.	A	T	8	10	18	0	0	18	0	0
23	25792952	.	A	T	8	5	13	0	1	14	0	0
23	25796355	.	C	T	7	5	12	1	0	13	0	0
23	25796484	.	G	C	1	0	1	0	4	5	0	0
23	25796899	.	G	A	12	6	18	0	0	18	0	0
23	25796975	.	G	A	3	3	6	0	0	6	0	0
23	25797143	.	G	C	3	8	11	0	0	11	0	0
23	25869424	.	A	G	15	0	15	0	9	24	0	0
23	25869571	.	G	A	6	4	10	0	0	10	0	0
23	25869596	.	C	A	7	5	12	0	0	12	0	0
23	25869658	.	C	T	6	8	14	0	0	14	0	0
23	25869706	.	A	G	12	5	17	0	0	17	0	0
23	25871493	.	A	G	3	9	12	0	0	12	0	0
23	25871628	.	G	C	3	9	12	0	0	12	0	0
23	25871764	.	C	A	12	8	20	0	2	22	0	0
23	25873876	.	A	T	1	4	5	0	0	5	0	0
23	25873882	.	G	C	1	4	5	0	0	5	0	0
23	25874089	.	A	C	9	19	28	0	0	28	0	0
23	25874100	.	A	T	10	17	27	0	0	27	0	0
23	25874135	.	G	A	3	14	17	0	12	29	0	0
23	25874154	.	T	G	15	10	25	0	0	25	0	0
23	25874249	.	A	G	19	0	19	0	7	26	0	0
23	25874261	.	T	A	17	7	24	0	1	25	0	0
23	25874334	.	C	G	6	3	9	0	0	9	0	0
23	25874355	.	A	T	4	7	11	0	0	11	0	0
23	25874385	.	T	C	7	11	18	0	1	19	0	0
23	25874452	.	A	T	8	11	19	0	1	20	0	0
23	25930689	.	C	T	17	15	32	0	0	32	0	0
23	25942399	.	T	G	15	0	15	0	16	31	0	0
23	25942559	.	T	A	4	6	10	0	1	11	0	0
23	25946530	.	A	G	2	2	4	0	1	5	0	0
23	25954602	.	G	A	2	2	4	0	0	4	0	0
23	25958173	.	T	C	1	0	1	0	2	3	0	0
23	26063264	.	T	C	2	3	5	0	1	6	0	0
23	26063560	.	A	T	26	25	51	0	8	59	0	0
23	26063581	.	T	C	32	1	33	0	23	56	0	0
23	26063614	.	A	C	28	26	54	0	3	57	0	0
23	26064050	.	T	A	29	24	53	0	2	55	0	0
23	26064122	.	T	A	13	22	35	0	1	36	0	0
23	26064124	.	T	A	27	11	38	0	0	38	0	0
23	26064186	.	C	G	18	19	37	2	0	39	0	0
23	26064192	.	T	A	18	18	36	2	0	38	0	0
23	26064234	.	G	T	19	21	40	0	2	42	0	0
23	26064266	.	T	A	15	13	28	0	0	28	0	0
23	26074123	.	G	A	22	15	37	0	1	38	0	0
23	26074252	.	T	A	11	17	28	0	2	30	0	0
23	26074288	.	T	C	14	13	27	0	0	27	0	0
23	26074312	.	C	T	13	13	26	0	2	28	0	0
23	26083603	.	A	G	2	2	4	0	0	4	0	0
23	26083822	.	A	C	2	3	5	0	0	5	0	0
23	26088857	.	T	C	4	6	10	0	1	11	0	0
23	26184132	.	T	C	11	11	22	0	0	22	0	0
23	26184225	.	G	A	8	7	15	0	0	15	0	0
23	26187373	.	C	T	1	5	6	0	12	18	0	0
23	26187415	.	A	G	6	3	9	0	0	9	0	0
23	26187603	.	C	A	0	2	2	0	2	4	0	0
23	26187735	.	C	T	2	4	6	0	1	7	0	0
23	26187885	.	T	C	1	7	8	0	1	9	0	0
23	26187912	.	G	A	1	6	7	0	0	7	0	0
23	26225670	.	T	C	4	9	13	0	0	13	0	0
23	26225871	.	G	A	1	2	3	0	1	4	0	0
23	26227697	.	C	T	0	6	6	0	9	15	0	0
23	26232509	.	C	A	15	6	21	0	1	22	0	0
23	26240897	.	C	T	8	10	18	0	0	18	0	0
23	26241224	.	T	A	4	4	8	0	3	11	0	0
23	26251973	.	C	T	6	7	13	0	2	15	0	0
23	26251979	.	A	T	7	7	14	0	2	16	0	0
23	26273212	.	C	T	0	3	3	0	3	6	0	0
23	26343689	.	C	G	2	2	4	0	0	4	0	0
23	26504151	.	A	C	38	1	39	2	21	62	0	0
23	26504202	.	A	T	48	18	66	3	5	74	0	0
23	26504254	.	G	A	38	14	52	2	1	55	0	0
23	26504264	.	C	T	36	15	51	2	0	53	0	0
23	26507741	.	G	A	29	27	56	0	1	57	0	0
23	26509764	.	G	A	26	27	53	0	2	55	0	0
23	26514677	.	G	A	33	20	53	0	2	55	0	0
23	26514797	.	T	C	23	17	40	0	3	43	0	0
23	26517183	.	G	A	18	16	34	0	3	37	0	0
23	26519635	.	T	G	12	15	27	0	3	30	0	0
23	26522647	.	A	G	17	12	29	0	3	32	0	0
23	26543878	.	A	T	2	2	4	0	0	4	0	0
23	26763798	.	A	T	5	4	9	0	1	10	0	0
23	26764269	.	G	A	6	5	11	0	0	11	0	0
23	26764324	.	C	A	1	2	3	0	0	3	0	0
23	26764351	.	A	C	3	2	5	0	0	5	0	0
23	26777492	.	G	A	1	2	3	0	0	3	0	0
23	26801660	.	G	A	2	2	4	0	0	4	0	0
23	26819681	.	T	G	2	2	4	0	0	4	0	0
23	26946805	.	A	G	5	5	10	0	0	10	0	0
23	26950928	.	G	A	0	3	3	0	3	6	0	0
23	26955401	.	A	G	4	6	10	0	1	11	0	0
23	26979212	.	C	A	10	12	22	0	0	22	0	0
23	27003720	.	G	A	24	37	61	0	3	64	0	0
23	27003925	.	T	C	23	23	46	0	2	48	0	0
23	27003983	.	A	T	19	24	43	0	1	44	0	0
23	27005195	.	G	A	26	16	42	0	7	49	0	0
23	27041461	.	A	T	4	4	8	0	0	8	0	0
23	27042357	.	G	A	6	4	10	0	1	11	0	0
23	27042454	.	T	C	3	2	5	0	0	5	0	0
23	27044136	.	G	A	2	2	4	0	0	4	0	0
23	27044307	.	A	G	4	5	9	0	0	9	0	0
23	27044526	.	A	G	0	3	3	0	1	4	0	0
23	27044653	.	G	A	4	4	8	0	1	9	0	0
23	27052058	.	C	T	27	27	54	0	0	54	0	0
23	27054361	.	C	T	13	16	29	0	0	29	0	0
23	27056877	.	G	A	19	17	36	0	2	38	0	0
23	27059120	.	G	A	0	16	16	0	15	31	0	0
23	27059376	.	T	A	18	20	38	0	1	39	0	0
23	27059422	.	C	T	20	19	39	0	0	39	0	0
23	27059526	.	G	A	2	21	23	0	17	40	0	0
23	27059591	.	C	A	14	16	30	0	1	31	0	0
23	27059782	.	A	G	14	15	29	0	1	30	0	0
23	27135734	.	G	A	2	3	5	0	1	6	0	0
23	27135893	.	G	A	1	3	4	0	0	4	0	0
23	27251789	.	G	C	23	20	43	0	0	43	0	0
23	27252024	.	G	A	23	21	44	0	2	46	0	0
23	27252425	.	G	A	20	29	49	0	3	52	0	0
23	27252587	.	A	G	24	15	39	0	2	41	0	0
23	27252833	.	A	G	15	17	32	0	1	33	0	0
23	27274110	.	G	A	6	7	13	0	0	13	0	0
23	27274266	.	G	A	8	10	18	0	3	21	0	0
23	27279320	.	A	G	9	10	19	0	1	20	0	0
23	27279533	.	C	T	10	9	19	0	0	19	0	0
23	27283466	.	T	C	6	8	14	0	0	14	0	0
23	27283475	.	A	G	5	8	13	0	1	14	0	0
23	27293293	.	C	T	0	11	11	0	5	16	0	0
23	27293335	.	G	A	6	5	11	0	3	14	0	0
23	27296964	.	G	C	11	0	11	0	6	17	0	0
23	27336193	.	G	A	5	3	8	0	1	9	0	0
23	27359176	.	A	G	6	13	19	0	1	20	0	0
23	27359526	.	T	C	7	6	13	0	1	14	0	0
23	27359528	.	C	G	7	6	13	0	0	13	0	0
23	27359825	.	C	A	14	5	19	0	0	19	0	0
23	27361210	.	A	T	6	4	10	0	1	12	1	0
23	27361216	.	G	A	7	5	12	0	1	13	0	0
23	27366669	.	C	T	4	3	7	0	0	7	0	0
23	27385057	.	G	A	1	2	3	0	0	3	0	0
23	27386226	.	G	A	2	3	5	0	0	5	0	0
23	27389324	.	C	A	5	3	8	0	0	8	0	0
23	27448169	.	T	C	2	2	4	0	0	4	0	0
23	27498040	.	C	G	7	11	18	0	0	18	0	0
23	27498111	.	C	A	10	10	20	0	0	20	0	0
23	27498177	.	T	C	12	12	24	0	2	26	0	0
23	27498195	.	A	T	14	12	26	0	0	26	0	0
23	27498359	.	T	A	10	8	18	0	0	18	0	0
23	27498798	.	C	T	2	14	16	0	14	30	0	0
23	27498865	.	G	A	17	17	34	0	3	37	0	0
23	27499096	.	G	A	14	14	28	0	0	28	0	0
23	27499135	.	G	A	12	11	23	0	0	23	0	0
23	27499195	.	A	T	13	18	31	0	0	31	0	0
23	27499246	.	G	A	13	16	29	0	0	29	0	0
23	27513919	.	G	A	9	9	18	0	0	18	0	0
23	27513934	.	T	C	12	11	23	0	0	23	0	0
23	27518434	.	G	A	8	9	17	0	2	19	0	0
23	27521608	.	A	T	3	4	7	0	0	7	0	0
23	27547568	.	G	A	4	5	9	0	0	9	0	0
23	27547850	.	C	T	2	3	5	0	1	6	0	0
23	27576533	.	T	G	5	4	9	0	0	9	0	0
23	27576535	.	G	A	5	4	9	0	0	9	0	0
23	27579064	.	T	A	2	2	4	0	0	4	0	0
23	27581369	.	G	T	2	2	4	0	0	4	0	0
23	27591378	.	G	T	11	6	17	0	1	18	0	0
23	27593230	.	C	T	5	8	13	0	0	13	0	0
23	27595823	.	C	A	1	8	9	0	13	22	0	0
23	27595868	.	T	C	10	6	16	0	0	16	0	0
23	27596059	.	G	A	7	10	17	0	1	18	0	0
23	27597141	.	C	A	0	6	6	0	8	14	0	0
23	27601731	.	G	A	4	2	6	0	0	6	0	0
23	27603158	.	C	T	3	2	5	0	0	5	0	0
23	27605927	.	C	T	1	4	5	0	0	5	0	0
23	27606827	.	T	A	1	2	3	0	0	3	0	0
23	27622036	.	T	A	24	19	43	0	3	46	0	0
23	27622094	.	C	A	14	15	29	0	3	32	0	0
23	27622324	.	T	C	14	12	26	0	0	26	0	0
23	27622531	.	A	T	21	11	32	0	1	33	0	0
23	27622706	.	T	C	7	1	8	0	9	17	0	0
23	27629713	.	G	A	19	22	41	0	0	41	0	0
23	27629923	.	A	T	14	16	30	0	1	31	0	0
23	27676223	.	G	T	27	32	59	0	3	62	0	0
23	27677278	.	G	A	29	22	51	0	1	52	0	0
23	27677457	.	G	A	12	20	32	0	0	32	0	0
23	27683143	.	G	T	5	2	7	0	1	8	0	0
23	27683248	.	C	A	0	3	3	0	2	5	0	0
23	27683371	.	C	T	1	6	7	0	2	9	0	0
23	27683497	.	C	T	8	12	20	0	0	20	0	0
23	27683629	.	C	T	0	2	2	0	4	6	0	0
23	27683710	.	G	A	3	5	8	0	0	8	0	0
23	27788665	.	C	T	7	8	15	0	1	16	0	0
23	27800681	.	G	T	7	4	11	0	0	11	0	0
23	27800977	.	C	T	3	17	20	0	0	20	0	0
23	27807523	.	A	G	4	5	9	0	1	10	0	0
23	27807664	.	G	A	3	2	5	0	0	5	0	0
23	27822743	.	T	C	6	5	11	0	0	11	0	0
23	27836235	.	C	T	0	2	2	0	5	7	0	0
23	28552149	.	A	C	1	2	3	0	13	16	0	0
23	28924872	.	G	A	3	5	8	0	0	8	0	0
23	29362550	.	G	T	5	3	8	0	5	13	0	0
23	29580587	.	A	T	4	3	7	0	0	7	0	0
23	29582416	.	T	C	19	37	56	0	2	58	0	0
23	29582420	.	T	C	13	44	57	0	2	59	0	0
23	30061604	.	A	C	17	20	37	0	7	44	0	0
23	30061605	.	A	C	27	13	40	0	4	44	0	0
23	30065641	.	T	G	7	4	11	0	0	11	0	0
23	30065642	.	T	G	9	2	11	0	3	14	0	0
23	30712041	.	T	A	6	3	9	0	0	9	0	0
23	30715397	.	G	A	0	2	2	0	4	6	0	0
23	30716096	.	C	T	4	6	10	0	1	11	0	0
23	30718514	.	T	A	8	6	14	0	0	14	0	0
23	30723747	.	A	T	6	9	15	0	2	17	0	0
23	30724440	.	T	C	8	9	17	0	0	17	0	0
23	30727016	.	T	C	1	0	1	0	2	3	0	0
23	30727172	.	T	C	1	0	1	0	2	3	0	0
23	30747357	.	G	C	3	4	7	0	2	9	0	0
23	30747953	.	G	A	4	5	9	0	1	10	0	0
23	30748097	.	G	A	6	7	13	0	2	15	0	0
23	30748712	.	C	G	6	0	6	0	6	12	0	0
23	30748743	.	C	T	3	9	12	0	1	13	0	0
23	30750402	.	C	A	10	10	20	0	0	20	0	0
23	30750694	.	C	A	13	11	24	0	4	28	0	0
23	30750751	.	G	A	0	12	12	0	15	27	0	0
23	30750932	.	A	C	15	17	32	0	1	33	0	0
23	30751008	.	T	C	13	17	30	0	0	30	0	0
23	30751027	.	A	T	12	16	28	0	1	29	0	0
23	30751061	.	A	G	11	0	11	0	12	23	0	0
23	30751117	.	T	C	11	14	25	0	1	26	0	0
23	30751132	.	T	G	10	2	12	0	13	25	0	0
23	30751252	.	A	G	18	14	32	0	1	33	0	0
23	30751570	.	C	T	14	18	32	0	0	32	0	0
23	30751633	.	T	C	13	15	28	0	0	28	0	0
23	30755989	.	C	T	9	10	19	0	1	20	0	0
23	30758493	.	G	T	11	12	23	0	0	23	0	0
23	30764058	.	T	A	6	5	11	0	0	11	0	0
23	30767575	.	T	A	14	10	24	0	1	25	0	0
23	30770193	.	A	G	15	7	22	0	0	22	0	0
23	30772610	.	C	T	1	10	11	0	11	22	0	0
23	30772902	.	C	T	4	7	11	0	1	12	0	0
23	30775315	.	T	C	17	0	17	0	16	33	0	0
23	30776329	.	T	A	8	7	15	0	0	15	0	0
23	30776380	.	T	C	6	1	7	0	8	15	0	0
23	30776574	.	A	T	4	11	15	0	0	15	0	0
23	30778358	.	T	C	3	3	6	0	0	6	0	0
23	30778499	.	G	A	6	10	16	0	0	16	0	0
23	30778864	.	C	G	0	10	10	0	11	21	0	0
23	30781226	.	T	A	5	11	16	0	1	17	0	0
23	30781319	.	A	G	13	6	19	0	0	19	0	0
23	30781367	.	T	C	7	5	12	0	1	13	0	0
23	30859543	.	C	A	6	3	9	0	4	13	0	0
23	30859579	.	T	A	9	3	12	0	2	14	0	0
23	30890018	.	G	T	4	2	6	0	0	6	0	0
23	30890701	.	T	A	1	2	3	0	0	3	0	0
23	30898132	.	C	T	4	6	10	0	0	10	0	0
23	30898150	.	T	C	5	6	11	0	0	11	0	0
23	30898297	.	T	C	3	2	5	0	0	5	0	0
23	30898355	.	A	C	2	5	7	0	0	7	0	0
23	30898387	.	C	T	2	4	6	0	0	6	0	0
23	30918961	.	G	T	3	2	5	0	1	6	0	0
23	30918998	.	A	G	3	2	5	0	0	5	0	0
23	30919027	.	T	G	1	4	5	0	0	5	0	0
23	30951633	.	A	G	3	2	5	0	0	5	0	0
23	30993014	.	G	A	2	2	4	0	1	5	0	0
23	31245593	.	A	T	4	2	6	0	0	6	0	0
23	31248605	.	A	T	4	5	9	0	0	9	0	0
23	31276396	.	T	A	6	8	14	0	0	14	0	0
23	31276453	.	G	A	8	6	14	0	0	14	0	0
23	31276509	.	C	T	5	2	7	0	0	7	0	0
23	31276657	.	T	C	6	3	9	0	1	10	0	0
23	31278183	.	G	T	3	5	8	0	1	9	0	0
23	31278237	.	C	T	1	2	3	0	2	5	0	0
23	31278322	.	A	G	8	5	13	0	1	14	0	0
23	31278375	.	A	G	5	5	10	0	1	11	0	0
23	31278417	.	G	T	4	3	7	0	0	7	0	0
23	31278450	.	T	A	5	2	7	0	1	8	0	0
23	31278732	.	C	T	4	4	8	0	1	9	0	0
23	31279122	.	G	T	4	7	11	0	0	11	0	0
23	31304661	.	A	G	1	2	3	0	1	4	0	0
23	31304670	.	G	A	2	2	4	0	0	4	0	0
23	31309722	.	T	C	1	2	3	0	0	3	0	0
23	31358342	.	A	T	31	11	42	0	3	45	0	0
23	31358344	.	A	T	26	12	38	0	1	39	0	0
23	31358489	.	T	G	28	17	45	0	0	45	0	0
23	31358631	.	G	A	30	25	55	0	1	56	0	0
23	31381068	.	C	T	4	2	6	0	1	7	0	0
23	31381335	.	A	G	3	2	5	0	1	6	0	0
23	31381356	.	G	A	2	2	4	0	0	4	0	0
23	31405519	.	C	T	4	8	12	0	0	12	0	0
23	31405570	.	A	C	6	13	19	0	0	19	0	0
23	31419064	.	C	T	9	10	19	0	0	19	0	0
23	31419172	.	A	T	7	5	12	0	0	12	0	0
23	31422369	.	A	T	3	3	6	0	0	6	0	0
23	31422429	.	C	T	10	3	13	0	0	13	0	0
23	31422540	.	A	C	2	5	7	0	0	9	2	0
23	31422543	.	A	C	4	5	9	0	0	9	0	0
23	31422768	.	A	G	11	6	17	1	0	18	0	0
23	31423091	.	T	C	9	10	19	0	0	19	0	0
23	31423145	.	G	A	0	7	7	0	13	20	0	0
23	31423392	.	C	A	14	15	29	0	2	31	0	0
23	31423427	.	A	G	26	1	27	0	11	38	0	0
23	31423432	.	C	A	24	11	35	0	1	37	1	0
23	31432102	.	A	G	5	0	5	0	12	17	0	0
23	31440119	.	T	A	3	2	5	0	0	5	0	0
23	31596584	.	T	G	2	0	2	0	5	7	0	0
23	31597571	.	T	C	9	10	19	0	1	20	0	0
23	31641153	.	C	A	22	27	49	0	1	50	0	0
23	31641197	.	A	G	20	32	52	0	0	52	0	0
23	31641270	.	G	A	25	24	49	0	2	51	0	0
23	31643818	.	A	G	17	15	32	0	1	33	0	0
23	31644368	.	A	G	13	11	24	0	0	24	0	0
23	31644419	.	A	G	12	12	24	0	0	24	0	0
23	31644602	.	T	G	10	16	26	0	2	28	0	0
23	31684244	.	A	G	8	5	13	0	3	16	0	0
23	31684352	.	G	A	14	10	24	0	0	24	0	0
23	31752717	.	A	G	1	2	3	0	0	3	0	0
23	31752909	.	A	G	1	5	6	0	0	6	0	0
23	31756210	.	G	A	3	4	7	0	0	7	0	0
23	31756216	.	C	T	0	5	5	0	3	8	0	0
23	31768596	.	T	C	7	7	14	0	1	15	0	0
23	31771282	.	T	C	7	8	15	0	0	15	0	0
23	31774194	.	G	A	12	7	19	0	0	19	0	0
23	31778174	.	A	G	7	6	13	0	0	13	0	0
23	31778183	.	C	T	7	7	14	0	0	14	0	0
23	31782969	.	T	C	6	0	6	0	7	13	0	0
23	31785175	.	G	A	2	7	9	0	0	9	0	0
23	31785183	.	T	G	2	7	9	0	0	9	0	0
23	31912503	.	C	G	1	2	3	0	0	3	0	0
23	31940681	.	C	A	4	4	8	0	0	8	0	0
23	31953228	.	A	T	2	3	5	0	0	5	0	0
23	31953501	.	A	G	2	5	7	0	0	7	0	0
23	31953518	.	C	T	1	2	3	0	1	4	0	0
23	31953537	.	A	C	2	3	5	0	0	5	0	0
23	31962971	.	T	C	9	7	16	0	1	17	0	0
23	31963226	.	C	T	5	8	13	0	0	13	0	0
23	31963360	.	A	G	4	7	11	0	0	11	0	0
23	31964680	.	C	T	4	11	15	0	0	15	0	0
23	31982041	.	T	C	2	5	7	0	1	8	0	0
23	31982042	.	C	T	3	5	8	0	0	8	0	0
23	31992375	.	T	C	1	2	3	0	0	3	0	0
23	31992690	.	C	T	5	2	7	0	1	8	0	0
23	31993590	.	C	T	5	4	9	0	0	9	0	0
23	31995113	.	G	A	1	4	5	0	0	5	0	0
23	31997582	.	G	A	6	2	8	0	0	8	0	0
23	31998162	.	T	C	6	6	12	0	0	12	0	0
23	31998741	.	A	G	5	0	5	0	4	9	0	0
23	32000336	.	G	C	2	8	10	0	0	10	0	0
23	32001190	.	C	T	3	2	5	0	1	6	0	0
23	32003354	.	T	A	5	6	11	0	0	11	0	0
23	32003808	.	T	C	5	4	9	0	1	10	0	0
23	32003820	.	G	T	8	4	12	0	0	12	0	0
23	32007376	.	T	G	7	9	16	0	0	16	0	0
23	32007445	.	T	A	7	6	13	0	1	14	0	0
23	32007520	.	T	C	7	4	11	0	0	11	0	0
23	32007526	.	C	G	7	4	11	0	0	11	0	0
23	32018811	.	C	T	1	2	3	0	0	3	0	0
23	32026927	.	T	C	14	16	30	0	0	30	0	0
23	32026978	.	C	T	3	7	10	0	0	10	0	0
23	32026996	.	G	A	0	4	4	0	2	7	1	0
23	32081708	.	C	T	11	10	21	0	1	22	0	0
23	32081717	.	T	C	13	12	25	0	0	25	0	0
23	32088077	.	T	G	1	3	4	0	0	4	0	0
23	32128848	.	A	T	3	2	5	0	0	5	0	0
23	32129326	.	C	A	4	2	6	0	0	6	0	0
23	32129476	.	G	T	6	4	10	0	0	10	0	0
23	32151669	.	A	C	14	12	26	0	2	28	0	0
23	32152022	.	C	T	11	17	28	1	0	29	0	0
23	32154021	.	G	T	7	2	9	0	0	9	0	0
23	32155325	.	A	G	8	5	13	0	0	13	0	0
23	32155719	.	C	T	7	5	12	0	0	12	0	0
23	32155720	.	C	T	0	5	5	0	7	12	0	0
23	32155975	.	C	T	7	2	9	0	0	9	0	0
23	32157787	.	G	T	6	5	11	0	0	11	0	0
23	32200517	.	C	A	3	2	5	0	0	5	0	0
23	32200583	.	C	T	0	3	3	0	2	5	0	0
23	32200979	.	A	G	4	2	6	0	0	6	0	0
23	32239672	.	G	A	12	7	19	0	0	19	0	0
23	32239688	.	C	A	17	7	24	0	0	24	0	0
23	32239708	.	G	A	17	8	25	0	0	25	0	0
23	32239824	.	G	A	12	15	27	0	0	27	0	0
23	32240258	.	C	T	12	7	19	0	0	19	0	0
23	32240290	.	A	G	13	5	18	0	0	18	0	0
23	32242086	.	C	A	11	12	23	0	0	23	0	0
23	32242251	.	T	C	12	5	17	0	0	17	0	0
23	32246169	.	A	G	10	7	17	0	0	17	0	0
23	32246190	.	A	G	9	5	14	0	0	14	0	0
23	32248595	.	C	G	6	7	13	0	1	14	0	0
23	32250286	.	C	T	5	6	11	0	0	11	0	0
23	32251473	.	T	G	12	3	15	0	0	15	0	0
23	32252805	.	A	G	4	5	9	0	0	9	0	0
23	32309187	.	T	C	19	14	33	0	1	34	0	0
23	32309193	.	G	A	14	14	28	0	3	31	0	0
23	32309323	.	G	A	15	20	35	0	0	35	0	0
23	32309533	.	A	G	7	14	21	0	0	21	0	0
23	32309659	.	C	A	0	12	12	0	8	20	0	0
23	32309709	.	G	A	10	8	18	0	0	18	0	0
23	32309787	.	A	C	15	7	22	0	1	23	0	0
23	32309846	.	T	A	6	4	10	0	1	11	0	0
23	32309860	.	C	T	6	2	8	0	0	8	0	0
23	32309943	.	A	G	5	5	10	0	0	10	0	0
23	32310209	.	C	T	2	4	6	0	0	6	0	0
23	32310782	.	T	G	1	1	2	0	1	3	0	0
23	32310808	.	C	T	1	3	4	0	1	5	0	0
23	32310864	.	G	A	8	10	18	0	1	19	0	0
23	32311418	.	T	C	7	10	17	0	1	18	0	0
23	32311555	.	G	C	19	12	31	0	1	32	0	0
23	32311612	.	G	A	25	9	34	0	1	35	0	0
23	32318047	.	A	G	14	15	29	0	1	30	0	0
23	32326532	.	A	G	9	10	19	0	0	19	0	0
23	32362317	.	A	G	2	4	6	0	0	6	0	0
23	32589398	.	C	T	4	5	9	0	0	9	0	0
23	32592331	.	A	G	1	5	6	0	0	6	0	0
23	32592593	.	C	T	0	3	3	0	2	5	0	0
23	32599214	.	G	T	2	5	7	0	0	7	0	0
23	32641956	.	C	T	0	0	0	0	5	5	0	0
23	32641959	.	G	A	3	2	5	0	0	5	0	0
23	32645443	.	G	A	2	4	6	0	2	8	0	0
23	33357856	.	A	C	2	2	4	0	0	4	0	0
23	33357953	.	T	A	4	5	9	0	0	9	0	0
23	33361256	.	C	T	0	3	3	0	6	9	0	0
23	33448146	.	T	A	1	2	3	0	0	3	0	0
23	33448148	.	C	T	1	1	2	0	1	3	0	0
23	33449124	.	G	T	1	2	3	0	0	3	0	0
23	33657431	.	T	A	16	15	31	0	0	31	0	0
23	33657460	.	C	T	15	13	28	0	2	30	0	0
23	33657467	.	T	A	14	15	29	0	0	29	0	0
23	33657714	.	T	G	8	8	16	0	1	17	0	0
23	33682045	.	A	T	4	3	7	0	0	7	0	0
23	33682306	.	T	C	4	7	11	0	0	11	0	0
23	33682313	.	A	G	4	7	11	0	0	11	0	0
23	33682369	.	T	A	1	4	5	0	0	5	0	0
23	33682370	.	T	A	1	4	5	0	0	5	0	0
23	33682416	.	T	A	1	5	6	0	0	6	0	0
23	33682736	.	A	G	4	3	7	0	0	7	0	0
23	33682740	.	A	T	4	3	7	0	0	7	0	0
23	33682992	.	T	A	3	4	7	0	0	7	0	0
23	33683092	.	T	G	2	8	10	0	2	12	0	0
23	33683299	.	T	A	1	4	5	0	0	5	0	0
23	33688013	.	T	C	6	0	6	0	6	12	0	0
23	33693482	.	G	A	4	3	7	0	0	7	0	0
23	33693572	.	T	C	5	3	8	0	0	8	0	0
23	33694328	.	A	C	2	0	2	0	4	6	0	0
23	33696929	.	T	G	2	2	4	0	0	4	0	0
23	33696938	.	C	G	2	2	4	0	0	4	0	0
23	33702812	.	G	A	6	4	10	0	0	10	0	0
23	33718699	.	T	C	23	25	48	0	1	49	0	0
23	33724825	.	G	A	4	18	22	0	20	42	0	0
23	33727916	.	C	T	20	20	40	0	4	44	0	0
23	33728398	.	A	T	16	14	30	0	4	34	0	0
23	33728518	.	T	C	23	16	39	0	0	39	0	0
23	33728609	.	A	T	26	14	40	0	2	42	0	0
23	33728877	.	T	A	29	22	51	0	0	51	0	0
23	33728994	.	T	A	24	9	33	0	3	36	0	0
23	33729231	.	T	A	13	9	22	0	1	23	0	0
23	33729510	.	A	G	21	16	37	0	5	42	0	0
23	33873137	.	T	A	5	3	8	0	1	9	0	0
23	33873187	.	C	G	4	3	7	0	1	8	0	0
23	33887839	.	C	T	10	7	17	0	0	17	0	0
23	33892021	.	C	T	10	7	17	0	0	17	0	0
23	33901239	.	C	T	12	9	21	1	0	22	0	0
23	33901271	.	C	T	5	10	15	1	0	16	0	0
23	33907969	.	C	A	12	18	30	0	0	30	0	0
23	33907990	.	A	G	10	0	10	0	20	31	1	0
23	33918162	.	C	T	17	12	29	0	2	31	0	0
23	33920287	.	G	A	16	14	30	0	1	31	0	0
23	33920311	.	A	G	11	11	22	0	0	22	0	0
23	33920344	.	C	T	9	11	20	0	1	21	0	0
23	33920431	.	C	T	16	14	30	0	0	30	0	0
23	33923716	.	A	G	11	0	11	0	17	28	0	0
23	33926555	.	C	A	25	21	46	0	2	48	0	0
23	33926663	.	C	T	25	24	49	0	0	49	0	0
23	33927045	.	C	T	28	20	48	0	5	53	0	0
23	33927244	.	G	A	1	12	13	0	17	30	0	0
23	33927500	.	T	A	17	8	25	0	2	28	1	0
23	33927897	.	T	G	29	25	54	1	4	59	0	0
23	33927941	.	C	T	24	25	49	0	7	56	0	0
23	33935471	.	C	G	10	8	18	0	1	19	0	0
23	33935549	.	C	T	5	10	15	0	2	17	0	0
23	33942036	.	C	T	6	4	10	0	0	10	0	0
23	33944059	.	G	A	7	5	12	0	0	12	0	0
23	33944188	.	C	T	6	9	15	0	0	15	0	0
23	33944295	.	T	G	6	4	10	0	0	10	0	0
23	33944336	.	A	T	9	7	16	0	0	16	0	0
23	33944337	.	G	A	9	7	16	0	0	16	0	0
23	33944421	.	C	A	1	4	5	0	0	5	0	0
23	33963655	.	G	T	2	2	4	0	0	4	0	0
23	33974392	.	T	C	18	14	32	0	0	32	0	0
23	33974659	.	C	A	15	15	30	0	0	30	0	0
23	33974662	.	A	T	13	16	29	0	3	32	0	0
23	33974827	.	A	T	6	22	28	0	1	29	0	0
23	33974904	.	T	A	11	22	33	0	1	34	0	0
23	33975854	.	T	A	15	16	31	0	1	32	0	0
23	33978028	.	T	G	7	6	13	0	0	13	0	0
23	33978049	.	A	T	5	6	11	0	0	11	0	0
23	33978125	.	A	C	3	4	7	0	0	7	0	0
23	33978220	.	C	A	4	3	7	0	0	7	0	0
23	33978462	.	T	A	11	9	20	0	0	20	0	0
23	33978469	.	C	T	9	8	17	0	3	20	0	0
23	33978577	.	C	T	6	8	14	0	1	15	0	0
23	33978639	.	G	T	9	12	21	0	0	21	0	0
23	33978671	.	T	A	12	10	22	0	2	24	0	0
23	33983333	.	G	C	9	16	25	0	2	27	0	0
23	33984364	.	G	A	17	18	35	0	1	36	0	0
23	33987467	.	T	G	11	5	16	0	0	16	0	0
23	33987637	.	C	T	11	9	20	0	0	20	0	0
23	33991132	.	G	A	8	6	14	0	1	15	0	0
23	33991460	.	A	G	1	2	3	0	0	3	0	0
23	33993191	.	T	C	9	7	16	0	0	16	0	0
23	34005089	.	G	T	8	8	16	0	1	17	0	0
23	34005095	.	T	C	7	8	15	0	0	15	0	0
23	34035241	.	G	T	11	5	16	0	0	16	0	0
23	34035295	.	G	A	8	10	18	0	0	18	0	0
23	34035364	.	C	T	10	10	20	0	0	20	0	0
23	34036432	.	A	G	12	8	20	0	1	21	0	0
23	34038436	.	C	T	12	13	25	0	4	29	0	0
23	34042998	.	C	T	21	26	47	0	0	47	0	0
23	34043308	.	G	T	20	17	37	0	3	40	0	0
23	34043335	.	G	A	2	21	23	0	17	40	0	0
23	34043423	.	G	A	20	14	34	0	0	34	0	0
23	34043536	.	T	C	15	11	26	0	2	28	0	0
23	34043596	.	T	C	3	8	11	0	0	11	0	0
23	34110634	.	C	T	16	13	29	0	0	29	0	0
23	34136467	.	C	T	17	17	34	1	0	35	0	0
23	34559897	.	C	T	2	2	4	0	1	5	0	0
23	34559971	.	C	T	2	4	6	0	0	6	0	0
23	34658549	.	C	T	1	3	4	0	0	4	0	0
23	34659533	.	C	T	5	4	9	0	0	9	0	0
23	34678957	.	G	T	3	4	7	0	0	8	1	0
23	34679008	.	A	G	9	3	12	0	0	12	0	0
23	34710333	.	C	T	7	5	12	0	0	12	0	0
23	34726384	.	A	G	7	0	7	0	6	13	0	0
23	34726387	.	A	G	6	7	13	0	0	13	0	0
23	34726438	.	T	C	9	2	11	0	2	13	0	0
23	34726444	.	G	T	9	3	12	0	0	12	0	0
23	34732871	.	A	G	9	0	9	0	7	17	1	0
23	34748833	.	G	A	0	9	9	0	11	20	0	0
23	34753803	.	A	G	12	12	24	0	1	25	0	0
23	35027189	.	T	C	2	2	4	0	0	4	0	0
23	35027386	.	T	G	5	4	9	0	0	9	0	0
23	35027480	.	T	G	4	4	8	0	0	8	0	0
23	35027518	.	T	A	3	9	12	0	0	12	0	0
23	35027541	.	A	G	4	9	13	0	0	13	0	0
23	35052494	.	G	A	5	2	7	0	0	7	0	0
23	35187726	.	C	T	2	2	4	0	0	4	0	0
23	35187739	.	G	T	2	2	4	0	0	4	0	0
23	35188009	.	G	C	3	0	3	0	3	6	0	0
23	35188012	.	T	C	2	2	4	0	0	4	0	0
23	35188562	.	G	A	3	2	5	0	0	5	0	0
23	35256186	.	G	A	3	2	5	0	0	5	0	0
23	35256414	.	A	C	2	0	2	0	5	7	0	0
23	35362951	.	C	T	11	4	15	0	1	16	0	0
23	35362973	.	G	T	7	4	11	0	3	14	0	0
23	35363024	.	A	T	7	10	17	0	1	18	0	0
23	35363067	.	A	T	12	6	18	0	2	20	0	0
23	35363106	.	G	A	16	14	30	0	1	31	0	0
23	35363111	.	C	G	15	13	28	0	3	31	0	0
23	35363226	.	T	C	18	0	18	0	15	33	0	0
23	35363341	.	A	G	17	9	26	0	2	28	0	0
23	35369733	.	G	A	9	7	16	0	1	17	0	0
23	35376893	.	A	G	1	3	4	0	0	4	0	0
23	35382971	.	C	T	2	4	6	0	0	6	0	0
23	35389118	.	C	T	2	3	5	0	0	5	0	0
23	35393459	.	A	G	4	4	8	0	1	9	0	0
23	35393473	.	G	T	5	5	10	0	0	10	0	0
23	35394053	.	G	C	2	2	4	0	0	4	0	0
23	35396735	.	C	A	4	3	7	0	0	7	0	0
23	35396791	.	C	A	4	3	7	0	0	7	0	0
23	35469135	.	T	C	1	3	4	0	0	4	0	0
23	35469136	.	G	A	1	3	4	0	0	4	0	0
23	35469479	.	A	G	6	3	9	0	0	9	0	0
23	35469668	.	G	T	7	11	18	0	0	19	1	0
23	35473640	.	A	G	1	5	6	0	1	7	0	0
23	35479283	.	A	C	1	3	4	0	0	4	0	0
23	35537247	.	A	G	4	3	7	0	0	7	0	0
23	35537248	.	A	G	4	3	7	0	0	7	0	0
23	35537455	.	A	G	17	10	27	0	1	28	0	0
23	35537599	.	G	A	9	5	14	0	0	14	0	0
23	35537617	.	G	A	7	4	11	0	0	11	0	0
23	35547609	.	G	A	3	2	5	0	0	5	0	0
23	35547612	.	G	A	3	2	5	0	0	5	0	0
23	35642327	.	T	G	10	6	16	0	1	17	0	0
23	35644234	.	C	T	11	10	21	0	0	21	0	0
23	35661380	.	C	T	3	6	9	0	1	10	0	0
23	35661530	.	T	C	5	6	11	0	0	11	0	0
23	35661549	.	A	C	5	6	11	0	2	13	0	0
23	35661572	.	A	C	4	6	10	0	0	10	0	0
23	35661692	.	C	A	2	2	4	0	0	4	0	0
23	35661723	.	A	C	3	4	7	0	0	7	0	0
23	35663421	.	T	G	4	3	7	0	0	7	0	0
23	35691968	.	T	G	10	13	23	2	2	27	0	0
23	35710179	.	A	C	32	20	52	8	3	63	0	0
23	35715418	.	T	G	1	7	8	1	2	11	0	0
23	36310415	.	C	A	2	3	5	0	0	5	0	0
23	37467073	.	A	G	7	6	13	0	0	13	0	0
23	37467109	.	A	G	9	0	9	0	5	14	0	0
23	37467115	.	A	G	8	0	8	0	7	15	0	0
23	37706728	.	T	C	3	2	5	0	0	5	0	0
23	39635930	.	T	C	1	2	3	0	1	4	0	0
23	39744943	.	A	T	4	20	24	0	3	27	0	0
23	39757050	.	T	C	4	4	8	0	0	8	0	0
23	39758923	.	T	C	1	4	5	1	1	7	0	0
23	39758994	.	T	C	5	5	10	0	0	10	0	0
23	40438000	.	T	A	1	2	3	0	0	3	0	0
23	40452660	.	A	T	8	4	12	0	0	12	0	0
23	40452667	.	T	C	7	4	11	0	1	12	0	0
23	40452735	.	G	T	7	6	13	0	1	14	0	0
23	40452739	.	G	C	3	7	10	0	6	16	0	0
23	40452793	.	A	G	7	4	11	0	0	11	0	0
23	40462004	.	A	G	11	3	14	0	0	14	0	0
23	40462538	.	G	A	10	10	20	0	1	21	0	0
23	40466320	.	C	T	9	7	16	0	0	16	0	0
23	40466623	.	C	G	8	8	16	0	0	16	0	0
23	40466714	.	T	A	4	4	8	0	0	8	0	0
23	40471963	.	G	A	1	12	13	0	8	21	0	0
23	40472068	.	A	G	16	0	16	0	9	25	0	0
23	40480255	.	C	A	13	14	27	0	1	28	0	0
23	40480263	.	C	T	12	13	25	0	0	25	0	0
23	40526326	.	T	C	10	0	10	0	3	13	0	0
23	40526713	.	T	C	3	4	7	1	0	8	0	0
23	40526745	.	G	T	7	3	10	0	1	11	0	0
23	40526760	.	G	A	11	4	15	0	0	15	0	0
23	40526883	.	T	G	9	1	10	1	0	11	0	0
23	40527174	.	A	T	6	2	8	0	0	8	0	0
23	40527205	.	C	T	7	2	9	0	0	9	0	0
23	40527359	.	T	C	6	0	6	0	6	12	0	0
23	40527425	.	C	T	1	3	4	0	3	7	0	0
23	40527427	.	A	C	4	0	4	0	3	7	0	0
23	40527556	.	C	G	1	2	3	1	0	4	0	0
23	40527583	.	G	A	3	3	6	3	0	9	0	0
23	40527632	.	G	A	10	4	14	5	0	19	0	0
23	40527653	.	T	G	9	4	13	3	0	16	0	0
23	40527759	.	G	T	6	4	10	1	0	11	0	0
23	40528019	.	C	T	3	3	6	1	0	7	0	0
23	40528209	.	C	T	5	4	9	0	0	9	0	0
23	40528226	.	G	C	3	4	7	1	0	8	0	0
23	40528669	.	C	T	1	6	7	0	12	19	0	0
23	40528727	.	G	A	5	15	20	0	0	20	0	0
23	40528886	.	T	A	9	10	19	0	1	20	0	0
23	40528998	.	G	A	9	14	23	0	0	23	0	0
23	40529137	.	T	C	6	9	15	0	0	15	0	0
23	40529288	.	T	C	10	5	15	0	0	15	0	0
23	40529318	.	A	G	5	8	13	0	0	13	0	0
23	40529693	.	T	C	6	7	13	0	0	13	0	0
23	40529708	.	T	C	6	3	9	0	1	10	0	0
23	40605356	.	C	T	1	3	4	0	0	4	0	0
23	40731713	.	G	A	1	4	5	0	2	7	0	0
23	40731757	.	A	G	3	3	6	0	0	6	0	0
23	40738508	.	A	G	1	2	3	0	0	3	0	0
23	40741673	.	A	G	2	5	7	0	0	7	0	0
23	40741765	.	C	T	4	5	9	0	0	9	0	0
23	40742133	.	G	C	12	4	16	0	1	17	0	0
23	40742234	.	C	A	6	8	14	0	1	15	0	0
23	40761073	.	T	A	9	6	15	0	0	15	0	0
23	40761326	.	T	A	8	5	13	0	2	15	0	0
23	40872777	.	T	A	1	2	3	0	0	3	0	0
23	40876907	.	G	T	1	2	3	0	0	3	0	0
23	40962864	.	G	T	3	2	5	0	0	5	0	0
23	41227092	.	T	C	1	3	4	0	0	4	0	0
23	41227146	.	C	G	1	0	1	0	2	3	0	0
23	41228903	.	T	G	1	2	3	0	0	3	0	0
23	41229119	.	C	T	3	3	6	0	0	6	0	0
23	41229152	.	C	T	1	2	3	0	0	3	0	0
23	41313116	.	G	C	8	7	15	0	0	15	0	0
23	41320957	.	G	A	5	2	7	0	0	7	0	0
23	41334628	.	T	C	1	2	3	0	0	3	0	0
23	41346686	.	G	A	0	1	1	0	2	3	0	0
23	41381026	.	A	C	1	3	4	0	0	4	0	0
23	41739874	.	C	A	6	3	9	0	0	9	0	0
23	41799849	.	C	A	10	4	14	0	0	14	0	0
23	41801492	.	C	T	15	13	28	0	3	31	0	0
23	41801555	.	G	A	15	12	27	0	1	28	0	0
23	41801940	.	G	T	16	14	30	0	0	30	0	0
23	41802130	.	T	G	9	12	21	0	0	21	0	0
23	41803017	.	G	A	1	6	7	0	0	7	0	0
23	41803124	.	G	T	4	12	16	0	2	18	0	0
23	41803160	.	C	T	5	8	13	0	0	13	0	0
23	41803217	.	T	C	4	0	4	0	9	13	0	0
23	41803447	.	G	A	4	5	9	0	1	10	0	0
23	41803473	.	A	G	3	8	11	0	0	11	0	0
23	41803672	.	C	T	3	2	5	0	0	5	0	0
23	41803740	.	A	G	4	7	11	0	0	11	0	0
23	41804039	.	A	G	4	4	8	0	0	8	0	0
23	41804151	.	A	G	5	2	7	0	0	7	0	0
23	41804202	.	T	A	2	6	8	0	0	8	0	0
23	41804326	.	C	A	1	3	4	0	0	4	0	0
23	41804340	.	A	T	1	3	4	0	0	4	0	0
23	41804518	.	A	C	2	7	9	0	1	10	0	0
23	41804600	.	T	A	2	11	13	0	0	13	0	0
23	41804776	.	G	C	3	3	6	0	0	6	0	0
23	41804779	.	A	T	3	3	6	0	0	6	0	0
23	41804934	.	A	C	1	0	1	0	5	6	0	0
23	41805158	.	C	T	5	4	9	0	1	10	0	0
23	41805348	.	G	A	6	10	16	0	0	16	0	0
23	41808038	.	G	A	1	5	6	0	0	6	0	0
23	41821117	.	G	C	2	2	4	0	0	4	0	0
23	41831305	.	T	A	7	14	21	0	2	23	0	0
23	41831306	.	C	T	7	15	22	0	1	23	0	0
23	41839373	.	G	A	0	8	8	0	13	21	0	0
23	41853782	.	T	C	4	11	15	0	0	15	0	0
23	41854025	.	C	A	8	5	13	0	0	13	0	0
23	41854030	.	C	A	8	5	13	0	0	13	0	0
23	41854068	.	G	T	6	6	12	0	1	13	0	0
23	41949585	.	A	C	2	3	5	0	0	5	0	0
23	41949703	.	G	A	3	2	5	0	0	5	0	0
23	41949748	.	T	G	4	7	11	0	1	12	0	0
23	41949751	.	A	G	5	7	12	0	0	12	0	0
23	41964709	.	G	A	4	2	6	0	0	6	0	0
23	41983318	.	C	A	1	2	3	0	0	3	0	0
23	42642926	.	A	G	3	2	5	0	0	5	0	0
23	43508141	.	A	G	3	2	5	0	0	5	0	0
23	43508171	.	T	C	2	3	5	0	0	5	0	0
23	43508198	.	A	G	1	0	1	0	2	3	0	0
23	43508261	.	G	A	0	3	3	0	1	4	0	0
23	43517458	.	A	G	2	4	6	0	1	7	0	0
23	43519354	.	C	G	3	2	5	0	0	5	0	0
23	43519414	.	G	A	4	2	6	0	0	6	0	0
23	43530633	.	T	C	1	3	4	0	0	4	0	0
23	43543158	.	A	G	1	3	4	0	0	4	0	0
23	43543197	.	A	G	1	2	3	0	0	3	0	0
23	43652306	.	G	C	6	5	11	0	0	11	0	0
23	43652590	.	T	C	2	7	9	0	0	9	0	0
23	43652831	.	G	C	2	3	5	0	0	5	0	0
23	43652901	.	C	G	4	2	6	1	0	7	0	0
23	43688078	.	C	T	1	3	4	0	0	4	0	0
23	43688291	.	T	C	3	2	5	0	1	6	0	0
23	43688361	.	A	T	1	2	3	0	0	3	0	0
23	43688364	.	A	T	2	2	4	0	0	4	0	0
23	43688409	.	A	T	2	2	4	0	0	4	0	0
23	43688730	.	G	A	1	4	5	0	0	5	0	0
23	43688737	.	G	A	1	5	6	0	0	6	0	0
23	43688805	.	C	T	2	4	6	0	0	6	0	0
23	43688810	.	T	C	1	4	5	0	1	6	0	0
23	43688852	.	C	G	2	4	6	0	1	7	0	0
23	43688959	.	C	G	4	3	7	0	0	7	0	0
23	43689729	.	G	A	2	4	6	0	0	6	0	0
23	43690144	.	T	C	3	4	7	0	0	7	0	0
23	43690361	.	T	C	4	2	6	0	1	7	0	0
23	43690490	.	A	G	4	5	9	0	0	9	0	0
23	43690622	.	G	C	4	7	11	0	0	11	0	0
23	43690625	.	T	G	3	6	9	0	0	9	0	0
23	43690715	.	T	C	2	6	8	0	0	8	0	0
23	43690838	.	A	G	1	3	4	0	0	4	0	0
23	43690913	.	T	G	2	5	7	0	0	7	0	0
23	43691069	.	G	A	1	3	4	0	0	4	0	0
23	43691515	.	C	T	3	5	8	0	0	8	0	0
23	43691528	.	C	T	3	4	7	0	0	7	0	0
23	43691770	.	T	C	1	3	4	0	0	4	0	0
23	43695927	.	C	A	1	5	6	0	10	16	0	0
23	43695956	.	C	T	1	8	9	0	13	22	0	0
23	43696355	.	G	A	21	21	42	0	2	44	0	0
23	43699846	.	A	G	24	22	46	0	0	46	0	0
23	43700064	.	T	C	12	0	12	0	20	32	0	0
23	43700082	.	C	G	12	22	34	0	0	34	0	0
23	43700114	.	G	A	14	17	31	0	1	32	0	0
23	43700121	.	G	A	15	18	33	0	1	34	0	0
23	43705961	.	G	T	18	18	36	0	2	38	0	0
23	43706003	.	A	G	22	19	41	0	0	41	0	0
23	43706102	.	T	G	17	16	33	0	2	35	0	0
23	43707165	.	C	T	8	10	18	0	2	20	0	0
23	43718042	.	C	A	1	7	8	0	1	9	0	0
23	43723615	.	G	A	11	11	22	0	1	23	0	0
23	43770583	.	C	A	8	6	14	0	2	16	0	0
23	43770667	.	A	G	4	0	4	0	7	11	0	0
23	43770682	.	T	C	5	7	12	0	0	12	0	0
23	43770715	.	C	T	5	7	12	0	1	13	0	0
23	43770832	.	T	C	8	8	16	0	1	17	0	0
23	43778396	.	T	G	5	9	14	0	2	16	0	0
23	43780214	.	C	T	11	8	19	0	2	21	0	0
23	43781781	.	C	T	5	8	13	0	1	14	0	0
23	43784985	.	C	T	5	10	15	0	1	16	0	0
23	43799699	.	T	C	1	2	3	0	0	3	0	0
23	43799798	.	A	C	2	3	5	0	0	5	0	0
23	43799835	.	A	G	1	0	1	0	3	4	0	0
23	43800594	.	C	T	2	2	4	0	0	4	0	0
23	43800621	.	G	C	0	3	3	0	2	5	0	0
23	43800983	.	G	A	3	2	5	0	0	5	0	0
23	43801018	.	A	G	2	0	2	0	3	5	0	0
23	43801284	.	C	G	4	3	7	0	0	7	0	0
23	43801536	.	A	G	0	0	0	0	3	3	0	0
23	43801569	.	T	G	1	2	3	0	0	3	0	0
23	43889641	.	T	C	6	3	9	0	0	9	0	0
23	43898075	.	C	T	3	4	7	0	0	7	0	0
23	43898097	.	A	C	1	4	5	0	0	5	0	0
23	43928824	.	A	G	2	3	5	0	0	5	0	0
23	43989294	.	C	T	1	6	7	0	0	7	0	0
23	44090326	.	T	A	14	10	24	0	1	26	1	0
23	44092839	.	T	A	17	19	36	0	1	37	0	0
23	44096060	.	A	G	9	0	9	0	9	18	0	0
23	44098511	.	A	G	21	9	30	0	1	31	0	0
23	44098517	.	C	T	18	9	27	0	3	30	0	0
23	44102199	.	G	T	21	9	30	0	2	32	0	0
23	44106540	.	C	T	26	26	52	0	2	54	0	0
23	44106591	.	G	C	19	29	48	0	0	48	0	0
23	44106860	.	G	A	7	5	12	1	11	24	0	0
23	44107138	.	C	T	13	11	24	0	3	27	0	0
23	44236361	.	G	T	2	2	4	0	0	4	0	0
23	44236388	.	A	T	3	3	6	0	0	6	0	0
23	44236673	.	C	T	4	8	12	0	0	12	0	0
23	44236750	.	T	A	5	7	12	0	1	13	0	0
23	44237158	.	A	C	8	5	13	0	1	14	0	0
23	44237416	.	T	C	8	3	11	0	1	12	0	0
23	44237531	.	G	T	10	9	19	0	1	20	0	0
23	44237611	.	G	C	2	20	22	0	14	36	0	0
23	44237701	.	C	A	13	9	22	0	0	22	0	0
23	44238125	.	G	T	11	7	18	0	0	18	0	0
23	44238186	.	C	T	8	9	17	0	0	17	0	0
23	44242535	.	A	C	7	13	20	0	0	20	0	0
23	44242608	.	T	C	15	9	24	0	1	25	0	0
23	44250638	.	A	G	4	0	4	0	9	13	0	0
23	44250702	.	C	A	8	6	14	0	0	14	0	0
23	44250736	.	C	T	11	8	19	0	0	19	0	0
23	44308088	.	G	A	18	11	29	0	0	29	0	0
23	44312611	.	G	A	2	17	19	0	11	30	0	0
23	44313190	.	G	C	8	14	22	0	0	22	0	0
23	44328488	.	G	A	23	20	43	1	2	46	0	0
23	44328557	.	C	T	17	17	34	0	2	36	0	0
23	44332614	.	C	T	12	18	30	0	8	38	0	0
23	44332617	.	C	T	22	14	36	0	1	37	0	0
23	44332675	.	C	T	21	10	31	4	2	38	1	0
23	44400965	.	C	T	2	4	6	0	1	7	0	0
23	44428067	.	A	C	17	12	29	0	0	29	0	0
23	44430544	.	C	T	14	19	33	0	0	33	0	0
23	44432608	.	C	T	16	14	30	0	1	31	0	0
23	44440421	.	G	A	11	5	16	0	0	16	0	0
23	44440489	.	C	T	7	15	22	0	1	23	0	0
23	44478131	.	A	G	12	16	28	0	2	30	0	0
23	44487465	.	C	G	12	12	24	0	0	24	0	0
23	44487521	.	A	G	11	10	21	0	0	21	0	0
23	44489428	.	A	C	4	1	5	0	8	13	0	0
23	44489449	.	C	T	2	4	6	0	7	13	0	0
23	44515717	.	C	T	2	3	5	0	0	5	0	0
23	44515735	.	T	A	2	2	4	0	0	4	0	0
23	44517743	.	G	C	1	3	4	0	0	5	1	0
23	44517792	.	C	A	2	3	5	0	0	5	0	0
23	44518479	.	G	A	1	4	5	0	0	5	0	0
23	44518668	.	A	T	2	3	5	0	0	5	0	0
23	44519149	.	A	T	6	3	9	0	0	9	0	0
23	44519175	.	A	G	2	6	8	0	0	8	0	0
23	44519381	.	T	G	1	0	1	0	3	4	0	0
23	44521074	.	G	T	2	5	7	0	0	7	0	0
23	44521330	.	A	G	6	7	13	0	1	14	0	0
23	44521495	.	G	A	10	6	16	0	1	17	0	0
23	44521516	.	A	C	9	4	13	0	2	15	0	0
23	44521676	.	C	T	6	7	13	0	0	13	0	0
23	44521721	.	T	G	7	5	12	0	0	12	0	0
23	44521725	.	G	C	5	3	8	0	2	10	0	0
23	44537383	.	G	A	2	3	5	0	0	5	0	0
23	44546116	.	G	A	1	2	3	0	0	3	0	0
23	44550446	.	G	A	9	12	21	0	1	22	0	0
23	44603710	.	T	C	11	11	22	0	0	22	0	0
23	44603912	.	G	A	4	5	9	0	1	10	0	0
23	44603990	.	C	G	5	5	10	0	0	10	0	0
23	44617600	.	T	C	3	2	5	0	1	6	0	0
23	44620750	.	C	T	6	7	13	0	2	15	0	0
23	44620911	.	C	T	8	7	15	0	1	16	0	0
23	44622736	.	T	C	4	13	17	0	0	17	0	0
23	44652616	.	C	A	2	2	4	1	1	6	0	0
23	44652697	.	T	G	3	2	5	0	0	5	0	0
23	44652702	.	T	A	2	3	5	0	0	5	0	0
23	44652877	.	A	G	7	8	15	0	0	15	0	0
23	44653259	.	A	T	5	10	15	0	1	16	0	0
23	44653647	.	A	G	8	0	8	0	5	13	0	0
23	44732976	.	G	A	27	21	48	0	5	53	0	0
23	44755296	.	T	C	35	26	61	0	5	66	0	0
23	44761680	.	G	C	12	26	38	0	1	39	0	0
23	44762190	.	T	C	21	36	57	0	3	60	0	0
23	44850211	.	A	T	1	4	5	0	2	7	0	0
23	44862985	.	G	A	1	3	4	0	0	4	0	0
23	44975073	.	G	A	5	5	10	0	1	11	0	0
23	44975079	.	G	T	6	6	12	0	0	12	0	0
23	44975489	.	G	A	2	4	6	0	0	6	0	0
23	44975542	.	G	A	5	2	7	0	0	7	0	0
23	44975547	.	G	C	5	3	8	0	0	8	0	0
23	44979814	.	G	A	1	3	4	0	0	4	0	0
23	44979861	.	C	T	3	4	7	0	0	7	0	0
23	44979987	.	C	T	1	4	5	0	0	5	0	0
23	44980002	.	G	T	1	3	4	0	0	4	0	0
23	44994074	.	T	C	4	0	4	0	3	7	0	0
23	44994077	.	C	A	4	3	7	0	0	7	0	0
23	44995961	.	C	T	5	3	8	0	0	8	0	0
23	44995974	.	T	C	5	2	7	0	0	7	0	0
23	45012640	.	C	G	2	2	4	0	1	5	0	0
23	45018630	.	G	A	1	2	3	0	0	3	0	0
23	45021218	.	G	A	1	2	3	0	0	3	0	0
23	45025952	.	A	G	23	11	34	0	1	35	0	0
23	45027911	.	C	T	30	21	51	0	4	55	0	0
23	45028191	.	T	C	26	27	53	0	0	53	0	0
23	45028248	.	C	T	35	22	57	0	3	60	0	0
23	45043654	.	G	A	7	4	11	0	1	12	0	0
23	46003346	.	T	C	5	2	7	0	0	7	0	0
24	20740	.	C	G	3	0	3	0	2	5	0	0
24	24470	.	T	C	2	3	5	0	0	5	0	0
24	24473	.	C	T	2	3	5	0	0	5	0	0
24	24765	.	A	T	4	5	9	0	0	9	0	0
24	26103	.	C	T	3	6	9	0	0	9	0	0
24	44306	.	C	T	8	12	20	0	0	20	0	0
24	139014	.	A	G	1	0	1	0	2	3	0	0
24	145697	.	A	C	3	3	6	0	0	6	0	0
24	166969	.	T	G	4	6	10	0	1	11	0	0
24	167149	.	A	T	5	17	22	0	0	22	0	0
24	167177	.	A	G	7	14	21	0	2	23	0	0
24	174353	.	A	G	9	0	9	0	11	20	0	0
24	178693	.	G	A	10	11	21	0	2	23	0	0
24	184800	.	A	G	16	1	17	0	21	38	0	0
24	184818	.	C	T	20	21	41	0	0	41	0	0
24	187371	.	T	A	12	13	25	0	3	28	0	0
24	187414	.	T	A	9	13	22	0	0	22	0	0
24	187686	.	T	A	14	7	21	1	2	24	0	0
24	187811	.	A	T	7	4	11	0	1	12	0	0
24	187971	.	A	G	2	4	6	0	0	6	0	0
24	188155	.	C	G	7	6	13	0	0	13	0	0
24	188191	.	T	A	9	6	15	0	1	16	0	0
24	188363	.	G	A	21	10	31	0	1	32	0	0
24	188382	.	G	A	2	16	18	0	15	33	0	0
24	188423	.	T	C	8	23	31	0	1	32	0	0
24	188425	.	A	T	7	22	29	0	2	32	1	0
24	188464	.	T	C	8	24	32	0	3	35	0	0
24	196679	.	G	A	8	7	15	0	1	16	0	0
24	197062	.	C	T	4	8	12	0	0	12	0	0
24	197072	.	C	T	1	8	9	0	3	12	0	0
24	788327	.	A	G	2	4	6	0	0	6	0	0
24	788343	.	A	G	6	4	10	0	1	11	0	0
24	788409	.	A	G	7	0	7	0	8	15	0	0
24	788419	.	A	G	9	0	9	0	4	13	0	0
24	945526	.	C	T	2	6	8	0	11	19	0	0
24	945537	.	G	A	8	6	14	0	4	18	0	0
24	947729	.	G	C	20	9	29	0	0	29	0	0
24	948056	.	T	C	8	3	11	0	12	23	0	0
24	948351	.	T	A	8	14	22	0	0	22	0	0
24	948360	.	A	G	10	8	18	0	2	20	0	0
24	948571	.	G	A	11	10	21	0	0	21	0	0
24	948609	.	G	T	5	9	14	0	6	20	0	0
24	948729	.	G	A	11	12	23	0	4	27	0	0
24	948848	.	C	T	1	3	4	0	12	16	0	0
24	948868	.	T	C	9	4	13	0	1	14	0	0
24	975123	.	G	A	2	4	6	0	0	6	0	0
24	977655	.	G	A	4	7	11	0	1	12	0	0
24	985438	.	A	C	9	8	17	0	0	17	0	0
24	985740	.	C	G	9	9	18	0	0	18	0	0
24	985748	.	G	A	9	6	15	0	1	16	0	0
24	988274	.	G	A	11	8	19	0	0	19	0	0
24	988810	.	G	A	4	5	9	0	1	10	0	0
24	1000040	.	A	G	6	7	13	0	0	13	0	0
24	1000112	.	G	A	8	7	15	0	0	15	0	0
24	1003494	.	C	T	1	12	13	0	6	19	0	0
24	1003551	.	C	A	0	10	10	0	8	18	0	0
24	1003596	.	G	A	7	5	12	0	0	12	0	0
24	1009978	.	A	C	6	0	6	0	3	9	0	0
24	1010347	.	G	T	1	5	6	0	0	6	0	0
24	1011786	.	A	G	5	3	8	0	0	8	0	0
24	1011823	.	A	G	3	3	6	0	0	6	0	0
24	1012020	.	C	T	3	3	6	0	0	6	0	0
24	1013142	.	G	A	4	3	7	0	0	7	0	0
24	1013303	.	G	A	2	4	6	0	0	6	0	0
24	1013359	.	G	C	3	6	9	0	0	9	0	0
24	1013375	.	A	T	0	5	5	0	0	6	1	0
24	1013799	.	C	A	2	3	5	0	0	5	0	0
24	1014927	.	G	A	0	3	3	0	1	4	0	0
24	1015029	.	C	T	2	4	6	0	6	12	0	0
24	1022962	.	G	A	3	2	5	3	0	8	0	0
24	1110150	.	T	C	6	4	10	0	0	10	0	0
24	1110152	.	T	A	6	3	9	0	1	10	0	0
24	1110325	.	C	A	4	12	16	0	0	16	0	0
24	1111164	.	T	C	0	5	5	0	1	6	0	0
24	1111175	.	T	C	1	3	4	0	2	6	0	0
24	1111453	.	T	A	2	3	5	0	1	6	0	0
24	1111469	.	C	T	0	4	4	0	2	6	0	0
24	1112337	.	A	G	1	2	3	0	0	3	0	0
24	1112547	.	C	G	0	3	3	0	1	4	0	0
24	1112972	.	T	G	2	2	4	0	0	4	0	0
24	1113121	.	A	G	1	2	3	0	0	3	0	0
24	1119112	.	G	A	1	1	2	0	1	3	0	0
24	1162622	.	T	A	10	13	23	0	1	24	0	0
24	1163061	.	G	A	18	12	30	0	0	30	0	0
24	1163184	.	A	G	23	16	39	0	1	40	0	0
24	1165088	.	G	C	19	8	27	0	1	28	0	0
24	1166957	.	G	A	14	10	24	0	0	24	0	0
24	1166975	.	T	C	12	11	23	0	3	26	0	0
24	1167263	.	G	A	12	14	26	0	0	26	0	0
24	1167338	.	C	T	2	13	15	0	12	27	0	0
24	1167413	.	A	G	18	11	29	0	2	31	0	0
24	1167496	.	G	A	10	12	22	0	1	23	0	0
24	1169291	.	C	T	0	15	15	0	13	28	0	0
24	1177074	.	T	A	9	16	25	1	3	29	0	0
24	1185142	.	G	A	7	6	13	0	0	13	0	0
24	1185225	.	G	T	9	5	14	0	0	14	0	0
24	1185271	.	G	A	8	8	16	0	1	17	0	0
24	1185374	.	G	C	9	7	16	0	0	16	0	0
24	1195775	.	C	T	7	8	15	0	1	16	0	0
24	1203471	.	A	T	3	6	9	0	1	10	0	0
24	1221280	.	C	T	0	10	10	0	12	22	0	0
24	1229571	.	A	G	10	5	15	0	0	15	0	0
24	1303660	.	G	T	4	3	7	0	0	7	0	0
24	1303892	.	A	G	8	7	15	0	0	15	0	0
24	1398248	.	A	T	4	3	7	0	0	7	0	0
24	2284197	.	G	C	18	18	36	0	2	38	0	0
24	2284279	.	C	T	3	21	24	0	12	36	0	0
24	2284456	.	A	T	18	16	34	0	3	37	0	0
24	2284458	.	G	A	20	18	38	0	0	38	0	0
24	2284526	.	T	C	13	1	14	0	16	30	0	0
24	2284647	.	C	T	1	18	19	0	12	31	0	0
24	2287254	.	C	G	11	15	26	0	0	26	0	0
24	2289991	.	C	T	2	8	10	0	13	23	0	0
24	2293360	.	G	A	10	7	17	0	0	17	0	0
24	2297093	.	T	A	8	6	14	0	0	14	0	0
24	2297117	.	A	G	4	6	10	0	1	11	0	0
24	2303778	.	G	A	4	9	13	0	1	14	0	0
24	2303784	.	C	T	10	5	15	0	0	15	0	0
24	2334247	.	C	T	3	2	5	0	0	5	0	0
24	2340379	.	C	T	4	9	13	0	0	13	0	0
24	2340671	.	A	T	6	2	8	0	0	8	0	0
24	2346825	.	A	T	1	2	3	0	2	5	0	0
24	2346826	.	A	T	1	3	4	0	1	5	0	0
24	2347721	.	T	G	1	2	3	0	0	3	0	0
24	2524848	.	C	A	32	28	60	0	1	61	0	0
24	2524868	.	C	T	34	24	58	0	6	64	0	0
24	2524903	.	A	T	27	23	50	0	3	53	0	0
24	2558354	.	G	A	4	3	7	0	1	8	0	0
24	2637790	.	G	A	2	4	6	0	2	8	0	0
24	2642517	.	G	A	2	2	4	0	0	4	0	0
24	2684208	.	A	G	2	3	5	0	0	5	0	0
24	2684314	.	C	T	2	2	4	0	0	4	0	0
24	2684417	.	C	T	0	3	3	0	2	5	0	0
24	2684455	.	A	G	3	3	6	0	0	6	0	0
24	2684481	.	G	A	5	2	7	0	0	7	0	0
24	2762780	.	C	A	8	6	14	0	0	14	0	0
24	2762782	.	G	A	1	6	7	0	7	14	0	0
24	2821435	.	G	A	7	12	19	1	0	20	0	0
24	2836451	.	C	A	1	3	4	0	1	5	0	0
24	2836452	.	A	G	2	2	4	0	1	5	0	0
24	2891081	.	T	C	2	0	2	0	4	6	0	0
24	2891146	.	G	A	2	3	5	0	0	5	0	0
24	2891187	.	T	G	5	3	8	0	0	8	0	0
24	2891188	.	A	T	5	2	7	0	1	8	0	0
24	2891258	.	A	G	3	3	6	0	0	6	0	0
24	2891263	.	T	C	2	3	5	0	1	6	0	0
24	2891326	.	C	A	1	2	3	0	0	3	0	0
24	2892587	.	C	A	3	3	6	0	1	7	0	0
24	2892688	.	G	T	9	8	17	0	0	17	0	0
24	2892951	.	T	C	8	6	14	0	1	15	0	0
24	2893003	.	A	T	14	4	18	0	0	18	0	0
24	2893056	.	T	G	3	6	9	0	1	10	0	0
24	2893175	.	C	G	5	3	8	0	0	8	0	0
24	2893342	.	T	C	3	2	5	0	1	6	0	0
24	2917174	.	A	T	2	3	5	0	0	5	0	0
24	2961142	.	C	G	2	9	11	0	0	11	0	0
24	2963066	.	C	G	3	7	10	0	0	10	0	0
24	2964809	.	C	T	7	3	10	0	0	10	0	0
24	2966557	.	C	T	9	9	18	0	0	18	0	0
24	2971595	.	T	C	19	10	29	0	1	30	0	0
24	2971684	.	A	G	14	14	28	0	0	28	0	0
24	2971747	.	G	T	12	11	23	0	1	24	0	0
24	2971890	.	A	G	7	6	13	0	2	15	0	0
24	3059710	.	C	T	3	6	9	0	0	9	0	0
24	3060871	.	C	T	2	1	3	0	1	4	0	0
24	3060896	.	C	T	2	1	3	0	2	6	1	0
24	3061408	.	A	G	4	0	4	0	3	7	0	0
24	3312555	.	T	C	2	2	4	0	0	4	0	0
24	3328397	.	C	G	9	12	21	0	0	21	0	0
24	3328473	.	A	T	5	5	10	0	0	10	0	0
24	3328532	.	T	C	8	5	13	0	1	14	0	0
24	3333539	.	A	G	4	5	9	0	0	9	0	0
24	3333940	.	G	A	7	5	12	0	0	12	0	0
24	3335963	.	G	A	0	6	6	0	10	16	0	0
24	3336199	.	C	T	12	8	20	0	1	21	0	0
24	3336236	.	G	A	0	9	9	0	10	19	0	0
24	3348012	.	G	T	10	5	15	0	0	15	0	0
24	3348503	.	C	T	0	12	12	0	13	25	0	0
24	3348530	.	C	T	13	6	19	0	1	20	0	0
24	3350081	.	T	C	8	0	8	0	6	14	0	0
24	3350639	.	A	G	9	4	13	0	0	13	0	0
24	3350732	.	A	G	1	5	6	0	1	7	0	0
24	3374783	.	G	A	5	4	9	0	0	9	0	0
24	3470405	.	T	C	3	3	6	0	0	6	0	0
24	3471076	.	T	C	4	2	6	0	0	6	0	0
24	3471183	.	T	C	7	3	10	0	2	12	0	0
24	3471272	.	T	C	9	3	12	0	0	12	0	0
24	3471342	.	T	C	9	5	14	0	0	14	0	0
24	3471477	.	T	C	4	3	7	1	0	8	0	0
24	3623954	.	G	A	1	1	2	0	1	3	0	0
24	3623984	.	C	T	1	3	4	0	0	4	0	0
24	3783180	.	G	A	1	2	3	0	0	3	0	0
24	3963803	.	G	A	7	6	13	0	0	13	0	0
24	3972295	.	C	T	19	22	41	0	2	43	0	0
24	3983324	.	G	A	28	26	54	0	3	57	0	0
24	3990337	.	G	A	4	25	29	0	27	56	0	0
24	4000242	.	C	T	23	31	54	0	3	57	0	0
24	4000308	.	T	C	35	28	63	0	2	65	0	0
24	4000323	.	C	T	24	29	53	0	4	57	0	0
24	4002905	.	C	G	24	33	57	0	2	59	0	0
24	4002966	.	A	G	24	26	50	0	2	52	0	0
24	4002997	.	C	T	34	19	53	0	2	55	0	0
24	4003172	.	C	T	24	27	51	0	2	53	0	0
24	4003533	.	C	T	36	41	77	0	1	78	0	0
24	4003559	.	G	A	29	43	72	0	3	75	0	0
24	4003598	.	C	T	10	53	63	0	2	65	0	0
24	4003693	.	A	C	38	27	65	0	5	70	0	0
24	4003782	.	C	A	39	22	61	0	1	62	0	0
24	4003800	.	T	C	31	29	60	0	2	62	0	0
24	4003842	.	G	A	29	17	46	3	3	52	0	0
24	4003947	.	G	A	6	24	30	0	21	51	0	0
24	4003978	.	G	A	17	26	43	0	2	45	0	0
24	4004041	.	C	A	5	18	23	0	0	23	0	0
24	4004046	.	G	C	6	20	26	0	0	26	0	0
24	4142777	.	C	T	0	4	4	0	6	10	0	0
24	4142856	.	C	T	7	8	15	0	0	15	0	0
24	4142898	.	T	C	5	12	17	0	1	18	0	0
24	4143517	.	T	A	6	7	13	0	2	15	0	0
24	4412690	.	G	A	0	3	3	0	5	8	0	0
24	4412717	.	C	T	2	3	5	0	0	5	0	0
24	4417793	.	G	A	4	4	8	0	0	8	0	0
24	4421183	.	C	T	2	4	6	0	0	6	0	0
24	4447935	.	T	A	9	3	12	0	0	12	0	0
24	4448608	.	T	C	2	4	6	0	1	7	0	0
24	4449939	.	C	A	3	2	5	0	0	5	0	0
24	4450011	.	G	A	1	2	3	0	0	3	0	0
24	4450161	.	C	T	3	5	8	0	1	9	0	0
24	4970956	.	T	C	23	26	49	0	2	51	0	0
24	4971126	.	G	T	37	24	61	0	11	72	0	0
24	4972735	.	G	A	31	20	51	0	5	56	0	0
24	4981740	.	G	A	13	17	30	0	0	30	0	0
24	5210628	.	G	A	10	14	24	0	1	25	0	0
24	5213008	.	G	T	6	4	10	0	0	10	0	0
24	5653468	.	C	T	3	2	5	0	0	5	0	0
24	5996942	.	A	T	15	6	21	0	3	24	0	0
24	5996996	.	G	A	18	5	23	0	1	24	0	0
24	6002538	.	C	G	16	0	16	0	16	32	0	0
24	6002628	.	T	C	17	11	28	0	1	29	0	0
24	6008674	.	G	A	10	11	21	0	0	21	0	0
24	6010450	.	C	T	9	7	16	0	0	16	0	0
24	6010598	.	G	A	1	4	5	0	8	13	0	0
24	6010770	.	C	T	8	8	16	0	1	17	0	0
24	6010801	.	G	A	9	8	17	0	1	18	0	0
24	6010830	.	A	T	6	4	10	0	0	10	0	0
24	6010912	.	C	T	3	3	6	0	0	6	0	0
24	6010942	.	T	C	2	4	6	0	0	6	0	0
24	6011154	.	A	T	5	2	7	0	0	7	0	0
24	6012026	.	A	T	2	2	4	0	0	4	0	0
24	6012031	.	A	T	3	2	5	0	0	5	0	0
24	6012374	.	T	C	11	13	24	0	0	24	0	0
24	6012381	.	T	C	10	14	24	0	0	24	0	0
24	6012499	.	T	A	7	11	18	0	0	18	0	0
24	6012535	.	T	A	9	6	15	0	1	16	0	0
24	6012540	.	A	T	9	7	16	0	0	16	0	0
24	6012662	.	G	A	6	5	11	0	1	12	0	0
24	6016749	.	A	C	6	4	10	0	0	10	0	0
24	6018727	.	C	T	7	3	10	0	1	11	0	0
24	6018908	.	C	T	3	5	8	0	0	8	0	0
24	6021001	.	G	A	6	6	12	0	0	12	0	0
24	6021022	.	G	C	5	0	5	0	4	9	0	0
24	6021277	.	T	C	6	1	7	0	4	11	0	0
24	6024303	.	A	C	4	0	4	0	4	8	0	0
24	6024355	.	C	T	3	5	8	0	0	8	0	0
24	6024366	.	T	C	4	6	10	0	0	10	0	0
24	6024401	.	A	T	4	5	9	0	0	9	0	0
24	6024411	.	C	A	0	3	3	0	4	7	0	0
24	6134324	.	T	G	27	46	73	0	1	74	0	0
24	6134456	.	C	T	5	44	49	0	24	73	0	0
24	6134881	.	C	T	29	18	47	0	0	47	0	0
24	6134888	.	C	G	2	22	24	0	26	50	0	0
24	6134946	.	A	T	27	21	48	0	0	48	0	0
24	6135002	.	A	G	20	38	58	0	3	61	0	0
24	6135100	.	A	T	17	34	51	0	0	51	0	0
24	6135118	.	A	G	15	33	48	0	3	51	0	0
24	6135375	.	A	C	27	28	55	0	1	56	0	0
24	6135701	.	G	A	29	22	51	0	2	53	0	0
24	6136089	.	T	G	6	6	12	0	3	15	0	0
24	6136243	.	T	G	6	9	15	0	1	16	0	0
24	6136414	.	A	T	11	3	14	0	1	15	0	0
24	6136415	.	A	T	11	4	15	1	0	16	0	0
24	6136714	.	T	A	16	26	42	0	2	44	0	0
24	6137061	.	C	T	1	21	22	0	8	30	0	0
24	6137622	.	C	T	3	28	31	0	34	65	0	0
24	6153202	.	C	T	1	26	27	0	25	52	0	0
24	6153515	.	A	G	23	28	51	0	5	56	0	0
24	6155751	.	T	C	18	0	18	0	25	43	0	0
24	6157154	.	G	A	21	22	43	0	0	43	0	0
24	6157832	.	A	G	21	28	49	0	1	50	0	0
24	6158835	.	C	A	16	13	29	0	1	30	0	0
24	6158868	.	C	T	10	11	21	0	0	21	0	0
24	6162256	.	C	T	0	3	3	0	1	4	0	0
24	6163129	.	T	G	1	2	3	0	0	3	0	0
24	6163130	.	C	A	1	2	3	0	0	3	0	0
24	6163718	.	A	G	4	2	6	0	0	6	0	0
24	6339629	.	G	A	5	2	7	0	1	8	0	0
24	6339714	.	G	T	5	9	14	0	0	14	0	0
24	6344909	.	G	A	6	6	12	0	0	12	0	0
24	6361523	.	C	G	1	2	3	0	0	3	0	0
24	6361525	.	A	G	1	1	2	0	1	3	0	0
24	6361637	.	T	A	2	2	4	0	0	4	0	0
24	6361639	.	G	A	2	2	4	0	0	4	0	0
24	6362079	.	G	C	13	1	14	0	7	21	0	0
24	6362116	.	T	C	18	9	27	1	1	29	0	0
24	6362123	.	A	C	9	16	25	1	0	27	1	0
24	6362609	.	A	T	19	12	31	0	0	31	0	0
24	6362688	.	T	C	12	17	29	0	0	29	0	0
24	6362730	.	T	C	10	15	25	0	1	26	0	0
24	6362791	.	C	A	9	9	18	0	0	18	0	0
24	6362801	.	G	A	9	9	18	0	1	19	0	0
24	6363502	.	G	A	17	23	40	0	2	42	0	0
24	6368235	.	G	A	15	16	31	0	0	31	0	0
24	6373660	.	A	G	17	8	25	0	0	25	0	0
24	6395401	.	G	A	4	3	7	0	0	7	0	0
24	6395655	.	G	A	9	6	15	0	0	15	0	0
24	6395734	.	T	C	7	4	11	0	0	11	0	0
24	6395838	.	G	T	8	4	12	0	0	12	0	0
24	6395877	.	G	A	3	6	9	0	0	9	0	0
24	6396137	.	C	G	6	10	16	0	0	16	0	0
24	6396198	.	T	A	9	11	20	0	0	20	0	0
24	6396720	.	A	G	8	3	11	0	0	11	0	0
24	6444204	.	C	T	0	2	2	0	3	5	0	0
24	6500411	.	C	T	1	3	4	0	0	4	0	0
24	6501024	.	T	C	4	3	7	0	0	7	0	0
24	6501044	.	C	T	3	3	6	0	1	7	0	0
24	6513857	.	A	T	11	11	22	0	1	23	0	0
24	6513996	.	G	A	7	8	15	0	0	15	0	0
24	6514012	.	C	T	8	5	13	0	1	14	0	0
24	6514117	.	T	C	13	8	21	0	0	21	0	0
24	6514263	.	T	G	14	16	30	0	0	30	0	0
24	6514882	.	A	T	6	8	14	0	0	14	0	0
24	6515019	.	C	T	1	8	9	0	14	23	0	0
24	6515245	.	G	A	10	10	20	0	0	20	0	0
24	6515327	.	G	A	13	13	26	0	0	26	0	0
24	6515364	.	A	T	16	12	28	0	1	29	0	0
24	6515499	.	A	G	6	5	11	0	2	13	0	0
24	6515519	.	T	C	6	0	6	0	10	16	0	0
24	6538447	.	T	C	7	0	7	0	8	15	0	0
24	6543068	.	A	G	4	4	8	0	0	8	0	0
24	6543443	.	G	A	7	3	10	0	2	12	0	0
24	6546364	.	A	C	4	8	12	0	1	13	0	0
24	6546749	.	C	T	1	5	6	0	4	10	0	0
24	6546841	.	G	A	7	12	19	0	1	20	0	0
24	6546863	.	T	C	9	0	9	0	13	22	0	0
24	6546909	.	T	C	7	0	7	0	5	12	0	0
24	6546999	.	T	C	6	2	8	0	0	8	0	0
24	6547020	.	T	C	5	1	6	0	1	7	0	0
24	6547278	.	A	G	3	4	7	0	0	7	0	0
24	6547727	.	G	A	5	4	9	0	0	9	0	0
24	6547812	.	C	T	4	10	14	0	0	14	0	0
24	6547890	.	C	G	3	8	11	0	0	11	0	0
24	6547956	.	A	G	5	2	7	0	2	9	0	0
24	6547958	.	A	T	5	3	8	0	0	8	0	0
24	6548027	.	C	T	1	2	3	0	5	8	0	0
24	6548064	.	T	C	7	0	7	0	3	10	0	0
24	7516020	.	A	G	1	0	1	0	1	2	0	0
24	7853944	.	T	C	1	4	5	0	0	5	0	0
24	7942731	.	T	C	1	6	7	0	1	8	0	0
24	7942732	.	T	C	3	5	8	0	0	8	0	0
24	7942790	.	T	C	7	4	11	0	0	11	0	0
24	8906130	.	A	T	1	2	3	0	0	3	0	0
24	8968808	.	G	A	1	6	7	0	4	11	0	0
24	8979615	.	C	G	1	6	7	0	0	7	0	0
24	8979618	.	G	A	1	6	7	0	0	7	0	0
24	8979708	.	C	T	0	11	11	0	7	18	0	0
24	8979917	.	G	A	7	3	10	0	0	10	0	0
24	8988945	.	G	C	8	1	9	0	13	22	0	0
24	8999699	.	T	A	5	8	13	0	0	13	0	0
24	9162634	.	T	C	1	2	3	0	0	3	0	0
24	9162766	.	G	A	2	2	4	0	0	4	0	0
24	9260452	.	A	C	2	3	5	0	0	5	0	0
24	9260530	.	A	G	1	1	2	0	1	3	0	0
24	9267967	.	A	T	3	2	5	0	0	5	0	0
24	9270074	.	G	A	1	2	3	0	1	4	0	0
24	9288558	.	T	G	1	1	2	0	17	19	0	0
24	9288889	.	G	T	12	17	29	0	3	32	0	0
24	9293831	.	A	G	8	6	14	0	0	14	0	0
24	9298312	.	G	A	1	4	5	0	0	5	0	0
24	9518441	.	A	G	5	0	5	0	2	7	0	0
24	9518447	.	T	C	4	2	6	0	0	6	0	0
24	9525632	.	C	T	1	4	5	0	0	5	0	0
24	9543120	.	A	G	3	0	3	0	2	5	0	0
24	9543144	.	A	C	2	4	6	0	0	6	0	0
24	9543510	.	G	T	1	2	3	0	3	6	0	0
24	9558527	.	C	T	2	2	4	0	0	4	0	0
24	9566928	.	A	G	2	2	4	0	0	4	0	0
24	9572907	.	A	G	0	2	2	0	1	3	0	0
24	9573201	.	T	C	3	3	6	0	0	6	0	0
24	9573220	.	G	A	3	5	8	0	0	8	0	0
24	9573300	.	A	C	1	3	4	1	0	5	0	0
24	9596350	.	G	A	2	4	6	0	0	6	0	0
24	9596366	.	T	A	3	3	6	0	0	6	0	0
24	9596423	.	T	C	3	6	9	0	0	9	0	0
24	9676147	.	T	A	23	9	32	0	3	35	0	0
24	9676204	.	C	A	16	13	29	0	1	30	0	0
24	9678514	.	A	T	14	12	26	0	1	27	0	0
24	9689613	.	G	T	5	3	8	0	0	8	0	0
24	9689709	.	G	T	5	10	15	0	0	15	0	0
24	9689758	.	T	C	9	0	9	0	10	19	0	0
24	9694204	.	A	T	1	2	3	0	0	3	0	0
24	9706946	.	C	T	1	2	3	0	0	3	0	0
24	9707007	.	G	C	2	3	5	0	0	5	0	0
24	9708511	.	G	A	2	1	3	0	2	5	0	0
24	9708555	.	G	A	0	2	2	0	2	4	0	0
24	9708911	.	G	C	0	2	2	0	2	4	0	0
24	9714423	.	T	C	3	3	6	0	0	6	0	0
24	9717326	.	A	C	3	2	5	0	0	5	0	0
24	9717589	.	T	C	3	4	7	0	0	7	0	0
24	9717625	.	C	G	3	4	7	0	1	8	0	0
24	9721103	.	A	C	1	5	6	0	0	6	0	0
24	9724925	.	A	G	2	2	4	0	0	4	0	0
24	9725084	.	C	G	4	5	9	0	0	9	0	0
24	9729966	.	A	T	2	3	5	0	0	5	0	0
24	9734938	.	G	A	2	2	4	0	1	5	0	0
24	9746370	.	T	A	3	3	6	0	0	6	0	0
24	9865836	.	G	A	0	9	9	0	8	17	0	0
24	9866192	.	A	T	7	10	17	0	1	18	0	0
24	9866270	.	G	A	9	5	14	0	2	16	0	0
24	9866562	.	A	T	12	7	19	0	0	19	0	0
24	9866623	.	G	T	7	13	20	0	1	21	0	0
24	9866721	.	C	T	10	6	16	0	1	17	0	0
24	9867105	.	T	A	8	8	16	0	0	16	0	0
24	10247292	.	G	A	3	2	5	0	1	6	0	0
24	10270376	.	G	A	1	2	3	0	0	3	0	0
24	10303168	.	C	T	3	6	9	0	0	9	0	0
24	10309119	.	G	C	0	5	5	0	9	14	0	0
24	10309244	.	G	A	1	7	8	0	0	8	0	0
24	10309382	.	T	C	4	3	7	0	1	8	0	0
24	10309611	.	G	T	6	3	9	0	0	9	0	0
24	10314437	.	T	A	1	2	3	0	0	3	0	0
24	10319304	.	C	A	1	1	2	0	0	2	0	0
24	10319320	.	C	A	1	3	4	0	0	4	0	0
24	10332172	.	C	T	2	3	5	0	0	5	0	0
24	10349671	.	C	T	2	2	4	0	1	5	0	0
24	10349818	.	G	A	5	7	12	0	0	12	0	0
24	10349865	.	T	G	3	11	14	0	0	14	0	0
24	10349898	.	T	C	3	8	11	0	0	11	0	0
24	10350089	.	T	A	2	4	6	0	0	6	0	0
24	10356563	.	G	A	2	3	5	0	0	5	0	0
24	10356592	.	T	C	1	5	6	0	0	6	0	0
24	10356617	.	G	A	2	5	7	0	0	7	0	0
24	10368855	.	G	A	2	3	5	0	0	5	0	0
24	10376984	.	G	A	1	2	3	0	0	3	0	0
24	10376990	.	T	C	1	2	3	0	0	3	0	0
24	10393951	.	C	G	1	2	3	0	0	3	0	0
24	10393979	.	G	T	3	2	5	0	0	5	0	0
24	10393995	.	A	C	4	2	6	0	0	6	0	0
24	10394079	.	A	C	1	3	4	0	0	4	0	0
24	10414439	.	G	T	1	5	6	0	3	9	0	0
24	10415193	.	A	G	10	11	21	0	4	25	0	0
24	10415424	.	A	C	8	8	16	0	0	16	0	0
24	10415487	.	G	A	1	9	10	0	12	22	0	0
24	10415827	.	T	G	1	2	3	0	0	3	0	0
24	10464188	.	C	A	3	2	5	0	0	5	0	0
24	10464195	.	A	G	2	4	6	0	0	6	0	0
24	10464409	.	C	T	4	2	6	0	0	6	0	0
24	10828512	.	A	G	10	7	17	0	0	17	0	0
24	10897254	.	G	A	11	8	19	0	0	19	0	0
24	10897340	.	C	A	4	3	7	0	0	7	0	0
24	10901467	.	A	C	4	9	13	0	2	15	0	0
24	10901696	.	C	G	29	24	53	1	1	55	0	0
24	10901759	.	G	T	26	28	54	0	0	54	0	0
24	10901946	.	C	T	14	9	23	0	1	24	0	0
24	10902065	.	T	G	11	6	17	0	1	18	0	0
24	10902192	.	T	A	13	10	23	0	0	23	0	0
24	10902268	.	G	A	14	8	22	0	1	23	0	0
24	10902688	.	G	A	29	14	43	0	1	44	0	0
24	10907000	.	T	C	20	17	37	0	2	39	0	0
24	10907473	.	C	T	14	20	34	0	3	37	0	0
24	10907587	.	G	T	23	12	35	0	2	37	0	0
24	10915813	.	A	G	21	14	35	0	1	36	0	0
24	10917040	.	C	T	17	19	36	0	3	39	0	0
24	10917046	.	C	T	0	16	16	0	22	38	0	0
24	10917238	.	C	T	11	6	17	0	1	18	0	0
24	10919519	.	A	G	3	8	11	0	0	11	0	0
24	10919563	.	G	T	5	5	10	0	0	10	0	0
24	10924880	.	C	T	9	8	17	0	0	17	0	0
24	10924912	.	C	T	12	5	17	0	0	17	0	0
24	10924930	.	T	A	11	6	17	0	0	17	0	0
24	10944579	.	T	A	9	9	18	0	0	18	0	0
24	10961510	.	T	C	8	7	15	0	2	17	0	0
24	10971160	.	G	A	1	3	4	0	1	5	0	0
24	11049421	.	G	A	3	5	8	0	0	8	0	0
24	11049627	.	T	G	2	3	5	0	1	6	0	0
24	11049902	.	G	C	2	3	5	0	0	5	0	0
24	11059944	.	T	A	3	4	7	0	0	7	0	0
24	11059968	.	C	T	0	4	4	0	0	4	0	0
24	11083475	.	G	A	8	4	12	0	0	12	0	0
24	11083860	.	C	T	3	4	7	0	1	8	0	0
24	11084035	.	G	A	6	3	9	0	0	9	0	0
24	11086437	.	G	T	5	4	9	0	0	9	0	0
24	11086465	.	T	A	1	5	6	0	1	7	0	0
24	11086752	.	A	G	11	5	16	0	1	17	0	0
24	11087015	.	G	A	4	3	7	0	0	7	0	0
24	11113493	.	T	C	9	0	9	0	5	14	0	0
24	11114040	.	A	C	10	5	15	0	0	15	0	0
24	11114048	.	C	A	8	3	11	0	0	11	0	0
24	11114236	.	A	T	8	8	16	0	1	17	0	0
24	11114288	.	T	C	4	5	9	0	1	10	0	0
24	11114290	.	A	G	4	4	8	0	3	11	0	0
24	11114356	.	C	T	6	3	9	0	0	9	0	0
24	11114560	.	T	C	18	1	19	0	4	23	0	0
24	11114583	.	A	T	15	6	21	0	0	21	0	0
24	11114670	.	C	T	1	8	9	0	8	17	0	0
24	11114688	.	T	G	9	8	17	0	0	17	0	0
24	11114709	.	T	A	8	11	19	0	0	19	0	0
24	11115048	.	T	A	2	10	12	0	1	13	0	0
24	11115269	.	C	A	3	8	11	0	0	11	0	0
24	11115338	.	A	T	4	9	13	0	0	13	0	0
24	11115339	.	C	T	2	9	11	0	2	13	0	0
24	11115373	.	C	T	4	6	10	0	2	12	0	0
24	11115513	.	G	A	3	5	8	0	0	8	0	0
24	11115532	.	G	A	3	4	7	0	1	8	0	0
24	11115719	.	T	A	4	3	7	0	0	7	0	0
24	11115720	.	A	G	4	3	7	0	0	7	0	0
24	11115806	.	A	G	6	3	9	0	1	10	0	0
24	11115894	.	A	G	4	9	13	0	1	14	0	0
24	11116025	.	G	C	5	0	5	0	5	10	0	0
24	11116032	.	C	T	3	5	8	0	0	8	0	0
24	11124199	.	C	T	3	2	5	0	0	5	0	0
24	11141253	.	A	C	9	6	15	0	0	16	1	0
24	11141654	.	A	G	8	8	16	0	1	17	0	0
24	11141757	.	T	C	4	7	11	0	2	13	0	0
24	11141849	.	G	A	9	11	20	0	0	20	0	0
24	11145148	.	C	T	7	7	14	0	0	14	0	0
24	11145232	.	G	A	7	7	14	0	0	14	0	0
24	11145445	.	G	A	8	8	16	0	0	16	0	0
24	11145460	.	A	G	9	8	17	0	0	17	0	0
24	11150790	.	G	A	5	2	7	0	0	7	0	0
24	11150791	.	A	T	7	2	9	0	0	9	0	0
24	11156140	.	T	C	3	5	8	0	0	8	0	0
24	11346616	.	C	G	1	2	3	0	0	3	0	0
24	11390514	.	G	A	1	2	3	0	0	3	0	0
24	11451686	.	T	A	1	3	4	0	0	4	0	0
24	11473351	.	G	T	4	5	9	0	0	9	0	0
24	11473788	.	T	A	5	2	7	0	0	7	0	0
24	11473857	.	C	A	9	7	16	0	0	16	0	0
24	11473891	.	G	A	7	9	16	0	0	16	0	0
24	11474103	.	C	G	12	8	20	0	0	20	0	0
24	11474110	.	G	A	13	8	21	0	0	21	0	0
24	11474167	.	T	C	7	11	18	0	1	19	0	0
24	11474730	.	A	G	9	9	18	0	0	18	0	0
24	11483833	.	C	T	9	3	12	0	0	12	0	0
24	11487067	.	G	C	5	7	12	0	0	12	0	0
24	11490280	.	A	C	1	3	4	0	0	4	0	0
24	11496640	.	T	A	3	3	6	0	1	7	0	0
24	11530529	.	G	A	1	3	4	0	0	4	0	0
24	11531132	.	G	A	4	3	7	0	0	7	0	0
24	11531307	.	A	G	3	2	5	0	0	5	0	0
24	11532686	.	T	C	1	2	3	0	0	3	0	0
24	11888694	.	G	A	4	4	8	0	1	9	0	0
24	11888788	.	G	A	7	11	18	0	1	19	0	0
24	11888799	.	T	C	9	9	18	0	2	20	0	0
24	11888854	.	T	C	11	6	17	0	1	18	0	0
24	11889038	.	C	G	2	2	4	0	0	4	0	0
24	11889107	.	T	C	7	4	11	0	0	11	0	0
24	11889468	.	T	C	7	3	10	0	1	11	0	0
24	11889557	.	T	C	8	3	11	0	0	11	0	0
24	11889579	.	T	C	4	4	8	0	0	8	0	0
24	11893428	.	G	A	3	5	8	0	0	8	0	0
24	11894908	.	A	G	4	3	7	0	1	8	0	0
24	11894968	.	C	T	0	6	6	0	3	9	0	0
24	11895910	.	C	A	1	3	4	0	0	4	0	0
24	11896033	.	A	G	1	2	3	0	0	3	0	0
24	11900151	.	A	G	6	3	9	0	0	9	0	0
24	11900166	.	G	A	3	3	6	0	0	6	0	0
24	11905817	.	A	G	2	2	4	0	0	4	0	0
24	11908852	.	T	C	5	2	7	0	0	7	0	0
24	11909441	.	T	G	4	3	7	0	0	7	0	0
24	11918846	.	G	A	6	11	17	0	0	17	0	0
24	11919170	.	A	G	1	3	4	0	0	4	0	0
24	11919202	.	A	T	1	3	4	0	0	4	0	0
24	12133998	.	A	C	10	4	14	0	0	14	0	0
24	12252675	.	G	T	16	9	25	0	2	27	0	0
24	12253067	.	G	A	8	5	13	0	0	13	0	0
24	12253154	.	T	G	7	5	12	0	0	12	0	0
24	12630352	.	A	G	18	11	29	1	0	30	0	0
24	12634439	.	C	T	17	6	23	0	1	24	0	0
24	12638007	.	C	T	2	11	13	0	12	25	0	0
24	12686316	.	A	T	12	9	21	0	0	21	0	0
24	12743992	.	G	A	3	3	6	0	0	6	0	0
24	12744159	.	T	C	3	2	5	0	0	5	0	0
24	12744274	.	A	G	2	2	4	0	0	4	0	0
24	12744535	.	A	G	5	5	10	0	0	10	0	0
24	12744603	.	C	T	3	3	6	0	0	6	0	0
24	12744606	.	G	A	3	3	6	0	0	6	0	0
24	12744653	.	T	C	1	2	3	0	0	3	0	0
24	12744829	.	T	C	1	0	1	1	5	7	0	0
24	12746597	.	A	G	2	3	5	0	0	5	0	0
24	12748468	.	A	G	1	5	6	0	0	6	0	0
24	12749046	.	G	A	8	6	14	0	1	15	0	0
24	12764550	.	A	T	2	5	7	0	0	7	0	0
24	12768339	.	G	A	3	3	6	0	0	6	0	0
24	12832146	.	A	G	2	2	4	0	0	4	0	0
24	12963161	.	T	A	8	4	12	0	0	12	0	0
24	12966730	.	C	T	18	19	37	0	1	38	0	0
24	12966981	.	G	A	10	8	18	0	0	18	0	0
24	12967041	.	C	T	7	10	17	0	0	17	0	0
24	12967214	.	T	C	9	0	9	0	12	21	0	0
24	12970814	.	A	T	6	10	16	0	1	17	0	0
24	12975210	.	A	G	10	9	19	0	0	19	0	0
24	12977735	.	A	T	8	2	10	0	1	11	0	0
24	12983478	.	A	T	8	11	19	0	0	19	0	0
24	13009351	.	T	A	5	2	7	0	0	7	0	0
24	13013596	.	T	C	3	4	7	0	1	8	0	0
24	13014280	.	C	T	5	2	7	0	0	8	1	0
24	13015582	.	A	T	12	4	16	0	1	17	0	0
24	13015843	.	C	G	4	3	7	0	0	7	0	0
24	13023054	.	C	T	42	16	58	0	0	58	0	0
24	13026060	.	G	A	35	12	47	1	3	51	0	0
24	13026449	.	T	C	27	23	50	0	1	51	0	0
24	13101128	.	A	G	33	19	52	0	2	54	0	0
24	13101143	.	C	A	36	20	56	0	0	56	0	0
24	13101185	.	A	G	37	2	39	0	27	66	0	0
24	13138165	.	T	C	37	22	59	1	3	63	0	0
24	13239124	.	T	A	26	15	41	1	1	43	0	0
24	13239248	.	A	G	24	8	32	0	15	47	0	0
24	13239985	.	G	C	26	15	41	0	2	43	0	0
24	13251801	.	A	C	7	5	12	0	0	12	0	0
24	13252065	.	G	A	8	4	12	0	2	14	0	0
24	13252122	.	A	C	7	0	7	0	8	15	0	0
24	13252448	.	A	G	8	5	13	0	1	14	0	0
24	13255400	.	C	T	11	5	16	1	0	17	0	0
24	13262409	.	G	C	3	0	3	0	2	5	0	0
24	13271566	.	T	C	4	3	7	0	0	7	0	0
24	13271628	.	A	G	4	4	8	0	0	8	0	0
24	13362353	.	G	T	1	3	4	0	0	4	0	0
24	13362401	.	A	G	1	2	3	0	0	3	0	0
24	14233798	.	G	C	1	3	4	0	1	5	0	0
24	14233840	.	T	G	1	4	5	0	0	5	0	0
24	14233841	.	G	A	1	4	5	0	0	5	0	0
24	14234355	.	A	G	4	2	6	0	0	6	0	0
24	14234412	.	T	G	2	3	5	0	0	5	0	0
24	14385405	.	G	A	0	3	3	0	2	5	0	0
24	14385520	.	A	G	5	3	8	0	0	8	0	0
24	14385526	.	C	A	5	3	8	0	0	8	0	0
24	14385969	.	C	T	5	2	7	0	0	7	0	0
24	14386024	.	C	T	6	2	8	0	0	8	0	0
24	14386050	.	C	T	4	2	6	0	0	6	0	0
24	14415965	.	G	A	6	5	11	0	0	11	0	0
24	14416018	.	G	C	1	5	6	0	7	13	0	0
24	14420990	.	T	G	5	0	5	0	8	13	0	0
24	14432194	.	T	C	7	9	16	0	0	16	0	0
24	14442861	.	G	A	6	7	13	0	0	13	0	0
24	14443212	.	G	T	5	7	12	0	0	12	0	0
24	14443291	.	C	T	10	9	19	0	1	20	0	0
24	14443578	.	A	G	12	6	18	0	0	18	0	0
24	14542501	.	A	G	4	3	7	0	0	7	0	0
24	14549344	.	T	A	8	8	16	0	1	17	0	0
24	14550545	.	C	T	4	6	10	0	0	10	0	0
24	14550554	.	G	A	4	6	10	0	0	10	0	0
24	14550596	.	T	C	4	7	11	0	0	11	0	0
24	14559391	.	A	G	10	16	26	0	3	29	0	0
24	14559778	.	A	T	45	22	67	0	6	73	0	0
24	14559828	.	T	A	38	34	72	0	2	76	2	0
24	14567239	.	A	T	1	3	4	0	0	4	0	0
24	14568300	.	G	T	23	40	63	0	1	64	0	0
24	14575607	.	G	A	32	31	63	0	0	63	0	0
24	14576693	.	A	G	16	12	28	0	0	28	0	0
24	14576782	.	A	G	6	9	15	0	0	15	0	0
24	14636649	.	G	A	2	3	5	0	0	5	0	0
24	14706845	.	A	G	1	2	3	0	0	3	0	0
24	14706851	.	A	G	1	2	3	0	0	3	0	0
24	14711624	.	A	G	3	2	5	0	0	5	0	0
24	14713789	.	G	A	0	2	2	0	1	3	0	0
24	14713796	.	T	C	1	3	4	0	0	4	0	0
24	14713927	.	T	C	13	18	31	0	2	33	0	0
24	14718163	.	T	C	28	19	47	0	2	49	0	0
24	14725164	.	A	G	21	18	39	0	0	39	0	0
24	14725417	.	G	A	13	31	44	0	1	45	0	0
24	14725551	.	G	A	9	21	30	0	1	31	0	0
24	14937209	.	T	G	3	2	5	0	0	5	0	0
24	15061397	.	T	C	6	6	12	0	0	12	0	0
24	15061434	.	T	C	4	6	10	0	0	10	0	0
24	15061758	.	C	T	5	3	8	0	0	8	0	0
24	15061866	.	G	A	6	6	12	0	0	12	0	0
24	15124785	.	A	T	3	5	8	0	3	11	0	0
24	15124880	.	T	C	7	0	7	0	10	17	0	0
24	15124890	.	A	G	7	10	17	0	0	17	0	0
24	15127487	.	A	T	3	5	8	0	1	9	0	0
24	15127639	.	T	C	4	5	9	0	1	10	0	0
24	15169316	.	C	T	1	2	3	0	1	4	0	0
24	15277347	.	T	C	1	3	4	0	0	4	0	0
24	15277923	.	T	C	3	4	7	0	0	7	0	0
24	15278187	.	A	G	1	3	4	0	0	4	0	0
24	15278217	.	C	T	1	3	4	0	1	5	0	0
24	15278238	.	G	T	2	3	5	0	0	5	0	0
24	15278508	.	C	T	4	3	7	0	0	7	0	0
24	15645617	.	G	T	9	10	19	2	15	36	0	0
24	15645669	.	G	T	10	18	28	0	1	29	0	0
24	15648158	.	A	G	15	18	33	0	1	34	0	0
24	15648504	.	T	C	7	4	11	0	0	11	0	0
24	15898505	.	C	G	1	5	6	0	0	6	0	0
24	16111914	.	T	C	2	14	16	0	0	16	0	0
24	16121362	.	G	A	2	8	10	0	7	17	0	0
24	16121462	.	G	A	7	8	15	0	0	15	0	0
24	16162056	.	A	T	6	2	8	0	0	8	0	0
24	16162107	.	T	G	1	3	4	0	0	4	0	0
24	16162185	.	T	G	3	2	5	0	0	5	0	0
24	16162344	.	A	T	5	6	11	0	0	11	0	0
24	16162422	.	A	T	2	6	8	0	0	8	0	0
24	16471603	.	C	A	2	2	4	0	0	4	0	0
24	16572266	.	G	A	11	7	18	0	1	19	0	0
24	16574732	.	A	G	6	4	10	0	1	11	0	0
24	16596414	.	A	G	14	0	14	0	9	23	0	0
24	16693526	.	T	C	14	14	28	0	0	28	0	0
24	16696713	.	G	C	23	20	43	0	2	46	1	0
24	16702886	.	G	T	0	6	6	0	11	17	0	0
24	16705878	.	C	T	14	15	29	0	2	31	0	0
24	16705948	.	C	T	24	19	43	0	0	43	0	0
24	16705949	.	A	G	23	19	42	0	1	43	0	0
24	16706108	.	A	G	20	20	40	0	1	41	0	0
24	16706834	.	A	G	2	6	8	0	1	9	0	0
24	16855489	.	G	A	1	1	2	0	1	3	0	0
24	16855491	.	A	C	1	2	3	0	0	3	0	0
24	16896769	.	T	C	2	2	4	0	0	4	0	0
24	16908827	.	G	A	17	19	36	0	0	36	0	0
24	16908908	.	C	T	14	12	26	0	3	29	0	0
24	16909052	.	T	C	12	19	31	0	0	31	0	0
24	16911600	.	A	C	20	27	47	0	5	52	0	0
24	16911898	.	C	T	19	24	43	0	1	44	0	0
24	16912191	.	G	A	24	29	53	0	2	55	0	0
24	16964239	.	A	C	1	3	4	0	1	5	0	0
24	16964353	.	C	A	4	2	6	0	0	6	0	0
24	16964452	.	G	A	4	7	11	0	0	11	0	0
24	16964500	.	C	T	4	4	8	0	1	9	0	0
24	16964753	.	C	T	1	3	4	0	0	4	0	0
24	16964787	.	T	A	2	4	6	0	0	6	0	0
24	16964819	.	T	C	0	5	5	0	1	6	0	0
24	16964839	.	A	C	2	5	7	0	1	8	0	0
24	16964854	.	T	C	3	6	9	0	0	9	0	0
24	16964881	.	G	C	5	5	10	0	0	10	0	0
24	16964889	.	A	G	5	7	12	0	0	12	0	0
24	16964943	.	A	T	8	4	12	0	1	13	0	0
24	16965020	.	C	T	5	5	10	0	1	11	0	0
24	16965032	.	G	A	5	4	9	0	1	10	0	0
24	16965545	.	C	A	2	6	8	0	0	8	0	0
24	16965648	.	C	G	7	6	13	0	0	13	0	0
24	16965729	.	A	C	5	5	10	0	0	10	0	0
24	16965765	.	T	C	7	3	10	0	0	10	0	0
24	16965770	.	T	C	8	3	11	0	0	11	0	0
24	16965900	.	A	C	3	0	3	0	3	6	0	0
24	16965972	.	A	G	3	4	7	0	1	8	0	0
24	16966176	.	G	A	5	7	12	0	1	13	0	0
24	16966185	.	T	C	6	1	7	0	5	12	0	0
24	16966389	.	A	G	2	2	4	0	0	4	0	0
24	16969033	.	A	G	4	2	6	0	0	6	0	0
24	16969132	.	A	C	1	0	1	0	3	4	0	0
24	16969220	.	T	C	4	3	7	0	0	7	0	0
24	16979653	.	C	A	0	3	3	0	2	5	0	0
24	16979678	.	A	T	2	2	4	0	0	4	0	0
24	16985547	.	C	T	6	13	19	0	1	20	0	0
24	16992605	.	G	A	1	16	17	0	15	32	0	0
24	16992915	.	C	T	18	16	34	0	3	37	0	0
24	16998976	.	A	T	36	19	55	0	0	55	0	0
24	17002611	.	C	T	26	24	50	0	2	52	0	0
24	17002666	.	A	T	19	27	46	0	4	50	0	0
24	17007501	.	C	G	1	5	6	0	0	6	0	0
24	17010932	.	G	T	2	5	7	0	0	7	0	0
24	17010995	.	C	A	1	3	4	0	0	4	0	0
24	17011082	.	C	A	1	3	4	0	0	5	1	0
24	17016658	.	T	C	5	3	8	0	0	8	0	0
24	17017060	.	T	C	7	4	11	0	1	12	0	0
24	17019252	.	A	G	5	0	5	1	7	13	0	0
24	17019483	.	T	G	2	0	2	0	6	8	0	0
24	17019504	.	G	A	5	4	9	0	0	9	0	0
24	17019669	.	A	G	4	3	7	0	2	9	0	0
24	17019843	.	A	G	4	1	5	0	6	11	0	0
24	17020128	.	C	T	7	5	12	0	0	12	0	0
24	17021848	.	G	A	22	22	44	0	0	44	0	0
24	17021894	.	T	C	25	2	27	0	10	37	0	0
24	17022028	.	A	G	20	9	29	1	0	31	1	0
24	17022029	.	T	A	18	9	27	1	2	30	0	0
24	17022265	.	A	G	2	2	4	0	0	4	0	0
24	17023063	.	G	A	8	15	23	0	1	24	0	0
24	17028690	.	T	A	9	16	25	0	0	25	0	0
24	17040627	.	C	T	1	2	3	0	0	3	0	0
24	17040803	.	A	T	3	3	6	0	0	6	0	0
24	17041159	.	G	C	4	2	6	0	0	6	0	0
24	17041208	.	T	G	4	3	7	0	1	8	0	0
24	17041267	.	T	A	10	5	15	0	0	15	0	0
24	17041354	.	A	G	3	2	5	0	0	5	0	0
24	17042763	.	C	T	6	4	10	0	2	12	0	0
24	17068942	.	C	T	8	6	14	0	0	14	0	0
24	17068949	.	A	G	8	0	8	0	7	15	0	0
24	17069249	.	C	A	2	2	4	0	0	4	0	0
24	17069297	.	A	G	2	6	8	0	1	9	0	0
24	17069358	.	T	A	2	3	5	0	1	6	0	0
24	17069360	.	G	A	2	4	6	0	0	6	0	0
24	17124124	.	C	T	9	6	15	0	0	15	0	0
24	17124476	.	G	A	3	13	16	0	14	30	0	0
24	17124567	.	T	C	10	20	30	0	1	31	0	0
24	17124591	.	T	A	8	20	28	0	2	30	0	0
24	17125969	.	C	G	5	1	6	1	13	21	1	0
24	17126069	.	G	A	19	11	30	0	3	33	0	0
24	17126341	.	C	T	15	17	32	0	3	35	0	0
24	17137566	.	G	T	1	2	3	0	0	3	0	0
24	17177262	.	G	A	0	7	7	0	5	12	0	0
24	17181103	.	A	G	5	0	5	0	3	8	0	0
24	17181217	.	C	A	2	6	8	0	0	8	0	0
24	17181443	.	A	G	4	0	4	0	5	9	0	0
24	17189815	.	T	A	7	5	12	1	0	13	0	0
24	17211821	.	C	A	13	10	23	0	1	24	0	0
24	17214493	.	A	T	9	12	21	0	2	23	0	0
24	17214746	.	C	T	9	7	16	0	1	17	0	0
24	17215186	.	T	C	8	12	20	1	2	23	0	0
24	17215894	.	A	G	5	3	8	0	0	8	0	0
24	17257693	.	C	A	14	11	25	0	3	28	0	0
24	17257866	.	T	C	5	7	12	0	0	12	0	0
24	17258426	.	G	A	10	13	23	0	0	23	0	0
24	17258451	.	G	T	15	16	31	0	2	33	0	0
24	17259535	.	G	T	9	6	15	0	1	16	0	0
24	17260568	.	C	A	3	4	7	0	0	7	0	0
24	17266382	.	G	A	7	4	11	0	0	11	0	0
24	17266564	.	G	T	2	5	7	0	0	7	0	0
24	17266886	.	T	A	6	9	15	0	1	16	0	0
24	17266909	.	T	A	6	5	11	0	3	14	0	0
24	17276447	.	T	C	2	3	5	0	0	5	0	0
24	17345618	.	C	A	2	3	5	0	0	5	0	0
24	17345634	.	T	C	0	3	3	0	1	4	0	0
24	17360174	.	T	C	1	2	3	0	0	3	0	0
24	17363523	.	C	T	0	3	3	0	2	5	0	0
24	17363740	.	A	G	2	4	6	0	0	6	0	0
24	17363745	.	T	G	1	5	6	0	1	7	0	0
24	17363811	.	T	C	2	3	5	0	2	7	0	0
24	17364010	.	G	A	1	4	5	0	5	10	0	0
24	17364076	.	A	T	2	6	8	0	1	9	0	0
24	17364287	.	T	C	6	4	10	0	0	10	0	0
24	17364985	.	G	A	13	11	24	0	0	24	0	0
24	17365081	.	A	G	10	11	21	0	2	23	0	0
24	17366374	.	G	A	23	6	29	0	1	30	0	0
24	17367882	.	G	A	13	10	23	0	0	23	0	0
24	17368343	.	T	A	7	10	17	0	1	18	0	0
24	17368816	.	G	A	7	8	15	0	0	15	0	0
24	17372074	.	G	A	9	6	15	0	0	15	0	0
24	17374611	.	T	C	8	5	13	0	0	13	0	0
24	17377871	.	G	A	11	5	16	0	0	16	0	0
24	17377874	.	G	A	10	6	16	0	0	16	0	0
24	17378123	.	T	C	6	0	6	0	4	10	0	0
24	17378475	.	A	G	1	4	5	0	3	8	0	0
24	17404219	.	G	A	3	5	8	0	1	9	0	0
24	17409892	.	T	G	5	4	9	0	0	9	0	0
24	17410039	.	G	C	4	4	8	0	0	8	0	0
24	17417535	.	T	G	15	12	27	0	1	28	0	0
24	17417855	.	G	C	8	19	27	0	1	28	0	0
24	17417899	.	G	C	8	14	22	0	1	23	0	0
24	17417947	.	A	G	3	7	10	0	0	10	0	0
24	17418024	.	C	A	12	15	27	0	0	27	0	0
24	17418180	.	G	T	15	9	24	0	0	24	0	0
24	17418752	.	T	A	1	5	6	0	0	6	0	0
24	17419118	.	T	G	3	6	9	0	0	9	0	0
24	17419140	.	A	G	6	4	10	0	0	10	0	0
24	17419563	.	A	T	6	2	8	0	0	8	0	0
24	17419604	.	C	A	4	7	11	0	0	12	1	0
24	17419607	.	A	T	6	8	14	0	0	14	0	0
24	17420516	.	G	A	13	10	23	0	3	26	0	0
24	17420519	.	T	C	14	0	14	0	11	25	0	0
24	17420595	.	T	A	11	11	22	0	1	23	0	0
24	17420761	.	G	T	4	8	12	0	0	12	0	0
24	17421216	.	G	T	13	17	30	0	0	30	0	0
24	17421270	.	C	T	1	9	10	0	16	26	0	0
24	17421311	.	G	C	17	9	26	0	1	27	0	0
24	17421338	.	A	T	18	12	30	1	0	31	0	0
24	17421396	.	C	A	12	23	35	1	2	38	0	0
24	17421655	.	G	A	12	16	28	0	0	28	0	0
24	17465715	.	C	T	6	8	14	0	0	14	0	0
24	17465722	.	A	T	6	5	11	0	2	13	0	0
24	17505209	.	G	A	4	6	10	0	0	10	0	0
24	17521679	.	C	G	5	3	8	0	0	9	1	0
24	17611267	.	A	G	2	2	4	0	0	4	0	0
24	17611316	.	G	C	3	2	5	0	0	5	0	0
24	17611349	.	G	A	5	3	8	0	0	8	0	0
24	17618929	.	T	G	2	6	8	0	0	8	0	0
24	17731754	.	T	A	5	2	7	0	0	7	0	0
24	17733702	.	A	G	2	4	6	0	1	7	0	0
24	17754557	.	G	A	1	6	7	0	1	8	0	0
24	17871763	.	T	C	2	2	4	0	0	4	0	0
24	18376848	.	A	C	2	3	5	0	0	5	0	0
24	18444097	.	A	T	5	6	11	0	0	11	0	0
24	18444153	.	G	C	3	6	9	0	0	9	0	0
24	18444267	.	T	C	13	4	17	0	16	33	0	0
24	18444334	.	G	T	34	22	56	0	4	61	1	0
24	18445784	.	A	G	30	30	60	0	4	64	0	0
24	18446545	.	G	A	16	22	38	0	0	38	0	0
24	18448348	.	G	A	4	5	9	0	1	10	0	0
24	18485873	.	T	A	1	2	3	0	0	3	0	0
24	18485959	.	T	A	1	3	4	0	0	4	0	0
24	18486030	.	A	G	3	3	6	0	0	6	0	0
24	18486705	.	C	T	2	2	4	0	0	4	0	0
24	18521384	.	T	A	1	2	3	0	0	3	0	0
24	18521467	.	C	A	5	11	16	0	1	17	0	0
24	18549400	.	G	A	12	11	23	0	1	24	0	0
24	18553898	.	C	T	6	3	9	0	0	9	0	0
24	18563695	.	G	A	4	7	11	0	0	11	0	0
24	18563714	.	A	G	5	7	12	0	0	12	0	0
24	18565564	.	A	G	3	6	9	0	0	9	0	0
24	18565591	.	C	T	6	3	9	0	0	9	0	0
24	18598654	.	C	T	2	5	7	0	0	7	0	0
24	18599302	.	A	G	1	7	8	0	0	8	0	0
24	18625641	.	C	G	5	3	8	0	0	8	0	0
24	18684818	.	C	T	2	2	4	0	2	6	0	0
24	18731867	.	T	C	4	3	7	0	0	7	0	0
24	18731951	.	T	C	1	3	4	0	0	4	0	0
24	18732188	.	T	C	2	2	4	0	0	4	0	0
24	18737472	.	G	T	8	5	13	0	1	14	0	0
24	18737876	.	C	T	7	6	13	0	1	14	0	0
24	18738073	.	C	T	0	4	4	0	9	13	0	0
24	18738081	.	T	C	4	0	4	0	4	8	0	0
24	18738409	.	G	A	15	10	25	0	1	26	0	0
24	18746161	.	C	T	10	11	21	0	0	21	0	0
24	18749985	.	A	G	13	14	27	0	0	27	0	0
24	18750012	.	G	C	17	8	25	0	4	29	0	0
24	18751734	.	T	A	14	13	27	0	1	28	0	0
24	18751740	.	C	T	1	13	14	0	14	28	0	0
24	18751833	.	A	G	8	10	18	0	1	19	0	0
24	18754752	.	G	A	6	8	14	0	1	15	0	0
24	18757399	.	G	A	6	4	10	0	0	10	0	0
24	18769652	.	A	G	6	9	15	0	0	15	0	0
24	18783090	.	A	G	8	5	13	0	3	16	0	0
24	18783638	.	G	A	3	3	6	0	0	6	0	0
24	18784288	.	G	A	3	5	8	0	0	8	0	0
24	18797129	.	G	T	3	4	7	0	0	7	0	0
24	18797142	.	G	A	4	2	6	0	0	6	0	0
24	18827372	.	A	G	3	4	7	0	0	7	0	0
24	19061248	.	G	A	0	2	2	0	1	3	0	0
24	19115072	.	C	A	1	3	4	0	0	4	0	0
24	19373816	.	A	T	3	3	6	0	0	6	0	0
24	19574162	.	C	G	1	2	3	0	0	3	0	0
24	19656872	.	A	G	1	2	3	0	0	3	0	0
24	19692059	.	G	A	0	3	3	0	1	4	0	0
24	19696060	.	T	C	3	4	7	0	0	7	0	0
24	19696090	.	C	T	0	7	7	0	2	9	0	0
24	19696151	.	A	C	3	5	8	0	0	8	0	0
24	19696794	.	C	G	4	5	9	0	0	9	0	0
24	19697048	.	G	A	3	4	7	0	0	7	0	0
24	19697387	.	A	G	1	3	4	0	0	4	0	0
24	19708085	.	A	G	11	19	30	0	0	30	0	0
24	19708448	.	G	T	5	13	18	0	0	18	0	0
24	19708846	.	T	C	8	7	15	0	0	15	0	0
24	19711576	.	G	T	12	7	19	0	1	20	0	0
24	19719132	.	C	A	0	8	8	0	15	23	0	0
24	20064128	.	C	T	2	3	5	0	0	5	0	0
24	20064130	.	G	T	2	3	5	0	0	5	0	0
24	20064232	.	G	A	8	4	12	0	2	14	0	0
24	20064844	.	A	G	5	7	12	1	0	13	0	0
24	20064924	.	A	G	3	4	7	0	0	7	0	0
24	20064988	.	A	C	3	2	5	0	0	5	0	0
24	20065115	.	C	T	1	4	5	0	4	9	0	0
24	20065366	.	T	G	3	5	8	0	0	8	0	0
24	20065375	.	T	A	2	4	6	0	0	6	0	0
24	20066160	.	T	C	1	3	4	0	0	4	0	0
24	20087709	.	T	C	5	4	9	0	0	9	0	0
24	20194372	.	T	C	1	2	3	0	0	3	0	0
24	20194475	.	A	G	4	6	10	0	1	11	0	0
24	20196172	.	A	G	7	5	12	0	1	13	0	0
24	20197755	.	C	A	3	5	8	0	1	9	0	0
24	20199122	.	A	C	2	3	5	0	0	5	0	0
24	20208353	.	A	G	2	3	5	0	0	5	0	0
24	20216163	.	A	T	1	2	3	0	0	3	0	0
24	20328609	.	G	A	1	5	6	0	0	6	0	0
24	20328821	.	C	A	5	5	10	0	1	11	0	0
24	20328999	.	T	A	3	2	5	0	0	5	0	0
24	20329493	.	G	A	10	7	17	0	0	17	0	0
24	20329589	.	G	C	5	12	17	0	0	17	0	0
24	20332187	.	A	T	1	4	5	0	0	5	0	0
24	20336686	.	T	C	2	3	5	0	0	5	0	0
24	20336694	.	A	G	2	0	2	0	2	4	0	0
24	20450191	.	A	G	7	6	13	0	0	13	0	0
24	20450424	.	A	T	5	5	10	0	2	12	0	0
24	20450475	.	G	A	6	4	10	0	0	10	0	0
24	20450672	.	C	G	12	8	20	0	0	20	0	0
24	20450766	.	G	A	9	15	24	0	0	24	0	0
24	20470788	.	A	G	7	9	16	0	2	18	0	0
24	20501116	.	A	G	8	6	14	0	0	14	0	0
24	20536188	.	C	A	10	6	16	0	1	17	0	0
24	20536235	.	G	A	0	4	4	0	8	12	0	0
24	20536292	.	A	G	2	3	5	0	1	6	0	0
24	20537515	.	A	T	3	5	8	0	0	8	0	0
24	20539454	.	G	A	11	8	19	0	0	19	0	0
24	20552578	.	A	C	23	21	44	0	0	44	0	0
24	20554732	.	A	G	13	18	31	0	1	32	0	0
24	20554812	.	T	A	11	9	20	0	2	22	0	0
24	20591775	.	G	A	6	6	12	0	0	12	0	0
24	20596717	.	A	G	1	2	3	0	1	4	0	0
24	20600431	.	T	C	2	2	4	0	0	4	0	0
24	20600444	.	G	C	2	2	4	0	0	4	0	0
24	20600670	.	T	G	1	3	4	0	0	4	0	0
24	20600671	.	G	C	1	3	4	0	0	4	0	0
24	20600712	.	C	T	2	3	5	0	0	5	0	0
24	20600788	.	A	T	1	5	6	0	1	7	0	0
24	20600794	.	G	A	1	6	7	0	0	7	0	0
24	20644548	.	A	G	22	27	49	0	0	49	0	0
24	20645101	.	T	C	13	22	35	0	2	37	0	0
24	20645273	.	T	C	14	17	31	0	1	32	0	0
24	20645858	.	A	T	17	12	29	0	2	31	0	0
24	20646289	.	T	A	14	8	22	0	3	25	0	0
24	20646694	.	G	A	9	9	18	0	2	20	0	0
24	20648945	.	T	C	12	13	25	0	3	28	0	0
24	20649013	.	T	C	15	13	28	0	1	29	0	0
24	20649039	.	T	G	11	14	25	0	0	25	0	0
24	20708288	.	C	T	2	1	3	0	3	6	0	0
24	20708388	.	A	G	5	2	7	0	0	7	0	0
24	20807990	.	G	A	1	2	3	0	0	3	0	0
24	20895293	.	T	A	3	5	8	0	0	8	0	0
24	20895308	.	A	G	2	6	8	0	0	8	0	0
24	20896969	.	G	T	4	2	6	0	0	6	0	0
24	20897011	.	T	A	1	2	3	0	0	3	0	0
24	20898402	.	A	G	1	3	4	0	0	4	0	0
24	20898439	.	G	T	1	3	4	0	2	6	0	0
24	20898485	.	G	A	2	4	6	0	0	6	0	0
24	20899896	.	T	A	2	2	4	0	0	4	0	0
24	20899929	.	A	T	3	2	5	0	0	5	0	0
24	20899947	.	C	A	3	2	5	0	0	5	0	0
24	20899964	.	A	T	2	2	4	0	0	4	0	0
24	20900142	.	A	G	2	3	5	0	0	5	0	0
24	20908035	.	A	C	2	0	2	0	2	4	0	0
24	20908042	.	A	T	2	2	4	0	0	4	0	0
24	20913353	.	A	G	1	11	12	0	0	12	0	0
24	20913362	.	C	T	1	11	12	0	1	13	0	0
24	20913403	.	C	T	0	3	3	0	1	4	0	0
24	20913408	.	T	A	1	3	4	0	0	4	0	0
24	20916788	.	A	G	5	7	12	0	0	12	0	0
24	20916841	.	C	A	4	6	10	0	1	11	0	0
24	20917017	.	T	C	3	5	8	2	0	10	0	0
24	20917029	.	T	C	4	5	9	3	0	12	0	0
24	20920648	.	G	C	2	16	18	0	13	31	0	0
24	20920910	.	C	G	14	6	20	6	1	27	0	0
24	20921431	.	C	T	11	4	15	16	0	31	0	0
24	20921530	.	A	G	5	10	15	0	1	16	0	0
24	20921537	.	G	T	6	11	17	0	0	17	0	0
24	20921565	.	C	A	6	10	16	0	0	16	0	0
24	20921594	.	C	T	4	6	10	0	1	11	0	0
24	20921615	.	A	G	1	5	6	0	0	6	0	0
24	20922721	.	G	A	4	2	6	0	0	6	0	0
24	20922783	.	G	A	4	2	6	0	0	6	0	0
24	20931626	.	G	A	15	11	26	0	1	27	0	0
24	20934223	.	C	T	25	21	46	0	1	47	0	0
24	20934528	.	G	A	16	6	22	0	1	23	0	0
24	20941540	.	G	A	10	5	15	0	0	15	0	0
24	20942342	.	G	A	4	4	8	0	13	21	0	0
24	20946263	.	G	A	13	20	33	0	2	35	0	0
24	20948122	.	C	T	18	12	30	0	0	30	0	0
24	20949494	.	A	G	13	10	23	0	4	27	0	0
24	20952215	.	T	A	7	4	11	0	1	12	0	0
24	20952306	.	C	T	0	2	2	0	4	6	0	0
24	20953415	.	C	T	8	9	17	0	0	17	0	0
24	20954109	.	G	A	9	8	17	0	1	18	0	0
24	20954151	.	C	A	17	6	23	0	0	23	0	0
24	20954154	.	T	C	18	6	24	0	0	24	0	0
24	20962473	.	C	A	1	2	3	0	0	3	0	0
24	20962477	.	G	C	1	2	3	0	0	3	0	0
24	20968593	.	C	T	3	2	5	0	0	5	0	0
24	20969449	.	C	T	2	3	5	0	0	5	0	0
24	20980141	.	A	G	3	8	11	0	0	11	0	0
24	20987798	.	T	C	1	2	3	0	1	4	0	0
24	20987834	.	G	A	1	3	4	0	0	4	0	0
24	20987865	.	A	G	2	3	5	0	0	5	0	0
24	21005908	.	A	T	3	4	7	0	1	8	0	0
24	21006053	.	A	G	9	7	16	0	1	17	0	0
24	21006082	.	G	A	7	5	12	0	0	12	0	0
24	21006188	.	T	G	5	5	10	0	0	10	0	0
24	21060125	.	G	A	2	2	4	0	0	4	0	0
24	21060137	.	G	A	1	2	3	0	0	3	0	0
24	21073140	.	A	T	2	3	5	0	0	5	0	0
24	21154165	.	G	A	12	9	21	0	2	23	0	0
24	21154203	.	C	T	23	10	33	0	1	34	0	0
24	21154421	.	A	T	17	18	35	0	1	36	0	0
24	21154496	.	C	A	4	19	23	0	13	36	0	0
24	21154707	.	A	G	23	35	58	0	2	60	0	0
24	21157712	.	G	A	20	26	46	0	1	47	0	0
24	21159814	.	A	G	23	13	36	0	1	37	0	0
24	21161459	.	C	T	1	19	20	0	14	34	0	0
24	21177180	.	T	C	8	10	18	0	0	18	0	0
24	21182156	.	A	G	1	2	3	0	0	3	0	0
24	21182444	.	A	G	10	8	18	0	0	18	0	0
24	21182783	.	C	T	10	16	26	0	2	28	0	0
24	21182834	.	G	A	1	11	12	0	14	26	0	0
24	21182911	.	G	A	0	11	11	0	7	18	0	0
24	21183181	.	C	T	12	9	21	0	2	23	0	0
24	21183228	.	C	G	16	16	32	0	1	33	0	0
24	21183467	.	T	C	6	6	12	0	0	12	0	0
24	21196211	.	C	A	3	3	6	0	0	6	0	0
24	21196410	.	A	G	1	2	3	0	0	3	0	0
24	21196446	.	T	G	2	2	4	0	0	4	0	0
24	21196503	.	A	C	1	2	3	0	0	3	0	0
24	21202203	.	A	G	1	5	6	0	1	7	0	0
24	21202225	.	C	T	2	2	4	0	1	5	0	0
24	21202488	.	G	A	2	2	4	0	3	7	0	0
24	21206347	.	T	A	1	2	3	0	1	4	0	0
24	21206352	.	G	T	1	3	4	0	0	4	0	0
24	21214898	.	G	A	2	5	7	0	0	7	0	0
24	21371801	.	T	G	27	27	54	0	3	57	0	0
24	21371919	.	G	A	18	22	40	3	2	45	0	0
24	21372389	.	T	A	17	24	41	0	1	42	0	0
24	21372417	.	A	G	18	18	36	0	1	37	0	0
24	21392168	.	T	C	15	19	34	0	0	34	0	0
24	21392258	.	T	C	17	12	29	0	0	29	0	0
24	21438113	.	A	G	5	8	13	0	1	14	0	0
24	21442815	.	A	G	13	14	27	0	0	27	0	0
24	21447610	.	T	G	9	7	16	0	0	16	0	0
24	21447668	.	C	T	0	7	7	0	6	13	0	0
24	21450383	.	G	A	7	9	16	0	1	17	0	0
24	21462810	.	A	G	2	10	12	0	0	12	0	0
24	21469067	.	T	G	4	5	9	0	1	10	0	0
24	21469157	.	T	C	10	0	10	0	12	22	0	0
24	21470881	.	A	T	1	4	5	0	1	6	0	0
24	21470892	.	A	C	1	4	5	0	0	5	0	0
24	21502007	.	A	G	8	8	16	0	0	16	0	0
24	21502069	.	G	A	6	11	17	0	0	17	0	0
24	21502133	.	T	C	7	1	8	0	10	18	0	0
24	21502305	.	A	G	9	9	18	0	1	19	0	0
24	21502762	.	T	A	11	6	17	0	1	18	0	0
24	21502817	.	C	A	5	3	8	0	1	9	0	0
24	21502999	.	G	A	7	7	14	0	0	14	0	0
24	21503438	.	G	A	5	2	7	0	0	7	0	0
24	21503793	.	G	A	4	6	10	0	1	11	0	0
24	21504169	.	T	G	2	5	7	0	0	7	0	0
24	21504467	.	A	G	4	10	14	0	0	14	0	0
24	21504725	.	C	T	1	4	5	0	7	12	0	0
24	21504785	.	A	G	6	8	14	0	1	15	0	0
24	21504860	.	G	T	9	3	12	0	1	13	0	0
24	21505255	.	T	G	7	4	11	0	1	12	0	0
24	21505606	.	T	C	4	3	7	0	0	7	0	0
24	21505623	.	G	A	7	4	11	0	0	11	0	0
24	21505895	.	A	G	4	4	8	0	0	8	0	0
24	21506032	.	T	C	5	2	7	0	1	8	0	0
24	21538430	.	C	T	18	9	27	0	1	28	0	0
24	21538441	.	T	G	19	0	19	0	8	27	0	0
24	21538568	.	A	C	15	7	22	0	1	23	0	0
24	21538628	.	C	T	8	6	14	0	0	14	0	0
24	21561074	.	C	T	2	7	9	0	0	9	0	0
24	21575273	.	T	A	10	13	23	0	2	25	0	0
24	21575311	.	G	C	9	11	20	0	1	21	0	0
24	21577488	.	T	C	3	6	9	0	1	10	0	0
24	21577620	.	T	G	9	4	13	0	1	14	0	0
24	21584115	.	T	C	7	3	10	0	3	13	0	0
24	21584116	.	A	C	10	3	13	0	0	13	0	0
24	21584189	.	G	A	8	4	12	0	0	12	0	0
24	21585148	.	T	C	3	0	3	0	2	5	0	0
24	21585396	.	C	T	1	9	10	0	7	17	0	0
24	21585719	.	C	T	0	3	3	0	4	7	0	0
24	21586135	.	T	A	5	3	8	0	0	8	0	0
24	21586190	.	C	G	6	3	9	0	0	9	0	0
24	21587309	.	T	G	3	2	5	0	0	5	0	0
24	21600984	.	C	A	15	22	37	0	2	39	0	0
24	21606035	.	G	A	13	9	22	0	0	22	0	0
24	21606325	.	C	T	5	15	20	0	10	30	0	0
24	21610064	.	G	A	19	14	33	0	1	34	0	0
24	21621730	.	G	T	14	14	28	0	0	28	0	0
24	21629737	.	G	A	1	2	3	0	0	3	0	0
24	21646375	.	G	A	4	6	10	0	0	10	0	0
24	21646704	.	G	T	32	20	52	0	3	55	0	0
24	21646847	.	A	C	22	14	36	0	1	37	0	0
24	21650034	.	T	A	24	22	46	0	2	48	0	0
24	21657567	.	C	G	18	15	33	0	0	33	0	0
24	21657606	.	T	C	16	11	27	0	1	28	0	0
24	21657639	.	G	A	11	13	24	0	3	27	0	0
24	21657642	.	G	A	12	14	26	0	1	27	0	0
24	21657738	.	T	C	14	0	14	0	14	28	0	0
24	21659864	.	A	T	14	9	23	0	2	26	1	0
24	21659873	.	A	G	14	8	22	0	1	23	0	0
24	21662298	.	T	G	7	8	15	0	2	17	0	0
24	21671114	.	G	A	18	16	34	0	0	34	0	0
24	21679971	.	G	A	8	6	14	0	1	15	0	0
24	21680010	.	G	A	1	10	11	1	5	17	0	0
24	21680143	.	T	C	6	7	13	0	1	14	0	0
24	21680646	.	G	T	3	4	7	0	0	7	0	0
24	21680661	.	T	G	5	4	9	0	0	9	0	0
24	21680747	.	C	G	2	2	4	0	1	5	0	0
24	21680811	.	C	G	3	7	10	0	0	10	0	0
24	21681074	.	G	T	9	7	16	0	0	16	0	0
24	21681112	.	T	A	3	4	7	0	0	8	1	0
24	21681162	.	C	T	2	4	6	0	0	6	0	0
24	21744266	.	A	G	8	6	14	0	1	15	0	0
24	21747705	.	T	C	5	4	9	0	0	9	0	0
24	21748175	.	A	G	13	7	20	0	1	21	0	0
24	21748249	.	T	C	15	9	24	0	0	24	0	0
24	21748279	.	C	T	9	8	17	0	1	18	0	0
24	21748374	.	T	C	2	7	9	0	2	11	0	0
24	21781146	.	A	G	4	3	7	0	0	7	0	0
24	21781451	.	T	G	5	4	9	0	0	9	0	0
24	21781452	.	T	A	5	4	9	0	0	9	0	0
24	21865207	.	G	A	1	2	3	0	0	3	0	0
24	21917502	.	T	C	2	5	7	0	1	8	0	0
24	21917518	.	G	A	2	9	11	0	1	12	0	0
24	21917745	.	T	G	6	8	14	0	0	14	0	0
24	21917777	.	C	A	8	3	11	0	0	11	0	0
24	21917863	.	T	C	2	2	4	0	1	5	0	0
24	21917955	.	G	A	1	6	7	0	1	8	0	0
24	21927456	.	C	T	5	2	7	0	0	7	0	0
24	21927506	.	A	G	2	5	7	0	0	7	0	0
24	22650131	.	T	C	1	1	2	0	3	5	0	0
24	22740589	.	T	C	5	8	13	0	0	13	0	0
24	22740897	.	A	T	13	17	30	0	1	31	0	0
24	22740949	.	A	G	12	19	31	0	0	31	0	0
24	22740996	.	C	T	8	11	19	0	0	19	0	0
24	22741051	.	G	A	13	9	22	0	0	22	0	0
24	22741088	.	C	T	12	9	21	0	2	23	0	0
24	22741403	.	T	A	12	10	22	0	2	24	0	0
24	22741453	.	C	T	8	6	14	0	1	15	0	0
24	22744502	.	A	G	10	13	23	0	1	24	0	0
24	22746843	.	T	G	21	8	29	0	1	30	0	0
24	22748633	.	C	T	12	7	19	0	2	21	0	0
24	22769225	.	A	T	10	12	22	0	3	25	0	0
24	22769333	.	A	G	8	0	8	0	9	17	0	0
24	22769447	.	G	A	10	6	16	0	1	17	0	0
24	22769593	.	C	A	7	4	11	0	1	12	0	0
24	22769595	.	T	A	6	6	12	0	1	13	0	0
24	23213738	.	C	T	2	2	4	0	0	4	0	0
24	23243257	.	A	G	1	7	8	0	1	9	0	0
24	23244265	.	G	A	1	10	11	1	4	16	0	0
24	23250116	.	T	A	4	5	9	0	1	10	0	0
24	23303003	.	G	A	2	3	5	0	0	5	0	0
24	23716987	.	T	A	2	6	8	0	0	8	0	0
24	23716991	.	A	G	2	5	7	0	1	8	0	0
24	23717079	.	T	G	7	8	15	0	0	15	0	0
24	23759505	.	A	G	5	3	8	0	0	8	0	0
24	23759787	.	T	G	6	6	12	0	1	13	0	0
24	23766841	.	G	A	5	5	10	0	1	11	0	0
24	23784647	.	G	A	6	2	8	0	0	8	0	0
24	23838823	.	C	T	5	4	9	0	0	9	0	0
24	23839024	.	T	C	10	3	13	0	0	13	0	0
24	23839303	.	A	G	6	8	14	0	0	14	0	0
24	23839342	.	T	C	5	7	12	0	2	14	0	0
24	23884522	.	G	A	0	2	2	0	5	7	0	0
24	23941618	.	G	T	2	4	6	0	0	6	0	0
24	24017837	.	C	T	10	4	14	0	0	14	0	0
24	24020314	.	C	T	7	8	15	0	3	18	0	0
24	24027914	.	T	A	5	9	14	0	0	14	0	0
24	24027939	.	A	G	9	3	12	0	1	14	1	0
24	24028016	.	C	T	14	12	26	0	0	26	0	0
24	24028032	.	G	C	15	11	26	0	0	26	0	0
24	24028059	.	T	A	12	14	26	0	0	26	0	0
24	24102091	.	T	C	17	0	17	0	25	42	0	0
24	24110789	.	A	T	21	21	42	0	1	43	0	0
24	24110935	.	C	T	21	15	36	0	1	37	0	0
24	24111470	.	G	A	8	9	17	0	2	19	0	0
24	24114272	.	G	C	17	6	23	0	0	23	0	0
24	24114321	.	C	T	16	8	24	0	0	24	0	0
24	24114417	.	C	T	16	6	22	0	0	22	0	0
24	24114744	.	G	A	15	9	24	0	0	24	0	0
24	24114810	.	A	C	8	9	17	0	0	17	0	0
24	24118213	.	A	C	8	3	11	0	0	11	0	0
24	24118272	.	A	G	8	4	12	0	0	12	0	0
24	24118362	.	C	T	6	8	14	0	1	15	0	0
24	24118366	.	A	T	4	9	13	0	1	14	0	0
24	24119411	.	C	A	2	3	5	0	0	5	0	0
24	24119757	.	G	A	1	2	3	0	0	3	0	0
24	24121130	.	C	T	21	24	45	0	4	49	0	0
24	24121282	.	C	G	3	23	26	0	24	50	0	0
24	24121366	.	A	G	23	18	41	0	2	43	0	0
24	24121375	.	G	C	18	0	18	0	24	42	0	0
24	24121502	.	T	A	14	8	22	0	3	25	0	0
24	24121826	.	G	T	20	23	43	0	1	45	1	0
24	24121851	.	A	T	26	21	47	0	3	50	0	0
24	24124517	.	G	A	26	30	56	0	3	59	0	0
24	24127078	.	A	T	34	13	47	0	0	47	0	0
24	24130794	.	A	G	32	30	62	0	0	62	0	0
24	24130824	.	T	C	31	27	58	0	0	59	1	0
24	24135906	.	G	A	35	19	54	0	2	56	0	0
24	24136047	.	T	G	13	31	44	0	1	45	0	0
24	24146669	.	T	C	28	3	31	0	33	64	0	0
24	24155586	.	T	C	12	13	25	0	4	29	0	0
24	24155607	.	G	A	16	9	25	0	0	25	0	0
24	24155655	.	A	G	13	13	26	0	0	26	0	0
24	24155664	.	C	A	11	12	23	0	1	24	0	0
24	24155718	.	A	T	13	12	25	0	1	26	0	0
24	24163114	.	C	T	7	4	11	0	1	12	0	0
24	24164812	.	A	T	14	16	30	0	0	30	0	0
24	24164935	.	A	C	8	12	20	0	1	21	0	0
24	24168359	.	G	C	29	29	58	0	0	58	0	0
24	24174889	.	T	C	2	4	6	0	0	6	0	0
24	24176103	.	A	G	1	4	5	0	0	5	0	0
24	24176122	.	A	C	1	5	6	0	0	6	0	0
24	24177137	.	A	G	3	7	10	0	1	11	0	0
24	24177158	.	T	C	3	5	8	0	1	9	0	0
24	24177288	.	G	A	2	2	4	0	0	4	0	0
24	24183959	.	T	G	7	4	11	0	0	11	0	0
24	24184394	.	T	C	5	0	5	0	6	11	0	0
24	24184677	.	T	A	6	14	20	0	0	20	0	0
24	24187454	.	T	G	6	3	9	0	0	9	0	0
24	24189345	.	T	A	8	3	11	0	0	11	0	0
24	24189357	.	A	G	7	3	10	0	0	10	0	0
24	24189516	.	C	T	0	4	4	0	4	8	0	0
24	24189543	.	T	C	7	4	11	0	0	11	0	0
24	24189561	.	G	A	6	3	9	0	0	9	0	0
24	24189591	.	C	T	3	4	7	0	0	7	0	0
24	24461710	.	T	A	12	7	19	0	0	19	0	0
24	24462021	.	C	T	15	11	26	0	0	26	0	0
24	24463030	.	T	A	17	14	31	0	0	31	0	0
24	24463060	.	A	G	20	11	31	0	2	33	0	0
24	24701885	.	C	G	7	6	13	0	1	14	0	0
24	24701938	.	T	C	4	9	13	0	2	15	0	0
24	24702674	.	C	T	12	8	20	0	1	21	0	0
24	24702930	.	C	T	0	14	14	0	8	22	0	0
24	24702936	.	T	C	7	13	20	0	0	20	0	0
24	24720991	.	G	A	5	7	12	0	1	13	0	0
24	24745966	.	T	C	4	0	4	0	6	10	0	0
24	24796567	.	C	G	0	4	4	0	2	6	0	0
24	24796811	.	T	C	2	0	2	0	2	4	0	0
24	24796901	.	T	C	4	2	6	0	0	6	0	0
24	24848118	.	C	T	3	24	27	0	17	44	0	0
24	24931465	.	T	C	7	5	12	0	3	15	0	0
24	24934236	.	A	G	11	7	18	0	0	18	0	0
24	24934347	.	T	C	8	4	12	0	2	14	0	0
24	24935527	.	G	A	10	9	19	0	0	19	0	0
24	24935560	.	A	G	9	0	9	0	11	20	0	0
24	24935791	.	G	C	8	5	13	0	0	13	0	0
24	24935810	.	T	C	4	10	14	0	4	18	0	0
24	24944387	.	A	C	7	12	19	0	2	21	0	0
24	24948089	.	T	A	9	9	18	0	1	19	0	0
24	24948101	.	T	A	9	9	18	0	2	20	0	0
24	24950569	.	T	C	6	3	9	0	0	9	0	0
24	24954478	.	T	C	2	5	7	0	0	7	0	0
24	24989293	.	T	G	7	6	13	0	3	16	0	0
24	24989368	.	C	T	0	7	7	0	9	16	0	0
24	24992522	.	G	A	7	5	12	0	1	13	0	0
24	25008884	.	G	A	4	9	13	0	0	13	0	0
24	25008887	.	G	A	4	9	13	0	0	13	0	0
24	25020054	.	T	G	8	3	11	0	0	11	0	0
24	25026278	.	G	A	2	4	6	0	0	6	0	0
24	25026344	.	C	T	0	2	2	0	4	6	0	0
24	25029860	.	T	A	2	2	4	0	0	4	0	0
24	25032485	.	G	A	5	4	9	0	0	9	0	0
24	25041054	.	T	C	2	4	6	0	0	6	0	0
24	25047572	.	C	G	2	0	2	0	6	8	0	0
24	25049209	.	C	T	5	4	9	0	0	9	0	0
24	25049436	.	T	C	5	5	10	0	0	10	0	0
24	25049484	.	T	G	3	3	6	0	0	6	0	0
24	25049658	.	T	C	3	4	7	0	0	7	0	0
24	25052078	.	C	T	5	3	8	0	0	8	0	0
24	25052723	.	T	A	5	7	12	0	0	12	0	0
24	25052774	.	C	T	9	4	13	0	0	13	0	0
24	25053032	.	C	A	12	9	21	0	1	22	0	0
24	25059127	.	C	T	7	4	11	0	0	11	0	0
24	25059129	.	T	C	8	4	12	0	0	12	0	0
24	25059174	.	T	C	3	9	12	0	0	12	0	0
24	25059181	.	G	A	5	8	13	0	0	13	0	0
24	25069670	.	G	A	10	5	15	0	1	16	0	0
24	25069926	.	A	G	8	0	8	0	11	19	0	0
24	25069928	.	T	A	11	7	18	0	2	20	0	0
24	25070289	.	C	T	6	4	10	0	2	12	0	0
24	25070515	.	C	T	4	7	11	0	0	11	0	0
24	25070745	.	G	A	1	6	7	0	9	16	0	0
24	25070921	.	C	T	8	4	12	0	1	13	0	0
24	25070922	.	T	G	8	5	13	0	0	13	0	0
24	25071270	.	T	A	7	11	18	0	0	18	0	0
24	25071474	.	T	C	12	21	33	0	1	34	0	0
24	25071486	.	A	T	19	11	30	0	2	32	0	0
24	25071726	.	G	A	12	4	16	0	0	16	0	0
24	25071742	.	T	C	9	6	15	0	1	16	0	0
24	25072088	.	T	C	10	12	22	0	0	22	0	0
24	25072102	.	T	C	13	7	20	0	0	20	0	0
24	25072311	.	C	T	3	8	11	0	0	11	0	0
24	25072358	.	C	A	5	6	11	0	0	11	0	0
24	25072487	.	A	G	14	16	30	0	0	30	0	0
24	25072511	.	T	G	14	9	23	0	1	24	0	0
24	25072711	.	G	A	16	7	23	0	3	26	0	0
24	25233472	.	A	G	3	3	6	0	0	6	0	0
24	25347794	.	G	T	7	8	15	0	0	15	0	0
24	25348354	.	C	T	7	5	12	0	2	14	0	0
24	25350710	.	G	A	4	4	8	0	1	9	0	0
24	25350712	.	G	A	5	5	10	0	0	10	0	0
24	25351091	.	A	G	2	3	5	0	0	5	0	0
24	25351121	.	T	C	2	3	5	0	0	5	0	0
24	25351368	.	A	T	4	3	7	0	1	8	0	0
24	25351563	.	T	C	2	2	4	0	0	4	0	0
24	25351911	.	C	T	0	5	5	0	4	9	0	0
24	25352109	.	G	A	3	4	7	0	0	7	0	0
24	25352630	.	T	C	2	0	2	0	6	8	0	0
24	25353123	.	G	A	2	2	4	0	0	4	0	0
24	25353132	.	T	C	1	2	3	0	0	3	0	0
24	25359497	.	A	G	1	4	5	0	0	5	0	0
24	25359803	.	A	G	1	2	3	0	0	3	0	0
24	25363324	.	C	G	1	2	3	0	0	3	0	0
24	25448155	.	G	A	11	8	19	0	0	19	0	0
24	25448185	.	C	A	2	8	10	0	4	14	0	0
24	25448800	.	T	C	6	6	12	0	0	12	0	0
24	25448810	.	T	C	7	1	8	0	0	8	0	0
24	25449319	.	G	A	1	4	5	0	0	5	0	0
24	25452620	.	G	A	4	3	7	0	0	7	0	0
24	25454912	.	G	A	4	4	8	0	0	8	0	0
24	25461217	.	T	C	1	0	1	0	3	4	0	0
24	25496133	.	T	C	8	7	15	0	0	15	0	0
24	25496194	.	A	C	1	5	6	0	0	6	0	0
24	25496215	.	T	G	1	5	6	0	0	6	0	0
24	25496271	.	C	T	5	4	9	0	0	9	0	0
24	25496435	.	T	C	3	6	9	0	0	9	0	0
24	25496590	.	T	C	7	5	12	0	0	12	0	0
24	25496789	.	T	C	6	5	11	0	1	12	0	0
24	25497273	.	A	T	4	5	9	0	3	12	0	0
24	25497327	.	T	C	5	4	9	0	0	9	0	0
24	25497353	.	G	A	1	3	4	0	5	9	0	0
24	25497904	.	C	A	1	3	4	0	0	4	0	0
24	25565407	.	T	C	5	1	6	0	5	11	0	0
24	25565556	.	T	C	4	3	7	0	0	7	0	0
24	25575049	.	A	G	6	3	9	0	0	9	0	0
24	25582229	.	A	G	6	6	12	0	0	12	0	0
24	25587684	.	T	C	2	2	4	0	1	5	0	0
24	25635801	.	C	T	4	4	8	0	0	8	0	0
24	25635933	.	G	A	3	5	8	0	0	8	0	0
24	25693003	.	G	A	11	24	35	0	1	36	0	0
24	25693026	.	C	T	24	14	38	0	3	41	0	0
24	25693948	.	A	G	19	22	41	0	1	42	0	0
24	25693992	.	T	A	22	21	43	0	3	47	1	0
24	25694537	.	A	C	19	18	37	0	3	40	0	0
24	25694871	.	G	T	3	2	5	0	0	5	0	0
24	25761963	.	C	A	4	2	6	0	0	6	0	0
24	25762072	.	T	C	4	3	7	0	0	7	0	0
24	25762272	.	G	A	2	5	7	0	1	8	0	0
24	25762491	.	A	G	2	2	4	0	0	4	0	0
24	25762506	.	C	T	2	2	4	0	0	4	0	0
24	25762734	.	C	T	2	3	5	0	1	6	0	0
24	25762884	.	C	T	3	3	6	0	0	6	0	0
24	25763479	.	T	C	3	1	4	0	1	5	0	0
24	25764729	.	T	C	1	0	1	0	2	3	0	0
24	25764756	.	G	A	1	2	3	0	0	3	0	0
24	25794334	.	C	T	1	3	4	0	0	4	0	0
24	25872390	.	C	T	6	8	14	0	0	14	0	0
24	25956470	.	C	T	2	2	4	0	0	4	0	0
24	25987120	.	T	A	1	2	3	0	0	3	0	0
24	25988133	.	C	A	1	4	5	2	0	7	0	0
24	26017133	.	T	C	3	3	6	0	0	6	0	0
24	26017175	.	T	A	4	8	12	0	1	13	0	0
24	26017188	.	A	G	4	7	11	0	0	11	0	0
24	26020514	.	T	G	3	2	5	0	0	5	0	0
24	26021810	.	T	C	1	2	3	0	0	3	0	0
24	26021871	.	G	A	1	2	3	0	2	5	0	0
24	26025151	.	T	C	3	4	7	0	0	7	0	0
24	26025384	.	T	A	1	3	4	0	0	4	0	0
24	26026179	.	A	T	7	3	10	0	1	11	0	0
24	26030340	.	T	G	9	6	15	0	0	15	0	0
24	26030571	.	C	T	6	21	27	0	1	28	0	0
24	26030663	.	T	C	13	10	23	0	0	23	0	0
24	26030827	.	A	C	9	16	25	0	0	25	0	0
24	26030849	.	T	A	13	19	32	0	2	34	0	0
24	26030893	.	G	A	14	16	30	0	0	30	0	0
24	26030985	.	A	T	15	11	26	0	0	26	0	0
24	26039798	.	A	G	3	4	7	0	0	7	0	0
24	26041227	.	T	C	2	2	4	0	0	4	0	0
24	26045132	.	C	T	2	3	5	0	0	5	0	0
24	26045910	.	A	G	2	3	5	0	0	5	0	0
24	26045916	.	T	C	2	3	5	0	0	5	0	0
24	26046618	.	G	A	4	4	8	0	2	10	0	0
24	26046820	.	A	G	3	0	3	0	5	8	0	0
24	26046822	.	T	C	3	5	8	0	0	8	0	0
24	26048017	.	G	A	3	9	12	1	0	13	0	0
24	26049166	.	G	T	4	5	9	0	1	10	0	0
24	26049825	.	T	C	5	5	10	0	1	11	0	0
24	26049946	.	A	C	4	10	14	0	0	14	0	0
24	26050066	.	A	T	9	5	14	0	4	18	0	0
24	26052082	.	T	C	8	5	13	0	0	13	0	0
24	26178446	.	G	A	1	2	3	0	0	3	0	0
24	26196843	.	G	T	1	2	3	0	0	3	0	0
24	26197205	.	G	A	0	3	3	0	2	5	0	0
24	26197291	.	A	G	4	2	6	0	0	6	0	0
24	26197313	.	G	T	3	2	5	0	0	5	0	0
24	26279971	.	C	T	3	2	5	0	0	5	0	0
24	26280058	.	G	A	6	6	12	0	0	12	0	0
24	26280163	.	A	G	5	3	8	0	1	9	0	0
24	26280668	.	A	C	5	2	7	0	1	8	0	0
24	26281680	.	G	T	2	3	5	0	0	5	0	0
24	26284612	.	G	T	9	7	16	0	0	16	0	0
24	26333084	.	T	C	1	3	4	0	0	4	0	0
24	26333597	.	C	T	4	2	6	0	0	6	0	0
24	26333801	.	C	T	6	4	10	0	1	11	0	0
24	26334257	.	G	A	3	2	5	0	0	5	0	0
24	26334299	.	A	G	4	0	4	0	4	8	0	0
24	26342519	.	G	C	0	2	2	1	6	9	0	0
24	26373473	.	G	A	10	4	14	0	1	15	0	0
24	26373498	.	G	A	6	11	17	0	0	17	0	0
24	26376380	.	A	G	12	7	19	0	0	19	0	0
24	26383430	.	A	G	6	3	9	0	0	9	0	0
24	26383604	.	T	A	6	5	11	0	0	11	0	0
24	26383670	.	A	G	4	3	7	0	0	7	0	0
24	26383700	.	C	T	0	6	6	0	1	7	0	0
24	26383829	.	C	T	1	4	5	0	6	11	0	0
24	26383840	.	C	T	6	7	13	0	0	13	0	0
24	26383907	.	T	C	3	7	10	0	0	10	0	0
24	26383971	.	A	C	5	0	5	0	5	10	0	0
24	26406895	.	C	A	9	4	13	0	1	14	0	0
24	26406898	.	A	G	9	0	9	0	4	13	0	0
24	26406967	.	G	T	5	7	12	0	1	13	0	0
24	26415190	.	T	C	7	9	16	0	1	17	0	0
24	26420141	.	T	C	9	9	18	0	0	18	0	0
24	26429443	.	T	C	10	5	15	0	0	15	0	0
24	26429456	.	C	T	8	5	13	0	0	13	0	0
24	26475434	.	C	T	12	13	25	0	0	25	0	0
24	26478889	.	C	T	1	26	27	0	18	45	0	0
24	26482337	.	T	C	38	32	70	0	1	71	0	0
24	26484274	.	A	T	2	3	5	0	0	5	0	0
24	26492113	.	C	T	3	9	12	0	13	25	0	0
24	26492505	.	G	T	7	11	18	0	2	20	0	0
24	26492905	.	G	T	4	8	12	0	0	12	0	0
24	26493029	.	T	G	3	4	7	0	0	7	0	0
24	26493158	.	A	C	7	0	7	0	11	18	0	0
24	26493542	.	C	A	10	14	24	0	1	25	0	0
24	26493691	.	T	A	8	9	17	0	1	18	0	0
24	26494077	.	C	A	8	5	13	0	0	13	0	0
24	26494477	.	C	T	0	11	11	0	7	18	0	0
24	26508886	.	C	T	0	10	10	0	5	15	0	0
24	26511001	.	C	T	10	9	19	0	0	19	0	0
24	26513205	.	T	C	6	4	10	0	1	11	0	0
24	26518811	.	A	G	3	7	10	0	0	10	0	0
24	26527472	.	G	A	6	5	11	0	0	11	0	0
24	26529715	.	G	A	2	2	4	0	0	4	0	0
24	26530814	.	T	A	2	7	9	0	0	9	0	0
24	26558029	.	A	G	6	6	12	0	2	14	0	0
24	26574127	.	C	T	1	2	3	0	0	3	0	0
24	26663739	.	T	C	2	7	9	0	0	9	0	0
24	26663944	.	A	G	2	5	7	0	0	7	0	0
24	26666778	.	G	A	2	3	5	0	1	6	0	0
24	26688607	.	C	T	1	4	5	0	1	6	0	0
24	26692273	.	T	C	1	2	3	0	0	3	0	0
24	26692296	.	A	G	1	2	3	0	0	3	0	0
24	26692396	.	C	G	0	3	3	0	2	5	0	0
24	26701534	.	C	T	2	1	3	0	1	4	0	0
24	26701540	.	C	T	2	2	4	0	0	4	0	0
24	26887490	.	C	A	2	3	5	0	0	5	0	0
24	26889347	.	C	T	3	2	5	0	0	5	0	0
24	26889359	.	G	A	3	3	6	0	0	6	0	0
24	26895836	.	T	G	2	1	3	0	1	4	0	0
24	26901589	.	A	G	1	3	4	0	0	4	0	0
24	26936643	.	G	A	0	2	2	0	2	4	0	0
24	26936839	.	T	C	2	3	5	0	0	5	0	0
24	26936846	.	G	A	3	2	5	0	0	5	0	0
24	26941493	.	T	G	9	2	11	0	1	12	0	0
24	26941496	.	G	T	8	3	11	0	0	11	0	0
24	26941713	.	C	T	12	7	19	0	1	20	0	0
24	26942242	.	C	G	7	8	15	0	0	15	0	0
24	26942711	.	T	C	11	7	18	0	1	19	0	0
24	26942880	.	A	T	11	8	19	0	0	19	0	0
24	26942989	.	G	A	5	3	8	0	0	8	0	0
24	26943103	.	C	G	5	9	14	0	0	14	0	0
24	26943148	.	C	T	5	8	13	0	1	14	0	0
24	26945274	.	T	A	9	3	12	0	1	13	0	0
24	26949426	.	A	C	4	6	10	0	0	10	0	0
24	26949555	.	T	G	5	2	7	0	0	7	0	0
24	26959891	.	T	C	2	0	2	0	6	8	0	0
24	26962107	.	G	A	5	5	10	0	0	10	0	0
24	26962277	.	C	T	6	8	14	0	0	14	0	0
24	26967521	.	C	T	1	4	5	0	0	5	0	0
24	26970404	.	G	A	1	2	3	0	1	4	0	0
24	26970407	.	C	T	2	2	4	0	0	4	0	0
24	26997920	.	G	A	4	3	7	0	0	7	0	0
24	27009231	.	C	A	6	4	10	0	0	10	0	0
24	27011189	.	T	A	4	5	9	0	2	11	0	0
24	27023403	.	C	T	6	5	11	0	0	11	0	0
24	27153245	.	C	T	5	3	8	0	2	10	0	0
24	27168681	.	T	C	1	4	5	0	0	5	0	0
24	27168939	.	C	T	6	4	10	0	0	10	0	0
24	27185574	.	A	G	10	7	17	0	0	17	0	0
24	27203410	.	C	T	4	3	7	1	0	8	0	0
24	27207238	.	G	T	13	10	23	0	0	23	0	0
24	27216987	.	G	A	2	4	6	0	5	11	0	0
24	27222574	.	G	A	13	8	21	0	1	22	0	0
24	27222662	.	C	T	14	10	24	0	2	26	0	0
24	27222731	.	A	G	9	1	10	0	9	19	0	0
24	27222937	.	G	A	3	12	15	0	7	22	0	0
24	27223018	.	C	T	8	5	13	0	0	13	0	0
24	27224064	.	T	A	21	22	43	0	0	43	0	0
24	27224598	.	G	A	5	6	11	0	0	11	0	0
24	27224863	.	C	A	11	5	16	0	1	17	0	0
24	27225096	.	T	C	10	14	24	0	2	26	0	0
24	27225423	.	C	A	18	13	31	0	1	32	0	0
24	27226057	.	C	T	8	9	17	0	0	17	0	0
24	27238808	.	C	T	1	9	10	0	14	24	0	0
24	27238826	.	G	A	10	14	24	0	0	24	0	0
24	27245021	.	C	A	2	2	4	0	0	4	0	0
24	27251249	.	C	T	6	12	18	0	0	18	0	0
24	27399969	.	T	C	3	7	10	0	0	10	0	0
24	28137429	.	G	A	1	2	3	0	1	4	0	0
24	28228993	.	A	T	3	2	5	0	0	5	0	0
24	28242709	.	T	C	3	0	3	0	8	11	0	0
24	28245753	.	G	T	7	6	13	0	1	14	0	0
24	28252898	.	C	A	11	17	28	0	0	28	0	0
24	28253127	.	G	A	6	9	15	0	1	16	0	0
24	28253646	.	A	T	20	10	30	0	0	30	0	0
24	28253663	.	G	A	18	8	26	0	1	27	0	0
24	28253740	.	A	T	18	14	32	0	2	34	0	0
24	28258999	.	G	A	11	9	20	1	0	21	0	0
24	28259134	.	T	C	13	12	25	0	1	26	0	0
24	28263850	.	G	A	9	13	22	1	2	25	0	0
24	28268081	.	T	C	11	16	27	0	1	28	0	0
24	28276193	.	C	T	0	13	13	0	11	24	0	0
24	28293347	.	C	T	1	7	8	0	7	15	0	0
24	28306386	.	T	A	2	2	4	0	0	4	0	0
24	28306413	.	A	C	3	0	3	0	4	7	0	0
24	28306471	.	C	T	3	4	7	0	0	7	0	0
24	28312326	.	T	A	8	5	13	0	0	13	0	0
24	28312359	.	G	A	6	7	13	0	1	14	0	0
24	28312431	.	G	A	8	6	14	0	1	15	0	0
24	28312460	.	A	T	12	9	21	0	0	21	0	0
24	28354675	.	T	G	8	9	17	0	1	18	0	0
24	28381103	.	C	T	3	5	8	0	0	8	0	0
24	28381130	.	T	C	2	5	7	0	0	7	0	0
24	28394446	.	G	T	2	7	9	0	0	9	0	0
24	28394461	.	A	T	4	8	12	0	0	12	0	0
24	28394482	.	C	T	4	5	9	0	0	9	0	0
24	28426363	.	T	G	33	14	47	0	2	49	0	0
24	28426583	.	T	A	20	17	37	0	1	38	0	0
24	28426615	.	G	A	19	20	39	0	3	42	0	0
24	28426705	.	T	A	23	9	32	0	1	33	0	0
24	28426717	.	C	T	1	10	11	0	21	32	0	0
24	28432162	.	A	G	13	18	31	0	0	31	0	0
24	28432297	.	A	C	15	26	41	0	0	41	0	0
24	28432372	.	G	A	13	15	28	0	4	32	0	0
24	28437375	.	A	G	19	19	38	0	2	40	0	0
24	28437405	.	G	A	16	17	33	0	0	33	0	0
24	28437562	.	G	C	8	12	20	0	1	21	0	0
24	28437681	.	C	T	17	8	25	0	1	26	0	0
24	28691389	.	C	T	9	9	18	0	2	20	0	0
24	28691457	.	C	T	0	7	7	0	9	16	0	0
24	28710915	.	G	T	4	3	7	0	0	7	0	0
24	28710953	.	G	A	7	5	12	0	1	13	0	0
24	28711027	.	T	A	4	3	7	0	0	7	0	0
24	28935232	.	A	G	5	5	10	0	0	10	0	0
24	28936801	.	A	T	17	5	22	0	0	22	0	0
24	28960786	.	T	G	15	11	26	0	0	26	0	0
24	28963133	.	C	T	13	10	23	0	2	25	0	0
24	28963445	.	C	T	13	10	23	0	0	23	0	0
24	28963796	.	A	G	2	2	4	0	0	4	0	0
24	28964378	.	A	G	1	3	4	0	0	4	0	0
24	28964393	.	T	C	1	3	4	0	0	4	0	0
24	28966810	.	T	C	10	4	14	0	1	15	0	0
24	28966812	.	T	G	11	4	15	0	0	15	0	0
24	28966892	.	T	C	7	4	11	0	2	13	0	0
24	28967234	.	A	G	1	0	1	0	2	3	0	0
24	29352296	.	T	A	5	5	10	0	0	10	0	0
24	29353340	.	T	A	1	2	3	0	0	3	0	0
24	29382235	.	T	C	7	6	13	0	0	13	0	0
24	29450177	.	T	C	13	7	20	0	1	21	0	0
24	29450195	.	C	T	11	11	22	0	0	22	0	0
24	29450222	.	C	T	10	7	17	0	1	18	0	0
24	29525071	.	C	T	16	16	32	0	0	32	0	0
24	29525169	.	T	A	10	16	26	0	7	33	0	0
24	29961958	.	G	A	3	2	5	0	0	5	0	0
24	29965446	.	T	C	2	0	2	0	9	11	0	0
24	29997145	.	A	T	6	7	13	1	0	14	0	0
24	30067126	.	C	T	1	10	11	0	0	11	0	0
24	31116765	.	T	C	10	4	14	0	0	14	0	0
24	31170701	.	C	T	0	4	4	0	2	6	0	0
24	31176087	.	A	G	1	2	3	0	0	3	0	0
24	31201348	.	T	C	1	2	3	0	0	3	0	0
24	31218903	.	G	T	1	5	6	0	0	6	0	0
24	31222959	.	T	C	1	3	4	0	0	4	0	0
24	31223165	.	T	A	1	2	3	0	0	3	0	0
24	31310981	.	T	G	11	7	18	0	0	18	0	0
24	31311110	.	T	A	12	14	26	0	0	26	0	0
24	31311137	.	A	G	13	11	24	0	0	24	0	0
24	31311185	.	T	G	5	9	14	0	1	15	0	0
24	31315500	.	A	G	8	4	12	0	1	13	0	0
24	31315985	.	A	G	7	5	12	0	1	13	0	0
24	31319044	.	A	G	3	6	9	0	0	9	0	0
24	31319333	.	T	G	4	7	11	0	0	11	0	0
24	31319363	.	A	C	5	12	17	0	0	17	0	0
24	31319544	.	T	C	8	11	19	0	0	19	0	0
24	31319606	.	A	G	4	3	7	0	0	7	0	0
24	31320006	.	A	G	5	3	8	0	0	8	0	0
24	31320049	.	G	A	2	6	8	0	0	8	0	0
24	31322911	.	G	C	5	0	5	0	7	12	0	0
24	31322920	.	A	G	5	7	12	0	0	12	0	0
24	31322950	.	T	G	3	6	9	0	0	9	0	0
24	31323287	.	A	C	6	4	10	0	0	10	0	0
24	31323293	.	G	A	4	5	9	0	1	10	0	0
24	31325202	.	T	C	3	4	7	0	1	8	0	0
24	31330040	.	G	A	4	3	7	0	0	7	0	0
24	31334313	.	A	G	11	22	33	0	2	35	0	0
24	31340562	.	A	C	27	13	40	0	2	42	0	0
24	31340610	.	C	G	32	1	33	1	24	58	0	0
24	31340922	.	A	G	17	0	17	0	27	44	0	0
24	31342684	.	A	G	1	2	3	0	0	3	0	0
24	31342883	.	T	A	2	5	7	0	1	8	0	0
24	31364567	.	G	A	2	5	7	0	0	7	0	0
24	31364622	.	C	T	8	3	11	0	1	12	0	0
24	31367533	.	T	C	6	8	14	0	0	14	0	0
24	31367851	.	G	A	2	2	4	0	0	4	0	0
24	31379892	.	C	G	1	2	3	0	0	3	0	0
24	31393945	.	T	C	4	3	7	0	0	7	0	0
24	31393957	.	A	T	3	4	7	0	0	7	0	0
24	31395718	.	T	C	4	3	7	0	0	7	0	0
24	31397840	.	G	A	6	3	9	0	0	9	0	0
24	32650263	.	T	G	5	10	15	0	1	16	0	0
24	32658868	.	A	C	15	0	15	0	8	23	0	0
24	32674686	.	T	A	10	9	19	0	0	19	0	0
24	32674708	.	C	T	10	6	16	0	0	16	0	0
24	32674886	.	A	G	8	8	16	0	1	17	0	0
24	33687600	.	C	T	1	2	3	0	0	3	0	0
24	33709247	.	C	G	23	26	49	1	1	51	0	0
24	33714797	.	A	G	17	16	33	0	1	34	0	0
24	33714854	.	G	A	20	25	45	0	1	46	0	0
24	33723289	.	C	A	3	14	17	0	17	35	1	0
24	33755683	.	C	T	20	17	37	0	0	37	0	0
24	33767992	.	T	C	6	6	12	0	0	12	0	0
24	33768192	.	G	A	5	2	7	0	0	7	0	0
24	33768346	.	T	A	11	2	13	1	2	16	0	0
24	33768509	.	C	T	9	4	13	0	1	14	0	0
24	33768530	.	G	T	12	5	17	0	2	19	0	0
24	33768705	.	A	G	10	9	19	0	5	24	0	0
24	33774457	.	G	A	6	5	11	0	0	11	0	0
24	33785898	.	G	A	5	10	15	0	0	15	0	0
24	33788330	.	G	A	4	3	7	0	1	8	0	0
24	33792254	.	C	T	1	2	3	0	1	4	0	0
24	33813399	.	G	A	0	2	2	0	2	4	0	0
24	33813891	.	G	C	1	2	3	0	0	3	0	0
24	33824494	.	T	C	2	2	4	0	0	4	0	0
24	33824509	.	G	A	0	2	2	0	2	4	0	0
24	33824590	.	A	G	3	0	3	0	3	6	0	0
24	33824635	.	C	T	3	2	5	0	0	5	0	0
24	33826850	.	C	T	6	2	8	0	1	9	0	0
24	33832513	.	G	A	6	5	11	0	0	11	0	0
24	33835143	.	T	A	1	2	3	0	0	3	0	0
24	33835259	.	T	G	3	2	5	0	0	5	0	0
24	33836490	.	T	A	3	5	8	0	1	9	0	0
24	33836581	.	C	T	3	2	5	1	0	6	0	0
24	33837100	.	C	G	0	3	3	0	0	3	0	0
24	33837343	.	A	G	3	2	5	6	0	11	0	0
24	33837595	.	A	G	3	2	5	0	0	5	0	0
24	33837636	.	G	T	5	3	8	0	0	8	0	0
24	33837790	.	A	G	2	8	10	0	1	11	0	0
24	33837895	.	A	G	4	2	6	2	0	8	0	0
24	33837932	.	A	G	4	0	4	0	2	6	0	0
24	33838097	.	A	G	7	4	11	0	0	11	0	0
24	33838293	.	A	G	7	6	13	0	1	14	0	0
24	33838486	.	G	A	1	4	5	0	0	5	0	0
24	33838876	.	A	G	10	1	11	0	7	18	0	0
24	33838954	.	A	C	6	6	12	0	1	13	0	0
24	33839031	.	G	A	6	13	19	0	2	21	0	0
24	34115661	.	G	C	4	3	7	0	0	7	0	0
24	34115830	.	G	A	1	3	4	0	0	4	0	0
24	34115850	.	G	A	1	3	4	0	3	7	0	0
24	34116386	.	G	C	2	3	5	0	0	5	0	0
24	34116399	.	C	T	1	3	4	0	1	5	0	0
24	34139278	.	G	A	12	9	21	0	0	21	0	0
24	34139317	.	C	T	12	6	18	0	0	18	0	0
24	34139323	.	T	C	7	0	7	0	9	16	0	0
24	34176593	.	C	T	2	3	5	0	0	5	0	0
24	34185156	.	T	C	2	5	7	0	1	8	0	0
24	34208678	.	G	A	5	5	10	0	0	10	0	0
24	34208684	.	T	C	5	5	10	0	0	10	0	0
24	34208747	.	A	G	7	5	12	0	0	12	0	0
24	34284596	.	G	T	18	13	31	0	4	35	0	0
24	34488691	.	T	C	1	2	3	0	0	3	0	0
24	34488697	.	A	T	1	2	3	0	0	3	0	0
24	34607282	.	C	G	8	8	16	0	0	16	0	0
24	34607366	.	C	A	2	2	4	0	0	4	0	0
24	34608653	.	C	T	7	12	19	0	0	19	0	0
24	34608844	.	C	T	6	10	16	0	0	16	0	0
24	34610158	.	A	G	15	1	16	0	11	27	0	0
24	34610215	.	G	T	0	9	9	0	15	24	0	0
24	34610515	.	G	A	15	16	31	0	0	31	0	0
24	34610655	.	G	A	1	5	6	0	13	19	0	0
24	34610874	.	A	G	14	9	23	0	1	24	0	0
24	34610920	.	A	T	16	10	26	0	1	27	0	0
24	34611151	.	T	C	22	11	33	0	1	34	0	0
24	34611211	.	G	A	15	17	32	0	2	34	0	0
24	34611236	.	G	A	3	23	26	0	12	38	0	0
24	34611378	.	G	T	23	14	37	0	2	39	0	0
24	34611407	.	G	C	17	21	38	0	0	38	0	0
24	34611445	.	A	G	17	15	32	0	1	33	0	0
24	34611536	.	G	A	17	18	35	0	0	35	0	0
24	34611623	.	A	G	17	10	27	0	2	29	0	0
24	34611681	.	C	T	19	7	26	0	0	26	0	0
24	34611757	.	T	G	7	11	18	0	2	20	0	0
24	34611915	.	A	G	7	1	8	0	12	20	0	0
24	34612187	.	C	A	15	16	31	0	1	32	0	0
24	34612317	.	G	A	17	19	36	0	2	38	0	0
24	34612327	.	A	T	19	16	35	0	4	39	0	0
24	34612576	.	G	A	4	32	36	0	9	45	0	0
24	34973991	.	C	T	1	6	7	0	0	7	0	0
24	35196166	.	C	T	12	4	16	0	0	16	0	0
24	35213755	.	T	C	16	12	28	0	1	29	0	0
24	35213764	.	G	A	2	13	15	0	14	29	0	0
24	35216439	.	A	T	14	18	32	0	4	37	1	0
24	35216835	.	A	G	9	8	17	0	3	20	0	0
24	35216973	.	C	T	7	10	17	0	4	21	0	0
24	35217222	.	A	T	14	9	23	0	1	24	0	0
24	35217255	.	G	A	4	10	14	0	0	14	0	0
24	35217258	.	C	G	3	8	11	0	1	12	0	0
24	35217311	.	T	A	11	1	12	0	0	12	0	0
24	35217426	.	C	T	11	11	22	0	4	26	0	0
24	35522379	.	A	T	13	5	18	1	2	21	0	0
24	35522568	.	C	T	28	22	50	0	2	52	0	0
24	35522962	.	A	G	23	21	44	0	2	46	0	0
24	35523088	.	A	T	18	33	51	2	10	63	0	0
24	35523134	.	T	A	38	17	55	2	1	58	0	0
24	35530249	.	T	G	26	20	46	0	1	47	0	0
24	35536845	.	C	T	2	2	4	0	0	4	0	0
24	35536875	.	T	A	4	2	6	0	1	7	0	0
24	35536906	.	C	A	3	3	6	0	0	6	0	0
24	35536927	.	T	A	3	2	5	0	0	5	0	0
24	35565350	.	C	G	6	0	6	0	6	12	0	0
24	35681625	.	G	A	24	17	41	0	3	44	0	0
24	35681753	.	G	A	28	29	57	1	0	58	0	0
24	35683349	.	T	C	21	23	44	0	3	47	0	0
24	35683883	.	A	G	17	21	38	0	3	41	0	0
24	35686180	.	A	G	19	18	37	0	0	37	0	0
24	35692741	.	C	T	2	15	17	0	20	37	0	0
24	35713710	.	T	C	4	4	8	0	0	8	0	0
24	35713835	.	G	A	4	6	10	0	0	10	0	0
24	35720498	.	C	T	2	8	10	0	6	16	0	0
24	35735837	.	C	T	6	4	10	0	0	10	0	0
24	35742791	.	A	G	3	6	9	0	1	10	0	0
24	35749016	.	C	T	0	2	2	0	1	3	0	0
24	35767462	.	C	T	5	5	10	0	0	10	0	0
24	35899358	.	A	G	2	1	3	0	6	9	0	0
24	35906191	.	G	A	1	5	6	0	6	12	0	0
24	35923708	.	T	C	2	2	4	0	1	5	0	0
24	35925145	.	T	C	6	2	8	0	0	8	0	0
24	35925163	.	C	A	6	3	9	0	0	9	0	0
24	35925499	.	T	C	5	5	10	0	1	11	0	0
24	35925529	.	T	C	4	4	8	0	0	8	0	0
24	35926460	.	C	T	2	6	8	0	0	8	0	0
24	35927589	.	G	A	0	3	3	0	2	5	0	0
24	35927598	.	C	T	2	3	5	0	0	5	0	0
24	35929814	.	A	C	4	3	7	0	0	7	0	0
24	35930005	.	A	C	5	3	8	0	1	9	0	0
24	35930056	.	T	G	3	3	6	0	0	6	0	0
24	36027212	.	T	C	10	18	28	0	1	29	0	0
24	36166121	.	T	G	5	6	11	0	0	11	0	0
24	36166196	.	A	G	6	5	11	0	1	12	0	0
24	36175078	.	G	A	5	4	9	0	0	9	0	0
24	36175099	.	T	G	2	5	7	0	0	7	0	0
24	36175205	.	G	A	6	5	11	0	0	11	0	0
24	36175208	.	C	T	5	5	10	0	0	10	0	0
24	36177597	.	A	C	5	5	10	0	0	10	0	0
24	36177609	.	T	C	7	7	14	0	0	14	0	0
24	36177713	.	T	C	5	0	5	0	4	9	0	0
24	36178063	.	C	G	6	5	11	0	0	11	0	0
24	36182443	.	A	G	7	5	12	0	0	12	0	0
24	36182455	.	G	A	6	5	11	0	0	11	0	0
24	36182503	.	G	C	4	6	10	0	0	10	0	0
24	36185723	.	G	A	2	4	6	0	1	7	0	0
24	36186986	.	G	A	7	5	12	0	0	12	0	0
24	36186987	.	T	A	6	5	11	0	0	12	1	0
24	36187507	.	G	T	4	3	7	0	0	7	0	0
24	36187933	.	A	T	4	4	8	0	0	8	0	0
24	36187963	.	C	T	1	4	5	0	2	7	0	0
24	36193431	.	C	T	0	2	2	0	1	3	0	0
24	36193557	.	C	A	1	7	8	0	2	10	0	0
24	36193974	.	G	A	1	2	3	0	0	3	0	0
24	36193988	.	T	G	2	2	4	0	0	4	0	0
24	36194151	.	G	A	1	2	3	0	0	3	0	0
24	36194535	.	A	T	3	3	6	0	0	6	0	0
24	36194586	.	G	A	3	4	7	0	0	7	0	0
24	36194721	.	T	A	2	3	5	0	0	5	0	0
24	36194736	.	C	T	2	4	6	0	0	6	0	0
24	36223627	.	T	C	2	4	6	0	1	7	0	0
24	36227850	.	A	C	1	0	1	0	2	3	0	0
24	36244407	.	C	T	4	6	10	0	0	10	0	0
24	36247261	.	A	T	4	8	12	0	3	15	0	0
24	36247537	.	C	T	4	3	7	0	0	7	0	0
24	36248705	.	C	T	4	4	8	0	0	8	0	0
24	36249910	.	G	T	2	6	8	0	0	8	0	0
24	36250403	.	T	C	7	7	14	0	0	14	0	0
24	36253324	.	C	T	22	25	47	0	0	47	0	0
24	36261389	.	C	A	1	1	2	0	1	3	0	0
24	36261666	.	T	C	4	4	8	0	0	8	0	0
24	36261730	.	C	T	2	4	6	0	5	11	0	0
24	36266460	.	C	A	4	2	6	0	0	6	0	0
24	36266484	.	A	G	4	2	6	0	0	6	0	0
24	36271269	.	T	A	11	6	17	0	0	17	0	0
24	36271274	.	T	A	8	6	14	0	2	16	0	0
24	36276087	.	A	G	1	2	3	0	0	3	0	0
24	36276363	.	A	G	5	11	16	0	1	17	0	0
24	36276364	.	G	T	6	11	17	0	0	17	0	0
24	36280272	.	A	G	9	8	17	0	1	18	0	0
24	36280296	.	T	G	9	8	17	0	0	17	0	0
24	36284470	.	G	A	8	4	12	0	0	12	0	0
24	36287396	.	G	T	7	6	13	0	2	15	0	0
24	36289642	.	T	C	3	2	5	0	0	5	0	0
24	36295355	.	C	T	4	2	6	0	0	6	0	0
24	36295445	.	C	T	0	3	3	0	6	9	0	0
24	36295448	.	C	T	6	3	9	0	0	9	0	0
24	36295817	.	A	G	1	6	7	0	0	7	0	0
24	36295833	.	G	C	1	5	6	0	0	6	0	0
24	36298928	.	G	A	1	3	4	0	0	4	0	0
24	36298934	.	G	A	3	3	6	0	0	6	0	0
24	36298963	.	A	G	4	2	6	0	0	6	0	0
24	36301035	.	T	G	3	3	6	0	0	6	0	0
24	36325256	.	C	G	6	2	8	0	1	9	0	0
24	36325262	.	C	G	5	2	7	0	2	9	0	0
24	36329292	.	A	G	4	7	11	0	0	11	0	0
24	36329516	.	A	G	1	2	3	0	0	3	0	0
24	36331134	.	T	A	1	5	6	0	0	6	0	0
24	36331150	.	A	G	1	5	6	0	0	6	0	0
24	36331180	.	G	C	2	4	6	0	0	6	0	0
24	36334589	.	G	A	1	3	4	0	0	4	0	0
24	36334677	.	T	C	3	6	9	0	0	9	0	0
24	36334724	.	A	G	4	5	9	0	0	9	0	0
24	36334848	.	A	G	5	5	10	0	0	10	0	0
24	36334857	.	G	A	6	5	11	0	1	12	0	0
24	36335024	.	C	G	5	4	9	0	0	9	0	0
24	36335106	.	A	T	5	5	10	0	0	10	0	0
24	36335139	.	T	C	7	0	7	0	6	13	0	0
24	36335196	.	C	G	1	5	6	0	0	6	0	0
24	36349911	.	C	T	2	4	6	0	0	6	0	0
24	36349915	.	G	A	2	4	6	0	0	6	0	0
24	36362031	.	G	C	5	3	8	0	0	8	0	0
24	36362141	.	T	C	4	9	13	0	1	14	0	0
24	36364389	.	T	A	2	2	4	0	0	4	0	0
24	36364454	.	A	G	5	3	8	0	2	10	0	0
24	37319839	.	G	A	1	7	8	0	0	8	0	0
24	37329628	.	T	A	9	0	9	0	1	10	0	0
24	37634889	.	G	T	1	3	4	0	0	4	0	0
24	37650077	.	C	T	1	2	3	0	0	3	0	0
24	37650143	.	A	G	1	0	1	0	4	5	0	0
24	37650146	.	T	C	1	4	5	0	0	5	0	0
24	37653261	.	C	T	2	2	4	0	0	4	0	0
24	37655196	.	A	T	3	5	8	0	1	9	0	0
24	37655213	.	C	T	5	3	8	0	0	8	0	0
24	37661443	.	T	A	2	2	4	0	0	4	0	0
24	37661474	.	A	G	1	2	3	0	0	3	0	0
24	37661949	.	C	T	2	2	4	0	1	5	0	0
24	37681556	.	G	T	3	2	5	0	0	5	0	0
24	37685925	.	C	T	8	3	11	0	0	11	0	0
24	37685942	.	C	T	0	8	8	0	3	11	0	0
24	37689919	.	T	C	32	28	60	0	0	60	0	0
24	37692529	.	G	A	37	22	59	0	2	61	0	0
24	37695799	.	T	C	1	1	2	0	0	2	0	0
24	37695870	.	C	T	0	6	6	0	3	9	0	0
24	37696508	.	T	C	3	7	10	0	1	11	0	0
24	37704287	.	G	C	2	8	10	0	0	10	0	0
24	37708017	.	T	C	3	4	7	0	0	7	0	0
24	37708207	.	T	A	4	7	11	0	0	11	0	0
24	37708288	.	A	C	3	6	9	0	0	9	0	0
24	37711607	.	A	G	1	3	4	0	1	5	0	0
24	37718769	.	T	C	2	3	5	0	0	5	0	0
24	37718813	.	C	T	1	2	3	0	0	3	0	0
24	37722245	.	T	C	1	2	3	0	0	3	0	0
24	37723056	.	G	A	2	2	4	0	0	4	0	0
24	37723096	.	G	A	1	4	5	0	0	5	0	0
24	37724045	.	A	T	6	2	8	0	0	8	0	0
24	37725260	.	T	G	1	2	3	0	2	5	0	0
24	37725817	.	G	A	5	1	6	0	2	8	0	0
24	37725860	.	T	G	2	6	8	0	0	8	0	0
24	37726004	.	G	A	2	5	7	0	0	7	0	0
24	37726367	.	C	T	3	2	5	0	0	5	0	0
24	37726377	.	A	G	2	3	5	0	0	5	0	0
24	37726649	.	G	A	1	4	5	0	5	10	0	0
24	37726867	.	C	G	3	5	8	0	0	8	0	0
24	37726991	.	C	T	1	5	6	0	1	7	0	0
24	37746094	.	G	A	1	7	8	0	4	12	0	0
24	37752430	.	C	T	5	4	9	0	1	10	0	0
24	37774244	.	C	T	3	3	6	0	0	6	0	0
24	37781428	.	G	A	11	5	16	0	0	16	0	0
24	37781446	.	C	T	4	9	13	0	1	14	0	0
24	37791099	.	C	T	3	9	12	0	0	12	0	0
24	37793276	.	C	A	9	9	18	0	1	19	0	0
24	37793282	.	C	T	9	11	20	0	3	23	0	0
24	37793315	.	C	T	7	9	16	0	0	16	0	0
24	37793725	.	C	T	8	5	13	0	2	15	0	0
24	37799821	.	G	T	0	2	2	0	1	3	0	0
24	37799822	.	A	G	1	2	3	0	0	3	0	0
24	37799941	.	T	C	1	2	3	0	0	3	0	0
24	37800119	.	A	T	1	4	5	0	0	5	0	0
24	37800433	.	C	T	1	2	3	0	0	3	0	0
24	37802119	.	T	G	2	0	2	0	7	9	0	0
24	37818456	.	T	C	6	8	14	0	0	14	0	0
24	37818469	.	C	G	8	4	12	0	1	13	0	0
24	37818500	.	A	T	1	5	6	0	0	6	0	0
24	37818511	.	G	A	4	3	7	0	0	7	0	0
24	37823329	.	T	C	2	2	4	0	0	4	0	0
24	37836280	.	C	G	1	2	3	0	1	4	0	0
24	37844852	.	A	G	4	2	6	0	1	7	0	0
24	37888518	.	C	T	1	5	6	0	0	6	0	0
24	37893269	.	A	G	1	4	5	0	0	5	0	0
24	37893391	.	A	T	1	2	3	0	1	4	0	0
24	37895022	.	C	T	4	2	6	0	1	7	0	0
24	37896875	.	C	T	5	2	7	0	0	7	0	0
24	37897208	.	G	C	4	5	9	0	0	9	0	0
24	37900945	.	G	A	1	4	5	0	4	9	0	0
24	37901148	.	A	G	5	4	9	0	0	9	0	0
24	37901178	.	C	T	6	3	9	0	0	9	0	0
24	37941922	.	A	C	10	2	12	0	1	13	0	0
24	37942183	.	A	T	2	3	5	0	0	5	0	0
24	37943725	.	A	C	3	2	5	0	0	5	0	0
24	38073247	.	A	G	6	13	19	0	0	19	0	0
24	38073271	.	G	A	15	15	30	0	0	30	0	0
24	38073625	.	A	G	7	12	19	0	1	20	0	0
24	38073712	.	C	T	9	12	21	0	0	21	0	0
24	38073754	.	A	C	8	18	26	0	1	27	0	0
24	38174887	.	T	A	1	2	3	0	0	3	0	0
24	38187937	.	T	C	3	2	5	0	0	5	0	0
24	38189538	.	G	A	2	4	6	0	0	6	0	0
24	38189702	.	A	C	4	5	9	0	0	9	0	0
24	38190121	.	A	G	3	7	10	0	0	10	0	0
24	38190387	.	T	C	6	2	8	0	0	8	0	0
24	38190396	.	A	C	8	4	12	0	0	12	0	0
24	38190460	.	G	C	7	4	11	0	0	11	0	0
24	38190654	.	T	C	2	3	5	0	0	5	0	0
24	38190868	.	A	G	3	3	6	0	0	6	0	0
24	38190894	.	G	A	2	4	6	0	1	7	0	0
24	38190968	.	A	T	2	2	4	0	0	5	1	0
24	38191164	.	G	T	1	2	3	0	0	3	0	0
24	38191202	.	T	C	1	3	4	0	0	4	0	0
24	38191227	.	A	T	1	1	2	0	0	2	0	0
24	38191525	.	A	C	1	5	6	0	0	6	0	0
24	38191537	.	C	T	1	7	8	0	0	8	0	0
24	38191590	.	T	C	3	7	10	0	0	10	0	0
24	38191643	.	A	G	5	3	8	0	0	8	0	0
24	38191652	.	A	T	7	3	10	0	0	10	0	0
24	38191841	.	C	T	3	3	6	0	0	6	0	0
24	38369559	.	T	A	16	16	32	0	3	35	0	0
24	38369873	.	G	A	24	22	46	0	0	46	0	0
24	38370188	.	A	G	14	7	21	0	2	23	0	0
24	38370245	.	C	G	0	12	12	0	14	26	0	0
24	38370443	.	C	T	2	12	14	0	14	28	0	0
24	38370998	.	A	G	7	11	18	0	2	20	0	0
24	38371178	.	A	G	8	8	16	0	3	19	0	0
24	38384245	.	A	T	5	7	12	0	1	13	0	0
24	38618659	.	C	T	1	2	3	0	0	3	0	0
24	38618668	.	G	A	1	2	3	0	1	4	0	0
24	38815105	.	T	A	6	2	8	0	0	8	0	0
24	38816010	.	G	T	2	4	6	0	0	6	0	0
24	39051126	.	C	T	5	7	12	0	0	12	0	0
24	39051803	.	A	C	3	9	12	0	2	14	0	0
24	39051981	.	G	A	0	4	4	0	10	14	0	0
24	39052200	.	C	T	10	7	17	0	0	17	0	0
24	39052236	.	G	T	1	12	13	0	8	21	0	0
24	39052302	.	G	A	10	6	16	0	0	16	0	0
24	39052311	.	C	T	5	9	14	0	1	15	0	0
24	39052410	.	C	T	5	4	9	0	1	10	0	0
24	39073885	.	G	A	0	4	4	0	11	15	0	0
24	39075534	.	T	C	8	6	14	0	1	15	0	0
24	39078597	.	A	G	7	0	7	0	9	16	0	0
24	39081150	.	C	T	3	3	6	0	1	7	0	0
24	39137777	.	G	A	1	7	8	0	12	20	0	0
24	39137785	.	G	T	9	10	19	0	1	20	0	0
24	39151075	.	A	G	6	13	19	0	0	19	0	0
24	39152107	.	A	G	8	5	13	0	1	14	0	0
24	39152504	.	A	G	3	7	10	0	0	10	0	0
24	39152523	.	A	G	3	7	10	0	0	10	0	0
24	39152794	.	A	G	16	7	23	0	1	24	0	0
24	39152798	.	A	G	20	4	24	0	1	25	0	0
24	39153010	.	C	G	9	3	12	1	0	13	0	0
24	39154230	.	A	G	27	11	38	0	1	39	0	0
24	39214185	.	G	A	1	2	3	0	0	3	0	0
24	39217715	.	G	A	5	3	8	0	0	8	0	0
24	39268891	.	A	G	8	14	22	0	0	22	0	0
24	39272041	.	A	G	3	9	12	0	0	12	0	0
24	39274821	.	A	G	6	3	9	0	0	9	0	0
24	39277575	.	C	G	12	4	16	0	1	17	0	0
24	39287210	.	A	G	3	8	11	0	3	14	0	0
24	39295664	.	T	C	4	7	11	0	1	12	0	0
24	39298214	.	C	T	5	7	12	0	0	12	0	0
24	39309684	.	A	G	6	0	6	0	6	12	0	0
24	39309889	.	A	T	12	12	24	0	0	24	0	0
24	39310129	.	G	A	2	5	7	0	1	8	0	0
24	39310163	.	G	T	2	5	7	0	1	8	0	0
24	39310253	.	C	T	7	6	13	0	0	13	0	0
24	39321017	.	T	C	24	21	45	0	2	47	0	0
24	39322945	.	G	T	2	23	25	0	24	49	0	0
24	39323791	.	C	T	19	29	48	0	0	48	0	0
24	39333916	.	C	T	17	26	43	0	2	45	0	0
24	39334153	.	T	G	23	17	40	0	1	41	0	0
24	39334388	.	A	G	15	27	42	0	1	43	0	0
24	39334681	.	G	T	12	38	50	0	3	53	0	0
24	39334796	.	G	A	1	7	8	0	21	29	0	0
24	39510891	.	T	C	8	4	12	0	0	12	0	0
24	39511016	.	T	C	9	3	12	0	2	14	0	0
24	39511034	.	G	A	9	2	11	0	1	12	0	0
24	39511157	.	G	A	1	7	8	0	1	9	0	0
24	39514075	.	A	C	3	10	13	0	0	13	0	0
24	39514296	.	C	G	7	8	15	0	0	15	0	0
24	39518554	.	C	G	1	10	11	0	9	20	0	0
24	39530034	.	G	A	1	5	6	0	4	10	0	0
24	39533836	.	C	T	3	3	6	0	0	6	0	0
24	39533987	.	T	A	6	10	16	0	1	17	0	0
24	39534488	.	A	G	1	0	1	0	7	8	0	0
24	39534490	.	A	G	3	0	3	0	5	8	0	0
24	39534532	.	A	G	3	0	3	0	9	12	0	0
24	39537605	.	C	T	2	3	5	0	0	5	0	0
24	39544398	.	G	A	1	4	5	0	0	5	0	0
24	39549379	.	C	T	1	6	7	0	0	7	0	0
24	39549427	.	A	G	1	0	1	0	3	4	0	0
24	39556276	.	G	T	1	2	3	0	3	6	0	0
24	39556324	.	G	A	3	2	5	0	0	5	0	0
24	39556716	.	C	G	2	3	5	0	0	5	0	0
24	39559345	.	A	G	4	0	4	0	3	7	0	0
24	39559356	.	C	T	3	4	7	0	0	7	0	0
24	39576071	.	A	T	4	2	6	0	2	8	0	0
24	39576166	.	G	A	0	4	4	0	3	7	0	0
24	39576247	.	C	T	3	3	6	0	0	6	0	0
24	39576414	.	C	T	3	2	5	0	0	5	0	0
24	39579443	.	C	T	4	5	9	0	0	9	0	0
24	39579569	.	G	A	5	7	12	0	0	12	0	0
24	39579730	.	A	G	2	2	4	0	0	4	0	0
24	39579989	.	G	A	2	7	9	0	4	13	0	0
24	39586778	.	A	T	5	8	13	0	0	13	0	0
24	39587369	.	C	G	10	7	17	0	0	17	0	0
24	39593009	.	T	C	10	4	14	0	0	14	0	0
24	39593038	.	G	A	0	6	6	0	8	14	0	0
24	39595866	.	A	C	9	7	16	0	1	17	0	0
24	39606237	.	G	A	22	18	40	2	1	43	0	0
24	39610535	.	G	T	15	11	26	0	0	26	0	0
24	39615224	.	T	G	2	4	6	0	3	10	1	0
24	39615628	.	T	G	1	2	3	1	0	4	0	0
24	39615640	.	G	A	5	2	7	5	0	12	0	0
24	39616170	.	C	A	4	8	12	0	0	12	0	0
24	39620548	.	A	G	2	1	3	0	3	6	0	0
24	39638642	.	G	A	16	21	37	0	0	37	0	0
24	39642072	.	A	T	9	10	19	0	0	19	0	0
24	39642220	.	A	G	8	6	14	0	0	14	0	0
24	39642229	.	A	G	8	6	14	0	0	14	0	0
24	39642336	.	C	A	11	11	22	1	0	23	0	0
24	39642361	.	G	T	13	11	24	0	2	26	0	0
24	39644259	.	T	C	18	16	34	0	0	34	0	0
24	39646762	.	C	T	16	20	36	0	1	37	0	0
24	39647042	.	G	C	21	23	44	0	3	47	0	0
24	39648806	.	C	T	27	23	50	0	1	51	0	0
24	39651567	.	T	G	20	27	47	0	1	48	0	0
24	39651612	.	A	T	26	20	46	0	5	51	0	0
24	39653626	.	G	A	24	16	40	14	1	55	0	0
24	39660219	.	C	T	9	11	20	0	0	20	0	0
24	39661890	.	T	A	12	12	24	0	2	26	0	0
24	39661905	.	C	T	14	12	26	0	0	26	0	0
24	39662074	.	T	C	11	13	24	0	0	24	0	0
24	39663197	.	A	G	6	18	24	0	0	24	0	0
24	39667152	.	A	T	31	5	36	1	2	39	0	0
24	39667348	.	T	C	9	11	20	3	0	23	0	0
24	39742273	.	G	A	3	5	8	0	0	8	0	0
24	39742336	.	G	A	2	2	4	0	1	5	0	0
24	39742396	.	G	A	4	4	8	0	0	8	0	0
24	39742786	.	T	A	5	9	14	0	0	14	0	0
24	39742869	.	G	T	6	5	11	0	0	11	0	0
24	39771659	.	G	T	5	5	10	0	0	10	0	0
24	39771864	.	T	C	2	2	4	0	0	4	0	0
24	39771976	.	G	A	10	4	14	0	0	14	0	0
24	39771983	.	A	G	10	5	15	0	0	15	0	0
24	39781817	.	T	C	1	2	3	0	0	3	0	0
24	40498708	.	G	A	1	4	5	0	1	6	0	0
24	40498712	.	C	A	1	5	6	0	0	6	0	0
24	40499819	.	C	T	2	2	4	0	0	4	0	0
24	40608954	.	C	T	5	11	16	0	0	16	0	0
24	40608962	.	G	T	7	9	16	0	1	17	0	0
24	40609001	.	A	G	8	7	15	0	0	15	0	0
24	40624408	.	T	C	13	12	25	0	0	25	0	0
24	40633168	.	T	C	6	4	10	0	1	11	0	0
24	40648270	.	C	T	19	15	34	1	1	36	0	0
24	40648284	.	T	A	21	17	38	1	1	40	0	0
24	40876839	.	G	A	1	2	3	7	0	10	0	0
24	40876873	.	G	T	2	3	5	0	0	5	0	0
24	40881213	.	T	C	4	0	4	1	2	7	0	0
24	40881240	.	T	A	2	2	4	1	0	5	0	0
24	40885816	.	A	G	1	6	7	0	0	7	0	0
24	40885828	.	T	C	1	7	8	0	0	8	0	0
24	40892759	.	C	T	0	4	4	1	4	9	0	0
24	41262783	.	G	C	1	2	3	0	0	3	0	0
24	41281297	.	T	C	1	2	3	0	0	3	0	0
24	41290602	.	G	A	0	2	2	0	4	6	0	0
24	41290604	.	G	A	5	2	7	0	0	7	0	0
24	41290712	.	C	T	2	7	9	0	0	9	0	0
24	41291588	.	C	T	8	3	11	0	1	12	0	0
24	41317090	.	A	T	22	8	30	0	10	41	1	0
24	41317132	.	G	A	11	14	25	2	2	29	0	0
24	41317285	.	T	A	6	18	24	2	1	27	0	0
24	41317287	.	T	A	7	17	24	2	2	28	0	0
24	41317350	.	G	C	9	2	11	1	15	27	0	0
24	41473576	.	T	C	14	0	14	0	11	25	0	0
24	41473618	.	G	A	18	6	24	0	0	24	0	0
24	41473627	.	G	A	16	3	19	0	0	19	0	0
24	41478831	.	C	T	10	9	19	0	0	19	0	0
24	41560146	.	G	A	1	5	6	0	0	6	0	0
24	41757941	.	C	A	1	4	5	0	0	5	0	0
24	41767752	.	A	G	1	3	4	0	0	4	0	0
24	41770723	.	A	T	3	2	5	0	1	6	0	0
24	41773216	.	G	C	0	4	4	0	3	7	0	0
24	41773287	.	A	T	4	2	6	0	1	7	0	0
24	41773318	.	C	T	4	5	9	0	0	9	0	0
24	41781968	.	C	T	2	10	12	0	0	12	0	0
24	41783906	.	G	A	0	7	7	0	5	12	0	0
24	41783999	.	C	T	6	9	15	0	1	16	0	0
24	41786304	.	G	A	2	3	5	0	0	5	0	0
24	41791707	.	A	G	1	3	4	0	0	4	0	0
24	41916447	.	G	T	6	5	11	0	0	11	0	0
24	41916584	.	G	A	3	4	7	0	0	7	0	0
24	41916677	.	A	G	6	0	6	0	4	10	0	0
24	41916887	.	G	A	3	10	13	0	0	13	0	0
24	41917543	.	T	C	7	6	13	0	0	13	0	0
24	41954781	.	C	T	9	9	18	0	0	18	0	0
24	41964610	.	G	A	0	8	8	0	14	22	0	0
24	41965111	.	G	A	11	14	25	0	1	26	0	0
24	41965147	.	T	C	8	16	24	0	2	26	0	0
24	41974704	.	G	A	19	14	33	0	2	35	0	0
24	41974736	.	C	T	20	16	36	0	2	38	0	0
24	41974769	.	C	T	22	17	39	0	4	43	0	0
24	41986273	.	C	T	14	27	41	1	3	45	0	0
24	41986311	.	C	A	17	29	46	0	1	47	0	0
24	41986704	.	C	T	14	28	42	0	0	42	0	0
24	41989416	.	C	G	5	3	8	0	0	8	0	0
24	41991010	.	A	G	8	12	20	0	0	20	0	0
24	41994096	.	G	A	9	8	17	0	1	18	0	0
24	41994147	.	G	T	12	7	19	0	1	20	0	0
24	42007915	.	C	T	1	2	3	0	0	3	0	0
24	42008582	.	G	A	0	2	2	0	2	4	0	0
24	42061316	.	T	A	5	4	9	0	0	9	0	0
24	42061364	.	G	T	4	3	7	0	0	7	0	0
24	42061369	.	C	T	4	4	8	0	0	8	0	0
24	42061460	.	A	G	3	5	8	0	0	8	0	0
24	42083840	.	G	A	13	9	22	0	1	23	0	0
24	42083876	.	A	G	13	13	26	0	0	26	0	0
24	42083906	.	G	A	10	14	24	0	0	24	0	0
24	42090574	.	A	T	13	14	27	0	3	30	0	0
24	42102647	.	G	A	5	2	7	0	0	7	0	0
24	42105278	.	C	A	4	3	7	0	0	7	0	0
24	42117761	.	A	G	10	9	19	0	1	20	0	0
24	42118145	.	C	T	4	10	14	0	0	14	0	0
24	42120459	.	G	C	8	5	13	0	0	13	0	0
24	42132148	.	C	T	3	5	8	16	0	24	0	0
24	42133270	.	G	A	0	9	9	7	14	30	0	0
24	42133646	.	C	T	6	13	19	6	1	26	0	0
24	42139889	.	C	T	15	11	26	0	2	28	0	0
24	42141460	.	C	T	6	6	12	0	0	12	0	0
24	42141560	.	T	C	5	0	5	2	6	13	0	0
24	42141793	.	A	G	9	14	23	0	1	24	0	0
24	42142938	.	C	T	8	18	26	0	0	26	0	0
24	42148189	.	G	A	5	14	19	0	0	19	0	0
24	42153199	.	C	T	3	11	14	1	2	17	0	0
24	42153205	.	C	T	3	12	15	1	1	17	0	0
24	42153476	.	G	A	1	13	14	0	15	29	0	0
24	42153503	.	G	A	17	7	24	0	3	27	0	0
24	42157498	.	C	T	10	16	26	0	0	26	0	0
24	42157571	.	A	G	16	10	26	0	1	27	0	0
24	42157602	.	C	T	16	11	27	0	0	27	0	0
24	42157817	.	C	T	3	2	5	0	0	5	0	0
25	14095	.	C	T	4	9	13	0	2	15	0	0
25	15467	.	C	T	12	10	22	0	0	22	0	0
25	15542	.	T	C	12	8	20	0	1	21	0	0
25	15764	.	A	G	15	1	16	0	10	26	0	0
25	127683	.	T	G	2	0	2	0	6	8	0	0
25	136788	.	T	C	17	13	30	1	1	32	0	0
25	136857	.	C	T	27	6	33	0	1	34	0	0
25	136986	.	C	T	27	7	34	0	2	36	0	0
25	137043	.	C	A	8	6	14	2	1	17	0	0
25	137492	.	C	A	10	7	17	1	4	22	0	0
25	146159	.	G	A	3	31	34	0	24	58	0	0
25	146282	.	C	T	30	17	47	0	1	48	0	0
25	146735	.	C	G	21	26	47	0	0	47	0	0
25	154440	.	C	T	6	4	10	0	0	10	0	0
25	156522	.	C	T	7	6	13	0	0	13	0	0
25	156608	.	C	T	2	6	8	0	0	8	0	0
25	157023	.	A	G	1	0	1	0	5	6	0	0
25	157151	.	T	C	6	4	10	0	1	11	0	0
25	157157	.	C	T	8	6	14	0	1	15	0	0
25	157389	.	T	C	3	7	10	0	1	11	0	0
25	157996	.	C	A	3	13	16	0	0	16	0	0
25	158641	.	T	C	11	4	15	0	1	16	0	0
25	158770	.	C	T	9	10	19	0	1	20	0	0
25	159510	.	C	T	12	11	23	0	0	23	0	0
25	159543	.	T	C	12	9	21	0	1	22	0	0
25	196495	.	T	C	36	29	65	0	3	68	0	0
25	203396	.	T	C	21	22	43	0	8	51	0	0
25	237012	.	G	A	5	6	11	0	0	11	0	0
25	238295	.	G	C	1	7	8	0	2	10	0	0
25	238588	.	A	G	5	6	11	0	0	11	0	0
25	241694	.	C	T	6	5	11	0	0	11	0	0
25	241695	.	A	G	6	5	11	0	0	11	0	0
25	244115	.	C	T	3	6	9	0	2	11	0	0
25	265570	.	A	G	3	6	9	0	1	10	0	0
25	314968	.	G	C	2	2	4	0	0	4	0	0
25	317297	.	C	A	3	2	5	0	0	5	0	0
25	317567	.	T	C	2	0	2	0	2	4	0	0
25	388320	.	C	A	1	3	4	0	0	4	0	0
25	399657	.	G	A	3	2	5	0	0	5	0	0
25	400361	.	G	A	0	2	2	0	4	6	0	0
25	401039	.	C	T	1	5	6	0	0	6	0	0
25	401363	.	T	C	4	7	11	0	0	11	0	0
25	401558	.	C	A	6	7	13	0	4	17	0	0
25	401810	.	T	C	7	5	12	0	1	13	0	0
25	402152	.	T	C	2	4	6	0	0	6	0	0
25	402224	.	A	T	2	4	6	0	0	6	0	0
25	402348	.	G	A	1	2	3	0	8	11	0	0
25	402359	.	T	G	7	0	7	0	6	13	0	0
25	403761	.	C	T	2	5	7	0	0	7	0	0
25	403935	.	T	G	7	8	15	0	0	15	0	0
25	404795	.	T	A	8	11	19	0	0	19	0	0
25	405253	.	G	A	11	2	13	0	4	17	0	0
25	450354	.	C	T	18	9	27	0	0	27	0	0
25	474938	.	T	A	20	18	38	0	2	40	0	0
25	485437	.	C	T	15	4	19	0	0	19	0	0
25	485612	.	C	T	1	26	27	0	17	44	0	0
25	485772	.	C	A	18	20	38	0	1	39	0	0
25	485802	.	T	C	24	19	43	0	0	43	0	0
25	485847	.	T	C	16	20	36	0	2	38	0	0
25	485863	.	A	T	20	13	33	0	2	35	0	0
25	486284	.	G	A	10	16	26	0	3	29	0	0
25	486472	.	A	T	12	10	22	0	1	23	0	0
25	486712	.	G	A	8	6	14	0	0	14	0	0
25	486895	.	C	T	10	12	22	0	0	22	0	0
25	487039	.	C	A	18	18	36	0	0	36	0	0
25	487045	.	C	T	18	14	32	0	3	35	0	0
25	487078	.	T	G	14	12	26	0	5	31	0	0
25	488817	.	G	T	14	10	24	0	2	26	0	0
25	489874	.	C	T	2	13	15	0	12	27	0	0
25	495366	.	G	A	16	8	24	0	0	24	0	0
25	498814	.	T	C	5	10	15	0	0	15	0	0
25	502608	.	G	A	9	13	22	0	0	22	0	0
25	504837	.	G	A	3	3	6	0	0	6	0	0
25	505214	.	C	T	4	6	10	0	0	10	0	0
25	509223	.	G	T	7	5	12	0	0	12	0	0
25	509625	.	G	A	4	8	12	0	1	13	0	0
25	509744	.	A	T	9	3	12	0	0	12	0	0
25	509899	.	C	T	4	5	9	0	0	9	0	0
25	509917	.	T	A	2	8	10	0	2	12	0	0
25	510000	.	T	G	6	9	15	0	1	16	0	0
25	510505	.	T	C	8	3	11	0	8	19	0	0
25	510514	.	T	A	12	8	20	0	0	20	0	0
25	523342	.	C	T	1	3	4	0	4	8	0	0
25	552872	.	G	A	2	3	5	0	0	5	0	0
25	663178	.	C	T	25	22	47	0	3	50	0	0
25	663284	.	G	A	1	26	27	0	20	47	0	0
25	664590	.	A	C	23	24	47	0	2	49	0	0
25	763774	.	T	C	12	11	23	0	1	24	0	0
25	769484	.	A	G	3	3	6	0	0	6	0	0
25	771140	.	T	G	2	2	4	0	0	4	0	0
25	771616	.	T	C	2	1	3	0	2	5	0	0
25	771625	.	G	A	2	2	4	0	1	5	0	0
25	824627	.	C	T	0	6	6	0	3	9	0	0
25	824774	.	C	T	6	5	11	0	0	11	0	0
25	824807	.	G	A	8	4	12	0	0	12	0	0
25	824881	.	G	T	4	4	8	0	0	8	0	0
25	824909	.	G	A	4	5	9	0	0	9	0	0
25	825656	.	G	A	3	2	5	0	0	5	0	0
25	825704	.	A	C	4	0	4	0	3	7	0	0
25	825746	.	T	C	4	0	4	0	3	7	0	0
25	825902	.	G	T	3	5	8	0	0	8	0	0
25	825968	.	A	C	3	4	7	0	0	7	0	0
25	826405	.	C	A	3	3	6	0	0	6	0	0
25	826445	.	G	T	4	4	8	0	0	8	0	0
25	826745	.	G	A	7	2	9	0	0	9	0	0
25	1048759	.	C	T	3	4	7	0	0	7	0	0
25	1089010	.	G	A	18	10	28	0	0	28	0	0
25	1089026	.	G	A	12	13	25	0	1	26	0	0
25	1091806	.	G	A	8	7	15	0	2	17	0	0
25	1092442	.	C	A	0	8	8	0	8	16	0	0
25	1092451	.	C	T	8	5	13	0	2	15	0	0
25	1093520	.	G	A	10	4	14	0	0	14	0	0
25	1093567	.	G	A	11	4	15	0	1	16	0	0
25	1101431	.	A	G	3	3	6	0	0	6	0	0
25	1101659	.	A	G	2	5	7	0	1	8	0	0
25	1101704	.	C	G	2	4	6	0	0	7	1	0
25	1101707	.	G	A	3	5	8	0	0	8	0	0
25	1102731	.	C	T	6	4	10	0	0	10	0	0
25	1106187	.	G	A	4	3	7	0	1	8	0	0
25	1106247	.	C	G	6	6	12	0	0	12	0	0
25	1117337	.	G	A	1	4	5	0	0	5	0	0
25	1117349	.	A	G	1	4	5	0	0	5	0	0
25	1124077	.	C	T	2	6	8	0	0	8	0	0
25	1132509	.	G	A	13	17	30	1	0	31	0	0
25	1132543	.	G	A	13	20	33	1	0	34	0	0
25	1235287	.	G	A	9	5	14	0	0	14	0	0
25	1304556	.	G	A	6	2	8	0	0	8	0	0
25	1305338	.	T	G	6	8	14	0	0	14	0	0
25	1335681	.	G	A	2	3	5	2	0	7	0	0
25	1335753	.	C	T	4	2	6	0	0	6	0	0
25	1335805	.	T	C	2	2	4	0	0	4	0	0
25	1335814	.	T	C	2	2	4	0	0	4	0	0
25	1338689	.	T	C	5	3	8	0	0	8	0	0
25	1339403	.	C	T	9	9	18	0	0	18	0	0
25	1339601	.	G	T	0	5	5	0	4	9	0	0
25	1339760	.	C	T	4	2	6	0	0	6	0	0
25	1340215	.	G	A	6	4	10	0	1	11	0	0
25	1355081	.	G	T	1	2	3	0	0	3	0	0
25	1355120	.	C	T	0	2	2	0	3	5	0	0
25	1355124	.	G	A	3	2	5	0	0	5	0	0
25	2243814	.	A	G	1	0	1	0	2	3	0	0
25	2243816	.	A	G	1	2	3	0	0	3	0	0
25	2264091	.	C	A	6	4	10	0	0	10	0	0
25	2264112	.	T	C	6	7	13	0	1	14	0	0
25	2264824	.	A	C	1	3	4	0	0	4	0	0
25	2264830	.	A	G	1	3	4	0	0	4	0	0
25	2273945	.	C	T	4	7	11	0	3	14	0	0
25	2276704	.	C	T	1	3	4	1	3	8	0	0
25	2276770	.	T	C	3	3	6	1	0	7	0	0
25	2276781	.	A	G	5	2	7	0	0	7	0	0
25	2276828	.	T	A	2	2	4	0	0	4	0	0
25	2276869	.	C	T	2	2	4	0	0	4	0	0
25	2282566	.	A	G	12	4	16	0	9	25	0	0
25	2282846	.	A	C	20	11	31	0	1	32	0	0
25	2286066	.	C	T	12	15	27	0	1	28	0	0
25	2286120	.	G	A	9	15	24	0	0	24	0	0
25	2286328	.	T	G	4	2	6	0	0	6	0	0
25	2286376	.	T	C	6	3	9	0	1	10	0	0
25	2286502	.	T	C	15	6	21	0	0	21	0	0
25	2286600	.	A	T	6	11	17	0	0	17	0	0
25	2286762	.	A	C	8	7	15	0	2	17	0	0
25	2286798	.	A	C	13	9	22	0	0	22	0	0
25	2286837	.	C	T	11	12	23	0	1	24	0	0
25	2286841	.	C	A	12	9	21	0	2	23	0	0
25	2702718	.	A	G	8	0	8	0	5	13	0	0
25	2707105	.	T	C	5	3	8	0	1	9	0	0
25	3245895	.	A	G	12	9	21	0	0	21	0	0
25	3881346	.	A	G	1	4	5	0	0	5	0	0
25	4669102	.	C	T	1	2	3	0	0	3	0	0
25	6074245	.	T	C	5	2	7	0	0	7	0	0
25	6204824	.	A	G	14	3	17	0	2	19	0	0
25	6206264	.	G	T	4	2	6	0	0	6	0	0
25	6403885	.	T	C	5	2	7	0	0	7	0	0
25	6403890	.	T	C	5	2	7	0	0	7	0	0
25	6403980	.	A	G	6	2	8	0	0	8	0	0
25	6404113	.	T	C	5	2	7	0	1	8	0	0
25	7230239	.	T	C	7	7	14	0	0	14	0	0
25	7324580	.	C	T	9	18	27	1	1	29	0	0
25	7327718	.	C	T	13	17	30	0	0	30	0	0
25	7333751	.	G	A	22	14	36	0	2	38	0	0
25	7333841	.	C	T	22	15	37	0	1	38	0	0
25	7334900	.	A	G	29	0	29	0	14	43	0	0
25	7334951	.	T	C	22	12	34	0	1	35	0	0
25	7334987	.	G	C	14	18	32	0	3	35	0	0
25	7336096	.	T	A	10	9	19	0	4	23	0	0
25	7410399	.	A	G	2	2	4	0	0	4	0	0
25	7410558	.	C	A	1	3	4	0	0	4	0	0
25	7410645	.	G	A	1	2	3	0	0	3	0	0
25	7410822	.	G	A	0	4	4	0	1	5	0	0
25	7412640	.	T	G	4	3	7	0	0	7	0	0
25	7412985	.	C	T	7	4	11	0	0	11	0	0
25	7413288	.	T	A	6	7	13	0	0	13	0	0
25	7428932	.	A	C	2	4	6	0	2	8	0	0
25	7428944	.	T	C	3	4	7	0	2	9	0	0
25	7428971	.	A	T	3	4	7	0	1	8	0	0
25	7429028	.	C	A	3	3	6	0	0	6	0	0
25	7431310	.	A	C	2	3	5	0	1	6	0	0
25	7431334	.	G	A	2	3	5	0	1	6	0	0
25	7454578	.	T	C	6	7	13	0	0	13	0	0
25	7454599	.	T	C	8	6	14	0	0	14	0	0
25	7456535	.	C	A	7	6	13	0	0	14	1	0
25	7456843	.	G	A	2	11	13	0	6	19	0	0
25	7456860	.	G	A	1	6	7	0	11	18	0	0
25	7477641	.	C	T	15	21	36	0	1	37	0	0
25	7487835	.	G	C	22	27	49	0	4	53	0	0
25	7488407	.	T	C	6	27	33	0	2	35	0	0
25	7488599	.	G	T	29	12	41	0	2	43	0	0
25	7488660	.	C	T	28	7	35	0	2	37	0	0
25	7488812	.	G	A	26	27	53	0	0	53	0	0
25	7488813	.	G	T	26	27	53	0	0	53	0	0
25	7489011	.	A	T	31	26	57	0	1	58	0	0
25	7489034	.	G	A	4	21	25	0	30	55	0	0
25	7489197	.	G	T	12	17	29	0	0	29	0	0
25	7492888	.	C	T	6	4	10	0	0	10	0	0
25	7492927	.	T	A	3	2	5	0	1	6	0	0
25	7494243	.	G	A	2	8	10	0	9	19	0	0
25	7496003	.	C	T	3	9	12	1	0	13	0	0
25	7496021	.	C	T	2	9	11	1	0	12	0	0
25	7496039	.	C	T	3	8	11	0	0	11	0	0
25	7496992	.	G	C	0	9	9	0	8	17	0	0
25	7500473	.	T	C	13	19	32	0	1	33	0	0
25	7501997	.	G	A	7	14	21	0	1	22	0	0
25	7502022	.	G	C	16	7	23	0	0	23	0	0
25	7502119	.	T	C	11	7	18	0	0	18	0	0
25	7502241	.	G	A	5	6	11	0	0	11	0	0
25	7533220	.	T	C	3	2	5	0	0	5	0	0
25	7533559	.	G	C	2	4	6	0	0	6	0	0
25	7890338	.	T	C	11	2	13	0	0	13	0	0
25	7890621	.	T	C	2	2	4	0	0	4	0	0
25	7890814	.	T	C	1	2	3	0	0	3	0	0
25	7891836	.	T	C	4	2	6	0	0	6	0	0
25	8049993	.	A	G	1	6	7	0	0	7	0	0
25	9678666	.	G	A	10	6	16	0	1	17	0	0
25	9679242	.	G	A	10	19	29	0	0	29	0	0
25	9679389	.	G	A	10	3	13	0	1	14	0	0
25	9680022	.	T	C	7	3	10	0	0	10	0	0
25	9680196	.	T	A	5	3	8	0	1	9	0	0
25	9680448	.	A	G	3	4	7	0	0	7	0	0
25	9805253	.	G	C	5	6	11	0	0	11	0	0
25	9805257	.	G	C	5	6	11	0	0	11	0	0
25	11796531	.	T	C	20	1	21	0	14	35	0	0
25	11796579	.	T	A	22	17	39	0	1	40	0	0
25	11796728	.	A	T	15	14	29	0	2	31	0	0
25	11796860	.	T	C	13	16	29	0	0	29	0	0
25	11796973	.	T	C	11	0	11	0	12	23	0	0
25	11796987	.	A	G	8	11	19	0	1	20	0	0
25	11797056	.	G	C	7	7	14	0	0	14	0	0
25	11797515	.	A	G	12	12	24	1	1	26	0	0
25	11797550	.	G	T	9	13	22	0	0	22	0	0
25	11797789	.	A	T	5	14	19	1	0	20	0	0
25	11797912	.	T	A	2	11	13	0	0	13	0	0
25	11797979	.	A	G	3	3	6	0	0	6	0	0
25	11797990	.	A	G	2	3	5	0	2	7	0	0
25	11798043	.	G	A	3	3	6	0	0	6	0	0
25	11798081	.	T	C	4	0	4	0	9	13	0	0
25	11798215	.	A	C	4	9	13	0	1	14	0	0
25	11798227	.	T	A	4	9	13	0	2	15	0	0
25	11798333	.	A	T	4	7	11	0	0	11	0	0
25	11798381	.	T	A	9	8	17	0	0	17	0	0
25	11798509	.	A	T	10	10	20	0	1	21	0	0
25	11798511	.	C	A	0	11	11	0	10	21	0	0
25	11798598	.	C	T	6	4	10	0	1	11	0	0
25	11798922	.	A	G	4	4	8	0	0	8	0	0
25	11799527	.	A	T	11	5	16	0	0	16	0	0
25	11799577	.	G	A	14	7	21	0	1	22	0	0
25	11799625	.	A	T	11	7	18	0	2	20	0	0
25	11799670	.	G	T	7	8	15	0	0	15	0	0
25	11799685	.	A	G	6	5	11	0	0	11	0	0
25	11800098	.	G	C	7	6	13	0	2	15	0	0
25	11800140	.	A	G	10	5	15	0	0	15	0	0
25	11800319	.	T	G	2	2	4	0	0	4	0	0
25	11800328	.	C	T	1	3	4	0	1	5	0	0
25	11800358	.	C	A	2	7	9	0	0	9	0	0
25	11800522	.	G	A	8	6	14	0	0	14	0	0
25	11800652	.	C	T	1	9	10	0	4	14	0	0
25	11801111	.	C	A	5	6	11	0	0	11	0	0
25	11801513	.	A	C	8	4	12	0	0	12	0	0
25	11801642	.	C	G	6	9	15	0	0	15	0	0
25	11801838	.	A	C	2	0	2	0	3	5	0	0
25	11801841	.	G	T	2	2	4	0	1	5	0	0
25	11802115	.	C	A	1	3	4	0	0	4	0	0
25	11802192	.	T	A	9	3	12	0	0	12	0	0
25	11802306	.	C	A	0	5	5	0	8	13	0	0
25	11802485	.	C	T	2	5	7	0	9	16	0	0
25	11803455	.	G	T	8	4	12	0	0	12	0	0
25	11803467	.	A	T	7	5	12	0	0	12	0	0
25	11804330	.	C	G	1	2	3	0	1	4	0	0
25	11804490	.	T	G	1	3	4	0	0	4	0	0
25	11804688	.	T	G	5	5	10	0	0	10	0	0
25	11804969	.	T	A	1	5	6	0	0	6	0	0
25	11833526	.	G	A	3	6	9	0	0	9	0	0
25	11894540	.	G	A	1	2	3	0	0	3	0	0
25	12853640	.	G	A	42	14	56	0	3	59	0	0
25	12853691	.	C	T	12	42	54	0	0	54	0	0
25	12853811	.	G	A	27	9	36	0	1	37	0	0
25	12853971	.	T	A	18	34	52	0	0	52	0	0
25	12854112	.	C	T	35	18	53	0	1	54	0	0
25	12854201	.	C	T	21	19	40	2	0	42	0	0
25	12854266	.	A	T	17	24	41	3	4	48	0	0
25	13104333	.	C	A	0	5	5	0	6	11	0	0
25	13104393	.	T	C	1	6	7	0	0	7	0	0
25	13105061	.	A	G	2	2	4	0	0	4	0	0
25	13332531	.	C	T	33	30	63	1	0	64	0	0
25	13332693	.	G	A	32	40	72	0	1	73	0	0
25	13332737	.	A	G	34	37	71	0	9	80	0	0
25	13333027	.	A	G	42	23	65	1	5	71	0	0
25	13333986	.	T	A	33	45	78	0	2	80	0	0
25	13333994	.	C	T	36	44	80	0	3	83	0	0
25	13334023	.	T	A	38	37	75	0	2	77	0	0
25	13334049	.	A	T	41	29	70	0	2	73	1	0
25	13334061	.	A	G	43	33	76	0	0	76	0	0
25	13334334	.	A	T	25	26	51	0	3	54	0	0
25	13334371	.	T	C	22	31	53	0	4	57	0	0
25	13334397	.	C	G	25	36	61	0	1	62	0	0
25	13334429	.	T	C	22	38	60	0	0	60	0	0
25	13334526	.	A	G	37	23	60	0	3	63	0	0
25	13334537	.	T	C	42	0	42	0	19	61	0	0
25	13334729	.	C	T	39	34	73	0	2	75	0	0
25	13335021	.	G	T	42	26	68	0	2	70	0	0
25	13335059	.	G	C	37	27	64	0	1	65	0	0
25	13335078	.	A	G	35	24	59	1	2	62	0	0
25	13335185	.	A	G	32	28	60	0	7	67	0	0
25	13335225	.	T	C	38	28	66	0	1	67	0	0
25	13335331	.	T	C	32	34	66	0	3	69	0	0
25	13335359	.	C	T	7	30	37	0	34	71	0	0
25	13335524	.	T	C	20	35	55	0	7	62	0	0
25	13335892	.	A	G	34	20	54	0	4	58	0	0
25	13335897	.	T	C	37	21	58	0	0	58	0	0
25	13336236	.	G	T	43	17	60	0	2	62	0	0
25	13336391	.	G	A	30	37	67	0	2	69	0	0
25	13336409	.	A	C	35	32	67	0	4	71	0	0
25	13336755	.	G	T	29	34	63	0	5	68	0	0
25	13336780	.	A	G	31	34	65	0	3	68	0	0
25	13336815	.	T	A	33	31	64	0	1	65	0	0
25	13336967	.	T	A	23	28	51	0	4	55	0	0
25	13337044	.	G	A	24	25	49	0	3	53	1	0
25	13337136	.	A	G	28	31	59	0	2	61	0	0
25	13340180	.	C	T	31	30	61	1	1	63	0	0
25	13346723	.	G	A	35	24	59	0	3	62	0	0
25	13346730	.	A	G	38	24	62	0	1	63	0	0
25	13350259	.	A	G	28	32	60	0	2	62	0	0
25	13351894	.	T	A	28	30	58	1	5	64	0	0
25	13352304	.	T	A	27	28	55	0	3	58	0	0
25	13352316	.	A	G	31	21	52	0	2	54	0	0
25	13353747	.	G	A	26	29	55	0	3	58	0	0
25	13469844	.	A	G	14	1	15	0	13	28	0	0
25	13469858	.	T	C	12	12	24	0	4	28	0	0
25	13470424	.	C	T	14	16	30	0	0	30	0	0
25	13470430	.	A	T	13	19	32	0	1	33	0	0
25	13470544	.	A	T	12	10	22	0	0	22	0	0
25	13471127	.	A	G	22	0	22	0	10	32	0	0
25	13474246	.	C	T	3	2	5	0	1	6	0	0
25	13474362	.	C	G	4	8	12	0	1	13	0	0
25	13474411	.	A	G	9	7	16	0	0	16	0	0
25	13479710	.	G	A	5	7	12	0	2	14	0	0
25	13510356	.	A	G	4	2	6	0	0	6	0	0
25	13525164	.	A	T	5	3	8	0	1	9	0	0
25	13525295	.	C	G	11	6	17	0	0	17	0	0
25	13525453	.	C	T	14	8	22	0	1	23	0	0
25	13525521	.	A	C	11	8	19	0	3	22	0	0
25	13525633	.	A	C	13	8	21	0	0	21	0	0
25	13525848	.	A	T	10	10	20	0	1	21	0	0
25	13525864	.	G	A	10	9	19	0	4	23	0	0
25	13525890	.	A	C	8	13	21	0	1	22	0	0
25	13526171	.	A	C	15	14	29	0	0	29	0	0
25	13528361	.	G	A	2	2	4	0	0	4	0	0
25	13529243	.	A	T	5	1	6	0	2	8	0	0
25	13529294	.	A	G	8	3	11	0	0	11	0	0
25	13559168	.	T	G	4	9	13	0	1	14	0	0
25	13559194	.	G	A	5	14	19	0	2	21	0	0
25	13559220	.	G	A	9	17	26	0	0	26	0	0
25	13559446	.	T	A	9	14	23	0	1	24	0	0
25	13559500	.	T	C	12	10	22	0	0	22	0	0
25	13559723	.	T	A	5	12	17	0	0	17	0	0
25	13559740	.	A	G	4	12	16	0	0	16	0	0
25	13559760	.	T	C	4	0	4	0	8	12	0	0
25	13559953	.	A	T	11	11	22	0	1	23	0	0
25	13560080	.	C	T	4	9	13	0	0	13	0	0
25	13560136	.	C	T	6	12	18	0	1	19	0	0
25	13560149	.	C	T	9	9	18	0	1	19	0	0
25	13560186	.	A	G	11	3	14	0	0	14	0	0
25	13560207	.	T	C	9	6	15	0	3	18	0	0
25	13560547	.	C	T	1	8	9	0	10	19	0	0
25	13560576	.	C	T	7	9	16	0	1	17	0	0
25	13560598	.	T	G	7	8	15	0	0	15	0	0
25	13560638	.	C	A	4	2	6	0	0	6	0	0
25	13561059	.	C	T	1	2	3	0	1	4	0	0
25	13561065	.	T	C	1	3	4	0	0	4	0	0
25	13561133	.	T	C	1	5	6	0	1	7	0	0
25	13561149	.	T	C	2	5	7	0	0	7	0	0
25	13561296	.	A	G	5	6	11	0	0	11	0	0
25	13561775	.	C	A	0	2	2	0	1	3	0	0
25	13562371	.	G	A	3	2	5	0	0	5	0	0
25	13562742	.	T	C	4	0	4	0	7	11	0	0
25	13614475	.	G	C	2	1	3	0	2	5	0	0
25	13614509	.	C	G	2	3	5	0	0	5	0	0
25	13645911	.	C	T	22	19	41	0	0	41	0	0
25	13646153	.	G	A	13	8	21	0	1	22	0	0
25	13649206	.	C	T	1	6	7	0	8	15	0	0
25	13651394	.	A	T	4	6	10	0	0	10	0	0
25	13658316	.	C	T	0	7	7	0	12	19	0	0
25	13658940	.	G	A	11	5	16	0	1	17	0	0
25	13658976	.	T	C	6	0	6	0	8	14	0	0
25	13659075	.	T	A	9	9	18	0	0	18	0	0
25	13672106	.	T	A	7	2	9	0	0	9	0	0
25	13672226	.	C	T	5	2	7	0	1	8	0	0
25	13672296	.	T	G	4	2	6	0	0	6	0	0
25	13672349	.	G	A	2	4	6	0	0	6	0	0
25	13672455	.	A	T	1	2	3	0	0	3	0	0
25	13672629	.	A	C	7	3	10	0	0	10	0	0
25	13673119	.	A	G	5	2	7	0	0	7	0	0
25	13673377	.	A	G	4	3	7	0	0	7	0	0
25	13674202	.	A	G	4	5	9	0	0	9	0	0
25	13674214	.	A	G	3	4	7	0	1	8	0	0
25	13676274	.	T	C	2	2	4	0	0	4	0	0
25	13677352	.	G	A	0	5	5	0	2	7	0	0
25	13677396	.	A	G	1	5	6	0	1	7	0	0
25	13677519	.	C	T	1	2	3	0	1	4	0	0
25	13685517	.	T	C	2	4	6	0	0	6	0	0
25	13689166	.	G	A	4	3	7	0	1	8	0	0
25	13689341	.	T	C	8	6	14	0	0	14	0	0
25	13689359	.	C	A	5	4	9	0	0	9	0	0
25	13689486	.	T	C	2	0	2	0	5	7	0	0
25	13689575	.	A	G	7	6	13	0	1	14	0	0
25	13689612	.	A	G	6	4	10	0	1	11	0	0
25	13689617	.	C	A	6	3	9	0	0	9	0	0
25	13689945	.	G	A	3	2	5	0	0	5	0	0
25	13695726	.	G	A	5	3	8	0	0	8	0	0
25	13745659	.	A	G	27	33	60	0	1	61	0	0
25	13745665	.	A	G	30	32	62	0	1	63	0	0
25	13745776	.	A	G	34	28	62	0	2	64	0	0
25	13745788	.	A	C	37	1	38	0	27	65	0	0
25	13747722	.	G	C	25	0	25	0	26	51	0	0
25	13747948	.	T	C	20	0	20	0	20	40	0	0
25	13750734	.	T	A	18	15	33	0	2	35	0	0
25	13754015	.	A	G	17	13	30	0	5	35	0	0
25	13754094	.	T	A	13	15	28	0	4	32	0	0
25	13754338	.	T	G	22	10	32	0	1	33	0	0
25	13754359	.	A	G	18	9	27	0	0	27	0	0
25	13759547	.	G	A	17	18	35	0	1	36	0	0
25	13762889	.	T	C	11	12	23	0	0	23	0	0
25	13763626	.	A	G	9	9	18	0	1	19	0	0
25	13763641	.	C	T	9	6	15	0	0	15	0	0
25	13767612	.	G	A	9	3	12	0	0	12	0	0
25	13767726	.	G	A	2	11	13	0	0	13	0	0
25	13768396	.	G	A	10	6	16	0	0	16	0	0
25	13768547	.	A	G	10	4	14	0	0	14	0	0
25	13774036	.	C	T	5	7	12	0	0	12	0	0
25	13775158	.	A	G	6	9	15	0	0	15	0	0
25	13776771	.	T	A	8	5	13	0	0	13	0	0
25	13780322	.	C	G	5	4	9	0	0	9	0	0
25	13782376	.	A	G	1	4	5	0	0	5	0	0
25	13787514	.	A	T	6	5	11	0	0	11	0	0
25	13791853	.	A	C	8	10	18	0	0	18	0	0
25	13795332	.	G	A	16	11	27	0	1	28	0	0
25	13795440	.	T	C	22	14	36	0	0	36	0	0
25	13795441	.	G	A	22	14	36	0	0	36	0	0
25	13795494	.	A	G	20	15	35	0	0	35	0	0
25	13796379	.	T	C	25	14	39	0	0	39	0	0
25	13799172	.	G	A	1	4	5	0	0	5	0	0
25	13799689	.	C	T	10	19	29	0	1	30	0	0
25	13801895	.	G	C	21	12	33	0	0	33	0	0
25	13801933	.	C	T	19	15	34	0	1	35	0	0
25	13802100	.	C	T	19	19	38	0	4	42	0	0
25	13802235	.	T	A	11	4	15	0	2	17	0	0
25	13802710	.	C	T	10	16	26	0	3	29	0	0
25	13802876	.	G	A	14	20	34	0	3	37	0	0
25	13802901	.	G	A	21	19	40	0	0	40	0	0
25	13802918	.	A	G	20	21	41	0	0	41	0	0
25	13802940	.	A	T	18	23	41	0	2	43	0	0
25	13803710	.	A	G	17	20	37	0	1	38	0	0
25	13803712	.	T	G	20	19	39	0	0	39	0	0
25	13803895	.	A	G	15	19	34	0	1	35	0	0
25	13803903	.	C	T	19	14	33	0	1	34	0	0
25	13804056	.	C	T	23	15	38	0	0	38	0	0
25	13804097	.	T	A	12	23	35	0	0	35	0	0
25	13804216	.	C	T	16	15	31	0	0	31	0	0
25	13813656	.	A	G	24	14	38	0	1	39	0	0
25	13813659	.	G	A	23	16	39	0	0	39	0	0
25	13815325	.	G	A	13	8	21	0	1	22	0	0
25	13815361	.	A	G	10	14	24	0	1	25	0	0
25	13816724	.	G	A	13	10	23	0	0	23	0	0
25	13816840	.	C	T	1	5	6	0	11	17	0	0
25	13817135	.	C	G	8	7	15	0	2	17	0	0
25	13817243	.	C	T	0	13	13	0	7	20	0	0
25	13821187	.	C	T	10	6	16	0	0	16	0	0
25	13847533	.	A	G	13	12	25	0	1	26	0	0
25	13848801	.	G	A	10	14	24	0	1	25	0	0
25	13848930	.	A	G	14	17	31	0	1	32	0	0
25	13850757	.	A	C	14	16	30	0	2	32	0	0
25	13854838	.	G	A	8	6	14	0	0	14	0	0
25	13855707	.	T	A	7	7	14	0	2	16	0	0
25	13856023	.	C	A	2	7	9	0	4	13	0	0
25	13869025	.	T	C	1	7	8	0	1	9	0	0
25	13871070	.	C	T	7	4	11	0	0	11	0	0
25	14018007	.	T	C	4	7	11	0	0	11	0	0
25	14018872	.	T	G	6	7	13	0	2	15	0	0
25	14019921	.	G	A	1	14	15	0	11	26	0	0
25	14020923	.	C	A	5	2	7	0	0	7	0	0
25	14020924	.	A	C	5	2	7	0	0	7	0	0
25	14020973	.	C	T	2	6	8	0	0	8	0	0
25	14021000	.	A	C	3	6	9	0	0	9	0	0
25	14033013	.	G	C	5	3	8	0	0	8	0	0
25	14033268	.	T	C	23	13	36	0	2	39	1	0
25	14033670	.	T	G	7	11	18	0	3	21	0	0
25	14033867	.	A	G	8	6	14	0	2	16	0	0
25	14033914	.	G	A	4	8	12	0	0	12	0	0
25	14033984	.	G	T	10	4	14	0	3	17	0	0
25	14034240	.	G	C	20	11	31	0	2	33	0	0
25	14034398	.	C	T	11	10	21	0	0	21	0	0
25	14034406	.	G	A	12	10	22	0	1	23	0	0
25	14034512	.	C	T	14	10	24	0	3	27	0	0
25	14034513	.	T	A	14	13	27	0	0	27	0	0
25	14034620	.	A	G	9	7	16	0	1	17	0	0
25	14034667	.	C	T	8	7	15	0	1	16	0	0
25	14034725	.	T	A	11	8	19	0	1	20	0	0
25	14034881	.	T	C	8	12	20	0	1	21	0	0
25	14034911	.	C	G	11	12	23	0	0	23	0	0
25	14035012	.	T	G	5	13	18	0	0	18	0	0
25	14035017	.	T	A	2	12	14	0	2	16	0	0
25	14035229	.	C	T	5	6	11	0	0	11	0	0
25	14035247	.	T	G	5	2	7	0	1	8	0	0
25	14035278	.	C	A	1	3	4	0	5	9	0	0
25	14035292	.	C	T	6	4	10	0	1	11	0	0
25	14035414	.	A	T	13	7	20	0	1	21	0	0
25	14035500	.	T	G	11	6	17	1	0	18	0	0
25	14035559	.	T	G	4	5	9	0	1	10	0	0
25	14035684	.	A	C	5	3	8	0	0	8	0	0
25	14035833	.	A	C	1	2	3	0	0	3	0	0
25	14035834	.	A	T	1	2	3	0	0	3	0	0
25	14035908	.	A	C	4	3	7	0	0	7	0	0
25	14117198	.	C	T	1	2	3	0	0	3	0	0
25	14361812	.	C	T	8	9	17	0	0	17	0	0
25	14363216	.	C	T	4	11	15	0	1	16	0	0
25	14363291	.	T	A	13	9	22	0	2	24	0	0
25	14363572	.	G	T	11	7	18	0	1	19	0	0
25	14365546	.	G	A	20	20	40	0	0	40	0	0
25	14365781	.	C	T	14	16	30	0	0	30	0	0
25	14365834	.	C	T	19	7	26	0	1	27	0	0
25	14366056	.	T	A	13	11	24	0	1	25	0	0
25	14369587	.	G	T	8	4	12	0	2	15	1	0
25	14369631	.	C	T	8	10	18	0	3	21	0	0
25	14369712	.	G	A	11	14	25	0	2	27	0	0
25	14369869	.	T	A	11	5	16	0	0	16	0	0
25	14369883	.	T	C	9	6	15	0	8	23	0	0
25	14374076	.	G	A	3	6	9	0	1	10	0	0
25	14381497	.	T	G	2	2	4	0	2	6	0	0
25	14381513	.	G	T	3	6	9	0	0	9	0	0
25	14381583	.	A	G	11	19	30	0	1	31	0	0
25	14381763	.	G	A	21	24	45	0	0	45	0	0
25	14384028	.	G	T	13	19	32	0	2	34	0	0
25	14387616	.	C	T	18	26	44	0	2	46	0	0
25	14388955	.	A	T	11	10	21	0	1	22	0	0
25	14392808	.	C	G	9	10	19	0	2	21	0	0
25	14393533	.	A	G	14	15	29	0	0	29	0	0
25	14398703	.	A	C	2	3	5	1	0	6	0	0
25	14398744	.	A	T	10	9	19	2	1	22	0	0
25	14401150	.	C	T	11	6	17	0	0	17	0	0
25	14401219	.	C	A	10	9	19	0	1	20	0	0
25	14403369	.	T	C	13	10	23	0	0	23	0	0
25	14403404	.	C	T	7	11	18	0	1	19	0	0
25	14406608	.	A	C	9	7	16	0	1	17	0	0
25	14406621	.	T	C	10	7	17	0	1	18	0	0
25	14406649	.	A	T	10	6	16	0	2	18	0	0
25	14409190	.	T	C	1	3	4	0	0	4	0	0
25	14409222	.	T	A	3	3	6	0	0	6	0	0
25	14409642	.	G	A	3	3	6	0	0	6	0	0
25	14409936	.	T	C	3	0	3	0	2	5	0	0
25	14426175	.	A	C	1	0	1	0	4	5	0	0
25	14426344	.	A	C	1	2	3	0	0	3	0	0
25	14426595	.	A	T	4	2	6	0	0	6	0	0
25	14511951	.	C	A	1	2	3	0	1	4	0	0
25	14511958	.	A	G	1	3	4	0	0	4	0	0
25	14694924	.	T	C	1	2	3	0	0	3	0	0
25	14694942	.	C	T	1	3	4	0	0	4	0	0
25	14694979	.	T	C	3	7	10	0	3	13	0	0
25	14695065	.	T	C	5	8	13	0	1	14	0	0
25	14695092	.	C	T	6	10	16	0	0	16	0	0
25	14695122	.	A	G	5	1	6	0	5	11	0	0
25	14702821	.	C	T	7	4	11	0	0	11	0	0
25	14733824	.	C	T	1	7	8	0	0	8	0	0
25	14734122	.	A	G	6	6	12	0	0	12	0	0
25	14738298	.	T	C	2	2	4	0	0	4	0	0
25	14738462	.	T	A	1	4	5	0	0	5	0	0
25	14738535	.	A	T	2	3	5	0	0	5	0	0
25	14738541	.	T	C	2	3	5	0	0	5	0	0
25	14870811	.	T	C	2	8	10	0	0	10	0	0
25	14897695	.	C	T	2	2	4	0	1	5	0	0
25	15029225	.	C	T	7	4	11	0	2	13	0	0
25	15031773	.	G	A	14	6	20	0	1	21	0	0
25	15031851	.	A	G	12	9	21	0	1	22	0	0
25	15032087	.	A	G	12	7	19	0	2	21	0	0
25	15034012	.	C	T	0	8	8	0	10	18	0	0
25	15045221	.	T	A	4	3	7	0	0	7	0	0
25	15276105	.	T	C	8	5	13	0	0	13	0	0
25	15281889	.	C	T	5	10	15	0	0	15	0	0
25	15281891	.	A	G	5	9	14	0	1	15	0	0
25	15284485	.	T	C	8	7	15	0	0	15	0	0
25	15284644	.	C	G	7	0	7	0	8	15	0	0
25	15284734	.	G	T	13	11	24	0	0	24	0	0
25	15284799	.	C	T	15	11	26	0	2	28	0	0
25	15284862	.	T	C	9	21	30	0	0	30	0	0
25	15284959	.	T	C	13	17	30	0	0	30	0	0
25	15285004	.	A	C	15	17	32	0	0	32	0	0
25	15285092	.	T	C	12	10	22	0	1	23	0	0
25	15285105	.	C	A	8	14	22	0	2	24	0	0
25	15285213	.	G	C	14	10	24	0	1	25	0	0
25	15285256	.	T	A	9	12	21	0	1	22	0	0
25	15285470	.	C	T	6	11	17	0	0	17	0	0
25	15285471	.	C	A	6	11	17	0	0	17	0	0
25	15292574	.	T	G	3	2	5	0	0	5	0	0
25	15292705	.	G	A	2	3	5	0	0	5	0	0
25	15342700	.	G	A	1	3	4	0	1	5	0	0
25	15343016	.	C	A	6	3	9	0	0	9	0	0
25	15345474	.	C	A	2	6	8	0	5	13	0	0
25	15347416	.	A	G	4	0	4	0	4	8	0	0
25	15347613	.	A	G	3	0	3	0	7	10	0	0
25	15347688	.	G	A	5	2	7	0	0	7	0	0
25	15348263	.	A	T	2	2	4	0	1	5	0	0
25	15348359	.	A	G	4	3	7	0	0	7	0	0
25	15350012	.	A	G	5	5	10	0	0	10	0	0
25	15350016	.	G	A	4	5	9	0	1	10	0	0
25	15350058	.	A	G	6	11	17	0	0	17	0	0
25	15350402	.	T	G	7	6	13	0	0	13	0	0
25	15350467	.	T	C	6	6	12	0	1	13	0	0
25	15351088	.	A	G	8	10	18	0	0	18	0	0
25	15354333	.	G	T	3	6	9	0	0	9	0	0
25	15354360	.	C	T	6	8	14	0	0	14	0	0
25	15404898	.	G	A	14	10	24	0	0	24	0	0
25	15408820	.	G	A	0	10	10	0	22	32	0	0
25	15409013	.	T	C	7	10	17	0	1	18	0	0
25	15430310	.	T	C	11	13	24	0	2	26	0	0
25	15430334	.	T	C	12	11	23	0	1	24	0	0
25	15432769	.	G	A	12	13	25	0	1	26	0	0
25	15434566	.	T	C	17	15	32	0	2	34	0	0
25	15434579	.	C	T	21	17	38	0	1	39	0	0
25	15438723	.	G	A	0	25	25	0	21	46	0	0
25	15438789	.	C	A	15	22	37	0	2	39	0	0
25	15450807	.	C	G	18	21	39	0	1	40	0	0
25	15465167	.	T	C	24	18	42	0	2	44	0	0
25	15472286	.	C	A	36	20	56	0	2	58	0	0
25	15477186	.	G	A	4	16	20	0	25	45	0	0
25	15478092	.	A	G	32	31	63	0	2	65	0	0
25	15480676	.	G	A	3	30	33	0	28	61	0	0
25	15480711	.	T	C	29	32	61	0	1	62	0	0
25	15481040	.	C	T	15	12	27	8	5	40	0	0
25	15481240	.	A	G	26	32	58	0	0	58	0	0
25	15481481	.	T	G	15	20	35	0	0	35	0	0
25	15481759	.	G	A	29	14	43	0	2	45	0	0
25	15648042	.	G	A	6	3	9	0	0	9	0	0
25	15648237	.	T	A	8	4	12	0	0	12	0	0
25	15648243	.	C	A	8	3	11	0	1	12	0	0
25	15648330	.	C	A	6	12	18	0	1	19	0	0
25	15648342	.	G	C	6	11	17	0	0	17	0	0
25	15649992	.	G	A	5	4	9	0	1	10	0	0
25	16963906	.	T	C	2	3	5	0	1	6	0	0
25	17892352	.	A	T	11	2	13	0	0	13	0	0
25	18031285	.	T	C	1	7	8	0	0	8	0	0
25	18907887	.	A	G	1	2	3	0	0	3	0	0
25	18907889	.	A	G	0	2	2	0	0	2	0	0
25	18908651	.	A	G	6	3	9	1	0	10	0	0
25	18961695	.	C	T	1	3	4	0	2	6	0	0
25	18963193	.	A	G	5	3	8	0	1	9	0	0
25	18977422	.	A	G	3	10	13	0	0	13	0	0
25	18977423	.	A	G	8	5	13	0	0	13	0	0
25	19525366	.	C	T	2	2	4	0	0	4	0	0
25	19867752	.	G	T	3	2	5	0	0	5	0	0
25	20669199	.	G	T	0	3	3	0	1	4	0	0
25	20998134	.	A	G	3	2	5	0	0	5	0	0
25	21518625	.	T	A	2	3	5	0	0	5	0	0
25	22076324	.	C	T	2	3	5	0	0	5	0	0
25	22079673	.	C	T	1	3	4	0	0	4	0	0
25	22079682	.	T	C	0	3	3	0	0	3	0	0
25	22095022	.	C	T	2	3	5	0	0	5	0	0
25	22095054	.	G	A	3	2	5	0	0	5	0	0
25	22095118	.	A	G	1	4	5	0	0	5	0	0
25	22095549	.	A	T	2	2	4	0	0	4	0	0
25	22095815	.	A	G	1	2	3	0	0	3	0	0
25	22216828	.	T	A	1	2	3	0	1	4	0	0
25	22225037	.	G	T	1	2	3	0	0	3	0	0
25	22228081	.	A	G	2	3	5	0	0	5	0	0
25	22232767	.	A	T	2	2	4	0	0	4	0	0
25	22232831	.	C	A	5	3	8	0	0	8	0	0
25	22281504	.	C	A	2	3	5	0	0	5	0	0
25	22635759	.	A	G	36	24	60	0	4	64	0	0
25	22635812	.	T	G	26	32	58	0	1	59	0	0
25	22636075	.	C	A	10	20	30	1	2	33	0	0
25	22636574	.	G	A	28	19	47	0	3	50	0	0
25	22636967	.	C	T	19	23	42	0	0	42	0	0
25	22637012	.	C	T	21	17	38	0	1	39	0	0
25	22637039	.	A	G	19	17	36	0	2	38	0	0
25	22637290	.	C	A	2	20	22	0	21	43	0	0
25	22637384	.	G	A	23	18	41	0	0	41	0	0
25	22637444	.	A	T	15	9	24	0	4	28	0	0
25	22637501	.	A	G	14	20	34	0	2	36	0	0
25	22637584	.	A	T	20	19	39	0	1	40	0	0
25	22637667	.	T	C	21	17	38	0	0	38	0	0
25	22637729	.	G	T	22	18	40	0	0	40	0	0
25	22637732	.	G	A	20	18	38	0	1	39	0	0
25	22637873	.	C	A	17	20	37	0	2	39	0	0
25	22638170	.	C	G	1	3	4	0	8	12	0	0
25	22639039	.	G	A	13	13	26	0	1	27	0	0
25	22730504	.	T	C	4	2	6	0	0	6	0	0
25	22730594	.	G	A	0	6	6	0	6	12	0	0
25	22979987	.	T	A	6	2	8	0	1	9	0	0
25	23449787	.	A	G	5	4	9	0	0	9	0	0
25	23555998	.	A	T	5	3	8	0	2	10	0	0
25	23556378	.	C	G	9	5	14	0	0	14	0	0
25	23562487	.	C	T	1	8	9	0	11	20	0	0
25	23571614	.	A	G	9	4	13	0	1	14	0	0
25	23571823	.	T	C	4	5	9	0	0	9	0	0
25	23636135	.	G	T	2	2	4	0	0	4	0	0
25	23636144	.	C	T	3	2	5	0	0	5	0	0
25	23643122	.	A	T	0	2	2	0	2	4	0	0
25	23643172	.	A	G	2	0	2	0	2	4	0	0
25	23643477	.	C	T	3	3	6	0	0	6	0	0
25	23643648	.	C	T	5	3	8	0	0	8	0	0
25	23777510	.	C	A	10	10	20	0	0	20	0	0
25	23777545	.	G	A	19	15	34	0	2	36	0	0
25	23815540	.	C	T	12	11	23	0	0	23	0	0
25	24059983	.	A	G	8	7	15	0	0	15	0	0
25	24059991	.	A	G	8	5	13	0	0	13	0	0
25	24060460	.	G	A	9	5	14	0	0	14	0	0
25	24181349	.	A	G	3	2	5	0	0	5	0	0
25	24181367	.	T	C	3	0	3	0	2	5	0	0
25	24236397	.	G	A	1	2	3	0	1	4	0	0
25	24237313	.	G	C	3	2	5	0	0	5	0	0
25	24237407	.	T	C	2	2	4	0	0	4	0	0
25	24237636	.	G	A	13	10	23	0	1	24	0	0
25	24238066	.	T	G	15	10	25	0	2	27	0	0
25	24238134	.	A	C	12	0	12	0	0	12	0	0
25	24238243	.	T	C	2	6	8	0	0	8	0	0
25	24240918	.	C	T	12	9	21	0	0	21	0	0
25	24241338	.	T	G	3	12	15	0	1	16	0	0
25	24241350	.	G	A	5	12	17	0	0	17	0	0
25	24242001	.	A	G	5	11	16	0	1	17	0	0
25	24242103	.	A	G	6	7	13	0	2	15	0	0
25	24242115	.	T	C	6	6	12	0	2	14	0	0
25	24247267	.	C	G	9	11	20	0	0	20	0	0
25	24247282	.	A	C	8	11	19	0	0	19	0	0
25	24247758	.	A	C	3	0	3	0	4	7	0	0
25	24247765	.	T	C	3	3	6	0	0	6	0	0
25	24247852	.	A	G	3	6	9	0	1	10	0	0
25	24247985	.	G	A	1	6	7	0	0	7	0	0
25	24264276	.	G	A	0	3	3	0	5	8	0	0
25	24388630	.	A	G	2	0	2	0	2	4	0	0
25	24593493	.	G	A	2	2	4	0	1	5	0	0
25	24593686	.	C	G	2	3	5	0	1	6	0	0
25	24593689	.	G	A	2	4	6	0	0	6	0	0
25	24593833	.	A	T	7	4	11	0	0	11	0	0
25	24594339	.	C	T	1	4	5	0	0	5	0	0
25	24594474	.	T	G	4	0	4	0	3	7	0	0
25	24596961	.	T	C	6	7	13	0	0	13	0	0
25	24596976	.	T	A	5	8	13	0	0	13	0	0
25	24598869	.	T	C	4	7	11	0	0	11	0	0
25	24605595	.	G	T	3	1	4	0	1	5	0	0
25	24605598	.	A	C	3	2	5	0	0	5	0	0
25	24607933	.	A	G	2	1	3	0	3	6	0	0
25	24609463	.	T	A	5	3	8	1	0	9	0	0
25	24609515	.	A	G	3	7	10	0	0	10	0	0
25	24610543	.	A	T	4	8	12	0	0	12	0	0
25	24610544	.	A	G	4	8	12	0	0	12	0	0
25	24714795	.	C	T	1	2	3	0	0	3	0	0
25	24720580	.	A	G	4	2	6	0	0	6	0	0
25	24720595	.	A	G	4	0	4	0	4	8	0	0
25	24723468	.	T	C	2	1	3	0	0	3	0	0
25	24736579	.	A	T	6	11	17	0	0	17	0	0
25	24736828	.	A	T	8	10	18	0	0	18	0	0
25	24736875	.	T	G	8	7	15	0	0	15	0	0
25	24736921	.	G	A	6	8	14	0	0	14	0	0
25	24737026	.	C	T	4	3	7	0	1	8	0	0
25	24737154	.	C	T	0	4	4	0	3	7	0	0
25	24737215	.	C	T	8	4	12	0	3	15	0	0
25	24737244	.	A	C	6	7	13	0	0	13	0	0
25	24737259	.	T	A	2	2	4	0	0	4	0	0
25	24737664	.	C	A	9	8	17	0	0	17	0	0
25	24737740	.	A	C	5	2	7	1	0	8	0	0
25	24737961	.	C	T	3	2	5	0	0	5	0	0
25	24738023	.	T	C	4	0	4	0	4	8	0	0
25	24738084	.	T	C	10	1	11	0	11	22	0	0
25	24738114	.	C	G	9	12	21	0	0	21	0	0
25	24738354	.	T	C	1	2	3	0	0	3	0	0
25	24738754	.	T	C	1	2	3	0	0	3	0	0
25	24738826	.	G	A	3	11	14	0	1	15	0	0
25	24739029	.	A	G	11	21	32	0	0	32	0	0
25	24752181	.	A	G	4	14	18	0	0	18	0	0
25	24760448	.	C	A	0	9	9	0	9	18	0	0
25	24763746	.	A	G	4	5	9	0	2	11	0	0
25	24763755	.	G	T	8	4	12	0	0	12	0	0
25	24770089	.	G	A	7	18	25	0	1	26	0	0
25	24792647	.	C	A	4	11	15	0	0	15	0	0
25	24805912	.	T	A	3	6	9	0	1	10	0	0
25	24826237	.	G	T	7	6	13	0	1	14	0	0
25	24826240	.	T	C	7	0	7	0	6	13	0	0
25	24826290	.	A	G	5	3	8	0	0	8	0	0
25	25058302	.	C	T	3	2	5	0	0	5	0	0
25	25058334	.	A	C	4	0	4	0	4	8	0	0
25	25123445	.	T	C	12	13	25	0	1	26	0	0
25	25124779	.	A	T	13	16	29	0	2	31	0	0
25	25127090	.	C	T	16	19	35	0	1	36	0	0
25	25127250	.	A	G	20	17	37	0	1	38	0	0
25	25130648	.	C	T	24	20	44	0	5	49	0	0
25	25130693	.	C	T	21	25	46	0	3	49	0	0
25	25130747	.	C	T	24	22	46	0	1	47	0	0
25	25130782	.	G	A	28	21	49	0	0	49	0	0
25	25130908	.	C	T	26	14	40	1	0	41	0	0
25	25130924	.	T	C	27	20	47	1	1	49	0	0
25	25130968	.	C	T	23	23	46	0	3	49	0	0
25	25131274	.	A	G	12	18	30	0	1	31	0	0
25	25131298	.	A	T	14	24	38	0	1	39	0	0
25	25131389	.	A	T	19	32	51	0	3	54	0	0
25	25131464	.	G	A	29	25	54	0	1	55	0	0
25	25131631	.	C	T	32	17	49	0	0	53	4	0
25	25131710	.	A	G	22	12	34	0	1	35	0	0
25	25132985	.	C	T	11	7	18	0	1	19	0	0
25	25133030	.	G	A	13	10	23	0	0	23	0	0
25	25133123	.	T	G	18	13	31	0	5	36	0	0
25	25133171	.	A	G	23	21	44	0	1	45	0	0
25	25133353	.	G	A	17	18	35	0	0	35	0	0
25	25133365	.	T	A	15	19	34	0	0	35	1	0
25	25133509	.	A	G	9	13	22	0	0	22	0	0
25	25142127	.	G	A	3	2	5	0	1	13	7	0
25	25142171	.	T	C	6	5	11	0	1	12	0	0
25	25396237	.	T	C	10	18	28	0	0	28	0	0
25	25396295	.	T	C	9	15	24	0	0	24	0	0
25	25488772	.	T	G	3	4	7	0	0	7	0	0
25	25536661	.	A	T	1	3	4	0	1	5	0	0
25	25536707	.	T	C	1	3	4	0	0	4	0	0
25	25538206	.	G	T	4	5	9	0	0	9	0	0
25	25538354	.	T	A	9	4	13	0	0	13	0	0
25	25538624	.	C	A	1	5	6	0	0	6	0	0
25	25539028	.	G	A	4	5	9	0	0	9	0	0
25	25539270	.	C	A	4	5	9	0	0	9	0	0
25	25539398	.	G	A	4	5	9	0	0	9	0	0
25	25539434	.	G	A	0	5	5	0	4	9	0	0
25	25539518	.	A	G	10	6	16	0	2	18	0	0
25	25539569	.	A	G	8	1	9	0	2	11	0	0
25	25539723	.	C	A	12	9	21	0	0	21	0	0
25	25539783	.	G	C	14	13	27	0	0	27	0	0
25	25539800	.	A	G	11	10	21	0	1	22	0	0
25	25539834	.	A	T	6	12	18	0	1	19	0	0
25	25539928	.	A	G	5	0	5	0	10	15	0	0
25	25540058	.	T	A	5	2	7	0	2	9	0	0
25	25540060	.	G	A	5	4	9	0	0	9	0	0
25	25540181	.	A	T	4	2	6	0	0	6	0	0
25	25540245	.	A	G	7	5	12	0	0	12	0	0
25	25540490	.	C	T	3	5	8	0	1	9	0	0
25	25540954	.	G	A	10	5	15	0	0	15	0	0
25	25545131	.	T	C	3	8	11	0	1	12	0	0
25	25545149	.	G	C	3	10	13	0	0	13	0	0
25	25545365	.	G	C	4	6	10	0	1	11	0	0
25	25545989	.	G	C	6	9	15	0	0	15	0	0
25	25547043	.	C	A	2	2	4	0	0	5	1	0
25	25547137	.	C	A	3	2	5	0	1	6	0	0
25	25547228	.	G	A	4	3	7	0	0	7	0	0
25	25592238	.	A	G	4	3	7	0	0	7	0	0
25	25592821	.	G	A	2	8	10	0	0	10	0	0
25	25592875	.	C	T	1	6	7	0	0	7	0	0
25	25646510	.	A	T	1	2	3	0	0	3	0	0
25	25646521	.	T	G	1	2	3	0	0	3	0	0
25	25646548	.	A	G	1	4	5	0	1	6	0	0
25	25736865	.	T	C	5	1	6	0	6	12	0	0
25	25806264	.	C	T	24	10	34	0	0	34	0	0
25	25823529	.	T	C	21	15	36	0	2	38	0	0
25	25829020	.	T	C	1	4	5	0	2	7	0	0
25	26673233	.	A	G	4	8	12	0	0	12	0	0
25	26744995	.	G	T	4	4	8	0	1	9	0	0
25	26821844	.	A	T	3	2	5	0	0	5	0	0
25	26822823	.	C	T	2	2	4	0	0	5	1	0
25	26823436	.	A	T	3	2	5	0	0	5	0	0
25	26823888	.	G	A	6	2	8	0	0	8	0	0
25	26824177	.	G	A	2	2	4	0	0	4	0	0
25	26829266	.	G	T	5	10	15	0	0	15	0	0
25	26830142	.	C	T	4	4	8	0	0	8	0	0
25	26840452	.	G	T	9	4	13	0	0	13	0	0
25	26840480	.	T	G	5	8	13	0	1	14	0	0
25	26840678	.	A	T	8	5	13	0	0	13	0	0
25	26840919	.	G	A	8	3	11	0	1	12	0	0
25	26842444	.	G	A	5	3	8	0	2	10	0	0
25	26854875	.	G	T	1	2	3	0	0	3	0	0
25	26867671	.	A	T	2	6	8	0	1	9	0	0
25	26867731	.	C	T	2	2	4	0	1	5	0	0
25	26877783	.	A	T	6	12	18	0	2	20	0	0
25	26877865	.	A	T	16	12	28	0	1	29	0	0
25	26879592	.	T	C	19	25	44	0	0	44	0	0
25	26884286	.	G	A	13	12	25	0	0	25	0	0
25	26884407	.	C	T	12	13	25	0	0	25	0	0
25	26888170	.	A	G	15	7	22	0	0	22	0	0
25	26890845	.	A	G	17	16	33	0	0	33	0	0
25	26908396	.	T	G	1	3	4	0	0	4	0	0
25	26908888	.	C	T	2	2	4	0	0	4	0	0
25	26909101	.	C	T	5	7	12	0	0	12	0	0
25	26909197	.	G	A	4	8	12	0	0	12	0	0
25	26909269	.	A	G	3	14	17	0	0	17	0	0
25	26909392	.	A	T	8	9	17	0	0	17	0	0
25	26909618	.	A	C	10	10	20	0	0	20	0	0
25	26911216	.	C	T	8	3	11	0	0	11	0	0
25	26911554	.	T	A	8	9	17	0	0	17	0	0
25	26911605	.	C	A	9	10	19	0	0	19	0	0
25	26911768	.	A	G	3	7	10	0	1	11	0	0
25	26912037	.	C	T	4	3	7	0	0	7	0	0
25	26912062	.	C	T	1	2	3	0	0	3	0	0
25	26923116	.	C	T	2	2	4	0	0	4	0	0
25	26923180	.	T	A	1	2	3	0	1	4	0	0
25	27173852	.	G	A	5	7	12	0	0	12	0	0
25	27173936	.	C	T	6	3	9	0	0	9	0	0
25	27173940	.	A	C	7	2	9	0	0	9	0	0
25	27174065	.	C	T	6	4	10	0	0	10	0	0
25	27237022	.	A	G	6	4	10	0	1	11	0	0
25	27491669	.	C	T	1	3	4	0	0	4	0	0
25	27491679	.	A	G	1	2	3	0	0	3	0	0
25	27499385	.	T	C	2	2	4	0	0	4	0	0
25	27500038	.	C	A	2	3	5	0	0	5	0	0
25	27500055	.	A	G	2	3	5	0	0	5	0	0
25	27500109	.	A	G	1	2	3	0	0	3	0	0
25	27544025	.	C	A	1	2	3	0	0	3	0	0
25	27636649	.	G	A	1	2	3	0	0	3	0	0
25	27636712	.	G	A	2	2	4	0	0	4	0	0
25	27717828	.	A	G	6	2	8	0	0	8	0	0
25	27744408	.	C	A	6	2	8	0	3	11	0	0
25	27759983	.	A	G	5	5	10	0	1	11	0	0
25	27795017	.	A	G	15	13	28	0	2	30	0	0
25	27795083	.	C	T	14	9	23	0	1	24	0	0
25	27801759	.	T	G	5	0	5	0	18	23	0	0
25	27801960	.	A	C	6	4	10	0	13	23	0	0
25	27801963	.	A	C	7	1	8	0	16	24	0	0
25	27802122	.	C	A	18	20	38	0	2	40	0	0
25	27802149	.	G	A	20	17	37	0	1	38	0	0
25	27811761	.	C	T	16	10	26	0	5	31	0	0
25	28070673	.	A	C	4	2	6	0	0	6	0	0
25	28120150	.	C	T	1	3	4	0	1	5	0	0
25	28122051	.	C	T	4	7	11	0	0	11	0	0
25	28138918	.	A	C	3	3	6	0	0	6	0	0
25	28334256	.	A	G	3	2	5	0	0	5	0	0
25	28640724	.	T	G	28	20	48	0	1	49	0	0
25	28640890	.	T	G	20	20	40	0	0	40	0	0
25	28641207	.	A	T	15	5	20	1	7	28	0	0
25	28641261	.	T	A	17	16	33	0	0	33	0	0
25	28641321	.	T	G	16	13	29	0	2	31	0	0
25	28648067	.	T	C	15	10	25	1	0	26	0	0
25	28648078	.	A	G	15	9	24	0	1	25	0	0
25	28650764	.	T	A	19	14	33	0	4	37	0	0
25	28655056	.	G	A	14	11	25	0	1	26	0	0
25	28661185	.	C	T	8	10	18	0	2	20	0	0
25	28661227	.	T	C	10	12	22	0	0	22	0	0
25	28661351	.	G	A	14	12	26	0	0	26	0	0
25	28661626	.	G	A	14	14	28	0	0	28	0	0
25	28665446	.	T	A	9	7	16	0	1	17	0	0
25	28665464	.	A	C	11	9	20	0	0	20	0	0
25	28668001	.	G	A	12	6	18	0	0	18	0	0
25	28668723	.	C	A	11	8	19	0	0	19	0	0
25	28714616	.	A	G	4	2	6	0	0	6	0	0
25	28715605	.	C	G	0	2	2	0	3	5	0	0
25	28715631	.	T	A	2	2	4	0	2	6	0	0
25	28719957	.	T	G	7	8	15	0	0	15	0	0
25	28720044	.	T	C	5	0	5	0	3	8	0	0
25	28726537	.	C	A	1	5	6	0	10	16	0	0
25	28726758	.	A	G	2	5	7	0	0	7	0	0
25	28726788	.	G	T	2	4	6	0	1	7	0	0
25	28726797	.	C	T	1	7	8	0	3	11	0	0
25	28736679	.	C	T	4	4	8	1	0	9	0	0
25	28736893	.	A	G	4	5	9	0	0	9	0	0
25	28737007	.	A	T	2	5	7	0	0	7	0	0
25	28739882	.	A	G	1	2	3	0	0	3	0	0
25	28739891	.	A	G	1	2	3	0	0	3	0	0
25	28740366	.	T	C	1	0	1	0	3	4	0	0
25	28745047	.	C	T	3	4	7	0	1	8	0	0
25	28745070	.	T	G	3	6	9	0	1	10	0	0
25	28752579	.	C	T	0	5	5	0	1	6	0	0
25	28768464	.	C	T	1	2	3	0	0	3	0	0
25	28825652	.	G	C	11	6	17	0	0	17	0	0
25	28826630	.	A	G	9	0	9	0	11	20	0	0
25	28827752	.	A	G	14	1	15	0	9	24	0	0
25	28846383	.	G	T	1	10	11	0	12	23	0	0
25	28893665	.	T	A	6	3	9	0	0	9	0	0
25	28893713	.	C	A	12	7	19	0	0	19	0	0
25	28893956	.	C	T	4	10	14	0	1	15	0	0
25	28903105	.	A	C	14	16	30	0	2	32	0	0
25	28903253	.	A	G	8	0	8	0	11	19	0	0
25	28926502	.	T	A	1	3	4	0	0	4	0	0
25	28926529	.	T	G	1	2	3	0	0	3	0	0
25	29076852	.	T	A	30	31	61	3	6	70	0	0
25	29080112	.	G	A	2	3	5	0	1	6	0	0
25	29083827	.	T	A	4	4	8	0	0	8	0	0
25	29084154	.	G	A	5	3	8	0	1	9	0	0
25	29087845	.	T	C	6	0	6	0	4	10	0	0
25	29087859	.	T	C	3	0	3	0	2	5	0	0
25	29109251	.	G	A	6	9	15	0	1	16	0	0
25	29110052	.	A	G	8	4	12	0	1	13	0	0
25	29114835	.	G	A	4	5	9	0	1	10	0	0
25	29117835	.	A	G	3	2	5	0	0	5	0	0
25	29129593	.	A	G	4	2	6	0	0	6	0	0
25	29212167	.	G	T	6	8	14	0	1	15	0	0
25	29212302	.	C	T	1	3	4	0	11	15	0	0
25	29212476	.	T	C	3	3	6	0	2	8	0	0
25	29212780	.	A	T	4	5	9	0	0	9	0	0
25	29212781	.	C	G	0	5	5	0	4	9	0	0
25	29212835	.	A	T	5	7	12	0	1	13	0	0
25	29212851	.	G	T	6	6	12	0	1	13	0	0
25	29212986	.	A	G	5	2	7	0	1	8	0	0
25	29213001	.	G	C	6	4	10	0	0	10	0	0
25	29213804	.	A	G	4	6	10	0	0	10	0	0
25	29427959	.	A	C	12	7	19	0	3	23	1	0
25	29427963	.	A	C	10	5	15	0	5	20	0	0
25	29665927	.	A	T	10	2	12	0	2	14	0	0
25	30151659	.	T	G	2	5	7	0	0	7	0	0
25	32216389	.	A	G	3	0	3	0	10	13	0	0
25	32886333	.	T	C	1	0	1	0	2	3	0	0
25	32886363	.	A	G	1	2	3	0	0	3	0	0
25	33038216	.	A	G	2	0	2	0	3	5	0	0
25	33065530	.	A	G	2	0	2	0	3	5	0	0
25	33065551	.	C	T	1	3	4	0	0	4	0	0
25	33065593	.	T	C	1	2	3	0	0	3	0	0
25	33091554	.	A	G	2	0	2	0	4	6	0	0
25	33093485	.	T	C	2	6	8	0	0	8	0	0
25	33104491	.	T	C	1	2	3	0	0	3	0	0
25	33104494	.	T	C	1	2	3	0	0	3	0	0
25	33107524	.	G	T	2	3	5	0	1	6	0	0
25	33107535	.	T	A	4	2	6	0	0	6	0	0
25	33121740	.	C	T	3	3	6	0	0	6	0	0
25	33121782	.	A	G	3	0	3	0	7	10	0	0
25	33125194	.	A	C	6	4	10	0	0	10	0	0
25	33145031	.	C	T	5	7	12	0	0	12	0	0
25	33151573	.	C	G	2	0	2	0	6	8	0	0
25	33225248	.	A	G	23	24	47	0	4	51	0	0
25	33225287	.	G	A	19	20	39	0	2	41	0	0
25	33226972	.	A	G	20	16	36	0	1	37	0	0
25	33226984	.	A	G	20	15	35	0	1	36	0	0
25	33238174	.	G	A	2	2	4	0	0	4	0	0
25	33238303	.	G	A	1	2	3	0	1	4	0	0
25	33239223	.	T	A	2	2	4	0	0	4	0	0
25	33239228	.	T	C	2	3	5	0	0	5	0	0
25	33242605	.	A	T	7	4	11	0	0	11	0	0
25	33242606	.	T	G	4	2	6	0	5	11	0	0
25	33249905	.	T	G	17	15	32	0	0	32	0	0
25	33250017	.	C	A	10	9	19	0	2	21	0	0
25	33250053	.	A	G	12	17	29	0	1	30	0	0
25	33258739	.	G	A	1	6	7	0	1	8	0	0
25	33258745	.	T	G	2	0	2	0	6	8	0	0
25	33259568	.	A	G	1	0	1	0	6	7	0	0
25	33262180	.	A	G	6	9	15	1	0	16	0	0
25	33265814	.	C	T	9	7	16	0	1	17	0	0
25	33265898	.	C	T	7	5	12	0	0	12	0	0
25	33266029	.	G	A	3	15	18	0	0	18	0	0
25	33266128	.	A	G	6	1	7	0	4	11	0	0
25	33266157	.	A	C	5	6	11	0	1	12	0	0
25	33962809	.	G	A	2	13	15	0	9	24	0	0
25	33963168	.	C	A	10	7	17	0	1	18	0	0
25	33963427	.	A	T	7	12	19	0	1	20	0	0
25	33964791	.	A	G	15	6	21	5	0	26	0	0
25	33964962	.	A	G	9	5	14	0	1	15	0	0
25	33964968	.	A	G	8	4	12	0	1	13	0	0
25	33965016	.	C	A	7	6	13	0	0	13	0	0
25	33965238	.	A	G	4	7	11	0	1	12	0	0
25	33965251	.	G	A	0	5	5	0	4	9	0	0
25	33965518	.	G	T	11	5	16	0	0	16	0	0
25	33965541	.	C	T	14	5	19	0	0	19	0	0
25	33965695	.	C	T	8	7	15	0	0	15	0	0
25	33965786	.	T	C	4	5	9	5	2	16	0	0
25	33965831	.	G	A	2	2	4	4	1	9	0	0
25	33965893	.	C	T	2	2	4	0	1	5	0	0
25	33965974	.	A	C	12	10	22	0	0	22	0	0
25	33966100	.	G	A	11	2	13	0	2	15	0	0
25	33966251	.	T	G	14	14	28	0	1	29	0	0
25	33966585	.	C	G	15	1	16	0	11	27	0	0
25	33966731	.	T	C	10	10	20	0	0	20	0	0
25	33966854	.	C	T	12	16	28	0	0	28	0	0
25	33966969	.	T	A	7	9	16	0	2	18	0	0
25	33967133	.	T	A	15	13	28	0	2	30	0	0
25	33967361	.	A	G	15	17	32	0	2	34	0	0
25	33967495	.	T	C	12	9	21	0	0	21	0	0
25	33967695	.	T	C	9	13	22	0	1	23	0	0
25	33967791	.	C	T	13	8	21	0	2	23	0	0
25	33967803	.	G	A	13	7	20	0	0	20	0	0
25	33968091	.	C	T	13	14	27	0	0	27	0	0
25	33968470	.	T	A	16	8	24	0	0	25	1	0
25	33968691	.	A	G	11	19	30	0	0	30	0	0
25	33968842	.	G	C	29	23	52	0	1	53	0	0
25	33968857	.	C	T	22	20	42	0	2	44	0	0
25	33968881	.	T	A	20	16	36	0	1	37	0	0
25	33983031	.	G	A	4	2	6	0	1	7	0	0
25	33983286	.	C	T	4	4	8	0	0	8	0	0
25	33983303	.	T	C	4	4	8	0	0	8	0	0
25	33987627	.	T	C	2	2	4	0	0	4	0	0
25	33987881	.	A	G	2	4	6	0	0	6	0	0
25	33988864	.	T	G	3	3	6	0	1	7	0	0
25	33988893	.	G	A	7	3	10	0	0	10	0	0
25	33988899	.	T	C	6	2	8	0	0	8	0	0
25	33991881	.	G	T	0	5	5	0	3	8	0	0
25	34002853	.	T	C	2	5	7	0	0	7	0	0
25	34014573	.	A	G	5	6	11	0	1	12	0	0
25	34017089	.	A	G	5	4	9	0	0	9	0	0
25	34018537	.	C	T	2	4	6	0	0	6	0	0
25	34020631	.	T	A	2	8	10	0	0	10	0	0
25	34022288	.	T	C	14	10	24	0	0	24	0	0
25	34022309	.	T	C	12	9	21	0	0	21	0	0
25	34027086	.	A	T	11	9	20	0	0	20	0	0
25	34027215	.	C	A	9	7	16	0	2	18	0	0
25	34027263	.	G	T	4	7	11	0	0	11	0	0
25	34154496	.	A	T	9	9	18	0	2	20	0	0
25	34154540	.	T	G	15	13	28	1	0	29	0	0
25	34154678	.	G	A	22	14	36	0	1	37	0	0
25	34247217	.	G	A	0	2	2	0	1	3	0	0
25	34251807	.	G	A	0	2	2	0	1	3	0	0
25	34267634	.	T	A	1	2	3	0	0	3	0	0
25	34268026	.	C	G	1	2	3	0	0	3	0	0
25	34268035	.	C	T	1	2	3	0	0	3	0	0
25	34421753	.	C	T	3	6	9	0	1	10	0	0
25	34426532	.	G	A	0	4	4	0	2	6	0	0
25	34455242	.	A	T	4	2	6	0	1	7	0	0
25	34456976	.	A	G	6	8	14	0	0	14	0	0
25	34457251	.	G	C	5	3	8	0	1	9	0	0
25	34457288	.	A	G	5	3	8	0	0	8	0	0
25	34457558	.	T	C	4	6	10	0	0	10	0	0
25	34457564	.	G	A	4	7	11	0	0	11	0	0
25	34457663	.	C	T	6	8	14	0	1	15	0	0
25	34457841	.	A	T	6	7	13	0	1	14	0	0
25	34458206	.	C	T	6	5	11	0	0	11	0	0
25	34487733	.	T	C	5	0	5	0	4	9	0	0
25	34487775	.	G	A	6	9	15	0	0	15	0	0
25	34487895	.	C	G	0	14	14	1	4	19	0	0
25	34488111	.	A	G	6	9	15	0	0	15	0	0
25	34488373	.	T	A	5	6	11	0	0	11	0	0
25	34488650	.	T	C	6	3	9	0	0	9	0	0
25	34489315	.	G	T	6	10	16	0	0	16	0	0
25	34511600	.	A	G	6	8	14	0	7	21	0	0
25	34511604	.	T	C	8	13	21	0	0	21	0	0
25	34511741	.	T	C	4	6	10	0	0	10	0	0
25	34511852	.	C	A	2	9	11	0	2	13	0	0
25	34511927	.	T	C	6	6	12	0	0	12	0	0
25	34511963	.	C	A	7	4	11	0	0	11	0	0
25	34643883	.	G	T	7	8	15	0	1	16	0	0
25	34643918	.	G	A	5	8	13	0	1	14	0	0
25	34647825	.	A	G	6	8	14	0	1	15	0	0
25	34649896	.	T	C	2	4	6	0	1	7	0	0
25	34649907	.	A	C	2	6	8	0	0	8	0	0
25	34662400	.	C	A	1	6	7	0	0	7	0	0
25	34662430	.	A	G	3	4	7	0	0	7	0	0
25	34670351	.	A	G	1	2	3	0	0	3	0	0
25	34670411	.	C	A	3	3	6	0	0	6	0	0
25	34697157	.	G	A	7	9	16	0	0	16	0	0
25	34703720	.	A	G	6	6	12	0	1	13	0	0
25	34703749	.	C	A	1	3	4	0	6	10	0	0
25	34704377	.	G	A	9	5	14	0	0	14	0	0
25	34706860	.	T	C	3	5	8	0	1	9	0	0
25	34706944	.	G	A	4	2	6	0	1	7	0	0
25	34709562	.	T	G	3	4	7	0	0	7	0	0
25	34713616	.	T	C	5	2	7	0	0	7	0	0
25	34714287	.	T	C	6	0	6	0	3	9	0	0
25	34718896	.	A	G	1	3	4	0	1	5	0	0
25	34722053	.	G	A	4	2	6	0	0	6	0	0
25	34722080	.	A	G	1	2	3	0	0	3	0	0
25	34728253	.	C	T	0	4	4	1	8	13	0	0
25	34728762	.	T	G	5	9	14	0	2	16	0	0
25	34728921	.	G	C	10	6	16	0	1	17	0	0
25	34728924	.	T	C	9	0	9	0	7	16	0	0
25	34762343	.	A	G	5	1	6	0	9	15	0	0
25	34762403	.	A	G	11	1	12	0	8	20	0	0
25	34763022	.	T	A	10	14	24	0	2	26	0	0
25	34763065	.	A	G	7	11	18	0	1	19	0	0
25	34763121	.	T	A	4	10	14	0	1	15	0	0
25	34763473	.	G	A	8	11	19	0	1	20	0	0
25	34765654	.	A	C	6	16	22	0	0	22	0	0
25	34765717	.	A	G	6	0	6	0	13	19	0	0
25	34765732	.	G	T	5	11	16	0	1	18	1	0
25	34794357	.	T	C	10	14	24	0	1	25	0	0
25	34797387	.	G	A	9	18	27	0	0	27	0	0
25	34798189	.	C	T	8	22	30	0	0	30	0	0
25	34798237	.	T	C	7	17	24	0	0	24	0	0
25	34798246	.	A	G	6	17	23	0	1	24	0	0
25	34799413	.	T	C	8	11	19	0	0	19	0	0
25	34799446	.	T	C	8	12	20	0	0	20	0	0
25	34801664	.	T	C	12	14	26	0	0	26	0	0
25	34802054	.	T	C	6	9	15	0	2	17	0	0
25	34802119	.	G	A	4	4	8	0	0	8	0	0
25	34802164	.	A	C	7	4	11	0	0	12	1	0
25	34802235	.	C	T	4	5	9	0	0	9	0	0
25	34802236	.	G	A	0	5	5	0	4	9	0	0
25	34802308	.	G	A	0	5	5	0	9	14	0	0
25	34802310	.	G	T	11	5	16	0	0	16	0	0
25	34802343	.	C	T	13	1	14	0	2	16	0	0
25	34802426	.	C	T	8	13	21	0	0	21	0	0
25	34802897	.	C	T	17	8	25	0	0	25	0	0
25	34802995	.	A	C	8	13	21	0	0	21	0	0
25	34803010	.	C	A	10	15	25	0	1	26	0	0
25	34803128	.	C	T	19	18	37	0	1	38	0	0
25	34803153	.	A	G	17	26	43	2	1	46	0	0
25	34803254	.	T	C	19	16	35	0	1	36	0	0
25	34803496	.	T	A	13	16	29	0	2	31	0	0
25	34803524	.	C	T	10	19	29	0	1	30	0	0
25	34803744	.	G	A	18	16	34	0	1	35	0	0
25	34803871	.	T	C	11	10	21	1	0	22	0	0
25	34803908	.	G	A	3	9	12	1	9	22	0	0
25	34803954	.	T	C	8	8	16	0	2	18	0	0
25	34804010	.	G	A	2	4	6	0	0	6	0	0
25	34804015	.	A	G	2	4	6	0	0	6	0	0
25	34804046	.	T	A	5	5	10	0	0	10	0	0
25	34811104	.	C	T	1	5	6	0	0	6	0	0
25	34818133	.	G	A	5	2	7	0	0	7	0	0
25	34825943	.	G	A	1	2	3	0	1	4	0	0
25	34833425	.	G	C	3	2	5	0	0	5	0	0
25	34835772	.	A	G	31	23	54	0	0	54	0	0
25	34841329	.	C	T	3	21	24	0	24	48	0	0
25	34844995	.	C	T	1	29	30	0	21	51	0	0
25	34845042	.	T	C	15	0	15	0	23	38	0	0
25	34851815	.	A	G	5	0	5	0	6	11	0	0
25	34859364	.	G	A	0	6	6	0	5	11	0	0
25	34859413	.	C	T	0	5	5	0	2	7	0	0
25	34859416	.	C	T	1	6	7	0	1	8	0	0
25	34889487	.	A	G	2	4	6	0	6	12	0	0
25	34889563	.	C	T	6	7	13	0	0	13	0	0
25	34956599	.	T	C	0	3	3	0	1	4	0	0
25	34972856	.	T	A	5	4	9	0	0	9	0	0
25	34973070	.	C	T	4	4	8	0	1	9	0	0
25	34973090	.	C	A	4	6	10	0	0	10	0	0
25	34976212	.	T	C	2	2	4	0	0	4	0	0
25	35002394	.	G	A	34	28	62	2	2	66	0	0
25	35005362	.	G	A	33	27	60	1	3	64	0	0
25	35006830	.	G	A	6	29	35	0	26	61	0	0
25	35006989	.	C	T	37	29	66	0	2	68	0	0
25	35007857	.	C	T	37	24	61	0	2	63	0	0
25	35007864	.	G	A	35	25	60	0	1	61	0	0
25	35270407	.	A	G	17	18	35	0	1	36	0	0
25	35467246	.	A	C	1	2	3	1	1	5	0	0
25	35713260	.	G	A	16	7	23	0	2	25	0	0
25	35713263	.	G	C	16	5	21	0	0	21	0	0
25	35765181	.	A	G	15	14	29	0	1	30	0	0
25	36040526	.	A	G	1	2	3	0	0	3	0	0
25	36199444	.	T	C	3	0	3	1	9	13	0	0
25	37335959	.	A	G	2	4	6	0	0	6	0	0
25	37335961	.	A	G	2	4	6	0	0	6	0	0
25	37336710	.	A	G	2	4	6	0	0	6	0	0
25	37470588	.	G	C	9	2	11	0	0	11	0	0
3	13937	.	C	T	7	4	11	9	0	20	0	0
3	40869	.	G	C	2	7	9	2	1	12	0	0
3	40915	.	C	T	0	2	2	0	2	4	0	0
3	240680	.	G	A	0	6	6	0	1	7	0	0
3	240735	.	C	A	4	5	9	1	1	11	0	0
3	441342	.	A	G	4	7	11	0	0	11	0	0
3	441393	.	A	G	6	3	9	1	0	10	0	0
3	441445	.	A	G	4	2	6	0	0	6	0	0
3	1130299	.	C	A	3	9	12	0	2	14	0	0
3	1323879	.	T	A	4	7	11	0	1	12	0	0
3	1324064	.	C	A	12	11	23	0	0	23	0	0
3	1324281	.	G	T	9	4	13	0	1	14	0	0
3	1324300	.	T	C	7	5	12	0	2	14	0	0
3	1324383	.	G	C	4	0	4	0	5	9	0	0
3	1324509	.	C	A	5	6	11	0	0	11	0	0
3	1324515	.	C	T	6	7	13	0	0	13	0	0
3	1337593	.	A	G	5	6	11	0	1	12	0	0
3	1337674	.	T	C	5	0	5	0	7	12	0	0
3	1339147	.	T	A	10	10	20	0	1	21	0	0
3	1500002	.	A	C	9	6	15	0	1	16	0	0
3	1500004	.	A	T	8	9	17	0	0	17	0	0
3	3610202	.	A	T	6	2	8	0	0	8	0	0
3	3610224	.	C	T	3	5	8	0	0	8	0	0
3	3617633	.	G	A	0	6	6	0	8	14	0	0
3	3630587	.	T	C	5	11	16	0	0	17	1	0
3	3631407	.	T	C	10	5	15	0	0	15	0	0
3	3634408	.	G	A	9	4	13	0	2	15	0	0
3	3813838	.	C	T	5	2	7	0	0	7	0	0
3	4461144	.	G	A	1	4	5	0	0	5	0	0
3	4461179	.	T	G	1	3	4	0	0	4	0	0
3	4502158	.	C	A	10	11	21	0	1	22	0	0
3	4506897	.	A	G	6	7	13	0	0	13	0	0
3	4506961	.	G	A	0	3	3	0	6	9	0	0
3	4507825	.	T	C	8	5	13	0	0	13	0	0
3	4508042	.	A	C	7	12	19	0	0	19	0	0
3	4508093	.	C	A	15	8	23	0	2	25	0	0
3	4508120	.	C	T	15	10	25	0	0	25	0	0
3	4511020	.	C	T	10	7	17	0	1	18	0	0
3	4511052	.	T	C	8	9	17	0	1	18	0	0
3	4511163	.	A	G	9	0	9	0	3	12	0	0
3	4516925	.	C	A	14	13	27	0	1	28	0	0
3	4530061	.	G	A	10	9	19	0	2	21	0	0
3	4997623	.	C	T	2	3	5	0	0	5	0	0
3	4997917	.	A	T	2	2	4	0	0	4	0	0
3	5009112	.	G	C	13	0	13	0	11	24	0	0
3	5012832	.	C	G	1	11	12	0	9	21	0	0
3	5021432	.	G	A	12	11	23	0	0	23	0	0
3	5021453	.	C	T	0	12	12	0	12	24	0	0
3	5040591	.	A	G	1	2	3	0	0	3	0	0
3	5052823	.	T	G	6	9	15	1	0	16	0	0
3	5052868	.	G	A	13	7	20	5	1	26	0	0
3	5053060	.	C	T	1	22	23	0	20	43	0	0
3	5053454	.	T	A	13	16	29	0	2	31	0	0
3	5053934	.	G	A	19	21	40	0	1	41	0	0
3	5053988	.	C	G	22	21	43	0	0	43	0	0
3	5056247	.	G	A	17	21	38	0	1	39	0	0
3	5056390	.	A	T	23	20	43	2	1	47	1	0
3	5062827	.	C	T	14	21	35	0	1	36	0	0
3	5063125	.	G	A	17	15	32	0	1	33	0	0
3	5063176	.	G	A	18	19	37	0	1	38	0	0
3	5067581	.	T	A	8	16	24	0	0	24	0	0
3	5130791	.	C	A	5	7	12	0	0	12	0	0
3	5130851	.	T	C	9	8	17	0	0	17	0	0
3	5134113	.	G	A	6	10	16	0	0	16	0	0
3	5134122	.	G	A	11	4	15	0	0	15	0	0
3	5134669	.	T	C	8	8	16	0	1	17	0	0
3	5136617	.	G	A	6	4	10	0	0	10	0	0
3	5140851	.	A	G	6	6	12	0	1	13	0	0
3	5141035	.	C	T	5	9	14	0	0	14	0	0
3	5141152	.	C	T	5	3	8	0	0	8	0	0
3	5143119	.	C	T	2	5	7	0	1	8	0	0
3	5143522	.	C	T	6	3	9	0	1	10	0	0
3	5145139	.	C	A	1	4	5	0	3	8	0	0
3	5145797	.	C	T	0	7	7	0	11	18	0	0
3	5147544	.	G	A	5	4	9	0	0	9	0	0
3	5147606	.	G	T	5	3	8	0	0	8	0	0
3	5152715	.	T	C	3	4	7	0	1	8	0	0
3	5159345	.	G	A	1	2	3	0	0	3	0	0
3	5163826	.	C	T	1	3	4	0	1	5	0	0
3	5163889	.	G	A	1	4	5	0	2	7	0	0
3	5171431	.	C	A	1	1	2	0	0	2	0	0
3	5265679	.	A	G	4	14	18	0	0	18	0	0
3	5265754	.	C	T	10	14	24	0	0	24	0	0
3	5267221	.	G	A	14	19	33	1	0	34	0	0
3	5267251	.	C	T	14	9	23	0	0	23	0	0
3	5270274	.	C	T	1	16	17	0	16	33	0	0
3	5624487	.	C	T	3	23	26	0	18	44	0	0
3	5633056	.	A	G	8	15	23	0	2	25	0	0
3	5633089	.	G	A	10	9	19	0	0	19	0	0
3	5633122	.	A	G	9	9	18	0	2	20	0	0
3	5634976	.	A	G	20	6	26	0	3	29	0	0
3	5719007	.	G	T	2	2	4	0	0	4	0	0
3	5723632	.	A	G	1	4	5	0	0	5	0	0
3	5723652	.	A	T	1	4	5	0	1	6	0	0
3	5778981	.	G	A	13	10	23	0	2	25	0	0
3	5779044	.	T	A	12	11	23	0	1	24	0	0
3	5779093	.	G	T	10	13	23	0	2	25	0	0
3	5782501	.	A	G	9	10	19	0	2	21	0	0
3	5782715	.	A	G	8	16	24	0	0	24	0	0
3	5812205	.	C	T	9	8	17	0	0	17	0	0
3	5812802	.	C	T	2	3	5	0	11	16	0	0
3	5812813	.	G	A	7	5	12	0	4	16	0	0
3	5814475	.	C	T	7	6	13	0	3	16	0	0
3	5814478	.	C	T	7	8	15	0	1	16	0	0
3	5823477	.	G	A	6	4	10	0	0	10	0	0
3	5823483	.	C	A	0	4	4	0	6	10	0	0
3	5824858	.	C	T	4	3	7	0	0	7	0	0
3	5829415	.	A	G	5	4	9	0	0	9	0	0
3	5882439	.	A	G	2	2	4	0	0	4	0	0
3	5882661	.	T	C	3	3	6	0	0	6	0	0
3	5882798	.	T	A	1	0	1	0	1	2	0	0
3	5882808	.	C	T	0	2	2	0	0	2	0	0
3	5886917	.	C	T	1	27	28	0	31	59	0	0
3	5887223	.	T	C	16	20	36	0	1	37	0	0
3	5887463	.	T	G	16	23	39	0	2	41	0	0
3	5887661	.	A	T	22	18	40	0	1	41	0	0
3	5887673	.	G	C	24	2	26	0	19	45	0	0
3	5887715	.	T	C	17	14	31	0	7	38	0	0
3	5887841	.	T	A	21	18	39	0	5	44	0	0
3	5887931	.	A	T	19	12	31	0	4	35	0	0
3	5888245	.	C	T	21	10	31	0	0	31	0	0
3	5888664	.	G	A	10	6	16	0	0	16	0	0
3	5888868	.	G	A	14	9	23	0	1	24	0	0
3	5889077	.	G	T	14	12	26	0	0	26	0	0
3	5889302	.	T	C	12	5	17	0	0	17	0	0
3	5889642	.	A	T	9	4	13	0	1	14	0	0
3	5890274	.	T	A	10	6	16	0	1	17	0	0
3	5890287	.	A	G	10	7	17	0	1	18	0	0
3	5890698	.	C	T	1	11	12	0	8	20	0	0
3	5908262	.	C	T	4	4	8	0	0	8	0	0
3	5908302	.	T	C	5	0	5	0	4	9	0	0
3	5908452	.	T	C	4	0	4	0	11	15	0	0
3	5908569	.	C	A	0	4	4	0	8	12	0	0
3	5964113	.	G	A	3	7	10	0	0	10	0	0
3	5991798	.	C	T	1	5	6	0	6	12	0	0
3	5991822	.	G	A	6	8	14	0	0	14	0	0
3	5995071	.	A	G	2	2	4	0	0	4	0	0
3	6018562	.	A	G	2	3	5	0	0	5	0	0
3	6380368	.	T	C	34	21	55	0	5	60	0	0
3	6417172	.	G	A	19	30	49	0	3	52	0	0
3	6444075	.	C	A	2	3	5	0	0	5	0	0
3	6457308	.	T	G	2	3	5	0	0	5	0	0
3	6474593	.	A	G	5	8	13	0	1	14	0	0
3	6477596	.	G	C	2	6	8	0	0	8	0	0
3	6491540	.	C	T	4	7	11	1	1	13	0	0
3	6491542	.	G	T	4	8	12	1	0	13	0	0
3	6491670	.	C	T	4	6	10	1	0	11	0	0
3	6491820	.	A	T	3	9	12	0	0	12	0	0
3	6491833	.	A	G	2	10	12	0	1	13	0	0
3	6491881	.	G	T	2	8	10	0	1	11	0	0
3	6491906	.	T	C	2	3	5	0	1	6	0	0
3	6495017	.	G	A	2	4	6	0	0	6	0	0
3	6498049	.	C	G	1	5	6	0	8	14	0	0
3	6499606	.	T	C	4	0	4	0	7	11	0	0
3	6499636	.	A	G	5	4	9	0	0	9	0	0
3	6502039	.	G	A	5	6	11	0	2	13	0	0
3	6504814	.	T	A	9	7	16	0	0	16	0	0
3	6505007	.	G	T	4	2	6	0	0	6	0	0
3	6505010	.	T	C	4	3	7	0	0	7	0	0
3	6516457	.	C	T	0	2	2	0	1	3	0	0
3	6659702	.	G	A	0	4	4	0	5	9	0	0
3	6659843	.	C	T	5	3	8	0	0	8	0	0
3	6664358	.	T	G	1	6	7	0	0	7	0	0
3	6664609	.	T	C	5	7	12	0	0	12	0	0
3	6664643	.	A	G	7	2	9	0	0	9	0	0
3	6664915	.	A	G	3	5	8	0	1	9	0	0
3	6664943	.	A	G	1	2	3	0	0	3	0	0
3	6665784	.	G	A	2	3	5	0	0	5	0	0
3	6665902	.	G	T	1	4	5	0	1	6	0	0
3	6665951	.	C	A	5	5	10	0	0	10	0	0
3	6665985	.	A	T	6	6	12	0	0	12	0	0
3	6666027	.	C	T	5	7	12	0	0	12	0	0
3	6666080	.	A	G	7	7	14	0	0	14	0	0
3	6666092	.	T	C	8	9	17	0	0	17	0	0
3	6666194	.	G	C	7	10	17	0	1	18	0	0
3	6666283	.	A	T	7	9	16	0	0	16	0	0
3	6666342	.	A	G	8	1	9	0	0	9	0	0
3	6666362	.	G	A	3	7	10	0	0	10	0	0
3	6666846	.	T	C	2	3	5	0	0	5	0	0
3	6667060	.	G	C	14	9	23	0	1	24	0	0
3	6667209	.	C	T	6	14	20	0	0	20	0	0
3	6667383	.	T	C	1	2	3	0	0	3	0	0
3	6721278	.	A	G	3	2	5	0	0	5	0	0
3	6721286	.	G	C	4	3	7	0	0	7	0	0
3	6721421	.	T	G	10	9	19	0	0	19	0	0
3	6721456	.	A	T	7	5	12	0	1	13	0	0
3	6721497	.	T	A	6	6	12	0	0	12	0	0
3	6721504	.	A	T	6	7	13	0	0	13	0	0
3	6721763	.	T	C	8	8	16	0	1	17	0	0
3	6721773	.	T	G	8	9	17	0	0	17	0	0
3	6721851	.	C	T	10	9	19	0	1	20	0	0
3	6722021	.	T	A	9	10	19	0	0	19	0	0
3	6722070	.	C	G	8	6	14	0	0	14	0	0
3	6722333	.	C	A	5	4	9	0	0	9	0	0
3	6722341	.	G	A	6	6	12	0	0	12	0	0
3	6722401	.	T	C	8	10	18	0	2	20	0	0
3	6722438	.	C	T	6	7	13	0	1	14	0	0
3	6722904	.	G	A	20	6	26	0	1	27	0	0
3	6725150	.	G	C	1	6	7	1	0	8	0	0
3	6725699	.	C	G	0	4	4	0	3	7	0	0
3	6725704	.	A	G	4	5	9	0	0	9	0	0
3	6725737	.	T	A	4	3	7	0	0	7	0	0
3	6725951	.	A	G	1	1	2	0	1	3	0	0
3	6726053	.	T	C	3	5	8	0	2	10	0	0
3	6726170	.	G	T	3	4	7	0	0	7	0	0
3	6726284	.	A	T	6	8	14	0	0	14	0	0
3	6726323	.	T	G	4	3	7	0	0	7	0	0
3	6726359	.	G	A	6	7	13	0	0	13	0	0
3	6727154	.	C	T	1	9	10	0	6	16	0	0
3	6731289	.	G	T	5	4	9	0	0	9	0	0
3	6732346	.	T	A	1	3	4	0	0	4	0	0
3	6732696	.	G	A	1	2	3	0	0	3	0	0
3	6732697	.	C	T	0	2	2	0	1	3	0	0
3	6737079	.	G	A	5	3	8	0	0	8	0	0
3	6737099	.	G	T	5	4	9	0	0	9	0	0
3	6749311	.	T	C	1	3	4	0	0	4	0	0
3	6895631	.	T	C	1	2	3	0	0	3	0	0
3	7007342	.	T	C	1	2	3	0	0	3	0	0
3	7008290	.	C	T	3	4	7	0	0	7	0	0
3	7008415	.	C	T	4	7	11	0	0	11	0	0
3	7008594	.	A	G	1	2	3	0	0	3	0	0
3	7008690	.	C	A	1	3	4	1	0	5	0	0
3	7081625	.	C	T	0	2	2	0	2	4	0	0
3	7099049	.	C	T	3	6	9	1	0	10	0	0
3	7099285	.	G	T	2	3	5	0	0	5	0	0
3	7099344	.	A	G	1	6	7	0	0	7	0	0
3	7099380	.	C	T	1	9	10	0	0	10	0	0
3	7099600	.	T	C	2	4	6	0	0	6	0	0
3	7099791	.	G	A	2	5	7	0	0	7	0	0
3	7112990	.	C	T	1	6	7	0	6	13	0	0
3	7113036	.	G	T	6	6	12	0	0	12	0	0
3	7113075	.	T	G	5	6	11	0	0	11	0	0
3	7113126	.	A	G	6	8	14	0	0	14	0	0
3	7113327	.	T	C	4	0	4	0	7	11	0	0
3	7113330	.	T	C	4	5	9	0	1	10	0	0
3	7113660	.	A	G	5	7	12	0	1	13	0	0
3	7113669	.	C	T	5	7	12	0	0	12	0	0
3	7113720	.	G	A	6	8	14	0	0	14	0	0
3	7113934	.	A	G	2	4	6	0	0	6	0	0
3	7124140	.	G	A	3	4	7	0	0	7	0	0
3	7124437	.	A	G	4	4	8	1	0	9	0	0
3	7133388	.	G	A	5	5	10	2	0	12	0	0
3	7133435	.	T	G	3	2	5	0	2	7	0	0
3	7133743	.	A	G	3	4	7	0	1	8	0	0
3	7133751	.	A	G	3	5	8	0	0	8	0	0
3	7133967	.	G	A	1	4	5	0	0	5	0	0
3	7141846	.	G	A	3	3	6	0	2	8	0	0
3	7141924	.	G	A	3	3	6	0	0	6	0	0
3	7142372	.	C	G	2	3	5	0	0	5	0	0
3	7147176	.	G	C	4	1	5	3	2	10	0	0
3	7147182	.	G	A	4	2	6	3	0	9	0	0
3	7155012	.	T	C	5	0	5	0	3	8	0	0
3	7155039	.	T	C	7	3	10	0	0	10	0	0
3	7155156	.	C	T	4	4	8	0	0	8	0	0
3	7155196	.	T	A	2	8	10	3	0	13	0	0
3	7155198	.	A	G	1	7	8	3	2	13	0	0
3	7156141	.	C	T	1	2	3	1	0	4	0	0
3	7509988	.	G	T	1	2	3	0	0	3	0	0
3	7510596	.	A	G	1	3	4	0	0	4	0	0
3	7546153	.	G	A	2	3	5	0	1	6	0	0
3	7638508	.	A	G	7	4	11	0	3	14	0	0
3	7638510	.	A	G	6	7	13	0	0	13	0	0
3	7779964	.	C	T	5	2	7	0	0	7	0	0
3	8399709	.	A	G	3	3	6	0	1	7	0	0
3	8399799	.	C	T	2	3	5	0	0	5	0	0
3	10162939	.	T	C	2	3	5	0	0	5	0	0
3	10163287	.	C	G	2	0	2	0	5	7	0	0
3	10163302	.	T	C	3	4	7	0	0	7	0	0
3	10163405	.	T	C	0	3	3	0	0	3	0	0
3	10163410	.	A	C	2	2	4	0	0	4	0	0
3	10163785	.	A	G	3	0	3	0	2	5	0	0
3	10163815	.	G	A	5	2	7	0	1	8	0	0
3	10164025	.	C	T	5	3	8	0	0	8	0	0
3	10164338	.	C	G	1	2	3	0	0	3	0	0
3	10411054	.	T	C	1	5	6	0	0	6	0	0
3	11554135	.	A	G	6	0	6	0	11	17	0	0
3	11554141	.	T	C	6	12	18	0	0	18	0	0
3	11558287	.	G	A	6	7	13	0	1	14	0	0
3	11575354	.	G	A	1	9	10	0	9	19	0	0
3	11575471	.	T	C	11	5	16	0	1	17	0	0
3	11575591	.	C	A	5	3	8	0	2	10	0	0
3	11575675	.	C	G	0	12	12	0	1	13	0	0
3	11585815	.	A	G	9	4	13	0	0	13	0	0
3	11585852	.	T	A	10	8	18	0	1	19	0	0
3	11585937	.	G	A	9	16	25	0	1	26	0	0
3	11586331	.	C	T	6	12	18	0	21	39	0	0
3	11586346	.	C	T	27	12	39	0	1	40	0	0
3	11586382	.	G	A	29	13	42	0	2	44	0	0
3	11586635	.	A	G	26	13	39	0	4	43	0	0
3	11586679	.	C	T	19	9	28	4	2	34	0	0
3	11586695	.	C	T	1	6	7	5	16	28	0	0
3	11590280	.	A	G	14	18	32	0	2	34	0	0
3	11614970	.	T	C	29	13	42	1	2	45	0	0
3	11615007	.	A	T	32	14	46	1	2	49	0	0
3	11615041	.	T	C	26	1	27	0	23	50	0	0
3	11615109	.	G	A	29	18	47	0	0	47	0	0
3	11615133	.	A	G	25	17	42	0	3	45	0	0
3	11615224	.	A	G	17	21	38	0	2	40	0	0
3	11624298	.	A	G	14	14	28	0	2	30	0	0
3	11781003	.	A	C	18	15	33	3	1	38	1	0
3	11781079	.	T	C	16	13	29	0	1	30	0	0
3	11781113	.	G	A	19	19	38	0	1	39	0	0
3	11784743	.	G	A	17	16	33	0	2	35	0	0
3	11797076	.	C	T	1	11	12	0	9	21	0	0
3	11947254	.	A	G	6	7	13	0	1	14	0	0
3	13424069	.	C	A	8	4	12	0	0	12	0	0
3	13424392	.	T	G	5	3	8	0	0	8	0	0
3	13424418	.	T	A	4	3	7	0	1	8	0	0
3	13424467	.	C	A	4	2	6	0	0	6	0	0
3	13424595	.	A	T	3	5	8	0	0	8	0	0
3	13424601	.	T	G	3	5	8	0	0	8	0	0
3	13424635	.	G	A	2	2	4	0	0	4	0	0
3	13424847	.	G	T	6	11	17	0	3	20	0	0
3	13424877	.	T	C	9	12	21	0	2	23	0	0
3	13424919	.	T	C	8	14	22	0	0	22	0	0
3	13424950	.	A	T	9	11	20	0	2	22	0	0
3	13424968	.	C	T	13	6	19	0	0	19	0	0
3	13424989	.	C	A	0	4	4	0	13	17	0	0
3	13426754	.	C	A	0	8	8	0	5	13	0	0
3	13430606	.	A	G	9	14	23	0	1	24	0	0
3	13431327	.	G	A	16	10	26	0	0	26	0	0
3	13432609	.	C	T	10	9	19	0	1	20	0	0
3	13434860	.	C	T	1	9	10	0	7	17	0	0
3	13434888	.	A	G	8	12	20	0	0	20	0	0
3	13434920	.	C	G	7	10	17	0	0	17	0	0
3	13434930	.	A	T	7	8	15	0	1	16	0	0
3	13435924	.	A	G	4	13	17	0	1	18	0	0
3	13435998	.	T	C	8	2	10	0	11	21	0	0
3	13437767	.	G	A	6	6	12	0	2	14	0	0
3	13441459	.	G	A	3	5	8	0	11	19	0	0
3	13445758	.	G	A	0	13	13	0	11	24	0	0
3	13445819	.	T	C	8	8	16	0	1	17	0	0
3	13445884	.	T	G	4	7	11	0	0	11	0	0
3	13446019	.	C	T	7	7	14	0	0	14	0	0
3	13447870	.	C	T	10	10	20	0	1	21	0	0
3	13453494	.	C	T	6	6	12	0	0	12	0	0
3	13453500	.	A	G	5	5	10	0	0	10	0	0
3	13456393	.	G	A	2	3	5	0	0	5	0	0
3	13456436	.	A	G	3	5	8	0	0	8	0	0
3	13456472	.	C	T	0	4	4	0	6	10	0	0
3	13456492	.	T	C	2	5	7	0	1	8	0	0
3	13458400	.	T	C	1	0	1	0	3	4	0	0
3	13487973	.	G	A	1	5	6	0	0	6	0	0
3	13488422	.	C	T	5	2	7	0	0	7	0	0
3	13488486	.	T	A	7	3	10	0	1	11	0	0
3	13488518	.	G	C	3	2	5	0	0	5	0	0
3	13502299	.	A	C	4	3	7	0	0	7	0	0
3	13525976	.	C	G	6	5	11	0	0	11	0	0
3	13526043	.	A	G	3	4	7	0	0	7	0	0
3	13534291	.	C	T	1	5	6	0	4	10	0	0
3	13534311	.	G	C	4	2	6	0	0	6	0	0
3	13534339	.	C	T	0	5	5	0	3	8	0	0
3	13535827	.	C	T	0	3	3	0	3	6	0	0
3	13542252	.	C	T	2	7	9	0	0	9	0	0
3	13582031	.	A	T	2	3	5	0	0	5	0	0
3	13582156	.	T	C	14	8	22	0	3	25	0	0
3	13582181	.	G	A	15	12	27	0	4	31	0	0
3	13582217	.	G	T	19	12	31	0	2	33	0	0
3	13582220	.	A	T	21	12	33	0	0	33	0	0
3	13582288	.	A	T	26	11	37	0	3	40	0	0
3	13582295	.	T	A	22	10	32	0	3	35	0	0
3	13582547	.	C	G	4	14	18	0	14	32	0	0
3	13589391	.	G	T	18	11	29	0	1	30	0	0
3	13589412	.	G	A	17	11	28	0	0	28	0	0
3	13589469	.	A	G	17	17	34	0	1	35	0	0
3	13590995	.	G	A	14	18	32	0	0	32	0	0
3	13593605	.	C	T	9	13	22	0	3	25	0	0
3	13595245	.	G	A	12	11	23	0	0	23	0	0
3	13595686	.	C	T	15	14	29	0	1	30	0	0
3	13599436	.	A	G	6	16	22	0	0	22	0	0
3	13603365	.	T	G	3	2	5	0	0	5	0	0
3	13607036	.	G	A	2	3	5	0	1	6	0	0
3	13607051	.	T	C	2	4	6	0	0	6	0	0
3	13608153	.	A	G	2	3	5	0	0	5	0	0
3	13608154	.	A	C	2	0	2	0	3	5	0	0
3	13617738	.	T	A	4	4	8	0	0	8	0	0
3	13618203	.	A	T	2	4	6	0	0	6	0	0
3	14496729	.	T	C	17	1	18	0	21	39	0	0
3	14496811	.	T	C	20	17	37	0	2	39	0	0
3	14496823	.	T	C	27	11	38	0	4	42	0	0
3	14507505	.	A	G	4	4	8	0	0	8	0	0
3	14507506	.	A	G	4	3	7	0	1	8	0	0
3	14859756	.	C	T	3	5	8	0	0	8	0	0
3	14860158	.	C	T	9	9	18	0	4	22	0	0
3	15057214	.	G	T	13	17	30	0	4	34	0	0
3	15057321	.	T	C	14	6	20	0	1	21	0	0
3	15057549	.	T	G	13	14	27	0	1	28	0	0
3	15057656	.	G	A	1	9	10	0	13	23	0	0
3	15057696	.	T	C	12	7	19	0	0	19	0	0
3	15057928	.	G	A	10	5	15	0	0	15	0	0
3	15058259	.	G	T	12	7	19	1	0	20	0	0
3	15058323	.	A	G	5	8	13	0	3	16	0	0
3	15085422	.	G	A	2	5	7	0	2	9	0	0
3	15085528	.	C	T	6	3	9	0	1	10	0	0
3	15085530	.	G	T	6	4	10	0	0	10	0	0
3	15085673	.	G	A	10	18	28	0	1	29	0	0
3	15085784	.	G	C	10	11	21	0	0	21	0	0
3	15085821	.	C	T	6	6	12	0	2	14	0	0
3	15091183	.	C	T	1	9	10	0	4	14	0	0
3	15098913	.	C	G	4	2	6	0	0	6	0	0
3	15113395	.	C	T	8	2	10	0	0	10	0	0
3	15214691	.	G	C	6	0	6	0	8	14	0	0
3	15358783	.	C	T	3	2	5	0	0	5	0	0
3	15629022	.	T	C	5	7	12	0	1	13	0	0
3	15670778	.	T	C	5	2	7	0	1	8	0	0
3	15988337	.	A	G	19	30	49	0	0	49	0	0
3	15988435	.	A	G	16	4	20	2	1	23	0	0
3	16389180	.	G	T	4	5	9	0	1	10	0	0
3	16389230	.	C	T	10	6	16	0	0	16	0	0
3	16389517	.	C	T	15	8	23	0	2	25	0	0
3	16391695	.	G	A	11	7	18	0	2	20	0	0
3	16391719	.	T	C	7	0	7	0	10	17	0	0
3	16394522	.	A	G	2	8	10	0	0	10	0	0
3	16395548	.	A	G	6	4	10	0	0	10	0	0
3	16397627	.	A	T	2	8	10	0	2	12	0	0
3	16404204	.	T	C	3	5	8	0	0	8	0	0
3	16404370	.	G	A	5	3	8	0	2	10	0	0
3	16404382	.	G	A	3	4	7	0	0	7	0	0
3	16409330	.	G	A	5	2	7	0	0	7	0	0
3	16644872	.	C	T	9	10	19	0	1	20	0	0
3	16648459	.	G	T	12	8	20	0	1	21	0	0
3	16650129	.	G	A	8	10	18	0	1	19	0	0
3	16668671	.	C	T	5	4	9	0	0	9	0	0
3	16671903	.	G	A	0	11	11	0	7	18	0	0
3	16679136	.	C	T	9	9	18	0	0	18	0	0
3	16679248	.	C	T	8	7	15	0	2	17	0	0
3	16679331	.	T	C	8	6	14	0	2	16	0	0
3	16679349	.	G	A	8	5	13	0	1	14	0	0
3	16679387	.	G	A	6	3	9	0	1	10	0	0
3	16679520	.	G	A	8	4	12	0	0	12	0	0
3	16679556	.	G	A	1	5	6	0	7	13	0	0
3	16679561	.	A	G	8	0	8	0	5	13	0	0
3	16692232	.	A	G	3	6	9	0	1	10	0	0
3	16696185	.	G	A	2	2	4	0	0	4	0	0
3	16729101	.	G	A	2	3	5	0	0	5	0	0
3	16731938	.	A	G	4	0	4	0	10	14	0	0
3	16733790	.	C	T	3	5	8	0	0	8	0	0
3	16735423	.	C	T	3	7	10	0	0	10	0	0
3	16735507	.	C	T	5	4	9	0	1	10	0	0
3	16738857	.	T	A	9	9	18	0	0	18	0	0
3	16741179	.	A	C	9	9	18	0	1	19	0	0
3	16741830	.	A	G	7	8	15	0	0	15	0	0
3	16741851	.	T	C	8	9	17	0	1	18	0	0
3	16746153	.	A	C	22	15	37	0	1	38	0	0
3	16746659	.	A	T	2	4	6	0	0	6	0	0
3	16746666	.	T	C	2	3	5	0	0	5	0	0
3	16746796	.	G	A	5	5	10	0	2	12	0	0
3	16746947	.	A	T	10	10	20	0	0	20	0	0
3	16747229	.	A	G	6	1	7	0	5	12	0	0
3	16747233	.	G	T	0	5	5	0	7	12	0	0
3	16842343	.	G	A	5	2	7	0	0	7	0	0
3	16872785	.	G	T	0	4	4	0	0	4	0	0
3	16872786	.	T	G	1	3	4	0	1	5	0	0
3	16972877	.	T	C	1	2	3	0	0	3	0	0
3	16972878	.	G	T	1	2	3	0	0	3	0	0
3	16972949	.	T	A	4	5	9	0	0	9	0	0
3	16972991	.	T	C	3	6	9	0	0	9	0	0
3	17093097	.	T	C	4	6	10	0	0	10	0	0
3	17458054	.	C	T	2	2	4	0	0	4	0	0
3	17458888	.	A	G	2	0	2	0	6	8	0	0
3	17458960	.	C	T	5	2	7	0	0	7	0	0
3	17488995	.	A	G	5	0	5	0	7	12	0	0
3	17489004	.	A	T	5	7	12	0	0	12	0	0
3	17522960	.	A	G	1	0	1	0	11	12	0	0
3	17591200	.	G	A	2	2	4	0	0	4	0	0
3	17600190	.	C	T	2	3	5	0	0	5	0	0
3	17600201	.	C	T	2	2	4	0	1	5	0	0
3	17601239	.	A	C	5	4	9	0	0	9	0	0
3	17601247	.	C	T	4	5	9	0	1	10	0	0
3	17601383	.	A	C	3	2	5	0	0	5	0	0
3	17601473	.	T	G	3	2	5	0	0	5	0	0
3	17601611	.	A	T	1	2	3	0	0	3	0	0
3	17601636	.	C	A	0	3	3	0	1	4	0	0
3	17601690	.	T	G	2	4	6	0	0	6	0	0
3	17601692	.	T	C	2	3	5	0	1	6	0	0
3	17650983	.	G	A	18	32	50	0	1	51	0	0
3	17651208	.	C	A	25	11	36	0	9	45	0	0
3	17651508	.	G	A	22	14	36	1	1	38	0	0
3	17651718	.	C	T	21	21	42	0	2	44	0	0
3	17651837	.	C	T	16	16	32	0	0	32	0	0
3	17651847	.	C	A	13	13	26	0	2	28	0	0
3	17653813	.	A	T	2	2	4	0	0	4	0	0
3	17653924	.	T	C	2	3	5	0	0	5	0	0
3	17660156	.	C	T	1	2	3	0	0	3	0	0
3	17669406	.	G	A	5	5	10	0	1	11	0	0
3	17669427	.	A	G	4	4	8	0	0	8	0	0
3	17669502	.	T	A	4	6	10	0	0	10	0	0
3	17671567	.	C	T	4	6	10	0	0	10	0	0
3	17673386	.	C	T	8	3	11	0	2	13	0	0
3	17678335	.	T	C	6	9	15	0	0	15	0	0
3	17744438	.	T	A	2	5	7	0	1	8	0	0
3	17867564	.	T	C	17	8	25	0	3	28	0	0
3	17867716	.	C	A	7	3	10	0	0	10	0	0
3	17867784	.	T	C	6	4	10	2	2	14	0	0
3	17867870	.	T	C	7	8	15	0	1	16	0	0
3	17868174	.	T	G	6	3	9	0	0	9	0	0
3	17868710	.	T	C	2	5	7	0	0	7	0	0
3	17868776	.	C	T	2	4	6	0	0	6	0	0
3	17868949	.	G	C	9	10	19	0	0	19	0	0
3	17869030	.	G	C	8	7	15	0	2	17	0	0
3	17869300	.	G	A	12	7	19	0	1	20	0	0
3	17878505	.	A	G	21	14	35	0	0	35	0	0
3	17886528	.	G	A	7	19	26	0	0	26	0	0
3	17886996	.	C	T	8	15	23	0	0	23	0	0
3	17943332	.	A	G	6	3	9	0	0	9	0	0
3	18376408	.	A	T	10	14	24	0	2	26	0	0
3	18435107	.	T	C	1	5	6	0	0	6	0	0
3	18686781	.	T	C	9	0	9	0	19	28	0	0
3	18838547	.	C	T	2	3	5	0	2	7	0	0
3	18838559	.	T	A	3	4	7	0	1	8	0	0
3	18838715	.	G	C	1	5	6	0	1	7	0	0
3	18838878	.	C	T	4	6	10	0	0	10	0	0
3	18838900	.	T	A	5	3	8	0	0	8	0	0
3	18839017	.	C	T	6	3	9	0	1	10	0	0
3	18922801	.	G	A	4	2	6	0	0	6	0	0
3	18922819	.	C	T	2	2	4	0	0	4	0	0
3	18923536	.	C	T	3	2	5	0	1	6	0	0
3	18923824	.	A	T	2	4	6	0	0	6	0	0
3	19006010	.	G	A	10	6	16	0	1	17	0	0
3	19006388	.	G	A	12	13	25	0	1	26	0	0
3	19019232	.	A	G	4	5	9	0	0	9	0	0
3	19042691	.	A	C	1	3	4	0	0	4	0	0
3	19068868	.	G	A	2	7	9	0	1	10	0	0
3	19090629	.	A	G	2	4	6	0	0	6	0	0
3	19090884	.	A	G	1	3	4	0	0	4	0	0
3	19162654	.	A	G	10	4	14	0	0	14	0	0
3	19162663	.	A	G	9	4	13	0	0	13	0	0
3	19162717	.	A	G	5	7	12	0	1	13	0	0
3	19172078	.	A	G	4	4	8	0	1	9	0	0
3	19172087	.	C	T	2	3	5	0	4	9	0	0
3	19172284	.	G	T	6	6	12	0	1	13	0	0
3	19180634	.	G	A	2	2	4	0	0	4	0	0
3	19180650	.	C	G	3	3	6	0	0	6	0	0
3	19180775	.	C	A	2	7	9	0	0	9	0	0
3	19180778	.	A	G	2	5	7	0	1	8	0	0
3	19180811	.	C	T	3	6	9	0	0	9	0	0
3	19194126	.	C	T	2	3	5	0	5	10	0	0
3	19194135	.	A	T	4	4	8	0	0	8	0	0
3	19207219	.	A	G	18	0	18	0	7	25	0	0
3	19210238	.	T	C	12	17	29	0	1	30	0	0
3	19210287	.	A	G	20	0	20	0	16	36	0	0
3	19210352	.	A	G	12	11	23	0	0	23	0	0
3	19210495	.	T	C	2	4	6	0	0	6	0	0
3	19264751	.	A	G	11	5	16	0	1	17	0	0
3	19264760	.	T	A	11	5	16	0	2	18	0	0
3	19264787	.	G	T	12	8	20	0	1	21	0	0
3	19264874	.	T	C	10	6	16	0	0	16	0	0
3	19267552	.	C	T	14	15	29	0	0	29	0	0
3	19267564	.	T	C	14	15	29	0	1	30	0	0
3	19267906	.	A	G	10	1	11	0	8	19	0	0
3	19267963	.	A	G	7	6	13	0	0	13	0	0
3	19270732	.	C	T	14	13	27	0	0	27	0	0
3	19271549	.	A	G	15	14	29	0	0	29	0	0
3	19273907	.	A	G	17	13	30	0	1	31	0	0
3	19274532	.	C	G	17	14	31	0	0	31	0	0
3	19274544	.	A	C	15	12	27	0	1	28	0	0
3	19274688	.	T	C	18	7	25	0	0	25	0	0
3	19277027	.	A	G	24	13	37	1	0	38	0	0
3	19277084	.	T	A	22	20	42	1	1	44	0	0
3	19278247	.	T	C	13	18	31	0	3	34	0	0
3	19278796	.	C	T	16	25	41	0	1	42	0	0
3	19281259	.	G	A	0	24	24	0	18	42	0	0
3	19281295	.	A	G	22	18	40	0	2	42	0	0
3	19281310	.	T	A	23	15	38	0	0	38	0	0
3	19336553	.	T	A	5	4	9	0	0	9	0	0
3	19338418	.	A	T	3	4	7	0	0	7	0	0
3	19338599	.	C	T	4	3	7	0	0	7	0	0
3	19346162	.	C	G	5	3	8	0	2	10	0	0
3	19346376	.	C	T	7	4	11	0	0	11	0	0
3	19346394	.	C	T	4	5	9	0	1	10	0	0
3	19354768	.	A	C	6	5	11	0	0	11	0	0
3	19354902	.	T	C	12	8	20	0	0	20	0	0
3	19609716	.	G	A	9	8	17	0	1	18	0	0
3	19609747	.	G	A	8	12	20	0	0	20	0	0
3	19609897	.	A	C	13	7	20	0	0	20	0	0
3	19610495	.	T	A	3	2	5	0	0	5	0	0
3	19610648	.	A	T	11	14	25	0	1	26	0	0
3	19610655	.	G	T	11	15	26	0	0	26	0	0
3	19610865	.	A	C	26	20	46	0	0	46	0	0
3	19610933	.	A	G	4	4	8	1	0	9	0	0
3	19674385	.	C	T	1	4	5	0	0	5	0	0
3	19674525	.	T	A	2	2	4	0	0	4	0	0
3	19678301	.	A	G	5	5	10	0	0	10	0	0
3	19678310	.	C	T	4	4	8	0	1	9	0	0
3	19685977	.	T	G	3	5	8	0	0	8	0	0
3	19686149	.	C	T	4	6	10	0	1	11	0	0
3	19686332	.	G	T	7	4	11	0	2	13	0	0
3	19687393	.	T	C	2	7	9	0	0	9	0	0
3	19702196	.	G	A	9	8	17	0	0	17	0	0
3	19702224	.	T	C	8	8	16	0	1	17	0	0
3	19702551	.	T	C	3	5	8	0	0	8	0	0
3	19706564	.	A	G	10	7	17	0	0	17	0	0
3	19707181	.	G	A	7	4	11	0	1	12	0	0
3	19710389	.	T	C	13	9	22	0	0	22	0	0
3	19716761	.	C	T	4	7	11	0	3	14	0	0
3	19717171	.	T	A	8	4	12	0	0	12	0	0
3	19717459	.	C	T	12	18	30	0	0	30	0	0
3	19717541	.	G	C	12	1	13	0	1	37	23	0
3	19717589	.	T	G	10	3	13	0	18	31	0	0
3	19717656	.	T	C	14	12	26	0	0	26	0	0
3	19717669	.	G	A	14	10	24	0	0	24	0	0
3	19851120	.	G	C	6	4	10	0	0	10	0	0
3	19851289	.	G	T	16	11	27	0	1	28	0	0
3	19851325	.	T	C	17	11	28	0	2	30	0	0
3	19914453	.	A	G	14	9	23	0	0	23	0	0
3	19914619	.	C	T	18	14	32	0	3	35	0	0
3	19914781	.	G	A	1	10	11	0	12	23	0	0
3	19969409	.	C	T	15	16	31	0	1	32	0	0
3	19969416	.	G	C	17	17	34	0	0	34	0	0
3	19969530	.	G	C	18	21	39	0	0	39	0	0
3	19969560	.	C	T	17	21	38	0	2	40	0	0
3	19969909	.	C	T	25	13	38	0	2	40	0	0
3	19970397	.	C	A	21	19	40	0	2	42	0	0
3	19970589	.	G	A	5	18	23	0	20	43	0	0
3	19971063	.	T	G	30	25	55	0	3	58	0	0
3	19971316	.	A	G	19	24	43	0	2	45	0	0
3	19971719	.	A	C	14	20	34	0	9	43	0	0
3	20015458	.	G	T	10	13	23	0	1	24	0	0
3	20015752	.	T	C	11	8	19	0	1	20	0	0
3	20015785	.	G	C	10	11	21	0	1	22	0	0
3	20021477	.	C	T	7	9	16	0	0	16	0	0
3	20021593	.	C	T	4	6	10	0	0	10	0	0
3	20026042	.	G	T	19	10	29	0	1	30	0	0
3	20026106	.	G	A	14	19	33	0	1	34	0	0
3	20026148	.	G	A	16	12	28	0	0	28	0	0
3	20035849	.	C	T	1	18	19	0	16	35	0	0
3	20036309	.	A	G	17	14	31	0	0	31	0	0
3	20040557	.	C	G	0	22	22	0	8	30	0	0
3	20042325	.	A	T	22	10	32	0	0	32	0	0
3	20042453	.	G	C	21	21	42	0	2	44	0	0
3	20042476	.	C	T	23	23	46	0	1	47	0	0
3	20042679	.	A	G	4	10	14	0	0	14	0	0
3	20042681	.	A	G	4	10	14	0	0	14	0	0
3	20042824	.	A	G	13	27	40	0	1	41	0	0
3	20042965	.	T	C	21	15	36	0	1	37	0	0
3	20043024	.	A	G	13	20	33	0	1	34	0	0
3	20043069	.	C	A	17	15	32	0	1	33	0	0
3	20043121	.	A	T	22	11	33	0	0	33	0	0
3	20043279	.	A	T	13	5	18	0	3	22	1	0
3	20043556	.	C	T	14	10	24	0	2	26	0	0
3	20045679	.	A	G	16	16	32	0	2	34	0	0
3	20049714	.	G	A	12	15	27	0	0	27	0	0
3	20051185	.	G	A	12	13	25	0	2	27	0	0
3	20051290	.	G	A	12	8	20	0	1	21	0	0
3	20062718	.	A	G	8	15	23	0	0	23	0	0
3	20063757	.	A	G	17	12	29	0	1	30	0	0
3	20063901	.	C	T	7	5	12	0	0	12	0	0
3	20063917	.	G	A	5	4	9	0	0	9	0	0
3	20108424	.	A	T	19	29	48	0	1	49	0	0
3	20108636	.	A	T	21	16	37	0	3	40	0	0
3	20108643	.	G	T	20	17	37	0	4	41	0	0
3	20108790	.	T	C	26	17	43	3	1	47	0	0
3	20109247	.	T	C	14	0	14	0	9	23	0	0
3	20109421	.	T	C	19	17	36	0	0	36	0	0
3	20109583	.	A	G	5	11	16	0	0	16	0	0
3	20109861	.	G	A	20	20	40	0	5	45	0	0
3	20109951	.	C	A	15	22	37	0	2	39	0	0
3	20110268	.	T	C	29	9	38	0	1	39	0	0
3	20110346	.	A	G	16	15	31	0	3	34	0	0
3	20110359	.	T	A	14	12	26	0	2	28	0	0
3	20110444	.	C	A	16	19	35	0	2	37	0	0
3	20110557	.	A	G	24	26	50	0	1	51	0	0
3	20118281	.	C	G	14	21	35	0	3	38	0	0
3	20224065	.	A	G	5	2	7	0	0	7	0	0
3	20224161	.	A	T	1	2	3	0	0	3	0	0
3	20224612	.	G	A	0	2	2	0	1	3	0	0
3	20224700	.	A	C	3	3	6	1	1	8	0	0
3	20224902	.	T	C	1	2	3	0	0	3	0	0
3	20226092	.	A	G	2	0	2	0	2	4	0	0
3	20226236	.	G	A	4	4	8	0	0	8	0	0
3	20226274	.	T	C	4	5	9	0	0	9	0	0
3	20226300	.	T	G	5	3	8	0	0	8	0	0
3	20226515	.	T	C	4	2	6	0	0	6	0	0
3	20226889	.	G	T	2	2	4	0	1	5	0	0
3	20226924	.	T	C	3	3	6	0	0	6	0	0
3	20226937	.	A	C	2	6	8	0	0	8	0	0
3	20226993	.	C	T	2	3	5	0	0	5	0	0
3	20226997	.	T	C	2	2	4	0	1	5	0	0
3	20227420	.	A	T	5	2	7	0	0	7	0	0
3	20227443	.	A	G	5	2	7	0	0	7	0	0
3	20227781	.	T	A	2	2	4	0	0	4	0	0
3	20227805	.	T	C	2	5	7	0	0	7	0	0
3	20228052	.	C	T	3	3	6	0	0	6	0	0
3	20228303	.	C	T	9	5	14	0	0	14	0	0
3	20228335	.	T	C	6	3	9	0	0	9	0	0
3	20229033	.	C	G	4	0	4	0	4	8	0	0
3	20229235	.	A	G	7	11	18	0	0	18	0	0
3	20229260	.	G	A	8	11	19	0	1	20	0	0
3	20230598	.	T	C	6	5	11	0	1	12	0	0
3	20230615	.	A	G	4	0	4	2	4	10	0	0
3	20231025	.	T	G	8	6	14	0	0	14	0	0
3	20231060	.	C	T	10	8	18	0	0	18	0	0
3	20231080	.	G	A	2	6	8	0	7	15	0	0
3	20231288	.	G	A	6	5	11	0	1	12	0	0
3	20231289	.	C	T	6	6	12	0	0	12	0	0
3	20231385	.	C	T	13	9	22	0	0	22	0	0
3	20231483	.	T	A	8	4	12	0	1	13	0	0
3	20231510	.	G	A	7	3	10	0	0	10	0	0
3	20231539	.	C	G	6	3	9	0	0	9	0	0
3	20658235	.	C	T	7	10	17	0	1	18	0	0
3	20658333	.	G	T	20	13	33	0	3	36	0	0
3	20658653	.	C	G	14	7	21	0	1	22	0	0
3	20658809	.	C	T	12	13	25	0	2	27	0	0
3	20658899	.	T	A	9	9	18	0	1	19	0	0
3	20659051	.	T	G	18	16	34	0	2	36	0	0
3	20666937	.	A	G	10	10	20	0	1	21	0	0
3	20666970	.	A	T	14	5	19	0	0	19	0	0
3	20677240	.	A	G	11	8	19	0	0	19	0	0
3	20677261	.	C	A	12	8	20	0	1	21	0	0
3	20720843	.	G	A	3	6	9	0	0	9	0	0
3	20721042	.	C	A	10	5	15	0	0	15	0	0
3	20721049	.	T	A	6	4	10	0	0	10	0	0
3	20752904	.	A	T	9	5	14	0	0	14	0	0
3	20752928	.	A	T	8	6	14	0	1	15	0	0
3	20948584	.	G	C	1	0	1	0	3	4	0	0
3	20950366	.	C	T	18	9	27	0	1	28	0	0
3	20950529	.	T	C	36	22	58	2	3	63	0	0
3	20956926	.	C	A	30	25	55	0	1	56	0	0
3	20956957	.	G	A	14	20	34	0	2	36	0	0
3	20973017	.	C	T	6	5	11	0	0	11	0	0
3	20982056	.	G	A	2	4	6	0	0	6	0	0
3	20982061	.	T	C	5	2	7	0	0	7	0	0
3	20982340	.	G	T	3	2	5	0	0	5	0	0
3	20982439	.	T	A	3	3	6	0	0	6	0	0
3	20982448	.	G	A	1	2	3	0	0	3	0	0
3	21022558	.	C	A	5	10	15	0	0	15	0	0
3	21022993	.	A	G	3	7	10	0	1	11	0	0
3	21022996	.	T	C	3	7	10	0	1	11	0	0
3	21025709	.	A	T	27	26	53	0	4	57	0	0
3	21025986	.	A	T	17	23	40	0	1	41	0	0
3	21026079	.	A	G	16	25	41	0	1	42	0	0
3	21026293	.	A	G	22	21	43	0	1	44	0	0
3	21026370	.	T	C	14	22	36	0	0	36	0	0
3	21026573	.	G	A	6	3	9	0	1	10	0	0
3	21026576	.	C	T	7	3	10	0	0	10	0	0
3	21026894	.	A	T	3	4	7	0	0	7	0	0
3	21027101	.	A	T	15	12	27	0	0	27	0	0
3	21027504	.	C	T	11	13	24	0	0	24	0	0
3	21027715	.	C	T	18	16	34	2	0	36	0	0
3	21027749	.	A	T	32	14	46	2	1	49	0	0
3	21029813	.	C	A	26	20	46	0	0	47	1	0
3	21029902	.	T	G	20	22	42	0	1	43	0	0
3	21030101	.	G	A	33	11	44	0	2	46	0	0
3	21030293	.	C	T	33	20	53	0	2	55	0	0
3	21030318	.	A	C	23	34	57	0	1	58	0	0
3	21030730	.	T	C	20	8	28	0	4	32	0	0
3	21037760	.	C	T	4	4	8	0	0	8	0	0
3	21037828	.	T	G	1	3	4	0	0	4	0	0
3	21044189	.	G	A	10	21	31	0	3	34	0	0
3	21062703	.	T	C	2	0	2	0	8	10	0	0
3	21062721	.	T	A	1	3	4	0	0	4	0	0
3	21066745	.	A	T	4	9	13	0	1	14	0	0
3	21067384	.	A	G	10	6	16	1	6	23	0	0
3	21067565	.	A	G	10	3	13	0	0	13	0	0
3	21067606	.	A	T	8	4	12	0	0	12	0	0
3	21067718	.	T	A	8	8	16	0	1	17	0	0
3	21067911	.	G	T	10	10	20	0	0	20	0	0
3	21068176	.	G	A	11	8	19	0	0	19	0	0
3	21068205	.	G	T	11	5	16	5	0	21	0	0
3	21068378	.	T	G	7	11	18	0	0	18	0	0
3	21074598	.	G	A	13	6	19	0	0	19	0	0
3	21074667	.	G	A	6	5	11	0	0	11	0	0
3	21086092	.	G	A	5	8	13	0	0	13	0	0
3	21087710	.	C	A	1	6	7	0	0	7	0	0
3	21087743	.	G	T	2	7	9	0	0	9	0	0
3	21094398	.	C	A	3	2	5	5	2	12	0	0
3	21094462	.	G	A	6	3	9	0	0	9	0	0
3	21096176	.	C	T	9	6	15	0	0	15	0	0
3	21096487	.	G	A	18	15	33	0	0	33	0	0
3	21096693	.	T	A	15	14	29	0	0	29	0	0
3	21104470	.	A	G	12	14	26	0	1	27	0	0
3	21111671	.	C	T	1	13	14	0	12	26	0	0
3	21111680	.	T	C	12	12	24	0	4	28	0	0
3	21111916	.	G	C	16	11	27	0	1	28	0	0
3	21111940	.	A	G	12	11	23	0	1	24	0	0
3	21113913	.	C	A	20	22	42	0	1	43	0	0
3	21125687	.	G	T	15	25	40	0	0	40	0	0
3	21126015	.	C	T	28	26	54	0	4	58	0	0
3	21139754	.	T	C	12	12	24	1	1	26	0	0
3	21141184	.	C	T	11	9	20	0	0	20	0	0
3	21142429	.	A	T	9	7	16	0	0	16	0	0
3	21240878	.	A	T	5	5	10	0	1	11	0	0
3	21240971	.	C	G	3	3	6	0	0	6	0	0
3	21241269	.	A	G	4	4	8	0	0	8	0	0
3	21241413	.	C	A	1	7	8	0	1	9	0	0
3	21241416	.	A	G	1	7	8	0	0	8	0	0
3	21241461	.	G	A	1	5	6	0	0	6	0	0
3	21242399	.	A	T	2	6	8	0	0	8	0	0
3	21242438	.	C	G	1	2	3	0	1	4	0	0
3	21251642	.	A	T	11	9	20	0	1	21	0	0
3	21251873	.	A	G	10	7	17	0	0	17	0	0
3	21251924	.	G	A	8	8	16	0	1	17	0	0
3	21252172	.	C	G	20	24	44	0	0	44	0	0
3	21281117	.	A	G	4	2	6	0	0	6	0	0
3	21281483	.	G	C	5	7	12	0	2	14	0	0
3	21281677	.	C	T	3	9	12	0	18	30	0	0
3	21281926	.	A	C	2	2	4	0	0	4	0	0
3	21281927	.	T	A	2	2	4	0	0	4	0	0
3	21282192	.	T	C	8	10	18	0	0	18	0	0
3	21282299	.	T	A	12	6	18	0	0	18	0	0
3	21282340	.	A	G	13	10	23	0	0	23	0	0
3	21282546	.	G	A	6	11	17	0	0	17	0	0
3	21283365	.	T	C	10	0	10	0	11	21	0	0
3	21283509	.	C	A	12	9	21	0	0	21	0	0
3	21283741	.	T	C	9	12	21	0	1	22	0	0
3	21283759	.	T	C	9	10	19	0	1	20	0	0
3	21283811	.	T	G	3	6	9	0	2	11	0	0
3	21284429	.	A	G	6	10	16	0	0	16	0	0
3	21284430	.	A	G	6	10	16	0	0	16	0	0
3	21284752	.	G	A	8	4	12	0	0	12	0	0
3	21284794	.	G	T	7	5	12	0	0	12	0	0
3	21287697	.	A	G	8	5	13	0	0	13	0	0
3	21287872	.	G	C	5	4	9	0	0	9	0	0
3	21287938	.	A	C	5	0	5	0	5	10	0	0
3	21287981	.	C	T	7	6	13	0	2	15	0	0
3	21288007	.	T	C	9	8	17	0	2	19	0	0
3	21288016	.	C	T	11	7	18	0	0	18	0	0
3	21348283	.	T	G	5	6	11	0	2	13	0	0
3	21883162	.	A	T	3	2	5	0	0	5	0	0
3	21885954	.	C	T	2	2	4	0	0	4	0	0
3	21887512	.	T	A	4	4	8	0	0	8	0	0
3	21887513	.	A	T	4	4	8	0	0	8	0	0
3	21888924	.	T	G	2	3	5	0	0	5	0	0
3	21889028	.	T	A	2	6	8	0	0	8	0	0
3	21889036	.	T	C	2	5	7	0	0	7	0	0
3	21889187	.	A	G	6	2	8	0	0	8	0	0
3	21889268	.	A	G	5	5	10	0	0	10	0	0
3	22039893	.	C	T	2	3	5	0	0	5	0	0
3	22050000	.	C	A	8	6	14	0	1	15	0	0
3	22050026	.	G	A	6	7	13	0	1	14	0	0
3	22050263	.	G	A	6	7	13	0	0	13	0	0
3	22054324	.	G	A	15	9	24	0	1	25	0	0
3	22054356	.	C	T	16	7	23	0	2	25	0	0
3	22054491	.	C	T	9	9	18	2	3	23	0	0
3	22054517	.	A	C	1	0	1	2	14	17	0	0
3	22054724	.	T	C	6	8	14	1	1	16	0	0
3	22054793	.	A	C	5	9	14	0	1	15	0	0
3	22054856	.	G	A	10	4	14	0	0	14	0	0
3	22055128	.	A	G	9	0	9	0	6	15	0	0
3	22055216	.	T	A	5	4	9	0	0	9	0	0
3	22079377	.	C	T	3	5	8	0	0	8	0	0
3	22079815	.	A	T	2	4	6	0	1	7	0	0
3	22080117	.	A	G	6	6	12	0	1	13	0	0
3	22080356	.	T	G	7	6	13	0	0	13	0	0
3	22128490	.	T	C	2	4	6	0	0	6	0	0
3	22128544	.	T	A	5	2	7	0	1	8	0	0
3	22130419	.	G	T	3	3	6	0	0	6	0	0
3	22146900	.	G	C	0	14	14	0	9	23	0	0
3	22146945	.	T	C	7	13	20	0	0	20	0	0
3	22146969	.	C	T	7	12	19	0	2	21	0	0
3	22153178	.	C	T	7	4	11	0	1	12	0	0
3	22153412	.	A	C	8	7	15	0	0	15	0	0
3	22153850	.	A	G	1	5	6	1	1	8	0	0
3	22153896	.	C	T	2	2	4	1	1	6	0	0
3	22153944	.	T	G	5	1	6	0	6	12	0	0
3	22154467	.	A	G	20	5	25	0	2	27	0	0
3	22154554	.	A	G	21	7	28	0	2	30	0	0
3	22154555	.	A	G	23	6	29	0	1	30	0	0
3	22154610	.	A	C	12	12	24	0	0	24	0	0
3	22158373	.	G	T	34	16	50	0	2	52	0	0
3	22158416	.	G	C	28	24	52	0	0	52	0	0
3	22158551	.	T	C	36	27	63	0	1	64	0	0
3	22158768	.	T	G	36	20	56	0	1	57	0	0
3	22158904	.	A	T	39	25	64	0	1	65	0	0
3	22159569	.	A	G	38	11	49	2	0	51	0	0
3	22159584	.	C	A	4	8	12	2	31	45	0	0
3	22159697	.	A	G	10	32	42	3	3	48	0	0
3	22159797	.	G	A	4	8	12	0	0	12	0	0
3	22159886	.	C	T	3	1	4	0	1	5	0	0
3	22159892	.	G	T	2	2	4	0	1	5	0	0
3	22160042	.	T	G	14	20	34	1	1	36	0	0
3	22160131	.	C	G	8	16	24	0	1	25	0	0
3	22160421	.	C	T	22	10	32	0	2	34	0	0
3	22160436	.	A	C	21	16	37	0	0	37	0	0
3	22160706	.	T	A	18	9	27	0	0	27	0	0
3	22160767	.	G	T	25	8	33	0	1	36	2	0
3	22160779	.	C	T	24	13	37	0	1	38	0	0
3	22160888	.	A	T	15	10	25	0	1	26	0	0
3	22160947	.	C	A	7	9	16	0	1	19	2	0
3	22161153	.	A	G	18	17	35	0	0	35	0	0
3	22161176	.	G	T	14	13	27	0	2	29	0	0
3	22161317	.	C	T	1	7	8	0	11	19	0	0
3	22161366	.	G	A	9	12	21	0	3	24	0	0
3	22161389	.	T	A	12	9	21	0	1	22	0	0
3	22161588	.	C	T	8	8	16	0	3	19	0	0
3	22168615	.	C	T	16	15	31	0	0	31	0	0
3	22172765	.	A	G	20	23	43	0	1	44	0	0
3	22172837	.	G	A	21	17	38	0	2	40	0	0
3	22176777	.	C	T	2	2	4	0	0	4	0	0
3	22179835	.	A	C	3	3	6	0	0	6	0	0
3	22179857	.	T	A	3	3	6	0	1	7	0	0
3	22179899	.	A	C	2	3	5	0	0	5	0	0
3	22180013	.	G	A	1	2	3	0	0	3	0	0
3	22180315	.	T	C	4	3	7	0	0	7	0	0
3	22180666	.	T	C	3	2	5	0	0	5	0	0
3	22191042	.	T	C	20	14	34	0	3	37	0	0
3	22191044	.	C	A	21	17	38	0	0	38	0	0
3	22213993	.	T	A	18	10	28	0	1	29	0	0
3	22216212	.	T	C	8	0	8	0	5	13	0	0
3	22216265	.	G	A	2	3	5	0	0	5	0	0
3	22216358	.	G	A	8	10	18	0	0	18	0	0
3	22216413	.	C	G	3	5	8	0	0	8	0	0
3	22534250	.	T	C	4	2	6	0	0	6	0	0
3	22547182	.	A	G	9	5	14	0	1	15	0	0
3	22548052	.	G	A	6	3	9	0	0	9	0	0
3	22548094	.	A	G	7	6	13	0	2	15	0	0
3	22548095	.	G	T	7	7	14	0	1	15	0	0
3	22548177	.	G	T	2	4	6	0	0	6	0	0
3	22548231	.	C	T	1	4	5	0	0	5	0	0
3	22548263	.	T	A	1	2	3	0	0	3	0	0
3	22548388	.	G	A	3	6	9	0	0	9	0	0
3	22548666	.	C	G	9	8	17	0	0	17	0	0
3	22548677	.	C	T	12	8	20	0	0	20	0	0
3	22548903	.	A	C	8	11	19	0	0	19	0	0
3	22548928	.	T	A	7	15	22	0	1	23	0	0
3	22578532	.	T	C	1	2	3	0	0	3	0	0
3	22760872	.	C	A	4	3	7	0	0	7	0	0
3	22783133	.	G	A	1	3	4	0	5	9	0	0
3	22783277	.	A	G	3	3	6	0	0	6	0	0
3	22783298	.	G	A	2	5	7	0	1	8	0	0
3	22784434	.	A	G	1	0	1	0	4	5	0	0
3	22788163	.	T	C	1	4	5	0	0	5	0	0
3	22788430	.	G	T	0	5	5	0	2	7	0	0
3	22788457	.	T	C	2	6	8	0	0	8	0	0
3	22790117	.	A	G	2	2	4	0	0	4	0	0
3	22790318	.	A	G	4	6	10	0	1	11	0	0
3	22792033	.	T	C	8	7	15	0	0	15	0	0
3	22794477	.	A	G	4	8	12	0	0	12	0	0
3	22794705	.	T	C	5	3	8	0	0	8	0	0
3	22811835	.	G	A	2	6	8	0	10	18	0	0
3	22812753	.	A	G	11	1	12	0	16	28	0	0
3	22812759	.	C	A	13	15	28	0	3	31	0	0
3	22813052	.	G	A	1	15	16	0	12	28	0	0
3	22813515	.	T	A	8	12	20	0	3	23	0	0
3	22813563	.	G	T	8	11	19	0	1	20	0	0
3	22813569	.	T	G	9	10	19	0	1	20	0	0
3	22813628	.	C	A	9	17	26	0	0	26	0	0
3	22813629	.	T	A	9	17	26	0	0	26	0	0
3	22813778	.	C	T	8	7	15	0	0	15	0	0
3	22813998	.	T	G	4	5	9	0	1	10	0	0
3	22814109	.	G	A	15	9	24	0	2	26	0	0
3	22814147	.	G	A	3	11	14	0	13	27	0	0
3	22814209	.	T	C	18	14	32	0	3	35	0	0
3	22814230	.	A	G	19	0	19	0	16	35	0	0
3	22814453	.	A	G	11	11	22	0	1	23	0	0
3	22814478	.	A	G	10	8	18	0	0	18	0	0
3	22814546	.	G	A	13	15	28	1	2	31	0	0
3	22815994	.	C	T	2	16	18	0	15	33	0	0
3	22816030	.	A	G	12	10	22	0	0	22	0	0
3	22816166	.	T	C	9	3	12	0	1	13	0	0
3	22816167	.	G	A	9	3	12	0	1	13	0	0
3	22816586	.	G	A	13	4	17	0	1	18	0	0
3	22816616	.	T	A	11	6	17	0	0	17	0	0
3	22816652	.	A	G	8	4	12	0	0	12	0	0
3	22816676	.	T	C	10	5	15	0	0	15	0	0
3	22816783	.	A	C	11	0	11	0	5	16	0	0
3	22816793	.	T	C	17	5	22	0	0	22	0	0
3	22816989	.	C	T	14	3	17	0	0	17	0	0
3	22817004	.	G	T	12	3	15	0	0	15	0	0
3	22817300	.	T	C	11	0	11	0	10	21	0	0
3	22821125	.	A	G	4	2	6	0	0	6	0	0
3	22823823	.	A	C	6	2	8	0	0	8	0	0
3	22828206	.	C	A	5	2	7	0	0	7	0	0
3	22828257	.	A	G	2	2	4	0	0	4	0	0
3	22829679	.	C	T	0	3	3	0	5	8	0	0
3	22829680	.	G	A	5	3	8	0	0	8	0	0
3	22935364	.	G	A	1	6	7	0	1	8	0	0
3	22947802	.	A	G	3	0	3	0	3	6	0	0
3	22947820	.	T	C	1	3	4	0	0	4	0	0
3	22953926	.	T	C	5	3	8	0	1	9	0	0
3	22967007	.	A	G	3	3	6	0	0	6	0	0
3	22967183	.	T	C	2	5	7	0	0	7	0	0
3	22993542	.	G	A	3	4	7	0	0	7	0	0
3	22993614	.	C	T	3	4	7	0	1	8	0	0
3	22994078	.	G	T	3	8	11	0	10	21	0	0
3	22994318	.	A	G	3	0	3	0	5	8	0	0
3	22994344	.	G	T	0	3	3	0	3	6	0	0
3	23248840	.	A	G	12	6	18	0	0	18	0	0
3	23250603	.	C	G	5	4	9	0	0	9	0	0
3	23250652	.	G	A	1	7	8	0	8	16	0	0
3	23251018	.	A	G	8	6	14	0	1	15	0	0
3	23251258	.	A	C	6	8	14	0	0	14	0	0
3	23251299	.	C	G	10	5	15	0	2	17	0	0
3	23251744	.	G	A	0	6	6	0	9	15	0	0
3	23251822	.	A	G	8	5	13	0	2	15	0	0
3	23302371	.	A	G	4	11	15	0	2	17	0	0
3	23307870	.	G	T	2	9	11	1	12	24	0	0
3	23309155	.	C	A	9	8	17	0	2	19	0	0
3	23309214	.	A	G	13	5	18	0	0	18	0	0
3	23318362	.	G	A	13	7	20	0	0	20	0	0
3	23318368	.	C	T	15	6	21	0	0	21	0	0
3	23323560	.	T	A	16	7	23	0	0	23	0	0
3	23323719	.	T	C	5	6	11	0	1	12	0	0
3	23323788	.	G	A	3	3	6	0	0	6	0	0
3	23323829	.	T	C	1	4	5	0	0	5	0	0
3	23324159	.	T	A	8	11	19	0	2	21	0	0
3	23324235	.	G	A	10	9	19	0	2	21	0	0
3	23324420	.	T	C	4	3	7	0	0	7	0	0
3	23324421	.	T	C	4	3	7	0	0	7	0	0
3	23324472	.	T	A	3	1	4	0	0	4	0	0
3	23324481	.	G	T	3	5	8	0	0	8	0	0
3	23324536	.	C	T	9	8	17	0	1	18	0	0
3	23324746	.	T	A	7	12	19	0	1	20	0	0
3	23324815	.	T	A	8	10	18	0	0	18	0	0
3	23324829	.	C	T	9	10	19	0	0	19	0	0
3	23325207	.	A	C	5	6	11	0	0	11	0	0
3	23325476	.	G	A	3	6	9	0	0	9	0	0
3	23326478	.	G	A	6	5	11	0	1	12	0	0
3	23326711	.	G	A	12	8	20	0	0	20	0	0
3	23327282	.	C	T	14	20	34	0	3	37	0	0
3	23334465	.	A	T	6	8	14	0	0	14	0	0
3	23335024	.	G	A	14	14	28	0	0	28	0	0
3	23348300	.	T	G	11	15	26	0	1	27	0	0
3	23348304	.	C	T	12	14	26	0	1	27	0	0
3	23351944	.	G	A	7	7	14	0	0	14	0	0
3	23363193	.	G	A	9	8	17	0	0	17	0	0
3	23406614	.	G	A	6	10	16	0	0	16	0	0
3	23406637	.	G	C	4	0	4	0	8	12	0	0
3	23406701	.	C	T	14	8	22	0	1	23	0	0
3	23407085	.	G	T	7	7	14	0	1	15	0	0
3	23429169	.	A	C	12	17	29	0	0	29	0	0
3	23429262	.	A	T	11	12	23	0	0	23	0	0
3	23429263	.	T	C	9	11	20	0	3	23	0	0
3	23429433	.	A	G	5	4	9	0	0	9	0	0
3	23429696	.	A	G	8	10	18	0	1	19	0	0
3	23429763	.	A	C	9	0	9	0	17	26	0	0
3	23430011	.	G	A	13	7	20	0	2	22	0	0
3	23430067	.	A	G	19	9	28	0	0	28	0	0
3	23430116	.	T	A	17	6	23	0	0	23	0	0
3	23430119	.	C	T	3	6	9	0	16	25	0	0
3	23436305	.	T	A	23	13	36	0	1	37	0	0
3	23444539	.	A	T	8	9	17	0	2	20	1	0
3	23444551	.	T	G	10	7	17	0	1	18	0	0
3	23456344	.	T	C	5	0	5	0	6	11	0	0
3	23464865	.	T	C	2	2	4	0	0	4	0	0
3	23464894	.	G	A	4	4	8	0	0	8	0	0
3	23464911	.	C	T	5	3	8	0	0	8	0	0
3	23465292	.	T	C	4	12	16	0	1	17	0	0
3	23466160	.	A	G	12	9	21	0	0	21	0	0
3	23469391	.	C	T	7	9	16	0	2	18	0	0
3	23469438	.	A	G	7	6	13	0	0	13	0	0
3	23469848	.	T	A	5	3	8	0	0	8	0	0
3	23470037	.	A	C	5	0	5	0	9	14	0	0
3	23470044	.	T	A	3	8	11	0	2	13	0	0
3	23470172	.	G	A	2	2	4	0	2	6	0	0
3	23470173	.	T	A	3	2	5	0	1	6	0	0
3	23488794	.	T	A	5	6	11	0	0	11	0	0
3	23493694	.	T	C	18	9	27	0	1	28	0	0
3	23495767	.	T	C	9	20	29	0	0	29	0	0
3	23495872	.	T	C	11	10	21	0	1	22	0	0
3	23495905	.	G	T	4	7	11	0	2	13	0	0
3	23495908	.	A	G	3	8	11	0	1	12	0	0
3	23584128	.	G	A	6	10	16	0	0	16	0	0
3	23584577	.	A	C	9	11	20	0	2	22	0	0
3	23584703	.	A	T	12	10	22	0	3	25	0	0
3	23584704	.	T	A	11	12	23	0	2	25	0	0
3	23584748	.	C	A	11	7	18	0	0	18	0	0
3	23591620	.	T	C	14	0	14	0	8	22	0	0
3	23591662	.	G	C	10	0	10	0	11	21	0	0
3	23599844	.	A	C	28	29	57	1	1	59	0	0
3	23705327	.	T	G	4	1	5	0	3	8	0	0
3	23723572	.	T	A	3	1	4	0	0	4	0	0
3	23723582	.	C	G	3	2	5	0	0	5	0	0
3	23723715	.	C	A	3	2	5	0	0	5	0	0
3	23748628	.	T	A	7	5	12	0	0	12	0	0
3	24071108	.	T	C	13	8	21	0	0	21	0	0
3	24100770	.	C	T	12	10	22	0	0	22	0	0
3	24109865	.	T	A	4	2	6	0	0	6	0	0
3	24110403	.	G	T	2	3	5	0	0	5	0	0
3	24111146	.	T	C	4	6	10	0	0	10	0	0
3	24134600	.	C	T	2	4	6	0	0	6	0	0
3	24134607	.	T	G	2	0	2	0	4	6	0	0
3	24142965	.	C	T	10	7	17	0	0	17	0	0
3	24143418	.	C	T	6	2	8	0	0	8	0	0
3	24143559	.	G	A	6	5	11	0	1	12	0	0
3	24144037	.	A	G	8	5	13	0	0	13	0	0
3	24196092	.	C	T	5	4	9	0	0	9	0	0
3	24196204	.	T	C	1	6	7	0	0	7	0	0
3	24196365	.	T	G	6	8	14	0	0	14	0	0
3	24196576	.	T	G	3	4	7	0	0	7	0	0
3	24198970	.	G	A	16	22	38	0	2	40	0	0
3	24200563	.	T	A	9	9	18	0	2	20	0	0
3	24203310	.	A	G	8	8	16	0	0	16	0	0
3	24203504	.	A	G	9	9	18	0	0	18	0	0
3	24203588	.	T	C	10	8	18	0	0	18	0	0
3	24203654	.	G	A	3	6	9	0	0	9	0	0
3	24203676	.	G	T	5	4	9	0	0	9	0	0
3	24203767	.	A	G	5	3	8	0	0	8	0	0
3	24207390	.	G	A	7	3	10	0	1	11	0	0
3	24209715	.	T	A	6	8	14	0	0	14	0	0
3	24209852	.	T	C	4	8	12	0	0	12	0	0
3	24214534	.	G	T	5	6	11	0	0	11	0	0
3	24216029	.	A	G	10	4	14	0	0	14	0	0
3	24216161	.	T	C	8	11	19	0	1	20	0	0
3	24218282	.	C	T	6	6	12	0	0	12	0	0
3	24289699	.	T	A	2	2	4	0	0	4	0	0
3	24289703	.	C	G	2	1	3	0	0	3	0	0
3	24292535	.	C	T	2	5	7	0	0	7	0	0
3	24295067	.	C	A	2	2	4	0	0	4	0	0
3	24295149	.	A	G	1	4	5	0	0	5	0	0
3	24295198	.	C	T	5	6	11	0	0	11	0	0
3	24295292	.	T	C	1	2	3	0	0	3	0	0
3	24361257	.	T	C	30	26	56	0	3	59	0	0
3	24434494	.	T	A	40	28	68	0	10	78	0	0
3	24434512	.	C	G	40	29	69	0	5	74	0	0
3	24434601	.	C	T	42	29	71	2	3	76	0	0
3	24483164	.	A	T	15	14	29	0	2	31	0	0
3	24483259	.	G	A	1	15	16	0	14	30	0	0
3	24487821	.	A	G	16	16	32	0	1	33	0	0
3	24487905	.	A	G	9	12	21	0	4	25	0	0
3	24489662	.	T	C	16	14	30	0	1	31	0	0
3	24489838	.	A	G	10	20	30	0	2	32	0	0
3	24501686	.	G	C	21	20	41	0	1	42	0	0
3	24501757	.	G	A	5	14	19	0	21	40	0	0
3	24501772	.	G	A	24	19	43	0	1	44	0	0
3	24516948	.	G	A	1	2	3	0	0	3	0	0
3	24518063	.	A	G	2	3	5	0	0	5	0	0
3	24567494	.	G	T	0	2	2	0	1	3	0	0
3	24690027	.	A	G	1	3	4	0	0	4	0	0
3	24690346	.	A	G	1	2	3	0	0	3	0	0
3	24691573	.	A	G	1	2	3	0	0	3	0	0
3	24691593	.	T	A	1	2	3	0	0	3	0	0
3	24691714	.	A	T	4	2	6	0	0	6	0	0
3	24692005	.	G	T	0	6	6	0	2	8	0	0
3	24692014	.	T	C	3	5	8	0	0	8	0	0
3	24692117	.	T	C	2	6	8	0	0	8	0	0
3	24763903	.	A	C	2	2	4	0	0	4	0	0
3	24764868	.	T	G	3	2	5	0	0	5	0	0
3	24765063	.	G	T	1	4	5	0	0	5	0	0
3	24765117	.	C	G	2	5	7	0	1	8	0	0
3	24904262	.	C	A	1	3	4	0	0	4	0	0
3	24904277	.	A	G	1	1	2	0	1	3	0	0
3	24973667	.	T	A	15	13	28	0	3	31	0	0
3	24973867	.	T	A	14	13	27	0	1	28	0	0
3	24973912	.	T	C	9	0	9	0	14	23	0	0
3	24974298	.	G	A	21	19	40	0	2	42	0	0
3	24990641	.	G	A	3	22	25	0	23	48	0	0
3	24990746	.	A	C	21	21	42	0	1	43	0	0
3	24993657	.	G	C	19	22	41	0	0	41	0	0
3	24993682	.	A	G	17	24	41	0	2	43	0	0
3	24994253	.	T	C	27	21	48	0	0	48	0	0
3	24997055	.	A	T	11	9	20	0	3	23	0	0
3	24997955	.	A	T	8	9	17	0	0	17	0	0
3	24998204	.	C	G	7	11	18	0	0	18	0	0
3	24998533	.	A	G	17	16	33	0	2	35	0	0
3	24998536	.	A	G	17	18	35	0	1	36	0	0
3	24998797	.	C	T	13	8	21	0	0	21	0	0
3	24998833	.	C	T	9	9	18	0	0	18	0	0
3	24998860	.	C	T	8	14	22	0	2	24	0	0
3	24999601	.	C	T	0	5	5	0	8	13	0	0
3	24999636	.	A	C	10	9	19	0	0	19	0	0
3	24999916	.	A	G	12	13	25	0	0	25	0	0
3	24999955	.	T	G	10	8	18	0	0	18	0	0
3	24999967	.	A	G	9	9	18	0	1	19	0	0
3	25000051	.	G	T	7	8	15	0	1	16	0	0
3	25000114	.	G	A	3	12	15	0	0	15	0	0
3	25000417	.	C	A	1	6	7	0	8	15	0	0
3	25002169	.	A	G	3	6	9	0	0	9	0	0
3	25005814	.	A	C	4	3	7	0	0	7	0	0
3	25007702	.	C	A	2	2	4	0	0	4	0	0
3	25027734	.	G	A	2	2	4	0	0	4	0	0
3	25039390	.	T	C	1	2	3	0	0	3	0	0
3	25039408	.	C	G	2	2	4	0	0	4	0	0
3	25040779	.	G	A	3	2	5	0	0	5	0	0
3	25040812	.	G	A	3	2	5	0	0	5	0	0
3	25054458	.	G	A	2	2	4	0	0	4	0	0
3	25059771	.	A	G	3	3	6	0	1	7	0	0
3	25060009	.	C	T	4	5	9	0	1	10	0	0
3	25066348	.	A	G	3	8	11	0	0	11	0	0
3	25072445	.	G	C	5	0	5	0	5	10	0	0
3	25081126	.	T	G	3	4	7	0	0	7	0	0
3	25081203	.	C	T	4	3	7	0	0	7	0	0
3	25086740	.	T	A	4	2	6	0	0	6	0	0
3	25094590	.	G	A	11	10	21	0	3	24	0	0
3	25094623	.	G	A	1	15	16	0	13	29	0	0
3	25097047	.	C	A	22	23	45	0	2	47	0	0
3	25097218	.	T	A	22	12	34	0	3	37	0	0
3	25097257	.	T	C	25	19	44	0	3	47	0	0
3	25099018	.	A	G	24	23	47	0	3	50	0	0
3	25099883	.	T	C	28	15	43	0	0	43	0	0
3	25099988	.	T	A	17	22	39	0	2	41	0	0
3	25100004	.	A	G	19	23	42	0	0	42	0	0
3	25100182	.	A	T	23	19	42	0	1	43	0	0
3	25100222	.	G	A	1	31	32	0	23	55	0	0
3	25100311	.	C	G	24	21	45	0	0	46	1	0
3	25100379	.	A	T	37	12	49	0	3	52	0	0
3	25100565	.	T	G	4	0	4	0	8	12	0	0
3	25102030	.	A	T	15	21	36	1	4	41	0	0
3	25102095	.	A	G	25	15	40	0	3	43	0	0
3	25105097	.	A	C	27	1	28	0	17	45	0	0
3	25107705	.	T	C	19	22	41	0	2	43	0	0
3	25107729	.	A	T	16	16	32	0	1	33	0	0
3	25136479	.	C	T	1	11	12	0	6	18	0	0
3	25136571	.	G	A	3	5	8	0	0	8	0	0
3	25136655	.	T	A	8	5	13	0	1	14	0	0
3	25136706	.	C	G	5	3	8	0	1	9	0	0
3	25136819	.	T	G	9	5	14	0	0	14	0	0
3	25136855	.	G	T	7	8	15	0	2	17	0	0
3	25136868	.	A	G	7	9	16	0	0	16	0	0
3	25137144	.	G	T	2	3	5	0	3	8	0	0
3	25137585	.	T	C	1	2	3	0	0	3	0	0
3	25138264	.	G	T	8	9	17	0	1	18	0	0
3	25138306	.	C	T	10	11	21	0	0	21	0	0
3	25138543	.	C	T	2	8	10	0	5	15	0	0
3	25144211	.	A	G	3	4	7	0	0	7	0	0
3	25147989	.	G	A	4	6	10	0	0	10	0	0
3	25147990	.	C	G	0	7	7	0	3	10	0	0
3	25166884	.	A	G	1	0	1	0	2	3	0	0
3	25167162	.	A	G	8	8	16	0	0	16	0	0
3	25167238	.	C	A	4	7	11	0	0	11	0	0
3	25167332	.	A	C	3	6	9	0	1	10	0	0
3	25167351	.	A	C	3	7	10	0	0	10	0	0
3	25168907	.	A	T	8	9	17	0	1	18	0	0
3	25168994	.	C	T	9	10	19	0	0	19	0	0
3	25169181	.	C	T	3	2	5	0	0	5	0	0
3	25269936	.	A	C	6	15	21	0	0	21	0	0
3	25269960	.	A	G	9	22	31	0	2	33	0	0
3	25270023	.	A	G	11	19	30	1	0	31	0	0
3	25270048	.	G	T	16	20	36	1	0	37	0	0
3	25270058	.	A	C	16	18	34	1	1	36	0	0
3	25270311	.	A	G	41	19	60	1	12	73	0	0
3	25270320	.	A	G	41	18	59	1	16	76	0	0
3	25270602	.	C	G	34	39	73	0	5	78	0	0
3	25270680	.	C	T	42	32	74	0	5	79	0	0
3	25270710	.	A	C	34	41	75	1	4	80	0	0
3	25270752	.	A	G	35	41	76	1	8	85	0	0
3	25271209	.	T	A	20	40	60	0	5	65	0	0
3	25271579	.	C	T	26	23	49	0	0	49	0	0
3	25271653	.	T	C	28	22	50	0	1	51	0	0
3	25272051	.	T	A	37	25	62	0	4	66	0	0
3	25272623	.	C	T	29	32	61	0	4	65	0	0
3	25272859	.	T	A	29	31	60	0	1	61	0	0
3	25273463	.	G	A	23	29	52	0	4	56	0	0
3	25273524	.	G	C	28	30	58	0	1	59	0	0
3	25273648	.	A	G	28	25	53	0	4	57	0	0
3	25282029	.	C	T	1	4	5	0	0	5	0	0
3	25286050	.	G	A	12	8	20	0	0	20	0	0
3	25333049	.	A	G	3	4	7	0	0	7	0	0
3	25379119	.	T	C	4	3	7	0	1	8	0	0
3	25379483	.	C	A	2	13	15	0	15	30	0	0
3	25379546	.	A	G	20	22	42	0	2	44	0	0
3	25381494	.	G	A	20	12	32	0	2	34	0	0
3	25393308	.	A	G	10	14	24	0	1	25	0	0
3	25396677	.	G	T	14	13	27	0	7	34	0	0
3	25400673	.	C	T	2	9	11	0	11	22	0	0
3	25403654	.	G	A	6	4	10	0	0	10	0	0
3	25403685	.	G	A	5	4	9	0	0	9	0	0
3	25403812	.	G	C	3	4	7	0	0	7	0	0
3	25404038	.	G	A	5	3	8	0	0	8	0	0
3	25404045	.	A	G	5	3	8	0	0	8	0	0
3	25404444	.	G	T	4	8	12	0	0	12	0	0
3	25404591	.	G	A	5	5	10	0	0	10	0	0
3	25404618	.	T	C	4	2	6	0	0	6	0	0
3	25405540	.	T	C	8	4	12	0	2	14	0	0
3	25409641	.	C	T	0	5	5	0	3	8	0	0
3	25409655	.	C	T	3	5	8	0	0	8	0	0
3	25417006	.	G	A	3	2	5	0	0	5	0	0
3	25417279	.	G	A	1	3	4	0	0	4	0	0
3	25420845	.	T	C	3	1	4	0	2	6	0	0
3	25436830	.	T	C	5	6	11	0	2	13	0	0
3	25436893	.	T	G	4	8	12	0	2	14	0	0
3	25437284	.	G	T	21	14	35	0	1	36	0	0
3	25491134	.	A	G	8	10	18	0	0	18	0	0
3	26032430	.	A	G	3	2	5	3	1	9	0	0
3	26351448	.	A	G	7	21	28	0	1	29	0	0
3	26905062	.	G	T	2	3	5	0	0	5	0	0
3	27695326	.	A	G	4	0	4	0	2	6	0	0
3	27695434	.	A	G	4	0	4	0	3	7	0	0
3	27695450	.	A	G	1	0	1	0	5	6	0	0
3	27767252	.	A	G	14	4	18	0	0	18	0	0
3	27767284	.	A	G	4	13	17	0	0	17	0	0
3	27767288	.	A	G	10	7	17	0	0	17	0	0
3	27831725	.	A	G	2	0	2	0	5	7	0	0
3	27833015	.	T	C	22	6	28	0	0	28	0	0
3	27833018	.	T	C	22	6	28	0	2	30	0	0
3	27834131	.	T	C	16	8	24	0	1	25	0	0
3	27834412	.	T	C	20	20	40	0	0	40	0	0
3	27834552	.	T	C	11	11	22	0	0	22	0	0
3	27834563	.	T	C	15	7	22	0	4	26	0	0
3	27836036	.	T	C	9	10	19	0	0	19	0	0
3	28068221	.	T	G	6	5	11	0	40	51	0	0
3	28627044	.	T	A	6	3	9	0	0	9	0	0
3	28634485	.	T	A	11	8	19	0	1	20	0	0
3	28634549	.	A	G	19	10	29	0	1	30	0	0
3	28634883	.	C	A	19	13	32	0	5	37	0	0
3	28634884	.	A	C	17	14	31	0	5	36	0	0
3	28635106	.	G	A	18	6	24	0	0	24	0	0
3	28640608	.	C	T	1	12	13	0	10	23	0	0
3	28640734	.	G	A	11	8	19	0	0	19	0	0
3	28650721	.	T	C	6	0	6	0	10	16	0	0
3	28665218	.	T	C	13	11	24	0	1	25	0	0
3	28665239	.	G	A	11	8	19	0	0	19	0	0
3	28719103	.	G	A	5	3	8	0	0	8	0	0
3	28719506	.	C	G	12	5	17	0	1	18	0	0
3	28719592	.	T	G	10	8	18	0	3	21	0	0
3	28719636	.	T	A	9	7	16	0	1	17	0	0
3	28719649	.	C	T	8	9	17	0	1	18	0	0
3	28719730	.	G	T	11	5	16	0	0	16	0	0
3	28719852	.	T	C	14	8	22	0	0	22	0	0
3	28719878	.	G	A	13	7	20	0	3	23	0	0
3	28719905	.	C	A	1	8	9	0	11	20	0	0
3	28719971	.	C	A	0	3	3	0	10	13	0	0
3	28720010	.	G	A	6	9	15	0	0	15	0	0
3	28750223	.	G	T	3	4	7	0	0	7	0	0
3	28750376	.	A	C	5	2	7	0	1	8	0	0
3	28750377	.	G	C	4	2	6	0	1	7	0	0
3	29950927	.	T	C	15	6	21	0	2	23	0	0
3	29951384	.	T	C	17	6	23	0	1	24	0	0
3	30749508	.	T	C	2	0	2	0	4	6	0	0
3	30749541	.	G	A	4	2	6	0	0	6	0	0
3	30801282	.	G	A	5	5	10	0	0	10	0	0
3	30801297	.	G	T	3	7	10	0	0	10	0	0
3	30801370	.	T	C	3	0	3	0	4	7	0	0
3	30868853	.	T	G	8	7	15	0	1	16	0	0
3	30868855	.	T	C	7	7	14	0	2	16	0	0
3	30869205	.	A	G	14	13	27	0	0	27	0	0
3	30869206	.	C	T	13	8	21	0	6	27	0	0
3	30869662	.	C	T	6	7	13	0	2	15	0	0
3	30869728	.	C	T	1	6	7	0	5	12	0	0
3	30869938	.	A	G	4	3	7	0	0	7	0	0
3	30870382	.	T	G	2	6	8	0	1	9	0	0
3	30870409	.	G	A	3	5	8	0	0	8	0	0
3	30870508	.	G	A	3	5	8	0	0	8	0	0
3	30870838	.	T	A	3	5	8	0	0	8	0	0
3	30870974	.	A	C	1	4	5	0	0	5	0	0
3	30871021	.	G	T	5	3	8	0	0	8	0	0
3	30871478	.	A	T	3	2	5	0	0	5	0	0
3	30871873	.	C	G	1	2	3	0	3	6	0	0
3	30872004	.	C	T	3	4	7	0	0	7	0	0
3	30872264	.	T	G	8	3	11	0	1	12	0	0
3	30872608	.	C	T	1	5	6	0	1	7	0	0
3	30873029	.	G	A	5	3	8	0	1	9	0	0
3	30873048	.	G	A	4	4	8	0	0	8	0	0
3	30873165	.	C	T	1	6	7	0	0	7	0	0
3	30873185	.	A	T	1	7	8	0	0	8	0	0
3	30888823	.	T	C	38	7	45	0	3	48	0	0
3	30888824	.	T	C	41	6	47	0	2	49	0	0
3	30890630	.	T	A	12	11	23	1	1	25	0	0
3	30890869	.	G	A	17	26	43	0	2	45	0	0
3	30891201	.	A	G	30	18	48	0	1	49	0	0
3	30894281	.	A	G	15	15	30	0	2	32	0	0
3	30926689	.	A	G	1	4	5	0	0	5	0	0
3	30926817	.	T	C	1	0	1	0	4	5	0	0
3	30948173	.	G	A	3	5	8	0	0	8	0	0
3	30948206	.	C	A	3	4	7	0	0	7	0	0
3	30962456	.	C	G	7	3	10	0	0	10	0	0
3	31039992	.	A	G	1	2	3	0	0	3	0	0
3	31043733	.	A	C	3	2	5	0	0	5	0	0
3	31043876	.	A	C	1	0	1	0	2	3	0	0
3	31044205	.	A	G	1	2	3	0	0	3	0	0
3	31044579	.	A	G	3	5	8	0	1	9	0	0
3	31044649	.	T	C	3	4	7	0	0	7	0	0
3	31044782	.	A	C	4	0	4	0	4	8	0	0
3	31044850	.	T	C	1	6	7	0	0	7	0	0
3	31044986	.	G	T	2	3	5	0	1	6	0	0
3	31045098	.	G	A	2	2	4	0	0	4	0	0
3	31050126	.	T	A	3	4	7	0	2	9	0	0
3	31050554	.	T	C	3	4	7	0	1	8	0	0
3	31053268	.	A	C	1	0	1	0	2	3	0	0
3	31060219	.	A	G	4	0	4	0	9	13	0	0
3	31060500	.	T	C	1	3	4	0	0	4	0	0
3	31063319	.	A	G	2	6	8	0	0	8	0	0
3	31063625	.	A	T	3	4	7	0	1	8	0	0
3	31066143	.	C	G	1	5	6	0	0	6	0	0
3	31066637	.	G	A	2	2	4	0	0	4	0	0
3	31069602	.	G	A	5	9	14	0	10	31	7	0
3	31069634	.	T	C	14	17	31	0	0	31	0	0
3	31070892	.	A	G	20	21	41	0	2	43	0	0
3	31080994	.	G	A	5	3	8	0	1	9	0	0
3	31081017	.	T	C	3	6	9	0	1	10	0	0
3	31082995	.	T	A	2	3	5	0	0	5	0	0
3	31090424	.	T	C	1	3	4	0	1	5	0	0
3	31104943	.	C	T	2	3	5	0	3	8	0	0
3	31105259	.	A	C	29	28	57	0	1	58	0	0
3	31120249	.	C	T	15	20	35	0	3	38	0	0
3	31122581	.	T	G	9	11	20	0	6	26	0	0
3	31135832	.	T	C	1	0	1	0	2	3	0	0
3	31135898	.	T	C	4	0	4	0	5	9	0	0
3	31137926	.	T	C	4	5	9	0	0	9	0	0
3	31137957	.	G	A	2	3	5	0	0	5	0	0
3	31138225	.	A	G	5	8	13	0	0	13	0	0
3	31138247	.	C	T	4	6	10	0	2	12	0	0
3	31146690	.	C	T	3	3	6	0	0	6	0	0
3	31146909	.	G	A	1	2	3	0	0	3	0	0
3	31150363	.	A	G	1	5	6	0	0	6	0	0
3	31184034	.	C	T	1	3	4	0	0	4	0	0
3	31187564	.	C	G	4	5	9	0	0	9	0	0
3	31187608	.	C	T	4	4	8	0	0	8	0	0
3	31217714	.	G	T	1	3	4	0	1	5	0	0
3	31217723	.	G	A	2	2	4	0	1	5	0	0
3	31218153	.	C	T	0	3	3	0	2	5	0	0
3	31218230	.	G	A	1	3	4	0	1	5	0	0
3	31396212	.	A	G	4	0	4	0	10	14	0	0
3	31396474	.	A	G	3	0	3	0	3	6	0	0
3	31396679	.	A	G	4	7	11	0	0	11	0	0
3	31396760	.	A	C	11	8	19	0	1	20	0	0
3	31396781	.	C	G	9	1	10	0	6	16	0	0
3	31396826	.	T	C	8	6	14	0	1	15	0	0
3	31430327	.	T	C	5	9	14	0	1	15	0	0
3	31600731	.	T	C	1	2	3	0	0	3	0	0
3	31601297	.	C	G	3	5	8	0	0	8	0	0
3	31601308	.	G	A	0	5	5	0	3	8	0	0
3	31603925	.	A	G	4	4	8	0	0	8	0	0
3	31604053	.	G	A	2	3	5	0	0	5	0	0
3	31604133	.	T	C	5	2	7	0	0	7	0	0
3	31604834	.	A	T	7	2	9	0	0	9	0	0
3	31605033	.	A	G	4	3	7	0	1	8	0	0
3	31605039	.	C	T	5	3	8	0	0	8	0	0
3	31623521	.	A	G	1	0	1	0	2	3	0	0
3	31689648	.	G	C	0	2	2	0	2	4	0	0
3	31689655	.	T	C	2	2	4	0	0	4	0	0
3	31706607	.	C	A	14	10	24	0	1	25	0	0
3	31706966	.	T	C	10	10	20	0	1	21	0	0
3	31709010	.	C	T	12	17	29	1	1	31	0	0
3	31709079	.	G	A	20	15	35	0	2	37	0	0
3	31711526	.	T	C	11	11	22	0	1	23	0	0
3	31712328	.	G	T	4	3	7	0	0	7	0	0
3	31717595	.	C	T	10	15	25	0	0	25	0	0
3	31722101	.	A	T	19	16	35	0	0	35	0	0
3	31722342	.	A	G	19	24	43	0	4	47	0	0
3	31725824	.	C	T	14	26	40	0	0	40	0	0
3	31726066	.	T	C	18	22	40	0	2	42	0	0
3	31726395	.	G	A	1	6	7	0	7	14	0	0
3	31726541	.	A	T	4	13	17	0	1	18	0	0
3	31726829	.	C	T	7	17	24	1	2	27	0	0
3	31729328	.	A	G	3	4	7	0	0	7	0	0
3	31729531	.	C	T	4	5	9	0	0	9	0	0
3	31729707	.	C	T	0	2	2	0	5	7	0	0
3	31734188	.	C	T	0	4	4	0	5	9	0	0
3	31784001	.	A	G	2	2	4	0	0	4	0	0
3	31792600	.	T	A	2	4	6	0	0	6	0	0
3	31792601	.	G	A	4	2	6	0	0	6	0	0
3	31792683	.	G	T	15	8	23	0	1	24	0	0
3	31792856	.	G	A	10	11	21	1	0	22	0	0
3	31793080	.	C	T	10	5	15	0	0	15	0	0
3	31793515	.	T	G	5	7	12	0	0	12	0	0
3	31793518	.	G	A	7	3	10	0	1	11	0	0
3	31793557	.	A	G	5	2	7	0	0	7	0	0
3	31793715	.	G	C	3	6	9	0	0	9	0	0
3	31793739	.	C	T	9	4	13	0	0	13	0	0
3	31797749	.	A	G	7	4	11	0	0	11	0	0
3	31874969	.	G	T	5	11	16	0	0	16	0	0
3	31879513	.	T	A	6	3	9	0	0	9	0	0
3	31879626	.	G	A	7	6	13	0	0	13	0	0
3	31879725	.	T	A	5	4	9	0	2	11	0	0
3	31879726	.	C	A	6	5	11	0	1	12	0	0
3	31879880	.	G	T	7	16	23	0	0	23	0	0
3	31879911	.	T	C	9	13	22	0	1	23	0	0
3	31880184	.	C	G	1	4	5	0	6	11	0	0
3	31880641	.	C	T	1	11	12	0	10	22	0	0
3	31881082	.	G	T	6	4	10	0	0	10	0	0
3	31884321	.	C	T	0	5	5	0	8	13	0	0
3	31884477	.	C	T	4	7	11	0	0	11	0	0
3	31886783	.	C	T	0	3	3	0	4	7	0	0
3	31890010	.	T	C	5	4	9	0	0	9	0	0
3	31892324	.	C	T	5	3	8	0	0	8	0	0
3	31897070	.	A	G	4	2	6	0	0	6	0	0
3	31914167	.	T	A	9	3	12	0	0	12	0	0
3	31916624	.	T	G	4	0	4	3	11	18	0	0
3	31916701	.	A	T	6	10	16	0	1	17	0	0
3	31916724	.	A	G	14	11	25	0	0	25	0	0
3	31916787	.	G	T	16	14	30	0	1	31	0	0
3	31916863	.	T	C	17	8	25	0	0	25	0	0
3	31917075	.	T	G	9	0	9	0	8	17	0	0
3	31917279	.	G	T	11	5	16	0	0	16	0	0
3	31922838	.	G	C	6	5	11	0	1	12	0	0
3	31926052	.	C	A	15	16	31	0	1	32	0	0
3	31939272	.	A	G	16	16	32	0	1	33	0	0
3	31939473	.	G	T	2	18	20	0	26	46	0	0
3	31939566	.	C	A	16	17	33	0	1	34	0	0
3	31941152	.	C	T	18	20	38	0	3	41	0	0
3	31944357	.	A	T	17	15	32	3	0	35	0	0
3	31951034	.	A	C	1	2	3	0	0	3	0	0
3	31961992	.	G	A	1	7	8	0	9	17	0	0
3	32021628	.	G	A	8	10	18	0	0	18	0	0
3	32049740	.	C	T	7	12	19	0	1	20	0	0
3	32079667	.	T	A	1	2	3	0	0	3	0	0
3	32083179	.	C	T	1	2	3	0	0	3	0	0
3	32087455	.	T	G	2	5	7	0	1	8	0	0
3	32095609	.	C	T	7	2	9	0	0	9	0	0
3	32098130	.	G	A	1	2	3	0	4	7	0	0
3	32098379	.	A	G	4	3	7	0	1	8	0	0
3	32099841	.	A	G	23	1	24	1	20	45	0	0
3	32100183	.	G	T	19	9	28	18	2	48	0	0
3	32100206	.	T	C	11	3	14	28	0	42	0	0
3	32100731	.	T	C	11	5	16	31	0	47	0	0
3	32100755	.	T	C	17	13	30	22	0	52	0	0
3	32105746	.	C	A	18	8	26	0	0	26	0	0
3	32118802	.	C	T	2	2	4	0	0	4	0	0
3	32120187	.	A	T	2	5	7	3	1	11	0	0
3	32139671	.	G	A	5	7	12	0	0	12	0	0
3	32139701	.	C	G	3	7	10	1	1	12	0	0
3	32294745	.	G	A	14	18	32	0	2	34	0	0
3	32294869	.	C	G	3	13	16	0	32	48	0	0
3	32295151	.	C	T	22	17	39	1	0	40	0	0
3	32295294	.	G	A	25	16	41	7	0	48	0	0
3	32295519	.	A	C	12	16	28	0	1	29	0	0
3	32295635	.	T	A	10	6	16	0	3	19	0	0
3	32295733	.	T	A	7	2	9	0	0	9	0	0
3	32296122	.	C	T	17	13	30	0	0	30	0	0
3	32296202	.	G	A	13	9	22	0	0	22	0	0
3	32296253	.	T	A	16	5	21	0	2	23	0	0
3	32296283	.	G	A	13	3	16	0	0	16	0	0
3	32296306	.	G	A	13	7	20	0	0	20	0	0
3	32296379	.	A	G	21	14	35	0	0	35	0	0
3	32296559	.	G	A	13	12	25	0	2	27	0	0
3	32296560	.	C	T	2	14	16	0	12	28	0	0
3	32296673	.	A	G	18	16	34	0	0	34	0	0
3	32296873	.	G	A	19	14	33	0	2	35	0	0
3	32303009	.	T	C	1	2	3	0	4	7	0	0
3	32303045	.	G	A	13	6	19	0	0	19	0	0
3	32303698	.	A	G	15	11	26	0	0	26	0	0
3	32314732	.	G	A	2	8	10	0	0	10	0	0
3	32325218	.	A	G	4	10	14	0	0	14	0	0
3	32329167	.	A	T	6	20	26	0	2	28	0	0
3	32357596	.	C	T	16	26	42	1	12	55	0	0
3	32357799	.	A	C	28	29	57	0	2	59	0	0
3	32360978	.	G	A	13	13	26	0	2	28	0	0
3	32361669	.	G	A	21	14	35	0	0	35	0	0
3	32361865	.	A	G	20	14	34	1	0	35	0	0
3	32366131	.	T	C	8	11	19	0	0	19	0	0
3	32366279	.	T	C	6	4	10	0	0	10	0	0
3	32366332	.	G	A	13	5	18	0	1	19	0	0
3	32366403	.	C	T	13	6	19	0	1	20	0	0
3	32400967	.	C	T	27	37	64	0	3	67	0	0
3	32401159	.	C	A	28	31	59	0	2	62	1	0
3	32401252	.	C	T	32	23	55	0	2	57	0	0
3	32403959	.	T	G	6	0	6	0	8	14	0	0
3	32405571	.	C	T	20	14	34	0	2	36	0	0
3	32405865	.	G	C	18	20	38	0	1	39	0	0
3	32405910	.	C	T	21	17	38	0	0	38	0	0
3	32406447	.	T	C	27	26	53	0	2	55	0	0
3	32406547	.	T	C	18	37	55	0	1	56	0	0
3	32406618	.	G	A	29	27	56	0	1	57	0	0
3	32406631	.	C	G	26	27	53	0	3	56	0	0
3	32414109	.	T	C	1	2	3	0	1	4	0	0
3	32414873	.	T	C	4	1	5	0	2	7	0	0
3	32414882	.	G	C	3	3	6	0	0	6	0	0
3	32415781	.	A	C	1	3	4	0	0	4	0	0
3	32434974	.	G	A	0	6	6	0	6	12	0	0
3	32435034	.	G	T	0	4	4	0	15	19	0	0
3	32435757	.	G	A	0	5	5	0	8	13	0	0
3	32435874	.	G	A	1	8	9	0	2	11	0	0
3	32436024	.	C	A	6	9	15	0	0	15	0	0
3	32436109	.	T	A	5	4	9	0	0	9	0	0
3	32436156	.	T	C	5	3	8	0	0	8	0	0
3	32436426	.	C	T	15	12	27	0	1	28	0	0
3	32436736	.	G	C	10	13	23	0	2	25	0	0
3	32436774	.	G	A	8	12	20	0	0	20	0	0
3	32438425	.	A	C	12	19	31	0	1	32	0	0
3	32440805	.	A	G	13	13	26	0	1	27	0	0
3	32441156	.	T	G	21	1	22	0	18	40	0	0
3	32441297	.	C	A	14	11	25	0	1	26	0	0
3	32441385	.	G	C	19	13	32	0	0	32	0	0
3	32441532	.	G	A	11	13	24	3	5	32	0	0
3	32441779	.	C	T	16	18	34	0	5	39	0	0
3	32447386	.	G	A	22	7	29	0	0	29	0	0
3	32447505	.	G	T	17	15	32	0	3	35	0	0
3	32447674	.	C	G	16	17	33	0	1	34	0	0
3	32447800	.	T	C	14	13	27	0	1	28	0	0
3	32450399	.	T	C	24	18	42	0	1	43	0	0
3	32453727	.	G	A	17	22	39	0	2	41	0	0
3	32457325	.	G	A	2	29	31	1	21	53	0	0
3	32457620	.	T	C	19	14	33	0	0	33	0	0
3	32457686	.	T	C	14	14	28	0	5	33	0	0
3	32458627	.	C	T	12	6	18	0	0	18	0	0
3	32477891	.	T	C	8	5	13	0	1	14	0	0
3	32477950	.	T	A	4	4	8	0	1	9	0	0
3	32482222	.	A	T	6	11	17	0	0	17	0	0
3	32482231	.	A	G	5	0	5	0	13	18	0	0
3	32482495	.	G	T	1	3	4	0	8	12	0	0
3	32482834	.	A	G	6	6	12	0	0	12	0	0
3	32483557	.	T	G	8	18	26	0	0	26	0	0
3	32483956	.	T	C	13	9	22	0	1	23	0	0
3	32484034	.	A	G	19	0	19	0	15	34	0	0
3	32484039	.	A	G	19	0	19	0	16	35	0	0
3	32484204	.	T	C	15	19	34	0	1	35	0	0
3	32484676	.	T	G	16	8	24	0	1	25	0	0
3	32484892	.	A	G	13	13	26	0	1	27	0	0
3	32485306	.	A	G	21	24	45	0	2	47	0	0
3	32485324	.	C	T	24	20	44	0	0	44	0	0
3	32485366	.	A	G	21	17	38	0	1	39	0	0
3	32485519	.	A	C	19	15	34	0	2	36	0	0
3	32485967	.	C	A	26	17	43	0	1	44	0	0
3	32486049	.	A	T	21	18	39	0	2	41	0	0
3	32486069	.	C	G	15	0	15	0	22	37	0	0
3	32489613	.	C	T	21	25	46	0	1	47	0	0
3	32490098	.	C	T	15	13	28	0	2	30	0	0
3	32490251	.	G	T	13	16	29	0	0	29	0	0
3	32490264	.	G	A	7	14	21	0	1	22	0	0
3	32490487	.	G	T	7	7	14	0	3	17	0	0
3	32532801	.	G	A	1	4	5	0	0	5	0	0
3	32534263	.	A	G	10	14	24	0	0	24	0	0
3	32534353	.	C	T	12	8	20	0	0	20	0	0
3	32534365	.	T	A	14	6	20	0	1	21	0	0
3	32587304	.	C	T	3	2	5	0	0	5	0	0
3	32637967	.	A	T	1	6	7	0	1	8	0	0
3	32637977	.	A	C	1	8	9	0	0	9	0	0
3	32641716	.	T	G	10	3	13	0	0	13	0	0
3	32643512	.	G	A	18	7	25	0	0	25	0	0
3	32647124	.	T	C	16	16	32	0	1	33	0	0
3	32647194	.	C	T	18	10	28	0	0	28	0	0
3	32647252	.	G	A	16	12	28	0	0	28	0	0
3	32647308	.	G	C	15	9	24	0	1	25	0	0
3	32647414	.	A	G	10	7	17	0	0	17	0	0
3	32647558	.	A	G	17	0	17	0	17	34	0	0
3	32649846	.	C	T	8	11	19	0	1	20	0	0
3	32649960	.	G	A	6	22	28	0	0	28	0	0
3	32650004	.	A	G	12	14	26	0	1	27	0	0
3	32650199	.	C	A	8	4	12	0	0	12	0	0
3	32657156	.	T	C	6	2	8	0	0	8	0	0
3	32658076	.	T	C	1	2	3	0	0	3	0	0
3	32663255	.	T	C	2	2	4	0	0	4	0	0
3	32663485	.	T	C	1	8	9	0	0	9	0	0
3	32663638	.	A	G	2	5	7	0	0	7	0	0
3	32663764	.	T	G	3	5	8	0	0	8	0	0
3	32665515	.	G	A	2	2	4	0	0	4	0	0
3	32667118	.	A	C	5	8	13	0	2	15	0	0
3	32668806	.	A	G	1	10	11	0	1	12	0	0
3	32668818	.	A	G	5	8	13	0	1	14	0	0
3	32669077	.	T	A	1	3	4	0	0	4	0	0
3	32672501	.	C	A	4	4	8	0	0	8	0	0
3	32675236	.	G	A	9	11	20	0	2	22	0	0
3	32679267	.	T	A	14	16	30	0	0	30	0	0
3	32679289	.	T	A	18	14	32	0	1	33	0	0
3	32679332	.	C	T	19	16	35	0	1	36	0	0
3	32679528	.	C	A	10	11	21	0	0	21	0	0
3	32685708	.	A	G	12	0	12	0	10	22	0	0
3	32686230	.	A	G	17	0	17	0	15	32	0	0
3	32686245	.	T	C	16	16	32	0	1	33	0	0
3	32698458	.	T	C	2	5	7	0	0	7	0	0
3	32698500	.	A	G	15	15	30	0	0	30	0	0
3	32700697	.	A	G	11	10	21	0	0	21	0	0
3	32700758	.	A	G	11	9	20	0	1	21	0	0
3	32700988	.	C	T	16	12	28	0	1	29	0	0
3	32701031	.	T	G	15	0	15	0	24	39	0	0
3	32702596	.	T	A	14	8	22	0	1	23	0	0
3	32707219	.	G	A	9	9	18	0	0	18	0	0
3	32707267	.	T	C	7	13	20	0	0	20	0	0
3	32707272	.	C	A	5	13	18	0	0	18	0	0
3	32707480	.	C	T	7	11	18	0	1	19	0	0
3	32707621	.	C	G	11	19	30	0	0	30	0	0
3	32707813	.	C	G	13	17	30	0	0	30	0	0
3	32708077	.	T	C	25	26	51	0	1	52	0	0
3	32710705	.	A	G	22	24	46	0	2	48	0	0
3	32710812	.	G	A	3	32	35	1	19	55	0	0
3	32710999	.	C	A	10	5	15	0	1	16	0	0
3	32711102	.	T	C	0	1	1	0	0	1	0	0
3	32711117	.	T	C	1	2	3	0	0	3	0	0
3	32711147	.	T	A	2	4	6	0	0	6	0	0
3	32717529	.	C	T	1	2	3	0	0	3	0	0
3	32718451	.	T	G	2	2	4	0	0	4	0	0
3	32718460	.	C	T	1	2	3	0	0	3	0	0
3	32718605	.	A	G	1	3	4	0	0	4	0	0
3	32718945	.	C	G	2	2	4	0	0	4	0	0
3	32719715	.	T	C	3	5	8	0	0	8	0	0
3	32720184	.	A	C	1	1	2	0	2	4	0	0
3	32720342	.	T	C	4	3	7	0	0	7	0	0
3	32722973	.	C	T	6	5	11	0	0	11	0	0
3	32723497	.	A	G	7	0	7	0	9	16	0	0
3	32723698	.	C	T	4	2	6	0	1	7	0	0
3	32724010	.	G	A	0	4	4	0	1	5	0	0
3	32724100	.	G	A	1	2	3	0	0	3	0	0
3	32726271	.	A	G	2	4	6	0	0	6	0	0
3	32728304	.	T	C	3	4	7	0	0	7	0	0
3	32729150	.	T	C	10	5	15	0	3	18	0	0
3	32729232	.	T	C	9	6	15	0	2	17	0	0
3	32729429	.	T	A	9	6	15	0	0	15	0	0
3	32729534	.	A	G	3	2	5	0	2	7	0	0
3	32729545	.	A	G	5	0	5	0	2	7	0	0
3	32729591	.	C	T	5	2	7	0	1	8	0	0
3	32729663	.	C	T	10	4	14	0	2	16	0	0
3	32729759	.	C	A	6	7	13	0	1	14	0	0
3	32729827	.	A	T	10	7	17	0	0	17	0	0
3	32729845	.	G	A	9	9	18	0	0	18	0	0
3	32730011	.	A	G	7	1	8	0	6	14	0	0
3	32730071	.	T	A	10	6	16	0	3	19	0	0
3	32730131	.	A	G	4	5	9	0	2	11	0	0
3	32731255	.	A	G	9	0	9	0	5	14	0	0
3	32731418	.	C	T	8	10	18	0	1	19	0	0
3	32731750	.	A	G	6	0	6	0	6	12	0	0
3	32731804	.	T	C	9	8	17	0	0	17	0	0
3	32731840	.	T	C	9	6	15	0	0	15	0	0
3	32734926	.	G	A	0	6	6	0	10	16	0	0
3	32737727	.	C	T	5	13	18	0	1	19	0	0
3	32741137	.	G	A	1	7	8	0	11	19	0	0
3	32741385	.	G	A	0	8	8	4	16	28	0	0
3	32741809	.	A	G	9	0	9	0	10	19	0	0
3	32777481	.	A	C	9	23	32	0	3	35	0	0
3	32777733	.	G	T	7	17	24	0	1	25	0	0
3	32778127	.	C	G	1	2	3	0	0	3	0	0
3	32778132	.	G	A	0	2	2	0	1	3	0	0
3	32789976	.	A	G	8	1	9	0	1	10	0	0
3	32789985	.	T	C	8	4	12	0	0	12	0	0
3	32794931	.	C	A	4	3	7	0	0	7	0	0
3	32795068	.	C	T	14	7	21	0	0	21	0	0
3	32795461	.	A	T	3	4	7	0	1	8	0	0
3	32795614	.	C	T	3	4	7	0	0	7	0	0
3	32807667	.	G	A	7	9	16	0	1	17	0	0
3	32808023	.	T	A	11	13	24	0	0	25	1	0
3	32808185	.	T	C	9	14	23	0	2	26	1	0
3	32808214	.	G	A	13	22	35	0	3	38	0	0
3	32808338	.	A	C	16	19	35	0	5	40	0	0
3	32808554	.	T	G	10	10	20	0	3	23	0	0
3	32808771	.	G	A	8	11	19	0	3	22	0	0
3	32808772	.	G	C	8	14	22	0	0	22	0	0
3	32808979	.	T	G	19	6	25	0	0	25	0	0
3	32809154	.	A	T	10	8	18	0	0	18	0	0
3	32809368	.	G	A	8	19	27	0	3	30	0	0
3	32809410	.	G	A	7	15	22	0	0	22	0	0
3	32809432	.	T	A	6	9	15	0	0	15	0	0
3	32809548	.	T	C	4	13	17	0	2	19	0	0
3	32809561	.	G	A	7	12	19	0	1	20	0	0
3	32809836	.	A	G	9	0	9	0	14	23	0	0
3	32809927	.	T	C	14	5	19	0	1	20	0	0
3	32810011	.	T	A	2	8	10	0	3	13	0	0
3	32810580	.	C	T	19	17	36	0	0	36	0	0
3	32810715	.	A	G	19	21	40	0	1	41	0	0
3	32811094	.	A	T	8	4	12	0	0	12	0	0
3	32824056	.	T	C	1	8	9	0	0	9	0	0
3	32824057	.	T	C	3	3	6	0	3	9	0	0
3	32824612	.	T	C	1	3	4	0	0	4	0	0
3	32825427	.	C	T	2	3	5	0	0	5	0	0
3	32837514	.	G	A	25	13	38	0	1	39	0	0
3	32837643	.	G	A	16	13	29	0	4	33	0	0
3	32837904	.	A	G	22	1	23	0	16	39	0	0
3	32838033	.	G	A	0	7	7	0	23	30	0	0
3	32838039	.	A	G	23	9	32	0	0	32	0	0
3	32842163	.	C	T	9	8	17	0	2	19	0	0
3	32842235	.	G	T	9	8	17	0	0	17	0	0
3	32842318	.	C	T	8	4	12	0	0	12	0	0
3	32847771	.	G	A	0	2	2	0	3	5	0	0
3	32847887	.	C	G	3	3	6	0	0	6	0	0
3	32847923	.	C	A	3	2	5	0	0	5	0	0
3	32848001	.	A	C	5	3	8	0	0	8	0	0
3	32848175	.	T	G	5	2	7	0	1	8	0	0
3	32848418	.	C	T	5	3	8	0	0	8	0	0
3	32848714	.	A	G	6	7	13	0	0	13	0	0
3	32849079	.	C	T	8	5	13	0	1	14	0	0
3	32849679	.	T	A	18	9	27	0	0	27	0	0
3	32850029	.	A	T	14	6	20	0	0	20	0	0
3	32850265	.	A	G	8	0	8	0	6	14	0	0
3	32850499	.	T	C	10	9	19	0	0	19	0	0
3	32854276	.	T	C	7	3	10	0	0	10	0	0
3	32854533	.	T	C	9	10	19	0	1	20	0	0
3	32854743	.	C	G	6	0	6	0	11	17	0	0
3	32854744	.	A	G	7	10	17	0	0	17	0	0
3	32855066	.	G	A	4	9	13	0	0	13	0	0
3	32863016	.	A	G	8	5	13	0	0	13	0	0
3	32863128	.	C	A	1	2	3	0	0	3	0	0
3	32864848	.	A	G	2	5	7	0	0	7	0	0
3	32864854	.	T	A	2	4	6	0	0	6	0	0
3	32865030	.	T	A	2	2	4	0	0	4	0	0
3	32866135	.	C	T	1	3	4	0	0	4	0	0
3	32866175	.	C	G	3	4	7	0	0	7	0	0
3	32867711	.	C	A	2	4	6	0	0	6	0	0
3	32868143	.	C	T	3	5	8	0	0	8	0	0
3	32868519	.	G	T	1	3	4	0	1	5	0	0
3	32868590	.	C	T	8	3	11	0	0	11	0	0
3	32868593	.	A	G	8	3	11	0	0	11	0	0
3	32869770	.	C	T	6	4	10	0	0	10	0	0
3	32869773	.	G	A	6	2	8	0	0	8	0	0
3	32869913	.	C	T	2	3	5	0	1	6	0	0
3	32870004	.	C	A	1	2	3	0	0	3	0	0
3	32870186	.	G	A	0	2	2	0	2	4	0	0
3	32870488	.	C	G	1	2	3	0	0	3	0	0
3	32870497	.	T	C	1	0	1	0	2	3	0	0
3	32870572	.	C	A	1	4	5	0	0	5	0	0
3	32870947	.	A	G	3	5	8	0	0	8	0	0
3	32871023	.	G	C	1	3	4	0	0	4	0	0
3	32871247	.	A	G	1	1	2	0	1	3	0	0
3	32871413	.	G	A	2	3	5	0	0	5	0	0
3	32871414	.	A	C	1	1	2	0	3	5	0	0
3	32889849	.	T	C	6	0	6	0	13	19	0	0
3	32890002	.	G	T	11	13	24	0	1	25	0	0
3	32890058	.	A	G	11	11	22	0	2	24	0	0
3	32892061	.	G	A	9	17	26	0	0	26	0	0
3	32892422	.	A	G	12	24	36	0	0	36	0	0
3	32900428	.	A	G	17	14	31	0	1	32	0	0
3	32924386	.	G	A	4	4	8	0	0	8	0	0
3	32924643	.	G	A	4	2	6	0	1	7	0	0
3	32924836	.	T	A	8	8	16	0	0	16	0	0
3	32924989	.	G	A	9	6	15	0	1	16	0	0
3	32925066	.	G	A	5	2	7	0	0	7	0	0
3	32925248	.	C	T	3	4	7	0	0	7	0	0
3	32925264	.	G	T	3	3	6	0	0	6	0	0
3	32926148	.	G	A	3	4	7	0	0	7	0	0
3	32926184	.	A	T	2	2	4	0	0	4	0	0
3	32933774	.	A	C	3	3	6	0	0	6	0	0
3	32933849	.	A	T	4	7	11	0	0	11	0	0
3	32935936	.	A	G	5	0	5	0	12	17	0	0
3	32937628	.	A	G	7	13	20	0	0	21	1	0
3	32941242	.	G	A	8	7	15	0	1	16	0	0
3	32941661	.	A	G	8	12	20	0	1	21	0	0
3	32944203	.	C	A	12	14	26	0	1	27	0	0
3	32944569	.	C	T	14	26	40	0	1	41	0	0
3	32944668	.	C	A	16	14	30	0	1	31	0	0
3	32944854	.	C	T	18	17	35	0	2	37	0	0
3	32947971	.	T	C	18	24	42	0	1	43	0	0
3	32950959	.	G	A	10	16	26	0	1	27	0	0
3	32950977	.	G	A	1	19	20	0	9	29	0	0
3	32951001	.	G	T	1	17	18	0	8	26	0	0
3	32951394	.	G	A	23	22	45	0	2	47	0	0
3	32951564	.	A	C	7	6	13	0	1	14	0	0
3	32951637	.	G	A	10	11	21	1	0	22	0	0
3	32951778	.	C	T	9	25	34	0	1	35	0	0
3	32951891	.	T	C	15	21	36	0	1	37	0	0
3	33065950	.	T	C	9	4	13	1	0	14	0	0
3	33065985	.	A	G	10	4	14	1	1	16	0	0
3	33066155	.	C	T	1	6	7	0	8	15	0	0
3	33066241	.	C	T	2	3	5	1	7	13	0	0
3	33066292	.	C	T	4	6	10	1	1	12	0	0
3	33066629	.	C	T	1	2	3	0	5	8	0	0
3	33066714	.	A	T	5	7	12	0	0	12	0	0
3	33066804	.	T	C	4	0	4	0	10	14	0	0
3	33066809	.	C	G	6	7	13	0	0	13	0	0
3	33066969	.	T	C	8	0	8	0	8	16	0	0
3	33066976	.	T	C	9	7	16	0	1	17	0	0
3	33067337	.	A	G	4	7	11	0	0	11	0	0
3	33067340	.	A	G	5	8	13	0	0	13	0	0
3	33067376	.	G	A	4	8	12	0	0	12	0	0
3	33067438	.	G	A	2	5	7	0	0	7	0	0
3	33069274	.	A	C	8	4	12	0	0	12	0	0
3	33069596	.	G	A	7	5	12	0	1	13	0	0
3	33075167	.	C	T	1	5	6	0	0	6	0	0
3	33341072	.	T	A	15	18	33	1	1	35	0	0
3	33344470	.	T	A	20	23	43	0	2	45	0	0
3	33345482	.	G	A	0	4	4	0	10	14	0	0
3	33360480	.	A	G	10	0	10	0	5	15	0	0
3	33368134	.	T	C	2	8	10	0	4	14	0	0
3	33372555	.	G	C	0	6	6	0	6	12	0	0
3	33373443	.	T	C	6	6	12	0	2	14	0	0
3	33375645	.	C	A	8	8	16	0	1	17	0	0
3	33424010	.	C	T	4	7	11	0	5	16	0	0
3	33424420	.	G	A	25	32	57	0	7	64	0	0
3	33426513	.	G	A	37	32	69	0	1	70	0	0
3	33432605	.	C	T	3	2	5	0	0	5	0	0
3	33433319	.	T	C	2	0	2	0	3	5	0	0
3	33433621	.	G	A	3	7	10	0	0	10	0	0
3	33437399	.	T	C	4	5	9	0	0	9	0	0
3	33440693	.	C	T	3	6	9	0	0	9	0	0
3	33445039	.	A	T	5	5	10	0	0	10	0	0
3	33445090	.	G	C	0	8	8	0	10	18	0	0
3	33449405	.	C	T	9	9	18	0	0	18	0	0
3	33449554	.	G	A	0	7	7	0	10	17	0	0
3	33452168	.	C	T	21	16	37	0	0	37	0	0
3	33455809	.	G	A	0	15	15	0	17	32	0	0
3	33458803	.	C	T	17	14	31	0	2	33	0	0
3	33458911	.	A	T	11	12	23	0	1	24	0	0
3	33459394	.	T	A	10	4	14	0	0	14	0	0
3	33459489	.	C	T	11	4	15	0	0	15	0	0
3	33459517	.	C	T	9	5	14	0	1	15	0	0
3	33459532	.	G	A	8	7	15	0	0	15	0	0
3	33461366	.	C	T	0	12	12	0	12	24	0	0
3	33461646	.	C	T	3	5	8	0	12	20	0	0
3	33461796	.	A	T	15	10	25	0	1	26	0	0
3	33469413	.	A	G	9	14	23	0	1	24	0	0
3	33469614	.	T	A	12	12	24	0	1	25	0	0
3	33473131	.	C	T	1	8	9	0	13	22	0	0
3	33476589	.	T	C	3	14	17	0	0	17	0	0
3	33478690	.	G	A	6	3	9	0	3	12	0	0
3	33494089	.	A	T	6	11	17	0	1	18	0	0
3	33494091	.	G	C	6	12	18	0	0	18	0	0
3	33570763	.	G	A	2	3	5	0	0	5	0	0
3	33571002	.	C	T	1	5	6	0	0	6	0	0
3	33571294	.	C	T	3	2	5	0	0	5	0	0
3	33572095	.	G	A	3	5	8	0	0	8	0	0
3	33572298	.	G	A	5	4	9	0	0	9	0	0
3	33572553	.	T	G	1	2	3	0	0	3	0	0
3	33572617	.	A	T	1	2	3	0	0	3	0	0
3	33573178	.	G	A	2	2	4	0	0	4	0	0
3	33747527	.	A	G	3	7	10	0	1	11	0	0
3	33747563	.	A	G	1	0	1	0	7	8	0	0
3	33761597	.	C	T	11	9	20	0	0	20	0	0
3	33761705	.	G	A	3	10	13	0	21	34	0	0
3	33761834	.	G	A	20	10	30	0	1	31	0	0
3	33761835	.	A	T	20	10	30	0	0	30	0	0
3	33762068	.	A	G	7	10	17	0	1	18	0	0
3	33762278	.	A	G	14	11	25	0	0	25	0	0
3	33762310	.	C	A	13	8	21	0	1	22	0	0
3	33762408	.	T	A	9	10	19	0	0	19	0	0
3	33762480	.	C	T	10	9	19	0	0	19	0	0
3	33773294	.	A	G	15	16	31	0	0	31	0	0
3	33777317	.	T	G	13	20	33	0	7	40	0	0
3	33777425	.	A	G	17	12	29	0	4	33	0	0
3	33777807	.	A	G	17	20	37	0	3	40	0	0
3	33820291	.	T	C	2	6	8	0	1	9	0	0
3	33820568	.	C	T	7	4	11	0	0	11	0	0
3	33820580	.	A	G	7	5	12	0	1	13	0	0
3	33821929	.	C	T	2	4	6	0	0	6	0	0
3	33834678	.	T	C	4	4	8	0	1	9	0	0
3	33842844	.	A	G	6	5	11	0	0	11	0	0
3	33844761	.	T	C	1	0	1	0	10	11	0	0
3	33847131	.	C	T	2	2	4	0	0	4	0	0
3	33854879	.	T	C	3	2	5	0	1	6	0	0
3	33854972	.	A	G	1	7	8	0	0	8	0	0
3	33918537	.	T	A	3	3	6	0	0	6	0	0
3	33918611	.	A	G	5	3	8	0	0	8	0	0
3	33918675	.	T	G	8	3	11	0	0	11	0	0
3	33918775	.	A	G	5	4	9	0	0	9	0	0
3	33921663	.	A	C	7	7	14	0	0	14	0	0
3	33921935	.	T	C	1	2	3	0	0	3	0	0
3	33922269	.	A	G	3	3	6	0	0	6	0	0
3	33922359	.	G	A	2	13	15	0	1	16	0	0
3	33922413	.	T	A	2	12	14	0	0	14	0	0
3	33922415	.	G	A	2	11	13	0	1	14	0	0
3	33922471	.	T	C	9	11	20	0	0	20	0	0
3	33932170	.	C	T	3	6	9	0	6	15	0	0
3	33932430	.	T	A	8	12	20	0	0	20	0	0
3	33932628	.	G	A	3	10	13	0	0	13	0	0
3	33934848	.	T	C	7	3	10	0	2	12	0	0
3	33934849	.	G	C	7	4	11	0	1	12	0	0
3	34129941	.	C	T	1	8	9	0	16	25	0	0
3	34135868	.	C	T	3	3	6	0	0	6	0	0
3	34144353	.	A	T	2	2	4	0	0	4	0	0
3	34144807	.	C	G	1	2	3	0	0	3	0	0
3	34144808	.	G	A	0	1	1	0	2	3	0	0
3	34146338	.	C	T	2	6	8	0	0	8	0	0
3	34146882	.	G	T	7	4	11	0	1	12	0	0
3	34146955	.	A	G	5	7	12	0	0	12	0	0
3	34166288	.	C	A	13	15	28	0	2	30	0	0
3	34170913	.	G	A	15	12	27	0	1	28	0	0
3	34180096	.	G	T	6	3	9	0	0	9	0	0
3	34180332	.	A	G	2	2	4	0	0	4	0	0
3	34180386	.	G	A	5	5	10	0	0	10	0	0
3	34182164	.	C	T	7	5	12	0	0	12	0	0
3	34182306	.	G	C	6	8	14	0	0	14	0	0
3	34182376	.	A	C	1	10	11	0	0	11	0	0
3	34182386	.	G	A	0	10	10	0	1	11	0	0
3	34220359	.	A	T	9	4	13	0	0	13	0	0
3	34244901	.	G	C	8	6	14	0	1	15	0	0
3	34258965	.	G	A	12	12	24	0	1	25	0	0
3	34259013	.	C	G	15	15	30	0	4	34	0	0
3	34259060	.	C	T	31	16	47	0	2	49	0	0
3	34260325	.	T	C	9	10	19	0	0	19	0	0
3	34260808	.	T	C	8	12	20	0	1	21	0	0
3	34261204	.	T	C	6	7	13	0	0	13	0	0
3	34261354	.	A	G	16	13	29	0	1	30	0	0
3	34261795	.	G	A	12	18	30	0	0	30	0	0
3	34262290	.	C	T	13	9	22	0	1	23	0	0
3	34262421	.	C	A	11	10	21	0	1	22	0	0
3	34262639	.	G	A	15	14	29	0	1	30	0	0
3	34262823	.	A	T	12	12	24	0	1	25	0	0
3	34263007	.	C	T	0	8	8	0	7	16	1	0
3	34263101	.	T	A	11	4	15	0	3	18	0	0
3	34263566	.	C	A	8	5	13	0	0	13	0	0
3	34264140	.	A	T	5	6	11	0	1	12	0	0
3	34264634	.	T	A	7	6	13	0	2	15	0	0
3	34264657	.	A	T	6	6	12	0	1	13	0	0
3	34270546	.	A	G	9	7	16	0	0	16	0	0
3	34337389	.	A	G	3	5	8	0	0	8	0	0
3	34588493	.	A	G	4	3	7	0	1	8	0	0
3	34588663	.	T	G	1	2	3	0	0	3	0	0
3	34588788	.	G	A	5	3	8	0	0	8	0	0
3	34589396	.	A	C	2	3	5	0	0	5	0	0
3	34589501	.	C	T	2	5	7	0	0	7	0	0
3	34697461	.	G	A	6	4	10	0	1	11	0	0
3	34697514	.	T	C	10	0	10	0	11	21	0	0
3	34767112	.	G	T	27	26	53	0	5	58	0	0
3	34767662	.	T	G	24	39	63	0	0	63	0	0
3	34767669	.	G	A	21	38	59	0	2	61	0	0
3	34772941	.	T	G	42	29	71	0	1	73	1	0
3	34775942	.	G	A	36	31	67	0	4	71	0	0
3	34776115	.	T	G	26	30	56	0	6	62	0	0
3	34776133	.	G	C	27	36	63	0	3	66	0	0
3	34776151	.	C	A	27	40	67	0	2	69	0	0
3	34781074	.	A	G	29	31	60	0	1	61	0	0
3	34781095	.	C	T	31	29	60	0	1	61	0	0
3	34781448	.	T	C	11	25	36	0	1	37	0	0
3	34781586	.	T	C	14	1	15	0	19	34	0	0
3	34783970	.	G	A	17	18	35	0	3	38	0	0
3	34783982	.	A	G	14	19	33	0	1	34	0	0
3	34801034	.	T	C	6	7	13	0	1	14	0	0
3	34804427	.	A	G	16	10	26	0	0	26	0	0
3	34814839	.	A	G	6	3	9	0	0	9	0	0
3	34822049	.	C	T	11	13	24	0	3	27	0	0
3	34822169	.	C	T	13	12	25	0	0	25	0	0
3	34822214	.	T	C	15	10	25	0	0	25	0	0
3	34919892	.	C	T	8	9	17	0	1	18	0	0
3	34977497	.	A	G	14	0	14	0	14	28	0	0
3	34977508	.	A	G	14	0	14	0	9	23	0	0
3	34981394	.	T	C	3	4	7	0	1	8	0	0
3	34994140	.	C	T	31	32	63	1	1	65	0	0
3	34994750	.	A	G	15	13	28	0	3	31	0	0
3	35170112	.	T	C	12	16	28	1	2	31	0	0
3	35225160	.	A	G	23	0	23	0	24	47	0	0
3	35225202	.	C	T	20	23	43	0	2	45	0	0
3	35248470	.	T	C	9	13	22	0	0	22	0	0
3	35248492	.	T	A	9	13	22	0	1	23	0	0
3	35249369	.	T	C	15	20	35	0	1	36	0	0
3	35249535	.	T	C	19	15	34	0	0	34	0	0
3	35250145	.	A	T	16	20	36	0	0	36	0	0
3	35250188	.	A	G	10	10	20	0	1	21	0	0
3	35264406	.	T	G	26	25	51	0	1	52	0	0
3	35264460	.	C	T	28	31	59	0	0	59	0	0
3	35264744	.	T	A	24	16	40	0	2	42	0	0
3	35264951	.	G	A	23	8	31	0	0	31	0	0
3	35264970	.	C	T	18	6	24	2	4	30	0	0
3	35265350	.	T	C	21	13	34	5	2	41	0	0
3	35265419	.	T	G	17	18	35	0	0	35	0	0
3	35265654	.	G	A	4	27	31	0	26	57	0	0
3	35266006	.	G	A	1	2	3	0	0	3	0	0
3	35298531	.	G	T	4	8	12	0	0	12	0	0
3	35298725	.	T	A	7	4	11	0	2	13	0	0
3	35374719	.	C	T	11	10	21	0	0	21	0	0
3	35375112	.	G	A	22	10	32	0	1	33	0	0
3	35375162	.	T	A	21	12	33	0	1	35	1	0
3	35375279	.	A	T	10	15	25	0	3	28	0	0
3	35375306	.	T	C	11	13	24	0	1	25	0	0
3	35375448	.	T	G	26	0	26	0	16	42	0	0
3	35375638	.	T	A	18	14	32	0	6	38	0	0
3	35406475	.	G	A	3	4	7	0	0	7	0	0
3	35406648	.	G	T	0	2	2	0	4	6	0	0
3	35418047	.	A	G	11	4	15	0	0	15	0	0
3	35419683	.	A	T	4	10	14	0	0	14	0	0
3	35420588	.	A	G	5	5	10	0	1	11	0	0
3	35420604	.	C	T	4	6	10	0	0	10	0	0
3	35514786	.	C	T	3	3	6	0	1	7	0	0
3	35514849	.	C	A	4	6	10	0	1	11	0	0
3	35515053	.	G	T	5	5	10	0	1	11	0	0
3	35515074	.	C	T	3	4	7	0	0	7	0	0
3	35515103	.	G	A	4	2	6	0	0	6	0	0
3	35515179	.	T	C	7	5	12	0	0	12	0	0
3	35515304	.	T	G	4	10	14	0	0	14	0	0
3	35515866	.	A	T	6	9	15	0	0	15	0	0
3	35517999	.	A	C	8	3	11	0	0	11	0	0
3	35518036	.	C	G	7	5	12	0	0	12	0	0
3	35518464	.	A	C	5	4	9	0	1	10	0	0
3	35518962	.	C	A	11	5	16	0	0	16	0	0
3	35523824	.	C	G	12	13	25	0	0	25	0	0
3	35527024	.	T	C	6	5	11	0	0	11	0	0
3	35529040	.	T	C	10	9	19	0	0	19	0	0
3	35530787	.	C	T	2	10	12	0	0	12	0	0
3	35531018	.	T	C	12	3	15	0	2	17	0	0
3	35531028	.	T	C	14	7	21	0	0	21	0	0
3	35531328	.	G	A	2	13	15	0	8	23	0	0
3	35531329	.	A	T	11	13	24	0	0	24	0	0
3	35531671	.	A	T	19	10	29	0	1	30	0	0
3	35531791	.	A	G	20	1	21	0	19	40	0	0
3	35531866	.	T	A	19	17	36	0	0	36	0	0
3	35531985	.	G	A	20	24	44	0	1	45	0	0
3	35532074	.	A	T	18	15	33	0	0	33	0	0
3	35532452	.	A	T	23	14	37	0	2	39	0	0
3	35532634	.	A	G	19	0	19	0	18	37	0	0
3	35532665	.	C	T	16	14	30	0	4	34	0	0
3	35532736	.	A	C	15	6	21	1	0	22	0	0
3	35535484	.	G	A	1	2	3	0	0	3	0	0
3	35535588	.	A	G	2	2	4	0	0	4	0	0
3	35535589	.	C	T	0	2	2	0	2	4	0	0
3	35535652	.	T	A	2	2	4	0	0	4	0	0
3	35535695	.	A	C	1	4	5	0	0	5	0	0
3	35535702	.	G	T	1	4	5	0	0	5	0	0
3	35536115	.	C	G	21	16	37	0	1	38	0	0
3	35536269	.	G	A	18	11	29	0	0	29	0	0
3	35541273	.	A	G	35	22	57	0	2	59	0	0
3	35549002	.	G	A	3	6	9	0	0	9	0	0
3	35551047	.	A	T	16	14	30	0	2	32	0	0
3	35551190	.	C	T	1	11	12	0	18	30	0	0
3	35589548	.	C	T	21	27	48	0	0	48	0	0
3	35589881	.	T	C	22	21	43	0	7	50	0	0
3	35589908	.	A	G	22	27	49	0	4	53	0	0
3	35589918	.	G	A	26	25	51	0	2	53	0	0
3	35590270	.	T	C	28	1	29	0	29	58	0	0
3	35602007	.	A	C	22	1	23	0	22	45	0	0
3	35602047	.	A	G	21	27	48	0	1	49	0	0
3	35602153	.	A	G	16	17	33	0	2	35	0	0
3	35602154	.	T	A	16	18	34	0	1	36	1	0
3	35608511	.	C	T	2	2	4	0	0	4	0	0
3	35617940	.	A	C	4	5	9	0	0	9	0	0
3	35617943	.	A	C	4	5	9	0	0	9	0	0
3	35621473	.	G	A	0	3	3	0	1	4	0	0
3	35635039	.	C	T	2	6	8	0	1	9	0	0
3	35635248	.	A	G	10	3	13	4	2	19	0	0
3	35635273	.	A	G	10	0	10	2	4	16	0	0
3	35635688	.	A	G	3	0	3	0	2	5	0	0
3	35636157	.	A	G	4	2	6	0	0	6	0	0
3	35636388	.	A	G	4	2	6	0	0	6	0	0
3	35636410	.	A	G	5	2	7	0	0	7	0	0
3	35638008	.	T	A	21	7	28	0	0	28	0	0
3	35638119	.	A	C	17	20	37	0	0	37	0	0
3	35638201	.	A	G	16	15	31	0	2	33	0	0
3	35638240	.	C	T	22	12	34	0	2	36	0	0
3	35638366	.	T	C	9	3	12	0	1	13	0	0
3	35638450	.	T	A	10	4	14	0	0	14	0	0
3	35638513	.	G	A	17	9	26	0	1	27	0	0
3	35638908	.	C	T	2	23	25	0	24	49	0	0
3	35638986	.	C	A	15	27	42	0	1	43	0	0
3	35639020	.	A	G	16	19	35	0	2	37	0	0
3	35639021	.	G	A	18	18	36	0	1	37	0	0
3	35639194	.	T	C	13	19	32	0	0	32	0	0
3	35639621	.	A	C	14	9	23	0	0	23	0	0
3	35639817	.	T	A	5	6	11	0	1	12	0	0
3	35639862	.	G	T	10	9	19	0	0	19	0	0
3	35639884	.	T	C	11	0	11	0	7	18	0	0
3	35639958	.	T	C	9	13	22	0	1	23	0	0
3	35640042	.	A	G	14	14	28	0	0	28	0	0
3	35640122	.	G	T	12	8	20	0	3	23	0	0
3	35640441	.	C	A	8	12	20	1	0	21	0	0
3	35640588	.	A	G	7	5	12	0	0	12	0	0
3	35640625	.	C	T	9	14	23	0	0	23	0	0
3	35640784	.	T	C	12	14	26	0	2	28	0	0
3	35641173	.	C	T	8	4	12	0	1	13	0	0
3	35641371	.	C	T	4	16	20	1	14	35	0	0
3	35641382	.	G	A	15	17	32	1	0	33	0	0
3	35641595	.	A	T	10	12	22	0	0	22	0	0
3	35641785	.	C	T	1	10	11	0	9	20	0	0
3	35642012	.	A	T	5	13	18	0	0	18	0	0
3	35642072	.	A	G	9	17	26	0	1	27	0	0
3	35642242	.	T	C	6	0	6	0	7	13	0	0
3	35642462	.	T	C	13	0	13	0	7	20	0	0
3	35643320	.	G	A	4	7	11	0	0	11	0	0
3	35643357	.	G	A	2	4	6	0	4	10	0	0
3	35643540	.	G	A	5	15	20	0	0	20	0	0
3	35643546	.	A	T	4	12	16	0	0	17	1	0
3	35645380	.	T	C	18	2	20	0	13	33	0	0
3	35645411	.	G	A	13	8	21	0	1	22	0	0
3	35645661	.	T	G	11	13	24	0	1	25	0	0
3	35646025	.	G	T	7	14	21	0	0	21	0	0
3	35646160	.	G	T	11	9	20	0	0	20	0	0
3	35646611	.	T	G	5	5	10	0	0	10	0	0
3	35647181	.	A	G	7	11	18	0	0	18	0	0
3	35647321	.	G	A	11	5	16	0	1	17	0	0
3	35647882	.	G	A	3	3	6	0	0	6	0	0
3	35647975	.	A	G	4	3	7	0	1	8	0	0
3	35652750	.	G	A	3	3	6	0	0	6	0	0
3	35652765	.	G	A	2	3	5	0	0	5	0	0
3	35800614	.	C	G	2	2	4	0	2	6	0	0
3	35800738	.	T	C	4	5	9	0	0	9	0	0
3	35800758	.	T	G	4	1	5	0	3	8	0	0
3	35800995	.	A	G	1	3	4	0	0	4	0	0
3	35801019	.	A	T	1	3	4	0	0	4	0	0
3	35831029	.	T	C	3	2	5	0	0	5	0	0
3	35831095	.	G	T	3	3	6	0	0	6	0	0
3	35831167	.	T	C	2	7	9	0	0	9	0	0
3	35837532	.	C	T	2	2	4	0	0	4	0	0
3	35840264	.	A	G	1	0	1	0	4	5	0	0
3	35840267	.	T	A	2	3	5	0	0	5	0	0
3	35846120	.	C	G	2	6	8	0	0	8	0	0
3	35846343	.	C	G	3	2	5	1	1	7	0	0
3	35846410	.	A	T	4	5	9	0	0	9	0	0
3	35846440	.	G	A	3	5	8	0	0	8	0	0
3	35846823	.	A	G	5	8	13	0	1	14	0	0
3	35850254	.	G	A	4	2	6	0	0	6	0	0
3	35858954	.	G	T	1	1	2	0	1	3	0	0
3	36023342	.	T	G	13	25	38	0	0	38	0	0
3	36023455	.	A	G	18	12	30	0	1	31	0	0
3	36023465	.	A	G	18	12	30	0	0	30	0	0
3	36026294	.	C	G	3	23	26	0	20	46	0	0
3	36032241	.	G	A	19	18	37	0	1	38	0	0
3	36038631	.	G	A	19	13	32	0	1	33	0	0
3	36040863	.	A	G	16	17	33	0	2	35	0	0
3	36041017	.	A	C	21	10	31	0	5	36	0	0
3	36125256	.	C	G	0	4	4	0	3	7	0	0
3	36127108	.	G	A	2	2	4	0	0	4	0	0
3	36129027	.	A	T	2	4	6	0	0	6	0	0
3	36131883	.	T	A	7	7	14	0	1	15	0	0
3	36132740	.	T	C	10	4	14	0	1	15	0	0
3	36135084	.	A	G	6	3	9	0	0	9	0	0
3	36135641	.	T	A	5	2	7	0	1	8	0	0
3	36135867	.	A	C	3	2	5	0	0	5	0	0
3	36136609	.	T	C	5	2	7	0	0	7	0	0
3	36143844	.	G	A	2	2	4	0	0	4	0	0
3	36167286	.	T	C	7	9	16	0	0	16	0	0
3	36173633	.	T	C	12	10	22	0	1	24	1	0
3	36174175	.	C	A	17	10	27	0	1	28	0	0
3	36174248	.	C	G	12	12	24	0	1	25	0	0
3	36174276	.	T	C	17	1	18	0	10	28	0	0
3	36184806	.	A	G	7	11	18	0	0	18	0	0
3	36188400	.	A	G	8	11	19	0	1	20	0	0
3	36210030	.	G	A	8	4	12	0	0	12	0	0
3	36229823	.	G	A	10	4	14	0	0	14	0	0
3	36229886	.	A	T	6	5	11	0	2	13	0	0
3	36232218	.	A	G	5	2	7	0	0	7	0	0
3	36232331	.	C	T	4	3	7	0	1	8	0	0
3	36241839	.	T	C	16	4	20	0	1	21	0	0
3	36241938	.	T	C	7	0	7	0	9	16	0	0
3	36242239	.	C	T	0	10	10	0	6	16	0	0
3	36249419	.	G	A	17	9	26	0	1	27	0	0
3	36249476	.	T	A	19	18	37	0	1	38	0	0
3	36249516	.	T	A	18	11	29	0	2	32	1	0
3	36249518	.	A	C	16	12	28	0	3	31	0	0
3	36253186	.	G	A	13	13	26	0	1	27	0	0
3	36255436	.	A	G	11	24	35	0	1	36	0	0
3	36259855	.	T	C	18	11	29	0	3	32	0	0
3	36262799	.	A	C	15	0	15	0	26	41	0	0
3	36263099	.	T	C	12	1	13	0	16	30	1	0
3	36263151	.	A	G	14	22	36	0	1	37	0	0
3	36263163	.	C	T	12	22	34	0	2	36	0	0
3	36263464	.	C	A	12	21	33	0	1	34	0	0
3	36263557	.	A	G	11	16	27	0	3	30	0	0
3	36263563	.	T	A	13	20	33	0	0	33	0	0
3	36263596	.	T	C	7	2	9	0	12	21	0	0
3	36263666	.	T	C	7	0	7	0	6	13	0	0
3	36263824	.	T	C	25	23	48	0	0	48	0	0
3	36263895	.	A	T	9	25	34	0	2	36	0	0
3	36264028	.	T	C	18	0	18	0	18	36	0	0
3	36264204	.	T	G	14	16	30	0	0	30	0	0
3	36264217	.	A	C	13	14	27	0	1	28	0	0
3	36264248	.	T	C	14	9	23	0	4	27	0	0
3	36264498	.	G	A	7	11	18	0	0	18	0	0
3	36264582	.	C	G	11	13	24	0	0	24	0	0
3	36265895	.	C	T	2	13	15	0	17	32	0	0
3	36266137	.	T	A	11	14	25	0	1	26	0	0
3	36266173	.	A	G	15	11	26	0	0	26	0	0
3	36268616	.	A	G	11	10	21	0	0	21	0	0
3	36285177	.	C	A	6	3	9	0	1	10	0	0
3	36291213	.	A	G	10	1	11	0	11	22	0	0
3	36292481	.	G	C	0	5	5	0	14	19	0	0
3	36292657	.	T	C	9	9	18	0	0	18	0	0
3	36293950	.	C	T	9	5	14	0	2	16	0	0
3	36293964	.	C	T	13	7	20	0	0	20	0	0
3	36305854	.	A	G	24	17	41	0	1	42	0	0
3	36305860	.	A	G	22	2	24	0	18	42	0	0
3	36305971	.	T	A	4	15	19	0	1	20	0	0
3	36323001	.	T	C	3	2	5	0	0	5	0	0
3	36323436	.	A	G	2	2	4	0	0	4	0	0
3	36325569	.	T	A	4	2	6	0	1	7	0	0
3	36325648	.	A	T	6	3	9	0	0	9	0	0
3	36325726	.	C	T	8	3	11	0	0	11	0	0
3	36325802	.	A	G	3	0	3	0	7	10	0	0
3	36326108	.	A	T	1	6	7	0	0	7	0	0
3	36326139	.	T	G	5	4	9	0	1	10	0	0
3	36326370	.	A	G	4	6	10	0	0	10	0	0
3	36326554	.	G	A	4	3	7	0	0	7	0	0
3	36326681	.	T	C	7	3	10	0	0	10	0	0
3	36326685	.	T	A	7	3	10	0	0	10	0	0
3	36326839	.	T	A	4	4	8	0	0	8	0	0
3	36327060	.	G	A	2	3	5	0	9	14	0	0
3	36327061	.	A	C	9	3	12	0	2	14	0	0
3	36327097	.	C	T	11	3	14	0	0	14	0	0
3	36327129	.	G	A	11	4	15	0	1	16	0	0
3	36327218	.	T	C	10	1	11	1	3	15	0	0
3	36327228	.	T	A	12	2	14	1	0	15	0	0
3	36327260	.	T	C	2	4	6	0	0	6	0	0
3	36327306	.	A	T	3	2	5	0	0	5	0	0
3	36327406	.	G	C	5	0	5	0	1	6	0	0
3	36327414	.	T	A	4	2	6	0	0	6	0	0
3	36327872	.	G	A	5	6	11	0	0	11	0	0
3	36327906	.	G	T	8	5	13	0	0	13	0	0
3	36327909	.	G	T	1	5	6	0	7	13	0	0
3	36328083	.	G	T	5	3	8	0	0	8	0	0
3	36328204	.	C	A	7	5	12	0	2	14	0	0
3	36328218	.	G	A	11	5	16	0	4	20	0	0
3	36328339	.	G	A	3	7	10	0	0	10	0	0
3	36328390	.	A	T	4	5	9	0	0	9	0	0
3	36328414	.	T	A	4	4	8	0	0	8	0	0
3	36407283	.	C	A	7	3	10	0	0	10	0	0
3	36408402	.	G	T	1	2	3	0	0	3	0	0
3	36409721	.	G	A	2	2	4	0	0	4	0	0
3	36409877	.	C	T	2	3	5	0	0	5	0	0
3	36410038	.	T	A	2	2	4	0	0	4	0	0
3	36410172	.	A	G	4	2	6	0	0	6	0	0
3	36414501	.	A	G	1	2	3	0	0	3	0	0
3	36415987	.	A	G	1	2	3	0	0	3	0	0
3	36415999	.	A	C	2	1	3	0	0	3	0	0
3	36428612	.	T	A	17	16	33	0	1	34	0	0
3	36428620	.	T	A	19	14	33	0	0	33	0	0
3	36431380	.	T	C	25	26	51	0	2	53	0	0
3	36441465	.	G	A	6	4	10	0	0	10	0	0
3	36441484	.	T	C	8	5	13	0	1	14	0	0
3	36442551	.	C	T	2	10	12	0	18	30	0	0
3	36442661	.	T	G	8	10	18	0	2	20	0	0
3	36442726	.	A	G	15	14	29	0	1	30	0	0
3	36443189	.	G	A	11	20	31	0	2	33	0	0
3	36446613	.	A	G	11	8	19	0	0	19	0	0
3	36624663	.	A	G	2	2	4	0	0	4	0	0
3	37104617	.	A	G	2	3	5	0	0	5	0	0
3	37104621	.	A	G	3	0	3	0	3	6	0	0
3	37104671	.	A	G	2	2	4	0	0	4	0	0
3	37107093	.	C	T	4	2	6	0	0	6	0	0
3	37558571	.	C	A	2	2	4	0	0	4	0	0
3	37559334	.	A	T	27	31	58	0	1	59	0	0
3	37559905	.	A	C	18	21	39	0	0	39	0	0
3	37564769	.	G	A	23	15	38	0	3	41	0	0
3	37649598	.	G	C	8	4	12	0	0	12	0	0
3	37660307	.	G	A	8	7	15	0	0	15	0	0
3	37660661	.	A	G	9	0	9	0	3	12	0	0
3	37664117	.	A	T	10	11	21	0	0	21	0	0
3	37664635	.	A	G	10	10	20	0	2	22	0	0
3	37665855	.	G	A	24	17	41	0	0	41	0	0
3	37666774	.	C	T	0	13	13	0	20	33	0	0
3	37667562	.	C	T	1	18	19	0	17	36	0	0
3	37667608	.	G	C	20	10	30	0	3	33	0	0
3	37667646	.	C	T	19	12	31	0	1	32	0	0
3	37667952	.	C	T	2	10	12	0	18	30	0	0
3	37668319	.	A	G	8	5	13	0	0	13	0	0
3	37668578	.	T	A	10	4	14	0	2	16	0	0
3	37668667	.	C	A	11	9	20	0	1	21	0	0
3	37670156	.	G	T	5	4	9	0	0	9	0	0
3	37673750	.	T	A	3	6	9	0	1	10	0	0
3	37726111	.	C	T	2	3	5	0	0	5	0	0
3	37727784	.	T	C	2	4	6	0	0	6	0	0
3	37727926	.	C	G	2	6	8	0	0	8	0	0
3	37737680	.	C	A	6	5	11	0	0	11	0	0
3	37737735	.	T	G	4	0	4	0	5	9	0	0
3	37737736	.	C	T	4	5	9	0	0	9	0	0
3	37737852	.	A	G	4	6	10	0	0	10	0	0
3	37738089	.	G	A	3	4	7	0	1	8	0	0
3	37742116	.	A	C	2	3	5	0	0	5	0	0
3	37742152	.	T	C	3	2	5	0	0	5	0	0
3	37742245	.	C	T	4	8	12	0	0	12	0	0
3	37742247	.	A	G	4	7	11	0	1	12	0	0
3	37742284	.	T	G	4	4	8	0	0	8	0	0
3	37742338	.	C	G	1	4	5	0	0	5	0	0
3	37742363	.	C	T	1	2	3	0	0	3	0	0
3	37776713	.	T	C	3	2	5	0	0	5	0	0
3	37777309	.	A	T	4	3	7	0	1	8	0	0
3	37777417	.	G	C	1	5	6	0	1	7	0	0
3	37777590	.	C	T	8	4	12	0	0	12	0	0
3	37777811	.	C	T	0	13	13	0	6	19	0	0
3	37781162	.	A	G	4	6	10	0	0	10	0	0
3	37788401	.	T	C	26	29	55	2	3	60	0	0
3	37789216	.	G	T	4	2	6	0	1	7	0	0
3	37827822	.	C	T	6	3	9	0	1	10	0	0
3	37827948	.	C	T	4	3	7	0	0	7	0	0
3	38505629	.	A	G	10	9	19	0	0	19	0	0
3	38614366	.	C	T	12	9	21	0	1	22	0	0
3	38614426	.	A	G	11	1	12	0	10	22	0	0
3	38614562	.	C	T	16	16	32	0	2	34	0	0
3	38624737	.	A	G	11	1	12	0	13	25	0	0
3	38624823	.	G	A	13	10	23	0	0	23	0	0
3	38625098	.	A	C	21	16	37	0	0	37	0	0
3	38625497	.	G	T	12	14	26	0	0	26	0	0
3	38625559	.	T	C	16	3	19	0	3	22	0	0
3	38625605	.	G	A	21	7	28	0	1	29	0	0
3	38625751	.	A	C	6	7	13	0	0	13	0	0
3	38625901	.	T	G	14	9	23	0	0	23	0	0
3	38649991	.	A	T	12	12	24	0	0	24	0	0
3	38650348	.	T	C	3	16	19	2	1	22	0	0
3	38650440	.	T	C	6	9	15	2	1	18	0	0
3	38650462	.	T	C	9	8	17	2	0	19	0	0
3	38763153	.	T	A	9	8	17	0	1	18	0	0
3	38763391	.	A	G	6	4	10	0	0	10	0	0
3	38763449	.	C	T	2	4	6	0	0	6	0	0
3	38763505	.	G	A	5	3	8	0	0	8	0	0
3	38763527	.	C	T	1	1	2	0	5	7	0	0
3	38763564	.	C	A	1	4	5	0	0	5	0	0
3	38763700	.	G	A	7	7	14	0	1	15	0	0
3	38764227	.	C	T	4	3	7	0	1	8	0	0
3	38764229	.	G	A	4	4	8	0	0	8	0	0
3	38764738	.	A	C	4	0	4	0	7	12	1	0
3	38764990	.	G	T	4	4	8	0	0	8	0	0
3	38765149	.	A	T	4	2	6	0	0	6	0	0
3	38765447	.	T	G	1	0	1	0	0	4	3	0
3	38766207	.	C	T	0	5	5	0	5	10	0	0
3	38766395	.	G	A	4	2	6	0	0	6	0	0
3	38793729	.	G	T	0	2	2	0	3	5	0	0
3	38794422	.	G	C	4	4	8	0	0	8	0	0
3	38858649	.	A	G	2	4	6	0	0	6	0	0
3	38858673	.	C	A	2	5	7	0	0	7	0	0
3	38859066	.	G	A	3	4	7	0	1	8	0	0
3	38859126	.	A	T	2	4	6	0	0	6	0	0
3	39181560	.	A	C	3	2	5	0	1	6	0	0
3	39181635	.	C	T	4	3	7	0	1	8	0	0
3	39181823	.	A	G	1	3	4	0	0	4	0	0
3	39181849	.	A	G	1	5	6	0	0	6	0	0
3	39184156	.	A	G	4	7	11	0	0	11	0	0
3	39184180	.	C	T	4	8	12	0	0	12	0	0
3	39184710	.	A	G	3	4	7	0	0	7	0	0
3	39184883	.	C	T	6	7	13	0	0	13	0	0
3	39189208	.	G	T	5	2	7	1	0	8	0	0
3	39189212	.	A	G	5	2	7	1	0	8	0	0
3	39238579	.	C	A	7	5	12	0	1	13	0	0
3	39238580	.	C	A	8	6	14	0	0	14	0	0
3	39239380	.	A	G	21	19	40	0	1	41	0	0
3	39241350	.	G	T	17	15	32	0	2	34	0	0
3	39248863	.	A	G	11	13	24	0	0	24	0	0
3	39251020	.	G	T	8	4	12	0	0	12	0	0
3	39251341	.	T	C	5	8	13	0	1	14	0	0
3	39259624	.	T	C	11	0	11	0	9	20	0	0
3	39261182	.	C	A	0	3	3	0	2	5	0	0
3	39261709	.	T	C	1	0	1	0	2	3	0	0
3	39261718	.	C	T	1	2	3	0	0	3	0	0
3	39263444	.	T	G	1	3	4	0	0	4	0	0
3	39313310	.	A	G	6	5	11	0	2	13	0	0
3	39313625	.	T	C	4	8	12	0	4	16	0	0
3	39314028	.	C	T	10	15	25	0	1	26	0	0
3	39314101	.	T	C	17	14	31	0	1	32	0	0
3	39314146	.	C	G	14	11	25	0	0	25	0	0
3	39314502	.	G	C	12	8	20	0	0	20	0	0
3	39314631	.	C	T	1	10	11	0	9	20	0	0
3	39314677	.	C	T	8	5	13	0	0	13	0	0
3	39314857	.	G	T	1	2	3	0	0	3	0	0
3	39314893	.	C	A	3	2	5	0	0	5	0	0
3	39314899	.	C	T	3	2	5	0	0	5	0	0
3	39315154	.	C	A	2	6	8	0	0	8	0	0
3	39315169	.	C	G	3	6	9	0	0	9	0	0
3	39315191	.	C	G	3	6	9	0	1	10	0	0
3	39315229	.	A	T	4	2	6	0	0	6	0	0
3	39315292	.	A	G	5	2	7	0	0	7	0	0
3	39315728	.	C	T	3	3	6	0	0	6	0	0
3	39315737	.	T	C	2	2	4	0	0	4	0	0
3	39315816	.	A	G	4	7	11	0	0	11	0	0
3	39315874	.	C	A	7	4	11	0	2	13	0	0
3	39315876	.	C	T	7	6	13	0	0	13	0	0
3	39315937	.	A	C	6	0	6	0	6	12	0	0
3	39316037	.	T	C	5	5	10	0	0	10	0	0
3	39316062	.	G	A	9	3	12	0	0	12	0	0
3	39316167	.	A	G	3	5	8	0	0	8	0	0
3	39316570	.	G	A	3	7	10	0	0	10	0	0
3	39316846	.	T	C	8	8	16	0	1	17	0	0
3	39316906	.	C	A	13	9	22	0	1	23	0	0
3	39316912	.	G	A	13	7	20	0	0	20	0	0
3	39316996	.	A	G	14	14	28	0	0	28	0	0
3	39317215	.	C	G	4	4	8	0	0	8	0	0
3	39317279	.	C	T	2	3	5	0	0	5	0	0
3	39317310	.	T	C	2	4	6	0	0	6	0	0
3	39317370	.	C	T	2	2	4	0	0	4	0	0
3	39322109	.	G	A	4	6	10	0	0	10	0	0
3	39328095	.	G	C	7	5	12	0	0	12	0	0
3	39330407	.	T	C	3	0	3	0	7	10	0	0
3	39348533	.	G	A	3	7	10	0	0	10	0	0
3	39348914	.	G	A	2	3	5	0	0	5	0	0
3	39454708	.	C	G	1	2	3	0	0	3	0	0
3	39560664	.	T	C	1	2	3	0	0	3	0	0
3	39568368	.	T	G	20	15	35	0	2	37	0	0
3	39568856	.	A	G	24	23	47	1	1	49	0	0
3	39574883	.	C	A	34	27	61	0	7	68	0	0
3	39576621	.	T	G	30	3	33	0	39	72	0	0
3	39576663	.	A	G	34	46	80	0	4	84	0	0
3	39576866	.	T	C	23	20	43	0	2	45	0	0
3	39579616	.	C	A	1	3	4	0	0	4	0	0
3	39579660	.	G	T	3	6	9	0	0	9	0	0
3	39580908	.	T	C	1	1	2	0	1	3	0	0
3	39586473	.	A	T	6	4	10	0	0	10	0	0
3	39592797	.	C	T	7	7	14	0	0	14	0	0
3	39592800	.	G	C	0	8	8	0	7	15	0	0
3	39606220	.	C	T	8	10	18	0	0	18	0	0
3	39612261	.	T	A	12	14	26	0	2	29	1	0
3	39612430	.	T	C	15	11	26	0	1	27	0	0
3	39612579	.	G	C	12	9	21	0	0	21	0	0
3	39612715	.	A	T	10	7	17	0	1	18	0	0
3	39613024	.	T	C	20	9	29	0	0	29	0	0
3	39685635	.	G	T	0	3	3	0	2	5	0	0
3	39686776	.	T	A	1	5	6	0	0	6	0	0
3	39686807	.	A	T	2	4	6	0	0	6	0	0
3	39687418	.	C	T	4	5	9	0	1	10	0	0
3	39688892	.	T	C	3	3	6	0	1	7	0	0
3	39688906	.	C	T	4	3	7	0	0	7	0	0
3	39689216	.	T	C	3	3	6	0	0	6	0	0
3	39689234	.	G	T	3	3	6	0	0	6	0	0
3	39691978	.	C	G	2	4	6	0	0	6	0	0
3	39692008	.	G	T	3	4	7	0	0	7	0	0
3	39692165	.	A	T	4	6	10	0	0	10	0	0
3	39692196	.	C	T	0	10	10	0	4	14	0	0
3	39692206	.	C	T	2	7	9	0	3	12	0	0
3	39692235	.	C	A	5	8	13	0	0	14	1	0
3	39692265	.	G	A	8	5	13	0	0	13	0	0
3	39692307	.	A	G	9	6	15	0	0	15	0	0
3	39695744	.	T	C	6	3	9	0	0	9	0	0
3	39876186	.	C	T	1	2	3	0	0	3	0	0
3	39884348	.	G	A	1	2	3	0	3	6	0	0
3	39919127	.	G	A	2	2	4	0	0	4	0	0
3	39925012	.	T	G	2	0	2	0	4	6	0	0
3	39925087	.	T	C	5	5	10	0	0	10	0	0
3	39940210	.	T	C	3	5	8	0	2	10	0	0
3	39945696	.	A	G	11	7	18	0	0	18	0	0
3	39949389	.	G	A	5	10	15	0	0	15	0	0
3	39949650	.	G	A	1	13	14	0	8	22	0	0
3	39950276	.	A	C	10	12	22	0	5	27	0	0
3	39950340	.	C	T	14	6	20	0	1	21	0	0
3	39950414	.	T	C	15	10	25	0	1	26	0	0
3	39950954	.	T	C	6	9	15	0	0	15	0	0
3	39951124	.	C	T	10	9	19	0	0	19	0	0
3	39951216	.	T	C	10	6	16	0	0	16	0	0
3	39951703	.	A	T	7	9	16	0	0	16	0	0
3	39952025	.	T	C	5	7	12	0	1	13	0	0
3	39952272	.	A	G	11	11	22	1	0	23	0	0
3	39952273	.	A	T	12	10	22	1	0	23	0	0
3	39958680	.	C	T	2	4	6	0	0	6	0	0
3	39958729	.	T	A	3	2	5	0	0	5	0	0
3	39959679	.	A	C	9	5	14	0	2	16	0	0
3	39960535	.	G	C	0	5	5	0	2	7	0	0
3	39962906	.	T	G	13	11	24	0	0	24	0	0
3	39962981	.	T	C	6	11	17	0	1	18	0	0
3	39963053	.	T	C	8	6	14	0	0	14	0	0
3	39963089	.	A	G	5	2	7	0	1	8	0	0
3	39963128	.	G	A	3	3	6	0	0	6	0	0
3	39963131	.	A	G	2	3	5	0	0	5	0	0
3	39970555	.	G	A	8	4	12	0	1	13	0	0
3	39970641	.	T	G	10	4	14	0	0	14	0	0
3	39971592	.	T	C	8	6	14	0	0	14	0	0
3	39971894	.	T	C	8	6	14	0	1	15	0	0
3	39972055	.	T	C	2	2	4	0	0	4	0	0
3	39972073	.	G	A	2	3	5	0	0	5	0	0
3	39975467	.	T	C	5	0	5	0	9	14	0	0
3	39982019	.	C	T	4	5	9	0	2	11	0	0
3	39982198	.	A	T	2	3	5	0	1	6	0	0
3	39984581	.	G	A	3	2	5	0	0	5	0	0
3	39990027	.	A	C	1	2	3	0	0	3	0	0
3	40003947	.	T	G	2	4	6	0	0	6	0	0
3	40207086	.	T	C	17	18	35	0	2	37	0	0
3	40256199	.	A	T	2	4	6	0	0	6	0	0
3	40256418	.	C	T	4	4	8	0	0	8	0	0
3	40256734	.	G	A	5	2	7	0	0	7	0	0
3	40256735	.	C	A	4	2	6	0	0	6	0	0
3	40257357	.	A	G	3	0	3	0	3	6	0	0
3	40258465	.	T	C	6	4	10	0	0	10	0	0
3	40278023	.	C	T	1	16	17	0	13	30	0	0
3	40278180	.	T	C	15	0	15	0	12	27	0	0
3	40280034	.	T	C	9	9	18	0	5	23	0	0
3	40284375	.	T	C	6	0	6	0	12	18	0	0
3	40284447	.	T	A	10	10	20	0	1	21	0	0
3	40284823	.	C	A	2	2	4	0	0	4	0	0
3	40284860	.	G	T	9	15	24	0	0	24	0	0
3	40284982	.	T	C	22	12	34	0	2	36	0	0
3	40287185	.	G	C	1	9	10	0	14	24	0	0
3	40287188	.	G	A	14	10	24	0	1	25	0	0
3	40287227	.	C	T	12	8	20	0	4	24	0	0
3	40287538	.	C	T	4	3	7	0	0	7	0	0
3	40287691	.	T	C	3	5	8	0	0	8	0	0
3	40287712	.	T	A	3	5	8	0	0	8	0	0
3	40290123	.	T	C	5	4	9	0	0	9	0	0
3	40290138	.	A	G	4	4	8	0	0	8	0	0
3	40294179	.	G	A	9	13	22	0	0	22	0	0
3	40294260	.	A	T	9	12	21	0	1	22	0	0
3	40294511	.	G	C	8	12	20	0	0	20	0	0
3	40296839	.	C	T	0	3	3	0	1	4	0	0
3	40297428	.	G	A	34	35	69	0	2	71	0	0
3	40297479	.	C	T	32	31	63	0	3	66	0	0
3	40299995	.	G	A	38	37	75	0	2	77	0	0
3	40301233	.	A	G	6	9	15	0	0	15	0	0
3	40315555	.	G	T	5	3	8	0	0	8	0	0
3	40318555	.	C	G	5	3	8	0	0	8	0	0
3	40318556	.	C	G	5	3	8	0	0	8	0	0
3	40318733	.	T	A	4	3	7	0	0	7	0	0
3	40333700	.	A	G	3	0	3	0	3	6	0	0
3	40333793	.	T	C	7	3	10	0	1	11	0	0
3	40346035	.	C	T	17	12	29	0	1	30	0	0
3	40346059	.	T	C	18	12	30	0	0	30	0	0
3	40348839	.	T	C	15	16	31	1	1	33	0	0
3	40349310	.	A	G	13	6	19	0	0	19	0	0
3	40349354	.	T	G	7	4	11	0	0	11	0	0
3	40404688	.	A	T	4	4	8	0	0	8	0	0
3	40430922	.	G	A	1	6	7	0	8	15	0	0
3	40443096	.	C	G	5	3	8	0	0	8	0	0
3	40444020	.	C	T	6	3	9	0	0	9	0	0
3	40444539	.	T	C	4	7	11	0	0	11	0	0
3	40448097	.	A	C	4	5	9	0	1	10	0	0
3	40448130	.	A	G	6	0	6	0	10	16	0	0
3	40448220	.	T	C	2	6	8	0	1	9	0	0
3	40449595	.	C	A	4	8	12	0	0	12	0	0
3	40449603	.	T	C	7	8	15	0	0	15	0	0
3	40449696	.	C	T	9	7	16	0	1	17	0	0
3	40450743	.	C	T	13	8	21	0	0	21	0	0
3	40450961	.	T	G	10	1	11	0	11	22	0	0
3	40451268	.	C	T	11	6	17	0	0	17	0	0
3	40451319	.	T	C	11	6	17	0	0	17	0	0
3	40451352	.	A	T	4	5	9	0	0	9	0	0
3	40451407	.	A	G	3	0	3	0	4	7	0	0
3	40451574	.	A	C	4	3	7	0	0	7	0	0
3	40452119	.	G	C	8	7	15	0	0	15	0	0
3	40452134	.	A	G	10	0	10	0	7	17	0	0
3	40458531	.	C	A	10	3	13	0	0	13	0	0
3	40458594	.	G	A	4	13	17	0	7	24	0	0
3	40467464	.	C	T	7	5	12	1	1	14	0	0
3	40467486	.	G	A	0	9	9	0	4	13	0	0
3	40467693	.	A	G	10	0	10	0	7	17	0	0
3	40467756	.	C	T	11	6	17	0	3	20	0	0
3	40469891	.	T	C	7	12	19	0	2	21	0	0
3	40480877	.	G	A	1	15	16	0	8	24	0	0
3	40480986	.	G	T	7	16	23	0	3	26	0	0
3	40481346	.	G	A	2	12	14	0	13	27	0	0
3	40481459	.	C	T	10	16	26	0	0	26	0	0
3	40481513	.	A	G	10	4	14	0	1	15	0	0
3	40481649	.	T	G	9	5	14	0	0	14	0	0
3	40481930	.	T	A	12	14	26	0	0	26	0	0
3	40482007	.	T	C	18	10	28	0	2	30	0	0
3	40482027	.	A	G	18	0	18	0	11	29	0	0
3	40482289	.	C	A	16	20	36	1	2	39	0	0
3	40482446	.	A	G	18	10	28	0	5	33	0	0
3	40484376	.	A	T	14	14	28	0	1	29	0	0
3	40485360	.	C	A	14	11	25	0	0	25	0	0
3	40485378	.	T	G	12	8	20	0	0	20	0	0
3	40485422	.	G	T	2	17	19	0	11	30	0	0
3	40485499	.	G	A	19	15	34	0	2	36	0	0
3	40485965	.	G	C	14	4	18	0	0	18	0	0
3	40487095	.	G	T	15	19	34	0	1	35	0	0
3	40487162	.	A	C	15	7	22	0	0	22	0	0
3	40487385	.	T	A	14	11	25	0	1	26	0	0
3	40487704	.	T	C	30	8	38	2	3	43	0	0
3	40487820	.	A	G	22	17	39	0	0	39	0	0
3	40487821	.	G	C	21	16	37	0	2	39	0	0
3	40488212	.	C	T	18	13	31	0	2	33	0	0
3	40488264	.	C	T	7	24	31	0	17	48	0	0
3	40527028	.	G	A	40	41	81	0	3	84	0	0
3	40527512	.	G	A	38	34	72	1	5	78	0	0
3	40527575	.	G	A	48	46	94	4	15	113	0	0
3	40527665	.	A	G	19	5	24	0	1	25	0	0
3	40527727	.	G	A	13	10	23	0	0	23	0	0
3	40528241	.	A	T	48	25	73	0	2	75	0	0
3	40576600	.	C	T	23	20	43	0	2	45	0	0
3	40576736	.	C	T	16	16	32	0	0	32	0	0
3	40576972	.	A	G	16	0	16	0	25	41	0	0
3	40577032	.	C	T	23	15	38	0	0	38	0	0
3	40583989	.	C	G	21	21	42	0	1	43	0	0
3	40584318	.	T	A	20	24	44	0	1	45	0	0
3	40587967	.	C	T	23	29	52	0	2	54	0	0
3	40588109	.	A	T	28	28	56	0	2	58	0	0
3	40588195	.	T	C	21	30	51	0	2	53	0	0
3	40588363	.	C	T	27	23	50	0	2	52	0	0
3	40588410	.	C	A	35	24	59	0	1	60	0	0
3	40588467	.	T	C	26	19	45	0	2	47	0	0
3	40588595	.	A	C	27	18	45	0	0	45	0	0
3	40588746	.	C	G	18	23	41	0	1	42	0	0
3	40588845	.	A	G	23	15	38	0	3	41	0	0
3	40589147	.	T	C	34	24	58	0	3	61	0	0
3	40589179	.	C	A	35	25	60	0	3	63	0	0
3	40589191	.	T	G	40	24	64	0	1	65	0	0
3	40589214	.	C	A	34	27	61	0	1	62	0	0
3	40589232	.	A	G	30	29	59	0	0	59	0	0
3	40589266	.	C	T	20	29	49	0	0	49	0	0
3	40589348	.	A	G	21	19	40	0	2	42	0	0
3	40589356	.	A	G	21	21	42	0	1	43	0	0
3	40656338	.	A	G	2	3	5	0	1	6	0	0
3	40656368	.	T	C	1	3	4	0	0	4	0	0
3	40690704	.	T	C	10	0	10	0	10	20	0	0
3	40690901	.	G	A	4	6	10	0	1	11	0	0
3	40691448	.	A	G	7	8	15	0	0	15	0	0
3	40691473	.	A	T	11	6	17	0	1	18	0	0
3	40691643	.	A	T	6	6	12	0	0	12	0	0
3	40691792	.	T	C	6	1	7	0	3	10	0	0
3	40691969	.	C	T	11	4	15	0	1	16	0	0
3	40692064	.	A	T	10	8	18	0	0	18	0	0
3	40698424	.	C	A	9	6	15	1	0	16	0	0
3	40698481	.	A	G	5	5	10	0	0	10	0	0
3	40712935	.	G	A	5	4	9	0	2	11	0	0
3	40713085	.	G	T	9	3	12	0	2	14	0	0
3	40715629	.	T	C	2	2	4	0	0	4	0	0
3	40768371	.	A	T	3	2	5	1	0	6	0	0
3	40804287	.	T	G	35	2	37	2	6	46	1	0
3	40819959	.	A	C	1	3	4	0	0	4	0	0
3	40820007	.	A	G	1	3	4	0	0	4	0	0
3	40821838	.	C	A	14	8	22	0	1	23	0	0
3	40821871	.	A	T	18	12	30	0	2	32	0	0
3	40821953	.	C	A	1	14	15	0	17	32	0	0
3	40828768	.	T	C	17	0	17	0	7	24	0	0
3	40876757	.	G	A	8	3	11	0	0	11	0	0
3	40881515	.	C	T	1	2	3	0	0	3	0	0
3	40882964	.	A	T	4	4	8	0	0	8	0	0
3	40885949	.	A	G	1	2	3	0	0	3	0	0
3	40902163	.	C	T	1	8	9	1	4	14	0	0
3	40907953	.	T	C	5	0	5	0	5	10	0	0
3	40913730	.	G	A	8	7	15	0	0	15	0	0
3	40927653	.	C	T	6	5	11	0	1	12	0	0
3	40933029	.	A	C	1	3	4	0	0	5	1	0
3	40969547	.	C	T	0	3	3	0	1	4	0	0
3	40974632	.	G	A	1	2	3	0	0	3	0	0
3	40979281	.	T	C	3	3	6	0	0	6	0	0
3	40979791	.	G	C	16	5	21	0	0	21	0	0
3	40980024	.	G	A	5	7	12	0	0	12	0	0
3	40980166	.	T	A	14	12	26	0	0	26	0	0
3	40983077	.	G	A	11	5	16	0	1	17	0	0
3	40985992	.	T	C	9	5	14	0	2	16	0	0
3	41003413	.	G	A	5	4	9	0	1	10	0	0
3	41023331	.	G	A	6	4	10	0	0	10	0	0
3	41030861	.	T	G	3	4	7	0	0	7	0	0
3	41047649	.	C	T	1	2	3	0	0	3	0	0
3	41086781	.	T	C	4	2	6	0	0	6	0	0
3	41092137	.	A	T	2	3	5	0	0	5	0	0
3	41705027	.	T	C	1	2	3	0	0	3	0	0
3	41705031	.	G	A	1	2	3	0	0	3	0	0
3	41705468	.	A	T	1	2	3	0	0	3	0	0
3	41705476	.	C	T	1	2	3	0	0	3	0	0
3	41705560	.	A	G	5	4	9	0	1	10	0	0
3	41705597	.	C	T	6	3	9	0	0	9	0	0
3	41719049	.	G	A	12	6	18	0	3	21	0	0
3	41721916	.	G	A	18	9	27	0	2	29	0	0
3	41723437	.	G	A	15	15	30	0	0	30	0	0
3	41724806	.	G	A	17	11	28	0	1	29	0	0
3	41917608	.	G	T	3	2	5	0	0	5	0	0
3	41917830	.	T	C	2	2	4	0	0	4	0	0
3	41922766	.	A	G	1	0	1	0	2	3	0	0
3	41923195	.	T	C	1	4	5	0	0	5	0	0
3	41923288	.	C	T	3	2	5	0	0	5	0	0
3	41925823	.	C	T	6	3	9	0	0	9	0	0
3	41925889	.	T	C	1	3	4	0	0	4	0	0
3	41926020	.	T	A	2	3	5	0	0	5	0	0
3	41926557	.	G	A	2	2	4	0	0	4	0	0
3	41926633	.	T	A	1	5	6	0	0	6	0	0
3	41955526	.	C	T	2	4	6	0	0	6	0	0
3	41955613	.	G	T	18	9	27	0	2	29	0	0
3	41955911	.	C	G	16	12	28	0	1	29	0	0
3	41956040	.	G	T	9	15	24	0	6	30	0	0
3	41956299	.	T	C	8	11	19	0	1	20	0	0
3	41956353	.	T	A	6	10	16	0	0	16	0	0
3	41956467	.	T	A	4	6	10	0	2	12	0	0
3	41956504	.	C	T	5	4	9	0	0	9	0	0
3	41956792	.	A	T	10	8	18	0	2	20	0	0
3	41956818	.	T	C	7	10	17	0	0	17	0	0
3	41956837	.	T	G	5	11	16	0	0	16	0	0
3	41956855	.	C	T	5	10	15	0	0	15	0	0
3	41956921	.	T	A	4	4	8	0	1	9	0	0
3	41956941	.	T	C	5	6	11	0	0	11	0	0
3	41956978	.	G	A	7	7	14	0	1	15	0	0
3	41957580	.	G	T	2	4	6	0	0	6	0	0
3	41957660	.	A	T	2	4	6	0	0	6	0	0
3	41957918	.	T	G	4	1	5	0	0	5	0	0
3	41957924	.	C	T	1	2	3	0	3	6	0	0
3	41958291	.	T	G	3	3	6	0	0	6	0	0
3	41959370	.	G	T	4	15	19	0	0	19	0	0
3	41959658	.	G	T	8	6	14	0	0	14	0	0
3	41959772	.	A	G	9	6	15	0	0	15	0	0
3	41959906	.	T	A	2	4	6	0	0	6	0	0
3	41959943	.	T	C	1	2	3	0	2	5	0	0
3	41959958	.	A	G	3	4	7	0	0	7	0	0
3	41960005	.	C	A	9	7	16	0	0	16	0	0
3	41960162	.	G	A	5	2	7	0	0	7	0	0
3	41960164	.	A	G	5	2	7	0	0	7	0	0
3	41960346	.	A	G	3	7	10	0	0	10	0	0
3	41960462	.	T	A	1	2	3	0	0	3	0	0
3	41961314	.	G	A	4	7	11	0	1	12	0	0
3	41961341	.	T	G	3	6	9	0	1	10	0	0
3	41961469	.	A	G	1	7	8	0	0	8	0	0
3	41961558	.	A	T	6	6	12	0	2	14	0	0
3	41961587	.	T	G	4	5	9	0	1	10	0	0
3	41961651	.	G	A	3	14	17	0	1	18	0	0
3	41961688	.	T	C	3	0	3	0	14	17	0	0
3	41961993	.	C	G	0	3	3	0	5	8	0	0
3	41962098	.	T	C	4	3	7	0	0	7	0	0
3	41962463	.	G	A	2	2	4	0	0	4	0	0
3	41985866	.	G	A	2	4	6	0	0	6	0	0
3	41985953	.	C	T	1	3	4	0	1	5	0	0
3	41985959	.	G	A	2	4	6	0	0	6	0	0
3	42016675	.	A	T	3	3	6	0	0	6	0	0
3	42016682	.	C	G	0	3	3	0	3	6	0	0
3	42126782	.	A	G	2	0	2	0	2	4	0	0
3	42918924	.	C	A	12	6	18	0	3	21	0	0
3	42919474	.	C	T	8	10	18	0	0	18	0	0
3	42919510	.	C	T	10	2	12	0	4	16	0	0
3	42919664	.	C	T	10	4	14	0	2	16	0	0
3	42919846	.	T	G	6	5	11	0	0	11	0	0
3	42919849	.	C	T	6	5	11	0	0	11	0	0
3	42919881	.	C	T	3	3	6	0	0	6	0	0
3	43011376	.	C	T	1	2	3	0	0	3	0	0
3	43014396	.	T	C	4	1	5	0	1	6	0	0
3	43017912	.	T	C	4	1	5	0	1	6	0	0
3	43018005	.	C	T	1	3	4	0	0	4	0	0
3	43038222	.	G	A	2	2	4	0	0	4	0	0
3	43039306	.	A	G	6	6	12	0	0	12	0	0
3	43039479	.	C	T	3	5	8	0	0	8	0	0
3	43040677	.	G	A	1	3	4	0	2	6	0	0
3	43052230	.	T	C	5	6	11	0	2	13	0	0
3	43059090	.	A	G	5	7	12	0	2	14	0	0
3	43059153	.	A	G	7	10	17	0	0	17	0	0
3	43060866	.	T	C	2	3	5	0	0	5	0	0
3	43376543	.	A	G	5	8	13	0	1	14	0	0
3	43380283	.	C	T	6	3	9	0	0	9	0	0
3	43392755	.	T	A	5	12	17	0	0	17	0	0
3	43392795	.	C	A	4	5	9	0	1	10	0	0
3	43467654	.	T	C	1	3	4	0	0	4	0	0
3	43467730	.	C	T	6	2	8	0	0	8	0	0
3	43475265	.	G	A	4	4	8	0	1	9	0	0
3	43475325	.	A	G	9	4	13	0	2	15	0	0
3	43475376	.	T	C	7	5	12	0	0	12	0	0
3	43475397	.	C	T	5	4	9	0	0	9	0	0
3	43475592	.	A	C	4	6	10	0	0	10	0	0
3	43475617	.	G	T	0	4	4	0	2	6	0	0
3	43475654	.	C	T	5	4	9	0	0	9	0	0
3	43475742	.	G	T	4	4	8	0	0	8	0	0
3	43475772	.	A	G	6	2	8	0	0	8	0	0
3	43476411	.	A	T	6	3	9	0	0	9	0	0
3	43476435	.	G	T	6	5	11	0	0	11	0	0
3	43476514	.	A	C	8	5	13	0	2	15	0	0
3	43476698	.	A	G	4	7	11	0	2	13	0	0
3	43477255	.	T	A	5	2	7	0	0	7	0	0
3	43477705	.	T	A	4	4	8	0	2	10	0	0
3	43478137	.	T	C	7	9	16	0	1	17	0	0
3	43478238	.	C	T	7	10	17	0	1	18	0	0
3	43478310	.	T	G	16	5	21	0	0	21	0	0
3	43478321	.	A	G	13	0	13	0	5	18	0	0
3	43478433	.	A	T	6	3	9	0	0	9	0	0
3	43478586	.	C	T	3	4	7	0	0	7	0	0
3	43579820	.	C	T	3	5	8	1	12	21	0	0
3	43580055	.	A	G	11	11	22	0	1	23	0	0
3	43580195	.	A	T	11	7	18	0	0	18	0	0
3	43580583	.	T	C	5	14	19	0	0	19	0	0
3	43581272	.	A	C	10	12	22	0	0	22	0	0
3	43584423	.	T	C	7	2	9	0	11	20	0	0
3	43584453	.	T	C	12	5	17	0	1	18	0	0
3	43594256	.	A	G	10	12	22	0	1	23	0	0
3	43594358	.	C	T	10	8	18	0	0	18	0	0
3	43594376	.	C	T	3	7	10	0	6	16	0	0
3	43594577	.	G	A	10	5	15	0	0	15	0	0
3	43594655	.	C	T	1	5	6	0	4	10	0	0
3	43594658	.	G	A	4	4	8	0	1	9	0	0
3	43594735	.	T	C	9	5	14	0	0	14	0	0
3	43600999	.	C	T	1	5	6	0	8	14	0	0
3	43645900	.	G	C	6	6	12	0	0	12	0	0
3	43646161	.	A	G	6	5	11	0	0	11	0	0
3	43646362	.	C	T	0	5	5	0	2	7	0	0
3	43711455	.	A	T	1	2	3	0	0	3	0	0
3	43774440	.	C	A	5	4	9	0	0	9	0	0
3	43776859	.	T	C	3	4	7	0	0	7	0	0
3	43785646	.	A	T	3	3	6	0	0	6	0	0
3	43791284	.	T	C	6	7	13	0	0	13	0	0
3	43791317	.	G	A	9	6	15	0	0	15	0	0
3	43793273	.	G	A	3	3	6	0	0	6	0	0
3	43793389	.	T	C	3	2	5	0	0	5	0	0
3	43796956	.	T	G	3	0	3	1	4	8	0	0
3	43797073	.	C	T	5	7	12	0	0	12	0	0
3	43801338	.	C	T	14	12	26	0	1	27	0	0
3	43807512	.	T	C	5	4	9	0	0	9	0	0
3	43807921	.	C	A	11	14	25	0	2	27	0	0
3	43807945	.	T	A	11	10	21	0	0	23	2	0
3	43814607	.	C	T	9	8	17	0	0	17	0	0
3	43821273	.	G	T	8	12	20	0	0	20	0	0
3	43821328	.	A	G	7	5	12	0	0	12	0	0
3	43829154	.	G	C	1	7	8	0	1	9	0	0
3	43829179	.	G	C	3	5	8	0	0	8	0	0
3	43829370	.	A	C	2	4	6	0	0	6	0	0
3	43829712	.	G	A	1	5	6	0	2	8	0	0
3	43829792	.	C	A	1	2	3	0	0	3	0	0
3	43942053	.	A	C	3	2	5	0	0	5	0	0
3	43944611	.	A	G	7	6	13	0	0	13	0	0
3	43953883	.	T	C	13	1	14	0	5	19	0	0
3	43985795	.	T	A	1	2	3	0	0	3	0	0
3	43985815	.	G	T	0	2	2	0	2	4	0	0
3	43986522	.	G	T	2	2	4	0	0	4	0	0
3	43986937	.	G	A	0	2	2	0	3	5	0	0
3	43986982	.	G	A	3	2	5	0	0	5	0	0
3	43987032	.	T	C	5	2	7	0	0	7	0	0
3	44076950	.	C	G	2	1	3	0	5	8	0	0
3	44077429	.	A	C	2	3	5	0	0	5	0	0
3	44077508	.	C	T	4	3	7	0	0	7	0	0
3	44081793	.	G	A	1	3	4	0	0	4	0	0
3	44082200	.	A	G	2	3	5	0	0	5	0	0
3	44089225	.	T	G	2	3	5	0	0	5	0	0
3	44093661	.	T	C	1	0	1	0	2	3	0	0
3	44541766	.	C	T	0	2	2	0	2	4	0	0
3	44541955	.	C	A	4	5	9	0	0	9	0	0
3	45284329	.	T	C	3	5	8	0	0	8	0	0
3	45284332	.	T	C	5	2	7	0	1	8	0	0
3	45284618	.	T	C	9	5	14	5	0	19	0	0
3	45714552	.	C	T	3	2	5	0	0	5	0	0
3	45714945	.	T	C	1	3	4	0	0	4	0	0
3	45715655	.	A	G	2	5	7	0	2	9	0	0
3	45715716	.	C	T	4	6	10	0	0	10	0	0
3	45716766	.	A	G	3	0	3	0	4	7	0	0
3	45717180	.	C	T	5	4	9	0	3	12	0	0
3	45776520	.	T	C	16	0	16	0	25	41	0	0
3	45776721	.	T	C	25	34	59	0	1	60	0	0
3	45778103	.	T	A	2	5	7	0	0	7	0	0
3	45814062	.	A	T	1	2	3	0	0	3	0	0
3	45814631	.	A	T	7	5	12	0	0	12	0	0
3	45816004	.	C	T	4	3	7	0	0	7	0	0
3	45816549	.	A	G	5	5	10	0	1	11	0	0
3	45816618	.	T	C	8	11	19	0	0	19	0	0
3	45817571	.	G	T	4	7	11	0	2	13	0	0
3	45817572	.	T	G	6	3	9	0	3	12	0	0
3	46043918	.	T	A	1	2	3	0	0	3	0	0
3	46044190	.	G	T	2	2	4	0	0	4	0	0
3	46114398	.	A	G	1	2	3	0	0	3	0	0
3	46114458	.	C	T	0	3	3	0	3	6	0	0
3	46114491	.	C	A	2	2	4	0	0	4	0	0
3	46353747	.	C	A	2	2	4	0	0	4	0	0
3	46354031	.	C	T	3	3	6	0	0	6	0	0
3	46354217	.	A	G	4	4	8	0	0	8	0	0
3	46354230	.	G	A	4	4	8	0	0	8	0	0
3	46358537	.	A	G	5	0	5	0	5	10	0	0
3	46362640	.	C	T	1	4	5	0	1	6	0	0
3	46362844	.	C	G	1	0	1	0	2	3	0	0
3	46363127	.	G	A	1	2	3	0	1	4	0	0
3	46364053	.	A	C	3	5	8	0	0	8	0	0
3	46364065	.	C	T	2	6	8	0	0	8	0	0
3	46364654	.	G	A	0	2	2	0	3	5	0	0
3	46364788	.	T	A	2	2	4	0	0	4	0	0
3	46365323	.	G	A	0	2	2	0	1	3	0	0
3	46377497	.	A	T	4	5	9	0	0	9	0	0
3	46377528	.	C	A	5	5	10	0	1	11	0	0
3	46379820	.	A	G	4	3	7	0	0	7	0	0
3	46379849	.	C	G	4	2	6	0	0	6	0	0
3	46380144	.	A	C	3	4	7	0	0	7	0	0
3	46380189	.	A	G	7	10	17	0	1	18	0	0
3	46380194	.	T	A	8	11	19	0	1	20	0	0
3	46388058	.	C	T	8	7	15	0	1	16	0	0
3	46388487	.	A	C	3	7	10	0	0	10	0	0
3	46388490	.	T	A	2	7	9	0	2	11	0	0
3	46388636	.	T	C	6	4	10	0	0	10	0	0
3	46388711	.	C	T	1	7	8	0	0	8	0	0
3	46388854	.	T	C	13	4	17	0	1	18	0	0
3	46388905	.	G	A	7	8	15	0	0	15	0	0
3	46388954	.	A	C	7	6	13	0	2	15	0	0
3	46388968	.	G	C	7	6	13	0	0	13	0	0
3	46389009	.	C	T	12	9	21	0	0	21	0	0
3	46391844	.	C	T	1	10	11	0	8	19	0	0
3	46398380	.	G	A	6	7	13	0	0	13	0	0
3	46403743	.	C	T	2	5	7	0	9	16	0	0
3	46410288	.	T	C	8	5	13	0	0	13	0	0
3	46463156	.	C	T	1	2	3	0	0	3	0	0
3	46463213	.	A	C	1	4	5	1	0	6	0	0
3	46463240	.	C	T	2	5	7	1	0	8	0	0
3	46473247	.	G	C	0	3	3	0	1	4	0	0
3	46473292	.	G	A	5	3	8	0	0	8	0	0
3	46502666	.	T	C	2	2	4	0	0	4	0	0
3	46512161	.	T	A	1	2	3	0	0	3	0	0
3	46512175	.	G	C	1	2	3	0	1	4	0	0
3	46528871	.	T	C	1	2	3	0	0	3	0	0
3	46550242	.	T	C	2	2	4	0	0	4	0	0
3	46551189	.	G	A	5	4	9	0	0	9	0	0
3	46552775	.	G	A	3	1	4	0	1	5	0	0
3	46552832	.	A	C	6	4	10	0	0	10	0	0
3	46552993	.	A	G	6	8	14	0	0	14	0	0
3	46553206	.	T	G	5	7	12	0	0	12	0	0
3	46553234	.	G	C	6	3	9	0	0	9	0	0
3	46553534	.	C	T	7	4	11	0	0	11	0	0
3	46553540	.	C	A	7	4	11	0	0	11	0	0
3	46553677	.	T	C	3	3	6	0	0	6	0	0
3	46553678	.	A	T	3	3	6	0	0	6	0	0
3	46553720	.	C	A	1	5	6	0	0	6	0	0
3	46553850	.	A	C	8	3	11	0	4	15	0	0
3	46553893	.	T	C	13	6	19	0	1	20	0	0
3	46553986	.	A	T	6	7	13	0	0	13	0	0
3	46554085	.	G	T	3	3	6	0	0	6	0	0
3	46554177	.	C	A	10	6	16	0	2	18	0	0
3	46554181	.	C	A	7	11	18	0	0	18	0	0
3	46554458	.	G	T	2	6	8	0	0	8	0	0
3	46554564	.	A	G	11	5	16	0	3	19	0	0
3	46554648	.	T	A	8	7	15	3	1	19	0	0
3	46554711	.	G	A	11	6	17	0	1	18	0	0
3	46749479	.	A	G	8	6	14	0	0	14	0	0
3	46750272	.	C	T	11	11	22	0	1	23	0	0
3	46750752	.	G	A	14	12	26	0	4	31	1	0
3	46750996	.	C	T	11	5	16	0	1	17	0	0
3	46751630	.	G	A	9	5	14	0	1	15	0	0
3	46752486	.	A	C	8	12	20	0	0	20	0	0
3	46752522	.	T	G	3	4	7	1	0	8	0	0
3	46753340	.	T	G	7	0	7	0	1	9	1	0
3	46753613	.	T	C	5	5	10	0	0	10	0	0
3	46753619	.	G	A	6	4	10	0	2	12	0	0
3	46753742	.	A	G	15	0	15	0	10	25	0	0
3	46754078	.	T	A	11	31	42	0	2	45	1	0
3	46754296	.	A	T	5	6	11	0	0	11	0	0
3	46764485	.	A	T	7	5	12	0	1	13	0	0
3	46764572	.	A	T	9	9	18	0	3	21	0	0
3	46767646	.	T	C	5	5	10	1	0	11	0	0
3	46778789	.	G	T	16	14	30	0	1	31	0	0
3	46795013	.	G	T	4	2	6	0	0	6	0	0
3	46795113	.	G	T	0	4	4	0	0	4	0	0
3	46795118	.	G	T	5	3	8	0	0	8	0	0
3	46800490	.	A	T	39	27	66	0	5	71	0	0
3	46800692	.	G	A	25	26	51	0	7	58	0	0
3	46800741	.	T	C	14	0	14	1	17	32	0	0
3	46800743	.	T	C	17	0	17	1	17	35	0	0
3	46800940	.	C	T	36	20	56	1	3	60	0	0
3	46800946	.	T	G	34	21	55	1	2	58	0	0
3	46802227	.	T	C	28	1	29	0	19	48	0	0
3	46923471	.	T	C	5	2	7	0	0	7	0	0
3	46923509	.	G	A	2	2	4	0	0	4	0	0
3	46925154	.	G	A	3	4	7	0	0	7	0	0
3	46925227	.	A	G	3	2	5	0	0	5	0	0
3	46932509	.	C	T	0	3	3	0	2	5	0	0
3	47114407	.	T	A	2	2	4	0	1	5	0	0
3	47114573	.	A	G	3	7	10	0	0	10	0	0
3	47114734	.	A	G	7	3	10	0	0	10	0	0
3	47114746	.	G	A	7	4	11	0	1	12	0	0
3	47119900	.	G	A	3	5	8	0	0	8	0	0
3	47119964	.	C	T	2	2	4	0	4	8	0	0
3	47125636	.	T	A	1	3	4	0	1	5	0	0
3	47125693	.	G	A	2	6	8	0	0	8	0	0
3	47125771	.	T	C	3	4	7	0	0	7	0	0
3	47164580	.	C	T	2	2	4	0	0	4	0	0
3	47173202	.	C	T	1	4	5	0	0	5	0	0
3	47173208	.	C	T	3	3	6	0	0	6	0	0
3	47198805	.	G	A	6	10	16	0	0	16	0	0
3	47201409	.	C	T	3	5	8	0	0	8	0	0
3	47201440	.	A	G	6	4	10	0	0	10	0	0
3	47205408	.	C	T	6	8	14	0	0	14	0	0
3	47205417	.	A	G	10	0	10	0	6	16	0	0
3	47205507	.	G	A	11	6	17	0	2	19	0	0
3	47205534	.	A	G	6	0	6	0	12	18	0	0
3	47205543	.	C	T	8	5	13	0	2	15	0	0
3	47205585	.	A	T	8	6	14	0	1	15	0	0
3	47205597	.	C	T	6	9	15	0	0	15	0	0
3	47209433	.	T	C	15	11	26	0	0	26	0	0
3	47209445	.	A	T	9	11	20	0	4	24	0	0
3	47212774	.	T	C	3	3	6	0	0	6	0	0
3	47212790	.	A	G	2	0	2	0	3	5	0	0
3	47212896	.	A	T	3	5	8	0	0	8	0	0
3	47212914	.	T	C	3	5	8	0	0	8	0	0
3	47213009	.	A	T	4	4	8	0	0	8	0	0
3	47213025	.	G	T	1	3	4	0	1	5	0	0
3	47213046	.	G	A	3	4	7	0	0	7	0	0
3	47213067	.	C	G	5	4	9	0	0	9	0	0
3	47384653	.	T	C	2	2	4	0	0	4	0	0
3	47498493	.	C	T	1	2	3	0	3	6	0	0
3	47498565	.	A	T	4	3	7	0	1	9	1	0
3	47498625	.	C	A	9	3	12	0	0	12	0	0
3	47498633	.	G	A	10	3	13	0	0	13	0	0
3	47498937	.	G	C	3	2	5	0	1	6	0	0
3	47498985	.	C	T	1	3	4	0	0	4	0	0
3	47526262	.	C	T	2	2	4	0	0	4	0	0
3	47526271	.	G	A	3	2	5	0	0	5	0	0
3	47529406	.	G	A	4	3	7	0	0	7	0	0
3	47529469	.	T	G	1	2	3	0	0	3	0	0
3	47550275	.	C	T	0	2	2	0	0	2	0	0
3	47550282	.	G	A	2	2	4	0	0	4	0	0
3	47554609	.	A	C	4	3	7	0	0	7	0	0
3	48226259	.	G	A	1	3	4	0	1	5	0	0
3	48229390	.	A	G	2	0	2	0	6	8	0	0
3	48229423	.	C	T	1	4	5	0	0	5	0	0
3	48229654	.	C	T	2	2	4	0	0	4	0	0
3	48229928	.	T	G	2	1	3	0	1	4	0	0
3	48229929	.	C	T	2	2	4	0	0	4	0	0
3	48244963	.	G	A	0	3	3	0	4	7	0	0
3	48247601	.	A	G	2	3	5	0	0	5	0	0
3	48253673	.	C	T	4	3	7	0	0	7	0	0
3	48278752	.	C	T	4	3	7	0	0	7	0	0
3	48283768	.	C	A	1	3	4	0	0	4	0	0
3	48286490	.	C	T	2	3	5	0	1	6	0	0
3	48286514	.	T	C	2	4	6	0	0	6	0	0
3	48301180	.	A	G	6	7	13	0	0	13	0	0
3	48305837	.	C	G	11	5	16	0	0	16	0	0
3	48305841	.	G	A	1	11	12	0	4	16	0	0
3	48305898	.	C	G	9	4	13	0	2	15	0	0
3	48305908	.	C	A	9	3	12	0	1	13	0	0
3	48320968	.	A	G	2	8	10	0	0	10	0	0
3	48326568	.	G	A	8	4	12	0	0	12	0	0
3	48326631	.	C	T	4	6	10	0	1	11	0	0
3	48473546	.	C	A	2	2	4	0	0	4	0	0
3	48473565	.	A	G	4	5	9	0	0	9	0	0
3	48479982	.	C	T	4	2	6	0	1	7	0	0
3	48480333	.	T	C	7	5	12	0	1	13	0	0
3	48486609	.	C	T	5	7	12	0	1	13	0	0
3	48488993	.	T	C	10	7	17	0	1	18	0	0
3	48489101	.	C	G	6	0	6	0	11	17	0	0
3	48489154	.	A	G	3	0	3	1	8	12	0	0
3	48550676	.	G	A	22	23	45	0	1	46	0	0
3	48557707	.	T	C	19	2	21	0	37	58	0	0
3	48584800	.	A	T	3	11	14	0	0	14	0	0
3	48585222	.	C	T	1	14	15	0	16	31	0	0
3	48585236	.	C	A	20	13	33	0	2	35	0	0
3	48585271	.	A	C	20	13	33	0	3	36	0	0
3	48585331	.	A	G	28	9	37	1	0	38	0	0
3	48585377	.	G	T	20	10	30	1	0	31	0	0
3	48585411	.	G	T	21	9	30	0	1	31	0	0
3	48586985	.	A	G	12	13	25	0	0	25	0	0
3	48587176	.	C	A	11	13	24	0	0	24	0	0
3	48587191	.	C	T	16	9	25	0	1	26	0	0
3	48588830	.	A	G	17	13	30	0	1	31	0	0
3	48588884	.	A	G	12	13	25	0	0	25	0	0
3	48591769	.	A	G	5	12	17	0	1	18	0	0
3	48591825	.	G	T	6	10	16	0	1	17	0	0
3	48593781	.	T	C	14	12	26	0	1	27	0	0
3	48593811	.	G	A	12	9	21	0	1	22	0	0
3	48594098	.	T	C	8	0	8	0	12	20	0	0
3	48596834	.	T	C	10	7	17	0	1	18	0	0
3	48612027	.	T	C	5	0	5	0	12	17	0	0
3	48612038	.	A	G	5	7	12	0	1	13	0	0
3	48638932	.	C	T	2	2	4	0	0	4	0	0
3	48645801	.	G	T	5	5	10	0	1	11	0	0
3	48661465	.	C	A	1	5	6	0	4	10	0	0
3	48661500	.	A	G	6	9	15	0	0	15	0	0
3	48661700	.	G	A	1	5	6	0	0	6	0	0
3	48665832	.	T	A	7	3	10	0	0	10	0	0
3	48665841	.	T	G	7	3	10	0	0	10	0	0
3	48686990	.	G	A	5	5	10	0	0	10	0	0
3	48687134	.	C	T	1	4	5	0	2	7	0	0
3	48691411	.	A	G	5	2	7	0	0	7	0	0
3	48700453	.	G	A	1	2	3	0	0	3	0	0
3	48704848	.	G	A	2	2	4	0	0	4	0	0
3	49130387	.	A	C	2	0	2	0	6	8	0	0
3	49134236	.	A	C	3	3	6	0	0	6	0	0
3	49134373	.	A	G	2	2	4	0	0	4	0	0
3	49137821	.	C	A	1	4	5	0	0	5	0	0
3	49154124	.	C	A	1	4	5	0	1	6	0	0
3	49154214	.	G	A	6	3	9	0	1	10	0	0
3	49163407	.	G	T	0	2	2	0	0	2	0	0
3	49163417	.	C	T	2	3	5	0	0	5	0	0
3	49426063	.	G	A	6	7	13	0	0	13	0	0
3	49426184	.	G	A	12	7	19	0	2	21	0	0
3	49439450	.	G	T	9	8	17	1	2	20	0	0
3	49439587	.	A	G	8	17	25	1	0	26	0	0
3	49440129	.	G	T	5	9	14	0	1	15	0	0
3	49447514	.	C	A	1	10	11	0	10	21	0	0
3	49466407	.	T	C	6	11	17	0	0	17	0	0
3	49478380	.	T	C	15	7	22	0	0	22	0	0
3	49503880	.	A	G	14	14	28	0	1	29	0	0
3	49559444	.	C	T	30	33	63	0	5	68	0	0
3	49559523	.	C	T	34	39	73	0	1	74	0	0
3	49559527	.	G	T	36	39	75	0	0	75	0	0
3	49559637	.	G	T	35	36	71	0	4	75	0	0
3	49559703	.	G	A	44	42	86	0	0	86	0	0
3	49559904	.	G	A	36	33	69	0	1	70	0	0
3	49559979	.	A	G	25	38	63	0	4	67	0	0
3	49559988	.	T	A	29	34	63	0	3	66	0	0
3	49560084	.	A	G	35	34	69	0	1	70	0	0
3	49560204	.	G	C	29	32	61	0	1	62	0	0
3	49560276	.	T	G	34	32	66	0	3	70	1	0
3	49560420	.	C	T	21	39	60	0	2	62	0	0
3	49560507	.	G	A	28	30	58	0	2	60	0	0
3	49758429	.	A	G	2	2	4	0	0	4	0	0
3	49758616	.	T	A	1	2	3	0	0	3	0	0
3	49759897	.	T	A	1	2	3	0	0	3	0	0
3	49760049	.	T	C	4	3	7	0	0	7	0	0
3	49760173	.	T	C	0	0	0	0	3	3	0	0
3	49760191	.	G	C	2	2	4	0	0	4	0	0
3	49760210	.	A	G	2	3	5	0	0	5	0	0
3	49766995	.	C	T	3	2	5	0	0	5	0	0
3	50054508	.	G	A	13	3	16	0	1	17	0	0
3	50054578	.	C	G	6	9	15	0	0	15	0	0
3	50054619	.	A	T	10	10	20	0	0	20	0	0
3	50054766	.	G	A	7	8	15	2	3	20	0	0
3	50059143	.	A	T	17	11	28	0	5	33	0	0
3	50063458	.	C	T	6	10	16	0	1	17	0	0
3	50063491	.	C	T	1	12	13	0	16	29	0	0
3	50066373	.	A	G	14	14	28	0	6	34	0	0
3	50066402	.	G	A	13	21	34	0	1	35	0	0
3	50077077	.	G	A	9	11	20	0	0	20	0	0
3	50077311	.	A	G	13	15	28	0	2	30	0	0
3	50077364	.	T	A	20	14	34	0	2	36	0	0
3	50077371	.	G	A	13	19	32	2	3	37	0	0
3	50077428	.	G	C	17	16	33	2	3	38	0	0
3	50081696	.	G	A	27	21	48	0	1	49	0	0
3	50083980	.	C	A	24	16	40	0	2	42	0	0
3	50084011	.	A	G	18	18	36	0	2	38	0	0
3	50087361	.	C	A	1	14	15	0	15	30	0	0
3	50087370	.	G	A	14	16	30	0	2	32	0	0
3	50087433	.	C	A	2	9	11	0	15	26	0	0
3	50089113	.	G	A	14	10	24	0	3	27	0	0
3	50089470	.	T	C	12	8	20	0	2	22	0	0
3	50091985	.	A	G	10	10	20	0	1	21	0	0
3	50092630	.	T	G	14	10	24	0	0	24	0	0
3	50092633	.	A	G	14	10	24	0	0	24	0	0
3	50095869	.	A	T	5	4	9	0	2	11	0	0
3	50095929	.	C	T	1	4	5	0	10	15	0	0
3	50099806	.	G	A	5	2	7	0	1	8	0	0
3	50104084	.	C	T	8	5	13	0	0	13	0	0
3	50110202	.	T	C	9	0	9	0	8	17	0	0
3	50110205	.	C	A	9	7	16	0	0	16	0	0
3	50110369	.	T	C	5	6	11	0	0	11	0	0
3	50110399	.	A	G	6	6	12	0	0	12	0	0
3	50123650	.	C	A	0	21	21	0	17	38	0	0
3	50123709	.	A	G	20	23	43	0	2	45	0	0
3	50123758	.	A	G	25	24	49	0	2	51	0	0
3	50123760	.	C	A	26	22	48	0	3	51	0	0
3	50123936	.	G	A	14	23	37	0	1	38	0	0
3	50124107	.	A	G	9	14	23	0	2	25	0	0
3	50124108	.	C	G	10	14	24	0	1	25	0	0
3	50127039	.	G	T	6	5	11	0	0	11	0	0
3	50155405	.	T	A	1	2	3	0	0	3	0	0
3	50155406	.	A	T	1	2	3	0	0	3	0	0
3	50156275	.	T	C	1	3	4	0	0	4	0	0
3	50159356	.	C	G	1	0	1	0	5	6	0	0
3	50159431	.	C	T	2	6	8	0	0	8	0	0
3	50166550	.	T	C	7	10	17	0	0	17	0	0
3	50170236	.	A	G	5	0	5	0	10	15	0	0
3	50170338	.	T	A	4	12	16	0	1	17	0	0
3	50170354	.	C	T	4	12	16	0	0	16	0	0
3	50171713	.	A	G	5	17	22	0	0	22	0	0
3	50172725	.	G	C	8	7	15	0	0	15	0	0
3	50172735	.	T	A	6	6	12	0	0	12	0	0
3	50172788	.	C	T	4	3	7	0	0	7	0	0
3	50175940	.	G	T	3	7	10	0	2	12	0	0
3	50176620	.	G	T	10	7	17	0	0	17	0	0
3	50253969	.	G	A	2	4	6	0	0	6	0	0
3	50256147	.	G	A	4	4	8	0	0	8	0	0
3	50256938	.	A	C	10	6	16	0	0	16	0	0
3	50265852	.	C	T	5	7	12	0	0	12	0	0
3	50265903	.	A	C	8	8	16	0	1	17	0	0
3	50265906	.	T	C	10	7	17	0	1	18	0	0
3	50265994	.	C	T	6	9	15	0	0	15	0	0
3	50266043	.	C	A	5	12	17	0	2	19	0	0
3	50266063	.	A	G	6	12	18	0	1	19	0	0
3	50266198	.	T	C	3	2	5	0	0	5	0	0
3	50266330	.	T	A	6	7	13	0	0	13	0	0
3	50266624	.	C	A	1	1	2	0	1	3	0	0
3	50267171	.	T	G	3	4	7	0	1	8	0	0
3	50267256	.	T	A	3	9	12	0	0	12	0	0
3	50267460	.	G	A	6	4	10	0	0	10	0	0
3	50267471	.	A	T	4	2	6	0	0	6	0	0
3	50267686	.	T	C	8	10	18	0	1	19	0	0
3	50267860	.	A	T	10	7	17	0	0	17	0	0
3	50267981	.	G	C	4	11	15	0	1	16	0	0
3	50267992	.	T	A	6	9	15	0	1	16	0	0
3	50268016	.	T	C	11	6	17	0	0	17	0	0
3	50268052	.	A	T	8	8	16	0	0	16	0	0
3	50268073	.	A	G	5	11	16	0	0	16	0	0
3	50268106	.	G	T	3	8	11	0	0	11	0	0
3	50268146	.	T	A	2	7	9	0	0	9	0	0
3	50268220	.	C	T	4	6	10	1	1	12	0	0
3	50268422	.	G	A	3	4	7	0	0	7	0	0
3	50268535	.	A	C	14	6	20	0	0	20	0	0
3	50268715	.	C	T	14	11	25	0	0	25	0	0
3	50268744	.	G	A	11	12	23	0	2	25	0	0
3	50272435	.	T	G	8	4	12	0	2	14	0	0
3	50272438	.	T	G	10	4	14	0	0	14	0	0
3	50273026	.	G	A	5	5	10	0	2	12	0	0
3	50273031	.	C	T	5	8	13	0	0	13	0	0
3	50273469	.	C	T	0	4	4	0	2	6	0	0
3	50276336	.	A	T	4	4	8	0	0	8	0	0
3	50277657	.	A	T	4	3	7	0	0	7	0	0
3	50277660	.	C	T	3	3	6	0	1	7	0	0
3	50366189	.	G	A	12	5	17	0	3	20	0	0
3	50418826	.	G	C	16	14	30	0	0	30	0	0
3	50419046	.	C	T	7	5	12	0	0	12	0	0
3	50419658	.	T	A	2	2	4	0	1	5	0	0
3	50419686	.	A	T	3	2	5	0	0	5	0	0
3	50419722	.	G	C	7	3	10	0	0	10	0	0
3	50419723	.	C	A	7	3	10	0	0	10	0	0
3	50419759	.	C	T	8	3	11	0	0	11	0	0
3	50419791	.	T	C	8	4	12	0	1	13	0	0
3	50419803	.	C	A	5	9	14	0	0	14	0	0
3	50419827	.	T	C	3	8	11	0	0	11	0	0
3	50419866	.	T	A	2	5	7	0	0	8	1	0
3	50419867	.	A	C	6	3	9	0	0	9	0	0
3	50420001	.	A	C	2	2	4	0	1	6	1	0
3	50420087	.	A	G	3	3	6	0	1	7	0	0
3	50420139	.	A	T	10	8	18	0	1	19	0	0
3	50420152	.	G	T	9	11	20	0	0	20	0	0
3	50420191	.	A	T	7	13	20	0	3	23	0	0
3	50420194	.	T	A	13	8	21	0	1	22	0	0
3	50861448	.	G	T	2	4	6	0	0	6	0	0
3	50861538	.	A	G	1	2	3	0	0	3	0	0
3	50861639	.	G	A	1	3	4	0	0	4	0	0
3	50861651	.	A	G	1	2	3	0	0	3	0	0
3	50951644	.	C	G	5	5	10	0	0	10	0	0
3	50951770	.	T	G	9	4	13	0	0	13	0	0
3	50951862	.	A	G	4	4	8	0	0	8	0	0
3	50952021	.	T	C	3	3	6	0	0	6	0	0
3	50952163	.	G	A	6	7	13	0	0	13	0	0
3	50952268	.	G	T	5	4	9	0	0	9	0	0
3	50952404	.	G	T	3	4	7	0	0	7	0	0
3	50998386	.	T	C	1	2	3	0	1	4	0	0
3	51034995	.	G	T	4	9	13	0	2	15	0	0
3	51039012	.	C	T	0	6	6	0	2	8	0	0
3	51043176	.	G	A	5	5	10	0	0	10	0	0
3	51043916	.	G	A	4	4	8	0	0	8	0	0
3	51043976	.	G	A	2	3	5	0	0	5	0	0
3	51043994	.	G	A	1	3	4	0	0	4	0	0
3	51056311	.	C	G	4	3	7	0	0	7	0	0
3	51056350	.	A	G	3	2	5	0	0	5	0	0
3	51056368	.	T	A	3	2	5	0	0	5	0	0
3	51058962	.	T	C	3	3	6	0	0	6	0	0
3	51060341	.	G	A	2	2	4	0	1	5	0	0
3	51074564	.	A	G	1	2	3	0	0	3	0	0
3	51074579	.	T	A	1	3	4	0	0	4	0	0
3	51563736	.	G	A	0	3	3	0	2	5	0	0
3	51581066	.	G	T	0	3	3	0	1	4	0	0
3	51642491	.	G	A	1	6	7	0	0	7	0	0
3	51645783	.	C	T	6	4	10	0	0	10	0	0
3	51656720	.	G	A	9	3	12	0	0	12	0	0
3	51656726	.	C	A	11	2	13	0	0	13	0	0
3	51656762	.	G	A	11	3	14	0	0	14	0	0
3	51656849	.	T	A	5	3	8	0	0	8	0	0
3	51656921	.	T	C	9	3	12	0	1	13	0	0
3	51656931	.	G	A	10	4	14	0	0	14	0	0
3	51657033	.	T	A	13	7	20	0	0	20	0	0
3	51657082	.	C	T	5	5	10	0	1	11	0	0
3	51657158	.	A	G	7	0	7	0	5	12	0	0
3	51657291	.	G	A	11	10	21	0	0	21	0	0
3	51657314	.	G	A	9	6	15	0	0	15	0	0
3	51657382	.	G	C	5	3	8	0	0	8	0	0
3	51657439	.	A	G	4	5	9	0	0	9	0	0
3	51657456	.	C	T	4	7	11	0	1	12	0	0
3	51742263	.	G	A	4	6	10	0	0	10	0	0
3	51808378	.	C	T	6	4	10	0	0	10	0	0
3	51813083	.	G	A	4	4	8	0	0	8	0	0
3	51834434	.	C	T	6	3	9	0	0	9	0	0
3	51861767	.	G	A	6	4	10	0	0	10	0	0
3	51871663	.	A	T	6	8	14	0	1	15	0	0
3	51871671	.	C	T	8	4	12	0	0	12	0	0
3	51871704	.	G	C	10	5	15	0	0	15	0	0
3	51871788	.	G	A	8	6	14	0	0	14	0	0
3	51874119	.	C	A	9	10	19	0	0	19	0	0
3	51874163	.	G	A	6	10	16	0	0	16	0	0
3	51874274	.	G	A	7	9	16	0	1	17	0	0
3	51879297	.	G	T	7	7	14	0	1	15	0	0
3	51891785	.	A	G	8	2	10	0	11	21	0	0
3	51891787	.	C	T	8	11	19	0	2	21	0	0
3	51892095	.	T	A	8	3	11	0	0	11	0	0
3	51892136	.	A	T	6	4	10	0	1	11	0	0
3	51892162	.	A	G	6	7	13	0	0	13	0	0
3	51892176	.	T	A	6	6	12	0	1	13	0	0
3	51892212	.	A	G	8	6	14	0	0	14	0	0
3	51892225	.	T	A	7	6	13	0	0	13	0	0
3	51892502	.	G	A	9	4	13	0	0	13	0	0
3	51899772	.	T	A	12	8	20	0	1	21	0	0
3	51899802	.	C	T	1	7	8	0	10	18	0	0
3	51899872	.	C	T	2	6	8	0	8	16	0	0
3	51900357	.	C	A	7	9	16	0	1	17	0	0
3	51900400	.	A	G	11	5	16	0	0	16	0	0
3	51900415	.	T	C	8	10	18	0	0	18	0	0
3	51900487	.	A	C	12	18	30	0	2	32	0	0
3	51900552	.	A	G	9	12	21	0	0	21	0	0
3	51900587	.	C	T	7	11	18	0	2	20	0	0
3	51900589	.	A	C	8	13	21	0	0	21	0	0
3	51900693	.	C	G	5	14	19	0	0	20	1	0
3	51900702	.	C	A	0	13	13	0	5	18	0	0
3	51900768	.	T	A	11	6	17	0	3	20	0	0
3	51900784	.	T	C	14	1	15	0	5	20	0	0
3	51901092	.	A	T	11	17	28	0	1	29	0	0
3	51901127	.	A	G	7	23	30	0	2	32	0	0
3	51901178	.	T	A	12	22	34	0	1	35	0	0
3	51901199	.	G	T	17	18	35	0	0	35	0	0
3	51901309	.	G	A	19	17	36	0	0	36	0	0
3	51901344	.	T	C	15	17	32	0	1	33	0	0
3	51901413	.	A	G	13	12	25	0	0	25	0	0
3	51901670	.	C	T	7	6	13	0	0	13	0	0
3	51901799	.	T	C	14	13	27	0	2	29	0	0
3	51901835	.	G	A	19	12	31	0	1	32	0	0
3	51901873	.	A	G	17	12	29	0	2	31	0	0
3	51901885	.	T	C	17	12	29	0	3	32	0	0
3	51902099	.	C	T	10	10	20	0	0	20	0	0
3	51902171	.	T	A	5	6	11	0	0	11	0	0
3	51902454	.	T	A	10	9	19	0	1	20	0	0
3	51902471	.	C	T	7	8	15	0	1	16	0	0
3	51902591	.	T	A	3	5	8	0	1	9	0	0
3	51902695	.	C	T	10	4	14	0	0	14	0	0
3	51902834	.	A	G	9	18	27	0	0	27	0	0
3	51902883	.	G	A	10	14	24	0	1	25	0	0
3	51902987	.	A	G	9	8	17	0	1	18	0	0
3	51903048	.	A	C	6	5	11	0	0	11	0	0
3	51903080	.	A	G	7	3	10	0	1	11	0	0
3	51903168	.	C	T	6	7	13	0	1	14	0	0
3	51903198	.	A	C	6	0	6	0	11	17	0	0
3	51903211	.	T	G	8	11	19	0	0	19	0	0
3	51903233	.	A	G	11	14	25	0	0	25	0	0
3	51903286	.	G	T	7	10	17	0	0	17	0	0
3	51903495	.	A	G	4	5	9	0	1	10	0	0
3	51903591	.	C	T	4	13	17	0	1	18	0	0
3	51903605	.	G	A	5	12	17	0	0	17	0	0
3	51903742	.	C	G	4	7	11	0	1	12	0	0
3	51903810	.	T	G	6	3	9	0	0	9	0	0
3	51903815	.	T	A	7	3	10	0	0	10	0	0
3	51903979	.	T	C	6	5	11	0	0	11	0	0
3	51904226	.	A	G	4	5	9	0	0	9	0	0
3	51904359	.	T	A	6	7	13	0	0	13	0	0
3	51904826	.	G	A	7	3	10	0	1	11	0	0
3	51907077	.	G	T	2	6	8	0	0	8	0	0
3	51907297	.	G	A	8	4	12	0	0	12	0	0
3	51911718	.	A	C	2	3	5	0	0	5	0	0
3	51911727	.	A	G	1	4	5	0	0	5	0	0
3	52558270	.	A	G	1	0	1	0	4	5	0	0
3	52558333	.	A	G	1	4	5	0	0	5	0	0
3	52558558	.	T	A	2	3	5	0	0	5	0	0
3	52563568	.	C	T	3	4	7	0	1	8	0	0
3	52584332	.	C	T	7	10	17	0	0	17	0	0
3	52584428	.	C	T	5	3	8	0	0	8	0	0
3	52588941	.	C	T	5	3	8	0	1	9	0	0
3	52594760	.	G	A	8	6	14	0	0	14	0	0
3	52594966	.	T	C	6	10	16	0	0	16	0	0
3	52603216	.	A	C	10	6	16	0	2	18	0	0
3	52641771	.	C	A	4	3	7	0	0	7	0	0
3	52641819	.	T	C	4	1	5	0	9	14	0	0
3	52641831	.	C	T	0	10	10	0	3	13	0	0
3	52642132	.	T	A	5	8	13	0	0	13	0	0
3	52642488	.	A	G	7	5	12	0	0	12	0	0
3	52642614	.	T	C	2	0	2	0	4	6	0	0
3	52647825	.	G	A	5	4	9	0	0	9	0	0
3	52648764	.	G	A	3	2	5	0	0	5	0	0
3	52649217	.	G	A	1	2	3	0	0	3	0	0
3	52660929	.	T	A	2	2	4	0	0	4	0	0
3	52668542	.	G	A	3	9	12	0	1	13	0	0
3	52668679	.	C	T	2	6	8	1	7	16	0	0
3	52669995	.	G	A	7	7	14	0	0	14	0	0
3	52673834	.	T	A	7	3	10	0	2	12	0	0
3	52673854	.	A	T	5	4	9	0	1	10	0	0
3	52673936	.	G	A	7	2	9	0	0	9	0	0
3	52674017	.	T	A	2	2	4	1	0	5	0	0
3	52674018	.	A	C	1	2	3	1	1	5	0	0
3	52676973	.	A	G	1	2	3	0	0	3	0	0
3	52676993	.	C	T	3	1	4	0	0	4	0	0
3	52677087	.	C	T	0	3	3	0	4	7	0	0
3	52677279	.	G	A	2	4	6	0	1	7	0	0
3	52677281	.	C	T	2	5	7	0	0	7	0	0
3	52677492	.	C	G	6	2	8	0	0	8	0	0
3	52677501	.	T	C	7	3	10	0	0	10	0	0
3	52689511	.	C	T	3	3	6	0	0	6	0	0
3	52697304	.	G	C	6	8	14	0	0	14	0	0
3	52697312	.	A	C	5	8	13	0	0	13	0	0
3	52697371	.	T	A	5	10	15	0	1	16	0	0
3	52699405	.	G	A	7	6	13	0	0	13	0	0
3	52699441	.	G	A	9	7	16	0	1	17	0	0
3	52699449	.	G	T	0	8	8	0	10	18	0	0
3	52699494	.	A	G	6	4	10	0	1	11	0	0
3	52699503	.	T	C	4	5	9	0	1	10	0	0
3	52700195	.	T	G	1	2	3	0	0	3	0	0
3	52895631	.	G	A	2	8	10	0	0	10	0	0
3	52895667	.	G	A	6	6	12	0	0	12	0	0
3	52895688	.	C	T	7	3	10	0	1	11	0	0
3	52895725	.	C	G	5	3	8	0	0	8	0	0
3	52902344	.	G	A	1	5	6	0	1	7	0	0
3	52902356	.	T	C	1	5	6	0	0	6	0	0
3	52911245	.	A	G	3	3	6	0	0	6	0	0
3	52913391	.	T	C	1	2	3	0	1	4	0	0
3	52913508	.	C	T	3	2	5	0	0	5	0	0
3	52921780	.	A	G	2	2	4	0	0	4	0	0
3	52921926	.	A	G	4	0	4	0	4	8	0	0
3	52931588	.	T	C	4	4	8	0	0	8	0	0
3	52932770	.	C	T	1	7	8	0	0	8	0	0
3	52932793	.	A	C	1	6	7	0	1	8	0	0
3	52935355	.	C	A	8	6	14	0	0	14	0	0
3	52937419	.	T	C	3	5	8	0	1	9	0	0
3	52937723	.	G	T	4	8	12	0	2	14	0	0
3	52937747	.	G	A	1	8	9	0	9	18	0	0
3	52945346	.	G	A	5	3	8	0	0	8	0	0
3	53000280	.	G	A	0	3	3	0	4	7	0	0
3	53000558	.	A	G	4	0	4	1	5	10	0	0
3	53000673	.	G	T	0	3	3	0	7	10	0	0
3	53001045	.	C	A	7	7	14	0	0	14	0	0
3	53047981	.	A	G	5	0	5	0	6	11	0	0
3	53048032	.	C	T	5	3	8	5	1	14	0	0
3	53074317	.	C	T	13	12	25	0	2	27	0	0
3	53074581	.	C	T	21	6	27	0	2	29	0	0
3	53075050	.	C	A	10	9	19	0	1	20	0	0
3	53075475	.	T	G	13	11	24	0	0	24	0	0
3	53076037	.	A	T	15	13	28	0	3	31	0	0
3	53076160	.	G	T	2	27	29	0	26	55	0	0
3	53140955	.	T	A	2	2	4	0	0	4	0	0
3	53192505	.	C	T	4	2	6	0	1	7	0	0
3	53196776	.	C	T	2	3	5	0	0	5	0	0
3	53198571	.	A	C	5	3	8	0	1	9	0	0
3	53198736	.	T	C	6	4	10	0	1	11	0	0
3	53198987	.	T	G	11	3	14	0	0	14	0	0
3	53199113	.	G	A	0	6	6	0	4	10	0	0
3	53199182	.	C	T	4	4	8	0	0	8	0	0
3	53199433	.	A	T	2	2	4	0	1	5	0	0
3	53203455	.	A	G	1	5	6	0	0	6	0	0
3	53203566	.	C	T	1	3	4	0	1	5	0	0
3	53203782	.	A	G	2	3	5	0	0	5	0	0
3	53203823	.	T	G	2	0	2	0	4	6	0	0
3	53204009	.	C	T	4	6	10	0	1	11	0	0
3	53204135	.	A	G	2	0	2	0	5	7	0	0
3	53206055	.	A	G	5	0	5	0	7	12	0	0
3	53206260	.	A	G	5	8	13	0	2	15	0	0
3	53206418	.	G	A	11	8	19	0	0	19	0	0
3	53206427	.	C	T	11	7	18	0	1	19	0	0
3	53206469	.	A	T	10	8	18	0	0	18	0	0
3	53206472	.	C	T	8	7	15	0	3	18	0	0
3	53211032	.	A	G	9	7	16	0	2	18	0	0
3	53211168	.	G	C	15	6	21	0	4	25	0	0
3	53211170	.	T	C	14	10	24	0	0	24	0	0
3	53211206	.	A	T	10	6	16	0	1	17	0	0
3	53211239	.	A	G	13	10	23	0	0	23	0	0
3	53211248	.	T	G	13	1	14	0	9	23	0	0
3	53211356	.	A	T	7	9	16	0	0	16	0	0
3	53211366	.	C	A	5	8	13	0	3	16	0	0
3	53211604	.	C	G	11	11	22	0	0	22	0	0
3	53211605	.	C	T	12	10	22	0	1	23	0	0
3	53214615	.	T	C	11	10	21	0	1	22	0	0
3	53215644	.	C	T	10	9	19	0	1	20	0	0
3	53215711	.	T	A	7	10	17	0	1	18	0	0
3	53215729	.	G	A	6	9	15	0	0	15	0	0
3	53218471	.	C	T	9	8	17	0	1	18	0	0
3	53222943	.	G	T	0	9	9	0	10	19	0	0
3	53223032	.	C	A	10	12	22	0	0	22	0	0
3	53223110	.	T	C	7	9	16	0	1	17	0	0
3	53223290	.	G	A	11	8	19	0	0	19	0	0
3	53223415	.	C	T	8	15	23	0	1	24	0	0
3	53223686	.	G	T	21	8	29	0	4	33	0	0
3	53223691	.	G	T	23	10	33	0	0	33	0	0
3	53223783	.	C	T	11	13	24	0	0	24	0	0
3	53223973	.	A	C	17	8	25	0	0	25	0	0
3	53224029	.	G	A	14	7	21	0	2	23	0	0
3	53224181	.	A	G	15	13	28	0	0	28	0	0
3	53224231	.	C	G	10	13	23	0	2	25	0	0
3	53228771	.	T	A	17	17	34	0	4	39	1	0
3	53229021	.	G	A	17	18	35	0	0	35	0	0
3	53229036	.	T	A	22	12	34	0	1	35	0	0
3	53230980	.	T	C	11	6	17	0	2	19	0	0
3	53231133	.	T	G	10	3	13	0	0	13	0	0
3	53231144	.	G	A	10	3	13	0	0	13	0	0
3	53248472	.	G	C	2	2	4	0	0	4	0	0
3	53253891	.	T	G	2	3	5	0	0	5	0	0
3	53253900	.	C	T	2	4	6	0	0	6	0	0
3	53271759	.	A	G	1	0	1	0	5	6	0	0
3	53273484	.	G	A	0	4	4	0	1	5	0	0
3	53273539	.	T	C	2	3	5	0	0	5	0	0
3	53273579	.	C	T	2	2	4	0	0	4	0	0
3	53273599	.	A	G	1	3	4	0	0	4	0	0
3	53273763	.	G	A	2	2	4	0	0	4	0	0
3	53273841	.	T	A	1	2	3	0	0	3	0	0
3	53330005	.	A	G	5	3	8	0	0	8	0	0
3	53331913	.	G	A	3	3	6	0	0	6	0	0
3	53342694	.	G	A	1	3	4	0	0	4	0	0
3	53342706	.	C	A	1	4	5	0	0	5	0	0
3	53344694	.	T	C	3	3	6	0	0	6	0	0
3	53344842	.	C	T	7	2	9	0	0	9	0	0
3	53346991	.	T	C	12	2	14	0	0	14	0	0
3	53352516	.	G	T	1	5	6	0	0	6	0	0
3	53398022	.	C	T	1	2	3	0	0	3	0	0
3	53444674	.	G	A	1	2	3	0	4	7	0	0
3	53445378	.	A	T	4	3	7	0	0	7	0	0
3	53445979	.	C	T	8	3	11	0	0	11	0	0
3	53446039	.	A	C	2	7	9	0	0	9	0	0
3	53446126	.	G	A	3	3	6	0	1	7	0	0
3	53446429	.	A	G	3	7	10	0	0	10	0	0
3	53446569	.	C	T	11	5	16	0	1	17	0	0
3	53447714	.	C	T	2	7	9	0	0	9	0	0
3	53447717	.	C	T	2	7	9	0	0	9	0	0
3	53447960	.	C	T	4	6	10	0	1	11	0	0
3	53448188	.	T	C	5	5	10	0	2	12	0	0
3	53449227	.	C	A	8	6	14	0	2	16	0	0
3	53449263	.	A	G	8	9	17	0	1	18	0	0
3	53522053	.	T	C	0	1	1	0	1	2	0	0
3	53528017	.	T	C	4	5	9	0	0	9	0	0
3	53528039	.	G	A	4	3	7	0	0	7	0	0
3	53528190	.	T	C	2	3	5	0	1	6	0	0
3	53529027	.	A	G	2	3	5	0	0	5	0	0
3	53529958	.	C	T	1	2	3	0	1	4	0	0
3	53530423	.	C	T	1	3	4	0	0	4	0	0
3	53687679	.	C	T	1	2	3	0	0	3	0	0
3	53687701	.	G	T	3	2	5	0	0	5	0	0
3	53688047	.	A	T	2	2	4	0	0	4	0	0
3	53688276	.	T	C	2	0	2	0	4	6	0	0
3	53688381	.	G	A	3	3	6	0	1	7	0	0
3	53918365	.	T	C	1	2	3	0	0	3	0	0
3	54047599	.	T	G	12	7	19	0	0	19	0	0
3	54047881	.	T	C	10	12	22	0	0	22	0	0
3	54168046	.	C	T	10	19	29	0	1	30	0	0
3	54168127	.	C	T	5	6	11	0	0	11	0	0
3	54168174	.	T	C	5	5	10	0	0	10	0	0
3	54168192	.	T	C	7	3	10	0	0	10	0	0
3	54168318	.	T	C	13	6	19	0	0	19	0	0
3	54207610	.	C	T	23	25	48	0	3	51	0	0
3	54223504	.	G	A	13	21	34	0	1	35	0	0
3	54236612	.	A	G	20	1	21	0	23	44	0	0
3	54236621	.	T	G	22	21	43	0	2	45	0	0
3	54236657	.	C	A	19	17	36	0	1	37	0	0
3	54236750	.	A	G	28	21	49	0	1	50	0	0
3	54236996	.	G	A	2	32	34	0	25	59	0	0
3	54237347	.	C	T	25	25	50	0	0	51	1	0
3	54237443	.	G	C	19	10	29	0	0	29	0	0
3	54237472	.	T	C	14	10	24	0	0	24	0	0
3	54434468	.	C	T	1	2	3	0	1	4	0	0
3	54435002	.	A	G	3	4	7	0	0	7	0	0
3	54435018	.	A	G	3	5	8	0	0	8	0	0
3	54435088	.	G	A	2	8	10	0	0	10	0	0
3	54435273	.	G	A	8	9	17	0	0	17	0	0
3	54435336	.	C	G	0	9	9	0	10	19	0	0
3	54435453	.	G	A	8	10	18	1	0	19	0	0
3	54438753	.	G	A	4	4	8	0	0	8	0	0
3	54438776	.	T	G	3	4	7	0	1	8	0	0
3	54455120	.	T	C	3	0	3	0	6	9	0	0
3	54455168	.	C	T	1	2	3	0	2	5	0	0
3	54455616	.	G	T	3	4	7	0	0	7	0	0
3	54455657	.	T	G	3	2	5	0	0	5	0	0
3	54455827	.	G	A	1	6	7	0	0	7	0	0
3	54456183	.	T	C	4	2	6	0	0	6	0	0
3	54474860	.	G	A	2	2	4	0	0	4	0	0
3	54500103	.	T	C	1	6	7	0	0	7	0	0
3	54500111	.	C	G	2	6	8	0	0	8	0	0
3	54554306	.	C	G	2	0	2	0	2	4	0	0
3	54561375	.	A	G	3	4	7	0	1	8	0	0
3	54567186	.	G	A	6	10	16	0	1	17	0	0
3	54567303	.	T	A	6	11	17	0	0	17	0	0
3	54567463	.	T	A	6	6	12	0	0	12	0	0
3	54567502	.	G	A	9	6	15	0	0	15	0	0
3	54567715	.	A	C	2	5	7	0	0	7	0	0
3	54567777	.	A	G	4	0	4	0	5	9	0	0
3	54567856	.	A	C	1	3	4	0	0	4	0	0
3	54567857	.	C	T	1	3	4	0	0	4	0	0
3	54583742	.	C	T	26	13	39	0	1	40	0	0
3	54585281	.	A	G	28	20	48	0	1	49	0	0
3	54585359	.	C	T	22	22	44	0	3	47	0	0
3	54585637	.	T	C	30	12	42	0	1	43	0	0
3	54585685	.	C	T	20	13	33	0	2	35	0	0
3	54586125	.	T	C	11	12	23	0	0	23	0	0
3	54589582	.	T	C	21	20	41	0	4	45	0	0
3	54591385	.	G	A	3	3	6	0	0	6	0	0
3	54591432	.	A	C	5	7	12	0	0	12	0	0
3	54591677	.	G	A	8	8	16	0	0	16	0	0
3	54591701	.	A	G	5	8	13	0	0	13	0	0
3	54591849	.	G	A	13	11	24	0	1	25	0	0
3	54592376	.	A	T	11	15	26	0	1	27	0	0
3	54592986	.	T	C	11	0	11	0	8	19	0	0
3	54593034	.	A	T	9	8	17	0	1	19	1	0
3	54593046	.	C	T	7	5	12	0	0	12	0	0
3	54594823	.	C	T	10	7	17	0	0	17	0	0
3	54594865	.	T	A	3	6	9	0	0	9	0	0
3	54594880	.	T	C	2	4	6	0	0	6	0	0
3	54596362	.	A	G	1	8	9	0	0	9	0	0
3	54596385	.	C	T	2	7	9	0	1	10	0	0
3	54596634	.	G	A	8	5	13	0	0	13	0	0
3	54596651	.	G	A	5	8	13	0	0	13	0	0
3	54596892	.	T	C	6	0	6	0	7	13	0	0
3	54596935	.	A	G	11	8	19	0	0	19	0	0
3	54597183	.	G	A	4	9	13	0	0	13	0	0
3	54597712	.	A	C	1	5	6	0	0	6	0	0
3	54598196	.	T	G	2	2	4	0	0	4	0	0
3	54598673	.	G	A	0	7	7	0	0	7	0	0
3	54598679	.	G	T	5	3	8	0	1	9	0	0
3	54601991	.	C	T	2	4	6	0	0	6	0	0
3	54602027	.	A	G	2	2	4	0	0	4	0	0
3	54602054	.	G	A	2	2	4	0	0	4	0	0
3	54748474	.	T	C	0	3	3	3	1	7	0	0
3	54748477	.	T	G	1	4	5	3	0	8	0	0
3	54810164	.	G	A	2	4	6	1	0	7	0	0
3	54834906	.	T	C	1	2	3	0	0	3	0	0
3	54836244	.	T	A	3	2	5	0	0	5	0	0
3	54837876	.	C	T	1	2	3	0	0	3	0	0
3	54849375	.	A	G	1	0	1	0	3	4	0	0
3	54849459	.	C	A	4	4	8	0	0	8	0	0
3	54849466	.	C	T	5	5	10	0	0	10	0	0
3	54850678	.	C	T	3	2	5	0	0	5	0	0
3	54852465	.	T	C	2	3	5	0	0	5	0	0
3	54852507	.	G	A	3	5	8	0	0	8	0	0
3	54856645	.	T	C	6	3	9	0	0	9	0	0
3	54859022	.	G	A	0	5	5	0	10	15	0	0
3	54859127	.	T	C	5	9	14	0	1	15	0	0
3	54866207	.	A	G	12	10	22	1	1	24	0	0
3	54868514	.	C	T	9	6	15	0	1	16	0	0
3	54871515	.	C	A	18	17	35	0	1	36	0	0
3	54871745	.	C	T	8	12	20	0	1	21	0	0
3	54872003	.	C	G	8	7	15	0	1	16	0	0
3	54872172	.	T	A	13	8	21	0	0	21	0	0
3	54872207	.	T	C	20	5	25	0	0	25	0	0
3	54872213	.	A	C	24	3	27	0	1	28	0	0
3	54872494	.	A	G	4	10	14	0	2	16	0	0
3	54872520	.	C	G	19	4	23	0	0	23	0	0
3	54873055	.	C	A	6	16	22	0	2	24	0	0
3	54873844	.	T	C	13	15	28	0	0	28	0	0
3	54874245	.	C	T	13	7	20	0	1	21	0	0
3	54874371	.	C	T	15	15	30	0	1	31	0	0
3	54874477	.	A	G	12	22	34	0	1	35	0	0
3	54874631	.	G	A	16	14	30	0	2	32	0	0
3	54874660	.	C	T	18	13	31	0	0	31	0	0
3	54874711	.	G	A	4	18	22	0	0	22	0	0
3	54896985	.	A	G	4	6	10	0	0	10	0	0
3	54897039	.	G	A	6	2	8	0	0	8	0	0
3	54897099	.	G	T	8	6	14	0	0	14	0	0
3	54897152	.	G	A	1	4	5	0	0	5	0	0
3	54908057	.	C	T	2	3	5	0	0	5	0	0
3	54910359	.	A	G	1	3	4	0	0	4	0	0
3	54911854	.	T	G	1	2	3	0	0	3	0	0
3	54914258	.	A	G	3	2	5	0	0	5	0	0
3	55032137	.	C	G	1	3	4	0	0	4	0	0
3	55042672	.	T	G	1	0	1	0	2	3	0	0
3	55045709	.	G	T	4	6	10	0	0	10	0	0
3	55046165	.	A	G	7	5	12	0	1	13	0	0
3	55050175	.	A	G	10	5	15	0	0	15	0	0
3	55050191	.	T	A	7	7	14	0	0	14	0	0
3	55051090	.	C	T	5	2	7	0	0	7	0	0
3	55093871	.	A	T	3	2	5	0	0	5	0	0
3	55093878	.	T	C	2	3	5	0	0	5	0	0
3	55093923	.	T	C	2	3	5	0	0	5	0	0
3	55093980	.	T	C	3	3	6	0	1	7	0	0
3	55094004	.	C	T	3	3	6	0	0	6	0	0
3	55098813	.	G	T	22	5	27	23	1	51	0	0
3	55100413	.	C	A	21	4	25	9	0	34	0	0
3	55100590	.	T	G	19	14	33	10	2	45	0	0
3	55100795	.	A	G	20	14	34	17	0	51	0	0
3	55104214	.	T	C	7	0	7	15	6	28	0	0
3	55104215	.	A	G	6	6	12	15	0	27	0	0
3	55105254	.	T	C	7	5	12	12	0	24	0	0
3	55105479	.	C	T	19	5	24	16	1	41	0	0
3	55105886	.	A	G	9	6	15	17	0	32	0	0
3	55174830	.	G	A	1	3	4	0	0	4	0	0
3	55174832	.	C	A	1	3	4	0	0	4	0	0
3	55218772	.	G	A	3	2	5	0	0	5	0	0
3	55222778	.	G	T	1	3	4	0	1	5	0	0
3	55422850	.	G	T	5	3	8	0	2	10	0	0
3	55422926	.	C	A	0	8	8	0	2	10	0	0
3	55422980	.	T	C	1	3	4	0	0	4	0	0
3	55423385	.	T	C	4	4	8	0	0	8	0	0
3	55423611	.	G	A	3	5	8	0	0	8	0	0
3	55423861	.	T	C	2	1	3	0	1	4	0	0
3	55426258	.	T	C	5	5	10	0	0	10	0	0
3	55430826	.	A	G	2	5	7	0	0	7	0	0
3	55438733	.	C	T	1	4	5	0	0	5	0	0
3	56883686	.	T	C	3	2	5	0	1	6	0	0
3	57462962	.	T	C	5	7	12	0	2	14	0	0
3	58197589	.	G	A	1	3	4	7	1	12	0	0
3	58197600	.	A	G	2	5	7	7	0	14	0	0
3	58197648	.	C	T	15	6	21	8	0	29	0	0
3	58197871	.	G	A	8	4	12	3	1	16	0	0
3	58210593	.	T	A	3	2	5	1	0	6	0	0
3	58211317	.	T	C	3	3	6	0	2	8	0	0
3	58608283	.	C	G	1	5	6	9	0	15	0	0
3	58608335	.	G	A	2	4	6	16	0	22	0	0
3	58610890	.	G	A	4	2	6	5	0	11	0	0
3	58615428	.	T	G	1	3	4	2	0	6	0	0
3	58615543	.	G	C	6	4	10	2	0	12	0	0
3	58704605	.	A	C	3	3	6	0	0	6	0	0
3	58704640	.	T	C	1	3	4	0	0	4	0	0
3	58704655	.	C	A	1	3	4	0	0	4	0	0
3	59146778	.	T	C	1	5	6	0	0	6	0	0
3	59802578	.	A	G	1	2	3	0	0	3	0	0
3	59802584	.	A	T	1	2	3	0	0	3	0	0
3	59808126	.	G	A	2	2	4	0	0	4	0	0
3	59815955	.	C	A	2	5	7	0	0	7	0	0
3	59868371	.	A	G	17	0	17	0	11	28	0	0
3	59868391	.	T	C	16	12	28	0	2	30	0	0
3	59868427	.	G	A	11	16	27	0	1	28	0	0
3	59870578	.	C	T	12	15	27	0	0	27	0	0
3	59876195	.	C	T	12	11	23	1	2	26	0	0
3	59876233	.	T	C	12	11	23	0	0	23	0	0
3	59876405	.	C	A	10	8	18	1	0	19	0	0
3	59876772	.	G	A	1	5	6	1	2	9	0	0
3	59880349	.	C	T	19	10	29	0	2	31	0	0
3	59880544	.	C	T	20	6	26	0	1	27	0	0
3	59883465	.	T	A	11	12	23	1	2	26	0	0
3	59883489	.	C	A	5	10	15	1	4	20	0	0
3	59887325	.	G	A	3	16	19	0	24	44	1	0
3	59887331	.	A	G	27	13	40	0	1	41	0	0
3	59889663	.	C	A	22	20	42	3	4	50	1	0
3	59941534	.	C	T	17	13	30	0	3	33	0	0
3	59941542	.	C	T	13	13	26	0	2	28	0	0
3	59941572	.	C	T	15	21	36	0	0	36	0	0
3	59942142	.	G	A	14	11	25	0	1	26	0	0
3	59945851	.	T	C	18	32	50	1	4	55	0	0
3	59946094	.	A	T	14	20	34	2	1	37	0	0
3	59946097	.	T	A	21	8	29	2	2	33	0	0
3	59946432	.	C	T	17	14	31	0	2	33	0	0
3	59946642	.	G	T	2	13	15	0	25	41	1	0
3	59946828	.	T	C	14	21	35	4	2	41	0	0
3	59946877	.	C	T	13	12	25	4	2	31	0	0
3	59946901	.	C	T	15	16	31	0	1	32	0	0
3	59947092	.	A	T	22	11	33	0	0	33	0	0
3	59951426	.	C	A	13	16	29	0	1	30	0	0
3	59951767	.	T	C	17	0	17	0	13	30	0	0
3	59951800	.	G	A	15	13	28	0	1	29	0	0
3	59952046	.	T	C	21	1	22	0	15	37	0	0
3	59952268	.	C	G	15	17	32	0	0	32	0	0
3	59952400	.	C	A	10	12	22	0	3	25	0	0
3	59961399	.	G	A	21	12	33	1	0	34	0	0
3	59994744	.	G	A	10	13	23	0	0	23	0	0
3	59994888	.	C	T	11	4	15	0	1	16	0	0
3	59995019	.	T	G	8	5	13	0	0	13	0	0
3	59995028	.	C	T	7	5	12	0	2	14	0	0
3	59995122	.	G	T	10	5	15	0	0	15	0	0
3	59997180	.	C	T	0	6	6	0	4	10	0	0
3	60025368	.	C	T	4	4	8	0	0	8	0	0
3	60025587	.	C	T	3	3	6	0	0	6	0	0
3	60025650	.	T	C	2	0	2	0	2	4	0	0
3	60055155	.	T	C	4	2	6	0	0	6	0	0
3	60219020	.	A	G	1	0	1	0	2	3	0	0
3	60223424	.	G	A	0	3	3	0	2	5	0	0
3	60225995	.	T	C	1	2	3	0	0	3	0	0
3	60226005	.	T	C	1	2	3	0	0	3	0	0
3	60526316	.	C	T	0	8	8	0	2	10	0	0
3	60526385	.	G	C	4	3	7	0	1	8	0	0
3	60526426	.	A	G	6	3	9	0	0	9	0	0
3	60595741	.	T	C	10	2	12	0	0	12	0	0
3	60596020	.	G	A	10	3	13	0	0	13	0	0
3	61034139	.	A	C	12	7	19	0	30	49	0	0
3	61156566	.	G	A	2	3	5	0	0	5	0	0
3	61221250	.	A	T	3	3	6	0	0	6	0	0
3	61221320	.	G	A	0	3	3	0	0	3	0	0
3	61221329	.	G	A	1	1	2	0	0	2	0	0
3	61244015	.	C	T	6	7	13	0	0	13	0	0
3	61276907	.	C	T	1	2	3	0	0	3	0	0
3	61277028	.	C	G	11	5	16	0	0	16	0	0
3	61278677	.	A	G	3	4	7	0	1	8	0	0
3	61278692	.	C	T	5	4	9	0	0	9	0	0
3	61278992	.	C	T	3	6	9	0	0	9	0	0
3	61279427	.	A	C	5	8	13	0	0	13	0	0
3	61279585	.	G	A	2	5	7	0	9	16	0	0
3	61279643	.	T	C	9	10	19	0	1	20	0	0
3	61280055	.	G	A	1	3	4	0	0	4	0	0
3	61280117	.	T	C	7	2	9	0	2	11	0	0
3	61280343	.	G	C	12	3	15	0	0	15	0	0
3	61280350	.	C	G	14	3	17	0	0	17	0	0
3	61280381	.	T	A	7	15	22	0	0	22	0	0
3	61280579	.	T	G	5	0	5	0	9	14	0	0
3	61281051	.	A	G	5	13	18	0	0	18	0	0
3	61281681	.	G	A	1	10	11	0	10	21	0	0
3	61285705	.	C	A	8	5	13	0	0	13	0	0
3	61285706	.	A	T	0	5	5	0	8	13	0	0
3	61285787	.	C	T	7	5	12	0	1	13	0	0
3	61286009	.	A	C	2	4	6	0	1	7	0	0
3	61286062	.	T	A	8	4	12	0	0	12	0	0
3	61286081	.	C	A	4	7	11	0	0	11	0	0
3	61286325	.	C	G	10	0	10	0	7	17	0	0
3	61286468	.	C	T	4	8	12	0	0	12	0	0
3	61286528	.	A	T	4	9	13	1	1	15	0	0
3	61286576	.	C	T	4	12	16	1	0	17	0	0
3	61286687	.	T	A	2	3	5	0	1	6	0	0
3	61286889	.	T	C	14	5	19	0	1	20	0	0
3	61287282	.	T	G	11	0	11	0	13	24	0	0
3	61287491	.	T	A	16	14	30	0	0	30	0	0
3	61287590	.	G	T	19	14	33	0	1	34	0	0
3	61287627	.	C	G	19	9	28	0	1	29	0	0
3	61287893	.	T	G	17	0	17	0	13	30	0	0
3	61288028	.	T	C	16	17	33	0	0	33	0	0
3	61288105	.	C	A	12	17	29	0	0	29	0	0
3	61288238	.	A	C	20	18	38	0	0	38	0	0
3	61288469	.	T	G	17	0	17	0	28	45	0	0
3	61292963	.	C	A	2	5	7	0	0	7	0	0
3	61293028	.	A	G	3	2	5	0	0	5	0	0
3	61293531	.	T	G	4	2	6	0	0	6	0	0
3	61297154	.	C	T	2	3	5	0	2	7	0	0
3	61308602	.	T	C	2	0	2	0	2	4	0	0
3	61308972	.	A	G	3	3	6	0	1	7	0	0
3	61317185	.	C	T	3	3	6	0	0	6	0	0
3	61317188	.	C	G	0	2	2	0	4	6	0	0
3	61331755	.	A	G	1	2	3	0	0	3	0	0
3	61342120	.	G	A	4	5	9	0	0	9	0	0
3	61342225	.	G	A	5	5	10	0	1	11	0	0
3	61342368	.	T	C	3	10	13	0	0	13	0	0
3	61342387	.	G	A	5	10	15	0	0	15	0	0
3	61342408	.	G	A	10	6	16	0	1	17	0	0
3	61342423	.	G	C	9	10	19	0	1	20	0	0
3	61342770	.	G	A	4	13	17	0	2	19	0	0
3	61342891	.	A	G	4	9	13	0	3	16	0	0
3	61343076	.	C	T	2	9	11	0	0	11	0	0
3	61343224	.	C	T	1	6	7	0	0	7	0	0
3	61343589	.	T	C	2	6	8	0	0	8	0	0
3	61349602	.	G	A	7	6	13	0	1	14	0	0
3	61349654	.	C	T	6	9	15	0	2	17	0	0
3	61349887	.	A	T	6	5	11	0	1	12	0	0
3	61349931	.	G	T	10	6	16	0	0	16	0	0
3	61350156	.	A	G	1	3	4	0	0	4	0	0
3	61350238	.	A	G	1	5	6	0	1	7	0	0
3	61350259	.	T	A	2	5	7	0	0	7	0	0
3	61350303	.	T	G	3	2	5	0	0	5	0	0
3	61350487	.	T	C	2	2	4	0	0	4	0	0
3	61350529	.	T	A	2	4	6	0	0	6	0	0
3	61350600	.	T	C	3	4	7	0	0	7	0	0
3	61350673	.	T	G	2	4	6	0	1	7	0	0
3	61350700	.	C	T	2	6	8	0	0	8	0	0
3	61350787	.	A	T	1	2	3	0	0	3	0	0
3	61350788	.	T	G	0	2	2	0	1	3	0	0
3	61351905	.	C	T	0	3	3	0	1	4	0	0
3	61351910	.	T	A	1	3	4	0	0	4	0	0
3	61352058	.	C	T	1	2	3	0	0	3	0	0
3	61358662	.	C	A	6	2	8	1	0	9	0	0
3	61358682	.	T	C	6	2	8	1	0	9	0	0
3	61358785	.	C	T	1	3	4	0	0	4	0	0
3	61359056	.	G	A	6	2	8	0	0	8	0	0
3	61365135	.	G	A	6	2	8	3	0	11	0	0
3	61367463	.	T	C	1	2	3	0	0	3	0	0
3	61372060	.	T	G	1	3	4	3	0	7	0	0
3	61372627	.	T	A	1	4	5	0	0	5	0	0
3	61373063	.	G	A	4	2	6	0	0	6	0	0
3	61383237	.	A	G	4	2	6	1	0	7	0	0
3	61383308	.	A	T	7	2	9	0	0	9	0	0
3	61383666	.	T	C	2	3	5	0	0	5	0	0
3	61387263	.	C	A	3	2	5	0	1	6	0	0
3	61391953	.	C	A	8	5	13	0	1	14	0	0
3	61392048	.	A	G	5	0	5	0	12	17	0	0
3	61395181	.	C	T	6	5	11	0	0	11	0	0
3	61396891	.	C	A	3	4	7	0	0	7	0	0
3	61396911	.	C	T	2	5	7	0	0	7	0	0
3	61397037	.	T	A	7	7	14	0	1	15	0	0
3	61397093	.	C	T	9	7	16	0	1	17	0	0
3	61397141	.	G	T	7	8	15	0	0	15	0	0
3	61397231	.	C	A	5	6	11	0	0	11	0	0
3	61397248	.	A	G	8	0	8	0	5	13	0	0
3	61398728	.	A	G	13	5	18	0	0	18	0	0
3	61398835	.	G	A	8	4	12	0	1	13	0	0
3	61398839	.	T	C	7	5	12	0	1	13	0	0
3	61401787	.	C	A	1	2	3	0	0	3	0	0
3	61401788	.	C	T	1	2	3	0	0	3	0	0
3	61542631	.	A	C	1	2	3	0	0	3	0	0
3	61542663	.	G	A	0	3	3	0	2	5	0	0
3	61542700	.	C	T	1	2	3	0	0	3	0	0
3	61542973	.	T	C	1	2	3	0	0	3	0	0
3	61543130	.	G	A	1	2	3	1	0	4	0	0
3	61566456	.	A	T	2	1	3	0	0	3	0	0
3	61566559	.	G	A	1	3	4	0	0	4	0	0
3	62034943	.	G	A	3	2	5	0	1	6	0	0
3	62035030	.	G	A	0	6	6	0	6	12	0	0
3	62036047	.	G	A	0	5	5	0	2	7	0	0
3	62036570	.	G	A	8	4	12	0	0	12	0	0
3	62037105	.	T	C	6	5	11	0	0	11	0	0
3	62037343	.	G	C	4	4	8	0	0	8	0	0
3	62037716	.	G	A	6	5	11	0	0	11	0	0
3	62038526	.	T	C	9	7	16	0	1	17	0	0
3	62038739	.	G	C	7	8	15	0	1	16	0	0
3	62038993	.	G	A	2	12	14	0	12	26	0	0
3	62039278	.	A	G	17	0	17	0	7	24	0	0
3	62039657	.	G	A	0	10	10	0	11	21	0	0
3	62039689	.	C	A	11	10	21	0	2	23	0	0
3	62039718	.	G	A	11	9	20	0	0	20	0	0
3	62039813	.	T	A	15	7	22	0	1	23	0	0
3	62040555	.	G	A	16	15	31	0	0	31	0	0
3	62051107	.	C	T	12	12	24	0	3	27	0	0
3	62051125	.	C	T	14	8	22	0	3	25	0	0
3	62051395	.	A	G	13	5	18	0	0	18	0	0
3	62051660	.	T	A	8	13	21	0	2	23	0	0
3	62051731	.	G	A	7	3	10	0	0	10	0	0
3	62068866	.	A	G	7	2	9	0	0	9	0	0
3	62068871	.	A	G	6	2	8	0	0	8	0	0
3	62069815	.	G	A	1	3	4	0	0	4	0	0
3	62069821	.	G	A	2	3	5	0	0	5	0	0
3	62070762	.	T	C	2	3	5	0	1	6	0	0
3	62070890	.	G	A	8	4	12	0	0	12	0	0
3	62073967	.	T	A	5	8	13	0	2	15	0	0
3	62074030	.	T	C	7	5	12	0	0	12	0	0
3	62080117	.	G	C	6	4	10	0	1	11	0	0
3	62080172	.	G	A	2	5	7	0	1	8	0	0
3	62091632	.	T	A	9	11	20	0	0	20	0	0
3	62091660	.	T	A	7	7	14	0	0	14	0	0
3	62091880	.	C	T	12	9	21	0	1	22	0	0
3	62091975	.	C	A	18	15	33	0	3	36	0	0
3	62091995	.	G	T	21	14	35	0	1	36	0	0
3	62092025	.	C	T	2	16	18	0	16	34	0	0
3	62092262	.	T	A	7	8	15	0	1	16	0	0
3	62092279	.	A	T	5	8	13	0	0	13	0	0
3	62092666	.	G	A	7	10	17	0	4	21	0	0
3	62092715	.	A	C	13	17	30	0	1	31	0	0
3	62092749	.	G	C	7	16	23	0	0	23	0	0
3	62092801	.	C	T	5	9	14	0	0	14	0	0
3	62092902	.	A	T	6	7	13	0	0	13	0	0
3	62093241	.	T	A	15	9	24	0	1	25	0	0
3	62093567	.	A	C	2	3	5	0	0	5	0	0
3	62094190	.	A	C	2	2	4	0	0	4	0	0
3	62094327	.	C	T	7	5	12	0	0	12	0	0
3	62094645	.	A	G	6	9	15	0	0	15	0	0
3	62094686	.	C	A	0	10	10	0	7	17	0	0
3	62094849	.	A	G	5	9	14	0	0	14	0	0
3	62095051	.	G	A	3	3	6	0	0	6	0	0
3	62095175	.	T	A	3	2	5	0	0	5	0	0
3	62095644	.	G	C	3	1	4	0	1	5	0	0
3	62095646	.	T	A	4	1	5	0	1	6	0	0
3	62095887	.	T	C	3	0	3	0	5	8	0	0
3	62095940	.	G	C	4	6	10	0	0	10	0	0
3	62096021	.	G	A	2	2	4	0	0	4	0	0
3	62097272	.	T	C	1	2	3	0	0	3	0	0
3	62097300	.	A	T	3	3	6	0	0	6	0	0
3	62097399	.	C	T	1	9	10	0	0	10	0	0
3	62097490	.	A	T	8	2	10	0	1	11	0	0
3	62097548	.	A	T	12	3	15	0	1	16	0	0
3	62114615	.	C	T	0	2	2	0	4	6	0	0
3	62114663	.	C	T	1	3	4	0	0	4	0	0
3	62117187	.	C	T	2	5	7	0	1	8	0	0
3	62137708	.	C	T	10	3	13	0	1	14	0	0
3	62147737	.	G	A	2	7	9	0	2	11	0	0
3	62149774	.	C	T	3	10	13	0	1	14	0	0
3	62173503	.	G	T	3	9	12	0	0	12	0	0
3	62173546	.	C	T	3	10	13	0	0	14	1	0
3	62173593	.	T	C	9	9	18	0	1	19	0	0
3	62173628	.	T	C	8	7	15	0	2	17	0	0
3	62180788	.	G	A	6	2	8	0	1	9	0	0
3	62188877	.	A	G	3	3	6	0	0	6	0	0
3	62188883	.	G	A	3	3	6	0	0	6	0	0
3	62190595	.	C	T	4	1	5	0	0	5	0	0
3	62190599	.	C	T	4	2	6	0	0	6	0	0
3	62196977	.	C	T	7	8	15	0	0	15	0	0
3	62202171	.	T	C	1	9	10	0	1	11	0	0
3	62203509	.	G	A	8	8	16	0	2	18	0	0
3	62208678	.	C	T	3	4	7	0	0	7	0	0
3	62209183	.	A	G	4	0	4	0	3	7	0	0
3	62209216	.	A	G	3	3	6	0	0	6	0	0
3	62209325	.	A	G	2	4	6	0	0	6	0	0
3	62238997	.	T	G	3	0	3	0	7	10	0	0
3	62275415	.	T	A	5	2	7	0	1	8	0	0
3	62275507	.	T	A	4	3	7	0	0	7	0	0
3	62275598	.	G	A	3	3	6	0	1	7	0	0
3	62275661	.	G	A	0	2	2	1	2	5	0	0
3	62275743	.	T	C	2	3	5	0	0	5	0	0
3	62275855	.	G	C	2	3	5	0	1	6	0	0
3	62276009	.	A	T	2	4	6	0	0	6	0	0
3	62276101	.	G	A	5	3	8	0	0	8	0	0
3	62276104	.	A	G	4	3	7	0	0	7	0	0
3	62323384	.	G	A	4	2	6	1	1	8	0	0
3	62323579	.	A	G	7	0	7	1	3	11	0	0
3	62323648	.	G	A	5	4	9	0	0	9	0	0
3	62324282	.	A	C	1	2	3	0	0	3	0	0
3	62324426	.	A	G	2	2	4	0	0	4	0	0
3	62328846	.	G	C	7	5	12	0	0	12	0	0
3	62328970	.	A	G	7	2	9	0	0	9	0	0
3	62329097	.	G	C	2	4	6	0	1	7	0	0
3	62329545	.	G	T	9	5	14	0	1	15	0	0
3	62345471	.	A	T	3	2	5	1	2	8	0	0
3	62345588	.	T	A	1	4	5	0	0	5	0	0
3	62345770	.	A	T	4	3	7	0	1	8	0	0
3	62346026	.	C	A	2	2	4	0	0	4	0	0
3	62353679	.	G	T	2	2	4	0	0	4	0	0
3	62359440	.	G	T	12	13	25	0	1	26	0	0
3	62360484	.	C	T	16	20	36	0	1	37	0	0
3	62360686	.	G	A	5	3	8	0	0	8	0	0
3	62360736	.	C	A	6	2	8	0	0	8	0	0
3	62369864	.	G	A	9	11	20	0	1	21	0	0
3	62370068	.	A	G	8	7	15	0	1	16	0	0
3	62370476	.	G	A	8	9	17	0	0	17	0	0
3	62379739	.	C	T	3	7	10	0	3	13	0	0
3	62382863	.	A	G	37	27	64	0	2	66	0	0
3	62383314	.	T	G	51	11	62	0	1	63	0	0
3	62383315	.	G	T	50	11	61	0	2	63	0	0
3	62383438	.	G	A	27	29	56	0	3	59	0	0
3	62383439	.	A	G	28	27	55	0	5	60	0	0
3	62383565	.	T	A	29	20	49	0	1	50	0	0
3	62383589	.	A	C	28	19	47	3	4	54	0	0
3	62383610	.	G	C	34	1	35	3	18	56	0	0
3	62383706	.	C	T	38	19	57	0	3	60	0	0
3	62383992	.	C	G	14	13	27	3	0	30	0	0
3	62384055	.	G	A	14	14	28	7	1	36	0	0
3	62384112	.	T	A	5	5	10	1	1	12	0	0
3	62384208	.	C	T	4	38	42	0	17	59	0	0
3	62384219	.	G	A	45	8	53	0	3	56	0	0
3	62384423	.	C	G	36	27	63	0	1	64	0	0
3	62384428	.	T	A	33	27	60	0	5	65	0	0
3	62384565	.	C	G	37	18	55	1	2	58	0	0
3	62386420	.	T	C	29	1	30	0	23	53	0	0
3	62386955	.	G	T	24	26	50	0	2	52	0	0
3	62387141	.	C	T	4	17	21	0	22	43	0	0
3	62387144	.	C	T	23	17	40	0	3	43	0	0
3	62389677	.	A	C	4	2	6	0	1	7	0	0
3	62389681	.	A	C	3	4	7	0	0	7	0	0
3	62393297	.	T	C	19	5	24	0	1	25	0	0
3	62393321	.	G	A	21	8	29	0	1	30	0	0
3	62393337	.	C	T	26	8	34	0	1	35	0	0
3	62433064	.	C	T	12	5	17	0	0	17	0	0
3	62433138	.	T	G	6	8	14	0	0	14	0	0
3	62521137	.	G	A	7	3	10	0	0	10	0	0
3	62521142	.	T	C	7	0	7	0	5	12	0	0
3	62521263	.	T	A	16	14	30	0	0	30	0	0
3	62521956	.	G	A	8	11	19	0	1	20	0	0
3	62522063	.	A	T	13	9	22	0	1	23	0	0
3	62522065	.	G	T	12	10	22	0	0	22	0	0
3	62522238	.	A	G	5	4	9	0	0	9	0	0
3	62522742	.	C	A	2	8	10	0	2	12	0	0
3	62522750	.	G	C	10	4	14	0	0	14	0	0
3	62522804	.	C	T	0	10	10	0	5	15	0	0
3	62522899	.	C	G	10	7	17	0	1	18	0	0
3	62523031	.	A	G	3	16	19	1	1	21	0	0
3	62523032	.	A	T	16	4	20	1	0	21	0	0
3	62523325	.	G	T	8	12	20	0	1	21	0	0
3	62523502	.	G	A	3	7	10	0	1	11	0	0
3	62523550	.	C	T	2	6	8	0	1	9	0	0
3	62527533	.	C	A	1	4	5	0	1	8	2	0
4	316946	.	A	T	22	14	36	0	4	40	0	0
4	317091	.	A	G	11	24	35	0	1	36	0	0
4	317217	.	T	A	14	11	25	0	0	26	1	0
4	317275	.	G	T	4	10	14	0	1	15	0	0
4	317938	.	G	A	3	2	5	0	1	6	0	0
4	325161	.	A	C	11	0	11	0	8	19	0	0
4	329743	.	G	A	13	9	22	0	0	22	0	0
4	329746	.	A	G	12	8	20	0	0	20	0	0
4	349298	.	T	C	3	3	6	0	0	6	0	0
4	349304	.	A	G	2	2	4	0	1	5	0	0
4	349490	.	A	C	3	4	7	0	1	8	0	0
4	349514	.	T	C	2	4	6	0	1	7	0	0
4	351055	.	G	A	2	7	9	0	0	9	0	0
4	351840	.	G	C	2	5	7	0	0	7	0	0
4	351845	.	A	C	2	5	7	0	0	7	0	0
4	352284	.	A	G	10	0	10	0	7	17	0	0
4	352289	.	T	C	10	6	16	0	1	17	0	0
4	352504	.	T	C	7	8	15	0	0	15	0	0
4	353049	.	A	T	7	5	12	0	1	13	0	0
4	353064	.	C	G	7	5	12	0	0	12	0	0
4	353238	.	T	G	7	0	7	0	3	10	0	0
4	353247	.	T	C	7	3	10	0	0	10	0	0
4	353379	.	A	T	6	7	13	0	3	16	0	0
4	353481	.	A	G	6	0	6	0	5	11	0	0
4	353638	.	C	T	5	4	9	0	1	10	0	0
4	353778	.	T	A	1	6	7	0	0	7	0	0
4	358080	.	T	C	6	4	10	0	0	10	0	0
4	362282	.	C	T	4	4	8	0	0	8	0	0
4	376379	.	A	G	4	0	4	1	10	15	0	0
4	385092	.	C	T	18	9	27	0	7	34	0	0
4	385625	.	A	T	3	4	7	0	1	8	0	0
4	385668	.	G	A	8	6	14	0	0	14	0	0
4	385710	.	T	C	15	8	23	0	0	23	0	0
4	386014	.	A	C	20	4	24	0	4	28	0	0
4	386037	.	T	G	19	9	28	0	1	29	0	0
4	386085	.	G	A	13	9	22	0	1	23	0	0
4	386124	.	C	A	4	5	9	0	6	15	0	0
4	386537	.	T	A	23	20	43	1	4	48	0	0
4	386538	.	T	A	28	17	45	1	6	53	1	0
4	386717	.	G	C	33	0	33	0	4	37	0	0
4	386839	.	A	G	32	0	32	0	6	38	0	0
4	394020	.	T	C	40	28	68	0	4	73	1	0
4	397913	.	A	G	6	4	10	0	1	11	0	0
4	647752	.	G	T	8	9	17	0	1	18	0	0
4	659276	.	C	T	11	8	19	0	1	20	0	0
4	659345	.	T	C	4	5	9	0	0	9	0	0
4	660571	.	G	A	7	4	11	0	0	11	0	0
4	660649	.	T	A	9	6	15	0	1	16	0	0
4	660655	.	G	A	1	5	6	0	10	16	0	0
4	660715	.	T	C	11	4	15	0	0	15	0	0
4	667358	.	T	C	11	9	20	0	0	20	0	0
4	667382	.	A	G	12	0	12	0	5	17	0	0
4	674838	.	T	C	19	12	31	0	1	32	0	0
4	676885	.	A	G	15	8	23	0	1	24	0	0
4	676942	.	A	G	11	5	16	0	1	17	0	0
4	678853	.	C	T	10	11	21	0	0	21	0	0
4	679441	.	C	G	0	13	13	0	18	31	0	0
4	680314	.	G	T	11	5	16	0	2	18	0	0
4	680320	.	C	T	9	6	15	0	0	15	0	0
4	680359	.	C	T	15	5	20	0	1	21	0	0
4	680395	.	T	C	20	0	20	0	5	25	0	0
4	680404	.	G	A	17	8	25	0	1	26	0	0
4	681595	.	G	A	7	8	15	0	1	16	0	0
4	687083	.	A	G	6	0	6	0	4	10	0	0
4	694254	.	T	C	3	5	8	0	1	9	0	0
4	694680	.	A	C	2	6	8	0	0	8	0	0
4	694718	.	G	A	2	9	11	0	0	11	0	0
4	694741	.	T	G	3	9	12	0	0	12	0	0
4	694757	.	A	T	4	10	14	0	0	14	0	0
4	695367	.	C	T	5	3	8	0	1	9	0	0
4	700281	.	A	C	8	11	19	0	3	22	0	0
4	700284	.	G	T	0	11	11	0	12	23	0	0
4	700563	.	G	T	7	3	10	0	1	11	0	0
4	700569	.	G	A	3	4	7	0	6	13	0	0
4	700598	.	A	T	4	4	8	0	1	9	0	0
4	700606	.	T	C	5	4	9	0	0	9	0	0
4	700634	.	A	C	6	2	8	0	0	8	0	0
4	702061	.	C	G	2	6	8	0	0	8	0	0
4	702130	.	G	A	2	15	17	0	0	17	0	0
4	702138	.	C	A	2	13	15	0	0	15	0	0
4	736442	.	A	G	11	14	25	0	0	25	0	0
4	737636	.	A	T	8	3	11	0	0	11	0	0
4	737811	.	A	G	7	4	11	0	0	11	0	0
4	737883	.	T	A	4	6	10	0	0	10	0	0
4	737927	.	T	G	6	9	15	0	2	17	0	0
4	740435	.	A	T	11	9	20	0	0	20	0	0
4	740921	.	T	C	5	3	8	0	0	8	0	0
4	740965	.	T	G	5	4	9	0	0	9	0	0
4	749803	.	G	A	18	13	31	0	2	33	0	0
4	749989	.	G	T	14	11	25	0	0	25	0	0
4	750016	.	T	C	11	0	11	0	6	17	0	0
4	750526	.	C	G	12	9	21	0	0	21	0	0
4	750531	.	C	T	11	9	20	0	1	21	0	0
4	750661	.	C	T	0	9	9	0	6	15	0	0
4	751275	.	A	G	4	10	14	0	0	14	0	0
4	751546	.	G	A	9	8	17	0	1	18	0	0
4	751553	.	C	T	8	8	16	0	0	16	0	0
4	751640	.	T	G	11	5	16	0	1	17	0	0
4	753723	.	T	C	4	0	4	0	6	10	0	0
4	755539	.	C	T	8	4	12	0	0	12	0	0
4	757405	.	C	T	3	3	6	0	0	6	0	0
4	760555	.	G	T	3	2	5	1	0	6	0	0
4	765112	.	A	G	11	9	20	0	1	21	0	0
4	766575	.	G	A	8	7	15	0	0	15	0	0
4	766588	.	G	A	6	6	12	0	0	12	0	0
4	766613	.	A	C	5	6	11	0	0	11	0	0
4	769533	.	A	T	6	5	11	0	0	11	0	0
4	769726	.	G	A	10	8	18	1	1	20	0	0
4	772363	.	C	T	12	14	26	0	3	29	0	0
4	776550	.	G	T	3	5	8	0	0	8	0	0
4	777976	.	A	G	7	5	12	0	0	12	0	0
4	778111	.	G	A	8	4	12	0	1	13	0	0
4	779310	.	G	A	8	6	14	0	0	14	0	0
4	779363	.	T	C	5	0	5	0	11	16	0	0
4	779429	.	A	G	11	6	17	0	1	18	0	0
4	779442	.	G	A	14	7	21	0	0	21	0	0
4	779523	.	T	C	1	4	5	0	0	5	0	0
4	783816	.	G	T	23	18	41	0	0	41	0	0
4	783835	.	A	G	21	18	39	0	3	42	0	0
4	784002	.	T	A	26	21	47	0	1	48	0	0
4	784177	.	T	C	24	25	49	0	5	54	0	0
4	784325	.	A	T	12	16	28	0	0	28	0	0
4	784373	.	T	A	6	10	16	0	1	18	1	0
4	784435	.	G	T	4	7	11	0	1	12	0	0
4	784472	.	T	C	4	3	7	0	0	7	0	0
4	784473	.	A	C	4	3	7	0	0	7	0	0
4	784558	.	G	A	2	2	4	0	0	4	0	0
4	784642	.	G	A	6	3	9	0	0	9	0	0
4	784733	.	T	A	5	4	9	0	0	9	0	0
4	784854	.	C	A	1	5	6	0	0	6	0	0
4	785060	.	T	A	25	7	32	0	1	33	0	0
4	785132	.	G	A	21	23	44	0	3	47	0	0
4	787098	.	T	G	3	0	3	1	14	18	0	0
4	788970	.	G	C	17	0	17	0	20	37	0	0
4	789589	.	A	G	16	12	28	0	0	28	0	0
4	798743	.	G	C	3	4	7	0	0	7	0	0
4	798804	.	G	A	10	6	16	0	3	19	0	0
4	798850	.	A	C	13	12	25	0	0	25	0	0
4	798861	.	G	T	12	15	27	0	1	28	0	0
4	799006	.	G	T	21	18	39	0	1	40	0	0
4	799090	.	T	C	20	8	28	0	2	30	0	0
4	799127	.	T	G	14	13	27	0	1	28	0	0
4	799245	.	G	A	12	12	24	0	0	24	0	0
4	799475	.	A	G	17	8	25	0	0	25	0	0
4	799513	.	G	A	12	20	32	0	2	34	0	0
4	799620	.	C	T	20	18	38	0	0	38	0	0
4	799643	.	T	A	16	20	36	0	3	39	0	0
4	799933	.	C	T	19	21	40	0	0	40	0	0
4	800027	.	C	T	16	11	27	0	0	27	0	0
4	800094	.	A	G	24	11	35	0	2	37	0	0
4	800113	.	A	G	24	14	38	0	1	39	0	0
4	800363	.	C	T	6	20	26	0	28	54	0	0
4	800520	.	T	C	23	22	45	0	1	46	0	0
4	802909	.	T	A	18	24	42	0	4	46	0	0
4	803862	.	T	C	11	0	11	0	25	36	0	0
4	806319	.	G	A	14	13	27	0	0	27	0	0
4	806322	.	T	C	13	12	25	0	1	26	0	0
4	807895	.	C	G	14	10	24	0	3	27	0	0
4	807898	.	A	G	11	12	23	0	3	26	0	0
4	808031	.	C	T	23	14	37	0	1	38	0	0
4	808421	.	A	G	11	12	23	0	3	26	0	0
4	809456	.	A	G	8	21	29	0	1	30	0	0
4	809512	.	T	C	15	0	15	0	18	33	0	0
4	809549	.	A	G	11	5	16	0	0	16	0	0
4	813157	.	G	A	11	10	21	0	3	24	0	0
4	813226	.	A	G	12	13	25	0	1	26	0	0
4	819146	.	C	A	1	2	3	0	0	3	0	0
4	819166	.	C	A	1	2	3	0	0	3	0	0
4	864324	.	T	A	3	5	8	0	0	8	0	0
4	864712	.	C	T	6	3	9	0	1	10	0	0
4	864739	.	G	C	4	4	8	0	0	8	0	0
4	867454	.	A	G	2	5	7	0	1	8	0	0
4	870833	.	C	T	0	2	2	0	4	6	0	0
4	870876	.	C	T	5	3	8	0	0	8	0	0
4	872356	.	A	G	2	2	4	0	0	4	0	0
4	873704	.	G	A	1	3	4	0	0	4	0	0
4	873763	.	C	G	6	4	10	0	0	10	0	0
4	874241	.	G	T	3	4	7	0	1	8	0	0
4	880033	.	A	G	3	2	5	0	0	5	0	0
4	880423	.	G	C	3	2	5	0	0	5	0	0
4	880692	.	T	G	2	2	4	0	1	5	0	0
4	880693	.	G	T	3	2	5	0	0	5	0	0
4	880890	.	C	G	3	3	6	0	0	6	0	0
4	881180	.	G	A	1	3	4	0	0	4	0	0
4	881497	.	A	C	1	2	3	0	0	3	0	0
4	905713	.	C	G	2	2	4	0	0	4	0	0
4	905801	.	A	C	1	2	3	0	0	3	0	0
4	958978	.	A	T	3	3	6	0	0	6	0	0
4	961542	.	G	A	6	4	10	0	0	10	0	0
4	963452	.	A	G	6	3	9	0	0	9	0	0
4	967974	.	C	T	7	6	13	0	0	13	0	0
4	968001	.	G	A	0	4	4	0	7	11	0	0
4	968121	.	T	C	3	7	10	0	0	10	0	0
4	969475	.	A	T	6	4	10	0	0	10	0	0
4	969486	.	T	G	6	0	6	0	6	12	0	0
4	970689	.	A	G	4	0	4	0	5	9	0	0
4	971765	.	A	G	3	5	8	0	0	8	0	0
4	971842	.	G	C	2	3	5	0	9	15	1	0
4	974482	.	C	T	9	5	14	1	1	16	0	0
4	975735	.	G	C	0	9	9	0	13	22	0	0
4	975758	.	C	T	8	14	22	0	0	22	0	0
4	975792	.	G	C	0	4	4	0	14	18	0	0
4	975938	.	T	C	13	10	23	0	1	24	0	0
4	982892	.	G	A	7	6	13	0	1	14	0	0
4	982893	.	T	C	7	5	12	0	0	12	0	0
4	982938	.	C	G	2	3	5	0	1	6	0	0
4	986210	.	T	C	1	3	4	0	0	4	0	0
4	986350	.	C	A	2	5	7	0	5	12	0	0
4	1054775	.	G	A	13	18	31	0	0	31	0	0
4	1054866	.	G	T	29	5	34	1	8	44	1	0
4	1054868	.	G	A	34	5	39	1	5	45	0	0
4	1055724	.	C	T	22	28	50	0	2	52	0	0
4	1055770	.	A	G	29	19	48	0	0	48	0	0
4	1146384	.	T	C	2	4	6	0	0	6	0	0
4	1146466	.	G	C	3	2	5	0	0	5	0	0
4	1283626	.	T	C	4	2	6	0	0	6	0	0
4	1283707	.	C	T	2	3	5	0	0	5	0	0
4	1301582	.	G	A	1	5	6	0	0	6	0	0
4	1302059	.	T	C	3	0	3	0	4	7	0	0
4	1302078	.	T	A	3	3	6	1	0	7	0	0
4	1302155	.	A	G	4	4	8	0	1	9	0	0
4	1302437	.	A	G	4	2	6	0	0	6	0	0
4	1302485	.	T	C	2	0	2	0	2	4	0	0
4	1302488	.	T	C	2	0	2	0	2	4	0	0
4	1302584	.	A	G	4	4	8	0	0	8	0	0
4	1302609	.	A	G	3	3	6	0	0	6	0	0
4	1302624	.	A	G	3	2	5	0	0	5	0	0
4	1302702	.	C	A	2	6	8	0	0	8	0	0
4	1302785	.	C	T	1	2	3	0	0	3	0	0
4	1389106	.	C	T	13	9	22	0	2	24	0	0
4	1390926	.	C	T	11	7	18	0	1	19	0	0
4	1392957	.	G	A	11	5	16	0	0	16	0	0
4	1393032	.	T	A	6	7	13	0	0	13	0	0
4	1393062	.	A	G	5	7	12	0	0	12	0	0
4	1396176	.	C	T	11	13	24	0	1	25	0	0
4	1469788	.	T	C	3	3	6	0	0	6	0	0
4	1470380	.	C	A	22	10	32	0	0	32	0	0
4	1470853	.	T	C	6	2	8	0	0	8	0	0
4	1470854	.	T	C	5	3	8	0	0	8	0	0
4	1479855	.	C	A	5	4	9	0	0	9	0	0
4	1497159	.	G	A	10	5	15	0	0	15	0	0
4	1497211	.	A	G	6	2	8	0	0	8	0	0
4	1563938	.	T	A	3	4	7	0	0	7	0	0
4	1565405	.	C	A	3	3	6	0	0	6	0	0
4	1565673	.	T	C	5	4	9	0	1	10	0	0
4	1566427	.	C	A	9	4	13	0	0	13	0	0
4	1566501	.	T	C	3	3	6	0	0	6	0	0
4	1566502	.	T	G	3	0	3	0	3	6	0	0
4	1734759	.	T	C	1	0	1	0	3	4	0	0
4	1832229	.	T	C	6	0	6	0	5	11	0	0
4	1834169	.	C	G	4	6	10	0	0	10	0	0
4	1834190	.	G	A	4	3	7	0	0	7	0	0
4	1835801	.	C	T	3	4	7	0	0	7	0	0
4	1835950	.	G	T	3	3	6	0	0	6	0	0
4	1835982	.	T	C	2	3	5	0	0	5	0	0
4	1837647	.	A	T	2	4	6	0	0	6	0	0
4	1839142	.	T	C	7	5	12	0	0	12	0	0
4	1988778	.	T	A	2	3	5	0	1	6	0	0
4	1988856	.	T	C	4	1	5	2	5	12	0	0
4	1988988	.	A	C	3	0	3	0	3	6	0	0
4	1994560	.	A	T	2	2	4	0	0	4	0	0
4	1997528	.	C	T	1	5	6	0	2	8	0	0
4	1997549	.	G	A	2	5	7	0	0	7	0	0
4	1999461	.	A	T	2	3	5	0	0	5	0	0
4	1999473	.	A	G	4	2	6	0	0	6	0	0
4	2014198	.	T	C	5	2	7	0	0	7	0	0
4	2036617	.	C	A	0	2	2	0	3	5	0	0
4	2044213	.	A	G	12	11	23	0	0	23	0	0
4	2044222	.	T	C	12	0	12	0	14	26	0	0
4	2044359	.	A	C	16	14	30	0	3	33	0	0
4	2044379	.	T	A	16	20	36	0	3	39	0	0
4	2044409	.	A	G	23	22	45	0	2	47	0	0
4	2044517	.	A	G	14	18	32	0	0	32	0	0
4	2044541	.	T	C	12	0	12	0	19	31	0	0
4	2045000	.	T	A	2	2	4	0	1	5	0	0
4	2051929	.	T	G	24	19	43	0	3	46	0	0
4	2055019	.	G	A	11	17	28	0	2	30	0	0
4	2055318	.	G	A	23	12	35	0	3	38	0	0
4	2056055	.	A	C	7	0	7	0	17	24	0	0
4	2056607	.	G	A	17	15	32	0	1	33	0	0
4	2060125	.	T	C	13	7	20	0	3	23	0	0
4	2060134	.	C	T	7	13	20	1	0	21	0	0
4	2061214	.	G	A	15	16	31	0	1	32	0	0
4	2061217	.	G	A	17	14	31	0	1	32	0	0
4	2062085	.	A	G	10	11	21	0	0	21	0	0
4	2062088	.	G	A	11	11	22	0	0	22	0	0
4	2151664	.	T	A	7	8	15	0	1	16	0	0
4	2151743	.	G	A	5	6	11	0	0	11	0	0
4	2160995	.	G	A	5	9	14	1	0	15	0	0
4	2162639	.	G	A	8	6	14	0	1	15	0	0
4	2162726	.	C	G	1	5	6	0	8	14	0	0
4	2162798	.	G	A	14	13	27	0	0	27	0	0
4	2162804	.	A	G	14	15	29	0	1	30	0	0
4	2163383	.	T	C	4	0	4	0	6	10	0	0
4	2210437	.	T	G	7	10	17	0	0	17	0	0
4	2210459	.	C	T	7	10	17	0	1	18	0	0
4	2210499	.	T	C	11	0	11	0	7	18	0	0
4	2210517	.	C	T	15	6	21	0	0	21	0	0
4	2210553	.	A	G	10	12	22	0	2	24	0	0
4	2210583	.	A	G	6	15	21	0	1	22	0	0
4	2259067	.	G	A	5	3	8	0	1	9	0	0
4	2259071	.	T	C	3	0	3	0	7	10	0	0
4	2259851	.	G	T	9	3	12	0	1	13	0	0
4	2260515	.	T	C	9	0	9	0	5	14	0	0
4	2261176	.	A	G	5	3	8	0	0	8	0	0
4	2265201	.	G	A	4	3	7	0	1	8	0	0
4	2349386	.	G	A	3	10	13	0	0	13	0	0
4	2349391	.	C	T	1	10	11	0	1	12	0	0
4	2349527	.	A	G	12	9	21	0	0	21	0	0
4	2349542	.	A	T	11	10	21	0	0	21	0	0
4	2349576	.	A	C	7	5	12	0	0	12	0	0
4	2349656	.	T	C	3	5	8	0	1	9	0	0
4	2349798	.	G	A	9	8	17	0	0	17	0	0
4	2349805	.	G	T	8	7	15	0	0	15	0	0
4	2361733	.	G	A	29	21	50	0	0	50	0	0
4	2361835	.	T	C	30	0	30	0	20	50	0	0
4	2362945	.	C	A	3	20	23	0	26	49	0	0
4	2396616	.	C	T	5	6	11	0	1	12	0	0
4	2402861	.	G	A	2	3	5	0	0	5	0	0
4	2404872	.	A	G	1	3	4	0	0	4	0	0
4	2412025	.	A	G	2	3	5	0	1	6	0	0
4	2497044	.	T	C	5	8	13	0	0	13	0	0
4	2666037	.	T	C	1	0	1	0	3	4	0	0
4	2705726	.	G	A	1	4	5	0	0	5	0	0
4	3337690	.	A	G	0	3	3	0	1	4	0	0
4	3338195	.	A	G	1	2	3	0	1	4	0	0
4	4090438	.	C	T	3	3	6	0	1	7	0	0
4	4098479	.	T	A	13	5	18	0	2	20	0	0
4	4104264	.	A	G	11	0	11	0	10	21	0	0
4	4106546	.	T	G	5	6	11	0	5	16	0	0
4	4111070	.	A	G	4	6	10	0	0	10	0	0
4	4111180	.	C	T	2	5	7	0	0	7	0	0
4	4111396	.	T	C	14	7	21	0	0	21	0	0
4	4111673	.	G	A	3	4	7	0	0	7	0	0
4	4117480	.	T	C	2	4	6	0	0	6	0	0
4	4117730	.	T	C	1	0	1	0	3	4	0	0
4	4117876	.	G	A	1	3	4	0	0	4	0	0
4	4117893	.	C	T	0	2	2	0	1	3	0	0
4	4119065	.	C	T	0	4	4	0	1	5	0	0
4	4119344	.	G	A	1	2	3	0	0	3	0	0
4	4119368	.	G	A	1	3	4	0	0	4	0	0
4	4232578	.	T	A	5	2	7	0	0	7	0	0
4	4232705	.	A	T	4	5	9	0	0	9	0	0
4	4232886	.	C	G	2	0	2	0	4	6	0	0
4	4232994	.	T	C	2	5	7	0	0	7	0	0
4	4235162	.	A	G	24	13	37	0	4	41	0	0
4	4238175	.	C	T	1	17	18	0	23	41	0	0
4	4240177	.	T	C	6	25	31	0	1	32	0	0
4	4243084	.	G	A	10	18	28	0	2	30	0	0
4	4249690	.	G	A	3	14	17	0	2	19	0	0
4	4258884	.	A	G	4	13	17	0	1	18	0	0
4	4258927	.	T	C	9	12	21	0	1	22	0	0
4	4258951	.	C	T	10	13	23	0	1	24	0	0
4	4291289	.	A	C	1	3	4	0	0	4	0	0
4	4329022	.	G	A	0	3	3	0	1	4	0	0
4	4331151	.	C	T	5	4	9	0	1	10	0	0
4	4348785	.	C	T	8	4	12	0	0	12	0	0
4	4348902	.	A	G	7	0	7	0	5	12	0	0
4	4355714	.	C	T	4	7	11	0	2	13	0	0
4	4355791	.	G	T	2	7	9	0	8	17	0	0
4	4357016	.	T	C	6	7	13	0	0	13	0	0
4	4357023	.	G	T	8	4	12	0	0	12	0	0
4	4357073	.	A	G	7	10	17	0	1	18	0	0
4	4357173	.	C	T	6	8	14	1	1	16	0	0
4	4357175	.	G	A	6	9	15	1	0	16	0	0
4	4357939	.	C	T	7	2	9	0	0	9	0	0
4	4358201	.	G	A	2	2	4	6	0	10	0	0
4	4358471	.	C	T	13	8	21	0	0	21	0	0
4	4358536	.	A	G	7	4	11	0	1	12	0	0
4	4358610	.	C	A	12	12	24	0	0	24	0	0
4	4484788	.	A	G	19	11	30	0	1	31	0	0
4	4484914	.	T	A	17	10	27	0	1	28	0	0
4	4485186	.	A	T	22	18	40	0	5	45	0	0
4	4485247	.	A	T	22	16	38	0	0	38	0	0
4	4485306	.	T	C	14	22	36	0	4	43	3	0
4	4485534	.	C	A	13	13	26	0	2	28	0	0
4	4485650	.	A	T	12	10	22	0	1	24	1	0
4	4485736	.	T	G	9	12	21	0	1	22	0	0
4	4485793	.	C	G	10	16	26	0	0	26	0	0
4	4488137	.	A	G	13	8	21	0	1	22	0	0
4	4488207	.	G	A	11	12	23	0	1	24	0	0
4	4491740	.	T	C	2	0	2	0	8	10	0	0
4	4491782	.	T	C	4	0	4	0	9	13	0	0
4	4492003	.	C	T	9	12	21	0	0	21	0	0
4	4492336	.	A	G	9	7	16	0	2	18	0	0
4	4492369	.	C	A	0	11	11	0	3	14	0	0
4	4492444	.	A	G	12	6	18	0	0	18	0	0
4	4492456	.	T	C	10	0	10	0	10	20	0	0
4	4494733	.	C	A	9	5	14	0	1	15	0	0
4	4495334	.	G	A	6	6	12	1	0	14	1	0
4	4510097	.	A	G	5	0	5	0	6	11	0	0
4	4514215	.	A	G	7	0	7	0	6	13	0	0
4	4516310	.	G	C	1	7	8	0	12	20	0	0
4	4516313	.	A	G	11	0	11	0	10	21	0	0
4	4516346	.	C	T	13	8	21	0	0	21	0	0
4	4519688	.	G	A	11	14	25	0	2	27	0	0
4	4519697	.	T	C	14	13	27	0	1	28	0	0
4	4523403	.	C	G	21	24	45	0	1	46	0	0
4	4523579	.	T	C	26	31	57	0	2	59	0	0
4	4523885	.	A	C	16	8	24	0	2	26	0	0
4	4524215	.	T	A	2	3	5	0	0	5	0	0
4	4635691	.	C	G	18	10	28	0	2	30	0	0
4	4638701	.	G	C	12	0	12	0	13	25	0	0
4	4640605	.	G	A	16	14	30	0	1	31	0	0
4	4640614	.	G	A	14	14	28	0	0	28	0	0
4	4647977	.	A	G	14	16	30	0	0	30	0	0
4	4653380	.	A	C	15	0	15	0	11	26	0	0
4	4657961	.	G	A	8	12	20	0	1	21	0	0
4	4706687	.	G	T	9	10	19	0	1	20	0	0
4	4706819	.	C	T	1	6	7	0	16	23	0	0
4	4706825	.	C	G	13	7	20	0	2	22	0	0
4	4712951	.	G	A	4	3	7	0	0	7	0	0
4	4714590	.	T	C	1	1	2	0	1	3	0	0
4	4723887	.	A	C	1	0	1	0	2	3	0	0
4	4753372	.	T	A	7	5	12	0	0	12	0	0
4	4754474	.	A	G	15	8	23	0	0	23	0	0
4	4755605	.	G	T	11	6	17	1	0	18	0	0
4	4755627	.	G	T	7	5	12	1	0	13	0	0
4	4758291	.	C	A	2	2	4	0	0	4	0	0
4	4758452	.	T	C	4	0	4	0	5	9	0	0
4	4758458	.	A	G	3	5	8	0	1	9	0	0
4	4760581	.	C	T	2	7	9	0	0	9	0	0
4	4762804	.	T	A	4	3	7	0	1	8	0	0
4	4780448	.	C	T	4	5	9	0	0	9	0	0
4	4782880	.	C	G	1	2	3	0	0	3	0	0
4	4782962	.	A	C	9	7	16	0	0	16	0	0
4	4783020	.	C	T	1	7	8	0	6	14	0	0
4	4783059	.	A	T	9	9	18	0	0	18	0	0
4	4783067	.	C	T	12	10	22	0	0	22	0	0
4	4784802	.	G	A	2	5	7	0	1	8	0	0
4	4786350	.	A	G	5	7	12	0	0	12	0	0
4	4786383	.	G	A	2	5	7	0	0	7	0	0
4	4786443	.	A	C	4	0	4	0	6	10	0	0
4	4831630	.	T	G	2	3	5	0	0	5	0	0
4	4831660	.	G	A	2	2	4	0	1	5	0	0
4	4831722	.	A	C	4	1	5	0	1	6	0	0
4	4831968	.	A	C	4	4	8	0	0	8	0	0
4	4832241	.	A	G	10	7	17	0	0	17	0	0
4	4834125	.	G	A	16	16	32	0	2	34	0	0
4	4834497	.	A	G	8	14	22	0	0	22	0	0
4	4834526	.	T	C	7	9	16	0	0	16	0	0
4	4901602	.	C	T	7	4	11	0	1	12	0	0
4	4901611	.	T	G	7	0	7	0	7	14	0	0
4	4902425	.	G	C	10	10	20	0	1	21	0	0
4	4908409	.	C	T	5	3	8	0	0	8	0	0
4	4911071	.	C	T	11	4	15	0	1	16	0	0
4	4913422	.	C	T	6	9	15	0	0	15	0	0
4	4914832	.	A	G	7	6	13	0	1	14	0	0
4	4921733	.	T	C	14	18	32	0	1	33	0	0
4	4921773	.	G	A	2	14	16	0	17	33	0	0
4	4923290	.	A	T	12	10	22	0	2	24	0	0
4	4923323	.	C	T	14	10	24	0	0	24	0	0
4	4923755	.	T	G	13	17	30	0	0	30	0	0
4	4925611	.	C	T	24	8	32	0	1	33	0	0
4	4971354	.	C	A	8	4	12	0	0	12	0	0
4	4971836	.	T	C	4	3	7	0	0	7	0	0
4	4971847	.	T	A	4	3	7	0	1	8	0	0
4	4971911	.	G	T	5	12	17	0	1	18	0	0
4	4971947	.	A	G	14	4	18	1	0	19	0	0
4	4972056	.	C	T	8	7	15	0	0	15	0	0
4	4972533	.	G	A	14	7	21	0	0	21	0	0
4	4972555	.	G	C	11	9	20	0	1	21	0	0
4	4972664	.	G	T	6	5	11	0	2	13	0	0
4	4973053	.	G	A	11	7	18	0	0	18	0	0
4	4975329	.	C	G	3	6	9	0	0	9	0	0
4	4975597	.	G	A	4	6	10	0	0	10	0	0
4	4980443	.	G	A	3	6	9	0	0	9	0	0
4	4980458	.	C	T	0	5	5	0	3	8	0	0
4	4983209	.	T	C	8	5	13	0	1	14	0	0
4	4983339	.	T	C	3	6	9	0	0	9	0	0
4	4984298	.	G	A	6	2	8	0	0	8	0	0
4	4985789	.	G	A	7	4	11	0	0	11	0	0
4	5006535	.	T	C	2	2	4	0	0	4	0	0
4	5006562	.	G	T	2	2	4	0	0	4	0	0
4	5025964	.	G	C	13	9	22	3	2	27	0	0
4	5026355	.	T	C	18	14	32	0	1	33	0	0
4	5042689	.	T	A	13	13	26	0	1	27	0	0
4	5042755	.	C	T	12	21	33	0	1	34	0	0
4	5048903	.	C	T	14	12	26	0	0	26	0	0
4	5048921	.	A	G	0	20	20	0	1	21	0	0
4	5094237	.	C	T	4	6	10	0	0	10	0	0
4	5097421	.	C	T	0	6	6	0	4	10	0	0
4	5098152	.	G	A	3	6	9	0	0	9	0	0
4	5098507	.	A	G	6	4	10	0	0	10	0	0
4	5102316	.	A	C	3	1	4	0	2	6	0	0
4	5107389	.	G	A	1	2	3	0	0	3	0	0
4	5158749	.	C	T	14	13	27	0	0	27	0	0
4	5161241	.	G	T	11	7	18	0	0	18	0	0
4	5161256	.	A	C	10	8	18	0	3	21	0	0
4	5181042	.	C	T	1	2	3	0	0	3	0	0
4	5200306	.	T	C	1	2	3	0	0	3	0	0
4	5240203	.	A	C	27	2	29	0	21	50	0	0
4	5240265	.	C	T	27	20	47	5	2	54	0	0
4	5240472	.	T	A	33	31	64	0	3	67	0	0
4	5240505	.	A	G	26	34	60	0	2	62	0	0
4	5242055	.	T	G	30	21	51	0	2	53	0	0
4	5242300	.	C	G	38	33	71	0	3	74	0	0
4	5243657	.	C	A	32	32	64	0	7	71	0	0
4	5244568	.	C	A	27	36	63	0	2	65	0	0
4	5244789	.	G	A	33	29	62	0	1	63	0	0
4	5247107	.	G	A	30	22	52	0	0	52	0	0
4	5247127	.	G	C	28	24	52	0	0	52	0	0
4	5247145	.	C	T	3	24	27	0	28	55	0	0
4	5255128	.	C	A	13	9	22	1	0	23	0	0
4	5255148	.	C	T	16	13	29	1	1	31	0	0
4	5255180	.	T	C	14	15	29	0	2	31	0	0
4	5256482	.	A	G	17	10	27	0	1	28	0	0
4	5256659	.	A	G	5	1	6	0	12	18	0	0
4	5256737	.	A	G	4	7	11	0	1	12	0	0
4	5256788	.	G	A	3	3	6	0	0	6	0	0
4	5265594	.	G	A	1	2	3	0	0	3	0	0
4	5269608	.	G	A	35	27	62	0	1	63	0	0
4	5269660	.	C	G	34	33	67	0	1	68	0	0
4	5290944	.	G	A	27	21	48	0	1	49	0	0
4	5290947	.	C	T	25	21	46	0	1	47	0	0
4	5291755	.	T	C	14	25	39	0	3	42	0	0
4	5291794	.	T	C	15	27	42	0	0	42	0	0
4	5302127	.	C	T	3	16	19	0	17	36	0	0
4	5302195	.	A	G	21	21	42	0	1	43	0	0
4	5302327	.	G	A	11	17	28	0	3	31	0	0
4	5302689	.	G	A	7	11	18	0	0	18	0	0
4	5318995	.	G	A	12	14	26	1	2	29	0	0
4	5324871	.	G	T	14	15	29	0	0	29	0	0
4	5325105	.	C	T	11	7	18	0	0	18	0	0
4	5329849	.	G	A	10	4	14	0	0	14	0	0
4	5329850	.	G	A	5	9	14	0	0	14	0	0
4	5330192	.	C	A	6	11	17	0	1	18	0	0
4	5330341	.	C	T	8	5	13	0	0	13	0	0
4	5331720	.	G	A	12	6	18	0	0	18	0	0
4	5334029	.	G	C	4	11	15	0	0	15	0	0
4	5334061	.	G	A	9	13	22	0	1	23	0	0
4	5338909	.	T	A	13	8	21	2	0	26	3	0
4	5338950	.	G	T	14	20	34	0	0	34	0	0
4	5339053	.	T	A	11	15	26	0	2	28	0	0
4	5353978	.	C	T	2	2	4	0	1	5	0	0
4	5360970	.	A	G	2	2	4	0	0	4	0	0
4	5363600	.	G	C	4	3	7	0	0	7	0	0
4	5363744	.	A	C	2	3	5	0	0	5	0	0
4	5363760	.	A	T	1	3	4	0	1	5	0	0
4	5363913	.	C	T	1	4	5	0	0	5	0	0
4	5363921	.	A	C	2	5	7	0	0	7	0	0
4	5364786	.	G	T	2	3	5	0	0	5	0	0
4	5365399	.	G	A	5	8	13	0	0	13	0	0
4	5366663	.	C	T	4	3	7	0	0	7	0	0
4	5366700	.	G	T	1	3	4	0	1	5	0	0
4	5366765	.	G	A	3	2	5	0	0	5	0	0
4	5367455	.	G	A	1	2	3	0	0	3	0	0
4	5421845	.	T	C	4	0	4	0	4	8	0	0
4	5450518	.	C	G	4	3	7	0	0	7	0	0
4	5457025	.	C	T	1	2	3	2	0	5	0	0
4	5521510	.	C	T	17	12	29	0	0	29	0	0
4	5521996	.	G	T	21	7	28	0	0	28	0	0
4	5522154	.	G	T	17	13	30	0	1	31	0	0
4	5522161	.	C	T	11	17	28	0	2	30	0	0
4	5595171	.	C	T	3	2	5	0	0	5	0	0
4	5597604	.	C	A	1	1	2	0	1	3	0	0
4	5597772	.	T	C	3	4	7	0	1	8	0	0
4	5643321	.	G	A	24	13	37	0	0	37	0	0
4	5644808	.	G	A	16	16	32	0	2	34	0	0
4	5644974	.	G	A	7	18	25	0	0	25	0	0
4	5645097	.	C	T	3	6	9	0	1	10	0	0
4	5645116	.	T	G	1	3	4	0	0	4	0	0
4	5665912	.	T	C	4	0	4	0	6	10	0	0
4	5672765	.	G	A	2	3	5	0	0	5	0	0
4	5742551	.	G	A	12	10	22	0	0	22	0	0
4	5742831	.	A	C	11	19	30	0	0	30	0	0
4	5742846	.	C	T	18	9	27	0	1	28	0	0
4	5742936	.	G	A	0	19	19	0	14	33	0	0
4	5742962	.	A	T	11	17	28	0	1	29	0	0
4	5743027	.	A	G	9	9	18	0	0	18	0	0
4	5750854	.	G	A	13	6	19	0	0	19	0	0
4	5750884	.	T	A	6	8	14	0	1	15	0	0
4	5750924	.	A	G	8	3	11	0	0	11	0	0
4	5751381	.	A	C	17	11	28	0	0	28	0	0
4	5751382	.	C	T	0	9	9	0	19	28	0	0
4	5751551	.	G	A	19	7	26	0	2	28	0	0
4	5755018	.	C	T	2	8	10	0	14	24	0	0
4	5755027	.	C	T	1	14	15	0	8	23	0	0
4	5757253	.	C	T	4	12	16	0	1	17	0	0
4	5759617	.	T	G	15	8	23	0	1	24	0	0
4	5763975	.	G	A	9	10	19	0	1	20	0	0
4	5764128	.	T	A	15	9	24	0	2	26	0	0
4	5765985	.	C	A	1	5	6	1	1	8	0	0
4	5766200	.	T	A	1	5	6	0	0	6	0	0
4	5766315	.	G	A	9	7	16	3	0	19	0	0
4	5786267	.	G	T	1	2	3	0	0	3	0	0
4	5806111	.	G	A	1	2	3	0	0	3	0	0
4	5806274	.	T	A	1	2	3	0	0	3	0	0
4	5806312	.	C	A	1	3	4	0	0	4	0	0
4	5834056	.	A	T	0	3	3	0	1	4	0	0
4	5834538	.	A	C	2	2	4	0	0	4	0	0
4	5835612	.	C	T	2	4	6	0	0	6	0	0
4	5835635	.	G	A	6	3	9	0	0	9	0	0
4	5835688	.	T	G	3	5	8	0	1	9	0	0
4	5835733	.	G	A	4	3	7	0	0	7	0	0
4	5838505	.	G	A	6	2	8	0	0	8	0	0
4	5849003	.	C	A	9	17	26	0	0	26	0	0
4	5849180	.	A	G	5	0	5	0	7	12	0	0
4	5849225	.	G	A	7	11	18	0	0	18	0	0
4	5849282	.	C	T	9	4	13	0	0	13	0	0
4	5849768	.	A	G	7	0	7	0	9	16	0	0
4	5850169	.	T	C	4	4	8	0	0	8	0	0
4	5850281	.	T	C	9	4	13	0	0	13	0	0
4	5850297	.	A	G	8	6	14	0	0	14	0	0
4	5850604	.	C	G	2	2	4	0	0	4	0	0
4	5878388	.	G	A	1	2	3	0	0	3	0	0
4	5905677	.	C	T	2	3	5	0	0	5	0	0
4	5905707	.	T	C	2	2	4	0	0	4	0	0
4	5907100	.	C	T	5	4	9	0	0	9	0	0
4	5907145	.	C	T	6	4	10	0	1	11	0	0
4	5907465	.	G	T	0	2	2	0	5	7	0	0
4	5908763	.	T	C	8	4	12	0	0	12	0	0
4	5908764	.	C	T	8	4	12	0	0	12	0	0
4	5910302	.	C	T	3	7	10	0	1	11	0	0
4	5910492	.	A	G	16	7	23	1	11	35	0	0
4	5910644	.	G	A	26	31	57	0	0	57	0	0
4	5912445	.	C	T	12	11	23	0	5	28	0	0
4	5912475	.	G	A	22	13	35	0	1	36	0	0
4	5912707	.	A	G	16	15	31	0	1	32	0	0
4	6436701	.	G	A	11	15	26	0	1	27	0	0
4	6436845	.	G	A	13	12	25	0	1	26	0	0
4	6508320	.	G	A	1	2	3	0	2	5	0	0
4	6508382	.	G	C	2	2	4	0	1	5	0	0
4	6579216	.	C	T	1	3	4	0	0	4	0	0
4	6948909	.	C	T	2	3	5	0	0	5	0	0
4	6948918	.	C	A	3	2	5	0	0	5	0	0
4	6960377	.	C	T	3	2	5	0	0	5	0	0
4	6989731	.	G	A	1	7	8	0	12	20	0	0
4	6991438	.	A	C	4	4	8	1	0	9	0	0
4	6991582	.	C	A	11	5	16	0	0	16	0	0
4	6991975	.	T	A	10	8	18	0	0	18	0	0
4	6992264	.	G	T	19	12	31	0	0	31	0	0
4	6992348	.	C	A	20	15	35	0	2	37	0	0
4	6992744	.	C	T	9	8	17	0	0	17	0	0
4	6992808	.	T	C	11	14	25	0	1	26	0	0
4	7870444	.	A	T	1	2	3	0	0	3	0	0
4	7870599	.	T	C	2	4	6	0	0	6	0	0
4	7870913	.	T	G	7	9	16	0	0	16	0	0
4	7870952	.	C	T	2	5	7	0	3	10	0	0
4	7870983	.	C	T	5	3	8	0	0	8	0	0
4	7871084	.	A	C	5	3	8	0	1	9	0	0
4	7872229	.	A	G	6	6	12	0	1	13	0	0
4	7872637	.	G	A	3	2	5	0	0	5	0	0
4	7875702	.	A	T	6	4	10	0	0	10	0	0
4	7875901	.	T	G	2	2	4	0	1	5	0	0
4	7875917	.	A	T	1	3	4	0	0	4	0	0
4	7876796	.	C	A	6	5	11	0	1	12	0	0
4	7881534	.	C	G	3	0	3	0	11	14	0	0
4	7883462	.	A	C	6	3	9	0	0	9	0	0
4	7883466	.	G	A	6	2	8	0	1	9	0	0
4	7888181	.	A	C	1	5	6	0	2	8	0	0
4	7943958	.	C	T	3	2	5	0	0	5	0	0
4	7959162	.	T	C	4	8	12	0	0	12	0	0
4	8045781	.	A	G	9	11	20	0	2	22	0	0
4	8609608	.	T	A	0	9	9	0	1	10	0	0
4	8609620	.	A	T	7	7	14	0	0	14	0	0
4	8609648	.	G	A	7	7	14	0	0	14	0	0
4	8609799	.	T	C	9	14	23	0	0	23	0	0
4	8680965	.	C	T	11	6	17	0	0	17	0	0
4	8681039	.	C	T	6	6	12	0	0	12	0	0
4	8697245	.	C	T	6	4	10	0	0	11	1	0
4	8697269	.	A	G	6	3	9	0	0	9	0	0
4	8702687	.	G	A	4	4	8	0	2	10	0	0
4	8702729	.	C	A	7	5	12	0	1	13	0	0
4	8702765	.	C	T	7	7	14	0	1	15	0	0
4	8704655	.	C	T	5	6	11	0	0	11	0	0
4	8706385	.	G	A	6	9	15	0	0	15	0	0
4	8706412	.	G	T	5	3	8	0	1	9	0	0
4	8706716	.	A	G	10	15	25	0	1	26	0	0
4	8706855	.	A	T	5	7	12	1	0	13	0	0
4	8707154	.	C	T	11	6	17	0	0	17	0	0
4	8707182	.	T	C	8	4	12	0	0	12	0	0
4	8707381	.	A	G	1	2	3	0	0	3	0	0
4	8755661	.	G	C	5	3	8	0	0	8	0	0
4	8761264	.	T	C	1	3	4	0	0	4	0	0
4	8777050	.	T	G	1	3	4	0	0	4	0	0
4	8780264	.	C	A	2	2	4	0	0	4	0	0
4	8795038	.	C	G	0	2	2	0	2	4	0	0
4	8795167	.	G	A	1	2	3	0	0	3	0	0
4	8797201	.	T	A	24	19	43	0	0	43	0	0
4	8797234	.	T	A	25	18	43	0	4	47	0	0
4	8797315	.	T	C	20	19	39	0	1	40	0	0
4	8803071	.	C	T	23	18	41	0	0	41	0	0
4	8805792	.	T	C	27	30	57	0	2	59	0	0
4	8808775	.	C	T	35	39	74	0	3	77	0	0
4	8808823	.	C	T	31	24	55	0	6	61	0	0
4	8808974	.	C	T	27	22	49	0	2	51	0	0
4	8809268	.	T	G	24	23	47	0	2	49	0	0
4	8809431	.	T	G	5	16	21	0	1	22	0	0
4	8809444	.	T	G	18	7	25	0	1	26	0	0
4	8809506	.	A	T	12	14	26	0	1	27	0	0
4	8809544	.	C	G	16	0	16	0	21	37	0	0
4	8809690	.	G	T	1	13	14	0	2	16	0	0
4	8809695	.	C	T	0	23	23	0	1	24	0	0
4	8809772	.	T	A	1	3	4	1	0	5	0	0
4	8809879	.	T	G	1	3	4	0	0	4	0	0
4	8809985	.	G	T	9	4	13	0	2	15	0	0
4	8810200	.	G	T	12	11	23	0	1	24	0	0
4	8810367	.	A	C	27	20	47	0	2	49	0	0
4	8810474	.	A	T	28	21	49	0	2	51	0	0
4	8810597	.	A	T	18	18	36	0	3	39	0	0
4	8810607	.	C	T	17	16	33	0	4	37	0	0
4	8850984	.	A	G	11	3	14	2	1	17	0	0
4	8851503	.	T	A	11	15	26	0	1	27	0	0
4	8851547	.	A	G	17	23	40	0	0	40	0	0
4	8851740	.	G	A	14	18	32	0	1	33	0	0
4	8851864	.	G	A	7	12	19	0	3	22	0	0
4	8851999	.	C	T	21	9	30	0	1	31	0	0
4	8852085	.	G	T	8	17	25	0	0	25	0	0
4	8854403	.	G	T	17	22	39	0	1	40	0	0
4	8857562	.	T	G	18	14	32	0	0	32	0	0
4	8882297	.	G	T	16	14	30	0	1	31	0	0
4	8898917	.	C	T	1	21	22	0	6	28	0	0
4	8898939	.	G	A	18	7	25	0	1	26	0	0
4	8903051	.	T	A	10	8	18	0	2	20	0	0
4	9012215	.	T	G	8	0	8	0	6	14	0	0
4	9012218	.	T	C	8	6	14	0	0	14	0	0
4	9012258	.	A	T	9	6	15	0	0	15	0	0
4	9017996	.	C	T	8	7	15	0	0	15	0	0
4	9021166	.	T	G	7	11	18	0	0	18	0	0
4	9021369	.	T	C	7	12	19	0	1	20	0	0
4	9024665	.	T	G	13	17	30	0	0	30	0	0
4	9024671	.	A	G	14	15	29	0	1	30	0	0
4	9024720	.	A	C	15	11	26	0	0	26	0	0
4	9024784	.	A	G	15	10	25	0	1	26	0	0
4	9024807	.	A	G	12	11	23	0	1	24	0	0
4	9028868	.	T	C	1	2	3	0	0	3	0	0
4	9045012	.	T	C	3	3	6	0	0	6	0	0
4	9045979	.	C	T	3	5	8	0	0	8	0	0
4	9051762	.	T	A	1	2	3	0	0	3	0	0
4	9051790	.	G	C	1	2	3	0	0	3	0	0
4	9051800	.	A	G	1	2	3	0	0	3	0	0
4	9052184	.	A	G	3	2	5	0	0	5	0	0
4	9052192	.	T	A	3	2	5	0	0	5	0	0
4	9052228	.	C	G	1	4	5	0	2	7	0	0
4	9070929	.	T	G	1	4	5	0	0	5	0	0
4	9085337	.	A	G	8	0	8	0	5	13	0	0
4	9094270	.	G	T	2	6	8	0	0	8	0	0
4	9094347	.	G	A	4	5	9	0	0	9	0	0
4	9094666	.	T	G	2	4	6	0	0	6	0	0
4	9094668	.	T	A	3	2	5	0	2	7	0	0
4	9104173	.	G	C	3	3	6	0	1	7	0	0
4	9104510	.	T	C	5	0	5	0	4	9	0	0
4	9105199	.	T	C	4	1	5	0	3	8	0	0
4	9128095	.	T	C	6	0	6	0	9	15	0	0
4	9173425	.	A	G	2	3	5	0	1	6	0	0
4	9173514	.	T	C	2	2	4	0	1	5	0	0
4	9180680	.	G	A	13	11	24	0	0	24	0	0
4	9180746	.	T	C	15	17	32	0	0	32	0	0
4	9183115	.	T	A	13	13	26	0	1	27	0	0
4	9189969	.	C	T	0	4	4	0	2	6	0	0
4	9192444	.	G	A	5	4	9	0	1	10	0	0
4	9192549	.	G	A	1	2	3	0	1	4	0	0
4	9208383	.	A	G	6	3	9	0	0	9	0	0
4	9209469	.	G	A	5	4	9	0	1	10	0	0
4	9209486	.	G	A	5	3	8	0	0	8	0	0
4	9317959	.	T	C	3	5	8	0	1	9	0	0
4	9329912	.	C	A	6	5	11	0	0	11	0	0
4	9331330	.	G	A	1	12	13	0	7	20	0	0
4	9331495	.	T	G	8	0	8	0	11	19	0	0
4	9333565	.	G	A	0	12	12	0	9	21	0	0
4	9333739	.	A	C	17	20	37	0	0	37	0	0
4	9334180	.	G	C	3	7	10	0	10	20	0	0
4	9334196	.	A	G	10	6	16	0	1	17	0	0
4	9334735	.	A	G	11	1	12	0	5	17	0	0
4	9339140	.	G	A	2	2	4	0	0	4	0	0
4	9339202	.	G	A	7	2	9	0	0	9	0	0
4	9339274	.	C	T	2	4	6	0	0	6	0	0
4	9339316	.	C	T	1	3	4	0	8	12	0	0
4	9372530	.	C	T	2	5	7	0	0	7	0	0
4	9376859	.	A	G	4	0	4	0	6	10	0	0
4	9385390	.	A	G	14	0	14	0	7	21	0	0
4	9386108	.	C	T	14	5	19	0	0	19	0	0
4	9388890	.	C	T	7	3	10	0	0	10	0	0
4	9389003	.	A	C	4	6	10	2	0	12	0	0
4	9389112	.	G	A	5	5	10	0	1	11	0	0
4	9405038	.	G	T	3	2	5	0	0	5	0	0
4	9429583	.	A	T	1	2	3	0	0	3	0	0
4	9429769	.	G	A	2	1	3	0	1	4	0	0
4	9447758	.	C	T	4	2	6	0	1	7	0	0
4	9448634	.	G	A	4	4	8	0	0	8	0	0
4	9448643	.	G	T	6	3	9	0	0	9	0	0
4	9460213	.	A	G	8	0	8	0	5	13	0	0
4	9460603	.	A	C	7	3	10	0	1	11	0	0
4	9461162	.	A	T	1	3	4	0	0	4	0	0
4	9461164	.	C	A	1	3	4	0	0	4	0	0
4	9461286	.	T	C	4	6	10	0	0	10	0	0
4	9461739	.	G	C	2	5	7	0	0	7	0	0
4	9461774	.	A	G	2	3	5	0	0	5	0	0
4	9461946	.	T	A	8	6	14	0	0	14	0	0
4	9462039	.	T	G	4	7	11	0	0	11	0	0
4	9462897	.	A	G	3	0	3	0	5	8	0	0
4	9464057	.	T	A	3	4	7	0	0	7	0	0
4	9464224	.	T	C	4	2	6	0	0	6	0	0
4	9465637	.	A	G	2	3	5	0	0	5	0	0
4	9465832	.	G	T	10	10	20	0	2	22	0	0
4	9465899	.	C	A	12	9	21	0	3	24	0	0
4	9465900	.	C	A	13	10	23	0	2	25	0	0
4	9466075	.	G	T	11	13	24	0	0	24	0	0
4	9466192	.	C	A	5	3	8	0	0	8	0	0
4	9492315	.	A	G	1	3	4	0	0	4	0	0
4	9496969	.	A	T	2	1	3	0	0	3	0	0
4	9496976	.	C	G	2	2	4	0	0	4	0	0
4	9498803	.	C	A	6	4	10	0	1	11	0	0
4	9498886	.	G	C	6	3	9	0	0	9	0	0
4	9498896	.	T	C	6	2	8	0	0	8	0	0
4	9499404	.	G	A	6	2	8	0	0	8	0	0
4	9500311	.	A	T	5	2	7	0	0	7	0	0
4	9500312	.	G	T	5	2	7	0	0	7	0	0
4	9502243	.	G	T	8	11	19	0	2	21	0	0
4	9502312	.	T	A	3	8	11	0	3	14	0	0
4	9502347	.	C	G	11	0	11	0	7	18	0	0
4	9502388	.	T	C	8	8	16	0	0	16	0	0
4	9502422	.	G	A	13	3	16	0	4	20	0	0
4	9502440	.	A	G	13	0	13	0	10	23	0	0
4	9502608	.	T	G	11	0	11	0	8	19	0	0
4	9537015	.	A	G	12	17	29	0	2	31	0	0
4	9537025	.	C	T	15	21	36	0	0	36	0	0
4	9539303	.	G	A	3	5	8	0	0	8	0	0
4	9539325	.	C	A	0	6	6	0	0	6	0	0
4	9560129	.	C	T	2	2	4	0	0	4	0	0
4	9579297	.	C	G	2	2	4	0	0	4	0	0
4	9592782	.	A	T	5	10	15	0	0	15	0	0
4	9593832	.	C	A	5	4	9	0	0	9	0	0
4	9596614	.	A	G	4	4	8	0	0	8	0	0
4	9597862	.	G	A	5	3	8	0	1	9	0	0
4	9598642	.	C	T	10	7	17	0	0	17	0	0
4	9598690	.	C	T	10	6	16	0	0	16	0	0
4	9599566	.	G	A	13	11	24	0	0	24	0	0
4	9601158	.	C	T	3	4	7	0	1	8	0	0
4	9601174	.	T	C	6	4	10	0	2	12	0	0
4	9601256	.	A	C	6	6	12	0	0	12	0	0
4	9601329	.	C	T	9	9	18	0	1	19	0	0
4	9601401	.	A	T	9	15	24	0	0	24	0	0
4	9603488	.	T	C	4	3	7	0	0	7	0	0
4	9603559	.	G	A	3	3	6	2	0	8	0	0
4	9603620	.	A	T	2	2	4	2	0	6	0	0
4	9603791	.	G	A	11	15	26	0	0	26	0	0
4	9603803	.	G	A	16	7	23	0	4	27	0	0
4	9604134	.	G	A	11	9	20	0	1	21	0	0
4	9604294	.	C	T	1	6	7	0	8	15	0	0
4	9604336	.	T	C	8	0	8	0	8	16	0	0
4	9604384	.	A	G	7	3	10	0	1	11	0	0
4	9605221	.	C	T	1	8	9	0	7	16	0	0
4	9605397	.	A	G	6	6	12	0	0	12	0	0
4	9605505	.	C	T	5	4	9	0	0	9	0	0
4	9607259	.	A	G	5	2	7	0	0	7	0	0
4	9616190	.	A	G	8	7	15	0	1	16	0	0
4	9618432	.	A	G	6	15	21	0	0	21	0	0
4	9618867	.	A	C	14	5	19	0	0	19	0	0
4	9653570	.	A	G	3	10	13	0	0	13	0	0
4	9653574	.	C	A	1	8	9	0	3	12	0	0
4	9653626	.	G	A	6	4	10	0	1	11	0	0
4	9653925	.	T	G	7	3	10	0	0	10	0	0
4	9654020	.	T	A	10	10	20	0	2	22	0	0
4	9654071	.	T	C	10	8	18	0	2	20	0	0
4	9654103	.	A	G	13	8	21	1	0	22	0	0
4	9654114	.	C	T	1	5	6	1	13	20	0	0
4	9654149	.	C	G	10	7	17	1	0	18	0	0
4	9655534	.	T	C	13	0	13	0	8	21	0	0
4	9655807	.	G	A	8	8	16	0	1	17	0	0
4	9659858	.	G	A	3	2	5	0	1	6	0	0
4	9661625	.	T	A	3	7	10	0	0	10	0	0
4	9663976	.	T	A	4	2	6	0	1	7	0	0
4	9669846	.	A	T	5	7	12	0	0	12	0	0
4	9669869	.	C	T	5	6	11	0	0	11	0	0
4	9674206	.	G	A	6	6	12	0	0	12	0	0
4	9675420	.	G	A	0	8	8	0	7	15	0	0
4	9677280	.	G	C	2	7	9	0	0	9	0	0
4	9677319	.	T	C	5	6	11	0	0	11	0	0
4	9686153	.	A	G	12	0	12	0	17	29	0	0
4	9688093	.	T	C	18	11	29	0	1	30	0	0
4	9688570	.	C	T	18	14	32	0	4	36	0	0
4	9688636	.	G	A	22	16	38	0	2	40	0	0
4	9689825	.	G	A	2	28	30	0	23	53	0	0
4	9695896	.	A	G	1	2	3	0	0	3	0	0
4	9697599	.	C	A	10	4	14	0	0	14	0	0
4	9697763	.	A	C	5	7	12	0	1	13	0	0
4	9697813	.	C	T	3	7	10	0	0	10	0	0
4	9698023	.	C	T	15	13	28	0	0	28	0	0
4	9724441	.	A	G	3	8	11	0	2	13	0	0
4	9724635	.	T	A	15	13	28	0	0	28	0	0
4	9724644	.	C	T	14	12	26	0	0	26	0	0
4	9724718	.	C	A	7	12	19	0	1	20	0	0
4	9724898	.	A	G	8	13	21	0	1	22	0	0
4	9736186	.	A	G	13	17	30	0	1	31	0	0
4	9736211	.	C	T	10	16	26	0	1	27	0	0
4	9737157	.	G	T	9	7	16	0	0	16	0	0
4	9737314	.	A	C	10	1	11	0	15	26	0	0
4	9739228	.	C	A	6	4	10	0	0	10	0	0
4	9740769	.	G	A	10	8	18	1	0	19	0	0
4	9743708	.	G	C	8	8	16	0	0	16	0	0
4	9743762	.	T	G	10	3	13	0	1	14	0	0
4	9743774	.	C	T	9	4	13	0	0	13	0	0
4	9746515	.	A	G	2	4	6	0	0	6	0	0
4	9746547	.	C	T	7	2	9	0	0	9	0	0
4	9746559	.	C	A	5	3	8	0	1	9	0	0
4	9746604	.	G	A	6	4	10	0	0	10	0	0
4	9750109	.	G	T	3	7	10	0	0	10	0	0
4	9750154	.	T	G	2	4	6	0	1	7	0	0
4	9751050	.	A	G	4	2	6	0	0	6	0	0
4	9751310	.	T	G	9	5	14	0	0	14	0	0
4	9753200	.	A	G	3	5	8	0	0	8	0	0
4	9755341	.	G	A	4	4	8	0	0	8	0	0
4	9755350	.	G	A	5	4	9	0	0	9	0	0
4	9756488	.	G	T	2	3	5	0	0	5	0	0
4	9758862	.	C	A	0	4	4	0	4	8	0	0
4	9764703	.	G	A	1	4	5	0	1	6	0	0
4	9784331	.	T	A	8	12	20	0	0	20	0	0
4	9784444	.	C	T	9	4	13	0	1	14	0	0
4	9784669	.	G	A	7	10	17	0	1	18	0	0
4	9784678	.	C	T	0	12	12	0	6	18	0	0
4	9784740	.	A	G	8	11	19	0	1	20	0	0
4	9784747	.	T	A	9	11	20	0	2	23	1	0
4	9785412	.	T	C	11	13	24	0	0	24	0	0
4	9785444	.	G	A	8	11	19	0	0	19	0	0
4	9785477	.	G	A	4	6	10	0	0	10	0	0
4	9785900	.	T	A	9	5	14	0	0	14	0	0
4	9786203	.	A	G	14	9	23	0	1	24	0	0
4	9786338	.	T	A	6	11	17	0	1	18	0	0
4	9786466	.	C	G	0	3	3	0	6	9	0	0
4	9786514	.	C	T	4	3	7	0	1	8	0	0
4	9786574	.	T	A	6	7	13	0	0	13	0	0
4	9786617	.	C	A	3	6	9	0	1	10	0	0
4	9786670	.	C	A	6	3	9	0	0	9	0	0
4	9786705	.	A	C	4	2	6	0	0	6	0	0
4	9786855	.	T	C	2	10	12	0	0	12	0	0
4	9786976	.	G	A	3	3	6	0	0	6	0	0
4	9787156	.	A	T	5	4	9	0	0	9	0	0
4	9787250	.	A	G	15	6	21	0	0	21	0	0
4	9787415	.	G	A	4	13	17	0	1	18	0	0
4	9787516	.	C	T	3	10	13	0	2	15	0	0
4	9787600	.	G	T	11	8	19	0	1	20	0	0
4	9787761	.	A	G	6	12	18	0	1	19	0	0
4	9789478	.	A	G	6	9	15	0	0	15	0	0
4	9791466	.	A	T	7	8	15	0	0	15	0	0
4	9791493	.	T	C	4	0	4	0	9	13	0	0
4	9792102	.	T	G	5	6	11	0	0	11	0	0
4	9792229	.	G	T	2	13	15	0	0	15	0	0
4	9792726	.	T	G	6	6	12	0	0	12	0	0
4	9792798	.	A	G	5	4	9	0	0	9	0	0
4	9794644	.	C	A	1	5	6	0	6	12	0	0
4	9795288	.	C	T	3	5	8	0	0	8	0	0
4	9795309	.	C	T	2	4	6	0	0	6	0	0
4	9795417	.	T	A	6	4	10	0	0	10	0	0
4	9797312	.	C	T	1	2	3	0	3	6	0	0
4	9797376	.	G	A	5	4	9	0	0	9	0	0
4	9797390	.	G	C	6	1	7	0	4	11	0	0
4	9797411	.	C	T	4	5	9	0	0	9	0	0
4	9798229	.	T	C	4	0	4	0	7	11	0	0
4	9798825	.	C	A	1	6	7	0	2	9	0	0
4	9801626	.	G	A	3	4	7	1	1	9	0	0
4	9801662	.	A	G	4	7	11	0	1	12	0	0
4	9801730	.	A	T	8	5	13	0	0	13	0	0
4	9801747	.	G	A	6	4	10	0	0	10	0	0
4	9801935	.	A	G	9	5	14	0	0	14	0	0
4	9813844	.	T	A	5	2	7	0	0	7	0	0
4	9814044	.	C	G	9	6	15	0	1	16	0	0
4	9817327	.	C	T	5	6	11	0	0	11	0	0
4	9819858	.	A	T	2	6	8	0	1	9	0	0
4	9819944	.	T	C	4	5	9	0	0	9	0	0
4	9836583	.	T	A	9	7	16	0	2	18	0	0
4	9838875	.	T	C	7	10	17	0	0	17	0	0
4	9838932	.	C	T	5	9	14	0	0	14	0	0
4	9838974	.	T	C	7	5	12	0	3	15	0	0
4	9840136	.	T	C	14	9	23	0	0	23	0	0
4	9840242	.	T	C	14	7	21	0	0	21	0	0
4	9840338	.	T	C	10	4	14	0	0	14	0	0
4	9841657	.	G	A	21	12	33	0	1	34	0	0
4	9854313	.	T	C	5	6	11	0	1	12	0	0
4	9855482	.	G	A	5	7	12	0	0	12	0	0
4	9858023	.	A	G	4	6	10	0	0	10	0	0
4	9858050	.	C	T	4	3	7	0	0	7	0	0
4	9863363	.	G	A	3	3	6	0	0	6	0	0
4	9863771	.	T	C	1	2	3	0	0	3	0	0
4	9866911	.	C	T	0	2	2	0	1	3	0	0
4	9866926	.	T	C	1	2	3	0	0	3	0	0
4	9867387	.	A	G	1	2	3	0	0	3	0	0
4	9943066	.	T	C	3	6	9	0	0	9	0	0
4	9955350	.	C	T	3	4	7	0	0	7	0	0
4	9957319	.	T	C	7	5	12	0	0	12	0	0
4	9957331	.	C	T	8	3	11	0	1	12	0	0
4	9957367	.	T	C	5	3	8	0	0	8	0	0
4	9964813	.	C	T	2	3	5	0	0	5	0	0
4	9964876	.	G	A	1	2	3	0	0	3	0	0
4	9966229	.	C	T	4	2	6	0	0	6	0	0
4	9969261	.	C	T	7	7	14	0	0	14	0	0
4	9969306	.	G	T	7	5	12	0	2	14	0	0
4	9969447	.	T	C	3	5	8	0	0	8	0	0
4	9974720	.	C	T	6	3	9	0	0	9	0	0
4	9979792	.	T	C	2	4	6	0	0	6	0	0
4	9980400	.	G	A	0	3	3	0	5	8	0	0
4	9981763	.	C	T	8	3	11	0	0	11	0	0
4	9981838	.	G	A	5	3	8	0	1	9	0	0
4	9982775	.	G	T	6	5	11	0	1	12	0	0
4	9982872	.	A	T	10	6	16	0	0	16	0	0
4	9982883	.	A	G	8	6	14	0	1	15	0	0
4	9983269	.	C	G	12	3	15	0	0	15	0	0
4	9983940	.	C	T	4	4	8	0	0	8	0	0
4	9983943	.	T	C	4	4	8	0	0	8	0	0
4	9985320	.	G	C	6	7	13	0	0	13	0	0
4	9986279	.	G	A	9	12	21	0	0	21	0	0
4	9988867	.	C	T	6	16	22	0	0	22	0	0
4	9990796	.	G	A	7	11	18	0	0	18	0	0
4	9993789	.	C	T	19	12	31	0	1	32	0	0
4	9996182	.	T	C	12	19	31	0	1	32	0	0
4	9998553	.	G	A	1	13	14	0	17	32	1	0
4	9998566	.	A	C	17	10	27	0	2	29	0	0
4	9998677	.	A	G	14	12	26	0	1	27	0	0
4	9998986	.	A	T	9	11	20	0	1	21	0	0
4	9998988	.	T	C	7	12	19	0	1	20	0	0
4	9999240	.	C	T	12	16	28	0	1	30	1	0
4	9999367	.	A	G	16	21	37	0	1	38	0	0
4	9999830	.	T	C	9	6	15	0	3	18	0	0
4	9999909	.	A	T	10	4	14	0	4	18	0	0
4	10005072	.	G	A	1	2	3	0	0	3	0	0
4	10017468	.	A	G	22	11	33	0	2	35	0	0
4	10038009	.	T	C	16	16	32	0	0	32	0	0
4	10040249	.	G	A	4	20	24	0	21	45	0	0
4	10040285	.	A	G	23	1	24	0	20	44	0	0
4	10040297	.	C	T	24	20	44	0	0	44	0	0
4	10127591	.	C	A	1	2	3	0	0	3	0	0
4	10366043	.	G	A	1	3	4	0	2	6	0	0
4	10366045	.	C	T	3	3	6	0	0	6	0	0
4	10367028	.	A	G	5	3	8	0	0	8	0	0
4	10367412	.	A	C	5	2	7	0	1	8	0	0
4	10367562	.	C	T	4	5	9	0	0	9	0	0
4	10367610	.	C	T	4	2	6	0	0	6	0	0
4	10367619	.	C	T	3	3	6	0	1	7	0	0
4	10558370	.	C	T	3	8	11	0	0	11	0	0
4	10558510	.	T	C	1	4	5	0	0	5	0	0
4	10559042	.	A	T	10	3	13	0	0	13	0	0
4	10559088	.	C	A	10	2	12	1	0	13	0	0
4	10559213	.	C	G	5	5	10	0	0	10	0	0
4	10559621	.	C	A	13	5	18	0	0	18	0	0
4	10560246	.	G	A	10	8	18	0	0	18	0	0
4	10560253	.	A	T	13	9	22	0	1	23	0	0
4	10560284	.	C	T	13	12	25	0	0	25	0	0
4	10560404	.	A	T	19	13	32	0	0	32	0	0
4	10560607	.	A	G	8	6	14	0	0	14	0	0
4	10560916	.	C	T	7	7	14	0	1	15	0	0
4	10561598	.	T	C	16	8	24	0	2	26	0	0
4	10561603	.	G	A	15	11	26	0	1	27	0	0
4	10605409	.	T	C	9	5	14	0	0	14	0	0
4	10605457	.	C	T	5	6	11	0	0	11	0	0
4	10608878	.	G	T	10	6	16	0	1	17	0	0
4	10611014	.	T	A	10	16	26	0	3	29	0	0
4	10615123	.	A	T	16	13	29	0	1	30	0	0
4	10615127	.	G	T	17	15	32	0	0	32	0	0
4	10615175	.	A	G	19	1	20	0	10	30	0	0
4	10709634	.	G	C	1	2	3	0	0	3	0	0
4	10755396	.	T	G	1	2	3	0	0	3	0	0
4	10762335	.	T	A	1	3	4	0	0	4	0	0
4	10812042	.	C	G	0	3	3	1	5	9	0	0
4	10888842	.	G	C	0	5	5	0	2	7	0	0
4	10888890	.	T	A	1	1	2	0	1	3	0	0
4	10888935	.	C	A	1	2	3	0	0	3	0	0
4	10890516	.	G	T	1	3	4	1	0	5	0	0
4	10890822	.	G	A	3	4	7	0	0	7	0	0
4	10896354	.	G	C	3	4	7	0	0	7	0	0
4	10896570	.	G	A	5	4	9	0	0	9	0	0
4	10896582	.	G	T	3	3	6	0	1	7	0	0
4	10896618	.	C	T	1	3	4	0	1	5	0	0
4	10896620	.	A	T	1	4	5	0	0	5	0	0
4	10904784	.	C	T	8	8	16	0	0	16	0	0
4	10905246	.	C	T	5	10	15	0	1	16	0	0
4	10906254	.	C	T	4	4	8	0	0	8	0	0
4	10908001	.	C	T	14	12	26	0	0	26	0	0
4	10908182	.	T	C	10	11	21	0	0	21	0	0
4	10908294	.	C	T	7	6	13	0	1	14	0	0
4	10974650	.	C	T	5	2	7	1	0	8	0	0
4	10974747	.	A	T	7	3	10	0	0	10	0	0
4	10975629	.	A	G	3	5	8	0	0	8	0	0
4	10975632	.	G	A	3	5	8	0	0	8	0	0
4	10976944	.	G	A	3	5	8	0	2	10	0	0
4	10982291	.	C	T	3	6	9	0	0	9	0	0
4	10982339	.	T	G	3	5	8	0	1	9	0	0
4	10982390	.	C	A	1	4	5	0	2	7	0	0
4	10987895	.	T	A	5	7	12	0	0	12	0	0
4	10988546	.	G	C	1	4	5	0	0	5	0	0
4	10988581	.	C	T	0	4	4	0	1	5	0	0
4	11053851	.	G	A	0	8	8	0	8	16	0	0
4	11054484	.	A	C	7	4	11	0	2	13	0	0
4	11054509	.	G	C	8	6	14	0	1	15	0	0
4	11356555	.	A	G	3	3	6	0	0	6	0	0
4	11356618	.	T	C	2	3	5	0	0	5	0	0
4	11358626	.	C	T	7	3	10	0	1	11	0	0
4	11366360	.	T	C	11	4	15	0	1	16	0	0
4	11366481	.	G	A	9	10	19	0	1	20	0	0
4	11367668	.	T	A	7	7	14	2	0	16	0	0
4	11367952	.	T	C	13	6	19	0	0	19	0	0
4	11368056	.	A	T	19	16	35	0	5	40	0	0
4	11368076	.	G	T	24	15	39	0	4	43	0	0
4	11368171	.	G	A	3	22	25	0	18	43	0	0
4	11368432	.	A	T	0	3	3	0	1	4	0	0
4	11385001	.	T	C	1	3	4	0	0	4	0	0
4	11387698	.	A	T	1	4	5	0	1	6	0	0
4	11389372	.	G	C	0	4	4	0	2	6	0	0
4	11415471	.	G	A	5	4	9	0	0	9	0	0
4	11415483	.	G	A	6	4	10	0	0	10	0	0
4	11416701	.	C	T	4	8	12	0	1	13	0	0
4	11416758	.	T	A	4	3	7	0	2	9	0	0
4	11416854	.	G	A	6	9	15	0	0	15	0	0
4	11417753	.	G	T	6	3	9	0	0	9	0	0
4	11417829	.	C	A	2	4	6	0	2	8	0	0
4	11418969	.	C	T	3	8	11	0	0	11	0	0
4	11419062	.	G	A	5	8	13	0	0	13	0	0
4	11419163	.	C	G	3	4	7	0	0	7	0	0
4	11419510	.	C	T	4	5	9	0	2	11	0	0
4	11419836	.	A	T	8	6	14	0	0	14	0	0
4	11419869	.	T	C	7	7	14	0	0	14	0	0
4	11420005	.	A	T	11	7	18	0	2	20	0	0
4	11421575	.	C	T	9	7	16	0	0	16	0	0
4	11422121	.	C	T	13	8	21	0	2	23	0	0
4	11425839	.	G	T	12	12	24	0	2	26	0	0
4	11439544	.	C	A	5	5	10	0	0	10	0	0
4	11444080	.	C	T	22	18	40	0	1	41	0	0
4	11446078	.	A	G	16	21	37	0	2	39	0	0
4	11446365	.	A	T	17	19	36	0	1	37	0	0
4	11446878	.	A	G	14	6	20	0	1	21	0	0
4	11447135	.	T	C	14	23	37	0	0	37	0	0
4	11447144	.	G	A	18	13	31	0	0	31	0	0
4	11447226	.	T	G	17	2	19	0	12	31	0	0
4	11447251	.	T	C	14	13	27	0	1	28	0	0
4	11447719	.	T	G	23	17	40	0	2	42	0	0
4	11448296	.	A	T	24	20	44	0	1	45	0	0
4	11448403	.	G	A	3	15	18	0	29	47	0	0
4	11458171	.	G	T	1	2	3	0	2	5	0	0
4	11461181	.	C	G	3	6	9	0	0	9	0	0
4	11461914	.	A	G	3	8	11	0	0	11	0	0
4	11464390	.	A	G	20	19	39	0	1	40	0	0
4	11470854	.	A	G	16	9	25	0	0	25	0	0
4	11471203	.	T	C	19	13	32	0	1	33	0	0
4	11472674	.	T	C	25	14	39	0	0	39	0	0
4	11476472	.	G	A	1	33	34	0	21	55	0	0
4	11476487	.	C	T	23	33	56	0	2	58	0	0
4	11476740	.	C	T	31	19	50	1	3	54	0	0
4	11476868	.	C	G	29	22	51	0	2	53	0	0
4	11476945	.	C	T	34	25	59	0	4	63	0	0
4	11477047	.	T	A	33	22	55	0	5	60	0	0
4	11477377	.	C	T	50	13	63	1	1	65	0	0
4	11480649	.	T	C	9	12	21	0	0	21	0	0
4	11480824	.	C	A	5	9	14	0	0	14	0	0
4	11480866	.	C	T	6	2	8	0	0	8	0	0
4	11482235	.	G	A	2	7	9	1	7	17	0	0
4	11482259	.	G	A	11	5	16	1	0	17	0	0
4	11482358	.	T	G	8	4	12	0	1	13	0	0
4	11482367	.	C	G	6	4	10	0	0	10	0	0
4	11482668	.	T	A	12	13	25	0	2	27	0	0
4	11482830	.	C	T	2	5	7	0	0	7	0	0
4	11573837	.	C	T	0	2	2	0	3	5	0	0
4	11704180	.	C	T	1	3	4	0	0	4	0	0
4	11704195	.	A	G	1	2	3	0	0	3	0	0
4	11712653	.	C	T	3	3	6	0	0	6	0	0
4	11712704	.	G	T	0	2	2	0	1	3	0	0
4	11712794	.	T	C	2	3	5	0	0	5	0	0
4	11713065	.	C	T	1	5	6	0	0	6	0	0
4	11721731	.	C	T	5	2	7	0	0	7	0	0
4	11726366	.	T	A	9	7	16	0	2	18	0	0
4	11728959	.	G	A	2	14	16	0	10	26	0	0
4	11729719	.	G	A	3	8	11	0	0	11	0	0
4	11730159	.	G	C	6	6	12	0	0	12	0	0
4	11730515	.	C	A	11	6	17	0	2	19	0	0
4	11732213	.	G	A	2	2	4	0	0	4	0	0
4	11732222	.	G	A	2	3	5	0	0	5	0	0
4	11732456	.	G	A	4	2	6	0	0	6	0	0
4	11732589	.	T	C	3	7	10	0	0	10	0	0
4	11732590	.	T	C	3	7	10	0	0	10	0	0
4	11733061	.	A	C	2	2	4	0	0	4	0	0
4	11733114	.	A	C	3	0	3	0	4	7	0	0
4	11733222	.	C	T	4	1	5	0	2	7	0	0
4	11733545	.	T	C	6	0	6	0	7	13	0	0
4	11733573	.	G	A	5	6	11	0	1	12	0	0
4	11733726	.	A	C	1	3	4	0	0	4	0	0
4	11733778	.	C	A	0	2	2	0	5	7	0	0
4	11734001	.	A	T	4	2	6	0	0	6	0	0
4	11734423	.	G	A	1	4	5	0	0	5	0	0
4	11780629	.	T	C	4	3	7	3	0	10	0	0
4	11804825	.	C	G	4	4	8	0	1	9	0	0
4	11804940	.	G	A	11	6	17	0	0	17	0	0
4	11805396	.	G	T	8	4	12	0	0	12	0	0
4	11805423	.	T	C	4	6	10	0	0	10	0	0
4	11806934	.	G	A	12	5	17	0	1	18	0	0
4	11806965	.	G	C	12	6	18	0	0	18	0	0
4	11810123	.	T	G	5	3	8	0	0	8	0	0
4	11810129	.	A	G	6	3	9	0	0	9	0	0
4	11814022	.	A	G	26	14	40	0	0	40	0	0
4	11814055	.	C	T	2	30	32	0	16	48	0	0
4	11814074	.	T	A	17	29	46	0	3	49	0	0
4	11814429	.	A	T	9	12	21	0	1	22	0	0
4	11814456	.	A	G	8	8	16	0	2	18	0	0
4	11814471	.	G	A	9	10	19	0	1	20	0	0
4	11814494	.	C	T	10	7	17	0	2	19	0	0
4	11814565	.	A	T	9	15	24	0	0	24	0	0
4	11814684	.	C	T	10	8	18	0	0	18	0	0
4	11814723	.	A	C	12	9	21	0	3	24	0	0
4	11815137	.	G	T	20	15	35	0	0	35	0	0
4	11815143	.	C	G	18	16	34	0	1	35	0	0
4	11815324	.	A	C	16	14	30	0	0	30	0	0
4	11816535	.	T	C	5	1	6	0	6	12	0	0
4	11818347	.	G	A	6	4	10	0	1	11	0	0
4	11818353	.	A	G	6	4	10	0	1	11	0	0
4	11827171	.	C	T	11	9	20	0	1	21	0	0
4	11841949	.	T	A	11	4	15	0	1	16	0	0
4	12006542	.	G	A	4	5	9	0	0	9	0	0
4	12006761	.	C	T	0	4	4	0	3	7	0	0
4	12007149	.	T	A	4	4	8	0	0	8	0	0
4	12013470	.	T	G	7	3	10	0	0	10	0	0
4	12013513	.	A	T	8	4	12	0	0	12	0	0
4	12020936	.	C	T	12	11	23	0	0	23	0	0
4	12021120	.	C	T	12	11	23	0	0	23	0	0
4	12021703	.	C	T	12	14	26	0	0	26	0	0
4	12021748	.	G	T	1	21	22	0	13	35	0	0
4	12022108	.	A	G	12	1	13	0	15	28	0	0
4	12022444	.	T	C	21	13	34	0	2	36	0	0
4	12023445	.	A	C	22	23	45	0	1	46	0	0
4	12025771	.	G	A	35	9	44	0	3	47	0	0
4	12026098	.	G	A	8	4	12	0	0	12	0	0
4	12026286	.	A	T	16	20	36	0	2	38	0	0
4	12026305	.	T	C	18	18	36	0	2	38	0	0
4	12026369	.	G	T	12	12	24	0	0	24	0	0
4	12026429	.	C	A	10	10	20	0	1	21	0	0
4	12026488	.	T	C	2	3	5	0	1	6	0	0
4	12078423	.	T	C	6	0	6	0	8	14	0	0
4	12080673	.	C	T	11	7	18	0	0	18	0	0
4	12080911	.	T	G	11	9	20	0	0	20	0	0
4	12087262	.	G	C	2	0	2	0	5	7	0	0
4	12091037	.	T	C	9	0	9	0	7	16	0	0
4	12091104	.	G	T	13	9	22	0	0	22	0	0
4	12103846	.	A	T	1	2	3	0	0	3	0	0
4	12103911	.	A	T	2	5	7	0	0	7	0	0
4	12103964	.	T	A	3	12	15	0	2	17	0	0
4	12106000	.	G	C	8	0	8	0	4	12	0	0
4	12111399	.	G	A	3	3	6	0	1	7	0	0
4	12234599	.	A	G	5	7	12	0	1	13	0	0
4	12234670	.	A	G	8	0	8	0	4	12	0	0
4	12234792	.	A	G	9	6	15	0	0	15	0	0
4	12235934	.	A	G	11	10	21	0	1	22	0	0
4	12236452	.	A	G	10	4	14	0	2	16	0	0
4	12236495	.	A	G	7	0	7	0	7	14	0	0
4	12311216	.	T	C	2	2	4	0	1	5	0	0
4	12902609	.	G	A	4	3	7	0	0	7	0	0
4	12917237	.	G	T	13	7	20	0	0	20	0	0
4	12917348	.	A	G	9	6	15	0	1	16	0	0
4	12917534	.	C	T	2	12	14	0	10	24	0	0
4	12917796	.	A	G	14	10	24	0	0	24	0	0
4	12921893	.	T	C	3	0	3	0	6	9	0	0
4	12929147	.	C	T	0	4	4	0	5	9	0	0
4	12971436	.	A	G	24	16	40	0	1	41	0	0
4	12971495	.	C	A	24	10	34	0	1	35	0	0
4	12971935	.	A	T	18	7	25	0	0	25	0	0
4	12972000	.	T	A	8	7	15	0	0	15	0	0
4	12972017	.	T	A	8	4	12	0	1	13	0	0
4	12972215	.	C	T	3	31	34	0	23	57	0	0
4	12976735	.	G	A	22	18	40	0	0	40	0	0
4	12976983	.	T	C	24	0	24	0	21	45	0	0
4	12978779	.	G	A	15	16	31	0	1	32	0	0
4	12978843	.	A	C	17	14	31	0	1	32	0	0
4	13035881	.	A	G	26	5	31	0	1	32	0	0
4	13035962	.	T	C	18	15	33	0	0	33	0	0
4	13036046	.	G	A	15	18	33	0	1	34	0	0
4	13036572	.	G	A	12	8	20	0	2	22	0	0
4	13041589	.	C	T	1	5	6	0	15	21	0	0
4	13054610	.	G	A	10	7	17	0	1	18	0	0
4	13056441	.	G	A	10	8	18	0	1	19	0	0
4	13079354	.	A	T	3	6	9	0	0	9	0	0
4	13419775	.	G	C	0	5	5	0	6	11	0	0
4	13424839	.	G	A	17	25	42	1	2	45	0	0
4	13424968	.	A	C	12	7	19	0	0	19	0	0
4	13453445	.	T	C	3	4	7	0	0	7	0	0
4	13457965	.	A	G	8	4	12	0	1	13	0	0
4	13458010	.	T	C	6	5	11	0	0	11	0	0
4	13458187	.	A	T	5	6	11	0	0	11	0	0
4	13458241	.	C	G	3	6	9	0	0	9	0	0
4	13458627	.	A	C	11	6	17	0	0	17	0	0
4	13458888	.	G	A	0	5	5	0	5	10	0	0
4	13458947	.	A	G	5	2	7	0	0	7	0	0
4	13458961	.	A	T	3	3	6	0	0	6	0	0
4	13459670	.	A	G	7	8	15	0	0	15	0	0
4	13459753	.	G	T	4	2	6	0	0	6	0	0
4	13459823	.	G	A	13	4	17	0	0	17	0	0
4	13460937	.	T	C	10	9	19	0	0	19	0	0
4	13461007	.	G	T	8	14	22	0	1	23	0	0
4	13461031	.	T	C	10	17	27	0	1	28	0	0
4	13461312	.	A	T	4	4	8	0	0	8	0	0
4	13461328	.	T	A	4	5	9	0	0	9	0	0
4	13557898	.	A	G	2	4	6	0	0	6	0	0
4	13557934	.	G	T	2	2	4	0	0	4	0	0
4	13557947	.	G	A	2	2	4	0	0	4	0	0
4	13558087	.	A	G	1	2	3	0	0	3	0	0
4	13562110	.	T	C	1	1	2	0	3	5	0	0
4	13570514	.	G	T	6	10	16	0	1	17	0	0
4	13570609	.	G	A	2	7	9	0	2	11	0	0
4	13570899	.	T	C	6	7	13	0	0	13	0	0
4	13571711	.	T	C	11	7	18	0	0	18	0	0
4	13572951	.	G	A	1	11	12	0	7	19	0	0
4	13575521	.	C	T	3	7	10	0	2	12	0	0
4	13575570	.	A	G	3	0	3	0	9	12	0	0
4	13575618	.	G	A	0	8	8	0	2	10	0	0
4	13575623	.	A	G	4	7	11	0	0	11	0	0
4	13575672	.	A	G	3	0	3	0	8	11	0	0
4	13575853	.	C	T	5	4	9	0	2	11	0	0
4	13575996	.	C	T	11	8	19	0	1	20	0	0
4	13576105	.	G	T	2	6	8	0	0	8	0	0
4	13576139	.	G	A	0	6	6	0	3	9	0	0
4	13589685	.	C	T	9	6	15	0	1	16	0	0
4	13589787	.	G	A	6	5	11	0	0	11	0	0
4	13591793	.	A	G	3	5	8	0	0	8	0	0
4	13593060	.	G	A	0	2	2	0	4	6	0	0
4	13593078	.	T	C	3	2	5	0	0	5	0	0
4	13593309	.	A	G	1	4	5	0	0	5	0	0
4	13597399	.	A	G	4	7	11	0	1	12	0	0
4	13597529	.	T	A	6	5	11	0	0	11	0	0
4	13597547	.	A	G	7	4	11	0	0	11	0	0
4	13597646	.	A	G	8	6	14	0	2	16	0	0
4	13597782	.	C	G	1	0	1	0	4	5	0	0
4	13597849	.	C	T	8	6	14	0	0	14	0	0
4	13599365	.	G	T	7	8	15	0	1	16	0	0
4	13599410	.	C	T	4	9	13	0	0	13	0	0
4	13599570	.	A	G	7	1	8	0	5	13	0	0
4	13599840	.	C	T	10	14	24	0	0	24	0	0
4	13604574	.	T	C	16	17	33	0	0	33	0	0
4	13629927	.	T	G	9	5	14	0	1	15	0	0
4	13631308	.	C	T	3	6	9	0	0	9	0	0
4	13642715	.	A	T	7	13	20	0	1	21	0	0
4	13643251	.	G	T	0	5	5	0	9	14	0	0
4	13702400	.	C	T	3	5	8	0	1	9	0	0
4	13702490	.	C	T	2	2	4	0	0	4	0	0
4	13705743	.	G	A	0	2	2	0	2	4	0	0
4	13707603	.	G	A	6	7	13	0	1	14	0	0
4	13709490	.	T	G	9	9	18	0	0	18	0	0
4	13710585	.	G	T	0	6	6	0	5	11	0	0
4	13710868	.	T	C	5	4	9	0	0	9	0	0
4	13713042	.	A	G	6	3	9	0	1	10	0	0
4	13714183	.	G	A	10	8	18	0	1	19	0	0
4	13716481	.	C	G	7	7	14	0	0	14	0	0
4	13723458	.	C	T	18	15	33	1	3	37	0	0
4	13724578	.	G	A	19	15	34	0	1	35	0	0
4	13724581	.	T	C	19	14	33	0	2	35	0	0
4	13728097	.	T	C	18	19	37	0	1	38	0	0
4	13734018	.	T	G	12	6	18	0	1	19	0	0
4	13742550	.	A	G	11	0	11	0	5	16	0	0
4	13742619	.	A	G	10	10	20	0	2	22	0	0
4	13742827	.	A	G	11	15	26	0	1	27	0	0
4	13744441	.	T	C	9	13	22	0	0	22	0	0
4	13744451	.	C	A	10	10	20	0	2	22	0	0
4	13744591	.	T	A	4	9	13	0	0	13	0	0
4	13744717	.	G	A	6	7	13	0	0	13	0	0
4	13747503	.	C	T	6	4	10	0	0	10	0	0
4	13747566	.	A	C	12	21	33	0	0	33	0	0
4	13748217	.	C	T	8	15	23	0	1	24	0	0
4	13748250	.	T	C	4	18	22	0	1	23	0	0
4	13748521	.	T	G	11	24	35	0	2	37	0	0
4	13750453	.	T	A	16	10	26	0	3	29	0	0
4	13753717	.	C	T	20	18	38	0	1	39	0	0
4	13753738	.	C	G	17	1	18	0	19	37	0	0
4	13753864	.	T	C	21	25	46	0	4	50	0	0
4	13754405	.	C	T	17	30	47	0	1	48	0	0
4	13754456	.	A	C	24	22	46	0	2	48	0	0
4	13755254	.	T	G	29	19	48	0	4	52	0	0
4	13755307	.	C	A	6	11	17	1	5	23	0	0
4	13755320	.	C	G	14	0	14	1	16	31	0	0
4	13755455	.	A	T	11	4	15	0	1	16	0	0
4	13755476	.	G	T	9	7	16	0	0	16	0	0
4	13755521	.	T	A	9	9	18	0	0	18	0	0
4	13755551	.	C	T	7	4	11	0	0	11	0	0
4	13755805	.	C	G	14	11	25	0	0	25	0	0
4	13755896	.	G	A	13	13	26	0	1	27	0	0
4	13756203	.	A	C	8	8	16	0	1	17	0	0
4	13756222	.	T	G	10	12	22	0	1	23	0	0
4	13756324	.	T	C	3	10	13	0	0	13	0	0
4	13756481	.	C	A	2	3	5	0	1	6	0	0
4	13756536	.	G	T	5	3	8	0	1	9	0	0
4	13810875	.	C	T	1	2	3	0	0	3	0	0
4	13810947	.	G	A	0	3	3	0	3	6	0	0
4	13810958	.	T	A	4	2	6	0	0	6	0	0
4	13847775	.	G	A	4	2	6	0	0	6	0	0
4	13861022	.	A	G	4	2	6	0	1	7	0	0
4	13893236	.	C	T	1	2	3	0	0	3	0	0
4	13905730	.	T	C	7	0	7	0	4	11	0	0
4	13905985	.	C	T	7	7	14	0	1	15	0	0
4	13906171	.	T	G	2	2	4	0	0	4	0	0
4	13906217	.	G	T	2	4	6	0	0	6	0	0
4	13906547	.	G	C	9	4	13	0	0	13	0	0
4	13906567	.	A	G	11	5	16	0	2	18	0	0
4	13906766	.	G	A	21	11	32	0	1	33	0	0
4	13906847	.	C	T	2	12	14	0	21	35	0	0
4	13925593	.	T	C	7	0	7	0	8	15	0	0
4	13929511	.	A	G	8	5	13	0	0	13	0	0
4	13929543	.	G	A	7	5	12	0	0	12	0	0
4	13931460	.	T	A	1	2	3	0	0	3	0	0
4	13931831	.	T	A	3	11	14	0	1	15	0	0
4	13931846	.	G	A	3	7	10	0	3	13	0	0
4	13935470	.	A	G	6	6	12	0	0	12	0	0
4	13935509	.	T	C	6	3	9	0	0	9	0	0
4	13935669	.	T	C	5	4	9	0	2	11	0	0
4	13943890	.	A	T	7	3	10	3	2	15	0	0
4	13943911	.	T	A	5	8	13	3	2	18	0	0
4	13944129	.	T	A	9	7	16	0	2	18	0	0
4	13950946	.	C	T	6	7	13	0	0	13	0	0
4	13953957	.	C	A	5	5	10	0	2	12	0	0
4	13954031	.	C	T	6	8	14	0	0	14	0	0
4	13963045	.	T	C	8	8	16	0	1	17	0	0
4	13963202	.	T	A	1	8	9	0	1	10	0	0
4	13963702	.	A	G	1	2	3	0	0	3	0	0
4	13964366	.	G	A	1	3	4	0	1	5	0	0
4	13964769	.	A	T	4	3	7	0	0	7	0	0
4	13964865	.	G	A	1	2	3	0	0	3	0	0
4	13965149	.	A	G	1	3	4	0	0	4	0	0
4	13965185	.	C	T	4	4	8	0	0	8	0	0
4	14193512	.	T	C	9	0	9	0	9	18	0	0
4	14194036	.	G	A	7	2	9	0	2	11	0	0
4	14194426	.	G	A	7	6	13	0	1	14	0	0
4	14194650	.	G	A	10	11	21	0	0	21	0	0
4	14196368	.	T	C	10	5	15	0	2	17	0	0
4	14198037	.	T	C	3	5	8	0	0	8	0	0
4	14198342	.	C	A	3	8	11	0	0	11	0	0
4	14205253	.	A	T	5	5	10	0	0	10	0	0
4	14248043	.	A	G	34	25	59	0	2	61	0	0
4	14248128	.	G	A	36	23	59	0	3	62	0	0
4	14248157	.	G	A	38	22	60	0	2	62	0	0
4	14248277	.	A	T	29	26	55	0	7	62	0	0
4	14248279	.	G	A	30	30	60	0	1	61	0	0
4	14248419	.	T	C	42	1	43	4	28	75	0	0
4	14248433	.	A	T	35	29	64	4	4	72	0	0
4	14248615	.	T	A	33	29	62	0	1	63	0	0
4	14248700	.	C	G	30	37	67	0	2	69	0	0
4	14249544	.	G	T	14	5	19	0	0	19	0	0
4	14249583	.	A	T	4	5	9	0	2	11	0	0
4	14249649	.	T	C	2	6	8	0	0	8	0	0
4	14249799	.	T	C	5	16	21	0	0	21	0	0
4	14249984	.	T	G	31	20	51	0	7	58	0	0
4	14250024	.	T	A	17	9	26	1	16	43	0	0
4	14250831	.	G	A	36	24	60	0	4	64	0	0
4	14250840	.	T	C	27	0	27	0	35	62	0	0
4	14282192	.	G	T	23	22	45	0	1	46	0	0
4	14282244	.	A	G	17	17	34	0	1	35	0	0
4	14303321	.	A	G	17	27	44	0	1	45	0	0
4	14305901	.	G	A	31	14	45	0	0	45	0	0
4	14315713	.	T	A	13	15	28	0	0	28	0	0
4	14328925	.	A	G	7	8	15	0	1	16	0	0
4	14348492	.	C	T	4	4	8	0	0	8	0	0
4	14348510	.	A	C	4	5	9	0	0	9	0	0
4	14369527	.	T	G	6	6	12	0	0	12	0	0
4	14370932	.	C	T	15	7	22	0	0	22	0	0
4	14372509	.	A	T	11	11	22	0	2	24	0	0
4	14372610	.	C	A	6	8	14	0	1	15	0	0
4	14372785	.	C	T	14	9	23	0	0	23	0	0
4	14433948	.	C	T	0	4	4	0	7	11	0	0
4	14435991	.	A	C	2	2	4	0	3	7	0	0
4	14435997	.	C	T	0	3	3	0	4	7	0	0
4	14437335	.	T	C	2	5	7	0	0	7	0	0
4	14444846	.	C	T	1	2	3	0	1	4	0	0
4	14444878	.	G	A	6	1	7	0	1	8	0	0
4	14444881	.	C	G	6	2	8	0	0	8	0	0
4	14449276	.	A	C	3	1	4	0	0	4	0	0
4	14449297	.	G	A	2	2	4	0	0	4	0	0
4	14449492	.	G	C	12	0	12	0	7	19	0	0
4	14449762	.	T	A	3	6	9	0	0	10	1	0
4	14449795	.	T	C	2	5	7	0	0	7	0	0
4	14450330	.	T	C	4	0	4	0	6	10	0	0
4	14450355	.	A	T	7	3	10	0	1	11	0	0
4	14450377	.	T	C	7	6	13	0	1	14	0	0
4	14450501	.	G	A	4	5	9	0	0	9	0	0
4	14450634	.	A	T	3	3	6	0	0	6	0	0
4	14450697	.	G	A	4	3	7	0	3	10	0	0
4	14452194	.	C	T	1	6	7	0	8	15	0	0
4	14452220	.	G	A	9	8	17	0	0	17	0	0
4	14454082	.	T	G	2	7	9	0	0	9	0	0
4	14456539	.	G	A	4	4	8	0	0	8	0	0
4	14466078	.	A	G	4	3	7	0	0	7	0	0
4	14466213	.	T	G	5	7	12	0	0	12	0	0
4	14466274	.	G	A	3	3	6	0	1	7	0	0
4	14466340	.	G	T	1	3	4	0	0	4	0	0
4	14469248	.	T	A	3	3	6	0	0	6	0	0
4	14470021	.	G	T	3	3	6	0	0	6	0	0
4	14471761	.	T	G	3	2	5	0	0	5	0	0
4	14486787	.	T	C	4	1	5	0	0	5	0	0
4	14486790	.	T	C	4	2	6	0	0	6	0	0
4	14667035	.	C	T	2	2	4	0	0	4	0	0
4	14667086	.	A	G	2	2	4	0	0	4	0	0
4	14684812	.	T	C	1	3	4	0	0	4	0	0
4	14692667	.	C	T	2	5	7	0	1	8	0	0
4	14695933	.	A	C	2	7	9	0	0	9	0	0
4	14700843	.	A	T	2	2	4	0	0	4	0	0
4	14702044	.	T	C	3	7	10	0	1	11	0	0
4	14711899	.	A	G	6	9	15	0	1	16	0	0
4	14711984	.	G	T	11	4	15	0	0	15	0	0
4	14728640	.	T	A	15	10	25	0	0	25	0	0
4	14734276	.	A	T	25	14	39	0	0	39	0	0
4	14734336	.	C	T	18	19	37	0	1	38	0	0
4	14736369	.	G	A	17	10	27	0	2	29	0	0
4	14736506	.	G	T	6	3	9	0	0	9	0	0
4	14736546	.	C	T	3	4	7	0	0	7	0	0
4	14826305	.	G	A	7	3	10	0	0	10	0	0
4	14844000	.	T	C	3	4	7	0	0	7	0	0
4	14863210	.	T	C	5	2	7	0	0	7	0	0
4	14863282	.	A	G	7	4	11	0	1	12	0	0
4	14863321	.	A	C	8	3	11	0	0	11	0	0
4	14863363	.	C	T	5	4	9	0	0	9	0	0
4	14895902	.	T	C	2	5	7	0	0	7	0	0
4	14896000	.	G	C	5	6	11	0	0	11	0	0
4	14896223	.	A	G	2	4	6	0	0	6	0	0
4	14896390	.	T	G	2	2	4	0	0	4	0	0
4	14896440	.	T	C	4	5	9	0	0	9	0	0
4	14896606	.	T	C	3	2	5	0	1	6	0	0
4	14896658	.	G	A	1	3	4	0	1	5	0	0
4	14900144	.	T	C	3	2	5	0	0	5	0	0
4	14901138	.	A	G	2	2	4	0	0	4	0	0
4	14901443	.	C	A	3	2	5	0	0	5	0	0
4	14906746	.	C	G	4	3	7	0	1	8	0	0
4	14906767	.	G	A	7	4	11	0	0	11	0	0
4	14906795	.	G	T	5	4	9	0	0	9	0	0
4	14906991	.	T	G	5	4	9	0	0	9	0	0
4	14906993	.	C	A	5	4	9	0	0	9	0	0
4	14909532	.	T	C	11	7	18	0	0	18	0	0
4	14912790	.	C	T	8	5	13	0	0	13	0	0
4	14912823	.	A	G	5	6	11	0	0	11	0	0
4	14912826	.	G	A	4	7	11	0	0	11	0	0
4	14912950	.	G	A	4	6	10	0	0	10	0	0
4	14913094	.	A	T	5	4	9	0	0	9	0	0
4	14915247	.	T	G	3	3	6	0	0	6	0	0
4	14915252	.	G	T	3	2	5	0	1	6	0	0
4	14917895	.	G	A	8	7	15	0	0	15	0	0
4	14919877	.	T	C	4	5	9	0	0	9	0	0
4	14920763	.	A	G	1	3	4	0	0	4	0	0
4	14923218	.	A	G	5	7	12	0	0	12	0	0
4	14926096	.	G	A	9	5	14	0	0	14	0	0
4	14926967	.	C	T	17	7	24	0	1	25	0	0
4	14928719	.	C	T	6	10	16	0	0	16	0	0
4	14928731	.	G	A	6	10	16	0	0	16	0	0
4	14929107	.	T	G	15	6	21	0	0	21	0	0
4	14931446	.	G	A	15	12	27	0	0	27	0	0
4	14932200	.	T	C	22	8	30	0	1	31	0	0
4	14932335	.	G	T	0	2	2	0	2	4	0	0
4	14932915	.	C	G	7	6	13	0	0	13	0	0
4	14933567	.	C	T	1	6	7	0	3	10	0	0
4	14933750	.	G	A	15	6	21	0	1	22	0	0
4	14933768	.	C	G	13	6	19	0	3	22	0	0
4	14938320	.	G	A	5	9	14	0	1	15	0	0
4	14938326	.	T	C	6	8	14	0	0	14	0	0
4	14951465	.	A	G	3	3	6	0	1	7	0	0
4	14991806	.	A	G	4	5	9	0	1	10	0	0
4	14992059	.	T	A	5	6	11	0	0	11	0	0
4	14992080	.	A	G	4	3	7	0	0	7	0	0
4	14992142	.	G	C	2	3	5	0	0	5	0	0
4	14992324	.	C	A	5	4	9	0	0	9	0	0
4	14992353	.	T	C	4	8	12	0	0	12	0	0
4	14992529	.	T	C	5	3	8	0	1	9	0	0
4	14992569	.	T	C	8	7	15	0	0	15	0	0
4	14992590	.	C	T	7	2	9	0	1	10	0	0
4	14992707	.	A	G	5	0	5	0	1	6	0	0
4	14992723	.	T	C	5	4	9	0	0	9	0	0
4	14992838	.	A	T	4	8	12	1	0	13	0	0
4	14992902	.	G	A	4	9	13	0	0	13	0	0
4	14992910	.	T	C	5	0	5	0	7	12	0	0
4	14993263	.	A	C	4	8	12	0	1	13	0	0
4	15003761	.	G	A	6	6	12	0	1	13	0	0
4	15008371	.	T	A	1	4	5	0	0	5	0	0
4	15008565	.	A	G	2	0	2	0	5	7	0	0
4	15009332	.	G	C	4	8	12	0	0	12	0	0
4	15009874	.	T	C	5	6	11	0	0	11	0	0
4	15009971	.	A	T	10	8	18	0	0	18	0	0
4	15010386	.	G	A	2	6	8	0	7	15	0	0
4	15010584	.	T	G	3	7	10	0	0	10	0	0
4	15010680	.	A	G	5	6	11	0	1	12	0	0
4	15010789	.	T	A	6	2	8	0	0	8	0	0
4	15058352	.	A	G	18	16	34	0	1	35	0	0
4	15058663	.	A	C	15	13	28	2	1	31	0	0
4	15058968	.	T	G	9	2	11	0	18	29	0	0
4	15059028	.	G	A	1	9	10	0	14	24	0	0
4	15059070	.	A	T	15	10	25	0	2	27	0	0
4	15059147	.	A	G	22	11	33	0	3	36	0	0
4	15059367	.	A	G	10	13	23	0	0	23	0	0
4	15059498	.	T	A	21	18	39	0	0	39	0	0
4	15059823	.	A	T	11	18	29	0	0	29	0	0
4	15081490	.	C	T	1	6	7	0	0	7	0	0
4	15081703	.	G	A	9	8	17	0	0	17	0	0
4	15081829	.	T	C	10	8	18	0	1	19	0	0
4	15081871	.	C	T	18	9	27	0	0	27	0	0
4	15081985	.	T	C	10	11	21	0	3	24	0	0
4	15096627	.	A	G	9	10	19	0	0	19	0	0
4	15218134	.	T	C	19	0	19	0	14	33	0	0
4	15218258	.	A	G	16	16	32	0	1	33	0	0
4	15218342	.	T	A	27	26	53	0	2	55	0	0
4	15218389	.	C	T	17	27	44	0	0	44	0	0
4	15218505	.	C	T	13	21	34	0	2	36	0	0
4	15218595	.	T	C	8	8	16	0	0	16	0	0
4	15218656	.	G	A	7	13	20	0	0	20	0	0
4	15218772	.	C	A	13	16	29	0	3	32	0	0
4	15218886	.	A	C	10	15	25	0	1	26	0	0
4	15219291	.	G	A	21	17	38	0	1	39	0	0
4	15219368	.	C	T	3	13	16	0	16	32	0	0
4	15219533	.	T	A	18	12	30	0	0	30	0	0
4	15219787	.	T	C	15	21	36	0	1	37	0	0
4	15219840	.	G	T	20	13	33	0	2	35	0	0
4	15219955	.	G	A	23	15	38	0	0	38	0	0
4	15220001	.	A	T	21	19	40	0	2	42	0	0
4	15220022	.	A	G	20	14	34	0	1	35	0	0
4	15220467	.	T	G	10	10	20	0	0	20	0	0
4	15238347	.	G	A	6	12	18	0	0	18	0	0
4	15247902	.	A	T	2	4	6	0	0	6	0	0
4	15250568	.	C	T	3	3	6	0	0	6	0	0
4	15500617	.	G	T	9	9	18	0	0	18	0	0
4	15500663	.	T	C	11	0	11	0	8	19	0	0
4	15500720	.	T	C	8	5	13	0	0	13	0	0
4	15585852	.	G	T	3	4	7	0	0	7	0	0
4	15600812	.	G	C	6	2	8	0	0	8	0	0
4	15600824	.	G	A	6	2	8	0	0	8	0	0
4	15636947	.	A	G	5	4	9	0	0	9	0	0
4	15775430	.	G	A	6	7	13	0	0	13	0	0
4	15795098	.	G	A	8	6	14	0	3	17	0	0
4	15799320	.	T	C	8	6	14	0	0	14	0	0
4	15799413	.	G	A	10	7	17	0	0	17	0	0
4	15799452	.	G	T	10	8	18	0	0	19	1	0
4	15799488	.	T	C	10	9	19	0	0	19	0	0
4	15816414	.	G	A	2	8	10	0	17	27	0	0
4	15831815	.	G	A	2	1	3	0	1	4	0	0
4	15833476	.	C	A	2	4	6	0	0	6	0	0
4	15981260	.	A	G	11	9	20	1	1	22	0	0
4	15981266	.	C	T	11	8	19	1	2	22	0	0
4	15981362	.	T	C	13	15	28	0	1	29	0	0
4	15981428	.	C	T	10	8	18	0	0	18	0	0
4	15984753	.	C	T	8	5	13	0	0	13	0	0
4	15988446	.	T	C	10	11	21	0	0	21	0	0
4	15989142	.	G	A	1	7	8	0	9	17	0	0
4	15989313	.	A	C	9	9	18	0	1	20	1	0
4	15989643	.	T	C	11	10	21	0	1	22	0	0
4	15989661	.	A	G	12	11	23	0	0	23	0	0
4	15989988	.	C	T	11	8	19	0	1	20	0	0
4	15991026	.	C	T	14	10	24	0	0	24	0	0
4	15992146	.	G	A	20	14	34	0	1	35	0	0
4	15992206	.	T	C	13	15	28	0	1	29	0	0
4	15993801	.	C	T	13	19	32	0	2	34	0	0
4	15993917	.	G	C	15	20	35	0	1	36	0	0
4	15993959	.	C	T	19	14	33	0	1	34	0	0
4	15995876	.	A	G	16	14	30	0	0	30	0	0
4	15996044	.	T	C	12	12	24	0	3	27	0	0
4	15996066	.	C	G	13	10	23	0	1	24	0	0
4	15998315	.	A	T	10	7	17	0	0	17	0	0
4	15999618	.	A	T	7	5	12	0	0	12	0	0
4	15999783	.	T	A	9	11	20	0	1	21	0	0
4	16001060	.	T	A	2	5	7	0	0	7	0	0
4	16077260	.	T	C	20	16	36	0	4	40	0	0
4	16078080	.	A	T	18	15	33	0	2	35	0	0
4	16078203	.	C	T	24	23	47	1	0	48	0	0
4	16078979	.	A	G	34	40	74	0	1	75	0	0
4	16081306	.	G	T	21	27	48	0	1	49	0	0
4	16085420	.	T	G	16	16	32	0	1	33	0	0
4	16086969	.	A	G	8	19	27	0	0	27	0	0
4	16086987	.	C	G	11	16	27	0	0	27	0	0
4	16087595	.	T	G	10	7	17	0	0	17	0	0
4	16088528	.	C	T	13	14	27	0	1	28	0	0
4	16088622	.	T	C	11	0	11	0	13	24	0	0
4	16088673	.	C	T	16	12	28	0	0	28	0	0
4	16090262	.	A	G	11	10	21	0	0	21	0	0
4	16098903	.	A	C	15	11	26	0	0	26	0	0
4	16098930	.	C	T	17	6	23	0	0	23	0	0
4	16111890	.	A	T	4	9	13	0	0	13	0	0
4	16112013	.	C	T	5	7	12	0	1	13	0	0
4	16791673	.	C	A	8	6	14	0	0	14	0	0
4	16857987	.	A	C	1	2	3	2	0	5	0	0
4	17661062	.	A	G	2	4	6	1	1	8	0	0
4	18207890	.	T	C	1	2	3	0	0	3	0	0
4	18208068	.	A	G	10	7	17	0	0	17	0	0
4	18208215	.	C	T	16	18	34	0	0	34	0	0
4	18208347	.	C	G	10	6	16	0	2	18	0	0
4	18208393	.	T	G	6	3	9	0	3	12	0	0
4	18208408	.	A	G	7	0	7	0	0	7	0	0
4	18208452	.	T	A	3	2	5	0	0	5	0	0
4	18208814	.	A	G	4	4	8	0	0	8	0	0
4	18208939	.	C	T	4	3	7	0	2	9	0	0
4	18209084	.	G	A	4	10	14	1	0	15	0	0
4	18237355	.	A	G	4	2	6	0	0	6	0	0
4	18240451	.	G	A	2	3	5	0	0	5	0	0
4	18240464	.	C	A	2	2	4	0	1	5	0	0
4	18240536	.	G	T	5	2	7	0	0	7	0	0
4	18240607	.	C	A	0	3	3	0	4	7	0	0
4	18240811	.	G	A	4	3	7	0	0	7	0	0
4	18241297	.	C	T	3	2	5	0	0	5	0	0
4	18241378	.	C	G	1	3	4	0	2	6	0	0
4	18242936	.	G	T	3	2	5	0	0	5	0	0
4	18244669	.	G	A	1	2	3	0	0	3	0	0
4	18244670	.	G	C	1	0	1	0	2	3	0	0
4	18248692	.	C	T	2	3	5	0	5	10	0	0
4	18249120	.	G	C	2	2	4	0	0	4	0	0
4	18249414	.	T	C	3	2	5	0	0	5	0	0
4	18249423	.	G	T	1	3	4	0	1	5	0	0
4	18283185	.	C	T	1	3	4	0	0	4	0	0
4	18287263	.	T	C	1	3	4	0	0	4	0	0
4	18287467	.	A	G	2	2	4	0	0	4	0	0
4	18296099	.	T	C	4	0	4	0	4	8	0	0
4	18296126	.	T	C	5	3	8	0	0	8	0	0
4	18301293	.	C	A	0	2	2	0	2	4	0	0
4	18301353	.	T	C	2	2	4	0	0	4	0	0
4	18301500	.	A	G	2	2	4	0	0	4	0	0
4	18416486	.	A	T	2	2	4	0	1	5	0	0
4	18432256	.	G	A	1	4	5	0	0	5	0	0
4	18432271	.	G	A	1	4	5	0	0	5	0	0
4	18432295	.	A	T	1	2	3	0	0	3	0	0
4	18436614	.	T	C	1	2	3	0	0	3	0	0
4	18454423	.	G	A	7	2	9	0	0	9	0	0
4	18454583	.	T	C	4	8	12	0	1	13	0	0
4	18502494	.	C	T	3	2	5	0	0	5	0	0
4	18503393	.	G	C	2	5	7	0	0	7	0	0
4	18503489	.	T	C	1	6	7	0	1	8	0	0
4	18503519	.	A	C	1	4	5	0	0	5	0	0
4	18504505	.	T	A	3	3	6	0	0	6	0	0
4	18609636	.	T	C	1	0	1	0	3	4	0	0
4	18609759	.	C	G	5	3	8	0	0	8	0	0
4	18609769	.	A	G	5	2	7	0	0	7	0	0
4	18609855	.	G	C	4	4	8	0	1	9	0	0
4	18610030	.	G	A	6	3	9	0	0	9	0	0
4	18614034	.	A	G	7	7	14	0	1	15	0	0
4	18614166	.	T	A	4	4	8	0	0	8	0	0
4	18614367	.	A	G	1	5	6	0	0	6	0	0
4	18720905	.	C	T	9	6	15	0	1	16	0	0
4	18720947	.	G	T	10	4	14	0	1	15	0	0
4	18733596	.	G	A	2	3	5	0	0	5	0	0
4	18734708	.	T	C	2	2	4	0	0	4	0	0
4	18836957	.	A	T	2	6	8	0	1	9	0	0
4	18837307	.	T	C	4	4	8	0	5	13	0	0
4	18837559	.	C	T	1	14	15	0	12	27	0	0
4	18837561	.	T	G	12	12	24	0	3	27	0	0
4	18838057	.	C	T	6	7	13	0	1	14	0	0
4	18839942	.	G	A	2	5	7	0	0	7	0	0
4	18839957	.	C	T	2	5	7	0	0	7	0	0
4	18849036	.	T	G	2	3	5	0	0	5	0	0
4	18850786	.	A	T	2	2	4	0	1	5	0	0
4	18853815	.	A	G	15	15	30	0	2	32	0	0
4	18853972	.	C	G	7	18	25	0	0	25	0	0
4	18854250	.	A	C	27	1	28	0	13	41	0	0
4	18854519	.	A	C	8	6	14	0	0	14	0	0
4	18854525	.	A	C	6	9	15	0	1	16	0	0
4	18967321	.	C	T	10	7	17	1	0	18	0	0
4	18976574	.	C	T	8	8	16	0	0	16	0	0
4	18979820	.	T	A	10	5	15	0	0	15	0	0
4	18984234	.	A	C	12	10	22	0	1	23	0	0
4	18984588	.	A	G	9	9	18	0	0	18	0	0
4	18984628	.	G	A	9	11	20	0	0	20	0	0
4	18984999	.	T	C	11	6	17	0	1	18	0	0
4	18985048	.	A	T	7	6	13	0	0	13	0	0
4	18985142	.	G	A	11	9	20	0	0	20	0	0
4	18985206	.	T	C	10	17	27	0	1	28	0	0
4	18985216	.	T	C	11	18	29	0	0	29	0	0
4	18985327	.	A	C	9	7	16	0	0	16	0	0
4	18985406	.	G	T	0	4	4	0	6	10	0	0
4	18985730	.	G	A	5	7	12	0	0	12	0	0
4	18986413	.	G	A	9	12	21	0	0	21	0	0
4	18986497	.	C	T	1	15	16	0	10	26	0	0
4	18986754	.	T	C	4	6	10	0	1	11	0	0
4	18986805	.	G	T	13	4	17	0	2	19	0	0
4	18986873	.	C	T	5	13	18	0	0	18	0	0
4	18986893	.	C	G	6	7	13	0	0	13	0	0
4	18987202	.	C	A	6	5	11	0	0	11	0	0
4	18987250	.	G	A	11	6	17	0	0	17	0	0
4	18987391	.	G	A	14	5	19	0	1	20	0	0
4	18988651	.	G	A	3	4	7	0	0	7	0	0
4	18988912	.	G	A	6	4	10	0	1	11	0	0
4	18989253	.	T	G	7	5	12	0	1	13	0	0
4	18999680	.	C	T	0	5	5	0	8	13	0	0
4	19007187	.	C	T	0	4	4	0	5	9	0	0
4	19007357	.	C	T	1	4	5	0	4	9	0	0
4	19007377	.	T	A	3	7	10	0	0	10	0	0
4	19007506	.	T	C	4	0	4	0	6	10	0	0
4	19007615	.	G	A	5	6	11	0	0	11	0	0
4	19007811	.	T	C	7	6	13	0	3	16	0	0
4	19007823	.	A	G	10	6	16	0	0	16	0	0
4	19016052	.	G	C	5	6	11	0	0	11	0	0
4	19397640	.	A	T	5	18	23	0	4	27	0	0
4	19397641	.	A	T	23	4	27	0	1	28	0	0
4	19414905	.	G	A	11	8	19	0	0	19	0	0
4	19421890	.	G	A	10	6	16	0	0	16	0	0
4	19493773	.	G	T	8	10	18	0	0	18	0	0
4	19535360	.	T	A	8	11	19	0	0	19	0	0
4	19535841	.	T	G	16	11	27	0	1	28	0	0
4	19536344	.	A	T	10	18	28	0	0	28	0	0
4	19536554	.	A	T	14	16	30	0	0	30	0	0
4	19536953	.	C	T	23	17	40	0	0	41	1	0
4	19536959	.	G	A	25	16	41	0	1	42	0	0
4	19537268	.	G	A	1	19	20	0	27	47	0	0
4	19537703	.	A	G	25	27	52	0	2	54	0	0
4	19537803	.	A	C	30	24	54	0	2	56	0	0
4	19537937	.	A	G	27	1	28	0	35	63	0	0
4	19538578	.	A	T	20	27	47	1	11	59	0	0
4	19539017	.	C	T	8	8	16	0	0	16	0	0
4	19611670	.	C	T	0	9	9	0	10	19	0	0
4	19611694	.	G	A	14	7	21	0	0	21	0	0
4	19611739	.	T	G	11	6	17	0	1	18	0	0
4	19611769	.	G	A	7	10	17	0	0	17	0	0
4	19651917	.	G	A	9	8	17	0	0	17	0	0
4	19664993	.	T	C	3	0	3	0	5	8	0	0
4	19690484	.	C	A	0	3	3	0	5	8	0	0
4	19693953	.	T	C	2	0	2	0	8	10	0	0
4	19884000	.	G	A	1	2	3	0	0	3	0	0
4	19947682	.	G	A	1	2	3	0	0	3	0	0
4	19947743	.	G	T	1	3	4	0	0	4	0	0
4	19948131	.	G	A	5	3	8	0	0	8	0	0
4	19948697	.	G	A	5	2	7	1	0	8	0	0
4	19948883	.	C	G	3	5	8	0	0	8	0	0
4	19949069	.	T	A	1	4	5	0	0	5	0	0
4	19949388	.	C	A	1	6	7	0	3	10	0	0
4	19949651	.	C	T	2	2	4	0	3	7	0	0
4	19949730	.	T	C	4	5	9	0	0	9	0	0
4	19949793	.	C	T	0	6	6	0	7	13	0	0
4	19949865	.	T	A	4	11	15	0	1	16	0	0
4	19950115	.	C	A	1	2	3	0	0	3	0	0
4	19950156	.	G	T	0	3	3	0	0	3	0	0
4	19950236	.	A	T	1	2	3	0	0	3	0	0
4	19955017	.	G	T	2	2	4	0	1	5	0	0
4	19962001	.	C	A	1	2	3	0	0	3	0	0
4	19962034	.	G	A	1	2	3	0	0	3	0	0
4	20037916	.	A	T	1	4	5	0	0	5	0	0
4	20053901	.	C	T	19	15	34	0	3	37	0	0
4	20054036	.	C	T	18	13	31	0	4	35	0	0
4	20054243	.	A	G	6	3	9	0	0	9	0	0
4	20054516	.	C	T	2	4	6	0	0	6	0	0
4	20065233	.	C	T	3	2	5	0	0	5	0	0
4	20065369	.	G	A	5	2	7	0	0	7	0	0
4	20065453	.	C	T	3	4	7	0	2	9	0	0
4	20065477	.	C	A	2	2	4	0	1	5	0	0
4	20065762	.	C	A	3	2	5	0	0	5	0	0
4	20066208	.	G	A	2	2	4	0	0	4	0	0
4	20066276	.	G	A	0	5	5	0	5	10	0	0
4	20068185	.	A	G	10	3	13	0	0	13	0	0
4	20068446	.	G	A	6	9	15	0	2	17	0	0
4	20068950	.	G	A	10	6	16	0	1	17	0	0
4	20069091	.	T	C	6	5	11	0	0	11	0	0
4	20069343	.	C	A	4	12	16	0	0	17	1	0
4	20071344	.	A	T	5	5	10	0	1	11	0	0
4	20071401	.	G	T	6	8	14	0	1	15	0	0
4	20071604	.	T	C	4	0	4	0	7	11	0	0
4	20072129	.	T	G	4	8	12	0	0	12	0	0
4	20072176	.	A	T	4	3	7	0	0	7	0	0
4	20072429	.	T	G	14	10	24	0	1	25	0	0
4	20072441	.	C	T	10	13	23	0	1	24	0	0
4	20073790	.	T	C	11	12	23	0	2	25	0	0
4	20075025	.	A	G	8	7	15	0	0	15	0	0
4	20075028	.	T	C	6	7	13	0	1	14	0	0
4	20075455	.	T	C	3	4	7	0	0	7	0	0
4	20075473	.	G	A	6	3	9	0	1	10	0	0
4	20080778	.	T	A	1	2	3	0	1	4	0	0
4	20082639	.	A	T	1	3	4	0	0	4	0	0
4	20082698	.	T	C	1	3	4	0	0	4	0	0
4	20091024	.	T	C	4	7	11	0	1	13	1	0
4	20091055	.	G	C	0	3	3	0	4	7	0	0
4	20093155	.	A	T	8	4	12	0	0	12	0	0
4	20094257	.	T	C	6	9	15	0	0	15	0	0
4	20094438	.	C	T	5	5	10	0	0	10	0	0
4	20094460	.	G	C	7	4	11	0	0	11	0	0
4	20098630	.	T	C	6	8	14	0	1	15	0	0
4	20098662	.	T	A	11	5	16	0	0	16	0	0
4	20098793	.	C	G	4	6	10	0	0	10	0	0
4	20099131	.	C	T	5	11	16	0	1	17	0	0
4	20099564	.	C	T	1	5	6	0	0	6	0	0
4	20099631	.	T	C	4	5	9	0	0	9	0	0
4	20100081	.	C	T	4	4	8	0	0	8	0	0
4	20100574	.	A	C	5	2	7	1	0	8	0	0
4	20100730	.	A	T	7	5	12	0	0	12	0	0
4	20100754	.	A	G	8	0	8	0	4	12	0	0
4	20100805	.	C	T	5	7	12	0	1	13	0	0
4	20101072	.	G	A	9	8	17	0	0	17	0	0
4	20101207	.	C	T	2	3	5	0	0	5	0	0
4	20101399	.	A	C	5	4	9	0	1	10	0	0
4	20101404	.	G	A	6	4	10	0	0	10	0	0
4	20101508	.	A	G	10	5	15	0	0	15	0	0
4	20101510	.	A	T	10	5	15	0	0	15	0	0
4	20101562	.	T	C	5	5	10	0	0	10	0	0
4	20102291	.	C	T	2	2	4	0	0	4	0	0
4	20102905	.	A	T	5	4	9	0	0	9	0	0
4	20105434	.	G	A	1	2	3	0	0	3	0	0
4	20125874	.	C	T	7	5	12	0	0	12	0	0
4	20125890	.	T	C	5	7	12	0	0	12	0	0
4	20127787	.	C	T	1	4	5	0	0	5	0	0
4	20130015	.	G	T	3	3	6	0	0	6	0	0
4	20146078	.	C	T	0	3	3	0	2	5	0	0
4	20903164	.	C	A	2	2	4	0	0	4	0	0
4	20903186	.	G	A	2	2	4	0	0	4	0	0
4	20919919	.	G	A	5	4	9	0	0	9	0	0
4	20930170	.	C	T	3	1	4	0	1	5	0	0
4	20949932	.	T	C	2	4	6	0	0	6	0	0
4	20958929	.	G	A	1	3	4	0	4	8	0	0
4	20970268	.	T	A	5	4	9	0	0	9	0	0
4	20971490	.	C	T	5	7	12	0	1	13	0	0
4	20974343	.	C	A	5	4	9	0	0	9	0	0
4	20976371	.	C	T	1	3	4	0	0	4	0	0
4	20979410	.	C	A	9	4	13	0	0	13	0	0
4	20979435	.	C	A	5	7	12	0	0	12	0	0
4	20980971	.	A	G	9	4	13	0	0	13	0	0
4	20981184	.	T	C	5	10	15	0	1	16	0	0
4	20981198	.	G	A	2	5	7	0	12	19	0	0
4	20981273	.	A	C	6	6	12	0	0	12	0	0
4	20986930	.	A	T	3	7	10	0	0	10	0	0
4	20987317	.	A	T	6	5	11	0	1	12	0	0
4	20987326	.	T	G	11	4	15	0	1	16	0	0
4	21263703	.	C	T	22	13	35	0	0	35	0	0
4	21290798	.	G	A	17	22	39	0	2	41	0	0
4	21312731	.	C	G	26	32	58	0	1	59	0	0
4	21312981	.	C	T	29	25	54	0	4	58	0	0
4	21313779	.	T	G	43	22	65	0	2	67	0	0
4	21313805	.	G	A	2	27	29	0	45	74	0	0
4	21314036	.	T	A	38	32	70	0	4	74	0	0
4	21314338	.	G	T	31	32	63	0	0	63	0	0
4	21314663	.	C	T	26	37	63	0	2	66	1	0
4	21314771	.	T	C	37	26	63	0	3	66	0	0
4	21314940	.	C	T	40	39	79	0	4	83	0	0
4	21323850	.	T	C	5	2	7	0	0	7	0	0
4	21369434	.	G	A	5	2	7	0	0	7	0	0
4	21489110	.	G	A	18	11	29	0	2	31	0	0
4	21489242	.	G	A	19	11	30	0	1	31	0	0
4	21489551	.	A	G	11	4	15	0	0	15	0	0
4	21489975	.	T	A	15	22	37	0	0	37	0	0
4	21507026	.	G	A	10	10	20	0	1	21	0	0
4	21508317	.	G	A	9	11	20	0	4	24	0	0
4	21508410	.	T	C	18	0	18	0	13	31	0	0
4	21512191	.	C	T	9	9	18	1	1	20	0	0
4	21519783	.	C	T	6	12	18	0	0	18	0	0
4	21523541	.	A	T	3	13	16	0	2	18	0	0
4	21523789	.	T	G	8	5	13	0	2	15	0	0
4	21525430	.	G	T	4	5	9	0	0	9	0	0
4	21539658	.	G	A	11	5	16	0	0	16	0	0
4	21651465	.	A	T	38	29	67	0	2	69	0	0
4	21651525	.	G	A	40	25	65	2	2	69	0	0
4	21652609	.	A	T	11	6	17	0	0	17	0	0
4	21752284	.	G	A	7	4	11	1	0	12	0	0
4	21752291	.	C	T	6	4	10	1	0	11	0	0
4	21752372	.	T	A	10	6	16	0	0	16	0	0
4	21752495	.	C	G	1	2	3	0	1	4	0	0
4	21752688	.	G	C	10	0	10	0	12	22	0	0
4	21752699	.	C	T	12	7	19	0	1	20	0	0
4	21752728	.	A	T	10	8	18	0	0	18	0	0
4	21752736	.	T	C	9	8	17	0	0	17	0	0
4	21752867	.	T	C	8	15	23	1	1	25	0	0
4	21753145	.	T	C	12	9	21	0	0	21	0	0
4	21761688	.	A	T	16	19	35	0	0	35	0	0
4	21766808	.	G	A	14	12	26	0	0	26	0	0
4	21958043	.	A	G	12	14	26	0	2	28	0	0
4	21958210	.	A	C	17	12	29	0	0	29	0	0
4	21958226	.	T	G	18	16	34	0	1	35	0	0
4	21962364	.	T	A	8	12	20	0	1	21	0	0
4	21967009	.	G	A	2	2	4	0	0	4	0	0
4	21973713	.	T	C	12	4	16	0	0	16	0	0
4	21974853	.	C	T	3	7	10	0	0	10	0	0
4	21975248	.	G	A	14	10	24	0	0	24	0	0
4	21975489	.	G	T	6	9	15	0	0	15	0	0
4	21981022	.	G	A	7	5	12	0	1	13	0	0
4	21981118	.	T	C	5	11	16	0	0	16	0	0
4	21987662	.	G	A	8	4	12	0	1	13	0	0
4	21987695	.	C	T	8	5	13	0	0	13	0	0
4	22006507	.	C	A	1	5	6	0	7	13	0	0
4	22010283	.	A	G	4	6	10	0	0	10	0	0
4	22010301	.	A	G	5	3	8	0	0	8	0	0
4	22029459	.	A	C	5	2	7	0	1	8	0	0
4	22299976	.	A	G	2	1	3	0	3	6	0	0
4	22300125	.	A	C	3	5	8	0	0	8	0	0
4	22300153	.	T	A	5	3	8	0	0	8	0	0
4	22300178	.	C	T	4	2	6	0	0	6	0	0
4	22312936	.	A	T	1	2	3	0	0	3	0	0
4	22313244	.	G	A	7	6	13	0	1	14	0	0
4	22313397	.	C	A	4	5	9	0	5	14	0	0
4	22313677	.	A	G	4	2	6	0	0	6	0	0
4	22313722	.	A	C	3	3	6	0	0	6	0	0
4	22313861	.	T	A	6	5	11	1	2	14	0	0
4	22314085	.	G	A	7	8	15	0	0	15	0	0
4	22314094	.	A	C	6	7	13	0	0	13	0	0
4	22314279	.	G	A	11	3	14	0	1	15	0	0
4	22316148	.	T	C	11	9	20	0	0	20	0	0
4	22316321	.	C	T	9	8	17	0	0	17	0	0
4	22316323	.	C	T	1	7	8	0	9	17	0	0
4	22316558	.	G	A	5	15	20	0	0	20	0	0
4	22316624	.	A	T	11	13	24	0	1	25	0	0
4	22318046	.	A	G	6	2	8	0	1	9	0	0
4	22318144	.	C	T	4	3	7	0	0	7	0	0
4	22318395	.	C	T	3	3	6	0	1	7	0	0
4	22318574	.	T	C	8	3	11	0	1	12	0	0
4	22318640	.	A	T	4	3	7	0	0	7	0	0
4	22318750	.	G	T	3	3	6	0	2	8	0	0
4	22319174	.	T	G	3	2	5	0	0	5	0	0
4	22319558	.	G	A	5	3	8	0	0	8	0	0
4	22319624	.	C	T	2	2	4	0	0	4	0	0
4	22319840	.	T	C	6	5	11	0	0	11	0	0
4	22319951	.	C	T	2	6	8	0	0	8	0	0
4	22320056	.	C	T	1	4	5	0	0	5	0	0
4	22320156	.	G	A	2	2	4	0	1	5	0	0
4	22320996	.	C	T	1	2	3	0	0	3	0	0
4	22321089	.	T	C	1	2	3	0	0	3	0	0
4	22321111	.	C	A	2	3	5	0	0	5	0	0
4	22321226	.	T	C	1	3	4	0	0	4	0	0
4	22321246	.	T	C	2	3	5	0	0	5	0	0
4	22321629	.	T	C	1	2	3	0	0	3	0	0
4	22328126	.	G	A	4	2	6	0	1	7	0	0
4	22328163	.	C	T	2	2	4	0	0	4	0	0
4	22329057	.	T	G	1	2	3	0	0	3	0	0
4	22363259	.	T	A	3	2	5	0	0	5	0	0
4	22363288	.	C	T	3	2	5	0	0	5	0	0
4	22365152	.	C	T	10	11	21	0	1	22	0	0
4	22365356	.	T	G	5	15	20	0	0	20	0	0
4	22365400	.	G	A	10	12	22	0	3	25	0	0
4	22365489	.	C	A	12	18	30	0	0	30	0	0
4	22418493	.	G	T	23	22	45	0	2	47	0	0
4	22418966	.	C	G	32	21	53	0	3	56	0	0
4	22419003	.	A	G	33	22	55	0	0	55	0	0
4	22419483	.	G	T	24	21	45	0	4	49	0	0
4	22424891	.	A	G	13	20	33	0	0	33	0	0
4	22424927	.	A	T	19	16	35	0	2	37	0	0
4	22425115	.	G	A	15	14	29	0	0	29	0	0
4	22428148	.	C	T	1	7	8	0	9	17	0	0
4	22428619	.	T	C	14	11	25	0	0	25	0	0
4	22429021	.	T	C	12	5	17	0	0	17	0	0
4	22432825	.	G	T	11	8	19	0	1	20	0	0
4	22433062	.	C	T	6	6	12	0	0	12	0	0
4	22433307	.	A	G	12	10	22	0	0	22	0	0
4	22433348	.	G	A	14	8	22	0	1	23	0	0
4	22433366	.	A	T	16	7	23	0	0	23	0	0
4	22433474	.	T	C	7	9	16	0	3	19	0	0
4	22472526	.	C	T	2	5	7	0	6	13	0	0
4	22480266	.	G	T	33	22	55	0	0	55	0	0
4	22480279	.	T	A	31	19	50	0	2	52	0	0
4	22482708	.	A	G	3	3	6	0	0	6	0	0
4	22482828	.	C	G	8	8	16	0	1	17	0	0
4	22482923	.	T	C	10	11	21	0	0	21	0	0
4	22482930	.	G	A	11	12	23	0	0	23	0	0
4	22483117	.	T	A	6	6	12	0	0	12	0	0
4	22485085	.	C	T	4	6	10	0	0	10	0	0
4	22485148	.	C	T	1	7	8	0	5	13	0	0
4	22491854	.	G	A	2	5	7	0	0	7	0	0
4	22492322	.	T	A	7	7	14	0	1	15	0	0
4	22492367	.	A	T	3	5	8	0	1	9	0	0
4	22492406	.	T	C	9	3	12	0	0	12	0	0
4	22494593	.	A	G	4	6	10	0	0	10	0	0
4	22494630	.	C	T	6	3	9	0	0	9	0	0
4	22495375	.	G	A	5	2	7	0	1	8	0	0
4	22652698	.	A	C	1	3	4	0	0	4	0	0
4	22652782	.	T	C	3	3	6	0	0	6	0	0
4	22652836	.	G	A	3	3	6	0	0	6	0	0
4	22658838	.	A	G	8	8	16	0	0	16	0	0
4	22659899	.	T	C	12	9	21	0	2	23	0	0
4	22660036	.	A	T	10	10	20	0	0	20	0	0
4	22670410	.	A	G	3	7	10	0	2	12	0	0
4	22671208	.	A	C	6	2	8	0	3	11	0	0
4	22671354	.	T	C	10	5	15	0	1	16	0	0
4	22680636	.	G	T	0	10	10	0	8	18	0	0
4	22697095	.	C	G	18	0	18	0	12	31	1	0
4	22697209	.	T	C	19	20	39	0	0	39	0	0
4	22707767	.	T	C	24	24	48	0	1	49	0	0
4	22707820	.	C	T	21	25	46	0	2	48	0	0
4	22709147	.	C	T	18	18	36	12	3	51	0	0
4	22713026	.	G	A	14	23	37	0	1	38	0	0
4	22713260	.	A	G	16	0	16	0	12	28	0	0
4	22713644	.	A	G	21	26	47	0	3	50	0	0
4	22713946	.	T	G	17	0	17	0	15	32	0	0
4	22730951	.	A	C	5	8	13	0	0	13	0	0
4	22731883	.	C	T	2	3	5	0	0	5	0	0
4	22731943	.	T	G	2	7	9	0	0	9	0	0
4	22734643	.	C	T	10	4	14	0	1	15	0	0
4	22734676	.	C	T	6	7	13	0	1	14	0	0
4	22736977	.	A	G	8	7	15	0	2	17	0	0
4	22738694	.	C	T	5	5	10	0	0	10	0	0
4	22739052	.	C	G	1	4	5	0	1	6	0	0
4	22740936	.	T	C	3	4	7	0	0	7	0	0
4	22741066	.	A	G	3	5	8	0	1	9	0	0
4	22743616	.	A	G	2	3	5	0	1	6	0	0
4	22749481	.	C	T	3	4	7	0	0	7	0	0
4	22749482	.	T	C	2	4	6	0	0	6	0	0
4	22755549	.	T	C	6	0	6	0	4	10	0	0
4	22755772	.	T	A	1	3	4	0	0	4	0	0
4	22756239	.	T	C	11	22	33	0	0	33	0	0
4	22756301	.	A	C	15	12	27	0	0	27	0	0
4	22756333	.	C	T	13	10	23	0	1	24	0	0
4	22756436	.	G	A	10	15	25	0	1	26	0	0
4	22756879	.	G	A	2	6	8	0	0	8	0	0
4	22756886	.	C	T	0	5	5	0	2	7	0	0
4	22757136	.	A	T	3	3	6	0	1	7	0	0
4	22757402	.	T	G	8	13	21	0	0	21	0	0
4	22757494	.	T	A	7	7	14	0	0	14	0	0
4	22757519	.	A	T	9	5	14	0	0	14	0	0
4	22758095	.	C	T	7	6	13	0	0	13	0	0
4	22758343	.	C	T	8	8	16	0	0	16	0	0
4	22758553	.	C	T	0	7	7	0	12	19	0	0
4	22768137	.	G	T	1	3	4	3	0	7	0	0
4	22768161	.	C	T	2	3	5	3	0	8	0	0
4	22773483	.	T	C	4	5	9	0	0	9	0	0
4	22776277	.	G	T	2	7	9	0	0	9	0	0
4	22776286	.	G	A	3	7	10	0	0	10	0	0
4	22865973	.	T	C	2	0	2	0	2	4	0	0
4	22981750	.	A	G	1	2	3	0	0	3	0	0
4	23122031	.	T	C	3	3	6	0	0	6	0	0
4	23122759	.	T	C	4	3	7	0	1	8	0	0
4	23122999	.	T	C	5	4	9	0	0	9	0	0
4	23129080	.	A	G	3	2	5	0	2	7	0	0
4	23132725	.	G	A	3	3	6	0	0	6	0	0
4	23132830	.	A	G	4	0	4	0	7	11	0	0
4	23134282	.	C	G	15	10	25	0	0	25	0	0
4	23134520	.	T	C	12	11	23	0	0	23	0	0
4	23134541	.	G	A	8	12	20	0	0	20	0	0
4	23135186	.	G	C	4	2	6	0	0	6	0	0
4	23135194	.	G	T	0	2	2	0	5	7	0	0
4	23135330	.	A	G	4	3	7	0	1	8	0	0
4	23135354	.	G	C	4	2	6	0	3	9	0	0
4	23135399	.	A	T	6	8	14	0	0	14	0	0
4	23135406	.	C	T	5	6	11	0	2	13	0	0
4	23135791	.	A	C	2	5	7	0	0	7	0	0
4	23135858	.	A	G	1	3	4	0	0	4	0	0
4	23135950	.	C	T	1	3	4	0	0	4	0	0
4	23135959	.	G	A	1	2	3	0	0	3	0	0
4	23229121	.	A	G	1	2	3	0	0	3	0	0
4	23303501	.	A	G	3	2	5	1	0	6	0	0
4	23303510	.	G	A	3	2	5	1	0	6	0	0
4	23303552	.	C	G	2	3	5	0	0	5	0	0
4	23391628	.	T	C	4	4	8	0	0	8	0	0
4	23404680	.	T	A	8	3	11	1	1	13	0	0
4	23408029	.	G	A	7	6	13	0	0	13	0	0
4	23465482	.	A	G	2	4	6	1	0	7	0	0
4	23465570	.	G	T	4	4	8	2	2	12	0	0
4	23486567	.	G	A	2	4	6	0	0	6	0	0
4	23527631	.	G	A	4	3	7	2	0	9	0	0
4	25055479	.	C	G	2	12	14	0	12	26	0	0
4	25055602	.	A	G	28	27	55	0	2	57	0	0
4	25084487	.	T	G	11	3	14	0	0	14	0	0
4	25084596	.	A	G	3	3	6	0	1	7	0	0
4	25084744	.	A	G	7	12	19	0	0	19	0	0
4	25104957	.	C	T	7	11	18	0	0	18	0	0
4	25105502	.	G	T	15	11	26	0	2	28	0	0
4	25105662	.	A	G	7	6	13	0	0	13	0	0
4	25165692	.	C	T	5	5	10	0	0	10	0	0
4	25165694	.	A	G	4	5	9	0	1	10	0	0
4	25168280	.	T	C	3	4	7	0	0	7	0	0
4	25168368	.	G	A	5	6	11	0	0	11	0	0
4	25168417	.	A	G	3	4	7	0	0	7	0	0
4	25168418	.	A	G	3	3	6	0	1	7	0	0
4	25173387	.	T	C	24	25	49	0	4	53	0	0
4	25173396	.	A	G	28	27	55	0	8	63	0	0
4	25176093	.	A	G	45	27	72	0	2	74	0	0
4	25178069	.	G	T	28	19	47	0	0	47	0	0
4	25178402	.	G	C	25	24	49	0	1	50	0	0
4	25178425	.	G	A	25	29	54	0	0	54	0	0
4	25179897	.	A	G	21	24	45	0	4	50	1	0
4	25179948	.	C	T	1	27	28	0	19	47	0	0
4	25179996	.	A	G	19	24	43	0	2	45	0	0
4	25184559	.	C	T	5	5	10	0	0	10	0	0
4	25184565	.	G	A	6	5	11	0	0	11	0	0
4	25184603	.	G	A	3	5	8	0	0	8	0	0
4	25184718	.	G	A	1	6	7	0	0	7	0	0
4	25184890	.	C	T	6	5	11	0	0	11	0	0
4	25185797	.	T	C	6	8	14	0	0	14	0	0
4	25332630	.	A	G	1	0	1	0	3	4	0	0
4	25353985	.	T	C	2	4	6	0	0	6	0	0
4	25353994	.	T	C	2	4	6	0	0	6	0	0
4	25354389	.	C	A	2	2	4	0	0	4	0	0
4	25354412	.	C	T	1	6	7	0	0	7	0	0
4	25356921	.	T	C	2	2	4	0	0	4	0	0
4	25473048	.	G	T	1	2	3	0	0	3	0	0
4	25473708	.	A	T	5	5	10	0	2	12	0	0
4	25473927	.	C	A	1	10	11	0	10	22	1	0
4	25473934	.	T	G	10	10	20	0	0	20	0	0
4	25474417	.	G	A	11	11	22	0	1	23	0	0
4	25476629	.	G	A	6	15	21	0	0	21	0	0
4	25478074	.	T	C	11	0	11	0	8	19	0	0
4	25479704	.	G	A	7	2	9	0	0	9	0	0
4	25480983	.	T	C	6	0	6	0	5	11	0	0
4	25480989	.	G	A	6	4	10	0	1	11	0	0
4	25481164	.	T	G	4	3	7	0	0	7	0	0
4	25482595	.	C	A	4	3	7	0	0	7	0	0
4	25485302	.	C	T	2	3	5	0	0	5	0	0
4	25485348	.	G	A	5	3	8	0	0	8	0	0
4	25485350	.	G	A	5	2	7	0	1	8	0	0
4	25485394	.	A	T	4	2	6	0	0	6	0	0
4	25497398	.	G	A	3	4	7	0	0	7	0	0
4	25497411	.	T	C	3	0	3	0	4	7	0	0
4	25497464	.	T	C	4	0	4	0	8	12	0	0
4	25502038	.	C	T	8	12	20	0	1	21	0	0
4	25505955	.	C	A	10	12	22	0	1	23	0	0
4	25506417	.	G	A	3	9	12	0	1	13	0	0
4	25506896	.	A	G	4	9	13	0	1	14	0	0
4	25511451	.	T	C	6	10	16	0	1	17	0	0
4	25512840	.	C	T	7	7	14	0	0	14	0	0
4	25515157	.	C	T	3	7	10	0	0	10	0	0
4	25515173	.	A	G	8	3	11	0	1	12	0	0
4	25515513	.	A	T	9	6	15	0	0	15	0	0
4	25700800	.	A	T	5	6	11	0	0	11	0	0
4	25702919	.	C	T	6	11	17	0	1	18	0	0
4	25703048	.	G	A	2	4	6	0	0	6	0	0
4	25703068	.	A	T	2	3	5	0	1	6	0	0
4	25703634	.	T	C	2	2	4	0	0	4	0	0
4	25750850	.	G	A	1	4	5	0	0	5	0	0
4	25754991	.	A	G	6	10	16	0	0	16	0	0
4	25755201	.	G	A	4	7	11	0	1	12	0	0
4	25755269	.	C	T	6	9	15	0	0	15	0	0
4	25755341	.	T	A	5	6	11	0	0	11	0	0
4	25755359	.	G	T	6	3	9	0	0	9	0	0
4	25755922	.	C	T	3	5	8	0	0	8	0	0
4	25756105	.	A	G	2	3	5	0	0	5	0	0
4	25756148	.	A	G	3	2	5	0	0	5	0	0
4	25756262	.	C	A	6	2	8	0	1	9	0	0
4	25756305	.	A	C	6	3	9	0	1	10	0	0
4	25756387	.	T	G	4	3	7	0	0	7	0	0
4	25756432	.	A	G	8	3	11	0	0	11	0	0
4	25759088	.	T	A	2	6	8	0	0	8	0	0
4	25759183	.	T	C	6	4	10	0	0	10	0	0
4	25759198	.	C	T	0	5	5	0	6	11	0	0
4	25759690	.	A	G	6	8	14	0	0	14	0	0
4	25759816	.	T	C	1	5	6	0	1	7	0	0
4	25796742	.	T	C	7	0	7	0	6	13	0	0
4	25796784	.	C	T	2	3	5	0	5	10	0	0
4	25833146	.	A	G	28	20	48	0	2	50	0	0
4	25839650	.	G	A	0	4	4	0	1	5	0	0
4	25839817	.	A	C	5	0	5	0	4	9	0	0
4	25842977	.	G	A	4	3	7	0	0	7	0	0
4	25843004	.	A	G	5	2	7	0	0	7	0	0
4	25843659	.	A	G	4	2	6	0	0	6	0	0
4	25846927	.	G	A	3	3	6	0	1	7	0	0
4	25851729	.	A	C	2	0	2	0	2	4	0	0
4	25860509	.	T	C	3	2	5	0	0	5	0	0
4	25860758	.	A	T	1	2	3	0	0	3	0	0
4	25860868	.	A	G	3	4	7	0	0	7	0	0
4	25861256	.	A	G	2	2	4	0	1	5	0	0
4	25862179	.	T	A	1	2	3	0	0	3	0	0
4	25862187	.	G	A	1	2	3	0	0	3	0	0
4	25920291	.	C	T	2	3	5	0	0	5	0	0
4	25932664	.	A	T	1	2	3	0	0	3	0	0
4	25934667	.	G	A	3	4	7	0	0	7	0	0
4	25934709	.	C	T	5	5	10	0	0	10	0	0
4	25934722	.	T	C	5	6	11	0	0	11	0	0
4	25936512	.	C	T	7	5	12	0	0	12	0	0
4	25939194	.	T	A	4	1	5	0	7	12	0	0
4	25939200	.	T	C	4	4	8	0	2	10	0	0
4	25946450	.	A	G	5	3	8	0	0	8	0	0
4	25946479	.	C	T	6	8	14	0	0	14	0	0
4	25946522	.	T	G	2	5	7	3	0	10	0	0
4	25946722	.	G	C	4	3	7	0	0	7	0	0
4	26016340	.	A	C	1	4	5	0	0	5	0	0
4	26021910	.	A	G	1	5	6	0	0	6	0	0
4	26021970	.	C	A	3	9	12	0	3	15	0	0
4	26022076	.	T	C	3	0	3	0	4	7	0	0
4	26022447	.	T	C	4	0	4	0	5	9	0	0
4	26022637	.	T	C	2	3	5	0	0	5	0	0
4	26022640	.	C	T	0	3	3	0	2	5	0	0
4	26026444	.	T	C	4	4	8	0	0	8	0	0
4	26027022	.	A	G	4	7	11	0	0	11	0	0
4	26028947	.	C	T	0	2	2	0	1	3	0	0
4	26060030	.	T	C	2	3	5	0	0	5	0	0
4	26064947	.	G	T	1	3	4	0	0	4	0	0
4	26068170	.	T	C	1	2	3	0	0	3	0	0
4	26075682	.	T	A	5	4	9	0	2	11	0	0
4	26075794	.	T	G	7	0	7	0	4	11	0	0
4	26075869	.	A	G	2	5	7	0	1	8	0	0
4	26075882	.	A	G	2	0	2	0	5	7	0	0
4	26077426	.	C	T	8	6	14	0	0	14	0	0
4	26078008	.	T	C	5	6	11	0	0	11	0	0
4	26078134	.	A	G	4	2	6	0	0	6	0	0
4	26078341	.	C	T	3	4	7	0	0	7	0	0
4	26078359	.	G	T	3	4	7	0	0	7	0	0
4	26078675	.	A	T	2	2	4	0	0	4	0	0
4	26078911	.	A	G	6	2	8	0	0	8	0	0
4	26079030	.	A	G	2	4	6	0	1	7	0	0
4	26079174	.	A	C	6	4	10	0	0	10	0	0
4	26079353	.	A	C	0	2	2	0	1	3	0	0
4	26079372	.	C	T	2	3	5	0	0	5	0	0
4	26079443	.	A	G	3	4	7	0	1	8	0	0
4	26079761	.	A	T	2	3	5	0	0	5	0	0
4	26079844	.	A	G	2	2	4	0	0	4	0	0
4	26079940	.	T	C	2	11	13	0	0	13	0	0
4	26080071	.	T	C	3	8	11	0	0	11	0	0
4	26080102	.	A	T	6	5	11	0	0	11	0	0
4	26080222	.	A	G	5	3	8	0	0	8	0	0
4	26080238	.	T	A	5	1	6	1	0	7	0	0
4	26080294	.	A	G	6	9	15	1	0	16	0	0
4	26080440	.	T	C	7	3	10	0	2	12	0	0
4	26080593	.	T	C	2	8	10	0	1	11	0	0
4	26080651	.	G	A	2	5	7	0	0	7	0	0
4	26081006	.	G	A	7	12	19	0	0	19	0	0
4	26303911	.	A	G	11	10	21	0	2	23	0	0
4	26303953	.	T	C	9	13	22	0	2	24	0	0
4	26304190	.	T	A	10	9	19	0	0	19	0	0
4	26304451	.	T	C	13	14	27	0	4	31	0	0
4	26306209	.	A	G	11	12	23	0	0	23	0	0
4	26321216	.	A	G	7	8	15	0	1	16	0	0
4	26322651	.	C	T	15	10	25	0	2	27	0	0
4	26322655	.	C	A	1	16	17	0	11	28	0	0
4	26322721	.	C	T	1	5	6	0	10	16	0	0
4	26496683	.	G	A	8	12	20	0	0	20	0	0
4	26496730	.	G	A	6	14	20	0	0	20	0	0
4	26629672	.	C	T	9	10	19	0	0	19	0	0
4	26762518	.	G	T	6	3	9	0	0	9	0	0
4	26762524	.	G	T	10	3	13	0	1	14	0	0
4	26764217	.	C	T	12	4	16	0	0	16	0	0
4	26765359	.	A	T	4	4	8	0	0	8	0	0
4	27082087	.	A	G	1	2	3	0	0	3	0	0
4	27091667	.	T	A	6	2	8	0	0	8	0	0
4	27091678	.	G	A	5	2	7	0	0	7	0	0
4	27109031	.	C	T	3	4	7	0	0	7	0	0
4	27109182	.	C	G	2	0	2	0	3	5	0	0
4	27109288	.	A	T	5	4	9	0	0	9	0	0
4	27112663	.	T	A	2	4	6	0	0	6	0	0
4	27113093	.	A	G	6	5	11	0	0	11	0	0
4	27113479	.	G	A	4	4	8	0	0	8	0	0
4	27113986	.	G	A	3	3	6	0	0	6	0	0
4	27115228	.	G	T	7	5	12	0	3	15	0	0
4	27115478	.	A	G	2	7	9	0	1	10	0	0
4	27117171	.	A	T	1	1	2	0	0	2	0	0
4	27117181	.	G	T	1	2	3	0	0	3	0	0
4	27130530	.	G	T	1	3	4	0	0	4	0	0
4	27133498	.	G	A	3	2	5	0	0	5	0	0
4	27133735	.	C	T	1	3	4	0	0	4	0	0
4	27137517	.	T	A	4	2	6	0	0	6	0	0
4	27137874	.	G	A	3	2	5	0	0	5	0	0
4	27137991	.	T	G	5	8	13	0	1	14	0	0
4	27139922	.	A	G	2	1	3	0	1	4	0	0
4	27147712	.	C	T	11	10	21	0	0	21	0	0
4	27148046	.	G	A	0	3	3	0	6	9	0	0
4	27148142	.	T	C	8	3	11	0	0	11	0	0
4	27148267	.	A	G	5	4	9	0	2	11	0	0
4	27148291	.	G	T	8	5	13	0	0	13	0	0
4	27148417	.	T	C	11	9	20	1	0	21	0	0
4	27148425	.	A	T	8	10	18	1	2	21	0	0
4	27148545	.	A	C	8	7	15	0	0	15	0	0
4	27148927	.	G	A	8	6	14	0	0	14	0	0
4	27148943	.	A	C	8	10	18	0	0	18	0	0
4	27149017	.	G	A	2	5	7	0	4	11	0	0
4	27149535	.	T	G	1	0	1	0	3	4	0	0
4	27149550	.	T	C	2	1	3	0	1	4	0	0
4	27252027	.	T	C	6	4	10	0	3	13	0	0
4	27252096	.	C	T	9	8	17	0	1	18	0	0
4	27252813	.	C	T	8	14	22	1	5	28	0	0
4	27253043	.	T	A	18	20	38	0	2	40	0	0
4	27350432	.	G	T	8	4	12	0	0	12	0	0
4	27350674	.	C	G	0	8	8	0	6	14	0	0
4	27835241	.	C	T	0	3	3	0	5	8	0	0
4	27869626	.	A	T	4	2	6	0	0	6	0	0
4	27869698	.	C	T	0	2	2	0	1	3	0	0
4	27898949	.	C	T	1	2	3	0	0	3	0	0
4	27938777	.	G	A	12	6	18	0	0	18	0	0
4	27938837	.	G	A	5	5	10	0	0	10	0	0
4	27941562	.	T	A	4	4	8	0	2	10	0	0
4	27941588	.	C	T	6	6	12	0	1	13	0	0
4	27945947	.	C	T	4	2	6	0	0	6	0	0
4	27945995	.	G	A	0	3	3	0	7	10	0	0
4	27946067	.	A	T	4	3	7	0	0	7	0	0
4	27953774	.	C	T	3	3	6	0	2	8	0	0
4	28423923	.	T	C	1	2	3	0	0	3	0	0
4	37246151	.	T	A	5	2	7	0	0	7	0	0
4	37246202	.	C	T	3	2	5	0	0	5	0	0
4	37510463	.	A	C	1	2	3	0	0	3	0	0
4	37510484	.	C	G	1	0	1	0	2	3	0	0
4	40959626	.	C	T	3	2	5	1	0	6	0	0
4	40959639	.	T	G	1	3	4	1	1	6	0	0
4	43919411	.	T	C	0	2	2	0	1	3	0	0
4	49579490	.	C	T	0	2	2	0	2	4	0	0
4	49579531	.	T	C	1	0	1	0	3	4	0	0
4	50755658	.	C	A	0	5	5	0	1	6	0	0
4	55451840	.	C	G	1	2	3	0	0	3	0	0
4	55451852	.	C	A	1	2	3	0	0	3	0	0
4	59773682	.	T	C	2	3	5	1	0	6	0	0
4	59773699	.	C	T	2	3	5	1	0	6	0	0
4	60381622	.	T	C	1	2	3	0	0	3	0	0
4	65727802	.	C	T	4	3	7	3	1	11	0	0
4	65727822	.	G	A	6	4	10	3	0	13	0	0
4	65727859	.	A	T	2	2	4	0	0	4	0	0
4	65727865	.	G	C	2	0	2	0	0	3	1	0
4	68497199	.	G	A	6	4	10	0	0	10	0	0
4	70846240	.	G	A	1	5	6	0	0	6	0	0
4	70850966	.	G	T	7	3	10	0	0	10	0	0
4	70851105	.	A	G	1	6	7	1	0	8	0	0
4	70851202	.	T	C	5	0	5	2	8	15	0	0
4	70855939	.	C	T	0	4	4	0	3	8	1	0
4	70866683	.	C	T	3	2	5	0	0	5	0	0
4	72217745	.	A	G	6	2	8	0	0	8	0	0
4	72272239	.	G	A	7	6	13	0	1	14	0	0
4	72272269	.	G	C	7	1	8	0	3	11	0	0
4	72272461	.	C	T	2	3	5	0	0	5	0	0
4	72272506	.	G	A	2	6	8	0	0	8	0	0
4	72272617	.	G	A	4	5	9	0	0	9	0	0
4	72275288	.	T	C	2	1	3	0	0	3	0	0
4	72348990	.	C	G	2	2	4	0	0	4	0	0
4	72349109	.	T	C	1	0	1	0	2	3	0	0
4	72437838	.	G	A	2	2	4	0	0	4	0	0
4	72534946	.	C	T	0	2	2	0	2	4	0	0
4	72546669	.	C	T	0	2	2	0	3	5	0	0
4	72549699	.	G	A	2	2	4	0	0	4	0	0
4	72559417	.	A	G	1	3	4	0	0	4	0	0
4	72559474	.	G	A	4	2	6	0	0	6	0	0
4	72559558	.	A	G	2	4	6	0	0	6	0	0
4	72559612	.	A	G	4	2	6	0	0	6	0	0
4	72559629	.	C	G	2	4	6	0	0	6	0	0
4	72559951	.	C	T	1	3	4	0	2	6	0	0
4	72560020	.	C	A	0	2	2	0	1	3	0	0
4	72573315	.	C	G	0	2	2	1	2	5	0	0
4	72604169	.	T	C	2	1	3	0	1	4	0	0
4	72604179	.	T	C	2	2	4	0	0	4	0	0
4	72628932	.	G	A	5	3	8	0	0	8	0	0
4	72629058	.	C	T	0	4	4	0	1	5	0	0
4	72629115	.	A	G	2	3	5	0	0	5	0	0
4	72629131	.	T	C	1	0	1	0	2	3	0	0
4	72630174	.	A	G	3	6	9	0	0	9	0	0
4	72630192	.	A	G	3	7	10	0	0	10	0	0
4	72630316	.	G	A	2	2	4	0	1	5	0	0
4	72723788	.	T	C	13	20	33	0	2	35	0	0
4	72723832	.	A	T	9	10	19	0	2	21	0	0
4	72723858	.	A	G	10	12	22	0	1	23	0	0
4	72748096	.	T	C	18	18	36	0	1	37	0	0
4	72754244	.	C	T	13	22	35	0	1	36	0	0
4	73064897	.	A	G	2	2	4	0	3	7	0	0
4	73064903	.	A	C	1	2	3	0	1	5	1	0
4	73277789	.	T	C	1	2	3	0	0	3	0	0
4	73336664	.	T	C	4	2	6	0	2	8	0	0
4	73336711	.	T	C	0	0	0	0	5	5	0	0
4	73343074	.	A	G	4	3	7	0	0	7	0	0
4	73383217	.	G	A	1	5	6	0	0	6	0	0
4	73419937	.	G	A	4	2	6	0	0	6	0	0
4	73419970	.	G	A	2	3	5	0	0	5	0	0
4	73473010	.	C	G	2	2	4	0	0	4	0	0
4	73473128	.	T	C	3	5	8	0	0	8	0	0
4	73473154	.	T	C	4	4	8	0	0	8	0	0
4	73473169	.	G	C	3	2	5	0	0	5	0	0
4	73491301	.	C	T	0	3	3	0	2	5	0	0
4	73498762	.	T	A	0	2	2	0	0	2	0	0
4	73498853	.	A	G	1	4	5	0	0	5	0	0
4	73498855	.	T	A	1	4	5	0	0	5	0	0
4	73498990	.	T	C	5	4	9	0	0	9	0	0
4	73499046	.	T	C	6	8	14	0	0	14	0	0
4	73499279	.	T	C	3	2	5	0	0	5	0	0
4	73499433	.	G	A	2	4	6	0	0	6	0	0
4	73500630	.	G	A	1	2	3	0	0	3	0	0
4	73501137	.	C	A	1	2	3	0	0	3	0	0
4	73520072	.	G	A	2	4	6	0	1	7	0	0
4	73542707	.	T	G	2	3	5	0	1	6	0	0
4	73542786	.	G	A	1	2	3	0	0	3	0	0
4	73542830	.	C	T	3	2	5	0	0	5	0	0
4	73542845	.	G	A	3	1	4	0	0	4	0	0
4	73550570	.	A	T	3	2	5	0	1	6	0	0
4	73550610	.	A	T	3	4	7	0	0	7	0	0
4	73551592	.	A	C	1	2	3	0	0	3	0	0
4	73563458	.	T	G	2	3	5	0	0	5	0	0
4	73563467	.	A	T	2	2	4	0	0	4	0	0
4	73563494	.	C	T	2	3	5	0	0	5	0	0
4	73574374	.	G	A	2	3	5	0	0	5	0	0
4	73574386	.	T	A	3	3	6	0	0	6	0	0
4	73575192	.	T	A	1	3	4	0	0	4	0	0
4	73575273	.	G	A	2	3	5	0	0	5	0	0
4	73575282	.	G	A	2	3	5	0	0	5	0	0
4	73575576	.	G	T	5	2	7	0	0	7	0	0
4	73575858	.	C	A	0	2	2	0	3	5	0	0
4	73575898	.	G	A	2	2	4	0	1	5	0	0
4	73575899	.	G	A	1	1	2	0	2	4	0	0
4	73575958	.	C	T	1	1	2	0	0	2	0	0
4	73575967	.	C	T	1	2	3	0	0	3	0	0
4	73730609	.	A	G	1	2	3	2	1	6	0	0
4	73759394	.	T	C	1	3	4	0	0	4	0	0
4	73897713	.	T	C	4	2	6	0	0	6	0	0
4	73897725	.	C	T	4	2	6	0	0	6	0	0
4	73897923	.	T	C	3	3	6	0	0	6	0	0
4	73899267	.	A	G	3	2	5	0	0	5	0	0
4	74204687	.	A	G	3	2	5	0	0	5	0	0
4	74871582	.	A	G	1	2	3	0	0	3	0	0
4	74875829	.	A	G	2	4	6	0	0	6	0	0
4	74943202	.	A	T	15	19	34	0	0	34	0	0
4	74952477	.	G	A	13	17	30	0	0	30	0	0
4	74952525	.	A	G	13	0	13	0	17	30	0	0
4	74952660	.	G	T	2	16	18	0	11	29	0	0
4	74960826	.	C	T	18	19	37	0	2	39	0	0
4	74961011	.	C	T	11	9	20	0	4	24	0	0
4	74961075	.	G	A	9	13	22	0	0	22	0	0
4	74961520	.	T	A	8	6	14	0	0	14	0	0
4	74961625	.	G	T	2	2	4	0	0	4	0	0
4	74979476	.	A	G	4	2	6	0	0	6	0	0
4	75013576	.	T	C	3	3	6	0	0	6	0	0
4	75021131	.	A	G	2	2	4	0	0	4	0	0
4	75038012	.	T	A	2	2	4	0	0	4	0	0
4	75138792	.	G	A	7	9	16	0	0	16	0	0
4	75139194	.	C	T	10	14	24	0	0	24	0	0
4	75142239	.	C	T	12	7	19	0	0	19	0	0
4	75142269	.	G	A	4	13	17	0	0	17	0	0
4	75146453	.	C	T	11	14	25	0	1	26	0	0
4	75149026	.	T	C	12	11	23	0	1	24	0	0
4	75149056	.	C	T	16	11	27	0	1	28	0	0
4	75149071	.	T	A	18	11	29	0	1	30	0	0
4	75149125	.	C	A	1	8	9	0	12	21	0	0
4	75149149	.	C	T	0	10	10	0	12	22	0	0
4	75150767	.	G	A	8	13	21	0	0	21	0	0
4	75153925	.	C	T	4	7	11	0	0	11	0	0
4	75154498	.	G	T	11	4	15	0	1	16	0	0
4	75157664	.	T	C	2	6	8	0	0	8	0	0
4	75157666	.	T	G	6	2	8	0	0	8	0	0
4	75268018	.	C	T	3	2	5	0	0	5	0	0
4	75294225	.	G	C	1	2	3	0	2	5	0	0
4	75388941	.	C	T	2	2	4	0	0	4	0	0
4	75406038	.	C	A	3	2	5	0	0	5	0	0
4	75410079	.	A	C	2	2	4	0	0	4	0	0
4	75416590	.	C	T	1	5	6	0	0	6	0	0
4	75416706	.	G	A	1	4	5	0	0	5	0	0
4	75417250	.	T	G	4	2	6	0	0	6	0	0
4	75417258	.	T	A	3	2	5	0	0	5	0	0
4	75417632	.	C	T	1	2	3	0	0	3	0	0
4	75417643	.	T	C	1	2	3	0	0	3	0	0
4	75417723	.	C	A	1	3	4	0	0	4	0	0
4	75417735	.	T	C	1	4	5	0	0	5	0	0
4	75417762	.	A	G	3	5	8	0	0	8	0	0
4	75419250	.	A	T	5	2	7	0	0	7	0	0
4	75419353	.	C	T	3	7	10	0	0	10	0	0
4	75419387	.	C	T	2	7	9	0	0	9	0	0
4	75419421	.	G	T	1	8	9	0	0	9	0	0
4	75419428	.	C	T	1	6	7	0	1	8	0	0
4	75419528	.	G	C	0	2	2	0	3	5	0	0
4	75419551	.	G	C	0	2	2	0	2	4	0	0
4	75419683	.	G	T	1	9	10	0	6	16	0	0
4	75419819	.	C	G	6	11	17	0	0	17	0	0
4	75419822	.	A	C	8	8	16	0	1	17	0	0
4	75419916	.	G	T	9	4	13	0	1	14	0	0
4	75419928	.	T	G	11	0	11	0	4	15	0	0
4	75419961	.	A	C	12	7	19	0	3	22	0	0
4	75419970	.	G	A	3	8	11	0	12	23	0	0
4	75420186	.	A	G	5	1	6	0	4	10	0	0
4	75420194	.	T	C	6	4	10	0	0	10	0	0
4	75420264	.	C	A	7	2	9	1	0	10	0	0
4	75420270	.	A	G	7	2	9	1	0	10	0	0
4	75420558	.	A	T	6	4	10	0	0	10	0	0
4	75420565	.	A	G	7	3	10	0	0	10	0	0
4	75420647	.	A	T	2	2	4	0	0	4	0	0
4	75420754	.	T	A	3	4	7	1	0	8	0	0
4	75420873	.	A	C	3	13	16	0	0	16	0	0
4	75420931	.	A	G	3	4	7	0	1	8	0	0
4	76320752	.	G	A	1	3	4	2	0	6	0	0
4	76320798	.	C	G	3	4	7	1	0	8	0	0
4	76322771	.	T	C	7	3	10	0	0	10	0	0
4	76322882	.	G	A	0	4	4	0	3	7	0	0
4	76334633	.	A	G	2	0	2	0	4	6	0	0
4	76336468	.	T	A	2	4	6	0	0	6	0	0
4	76336471	.	A	C	4	2	6	0	1	7	0	0
4	76343790	.	A	C	1	2	3	0	0	3	0	0
4	76343802	.	T	C	1	2	3	0	0	3	0	0
4	76345427	.	C	T	4	2	6	5	0	11	0	0
4	76345433	.	T	C	1	5	6	5	0	11	0	0
4	76345689	.	C	T	5	5	10	0	0	10	0	0
4	76345708	.	G	T	5	2	7	1	1	9	0	0
4	76345923	.	A	G	2	0	2	0	4	6	0	0
4	76345974	.	A	G	2	5	7	0	0	7	0	0
4	76346004	.	T	C	3	3	6	0	0	6	0	0
4	76346011	.	T	C	3	2	5	0	1	6	0	0
4	76346153	.	G	C	4	3	7	0	0	7	0	0
4	76346188	.	T	A	4	7	11	0	0	11	0	0
4	76346238	.	C	A	8	3	11	3	0	14	0	0
4	76346509	.	C	A	6	5	11	7	0	18	0	0
4	76347126	.	T	C	2	3	5	1	0	6	0	0
4	76347163	.	A	G	4	3	7	1	1	9	0	0
4	76347508	.	T	G	5	4	9	0	1	10	0	0
4	76347977	.	A	T	2	3	5	0	0	5	0	0
4	76348088	.	T	A	1	6	7	0	0	7	0	0
4	76363060	.	A	C	3	2	5	0	1	6	0	0
4	76363195	.	C	T	1	5	6	0	1	7	0	0
4	76363204	.	A	C	2	5	7	0	0	7	0	0
4	76378187	.	C	T	1	2	3	0	0	3	0	0
4	76378189	.	C	T	1	2	3	0	0	3	0	0
4	76409375	.	A	T	5	2	7	0	0	7	0	0
4	76409385	.	C	G	4	2	6	0	0	6	0	0
4	76409422	.	C	T	3	4	7	0	0	7	0	0
4	76409565	.	G	A	1	2	3	0	0	3	0	0
4	76409976	.	C	A	1	2	3	0	1	4	0	0
4	76410940	.	G	T	2	2	4	0	1	5	0	0
4	76410955	.	C	T	2	2	4	0	0	4	0	0
4	76411517	.	T	C	1	4	5	0	0	5	0	0
4	76411757	.	A	T	4	4	8	0	1	9	0	0
4	76411759	.	A	T	5	4	9	0	0	9	0	0
4	76411990	.	A	G	3	0	3	0	5	8	0	0
4	76412061	.	A	G	3	2	5	0	0	5	0	0
4	76412570	.	G	A	4	2	6	0	1	7	0	0
4	76412751	.	A	T	1	2	3	0	0	3	0	0
4	76412791	.	A	G	2	2	4	0	0	4	0	0
4	76413037	.	C	G	4	2	6	0	0	6	0	0
4	76413079	.	C	T	5	2	7	0	0	7	0	0
4	76416860	.	A	G	1	5	6	0	0	6	0	0
4	76420841	.	G	T	1	2	3	0	1	4	0	0
4	76420930	.	T	A	1	3	4	0	0	4	0	0
4	76421193	.	C	T	2	2	4	0	1	5	0	0
4	76421602	.	A	C	5	3	8	0	0	8	0	0
4	76421886	.	C	T	3	2	5	0	0	5	0	0
4	76422057	.	T	A	2	7	9	0	0	9	0	0
4	76422129	.	G	T	2	3	5	0	6	11	0	0
4	76422231	.	G	A	1	2	3	0	3	6	0	0
4	76422357	.	T	C	1	2	3	0	1	4	0	0
4	76422395	.	C	T	2	2	4	0	0	4	0	0
4	76422424	.	A	G	2	4	6	0	0	6	0	0
4	76422432	.	G	A	2	3	5	0	0	5	0	0
4	76422615	.	C	T	2	2	4	0	0	4	0	0
4	76422891	.	A	G	2	0	2	0	4	6	0	0
4	76423177	.	A	G	8	2	10	0	0	10	0	0
4	76423234	.	G	A	8	3	11	2	0	13	0	0
4	76423537	.	C	T	3	4	7	0	0	7	0	0
4	76427137	.	G	C	1	3	4	0	0	4	0	0
4	76427145	.	A	G	1	3	4	0	1	5	0	0
4	76429545	.	C	A	2	2	4	0	0	4	0	0
4	76429734	.	A	G	3	0	3	4	4	11	0	0
4	76429742	.	A	T	3	5	8	2	0	10	0	0
4	76430115	.	G	A	4	4	8	0	1	9	0	0
4	76430256	.	G	A	3	3	6	0	0	6	0	0
4	76430257	.	A	G	3	3	6	0	0	6	0	0
4	76430468	.	C	T	3	4	7	0	0	7	0	0
4	76436823	.	T	G	5	2	7	0	0	7	0	0
4	76436889	.	A	G	3	2	5	0	0	5	0	0
4	76436914	.	G	A	1	2	3	0	0	3	0	0
4	76436925	.	C	T	2	3	5	0	0	5	0	0
4	76437869	.	A	G	2	4	6	0	0	6	0	0
4	76437999	.	A	T	3	2	5	0	0	5	0	0
4	76438012	.	A	T	4	3	7	0	0	7	0	0
4	76439062	.	G	A	3	2	5	0	1	6	0	0
4	76439228	.	C	T	1	3	4	0	1	5	0	0
4	76439409	.	A	G	3	0	3	0	2	5	0	0
4	76439435	.	A	G	0	0	0	0	3	3	0	0
4	76463475	.	A	G	2	2	4	0	1	5	0	0
4	76463517	.	G	A	1	4	5	0	0	5	0	0
4	76464562	.	A	G	3	0	3	0	2	5	0	0
4	76474339	.	G	C	1	3	4	0	0	4	0	0
4	76480573	.	T	C	1	3	4	0	0	4	0	0
4	76480996	.	C	T	1	4	5	1	3	9	0	0
4	76481087	.	C	A	0	4	4	0	4	8	0	0
4	76481103	.	T	C	4	7	11	0	0	11	0	0
4	76481177	.	T	C	5	0	5	0	7	12	0	0
4	76481403	.	T	A	5	18	23	0	0	23	0	0
4	76481409	.	T	G	16	7	23	0	1	24	0	0
4	76481665	.	A	T	4	3	7	0	1	8	0	0
4	76481692	.	T	C	1	0	1	0	2	3	0	0
4	76482245	.	C	T	1	2	3	0	0	3	0	0
4	76482273	.	C	G	2	2	4	0	1	5	0	0
4	76482487	.	G	T	4	2	6	0	1	7	0	0
4	76482509	.	G	A	3	4	7	0	0	7	0	0
4	76482696	.	T	A	5	3	8	0	0	8	0	0
4	76484531	.	T	C	2	3	5	0	0	5	0	0
4	76484688	.	C	T	7	3	10	0	0	10	0	0
4	76484727	.	G	T	6	4	10	0	1	11	0	0
4	76488244	.	A	T	8	3	11	0	0	11	0	0
4	76488269	.	G	T	7	5	12	0	0	12	0	0
4	76488514	.	T	A	2	2	4	0	0	4	0	0
4	76488617	.	G	A	5	2	7	0	1	8	0	0
4	76488624	.	A	G	1	6	7	0	0	7	0	0
4	76488742	.	G	C	1	7	8	0	0	8	0	0
4	76488820	.	G	A	1	3	4	1	0	5	0	0
4	76503193	.	T	C	3	5	8	0	0	8	0	0
4	76575587	.	A	G	3	3	6	0	0	6	0	0
4	76575611	.	A	G	3	2	5	0	0	5	0	0
4	76582040	.	T	C	2	2	4	0	0	4	0	0
4	76582384	.	A	G	1	2	3	0	0	3	0	0
4	76587462	.	T	C	2	9	11	0	0	11	0	0
4	76587474	.	C	T	4	7	11	1	1	13	0	0
4	76588133	.	A	C	7	5	12	3	1	16	0	0
4	76588134	.	C	G	8	0	8	3	5	16	0	0
4	76588177	.	T	C	7	6	13	0	1	14	0	0
4	76588256	.	G	C	9	7	16	0	0	16	0	0
4	76588295	.	G	T	4	8	12	0	1	13	0	0
4	76852287	.	C	A	1	2	3	0	0	3	0	0
4	76852299	.	G	A	0	1	1	0	2	3	0	0
4	76866993	.	A	G	5	4	9	0	2	11	0	0
4	76867394	.	A	T	9	3	12	0	0	12	0	0
4	76867743	.	T	C	8	5	13	1	0	14	0	0
4	76867829	.	C	G	4	3	7	0	1	8	0	0
4	77047149	.	G	C	1	2	3	0	0	3	0	0
4	77050628	.	A	G	1	0	1	1	4	6	0	0
4	77050633	.	A	G	1	4	5	1	0	6	0	0
4	77051421	.	A	G	1	2	3	0	1	4	0	0
4	77051459	.	A	T	1	3	4	0	0	4	0	0
4	77051715	.	C	T	1	2	3	0	0	3	0	0
4	77051720	.	C	G	2	1	3	0	1	4	0	0
4	77052010	.	G	A	1	2	3	0	0	3	0	0
4	77052016	.	T	C	1	2	3	0	0	3	0	0
4	77052677	.	A	G	3	0	3	0	2	5	0	0
4	77057243	.	G	C	2	6	8	0	0	8	0	0
4	77057635	.	C	T	3	2	5	0	0	5	0	0
4	77057671	.	G	A	6	2	8	0	0	8	0	0
4	77057695	.	C	G	7	0	7	0	3	10	0	0
4	77058024	.	G	A	2	3	5	0	0	5	0	0
4	77058097	.	T	C	3	3	6	0	0	6	0	0
4	77058108	.	A	G	3	3	6	0	0	6	0	0
4	77058420	.	C	G	3	2	5	0	0	5	0	0
4	77058436	.	A	T	4	3	7	0	0	7	0	0
4	77058543	.	G	A	1	2	3	0	3	6	0	0
4	77058603	.	A	T	7	2	9	0	1	10	0	0
4	77058604	.	A	G	8	2	10	0	0	10	0	0
4	77058723	.	A	G	6	5	11	0	0	11	0	0
4	77060002	.	A	G	3	2	5	0	0	5	0	0
4	77065070	.	G	T	1	1	2	0	0	2	0	0
4	77065082	.	T	A	1	2	3	0	0	3	0	0
4	77065265	.	G	A	2	2	4	0	1	5	0	0
4	77065304	.	A	T	3	4	7	0	0	7	0	0
4	77065472	.	G	A	0	5	5	0	5	10	0	0
4	77065540	.	G	A	2	5	7	0	0	7	0	0
4	77100775	.	G	T	0	1	1	0	3	4	0	0
4	77100790	.	A	G	2	1	3	0	2	5	0	0
4	77146423	.	A	G	1	3	4	0	0	4	0	0
4	77147496	.	A	G	1	2	3	0	0	3	0	0
4	77147857	.	T	C	2	2	4	0	0	4	0	0
4	77148661	.	T	C	3	2	5	0	0	5	0	0
4	77148695	.	G	T	7	2	9	0	0	9	0	0
4	77148807	.	T	C	2	2	4	0	0	4	0	0
4	77148814	.	G	A	0	1	1	0	3	4	0	0
4	77149765	.	C	T	1	2	3	0	1	4	0	0
4	77149888	.	C	T	5	4	9	0	0	9	0	0
4	77158384	.	A	G	1	0	1	0	2	3	0	0
4	77158391	.	A	G	1	0	1	0	2	3	0	0
4	77193791	.	A	G	1	2	3	0	0	3	0	0
4	77207768	.	G	C	3	7	10	0	0	10	0	0
4	77207903	.	C	T	1	16	17	0	7	24	0	0
4	77212090	.	T	A	4	7	11	0	2	13	0	0
4	77214843	.	C	A	2	3	5	0	3	8	0	0
4	77214846	.	G	A	2	3	5	0	0	5	0	0
4	77220252	.	T	C	1	0	1	0	3	4	0	0
4	77222161	.	A	C	4	2	6	0	0	6	0	0
4	77222180	.	G	A	3	3	6	0	1	7	0	0
4	77229619	.	C	G	0	2	2	0	1	3	0	0
4	77229875	.	G	A	3	2	5	0	1	6	0	0
4	77230775	.	T	G	4	4	8	0	0	8	0	0
4	77230829	.	G	C	3	0	3	0	2	5	0	0
4	77230839	.	T	A	2	3	5	0	0	5	0	0
4	77233844	.	A	C	2	3	5	0	0	5	0	0
4	77233847	.	C	T	1	3	4	0	0	4	0	0
4	77233945	.	C	T	2	3	5	0	0	5	0	0
4	77250537	.	G	A	4	3	7	0	0	7	0	0
4	77250856	.	A	T	7	4	11	0	1	12	0	0
4	77250862	.	G	A	7	4	11	0	1	12	0	0
4	77250931	.	T	C	1	3	4	0	1	5	0	0
4	77250939	.	T	C	3	2	5	0	0	5	0	0
4	77251255	.	A	G	8	3	11	0	1	12	0	0
4	77251264	.	A	G	7	4	11	0	2	13	0	0
4	77251949	.	T	G	4	4	8	1	0	9	0	0
4	77252256	.	G	A	1	2	3	0	0	3	0	0
4	77254782	.	A	C	2	0	2	0	2	4	0	0
4	77254999	.	T	C	3	4	7	0	0	7	0	0
4	77260336	.	A	G	1	2	3	0	0	3	0	0
4	77260337	.	C	T	0	2	2	0	1	3	0	0
4	77262996	.	T	C	3	0	3	0	3	6	0	0
4	77270251	.	A	G	7	3	10	0	0	10	0	0
4	77270517	.	A	T	1	2	3	0	0	3	0	0
4	77270523	.	A	G	2	2	4	0	0	4	0	0
4	77270604	.	A	T	3	2	5	0	0	5	0	0
4	77270773	.	G	C	1	4	5	0	0	5	0	0
4	77271020	.	G	A	3	3	6	0	0	6	0	0
4	77271057	.	A	G	3	2	5	0	2	7	0	0
4	77271257	.	T	C	5	0	5	0	6	11	0	0
4	77271278	.	G	A	3	7	10	0	1	11	0	0
4	77271310	.	C	T	5	3	8	0	1	9	0	0
4	77271341	.	T	A	8	4	12	0	0	12	0	0
4	77271552	.	C	T	0	4	4	0	3	7	0	0
4	77271920	.	G	A	3	2	5	0	0	5	0	0
4	77271937	.	T	G	4	3	7	0	0	7	0	0
4	77271975	.	C	T	4	3	7	0	1	8	0	0
4	77271984	.	G	A	3	4	7	0	0	7	0	0
4	77272134	.	T	C	5	0	5	0	3	8	0	0
4	77272192	.	G	A	2	3	5	0	2	7	0	0
4	77272250	.	A	T	2	3	5	1	0	6	0	0
4	77272342	.	T	C	1	0	1	0	2	3	0	0
4	77272374	.	A	G	2	3	5	0	0	5	0	0
4	77272429	.	C	A	2	3	5	0	2	7	0	0
4	77272865	.	C	T	0	4	4	1	2	7	0	0
4	77273061	.	G	C	4	3	7	0	0	7	0	0
4	77273068	.	T	G	6	2	8	0	1	9	0	0
4	77273109	.	T	A	5	2	7	0	0	7	0	0
4	77273112	.	C	G	4	2	6	0	0	6	0	0
4	77273728	.	C	T	1	1	2	0	1	3	0	0
4	77273992	.	G	A	5	3	8	0	0	8	0	0
4	77389929	.	G	C	9	5	14	0	0	14	0	0
4	77389932	.	C	A	11	4	15	0	0	15	0	0
4	77928526	.	G	C	4	4	8	0	0	8	0	0
4	77931408	.	G	A	23	14	37	0	1	38	0	0
4	77932143	.	C	T	26	20	46	0	0	46	0	0
4	77932186	.	T	C	22	11	33	0	4	37	0	0
4	77932198	.	A	G	20	13	33	0	5	38	0	0
4	77932221	.	A	G	18	14	32	0	5	37	0	0
4	77932408	.	G	C	15	8	23	1	3	27	0	0
4	77932414	.	T	C	16	9	25	0	0	25	0	0
4	77932461	.	G	A	13	10	23	0	0	23	0	0
4	77932489	.	A	G	10	6	16	0	1	17	0	0
4	77943194	.	T	C	3	4	7	0	0	7	0	0
4	77948591	.	G	A	1	3	4	0	0	4	0	0
4	77953227	.	C	A	5	4	9	0	1	10	0	0
4	77953368	.	G	A	1	5	6	0	3	9	0	0
4	77953718	.	T	C	0	3	3	0	2	5	0	0
4	77953777	.	G	A	2	0	2	0	2	4	0	0
4	77954049	.	T	C	4	6	10	0	4	14	0	0
4	77954200	.	G	A	4	3	7	0	0	7	0	0
4	77954203	.	G	A	3	4	7	0	0	7	0	0
4	77954313	.	C	T	3	3	6	0	1	7	0	0
4	77957718	.	C	A	7	3	10	0	0	10	0	0
4	77959109	.	T	C	9	7	16	0	0	16	0	0
4	77960149	.	C	T	6	10	16	0	0	16	0	0
4	77963210	.	C	G	12	3	15	0	0	15	0	0
4	77963270	.	A	G	8	3	11	0	0	11	0	0
4	77964609	.	G	A	1	5	6	0	11	17	0	0
4	77965345	.	T	C	4	11	15	0	2	17	0	0
4	77965360	.	G	C	3	10	13	0	0	13	0	0
4	77966094	.	T	C	1	3	4	0	0	4	0	0
4	77966234	.	A	G	2	0	2	0	2	4	0	0
4	77966266	.	G	A	0	2	2	0	1	3	0	0
4	77971638	.	C	T	1	2	3	0	0	3	0	0
4	77971683	.	C	T	3	6	9	0	0	9	0	0
4	77981599	.	C	T	9	3	12	0	0	12	0	0
4	77981644	.	G	A	6	5	11	0	6	17	0	0
4	77981663	.	G	A	1	6	7	0	8	15	0	0
4	77993210	.	G	A	7	3	10	0	1	11	0	0
4	77993555	.	G	T	6	8	14	0	0	14	0	0
4	77993574	.	C	A	7	7	14	0	1	15	0	0
4	77993813	.	T	C	0	7	7	0	0	7	0	0
4	77993916	.	G	A	10	6	16	0	2	18	0	0
4	77995494	.	C	G	7	9	16	0	0	16	0	0
4	77995677	.	C	A	8	11	19	0	0	19	0	0
4	77995988	.	A	C	3	7	10	0	0	10	0	0
4	77995990	.	C	G	9	3	12	0	0	12	0	0
4	77996032	.	C	A	6	3	9	0	1	10	0	0
4	77996171	.	C	T	5	5	10	0	1	11	0	0
4	78022662	.	C	A	2	17	19	0	18	37	0	0
4	78024265	.	G	A	32	21	53	0	4	57	0	0
4	78024322	.	C	T	4	28	32	0	22	54	0	0
4	78024558	.	C	T	2	33	35	0	21	56	0	0
4	78025223	.	C	T	2	20	22	0	25	47	0	0
4	78025241	.	A	G	23	23	46	0	1	47	0	0
4	78025434	.	T	A	23	21	44	0	2	46	0	0
5	32121	.	A	T	3	2	5	0	0	5	0	0
5	43375	.	G	T	3	2	5	0	0	5	0	0
5	318077	.	G	A	12	14	26	0	0	26	0	0
5	318125	.	C	T	10	11	21	0	0	21	0	0
5	320383	.	T	C	7	0	7	0	6	13	0	0
5	395497	.	A	C	1	3	4	1	1	6	0	0
5	894613	.	C	T	4	6	10	0	0	10	0	0
5	894882	.	T	A	3	8	11	0	1	12	0	0
5	895581	.	T	C	3	10	13	0	2	15	0	0
5	896908	.	C	A	5	9	14	1	1	16	0	0
5	899952	.	C	T	6	9	15	0	0	15	0	0
5	905263	.	C	A	9	6	15	0	0	15	0	0
5	917336	.	C	T	13	10	23	0	0	23	0	0
5	1055103	.	C	T	14	17	31	0	1	32	0	0
5	1059697	.	T	C	15	16	31	0	2	33	0	0
5	1064013	.	A	G	21	20	41	0	1	42	0	0
5	1068116	.	T	A	16	16	32	0	1	33	0	0
5	1073768	.	T	G	0	2	2	6	1	9	0	0
5	1073789	.	C	T	0	3	3	4	1	8	0	0
5	1073844	.	T	C	0	3	3	0	0	3	0	0
5	1073850	.	T	G	2	2	4	0	0	4	0	0
5	1079480	.	C	T	16	13	29	0	1	30	0	0
5	1079558	.	G	T	6	6	12	0	0	12	0	0
5	1083073	.	A	G	4	0	4	0	5	9	0	0
5	1083203	.	G	C	9	4	13	0	1	14	0	0
5	1083679	.	G	A	0	4	4	5	2	11	0	0
5	1083894	.	T	G	7	0	7	0	13	20	0	0
5	1150143	.	T	C	2	3	5	0	0	5	0	0
5	1152132	.	C	A	2	3	5	0	0	5	0	0
5	1155594	.	G	A	3	2	5	0	0	5	0	0
5	1159612	.	G	A	0	2	2	0	1	3	0	0
5	1187950	.	G	A	2	9	11	0	0	11	0	0
5	1207835	.	C	T	4	5	9	1	2	12	0	0
5	1216494	.	A	G	4	9	13	0	1	14	0	0
5	1216536	.	C	T	0	10	10	0	2	12	0	0
5	1216575	.	G	A	3	7	10	0	1	11	0	0
5	1218781	.	G	A	4	2	6	0	0	6	0	0
5	1219232	.	G	A	7	9	16	0	1	17	0	0
5	1219263	.	C	T	17	14	31	0	0	31	0	0
5	1219381	.	G	A	21	13	34	0	0	34	0	0
5	1223368	.	A	T	16	9	25	1	1	27	0	0
5	1223369	.	C	T	16	10	26	1	0	27	0	0
5	1223460	.	G	A	14	6	20	0	0	20	0	0
5	1223487	.	G	T	16	6	22	0	1	23	0	0
5	1240403	.	C	A	1	5	6	1	1	8	0	0
5	1240589	.	C	T	1	5	6	0	3	9	0	0
5	1244945	.	A	G	1	3	4	0	0	4	0	0
5	1244952	.	C	T	0	3	3	0	1	4	0	0
5	1299350	.	C	G	6	1	7	0	12	19	0	0
5	1311041	.	G	A	27	10	37	0	1	38	0	0
5	1317871	.	T	C	12	14	26	0	0	26	0	0
5	1317883	.	G	A	12	16	28	0	0	28	0	0
5	1346838	.	T	C	18	14	32	0	0	32	0	0
5	1420729	.	A	G	12	6	18	0	0	18	0	0
5	1420843	.	A	G	5	3	8	0	1	9	0	0
5	1438628	.	G	A	7	8	15	0	0	15	0	0
5	1451568	.	G	A	2	3	5	0	0	5	0	0
5	1451666	.	T	C	1	0	1	0	6	7	0	0
5	1467806	.	C	T	1	3	4	0	8	12	0	0
5	1468472	.	T	C	3	0	3	0	5	8	0	0
5	1519571	.	G	C	12	11	23	0	0	23	0	0
5	1519574	.	T	A	11	8	19	0	3	22	0	0
5	2069082	.	C	G	3	5	8	2	1	11	0	0
5	2242599	.	G	A	3	2	5	0	0	5	0	0
5	2242602	.	G	T	1	2	3	0	0	3	0	0
5	2242708	.	A	G	5	3	8	0	0	8	0	0
5	2242795	.	G	A	5	3	8	0	0	8	0	0
5	2251629	.	C	T	1	2	3	0	1	4	0	0
5	2251669	.	A	G	1	4	5	0	0	5	0	0
5	2251670	.	T	A	1	4	5	0	0	5	0	0
5	2251704	.	T	C	1	0	1	0	3	4	0	0
5	2254721	.	G	T	2	3	5	0	0	5	0	0
5	2658348	.	G	A	7	8	15	0	1	16	0	0
5	2686225	.	G	C	1	8	9	0	0	9	0	0
5	2696477	.	A	G	1	5	6	0	0	6	0	0
5	2709533	.	A	G	3	5	8	0	0	8	0	0
5	2713967	.	A	G	27	20	47	0	3	50	0	0
5	2714042	.	C	T	27	18	45	0	3	48	0	0
5	2714135	.	C	T	33	20	53	0	1	54	0	0
5	2714237	.	G	A	31	20	51	0	3	54	0	0
5	2714495	.	G	A	24	23	47	0	0	47	0	0
5	2714507	.	A	G	22	26	48	0	1	49	0	0
5	2714531	.	T	C	24	1	25	0	25	50	0	0
5	2716930	.	G	A	11	16	27	1	3	31	0	0
5	2716963	.	G	A	12	15	27	0	2	29	0	0
5	2717014	.	G	A	12	16	28	0	1	29	0	0
5	2717022	.	G	A	10	14	24	0	2	26	0	0
5	2717260	.	T	C	10	12	22	0	1	23	0	0
5	2717350	.	G	C	13	0	13	0	17	30	0	0
5	2717611	.	C	T	14	12	26	0	1	27	0	0
5	2717623	.	A	G	16	13	29	0	0	29	0	0
5	2717960	.	A	G	7	6	13	0	0	13	0	0
5	2718696	.	A	G	9	7	16	0	1	17	0	0
5	2718834	.	G	A	6	6	12	0	0	12	0	0
5	2720119	.	A	G	5	8	13	0	0	13	0	0
5	2721588	.	C	T	9	8	17	0	3	20	0	0
5	2742784	.	A	G	9	6	15	0	1	16	0	0
5	2744938	.	C	T	5	6	11	0	0	11	0	0
5	2744962	.	C	G	7	5	12	0	1	13	0	0
5	2744998	.	C	T	7	5	12	0	1	13	0	0
5	2745220	.	G	T	8	9	17	0	2	19	0	0
5	2750087	.	G	A	7	8	15	0	1	16	0	0
5	2750127	.	G	A	6	8	14	0	1	15	0	0
5	2750244	.	G	A	7	4	11	0	1	12	0	0
5	2750256	.	G	A	5	8	13	0	0	13	0	0
5	2751319	.	G	A	7	3	10	0	1	11	0	0
5	2751511	.	G	A	8	7	15	0	1	16	0	0
5	3185195	.	A	T	3	3	6	0	0	6	0	0
5	3192019	.	C	T	0	2	2	0	1	3	0	0
5	3194073	.	A	T	2	2	4	0	0	4	0	0
5	3197134	.	C	A	0	3	3	0	2	5	0	0
5	3362996	.	G	A	1	2	3	0	1	4	0	0
5	3363050	.	C	T	1	3	4	0	1	5	0	0
5	3430240	.	C	A	1	2	3	0	0	3	0	0
5	3501954	.	C	A	25	16	41	0	3	44	0	0
5	3544098	.	C	T	29	22	51	0	4	55	0	0
5	3544380	.	C	T	30	31	61	0	2	63	0	0
5	3544955	.	T	C	23	20	43	0	1	44	0	0
5	3545011	.	T	A	28	18	46	0	5	51	0	0
5	3545205	.	A	T	33	0	33	0	0	33	0	0
5	3568371	.	A	G	0	4	4	1	1	6	0	0
5	3568373	.	G	A	4	3	7	1	0	8	0	0
5	3568494	.	C	T	4	14	18	0	0	18	0	0
5	3568518	.	G	T	3	7	10	0	0	10	0	0
5	3568530	.	C	T	10	4	14	0	0	14	0	0
5	3573946	.	A	C	1	2	3	0	0	3	0	0
5	3611952	.	C	T	1	2	3	0	3	6	0	0
5	3612011	.	A	T	2	5	7	0	0	7	0	0
5	3612025	.	C	A	4	6	10	0	0	10	0	0
5	3612075	.	A	T	4	6	10	0	0	10	0	0
5	3612185	.	A	T	8	2	10	0	2	12	0	0
5	3612254	.	A	G	2	11	13	0	0	13	0	0
5	3612415	.	G	T	3	4	7	0	0	7	0	0
5	3618064	.	G	A	7	7	14	0	2	16	0	0
5	3670231	.	G	A	1	2	3	0	1	4	0	0
5	3891528	.	C	T	4	3	7	0	2	9	0	0
5	3891532	.	G	C	5	4	9	0	1	10	0	0
5	3901564	.	A	C	4	2	6	0	1	7	0	0
5	3914638	.	T	G	11	13	24	0	1	25	0	0
5	3925732	.	A	C	19	1	20	0	18	38	0	0
5	3925769	.	T	C	16	21	37	0	4	41	0	0
5	3927524	.	G	A	18	13	31	0	1	32	0	0
5	3930283	.	G	C	1	2	3	0	0	3	0	0
5	4010639	.	G	C	1	2	3	0	0	3	0	0
5	4024746	.	A	G	5	0	5	0	6	11	0	0
5	4052191	.	G	A	5	6	11	0	0	11	0	0
5	4052225	.	A	G	2	2	4	0	1	5	0	0
5	4137043	.	A	G	4	4	8	0	0	8	0	0
5	4142487	.	G	A	3	2	5	0	0	5	0	0
5	4254061	.	C	T	0	8	8	0	10	18	0	0
5	4265417	.	T	C	5	15	20	0	1	21	0	0
5	4270791	.	C	A	2	7	9	0	8	17	0	0
5	4271102	.	C	T	1	5	6	0	10	17	1	0
5	4273144	.	T	C	9	9	18	0	4	22	0	0
5	4273159	.	T	C	6	13	19	0	3	22	0	0
5	4275481	.	C	T	2	18	20	0	13	33	0	0
5	4281626	.	A	G	7	9	16	0	0	16	0	0
5	4281634	.	A	G	7	9	16	0	1	17	0	0
5	4292545	.	A	T	4	1	5	0	2	7	0	0
5	4293975	.	T	C	6	10	16	0	0	16	0	0
5	4293978	.	C	A	6	11	17	0	0	17	0	0
5	4296556	.	C	G	14	5	19	0	1	20	0	0
5	4298902	.	G	C	11	9	20	0	2	22	0	0
5	4299588	.	A	G	13	1	14	0	9	23	0	0
5	4373684	.	C	T	7	10	17	0	1	18	0	0
5	4373701	.	G	T	1	8	9	0	3	12	0	0
5	4373796	.	A	T	2	2	4	0	0	4	0	0
5	4373819	.	A	G	1	2	3	0	1	4	0	0
5	4374299	.	A	G	1	3	4	0	1	5	0	0
5	4382543	.	A	G	10	6	16	0	0	16	0	0
5	4384706	.	G	A	7	6	13	0	2	15	0	0
5	4397741	.	A	G	9	6	15	0	0	15	0	0
5	4397901	.	T	C	5	5	10	0	1	11	0	0
5	4414178	.	C	T	11	6	17	0	2	19	0	0
5	4444925	.	A	G	2	3	5	0	0	5	0	0
5	4445039	.	T	C	3	6	9	0	0	9	0	0
5	4448249	.	G	A	1	3	4	0	5	9	0	0
5	4733927	.	C	T	1	7	8	0	5	13	0	0
5	5171358	.	T	A	1	2	3	0	1	4	0	0
5	5171750	.	G	A	5	2	7	0	1	8	0	0
5	5171770	.	G	A	5	2	7	0	0	7	0	0
5	5171846	.	A	T	1	2	3	0	0	3	0	0
5	5195882	.	A	G	2	3	5	0	0	5	0	0
5	5217028	.	G	A	3	5	8	0	0	8	0	0
5	5308502	.	A	G	3	4	7	0	0	7	0	0
5	5325934	.	C	T	1	2	3	0	0	3	0	0
5	5399025	.	T	A	1	3	4	0	0	4	0	0
5	5406727	.	G	A	0	2	2	0	2	4	0	0
5	5434071	.	G	C	0	5	5	0	3	8	0	0
5	5622203	.	G	A	1	3	4	0	0	4	0	0
5	5629053	.	A	G	1	2	3	0	0	3	0	0
5	5708595	.	C	G	6	4	10	0	0	10	0	0
5	5720021	.	G	A	5	6	11	0	0	11	0	0
5	5731919	.	C	T	1	2	3	0	0	3	0	0
5	5733101	.	T	C	1	2	3	0	1	4	0	0
5	5733130	.	C	T	3	3	6	0	0	6	0	0
5	5733227	.	C	G	2	7	9	0	0	9	0	0
5	5780207	.	G	A	2	3	5	0	0	5	0	0
5	5797883	.	T	A	1	2	3	0	0	3	0	0
5	6672965	.	G	T	2	3	5	0	0	5	0	0
5	6717804	.	T	C	1	3	4	0	0	4	0	0
5	6717809	.	G	A	0	4	4	0	0	4	0	0
5	6726864	.	A	C	4	2	6	0	1	7	0	0
5	6735293	.	A	G	1	4	5	0	0	5	0	0
5	6796383	.	G	A	0	4	4	0	3	7	0	0
5	6827651	.	G	A	2	4	6	1	1	8	0	0
5	6827669	.	G	C	5	3	8	1	0	9	0	0
5	6828589	.	A	T	6	7	13	0	0	13	0	0
5	6828721	.	G	A	3	5	8	0	0	8	0	0
5	6832646	.	C	T	3	5	8	0	2	10	0	0
5	6839136	.	A	C	6	5	11	0	0	11	0	0
5	6858380	.	C	A	2	12	14	0	0	14	0	0
5	6858389	.	T	A	2	12	14	0	0	14	0	0
5	6858779	.	G	T	0	5	5	0	11	16	0	0
5	6863577	.	C	T	18	9	27	0	1	28	0	0
5	6863647	.	C	T	14	9	23	0	1	24	0	0
5	6863768	.	G	C	11	6	17	0	0	17	0	0
5	6863793	.	G	A	5	15	20	0	2	22	0	0
5	6863834	.	A	G	2	0	2	0	15	17	0	0
5	6863855	.	G	A	5	7	12	0	0	12	0	0
5	6881679	.	C	T	2	4	6	0	0	6	0	0
5	6881773	.	C	T	6	4	10	0	0	10	0	0
5	6921397	.	T	C	2	4	6	0	0	6	0	0
5	6921448	.	A	G	1	3	4	0	1	5	0	0
5	6956547	.	C	G	3	2	5	0	0	5	0	0
5	6958910	.	T	C	5	2	7	0	1	8	0	0
5	6958965	.	G	C	2	3	5	0	0	5	0	0
5	6959148	.	C	A	5	3	8	0	0	8	0	0
5	6959834	.	T	A	7	4	11	0	0	11	0	0
5	6959839	.	C	T	8	6	14	0	0	14	0	0
5	7477276	.	C	G	2	2	4	0	0	4	0	0
5	7504448	.	C	T	2	3	5	0	0	5	0	0
5	8006206	.	A	G	2	2	4	0	2	6	0	0
5	8006474	.	A	G	8	4	12	0	3	15	0	0
5	8006503	.	A	G	15	7	22	0	1	23	0	0
5	8006977	.	A	G	12	11	23	0	0	23	0	0
5	8015099	.	C	T	0	5	5	0	6	11	0	0
5	8015192	.	C	T	0	3	3	0	7	10	0	0
5	8015252	.	C	T	6	3	9	0	0	9	0	0
5	8015361	.	G	T	15	12	27	1	2	30	0	0
5	8019962	.	A	G	6	6	12	0	1	13	0	0
5	8020001	.	C	T	8	8	16	0	1	17	0	0
5	8033036	.	A	G	6	6	12	0	0	12	0	0
5	8038472	.	C	T	2	3	5	0	1	6	0	0
5	8043891	.	C	T	7	9	16	0	0	16	0	0
5	8237162	.	A	G	1	5	6	0	1	7	0	0
5	8537820	.	T	C	3	2	5	0	1	6	0	0
5	8537821	.	T	C	4	1	5	0	1	6	0	0
5	8752713	.	A	G	1	5	6	0	0	6	0	0
5	9443251	.	T	C	4	8	12	0	0	12	0	0
5	9824444	.	G	C	10	3	13	0	0	13	0	0
5	9824694	.	G	A	2	2	4	0	0	4	0	0
5	10046718	.	G	A	0	4	4	0	1	5	0	0
5	10046839	.	G	A	0	5	5	0	2	7	0	0
5	10084232	.	T	G	5	2	7	0	0	7	0	0
5	10084310	.	C	T	5	2	7	0	0	7	0	0
5	10766286	.	G	A	11	5	16	0	0	16	0	0
5	10766505	.	A	G	7	16	23	6	3	32	0	0
5	10766529	.	G	A	14	10	24	7	0	31	0	0
5	10766879	.	A	G	14	14	28	0	2	30	0	0
5	10767113	.	C	T	12	13	25	0	2	27	0	0
5	10767259	.	A	G	14	20	34	0	2	36	0	0
5	10767456	.	G	A	8	7	15	1	0	16	0	0
5	10767588	.	C	T	5	7	12	0	0	12	0	0
5	10768089	.	G	A	7	5	12	0	0	12	0	0
5	10768182	.	G	A	6	8	14	0	0	14	0	0
5	10768215	.	T	C	8	0	8	0	5	13	0	0
5	10946038	.	G	A	8	6	14	0	0	14	0	0
5	10946085	.	G	T	7	5	12	0	1	13	0	0
5	11244625	.	T	C	3	3	6	0	0	6	0	0
5	11244675	.	A	G	7	3	10	0	0	10	0	0
5	11507602	.	A	G	7	6	13	0	0	13	0	0
5	11573461	.	C	T	10	4	14	0	0	14	0	0
5	11812278	.	C	T	6	7	13	0	0	13	0	0
5	11816599	.	G	A	7	6	13	0	0	13	0	0
5	11818876	.	A	C	2	5	7	0	0	7	0	0
5	11824059	.	G	A	0	4	4	0	6	10	0	0
5	11824188	.	T	C	4	4	8	0	0	8	0	0
5	11826347	.	T	C	6	8	14	0	0	14	0	0
5	11836437	.	T	C	14	5	19	0	2	21	0	0
5	11864774	.	T	G	10	7	17	0	1	18	0	0
5	11869576	.	C	A	1	6	7	0	8	15	0	0
5	11900230	.	T	C	10	0	10	0	5	15	0	0
5	11905038	.	G	A	3	5	8	0	0	8	0	0
5	11905044	.	A	C	4	5	9	0	0	9	0	0
5	11905661	.	T	C	1	0	1	0	2	3	0	0
5	11905890	.	A	G	7	6	13	0	0	13	0	0
5	11905903	.	T	G	5	6	11	0	0	11	0	0
5	11917125	.	C	T	9	9	18	0	1	19	0	0
5	11917405	.	G	A	12	7	19	0	0	19	0	0
5	11917436	.	G	A	2	11	13	0	0	13	0	0
5	11917485	.	G	A	8	6	14	0	0	14	0	0
5	11917596	.	C	A	1	13	14	0	13	27	0	0
5	11933155	.	A	G	9	14	23	0	1	24	0	0
5	11935444	.	G	A	7	11	18	0	1	19	0	0
5	11937486	.	G	A	11	4	15	0	0	15	0	0
5	11937564	.	A	T	6	5	11	0	0	11	0	0
5	11941903	.	T	C	5	0	5	0	5	10	0	0
5	11943662	.	A	C	3	4	7	0	1	8	0	0
5	11943868	.	G	A	11	6	17	0	0	17	0	0
5	11943948	.	T	A	2	12	14	0	0	14	0	0
5	11943989	.	G	A	7	6	13	0	1	14	0	0
5	11944060	.	T	G	3	3	6	0	0	6	0	0
5	11949244	.	G	T	9	8	17	0	0	17	0	0
5	11959776	.	G	T	0	11	11	0	16	27	0	0
5	11959777	.	C	T	12	16	28	0	1	29	0	0
5	11959818	.	C	T	14	13	27	0	1	28	0	0
5	11959966	.	C	G	12	15	27	0	0	27	0	0
5	11959988	.	G	A	2	10	12	0	14	26	0	0
5	11982950	.	C	A	6	2	8	0	0	8	0	0
5	11983017	.	T	C	1	4	5	0	0	5	0	0
5	11983395	.	T	A	5	2	7	1	0	8	0	0
5	11983548	.	C	G	1	8	9	0	1	10	0	0
5	11984086	.	T	C	3	2	5	0	0	5	0	0
5	11984133	.	C	T	3	3	6	0	1	7	0	0
5	11984141	.	T	A	2	4	6	0	0	6	0	0
5	11985626	.	A	T	2	3	5	0	0	5	0	0
5	11985842	.	T	A	1	2	3	0	0	3	0	0
5	11985843	.	G	T	1	2	3	0	0	3	0	0
5	12000924	.	A	G	1	3	4	0	0	4	0	0
5	12100335	.	G	A	2	5	7	0	0	7	0	0
5	12115313	.	A	G	3	3	6	0	0	6	0	0
5	12144035	.	T	C	2	3	5	0	0	5	0	0
5	12283962	.	G	A	6	16	22	1	0	23	0	0
5	12283969	.	A	G	4	13	17	1	2	20	0	0
5	12284075	.	C	T	16	16	32	0	3	35	0	0
5	12285172	.	T	C	16	0	16	0	7	23	0	0
5	12285316	.	C	T	1	3	4	0	0	4	0	0
5	12285601	.	C	G	2	3	5	0	0	5	0	0
5	12288511	.	T	C	2	9	11	0	2	13	0	0
5	12288541	.	A	G	6	12	18	0	1	19	0	0
5	12297084	.	C	T	9	6	15	0	2	17	0	0
5	12322321	.	G	A	7	8	15	0	0	15	0	0
5	12357538	.	G	A	9	9	18	0	1	19	0	0
5	12357554	.	C	T	9	10	19	0	0	19	0	0
5	12454563	.	T	C	6	0	6	0	11	17	0	0
5	12524938	.	A	G	4	4	8	1	0	9	0	0
5	12530423	.	G	T	5	6	11	0	2	13	0	0
5	12530425	.	C	A	6	7	13	0	1	14	0	0
5	12533197	.	C	T	4	4	8	0	1	9	0	0
5	12535785	.	A	T	2	2	4	0	0	4	0	0
5	12549258	.	C	T	11	7	18	0	1	19	0	0
5	12549326	.	C	T	2	6	8	0	1	9	0	0
5	12549807	.	A	G	5	2	7	0	0	7	0	0
5	12549981	.	G	T	7	6	13	0	1	14	0	0
5	12553935	.	C	T	0	4	4	0	1	5	0	0
5	12554073	.	G	A	2	2	4	0	0	4	0	0
5	12554119	.	A	G	3	3	6	0	0	6	0	0
5	12558090	.	C	T	2	2	4	0	0	4	0	0
5	12724224	.	G	A	11	20	31	0	0	31	0	0
5	12724249	.	A	C	11	7	18	0	0	18	0	0
5	12724412	.	A	G	4	2	6	0	0	6	0	0
5	12724450	.	C	T	1	3	4	0	5	9	0	0
5	12724505	.	C	A	11	11	22	0	2	24	0	0
5	12724518	.	G	C	16	1	17	0	7	24	0	0
5	12724567	.	A	G	18	10	28	0	1	29	0	0
5	12724694	.	C	T	3	11	14	0	12	26	0	0
5	12725930	.	G	A	21	25	46	0	0	46	0	0
5	12726842	.	A	G	18	16	34	0	1	35	0	0
5	12729397	.	C	T	11	10	21	0	0	21	0	0
5	12732247	.	C	T	10	4	14	0	0	14	0	0
5	12734883	.	G	T	9	11	20	0	1	21	0	0
5	12734910	.	T	C	10	9	19	0	0	19	0	0
5	12809409	.	G	C	0	0	0	0	3	3	0	0
5	12809410	.	T	G	1	2	3	0	0	3	0	0
5	12837064	.	G	A	3	4	7	0	0	7	0	0
5	12859258	.	T	C	19	8	27	0	2	29	0	0
5	12905796	.	G	A	3	4	7	0	0	7	0	0
5	12905806	.	C	A	3	4	7	0	0	7	0	0
5	12905968	.	T	G	4	2	6	0	0	6	0	0
5	12906014	.	C	T	5	4	9	0	1	10	0	0
5	12906273	.	C	T	2	5	7	1	1	9	0	0
5	12906343	.	A	G	2	0	2	0	5	7	0	0
5	12908828	.	C	A	3	5	8	0	0	8	0	0
5	12926507	.	C	A	4	4	8	0	0	8	0	0
5	12935223	.	A	G	5	2	7	0	0	7	0	0
5	12956918	.	T	C	8	3	11	0	0	11	0	0
5	12956960	.	C	T	6	8	14	0	1	16	1	0
5	12975297	.	G	A	2	7	9	0	14	23	0	0
5	12975532	.	C	T	7	7	14	0	0	14	0	0
5	12979889	.	C	T	5	2	7	0	0	7	0	0
5	13037199	.	C	T	1	4	5	0	5	10	0	0
5	13037203	.	C	T	2	5	7	0	6	13	0	0
5	13037723	.	A	G	4	5	9	0	2	11	0	0
5	13037939	.	T	G	8	5	13	0	1	14	0	0
5	13037967	.	G	A	7	5	12	0	0	12	0	0
5	13037998	.	A	G	5	5	10	0	1	11	0	0
5	13105020	.	C	T	22	15	37	1	10	48	0	0
5	13105070	.	C	A	5	20	25	0	24	49	0	0
5	13112979	.	G	A	17	15	32	0	0	32	0	0
5	13167048	.	A	T	9	10	19	0	3	22	0	0
5	13214637	.	C	G	4	3	7	0	0	7	0	0
5	13214802	.	C	G	2	5	7	0	2	9	0	0
5	13223062	.	G	A	5	4	9	0	0	9	0	0
5	13227057	.	C	T	1	4	5	0	2	7	0	0
5	13229024	.	C	A	2	4	6	0	0	6	0	0
5	13229846	.	G	T	3	4	7	0	0	7	0	0
5	13235157	.	G	C	3	4	7	0	0	7	0	0
5	13237809	.	G	A	2	2	4	0	0	4	0	0
5	13308959	.	G	A	3	2	5	0	0	5	0	0
5	13308985	.	T	C	2	4	6	0	0	6	0	0
5	13308997	.	G	T	7	3	10	0	0	10	0	0
5	13309174	.	T	C	11	0	11	0	14	25	0	0
5	13309215	.	C	T	8	10	18	0	2	20	0	0
5	13309273	.	C	T	15	11	26	0	1	27	0	0
5	13309309	.	G	A	11	15	26	0	2	28	0	0
5	13309402	.	A	G	12	12	24	0	1	25	0	0
5	13309435	.	A	T	11	20	31	0	0	31	0	0
5	13309522	.	G	A	11	12	23	0	1	24	0	0
5	13312671	.	A	T	14	15	29	0	1	30	0	0
5	13312746	.	G	A	16	13	29	0	0	29	0	0
5	13315490	.	G	C	13	14	27	0	0	28	1	0
5	13315526	.	T	C	7	14	21	0	2	23	0	0
5	13315603	.	A	C	8	16	24	0	1	25	0	0
5	13326911	.	G	A	0	5	5	0	2	7	0	0
5	13326920	.	G	A	4	2	6	0	0	6	0	0
5	13332930	.	A	G	4	4	8	0	1	9	0	0
5	13335291	.	C	T	1	3	4	0	0	4	0	0
5	13335333	.	G	A	7	4	11	0	0	11	0	0
5	13335373	.	G	T	1	7	8	0	5	13	0	0
5	13335423	.	C	T	3	4	7	0	0	7	0	0
5	13337803	.	C	T	10	14	24	0	0	24	0	0
5	13337883	.	T	A	16	17	33	1	2	36	0	0
5	13338441	.	C	T	2	16	18	0	17	35	0	0
5	13338762	.	A	T	14	11	25	0	1	26	0	0
5	13339038	.	G	C	18	17	35	1	14	50	0	0
5	13419418	.	T	C	4	2	6	0	1	7	0	0
5	13445433	.	C	T	2	2	4	0	0	4	0	0
5	13465095	.	T	C	3	3	6	0	0	6	0	0
5	13468108	.	G	T	1	5	6	0	1	7	0	0
5	13468172	.	C	T	2	7	9	0	0	9	0	0
5	13468440	.	T	A	3	2	5	0	0	5	0	0
5	13468655	.	G	A	2	2	4	0	0	4	0	0
5	13468656	.	A	T	2	2	4	0	0	4	0	0
5	13469105	.	T	A	2	3	5	0	0	5	0	0
5	13472279	.	C	T	2	9	11	0	0	11	0	0
5	13472295	.	G	T	10	3	13	0	0	13	0	0
5	13472743	.	A	T	4	2	6	0	0	6	0	0
5	13473334	.	G	A	0	3	3	0	1	4	0	0
5	13501336	.	C	T	1	3	4	0	0	4	0	0
5	13501345	.	C	T	1	4	5	0	0	5	0	0
5	13539403	.	A	G	2	0	2	0	8	10	0	0
5	13539493	.	A	G	3	0	3	0	8	11	0	0
5	13540689	.	C	T	6	8	14	0	2	16	0	0
5	13540738	.	C	T	3	4	7	0	0	7	0	0
5	13540846	.	T	A	6	4	10	1	0	11	0	0
5	13553690	.	G	A	0	2	2	0	1	3	0	0
5	13553712	.	T	A	1	2	3	0	0	3	0	0
5	13643325	.	G	A	11	13	24	0	3	27	0	0
5	13643411	.	C	T	3	22	25	0	22	47	0	0
5	13644126	.	A	T	28	14	42	0	1	43	0	0
5	13644185	.	T	G	16	13	29	0	1	30	0	0
5	13644189	.	T	G	17	11	28	0	3	31	0	0
5	13644227	.	A	G	19	8	27	1	1	29	0	0
5	13644256	.	A	T	21	7	28	5	1	34	0	0
5	13644581	.	T	G	14	20	34	0	3	37	0	0
5	13644602	.	T	A	18	21	39	0	3	43	1	0
5	13644781	.	C	T	11	6	17	0	0	17	0	0
5	13644797	.	A	G	5	9	14	0	0	14	0	0
5	13645047	.	C	G	18	11	29	0	2	31	0	0
5	13645746	.	A	G	12	21	33	0	0	33	0	0
5	13645885	.	T	C	14	10	24	0	1	25	0	0
5	13649518	.	C	T	14	19	33	0	1	34	0	0
5	13671624	.	G	T	9	9	18	0	3	21	0	0
5	13671631	.	A	C	11	8	19	0	0	19	0	0
5	13671899	.	C	G	19	20	39	0	0	39	0	0
5	13672004	.	C	T	0	22	22	0	20	42	0	0
5	13672211	.	C	T	19	20	39	0	2	41	0	0
5	13672232	.	C	T	18	22	40	0	1	41	0	0
5	13673016	.	C	G	3	18	21	0	21	42	0	0
5	13684132	.	A	G	20	11	31	0	4	35	0	0
5	13684502	.	C	A	7	27	34	0	20	54	0	0
5	13766188	.	A	T	8	6	14	0	0	14	0	0
5	13766276	.	A	G	3	8	11	0	2	13	0	0
5	13772666	.	T	C	31	20	51	1	2	54	0	0
5	13778659	.	G	T	26	20	46	0	2	48	0	0
5	13778663	.	C	T	25	20	45	0	2	47	0	0
5	13782325	.	T	C	25	20	45	1	1	47	0	0
5	13782786	.	C	A	9	9	18	1	1	20	0	0
5	13783350	.	C	A	1	5	6	0	0	6	0	0
5	13783377	.	A	G	1	4	5	0	1	6	0	0
5	13783391	.	G	A	2	3	5	0	0	5	0	0
5	13783516	.	A	C	5	15	20	0	1	21	0	0
5	13783962	.	T	C	3	5	8	0	3	11	0	0
5	13784111	.	G	T	3	2	5	0	1	6	0	0
5	13784243	.	T	A	10	15	25	0	0	25	0	0
5	13784486	.	G	T	9	6	15	0	0	15	0	0
5	13784559	.	T	A	8	8	16	4	2	22	0	0
5	13784574	.	T	G	0	10	10	1	0	11	0	0
5	13784914	.	G	T	2	5	7	0	0	7	0	0
5	13784916	.	C	T	3	5	8	0	0	8	0	0
5	13785289	.	T	C	10	0	10	3	2	15	0	0
5	13785304	.	A	G	9	4	13	3	1	17	0	0
5	13785326	.	A	G	10	5	15	3	0	18	0	0
5	13785441	.	A	G	10	7	17	0	1	18	0	0
5	13785485	.	T	C	8	0	8	0	4	12	0	0
5	13785490	.	G	A	7	5	12	0	1	13	0	0
5	13785522	.	T	C	3	6	9	0	3	12	0	0
5	13785559	.	G	A	2	4	6	1	0	7	0	0
5	13785563	.	T	C	2	3	5	0	1	6	0	0
5	13785735	.	C	T	11	10	21	0	1	22	0	0
5	13791984	.	G	A	16	12	28	0	0	28	0	0
5	13793333	.	T	C	12	11	23	0	4	27	0	0
5	13799613	.	G	A	10	7	17	0	1	18	0	0
5	13799635	.	C	T	9	7	16	0	2	18	0	0
5	13799704	.	G	A	10	12	22	0	0	22	0	0
5	13800062	.	C	T	4	6	10	0	0	10	0	0
5	13800170	.	C	A	5	5	10	0	0	10	0	0
5	13803918	.	C	A	1	4	5	0	5	10	0	0
5	13803960	.	C	T	3	10	13	0	0	13	0	0
5	13820304	.	C	T	9	6	15	0	0	15	0	0
5	13820457	.	G	A	5	4	9	0	0	9	0	0
5	13835410	.	T	A	1	2	3	0	0	3	0	0
5	13835462	.	T	G	2	2	4	0	0	4	0	0
5	13992582	.	T	C	1	2	3	0	0	3	0	0
5	14306793	.	G	T	19	17	36	0	3	39	0	0
5	14307459	.	G	A	15	14	29	0	0	29	0	0
5	14307720	.	C	T	10	18	28	0	0	28	0	0
5	14308394	.	A	C	20	0	20	0	0	20	0	0
5	14308710	.	A	G	11	12	23	0	0	23	0	0
5	14308773	.	G	A	17	4	21	0	2	23	0	0
5	14308792	.	C	A	19	7	26	0	0	26	0	0
5	14309073	.	T	C	9	6	15	0	0	15	0	0
5	14309219	.	A	G	3	7	10	0	1	11	0	0
5	14309334	.	C	T	1	9	10	0	10	20	0	0
5	14309661	.	C	T	6	6	12	0	0	12	0	0
5	14310874	.	T	A	13	14	27	0	1	28	0	0
5	14312030	.	C	T	1	9	10	0	7	17	0	0
5	14312091	.	G	A	9	7	16	0	2	18	0	0
5	14321243	.	G	A	1	6	7	0	0	7	0	0
5	14321336	.	G	A	3	9	12	0	1	13	0	0
5	14321393	.	C	T	3	5	8	0	0	8	0	0
5	14321438	.	A	G	3	8	11	0	0	11	0	0
5	14322022	.	C	T	11	4	15	0	0	15	0	0
5	14322037	.	C	T	7	4	11	0	1	12	0	0
5	14322212	.	C	T	8	6	14	0	1	15	0	0
5	14322269	.	T	C	2	6	8	0	4	12	0	0
5	14322433	.	A	T	7	2	9	0	3	12	0	0
5	14322647	.	C	T	4	2	6	0	1	7	0	0
5	14322898	.	T	G	7	7	14	0	1	15	0	0
5	14323082	.	A	T	6	2	8	0	0	8	0	0
5	14375330	.	T	A	2	6	8	0	0	8	0	0
5	14375529	.	A	G	10	16	26	0	1	27	0	0
5	14375598	.	A	G	12	20	32	0	0	32	0	0
5	14375623	.	A	G	13	13	26	0	2	28	0	0
5	14375881	.	T	C	6	7	13	1	4	18	0	0
5	14376155	.	A	G	18	15	33	1	2	36	0	0
5	14380632	.	C	T	18	12	30	0	1	31	0	0
5	14382534	.	C	G	13	12	25	0	0	25	0	0
5	14383193	.	G	A	10	11	21	0	1	22	0	0
5	14386045	.	T	A	12	11	23	0	1	24	0	0
5	14386277	.	A	G	9	10	19	0	0	19	0	0
5	14387338	.	G	A	10	10	20	0	1	21	0	0
5	14394466	.	A	G	22	13	35	0	4	39	0	0
5	14394515	.	G	A	24	15	39	0	2	41	0	0
5	14394872	.	T	A	12	12	24	0	2	26	0	0
5	14395430	.	G	A	12	15	27	0	0	27	0	0
5	14395664	.	G	A	23	18	41	0	1	42	0	0
5	14395697	.	G	A	18	19	37	0	1	38	0	0
5	14396030	.	C	T	8	7	15	0	1	16	0	0
5	14396438	.	C	G	1	15	16	0	16	33	1	0
5	14396609	.	T	C	3	8	11	0	1	12	0	0
5	14396783	.	C	T	9	7	16	0	1	17	0	0
5	14396876	.	C	T	11	10	21	0	0	21	0	0
5	14396893	.	G	T	8	9	17	0	1	18	0	0
5	14397231	.	T	A	11	3	14	0	1	15	0	0
5	14397232	.	G	T	11	2	13	0	1	14	0	0
5	14398364	.	C	T	5	2	7	0	0	7	0	0
5	14398876	.	A	T	4	2	6	0	0	6	0	0
5	14399766	.	G	C	4	3	7	0	0	7	0	0
5	14402144	.	C	T	0	3	3	0	3	6	0	0
5	14402848	.	C	T	2	4	6	0	0	6	0	0
5	14413810	.	A	G	2	2	4	0	0	4	0	0
5	14442388	.	C	T	1	4	5	0	2	7	0	0
5	14529221	.	C	T	1	18	19	0	14	33	0	0
5	14529450	.	C	T	21	7	28	0	1	29	0	0
5	14530091	.	T	G	14	10	24	0	1	25	0	0
5	14530346	.	C	T	7	4	11	0	0	11	0	0
5	14530457	.	G	A	5	6	11	0	1	12	0	0
5	14530511	.	T	C	6	13	19	0	3	22	0	0
5	14530571	.	A	G	11	4	15	0	0	15	0	0
5	14530595	.	C	T	7	9	16	0	0	16	0	0
5	14533937	.	C	T	1	13	14	0	4	18	0	0
5	14534025	.	G	A	7	6	13	0	0	13	0	0
5	14543331	.	G	A	6	12	18	0	1	19	0	0
5	14545814	.	C	T	1	3	4	0	9	13	0	0
5	14560993	.	G	A	7	3	10	0	0	10	0	0
5	14564831	.	G	A	7	2	9	0	0	9	0	0
5	14584305	.	G	A	6	3	9	0	1	10	0	0
5	14648272	.	G	A	3	3	6	0	0	6	0	0
5	15222150	.	A	G	1	2	3	0	0	3	0	0
5	15357517	.	A	G	4	3	7	0	1	8	0	0
5	15394285	.	G	T	14	5	19	0	1	20	0	0
5	15394354	.	G	A	8	7	15	0	0	15	0	0
5	15394357	.	A	G	7	7	14	0	0	14	0	0
5	15394396	.	C	T	0	6	6	0	6	12	0	0
5	15416836	.	T	A	6	6	12	0	0	12	0	0
5	15810321	.	A	G	4	2	6	0	0	6	0	0
5	17885521	.	A	G	1	6	7	0	0	7	0	0
5	18827368	.	T	C	7	7	14	0	0	14	0	0
5	19008334	.	A	G	23	1	24	3	18	46	1	0
5	20416565	.	G	C	0	6	6	0	1	7	0	0
5	20787190	.	T	C	5	4	9	0	0	9	0	0
5	20787730	.	A	G	5	2	7	0	0	7	0	0
5	20925834	.	A	G	1	6	7	0	0	7	0	0
5	20933321	.	C	A	6	49	55	0	4	59	0	0
5	20933332	.	T	C	9	2	11	4	51	66	0	0
5	22106347	.	A	G	7	3	10	0	0	10	0	0
5	22873074	.	G	A	0	7	7	2	1	10	0	0
5	23397221	.	T	C	11	14	25	0	0	25	0	0
5	23574322	.	A	G	3	2	5	0	0	5	0	0
5	23574916	.	T	C	2	3	5	0	1	6	0	0
5	23575630	.	T	C	6	2	8	0	1	9	0	0
5	23575646	.	T	C	2	6	8	0	0	8	0	0
5	24135195	.	C	T	12	4	16	0	0	16	0	0
5	24163098	.	A	G	4	3	7	0	0	7	0	0
5	24245036	.	G	A	1	2	3	0	0	3	0	0
5	24818488	.	T	C	9	6	15	0	0	15	0	0
5	24818649	.	T	C	4	6	10	0	0	10	0	0
5	25088966	.	T	G	5	9	14	0	1	15	0	0
5	25693715	.	C	T	10	10	20	0	1	21	0	0
5	26062582	.	A	G	2	9	11	0	0	11	0	0
5	26102654	.	T	A	1	3	4	0	0	4	0	0
5	26109230	.	A	G	1	2	3	0	0	3	0	0
5	26109231	.	G	C	1	2	3	0	0	3	0	0
5	26722622	.	T	A	1	3	4	0	0	4	0	0
5	26802968	.	G	A	1	4	5	0	0	5	0	0
5	29001080	.	A	G	3	3	6	0	3	9	0	0
5	29001101	.	C	T	2	7	9	0	1	10	0	0
5	29001230	.	A	G	13	0	13	0	5	18	0	0
5	29181832	.	A	G	2	2	4	0	0	4	0	0
5	29598984	.	T	C	37	0	37	0	16	53	0	0
5	30606225	.	A	G	3	3	6	0	0	6	0	0
5	32494697	.	A	C	1	6	7	0	0	7	0	0
5	33329786	.	A	G	5	12	17	0	1	18	0	0
5	33554892	.	T	C	4	4	8	0	0	8	0	0
5	35124435	.	T	C	14	0	14	0	13	27	0	0
5	35124479	.	C	T	1	5	6	0	14	20	0	0
5	35124859	.	C	T	5	3	8	0	1	9	0	0
5	35124939	.	G	A	4	4	8	0	0	8	0	0
5	35125414	.	C	T	0	2	2	0	3	5	0	0
5	35125423	.	C	T	4	2	6	0	0	6	0	0
5	35125882	.	G	A	4	10	14	0	0	14	0	0
5	35125883	.	A	T	4	10	14	0	0	14	0	0
5	35129861	.	C	A	5	3	8	0	0	8	0	0
5	35135687	.	G	A	5	7	12	0	1	13	0	0
5	35137384	.	A	G	3	2	5	0	0	5	0	0
5	35137621	.	C	T	0	6	6	0	4	10	0	0
5	35178715	.	A	G	2	3	5	0	1	6	0	0
5	35200648	.	T	G	2	3	5	0	0	5	0	0
5	35202876	.	A	T	11	6	17	0	1	18	0	0
5	35202958	.	G	A	8	10	18	0	1	20	1	0
5	35202959	.	A	T	11	8	19	0	1	21	1	0
5	35203092	.	G	A	13	10	23	0	0	23	0	0
5	35203486	.	C	A	10	6	16	0	1	17	0	0
5	35203629	.	C	T	0	19	19	0	9	28	0	0
5	35204077	.	T	G	8	7	15	0	1	16	0	0
5	35204159	.	C	T	4	12	16	0	0	16	0	0
5	35204280	.	A	T	7	12	19	0	0	19	0	0
5	35204322	.	A	G	6	11	17	0	0	17	0	0
5	35204353	.	C	T	7	8	15	0	2	17	0	0
5	35204390	.	G	A	9	5	14	0	1	15	0	0
5	35204681	.	A	C	3	7	10	0	0	10	0	0
5	35204689	.	A	C	3	0	3	0	7	10	0	0
5	35204754	.	C	T	4	10	14	0	1	15	0	0
5	35205005	.	G	A	12	11	23	0	0	23	0	0
5	35207914	.	T	G	5	6	11	0	0	11	0	0
5	35220402	.	T	A	1	5	6	0	0	6	0	0
5	35261331	.	A	G	2	2	4	0	0	4	0	0
5	35271001	.	C	T	27	14	41	0	1	42	0	0
5	35271154	.	A	T	27	21	48	0	0	48	0	0
5	35271181	.	A	G	32	20	52	0	5	57	0	0
5	35271194	.	G	A	38	21	59	0	1	60	0	0
5	35271309	.	T	A	33	22	55	0	2	57	0	0
5	35271465	.	T	C	30	23	53	0	6	59	0	0
5	35271824	.	C	A	20	18	38	0	2	40	0	0
5	35272032	.	G	A	17	10	27	0	0	27	0	0
5	35272438	.	C	T	0	6	6	0	30	36	0	0
5	35272497	.	G	A	13	6	19	0	0	19	0	0
5	35272560	.	T	G	13	8	21	0	2	23	0	0
5	35273062	.	G	A	23	30	53	0	1	54	0	0
5	35273225	.	T	C	17	17	34	0	2	36	0	0
5	35273447	.	A	G	30	11	41	1	0	42	0	0
5	35273509	.	A	T	21	10	31	0	2	33	0	0
5	35273546	.	A	T	13	13	26	0	2	28	0	0
5	35273564	.	G	A	10	14	24	0	1	25	0	0
5	35273708	.	T	C	11	12	23	0	0	23	0	0
5	35273793	.	A	T	16	16	32	0	0	32	0	0
5	35273838	.	A	C	16	14	30	0	1	31	0	0
5	35273992	.	A	G	18	20	38	0	2	40	0	0
5	35274398	.	G	A	17	11	28	0	1	29	0	0
5	35275103	.	C	T	25	15	40	0	1	41	0	0
5	35275859	.	G	T	17	13	30	0	0	30	0	0
5	35276154	.	A	G	19	12	31	0	1	32	0	0
5	35276303	.	G	C	17	13	30	0	0	30	0	0
5	35276386	.	G	A	16	11	27	0	0	27	0	0
5	35276580	.	A	G	16	6	22	0	1	23	0	0
5	35276811	.	C	G	10	8	18	0	0	18	0	0
5	35276911	.	C	T	1	7	8	0	7	15	0	0
5	35277184	.	T	A	11	3	14	0	0	14	0	0
5	35277256	.	T	A	7	13	20	0	0	20	0	0
5	35277280	.	T	C	9	12	21	0	0	21	0	0
5	35277459	.	T	C	15	7	22	0	1	23	0	0
5	35277509	.	A	T	10	9	19	0	3	22	0	0
5	35278237	.	A	T	3	3	6	0	0	6	0	0
5	35278597	.	C	T	7	7	14	0	0	14	0	0
5	35278863	.	C	T	9	8	17	0	1	18	0	0
5	35278933	.	T	C	8	0	8	0	7	15	0	0
5	35279065	.	A	G	4	5	9	0	0	9	0	0
5	35279230	.	T	G	7	6	13	0	0	13	0	0
5	35279275	.	T	G	7	9	16	0	0	16	0	0
5	35279831	.	C	T	2	3	5	0	1	6	0	0
5	35279884	.	G	A	4	5	9	0	0	9	0	0
5	35297280	.	T	C	8	0	8	0	3	11	0	0
5	35301563	.	A	G	7	3	10	0	0	10	0	0
5	35422324	.	T	C	6	5	11	0	0	11	0	0
5	35422530	.	C	T	4	2	6	0	0	6	0	0
5	35431641	.	A	G	7	9	16	0	0	16	0	0
5	35431703	.	T	G	4	10	14	0	1	15	0	0
5	35454464	.	C	T	13	11	24	0	0	24	0	0
5	35473544	.	T	C	3	4	7	0	0	7	0	0
5	35475907	.	A	T	7	8	15	0	0	15	0	0
5	35486714	.	T	C	1	2	3	0	0	3	0	0
5	35486822	.	C	T	3	2	5	0	0	5	0	0
5	35486827	.	G	A	3	2	5	0	0	5	0	0
5	35486955	.	T	C	6	6	12	0	0	12	0	0
5	35487030	.	A	G	5	6	11	0	0	11	0	0
5	35487332	.	T	A	3	3	6	0	0	6	0	0
5	35487459	.	A	T	4	2	6	0	0	6	0	0
5	35487767	.	T	G	2	0	2	0	2	4	0	0
5	35562617	.	T	C	1	2	3	0	0	3	0	0
5	35678570	.	G	A	0	2	2	0	3	5	0	0
5	35682874	.	A	G	2	2	4	0	0	4	0	0
5	35682967	.	C	A	1	2	3	0	0	3	0	0
5	35682999	.	C	A	1	2	3	0	0	3	0	0
5	35683225	.	C	A	2	5	7	0	0	7	0	0
5	35748938	.	T	C	5	15	20	0	0	20	0	0
5	35749470	.	A	G	9	6	15	0	0	15	0	0
5	35751883	.	G	T	9	7	16	0	0	16	0	0
5	35751977	.	A	G	6	8	14	0	2	16	0	0
5	35754284	.	A	G	17	0	17	0	13	30	0	0
5	35754424	.	T	C	16	10	26	0	1	27	0	0
5	35754431	.	A	G	14	0	14	0	12	26	0	0
5	35754503	.	A	C	14	10	24	0	1	25	0	0
5	35754599	.	T	A	13	15	28	0	0	28	0	0
5	35754663	.	A	G	11	10	21	0	3	24	0	0
5	35898689	.	T	C	2	2	4	0	0	4	0	0
5	35955514	.	T	C	11	14	25	0	1	26	0	0
5	35967234	.	C	T	8	10	18	0	0	18	0	0
5	35967270	.	T	A	5	5	10	0	0	10	0	0
5	36271160	.	T	G	5	5	10	0	0	10	0	0
5	36274750	.	C	A	3	4	7	0	0	7	0	0
5	36296066	.	G	A	4	3	7	0	0	7	0	0
5	36416204	.	A	G	12	14	26	0	2	28	0	0
5	36416307	.	C	G	12	0	12	0	8	20	0	0
5	36416367	.	G	A	3	11	14	0	13	27	0	0
5	36416478	.	G	T	15	6	21	0	1	22	0	0
5	36416583	.	C	T	21	15	36	0	1	37	0	0
5	36421991	.	G	A	4	9	13	0	10	23	0	0
5	36530959	.	A	T	15	6	21	0	1	22	0	0
5	36536665	.	T	C	13	6	19	0	1	20	0	0
5	36536742	.	C	T	14	11	25	0	2	27	0	0
5	36536859	.	A	G	8	2	10	0	4	14	0	0
5	36536910	.	G	A	9	5	14	0	0	14	0	0
5	36537020	.	A	G	7	9	16	0	0	16	0	0
5	36537021	.	T	A	7	9	16	0	0	16	0	0
5	36537057	.	G	A	8	8	16	0	0	16	0	0
5	36537073	.	A	C	9	8	17	0	0	17	0	0
5	36537126	.	G	A	16	10	26	0	0	26	0	0
5	36537231	.	A	T	12	9	21	0	0	21	0	0
5	36537246	.	A	G	10	0	10	0	8	18	0	0
5	36537334	.	A	T	11	3	14	0	0	14	0	0
5	36537352	.	G	A	10	3	13	0	0	13	0	0
5	36537611	.	C	A	9	5	14	0	2	16	0	0
5	36537672	.	C	A	5	4	9	0	0	9	0	0
5	36537927	.	T	C	2	3	5	0	0	5	0	0
5	36558059	.	G	A	17	15	32	0	1	33	0	0
5	36558348	.	A	G	12	16	28	0	2	30	0	0
5	36558369	.	G	A	15	16	31	0	2	33	0	0
5	36558441	.	C	T	22	11	33	0	2	35	0	0
5	36563257	.	T	C	14	7	21	0	0	21	0	0
5	36564205	.	A	G	4	6	10	0	1	11	0	0
5	36564206	.	A	T	5	6	11	0	0	11	0	0
5	36567750	.	C	A	1	3	4	0	6	10	0	0
5	36570280	.	G	A	6	6	12	0	0	12	0	0
5	36583271	.	A	G	2	5	7	0	0	7	0	0
5	36583575	.	C	T	1	2	3	0	5	8	0	0
5	36584985	.	C	T	2	6	8	0	0	8	0	0
5	36585933	.	C	T	2	2	4	0	0	4	0	0
5	36586190	.	G	A	2	3	5	0	0	5	0	0
5	36586192	.	C	G	2	3	5	0	0	5	0	0
5	36586867	.	A	G	5	5	10	0	0	10	0	0
5	36586906	.	C	G	1	4	5	0	5	10	0	0
5	36595772	.	A	T	4	4	8	0	0	8	0	0
5	36595912	.	G	A	4	5	9	0	0	9	0	0
5	36596106	.	A	G	6	3	9	0	0	9	0	0
5	36596278	.	G	A	6	3	9	0	0	9	0	0
5	36596294	.	G	A	5	2	7	0	0	7	0	0
5	36596378	.	G	A	2	2	4	0	0	4	0	0
5	36596397	.	T	A	2	4	6	0	0	6	0	0
5	36596517	.	C	A	0	5	5	0	6	11	0	0
5	36624620	.	G	A	1	12	13	0	6	19	0	0
5	36650153	.	C	A	3	4	7	0	0	7	0	0
5	36650176	.	A	T	2	5	7	0	0	7	0	0
5	36650289	.	T	G	7	3	10	0	0	10	0	0
5	36653522	.	G	A	9	3	12	0	1	13	0	0
5	36654147	.	G	A	0	10	10	0	8	18	0	0
5	36654334	.	A	T	4	2	6	0	0	6	0	0
5	36665351	.	C	T	6	6	12	0	1	13	0	0
5	36668321	.	C	T	3	6	9	0	0	9	0	0
5	36673347	.	C	T	4	3	7	0	0	7	0	0
5	36673470	.	C	A	4	4	8	0	0	8	0	0
5	36673687	.	A	T	7	4	11	0	0	11	0	0
5	36674796	.	G	C	6	7	13	0	1	14	0	0
5	36674831	.	C	T	5	3	8	0	0	8	0	0
5	36730732	.	C	T	2	3	5	0	0	5	0	0
5	36732199	.	G	C	17	23	40	0	0	41	1	0
5	36732217	.	A	G	18	20	38	0	2	40	0	0
5	36739134	.	T	C	13	17	30	0	0	30	0	0
5	36739310	.	T	A	17	14	31	0	1	32	0	0
5	36739316	.	T	C	16	12	28	0	1	29	0	0
5	36739352	.	T	A	13	12	25	0	3	28	0	0
5	36739361	.	T	C	10	11	21	0	3	24	0	0
5	36786641	.	G	A	1	5	6	0	8	14	0	0
5	36802395	.	A	C	3	2	5	0	0	5	0	0
5	36802407	.	T	C	2	3	5	0	1	6	0	0
5	36851191	.	C	T	7	6	13	0	0	13	0	0
5	36852564	.	A	G	5	0	5	0	8	13	0	0
5	36852848	.	G	A	0	7	7	0	4	11	0	0
5	36853849	.	C	G	13	10	23	0	1	24	0	0
5	36895627	.	G	A	3	3	6	0	0	6	0	0
5	36898476	.	C	T	29	16	45	0	1	46	0	0
5	36898668	.	A	G	26	1	27	0	31	58	0	0
5	36901003	.	T	G	11	7	18	0	1	19	0	0
5	36902610	.	A	G	12	2	14	0	12	26	0	0
5	36902628	.	T	C	9	17	26	0	0	26	0	0
5	36907182	.	G	T	10	3	13	0	0	13	0	0
5	36908034	.	T	C	16	24	40	0	2	42	0	0
5	36913570	.	A	G	1	3	4	0	0	4	0	0
5	36914002	.	C	T	2	5	7	0	1	8	0	0
5	36914018	.	A	C	2	0	2	0	8	10	0	0
5	36916370	.	A	T	1	6	7	0	0	7	0	0
5	36922399	.	A	G	3	3	6	0	1	7	0	0
5	36924122	.	G	C	3	2	5	0	0	5	0	0
5	36945378	.	T	A	20	18	38	6	1	45	0	0
5	36945383	.	A	T	20	18	38	6	2	46	0	0
5	36945463	.	T	A	34	20	54	0	1	55	0	0
5	36945518	.	T	G	28	21	49	0	6	55	0	0
5	36945719	.	G	T	35	21	56	1	19	76	0	0
5	36945747	.	T	A	30	24	54	1	14	69	0	0
5	36945927	.	A	C	37	27	64	0	3	67	0	0
5	36945937	.	C	T	36	27	63	0	2	66	1	0
5	36946244	.	A	G	36	29	65	0	6	71	0	0
5	36946261	.	T	C	34	5	39	0	29	68	0	0
5	36946341	.	C	T	9	41	50	0	23	73	0	0
5	36996458	.	A	G	14	11	25	0	1	26	0	0
5	36996638	.	A	G	12	0	12	0	17	29	0	0
5	36997133	.	A	G	14	15	29	0	0	29	0	0
5	37032095	.	A	G	6	16	22	0	2	24	0	0
5	37032191	.	T	C	9	9	18	0	0	18	0	0
5	37032280	.	C	G	8	14	22	0	1	23	0	0
5	37032339	.	A	G	9	0	9	0	11	20	0	0
5	37032611	.	T	C	9	8	17	0	0	17	0	0
5	37032782	.	G	A	7	20	27	0	2	29	0	0
5	37032799	.	A	T	9	22	31	0	0	31	0	0
5	37032959	.	A	G	16	14	30	0	0	30	0	0
5	37034111	.	T	C	17	14	31	0	0	31	0	0
5	37036404	.	T	C	7	8	15	0	0	15	0	0
5	37036648	.	A	G	10	0	10	0	11	21	0	0
5	37036662	.	T	A	12	7	19	0	2	21	0	0
5	37036856	.	T	C	7	11	18	0	0	19	1	0
5	37036975	.	A	T	9	9	18	0	1	19	0	0
5	37037079	.	C	T	18	11	29	0	0	29	0	0
5	37037152	.	T	C	14	16	30	0	1	31	0	0
5	37037308	.	C	A	3	7	10	0	2	12	0	0
5	37037583	.	T	C	13	10	23	0	1	24	0	0
5	37037617	.	A	T	17	13	30	0	0	30	0	0
5	37037669	.	T	G	13	13	26	0	0	26	0	0
5	37037742	.	A	T	24	13	37	0	1	38	0	0
5	37038017	.	T	C	8	6	14	0	2	16	0	0
5	37061485	.	G	A	19	13	32	0	4	36	0	0
5	37061487	.	C	T	22	15	37	0	0	37	0	0
5	37065416	.	T	C	21	23	44	0	1	45	0	0
5	37065729	.	C	T	13	9	22	0	0	28	6	0
5	37095066	.	A	C	7	3	10	0	0	10	0	0
5	37277355	.	A	G	1	4	5	0	0	5	0	0
5	37277377	.	T	A	1	4	5	0	0	5	0	0
5	37280125	.	A	G	2	5	7	0	0	7	0	0
5	37286325	.	A	G	6	0	6	0	3	9	0	0
5	37286590	.	G	A	1	8	9	0	1	10	0	0
5	37293768	.	G	A	6	6	12	0	1	13	0	0
5	37293815	.	T	C	7	7	14	0	0	14	0	0
5	37293841	.	G	A	7	5	12	0	0	12	0	0
5	37294077	.	G	A	5	2	7	0	0	7	0	0
5	37295646	.	C	T	4	5	9	0	0	9	0	0
5	37296298	.	C	T	6	7	13	0	1	14	0	0
5	37301236	.	G	A	7	9	16	0	0	16	0	0
5	37301249	.	C	T	6	10	16	0	0	16	0	0
5	37301282	.	C	T	6	7	13	0	0	13	0	0
5	37301505	.	A	G	12	11	23	0	1	24	0	0
5	37301783	.	A	G	16	14	30	0	3	33	0	0
5	37304028	.	T	C	9	4	13	0	1	14	0	0
5	37304070	.	G	T	8	4	12	0	1	13	0	0
5	37307921	.	C	G	16	17	33	0	1	34	0	0
5	37309734	.	A	G	16	16	32	0	0	32	0	0
5	37309881	.	C	T	19	13	32	0	3	36	1	0
5	37331854	.	C	T	4	4	8	0	1	9	0	0
5	37333870	.	G	A	9	11	20	0	1	21	0	0
5	37334264	.	T	A	4	4	8	0	0	8	0	0
5	37380533	.	T	C	3	6	9	0	0	9	0	0
5	37413762	.	G	A	8	6	14	0	0	14	0	0
5	37422999	.	A	T	7	6	13	0	0	13	0	0
5	37423193	.	G	A	9	10	19	0	0	19	0	0
5	37439388	.	C	T	3	14	17	0	0	17	0	0
5	37439418	.	C	T	6	14	20	0	0	20	0	0
5	37439505	.	T	C	11	7	18	0	2	20	0	0
5	37439517	.	A	C	6	9	15	0	2	17	0	0
5	37439891	.	T	C	16	17	33	0	0	33	0	0
5	37504439	.	T	A	3	3	6	0	0	6	0	0
5	37504489	.	G	T	3	2	5	0	0	5	0	0
5	37504966	.	G	A	4	2	6	0	0	6	0	0
5	37505245	.	G	A	4	2	6	0	0	6	0	0
5	37507823	.	T	C	5	4	9	0	0	9	0	0
5	37507901	.	C	T	6	7	13	0	0	13	0	0
5	37508828	.	C	T	5	3	8	0	0	8	0	0
5	37508832	.	T	G	5	2	7	0	0	7	0	0
5	37508979	.	A	C	1	4	5	0	0	5	0	0
5	37509296	.	G	C	6	8	14	0	0	14	0	0
5	37509428	.	T	G	2	3	5	0	0	5	0	0
5	37509703	.	C	T	8	16	24	0	0	24	0	0
5	37509766	.	G	A	0	6	6	0	9	15	0	0
5	37509857	.	A	G	10	5	15	0	0	15	0	0
5	37509916	.	A	G	9	6	15	0	0	15	0	0
5	37510247	.	C	T	4	3	7	0	0	7	0	0
5	37510292	.	C	T	5	4	9	0	0	9	0	0
5	37510293	.	T	C	5	4	9	0	0	9	0	0
5	37510574	.	C	G	7	5	12	0	0	12	0	0
5	37573605	.	T	A	1	2	3	0	0	3	0	0
5	37578979	.	G	A	1	4	5	0	0	5	0	0
5	37580857	.	C	T	2	4	6	0	0	6	0	0
5	37581111	.	G	A	5	3	8	0	0	8	0	0
5	37584160	.	A	G	6	2	8	0	0	8	0	0
5	37677229	.	C	T	2	4	6	0	0	6	0	0
5	37678256	.	T	C	4	3	7	0	0	7	0	0
5	37680403	.	G	A	0	8	8	0	2	10	0	0
5	37686590	.	C	T	6	4	10	0	0	10	0	0
5	37688077	.	C	T	4	4	8	0	0	8	0	0
5	37688422	.	A	G	9	6	15	0	0	15	0	0
5	37688878	.	A	C	7	8	15	0	0	15	0	0
5	37691223	.	A	G	8	8	16	0	1	17	0	0
5	37692171	.	A	G	15	16	31	0	1	32	0	0
5	37692620	.	T	C	13	5	18	0	2	20	0	0
5	37694283	.	G	A	8	8	16	0	0	16	0	0
5	37694568	.	A	C	8	7	15	0	0	15	0	0
5	37695528	.	A	G	5	3	8	0	1	9	0	0
5	37696582	.	G	A	7	6	13	0	2	15	0	0
5	37697134	.	C	T	14	13	27	0	1	28	0	0
5	37699115	.	A	G	13	17	30	0	1	31	0	0
5	37700687	.	C	A	10	14	24	0	1	25	0	0
5	37700908	.	T	C	10	16	26	0	1	27	0	0
5	37701262	.	T	A	10	12	22	0	1	23	0	0
5	37702934	.	C	T	18	14	32	0	0	32	0	0
5	37703176	.	G	A	0	11	11	0	16	27	0	0
5	37706798	.	C	T	19	25	44	1	1	46	0	0
5	37707190	.	G	A	24	10	34	0	4	38	0	0
5	37708995	.	A	T	24	25	49	0	1	50	0	0
5	37709057	.	T	A	23	22	45	0	1	46	0	0
5	37754583	.	A	G	1	3	4	0	0	4	0	0
5	37757505	.	C	T	3	4	7	0	0	7	0	0
5	37757677	.	C	T	4	7	11	0	0	11	0	0
5	37757690	.	T	C	5	7	12	0	1	13	0	0
5	37838415	.	T	C	31	33	64	0	3	67	0	0
5	37839029	.	G	T	49	35	84	0	4	88	0	0
5	37851528	.	T	C	2	3	5	0	0	5	0	0
5	37851542	.	G	A	2	3	5	0	0	5	0	0
5	37851742	.	G	A	2	7	9	0	0	9	0	0
5	37851758	.	T	A	2	6	8	0	0	8	0	0
5	37851830	.	C	A	2	10	12	0	0	12	0	0
5	37851876	.	C	T	5	9	14	0	0	14	0	0
5	37851923	.	G	A	3	4	7	0	0	7	0	0
5	37864845	.	A	G	14	6	20	0	0	20	0	0
5	37865142	.	C	T	11	3	14	0	1	15	0	0
5	37865628	.	T	C	10	6	16	0	0	16	0	0
5	37865677	.	G	T	5	2	7	0	0	7	0	0
5	37865744	.	C	G	4	3	7	0	2	9	0	0
5	37866310	.	C	T	7	6	13	0	1	14	0	0
5	37867491	.	C	T	8	7	15	0	0	15	0	0
5	37872801	.	C	T	4	2	6	0	0	6	0	0
5	37880796	.	A	T	1	3	4	0	0	4	0	0
5	37912292	.	T	A	21	17	38	0	2	40	0	0
5	37912442	.	A	G	11	16	27	0	0	27	0	0
5	37912489	.	T	A	13	11	24	0	2	26	0	0
5	37912748	.	A	T	10	11	21	0	0	21	0	0
5	37912859	.	A	C	15	15	30	0	1	31	0	0
5	37912970	.	A	C	16	9	25	0	0	25	0	0
5	37913041	.	C	G	15	15	30	0	0	30	0	0
5	37913064	.	T	C	18	16	34	0	1	35	0	0
5	37918855	.	G	A	3	4	7	0	0	7	0	0
5	37918894	.	A	T	6	2	8	0	3	11	0	0
5	37918932	.	A	T	6	7	13	0	1	14	0	0
5	37918994	.	C	T	3	2	5	0	1	6	0	0
5	37926281	.	G	A	1	3	4	0	0	4	0	0
5	37926323	.	T	A	3	3	6	0	0	6	0	0
5	37934005	.	C	T	5	2	7	0	0	7	0	0
5	37934156	.	A	G	6	2	8	0	0	8	0	0
5	37934206	.	T	C	3	5	8	0	0	8	0	0
5	37963259	.	C	T	13	9	22	0	3	25	0	0
5	37963262	.	G	T	12	13	25	0	0	25	0	0
5	37963316	.	C	A	11	16	27	0	3	30	0	0
5	37963326	.	C	A	12	11	23	0	1	24	0	0
5	37968879	.	G	T	5	12	17	0	1	18	0	0
5	37968912	.	T	G	6	13	19	0	0	19	0	0
5	37968951	.	G	A	12	6	18	0	1	19	0	0
5	37968966	.	T	C	11	5	16	0	0	16	0	0
5	37970764	.	C	T	9	11	20	0	0	20	0	0
5	37970773	.	A	T	7	7	14	0	0	14	0	0
5	37970818	.	T	G	6	0	6	0	8	14	0	0
5	37981906	.	T	G	4	5	9	0	0	9	0	0
5	37982156	.	G	C	6	0	6	0	6	12	0	0
5	37987325	.	C	T	2	7	9	0	6	15	0	0
5	37987369	.	G	A	8	7	15	0	0	15	0	0
5	37988969	.	G	T	7	8	15	0	0	15	0	0
5	37989090	.	G	A	9	4	13	0	0	13	0	0
5	37989135	.	A	G	5	12	17	0	1	18	0	0
5	37989325	.	G	A	5	5	10	0	1	11	0	0
5	37989379	.	G	T	3	7	10	0	0	10	0	0
5	37989443	.	A	C	5	7	12	0	0	12	0	0
5	37989447	.	A	G	5	5	10	0	0	10	0	0
5	37991350	.	T	A	6	6	12	0	1	13	0	0
5	37991535	.	T	G	2	4	6	0	1	7	0	0
5	37991566	.	C	A	0	2	2	0	3	5	0	0
5	37991756	.	C	T	2	5	7	0	0	7	0	0
5	37991757	.	C	T	2	5	7	0	0	7	0	0
5	37992120	.	T	C	5	7	12	0	0	12	0	0
5	37993446	.	G	T	2	3	5	0	0	5	0	0
5	38089309	.	G	A	2	2	4	0	0	4	0	0
5	38089537	.	T	C	3	2	5	0	0	5	0	0
5	38089578	.	T	G	3	3	6	0	1	7	0	0
5	38089651	.	G	A	5	8	13	0	0	13	0	0
5	38089733	.	G	C	4	0	4	0	6	10	0	0
5	38089834	.	A	G	4	5	9	0	0	9	0	0
5	38089930	.	G	T	4	3	7	0	0	7	0	0
5	38090070	.	A	G	1	2	3	0	1	4	0	0
5	38090542	.	G	A	1	3	4	0	0	4	0	0
5	38090659	.	G	C	2	0	2	0	3	5	0	0
5	38090677	.	A	G	2	3	5	0	0	5	0	0
5	38091247	.	A	G	2	4	6	0	0	6	0	0
5	38101745	.	T	G	2	0	2	0	2	4	0	0
5	38101869	.	C	T	1	5	6	0	0	6	0	0
5	38104953	.	C	T	2	2	4	0	0	4	0	0
5	38104971	.	G	T	0	2	2	0	1	3	0	0
5	38105012	.	C	G	1	2	3	0	0	3	0	0
5	38105257	.	A	T	2	2	4	0	0	4	0	0
5	38105327	.	T	C	2	3	5	0	0	5	0	0
5	38107054	.	T	C	1	3	4	0	0	4	0	0
5	38110486	.	C	T	1	2	3	0	0	3	0	0
5	38110826	.	G	T	8	4	12	0	0	12	0	0
5	38110908	.	A	T	8	12	20	0	0	20	0	0
5	38111060	.	T	C	5	0	5	0	11	16	0	0
5	38115349	.	T	C	3	4	7	0	1	9	1	0
5	38115361	.	T	C	1	5	6	0	0	6	0	0
5	38115395	.	A	G	2	3	5	0	0	5	0	0
5	38115502	.	C	T	7	4	11	0	1	12	0	0
5	38115582	.	C	T	8	3	11	0	0	11	0	0
5	38115685	.	A	T	7	5	12	0	0	12	0	0
5	38115940	.	T	C	1	0	1	0	5	6	0	0
5	38120116	.	A	G	5	3	8	0	0	8	0	0
5	38120117	.	C	A	5	2	7	0	1	8	0	0
5	38121914	.	T	A	8	6	14	0	0	14	0	0
5	38121942	.	A	G	5	8	13	0	0	13	0	0
5	38121991	.	A	T	3	7	10	0	1	11	0	0
5	38121993	.	T	C	4	6	10	0	1	11	0	0
5	38122100	.	C	A	3	3	6	0	0	6	0	0
5	38206476	.	C	T	2	2	4	0	0	4	0	0
5	38206485	.	G	T	1	2	3	0	1	4	0	0
5	38212551	.	T	G	2	0	2	0	2	4	0	0
5	38213310	.	C	A	2	3	5	0	1	6	0	0
5	38213877	.	G	C	3	3	6	0	1	7	0	0
5	38214258	.	A	G	4	4	8	0	0	8	0	0
5	38216140	.	C	T	3	2	5	0	0	5	0	0
5	38216175	.	T	G	1	3	4	0	1	5	0	0
5	38216204	.	G	A	3	3	6	0	0	6	0	0
5	38216344	.	G	A	1	6	7	0	0	7	0	0
5	38216469	.	C	A	3	4	7	0	0	7	0	0
5	38216471	.	C	T	1	4	5	0	2	7	0	0
5	38216661	.	G	A	1	3	4	0	0	4	0	0
5	38217224	.	G	A	3	4	7	0	0	7	0	0
5	38217376	.	T	C	4	3	7	0	0	7	0	0
5	38218004	.	G	A	3	3	6	0	0	6	0	0
5	38251327	.	A	T	2	2	4	0	0	4	0	0
5	38251506	.	C	T	1	3	4	0	3	7	0	0
5	38251968	.	T	G	4	5	9	0	0	9	0	0
5	38252113	.	G	C	7	3	10	0	0	10	0	0
5	38254734	.	A	G	5	3	8	0	0	8	0	0
5	38254919	.	A	G	3	2	5	0	0	5	0	0
5	38254958	.	C	T	0	5	5	0	2	7	0	0
5	38255132	.	G	A	2	5	7	0	0	7	0	0
5	38263384	.	G	A	18	14	32	0	0	32	0	0
5	38263611	.	G	A	9	11	20	0	0	20	0	0
5	38263870	.	C	T	16	13	29	0	0	29	0	0
5	38281540	.	G	C	2	16	18	0	14	32	0	0
5	38287103	.	C	T	15	21	36	0	0	36	0	0
5	38288313	.	T	A	9	15	24	0	1	25	0	0
5	38288346	.	T	A	12	20	32	0	1	33	0	0
5	38289358	.	A	C	17	18	35	0	7	42	0	0
5	38296192	.	C	T	21	20	41	0	2	43	0	0
5	38296193	.	A	G	22	20	42	0	1	43	0	0
5	38296475	.	G	A	23	13	36	0	2	38	0	0
5	38296765	.	A	C	15	23	38	0	2	40	0	0
5	38296799	.	A	C	15	26	41	0	2	43	0	0
5	38297305	.	A	G	23	0	23	0	24	47	0	0
5	38302085	.	G	A	12	16	28	0	2	30	0	0
5	38302158	.	C	A	24	18	42	0	2	44	0	0
5	38302159	.	A	C	33	12	45	0	0	45	0	0
5	38302589	.	T	A	20	15	35	0	1	36	0	0
5	38302753	.	G	T	22	25	47	0	5	52	0	0
5	38302859	.	C	T	18	24	42	0	2	44	0	0
5	38302911	.	A	T	19	14	33	0	0	33	0	0
5	38303028	.	G	T	21	18	39	0	2	41	0	0
5	38303301	.	T	C	13	0	13	0	18	31	0	0
5	38303895	.	A	T	25	20	45	0	2	47	0	0
5	38303896	.	G	A	26	19	45	0	2	47	0	0
5	38304578	.	C	T	22	20	42	0	2	44	0	0
5	38304633	.	T	G	21	14	35	0	2	37	0	0
5	38304768	.	G	A	15	21	36	1	1	38	0	0
5	38305068	.	G	A	17	26	43	0	2	45	0	0
5	38305127	.	T	C	18	21	39	0	3	44	2	0
5	38305493	.	C	T	4	19	23	0	0	23	0	0
5	38305698	.	G	A	10	13	23	0	2	25	0	0
5	38308378	.	C	A	19	15	34	1	1	36	0	0
5	38314069	.	C	T	10	17	27	0	0	27	0	0
5	38320825	.	A	G	14	8	22	0	4	26	0	0
5	38324453	.	C	T	11	5	16	0	0	16	0	0
5	38349956	.	A	G	4	5	9	0	1	10	0	0
5	38363132	.	T	C	6	0	6	0	6	12	0	0
5	38369850	.	C	T	4	7	11	0	0	11	0	0
5	38388741	.	C	A	3	3	6	0	0	6	0	0
5	38388786	.	G	A	1	4	5	0	0	5	0	0
5	38388875	.	C	G	0	2	2	0	2	4	0	0
5	38389147	.	T	C	1	4	5	0	1	6	0	0
5	38389165	.	G	T	1	4	5	0	0	5	0	0
5	38389641	.	G	A	3	2	5	0	0	5	0	0
5	38389642	.	G	T	3	2	5	0	0	5	0	0
5	38390352	.	A	G	4	2	6	0	0	6	0	0
5	38390634	.	T	C	2	2	4	0	0	4	0	0
5	38390640	.	T	C	1	2	3	0	0	3	0	0
5	38390672	.	C	T	3	3	6	0	1	7	0	0
5	38391622	.	T	G	2	4	6	0	0	6	0	0
5	38475953	.	C	G	5	10	15	0	1	16	0	0
5	38476185	.	C	T	8	3	11	0	2	13	0	0
5	38476750	.	C	A	8	7	15	0	2	17	0	0
5	38506785	.	T	G	4	2	6	2	0	8	0	0
5	38531848	.	T	A	5	8	13	0	0	13	0	0
5	38532216	.	A	T	5	6	11	0	1	12	0	0
5	38532462	.	T	C	5	0	5	0	7	12	0	0
5	38532535	.	A	G	5	8	13	0	0	13	0	0
5	38533170	.	A	G	13	4	17	0	1	18	0	0
5	38533296	.	T	G	7	6	13	0	1	14	0	0
5	38533392	.	G	T	8	13	21	0	0	21	0	0
5	38533404	.	C	T	0	11	11	0	6	17	0	0
5	38533464	.	A	G	3	4	7	0	0	7	0	0
5	38533551	.	A	G	7	5	12	0	2	14	0	0
5	38604395	.	A	G	1	0	1	0	2	3	0	0
5	38604413	.	C	T	2	2	4	0	0	4	0	0
5	38605094	.	C	T	6	8	14	0	1	15	0	0
5	38605106	.	A	T	8	7	15	0	2	17	0	0
5	38605164	.	C	T	7	3	10	0	1	11	0	0
5	38605201	.	A	C	10	3	13	0	0	13	0	0
5	38605291	.	G	C	12	5	17	0	0	17	0	0
5	38611096	.	G	T	9	11	20	1	2	23	0	0
5	38611108	.	T	C	6	0	6	1	14	21	0	0
5	38721044	.	G	C	2	4	6	0	0	6	0	0
5	38726961	.	A	T	1	2	3	0	0	3	0	0
5	38745962	.	A	T	1	2	3	0	0	3	0	0
5	38745980	.	G	T	0	2	2	0	1	3	0	0
5	38749541	.	T	A	4	2	6	0	0	6	0	0
5	38749814	.	G	A	1	2	3	0	0	3	0	0
5	38749892	.	C	T	1	2	3	0	0	3	0	0
5	38749893	.	C	T	1	2	3	0	0	3	0	0
5	38749939	.	C	A	1	3	4	0	0	5	1	0
5	38786922	.	T	C	6	5	11	0	0	11	0	0
5	38787083	.	A	T	1	2	3	0	0	3	0	0
5	38787107	.	G	T	2	3	5	0	0	5	0	0
5	38811281	.	T	C	1	2	3	0	0	3	0	0
5	38824361	.	A	G	1	3	4	0	0	4	0	0
5	38826047	.	A	C	4	4	8	0	0	8	0	0
5	38827340	.	T	A	6	2	8	0	0	8	0	0
5	39048254	.	G	A	0	2	2	0	1	3	0	0
5	39067289	.	T	C	1	2	3	0	0	3	0	0
5	39083065	.	A	C	3	4	7	0	0	7	0	0
5	39083116	.	T	C	1	2	3	0	0	3	0	0
5	39083125	.	G	A	1	2	3	0	0	3	0	0
5	39085112	.	C	G	1	2	3	0	0	3	0	0
5	39085271	.	T	C	3	2	5	0	0	5	0	0
5	39085976	.	C	T	5	5	10	0	0	10	0	0
5	39099642	.	T	C	5	6	11	0	1	12	0	0
5	39124314	.	C	T	2	7	9	0	1	10	0	0
5	39136032	.	G	A	6	5	11	0	0	11	0	0
5	39142657	.	A	G	8	0	8	1	5	14	0	0
5	39143310	.	C	T	4	5	9	0	0	9	0	0
5	39143447	.	C	T	7	6	13	0	0	13	0	0
5	39150608	.	C	A	2	3	5	0	0	5	0	0
5	39150623	.	C	T	1	4	5	0	0	5	0	0
5	39150758	.	C	A	1	2	3	0	0	3	0	0
5	39152155	.	G	A	2	2	4	0	2	6	0	0
5	39152156	.	T	C	3	2	5	0	0	5	0	0
5	39152411	.	C	T	6	2	8	0	0	8	0	0
5	39152582	.	A	G	2	2	4	0	0	4	0	0
5	39154819	.	C	G	5	12	17	0	0	17	0	0
5	39154829	.	G	T	5	14	19	0	0	19	0	0
5	39154919	.	A	G	12	6	18	0	0	18	0	0
5	39154958	.	C	G	8	11	19	0	1	20	0	0
5	39154979	.	C	T	0	11	11	0	6	17	0	0
5	39155006	.	T	A	9	8	17	0	0	17	0	0
5	39155044	.	A	G	7	6	13	0	0	13	0	0
5	39155146	.	T	A	1	3	4	0	0	4	0	0
5	39155419	.	C	T	7	5	12	0	0	12	0	0
5	39155473	.	T	A	10	8	18	0	2	20	0	0
5	39155474	.	G	T	10	9	19	0	1	20	0	0
5	39155511	.	A	G	5	8	13	0	0	13	0	0
5	39160584	.	G	A	3	2	5	0	0	5	0	0
5	39386791	.	C	A	3	2	5	0	0	5	0	0
5	39504271	.	G	C	4	6	10	0	0	10	0	0
5	39508009	.	C	T	19	12	31	0	1	32	0	0
5	39508059	.	T	A	20	10	30	0	2	32	0	0
5	39508540	.	G	A	1	6	7	0	10	17	0	0
5	39707665	.	A	T	2	2	4	0	0	4	0	0
5	39707758	.	A	C	5	9	14	0	1	15	0	0
5	39707825	.	G	A	10	8	18	0	0	18	0	0
5	39708046	.	A	G	10	9	19	0	0	19	0	0
5	39712557	.	T	C	14	5	19	0	3	22	0	0
5	39714917	.	T	C	14	14	28	0	2	30	0	0
5	39715249	.	G	A	12	10	22	0	1	23	0	0
5	39730511	.	A	G	14	8	22	0	1	23	0	0
5	39730575	.	C	T	13	8	21	0	0	21	0	0
5	39730713	.	T	C	5	7	12	0	1	13	0	0
5	39730785	.	A	G	4	3	7	0	0	7	0	0
5	39731805	.	T	C	4	10	14	0	0	14	0	0
5	39736279	.	C	T	3	6	9	0	0	9	0	0
5	39805398	.	T	C	3	0	3	0	2	5	0	0
5	40003053	.	G	A	0	3	3	0	3	6	0	0
5	40003650	.	C	T	5	7	12	0	0	12	0	0
5	40012989	.	G	A	5	3	8	0	0	8	0	0
5	40024831	.	C	T	0	4	4	0	10	14	0	0
5	40054407	.	C	G	19	12	31	0	0	31	0	0
5	40059722	.	C	G	18	17	35	0	1	36	0	0
5	40059761	.	T	C	15	18	33	0	0	33	0	0
5	40062351	.	A	G	13	9	22	0	1	23	0	0
5	40062390	.	G	A	13	6	19	0	1	20	0	0
5	40071745	.	C	T	4	9	13	0	0	13	0	0
5	40077300	.	G	A	15	5	20	0	0	20	0	0
5	40078717	.	C	A	11	5	16	0	2	18	0	0
5	40080885	.	G	A	8	4	12	0	0	12	0	0
5	40093858	.	G	A	5	3	8	0	0	8	0	0
5	40094642	.	A	G	7	2	9	0	0	9	0	0
5	40095602	.	C	T	1	3	4	0	1	5	0	0
5	40097502	.	A	G	4	5	9	0	1	10	0	0
5	40097505	.	A	G	4	5	9	0	1	10	0	0
5	40097831	.	A	G	2	3	5	0	0	5	0	0
5	40203540	.	G	A	6	4	10	0	0	10	0	0
5	40206117	.	G	A	6	8	14	0	1	15	0	0
5	40206358	.	A	C	2	7	9	0	1	10	0	0
5	40210379	.	A	C	3	6	9	0	0	9	0	0
5	40273444	.	A	C	2	2	4	0	0	4	0	0
5	40273468	.	T	C	2	2	4	0	0	4	0	0
5	40273606	.	C	T	0	6	6	0	1	7	0	0
5	40273727	.	T	A	4	1	5	0	1	6	0	0
5	40273864	.	G	A	4	4	8	0	0	8	0	0
5	40505124	.	C	T	2	2	4	0	4	8	0	0
5	40506670	.	G	A	3	7	10	0	1	11	0	0
5	40506837	.	A	G	1	2	3	0	0	3	0	0
5	40507001	.	G	A	2	1	3	0	1	4	0	0
5	40507154	.	C	G	3	2	5	0	0	5	0	0
5	40507577	.	C	A	4	7	11	0	0	11	0	0
5	40728810	.	T	C	1	0	1	0	3	4	0	0
5	40729081	.	A	C	8	4	12	0	2	14	0	0
5	40729147	.	T	C	8	3	11	0	0	11	0	0
5	40729270	.	G	C	3	2	5	0	1	6	0	0
5	40729408	.	G	A	8	9	17	0	1	18	0	0
5	40729618	.	A	G	9	10	19	0	1	20	0	0
5	40732293	.	A	G	6	5	11	0	0	11	0	0
5	40732341	.	T	A	5	3	8	0	0	8	0	0
5	40845312	.	A	G	10	9	19	0	1	20	0	0
5	40845344	.	G	C	3	8	11	0	1	12	0	0
5	40845387	.	A	G	8	8	16	0	0	16	0	0
5	40845389	.	A	T	8	7	15	0	2	17	0	0
5	40845433	.	A	G	6	4	10	0	0	10	0	0
5	40845434	.	G	A	6	4	10	0	0	10	0	0
5	40845505	.	G	C	6	0	6	0	7	14	1	0
5	40845556	.	C	A	8	7	15	0	1	16	0	0
5	40845893	.	A	G	2	5	7	0	0	7	0	0
5	40846122	.	G	A	9	10	19	0	1	20	0	0
5	40856738	.	T	G	7	4	11	0	0	11	0	0
5	40857564	.	C	T	6	1	7	0	2	9	0	0
5	40865220	.	T	C	10	5	15	0	2	17	0	0
5	40865309	.	C	T	1	3	4	0	2	6	0	0
5	40877058	.	T	C	4	4	8	0	0	8	0	0
5	40910770	.	A	G	3	4	7	0	0	7	0	0
5	40935003	.	C	T	1	2	3	0	0	3	0	0
5	40953232	.	G	C	1	2	3	0	0	3	0	0
5	40956111	.	G	A	1	2	3	0	0	3	0	0
5	41082921	.	C	G	11	6	17	0	0	17	0	0
5	41082951	.	A	C	9	0	9	0	5	14	0	0
5	41083000	.	C	A	8	7	15	0	0	15	0	0
5	41083001	.	T	C	8	0	8	0	7	15	0	0
5	41083118	.	C	T	0	4	4	0	2	6	0	0
5	41083227	.	A	G	9	4	13	0	0	13	0	0
5	41083763	.	A	G	11	10	21	0	1	22	0	0
5	41083854	.	T	C	9	15	24	0	1	25	0	0
5	41083874	.	G	T	12	18	30	0	2	32	0	0
5	41084063	.	G	C	10	13	23	0	1	24	0	0
5	41084116	.	A	T	13	4	17	0	0	17	0	0
5	41084274	.	A	G	20	8	28	0	2	30	0	0
5	41084367	.	C	A	0	10	10	0	12	22	0	0
5	41085049	.	A	C	3	2	5	0	0	5	0	0
5	41085118	.	A	G	6	5	11	0	0	11	0	0
5	41085414	.	T	A	6	2	8	0	0	8	0	0
5	41085511	.	C	T	0	2	2	0	4	6	0	0
5	41085571	.	T	C	5	0	5	0	7	12	0	0
5	41085582	.	C	T	4	6	10	0	1	11	0	0
5	41086082	.	T	G	5	5	10	0	0	10	0	0
5	41086195	.	A	T	7	5	12	0	0	12	0	0
5	41103462	.	A	G	8	9	17	0	0	17	0	0
5	41103469	.	G	A	5	10	15	0	2	17	0	0
5	41124760	.	T	C	3	0	3	0	4	7	0	0
5	41125229	.	G	T	4	4	8	0	1	9	0	0
5	41125310	.	A	C	24	18	42	0	1	43	0	0
5	41125311	.	A	C	24	19	43	0	0	43	0	0
5	41125354	.	C	A	26	14	40	0	1	41	0	0
5	41125996	.	T	C	22	18	40	1	0	41	0	0
5	41126059	.	G	A	22	20	42	1	1	44	0	0
5	41127111	.	T	C	15	22	37	0	0	37	0	0
5	41127132	.	C	T	16	23	39	0	1	40	0	0
5	41128808	.	T	G	21	20	41	0	2	43	0	0
5	41133401	.	A	T	19	23	42	0	2	44	0	0
5	41134921	.	A	T	13	11	24	0	0	24	0	0
5	41134942	.	A	G	11	13	24	0	0	24	0	0
5	41135002	.	A	G	13	21	34	0	0	34	0	0
5	41137311	.	G	A	15	10	25	0	0	25	0	0
5	41137341	.	G	A	19	16	35	0	0	35	0	0
5	41138377	.	C	T	18	14	32	0	3	35	0	0
5	41138720	.	T	C	16	15	31	0	1	32	0	0
5	41138738	.	A	G	17	11	28	0	2	30	0	0
5	41138756	.	C	A	16	13	29	0	0	29	0	0
5	41138807	.	T	C	18	0	18	0	13	31	0	0
5	41146801	.	G	A	28	23	51	0	1	52	0	0
5	41150615	.	C	T	20	12	32	1	2	35	0	0
5	41150898	.	T	A	23	18	41	0	0	41	0	0
5	41150979	.	A	C	28	19	47	0	1	48	0	0
5	41151265	.	G	A	12	10	22	0	0	22	0	0
5	41260937	.	C	T	9	2	11	0	1	12	0	0
5	41261032	.	A	G	4	2	6	0	0	6	0	0
5	41261680	.	A	G	3	3	6	0	0	6	0	0
5	41261684	.	G	A	3	3	6	0	0	6	0	0
5	41261901	.	G	C	7	4	11	0	1	12	0	0
5	41261907	.	G	A	6	3	9	0	1	10	0	0
5	41271673	.	A	G	3	5	8	0	0	8	0	0
5	41286892	.	G	A	4	3	7	0	0	7	0	0
5	41286949	.	G	A	1	2	3	0	0	3	0	0
5	41286973	.	G	T	1	2	3	0	0	3	0	0
5	41306594	.	C	T	4	5	9	0	0	9	0	0
5	41306624	.	G	A	5	3	8	0	0	8	0	0
5	41478237	.	G	A	1	5	6	0	1	7	0	0
5	41478264	.	A	G	2	0	2	0	6	8	0	0
5	41478382	.	T	C	4	3	7	1	0	8	0	0
5	41481405	.	A	G	2	6	8	0	1	9	0	0
5	41481991	.	C	T	1	4	5	0	0	5	0	0
5	41481996	.	C	T	2	4	6	0	0	6	0	0
5	41484391	.	A	C	9	11	20	0	0	20	0	0
5	41484460	.	T	C	12	13	25	0	2	27	0	0
5	41484496	.	T	C	16	9	25	0	0	25	0	0
5	41484680	.	C	T	7	8	15	0	1	16	0	0
5	41484797	.	C	A	8	13	21	0	2	23	0	0
5	41485363	.	C	G	14	10	24	0	2	26	0	0
5	41485365	.	A	G	13	12	25	0	1	26	0	0
5	41485497	.	C	G	22	25	47	0	1	48	0	0
5	41485533	.	C	T	4	31	35	0	26	61	0	0
5	41485709	.	A	T	34	27	61	0	2	63	0	0
5	41485814	.	A	T	23	31	54	0	0	54	0	0
5	41486025	.	A	G	26	36	62	0	3	65	0	0
5	41486031	.	T	G	24	37	61	0	3	64	0	0
5	41486803	.	G	A	28	28	56	0	2	58	0	0
5	41486890	.	C	T	28	24	52	0	6	58	0	0
5	41488903	.	A	G	28	21	49	0	0	49	0	0
5	41489487	.	G	T	21	22	43	0	8	51	0	0
5	41489493	.	C	T	25	24	49	0	4	53	0	0
5	41489748	.	T	C	19	31	50	0	1	51	0	0
5	41492135	.	C	T	18	18	36	0	0	36	0	0
5	41492183	.	C	T	4	17	21	0	18	39	0	0
5	41492234	.	G	A	28	17	45	0	1	46	0	0
5	41492279	.	G	A	35	17	52	0	0	52	0	0
5	41492901	.	G	A	18	20	38	0	1	39	0	0
5	41492934	.	A	G	14	25	39	0	5	44	0	0
5	41503549	.	C	T	3	4	7	0	0	7	0	0
5	41509101	.	C	T	2	4	6	0	0	6	0	0
5	41513013	.	T	C	11	12	23	0	0	23	0	0
5	41514127	.	A	G	12	6	18	0	1	19	0	0
5	41516322	.	A	C	13	10	23	0	0	23	0	0
5	41516521	.	G	A	17	8	25	0	0	25	0	0
5	41518836	.	T	C	20	23	43	0	2	45	0	0
5	41519423	.	A	C	30	22	52	1	0	53	0	0
5	41519459	.	T	C	27	25	52	1	0	53	0	0
5	41520822	.	A	T	19	25	44	0	2	46	0	0
5	41520823	.	T	C	19	23	42	0	4	46	0	0
5	41520886	.	G	A	18	6	24	0	1	25	0	0
5	41559351	.	G	T	2	2	4	0	1	5	0	0
5	41560836	.	T	A	2	4	6	0	0	6	0	0
5	41582736	.	G	A	6	6	12	0	0	12	0	0
5	41585126	.	C	T	8	4	12	0	0	12	0	0
5	41585186	.	G	A	4	3	7	0	1	8	0	0
5	41594919	.	G	T	1	3	4	0	0	4	0	0
5	41597740	.	A	G	3	2	5	0	0	5	0	0
5	41600769	.	G	T	3	3	6	0	0	6	0	0
5	41617159	.	C	T	1	3	4	0	0	4	0	0
5	41617163	.	G	A	1	2	3	0	0	3	0	0
5	41617410	.	A	G	1	2	3	0	0	3	0	0
5	41639787	.	A	T	3	5	8	0	0	8	0	0
5	41639814	.	A	G	3	8	11	0	0	11	0	0
5	41639874	.	G	T	3	9	12	0	0	12	0	0
5	41641750	.	G	A	15	9	24	0	0	24	0	0
5	41641835	.	G	C	5	14	19	0	1	20	0	0
5	41641887	.	A	G	9	12	21	0	1	22	0	0
5	41642167	.	A	G	4	8	12	0	0	12	0	0
5	41642348	.	G	A	5	3	8	0	0	8	0	0
5	41643084	.	A	G	4	5	9	0	1	10	0	0
5	41643095	.	A	G	2	5	7	0	0	7	0	0
5	41643359	.	G	A	7	7	14	0	0	14	0	0
5	41645652	.	A	G	13	17	30	0	2	32	0	0
5	41645815	.	C	G	15	7	22	0	1	23	0	0
5	41645827	.	T	A	21	9	30	0	0	30	0	0
5	41645982	.	A	G	18	23	41	0	4	45	0	0
5	41650451	.	T	C	13	1	14	0	18	32	0	0
5	41655134	.	G	A	10	13	23	0	0	23	0	0
5	41655155	.	T	A	11	13	24	0	1	25	0	0
5	41670193	.	G	A	4	3	7	0	0	7	0	0
5	41676855	.	T	C	6	3	9	0	1	10	0	0
5	41684870	.	A	G	2	5	7	0	0	7	0	0
5	41684885	.	A	T	1	5	6	0	0	6	0	0
5	41689439	.	T	G	3	6	9	0	0	9	0	0
5	41691606	.	A	G	8	5	13	0	0	13	0	0
5	41708947	.	C	T	0	2	2	0	4	6	0	0
5	41878612	.	A	C	11	12	23	0	0	23	0	0
5	41878660	.	A	G	13	17	30	0	0	30	0	0
5	41878711	.	C	T	1	11	12	0	11	23	0	0
5	41878965	.	G	C	9	9	18	0	0	18	0	0
5	41879465	.	C	G	8	5	13	0	3	16	0	0
5	41879497	.	T	C	5	5	10	0	0	10	0	0
5	41879848	.	C	A	4	3	7	0	0	7	0	0
5	41880186	.	G	C	1	0	1	0	16	17	0	0
5	41880240	.	T	C	17	0	17	0	15	32	0	0
5	41880243	.	T	C	16	0	16	0	15	31	0	0
5	41880280	.	C	G	15	16	31	0	3	34	0	0
5	41880288	.	G	A	16	14	30	0	1	31	0	0
5	41882364	.	T	C	7	16	23	0	6	29	0	0
5	41885861	.	C	A	14	11	25	0	0	25	0	0
5	41888132	.	T	C	9	0	9	0	15	24	0	0
5	41890054	.	G	A	10	10	20	0	0	20	0	0
5	41890092	.	A	G	7	6	13	0	1	14	0	0
5	41890277	.	T	G	4	2	6	0	1	7	0	0
5	41891324	.	T	C	4	1	5	0	6	11	0	0
5	41898424	.	A	G	11	7	18	0	1	19	0	0
5	41899006	.	C	G	0	4	4	0	3	7	0	0
5	41899015	.	C	T	0	4	4	0	3	7	0	0
5	41900012	.	A	C	3	4	7	0	1	8	0	0
5	41900020	.	A	G	3	5	8	0	0	8	0	0
5	41900126	.	G	T	2	3	5	0	0	5	0	0
5	41900153	.	T	C	3	0	3	0	5	8	0	0
5	41900604	.	C	T	2	5	7	0	0	7	0	0
5	41901020	.	A	G	2	2	4	0	0	4	0	0
5	41914620	.	C	T	2	2	4	0	1	5	0	0
5	41914784	.	A	G	3	2	5	0	0	5	0	0
5	41917306	.	A	G	2	2	4	0	1	5	0	0
5	41917426	.	C	T	2	4	6	0	0	6	0	0
5	41917501	.	G	A	4	2	6	0	0	6	0	0
5	41917544	.	C	T	6	3	9	0	1	10	0	0
5	41917615	.	G	A	4	3	7	0	0	7	0	0
5	41917631	.	C	A	3	4	7	0	0	7	0	0
5	41917678	.	T	A	1	2	3	0	0	3	0	0
5	41960208	.	A	G	4	2	6	0	1	7	0	0
5	41974556	.	C	A	0	3	3	0	2	5	0	0
5	41984305	.	A	G	1	3	4	0	0	4	0	0
5	41997098	.	T	C	3	3	6	0	0	6	0	0
5	41997144	.	G	A	3	2	5	0	0	5	0	0
5	41997146	.	A	T	3	2	5	0	0	5	0	0
5	41997446	.	C	A	1	2	3	0	0	3	0	0
5	42028974	.	C	T	2	5	7	0	0	7	0	0
5	42053465	.	G	C	1	2	3	0	0	3	0	0
5	42054025	.	T	A	1	2	3	0	0	3	0	0
5	42064204	.	T	G	9	4	13	0	0	13	0	0
5	42066958	.	C	T	16	10	26	13	0	39	0	0
5	42067588	.	G	A	16	8	24	24	3	51	0	0
5	42094464	.	C	A	1	2	3	2	0	5	0	0
5	42122838	.	G	A	2	2	4	0	0	4	0	0
5	42122907	.	C	T	8	8	16	0	0	16	0	0
5	42122914	.	C	T	9	11	20	0	0	20	0	0
5	42123023	.	C	T	22	12	34	0	1	35	0	0
5	42123125	.	C	T	25	14	39	0	4	43	0	0
5	42123375	.	C	A	18	10	28	0	0	28	0	0
5	42123664	.	A	G	9	16	25	0	3	28	0	0
5	42123697	.	G	C	17	13	30	0	0	30	0	0
5	42123766	.	G	T	8	7	15	0	1	16	0	0
5	42362191	.	A	G	1	2	3	0	0	3	0	0
5	42362197	.	A	G	1	2	3	1	0	4	0	0
5	43872987	.	T	C	1	2	3	0	0	3	0	0
5	44262893	.	C	T	5	2	7	0	0	7	0	0
5	44795297	.	A	G	10	0	10	0	19	29	0	0
5	44795308	.	A	G	12	15	27	0	2	29	0	0
5	45183470	.	G	A	2	6	8	0	0	8	0	0
5	45204118	.	C	T	6	6	12	0	2	14	0	0
5	45204175	.	G	A	4	3	7	0	0	7	0	0
5	45224048	.	C	T	4	11	15	0	2	17	0	0
5	45224396	.	A	G	4	5	9	0	0	9	0	0
5	45230659	.	C	A	9	4	13	0	0	13	0	0
5	45261926	.	C	T	13	10	23	0	2	25	0	0
5	45269380	.	A	G	12	13	25	0	0	25	0	0
5	45269386	.	A	G	12	15	27	0	0	27	0	0
5	45272009	.	A	G	17	0	17	0	14	31	0	0
5	45272056	.	C	T	12	13	25	0	1	26	0	0
5	45272068	.	G	A	12	16	28	0	0	28	0	0
5	45274486	.	C	T	8	14	22	0	2	24	0	0
5	45283046	.	G	T	5	5	10	0	0	10	0	0
5	45283074	.	G	A	0	5	5	0	5	10	0	0
5	45283117	.	A	C	6	6	12	0	2	14	0	0
5	45283165	.	C	T	2	4	6	0	0	6	0	0
5	45283274	.	T	C	6	8	14	0	1	15	0	0
5	45283284	.	T	C	5	8	13	0	1	14	0	0
5	45283365	.	G	A	9	10	19	0	1	20	0	0
5	45613282	.	A	G	4	2	6	0	0	6	0	0
5	45747455	.	C	T	12	8	20	0	0	20	0	0
5	45747475	.	C	T	2	9	11	0	6	17	0	0
5	45747647	.	A	G	7	5	12	0	0	12	0	0
5	45747924	.	A	T	4	2	6	0	0	6	0	0
5	45748339	.	T	G	9	6	15	0	0	15	0	0
5	45754818	.	C	T	6	3	9	0	0	9	0	0
5	45754851	.	A	G	5	7	12	0	1	13	0	0
5	45754899	.	G	A	5	7	12	0	0	12	0	0
5	45757617	.	A	G	2	5	7	0	0	7	0	0
5	45890036	.	A	T	9	7	16	0	0	16	0	0
5	45890086	.	A	T	8	7	15	0	0	15	0	0
5	45890087	.	A	T	7	8	15	0	0	15	0	0
5	45890159	.	A	G	2	3	5	0	0	5	0	0
5	45890195	.	A	G	3	6	9	0	1	10	0	0
5	45890219	.	A	T	4	8	12	0	0	12	0	0
5	45890625	.	C	T	11	11	22	0	0	22	0	0
5	45890908	.	C	T	1	9	10	0	11	21	0	0
5	45890915	.	C	T	10	8	18	0	2	20	0	0
5	45891074	.	A	G	7	9	16	0	0	16	0	0
5	45891090	.	A	G	9	8	17	0	0	17	0	0
5	45891147	.	T	A	9	11	20	0	2	22	0	0
5	45891226	.	T	A	11	13	24	0	0	24	0	0
5	45891327	.	G	T	13	8	21	0	0	21	0	0
5	45892671	.	C	A	11	5	16	1	0	17	0	0
5	45894699	.	C	T	12	9	21	0	0	21	0	0
5	45894720	.	T	C	12	10	22	0	0	22	0	0
5	45894737	.	T	C	10	12	22	0	1	23	0	0
5	45900422	.	T	G	3	2	5	0	0	5	0	0
5	45904764	.	C	A	1	4	5	0	0	5	0	0
5	45990216	.	C	T	6	6	12	0	0	12	0	0
5	45990252	.	C	T	3	3	6	0	0	6	0	0
5	45990372	.	G	A	2	3	5	0	0	5	0	0
5	45990426	.	C	T	0	6	6	0	1	7	0	0
5	46064330	.	G	T	1	3	4	0	1	5	0	0
5	46066228	.	A	G	3	0	3	0	3	6	0	0
5	46209051	.	G	T	3	10	13	0	0	13	0	0
5	46242156	.	C	T	4	3	7	0	0	7	0	0
5	46327798	.	G	T	4	6	10	0	0	10	0	0
5	46328476	.	T	C	4	0	4	0	7	11	0	0
5	46328611	.	C	T	2	4	6	0	1	7	0	0
5	46329750	.	C	G	1	4	5	0	5	10	0	0
5	46491126	.	G	T	1	2	3	0	0	3	0	0
5	46659285	.	T	G	26	15	41	0	1	42	0	0
5	46659401	.	A	G	20	24	44	0	1	45	0	0
5	46659666	.	T	A	27	16	43	0	5	48	0	0
5	46659707	.	C	A	26	32	58	0	0	58	0	0
5	46659861	.	G	A	10	16	26	0	7	33	0	0
5	46659950	.	C	T	24	16	40	0	1	41	0	0
5	46659985	.	A	G	23	27	50	0	0	50	0	0
5	46660068	.	C	T	18	20	38	0	0	38	0	0
5	46660116	.	C	T	14	23	37	0	1	38	0	0
5	46660120	.	A	G	22	13	35	0	3	38	0	0
5	46660162	.	C	G	16	19	35	0	1	36	0	0
5	46660600	.	T	A	13	19	32	3	1	36	0	0
5	46660672	.	G	A	18	22	40	1	1	42	0	0
5	46660940	.	G	A	18	22	40	1	1	42	0	0
5	46660941	.	A	T	22	17	39	0	1	40	0	0
5	46661073	.	G	A	15	9	24	0	0	24	0	0
5	46661168	.	T	A	6	9	15	0	1	16	0	0
5	46661213	.	A	G	12	10	22	0	1	23	0	0
5	46661240	.	A	G	15	14	29	0	1	30	0	0
5	46661423	.	T	C	28	2	30	0	21	51	0	0
5	46661519	.	C	T	17	13	30	0	1	31	0	0
5	46661678	.	T	A	6	3	9	0	0	9	0	0
5	46662030	.	A	T	16	5	21	1	0	22	0	0
5	46662036	.	A	T	12	4	16	1	0	17	0	0
5	46662184	.	G	T	4	3	7	0	0	7	0	0
5	46662271	.	A	G	9	9	18	0	0	18	0	0
5	46662316	.	A	G	8	12	20	0	0	20	0	0
5	46685872	.	A	G	14	17	31	0	0	31	0	0
5	46724854	.	G	A	12	14	26	0	2	28	0	0
5	46724893	.	G	T	13	13	26	0	0	26	0	0
5	47727760	.	C	T	3	21	24	0	16	40	0	0
5	47932096	.	T	C	2	2	4	0	0	4	0	0
5	47949992	.	G	A	3	6	9	0	2	11	0	0
5	47950082	.	A	C	4	5	9	0	0	9	0	0
5	47950862	.	C	T	5	2	7	0	0	7	0	0
5	47953562	.	G	A	2	5	7	0	0	7	0	0
5	47955833	.	C	A	6	2	8	0	0	8	0	0
5	47959994	.	C	A	1	2	3	0	0	3	0	0
5	47960140	.	T	C	2	2	4	0	0	4	0	0
5	47968970	.	C	T	8	8	16	0	1	17	0	0
5	47970622	.	A	G	10	4	14	0	0	14	0	0
5	47972770	.	T	C	3	0	3	0	3	6	0	0
5	47973386	.	T	G	6	4	10	0	0	10	0	0
5	47975340	.	A	T	2	3	5	0	0	5	0	0
5	47976525	.	C	T	2	3	5	0	0	5	0	0
5	47976728	.	C	G	6	6	12	0	0	12	0	0
5	47976747	.	C	A	8	8	16	0	0	16	0	0
5	47976827	.	A	G	6	6	12	0	2	14	0	0
5	48022757	.	T	C	1	4	5	0	0	5	0	0
5	48023209	.	C	T	2	2	4	0	0	4	0	0
5	48028228	.	A	G	2	3	5	0	1	6	0	0
5	48028338	.	C	A	3	2	5	0	0	5	0	0
5	48028406	.	A	C	7	5	12	0	0	12	0	0
5	48028435	.	G	T	6	10	16	0	0	16	0	0
5	48029494	.	A	C	5	0	5	0	0	6	1	0
5	48029497	.	A	T	6	3	9	0	0	9	0	0
5	48029633	.	C	A	4	7	11	0	0	11	0	0
5	48029667	.	G	A	3	5	8	0	0	8	0	0
5	48029732	.	C	T	1	7	8	0	2	10	0	0
5	48029793	.	C	T	2	7	9	0	3	12	0	0
5	48029805	.	A	C	2	10	12	0	1	13	0	0
5	48029828	.	A	T	3	7	10	0	3	13	0	0
5	48036243	.	C	T	6	2	8	0	1	9	0	0
5	48036246	.	G	C	6	2	8	0	1	9	0	0
5	48050510	.	C	A	2	3	5	0	0	5	0	0
5	48110331	.	G	A	10	8	18	0	1	19	0	0
5	48154436	.	G	A	18	9	27	0	0	27	0	0
5	48154456	.	T	A	17	8	25	0	2	27	0	0
5	48172446	.	C	A	1	5	6	1	7	14	0	0
5	48175515	.	C	T	1	3	4	0	0	4	0	0
5	48182550	.	A	T	8	5	13	0	0	13	0	0
5	48182725	.	T	C	7	8	15	0	0	15	0	0
5	48183577	.	C	T	3	10	13	0	13	26	0	0
5	48183579	.	A	G	12	12	24	0	0	24	0	0
5	48183628	.	T	C	8	0	8	0	12	20	0	0
5	48208539	.	G	A	5	9	14	0	1	15	0	0
5	48208572	.	G	A	6	6	12	0	0	12	0	0
5	48242529	.	T	G	7	5	12	0	0	12	0	0
5	48242610	.	G	A	5	2	7	0	0	7	0	0
5	48285619	.	C	T	5	6	11	0	0	11	0	0
5	48285709	.	G	C	3	2	5	0	0	5	0	0
5	48664229	.	T	C	2	5	7	0	0	7	0	0
5	48672740	.	G	A	5	6	11	0	0	11	0	0
5	48672925	.	A	T	2	4	6	0	0	6	0	0
5	48673501	.	A	G	12	8	20	0	0	20	0	0
5	48673639	.	C	A	0	11	11	0	3	14	0	0
5	48673720	.	A	G	3	5	8	0	0	8	0	0
5	48679320	.	A	G	7	2	9	0	0	9	0	0
5	48679428	.	A	T	7	2	9	0	1	10	0	0
5	48679482	.	A	T	4	5	9	0	0	9	0	0
5	48832593	.	C	A	2	2	4	0	0	4	0	0
5	48841813	.	T	C	2	2	4	0	0	4	0	0
5	48841822	.	T	C	1	2	3	0	1	4	0	0
5	48899697	.	C	G	0	0	0	0	4	4	0	0
5	48899724	.	G	A	1	3	4	0	3	7	0	0
5	48935981	.	C	T	2	2	4	0	0	4	0	0
5	48986109	.	G	A	7	9	16	0	1	17	0	0
5	48986405	.	T	A	16	9	25	1	0	26	0	0
5	48986410	.	G	T	16	10	26	1	0	27	0	0
5	48986565	.	A	G	8	20	28	0	1	29	0	0
5	48986626	.	A	T	12	19	31	0	0	31	0	0
5	48986939	.	C	T	20	14	34	0	0	34	0	0
5	48987007	.	A	T	16	11	27	0	0	27	0	0
5	48987199	.	C	T	10	10	20	0	1	21	0	0
5	48987356	.	G	T	10	11	21	0	0	21	0	0
5	48987920	.	T	C	9	12	21	0	2	23	0	0
5	48988051	.	C	T	0	16	16	0	8	24	0	0
5	48988084	.	A	G	13	6	19	0	1	20	0	0
5	48992401	.	T	C	9	0	9	0	9	18	0	0
5	48992972	.	C	T	1	5	6	0	9	15	0	0
5	48993345	.	T	C	2	9	11	0	0	11	0	0
5	48995559	.	A	T	7	9	16	0	0	16	0	0
5	48995613	.	A	G	7	14	21	0	2	23	0	0
5	48995637	.	A	T	10	12	22	0	1	23	0	0
5	48995860	.	A	G	3	2	5	0	1	6	0	0
5	48995884	.	G	A	11	8	19	0	0	19	0	0
5	48995945	.	G	A	8	5	13	0	0	13	0	0
5	49019495	.	A	T	1	2	3	0	0	3	0	0
5	49019528	.	T	C	3	2	5	0	1	6	0	0
5	49019744	.	A	T	3	4	7	1	1	9	0	0
5	49019746	.	C	A	4	4	8	1	0	9	0	0
5	49019798	.	A	T	2	2	4	0	0	4	0	0
5	49020054	.	G	A	4	2	6	0	0	6	0	0
5	49020066	.	A	T	4	2	6	0	0	6	0	0
5	49021535	.	G	T	2	2	4	0	0	4	0	0
5	49021567	.	T	C	1	3	4	0	1	5	0	0
5	49021573	.	A	G	2	3	5	0	0	5	0	0
5	49028707	.	G	T	2	2	4	0	0	4	0	0
5	49734581	.	C	T	10	9	19	0	1	20	0	0
5	49734889	.	C	T	8	2	10	0	0	10	0	0
5	49735022	.	G	T	6	2	8	0	0	8	0	0
5	49735135	.	C	A	5	4	9	0	0	9	0	0
5	49735169	.	A	T	5	6	11	0	0	11	0	0
5	49735453	.	T	C	1	4	5	0	0	5	0	0
5	49735942	.	T	G	9	7	16	0	0	16	0	0
5	49743020	.	A	T	11	5	16	0	1	17	0	0
5	49745130	.	T	A	11	6	17	0	1	18	0	0
5	49747271	.	G	T	1	18	19	0	16	35	0	0
5	49750765	.	C	T	11	13	24	0	1	25	0	0
5	49750796	.	A	C	9	11	20	0	1	21	0	0
5	49768324	.	G	T	4	4	8	0	0	8	0	0
5	49768341	.	T	C	4	3	7	0	0	7	0	0
5	49768429	.	A	T	2	2	4	0	0	4	0	0
5	49768467	.	T	C	1	3	4	0	0	4	0	0
5	49769217	.	A	G	2	4	6	0	0	6	0	0
5	49769485	.	A	G	5	4	9	0	0	9	0	0
5	49769711	.	C	G	5	4	9	0	0	9	0	0
5	49773772	.	G	A	1	2	3	0	2	5	0	0
5	49773801	.	A	T	1	3	4	0	0	4	0	0
5	49919762	.	G	A	2	1	3	0	1	4	0	0
5	50081817	.	A	C	5	0	5	0	3	8	0	0
5	50085012	.	A	C	1	1	2	0	1	3	0	0
5	50085014	.	T	G	1	2	3	0	0	3	0	0
5	50086548	.	A	C	1	2	3	0	0	3	0	0
5	50086549	.	T	C	1	2	3	0	0	3	0	0
5	50256257	.	C	T	2	5	7	0	0	7	0	0
5	50296657	.	C	T	2	4	6	0	0	6	0	0
5	50435897	.	G	A	3	4	7	0	0	7	0	0
5	50436028	.	C	T	2	4	6	0	0	6	0	0
5	50436069	.	C	T	2	5	7	0	1	8	0	0
5	50436127	.	C	T	8	4	12	0	0	12	0	0
5	50436175	.	C	G	3	0	3	0	5	8	0	0
5	50436354	.	G	A	4	3	7	0	0	7	0	0
5	50436359	.	G	T	3	3	6	0	0	6	0	0
5	50443077	.	T	C	10	15	25	0	5	30	0	0
5	50443184	.	A	G	19	10	29	0	2	31	0	0
5	50443211	.	C	A	11	13	24	0	2	26	0	0
5	50443399	.	G	C	22	8	30	0	1	31	0	0
5	50443418	.	T	A	15	21	36	0	2	38	0	0
5	50443466	.	A	G	15	14	29	0	1	30	0	0
5	50443837	.	G	A	5	5	10	0	0	10	0	0
5	50443868	.	T	G	4	6	10	0	0	10	0	0
5	50444519	.	A	T	1	3	4	0	0	4	0	0
5	50444521	.	T	A	1	3	4	0	0	4	0	0
5	50465188	.	C	T	1	12	13	0	8	21	0	0
5	50465649	.	G	A	5	3	8	0	0	8	0	0
5	50520009	.	G	A	10	6	16	0	1	17	0	0
5	50544107	.	G	C	2	2	4	0	0	4	0	0
5	50544227	.	G	A	4	3	7	0	1	8	0	0
5	50544281	.	T	C	3	5	8	0	2	10	0	0
5	50576699	.	G	A	8	4	12	0	1	13	0	0
5	50576705	.	A	G	2	9	11	0	0	11	0	0
5	50582271	.	G	A	4	5	9	0	0	9	0	0
5	50582482	.	T	G	3	7	10	0	0	10	0	0
5	50582594	.	A	G	5	3	8	0	0	8	0	0
5	50594268	.	C	T	0	4	4	0	2	6	0	0
5	50594298	.	G	C	3	0	3	0	3	6	0	0
5	50636066	.	C	T	0	4	4	0	4	8	0	0
5	50781108	.	G	A	2	5	7	0	2	9	0	0
5	50817403	.	C	T	2	7	9	0	2	11	0	0
5	50817414	.	C	T	2	8	10	0	0	10	0	0
5	50819811	.	G	A	1	10	11	0	1	12	0	0
5	50820988	.	A	G	1	3	4	0	0	4	0	0
5	50821047	.	T	C	3	3	6	0	0	6	0	0
5	50821075	.	A	T	3	3	6	0	0	6	0	0
5	50831444	.	T	A	2	5	7	0	0	8	1	0
5	50837467	.	C	T	2	2	4	0	0	4	0	0
5	50839022	.	T	C	2	0	2	0	3	5	0	0
5	50840669	.	G	T	3	5	8	0	1	9	0	0
5	50840893	.	A	G	1	3	4	0	0	4	0	0
5	50843374	.	G	T	1	3	4	0	1	5	0	0
5	50843399	.	C	T	0	2	2	0	1	3	0	0
5	50856945	.	G	A	0	3	3	0	1	4	0	0
5	50867810	.	C	T	0	2	2	0	1	3	0	0
5	50869887	.	T	G	5	1	6	0	1	7	0	0
5	50871801	.	G	T	1	2	3	0	1	4	0	0
5	50872448	.	C	A	2	3	5	0	0	5	0	0
5	50872460	.	A	G	1	2	3	0	1	4	0	0
5	50874881	.	G	T	3	2	5	0	0	5	0	0
5	50881136	.	T	C	4	2	6	0	0	6	0	0
5	50886309	.	C	T	1	3	4	0	0	4	0	0
5	50889675	.	T	G	3	2	5	0	0	5	0	0
5	50889714	.	G	A	3	2	5	0	1	6	0	0
5	50892968	.	T	A	5	3	8	0	0	8	0	0
5	50895544	.	C	T	5	8	13	0	0	13	0	0
5	50895606	.	C	T	1	2	3	0	0	3	0	0
5	50897465	.	G	T	3	3	6	0	7	13	0	0
5	50897585	.	C	T	3	3	6	0	1	7	0	0
5	50897630	.	A	G	2	2	4	0	0	4	0	0
5	50949156	.	T	C	2	3	5	0	0	5	0	0
5	50949712	.	A	T	1	2	3	0	0	3	0	0
5	50953383	.	C	A	1	3	4	0	0	4	0	0
5	50963250	.	C	G	4	4	8	0	1	9	0	0
5	50969971	.	G	T	0	2	2	0	2	4	0	0
5	50969974	.	C	G	2	2	4	0	0	4	0	0
5	50970198	.	C	G	1	0	1	0	2	3	0	0
5	50973357	.	T	A	1	3	4	0	0	4	0	0
5	50973471	.	C	G	6	3	9	0	0	9	0	0
5	50973518	.	A	C	9	9	18	0	0	18	0	0
5	50973625	.	A	T	3	7	10	0	0	10	0	0
5	50973669	.	C	T	0	5	5	0	3	8	0	0
5	50973748	.	C	T	4	7	11	0	0	11	0	0
5	50978920	.	G	C	4	5	9	0	0	9	0	0
5	50981198	.	G	A	2	2	4	0	0	4	0	0
5	50981201	.	C	T	2	2	4	0	0	4	0	0
5	50983029	.	G	A	3	2	5	0	0	5	0	0
5	50991314	.	G	A	1	2	3	0	0	3	0	0
5	51102462	.	A	G	1	2	3	0	0	3	0	0
5	51102474	.	G	A	1	2	3	0	0	3	0	0
5	51102602	.	T	G	1	2	3	0	0	3	0	0
5	51102641	.	T	C	1	4	5	0	0	5	0	0
5	51102947	.	C	A	1	1	2	0	1	3	0	0
5	51103006	.	T	C	3	3	6	0	0	6	0	0
5	51103007	.	T	C	3	2	5	0	0	5	0	0
5	51103318	.	G	A	2	3	5	0	0	5	0	0
5	51103411	.	G	A	2	3	5	0	1	6	0	0
5	51103550	.	G	A	2	4	6	0	0	6	0	0
5	51103689	.	A	C	3	7	10	0	0	10	0	0
5	51103904	.	A	T	1	2	3	0	1	4	0	0
5	51103944	.	A	T	4	3	7	0	0	7	0	0
5	51104010	.	G	A	2	3	5	0	0	5	0	0
5	51104031	.	G	A	1	4	5	0	2	7	0	0
5	51104050	.	T	G	1	5	6	0	1	7	0	0
5	51104070	.	A	G	0	6	6	0	0	6	0	0
5	51111786	.	G	A	1	2	3	0	0	3	0	0
5	51117800	.	G	A	1	2	3	0	0	3	0	0
5	51117810	.	C	T	1	3	4	0	0	4	0	0
5	51121295	.	G	A	3	7	10	0	0	10	0	0
5	51124803	.	A	G	1	4	5	0	1	6	0	0
5	51169376	.	T	C	2	0	2	0	4	6	0	0
5	51169545	.	C	T	1	8	9	0	0	9	0	0
5	51169732	.	G	A	3	3	6	0	0	6	0	0
5	51170113	.	G	A	1	2	3	0	0	3	0	0
5	51170171	.	T	C	2	4	6	0	0	6	0	0
5	51170264	.	A	G	5	2	7	0	0	7	0	0
5	51170577	.	G	A	1	4	5	0	0	5	0	0
5	51170595	.	A	G	2	3	5	0	0	5	0	0
5	51200506	.	A	G	7	4	11	0	0	11	0	0
5	51200697	.	G	A	5	4	9	1	1	11	0	0
5	51202374	.	T	A	2	5	7	0	0	7	0	0
5	51202938	.	G	A	6	6	12	0	0	12	0	0
5	51203146	.	C	T	8	4	12	0	0	12	0	0
5	51205439	.	G	T	1	3	4	0	0	4	0	0
5	51205593	.	G	A	4	2	6	0	0	6	0	0
5	51208565	.	G	A	3	3	6	0	1	7	0	0
5	51208586	.	C	A	0	3	3	0	5	8	0	0
5	51208839	.	A	G	2	2	4	0	0	4	0	0
5	51227011	.	T	A	2	6	8	0	0	8	0	0
5	51227197	.	C	T	8	4	12	0	0	12	0	0
5	51228935	.	G	A	3	5	8	0	0	8	0	0
5	51230665	.	C	G	4	3	7	0	1	8	0	0
5	51230901	.	T	C	2	3	5	0	0	5	0	0
5	51236528	.	A	G	2	6	8	0	0	8	0	0
5	51240588	.	T	C	2	2	4	0	0	4	0	0
5	51240679	.	A	G	5	3	8	0	0	8	0	0
5	51240830	.	T	C	7	7	14	0	0	14	0	0
5	51240936	.	A	G	7	3	10	0	0	10	0	0
5	51241023	.	A	G	3	9	12	0	0	12	0	0
5	51241083	.	T	A	0	9	9	0	1	10	0	0
5	51241095	.	C	T	2	7	9	0	0	9	0	0
5	51242020	.	C	T	2	5	7	0	0	7	0	0
5	51242684	.	A	G	1	3	4	0	1	5	0	0
5	51242882	.	A	G	9	9	18	0	0	18	0	0
5	51242904	.	C	T	9	8	17	0	0	17	0	0
5	51243006	.	T	A	8	7	15	0	0	15	0	0
5	51243068	.	A	G	12	11	23	0	0	23	0	0
5	51243085	.	C	A	10	6	16	0	2	18	0	0
5	51243157	.	T	A	8	7	15	0	0	15	0	0
5	51243243	.	C	T	6	3	9	0	0	9	0	0
5	51243287	.	G	A	4	3	7	0	0	7	0	0
5	51243341	.	G	A	7	3	10	0	0	10	0	0
5	51243635	.	C	T	5	6	11	0	0	11	0	0
5	51243645	.	A	T	4	6	10	0	0	10	0	0
5	51243680	.	T	G	9	6	15	0	0	15	0	0
5	51243706	.	C	T	8	12	20	0	2	22	0	0
5	51438782	.	T	C	1	2	3	0	0	3	0	0
5	51546541	.	C	T	1	2	3	0	0	3	0	0
5	51548092	.	C	T	6	3	9	0	0	9	0	0
5	51548107	.	A	G	3	0	3	0	5	8	0	0
5	51575756	.	C	T	2	3	5	0	0	5	0	0
5	51578289	.	A	G	1	0	1	0	4	5	0	0
5	51579025	.	G	A	0	3	3	0	4	7	0	0
5	51579076	.	C	T	3	4	7	0	0	7	0	0
5	51616474	.	A	T	6	3	9	0	0	9	0	0
5	51616580	.	A	T	3	2	5	0	0	5	0	0
5	51616704	.	C	G	10	5	15	0	1	16	0	0
5	51616959	.	G	A	4	11	15	0	0	15	0	0
5	51775190	.	C	T	8	5	13	0	1	14	0	0
5	51775291	.	A	T	17	21	38	0	1	39	0	0
5	51775364	.	A	T	10	25	35	0	0	35	0	0
5	51775458	.	A	C	27	13	40	0	0	40	0	0
5	51775501	.	T	G	24	10	34	0	2	36	0	0
5	51775642	.	T	A	21	15	36	0	1	37	0	0
5	51775962	.	G	T	25	11	36	0	2	38	0	0
5	51776150	.	C	A	14	19	33	0	0	33	0	0
5	51779513	.	C	T	18	17	35	0	1	36	0	0
5	51789180	.	C	T	0	7	7	0	4	11	0	0
5	51792974	.	G	A	17	12	29	0	1	30	0	0
5	51834217	.	C	A	1	2	3	0	2	5	0	0
5	51835634	.	C	T	3	5	8	0	0	8	0	0
5	51836211	.	T	A	2	3	5	0	0	5	0	0
5	51840942	.	C	T	5	5	10	0	0	10	0	0
5	51846285	.	C	A	5	5	10	0	1	11	0	0
5	51847274	.	T	C	11	5	16	0	0	16	0	0
5	51847429	.	T	C	5	2	7	0	0	7	0	0
5	51847675	.	C	G	3	5	8	0	0	8	0	0
5	51886188	.	A	C	13	10	23	0	1	24	0	0
5	51894040	.	T	C	4	11	15	0	1	16	0	0
5	51898796	.	C	T	2	6	8	0	6	14	0	0
5	51898933	.	C	G	1	3	4	0	1	5	0	0
5	51902067	.	T	G	3	6	9	0	0	9	0	0
5	51902253	.	A	G	5	3	8	0	0	8	0	0
5	51935095	.	C	T	1	4	5	0	0	5	0	0
5	51947370	.	G	T	6	5	11	0	0	11	0	0
5	51947398	.	C	T	0	8	8	0	11	19	0	0
5	51947497	.	C	T	14	11	25	0	0	25	0	0
5	51947650	.	T	C	3	5	8	0	1	9	0	0
5	51947696	.	A	T	7	6	13	0	0	13	0	0
5	51947852	.	A	T	7	6	13	0	1	14	0	0
5	51947927	.	T	C	8	3	11	0	4	15	0	0
5	51947976	.	C	G	6	3	9	0	1	10	0	0
5	51948017	.	G	T	7	6	13	0	0	13	0	0
5	51948146	.	G	A	11	14	25	0	0	25	0	0
5	51948207	.	T	C	7	7	14	0	0	14	0	0
5	51948565	.	A	T	1	3	4	0	0	4	0	0
5	51948671	.	C	A	0	2	2	0	1	3	0	0
5	51948708	.	A	T	4	3	7	0	0	7	0	0
5	51948737	.	C	T	1	4	5	0	3	8	0	0
5	51948755	.	C	A	4	4	8	0	0	8	0	0
5	51948825	.	T	C	4	8	12	0	0	12	0	0
5	51948827	.	C	G	8	4	12	0	1	13	0	0
5	51948870	.	A	G	9	8	17	0	1	18	0	0
5	51949069	.	T	A	13	12	25	0	0	25	0	0
5	51949115	.	G	T	3	4	7	0	1	8	0	0
5	51950032	.	G	C	6	8	14	0	1	15	0	0
5	51950357	.	C	T	0	2	2	0	1	3	0	0
5	51958296	.	T	A	2	2	4	0	0	4	0	0
5	51960989	.	G	A	2	2	4	0	2	6	0	0
5	52002660	.	T	G	3	6	9	0	0	9	0	0
5	52002708	.	T	C	3	6	9	0	0	9	0	0
5	52002743	.	T	G	5	4	9	0	1	10	0	0
5	52005851	.	G	T	14	10	24	0	0	24	0	0
5	52005893	.	C	T	6	7	13	0	0	13	0	0
5	52007700	.	C	T	5	4	9	0	0	9	0	0
5	52068422	.	C	T	4	2	6	0	1	7	0	0
5	52121557	.	T	C	4	4	8	0	0	8	0	0
5	52121629	.	G	A	3	3	6	0	0	6	0	0
5	52121801	.	G	C	2	3	5	0	0	5	0	0
5	52122057	.	C	G	6	0	6	0	4	10	0	0
5	52123640	.	G	T	6	5	11	0	0	11	0	0
5	52124734	.	A	G	9	5	14	0	2	16	0	0
5	52132468	.	G	A	14	4	18	0	1	19	0	0
5	52132498	.	A	T	12	8	20	0	0	20	0	0
5	52132561	.	C	T	9	10	19	0	1	20	0	0
5	52132966	.	A	G	3	4	7	0	0	7	0	0
5	52191185	.	G	T	2	3	5	0	1	6	0	0
5	52192545	.	T	A	1	5	6	0	0	6	0	0
5	52192668	.	C	T	0	2	2	0	1	3	0	0
5	52192704	.	T	C	3	0	3	0	8	11	0	0
5	52193066	.	C	T	6	3	9	0	2	11	0	0
5	52193249	.	T	G	5	3	8	0	2	10	0	0
5	52193817	.	A	G	5	2	7	0	0	7	0	0
5	52197793	.	C	T	3	3	6	0	0	6	0	0
5	52198066	.	G	A	3	2	5	0	0	5	0	0
5	52199622	.	C	T	3	3	6	0	0	6	0	0
5	52215405	.	T	A	1	2	3	0	0	3	0	0
5	52227090	.	T	A	8	6	14	0	1	15	0	0
5	52227190	.	T	A	8	8	16	0	0	16	0	0
5	52227393	.	T	C	8	2	10	0	0	10	0	0
5	52234708	.	A	G	2	6	8	0	0	8	0	0
5	52236775	.	G	T	3	2	5	0	0	5	0	0
5	52237001	.	T	G	1	6	7	0	0	7	0	0
5	52237028	.	C	T	2	4	6	0	1	7	0	0
5	52237039	.	G	A	2	5	7	0	0	7	0	0
5	52237263	.	T	C	1	1	2	0	5	7	0	0
5	52257106	.	A	C	9	0	9	4	5	18	0	0
5	52257299	.	G	A	9	10	19	0	0	19	0	0
5	52257976	.	G	T	13	11	24	0	0	24	0	0
5	52258036	.	G	A	7	9	16	0	2	18	0	0
5	52258234	.	G	A	8	18	26	1	0	27	0	0
5	52258268	.	C	G	7	12	19	2	0	22	1	0
5	52258518	.	C	T	15	11	26	0	1	27	0	0
5	52258614	.	C	A	2	8	10	0	2	12	0	0
5	52258721	.	C	G	5	8	13	0	1	14	0	0
5	52258921	.	T	G	5	7	12	0	0	12	0	0
5	52259221	.	T	A	7	13	20	0	2	22	0	0
5	52259542	.	G	C	10	0	10	0	7	17	0	0
5	52259579	.	A	T	5	5	10	0	0	10	0	0
5	52259825	.	C	A	7	10	17	0	0	17	0	0
5	52264354	.	C	T	0	11	11	0	4	15	0	0
5	52264456	.	C	G	1	5	6	0	9	15	0	0
5	52264512	.	G	A	3	4	7	0	1	8	0	0
5	52264549	.	C	T	6	7	13	0	1	14	0	0
5	52264654	.	C	G	0	7	7	0	11	18	0	0
5	52264663	.	G	A	12	7	19	0	1	20	0	0
5	52277390	.	G	A	3	8	11	0	0	11	0	0
5	52277448	.	A	T	6	4	10	0	0	10	0	0
5	52277487	.	T	A	5	3	8	0	0	8	0	0
5	52277574	.	G	A	11	3	14	0	1	15	0	0
5	52598377	.	C	T	1	3	4	0	1	5	0	0
5	52598563	.	G	A	6	2	8	0	0	8	0	0
5	52608696	.	G	A	2	3	5	1	0	6	0	0
5	52617922	.	A	G	6	6	12	0	1	13	0	0
5	52697519	.	A	C	7	6	13	0	1	14	0	0
5	52698067	.	G	A	5	6	11	0	1	12	0	0
5	52710951	.	A	G	2	3	5	0	1	6	0	0
5	52710957	.	G	A	3	4	7	0	0	7	0	0
5	52725675	.	C	T	2	4	6	0	0	6	0	0
5	52730540	.	C	T	9	6	15	0	0	15	0	0
5	52730645	.	C	T	9	5	14	0	0	14	0	0
5	52730742	.	G	C	4	6	10	0	2	12	0	0
5	52730988	.	C	G	3	0	3	0	4	7	0	0
5	52731515	.	C	A	11	14	25	0	1	26	0	0
5	52731550	.	C	T	9	6	15	0	1	16	0	0
5	52731647	.	G	A	1	12	13	0	6	19	0	0
5	52731678	.	A	T	8	8	16	0	1	17	0	0
5	52731758	.	G	C	5	9	14	0	3	17	0	0
5	52731787	.	G	A	5	11	16	0	0	16	0	0
5	52731919	.	C	A	7	4	11	0	0	11	0	0
5	52732146	.	C	T	4	10	14	0	1	15	0	0
5	52732147	.	G	A	10	5	15	0	0	15	0	0
5	52732383	.	C	T	13	11	24	0	2	26	0	0
5	52732727	.	G	A	16	8	24	0	3	27	0	0
5	52732931	.	C	T	10	15	25	0	3	28	0	0
5	52732991	.	A	G	14	0	14	0	14	28	0	0
5	52733022	.	G	T	9	15	24	0	0	24	0	0
5	52733230	.	G	A	23	9	32	0	0	32	0	0
5	52733259	.	T	G	20	13	33	0	1	35	1	0
5	52733266	.	T	G	20	16	36	0	1	37	0	0
5	52733370	.	A	T	14	15	29	0	2	31	0	0
5	52733411	.	G	A	11	7	18	0	0	18	0	0
5	52745571	.	T	G	2	6	8	0	1	9	0	0
5	52748724	.	T	C	4	3	7	0	0	7	0	0
5	52751568	.	C	T	1	4	5	0	3	8	0	0
5	52751586	.	C	T	3	2	5	0	1	6	0	0
5	52752441	.	T	A	2	2	4	0	0	4	0	0
5	52752479	.	A	G	3	2	5	0	1	6	0	0
5	52783758	.	C	T	4	4	8	0	0	8	0	0
5	52858898	.	A	G	3	0	3	0	3	6	0	0
5	52859510	.	C	T	4	2	6	1	0	7	0	0
5	52859751	.	G	T	3	6	9	0	0	9	0	0
5	52860243	.	T	A	2	2	4	0	0	4	0	0
5	52860310	.	T	A	1	4	5	0	0	5	0	0
5	52860413	.	G	A	0	5	5	0	3	8	0	0
5	52860503	.	A	T	7	9	16	0	1	17	0	0
5	52860701	.	G	T	8	8	16	0	0	16	0	0
5	52860718	.	G	C	8	8	16	0	2	18	0	0
5	52860863	.	G	T	6	12	18	0	0	18	0	0
5	52861213	.	T	C	2	7	9	0	3	12	0	0
5	52861239	.	G	T	0	7	7	0	5	12	0	0
5	52861266	.	A	C	4	6	10	0	0	10	0	0
5	52861818	.	G	A	9	6	15	1	2	18	0	0
5	52937798	.	A	G	6	5	11	0	0	11	0	0
5	52938528	.	A	G	2	4	6	0	0	6	0	0
5	52938532	.	T	C	2	4	6	0	0	6	0	0
5	52938742	.	C	T	10	6	16	0	1	17	0	0
5	52938787	.	C	A	5	4	9	0	2	11	0	0
5	52939163	.	T	C	6	2	8	0	0	8	0	0
5	52962667	.	T	C	7	0	7	0	4	11	0	0
5	52972260	.	A	G	5	6	11	0	0	11	0	0
5	52972323	.	C	A	5	9	14	0	1	15	0	0
5	52988108	.	C	T	6	5	11	0	3	14	0	0
5	52988147	.	C	T	4	6	10	0	0	10	0	0
5	53003463	.	C	G	0	8	8	0	8	16	0	0
5	53003640	.	C	G	4	5	9	0	0	9	0	0
5	53003896	.	G	A	6	4	10	0	0	10	0	0
5	53003988	.	A	C	7	0	7	0	5	12	0	0
5	53041702	.	T	C	12	3	15	0	0	15	0	0
5	53734556	.	C	T	2	4	6	0	0	6	0	0
5	53748244	.	C	T	5	7	12	0	0	12	0	0
5	53748304	.	T	G	3	2	5	0	0	5	0	0
5	53759491	.	A	T	8	7	15	0	0	15	0	0
5	53762143	.	C	G	2	0	2	3	4	9	0	0
5	53865322	.	T	C	3	2	5	0	0	5	0	0
5	53876236	.	A	T	10	17	27	1	0	28	0	0
5	53876244	.	G	A	11	22	33	1	0	34	0	0
5	53899585	.	G	T	13	7	20	0	1	21	0	0
5	53908957	.	A	T	8	6	14	0	1	15	0	0
5	53909321	.	C	T	6	3	9	0	0	9	0	0
5	53909509	.	G	A	0	3	3	0	1	4	0	0
5	53909914	.	C	T	7	2	9	0	0	9	0	0
5	53910004	.	G	A	5	3	8	0	0	8	0	0
5	54280198	.	A	T	3	4	7	0	0	7	0	0
5	54280223	.	C	T	3	3	6	0	0	6	0	0
5	54280350	.	C	G	3	2	5	0	1	6	0	0
5	54280436	.	A	T	2	3	5	0	0	5	0	0
5	54280678	.	T	C	7	3	10	0	1	11	0	0
5	54280801	.	G	A	8	5	13	0	0	13	0	0
5	54290289	.	C	A	3	9	12	0	1	13	0	0
5	54293907	.	A	T	2	3	5	0	0	5	0	0
5	54297376	.	T	A	4	3	7	0	0	7	0	0
5	54297377	.	C	T	4	3	7	0	0	7	0	0
5	54297461	.	T	G	1	3	4	0	0	4	0	0
5	54297668	.	C	T	4	3	7	0	0	7	0	0
5	54298990	.	A	G	1	2	3	0	2	5	0	0
5	54304666	.	C	G	3	2	5	0	0	5	0	0
5	54305209	.	G	A	8	3	11	0	1	12	0	0
5	54309452	.	G	T	6	4	10	1	0	11	0	0
5	54337575	.	G	A	8	6	14	0	2	16	0	0
5	54337831	.	T	A	8	9	17	0	0	17	0	0
5	54337880	.	T	C	11	0	11	0	8	19	0	0
5	54337902	.	C	T	4	10	14	0	3	17	0	0
5	54337934	.	C	A	10	4	14	0	1	15	0	0
5	54339740	.	C	T	9	8	17	0	0	17	0	0
5	54340047	.	G	A	5	4	9	0	0	9	0	0
5	54342519	.	T	A	3	4	7	0	0	7	0	0
5	54416392	.	G	C	5	3	8	0	0	8	0	0
5	54416411	.	T	C	4	5	9	0	0	9	0	0
5	54416429	.	T	A	2	5	7	0	0	7	0	0
5	54416446	.	T	C	1	3	4	0	1	5	0	0
5	54416810	.	C	T	6	7	13	0	0	13	0	0
5	54416820	.	A	G	5	6	11	0	0	11	0	0
5	54420513	.	A	G	3	2	5	0	0	5	0	0
5	54457983	.	G	A	6	5	11	0	3	14	0	0
5	54458053	.	A	C	4	6	10	0	0	10	0	0
5	54458326	.	G	A	9	14	23	0	0	23	0	0
5	54458345	.	T	A	20	7	27	0	1	28	0	0
5	54458437	.	C	T	7	12	19	0	1	20	0	0
5	54458477	.	C	T	12	7	19	0	1	20	0	0
5	54458668	.	C	A	8	5	13	0	0	13	0	0
5	54458791	.	C	G	2	9	11	0	6	17	0	0
5	54458974	.	C	G	5	7	12	0	0	12	0	0
5	54459086	.	G	T	7	6	13	0	1	14	0	0
5	54459334	.	T	C	6	5	11	0	1	12	0	0
5	54459337	.	T	C	5	6	11	0	0	11	0	0
5	54459467	.	T	C	2	0	2	0	7	9	0	0
5	54459628	.	G	T	7	3	10	0	0	10	0	0
5	54459647	.	A	C	7	5	12	0	0	12	0	0
5	54459682	.	C	T	3	5	8	0	0	8	0	0
5	54459772	.	T	C	3	3	6	0	1	7	0	0
5	54459808	.	A	C	4	3	7	0	0	7	0	0
5	54459814	.	G	A	1	2	3	0	0	3	0	0
5	54460218	.	A	C	4	7	11	0	0	11	0	0
5	54460237	.	T	A	6	9	15	0	0	15	0	0
5	54460259	.	G	A	11	6	17	0	0	17	0	0
5	54460322	.	T	A	4	11	15	0	0	15	0	0
5	54460371	.	T	A	3	13	16	0	1	17	0	0
5	54460460	.	A	G	7	11	18	0	0	18	0	0
5	54460481	.	C	T	0	10	10	0	9	19	0	0
5	54460555	.	G	A	9	10	19	0	2	21	0	0
5	54460558	.	A	T	9	6	15	0	7	22	0	0
5	54467999	.	G	T	2	5	7	0	0	7	0	0
5	54470845	.	C	G	0	3	3	0	4	7	0	0
5	54470912	.	C	G	3	2	5	1	1	7	0	0
5	54473134	.	G	A	6	5	11	0	0	11	0	0
5	54482550	.	G	A	9	7	16	0	0	16	0	0
5	54482561	.	A	C	6	6	12	0	1	13	0	0
5	54482795	.	C	A	4	2	6	0	0	6	0	0
5	54482806	.	C	T	3	2	5	0	0	5	0	0
5	54492839	.	C	T	0	4	4	0	2	6	0	0
5	54493073	.	A	C	2	4	6	0	1	7	0	0
5	54497019	.	G	A	4	3	7	0	1	8	0	0
5	54498226	.	G	C	8	3	11	0	0	11	0	0
5	54498255	.	A	C	7	3	10	0	1	11	0	0
5	54498292	.	C	T	2	6	8	0	0	8	0	0
5	54498363	.	C	T	5	9	14	0	0	14	0	0
5	54498452	.	C	T	10	11	21	0	2	23	0	0
5	54501179	.	C	T	2	7	9	0	6	15	0	0
5	54501993	.	A	G	2	0	2	0	6	8	0	0
5	54502264	.	G	A	6	6	12	0	2	14	0	0
5	54502307	.	G	A	1	8	9	0	7	16	0	0
5	54502414	.	G	C	11	6	17	0	0	17	0	0
5	54502697	.	A	G	3	0	3	0	4	7	0	0
5	54541975	.	C	A	3	5	8	0	0	8	0	0
5	54552033	.	A	C	3	4	7	0	0	7	0	0
5	54555593	.	A	G	2	3	5	0	0	5	0	0
5	54558738	.	A	C	1	3	4	0	0	4	0	0
5	54564682	.	C	T	2	4	6	0	0	6	0	0
5	54564835	.	C	T	4	6	10	0	0	10	0	0
5	54572859	.	T	A	2	2	4	0	1	5	0	0
5	54576223	.	C	T	7	6	13	0	1	14	0	0
5	54576238	.	G	A	4	9	13	0	0	13	0	0
5	54576562	.	G	T	1	3	4	0	3	7	0	0
5	54579900	.	A	C	3	6	9	0	0	9	0	0
5	54580125	.	G	A	3	6	9	0	0	9	0	0
5	54585600	.	C	T	1	2	3	0	0	3	0	0
5	54610737	.	G	A	0	2	2	0	3	5	0	0
5	54618404	.	G	A	1	2	3	0	0	3	0	0
5	54624856	.	T	C	1	2	3	0	1	4	0	0
5	54652941	.	T	A	8	10	18	0	0	18	0	0
5	54652947	.	C	A	9	7	16	0	1	17	0	0
5	54656583	.	A	G	9	0	9	0	7	16	0	0
5	54656613	.	T	C	7	5	12	0	0	12	0	0
5	54685371	.	A	T	7	21	28	0	0	28	0	0
5	54685445	.	C	A	15	14	29	0	0	29	0	0
5	54719503	.	A	G	9	10	19	0	0	19	0	0
5	54719844	.	G	A	12	9	21	0	1	22	0	0
5	54720249	.	C	T	5	2	7	0	3	10	0	0
5	54724444	.	A	T	2	6	8	0	1	9	0	0
5	54767361	.	C	A	14	5	19	0	0	19	0	0
5	54767688	.	C	T	20	19	39	0	1	40	0	0
5	54767734	.	T	A	19	19	38	0	1	39	0	0
5	54768993	.	G	T	17	16	33	0	1	34	0	0
5	54769091	.	A	G	10	8	18	0	2	20	0	0
5	54769133	.	A	G	15	5	20	0	0	20	0	0
5	54769896	.	A	G	13	13	26	0	1	27	0	0
5	54769914	.	C	T	16	11	27	0	0	27	0	0
5	54770121	.	T	C	17	21	38	0	1	39	0	0
5	54770370	.	G	A	17	16	33	0	0	33	0	0
5	54770889	.	C	T	17	19	36	0	0	36	0	0
5	54772818	.	G	A	4	5	9	0	0	9	0	0
5	54772955	.	T	C	5	2	7	0	0	7	0	0
5	54773182	.	C	A	1	7	8	0	8	16	0	0
5	54776408	.	T	C	7	6	13	0	0	13	0	0
5	54776413	.	G	C	6	8	14	0	0	14	0	0
5	54778115	.	G	C	6	3	9	0	1	10	0	0
5	54790513	.	T	C	4	2	6	0	0	6	0	0
5	54790751	.	A	C	5	5	10	0	1	11	0	0
5	54790808	.	T	G	5	5	10	0	2	12	0	0
5	54958580	.	G	A	7	11	18	0	0	18	0	0
5	54961109	.	A	G	6	4	10	0	3	13	0	0
5	54964633	.	G	A	6	5	11	0	1	12	0	0
5	54965991	.	G	A	1	5	6	0	1	7	0	0
5	54966114	.	C	A	2	5	7	0	1	8	0	0
5	54971774	.	G	C	3	7	10	0	0	10	0	0
5	54974350	.	A	G	3	8	11	0	0	11	0	0
5	54982520	.	G	A	3	4	7	0	0	7	0	0
5	55160572	.	G	A	2	12	14	0	0	14	0	0
5	55160685	.	C	T	12	8	20	0	0	20	0	0
5	55165175	.	A	T	13	10	23	0	1	24	0	0
5	55168177	.	G	T	13	21	34	0	1	35	0	0
5	55200982	.	C	T	4	4	8	0	0	8	0	0
5	55371908	.	C	T	4	9	13	0	0	13	0	0
5	55372218	.	A	G	27	10	37	0	1	38	0	0
5	55372425	.	A	C	22	15	37	0	0	37	0	0
5	55372773	.	A	T	4	12	16	0	0	16	0	0
5	55373299	.	G	A	18	17	35	0	0	35	0	0
5	55373869	.	G	T	7	10	17	0	0	17	0	0
5	55374343	.	T	A	7	13	20	0	1	21	0	0
5	55374560	.	T	C	6	7	13	0	1	14	0	0
5	55588458	.	T	C	9	6	15	0	0	15	0	0
5	55588562	.	T	C	7	13	20	0	0	20	0	0
5	55599950	.	G	C	9	5	14	0	1	15	0	0
5	55600108	.	A	C	10	6	16	0	1	17	0	0
5	55600149	.	T	C	7	8	15	0	1	16	0	0
5	55600154	.	A	G	10	8	18	0	0	18	0	0
5	55600657	.	C	T	2	2	4	0	1	5	0	0
5	55604037	.	G	C	17	6	23	0	0	23	0	0
5	55604162	.	G	C	13	15	28	0	4	32	0	0
5	55604211	.	A	T	24	8	32	1	0	33	0	0
5	55604228	.	G	T	16	11	27	1	2	31	1	0
5	55604302	.	A	T	27	1	28	1	0	29	0	0
5	55604392	.	T	A	7	9	16	0	10	26	0	0
5	55604438	.	A	G	14	19	33	0	2	35	0	0
5	55609426	.	T	G	17	20	37	0	2	39	0	0
5	55613789	.	G	A	15	12	27	0	1	28	0	0
5	55613813	.	A	C	17	10	27	0	0	27	0	0
5	55613864	.	A	G	20	10	30	0	0	30	0	0
5	55613999	.	G	A	18	13	31	0	0	31	0	0
5	55626700	.	T	A	3	3	6	0	0	6	0	0
5	55669528	.	C	T	5	3	8	0	0	8	0	0
5	55674606	.	A	G	5	3	8	0	0	8	0	0
5	55686574	.	T	C	3	4	7	0	0	7	0	0
5	55689628	.	C	T	4	5	9	0	0	9	0	0
5	55720486	.	C	T	0	13	13	0	7	20	0	0
5	55723534	.	A	G	7	7	14	0	2	16	0	0
5	55763649	.	A	G	23	25	48	0	0	48	0	0
5	55763752	.	G	T	27	20	47	0	2	49	0	0
5	55763884	.	G	A	26	26	52	0	3	55	0	0
5	55764173	.	T	C	7	1	8	0	14	22	0	0
5	55764509	.	G	A	19	26	45	0	2	47	0	0
5	55773856	.	A	G	16	20	36	0	1	37	0	0
5	55866925	.	C	T	1	2	3	0	1	4	0	0
5	55873712	.	C	A	3	3	6	0	0	6	0	0
5	55876508	.	C	G	4	7	11	0	0	11	0	0
5	55876698	.	T	A	2	5	7	0	0	7	0	0
5	55890693	.	A	G	2	2	4	0	0	4	0	0
5	55921076	.	A	T	8	9	17	0	0	17	0	0
5	55921335	.	G	A	19	15	34	0	0	34	0	0
5	55921628	.	T	C	5	4	9	0	0	9	0	0
5	55921931	.	A	G	3	8	11	0	0	11	0	0
5	55928142	.	G	A	8	7	15	0	1	16	0	0
5	55928367	.	A	G	5	8	13	0	0	13	0	0
5	55933055	.	G	A	6	6	12	0	0	12	0	0
5	55933243	.	T	C	5	4	9	0	0	9	0	0
5	55936430	.	C	A	4	2	6	0	1	7	0	0
5	55946001	.	T	G	1	7	8	0	0	8	0	0
5	55951639	.	A	T	1	7	8	0	0	8	0	0
5	55951928	.	T	G	2	3	5	0	0	5	0	0
5	55951937	.	T	C	2	4	6	0	0	6	0	0
5	56100260	.	T	A	2	3	5	0	0	5	0	0
5	56102224	.	A	C	2	2	4	0	0	4	0	0
5	56111059	.	A	G	1	4	5	0	1	6	0	0
5	56113870	.	C	T	3	4	7	0	0	7	0	0
5	56268496	.	T	C	1	2	3	0	0	3	0	0
5	56271365	.	T	C	1	3	4	0	1	5	0	0
5	56271503	.	C	T	2	2	4	0	1	5	0	0
5	56271521	.	A	G	3	3	6	0	0	6	0	0
5	56272381	.	A	G	2	0	2	0	2	4	0	0
5	56273446	.	A	G	4	2	6	0	6	12	0	0
5	56273737	.	C	T	1	2	3	0	0	3	0	0
5	56280547	.	T	A	2	3	5	0	0	5	0	0
5	56289884	.	A	G	3	5	8	0	0	8	0	0
5	56289904	.	T	C	4	3	7	0	0	7	0	0
5	56289925	.	G	A	0	2	2	0	3	5	0	0
5	56305814	.	C	T	2	2	4	0	0	4	0	0
5	56308816	.	C	T	2	13	15	0	14	29	0	0
5	56309013	.	G	C	22	8	30	2	1	33	0	0
5	56309109	.	C	T	1	21	22	0	7	29	0	0
5	56309115	.	A	T	7	19	26	0	2	28	0	0
5	56309244	.	A	G	9	4	13	0	1	14	0	0
5	56309246	.	A	C	9	5	14	0	0	14	0	0
5	56309454	.	A	G	25	8	33	0	1	34	0	0
5	56309517	.	T	C	12	15	27	0	4	31	0	0
5	56309672	.	C	A	0	14	14	0	15	29	0	0
5	56309677	.	C	A	14	13	27	0	0	27	0	0
5	56309761	.	G	C	17	12	29	0	0	29	0	0
5	56309844	.	G	A	16	23	39	0	1	40	0	0
5	56313189	.	A	G	33	18	51	0	2	53	0	0
5	56313207	.	G	A	27	18	45	0	0	45	0	0
5	56317153	.	T	A	25	16	41	0	0	41	0	0
5	56317170	.	C	T	22	13	35	0	4	39	0	0
5	56317377	.	G	A	23	15	38	0	2	40	0	0
5	56322148	.	A	G	20	5	25	0	1	26	0	0
5	56322205	.	C	T	16	14	30	0	1	31	0	0
5	56322404	.	A	G	5	12	17	0	1	18	0	0
5	56322449	.	T	C	8	11	19	0	0	19	0	0
5	56322467	.	G	A	6	12	18	0	1	19	0	0
5	56322680	.	A	G	12	11	23	0	2	25	0	0
5	56326387	.	A	G	9	5	14	0	0	14	0	0
5	56340613	.	A	G	5	6	11	0	1	12	0	0
5	56343032	.	C	T	0	8	8	0	12	20	0	0
5	56343095	.	C	T	7	4	11	0	1	13	1	0
5	56345091	.	A	G	3	3	6	0	0	6	0	0
5	56345109	.	A	G	3	2	5	0	1	6	0	0
5	56345138	.	T	G	3	3	6	0	0	6	0	0
5	56345653	.	T	C	4	7	11	0	0	11	0	0
5	56355401	.	A	G	8	4	12	0	1	13	0	0
5	56362376	.	C	T	6	6	12	0	0	12	0	0
5	56364862	.	A	G	5	5	10	0	0	10	0	0
5	56364898	.	G	A	7	1	8	0	1	9	0	0
5	56364979	.	A	G	10	4	14	0	0	14	0	0
5	56364982	.	G	T	10	4	14	0	0	14	0	0
5	56375274	.	C	T	9	5	14	0	3	17	0	0
5	56375289	.	G	T	9	7	16	0	0	16	0	0
5	56376741	.	T	G	2	6	8	0	0	8	0	0
5	56378072	.	C	A	2	5	7	0	0	7	0	0
5	56381781	.	G	A	4	3	7	2	0	9	0	0
5	56383131	.	C	G	2	2	4	0	0	4	0	0
5	56383379	.	T	G	1	2	3	0	0	3	0	0
5	56384447	.	A	G	2	2	4	0	0	4	0	0
5	56918932	.	G	A	6	7	13	0	1	14	0	0
5	56918974	.	A	G	8	7	15	0	0	15	0	0
5	56924447	.	G	T	3	4	7	0	0	7	0	0
5	56924460	.	T	C	3	3	6	0	0	6	0	0
5	56927898	.	G	A	2	3	5	0	0	5	0	0
5	56934960	.	A	G	1	4	5	0	0	5	0	0
5	56939054	.	C	T	1	2	3	0	0	3	0	0
5	56942904	.	C	T	2	2	4	0	0	4	0	0
5	56951015	.	A	C	15	0	15	0	10	25	0	0
5	56951081	.	T	C	13	10	23	0	3	26	0	0
5	56951144	.	A	T	4	13	17	0	1	18	0	0
5	56951156	.	C	T	17	5	22	0	0	22	0	0
5	56951220	.	C	T	18	17	35	0	1	36	0	0
5	56951258	.	A	C	8	8	16	0	2	18	0	0
5	56958513	.	C	T	11	9	20	0	2	22	0	0
5	56964475	.	G	A	5	6	11	0	1	12	0	0
5	57217249	.	G	A	0	6	6	0	3	9	0	0
5	57219429	.	T	C	7	11	18	0	0	18	0	0
5	57219430	.	T	A	6	11	17	0	0	17	0	0
5	57219496	.	G	A	10	4	14	0	0	14	0	0
5	57219591	.	G	C	3	4	7	0	0	7	0	0
5	57219736	.	T	C	6	3	9	0	3	12	0	0
5	57219789	.	C	T	9	4	13	0	0	13	0	0
5	57219938	.	G	C	0	6	6	0	8	14	0	0
5	57219990	.	C	A	7	5	12	0	0	12	0	0
5	57220108	.	G	A	2	5	7	0	12	19	0	0
5	57220262	.	A	T	11	5	16	0	0	16	0	0
5	57220324	.	T	C	8	4	12	0	0	12	0	0
5	57225332	.	C	T	8	8	16	0	2	18	0	0
5	57225343	.	C	T	9	10	19	0	0	19	0	0
5	57225496	.	C	G	7	0	7	0	12	19	0	0
5	57226522	.	T	C	15	10	25	0	0	25	0	0
5	57320235	.	C	T	35	27	62	0	1	63	0	0
5	57320274	.	G	A	43	25	68	0	2	70	0	0
5	57325158	.	T	G	30	23	53	0	5	59	1	0
5	57325204	.	T	G	27	1	28	0	35	63	0	0
5	57325210	.	G	A	29	36	65	0	1	66	0	0
5	57325359	.	G	A	33	20	53	0	7	60	0	0
5	57351036	.	A	G	3	0	3	0	2	5	0	0
5	57352465	.	G	C	5	5	10	0	0	10	0	0
5	57353616	.	T	A	4	4	8	0	3	11	0	0
5	57353886	.	C	T	3	4	7	1	0	8	0	0
5	57353959	.	C	A	3	7	10	0	1	11	0	0
5	57353981	.	C	T	10	7	17	0	2	19	0	0
5	57354046	.	G	A	10	7	17	0	1	18	0	0
5	57354061	.	G	A	0	5	5	1	4	10	0	0
5	57354302	.	A	G	5	5	10	0	1	11	0	0
5	57354311	.	G	A	7	0	7	0	1	8	0	0
5	57354552	.	C	T	3	4	7	0	0	7	0	0
5	57354656	.	A	G	7	5	12	0	1	13	0	0
5	57354680	.	G	A	1	13	14	0	10	24	0	0
5	57354719	.	T	G	9	13	22	0	1	23	0	0
5	57354786	.	G	T	5	3	8	0	0	8	0	0
5	57354832	.	C	A	3	2	5	0	0	5	0	0
5	57354839	.	A	G	3	0	3	0	3	6	0	0
5	57359740	.	G	A	10	6	16	0	0	16	0	0
5	57359811	.	A	G	11	8	19	0	0	19	0	0
5	57361015	.	G	T	26	12	38	0	3	41	0	0
5	57442382	.	G	A	0	3	3	0	4	7	0	0
5	57442389	.	T	G	4	3	7	0	0	7	0	0
5	57444318	.	G	C	6	5	11	0	0	11	0	0
5	57446925	.	G	A	3	6	9	0	0	9	0	0
5	57448788	.	T	C	1	3	4	0	1	5	0	0
5	57449035	.	C	A	4	7	11	1	0	12	0	0
5	57450862	.	C	T	7	3	10	0	0	10	0	0
5	57450868	.	C	A	6	3	9	0	1	10	0	0
5	57450973	.	A	G	7	0	7	0	5	12	0	0
5	57453587	.	T	C	2	6	8	0	0	8	0	0
5	57453635	.	T	C	5	4	9	0	0	9	0	0
5	57489821	.	G	A	11	13	24	0	1	25	0	0
5	57499990	.	T	C	17	0	17	0	17	35	1	0
5	57500086	.	T	C	12	15	27	0	0	27	0	0
5	57505050	.	C	T	16	6	22	0	0	22	0	0
5	57506568	.	A	C	11	15	26	0	1	27	0	0
5	57514332	.	G	A	14	14	28	0	2	30	0	0
5	57514428	.	G	A	12	17	29	2	0	31	0	0
5	57629657	.	C	A	2	3	5	0	0	5	0	0
5	57641711	.	A	T	5	3	8	0	0	8	0	0
5	57641751	.	C	T	1	3	4	0	0	4	0	0
5	57641808	.	T	C	3	7	10	0	0	10	0	0
5	57641811	.	T	C	8	3	11	0	0	11	0	0
5	57641895	.	T	C	2	6	8	0	1	9	0	0
5	57643949	.	T	C	1	5	6	0	0	6	0	0
5	57644184	.	T	G	5	11	16	0	1	17	0	0
5	57644256	.	G	A	6	10	16	0	1	17	0	0
5	57644833	.	G	C	1	2	3	0	0	3	0	0
5	57650695	.	C	T	6	7	13	0	1	14	0	0
5	57650699	.	C	A	6	7	13	0	0	13	0	0
5	57693556	.	A	G	2	4	6	0	1	7	0	0
5	57693625	.	C	A	6	3	9	0	0	9	0	0
5	57704982	.	C	T	1	3	4	0	3	7	0	0
5	57715136	.	G	T	1	3	4	0	0	4	0	0
5	57715159	.	T	C	2	3	5	0	0	5	0	0
5	57715904	.	T	C	12	18	30	0	1	31	0	0
5	57716169	.	T	C	7	13	20	0	0	20	0	0
5	57718478	.	G	T	11	7	18	0	0	18	0	0
5	57718558	.	G	T	0	5	5	1	0	6	0	0
5	57718649	.	A	G	15	0	15	1	0	16	0	0
5	57718659	.	C	T	7	17	24	1	1	26	0	0
5	57726573	.	T	A	1	4	5	0	0	5	0	0
5	57734692	.	A	T	3	4	7	0	0	7	0	0
5	57737337	.	A	G	2	5	7	0	0	7	0	0
5	57737427	.	G	A	1	3	4	0	4	8	0	0
5	57737460	.	C	T	5	3	8	0	0	8	0	0
5	57737504	.	C	A	4	3	7	0	1	8	0	0
5	57737637	.	A	G	2	0	2	0	5	7	0	0
5	57737673	.	T	C	5	5	10	0	1	11	0	0
5	57737677	.	A	T	5	5	10	0	1	11	0	0
5	57737862	.	T	A	7	6	13	0	0	13	0	0
5	57737863	.	A	C	7	6	13	0	0	13	0	0
5	57738078	.	C	T	3	8	11	0	0	11	0	0
5	57738233	.	C	T	3	8	11	0	0	11	0	0
5	57743868	.	G	A	8	6	14	0	0	14	0	0
5	57743907	.	A	G	7	7	14	0	3	17	0	0
5	57744681	.	C	T	5	4	9	0	0	9	0	0
5	57744731	.	T	C	5	11	16	0	0	16	0	0
5	57750299	.	C	T	5	4	9	0	0	9	0	0
5	57751676	.	T	A	4	11	15	0	1	16	0	0
5	57753821	.	C	T	9	8	17	0	0	17	0	0
5	57753827	.	A	G	8	0	8	0	9	17	0	0
5	57762390	.	A	G	24	15	39	1	1	41	0	0
5	57762468	.	G	T	19	20	39	0	2	41	0	0
5	57762479	.	A	T	18	23	41	0	1	42	0	0
5	57762529	.	C	T	23	18	41	0	3	44	0	0
5	57762656	.	T	G	19	17	36	0	0	36	0	0
5	57762849	.	A	T	16	12	28	0	0	28	0	0
5	57762868	.	A	G	12	9	21	0	1	22	0	0
5	57762900	.	T	C	14	6	20	0	0	20	0	0
5	57762938	.	A	T	12	20	32	0	0	32	0	0
5	57762986	.	C	G	8	14	22	0	1	23	0	0
5	57777906	.	C	G	19	0	19	0	15	34	0	0
5	57787630	.	C	T	33	15	48	0	3	51	0	0
5	57790313	.	G	A	32	17	49	0	3	52	0	0
5	57790583	.	G	A	24	26	50	0	2	52	0	0
5	57797085	.	A	C	27	29	56	0	9	65	0	0
5	57797770	.	T	C	32	24	56	0	1	57	0	0
5	57797774	.	T	C	31	24	55	0	3	58	0	0
5	57797844	.	C	T	24	30	54	0	7	61	0	0
5	57797887	.	A	T	26	24	50	0	2	52	0	0
5	57797914	.	A	G	26	4	30	0	15	45	0	0
5	57797954	.	T	C	28	10	38	0	1	39	0	0
5	57814454	.	C	A	3	2	5	0	0	5	0	0
5	57814627	.	G	A	10	7	17	0	1	18	0	0
5	57814630	.	T	C	6	0	6	0	12	18	0	0
5	57815018	.	G	A	2	5	7	0	1	8	0	0
5	57820641	.	C	A	1	2	3	0	0	3	0	0
5	57820731	.	T	A	4	4	8	0	0	8	0	0
5	57820743	.	G	C	4	3	7	0	0	7	0	0
5	58075599	.	C	T	2	5	7	0	0	7	0	0
5	58075686	.	A	G	3	3	6	0	0	6	0	0
5	58075815	.	T	G	3	2	5	0	1	6	0	0
5	58075863	.	G	A	2	3	5	0	0	5	0	0
5	58081110	.	C	T	4	3	7	0	2	9	0	0
5	58081173	.	T	A	6	2	8	0	0	8	0	0
5	58081179	.	C	T	3	4	7	0	0	7	0	0
5	58086215	.	G	C	2	0	2	0	3	5	0	0
5	58372268	.	T	C	35	21	56	0	5	61	0	0
5	58372286	.	G	A	24	34	58	0	4	62	0	0
5	58382159	.	A	G	33	4	37	0	37	74	0	0
5	58382358	.	C	T	14	30	44	1	2	47	0	0
5	58402129	.	C	T	2	2	4	0	0	4	0	0
5	58402147	.	A	G	1	2	3	0	0	3	0	0
5	58409519	.	C	T	2	2	4	0	0	4	0	0
5	58412439	.	C	T	2	5	7	0	1	8	0	0
5	58440528	.	A	T	7	3	10	0	1	11	0	0
5	58440541	.	A	G	3	0	3	0	8	11	0	0
5	58455566	.	A	T	4	3	7	0	0	7	0	0
5	58459476	.	A	C	7	2	9	0	1	10	0	0
5	58462891	.	A	G	7	0	7	0	10	17	0	0
5	58478188	.	C	T	7	15	22	0	0	22	0	0
5	58500411	.	C	T	4	4	8	0	0	8	0	0
5	58500489	.	G	A	1	4	5	0	0	5	0	0
5	58504183	.	C	T	8	4	12	0	0	12	0	0
5	58504447	.	G	T	6	7	13	0	0	13	0	0
5	58511523	.	C	G	4	8	12	0	0	12	0	0
5	58511553	.	T	C	3	6	9	0	1	10	0	0
5	58511705	.	G	A	1	4	5	0	0	5	0	0
5	58687623	.	A	T	7	7	14	0	0	14	0	0
5	58687649	.	C	A	6	8	14	0	0	14	0	0
5	58687673	.	T	C	4	9	13	0	1	14	0	0
5	58688749	.	A	G	6	4	10	0	1	11	0	0
5	58695764	.	G	A	1	10	11	0	5	16	0	0
5	58696412	.	A	C	8	7	15	0	0	15	0	0
5	58696420	.	C	G	9	8	17	0	0	17	0	0
5	58696905	.	C	G	13	7	20	0	0	20	0	0
5	58699888	.	C	T	4	7	11	0	1	12	0	0
5	58704272	.	C	T	5	12	17	0	0	17	0	0
5	58711159	.	G	T	8	4	12	0	1	13	0	0
5	58713213	.	C	T	0	6	6	0	5	11	0	0
5	58713579	.	C	T	5	8	13	0	1	14	0	0
5	58717412	.	C	T	7	6	13	0	1	14	0	0
5	58719797	.	C	T	5	3	8	0	0	8	0	0
5	58721406	.	C	T	0	3	3	0	8	11	0	0
5	58722507	.	T	C	3	6	9	0	1	10	0	0
5	58726558	.	C	T	2	4	6	0	1	7	0	0
5	58726575	.	C	T	2	6	8	0	1	9	0	0
5	58730739	.	G	A	2	2	4	0	0	4	0	0
5	58736111	.	T	G	6	4	10	0	1	11	0	0
5	58736144	.	C	T	4	5	9	0	0	9	0	0
5	58742862	.	C	T	4	2	6	0	1	7	0	0
5	58751855	.	T	A	1	2	3	0	0	3	0	0
5	58832250	.	C	T	2	2	4	0	0	4	0	0
5	58850871	.	G	T	18	16	34	0	3	37	0	0
5	58850923	.	A	C	13	18	31	0	2	33	0	0
5	58851297	.	T	A	9	5	14	0	1	15	0	0
5	58851789	.	A	C	20	0	20	0	18	38	0	0
5	58851865	.	T	C	17	0	17	0	12	29	0	0
5	58851925	.	G	A	21	14	35	0	2	37	0	0
5	58851938	.	C	T	19	13	32	0	4	36	0	0
5	58852042	.	T	C	13	0	13	0	14	27	0	0
5	58852164	.	T	C	21	9	30	0	1	31	0	0
5	58852223	.	A	T	14	17	31	0	1	32	0	0
5	58852515	.	A	G	3	4	7	5	0	12	0	0
5	58852758	.	C	A	13	6	19	0	1	20	0	0
5	58852825	.	A	C	20	9	29	0	0	29	0	0
5	58852864	.	T	G	5	13	18	0	0	18	0	0
5	58852971	.	C	T	0	2	2	0	2	5	1	0
5	58852983	.	C	T	2	2	4	0	0	4	0	0
5	58853407	.	C	T	7	3	10	0	0	10	0	0
5	58853711	.	T	A	11	11	22	0	0	23	1	0
5	58866495	.	C	T	14	5	19	0	1	20	0	0
5	58868891	.	A	G	10	5	15	0	0	15	0	0
5	58875086	.	A	G	3	5	8	0	0	8	0	0
5	58875113	.	T	C	7	7	14	0	0	14	0	0
5	58875140	.	C	G	0	10	10	0	6	16	0	0
5	58876301	.	C	T	1	7	8	0	7	15	0	0
5	58876498	.	T	C	2	0	2	0	3	5	0	0
5	58878863	.	G	C	6	3	9	0	0	9	0	0
5	58939388	.	C	A	0	12	12	0	6	18	0	0
5	58992839	.	G	A	2	2	4	0	0	4	0	0
5	58997286	.	T	A	5	3	8	0	0	8	0	0
5	59030172	.	T	C	2	3	5	0	0	5	0	0
5	59041862	.	T	C	6	2	8	0	0	8	0	0
5	59046275	.	G	A	0	4	4	0	3	7	0	0
5	59046296	.	T	C	3	5	8	0	1	9	0	0
5	59050313	.	C	T	3	3	6	0	0	6	0	0
5	59060620	.	C	T	6	6	12	0	0	12	0	0
5	59060855	.	C	T	8	5	13	0	0	13	0	0
5	59067763	.	T	A	7	2	9	1	1	11	0	0
5	59079919	.	G	A	1	2	3	1	3	7	0	0
5	59079932	.	C	T	3	4	7	0	0	7	0	0
5	59080452	.	G	T	1	15	16	0	6	22	0	0
5	59080526	.	T	A	12	7	19	0	0	19	0	0
5	59080804	.	T	A	11	2	13	0	0	13	0	0
5	59080874	.	A	G	4	3	7	0	0	7	0	0
5	59082395	.	C	T	3	4	7	0	0	7	0	0
5	59082495	.	C	A	14	9	23	0	1	24	0	0
5	59082540	.	C	T	10	7	17	0	0	17	0	0
5	59082581	.	T	A	6	7	13	0	0	14	1	0
5	59082882	.	C	T	13	12	25	0	1	26	0	0
5	59083136	.	T	G	8	8	16	0	3	19	0	0
5	59083201	.	T	A	7	5	12	0	0	12	0	0
5	59092513	.	A	G	8	11	19	0	1	20	0	0
5	59092644	.	G	A	9	13	22	0	2	24	0	0
5	59100577	.	G	A	4	2	6	0	0	6	0	0
5	59101813	.	G	A	9	3	12	0	0	12	0	0
5	59101933	.	G	A	5	5	10	0	0	10	0	0
5	59199018	.	G	A	0	2	2	0	1	3	0	0
5	59199173	.	T	G	3	3	6	0	0	6	0	0
5	59199316	.	A	T	2	1	3	0	0	3	0	0
5	59199332	.	A	C	2	3	5	0	0	5	0	0
5	59199517	.	C	T	6	2	8	0	0	8	0	0
5	59200130	.	A	G	1	5	6	0	0	6	0	0
5	59200153	.	T	G	2	7	9	0	0	9	0	0
5	59200206	.	G	T	7	2	9	0	0	9	0	0
5	59200211	.	C	T	1	6	7	0	0	7	0	0
5	59200270	.	T	A	3	5	8	0	0	8	0	0
5	59200435	.	T	G	4	8	12	0	0	12	0	0
5	59200444	.	G	A	3	7	10	0	0	10	0	0
5	59201308	.	G	A	2	6	8	0	3	11	0	0
5	59201690	.	T	C	4	2	6	0	0	6	0	0
5	59201785	.	T	G	6	7	13	0	0	13	0	0
5	59201825	.	G	A	6	5	11	0	2	13	0	0
5	59201883	.	T	G	6	7	13	0	0	13	0	0
5	59201947	.	A	G	7	9	16	0	0	16	0	0
5	59202206	.	C	T	1	3	4	0	0	4	0	0
5	59234451	.	G	T	4	4	8	0	0	8	0	0
5	59239773	.	C	G	7	6	13	0	0	13	0	0
5	59239851	.	G	A	14	6	20	0	2	22	0	0
5	59247894	.	A	G	4	13	17	2	0	19	0	0
5	59248038	.	C	G	10	3	13	0	2	15	0	0
5	59248231	.	G	T	0	3	3	0	4	7	0	0
5	59303988	.	C	T	2	3	5	0	1	6	0	0
5	59328502	.	G	A	4	4	8	0	0	8	0	0
5	59380488	.	C	T	3	5	8	0	0	8	0	0
5	59386337	.	G	T	0	3	3	0	2	5	0	0
5	59386416	.	A	G	8	4	12	0	0	12	0	0
5	59386504	.	T	G	3	0	3	0	7	10	0	0
5	59386512	.	C	G	8	4	12	0	0	12	0	0
5	59387075	.	A	C	8	3	11	0	0	11	0	0
5	59387094	.	A	T	2	6	8	0	0	8	0	0
5	59387416	.	T	A	2	4	6	0	0	6	0	0
5	59387476	.	C	A	5	4	9	0	0	9	0	0
5	59387478	.	C	A	4	5	9	0	0	9	0	0
5	59387566	.	G	T	7	9	16	0	0	16	0	0
5	59388251	.	T	A	5	3	8	0	0	8	0	0
5	59388449	.	G	A	0	4	4	0	8	12	0	0
5	59388479	.	G	A	7	6	13	0	0	13	0	0
5	59388660	.	A	G	10	8	18	0	1	19	0	0
5	59388686	.	C	T	4	7	11	0	0	11	0	0
5	59389014	.	G	A	9	4	13	0	1	14	0	0
5	59389101	.	G	A	2	5	7	0	1	8	0	0
5	59389107	.	G	A	2	5	7	0	0	7	0	0
5	59389688	.	G	A	8	10	18	0	0	18	0	0
5	59419954	.	C	T	6	3	9	0	1	10	0	0
5	59420030	.	C	T	7	3	10	0	1	11	0	0
5	59420096	.	T	C	2	4	6	0	0	6	0	0
5	59420111	.	G	A	1	5	6	0	0	6	0	0
5	59420138	.	G	A	0	4	4	0	1	5	0	0
5	59420249	.	A	G	5	0	5	0	4	9	0	0
5	59420321	.	A	C	3	3	6	0	0	6	0	0
5	59420414	.	G	T	1	6	7	0	5	12	0	0
5	59449767	.	C	T	5	10	15	0	1	16	0	0
5	59462457	.	G	A	6	7	13	0	2	15	0	0
5	59462595	.	C	T	2	10	12	0	1	13	0	0
5	59462663	.	C	T	6	3	9	0	0	9	0	0
5	59462679	.	C	T	2	3	5	0	1	6	0	0
5	59462829	.	T	G	10	6	16	0	0	16	0	0
5	59462881	.	G	A	6	4	10	0	4	14	0	0
5	59462994	.	A	T	2	2	4	0	0	4	0	0
5	59463183	.	G	T	3	4	7	0	0	7	0	0
5	59463213	.	T	C	6	4	10	0	0	10	0	0
5	59463261	.	C	A	4	4	8	0	0	8	0	0
5	59473885	.	A	C	12	11	23	0	2	25	0	0
5	59479541	.	C	A	7	9	16	1	0	17	0	0
5	59479818	.	C	G	13	5	18	0	1	19	0	0
5	59479973	.	C	T	7	4	11	0	2	13	0	0
5	59538508	.	T	G	3	0	3	0	3	6	0	0
5	59538782	.	C	T	5	2	7	0	0	7	0	0
5	59544327	.	C	T	3	4	7	0	1	8	0	0
5	59544717	.	A	G	3	0	3	0	6	9	0	0
5	59549182	.	G	A	3	2	5	0	0	5	0	0
5	59549382	.	A	G	6	4	10	0	0	10	0	0
5	59549389	.	G	A	5	3	8	0	0	8	0	0
5	59550725	.	G	T	1	2	3	0	0	3	0	0
5	59550762	.	A	C	4	2	6	0	0	6	0	0
5	59559881	.	C	T	5	6	11	0	0	11	0	0
5	59559905	.	T	C	6	6	12	0	0	12	0	0
5	59560110	.	T	C	12	7	19	0	2	21	0	0
5	59560131	.	A	G	8	0	8	0	9	17	0	0
5	59584626	.	C	T	9	5	14	0	0	14	0	0
5	59589199	.	G	A	0	5	5	0	9	14	0	0
5	59593297	.	G	C	0	7	7	0	11	18	0	0
5	59593363	.	C	T	3	9	12	0	0	12	0	0
5	59593408	.	G	T	10	8	18	0	0	18	0	0
5	59593441	.	G	A	6	7	13	0	5	18	0	0
5	59593471	.	G	A	1	7	8	0	6	14	0	0
5	59593523	.	C	T	4	2	6	0	1	7	0	0
5	59593623	.	C	T	6	10	16	0	0	16	0	0
5	59593844	.	C	T	1	4	5	0	0	5	0	0
5	59594328	.	T	C	8	6	14	0	0	14	0	0
5	59594507	.	A	C	13	14	27	0	0	27	0	0
5	59594648	.	A	T	5	8	13	0	0	13	0	0
5	59594762	.	G	A	6	13	19	0	0	19	0	0
5	59594825	.	A	T	5	8	13	0	0	13	0	0
5	59595127	.	T	C	5	4	9	0	2	11	0	0
5	59595193	.	G	A	3	7	10	0	0	10	0	0
5	59595307	.	C	A	11	8	19	0	1	20	0	0
5	59595339	.	G	A	11	10	21	0	0	21	0	0
5	59595360	.	A	G	7	8	15	0	0	15	0	0
5	59595407	.	G	A	7	10	17	0	2	19	0	0
5	60521085	.	A	G	2	0	2	0	2	4	0	0
5	60665225	.	A	C	3	3	6	0	0	6	0	0
5	60673572	.	C	G	5	5	10	0	0	10	0	0
5	60683909	.	C	T	2	5	7	0	1	8	0	0
5	60683998	.	C	A	4	3	7	0	0	7	0	0
5	60684434	.	C	T	5	6	11	0	0	11	0	0
5	60685481	.	G	A	11	9	20	0	0	20	0	0
5	60685513	.	A	G	6	10	16	0	0	16	0	0
5	60685758	.	T	C	7	7	14	0	0	14	0	0
5	60685822	.	C	T	8	7	15	0	0	15	0	0
5	60685851	.	G	A	5	8	13	0	1	14	0	0
5	60686374	.	A	T	5	7	12	0	0	12	0	0
5	60686380	.	C	A	6	6	12	0	2	14	0	0
5	60686409	.	G	A	9	10	19	0	0	19	0	0
5	60686686	.	C	G	7	6	13	0	0	13	0	0
5	60686784	.	G	T	10	3	13	0	0	13	0	0
5	60687344	.	A	T	8	12	20	0	1	21	0	0
5	60850285	.	A	C	2	3	5	0	1	6	0	0
5	60850291	.	T	A	2	4	6	0	0	6	0	0
5	60850638	.	T	C	1	1	2	0	1	3	0	0
5	60863132	.	C	T	4	3	7	0	0	7	0	0
5	60867936	.	A	G	12	5	17	0	0	17	0	0
5	60868009	.	A	G	6	0	6	0	6	12	0	0
5	60868173	.	G	A	0	4	4	0	3	7	0	0
5	60868216	.	G	A	4	4	8	0	1	9	0	0
5	60871999	.	A	T	6	6	12	0	0	12	0	0
5	60872258	.	C	T	5	2	7	0	1	8	0	0
5	60872299	.	T	G	1	7	8	0	1	9	0	0
5	60872349	.	T	G	4	1	5	0	8	13	0	0
5	60872639	.	G	A	0	4	4	0	4	8	0	0
5	60872708	.	T	C	3	2	5	0	1	6	0	0
5	60886282	.	C	T	4	2	6	0	0	6	0	0
5	60894675	.	G	A	3	4	7	0	1	8	0	0
5	60899705	.	T	C	3	2	5	0	0	5	0	0
5	60906002	.	C	T	2	3	5	0	0	5	0	0
5	60906313	.	G	A	0	4	4	0	6	10	0	0
5	61270901	.	G	A	12	8	20	0	1	21	0	0
5	61270905	.	C	T	13	8	21	0	0	21	0	0
5	61316248	.	T	C	13	10	23	0	0	23	0	0
5	61325345	.	A	T	11	9	20	0	1	21	0	0
5	61329486	.	G	A	9	7	16	0	0	16	0	0
5	61329508	.	G	C	8	5	13	0	0	13	0	0
5	61329650	.	A	G	12	5	17	0	1	18	0	0
5	61351851	.	C	T	7	9	16	0	1	17	0	0
5	61352582	.	T	C	7	6	13	0	0	13	0	0
5	61354097	.	A	C	2	6	8	0	1	9	0	0
5	61354482	.	T	G	1	1	2	0	0	2	0	0
5	61354502	.	G	A	1	3	4	0	0	4	0	0
5	61380091	.	A	G	9	0	9	0	8	17	0	0
5	61380103	.	T	A	11	8	19	0	1	20	0	0
5	61380130	.	C	T	9	14	23	0	2	25	0	0
5	61389725	.	T	C	11	21	32	0	0	32	0	0
5	61396054	.	G	A	16	8	24	0	4	28	0	0
5	61401915	.	C	T	11	8	19	0	1	20	0	0
5	61402030	.	G	A	9	7	16	0	0	16	0	0
5	61402366	.	G	C	10	11	21	0	4	25	0	0
5	61402440	.	T	C	15	13	28	0	0	28	0	0
5	61402479	.	G	A	13	12	25	0	3	28	0	0
5	61402532	.	C	T	21	11	32	0	2	34	0	0
5	61402534	.	T	A	22	11	33	0	2	35	0	0
5	61402570	.	T	C	14	15	29	0	1	30	0	0
5	61403005	.	A	T	12	13	25	0	2	27	0	0
5	61404613	.	C	A	4	3	7	0	0	7	0	0
5	61404702	.	A	T	8	3	11	0	0	11	0	0
5	61405885	.	A	G	7	4	11	0	0	11	0	0
5	61414618	.	A	T	13	8	21	0	1	22	0	0
5	61420653	.	C	T	11	5	16	0	0	16	0	0
5	61429013	.	C	A	6	3	9	0	1	10	0	0
5	61431675	.	G	A	3	2	5	0	0	5	0	0
5	61433181	.	T	G	1	6	7	0	0	7	0	0
5	61459502	.	T	C	6	13	19	0	3	22	0	0
5	61464874	.	G	T	10	9	19	1	1	21	0	0
5	61467748	.	G	T	5	4	9	0	1	10	0	0
5	61467754	.	T	A	5	4	9	0	1	10	0	0
5	61472457	.	C	T	6	3	9	0	0	9	0	0
5	61552554	.	T	C	14	6	20	0	2	22	0	0
5	61552591	.	A	T	14	8	22	0	1	23	0	0
5	61552620	.	G	C	11	14	25	0	1	26	0	0
5	61552724	.	G	T	13	16	29	0	0	29	0	0
5	61552808	.	T	A	10	6	16	0	0	16	0	0
5	61552836	.	T	A	12	5	17	0	2	19	0	0
5	61553119	.	A	G	4	10	14	0	0	14	0	0
5	61553207	.	C	T	11	4	15	0	0	15	0	0
5	61553252	.	G	T	15	6	21	0	1	22	0	0
5	61553309	.	A	G	5	0	5	0	8	13	0	0
5	61553418	.	G	A	12	13	25	0	1	26	0	0
5	61553517	.	G	T	13	14	27	0	1	28	0	0
5	61553556	.	A	T	15	11	26	0	0	26	0	0
5	61553614	.	C	T	21	4	25	0	0	25	0	0
5	61553702	.	A	T	20	11	31	0	1	32	0	0
5	61553852	.	A	T	13	6	19	0	2	21	0	0
5	61566678	.	G	C	4	3	7	0	0	7	0	0
5	61566753	.	T	C	2	6	8	0	0	8	0	0
5	61570931	.	C	T	6	5	11	0	1	12	0	0
5	61584008	.	A	T	1	4	5	0	4	9	0	0
5	61584010	.	A	T	3	4	7	0	4	11	0	0
5	61584047	.	T	C	3	0	3	0	11	14	0	0
5	61584144	.	G	C	8	4	12	0	0	12	0	0
5	61584178	.	T	C	7	4	11	0	0	11	0	0
5	61588913	.	A	G	2	3	5	0	0	5	0	0
5	61588989	.	C	T	1	2	3	0	0	3	0	0
5	61657805	.	C	T	15	17	32	0	1	33	0	0
5	61665215	.	G	A	6	9	15	0	2	17	0	0
5	61668302	.	G	A	3	10	13	0	9	22	0	0
5	61676676	.	T	G	16	0	16	0	11	27	0	0
5	61676700	.	T	G	16	8	24	0	1	25	0	0
5	61676739	.	A	C	17	6	23	0	1	24	0	0
5	61682577	.	C	T	9	14	23	0	1	24	0	0
5	61682715	.	A	C	13	16	29	0	1	30	0	0
5	61682721	.	C	T	14	16	30	0	1	31	0	0
5	61698770	.	C	T	18	15	33	0	2	35	0	0
5	61701969	.	C	A	31	24	55	0	3	58	0	0
5	61712754	.	C	T	33	35	68	0	0	68	0	0
5	61723061	.	G	A	34	25	59	0	0	59	0	0
5	61723180	.	T	C	35	29	64	1	1	66	0	0
5	61723366	.	A	G	32	22	54	2	1	57	0	0
5	61723538	.	A	G	19	2	21	0	30	51	0	0
5	61723637	.	A	G	15	21	36	0	1	37	0	0
5	61723694	.	T	G	18	24	42	0	1	43	0	0
5	61723914	.	T	C	21	25	46	0	4	50	0	0
5	61723979	.	C	T	13	6	19	0	0	19	0	0
5	61723981	.	G	A	13	4	17	0	4	21	0	0
5	61724055	.	G	A	3	5	8	0	5	13	0	0
5	61790220	.	G	A	3	5	8	0	0	8	0	0
5	61790442	.	C	G	0	2	2	0	6	8	0	0
5	61790460	.	G	T	3	6	9	0	1	10	0	0
5	61790480	.	A	G	5	4	9	0	0	9	0	0
5	61790501	.	A	T	4	3	7	0	1	8	0	0
5	61791376	.	G	A	7	3	10	0	0	10	0	0
5	61793019	.	T	A	3	5	8	0	0	8	0	0
5	61793811	.	T	C	4	0	4	0	3	7	0	0
5	61793978	.	C	T	5	3	8	0	0	8	0	0
5	61799766	.	G	A	16	9	25	0	2	27	0	0
5	61801070	.	G	A	11	10	21	0	2	23	0	0
5	61804538	.	C	T	10	13	23	0	1	24	0	0
5	61806498	.	T	C	18	8	26	0	0	26	0	0
5	61817051	.	A	T	23	24	47	0	2	49	0	0
5	61868378	.	C	T	3	2	5	0	0	5	0	0
5	61871360	.	T	C	1	4	5	0	1	6	0	0
5	61877517	.	G	A	4	3	7	0	0	7	0	0
5	61881101	.	C	T	4	2	6	0	0	6	0	0
5	61881353	.	A	G	3	3	6	0	1	7	0	0
5	61884167	.	G	A	5	4	9	0	3	12	0	0
5	61884460	.	C	T	11	8	19	0	1	20	0	0
5	61884478	.	C	T	12	11	23	0	0	23	0	0
5	61884514	.	C	T	16	10	26	0	0	27	1	0
5	61886601	.	C	T	16	12	28	0	2	30	0	0
5	61886622	.	G	A	17	17	34	0	2	36	0	0
5	61889421	.	A	G	15	0	15	0	12	27	0	0
5	61889572	.	C	G	9	17	26	0	2	28	0	0
5	61890223	.	G	A	1	10	11	0	6	17	0	0
5	61890336	.	A	T	6	10	16	0	0	16	0	0
5	61923322	.	A	G	1	3	4	0	0	4	0	0
5	61930715	.	A	T	12	6	18	0	3	21	0	0
5	61931392	.	A	G	15	22	37	0	2	39	0	0
5	61931409	.	C	T	23	16	39	0	0	39	0	0
5	61931795	.	T	C	1	2	3	0	0	3	0	0
5	61932038	.	T	C	26	13	39	0	0	39	0	0
5	61932177	.	G	A	3	3	6	0	1	7	0	0
5	61932319	.	C	T	10	13	23	0	0	23	0	0
5	61932332	.	C	T	11	8	19	0	3	22	0	0
5	61932361	.	A	T	7	10	17	0	2	19	0	0
5	61932383	.	G	A	11	6	17	0	0	17	0	0
5	61932568	.	T	C	14	14	28	0	0	28	0	0
5	61932604	.	C	T	12	12	24	0	0	24	0	0
5	61932706	.	C	G	13	15	28	0	0	28	0	0
5	61932707	.	T	G	13	13	26	0	1	28	1	0
5	61932754	.	G	C	17	17	34	0	0	34	0	0
5	61934579	.	C	T	10	11	21	0	1	22	0	0
5	61941680	.	C	T	1	2	3	1	0	4	0	0
5	61947586	.	G	C	3	2	5	0	0	5	0	0
5	61947848	.	G	C	4	2	6	0	0	6	0	0
5	61947914	.	A	T	2	2	4	0	0	4	0	0
5	61947962	.	G	A	3	3	6	0	0	6	0	0
5	61947983	.	G	A	2	2	4	0	0	4	0	0
5	61948214	.	C	T	4	3	7	0	0	7	0	0
5	61948809	.	G	A	0	8	8	0	2	10	0	0
5	61949198	.	G	T	2	2	4	0	0	4	0	0
5	61949549	.	T	G	3	5	8	0	1	9	0	0
5	61949624	.	C	T	7	4	11	0	0	11	0	0
5	61949757	.	C	G	4	3	7	0	0	7	0	0
5	61950249	.	G	A	0	5	5	0	3	8	0	0
5	61950345	.	T	G	1	2	3	0	0	3	0	0
5	61950389	.	T	A	4	0	4	0	0	4	0	0
5	61950834	.	A	T	2	6	8	0	0	8	0	0
5	61951038	.	A	G	9	4	13	0	0	13	0	0
5	61998644	.	C	T	8	15	23	0	1	24	0	0
5	62004552	.	C	T	26	21	47	0	1	48	0	0
5	62004561	.	A	G	19	25	44	0	1	45	0	0
5	62004999	.	A	G	8	7	15	0	4	19	0	0
5	62005005	.	G	T	11	7	18	0	1	19	0	0
5	62005054	.	C	T	3	3	6	0	0	6	0	0
5	62018920	.	G	A	1	2	3	0	3	6	0	0
5	62025541	.	C	T	8	4	12	0	0	12	0	0
5	62025736	.	G	A	1	3	4	0	6	10	0	0
5	62025829	.	C	A	5	2	7	0	0	7	0	0
5	62025924	.	T	C	7	6	13	0	1	14	0	0
5	62025991	.	A	G	3	0	3	0	4	7	0	0
5	62026018	.	C	A	3	4	7	0	1	8	0	0
5	62038700	.	C	A	6	11	17	0	0	17	0	0
5	62042450	.	A	G	7	13	20	0	0	20	0	0
5	62053043	.	G	A	4	3	7	0	0	7	0	0
5	62288882	.	T	C	4	2	6	0	0	6	0	0
5	62288960	.	C	T	4	10	14	0	1	15	0	0
5	62289032	.	A	T	5	4	9	0	2	11	0	0
5	62289218	.	G	T	1	2	3	0	0	3	0	0
5	62289222	.	C	A	1	2	3	0	0	3	0	0
5	62289822	.	A	G	5	0	5	0	8	13	0	0
5	62290430	.	G	T	4	4	8	0	2	10	0	0
5	62290448	.	A	T	13	6	19	1	0	20	0	0
5	62290480	.	G	A	0	4	4	2	9	15	0	0
5	62290516	.	G	T	1	3	4	2	4	10	0	0
5	62290539	.	A	G	7	0	7	0	5	12	0	0
5	62290568	.	A	T	8	4	12	0	0	12	0	0
5	62290605	.	T	C	5	5	10	0	1	11	0	0
5	62290844	.	G	A	2	3	5	0	0	5	0	0
5	62290869	.	A	T	3	4	7	0	0	7	0	0
5	62290904	.	T	C	3	5	8	0	1	9	0	0
5	62290931	.	T	C	2	5	7	0	0	7	0	0
5	62290956	.	T	C	2	5	7	0	1	8	0	0
5	62311639	.	C	A	7	3	10	0	0	10	0	0
5	62328477	.	G	A	4	2	6	0	0	6	0	0
5	62329216	.	G	A	2	2	4	0	1	5	0	0
5	62329288	.	A	G	2	2	4	0	0	4	0	0
5	62329437	.	G	A	2	5	7	0	0	7	0	0
5	62329486	.	A	C	6	2	8	0	1	9	0	0
5	62329773	.	G	T	4	2	6	0	0	6	0	0
5	62329876	.	C	G	3	3	6	0	0	6	0	0
5	62329944	.	A	G	2	0	2	0	4	6	0	0
5	62330030	.	C	T	1	2	3	0	0	3	0	0
5	62330124	.	C	T	1	3	4	0	0	4	0	0
5	62330232	.	G	T	4	2	6	0	0	6	0	0
5	62330389	.	A	G	4	2	6	0	0	6	0	0
5	62330438	.	G	A	0	5	5	0	1	6	0	0
5	62330541	.	G	C	2	3	5	0	0	5	0	0
5	62330737	.	C	G	2	4	6	0	0	6	0	0
5	62330913	.	A	G	3	0	3	0	2	5	0	0
5	62331163	.	C	T	3	2	5	0	0	5	0	0
5	62331193	.	G	T	0	2	2	0	3	5	0	0
5	62331255	.	T	C	1	2	3	0	0	3	0	0
5	62331427	.	A	T	5	6	11	0	0	11	0	0
5	62331478	.	C	A	1	5	6	0	0	6	0	0
5	62331516	.	A	T	3	5	8	0	1	9	0	0
5	62331519	.	A	G	3	5	8	0	0	8	0	0
5	62331675	.	G	A	2	7	9	0	0	9	0	0
5	62331835	.	G	A	6	2	8	0	2	10	0	0
5	62331897	.	C	T	4	4	8	0	0	8	0	0
5	62331932	.	T	G	4	5	9	0	1	10	0	0
5	62332231	.	A	C	6	2	8	0	0	8	0	0
5	62332491	.	G	A	6	6	12	0	1	13	0	0
5	62332508	.	G	A	7	6	13	0	0	13	0	0
5	62332735	.	C	T	3	2	5	0	0	5	0	0
5	62333198	.	C	A	4	3	7	0	0	7	0	0
5	62333257	.	C	T	6	2	8	0	0	8	0	0
5	62333267	.	A	T	5	3	8	0	0	8	0	0
5	62333534	.	A	C	6	6	12	0	0	12	0	0
5	62333926	.	T	A	2	4	6	0	0	6	0	0
5	62333981	.	A	G	8	0	8	0	4	12	0	0
5	62334062	.	A	G	8	4	12	0	1	13	0	0
5	62334064	.	C	T	9	4	13	0	0	13	0	0
5	62334121	.	G	C	4	6	10	0	0	10	0	0
5	62334164	.	G	A	2	8	10	0	1	11	0	0
5	62334610	.	C	T	3	5	8	0	0	8	0	0
5	62334694	.	A	T	5	7	12	0	2	14	0	0
5	62334738	.	A	C	4	8	12	0	0	12	0	0
5	62334754	.	G	A	3	7	10	0	0	10	0	0
5	62334843	.	G	T	5	2	7	0	1	8	0	0
5	62334980	.	G	A	10	3	13	0	3	16	0	0
5	62335079	.	A	G	3	0	3	0	9	12	0	0
5	62335089	.	A	G	4	0	4	0	10	14	0	0
5	62335167	.	T	C	4	7	11	0	0	11	0	0
5	62335297	.	C	A	8	6	14	0	1	15	0	0
5	62335337	.	A	T	9	6	15	0	0	15	0	0
5	62335523	.	A	G	10	0	10	0	8	18	0	0
5	62335641	.	T	A	8	4	12	0	0	12	0	0
5	62335655	.	G	T	6	3	9	0	0	9	0	0
5	62521757	.	C	A	6	6	12	0	2	14	0	0
5	62526241	.	T	C	5	5	10	0	0	10	0	0
5	62526295	.	C	T	10	3	13	0	1	14	0	0
5	62533737	.	C	T	5	7	12	0	1	13	0	0
5	62633231	.	A	G	6	0	6	0	14	20	0	0
5	62637753	.	A	C	16	8	24	0	0	24	0	0
5	62639596	.	G	A	18	24	42	0	2	44	0	0
5	62642976	.	T	G	17	0	17	2	12	31	0	0
5	62642989	.	A	G	18	8	26	2	0	28	0	0
5	62806675	.	A	G	8	10	18	0	1	19	0	0
5	62806701	.	A	G	6	8	14	0	0	14	0	0
5	62806902	.	T	C	6	0	6	0	3	9	0	0
5	62806918	.	G	C	3	9	12	0	0	12	0	0
5	62806951	.	A	G	5	3	8	0	1	9	0	0
5	62807044	.	T	A	1	3	4	0	0	4	0	0
5	62807056	.	T	C	1	3	4	0	0	4	0	0
5	62807294	.	G	A	6	3	9	0	0	9	0	0
5	62821214	.	A	T	9	4	13	0	2	15	0	0
5	62856559	.	C	T	6	8	14	0	0	14	0	0
5	62868303	.	T	C	4	4	8	0	0	8	0	0
5	62868328	.	G	A	5	3	8	0	0	8	0	0
5	62883587	.	C	T	10	3	13	0	0	13	0	0
5	62884052	.	T	C	4	3	7	0	0	7	0	0
5	62885777	.	A	G	3	7	10	0	2	12	0	0
5	62885835	.	C	T	8	4	12	0	1	13	0	0
5	62885838	.	G	A	8	4	12	0	0	12	0	0
5	62889966	.	C	G	5	5	10	0	0	10	0	0
5	62890047	.	C	T	0	3	3	0	2	5	0	0
5	62890397	.	T	A	7	4	11	0	1	12	0	0
5	62890482	.	C	T	1	3	4	0	0	4	0	0
5	62890515	.	A	G	2	1	3	0	1	4	0	0
5	62890650	.	C	T	5	4	9	0	0	9	0	0
5	62890740	.	C	T	8	3	11	0	0	11	0	0
5	62890951	.	G	A	7	4	11	0	1	12	0	0
5	62940788	.	A	G	3	3	6	1	1	8	0	0
5	63065718	.	C	T	1	3	4	0	0	4	0	0
5	63065739	.	G	A	1	4	5	0	0	5	0	0
5	63065768	.	A	C	3	1	4	0	3	7	0	0
5	63268917	.	G	A	2	2	4	0	0	4	0	0
5	63285995	.	T	G	4	2	6	0	0	6	0	0
5	63359654	.	A	G	2	0	2	0	3	5	0	0
5	63359812	.	G	A	2	2	4	0	0	4	0	0
5	63360284	.	C	T	2	3	5	0	0	5	0	0
5	63360290	.	A	G	3	3	6	0	0	6	0	0
5	63360344	.	T	C	2	5	7	0	0	7	0	0
5	63363058	.	C	T	2	3	5	1	0	6	0	0
5	63367615	.	C	A	6	4	10	0	0	10	0	0
5	63373157	.	T	C	3	3	6	0	0	6	0	0
5	63373634	.	T	A	3	1	4	2	1	7	0	0
5	63373635	.	G	A	3	0	3	2	2	7	0	0
5	63375980	.	C	T	2	3	5	0	3	8	0	0
5	63376006	.	G	C	2	3	5	0	1	6	0	0
5	63376032	.	A	G	1	4	5	0	1	6	0	0
5	63382567	.	A	G	2	0	2	0	2	4	0	0
5	63386534	.	C	G	1	4	5	0	0	5	0	0
5	63386817	.	G	C	1	4	5	3	0	8	0	0
5	63395030	.	T	C	17	25	42	0	4	46	0	0
5	63395057	.	A	T	23	17	40	0	2	42	0	0
5	63398847	.	T	C	8	14	22	0	0	22	0	0
5	63399066	.	G	C	27	27	54	0	0	54	0	0
5	63399202	.	C	T	25	21	46	0	2	48	0	0
5	63399479	.	C	T	31	33	64	0	2	66	0	0
5	63399683	.	T	A	22	10	32	0	0	32	0	0
5	63402654	.	C	T	0	2	2	0	2	4	0	0
5	63407169	.	G	A	4	2	6	0	0	6	0	0
5	63412576	.	T	C	1	3	4	0	0	4	0	0
5	63412595	.	C	G	3	2	5	0	0	5	0	0
5	63416896	.	T	G	3	2	5	0	0	5	0	0
5	63417980	.	C	T	0	3	3	0	2	5	0	0
5	63425133	.	C	G	1	2	3	0	0	3	0	0
5	63434314	.	T	C	1	0	1	0	4	5	0	0
5	63437792	.	A	G	2	2	4	0	0	4	0	0
5	63510908	.	G	T	9	11	20	0	0	20	0	0
5	63511045	.	A	G	7	3	10	0	0	10	0	0
5	63511110	.	T	C	7	1	8	0	8	16	0	0
5	63511264	.	A	G	6	7	13	0	1	14	0	0
5	63511315	.	A	G	5	5	10	0	3	13	0	0
5	63511788	.	A	T	6	6	12	0	0	12	0	0
5	63511791	.	A	G	6	6	12	0	0	12	0	0
5	63514810	.	T	C	1	0	1	0	4	5	0	0
5	63629121	.	C	A	6	5	11	0	0	11	0	0
5	63629136	.	G	A	6	4	10	0	1	11	0	0
5	63629299	.	A	T	6	8	14	0	0	14	0	0
5	63644850	.	G	A	1	2	3	0	0	3	0	0
5	63648324	.	C	T	2	3	5	0	0	5	0	0
5	63648376	.	T	C	4	1	5	0	3	8	0	0
5	63655829	.	T	C	2	8	10	0	0	10	0	0
5	63658433	.	T	G	2	3	5	0	0	5	0	0
5	63658436	.	G	C	2	2	4	0	0	4	0	0
5	63659582	.	T	A	1	2	3	0	0	3	0	0
5	63680655	.	A	G	10	0	10	0	3	13	0	0
5	63680661	.	C	G	7	3	10	0	0	10	0	0
5	63680709	.	T	G	7	5	12	0	0	12	0	0
5	63680718	.	A	G	5	0	5	0	7	12	0	0
5	63681123	.	A	G	5	5	10	0	1	11	0	0
5	63681300	.	A	G	8	7	15	0	0	15	0	0
5	63695760	.	C	T	10	8	18	0	0	18	0	0
5	63698549	.	T	C	10	13	23	0	0	23	0	0
5	63699468	.	T	C	10	13	23	0	3	26	0	0
5	63720639	.	A	G	17	20	37	0	1	38	0	0
5	63723807	.	G	A	0	10	10	0	15	25	0	0
5	63739912	.	A	G	19	17	36	1	1	38	0	0
5	63740093	.	C	T	17	17	34	0	1	35	0	0
5	63740097	.	T	A	14	17	31	0	2	33	0	0
5	63740149	.	T	C	27	7	34	0	0	34	0	0
5	63740167	.	A	G	13	16	29	0	3	32	0	0
5	63740293	.	A	G	13	7	20	1	0	21	0	0
5	63740305	.	A	G	15	7	22	1	1	24	0	0
5	63740815	.	A	C	20	25	45	0	3	48	0	0
5	63740874	.	A	C	31	23	54	0	1	55	0	0
5	63740895	.	A	C	28	22	50	0	1	51	0	0
5	63740910	.	A	G	21	26	47	0	2	49	0	0
5	63741023	.	T	A	15	12	27	1	4	32	0	0
5	63741077	.	A	T	12	6	18	0	1	19	0	0
5	63848261	.	T	C	4	5	9	0	0	9	0	0
5	63848662	.	C	T	4	3	7	0	0	7	0	0
5	63848668	.	G	T	3	3	6	0	1	7	0	0
5	63858951	.	C	A	5	3	8	0	0	8	0	0
5	63860815	.	C	T	4	5	9	0	0	9	0	0
5	63860936	.	A	G	5	3	8	0	0	8	0	0
5	63860943	.	A	G	4	0	4	0	4	8	0	0
5	63862430	.	T	C	1	2	3	0	0	3	0	0
5	63863073	.	A	G	1	2	3	0	0	3	0	0
5	63863537	.	G	T	3	4	7	0	0	7	0	0
5	63863538	.	T	C	3	3	6	0	1	7	0	0
5	63863945	.	G	C	2	3	5	0	0	5	0	0
5	63864117	.	C	T	9	4	13	0	0	13	0	0
5	63864150	.	T	C	3	4	7	0	1	8	0	0
5	64184562	.	T	C	2	2	4	0	0	4	0	0
5	64205273	.	T	C	6	0	6	0	3	9	0	0
5	64205776	.	T	C	11	4	15	0	0	15	0	0
5	64413842	.	C	T	17	4	21	1	0	22	0	0
5	64671124	.	G	A	1	1	2	0	0	2	0	0
5	66250917	.	C	T	3	4	7	0	0	7	0	0
5	66252054	.	G	A	0	5	5	0	6	11	0	0
5	66252127	.	A	T	1	2	3	0	0	3	0	0
5	66266997	.	A	G	6	3	9	0	0	9	0	0
5	66268964	.	A	G	5	0	5	0	4	9	0	0
5	66271189	.	G	A	2	4	6	0	0	6	0	0
5	66271214	.	C	T	2	5	7	0	0	7	0	0
5	66388196	.	G	A	6	4	10	0	1	11	0	0
5	66389652	.	C	T	3	3	6	0	0	6	0	0
5	66389676	.	C	T	3	2	5	0	0	5	0	0
5	66397643	.	C	A	6	3	9	0	0	9	0	0
5	66489362	.	G	A	1	3	4	0	0	4	0	0
5	66489380	.	A	G	1	3	4	0	0	4	0	0
5	66512040	.	G	C	3	2	5	0	0	5	0	0
5	66676766	.	C	G	9	13	22	0	1	23	0	0
5	66676768	.	G	A	10	12	22	0	1	23	0	0
5	66699135	.	G	T	7	13	20	0	1	21	0	0
5	66699138	.	C	G	7	13	20	0	0	20	0	0
5	66699564	.	G	T	6	14	20	0	1	21	0	0
5	66700388	.	C	T	6	3	9	0	0	9	0	0
5	66700602	.	T	A	2	2	4	0	0	4	0	0
5	66700608	.	T	C	3	2	5	0	0	5	0	0
5	66700734	.	C	A	0	3	3	0	3	6	0	0
5	66701266	.	T	C	2	5	7	0	0	7	0	0
5	66701493	.	T	C	2	8	10	0	0	10	0	0
5	66702411	.	G	A	1	2	3	0	0	3	0	0
5	66733572	.	C	T	2	6	8	1	6	15	0	0
5	66733682	.	T	C	14	11	25	0	0	25	0	0
5	66733694	.	T	C	14	0	14	0	13	27	0	0
5	66733891	.	G	C	10	6	16	0	1	17	0	0
5	66736211	.	T	C	5	10	15	0	4	19	0	0
5	66736280	.	A	G	4	6	10	0	0	10	0	0
5	66740183	.	A	T	5	6	11	0	2	13	0	0
5	66740239	.	T	G	2	10	12	0	0	12	0	0
5	66740273	.	A	T	3	4	7	0	0	7	0	0
5	66807482	.	C	T	17	12	29	0	0	29	0	0
5	66807543	.	C	T	2	21	23	0	17	40	0	0
5	66807735	.	A	G	10	12	22	0	0	22	0	0
5	66807771	.	T	G	16	13	29	0	1	30	0	0
5	66807788	.	C	T	5	15	20	0	14	34	0	0
5	66807830	.	G	A	14	11	25	1	3	29	0	0
5	66807831	.	A	G	15	11	26	1	2	29	0	0
5	66807881	.	A	G	22	15	37	1	1	39	0	0
5	66807916	.	T	C	27	13	40	1	1	42	0	0
5	66813647	.	T	C	12	1	13	0	11	24	0	0
5	66813674	.	G	A	12	9	21	0	0	21	0	0
5	66813722	.	A	G	12	14	26	0	0	26	0	0
5	66814504	.	T	C	10	15	25	0	0	25	0	0
5	66814522	.	A	G	15	12	27	1	0	28	0	0
5	66818699	.	C	T	14	14	28	0	0	28	0	0
5	66819515	.	T	C	10	17	27	0	1	28	0	0
5	66820859	.	A	T	9	10	19	0	1	20	0	0
5	67200217	.	G	T	1	11	12	0	0	12	0	0
5	67273141	.	A	G	1	4	5	0	0	5	0	0
5	67884508	.	G	A	6	3	9	0	0	9	0	0
5	68767339	.	T	C	5	0	5	2	3	10	0	0
5	68767342	.	T	C	6	2	8	2	1	11	0	0
5	68833297	.	T	C	1	5	6	0	0	6	0	0
5	68891590	.	T	C	10	3	13	0	1	14	0	0
5	68891782	.	A	G	0	5	5	1	0	6	0	0
5	68891791	.	G	T	5	4	9	1	1	12	1	0
5	68892515	.	A	C	23	22	45	6	1	52	0	0
5	68892872	.	T	C	4	18	22	0	0	22	0	0
5	68892875	.	T	C	14	7	21	0	2	23	0	0
5	68892917	.	T	C	4	14	18	0	1	19	0	0
5	68892928	.	T	C	4	0	4	0	19	23	0	0
5	69014276	.	T	C	2	5	7	0	0	7	0	0
5	69588720	.	A	T	3	11	14	1	0	15	0	0
5	69595361	.	G	A	8	18	26	0	1	27	0	0
5	69599798	.	G	T	2	16	18	1	1	20	0	0
5	69608211	.	G	A	3	20	23	3	0	26	0	0
5	69608223	.	G	A	3	19	22	1	1	24	0	0
5	69616625	.	A	T	2	3	5	3	0	8	0	0
5	69708830	.	C	A	4	2	6	0	0	6	0	0
5	69851203	.	T	C	1	10	11	0	0	11	0	0
5	69900898	.	A	C	10	2	12	0	20	32	0	0
5	69900904	.	G	C	12	0	12	0	20	32	0	0
5	69907537	.	T	C	11	6	17	0	1	18	0	0
5	70182082	.	A	G	29	33	62	0	1	63	0	0
5	70182599	.	T	G	34	0	34	0	21	55	0	0
5	70315679	.	G	A	0	3	3	0	1	4	0	0
5	70317090	.	T	A	0	2	2	0	1	3	0	0
5	70317576	.	T	C	1	3	4	0	0	4	0	0
5	70317960	.	G	A	2	3	5	0	0	5	0	0
5	70318311	.	T	C	3	4	7	0	0	7	0	0
5	70318320	.	G	A	5	4	9	0	0	9	0	0
5	70318665	.	A	T	1	6	7	0	0	8	1	0
5	70318671	.	C	T	2	7	9	0	0	9	0	0
5	70318898	.	T	A	2	5	7	0	0	7	0	0
5	70318950	.	A	G	3	2	5	0	0	5	0	0
5	70319066	.	G	A	0	8	8	0	3	11	0	0
5	70319330	.	G	C	2	2	4	0	0	4	0	0
5	70319533	.	C	T	2	4	6	0	0	6	0	0
5	70319984	.	T	A	2	2	4	0	1	5	0	0
5	70518761	.	C	T	1	3	4	0	0	4	0	0
5	71748357	.	T	C	2	3	5	0	0	5	0	0
5	71765768	.	C	T	7	7	14	0	0	14	0	0
5	71927440	.	G	A	1	2	3	0	0	3	0	0
5	71934680	.	A	C	2	4	6	0	0	6	0	0
5	71934706	.	T	G	2	0	2	0	5	7	0	0
5	71934762	.	T	C	2	2	4	0	0	4	0	0
5	71934867	.	C	T	3	2	5	0	0	5	0	0
5	71944137	.	G	A	0	2	2	0	3	5	0	0
5	71944140	.	G	A	2	2	4	0	1	5	0	0
5	71946540	.	A	G	6	2	8	0	0	8	0	0
5	72002655	.	A	C	5	4	9	0	0	9	0	0
5	72002712	.	G	A	3	3	6	0	0	6	0	0
5	72002790	.	G	T	3	2	5	0	0	5	0	0
5	72023857	.	C	T	25	24	49	0	13	62	0	0
5	72024336	.	C	T	0	21	21	0	32	53	0	0
5	72027464	.	C	T	1	15	16	0	29	45	0	0
5	72028042	.	G	C	11	1	12	0	24	36	0	0
5	72031809	.	G	A	20	15	35	0	0	35	0	0
5	72031846	.	A	G	20	9	29	0	0	29	0	0
5	72033527	.	C	T	2	14	16	0	18	34	0	0
5	72034108	.	C	T	0	13	13	0	16	29	0	0
5	72034177	.	A	G	14	14	28	0	2	30	0	0
5	72038586	.	C	T	16	14	30	0	3	33	0	0
5	72038727	.	G	A	12	14	26	0	1	27	0	0
5	72038909	.	C	T	0	5	5	0	17	22	0	0
5	72039105	.	G	A	14	7	21	0	0	21	0	0
5	72043751	.	A	G	12	12	24	1	4	29	0	0
5	72043778	.	G	A	16	10	26	0	1	27	0	0
5	72043791	.	G	T	13	18	31	0	1	32	0	0
5	72044324	.	G	A	7	7	14	0	0	14	0	0
5	72044342	.	A	G	8	9	17	0	1	18	0	0
5	72045010	.	C	T	0	9	9	0	3	12	0	0
5	72046888	.	C	T	13	13	26	0	0	26	0	0
5	72047047	.	C	G	1	11	12	0	10	22	0	0
5	72047127	.	T	A	11	12	23	0	0	23	0	0
5	72047136	.	T	C	13	0	13	0	9	22	0	0
5	72047881	.	G	A	12	11	23	0	0	23	0	0
5	72049688	.	C	A	2	10	12	0	15	27	0	0
5	72050192	.	A	G	14	7	21	0	6	27	0	0
5	72050257	.	C	T	2	11	13	0	18	31	0	0
5	72050314	.	T	C	9	2	11	0	16	27	0	0
5	72053139	.	C	T	0	8	8	0	9	17	0	0
5	72058489	.	T	C	3	6	9	0	0	9	0	0
5	72066904	.	C	T	2	3	5	0	0	5	0	0
5	72066993	.	G	A	3	2	5	0	1	6	0	0
5	72068056	.	A	C	1	5	6	0	0	6	0	0
5	72068691	.	G	A	3	3	6	0	0	6	0	0
5	72068820	.	C	T	0	3	3	0	2	5	0	0
5	72071914	.	A	G	6	3	9	0	0	9	0	0
5	72092483	.	C	T	41	24	65	0	1	66	0	0
5	72092958	.	G	A	5	39	44	0	28	72	0	0
5	72094698	.	C	T	0	3	3	0	3	6	0	0
5	72095796	.	G	A	1	4	5	0	0	5	0	0
5	72114638	.	A	T	1	2	3	0	0	3	0	0
5	72114656	.	T	A	2	2	4	0	0	4	0	0
5	72130139	.	C	A	6	4	10	0	1	11	0	0
5	72130656	.	A	G	4	3	7	0	0	7	0	0
5	72131154	.	G	A	3	4	7	0	0	7	0	0
5	72131482	.	C	T	0	6	6	0	2	8	0	0
5	72131618	.	C	T	2	5	7	0	0	7	0	0
5	72134329	.	A	G	1	2	3	0	0	3	0	0
5	72136544	.	G	A	2	3	5	0	1	6	0	0
5	72139978	.	G	A	7	3	10	0	2	12	0	0
5	72155379	.	C	T	2	4	6	0	0	6	0	0
5	72155430	.	G	A	1	3	4	0	3	7	0	0
5	72155508	.	A	C	2	2	4	0	0	4	0	0
5	72167277	.	G	A	6	2	8	0	0	8	0	0
5	72167289	.	A	G	5	2	7	0	0	7	0	0
5	72168267	.	A	G	4	2	6	0	0	6	0	0
5	72168297	.	T	G	3	0	3	0	3	6	0	0
5	72168323	.	T	C	2	3	5	0	0	5	0	0
5	72168342	.	C	T	2	2	4	0	0	4	0	0
5	72168552	.	C	T	8	3	11	0	0	11	0	0
5	72172350	.	T	A	27	27	54	0	3	57	0	0
5	72172446	.	G	T	17	16	33	0	3	36	0	0
5	72172456	.	G	T	18	18	36	0	1	37	0	0
5	72172752	.	G	A	17	37	54	0	2	56	0	0
5	72173169	.	C	A	13	4	17	0	0	17	0	0
5	72173476	.	T	C	12	13	25	0	2	27	0	0
5	72173483	.	T	G	14	14	28	0	0	28	0	0
5	72173894	.	G	A	9	8	17	0	1	18	0	0
5	72173943	.	C	T	11	8	19	0	1	20	0	0
5	72199763	.	C	T	2	2	4	0	0	4	0	0
5	72202402	.	G	A	1	5	6	0	9	15	0	0
5	72202467	.	G	A	4	8	12	0	2	14	0	0
5	72203313	.	G	A	10	9	19	0	0	19	0	0
5	72204359	.	C	T	1	3	4	0	0	4	0	0
5	72205483	.	A	C	7	13	20	0	0	20	0	0
5	72205583	.	T	G	12	0	12	0	11	23	0	0
5	72205867	.	T	G	3	3	6	0	1	7	0	0
5	72205905	.	T	C	9	4	13	0	1	14	0	0
5	72206009	.	T	C	9	7	16	0	1	17	0	0
5	72206090	.	T	C	9	7	16	0	1	17	0	0
5	72206155	.	G	T	10	5	15	0	0	15	0	0
5	72206235	.	T	G	4	0	4	0	8	12	0	0
5	72316948	.	A	G	3	2	5	0	0	5	0	0
5	72316977	.	T	G	3	3	6	0	0	6	0	0
5	72317357	.	T	C	1	2	3	0	0	3	0	0
5	72317589	.	T	G	3	2	5	0	0	5	0	0
5	72317622	.	C	T	3	2	5	0	1	6	0	0
5	72317643	.	A	G	4	2	6	0	0	6	0	0
5	72317660	.	A	G	2	3	5	0	0	5	0	0
5	72376119	.	C	G	21	31	52	0	0	52	0	0
5	72376227	.	A	G	14	23	37	0	0	37	0	0
5	72376959	.	A	G	8	18	26	0	0	26	0	0
5	72382995	.	C	T	16	17	33	0	0	33	0	0
5	72383263	.	C	T	16	19	35	0	3	38	0	0
5	72383964	.	A	G	6	5	11	1	0	12	0	0
5	72384426	.	A	C	16	11	27	0	1	28	0	0
5	72384524	.	A	G	8	7	15	0	2	17	0	0
5	72384642	.	T	C	5	10	15	0	0	15	0	0
5	72384807	.	T	C	9	0	9	0	13	22	0	0
5	72384978	.	G	A	14	5	19	0	0	19	0	0
5	72385001	.	C	T	13	12	25	0	0	25	0	0
5	72385034	.	A	G	12	19	31	0	0	31	0	0
5	72385075	.	C	T	14	15	29	0	2	31	0	0
5	72386870	.	T	C	10	12	22	0	0	22	0	0
5	72389156	.	C	A	2	11	13	0	24	37	0	0
5	72390189	.	G	A	15	5	20	0	3	23	0	0
6	272194	.	A	G	33	1	34	0	17	51	0	0
6	842391	.	T	C	12	4	16	0	2	18	0	0
6	844282	.	T	C	2	4	6	0	0	6	0	0
6	1780069	.	T	C	6	19	25	0	1	26	0	0
6	1798107	.	G	A	4	2	6	0	0	6	0	0
6	1798118	.	A	T	3	2	5	0	1	6	0	0
6	2208117	.	G	A	1	3	4	0	0	4	0	0
6	3005179	.	G	T	2	4	6	0	0	6	0	0
6	3040450	.	G	A	1	3	4	0	0	4	0	0
6	3040536	.	T	C	6	5	11	0	0	11	0	0
6	3040572	.	G	A	2	3	5	0	0	5	0	0
6	3047971	.	A	T	3	5	8	0	0	8	0	0
6	3142968	.	T	C	4	2	6	0	1	7	0	0
6	3143292	.	T	A	5	7	12	0	1	13	0	0
6	3143609	.	G	A	3	5	8	0	0	8	0	0
6	3197028	.	C	T	6	12	18	0	0	18	0	0
6	3223245	.	C	T	4	9	13	0	1	14	0	0
6	3223341	.	C	G	8	7	15	0	0	15	0	0
6	3249490	.	C	T	8	11	19	0	0	19	0	0
6	3256066	.	C	A	12	16	28	0	2	30	0	0
6	3268327	.	T	C	9	19	28	0	3	31	0	0
6	3269864	.	A	G	13	0	13	0	17	30	0	0
6	3270011	.	G	A	22	18	40	0	1	41	0	0
6	3273272	.	A	T	10	17	27	0	2	29	0	0
6	3273341	.	T	A	17	11	28	0	1	30	1	0
6	3273379	.	A	G	12	15	27	0	0	27	0	0
6	3273901	.	T	G	18	2	20	0	14	34	0	0
6	3274114	.	G	C	1	25	26	0	17	43	0	0
6	3274191	.	G	C	25	7	32	2	1	35	0	0
6	3280947	.	C	T	1	3	4	0	0	4	0	0
6	3280975	.	G	C	1	3	4	0	0	4	0	0
6	3287392	.	G	A	0	3	3	0	1	4	0	0
6	3293933	.	T	G	1	2	3	0	0	3	0	0
6	3294251	.	T	C	3	3	6	0	0	6	0	0
6	3294755	.	C	T	2	3	5	0	0	5	0	0
6	3295262	.	C	T	4	7	11	0	0	11	0	0
6	3295664	.	T	A	3	1	4	0	3	7	0	0
6	3298796	.	G	A	3	6	9	0	0	9	0	0
6	3298816	.	G	C	2	3	5	0	0	5	0	0
6	3312627	.	C	T	2	3	5	0	0	5	0	0
6	3312750	.	A	T	2	3	5	0	0	5	0	0
6	3318673	.	T	C	5	2	7	0	0	7	0	0
6	3318721	.	G	A	0	5	5	0	6	11	0	0
6	3319076	.	A	G	2	3	5	0	1	6	0	0
6	3334494	.	A	G	2	0	2	0	3	5	0	0
6	3334502	.	T	C	2	3	5	0	1	6	0	0
6	3395649	.	C	T	6	2	8	0	1	9	0	0
6	3398906	.	A	G	7	7	14	0	0	14	0	0
6	3404913	.	A	C	8	3	11	0	1	12	0	0
6	3404956	.	G	A	0	4	4	0	2	6	0	0
6	3404974	.	C	T	1	4	5	0	1	6	0	0
6	3405052	.	G	A	5	4	9	0	0	9	0	0
6	3405060	.	G	A	0	7	7	0	5	12	0	0
6	3405143	.	T	C	7	8	15	0	1	16	0	0
6	3405191	.	G	C	6	5	11	0	2	13	0	0
6	3405244	.	A	G	8	3	11	0	5	16	0	0
6	3405245	.	C	A	14	3	17	0	0	17	0	0
6	3509041	.	T	G	3	6	9	0	0	9	0	0
6	3514481	.	A	C	26	33	59	3	2	64	0	0
6	3514719	.	C	G	1	2	3	0	0	3	0	0
6	3566481	.	T	C	3	2	5	0	0	5	0	0
6	3566766	.	C	G	0	2	2	0	1	3	0	0
6	3704391	.	G	A	0	3	3	0	11	14	0	0
6	3707095	.	A	G	6	7	13	0	0	13	0	0
6	3707116	.	G	A	6	9	15	0	0	15	0	0
6	3707371	.	G	A	0	12	12	0	8	20	0	0
6	3707372	.	A	G	7	12	19	0	1	20	0	0
6	3707407	.	T	C	8	11	19	0	1	20	0	0
6	3708061	.	A	G	6	8	14	0	0	14	0	0
6	3708149	.	T	C	5	8	13	0	0	13	0	0
6	3711200	.	T	A	4	5	9	0	0	9	0	0
6	3711221	.	A	G	5	5	10	0	0	10	0	0
6	3711282	.	T	G	11	1	12	0	13	25	0	0
6	3711338	.	A	G	9	9	18	0	0	18	0	0
6	3711386	.	T	C	10	4	14	0	0	14	0	0
6	3711419	.	A	G	5	2	7	0	1	8	0	0
6	3711448	.	C	A	5	2	7	0	0	7	0	0
6	3711616	.	G	A	1	2	3	0	0	3	0	0
6	3711665	.	A	T	2	2	4	0	0	4	0	0
6	3711971	.	G	A	4	8	12	0	0	12	0	0
6	3712045	.	T	A	4	6	10	0	0	10	0	0
6	3712069	.	A	T	6	10	16	0	0	16	0	0
6	3712198	.	G	T	5	5	10	0	0	10	0	0
6	3712199	.	A	C	5	5	10	0	0	10	0	0
6	3712238	.	A	T	5	5	10	0	0	10	0	0
6	3712264	.	A	C	3	5	8	0	1	9	0	0
6	3712335	.	T	G	7	0	7	0	7	14	0	0
6	3712389	.	C	T	6	2	8	0	0	8	0	0
6	3712582	.	A	T	4	2	6	0	0	6	0	0
6	3712713	.	C	G	6	8	14	0	1	15	0	0
6	3717843	.	C	T	6	3	9	0	0	9	0	0
6	3724870	.	A	C	12	13	25	0	0	25	0	0
6	3725767	.	C	A	16	17	33	0	2	35	0	0
6	3727891	.	C	T	10	8	18	0	0	18	0	0
6	3728295	.	A	T	9	5	14	0	0	14	0	0
6	3728559	.	G	C	3	7	10	0	0	10	0	0
6	3827894	.	C	A	15	15	30	0	2	32	0	0
6	3834630	.	G	C	20	31	51	0	1	52	0	0
6	3853120	.	T	G	37	2	39	0	25	64	0	0
6	3853165	.	T	C	37	29	66	0	3	69	0	0
6	3862018	.	A	G	10	15	25	0	1	26	0	0
6	3867542	.	A	T	12	7	19	0	1	20	0	0
6	3869454	.	G	A	1	18	19	0	12	31	0	0
6	3869891	.	C	T	17	19	36	0	2	38	0	0
6	3871982	.	T	A	12	20	32	0	5	37	0	0
6	3874504	.	G	A	5	23	28	0	21	49	0	0
6	3874533	.	C	T	18	25	43	0	2	45	0	0
6	3874686	.	A	G	14	19	33	0	0	33	0	0
6	3878513	.	T	A	4	5	9	0	0	9	0	0
6	3878593	.	A	G	7	9	16	0	0	16	0	0
6	3878831	.	G	C	7	4	11	0	1	12	0	0
6	3878983	.	A	T	10	7	17	0	5	22	0	0
6	3879158	.	A	G	5	13	18	0	0	18	0	0
6	3879247	.	C	A	3	9	12	0	18	30	0	0
6	3879314	.	C	G	0	10	10	0	7	17	0	0
6	3879335	.	C	T	8	10	18	0	0	18	0	0
6	3879367	.	G	A	6	13	19	1	1	21	0	0
6	3881078	.	G	A	10	6	16	0	0	16	0	0
6	3885451	.	C	T	10	9	19	0	2	21	0	0
6	3895442	.	A	T	8	3	11	0	0	11	0	0
6	3895460	.	C	T	2	6	8	0	10	18	0	0
6	3901120	.	C	T	0	4	4	0	9	13	0	0
6	3906051	.	C	T	1	7	8	0	4	12	0	0
6	3907796	.	A	T	7	7	14	0	1	15	0	0
6	3950267	.	C	T	4	2	6	0	0	6	0	0
6	3950270	.	C	T	2	3	5	0	1	6	0	0
6	3950309	.	C	T	1	3	4	0	1	5	0	0
6	3953280	.	T	C	6	7	13	0	2	15	0	0
6	3953302	.	A	C	4	5	9	0	0	9	0	0
6	3961387	.	G	A	7	6	13	0	0	13	0	0
6	3962132	.	G	A	27	25	52	0	3	55	0	0
6	3962192	.	A	T	24	20	44	0	0	44	0	0
6	3964619	.	G	A	8	8	16	0	0	16	0	0
6	3965389	.	G	T	8	8	16	0	0	16	0	0
6	3965461	.	A	G	11	13	24	0	0	24	0	0
6	3973572	.	G	A	10	7	17	0	0	17	0	0
6	3973638	.	T	G	11	11	22	0	1	23	0	0
6	3974047	.	G	A	8	7	15	0	1	16	0	0
6	3985083	.	G	A	5	6	11	0	0	11	0	0
6	3985137	.	G	A	5	10	15	0	0	15	0	0
6	3987131	.	A	G	4	3	7	0	0	7	0	0
6	3987145	.	T	C	3	2	5	0	0	5	0	0
6	4144448	.	C	T	2	3	5	0	0	5	0	0
6	4145917	.	C	G	1	2	3	0	0	3	0	0
6	4185678	.	G	A	10	13	23	0	1	24	0	0
6	4191449	.	C	T	2	4	6	0	0	6	0	0
6	4191554	.	A	T	6	3	9	0	0	9	0	0
6	4192025	.	G	A	7	10	17	0	0	17	0	0
6	4192031	.	A	G	8	7	15	0	1	16	0	0
6	4192171	.	G	A	5	4	9	0	1	10	0	0
6	4199494	.	T	C	2	5	7	0	0	7	0	0
6	4206411	.	G	A	7	5	12	0	0	12	0	0
6	4206435	.	G	A	7	6	13	0	0	13	0	0
6	4241945	.	C	T	1	5	6	0	0	6	0	0
6	4241954	.	A	G	3	5	8	0	0	8	0	0
6	4245276	.	C	T	7	10	17	0	2	19	0	0
6	4246466	.	T	C	3	5	8	0	1	9	0	0
6	4246496	.	G	A	0	4	4	0	6	10	0	0
6	4246638	.	A	C	3	3	6	0	0	6	0	0
6	4247928	.	C	T	4	4	8	0	0	8	0	0
6	4247942	.	T	C	3	5	8	0	0	8	0	0
6	4248195	.	G	C	6	4	10	0	1	11	0	0
6	4248231	.	A	G	4	0	4	0	5	9	0	0
6	4248307	.	G	A	0	2	2	0	2	4	0	0
6	4248399	.	A	T	5	3	8	1	0	9	0	0
6	4248412	.	T	A	4	3	7	1	0	8	0	0
6	4249420	.	C	T	5	2	7	0	0	7	0	0
6	4249684	.	A	G	3	7	10	0	1	11	0	0
6	4249821	.	G	A	1	3	4	0	1	5	0	0
6	4250046	.	A	T	2	6	8	0	0	8	0	0
6	4334616	.	T	G	2	0	2	0	4	6	0	0
6	4341944	.	G	A	1	2	3	0	0	3	0	0
6	4347541	.	T	C	2	4	6	0	0	6	0	0
6	4352140	.	G	T	2	4	6	0	0	6	0	0
6	4359773	.	G	A	2	2	4	0	0	4	0	0
6	4360110	.	C	T	3	2	5	0	0	5	0	0
6	4365163	.	C	T	7	9	16	0	0	16	0	0
6	4365295	.	G	C	10	10	20	0	0	20	0	0
6	4376849	.	G	A	0	6	6	0	2	8	0	0
6	4377182	.	A	G	1	2	3	0	0	3	0	0
6	4379559	.	G	C	5	5	10	0	3	13	0	0
6	4379760	.	G	A	0	2	2	0	7	9	0	0
6	4386999	.	C	T	6	6	12	0	0	12	0	0
6	4389434	.	G	A	9	8	17	0	0	17	0	0
6	4389436	.	T	C	9	9	18	0	0	18	0	0
6	4389506	.	A	C	3	0	3	0	10	13	0	0
6	4392639	.	C	T	6	3	9	0	1	10	0	0
6	4397173	.	G	A	2	10	12	0	3	15	0	0
6	4397181	.	C	A	4	9	13	0	3	16	0	0
6	4397262	.	C	T	9	6	15	0	0	15	0	0
6	4398906	.	C	T	8	4	12	0	1	13	0	0
6	4398939	.	A	C	7	5	12	0	0	12	0	0
6	4400652	.	A	T	5	3	8	0	0	8	0	0
6	4400803	.	T	A	4	4	8	0	0	8	0	0
6	4400999	.	C	T	2	6	8	0	0	8	0	0
6	4401087	.	T	A	7	4	11	0	0	11	0	0
6	4401088	.	A	T	9	2	11	0	0	11	0	0
6	4416859	.	G	A	3	2	5	0	1	6	0	0
6	4417007	.	G	A	1	2	3	0	0	3	0	0
6	4531158	.	T	C	5	2	7	0	0	7	0	0
6	4540110	.	A	G	1	1	2	0	1	3	0	0
6	4540115	.	C	A	2	3	5	0	0	5	0	0
6	4540422	.	A	G	2	3	5	0	1	6	0	0
6	4541178	.	T	C	3	7	10	0	0	10	0	0
6	4542492	.	A	G	3	0	3	0	2	5	0	0
6	4542573	.	A	C	6	8	14	0	0	14	0	0
6	4874563	.	C	T	4	4	8	0	0	8	0	0
6	4874821	.	G	C	1	4	5	0	0	5	0	0
6	4875292	.	C	T	3	3	6	0	1	7	0	0
6	4876522	.	G	C	0	5	5	0	11	16	0	0
6	4876738	.	G	A	10	7	17	0	1	18	0	0
6	4876946	.	C	A	3	3	6	0	1	7	0	0
6	4877023	.	C	T	2	4	6	0	0	6	0	0
6	6231117	.	T	C	2	3	5	0	0	5	0	0
6	6231186	.	C	A	1	4	5	0	0	5	0	0
6	6231321	.	C	A	2	1	3	0	1	4	0	0
6	6232301	.	A	C	27	19	46	0	3	49	0	0
6	6232315	.	T	C	26	1	27	0	22	49	0	0
6	6234779	.	A	G	25	29	54	0	0	54	0	0
6	6235307	.	G	A	18	25	43	0	0	43	0	0
6	6258045	.	G	C	2	0	2	0	8	10	0	0
6	6258130	.	C	T	7	3	10	0	0	10	0	0
6	6258239	.	C	T	0	3	3	0	5	8	0	0
6	6258240	.	A	G	3	5	8	0	0	8	0	0
6	6270882	.	G	C	22	18	40	0	4	44	0	0
6	6273345	.	C	T	33	29	62	0	2	64	0	0
6	6273396	.	C	T	24	34	58	0	0	58	0	0
6	6275599	.	A	G	8	6	14	0	1	15	0	0
6	6275667	.	C	T	9	10	19	0	0	19	0	0
6	6275668	.	A	G	8	9	17	0	1	18	0	0
6	6284114	.	A	G	5	5	10	0	0	10	0	0
6	6303823	.	C	A	2	6	8	0	0	8	0	0
6	6307946	.	A	C	2	2	4	0	1	5	0	0
6	6308018	.	A	G	2	3	5	0	0	5	0	0
6	6395099	.	C	T	2	3	5	0	0	5	0	0
6	6395211	.	T	A	4	9	13	0	0	13	0	0
6	6395222	.	T	A	2	8	10	0	0	10	0	0
6	6395367	.	C	T	0	5	5	0	5	10	0	0
6	6395405	.	C	T	7	2	9	0	0	9	0	0
6	6423827	.	C	T	0	3	3	0	1	4	0	0
6	6459235	.	T	C	5	6	11	0	0	11	0	0
6	6459315	.	G	A	5	7	12	0	1	13	0	0
6	6463633	.	T	G	6	2	8	0	1	9	0	0
6	6466502	.	C	T	4	8	12	0	0	12	0	0
6	6467931	.	C	T	0	6	6	0	6	12	0	0
6	6470842	.	G	A	1	5	6	0	0	6	0	0
6	6471875	.	C	G	4	2	6	0	0	6	0	0
6	6472177	.	T	C	2	3	5	0	0	5	0	0
6	6475515	.	C	T	1	3	4	0	2	6	0	0
6	6475576	.	G	T	5	3	8	0	0	8	0	0
6	6475578	.	G	T	3	4	7	0	1	8	0	0
6	6477578	.	C	A	0	2	2	0	6	8	0	0
6	6477785	.	G	A	2	3	5	0	0	5	0	0
6	6480100	.	T	A	3	4	7	0	0	7	0	0
6	6480583	.	A	G	5	2	7	0	0	7	0	0
6	6539842	.	T	G	7	0	7	0	4	11	0	0
6	6539848	.	T	A	6	4	10	0	0	10	0	0
6	6540903	.	A	G	1	2	3	0	0	3	0	0
6	6541039	.	C	T	5	4	9	0	0	9	0	0
6	6669502	.	C	G	2	2	4	0	0	4	0	0
6	6669743	.	G	A	4	7	11	0	2	13	0	0
6	6671545	.	G	C	3	5	8	0	1	9	0	0
6	6671607	.	C	G	3	2	5	0	0	5	0	0
6	6671769	.	T	A	4	6	10	0	1	11	0	0
6	6737391	.	C	T	14	14	28	0	0	28	0	0
6	6737401	.	G	T	15	10	25	0	0	25	0	0
6	6737982	.	T	A	17	20	37	0	5	42	0	0
6	6737998	.	C	T	2	23	25	0	19	44	0	0
6	6769345	.	T	A	10	11	21	0	1	22	0	0
6	6769716	.	C	T	9	10	19	0	0	19	0	0
6	6769719	.	T	C	7	9	16	0	2	18	0	0
6	6769782	.	A	G	12	8	20	0	0	20	0	0
6	6779232	.	C	A	1	2	3	0	0	3	0	0
6	6784095	.	G	A	4	7	11	0	0	11	0	0
6	6784239	.	G	C	1	6	7	0	0	7	0	0
6	6788714	.	A	G	8	0	8	0	3	11	0	0
6	6793164	.	C	T	14	13	27	0	0	27	0	0
6	6793224	.	G	A	3	6	9	0	7	16	0	0
6	6795520	.	T	A	2	7	9	0	1	10	0	0
6	6795664	.	T	C	7	10	17	0	0	17	0	0
6	6797583	.	A	G	5	9	14	0	1	15	0	0
6	6797598	.	T	C	12	6	18	0	0	18	0	0
6	6797694	.	T	A	11	6	17	0	0	17	0	0
6	6800031	.	G	T	4	3	7	0	0	7	0	0
6	6803534	.	T	A	9	9	18	0	1	19	0	0
6	6803726	.	T	A	12	11	23	0	0	23	0	0
6	6805275	.	G	A	12	13	25	0	0	25	0	0
6	6805477	.	T	C	4	6	10	0	0	10	0	0
6	6805572	.	G	T	13	12	25	0	3	28	0	0
6	6808217	.	A	G	0	2	2	0	1	3	0	0
6	6903468	.	C	T	6	8	14	0	1	15	0	0
6	6903513	.	G	A	9	9	18	0	0	18	0	0
6	6905848	.	G	A	0	4	4	0	10	14	0	0
6	6908955	.	A	G	2	2	4	0	0	4	0	0
6	6909792	.	G	A	5	9	14	0	0	14	0	0
6	6916417	.	A	G	5	0	5	0	7	12	0	0
6	6919866	.	G	T	0	10	10	0	8	18	0	0
6	6920673	.	A	T	8	6	14	0	0	14	0	0
6	6921577	.	C	T	11	12	23	0	1	24	0	0
6	6921581	.	T	C	10	10	20	0	1	21	0	0
6	6921802	.	G	A	17	22	39	1	0	40	0	0
6	6921889	.	T	A	8	13	21	0	4	25	0	0
6	6922072	.	G	T	11	17	28	0	1	29	0	0
6	6922187	.	T	C	16	11	27	0	3	30	0	0
6	6973009	.	A	T	11	5	16	0	0	16	0	0
6	6973383	.	G	T	8	4	12	21	1	34	0	0
6	7089952	.	C	G	6	3	9	0	0	9	0	0
6	7107034	.	A	G	3	5	8	0	0	8	0	0
6	7107833	.	C	T	2	6	8	0	0	8	0	0
6	7110148	.	C	T	5	5	10	0	1	11	0	0
6	7110434	.	C	T	17	14	31	1	1	33	0	0
6	7110435	.	T	G	17	14	31	1	0	32	0	0
6	7110551	.	C	T	32	14	46	0	0	46	0	0
6	7113001	.	T	G	14	10	24	0	1	25	0	0
6	7114482	.	C	T	17	12	29	0	0	29	0	0
6	7114937	.	A	G	10	13	23	0	0	23	0	0
6	7115967	.	T	C	15	10	25	0	1	26	0	0
6	7118398	.	A	C	9	6	15	0	1	16	0	0
6	7157570	.	G	A	2	4	6	0	1	7	0	0
6	7157615	.	C	T	4	2	6	0	0	6	0	0
6	7157771	.	G	A	3	3	6	0	0	6	0	0
6	7207652	.	G	A	3	2	5	0	0	5	0	0
6	7251362	.	A	T	5	7	12	0	0	12	0	0
6	7251426	.	A	G	9	4	13	0	1	14	0	0
6	7251564	.	G	A	8	6	14	0	0	14	0	0
6	7251627	.	A	G	3	8	11	0	0	11	0	0
6	7251694	.	G	A	1	4	5	0	2	7	0	0
6	7265179	.	G	A	1	5	6	0	0	6	0	0
6	7270355	.	T	C	7	7	14	0	0	14	0	0
6	7273005	.	A	G	7	0	7	0	5	12	0	0
6	7273021	.	C	T	6	5	11	0	0	11	0	0
6	7273512	.	T	A	4	5	9	0	3	12	0	0
6	7273518	.	G	A	1	9	10	0	4	14	0	0
6	7276139	.	T	C	5	2	7	0	1	8	0	0
6	7276178	.	T	A	9	7	16	0	0	16	0	0
6	7276212	.	C	T	13	6	19	0	1	20	0	0
6	7276263	.	G	A	0	5	5	0	12	17	0	0
6	7276776	.	A	C	5	7	12	0	1	13	0	0
6	7435565	.	C	T	6	5	11	0	0	11	0	0
6	7438474	.	C	T	5	5	10	0	1	11	0	0
6	7444930	.	T	C	11	12	23	0	1	24	0	0
6	7451563	.	T	G	12	13	25	0	2	27	0	0
6	7452519	.	T	C	11	15	26	0	0	26	0	0
6	7453379	.	T	G	17	0	17	1	18	36	0	0
6	7453567	.	G	T	8	8	16	1	2	19	0	0
6	7453649	.	C	G	11	9	20	0	0	20	0	0
6	7453660	.	C	T	11	5	16	0	0	16	0	0
6	7530577	.	A	G	1	3	4	0	0	4	0	0
6	7531114	.	G	A	1	2	3	0	0	3	0	0
6	7542491	.	G	T	0	10	10	0	11	21	0	0
6	7545794	.	C	T	20	9	29	0	1	30	0	0
6	7545824	.	T	C	16	13	29	0	1	30	0	0
6	7547451	.	C	T	5	6	11	0	3	14	0	0
6	7549967	.	G	A	17	21	38	0	1	39	0	0
6	7550210	.	A	C	10	7	17	0	1	18	0	0
6	7550405	.	C	T	11	14	25	0	1	26	0	0
6	7551087	.	C	A	4	3	7	0	0	7	0	0
6	7555871	.	G	A	6	3	9	0	0	9	0	0
6	7591018	.	G	A	4	4	8	0	0	8	0	0
6	7624322	.	C	T	7	4	11	0	0	11	0	0
6	7624725	.	T	C	6	4	10	0	0	10	0	0
6	7626457	.	C	T	5	8	13	0	0	13	0	0
6	7633452	.	G	C	1	16	17	0	9	26	0	0
6	7636811	.	A	T	9	12	21	0	0	21	0	0
6	7637195	.	C	T	12	15	27	0	0	27	0	0
6	7638717	.	G	A	10	17	27	0	0	27	0	0
6	7645319	.	T	C	19	9	28	0	1	29	0	0
6	7646039	.	A	G	20	8	28	0	1	29	0	0
6	7646102	.	G	A	11	10	21	0	1	22	0	0
6	7646111	.	G	C	12	12	24	0	1	25	0	0
6	7648224	.	A	G	5	0	5	1	18	24	0	0
6	7652458	.	C	T	19	23	42	0	3	45	0	0
6	7652470	.	A	C	19	24	43	0	0	43	0	0
6	7652896	.	G	A	1	17	18	0	17	35	0	0
6	7652959	.	C	T	20	25	45	0	2	47	0	0
6	7652989	.	C	T	21	23	44	0	2	46	0	0
6	7656920	.	A	G	20	0	20	1	25	46	0	0
6	7656932	.	A	G	21	23	44	1	3	48	0	0
6	7657177	.	C	T	17	9	26	0	2	28	0	0
6	7657793	.	A	C	15	23	38	0	0	38	0	0
6	7657886	.	T	A	24	15	39	0	3	43	1	0
6	7657887	.	G	T	24	17	41	0	2	43	0	0
6	7657972	.	T	G	22	7	29	0	0	29	0	0
6	7658076	.	G	A	13	11	24	0	2	26	0	0
6	7659833	.	A	T	4	1	5	0	0	5	0	0
6	7659915	.	G	A	4	3	7	0	0	7	0	0
6	7660119	.	A	G	5	13	18	0	0	18	0	0
6	7660300	.	T	C	2	0	2	0	5	7	0	0
6	7660369	.	T	C	2	4	6	1	0	7	0	0
6	7660458	.	A	C	5	0	5	0	6	11	0	0
6	7660594	.	C	T	6	2	8	0	0	8	0	0
6	7660659	.	C	A	0	5	5	0	4	9	0	0
6	7660707	.	C	T	0	5	5	0	5	10	0	0
6	7679455	.	G	A	1	2	3	0	0	3	0	0
6	7682793	.	C	A	0	3	3	0	1	4	0	0
6	7699948	.	C	T	3	9	12	0	0	12	0	0
6	7702770	.	G	T	3	5	8	0	0	8	0	0
6	7713350	.	A	T	3	4	7	0	2	9	0	0
6	7713433	.	G	A	23	23	46	0	4	50	0	0
6	7721530	.	T	A	4	7	11	0	0	11	0	0
6	7721860	.	G	A	2	6	8	0	0	8	0	0
6	7721906	.	G	A	7	14	21	0	2	23	0	0
6	7721958	.	C	A	9	12	21	1	4	26	0	0
6	7722143	.	G	T	16	13	29	0	6	35	0	0
6	7722159	.	A	T	18	14	32	0	2	34	0	0
6	7722195	.	G	T	18	12	30	0	0	30	0	0
6	7722205	.	G	A	14	12	26	0	0	26	0	0
6	7722333	.	G	A	7	10	17	1	0	18	0	0
6	7722387	.	T	C	17	10	27	0	2	29	0	0
6	7722402	.	T	C	17	12	29	0	0	29	0	0
6	7722467	.	T	A	17	5	22	0	0	22	0	0
6	7722577	.	C	T	0	12	12	0	10	22	0	0
6	7722921	.	A	T	2	4	6	0	1	7	0	0
6	7723008	.	G	T	12	6	18	0	0	18	0	0
6	7723155	.	A	C	14	7	21	0	0	21	0	0
6	7723232	.	A	T	8	5	13	0	0	13	0	0
6	7723850	.	C	T	0	7	7	0	8	15	0	0
6	7723961	.	G	A	12	13	25	0	1	26	0	0
6	7726824	.	G	A	4	10	14	0	0	14	0	0
6	7734250	.	A	C	4	3	7	0	0	7	0	0
6	7734271	.	C	A	5	4	9	0	0	9	0	0
6	7795698	.	C	T	17	10	27	0	9	36	0	0
6	7842013	.	C	T	1	5	6	0	7	13	0	0
6	7842034	.	C	A	11	6	17	0	0	17	0	0
6	8176101	.	A	G	3	5	8	0	1	9	0	0
6	8176575	.	C	T	5	4	9	0	0	10	1	0
6	8177030	.	T	C	6	10	16	0	1	17	0	0
6	8177399	.	T	C	7	5	12	0	0	12	0	0
6	8177678	.	C	T	9	4	13	0	0	13	0	0
6	8178002	.	T	C	6	8	14	0	2	16	0	0
6	8178053	.	G	A	2	8	10	0	8	18	0	0
6	8178113	.	T	C	12	9	21	0	1	22	0	0
6	8178351	.	G	A	5	6	11	0	2	13	0	0
6	8179022	.	G	T	2	16	18	0	8	26	0	0
6	8179205	.	A	T	11	15	26	0	0	26	0	0
6	8179373	.	G	A	18	15	33	0	0	33	0	0
6	8179683	.	A	T	2	5	7	0	0	7	0	0
6	8211075	.	C	T	3	8	11	0	0	11	0	0
6	8211106	.	T	C	3	5	8	0	0	8	0	0
6	8211143	.	A	T	4	2	6	0	0	6	0	0
6	8211154	.	T	C	3	1	4	0	0	4	0	0
6	8211253	.	G	A	5	3	8	0	0	8	0	0
6	8212174	.	G	A	4	4	8	0	0	8	0	0
6	8214044	.	G	A	7	3	10	0	0	10	0	0
6	8214045	.	T	G	4	3	7	0	2	9	0	0
6	8214118	.	T	C	2	3	5	0	0	5	0	0
6	8214947	.	T	C	1	0	1	0	3	4	0	0
6	8217870	.	G	A	3	3	6	0	0	6	0	0
6	8224881	.	A	G	2	3	5	0	0	5	0	0
6	8265214	.	G	A	3	4	7	0	0	7	0	0
6	8265282	.	G	A	5	7	12	0	0	12	0	0
6	8267111	.	C	T	15	14	29	0	1	30	0	0
6	8267266	.	A	G	15	23	38	0	0	38	0	0
6	8267284	.	G	A	11	19	30	0	1	31	0	0
6	8267307	.	G	C	9	14	23	0	1	25	1	0
6	8267352	.	A	T	10	18	28	0	0	28	0	0
6	8267519	.	G	A	18	16	34	0	1	36	1	0
6	8267563	.	G	T	22	17	39	0	1	40	0	0
6	8267635	.	T	C	23	22	45	0	1	46	0	0
6	8267795	.	T	A	17	7	24	0	1	25	0	0
6	8267880	.	G	A	12	13	25	0	0	25	0	0
6	8268529	.	A	G	10	8	18	0	0	18	0	0
6	8273066	.	G	A	8	10	18	0	0	18	0	0
6	8277141	.	C	A	6	3	9	0	0	9	0	0
6	8282275	.	A	G	2	4	6	0	0	6	0	0
6	8283360	.	A	G	2	2	4	0	0	4	0	0
6	8315076	.	A	G	5	12	17	0	0	17	0	0
6	8315078	.	A	G	5	12	17	0	0	17	0	0
6	8316947	.	A	G	4	5	9	0	0	9	0	0
6	8318001	.	T	C	3	7	10	0	0	10	0	0
6	8318037	.	G	A	1	8	9	0	4	13	0	0
6	8328181	.	G	T	12	16	28	0	0	28	0	0
6	8365753	.	T	C	1	3	4	0	1	5	0	0
6	8366006	.	A	T	11	7	18	0	0	19	1	0
6	8366167	.	C	T	19	7	26	1	0	27	0	0
6	8370489	.	T	C	13	12	25	0	0	25	0	0
6	8374716	.	G	A	3	6	9	0	0	9	0	0
6	8375089	.	C	T	13	12	25	0	1	26	0	0
6	8380102	.	G	A	6	4	10	0	0	10	0	0
6	8380121	.	T	A	5	3	8	0	1	9	0	0
6	8380485	.	G	T	4	2	6	0	0	6	0	0
6	8391629	.	C	T	0	10	10	0	10	20	0	0
6	8392005	.	G	A	6	11	17	0	0	17	0	0
6	8453747	.	C	T	1	3	4	0	0	4	0	0
6	8455483	.	T	C	2	0	2	0	3	5	0	0
6	8457125	.	T	C	3	5	8	0	0	8	0	0
6	8460435	.	G	T	2	2	4	0	0	4	0	0
6	8460493	.	G	T	1	2	3	0	0	3	0	0
6	8460603	.	T	G	1	3	4	0	0	4	0	0
6	8460622	.	T	C	1	0	1	0	5	6	0	0
6	8674673	.	T	C	6	2	8	0	0	8	0	0
6	9391799	.	C	T	4	3	7	0	0	7	0	0
6	9391802	.	C	A	4	3	7	0	0	7	0	0
6	10000878	.	T	A	4	0	4	0	11	16	1	0
6	10008329	.	G	A	4	17	21	0	16	37	0	0
6	10008398	.	A	G	18	20	38	0	1	39	0	0
6	10008407	.	C	T	17	19	36	0	2	38	0	0
6	10009850	.	C	T	19	20	39	0	1	40	0	0
6	10009903	.	A	T	22	20	42	0	1	43	0	0
6	10015551	.	T	C	2	2	4	0	2	6	0	0
6	10015602	.	T	C	22	13	35	0	3	38	0	0
6	10015794	.	A	T	28	26	54	2	2	58	0	0
6	10015902	.	A	T	31	27	58	0	1	59	0	0
6	10015952	.	C	A	37	25	62	0	1	63	0	0
6	10015992	.	A	C	37	24	61	0	2	63	0	0
6	10015993	.	G	A	36	24	60	0	3	63	0	0
6	10016114	.	C	T	41	31	72	0	0	72	0	0
6	10016116	.	C	A	40	28	68	0	3	71	0	0
6	10016174	.	T	G	46	17	63	1	12	76	0	0
6	10016363	.	T	G	38	22	60	2	3	71	6	0
6	10020055	.	G	A	29	28	57	0	1	58	0	0
6	10026677	.	C	T	32	27	59	0	4	63	0	0
6	10026818	.	G	A	8	6	14	0	0	14	0	0
6	10033015	.	G	A	1	6	7	0	0	7	0	0
6	10034079	.	C	T	1	2	3	0	0	3	0	0
6	10045449	.	G	T	8	13	21	0	1	22	0	0
6	10047204	.	T	C	18	13	31	0	0	31	0	0
6	10047805	.	G	A	19	7	26	0	0	26	0	0
6	10047814	.	T	C	17	9	26	0	2	28	0	0
6	10050050	.	G	A	22	15	37	0	2	39	0	0
6	10056466	.	G	T	19	21	40	0	3	43	0	0
6	10085418	.	C	T	2	2	4	0	0	4	0	0
6	10085430	.	A	C	1	2	3	0	0	3	0	0
6	10085495	.	A	G	2	4	6	0	0	6	0	0
6	10088109	.	C	T	1	2	3	0	0	3	0	0
6	10248476	.	T	A	12	13	25	0	0	25	0	0
6	10248530	.	A	G	11	14	25	0	2	27	0	0
6	10248546	.	T	C	10	0	10	0	15	25	0	0
6	10248596	.	T	C	15	20	35	0	1	36	0	0
6	10248980	.	A	G	6	4	10	0	0	10	0	0
6	10249451	.	A	G	9	5	14	0	2	16	0	0
6	10251188	.	C	A	12	7	19	0	1	20	0	0
6	10257886	.	A	G	4	2	6	0	0	6	0	0
6	10264656	.	T	C	6	1	7	0	5	12	0	0
6	10283462	.	A	G	7	3	10	0	0	10	0	0
6	10288855	.	A	G	2	2	4	0	0	4	0	0
6	10305813	.	T	G	2	4	6	0	2	8	0	0
6	10305821	.	A	G	3	3	6	0	3	9	0	0
6	10305922	.	G	A	3	5	8	0	1	9	0	0
6	10354469	.	T	C	1	2	3	0	0	3	0	0
6	10512858	.	C	T	2	7	9	1	1	11	0	0
6	10512903	.	C	G	5	5	10	0	0	10	0	0
6	10522332	.	C	T	2	4	6	0	0	6	0	0
6	10540138	.	C	T	1	3	4	0	0	5	1	0
6	10540300	.	A	T	3	3	6	0	0	6	0	0
6	10547409	.	C	T	3	3	6	0	0	6	0	0
6	10567861	.	C	T	6	8	14	0	0	14	0	0
6	10570843	.	C	T	11	5	16	0	0	16	0	0
6	10576573	.	A	G	4	0	4	0	5	9	0	0
6	10701864	.	T	C	2	0	2	0	3	5	0	0
6	10702203	.	T	C	2	0	2	0	5	7	0	0
6	10702244	.	T	C	4	0	4	0	3	7	0	0
6	10702269	.	T	A	2	2	4	0	0	4	0	0
6	10705814	.	C	T	1	4	5	0	1	6	0	0
6	10705815	.	G	T	2	4	6	0	0	6	0	0
6	10713784	.	G	A	3	3	6	0	3	9	0	0
6	10713810	.	G	T	4	4	8	0	1	9	0	0
6	10721767	.	C	T	18	0	18	0	1	19	0	0
6	10722541	.	G	A	11	9	20	0	2	22	0	0
6	10724275	.	G	A	5	2	7	0	0	7	0	0
6	10724336	.	C	T	2	4	6	0	7	13	0	0
6	10724591	.	G	T	10	9	19	0	3	22	0	0
6	10724645	.	A	T	14	5	19	0	2	21	0	0
6	10724665	.	G	A	8	10	18	0	1	19	0	0
6	10724765	.	G	A	4	10	14	0	0	14	0	0
6	10725365	.	T	C	5	0	5	0	7	12	0	0
6	10725506	.	T	C	4	5	9	0	1	10	0	0
6	10733176	.	G	A	1	2	3	0	0	3	0	0
6	10733605	.	T	G	1	2	3	0	0	3	0	0
6	10736615	.	T	C	4	4	8	0	0	8	0	0
6	10736746	.	C	T	0	2	2	0	3	5	0	0
6	10736760	.	A	C	2	2	4	0	0	4	0	0
6	10737000	.	C	A	0	2	2	0	2	4	0	0
6	10741616	.	A	G	2	3	5	0	0	5	0	0
6	10741852	.	G	T	2	2	4	0	0	4	0	0
6	10741853	.	T	G	3	2	5	0	0	5	0	0
6	10741916	.	G	C	10	8	18	0	0	18	0	0
6	10742120	.	T	C	21	23	44	0	2	46	0	0
6	10742121	.	G	A	21	22	43	0	3	46	0	0
6	10742306	.	A	G	21	25	46	0	2	48	0	0
6	10742318	.	G	A	22	21	43	0	4	47	0	0
6	10742497	.	T	C	20	0	20	0	31	51	0	0
6	10751216	.	G	A	10	6	16	1	2	19	0	0
6	10758866	.	A	T	2	4	6	0	0	6	0	0
6	10758890	.	A	C	7	1	8	0	3	11	0	0
6	10761181	.	C	G	2	2	4	0	0	4	0	0
6	10763977	.	A	G	4	9	13	0	0	13	0	0
6	10764001	.	A	G	3	10	13	0	1	14	0	0
6	10776031	.	G	A	1	3	4	0	0	4	0	0
6	10831093	.	G	A	35	30	65	1	4	70	0	0
6	10833078	.	T	C	20	1	21	0	40	61	0	0
6	10834821	.	G	C	30	33	63	0	0	63	0	0
6	10835676	.	G	A	3	2	5	0	0	5	0	0
6	10835700	.	T	A	2	3	5	0	1	6	0	0
6	10835721	.	A	G	2	4	6	0	0	6	0	0
6	10835788	.	G	A	3	7	10	0	1	11	0	0
6	10838690	.	C	T	0	4	4	0	1	5	0	0
6	10838716	.	A	C	5	5	10	0	0	10	0	0
6	10838741	.	G	A	6	5	11	0	0	11	0	0
6	10838753	.	T	C	6	6	12	0	0	12	0	0
6	10839332	.	A	G	2	5	7	0	1	8	0	0
6	10839885	.	C	A	2	12	14	0	14	28	0	0
6	10846001	.	G	A	18	15	33	0	0	33	0	0
6	10858734	.	C	T	5	6	11	0	0	11	0	0
6	10858747	.	T	C	4	6	10	0	0	10	0	0
6	10859011	.	G	A	4	3	7	0	0	7	0	0
6	10863599	.	T	C	7	2	9	0	0	9	0	0
6	10872687	.	T	C	9	9	18	0	1	19	0	0
6	10877269	.	A	G	16	23	39	0	1	40	0	0
6	10879525	.	T	C	22	16	38	0	1	39	0	0
6	10879633	.	T	C	20	12	32	0	1	33	0	0
6	10879679	.	G	A	16	17	33	0	3	36	0	0
6	10879816	.	A	T	13	12	25	0	1	26	0	0
6	10879833	.	A	G	14	0	14	0	12	26	0	0
6	10910684	.	G	A	7	9	16	0	1	17	0	0
6	10910784	.	C	A	28	14	42	0	1	43	0	0
6	10911066	.	T	C	26	31	57	0	3	60	0	0
6	10911198	.	A	G	37	42	79	0	2	81	0	0
6	10912341	.	G	A	22	25	47	0	0	47	0	0
6	10982902	.	A	G	1	4	5	0	0	5	0	0
6	10982984	.	G	T	1	4	5	0	0	5	0	0
6	11066855	.	T	C	1	2	3	0	0	3	0	0
6	11071222	.	A	G	24	27	51	0	4	55	0	0
6	11101781	.	T	C	4	9	13	0	2	15	0	0
6	11101790	.	C	T	1	8	9	0	6	15	0	0
6	11101852	.	G	A	8	9	17	0	0	17	0	0
6	11107167	.	G	C	4	0	4	0	5	9	0	0
6	11107233	.	C	A	2	3	5	0	0	5	0	0
6	11107326	.	T	C	2	1	3	0	3	6	0	0
6	11113091	.	A	G	1	7	8	0	0	8	0	0
6	11122579	.	A	G	2	3	5	0	0	5	0	0
6	11129033	.	G	A	2	2	4	0	0	4	0	0
6	11129357	.	T	C	2	4	6	0	0	6	0	0
6	11129447	.	A	T	2	2	4	0	0	4	0	0
6	11141282	.	T	C	1	2	3	0	0	3	0	0
6	11250427	.	A	T	4	2	6	0	0	6	0	0
6	11250462	.	C	T	8	5	13	0	1	14	0	0
6	11250973	.	T	C	7	5	12	0	1	13	0	0
6	11252838	.	C	A	3	6	9	0	0	9	0	0
6	11252883	.	A	G	5	7	12	0	1	13	0	0
6	11253881	.	T	C	5	6	11	0	0	11	0	0
6	11253890	.	C	T	6	5	11	0	1	12	0	0
6	11254142	.	T	G	5	0	5	0	7	12	0	0
6	11254358	.	A	G	6	0	6	0	7	13	0	0
6	11254526	.	C	T	5	10	15	0	2	17	0	0
6	11257827	.	G	A	0	17	17	0	10	27	0	0
6	11257866	.	G	C	1	15	16	0	10	26	0	0
6	11257917	.	T	A	16	10	26	0	2	28	0	0
6	11259970	.	C	A	23	9	32	0	0	32	0	0
6	11265612	.	G	T	1	9	10	0	11	21	0	0
6	11265681	.	T	A	21	10	31	0	0	31	0	0
6	11265717	.	T	C	26	8	34	0	0	34	0	0
6	11265899	.	A	G	12	1	13	0	4	17	0	0
6	11266255	.	C	T	18	16	34	0	1	35	0	0
6	11266490	.	A	T	6	7	13	0	0	13	0	0
6	11266496	.	T	C	6	7	13	0	0	13	0	0
6	11276827	.	T	A	4	4	8	0	1	9	0	0
6	11276912	.	A	G	9	3	12	0	0	12	0	0
6	11279804	.	T	C	5	2	7	0	0	7	0	0
6	11279815	.	T	C	5	3	8	0	0	8	0	0
6	11281923	.	A	G	2	3	5	0	0	5	0	0
6	11285310	.	C	T	5	3	8	0	0	8	0	0
6	11285362	.	T	C	7	0	7	0	2	9	0	0
6	11285374	.	C	T	6	3	9	0	0	9	0	0
6	11285583	.	C	T	6	3	9	0	0	9	0	0
6	11285662	.	C	T	0	2	2	0	3	5	0	0
6	11285716	.	G	A	5	5	10	0	0	10	0	0
6	11285772	.	C	T	2	2	4	0	0	4	0	0
6	11288460	.	G	T	4	4	8	0	0	9	1	0
6	11295616	.	T	G	2	2	4	0	0	4	0	0
6	11299909	.	C	T	1	3	4	0	0	4	0	0
6	11303424	.	T	G	4	3	7	0	0	7	0	0
6	11326973	.	G	A	3	5	8	0	0	8	0	0
6	11334517	.	T	A	3	2	5	0	0	5	0	0
6	11334951	.	C	A	1	2	3	0	0	3	0	0
6	11348510	.	C	T	1	2	3	0	0	3	0	0
6	11397818	.	G	C	1	5	6	0	5	11	0	0
6	11398324	.	G	T	5	9	14	0	0	14	0	0
6	11403359	.	C	A	5	11	16	0	3	19	0	0
6	11407918	.	G	A	5	11	16	0	0	16	0	0
6	11407944	.	A	G	8	8	16	0	1	17	0	0
6	11407954	.	A	G	11	8	19	0	1	20	0	0
6	11410523	.	C	T	8	11	19	0	0	19	0	0
6	11413532	.	A	T	5	10	15	0	0	15	0	0
6	11414715	.	C	T	9	3	12	0	0	12	0	0
6	11414748	.	G	A	6	6	12	0	1	13	0	0
6	11414777	.	A	T	7	5	12	0	0	12	0	0
6	11414822	.	T	G	3	0	3	0	7	10	0	0
6	11415220	.	A	C	18	18	36	0	0	36	0	0
6	11415460	.	G	A	1	8	9	0	4	13	0	0
6	11765364	.	A	G	23	15	38	0	4	42	0	0
6	11765506	.	A	G	28	26	54	2	0	56	0	0
6	11765913	.	G	A	22	23	45	0	2	47	0	0
6	11766267	.	G	A	20	17	37	0	1	38	0	0
6	11766276	.	A	G	22	16	38	0	1	39	0	0
6	11766765	.	T	C	25	12	37	0	0	37	0	0
6	11767623	.	T	C	22	27	49	0	1	50	0	0
6	11768196	.	G	C	19	31	50	1	1	52	0	0
6	11771118	.	G	A	18	26	44	0	2	46	0	0
6	11773266	.	C	T	23	21	44	0	1	45	0	0
6	11779940	.	C	A	13	14	27	0	1	28	0	0
6	11780001	.	A	C	7	12	19	0	0	19	0	0
6	11780004	.	A	T	6	11	17	0	0	17	0	0
6	11781567	.	A	C	7	1	8	0	2	10	0	0
6	11791106	.	T	C	5	0	5	0	8	13	0	0
6	11791225	.	T	C	5	0	5	0	4	9	0	0
6	11791258	.	G	A	5	6	11	0	0	11	0	0
6	11791572	.	A	G	2	10	12	0	0	12	0	0
6	11791644	.	A	G	7	8	15	0	1	16	0	0
6	11791646	.	T	C	7	9	16	0	0	16	0	0
6	11791686	.	A	C	4	0	4	0	12	16	0	0
6	11791770	.	G	A	10	6	16	0	1	17	0	0
6	11791806	.	T	G	10	5	15	0	0	15	0	0
6	11791947	.	A	G	11	11	22	0	0	22	0	0
6	11796238	.	A	T	2	4	6	0	0	6	0	0
6	11816438	.	T	C	1	0	1	0	2	3	0	0
6	11816451	.	G	A	3	2	5	0	0	5	0	0
6	11817185	.	C	T	4	4	8	0	0	8	0	0
6	11817192	.	A	G	2	2	4	0	0	4	0	0
6	11817278	.	A	T	5	3	8	0	0	8	0	0
6	11817482	.	C	T	0	2	2	0	5	7	0	0
6	11817935	.	A	T	3	2	5	0	0	5	0	0
6	11817945	.	T	C	3	2	5	0	0	5	0	0
6	11818469	.	C	G	2	2	4	0	0	4	0	0
6	11939839	.	G	A	2	6	8	0	0	8	0	0
6	11943997	.	G	A	0	3	3	0	9	12	0	0
6	11944003	.	T	G	9	3	12	0	0	12	0	0
6	11944146	.	G	C	6	9	15	0	0	15	0	0
6	11950504	.	A	C	9	3	12	0	1	13	0	0
6	11950543	.	T	A	8	3	11	0	0	11	0	0
6	11950582	.	C	A	5	3	8	0	0	8	0	0
6	11950583	.	A	G	3	3	6	0	2	8	0	0
6	11952477	.	A	C	2	10	12	0	0	12	0	0
6	11959601	.	G	A	0	2	2	0	3	5	0	0
6	11960667	.	C	T	2	7	9	0	0	9	0	0
6	11975763	.	G	A	1	4	5	0	0	5	0	0
6	11976566	.	A	T	4	8	12	0	0	12	0	0
6	11976614	.	A	G	4	6	10	0	2	12	0	0
6	11976617	.	G	A	0	6	6	0	6	12	0	0
6	11979035	.	G	C	5	6	11	0	1	12	0	0
6	11981831	.	C	G	10	0	10	0	8	18	0	0
6	11982213	.	A	C	15	15	30	0	0	30	0	0
6	11982319	.	A	T	6	10	16	0	1	17	0	0
6	11986615	.	C	T	8	7	15	0	0	15	0	0
6	11986656	.	C	G	9	9	18	0	0	18	0	0
6	11994733	.	C	T	10	12	22	0	0	22	0	0
6	11994790	.	T	C	11	12	23	0	2	25	0	0
6	12001212	.	T	C	18	23	41	0	0	41	0	0
6	12006823	.	G	A	8	8	16	0	1	17	0	0
6	12006904	.	C	T	5	7	12	0	0	12	0	0
6	12006923	.	T	C	3	6	9	0	1	10	0	0
6	12016450	.	G	A	9	6	15	0	8	23	0	0
6	12036984	.	C	T	11	10	21	0	5	26	0	0
6	12037141	.	G	A	13	13	26	0	1	27	0	0
6	12037196	.	C	T	18	9	27	0	0	27	0	0
6	12037197	.	T	G	17	9	26	0	0	26	0	0
6	12037293	.	G	T	10	10	20	0	1	21	0	0
6	12037401	.	G	A	5	11	16	0	2	18	0	0
6	12044204	.	C	T	6	9	15	0	0	15	0	0
6	12044225	.	A	G	6	7	13	0	0	13	0	0
6	12053036	.	A	T	8	11	19	0	0	19	0	0
6	12053093	.	G	C	10	5	15	1	0	16	0	0
6	12066165	.	C	T	0	2	2	0	5	7	0	0
6	12067622	.	C	T	3	2	5	0	0	5	0	0
6	12073008	.	T	C	7	6	13	0	2	15	0	0
6	12084841	.	A	G	2	2	4	0	1	5	0	0
6	12084869	.	T	C	3	2	5	0	1	6	0	0
6	12089953	.	G	A	2	2	4	0	0	4	0	0
6	12093071	.	G	A	3	3	6	0	0	6	0	0
6	12093083	.	C	T	0	2	2	0	7	9	0	0
6	12100124	.	A	G	2	3	5	0	1	6	0	0
6	12100171	.	C	T	1	5	6	0	0	6	0	0
6	12110396	.	G	T	7	7	14	0	0	14	0	0
6	12110408	.	C	T	7	8	15	0	0	15	0	0
6	12200472	.	G	T	14	10	24	0	0	24	0	0
6	12200654	.	T	A	7	2	9	0	0	9	0	0
6	12200808	.	T	A	2	8	10	1	3	14	0	0
6	12200972	.	G	T	13	10	23	0	3	26	0	0
6	12201030	.	G	A	11	14	25	0	2	27	0	0
6	12201132	.	G	A	13	14	27	0	3	30	0	0
6	12212817	.	C	T	3	16	19	0	10	29	0	0
6	12214149	.	T	C	9	12	21	0	1	22	0	0
6	12217851	.	A	G	8	12	20	1	0	21	0	0
6	12220638	.	A	G	15	9	24	0	0	24	0	0
6	12224262	.	T	A	5	8	13	0	0	13	0	0
6	12224325	.	G	C	12	7	19	0	0	19	0	0
6	12275783	.	C	T	1	4	5	0	3	8	0	0
6	12299421	.	A	G	24	30	54	0	4	58	0	0
6	12299422	.	T	C	25	28	53	0	6	59	0	0
6	12299751	.	A	G	29	33	62	1	3	66	0	0
6	12303882	.	A	G	30	22	52	0	1	53	0	0
6	12303897	.	A	G	28	23	51	0	2	53	0	0
6	12313925	.	A	T	24	20	44	3	1	48	0	0
6	12331625	.	A	C	2	2	4	0	0	4	0	0
6	12464663	.	T	C	1	2	3	0	0	3	0	0
6	12503989	.	T	G	3	3	6	0	0	6	0	0
6	12504230	.	T	C	4	4	8	0	0	8	0	0
6	12504392	.	G	C	2	2	4	2	1	7	0	0
6	12516517	.	T	C	3	2	5	0	0	5	0	0
6	12595340	.	C	G	4	8	12	0	0	12	0	0
6	12595518	.	A	G	8	9	17	0	0	17	0	0
6	12598344	.	A	G	5	7	12	0	0	12	0	0
6	12600430	.	A	T	6	4	10	0	0	10	0	0
6	12603263	.	T	G	8	8	16	0	0	16	0	0
6	12603389	.	G	T	5	2	7	0	2	9	0	0
6	12606904	.	C	A	6	4	10	0	0	10	0	0
6	12620093	.	T	A	4	3	7	0	0	7	0	0
6	12633166	.	C	T	0	2	2	0	2	4	0	0
6	12656450	.	C	T	0	2	2	0	1	3	0	0
6	12671341	.	T	C	1	2	3	0	0	3	0	0
6	12671681	.	A	G	1	2	3	0	0	3	0	0
6	12797677	.	C	T	4	6	10	0	0	10	0	0
6	12797755	.	G	A	14	10	24	0	1	25	0	0
6	12797815	.	A	G	11	13	24	0	1	25	0	0
6	12798083	.	G	T	2	4	6	0	0	6	0	0
6	12798124	.	T	C	5	2	7	0	0	7	0	0
6	12803257	.	C	A	9	3	12	0	0	12	0	0
6	12803568	.	A	G	5	2	7	0	1	8	0	0
6	12803598	.	T	C	6	3	9	0	0	9	0	0
6	12803664	.	G	A	4	6	10	0	0	10	0	0
6	12803790	.	A	G	9	7	16	0	0	16	0	0
6	12804024	.	A	T	5	5	10	0	0	10	0	0
6	12804132	.	G	A	6	4	10	0	0	10	0	0
6	12810249	.	C	G	0	2	2	0	5	7	0	0
6	12853748	.	G	A	11	10	21	0	0	21	0	0
6	14950538	.	T	A	8	4	12	0	0	12	0	0
6	14950567	.	T	C	8	7	15	0	0	15	0	0
6	14950759	.	T	C	10	10	20	0	0	20	0	0
6	14951854	.	C	T	14	14	28	0	2	30	0	0
6	14952579	.	T	C	14	7	21	0	2	23	0	0
6	14988559	.	G	T	12	9	21	0	1	22	0	0
6	15000149	.	C	T	3	8	11	0	0	11	0	0
6	15023688	.	G	A	11	10	21	0	4	25	0	0
6	15023713	.	A	G	7	11	18	0	1	19	0	0
6	15037025	.	A	G	3	4	7	0	0	7	0	0
6	15037258	.	A	G	5	5	10	0	0	10	0	0
6	15042303	.	A	T	3	2	5	0	1	6	0	0
6	15043636	.	T	A	3	3	6	0	0	6	0	0
6	15043728	.	T	G	3	3	6	0	0	6	0	0
6	15043738	.	C	T	4	3	7	0	0	7	0	0
6	15043859	.	T	C	3	3	6	0	0	6	0	0
6	15043886	.	A	T	1	3	4	0	0	4	0	0
6	15051753	.	G	A	2	3	5	0	0	5	0	0
6	15051834	.	A	G	1	2	3	0	0	3	0	0
6	15059249	.	A	G	3	4	7	1	0	8	0	0
6	15127591	.	G	A	0	2	2	0	4	6	0	0
6	15127666	.	T	G	3	0	3	0	3	6	0	0
6	15130921	.	G	A	3	2	5	0	0	5	0	0
6	15130982	.	G	A	0	2	2	0	5	7	0	0
6	15210156	.	C	T	2	3	5	0	0	5	0	0
6	15236344	.	G	A	6	5	11	0	1	12	0	0
6	15242287	.	A	T	6	6	12	0	1	13	0	0
6	15243129	.	T	C	2	3	5	0	0	5	0	0
6	15243137	.	A	C	2	1	3	0	0	3	0	0
6	15434544	.	T	A	4	12	16	0	2	18	0	0
6	15447086	.	C	T	4	3	7	0	1	8	0	0
6	15447202	.	T	C	3	2	5	0	0	5	0	0
6	15447203	.	A	G	3	0	3	0	2	5	0	0
6	15447452	.	C	A	3	5	8	0	0	8	0	0
6	15455804	.	C	A	1	2	3	0	4	7	0	0
6	15491460	.	C	A	1	2	3	0	1	4	0	0
6	15527107	.	A	G	6	5	11	0	1	12	0	0
6	15527202	.	T	C	3	3	6	0	1	7	0	0
6	15527356	.	T	C	5	8	13	0	1	14	0	0
6	15527385	.	G	A	5	9	14	0	0	14	0	0
6	15531697	.	G	A	4	3	7	0	0	7	0	0
6	15541015	.	G	A	10	9	19	0	0	19	0	0
6	15541077	.	T	C	7	6	13	0	1	14	0	0
6	15543451	.	C	T	12	4	16	0	0	16	0	0
6	15548966	.	A	G	7	7	14	0	0	14	0	0
6	15604133	.	C	T	7	4	11	0	0	11	0	0
6	15752298	.	A	C	4	1	5	0	4	9	0	0
6	15752348	.	A	G	6	6	12	0	0	12	0	0
6	15752489	.	C	T	3	2	5	0	0	5	0	0
6	15752602	.	A	G	1	6	7	0	0	7	0	0
6	15752681	.	A	C	2	2	4	0	0	4	0	0
6	15753508	.	A	C	1	1	2	0	1	3	0	0
6	16031714	.	C	T	3	2	5	0	0	5	0	0
6	16033239	.	A	G	3	5	8	0	0	8	0	0
6	16043950	.	C	T	0	7	7	0	16	23	0	0
6	16043980	.	A	G	15	7	22	0	0	22	0	0
6	16044019	.	T	C	15	0	15	0	9	24	0	0
6	16044597	.	C	T	12	7	19	0	1	20	0	0
6	16044664	.	T	C	12	13	25	0	0	25	0	0
6	16045413	.	T	C	10	9	19	0	3	22	0	0
6	16045463	.	G	C	8	0	8	0	15	23	0	0
6	16045511	.	G	A	9	11	20	0	0	20	0	0
6	16045650	.	G	A	6	10	16	0	0	16	0	0
6	16045712	.	C	T	11	13	24	0	0	24	0	0
6	16045768	.	C	G	7	10	17	0	0	17	0	0
6	16045798	.	T	C	9	9	18	0	0	18	0	0
6	16045884	.	A	G	14	9	23	0	4	27	0	0
6	16045912	.	T	C	4	0	4	0	28	32	0	0
6	16045946	.	A	C	10	9	19	1	6	26	0	0
6	16045947	.	A	T	15	9	24	1	1	26	0	0
6	16046025	.	T	A	9	17	26	0	2	28	0	0
6	16046049	.	G	T	21	8	29	0	0	29	0	0
6	16046272	.	G	T	13	8	21	0	2	23	0	0
6	16046365	.	G	A	4	2	6	1	3	10	0	0
6	16046371	.	A	T	6	2	8	1	0	9	0	0
6	16046664	.	A	G	4	8	12	0	0	12	0	0
6	16046676	.	G	A	7	5	12	0	0	12	0	0
6	16046850	.	G	A	13	17	30	0	1	31	0	0
6	16047197	.	C	T	2	15	17	0	14	31	0	0
6	16084168	.	T	C	8	7	15	0	0	15	0	0
6	16104448	.	G	T	14	6	20	0	1	21	0	0
6	16129824	.	G	T	3	6	9	0	0	9	0	0
6	16135963	.	C	T	3	5	8	0	0	8	0	0
6	16135966	.	C	T	5	3	8	0	0	8	0	0
6	16162994	.	G	A	6	3	9	0	1	10	0	0
6	16169641	.	G	A	3	8	11	0	0	11	0	0
6	16196326	.	G	A	4	6	10	0	0	10	0	0
6	16393459	.	G	T	5	2	7	0	0	7	0	0
6	16393570	.	G	T	3	5	8	0	0	8	0	0
6	16393816	.	G	C	1	3	4	0	0	4	0	0
6	16474879	.	T	C	4	3	7	0	1	8	0	0
6	16475047	.	T	A	11	7	18	0	0	18	0	0
6	16475395	.	A	C	5	9	14	0	0	14	0	0
6	16475499	.	G	A	2	6	8	0	0	8	0	0
6	16475502	.	G	T	2	6	8	0	1	9	0	0
6	16475728	.	G	A	1	12	13	0	3	16	0	0
6	16478198	.	C	A	1	7	8	0	10	18	0	0
6	16478200	.	T	G	9	8	17	0	1	18	0	0
6	16485073	.	A	T	27	20	47	0	1	48	0	0
6	16493381	.	A	T	17	14	31	0	1	32	0	0
6	16499206	.	G	A	5	9	14	0	0	14	0	0
6	16499260	.	A	G	6	5	11	0	1	12	0	0
6	16499312	.	A	G	9	0	9	0	7	16	0	0
6	16499422	.	A	G	7	5	12	0	0	12	0	0
6	16521166	.	C	A	5	5	10	0	0	10	0	0
6	16523662	.	C	T	0	2	2	0	2	4	0	0
6	16523704	.	A	G	5	4	9	0	0	9	0	0
6	16523788	.	G	A	4	4	8	0	0	8	0	0
6	16524019	.	G	A	4	2	6	0	1	7	0	0
6	16524618	.	C	G	5	4	9	0	0	9	0	0
6	16524653	.	G	A	2	5	7	0	0	7	0	0
6	16524663	.	T	C	1	6	7	0	0	7	0	0
6	16535731	.	G	C	1	5	6	0	0	6	0	0
6	16544879	.	G	A	1	2	3	0	0	3	0	0
6	16545904	.	C	T	2	2	4	0	0	4	0	0
6	16545916	.	A	G	2	2	4	0	0	4	0	0
6	16561379	.	C	T	1	2	3	0	0	3	0	0
6	16574821	.	G	C	3	2	5	0	0	5	0	0
6	16577142	.	A	G	2	2	4	0	0	4	0	0
6	16577229	.	C	T	0	3	3	0	4	7	0	0
6	16586104	.	T	C	1	3	4	0	0	4	0	0
6	16586221	.	C	T	0	4	4	0	1	5	0	0
6	16599048	.	A	G	1	2	3	0	0	3	0	0
6	16673876	.	C	T	2	2	4	0	0	4	0	0
6	16674296	.	A	G	8	13	21	0	2	23	0	0
6	16674344	.	T	A	16	15	31	1	2	34	0	0
6	16674371	.	T	C	14	9	23	3	7	33	0	0
6	16674435	.	A	C	13	14	27	2	2	31	0	0
6	16674618	.	G	A	16	12	28	0	1	29	0	0
6	16674808	.	T	C	8	11	19	0	0	19	0	0
6	16683385	.	T	C	17	11	28	0	1	29	0	0
6	16683421	.	A	G	9	11	20	0	0	20	0	0
6	16684004	.	A	G	7	5	12	0	0	12	0	0
6	16687429	.	C	A	17	10	27	0	5	32	0	0
6	16687432	.	T	A	19	10	29	0	1	30	0	0
6	16688900	.	T	C	2	6	8	0	2	10	0	0
6	16688921	.	A	G	9	6	15	0	0	15	0	0
6	16689416	.	T	A	6	4	10	0	0	10	0	0
6	16695771	.	C	T	2	2	4	0	1	5	0	0
6	16695994	.	A	C	2	3	5	0	0	5	0	0
6	16699626	.	C	G	2	2	4	0	0	4	0	0
6	16714407	.	A	G	1	2	3	0	0	3	0	0
6	16714419	.	A	G	0	2	2	0	1	3	0	0
6	16717705	.	G	A	3	3	6	0	0	6	0	0
6	17911148	.	C	T	0	2	2	0	3	5	0	0
6	18078439	.	G	A	5	3	8	0	0	8	0	0
6	18203842	.	G	A	14	18	32	0	0	32	0	0
6	18220141	.	G	A	6	5	11	0	0	11	0	0
6	18228324	.	G	A	7	4	11	0	0	11	0	0
6	18245385	.	G	A	21	14	35	0	1	36	0	0
6	18272540	.	T	C	2	4	6	0	0	6	0	0
6	18274351	.	T	A	2	2	4	0	0	4	0	0
6	18290937	.	G	A	1	2	3	0	1	4	0	0
6	18359389	.	G	A	5	13	18	0	0	18	0	0
6	18361359	.	A	T	13	10	23	0	1	24	0	0
6	18361609	.	T	C	8	7	15	0	0	15	0	0
6	18364051	.	A	T	3	2	5	0	0	5	0	0
6	18364081	.	G	A	0	3	3	0	3	6	0	0
6	18367670	.	C	A	1	2	3	0	0	3	0	0
6	18375692	.	A	C	2	3	5	0	2	7	0	0
6	18375693	.	T	C	2	5	7	0	0	7	0	0
6	18381278	.	G	A	2	5	7	0	4	11	0	0
6	18388387	.	T	G	1	7	8	0	1	9	0	0
6	18388517	.	G	C	4	2	6	0	1	7	0	0
6	18388569	.	C	T	4	5	9	0	0	9	0	0
6	18389220	.	G	A	14	5	19	0	0	19	0	0
6	18389541	.	C	T	11	13	24	0	0	24	0	0
6	18389655	.	G	A	12	5	17	0	0	17	0	0
6	18390031	.	T	A	8	7	15	0	0	15	0	0
6	18390141	.	C	T	4	3	7	0	1	8	0	0
6	18393826	.	A	T	3	4	7	0	0	7	0	0
6	18399975	.	C	T	2	4	6	0	0	6	0	0
6	18399981	.	C	T	0	3	3	0	4	7	0	0
6	18400286	.	G	T	2	2	4	0	0	5	1	0
6	18418714	.	T	G	5	2	7	0	0	7	0	0
6	18418760	.	G	A	4	3	7	0	1	8	0	0
6	18423946	.	A	C	3	3	6	0	0	6	0	0
6	18423950	.	A	T	2	3	5	0	0	5	0	0
6	18437514	.	T	G	13	0	13	0	19	32	0	0
6	18438459	.	A	G	11	11	22	0	1	23	0	0
6	18439256	.	C	A	7	11	18	0	1	19	0	0
6	18439481	.	A	T	12	8	20	0	1	21	0	0
6	18439576	.	A	G	7	14	21	0	1	22	0	0
6	18439723	.	G	A	7	7	14	0	0	14	0	0
6	18439774	.	G	A	1	4	5	0	4	9	0	0
6	18520930	.	T	A	20	16	36	0	0	36	0	0
6	18523549	.	C	A	14	13	27	0	0	27	0	0
6	18523770	.	A	T	16	15	31	0	2	33	0	0
6	18523772	.	C	G	15	12	27	0	5	32	0	0
6	18523817	.	T	A	14	6	20	0	1	21	0	0
6	18524550	.	A	G	3	4	7	0	1	8	0	0
6	18524579	.	A	G	3	5	8	0	0	8	0	0
6	18526432	.	A	G	4	5	9	0	1	10	0	0
6	18529457	.	G	A	3	4	7	0	0	7	0	0
6	18529589	.	G	A	1	3	4	0	0	4	0	0
6	18529593	.	T	G	0	2	2	0	0	2	0	0
6	18530378	.	C	T	6	4	10	0	0	10	0	0
6	18531296	.	T	G	4	2	6	0	1	7	0	0
6	18532445	.	A	T	4	3	7	0	0	7	0	0
6	18536239	.	G	T	8	8	16	0	0	16	0	0
6	18536748	.	C	T	5	6	11	0	1	12	0	0
6	18540815	.	G	T	8	9	17	0	1	18	0	0
6	18541077	.	A	G	1	2	3	0	0	3	0	0
6	18541083	.	A	G	1	2	3	0	0	3	0	0
6	18542836	.	C	A	4	3	7	0	0	7	0	0
6	18542933	.	T	C	5	4	9	0	0	9	0	0
6	18543385	.	C	T	18	10	28	0	0	28	0	0
6	18543400	.	A	G	18	9	27	0	1	28	0	0
6	18543637	.	A	G	14	8	22	0	3	25	0	0
6	18543735	.	A	G	8	8	16	0	0	16	0	0
6	18543950	.	G	T	12	7	19	0	0	19	0	0
6	18554177	.	T	G	8	4	12	0	1	14	1	0
6	18558062	.	G	A	2	3	5	0	0	5	0	0
6	18558098	.	A	G	3	3	6	0	0	6	0	0
6	18558110	.	C	G	2	3	5	0	0	5	0	0
6	18587728	.	G	A	6	3	9	0	0	9	0	0
6	18589235	.	T	C	11	3	14	0	0	14	0	0
6	18592209	.	G	A	6	5	11	0	0	11	0	0
6	18595391	.	C	A	3	2	5	0	0	5	0	0
6	18598494	.	A	T	3	6	9	0	0	9	0	0
6	18606063	.	T	C	6	7	13	0	2	15	0	0
6	18606135	.	T	G	11	10	21	0	0	21	0	0
6	18607590	.	G	A	10	19	29	0	1	30	0	0
6	18624464	.	T	A	8	3	11	0	0	11	0	0
6	18714592	.	T	G	1	2	3	0	0	3	0	0
6	18714845	.	A	C	5	4	9	0	0	9	0	0
6	18714890	.	T	A	7	10	17	0	0	17	0	0
6	18714910	.	T	C	11	5	16	0	0	16	0	0
6	18714937	.	A	G	10	5	15	0	1	16	0	0
6	18715090	.	A	G	6	6	12	0	0	12	0	0
6	18715309	.	T	C	2	0	2	0	4	6	0	0
6	18715540	.	A	G	6	2	8	0	0	8	0	0
6	18715544	.	C	T	2	6	8	0	0	8	0	0
6	18716054	.	G	A	9	6	15	0	0	15	0	0
6	18716085	.	C	T	3	9	12	0	0	12	0	0
6	18716242	.	G	A	9	4	13	0	0	13	0	0
6	18716269	.	A	G	3	7	10	0	0	10	0	0
6	18716330	.	C	T	1	7	8	0	0	8	0	0
6	18716539	.	C	T	0	3	3	0	8	11	0	0
6	18716551	.	T	C	2	8	10	0	1	11	0	0
6	18717238	.	T	A	2	2	4	0	1	5	0	0
6	18717315	.	T	C	4	5	9	0	0	9	0	0
6	18717319	.	A	T	4	4	8	0	1	9	0	0
6	18717449	.	C	A	0	2	2	0	5	7	0	0
6	18717539	.	T	C	6	0	6	0	4	10	0	0
6	18717934	.	T	C	2	2	4	0	0	4	0	0
6	18718662	.	G	A	6	2	8	0	0	8	0	0
6	18718663	.	C	T	6	2	8	0	0	8	0	0
6	18718846	.	A	T	4	4	8	0	2	10	0	0
6	18718964	.	A	G	3	2	5	0	2	7	0	0
6	18724415	.	T	A	2	2	4	0	0	4	0	0
6	18725196	.	C	T	3	4	7	0	0	7	0	0
6	18725232	.	A	G	4	3	7	0	0	7	0	0
6	18736460	.	A	G	3	2	5	0	1	6	0	0
6	18738593	.	T	A	3	3	6	0	0	6	0	0
6	18953406	.	G	C	6	4	10	0	0	10	0	0
6	19295015	.	T	A	19	19	38	0	2	40	0	0
6	19295044	.	A	T	18	13	31	0	2	33	0	0
6	19295469	.	T	C	12	1	13	0	22	35	0	0
6	19295609	.	A	T	10	17	27	0	0	27	0	0
6	19295644	.	C	T	2	15	17	0	17	34	0	0
6	19320696	.	C	T	0	2	2	0	3	5	0	0
6	19330205	.	G	A	1	1	2	0	1	3	0	0
6	19331045	.	G	A	2	2	4	0	1	5	0	0
6	19331054	.	C	T	4	2	6	0	0	6	0	0
6	19334722	.	A	C	2	4	6	0	0	6	0	0
6	19335232	.	A	G	1	2	3	0	0	3	0	0
6	19339426	.	C	T	2	5	7	0	0	7	0	0
6	19344846	.	C	T	7	16	23	0	0	23	0	0
6	19344930	.	G	C	7	5	12	0	1	13	0	0
6	19344950	.	C	T	9	6	15	0	3	18	0	0
6	19345191	.	G	A	4	9	13	1	0	14	0	0
6	19347426	.	C	T	0	9	9	0	3	12	0	0
6	19381640	.	G	T	2	5	7	0	0	7	0	0
6	19381679	.	C	G	4	6	10	0	0	10	0	0
6	19715507	.	A	C	4	7	11	0	0	11	0	0
6	19802042	.	T	C	7	12	19	0	0	19	0	0
6	19802242	.	C	T	9	9	18	0	0	18	0	0
6	19802330	.	G	A	8	9	17	0	1	18	0	0
6	19802354	.	G	A	10	6	16	0	0	16	0	0
6	19802414	.	C	G	7	0	7	0	7	14	0	0
6	19802415	.	G	A	7	7	14	0	0	14	0	0
6	19804702	.	A	C	2	5	7	0	0	7	0	0
6	19804743	.	A	T	10	3	13	0	0	13	0	0
6	19804878	.	C	T	2	8	10	0	0	10	0	0
6	19805628	.	T	C	2	3	5	0	1	6	0	0
6	19807574	.	A	G	2	1	3	0	1	4	0	0
6	19807640	.	T	C	1	0	1	0	2	3	0	0
6	19808670	.	C	T	1	3	4	0	0	4	0	0
6	19808818	.	G	A	4	4	8	0	0	8	0	0
6	20766102	.	A	T	1	2	3	0	0	3	0	0
6	20766136	.	C	T	10	5	15	0	2	17	0	0
6	20766307	.	A	G	26	8	34	0	2	36	0	0
6	20766500	.	G	T	11	4	15	0	0	15	0	0
6	20767015	.	T	A	20	15	35	0	2	37	0	0
6	20767537	.	A	G	23	22	45	0	1	46	0	0
6	20767830	.	T	G	9	3	12	0	0	12	0	0
6	20767958	.	T	G	8	9	17	0	0	17	0	0
6	20767994	.	T	C	10	10	20	0	2	22	0	0
6	20768061	.	A	G	13	11	24	0	1	25	0	0
6	20768076	.	C	A	13	7	20	0	1	22	1	0
6	20768107	.	A	T	12	7	19	0	5	24	0	0
6	20768239	.	A	G	12	7	19	2	1	22	0	0
6	20768338	.	G	A	9	17	26	0	0	27	1	0
6	20768346	.	T	G	10	19	29	0	0	29	0	0
6	20768558	.	C	G	12	12	24	0	0	24	0	0
6	20773961	.	G	A	19	13	32	0	0	32	0	0
6	20774048	.	A	C	27	8	35	0	1	36	0	0
6	20774701	.	G	A	19	10	29	0	0	29	0	0
6	20774768	.	C	T	15	7	22	0	0	22	0	0
6	20785089	.	A	G	9	6	15	0	0	15	0	0
6	20785105	.	C	T	0	7	7	0	9	16	0	0
6	20785144	.	G	A	8	11	19	0	0	19	0	0
6	20789072	.	A	G	8	10	18	0	1	19	0	0
6	20789162	.	G	A	6	8	14	0	1	15	0	0
6	20789195	.	C	T	7	8	15	0	1	16	0	0
6	20789351	.	T	C	9	6	15	0	0	15	0	0
6	20789369	.	T	A	11	4	15	0	0	15	0	0
6	20789489	.	T	C	5	6	11	0	1	12	0	0
6	20814418	.	A	G	3	3	6	0	0	6	0	0
6	20815058	.	A	T	6	2	8	0	0	8	0	0
6	20822000	.	A	G	2	3	5	0	0	5	0	0
6	20822108	.	T	C	4	5	9	1	0	10	0	0
6	20910759	.	A	T	4	4	8	0	0	8	0	0
6	20910830	.	T	C	5	6	11	0	0	11	0	0
6	20910880	.	G	A	4	5	9	0	0	9	0	0
6	20917730	.	A	T	6	4	10	0	1	11	0	0
6	20917780	.	T	A	6	7	13	0	0	13	0	0
6	20917921	.	G	A	5	14	19	0	2	21	0	0
6	20917922	.	A	C	5	15	20	0	2	22	0	0
6	20918237	.	A	G	3	11	14	0	0	14	0	0
6	20918258	.	A	G	13	2	15	1	0	16	0	0
6	20918456	.	C	A	8	9	17	0	0	17	0	0
6	20918613	.	G	T	11	5	16	0	0	16	0	0
6	20918673	.	T	C	11	3	14	0	0	14	0	0
6	20921859	.	G	A	7	4	11	0	1	12	0	0
6	20922057	.	A	T	4	8	12	0	0	12	0	0
6	20922316	.	G	C	4	0	4	0	5	9	0	0
6	20922330	.	G	A	5	4	9	0	1	10	0	0
6	20922396	.	G	A	8	6	14	0	0	14	0	0
6	20922468	.	G	A	7	5	12	0	0	12	0	0
6	20956685	.	G	T	2	2	4	0	0	4	0	0
6	20965710	.	G	A	1	3	4	0	1	5	0	0
6	20965745	.	T	A	1	4	5	0	1	6	0	0
6	20965873	.	T	A	3	4	7	0	0	7	0	0
6	20969124	.	A	T	2	4	6	0	0	6	0	0
6	20969126	.	G	T	2	4	6	0	0	6	0	0
6	20970989	.	T	A	4	5	9	0	0	9	0	0
6	20975617	.	T	C	2	3	5	0	0	5	0	0
6	20977715	.	T	C	4	3	7	0	0	7	0	0
6	20978972	.	C	T	3	3	6	0	0	6	0	0
6	20996640	.	C	T	7	6	13	0	0	13	0	0
6	20996705	.	C	T	3	4	7	0	0	7	0	0
6	20996733	.	A	C	5	2	7	0	4	11	0	0
6	20997031	.	A	T	7	6	13	0	0	13	0	0
6	21116134	.	C	G	2	5	7	0	0	7	0	0
6	21119598	.	C	T	2	2	4	0	0	4	0	0
6	21119953	.	C	A	1	3	4	0	0	4	0	0
6	21119994	.	T	C	3	4	7	0	0	7	0	0
6	21120001	.	A	G	3	4	7	0	1	8	0	0
6	21120080	.	A	G	3	4	7	0	0	7	0	0
6	21120146	.	G	C	3	3	6	0	1	7	0	0
6	21120261	.	C	T	4	4	8	0	0	8	0	0
6	21120341	.	A	C	9	4	13	0	0	13	0	0
6	21130593	.	G	A	1	3	4	0	0	4	0	0
6	21130623	.	C	T	4	3	7	0	0	7	0	0
6	21130668	.	A	C	4	2	6	0	0	6	0	0
6	21130850	.	T	G	1	4	5	0	0	5	0	0
6	21130910	.	A	T	1	2	3	0	1	4	0	0
6	21131142	.	A	T	3	8	11	0	2	13	0	0
6	21131414	.	C	A	5	6	11	0	0	11	0	0
6	21140553	.	G	T	1	2	3	0	0	3	0	0
6	21143033	.	T	C	2	4	6	0	0	6	0	0
6	21143685	.	C	T	1	7	8	0	0	8	0	0
6	21143995	.	G	A	3	5	8	0	0	8	0	0
6	21144020	.	T	G	2	4	6	0	0	6	0	0
6	21144245	.	C	T	3	3	6	0	0	6	0	0
6	21144285	.	T	C	3	2	5	0	0	5	0	0
6	21146813	.	T	G	5	0	5	0	6	11	0	0
6	21147218	.	G	A	1	6	7	0	5	12	0	0
6	21147240	.	A	G	6	5	11	0	0	11	0	0
6	21147291	.	C	A	10	7	17	0	0	17	0	0
6	21147332	.	T	A	5	5	10	0	0	10	0	0
6	21147334	.	T	A	5	5	10	0	0	10	0	0
6	21147368	.	G	A	0	7	7	0	1	8	0	0
6	21147818	.	T	C	4	7	11	0	1	12	0	0
6	21147837	.	A	G	6	7	13	0	1	14	0	0
6	21147920	.	A	C	6	10	16	0	0	16	0	0
6	21148166	.	A	T	5	7	12	0	1	13	0	0
6	21148167	.	T	C	5	7	12	0	1	13	0	0
6	21148736	.	T	A	6	4	10	0	0	10	0	0
6	21148737	.	A	T	6	4	10	0	0	10	0	0
6	21148972	.	G	C	4	7	11	0	0	11	0	0
6	21149337	.	G	A	4	15	19	0	1	20	0	0
6	21150661	.	T	C	19	16	35	0	2	37	0	0
6	21150672	.	G	A	16	15	31	0	2	33	0	0
6	21150712	.	A	T	14	18	32	0	1	33	0	0
6	21150872	.	C	T	19	22	41	0	0	41	0	0
6	21150958	.	A	G	12	15	27	0	3	30	0	0
6	21151027	.	A	G	11	10	21	0	0	21	0	0
6	21151078	.	T	C	13	14	27	0	0	27	0	0
6	21151312	.	T	C	7	5	12	0	0	12	0	0
6	21151379	.	A	C	7	10	17	0	0	17	0	0
6	21151415	.	T	C	11	9	20	0	1	21	0	0
6	21151459	.	T	C	9	12	21	0	0	21	0	0
6	21153285	.	G	A	2	16	18	0	13	31	0	0
6	21154996	.	T	A	16	12	28	0	0	28	0	0
6	21378520	.	A	T	5	2	7	0	0	7	0	0
6	21390316	.	G	A	0	4	4	0	1	5	0	0
6	21391439	.	G	A	1	2	3	0	0	3	0	0
6	21391444	.	C	T	1	2	3	0	0	3	0	0
6	21391499	.	T	A	5	3	8	0	0	8	0	0
6	21391675	.	A	G	3	3	6	0	0	6	0	0
6	21392126	.	A	G	3	2	5	0	0	5	0	0
6	21392584	.	C	A	3	3	6	0	0	6	0	0
6	21392722	.	T	C	5	2	7	0	1	8	0	0
6	21393635	.	G	A	0	5	5	0	7	12	0	0
6	21436342	.	G	A	2	3	5	0	1	6	0	0
6	21513773	.	G	C	3	2	5	0	0	5	0	0
6	21513778	.	A	G	2	5	7	0	0	7	0	0
6	21513826	.	C	A	1	4	5	0	0	5	0	0
6	21513885	.	G	T	6	3	9	0	0	9	0	0
6	21514000	.	A	T	4	3	7	0	0	7	0	0
6	21514529	.	C	T	5	3	8	0	0	8	0	0
6	21514622	.	T	G	1	3	4	0	1	5	0	0
6	21515032	.	C	T	1	2	3	0	0	3	0	0
6	21516593	.	A	G	3	3	6	0	0	6	0	0
6	21525887	.	C	A	11	9	20	0	0	20	0	0
6	21525916	.	A	G	11	12	23	0	1	24	0	0
6	21525943	.	T	A	17	12	29	0	1	30	0	0
6	21526047	.	C	A	9	4	13	0	1	14	0	0
6	21526069	.	T	C	10	0	10	0	12	22	0	0
6	21526109	.	A	G	9	14	23	0	1	24	0	0
6	21526322	.	A	G	9	10	19	0	1	20	0	0
6	21526357	.	C	T	2	12	14	0	6	20	0	0
6	21526620	.	T	C	20	10	30	0	2	32	0	0
6	21529229	.	A	G	8	10	18	0	0	18	0	0
6	21529253	.	C	A	10	13	23	0	3	26	0	0
6	21529379	.	A	T	12	22	34	0	2	36	0	0
6	21576216	.	T	G	1	2	3	0	0	3	0	0
6	21578760	.	C	T	2	2	4	0	0	4	0	0
6	21581596	.	G	T	1	2	3	0	0	3	0	0
6	21588594	.	C	A	0	9	9	0	12	21	0	0
6	21588597	.	T	G	10	7	17	0	4	21	0	0
6	21588727	.	T	A	5	5	10	0	0	10	0	0
6	21598085	.	C	T	8	10	18	0	0	18	0	0
6	21602514	.	C	T	8	17	25	1	1	27	0	0
6	21602679	.	T	G	11	12	23	0	1	24	0	0
6	21602849	.	C	A	11	7	18	0	0	18	0	0
6	21615529	.	C	T	3	4	7	0	0	7	0	0
6	21693910	.	A	G	3	12	15	0	1	16	0	0
6	21694306	.	G	A	12	12	24	0	0	24	0	0
6	21694369	.	T	A	6	14	20	0	0	20	0	0
6	21694486	.	C	A	6	9	15	0	2	18	1	0
6	21694544	.	A	G	6	11	17	0	2	19	0	0
6	21694591	.	C	A	5	6	11	0	1	12	0	0
6	21694652	.	T	A	4	10	14	0	1	15	0	0
6	21694917	.	C	A	7	3	10	0	2	12	0	0
6	21695033	.	C	A	5	4	9	0	0	9	0	0
6	21695034	.	C	T	5	4	9	0	0	9	0	0
6	21726584	.	C	T	5	3	8	0	0	8	0	0
6	21726739	.	T	G	2	3	5	0	1	6	0	0
6	21809936	.	T	A	2	3	5	0	1	6	0	0
6	21811551	.	G	A	5	3	8	0	0	8	0	0
6	21815301	.	C	A	0	2	2	0	4	6	0	0
6	21815577	.	G	A	2	2	4	0	0	4	0	0
6	21861324	.	G	T	20	17	37	0	3	40	0	0
6	21861490	.	C	A	2	10	12	0	30	42	0	0
6	21861590	.	G	T	20	10	30	0	0	30	0	0
6	21861725	.	A	T	15	7	22	0	2	24	0	0
6	21861736	.	T	G	7	11	18	0	2	20	0	0
6	21862054	.	C	A	18	16	34	0	2	36	0	0
6	21862158	.	G	C	20	14	34	0	1	35	0	0
6	21862486	.	G	A	21	20	41	0	1	42	0	0
6	21876182	.	T	C	2	2	4	0	0	4	0	0
6	21876183	.	T	C	1	2	3	0	1	4	0	0
6	21996281	.	C	A	6	4	10	0	0	10	0	0
6	21996320	.	A	G	3	5	8	0	1	9	0	0
6	21996452	.	C	A	7	5	12	0	0	12	0	0
6	21999860	.	A	T	6	6	12	0	0	12	0	0
6	22001456	.	G	A	2	4	6	0	0	6	0	0
6	22007420	.	G	A	5	4	9	0	1	10	0	0
6	22013133	.	A	G	2	4	6	0	0	6	0	0
6	22026088	.	A	G	2	0	2	0	2	4	0	0
6	22026339	.	T	A	3	3	6	0	0	6	0	0
6	22026431	.	G	C	4	3	7	0	1	8	0	0
6	22026440	.	G	A	7	2	9	0	0	9	0	0
6	22026825	.	C	A	3	3	6	0	0	6	0	0
6	22027263	.	A	G	7	0	7	0	4	11	0	0
6	22028009	.	A	T	6	5	11	0	1	12	0	0
6	22034802	.	A	G	8	7	15	0	1	16	0	0
6	22034961	.	A	C	10	6	16	0	0	16	0	0
6	22035222	.	G	A	2	10	12	0	10	22	0	0
6	22035426	.	A	G	10	6	16	0	2	18	0	0
6	22035519	.	G	A	6	6	12	0	0	12	0	0
6	22037517	.	A	G	6	2	8	0	11	19	0	0
6	22037553	.	G	A	7	7	14	0	1	15	0	0
6	22037565	.	A	G	6	0	6	0	7	13	0	0
6	22037625	.	C	T	7	5	12	0	0	12	0	0
6	22048636	.	A	G	4	2	6	0	0	6	0	0
6	22055534	.	T	C	1	0	1	0	1	2	0	0
6	22055545	.	A	G	0	2	2	0	0	2	0	0
6	22093501	.	A	G	5	2	7	0	0	7	0	0
6	22093674	.	T	A	6	8	14	0	0	14	0	0
6	22093707	.	A	G	4	4	8	0	0	8	0	0
6	22093722	.	A	G	3	7	10	0	0	10	0	0
6	22099448	.	C	T	2	7	9	0	0	9	0	0
6	22105061	.	G	C	6	8	14	0	0	14	0	0
6	22105118	.	A	T	3	5	8	0	1	9	0	0
6	22105289	.	T	G	7	10	17	0	0	17	0	0
6	22107277	.	C	T	4	7	11	0	0	11	0	0
6	22107813	.	T	G	5	0	5	0	6	11	0	0
6	22107858	.	C	T	5	10	15	0	0	15	0	0
6	22108004	.	C	G	10	5	15	0	0	15	0	0
6	22108307	.	C	A	10	7	17	0	1	18	0	0
6	22109552	.	T	G	15	0	15	0	7	22	0	0
6	22109678	.	A	T	8	8	16	0	0	16	0	0
6	22111594	.	A	G	10	12	22	0	0	22	0	0
6	22112416	.	C	T	18	13	31	0	1	32	0	0
6	22118497	.	G	C	17	39	56	0	0	56	0	0
6	22118630	.	G	A	34	16	50	3	0	53	0	0
6	22118681	.	C	T	24	12	36	0	2	38	0	0
6	22119241	.	A	T	4	8	12	0	4	17	1	0
6	22119376	.	A	C	14	19	33	0	0	33	0	0
6	22119516	.	T	C	16	22	38	0	1	39	0	0
6	22119582	.	T	C	21	12	33	0	2	35	0	0
6	22119836	.	T	A	5	6	11	0	0	11	0	0
6	22119977	.	T	A	15	12	27	0	3	30	0	0
6	22120342	.	T	A	8	5	13	0	0	13	0	0
6	22120445	.	A	G	15	5	20	0	0	20	0	0
6	22120793	.	A	G	5	10	15	0	0	15	0	0
6	22127270	.	C	T	8	4	12	0	1	13	0	0
6	22327331	.	T	C	2	4	6	0	1	7	0	0
6	22328821	.	A	G	9	0	9	0	10	19	0	0
6	22333884	.	A	T	3	6	9	0	1	10	0	0
6	22344452	.	C	T	23	24	47	0	1	48	0	0
6	22351692	.	T	C	33	24	57	0	0	57	0	0
6	22351727	.	T	C	26	22	48	0	2	50	0	0
6	22351770	.	A	C	25	25	50	0	2	52	0	0
6	22351780	.	T	A	27	23	50	0	3	53	0	0
6	22352229	.	T	C	11	7	18	0	3	21	0	0
6	22352370	.	C	T	12	8	20	0	0	20	0	0
6	22352539	.	C	T	9	27	36	0	0	36	0	0
6	22354759	.	A	G	6	5	11	0	0	11	0	0
6	22355040	.	T	C	2	0	2	0	5	7	0	0
6	22364151	.	T	C	2	2	4	0	0	4	0	0
6	22463274	.	A	C	3	2	5	0	0	5	0	0
6	22463346	.	C	T	2	4	6	0	0	6	0	0
6	22464834	.	A	G	1	0	1	0	4	5	0	0
6	22464835	.	C	A	1	4	5	0	0	5	0	0
6	22597503	.	G	A	14	11	25	0	2	27	0	0
6	22615546	.	G	A	15	18	33	0	0	33	0	0
6	22628073	.	T	G	17	10	27	0	0	27	0	0
6	22628112	.	A	G	12	6	18	0	0	18	0	0
6	22628483	.	G	A	0	15	15	0	26	41	0	0
6	22628779	.	T	C	23	18	41	0	0	41	0	0
6	22628997	.	T	G	8	0	8	0	9	17	0	0
6	22629099	.	A	T	12	3	15	0	0	15	0	0
6	22629182	.	A	G	2	2	4	0	0	4	0	0
6	22682887	.	G	C	10	3	13	0	1	14	0	0
6	22683191	.	A	G	0	4	4	8	0	12	0	0
6	22683206	.	A	G	7	4	11	3	0	14	0	0
6	22683362	.	A	G	13	6	19	0	0	19	0	0
6	22966966	.	C	A	8	4	12	0	0	12	0	0
6	23018861	.	G	A	2	6	8	0	1	9	0	0
6	23053129	.	C	T	8	6	14	0	1	15	0	0
6	23053296	.	A	G	6	3	9	0	0	9	0	0
6	23053374	.	G	A	0	6	6	0	9	15	0	0
6	23053482	.	G	C	10	4	14	0	0	14	0	0
6	23053761	.	A	G	9	5	14	0	0	14	0	0
6	23053980	.	A	T	13	9	22	0	2	24	0	0
6	23054266	.	C	T	10	13	23	1	3	27	0	0
6	23054267	.	A	G	10	12	22	1	4	27	0	0
6	23054569	.	C	T	4	6	10	0	3	13	0	0
6	23054705	.	A	G	2	1	3	0	6	9	0	0
6	23617815	.	C	T	4	3	7	0	2	9	0	0
6	23752615	.	G	A	1	2	3	0	5	8	0	0
6	23781314	.	C	T	6	3	9	0	0	9	0	0
6	23810518	.	T	C	6	6	12	0	0	12	0	0
6	23810922	.	G	C	6	9	15	0	1	16	0	0
6	23811154	.	C	T	5	9	14	0	1	15	0	0
6	23812768	.	T	A	12	9	21	0	2	23	0	0
6	23812771	.	C	G	11	8	19	0	2	21	0	0
6	23812885	.	T	C	8	10	18	0	0	18	0	0
6	23813437	.	G	C	16	10	26	0	0	26	0	0
6	23813554	.	C	A	9	16	25	0	2	27	0	0
6	23813767	.	C	A	11	14	25	0	3	28	0	0
6	23938676	.	A	C	8	6	14	0	0	14	0	0
6	23938738	.	A	G	10	10	20	0	1	21	0	0
6	24055743	.	T	A	7	13	20	0	0	20	0	0
6	24055784	.	G	A	7	10	17	0	1	18	0	0
6	24055866	.	G	T	6	7	13	0	1	14	0	0
6	24056103	.	C	T	0	10	10	0	7	17	0	0
6	24065975	.	C	G	2	9	11	0	5	16	0	0
6	24066253	.	T	C	10	0	10	0	12	22	0	0
6	24066345	.	A	G	4	7	11	0	0	11	0	0
6	24066382	.	T	A	5	14	19	0	0	19	0	0
6	24066547	.	C	T	4	4	8	0	13	21	0	0
6	24066662	.	A	T	1	3	4	0	0	4	0	0
6	24091437	.	G	T	1	2	3	0	0	3	0	0
6	24096675	.	G	A	1	2	3	0	0	3	0	0
6	24153159	.	C	T	19	24	43	0	1	44	0	0
6	24155442	.	A	T	22	16	38	0	0	38	0	0
6	24155744	.	T	C	12	16	28	0	1	29	0	0
6	24155766	.	T	C	15	14	29	0	0	29	0	0
6	24155886	.	A	C	16	0	16	0	17	33	0	0
6	24155898	.	C	T	15	16	31	0	2	33	0	0
6	24156027	.	T	C	24	22	46	0	1	47	0	0
6	24156344	.	T	G	9	10	19	0	2	21	0	0
6	24156399	.	C	G	9	12	21	0	1	22	0	0
6	24156428	.	A	T	8	16	24	0	0	24	0	0
6	24156476	.	T	G	6	13	19	0	0	19	0	0
6	24156486	.	A	C	16	5	21	0	0	21	0	0
6	24156567	.	T	C	17	0	17	0	9	26	0	0
6	24157177	.	C	T	7	4	11	0	0	11	0	0
6	24158601	.	T	C	9	0	9	0	13	22	0	0
6	24160303	.	T	C	12	11	23	0	0	23	0	0
6	24161409	.	G	A	12	15	27	0	0	27	0	0
6	24164410	.	G	T	2	2	4	0	0	4	0	0
6	24338496	.	T	A	13	16	29	0	2	31	0	0
6	24338526	.	G	A	19	11	30	0	1	31	0	0
6	24358326	.	G	A	6	8	14	0	2	16	0	0
6	24358608	.	T	A	6	2	8	0	1	9	0	0
6	24365205	.	T	A	7	4	11	0	0	11	0	0
6	24370637	.	C	T	9	8	17	0	0	17	0	0
6	24370646	.	T	C	7	8	15	0	0	15	0	0
6	24379745	.	T	C	13	8	21	0	0	21	0	0
6	24379760	.	T	C	10	6	16	0	0	16	0	0
6	24379865	.	G	A	12	12	24	0	2	26	0	0
6	24380335	.	C	A	10	11	21	0	2	23	0	0
6	24382063	.	A	T	6	4	10	0	0	10	0	0
6	24384613	.	T	C	6	8	14	0	0	14	0	0
6	24389518	.	A	T	4	6	10	0	2	12	0	0
6	24392318	.	C	T	5	5	10	0	1	11	0	0
6	24392562	.	T	C	8	0	8	0	5	13	0	0
6	24392674	.	G	T	3	4	7	0	0	7	0	0
6	24392732	.	T	C	3	3	6	0	0	6	0	0
6	24681047	.	C	T	1	2	3	0	0	3	0	0
6	24681529	.	C	T	5	3	8	0	1	9	0	0
6	24681812	.	T	A	1	3	4	0	0	4	0	0
6	24682165	.	G	C	6	3	9	0	0	9	0	0
6	24682721	.	C	T	6	11	17	0	0	17	0	0
6	24682759	.	G	T	12	7	19	0	1	20	0	0
6	24682925	.	T	C	10	4	14	0	1	15	0	0
6	24683354	.	C	T	3	5	8	0	0	8	0	0
6	24683723	.	A	T	8	3	11	0	0	11	0	0
6	24683854	.	A	G	9	0	9	0	9	18	0	0
6	24691791	.	A	T	5	5	10	0	3	13	0	0
6	24697940	.	G	C	8	8	16	0	1	17	0	0
6	24818014	.	C	T	4	2	6	0	0	6	0	0
6	24818240	.	C	A	11	11	22	0	2	24	0	0
6	24818312	.	C	G	15	11	26	0	0	26	0	0
6	25168647	.	G	C	8	7	15	0	0	15	0	0
6	25169241	.	A	T	2	4	6	0	0	6	0	0
6	25169269	.	G	A	0	4	4	0	0	4	0	0
6	25169277	.	C	T	1	2	3	0	2	5	0	0
6	25169334	.	A	C	5	2	7	0	0	7	0	0
6	25169385	.	T	A	2	2	4	0	0	4	0	0
6	25170438	.	T	C	6	6	12	0	0	12	0	0
6	25170579	.	A	G	8	4	12	0	0	12	0	0
6	25170743	.	G	A	5	5	10	0	0	10	0	0
6	25171078	.	T	A	5	4	9	0	0	9	0	0
6	25171100	.	A	G	4	5	9	0	2	11	0	0
6	25171285	.	A	G	9	5	14	0	0	14	0	0
6	25171940	.	A	G	2	3	5	0	0	5	0	0
6	25172176	.	A	T	4	3	7	0	0	7	0	0
6	25173005	.	G	A	3	4	7	0	0	7	0	0
6	25173026	.	A	G	3	3	6	0	0	6	0	0
6	25174178	.	T	C	1	0	1	0	2	3	0	0
6	25261426	.	T	A	2	3	5	0	0	5	0	0
6	25264512	.	C	T	5	3	8	0	1	9	0	0
6	25265479	.	C	T	2	2	4	0	0	4	0	0
6	25266378	.	A	T	1	2	3	0	0	3	0	0
6	25933796	.	A	G	3	2	5	0	0	5	0	0
6	25933917	.	T	C	19	4	23	0	19	42	0	0
6	25934214	.	A	G	15	9	24	0	3	31	4	0
6	25934313	.	A	T	11	21	32	0	0	32	0	0
6	26065499	.	A	C	5	7	12	0	0	13	1	0
6	26065508	.	C	A	0	6	6	0	10	16	0	0
6	26066097	.	A	T	7	6	13	0	0	13	0	0
6	26080187	.	A	G	5	9	14	0	0	14	0	0
6	26080352	.	C	T	4	8	12	0	0	12	0	0
6	26225456	.	G	A	2	8	10	0	0	10	0	0
6	26225479	.	T	G	2	7	9	0	0	9	0	0
6	26225575	.	A	C	1	0	1	0	5	6	0	0
6	26225657	.	G	C	5	4	9	0	0	9	0	0
6	26558837	.	C	T	1	21	22	0	15	37	0	0
6	26558927	.	C	T	0	17	17	0	15	32	0	0
6	26559179	.	T	C	14	0	14	0	20	34	0	0
6	26559780	.	A	G	11	8	19	0	1	20	0	0
6	26559807	.	A	G	14	14	28	0	0	28	0	0
6	26875804	.	C	A	10	13	23	0	1	24	0	0
6	26875944	.	T	A	14	15	29	0	1	30	0	0
6	26878802	.	G	A	7	8	15	0	0	15	0	0
6	26879486	.	G	T	6	5	11	0	1	12	0	0
6	26879510	.	T	C	11	6	17	0	0	17	0	0
6	26883895	.	T	G	10	8	18	0	1	19	0	0
6	27038157	.	G	A	2	2	4	0	0	4	0	0
6	27038198	.	G	A	2	1	3	0	1	4	0	0
6	27038507	.	A	T	2	2	4	0	0	4	0	0
6	27041886	.	T	C	9	10	19	1	1	21	0	0
6	27041988	.	C	T	6	8	14	1	2	17	0	0
6	27045205	.	G	A	13	13	26	0	0	26	0	0
6	27045238	.	A	G	10	10	20	0	0	20	0	0
6	27045424	.	T	C	12	1	13	0	19	32	0	0
6	27048800	.	T	A	10	17	27	0	4	31	0	0
6	27048976	.	A	G	21	10	31	0	5	36	0	0
6	27051710	.	G	A	14	19	33	0	2	35	0	0
6	27051749	.	C	T	14	18	32	0	0	32	0	0
6	27051836	.	G	A	13	6	19	0	0	19	0	0
6	27055569	.	T	C	5	11	16	0	0	16	0	0
6	27057438	.	A	G	3	11	14	0	1	15	0	0
6	27057561	.	A	G	7	6	13	0	2	15	0	0
6	27057586	.	T	C	14	6	20	0	0	20	0	0
6	27057598	.	A	T	13	7	20	0	0	20	0	0
6	27067473	.	G	A	2	3	5	0	0	5	0	0
6	27067485	.	C	G	3	3	6	0	0	6	0	0
6	27067560	.	C	T	1	3	4	0	0	4	0	0
6	27087515	.	T	A	4	5	9	0	0	9	0	0
6	27087776	.	A	G	4	4	8	0	0	8	0	0
6	27087788	.	C	T	2	5	7	0	0	7	0	0
6	27087827	.	A	T	1	2	3	0	0	3	0	0
6	27087843	.	A	G	3	2	5	0	0	5	0	0
6	27087875	.	G	A	2	1	3	0	0	3	0	0
6	27087884	.	C	T	3	3	6	0	0	6	0	0
6	27087929	.	T	C	2	4	6	0	0	6	0	0
6	27088076	.	G	C	9	7	16	0	1	17	0	0
6	27088260	.	A	G	5	7	12	0	0	12	0	0
6	27092237	.	A	T	3	3	6	0	0	6	0	0
6	27092370	.	G	A	0	4	4	0	6	10	0	0
6	27099004	.	T	C	3	7	10	0	0	10	0	0
6	27099061	.	G	A	5	6	11	0	0	11	0	0
6	27101393	.	A	G	5	0	5	0	6	11	0	0
6	27104458	.	G	C	12	7	19	0	0	19	0	0
6	27104584	.	T	C	11	10	21	0	2	23	0	0
6	27104752	.	A	G	5	5	10	0	1	11	0	0
6	27104898	.	A	T	2	4	6	0	0	6	0	0
6	27104906	.	C	G	2	4	6	0	0	6	0	0
6	27106554	.	G	A	3	3	6	0	0	6	0	0
6	27106952	.	A	G	2	2	4	0	0	4	0	0
6	27108673	.	C	A	1	3	4	0	0	4	0	0
6	27146872	.	C	T	4	4	8	0	0	8	0	0
6	27146902	.	C	T	5	2	7	0	0	7	0	0
6	27146933	.	C	T	2	1	3	0	0	3	0	0
6	27146992	.	T	C	2	3	5	0	0	5	0	0
6	27216458	.	T	A	11	6	17	0	1	18	0	0
6	27220245	.	C	T	12	12	24	0	0	24	0	0
6	27231706	.	G	A	1	9	10	0	12	22	0	0
6	27233775	.	G	A	1	13	14	0	8	22	0	0
6	27234032	.	T	G	12	8	20	0	0	20	0	0
6	27234250	.	C	T	15	16	31	0	1	32	0	0
6	27234414	.	A	G	11	16	27	0	3	30	0	0
6	27259107	.	T	A	17	7	24	0	0	24	0	0
6	27261772	.	A	C	11	1	12	0	30	42	0	0
6	27265434	.	C	T	19	19	38	0	0	38	0	0
6	27269862	.	G	A	2	18	20	0	14	34	0	0
6	27269873	.	C	T	21	12	33	0	1	34	0	0
6	27269902	.	T	A	20	19	39	0	0	39	0	0
6	27270389	.	C	A	9	15	24	0	1	25	0	0
6	27270548	.	G	A	27	19	46	0	1	47	0	0
6	27270738	.	A	G	19	1	20	0	15	35	0	0
6	27270959	.	C	A	13	8	21	0	7	28	0	0
6	27271208	.	A	G	24	4	28	0	27	55	0	0
6	27271215	.	A	G	41	14	55	0	1	56	0	0
6	27271409	.	G	A	35	13	48	0	0	48	0	0
6	27271443	.	G	A	30	21	51	0	0	51	0	0
6	27271498	.	C	T	16	21	37	0	2	39	0	0
6	27271543	.	C	T	18	13	31	0	3	34	0	0
6	27271610	.	A	T	23	17	40	0	0	40	0	0
6	27271617	.	G	A	22	18	40	0	0	40	0	0
6	27271803	.	A	G	36	13	49	0	8	57	0	0
6	27271813	.	A	G	40	14	54	0	1	55	0	0
6	27272205	.	G	C	22	25	47	0	0	47	0	0
6	27272440	.	C	T	13	25	38	0	1	39	0	0
6	27272487	.	A	T	24	17	41	0	0	41	0	0
6	27272488	.	T	C	24	17	41	0	0	41	0	0
6	27272623	.	A	G	17	28	45	0	3	48	0	0
6	27272660	.	C	G	21	20	41	0	2	43	0	0
6	27272835	.	G	T	21	16	37	0	1	38	0	0
6	27277994	.	C	T	1	3	4	0	0	4	0	0
6	27450095	.	A	G	1	4	5	0	0	5	0	0
6	27578216	.	C	T	1	4	5	0	0	5	0	0
6	27613633	.	C	T	1	2	3	0	0	3	0	0
6	27614989	.	A	T	6	5	11	0	1	12	0	0
6	27614993	.	T	C	5	5	10	0	0	10	0	0
6	27615132	.	T	A	2	2	4	0	0	4	0	0
6	27615242	.	A	C	3	2	5	0	0	5	0	0
6	27664008	.	G	A	0	2	2	0	1	3	0	0
6	27667415	.	A	C	26	17	43	0	3	47	1	0
6	27775416	.	T	A	23	16	39	0	4	43	0	0
6	27874674	.	T	C	16	21	37	0	0	37	0	0
6	27874680	.	C	G	14	22	36	0	1	37	0	0
6	27874730	.	A	G	11	1	12	0	18	30	0	0
6	27874753	.	G	C	1	14	15	0	6	21	0	0
6	27874769	.	T	A	9	8	17	0	0	17	0	0
6	27874896	.	T	A	29	8	37	0	1	38	0	0
6	27875309	.	T	C	25	23	48	0	4	52	0	0
6	27875383	.	G	T	28	31	59	0	2	61	0	0
6	27875519	.	G	T	26	28	54	1	1	56	0	0
6	27875598	.	T	C	0	44	44	0	4	48	0	0
6	27875600	.	A	C	59	0	59	1	1	62	1	0
6	27875873	.	A	G	26	21	47	0	0	47	0	0
6	27876060	.	T	A	31	30	61	0	0	62	1	0
6	27876134	.	C	T	27	24	51	0	2	53	0	0
6	27884878	.	C	T	1	2	3	0	0	4	1	0
6	27922994	.	A	T	1	2	3	0	0	3	0	0
6	27922995	.	G	A	1	2	3	0	0	3	0	0
6	27997333	.	C	T	1	5	6	0	0	6	0	0
6	27998329	.	C	A	7	3	10	0	0	10	0	0
6	27999645	.	C	T	1	4	5	0	0	5	0	0
6	27999744	.	A	C	4	9	13	0	0	13	0	0
6	28000242	.	T	A	7	8	15	0	0	15	0	0
6	28000316	.	G	A	1	5	6	0	5	11	0	0
6	28000768	.	G	T	5	6	11	0	0	11	0	0
6	28031468	.	G	A	6	6	12	0	0	12	0	0
6	28031474	.	T	C	6	7	13	0	0	13	0	0
6	28036311	.	C	T	10	5	15	0	1	16	0	0
6	28036714	.	A	G	2	0	2	0	4	6	0	0
6	28039034	.	C	T	5	8	13	0	0	13	0	0
6	28039175	.	T	A	6	4	10	0	1	11	0	0
6	28041161	.	G	A	1	8	9	0	1	10	0	0
6	28044401	.	A	G	3	8	11	0	2	13	0	0
6	28048870	.	C	T	5	4	9	0	0	9	0	0
6	28048923	.	C	A	3	3	6	0	2	8	0	0
6	28125286	.	A	C	2	2	4	0	0	4	0	0
6	28206124	.	T	C	12	9	21	0	0	21	0	0
6	28206442	.	G	A	5	10	15	0	0	15	0	0
6	28207340	.	C	T	11	9	20	0	0	20	0	0
6	28207418	.	C	G	10	8	18	0	0	18	0	0
6	28207532	.	C	A	2	3	5	0	1	6	0	0
6	28207534	.	A	G	3	3	6	0	0	6	0	0
6	28207593	.	A	G	1	5	6	0	1	7	0	0
6	28217596	.	C	T	0	10	10	0	8	18	0	0
6	28218159	.	G	T	5	7	12	0	1	13	0	0
6	28218555	.	T	G	8	6	14	0	0	14	0	0
6	28223781	.	C	A	2	2	4	0	0	4	0	0
6	28223810	.	C	A	2	2	4	0	0	4	0	0
6	28224044	.	T	A	2	2	4	0	0	4	0	0
6	28914331	.	A	G	10	4	14	0	0	14	0	0
6	28914336	.	C	T	4	9	13	0	1	14	0	0
6	28914418	.	A	G	13	12	25	0	0	25	0	0
6	28914523	.	G	A	17	10	27	0	1	28	0	0
6	28914571	.	T	A	22	11	33	0	0	33	0	0
6	28914886	.	G	A	6	6	12	0	0	12	0	0
6	28914975	.	T	A	13	16	29	0	2	31	0	0
6	28923667	.	G	A	8	8	16	0	0	16	0	0
6	28926540	.	C	T	6	7	13	0	1	14	0	0
6	28926567	.	T	A	6	5	11	0	1	12	0	0
6	28931184	.	C	T	7	6	13	0	0	13	0	0
6	28932634	.	G	A	6	6	12	0	1	13	0	0
6	28946199	.	T	G	20	23	43	0	3	46	0	0
6	28956323	.	A	G	14	12	26	0	0	26	0	0
6	28957089	.	G	A	11	9	20	0	0	20	0	0
6	28957814	.	C	G	7	13	20	0	0	20	0	0
6	28961407	.	A	G	13	12	25	0	0	25	0	0
6	29011988	.	C	T	9	6	15	0	0	15	0	0
6	29012037	.	A	T	5	7	12	0	1	13	0	0
6	29034576	.	G	C	14	7	21	1	0	22	0	0
6	29040789	.	C	T	0	3	3	0	11	14	0	0
6	29040885	.	C	T	0	9	9	0	8	17	0	0
6	29043162	.	T	G	7	3	10	0	0	10	0	0
6	29043673	.	G	A	4	4	8	0	0	8	0	0
6	29044465	.	A	G	4	2	6	0	0	6	0	0
6	29044900	.	G	A	5	3	8	0	0	8	0	0
6	29044933	.	A	G	2	3	5	0	0	5	0	0
6	29085397	.	A	T	2	3	5	0	0	5	0	0
6	29086613	.	C	T	1	6	7	0	0	7	0	0
6	29087164	.	T	G	23	29	52	0	4	56	0	0
6	29096659	.	A	C	33	28	61	0	2	63	0	0
6	29097297	.	G	A	16	31	47	0	2	49	0	0
6	29097344	.	T	C	8	13	21	0	2	23	0	0
6	29105698	.	C	T	3	4	7	0	0	7	0	0
6	29108423	.	T	G	1	4	5	0	0	5	0	0
6	29143365	.	A	T	2	4	6	0	0	6	0	0
6	29144951	.	T	A	7	2	9	0	0	9	0	0
6	29144952	.	A	T	6	2	8	0	1	9	0	0
6	29145433	.	C	A	1	10	11	0	6	17	0	0
6	29145742	.	T	A	10	10	20	1	0	21	0	0
6	29152208	.	C	T	8	5	13	0	0	13	0	0
6	29152334	.	G	A	1	5	6	0	1	7	0	0
6	29152618	.	A	G	4	3	7	0	0	7	0	0
6	29152769	.	G	A	3	5	8	0	0	8	0	0
6	29152819	.	C	T	5	7	12	0	0	12	0	0
6	29154280	.	T	A	3	3	6	0	0	6	0	0
6	29154295	.	T	C	4	0	4	0	6	10	0	0
6	29154520	.	C	T	4	5	9	0	0	9	0	0
6	29154721	.	G	A	3	5	8	0	0	8	0	0
6	29154889	.	C	A	3	2	5	0	1	6	0	0
6	29155039	.	G	A	2	3	5	0	0	5	0	0
6	29159851	.	G	A	4	3	7	0	4	11	0	0
6	29221040	.	C	T	8	9	17	0	0	17	0	0
6	29222796	.	A	C	9	10	19	0	1	20	0	0
6	29223651	.	T	C	11	18	29	0	1	30	0	0
6	29226126	.	G	A	0	19	19	0	11	30	0	0
6	29226186	.	A	G	17	15	32	0	0	32	0	0
6	29226189	.	C	T	16	16	32	0	1	33	0	0
6	29226767	.	A	T	14	13	27	1	4	32	0	0
6	29226790	.	G	A	10	19	29	1	2	32	0	0
6	29226823	.	A	C	14	10	24	0	1	25	0	0
6	29273690	.	C	T	6	3	9	0	2	11	0	0
6	29273855	.	G	A	12	4	16	0	2	18	0	0
6	29278868	.	T	G	3	10	13	0	1	14	0	0
6	29278874	.	G	A	4	10	14	0	0	14	0	0
6	29287954	.	G	A	11	3	14	0	0	14	0	0
6	29288619	.	C	A	1	3	4	0	0	4	0	0
6	29288635	.	T	C	0	5	5	0	0	5	0	0
6	29289386	.	G	A	1	5	6	0	1	7	0	0
6	29289437	.	G	A	1	5	6	0	0	6	0	0
6	29289625	.	G	A	2	2	4	0	0	4	0	0
6	29289844	.	A	T	3	3	6	0	0	6	0	0
6	29289883	.	C	T	4	4	8	0	1	9	0	0
6	29291666	.	G	A	6	7	13	0	1	14	0	0
6	29292610	.	A	C	2	5	7	0	0	7	0	0
6	29292728	.	C	T	4	3	7	0	1	8	0	0
6	29292780	.	G	A	7	4	11	0	0	11	0	0
6	29292804	.	G	A	8	3	11	0	1	12	0	0
6	29295492	.	T	A	10	10	20	0	2	22	0	0
6	29295517	.	G	C	10	10	20	0	0	20	0	0
6	29295535	.	T	A	8	9	17	0	2	19	0	0
6	29295713	.	C	A	8	8	16	0	1	17	0	0
6	29295714	.	G	A	8	9	17	0	0	17	0	0
6	29295851	.	G	A	8	12	20	0	0	20	0	0
6	29295860	.	C	T	7	12	19	0	1	20	0	0
6	29303573	.	C	T	5	6	11	0	0	11	0	0
6	29303625	.	G	A	6	6	12	0	1	13	0	0
6	29303630	.	G	A	7	5	12	0	0	12	0	0
6	29303778	.	C	T	2	5	7	0	5	12	0	0
6	29303925	.	C	T	6	5	11	0	1	12	0	0
6	29303958	.	C	T	0	8	8	0	10	18	0	0
6	29305073	.	G	A	9	6	15	0	0	15	0	0
6	29322547	.	G	A	7	11	18	0	1	19	0	0
6	29328308	.	G	A	6	4	10	0	0	10	0	0
6	29328524	.	A	G	9	6	15	0	0	15	0	0
6	29328866	.	G	A	3	3	6	0	0	6	0	0
6	29330676	.	G	A	2	3	5	0	0	5	0	0
6	29330727	.	A	G	6	3	9	0	0	9	0	0
6	29332546	.	A	T	4	6	10	0	0	10	0	0
6	29336100	.	T	C	5	4	9	0	0	9	0	0
6	29337926	.	A	G	6	2	8	0	0	8	0	0
6	29343892	.	G	A	5	6	11	0	0	11	0	0
6	29393714	.	C	T	5	7	12	0	2	14	0	0
6	29394244	.	A	T	9	9	18	0	0	18	0	0
6	29395424	.	G	A	4	12	16	0	1	17	0	0
6	29395497	.	T	A	7	6	13	0	1	14	0	0
6	29397697	.	G	A	3	5	8	0	1	9	0	0
6	29401837	.	T	C	8	10	18	0	0	18	0	0
6	29402451	.	C	A	1	5	6	0	10	16	0	0
6	29403052	.	G	T	0	13	13	0	10	23	0	0
6	29403076	.	C	T	15	14	29	0	2	31	0	0
6	29410040	.	C	T	2	4	6	0	0	6	0	0
6	29466626	.	C	A	3	5	8	0	1	9	0	0
6	29466897	.	A	C	1	2	3	0	0	3	0	0
6	29466968	.	G	T	1	3	4	0	1	5	0	0
6	29466993	.	T	A	1	3	4	0	0	4	0	0
6	29467475	.	A	G	1	2	3	0	0	3	0	0
6	29468320	.	C	T	7	4	11	0	1	12	0	0
6	29468331	.	A	T	7	3	10	0	1	11	0	0
6	29468671	.	A	G	3	3	6	0	1	7	0	0
6	29476983	.	C	A	4	3	7	1	0	8	0	0
6	29477187	.	G	A	5	4	9	0	0	9	0	0
6	29477405	.	T	A	3	3	6	0	0	6	0	0
6	29477526	.	C	T	3	4	7	0	1	8	0	0
6	29477739	.	C	T	2	2	4	0	0	4	0	0
6	29477962	.	C	T	5	3	8	0	0	8	0	0
6	29477989	.	C	T	1	2	3	0	2	5	0	0
6	29536069	.	G	A	1	3	4	0	1	5	0	0
6	29612067	.	G	A	1	2	3	0	1	4	0	0
6	29705343	.	C	T	18	8	26	0	1	27	0	0
6	29705561	.	A	T	10	9	19	0	1	20	0	0
6	29705588	.	C	T	1	12	13	0	2	15	0	0
6	29705614	.	G	A	2	8	10	0	0	10	0	0
6	29708100	.	C	T	9	12	21	0	0	21	0	0
6	29710252	.	T	C	8	12	20	0	2	22	0	0
6	29713920	.	G	T	6	6	12	0	1	13	0	0
6	29713926	.	T	C	7	8	15	0	1	16	0	0
6	29714017	.	A	G	7	5	12	0	2	14	0	0
6	29714054	.	A	C	5	2	7	0	0	7	0	0
6	29714064	.	C	T	4	3	7	0	1	8	0	0
6	29793814	.	C	T	33	39	72	0	5	77	0	0
6	29794003	.	T	G	31	41	72	0	6	78	0	0
6	29794695	.	T	C	32	28	60	0	3	63	0	0
6	30027896	.	C	A	18	15	33	0	1	34	0	0
6	30032574	.	A	G	13	0	13	1	11	25	0	0
6	30048285	.	A	G	10	0	10	0	8	18	0	0
6	30052061	.	C	A	21	21	42	0	1	43	0	0
6	30052085	.	A	G	24	20	44	0	2	46	0	0
6	30060296	.	C	T	13	25	38	0	0	38	0	0
6	30081420	.	C	T	11	15	26	0	10	36	0	0
6	30081421	.	T	C	14	14	28	0	8	36	0	0
6	30081503	.	A	G	23	13	36	0	0	36	0	0
6	30081725	.	C	T	19	16	35	0	4	39	0	0
6	30082838	.	G	T	10	6	16	0	2	18	0	0
6	30124575	.	C	T	17	16	33	0	1	34	0	0
6	30133958	.	G	T	19	14	33	0	9	42	0	0
6	30134052	.	C	T	2	6	8	0	31	39	0	0
6	30147249	.	T	C	19	2	21	0	13	34	0	0
6	30148182	.	G	A	10	9	19	0	1	20	0	0
6	30148422	.	C	T	9	11	20	0	1	21	0	0
6	30148863	.	T	C	14	10	24	0	2	26	0	0
6	30151519	.	G	A	10	12	22	0	1	23	0	0
6	30151537	.	G	A	15	12	27	0	0	27	0	0
6	30160956	.	C	T	12	7	19	0	1	20	0	0
6	30177635	.	G	A	9	5	14	0	0	14	0	0
6	30177724	.	G	A	7	3	10	0	0	10	0	0
6	30177742	.	T	C	4	5	9	0	1	10	0	0
6	30432533	.	T	G	1	4	5	0	0	5	0	0
6	30433337	.	T	A	1	3	4	0	0	4	0	0
6	30440099	.	A	C	1	3	4	0	1	5	0	0
6	30441589	.	C	G	1	3	4	0	0	4	0	0
6	30450458	.	T	C	3	8	11	0	0	11	0	0
6	30452540	.	T	G	6	0	6	0	5	11	0	0
6	30452573	.	C	T	5	3	8	0	0	8	0	0
6	30452669	.	A	T	2	3	5	0	0	5	0	0
6	30452932	.	G	C	4	4	8	0	0	8	0	0
6	30576901	.	C	T	2	3	5	0	0	5	0	0
6	30579371	.	A	T	2	2	4	0	0	4	0	0
6	30583815	.	A	G	2	3	5	0	0	5	0	0
6	30587201	.	T	A	4	4	8	0	0	8	0	0
6	30592556	.	T	C	1	2	3	0	0	3	0	0
6	30592558	.	A	T	1	2	3	0	0	3	0	0
6	30626630	.	T	G	10	10	20	0	1	21	0	0
6	30626908	.	G	A	8	10	18	0	0	18	0	0
6	30626931	.	T	C	9	8	17	0	1	18	0	0
6	30627182	.	T	A	12	11	23	0	1	24	0	0
6	30627228	.	A	C	19	13	32	0	1	33	0	0
6	30627549	.	G	A	15	10	25	0	1	26	0	0
6	30627674	.	G	T	13	8	21	0	1	22	0	0
6	30627764	.	G	T	16	13	29	0	1	30	0	0
6	30627807	.	G	T	7	16	23	0	1	24	0	0
6	30627811	.	T	C	15	6	21	0	2	23	0	0
6	30628066	.	T	C	8	15	23	0	0	23	0	0
6	30628097	.	C	T	16	15	31	0	1	32	0	0
6	30628185	.	G	A	6	7	13	0	1	14	0	0
6	30628447	.	G	A	9	5	14	0	0	14	0	0
6	30628459	.	A	G	9	5	14	0	0	14	0	0
6	30628540	.	T	C	8	1	9	0	6	15	0	0
6	30628651	.	G	A	10	3	13	0	0	13	0	0
6	30628684	.	C	A	14	7	21	0	0	21	0	0
6	30628848	.	C	T	10	7	17	0	1	18	0	0
6	30628976	.	T	A	8	14	22	0	0	22	0	0
6	30628978	.	C	T	16	8	24	0	0	24	0	0
6	30629142	.	G	A	13	4	17	0	0	17	0	0
6	30629229	.	T	A	4	9	13	0	0	13	0	0
6	30629384	.	T	C	6	0	6	0	11	17	0	0
6	30629553	.	C	T	0	3	3	0	6	9	0	0
6	30629723	.	T	C	3	3	6	0	0	6	0	0
6	30629734	.	A	G	2	3	5	0	0	5	0	0
6	30629827	.	C	A	6	4	10	0	0	10	0	0
6	30629988	.	C	A	7	4	11	0	0	11	0	0
6	30630057	.	G	A	3	2	5	0	0	5	0	0
6	30630163	.	G	A	1	2	3	0	0	3	0	0
6	30630171	.	C	T	0	2	2	0	1	3	0	0
6	30630454	.	T	G	3	7	10	0	1	11	0	0
6	30630811	.	T	C	8	7	15	0	0	15	0	0
6	30630904	.	A	G	6	5	11	0	0	11	0	0
6	30658102	.	T	C	7	3	10	0	1	11	0	0
6	30658524	.	T	C	7	6	13	0	0	13	0	0
6	30658545	.	G	A	9	5	14	0	0	14	0	0
6	30658728	.	A	C	4	4	8	0	0	8	0	0
6	30677307	.	T	A	2	2	4	0	1	5	0	0
6	30677330	.	G	A	1	4	5	0	1	6	0	0
6	30677347	.	G	T	4	2	6	0	2	8	0	0
6	30677475	.	A	G	2	5	7	0	0	7	0	0
6	30677646	.	A	G	4	12	16	0	0	16	0	0
6	30677701	.	C	T	1	10	11	0	2	13	0	0
6	30678396	.	T	C	3	2	5	0	0	5	0	0
6	30678406	.	C	A	1	3	4	0	1	5	0	0
6	30681291	.	C	A	6	5	11	0	0	11	0	0
6	30683571	.	T	A	4	2	6	0	0	6	0	0
6	30683578	.	T	C	4	2	6	0	0	6	0	0
6	30685027	.	T	C	4	8	12	0	0	12	0	0
6	30685311	.	A	G	2	3	5	0	0	5	0	0
6	30685353	.	T	C	4	3	7	0	0	7	0	0
6	30685354	.	G	A	4	3	7	0	0	7	0	0
6	30688021	.	A	G	2	3	5	0	0	5	0	0
6	30704079	.	G	A	0	2	2	0	2	4	0	0
6	30704115	.	C	T	2	2	4	0	0	4	0	0
6	30710313	.	C	A	26	25	51	0	3	54	0	0
6	30711447	.	C	T	10	7	17	0	0	17	0	0
6	30711485	.	A	T	14	14	28	0	1	29	0	0
6	30711511	.	C	T	14	23	37	0	0	37	0	0
6	30711554	.	C	T	2	16	18	0	19	37	0	0
6	30711586	.	A	C	22	1	23	0	16	39	0	0
6	30711612	.	G	A	24	17	41	0	1	42	0	0
6	30711777	.	C	T	10	16	26	1	1	28	0	0
6	30712121	.	G	T	26	17	43	0	2	45	0	0
6	30712458	.	A	G	10	3	13	0	1	14	0	0
6	30712508	.	G	A	11	6	17	0	3	20	0	0
6	30712616	.	C	T	2	6	8	0	17	25	0	0
6	30712622	.	A	G	16	8	24	2	1	27	0	0
6	30712917	.	G	A	22	8	30	0	1	31	0	0
6	30713184	.	T	A	4	15	19	2	0	21	0	0
6	30713334	.	G	C	9	10	19	1	1	21	0	0
6	30713341	.	G	A	14	8	22	1	1	24	0	0
6	30713910	.	C	T	15	25	40	0	4	44	0	0
6	30713929	.	C	G	27	17	44	0	1	45	0	0
6	30714177	.	T	A	13	13	26	0	1	27	0	0
6	30714218	.	T	A	20	8	28	0	1	29	0	0
6	30714240	.	T	C	12	9	21	0	0	21	0	0
6	30715647	.	A	T	13	10	23	0	0	23	0	0
6	30715865	.	A	T	17	10	27	0	3	30	0	0
6	30719348	.	G	C	8	14	22	0	0	22	0	0
6	30719391	.	A	T	13	10	23	0	3	26	0	0
6	30719935	.	C	T	12	9	21	0	0	21	0	0
6	30721397	.	G	A	9	16	25	0	1	26	0	0
6	30740160	.	C	A	0	3	3	0	5	8	0	0
6	30851611	.	A	T	4	4	8	0	0	8	0	0
6	30853053	.	T	A	37	26	63	0	3	66	0	0
6	30855423	.	G	A	17	14	31	0	0	31	0	0
6	30859381	.	T	A	20	16	36	0	0	36	0	0
6	30931362	.	C	T	0	4	4	0	2	6	0	0
6	30931476	.	A	T	6	4	10	0	0	10	0	0
6	30931479	.	T	C	6	0	6	0	4	10	0	0
6	31184478	.	A	G	6	2	8	0	0	8	0	0
6	31184600	.	T	G	6	2	8	2	0	10	0	0
6	31184952	.	T	C	3	3	6	0	0	6	0	0
6	31185133	.	G	A	5	6	11	0	0	11	0	0
6	31185247	.	C	G	6	5	11	0	0	11	0	0
6	31185292	.	A	C	4	3	7	0	0	7	0	0
6	31185760	.	T	A	4	2	6	0	1	7	0	0
6	31185825	.	A	T	1	3	4	0	1	5	0	0
6	31186737	.	A	C	2	3	5	0	0	5	0	0
6	31186794	.	G	A	3	3	6	0	0	6	0	0
6	31186981	.	G	A	7	7	14	0	0	14	0	0
6	31198869	.	G	A	0	3	3	0	0	3	0	0
6	31198876	.	T	A	1	3	4	0	0	4	0	0
6	31279834	.	G	A	18	13	31	0	0	31	0	0
6	31280141	.	G	A	27	16	43	0	2	45	0	0
6	31280185	.	T	A	31	14	45	0	0	45	0	0
6	31280495	.	C	T	18	16	34	1	0	35	0	0
6	31280586	.	A	G	16	15	31	0	2	33	0	0
6	31280645	.	C	A	0	5	5	0	1	15	9	0
6	31280936	.	A	T	13	12	25	0	3	28	0	0
6	31281006	.	C	T	2	12	14	0	15	29	0	0
6	31281130	.	A	G	21	25	46	0	1	47	0	0
6	31281304	.	C	A	19	19	38	0	3	41	0	0
6	31281481	.	A	G	2	3	5	0	0	5	0	0
6	31281533	.	T	A	6	7	13	0	0	13	0	0
6	31281537	.	A	G	7	8	15	0	0	15	0	0
6	31281594	.	A	T	11	9	20	0	1	21	0	0
6	31281994	.	T	A	14	10	24	0	0	24	0	0
6	31282028	.	T	G	9	8	17	0	1	18	0	0
6	31282118	.	T	G	3	2	5	0	0	5	0	0
6	31282170	.	T	C	8	1	9	0	4	13	0	0
6	31282205	.	C	T	10	7	17	0	1	18	0	0
6	31282710	.	A	T	1	2	3	1	0	4	0	0
6	31283049	.	C	A	5	4	9	0	2	11	0	0
6	31283055	.	G	A	7	5	12	0	0	12	0	0
6	31283245	.	A	G	12	10	22	0	2	24	0	0
6	31283280	.	T	A	9	11	20	0	2	22	0	0
6	31309823	.	C	T	0	11	11	0	9	20	0	0
6	31336156	.	G	A	4	6	10	0	3	13	0	0
6	31352298	.	T	A	11	8	19	0	1	21	1	0
6	31352556	.	G	A	3	4	7	0	0	7	0	0
6	31352664	.	C	T	2	2	4	0	0	4	0	0
6	31353022	.	G	C	12	5	17	0	0	17	0	0
6	31353073	.	T	C	11	4	15	0	0	15	0	0
6	31353345	.	T	A	16	10	26	0	0	26	0	0
6	31353451	.	A	T	6	12	18	0	0	18	0	0
6	31355787	.	C	T	15	8	23	0	0	23	0	0
6	31358525	.	C	T	0	12	12	0	17	29	0	0
6	31394453	.	A	C	1	1	2	0	0	2	0	0
6	31395724	.	T	C	1	3	4	0	0	4	0	0
6	31395746	.	C	T	1	3	4	0	0	4	0	0
6	31395835	.	G	A	5	4	9	0	0	9	0	0
6	31411751	.	C	T	4	3	7	0	0	7	0	0
6	31414061	.	A	C	4	2	6	0	0	6	0	0
6	31417667	.	C	T	5	5	10	0	1	11	0	0
6	31419749	.	T	C	2	5	7	0	1	8	0	0
6	31426246	.	A	G	9	1	10	0	9	19	0	0
6	31426727	.	C	G	7	10	17	0	2	19	0	0
6	31426881	.	C	T	7	8	15	0	1	16	0	0
6	31426886	.	C	T	10	8	18	0	0	18	0	0
6	31427226	.	C	T	3	2	5	0	0	5	0	0
6	31427261	.	T	C	7	3	10	0	0	10	0	0
6	31427468	.	A	G	5	11	16	0	1	17	0	0
6	31427646	.	A	T	4	6	10	0	1	11	0	0
6	31427815	.	G	T	1	7	8	0	9	17	0	0
6	31428283	.	C	A	17	11	28	1	1	30	0	0
6	31428565	.	T	G	6	5	11	0	2	13	0	0
6	31428566	.	A	G	8	5	13	0	0	13	0	0
6	31428705	.	C	T	17	6	23	0	1	24	0	0
6	31428980	.	C	G	5	0	5	1	4	10	0	0
6	31431145	.	T	G	3	2	5	0	0	5	0	0
6	31431355	.	G	A	9	12	21	0	2	23	0	0
6	31431520	.	A	G	18	16	34	0	2	36	0	0
6	31431775	.	T	C	18	11	29	0	4	33	0	0
6	31431870	.	G	A	18	10	28	0	0	28	0	0
6	31431926	.	A	T	20	17	37	0	2	39	0	0
6	31432302	.	G	A	6	5	11	0	0	11	0	0
6	31432554	.	A	T	4	4	8	0	0	8	0	0
6	31432563	.	T	C	5	4	9	0	0	9	0	0
6	31432617	.	T	G	3	4	7	0	0	7	0	0
6	31432679	.	T	A	5	5	10	0	0	10	0	0
6	31432684	.	T	C	5	5	10	0	0	10	0	0
6	31432881	.	C	T	1	10	11	0	6	17	0	0
6	31432950	.	G	A	3	7	10	1	1	12	0	0
6	31432955	.	T	C	1	6	7	1	1	9	0	0
6	31433412	.	A	G	1	1	2	0	2	4	0	0
6	31433572	.	T	A	5	5	10	0	1	11	0	0
6	31433846	.	G	A	2	4	6	0	0	6	0	0
6	31434050	.	C	A	4	4	8	0	0	8	0	0
6	31434830	.	A	G	4	4	8	0	0	8	0	0
6	31434923	.	C	T	2	3	5	0	6	11	0	0
6	31435017	.	C	T	0	2	2	0	2	4	0	0
6	31441574	.	A	T	9	9	18	0	0	18	0	0
6	31462606	.	G	A	3	4	7	0	0	7	0	0
6	31463147	.	A	T	4	2	6	0	0	6	0	0
6	31470029	.	G	C	1	0	1	0	3	4	0	0
6	31470041	.	T	C	2	2	4	0	0	4	0	0
6	31591116	.	C	T	8	8	16	0	4	20	0	0
6	31591452	.	C	T	9	11	20	0	0	20	0	0
6	31591838	.	T	G	19	17	36	0	2	38	0	0
6	31591841	.	G	A	18	18	36	0	1	37	0	0
6	31591883	.	C	T	3	3	6	0	19	25	0	0
6	31591997	.	A	C	21	0	21	0	20	42	1	0
6	31598783	.	C	T	9	9	18	0	2	20	0	0
6	31624107	.	T	C	6	8	14	0	0	14	0	0
6	31625714	.	C	T	3	4	7	0	0	7	0	0
6	31627223	.	G	A	7	7	14	0	0	14	0	0
6	31631366	.	A	G	3	4	7	0	0	7	0	0
6	31632508	.	T	C	5	4	9	0	0	9	0	0
6	31632519	.	G	A	5	4	9	0	0	9	0	0
6	31632550	.	G	C	6	0	6	0	3	9	0	0
6	32010215	.	C	T	4	0	4	0	2	6	0	0
6	32010259	.	G	A	8	6	14	0	0	14	0	0
6	32010341	.	C	T	2	15	17	0	17	34	0	0
6	32010475	.	A	G	31	22	53	0	4	57	0	0
6	32014771	.	T	G	24	22	46	0	0	46	0	0
6	32016492	.	T	C	16	13	29	0	0	29	0	0
6	32020326	.	G	A	3	6	9	0	1	10	0	0
6	32020327	.	T	A	3	4	7	0	3	10	0	0
6	32024960	.	C	T	8	3	11	0	0	11	0	0
6	32025109	.	C	A	12	11	23	0	1	24	0	0
6	32029267	.	A	T	4	3	7	0	0	7	0	0
6	32029269	.	A	T	4	3	7	0	0	7	0	0
6	32032371	.	A	C	7	7	14	0	1	15	0	0
6	32032479	.	C	T	6	7	13	1	0	14	0	0
6	32035921	.	G	A	2	4	6	0	0	6	0	0
6	32040581	.	G	A	6	2	8	0	1	9	0	0
6	32042501	.	G	A	9	8	17	0	0	17	0	0
6	32043513	.	G	C	6	2	8	0	0	8	0	0
6	32043514	.	G	T	6	2	8	0	0	8	0	0
6	32065310	.	C	T	3	4	7	0	0	7	0	0
6	32068390	.	C	T	1	2	3	0	3	6	0	0
6	32068411	.	G	C	3	2	5	0	1	6	0	0
6	32068488	.	G	A	1	5	6	0	0	6	0	0
6	32071935	.	G	A	2	2	4	0	0	4	0	0
6	32092825	.	C	T	0	1	1	0	3	4	0	0
6	32300717	.	G	A	1	2	3	0	0	3	0	0
6	32301040	.	G	C	4	3	7	0	1	8	0	0
6	32301137	.	A	T	9	5	14	0	2	16	0	0
6	32301161	.	C	T	10	7	17	0	1	18	0	0
6	32301214	.	A	T	7	8	15	0	2	17	0	0
6	32301265	.	A	T	9	7	16	0	1	17	0	0
6	32301462	.	C	T	1	3	4	0	0	4	0	0
6	32301900	.	C	G	1	2	3	0	4	7	0	0
6	32301969	.	T	G	7	5	12	0	1	13	0	0
6	32302236	.	C	T	0	3	3	0	2	5	0	0
6	32331333	.	G	A	0	3	3	0	2	5	0	0
6	32331344	.	G	T	2	2	4	0	0	4	0	0
6	32339831	.	C	A	5	3	8	0	0	8	0	0
6	32340005	.	C	T	4	5	9	0	0	9	0	0
6	32359470	.	G	A	2	2	4	0	1	5	0	0
6	32359533	.	G	A	4	2	6	0	0	6	0	0
6	32364439	.	C	T	5	3	8	0	1	9	0	0
6	32368952	.	C	T	3	4	7	0	0	7	0	0
6	32368970	.	A	T	2	4	6	0	0	6	0	0
6	32375838	.	T	C	7	4	11	0	0	11	0	0
6	32382629	.	C	T	6	7	13	0	1	14	0	0
6	32397588	.	C	T	16	23	39	0	0	39	0	0
6	32398844	.	G	A	18	13	31	0	0	31	0	0
6	32403028	.	G	A	18	11	29	0	0	29	0	0
6	32403052	.	T	C	16	16	32	0	2	34	0	0
6	32404206	.	C	G	14	10	24	0	1	25	0	0
6	32404863	.	C	T	0	6	6	0	6	12	0	0
6	32405020	.	G	A	7	7	14	0	0	14	0	0
6	32405266	.	G	A	4	6	10	0	0	10	0	0
6	32405478	.	A	T	7	2	9	0	0	9	0	0
6	32405741	.	A	T	7	8	15	0	0	15	0	0
6	32405784	.	A	G	8	4	12	0	0	12	0	0
6	32405952	.	C	T	7	6	13	0	2	15	0	0
6	32406216	.	G	A	8	11	19	0	0	19	0	0
6	32408299	.	G	A	3	2	5	0	0	5	0	0
6	32408437	.	C	T	2	2	4	0	5	9	0	0
6	32408742	.	A	T	1	4	5	0	1	6	0	0
6	32409931	.	A	G	4	3	7	0	0	7	0	0
6	32411039	.	C	T	0	2	2	0	3	5	0	0
6	32415560	.	C	A	2	5	7	0	1	8	0	0
6	32481835	.	G	A	2	2	4	0	0	4	0	0
6	32481868	.	G	A	2	3	5	0	0	5	0	0
6	32481998	.	T	C	3	3	6	0	0	6	0	0
6	32482376	.	G	A	1	3	4	0	0	4	0	0
6	32482525	.	C	T	1	2	3	0	0	3	0	0
6	32482727	.	G	A	2	3	5	0	0	5	0	0
6	32482984	.	C	T	2	4	6	0	0	6	0	0
6	32483750	.	T	C	8	7	15	0	0	15	0	0
6	32493103	.	C	T	4	2	6	0	0	6	0	0
6	32497690	.	A	G	5	4	9	0	0	9	0	0
6	32504356	.	C	T	7	4	11	0	0	11	0	0
6	32506349	.	T	A	7	10	17	0	0	17	0	0
6	32506386	.	C	T	11	3	14	0	2	16	0	0
6	32506473	.	G	A	1	7	8	0	7	15	0	0
6	32506526	.	A	G	3	4	7	0	0	7	0	0
6	32699666	.	G	A	7	5	12	0	0	12	0	0
6	32699682	.	T	A	7	7	14	0	0	14	0	0
6	32699775	.	A	C	8	0	8	0	4	12	0	0
6	32699870	.	A	T	7	4	11	0	1	12	0	0
6	32700530	.	T	C	1	3	4	0	0	4	0	0
6	32700607	.	T	G	5	7	12	0	0	12	0	0
6	32702198	.	C	T	3	7	10	0	2	12	0	0
6	32717831	.	G	A	3	2	5	0	0	5	0	0
6	32739226	.	A	G	4	4	8	0	0	8	0	0
6	32744121	.	G	A	2	2	4	0	0	4	0	0
6	32747707	.	T	G	5	3	8	0	0	8	0	0
6	32747709	.	A	G	5	3	8	0	0	8	0	0
6	32830083	.	A	G	2	2	4	0	0	4	0	0
6	32831529	.	C	T	1	4	5	0	1	6	0	0
6	32831635	.	A	G	1	3	4	0	1	5	0	0
6	32831644	.	A	T	1	3	4	0	0	4	0	0
6	32831728	.	A	G	1	3	4	0	0	4	0	0
6	32831871	.	G	T	4	2	6	0	0	6	0	0
6	32831881	.	C	T	5	2	7	0	0	7	0	0
6	32831927	.	G	A	1	7	8	0	0	8	0	0
6	32832166	.	T	C	3	0	3	0	3	6	0	0
6	32832499	.	C	T	5	2	7	0	0	7	0	0
6	32832525	.	G	C	3	5	8	0	0	8	0	0
6	32832662	.	A	G	1	2	3	0	0	3	0	0
6	32966915	.	G	C	6	10	16	0	2	18	0	0
6	32967065	.	C	T	8	9	17	0	0	17	0	0
6	32967080	.	T	C	9	10	19	0	0	19	0	0
6	32967174	.	G	A	9	9	18	0	1	19	0	0
6	32967182	.	A	T	10	9	19	0	1	20	0	0
6	32967357	.	G	A	8	20	28	0	0	28	0	0
6	32970032	.	G	A	4	10	14	0	1	15	0	0
6	32970178	.	T	C	3	8	11	0	0	11	0	0
6	32976281	.	G	A	2	7	9	0	0	9	0	0
6	32979285	.	A	C	5	5	10	0	0	10	0	0
6	32999747	.	A	C	4	0	4	0	4	8	0	0
6	33023389	.	T	A	3	5	8	0	1	9	0	0
6	33023439	.	G	A	8	4	12	0	0	12	0	0
6	33023545	.	T	C	3	0	3	0	10	13	0	0
6	33023601	.	A	G	4	8	12	0	0	12	0	0
6	33023625	.	G	C	3	4	7	0	1	8	0	0
6	33077446	.	T	C	2	3	5	0	0	5	0	0
6	33083415	.	G	A	1	2	3	0	0	3	0	0
6	33086403	.	T	C	3	2	5	0	0	5	0	0
6	33089139	.	G	A	1	4	5	0	4	9	0	0
6	33091561	.	C	T	2	3	5	0	0	5	0	0
6	33091567	.	T	C	3	2	5	0	0	5	0	0
6	33092969	.	A	C	3	3	6	0	0	6	0	0
6	33094767	.	A	C	5	4	9	0	0	9	0	0
6	33095174	.	G	A	5	1	6	0	1	7	0	0
6	33095499	.	T	C	1	3	4	0	0	4	0	0
6	33548919	.	A	G	7	7	14	0	0	14	0	0
6	33549187	.	T	G	5	0	5	0	9	14	0	0
6	33553084	.	G	A	6	6	12	0	0	12	0	0
6	33553406	.	T	C	6	5	11	0	2	13	0	0
6	33554433	.	A	T	7	4	11	0	1	12	0	0
6	33554435	.	C	T	8	3	11	0	1	12	0	0
6	33555159	.	G	A	0	6	6	0	8	14	0	0
6	33555168	.	C	T	6	5	11	0	1	12	0	0
6	33555351	.	A	G	10	10	20	0	0	20	0	0
6	33555374	.	G	A	1	6	7	0	14	21	0	0
6	33555397	.	A	G	19	5	24	0	0	24	0	0
6	33555570	.	G	A	8	14	22	0	0	22	0	0
6	33555594	.	T	C	6	11	17	0	0	17	0	0
6	33555691	.	T	G	4	0	4	0	4	8	0	0
6	33555952	.	T	A	9	15	24	0	0	24	0	0
6	33556036	.	T	A	14	9	23	0	1	24	0	0
6	33556316	.	C	T	8	15	23	0	1	24	0	0
6	33556424	.	A	G	11	7	18	0	0	18	0	0
6	33556441	.	G	A	11	10	21	0	0	21	0	0
6	33556493	.	A	T	1	22	23	0	0	23	0	0
6	33556497	.	A	T	12	12	24	0	3	27	0	0
6	33556706	.	G	C	17	9	26	0	2	28	0	0
6	33556877	.	G	A	1	13	14	0	15	29	0	0
6	33556968	.	G	C	17	11	28	0	1	29	0	0
6	33557000	.	A	C	2	2	4	0	12	16	0	0
6	33557077	.	G	A	2	5	7	0	10	17	0	0
6	33557141	.	G	C	9	7	16	0	1	17	0	0
6	33557438	.	T	A	7	8	15	0	1	16	0	0
6	33557625	.	C	T	16	23	39	0	0	39	0	0
6	33558204	.	G	A	13	6	19	0	0	19	0	0
6	33558437	.	G	A	17	21	38	0	0	38	0	0
6	33558711	.	G	C	14	32	46	0	2	48	0	0
6	33558837	.	C	T	11	6	17	0	0	17	0	0
6	33663690	.	T	C	4	10	14	0	1	15	0	0
6	33663701	.	T	C	8	8	16	0	0	16	0	0
6	33663839	.	C	T	0	17	17	0	7	24	0	0
6	33664182	.	A	G	6	12	18	0	1	19	0	0
6	33664460	.	A	G	3	3	6	0	0	6	0	0
6	33664556	.	C	T	3	4	7	0	0	7	0	0
6	33664801	.	A	G	6	10	16	0	0	16	0	0
6	33664899	.	G	A	8	6	14	1	0	15	0	0
6	33664917	.	C	T	2	7	9	0	6	15	0	0
6	33664957	.	T	C	12	6	18	0	2	20	0	0
6	33665123	.	T	G	8	8	16	0	0	16	0	0
6	33665320	.	G	A	5	6	11	0	1	12	0	0
6	33665327	.	C	T	4	5	9	0	0	9	0	0
6	33665513	.	C	T	0	8	8	0	7	15	0	0
6	33665734	.	C	T	11	9	20	0	1	21	0	0
6	33665867	.	G	T	11	10	21	0	0	21	0	0
6	33665968	.	C	T	12	13	25	0	1	26	0	0
6	33666166	.	G	A	4	10	14	0	0	14	0	0
6	33666250	.	C	A	0	10	10	0	6	16	0	0
6	33666302	.	C	A	9	3	12	0	1	13	0	0
6	33666308	.	G	A	8	5	13	0	0	13	0	0
6	33666472	.	G	T	9	16	25	1	0	26	0	0
6	33666578	.	G	T	10	12	22	0	1	23	0	0
6	33666631	.	C	T	7	17	24	0	3	27	0	0
6	33666715	.	C	A	9	11	20	0	0	20	0	0
6	33666733	.	A	G	10	15	25	0	0	25	0	0
6	33666871	.	A	T	13	9	22	0	0	22	0	0
6	33666910	.	G	T	8	7	15	0	0	15	0	0
6	33667006	.	C	T	5	6	11	0	1	12	0	0
6	33667056	.	T	C	6	0	6	0	7	13	0	0
6	33667180	.	C	T	1	2	3	0	6	9	0	0
6	33667234	.	T	A	4	8	12	0	2	14	0	0
6	33667345	.	G	C	12	4	16	0	3	19	0	0
6	33667369	.	G	A	5	15	20	0	4	24	0	0
6	33667492	.	G	T	13	3	16	0	8	24	0	0
6	33668729	.	A	T	5	5	10	0	0	10	0	0
6	33669168	.	G	C	5	0	5	0	5	10	0	0
6	33669460	.	A	C	8	4	12	0	0	12	0	0
6	33675666	.	C	T	0	8	8	0	3	11	0	0
6	33683816	.	A	G	2	2	4	0	0	4	0	0
6	33875746	.	T	A	3	2	5	0	0	5	0	0
6	33875833	.	G	A	1	2	3	0	0	3	0	0
6	33875902	.	C	T	0	2	2	0	3	5	0	0
6	33875954	.	A	G	4	5	9	0	0	9	0	0
6	33883580	.	C	T	6	3	9	0	0	9	0	0
6	33896399	.	T	A	30	16	46	0	2	48	0	0
6	33896457	.	A	G	23	24	47	0	2	49	0	0
6	33896538	.	T	C	27	16	43	1	5	49	0	0
6	33896562	.	A	G	30	17	47	0	1	48	0	0
6	33896615	.	G	A	1	17	18	0	25	43	0	0
6	33896620	.	C	T	21	22	43	0	1	44	0	0
6	33897505	.	G	A	10	7	17	0	2	19	0	0
6	33910226	.	G	T	0	2	2	0	1	3	0	0
6	33912228	.	G	T	7	8	15	0	0	15	0	0
6	33912708	.	A	C	7	2	9	0	5	14	0	0
6	33913345	.	A	T	3	5	8	0	0	8	0	0
6	33916648	.	T	C	5	0	5	0	7	12	0	0
6	33921298	.	C	T	5	2	7	0	0	7	0	0
6	33921511	.	G	A	12	8	20	0	2	22	0	0
6	33923900	.	C	T	5	4	9	0	1	10	0	0
6	33924693	.	A	G	9	9	18	0	1	19	0	0
6	33925182	.	C	A	1	2	3	0	0	3	0	0
6	33925183	.	A	G	1	2	3	0	0	3	0	0
6	33927040	.	A	T	8	10	18	0	2	20	0	0
6	33927271	.	G	T	7	7	14	0	1	15	0	0
6	33931582	.	T	C	6	7	13	0	1	14	0	0
6	33982662	.	C	G	0	2	2	0	1	3	0	0
6	33982863	.	A	G	0	2	2	0	0	2	0	0
6	34072117	.	A	G	1	2	3	0	0	3	0	0
6	34767154	.	T	C	1	2	3	0	0	3	0	0
6	34767157	.	T	A	1	2	3	0	0	3	0	0
6	34772224	.	T	C	1	2	3	0	0	3	0	0
6	34805913	.	C	A	4	2	6	0	0	6	0	0
6	34806893	.	A	T	7	2	9	0	0	9	0	0
6	34807534	.	C	A	3	3	6	0	0	6	0	0
6	34807605	.	C	G	1	3	4	0	0	4	0	0
6	34807843	.	A	T	2	2	4	0	0	4	0	0
6	34807927	.	T	A	3	2	5	2	0	7	0	0
6	34807933	.	G	T	4	3	7	2	0	9	0	0
6	34807999	.	G	T	6	6	12	0	0	12	0	0
6	34808122	.	G	A	1	2	3	0	0	3	0	0
6	34808138	.	A	C	1	2	3	0	1	4	0	0
6	34808517	.	A	G	5	4	9	0	0	9	0	0
6	34808591	.	G	A	8	12	20	0	0	20	0	0
6	34808754	.	C	T	9	4	13	0	1	14	0	0
6	34808821	.	G	A	4	8	12	0	1	13	0	0
6	34808996	.	A	G	5	0	5	0	5	10	0	0
6	34809697	.	C	G	7	0	7	0	11	18	0	0
6	34810495	.	G	A	1	9	10	0	15	25	0	0
6	34810748	.	A	C	10	9	19	0	1	20	0	0
6	34810763	.	T	A	13	7	20	0	1	21	0	0
6	34810896	.	G	A	8	7	15	0	1	16	0	0
6	34810908	.	T	C	10	8	18	0	0	18	0	0
6	34811130	.	A	T	4	4	8	0	0	8	0	0
6	34811175	.	T	C	4	10	14	0	0	14	0	0
6	34826051	.	T	C	1	5	6	0	1	7	0	0
6	34826214	.	G	A	5	2	7	0	0	7	0	0
6	34826598	.	G	A	4	6	10	2	0	12	0	0
6	34826870	.	G	A	8	11	19	0	1	20	0	0
6	34826882	.	T	G	8	9	17	0	0	17	0	0
6	34828893	.	A	T	14	9	23	0	0	23	0	0
6	34831124	.	A	C	2	1	3	0	5	8	0	0
6	34848320	.	C	T	4	3	7	0	1	8	0	0
6	34854397	.	G	A	3	3	6	0	0	6	0	0
6	34856516	.	A	T	4	4	8	0	0	8	0	0
6	34931646	.	G	A	14	12	26	1	2	29	0	0
6	34931911	.	C	T	29	24	53	0	3	56	0	0
6	34931912	.	C	T	28	24	52	0	3	55	0	0
6	34933574	.	C	T	33	24	57	0	1	58	0	0
6	34934903	.	G	T	29	23	52	0	1	53	0	0
6	34943451	.	G	T	2	3	5	0	0	5	0	0
6	34943714	.	G	A	6	4	10	0	0	10	0	0
6	34943938	.	T	C	2	3	5	0	1	6	0	0
6	34944523	.	G	A	10	3	13	0	0	13	0	0
6	34947195	.	T	A	3	6	9	0	0	9	0	0
6	35036320	.	C	T	6	2	8	0	0	8	0	0
6	35036459	.	A	T	7	8	15	0	0	15	0	0
6	35036463	.	T	C	6	1	7	0	7	14	0	0
6	35036520	.	A	G	7	4	11	0	0	11	0	0
6	35036525	.	T	G	6	4	10	0	0	10	0	0
6	35036755	.	T	A	7	6	13	0	0	13	0	0
6	35039912	.	G	T	4	5	9	0	1	10	0	0
6	35039966	.	C	T	7	7	14	0	1	15	0	0
6	35042176	.	C	T	3	5	8	0	0	8	0	0
6	35042201	.	A	G	3	3	6	0	1	7	0	0
6	35046783	.	G	A	4	3	7	0	0	7	0	0
6	35046852	.	T	C	3	5	8	0	1	9	0	0
6	35046894	.	A	G	4	2	6	0	0	6	0	0
6	35051403	.	T	G	1	3	4	0	0	4	0	0
6	35052942	.	T	C	2	2	4	0	0	4	0	0
6	35053243	.	G	A	3	2	5	0	1	6	0	0
6	35053250	.	A	G	3	3	6	0	1	7	0	0
6	35054984	.	T	G	1	2	3	0	0	3	0	0
6	35055004	.	A	T	2	2	4	0	1	5	0	0
6	35056547	.	C	T	1	4	5	0	0	5	0	0
6	35056787	.	A	G	4	5	9	0	1	10	0	0
6	35058696	.	A	G	5	2	7	0	0	7	0	0
6	35058850	.	A	G	5	2	7	0	0	7	0	0
6	35099980	.	T	C	4	4	8	0	1	9	0	0
6	35100084	.	G	A	3	3	6	0	0	6	0	0
6	35100230	.	T	A	4	2	6	0	0	6	0	0
6	35100423	.	C	T	2	1	3	0	1	4	0	0
6	35100442	.	T	C	3	2	5	0	0	5	0	0
6	35100484	.	C	T	1	2	3	0	3	6	0	0
6	35100528	.	A	G	4	3	7	0	0	7	0	0
6	35100795	.	C	G	0	3	3	0	7	10	0	0
6	35100801	.	T	G	6	4	10	0	0	10	0	0
6	35100868	.	T	A	1	9	10	0	1	11	0	0
6	35100894	.	C	T	0	6	6	0	1	7	0	0
6	35100933	.	A	G	2	10	12	0	0	12	0	0
6	35101184	.	A	T	3	2	5	0	1	6	0	0
6	35102555	.	G	C	2	3	5	0	0	5	0	0
6	35102576	.	C	T	2	3	5	0	0	5	0	0
6	35102886	.	T	G	1	4	5	0	0	5	0	0
6	35113305	.	A	G	2	3	5	0	0	5	0	0
6	35136451	.	T	C	4	9	13	0	0	13	0	0
6	35136471	.	C	T	0	11	11	0	4	15	0	0
6	35136505	.	T	A	6	8	14	0	0	14	0	0
6	35136558	.	G	A	5	8	13	0	0	13	0	0
6	35136983	.	A	G	3	6	9	0	0	9	0	0
6	35137320	.	A	G	3	2	5	0	1	6	0	0
6	35137587	.	A	G	5	4	9	0	0	9	0	0
6	35139248	.	T	C	4	4	8	0	2	10	0	0
6	35194786	.	G	A	2	5	7	0	0	7	0	0
6	35309798	.	T	G	2	4	6	0	0	6	0	0
6	35309823	.	A	T	4	3	7	0	0	7	0	0
6	35309901	.	T	G	3	2	5	0	0	5	0	0
6	35309942	.	G	A	2	3	5	0	0	5	0	0
6	35363247	.	A	G	4	12	16	0	1	17	0	0
6	35364869	.	G	A	8	4	12	0	0	12	0	0
6	35365098	.	A	T	3	7	10	0	1	11	0	0
6	35365234	.	C	T	4	7	11	0	0	11	0	0
6	35365441	.	C	A	4	2	6	0	0	6	0	0
6	35365462	.	T	A	3	2	5	0	0	5	0	0
6	35365492	.	A	G	4	2	6	0	0	6	0	0
6	35365872	.	C	T	10	11	21	0	0	21	0	0
6	35365877	.	C	T	10	11	21	0	0	21	0	0
6	35366140	.	G	T	1	13	14	0	8	22	0	0
6	35366141	.	A	G	9	12	21	0	1	22	0	0
6	35366640	.	C	G	10	3	13	0	0	13	0	0
6	35461688	.	T	C	7	6	13	0	1	14	0	0
6	35461859	.	A	G	1	2	3	0	0	3	0	0
6	35462087	.	G	A	15	9	24	0	1	25	0	0
6	35462088	.	A	G	16	9	25	0	0	25	0	0
6	35462134	.	G	A	13	11	24	5	1	30	0	0
6	35462186	.	A	G	18	14	32	0	1	33	0	0
6	35462470	.	G	A	13	18	31	0	0	31	0	0
6	35472834	.	C	T	14	17	31	0	1	32	0	0
6	35472858	.	G	T	13	17	30	0	1	31	0	0
6	35676784	.	A	G	10	12	22	0	0	22	0	0
6	35676799	.	C	T	12	10	22	0	0	23	1	0
6	35688231	.	G	A	6	5	11	0	0	11	0	0
6	35693656	.	C	T	4	6	10	0	0	10	0	0
6	35713078	.	T	A	1	2	3	0	0	3	0	0
6	35718058	.	T	C	3	3	6	0	0	6	0	0
6	35737276	.	G	T	5	5	10	0	0	10	0	0
6	35737289	.	A	G	8	5	13	0	0	13	0	0
6	35738430	.	C	A	0	6	6	0	2	8	0	0
6	36129003	.	T	G	4	2	6	0	0	6	0	0
6	36129066	.	A	G	1	2	3	0	0	3	0	0
6	36129135	.	T	A	1	4	5	0	0	5	0	0
6	36129779	.	C	T	5	5	10	0	0	10	0	0
6	36130245	.	G	A	3	8	11	0	1	12	0	0
6	36130351	.	T	A	5	2	7	0	1	8	0	0
6	36130358	.	A	C	5	3	8	0	1	9	0	0
6	36131055	.	A	G	4	6	10	0	1	11	0	0
6	36131097	.	A	T	6	5	11	0	1	12	0	0
6	36131876	.	G	A	1	5	6	0	0	6	0	0
6	36132072	.	C	T	0	2	2	0	1	3	0	0
6	36137010	.	G	A	6	3	9	0	0	9	0	0
6	36141601	.	G	A	5	4	9	0	1	10	0	0
6	36141631	.	G	A	4	4	8	0	0	8	0	0
6	36141739	.	T	G	5	4	9	0	0	9	0	0
6	36141741	.	A	G	5	4	9	0	0	9	0	0
6	36157011	.	T	C	2	0	2	0	2	4	0	0
6	36178531	.	A	G	4	2	6	0	0	6	0	0
6	36197470	.	A	T	5	2	7	0	0	7	0	0
6	36720558	.	G	A	3	2	5	0	0	5	0	0
6	36758758	.	A	G	19	19	38	0	0	38	0	0
6	36760065	.	A	C	13	0	13	0	17	30	0	0
6	36760080	.	T	A	11	18	29	0	1	30	0	0
6	36760140	.	C	T	13	15	28	0	1	29	0	0
6	36762535	.	A	G	13	11	24	0	2	26	0	0
6	36770666	.	C	T	10	6	16	0	0	16	0	0
6	36783178	.	T	C	11	8	19	0	0	19	0	0
6	36783187	.	T	A	10	7	17	0	0	17	0	0
6	36789072	.	A	G	8	9	17	0	0	17	0	0
6	36792028	.	A	C	7	5	12	0	0	12	0	0
6	36792112	.	A	G	11	6	17	0	0	17	0	0
6	36792130	.	A	T	11	4	15	0	3	19	1	0
6	36792163	.	C	G	10	9	19	0	1	20	0	0
6	36792294	.	A	G	10	5	15	0	2	17	0	0
6	36818779	.	T	A	2	4	6	0	0	6	0	0
6	36818784	.	C	T	2	4	6	0	0	6	0	0
6	36818840	.	C	T	2	2	4	0	0	4	0	0
6	36819202	.	C	G	3	4	7	0	0	7	0	0
6	36854168	.	C	T	1	1	2	0	1	3	0	0
6	36854171	.	A	G	1	2	3	0	0	3	0	0
6	36877053	.	A	G	3	1	4	0	0	4	0	0
6	36877078	.	G	A	3	2	5	0	1	6	0	0
6	36877097	.	A	T	4	2	6	0	0	6	0	0
6	36877265	.	A	G	3	2	5	0	0	5	0	0
6	36877293	.	A	C	4	3	7	0	0	7	0	0
6	36877419	.	A	G	1	0	1	0	2	3	0	0
6	37071353	.	G	A	12	10	22	0	0	22	0	0
6	37071374	.	A	G	12	11	23	0	2	25	0	0
6	37163366	.	A	T	13	6	19	0	6	25	0	0
6	37163449	.	G	A	2	11	13	0	29	42	0	0
6	37163488	.	G	A	26	19	45	0	0	45	0	0
6	37163588	.	G	T	2	19	21	0	19	40	0	0
6	37163932	.	T	C	19	17	36	0	1	37	0	0
6	37163943	.	C	T	15	19	34	0	1	35	0	0
6	37164060	.	T	C	17	17	34	0	4	38	0	0
6	37164173	.	T	G	14	13	27	0	0	27	0	0
6	37301438	.	G	T	10	8	18	0	1	19	0	0
6	37301458	.	A	G	13	11	24	0	1	25	0	0
6	37301479	.	A	T	14	14	28	0	3	31	0	0
6	37305142	.	A	C	14	12	26	0	3	29	0	0
6	37305532	.	G	T	6	6	12	0	0	12	0	0
6	37305539	.	G	T	5	4	9	0	0	9	0	0
6	37306620	.	A	T	23	13	36	0	0	36	0	0
6	37306827	.	C	T	11	6	17	0	0	17	0	0
6	37409738	.	C	T	4	12	16	0	1	17	0	0
6	37409986	.	C	T	6	4	10	0	1	11	0	0
6	37410029	.	A	G	6	8	14	0	0	14	0	0
6	37410047	.	C	T	9	10	19	0	0	19	0	0
6	37410119	.	C	T	6	12	18	0	1	19	0	0
6	37417345	.	T	A	5	6	11	0	2	13	0	0
6	37419449	.	G	A	8	6	14	0	2	16	0	0
6	37419479	.	G	A	7	6	13	0	0	13	0	0
6	37419491	.	A	T	5	6	11	0	0	11	0	0
6	37420172	.	A	C	2	2	4	0	0	4	0	0
6	37421038	.	C	A	0	2	2	0	4	6	0	0
6	37422787	.	A	G	2	4	6	0	0	6	0	0
6	37431476	.	T	G	2	5	7	0	0	7	0	0
6	37431532	.	G	C	3	7	10	0	1	11	0	0
6	37431592	.	C	T	2	6	8	0	0	8	0	0
6	37431649	.	T	C	6	11	17	0	1	18	0	0
6	37440515	.	G	T	2	5	7	0	0	7	0	0
6	37440547	.	T	A	2	4	6	0	0	6	0	0
6	37441474	.	T	C	1	5	6	0	0	6	0	0
6	37441492	.	G	A	1	4	5	0	0	5	0	0
6	37442060	.	G	T	2	3	5	0	0	5	0	0
6	37443945	.	T	C	2	2	4	0	0	4	0	0
6	37444475	.	C	T	1	3	4	0	0	4	0	0
6	37445258	.	T	A	1	2	3	0	0	3	0	0
6	37445357	.	T	C	4	9	13	0	1	14	0	0
6	37461072	.	C	T	4	3	7	0	1	8	0	0
6	37461661	.	G	A	7	7	14	0	0	14	0	0
6	37461662	.	T	A	7	6	13	0	1	14	0	0
6	37469571	.	C	A	0	3	3	0	1	4	0	0
6	37478859	.	G	A	8	4	12	0	0	12	0	0
6	37478878	.	G	A	7	5	12	0	0	12	0	0
6	37478905	.	G	A	10	4	14	0	1	15	0	0
6	37479506	.	G	A	6	10	16	0	0	16	0	0
6	37479563	.	C	G	4	4	8	0	0	8	0	0
6	37479578	.	G	A	2	5	7	0	0	7	0	0
6	37479779	.	A	C	7	7	14	0	0	14	0	0
6	37479785	.	A	C	8	6	14	0	0	14	0	0
6	37479910	.	T	G	8	3	11	0	0	11	0	0
6	37479932	.	G	A	8	6	14	0	0	14	0	0
6	37479998	.	A	G	8	4	12	0	0	12	0	0
6	37480100	.	T	A	4	10	14	0	1	15	0	0
6	37485828	.	G	A	1	3	4	0	0	4	0	0
6	37495117	.	G	A	2	2	4	0	0	4	0	0
6	37495147	.	G	A	3	4	7	0	0	7	0	0
6	37498477	.	A	G	1	5	6	0	0	6	0	0
6	37499562	.	A	C	5	2	7	0	0	7	0	0
6	37514941	.	T	A	1	2	3	0	0	3	0	0
6	37515300	.	C	T	5	3	8	0	0	8	0	0
6	37515353	.	T	A	1	6	7	0	2	9	0	0
6	37521529	.	A	T	5	11	16	0	2	18	0	0
6	37521594	.	C	A	10	5	15	0	0	15	0	0
6	37525748	.	G	A	6	6	12	0	1	13	0	0
6	37529504	.	C	A	11	12	23	0	2	25	0	0
6	37548605	.	T	C	10	5	15	0	0	15	0	0
6	37548897	.	C	T	12	11	23	0	0	23	0	0
6	37551165	.	G	A	0	10	10	0	14	24	0	0
6	37551548	.	T	C	11	13	24	0	0	24	0	0
6	37552621	.	C	T	18	11	29	0	2	31	0	0
6	37554293	.	C	T	15	9	24	0	2	26	0	0
6	37598966	.	C	T	17	20	37	0	0	37	0	0
6	37599293	.	C	T	10	16	26	0	0	26	0	0
6	37599406	.	G	A	11	12	23	0	0	23	0	0
6	37599499	.	G	T	11	13	24	0	1	25	0	0
6	37599687	.	A	T	14	9	23	1	1	25	0	0
6	37599937	.	T	G	24	15	39	0	0	39	0	0
6	37599954	.	C	T	19	14	33	0	1	34	0	0
6	37600173	.	A	G	17	0	17	0	21	38	0	0
6	37600210	.	G	A	3	20	23	1	21	45	0	0
6	37600233	.	G	A	19	23	42	1	2	46	1	0
6	37603982	.	T	G	4	4	8	0	0	8	0	0
6	37603983	.	A	G	4	4	8	0	0	8	0	0
6	37604410	.	T	A	6	3	9	0	1	10	0	0
6	37604547	.	A	G	3	2	5	0	0	5	0	0
6	37604724	.	G	A	3	4	7	0	0	7	0	0
6	37604866	.	A	C	8	6	14	0	1	15	0	0
6	37621150	.	T	C	2	2	4	0	0	4	0	0
6	37621204	.	A	G	2	2	4	0	0	4	0	0
6	37621213	.	A	G	2	3	5	0	0	5	0	0
6	37621918	.	A	G	6	3	9	0	0	9	0	0
6	37623836	.	A	T	1	1	2	0	0	2	0	0
6	37626084	.	T	A	1	2	3	0	0	3	0	0
6	37627004	.	A	G	2	4	6	0	0	6	0	0
6	37627114	.	G	A	2	3	5	0	0	5	0	0
6	37627141	.	C	A	4	3	7	0	0	7	0	0
6	37628973	.	G	A	3	3	6	0	1	7	0	0
6	37628991	.	C	T	2	3	5	0	1	6	0	0
6	37629402	.	A	G	6	0	6	0	6	13	1	0
6	37631456	.	A	G	3	6	9	0	1	10	0	0
6	37632963	.	A	G	2	0	2	0	3	5	0	0
6	37632966	.	C	T	2	4	6	0	0	6	0	0
6	37633005	.	C	A	2	4	6	0	1	7	0	0
6	37633549	.	G	A	2	4	6	0	6	12	0	0
6	37635649	.	T	C	3	8	11	0	0	11	0	0
6	37637987	.	G	A	5	3	8	0	3	11	0	0
6	37651619	.	T	C	13	9	22	0	2	24	0	0
6	37730520	.	C	T	1	2	3	0	1	4	0	0
6	37730527	.	C	T	2	2	4	0	0	4	0	0
6	37737188	.	C	A	3	5	8	0	1	9	0	0
6	37743319	.	A	C	3	0	3	0	3	6	0	0
6	37743373	.	C	G	3	5	8	0	1	9	0	0
6	37743456	.	T	C	2	0	2	0	3	5	0	0
6	37744304	.	C	A	2	8	10	0	0	10	0	0
6	37745985	.	T	G	1	2	3	0	0	3	0	0
6	37746085	.	C	T	3	3	6	0	0	6	0	0
6	37746099	.	G	A	3	2	5	0	0	5	0	0
6	37752838	.	A	G	3	2	5	0	0	5	0	0
6	37796222	.	G	C	2	5	7	0	0	7	0	0
6	37801954	.	A	G	2	0	2	0	2	4	0	0
6	37808349	.	G	A	1	3	4	0	0	4	0	0
6	37809918	.	C	T	2	9	11	0	0	11	0	0
6	37810029	.	T	C	1	4	5	0	1	6	0	0
6	37810256	.	C	T	1	6	7	0	0	7	0	0
6	37812199	.	A	G	5	2	7	0	0	7	0	0
6	37815621	.	T	G	6	4	10	0	1	11	0	0
6	37815799	.	C	T	1	5	6	0	0	6	0	0
6	37818324	.	A	C	7	4	11	0	0	11	0	0
6	37818327	.	G	A	7	4	11	0	0	11	0	0
6	37820306	.	C	T	8	6	14	0	1	15	0	0
6	37821169	.	G	T	1	4	5	0	1	6	0	0
6	37824355	.	G	T	6	8	14	0	0	14	0	0
6	37824645	.	T	C	8	10	18	0	0	18	0	0
6	37825508	.	T	G	7	0	7	0	5	12	0	0
6	37829585	.	G	A	13	9	22	0	0	22	0	0
6	37829613	.	T	C	12	13	25	0	2	27	0	0
6	37830742	.	A	T	15	7	22	0	0	22	0	0
6	37830784	.	C	T	18	10	28	0	2	30	0	0
6	37830811	.	C	T	16	10	26	0	1	27	0	0
6	37832947	.	C	T	11	15	26	0	2	28	0	0
6	37832953	.	G	A	10	18	28	0	0	28	0	0
6	37833493	.	T	C	15	9	24	0	1	25	0	0
6	37835767	.	T	C	16	16	32	0	1	33	0	0
6	37835797	.	C	T	15	12	27	0	2	29	0	0
6	37836387	.	G	A	12	12	24	0	4	28	0	0
6	37841100	.	C	T	8	13	21	0	0	22	1	0
6	37846026	.	C	T	26	21	47	0	1	48	0	0
6	38367062	.	G	C	16	0	16	0	13	29	0	0
6	38367107	.	T	C	13	10	23	0	0	23	0	0
6	38375020	.	G	A	22	16	38	0	0	38	0	0
6	38381094	.	G	A	6	11	17	0	0	17	0	0
6	38415315	.	G	A	10	6	16	0	0	16	0	0
6	38415385	.	A	G	5	10	15	0	1	16	0	0
6	38477019	.	G	T	12	2	14	0	2	16	0	0
6	38503673	.	C	T	11	4	15	0	1	16	0	0
6	38511604	.	G	A	13	9	22	0	0	22	0	0
6	38511739	.	C	T	11	10	21	0	0	21	0	0
6	38511921	.	T	C	12	6	18	0	1	19	0	0
6	38511967	.	A	T	13	6	19	0	2	21	0	0
6	38512160	.	T	C	10	12	22	0	1	23	0	0
6	38512178	.	G	A	13	16	29	0	0	29	0	0
6	38512236	.	C	T	30	10	40	0	0	40	0	0
6	38512629	.	C	T	16	14	30	0	2	32	0	0
6	38513231	.	C	T	14	6	20	0	2	22	0	0
6	38782025	.	C	T	6	4	10	0	0	10	0	0
6	38782439	.	C	A	2	6	8	0	1	9	0	0
6	38782442	.	C	T	2	5	7	0	1	8	0	0
6	38782511	.	A	G	7	5	12	0	0	12	0	0
6	38782712	.	T	C	5	7	12	0	0	12	0	0
6	38782794	.	C	T	9	4	13	0	0	13	0	0
6	38782799	.	T	A	9	3	12	0	2	14	0	0
6	38783002	.	T	A	3	8	11	0	0	11	0	0
6	38783044	.	T	A	2	3	5	0	0	5	0	0
6	38786301	.	G	A	0	7	7	0	3	10	0	0
6	38786622	.	C	A	7	7	14	0	0	14	0	0
6	38789065	.	C	A	13	7	20	0	0	20	0	0
6	38789292	.	C	T	9	13	22	0	2	24	0	0
6	38789317	.	C	T	11	15	26	0	3	29	0	0
6	38789507	.	A	T	11	8	19	0	0	19	0	0
6	38789583	.	G	C	13	14	27	0	0	27	0	0
6	38789733	.	A	G	9	11	20	0	7	27	0	0
6	38789832	.	A	G	14	13	27	0	1	28	0	0
6	38789853	.	T	A	12	13	25	0	4	29	0	0
6	38845797	.	G	A	2	6	8	0	0	8	0	0
6	38845817	.	T	C	4	5	9	0	0	9	0	0
6	38845865	.	G	A	6	6	12	0	0	12	0	0
6	38845986	.	A	G	1	1	2	0	4	6	0	0
6	38858036	.	G	T	1	10	11	0	5	16	0	0
6	38858558	.	T	A	6	5	11	0	0	11	0	0
6	38858784	.	T	G	11	8	19	0	0	19	0	0
6	38858832	.	T	G	6	7	13	0	1	14	0	0
6	38858902	.	T	A	1	4	5	0	0	5	0	0
6	38859796	.	T	A	7	5	12	0	0	12	0	0
6	38860293	.	C	G	6	5	11	0	4	15	0	0
6	38860362	.	T	A	3	7	10	0	1	11	0	0
6	38860815	.	A	G	6	12	18	0	0	18	0	0
6	38860823	.	C	T	6	13	19	0	2	21	0	0
6	38860905	.	C	T	3	20	23	0	1	24	0	0
6	38860981	.	T	C	6	9	15	1	2	18	0	0
6	38860985	.	T	G	6	10	16	1	1	18	0	0
6	38861020	.	G	A	7	11	18	0	1	19	0	0
6	38861035	.	C	A	6	11	17	0	2	19	0	0
6	38896360	.	A	G	8	5	13	0	0	13	0	0
6	38896523	.	T	C	10	7	17	0	0	17	0	0
6	38899123	.	T	C	8	6	14	0	3	17	0	0
6	38901991	.	T	C	11	11	22	0	0	22	0	0
6	38902291	.	T	A	6	6	12	0	0	12	0	0
6	39014616	.	T	C	1	0	1	0	2	3	0	0
6	39068424	.	A	G	15	19	34	0	1	35	0	0
6	39075254	.	A	C	18	12	30	0	1	31	0	0
6	39075513	.	G	A	7	10	17	0	0	17	0	0
6	39077308	.	G	C	11	11	22	0	3	25	0	0
6	39077364	.	C	T	7	4	11	0	1	12	0	0
6	39123923	.	C	A	3	2	5	0	0	5	0	0
6	39124100	.	T	A	1	2	3	0	0	3	0	0
6	39124288	.	C	A	5	7	12	0	0	12	0	0
6	39124304	.	A	C	4	8	12	0	0	12	0	0
6	39124485	.	A	C	3	2	5	0	0	5	0	0
6	39124784	.	T	A	5	4	9	0	0	9	0	0
6	39124789	.	C	A	4	6	10	0	0	10	0	0
6	39125228	.	G	A	2	2	4	0	0	4	0	0
6	39125296	.	C	T	4	4	8	0	0	8	0	0
6	39125609	.	A	C	6	6	12	0	0	12	0	0
6	39125626	.	G	A	5	6	11	0	0	11	0	0
6	39125653	.	G	A	4	3	7	0	0	7	0	0
6	39125746	.	A	C	3	4	7	0	0	7	0	0
6	39126533	.	C	T	0	2	2	0	2	4	0	0
6	39126884	.	C	T	3	7	10	0	0	10	0	0
6	39127231	.	G	C	5	5	10	0	0	10	0	0
6	39136487	.	A	G	2	3	5	0	0	5	0	0
6	39155438	.	C	T	1	2	3	0	0	3	0	0
6	39162488	.	C	A	1	2	3	0	0	3	0	0
6	39162491	.	C	G	1	2	3	0	0	3	0	0
6	39162607	.	C	T	10	7	17	0	0	17	0	0
6	39162718	.	A	T	9	5	14	0	0	14	0	0
6	39162756	.	T	A	5	7	12	0	0	12	0	0
6	39162855	.	C	T	6	5	11	0	0	11	0	0
6	39162896	.	G	A	5	8	13	0	1	14	0	0
6	39163058	.	T	A	4	5	9	0	0	9	0	0
6	39163286	.	G	A	7	4	11	0	1	12	0	0
6	39163363	.	A	T	4	8	12	0	1	13	0	0
6	39163657	.	T	G	5	6	11	0	0	11	0	0
6	39163690	.	T	C	4	0	4	0	4	8	0	0
6	39163876	.	A	G	2	3	5	0	0	5	0	0
6	39164046	.	T	G	3	3	6	0	0	6	0	0
6	39194444	.	A	T	2	1	3	0	1	4	0	0
6	39239668	.	A	G	3	2	5	0	0	5	0	0
6	39636064	.	A	C	0	5	5	1	0	6	0	0
6	40708523	.	G	A	3	2	5	0	2	7	0	0
6	41435866	.	A	G	28	20	48	0	1	49	0	0
6	41460563	.	A	T	2	6	8	0	0	8	0	0
6	42933403	.	T	A	4	2	6	0	0	6	0	0
6	44914915	.	G	T	3	2	5	0	0	5	0	0
6	44939209	.	A	G	4	6	10	0	0	10	0	0
6	44942314	.	G	A	0	2	2	0	2	4	0	0
6	44945233	.	A	G	4	4	8	0	1	9	0	0
6	44945585	.	C	T	6	5	11	0	1	12	0	0
6	44950364	.	C	T	4	4	8	0	0	8	0	0
6	44950644	.	C	T	5	10	15	0	0	15	0	0
6	44950701	.	T	G	5	4	9	0	1	10	0	0
6	44961519	.	A	G	10	5	15	0	1	16	0	0
6	44970154	.	A	G	3	0	3	0	8	11	0	0
6	44977406	.	G	A	11	9	20	0	3	23	0	0
6	45927385	.	A	G	1	2	3	0	0	3	0	0
6	46343180	.	T	C	2	2	4	0	0	4	0	0
6	46357708	.	C	A	0	3	3	0	5	8	0	0
6	46410500	.	T	C	1	2	3	0	0	3	0	0
6	46412975	.	A	T	1	2	3	0	0	3	0	0
6	46413942	.	T	C	3	2	5	0	0	5	0	0
6	46413948	.	G	A	2	2	4	0	0	4	0	0
6	46419928	.	A	T	4	2	6	0	0	6	0	0
6	46422955	.	G	A	3	5	8	0	0	8	0	0
6	46423470	.	C	A	6	3	9	0	0	9	0	0
6	46423593	.	G	T	5	6	11	0	2	13	0	0
6	46425620	.	A	G	9	4	13	1	1	15	0	0
6	46428718	.	A	C	9	7	16	0	1	17	0	0
6	46431113	.	G	A	1	4	5	0	3	8	0	0
6	46431950	.	A	G	21	25	46	0	2	48	0	0
6	46432016	.	G	A	28	27	55	0	0	55	0	0
6	46450487	.	C	G	34	23	57	0	0	57	0	0
6	46450547	.	T	C	33	15	48	0	1	49	0	0
6	46450804	.	C	T	32	14	46	0	7	53	0	0
6	46452997	.	C	T	31	24	55	0	3	58	0	0
6	46454103	.	C	A	16	15	31	0	2	34	1	0
6	46454148	.	G	A	25	10	35	0	2	37	0	0
6	46454173	.	T	G	25	14	39	0	1	40	0	0
6	46454396	.	T	A	31	27	58	0	1	60	1	0
6	46507612	.	A	G	4	2	6	0	0	6	0	0
6	46701953	.	C	T	5	2	7	0	1	8	0	0
6	46715399	.	A	G	5	2	7	0	0	7	0	0
6	46715454	.	T	A	4	6	10	0	0	10	0	0
6	46716897	.	T	C	7	7	14	0	2	16	0	0
6	46716915	.	C	T	7	5	12	0	1	14	1	0
6	46716954	.	T	C	7	5	12	0	1	13	0	0
6	46717535	.	T	C	9	3	12	0	1	13	0	0
6	46717731	.	A	G	3	0	3	0	4	7	0	0
6	46717772	.	T	C	3	8	11	0	0	11	0	0
6	46718103	.	T	G	14	4	18	0	2	20	0	0
6	46718193	.	G	T	16	12	28	0	0	28	0	0
6	46718237	.	G	A	11	9	20	0	1	21	0	0
6	46718243	.	G	A	10	9	19	0	1	20	0	0
6	46721369	.	C	T	13	12	25	0	0	25	0	0
6	46722670	.	G	A	9	2	11	0	1	12	0	0
6	46722671	.	G	T	9	3	12	0	0	12	0	0
6	46722783	.	G	T	1	3	4	0	14	18	0	0
6	46722786	.	C	G	14	3	17	0	0	17	0	0
6	46722883	.	T	G	9	4	13	0	0	13	0	0
6	46725966	.	T	A	2	2	4	0	0	4	0	0
6	46726080	.	A	G	9	5	14	1	0	15	0	0
6	46726234	.	T	G	4	4	8	0	2	10	0	0
6	46726901	.	C	T	5	6	11	0	0	11	0	0
6	46737003	.	C	T	1	3	4	0	0	4	0	0
6	47006599	.	G	A	15	13	28	0	1	29	0	0
6	47006611	.	A	G	15	15	30	0	0	30	0	0
6	47032679	.	C	T	11	5	16	0	3	19	0	0
6	47032772	.	A	G	6	7	13	0	2	15	0	0
6	47054448	.	A	G	5	6	11	0	0	11	0	0
6	47246513	.	C	T	3	5	8	0	0	8	0	0
6	47460346	.	T	A	2	2	4	0	0	4	0	0
6	47530011	.	A	G	3	4	7	0	1	8	0	0
6	47530049	.	A	G	4	4	8	0	0	8	0	0
6	47530112	.	C	G	3	3	6	0	0	6	0	0
6	47530428	.	T	C	4	4	8	0	0	8	0	0
6	47530828	.	C	T	0	5	5	0	5	10	0	0
6	47531110	.	C	A	9	4	13	0	1	14	0	0
6	47531176	.	G	C	2	0	2	0	6	8	0	0
6	47540060	.	C	T	1	3	4	0	0	4	0	0
6	47540093	.	C	T	1	3	4	0	0	4	0	0
6	47540279	.	C	T	5	4	9	0	0	9	0	0
6	47540405	.	A	T	2	3	5	0	0	5	0	0
6	47558374	.	C	T	1	4	5	0	2	7	0	0
6	47571152	.	C	T	2	3	5	0	0	5	0	0
6	47574248	.	C	T	0	2	2	0	3	5	0	0
6	47809905	.	T	G	4	4	8	0	0	8	0	0
6	47810323	.	A	G	9	7	16	0	0	16	0	0
6	47810671	.	T	A	11	4	15	0	2	17	0	0
6	47810804	.	A	T	4	8	12	0	1	13	0	0
6	47810810	.	T	A	8	4	12	0	1	13	0	0
6	47810941	.	C	T	1	5	6	0	6	12	0	0
6	47811024	.	G	A	5	14	19	0	3	22	0	0
6	47811463	.	G	A	5	5	10	0	0	10	0	0
6	47811473	.	G	A	6	5	11	0	0	11	0	0
6	47811687	.	T	C	1	0	1	0	4	5	0	0
6	47811875	.	A	C	1	6	7	0	0	7	0	0
6	47811890	.	G	A	1	4	5	0	1	6	0	0
6	47811940	.	G	A	3	5	8	0	1	9	0	0
6	47811993	.	A	G	6	2	8	0	0	8	0	0
6	47812193	.	C	A	4	2	6	0	0	6	0	0
6	47812280	.	G	C	2	0	2	0	2	4	0	0
6	47813006	.	A	T	2	2	4	0	0	4	0	0
6	47813011	.	C	T	1	3	4	0	1	5	0	0
6	47813100	.	T	G	5	3	8	0	1	9	0	0
6	47813499	.	G	A	3	4	7	0	0	7	0	0
6	47813548	.	T	C	2	4	6	0	1	7	0	0
6	47813877	.	G	A	7	6	13	0	0	13	0	0
6	47816406	.	G	C	1	2	3	0	0	3	0	0
6	47816512	.	G	A	2	4	6	0	0	6	0	0
6	47820011	.	C	A	0	2	2	0	2	4	0	0
6	47825288	.	G	A	2	3	5	0	1	6	0	0
6	47825364	.	T	A	4	3	7	0	0	7	0	0
6	47825488	.	G	A	1	4	5	0	0	5	0	0
6	47825537	.	G	A	3	3	6	0	0	6	0	0
6	47838392	.	T	C	3	0	3	0	2	5	0	0
6	47858196	.	C	T	2	3	5	0	0	5	0	0
6	47865238	.	C	G	6	4	10	0	0	10	0	0
6	47865287	.	C	A	1	5	6	0	0	6	0	0
6	47865322	.	C	T	2	6	8	0	0	8	0	0
6	47865391	.	C	T	6	9	15	0	0	15	0	0
6	47865553	.	T	C	7	4	11	0	0	11	0	0
6	47865554	.	C	G	6	0	6	0	5	11	0	0
6	47865588	.	T	C	3	3	6	0	1	7	0	0
6	47865626	.	G	T	4	3	7	0	0	7	0	0
6	47865661	.	A	T	4	7	11	0	0	11	0	0
6	47869454	.	C	T	2	3	5	0	0	5	0	0
6	47869500	.	C	T	4	2	6	0	1	7	0	0
6	47869510	.	C	G	2	5	7	0	0	7	0	0
6	47869982	.	G	A	6	8	14	0	0	14	0	0
6	47870185	.	T	C	4	0	4	0	3	7	0	0
6	47870463	.	G	A	4	6	10	0	2	12	0	0
6	47872510	.	G	A	8	4	12	0	1	13	0	0
6	47875681	.	G	A	4	7	11	0	0	11	0	0
6	47879230	.	C	T	3	5	8	0	0	8	0	0
6	48047026	.	G	A	0	4	4	0	2	6	0	0
6	48051766	.	G	A	2	2	4	0	0	4	0	0
6	48051920	.	T	C	2	4	6	0	0	6	0	0
6	48052127	.	G	A	2	5	7	0	0	7	0	0
6	48052310	.	C	T	4	5	9	0	1	10	0	0
6	48054766	.	C	T	4	4	8	0	1	9	0	0
6	48057928	.	C	T	17	15	32	0	2	34	0	0
6	48058088	.	T	A	2	2	4	0	0	4	0	0
6	48058628	.	A	G	7	8	15	0	0	15	0	0
6	49108157	.	T	C	13	5	18	0	0	18	0	0
6	49109093	.	T	C	21	8	29	1	0	30	0	0
6	49109122	.	T	C	22	1	23	0	9	32	0	0
6	49577497	.	A	G	2	2	4	0	0	4	0	0
6	49737949	.	A	G	6	6	12	0	1	13	0	0
6	49738006	.	A	G	9	4	13	0	2	15	0	0
6	49738171	.	A	G	3	0	3	0	14	17	0	0
6	49738348	.	A	G	9	0	9	0	5	14	0	0
6	49738353	.	A	G	8	0	8	0	8	16	0	0
6	49738490	.	A	G	12	6	18	0	0	18	0	0
6	49738506	.	A	G	11	5	16	0	1	17	0	0
6	49738752	.	A	G	12	3	15	0	1	16	0	0
6	49738807	.	A	G	5	3	8	0	1	9	0	0
6	49738823	.	A	G	4	8	12	0	0	12	0	0
6	51531900	.	T	C	4	2	6	0	0	6	0	0
6	52223936	.	A	G	36	11	47	0	3	50	0	0
6	52223956	.	A	G	40	11	51	0	3	54	0	0
6	52224090	.	A	G	30	23	53	0	0	53	0	0
6	52224406	.	A	G	33	27	60	0	2	62	0	0
6	52224537	.	A	G	34	7	41	0	4	45	0	0
6	54806566	.	T	C	6	4	10	0	0	10	0	0
6	55217796	.	A	G	3	6	9	0	2	11	0	0
6	55218047	.	A	G	2	8	10	0	0	10	0	0
6	55218127	.	A	G	7	6	13	0	2	15	0	0
6	55218137	.	A	G	3	9	12	0	2	14	0	0
6	55218340	.	A	G	6	6	12	0	0	12	0	0
6	55335648	.	A	G	6	2	8	0	0	8	0	0
6	57401624	.	C	T	0	3	3	0	2	5	0	0
6	57401665	.	C	T	2	2	4	0	0	4	0	0
6	57402114	.	C	T	0	2	2	0	2	4	0	0
6	57405666	.	C	T	1	2	3	0	1	4	0	0
6	57439021	.	T	C	8	9	17	0	0	17	0	0
6	57439429	.	C	T	7	8	15	0	1	16	0	0
6	57455557	.	T	C	6	8	14	0	0	14	0	0
6	57459817	.	C	T	5	3	8	0	1	9	0	0
6	57459823	.	T	G	6	3	9	0	0	9	0	0
6	57478900	.	C	T	2	16	18	0	25	43	0	0
6	57481377	.	A	G	23	26	49	2	2	53	0	0
6	57492086	.	G	A	8	11	19	0	1	20	0	0
6	57492208	.	G	A	3	7	10	0	0	10	0	0
6	57492209	.	A	G	3	6	9	0	1	10	0	0
6	57494354	.	C	G	0	10	10	0	4	14	0	0
6	57498040	.	G	A	6	4	10	0	0	10	0	0
6	57498088	.	T	C	6	9	15	0	1	16	0	0
6	57498253	.	A	G	6	5	11	0	0	11	0	0
6	57498255	.	A	T	6	5	11	0	0	11	0	0
6	57500563	.	G	A	5	3	8	0	0	8	0	0
6	57500608	.	C	T	2	1	3	0	0	3	0	0
6	57500617	.	G	C	2	1	3	0	1	4	0	0
6	57504571	.	G	T	6	4	10	0	0	10	0	0
6	57504592	.	C	T	6	4	10	0	0	10	0	0
6	57508317	.	G	A	6	5	11	0	0	11	0	0
6	57510245	.	T	A	2	4	6	0	0	6	0	0
6	57510254	.	T	A	2	4	6	0	0	6	0	0
6	57519053	.	T	C	5	0	5	0	5	10	0	0
6	57519534	.	G	A	2	2	4	0	0	4	0	0
6	57519597	.	G	C	2	7	9	0	1	10	0	0
6	57523315	.	T	G	3	3	6	0	0	6	0	0
6	57523330	.	T	A	2	3	5	0	0	5	0	0
6	57538896	.	G	C	1	2	3	0	1	4	0	0
6	57541942	.	T	A	17	14	31	0	1	32	0	0
6	57583996	.	T	C	17	9	26	0	1	27	0	0
6	57595160	.	T	C	16	11	27	0	0	27	0	0
6	57595196	.	T	C	16	13	29	0	0	29	0	0
6	57618934	.	C	T	26	23	49	0	2	51	0	0
6	57620177	.	T	C	20	24	44	0	2	46	0	0
6	57620315	.	A	C	19	22	41	0	0	41	0	0
6	57630819	.	A	G	7	8	15	0	0	15	0	0
6	57630879	.	C	A	4	4	8	0	0	8	0	0
6	57634880	.	T	G	11	10	21	0	1	22	0	0
6	57634922	.	G	A	16	8	24	0	1	25	0	0
6	57634949	.	G	A	17	6	23	0	1	24	0	0
6	57638474	.	T	G	10	5	15	0	0	15	0	0
6	57644311	.	A	G	5	4	9	0	4	13	0	0
6	57644779	.	C	T	6	8	14	0	1	15	0	0
6	57651978	.	C	A	7	4	11	0	1	12	0	0
6	57652041	.	T	C	4	0	4	0	6	10	0	0
6	57652209	.	T	C	5	8	13	0	3	16	0	0
6	57900462	.	C	T	4	7	11	0	0	11	0	0
6	57901172	.	C	T	8	11	19	1	0	20	0	0
6	57909090	.	T	C	8	0	8	0	14	22	0	0
6	57930218	.	A	G	9	5	14	0	0	14	0	0
6	57984041	.	C	T	5	6	11	0	1	12	0	0
6	58038349	.	A	C	4	0	4	0	3	7	0	0
6	58304147	.	T	C	0	2	2	0	1	3	0	0
6	58304148	.	C	T	1	2	3	0	0	3	0	0
6	58307588	.	C	T	1	2	3	0	1	4	0	0
6	58359460	.	T	C	6	3	9	0	0	9	0	0
6	58369530	.	T	C	4	2	6	0	1	7	0	0
6	58370814	.	A	G	2	0	2	0	2	4	0	0
6	58370817	.	C	T	2	5	7	0	0	7	0	0
6	58374023	.	C	T	3	3	6	0	0	6	0	0
6	58374026	.	C	A	3	4	7	0	0	7	0	0
6	58374508	.	T	C	2	4	6	0	0	6	0	0
6	58382915	.	T	G	7	5	12	0	1	13	0	0
6	58382939	.	C	T	4	8	12	0	0	12	0	0
6	58382954	.	C	T	5	6	11	0	0	11	0	0
6	58384067	.	A	G	6	0	6	0	3	9	0	0
6	58389115	.	A	C	7	12	19	0	0	19	0	0
6	58389139	.	C	T	14	7	21	0	0	21	0	0
6	58389151	.	G	T	5	9	14	0	1	15	0	0
6	58393919	.	A	T	7	8	15	0	1	16	0	0
6	58395444	.	G	A	1	10	11	0	15	26	0	0
6	58395451	.	C	A	14	11	25	0	0	25	0	0
6	58448412	.	T	C	2	5	7	0	0	7	0	0
6	58459515	.	A	G	3	3	6	0	0	6	0	0
6	58463787	.	C	T	2	4	6	0	1	7	0	0
6	58495573	.	G	T	4	4	8	0	0	8	0	0
6	58496002	.	A	G	3	0	3	0	6	9	0	0
6	58496148	.	T	C	3	5	8	0	0	8	0	0
6	58496580	.	T	G	2	2	4	0	1	5	0	0
6	58497002	.	T	C	1	4	5	0	0	5	0	0
6	58497739	.	G	A	3	1	4	0	1	5	0	0
6	58497757	.	C	T	4	1	5	0	1	6	0	0
6	58497864	.	A	T	6	6	12	0	0	12	0	0
6	58498040	.	T	A	4	2	6	0	1	7	0	0
6	58498087	.	G	A	3	3	6	0	0	7	1	0
6	58498101	.	T	G	3	4	7	0	0	7	0	0
6	58498298	.	T	G	2	2	4	0	0	4	0	0
6	58498352	.	C	A	2	3	5	0	0	5	0	0
6	58498439	.	A	T	3	1	4	0	0	4	0	0
6	58499600	.	A	C	4	2	6	0	0	6	0	0
6	58499657	.	T	C	4	4	8	0	1	9	0	0
6	58499755	.	T	C	3	2	5	0	0	5	0	0
6	58499773	.	T	C	1	2	3	0	0	3	0	0
6	58522771	.	A	G	10	9	19	0	0	19	0	0
6	58524509	.	C	A	16	11	27	0	0	27	0	0
6	58549100	.	A	G	28	0	28	1	24	53	0	0
6	58553387	.	G	A	25	18	43	0	3	46	0	0
6	58553424	.	T	C	26	26	52	0	2	54	0	0
6	58560682	.	G	A	31	27	58	0	0	58	0	0
6	58560718	.	G	A	30	32	62	0	0	62	0	0
6	58561057	.	T	C	21	19	40	0	1	41	0	0
6	58561081	.	A	C	13	19	32	0	4	36	0	0
6	58561190	.	C	G	18	13	31	0	0	31	0	0
6	58561673	.	A	G	33	8	41	1	5	47	0	0
6	58562407	.	T	A	25	8	33	5	5	43	0	0
6	58563093	.	T	A	19	28	47	0	2	49	0	0
6	58563157	.	T	C	22	21	43	0	6	49	0	0
6	58563159	.	G	A	23	26	49	0	1	50	0	0
6	58563229	.	A	C	28	17	45	3	0	49	1	0
6	58563374	.	C	T	16	16	32	0	2	34	0	0
6	58563415	.	A	T	11	10	21	0	1	22	0	0
6	58596573	.	C	T	1	2	3	0	0	3	0	0
6	58698875	.	C	A	9	3	12	0	1	13	0	0
6	58698910	.	T	G	4	0	4	0	4	8	0	0
6	58708185	.	A	G	3	8	11	1	0	12	0	0
6	58708194	.	T	C	4	7	11	0	0	11	0	0
6	58708227	.	T	G	8	8	16	0	0	16	0	0
6	58712458	.	G	C	11	6	17	0	0	17	0	0
6	58712540	.	G	A	1	6	7	0	5	12	0	0
6	58723254	.	C	G	4	6	10	0	0	10	0	0
6	58723383	.	T	G	8	13	21	0	1	22	0	0
6	58725930	.	T	C	7	9	16	0	0	16	0	0
6	58726154	.	A	G	14	15	29	0	2	31	0	0
6	58728706	.	G	A	0	7	7	0	12	19	0	0
6	58728825	.	A	G	4	8	12	0	0	12	0	0
6	58728858	.	G	A	1	9	10	0	4	14	0	0
6	58729053	.	T	A	12	4	16	0	1	17	0	0
6	58729059	.	T	G	14	0	14	0	2	16	0	0
6	58729100	.	C	G	11	1	12	0	3	15	0	0
6	58729120	.	T	C	12	10	22	0	0	22	0	0
6	58729145	.	G	A	11	9	20	0	1	21	0	0
6	58730208	.	A	T	3	10	13	0	0	13	0	0
6	58730474	.	A	T	1	2	3	0	0	3	0	0
6	58730493	.	G	C	1	2	3	0	0	3	0	0
6	58730657	.	T	C	4	8	12	0	2	14	0	0
6	58732475	.	C	G	18	16	34	0	2	37	1	0
6	58772271	.	T	A	17	12	29	0	4	33	0	0
6	58772272	.	G	A	20	11	31	0	2	33	0	0
6	58773647	.	T	G	18	13	31	0	0	31	0	0
6	58773785	.	C	T	1	8	9	0	14	23	0	0
6	58773788	.	A	G	14	9	23	0	1	24	0	0
6	58778896	.	G	C	9	0	9	0	10	19	0	0
6	58781017	.	G	A	7	17	24	0	4	28	0	0
6	58789896	.	A	G	6	8	14	0	0	14	0	0
6	58808298	.	G	A	8	5	13	0	0	13	0	0
6	58808328	.	C	T	9	10	19	0	0	19	0	0
6	58828036	.	A	G	7	6	13	0	1	14	0	0
6	58855648	.	C	T	20	10	30	0	1	31	0	0
6	58857964	.	A	G	24	0	24	0	21	45	0	0
6	58859737	.	G	A	2	17	19	0	23	42	0	0
6	58861707	.	A	G	19	15	34	0	2	36	0	0
6	58862341	.	G	A	3	25	28	0	17	45	0	0
6	58867018	.	A	G	28	1	29	0	25	54	0	0
6	58867240	.	A	G	22	8	30	0	1	31	0	0
6	58867362	.	A	G	21	5	26	0	1	27	0	0
6	58867453	.	A	G	31	11	42	0	3	45	0	0
6	58867470	.	C	A	21	16	37	0	0	38	1	0
6	58873918	.	T	C	2	6	8	0	1	9	0	0
6	58873926	.	G	C	2	7	9	0	0	9	0	0
6	58874121	.	T	C	3	0	3	0	2	5	0	0
6	58875665	.	T	C	3	0	3	1	3	7	0	0
6	58877981	.	G	C	5	0	5	0	4	9	0	0
6	58878077	.	T	C	5	2	7	0	0	7	0	0
6	58889690	.	A	G	3	4	7	0	0	7	0	0
6	58889713	.	T	C	3	5	8	0	0	8	0	0
6	58891765	.	T	A	2	2	4	0	0	4	0	0
6	58892717	.	C	T	2	2	4	0	1	5	0	0
6	58892828	.	T	C	1	0	1	0	4	5	0	0
6	58918095	.	T	C	12	8	20	0	0	20	0	0
6	58918506	.	A	G	13	0	13	1	20	34	0	0
6	58918676	.	T	G	14	19	33	0	1	34	0	0
6	58918693	.	T	C	11	14	25	0	3	28	0	0
6	58921434	.	C	A	7	7	14	0	0	14	0	0
6	58921506	.	G	T	8	9	17	0	0	17	0	0
6	58923246	.	T	C	2	6	8	0	3	11	0	0
6	58939261	.	T	C	4	4	8	0	1	9	0	0
6	58939303	.	G	T	3	4	7	0	0	7	0	0
6	58948931	.	C	T	4	10	14	0	0	14	0	0
6	58949364	.	C	A	0	3	3	0	2	5	0	0
6	58953366	.	C	T	4	3	7	0	1	8	0	0
6	58974749	.	C	A	1	3	4	0	1	5	0	0
6	59198644	.	G	A	1	7	8	0	0	8	0	0
6	59652091	.	C	T	3	2	5	0	0	5	0	0
6	59671954	.	A	G	3	0	3	0	9	12	0	0
6	59679633	.	G	A	0	5	5	0	12	17	0	0
6	59679636	.	C	A	6	9	15	0	1	16	0	0
6	59681450	.	A	T	2	9	11	0	4	15	0	0
6	59681464	.	G	A	3	6	9	1	2	12	0	0
6	59691533	.	C	T	4	10	14	0	0	14	0	0
6	59813578	.	G	A	3	20	23	0	24	47	0	0
6	59813608	.	A	G	22	16	38	0	5	43	0	0
6	59813857	.	G	A	1	20	21	0	13	34	0	0
6	59813905	.	A	G	20	1	21	0	16	37	0	0
6	59819362	.	C	T	17	15	32	0	2	34	0	0
6	59824482	.	C	T	21	20	41	1	1	43	0	0
6	59824496	.	C	T	19	15	34	1	2	37	0	0
6	59824672	.	C	T	24	15	39	0	4	43	0	0
6	59824736	.	C	T	23	17	40	0	0	40	0	0
6	59832922	.	T	C	10	13	23	0	0	23	0	0
6	59833006	.	T	A	9	10	19	0	1	20	0	0
6	59833007	.	A	G	9	10	19	0	1	20	0	0
6	59837587	.	C	G	9	10	19	0	0	19	0	0
6	59837710	.	A	G	17	21	38	0	2	40	0	0
6	59837747	.	G	A	0	16	16	0	17	33	0	0
6	59839033	.	G	A	3	10	13	0	13	26	0	0
6	59839048	.	G	A	16	8	24	0	1	25	0	0
6	59841394	.	G	A	0	20	20	0	9	29	0	0
6	59845096	.	A	G	1	2	3	0	0	3	0	0
6	59848119	.	C	T	30	26	56	0	2	58	0	0
6	59848345	.	T	C	28	21	49	1	2	52	0	0
6	59848624	.	C	G	19	6	25	6	1	32	0	0
6	59848894	.	T	C	21	19	40	1	2	43	0	0
6	59850253	.	C	T	24	14	38	0	0	38	0	0
6	59850308	.	T	C	22	17	39	0	3	42	0	0
6	59854344	.	G	T	3	3	6	0	7	13	0	0
6	59874147	.	G	A	0	6	6	0	5	11	0	0
6	59882680	.	T	C	12	9	21	0	0	21	0	0
6	59882704	.	T	C	12	7	19	0	1	20	0	0
6	59883154	.	G	A	7	8	15	0	1	16	0	0
6	59889640	.	G	T	1	6	7	0	10	17	0	0
6	59891289	.	T	C	11	11	22	0	0	22	0	0
6	59892864	.	C	T	9	7	16	0	4	20	0	0
6	59894548	.	T	C	10	12	22	0	1	23	0	0
6	59894580	.	T	A	14	10	24	0	3	27	0	0
6	59894719	.	T	C	15	7	22	0	0	22	0	0
6	59915599	.	T	C	13	4	17	0	0	17	0	0
6	59915608	.	T	C	16	5	21	0	1	22	0	0
6	59917077	.	T	C	5	7	12	0	0	12	0	0
6	59921661	.	T	G	14	14	28	0	0	28	0	0
6	59921685	.	T	C	11	14	25	0	1	26	0	0
6	59921788	.	A	C	7	13	20	0	0	20	0	0
6	59939277	.	G	A	15	12	27	0	0	27	0	0
6	59945088	.	A	G	4	3	7	2	0	9	0	0
6	59949374	.	C	A	6	2	8	2	1	11	0	0
6	59949585	.	A	G	3	7	10	0	2	12	0	0
6	59949591	.	G	A	7	4	11	0	1	12	0	0
6	59951038	.	C	T	3	3	6	0	0	6	0	0
6	59951450	.	T	A	4	6	10	0	0	10	0	0
6	59951483	.	C	G	4	3	7	0	0	7	0	0
6	59971374	.	T	C	14	2	16	0	20	36	0	0
6	59971416	.	C	T	25	23	48	0	3	51	0	0
6	59971598	.	A	G	35	13	48	0	3	51	0	0
6	59971711	.	G	A	27	19	46	4	0	50	0	0
6	59971718	.	C	A	25	20	45	4	3	52	0	0
6	59971897	.	G	A	3	6	9	2	0	11	0	0
6	59972259	.	T	A	9	18	27	2	0	29	0	0
6	59985833	.	C	T	3	5	8	0	0	8	0	0
6	59999765	.	C	T	1	3	4	0	0	4	0	0
6	60031520	.	G	A	12	9	21	0	0	21	0	0
6	60031641	.	C	T	2	4	6	1	12	19	0	0
6	60043150	.	A	G	1	8	9	0	0	9	0	0
6	60043580	.	G	C	5	3	8	0	0	8	0	0
6	60043792	.	T	C	7	9	16	0	0	16	0	0
6	60043842	.	C	T	7	6	13	0	0	13	0	0
7	742828	.	T	C	13	24	37	0	1	38	0	0
7	847189	.	A	T	6	6	12	0	0	12	0	0
7	861057	.	G	C	3	3	6	1	0	7	0	0
7	1417813	.	A	T	4	3	7	1	0	8	0	0
7	1418299	.	A	G	5	6	11	0	0	11	0	0
7	1418310	.	T	C	5	6	11	1	0	12	0	0
7	1418631	.	T	C	3	2	5	0	0	5	0	0
7	3931029	.	A	G	34	20	54	0	5	59	0	0
7	3931264	.	C	T	29	22	51	0	0	51	0	0
7	3931396	.	A	T	20	35	55	0	3	58	0	0
7	3931543	.	A	T	26	32	58	0	1	59	0	0
7	3931598	.	G	T	17	31	48	0	4	52	0	0
7	3931644	.	T	C	29	0	29	0	23	52	0	0
7	3932209	.	A	T	10	22	32	0	1	34	1	0
7	3932463	.	T	G	9	12	21	2	1	24	0	0
7	3932546	.	C	A	8	5	13	0	0	13	0	0
7	3932694	.	G	A	27	12	39	0	2	41	0	0
7	3932698	.	T	C	29	16	45	0	1	46	0	0
7	3932731	.	C	A	28	14	42	0	4	46	0	0
7	3932935	.	C	A	27	14	41	0	4	45	0	0
7	3933121	.	G	A	28	26	54	0	0	54	0	0
7	3933243	.	C	A	23	12	35	0	0	35	0	0
7	3933271	.	C	T	25	12	37	0	1	38	0	0
7	3933383	.	A	C	13	0	13	0	22	35	0	0
7	3933481	.	T	C	29	0	29	0	10	39	0	0
7	3933483	.	C	T	3	9	12	0	26	38	0	0
7	3933998	.	C	T	20	16	36	0	0	36	0	0
7	3934038	.	A	T	11	15	26	0	1	27	0	0
7	3934208	.	T	C	31	5	36	0	1	37	0	0
7	3934387	.	C	T	18	16	34	0	2	36	0	0
7	3934428	.	G	T	20	25	45	0	0	45	0	0
7	3934551	.	A	T	16	4	20	0	1	21	0	0
7	3934645	.	A	C	11	10	21	0	1	22	0	0
7	3934818	.	G	A	12	4	16	0	0	16	0	0
7	3934970	.	A	G	7	15	22	0	1	23	0	0
7	3935055	.	T	C	12	19	31	0	1	32	0	0
7	3935123	.	A	G	11	16	27	0	1	28	0	0
7	3935283	.	G	A	11	20	31	0	2	33	0	0
7	3935737	.	C	T	3	9	12	0	20	32	0	0
7	3935788	.	C	A	12	10	22	2	0	24	0	0
7	3936127	.	C	T	0	14	14	0	15	30	1	0
7	3936702	.	A	G	2	5	7	0	1	8	0	0
7	3936764	.	G	A	9	8	17	0	1	18	0	0
7	3936946	.	C	T	1	5	6	0	16	22	0	0
7	3951010	.	C	T	2	11	13	0	10	23	0	0
7	3951115	.	G	A	14	10	24	0	1	25	0	0
7	3952993	.	A	G	10	14	24	0	2	26	0	0
7	3955628	.	G	A	4	13	17	0	0	17	0	0
7	4088334	.	C	T	9	18	27	0	2	29	0	0
7	4088545	.	C	T	0	17	17	0	13	30	0	0
7	4088680	.	G	A	9	18	27	0	3	30	0	0
7	4088727	.	A	T	25	17	42	0	2	44	0	0
7	4088832	.	A	G	19	20	39	0	2	41	0	0
7	4089042	.	A	G	24	8	32	0	2	34	0	0
7	4089090	.	G	A	19	8	27	0	0	27	0	0
7	4095265	.	C	T	0	28	28	0	13	41	0	0
7	4100931	.	C	T	13	16	29	0	1	30	0	0
7	4100967	.	G	A	11	17	28	0	2	30	0	0
7	4110441	.	T	C	6	0	6	0	9	15	0	0
7	4163069	.	A	G	2	2	4	0	0	4	0	0
7	4163076	.	A	T	2	2	4	0	0	4	0	0
7	4167386	.	C	T	4	2	6	0	0	6	0	0
7	4174962	.	G	A	0	6	6	0	1	7	0	0
7	4175054	.	G	A	2	10	12	0	0	12	0	0
7	4175078	.	G	A	1	7	8	0	0	8	0	0
7	4179204	.	G	A	1	2	3	0	1	4	0	0
7	4183317	.	G	A	4	3	7	0	0	7	0	0
7	4183345	.	C	T	3	2	5	0	1	6	0	0
7	4183602	.	T	G	2	2	4	0	0	4	0	0
7	4183604	.	C	A	2	2	4	0	0	4	0	0
7	4184897	.	G	T	4	2	6	0	0	6	0	0
7	4185160	.	A	T	12	9	21	0	1	22	0	0
7	4185556	.	A	G	2	3	5	0	1	6	0	0
7	4185569	.	A	G	5	5	10	0	0	10	0	0
7	4186499	.	A	G	7	8	15	2	0	17	0	0
7	4186532	.	G	A	4	4	8	1	7	16	0	0
7	4186568	.	T	A	3	9	12	0	2	14	0	0
7	5324609	.	T	A	1	4	5	1	0	6	0	0
7	5380480	.	T	A	7	3	10	0	3	13	0	0
7	5467608	.	C	T	1	6	7	0	0	7	0	0
7	7038762	.	G	A	0	2	2	0	1	3	0	0
7	7042115	.	A	G	22	6	28	5	1	34	0	0
7	7245508	.	C	G	2	2	4	0	1	5	0	0
7	7248193	.	C	T	13	14	27	0	5	32	0	0
7	7248212	.	A	T	10	11	21	0	7	28	0	0
7	7372341	.	A	G	4	11	15	0	0	15	0	0
7	7372404	.	A	G	20	7	27	1	0	28	0	0
7	7478533	.	T	C	17	12	29	0	2	31	0	0
7	7552113	.	G	A	9	9	18	0	0	18	0	0
7	7597059	.	A	G	4	0	4	0	9	13	0	0
7	7608920	.	G	A	0	6	6	0	13	19	0	0
7	7608944	.	T	G	12	1	13	0	8	21	0	0
7	7608965	.	C	T	10	10	20	0	1	21	0	0
7	7611758	.	C	T	22	11	33	0	1	34	0	0
7	7611803	.	C	A	10	6	16	0	12	28	0	0
7	7611866	.	T	C	13	10	23	0	0	23	0	0
7	7617855	.	T	C	19	16	35	0	4	39	0	0
7	7617963	.	C	G	12	16	28	0	1	29	0	0
7	7624082	.	A	G	14	25	39	0	6	45	0	0
7	7624090	.	T	C	19	23	42	0	3	45	0	0
7	7641230	.	A	T	20	20	40	0	2	42	0	0
7	7641351	.	G	A	14	19	33	0	2	35	0	0
7	7641353	.	G	A	15	20	35	0	0	35	0	0
7	7641559	.	C	T	16	27	43	0	0	43	0	0
7	7641567	.	C	T	14	24	38	0	2	40	0	0
7	7641608	.	A	G	12	19	31	0	1	32	0	0
7	7641678	.	T	A	19	7	26	0	3	29	0	0
7	7641976	.	T	C	17	10	27	0	1	28	0	0
7	7641984	.	G	T	16	9	25	0	1	26	0	0
7	7642730	.	C	T	18	19	37	0	2	39	0	0
7	7642819	.	G	A	19	14	33	0	0	33	0	0
7	7642840	.	T	A	14	9	23	0	2	25	0	0
7	7642856	.	C	T	16	9	25	0	0	25	0	0
7	7642944	.	C	T	7	6	13	0	0	13	0	0
7	7642991	.	T	A	3	3	6	0	0	6	0	0
7	7643184	.	A	G	16	0	16	0	18	34	0	0
7	7643348	.	G	A	21	21	42	0	1	43	0	0
7	7643362	.	T	A	20	20	40	1	2	43	0	0
7	7643488	.	A	G	25	28	53	0	2	56	1	0
7	7643629	.	A	G	27	28	55	0	5	60	0	0
7	7662467	.	C	G	11	5	16	0	0	16	0	0
7	7662475	.	T	C	12	0	12	0	7	19	0	0
7	7662527	.	A	C	15	11	26	0	0	26	0	0
7	7662580	.	G	A	13	19	32	0	1	33	0	0
7	7662872	.	A	C	16	12	28	0	1	29	0	0
7	7662978	.	A	C	13	16	29	0	1	30	0	0
7	7663017	.	T	A	16	15	31	0	1	32	0	0
7	7663048	.	A	G	16	17	33	0	0	33	0	0
7	7663132	.	A	G	21	10	31	0	0	31	0	0
7	7663152	.	A	T	22	7	29	0	0	29	0	0
7	7663320	.	C	G	18	9	27	0	0	27	0	0
7	7663449	.	A	C	17	0	17	0	6	23	0	0
7	7663453	.	A	T	16	6	22	0	1	23	0	0
7	7663682	.	C	T	4	6	10	0	12	22	0	0
7	7663902	.	G	T	10	5	15	1	0	16	0	0
7	7664011	.	A	G	7	2	9	0	0	9	0	0
7	7664026	.	G	A	6	3	9	0	0	9	0	0
7	7664083	.	G	A	3	3	6	0	0	6	0	0
7	7664503	.	G	A	1	3	4	0	0	4	0	0
7	7664558	.	G	T	6	7	13	1	0	14	0	0
7	7664838	.	G	T	10	4	14	0	0	14	0	0
7	7664870	.	G	T	9	4	13	0	0	13	0	0
7	7664882	.	G	C	9	4	13	0	0	13	0	0
7	7664912	.	A	C	5	5	10	0	0	10	0	0
7	7665480	.	A	C	4	4	8	0	0	8	0	0
7	7666388	.	G	A	10	5	15	0	1	16	0	0
7	7666625	.	G	A	7	7	14	0	1	15	0	0
7	7674462	.	C	G	14	10	24	0	1	25	0	0
7	7674474	.	T	A	11	9	20	0	0	20	0	0
7	7676086	.	C	T	6	7	13	5	0	18	0	0
7	7676112	.	C	T	4	3	7	4	1	12	0	0
7	7680073	.	C	T	3	8	11	1	0	12	0	0
7	7681415	.	T	G	4	5	9	0	0	9	0	0
7	7681419	.	C	G	0	5	5	0	4	9	0	0
7	7685156	.	C	T	1	2	3	0	0	3	0	0
7	7696726	.	G	C	6	4	10	0	0	10	0	0
7	7696742	.	A	G	6	8	14	0	0	14	0	0
7	7696785	.	T	A	2	11	13	0	0	13	0	0
7	7696794	.	G	T	0	9	9	0	2	11	0	0
7	7700867	.	G	A	0	10	10	1	7	18	0	0
7	7700965	.	T	G	6	0	6	0	10	16	0	0
7	7700987	.	T	C	3	9	12	0	1	13	0	0
7	7701016	.	G	C	2	9	11	0	1	12	0	0
7	7705993	.	C	G	7	0	7	0	14	21	0	0
7	7706005	.	C	T	7	14	21	0	1	22	0	0
7	7706702	.	G	A	0	12	12	0	5	17	0	0
7	7706869	.	A	G	4	6	10	0	1	11	0	0
7	7706997	.	C	A	7	7	14	0	0	14	0	0
7	7707029	.	T	G	3	5	8	0	0	8	0	0
7	7707191	.	A	C	3	2	5	0	0	5	0	0
7	7707214	.	T	C	5	3	8	0	0	8	0	0
7	7708527	.	C	T	6	2	8	0	1	9	0	0
7	7708572	.	T	C	5	3	8	0	1	9	0	0
7	7708714	.	T	C	8	7	15	0	0	15	0	0
7	7708826	.	T	G	4	2	6	0	0	6	0	0
7	7708840	.	C	A	3	2	5	0	1	6	0	0
7	7709061	.	A	G	8	4	12	0	1	13	0	0
7	7709233	.	C	T	1	2	3	0	0	3	0	0
7	7779047	.	A	T	1	7	8	0	0	8	0	0
7	7779060	.	G	A	0	6	6	0	2	8	0	0
7	7796088	.	T	C	3	3	6	0	1	7	0	0
7	8694709	.	T	A	2	4	6	0	0	6	0	0
7	8694818	.	T	G	5	3	8	0	1	9	0	0
7	8694999	.	T	A	3	4	7	0	0	7	0	0
7	8695001	.	C	A	3	4	7	0	0	7	0	0
7	8695107	.	A	G	4	9	13	0	0	13	0	0
7	8890495	.	C	T	0	7	7	0	6	13	0	0
7	8890515	.	G	C	7	0	7	0	12	19	0	0
7	8891710	.	A	G	3	9	12	0	1	13	0	0
7	8891717	.	A	G	4	10	14	0	0	14	0	0
7	8891755	.	T	G	6	10	16	0	1	17	0	0
7	8909438	.	C	T	4	3	7	0	0	7	0	0
7	8950378	.	G	A	2	2	4	0	0	4	0	0
7	8950386	.	C	A	3	2	5	0	0	5	0	0
7	9212234	.	A	G	4	5	9	0	1	10	0	0
7	9224366	.	G	A	0	3	3	0	2	5	0	0
7	9229327	.	A	C	4	10	14	0	1	15	0	0
7	9232531	.	T	C	2	5	7	0	0	7	0	0
7	9232615	.	C	T	2	4	6	0	0	6	0	0
7	9232621	.	C	G	2	4	6	0	0	6	0	0
7	9238631	.	A	G	4	0	4	0	5	9	0	0
7	9261589	.	T	C	2	6	8	0	0	8	0	0
7	9291049	.	C	A	17	8	25	0	3	28	0	0
7	9299699	.	G	A	3	2	5	0	0	5	0	0
7	9299726	.	A	G	4	2	6	0	0	6	0	0
7	9302654	.	G	A	0	5	5	1	11	17	0	0
7	9302664	.	T	C	14	6	20	1	0	21	0	0
7	9302905	.	A	G	17	0	17	0	5	22	0	0
7	9302990	.	T	A	18	5	23	0	1	24	0	0
7	9303000	.	T	A	17	5	22	0	0	22	0	0
7	9304692	.	T	C	23	13	36	0	1	37	0	0
7	9308683	.	A	G	11	17	28	0	2	30	0	0
7	9308715	.	C	T	20	13	33	0	0	33	0	0
7	9308817	.	A	G	16	8	24	0	0	24	0	0
7	9312770	.	G	A	2	15	17	0	16	33	0	0
7	9317990	.	G	A	17	16	33	0	1	34	0	0
7	9319626	.	T	C	17	20	37	0	1	38	0	0
7	9319966	.	T	C	1	2	3	0	0	3	0	0
7	9320431	.	A	T	17	12	29	0	0	29	0	0
7	9320489	.	A	G	13	4	17	0	3	20	0	0
7	9320719	.	C	T	17	11	28	0	0	28	0	0
7	9321124	.	G	A	2	2	4	0	8	12	0	0
7	9321374	.	C	T	2	2	4	0	0	4	0	0
7	9321375	.	T	A	2	2	4	0	0	4	0	0
7	9321800	.	G	A	0	8	8	0	11	19	0	0
7	9321981	.	G	T	17	13	30	0	3	33	0	0
7	9322176	.	C	A	21	4	25	1	1	29	2	0
7	9322178	.	T	C	24	3	27	1	2	30	0	0
7	9322216	.	A	G	16	10	26	0	0	26	0	0
7	9322271	.	G	C	10	12	22	0	2	24	0	0
7	9322441	.	C	T	3	7	10	0	0	10	0	0
7	9509429	.	C	T	3	3	6	0	0	6	0	0
7	9509450	.	C	T	5	3	8	0	0	8	0	0
7	9511184	.	C	T	6	6	12	0	0	12	0	0
7	9844342	.	T	C	1	0	1	0	4	5	0	0
7	10873921	.	A	G	17	0	17	0	8	25	0	0
7	10875386	.	A	G	19	6	25	0	2	27	0	0
7	10875552	.	A	G	18	10	28	0	0	28	0	0
7	11340654	.	A	G	4	5	9	0	1	10	0	0
7	11340658	.	A	G	5	0	5	0	6	11	0	0
7	11340718	.	A	G	8	5	13	0	0	13	0	0
7	11341038	.	A	G	6	2	8	0	0	8	0	0
7	11341044	.	A	G	4	1	5	0	2	7	0	0
7	12844513	.	T	C	3	3	6	0	2	8	0	0
7	12844537	.	T	C	7	4	11	0	0	11	0	0
7	12844549	.	T	C	9	0	9	0	5	14	0	0
7	13565116	.	T	C	1	4	5	1	0	6	0	0
7	13569928	.	T	C	4	2	6	0	1	7	0	0
7	13617354	.	A	G	5	0	5	0	2	7	0	0
7	13617359	.	A	G	5	0	5	0	3	8	0	0
7	13858902	.	T	A	2	3	5	0	0	5	0	0
7	13897765	.	A	C	3	4	7	0	0	7	0	0
7	13897768	.	A	C	3	0	3	0	4	7	0	0
7	13897822	.	G	A	3	2	5	0	0	5	0	0
7	13897878	.	G	A	3	2	5	0	0	5	0	0
7	13897897	.	T	C	3	3	6	0	0	6	0	0
7	14203174	.	G	T	1	2	3	0	0	3	0	0
7	14204447	.	T	A	2	2	4	0	0	4	0	0
7	14204493	.	G	C	1	2	3	0	0	3	0	0
7	14204530	.	A	T	1	3	4	0	0	4	0	0
7	14205132	.	A	G	1	2	3	0	0	3	0	0
7	14205154	.	T	C	3	3	6	0	0	6	0	0
7	14205503	.	G	A	6	7	13	0	0	13	0	0
7	14205527	.	G	C	8	7	15	0	0	15	0	0
7	14205559	.	T	C	8	7	15	0	0	15	0	0
7	14205781	.	T	G	3	2	5	0	0	5	0	0
7	14205857	.	C	A	3	6	9	0	0	9	0	0
7	14205881	.	A	G	3	5	8	0	0	8	0	0
7	14205992	.	G	T	2	4	6	0	1	7	0	0
7	14206199	.	T	A	2	3	5	0	0	5	0	0
7	14206200	.	C	T	2	3	5	0	0	5	0	0
7	14206383	.	C	T	2	3	5	0	0	5	0	0
7	14206790	.	T	G	8	4	12	0	0	12	0	0
7	14262108	.	A	T	1	1	2	0	1	3	0	0
7	14262111	.	G	T	0	3	3	0	2	5	0	0
7	14350822	.	G	A	1	2	3	0	0	3	0	0
7	14381282	.	C	G	1	3	4	0	0	4	0	0
7	14393796	.	T	C	2	3	5	0	0	5	0	0
7	14393817	.	T	G	2	2	4	0	0	4	0	0
7	14394824	.	G	T	3	2	5	0	0	5	0	0
7	14394839	.	G	C	2	2	4	0	0	4	0	0
7	14394891	.	G	A	1	2	3	0	0	3	0	0
7	14394925	.	A	G	2	3	5	0	1	6	0	0
7	14394991	.	G	A	1	3	4	0	0	4	0	0
7	14395029	.	A	G	1	5	6	0	0	6	0	0
7	14417239	.	C	A	1	2	3	0	1	4	0	0
7	14423500	.	T	G	1	3	4	0	0	4	0	0
7	14512064	.	G	A	3	2	5	0	1	6	0	0
7	14512081	.	A	C	3	5	8	0	0	8	0	0
7	14512099	.	C	G	4	7	11	0	0	11	0	0
7	14532066	.	T	C	17	10	27	0	0	27	0	0
7	14534326	.	T	C	17	2	19	0	10	29	0	0
7	14534789	.	T	C	12	24	36	0	0	36	0	0
7	14535719	.	T	C	11	9	20	0	2	22	0	0
7	14535749	.	T	A	12	12	24	0	0	24	0	0
7	14535782	.	G	T	14	13	27	0	1	28	0	0
7	14535834	.	A	C	3	7	10	0	0	10	0	0
7	14536163	.	A	G	10	3	13	0	0	13	0	0
7	14539470	.	T	C	12	10	22	0	0	22	0	0
7	14542854	.	C	T	6	11	17	0	0	17	0	0
7	14542893	.	C	T	6	9	15	0	1	16	0	0
7	14543002	.	T	C	8	7	15	0	0	15	0	0
7	14543031	.	G	A	6	12	18	0	1	19	0	0
7	14543128	.	A	T	1	3	4	0	1	5	0	0
7	14543391	.	A	G	4	4	8	1	0	9	0	0
7	14543454	.	G	T	1	5	6	0	0	6	0	0
7	14543703	.	G	T	0	3	3	0	1	4	0	0
7	14543742	.	C	T	1	3	4	0	0	4	0	0
7	14632554	.	A	C	1	5	6	0	0	6	0	0
7	14774086	.	C	A	10	3	13	0	0	13	0	0
7	14789964	.	G	A	1	10	11	0	5	16	0	0
7	14860521	.	C	T	10	7	17	0	0	17	0	0
7	14860524	.	A	C	11	7	18	0	0	18	0	0
7	14900869	.	G	A	8	9	17	0	0	17	0	0
7	14905516	.	G	C	6	9	15	0	1	16	0	0
7	14937357	.	T	A	3	5	8	0	0	8	0	0
7	14938134	.	C	T	12	7	19	0	2	21	0	0
7	14938404	.	C	T	6	3	9	0	0	9	0	0
7	15087831	.	A	T	1	2	3	0	0	3	0	0
7	15087833	.	G	A	1	2	3	0	0	3	0	0
7	15088519	.	T	C	1	2	3	0	0	3	0	0
7	15602760	.	T	G	2	0	2	0	2	4	0	0
7	15604146	.	G	A	0	2	2	0	1	3	0	0
7	15605070	.	A	G	1	3	4	0	1	5	0	0
7	15605180	.	A	T	2	3	5	0	0	5	0	0
7	15605276	.	A	T	6	1	7	0	1	8	0	0
7	15605307	.	T	A	1	3	4	0	0	4	0	0
7	15605844	.	C	T	2	5	7	0	1	8	0	0
7	15605846	.	T	C	2	6	8	0	0	8	0	0
7	15605950	.	T	C	7	4	11	0	1	12	0	0
7	15605968	.	T	A	6	4	10	0	1	11	0	0
7	15607650	.	C	T	6	10	16	0	1	17	0	0
7	15607757	.	G	A	0	4	4	0	8	12	0	0
7	15608108	.	A	C	2	3	5	0	0	5	0	0
7	15608113	.	T	C	2	4	6	0	0	6	0	0
7	15608471	.	C	T	10	6	16	0	0	16	0	0
7	15608487	.	A	G	13	0	13	0	5	18	0	0
7	15608520	.	G	A	8	2	10	0	0	10	0	0
7	15608620	.	G	A	5	6	11	0	0	11	0	0
7	15608652	.	A	T	3	2	5	0	0	5	0	0
7	15608707	.	T	G	4	3	7	0	0	7	0	0
7	15608730	.	A	C	2	3	5	0	0	5	0	0
7	15608767	.	T	A	5	4	9	0	0	9	0	0
7	15608774	.	C	G	4	3	7	0	0	7	0	0
7	15609137	.	A	C	5	6	11	0	0	11	0	0
7	15609156	.	G	A	2	5	7	0	0	7	0	0
7	15609387	.	T	A	5	5	10	0	3	13	0	0
7	15609469	.	C	T	10	11	21	0	1	22	0	0
7	15609520	.	G	A	8	2	10	0	0	10	0	0
7	15609826	.	C	T	11	11	22	0	0	22	0	0
7	15609961	.	C	T	9	9	18	0	0	18	0	0
7	15618216	.	T	C	3	3	6	0	0	6	0	0
7	15618227	.	C	T	4	3	7	0	0	7	0	0
7	15620071	.	A	G	3	6	9	0	0	9	0	0
7	15623727	.	A	C	1	3	4	0	0	4	0	0
7	15634379	.	A	G	2	2	4	0	0	4	0	0
7	15634391	.	G	A	1	2	3	0	2	5	0	0
7	15648755	.	C	T	2	2	4	0	0	4	0	0
7	15648760	.	T	C	3	1	4	0	0	4	0	0
7	15653514	.	G	A	3	4	7	0	0	7	0	0
7	15819692	.	C	T	5	7	12	0	0	12	0	0
7	15825888	.	T	C	9	0	9	0	5	14	0	0
7	15825932	.	T	C	7	0	7	0	5	12	0	0
7	15826026	.	G	A	1	5	6	0	0	6	0	0
7	15830007	.	T	C	6	4	10	0	1	11	0	0
7	15830026	.	A	G	6	3	9	0	0	9	0	0
7	15830095	.	C	T	5	2	7	0	0	7	0	0
7	15896959	.	G	C	1	7	8	0	1	9	0	0
7	15896998	.	G	A	0	6	6	0	1	7	0	0
7	15897024	.	G	A	1	2	3	0	0	3	0	0
7	15897530	.	T	G	1	3	4	0	0	4	0	0
7	15897615	.	G	T	1	2	3	0	1	4	0	0
7	15897755	.	A	G	3	4	7	0	1	8	0	0
7	15898112	.	G	T	4	3	7	0	0	7	0	0
7	15898280	.	T	C	6	2	8	0	0	8	0	0
7	15898400	.	T	C	2	6	8	0	0	8	0	0
7	15898712	.	C	A	3	4	7	0	0	8	1	0
7	15898954	.	T	C	4	3	7	0	1	8	0	0
7	15899189	.	T	C	2	6	8	0	0	8	0	0
7	15899191	.	A	G	2	5	7	0	1	8	0	0
7	15899468	.	A	T	3	9	12	0	0	12	0	0
7	15899532	.	T	A	5	6	11	0	2	13	0	0
7	16051387	.	T	G	2	2	4	0	0	4	0	0
7	16051826	.	A	T	1	3	4	0	1	5	0	0
7	16348898	.	A	G	9	11	20	0	0	20	0	0
7	16388262	.	C	T	16	13	29	0	1	30	0	0
7	16388307	.	C	T	9	14	23	0	1	24	0	0
7	16388310	.	G	C	10	14	24	0	0	24	0	0
7	16388358	.	T	C	9	9	18	0	0	18	0	0
7	16456854	.	C	T	14	12	26	0	1	27	0	0
7	16460093	.	C	T	5	6	11	0	2	13	0	0
7	16460252	.	G	A	9	4	13	0	2	15	0	0
7	16460448	.	T	C	3	3	6	0	0	6	0	0
7	16461100	.	G	T	1	2	3	0	0	3	0	0
7	16514226	.	G	A	1	2	3	0	1	4	0	0
7	16514265	.	C	T	4	2	6	0	0	6	0	0
7	16529521	.	C	T	5	2	7	0	0	7	0	0
7	16533097	.	G	A	0	4	4	0	2	6	0	0
7	16545638	.	C	T	8	5	13	1	0	14	0	0
7	16955692	.	T	C	2	2	4	0	0	4	0	0
7	16958050	.	C	T	2	1	3	0	1	4	0	0
7	16963444	.	C	A	1	2	3	0	0	3	0	0
7	17000956	.	G	A	0	3	3	0	2	5	0	0
7	17003632	.	A	T	2	3	5	0	0	5	0	0
7	17004383	.	C	T	1	3	4	0	0	4	0	0
7	17007283	.	C	T	2	3	5	0	0	5	0	0
7	17008188	.	G	T	2	2	4	0	0	4	0	0
7	17008305	.	C	T	3	3	6	0	0	6	0	0
7	17008500	.	G	A	0	2	2	0	2	4	0	0
7	17009538	.	C	T	2	3	5	0	0	5	0	0
7	17010015	.	T	C	6	2	8	0	0	8	0	0
7	17011843	.	T	C	2	2	4	0	0	4	0	0
7	17012299	.	T	A	4	3	7	0	0	7	0	0
7	17012682	.	C	T	3	2	5	0	0	5	0	0
7	17013825	.	T	C	2	3	5	0	0	5	0	0
7	17013827	.	T	A	2	3	5	0	0	5	0	0
7	17013899	.	C	T	4	5	9	0	0	9	0	0
7	17014219	.	A	G	2	6	8	0	0	8	0	0
7	17014453	.	A	C	7	6	13	0	0	13	0	0
7	17014531	.	C	A	8	5	13	0	1	14	0	0
7	17014548	.	G	T	8	7	15	0	1	16	0	0
7	17014621	.	T	A	3	12	15	0	1	16	0	0
7	17014653	.	C	T	3	12	15	0	0	15	0	0
7	17014748	.	T	C	5	7	12	0	0	12	0	0
7	17014809	.	A	C	6	3	9	0	0	9	0	0
7	17014815	.	T	C	6	4	10	0	0	10	0	0
7	17014914	.	A	G	3	4	7	0	1	8	0	0
7	17096421	.	T	C	11	6	17	0	0	17	0	0
7	17097176	.	G	A	9	7	16	0	0	16	0	0
7	17097191	.	C	T	7	8	15	0	0	15	0	0
7	17100076	.	T	C	12	11	23	0	0	23	0	0
7	17100259	.	T	C	14	6	20	0	1	21	0	0
7	17100271	.	G	A	14	6	20	0	0	20	0	0
7	17102964	.	G	T	11	4	15	0	0	15	0	0
7	17103021	.	A	G	3	5	8	0	2	10	0	0
7	17103902	.	G	A	2	3	5	0	0	5	0	0
7	17106599	.	C	T	3	3	6	0	0	6	0	0
7	17173458	.	A	G	2	0	2	0	4	6	0	0
7	17199806	.	T	A	3	2	5	0	0	5	0	0
7	17248022	.	G	A	4	3	7	0	0	7	0	0
7	17248433	.	G	A	7	2	9	0	0	9	0	0
7	17248436	.	G	A	0	2	2	0	7	9	0	0
7	17248484	.	A	C	1	7	8	0	0	8	0	0
7	17248865	.	T	A	7	5	12	0	0	12	0	0
7	17249121	.	C	T	4	3	7	0	0	7	0	0
7	17249293	.	A	T	1	4	5	0	0	5	0	0
7	17249439	.	T	A	2	9	11	0	0	11	0	0
7	17249642	.	C	T	1	4	5	0	0	5	0	0
7	17249829	.	A	T	1	6	7	0	0	7	0	0
7	17249885	.	G	A	3	4	7	1	2	10	0	0
7	17250191	.	C	T	3	18	21	0	0	21	0	0
7	17250249	.	G	A	0	11	11	0	2	13	0	0
7	17250298	.	C	T	1	3	4	0	0	4	0	0
7	17251098	.	C	A	26	13	39	0	0	39	0	0
7	17251222	.	G	A	2	18	20	0	29	49	0	0
7	17251234	.	A	G	28	17	45	0	3	48	0	0
7	17654734	.	C	G	4	2	6	0	0	6	0	0
7	17657860	.	G	C	5	2	7	0	0	7	0	0
7	17663134	.	C	T	4	5	9	0	0	9	0	0
7	17690835	.	C	T	0	3	3	0	3	6	0	0
7	17690859	.	T	A	4	3	7	0	0	7	0	0
7	17692797	.	G	A	6	9	15	0	0	15	0	0
7	17692857	.	T	C	5	9	14	0	1	15	0	0
7	17695039	.	C	T	2	5	7	0	1	8	0	0
7	17695051	.	A	G	4	2	6	0	1	7	0	0
7	17695425	.	A	G	2	5	7	0	0	7	0	0
7	17708643	.	C	T	0	2	2	0	2	4	0	0
7	17708783	.	C	T	1	3	4	0	1	5	0	0
7	17708811	.	G	A	2	2	4	0	0	4	0	0
7	17754299	.	G	A	15	27	42	4	1	47	0	0
7	17755699	.	C	T	2	4	6	0	6	12	0	0
7	17757019	.	A	G	21	28	49	0	9	58	0	0
7	17757024	.	C	T	32	21	53	0	3	56	0	0
7	17757078	.	A	G	35	30	65	0	1	66	0	0
7	17757243	.	T	G	30	14	44	1	3	48	0	0
7	17757261	.	T	G	6	38	44	2	1	47	0	0
7	17757371	.	T	C	27	38	65	0	2	67	0	0
7	17757408	.	G	A	35	24	59	0	5	64	0	0
7	17760943	.	C	T	1	3	4	0	0	4	0	0
7	17761063	.	A	C	1	4	5	0	1	6	0	0
7	17761303	.	C	T	0	4	4	0	2	6	0	0
7	17761342	.	T	G	0	2	2	0	1	3	0	0
7	17762433	.	C	T	2	3	5	0	1	6	0	0
7	17762455	.	C	G	1	6	7	0	5	12	0	0
7	17762480	.	G	C	4	8	12	0	0	12	0	0
7	17762896	.	G	A	2	2	4	0	0	4	0	0
7	17762911	.	G	A	2	4	6	0	0	6	0	0
7	17762931	.	A	T	1	4	5	0	0	5	0	0
7	17766963	.	T	A	2	3	5	0	0	5	0	0
7	17767011	.	G	T	2	5	7	0	0	7	0	0
7	17772564	.	C	T	0	1	1	0	2	3	0	0
7	17775713	.	G	A	3	3	6	0	0	6	0	0
7	17779394	.	T	C	2	0	2	0	3	5	0	0
7	17792032	.	A	C	4	3	7	0	0	7	0	0
7	17800956	.	A	G	9	3	12	0	0	12	0	0
7	17800993	.	C	T	4	4	8	0	0	8	0	0
7	17801064	.	A	C	2	4	6	0	0	6	0	0
7	17801841	.	C	T	2	2	4	0	0	4	0	0
7	17801857	.	C	A	2	4	6	0	0	6	0	0
7	17801896	.	T	G	3	4	7	0	0	7	0	0
7	17801900	.	A	G	1	0	1	0	5	6	0	0
7	17801938	.	A	G	2	0	2	1	3	6	0	0
7	17803355	.	T	A	2	1	3	0	0	3	0	0
7	17803374	.	T	G	2	2	4	0	0	4	0	0
7	17803410	.	T	A	1	4	5	0	0	5	0	0
7	17803424	.	C	A	1	4	5	0	0	5	0	0
7	17805706	.	C	G	6	5	11	0	0	11	0	0
7	17809860	.	C	T	7	6	13	0	0	13	0	0
7	17810581	.	C	T	7	5	12	0	1	13	0	0
7	17810611	.	G	A	7	4	11	0	0	11	0	0
7	17810624	.	C	T	8	6	14	0	0	14	0	0
7	17813283	.	A	G	5	8	13	0	0	13	0	0
7	17813987	.	T	C	6	0	6	0	7	13	0	0
7	17933314	.	C	G	7	7	14	0	0	14	0	0
7	17933323	.	C	T	6	6	12	0	0	12	0	0
7	17933350	.	G	A	1	10	11	0	11	22	0	0
7	17933362	.	A	G	11	1	12	0	7	19	0	0
7	17933413	.	T	A	7	7	14	0	0	14	0	0
7	17933777	.	G	A	1	13	14	0	15	29	0	0
7	17936753	.	C	G	15	9	24	0	0	24	0	0
7	17936795	.	G	A	0	9	9	0	13	22	0	0
7	17938069	.	C	A	11	11	22	0	0	22	0	0
7	17941936	.	C	T	11	9	20	0	3	23	0	0
7	17942370	.	G	A	5	3	8	0	0	8	0	0
7	17942540	.	A	G	4	2	6	0	0	6	0	0
7	17942883	.	T	G	13	13	26	0	1	27	0	0
7	17943078	.	A	G	11	15	26	0	0	26	0	0
7	17943133	.	C	T	16	7	23	0	0	23	0	0
7	17943170	.	G	A	2	14	16	0	16	32	0	0
7	17943376	.	C	G	19	15	34	0	5	39	0	0
7	17943509	.	A	G	14	0	14	0	27	41	0	0
7	17943851	.	G	C	1	2	3	0	0	3	0	0
7	17953895	.	T	G	1	2	3	0	0	3	0	0
7	17957514	.	C	A	3	2	5	0	0	5	0	0
7	17965749	.	G	A	4	4	8	0	0	8	0	0
7	17969145	.	C	T	6	3	9	0	1	10	0	0
7	17969461	.	T	A	5	4	9	0	0	9	0	0
7	17969720	.	C	T	2	5	7	0	2	9	0	0
7	17969792	.	A	G	5	5	10	0	0	10	0	0
7	17969851	.	A	G	7	3	10	0	1	11	0	0
7	17969883	.	G	C	1	1	2	0	8	10	0	0
7	17969949	.	A	G	2	4	6	0	0	6	0	0
7	17970016	.	C	T	2	4	6	0	0	6	0	0
7	17970124	.	T	A	3	3	6	0	0	6	0	0
7	17970274	.	A	G	4	0	4	1	4	9	0	0
7	17970277	.	A	G	1	0	1	1	8	10	0	0
7	17970654	.	G	A	8	2	10	0	0	10	0	0
7	18072797	.	T	G	1	2	3	0	0	3	0	0
7	18114316	.	G	A	5	22	27	0	36	63	0	0
7	18114495	.	C	T	13	23	36	0	2	38	0	0
7	18114518	.	A	T	10	11	21	0	12	33	0	0
7	18115220	.	T	A	26	17	43	0	1	44	0	0
7	18115261	.	G	T	15	23	38	0	1	40	1	0
7	18115302	.	G	A	3	18	21	0	14	35	0	0
7	18115470	.	C	T	26	22	48	0	0	48	0	0
7	18115584	.	T	G	8	21	29	2	2	33	0	0
7	18115721	.	G	A	4	24	28	0	20	48	0	0
7	18116037	.	C	T	15	10	25	0	1	26	0	0
7	18116204	.	G	A	27	17	44	0	3	47	0	0
7	18122445	.	C	G	7	8	15	0	1	16	0	0
7	18122541	.	G	C	21	0	21	0	22	43	0	0
7	18124218	.	C	T	14	26	40	0	1	41	0	0
7	18124314	.	C	T	17	22	39	0	0	39	0	0
7	18124329	.	T	A	14	20	34	0	2	36	0	0
7	18137325	.	C	T	2	20	22	0	22	44	0	0
7	18146699	.	T	G	12	11	23	0	0	23	0	0
7	18168253	.	T	A	17	12	29	0	2	31	0	0
7	18168419	.	A	T	4	2	6	0	0	6	0	0
7	18366932	.	T	C	2	2	4	0	0	4	0	0
7	18366936	.	A	T	2	2	4	0	0	4	0	0
7	18367075	.	A	C	2	2	4	0	0	4	0	0
7	18413054	.	G	T	3	10	13	0	0	13	0	0
7	18413086	.	G	T	7	5	12	0	1	13	0	0
7	18413585	.	A	C	2	5	7	0	0	7	0	0
7	18413642	.	A	G	2	3	5	1	0	6	0	0
7	18413745	.	G	A	3	3	6	1	0	7	0	0
7	18415009	.	A	T	3	4	7	0	0	7	0	0
7	18416804	.	C	A	3	2	5	0	0	5	0	0
7	18462420	.	A	T	2	2	4	0	1	5	0	0
7	18462733	.	G	A	4	6	10	0	1	11	0	0
7	18463132	.	T	A	4	5	9	0	0	9	0	0
7	18463259	.	T	C	2	5	7	0	0	7	0	0
7	18463488	.	A	T	6	6	12	0	1	13	0	0
7	18463589	.	A	T	2	2	4	0	0	4	0	0
7	18464919	.	C	T	6	7	13	0	0	13	0	0
7	18465000	.	G	A	7	12	19	0	2	21	0	0
7	18465096	.	A	G	12	9	21	0	0	21	0	0
7	18465435	.	T	G	6	5	11	0	1	12	0	0
7	18470277	.	G	A	1	3	4	0	0	4	0	0
7	18470573	.	C	A	5	4	9	0	0	9	0	0
7	18470813	.	C	A	5	5	10	0	1	11	0	0
7	18474994	.	C	T	2	4	6	0	0	6	0	0
7	18475150	.	C	G	2	2	4	0	0	4	0	0
7	18482163	.	G	A	3	2	5	0	0	5	0	0
7	18550499	.	C	T	3	4	7	0	1	8	0	0
7	18558504	.	C	T	10	12	22	0	0	22	0	0
7	18558586	.	T	C	5	0	5	0	3	8	0	0
7	18558600	.	G	A	4	2	6	0	0	6	0	0
7	18558806	.	A	T	9	12	21	0	1	22	0	0
7	18558871	.	G	A	12	8	20	0	1	21	0	0
7	18558906	.	T	G	10	11	21	1	0	22	0	0
7	18559197	.	G	T	7	5	12	0	0	12	0	0
7	18559212	.	C	A	8	8	16	0	0	16	0	0
7	18559258	.	A	G	5	9	14	0	1	15	0	0
7	18559548	.	C	T	3	6	9	0	0	9	0	0
7	18560013	.	C	A	10	5	15	0	2	17	0	0
7	18560047	.	G	A	11	4	15	0	0	15	0	0
7	18560397	.	C	T	1	11	12	0	3	15	0	0
7	18560474	.	C	T	2	3	5	0	8	13	0	0
7	18560478	.	T	A	3	9	12	0	1	13	0	0
7	18560952	.	C	T	0	3	3	0	5	8	0	0
7	18564318	.	G	A	7	5	12	0	0	12	0	0
7	18594557	.	T	C	4	0	4	0	8	12	0	0
7	18608309	.	T	A	1	2	3	0	0	3	0	0
7	18618776	.	T	C	9	3	12	0	0	12	0	0
7	18618859	.	A	G	7	3	10	0	1	11	0	0
7	18618860	.	T	C	6	0	6	0	8	14	0	0
7	18618927	.	T	C	10	5	15	0	0	15	0	0
7	18619661	.	G	A	5	6	11	0	2	13	0	0
7	18619990	.	C	T	1	4	5	0	0	5	0	0
7	18620027	.	A	T	8	1	9	0	0	9	0	0
7	18620049	.	A	C	7	3	10	0	1	11	0	0
7	18620223	.	C	T	1	4	5	0	5	10	0	0
7	18620273	.	T	C	1	5	6	0	0	6	0	0
7	18645360	.	G	A	2	3	5	0	0	5	0	0
7	18650823	.	C	G	1	3	4	0	0	4	0	0
7	18655772	.	A	C	1	4	5	0	0	5	0	0
7	18655798	.	T	G	1	4	5	0	0	5	0	0
7	18655921	.	G	A	3	4	7	0	0	7	0	0
7	18655949	.	T	G	0	3	3	0	1	4	0	0
7	18656025	.	G	A	4	4	8	0	0	8	0	0
7	18705665	.	G	A	4	2	6	0	1	7	0	0
7	18705728	.	G	A	2	3	5	0	0	5	0	0
7	18710367	.	T	G	4	2	6	0	1	7	0	0
7	18712511	.	C	T	3	5	8	0	0	8	0	0
7	18780119	.	A	G	3	3	6	0	0	6	0	0
7	18780196	.	A	G	5	7	12	0	0	12	0	0
7	18810675	.	A	G	11	7	18	0	0	18	0	0
7	18810692	.	T	C	8	7	15	0	1	16	0	0
7	18810710	.	C	T	9	5	14	0	0	14	0	0
7	18810768	.	C	A	1	3	4	0	6	10	0	0
7	18810926	.	T	C	2	2	4	0	0	4	0	0
7	18810971	.	C	T	2	4	6	0	5	11	0	0
7	18810990	.	C	A	6	4	10	0	0	10	0	0
7	18876417	.	A	C	4	4	8	0	1	9	0	0
7	18876519	.	G	A	3	5	8	0	1	9	0	0
7	18958373	.	T	C	1	2	3	0	0	3	0	0
7	18976568	.	T	C	4	5	9	0	0	9	0	0
7	18976592	.	A	C	5	2	7	0	0	7	0	0
7	18983123	.	G	A	0	4	4	0	3	7	0	0
7	18983230	.	G	A	1	2	3	0	4	7	0	0
7	19055605	.	C	T	26	18	44	0	2	46	0	0
7	19065861	.	A	G	18	12	30	0	0	30	0	0
7	19070994	.	C	T	0	13	13	0	28	41	0	0
7	19071420	.	T	C	12	0	12	1	17	30	0	0
7	19071617	.	T	C	17	6	23	0	0	23	0	0
7	19071639	.	C	A	11	6	17	0	1	18	0	0
7	19072767	.	T	A	1	5	6	0	0	6	0	0
7	19073105	.	T	C	1	3	4	0	0	4	0	0
7	19073202	.	T	C	1	0	1	0	4	5	0	0
7	19073481	.	T	C	7	16	23	0	0	23	0	0
7	19073495	.	G	A	7	15	22	0	0	22	0	0
7	19073563	.	A	T	11	9	20	0	0	20	0	0
7	19073576	.	T	A	7	9	16	0	3	19	0	0
7	19073788	.	T	C	2	16	18	0	2	20	0	0
7	19073818	.	T	C	3	9	12	0	1	13	0	0
7	19073833	.	G	A	4	6	10	0	0	10	0	0
7	19073918	.	G	A	9	8	17	0	1	18	0	0
7	19074041	.	G	A	10	4	14	0	3	17	0	0
7	19074056	.	T	C	14	8	22	0	0	22	0	0
7	19074173	.	C	T	4	14	18	0	2	20	0	0
7	19074194	.	A	T	4	13	17	0	0	17	0	0
7	19074270	.	G	A	8	8	16	0	0	16	0	0
7	19074363	.	T	C	10	4	14	0	0	14	0	0
7	19074666	.	C	G	2	3	5	0	0	5	0	0
7	19075025	.	C	T	1	3	4	0	8	12	0	0
7	19075058	.	T	C	3	0	3	0	5	8	0	0
7	19075591	.	T	C	4	2	6	0	1	7	0	0
7	19075605	.	A	C	6	3	9	0	1	10	0	0
7	19076154	.	A	G	4	4	8	0	0	8	0	0
7	19076211	.	A	G	6	2	8	0	0	8	0	0
7	19076354	.	C	G	2	3	5	0	0	5	0	0
7	19076536	.	A	G	4	2	6	0	0	6	0	0
7	19076550	.	G	A	7	3	10	0	0	10	0	0
7	19076759	.	C	A	2	5	7	0	0	7	0	0
7	19077092	.	G	A	5	4	9	0	1	10	0	0
7	19083600	.	G	A	7	4	11	0	0	11	0	0
7	19179977	.	C	T	0	3	3	0	4	7	0	0
7	19180152	.	T	A	5	4	9	0	0	9	0	0
7	19745853	.	G	A	2	7	9	0	10	19	0	0
7	19753008	.	C	A	11	10	21	0	1	22	0	0
7	19753702	.	C	T	10	11	21	0	1	22	0	0
7	19759079	.	G	T	8	16	24	0	2	26	0	0
7	19759194	.	C	A	9	9	18	0	0	18	0	0
7	19759209	.	G	A	2	8	10	0	7	17	0	0
7	19759263	.	T	A	10	4	14	0	1	15	0	0
7	19759296	.	C	T	15	4	19	0	0	19	0	0
7	19759299	.	A	T	15	3	18	0	1	19	0	0
7	19759550	.	C	T	4	5	9	0	0	9	0	0
7	19864504	.	G	A	0	2	2	0	1	3	0	0
7	19891365	.	A	G	2	0	2	0	2	4	0	0
7	19891551	.	G	A	1	2	3	0	0	3	0	0
7	19891779	.	G	C	1	5	6	0	0	6	0	0
7	19892265	.	C	T	4	3	7	0	0	7	0	0
7	19892592	.	A	G	6	0	6	0	9	15	0	0
7	19892880	.	G	A	0	6	6	0	3	9	0	0
7	19893149	.	T	G	1	4	5	0	1	6	0	0
7	19893463	.	A	G	3	2	5	0	0	5	0	0
7	19893705	.	A	T	5	4	9	0	0	9	0	0
7	19894016	.	A	G	5	4	9	0	1	10	0	0
7	19894848	.	T	A	2	3	5	0	0	5	0	0
7	19894849	.	A	T	3	2	5	0	0	5	0	0
7	19895088	.	G	A	0	5	5	0	2	7	0	0
7	19895268	.	G	A	4	2	6	0	0	6	0	0
7	19895506	.	G	A	0	3	3	0	2	5	0	0
7	19895683	.	C	T	3	4	7	0	0	7	0	0
7	19896642	.	G	T	6	2	8	1	0	9	0	0
7	19897309	.	C	T	7	6	13	0	0	13	0	0
7	19897599	.	G	A	4	2	6	0	0	6	0	0
7	19897959	.	T	C	10	9	19	0	1	20	0	0
7	19899331	.	A	G	10	0	10	0	6	16	0	0
7	19909988	.	C	T	1	1	2	0	0	2	0	0
7	19909995	.	C	T	1	2	3	0	0	3	0	0
7	19965281	.	G	A	5	7	12	0	0	12	0	0
7	19965721	.	T	A	8	5	13	0	0	13	0	0
7	19966252	.	G	A	5	4	9	0	2	11	0	0
7	19966273	.	T	G	7	5	12	0	0	12	0	0
7	19978847	.	G	A	4	4	8	0	0	8	0	0
7	19978875	.	T	A	5	2	7	0	0	7	0	0
7	19979133	.	C	T	5	4	9	0	0	9	0	0
7	19979200	.	A	G	2	7	9	0	1	10	0	0
7	19979669	.	G	A	2	7	9	0	0	9	0	0
7	19979773	.	A	G	0	4	4	0	0	4	0	0
7	19979943	.	A	T	7	7	14	1	1	16	0	0
7	19979968	.	C	A	2	6	8	0	8	16	0	0
7	19986080	.	A	T	1	3	4	0	0	4	0	0
7	19991783	.	G	T	1	5	6	0	0	6	0	0
7	20023925	.	C	A	1	1	2	0	1	3	0	0
7	20027595	.	A	T	3	2	5	0	1	6	0	0
7	20027717	.	G	A	3	8	11	0	0	11	0	0
7	20028011	.	G	A	1	5	6	0	0	6	0	0
7	20054527	.	A	G	1	0	1	0	4	5	0	0
7	20059381	.	T	G	2	0	2	0	1	3	0	0
7	20118228	.	C	G	11	7	18	0	0	18	0	0
7	20118330	.	T	C	10	9	19	0	0	19	0	0
7	20141697	.	T	C	14	13	27	0	2	29	0	0
7	20141823	.	A	G	14	13	27	0	2	29	0	0
7	20141916	.	T	C	14	9	23	0	0	23	0	0
7	20142253	.	A	T	4	2	6	0	0	6	0	0
7	20142360	.	A	G	0	3	3	0	0	3	0	0
7	20142361	.	A	T	1	3	4	0	0	4	0	0
7	20142497	.	T	A	2	4	6	1	0	7	0	0
7	20142523	.	T	C	1	3	4	0	1	5	0	0
7	20222385	.	A	G	7	5	12	0	1	13	0	0
7	20222861	.	C	G	2	3	5	0	0	5	0	0
7	20222949	.	A	C	2	4	6	0	0	6	0	0
7	20223074	.	G	A	10	8	18	0	0	18	0	0
7	20223079	.	A	G	10	9	19	0	0	19	0	0
7	20223110	.	G	A	7	8	15	0	0	15	0	0
7	20223208	.	G	C	3	3	6	0	0	6	0	0
7	20223384	.	A	C	9	4	13	0	0	13	0	0
7	20223385	.	C	T	9	4	13	0	0	13	0	0
7	20223478	.	T	A	14	6	20	0	1	21	0	0
7	20223568	.	C	T	6	9	15	0	1	16	0	0
7	20223632	.	C	T	9	10	19	0	0	19	0	0
7	20223880	.	G	A	1	3	4	0	3	7	0	0
7	20240298	.	T	C	1	2	3	0	0	3	0	0
7	20295116	.	T	C	1	2	3	0	0	3	0	0
7	20298563	.	A	T	5	5	10	0	0	10	0	0
7	20298577	.	A	G	6	7	13	0	0	13	0	0
7	20298598	.	A	T	5	6	11	0	1	12	0	0
7	20298789	.	C	G	2	4	6	0	0	6	0	0
7	20301839	.	C	T	7	8	15	0	1	16	0	0
7	20302952	.	A	G	7	5	12	0	0	12	0	0
7	20305694	.	C	T	5	7	12	0	0	12	0	0
7	20305697	.	C	T	5	8	13	0	0	13	0	0
7	20310893	.	T	C	9	6	15	0	0	15	0	0
7	20310929	.	T	C	7	6	13	0	0	13	0	0
7	20315913	.	G	A	3	12	15	0	5	20	0	0
7	20325995	.	C	T	7	11	18	0	2	20	0	0
7	20326405	.	T	C	8	5	13	0	1	14	0	0
7	20332513	.	T	C	11	10	21	0	2	23	0	0
7	20332775	.	A	T	12	9	21	0	1	22	0	0
7	20332784	.	G	A	11	9	20	0	1	21	0	0
7	20332959	.	G	A	12	12	24	0	0	24	0	0
7	20332963	.	G	A	11	11	22	0	2	24	0	0
7	20333061	.	A	G	6	0	6	0	15	21	0	0
7	20333076	.	C	A	6	12	18	0	1	19	0	0
7	20333120	.	A	C	7	11	18	0	0	18	0	0
7	20333276	.	T	G	2	9	11	0	0	11	0	0
7	20334603	.	T	C	5	7	12	0	0	12	0	0
7	20335035	.	C	T	1	2	3	0	0	3	0	0
7	20335283	.	T	C	3	2	5	0	0	5	0	0
7	20335323	.	G	A	2	4	6	0	1	7	0	0
7	20335331	.	A	G	3	4	7	0	0	7	0	0
7	20337985	.	A	G	2	2	4	0	0	4	0	0
7	20337988	.	C	T	2	2	4	0	0	4	0	0
7	20463715	.	T	C	1	2	3	0	0	3	0	0
7	20529155	.	A	G	1	3	4	0	0	4	0	0
7	20529578	.	A	C	3	2	5	0	1	6	0	0
7	20529725	.	C	T	5	5	10	0	0	10	0	0
7	20529728	.	G	A	4	6	10	0	1	11	0	0
7	20529760	.	C	T	7	6	13	0	0	13	0	0
7	20529773	.	T	C	6	5	11	0	0	11	0	0
7	20530284	.	A	T	5	6	11	0	1	12	0	0
7	20530314	.	G	A	4	5	9	0	1	10	0	0
7	20530338	.	C	T	4	4	8	0	0	8	0	0
7	20530373	.	T	A	4	5	9	0	0	9	0	0
7	20542251	.	G	A	2	11	13	0	0	13	0	0
7	20542262	.	C	A	4	7	11	0	0	11	0	0
7	20587681	.	G	T	4	8	12	0	1	13	0	0
7	20587685	.	T	G	5	7	12	0	2	14	0	0
7	20587812	.	T	C	4	4	8	0	0	8	0	0
7	20588280	.	C	G	6	3	9	0	1	10	0	0
7	20593682	.	G	A	1	16	17	0	10	27	0	0
7	20593809	.	G	A	14	7	21	0	3	24	0	0
7	20597033	.	G	A	9	7	16	0	1	17	0	0
7	20597132	.	C	T	6	5	11	0	1	12	0	0
7	20600211	.	T	A	10	6	16	0	0	16	0	0
7	20600398	.	C	T	10	6	16	0	0	16	0	0
7	20600447	.	A	G	10	0	10	0	8	18	0	0
7	20601052	.	G	A	7	4	11	0	0	11	0	0
7	20601072	.	T	C	4	3	7	0	0	7	0	0
7	20601250	.	A	G	3	4	7	0	0	7	0	0
7	20601325	.	A	G	2	5	7	0	1	8	0	0
7	20601410	.	T	A	1	8	9	0	0	9	0	0
7	20601524	.	G	A	6	7	13	0	0	13	0	0
7	20601539	.	T	C	4	8	12	0	0	12	0	0
7	20601713	.	A	T	3	2	5	0	0	5	0	0
7	20601835	.	G	T	3	5	8	0	1	9	0	0
7	20601907	.	A	T	6	6	12	0	0	12	0	0
7	20601925	.	T	C	4	6	10	0	0	10	0	0
7	20602053	.	T	C	1	2	3	0	1	4	0	0
7	20602205	.	A	G	3	4	7	0	1	8	0	0
7	20605541	.	C	T	2	2	4	0	0	4	0	0
7	20605661	.	A	G	3	2	5	0	2	7	0	0
7	20629792	.	G	A	5	8	13	0	1	14	0	0
7	20629801	.	A	G	3	9	12	0	0	12	0	0
7	20633683	.	A	C	4	3	7	0	0	7	0	0
7	20633686	.	T	A	4	3	7	0	0	7	0	0
7	20634045	.	A	G	2	0	2	7	6	15	0	0
7	20634202	.	C	G	9	5	14	0	1	15	0	0
7	20634444	.	A	T	4	6	10	0	0	10	0	0
7	20634498	.	T	A	6	13	19	0	0	19	0	0
7	20634577	.	T	G	10	16	26	0	0	26	0	0
7	20635475	.	A	G	6	9	15	0	1	16	0	0
7	20635495	.	T	A	5	8	13	0	0	13	0	0
7	20635519	.	A	G	6	4	10	0	0	10	0	0
7	20635616	.	T	C	9	14	23	0	0	23	0	0
7	20635760	.	A	G	2	5	7	0	0	7	0	0
7	20636115	.	T	G	2	2	4	0	0	4	0	0
7	20636344	.	A	G	4	9	13	0	0	13	0	0
7	20636379	.	A	T	7	11	18	0	1	19	0	0
7	20636410	.	C	T	10	12	22	0	1	23	0	0
7	20636414	.	T	G	11	10	21	0	1	22	0	0
7	20636464	.	G	A	9	15	24	0	2	27	1	0
7	20636465	.	A	G	9	17	26	0	1	27	0	0
7	20636802	.	T	G	4	17	21	0	0	21	0	0
7	20636833	.	A	G	10	16	26	0	0	26	0	0
7	20636844	.	T	A	12	20	32	0	0	32	0	0
7	20664621	.	A	T	3	3	6	0	0	6	0	0
7	20664672	.	A	G	3	0	3	0	3	6	0	0
7	20693673	.	G	T	16	16	32	0	3	35	0	0
7	20695949	.	G	T	22	15	37	0	0	37	0	0
7	20698208	.	T	A	18	12	30	0	1	31	0	0
7	20712555	.	C	T	12	7	19	0	1	20	0	0
7	20715178	.	G	A	14	13	27	0	0	27	0	0
7	20715434	.	C	T	9	7	16	0	1	17	0	0
7	20715485	.	A	G	6	8	14	0	0	14	0	0
7	20731052	.	C	T	13	8	21	0	1	22	0	0
7	20731166	.	A	G	5	6	11	0	2	13	0	0
7	20735155	.	G	A	7	4	11	0	0	11	0	0
7	20738148	.	A	G	11	6	17	0	0	17	0	0
7	20743583	.	G	A	7	5	12	0	0	12	0	0
7	20743984	.	C	T	1	4	5	0	6	11	0	0
7	20754669	.	G	A	3	5	8	0	1	9	0	0
7	20780285	.	G	A	8	6	14	0	0	14	0	0
7	20780317	.	C	T	6	7	13	0	1	14	0	0
7	20780337	.	A	C	4	12	16	0	0	17	1	0
7	20780356	.	A	G	13	5	18	0	2	20	0	0
7	20780424	.	A	T	9	7	16	0	0	16	0	0
7	20780453	.	C	A	8	8	16	0	0	16	0	0
7	20780500	.	A	C	6	1	7	0	6	13	0	0
7	20780732	.	A	C	8	11	19	0	0	19	0	0
7	20780758	.	T	C	13	5	18	0	0	18	0	0
7	20780797	.	T	C	7	4	11	0	0	11	0	0
7	20780918	.	C	T	1	5	6	0	12	18	0	0
7	20780987	.	G	A	9	9	18	0	0	18	0	0
7	20781110	.	C	T	8	3	11	0	2	13	0	0
7	20781253	.	T	C	16	4	20	0	0	20	0	0
7	20781327	.	A	G	8	5	13	0	0	13	0	0
7	20781471	.	T	C	6	3	9	0	1	10	0	0
7	20781549	.	C	G	6	4	10	0	2	12	0	0
7	20781996	.	T	G	5	8	13	0	0	13	0	0
7	20784496	.	C	T	5	6	11	0	0	11	0	0
7	20784772	.	G	A	5	6	11	0	0	11	0	0
7	20787233	.	C	T	1	6	7	0	1	8	0	0
7	20859446	.	G	C	6	4	10	0	0	10	0	0
7	20859843	.	T	G	3	2	5	0	0	5	0	0
7	20859975	.	G	A	12	7	19	0	1	20	0	0
7	20860011	.	T	C	15	11	26	0	0	26	0	0
7	20864097	.	A	G	12	13	25	0	0	25	0	0
7	20864256	.	T	C	9	8	17	0	2	19	0	0
7	20889840	.	C	A	8	5	13	0	0	13	0	0
7	20890420	.	T	C	3	2	5	0	1	6	0	0
7	20890435	.	C	T	3	3	6	0	0	6	0	0
7	20894701	.	G	A	0	2	2	0	2	4	0	0
7	20897911	.	G	A	0	1	1	0	2	3	0	0
7	20901170	.	C	T	2	3	5	0	0	5	0	0
7	20935058	.	T	C	2	8	10	0	0	10	0	0
7	20935547	.	G	A	5	5	10	0	0	10	0	0
7	20935684	.	C	T	3	4	7	0	0	7	0	0
7	20935737	.	T	A	3	8	11	0	0	11	0	0
7	20935765	.	A	G	6	2	8	0	1	9	0	0
7	20938812	.	C	T	3	3	6	0	0	6	0	0
7	20938928	.	C	T	2	3	5	0	0	5	0	0
7	20966508	.	G	T	0	3	3	0	4	7	0	0
7	21765244	.	G	A	3	3	6	0	0	6	0	0
7	21765562	.	C	A	3	5	8	0	0	8	0	0
7	21766917	.	G	A	7	4	11	0	0	11	0	0
7	21766937	.	C	A	6	2	8	0	0	8	0	0
7	21767423	.	A	G	8	6	14	0	0	14	0	0
7	21768002	.	T	C	3	4	7	0	0	7	0	0
7	21768060	.	A	G	8	7	15	0	0	15	0	0
7	21768270	.	G	A	5	6	11	0	1	12	0	0
7	21768334	.	C	A	9	6	15	0	2	17	0	0
7	21768540	.	T	A	3	5	8	0	2	10	0	0
7	21769286	.	T	G	4	5	9	0	0	9	0	0
7	21769318	.	A	G	6	4	10	0	0	10	0	0
7	21769733	.	G	A	4	6	10	0	0	10	0	0
7	21770141	.	A	G	2	0	2	0	3	5	0	0
7	21770567	.	C	T	4	14	18	0	3	21	0	0
7	21770819	.	G	T	1	4	5	0	6	11	0	0
7	21772869	.	A	T	8	5	13	0	1	14	0	0
7	21773542	.	C	T	10	10	20	0	2	22	0	0
7	21773626	.	C	T	9	5	14	0	0	14	0	0
7	21774127	.	G	A	14	8	22	0	2	24	0	0
7	21776426	.	C	T	12	6	18	0	0	18	0	0
7	21776683	.	G	A	7	13	20	0	0	20	0	0
7	21776693	.	T	C	8	12	20	1	0	21	0	0
7	21777110	.	G	A	10	4	14	0	0	14	0	0
7	21777111	.	C	T	10	4	14	0	0	14	0	0
7	21777203	.	G	T	7	4	11	0	0	11	0	0
7	21777720	.	G	A	9	10	19	0	3	22	0	0
7	21777978	.	T	G	16	10	26	0	0	26	0	0
7	21778055	.	G	A	6	5	11	0	0	11	0	0
7	21778070	.	T	C	3	2	5	0	1	6	0	0
7	21878507	.	G	A	2	3	5	0	0	5	0	0
7	21881863	.	C	T	1	5	6	0	1	7	0	0
7	21884138	.	C	A	0	1	1	0	2	3	0	0
7	21884493	.	G	A	2	3	5	0	0	5	0	0
7	21884703	.	C	T	0	3	3	0	1	4	0	0
7	21884799	.	C	T	1	2	3	0	0	3	0	0
7	21887797	.	A	T	25	21	46	0	2	48	0	0
7	21887967	.	C	T	27	11	38	0	1	39	0	0
7	21888084	.	T	A	23	13	36	0	2	39	1	0
7	21888274	.	T	A	16	12	28	0	2	30	0	0
7	21890998	.	C	T	3	7	10	0	1	11	0	0
7	21891031	.	G	A	2	2	4	0	3	7	0	0
7	21891208	.	C	T	6	9	15	0	0	15	0	0
7	21917927	.	C	A	2	3	5	0	0	5	0	0
7	21918410	.	G	A	0	5	5	0	3	8	0	0
7	21918412	.	T	A	3	5	8	0	0	8	0	0
7	21940965	.	T	G	10	8	18	0	2	20	0	0
7	21940992	.	A	G	11	16	27	0	0	27	0	0
7	21941016	.	T	G	12	21	33	0	0	33	0	0
7	21941460	.	G	A	8	9	17	0	0	17	0	0
7	21941477	.	C	A	13	10	23	0	0	23	0	0
7	21941568	.	C	T	14	12	26	0	1	27	0	0
7	21941579	.	A	C	12	11	23	0	0	23	0	0
7	21942378	.	C	T	16	14	30	0	1	31	0	0
7	21942513	.	A	T	15	9	24	0	4	28	0	0
7	21942644	.	T	A	11	13	24	0	0	24	0	0
7	21942672	.	C	T	16	10	26	0	2	28	0	0
7	21943553	.	A	G	12	14	26	0	1	27	0	0
7	21943625	.	G	A	13	6	19	0	0	19	0	0
7	21943716	.	T	G	17	5	22	0	1	23	0	0
7	21943772	.	T	C	11	12	23	0	1	24	0	0
7	21943886	.	C	A	7	5	12	0	1	13	0	0
7	21944495	.	T	C	8	7	15	0	0	15	0	0
7	21944753	.	G	A	11	6	17	0	0	17	0	0
7	21945257	.	C	T	2	8	10	0	14	24	0	0
7	21945347	.	C	T	2	14	16	0	10	26	0	0
7	21947228	.	G	A	10	3	13	0	0	13	0	0
7	21947237	.	C	T	5	8	13	0	0	13	0	0
7	21951353	.	G	A	3	8	11	0	0	11	0	0
7	21956571	.	A	G	2	4	6	0	1	7	0	0
7	22131815	.	C	T	3	3	6	0	6	12	0	0
7	22132134	.	A	G	10	3	13	0	0	13	0	0
7	23750169	.	T	C	18	7	25	0	0	25	0	0
7	23750477	.	C	T	11	11	22	0	2	24	0	0
7	23751956	.	C	A	12	4	16	0	0	16	0	0
7	23907703	.	T	G	1	0	1	0	2	3	0	0
7	23907784	.	G	T	23	17	40	0	1	41	0	0
7	23909369	.	A	C	19	20	39	0	1	40	0	0
7	23909456	.	T	G	21	17	38	0	3	41	0	0
7	23915104	.	G	A	5	28	33	1	24	58	0	0
7	23915296	.	C	T	29	29	58	0	3	61	0	0
7	23915359	.	G	A	4	28	32	0	29	61	0	0
7	23915379	.	T	A	28	28	56	0	2	59	1	0
7	23915700	.	G	T	27	12	39	0	3	42	0	0
7	23915731	.	G	T	27	17	44	0	3	47	0	0
7	23915926	.	C	T	37	22	59	1	1	61	0	0
7	23915963	.	A	G	23	0	23	0	30	53	0	0
7	23915964	.	A	T	23	28	51	0	3	54	0	0
7	23967515	.	A	C	13	1	14	0	6	20	0	0
7	23967522	.	G	A	11	7	18	0	0	18	0	0
7	23967591	.	G	A	10	11	21	0	1	22	0	0
7	23967596	.	G	A	10	9	19	0	2	21	0	0
7	23967705	.	G	A	7	7	14	0	0	14	0	0
7	23967772	.	A	G	9	16	25	0	2	27	0	0
7	23967861	.	C	T	2	22	24	0	20	44	0	0
7	23967878	.	G	A	22	18	40	0	0	40	0	0
7	23967930	.	A	G	20	23	43	0	2	45	0	0
7	23968009	.	T	C	23	0	23	0	13	36	0	0
7	23968174	.	A	C	15	13	28	0	0	28	0	0
7	23968267	.	A	C	9	6	15	0	0	15	0	0
7	23968292	.	T	G	8	10	18	1	1	20	0	0
7	23968414	.	A	C	2	2	4	0	0	4	0	0
7	23969226	.	G	A	8	12	20	0	1	21	0	0
7	23969446	.	C	T	9	5	14	0	0	14	0	0
7	23969593	.	G	A	9	4	13	4	1	18	0	0
7	23969819	.	A	G	3	3	6	5	0	11	0	0
7	23970196	.	A	G	3	15	18	0	2	20	0	0
7	23970236	.	T	A	7	17	24	0	5	29	0	0
7	23970320	.	G	T	11	14	25	0	0	25	0	0
7	23970331	.	G	A	11	14	25	0	0	25	0	0
7	23970428	.	T	C	13	14	27	0	0	27	0	0
7	23970695	.	T	C	1	7	8	0	0	8	0	0
7	23971138	.	T	C	3	3	6	0	0	6	0	0
7	23971181	.	G	C	3	3	6	0	0	6	0	0
7	23971682	.	T	A	4	6	10	0	0	10	0	0
7	23971714	.	G	C	6	3	9	0	0	9	0	0
7	23971728	.	T	A	4	6	10	0	0	10	0	0
7	23977905	.	A	C	7	3	10	0	0	10	0	0
7	24006992	.	A	T	3	5	8	0	0	8	0	0
7	24007014	.	T	C	1	2	3	0	0	3	0	0
7	24007222	.	T	C	5	3	8	0	1	9	0	0
7	24007347	.	G	A	0	2	2	0	4	6	0	0
7	24007373	.	A	G	6	5	11	0	0	11	0	0
7	24011474	.	C	A	3	3	6	0	0	6	0	0
7	24011926	.	T	C	4	7	11	0	0	11	0	0
7	24012794	.	T	C	4	3	7	0	1	8	0	0
7	24013269	.	G	A	7	4	11	0	0	11	0	0
7	24013489	.	G	A	0	10	10	0	10	20	0	0
7	24033639	.	C	G	4	6	10	0	0	10	0	0
7	24033949	.	G	A	0	2	2	0	2	4	0	0
7	24034020	.	C	T	2	3	5	0	0	5	0	0
7	24043250	.	C	T	3	6	9	0	0	9	0	0
7	24043391	.	G	A	3	6	9	0	0	9	0	0
7	24053451	.	G	A	3	2	5	0	0	5	0	0
7	24053526	.	T	C	3	3	6	0	0	6	0	0
7	24053553	.	A	G	5	3	8	0	0	8	0	0
7	24053575	.	A	G	3	0	3	0	5	8	0	0
7	24053673	.	A	G	3	4	7	0	0	7	0	0
7	24053689	.	C	T	3	2	5	0	0	5	0	0
7	24053850	.	C	T	3	6	9	0	1	10	0	0
7	24053892	.	A	G	4	4	8	0	0	8	0	0
7	24053911	.	G	A	4	2	6	0	0	6	0	0
7	24059449	.	T	A	1	5	6	0	0	6	0	0
7	24059570	.	C	T	3	4	7	0	0	7	0	0
7	24059873	.	C	T	5	2	7	0	1	8	0	0
7	24060071	.	A	C	6	2	8	0	0	8	0	0
7	24060107	.	G	T	6	4	10	0	0	10	0	0
7	24066825	.	C	T	5	4	9	0	0	9	0	0
7	24067056	.	G	T	2	2	4	1	0	5	0	0
7	24068078	.	T	G	4	8	12	0	0	12	0	0
7	24068224	.	A	T	6	4	10	0	2	12	0	0
7	24068586	.	C	T	3	6	9	0	0	9	0	0
7	24068669	.	T	G	1	2	3	0	2	5	0	0
7	24068761	.	G	T	4	3	7	0	0	7	0	0
7	24069484	.	T	C	2	3	5	0	0	5	0	0
7	24075776	.	C	T	7	12	19	0	0	19	0	0
7	24075842	.	A	C	12	7	19	0	0	19	0	0
7	24075911	.	G	A	5	6	11	0	0	11	0	0
7	24076086	.	C	A	5	3	8	0	0	8	0	0
7	24076088	.	A	G	4	2	6	0	1	7	0	0
7	24076192	.	C	T	0	10	10	0	0	10	0	0
7	24076198	.	C	T	8	4	12	0	1	13	0	0
7	24076269	.	C	T	4	9	13	0	0	13	0	0
7	24076329	.	C	T	5	8	13	0	1	14	0	0
7	24076373	.	C	T	4	6	10	0	2	12	0	0
7	24084783	.	C	T	11	13	24	0	0	24	0	0
7	24084879	.	C	T	10	7	17	0	0	17	0	0
7	24087362	.	A	T	10	5	15	0	1	16	0	0
7	24087365	.	T	C	5	11	16	0	0	16	0	0
7	24087724	.	C	A	4	5	9	0	1	10	0	0
7	24090182	.	G	A	12	11	23	0	0	23	0	0
7	24091054	.	G	A	16	12	28	0	2	30	0	0
7	24091269	.	G	A	2	5	7	0	18	25	0	0
7	24092626	.	C	T	6	11	17	0	0	17	0	0
7	24093165	.	C	G	18	13	31	0	3	34	0	0
7	24093300	.	C	T	17	18	35	0	1	36	0	0
7	24093301	.	A	C	18	19	37	0	0	37	0	0
7	24093372	.	A	G	14	20	34	0	1	35	0	0
7	24095515	.	C	G	28	19	47	0	1	48	0	0
7	24095717	.	G	A	3	10	13	0	17	30	0	0
7	24095776	.	G	A	16	16	32	0	3	35	0	0
7	24095788	.	A	G	18	19	37	0	2	39	0	0
7	24095836	.	C	T	14	13	27	0	1	28	0	0
7	24095848	.	G	A	15	14	29	0	3	32	0	0
7	24095883	.	T	A	19	16	35	0	2	37	0	0
7	24095926	.	A	C	19	11	30	0	3	33	0	0
7	24095978	.	T	A	15	20	35	0	3	38	0	0
7	24096399	.	C	A	13	15	28	0	1	29	0	0
7	24096505	.	G	A	2	18	20	0	14	34	0	0
7	24096541	.	C	T	12	15	27	0	0	28	1	0
7	24096767	.	A	C	14	21	35	0	3	38	0	0
7	24115186	.	G	A	10	21	31	0	0	31	0	0
7	24154878	.	C	T	1	2	3	0	0	3	0	0
7	24158843	.	A	G	6	0	6	0	3	9	0	0
7	24158918	.	G	A	0	4	4	0	2	6	0	0
7	24159155	.	G	T	4	4	8	0	0	8	0	0
7	24159248	.	C	A	3	6	9	0	0	9	0	0
7	24159284	.	G	A	4	3	7	0	0	7	0	0
7	24161591	.	C	A	11	5	16	0	3	19	0	0
7	24161648	.	G	A	1	10	11	0	15	26	0	0
7	24162019	.	G	A	3	7	10	0	0	10	0	0
7	24162034	.	C	T	4	4	8	0	0	8	0	0
7	24162368	.	A	T	5	7	12	0	0	12	0	0
7	24162369	.	A	C	5	7	12	0	0	12	0	0
7	24162485	.	C	T	9	4	13	0	1	14	0	0
7	24162567	.	T	C	9	8	17	0	0	17	0	0
7	24162761	.	G	T	5	2	7	0	1	8	0	0
7	24197574	.	C	A	5	2	7	0	0	7	0	0
7	24197607	.	A	T	2	2	4	0	0	4	0	0
7	24197962	.	T	C	2	0	2	0	2	4	0	0
7	24198011	.	G	A	6	2	8	0	0	8	0	0
7	24198170	.	C	A	10	3	13	0	0	13	0	0
7	24198281	.	T	C	5	2	7	0	0	7	0	0
7	24198282	.	T	C	5	1	6	0	1	7	0	0
7	24198334	.	C	T	3	5	8	0	0	8	0	0
7	24198335	.	C	T	0	5	5	0	3	8	0	0
7	24200052	.	C	T	0	5	5	0	8	13	0	0
7	24207520	.	A	C	28	15	43	0	0	43	0	0
7	24207552	.	A	G	15	2	17	0	25	42	0	0
7	24207590	.	A	T	20	17	37	0	1	38	0	0
7	24207632	.	G	C	20	20	40	0	0	40	0	0
7	24210323	.	C	A	1	16	17	0	9	26	0	0
7	24210422	.	T	C	10	19	29	0	3	32	0	0
7	24210629	.	T	A	23	18	41	3	4	48	0	0
7	24210659	.	A	G	23	21	44	3	2	49	0	0
7	24210676	.	A	G	23	19	42	0	2	44	0	0
7	24211015	.	A	T	12	15	27	2	0	29	0	0
7	24211054	.	G	A	14	20	34	0	3	37	0	0
7	24211081	.	T	A	16	20	36	0	1	37	0	0
7	24211342	.	C	T	2	12	14	0	18	32	0	0
7	24211443	.	C	T	2	11	13	0	9	22	0	0
7	24211542	.	G	T	4	5	9	0	1	10	0	0
7	24211560	.	A	T	4	5	9	0	0	9	0	0
7	24211646	.	C	T	0	2	2	0	5	7	0	0
7	24211978	.	G	A	14	12	26	2	1	29	0	0
7	24212093	.	C	G	12	19	31	0	0	31	0	0
7	24212122	.	T	C	12	8	20	0	0	20	0	0
7	24212159	.	G	C	10	0	10	0	9	19	0	0
7	24212383	.	G	A	14	14	28	0	0	28	0	0
7	24214655	.	C	T	10	8	18	1	0	19	0	0
7	24214673	.	C	A	10	11	21	1	1	23	0	0
7	24219052	.	A	G	3	4	7	0	0	7	0	0
7	24227149	.	T	G	4	2	6	0	0	7	1	0
7	24235933	.	T	C	2	2	4	0	0	4	0	0
7	24236177	.	C	G	7	6	13	0	2	15	0	0
7	24457691	.	C	A	30	32	62	0	2	64	0	0
7	24457788	.	C	A	27	20	47	0	4	51	0	0
7	24457803	.	A	C	27	19	46	0	2	48	0	0
7	24458103	.	C	A	31	15	46	0	2	48	0	0
7	24458128	.	G	C	33	17	50	0	1	51	0	0
7	24458205	.	G	A	39	27	66	0	0	66	0	0
7	24458282	.	C	T	24	22	46	0	0	46	0	0
7	24458339	.	A	G	39	12	51	0	1	52	0	0
7	24458866	.	T	C	23	28	51	0	1	52	0	0
7	24458894	.	T	A	23	30	53	0	1	54	0	0
7	24459452	.	G	A	22	18	40	0	1	41	0	0
7	24459847	.	A	G	25	18	43	0	2	45	0	0
7	24459932	.	T	C	18	24	42	0	2	44	0	0
7	24460025	.	G	A	19	17	36	0	3	39	0	0
7	24460026	.	C	T	19	20	39	0	1	40	0	0
7	24460189	.	T	C	15	19	34	0	1	35	0	0
7	24460443	.	G	A	20	17	37	0	4	41	0	0
7	24460461	.	G	A	27	14	41	0	1	42	0	0
7	24461115	.	A	C	16	14	30	1	2	33	0	0
7	24461298	.	G	A	16	14	30	0	1	31	0	0
7	24461601	.	A	G	25	10	35	0	0	35	0	0
7	24462394	.	A	G	18	18	36	2	0	38	0	0
7	24470812	.	A	G	23	21	44	0	0	44	0	0
7	24486345	.	A	G	22	21	43	0	1	45	1	0
7	24486515	.	A	C	34	30	64	0	1	65	0	0
7	24486546	.	G	C	33	30	63	0	1	66	2	0
7	24486721	.	G	A	33	33	66	0	7	73	0	0
7	24486822	.	G	A	44	22	66	0	0	66	0	0
7	24489888	.	A	G	35	28	63	0	2	65	0	0
7	24498912	.	C	T	7	9	16	0	0	16	0	0
7	24501156	.	T	C	3	8	11	0	3	14	0	0
7	24504508	.	C	T	11	11	22	0	0	22	0	0
7	24504875	.	C	T	9	7	16	0	1	17	0	0
7	24505063	.	A	G	2	6	8	0	0	8	0	0
7	24528917	.	T	A	3	5	8	0	2	10	0	0
7	24528976	.	G	T	4	3	7	0	0	7	0	0
7	24551057	.	G	C	4	5	9	0	0	9	0	0
7	24562663	.	T	C	3	2	5	0	0	5	0	0
7	24569961	.	T	C	10	9	19	0	5	24	0	0
7	24569990	.	T	G	13	8	21	0	2	23	0	0
7	24570012	.	A	T	14	7	21	0	1	22	0	0
7	24570714	.	G	A	1	8	9	0	9	18	0	0
7	24570973	.	G	A	5	3	8	0	0	8	0	0
7	24593439	.	T	C	16	11	27	0	0	27	0	0
7	24593452	.	T	A	15	13	28	0	2	30	0	0
7	24594860	.	T	A	15	6	21	0	1	22	0	0
7	24598728	.	G	T	13	9	22	0	0	22	0	0
7	24603028	.	G	T	5	7	12	0	0	12	0	0
7	24603231	.	C	T	1	6	7	0	7	14	0	0
7	24612524	.	G	A	7	4	11	0	0	11	0	0
7	24612623	.	C	T	4	3	7	0	0	7	0	0
7	24616240	.	G	A	5	4	9	0	0	9	0	0
7	24621385	.	C	T	5	4	9	0	0	9	0	0
7	24621480	.	T	C	2	4	6	0	0	6	0	0
7	24631757	.	C	A	3	2	5	0	0	5	0	0
7	24635159	.	G	A	7	4	11	0	0	11	0	0
7	24637765	.	C	A	5	3	8	0	2	10	0	0
7	24637934	.	T	C	4	7	11	0	0	11	0	0
7	24644434	.	G	C	2	7	9	0	0	9	0	0
7	24644446	.	A	C	1	6	7	0	0	7	0	0
7	24645292	.	A	G	2	3	5	0	0	5	0	0
7	24646602	.	T	C	1	4	5	0	0	5	0	0
7	24649610	.	G	C	2	4	6	0	0	6	0	0
7	24649694	.	T	C	1	3	4	0	0	4	0	0
7	24651636	.	C	T	2	4	6	0	0	6	0	0
7	24651645	.	G	A	2	4	6	0	1	7	0	0
7	24653121	.	G	A	6	2	8	0	0	8	0	0
7	24655086	.	T	A	8	5	13	0	0	13	0	0
7	24655094	.	T	C	9	5	14	0	0	14	0	0
7	24655261	.	A	G	5	4	9	0	0	9	0	0
7	24658938	.	G	A	2	3	5	0	5	10	0	0
7	24662235	.	G	A	5	3	8	0	0	8	0	0
7	24663995	.	T	C	5	6	11	0	1	12	0	0
7	24672147	.	A	G	13	1	14	0	13	27	0	0
7	24672257	.	G	C	14	10	24	0	0	24	0	0
7	24672766	.	A	G	0	2	2	0	1	3	0	0
7	24681673	.	A	G	21	21	42	0	2	44	0	0
7	24681731	.	T	C	12	31	43	0	4	47	0	0
7	24681755	.	A	G	16	27	43	0	1	44	0	0
7	24681806	.	A	G	16	21	37	0	1	38	0	0
7	24697400	.	T	C	10	10	20	0	0	20	0	0
7	24699881	.	G	T	8	13	21	0	1	22	0	0
7	24715143	.	G	A	2	2	4	0	0	4	0	0
7	24715168	.	A	C	1	2	3	0	0	3	0	0
7	24715278	.	A	G	1	2	3	0	0	3	0	0
7	24715361	.	T	C	3	2	5	0	0	5	0	0
7	24715879	.	C	T	2	2	4	0	0	4	0	0
7	24716258	.	C	T	4	2	6	0	0	6	0	0
7	24716373	.	G	A	2	3	5	0	0	5	0	0
7	24716393	.	G	T	4	5	9	0	0	9	0	0
7	24716508	.	T	G	3	4	7	0	0	7	0	0
7	24716538	.	G	A	3	5	8	0	0	8	0	0
7	24717402	.	G	A	1	3	4	0	1	5	0	0
7	24812090	.	C	G	1	4	5	0	0	5	0	0
7	24812587	.	C	T	8	4	12	0	0	12	0	0
7	24812662	.	G	T	4	3	7	0	0	7	0	0
7	24812783	.	A	G	2	0	2	0	4	6	0	0
7	24812870	.	C	T	2	2	4	0	0	4	0	0
7	24815992	.	C	T	6	9	15	0	1	16	0	0
7	24819788	.	G	A	26	19	45	0	2	47	0	0
7	24819812	.	G	A	24	15	39	0	2	41	0	0
7	24822914	.	G	A	21	17	38	0	2	40	0	0
7	24888052	.	A	C	1	1	2	0	1	3	0	0
7	24888986	.	T	C	1	6	7	0	0	7	0	0
7	24889617	.	T	G	2	0	2	0	3	5	0	0
7	24889758	.	T	C	1	2	3	0	0	3	0	0
7	24889808	.	C	G	3	2	5	0	0	5	0	0
7	24923112	.	G	A	0	3	3	0	5	8	0	0
7	24944724	.	C	T	5	5	10	0	0	10	0	0
7	24946895	.	C	T	6	6	12	0	0	12	0	0
7	24946913	.	T	C	5	6	11	0	0	11	0	0
7	24947440	.	T	C	6	7	13	0	1	14	0	0
7	24974916	.	T	C	12	13	25	1	0	26	0	0
7	24974937	.	T	C	11	11	22	1	0	23	0	0
7	24975264	.	T	C	15	9	24	0	1	25	0	0
7	24975646	.	C	T	16	15	31	0	0	31	0	0
7	24975678	.	G	A	19	10	29	0	2	31	0	0
7	24976539	.	T	C	17	13	30	0	1	31	0	0
7	24979979	.	A	G	3	4	7	0	0	7	0	0
7	24980107	.	T	G	5	9	14	0	1	15	0	0
7	24980185	.	T	G	11	5	16	0	0	16	0	0
7	24980469	.	C	T	15	11	26	0	0	26	0	0
7	24983304	.	C	T	6	7	13	0	1	14	0	0
7	24983328	.	C	T	1	4	5	0	7	12	0	0
7	24984869	.	G	T	7	2	9	0	0	9	0	0
7	25010745	.	C	T	26	19	45	0	1	46	0	0
7	25011238	.	A	G	13	11	24	0	0	24	0	0
7	25011375	.	T	C	5	5	10	0	1	11	0	0
7	25011585	.	T	G	9	4	13	0	0	13	0	0
7	25015154	.	C	T	4	8	12	0	0	12	0	0
7	25015239	.	C	T	8	3	11	0	0	11	0	0
7	25015419	.	T	C	5	13	18	1	0	19	0	0
7	25015424	.	G	A	3	12	15	1	0	16	0	0
7	25017967	.	G	C	5	10	15	0	0	15	0	0
7	25018043	.	G	T	2	6	8	0	3	11	0	0
7	25021647	.	T	G	3	9	12	0	0	12	0	0
7	25021697	.	T	C	6	10	16	0	1	17	0	0
7	25021718	.	C	T	7	9	16	0	0	16	0	0
7	25024266	.	T	C	15	9	24	0	0	24	0	0
7	25024277	.	A	T	15	10	25	0	1	27	1	0
7	25024346	.	G	C	0	11	11	2	11	24	0	0
7	25026873	.	C	T	7	9	16	0	1	17	0	0
7	25026960	.	C	T	5	11	16	0	1	17	0	0
7	25027022	.	T	C	12	7	19	0	1	20	0	0
7	25027034	.	A	G	10	8	18	0	0	18	0	0
7	25027208	.	G	A	4	5	9	0	0	9	0	0
7	25027211	.	G	T	1	5	6	0	3	9	0	0
7	25027266	.	T	C	4	6	10	0	0	10	0	0
7	25027466	.	C	A	3	8	11	0	0	11	0	0
7	25027561	.	C	T	13	12	25	0	0	25	0	0
7	25027571	.	A	G	12	13	25	0	1	26	0	0
7	25027756	.	T	C	15	7	22	0	0	22	0	0
7	25028034	.	C	T	12	17	29	0	0	29	0	0
7	25028081	.	A	G	17	13	30	0	0	30	0	0
7	25028085	.	G	C	17	14	31	0	0	31	0	0
7	25028205	.	T	A	19	12	31	0	1	32	0	0
7	25029003	.	T	C	6	7	13	0	0	13	0	0
7	25029191	.	G	A	0	3	3	0	1	4	0	0
7	25042942	.	A	C	15	13	28	0	3	31	0	0
7	25045337	.	T	A	10	6	16	0	0	16	0	0
7	25045642	.	C	T	2	2	4	0	0	4	0	0
7	25045777	.	A	G	17	9	26	0	1	27	0	0
7	25047228	.	A	C	1	3	4	0	0	4	0	0
7	25047307	.	G	C	5	4	9	0	0	9	0	0
7	25047318	.	A	C	6	4	10	0	0	10	0	0
7	25047441	.	T	G	16	9	25	0	0	25	0	0
7	25047604	.	T	A	11	13	24	0	0	24	0	0
7	25047954	.	G	A	20	10	30	0	0	30	0	0
7	25049262	.	A	G	12	15	27	0	0	27	0	0
7	25059856	.	C	T	12	10	22	0	1	23	0	0
7	25098910	.	G	A	36	20	56	0	2	58	0	0
7	25099133	.	A	G	24	4	28	2	25	55	0	0
7	25099302	.	T	C	16	10	26	0	0	26	0	0
7	25099594	.	T	G	14	12	26	0	1	27	0	0
7	25099704	.	T	C	15	16	31	0	2	33	0	0
7	25128575	.	T	A	2	2	4	0	0	4	0	0
7	25128611	.	T	C	5	2	7	0	0	7	0	0
7	25128620	.	G	A	5	2	7	0	0	7	0	0
7	25129363	.	G	T	2	2	4	0	0	4	0	0
7	25292455	.	T	C	1	4	5	0	0	5	0	0
7	25292978	.	G	A	0	3	3	0	1	4	0	0
7	25293123	.	C	A	3	3	6	0	0	6	0	0
7	25293131	.	G	T	3	4	7	0	0	7	0	0
7	25293261	.	T	C	2	5	7	0	1	8	0	0
7	25293666	.	A	G	2	5	7	0	0	7	0	0
7	25346924	.	G	C	0	3	3	0	5	8	0	0
7	25347459	.	T	G	6	10	16	0	0	16	0	0
7	25348031	.	C	T	1	3	4	0	0	4	0	0
7	25348396	.	A	T	2	2	4	0	0	4	0	0
7	25558747	.	G	A	2	3	5	0	0	5	0	0
7	25558837	.	T	A	1	3	4	0	0	4	0	0
7	25558952	.	C	A	0	5	5	0	7	12	0	0
7	25559010	.	T	C	4	4	8	0	0	8	0	0
7	25559093	.	A	G	3	4	7	0	0	7	0	0
7	25559814	.	C	T	2	2	4	0	0	4	0	0
7	25560010	.	T	A	1	2	3	0	0	3	0	0
7	25560013	.	C	A	1	2	3	0	0	3	0	0
7	25563477	.	T	C	1	2	3	0	0	3	0	0
7	25843643	.	A	G	1	0	1	0	3	4	0	0
7	25852549	.	A	G	3	0	3	0	3	6	0	0
7	25854239	.	T	C	7	3	10	0	0	10	0	0
7	25854245	.	C	G	6	3	9	0	0	9	0	0
7	25858611	.	C	A	7	5	12	0	1	13	0	0
7	25863708	.	C	T	10	7	17	0	1	18	0	0
7	25867412	.	C	T	12	7	19	0	0	19	0	0
7	25869617	.	C	T	11	13	24	0	0	24	0	0
7	25872580	.	C	T	13	7	20	2	0	22	0	0
7	25872691	.	G	A	2	9	11	0	12	23	0	0
7	25873009	.	C	T	15	9	24	0	0	24	0	0
7	25873601	.	A	T	19	14	33	0	0	33	0	0
7	25873728	.	T	G	19	0	19	0	16	35	0	0
7	25873743	.	C	A	22	16	38	0	1	39	0	0
7	25873857	.	T	C	10	10	20	0	0	20	0	0
7	25876947	.	A	C	14	10	24	0	1	25	0	0
7	25877033	.	A	T	11	12	23	0	2	25	0	0
7	25877038	.	G	A	12	12	24	0	2	26	0	0
7	25877420	.	T	C	17	15	32	0	0	32	0	0
7	25877445	.	G	C	17	17	34	0	0	34	0	0
7	25877984	.	A	C	2	3	5	0	0	5	0	0
7	25878417	.	T	G	6	6	12	0	0	12	0	0
7	25878642	.	G	T	19	14	33	0	2	35	0	0
7	25878723	.	A	C	22	21	43	0	1	44	0	0
7	25878786	.	C	T	1	28	29	0	27	56	0	0
7	25878849	.	T	C	17	22	39	0	7	46	0	0
7	25878977	.	A	G	25	12	37	0	2	39	0	0
7	25879116	.	T	G	23	22	45	0	4	49	0	0
7	25879130	.	G	C	27	23	50	0	2	52	0	0
7	25879514	.	T	A	21	28	49	0	0	49	0	0
7	25879905	.	G	A	19	15	34	0	1	35	0	0
7	25879920	.	G	T	20	13	33	0	2	36	1	0
7	25880033	.	A	T	17	14	31	0	1	32	0	0
7	25880046	.	C	A	16	13	29	0	1	30	0	0
7	25880207	.	T	A	10	9	19	0	0	19	0	0
7	25880226	.	G	A	10	9	19	0	0	19	0	0
7	25880313	.	T	A	20	19	39	0	1	40	0	0
7	25880340	.	C	T	1	19	20	0	22	42	0	0
7	25880754	.	C	T	2	12	14	0	18	32	0	0
7	25880843	.	G	A	10	14	24	0	2	26	0	0
7	25881215	.	C	T	19	12	31	0	2	33	0	0
7	25881583	.	G	A	21	8	29	6	5	40	0	0
7	25881605	.	A	C	21	9	30	6	2	38	0	0
7	25884007	.	G	T	15	14	29	0	0	29	0	0
7	25884148	.	A	G	13	20	33	0	1	34	0	0
7	25917046	.	A	G	40	32	72	0	2	74	0	0
7	25917473	.	G	A	3	25	28	2	37	67	0	0
7	25917634	.	A	T	32	34	66	0	2	68	0	0
7	25918056	.	C	T	29	35	64	4	6	74	0	0
7	25918101	.	T	G	29	5	34	0	34	68	0	0
7	25920966	.	A	G	12	0	12	0	13	25	0	0
7	25979203	.	T	C	10	12	22	0	0	22	0	0
7	25979417	.	C	T	11	14	25	0	1	26	0	0
7	25979468	.	C	T	20	14	34	0	0	34	0	0
7	25979510	.	T	C	22	13	35	0	0	35	0	0
7	25986069	.	G	T	2	18	20	0	18	38	0	0
7	25986099	.	C	T	18	20	38	0	3	41	0	0
7	25988324	.	C	A	25	11	36	0	1	37	0	0
7	26002674	.	C	T	21	20	41	0	1	42	0	0
7	26002915	.	T	A	26	11	37	0	1	38	0	0
7	26003853	.	C	T	4	3	7	0	0	7	0	0
7	26004014	.	G	T	3	2	5	0	0	5	0	0
7	26004616	.	A	G	7	5	12	0	0	12	0	0
7	26004876	.	T	A	11	5	16	2	0	18	0	0
7	26005033	.	A	G	4	7	11	0	1	12	0	0
7	26005574	.	A	T	1	7	8	0	0	8	0	0
7	26008444	.	A	G	4	2	6	0	1	7	0	0
7	26011665	.	A	T	3	5	8	0	0	8	0	0
7	26013041	.	C	G	3	4	7	0	1	8	0	0
7	26015376	.	C	T	4	7	11	0	1	12	0	0
7	26015378	.	A	G	4	8	12	0	0	12	0	0
7	26015544	.	G	T	8	6	14	0	0	14	0	0
7	26015595	.	C	A	9	5	14	0	0	14	0	0
7	26015628	.	T	C	10	7	17	0	1	18	0	0
7	26015663	.	T	C	14	8	22	0	0	22	0	0
7	26015693	.	C	A	14	12	26	0	0	26	0	0
7	26020078	.	T	C	13	13	26	0	0	26	0	0
7	26020192	.	C	T	7	12	19	0	2	21	0	0
7	26020273	.	G	A	1	11	12	0	8	20	0	0
7	26020370	.	T	C	8	7	15	0	0	15	0	0
7	26020408	.	A	C	6	6	12	0	1	13	0	0
7	26020659	.	C	T	7	11	18	0	1	19	0	0
7	26020779	.	C	T	9	9	18	0	2	20	0	0
7	26020927	.	A	T	11	7	18	0	0	18	0	0
7	26021146	.	A	G	17	11	28	0	1	29	0	0
7	26026114	.	A	G	14	1	15	0	13	28	0	0
7	26026176	.	C	T	9	14	23	0	1	24	0	0
7	26026188	.	C	A	12	12	24	0	1	25	0	0
7	26026241	.	G	A	15	4	19	0	0	19	0	0
7	26026264	.	C	G	9	4	13	1	1	15	0	0
7	26026298	.	T	G	7	0	7	1	4	12	0	0
7	26026330	.	A	T	7	5	12	1	0	13	0	0
7	26026358	.	A	C	4	4	8	0	0	8	0	0
7	26026379	.	C	T	3	4	7	0	1	8	0	0
7	26048364	.	T	A	3	3	6	0	1	7	0	0
7	26049179	.	G	T	1	3	4	0	0	4	0	0
7	26049191	.	A	T	2	1	3	0	1	4	0	0
7	26074160	.	C	A	11	9	20	0	0	20	0	0
7	26076368	.	A	G	3	7	10	0	0	10	0	0
7	26076458	.	A	T	3	7	10	0	0	10	0	0
7	26076531	.	G	C	2	4	6	0	0	6	0	0
7	26077845	.	G	T	23	20	43	0	0	43	0	0
7	26077947	.	T	A	22	31	53	0	3	56	0	0
7	26077949	.	C	T	23	32	55	0	2	57	0	0
7	26078061	.	T	C	16	25	41	4	1	46	0	0
7	26078243	.	A	C	21	21	42	0	1	43	0	0
7	26078284	.	C	T	16	22	38	0	2	40	0	0
7	26078345	.	T	A	25	22	47	0	0	47	0	0
7	26078435	.	G	T	15	14	29	0	3	32	0	0
7	26078516	.	T	A	20	6	26	0	1	27	0	0
7	26078897	.	G	A	26	18	44	0	3	47	0	0
7	26078947	.	G	A	26	16	42	0	3	45	0	0
7	26079370	.	T	G	20	27	47	0	0	47	0	0
7	26079667	.	C	G	4	28	32	0	15	47	0	0
7	26081171	.	C	T	20	13	33	0	1	34	0	0
7	26081252	.	A	G	16	18	34	0	4	38	0	0
7	26081744	.	T	C	15	15	30	0	2	32	0	0
7	26118553	.	G	C	2	2	4	0	0	4	0	0
7	26118564	.	T	C	1	3	4	0	0	4	0	0
7	26118734	.	T	C	4	0	4	0	4	8	0	0
7	26132724	.	C	T	21	9	30	0	0	30	0	0
7	26132743	.	C	T	17	11	28	0	1	29	0	0
7	26140767	.	A	G	18	23	41	0	2	43	0	0
7	26141394	.	G	C	16	6	22	0	2	24	0	0
7	26141519	.	T	A	16	18	34	0	0	34	0	0
7	26141568	.	T	A	25	22	47	0	3	50	0	0
7	26142339	.	T	C	18	12	30	0	3	33	0	0
7	26142525	.	T	G	23	0	23	1	13	37	0	0
7	26142702	.	A	G	14	30	44	0	1	45	0	0
7	26142736	.	A	T	13	24	37	0	0	37	0	0
7	26143343	.	A	G	7	17	24	0	1	25	0	0
7	26143501	.	T	C	13	28	41	0	2	43	0	0
7	26143760	.	G	A	16	20	36	0	1	37	0	0
7	26144551	.	T	A	6	3	9	0	0	9	0	0
7	26144628	.	C	T	1	6	7	0	0	7	0	0
7	26145605	.	T	C	27	28	55	0	0	55	0	0
7	26145816	.	C	T	3	6	9	0	1	10	0	0
7	26145873	.	C	T	6	11	17	0	1	18	0	0
7	26145910	.	T	C	12	10	22	0	0	22	0	0
7	26146176	.	A	C	33	25	58	0	0	59	1	0
7	26146188	.	T	C	32	29	61	0	0	62	1	0
7	26146796	.	A	G	40	1	41	0	23	64	0	0
7	26146993	.	C	T	39	26	65	0	4	69	0	0
7	26148181	.	A	C	30	36	66	0	5	71	0	0
7	26148312	.	T	G	28	25	53	0	1	54	0	0
7	26148773	.	G	A	8	6	14	0	0	14	0	0
7	26149252	.	G	A	34	30	64	0	0	64	0	0
7	26149690	.	C	T	25	33	58	0	2	60	0	0
7	26150096	.	T	A	16	23	39	0	0	39	0	0
7	26224320	.	A	G	19	16	35	0	0	35	0	0
7	26224365	.	A	T	13	10	23	0	1	24	0	0
7	26226772	.	G	C	15	15	30	0	0	30	0	0
7	26227119	.	C	T	19	16	35	0	3	38	0	0
7	26227149	.	C	T	19	15	34	0	0	34	0	0
7	26227527	.	T	C	11	16	27	0	2	29	0	0
7	26227539	.	T	C	11	17	28	0	0	28	0	0
7	26228290	.	C	T	15	24	39	0	2	41	0	0
7	26228639	.	T	C	21	20	41	0	0	41	0	0
7	26229449	.	G	A	11	19	30	0	1	31	0	0
7	26229529	.	C	T	27	25	52	0	0	52	0	0
7	26229551	.	T	A	31	22	53	0	4	57	0	0
7	26229640	.	T	C	31	27	58	0	0	58	0	0
7	26229935	.	C	T	25	16	41	0	1	42	0	0
7	26229979	.	A	G	6	16	22	0	4	26	0	0
7	26245668	.	T	C	11	14	25	0	2	27	0	0
7	26245714	.	A	T	8	21	29	0	1	30	0	0
7	26263153	.	C	T	10	10	20	0	0	20	0	0
7	26263174	.	T	C	4	0	4	0	4	8	0	0
7	26265832	.	C	A	1	3	4	0	1	5	0	0
7	26266069	.	G	C	5	5	10	0	1	11	0	0
7	26267967	.	C	T	3	3	6	0	0	6	0	0
7	26300263	.	A	G	7	3	10	0	0	10	0	0
7	26300359	.	A	G	3	9	12	0	1	13	0	0
7	26300955	.	T	C	1	0	1	0	4	5	0	0
7	26366620	.	T	C	11	9	20	0	0	20	0	0
7	26366684	.	C	T	7	6	13	0	0	13	0	0
7	26366778	.	G	A	9	18	27	0	0	27	0	0
7	26366919	.	G	A	10	5	15	0	2	17	0	0
7	26367056	.	T	C	9	1	10	0	11	21	0	0
7	26367280	.	C	T	1	6	7	0	10	17	0	0
7	26367470	.	C	G	2	5	7	1	0	8	0	0
7	26367486	.	A	C	2	6	8	1	0	9	0	0
7	26367525	.	A	G	6	8	14	0	3	17	0	0
7	26367944	.	G	A	7	3	10	0	0	10	0	0
7	26368240	.	C	A	5	5	10	0	0	10	0	0
7	26368291	.	A	C	5	4	9	0	0	9	0	0
7	26368333	.	A	T	6	5	11	0	2	13	0	0
7	26368483	.	T	A	4	11	15	0	0	15	0	0
7	26368549	.	A	G	6	6	12	0	0	12	0	0
7	26368719	.	C	A	4	4	8	0	1	9	0	0
7	26368748	.	A	T	5	3	8	0	1	9	0	0
7	26368836	.	A	T	2	5	7	0	1	8	0	0
7	26368955	.	G	T	9	5	14	0	0	14	0	0
7	26369030	.	C	T	9	2	11	0	1	12	0	0
7	26369034	.	G	C	7	3	10	0	1	11	0	0
7	26369227	.	G	A	4	6	10	0	0	10	0	0
7	26369583	.	A	C	9	0	9	0	9	18	0	0
7	26371702	.	G	A	4	5	9	0	1	10	0	0
7	26371711	.	G	A	7	5	12	0	0	12	0	0
7	26378224	.	G	A	4	7	11	0	0	11	0	0
7	26389261	.	C	T	1	3	4	0	0	4	0	0
7	26389351	.	C	T	1	5	6	0	1	7	0	0
7	26389369	.	G	A	2	3	5	0	1	6	0	0
7	26389429	.	C	T	1	5	6	0	1	7	0	0
7	26389486	.	G	A	2	4	6	0	1	7	0	0
7	26394208	.	A	T	15	20	35	0	2	37	0	0
7	26394285	.	A	T	11	13	24	1	1	26	0	0
7	26394382	.	C	T	1	19	20	0	11	31	0	0
7	26394476	.	G	A	20	15	35	0	1	36	0	0
7	26394791	.	A	G	24	15	39	0	0	39	0	0
7	26394848	.	G	A	21	12	33	0	0	33	0	0
7	26395538	.	T	C	14	14	28	0	0	28	0	0
7	26395625	.	T	A	6	5	11	0	1	12	0	0
7	26395778	.	T	G	2	10	12	0	0	12	0	0
7	26396170	.	G	A	8	6	14	0	0	14	0	0
7	26396768	.	G	A	16	18	34	0	0	34	0	0
7	26396915	.	A	C	7	5	12	0	0	12	0	0
7	26396975	.	A	G	9	7	16	0	0	16	0	0
7	26397003	.	T	G	11	4	15	0	0	15	0	0
7	26397096	.	T	C	9	0	9	0	6	15	0	0
7	26397243	.	G	A	10	9	19	0	0	19	0	0
7	26397475	.	T	A	4	8	12	0	1	13	0	0
7	26397760	.	C	T	12	5	17	0	2	19	0	0
7	26398159	.	A	T	6	13	19	0	0	19	0	0
7	26398351	.	A	G	9	5	14	0	0	14	0	0
7	26398867	.	G	A	11	11	22	0	3	25	0	0
7	26402680	.	C	A	9	6	15	0	0	15	0	0
7	26402788	.	T	G	3	7	10	0	0	10	0	0
7	26408340	.	C	T	4	4	8	0	0	8	0	0
7	26408466	.	C	A	0	2	2	0	4	6	0	0
7	26457085	.	A	G	1	2	3	0	0	3	0	0
7	26469820	.	G	A	0	6	6	0	6	12	0	0
7	26472340	.	A	C	6	12	18	0	0	18	0	0
7	26472346	.	A	T	5	11	16	0	1	17	0	0
7	26472398	.	C	T	9	7	16	0	0	16	0	0
7	26472413	.	A	G	9	4	13	0	0	13	0	0
7	26472512	.	G	T	8	4	12	0	1	13	0	0
7	26472971	.	C	G	6	4	10	0	0	10	0	0
7	26473040	.	A	G	2	0	2	0	9	11	0	0
7	26473163	.	G	A	6	4	10	0	0	10	0	0
7	26511439	.	A	T	20	16	36	0	6	42	0	0
7	26511691	.	G	A	33	10	43	0	2	45	0	0
7	26511760	.	A	G	20	26	46	0	1	47	0	0
7	26511801	.	T	G	24	20	44	0	0	44	0	0
7	26519052	.	A	G	7	7	14	0	2	16	0	0
7	26519150	.	A	T	13	11	24	0	1	25	0	0
7	26522358	.	T	C	9	9	18	0	0	18	0	0
7	26522364	.	C	T	8	7	15	0	1	16	0	0
7	26523169	.	A	G	6	10	16	0	1	17	0	0
7	26525463	.	C	T	9	5	14	0	0	14	0	0
7	27018372	.	T	A	11	2	13	0	0	13	0	0
7	27681025	.	G	T	5	9	14	0	1	15	0	0
7	27681071	.	A	T	16	10	26	0	0	26	0	0
7	27682919	.	C	T	7	10	17	1	0	18	0	0
7	27700517	.	G	A	6	9	15	0	3	18	0	0
7	27700777	.	C	T	1	8	9	0	9	18	0	0
7	27701231	.	T	A	6	6	12	0	1	13	0	0
7	27701348	.	A	C	5	5	10	0	2	12	0	0
7	27701431	.	T	A	1	3	4	0	1	5	0	0
7	27701561	.	A	T	11	3	14	0	0	14	0	0
7	27701623	.	C	A	8	4	12	0	1	13	0	0
7	27701634	.	A	G	7	5	12	0	0	12	0	0
7	27702003	.	A	C	2	4	6	0	0	6	0	0
7	27702571	.	T	G	10	7	17	0	0	17	0	0
7	27702934	.	G	A	10	9	19	0	1	20	0	0
7	27702998	.	T	A	9	8	17	0	0	17	0	0
7	27703102	.	T	C	6	8	14	0	1	15	0	0
7	27705837	.	G	A	11	6	17	0	0	17	0	0
7	27712933	.	C	T	0	3	3	0	2	5	0	0
7	27718258	.	C	G	2	7	9	0	4	13	0	0
7	27720520	.	A	G	4	10	14	0	0	14	0	0
7	27722513	.	A	G	6	8	14	0	0	14	0	0
7	27722534	.	A	G	5	6	11	0	0	11	0	0
7	27724908	.	T	C	4	6	10	0	0	10	0	0
7	27724920	.	T	G	4	4	8	0	1	9	0	0
7	27798561	.	A	C	4	4	8	0	0	8	0	0
7	27805487	.	A	G	3	3	6	0	1	7	0	0
7	27805547	.	C	T	4	3	7	0	0	7	0	0
7	27806074	.	G	A	1	7	8	0	3	11	0	0
7	27811770	.	C	T	13	9	22	0	1	23	0	0
7	27813749	.	C	T	7	12	19	0	2	21	0	0
7	27813942	.	G	A	12	5	17	0	0	17	0	0
7	27813978	.	A	G	7	0	7	0	10	17	0	0
7	27814326	.	C	T	8	9	17	0	2	19	0	0
7	27816668	.	T	C	13	12	25	0	2	27	0	0
7	27816875	.	C	T	16	10	26	0	1	27	0	0
7	27817229	.	C	A	18	15	33	0	1	34	0	0
7	27817283	.	A	G	22	1	23	0	14	37	0	0
7	27817755	.	G	C	17	21	38	0	2	40	0	0
7	27820177	.	G	A	7	8	15	0	0	15	0	0
7	27834170	.	A	G	7	3	10	0	1	11	0	0
7	27884185	.	A	G	8	11	19	1	1	21	0	0
7	27884211	.	A	G	8	7	15	1	0	16	0	0
7	27884343	.	A	G	1	1	2	0	2	4	0	0
7	27884979	.	G	T	2	2	4	0	0	4	0	0
7	27885000	.	T	C	3	4	7	0	0	7	0	0
7	27885043	.	C	T	5	6	11	0	0	11	0	0
7	27885160	.	A	G	6	4	10	0	0	10	0	0
7	27885259	.	A	G	8	5	13	0	0	13	0	0
7	27885703	.	A	T	8	5	13	0	0	13	0	0
7	27885706	.	C	T	7	5	12	0	1	13	0	0
7	27885941	.	G	A	5	7	12	0	0	12	0	0
7	27886502	.	A	T	2	7	9	0	3	12	0	0
7	27886508	.	A	T	5	7	12	0	0	12	0	0
7	27886602	.	C	A	9	9	18	1	0	19	0	0
7	27886923	.	A	G	6	10	16	0	3	19	0	0
7	27886924	.	A	G	7	12	19	0	0	19	0	0
7	27887044	.	T	A	7	4	11	0	0	11	0	0
7	27887284	.	A	C	1	2	3	0	0	3	0	0
7	27976894	.	C	T	4	9	13	0	0	13	0	0
7	27977061	.	C	T	7	8	15	0	0	15	0	0
7	27977083	.	G	A	0	7	7	0	7	14	0	0
7	28033649	.	G	A	0	7	7	0	15	22	0	0
7	28039990	.	G	A	0	7	7	0	7	14	0	0
7	28040014	.	G	T	0	4	4	0	10	14	0	0
7	28040083	.	T	C	4	2	6	0	0	6	0	0
7	28041147	.	G	A	0	4	4	0	6	10	0	0
7	28041496	.	T	C	10	3	13	0	0	13	0	0
7	28041538	.	T	C	4	12	16	0	0	16	0	0
7	28041570	.	G	T	9	4	13	0	1	14	0	0
7	28041736	.	A	G	5	4	9	0	1	10	0	0
7	28041842	.	T	C	5	3	8	0	0	8	0	0
7	28041942	.	T	C	7	4	11	0	2	13	0	0
7	28042060	.	G	A	2	5	7	0	0	7	0	0
7	28042070	.	A	C	4	2	6	0	1	7	0	0
7	28042732	.	G	A	3	2	5	0	1	6	0	0
7	28042740	.	G	A	3	5	8	0	0	8	0	0
7	28042909	.	C	T	3	6	9	1	1	11	0	0
7	28043040	.	C	A	2	2	4	0	0	4	0	0
7	28043173	.	T	G	11	2	13	0	1	14	0	0
7	28043184	.	A	G	8	1	9	0	4	13	0	0
7	28043284	.	A	G	6	5	11	0	1	12	0	0
7	28043416	.	A	G	8	8	16	0	1	17	0	0
7	28043837	.	T	G	15	0	15	0	7	22	0	0
7	28043852	.	G	A	16	9	25	0	1	26	0	0
7	28044193	.	A	G	8	13	21	0	0	21	0	0
7	28044628	.	A	G	10	2	12	0	0	12	0	0
7	28045160	.	G	A	0	4	4	0	7	11	0	0
7	28045263	.	C	G	12	7	19	2	1	22	0	0
7	28045318	.	G	A	13	5	18	0	0	18	0	0
7	28045323	.	C	A	12	4	16	0	0	16	0	0
7	28045404	.	A	C	12	6	18	1	0	19	0	0
7	28045444	.	T	A	12	10	22	0	0	22	0	0
7	28045571	.	T	C	12	8	20	0	0	20	0	0
7	28045600	.	C	T	10	13	23	0	2	25	0	0
7	28045685	.	C	T	7	11	18	0	0	18	0	0
7	28046436	.	T	C	5	9	14	2	2	18	0	0
7	28046530	.	A	G	16	9	25	0	0	25	0	0
7	28046572	.	T	C	13	11	24	0	0	24	0	0
7	28046580	.	A	G	9	13	22	0	1	23	0	0
7	28046619	.	A	G	22	0	22	2	10	34	0	0
7	28046784	.	C	T	4	1	5	0	1	6	0	0
7	28046918	.	A	C	7	6	13	1	0	14	0	0
7	28047004	.	G	A	9	7	16	0	0	16	0	0
7	28047072	.	C	T	3	4	7	0	0	7	0	0
7	28047163	.	C	T	2	2	4	0	0	4	0	0
7	28147806	.	T	A	16	15	31	0	1	32	0	0
7	28406514	.	G	A	1	2	3	0	0	3	0	0
7	28408396	.	A	G	2	2	4	0	1	5	0	0
7	28424237	.	C	G	10	6	16	0	2	18	0	0
7	28424381	.	A	T	8	7	15	0	0	15	0	0
7	28430010	.	G	A	9	8	17	0	0	17	0	0
7	28430127	.	C	A	9	3	12	0	1	13	0	0
7	28430430	.	C	T	6	10	16	0	0	16	0	0
7	28430454	.	C	A	7	7	14	0	1	15	0	0
7	28430503	.	G	A	8	3	11	0	1	12	0	0
7	28430528	.	G	T	6	5	11	0	1	12	0	0
7	28434034	.	A	T	12	9	21	0	0	21	0	0
7	28436486	.	G	C	9	10	19	0	0	19	0	0
7	28442009	.	G	C	10	6	16	0	1	17	0	0
7	28448588	.	C	T	6	5	11	0	0	11	0	0
7	28465338	.	G	A	4	8	12	0	1	13	0	0
7	28467182	.	A	G	10	7	17	0	1	18	0	0
7	28485206	.	G	A	4	3	7	0	0	7	0	0
7	28485287	.	T	A	1	2	3	0	1	4	0	0
7	28516905	.	G	A	2	2	4	0	0	4	0	0
7	28559907	.	G	A	16	16	32	0	0	32	0	0
7	28559969	.	G	T	10	8	18	0	2	20	0	0
7	28560250	.	G	C	19	10	29	0	1	30	0	0
7	28560256	.	G	A	20	9	29	0	0	29	0	0
7	28560467	.	C	G	16	19	35	0	1	36	0	0
7	28562196	.	A	G	14	16	30	0	1	31	0	0
7	28571529	.	G	A	3	3	6	0	0	6	0	0
7	28580690	.	C	T	1	2	3	0	0	3	0	0
7	28580691	.	T	C	1	2	3	0	0	3	0	0
7	28593495	.	T	C	1	1	2	0	1	3	0	0
7	28593499	.	G	A	0	1	1	0	1	2	0	0
7	28612726	.	T	C	17	16	33	0	0	33	0	0
7	28612899	.	G	A	0	10	10	0	10	20	0	0
7	28612929	.	A	G	12	11	23	0	2	25	0	0
7	28612962	.	G	A	13	15	28	0	1	29	0	0
7	28615709	.	T	C	15	12	27	0	1	28	0	0
7	28615850	.	G	A	18	18	36	0	1	37	0	0
7	28615922	.	A	G	14	0	14	0	13	27	0	0
7	28618813	.	C	T	42	16	58	1	0	59	0	0
7	28622856	.	G	A	19	19	38	0	3	41	0	0
7	28622970	.	T	C	28	21	49	1	1	51	0	0
7	28623506	.	T	A	3	7	10	0	0	10	0	0
7	28623533	.	A	T	3	3	6	0	1	7	0	0
7	28623599	.	T	C	1	0	1	0	2	3	0	0
7	28623860	.	A	G	11	6	17	0	0	17	0	0
7	28623863	.	A	G	11	7	18	0	0	18	0	0
7	28624106	.	A	T	9	3	12	0	1	13	0	0
7	28624157	.	C	G	2	6	8	0	0	8	0	0
7	28624688	.	A	T	6	4	10	0	1	11	0	0
7	28624692	.	T	C	4	7	11	0	0	11	0	0
7	28625080	.	G	T	3	5	8	0	0	8	0	0
7	28625145	.	A	T	4	5	9	0	0	9	0	0
7	28626037	.	G	C	2	2	4	0	0	4	0	0
7	28626098	.	G	A	3	4	7	0	0	7	0	0
7	28636305	.	G	A	2	2	4	0	0	4	0	0
7	29968898	.	A	G	1	4	5	0	0	5	0	0
7	30535901	.	C	T	3	2	5	0	0	5	0	0
7	30770623	.	C	T	2	3	5	0	0	5	0	0
7	31925384	.	T	C	10	5	15	1	0	16	0	0
7	32746213	.	A	G	19	13	32	0	0	32	0	0
7	32747956	.	A	G	13	1	14	0	10	24	0	0
7	32747973	.	A	G	8	18	26	0	1	27	0	0
7	32748203	.	A	G	18	9	27	0	1	28	0	0
7	32835573	.	T	A	3	1	4	0	1	5	0	0
7	34105791	.	T	C	2	3	5	0	0	5	0	0
7	34105793	.	T	C	2	2	4	0	1	5	0	0
7	34652564	.	C	T	1	6	7	0	0	7	0	0
7	35211659	.	A	G	0	3	3	0	0	3	0	0
7	35211680	.	A	G	2	3	5	0	0	5	0	0
7	37583018	.	T	G	10	2	12	1	0	13	0	0
7	37585016	.	T	A	5	2	7	0	1	8	0	0
7	38385555	.	T	A	2	5	7	0	0	7	0	0
7	38456516	.	C	A	7	4	11	0	0	11	0	0
7	38456517	.	C	T	8	4	12	0	0	12	0	0
7	38456592	.	A	T	8	3	11	0	0	11	0	0
7	38456699	.	T	C	4	4	8	0	0	8	0	0
7	38456944	.	T	C	6	0	6	0	5	11	0	0
7	38476911	.	T	A	7	9	16	0	0	16	0	0
7	38476976	.	C	T	7	7	14	0	2	16	0	0
7	38477026	.	C	T	1	5	6	0	6	12	0	0
7	38477075	.	G	A	5	5	10	0	4	14	0	0
7	38477196	.	C	T	5	3	8	0	0	8	0	0
7	38477224	.	T	C	1	2	3	0	0	3	0	0
7	38529272	.	G	T	4	2	6	0	0	6	0	0
7	38529290	.	C	T	3	3	6	0	0	6	0	0
7	38529350	.	C	T	2	2	4	0	0	4	0	0
7	38529680	.	G	A	3	3	6	0	0	6	0	0
7	38529689	.	C	G	3	0	3	0	3	6	0	0
7	38529867	.	A	T	3	3	6	0	0	6	0	0
7	38529899	.	C	T	2	3	5	0	0	5	0	0
7	38531615	.	C	A	3	2	5	0	0	5	0	0
7	38532382	.	A	C	3	4	7	0	1	8	0	0
7	38532390	.	G	A	0	3	3	0	4	7	0	0
7	38532495	.	G	A	1	3	4	0	0	4	0	0
7	38532541	.	G	C	1	3	4	0	0	4	0	0
7	38532888	.	G	A	1	3	4	1	1	6	0	0
7	38533225	.	G	T	4	4	8	0	0	8	0	0
7	38533250	.	C	G	2	4	6	0	0	6	0	0
7	38533275	.	A	G	3	3	6	0	0	6	0	0
7	38533301	.	A	G	3	2	5	0	1	6	0	0
7	38533453	.	T	C	3	2	5	0	0	5	0	0
7	38536370	.	C	T	24	15	39	0	0	39	0	0
7	38536416	.	C	T	15	17	32	0	0	32	0	0
7	38536697	.	A	G	17	12	29	0	0	29	0	0
7	38536703	.	A	T	16	12	28	0	3	31	0	0
7	38536889	.	G	T	15	11	26	0	0	26	0	0
7	38537085	.	T	A	14	10	24	0	0	24	0	0
7	38537345	.	C	T	16	17	33	0	0	33	0	0
7	38537657	.	C	T	9	11	20	0	0	20	0	0
7	38539554	.	A	G	10	7	17	0	0	17	0	0
7	38539577	.	A	G	8	8	16	0	0	16	0	0
7	38539643	.	C	A	7	7	14	0	1	15	0	0
7	38539730	.	G	A	6	7	13	0	0	13	0	0
7	38539768	.	T	A	13	7	20	0	0	20	0	0
7	38539992	.	G	A	6	11	17	0	0	17	0	0
7	38540134	.	G	A	8	15	23	0	0	24	1	0
7	38544706	.	A	G	8	7	15	0	0	15	0	0
7	38552294	.	T	C	1	6	7	0	2	9	0	0
7	38570789	.	C	T	4	5	9	0	0	9	0	0
7	38578128	.	T	C	3	3	6	0	0	6	0	0
7	38578140	.	T	C	4	3	7	0	0	7	0	0
7	38594474	.	A	C	16	12	28	0	2	30	0	0
7	38594510	.	G	C	12	10	22	0	2	24	0	0
7	38600226	.	A	G	16	12	28	0	4	32	0	0
7	38600265	.	T	C	24	16	40	0	1	41	0	0
7	38600483	.	A	G	9	17	26	0	1	27	0	0
7	38600585	.	C	T	2	13	15	1	21	37	0	0
7	38600892	.	G	A	17	10	27	0	1	28	0	0
7	38600982	.	G	A	34	29	63	0	2	65	0	0
7	38601025	.	G	T	41	15	56	0	3	59	0	0
7	38601067	.	G	T	42	13	55	0	2	57	0	0
7	38601156	.	G	T	23	17	40	0	5	45	0	0
7	38601374	.	C	T	33	30	63	0	1	64	0	0
7	38601391	.	T	A	24	38	62	0	2	64	0	0
7	38601417	.	A	C	28	36	64	0	1	65	0	0
7	38601625	.	C	A	39	10	49	0	2	51	0	0
7	38601646	.	G	A	35	21	56	0	1	57	0	0
7	38601751	.	T	C	38	20	58	0	2	60	0	0
7	38601759	.	C	G	44	19	63	0	2	65	0	0
7	38601823	.	C	A	6	14	20	1	31	52	0	0
7	38601909	.	C	T	2	17	19	0	20	39	0	0
7	38602123	.	C	T	30	26	56	0	3	59	0	0
7	38602160	.	A	T	26	23	49	0	2	51	0	0
7	38602623	.	T	C	34	28	62	0	0	62	0	0
7	38602656	.	G	A	28	24	52	0	2	55	1	0
7	38602917	.	A	T	26	34	60	0	1	61	0	0
7	38612100	.	A	G	21	13	34	0	0	34	0	0
7	38612109	.	G	A	22	14	36	0	1	37	0	0
7	38612334	.	T	C	1	0	1	0	4	5	0	0
7	38671516	.	A	G	13	8	21	0	1	22	0	0
7	38671782	.	T	C	13	9	22	0	0	22	0	0
7	38673259	.	G	A	2	10	12	0	11	23	0	0
7	38674189	.	T	C	10	18	28	0	0	28	0	0
7	38677497	.	T	C	16	17	33	0	2	35	0	0
7	38677880	.	G	T	18	19	37	0	0	37	0	0
7	38677999	.	A	T	10	12	22	0	1	23	0	0
7	38681322	.	C	T	16	11	27	0	0	27	0	0
7	38683503	.	C	A	12	15	27	0	1	28	0	0
7	38683834	.	T	C	16	16	32	0	2	34	0	0
7	38684830	.	C	T	22	17	39	0	1	40	0	0
7	38684970	.	C	T	16	15	31	0	0	31	0	0
7	38685201	.	T	G	1	4	5	0	0	5	0	0
7	38686849	.	T	C	2	7	9	0	0	9	0	0
7	38689592	.	A	T	1	2	3	0	1	4	0	0
7	38689603	.	A	C	1	3	4	0	0	4	0	0
7	38689701	.	G	A	0	5	5	0	1	6	0	0
7	38690012	.	C	T	1	3	4	0	0	4	0	0
7	38690013	.	C	T	1	3	4	0	0	4	0	0
7	38696163	.	A	G	31	38	69	0	1	70	0	0
7	38703509	.	C	T	0	3	3	0	3	6	0	0
7	38703598	.	C	T	5	3	8	0	0	8	0	0
7	38704063	.	T	C	4	6	10	0	0	10	0	0
7	38704622	.	C	A	8	8	16	0	0	16	0	0
7	38704623	.	T	C	8	0	8	0	8	16	0	0
7	38704754	.	C	T	6	4	10	1	2	13	0	0
7	38704832	.	G	A	7	4	11	0	1	12	0	0
7	38704834	.	A	G	8	4	12	0	0	12	0	0
7	38705012	.	A	T	4	7	11	0	1	12	0	0
7	38705097	.	A	C	8	0	8	0	5	13	0	0
7	38705643	.	A	G	7	4	11	1	1	13	0	0
7	38709326	.	G	T	9	7	16	0	0	16	0	0
7	38709701	.	G	A	5	4	9	0	0	9	0	0
7	38714503	.	A	T	4	5	9	0	0	9	0	0
7	38717795	.	G	A	3	8	11	0	9	20	0	0
7	38717819	.	A	C	11	10	21	0	0	21	0	0
7	38722708	.	T	C	15	19	34	0	0	34	0	0
7	38722716	.	T	A	13	19	32	0	2	34	0	0
7	38726646	.	A	G	18	9	27	0	1	28	0	0
7	38734152	.	G	A	0	8	8	0	5	13	0	0
7	38734276	.	T	G	7	14	21	0	0	21	0	0
7	38734431	.	C	A	22	11	33	0	2	35	0	0
7	38734475	.	A	C	22	14	36	0	1	37	0	0
7	38734527	.	T	C	18	16	34	0	0	34	0	0
7	38734573	.	A	G	12	15	27	0	2	29	0	0
7	38734626	.	G	T	27	13	40	0	0	40	0	0
7	38735363	.	A	G	18	17	35	0	1	36	0	0
7	38735406	.	C	T	19	19	38	0	0	38	0	0
7	38735460	.	G	T	29	16	45	0	2	47	0	0
7	38735465	.	A	C	28	15	43	0	2	45	0	0
7	38735501	.	T	C	15	13	28	0	2	30	0	0
7	38735552	.	T	A	5	2	7	0	3	10	0	0
7	38735711	.	G	A	4	10	14	0	0	14	0	0
7	38735727	.	A	T	5	13	18	0	0	18	0	0
7	38735827	.	A	C	17	13	30	0	2	32	0	0
7	38736320	.	G	C	15	31	46	0	2	48	0	0
7	38736526	.	C	T	12	4	16	0	1	17	0	0
7	38736818	.	C	A	3	3	6	0	1	7	0	0
7	38736819	.	A	G	3	4	7	0	0	7	0	0
7	38736912	.	T	C	1	7	8	0	0	8	0	0
7	38737020	.	T	C	5	9	14	0	1	15	0	0
7	38737224	.	C	T	11	4	15	0	2	17	0	0
7	38737286	.	C	T	9	7	16	0	1	17	0	0
7	38762091	.	A	C	6	5	11	0	0	11	0	0
7	38762127	.	A	G	13	0	13	0	14	27	0	0
7	38773039	.	C	T	7	9	16	0	3	19	0	0
7	38775075	.	A	G	10	14	24	0	1	25	0	0
7	38775078	.	C	T	11	13	24	0	1	25	0	0
7	38777082	.	C	T	15	11	26	1	3	30	0	0
7	38779759	.	A	G	21	3	24	1	16	41	0	0
7	38783439	.	C	T	26	19	45	0	0	45	0	0
7	38783644	.	A	G	29	16	45	0	1	46	0	0
7	38783742	.	G	A	22	15	37	0	1	38	0	0
7	38783972	.	T	C	14	11	25	3	1	29	0	0
7	38784327	.	G	A	18	14	32	0	3	35	0	0
7	38784648	.	A	G	40	20	60	0	1	61	0	0
7	38784766	.	C	A	24	22	46	0	2	48	0	0
7	38784786	.	T	A	24	28	52	0	1	53	0	0
7	38784818	.	G	A	31	25	56	0	3	59	0	0
7	38784976	.	T	A	29	18	47	0	0	48	1	0
7	38785069	.	C	T	19	23	42	0	1	43	0	0
7	38785182	.	G	C	3	23	26	0	24	50	0	0
7	38785224	.	G	A	4	23	27	0	21	48	0	0
7	38794090	.	T	G	11	10	21	0	0	22	1	0
7	38794235	.	C	T	15	17	32	0	1	33	0	0
7	38798630	.	A	G	16	15	31	0	0	31	0	0
7	38805508	.	T	G	10	8	18	0	1	20	1	0
7	38805781	.	T	A	7	10	17	1	0	18	0	0
7	38807677	.	T	G	9	11	20	0	0	20	0	0
7	38807714	.	G	A	9	6	15	0	0	15	0	0
7	38807723	.	A	T	12	7	19	0	1	20	0	0
7	38807797	.	G	A	4	7	11	0	0	11	0	0
7	38809865	.	G	T	0	4	4	0	5	9	0	0
7	38810084	.	A	C	6	3	9	0	0	9	0	0
7	38820388	.	A	T	3	3	6	0	0	7	1	0
7	38822327	.	C	T	10	4	14	0	1	15	0	0
7	38822368	.	A	T	6	4	10	0	0	10	0	0
7	38822523	.	G	A	4	5	9	0	1	10	0	0
7	38822528	.	C	A	0	5	5	0	3	8	0	0
7	38822559	.	C	T	2	3	5	0	2	7	0	0
7	38822825	.	T	C	4	3	7	0	0	7	0	0
7	38824387	.	C	G	8	4	12	0	0	12	0	0
7	38824972	.	G	A	5	6	11	0	0	11	0	0
7	38836062	.	G	A	1	5	6	0	0	6	0	0
7	38842502	.	C	T	2	2	4	0	2	6	0	0
7	39100137	.	C	A	5	3	8	0	1	9	0	0
7	39123095	.	G	A	0	6	6	0	10	16	0	0
7	39145653	.	C	T	9	6	15	0	0	15	0	0
7	39153769	.	C	A	3	5	8	0	1	9	0	0
7	39153849	.	G	A	1	5	6	0	0	6	0	0
7	39153975	.	G	A	4	5	9	0	0	9	0	0
7	39154119	.	C	T	3	5	8	0	1	9	0	0
7	39154181	.	A	T	3	10	13	0	0	13	0	0
7	39154272	.	A	T	2	8	10	0	1	11	0	0
7	39155099	.	C	T	5	8	13	0	0	13	0	0
7	39155115	.	T	C	7	9	16	0	0	16	0	0
7	39155344	.	G	A	6	4	10	0	1	11	0	0
7	39155940	.	T	A	5	3	8	0	0	8	0	0
7	39156140	.	T	C	12	11	23	0	0	23	0	0
7	39156161	.	C	T	11	10	21	0	0	21	0	0
7	39156207	.	T	C	10	6	16	0	1	17	0	0
7	39156474	.	T	C	12	8	20	0	1	21	0	0
7	39156553	.	C	A	16	9	25	0	0	25	0	0
7	39156736	.	A	G	11	5	16	0	0	16	0	0
7	39156760	.	A	G	12	11	23	0	3	26	0	0
7	39157175	.	A	T	8	11	19	0	1	20	0	0
7	39157219	.	G	A	1	7	8	0	7	15	0	0
7	39157239	.	C	A	7	7	14	0	0	14	0	0
7	39174052	.	T	C	6	12	18	0	1	19	0	0
7	39174452	.	G	A	1	17	18	0	13	31	0	0
7	39176261	.	G	A	2	13	15	2	16	33	0	0
7	39176444	.	G	A	1	17	18	0	16	34	0	0
7	39176447	.	A	C	15	18	33	0	1	34	0	0
7	39176739	.	A	T	12	4	16	0	1	17	0	0
7	39176863	.	G	A	10	22	32	0	0	32	0	0
7	39176881	.	G	A	23	6	29	0	0	29	0	0
7	39176940	.	A	G	7	5	12	3	0	15	0	0
7	39176957	.	A	G	4	3	7	3	1	11	0	0
7	39176983	.	T	C	3	2	5	0	0	5	0	0
7	39177067	.	A	G	1	2	3	0	2	5	0	0
7	39177729	.	A	G	8	12	20	0	1	21	0	0
7	39177871	.	C	A	5	7	12	0	1	13	0	0
7	39181275	.	A	G	13	13	26	0	1	27	0	0
7	39181318	.	C	T	12	18	30	1	1	32	0	0
7	39181597	.	C	A	17	13	30	0	1	31	0	0
7	39181853	.	C	A	8	13	21	0	0	21	0	0
7	39182265	.	T	C	21	9	30	0	1	31	0	0
7	39182433	.	T	C	13	13	26	0	0	26	0	0
7	39182910	.	G	A	11	11	22	0	1	23	0	0
7	39183045	.	A	G	9	14	23	0	0	23	0	0
7	39482767	.	C	T	1	3	4	0	0	4	0	0
7	39483528	.	T	C	1	4	5	0	0	5	0	0
7	39537983	.	C	G	4	3	7	0	0	7	0	0
7	39538001	.	T	C	4	3	7	0	0	7	0	0
7	39541293	.	T	G	2	2	4	0	0	4	0	0
7	39541452	.	A	C	3	3	6	0	0	6	0	0
7	39552270	.	G	T	4	2	6	0	2	8	0	0
7	39642671	.	G	A	0	4	4	0	3	7	0	0
7	39643001	.	G	A	6	8	14	0	0	14	0	0
7	39643046	.	A	G	1	4	5	0	0	5	0	0
7	39648980	.	A	G	1	3	4	0	1	5	0	0
7	39649070	.	C	T	2	4	6	0	1	7	0	0
7	39654722	.	C	T	3	4	7	0	1	8	0	0
7	39655392	.	T	G	6	2	8	0	0	8	0	0
7	39655524	.	T	A	1	2	3	0	0	4	1	0
7	39655586	.	C	G	5	2	7	0	0	7	0	0
7	39656372	.	C	T	5	3	8	0	1	9	0	0
7	39656394	.	T	A	5	6	11	0	1	12	0	0
7	39656620	.	G	A	11	6	17	0	1	18	0	0
7	39656916	.	C	T	6	4	10	0	0	10	0	0
7	39656950	.	G	T	6	3	9	3	0	12	0	0
7	39657301	.	C	T	2	2	4	0	0	4	0	0
7	39658224	.	A	C	9	16	25	0	1	26	0	0
7	39658293	.	C	A	15	6	21	0	1	22	0	0
7	39658356	.	T	C	6	11	17	0	0	17	0	0
7	39658445	.	C	A	11	9	20	0	0	20	0	0
7	39658730	.	G	T	1	14	15	0	13	28	0	0
7	39658831	.	T	G	11	14	25	0	2	27	0	0
7	39659711	.	A	C	4	2	6	3	0	9	0	0
7	39659738	.	G	A	4	3	7	3	1	11	0	0
7	39659806	.	G	A	6	3	9	0	2	11	0	0
7	39659973	.	A	G	2	2	4	0	1	5	0	0
7	39660054	.	A	C	9	7	16	0	1	17	0	0
7	39660201	.	G	A	19	9	28	0	3	31	0	0
7	39660240	.	A	T	17	19	36	0	1	37	0	0
7	39660249	.	A	C	24	19	43	0	0	43	0	0
7	39670892	.	G	C	5	11	16	0	0	16	0	0
7	39671118	.	T	A	3	7	10	0	0	10	0	0
7	39671281	.	G	A	5	5	10	0	0	10	0	0
7	39671647	.	C	T	7	11	18	0	1	19	0	0
7	39671715	.	A	C	2	7	9	0	0	9	0	0
7	39672054	.	A	T	7	3	10	0	0	10	0	0
7	39672165	.	G	A	6	4	10	0	1	11	0	0
7	39672741	.	A	G	9	8	17	0	0	17	0	0
7	39673095	.	A	G	6	0	6	0	11	17	0	0
7	39673773	.	G	C	1	15	16	0	11	27	0	0
7	39675838	.	A	G	4	6	10	0	1	11	0	0
7	39675961	.	T	A	2	3	5	0	0	5	0	0
7	39676183	.	T	A	5	6	11	0	0	11	0	0
7	39676364	.	T	G	3	2	5	0	1	6	0	0
7	39676365	.	C	T	3	2	5	0	0	6	1	0
7	39676446	.	A	T	9	7	16	0	0	16	0	0
7	39676518	.	A	G	9	8	17	0	2	19	0	0
7	39676833	.	T	C	6	11	17	0	2	19	0	0
7	39676947	.	T	G	13	8	21	0	7	28	0	0
7	39676948	.	T	G	16	7	23	0	6	29	0	0
7	39677347	.	G	A	6	14	20	0	2	22	0	0
7	39677948	.	G	T	14	13	27	0	1	28	0	0
7	39691119	.	G	A	3	5	8	0	10	18	0	0
7	39691357	.	G	A	2	2	4	0	0	4	0	0
7	39693686	.	T	C	6	4	10	0	0	10	0	0
7	39695776	.	A	C	5	3	8	0	0	8	0	0
7	39701913	.	A	C	3	12	15	0	0	15	0	0
7	39702172	.	T	C	5	2	7	0	0	7	0	0
7	39702199	.	C	G	3	2	5	0	0	5	0	0
7	39702337	.	C	A	7	3	10	0	1	11	0	0
7	39702569	.	G	T	1	5	6	0	0	6	0	0
7	39702827	.	C	T	3	4	7	1	0	8	0	0
7	39704063	.	T	A	5	7	12	0	0	12	0	0
7	39704085	.	A	G	6	8	14	0	0	14	0	0
7	39704166	.	A	T	9	3	12	0	1	13	0	0
7	39705178	.	C	T	4	13	17	2	0	19	0	0
7	39705187	.	T	G	4	11	15	2	0	17	0	0
7	39705601	.	A	G	3	5	8	0	1	9	0	0
7	39705683	.	T	A	10	0	10	0	0	10	0	0
7	39731015	.	T	A	1	2	3	0	0	3	0	0
7	39741626	.	C	T	1	1	2	0	0	2	0	0
7	39742820	.	T	G	6	4	10	3	1	14	0	0
7	39742841	.	A	T	8	6	14	1	1	16	0	0
7	39743014	.	A	G	3	0	3	0	5	8	0	0
7	39743358	.	G	A	1	2	3	0	0	3	0	0
7	39744543	.	G	A	10	4	14	0	0	14	0	0
7	39745091	.	T	C	9	7	16	0	1	17	0	0
7	39745110	.	A	T	10	8	18	0	0	18	0	0
7	39748847	.	T	C	6	15	21	0	0	21	0	0
7	39748934	.	A	C	12	10	22	0	0	22	0	0
7	39983885	.	G	A	2	3	5	0	0	5	0	0
7	40023279	.	C	T	1	2	3	0	0	3	0	0
7	40043336	.	T	C	3	3	6	0	0	6	0	0
7	40046715	.	G	A	2	2	4	0	2	6	0	0
7	40046734	.	T	C	2	2	4	0	0	4	0	0
7	40050962	.	C	T	5	3	8	0	0	8	0	0
7	40050986	.	G	C	1	3	4	0	7	11	0	0
7	40053306	.	G	A	6	6	12	0	0	12	0	0
7	40053490	.	T	C	6	6	12	0	3	15	0	0
7	40053537	.	C	T	7	9	16	0	0	16	0	0
7	40053717	.	T	A	5	10	15	0	0	15	0	0
7	40053720	.	G	A	9	4	13	0	1	14	0	0
7	40053978	.	C	T	11	10	21	0	1	22	0	0
7	40054234	.	G	A	5	7	12	0	0	12	0	0
7	40054464	.	A	C	5	4	9	0	0	9	0	0
7	40054814	.	C	T	5	6	11	0	0	11	0	0
7	40054901	.	G	T	7	6	13	0	1	14	0	0
7	40054925	.	G	T	1	9	10	0	9	19	0	0
7	40055080	.	T	C	11	12	23	1	0	24	0	0
7	40055099	.	C	T	11	8	19	1	1	21	0	0
7	40055117	.	T	A	11	6	17	1	0	18	0	0
7	40055178	.	C	G	4	11	15	0	2	18	1	0
7	40055353	.	A	G	2	0	2	0	5	7	0	0
7	40055612	.	C	T	8	9	17	0	0	17	0	0
7	40055628	.	G	A	7	10	17	0	0	17	0	0
7	40055672	.	G	A	4	5	9	0	1	10	0	0
7	40055711	.	A	T	2	5	7	0	1	8	0	0
7	40055844	.	C	T	11	5	16	0	0	16	0	0
7	40055928	.	T	C	7	4	11	0	0	11	0	0
7	40055945	.	C	T	5	7	12	0	0	12	0	0
7	40056060	.	C	T	10	5	15	0	0	15	0	0
7	40056112	.	T	G	13	7	20	0	0	20	0	0
7	40056307	.	C	T	10	9	19	0	0	19	0	0
7	40056353	.	G	A	9	11	20	0	2	22	0	0
7	40056417	.	C	A	9	4	13	0	2	15	0	0
7	40056542	.	A	T	9	10	19	0	0	19	0	0
7	40056587	.	C	T	12	6	18	0	1	19	0	0
7	40056589	.	T	C	12	7	19	0	0	19	0	0
7	40056729	.	A	T	6	7	13	0	1	14	0	0
7	40056851	.	T	C	4	13	17	0	2	19	0	0
7	40056982	.	C	T	4	7	11	0	0	11	0	0
7	40057140	.	G	A	11	8	19	0	0	19	0	0
7	40057393	.	C	T	10	12	22	0	0	22	0	0
7	40057581	.	T	G	10	6	16	0	1	17	0	0
7	40057674	.	A	G	4	2	6	0	0	6	0	0
7	40059207	.	G	A	9	6	15	0	0	15	0	0
7	40059248	.	T	C	12	10	22	0	1	23	0	0
7	40059984	.	T	C	4	0	4	0	0	4	0	0
7	40060083	.	C	T	1	5	6	0	6	12	0	0
7	40060089	.	C	G	8	5	13	0	0	13	0	0
7	40060505	.	C	T	1	2	3	0	0	3	0	0
7	40060665	.	T	A	2	2	4	0	0	4	0	0
7	40063669	.	G	T	3	4	7	0	0	7	0	0
7	40070301	.	G	A	5	1	6	0	1	7	0	0
7	40070531	.	C	G	1	2	3	0	0	3	0	0
7	40071605	.	A	C	2	0	2	0	4	6	0	0
7	40072184	.	T	C	3	3	6	0	0	6	0	0
7	40072371	.	T	G	5	4	9	0	1	10	0	0
7	40074825	.	A	G	6	3	9	0	0	9	0	0
7	40076634	.	T	C	4	0	4	0	10	14	0	0
7	40076782	.	A	G	2	5	7	0	1	8	0	0
7	40081813	.	C	T	1	2	3	0	1	4	0	0
7	40083683	.	T	A	7	16	23	0	2	25	0	0
7	40083762	.	C	G	4	6	10	0	0	10	0	0
7	40083786	.	A	T	3	6	9	0	1	10	0	0
7	40090547	.	T	A	14	11	25	0	2	27	0	0
7	40090602	.	T	C	24	14	38	0	0	38	0	0
7	40091332	.	C	A	6	6	12	0	0	12	0	0
7	40091460	.	C	T	6	2	8	0	1	9	0	0
7	40091552	.	A	T	4	4	8	0	1	9	0	0
7	40091622	.	C	G	9	5	14	0	2	16	0	0
7	40091718	.	G	A	15	12	27	0	1	28	0	0
7	40091749	.	T	C	14	11	25	0	0	25	0	0
7	40091818	.	T	G	9	7	16	0	1	17	0	0
7	40091951	.	A	T	3	2	5	0	2	7	0	0
7	40093987	.	A	T	1	2	3	0	0	3	0	0
7	40093991	.	G	A	1	2	3	0	0	3	0	0
7	40094092	.	T	A	3	4	7	0	0	7	0	0
7	40094104	.	G	T	3	3	6	0	0	6	0	0
7	40094283	.	T	C	3	2	5	0	0	5	0	0
7	40094359	.	C	A	1	4	5	0	1	6	0	0
7	40097105	.	A	C	3	4	7	0	3	10	0	0
7	40097271	.	C	G	7	5	12	0	0	12	0	0
7	40097304	.	C	A	7	4	11	0	3	14	0	0
7	40097313	.	G	C	8	4	12	0	0	12	0	0
7	40097345	.	A	G	5	4	9	0	1	10	0	0
7	40097395	.	A	G	5	3	8	0	0	8	0	0
7	40097396	.	T	C	5	3	8	0	0	8	0	0
7	40097681	.	T	A	2	5	7	0	2	9	0	0
7	40100168	.	A	C	4	3	7	0	0	7	0	0
7	40100294	.	C	T	3	1	4	0	2	6	0	0
7	40100976	.	C	T	5	4	9	0	0	9	0	0
7	40104296	.	T	C	1	3	4	0	0	4	0	0
7	40123112	.	T	A	1	2	3	0	0	3	0	0
7	40123113	.	A	G	1	2	3	0	0	3	0	0
7	40123342	.	T	C	4	5	9	0	0	9	0	0
7	40123350	.	A	T	4	4	8	0	1	9	0	0
7	40123989	.	T	C	4	0	4	0	5	9	0	0
7	40126615	.	T	C	1	3	4	0	0	4	0	0
7	40126829	.	C	T	1	2	3	0	1	4	0	0
7	40126962	.	T	C	2	3	5	0	0	5	0	0
7	40138250	.	G	C	2	3	5	0	0	5	0	0
7	40138268	.	C	T	1	3	4	0	0	4	0	0
7	40138794	.	C	T	2	2	4	0	0	4	0	0
7	40138808	.	C	T	2	2	4	0	0	4	0	0
7	40140399	.	T	C	2	2	4	0	0	4	0	0
7	40144329	.	T	A	1	4	5	0	2	7	0	0
7	40144339	.	C	T	1	3	4	0	1	5	0	0
7	40145032	.	A	T	5	2	7	0	0	7	0	0
7	40183822	.	T	A	1	3	4	0	0	4	0	0
7	40183825	.	G	A	1	2	3	0	0	3	0	0
7	40188991	.	C	T	10	8	18	0	0	18	0	0
7	40197623	.	C	A	7	3	10	0	1	11	0	0
7	40200740	.	G	A	4	4	8	0	0	8	0	0
7	40201016	.	C	T	5	9	14	0	1	15	0	0
7	40201108	.	G	T	5	13	18	0	0	18	0	0
7	40201149	.	G	A	12	3	15	0	0	15	0	0
7	40201200	.	G	A	2	2	4	0	0	4	0	0
7	40201975	.	A	G	10	8	18	0	2	20	0	0
7	40228499	.	A	T	15	12	27	0	0	27	0	0
7	40292834	.	T	C	12	11	23	0	0	23	0	0
7	40318309	.	T	A	15	12	27	0	1	28	0	0
7	40318486	.	A	G	19	1	20	0	15	35	0	0
7	40318580	.	G	T	9	6	15	0	0	15	0	0
7	40318593	.	G	A	8	5	13	0	2	15	0	0
7	40320956	.	A	C	22	9	31	0	0	31	0	0
7	40321174	.	C	T	15	20	35	0	2	37	0	0
7	40321224	.	A	G	20	13	33	0	0	33	0	0
7	40321273	.	G	T	21	15	36	0	1	37	0	0
7	40321443	.	C	T	13	19	32	0	0	32	0	0
7	40460256	.	T	C	14	30	44	0	3	47	0	0
7	40460371	.	C	T	16	22	38	0	0	38	0	0
7	40466026	.	A	G	32	21	53	0	3	56	0	0
7	40471301	.	A	G	27	25	52	0	1	53	0	0
7	40492740	.	T	A	39	26	65	0	0	65	0	0
7	40492764	.	G	C	5	33	38	0	33	71	0	0
7	40492789	.	T	C	44	21	65	0	3	68	0	0
7	40492800	.	G	T	47	18	65	0	1	66	0	0
7	40498598	.	G	A	32	19	51	0	1	52	0	0
7	40498934	.	C	A	24	24	48	0	0	48	0	0
7	40499177	.	A	C	12	9	21	0	1	22	0	0
7	40499182	.	A	G	11	9	20	0	0	20	0	0
7	40537979	.	A	G	1	2	3	0	0	3	0	0
7	40560934	.	G	A	9	12	21	0	1	23	1	0
7	40561366	.	G	A	5	5	10	3	0	13	0	0
7	40562662	.	C	T	0	4	4	0	8	12	0	0
7	40562743	.	G	A	8	5	13	0	0	13	0	0
7	40562757	.	T	G	8	3	11	0	0	11	0	0
7	40567075	.	T	C	10	6	16	0	0	16	0	0
7	40569966	.	G	A	8	4	12	0	1	13	0	0
7	40578658	.	C	G	11	6	17	0	1	18	0	0
7	40584065	.	A	C	6	4	10	0	0	10	0	0
7	40584121	.	A	C	13	9	22	0	1	23	0	0
7	40584148	.	T	C	13	0	13	0	10	23	0	0
7	40584415	.	G	C	12	7	19	0	1	20	0	0
7	40584469	.	C	T	8	10	18	0	0	18	0	0
7	40584988	.	A	C	9	9	18	0	1	19	0	0
7	40585112	.	A	G	2	4	6	0	0	6	0	0
7	40585217	.	T	C	6	7	13	0	0	13	0	0
7	40585546	.	A	T	3	4	7	0	0	7	0	0
7	40602439	.	G	A	4	3	7	0	0	7	0	0
7	40607911	.	T	A	3	2	5	0	0	5	0	0
7	40615603	.	T	C	2	2	4	0	0	4	0	0
7	40615648	.	T	C	3	0	3	0	2	5	0	0
7	40616896	.	A	G	3	2	5	0	1	6	0	0
7	40626449	.	C	T	3	2	5	0	0	5	0	0
7	40645217	.	A	G	3	7	10	0	0	10	0	0
7	40676025	.	G	A	2	2	4	0	0	4	0	0
7	40707966	.	G	A	0	2	2	0	6	8	0	0
7	40708059	.	A	G	2	7	9	0	0	9	0	0
7	40884570	.	T	C	2	4	6	0	0	6	0	0
7	40889981	.	C	T	4	4	8	0	1	9	0	0
7	40890410	.	A	G	3	7	10	0	1	11	0	0
7	40890678	.	G	A	2	9	11	0	1	12	0	0
7	40900772	.	G	A	11	14	25	2	3	31	1	0
7	40900785	.	C	A	1	14	15	1	15	31	0	0
7	40901126	.	A	T	1	2	3	0	0	3	0	0
7	40901425	.	T	A	2	7	9	0	0	9	0	0
7	40901436	.	G	A	2	6	8	0	0	8	0	0
7	40901584	.	A	C	2	6	8	0	0	8	0	0
7	40901592	.	T	C	7	1	8	0	0	8	0	0
7	40901779	.	C	G	9	10	19	0	1	20	0	0
7	40901945	.	T	C	5	8	13	0	0	13	0	0
7	40903292	.	G	A	2	9	11	0	0	11	0	0
7	40903369	.	T	C	0	5	5	0	0	7	2	0
7	40903374	.	T	A	0	5	5	0	0	5	0	0
7	40903491	.	T	A	3	6	9	0	2	11	0	0
7	40903915	.	C	A	0	2	2	0	4	6	0	0
7	40904949	.	G	T	3	3	6	0	0	6	0	0
7	40905164	.	A	T	2	3	5	0	1	6	0	0
7	40905695	.	A	T	8	12	20	0	1	21	0	0
7	40905774	.	C	T	0	11	11	0	10	21	0	0
7	40906286	.	T	C	6	8	14	0	0	14	0	0
7	40906377	.	T	C	8	3	11	0	0	11	0	0
7	40906415	.	T	A	4	5	9	0	0	9	0	0
7	40906516	.	C	A	1	2	3	0	4	7	0	0
7	40931758	.	G	C	3	4	7	0	1	8	0	0
7	40931873	.	T	A	6	5	11	0	1	12	0	0
7	40931874	.	C	T	0	6	6	0	6	12	0	0
7	40935308	.	C	T	5	6	11	0	0	11	0	0
7	40942588	.	G	C	6	5	11	0	0	11	0	0
7	40951391	.	G	A	7	6	13	0	1	14	0	0
7	40989156	.	A	G	6	2	8	0	0	8	0	0
7	40990473	.	G	C	3	7	10	0	0	10	0	0
7	40990589	.	T	A	2	5	7	0	0	7	0	0
7	40993298	.	G	A	2	6	8	0	0	8	0	0
7	40993422	.	G	A	7	5	12	0	0	12	0	0
7	41008618	.	T	C	15	7	22	0	2	24	0	0
7	41008856	.	C	T	0	10	10	0	13	23	0	0
7	41009217	.	C	T	1	17	18	0	17	35	0	0
7	41009797	.	T	A	13	22	35	0	4	39	0	0
7	41012081	.	A	T	10	17	27	0	2	29	0	0
7	41012505	.	C	T	1	8	9	0	7	16	0	0
7	41014175	.	C	T	4	8	12	0	1	13	0	0
7	41082391	.	T	G	4	4	8	0	0	8	0	0
7	41082802	.	G	A	2	6	8	0	0	8	0	0
7	41082931	.	C	T	4	3	7	0	0	7	0	0
7	41147792	.	A	G	10	2	12	0	13	25	0	0
7	41157531	.	G	C	17	22	39	0	1	40	0	0
7	41157735	.	T	C	19	22	41	0	2	43	0	0
7	41157805	.	C	A	18	19	37	0	3	40	0	0
7	41157997	.	G	A	15	11	26	0	0	26	0	0
7	41158057	.	C	T	10	13	23	0	1	24	0	0
7	41223561	.	C	T	3	2	5	0	1	6	0	0
7	41238313	.	C	T	2	6	8	0	0	8	0	0
7	41238671	.	T	C	5	5	10	0	0	10	0	0
7	41249282	.	A	G	6	4	10	0	0	10	0	0
7	41249613	.	A	G	5	0	5	0	5	10	0	0
7	41250813	.	T	C	3	3	6	0	0	6	0	0
7	41255443	.	A	T	9	11	20	0	0	20	0	0
7	41258015	.	T	C	6	6	12	0	0	12	0	0
7	41261343	.	C	A	16	8	24	0	3	27	0	0
7	41262058	.	T	G	7	14	21	0	0	21	0	0
7	41262277	.	A	G	5	11	16	0	0	16	0	0
7	41262361	.	G	A	7	9	16	0	0	16	0	0
7	41263277	.	G	A	1	8	9	0	9	18	0	0
7	41267424	.	C	T	9	15	24	0	0	24	0	0
7	41269653	.	C	G	15	9	24	0	0	24	0	0
7	41273527	.	T	C	7	8	15	0	1	16	0	0
7	41273889	.	T	C	12	13	25	0	0	25	0	0
7	41274080	.	T	G	7	13	20	0	0	20	0	0
7	41274258	.	T	C	10	8	18	0	0	18	0	0
7	41274261	.	A	G	11	0	11	0	9	20	0	0
7	41274802	.	C	A	17	10	27	0	3	30	0	0
7	41274896	.	A	C	12	17	29	0	2	31	0	0
7	41274916	.	A	C	12	14	26	0	1	27	0	0
7	41274943	.	T	A	14	16	30	0	2	32	0	0
7	41313853	.	C	A	1	5	6	0	0	6	0	0
7	41313894	.	G	C	2	5	7	0	0	7	0	0
7	41313920	.	C	A	2	2	4	0	0	4	0	0
7	41314900	.	G	T	5	6	11	0	1	13	1	0
7	41316722	.	T	G	7	3	10	0	0	10	0	0
7	41318020	.	A	G	1	2	3	0	0	3	0	0
7	41318023	.	A	T	1	3	4	0	0	4	0	0
7	41318087	.	A	T	1	2	3	0	0	3	0	0
7	41322440	.	G	A	3	3	6	0	0	6	0	0
7	41323119	.	T	G	1	3	4	0	0	4	0	0
7	41326482	.	A	G	1	2	3	0	0	3	0	0
7	41329433	.	G	C	2	3	5	0	1	6	0	0
7	41329736	.	C	T	2	3	5	0	0	5	0	0
7	41329778	.	A	G	2	0	2	0	5	7	0	0
7	41330106	.	A	T	3	2	5	0	0	5	0	0
7	41330310	.	T	C	1	2	3	0	0	3	0	0
7	41330347	.	C	T	1	2	3	0	0	3	0	0
7	41330360	.	A	G	2	2	4	0	0	4	0	0
7	41330517	.	A	C	5	3	8	0	0	8	0	0
7	41330650	.	C	A	3	2	5	0	0	5	0	0
7	41330664	.	T	C	4	3	7	0	0	7	0	0
7	41340641	.	T	C	2	3	5	0	0	5	0	0
7	41340840	.	C	A	3	2	5	0	0	5	0	0
7	41344440	.	T	A	4	4	8	0	0	8	0	0
7	41345105	.	C	T	3	2	5	0	0	5	0	0
7	41345123	.	C	T	1	2	3	0	1	4	0	0
7	41345282	.	A	C	5	4	9	0	0	9	0	0
7	41345375	.	T	C	3	3	6	0	0	6	0	0
7	41345393	.	A	T	1	2	3	0	0	3	0	0
7	41345463	.	T	G	2	2	4	0	1	5	0	0
7	41345828	.	G	T	9	3	12	0	1	13	0	0
7	41347123	.	A	G	5	0	5	0	4	9	0	0
7	41347138	.	C	T	5	4	9	0	0	9	0	0
7	41347642	.	T	C	6	6	12	0	1	13	0	0
7	41347813	.	C	T	3	5	8	0	0	8	0	0
7	41349128	.	C	T	2	6	8	0	9	17	0	0
7	41349454	.	G	T	10	11	21	0	0	21	0	0
7	41350424	.	A	G	4	3	7	0	0	7	0	0
7	41352145	.	T	A	6	3	9	0	0	9	0	0
7	41353258	.	G	A	6	2	8	0	0	8	0	0
7	41355308	.	T	C	3	2	5	0	0	5	0	0
7	41356547	.	C	T	2	6	8	0	0	8	0	0
7	41357331	.	C	T	4	4	8	0	0	8	0	0
7	41357602	.	G	A	3	4	7	0	0	7	0	0
7	41357623	.	G	C	3	4	7	0	0	7	0	0
7	41359972	.	C	T	3	5	8	0	0	8	0	0
7	41359987	.	A	T	3	2	5	0	0	5	0	0
7	41360436	.	T	C	1	2	3	0	0	3	0	0
7	41362945	.	A	G	1	4	5	0	0	5	0	0
7	41362984	.	G	A	2	2	4	0	0	4	0	0
7	41364641	.	A	G	1	2	3	0	0	3	0	0
7	41370434	.	G	A	1	2	3	0	0	3	0	0
7	41401851	.	C	T	3	6	9	0	1	10	0	0
7	41401881	.	T	C	4	4	8	0	0	8	0	0
7	41402040	.	A	G	2	3	5	0	0	5	0	0
7	41402943	.	C	G	3	6	9	0	1	10	0	0
7	41402988	.	G	C	2	6	8	0	0	8	0	0
7	41404081	.	C	T	13	4	17	0	1	18	0	0
7	41404090	.	T	C	9	4	13	0	2	15	0	0
7	41404552	.	G	A	7	8	15	0	0	15	0	0
7	41404564	.	A	G	9	6	15	0	0	15	0	0
7	41405926	.	A	G	8	5	13	0	0	13	0	0
7	41406005	.	G	A	6	3	9	0	1	10	0	0
7	41413530	.	G	A	7	3	10	0	0	10	0	0
7	41413760	.	C	T	2	6	8	0	0	8	0	0
7	41413781	.	A	T	2	4	6	0	1	7	0	0
7	41419183	.	G	T	5	4	9	0	0	9	0	0
7	41422123	.	C	A	2	2	4	0	0	4	0	0
7	41422318	.	C	G	3	4	7	0	0	7	0	0
7	41430417	.	T	C	5	4	9	0	1	10	0	0
7	41431901	.	A	T	2	4	6	0	1	7	0	0
7	41431916	.	T	C	2	4	6	0	1	7	0	0
7	41432039	.	T	C	4	5	9	0	2	11	0	0
7	41432220	.	G	A	0	6	6	0	7	13	0	0
7	41432324	.	T	A	4	5	9	0	0	9	0	0
7	41432676	.	T	C	11	12	23	0	0	23	0	0
7	41432732	.	A	T	5	12	17	0	2	19	0	0
7	41432906	.	T	C	9	7	16	0	0	16	0	0
7	41433244	.	A	G	5	0	5	0	7	12	0	0
7	41433390	.	T	A	7	5	12	0	0	12	0	0
7	41436811	.	T	A	5	3	8	0	0	8	0	0
7	41436902	.	A	G	7	4	11	0	0	11	0	0
7	41436907	.	G	A	7	6	13	0	0	13	0	0
7	41437342	.	A	C	12	12	24	0	2	26	0	0
7	41437363	.	A	G	10	14	24	0	0	24	0	0
7	41437623	.	C	A	18	8	26	0	0	26	0	0
7	41437715	.	T	G	5	12	17	0	1	18	0	0
7	41437827	.	C	A	0	5	5	0	16	21	0	0
7	41437948	.	G	A	9	12	21	0	1	22	0	0
7	41438036	.	A	C	7	5	12	0	1	13	0	0
7	41438417	.	T	A	2	6	8	0	0	8	0	0
7	41438502	.	C	T	1	5	6	0	4	10	0	0
7	41438676	.	G	T	4	6	10	0	0	10	0	0
7	41438677	.	T	C	4	6	10	0	0	10	0	0
7	41438826	.	C	T	0	8	8	0	12	20	0	0
7	41438871	.	C	T	2	8	10	0	8	18	0	0
7	41438896	.	C	T	0	2	2	0	6	8	0	0
7	41438970	.	G	A	8	10	18	0	0	18	0	0
7	41439411	.	C	T	1	12	13	0	11	24	0	0
7	41443186	.	C	T	0	4	4	0	4	8	0	0
7	41452225	.	T	C	5	0	5	0	7	12	0	0
7	41491635	.	T	G	4	4	8	0	1	9	0	0
7	41491652	.	C	T	6	4	10	0	0	10	0	0
7	41491701	.	A	T	9	3	12	0	0	12	0	0
7	41496791	.	G	A	11	10	21	0	0	21	0	0
7	41498075	.	T	C	5	6	11	0	0	11	0	0
7	41500538	.	A	G	14	4	18	0	0	18	0	0
7	41500676	.	G	A	7	2	9	0	0	9	0	0
7	41501061	.	A	G	2	6	8	0	1	9	0	0
7	41501124	.	A	G	2	3	5	0	2	7	0	0
7	41506677	.	A	G	7	4	11	0	0	11	0	0
7	41506683	.	T	C	6	3	9	0	0	9	0	0
7	41511558	.	T	C	3	4	7	0	0	7	0	0
7	41511626	.	C	T	4	6	10	0	0	10	0	0
7	41511804	.	T	C	2	3	5	0	1	6	0	0
7	41511939	.	A	C	1	4	5	0	0	5	0	0
7	41517442	.	C	G	1	7	8	0	0	8	0	0
7	41517467	.	A	G	2	6	8	0	0	8	0	0
7	41517593	.	G	T	4	7	11	0	0	11	0	0
7	41517607	.	T	A	4	5	9	0	0	9	0	0
7	41517659	.	G	A	4	7	11	0	1	12	0	0
7	41517796	.	T	C	3	2	5	0	0	5	0	0
7	41517909	.	T	A	5	6	11	0	0	11	0	0
7	41517978	.	A	G	5	13	18	0	0	18	0	0
7	41518033	.	G	A	7	11	18	0	0	18	0	0
7	41518109	.	C	A	9	7	16	0	0	16	0	0
7	41518146	.	G	A	8	6	14	0	0	14	0	0
7	41518147	.	C	G	9	6	15	0	0	15	0	0
7	41518217	.	C	A	1	4	5	2	6	13	0	0
7	41518328	.	T	G	13	9	22	0	1	23	0	0
7	41518420	.	G	C	7	4	11	0	0	11	0	0
7	41518721	.	G	T	6	8	14	0	1	15	0	0
7	41518727	.	C	T	5	7	12	0	2	14	0	0
7	41518871	.	T	G	11	3	14	0	0	14	0	0
7	41518875	.	G	A	10	2	12	0	0	12	0	0
7	41519283	.	A	C	5	4	9	0	0	9	0	0
7	41519284	.	G	A	5	4	9	0	0	9	0	0
7	41519390	.	A	G	1	3	4	0	0	4	0	0
7	41574673	.	C	G	2	3	5	0	0	5	0	0
7	41627738	.	C	T	0	3	3	0	4	7	0	0
7	41627745	.	C	T	3	3	6	0	1	7	0	0
7	41627849	.	G	C	2	2	4	0	0	4	0	0
7	41627885	.	T	G	1	2	3	0	0	3	0	0
7	41633945	.	C	A	1	2	3	0	0	3	0	0
7	41633954	.	T	A	1	2	3	0	0	3	0	0
7	41714059	.	C	T	0	4	4	0	2	6	0	0
7	41714076	.	A	T	3	2	5	0	1	6	0	0
7	41714140	.	C	T	1	6	7	0	4	11	0	0
7	41714196	.	T	A	10	6	16	0	0	16	0	0
7	41714205	.	C	T	9	6	15	0	0	15	0	0
7	41714440	.	T	C	14	6	20	0	0	20	0	0
7	41714453	.	T	C	10	10	20	0	0	20	0	0
7	41714481	.	C	T	6	12	18	0	0	18	0	0
7	41714557	.	T	C	7	0	7	1	5	13	0	0
7	41714923	.	G	A	9	3	12	0	1	13	0	0
7	41715288	.	C	T	0	4	4	0	2	6	0	0
7	41715446	.	G	A	9	3	12	0	0	12	0	0
7	41715594	.	T	A	6	9	15	0	1	16	0	0
7	41715721	.	T	A	6	9	15	0	1	16	0	0
7	41715794	.	C	T	1	6	7	0	3	10	0	0
7	41726186	.	C	T	6	4	10	0	1	11	0	0
7	41726339	.	C	T	1	4	5	0	6	11	0	0
7	41726355	.	G	T	5	5	10	0	0	10	0	0
7	41726580	.	A	C	3	2	5	1	0	6	0	0
7	41748916	.	G	T	2	3	5	0	1	6	0	0
7	41749093	.	A	T	6	2	8	0	1	9	0	0
7	41749150	.	A	G	8	5	13	0	0	13	0	0
7	41749382	.	C	T	9	4	13	0	0	13	0	0
7	41751146	.	C	T	6	7	13	0	0	13	0	0
7	41751510	.	T	C	5	6	11	0	0	11	0	0
7	41751671	.	C	T	13	7	20	0	0	20	0	0
7	41752210	.	A	G	14	5	19	2	0	21	0	0
7	41752422	.	G	T	19	3	22	1	0	23	0	0
7	41752440	.	A	C	17	6	23	1	0	24	0	0
7	41752463	.	A	G	19	0	19	1	9	29	0	0
7	41752497	.	C	A	18	7	25	5	0	30	0	0
7	41752507	.	C	G	19	5	24	6	1	31	0	0
7	41752631	.	A	G	20	10	30	0	1	31	0	0
7	41752662	.	G	A	23	8	31	0	1	32	0	0
7	41752892	.	T	A	4	4	8	0	0	8	0	0
7	41753093	.	T	A	7	1	8	0	0	8	0	0
7	41753195	.	A	T	5	3	8	0	1	9	0	0
7	41757730	.	G	A	31	16	47	0	1	48	0	0
7	41773951	.	T	G	16	17	33	0	2	35	0	0
7	41774020	.	A	G	12	24	36	0	1	37	0	0
7	41774035	.	G	A	12	23	35	0	2	37	0	0
7	41774125	.	A	G	17	22	39	0	2	41	0	0
7	41780925	.	A	T	12	7	19	0	6	25	0	0
7	41791391	.	A	G	6	4	10	0	0	10	0	0
7	41791469	.	T	C	12	11	23	0	0	23	0	0
7	41791538	.	G	A	10	9	19	0	5	24	0	0
7	41791857	.	C	T	17	11	28	1	1	30	0	0
7	41791920	.	C	T	8	17	25	0	0	25	0	0
7	41805215	.	G	T	6	18	24	0	0	24	0	0
7	41805518	.	C	T	4	5	9	0	0	9	0	0
7	41805881	.	G	A	7	8	15	0	0	15	0	0
7	41873215	.	A	T	10	7	17	0	1	18	0	0
7	41873256	.	C	T	17	13	30	0	1	31	0	0
7	41873257	.	T	G	17	12	29	0	2	31	0	0
7	41873368	.	T	A	22	7	29	0	1	30	0	0
7	41873426	.	T	C	12	8	20	0	1	21	0	0
7	41873503	.	A	G	20	13	33	0	2	35	0	0
7	41873554	.	A	T	19	29	48	0	0	49	1	0
7	41873691	.	T	C	16	17	33	0	0	33	0	0
7	41875951	.	T	C	21	19	40	0	0	40	0	0
7	41891612	.	C	G	1	4	5	0	0	5	0	0
7	41896385	.	A	G	5	6	11	0	2	13	0	0
7	41899051	.	A	C	5	4	9	0	2	11	0	0
7	41899352	.	C	T	4	5	9	0	0	9	0	0
7	41899426	.	C	A	4	6	10	0	0	10	0	0
7	41899674	.	T	C	7	5	12	0	0	12	0	0
7	41900180	.	C	T	3	3	6	0	0	6	0	0
7	41900215	.	T	C	9	4	13	0	0	13	0	0
7	41900402	.	G	C	3	4	7	0	0	7	0	0
7	41901094	.	A	G	7	3	10	0	1	11	0	0
7	41901355	.	A	G	9	14	23	0	0	23	0	0
7	41903633	.	T	A	12	17	29	0	3	32	0	0
7	41903681	.	C	T	20	18	38	0	1	39	0	0
7	41903907	.	A	G	6	6	12	0	0	12	0	0
7	41904152	.	A	G	31	21	52	0	0	52	0	0
7	41904520	.	G	A	23	32	55	0	2	57	0	0
7	41911604	.	C	T	3	16	19	0	27	46	0	0
7	41912618	.	T	C	21	5	26	0	0	26	0	0
7	41957814	.	G	A	4	3	7	0	0	7	0	0
7	41995046	.	T	C	6	12	18	0	5	23	0	0
7	42068201	.	C	T	2	4	6	1	0	7	0	0
7	42096376	.	C	A	7	8	15	0	0	15	0	0
7	42096378	.	A	G	7	8	15	0	0	15	0	0
7	42096413	.	C	T	0	5	5	0	8	13	0	0
7	42125466	.	G	A	7	6	13	0	1	14	0	0
7	42125480	.	C	G	7	6	13	0	0	13	0	0
7	42161814	.	G	A	2	2	4	0	2	6	0	0
7	42203869	.	T	C	5	2	7	0	0	7	0	0
7	42229877	.	C	T	4	5	9	0	0	9	0	0
7	42255966	.	C	T	6	7	13	0	1	14	0	0
7	42267249	.	C	T	4	5	9	0	2	11	0	0
7	42267339	.	T	C	8	5	13	0	1	14	0	0
7	42323699	.	G	C	1	7	8	0	6	14	0	0
7	42338816	.	A	G	14	11	25	3	0	28	0	0
7	42345361	.	G	T	5	10	15	0	0	15	0	0
7	42345681	.	T	A	16	13	29	0	1	30	0	0
7	42345782	.	G	A	3	2	5	0	0	5	0	0
7	42546969	.	G	A	1	2	3	0	0	3	0	0
7	43174642	.	G	A	11	6	17	0	1	18	0	0
7	43309851	.	T	G	5	10	15	0	0	15	0	0
7	43760755	.	T	C	24	7	31	0	6	38	1	0
7	43760822	.	G	A	14	13	27	0	2	29	0	0
7	43760875	.	T	A	12	10	22	0	1	23	0	0
7	43760881	.	G	A	6	13	19	0	1	21	1	0
7	43761810	.	T	A	9	9	18	0	2	20	0	0
7	43761966	.	C	T	0	14	14	0	9	23	0	0
7	43765189	.	A	G	16	7	23	0	1	24	0	0
7	43765197	.	A	G	18	7	25	0	0	25	0	0
7	43765348	.	G	A	15	12	27	0	0	27	0	0
7	43775054	.	G	A	9	11	20	0	1	21	0	0
7	43778690	.	C	G	14	13	27	0	1	29	1	0
7	43781554	.	G	T	7	9	16	0	2	18	0	0
7	43787480	.	C	G	5	4	9	0	1	10	0	0
7	44469702	.	A	C	1	4	5	0	0	5	0	0
7	44587246	.	A	C	1	1	2	0	9	11	0	0
7	44587249	.	A	C	1	0	1	0	10	11	0	0
7	44588458	.	A	G	9	3	12	0	2	14	0	0
7	44676882	.	A	G	6	2	8	0	1	9	0	0
7	44960343	.	A	G	5	2	7	0	0	7	0	0
7	45400754	.	A	T	2	2	4	0	0	4	0	0
7	45400790	.	C	T	11	10	21	0	0	21	0	0
7	45402452	.	C	T	20	21	41	0	1	42	0	0
7	45402887	.	C	A	18	25	43	0	1	44	0	0
7	45402989	.	C	T	17	18	35	0	4	39	0	0
7	45403244	.	C	T	19	16	35	0	3	38	0	0
7	45403292	.	G	A	21	14	35	0	3	38	0	0
7	45403294	.	A	T	18	15	33	0	6	39	0	0
7	45403360	.	T	G	10	19	29	0	2	31	0	0
7	45403370	.	A	T	10	19	29	0	0	29	0	0
7	45403416	.	C	T	18	8	26	1	0	27	0	0
7	45403735	.	G	A	0	2	2	0	7	9	0	0
7	45403793	.	G	A	3	8	11	0	0	11	0	0
7	45404490	.	C	T	5	9	14	0	0	14	0	0
7	45404554	.	A	T	3	9	12	0	0	12	0	0
7	45404559	.	G	A	2	9	11	0	0	11	0	0
7	45405163	.	C	T	12	11	23	0	0	23	0	0
7	45405179	.	G	T	12	13	25	0	0	25	0	0
7	45405839	.	G	T	8	7	15	0	0	15	0	0
7	45405871	.	A	C	2	8	10	0	1	11	0	0
7	45405992	.	C	T	6	6	12	0	0	12	0	0
7	45971454	.	A	T	6	7	13	0	0	13	0	0
7	46004948	.	T	G	9	7	16	0	0	16	0	0
7	46004971	.	C	G	10	9	19	0	2	21	0	0
7	46004991	.	C	G	9	1	10	0	7	17	0	0
7	46373295	.	A	G	2	6	8	0	0	8	0	0
7	46374272	.	T	A	5	4	9	0	0	9	0	0
7	46374390	.	A	G	4	6	10	0	0	10	0	0
7	46430530	.	G	A	9	5	14	0	0	14	0	0
7	46430696	.	T	A	9	7	16	0	2	18	0	0
7	46430847	.	C	G	9	5	14	0	2	16	0	0
7	46431108	.	T	A	7	10	17	0	2	19	0	0
7	46431256	.	C	A	12	6	18	0	0	18	0	0
7	46431273	.	C	G	8	7	15	0	2	17	0	0
7	46431319	.	A	G	10	7	17	0	0	17	0	0
7	46431577	.	G	A	17	10	27	0	0	27	0	0
7	46486048	.	C	T	9	12	21	0	1	22	0	0
7	46486244	.	A	C	15	14	29	0	0	29	0	0
7	46486629	.	G	A	1	16	17	0	12	29	0	0
7	46486719	.	G	T	18	7	25	0	1	26	0	0
7	46487322	.	C	T	16	13	29	0	0	29	0	0
7	46728687	.	G	A	4	3	7	0	0	7	0	0
7	46728721	.	A	C	4	0	4	0	5	9	0	0
7	46728791	.	A	C	9	5	14	1	1	16	0	0
7	46728964	.	A	C	1	2	3	0	0	3	0	0
7	46729545	.	C	T	1	10	11	0	6	17	0	0
7	46730178	.	A	T	6	2	8	0	0	8	0	0
7	46730199	.	A	C	6	0	6	0	3	9	0	0
7	46730469	.	C	T	12	14	26	0	1	27	0	0
7	46730705	.	C	T	6	6	12	0	1	13	0	0
7	46730754	.	G	A	3	3	6	0	1	7	0	0
7	46730820	.	T	C	5	0	5	0	11	16	0	0
7	46731141	.	C	T	4	8	12	0	0	12	0	0
7	46731669	.	T	C	4	2	6	0	0	6	0	0
7	46732134	.	G	A	6	3	9	0	1	10	0	0
7	46732365	.	C	T	2	2	4	0	0	4	0	0
7	46732680	.	G	A	1	2	3	0	0	3	0	0
7	47265898	.	G	A	2	5	7	0	3	10	0	0
7	47265934	.	G	A	1	3	4	0	3	7	0	0
7	47312817	.	C	T	2	3	5	0	0	5	0	0
7	47320002	.	G	T	2	3	5	0	0	5	0	0
7	47323685	.	C	T	4	4	8	0	0	8	0	0
7	47358452	.	A	G	6	0	6	1	4	11	0	0
7	47410829	.	C	T	4	8	12	0	1	13	0	0
7	47411358	.	C	A	3	5	8	0	0	8	0	0
7	47411783	.	G	T	3	3	6	0	0	6	0	0
7	47411837	.	T	G	5	0	5	0	7	12	0	0
7	47411838	.	G	A	5	7	12	0	0	12	0	0
7	47411934	.	C	T	11	4	15	0	0	15	0	0
7	47411962	.	C	A	3	7	10	0	0	10	0	0
7	47411977	.	C	T	7	3	10	0	0	10	0	0
7	47412000	.	T	A	7	6	13	0	0	13	0	0
7	47412040	.	C	T	11	6	17	0	0	17	0	0
7	47412203	.	A	C	13	5	18	0	1	19	0	0
7	47412215	.	C	T	10	5	15	0	0	15	0	0
7	47412366	.	C	T	6	2	8	0	1	9	0	0
7	47412373	.	C	T	2	6	8	0	0	8	0	0
7	47412447	.	T	A	5	6	11	0	0	11	0	0
7	47412525	.	C	T	1	3	4	0	0	4	0	0
7	47413691	.	A	T	6	2	8	0	0	8	0	0
7	47414174	.	C	T	7	3	10	0	0	10	0	0
7	47414786	.	T	A	3	2	5	0	1	6	0	0
7	47415036	.	G	A	8	5	13	0	0	13	0	0
7	47415257	.	A	T	6	5	11	0	0	11	0	0
7	47415272	.	C	T	3	5	8	0	0	8	0	0
7	47416075	.	A	C	4	8	12	0	1	13	0	0
7	47416473	.	G	A	9	10	19	1	0	20	0	0
7	47417002	.	C	A	13	5	18	0	0	18	0	0
7	47417080	.	T	C	13	2	15	0	1	16	0	0
7	47417195	.	T	A	3	4	7	0	1	8	0	0
7	47417810	.	C	T	8	8	16	0	1	17	0	0
7	47417821	.	C	T	8	8	16	0	0	16	0	0
7	47418320	.	C	T	9	15	24	0	1	25	0	0
7	47418526	.	T	C	16	14	30	0	2	32	0	0
7	47418657	.	G	A	11	16	27	0	2	29	0	0
7	47418697	.	C	A	10	19	29	0	0	29	0	0
7	47418847	.	T	A	11	8	19	0	0	19	0	0
7	47419070	.	T	A	9	11	20	0	1	21	0	0
7	47419114	.	A	C	12	5	17	0	2	19	0	0
7	47419842	.	G	A	13	13	26	0	1	27	0	0
7	47420208	.	A	G	11	12	23	0	1	24	0	0
7	47524444	.	T	C	3	5	8	0	0	8	0	0
7	47563381	.	A	T	2	4	6	0	0	6	0	0
7	47563614	.	C	A	2	2	4	0	0	4	0	0
7	47563853	.	G	A	2	4	6	0	0	6	0	0
7	47596707	.	T	C	2	0	2	0	2	4	0	0
7	47628203	.	G	A	1	3	4	0	0	4	0	0
7	47691435	.	A	G	1	2	3	0	0	3	0	0
7	47691483	.	A	G	1	2	3	0	0	3	0	0
7	48041808	.	A	T	8	9	17	0	1	18	0	0
7	48041940	.	G	A	8	5	13	0	0	13	0	0
7	48041967	.	G	A	8	4	12	0	0	12	0	0
7	48042195	.	G	A	4	5	9	0	0	9	0	0
7	48042390	.	G	A	3	4	7	0	0	7	0	0
7	48042456	.	A	G	3	3	6	0	1	7	0	0
7	48054990	.	G	A	5	5	10	0	0	10	0	0
7	48063519	.	A	G	5	4	9	1	0	10	0	0
7	48071605	.	T	C	2	4	6	0	0	6	0	0
7	48172753	.	A	G	2	4	6	0	1	7	0	0
7	48240935	.	T	C	1	3	4	0	1	5	0	0
7	48241629	.	T	A	1	2	3	0	0	3	0	0
7	48253537	.	G	A	2	2	4	0	0	4	0	0
7	48288848	.	A	G	15	27	42	0	3	45	0	0
7	48291166	.	G	A	23	19	42	0	0	42	0	0
7	48295850	.	A	T	20	12	32	0	0	32	0	0
7	48295902	.	G	T	10	16	26	0	0	26	0	0
7	48295910	.	C	T	12	20	32	0	0	32	0	0
7	48296167	.	G	T	1	2	3	0	0	3	0	0
7	48300607	.	G	A	1	3	4	0	4	8	0	0
7	48300621	.	T	C	3	5	8	0	0	8	0	0
7	48300648	.	G	C	6	4	10	0	0	10	0	0
7	48302159	.	A	C	5	7	12	0	1	13	0	0
7	48303198	.	T	A	6	2	8	0	0	8	0	0
7	48303216	.	G	A	6	2	8	0	0	8	0	0
7	48303273	.	A	T	2	2	4	0	0	4	0	0
7	48303274	.	A	C	2	2	4	0	0	4	0	0
7	48303814	.	G	A	0	7	7	0	9	16	0	0
7	48303838	.	C	T	7	7	14	0	2	16	0	0
7	48303954	.	T	C	10	12	22	0	0	22	0	0
7	48304396	.	G	A	2	6	8	0	1	9	0	0
7	48304419	.	A	G	2	6	8	0	1	9	0	0
7	48304457	.	T	G	6	5	11	0	1	12	0	0
7	48304548	.	A	T	8	6	14	0	0	14	0	0
7	48304554	.	G	A	5	9	14	0	2	16	0	0
7	48304589	.	A	T	8	5	13	0	0	13	0	0
7	48334796	.	C	T	1	9	10	0	1	11	0	0
7	48342482	.	G	C	5	2	7	0	0	7	0	0
7	48342575	.	C	T	2	3	5	0	0	5	0	0
7	48347562	.	G	T	11	5	16	0	1	17	0	0
7	48347680	.	A	C	10	12	22	0	0	22	0	0
7	48348003	.	G	A	6	13	19	0	1	20	0	0
7	48348148	.	T	A	2	5	7	0	0	7	0	0
7	48348149	.	C	A	2	5	7	0	0	7	0	0
7	48348335	.	G	A	5	10	15	0	1	16	0	0
7	48348554	.	G	A	6	7	13	0	1	14	0	0
7	48358792	.	A	T	5	7	12	0	0	12	0	0
7	48361334	.	C	A	7	6	13	0	1	14	0	0
7	48363752	.	G	A	4	7	11	0	0	11	0	0
7	48368758	.	C	T	0	4	4	0	5	9	0	0
7	48368821	.	G	A	6	9	15	0	0	15	0	0
7	48368977	.	T	G	4	3	7	0	0	7	0	0
7	48368995	.	G	A	4	5	9	0	2	11	0	0
7	48369999	.	C	T	4	6	10	0	0	10	0	0
7	48375665	.	G	C	3	0	3	0	3	6	0	0
7	48375704	.	A	G	1	4	5	0	0	6	1	0
7	48391532	.	C	T	1	6	7	0	0	7	0	0
7	48460315	.	C	T	11	10	21	0	1	22	0	0
7	48460497	.	G	A	1	10	11	0	9	20	0	0
7	48482286	.	C	A	10	5	15	0	1	16	0	0
7	48482370	.	C	T	3	6	9	0	0	9	0	0
7	48484269	.	T	C	13	24	37	0	2	39	0	0
7	48484307	.	G	A	1	17	18	0	12	30	0	0
7	48484416	.	G	A	6	13	19	0	1	20	0	0
7	48484736	.	A	G	8	15	23	0	0	23	0	0
7	48663980	.	T	A	3	6	9	0	0	9	0	0
7	48664850	.	T	C	3	1	4	0	3	7	0	0
7	48664862	.	C	T	5	4	9	0	0	9	0	0
7	48720187	.	G	T	1	3	4	0	0	4	0	0
7	48720214	.	T	A	2	2	4	0	0	4	0	0
7	48721692	.	C	T	1	4	5	0	6	11	0	0
7	48788389	.	G	C	6	0	6	0	6	12	0	0
7	48788498	.	T	A	3	9	12	0	0	12	0	0
7	48788790	.	A	T	3	2	5	0	0	5	0	0
7	48788791	.	T	A	3	2	5	0	0	5	0	0
7	48788873	.	G	A	6	4	10	0	0	10	0	0
7	48788910	.	C	T	3	4	7	0	1	8	0	0
7	48793253	.	C	T	1	3	4	0	0	4	0	0
7	48800907	.	G	A	3	2	5	0	0	5	0	0
7	48804984	.	G	A	2	2	4	0	0	4	0	0
7	48805626	.	C	A	6	4	10	0	0	10	0	0
7	48809280	.	A	G	3	4	7	0	0	7	0	0
7	48809290	.	A	G	3	0	3	0	6	9	0	0
7	48811446	.	C	T	11	6	17	0	0	17	0	0
7	48818286	.	C	G	7	0	7	0	9	16	0	0
7	48818563	.	T	C	8	19	27	0	0	27	0	0
7	48821362	.	C	T	9	10	19	0	0	19	0	0
7	48829728	.	A	G	5	6	11	0	1	12	0	0
7	48829926	.	A	T	2	4	6	0	0	6	0	0
7	49020658	.	G	A	6	5	11	0	0	11	0	0
7	49046764	.	C	T	5	2	7	0	0	7	0	0
7	49051870	.	G	A	6	6	12	0	1	13	0	0
7	49051922	.	G	A	6	3	9	0	0	9	0	0
7	49051927	.	G	A	6	2	8	0	2	10	0	0
7	49052044	.	T	A	8	7	15	0	0	15	0	0
7	49052112	.	C	T	12	8	20	0	1	21	0	0
7	49052138	.	G	A	11	8	19	0	2	21	0	0
7	49052359	.	A	G	8	6	14	0	1	15	0	0
7	49052377	.	A	T	5	8	13	1	1	15	0	0
7	49052413	.	C	T	8	8	16	1	0	17	0	0
7	49052476	.	G	A	7	9	16	0	1	17	0	0
7	49052575	.	G	A	4	8	12	0	0	12	0	0
7	49052625	.	C	T	7	5	12	0	0	12	0	0
7	49052777	.	C	T	7	11	18	0	0	18	0	0
7	49052957	.	C	G	8	6	14	0	1	15	0	0
7	49053260	.	C	T	3	10	13	0	0	13	0	0
7	49053531	.	C	T	17	7	24	0	1	25	0	0
7	49053566	.	G	A	1	9	10	0	12	22	0	0
7	49053627	.	C	T	9	13	22	0	0	22	0	0
7	49053677	.	G	A	0	9	9	1	10	20	0	0
7	49053817	.	C	T	3	19	22	0	2	24	0	0
7	49053977	.	C	T	7	4	11	0	0	11	0	0
7	49054243	.	G	A	3	3	6	0	3	9	0	0
7	49054268	.	T	C	9	6	15	0	0	15	0	0
7	49054382	.	T	A	15	6	21	0	1	22	0	0
7	49054885	.	C	T	10	10	20	0	0	20	0	0
7	49054985	.	T	C	6	2	8	0	0	8	0	0
7	49055197	.	C	T	4	5	9	0	1	10	0	0
7	49055371	.	A	C	9	20	29	0	0	29	0	0
7	49055411	.	T	C	16	12	28	0	1	29	0	0
7	49055812	.	T	G	1	0	1	1	3	5	0	0
7	49055880	.	C	T	2	4	6	0	0	6	0	0
7	49055930	.	A	C	1	3	4	0	0	4	0	0
7	49079102	.	C	T	1	4	5	0	0	5	0	0
7	49147462	.	G	C	4	5	9	0	0	9	0	0
7	49147525	.	C	T	2	4	6	0	0	6	0	0
7	49169991	.	C	T	2	3	5	0	0	5	0	0
7	49170028	.	G	A	1	4	5	0	5	10	0	0
7	49170029	.	G	T	6	3	9	0	1	10	0	0
7	49179547	.	G	C	1	2	3	0	0	3	0	0
7	49257220	.	C	T	4	3	7	0	0	7	0	0
7	49257333	.	T	C	4	7	11	0	1	12	0	0
7	49257841	.	C	T	11	3	14	0	0	14	0	0
7	49257979	.	A	G	4	5	9	0	0	9	0	0
7	49258012	.	G	A	6	6	12	0	0	12	0	0
7	49266497	.	G	A	10	6	16	0	0	16	0	0
7	49271067	.	C	A	9	6	15	0	0	15	0	0
7	49271069	.	C	T	7	9	16	0	0	16	0	0
7	49271208	.	C	T	9	9	18	0	0	18	0	0
7	49320253	.	G	A	13	6	19	0	0	19	0	0
7	49320342	.	A	T	5	2	7	0	0	7	0	0
7	49320841	.	A	G	3	5	8	0	0	8	0	0
7	49338309	.	G	A	16	10	26	0	2	28	0	0
7	49342391	.	G	A	16	15	31	0	1	32	0	0
7	49357357	.	G	A	11	9	20	0	0	20	0	0
7	49594967	.	C	T	7	5	12	0	3	15	0	0
7	49620601	.	T	C	6	2	8	0	0	8	0	0
7	50877064	.	T	C	5	5	10	0	0	10	0	0
7	50877100	.	T	C	3	3	6	0	0	6	0	0
7	50881518	.	T	C	1	1	2	0	1	3	0	0
7	51219977	.	T	C	21	7	28	0	1	29	0	0
7	51220557	.	G	A	3	8	11	0	1	12	0	0
7	51249441	.	G	T	1	7	8	0	0	8	0	0
7	51352721	.	A	T	1	3	4	0	1	5	0	0
7	51352806	.	T	C	4	3	7	0	0	7	0	0
7	51352871	.	T	C	7	5	12	0	0	12	0	0
7	51353421	.	C	T	2	6	8	0	0	8	0	0
7	51353447	.	G	T	6	2	8	0	1	9	0	0
7	51353854	.	T	A	1	4	5	0	0	5	0	0
7	51353935	.	G	A	5	2	7	0	0	7	0	0
7	51354066	.	G	A	2	3	5	0	2	7	0	0
7	51354296	.	A	G	5	9	14	0	0	14	0	0
7	51354306	.	T	C	11	5	16	0	0	16	0	0
7	51354424	.	T	A	5	3	8	0	0	8	0	0
7	51354442	.	C	A	4	4	8	0	1	9	0	0
7	51354672	.	T	A	4	6	10	0	0	10	0	0
7	51354696	.	C	T	8	6	14	0	0	14	0	0
7	51354756	.	T	C	4	6	10	0	0	10	0	0
7	51355000	.	C	T	4	4	8	0	0	8	0	0
7	51355337	.	A	G	1	3	4	0	0	4	0	0
7	51355342	.	A	G	1	0	1	0	2	3	0	0
7	51355592	.	G	A	0	4	4	0	3	7	0	0
7	51355972	.	T	A	5	3	8	0	0	8	0	0
7	51355993	.	T	A	5	4	9	0	0	9	0	0
7	51356018	.	C	A	3	3	6	0	0	6	0	0
7	51356100	.	A	T	5	7	12	0	1	13	0	0
7	51356542	.	C	G	14	6	20	0	0	20	0	0
7	51368654	.	T	G	0	2	2	0	1	3	0	0
7	51395580	.	T	A	1	3	4	0	0	4	0	0
7	51468042	.	C	T	3	17	20	0	9	29	0	0
7	51468199	.	C	T	23	19	42	0	0	42	0	0
7	51468389	.	C	T	3	17	20	0	12	32	0	0
7	51468411	.	A	T	16	11	27	0	0	27	0	0
7	51468556	.	G	C	25	12	37	0	1	38	0	0
7	51468577	.	C	A	16	20	36	0	1	37	0	0
7	51468928	.	G	A	10	15	25	1	3	29	0	0
7	51469048	.	T	G	25	17	42	0	2	44	0	0
7	51469166	.	A	T	13	10	23	0	1	25	1	0
7	51469340	.	G	A	10	11	21	0	0	21	0	0
7	51469361	.	A	G	11	10	21	0	0	21	0	0
7	51469578	.	T	G	8	13	21	0	0	21	0	0
7	51469897	.	A	G	8	3	11	0	0	11	0	0
7	51469952	.	A	T	10	12	22	0	0	22	0	0
7	51469956	.	C	T	1	11	12	0	9	21	0	0
7	51470070	.	T	C	3	0	3	0	5	8	0	0
7	51470569	.	G	T	6	6	12	0	0	12	0	0
7	51470741	.	A	G	2	5	7	0	0	7	0	0
7	51470868	.	C	A	8	5	13	0	0	13	0	0
7	51471107	.	G	A	3	18	21	0	0	21	0	0
7	51471117	.	A	G	5	13	18	0	1	19	0	0
7	51471249	.	T	C	4	7	11	0	2	13	0	0
7	51471365	.	T	C	14	0	14	0	1	15	0	0
7	51471554	.	T	C	3	0	3	0	10	13	0	0
7	51471560	.	T	C	12	5	17	0	0	17	0	0
7	51471591	.	T	C	9	7	16	0	2	18	0	0
7	51471690	.	T	C	6	0	6	0	5	11	0	0
7	51471714	.	A	G	7	8	15	0	0	15	0	0
7	51471775	.	G	A	4	8	12	0	0	12	0	0
7	51472456	.	C	T	5	3	8	0	0	8	0	0
7	51472693	.	C	T	0	3	3	0	3	6	0	0
7	51472702	.	A	G	3	4	7	0	0	7	0	0
7	51472793	.	A	C	4	0	4	0	9	13	0	0
7	51473000	.	C	T	5	7	12	0	0	12	0	0
7	51473021	.	C	T	6	8	14	0	0	14	0	0
7	51473585	.	T	C	4	1	5	0	7	12	0	0
7	51473673	.	G	A	6	8	14	0	0	14	0	0
7	51473814	.	C	T	8	3	11	0	1	12	0	0
7	51474238	.	G	A	6	3	9	0	1	10	0	0
7	51474279	.	C	A	7	4	11	0	0	11	0	0
7	51474300	.	G	T	6	8	14	0	1	15	0	0
7	51474468	.	C	T	1	8	9	0	11	20	0	0
7	51475111	.	G	A	5	9	14	0	0	14	0	0
7	51475288	.	G	A	3	3	6	0	1	7	0	0
7	51476108	.	G	A	2	3	5	0	0	5	0	0
7	51483357	.	G	A	3	4	7	0	0	7	0	0
7	51634231	.	A	G	25	28	53	0	3	56	0	0
7	51634285	.	C	T	26	37	63	0	4	67	0	0
7	51634480	.	G	A	40	23	63	0	2	65	0	0
7	51639656	.	C	T	5	4	9	0	0	9	0	0
7	51643163	.	A	G	4	2	6	0	0	6	0	0
7	51643639	.	A	C	5	2	7	0	0	7	0	0
7	51643722	.	A	G	3	3	6	0	0	6	0	0
7	51656560	.	A	T	1	3	4	0	0	4	0	0
7	51656576	.	A	G	2	2	4	0	0	4	0	0
7	51656759	.	G	A	4	2	6	0	0	6	0	0
7	51698403	.	T	A	3	6	9	0	0	9	0	0
7	51709472	.	G	A	4	2	6	0	0	6	0	0
7	51712777	.	T	C	1	2	3	0	0	3	0	0
7	51779552	.	G	A	2	17	19	0	21	40	0	0
7	51779636	.	T	C	21	20	41	0	2	43	0	0
7	51786442	.	T	G	21	1	22	0	21	43	0	0
7	51788729	.	C	T	17	21	38	1	0	39	0	0
7	51788756	.	A	C	15	20	35	1	4	40	0	0
7	51793623	.	C	T	26	18	44	0	1	45	0	0
7	51793747	.	C	T	19	24	43	0	0	43	0	0
7	51793813	.	G	C	12	11	23	0	2	25	0	0
7	51795827	.	C	T	1	4	5	0	0	5	0	0
7	51805642	.	A	T	4	1	5	0	0	5	0	0
7	51808384	.	G	C	0	3	3	0	2	5	0	0
7	51808396	.	C	T	3	2	5	0	0	5	0	0
7	51813764	.	G	A	4	9	13	0	0	13	0	0
7	51814287	.	C	G	6	8	14	0	0	14	0	0
7	51814385	.	G	C	13	7	20	0	1	21	0	0
7	51814416	.	T	A	11	4	15	0	0	15	0	0
7	51814512	.	C	T	4	4	8	0	1	9	0	0
7	51824687	.	C	A	5	3	8	0	0	8	0	0
7	51824718	.	A	C	4	2	6	0	0	6	0	0
7	51824772	.	T	G	5	5	10	0	0	10	0	0
7	52151714	.	T	G	6	3	9	0	0	9	0	0
7	52152016	.	C	T	2	3	5	0	0	5	0	0
7	52152053	.	A	T	2	3	5	0	0	5	0	0
7	52152063	.	C	T	0	3	3	0	2	5	0	0
7	52153001	.	G	A	2	3	5	0	0	5	0	0
7	52153006	.	C	T	2	3	5	0	0	5	0	0
7	52156137	.	T	A	2	2	4	0	0	4	0	0
7	52157531	.	T	G	4	2	6	0	0	6	0	0
7	52157782	.	T	C	4	5	9	0	1	10	0	0
7	52157814	.	G	T	7	4	11	0	1	12	0	0
7	52157994	.	A	G	6	0	6	1	4	11	0	0
7	52158210	.	G	T	6	5	11	0	0	11	0	0
7	52158304	.	G	A	4	1	5	0	3	8	0	0
7	52158339	.	G	C	5	4	9	0	0	9	0	0
7	52158362	.	T	A	5	3	8	0	0	8	0	0
7	52158435	.	A	T	2	6	8	0	0	8	0	0
7	52158916	.	C	G	2	3	5	0	0	5	0	0
7	52161646	.	G	T	1	3	4	0	0	4	0	0
7	52164592	.	T	C	3	5	8	0	0	8	0	0
7	52165016	.	T	A	8	5	13	0	0	13	0	0
7	52166143	.	G	A	5	13	18	0	0	18	0	0
7	52173195	.	C	A	8	11	19	0	1	20	0	0
7	52175362	.	T	C	11	12	23	0	0	23	0	0
7	52178542	.	T	C	4	4	8	0	0	8	0	0
7	52282674	.	G	T	11	11	22	0	0	22	0	0
7	52285113	.	C	G	4	4	8	0	1	9	0	0
7	52294403	.	G	A	20	17	37	0	2	39	0	0
7	52294540	.	A	T	19	13	32	0	0	32	0	0
7	52294746	.	C	T	1	8	9	0	7	16	0	0
7	52295795	.	C	T	4	11	15	0	12	27	0	0
7	52296320	.	G	A	8	5	13	0	0	13	0	0
7	52296352	.	G	T	7	4	11	0	1	12	0	0
7	52296400	.	C	A	8	6	14	0	0	14	0	0
7	52309924	.	G	A	10	9	19	0	1	20	0	0
7	52315434	.	C	G	1	5	6	0	5	11	0	0
7	52315513	.	C	T	0	3	3	0	10	13	0	0
7	52328463	.	A	G	5	6	11	0	0	11	0	0
7	52328569	.	C	T	7	3	10	0	0	10	0	0
7	52432459	.	G	A	2	2	4	0	0	4	0	0
7	52517561	.	C	G	5	8	13	0	0	13	0	0
7	52518134	.	G	C	4	0	4	0	7	12	1	0
7	52518271	.	A	T	4	9	13	0	1	14	0	0
7	52518813	.	C	T	3	5	8	0	0	8	0	0
7	52519134	.	G	A	9	6	15	0	0	15	0	0
7	52521352	.	G	A	3	5	8	0	1	9	0	0
7	52533621	.	C	T	5	3	8	0	0	8	0	0
7	52533649	.	C	T	4	2	6	0	0	6	0	0
7	52551570	.	A	T	6	6	12	0	3	15	0	0
7	52574213	.	A	C	1	0	1	0	4	5	0	0
7	52574225	.	G	A	1	2	3	0	2	5	0	0
7	52709772	.	T	A	2	5	7	0	0	7	0	0
7	52716777	.	T	A	3	4	7	0	0	7	0	0
7	52716792	.	A	T	3	5	8	0	1	9	0	0
7	52717095	.	T	C	3	5	8	0	1	9	0	0
7	52728713	.	G	A	4	3	7	0	1	8	0	0
7	52744228	.	T	C	4	7	11	0	1	12	0	0
7	52750565	.	C	T	17	11	28	0	0	28	0	0
7	52750847	.	C	T	9	12	21	0	0	21	0	0
7	52751306	.	T	C	3	3	6	0	0	6	0	0
7	52751341	.	T	A	2	1	3	0	0	3	0	0
7	52751357	.	T	C	1	4	5	0	0	5	0	0
7	52820320	.	C	T	10	5	15	0	0	15	0	0
7	52821372	.	A	G	2	6	8	0	1	9	0	0
7	52821377	.	A	G	5	5	10	0	0	10	0	0
7	52821646	.	A	C	4	3	7	0	0	7	0	0
7	52821658	.	C	A	5	4	9	0	0	9	0	0
7	52821701	.	G	A	5	4	9	0	0	9	0	0
7	52822708	.	C	T	10	4	14	0	1	15	0	0
7	52822791	.	T	A	9	8	17	0	1	18	0	0
7	52822793	.	A	G	9	8	17	0	1	18	0	0
7	52823429	.	A	T	5	8	13	0	1	14	0	0
7	52830423	.	G	T	1	3	4	0	1	5	0	0
7	52830447	.	G	T	4	2	6	0	0	6	0	0
7	52830601	.	T	G	18	19	37	0	0	37	0	0
7	52831053	.	G	T	29	15	44	0	2	46	0	0
7	52831413	.	C	T	20	14	34	0	4	38	0	0
7	52831622	.	T	C	16	4	20	1	1	22	0	0
7	52832127	.	C	T	14	18	32	0	1	33	0	0
7	52832129	.	C	T	11	15	26	0	5	31	0	0
7	52832427	.	C	A	14	15	29	0	1	30	0	0
7	52833126	.	C	G	11	10	21	0	1	22	0	0
7	52833248	.	A	T	17	8	25	0	1	26	0	0
7	52833606	.	G	A	25	22	47	1	3	51	0	0
7	52833792	.	G	A	14	15	29	0	2	31	0	0
7	52837804	.	T	G	17	16	33	0	2	35	0	0
7	52837908	.	G	A	13	11	24	0	0	24	0	0
7	52838681	.	G	A	10	9	19	0	0	19	0	0
7	52839062	.	C	T	6	8	14	0	0	14	0	0
7	52841648	.	G	A	3	5	8	0	1	9	0	0
7	52900928	.	A	C	9	9	18	0	0	18	0	0
7	52901531	.	C	T	8	12	20	0	2	22	0	0
7	52902160	.	G	A	16	11	27	0	1	28	0	0
7	52929182	.	G	A	25	23	48	0	0	48	0	0
7	52937334	.	G	A	8	8	16	0	0	16	0	0
7	52942312	.	G	T	10	3	13	0	2	15	0	0
7	52942472	.	C	T	7	6	13	0	0	13	0	0
7	52944199	.	G	A	4	9	13	0	0	13	0	0
7	52962765	.	T	C	3	0	3	0	5	8	0	0
7	53162537	.	A	G	1	3	4	1	0	5	0	0
7	53527883	.	C	G	4	2	6	0	1	7	0	0
7	54105335	.	C	A	0	3	3	0	1	4	0	0
7	54105352	.	T	G	1	0	1	0	1	2	0	0
7	54307268	.	G	C	1	2	3	0	1	4	0	0
7	54307660	.	A	G	4	2	6	0	0	6	0	0
7	54307898	.	T	C	2	2	4	0	0	4	0	0
7	54307917	.	G	A	2	2	4	0	3	7	0	0
7	54323986	.	T	C	15	2	17	0	10	27	0	0
7	54331379	.	G	C	9	8	17	0	0	17	0	0
7	54356092	.	A	T	5	5	10	0	0	10	0	0
7	54366517	.	A	G	2	4	6	0	0	6	0	0
7	54407619	.	C	T	4	8	12	0	0	12	0	0
7	54430450	.	T	C	3	5	8	0	0	8	0	0
7	54480159	.	C	T	1	3	4	0	0	4	0	0
7	54486819	.	T	C	4	3	7	0	1	8	0	0
7	54498267	.	G	A	1	3	4	0	0	4	0	0
7	54655025	.	A	T	5	2	7	0	1	8	0	0
7	55058697	.	A	T	1	2	3	0	0	3	0	0
7	55261074	.	C	T	3	1	4	0	1	5	0	0
7	55300266	.	C	T	3	1	4	0	1	5	0	0
7	55300360	.	T	C	1	2	3	0	0	3	0	0
7	55305497	.	A	G	2	2	4	0	0	4	0	0
7	55314253	.	A	G	4	2	6	0	0	6	0	0
7	55315983	.	C	G	4	2	6	0	0	6	0	0
7	55321423	.	C	A	5	2	7	0	0	7	0	0
7	55325582	.	A	T	2	4	6	0	0	6	0	0
7	55325586	.	G	T	2	4	6	0	0	6	0	0
7	55531105	.	A	G	10	6	16	0	1	17	0	0
7	55531112	.	G	A	10	5	15	0	3	18	0	0
7	55531224	.	G	A	11	6	17	0	7	24	0	0
7	55531240	.	G	A	15	3	18	0	2	20	0	0
7	55531295	.	C	T	2	4	6	0	15	21	0	0
7	55531430	.	G	T	15	4	19	0	0	19	0	0
7	55531932	.	C	A	3	2	5	0	0	5	0	0
7	55532125	.	G	A	7	6	13	0	0	13	0	0
7	55532131	.	G	A	8	6	14	0	0	14	0	0
7	55532281	.	G	A	3	2	5	0	0	5	0	0
7	55532316	.	A	G	4	5	9	0	0	9	0	0
7	55532327	.	C	A	3	6	9	0	0	9	0	0
7	55532380	.	T	C	6	0	6	0	7	13	0	0
7	55532424	.	C	A	6	3	9	0	0	9	0	0
7	55532429	.	T	C	7	3	10	0	1	11	0	0
7	55532656	.	A	G	7	8	15	0	0	15	0	0
7	55535754	.	T	A	9	7	16	0	0	16	0	0
7	55536419	.	C	G	8	6	14	0	0	14	0	0
7	55536451	.	G	A	5	4	9	0	1	10	0	0
7	55536487	.	G	A	6	2	8	0	0	8	0	0
7	55539410	.	A	G	6	5	11	0	0	11	0	0
7	55593120	.	A	C	3	2	5	0	1	6	0	0
7	55635202	.	T	C	7	14	21	0	0	21	0	0
7	55635355	.	G	A	1	2	3	0	4	7	0	0
7	55637122	.	C	A	7	5	12	0	0	12	0	0
7	55637360	.	G	A	1	2	3	0	0	3	0	0
7	55660269	.	G	A	13	11	24	0	0	24	0	0
7	55952877	.	C	T	2	2	4	0	0	4	0	0
7	56020062	.	C	T	1	2	3	0	0	3	0	0
7	56152363	.	C	A	6	6	12	0	1	13	0	0
7	56152436	.	G	A	8	7	15	0	2	17	0	0
7	56152437	.	G	A	9	7	16	0	0	16	0	0
7	56152660	.	T	C	10	12	22	0	0	22	0	0
7	56152740	.	G	A	16	14	30	0	0	30	0	0
7	56152759	.	C	G	0	12	12	0	19	31	0	0
7	56158197	.	G	A	9	14	23	0	2	25	0	0
7	56164219	.	T	G	11	9	20	0	1	21	0	0
7	56164267	.	G	A	12	12	24	0	1	25	0	0
7	56167349	.	C	A	12	10	22	0	0	22	0	0
7	56177177	.	C	T	0	5	5	0	7	12	0	0
7	56177188	.	T	G	7	5	12	0	1	13	0	0
7	56180399	.	A	G	1	2	3	0	0	3	0	0
7	56180417	.	A	C	2	2	4	0	0	4	0	0
7	56180528	.	G	A	2	2	4	0	0	4	0	0
7	56253928	.	T	A	2	2	4	0	0	4	0	0
7	56394991	.	T	C	5	3	8	0	0	8	0	0
7	56395283	.	A	G	2	2	4	0	1	5	0	0
7	56395495	.	T	C	1	2	3	0	0	3	0	0
7	56395822	.	T	C	3	3	6	0	0	6	0	0
7	56396599	.	G	A	0	5	5	0	7	12	0	0
7	56397859	.	G	A	2	2	4	0	0	4	0	0
7	56401049	.	A	G	5	2	7	0	0	7	0	0
7	56473558	.	T	A	5	6	11	0	0	11	0	0
7	56473834	.	T	A	4	4	8	0	0	8	0	0
7	56483052	.	G	A	4	2	6	0	0	6	0	0
7	56483101	.	G	T	2	2	4	0	0	4	0	0
7	56483131	.	A	C	1	2	3	0	0	3	0	0
7	56483141	.	T	C	1	2	3	0	0	3	0	0
7	56483772	.	T	G	14	6	20	0	3	23	0	0
7	56483928	.	C	T	7	9	16	0	0	16	0	0
7	56484288	.	G	C	23	16	39	1	0	40	0	0
7	56523233	.	A	G	7	4	11	0	0	11	0	0
7	56528922	.	G	A	9	8	17	0	0	17	0	0
7	56529352	.	T	C	1	2	3	0	0	3	0	0
7	56721953	.	G	A	0	2	2	0	3	5	0	0
7	56721963	.	T	A	2	2	4	0	1	5	0	0
7	56746224	.	T	C	4	8	12	0	0	12	0	0
7	56746311	.	C	T	4	9	13	0	1	14	0	0
7	56761482	.	G	T	3	5	8	0	0	9	1	0
7	56762118	.	G	C	7	7	14	0	0	14	0	0
7	56764603	.	G	A	4	6	10	0	0	10	0	0
7	56778235	.	T	A	16	15	31	0	1	32	0	0
7	56778251	.	T	C	16	14	30	0	2	32	0	0
7	56778282	.	C	T	3	17	20	0	13	33	0	0
7	56778605	.	A	T	28	26	54	0	1	55	0	0
7	56778817	.	G	A	9	13	22	0	0	22	0	0
7	56778822	.	A	T	9	13	22	0	1	23	0	0
7	56784046	.	C	T	14	12	26	0	3	29	0	0
7	56784070	.	A	T	11	16	27	0	2	29	0	0
7	56785006	.	T	C	10	10	20	0	1	21	0	0
7	56785093	.	A	C	18	16	34	0	1	35	0	0
7	56785315	.	G	A	17	10	27	0	0	27	0	0
7	56787414	.	A	T	20	12	32	0	0	32	0	0
7	56787483	.	T	A	16	20	36	0	0	36	0	0
7	56787527	.	C	T	18	15	33	0	0	33	0	0
7	56787671	.	T	A	11	7	18	0	0	18	0	0
7	56793647	.	C	A	1	10	11	0	4	15	0	0
7	56831574	.	T	C	1	0	1	0	3	4	0	0
7	56831631	.	C	T	2	4	6	0	1	7	0	0
7	56890304	.	G	A	0	2	2	0	2	4	0	0
7	56890430	.	T	C	1	2	3	0	0	3	0	0
7	56981010	.	T	C	2	2	4	0	0	4	0	0
7	57048677	.	T	C	4	2	6	0	0	6	0	0
7	57048682	.	C	A	3	2	5	0	0	5	0	0
7	57049638	.	A	G	4	2	6	0	0	6	0	0
7	57049715	.	T	C	3	4	7	0	0	7	0	0
7	57049863	.	C	T	1	3	4	0	0	4	0	0
7	57049865	.	G	C	0	3	3	0	1	4	0	0
7	57049917	.	G	C	2	2	4	0	0	4	0	0
7	57057285	.	C	T	3	4	7	0	0	7	0	0
7	57065184	.	T	C	4	2	6	0	0	6	0	0
7	57065256	.	G	T	2	8	10	0	0	10	0	0
7	57081143	.	C	T	5	6	11	0	0	11	0	0
7	57081146	.	T	C	6	6	12	0	0	12	0	0
7	57083043	.	C	T	7	4	11	0	0	11	0	0
7	57083156	.	A	T	7	3	10	0	1	11	0	0
7	57086216	.	G	A	0	4	4	0	4	8	0	0
7	57086277	.	G	A	2	9	11	0	7	18	0	0
7	57113135	.	A	G	1	2	3	0	1	4	0	0
7	57123438	.	A	G	2	2	4	0	0	4	0	0
7	57123513	.	T	G	3	0	3	0	3	6	0	0
7	57129474	.	A	G	2	5	7	0	0	7	0	0
7	57129518	.	C	T	2	2	4	1	0	5	0	0
7	57129520	.	A	T	2	2	4	1	0	5	0	0
7	57129766	.	A	T	1	4	5	1	0	6	0	0
7	57342407	.	T	C	1	4	5	0	0	5	0	0
7	57469701	.	T	A	1	6	7	0	0	7	0	0
7	57485461	.	T	C	8	3	11	0	1	12	0	0
7	57485811	.	C	A	14	8	22	0	0	22	0	0
7	57485847	.	G	A	12	8	20	0	1	21	0	0
7	57494184	.	C	T	2	10	12	0	15	27	0	0
7	57497455	.	C	G	5	4	9	0	0	9	0	0
7	57497456	.	T	C	5	0	5	0	4	9	0	0
7	57509353	.	C	T	4	2	6	0	1	7	0	0
7	57800754	.	C	T	4	5	9	2	0	11	0	0
7	59505300	.	G	A	4	2	6	0	0	6	0	0
7	59677592	.	T	C	5	2	7	0	1	8	0	0
7	61772930	.	G	T	5	5	10	0	0	10	0	0
7	61799933	.	C	T	4	3	7	0	1	8	0	0
7	61804557	.	A	T	3	4	7	0	0	7	0	0
7	61804880	.	A	T	7	4	11	0	1	12	0	0
7	61804909	.	C	A	5	3	8	0	0	8	0	0
7	61805102	.	G	A	5	5	10	0	0	10	0	0
7	61805104	.	T	A	4	5	9	0	0	9	0	0
7	61921320	.	G	A	9	3	12	0	0	12	0	0
7	61921387	.	T	A	3	2	5	0	0	5	0	0
7	61921463	.	C	T	7	2	9	0	1	10	0	0
7	61921465	.	T	A	6	2	8	0	1	9	0	0
7	61934189	.	T	A	7	7	14	0	0	14	0	0
7	61934306	.	A	G	8	0	8	0	4	12	0	0
7	61934330	.	A	G	2	0	2	0	7	9	0	0
7	61945030	.	A	G	5	3	8	0	0	8	0	0
7	61950074	.	C	T	3	2	5	0	0	5	0	0
7	61953293	.	C	T	3	7	10	0	1	11	0	0
7	61953344	.	G	C	3	4	7	0	0	7	0	0
7	61954500	.	G	T	5	4	9	0	1	10	0	0
7	61961664	.	A	G	4	2	6	0	0	6	0	0
7	61977229	.	C	T	9	5	14	0	0	14	0	0
7	61977256	.	A	T	11	3	14	0	1	15	0	0
7	61977499	.	T	C	4	9	13	0	0	13	0	0
7	61977514	.	G	A	6	13	19	0	0	19	0	0
7	61977744	.	G	A	3	7	10	0	1	11	0	0
7	61981518	.	A	G	4	2	6	0	0	6	0	0
7	61981934	.	G	C	3	4	7	0	0	7	0	0
7	61982188	.	A	G	7	4	11	0	1	12	0	0
7	61987819	.	A	G	4	3	7	0	0	7	0	0
7	61989033	.	A	C	4	2	6	0	0	6	0	0
7	61995417	.	G	A	4	3	7	0	0	7	0	0
7	62000765	.	G	A	2	2	4	0	1	5	0	0
7	62000825	.	G	A	1	3	4	0	1	5	0	0
7	62009652	.	G	A	0	12	12	0	5	17	0	0
7	62009677	.	G	A	0	13	13	0	4	17	0	0
7	62009701	.	C	T	3	10	13	0	1	14	0	0
7	62205699	.	G	T	1	4	5	0	0	5	0	0
7	62205714	.	T	C	1	3	4	0	1	5	0	0
7	62248635	.	C	T	4	2	6	0	1	7	0	0
7	62248651	.	T	G	4	2	6	0	0	6	0	0
7	62268259	.	C	T	5	5	10	0	1	11	0	0
7	63325317	.	A	G	2	3	5	0	0	5	0	0
7	63325484	.	T	C	2	2	4	0	0	4	0	0
7	63325567	.	C	G	3	3	6	0	0	6	0	0
7	63326010	.	A	C	1	3	4	0	0	4	0	0
7	63326928	.	G	A	0	3	3	0	5	8	0	0
7	63327252	.	C	T	1	4	5	0	0	5	0	0
7	63327468	.	C	T	1	5	6	0	0	6	0	0
7	63327757	.	C	T	6	6	12	0	1	13	0	0
7	63327912	.	G	C	0	5	5	0	5	10	0	0
7	63328125	.	A	T	8	4	12	0	0	12	0	0
7	63328305	.	T	C	5	7	12	0	0	12	0	0
7	63328320	.	T	C	5	5	10	0	1	11	0	0
7	63328446	.	T	A	12	7	19	0	3	22	0	0
7	63328485	.	C	T	12	8	20	0	0	20	0	0
7	63328599	.	A	G	13	0	13	0	12	25	0	0
7	63328632	.	C	A	13	11	24	0	1	25	0	0
7	63328746	.	G	T	19	9	28	1	1	30	0	0
7	63328764	.	G	A	0	14	14	1	15	30	0	0
7	63394480	.	C	G	1	2	3	0	0	3	0	0
7	63394488	.	T	C	1	2	3	0	0	3	0	0
7	64978891	.	A	C	10	15	25	0	0	25	0	0
7	64980793	.	A	G	11	9	20	0	0	20	0	0
7	64980820	.	A	G	11	8	19	0	2	21	0	0
7	64988061	.	A	G	9	13	22	0	2	24	0	0
7	64996666	.	A	G	3	3	6	0	0	6	0	0
7	65019731	.	T	C	8	4	12	0	0	12	0	0
7	65024082	.	C	T	0	7	7	0	9	16	0	0
7	65026828	.	C	T	0	4	4	0	2	6	0	0
7	65035275	.	A	G	8	5	13	0	1	14	0	0
7	65035416	.	G	T	5	7	12	0	0	12	0	0
7	65035437	.	C	T	6	7	13	0	0	13	0	0
7	65039374	.	T	A	3	9	12	0	0	12	0	0
7	65039436	.	A	C	11	0	11	0	8	19	0	0
7	65049706	.	C	T	0	2	2	0	4	6	0	0
7	65050312	.	A	T	3	9	12	0	0	12	0	0
7	65093097	.	G	A	9	9	18	0	0	18	0	0
7	65104080	.	A	G	2	3	5	0	0	5	0	0
7	65104840	.	C	A	2	2	4	0	0	4	0	0
7	65105011	.	G	C	2	2	4	0	0	4	0	0
7	65105160	.	C	A	2	6	8	0	0	8	0	0
7	65121982	.	C	T	7	5	12	0	0	12	0	0
7	65132884	.	C	T	6	5	11	0	0	11	0	0
7	65138868	.	A	G	5	6	11	0	0	11	0	0
7	65140532	.	C	A	6	3	9	0	1	10	0	0
7	65140738	.	T	A	5	4	9	0	0	9	0	0
7	65140786	.	G	A	5	6	11	0	1	12	0	0
7	65144861	.	G	T	1	6	7	0	9	16	0	0
7	65147905	.	G	A	7	5	12	0	1	13	0	0
7	65152024	.	T	C	1	4	5	0	0	5	0	0
7	65152075	.	A	G	3	5	8	0	0	8	0	0
7	65157397	.	A	C	6	10	16	0	1	17	0	0
7	65162339	.	G	A	1	13	14	0	12	26	0	0
7	65173289	.	A	T	15	10	25	0	1	27	1	0
7	65173534	.	C	T	8	6	14	0	0	14	0	0
7	65173829	.	A	T	1	2	3	0	0	3	0	0
7	65178135	.	C	T	1	4	5	0	2	7	0	0
7	65178270	.	C	T	7	4	11	0	0	11	0	0
7	65297041	.	A	T	5	6	11	0	0	11	0	0
7	65297313	.	G	T	3	5	8	0	0	8	0	0
7	65306067	.	T	C	9	6	15	0	1	16	0	0
7	65306229	.	G	A	5	5	10	0	1	11	0	0
7	65306417	.	C	A	4	2	6	0	0	6	0	0
7	65310699	.	G	A	4	3	7	0	0	7	0	0
7	65333843	.	T	C	6	3	9	0	1	10	0	0
7	65333874	.	C	T	3	4	7	0	0	7	0	0
7	65433092	.	T	C	3	4	7	0	0	7	0	0
7	65433343	.	G	T	5	6	11	0	0	11	0	0
7	65433352	.	C	A	5	6	11	0	1	12	0	0
7	65434589	.	C	T	4	6	10	0	0	10	0	0
7	65434610	.	C	T	6	6	12	0	0	12	0	0
7	65440493	.	C	T	2	3	5	0	1	6	0	0
7	65440505	.	G	A	2	2	4	0	1	5	0	0
7	65443348	.	T	C	5	3	8	0	0	8	0	0
7	65443396	.	G	A	4	6	10	0	1	11	0	0
7	65445483	.	G	A	3	4	7	0	1	8	0	0
7	65451324	.	T	A	11	8	19	0	0	19	0	0
7	65451369	.	C	T	11	6	17	0	0	17	0	0
7	65452005	.	G	A	2	10	12	0	6	18	0	0
7	65452017	.	G	A	9	11	20	0	1	21	0	0
7	65453057	.	G	A	1	11	12	0	6	18	0	0
7	65461040	.	G	A	0	6	6	0	9	15	0	0
7	65463165	.	C	A	9	12	21	0	0	21	0	0
7	65463297	.	G	T	4	7	11	0	7	18	0	0
7	65463511	.	G	A	2	18	20	0	18	38	0	0
7	65463586	.	C	T	10	6	16	0	0	16	0	0
7	65463906	.	T	C	7	7	14	0	0	14	0	0
7	65464120	.	T	G	7	5	12	1	0	13	0	0
7	65464132	.	T	G	6	0	6	1	6	13	0	0
7	65473137	.	G	T	12	23	35	0	1	36	0	0
7	65473421	.	G	C	28	26	54	0	1	55	0	0
7	65473775	.	G	T	15	32	47	0	3	50	0	0
7	65473814	.	T	C	33	15	48	1	3	52	0	0
7	65473972	.	T	C	17	30	47	0	0	47	0	0
7	65475422	.	T	G	18	29	47	0	3	50	0	0
7	65475708	.	T	G	19	13	32	0	2	34	0	0
7	65491835	.	G	A	31	19	50	0	1	51	0	0
7	65491910	.	T	A	11	6	17	1	1	19	0	0
7	65631891	.	A	G	1	2	3	0	0	3	0	0
7	65918566	.	A	G	3	2	5	0	0	5	0	0
7	65918569	.	T	C	3	2	5	0	0	5	0	0
7	65918793	.	T	G	3	3	6	0	0	6	0	0
7	65918984	.	T	G	1	5	6	1	0	7	0	0
7	65919167	.	A	G	1	2	3	0	0	3	0	0
7	65919373	.	A	C	4	2	6	0	0	6	0	0
7	65919903	.	C	A	1	2	3	0	0	3	0	0
7	65919940	.	T	G	1	0	1	0	5	6	0	0
7	65919942	.	T	A	2	4	6	0	0	6	0	0
7	65920618	.	G	A	2	4	6	0	0	6	0	0
7	65920670	.	A	G	4	1	5	0	4	9	0	0
7	65920720	.	A	G	3	0	3	0	3	6	0	0
7	65921645	.	T	A	1	2	3	0	0	3	0	0
7	65922495	.	A	G	3	0	3	0	5	8	0	0
7	65922504	.	A	G	1	4	5	0	0	5	0	0
7	65922868	.	T	C	2	1	3	0	1	4	0	0
7	65923179	.	C	T	10	4	14	0	0	14	0	0
7	65923238	.	C	T	5	4	9	0	0	9	0	0
7	65923321	.	A	C	2	2	4	0	0	4	0	0
7	65923777	.	T	A	2	2	4	0	0	4	0	0
7	65923944	.	T	G	4	3	7	0	0	7	0	0
7	65924621	.	T	C	4	3	7	0	2	9	0	0
7	65924634	.	A	G	4	3	7	0	0	7	0	0
7	66069906	.	A	G	5	2	7	0	0	7	0	0
7	66080231	.	G	A	4	2	6	1	0	7	0	0
7	66090927	.	C	T	2	5	7	0	0	7	0	0
7	66093051	.	T	A	2	2	4	0	0	4	0	0
7	66105498	.	C	T	5	9	14	0	0	14	0	0
7	66105663	.	A	G	7	0	7	0	7	14	0	0
7	66105752	.	C	T	6	3	9	0	1	10	0	0
7	66105804	.	G	A	1	2	3	0	3	6	0	0
7	66112702	.	T	C	6	5	11	0	1	12	0	0
7	66126466	.	T	C	3	5	8	0	0	8	0	0
7	66133626	.	A	T	3	4	7	0	1	8	0	0
7	66259574	.	A	T	6	6	12	0	0	12	0	0
7	66276243	.	G	A	6	8	14	0	0	14	0	0
7	66361984	.	A	G	9	6	15	0	0	15	0	0
7	66368653	.	T	C	4	0	4	0	3	7	0	0
7	67434693	.	A	C	9	12	21	0	2	23	0	0
7	67434807	.	T	C	10	3	13	0	2	15	0	0
7	67436273	.	C	T	11	11	22	0	0	22	0	0
7	67439428	.	A	C	12	7	19	0	0	19	0	0
7	67439496	.	T	A	8	8	16	0	2	18	0	0
7	67439520	.	T	A	8	6	14	0	1	15	0	0
7	67439742	.	T	C	13	15	28	0	0	28	0	0
7	67439743	.	C	T	13	15	28	0	0	28	0	0
7	67439781	.	T	C	14	16	30	0	1	31	0	0
7	67443766	.	T	C	13	10	23	0	0	23	0	0
7	67444837	.	G	A	19	12	31	0	1	32	0	0
7	67446295	.	C	T	23	11	34	0	1	35	0	0
7	67448338	.	T	C	20	13	33	0	2	35	0	0
7	67448363	.	A	T	21	13	34	0	0	34	0	0
7	67448373	.	T	A	21	14	35	0	0	35	0	0
7	67476376	.	T	C	40	23	63	0	4	67	0	0
7	67493909	.	C	T	2	2	4	0	0	4	0	0
7	67524484	.	G	A	2	2	4	0	0	4	0	0
7	67524520	.	C	A	1	3	4	0	1	5	0	0
7	67581909	.	T	C	5	2	7	0	1	8	0	0
7	67584796	.	C	T	3	5	8	0	0	8	0	0
7	67594248	.	C	T	6	4	10	0	0	10	0	0
7	67594292	.	A	T	4	5	9	0	1	10	0	0
7	67594506	.	G	A	1	2	3	0	5	8	0	0
7	67743603	.	T	A	3	5	8	0	0	8	0	0
7	67743604	.	G	T	3	5	8	0	0	8	0	0
7	67743646	.	A	G	3	6	9	0	0	9	0	0
7	67743878	.	T	C	4	8	12	0	0	12	0	0
7	67744341	.	A	G	11	3	14	0	0	14	0	0
7	67747819	.	T	C	8	11	19	0	3	22	0	0
7	67747826	.	T	G	7	11	18	0	1	19	0	0
7	67747915	.	G	A	6	4	10	0	0	10	0	0
7	67747916	.	A	T	6	4	10	0	0	10	0	0
7	67751133	.	C	T	5	3	8	0	0	8	0	0
7	67751286	.	A	G	3	0	3	0	2	5	0	0
7	67752263	.	T	C	2	3	5	0	0	5	0	0
7	67752290	.	G	A	3	2	5	0	0	5	0	0
7	67753196	.	T	C	5	4	9	0	0	9	0	0
7	67759739	.	C	T	3	3	6	0	0	6	0	0
7	67759772	.	C	A	4	2	6	0	0	6	0	0
7	67760488	.	C	G	3	4	7	0	1	8	0	0
7	67760491	.	C	T	3	4	7	0	1	8	0	0
7	67765772	.	T	C	3	2	5	0	0	5	0	0
7	67770477	.	T	G	3	4	7	0	0	7	0	0
7	67776588	.	C	T	4	6	10	0	1	11	0	0
7	67795367	.	T	C	5	4	9	0	1	10	0	0
7	67795386	.	A	G	6	6	12	0	0	12	0	0
7	67795429	.	G	A	2	7	9	0	0	9	0	0
7	67796494	.	G	A	1	6	7	0	9	16	0	0
7	67797037	.	C	G	7	10	17	0	1	18	0	0
7	67797087	.	G	T	8	8	16	0	0	16	0	0
7	67797097	.	C	T	7	7	14	0	0	14	0	0
7	67817399	.	C	T	6	5	11	0	1	12	0	0
7	67830051	.	C	T	0	6	6	0	4	10	0	0
7	67833051	.	G	A	4	6	10	0	0	10	0	0
7	67835264	.	A	G	7	4	11	0	0	11	0	0
7	67835269	.	A	C	7	4	11	0	0	11	0	0
7	67842641	.	G	T	5	6	11	0	1	12	0	0
7	67846087	.	T	C	3	2	5	0	0	5	0	0
7	67861868	.	T	G	4	5	9	0	0	9	0	0
7	67861872	.	G	C	4	0	4	0	5	9	0	0
7	67870323	.	A	G	1	2	3	0	0	3	0	0
7	67876771	.	C	T	0	3	3	0	1	4	0	0
7	67876880	.	T	A	2	2	4	1	0	5	0	0
7	67876881	.	G	A	2	2	4	1	0	5	0	0
7	67893985	.	G	C	2	2	4	0	0	4	0	0
7	67916337	.	G	A	2	5	7	0	0	7	0	0
7	67916385	.	A	G	2	4	6	0	0	6	0	0
7	68215451	.	A	T	20	17	37	2	3	42	0	0
7	68215990	.	T	G	14	17	31	0	2	33	0	0
7	68216504	.	C	A	0	8	8	0	4	12	0	0
7	68216781	.	G	C	4	3	7	0	0	7	0	0
7	68217387	.	G	A	13	12	25	0	1	26	0	0
7	68219043	.	T	C	3	0	3	1	3	7	0	0
7	68219332	.	A	G	6	8	14	0	0	14	0	0
7	68219340	.	A	T	8	5	13	0	3	17	1	0
7	68219412	.	T	A	6	11	17	0	2	19	0	0
7	68220824	.	A	C	9	6	15	0	1	16	0	0
7	68224841	.	G	A	5	4	9	0	0	9	0	0
7	68540716	.	T	A	2	5	7	0	0	7	0	0
7	68542517	.	C	T	1	2	3	0	0	3	0	0
7	68542538	.	C	T	5	3	8	0	0	8	0	0
7	69144357	.	T	C	4	3	7	0	0	7	0	0
7	69145033	.	T	C	3	3	6	0	1	7	0	0
7	69145048	.	T	C	6	0	6	0	1	7	0	0
7	69145499	.	T	C	11	0	11	0	4	15	0	0
7	69145516	.	T	C	11	5	16	0	0	16	0	0
7	69146366	.	T	C	3	2	5	0	0	5	0	0
7	69437422	.	A	C	3	2	5	0	0	5	0	0
7	69437495	.	C	A	4	2	6	0	0	6	0	0
7	69439094	.	T	A	2	3	5	0	1	6	0	0
7	69439436	.	T	C	5	5	10	0	0	10	0	0
7	69439580	.	A	G	4	3	7	0	0	7	0	0
7	69439587	.	A	G	5	0	5	0	4	9	0	0
7	69442261	.	T	G	3	2	5	0	0	5	0	0
7	69442374	.	C	T	7	4	11	0	2	13	0	0
7	69447324	.	G	A	7	7	14	0	2	16	0	0
7	69447352	.	T	C	10	8	18	0	1	19	0	0
7	69447469	.	C	G	3	4	7	0	0	7	0	0
7	69447516	.	A	G	5	2	7	0	0	7	0	0
7	69447520	.	G	A	3	2	5	0	2	7	0	0
7	69450044	.	A	G	2	3	5	0	0	5	0	0
7	69458368	.	G	A	0	2	2	0	2	4	0	0
7	69458611	.	T	C	2	5	7	0	0	7	0	0
7	69467145	.	A	G	6	6	12	0	0	12	0	0
7	69467267	.	A	G	5	2	7	0	1	8	0	0
7	69467383	.	T	G	2	2	4	0	5	9	0	0
7	69477283	.	T	G	28	24	52	2	0	56	2	0
7	69477303	.	A	G	16	1	17	1	41	59	0	0
7	69477437	.	A	G	25	30	55	0	3	58	0	0
7	69477464	.	T	C	25	25	50	0	3	53	0	0
7	69496521	.	C	A	11	12	23	0	0	23	0	0
7	69496537	.	A	T	12	11	23	0	3	26	0	0
7	69496572	.	A	G	9	19	28	0	0	28	0	0
7	69497048	.	A	T	9	13	22	0	1	23	0	0
7	69497493	.	G	T	21	14	35	0	0	35	0	0
7	69497637	.	G	A	16	22	38	0	0	38	0	0
7	69501040	.	A	G	18	17	35	0	0	35	0	0
7	69501148	.	A	G	15	22	37	0	1	38	0	0
7	69501300	.	A	G	17	12	29	0	0	29	0	0
7	69501345	.	G	T	16	8	24	0	0	24	0	0
7	69566119	.	A	G	18	7	25	0	1	26	0	0
7	69566179	.	A	T	16	6	22	0	0	22	0	0
7	69566848	.	G	A	9	9	18	0	1	19	0	0
7	69576019	.	C	A	9	10	19	0	1	20	0	0
7	69583133	.	A	T	6	10	16	0	0	16	0	0
7	69583139	.	C	T	5	10	15	0	0	15	0	0
7	69615021	.	G	A	10	4	14	0	0	14	0	0
7	69950322	.	G	A	2	2	4	0	0	4	0	0
7	69959980	.	G	A	3	8	11	0	0	11	0	0
7	71794062	.	T	C	9	3	12	0	2	14	0	0
7	72028326	.	A	G	39	15	54	0	2	56	0	0
7	72028742	.	A	G	26	8	34	1	0	35	0	0
7	72139791	.	A	G	3	2	5	0	0	5	0	0
7	72981807	.	T	C	2	2	4	0	0	4	0	0
7	73086522	.	A	G	2	2	4	0	3	7	0	0
7	73617792	.	A	G	4	6	10	0	0	10	0	0
7	73617817	.	A	G	10	5	15	0	1	16	0	0
7	73617880	.	A	G	4	14	18	0	0	18	0	0
7	73618565	.	A	G	10	0	10	0	4	14	0	0
7	73618841	.	A	G	3	4	7	0	0	7	0	0
7	73618866	.	A	G	6	0	6	0	3	9	0	0
7	73656361	.	G	A	4	4	8	0	1	9	0	0
7	74135779	.	G	T	10	9	19	0	0	19	0	0
8	5733	.	T	C	26	22	48	0	2	50	0	0
8	6265	.	C	T	41	31	72	0	0	72	0	0
8	6368	.	T	C	27	8	35	0	6	47	6	0
8	6440	.	A	T	19	11	30	1	3	34	0	0
8	6468	.	G	A	4	8	12	0	19	32	1	0
8	7184	.	T	C	5	11	16	0	1	17	0	0
8	7276	.	G	A	5	6	11	0	1	12	0	0
8	7346	.	G	T	4	5	9	0	0	9	0	0
8	7821	.	A	C	2	2	4	0	0	4	0	0
8	7822	.	G	T	2	2	4	0	0	4	0	0
8	8610	.	G	A	1	2	3	0	0	3	0	0
8	8615	.	C	A	1	2	3	0	0	3	0	0
8	8747	.	C	A	1	2	3	0	0	3	0	0
8	41751	.	G	C	11	15	26	0	0	26	0	0
8	41754	.	C	T	11	13	24	0	2	26	0	0
8	41925	.	T	C	14	1	15	0	16	31	0	0
8	41948	.	A	G	17	21	38	0	1	39	0	0
8	43740	.	T	C	13	0	13	0	13	26	0	0
8	43800	.	A	G	13	12	25	0	1	26	0	0
8	44337	.	G	A	7	7	14	0	0	14	0	0
8	52280	.	C	T	11	18	29	0	1	30	0	0
8	56225	.	T	G	5	7	12	0	0	12	0	0
8	56285	.	A	G	8	3	11	0	1	12	0	0
8	58399	.	C	G	5	8	13	0	0	13	0	0
8	61833	.	G	A	8	7	15	0	1	16	0	0
8	75188	.	C	A	4	9	13	0	0	13	0	0
8	75446	.	G	T	1	9	10	0	5	15	0	0
8	75646	.	G	C	0	6	6	0	5	11	0	0
8	75669	.	C	G	4	7	11	0	0	11	0	0
8	81536	.	A	G	6	0	6	0	10	16	0	0
8	109321	.	G	A	0	3	3	0	8	11	0	0
8	109375	.	C	A	4	4	8	0	1	9	0	0
8	109378	.	T	C	5	4	9	0	0	9	0	0
8	109489	.	T	C	2	5	7	0	0	7	0	0
8	120282	.	G	A	5	6	11	0	2	13	0	0
8	120377	.	A	G	5	0	5	0	3	8	0	0
8	120839	.	G	A	1	8	9	0	3	12	0	0
8	120896	.	T	C	3	10	13	0	0	13	0	0
8	121205	.	A	G	3	2	5	0	0	5	0	0
8	158431	.	C	T	9	10	19	0	0	19	0	0
8	173841	.	A	G	15	13	28	0	0	28	0	0
8	174020	.	G	A	22	8	30	0	0	30	0	0
8	261498	.	T	C	1	4	5	0	0	5	0	0
8	262012	.	C	T	3	7	10	0	0	10	0	0
8	262054	.	C	A	4	3	7	0	0	7	0	0
8	262858	.	G	T	0	6	6	0	4	10	0	0
8	268215	.	G	A	2	6	8	0	0	8	0	0
8	269360	.	G	T	1	3	4	0	0	4	0	0
8	276277	.	C	T	3	9	12	1	0	13	0	0
8	276334	.	A	G	13	10	23	0	0	23	0	0
8	286192	.	A	G	10	13	23	0	1	24	0	0
8	286251	.	C	T	12	12	24	0	0	24	0	0
8	286302	.	G	A	13	6	19	0	1	20	0	0
8	387662	.	A	T	11	3	14	0	0	14	0	0
8	388885	.	C	T	20	12	32	0	0	32	0	0
8	392047	.	G	T	8	10	18	0	2	20	0	0
8	392160	.	C	A	6	7	13	0	0	13	0	0
8	392389	.	T	C	8	1	9	0	8	17	0	0
8	392689	.	C	T	2	17	19	1	17	37	0	0
8	395281	.	C	A	3	10	13	0	9	22	0	0
8	395287	.	C	T	8	15	23	0	1	24	0	0
8	395428	.	G	A	16	9	25	0	1	26	0	0
8	397338	.	T	C	14	10	24	0	0	24	0	0
8	397341	.	C	T	1	11	12	0	13	25	0	0
8	406330	.	T	G	7	9	16	0	0	16	0	0
8	406432	.	A	C	13	6	19	0	2	21	0	0
8	412296	.	T	C	15	0	15	1	10	26	0	0
8	412303	.	G	A	15	7	22	1	1	24	0	0
8	412355	.	A	G	21	8	29	0	1	30	0	0
8	412358	.	A	G	21	8	29	0	1	30	0	0
8	412504	.	T	C	24	2	26	0	12	38	0	0
8	417849	.	A	G	6	9	15	0	0	15	0	0
8	418575	.	A	G	6	4	10	0	0	10	0	0
8	423723	.	C	T	12	7	19	0	4	23	0	0
8	423920	.	T	C	11	7	18	0	2	20	0	0
8	424969	.	G	A	9	9	18	0	0	18	0	0
8	473773	.	G	A	2	9	11	0	0	11	0	0
8	478707	.	C	T	5	2	7	0	0	7	0	0
8	478844	.	T	C	1	5	6	0	0	6	0	0
8	478889	.	G	T	2	7	9	0	1	10	0	0
8	482033	.	A	G	1	5	6	0	1	7	0	0
8	484740	.	A	G	1	0	1	0	5	6	0	0
8	484746	.	T	C	1	4	5	0	1	6	0	0
8	487241	.	T	C	8	5	13	0	0	13	0	0
8	489120	.	C	T	2	2	4	0	0	4	0	0
8	489135	.	C	T	2	2	4	0	0	4	0	0
8	539973	.	T	G	9	0	9	0	13	23	1	0
8	539979	.	C	G	11	13	24	0	0	24	0	0
8	541376	.	C	A	11	13	24	0	0	24	0	0
8	600882	.	G	A	1	3	4	0	0	4	0	0
8	705549	.	C	T	4	2	6	0	0	6	0	0
8	928341	.	G	A	7	17	24	0	2	26	0	0
8	941369	.	T	C	5	4	9	0	1	10	0	0
8	941378	.	C	T	0	4	4	0	6	10	0	0
8	943953	.	G	C	7	6	13	0	0	13	0	0
8	1094388	.	G	A	5	5	10	0	0	10	0	0
8	1094542	.	T	C	12	9	21	0	1	22	0	0
8	1094566	.	C	T	11	12	23	0	4	27	0	0
8	1094590	.	G	A	2	13	15	0	12	27	0	0
8	1094910	.	T	A	8	13	21	0	1	22	0	0
8	1100463	.	C	T	20	12	32	0	0	33	1	0
8	1102404	.	T	C	7	14	21	0	1	22	0	0
8	1104980	.	A	G	9	0	9	0	6	15	0	0
8	1106149	.	C	T	11	16	27	0	1	28	0	0
8	1106494	.	C	A	11	11	22	0	0	22	0	0
8	1130331	.	C	T	3	4	7	0	0	7	0	0
8	1130450	.	C	G	6	0	6	0	5	11	0	0
8	1133689	.	A	G	4	5	9	0	0	9	0	0
8	1133753	.	C	G	3	3	6	0	0	6	0	0
8	1133889	.	T	G	1	1	2	0	1	3	0	0
8	1151416	.	T	C	10	15	25	0	1	26	0	0
8	1222417	.	T	C	8	1	9	0	7	16	0	0
8	1222504	.	T	C	13	0	13	0	20	33	0	0
8	1222558	.	A	G	22	20	42	0	0	42	0	0
8	1253651	.	G	A	28	16	44	0	1	45	0	0
8	1254337	.	C	T	18	15	33	0	1	34	0	0
8	1255292	.	C	G	6	8	14	0	18	32	0	0
8	1255304	.	G	A	17	5	22	0	4	26	0	0
8	1259023	.	G	A	20	15	35	0	3	38	0	0
8	1264645	.	A	G	13	7	20	0	2	22	0	0
8	1298792	.	C	T	3	2	5	0	0	5	0	0
8	1298813	.	C	T	4	3	7	0	0	7	0	0
8	1852056	.	A	G	3	4	7	0	0	7	0	0
8	1852078	.	A	G	4	5	9	0	0	9	0	0
8	1852274	.	A	G	2	4	6	0	0	6	0	0
8	1852599	.	A	G	5	5	10	0	0	10	0	0
8	1852948	.	A	G	4	2	6	0	0	6	0	0
8	1853406	.	A	G	9	5	14	0	0	14	0	0
8	1853474	.	A	G	3	6	9	0	0	9	0	0
8	1855256	.	A	G	5	2	7	0	0	7	0	0
8	1855312	.	A	G	14	9	23	0	4	27	0	0
8	1855322	.	A	G	24	0	24	0	7	31	0	0
8	1856171	.	A	G	6	5	11	0	0	11	0	0
8	1856174	.	A	G	0	10	10	0	0	10	0	0
8	1856254	.	A	G	7	12	19	0	2	21	0	0
8	1856265	.	A	G	5	11	16	0	5	21	0	0
8	2216013	.	A	G	6	2	8	0	0	8	0	0
8	2219604	.	G	A	1	3	4	0	0	4	0	0
8	2222548	.	C	T	2	3	5	0	0	5	0	0
8	2261052	.	T	C	1	3	4	0	0	4	0	0
8	2757956	.	C	T	2	6	8	0	0	8	0	0
8	2770202	.	A	G	2	3	5	0	0	5	0	0
8	2780722	.	A	G	0	2	2	0	1	3	0	0
8	2787141	.	T	C	4	5	9	0	0	9	0	0
8	2789535	.	T	C	3	3	6	0	0	6	0	0
8	2789536	.	C	A	3	3	6	0	0	6	0	0
8	2789592	.	T	C	4	10	14	0	0	14	0	0
8	2789655	.	C	A	2	7	9	0	1	10	0	0
8	2789748	.	T	A	3	3	6	0	0	6	0	0
8	2789757	.	G	T	2	3	5	0	0	5	0	0
8	3085393	.	G	A	2	2	4	0	0	4	0	0
8	3085423	.	T	C	5	2	7	0	0	7	0	0
8	3085466	.	C	A	5	2	7	0	0	7	0	0
8	3085565	.	A	G	1	2	3	0	0	3	0	0
8	3085841	.	T	A	3	3	6	0	0	6	0	0
8	3085863	.	A	G	4	2	6	0	1	7	0	0
8	3099585	.	G	A	1	8	9	0	9	18	0	0
8	3099922	.	T	C	3	2	5	0	0	5	0	0
8	3101241	.	G	T	3	11	14	0	0	14	0	0
8	3101277	.	T	C	7	12	19	0	0	19	0	0
8	3434245	.	C	T	1	2	3	0	0	3	0	0
8	3434302	.	T	C	4	2	6	0	0	6	0	0
8	3434506	.	C	A	1	2	3	0	1	4	0	0
8	3434527	.	T	C	1	2	3	0	0	3	0	0
8	3438906	.	A	G	3	2	5	0	0	5	0	0
8	3439266	.	G	T	2	3	5	0	0	5	0	0
8	3537152	.	G	A	0	5	5	0	1	6	0	0
8	3561515	.	G	A	2	2	4	0	0	4	0	0
8	3581488	.	G	A	0	2	2	0	1	3	0	0
8	3591190	.	C	T	3	3	6	0	0	6	0	0
8	3591211	.	C	A	5	3	8	0	0	8	0	0
8	3595161	.	G	A	0	3	3	0	7	10	0	0
8	3595359	.	C	T	8	8	16	0	2	18	0	0
8	3602041	.	T	C	4	5	9	0	1	10	0	0
8	3605171	.	C	T	6	5	11	0	0	11	0	0
8	3624208	.	G	C	17	9	26	0	0	26	0	0
8	3624690	.	G	A	2	7	9	0	6	15	0	0
8	3628683	.	C	T	9	10	19	0	1	20	0	0
8	3628747	.	C	A	13	8	21	0	2	23	0	0
8	3628758	.	T	A	11	12	23	0	0	23	0	0
8	3628782	.	G	A	1	15	16	0	11	27	0	0
8	3629231	.	G	T	2	9	11	0	8	19	0	0
8	3629232	.	T	C	7	10	17	0	2	19	0	0
8	3630935	.	A	T	11	8	19	0	0	19	0	0
8	3631371	.	T	C	11	9	20	0	1	21	0	0
8	3641224	.	C	T	18	15	33	0	3	36	0	0
8	3643299	.	T	C	24	16	40	0	2	42	0	0
8	3659979	.	T	C	5	6	11	0	1	12	0	0
8	3660034	.	C	T	3	5	8	0	0	8	0	0
8	3674670	.	C	T	4	2	6	0	0	6	0	0
8	3674701	.	T	C	2	2	4	0	1	5	0	0
8	3690953	.	G	A	2	2	4	0	0	4	0	0
8	3691184	.	C	T	0	3	3	0	2	5	0	0
8	3859383	.	T	A	4	6	10	0	0	10	0	0
8	3865233	.	T	C	5	5	10	0	0	10	0	0
8	3883831	.	C	G	6	6	12	0	1	13	0	0
8	3885609	.	C	T	6	5	11	0	0	11	0	0
8	3886223	.	C	T	2	6	8	0	1	9	0	0
8	3889662	.	G	A	0	6	6	0	3	9	0	0
8	3890837	.	T	C	6	11	17	0	0	17	0	0
8	3893987	.	C	T	8	6	14	0	0	14	0	0
8	3894008	.	A	T	8	7	15	0	0	15	0	0
8	3894077	.	G	A	7	9	16	0	0	16	0	0
8	3904963	.	C	T	3	9	12	0	0	12	0	0
8	3906073	.	C	A	10	16	26	0	0	26	0	0
8	3915909	.	G	A	7	10	17	0	0	17	0	0
8	3918567	.	C	T	14	16	30	0	0	30	0	0
8	3932842	.	T	G	3	3	6	0	0	6	0	0
8	3932889	.	A	T	3	5	8	0	0	8	0	0
8	3932990	.	A	G	7	5	12	0	0	12	0	0
8	3950039	.	C	G	6	3	9	0	0	9	0	0
8	3950317	.	G	A	4	3	7	0	0	7	0	0
8	3950341	.	A	G	2	3	5	0	0	5	0	0
8	4044846	.	G	A	2	5	7	0	1	8	0	0
8	4044876	.	T	C	8	4	12	0	0	12	0	0
8	4399054	.	A	G	6	0	6	0	5	11	0	0
8	4399055	.	A	G	6	5	11	0	0	11	0	0
8	4399093	.	A	G	6	6	12	1	0	13	0	0
8	4399674	.	A	G	3	0	3	0	5	8	0	0
8	4762881	.	G	A	1	11	12	0	10	22	0	0
8	4771987	.	C	T	22	9	31	0	2	33	0	0
8	4779959	.	A	G	2	2	4	0	0	4	0	0
8	4779962	.	G	T	4	2	6	0	0	6	0	0
8	4780110	.	A	C	5	4	9	0	0	9	0	0
8	4780238	.	T	A	9	9	18	0	0	18	0	0
8	4780586	.	G	A	10	14	24	0	1	25	0	0
8	4780637	.	G	T	10	16	26	0	0	26	0	0
8	4782879	.	C	T	0	7	7	0	5	12	0	0
8	4788763	.	A	G	6	6	12	0	2	14	0	0
8	4800572	.	G	A	2	2	4	0	0	4	0	0
8	4800574	.	G	A	2	2	4	0	0	4	0	0
8	4803950	.	C	T	3	6	9	0	0	9	0	0
8	4803956	.	C	T	4	5	9	0	1	10	0	0
8	4806795	.	T	C	5	5	10	0	0	10	0	0
8	4806865	.	C	T	2	2	4	0	0	4	0	0
8	4807033	.	G	C	1	4	5	0	2	7	0	0
8	4807084	.	C	T	6	4	10	0	0	10	0	0
8	4809221	.	C	T	10	3	13	1	0	14	0	0
8	4813479	.	A	C	1	2	3	0	1	4	0	0
8	4813493	.	T	C	3	2	5	0	0	5	0	0
8	4813592	.	C	T	5	9	14	0	1	15	0	0
8	4964236	.	T	C	3	8	11	0	1	12	0	0
8	4964521	.	G	A	16	11	27	0	0	27	0	0
8	4972812	.	C	T	10	8	18	0	1	19	0	0
8	5119396	.	A	G	6	8	14	0	0	14	0	0
8	5122568	.	G	A	10	8	18	0	1	19	0	0
8	5141521	.	G	A	7	7	14	0	0	14	0	0
8	5142508	.	G	C	8	6	14	0	0	14	0	0
8	5144347	.	T	G	4	9	13	0	0	13	0	0
8	5149030	.	G	T	5	4	9	0	1	10	0	0
8	6866887	.	C	A	1	2	3	0	0	3	0	0
8	7014476	.	C	T	10	7	17	0	1	18	0	0
8	7018017	.	G	A	9	11	20	0	1	21	0	0
8	7021512	.	C	T	10	10	20	0	2	22	0	0
8	7022029	.	G	A	1	10	11	0	13	24	0	0
8	7022227	.	A	G	10	7	17	0	1	18	0	0
8	7022305	.	C	T	10	6	16	0	0	16	0	0
8	7108624	.	C	T	2	3	5	0	0	5	0	0
8	7114497	.	T	C	6	5	11	0	0	11	0	0
8	7118497	.	T	C	8	8	16	0	1	17	0	0
8	7118520	.	T	G	11	0	11	0	8	19	0	0
8	7118809	.	G	A	11	9	20	0	3	23	0	0
8	7119013	.	G	A	0	5	5	0	3	8	0	0
8	7119189	.	A	G	1	5	6	0	0	6	0	0
8	7119718	.	C	G	4	0	4	0	5	9	0	0
8	7120014	.	C	A	1	3	4	0	0	4	0	0
8	7120479	.	A	T	4	5	9	0	0	9	0	0
8	7120498	.	A	G	7	3	10	0	0	10	0	0
8	7120546	.	A	G	10	11	21	0	0	21	0	0
8	7120572	.	C	G	7	7	14	0	1	15	0	0
8	7120604	.	T	C	8	2	10	1	1	12	0	0
8	7121011	.	T	A	16	5	21	0	0	21	0	0
8	7121067	.	G	A	3	4	7	0	0	7	0	0
8	7121312	.	C	T	3	2	5	0	0	5	0	0
8	7121347	.	A	T	7	4	11	0	0	11	0	0
8	7121649	.	T	C	5	6	11	0	0	11	0	0
8	7121868	.	C	T	5	3	8	0	0	8	0	0
8	7121877	.	A	G	5	3	8	0	0	8	0	0
8	7121939	.	A	C	3	2	5	0	0	5	0	0
8	7122186	.	T	C	1	4	5	0	0	5	0	0
8	7122221	.	T	A	1	4	5	0	0	5	0	0
8	7122248	.	C	A	1	5	6	0	1	7	0	0
8	7122396	.	C	A	9	8	17	0	0	17	0	0
8	7122459	.	A	G	16	5	21	0	0	21	0	0
8	7122460	.	A	T	16	5	21	0	0	21	0	0
8	7122931	.	G	A	1	8	9	0	10	19	0	0
8	7123171	.	G	C	1	9	10	0	13	23	0	0
8	7123233	.	A	T	13	10	23	0	0	23	0	0
8	7123257	.	T	C	12	10	22	0	0	22	0	0
8	7123323	.	C	A	9	5	14	0	0	14	0	0
8	7123326	.	A	G	9	5	14	0	0	14	0	0
8	7123360	.	A	T	11	6	17	0	0	17	0	0
8	7123414	.	G	A	1	6	7	0	11	18	0	0
8	7123415	.	G	C	11	6	17	0	0	17	0	0
8	7123452	.	G	A	15	10	25	0	0	25	0	0
8	7123472	.	A	G	19	8	27	0	0	27	0	0
8	7123491	.	T	C	16	14	30	0	2	32	0	0
8	7123538	.	G	A	15	13	28	0	0	28	0	0
8	7908369	.	A	G	3	3	6	0	0	6	0	0
8	7908374	.	A	G	4	0	4	0	3	7	0	0
8	7908520	.	A	G	4	3	7	1	0	8	0	0
8	7908744	.	A	G	2	3	5	0	0	5	0	0
8	7910145	.	A	G	3	0	3	0	2	5	0	0
8	8263732	.	T	C	1	4	5	0	0	5	0	0
8	8402638	.	T	C	4	2	6	0	0	6	0	0
8	8695773	.	G	T	1	2	3	0	0	3	0	0
8	8695968	.	C	T	1	2	3	0	0	3	0	0
8	8699163	.	A	T	4	4	8	0	0	8	0	0
8	8699174	.	T	A	4	5	9	0	0	9	0	0
8	8699211	.	C	T	4	3	7	0	0	7	0	0
8	8699235	.	G	A	6	7	13	0	0	13	0	0
8	8704215	.	C	T	6	8	14	0	1	15	0	0
8	8704274	.	A	G	5	0	5	0	3	8	0	0
8	8704377	.	G	C	1	2	3	0	0	3	0	0
8	8729278	.	C	G	8	5	13	0	0	13	0	0
8	8729308	.	T	A	7	6	13	0	0	13	0	0
8	8735644	.	T	C	6	7	13	0	1	14	0	0
8	8735698	.	C	A	8	5	13	0	0	13	0	0
8	8846877	.	C	T	7	6	13	0	0	13	0	0
8	8846924	.	G	A	4	3	7	0	3	10	0	0
8	8847341	.	T	A	9	8	17	0	0	18	1	0
8	8847476	.	C	T	4	3	7	0	0	7	0	0
8	8847648	.	T	A	11	15	26	0	0	26	0	0
8	8847893	.	A	T	8	10	18	1	0	19	0	0
8	8848122	.	C	A	6	5	11	0	1	12	0	0
8	8861240	.	G	A	0	8	8	0	4	12	0	0
8	8914911	.	C	T	11	12	23	0	2	25	0	0
8	8919045	.	G	A	1	15	16	0	14	30	0	0
8	8974572	.	G	A	1	7	8	0	8	16	0	0
8	8975929	.	T	C	5	10	15	0	1	16	0	0
8	8977919	.	G	A	8	9	17	0	0	17	0	0
8	8993240	.	A	G	7	13	20	0	0	20	0	0
8	9015855	.	A	G	6	8	14	0	1	15	0	0
8	9015894	.	G	C	6	10	16	0	1	17	0	0
8	9028945	.	G	A	0	14	14	0	10	24	0	0
8	9029047	.	C	A	3	5	8	0	0	8	0	0
8	9029076	.	A	G	5	2	7	0	1	8	0	0
8	9052123	.	C	T	8	8	16	0	1	17	0	0
8	9076296	.	T	C	10	8	18	0	0	18	0	0
8	9076389	.	C	T	1	4	5	0	7	12	0	0
8	9093623	.	A	T	5	7	12	0	3	15	0	0
8	9232930	.	C	T	7	8	15	0	0	15	0	0
8	9234574	.	G	A	6	4	10	0	0	10	0	0
8	9262024	.	G	A	6	5	11	0	0	11	0	0
8	9267615	.	G	C	4	3	7	0	0	7	0	0
8	9270038	.	A	G	8	3	11	0	0	11	0	0
8	9270041	.	G	A	7	1	8	0	2	10	0	0
8	9270373	.	G	A	8	3	11	0	1	12	0	0
8	9275165	.	C	T	0	2	2	0	6	8	0	0
8	9275180	.	G	A	3	3	6	0	0	6	0	0
8	9280472	.	G	A	3	3	6	0	1	7	0	0
8	9390769	.	G	A	2	3	5	0	0	5	0	0
8	9395005	.	G	A	3	5	8	0	1	9	0	0
8	9429697	.	G	A	2	6	8	0	0	8	0	0
8	9542541	.	G	A	6	3	9	0	1	10	0	0
8	9542724	.	C	T	3	3	6	0	0	6	0	0
8	9570464	.	T	A	1	3	4	0	0	4	0	0
8	9700176	.	G	T	0	3	3	0	4	7	0	0
8	9709591	.	T	C	1	2	3	0	1	4	0	0
8	9716087	.	C	G	6	3	9	0	0	9	0	0
8	9716229	.	A	G	1	7	8	0	0	8	0	0
8	9728650	.	G	A	0	5	5	0	2	7	0	0
8	9733153	.	G	A	0	8	8	0	4	12	0	0
8	9733174	.	G	A	4	7	11	0	1	12	0	0
8	9736134	.	A	G	4	7	11	0	0	11	0	0
8	9736287	.	G	A	7	10	17	0	0	17	0	0
8	9743078	.	T	C	11	9	20	0	0	20	0	0
8	9743081	.	A	T	11	10	21	0	0	21	0	0
8	9748783	.	A	G	7	13	20	0	0	20	0	0
8	9748864	.	A	G	6	6	12	0	0	12	0	0
8	9755356	.	T	G	7	9	16	0	2	18	0	0
8	9755411	.	A	G	6	0	6	0	10	16	0	0
8	9781903	.	G	A	7	5	12	0	1	13	0	0
8	9791577	.	G	A	1	6	7	0	6	13	0	0
8	9791902	.	T	C	5	8	13	0	0	13	0	0
8	9791977	.	G	A	0	8	8	0	5	13	0	0
8	9792083	.	C	G	4	5	9	0	0	9	0	0
8	9867730	.	C	T	3	4	7	0	0	7	0	0
8	9867823	.	G	A	1	2	3	0	1	4	0	0
8	9867902	.	G	A	3	3	6	0	1	7	0	0
8	9868004	.	C	T	1	4	5	0	0	5	0	0
8	9868973	.	G	A	1	6	7	0	6	13	0	0
8	9985326	.	C	T	10	9	19	0	4	23	0	0
8	9985374	.	A	G	15	11	26	0	1	27	0	0
8	10305260	.	C	T	15	6	21	0	1	22	0	0
8	10306061	.	C	T	14	15	29	0	1	30	0	0
8	10307924	.	G	A	18	11	29	0	1	30	0	0
8	10308278	.	G	T	16	19	35	2	1	38	0	0
8	10369089	.	T	C	1	3	4	0	0	4	0	0
8	10562144	.	C	T	10	8	18	0	0	18	0	0
8	10562198	.	A	G	3	7	10	0	1	11	0	0
8	10856883	.	A	C	3	3	6	0	0	6	0	0
8	10869215	.	T	C	2	3	5	0	0	5	0	0
8	10869953	.	C	T	1	1	2	0	1	3	0	0
8	10870571	.	C	A	5	2	7	0	0	7	0	0
8	10873945	.	A	G	2	3	5	0	0	5	0	0
8	10884375	.	G	A	0	5	5	0	5	10	0	0
8	10884492	.	C	T	3	4	7	0	0	7	0	0
8	10890013	.	C	T	5	3	8	0	2	10	0	0
8	10890056	.	G	A	1	4	5	0	3	8	0	0
8	10890079	.	C	T	2	3	5	0	2	7	0	0
8	10890169	.	T	C	7	4	11	0	1	12	0	0
8	10894887	.	C	T	4	5	9	0	0	9	0	0
8	10937661	.	A	G	1	2	3	0	0	3	0	0
8	10956561	.	G	T	4	2	6	0	0	6	0	0
8	10956794	.	G	C	2	9	11	0	0	11	0	0
8	10957045	.	G	T	10	12	22	0	1	23	0	0
8	10967342	.	T	C	9	0	9	0	10	19	0	0
8	10969694	.	C	T	14	4	18	0	0	18	0	0
8	10972414	.	G	A	12	12	24	0	0	24	0	0
8	10987621	.	G	A	6	4	10	0	0	10	0	0
8	10988903	.	C	T	5	5	10	0	1	11	0	0
8	11004226	.	A	G	4	3	7	0	0	7	0	0
8	11004246	.	G	A	5	2	7	0	0	7	0	0
8	11004484	.	C	A	0	2	2	0	6	8	0	0
8	11004549	.	C	T	6	2	8	0	3	11	0	0
8	11004597	.	G	T	6	4	10	0	0	10	0	0
8	11010149	.	T	C	8	17	25	0	1	26	0	0
8	11039011	.	T	A	4	2	6	0	0	6	0	0
8	11116511	.	T	G	3	3	6	0	0	6	0	0
8	11136791	.	G	A	6	9	15	0	0	15	0	0
8	11139954	.	C	G	5	7	12	0	1	13	0	0
8	11141807	.	C	T	6	3	9	0	0	9	0	0
8	11144820	.	T	C	4	0	4	1	5	10	0	0
8	11179228	.	T	A	8	8	16	0	0	16	0	0
8	11180061	.	C	T	8	11	19	0	0	19	0	0
8	11180063	.	T	G	8	10	18	0	1	19	0	0
8	11182873	.	G	A	5	6	11	0	0	11	0	0
8	11182905	.	A	C	5	3	8	0	0	8	0	0
8	11183130	.	T	A	4	4	8	0	1	9	0	0
8	11183508	.	T	A	7	6	13	0	1	14	0	0
8	11183555	.	G	T	4	9	13	0	1	14	0	0
8	11183576	.	A	T	4	9	13	0	0	13	0	0
8	11183670	.	G	T	8	3	11	0	0	11	0	0
8	11183690	.	T	C	6	2	8	0	0	8	0	0
8	11183708	.	G	A	4	4	8	0	1	9	0	0
8	11183733	.	C	T	3	9	12	0	0	12	0	0
8	11183787	.	G	A	5	5	10	0	0	10	0	0
8	11183817	.	C	G	1	4	5	0	5	10	0	0
8	11183892	.	T	A	1	4	5	0	0	5	0	0
8	11184030	.	C	A	3	5	8	0	0	8	0	0
8	11184192	.	T	G	4	3	7	0	0	7	0	0
8	11184222	.	A	G	2	3	5	0	1	6	0	0
8	11184296	.	C	T	3	2	5	0	0	5	0	0
8	11184609	.	T	G	6	3	9	0	0	9	0	0
8	11185371	.	T	C	3	3	6	0	0	6	0	0
8	11185406	.	G	C	5	3	8	0	0	8	0	0
8	11185411	.	A	G	5	3	8	0	0	8	0	0
8	11185453	.	T	A	2	4	6	0	0	6	0	0
8	11185625	.	C	T	3	1	4	0	2	6	0	0
8	11185729	.	A	G	1	2	3	0	0	3	0	0
8	11189117	.	C	G	2	2	4	0	0	4	0	0
8	11189275	.	A	G	1	3	4	0	0	4	0	0
8	11189290	.	A	G	1	3	4	0	1	5	0	0
8	11190319	.	T	C	3	0	3	0	3	6	0	0
8	11190323	.	G	A	3	2	5	0	0	5	0	0
8	11191339	.	T	G	1	2	3	0	0	3	0	0
8	11191347	.	T	C	1	0	1	0	1	2	0	0
8	11191378	.	C	T	1	2	3	0	0	3	0	0
8	11204295	.	C	T	5	3	8	0	0	8	0	0
8	11204346	.	T	A	4	3	7	0	0	7	0	0
8	11204441	.	C	T	1	3	4	5	3	12	0	0
8	11204699	.	C	T	4	2	6	0	0	6	0	0
8	11207204	.	G	A	3	4	7	0	0	7	0	0
8	11234678	.	G	A	5	5	10	0	0	10	0	0
8	11241284	.	A	T	6	4	10	0	1	11	0	0
8	11245967	.	A	G	3	7	10	0	0	10	0	0
8	11246006	.	G	A	4	3	7	0	1	8	0	0
8	11250740	.	A	T	9	5	14	0	0	14	0	0
8	11268795	.	G	A	7	4	11	0	0	11	0	0
8	11268807	.	G	A	5	6	11	0	0	11	0	0
8	11268837	.	G	A	5	4	9	0	0	9	0	0
8	11278615	.	G	A	2	6	8	0	0	8	0	0
8	11288949	.	C	T	2	2	4	0	0	4	0	0
8	11477573	.	C	T	2	5	7	0	0	7	0	0
8	11483097	.	G	A	1	9	10	0	9	19	0	0
8	11483163	.	C	T	18	11	29	0	0	29	0	0
8	11488468	.	C	T	8	8	16	0	1	17	0	0
8	11491332	.	C	T	12	9	21	0	1	22	0	0
8	11503000	.	A	C	6	9	15	0	2	17	0	0
8	11503006	.	T	C	9	8	17	0	0	17	0	0
8	11511403	.	C	T	8	4	12	0	0	12	0	0
8	11520599	.	C	T	5	5	10	0	0	10	0	0
8	11521145	.	G	A	11	4	15	0	0	15	0	0
8	11521229	.	C	T	5	7	12	0	0	12	0	0
8	11540815	.	G	T	10	16	26	0	0	26	0	0
8	11541829	.	A	G	10	13	23	0	0	23	0	0
8	11541844	.	C	A	13	9	22	0	0	22	0	0
8	11541960	.	G	T	1	3	4	0	1	5	0	0
8	11542207	.	C	G	10	5	15	0	0	15	0	0
8	11543631	.	C	T	2	2	4	0	1	5	0	0
8	11548419	.	A	G	1	3	4	0	0	4	0	0
8	11578414	.	G	T	4	6	10	0	0	10	0	0
8	11590976	.	G	A	5	5	10	0	1	11	0	0
8	11603914	.	G	A	3	4	7	0	0	7	0	0
8	11615923	.	C	T	0	3	3	0	3	6	0	0
8	11642155	.	C	T	2	1	3	0	1	4	0	0
8	11642170	.	A	T	1	2	3	0	0	3	0	0
8	11648815	.	T	G	3	5	8	0	0	8	0	0
8	11661816	.	A	C	1	4	5	0	1	7	1	0
8	11680661	.	T	A	1	2	3	0	0	3	0	0
8	11681056	.	G	T	3	2	5	0	0	5	0	0
8	11681078	.	G	A	2	4	6	0	2	8	0	0
8	11681128	.	T	C	1	2	3	0	0	3	0	0
8	11681227	.	A	G	1	1	2	1	1	4	0	0
8	11681297	.	T	G	2	4	6	0	0	6	0	0
8	11728172	.	A	G	3	0	3	0	4	7	0	0
8	11728191	.	C	T	5	3	8	0	0	8	0	0
8	11734353	.	C	A	4	4	8	0	0	8	0	0
8	11736671	.	T	A	7	5	12	0	0	12	0	0
8	11737937	.	A	G	5	3	8	0	1	9	0	0
8	11740461	.	A	C	4	7	11	0	1	12	0	0
8	11744619	.	A	G	10	7	17	0	1	18	0	0
8	11744660	.	A	G	9	6	15	0	1	16	0	0
8	11744723	.	T	G	6	8	14	0	0	14	0	0
8	11744758	.	A	G	4	9	13	0	0	13	0	0
8	11744810	.	G	A	3	5	8	0	1	9	0	0
8	11746647	.	A	G	6	4	10	0	0	10	0	0
8	11746684	.	A	G	6	5	11	0	0	11	0	0
8	11746701	.	G	T	5	5	10	0	1	11	0	0
8	11746741	.	G	A	4	8	12	0	1	13	0	0
8	11746759	.	G	A	9	4	13	0	0	13	0	0
8	11752669	.	C	T	0	5	5	0	4	9	0	0
8	11756494	.	C	T	4	3	7	0	0	7	0	0
8	11756602	.	A	G	1	4	5	0	0	5	0	0
8	11761820	.	C	T	0	4	4	0	3	7	0	0
8	11761829	.	T	A	4	2	6	0	1	7	0	0
8	11779630	.	C	A	0	2	2	0	5	7	0	0
8	11794663	.	C	T	2	3	5	0	2	7	0	0
8	11985228	.	A	G	4	6	10	0	0	10	0	0
8	11987931	.	C	T	2	2	4	0	0	4	0	0
8	12016553	.	G	A	9	8	17	0	0	17	0	0
8	12111198	.	C	T	17	11	28	0	0	28	0	0
8	12118473	.	A	G	10	4	14	0	0	14	0	0
8	12121766	.	C	T	10	4	14	0	1	15	0	0
8	12135256	.	G	A	7	10	17	0	1	18	0	0
8	12136448	.	A	G	9	6	15	0	0	15	0	0
8	12149688	.	C	T	3	10	13	0	0	13	0	0
8	12149865	.	G	T	4	6	10	0	0	10	0	0
8	12149994	.	G	A	3	2	5	0	0	5	0	0
8	12150108	.	A	G	5	10	15	0	1	16	0	0
8	12150471	.	C	T	2	7	9	0	1	10	0	0
8	12182923	.	G	A	2	2	4	0	0	4	0	0
8	12340595	.	A	G	2	2	4	0	0	4	0	0
8	12340621	.	C	T	1	3	4	0	0	4	0	0
8	13852674	.	A	C	2	1	3	0	8	11	0	0
8	14159804	.	T	C	6	2	8	0	0	8	0	0
8	14441120	.	A	G	14	4	18	0	0	18	0	0
8	14441524	.	A	G	5	5	10	0	1	11	0	0
8	14441596	.	A	G	17	7	24	0	3	27	0	0
8	15276864	.	A	T	4	2	6	0	0	6	0	0
8	16464100	.	A	G	7	7	14	0	0	14	0	0
8	16464166	.	G	A	6	5	11	0	0	11	0	0
8	16516832	.	A	T	7	10	17	0	0	17	0	0
8	16517152	.	C	A	3	9	12	0	0	12	0	0
8	16517310	.	C	G	5	2	7	0	0	7	0	0
8	16517702	.	G	T	0	4	4	0	2	6	0	0
8	16517783	.	C	G	4	4	8	0	0	8	0	0
8	16517789	.	A	G	3	4	7	0	1	8	0	0
8	16518452	.	G	C	1	2	3	0	0	3	0	0
8	16518493	.	T	A	4	5	9	0	0	9	0	0
8	16519055	.	C	T	3	12	15	0	0	15	0	0
8	16519084	.	C	A	5	14	19	0	1	20	0	0
8	16519506	.	T	C	3	4	7	0	0	7	0	0
8	16519637	.	C	T	5	4	9	0	0	9	0	0
8	16519646	.	G	T	5	3	8	0	0	8	0	0
8	16519692	.	G	A	8	6	14	0	0	14	0	0
8	16519695	.	G	C	8	6	14	0	1	15	0	0
8	16519782	.	C	T	19	7	26	0	0	26	0	0
8	16519821	.	G	A	23	8	31	0	1	32	0	0
8	16524401	.	G	C	6	0	6	0	4	10	0	0
8	16525504	.	T	A	5	3	8	0	0	8	0	0
8	16525519	.	A	G	6	2	8	0	0	8	0	0
8	16527055	.	C	G	2	5	7	0	0	7	0	0
8	16528390	.	T	G	6	2	8	0	0	8	0	0
8	16528454	.	C	T	0	2	2	0	5	7	0	0
8	16528475	.	C	T	0	3	3	0	4	7	0	0
8	16531802	.	C	T	4	2	6	0	0	6	0	0
8	16583174	.	C	A	17	16	33	1	2	36	0	0
8	16584037	.	C	T	4	19	23	15	20	58	0	0
8	16587964	.	A	T	19	16	35	0	0	35	0	0
8	16588421	.	C	T	22	10	32	1	0	33	0	0
8	16588444	.	G	A	16	10	26	1	2	29	0	0
8	16591864	.	A	G	12	9	21	0	2	23	0	0
8	16597589	.	T	A	6	5	11	0	0	11	0	0
8	16597986	.	G	A	4	13	17	0	0	17	0	0
8	16598076	.	C	T	0	9	9	0	6	15	0	0
8	16605597	.	A	G	7	7	14	0	0	14	0	0
8	16605615	.	G	A	6	7	13	0	0	13	0	0
8	16605678	.	G	A	4	3	7	0	0	7	0	0
8	16605723	.	G	A	6	6	12	0	0	12	0	0
8	16608875	.	G	A	2	2	4	0	0	4	0	0
8	16610107	.	T	C	9	1	10	0	3	13	0	0
8	16610387	.	G	A	4	8	12	0	3	15	0	0
8	16610585	.	T	C	3	6	9	0	1	10	0	0
8	16611008	.	A	G	5	2	7	0	0	7	0	0
8	16615866	.	T	C	6	7	13	0	1	14	0	0
8	16615867	.	A	G	7	7	14	0	0	14	0	0
8	16615929	.	A	T	15	14	29	0	4	33	0	0
8	16616190	.	C	A	14	12	26	0	0	26	0	0
8	16616697	.	C	T	2	20	22	0	22	44	0	0
8	16616899	.	G	A	17	16	33	0	0	33	0	0
8	16621919	.	A	G	14	17	31	0	0	31	0	0
8	16625575	.	C	A	8	11	19	0	0	19	0	0
8	16653843	.	A	G	4	6	10	0	0	10	0	0
8	16688316	.	T	G	2	2	4	0	0	4	0	0
8	17055727	.	C	T	1	19	20	0	31	51	0	0
8	17055751	.	C	T	22	15	37	0	13	50	0	0
8	17055766	.	G	A	22	22	44	0	3	47	0	0
8	17055802	.	C	T	1	24	25	0	24	49	0	0
8	17062173	.	G	A	26	16	42	0	2	44	0	0
8	17067268	.	A	T	11	20	31	0	3	34	0	0
8	17067269	.	T	C	23	9	32	0	2	34	0	0
8	17081728	.	G	T	12	13	25	0	1	26	0	0
8	17081734	.	G	A	12	13	25	0	2	27	0	0
8	17081976	.	C	T	10	14	24	0	0	24	0	0
8	17082696	.	C	A	10	10	20	0	0	20	0	0
8	17084696	.	G	C	17	30	47	0	2	49	0	0
8	17085921	.	G	A	18	14	32	0	4	36	0	0
8	17086033	.	C	T	9	5	14	0	1	15	0	0
8	17086043	.	C	T	12	3	15	0	1	16	0	0
8	17146845	.	T	G	3	3	6	0	0	6	0	0
8	17152826	.	A	G	4	7	11	0	0	11	0	0
8	17154080	.	A	C	2	4	6	0	0	6	0	0
8	17154128	.	A	G	2	0	2	0	8	10	0	0
8	17154188	.	C	T	9	3	12	0	0	12	0	0
8	17154406	.	T	C	6	3	9	0	0	9	0	0
8	17156641	.	A	G	3	3	6	0	0	6	0	0
8	17156772	.	G	C	4	3	7	0	0	7	0	0
8	17156806	.	A	G	7	5	12	0	0	12	0	0
8	17156869	.	C	T	7	7	14	0	0	14	0	0
8	17156950	.	T	A	6	5	11	0	0	11	0	0
8	17163611	.	A	G	12	9	21	0	1	22	0	0
8	17163704	.	C	T	8	10	18	0	0	18	0	0
8	17163766	.	T	A	14	9	23	0	2	25	0	0
8	17163771	.	A	G	14	9	23	0	2	25	0	0
8	17163847	.	C	G	1	14	15	0	13	28	0	0
8	17163852	.	C	T	13	16	29	0	0	29	0	0
8	17164208	.	G	A	25	14	39	0	2	41	0	0
8	17164302	.	A	G	33	19	52	0	2	54	0	0
8	17166577	.	C	T	18	11	29	0	1	30	0	0
8	17174965	.	G	C	1	4	5	0	0	5	0	0
8	17179051	.	G	C	1	3	4	0	0	4	0	0
8	17180814	.	C	T	0	3	3	0	2	5	0	0
8	17181187	.	T	C	1	0	1	0	4	5	0	0
8	17181190	.	T	A	0	3	3	0	2	5	0	0
8	17190086	.	C	T	3	1	4	0	1	5	0	0
8	17190095	.	A	G	3	0	3	0	2	5	0	0
8	17190299	.	C	T	2	4	6	0	0	6	0	0
8	17191921	.	A	G	3	4	7	0	1	8	0	0
8	17192538	.	C	G	4	0	4	0	3	7	0	0
8	17396186	.	T	G	25	16	41	0	2	43	0	0
8	17396566	.	T	C	0	4	4	0	0	4	0	0
8	17396567	.	C	T	1	4	5	0	0	5	0	0
8	17396815	.	T	A	10	1	11	2	1	14	0	0
8	17396904	.	T	C	22	0	22	0	8	30	0	0
8	17397095	.	C	T	5	2	7	0	0	7	0	0
8	17397780	.	T	C	3	2	5	0	1	6	0	0
8	17397793	.	T	A	4	4	8	0	0	8	0	0
8	17397995	.	A	T	11	11	22	0	0	22	0	0
8	17398070	.	T	C	12	10	22	0	2	24	0	0
8	17398113	.	C	T	2	7	9	0	7	16	0	0
8	17398277	.	G	A	5	7	12	0	0	12	0	0
8	17398712	.	G	A	8	7	15	0	0	15	0	0
8	17399061	.	C	T	6	4	10	1	0	11	0	0
8	17399609	.	C	T	16	16	32	0	1	33	0	0
8	17407150	.	G	A	7	4	11	0	0	11	0	0
8	17407210	.	C	G	1	5	6	0	6	12	0	0
8	17407258	.	T	C	13	0	13	0	7	20	0	0
8	17516363	.	G	A	1	4	5	0	0	5	0	0
8	17529521	.	C	T	2	2	4	0	0	4	0	0
8	17535026	.	C	A	1	2	3	0	0	3	0	0
8	17563237	.	A	G	6	11	17	0	3	20	0	0
8	17609003	.	C	T	4	6	10	0	1	11	0	0
8	17775655	.	A	C	2	2	4	0	0	4	0	0
8	17778843	.	G	C	3	7	10	0	0	10	0	0
8	17778864	.	C	T	4	2	6	0	0	6	0	0
8	17781076	.	G	A	1	5	6	0	6	12	0	0
8	17781096	.	C	A	5	5	10	0	2	12	0	0
8	17781537	.	T	C	9	4	13	0	1	14	0	0
8	17781576	.	T	C	9	1	10	0	3	13	0	0
8	17782436	.	G	T	1	2	3	0	0	3	0	0
8	17783703	.	G	T	4	4	8	0	0	8	0	0
8	17783775	.	C	T	2	7	9	0	0	9	0	0
8	17784308	.	A	G	6	9	15	0	0	15	0	0
8	17784322	.	T	A	6	9	15	0	0	15	0	0
8	17790323	.	C	T	2	3	5	0	0	5	0	0
8	17790883	.	A	C	1	0	1	0	3	4	0	0
8	17800833	.	A	G	2	3	5	0	0	5	0	0
8	17801060	.	C	T	1	5	6	0	0	6	0	0
8	17801078	.	T	A	1	3	4	0	0	4	0	0
8	17801438	.	A	G	5	3	8	0	0	8	0	0
8	17820740	.	G	A	3	2	5	0	0	5	0	0
8	17820773	.	T	C	3	2	5	0	0	5	0	0
8	17820839	.	C	G	3	3	6	0	0	6	0	0
8	17820846	.	G	A	4	2	6	0	1	7	0	0
8	17822149	.	C	G	7	3	10	0	0	10	0	0
8	17822181	.	G	A	5	4	9	0	0	9	0	0
8	17905324	.	A	C	1	4	5	0	0	5	0	0
8	17909833	.	C	T	3	2	5	0	1	6	0	0
8	17917301	.	C	T	3	2	5	0	0	5	0	0
8	17917305	.	G	A	0	2	2	0	3	5	0	0
8	17917388	.	T	C	3	2	5	1	0	8	2	0
8	17983718	.	G	C	3	2	5	0	0	5	0	0
8	17983938	.	T	G	1	2	3	0	0	3	0	0
8	18024959	.	C	T	16	13	29	0	1	30	0	0
8	18026052	.	G	A	1	5	6	0	16	22	0	0
8	18030857	.	C	T	11	10	21	0	1	22	0	0
8	18030884	.	G	A	14	10	24	0	0	24	0	0
8	18033113	.	T	C	10	3	13	0	4	17	0	0
8	18035129	.	A	T	15	17	32	0	2	34	0	0
8	18035428	.	G	A	18	13	31	0	2	33	0	0
8	18035786	.	C	T	13	15	28	0	1	29	0	0
8	18035946	.	T	A	5	13	18	0	0	18	0	0
8	18036167	.	T	C	5	12	17	0	0	17	0	0
8	18036592	.	G	A	8	6	14	0	1	15	0	0
8	18036610	.	C	T	8	4	12	0	0	12	0	0
8	18041925	.	A	C	1	0	1	0	3	4	0	0
8	18193373	.	C	G	13	6	19	0	0	19	0	0
8	18193420	.	C	G	7	6	13	0	0	13	0	0
8	18193503	.	G	T	4	7	11	0	0	11	0	0
8	18193591	.	A	T	10	13	23	0	0	23	0	0
8	18193628	.	T	C	20	21	41	0	0	41	0	0
8	18193707	.	T	C	20	19	39	0	1	40	0	0
8	18194238	.	T	C	16	17	33	0	0	33	0	0
8	18194283	.	G	A	23	16	39	1	3	43	0	0
8	18196444	.	C	T	1	16	17	0	20	37	0	0
8	18198801	.	C	T	15	16	31	0	3	34	0	0
8	18199999	.	A	G	7	4	11	0	0	11	0	0
8	18206787	.	T	C	1	3	4	0	0	4	0	0
8	18206793	.	A	G	2	3	5	0	0	5	0	0
8	18210162	.	G	T	1	3	4	0	0	4	0	0
8	18210185	.	A	G	2	3	5	0	0	5	0	0
8	18211605	.	T	A	0	2	2	0	1	3	0	0
8	18242651	.	A	G	1	1	2	0	1	3	0	0
8	18242762	.	G	T	2	2	4	0	0	4	0	0
8	18242977	.	C	A	2	3	5	0	0	5	0	0
8	18242978	.	A	C	2	3	5	0	0	5	0	0
8	18243082	.	C	A	1	2	3	0	0	3	0	0
8	18243564	.	C	T	1	4	5	0	0	5	0	0
8	18243578	.	C	T	2	3	5	0	1	6	0	0
8	18243633	.	C	T	4	3	7	0	1	8	0	0
8	18243671	.	G	T	4	4	8	0	0	8	0	0
8	18244042	.	G	A	1	2	3	0	0	3	0	0
8	18356524	.	G	A	15	11	26	0	0	26	0	0
8	18356688	.	G	A	9	7	16	0	1	17	0	0
8	18358694	.	T	G	6	3	9	0	1	10	0	0
8	18358709	.	T	C	4	5	9	0	0	9	0	0
8	18358760	.	C	A	5	7	12	0	0	12	0	0
8	18361223	.	G	A	8	7	15	0	0	15	0	0
8	18364066	.	G	A	4	4	8	0	0	8	0	0
8	18365788	.	C	T	5	3	8	0	0	8	0	0
8	18486731	.	T	C	1	2	3	0	0	3	0	0
8	18512015	.	A	T	9	3	12	0	0	12	0	0
8	18514407	.	C	T	1	2	3	1	0	4	0	0
8	18515741	.	A	G	4	1	5	0	0	5	0	0
8	18515751	.	C	A	0	2	2	0	2	4	0	0
8	18519279	.	T	C	0	2	2	0	1	3	0	0
8	18545641	.	A	T	4	4	8	0	0	8	0	0
8	18550469	.	T	A	4	2	6	0	0	6	0	0
8	18554720	.	G	T	13	7	20	0	0	20	0	0
8	18554825	.	T	C	11	12	23	0	1	24	0	0
8	18562153	.	A	G	15	20	35	0	0	35	0	0
8	18562225	.	C	A	20	16	36	0	0	36	0	0
8	18562283	.	G	A	3	17	20	0	17	37	0	0
8	18562317	.	C	T	12	16	28	0	2	30	0	0
8	18562570	.	C	T	3	17	20	0	0	20	0	0
8	18562950	.	T	C	3	3	6	0	0	6	0	0
8	18566278	.	G	A	11	7	18	0	3	21	0	0
8	18566327	.	C	A	7	9	16	0	0	16	0	0
8	18566419	.	T	A	12	11	23	0	2	25	0	0
8	18566466	.	A	T	8	7	15	0	1	16	0	0
8	18566615	.	T	G	12	11	23	0	1	24	0	0
8	18566669	.	C	T	17	12	29	0	3	32	0	0
8	18566687	.	T	C	17	14	31	0	3	34	0	0
8	18566970	.	C	A	16	7	23	0	3	26	0	0
8	18567230	.	G	A	5	5	10	0	8	18	0	0
8	18567260	.	A	G	3	10	13	0	8	21	0	0
8	18567453	.	A	G	12	12	24	0	1	25	0	0
8	18568167	.	G	T	11	5	16	0	2	18	0	0
8	18568189	.	C	A	14	7	21	0	0	21	0	0
8	18568264	.	T	A	10	4	14	0	1	15	0	0
8	18568350	.	C	G	9	11	20	0	0	20	0	0
8	18568468	.	A	T	6	6	12	1	1	14	0	0
8	18568473	.	T	G	6	6	12	1	0	13	0	0
8	18568527	.	C	T	5	3	8	0	0	8	0	0
8	18568571	.	T	G	5	8	13	0	2	15	0	0
8	18568677	.	C	T	0	9	9	0	18	27	0	0
8	18568687	.	A	G	20	12	32	0	0	32	0	0
8	18568852	.	T	C	7	0	7	0	8	15	0	0
8	18569039	.	T	C	3	2	5	0	1	6	0	0
8	18570116	.	A	T	4	4	8	0	0	8	0	0
8	18570117	.	C	G	0	4	4	0	4	8	0	0
8	18570190	.	G	C	5	5	10	0	0	10	0	0
8	18570201	.	C	T	5	4	9	0	1	10	0	0
8	18593094	.	C	T	1	6	7	0	0	7	0	0
8	18598306	.	C	T	8	9	17	0	1	18	0	0
8	18598333	.	A	T	7	8	15	0	0	15	0	0
8	18598391	.	T	A	5	13	18	1	0	19	0	0
8	18598593	.	C	G	6	6	12	0	0	12	0	0
8	18598628	.	A	T	4	11	15	0	6	21	0	0
8	18598915	.	A	G	9	12	21	0	0	21	0	0
8	18598920	.	G	C	11	12	23	0	0	23	0	0
8	18599014	.	G	T	0	16	16	0	12	28	0	0
8	18599088	.	C	A	8	12	20	0	0	20	0	0
8	18599235	.	G	A	4	3	7	0	0	7	0	0
8	18609265	.	A	T	11	5	16	0	0	16	0	0
8	18609272	.	C	A	10	7	17	0	1	18	0	0
8	18609308	.	C	T	7	7	14	0	0	14	0	0
8	18611048	.	G	A	8	7	15	0	0	15	0	0
8	18613661	.	A	T	4	4	8	0	0	8	0	0
8	18631208	.	C	T	2	2	4	0	0	4	0	0
8	18633221	.	C	T	6	3	9	0	1	10	0	0
8	18635266	.	G	A	3	3	6	0	1	7	0	0
8	18635278	.	T	C	2	3	5	0	0	5	0	0
8	18640339	.	T	C	6	7	13	0	0	13	0	0
8	18640342	.	T	C	5	7	12	0	0	12	0	0
8	18646867	.	T	G	6	9	15	0	0	15	0	0
8	18646894	.	C	T	7	10	17	0	1	18	0	0
8	18647113	.	T	C	8	5	13	0	0	13	0	0
8	18647252	.	A	G	12	4	16	0	0	16	0	0
8	18647298	.	G	A	13	4	17	0	1	18	0	0
8	18837255	.	C	A	2	2	4	0	0	4	0	0
8	18837494	.	C	A	11	6	17	0	0	17	0	0
8	18837533	.	A	G	13	7	20	0	0	20	0	0
8	18837864	.	C	T	6	12	18	0	0	18	0	0
8	18840330	.	C	T	7	13	20	0	0	20	0	0
8	18885207	.	G	A	4	5	9	0	1	10	0	0
8	18885507	.	G	A	3	4	7	0	0	7	0	0
8	18888742	.	G	A	5	3	8	0	0	8	0	0
8	18888748	.	G	A	4	4	8	0	0	8	0	0
8	18891001	.	G	A	2	3	5	0	0	5	0	0
8	18891033	.	T	A	5	3	8	0	0	8	0	0
8	18893166	.	G	T	5	6	11	0	0	11	0	0
8	18936643	.	A	C	7	3	10	0	1	11	0	0
8	18936665	.	C	T	5	4	9	0	0	9	0	0
8	18936754	.	C	T	7	4	11	0	0	11	0	0
8	18965152	.	A	C	2	3	5	0	1	6	0	0
8	18971535	.	C	T	0	5	5	0	5	10	0	0
8	18977632	.	C	T	7	4	11	0	0	11	0	0
8	18977684	.	A	C	6	0	6	0	3	9	0	0
8	18977710	.	T	G	5	3	8	0	0	8	0	0
8	19003298	.	T	G	2	4	6	0	0	6	0	0
8	19232258	.	A	C	4	4	8	0	0	8	0	0
8	19253718	.	G	A	9	5	14	0	2	16	0	0
8	19258719	.	C	T	1	5	6	0	5	11	0	0
8	19258761	.	G	A	8	5	13	0	0	13	0	0
8	19283418	.	A	C	1	6	7	0	0	7	0	0
8	19284169	.	A	G	6	5	11	0	0	11	0	0
8	19285193	.	C	T	3	6	9	0	1	10	0	0
8	19285261	.	A	G	2	4	6	0	0	6	0	0
8	19402136	.	G	T	7	11	18	0	0	18	0	0
8	19402363	.	A	G	16	18	34	0	3	37	0	0
8	19402374	.	C	T	1	19	20	0	18	38	0	0
8	19474072	.	T	C	9	0	9	0	9	18	0	0
8	19476600	.	A	G	9	5	14	0	0	14	0	0
8	19477798	.	C	T	2	15	17	0	2	19	0	0
8	19477928	.	A	G	7	9	16	0	1	17	0	0
8	19478140	.	C	T	6	9	15	0	0	15	0	0
8	19479784	.	A	G	3	3	6	0	1	7	0	0
8	19481987	.	G	A	6	4	10	0	0	10	0	0
8	19483818	.	G	A	4	4	8	0	0	8	0	0
8	19489979	.	G	A	1	4	5	0	1	6	0	0
8	19490196	.	T	G	3	0	3	0	4	7	0	0
8	19490204	.	A	G	3	3	6	0	0	6	0	0
8	19504144	.	A	G	12	10	22	0	0	22	0	0
8	19506793	.	C	T	11	7	18	5	0	23	0	0
8	19508927	.	A	G	17	11	28	0	1	29	0	0
8	19508961	.	C	A	15	13	28	0	1	29	0	0
8	19511480	.	G	A	2	11	13	0	9	22	0	0
8	19512186	.	A	G	13	0	13	0	10	23	0	0
8	19512187	.	C	A	13	10	23	0	0	23	0	0
8	19616700	.	G	A	0	2	2	0	1	3	0	0
8	19619309	.	G	A	2	2	4	0	0	4	0	0
8	19642555	.	A	T	3	4	7	0	0	7	0	0
8	19642570	.	C	A	2	5	7	0	0	7	0	0
8	19642764	.	A	C	8	0	8	0	5	13	0	0
8	19676049	.	A	C	1	3	4	0	0	4	0	0
8	19997858	.	A	T	1	3	4	0	0	4	0	0
8	19997914	.	G	A	1	3	4	0	0	4	0	0
8	19997918	.	A	G	1	2	3	0	0	3	0	0
8	19998074	.	T	C	3	3	6	0	0	6	0	0
8	19998254	.	G	T	0	3	3	1	7	11	0	0
8	20041185	.	A	G	3	0	3	0	2	5	0	0
8	20048330	.	G	A	1	4	5	0	0	5	0	0
8	20053564	.	C	T	1	2	3	0	0	3	0	0
8	20053600	.	G	A	1	2	3	0	0	3	0	0
8	20059115	.	T	C	3	3	6	0	0	6	0	0
8	20059302	.	A	C	6	5	11	0	0	11	0	0
8	20059401	.	C	T	3	2	5	0	0	5	0	0
8	20059563	.	C	A	0	2	2	0	1	3	0	0
8	20059860	.	T	A	3	2	5	0	0	5	0	0
8	20062344	.	C	T	4	3	7	1	0	8	0	0
8	20065519	.	T	G	3	0	3	0	6	9	0	0
8	20068125	.	T	C	3	7	10	0	0	10	0	0
8	20068366	.	T	C	4	4	8	0	0	8	0	0
8	20073872	.	G	C	1	3	4	0	0	4	0	0
8	20080039	.	A	G	2	1	3	0	1	4	0	0
8	20157840	.	A	G	7	6	13	0	1	14	0	0
8	20170561	.	C	T	8	13	21	0	0	21	0	0
8	20170672	.	T	C	6	6	12	0	0	12	0	0
8	20170795	.	T	C	8	14	22	0	1	23	0	0
8	20175907	.	A	C	9	8	17	0	2	19	0	0
8	20177126	.	C	G	10	0	10	0	8	18	0	0
8	20183420	.	T	C	5	14	19	0	1	20	0	0
8	20184545	.	A	G	8	11	19	0	0	19	0	0
8	20184698	.	T	C	15	12	27	0	0	27	0	0
8	20185652	.	A	G	11	2	13	0	18	31	0	0
8	20185664	.	A	G	10	1	11	0	14	25	0	0
8	20185694	.	C	T	11	12	23	0	0	23	0	0
8	20185718	.	G	T	13	16	29	0	0	29	0	0
8	20185793	.	G	A	2	15	17	0	10	27	0	0
8	20185796	.	G	C	11	16	27	0	0	27	0	0
8	20187793	.	T	C	12	10	22	0	1	23	0	0
8	20187829	.	A	T	12	12	24	0	1	25	0	0
8	20187835	.	A	G	11	0	11	0	14	25	0	0
8	20190489	.	A	G	14	12	26	0	2	28	0	0
8	20190764	.	G	C	10	16	26	0	0	26	0	0
8	20190790	.	T	C	11	25	36	0	0	36	0	0
8	20190809	.	G	C	14	29	43	0	0	43	0	0
8	20190876	.	A	G	17	16	33	0	1	34	0	0
8	20190967	.	G	A	1	21	22	0	19	41	0	0
8	20191067	.	T	C	7	15	22	0	0	22	0	0
8	20191286	.	A	G	14	1	15	0	23	38	0	0
8	20191301	.	C	A	16	17	33	0	3	36	0	0
8	20191354	.	A	G	21	10	31	0	3	34	0	0
8	20191561	.	A	G	18	23	41	0	3	44	0	0
8	20191651	.	T	C	14	19	33	0	4	37	0	0
8	20191965	.	T	A	20	21	41	0	0	41	0	0
8	20191999	.	C	T	13	16	29	0	0	29	0	0
8	20192046	.	A	G	19	0	19	0	14	33	0	0
8	20192049	.	G	A	20	14	34	0	1	35	0	0
8	20194246	.	C	T	1	2	3	0	0	3	0	0
8	20194583	.	C	T	8	6	14	0	0	14	0	0
8	20194647	.	T	C	11	7	18	0	1	19	0	0
8	20196748	.	A	T	2	3	5	0	1	6	0	0
8	20197237	.	A	G	1	3	4	0	2	6	0	0
8	20197240	.	A	T	2	4	6	0	0	6	0	0
8	20207147	.	A	C	3	2	5	0	0	5	0	0
8	20298639	.	G	A	2	2	4	0	0	4	0	0
8	20327539	.	T	C	1	2	3	0	1	4	0	0
8	20471391	.	C	T	2	5	7	0	1	8	0	0
8	20471480	.	C	T	4	6	10	0	0	10	0	0
8	20471508	.	T	A	5	5	10	0	0	10	0	0
8	20496037	.	T	C	6	5	11	0	0	11	0	0
8	20503515	.	C	T	8	3	11	0	1	12	0	0
8	20503697	.	A	G	8	4	12	0	0	12	0	0
8	20503829	.	C	T	2	3	5	0	0	5	0	0
8	20546122	.	T	C	13	15	28	0	1	29	0	0
8	20546182	.	T	C	17	10	27	0	3	30	0	0
8	20559241	.	G	A	18	21	39	0	2	41	0	0
8	20580318	.	T	G	2	2	4	0	1	5	0	0
8	20853149	.	A	G	8	9	17	0	1	18	0	0
8	20853314	.	A	G	11	11	22	0	0	22	0	0
8	20853335	.	A	T	11	11	22	0	1	23	0	0
8	20853803	.	G	A	9	7	16	0	1	17	0	0
8	20853900	.	G	A	9	11	20	0	0	20	0	0
8	20853951	.	G	C	5	6	11	0	0	11	0	0
8	20856365	.	T	G	9	14	23	0	2	25	0	0
8	20856383	.	G	A	13	14	27	0	0	27	0	0
8	20856505	.	A	G	7	10	17	0	2	19	0	0
8	20856643	.	G	A	4	10	14	0	4	18	0	0
8	20856646	.	C	A	13	7	20	0	0	20	0	0
8	20862385	.	C	A	2	4	6	0	0	6	0	0
8	20863117	.	A	G	5	4	9	0	1	10	0	0
8	20865545	.	A	C	5	12	17	0	2	19	0	0
8	20865557	.	A	T	13	4	17	0	0	17	0	0
8	20868122	.	G	A	6	6	12	0	1	13	0	0
8	20868167	.	T	A	8	9	17	0	2	19	0	0
8	20868191	.	G	A	10	8	18	0	0	18	0	0
8	20868203	.	C	A	10	8	18	0	0	18	0	0
8	20871596	.	A	G	4	10	14	0	0	14	0	0
8	20872987	.	G	T	5	13	18	0	0	18	0	0
8	20873116	.	T	C	14	11	25	0	0	25	0	0
8	21047673	.	G	T	3	2	5	0	0	5	0	0
8	21047698	.	C	G	3	5	8	0	0	8	0	0
8	21047824	.	C	A	9	3	12	0	0	12	0	0
8	21048116	.	G	A	3	2	5	0	0	5	0	0
8	21050616	.	T	A	2	2	4	0	0	4	0	0
8	21052672	.	G	A	1	6	7	0	0	7	0	0
8	21052694	.	A	G	3	7	10	0	0	10	0	0
8	21053030	.	G	A	7	11	18	0	0	18	0	0
8	21053084	.	A	T	7	4	11	0	3	14	0	0
8	21053122	.	G	A	4	11	15	0	1	16	0	0
8	21053345	.	T	C	8	1	9	0	7	16	0	0
8	21053371	.	G	A	5	8	13	0	0	13	0	0
8	21053404	.	T	C	3	3	6	0	1	7	0	0
8	21053744	.	G	A	10	7	17	0	0	17	0	0
8	21053754	.	A	G	11	7	18	0	3	21	0	0
8	21055186	.	C	A	2	5	7	2	0	9	0	0
8	21068401	.	G	A	2	5	7	0	1	8	0	0
8	21068694	.	C	T	6	3	9	0	0	9	0	0
8	21068849	.	C	T	2	5	7	0	0	7	0	0
8	21068865	.	C	T	0	3	3	0	3	6	0	0
8	21071433	.	G	A	12	9	21	0	0	21	0	0
8	21071672	.	T	C	3	0	3	0	4	7	0	0
8	21089923	.	A	T	1	2	3	1	0	4	0	0
8	21095288	.	G	A	7	5	12	0	0	12	0	0
8	21095439	.	G	C	11	6	17	0	0	17	0	0
8	21095504	.	A	C	12	9	21	0	1	22	0	0
8	21100075	.	G	A	8	4	12	0	0	12	0	0
8	21100096	.	A	G	6	3	9	0	0	9	0	0
8	21101847	.	G	A	4	4	8	0	0	8	0	0
8	21104853	.	G	T	3	2	5	0	0	5	0	0
8	21109948	.	C	A	2	5	7	0	0	7	0	0
8	21110008	.	A	T	1	1	2	0	1	3	0	0
8	21110074	.	A	G	9	15	24	0	1	25	0	0
8	21110172	.	C	T	9	7	16	0	0	16	0	0
8	21114444	.	C	T	5	10	15	0	2	17	0	0
8	21123607	.	T	C	4	3	7	0	1	8	0	0
8	21130158	.	G	A	3	6	9	0	0	9	0	0
8	21130888	.	A	C	0	2	2	0	0	2	0	0
8	21130910	.	C	T	2	2	4	0	0	4	0	0
8	21131432	.	G	A	3	5	8	0	0	8	0	0
8	21131443	.	G	A	2	3	5	0	1	6	0	0
8	21131702	.	A	G	3	3	6	0	0	6	0	0
8	21131996	.	A	G	2	0	2	0	2	4	0	0
8	21132300	.	C	T	8	16	24	0	2	26	0	0
8	21132318	.	G	A	18	9	27	0	1	28	0	0
8	21132538	.	C	G	13	10	23	0	0	24	1	0
8	21132599	.	G	A	1	12	13	0	8	21	0	0
8	21132648	.	T	C	10	9	19	0	0	19	0	0
8	21132696	.	C	T	11	16	27	0	0	27	0	0
8	21134088	.	G	T	18	19	37	0	1	38	0	0
8	21134536	.	T	C	19	19	38	0	2	40	0	0
8	21135606	.	T	C	10	3	13	0	1	14	0	0
8	21137733	.	T	C	2	8	10	0	0	10	0	0
8	21139950	.	C	A	1	5	6	0	8	14	0	0
8	21140121	.	G	C	3	0	3	0	7	10	0	0
8	21140175	.	G	T	2	7	9	0	0	9	0	0
8	21140181	.	G	T	2	5	7	0	1	8	0	0
8	21140215	.	T	G	4	3	7	0	0	7	0	0
8	21140286	.	C	T	1	4	5	0	2	7	0	0
8	21140313	.	A	C	3	0	3	0	2	5	0	0
8	21140433	.	G	A	2	4	6	0	0	6	0	0
8	21141055	.	G	C	1	2	3	0	1	4	0	0
8	21141072	.	A	G	2	2	4	0	1	5	0	0
8	21146324	.	C	T	3	5	8	0	0	8	0	0
8	21146373	.	G	A	0	6	6	0	4	10	0	0
8	21146789	.	C	T	3	3	6	0	1	7	0	0
8	21148814	.	G	A	5	2	7	0	0	7	0	0
8	21149051	.	G	A	2	4	6	0	0	6	0	0
8	21153088	.	G	T	4	5	9	0	1	10	0	0
8	21153257	.	A	T	3	3	6	0	0	6	0	0
8	21155392	.	T	G	3	5	8	0	0	8	0	0
8	21155439	.	G	A	2	9	11	0	0	11	0	0
8	21155445	.	A	G	2	8	10	0	0	10	0	0
8	21155864	.	A	G	6	9	15	0	0	15	0	0
8	21159168	.	G	T	0	2	2	0	1	3	0	0
8	21159196	.	A	G	9	8	17	0	0	17	0	0
8	21159288	.	A	G	7	12	19	0	0	19	0	0
8	21162056	.	C	T	6	7	13	0	2	15	0	0
8	21162161	.	C	T	15	11	26	0	0	26	0	0
8	21162191	.	C	T	17	12	29	0	0	29	0	0
8	21162284	.	A	G	10	0	10	0	16	26	0	0
8	21162318	.	T	C	8	18	26	0	3	29	0	0
8	21229867	.	T	C	13	10	23	0	1	24	0	0
8	21239835	.	A	C	10	11	21	0	0	21	0	0
8	21245422	.	T	C	3	2	5	0	0	5	0	0
8	21245463	.	C	A	1	2	3	0	0	3	0	0
8	21245803	.	C	T	5	4	9	0	1	10	0	0
8	21248852	.	C	A	25	19	44	0	2	46	0	0
8	21248879	.	G	A	28	19	47	0	1	48	0	0
8	21250132	.	T	A	26	14	40	0	0	40	0	0
8	21250553	.	T	C	14	5	19	1	4	24	0	0
8	21250558	.	G	A	10	10	20	1	6	27	0	0
8	21250709	.	C	A	16	17	33	0	2	35	0	0
8	21250897	.	G	A	1	7	8	0	6	14	0	0
8	21250982	.	G	A	15	5	20	0	0	20	0	0
8	21250988	.	C	T	15	4	19	0	0	19	0	0
8	21251241	.	G	A	24	27	51	0	3	54	0	0
8	21251325	.	C	A	23	25	48	0	1	49	0	0
8	21251456	.	T	G	33	13	46	1	0	47	0	0
8	21251561	.	G	A	2	19	21	0	29	50	0	0
8	21251623	.	A	G	10	0	10	0	9	19	0	0
8	21251820	.	A	T	18	11	29	0	1	30	0	0
8	21251856	.	G	A	14	10	24	0	0	24	0	0
8	21251993	.	A	C	6	6	12	0	1	13	0	0
8	21252125	.	A	T	24	18	42	0	1	43	0	0
8	21252155	.	T	C	27	23	50	0	1	51	0	0
8	21252215	.	A	T	28	21	49	0	2	51	0	0
8	21252237	.	T	C	23	21	44	0	3	47	0	0
8	21368584	.	A	G	1	2	3	0	0	3	0	0
8	21407066	.	G	A	2	2	4	0	0	4	0	0
8	21413092	.	G	A	2	2	4	0	0	4	0	0
8	21588443	.	G	T	2	5	7	0	3	10	0	0
8	21629342	.	G	C	1	4	5	0	0	5	0	0
8	21629800	.	T	G	8	0	8	0	15	23	0	0
8	21664443	.	C	T	12	7	19	0	0	19	0	0
8	21671568	.	G	A	1	8	9	0	12	21	0	0
8	21671593	.	A	T	9	7	16	0	2	18	0	0
8	21671769	.	G	A	3	4	7	0	0	7	0	0
8	21672085	.	A	C	8	3	11	1	1	13	0	0
8	21672280	.	T	A	6	5	11	0	0	11	0	0
8	21672329	.	T	A	10	7	17	0	0	17	0	0
8	21672605	.	A	G	8	6	14	0	0	14	0	0
8	21672637	.	A	T	12	5	17	0	0	17	0	0
8	21672688	.	T	G	4	11	15	0	1	16	0	0
8	21673516	.	G	A	3	13	16	0	10	26	0	0
8	21673629	.	T	G	10	5	15	0	0	15	0	0
8	21673650	.	G	T	9	4	13	0	1	14	0	0
8	21673789	.	T	G	11	0	11	0	6	17	0	0
8	21674080	.	G	T	5	8	13	0	1	14	0	0
8	21674141	.	A	G	4	5	9	0	1	10	0	0
8	21674499	.	T	C	1	4	5	0	0	5	0	0
8	21674662	.	T	C	6	4	10	0	0	10	0	0
8	21674795	.	A	C	10	4	14	0	1	15	0	0
8	21674815	.	A	T	11	7	18	0	0	18	0	0
8	21674841	.	A	G	10	0	10	0	11	21	0	0
8	21675000	.	G	A	17	5	22	0	0	22	0	0
8	21675054	.	A	G	16	0	16	0	0	16	0	0
8	21675208	.	T	C	7	5	12	0	0	12	0	0
8	21675745	.	G	A	8	6	14	0	0	14	0	0
8	21675755	.	A	G	5	8	13	0	0	13	0	0
8	21676136	.	A	G	2	3	5	0	0	5	0	0
8	21676137	.	A	G	2	3	5	0	0	5	0	0
8	21978302	.	A	C	3	2	5	0	0	5	0	0
8	21978306	.	G	A	2	2	4	0	0	4	0	0
8	21978455	.	A	G	2	3	5	0	0	5	0	0
8	21978475	.	A	G	3	3	6	0	0	6	0	0
8	21978645	.	T	C	4	2	6	0	0	6	0	0
8	21982767	.	C	T	3	3	6	0	0	6	0	0
8	21982860	.	T	A	6	2	8	0	0	8	0	0
8	22003593	.	G	T	1	2	3	0	0	3	0	0
8	22277346	.	T	C	1	2	3	0	0	3	0	0
8	22278411	.	T	C	3	3	6	0	1	7	0	0
8	22278456	.	G	T	5	3	8	0	1	9	0	0
8	22282096	.	T	A	7	3	10	0	0	10	0	0
8	22283782	.	G	A	7	3	10	0	0	10	0	0
8	22284266	.	C	T	7	8	15	0	0	15	0	0
8	22284316	.	C	T	6	5	11	0	1	12	0	0
8	22284379	.	T	G	7	8	15	0	0	15	0	0
8	22286820	.	G	A	12	13	25	0	1	26	0	0
8	22287063	.	A	C	8	0	8	0	13	21	0	0
8	22290136	.	C	T	1	3	4	0	0	4	0	0
8	22302712	.	C	T	3	3	6	0	0	6	0	0
8	22302716	.	G	A	2	4	6	0	0	6	0	0
8	22307003	.	C	T	3	2	5	0	0	5	0	0
8	22320748	.	A	G	6	5	11	0	0	11	0	0
8	22320853	.	C	T	2	3	5	0	0	5	0	0
8	22321217	.	A	G	2	6	8	0	0	8	0	0
8	22321242	.	G	A	2	3	5	0	0	5	0	0
8	22324449	.	T	C	2	4	6	0	0	6	0	0
8	22345353	.	C	G	2	5	7	0	0	7	0	0
8	22345517	.	G	A	2	2	4	0	4	8	0	0
8	22345520	.	G	A	5	2	7	0	0	7	0	0
8	22345747	.	A	C	5	4	9	0	0	9	0	0
8	22346508	.	T	C	3	4	7	0	0	7	0	0
8	22406886	.	A	G	1	3	4	0	0	4	0	0
8	22486369	.	T	C	2	5	7	0	0	7	0	0
8	22500274	.	C	T	0	6	6	0	1	7	0	0
8	22500293	.	C	T	5	3	8	0	0	8	0	0
8	22500436	.	G	A	6	2	8	0	0	8	0	0
8	22500739	.	G	A	9	7	16	0	0	16	0	0
8	22503494	.	G	T	2	5	7	0	1	8	0	0
8	22503725	.	T	G	3	6	9	0	0	9	0	0
8	22503748	.	C	T	2	4	6	0	0	6	0	0
8	22503782	.	C	T	0	2	2	0	2	4	0	0
8	22504329	.	C	G	3	4	7	0	0	7	0	0
8	22504337	.	A	C	2	5	7	0	0	7	0	0
8	22504424	.	T	A	5	4	9	0	1	10	0	0
8	22504463	.	T	A	5	5	10	0	0	10	0	0
8	22511045	.	G	A	2	3	5	0	0	5	0	0
8	22511252	.	A	T	8	5	13	0	0	13	0	0
8	22511375	.	C	T	7	4	11	0	0	11	0	0
8	22511387	.	G	A	8	3	11	0	0	11	0	0
8	22511471	.	C	T	10	8	18	0	0	18	0	0
8	22511518	.	C	T	2	5	7	0	8	15	0	0
8	22511551	.	C	A	7	3	10	0	1	11	0	0
8	22511718	.	G	A	1	3	4	0	0	4	0	0
8	22511945	.	T	G	5	6	11	0	1	12	0	0
8	22512537	.	T	G	5	2	7	0	1	8	0	0
8	22512881	.	G	A	3	2	5	0	0	5	0	0
8	22521792	.	G	C	9	6	15	0	1	16	0	0
8	22522035	.	G	A	18	22	40	3	7	50	0	0
8	22522136	.	A	G	21	23	44	1	2	47	0	0
8	22522385	.	T	C	9	0	9	0	10	19	0	0
8	22522397	.	G	A	6	7	13	0	0	13	0	0
8	22522742	.	T	C	16	17	33	0	1	34	0	0
8	22522744	.	A	G	18	16	34	0	1	35	0	0
8	22523010	.	A	T	22	15	37	0	0	37	0	0
8	22523118	.	G	A	13	21	34	0	0	34	0	0
8	22525228	.	G	A	21	12	33	0	0	33	0	0
8	22525336	.	G	A	26	19	45	0	2	47	0	0
8	22530423	.	T	C	14	14	28	0	1	29	0	0
8	22530633	.	A	G	18	13	31	0	0	31	0	0
8	22544985	.	G	A	3	5	8	0	1	9	0	0
8	22551311	.	G	A	4	3	7	0	0	7	0	0
8	22558686	.	T	A	2	2	4	0	0	4	0	0
8	22603951	.	C	T	3	8	11	0	0	11	0	0
8	22604028	.	C	T	5	4	9	0	0	9	0	0
8	22608378	.	C	T	7	4	11	0	0	11	0	0
8	22611837	.	C	T	8	9	17	0	0	17	0	0
8	22612068	.	C	A	6	5	11	0	0	11	0	0
8	22612069	.	C	A	5	5	10	0	0	10	0	0
8	22612158	.	A	C	5	11	16	0	2	18	0	0
8	22612227	.	A	T	5	5	10	0	0	10	0	0
8	22612258	.	G	A	4	7	11	0	0	11	0	0
8	22612328	.	A	G	4	3	7	0	0	7	0	0
8	22612329	.	C	T	4	3	7	0	0	7	0	0
8	22612608	.	T	C	7	5	12	0	0	12	0	0
8	22612638	.	T	C	3	3	6	0	0	6	0	0
8	22612712	.	C	T	6	3	9	0	1	10	0	0
8	22612869	.	C	A	3	10	13	0	0	13	0	0
8	22612917	.	T	G	10	3	13	0	0	13	0	0
8	22613136	.	C	T	6	8	14	0	1	15	0	0
8	22613346	.	G	T	8	5	13	0	0	13	0	0
8	22613404	.	T	C	4	1	5	0	5	10	0	0
8	22613419	.	C	A	3	3	6	0	4	10	0	0
8	22613493	.	G	A	8	7	15	0	0	15	0	0
8	22613553	.	A	G	5	7	12	0	0	12	0	0
8	22619110	.	G	A	23	23	46	0	2	48	0	0
8	22619669	.	G	A	6	14	20	0	13	33	0	0
8	22622632	.	G	C	12	7	19	0	0	19	0	0
8	22622674	.	A	T	14	6	20	0	0	20	0	0
8	22622712	.	C	T	2	13	15	0	11	26	0	0
8	22624324	.	C	A	2	13	15	0	8	23	0	0
8	22631760	.	T	A	13	7	20	0	2	22	0	0
8	22631775	.	T	C	9	13	22	0	0	22	0	0
8	22631865	.	A	G	6	9	15	0	2	17	0	0
8	22631898	.	C	A	0	15	15	0	9	24	0	0
8	22632185	.	G	A	15	6	21	0	1	22	0	0
8	22632213	.	A	G	11	6	17	0	1	18	0	0
8	22632249	.	A	G	9	5	14	0	1	15	0	0
8	22635807	.	C	T	1	5	6	0	6	12	0	0
8	22637674	.	G	A	6	5	11	0	1	12	0	0
8	22762442	.	A	G	9	5	14	0	0	14	0	0
8	22766529	.	A	C	4	3	7	0	0	7	0	0
8	22766857	.	A	G	3	5	8	0	0	8	0	0
8	22787579	.	T	A	5	2	7	0	0	7	0	0
8	22787968	.	C	A	2	5	7	0	0	7	0	0
8	22788116	.	G	A	6	2	8	0	0	8	0	0
8	22788410	.	A	T	1	2	3	0	1	4	0	0
8	22788511	.	A	G	4	7	11	0	0	11	0	0
8	22788583	.	T	G	3	4	7	0	0	7	0	0
8	22788956	.	A	G	2	2	4	0	0	4	0	0
8	22788994	.	C	T	7	4	11	0	0	11	0	0
8	22916188	.	G	A	2	2	4	0	0	4	0	0
8	22926876	.	A	C	2	3	5	0	1	6	0	0
8	22926934	.	T	C	4	5	9	0	0	9	0	0
8	22931400	.	T	G	1	0	1	0	3	4	0	0
8	22945179	.	G	T	22	25	47	0	4	51	0	0
8	22945572	.	T	C	24	30	54	0	0	54	0	0
8	22945605	.	T	C	29	25	54	0	2	56	0	0
8	22946780	.	T	C	20	24	44	0	0	44	0	0
8	22946987	.	G	C	33	30	63	0	0	63	0	0
8	22947209	.	C	T	37	29	66	0	7	73	0	0
8	22950810	.	C	G	7	16	23	0	0	23	0	0
8	22951053	.	G	A	36	18	54	0	6	60	0	0
8	22951054	.	C	G	36	24	60	0	0	60	0	0
8	22951364	.	A	T	34	14	48	0	3	51	0	0
8	22951406	.	T	A	17	20	37	0	17	54	0	0
8	22951691	.	A	T	28	22	50	0	0	50	0	0
8	22951847	.	A	T	29	32	61	0	2	63	0	0
8	22951880	.	A	G	26	28	54	0	2	56	0	0
8	22951919	.	C	T	27	30	57	0	3	60	0	0
8	22952243	.	T	A	36	39	75	0	1	76	0	0
8	22952330	.	A	T	34	34	68	0	4	72	0	0
8	22953203	.	T	A	2	2	4	0	0	4	0	0
8	22985426	.	G	A	2	2	4	0	0	4	0	0
8	22985516	.	G	C	5	2	7	0	0	7	0	0
8	23040902	.	G	A	9	12	21	0	2	23	0	0
8	23040913	.	G	C	9	13	22	0	1	23	0	0
8	23041461	.	C	T	0	6	6	0	17	23	0	0
8	23044374	.	C	G	1	8	9	0	10	19	0	0
8	23044752	.	A	G	10	9	19	0	0	19	0	0
8	23056164	.	T	A	9	6	15	0	0	15	0	0
8	23081314	.	T	C	6	0	6	0	7	13	0	0
8	23101463	.	A	G	9	9	18	0	0	18	0	0
8	23102846	.	C	T	7	6	13	0	0	13	0	0
8	23102951	.	T	A	9	5	14	0	1	15	0	0
8	23103153	.	T	C	1	4	5	0	1	6	0	0
8	23103307	.	C	T	4	10	14	0	1	15	0	0
8	23103379	.	T	C	2	8	10	0	1	11	0	0
8	23109443	.	G	A	10	7	17	0	0	17	0	0
8	23109890	.	T	C	10	9	19	0	1	20	0	0
8	23110301	.	T	A	17	18	35	0	0	36	1	0
8	23110475	.	A	G	9	13	22	0	0	22	0	0
8	23118396	.	A	G	7	10	17	0	1	18	0	0
8	23118830	.	T	C	13	17	30	0	1	31	0	0
8	23119524	.	C	A	14	13	27	0	2	29	0	0
8	23122210	.	T	G	2	5	7	0	0	7	0	0
8	23122348	.	A	G	9	9	18	0	0	18	0	0
8	23147528	.	C	T	1	3	4	0	0	4	0	0
8	23147536	.	G	A	1	3	4	0	0	4	0	0
8	23147682	.	C	G	7	4	11	0	0	11	0	0
8	23147794	.	C	T	1	3	4	0	0	4	0	0
8	23149815	.	C	G	6	18	24	1	0	25	0	0
8	23151375	.	C	T	3	18	21	0	1	22	0	0
8	23151428	.	T	A	4	10	14	0	1	15	0	0
8	23177298	.	C	T	24	20	44	0	4	48	0	0
8	23194322	.	A	T	7	5	12	0	1	13	0	0
8	23202689	.	C	T	7	7	14	0	0	14	0	0
8	23202730	.	T	C	4	8	12	0	0	12	0	0
8	23202757	.	C	T	3	7	10	0	1	11	0	0
8	23206939	.	C	T	10	10	20	0	1	21	0	0
8	23210432	.	C	T	19	15	34	0	2	36	0	0
8	23210441	.	T	C	22	13	35	0	2	37	0	0
8	23210598	.	G	C	16	15	31	0	0	31	0	0
8	23210767	.	G	A	9	6	15	0	0	15	0	0
8	23210832	.	A	T	7	7	14	0	0	14	0	0
8	23210857	.	A	G	8	8	16	0	1	17	0	0
8	23210944	.	T	C	14	7	21	0	0	21	0	0
8	23210955	.	C	T	15	7	22	0	0	22	0	0
8	23211109	.	G	T	14	10	24	0	2	26	0	0
8	23211200	.	G	T	14	10	24	0	1	25	0	0
8	23211519	.	T	C	4	5	9	0	1	10	0	0
8	23211527	.	G	A	4	4	8	0	1	9	0	0
8	23211615	.	A	G	3	0	3	0	3	6	0	0
8	23215631	.	C	T	6	5	11	0	0	11	0	0
8	23215634	.	C	T	8	5	13	0	1	14	0	0
8	23215697	.	G	A	0	5	5	0	11	16	0	0
8	23215762	.	T	C	12	3	15	0	0	15	0	0
8	23253068	.	T	A	2	3	5	0	1	6	0	0
8	23253118	.	T	C	5	4	9	0	0	9	0	0
8	23253169	.	T	C	4	4	8	0	0	8	0	0
8	23253200	.	A	G	1	2	3	0	0	3	0	0
8	23253843	.	A	G	2	4	6	0	0	6	0	0
8	23253892	.	A	G	3	5	8	0	0	8	0	0
8	23256703	.	C	T	1	2	3	0	0	3	0	0
8	23261031	.	A	G	3	3	6	0	1	7	0	0
8	23286153	.	G	A	2	3	5	0	2	7	0	0
8	23384075	.	G	A	0	2	2	0	2	4	0	0
8	23388348	.	T	C	4	1	5	0	1	6	0	0
8	23389736	.	G	A	2	4	6	0	0	6	0	0
8	23389781	.	T	A	4	3	7	0	0	7	0	0
8	23390197	.	T	A	1	3	4	0	0	4	0	0
8	23415717	.	A	G	7	5	12	0	1	13	0	0
8	23553476	.	A	G	5	7	12	0	1	13	0	0
8	23553749	.	A	C	4	2	6	0	2	8	0	0
8	23553785	.	A	G	4	3	7	0	0	7	0	0
8	23567670	.	T	C	1	2	3	0	0	3	0	0
8	23567740	.	G	T	1	1	2	0	1	3	0	0
8	23567780	.	T	G	0	2	2	0	1	3	0	0
8	23580286	.	C	A	3	2	5	0	0	5	0	0
8	23580389	.	C	T	1	2	3	0	0	3	0	0
8	23580396	.	C	T	1	2	3	0	0	3	0	0
8	23615202	.	T	A	2	7	9	0	0	9	0	0
8	23615206	.	A	T	2	6	8	0	1	9	0	0
8	23615247	.	C	T	4	5	9	0	0	9	0	0
8	23615456	.	C	T	7	2	9	0	0	9	0	0
8	23617372	.	C	T	4	5	9	0	0	9	0	0
8	23620494	.	G	A	10	9	19	0	0	19	0	0
8	23627494	.	T	C	6	7	13	0	0	13	0	0
8	23636923	.	C	T	7	4	11	0	1	12	0	0
8	23636973	.	T	G	1	3	4	0	0	4	0	0
8	23637140	.	A	G	6	6	12	0	0	12	0	0
8	23637751	.	T	C	2	2	4	0	0	4	0	0
8	23639214	.	T	G	3	4	7	0	0	7	0	0
8	23639298	.	C	A	3	3	6	0	1	7	0	0
8	23639301	.	T	C	3	4	7	0	0	7	0	0
8	23640048	.	A	G	2	0	2	0	2	4	0	0
8	23644351	.	C	A	3	4	7	0	1	8	0	0
8	23644363	.	T	A	3	3	6	0	0	6	0	0
8	23647323	.	G	C	5	4	9	0	0	9	0	0
8	23647389	.	T	A	5	5	10	0	1	11	0	0
8	23648725	.	G	A	13	7	20	0	2	22	0	0
8	23648753	.	T	C	10	9	19	0	0	19	0	0
8	23651328	.	C	T	13	4	17	0	0	17	0	0
8	23651370	.	C	T	8	3	11	0	0	11	0	0
8	23651397	.	G	A	1	4	5	0	7	12	0	0
8	23655968	.	C	T	9	3	12	0	0	12	0	0
8	23656058	.	G	A	2	5	7	0	0	7	0	0
8	23656125	.	G	T	7	8	15	0	2	17	0	0
8	23656151	.	C	T	14	8	22	0	1	23	0	0
8	23656212	.	A	T	11	7	18	0	1	19	0	0
8	23656321	.	C	A	8	8	16	0	0	16	0	0
8	23666962	.	T	C	5	3	8	0	0	8	0	0
8	23667281	.	T	C	3	7	10	0	0	10	0	0
8	23667290	.	A	G	1	0	1	0	7	8	0	0
8	23667549	.	T	C	3	3	6	0	0	6	0	0
8	23667810	.	T	C	4	4	8	0	2	10	0	0
8	23668371	.	A	T	4	4	8	0	0	8	0	0
8	23668623	.	G	C	7	4	11	0	1	12	0	0
8	23669307	.	T	C	11	4	15	0	0	15	0	0
8	23669451	.	A	G	3	4	7	0	0	7	0	0
8	23669617	.	T	C	9	9	18	0	2	20	0	0
8	23669885	.	G	T	5	8	13	0	1	14	0	0
8	23670019	.	T	C	2	4	6	0	1	7	0	0
8	23670246	.	T	G	3	0	3	0	4	7	0	0
8	23672505	.	C	T	2	2	4	0	0	4	0	0
8	23673133	.	G	T	3	2	5	0	0	5	0	0
8	23703754	.	C	T	1	3	4	0	0	4	0	0
8	23703775	.	T	A	1	3	4	0	0	4	0	0
8	23711867	.	G	A	3	6	9	0	0	9	0	0
8	23711882	.	C	T	3	5	8	0	0	8	0	0
8	23711985	.	G	A	5	3	8	0	0	8	0	0
8	23712098	.	C	T	3	4	7	0	0	7	0	0
8	23713465	.	G	A	3	4	7	0	1	8	0	0
8	23713578	.	T	C	1	2	3	0	0	3	0	0
8	23723621	.	C	T	3	4	7	0	0	7	0	0
8	23723736	.	G	A	1	2	3	0	0	3	0	0
8	23723762	.	G	A	1	4	5	0	0	5	0	0
8	23724045	.	A	C	7	3	10	0	1	11	0	0
8	23724752	.	A	T	1	3	4	0	1	5	0	0
8	23735856	.	C	T	5	2	7	0	0	7	0	0
8	23738160	.	C	G	13	9	22	0	1	23	0	0
8	23740148	.	T	C	7	8	15	0	0	15	0	0
8	23740519	.	G	A	32	27	59	0	4	63	0	0
8	23742978	.	G	A	2	4	6	0	4	10	0	0
8	23753566	.	T	A	3	7	10	0	0	10	0	0
8	23753793	.	C	T	0	2	2	0	5	7	0	0
8	23753834	.	C	G	0	2	2	0	5	7	0	0
8	23753934	.	G	A	4	4	8	1	1	10	0	0
8	23756172	.	C	T	1	4	5	0	4	9	0	0
8	23756557	.	G	A	10	13	23	0	0	23	0	0
8	23756680	.	T	A	4	7	11	0	0	11	0	0
8	23760297	.	C	T	0	3	3	0	9	12	0	0
8	23760323	.	G	A	8	3	11	0	0	11	0	0
8	23763809	.	T	C	1	4	5	0	0	5	0	0
8	23765199	.	T	C	3	4	7	0	0	7	0	0
8	23781194	.	G	A	4	4	8	0	0	8	0	0
8	23781195	.	C	A	4	4	8	0	0	8	0	0
8	23781425	.	A	G	1	0	1	0	3	4	0	0
8	23781426	.	A	G	1	2	3	0	1	4	0	0
8	23827610	.	C	T	5	4	9	0	1	10	0	0
8	23827617	.	G	A	6	3	9	0	1	10	0	0
8	23827665	.	A	G	7	0	7	0	3	10	0	0
8	23827670	.	C	T	7	3	10	0	0	10	0	0
8	23857845	.	T	C	12	7	19	0	2	21	0	0
8	23857997	.	G	A	8	5	13	0	0	13	0	0
8	23860391	.	T	G	9	6	15	0	0	15	0	0
8	23860641	.	G	T	2	3	5	0	6	11	0	0
8	23865804	.	A	C	7	4	11	0	1	12	0	0
8	23865837	.	A	G	3	4	7	0	1	8	0	0
8	23867417	.	A	G	1	8	9	0	0	9	0	0
8	23868598	.	T	C	7	10	17	0	0	17	0	0
8	23871782	.	C	T	7	12	19	0	1	20	0	0
8	23878905	.	T	A	9	11	20	0	1	21	0	0
8	23878994	.	G	A	8	15	23	0	0	23	0	0
8	23879044	.	T	A	12	6	18	0	0	18	0	0
8	23879238	.	T	A	9	13	22	0	1	23	0	0
8	23879365	.	G	A	8	9	17	0	1	18	0	0
8	23879461	.	C	T	6	2	8	0	0	8	0	0
8	23961168	.	G	T	3	3	6	0	0	6	0	0
8	24108749	.	T	G	2	2	4	0	1	5	0	0
8	24109195	.	A	T	6	11	17	0	0	17	0	0
8	24109336	.	A	G	5	10	15	0	0	15	0	0
8	24109399	.	A	G	5	11	16	0	1	17	0	0
8	24109496	.	C	T	0	6	6	0	10	16	0	0
8	24109693	.	A	G	11	8	19	0	0	19	0	0
8	24109787	.	C	T	7	9	16	0	0	16	0	0
8	24109879	.	G	A	4	5	9	0	0	9	0	0
8	24110817	.	A	G	5	7	12	0	0	12	0	0
8	24111073	.	A	G	4	4	8	0	0	8	0	0
8	24113519	.	G	C	7	5	12	0	0	12	0	0
8	24120176	.	T	A	6	3	9	0	0	9	0	0
8	24120187	.	A	T	6	4	10	0	0	10	0	0
8	24123072	.	C	T	1	2	3	0	1	4	0	0
8	24123161	.	G	T	3	3	6	0	1	7	0	0
8	24135022	.	G	A	4	6	10	0	0	10	0	0
8	24282240	.	C	T	1	2	3	0	2	5	0	0
8	24295076	.	G	A	0	2	2	0	3	5	0	0
8	24303878	.	T	C	1	2	3	0	0	3	0	0
8	24304419	.	T	C	1	4	5	0	0	5	0	0
8	24310532	.	T	G	5	2	7	0	0	7	0	0
8	24313399	.	T	C	1	5	6	0	0	6	0	0
8	24314382	.	G	A	0	3	3	0	3	6	0	0
8	24315553	.	T	C	3	4	7	0	0	7	0	0
8	24318472	.	G	A	4	3	7	0	0	7	0	0
8	24322223	.	G	A	4	1	5	2	0	7	0	0
8	24322229	.	G	T	5	2	7	1	0	8	0	0
8	24322489	.	T	C	5	12	17	0	1	18	0	0
8	24323336	.	T	C	8	6	14	0	0	14	0	0
8	24325254	.	G	A	9	11	20	0	2	22	0	0
8	24325594	.	G	T	2	3	5	0	0	5	0	0
8	24740093	.	T	A	5	4	9	0	0	9	0	0
8	24740094	.	A	C	5	4	9	0	0	9	0	0
8	24740168	.	C	A	15	15	30	0	1	31	0	0
8	24741031	.	A	T	6	7	13	0	0	13	0	0
8	24743676	.	A	T	6	14	20	0	0	20	0	0
8	24743696	.	T	G	4	0	4	0	17	21	0	0
8	24743756	.	A	C	1	3	4	0	0	4	0	0
8	24743823	.	C	A	3	5	8	0	0	8	0	0
8	24743969	.	T	A	2	4	6	0	0	6	0	0
8	24789324	.	C	T	2	16	18	0	6	24	0	0
8	24789513	.	T	G	9	7	16	0	2	18	0	0
8	24790139	.	A	G	3	7	10	0	0	10	0	0
8	24790724	.	C	T	6	7	13	0	0	13	0	0
8	24854637	.	G	A	5	4	9	0	0	9	0	0
8	24880304	.	C	T	5	2	7	0	1	8	0	0
8	24883487	.	T	C	5	4	9	0	0	9	0	0
8	24883577	.	C	T	7	2	9	0	0	9	0	0
8	24883873	.	C	T	6	4	10	0	0	10	0	0
8	24883975	.	A	G	4	4	8	0	0	8	0	0
8	24886194	.	T	C	4	7	11	0	0	11	0	0
8	24886251	.	A	G	4	5	9	0	0	9	0	0
8	24889230	.	G	A	1	11	12	0	23	35	0	0
8	24889403	.	C	T	14	13	27	0	1	28	0	0
8	24889468	.	C	T	14	11	25	1	1	27	0	0
8	24889482	.	A	T	14	8	22	1	0	23	0	0
8	24889586	.	C	T	12	16	28	0	0	28	0	0
8	24889609	.	T	A	15	11	26	0	5	31	0	0
8	24889674	.	C	T	16	16	32	0	5	37	0	0
8	24890084	.	T	A	13	6	19	4	1	24	0	0
8	24890798	.	C	T	3	3	6	0	0	6	0	0
8	24890891	.	C	T	11	8	19	0	0	19	0	0
8	24938274	.	C	T	4	4	8	0	0	8	0	0
8	24964775	.	G	A	2	2	4	0	0	4	0	0
8	24972006	.	T	C	17	17	34	0	3	37	0	0
8	24972594	.	T	C	15	21	36	0	0	36	0	0
8	24972595	.	T	A	16	20	36	0	1	37	0	0
8	24972665	.	T	C	16	21	37	0	1	38	0	0
8	24972743	.	C	T	3	17	20	0	21	41	0	0
8	24972776	.	C	T	3	12	15	0	23	38	0	0
8	24973010	.	T	A	20	20	40	0	1	41	0	0
8	24973116	.	C	G	11	13	24	0	0	24	0	0
8	24973276	.	A	G	11	14	25	0	0	25	0	0
8	24973462	.	A	G	7	10	17	1	1	19	0	0
8	24983245	.	C	G	1	31	32	0	13	45	0	0
8	24985735	.	T	C	14	13	27	0	0	27	0	0
8	24985741	.	G	C	15	15	30	0	0	30	0	0
8	24986965	.	G	A	12	13	25	0	1	26	0	0
8	24991169	.	G	A	6	10	16	0	0	16	0	0
8	25028646	.	A	G	3	5	8	0	0	8	0	0
8	25036367	.	A	T	9	4	13	1	0	14	0	0
8	25036493	.	C	T	7	3	10	0	0	10	0	0
8	25036520	.	T	C	5	3	8	0	0	8	0	0
8	25036551	.	T	A	2	4	6	0	1	7	0	0
8	25036679	.	T	A	5	7	12	1	3	16	0	0
8	25036694	.	C	G	7	11	18	1	0	19	0	0
8	25039704	.	T	C	6	8	14	0	0	14	0	0
8	25039840	.	T	C	4	5	9	0	0	9	0	0
8	25040349	.	A	G	5	4	9	0	1	10	0	0
8	25040479	.	T	C	1	3	4	0	0	4	0	0
8	25040499	.	T	G	2	2	4	0	0	4	0	0
8	25041986	.	G	A	1	6	7	0	2	9	0	0
8	25042447	.	T	C	9	9	18	0	2	20	0	0
8	25042578	.	A	G	15	7	22	1	0	23	0	0
8	25043021	.	A	G	4	7	11	9	4	24	0	0
8	25043112	.	T	G	10	14	24	0	2	26	0	0
8	25044564	.	C	G	1	11	12	0	11	23	0	0
8	25044591	.	C	T	0	8	8	0	15	23	0	0
8	25045766	.	T	C	8	11	19	0	1	20	0	0
8	25055972	.	G	T	5	7	12	0	1	13	0	0
8	25056041	.	T	C	6	0	6	0	4	10	0	0
8	25074028	.	T	C	1	3	4	0	1	5	0	0
8	25074042	.	A	C	2	3	5	0	0	5	0	0
8	25094117	.	A	G	5	0	5	0	3	8	0	0
8	25094247	.	G	A	1	5	6	0	11	17	0	0
8	25094248	.	A	T	11	5	16	0	1	17	0	0
8	25094288	.	C	T	8	3	11	0	0	11	0	0
8	25094326	.	A	C	6	3	9	0	0	9	0	0
8	25094389	.	A	G	2	0	2	0	3	5	0	0
8	25097206	.	T	C	2	2	4	0	0	4	0	0
8	25103719	.	T	C	11	6	17	0	0	17	0	0
8	25103731	.	T	C	10	7	17	0	1	18	0	0
8	25103887	.	G	A	6	7	13	0	0	13	0	0
8	25117654	.	T	C	8	5	13	0	0	13	0	0
8	25117981	.	G	A	5	3	8	0	0	8	0	0
8	25117990	.	T	C	4	5	9	0	0	9	0	0
8	25118128	.	C	T	3	10	13	0	0	13	0	0
8	25176250	.	T	C	12	6	18	0	0	18	0	0
8	25177264	.	G	C	11	6	17	0	0	17	0	0
8	25177501	.	T	G	5	4	9	0	1	10	0	0
8	25269942	.	G	A	5	4	9	0	0	9	0	0
8	25269993	.	G	A	8	4	12	0	1	13	0	0
8	25270753	.	G	C	0	5	5	0	3	8	0	0
8	25271550	.	G	A	1	3	4	0	1	5	0	0
8	25272507	.	C	T	6	8	14	0	0	14	0	0
8	25277047	.	G	A	1	9	10	0	9	19	0	0
8	25280807	.	C	T	9	5	14	0	1	15	0	0
8	25280849	.	C	T	5	7	12	0	0	12	0	0
8	25283346	.	T	G	7	1	8	0	11	19	0	0
8	25283768	.	A	G	12	11	23	0	2	25	0	0
8	25283771	.	T	C	12	11	23	0	3	26	0	0
8	25288980	.	T	C	7	12	19	0	0	19	0	0
8	25289180	.	C	T	10	16	26	0	0	26	0	0
8	25291308	.	C	T	14	12	26	0	1	27	0	0
8	25291478	.	A	T	12	6	18	1	0	19	0	0
8	25291573	.	C	A	6	7	13	0	2	15	0	0
8	25291839	.	T	C	21	9	30	0	1	31	0	0
8	25291876	.	A	G	19	11	30	0	3	33	0	0
8	25292020	.	A	T	25	24	49	0	1	50	0	0
8	25292188	.	C	T	5	6	11	0	0	11	0	0
8	25292274	.	G	A	1	9	10	0	15	25	0	0
8	25292330	.	C	T	16	11	27	0	0	27	0	0
8	25292370	.	A	G	7	27	34	0	2	36	0	0
8	25292482	.	T	C	20	8	28	0	3	31	0	0
8	25292492	.	A	T	24	10	34	0	0	34	0	0
8	25292608	.	T	C	28	16	44	0	0	44	0	0
8	25292865	.	G	C	15	19	34	0	0	34	0	0
8	25293008	.	A	G	18	17	35	1	2	38	0	0
8	25293064	.	C	T	15	21	36	1	1	38	0	0
8	25293111	.	G	T	11	21	32	0	4	37	1	0
8	25293145	.	C	T	31	14	45	0	1	46	0	0
8	25293184	.	C	T	15	25	40	0	2	42	0	0
8	25293225	.	T	A	15	10	25	0	1	27	1	0
8	25293346	.	C	T	10	19	29	0	0	29	0	0
8	25295219	.	A	T	7	4	11	0	0	11	0	0
8	25297326	.	A	G	18	0	18	0	27	45	0	0
8	25297617	.	G	C	9	18	27	0	0	27	0	0
8	25297741	.	C	T	5	21	26	0	1	27	0	0
8	25299819	.	A	G	1	4	5	0	0	5	0	0
8	25300974	.	A	T	9	3	12	0	0	12	0	0
8	25301389	.	G	A	0	5	5	0	1	6	0	0
8	25330065	.	T	A	13	12	25	0	0	26	1	0
8	25330181	.	C	T	7	6	13	0	0	13	0	0
8	25332708	.	C	T	35	36	71	0	2	73	0	0
8	25332900	.	A	G	30	37	67	0	2	69	0	0
8	25332945	.	G	A	27	37	64	0	0	64	0	0
8	25335063	.	G	A	32	28	60	0	1	61	0	0
8	25336097	.	T	A	21	32	53	0	6	59	0	0
8	25336102	.	T	G	20	37	57	0	2	59	0	0
8	25336175	.	A	G	1	4	5	0	0	5	0	0
8	25366990	.	T	A	5	2	7	0	0	7	0	0
8	25368613	.	G	A	6	8	14	0	0	14	0	0
8	25370776	.	T	C	12	10	22	1	0	23	0	0
8	25424272	.	C	T	6	6	12	0	4	16	0	0
8	25424411	.	T	A	8	9	17	0	0	18	1	0
8	25424658	.	G	A	2	4	6	0	1	7	0	0
8	25425033	.	T	C	7	4	11	0	0	11	0	0
8	25425103	.	A	G	3	4	7	0	0	7	0	0
8	25425137	.	C	T	4	5	9	0	0	9	0	0
8	25425311	.	T	C	3	3	6	0	0	6	0	0
8	25425395	.	G	A	2	2	4	0	0	4	0	0
8	25426338	.	T	G	3	5	8	0	0	8	0	0
8	25426521	.	T	A	2	3	5	0	0	5	0	0
8	25433771	.	A	G	1	2	3	0	1	4	0	0
8	25452003	.	G	A	2	3	5	0	0	5	0	0
8	25452089	.	G	A	1	4	5	0	0	5	0	0
8	25455977	.	C	T	0	2	2	0	2	4	0	0
8	25708263	.	A	G	3	6	9	0	0	9	0	0
8	25708311	.	C	T	6	3	9	0	1	10	0	0
8	25709085	.	T	G	16	6	22	0	1	23	0	0
8	25709694	.	T	G	8	15	23	0	0	23	0	0
8	25712660	.	G	T	18	11	29	0	1	30	0	0
8	25713035	.	T	A	15	7	22	0	1	23	0	0
8	25713053	.	G	A	5	15	20	0	1	21	0	0
8	25714884	.	G	A	4	4	8	0	0	8	0	0
8	25715028	.	T	A	9	7	16	0	4	20	0	0
8	25734814	.	C	A	3	2	5	0	0	5	0	0
8	25734892	.	G	A	4	7	11	0	0	11	0	0
8	25745724	.	C	T	5	10	15	0	1	16	0	0
8	25745840	.	C	T	7	12	19	0	0	19	0	0
8	25745877	.	T	A	10	4	14	0	0	14	0	0
8	25746125	.	C	T	4	9	13	0	0	13	0	0
8	25746183	.	G	A	0	10	10	0	6	16	0	0
8	25746213	.	A	G	6	0	6	0	10	16	0	0
8	25746376	.	G	A	6	3	9	0	0	9	0	0
8	25746508	.	A	G	2	6	8	0	0	8	0	0
8	25746535	.	C	A	4	7	11	0	0	11	0	0
8	25746606	.	C	T	2	3	5	0	0	5	0	0
8	25746650	.	T	G	2	7	9	0	0	9	0	0
8	25746684	.	C	T	3	3	6	0	0	6	0	0
8	25746788	.	C	G	2	11	13	0	1	14	0	0
8	25746999	.	G	A	0	7	7	0	2	9	0	0
8	25747028	.	T	A	4	5	9	0	1	10	0	0
8	25747202	.	A	C	3	7	10	0	1	11	0	0
8	25747365	.	T	C	9	9	18	0	2	20	0	0
8	25747644	.	T	G	7	7	14	0	1	15	0	0
8	25747993	.	G	A	1	7	8	0	5	13	0	0
8	25748047	.	G	A	1	6	7	0	8	15	0	0
8	25748147	.	C	T	3	6	9	0	0	9	0	0
8	25748185	.	T	C	11	4	15	0	1	16	0	0
8	25748244	.	G	A	10	4	14	0	1	15	0	0
8	25748283	.	G	T	3	6	9	0	0	9	0	0
8	25748329	.	A	T	4	8	12	0	0	12	0	0
8	25748330	.	T	A	5	8	13	0	0	13	0	0
8	25748562	.	T	A	10	11	21	0	1	22	0	0
8	25748685	.	G	A	5	3	8	0	0	8	0	0
8	25761791	.	A	T	3	6	9	0	0	9	0	0
8	25761792	.	C	A	3	6	9	0	0	9	0	0
8	25761886	.	T	C	4	12	16	0	0	16	0	0
8	25764192	.	T	C	24	29	53	0	0	53	0	0
8	25765640	.	T	A	12	5	17	0	0	17	0	0
8	25765647	.	G	A	3	11	14	0	5	19	0	0
8	25765788	.	G	A	2	16	18	0	19	37	0	0
8	25765794	.	G	A	17	14	31	0	4	35	0	0
8	25766098	.	G	A	12	14	26	0	3	29	0	0
8	25766131	.	T	C	11	16	27	0	1	28	0	0
8	25766188	.	A	C	11	15	26	0	0	26	0	0
8	25812075	.	T	C	16	12	28	0	4	32	0	0
8	25812113	.	G	A	19	12	31	0	2	33	0	0
8	25812324	.	A	G	27	13	40	0	2	42	0	0
8	25813740	.	A	G	16	20	36	0	1	37	0	0
8	25813904	.	A	G	15	14	29	0	2	31	0	0
8	25813937	.	G	T	18	9	27	0	0	27	0	0
8	25813987	.	G	A	19	11	30	0	2	32	0	0
8	25814003	.	C	T	2	11	13	0	23	37	1	0
8	25816811	.	T	A	16	11	27	0	10	37	0	0
8	25816916	.	G	T	19	13	32	1	0	33	0	0
8	25816917	.	C	G	19	11	30	1	2	33	0	0
8	25819057	.	T	A	13	15	28	0	1	29	0	0
8	25819095	.	A	T	8	14	22	0	0	22	0	0
8	25819196	.	G	A	4	3	7	0	0	7	0	0
8	25819349	.	A	G	9	8	17	0	1	18	0	0
8	25819430	.	A	T	11	8	19	0	0	19	0	0
8	25819434	.	C	G	11	8	19	0	0	19	0	0
8	25819478	.	G	A	9	10	19	0	1	20	0	0
8	25819548	.	C	G	22	15	37	0	0	37	0	0
8	25820884	.	G	T	5	4	9	0	0	9	0	0
8	25821088	.	T	G	11	4	15	0	0	15	0	0
8	25821140	.	G	A	16	5	21	0	1	22	0	0
8	25845780	.	C	T	15	14	29	0	2	31	0	0
8	25845830	.	T	C	5	14	19	0	8	27	0	0
8	25845864	.	A	G	15	8	23	0	3	26	0	0
8	25892895	.	T	C	3	2	5	0	0	5	0	0
8	25893610	.	C	G	4	4	8	0	0	8	0	0
8	25893862	.	C	T	4	5	9	0	0	9	0	0
8	25894222	.	G	A	1	5	6	0	15	21	0	0
8	25894300	.	C	T	8	9	17	0	0	17	0	0
8	25897145	.	T	A	15	11	26	0	0	26	0	0
8	25897287	.	C	T	7	5	12	0	0	12	0	0
8	25897489	.	G	A	5	7	12	0	0	12	0	0
8	25897694	.	C	T	6	3	9	0	0	9	0	0
8	25897861	.	G	A	5	2	7	0	1	8	0	0
8	25902319	.	C	T	25	19	44	0	0	44	0	0
8	25905524	.	T	A	31	9	40	1	0	41	0	0
8	25905744	.	T	G	17	26	43	1	2	46	0	0
8	25905919	.	T	C	5	7	12	0	1	13	0	0
8	25927496	.	G	A	0	3	3	0	3	6	0	0
8	25940273	.	A	G	5	3	8	0	0	8	0	0
8	25950577	.	G	A	13	7	20	0	0	20	0	0
8	25950707	.	G	C	10	6	16	0	1	17	0	0
8	25950803	.	G	A	0	15	15	0	16	31	0	0
8	25950877	.	C	T	12	14	26	0	2	28	0	0
8	25950999	.	G	A	1	13	14	0	12	26	0	0
8	25951090	.	A	G	25	8	33	0	3	36	0	0
8	25951162	.	G	A	2	9	11	0	8	19	0	0
8	25951194	.	A	T	9	7	16	0	0	16	0	0
8	25951197	.	G	A	9	6	15	0	0	15	0	0
8	25951324	.	A	C	11	4	15	0	1	16	0	0
8	25951366	.	C	T	18	9	27	0	0	27	0	0
8	25951417	.	A	T	19	15	34	0	2	36	0	0
8	25951437	.	A	C	12	15	27	0	1	28	0	0
8	25951473	.	A	T	11	10	21	0	1	22	0	0
8	25951517	.	C	T	12	9	21	0	0	21	0	0
8	25951804	.	A	G	10	4	14	0	1	15	0	0
8	25951806	.	A	T	11	4	15	0	0	15	0	0
8	25963223	.	A	C	7	7	14	0	0	14	0	0
8	25964397	.	A	C	14	10	24	0	1	25	0	0
8	25964398	.	T	C	14	10	24	0	1	25	0	0
8	25964468	.	A	G	9	0	9	0	11	20	0	0
8	25964489	.	A	G	6	0	6	0	13	19	0	0
8	25970772	.	A	G	15	5	20	0	1	22	1	0
8	26008088	.	G	A	0	3	3	0	3	6	0	0
8	26008118	.	T	C	2	2	4	0	0	4	0	0
8	26019038	.	A	G	2	2	4	0	0	4	0	0
8	26019103	.	G	A	3	2	5	0	0	5	0	0
8	26019711	.	A	G	2	4	6	0	1	7	0	0
8	26019765	.	G	A	0	2	2	0	1	3	0	0
8	26025040	.	T	C	4	2	6	0	0	6	0	0
8	26026772	.	C	T	5	6	11	0	0	11	0	0
8	26026787	.	C	T	6	4	10	0	0	10	0	0
8	26030223	.	C	T	2	4	6	0	1	7	0	0
8	26030226	.	G	A	3	5	8	0	0	8	0	0
8	26030739	.	T	A	1	1	2	0	1	3	0	0
8	26030808	.	C	A	1	2	3	0	0	3	0	0
8	26034654	.	A	G	6	8	14	0	2	16	0	0
8	26038309	.	G	A	14	9	23	0	0	23	0	0
8	26046168	.	G	C	0	9	9	0	7	16	0	0
8	26056935	.	T	C	28	17	45	0	6	51	0	0
8	26056970	.	T	C	21	17	38	0	2	40	0	0
8	26056990	.	T	C	24	20	44	0	1	45	0	0
8	26057014	.	T	C	18	21	39	0	7	46	0	0
8	26057130	.	T	C	25	19	44	0	2	46	0	0
8	26059867	.	T	A	1	4	5	0	1	6	0	0
8	26059897	.	A	T	1	4	5	0	0	5	0	0
8	26066234	.	C	T	8	8	16	0	1	17	0	0
8	26073777	.	G	A	11	5	16	0	0	16	0	0
8	26078879	.	T	G	12	9	21	0	0	21	0	0
8	26078898	.	C	A	5	10	15	0	1	16	0	0
8	26091570	.	G	A	7	6	13	0	0	13	0	0
8	26091586	.	G	A	0	4	4	0	7	11	0	0
8	26091845	.	A	G	12	0	12	0	6	18	0	0
8	26091939	.	G	A	0	9	9	0	11	20	0	0
8	26092176	.	T	A	4	7	11	0	0	11	0	0
8	26093660	.	G	A	6	6	12	0	0	12	0	0
8	26097321	.	C	T	26	17	43	0	3	47	1	0
8	26097399	.	T	C	31	17	48	0	1	49	0	0
8	26097744	.	G	T	0	8	8	0	8	16	0	0
8	26097749	.	C	T	7	10	17	0	1	18	0	0
8	26097881	.	T	C	5	10	15	0	0	15	0	0
8	26097966	.	C	T	4	8	12	0	1	13	0	0
8	26166320	.	C	T	1	2	3	0	0	3	0	0
8	26166467	.	T	C	1	3	4	0	0	4	0	0
8	26179738	.	T	C	6	4	10	0	0	10	0	0
8	26189447	.	T	G	3	2	5	0	0	5	0	0
8	26190452	.	G	A	4	3	7	0	0	7	0	0
8	26192708	.	G	A	0	4	4	0	6	10	0	0
8	26203553	.	A	G	8	1	9	0	4	13	0	0
8	26205537	.	C	T	5	6	11	0	0	11	0	0
8	26210178	.	G	A	7	10	17	0	1	18	0	0
8	26210523	.	A	T	5	5	10	0	0	10	0	0
8	26210781	.	C	T	5	7	12	0	2	14	0	0
8	26210949	.	G	A	0	1	1	0	8	9	0	0
8	26233192	.	C	T	2	3	5	0	0	5	0	0
8	26233424	.	T	C	1	2	3	0	0	3	0	0
8	26233430	.	G	A	0	2	2	0	1	3	0	0
8	26234027	.	A	G	4	4	8	0	1	9	0	0
8	26234044	.	G	A	4	3	7	0	0	7	0	0
8	26234078	.	G	A	3	3	6	0	0	6	0	0
8	26234114	.	G	T	0	3	3	0	3	6	0	0
8	26234123	.	T	A	3	3	6	0	0	6	0	0
8	26234169	.	G	A	4	3	7	0	0	7	0	0
8	26234207	.	T	C	8	4	12	0	0	12	0	0
8	26234225	.	G	A	9	3	12	0	0	12	0	0
8	26234563	.	G	A	4	2	6	0	1	7	0	0
8	26235471	.	A	G	3	3	6	0	1	7	0	0
8	26235554	.	C	T	10	3	13	0	2	15	0	0
8	26235560	.	T	G	9	3	12	0	0	12	0	0
8	26239938	.	G	A	5	3	8	0	1	9	0	0
8	26240007	.	C	T	10	3	13	0	0	13	0	0
8	26240346	.	G	A	0	4	4	0	4	8	0	0
8	26240348	.	A	T	3	4	7	0	1	8	0	0
8	26293930	.	C	T	11	6	17	0	1	18	0	0
8	26317376	.	T	C	11	11	22	0	0	22	0	0
8	26321296	.	C	T	13	6	19	0	1	20	0	0
8	26321359	.	G	A	14	12	26	0	0	26	0	0
8	26323458	.	A	T	6	11	17	0	0	17	0	0
8	26323511	.	T	A	9	8	17	0	2	19	0	0
8	26324620	.	C	T	7	5	12	0	0	12	0	0
8	26324691	.	C	A	4	2	6	0	0	6	0	0
8	26324773	.	T	C	4	7	11	0	0	11	0	0
8	26324905	.	A	G	6	12	18	0	0	18	0	0
8	26325332	.	T	A	34	18	52	0	2	55	1	0
8	26325333	.	A	T	29	17	46	0	9	55	0	0
8	26325680	.	G	A	3	18	21	0	17	38	0	0
8	26325888	.	G	A	2	16	18	0	19	37	0	0
8	26330006	.	G	A	10	7	17	0	1	18	0	0
8	26330190	.	T	C	8	12	20	0	0	20	0	0
8	26330352	.	T	A	4	3	7	0	0	7	0	0
8	26330545	.	C	T	12	7	19	0	1	20	0	0
8	26330666	.	T	C	9	10	19	0	2	21	0	0
8	26357826	.	A	G	11	17	28	0	0	28	0	0
8	26360974	.	G	T	19	12	31	0	1	32	0	0
8	26361294	.	G	A	10	9	19	0	1	20	0	0
8	26367891	.	T	G	16	23	39	0	2	41	0	0
8	26368019	.	C	T	28	21	49	3	0	52	0	0
8	26368025	.	C	T	31	18	49	3	1	53	0	0
8	26368171	.	T	C	28	25	53	0	1	54	0	0
8	26368356	.	G	A	1	19	20	0	14	34	0	0
8	26369055	.	C	T	3	3	6	0	0	6	0	0
8	26410472	.	G	C	3	2	5	0	0	5	0	0
8	26417276	.	C	T	4	2	6	0	0	6	0	0
8	26426163	.	T	C	9	9	18	0	1	19	0	0
8	26426478	.	G	A	2	11	13	0	0	13	0	0
8	26426487	.	G	A	1	9	10	0	0	10	0	0
8	26426596	.	T	G	8	4	12	0	0	12	0	0
8	26426771	.	C	T	1	5	6	0	0	6	0	0
8	26426978	.	A	C	7	4	11	0	0	11	0	0
8	26427081	.	C	T	12	4	16	0	0	16	0	0
8	26427137	.	A	T	5	5	10	0	0	10	0	0
8	26432701	.	C	T	3	4	7	0	0	7	0	0
8	26433541	.	T	C	5	2	7	0	0	7	0	0
8	26435187	.	G	A	2	3	5	0	0	5	0	0
8	26436664	.	C	T	2	3	5	0	0	5	0	0
8	26439033	.	C	T	6	3	9	0	0	9	0	0
8	26439046	.	A	G	5	5	10	0	1	11	0	0
8	26444701	.	T	C	3	3	6	0	0	6	0	0
8	26444741	.	T	C	3	4	7	0	0	7	0	0
8	26444877	.	C	T	4	3	7	0	0	7	0	0
8	26444892	.	T	A	2	3	5	0	1	6	0	0
8	26445037	.	T	C	3	5	8	0	1	9	0	0
8	26445119	.	A	G	10	5	15	0	1	16	0	0
8	26445166	.	G	A	3	7	10	0	7	17	0	0
8	26565265	.	T	G	1	0	1	0	3	4	0	0
8	26565293	.	A	C	2	4	6	0	0	6	0	0
8	26565389	.	C	T	3	3	6	0	0	6	0	0
8	26572943	.	T	C	3	5	8	0	0	8	0	0
8	26573009	.	T	C	4	4	8	0	0	8	0	0
8	26573030	.	G	A	1	6	7	0	4	11	0	0
8	26573066	.	T	A	4	6	10	0	0	10	0	0
8	26573075	.	A	C	4	6	10	0	0	10	0	0
8	26573243	.	T	C	2	2	4	0	0	4	0	0
8	26573622	.	G	A	1	3	4	0	1	5	0	0
8	26586558	.	G	A	15	5	20	0	1	21	0	0
8	26586634	.	A	C	7	5	12	0	1	13	0	0
8	26586900	.	G	T	12	10	22	0	1	23	0	0
8	26587137	.	C	G	6	2	8	0	0	8	0	0
8	26587164	.	G	A	3	3	6	0	0	6	0	0
8	26587323	.	G	A	9	4	13	0	2	15	0	0
8	26587380	.	G	A	2	7	9	0	0	9	0	0
8	26587447	.	C	T	1	3	4	0	6	10	0	0
8	26594082	.	A	G	2	5	7	0	0	7	0	0
8	26709876	.	A	T	1	4	5	0	1	6	0	0
8	26709940	.	C	T	3	2	5	0	1	6	0	0
8	26716404	.	C	T	6	2	8	0	0	8	0	0
8	26718306	.	A	G	5	1	6	0	0	6	0	0
8	26718309	.	T	G	5	2	7	0	0	7	0	0
8	26731764	.	A	C	11	4	15	0	0	15	0	0
8	26731866	.	T	G	5	2	7	0	1	8	0	0
8	26746173	.	C	T	7	7	14	0	0	14	0	0
8	26792738	.	T	A	6	4	10	0	0	10	0	0
8	26792849	.	A	G	6	9	15	0	2	17	0	0
8	26838478	.	T	G	4	0	4	0	3	7	0	0
8	26838547	.	C	T	3	3	6	0	0	6	0	0
8	26860061	.	C	A	4	5	9	0	0	9	0	0
8	26860064	.	A	T	4	5	9	0	0	9	0	0
8	26860124	.	G	A	5	4	9	0	0	9	0	0
8	26860307	.	A	G	2	4	6	0	0	6	0	0
8	26860493	.	A	C	3	5	8	0	0	8	0	0
8	26860511	.	T	C	5	6	11	0	0	11	0	0
8	26860600	.	G	T	1	2	3	0	1	4	0	0
8	26860778	.	T	C	2	3	5	0	0	5	0	0
8	26860779	.	G	A	3	3	6	0	0	6	0	0
8	26861145	.	A	G	6	9	15	0	0	15	0	0
8	26861248	.	G	T	9	9	18	0	1	19	0	0
8	26861434	.	G	A	1	7	8	0	0	8	0	0
8	26861653	.	T	C	5	5	10	0	0	10	0	0
8	26861760	.	C	A	7	3	10	0	2	12	0	0
8	26862002	.	A	C	11	4	15	0	0	15	0	0
8	26862526	.	C	A	6	9	15	0	0	15	0	0
8	26863804	.	C	A	6	6	12	0	3	15	0	0
8	26864121	.	A	G	11	14	25	0	0	25	0	0
8	26864150	.	G	C	12	10	22	0	0	22	0	0
8	26864195	.	G	C	13	11	24	0	0	24	0	0
8	26868418	.	T	C	9	12	21	0	0	21	0	0
8	26881205	.	T	G	17	0	17	0	23	40	0	0
8	26884298	.	T	C	18	18	36	0	0	36	0	0
8	26884313	.	A	G	16	19	35	0	0	35	0	0
8	26884619	.	C	T	27	26	53	0	2	55	0	0
8	26884767	.	C	T	28	19	47	0	1	48	0	0
8	26884903	.	T	A	14	23	37	0	2	39	0	0
8	26885382	.	C	A	15	27	42	0	4	46	0	0
8	26886025	.	C	T	19	15	34	0	7	41	0	0
8	26886177	.	T	C	20	19	39	0	1	40	0	0
8	26886259	.	A	G	19	21	40	0	2	42	0	0
8	26886399	.	C	G	23	24	47	0	0	47	0	0
8	26886667	.	T	A	27	27	54	0	3	61	4	0
8	26886766	.	T	C	28	22	50	0	1	51	0	0
8	26886972	.	A	T	25	23	48	0	3	52	1	0
8	26887013	.	T	C	19	24	43	0	3	46	0	0
8	26887122	.	A	C	15	25	40	0	0	40	0	0
8	26887240	.	G	A	1	2	3	0	1	4	0	0
8	27361846	.	G	A	6	9	15	0	0	15	0	0
8	27362288	.	C	G	9	11	20	0	0	20	0	0
8	27371858	.	C	G	5	11	16	0	2	18	0	0
8	27515239	.	T	C	11	6	17	0	0	17	0	0
8	27624026	.	T	A	27	14	41	0	1	42	0	0
8	27624027	.	T	C	26	14	40	0	2	42	0	0
8	27624255	.	A	T	2	2	4	0	1	5	0	0
8	27813611	.	C	A	18	11	29	0	0	29	0	0
8	27816560	.	C	A	30	24	54	0	3	57	0	0
8	27816680	.	C	T	32	18	50	0	3	53	0	0
8	28066077	.	T	A	5	3	8	0	0	8	0	0
8	28066167	.	G	A	10	5	15	0	0	15	0	0
8	28066168	.	C	A	10	5	15	0	0	15	0	0
8	28066291	.	G	T	0	6	6	0	1	7	0	0
8	28224987	.	G	A	7	9	16	0	1	17	0	0
8	28229971	.	C	T	18	15	33	0	1	34	0	0
8	28232496	.	G	A	8	4	12	0	1	13	0	0
8	28232512	.	G	T	6	9	15	0	0	15	0	0
8	28232557	.	T	A	13	7	20	0	0	20	0	0
8	28232745	.	G	T	11	15	26	0	1	27	0	0
8	28232812	.	G	T	6	9	15	0	1	17	1	0
8	28243362	.	A	G	2	2	4	0	0	4	0	0
8	28243437	.	A	G	3	4	7	0	0	7	0	0
8	28243579	.	C	T	8	6	14	0	0	14	0	0
8	28243707	.	C	G	9	7	16	0	0	16	0	0
8	28243830	.	T	G	2	4	6	0	0	6	0	0
8	28244063	.	C	T	2	2	4	0	0	4	0	0
8	28244076	.	C	T	3	2	5	0	1	6	0	0
8	28244116	.	G	A	6	3	9	0	1	10	0	0
8	28244193	.	G	A	6	5	11	0	0	11	0	0
8	28248692	.	G	T	2	5	7	0	1	8	0	0
8	28252294	.	A	G	4	4	8	0	1	9	0	0
8	28256293	.	G	T	1	2	3	0	0	3	0	0
8	28256308	.	A	T	1	2	3	0	0	3	0	0
8	28256649	.	A	C	2	0	2	0	2	4	0	0
8	28313256	.	G	A	19	18	37	0	1	38	0	0
8	28315258	.	A	G	11	12	23	1	1	25	0	0
8	28315301	.	T	C	10	0	10	0	13	23	0	0
8	28315378	.	A	G	5	18	23	0	0	23	0	0
8	28315424	.	C	G	4	10	14	0	1	15	0	0
8	28315436	.	G	T	3	9	12	0	1	13	0	0
8	28315481	.	A	G	4	10	14	0	1	15	0	0
8	28315694	.	A	G	8	8	16	0	0	16	0	0
8	28315699	.	A	G	9	8	17	0	0	17	0	0
8	28317748	.	A	T	11	5	16	0	1	17	0	0
8	28317844	.	T	C	8	0	8	0	12	20	0	0
8	28323403	.	C	A	1	10	11	0	7	19	1	0
8	28323442	.	A	G	8	8	16	0	0	16	0	0
8	28346143	.	A	G	3	2	5	0	0	5	0	0
8	28346146	.	C	T	3	2	5	0	0	5	0	0
8	28346284	.	G	A	2	5	7	0	0	7	0	0
8	28346569	.	A	G	2	5	7	0	1	8	0	0
8	28346656	.	A	G	1	5	6	0	0	6	0	0
8	28346659	.	G	C	2	5	7	0	0	7	0	0
8	28346701	.	A	C	1	2	3	0	1	4	0	0
8	28351147	.	T	A	6	5	11	0	0	11	0	0
8	28351678	.	T	C	1	6	7	0	0	7	0	0
8	28351679	.	C	T	1	5	6	0	1	7	0	0
8	28356317	.	A	G	11	8	19	0	0	19	0	0
8	28358501	.	C	A	7	9	16	0	2	18	0	0
8	28359559	.	T	C	16	11	27	0	0	27	0	0
8	28364854	.	G	A	1	8	9	0	19	28	0	0
8	28364923	.	T	A	12	13	25	1	0	26	0	0
8	28365119	.	C	T	10	7	17	0	0	17	0	0
8	28365328	.	A	T	10	8	18	0	0	18	0	0
8	28365361	.	C	T	11	12	23	0	0	23	0	0
8	28365417	.	A	G	4	5	9	0	1	10	0	0
8	28365479	.	C	T	5	4	9	0	0	9	0	0
8	28365496	.	C	A	4	4	8	0	0	8	0	0
8	28379375	.	T	A	1	4	5	0	0	5	0	0
8	28381446	.	G	A	0	5	5	0	1	6	0	0
8	28383189	.	G	A	5	5	10	0	0	10	0	0
8	28399129	.	G	A	9	3	12	0	0	12	0	0
8	28399297	.	T	A	8	3	11	0	1	12	0	0
8	28399580	.	T	A	8	6	14	0	1	15	0	0
8	28399625	.	A	C	7	5	12	0	0	12	0	0
8	28399672	.	A	G	7	5	12	0	0	12	0	0
8	28401003	.	C	A	2	6	8	0	0	8	0	0
8	28406481	.	G	A	2	2	4	0	0	4	0	0
8	28406502	.	G	A	2	2	4	0	0	4	0	0
8	28449176	.	A	G	6	5	11	0	0	11	0	0
8	28457220	.	C	T	2	2	4	0	0	4	0	0
8	28463137	.	C	T	3	2	5	0	0	5	0	0
8	28463373	.	A	T	3	4	7	0	0	7	0	0
8	28463551	.	T	G	3	0	3	0	6	9	0	0
8	28463587	.	T	C	2	3	5	0	0	5	0	0
8	28463785	.	A	T	5	4	9	0	0	9	0	0
8	28464556	.	C	T	9	7	16	0	0	16	0	0
8	28527921	.	G	A	0	3	3	0	3	6	0	0
8	28528277	.	A	T	11	3	14	0	1	15	0	0
8	28532166	.	G	A	0	4	4	0	5	9	0	0
8	28532304	.	C	T	8	6	14	0	0	14	0	0
8	28532490	.	C	T	4	4	8	0	1	9	0	0
8	28532715	.	C	T	6	17	23	0	0	23	0	0
8	28594221	.	G	A	2	4	6	0	0	6	0	0
8	28594395	.	C	T	4	4	8	0	1	9	0	0
8	28724810	.	C	T	1	1	2	0	1	3	0	0
8	28727546	.	G	T	1	2	3	0	3	6	0	0
8	28727877	.	G	A	2	2	4	0	0	4	0	0
8	28868425	.	G	A	3	8	11	0	0	11	0	0
8	28900870	.	G	T	0	4	4	0	1	5	0	0
8	28901170	.	C	A	4	4	8	0	0	8	0	0
8	28982606	.	G	A	5	2	7	0	0	7	0	0
8	29267122	.	A	C	6	3	9	0	0	9	0	0
8	29267218	.	C	T	4	7	11	0	2	13	0	0
8	29267269	.	T	C	7	3	10	0	1	11	0	0
8	29285661	.	C	T	7	11	18	0	0	18	0	0
8	29427918	.	G	A	1	8	9	0	6	15	0	0
8	29428042	.	C	A	6	5	11	0	1	12	0	0
8	29574985	.	C	A	15	16	31	0	0	31	0	0
8	29587232	.	C	T	19	17	36	0	3	39	0	0
8	29587262	.	C	A	14	16	30	0	1	31	0	0
8	29587431	.	A	C	3	1	4	0	16	20	0	0
8	29587500	.	C	A	15	14	29	0	0	29	0	0
8	29587651	.	C	T	11	12	23	0	1	24	0	0
8	29636980	.	C	T	1	2	3	0	1	4	0	0
8	29637189	.	T	G	4	2	6	0	0	6	0	0
8	29640766	.	G	A	1	3	4	0	0	4	0	0
8	29644791	.	G	A	3	5	8	0	0	8	0	0
8	29719306	.	C	T	2	2	4	0	0	4	0	0
8	29749265	.	G	A	3	4	7	0	0	7	0	0
8	29758468	.	T	C	3	5	8	0	0	8	0	0
8	29758522	.	G	A	0	4	4	0	5	9	0	0
8	29759705	.	C	T	2	3	5	0	1	6	0	0
8	29760924	.	C	A	1	4	5	0	0	5	0	0
8	29763390	.	G	C	6	5	11	0	1	12	0	0
8	29763480	.	C	T	2	7	9	0	0	9	0	0
8	29763633	.	C	G	4	0	4	0	7	11	0	0
8	29763822	.	A	G	6	0	6	0	10	16	0	0
8	29764138	.	C	T	3	6	9	0	0	9	0	0
8	29764150	.	A	T	3	6	9	0	0	9	0	0
8	29764532	.	A	G	5	5	10	0	0	10	0	0
8	29764583	.	C	G	1	3	4	1	1	6	0	0
8	29764695	.	G	T	3	4	7	0	1	8	0	0
8	29764761	.	T	C	3	2	5	0	2	7	0	0
8	29764968	.	T	C	5	9	14	0	0	14	0	0
8	29765178	.	C	T	2	3	5	0	0	5	0	0
8	29765264	.	A	C	3	2	5	0	0	5	0	0
8	29765395	.	G	C	1	3	4	0	0	4	0	0
8	29765413	.	T	C	1	2	3	0	0	3	0	0
8	29765824	.	T	C	1	4	5	0	0	5	0	0
8	29765872	.	A	C	1	2	3	0	1	4	0	0
8	29766247	.	T	C	2	5	7	0	0	7	0	0
8	29768417	.	T	C	0	3	3	1	1	5	0	0
8	29770185	.	C	T	19	8	27	0	2	29	0	0
8	29770207	.	G	A	24	14	38	0	1	39	0	0
8	29770371	.	T	A	33	32	65	0	4	69	0	0
8	29770511	.	C	T	24	37	61	0	1	62	0	0
8	29770775	.	A	T	24	24	48	1	2	51	0	0
8	29771053	.	A	G	20	19	39	0	1	40	0	0
8	29771173	.	G	A	21	9	30	0	0	30	0	0
8	29771336	.	T	C	5	0	5	0	6	11	0	0
8	29771516	.	C	A	4	4	8	0	0	8	0	0
8	29771718	.	T	C	2	1	3	0	3	6	0	0
8	29771938	.	C	T	0	7	7	0	8	15	0	0
8	29772910	.	G	T	7	7	14	0	1	15	0	0
8	29772933	.	C	T	0	12	12	0	9	21	0	0
8	29773127	.	T	A	13	13	26	0	1	27	0	0
8	29773329	.	C	A	12	11	23	0	0	23	0	0
8	29774258	.	C	T	20	16	36	0	1	37	0	0
8	29774263	.	C	A	18	17	35	0	4	39	0	0
8	29774309	.	A	T	22	10	32	0	3	35	0	0
8	29774428	.	T	A	12	9	21	0	1	22	0	0
8	29774528	.	C	T	3	12	15	0	7	22	0	0
8	29774747	.	A	T	2	2	4	1	0	5	0	0
8	29774827	.	C	T	2	7	9	0	16	25	0	0
8	29775340	.	A	T	14	6	20	0	0	21	1	0
8	29775342	.	T	A	8	13	21	0	0	21	0	0
8	29787265	.	C	T	3	10	13	0	9	22	0	0
8	29793782	.	A	G	5	3	8	0	0	8	0	0
8	29799168	.	C	T	1	14	15	0	10	25	0	0
8	29799360	.	G	A	11	9	20	0	0	20	0	0
8	29799627	.	G	A	11	15	26	0	2	29	1	0
8	29801150	.	C	G	17	14	31	0	0	31	0	0
8	29801291	.	C	T	4	4	8	0	1	9	0	0
8	29819317	.	G	A	3	4	7	0	1	8	0	0
8	29819431	.	G	A	5	3	8	0	0	8	0	0
8	29819581	.	A	G	7	5	12	0	0	12	0	0
8	29864654	.	A	G	3	6	9	0	0	9	0	0
8	29865886	.	C	T	2	2	4	0	0	4	0	0
8	29871800	.	T	C	9	6	15	0	0	15	0	0
8	29875559	.	A	T	2	5	7	0	0	7	0	0
8	29898947	.	T	C	7	5	12	0	0	12	0	0
8	29899117	.	G	A	5	5	10	0	0	10	0	0
8	29899186	.	G	T	9	5	14	0	0	14	0	0
8	29899209	.	T	C	2	7	9	0	0	9	0	0
8	29899373	.	G	A	5	6	11	0	0	11	0	0
8	29899453	.	A	G	6	3	9	1	0	10	0	0
8	29902904	.	T	C	3	2	5	0	1	6	0	0
8	29904949	.	G	T	2	2	4	0	1	5	0	0
8	29907414	.	C	A	1	1	2	0	1	3	0	0
8	29907560	.	C	G	1	3	4	0	0	4	0	0
8	29926972	.	A	T	1	6	7	0	0	7	0	0
8	29930754	.	T	A	2	5	7	0	0	7	0	0
8	30038883	.	G	A	2	3	5	0	0	5	0	0
8	30063320	.	T	C	1	7	8	0	0	8	0	0
8	30159420	.	C	T	2	2	4	0	1	5	0	0
8	30159560	.	A	C	12	0	12	0	10	22	0	0
8	30330667	.	C	T	8	3	11	0	0	11	0	0
8	30426211	.	C	A	12	6	18	0	0	18	0	0
8	30437538	.	T	C	3	10	13	0	0	13	0	0
8	30449074	.	G	A	5	5	10	0	0	10	0	0
8	30572092	.	C	T	2	4	6	0	0	6	0	0
8	30575850	.	G	A	2	4	6	0	0	6	0	0
8	30585283	.	C	T	6	5	11	0	1	12	0	0
8	30591955	.	T	C	6	8	14	0	0	14	0	0
8	30591991	.	G	T	5	2	7	0	0	7	0	0
8	30593567	.	G	A	4	5	9	0	1	10	0	0
8	30600565	.	C	T	4	4	8	0	0	8	0	0
8	30600606	.	T	A	6	8	14	0	0	14	0	0
8	30623106	.	T	C	2	2	4	0	0	4	0	0
8	30623994	.	C	T	7	3	10	0	0	10	0	0
8	30624247	.	G	A	6	10	16	0	0	16	0	0
8	30624340	.	T	C	5	3	8	0	0	8	0	0
8	30631057	.	C	T	3	3	6	0	0	6	0	0
8	30661270	.	C	T	3	8	11	0	1	12	0	0
8	30661565	.	A	G	9	0	9	0	10	19	0	0
8	30661645	.	G	A	6	9	15	0	0	15	0	0
8	30662278	.	T	G	9	3	12	0	1	13	0	0
8	30662279	.	G	A	9	3	12	0	1	13	0	0
8	30662343	.	G	C	4	2	6	0	1	7	0	0
8	30662488	.	T	A	15	4	19	0	0	19	0	0
8	30662505	.	A	T	10	6	16	0	1	17	0	0
8	30662627	.	A	T	1	3	4	0	0	4	0	0
8	30730983	.	A	C	3	4	7	0	0	7	0	0
8	30731178	.	G	A	2	7	9	0	0	9	0	0
8	30731421	.	T	A	5	3	8	0	0	8	0	0
8	30731535	.	A	T	1	2	3	0	0	3	0	0
8	30731791	.	T	A	2	3	5	0	0	5	0	0
8	30735082	.	T	A	3	8	11	0	2	13	0	0
8	30735085	.	A	G	3	8	11	0	1	12	0	0
8	30741991	.	C	G	6	4	10	0	0	10	0	0
8	30742022	.	C	A	1	8	9	0	7	16	0	0
8	30742075	.	C	T	8	4	12	0	0	12	0	0
8	30744468	.	G	A	0	6	6	0	6	12	0	0
8	30758237	.	C	T	4	3	7	0	0	7	0	0
8	30758334	.	T	C	2	3	5	0	0	5	0	0
8	30758447	.	G	A	2	3	5	0	0	5	0	0
8	30758449	.	C	T	2	3	5	0	0	5	0	0
8	30758485	.	A	G	1	3	4	0	0	4	0	0
8	30778415	.	C	A	2	2	4	1	0	5	0	0
8	30921546	.	G	T	1	3	4	0	0	4	0	0
8	30928624	.	G	A	2	6	8	0	2	10	0	0
8	30929958	.	T	A	21	14	35	0	0	35	0	0
8	30930764	.	C	A	17	26	43	0	8	51	0	0
8	30940027	.	T	A	10	18	28	0	0	28	0	0
8	30940072	.	T	G	8	14	22	0	3	25	0	0
8	30949969	.	C	T	9	6	15	0	0	15	0	0
8	30950057	.	G	A	9	7	16	0	0	16	0	0
8	30951623	.	G	A	7	5	12	0	0	12	0	0
8	30953444	.	C	T	0	3	3	0	4	7	0	0
8	31008426	.	G	A	0	8	8	0	9	17	0	0
8	31012948	.	A	C	10	15	25	0	2	27	0	0
8	31012993	.	C	T	16	14	30	0	2	32	0	0
8	31013176	.	A	T	12	14	26	0	1	27	0	0
8	31013220	.	A	G	10	10	20	0	1	21	0	0
8	31030914	.	A	T	13	15	28	0	0	28	0	0
8	31031068	.	A	G	10	4	14	0	0	14	0	0
8	31031069	.	A	T	10	4	14	0	0	14	0	0
8	31031269	.	T	G	2	7	9	0	0	9	0	0
8	31031272	.	T	C	2	7	9	0	1	10	0	0
8	31031307	.	C	G	1	4	5	0	0	5	0	0
8	31031603	.	A	T	11	5	16	0	3	19	0	0
8	31031740	.	A	G	14	19	33	0	3	36	0	0
8	31031993	.	G	A	19	18	37	0	1	38	0	0
8	31032379	.	C	T	12	15	27	0	3	30	0	0
8	31033861	.	A	T	15	21	36	0	0	36	0	0
8	31034924	.	A	G	13	13	26	0	2	28	0	0
8	31036057	.	G	A	17	11	28	0	2	30	0	0
8	31036126	.	G	A	17	10	27	0	0	27	0	0
8	31037403	.	C	T	6	4	10	0	0	10	0	0
8	31038890	.	C	T	10	5	15	0	1	16	0	0
8	31040157	.	G	A	5	6	11	0	0	11	0	0
8	31040175	.	A	G	6	7	13	0	1	14	0	0
8	31040211	.	A	G	8	7	15	0	0	15	0	0
8	31040861	.	G	A	4	6	10	0	0	10	0	0
8	31040973	.	T	C	2	0	2	0	6	8	0	0
8	31041221	.	A	G	4	7	11	0	0	11	0	0
8	31041287	.	C	T	0	8	8	0	2	10	0	0
8	31045790	.	A	G	3	5	8	0	0	8	0	0
8	31046698	.	A	G	1	7	8	0	0	8	0	0
8	31064844	.	G	A	1	2	3	0	0	3	0	0
8	31119730	.	A	G	10	9	19	0	3	22	0	0
8	31119865	.	T	C	7	12	19	0	0	19	0	0
8	31119909	.	T	G	8	2	10	0	4	14	0	0
8	31123029	.	T	C	11	14	25	0	1	26	0	0
8	31131079	.	G	A	13	15	28	0	0	28	0	0
8	31131277	.	A	G	18	21	39	0	1	40	0	0
8	31131394	.	A	C	19	9	28	0	0	28	0	0
8	31142074	.	G	A	29	17	46	0	9	55	0	0
8	31146748	.	G	A	26	28	54	0	1	55	0	0
8	31146913	.	G	A	25	21	46	0	4	51	1	0
8	31147380	.	T	G	22	24	46	0	0	46	0	0
8	31147526	.	G	A	28	22	50	0	3	53	0	0
8	31249080	.	A	C	5	11	16	0	0	16	0	0
8	31249365	.	G	A	12	6	18	0	2	20	0	0
8	31249605	.	A	G	11	13	24	0	0	24	0	0
8	31249881	.	T	A	6	14	20	0	3	23	0	0
8	31249941	.	T	A	7	8	15	0	0	15	0	0
8	31250032	.	A	G	17	0	17	0	8	25	0	0
8	31250183	.	C	A	17	16	33	0	0	33	0	0
8	31250823	.	G	A	12	19	31	0	1	32	0	0
8	31251129	.	G	A	18	12	30	0	0	30	0	0
8	31251282	.	A	C	21	18	39	0	2	41	0	0
8	31253582	.	C	T	24	16	40	0	0	40	0	0
8	31253722	.	T	C	14	12	26	0	2	28	0	0
8	31253729	.	T	A	14	7	21	0	1	22	0	0
8	31254163	.	G	A	17	24	41	0	0	41	0	0
8	31254219	.	T	C	7	9	16	0	0	16	0	0
8	31367747	.	T	C	4	5	9	0	0	9	0	0
8	31368010	.	G	A	18	15	33	0	1	34	0	0
8	31368279	.	T	G	7	8	15	0	1	16	0	0
8	31368358	.	G	T	1	2	3	0	0	3	0	0
8	31368524	.	C	T	13	6	19	0	1	20	0	0
8	31368889	.	C	T	7	4	11	0	0	11	0	0
8	31369071	.	G	C	6	8	14	0	0	14	0	0
8	31375400	.	C	T	7	8	15	0	0	15	0	0
8	31375457	.	A	G	7	7	14	0	0	14	0	0
8	31379542	.	C	T	0	13	13	0	15	28	0	0
8	31381731	.	T	A	13	5	18	0	4	23	1	0
8	31387695	.	A	G	8	6	14	0	0	14	0	0
8	31387833	.	C	T	0	8	8	0	6	14	0	0
8	31393220	.	G	A	8	3	11	0	0	11	0	0
8	31393424	.	C	T	0	2	2	0	4	6	0	0
8	31393451	.	G	T	2	2	4	0	1	5	0	0
8	31395400	.	C	T	1	3	4	0	2	6	0	0
8	31395532	.	T	G	6	6	12	0	2	14	0	0
8	31395778	.	G	T	3	2	5	0	2	7	0	0
8	31395894	.	A	C	2	7	9	0	0	9	0	0
8	31406847	.	G	C	7	0	7	0	10	17	0	0
8	31407153	.	C	T	9	9	18	0	1	19	0	0
8	31410872	.	C	T	12	7	19	0	0	19	0	0
8	31410887	.	G	A	9	8	17	0	0	17	0	0
8	31411089	.	C	T	0	7	7	0	9	16	0	0
8	31411176	.	T	G	8	14	22	0	0	22	0	0
8	31411569	.	A	C	9	0	9	0	10	19	0	0
8	31411638	.	G	T	3	8	11	0	3	14	0	0
8	31411858	.	A	G	11	5	16	0	0	16	0	0
8	31437611	.	C	T	10	12	22	0	0	22	0	0
8	31437671	.	T	C	10	8	18	0	2	20	0	0
8	31441724	.	G	T	13	14	27	0	1	28	0	0
8	31441733	.	C	A	14	16	30	0	0	30	0	0
8	31441814	.	G	A	17	19	36	0	3	39	0	0
8	31442595	.	G	A	16	12	28	0	0	28	0	0
8	31442648	.	C	T	18	17	35	0	0	35	0	0
8	31443023	.	A	C	35	10	45	1	10	56	0	0
8	31696153	.	G	C	1	2	3	0	0	3	0	0
8	31696156	.	A	G	1	2	3	0	0	3	0	0
8	31705267	.	G	A	24	18	42	0	0	42	0	0
8	31710941	.	G	A	12	6	18	0	0	18	0	0
8	31711411	.	T	C	11	0	11	1	9	21	0	0
8	31719077	.	T	C	12	7	19	0	0	19	0	0
8	31730762	.	C	A	12	7	19	0	0	19	0	0
8	31730771	.	C	T	12	6	18	0	0	18	0	0
8	31730801	.	C	G	14	8	22	0	0	22	0	0
8	31730813	.	A	C	16	10	26	0	1	27	0	0
8	31756865	.	T	C	13	22	35	0	1	36	0	0
8	31756940	.	T	C	12	22	34	0	0	34	0	0
8	31756946	.	T	C	13	17	30	0	3	33	0	0
8	31764858	.	G	A	25	13	38	0	1	39	0	0
8	31765077	.	C	T	28	15	43	0	0	43	0	0
8	31818022	.	G	A	2	14	16	0	21	37	0	0
8	31818083	.	A	T	20	20	40	0	3	43	0	0
8	31818349	.	A	C	9	15	24	0	0	24	0	0
8	31818371	.	A	G	16	14	30	0	0	30	0	0
8	31818549	.	C	T	4	10	14	0	2	16	0	0
8	31818745	.	C	T	15	10	25	0	0	25	0	0
8	31850976	.	G	T	17	13	30	0	1	31	0	0
8	31851270	.	G	A	13	7	20	0	1	21	0	0
8	31851594	.	T	C	25	18	43	0	0	43	0	0
8	31861425	.	A	G	22	19	41	0	2	43	0	0
8	31861580	.	G	A	18	19	37	0	1	38	0	0
8	31861615	.	A	C	21	16	37	0	1	38	0	0
8	31861742	.	G	A	23	22	45	0	0	45	0	0
8	31861746	.	C	T	22	20	42	0	1	43	0	0
8	31862179	.	A	G	21	15	36	0	1	37	0	0
8	31862312	.	G	A	2	20	22	0	27	49	0	0
8	31893561	.	A	G	2	2	4	0	0	4	0	0
8	31898671	.	A	G	5	3	8	0	2	10	0	0
8	31901760	.	C	T	5	2	7	0	0	7	0	0
8	31901925	.	G	A	6	14	20	0	2	22	0	0
8	31906927	.	G	A	18	15	33	0	0	33	0	0
8	31919451	.	G	T	12	11	23	0	0	23	0	0
8	31919526	.	C	A	17	12	29	0	1	30	0	0
8	31941679	.	C	T	4	7	11	0	0	11	0	0
8	31941746	.	C	A	12	5	17	0	0	17	0	0
8	31942099	.	C	T	7	13	20	0	0	20	0	0
8	31942174	.	G	A	2	13	15	0	13	28	0	0
8	31942771	.	C	T	12	7	19	0	3	22	0	0
8	31943276	.	G	A	8	2	10	0	0	10	0	0
8	32028856	.	G	T	5	5	10	0	0	10	0	0
8	32028921	.	T	A	10	6	16	0	0	16	0	0
8	32029267	.	G	A	4	3	7	0	1	8	0	0
8	32029572	.	T	C	5	2	7	0	0	7	0	0
8	32029573	.	T	C	1	0	1	0	6	7	0	0
8	32029692	.	T	C	2	2	4	0	1	5	0	0
8	32029745	.	T	C	5	2	7	0	0	7	0	0
8	32029810	.	G	C	3	2	5	0	0	5	0	0
8	32029843	.	T	C	3	2	5	0	1	6	0	0
8	32029881	.	G	T	1	2	3	0	0	3	0	0
8	32029882	.	A	T	1	2	3	0	0	3	0	0
8	32030087	.	G	A	4	2	6	0	0	6	0	0
8	32030107	.	G	A	5	2	7	0	0	7	0	0
8	32030771	.	T	G	5	4	9	0	1	10	0	0
8	32030837	.	T	A	7	8	15	0	0	15	0	0
8	32129255	.	T	C	2	4	6	0	0	6	0	0
8	32191744	.	G	A	4	4	8	0	0	8	0	0
8	32247877	.	G	A	2	2	4	0	0	4	0	0
8	32403787	.	C	T	1	2	3	0	0	3	0	0
8	32482851	.	C	T	21	19	40	0	2	42	0	0
8	32483536	.	C	T	14	9	23	0	2	25	0	0
8	32483905	.	G	C	12	14	26	0	0	26	0	0
8	32486956	.	C	T	1	8	9	0	13	22	0	0
8	32497629	.	G	T	11	10	21	0	1	22	0	0
8	32501541	.	A	G	4	2	6	0	0	6	0	0
8	32502932	.	C	T	8	3	11	0	0	11	0	0
8	32503968	.	C	T	1	3	4	0	0	4	0	0
8	32516331	.	C	T	4	3	7	0	0	7	0	0
8	32516557	.	T	C	9	8	17	0	1	18	0	0
8	32516629	.	A	C	9	9	18	0	0	18	0	0
8	32577794	.	G	A	7	4	11	0	1	12	0	0
8	32598954	.	A	G	11	7	18	0	1	19	0	0
8	32599413	.	T	C	12	7	19	0	0	19	0	0
8	32599586	.	C	T	12	4	16	0	1	17	0	0
8	32914694	.	C	T	15	17	32	0	2	34	0	0
8	32914782	.	T	A	10	16	26	0	4	30	0	0
8	32914813	.	A	T	10	8	18	0	1	19	0	0
8	32914853	.	C	T	5	3	8	0	2	10	0	0
8	32949287	.	C	T	2	8	10	0	5	15	0	0
8	33084515	.	A	G	11	12	23	0	0	23	0	0
8	33896326	.	A	T	14	13	27	1	1	29	0	0
8	33896585	.	C	T	31	18	49	0	0	49	0	0
8	33896902	.	G	A	18	23	41	0	0	41	0	0
8	33896922	.	G	A	21	18	39	0	2	41	0	0
8	33897266	.	T	C	21	0	21	0	29	50	0	0
8	33897274	.	C	T	2	19	21	0	28	49	0	0
8	33910008	.	G	A	27	24	51	4	4	59	0	0
8	33910017	.	G	A	31	25	56	5	2	63	0	0
8	33924284	.	A	G	15	20	35	0	2	37	0	0
8	33924432	.	C	T	1	25	26	0	19	45	0	0
8	34051719	.	G	A	22	9	31	0	1	32	0	0
8	34051850	.	G	A	14	11	25	1	1	27	0	0
8	34051930	.	T	G	12	13	25	0	1	26	0	0
8	34342146	.	G	A	10	8	18	0	1	19	0	0
8	34342214	.	A	T	9	13	22	0	2	24	0	0
8	34342462	.	A	G	6	14	20	1	1	22	0	0
8	34345285	.	G	A	12	18	30	0	1	31	0	0
8	34345372	.	T	C	18	9	27	0	0	27	0	0
8	34345390	.	A	G	16	9	25	0	0	25	0	0
8	34345583	.	A	G	10	11	21	0	0	21	0	0
8	34347281	.	T	C	15	20	35	0	3	38	0	0
8	34348958	.	A	C	8	3	11	0	0	11	0	0
8	34376264	.	G	A	3	3	6	0	2	8	0	0
8	34376728	.	G	A	2	3	5	0	0	5	0	0
8	34397046	.	C	T	1	5	6	0	1	7	0	0
8	35580986	.	C	T	2	2	4	0	0	4	0	0
8	35703841	.	C	A	1	3	4	0	0	4	0	0
8	35759363	.	T	G	5	2	7	0	0	7	0	0
8	35759402	.	C	T	2	6	8	0	0	8	0	0
8	35759444	.	C	T	3	4	7	0	0	7	0	0
8	35759726	.	C	T	2	2	4	0	0	4	0	0
8	35759999	.	C	T	4	4	8	0	0	9	1	0
8	35760218	.	C	T	7	3	10	0	1	11	0	0
8	36058504	.	G	T	4	4	8	0	0	8	0	0
8	36059070	.	T	C	1	2	3	0	0	3	0	0
8	36059333	.	T	C	2	6	8	0	0	8	0	0
8	36061541	.	C	T	0	4	4	0	2	6	0	0
8	36061619	.	G	A	3	2	5	0	0	5	0	0
8	36473361	.	A	T	1	6	7	0	1	8	0	0
8	36504422	.	T	A	1	2	3	0	0	3	0	0
8	36504620	.	A	G	3	3	6	0	0	6	0	0
8	36504728	.	T	G	2	3	5	0	0	5	0	0
8	36507260	.	T	G	4	2	6	0	0	6	0	0
8	36507449	.	T	C	1	3	4	0	0	4	0	0
8	36507470	.	C	T	3	3	6	0	0	6	0	0
8	36507636	.	T	C	2	2	4	0	0	4	0	0
8	36507764	.	G	A	3	3	6	0	0	6	0	0
8	36515721	.	A	G	6	4	10	0	0	10	0	0
8	36515779	.	G	A	0	8	8	0	2	10	0	0
8	36560180	.	C	T	16	9	25	0	2	27	0	0
8	36561942	.	A	T	19	8	27	0	3	30	0	0
8	36562262	.	T	C	21	7	28	0	1	29	0	0
8	36562293	.	C	T	17	5	22	0	1	23	0	0
8	36562451	.	A	G	19	0	19	0	10	29	0	0
8	36564005	.	A	G	20	9	29	0	2	31	0	0
8	36564746	.	C	T	3	9	12	0	2	14	0	0
8	36566125	.	C	T	20	8	28	0	4	32	0	0
8	36566167	.	G	A	16	15	31	0	1	32	0	0
8	36566182	.	T	C	15	16	31	0	1	32	0	0
8	36566353	.	T	C	23	9	32	0	1	33	0	0
8	36567283	.	C	T	37	10	47	0	0	47	0	0
8	36568561	.	A	G	21	8	29	0	3	32	0	0
8	36568755	.	T	C	12	13	25	0	0	25	0	0
8	36569810	.	T	C	9	8	17	0	1	18	0	0
8	36569924	.	C	A	16	6	22	0	1	23	0	0
8	36569925	.	T	A	14	7	21	0	2	23	0	0
8	36569968	.	A	C	10	9	19	0	0	19	0	0
8	36569990	.	A	G	10	8	18	0	0	18	0	0
8	36570602	.	A	G	1	1	2	0	1	3	0	0
8	36570947	.	C	T	4	3	7	0	0	7	0	0
8	36571018	.	A	C	0	2	2	0	1	3	0	0
8	36573472	.	T	C	6	2	8	0	0	8	0	0
8	36577083	.	T	C	7	4	11	0	0	11	0	0
8	36577368	.	T	A	6	3	9	0	0	9	0	0
8	36578796	.	T	C	5	4	9	0	0	9	0	0
8	36578813	.	C	T	6	5	11	0	0	11	0	0
8	36579387	.	T	C	3	2	5	0	1	6	0	0
8	36583834	.	T	C	12	12	24	0	2	26	0	0
8	36587934	.	A	G	11	12	23	0	1	24	0	0
8	36587936	.	A	G	11	1	12	0	11	23	0	0
8	36587970	.	C	A	9	13	22	0	2	24	0	0
8	36587981	.	G	T	10	13	23	0	0	23	0	0
8	36588124	.	G	A	16	11	27	0	1	28	0	0
8	36589197	.	C	T	6	9	15	0	1	16	0	0
8	36589260	.	T	A	6	5	11	0	1	12	0	0
8	36591868	.	A	C	5	6	11	0	0	11	0	0
8	36591985	.	C	T	1	5	6	0	0	6	0	0
8	36592018	.	A	G	2	10	12	0	0	12	0	0
8	36592021	.	C	A	0	9	9	0	3	12	0	0
8	36592159	.	A	G	3	4	7	0	0	7	0	0
8	36592160	.	A	G	3	3	6	0	1	7	0	0
8	36592297	.	G	A	6	7	13	1	0	14	0	0
8	36592374	.	A	G	15	11	26	0	1	27	0	0
8	36594354	.	T	C	10	0	10	0	11	21	0	0
8	36594481	.	T	G	10	11	21	0	0	21	0	0
8	36594509	.	G	A	9	10	19	0	0	19	0	0
8	36598244	.	T	C	6	0	6	0	9	15	0	0
8	36598441	.	C	T	1	6	7	0	7	14	0	0
8	36600867	.	C	T	7	10	17	0	1	18	0	0
8	36600879	.	G	A	8	8	16	0	1	17	0	0
8	36602459	.	C	T	11	6	17	0	0	17	0	0
8	36617635	.	C	G	4	6	10	0	0	10	0	0
8	36617669	.	A	G	2	9	11	0	0	11	0	0
8	36617728	.	G	A	7	8	15	0	0	15	0	0
8	36617954	.	C	T	8	7	15	1	1	17	0	0
8	36750219	.	T	C	3	3	6	0	0	6	0	0
8	36750222	.	C	T	3	3	6	0	0	6	0	0
8	36781593	.	G	A	0	6	6	0	5	11	0	0
8	36781596	.	A	G	3	0	3	0	8	11	0	0
8	36783396	.	C	T	6	3	9	0	0	9	0	0
8	36785572	.	A	C	1	6	7	0	0	7	0	0
8	36785599	.	T	C	3	4	7	0	0	7	0	0
8	36803687	.	G	A	6	4	10	0	0	10	0	0
8	36803717	.	G	A	1	7	8	0	6	14	0	0
8	36803850	.	T	C	9	11	20	0	0	20	0	0
8	36951346	.	C	T	12	10	22	0	0	22	0	0
8	36951481	.	C	T	8	10	18	0	0	18	0	0
8	36951610	.	T	C	17	8	25	0	1	26	0	0
8	36952015	.	A	G	17	0	17	0	28	45	0	0
8	36953884	.	A	G	7	8	15	0	1	16	0	0
8	36953947	.	C	T	8	11	19	0	3	22	0	0
8	36953950	.	G	C	10	12	22	0	1	23	0	0
8	36956254	.	C	T	13	14	27	0	1	28	0	0
8	36956269	.	T	C	15	15	30	0	1	31	0	0
8	36959694	.	C	T	10	8	18	0	0	18	0	0
8	36959915	.	T	A	11	6	17	0	1	18	0	0
8	36961895	.	C	A	19	15	34	0	1	35	0	0
8	36964126	.	G	A	10	19	29	0	1	30	0	0
8	36969205	.	T	C	12	17	29	0	1	30	0	0
8	36974328	.	C	T	24	16	40	0	3	43	0	0
8	36974514	.	C	T	27	24	51	0	2	53	0	0
8	36975826	.	A	G	16	15	31	0	0	31	0	0
8	36975928	.	T	C	16	9	25	0	0	25	0	0
8	36976089	.	T	C	12	7	19	0	0	19	0	0
8	36976247	.	A	C	3	3	6	0	0	6	0	0
8	36976255	.	T	G	1	4	5	0	0	5	0	0
8	36976288	.	T	A	3	6	9	0	0	9	0	0
8	36976319	.	T	A	6	3	9	0	1	10	0	0
8	36976352	.	G	T	2	3	5	0	7	12	0	0
8	36976388	.	A	T	15	8	23	0	1	24	0	0
8	36976432	.	T	A	12	14	26	0	1	27	0	0
8	36976557	.	G	A	17	13	30	0	3	33	0	0
8	36976836	.	C	A	15	14	29	0	3	32	0	0
8	36977178	.	A	G	22	25	47	0	0	47	0	0
8	36977199	.	C	A	24	23	47	0	1	48	0	0
8	36977520	.	G	A	21	16	37	0	0	37	0	0
8	36977848	.	T	C	9	13	22	0	0	22	0	0
8	36983963	.	C	G	4	2	6	0	0	6	0	0
8	37009605	.	C	T	2	2	4	0	0	4	0	0
8	37009674	.	C	G	5	0	5	0	3	8	0	0
8	37010662	.	T	C	3	8	11	0	0	11	0	0
8	37012762	.	T	A	6	6	12	0	1	13	0	0
8	37012825	.	C	T	7	6	13	0	0	13	0	0
8	37012872	.	C	G	4	7	11	0	0	11	0	0
8	37013093	.	A	G	3	9	12	0	0	12	0	0
8	37013255	.	T	C	3	5	8	0	0	8	0	0
8	37013282	.	T	C	4	2	6	0	2	8	0	0
8	37014582	.	T	C	7	10	17	0	1	18	0	0
8	37016584	.	G	T	3	9	12	0	15	28	1	0
8	37016616	.	C	T	14	7	21	0	1	22	0	0
8	37016638	.	A	G	14	10	24	0	1	25	0	0
8	37016784	.	G	A	1	17	18	0	8	26	0	0
8	37016790	.	T	C	10	16	26	0	0	26	0	0
8	37017149	.	G	A	14	10	24	0	2	26	0	0
8	37017159	.	C	T	16	13	29	0	1	30	0	0
8	37018904	.	A	G	18	0	18	0	15	33	0	0
8	37019048	.	G	A	20	19	39	0	0	39	0	0
8	37019062	.	C	A	19	19	38	0	2	40	0	0
8	37025576	.	A	T	20	12	32	0	2	34	0	0
8	37025614	.	T	A	17	14	31	0	1	32	0	0
8	37025633	.	A	G	15	1	16	0	16	32	0	0
8	37025896	.	T	C	8	12	20	0	0	20	0	0
8	37026130	.	G	A	16	14	30	0	0	30	0	0
8	37033173	.	T	G	2	3	5	0	0	5	0	0
8	37033321	.	T	C	3	3	6	0	0	6	0	0
8	37059952	.	A	G	2	2	4	0	0	4	0	0
8	37059976	.	A	G	2	4	6	0	0	6	0	0
8	37060595	.	A	C	13	7	20	0	1	21	0	0
8	37060640	.	A	G	8	6	14	0	0	14	0	0
8	37075875	.	T	C	1	2	3	0	0	3	0	0
8	37101346	.	T	C	3	8	11	0	0	11	0	0
8	37101370	.	G	C	2	6	8	0	1	9	0	0
8	37232122	.	C	T	2	6	8	0	7	15	0	0
8	37232189	.	A	C	14	0	14	0	6	20	0	0
8	37232442	.	A	C	15	0	15	0	19	34	0	0
8	37232487	.	A	C	21	22	43	0	1	44	0	0
8	37239141	.	C	T	0	7	7	0	5	12	0	0
8	37241078	.	A	G	8	3	11	0	1	12	0	0
8	37242367	.	T	G	4	2	6	0	0	6	0	0
8	37242374	.	A	T	4	2	6	0	0	6	0	0
8	37280726	.	C	T	8	13	21	0	1	22	0	0
8	37280858	.	C	T	10	8	18	0	1	19	0	0
8	37281109	.	T	C	4	27	31	0	4	35	0	0
8	37282486	.	A	C	22	10	32	0	0	32	0	0
8	37282487	.	G	T	20	9	29	0	2	31	0	0
8	37282610	.	G	A	17	9	26	1	0	27	0	0
8	37282752	.	C	T	27	13	40	0	3	43	0	0
8	37282866	.	T	G	16	16	32	0	0	32	0	0
8	37282950	.	T	G	8	14	22	0	1	23	0	0
8	37282976	.	G	A	9	12	21	0	2	23	0	0
8	37283177	.	T	A	5	3	8	0	2	10	0	0
8	37283487	.	A	C	8	10	18	0	0	18	0	0
8	37283536	.	G	A	3	10	13	0	2	15	0	0
8	37294918	.	C	T	0	11	11	0	22	33	0	0
8	37294923	.	G	A	19	8	27	0	8	35	0	0
8	37297524	.	C	T	16	22	38	0	0	38	0	0
8	37303891	.	G	A	9	9	18	0	0	18	0	0
8	37305515	.	G	C	5	2	7	0	0	7	0	0
8	37306114	.	A	G	6	2	8	0	3	11	0	0
8	37311888	.	T	A	4	5	9	0	0	9	0	0
8	39765993	.	T	A	1	2	3	0	0	3	0	0
8	40217948	.	G	A	1	4	5	0	0	5	0	0
8	40234640	.	C	T	5	2	7	0	1	8	0	0
8	40234830	.	A	G	8	6	14	0	0	14	0	0
8	40234831	.	T	A	8	5	13	0	1	14	0	0
8	40235219	.	A	G	5	4	9	0	0	9	0	0
8	40235244	.	C	T	5	6	11	0	0	11	0	0
8	40235281	.	G	A	6	6	12	0	0	12	0	0
8	40235348	.	G	C	2	7	9	1	1	11	0	0
8	40236088	.	T	A	4	2	6	0	0	6	0	0
8	40237799	.	C	A	1	2	3	1	0	4	0	0
8	40239998	.	A	T	2	1	3	0	0	3	0	0
8	40240019	.	G	A	1	2	3	0	0	3	0	0
8	40240043	.	C	T	1	3	4	0	0	4	0	0
8	40240922	.	C	G	12	7	19	0	1	20	0	0
8	40241441	.	A	G	25	15	40	8	1	49	0	0
8	40241446	.	A	G	25	15	40	8	2	50	0	0
8	40241640	.	A	T	27	10	37	2	0	39	0	0
8	40241681	.	A	G	29	14	43	0	1	44	0	0
8	40241695	.	T	A	31	10	41	0	1	42	0	0
8	40242103	.	G	A	23	13	36	0	0	36	0	0
8	40242453	.	G	A	10	11	21	0	0	21	0	0
8	40242613	.	T	A	5	7	12	0	2	14	0	0
8	40243052	.	G	C	15	16	31	0	1	32	0	0
8	40243148	.	T	C	12	16	28	0	1	29	0	0
8	40248373	.	T	G	6	13	19	0	0	19	0	0
8	40248673	.	T	C	14	14	28	0	3	31	0	0
8	40248976	.	G	T	14	20	34	0	0	34	0	0
8	40251444	.	T	G	15	14	29	0	0	29	0	0
8	40251834	.	C	A	16	4	20	0	0	20	0	0
8	40252508	.	C	T	3	14	17	0	15	32	0	0
8	40254366	.	A	G	8	13	21	0	0	21	0	0
8	40254375	.	T	G	6	13	19	0	3	22	0	0
8	40270856	.	G	A	9	12	21	0	0	21	0	0
8	40325709	.	G	T	16	7	23	0	0	23	0	0
8	40326039	.	A	G	8	21	29	0	1	30	0	0
8	40326128	.	C	T	14	14	28	0	1	29	0	0
8	40326736	.	A	G	9	3	12	0	1	13	0	0
8	40427489	.	T	C	7	5	12	0	0	12	0	0
8	40427890	.	T	C	5	3	8	0	0	8	0	0
8	40427912	.	T	C	1	6	7	0	0	7	0	0
8	40427932	.	T	C	1	5	6	0	0	6	0	0
8	40428012	.	T	G	2	4	6	0	0	6	0	0
8	40428015	.	A	C	2	4	6	0	0	6	0	0
8	40430038	.	C	A	4	6	10	0	0	10	0	0
8	40430293	.	C	T	0	4	4	0	4	8	0	0
8	40430322	.	A	G	3	4	7	0	2	9	0	0
8	40430664	.	G	A	2	3	5	0	0	5	0	0
8	40430771	.	A	G	5	2	7	0	0	7	0	0
8	40631823	.	C	T	3	8	11	0	2	13	0	0
8	40631862	.	C	T	2	7	9	0	0	9	0	0
8	40632313	.	C	G	7	8	15	0	0	15	0	0
8	40632411	.	A	T	4	6	10	0	0	10	0	0
8	40632758	.	A	C	5	5	10	1	1	12	0	0
8	40632793	.	A	T	4	3	7	0	0	7	0	0
8	40633172	.	G	C	6	4	10	0	0	10	0	0
8	40644840	.	C	T	7	5	12	0	0	12	0	0
8	40644876	.	T	G	7	8	15	0	0	15	0	0
8	40645084	.	T	C	5	9	14	0	1	15	0	0
8	40645890	.	A	G	5	4	9	0	0	9	0	0
8	40646154	.	C	T	5	10	15	0	0	15	0	0
8	41186455	.	A	C	4	4	8	0	1	9	0	0
8	41194542	.	C	G	4	5	9	0	0	9	0	0
8	41206801	.	C	G	1	3	4	0	0	4	0	0
8	41238110	.	G	A	1	2	3	0	2	5	0	0
8	41239494	.	G	A	3	4	7	0	0	7	0	0
8	41239500	.	T	C	3	6	9	0	0	9	0	0
8	41240949	.	T	C	3	3	6	0	0	6	0	0
8	41249879	.	A	G	11	11	22	0	0	22	0	0
8	41249882	.	T	C	11	10	21	0	1	22	0	0
8	41249942	.	T	C	10	11	21	0	0	21	0	0
8	41255346	.	C	T	9	10	19	0	0	19	0	0
8	41255439	.	G	A	10	15	25	0	1	26	0	0
8	41255554	.	C	T	13	8	21	0	2	23	0	0
8	41255573	.	T	C	11	8	19	0	2	21	0	0
8	41255750	.	G	A	6	2	8	0	1	9	0	0
8	41260534	.	C	T	26	14	40	0	4	44	0	0
8	41260634	.	A	G	22	30	52	0	2	54	0	0
8	41260668	.	A	G	28	22	50	0	3	53	0	0
8	41260823	.	G	C	20	22	42	0	1	43	0	0
8	41260877	.	A	G	27	22	49	0	1	50	0	0
8	41260880	.	T	C	26	1	27	0	25	52	0	0
8	41260923	.	T	A	26	22	48	0	2	50	0	0
8	41260985	.	G	A	27	22	49	0	1	50	0	0
8	41261178	.	T	C	24	14	38	0	0	38	0	0
8	41261190	.	A	G	26	16	42	0	0	42	0	0
8	41261294	.	A	G	16	28	44	0	2	46	0	0
8	41263005	.	A	G	31	22	53	0	2	55	0	0
8	41263085	.	G	A	27	20	47	0	3	50	0	0
8	41263206	.	A	G	24	21	45	2	1	48	0	0
8	41263220	.	T	C	21	21	42	2	1	45	0	0
8	41264447	.	A	T	23	22	45	0	3	48	0	0
8	41264549	.	C	G	30	21	51	0	2	53	0	0
8	41264786	.	A	C	30	23	53	0	3	56	0	0
8	41264788	.	T	A	30	22	52	0	3	55	0	0
8	41265180	.	T	C	28	19	47	0	2	49	0	0
8	41265264	.	G	A	27	16	43	0	1	44	0	0
8	41265549	.	T	C	21	18	39	0	1	40	0	0
8	41266567	.	T	C	18	15	33	0	2	35	0	0
8	41266573	.	A	T	18	14	32	0	1	33	0	0
8	41267976	.	C	T	16	10	26	0	1	27	0	0
8	41273680	.	C	T	11	12	23	0	1	24	0	0
8	41274561	.	T	C	6	5	11	0	0	11	0	0
8	41274617	.	G	A	6	3	9	0	1	10	0	0
8	41468868	.	C	T	6	5	11	0	1	12	0	0
8	41474547	.	T	C	5	5	10	0	0	10	0	0
8	41474556	.	G	A	7	7	14	0	0	14	0	0
8	41478650	.	C	T	6	1	7	0	1	8	0	0
8	41478670	.	C	T	5	4	9	0	0	9	0	0
8	41482466	.	C	T	6	5	11	0	1	12	0	0
8	41484219	.	G	A	5	9	14	0	0	14	0	0
8	41485132	.	A	G	2	6	8	0	0	8	0	0
8	41488641	.	C	G	0	5	5	0	4	9	0	0
8	41493936	.	C	G	3	4	7	0	1	8	0	0
8	41493994	.	T	C	3	3	6	0	0	6	0	0
8	41502731	.	T	C	1	0	1	0	2	3	0	0
8	41533605	.	T	C	4	9	13	0	0	13	0	0
8	41533738	.	A	T	6	6	12	0	0	12	0	0
8	42075668	.	A	T	4	5	9	0	1	10	0	0
8	42075701	.	A	G	2	6	8	0	1	9	0	0
8	42834091	.	C	G	3	8	11	0	0	11	0	0
8	42834146	.	T	C	3	7	10	0	0	10	0	0
8	43455875	.	G	A	7	2	9	0	0	9	0	0
8	43935417	.	G	T	6	2	8	0	0	8	0	0
8	44211479	.	C	A	1	2	3	0	0	3	0	0
8	44211831	.	G	A	4	4	8	0	1	9	0	0
8	44213470	.	T	G	2	4	6	0	0	6	0	0
8	44213729	.	C	T	2	2	4	0	0	4	0	0
8	44296292	.	C	T	0	4	4	0	3	7	0	0
8	44296672	.	G	A	3	8	11	0	0	11	0	0
8	44296985	.	G	A	2	3	5	0	0	5	0	0
8	44297174	.	A	C	5	2	7	0	0	7	0	0
8	44297555	.	A	G	3	3	6	0	0	6	0	0
8	44297609	.	G	A	2	3	5	0	0	5	0	0
8	44299173	.	G	C	1	4	5	0	0	5	0	0
8	44446256	.	G	A	4	4	8	0	0	8	0	0
8	44599938	.	C	T	9	6	15	0	0	15	0	0
8	44602132	.	G	A	9	5	14	0	1	15	0	0
8	44602264	.	A	G	8	3	11	0	0	11	0	0
8	44602353	.	G	C	6	0	6	0	6	12	0	0
8	44602357	.	T	C	7	6	13	0	0	13	0	0
8	44604588	.	C	T	0	6	6	0	5	12	1	0
8	44617902	.	G	A	1	4	5	0	0	5	0	0
8	44617903	.	A	T	1	4	5	0	0	5	0	0
8	44618024	.	C	T	6	4	10	0	1	11	0	0
8	44669550	.	T	C	5	6	11	0	0	11	0	0
8	44671767	.	T	C	3	4	7	0	1	8	0	0
8	44677544	.	C	T	6	4	10	0	1	11	0	0
8	44677613	.	T	C	5	10	15	0	0	15	0	0
8	44694956	.	G	A	0	6	6	0	5	11	0	0
8	44695043	.	A	C	8	9	17	0	0	17	0	0
8	44695140	.	A	C	6	8	14	0	2	16	0	0
8	44695230	.	A	T	9	11	20	0	0	20	0	0
8	44714384	.	C	T	7	4	11	0	0	11	0	0
8	44726070	.	C	A	3	5	8	0	0	8	0	0
8	44730536	.	G	A	1	4	5	0	5	10	0	0
8	44737646	.	C	A	1	8	9	0	0	9	0	0
8	44894337	.	G	T	3	5	8	0	0	8	0	0
8	44894575	.	T	A	2	3	5	0	0	5	0	0
8	44894604	.	C	T	5	6	11	0	0	11	0	0
8	44894631	.	G	C	6	9	15	0	0	15	0	0
8	44897853	.	C	A	1	7	8	0	8	16	0	0
8	44921346	.	G	A	2	2	4	0	0	4	0	0
8	44923501	.	T	G	3	2	5	0	1	6	0	0
8	44923700	.	T	C	2	0	2	0	4	6	0	0
8	44959583	.	C	T	3	2	5	0	0	5	0	0
8	44959589	.	A	G	3	2	5	0	0	5	0	0
8	44975939	.	G	C	1	2	3	0	0	3	0	0
8	44976120	.	G	A	2	3	5	0	0	5	0	0
8	45293782	.	A	G	4	0	4	0	7	11	0	0
8	45298603	.	G	A	7	7	14	0	1	15	0	0
8	45298943	.	G	C	8	8	16	0	1	17	0	0
8	45304210	.	T	C	4	11	15	0	0	15	0	0
8	45308963	.	A	C	10	11	21	0	0	21	0	0
8	45312231	.	G	C	1	9	10	0	11	21	0	0
8	45312285	.	C	A	14	6	20	0	3	23	0	0
8	45313023	.	A	C	7	22	29	0	0	29	0	0
8	45315444	.	T	C	13	12	25	0	4	29	0	0
8	45317898	.	A	T	9	22	31	0	2	33	0	0
8	45317976	.	G	A	5	14	19	0	17	36	0	0
8	45318124	.	C	T	20	14	34	0	1	35	0	0
8	45319659	.	A	G	19	0	19	0	21	40	0	0
8	45325269	.	G	C	15	24	39	0	3	42	0	0
8	45328278	.	T	A	8	7	15	0	0	15	0	0
8	45361816	.	A	G	17	11	28	0	0	28	0	0
8	45365789	.	T	C	11	12	23	1	0	24	0	0
8	45374151	.	A	T	14	14	28	1	3	32	0	0
8	45374477	.	A	G	7	17	24	0	0	24	0	0
8	45374665	.	T	A	13	15	28	0	0	28	0	0
8	45374828	.	A	C	9	9	18	0	3	21	0	0
8	45374884	.	T	G	19	12	31	0	0	31	0	0
8	45374966	.	G	T	4	6	10	0	0	10	0	0
8	45374970	.	A	G	4	6	10	0	0	10	0	0
8	45381427	.	T	A	2	4	6	0	0	6	0	0
8	45381488	.	C	A	3	4	7	0	0	7	0	0
8	45381919	.	G	A	2	2	4	0	4	8	0	0
8	45385546	.	T	A	5	2	7	0	0	7	0	0
8	45392034	.	G	A	0	4	4	0	9	13	0	0
8	45394968	.	A	T	1	2	3	0	0	3	0	0
8	45395280	.	T	C	1	2	3	0	0	3	0	0
8	45395318	.	A	G	1	1	2	0	0	3	1	0
8	45395357	.	C	T	1	4	5	0	2	7	0	0
8	45396028	.	T	C	8	2	10	0	5	15	0	0
8	45427189	.	C	A	24	21	45	0	2	47	0	0
8	45428039	.	C	T	15	18	33	0	0	33	0	0
8	45430757	.	G	A	28	19	47	0	1	48	0	0
8	45755117	.	G	A	2	5	7	0	0	7	0	0
8	45755185	.	T	C	3	4	7	0	0	7	0	0
8	45755212	.	G	T	4	2	6	0	0	6	0	0
8	45755577	.	G	A	2	6	8	0	0	8	0	0
8	45755816	.	T	C	36	26	62	0	1	63	0	0
8	45755973	.	C	G	29	41	70	0	1	71	0	0
8	45756191	.	A	G	37	21	58	0	5	63	0	0
8	45756206	.	G	A	33	22	55	0	5	60	0	0
8	45760071	.	A	C	4	0	4	0	10	14	0	0
8	45762689	.	C	T	1	4	5	0	0	5	0	0
8	45762690	.	C	T	0	4	4	0	1	5	0	0
8	45763562	.	G	A	13	13	26	1	3	30	0	0
8	45763991	.	A	G	19	20	39	0	3	42	0	0
8	45764006	.	G	C	21	16	37	0	3	40	0	0
8	45764118	.	C	T	3	18	21	0	24	45	0	0
8	45764327	.	T	C	9	10	19	0	1	20	0	0
8	45764684	.	T	C	16	0	16	0	13	29	0	0
8	45764697	.	T	C	18	8	26	0	0	26	0	0
8	45764873	.	T	C	9	15	24	0	0	24	0	0
8	45764893	.	T	C	9	28	37	0	0	37	0	0
8	45764939	.	G	A	24	24	48	0	1	49	0	0
8	45764988	.	A	T	23	27	50	0	2	53	1	0
8	45765023	.	T	A	30	18	48	1	5	54	0	0
8	45765024	.	T	A	33	17	50	1	4	55	0	0
8	45765305	.	G	A	20	25	45	0	4	49	0	0
8	45772915	.	C	A	19	16	35	0	1	36	0	0
8	45774471	.	C	T	1	14	15	0	10	25	0	0
8	45775047	.	C	T	8	18	26	0	0	26	0	0
8	45775068	.	A	T	16	8	24	0	0	24	0	0
8	45775304	.	G	A	10	11	21	0	0	21	0	0
8	45775319	.	G	T	11	13	24	0	0	24	0	0
8	45779729	.	A	C	11	13	24	0	2	26	0	0
8	45786186	.	C	T	1	11	12	0	7	19	0	0
8	45786528	.	A	G	12	5	17	0	0	17	0	0
8	45786615	.	A	G	4	5	9	0	0	9	0	0
8	45787137	.	A	G	6	12	18	0	1	19	0	0
8	45788941	.	T	G	8	8	16	0	1	17	0	0
8	45797305	.	G	A	6	9	15	0	0	15	0	0
8	45834759	.	C	T	1	2	3	0	0	3	0	0
8	45834940	.	G	A	3	7	10	0	2	12	0	0
8	45838228	.	C	T	6	2	8	0	0	8	0	0
8	45852792	.	T	C	1	2	3	0	0	3	0	0
8	45852802	.	T	C	1	3	4	0	0	4	0	0
8	45853288	.	A	C	6	4	10	0	1	11	0	0
8	45853344	.	T	A	2	7	9	0	0	9	0	0
8	45853626	.	G	A	8	4	12	0	0	12	0	0
8	45864652	.	G	C	9	16	25	0	0	25	0	0
8	45871782	.	A	G	2	4	6	0	1	7	0	0
8	45875696	.	T	G	1	2	3	0	0	3	0	0
8	45896997	.	T	C	2	0	2	0	4	6	0	0
8	45898077	.	A	G	1	2	3	0	0	3	0	0
8	45939385	.	G	A	3	3	6	0	0	6	0	0
8	45939398	.	A	G	2	3	5	0	0	5	0	0
8	45944896	.	T	A	7	10	17	0	0	17	0	0
8	45944983	.	G	A	3	5	8	0	0	8	0	0
8	45945024	.	C	T	5	3	8	0	1	9	0	0
8	45951974	.	G	A	0	7	7	0	2	9	0	0
8	45952152	.	A	T	3	4	7	0	0	7	0	0
8	45952281	.	C	T	6	11	17	0	0	17	0	0
8	45952547	.	G	T	4	2	6	0	1	7	0	0
8	45965749	.	G	A	2	3	5	0	0	5	0	0
8	46005260	.	T	A	2	3	5	0	0	5	0	0
8	46013996	.	A	G	2	3	5	0	0	5	0	0
8	46014037	.	C	A	2	2	4	0	0	4	0	0
8	46077850	.	T	A	5	3	8	0	1	9	0	0
8	46077879	.	C	A	4	3	7	0	1	8	0	0
8	46078168	.	C	A	3	4	7	0	0	7	0	0
8	46078241	.	A	T	10	8	18	0	1	19	0	0
8	46078264	.	A	T	8	7	15	0	2	17	0	0
8	46078287	.	A	G	8	10	18	0	2	20	0	0
8	46078342	.	C	G	10	7	17	0	0	17	0	0
8	46089052	.	T	C	12	10	22	0	2	24	0	0
8	46094790	.	G	A	9	14	23	0	0	23	0	0
8	46123717	.	G	A	8	6	14	0	0	14	0	0
8	46123731	.	G	A	7	7	14	0	1	15	0	0
8	46125509	.	G	A	4	4	8	0	0	8	0	0
8	46132662	.	G	C	3	0	3	0	4	7	0	0
8	46233594	.	C	T	1	2	3	0	0	3	0	0
8	46233600	.	T	C	1	0	1	0	2	3	0	0
8	46258216	.	A	G	2	2	4	0	0	4	0	0
8	46286410	.	T	C	1	3	4	0	0	4	0	0
8	46294285	.	C	T	2	2	4	0	0	4	0	0
8	46317199	.	G	A	3	2	5	0	0	5	0	0
8	46327404	.	A	G	4	2	6	0	0	6	0	0
8	46337310	.	A	G	2	2	4	0	0	4	0	0
8	46340777	.	A	G	2	0	2	0	4	6	0	0
8	46346713	.	C	T	4	7	11	0	0	11	0	0
8	46346837	.	T	C	4	7	11	0	2	13	0	0
8	46346949	.	G	T	0	3	3	0	2	5	0	0
8	46347099	.	A	T	3	3	6	0	2	9	1	0
8	46347147	.	C	T	1	5	6	0	0	6	0	0
8	46348145	.	G	T	5	2	7	0	0	7	0	0
8	46356282	.	G	A	6	6	12	0	0	12	0	0
8	46359860	.	C	T	0	3	3	0	5	8	0	0
8	46362082	.	G	A	4	3	7	0	0	7	0	0
8	46362083	.	G	T	4	3	7	0	0	7	0	0
8	46362293	.	G	A	3	3	6	0	0	6	0	0
8	46367300	.	C	T	5	2	7	0	0	7	0	0
8	46367312	.	G	A	5	2	7	0	0	7	0	0
8	46376645	.	A	G	2	2	4	0	0	4	0	0
8	46395923	.	A	G	3	2	5	0	0	5	0	0
8	46431134	.	A	G	10	4	14	0	0	14	0	0
8	46431240	.	A	C	2	6	8	0	0	8	0	0
8	46431247	.	A	T	2	7	9	0	0	9	0	0
8	46431298	.	A	G	6	6	12	0	1	13	0	0
8	46431329	.	T	A	8	4	12	0	0	12	0	0
8	46431403	.	T	G	7	5	12	0	0	12	0	0
8	46431408	.	G	A	7	5	12	0	0	12	0	0
8	46431453	.	A	T	9	5	14	0	0	14	0	0
8	46431620	.	C	T	7	4	11	0	0	11	0	0
8	46431631	.	G	C	5	4	9	0	0	9	0	0
8	46433538	.	T	C	9	5	14	0	0	14	0	0
8	46433554	.	G	C	6	8	14	0	0	14	0	0
8	46433637	.	T	C	5	4	9	0	0	9	0	0
8	46433659	.	A	T	7	3	10	0	0	10	0	0
8	46433693	.	T	C	7	5	12	0	0	12	0	0
8	46433712	.	T	A	8	4	12	0	0	12	0	0
8	46853005	.	A	T	14	7	21	0	3	24	0	0
8	46853015	.	A	T	15	6	21	0	1	22	0	0
8	46855313	.	G	A	7	6	13	0	1	14	0	0
8	46881326	.	G	T	13	5	18	0	0	18	0	0
8	46883677	.	T	A	9	7	16	0	0	16	0	0
8	47145008	.	A	G	49	38	87	0	0	87	0	0
8	47147333	.	A	T	37	27	64	0	3	67	0	0
8	47149394	.	A	G	32	31	63	0	4	67	0	0
8	47159514	.	G	A	6	3	9	0	1	10	0	0
8	47159557	.	C	A	5	5	10	0	1	11	0	0
8	47163244	.	G	A	4	2	6	0	0	6	0	0
8	47163283	.	G	A	3	4	7	0	1	8	0	0
8	47178393	.	T	A	6	4	10	0	0	10	0	0
8	47834998	.	G	A	5	6	11	0	1	12	0	0
8	47835146	.	T	C	9	6	15	0	0	15	0	0
8	47835148	.	C	T	7	6	13	0	1	14	0	0
8	47843557	.	T	A	2	3	5	0	0	5	0	0
8	47911031	.	C	G	7	0	7	0	7	14	0	0
8	47927814	.	C	T	6	5	11	0	1	12	0	0
8	47928187	.	T	A	6	4	10	0	0	10	0	0
8	47932409	.	C	T	6	5	11	0	2	13	0	0
8	47932442	.	G	A	6	4	10	0	1	11	0	0
8	47937152	.	T	C	12	6	18	0	0	18	0	0
8	47937156	.	A	G	12	0	12	0	6	18	0	0
8	47937263	.	T	C	11	10	21	0	0	21	0	0
8	47946517	.	T	C	19	8	27	0	1	28	0	0
8	47946674	.	G	A	5	10	15	0	1	16	0	0
8	47946753	.	C	T	16	8	24	0	1	25	0	0
8	47946776	.	T	C	13	11	24	0	1	25	0	0
8	47946833	.	A	G	11	13	24	0	2	26	0	0
8	47946846	.	A	G	5	12	17	0	3	20	0	0
8	47947052	.	A	C	6	7	13	0	1	14	0	0
8	47947297	.	C	T	11	11	22	0	0	22	0	0
8	47947341	.	C	A	12	7	19	0	0	19	0	0
8	47947649	.	T	A	16	18	34	0	2	36	0	0
8	47947772	.	A	G	15	1	16	0	8	24	0	0
8	47947996	.	T	G	14	9	23	1	2	26	0	0
8	47948102	.	T	A	25	13	38	0	0	38	0	0
8	47948225	.	A	T	8	30	38	2	0	40	0	0
8	47948602	.	G	A	4	12	16	0	21	37	0	0
8	47948755	.	C	T	12	16	28	0	1	29	0	0
8	47948820	.	A	C	6	11	17	0	0	17	0	0
8	47948866	.	C	A	2	5	7	0	0	7	0	0
8	48093139	.	T	C	3	2	5	0	0	5	0	0
8	48603552	.	T	C	6	7	13	0	0	13	0	0
8	48603788	.	G	C	0	6	6	0	2	8	0	0
8	48603978	.	T	A	7	5	12	0	0	12	0	0
8	48604114	.	T	A	5	4	9	0	1	10	0	0
8	48629640	.	T	A	4	5	9	0	0	9	0	0
8	48629668	.	G	A	8	5	13	0	1	14	0	0
8	48629797	.	C	A	11	7	18	0	1	19	0	0
8	48629946	.	A	T	12	7	19	0	1	20	0	0
8	48629969	.	T	C	13	0	13	0	10	23	0	0
8	48630017	.	A	G	12	4	16	0	1	17	0	0
8	48642433	.	G	A	3	6	9	0	0	9	0	0
8	48646053	.	A	G	3	3	6	0	2	8	0	0
8	48646089	.	G	A	6	3	9	0	0	9	0	0
8	48649106	.	A	C	1	4	5	0	0	5	0	0
8	48658757	.	T	A	2	2	4	0	0	4	0	0
8	48660930	.	G	A	1	2	3	0	0	3	0	0
8	48801480	.	G	A	0	3	3	0	7	10	0	0
8	48801508	.	C	T	6	5	11	0	1	12	0	0
8	48801553	.	C	T	7	5	12	0	0	12	0	0
8	48801678	.	C	T	6	2	8	0	2	10	0	0
8	48809531	.	C	G	6	4	10	0	0	10	0	0
8	48809570	.	G	A	4	7	11	0	0	11	0	0
8	48809587	.	T	G	3	5	8	0	0	8	0	0
8	48809678	.	A	C	4	10	14	0	1	15	0	0
8	48816438	.	T	G	4	1	5	0	0	5	0	0
8	48816447	.	C	T	0	2	2	0	5	7	0	0
8	48958189	.	T	C	12	0	12	0	2	14	0	0
8	48958387	.	A	C	1	4	5	0	0	5	0	0
8	48958392	.	T	C	0	5	5	0	0	5	0	0
8	48958468	.	C	T	4	3	7	0	1	8	0	0
8	48958637	.	A	G	5	4	9	0	0	9	0	0
8	48958822	.	C	T	14	9	23	0	0	23	0	0
8	48959047	.	G	A	5	5	10	0	0	10	0	0
8	48965853	.	C	G	1	2	3	0	0	3	0	0
8	48966140	.	C	G	4	3	7	0	0	7	0	0
8	49003785	.	A	G	4	0	4	0	4	8	0	0
8	49005753	.	C	T	3	4	7	0	0	7	0	0
8	49009822	.	C	A	4	5	9	0	1	10	0	0
8	49009829	.	C	T	6	4	10	0	0	10	0	0
8	49009917	.	T	C	3	3	6	0	0	6	0	0
8	49034323	.	G	A	1	6	7	0	2	9	0	0
8	49078817	.	C	T	3	2	5	0	1	6	0	0
8	49078827	.	A	C	1	3	4	0	1	5	0	0
8	49082598	.	C	A	3	4	7	0	0	7	0	0
8	49086105	.	G	T	4	5	9	0	1	10	0	0
8	49092108	.	C	T	5	15	20	0	0	20	0	0
8	49092129	.	C	T	11	8	19	0	0	19	0	0
8	49096541	.	G	T	5	10	15	1	1	17	0	0
8	49108347	.	A	T	12	13	25	0	2	27	0	0
8	49170190	.	T	A	7	4	11	0	1	12	0	0
8	49170366	.	T	A	34	32	66	0	3	69	0	0
8	49172338	.	A	G	36	33	69	0	4	73	0	0
8	49310830	.	C	T	2	4	6	0	0	6	0	0
8	49310928	.	T	C	0	4	4	0	1	5	0	0
8	49311090	.	C	T	8	7	15	0	1	16	0	0
8	49311355	.	T	C	16	18	34	1	1	36	0	0
8	49311396	.	C	A	12	17	29	1	1	31	0	0
8	49311398	.	G	C	11	17	28	1	0	29	0	0
8	49345116	.	C	T	3	6	9	0	0	9	0	0
8	49345191	.	T	C	5	11	16	0	0	16	0	0
8	49345272	.	A	G	8	4	12	0	0	12	0	0
8	49404152	.	G	T	19	22	41	2	5	48	0	0
8	49404262	.	C	T	36	26	62	0	1	63	0	0
8	49404502	.	C	T	42	26	68	2	3	73	0	0
8	49404928	.	C	T	32	40	72	0	3	75	0	0
8	49406014	.	G	A	1	3	4	0	0	4	0	0
8	49406035	.	G	A	3	4	7	0	0	7	0	0
8	49406062	.	G	C	5	2	7	1	0	8	0	0
8	49406083	.	G	A	2	2	4	1	0	5	0	0
8	49413417	.	G	T	39	35	74	0	3	77	0	0
8	49413444	.	G	A	25	34	59	0	8	67	0	0
8	49413459	.	G	A	25	36	61	0	6	67	0	0
8	49415718	.	G	C	34	18	52	0	2	54	0	0
8	49435964	.	C	G	18	7	25	0	1	26	0	0
8	49443191	.	A	G	9	0	9	0	14	23	0	0
8	49447181	.	A	G	2	2	4	0	0	4	0	0
8	49447458	.	A	T	2	4	6	0	0	6	0	0
8	49447519	.	G	A	6	7	13	0	0	13	0	0
8	49447559	.	G	T	2	14	16	0	0	16	0	0
8	49447574	.	T	G	4	11	15	0	0	15	0	0
8	49447657	.	C	A	2	5	7	0	0	7	0	0
8	49710686	.	G	A	8	6	14	0	1	15	0	0
8	49722313	.	T	C	4	6	10	0	1	11	0	0
8	49728659	.	T	A	10	11	21	0	1	22	0	0
8	49732246	.	G	T	2	2	4	0	0	4	0	0
8	49745727	.	T	G	3	4	7	0	0	7	0	0
8	49746224	.	T	C	11	9	20	0	0	20	0	0
8	49746256	.	G	A	11	10	21	0	1	22	0	0
8	49746440	.	T	C	22	20	42	1	5	48	0	0
8	49746456	.	T	G	25	18	43	1	5	49	0	0
8	49755801	.	A	C	17	15	32	0	2	34	0	0
8	49755867	.	A	T	19	12	31	0	2	33	0	0
8	49756121	.	A	T	13	16	29	0	0	30	1	0
8	49759453	.	A	G	12	13	25	0	0	25	0	0
8	49768925	.	G	A	4	2	6	0	0	6	0	0
8	49769496	.	G	A	3	2	5	0	0	5	0	0
8	49845392	.	A	G	8	2	10	0	1	11	0	0
8	49851155	.	C	G	4	6	10	0	2	12	0	0
8	49860718	.	C	T	4	10	14	0	1	15	0	0
8	49864103	.	T	C	5	7	12	0	0	12	0	0
8	49864124	.	G	A	14	6	20	0	1	21	0	0
8	49864212	.	C	T	7	8	15	0	0	15	0	0
8	49864232	.	G	A	8	5	13	0	1	14	0	0
8	49864402	.	C	T	13	5	18	0	0	18	0	0
8	49864655	.	G	T	4	8	12	0	1	13	0	0
8	49865070	.	G	A	4	2	6	0	0	6	0	0
8	49865099	.	T	G	4	2	6	0	1	7	0	0
8	49865124	.	C	T	5	1	6	0	0	6	0	0
8	49899474	.	G	A	5	3	8	0	0	8	0	0
8	49899528	.	G	A	5	7	12	0	0	12	0	0
8	49899621	.	G	A	4	4	8	0	0	8	0	0
8	49901127	.	T	C	4	0	4	0	6	10	0	0
8	49908677	.	C	T	1	5	6	0	0	6	0	0
8	49908719	.	C	T	1	3	4	0	3	7	0	0
8	49908792	.	G	A	1	2	3	0	0	3	0	0
8	49908841	.	C	T	2	3	5	0	0	5	0	0
8	49911143	.	G	A	1	4	5	0	0	5	0	0
8	49912557	.	G	A	3	4	7	0	0	7	0	0
8	49912682	.	G	A	2	3	5	0	0	5	0	0
8	49947483	.	C	T	4	8	12	0	1	13	0	0
8	49949798	.	C	T	5	8	13	0	0	13	0	0
8	49952260	.	C	T	4	9	13	0	1	14	0	0
8	49969037	.	C	T	3	6	9	0	0	9	0	0
8	49991438	.	A	G	3	3	6	0	0	6	0	0
8	49993381	.	A	C	2	3	5	0	0	5	0	0
8	49996176	.	T	C	1	3	4	0	0	4	0	0
8	50000859	.	C	A	3	6	9	0	0	9	0	0
8	50012607	.	G	A	5	4	9	0	1	10	0	0
8	50159515	.	A	G	4	3	7	0	0	7	0	0
8	50163398	.	A	G	4	0	4	0	10	14	0	0
8	50179868	.	T	A	6	3	9	0	1	10	0	0
8	50179944	.	T	G	10	3	13	0	0	13	0	0
8	50501462	.	C	T	1	2	3	0	0	3	0	0
8	50501513	.	C	G	1	0	1	0	4	5	0	0
8	50501981	.	C	T	1	2	3	0	0	3	0	0
8	50818102	.	G	T	6	5	11	0	0	11	0	0
8	50818180	.	C	T	7	3	10	0	0	10	0	0
8	50837684	.	G	C	1	3	4	0	1	5	0	0
8	50837731	.	A	G	1	3	4	0	0	4	0	0
8	50845104	.	T	C	3	2	5	0	0	5	0	0
8	50849973	.	C	T	4	3	7	0	0	7	0	0
8	50851915	.	A	T	1	2	3	0	1	4	0	0
8	50890053	.	G	A	2	1	3	0	0	3	0	0
8	50890057	.	A	T	2	2	4	0	0	4	0	0
8	50890422	.	A	T	8	8	16	0	1	17	0	0
8	50898126	.	C	T	2	4	6	0	6	12	0	0
8	50947386	.	G	C	30	23	53	0	0	53	0	0
8	50947648	.	T	A	13	23	36	0	1	37	0	0
8	50948620	.	A	G	9	0	9	0	17	26	0	0
8	50948623	.	T	C	10	18	28	0	1	29	0	0
8	50949040	.	T	A	18	20	38	0	1	39	0	0
8	50949086	.	T	A	6	9	15	3	0	18	0	0
8	50949128	.	T	C	10	8	18	3	1	22	0	0
8	50949160	.	A	T	12	17	29	0	0	29	0	0
8	50949188	.	C	T	12	19	31	0	1	32	0	0
8	50949430	.	T	A	20	18	38	0	4	42	0	0
8	50949479	.	A	G	22	28	50	0	1	51	0	0
8	50949501	.	A	T	34	24	58	0	0	58	0	0
8	50949570	.	G	A	32	20	52	0	5	57	0	0
8	50949573	.	G	A	25	29	54	0	4	58	0	0
8	50949639	.	C	T	25	22	47	5	3	55	0	0
8	50949766	.	C	T	10	7	17	0	1	18	0	0
8	50949903	.	A	G	24	0	24	0	20	44	0	0
8	50960443	.	C	A	11	14	25	0	1	27	1	0
8	50960542	.	T	C	11	14	25	0	0	25	0	0
8	50962536	.	T	C	18	20	38	0	0	38	0	0
8	50962623	.	T	G	15	0	15	0	20	35	0	0
8	50967774	.	C	G	4	8	12	0	1	13	0	0
8	50967890	.	C	T	5	12	17	0	0	17	0	0
8	50969141	.	T	C	4	6	10	0	0	10	0	0
8	50969150	.	A	G	5	6	11	0	0	11	0	0
8	50969493	.	T	A	13	8	21	1	0	22	0	0
8	50971524	.	G	A	6	6	12	1	1	14	0	0
8	50972267	.	C	T	7	5	12	0	1	13	0	0
8	51008365	.	T	C	3	2	5	0	0	5	0	0
8	51008524	.	T	G	3	3	6	0	1	7	0	0
8	51026996	.	A	G	5	4	9	0	0	9	0	0
8	51027069	.	C	T	5	3	8	0	0	8	0	0
8	51027111	.	T	G	2	2	4	0	0	4	0	0
8	51027123	.	C	A	2	2	4	0	0	4	0	0
8	51103031	.	C	T	2	2	4	0	0	4	0	0
8	51144662	.	T	C	1	1	2	0	1	3	0	0
8	51147570	.	A	G	5	2	7	0	0	7	0	0
8	51165786	.	C	A	2	11	13	0	9	22	0	0
8	51173843	.	A	G	7	4	11	0	0	11	0	0
8	51175677	.	G	A	7	2	9	0	0	9	0	0
8	51189364	.	C	T	0	5	5	0	3	8	0	0
8	51189373	.	G	C	3	4	7	0	0	7	0	0
8	51189463	.	A	G	1	2	3	0	0	3	0	0
8	51228659	.	G	A	2	3	5	0	0	5	0	0
8	51309145	.	T	G	16	12	28	0	0	28	0	0
8	51309311	.	A	G	9	11	20	0	1	21	0	0
8	51314087	.	G	A	13	16	29	0	1	30	0	0
8	51320547	.	C	T	14	6	20	0	5	25	0	0
8	51320652	.	C	T	14	9	23	0	1	24	0	0
8	51325510	.	T	G	10	6	16	0	2	18	0	0
8	51330836	.	A	T	8	7	15	0	0	15	0	0
8	51351121	.	C	T	11	6	17	0	0	17	0	0
8	51351155	.	T	A	8	6	14	0	0	15	1	0
8	51351200	.	A	T	10	14	24	0	0	24	0	0
8	51352480	.	A	G	14	17	31	0	3	34	0	0
8	51352525	.	A	T	15	16	31	0	2	33	0	0
8	51358769	.	G	A	16	15	31	0	1	32	0	0
8	51364515	.	T	C	11	5	16	0	0	16	0	0
8	51364644	.	C	A	0	9	9	0	16	25	0	0
8	51364665	.	T	C	11	8	19	0	1	20	0	0
8	51364696	.	C	G	13	5	18	0	0	18	0	0
8	51364713	.	C	A	0	3	3	0	9	12	0	0
8	51367178	.	A	T	14	4	18	0	2	20	0	0
8	51367206	.	C	T	10	7	17	0	2	19	0	0
8	51367217	.	C	T	10	9	19	0	1	20	0	0
8	51367267	.	A	T	6	7	13	0	0	13	0	0
8	51375405	.	T	G	14	7	21	0	0	21	0	0
8	51379609	.	G	A	3	6	9	0	1	10	0	0
8	51379699	.	G	A	5	3	8	0	1	9	0	0
8	51379741	.	A	T	8	3	11	0	1	12	0	0
8	51379747	.	G	A	8	3	11	0	1	12	0	0
8	51383765	.	C	T	4	3	7	0	0	7	0	0
8	51431321	.	T	A	10	7	17	0	0	17	0	0
8	51431396	.	C	T	1	4	5	0	4	9	0	0
8	51431412	.	A	G	9	0	9	0	0	9	0	0
8	51431526	.	A	T	2	6	8	0	0	9	1	0
8	51431561	.	A	G	1	8	9	0	0	9	0	0
8	51431573	.	A	T	1	6	7	0	0	7	0	0
8	51431604	.	A	C	2	7	9	0	1	10	0	0
8	51431628	.	C	T	6	4	10	0	0	10	0	0
8	51431805	.	T	A	7	3	10	0	1	11	0	0
8	51432050	.	T	C	6	2	8	0	1	9	0	0
8	51432107	.	T	C	2	6	8	0	1	9	0	0
8	51433088	.	C	T	3	2	5	0	0	5	0	0
8	51433569	.	G	A	1	4	5	0	0	5	0	0
8	51434081	.	A	G	1	2	3	0	0	3	0	0
8	51434224	.	G	C	5	2	7	0	0	7	0	0
8	51434289	.	C	T	2	3	5	0	0	5	0	0
8	51434330	.	C	A	0	2	2	0	1	3	0	0
8	51437323	.	A	G	4	2	6	0	0	6	0	0
8	51481945	.	G	A	1	2	3	0	0	3	0	0
8	51573293	.	A	G	1	2	3	0	0	3	0	0
8	51573385	.	C	T	2	2	4	0	0	4	0	0
8	51573439	.	T	C	1	4	5	0	0	5	0	0
8	51573441	.	T	C	1	4	5	0	0	5	0	0
8	51576925	.	C	T	0	3	3	0	4	7	0	0
8	51579224	.	C	G	0	3	3	0	2	5	0	0
8	51579225	.	G	A	2	3	5	0	0	5	0	0
8	51587236	.	A	G	1	3	4	0	0	4	0	0
8	51635844	.	G	A	1	2	3	0	0	3	0	0
8	51718619	.	T	C	4	2	6	0	0	6	0	0
8	51721731	.	G	T	3	2	5	0	0	5	0	0
8	51723164	.	C	T	2	6	8	0	0	8	0	0
8	51723249	.	A	G	3	3	6	2	0	8	0	0
8	51723285	.	G	A	1	16	17	5	2	24	0	0
8	51723320	.	A	G	2	12	14	3	0	18	1	0
8	51724515	.	C	T	2	2	4	0	0	4	0	0
8	51724928	.	G	T	2	7	9	0	0	9	0	0
8	51724974	.	G	A	3	3	6	0	0	6	0	0
8	51725058	.	G	T	3	4	7	0	0	7	0	0
8	51725237	.	C	G	8	4	12	1	1	14	0	0
8	51725241	.	G	T	7	4	11	1	1	13	0	0
8	51726166	.	C	T	4	2	6	0	0	6	0	0
8	51726299	.	T	A	3	4	7	0	0	7	0	0
8	52108237	.	T	C	5	3	8	0	0	8	0	0
8	52109005	.	T	C	5	2	7	0	0	7	0	0
8	52292515	.	T	C	8	4	12	0	1	13	0	0
8	52296833	.	T	G	9	3	12	0	1	13	0	0
8	52296834	.	T	G	10	2	12	0	2	14	0	0
8	52314637	.	G	T	0	4	4	0	2	6	0	0
8	52336870	.	T	C	5	5	10	0	0	10	0	0
8	52342586	.	A	C	4	8	12	1	0	13	0	0
8	52345733	.	T	C	5	10	15	0	0	15	0	0
8	52345751	.	T	C	5	11	16	0	0	16	0	0
8	52345915	.	T	C	7	8	15	0	1	16	0	0
8	52346035	.	T	C	4	7	11	0	1	12	0	0
8	52346072	.	A	T	2	2	4	0	0	4	0	0
8	52346225	.	A	T	3	3	6	0	0	6	0	0
8	52347460	.	C	T	8	3	11	0	1	12	0	0
8	52347840	.	A	G	2	13	15	0	0	15	0	0
8	52348252	.	A	G	5	11	16	0	1	17	0	0
8	52348294	.	A	G	10	6	16	0	0	16	0	0
8	52348576	.	A	G	3	3	6	0	0	6	0	0
8	52348584	.	A	G	3	3	6	0	0	6	0	0
8	52348685	.	T	C	4	4	8	0	0	8	0	0
8	52349080	.	T	G	7	2	9	0	2	11	0	0
8	52349604	.	A	G	13	17	30	0	4	34	0	0
8	52349607	.	A	G	9	26	35	0	0	35	0	0
8	52350007	.	T	C	4	5	9	0	0	9	0	0
8	52350026	.	A	T	7	7	14	0	0	14	0	0
8	52350101	.	A	G	15	0	15	1	9	26	1	0
8	52350146	.	A	G	15	0	15	0	17	32	0	0
8	52350251	.	A	G	10	9	19	0	1	20	0	0
8	52350322	.	T	G	2	3	5	0	0	5	0	0
8	52408619	.	G	A	22	30	52	0	4	56	0	0
8	52411451	.	T	C	16	21	37	0	0	37	0	0
8	52412982	.	A	G	13	20	33	1	1	35	0	0
8	52412985	.	C	G	14	19	33	1	0	34	0	0
8	52453432	.	A	C	6	4	10	0	0	10	0	0
8	52453862	.	T	A	5	8	13	0	0	13	0	0
8	52455588	.	A	G	2	7	9	0	0	9	0	0
8	52455610	.	A	G	1	7	8	0	0	8	0	0
8	52455638	.	C	G	1	5	6	0	0	6	0	0
8	52463828	.	T	A	6	3	9	0	0	9	0	0
8	52463855	.	C	T	0	2	2	0	6	8	0	0
8	52472930	.	C	G	3	5	8	0	1	9	0	0
8	52472955	.	C	T	0	5	5	0	4	9	0	0
8	52472997	.	T	C	2	2	4	0	0	4	0	0
8	52491586	.	G	A	8	4	12	0	0	12	0	0
8	52509559	.	C	A	7	4	11	0	1	12	0	0
8	52509568	.	C	A	6	5	11	0	0	11	0	0
8	52509624	.	G	A	2	2	4	0	0	4	0	0
8	52509762	.	A	T	2	3	5	0	0	5	0	0
8	52510088	.	C	T	2	4	6	0	0	6	0	0
8	52510222	.	C	T	1	3	4	0	0	4	0	0
8	52510243	.	T	C	1	2	3	0	1	4	0	0
8	52521802	.	A	T	4	5	9	0	0	9	0	0
8	52521832	.	T	G	3	0	3	0	5	8	0	0
8	52524436	.	A	T	8	3	11	0	1	12	0	0
8	52527359	.	C	G	1	3	4	0	0	4	0	0
8	52527391	.	A	T	4	2	6	0	0	6	0	0
8	52527452	.	T	C	3	3	6	0	0	6	0	0
8	52527486	.	G	A	5	4	9	0	0	9	0	0
8	52527547	.	A	C	6	3	9	0	0	9	0	0
8	52528665	.	A	G	13	5	18	0	0	18	0	0
8	52528717	.	A	G	11	12	23	0	0	23	0	0
8	52528856	.	C	G	2	3	5	0	0	5	0	0
8	52528868	.	A	G	3	2	5	0	0	5	0	0
8	52529169	.	A	G	7	5	12	0	2	14	0	0
8	52529206	.	T	C	11	3	14	0	0	14	0	0
8	52529397	.	A	G	11	5	16	0	0	16	0	0
8	52533968	.	C	G	2	3	5	0	0	5	0	0
8	52538042	.	A	T	3	5	8	0	1	9	0	0
8	52543717	.	C	A	6	5	11	0	1	12	0	0
8	52547038	.	T	G	10	3	13	1	1	15	0	0
8	52547091	.	T	C	6	5	11	0	2	13	0	0
8	52547356	.	A	G	4	5	9	0	1	10	0	0
8	52547522	.	C	T	5	4	9	0	0	9	0	0
8	52547523	.	G	A	0	4	4	0	5	9	0	0
8	52547569	.	T	A	2	3	5	0	0	5	0	0
8	52547664	.	A	C	4	3	7	0	0	7	0	0
8	52547677	.	C	T	6	3	9	0	1	10	0	0
8	52547706	.	A	T	8	7	15	0	0	15	0	0
8	52547727	.	G	C	5	9	14	0	1	15	0	0
8	52547787	.	T	A	3	3	6	0	0	6	0	0
8	52547829	.	T	G	4	3	7	0	0	7	0	0
8	52547902	.	T	A	2	2	4	0	0	4	0	0
8	52550373	.	T	C	8	0	8	0	4	12	0	0
8	52550462	.	A	G	3	6	9	0	1	10	0	0
8	52550502	.	T	A	9	6	15	0	0	15	0	0
8	52553193	.	A	T	1	3	4	0	3	7	0	0
8	52553197	.	A	G	1	7	8	0	0	8	0	0
8	52554679	.	T	C	5	0	5	0	7	12	0	0
8	52554937	.	T	G	5	8	13	0	0	13	0	0
8	52554983	.	C	T	7	6	13	0	2	15	0	0
8	52555018	.	T	G	5	5	10	0	1	11	0	0
8	52555050	.	G	A	8	10	18	0	0	18	0	0
8	52555077	.	C	G	10	9	19	0	0	19	0	0
8	52555112	.	G	T	3	9	12	0	1	13	0	0
8	52555137	.	G	A	7	5	12	0	0	12	0	0
8	52557454	.	G	T	4	5	9	0	1	10	0	0
8	52562746	.	C	T	5	8	13	0	0	13	0	0
8	52564816	.	T	C	5	8	13	0	0	13	0	0
8	52571198	.	T	C	3	4	7	0	0	7	0	0
8	52576054	.	C	T	0	3	3	0	2	5	0	0
8	52630142	.	G	T	1	2	3	0	0	3	0	0
8	52630505	.	T	C	2	2	4	0	0	4	0	0
8	53067732	.	C	T	1	3	4	0	0	4	0	0
8	53067735	.	T	C	1	2	3	0	1	4	0	0
8	53082186	.	G	C	3	5	8	0	0	8	0	0
8	53087090	.	C	T	4	3	7	0	0	7	0	0
8	53087121	.	C	A	2	3	5	0	0	5	0	0
8	53089839	.	T	C	6	1	7	0	0	7	0	0
8	53089843	.	G	A	0	4	4	0	3	7	0	0
8	53095146	.	G	A	9	11	20	0	0	20	0	0
8	53095179	.	A	G	7	5	12	0	1	13	0	0
8	53149259	.	T	C	3	3	6	0	1	7	0	0
8	53150630	.	T	C	3	3	6	0	0	6	0	0
8	53150805	.	T	C	1	6	7	0	0	7	0	0
8	53150807	.	T	C	1	5	6	0	1	7	0	0
8	53152039	.	C	G	1	4	5	1	0	6	0	0
8	53630383	.	G	C	0	2	2	0	1	3	0	0
8	53664327	.	T	C	2	3	5	0	0	5	0	0
8	53751413	.	G	A	1	3	4	1	0	5	0	0
8	53752762	.	C	T	0	4	4	1	2	7	0	0
8	53756111	.	G	T	2	6	8	0	1	9	0	0
8	53756168	.	C	T	8	3	11	0	0	11	0	0
8	53765095	.	C	T	0	4	4	0	4	8	0	0
8	53769634	.	C	T	0	3	3	0	2	5	0	0
8	53769685	.	C	A	1	5	6	0	0	6	0	0
8	53769686	.	A	T	1	5	6	0	0	6	0	0
8	53794163	.	T	A	8	7	15	0	2	17	0	0
8	53794250	.	T	C	12	11	23	0	0	23	0	0
8	53794943	.	T	G	6	7	13	0	1	14	0	0
8	53795006	.	C	T	7	7	14	0	0	14	0	0
8	53795162	.	A	G	4	10	14	0	0	14	0	0
8	53795249	.	G	A	5	3	8	0	0	8	0	0
8	53795411	.	T	C	7	4	11	0	1	12	0	0
8	53795602	.	T	A	6	12	18	0	0	18	0	0
8	53795636	.	A	T	6	8	14	0	0	14	0	0
8	53795640	.	A	G	6	8	14	0	0	14	0	0
8	53795684	.	T	C	7	0	7	0	4	11	0	0
8	53795692	.	G	A	7	4	11	0	0	11	0	0
8	53795892	.	G	T	11	6	17	0	1	18	0	0
8	53796620	.	G	A	2	5	7	0	0	7	0	0
8	53796657	.	C	T	3	2	5	0	0	5	0	0
8	53797040	.	A	G	3	8	11	0	0	11	0	0
8	53797118	.	G	T	7	4	11	0	0	11	0	0
8	53797265	.	C	T	5	4	9	0	0	9	0	0
8	53797451	.	C	T	0	3	3	0	3	6	0	0
8	53797741	.	T	G	6	4	10	0	0	10	0	0
8	53797802	.	A	C	5	3	8	0	0	8	0	0
8	53798130	.	A	G	8	6	14	0	0	14	0	0
8	53798168	.	A	G	6	9	15	0	1	16	0	0
8	53798321	.	T	A	2	2	4	0	1	5	0	0
8	53798450	.	T	G	4	3	7	0	0	7	0	0
8	53798864	.	A	G	3	4	7	0	1	8	0	0
8	53799491	.	T	A	4	3	7	0	1	8	0	0
8	53799521	.	G	A	4	4	8	0	0	8	0	0
8	53803121	.	G	T	2	3	5	0	1	6	0	0
8	53803139	.	A	T	2	3	5	0	0	5	0	0
8	53866884	.	C	T	3	2	5	0	0	5	0	0
8	53867228	.	A	G	2	2	4	0	0	4	0	0
8	53876632	.	C	T	1	4	5	0	0	5	0	0
8	53918281	.	T	G	4	3	7	0	0	7	0	0
8	53918323	.	A	T	5	4	9	0	0	9	0	0
8	53918472	.	T	C	8	13	21	0	1	22	0	0
8	53918600	.	T	A	7	3	10	0	1	11	0	0
8	53918664	.	C	T	11	6	17	0	0	17	0	0
8	53918730	.	T	C	6	6	12	0	1	13	0	0
8	53918790	.	G	T	5	6	11	0	3	14	0	0
8	53919124	.	C	A	5	6	11	1	0	12	0	0
8	53921722	.	A	G	9	8	17	0	0	17	0	0
8	53921779	.	G	A	10	6	16	0	0	16	0	0
8	53921797	.	A	G	8	6	14	0	0	14	0	0
8	53921815	.	A	G	10	5	15	0	0	15	0	0
8	53922034	.	A	G	7	4	11	0	1	12	0	0
8	53939449	.	T	C	5	2	7	0	0	7	0	0
8	53942440	.	T	C	8	7	15	0	0	15	0	0
8	53948412	.	C	T	13	4	17	0	0	17	0	0
8	53948434	.	G	A	10	5	15	0	0	15	0	0
8	53948501	.	T	C	8	7	15	0	0	15	0	0
8	53949706	.	G	A	18	13	31	0	0	31	0	0
8	53950181	.	T	C	17	0	17	0	19	36	0	0
8	53953420	.	C	G	14	11	25	0	1	26	0	0
8	53956476	.	T	G	9	12	21	0	0	21	0	0
8	53956530	.	T	G	12	13	25	0	2	27	0	0
8	53959378	.	T	C	11	8	19	0	0	19	0	0
8	53984570	.	C	T	0	4	4	1	5	10	0	0
8	54013347	.	A	T	7	12	19	0	0	19	0	0
8	54061034	.	T	A	5	2	7	0	1	8	0	0
8	54128964	.	A	G	14	0	14	0	10	24	0	0
8	54129735	.	G	A	0	13	13	0	18	31	0	0
8	54129767	.	G	A	18	11	29	0	0	29	0	0
8	54129774	.	T	C	17	12	29	0	0	29	0	0
8	54129867	.	A	C	15	7	22	0	3	25	0	0
8	54130103	.	T	G	5	4	9	0	1	10	0	0
8	54130203	.	T	G	8	8	16	0	0	16	0	0
8	54131889	.	T	G	4	5	9	0	1	10	0	0
8	54132024	.	C	G	7	7	14	0	0	14	0	0
8	54132044	.	C	T	9	8	17	0	1	18	0	0
8	54132084	.	C	G	11	8	19	0	0	19	0	0
8	54132248	.	T	A	4	4	8	0	0	8	0	0
8	54132477	.	G	T	3	2	5	0	0	5	0	0
8	54132773	.	C	T	4	2	6	0	0	6	0	0
8	54133376	.	A	G	17	12	29	0	0	29	0	0
8	54133403	.	A	T	13	8	21	0	0	21	0	0
8	54133450	.	G	A	15	8	23	0	2	25	0	0
8	54133522	.	G	A	13	10	23	0	0	23	0	0
8	54137658	.	T	C	2	5	7	0	0	7	0	0
8	54137805	.	T	G	5	3	8	0	0	8	0	0
8	54142752	.	C	T	6	3	9	0	0	9	0	0
8	54142959	.	A	G	6	5	11	0	0	11	0	0
8	54145198	.	A	G	2	4	6	0	0	6	0	0
8	54147056	.	T	C	4	8	12	0	1	13	0	0
8	54155012	.	C	A	11	12	23	0	2	25	0	0
8	54202655	.	C	T	8	10	18	0	0	18	0	0
8	54203198	.	A	G	9	4	13	0	1	14	0	0
8	54208231	.	A	G	14	10	24	1	0	25	0	0
8	54208282	.	C	T	12	9	21	1	1	23	0	0
8	54208572	.	C	T	10	19	29	0	1	30	0	0
8	54210066	.	G	A	18	19	37	0	0	37	0	0
8	54210081	.	C	T	17	16	33	0	0	33	0	0
8	54211989	.	G	A	2	4	6	0	0	6	0	0
8	54211991	.	G	A	1	4	5	0	1	6	0	0
8	54213074	.	G	A	4	7	11	0	0	11	0	0
8	54213461	.	A	G	7	6	13	0	0	13	0	0
8	54213462	.	C	T	7	5	12	0	1	13	0	0
8	54220876	.	T	A	14	12	26	0	2	28	0	0
8	54221065	.	A	T	16	26	42	1	2	45	0	0
8	54221067	.	T	C	28	12	40	1	3	44	0	0
8	54221243	.	T	C	23	0	23	0	19	42	0	0
8	54221390	.	T	C	19	11	30	0	7	37	0	0
8	54221573	.	T	C	15	2	17	0	18	35	0	0
8	54221812	.	G	C	23	21	44	0	0	44	0	0
8	54221927	.	C	T	15	24	39	0	2	41	0	0
8	54221966	.	G	A	18	25	43	0	1	44	0	0
9	11863	.	C	A	2	3	5	0	0	5	0	0
9	24528	.	C	T	17	19	36	0	1	37	0	0
9	37058	.	G	A	20	16	36	0	1	37	0	0
9	37199	.	G	A	11	10	21	0	1	22	0	0
9	37830	.	C	T	0	12	12	0	17	29	0	0
9	52853	.	G	A	0	2	2	9	1	12	0	0
9	54479	.	C	T	12	12	24	0	3	27	0	0
9	62205	.	C	G	15	1	16	4	5	29	4	0
9	62336	.	T	C	17	10	27	0	5	32	0	0
9	62351	.	A	G	22	9	31	0	2	33	0	0
9	62528	.	T	G	14	19	33	0	5	38	0	0
9	63313	.	G	A	6	20	26	0	2	28	0	0
9	63418	.	G	A	15	9	24	0	0	24	0	0
9	63532	.	G	A	13	9	22	0	1	23	0	0
9	63604	.	G	A	11	4	15	0	1	16	0	0
9	64739	.	C	A	2	7	9	0	7	16	0	0
9	82712	.	C	T	1	2	3	0	0	3	0	0
9	83092	.	C	T	3	2	5	0	0	5	0	0
9	83116	.	A	G	5	2	7	0	0	7	0	0
9	83133	.	G	C	5	3	8	0	0	8	0	0
9	83347	.	A	G	3	4	7	0	0	7	0	0
9	83365	.	A	C	4	5	9	0	0	9	0	0
9	84070	.	G	A	0	4	4	1	2	7	0	0
9	84079	.	C	G	2	4	6	0	0	6	0	0
9	84216	.	G	A	1	3	4	0	2	6	0	0
9	84293	.	A	G	2	2	4	0	1	5	0	0
9	84617	.	A	T	1	4	5	0	0	5	0	0
9	85318	.	T	C	3	6	9	0	0	9	0	0
9	85846	.	A	G	0	2	2	0	1	3	0	0
9	86107	.	C	G	5	4	9	0	0	9	0	0
9	86439	.	T	C	4	4	8	0	0	8	0	0
9	86462	.	G	T	4	4	8	0	0	8	0	0
9	86719	.	T	C	4	4	8	0	3	11	0	0
9	86767	.	T	C	10	5	15	0	0	15	0	0
9	86830	.	T	C	7	4	11	0	2	13	0	0
9	89407	.	C	T	8	11	19	0	1	20	0	0
9	90105	.	C	A	13	5	18	0	6	24	0	0
9	90189	.	A	G	6	10	16	0	2	18	0	0
9	90507	.	G	C	1	6	7	0	4	11	0	0
9	94276	.	T	C	8	14	22	0	2	24	0	0
9	94480	.	A	T	1	6	7	0	0	7	0	0
9	94482	.	A	C	1	5	6	0	1	7	0	0
9	97312	.	G	A	1	5	6	0	0	6	0	0
9	97348	.	G	A	1	3	4	0	0	4	0	0
9	97930	.	A	G	1	3	4	0	0	4	0	0
9	103432	.	T	C	12	12	24	0	1	25	0	0
9	104840	.	G	A	8	8	16	0	4	20	0	0
9	104862	.	T	G	4	9	13	0	0	13	0	0
9	105091	.	C	T	2	5	7	0	5	12	0	0
9	134835	.	C	T	1	3	4	0	3	7	0	0
9	134945	.	C	T	0	5	5	0	5	10	0	0
9	134949	.	C	T	0	4	4	0	5	9	0	0
9	134999	.	C	T	0	5	5	0	2	7	0	0
9	135532	.	G	T	1	4	5	0	0	5	0	0
9	135558	.	A	G	1	2	3	0	0	3	0	0
9	145209	.	A	G	2	3	5	0	0	5	0	0
9	145214	.	C	T	2	5	7	0	0	7	0	0
9	148333	.	G	A	1	8	9	0	7	16	0	0
9	148339	.	A	G	6	9	15	0	0	15	0	0
9	149078	.	G	A	0	13	13	0	11	24	0	0
9	149215	.	C	A	18	9	27	0	4	31	0	0
9	149251	.	A	T	11	13	24	0	1	25	0	0
9	153001	.	C	T	6	10	16	0	0	16	0	0
9	168848	.	T	C	6	5	11	0	1	12	0	0
9	169030	.	T	C	4	5	9	0	0	9	0	0
9	169072	.	T	A	7	4	11	0	1	12	0	0
9	169096	.	T	C	6	3	9	0	2	11	0	0
9	169806	.	G	C	21	1	22	0	11	33	0	0
9	170845	.	G	T	15	8	23	0	1	24	0	0
9	170945	.	G	A	13	13	26	0	0	26	0	0
9	172661	.	C	T	13	10	23	0	0	23	0	0
9	180245	.	G	A	13	6	19	0	2	21	0	0
9	208799	.	C	T	2	4	6	0	4	10	0	0
9	209444	.	T	A	4	3	7	0	0	7	0	0
9	225220	.	T	A	11	8	19	0	0	19	0	0
9	225257	.	C	T	6	10	16	0	1	17	0	0
9	225362	.	T	C	5	6	11	0	2	13	0	0
9	225371	.	T	C	7	4	11	0	1	12	0	0
9	225599	.	C	T	5	2	7	0	0	7	0	0
9	225656	.	C	T	2	7	9	0	1	10	0	0
9	226168	.	C	T	5	5	10	0	1	11	0	0
9	227072	.	C	T	7	6	13	0	0	13	0	0
9	233295	.	A	G	3	0	3	0	5	8	0	0
9	233922	.	C	T	5	3	8	0	2	10	0	0
9	234328	.	G	A	8	7	15	0	1	16	0	0
9	235262	.	G	T	1	8	9	0	7	16	0	0
9	235365	.	T	A	10	6	16	0	2	18	0	0
9	235567	.	C	G	12	6	18	0	1	19	0	0
9	253264	.	T	C	11	4	15	0	21	36	0	0
9	254484	.	A	G	31	28	59	0	5	64	0	0
9	257890	.	A	T	23	23	46	4	9	59	0	0
9	257926	.	G	C	21	3	24	4	25	53	0	0
9	262487	.	A	G	24	18	42	0	5	47	0	0
9	262511	.	C	T	1	16	17	0	31	48	0	0
9	266053	.	T	C	12	23	35	0	3	38	0	0
9	266227	.	T	C	24	34	58	0	1	59	0	0
9	266255	.	C	T	28	27	55	0	4	59	0	0
9	266445	.	G	C	34	26	60	0	1	61	0	0
9	266572	.	T	C	35	3	38	0	24	62	0	0
9	266721	.	A	G	22	12	34	0	1	35	0	0
9	266802	.	A	C	20	23	43	0	1	44	0	0
9	266910	.	G	A	24	28	52	0	0	52	0	0
9	267081	.	A	G	34	29	63	0	1	64	0	0
9	267290	.	G	A	31	34	65	0	1	66	0	0
9	275474	.	G	A	29	27	56	0	3	59	0	0
9	276059	.	A	G	23	24	47	1	4	52	0	0
9	278150	.	A	G	27	24	51	0	0	51	0	0
9	278174	.	G	A	28	23	51	0	0	51	0	0
9	282686	.	C	T	14	19	33	0	4	37	0	0
9	282737	.	T	C	22	1	23	0	21	44	0	0
9	296052	.	G	A	21	17	38	0	0	38	0	0
9	296177	.	T	A	27	18	45	0	4	49	0	0
9	296181	.	T	C	25	1	26	0	20	46	0	0
9	298970	.	A	G	1	3	4	0	0	4	0	0
9	299247	.	C	T	3	2	5	1	0	6	0	0
9	301535	.	A	T	6	7	13	0	0	13	0	0
9	302720	.	T	C	3	3	6	0	1	7	0	0
9	303032	.	C	G	6	4	10	0	1	11	0	0
9	303061	.	T	C	10	0	10	0	3	13	0	0
9	303070	.	T	C	9	3	12	0	0	12	0	0
9	303288	.	C	T	0	5	5	0	3	8	0	0
9	323588	.	A	G	8	4	12	0	2	14	0	0
9	323762	.	T	C	4	3	7	0	1	8	0	0
9	331672	.	C	T	2	3	5	0	0	5	0	0
9	332777	.	A	T	3	2	5	0	0	5	0	0
9	332779	.	A	T	3	2	5	0	0	5	0	0
9	336776	.	G	T	6	2	8	0	0	8	0	0
9	336852	.	A	T	5	4	9	0	0	9	0	0
9	336863	.	A	G	5	0	5	0	4	9	0	0
9	339332	.	T	C	9	2	11	0	2	13	0	0
9	340075	.	T	C	3	5	8	0	0	8	0	0
9	340076	.	A	T	3	5	8	0	0	8	0	0
9	340170	.	T	C	1	5	6	0	0	6	0	0
9	355324	.	A	G	6	6	12	0	1	13	0	0
9	355348	.	G	A	6	4	10	0	1	11	0	0
9	358679	.	C	G	2	3	5	0	7	12	0	0
9	358737	.	T	A	9	3	12	1	1	14	0	0
9	429277	.	A	T	5	8	13	0	0	13	0	0
9	430071	.	T	C	7	4	11	0	0	11	0	0
9	430125	.	G	T	0	4	4	0	2	6	0	0
9	431089	.	C	T	2	6	8	0	0	8	0	0
9	431137	.	C	T	3	10	13	0	0	13	0	0
9	433764	.	C	T	2	6	8	0	0	8	0	0
9	458995	.	T	A	12	10	22	0	2	24	0	0
9	459042	.	A	T	11	9	20	0	0	20	0	0
9	459754	.	C	T	10	14	24	0	1	25	0	0
9	459755	.	T	C	9	0	9	0	16	25	0	0
9	459893	.	C	T	2	18	20	0	22	42	0	0
9	462959	.	T	G	17	4	21	0	2	23	0	0
9	463005	.	A	C	8	6	14	0	0	14	0	0
9	463010	.	T	C	8	0	8	0	7	15	0	0
9	468064	.	A	G	3	3	6	0	0	6	0	0
9	468067	.	A	G	3	4	7	0	0	7	0	0
9	511782	.	G	T	0	3	3	0	1	4	0	0
9	527734	.	C	A	5	2	7	0	1	8	0	0
9	527867	.	A	T	3	3	6	0	0	6	0	0
9	527969	.	G	A	0	2	2	0	8	10	0	0
9	528021	.	A	G	2	3	5	0	0	5	0	0
9	529121	.	A	C	1	3	4	0	0	4	0	0
9	529147	.	C	T	4	2	6	0	0	6	0	0
9	529156	.	G	A	2	3	5	0	1	6	0	0
9	529217	.	C	G	1	3	4	0	0	4	0	0
9	529520	.	G	C	2	2	4	0	0	4	0	0
9	529538	.	C	G	2	2	4	0	0	4	0	0
9	529824	.	C	A	3	2	5	0	0	5	0	0
9	529849	.	G	A	0	3	3	0	4	7	0	0
9	529978	.	C	T	0	2	2	0	1	3	0	0
9	588454	.	A	G	4	9	13	0	0	13	0	0
9	588456	.	C	T	4	9	13	0	1	14	0	0
9	595354	.	G	A	4	6	10	0	1	11	0	0
9	596596	.	G	A	1	3	4	0	1	5	0	0
9	597342	.	C	T	4	5	9	0	0	9	0	0
9	598720	.	A	G	9	8	17	0	0	17	0	0
9	598795	.	A	G	5	17	22	0	1	23	0	0
9	598819	.	G	A	5	15	20	0	1	21	0	0
9	600609	.	G	A	2	8	10	0	0	10	0	0
9	604848	.	A	G	10	6	16	0	1	17	0	0
9	606784	.	T	A	4	5	9	0	0	9	0	0
9	606838	.	A	G	3	4	7	0	0	7	0	0
9	612636	.	G	A	2	5	7	0	0	7	0	0
9	619211	.	C	T	0	2	2	0	1	3	0	0
9	701575	.	A	T	6	4	10	0	0	10	0	0
9	701934	.	T	C	5	5	10	0	0	10	0	0
9	704662	.	T	A	3	4	7	0	0	7	0	0
9	707866	.	T	G	2	3	5	0	0	5	0	0
9	707996	.	C	T	2	21	23	0	20	43	0	0
9	708075	.	T	C	31	1	32	0	25	57	0	0
9	712883	.	C	T	2	5	7	0	0	7	0	0
9	712898	.	T	C	5	8	13	0	0	13	0	0
9	716225	.	A	G	8	6	14	0	0	14	0	0
9	717840	.	G	A	9	5	14	0	1	15	0	0
9	719729	.	G	A	6	4	10	0	0	10	0	0
9	719825	.	A	G	7	3	10	0	0	10	0	0
9	721472	.	C	T	0	12	12	0	8	20	0	0
9	721822	.	T	A	10	9	19	0	3	22	0	0
9	721829	.	A	G	12	8	20	0	2	22	0	0
9	722965	.	A	G	10	4	14	0	0	14	0	0
9	723004	.	G	A	9	6	15	0	0	15	0	0
9	723044	.	C	T	7	7	14	0	2	16	0	0
9	724532	.	G	A	6	4	10	0	0	10	0	0
9	724592	.	G	A	7	3	10	0	0	10	0	0
9	724616	.	G	A	6	5	11	0	0	11	0	0
9	724664	.	G	C	8	9	17	0	0	17	0	0
9	726870	.	A	G	4	3	7	0	1	8	0	0
9	730515	.	C	T	3	3	6	0	1	7	0	0
9	730539	.	C	A	3	5	8	0	0	8	0	0
9	732191	.	C	T	0	4	4	0	5	9	0	0
9	732218	.	G	A	6	7	13	0	1	14	0	0
9	732227	.	C	T	8	8	16	0	0	16	0	0
9	737461	.	C	A	3	3	6	0	1	7	0	0
9	737462	.	G	T	3	2	5	0	1	7	1	0
9	746006	.	A	G	1	3	4	0	0	4	0	0
9	746040	.	A	G	5	2	7	0	1	8	0	0
9	751441	.	A	G	6	6	12	0	3	15	0	0
9	781869	.	T	A	2	2	4	0	0	4	0	0
9	781873	.	T	A	2	2	4	0	0	4	0	0
9	795984	.	T	C	2	3	5	0	0	5	0	0
9	795994	.	T	G	2	4	6	0	0	6	0	0
9	844275	.	G	T	1	3	4	0	0	4	0	0
9	881678	.	A	T	4	4	8	0	0	8	0	0
9	881735	.	A	T	2	2	4	0	0	4	0	0
9	881773	.	T	A	1	2	3	0	0	3	0	0
9	881905	.	A	C	20	5	25	0	1	26	0	0
9	881999	.	C	T	13	6	19	0	0	19	0	0
9	882143	.	T	C	11	0	11	0	9	20	0	0
9	887854	.	A	G	5	9	14	0	1	15	0	0
9	889433	.	G	A	5	2	7	0	0	7	0	0
9	900550	.	A	T	2	3	5	0	0	5	0	0
9	900592	.	G	A	3	4	7	0	0	7	0	0
9	901137	.	A	G	5	10	15	0	1	16	0	0
9	902265	.	T	C	6	0	6	0	12	18	0	0
9	902877	.	A	G	5	12	17	0	0	17	0	0
9	904118	.	A	T	5	9	14	0	0	14	0	0
9	907564	.	A	G	22	21	43	0	1	44	0	0
9	910882	.	C	T	27	25	52	0	2	54	0	0
9	913874	.	T	C	24	22	46	0	2	48	0	0
9	913882	.	C	T	24	26	50	0	0	50	0	0
9	913909	.	G	A	3	24	27	0	18	45	0	0
9	914506	.	C	A	4	3	7	0	0	7	0	0
9	914507	.	C	T	3	3	6	0	0	6	0	0
9	963731	.	C	T	6	2	8	0	0	8	0	0
9	1235841	.	A	G	1	2	3	0	0	3	0	0
9	1285758	.	A	G	2	0	2	0	4	6	0	0
9	1296937	.	G	A	0	4	4	0	2	6	0	0
9	1296985	.	T	C	1	3	4	0	0	4	0	0
9	1297000	.	G	A	1	3	4	0	1	5	0	0
9	1297027	.	T	C	1	4	5	0	0	5	0	0
9	1368428	.	T	A	5	5	10	0	1	11	0	0
9	1371362	.	C	T	5	6	11	0	1	12	0	0
9	1371363	.	A	G	5	7	12	0	0	12	0	0
9	1373000	.	A	G	5	6	11	0	1	12	0	0
9	1373075	.	T	G	6	10	16	0	2	18	0	0
9	1373144	.	C	A	4	5	9	0	4	13	0	0
9	1376134	.	T	C	6	2	8	0	0	8	0	0
9	1376201	.	A	G	6	0	6	0	5	11	0	0
9	1413677	.	C	T	1	1	2	0	1	3	0	0
9	1434585	.	G	A	1	3	4	0	0	4	0	0
9	1463287	.	T	C	1	3	4	0	0	4	0	0
9	1465005	.	G	A	3	2	5	0	0	5	0	0
9	1469002	.	T	C	4	2	6	0	0	6	0	0
9	1477756	.	C	T	1	2	3	0	0	3	0	0
9	1479215	.	G	A	2	2	4	0	0	4	0	0
9	1479254	.	C	T	0	1	1	0	4	5	0	0
9	1479290	.	G	T	3	2	5	0	1	6	0	0
9	1543604	.	T	C	1	2	3	0	0	3	0	0
9	1576074	.	T	C	1	2	3	0	0	3	0	0
9	1576112	.	C	A	3	2	5	0	0	5	0	0
9	1577251	.	T	A	2	2	4	0	0	4	0	0
9	1577542	.	C	A	4	15	19	0	0	19	0	0
9	1579792	.	T	C	7	5	12	0	0	12	0	0
9	1589727	.	T	A	1	3	4	0	0	4	0	0
9	1589799	.	A	G	1	4	5	0	0	5	0	0
9	1644148	.	A	C	1	3	4	0	0	4	0	0
9	1644564	.	T	G	1	2	3	0	0	3	0	0
9	1673601	.	C	T	2	4	6	0	1	7	0	0
9	1679969	.	C	A	3	2	5	0	0	5	0	0
9	1680375	.	C	T	3	2	5	0	0	5	0	0
9	1680636	.	A	G	4	3	7	0	0	7	0	0
9	1680660	.	T	A	4	3	7	0	0	7	0	0
9	1680700	.	T	A	3	5	8	0	0	8	0	0
9	1681054	.	C	A	1	2	3	0	0	3	0	0
9	1682619	.	T	C	3	3	6	4	0	10	0	0
9	1682647	.	A	T	5	4	9	0	0	9	0	0
9	1682740	.	G	C	1	5	6	0	9	15	0	0
9	1693082	.	A	C	14	6	20	0	0	20	0	0
9	1693092	.	G	A	11	6	17	0	3	21	1	0
9	1693443	.	G	A	8	7	15	0	0	15	0	0
9	1693494	.	T	G	12	5	17	0	1	18	0	0
9	1693585	.	C	T	1	2	3	0	7	10	0	0
9	1937440	.	A	T	3	2	5	0	0	5	0	0
9	1939007	.	T	A	1	2	3	0	0	3	0	0
9	1948722	.	G	A	1	2	3	0	0	4	1	0
9	2005336	.	A	G	1	0	1	0	6	7	0	0
9	2030569	.	G	A	0	0	0	0	4	4	0	0
9	2030571	.	G	A	1	2	3	0	1	4	0	0
9	2044701	.	C	A	2	2	4	0	0	4	0	0
9	2045265	.	G	A	4	6	10	0	0	10	0	0
9	2334164	.	C	T	28	17	45	2	2	49	0	0
9	2336682	.	A	G	26	0	26	0	26	52	0	0
9	2337291	.	C	T	24	32	56	0	2	58	0	0
9	2340561	.	G	A	36	25	61	1	3	65	0	0
9	2340564	.	G	A	35	24	59	1	4	64	0	0
9	2340618	.	C	T	26	26	52	0	2	54	0	0
9	2340776	.	C	T	33	29	62	0	10	72	0	0
9	2341035	.	T	C	23	15	38	0	1	39	0	0
9	2341053	.	T	C	13	14	27	0	1	28	0	0
9	2347618	.	G	A	1	2	3	0	0	3	0	0
9	2351723	.	G	C	2	2	4	0	0	4	0	0
9	2351795	.	C	G	4	4	8	0	0	8	0	0
9	2365092	.	T	C	2	3	5	0	0	5	0	0
9	2404624	.	A	C	4	3	7	0	0	7	0	0
9	2421012	.	T	A	4	11	15	0	1	16	0	0
9	2423092	.	C	A	8	12	20	0	1	21	0	0
9	2423119	.	C	T	11	8	19	0	0	19	0	0
9	2452697	.	T	C	9	21	30	0	1	31	0	0
9	2483484	.	A	G	16	2	18	0	1	19	0	0
9	2483489	.	A	G	14	3	17	0	1	18	0	0
9	2538987	.	C	T	1	2	3	0	0	3	0	0
9	2556339	.	T	C	2	4	6	0	0	6	0	0
9	2556415	.	T	A	3	2	5	0	0	5	0	0
9	2556516	.	A	T	1	4	5	0	0	5	0	0
9	2557005	.	T	G	1	2	3	0	0	3	0	0
9	2557708	.	G	A	1	2	3	1	0	4	0	0
9	2557722	.	A	G	2	2	4	1	0	5	0	0
9	2558355	.	G	T	4	7	11	0	0	11	0	0
9	2558649	.	G	A	3	4	7	0	1	8	0	0
9	2559177	.	C	T	7	2	9	0	0	9	0	0
9	2559204	.	C	T	3	9	12	0	0	12	0	0
9	2559566	.	C	A	1	4	5	0	1	6	0	0
9	2559587	.	G	C	1	0	1	0	5	6	0	0
9	2559640	.	A	T	1	2	3	0	0	3	0	0
9	2559912	.	A	C	2	8	10	0	1	11	0	0
9	2561135	.	C	T	1	3	4	0	0	4	0	0
9	2561604	.	C	T	12	17	29	0	2	31	0	0
9	2561632	.	A	T	12	15	27	0	1	28	0	0
9	2564111	.	G	A	28	20	48	0	0	48	0	0
9	2564656	.	G	T	8	25	33	0	1	34	0	0
9	2564788	.	A	T	11	16	27	0	1	28	0	0
9	2564790	.	A	T	11	17	28	0	0	28	0	0
9	2568777	.	C	T	12	21	33	0	0	33	0	0
9	2569372	.	T	G	8	8	16	0	0	16	0	0
9	2572235	.	A	T	11	7	18	0	0	18	0	0
9	2572756	.	A	T	13	15	28	0	1	29	0	0
9	2572809	.	C	T	0	4	4	0	4	8	0	0
9	2586206	.	A	G	10	0	10	0	8	18	0	0
9	2586259	.	A	G	10	10	20	0	0	20	0	0
9	2592246	.	C	T	9	11	20	0	0	20	0	0
9	2592518	.	A	T	9	6	15	0	2	17	0	0
9	2592519	.	T	A	6	8	14	0	3	17	0	0
9	2592675	.	G	A	13	11	24	0	1	25	0	0
9	2592960	.	A	G	8	10	18	0	1	19	0	0
9	2592984	.	C	A	0	9	9	0	9	18	0	0
9	2593059	.	C	T	1	6	7	0	3	10	0	0
9	2593518	.	G	A	3	2	5	0	0	5	0	0
9	2593533	.	G	A	2	4	6	0	0	6	0	0
9	2897200	.	A	T	1	2	3	0	0	3	0	0
9	2909623	.	G	A	1	2	3	0	0	3	0	0
9	2949273	.	G	A	6	3	9	0	0	9	0	0
9	2949291	.	C	A	1	4	5	0	2	7	0	0
9	2949374	.	T	A	3	4	7	0	0	7	0	0
9	2953640	.	G	A	1	6	7	0	0	7	0	0
9	2954058	.	G	C	4	0	4	0	6	10	0	0
9	2954088	.	T	C	3	0	3	0	6	9	0	0
9	2954118	.	G	A	3	3	6	0	0	6	0	0
9	2958450	.	T	C	2	3	5	0	0	5	0	0
9	2966295	.	A	T	1	2	3	0	0	3	0	0
9	2980123	.	C	G	1	3	4	0	0	4	0	0
9	3499513	.	T	C	1	0	1	0	2	3	0	0
9	3499561	.	T	C	2	3	5	0	1	6	0	0
9	4279628	.	T	C	6	2	8	0	0	8	0	0
9	4721500	.	G	T	6	5	11	3	1	15	0	0
9	5041842	.	A	T	1	2	3	0	0	3	0	0
9	5042724	.	G	T	4	3	7	0	1	8	0	0
9	5042772	.	C	T	4	4	8	0	0	8	0	0
9	5042784	.	A	G	3	3	6	0	0	6	0	0
9	5904817	.	G	A	3	3	6	0	1	7	0	0
9	5911943	.	G	A	3	2	5	0	0	5	0	0
9	6009282	.	C	T	17	11	28	0	0	28	0	0
9	6083012	.	G	A	2	6	8	0	16	24	0	0
9	6083026	.	C	T	10	8	18	0	1	19	0	0
9	6083113	.	C	T	9	8	17	0	0	17	0	0
9	6083169	.	C	T	4	3	7	0	1	8	0	0
9	6083401	.	G	A	15	14	29	0	0	29	0	0
9	6109544	.	A	G	9	11	20	0	0	20	0	0
9	6123441	.	G	A	16	16	32	0	0	32	0	0
9	6123490	.	G	T	15	11	26	0	0	26	0	0
9	6123742	.	A	C	8	13	21	0	0	21	0	0
9	6123857	.	C	T	4	6	10	0	0	10	0	0
9	6124057	.	G	A	0	6	6	0	9	15	0	0
9	6124100	.	T	C	7	8	15	0	0	15	0	0
9	6124201	.	G	A	0	6	6	0	7	13	0	0
9	6124393	.	C	T	3	6	9	0	0	9	0	0
9	6124478	.	G	A	15	7	22	0	2	24	0	0
9	6124759	.	T	A	20	11	31	0	2	33	0	0
9	6124761	.	T	G	12	14	26	0	4	30	0	0
9	6124884	.	T	C	6	9	15	0	1	16	0	0
9	6125346	.	T	A	5	2	7	0	1	8	0	0
9	6125427	.	G	C	1	3	4	0	0	4	0	0
9	6125501	.	A	C	3	3	6	0	0	6	0	0
9	6125588	.	A	C	2	2	4	0	0	4	0	0
9	6125761	.	G	T	5	2	7	0	1	8	0	0
9	6125859	.	T	A	9	10	19	1	1	21	0	0
9	6126074	.	T	A	20	14	34	0	0	34	0	0
9	6126288	.	A	C	12	18	30	0	1	31	0	0
9	6126410	.	G	A	23	11	34	1	1	36	0	0
9	6126469	.	G	A	14	9	23	0	2	25	0	0
9	6126781	.	T	G	13	10	23	0	0	23	0	0
9	6126900	.	C	T	6	7	13	1	2	16	0	0
9	6126911	.	C	A	8	5	13	1	1	15	0	0
9	6127075	.	G	A	0	19	19	0	28	47	0	0
9	6127346	.	C	A	15	6	21	0	1	22	0	0
9	6127357	.	C	T	13	10	23	0	0	23	0	0
9	6130147	.	C	T	0	2	2	0	1	3	0	0
9	6130179	.	C	T	0	2	2	0	1	3	0	0
9	6660314	.	G	A	6	4	10	0	0	10	0	0
9	6660611	.	G	A	18	10	28	0	0	28	0	0
9	6660953	.	C	T	1	5	6	0	6	12	0	0
9	7030092	.	A	G	7	3	10	0	0	10	0	0
9	7031683	.	C	T	5	4	9	0	1	10	0	0
9	7032231	.	C	A	5	5	10	0	0	10	0	0
9	7039659	.	C	T	5	12	17	0	0	17	0	0
9	7039689	.	T	C	7	6	13	0	0	13	0	0
9	7042639	.	C	T	11	6	17	0	0	17	0	0
9	7042659	.	G	A	7	9	16	0	1	17	0	0
9	7042674	.	A	G	7	0	7	0	7	14	0	0
9	7046383	.	A	G	7	6	13	0	0	13	0	0
9	7049484	.	C	G	4	9	13	0	0	13	0	0
9	7056563	.	T	C	8	8	16	0	0	16	0	0
9	7056713	.	A	C	5	6	11	0	0	11	0	0
9	7056968	.	C	T	11	3	14	0	0	14	0	0
9	7093825	.	T	C	6	2	8	0	0	8	0	0
9	7094141	.	T	C	10	7	17	0	1	18	0	0
9	7094898	.	T	C	14	11	25	0	0	25	0	0
9	7213050	.	A	G	10	4	14	0	0	14	0	0
9	7213565	.	C	T	2	2	4	0	0	4	0	0
9	7213607	.	T	C	5	5	10	0	1	11	0	0
9	7228272	.	C	A	17	10	27	0	0	27	0	0
9	7228487	.	C	A	6	3	9	0	1	10	0	0
9	7229288	.	G	T	26	12	38	0	3	41	0	0
9	7229343	.	T	G	16	19	35	0	1	36	0	0
9	7229347	.	G	A	15	18	33	0	1	34	0	0
9	7229512	.	C	T	15	12	27	0	0	27	0	0
9	7234590	.	G	A	12	14	26	0	2	28	0	0
9	7234618	.	A	C	15	0	15	0	18	33	0	0
9	7234642	.	G	A	15	15	30	0	0	30	0	0
9	7234681	.	A	C	12	12	24	0	0	24	0	0
9	7238498	.	C	T	16	15	31	0	1	32	0	0
9	7238502	.	C	A	15	15	30	0	0	30	0	0
9	7241101	.	A	G	1	2	3	0	0	3	0	0
9	7241118	.	G	A	1	2	3	0	0	3	0	0
9	7241409	.	G	T	7	4	11	0	1	12	0	0
9	7241494	.	T	C	1	3	4	1	0	5	0	0
9	7241855	.	C	T	4	6	10	0	1	11	0	0
9	7241922	.	T	C	3	4	7	0	0	7	0	0
9	7242056	.	C	T	1	2	3	0	5	8	0	0
9	7242214	.	G	A	5	2	7	0	0	7	0	0
9	7242534	.	C	A	3	2	5	0	1	6	0	0
9	7244659	.	T	C	1	4	5	0	0	5	0	0
9	7244962	.	T	C	5	0	5	0	3	8	0	0
9	7244985	.	C	T	6	4	10	0	0	10	0	0
9	7245004	.	C	T	6	3	9	0	0	9	0	0
9	7245023	.	T	C	4	9	13	0	0	13	0	0
9	7245075	.	T	G	2	4	6	0	0	6	0	0
9	7245218	.	C	T	3	1	4	0	0	4	0	0
9	7245226	.	A	G	3	2	5	0	0	5	0	0
9	7245377	.	C	T	8	5	13	0	0	13	0	0
9	7245528	.	T	A	4	4	8	0	0	8	0	0
9	7245681	.	C	G	6	6	12	0	0	12	0	0
9	7245852	.	C	T	1	5	6	0	3	9	0	0
9	7245868	.	C	T	0	5	5	0	5	10	0	0
9	7249063	.	G	C	6	5	11	0	0	11	0	0
9	7249072	.	T	A	5	4	9	0	1	10	0	0
9	7249156	.	G	A	4	4	8	0	0	8	0	0
9	7249443	.	G	T	5	5	10	0	0	10	0	0
9	7516095	.	G	T	3	2	5	0	0	5	0	0
9	7548591	.	A	G	5	9	14	0	0	14	0	0
9	7548600	.	T	A	6	10	16	0	0	16	0	0
9	7570857	.	A	G	13	1	14	0	26	40	0	0
9	7570891	.	T	A	19	19	38	0	1	39	0	0
9	7574042	.	T	A	17	14	31	0	0	31	0	0
9	7574126	.	C	T	20	15	35	0	0	35	0	0
9	7574135	.	A	T	16	14	30	0	1	32	1	0
9	7575309	.	G	A	26	16	42	0	2	44	0	0
9	7575545	.	A	C	20	13	33	0	0	33	0	0
9	7578595	.	G	C	19	15	34	0	0	34	0	0
9	7604524	.	G	A	26	21	47	0	4	51	0	0
9	7612711	.	G	A	3	32	35	1	22	61	3	0
9	7612826	.	C	T	21	31	52	1	0	53	0	0
9	7618903	.	A	C	34	21	55	0	5	60	0	0
9	7618906	.	T	C	32	24	56	0	5	61	0	0
9	7621780	.	T	A	2	2	4	0	0	4	0	0
9	7621877	.	C	T	3	2	5	0	1	6	0	0
9	7635316	.	G	A	1	5	6	0	0	6	0	0
9	7635535	.	C	A	1	3	4	0	0	4	0	0
9	7635925	.	G	A	4	4	8	0	0	8	0	0
9	7646663	.	T	A	3	4	7	0	0	7	0	0
9	7655020	.	G	A	7	3	10	0	2	12	0	0
9	7671165	.	G	A	4	7	11	0	2	13	0	0
9	7909543	.	G	A	3	4	7	0	1	8	0	0
9	7909633	.	T	C	2	2	4	0	0	4	0	0
9	7976555	.	G	A	1	4	5	0	1	6	0	0
9	8064308	.	C	T	2	2	4	0	0	4	0	0
9	8090089	.	G	T	5	6	11	0	0	11	0	0
9	8090240	.	C	T	8	7	15	1	1	17	0	0
9	8114242	.	T	C	3	5	8	0	1	9	0	0
9	8120971	.	C	T	5	8	13	0	1	14	0	0
9	8121026	.	A	C	9	5	14	0	1	15	0	0
9	8121041	.	C	T	11	3	14	0	0	14	0	0
9	8121093	.	A	G	9	9	18	0	0	18	0	0
9	8121113	.	A	G	6	10	16	0	1	17	0	0
9	8122429	.	C	T	7	11	18	0	2	20	0	0
9	8128576	.	G	A	9	10	19	0	1	20	0	0
9	8429331	.	A	G	5	2	7	0	1	8	0	0
9	8429782	.	T	C	9	10	19	0	2	21	0	0
9	8429899	.	A	G	11	9	20	3	7	30	0	0
9	8430162	.	A	G	14	14	28	0	1	29	0	0
9	8430424	.	A	G	13	22	35	0	0	35	0	0
9	8430430	.	C	T	21	12	33	0	1	34	0	0
9	8430464	.	G	A	17	15	32	0	1	33	0	0
9	8430527	.	T	C	8	0	8	0	17	25	0	0
9	8430881	.	C	T	14	10	24	0	0	24	0	0
9	8430962	.	T	C	10	12	22	0	0	22	0	0
9	8431031	.	A	G	16	15	31	0	1	32	0	0
9	8431256	.	G	A	11	15	26	0	1	27	0	0
9	8431345	.	A	C	12	2	14	0	11	25	0	0
9	8431450	.	A	G	16	8	24	0	1	25	0	0
9	8431541	.	A	T	12	8	20	0	1	21	0	0
9	8431714	.	G	T	7	9	16	0	1	17	0	0
9	8431772	.	C	T	6	12	18	0	0	18	0	0
9	8431814	.	A	G	14	10	24	0	1	25	0	0
9	8431837	.	T	C	11	9	20	0	3	23	0	0
9	8431854	.	T	C	11	10	21	0	0	21	0	0
9	8431894	.	A	G	2	13	15	0	0	15	0	0
9	8431998	.	A	C	5	0	5	0	6	11	0	0
9	8433205	.	G	A	9	7	16	0	0	16	0	0
9	8450740	.	G	A	7	13	20	0	1	21	0	0
9	8450788	.	G	A	5	9	14	0	1	15	0	0
9	8451265	.	G	A	3	8	11	0	0	11	0	0
9	8451312	.	A	G	6	5	11	0	0	11	0	0
9	8451540	.	C	T	9	6	15	0	1	16	0	0
9	8451633	.	G	A	10	7	17	0	1	18	0	0
9	8452099	.	T	C	2	0	2	0	5	7	0	0
9	8452405	.	T	C	2	0	2	0	4	6	0	0
9	8452695	.	C	T	5	3	8	0	2	10	0	0
9	8452705	.	G	A	6	4	10	0	1	11	0	0
9	8887858	.	T	G	1	2	3	0	0	3	0	0
9	8887885	.	G	A	1	1	2	0	1	3	0	0
9	8898906	.	G	A	0	4	4	0	5	9	0	0
9	8899665	.	C	T	8	13	21	0	0	21	0	0
9	8899704	.	C	T	6	7	13	0	1	14	0	0
9	8899948	.	G	A	4	6	10	0	7	17	0	0
9	8899974	.	A	G	5	6	11	0	2	13	0	0
9	8900043	.	C	T	3	3	6	0	1	7	0	0
9	8903523	.	G	C	15	6	21	0	1	22	0	0
9	8904032	.	C	T	12	10	22	0	1	23	0	0
9	8910116	.	A	T	8	8	16	0	1	17	0	0
9	8914657	.	G	C	11	7	18	0	0	19	1	0
9	8964925	.	G	T	13	19	32	0	0	32	0	0
9	8967459	.	C	T	21	12	33	0	1	34	0	0
9	8968956	.	G	A	5	2	7	0	0	7	0	0
9	8969067	.	C	T	9	8	17	0	0	17	0	0
9	8969571	.	T	C	10	9	19	0	0	19	0	0
9	8971995	.	A	C	16	18	34	0	0	34	0	0
9	8972294	.	A	G	18	13	31	0	1	32	0	0
9	8972340	.	C	G	21	22	43	1	0	44	0	0
9	8972468	.	A	G	16	4	20	0	5	25	0	0
9	8972601	.	G	A	14	15	29	0	2	31	0	0
9	8973227	.	T	C	7	3	10	0	0	10	0	0
9	8973335	.	T	G	1	6	7	0	0	7	0	0
9	8973379	.	T	G	1	3	4	0	0	4	0	0
9	8974221	.	T	C	6	5	11	0	1	12	0	0
9	8974509	.	G	A	4	2	6	0	0	6	0	0
9	9112417	.	G	T	4	2	6	0	0	6	0	0
9	9112933	.	C	A	3	5	8	0	0	8	0	0
9	9116845	.	C	A	6	6	12	0	0	12	0	0
9	9116890	.	C	T	6	6	12	0	0	12	0	0
9	9117542	.	T	C	5	3	8	0	0	8	0	0
9	9118363	.	A	C	9	8	17	0	0	17	0	0
9	9118695	.	C	T	6	2	8	0	0	8	0	0
9	9118701	.	A	G	3	4	7	0	3	10	0	0
9	9118991	.	C	T	10	12	22	0	1	23	0	0
9	9118994	.	C	T	11	12	23	0	1	24	0	0
9	9119417	.	C	T	9	9	18	0	0	18	0	0
9	9119830	.	A	T	1	4	5	0	0	5	0	0
9	9119987	.	T	C	2	6	8	0	0	8	0	0
9	9120185	.	A	G	9	6	15	0	0	15	0	0
9	9120271	.	T	C	9	8	17	0	0	17	0	0
9	9120847	.	G	A	7	8	15	0	3	18	0	0
9	9121242	.	T	C	8	6	14	0	1	15	0	0
9	9121382	.	G	A	7	6	13	0	1	14	0	0
9	9121917	.	A	T	6	4	10	0	1	11	0	0
9	9183768	.	C	A	12	13	25	0	1	26	0	0
9	9183784	.	A	T	11	14	25	0	0	25	0	0
9	9183848	.	C	A	0	8	8	0	18	26	0	0
9	9183969	.	T	A	14	15	29	0	1	32	2	0
9	9184593	.	T	C	5	17	22	0	2	24	0	0
9	9193044	.	A	C	28	14	42	0	0	42	0	0
9	9198202	.	A	C	12	15	27	0	0	27	0	0
9	9202668	.	T	C	10	14	24	0	0	24	0	0
9	9205089	.	G	A	11	10	21	0	2	23	0	0
9	9206612	.	C	G	10	9	19	0	1	20	0	0
9	9208786	.	G	A	16	6	22	0	1	23	0	0
9	9225717	.	C	T	7	13	20	0	0	20	0	0
9	9235825	.	G	C	15	1	16	0	18	34	0	0
9	9235849	.	T	C	15	0	15	0	23	38	0	0
9	9238577	.	G	A	14	9	23	0	5	28	0	0
9	9238583	.	G	A	13	14	27	0	2	29	0	0
9	9241683	.	A	G	20	21	41	0	2	43	0	0
9	9322661	.	C	A	2	9	11	0	0	11	0	0
9	9322664	.	A	G	2	10	12	0	0	12	0	0
9	9322733	.	G	A	7	7	14	0	1	15	0	0
9	9342835	.	T	A	11	4	15	0	1	16	0	0
9	9342892	.	C	T	6	11	17	0	1	18	0	0
9	9342994	.	A	G	2	4	6	0	0	6	0	0
9	9345134	.	G	A	4	4	8	0	0	8	0	0
9	9345537	.	A	T	1	3	4	0	0	4	0	0
9	9345709	.	A	G	4	3	7	0	0	7	0	0
9	9345751	.	C	T	6	5	11	0	0	11	0	0
9	9502704	.	T	C	1	2	3	0	0	3	0	0
9	9537782	.	T	A	2	3	5	0	1	6	0	0
9	9542914	.	G	A	2	2	4	0	0	4	0	0
9	9561816	.	A	T	2	3	5	0	0	5	0	0
9	9561834	.	C	T	3	2	5	0	0	5	0	0
9	9578295	.	C	A	12	13	25	0	2	27	0	0
9	9578829	.	T	A	31	20	51	0	0	52	1	0
9	9578880	.	G	A	31	17	48	0	1	49	0	0
9	9578936	.	T	G	21	28	49	2	1	53	1	0
9	9579078	.	A	T	18	17	35	0	2	37	0	0
9	9579165	.	C	T	24	18	42	0	2	44	0	0
9	9579551	.	T	A	6	9	15	0	1	16	0	0
9	9579653	.	G	A	12	12	24	0	0	24	0	0
9	9592761	.	G	A	15	13	28	0	0	28	0	0
9	9599452	.	A	G	7	7	14	0	0	14	0	0
9	9670925	.	G	C	8	9	17	0	0	17	0	0
9	9671208	.	G	A	11	6	17	0	0	17	0	0
9	9719311	.	T	A	1	2	3	0	0	3	0	0
9	9731574	.	T	C	1	0	1	0	2	3	0	0
9	9731796	.	A	C	1	0	1	0	3	4	0	0
9	9731811	.	A	G	1	3	4	0	0	4	0	0
9	9737150	.	T	C	11	0	11	0	8	19	0	0
9	9737592	.	T	A	5	5	10	0	0	10	0	0
9	9737821	.	C	T	3	7	10	0	0	10	0	0
9	9739059	.	C	G	1	3	4	0	0	4	0	0
9	9739135	.	T	C	3	3	6	0	0	6	0	0
9	9751476	.	A	T	4	3	7	0	0	7	0	0
9	9771333	.	C	G	1	3	4	0	0	4	0	0
9	9771351	.	A	G	1	4	5	0	0	5	0	0
9	9941440	.	G	A	1	2	3	0	0	3	0	0
9	9942866	.	G	A	3	3	6	0	0	6	0	0
9	9943121	.	C	T	6	2	8	0	0	8	0	0
9	9945569	.	G	C	1	3	4	0	0	4	0	0
9	9947425	.	G	A	1	3	4	0	0	4	0	0
9	9948145	.	C	T	6	5	11	0	1	12	0	0
9	9948700	.	T	C	4	3	7	0	1	8	0	0
9	9953683	.	T	A	3	2	5	0	0	5	0	0
9	9957564	.	G	T	1	2	3	0	0	3	0	0
9	10014889	.	G	A	4	4	8	0	2	10	0	0
9	10014972	.	G	A	1	2	3	0	4	7	0	0
9	10015090	.	T	C	3	4	7	0	1	8	0	0
9	10043130	.	T	C	5	6	11	0	1	12	0	0
9	10043201	.	C	G	3	2	5	0	1	6	0	0
9	10043415	.	C	T	6	6	12	0	0	12	0	0
9	10043673	.	C	T	9	8	17	0	0	17	0	0
9	10043739	.	C	T	7	8	15	0	2	17	0	0
9	10050938	.	C	T	1	3	4	0	0	4	0	0
9	10050949	.	A	T	1	3	4	0	1	5	0	0
9	10051006	.	G	A	5	4	9	0	0	9	0	0
9	10051080	.	T	A	5	4	9	0	0	9	0	0
9	10051354	.	A	G	14	5	19	0	0	19	0	0
9	10138338	.	G	A	11	4	15	0	0	15	0	0
9	10153091	.	C	T	3	3	6	0	0	6	0	0
9	10153342	.	T	A	6	9	15	1	0	16	0	0
9	10153590	.	A	C	11	8	19	0	0	19	0	0
9	10153606	.	A	G	13	10	23	0	0	23	0	0
9	10153689	.	G	C	15	9	24	0	1	25	0	0
9	10153705	.	A	T	10	15	25	0	1	26	0	0
9	10154013	.	G	T	18	9	27	0	0	27	0	0
9	10154014	.	C	T	17	9	26	0	0	26	0	0
9	10154138	.	T	C	4	4	8	0	1	9	0	0
9	10154195	.	A	T	5	6	11	0	0	11	0	0
9	10155366	.	T	C	3	4	7	0	0	7	0	0
9	10156145	.	C	A	9	10	19	0	0	19	0	0
9	10157193	.	C	G	5	7	12	0	0	12	0	0
9	10168945	.	C	T	2	5	7	0	3	10	0	0
9	10175770	.	C	G	0	6	6	0	6	12	0	0
9	10175785	.	A	G	7	7	14	0	1	15	0	0
9	10175812	.	G	A	5	7	12	0	0	12	0	0
9	10183289	.	C	T	3	4	7	0	0	7	0	0
9	10195488	.	T	A	1	3	4	0	0	4	0	0
9	11533292	.	C	T	13	5	18	0	0	18	0	0
9	11533594	.	A	G	7	6	13	0	4	17	0	0
9	11576640	.	T	C	1	0	1	0	3	4	0	0
9	11576697	.	C	T	0	2	2	0	2	4	0	0
9	11576829	.	G	C	4	5	9	0	0	9	0	0
9	11579736	.	A	C	1	3	4	0	0	4	0	0
9	11592221	.	G	A	0	7	7	0	1	8	0	0
9	11597511	.	A	C	4	7	11	0	0	11	0	0
9	11597569	.	T	A	1	5	6	0	1	7	0	0
9	11597803	.	A	T	1	3	4	0	0	4	0	0
9	11598029	.	T	C	5	0	5	0	3	8	0	0
9	11598312	.	C	T	1	4	5	0	5	10	0	0
9	11601089	.	C	T	0	4	4	0	7	11	0	0
9	11601092	.	G	A	6	3	9	0	1	10	0	0
9	11602010	.	A	C	4	0	4	0	7	11	0	0
9	11602207	.	A	G	6	4	10	0	0	10	0	0
9	11602255	.	G	A	3	3	6	0	0	6	0	0
9	11605579	.	T	C	5	3	8	0	0	8	0	0
9	11612254	.	A	G	5	5	10	0	0	10	0	0
9	11616380	.	G	A	6	3	9	0	0	9	0	0
9	11626468	.	T	C	4	3	7	0	0	7	0	0
9	11626478	.	A	G	4	3	7	0	0	7	0	0
9	11652589	.	G	T	2	3	5	0	0	5	0	0
9	11665875	.	T	C	20	8	28	0	1	29	0	0
9	11670127	.	G	A	7	11	18	0	1	19	0	0
9	11906956	.	A	G	16	8	24	0	0	24	0	0
9	11907823	.	G	A	10	3	13	0	0	13	0	0
9	11908394	.	A	T	5	2	7	0	0	7	0	0
9	11908413	.	C	A	3	2	5	0	1	6	0	0
9	11908503	.	C	T	5	5	10	0	0	10	0	0
9	11908521	.	C	T	6	5	11	0	2	13	0	0
9	11908855	.	G	A	8	4	12	0	1	13	0	0
9	11909061	.	C	T	5	3	8	0	0	8	0	0
9	11909575	.	A	G	5	6	11	0	0	11	0	0
9	12034300	.	A	G	4	2	6	0	0	6	0	0
9	12034399	.	C	T	3	3	6	0	1	7	0	0
9	12263245	.	T	A	4	5	9	0	0	9	0	0
9	12265917	.	T	C	2	2	4	0	0	4	0	0
9	12269833	.	A	G	5	4	9	0	0	9	0	0
9	12269898	.	A	G	1	2	3	0	0	3	0	0
9	12405184	.	A	C	1	3	4	0	0	4	0	0
9	12405430	.	T	C	5	7	12	0	0	12	0	0
9	12405454	.	G	T	4	10	14	0	0	14	0	0
9	12405502	.	T	C	6	9	15	0	0	15	0	0
9	12405517	.	T	C	4	8	12	0	1	13	0	0
9	12405544	.	G	T	3	8	11	0	0	11	0	0
9	12405559	.	T	A	2	9	11	0	1	12	0	0
9	12405684	.	C	G	2	10	12	0	0	12	0	0
9	12405796	.	A	C	5	12	17	0	0	17	0	0
9	12423497	.	A	G	4	8	12	0	1	13	0	0
9	12424725	.	G	T	5	5	10	0	1	11	0	0
9	12424758	.	C	T	0	6	6	0	4	10	0	0
9	12454818	.	C	T	6	9	15	0	1	16	0	0
9	12454823	.	C	T	5	7	12	0	0	12	0	0
9	12455193	.	A	T	8	3	11	0	0	11	0	0
9	12582251	.	C	T	21	21	42	0	3	45	0	0
9	12584902	.	T	C	17	1	18	0	20	38	0	0
9	12589968	.	T	C	15	19	34	0	3	37	0	0
9	12590019	.	A	G	13	14	27	0	4	31	0	0
9	12590269	.	A	T	4	4	8	0	0	8	0	0
9	12590356	.	T	G	1	6	7	0	0	7	0	0
9	12594685	.	G	T	9	5	14	0	0	14	0	0
9	12648898	.	C	T	1	11	12	0	14	26	0	0
9	12649224	.	T	C	7	15	22	0	2	24	0	0
9	12649429	.	A	C	15	5	20	2	1	23	0	0
9	12664466	.	T	G	3	5	8	0	0	8	0	0
9	12667694	.	A	G	3	2	5	0	0	5	0	0
9	12667695	.	A	G	3	2	5	0	0	5	0	0
9	12667758	.	C	T	3	2	5	0	0	5	0	0
9	12676846	.	C	T	0	2	2	0	1	3	0	0
9	12866399	.	G	A	2	2	4	0	0	4	0	0
9	12866637	.	T	G	1	2	3	0	0	3	0	0
9	12866908	.	G	A	1	2	3	0	0	3	0	0
9	12868421	.	T	C	7	0	7	0	6	13	0	0
9	12870473	.	C	G	2	11	13	0	0	13	0	0
9	12870543	.	T	A	8	4	12	0	1	13	0	0
9	12871592	.	T	A	5	5	10	0	1	11	0	0
9	12872002	.	G	A	4	3	7	0	0	7	0	0
9	12872010	.	T	C	5	2	7	0	0	7	0	0
9	12874079	.	G	T	3	3	6	0	0	6	0	0
9	12874402	.	A	T	6	6	12	0	1	13	0	0
9	12874441	.	C	A	6	3	9	0	1	10	0	0
9	12920964	.	C	G	4	2	6	0	0	6	0	0
9	12943867	.	G	A	3	3	6	0	0	6	0	0
9	12944401	.	A	G	3	2	5	0	0	5	0	0
9	12944409	.	C	A	2	2	4	0	1	5	0	0
9	12944511	.	T	G	2	3	5	0	0	5	0	0
9	12944546	.	G	C	1	4	5	0	0	5	0	0
9	12944578	.	G	A	2	4	6	0	0	6	0	0
9	12944652	.	A	G	1	4	5	0	0	5	0	0
9	12945298	.	G	C	3	4	7	0	0	7	0	0
9	12945384	.	G	T	3	2	5	0	0	5	0	0
9	12945474	.	A	G	2	6	8	0	0	8	0	0
9	12945764	.	G	A	1	2	3	0	0	3	0	0
9	12946435	.	G	A	3	2	5	0	0	5	0	0
9	12946468	.	T	A	3	3	6	0	1	7	0	0
9	12946726	.	A	G	3	3	6	0	0	6	0	0
9	12946824	.	A	G	4	4	8	0	0	8	0	0
9	12946914	.	G	A	2	2	4	0	1	5	0	0
9	12947217	.	A	G	3	2	5	0	0	5	0	0
9	12947400	.	A	T	2	4	6	0	1	7	0	0
9	12947529	.	A	G	3	6	9	0	1	10	0	0
9	12947649	.	A	C	3	4	7	0	1	8	0	0
9	12947708	.	A	G	8	5	13	0	0	13	0	0
9	12947742	.	A	G	5	8	13	0	0	13	0	0
9	12947809	.	C	A	2	3	5	0	1	6	0	0
9	12947823	.	T	C	2	4	6	0	0	6	0	0
9	12947902	.	G	T	0	4	4	0	4	8	0	0
9	12947919	.	G	T	4	5	9	0	0	9	0	0
9	12948021	.	G	A	4	2	6	0	0	6	0	0
9	12948176	.	A	T	7	3	10	0	0	10	0	0
9	12948332	.	A	T	2	3	5	0	0	5	0	0
9	12948451	.	A	G	4	4	8	0	0	8	0	0
9	12948481	.	T	C	2	4	6	0	0	6	0	0
9	12948565	.	G	A	2	5	7	0	0	7	0	0
9	12948577	.	C	T	3	5	8	0	0	8	0	0
9	12948649	.	A	G	6	4	10	0	0	10	0	0
9	12948798	.	G	T	5	8	13	0	1	14	0	0
9	12948859	.	A	C	7	8	15	0	1	16	0	0
9	12951362	.	G	A	7	9	16	0	1	17	0	0
9	12953653	.	A	C	1	3	4	0	0	4	0	0
9	12953656	.	C	G	1	3	4	0	0	4	0	0
9	12953742	.	T	C	4	4	8	0	0	8	0	0
9	12959918	.	T	C	2	3	5	0	1	6	0	0
9	13102314	.	C	T	1	2	3	0	0	3	0	0
9	13106452	.	A	C	7	4	11	0	0	11	0	0
9	13106643	.	T	C	9	4	13	0	1	14	0	0
9	13106715	.	A	T	7	5	12	0	0	12	0	0
9	13106736	.	A	G	5	1	6	0	7	13	0	0
9	13106802	.	T	C	4	4	8	0	0	8	0	0
9	13106922	.	A	G	5	3	8	0	1	9	0	0
9	13106943	.	A	T	5	3	8	0	0	8	0	0
9	13107399	.	G	T	5	6	11	0	2	13	0	0
9	13107423	.	A	G	5	7	12	0	1	13	0	0
9	13107576	.	G	A	1	4	5	0	3	8	0	0
9	13107577	.	G	T	5	4	9	0	0	9	0	0
9	13107633	.	A	G	3	3	6	0	1	7	0	0
9	13107642	.	C	T	5	3	8	0	0	8	0	0
9	13107730	.	A	G	1	7	8	0	0	8	0	0
9	13110955	.	C	T	1	8	9	0	0	9	0	0
9	13111014	.	T	C	3	2	5	0	0	5	0	0
9	13144092	.	T	G	2	3	5	0	0	5	0	0
9	13212548	.	C	T	2	6	8	0	0	8	0	0
9	13230322	.	A	G	6	4	10	0	0	10	0	0
9	13233402	.	G	A	0	4	4	0	6	10	0	0
9	13233609	.	C	T	3	3	6	0	0	6	0	0
9	13233634	.	G	A	0	3	3	0	4	7	0	0
9	13233655	.	A	G	3	3	6	0	0	6	0	0
9	13235245	.	T	C	4	7	11	0	1	12	0	0
9	13236873	.	T	C	4	4	8	0	2	10	0	0
9	13241833	.	G	A	6	6	12	0	0	12	0	0
9	13246442	.	G	T	14	7	21	0	0	21	0	0
9	13352687	.	A	G	7	9	16	0	0	16	0	0
9	13352720	.	C	A	4	7	11	0	1	12	0	0
9	13353097	.	A	G	9	9	18	0	0	18	0	0
9	13354066	.	A	G	3	3	6	0	0	6	0	0
9	13354874	.	T	C	5	5	10	0	0	10	0	0
9	13354910	.	C	G	4	2	6	0	1	7	0	0
9	13765232	.	T	C	20	12	32	0	0	32	0	0
9	13774639	.	T	C	18	8	26	0	0	26	0	0
9	13797720	.	T	G	21	0	21	0	15	36	0	0
9	13799301	.	T	C	16	10	26	0	0	26	0	0
9	13799463	.	G	A	16	4	20	0	1	21	0	0
9	13799540	.	T	A	18	12	30	0	2	32	0	0
9	13803002	.	G	A	18	16	34	0	3	37	0	0
9	13815245	.	G	C	19	1	20	0	13	33	0	0
9	13815485	.	A	G	15	12	27	0	1	28	0	0
9	13815575	.	A	G	14	20	34	0	2	36	0	0
9	13815875	.	T	C	16	9	25	0	1	26	0	0
9	13816130	.	A	G	8	14	22	0	0	22	0	0
9	13816505	.	A	G	12	6	18	0	0	18	0	0
9	13816708	.	T	C	10	4	14	0	1	15	0	0
9	13816758	.	G	A	12	7	19	0	0	19	0	0
9	13816784	.	T	C	19	1	20	0	8	28	0	0
9	13816829	.	C	T	15	9	24	0	2	26	0	0
9	13816925	.	G	T	10	3	13	0	6	19	0	0
9	13816949	.	A	G	10	7	17	0	1	18	0	0
9	14191113	.	G	C	1	4	5	0	0	5	0	0
9	14195210	.	G	A	1	4	5	0	1	6	0	0
9	14196513	.	G	A	1	2	3	0	0	3	0	0
9	14196763	.	A	C	2	4	6	0	0	6	0	0
9	14196866	.	G	A	3	2	5	0	0	5	0	0
9	14197103	.	A	G	6	3	9	1	0	10	0	0
9	14367775	.	C	T	8	4	12	0	0	12	0	0
9	14367837	.	T	G	7	8	15	0	2	17	0	0
9	14367878	.	C	T	13	11	24	0	2	26	0	0
9	14368350	.	T	C	13	12	25	0	1	26	0	0
9	14368378	.	A	T	16	7	23	0	1	24	0	0
9	14368504	.	C	T	0	0	0	1	8	9	0	0
9	14368527	.	A	G	4	2	6	1	1	8	0	0
9	14368590	.	G	A	5	5	10	0	0	10	0	0
9	14368676	.	A	G	9	4	13	0	0	13	0	0
9	14368788	.	T	C	6	10	16	4	1	21	0	0
9	14368892	.	C	T	14	5	19	0	0	19	0	0
9	14368988	.	G	A	12	11	23	0	2	25	0	0
9	14369084	.	G	A	10	7	17	0	0	17	0	0
9	14369150	.	T	A	9	10	19	1	2	23	1	0
9	14381060	.	G	A	7	5	12	0	2	14	0	0
9	14381116	.	G	A	4	9	13	0	0	13	0	0
9	14381240	.	A	C	4	6	10	0	0	10	0	0
9	14411677	.	C	A	7	9	16	0	0	16	0	0
9	14433931	.	A	T	2	4	6	1	0	7	0	0
9	14504685	.	T	A	5	3	8	0	0	8	0	0
9	16128102	.	C	T	4	2	6	0	0	6	0	0
9	16128736	.	C	T	1	4	5	0	0	5	0	0
9	16128742	.	T	A	1	3	4	0	0	4	0	0
9	16132709	.	C	A	2	2	4	0	1	5	0	0
9	16241711	.	G	A	1	4	5	0	0	5	0	0
9	16867489	.	C	T	3	2	5	0	0	5	0	0
9	16867495	.	G	C	2	3	5	0	0	5	0	0
9	16867634	.	C	T	7	3	10	0	0	10	0	0
9	16867646	.	G	A	6	3	9	0	2	11	0	0
9	16867806	.	A	G	13	5	18	0	0	18	0	0
9	16867909	.	A	G	14	12	26	0	0	26	0	0
9	16868233	.	A	G	8	10	18	0	1	19	0	0
9	16868242	.	G	A	7	13	20	0	0	20	0	0
9	16868326	.	T	C	6	0	6	0	7	13	0	0
9	16872764	.	T	C	6	4	10	0	0	10	0	0
9	16872767	.	T	C	6	4	10	0	0	10	0	0
9	16877408	.	G	A	8	7	15	0	0	15	0	0
9	16877518	.	A	G	2	3	5	0	0	5	0	0
9	17046020	.	T	C	19	20	39	0	1	40	0	0
9	17046736	.	A	G	22	21	43	0	0	43	0	0
9	17047014	.	A	G	23	14	37	3	4	44	0	0
9	17057365	.	T	C	15	19	34	0	6	40	0	0
9	17060311	.	G	A	13	11	24	0	0	24	0	0
9	17067934	.	C	T	19	8	27	0	2	29	0	0
9	17068057	.	T	G	12	16	28	0	0	28	0	0
9	17073498	.	T	C	15	19	34	0	3	37	0	0
9	17074714	.	T	C	13	11	24	0	0	24	0	0
9	17074720	.	T	C	14	10	24	0	0	24	0	0
9	17074792	.	G	A	13	13	26	0	2	28	0	0
9	17077376	.	A	G	18	9	27	0	0	27	0	0
9	17077430	.	C	T	2	8	10	0	13	23	0	0
9	17077439	.	A	G	13	9	22	0	1	23	0	0
9	17080224	.	G	T	15	10	25	0	4	29	0	0
9	17080517	.	G	A	12	12	24	0	1	25	0	0
9	17080970	.	A	G	8	6	14	0	0	14	0	0
9	17082273	.	A	T	16	9	25	0	2	27	0	0
9	17082926	.	G	T	10	6	16	0	0	16	0	0
9	17083053	.	G	A	6	4	10	0	0	10	0	0
9	17083221	.	T	C	6	9	15	0	0	15	0	0
9	17083278	.	G	A	13	10	23	0	0	23	0	0
9	17083296	.	T	A	11	8	19	0	0	19	0	0
9	17083434	.	C	T	6	10	16	0	1	17	0	0
9	17083581	.	G	T	10	8	18	0	0	18	0	0
9	17083908	.	T	C	6	0	6	0	10	16	0	0
9	17083989	.	G	A	1	6	7	0	1	8	0	0
9	17084229	.	T	C	10	1	11	0	6	17	0	0
9	17084253	.	G	A	9	7	16	0	0	16	0	0
9	17094362	.	A	T	2	6	8	0	0	8	0	0
9	17119143	.	G	A	4	4	8	0	0	8	0	0
9	17119789	.	G	A	4	3	7	0	0	7	0	0
9	17119982	.	A	G	1	6	7	0	0	7	0	0
9	17120018	.	T	C	5	0	5	0	5	10	0	0
9	17127011	.	G	T	1	5	6	0	0	6	0	0
9	17127025	.	C	T	5	5	10	0	0	10	0	0
9	17130282	.	G	A	1	2	3	0	0	3	0	0
9	17139350	.	A	T	5	2	7	0	0	7	0	0
9	17145472	.	T	C	2	3	5	0	0	5	0	0
9	17148204	.	G	A	3	3	6	0	0	6	0	0
9	17163711	.	A	C	3	0	3	0	2	5	0	0
9	17169110	.	C	T	2	2	4	0	0	4	0	0
9	17193186	.	A	G	1	3	4	0	1	5	0	0
9	17217519	.	G	A	2	5	7	0	0	7	0	0
9	17221785	.	A	G	1	2	3	0	0	3	0	0
9	17348855	.	C	A	11	9	20	0	0	20	0	0
9	17348977	.	G	A	3	2	5	0	0	5	0	0
9	17349073	.	T	C	3	8	11	0	1	12	0	0
9	17349103	.	G	T	0	3	3	0	4	7	0	0
9	17349125	.	G	A	0	4	4	0	3	7	0	0
9	17364337	.	C	G	3	5	8	0	1	9	0	0
9	17368825	.	C	T	5	9	14	0	1	15	0	0
9	17378276	.	A	T	6	9	15	0	1	16	0	0
9	17379954	.	C	T	9	9	18	0	0	18	0	0
9	17386091	.	G	A	0	2	2	0	6	8	0	0
9	17386092	.	A	T	6	2	8	0	0	8	0	0
9	17386148	.	C	T	5	8	13	0	0	13	0	0
9	17386152	.	C	A	5	7	12	0	0	12	0	0
9	17386338	.	A	G	8	0	8	0	3	11	0	0
9	17424639	.	T	G	3	2	5	0	0	5	0	0
9	17424714	.	G	A	0	2	2	0	3	5	0	0
9	17425845	.	C	T	3	3	6	0	0	6	0	0
9	17429258	.	G	A	0	2	2	0	6	8	0	0
9	17431499	.	T	C	2	4	6	0	0	6	0	0
9	17431690	.	T	C	4	2	6	0	0	6	0	0
9	17431709	.	T	A	5	3	8	0	0	8	0	0
9	17431798	.	A	G	1	3	4	0	1	5	0	0
9	17432470	.	T	C	6	2	8	0	0	8	0	0
9	17433769	.	T	G	2	3	5	0	1	6	0	0
9	17445217	.	A	G	13	7	20	0	1	21	0	0
9	17449399	.	T	C	7	11	18	0	0	18	0	0
9	17540692	.	A	C	5	4	9	0	1	10	0	0
9	17540701	.	T	C	5	5	10	0	0	10	0	0
9	17542985	.	A	G	8	4	12	0	0	12	0	0
9	17548502	.	T	C	3	5	8	0	0	8	0	0
9	17560343	.	A	G	5	4	9	0	2	11	0	0
9	17563079	.	C	T	11	4	15	0	0	15	0	0
9	17600571	.	C	T	0	5	5	0	6	11	0	0
9	17659262	.	C	A	2	3	5	0	0	5	0	0
9	17669180	.	T	A	3	3	6	0	1	7	0	0
9	17669184	.	C	T	0	3	3	0	4	7	0	0
9	17747795	.	T	C	1	0	1	0	3	4	0	0
9	17788017	.	C	T	1	2	3	0	0	3	0	0
9	17899179	.	G	A	0	2	2	0	4	6	0	0
9	17900487	.	C	T	6	2	8	0	0	8	0	0
9	17908818	.	G	A	2	4	6	0	0	6	0	0
9	17908958	.	A	C	8	7	15	0	1	16	0	0
9	17912372	.	C	G	2	6	8	0	1	9	0	0
9	17915275	.	A	G	3	0	3	0	9	12	0	0
9	17918428	.	A	G	2	5	7	0	0	7	0	0
9	17918461	.	C	A	7	8	15	0	0	15	0	0
9	17918485	.	A	G	7	11	18	0	1	19	0	0
9	17918627	.	G	A	8	6	14	0	0	14	0	0
9	17922172	.	T	A	9	11	20	0	0	20	0	0
9	17922191	.	G	C	10	6	16	0	1	17	0	0
9	17934202	.	T	G	6	6	12	0	0	12	0	0
9	17934232	.	G	A	8	8	16	0	0	16	0	0
9	17934262	.	T	C	6	8	14	0	0	14	0	0
9	17940161	.	C	T	7	7	14	0	0	14	0	0
9	17979350	.	A	C	4	5	9	0	1	10	0	0
9	17979603	.	T	A	1	3	4	0	0	4	0	0
9	17984877	.	G	T	1	4	5	0	3	8	0	0
9	17984914	.	G	T	1	5	6	0	0	6	0	0
9	17987998	.	A	G	10	10	20	0	0	20	0	0
9	17988011	.	C	A	9	8	17	0	0	17	0	0
9	17988072	.	A	C	7	7	14	0	0	14	0	0
9	17988091	.	A	G	9	6	15	0	0	15	0	0
9	18001200	.	A	C	21	18	39	0	0	39	0	0
9	18003290	.	G	A	1	20	21	1	23	45	0	0
9	18003487	.	C	A	13	20	33	0	0	33	0	0
9	18003807	.	C	T	15	20	35	0	0	35	0	0
9	18003823	.	G	A	2	24	26	0	17	43	0	0
9	18005655	.	T	A	16	10	26	0	0	26	0	0
9	18005818	.	A	G	11	16	27	0	0	27	0	0
9	18005864	.	G	A	17	14	31	0	2	33	0	0
9	18215989	.	T	G	10	9	19	0	1	20	0	0
9	18235382	.	A	T	12	13	25	0	0	25	0	0
9	18235383	.	A	G	11	12	23	0	1	24	0	0
9	18277985	.	T	A	4	10	14	0	1	15	0	0
9	18278009	.	A	G	5	2	7	0	8	15	0	0
9	18278366	.	G	T	9	4	13	0	0	13	0	0
9	18278431	.	C	T	5	2	7	0	0	7	0	0
9	18333107	.	A	G	10	11	21	0	0	21	0	0
9	18390631	.	T	C	4	8	12	0	0	12	0	0
9	18390683	.	C	T	7	7	14	0	0	14	0	0
9	18392777	.	T	G	5	5	10	0	0	10	0	0
9	18424739	.	A	T	4	4	8	0	0	8	0	0
9	18424775	.	C	T	4	8	12	0	0	12	0	0
9	18568875	.	T	C	5	1	6	0	10	16	0	0
9	18716630	.	T	A	20	24	44	0	0	44	0	0
9	18721152	.	A	G	7	9	16	0	0	16	0	0
9	18732819	.	T	C	26	24	50	0	8	58	0	0
9	18732878	.	C	T	4	22	26	1	23	51	1	0
9	18732899	.	G	A	29	28	57	1	1	59	0	0
9	18733062	.	G	T	31	30	61	0	5	66	0	0
9	18733545	.	G	T	32	33	65	0	8	73	0	0
9	18733592	.	T	C	26	4	30	0	47	77	0	0
9	18735081	.	A	G	30	21	51	0	1	52	0	0
9	18742401	.	G	T	1	4	5	0	0	5	0	0
9	18812765	.	A	G	8	8	16	0	0	16	0	0
9	18812824	.	G	C	9	12	21	0	2	23	0	0
9	18814379	.	A	G	4	3	7	0	1	8	0	0
9	18876266	.	G	A	13	12	25	0	4	29	0	0
9	18876332	.	A	T	24	18	42	0	2	44	0	0
9	18876402	.	C	A	20	10	30	0	1	31	0	0
9	18876403	.	C	A	19	10	29	0	1	30	0	0
9	18876545	.	G	T	14	25	39	0	1	40	0	0
9	18876937	.	C	G	1	32	33	0	12	45	0	0
9	18909235	.	A	T	4	2	6	1	1	8	0	0
9	18909242	.	A	T	5	2	7	1	0	8	0	0
9	18909748	.	A	C	5	3	8	0	0	8	0	0
9	19027491	.	A	G	1	2	3	0	1	4	0	0
9	19027630	.	T	A	4	3	7	0	3	10	0	0
9	19027637	.	G	T	6	4	10	0	1	11	0	0
9	19027681	.	C	T	9	8	17	0	0	17	0	0
9	19027685	.	T	C	11	0	11	0	9	20	0	0
9	19027748	.	T	C	11	6	17	0	0	17	0	0
9	19040846	.	C	T	8	5	13	0	3	16	0	0
9	19074628	.	T	C	5	4	9	0	0	9	0	0
9	19074642	.	G	T	5	5	10	0	1	11	0	0
9	19074687	.	G	A	4	3	7	0	0	7	0	0
9	19074800	.	A	G	1	2	3	0	0	3	0	0
9	19075002	.	C	T	0	2	2	0	5	7	0	0
9	19075015	.	C	A	4	3	7	0	0	7	0	0
9	19075057	.	T	A	2	2	4	0	0	4	0	0
9	19088325	.	A	T	1	2	3	0	0	3	0	0
9	19088366	.	A	G	1	2	3	0	0	3	0	0
9	19116528	.	G	C	3	2	5	0	0	5	0	0
9	19118990	.	G	A	2	2	4	0	1	5	0	0
9	19119000	.	G	A	3	2	5	0	0	5	0	0
9	19306630	.	T	C	0	2	2	0	1	3	0	0
9	19351953	.	C	T	4	2	6	0	1	7	0	0
9	19352004	.	G	A	1	2	3	0	0	3	0	0
9	19364025	.	G	A	1	2	3	0	0	3	0	0
9	19366353	.	A	T	1	2	3	0	0	3	0	0
9	19368167	.	A	C	3	4	7	0	0	7	0	0
9	19368168	.	A	C	3	3	6	0	1	7	0	0
9	19394111	.	A	G	2	2	4	0	0	4	0	0
9	19406130	.	G	A	7	2	9	0	0	9	0	0
9	19406131	.	G	T	8	2	10	0	0	10	0	0
9	19406310	.	A	G	6	0	6	0	3	9	0	0
9	19406425	.	T	A	3	2	5	0	0	5	0	0
9	19406564	.	A	T	1	5	6	0	0	6	0	0
9	19406607	.	T	C	1	5	6	0	0	6	0	0
9	19407587	.	G	T	2	3	5	0	0	5	0	0
9	19408038	.	A	G	3	3	6	0	0	6	0	0
9	19408248	.	A	G	5	3	8	0	2	10	0	0
9	19408327	.	C	G	2	5	7	0	0	7	0	0
9	19408345	.	G	A	4	4	8	0	0	8	0	0
9	19438572	.	G	A	1	5	6	0	3	9	0	0
9	19469133	.	C	T	6	3	9	0	1	10	0	0
9	19469175	.	C	T	2	8	10	0	0	10	0	0
9	19477882	.	T	G	3	2	5	0	0	5	0	0
9	19477913	.	T	C	5	7	12	0	0	12	0	0
9	19486262	.	A	C	1	5	6	0	0	6	0	0
9	19488371	.	C	T	0	2	2	0	1	3	0	0
9	19510699	.	G	A	10	14	24	0	0	24	0	0
9	19518690	.	A	T	7	3	10	0	2	12	0	0
9	19524019	.	T	A	1	4	5	0	0	5	0	0
9	19524026	.	G	A	1	3	4	0	0	4	0	0
9	19527981	.	T	C	3	2	5	0	0	5	0	0
9	19534237	.	G	A	3	6	9	0	0	9	0	0
9	19539222	.	C	T	8	3	11	0	0	11	0	0
9	19539770	.	C	A	6	5	11	0	1	12	0	0
9	19539800	.	T	C	2	2	4	2	2	8	0	0
9	19539840	.	T	C	5	7	12	2	0	14	0	0
9	19549346	.	A	G	2	0	2	0	9	11	0	0
9	19549620	.	C	T	1	6	7	0	1	8	0	0
9	19549868	.	A	T	6	4	10	0	0	10	0	0
9	19549958	.	C	A	8	5	13	0	0	13	0	0
9	19549989	.	G	A	6	3	9	0	0	9	0	0
9	19636514	.	G	A	0	3	3	0	1	4	0	0
9	19641168	.	T	C	1	3	4	0	0	4	0	0
9	19642709	.	A	G	1	4	5	0	0	5	0	0
9	19642724	.	T	C	2	5	7	0	0	7	0	0
9	19646511	.	A	G	3	3	6	0	1	7	0	0
9	19646535	.	T	G	3	0	3	0	4	7	0	0
9	19648295	.	T	C	5	3	8	0	1	9	0	0
9	19652691	.	A	C	8	12	20	0	2	22	0	0
9	19652706	.	G	A	12	12	24	0	2	26	0	0
9	19652816	.	A	T	10	8	18	0	1	19	0	0
9	19653115	.	G	A	2	4	6	0	0	6	0	0
9	19653130	.	T	A	4	6	10	0	0	10	0	0
9	19653188	.	C	T	5	3	8	0	0	8	0	0
9	19653200	.	C	T	5	2	7	0	0	7	0	0
9	19653284	.	A	G	2	2	4	0	0	4	0	0
9	19653318	.	T	G	1	2	3	0	0	3	0	0
9	19653325	.	A	C	1	2	3	0	0	3	0	0
9	20076615	.	G	A	16	9	25	0	0	25	0	0
9	20076691	.	G	C	12	12	24	0	2	26	0	0
9	20076799	.	A	G	17	7	24	0	0	24	0	0
9	20076847	.	A	G	17	12	29	0	0	29	0	0
9	20076850	.	A	G	15	12	27	0	2	29	0	0
9	20076913	.	T	C	11	0	11	0	24	35	0	0
9	20077971	.	A	G	14	17	31	0	2	33	0	0
9	20078072	.	G	T	14	7	21	0	1	22	0	0
9	20095605	.	A	G	9	7	16	0	2	18	0	0
9	20160291	.	T	A	9	5	14	0	0	14	0	0
9	20174733	.	G	C	4	5	9	0	0	9	0	0
9	20174954	.	T	C	2	0	2	0	4	6	0	0
9	20191377	.	T	C	4	0	4	0	3	7	0	0
9	20315497	.	A	G	4	2	6	0	0	6	0	0
9	20315614	.	A	G	1	2	3	0	0	3	0	0
9	20500337	.	A	C	3	3	6	0	0	6	0	0
9	20501158	.	C	T	1	2	3	0	0	3	0	0
9	20558247	.	C	T	8	6	14	0	0	14	0	0
9	20663995	.	C	T	8	3	11	0	0	11	0	0
9	20700130	.	T	C	2	1	3	0	1	4	0	0
9	20731311	.	A	G	12	5	17	0	0	17	0	0
9	20734036	.	T	C	11	3	14	0	0	14	0	0
9	20749770	.	A	T	13	8	21	0	0	21	0	0
9	20763830	.	G	C	9	6	15	1	0	16	0	0
9	20763834	.	G	A	1	6	7	1	10	18	0	0
9	20763878	.	G	A	1	10	11	0	11	22	0	0
9	20763907	.	A	T	14	7	21	0	1	22	0	0
9	20764004	.	G	A	15	12	27	0	2	29	0	0
9	20764019	.	T	A	14	15	29	0	0	29	0	0
9	20764183	.	C	T	17	18	35	0	0	35	0	0
9	20764229	.	G	C	19	12	31	0	1	32	0	0
9	20764231	.	T	A	21	12	33	0	0	33	0	0
9	20764271	.	C	A	22	6	28	0	4	32	0	0
9	20764877	.	T	C	16	8	24	0	1	25	0	0
9	20764994	.	G	A	15	14	29	0	1	30	0	0
9	20765193	.	A	G	11	9	20	0	0	20	0	0
9	20806530	.	A	C	6	4	10	0	0	10	0	0
9	20806656	.	A	T	6	4	10	0	0	10	0	0
9	20806657	.	A	G	6	4	10	0	0	10	0	0
9	20807171	.	C	T	4	3	7	0	1	8	0	0
9	20807179	.	G	A	4	4	8	0	0	8	0	0
9	20807216	.	T	C	4	4	8	0	0	8	0	0
9	20807217	.	G	A	4	4	8	0	0	8	0	0
9	20838024	.	T	C	3	0	3	0	4	7	0	0
9	20850584	.	A	G	4	6	10	0	1	11	0	0
9	20853933	.	G	T	1	3	4	0	0	4	0	0
9	20856248	.	G	A	1	2	3	0	1	4	0	0
9	20859268	.	A	G	1	0	1	0	3	4	0	0
9	20860161	.	G	C	2	2	4	0	1	5	0	0
9	20860396	.	A	T	1	2	3	0	0	3	0	0
9	20863300	.	A	T	1	3	4	0	0	4	0	0
9	20863342	.	T	C	1	2	3	0	0	3	0	0
9	20863822	.	T	C	2	2	4	0	0	4	0	0
9	20868978	.	T	A	3	4	7	0	0	7	0	0
9	20870521	.	T	C	4	3	7	0	0	7	0	0
9	20870779	.	T	C	4	5	9	0	0	9	0	0
9	20872331	.	T	C	6	7	13	0	0	13	0	0
9	21072714	.	T	C	2	0	2	0	3	5	0	0
9	21072922	.	T	C	7	3	10	0	0	10	0	0
9	21076209	.	A	T	3	2	5	0	0	5	0	0
9	21076422	.	T	C	1	0	1	0	4	5	0	0
9	21084783	.	A	G	2	5	7	0	0	7	0	0
9	21098324	.	T	G	1	3	4	0	0	4	0	0
9	21204244	.	T	G	8	5	13	0	0	13	0	0
9	21205138	.	A	G	1	5	6	0	0	6	0	0
9	21216897	.	T	C	4	15	19	0	0	19	0	0
9	21216898	.	T	C	4	14	18	0	1	19	0	0
9	21217434	.	G	T	2	8	10	0	0	10	0	0
9	21217438	.	A	G	2	8	10	0	0	10	0	0
9	21224703	.	T	C	6	12	18	0	0	18	0	0
9	21224725	.	G	A	8	10	18	0	5	23	0	0
9	21224753	.	G	A	8	18	26	0	0	26	0	0
9	21224768	.	T	G	9	18	27	0	1	28	0	0
9	21224789	.	G	T	5	13	18	0	1	19	0	0
9	21224860	.	A	G	16	4	20	0	0	20	0	0
9	21224866	.	A	G	3	19	22	0	0	22	0	0
9	21225011	.	C	A	3	20	23	0	0	23	0	0
9	21225282	.	G	A	2	4	6	0	0	6	0	0
9	21225987	.	C	A	1	4	5	0	0	5	0	0
9	21235685	.	C	T	4	5	9	0	0	9	0	0
9	21235717	.	C	T	6	6	12	0	0	12	0	0
9	21235737	.	C	A	7	5	12	0	1	13	0	0
9	21235770	.	A	T	8	9	17	0	1	18	0	0
9	21236049	.	G	C	6	4	10	0	0	10	0	0
9	21266763	.	A	T	3	2	5	0	0	5	0	0
9	21266854	.	A	G	14	11	25	0	2	27	0	0
9	21266878	.	C	T	1	9	10	0	14	24	0	0
9	21267133	.	C	T	26	21	47	0	1	48	0	0
9	21267323	.	C	T	26	15	41	0	0	41	0	0
9	21271683	.	G	A	4	5	9	0	0	9	0	0
9	21271781	.	A	T	3	3	6	0	0	6	0	0
9	21805309	.	A	G	0	2	2	0	1	3	0	0
9	22483856	.	G	A	0	3	3	0	2	5	0	0
9	22483862	.	C	T	2	3	5	0	0	5	0	0
9	22634324	.	T	C	9	17	26	0	0	26	0	0
9	22636747	.	C	T	18	23	41	0	2	43	0	0
9	22636988	.	C	T	18	22	40	0	2	42	0	0
9	22637031	.	C	G	19	25	44	0	0	44	0	0
9	22637082	.	A	T	23	24	47	0	0	47	0	0
9	22638738	.	C	G	16	15	31	0	1	32	0	0
9	22647331	.	T	C	19	22	41	0	3	44	0	0
9	22647373	.	A	G	20	0	20	0	23	43	0	0
9	22647391	.	C	T	17	19	36	0	6	42	0	0
9	22647607	.	A	T	19	18	37	0	4	41	0	0
9	22647754	.	A	T	13	17	30	0	3	33	0	0
9	22647755	.	A	T	15	16	31	0	1	32	0	0
9	22648004	.	A	G	12	0	12	0	13	25	0	0
9	22648010	.	G	A	1	12	13	0	12	25	0	0
9	22648051	.	T	C	17	15	32	0	1	33	0	0
9	22648355	.	A	T	17	25	42	0	2	44	0	0
9	22648747	.	T	G	17	28	45	0	2	47	0	0
9	22747419	.	A	G	5	0	5	0	8	13	0	0
9	22747557	.	A	G	5	5	10	0	0	10	0	0
9	22747644	.	G	A	0	4	4	0	6	10	0	0
9	22747865	.	A	C	2	2	4	0	0	4	0	0
9	22796244	.	C	A	1	4	5	0	0	5	0	0
9	22796255	.	C	A	1	4	5	0	0	5	0	0
9	22797962	.	A	C	2	5	7	0	1	8	0	0
9	22798087	.	C	T	4	4	8	0	0	8	0	0
9	22798180	.	C	A	4	4	8	0	0	8	0	0
9	22798715	.	A	G	4	6	10	0	1	11	0	0
9	22798736	.	G	T	3	7	10	0	0	10	0	0
9	22798765	.	A	G	3	3	6	0	1	7	0	0
9	22799115	.	T	A	8	4	12	0	1	13	0	0
9	22799157	.	G	A	8	4	12	0	0	12	0	0
9	22799456	.	G	C	1	7	8	0	5	13	0	0
9	22799508	.	T	C	3	7	10	0	0	10	0	0
9	22799810	.	A	G	7	8	15	0	0	15	0	0
9	22799883	.	C	T	11	7	18	0	0	18	0	0
9	22800271	.	T	C	10	4	14	0	0	14	0	0
9	22801205	.	C	T	8	11	19	0	2	21	0	0
9	22801527	.	C	T	9	8	17	0	1	18	0	0
9	22801746	.	A	G	10	9	19	0	1	20	0	0
9	22801785	.	A	G	9	0	9	0	10	19	0	0
9	22801929	.	A	G	3	8	11	0	0	11	0	0
9	22902938	.	A	T	6	2	8	0	0	8	0	0
9	22902997	.	G	A	7	4	11	0	1	12	0	0
9	22903012	.	T	G	6	5	11	0	0	11	0	0
9	22903166	.	C	T	0	13	13	0	17	30	0	0
9	22903270	.	A	T	5	13	18	0	2	20	0	0
9	22906425	.	C	T	7	11	18	0	0	18	0	0
9	22932366	.	T	G	1	5	6	0	0	6	0	0
9	22937852	.	G	A	7	4	11	0	0	11	0	0
9	22938719	.	A	T	7	12	19	0	1	20	0	0
9	22938828	.	T	G	5	8	13	0	1	14	0	0
9	22938932	.	T	G	13	0	13	0	11	24	0	0
9	22938967	.	T	G	5	18	23	0	0	23	0	0
9	22939068	.	A	G	8	10	18	0	2	20	0	0
9	22939201	.	C	G	6	4	10	0	0	10	0	0
9	22941166	.	C	A	9	3	12	0	0	12	0	0
9	22941285	.	G	T	7	7	14	0	0	14	0	0
9	22946494	.	G	A	4	5	9	0	1	10	0	0
9	22949353	.	C	T	5	5	10	0	0	10	0	0
9	23004411	.	C	A	0	2	2	0	1	3	0	0
9	23006862	.	T	C	2	3	5	0	0	5	0	0
9	23009923	.	G	A	2	3	5	0	0	5	0	0
9	23016482	.	T	A	5	6	11	0	0	11	0	0
9	23018709	.	C	A	4	3	7	0	1	8	0	0
9	23022763	.	A	T	9	7	16	0	0	16	0	0
9	23023047	.	A	T	7	5	12	0	0	12	0	0
9	23023064	.	C	T	4	6	10	0	0	10	0	0
9	23023103	.	G	C	5	4	9	0	0	9	0	0
9	23023254	.	G	A	0	4	4	0	2	6	0	0
9	23026412	.	A	T	4	3	7	0	0	7	0	0
9	23026901	.	C	T	9	9	18	0	3	21	0	0
9	23033771	.	T	C	8	0	8	0	5	13	0	0
9	23049577	.	A	G	4	0	4	0	6	10	0	0
9	23051913	.	G	T	0	4	4	0	4	9	1	0
9	23055635	.	C	T	9	16	25	0	3	28	0	0
9	23055644	.	A	G	10	17	27	0	2	29	0	0
9	23055674	.	G	C	9	16	25	0	1	26	0	0
9	23055986	.	A	C	1	6	7	0	0	7	0	0
9	23056098	.	A	T	6	3	9	0	1	10	0	0
9	23056104	.	G	C	3	2	5	0	2	7	0	0
9	23056148	.	A	T	2	5	7	0	1	8	0	0
9	23071272	.	A	G	2	4	6	0	0	6	0	0
9	23071579	.	G	A	4	3	7	0	0	7	0	0
9	23071830	.	T	A	3	4	7	0	0	7	0	0
9	23118208	.	C	T	2	2	4	0	0	4	0	0
9	23118297	.	C	T	3	2	5	0	0	5	0	0
9	23185674	.	A	G	14	16	30	0	3	33	0	0
9	23185786	.	A	C	17	21	38	0	1	39	0	0
9	23185801	.	T	A	11	23	34	0	4	38	0	0
9	23186163	.	A	C	14	9	23	0	1	24	0	0
9	23187985	.	T	C	3	5	8	0	0	8	0	0
9	23188003	.	C	T	3	6	9	0	0	9	0	0
9	23194587	.	G	A	10	10	20	0	0	20	0	0
9	23194608	.	A	T	11	8	19	0	1	20	0	0
9	23198166	.	C	T	6	4	10	0	0	10	0	0
9	23202433	.	A	T	6	4	10	0	1	11	0	0
9	23202743	.	G	A	1	3	4	0	0	4	0	0
9	23217093	.	C	T	6	5	11	0	0	11	0	0
9	23234567	.	T	C	11	1	12	0	17	29	0	0
9	23234777	.	C	T	2	14	16	0	10	26	0	0
9	23236339	.	T	C	10	12	22	0	3	25	0	0
9	23236465	.	G	C	10	10	20	0	0	20	0	0
9	23236515	.	G	A	14	22	36	0	0	36	0	0
9	23236531	.	C	T	0	22	22	0	12	34	0	0
9	23357063	.	T	A	4	2	6	0	0	6	0	0
9	23357134	.	A	G	4	4	8	0	0	8	0	0
9	23357142	.	G	C	3	0	3	0	4	7	0	0
9	23357194	.	C	T	3	10	13	0	1	14	0	0
9	23357200	.	T	C	3	11	14	0	0	14	0	0
9	23357234	.	C	G	3	10	13	0	0	14	1	0
9	23357317	.	T	C	6	0	6	0	9	15	0	0
9	23357528	.	C	T	11	8	19	0	0	19	0	0
9	23590600	.	C	T	1	2	3	0	0	3	0	0
9	23717861	.	T	A	1	1	2	0	1	3	0	0
9	23740555	.	G	C	5	4	9	0	0	9	0	0
9	23740676	.	A	G	23	14	37	0	3	40	0	0
9	23745176	.	C	T	1	15	16	0	16	32	0	0
9	23745201	.	T	A	17	15	32	0	1	33	0	0
9	23745471	.	C	A	20	11	31	0	2	33	0	0
9	23745504	.	A	G	17	10	27	0	0	27	0	0
9	23745531	.	C	T	21	10	31	0	2	33	0	0
9	23745558	.	T	C	14	0	14	0	16	30	0	0
9	23745570	.	G	A	17	13	30	0	1	31	0	0
9	23746628	.	A	G	10	20	30	0	2	32	0	0
9	23746676	.	G	A	13	14	27	0	2	29	0	0
9	23747111	.	T	C	23	7	30	0	0	30	0	0
9	23747118	.	G	A	23	8	31	0	0	31	0	0
9	23747226	.	A	C	6	7	13	0	0	13	0	0
9	23748417	.	C	G	9	4	13	0	0	13	0	0
9	23748421	.	A	G	8	5	13	0	1	14	0	0
9	23748993	.	G	C	11	3	14	0	0	14	0	0
9	23750634	.	T	C	13	11	24	0	1	25	0	0
9	23750643	.	C	T	14	10	24	0	0	24	0	0
9	23754905	.	T	C	14	12	26	0	0	26	0	0
9	23754989	.	C	A	4	9	13	0	0	13	0	0
9	23755024	.	A	T	7	5	12	0	0	12	0	0
9	23755618	.	A	G	2	2	4	0	0	4	0	0
9	23755774	.	G	A	4	5	9	0	0	9	0	0
9	23755883	.	C	T	7	2	9	0	0	9	0	0
9	23755897	.	G	C	6	3	9	0	0	9	0	0
9	23756108	.	G	C	9	5	14	0	0	14	0	0
9	23756268	.	G	A	4	9	13	0	0	13	0	0
9	23756298	.	A	G	5	0	5	0	10	15	0	0
9	23756332	.	T	A	2	5	7	0	1	8	0	0
9	23756377	.	G	A	6	7	13	0	0	13	0	0
9	23756519	.	C	T	7	5	12	0	0	12	0	0
9	23756552	.	C	T	8	3	11	0	1	12	0	0
9	23756584	.	T	C	5	4	9	0	0	9	0	0
9	23756636	.	T	A	6	3	9	0	1	10	0	0
9	23756640	.	C	G	7	3	10	0	0	10	0	0
9	23757103	.	G	T	5	3	8	0	0	8	0	0
9	23757145	.	C	T	5	2	7	0	1	8	0	0
9	23757157	.	G	A	6	2	8	0	0	8	0	0
9	23757196	.	G	C	2	2	4	0	0	4	0	0
9	23757197	.	G	A	2	2	4	0	0	4	0	0
9	23808573	.	T	C	2	2	4	0	0	4	0	0
9	23810426	.	A	G	5	2	7	0	0	7	0	0
9	23814104	.	G	C	11	14	25	0	1	26	0	0
9	23823895	.	A	G	17	15	32	0	1	33	0	0
9	23826525	.	A	G	2	3	5	0	0	5	0	0
9	23826534	.	G	A	2	4	6	0	0	6	0	0
9	23832209	.	G	A	3	3	6	0	0	6	0	0
9	23832689	.	C	T	2	2	4	0	0	4	0	0
9	23836415	.	T	C	3	3	6	0	1	7	0	0
9	23838389	.	G	C	2	2	4	0	0	4	0	0
9	23840775	.	G	C	4	4	8	1	1	10	0	0
9	23840824	.	C	T	4	8	12	0	1	13	0	0
9	23841000	.	A	G	2	0	2	0	5	7	0	0
9	23841037	.	T	G	3	5	8	0	0	8	0	0
9	23841088	.	G	A	1	5	6	0	0	6	0	0
9	23841139	.	T	C	2	3	5	0	0	5	0	0
9	23849227	.	T	C	0	0	0	0	3	3	0	0
9	23905834	.	A	C	8	7	15	0	0	15	0	0
9	23905848	.	G	T	8	3	11	0	2	13	0	0
9	23906101	.	C	T	2	3	5	0	0	5	0	0
9	23914555	.	T	C	2	5	7	0	2	9	0	0
9	23914684	.	C	G	2	2	4	0	0	4	0	0
9	23914696	.	G	C	2	2	4	0	0	4	0	0
9	24026088	.	G	T	1	3	4	0	0	4	0	0
9	24026116	.	C	A	3	3	6	0	0	6	0	0
9	24026205	.	C	A	8	4	12	0	0	12	0	0
9	24026332	.	G	T	6	4	10	0	0	10	0	0
9	24026397	.	G	A	11	4	15	0	1	17	1	0
9	24026400	.	G	A	11	6	17	0	0	17	0	0
9	24044395	.	G	A	2	4	6	0	0	6	0	0
9	24107215	.	G	A	8	3	11	0	0	11	0	0
9	24107251	.	C	A	3	10	13	0	0	13	0	0
9	24114126	.	C	T	9	5	14	0	0	14	0	0
9	24114655	.	G	C	1	7	8	0	7	15	0	0
9	24114826	.	C	T	9	5	14	0	0	14	0	0
9	24114867	.	T	G	1	8	9	0	0	9	0	0
9	24116512	.	T	C	2	0	2	0	3	5	0	0
9	24116915	.	C	A	9	3	12	0	0	12	0	0
9	24117048	.	C	A	0	6	6	0	6	12	0	0
9	24122676	.	C	T	17	7	24	0	0	24	0	0
9	24122715	.	G	T	1	11	12	0	9	21	0	0
9	24123504	.	T	C	4	4	8	0	2	10	0	0
9	24123723	.	T	C	2	2	4	0	0	4	0	0
9	24140229	.	C	A	2	2	4	0	0	4	0	0
9	24145547	.	T	C	3	2	5	0	0	5	0	0
9	24159805	.	C	A	1	2	3	0	1	4	0	0
9	24165555	.	C	T	2	3	5	0	0	5	0	0
9	24166575	.	T	C	6	3	9	0	0	9	0	0
9	24166729	.	T	C	4	5	9	0	0	9	0	0
9	24166825	.	T	C	4	3	7	0	0	7	0	0
9	24166846	.	C	T	3	3	6	0	0	6	0	0
9	24166867	.	A	G	2	2	4	0	0	4	0	0
9	24178660	.	G	A	8	9	17	0	0	17	0	0
9	24183438	.	T	C	2	8	10	0	0	10	0	0
9	24183603	.	C	T	9	8	17	0	0	17	0	0
9	24186269	.	G	A	8	3	11	0	0	11	0	0
9	24187510	.	C	A	12	9	21	0	0	21	0	0
9	24187675	.	T	G	6	5	11	0	0	11	0	0
9	24187805	.	C	G	11	5	16	0	1	17	0	0
9	24187967	.	A	G	9	0	9	0	14	23	0	0
9	24188100	.	A	T	4	5	9	0	0	9	0	0
9	24188110	.	A	T	4	3	7	0	0	7	0	0
9	24188729	.	C	G	8	4	12	0	1	13	0	0
9	24188969	.	T	G	6	16	22	0	1	23	0	0
9	24189179	.	T	G	9	6	15	0	0	15	0	0
9	24189198	.	A	G	3	10	13	0	0	13	0	0
9	24189283	.	G	A	15	12	27	0	1	28	0	0
9	24189407	.	A	G	18	12	30	0	1	31	0	0
9	24189757	.	C	A	14	10	24	0	0	24	0	0
9	24189825	.	T	A	12	9	21	0	4	25	0	0
9	24190010	.	G	A	18	9	27	2	1	30	0	0
9	24190020	.	G	A	17	11	28	1	1	30	0	0
9	24190048	.	T	C	16	14	30	1	2	33	0	0
9	24190139	.	A	G	14	8	22	1	0	23	0	0
9	24190295	.	T	C	10	10	20	0	1	21	0	0
9	24190302	.	A	G	8	10	18	0	2	20	0	0
9	24190419	.	G	A	23	12	35	0	0	35	0	0
9	24190466	.	G	T	16	9	25	0	3	28	0	0
9	24190489	.	C	G	13	10	23	0	0	23	0	0
9	24190547	.	C	A	13	5	18	0	1	19	0	0
9	24190630	.	G	C	14	7	21	0	1	22	0	0
9	24190642	.	T	A	13	9	22	0	1	23	0	0
9	24190748	.	G	T	14	8	22	0	0	22	0	0
9	24190767	.	A	G	16	0	16	0	8	24	0	0
9	24190792	.	A	G	11	12	23	0	2	25	0	0
9	24191053	.	T	A	18	15	33	1	1	35	0	0
9	24191462	.	G	A	19	13	32	0	0	32	0	0
9	24200608	.	C	T	3	5	8	0	0	8	0	0
9	24201111	.	A	G	1	0	1	0	3	4	0	0
9	24204218	.	C	T	4	3	7	0	0	7	0	0
9	24204231	.	A	T	3	3	6	0	0	6	0	0
9	24204456	.	T	C	3	2	5	0	0	5	0	0
9	24204723	.	T	A	4	8	12	0	1	13	0	0
9	24204749	.	T	A	8	8	16	0	1	17	0	0
9	24204762	.	A	G	8	7	15	0	2	17	0	0
9	24204806	.	T	C	8	0	8	0	6	14	0	0
9	24204905	.	T	A	8	14	22	0	0	22	0	0
9	24204913	.	G	C	12	6	18	0	1	19	0	0
9	24204947	.	A	C	6	7	13	0	0	13	0	0
9	24205136	.	G	A	5	7	12	0	0	12	0	0
9	24205292	.	C	T	3	3	6	0	1	7	0	0
9	24205318	.	A	G	3	3	6	0	0	6	0	0
9	24205391	.	T	C	5	6	11	0	0	11	0	0
9	24205484	.	A	G	2	8	10	0	0	10	0	0
9	24205596	.	C	T	11	6	17	0	0	17	0	0
9	24205681	.	G	T	6	12	18	0	1	19	0	0
9	24208774	.	T	C	9	6	15	0	2	17	0	0
9	24208779	.	T	A	9	5	14	0	1	15	0	0
9	24208825	.	T	C	6	0	6	0	5	11	0	0
9	24210083	.	A	G	1	0	1	0	2	3	0	0
9	24210244	.	T	C	1	2	3	0	0	3	0	0
9	24210449	.	C	T	2	3	5	0	0	5	0	0
9	24211172	.	A	G	3	0	3	0	4	7	0	0
9	24212277	.	C	T	7	6	13	0	0	13	0	0
9	24212299	.	G	A	4	6	10	0	0	10	0	0
9	24212552	.	G	A	0	3	3	0	4	7	0	0
9	24212585	.	A	C	1	2	3	0	0	3	0	0
9	24212629	.	T	A	1	6	7	0	1	8	0	0
9	24212654	.	T	A	1	6	7	0	0	7	0	0
9	24212748	.	T	C	1	3	4	0	0	4	0	0
9	24214709	.	C	A	1	6	7	0	4	11	0	0
9	24214792	.	C	T	10	12	22	0	1	23	0	0
9	24217459	.	G	A	4	4	8	0	0	8	0	0
9	24217801	.	T	A	5	4	9	1	0	10	0	0
9	24217829	.	T	G	4	2	6	3	2	11	0	0
9	24217894	.	T	A	5	7	12	0	0	12	0	0
9	24217910	.	T	C	7	5	12	0	0	12	0	0
9	24249396	.	T	G	20	20	40	0	1	41	0	0
9	24249414	.	T	C	17	0	17	0	23	40	0	0
9	24252457	.	C	T	1	21	22	0	26	48	0	0
9	24252490	.	T	C	23	0	23	1	20	44	0	0
9	24255690	.	G	T	20	21	41	0	0	41	0	0
9	24366142	.	G	A	14	24	38	0	1	39	0	0
9	24412781	.	A	G	16	9	25	1	1	27	0	0
9	24412790	.	A	G	17	9	26	1	0	27	0	0
9	24949068	.	C	T	3	2	5	0	0	5	0	0
9	24950385	.	C	T	6	3	9	0	1	10	0	0
9	24950389	.	C	T	7	1	8	0	2	10	0	0
9	25123436	.	A	C	2	3	5	0	0	5	0	0
9	25132315	.	C	A	2	3	5	0	0	5	0	0
9	25132516	.	C	T	5	2	7	0	0	7	0	0
9	25148540	.	C	A	4	9	13	0	0	13	0	0
9	25154390	.	T	G	9	7	16	0	0	16	0	0
9	25154910	.	T	A	10	5	15	0	0	15	0	0
9	25167271	.	C	T	2	2	4	0	0	4	0	0
9	25167620	.	C	G	7	3	10	0	0	10	0	0
9	25168569	.	A	C	4	6	10	0	0	10	0	0
9	25169246	.	G	T	2	1	3	0	0	3	0	0
9	25169258	.	A	T	2	4	6	0	0	6	0	0
9	25169295	.	T	A	1	4	5	0	1	6	0	0
9	25169380	.	A	G	5	12	17	0	1	18	0	0
9	25169399	.	T	A	6	7	13	0	3	16	0	0
9	25169444	.	T	G	5	5	10	0	1	11	0	0
9	25169609	.	T	C	7	5	12	0	0	12	0	0
9	25169738	.	G	A	6	4	10	0	0	10	0	0
9	25172158	.	G	C	5	3	8	0	1	9	0	0
9	25177600	.	A	G	3	4	7	0	0	7	0	0
9	25177642	.	A	G	2	3	5	0	1	6	0	0
9	25180196	.	G	A	8	8	16	0	0	16	0	0
9	25210606	.	C	T	2	2	4	0	0	4	0	0
9	25210612	.	T	A	0	2	2	0	1	3	0	0
9	25255468	.	T	C	1	0	1	0	3	4	0	0
9	25320799	.	C	T	6	3	9	0	0	9	0	0
9	25320812	.	C	T	4	4	8	0	0	8	0	0
9	25320914	.	T	A	9	10	19	0	0	19	0	0
9	25320980	.	A	T	11	6	17	1	0	18	0	0
9	25321073	.	C	A	5	3	8	0	0	8	0	0
9	25321538	.	G	A	11	7	18	0	0	18	0	0
9	25323773	.	C	T	7	6	13	0	0	13	0	0
9	25326386	.	G	A	4	8	12	0	0	12	0	0
9	25337499	.	G	A	3	2	5	0	0	5	0	0
9	25337529	.	G	A	2	2	4	0	0	4	0	0
9	25345948	.	A	G	3	2	5	0	0	5	0	0
9	25345974	.	A	G	2	2	4	0	0	4	0	0
9	25346001	.	G	T	0	2	2	0	1	3	0	0
9	25347908	.	T	A	2	3	5	0	1	6	0	0
9	25347916	.	G	T	2	3	5	0	1	6	0	0
9	25353387	.	C	T	1	6	7	0	8	15	0	0
9	25356838	.	A	G	9	6	15	0	0	15	0	0
9	25381021	.	A	G	26	13	39	0	1	40	0	0
9	25381150	.	A	G	17	16	33	0	0	33	0	0
9	25382028	.	T	C	10	0	10	0	6	16	0	0
9	25382097	.	T	C	7	7	14	0	2	16	0	0
9	25382322	.	C	G	11	4	15	0	0	15	0	0
9	25382478	.	C	A	8	5	13	0	0	13	0	0
9	25383046	.	C	A	13	10	23	0	0	23	0	0
9	25383124	.	T	C	8	0	8	0	13	21	0	0
9	25383421	.	G	A	12	5	17	0	1	18	0	0
9	25383571	.	G	A	4	2	6	0	0	6	0	0
9	25383780	.	A	C	10	7	17	0	0	17	0	0
9	25384091	.	G	A	10	12	22	0	1	23	0	0
9	25388150	.	T	C	7	0	7	0	10	17	0	0
9	25389823	.	G	A	5	8	13	0	0	13	0	0
9	25389931	.	G	A	8	6	14	0	1	15	0	0
9	25392985	.	C	T	9	5	14	0	1	15	0	0
9	25393036	.	T	C	5	6	11	0	0	11	0	0
9	25419211	.	C	G	5	7	12	0	0	12	0	0
9	25443163	.	T	A	0	2	2	0	1	3	0	0
9	25443330	.	A	T	5	3	8	0	0	8	0	0
9	25443352	.	A	T	5	3	8	0	0	8	0	0
9	25443575	.	A	T	1	3	4	0	0	4	0	0
9	25443874	.	T	A	3	3	6	0	1	7	0	0
9	25443908	.	C	T	1	5	6	0	0	6	0	0
9	25837206	.	A	T	2	2	4	0	0	4	0	0
9	25837213	.	A	T	5	3	8	0	1	9	0	0
9	27381862	.	A	G	4	2	6	0	0	6	0	0
9	27381934	.	A	C	5	2	7	0	0	7	0	0
9	27381941	.	A	G	4	2	6	0	0	6	0	0
9	27691970	.	A	G	1	2	3	0	0	3	0	0
9	27692005	.	C	A	5	2	7	0	0	7	0	0
9	27692017	.	T	C	6	4	10	0	0	10	0	0
9	27692075	.	G	T	4	5	9	0	0	9	0	0
9	27692325	.	A	G	13	3	16	0	0	16	0	0
9	27692329	.	G	T	9	4	13	0	4	17	0	0
9	27692389	.	A	G	10	6	16	0	1	17	0	0
9	27692402	.	G	T	10	5	15	0	1	16	0	0
9	27692471	.	C	T	2	5	7	0	6	13	0	0
9	27692699	.	C	G	1	12	13	0	7	20	0	0
9	27694630	.	T	C	4	3	7	0	1	8	0	0
9	27716762	.	A	G	3	4	7	0	0	7	0	0
9	27716974	.	A	G	4	5	9	0	0	9	0	0
9	27733526	.	C	T	1	2	3	0	0	3	0	0
9	27741482	.	T	G	1	2	3	0	0	3	0	0
9	27757831	.	C	T	14	16	30	0	0	30	0	0
9	27757893	.	A	G	21	1	22	0	16	38	0	0
9	27804274	.	C	A	1	2	3	5	0	8	0	0
9	27860734	.	C	T	2	6	8	0	5	13	0	0
9	27861186	.	G	T	5	2	7	0	1	8	0	0
9	27861293	.	C	G	1	7	8	0	9	17	0	0
9	27863828	.	G	T	5	6	11	0	0	11	0	0
9	27886614	.	T	C	2	6	8	0	0	8	0	0
9	27888461	.	G	T	2	5	7	0	0	7	0	0
9	27894656	.	T	C	8	5	13	0	0	13	0	0
9	27901012	.	A	T	2	7	9	0	1	10	0	0
9	27901013	.	C	T	4	7	11	0	0	11	0	0
9	27909933	.	C	T	9	5	14	0	0	14	0	0
9	27912962	.	G	A	4	3	7	0	0	7	0	0
9	27920595	.	T	A	6	3	9	0	0	9	0	0
9	27920649	.	G	A	2	4	6	0	0	6	0	0
9	27954620	.	G	A	1	2	3	0	0	3	0	0
9	27966379	.	T	C	1	4	5	0	0	5	0	0
9	27966424	.	T	A	2	3	5	0	0	5	0	0
9	28115886	.	A	G	4	0	4	0	5	9	0	0
9	28115901	.	A	G	4	5	9	0	1	10	0	0
9	28116064	.	T	C	6	7	13	0	0	13	0	0
9	28124661	.	G	A	6	5	11	0	1	12	0	0
9	28124775	.	A	G	10	1	11	0	11	22	0	0
9	28127334	.	A	G	12	0	12	0	8	20	0	0
9	28127471	.	A	G	7	8	15	0	4	19	0	0
9	28127513	.	A	C	14	7	21	0	0	21	0	0
9	28127532	.	A	C	13	5	18	0	1	19	0	0
9	28127573	.	A	G	11	12	23	0	1	24	0	0
9	28127706	.	C	G	13	8	21	0	0	21	0	0
9	28160011	.	T	C	1	2	3	0	0	3	0	0
9	28204026	.	C	T	4	3	7	0	0	7	0	0
9	28204036	.	C	A	4	2	6	0	1	7	0	0
9	28204464	.	C	A	5	6	11	0	0	11	0	0
9	28205071	.	C	T	3	3	6	0	0	6	0	0
9	28205072	.	G	A	1	2	3	0	3	6	0	0
9	28205214	.	C	T	3	2	5	0	0	5	0	0
9	28205464	.	G	A	2	3	5	0	0	5	0	0
9	28205484	.	C	A	3	2	5	0	0	5	0	0
9	28205703	.	T	C	3	3	6	0	0	6	0	0
9	28205743	.	T	C	1	3	4	0	0	4	0	0
9	28205786	.	C	A	4	2	6	0	0	6	0	0
9	28206679	.	T	C	5	2	7	0	0	7	0	0
9	28206947	.	A	T	5	8	13	0	0	13	0	0
9	28207339	.	T	A	2	5	7	0	0	7	0	0
9	28207392	.	T	A	4	5	9	0	0	9	0	0
9	28207647	.	C	T	4	2	6	0	0	6	0	0
9	28238302	.	C	T	12	22	34	0	0	34	0	0
9	28238305	.	C	T	2	21	23	0	11	34	0	0
9	28245874	.	G	A	9	12	21	0	0	21	0	0
9	28254633	.	C	T	9	9	18	0	1	19	0	0
9	28254783	.	C	T	0	17	17	0	11	28	0	0
9	28254810	.	G	A	8	13	21	0	1	22	0	0
9	28254909	.	G	A	2	6	8	0	0	8	0	0
9	28263971	.	C	T	13	9	22	0	0	22	0	0
9	28264469	.	T	C	13	0	13	0	12	25	0	0
9	28267158	.	G	A	12	8	20	0	2	22	0	0
9	28268543	.	G	A	8	8	16	0	0	16	0	0
9	28271181	.	T	C	8	6	14	0	1	15	0	0
9	28341330	.	C	A	0	9	9	0	7	16	0	0
9	28341382	.	G	A	9	8	17	0	0	17	0	0
9	28341591	.	C	A	16	24	40	0	3	43	0	0
9	28341593	.	T	A	16	23	39	0	5	44	0	0
9	28342963	.	G	A	10	10	20	0	1	21	0	0
9	28343054	.	G	A	10	9	19	0	2	21	0	0
9	28343100	.	A	G	12	14	26	0	1	27	0	0
9	28343121	.	T	G	11	15	26	0	0	26	0	0
9	28343549	.	C	T	7	5	12	0	2	14	0	0
9	28343590	.	G	A	8	4	12	0	0	12	0	0
9	28343629	.	C	T	3	8	11	0	0	11	0	0
9	28344026	.	T	C	7	4	11	0	0	11	0	0
9	28344126	.	A	C	9	7	16	0	1	17	0	0
9	28344320	.	T	G	13	7	20	2	0	22	0	0
9	28345531	.	T	C	8	7	15	0	0	15	0	0
9	28363208	.	G	A	7	4	11	0	1	12	0	0
9	28398942	.	G	C	3	5	8	0	0	8	0	0
9	28688667	.	T	G	2	0	2	0	8	10	0	0
9	28688956	.	C	G	8	0	8	0	4	12	0	0
9	28688965	.	A	G	10	4	14	0	0	14	0	0
9	28689032	.	G	A	11	11	22	0	2	24	0	0
9	28689033	.	C	A	12	11	23	0	0	23	0	0
9	28691645	.	T	C	10	3	13	0	1	14	0	0
9	28693734	.	A	T	1	3	4	0	0	4	0	0
9	28693737	.	C	T	1	3	4	0	0	4	0	0
9	28696610	.	A	C	5	3	8	0	0	8	0	0
9	28696643	.	A	G	5	5	10	0	0	10	0	0
9	28818498	.	A	T	6	5	11	0	1	12	0	0
9	28839859	.	G	A	5	4	9	0	0	9	0	0
9	28839879	.	T	A	4	6	10	0	1	11	0	0
9	28867390	.	T	C	8	0	8	0	4	12	0	0
9	28867421	.	A	C	4	3	7	0	0	7	0	0
9	28867426	.	A	C	4	2	6	0	1	7	0	0
9	28867459	.	C	T	3	4	7	0	0	7	0	0
9	28867555	.	G	A	3	3	6	0	0	6	0	0
9	28871367	.	A	T	4	5	9	0	0	9	0	0
9	28872083	.	A	G	3	2	5	0	1	6	0	0
9	28872253	.	T	G	3	3	6	0	0	6	0	0
9	28872341	.	G	A	6	5	11	0	2	13	0	0
9	28879348	.	C	T	4	3	7	0	2	9	0	0
9	28940998	.	G	A	13	12	25	0	0	25	0	0
9	28941003	.	T	C	14	0	14	0	14	28	0	0
9	28941061	.	A	C	8	5	13	0	3	17	1	0
9	28941179	.	A	G	8	11	19	0	0	19	0	0
9	28941189	.	G	A	7	9	16	0	0	16	0	0
9	28941234	.	C	T	5	7	12	0	0	12	0	0
9	28941414	.	A	G	21	12	33	0	1	34	0	0
9	28941446	.	A	G	13	16	29	0	3	32	0	0
9	28941488	.	T	A	13	10	23	0	1	24	0	0
9	28941498	.	C	G	12	9	21	0	0	21	0	0
9	28941629	.	G	A	6	7	13	0	1	14	0	0
9	28941630	.	G	A	7	7	14	0	1	15	0	0
9	28941684	.	C	G	4	3	7	0	1	8	0	0
9	28941709	.	G	C	4	3	7	0	0	7	0	0
9	28941723	.	A	G	4	3	7	0	0	7	0	0
9	28941795	.	C	T	4	7	11	0	0	11	0	0
9	28941832	.	A	G	8	3	11	0	0	11	0	0
9	28941879	.	A	T	5	3	8	0	0	8	0	0
9	28941897	.	T	G	4	4	8	0	0	8	0	0
9	28942018	.	G	A	9	9	18	0	0	18	0	0
9	28942111	.	A	G	3	3	6	0	0	6	0	0
9	28942542	.	T	A	9	10	19	0	6	25	0	0
9	28942553	.	T	A	11	12	23	0	0	23	0	0
9	28946132	.	A	T	11	11	22	0	0	22	0	0
9	28952959	.	G	A	12	8	20	0	0	20	0	0
9	28955543	.	A	G	9	3	12	0	1	13	0	0
9	28964849	.	C	A	7	10	17	0	0	17	0	0
9	28967048	.	A	G	9	5	14	0	1	15	0	0
9	28983790	.	C	A	0	4	4	0	5	9	0	0
9	28989543	.	C	T	1	1	2	0	1	3	0	0
9	28989549	.	G	A	0	3	3	0	0	3	0	0
9	29029545	.	T	A	2	4	6	0	0	6	0	0
9	29035139	.	A	G	2	2	4	0	0	4	0	0
9	29035572	.	T	C	5	5	10	0	0	10	0	0
9	29035575	.	A	G	5	5	10	0	0	10	0	0
9	29035614	.	A	C	5	3	8	0	0	8	0	0
9	29035839	.	C	A	3	2	5	0	0	5	0	0
9	29035977	.	A	G	2	2	4	0	0	4	0	0
9	29036107	.	T	C	1	3	4	0	0	4	0	0
9	29049712	.	T	C	1	3	4	0	0	4	0	0
9	29049901	.	T	C	6	3	9	0	0	9	0	0
9	29122231	.	T	G	5	8	13	0	1	14	0	0
9	29122536	.	T	A	8	6	14	0	0	14	0	0
9	29122725	.	C	T	3	3	6	0	0	6	0	0
9	29122849	.	A	G	5	6	11	0	0	11	0	0
9	29167096	.	T	C	1	0	1	0	3	4	0	0
9	29195268	.	A	G	1	3	4	0	0	4	0	0
9	29225281	.	G	A	4	5	9	0	0	9	0	0
9	29230754	.	A	G	0	4	4	0	1	5	0	0
9	29443840	.	T	C	4	2	6	0	0	6	0	0
9	29448372	.	T	G	1	3	4	0	0	4	0	0
9	29448703	.	T	G	1	0	1	0	3	4	0	0
9	29455415	.	T	C	3	5	8	0	0	8	0	0
9	29465051	.	C	T	2	3	5	0	0	5	0	0
9	29470325	.	G	A	1	6	7	0	0	7	0	0
9	29470326	.	G	A	1	5	6	0	1	7	0	0
9	29473879	.	T	A	6	4	10	0	0	10	0	0
9	29477021	.	G	C	11	5	16	1	0	17	0	0
9	29481518	.	T	C	8	10	18	0	2	20	0	0
9	29481732	.	A	G	7	2	9	0	1	10	0	0
9	29481747	.	G	A	1	4	5	0	6	11	0	0
9	29481795	.	T	C	4	3	7	0	1	8	0	0
9	29482135	.	T	A	8	5	13	0	0	13	0	0
9	29487130	.	C	T	7	4	11	0	0	11	0	0
9	29487163	.	C	T	7	3	10	0	0	10	0	0
9	29492571	.	A	G	1	2	3	0	0	3	0	0
9	29496189	.	A	G	4	4	8	0	0	8	0	0
9	29496672	.	A	T	3	2	5	0	1	6	0	0
9	29496692	.	T	G	3	2	5	0	0	5	0	0
9	29497181	.	C	T	1	3	4	0	2	6	0	0
9	29520819	.	A	G	11	18	29	0	5	34	0	0
9	29523552	.	T	G	15	0	15	0	12	27	0	0
9	29602959	.	T	C	5	3	8	0	0	8	0	0
9	29607543	.	C	T	8	12	20	0	1	21	0	0
9	29615087	.	C	G	29	15	44	0	0	44	0	0
9	29615238	.	T	A	19	12	31	0	1	32	0	0
9	29615575	.	C	T	19	12	31	0	2	33	0	0
9	29630650	.	C	T	1	2	3	0	0	3	0	0
9	29630668	.	T	C	1	2	3	0	0	3	0	0
9	29647469	.	G	A	32	14	46	0	0	46	0	0
9	29647470	.	C	T	30	14	44	0	2	46	0	0
9	29649571	.	C	A	31	19	50	0	3	53	0	0
9	29654858	.	T	C	1	2	3	0	0	3	0	0
9	29679106	.	A	G	2	2	4	0	2	6	0	0
9	29731041	.	T	C	13	12	25	0	1	26	0	0
9	29992145	.	A	G	13	0	13	0	14	27	0	0
9	29992332	.	G	A	4	4	8	0	0	8	0	0
9	30028016	.	C	T	1	4	5	0	5	10	0	0
9	30028056	.	T	C	2	0	2	0	4	6	0	0
9	30108779	.	T	C	6	6	12	0	1	13	0	0
9	30110026	.	T	C	11	4	15	0	0	15	0	0
9	30110217	.	T	C	6	10	16	0	1	17	0	0
9	30112544	.	A	G	15	2	17	0	17	34	0	0
9	30114853	.	A	G	11	9	20	0	1	21	0	0
9	30121155	.	C	A	17	15	32	0	2	34	0	0
9	30121167	.	C	T	10	15	25	0	3	28	0	0
9	30126136	.	A	G	23	1	24	0	30	54	0	0
9	30128084	.	C	G	40	22	62	0	0	62	0	0
9	30128085	.	C	T	40	21	61	0	1	62	0	0
9	30218140	.	C	T	4	5	9	0	0	9	0	0
9	30218310	.	G	A	4	3	7	0	0	7	0	0
9	30218323	.	A	G	5	3	8	0	0	8	0	0
9	30220931	.	C	T	4	3	7	0	0	7	0	0
9	30220968	.	T	A	2	7	9	0	0	9	0	0
9	30220975	.	C	T	2	8	10	0	0	10	0	0
9	30226160	.	T	C	7	0	7	0	6	13	0	0
9	30226583	.	T	C	5	0	5	0	12	17	0	0
9	30231309	.	G	A	3	3	6	0	0	6	0	0
9	30231360	.	A	C	2	0	2	0	3	5	0	0
9	30231557	.	A	G	2	2	4	0	0	4	0	0
9	30233169	.	A	T	2	2	4	0	1	5	0	0
9	30236090	.	A	C	3	3	6	0	0	6	0	0
9	30236303	.	A	G	2	2	4	0	0	4	0	0
9	30240979	.	A	G	1	3	4	0	0	4	0	0
9	30249039	.	C	T	0	10	10	0	3	13	0	0
9	30255146	.	C	G	2	2	4	0	1	5	0	0
9	30259418	.	C	G	2	4	6	0	0	6	0	0
9	30316447	.	C	T	2	3	5	0	0	5	0	0
9	30326347	.	G	A	4	7	11	0	0	11	0	0
9	30326377	.	A	G	6	5	11	0	0	11	0	0
9	30340154	.	A	G	9	5	14	0	0	14	0	0
9	30342030	.	T	C	3	0	3	0	7	10	0	0
9	30342072	.	T	C	3	0	3	0	6	9	0	0
9	30344279	.	A	G	4	3	7	0	0	7	0	0
9	30374990	.	A	T	1	3	4	0	2	6	0	0
9	30375015	.	G	T	3	3	6	0	1	7	0	0
9	30375346	.	A	G	3	2	5	0	1	6	0	0
9	30375470	.	A	T	4	8	12	0	0	12	0	0
9	30375746	.	G	A	3	4	7	0	0	7	0	0
9	30377582	.	G	T	2	3	5	1	1	7	0	0
9	30381813	.	C	G	0	3	3	0	2	5	0	0
9	30424220	.	G	A	1	2	3	0	0	3	0	0
9	30426795	.	C	T	1	2	3	0	0	3	0	0
9	30487596	.	C	A	6	2	8	0	0	8	0	0
9	30487599	.	T	C	5	1	6	0	1	7	0	0
9	30489813	.	A	G	4	2	6	0	0	6	0	0
9	30490106	.	G	A	2	4	6	0	0	6	0	0
9	30490949	.	G	T	5	6	11	0	0	11	0	0
9	30491053	.	T	C	9	4	13	0	0	13	0	0
9	30491197	.	G	A	5	7	12	0	0	12	0	0
9	30491560	.	C	T	4	8	12	0	10	22	0	0
9	30494225	.	T	C	12	6	18	0	1	19	0	0
9	30494839	.	A	G	4	5	9	0	0	9	0	0
9	30494854	.	T	A	2	4	6	0	0	6	0	0
9	30494965	.	G	A	8	6	14	0	1	15	0	0
9	30495139	.	C	T	0	4	4	0	8	12	0	0
9	30496377	.	A	G	3	7	10	0	0	10	0	0
9	30496436	.	A	G	5	2	7	0	1	8	0	0
9	30496446	.	G	T	6	2	8	0	0	8	0	0
9	30496952	.	A	G	3	4	7	0	0	7	0	0
9	30543686	.	C	T	0	2	2	0	1	3	0	0
9	30562611	.	T	C	2	2	4	0	0	4	0	0
9	30562659	.	A	G	4	4	8	0	0	8	0	0
9	30562947	.	A	G	2	3	5	0	0	5	0	0
9	30563034	.	A	T	1	6	7	0	0	7	0	0
9	30563056	.	C	T	1	4	5	0	0	5	0	0
9	30563126	.	C	T	1	2	3	0	0	3	0	0
9	30563541	.	T	C	8	0	8	0	5	13	0	0
9	30563568	.	T	C	8	0	8	0	8	16	0	0
9	30566872	.	T	C	2	2	4	0	0	4	0	0
9	30566878	.	G	T	2	1	3	0	1	4	0	0
9	30578018	.	A	G	1	5	6	0	0	6	0	0
9	30578122	.	C	G	5	4	9	0	0	9	0	0
9	30581779	.	G	C	5	10	15	0	0	15	0	0
9	30581942	.	C	T	4	3	7	0	0	7	0	0
9	30630597	.	C	G	2	2	4	0	0	4	0	0
9	30636682	.	A	G	3	2	5	0	0	5	0	0
9	30636727	.	T	C	2	4	6	0	0	6	0	0
9	30638922	.	A	G	3	5	8	0	0	8	0	0
9	30638970	.	A	G	4	3	7	0	0	7	0	0
9	30639047	.	A	T	1	2	3	0	0	3	0	0
9	30639148	.	C	T	1	0	1	0	2	3	0	0
9	30639149	.	T	C	0	2	2	0	1	3	0	0
9	30783874	.	T	A	4	1	5	0	1	6	0	0
9	30783887	.	A	C	4	3	7	0	0	7	0	0
9	30806492	.	A	G	2	5	7	0	0	7	0	0
9	30806642	.	G	T	6	6	12	0	0	12	0	0
9	30806662	.	T	G	6	3	9	0	1	10	0	0
9	30807944	.	C	T	5	4	9	0	0	9	0	0
9	30990731	.	T	C	5	7	12	0	1	13	0	0
9	30990845	.	A	G	8	9	17	0	0	17	0	0
9	31042584	.	T	C	21	23	44	0	1	45	0	0
9	31062518	.	T	A	21	17	38	0	1	39	0	0
9	31062588	.	G	A	24	18	42	0	1	43	0	0
9	31062589	.	G	A	22	19	41	0	1	42	0	0
9	31214307	.	T	G	7	3	10	0	0	10	0	0
9	31214442	.	A	C	8	6	14	0	0	14	0	0
9	31239258	.	A	G	5	0	5	0	3	8	0	0
9	31248923	.	C	T	10	6	16	0	0	16	0	0
9	31258832	.	G	A	10	8	18	0	1	19	0	0
9	31274993	.	T	C	14	0	14	3	11	28	0	0
9	31276912	.	C	T	14	18	32	0	2	34	0	0
9	31497898	.	A	T	1	2	3	0	0	3	0	0
9	31510724	.	T	A	6	4	10	0	0	10	0	0
9	31518804	.	C	T	4	2	6	1	0	7	0	0
9	31524405	.	G	A	3	3	6	0	0	6	0	0
9	31524406	.	T	C	1	3	4	0	2	6	0	0
9	31576987	.	T	C	1	3	4	0	0	4	0	0
9	31595634	.	C	T	30	18	48	0	1	49	0	0
9	31604943	.	G	A	8	3	11	0	0	11	0	0
9	31605235	.	A	G	7	6	13	0	1	14	0	0
9	31605260	.	T	C	8	0	8	0	7	15	0	0
9	31605281	.	C	A	2	8	10	0	7	17	0	0
9	31606333	.	C	T	9	5	14	0	2	16	0	0
9	31612184	.	C	T	2	5	7	0	0	7	0	0
9	31617687	.	A	G	7	10	17	0	0	17	0	0
9	31619998	.	A	G	7	5	12	0	0	12	0	0
9	31639107	.	C	T	0	4	4	0	7	11	0	0
9	31715887	.	A	G	3	3	6	0	0	6	0	0
9	31716932	.	G	A	2	5	7	0	0	7	0	0
9	31735673	.	A	G	1	2	3	0	0	3	0	0
9	31735676	.	A	C	2	3	5	0	0	5	0	0
9	31736102	.	G	A	3	4	7	0	0	7	0	0
9	31759780	.	A	C	1	2	3	2	0	5	0	0
9	32169182	.	A	G	19	27	46	0	0	46	0	0
9	32169287	.	G	A	20	31	51	0	2	53	0	0
9	32187866	.	A	T	8	3	11	0	0	11	0	0
9	32286804	.	C	G	6	6	12	0	1	13	0	0
9	32286858	.	C	T	7	10	17	0	0	17	0	0
9	32287162	.	A	G	13	19	32	0	0	32	0	0
9	32287208	.	A	C	21	23	44	0	0	44	0	0
9	32287418	.	A	G	23	18	41	0	2	43	0	0
9	32287419	.	A	G	25	18	43	0	0	43	0	0
9	32287481	.	T	C	28	10	38	0	1	39	0	0
9	32287688	.	A	G	18	17	35	0	1	36	0	0
9	32289064	.	C	A	2	14	16	0	22	38	0	0
9	32289281	.	G	A	19	14	33	0	1	34	0	0
9	32290957	.	G	A	12	15	27	0	0	27	0	0
9	32297376	.	G	A	9	6	15	0	0	15	0	0
9	32297472	.	T	C	12	7	19	0	0	19	0	0
9	32297487	.	C	T	11	7	18	0	0	18	0	0
9	32304476	.	G	A	11	6	17	0	0	17	0	0
9	32307717	.	T	C	22	20	42	0	0	42	0	0
9	32308523	.	A	C	13	15	28	0	2	30	0	0
9	32312472	.	C	T	29	30	59	0	0	59	0	0
9	32312600	.	A	G	27	2	29	0	25	54	0	0
9	32312683	.	C	A	17	13	30	0	0	30	0	0
9	32313260	.	T	C	3	2	5	0	0	5	0	0
9	32313318	.	T	C	8	3	11	0	0	11	0	0
9	32313626	.	C	T	5	3	8	0	0	8	0	0
9	32313875	.	G	T	4	2	6	0	0	6	0	0
9	32313964	.	G	A	5	3	8	0	0	8	0	0
9	32316114	.	C	T	6	3	9	0	0	9	0	0
9	32316348	.	C	G	9	4	13	0	0	13	0	0
9	32316499	.	A	G	6	2	8	0	0	8	0	0
9	32316788	.	G	T	3	5	8	0	0	8	0	0
9	32320286	.	T	C	1	2	3	0	0	3	0	0
9	32432199	.	T	G	1	0	1	0	2	3	0	0
9	32435052	.	G	A	4	4	8	0	0	8	0	0
9	32435121	.	T	A	4	2	6	0	0	6	0	0
9	32435127	.	T	A	3	2	5	0	0	5	0	0
9	32435256	.	T	G	2	2	4	0	0	4	0	0
9	32441761	.	A	G	4	0	4	0	5	9	0	0
9	32441800	.	T	C	6	7	13	0	0	13	0	0
9	32457192	.	C	T	10	10	20	0	0	20	0	0
9	32641131	.	T	A	5	9	14	0	0	14	0	0
9	32641175	.	T	G	7	14	21	0	1	22	0	0
9	32641278	.	A	T	4	9	13	0	1	14	0	0
9	32641294	.	G	T	8	11	19	0	1	20	0	0
9	32641548	.	T	A	3	7	10	0	2	12	0	0
9	32641600	.	A	G	7	9	16	1	0	17	0	0
9	32641682	.	A	G	12	14	26	0	1	27	0	0
9	32641731	.	C	A	9	12	21	0	1	22	0	0
9	32641737	.	A	G	11	12	23	0	1	24	0	0
9	32641802	.	T	C	10	5	15	0	2	17	0	0
9	32641805	.	A	G	12	4	16	0	0	16	0	0
9	32642342	.	A	G	10	22	32	0	2	34	0	0
9	32643643	.	G	A	8	11	19	0	0	19	0	0
9	32645615	.	G	C	19	11	30	0	2	32	0	0
9	32645939	.	T	C	9	13	22	0	0	22	0	0
9	32649147	.	C	T	5	4	9	0	0	9	0	0
9	32649662	.	T	C	2	3	5	0	1	6	0	0
9	32651241	.	A	T	2	4	6	0	0	6	0	0
9	32651334	.	C	T	3	7	10	0	1	11	0	0
9	32651527	.	C	A	8	4	12	0	0	12	0	0
9	32651648	.	A	G	5	3	8	0	0	8	0	0
9	32651665	.	T	C	5	5	10	0	0	10	0	0
9	32651826	.	T	C	4	4	8	0	1	9	0	0
9	32652059	.	A	G	1	0	1	0	3	4	0	0
9	32652072	.	T	C	1	3	4	0	0	4	0	0
9	32652129	.	C	T	4	2	6	0	1	7	0	0
9	32670606	.	T	C	1	2	3	0	0	3	0	0
9	32670610	.	A	G	1	2	3	0	0	3	0	0
9	32670920	.	C	T	1	2	3	0	0	3	0	0
9	32674841	.	T	C	1	2	3	0	0	3	0	0
9	32681720	.	A	T	4	2	6	0	0	6	0	0
9	32681877	.	A	C	1	6	7	0	2	9	0	0
9	32681880	.	A	C	2	7	9	0	0	9	0	0
9	32728896	.	G	C	8	10	18	0	1	19	0	0
9	32728969	.	A	G	11	12	23	0	1	24	0	0
9	32728984	.	C	A	12	9	21	0	0	21	0	0
9	32729022	.	T	C	8	5	13	0	0	13	0	0
9	32729072	.	G	A	6	8	14	0	0	14	0	0
9	32729183	.	T	G	4	7	11	0	1	12	0	0
9	32729908	.	C	A	8	7	15	0	0	15	0	0
9	32751640	.	A	G	12	13	25	0	2	27	0	0
9	32751812	.	A	G	11	15	26	0	0	26	0	0
9	32751825	.	C	T	10	16	26	0	0	26	0	0
9	32752272	.	C	T	18	16	34	0	0	34	0	0
9	32752555	.	C	T	17	15	32	0	0	32	0	0
9	32752794	.	A	C	11	1	12	0	20	32	0	0
9	32752824	.	G	T	13	14	27	0	0	27	0	0
9	32752864	.	G	T	12	15	27	0	0	27	0	0
9	32752995	.	T	C	7	11	18	0	1	19	0	0
9	32753016	.	C	G	13	10	23	0	0	23	0	0
9	32804802	.	C	T	9	7	16	0	1	17	0	0
9	32804898	.	C	A	0	3	3	0	3	6	0	0
9	32863357	.	G	A	1	2	3	0	0	3	0	0
9	32870922	.	T	C	2	2	4	0	0	4	0	0
9	32871509	.	A	G	2	3	5	0	0	5	0	0
9	32871514	.	T	C	2	4	6	0	0	6	0	0
9	32871562	.	G	A	5	3	8	0	1	9	0	0
9	32872881	.	G	A	3	2	5	0	0	5	0	0
9	32872932	.	T	C	2	2	4	0	0	4	0	0
9	32873025	.	G	A	1	4	5	0	0	5	0	0
9	32873040	.	C	T	2	3	5	0	0	5	0	0
9	32873064	.	T	C	3	2	5	0	0	5	0	0
9	32873127	.	G	T	4	3	7	0	0	7	0	0
9	32873151	.	G	A	1	2	3	0	3	6	0	0
9	32873544	.	G	T	1	5	6	0	14	20	0	0
9	32873788	.	C	A	7	5	12	0	0	12	0	0
9	32873792	.	C	A	8	4	12	0	1	13	0	0
9	32873834	.	A	T	10	8	18	0	1	19	0	0
9	32873940	.	G	A	9	8	17	0	0	17	0	0
9	32874222	.	T	G	6	4	10	0	0	10	0	0
9	32874603	.	G	A	2	12	14	0	7	21	0	0
9	32895294	.	A	T	5	3	8	0	0	8	0	0
9	32895297	.	T	C	5	0	5	0	3	8	0	0
9	32897304	.	C	T	9	3	12	0	1	13	0	0
9	32899796	.	C	T	4	4	8	0	0	8	0	0
9	32900000	.	T	C	1	0	1	0	3	4	0	0
9	32900267	.	C	T	0	6	6	0	5	11	0	0
9	32900453	.	A	G	5	5	10	0	0	10	0	0
9	32900768	.	A	G	10	4	14	0	0	14	0	0
9	32900849	.	G	A	2	7	9	0	0	9	0	0
9	32901173	.	A	G	11	12	23	0	0	23	0	0
9	32901176	.	T	A	10	12	22	0	0	22	0	0
9	32901275	.	G	A	2	4	6	0	0	6	0	0
9	32912464	.	A	G	4	2	6	0	0	6	0	0
9	32980561	.	T	A	2	2	4	0	0	4	0	0
9	32981252	.	C	T	5	3	8	1	1	10	0	0
9	32981302	.	C	T	2	3	5	0	0	5	0	0
9	32981317	.	T	C	2	3	5	0	1	6	0	0
9	33411227	.	C	A	11	8	19	0	0	19	0	0
9	33411228	.	A	G	11	8	19	0	0	19	0	0
9	33661399	.	A	G	16	14	30	0	0	30	0	0
9	33661424	.	G	A	11	14	25	0	1	26	0	0
9	33661645	.	A	T	10	8	18	0	0	18	0	0
9	33661691	.	A	T	3	4	7	0	1	8	0	0
9	33661714	.	G	A	6	5	11	0	1	12	0	0
9	33661765	.	C	T	6	8	14	0	1	16	1	0
9	33661773	.	A	C	7	10	17	0	0	17	0	0
9	33661939	.	T	A	7	6	13	0	0	13	0	0
9	33662043	.	A	G	9	7	16	1	0	17	0	0
9	33662134	.	C	T	12	5	17	0	3	20	0	0
9	33662158	.	A	G	15	11	26	0	0	26	0	0
9	33662175	.	T	G	13	10	23	0	1	24	0	0
9	33662223	.	A	T	5	9	14	0	0	14	0	0
9	33662250	.	A	T	4	5	9	0	0	9	0	0
9	33662273	.	A	C	2	6	8	0	0	8	0	0
9	33663176	.	T	A	3	6	9	0	0	9	0	0
9	33663300	.	G	A	7	9	16	0	0	16	0	0
9	33663331	.	A	G	12	10	22	0	0	22	0	0
9	33663455	.	A	G	3	5	8	0	1	9	0	0
9	33669020	.	C	A	3	6	9	0	0	9	0	0
9	33678095	.	G	A	6	4	10	0	0	10	0	0
9	33678124	.	A	G	5	4	9	0	1	10	0	0
9	33783731	.	T	A	4	3	7	0	1	8	0	0
9	33783800	.	A	T	10	9	19	0	2	21	0	0
9	33783822	.	T	A	18	13	31	0	0	31	0	0
9	33783852	.	A	G	30	10	40	0	0	40	0	0
9	33783956	.	T	C	26	22	48	0	2	51	1	0
9	33784689	.	T	G	33	22	55	0	3	58	0	0
9	33816289	.	C	T	1	3	4	0	0	4	0	0
9	33853510	.	A	G	9	0	9	0	9	18	0	0
9	33857776	.	C	T	9	4	13	0	0	13	0	0
9	33858088	.	G	A	8	8	16	0	0	16	0	0
9	33858111	.	T	C	8	12	20	0	1	21	0	0
9	33861813	.	A	T	3	4	7	0	0	7	0	0
9	33861865	.	C	T	9	4	13	0	3	16	0	0
9	34090715	.	T	A	1	2	3	0	0	3	0	0
9	34112981	.	T	C	6	8	14	0	0	14	0	0
9	34113008	.	A	T	6	6	12	0	1	13	0	0
9	34113140	.	G	A	5	2	7	0	1	8	0	0
9	34116933	.	A	G	3	5	8	0	0	8	0	0
9	34117293	.	A	C	7	6	13	0	1	14	0	0
9	34117578	.	C	G	7	2	9	0	1	10	0	0
9	34120732	.	C	T	0	4	4	0	2	6	0	0
9	34147568	.	A	G	2	3	5	0	0	5	0	0
9	34161749	.	G	A	7	6	13	0	2	15	0	0
9	34170057	.	G	A	8	10	18	0	0	18	0	0
9	34174561	.	C	T	6	11	17	0	0	17	0	0
9	34174682	.	G	A	1	8	9	0	0	9	0	0
9	34191597	.	G	A	8	3	11	0	1	12	0	0
9	34200253	.	T	A	2	3	5	0	0	5	0	0
9	34201156	.	G	A	3	4	7	0	0	7	0	0
9	34205537	.	A	G	6	2	8	0	0	8	0	0
9	34218953	.	A	G	5	2	7	0	0	7	0	0
9	34219058	.	G	T	2	4	6	0	0	6	0	0
9	34222113	.	C	T	19	9	28	0	2	30	0	0
9	34225055	.	A	G	9	17	26	0	0	26	0	0
9	34225316	.	G	C	21	23	44	0	3	47	0	0
9	34226884	.	G	A	22	30	52	0	0	52	0	0
9	34226888	.	G	A	2	30	32	0	20	52	0	0
9	34226960	.	A	C	25	23	48	1	0	49	0	0
9	34227016	.	A	T	13	16	29	0	1	30	0	0
9	34227020	.	C	G	13	15	28	0	0	28	0	0
9	34227054	.	C	T	12	18	30	0	0	30	0	0
9	34227074	.	C	A	13	14	27	0	0	27	0	0
9	34232612	.	G	T	2	2	4	0	0	4	0	0
9	34238849	.	C	T	1	5	6	0	0	6	0	0
9	34238858	.	C	A	1	5	6	0	0	6	0	0
9	34243122	.	G	C	3	4	7	0	0	7	0	0
9	34243567	.	G	T	5	7	12	0	0	12	0	0
9	34246473	.	G	A	3	10	13	0	0	13	0	0
9	34246524	.	G	A	8	14	22	0	1	23	0	0
9	34246555	.	T	G	10	7	17	0	2	19	0	0
9	34246628	.	G	A	7	5	12	0	0	12	0	0
9	34246710	.	G	A	8	5	13	0	0	13	0	0
9	34246932	.	A	G	16	15	31	0	0	31	0	0
9	34247356	.	G	A	11	11	22	0	2	24	0	0
9	34251632	.	G	A	11	12	23	0	4	27	0	0
9	34251707	.	C	G	18	10	28	0	2	30	0	0
9	34251752	.	G	A	14	9	23	0	2	25	0	0
9	34251764	.	G	A	13	10	23	0	0	23	0	0
9	34251963	.	A	G	6	9	15	0	0	15	0	0
9	34254678	.	A	G	8	6	14	0	0	14	0	0
9	34254685	.	G	A	6	5	11	0	1	12	0	0
9	34254896	.	G	A	7	9	16	0	1	17	0	0
9	34256016	.	A	C	2	6	8	0	0	8	0	0
9	34258384	.	A	G	7	7	14	0	1	15	0	0
9	34258565	.	T	G	4	5	9	0	0	9	0	0
9	34258580	.	C	T	0	3	3	0	3	6	0	0
9	34259406	.	T	A	5	4	9	0	0	9	0	0
9	34259418	.	T	A	6	5	11	0	0	11	0	0
9	34334173	.	T	G	7	0	7	0	9	16	0	0
9	34338283	.	C	T	6	2	8	0	0	8	0	0
9	34338325	.	G	A	5	2	7	0	0	7	0	0
9	34349379	.	T	C	6	5	11	0	1	12	0	0
9	34352271	.	G	A	1	6	7	0	1	8	0	0
9	34380503	.	T	A	9	10	19	0	1	20	0	0
9	34380525	.	T	A	9	17	26	0	0	26	0	0
9	34382946	.	A	T	13	16	29	0	0	29	0	0
9	34385183	.	A	G	8	10	18	0	2	20	0	0
9	34385396	.	A	G	7	2	9	0	16	25	0	0
9	34388882	.	G	A	14	13	27	0	4	31	0	0
9	34389077	.	T	C	8	10	18	0	0	18	0	0
9	34389101	.	C	G	8	9	17	0	0	17	0	0
9	34389288	.	T	G	9	17	26	0	1	27	0	0
9	34389299	.	T	G	12	0	12	0	16	28	0	0
9	34389427	.	C	T	12	17	29	0	2	31	0	0
9	34389602	.	A	G	17	0	17	0	16	33	0	0
9	34389666	.	A	G	14	17	31	0	0	31	0	0
9	34389701	.	A	T	13	23	36	0	1	37	0	0
9	34389704	.	G	C	13	23	36	0	1	37	0	0
9	34389743	.	G	T	11	21	32	0	1	33	0	0
9	34389748	.	A	C	11	21	32	0	1	33	0	0
9	34389791	.	A	G	4	8	12	0	0	12	0	0
9	34398133	.	C	A	1	2	3	0	0	3	0	0
9	34408154	.	C	T	1	3	4	0	0	4	0	0
9	34410156	.	G	A	7	2	9	0	0	9	0	0
9	34410237	.	T	C	3	7	10	0	0	10	0	0
9	34415308	.	T	C	8	11	19	0	0	19	0	0
9	34416575	.	A	T	7	4	11	0	2	13	0	0
9	34423397	.	C	A	6	9	15	0	0	15	0	0
9	34423415	.	T	A	7	11	18	0	0	18	0	0
9	34423468	.	T	A	6	12	18	0	2	20	0	0
9	34423474	.	A	G	7	0	7	0	11	18	0	0
9	34423794	.	T	C	1	2	3	0	0	3	0	0
9	34423822	.	T	A	2	2	4	0	0	4	0	0
9	34425920	.	C	T	5	8	13	0	1	14	0	0
9	34427760	.	A	G	1	4	5	0	0	5	0	0
9	34482462	.	G	A	3	4	7	0	1	8	0	0
9	34491034	.	C	A	3	2	5	0	0	5	0	0
9	34647349	.	T	C	14	19	33	0	2	35	0	0
9	34647352	.	G	A	14	17	31	0	3	34	0	0
9	34647415	.	A	G	14	2	16	0	22	38	0	0
9	34647427	.	A	C	18	19	37	0	1	38	0	0
9	34866579	.	T	G	14	9	23	0	0	23	0	0
9	34866684	.	T	A	4	4	8	0	1	9	0	0
9	34866888	.	C	T	17	17	34	0	0	34	0	0
9	34867007	.	C	A	2	13	15	0	16	31	0	0
9	34867015	.	T	C	15	0	15	0	12	27	0	0
9	34869699	.	A	G	11	19	30	0	0	30	0	0
9	34869813	.	G	A	10	8	18	0	2	20	0	0
9	34869945	.	G	A	11	15	26	0	1	27	0	0
9	34871796	.	G	C	12	11	23	0	0	23	0	0
9	34877024	.	G	A	2	2	4	0	0	4	0	0
9	34877042	.	G	A	4	3	7	0	0	7	0	0
9	34877074	.	C	T	5	4	9	0	0	9	0	0
9	34877285	.	G	A	3	2	5	0	0	5	0	0
9	34877315	.	G	A	3	2	5	0	0	5	0	0
9	34878371	.	T	C	1	2	3	0	0	3	0	0
9	34880471	.	T	C	1	2	3	0	0	3	0	0
9	34903218	.	T	G	33	18	51	0	0	51	0	0
9	34906337	.	C	G	29	30	59	0	4	63	0	0
9	34912626	.	A	T	25	21	46	0	2	48	0	0
9	34912695	.	T	C	14	0	14	0	24	38	0	0
9	34912895	.	T	A	17	19	36	0	3	39	0	0
9	34920395	.	G	A	5	6	11	0	0	11	0	0
9	34922670	.	C	T	1	3	4	0	2	6	0	0
9	34922898	.	A	G	5	9	14	0	1	15	0	0
9	34937099	.	G	A	2	2	4	0	0	4	0	0
9	34937145	.	C	G	3	4	7	0	0	7	0	0
9	34937154	.	A	T	3	4	7	0	0	7	0	0
9	34938795	.	C	T	7	10	17	0	0	17	0	0
9	34939336	.	A	G	11	20	31	0	0	31	0	0
9	34939800	.	T	C	8	16	24	0	0	24	0	0
9	34967647	.	C	T	5	6	11	0	0	11	0	0
9	34967649	.	C	T	7	5	12	0	1	13	0	0
9	34967733	.	A	G	6	5	11	0	0	11	0	0
9	34967743	.	A	C	6	6	12	0	0	12	0	0
9	34968005	.	A	G	5	2	7	0	0	7	0	0
9	35022050	.	A	G	2	3	5	0	1	6	0	0
9	35024459	.	G	C	0	4	4	0	6	10	0	0
9	35025183	.	C	T	5	7	12	0	0	12	0	0
9	35025243	.	A	T	10	4	14	0	1	15	0	0
9	35025430	.	C	T	5	4	9	0	0	9	0	0
9	35026736	.	T	A	32	30	62	0	2	64	0	0
9	35026941	.	T	C	33	25	58	0	3	61	0	0
9	35027262	.	A	G	41	30	71	0	3	74	0	0
9	35027309	.	T	C	39	6	45	0	24	69	0	0
9	35027333	.	A	G	40	22	62	0	4	66	0	0
9	35027365	.	G	T	42	24	66	1	1	68	0	0
9	35027371	.	G	T	39	27	66	1	2	70	1	0
9	35027402	.	G	A	37	28	65	1	0	66	0	0
9	35027549	.	T	G	40	22	62	0	0	62	0	0
9	35027705	.	G	A	26	5	31	0	2	42	9	0
9	35028086	.	T	C	44	5	49	0	34	83	0	0
9	35028282	.	T	C	37	7	44	0	40	84	0	0
9	35030977	.	G	A	31	33	64	1	1	66	0	0
9	35032640	.	A	G	35	25	60	0	3	63	0	0
9	35032643	.	A	G	37	23	60	0	3	63	0	0
9	35033347	.	C	T	28	26	54	0	1	55	0	0
9	35039175	.	T	C	22	21	43	2	2	47	0	0
9	35048839	.	G	C	29	17	46	0	2	48	0	0
9	35048840	.	A	C	31	17	48	0	0	48	0	0
9	35170671	.	G	A	13	14	27	0	1	28	0	0
9	35176030	.	A	G	22	15	37	0	0	37	0	0
9	35228165	.	G	A	8	11	19	0	0	19	0	0
9	35230740	.	G	A	7	7	14	0	1	15	0	0
9	35254679	.	G	A	5	4	9	0	0	9	0	0
9	35266330	.	C	T	2	10	12	0	4	16	0	0
9	35296835	.	C	T	2	5	7	0	0	7	0	0
9	35296926	.	T	A	6	2	8	0	0	8	0	0
9	35836674	.	T	G	4	4	8	0	0	8	0	0
9	35836721	.	T	A	6	4	10	0	0	10	0	0
9	35837194	.	C	G	9	0	9	0	3	12	0	0
9	35837404	.	C	A	4	5	9	0	1	10	0	0
9	35838477	.	T	A	12	15	27	0	1	28	0	0
9	35840713	.	G	A	14	4	18	0	0	18	0	0
9	35840782	.	T	C	9	7	16	0	0	16	0	0
9	35841279	.	G	T	9	3	12	0	1	13	0	0
9	35841282	.	A	G	10	3	13	0	0	13	0	0
9	35841663	.	G	T	7	11	18	0	1	19	0	0
9	35841879	.	T	A	15	6	21	0	1	22	0	0
9	35841994	.	A	G	6	5	11	0	1	12	0	0
9	35842164	.	T	A	11	10	21	0	3	24	0	0
9	35842209	.	G	T	10	8	18	0	0	18	0	0
9	35860982	.	G	A	5	7	12	0	0	12	0	0
9	35860983	.	A	T	4	7	11	0	1	12	0	0
9	35862299	.	G	A	10	19	29	0	2	31	0	0
9	35863132	.	C	T	12	18	30	0	1	31	0	0
9	35863555	.	T	C	12	16	28	0	2	30	0	0
9	35863603	.	T	C	12	12	24	0	0	24	0	0
9	35863798	.	C	T	18	18	36	0	0	36	0	0
9	35863968	.	A	T	13	16	29	0	1	30	0	0
9	35864155	.	A	T	9	7	16	0	0	16	0	0
9	35864210	.	C	T	11	6	17	0	1	18	0	0
9	35864266	.	C	A	10	11	21	0	1	22	0	0
9	35864277	.	C	T	9	10	19	0	0	19	0	0
9	35864416	.	A	C	1	2	3	0	0	3	0	0
9	35864486	.	C	T	5	7	12	0	0	12	0	0
9	35864565	.	A	G	7	6	13	0	0	13	0	0
9	35864598	.	C	T	6	11	17	0	1	18	0	0
9	35865073	.	C	T	18	17	35	0	2	37	0	0
9	35865162	.	G	T	14	9	23	0	2	25	0	0
9	35865270	.	C	G	15	18	33	0	5	38	0	0
9	35872927	.	G	A	4	3	7	0	0	7	0	0
9	35872942	.	G	A	6	2	8	0	0	8	0	0
9	35872993	.	A	T	7	5	12	0	0	12	0	0
9	35873884	.	A	G	2	3	5	0	0	5	0	0
9	35907553	.	C	T	3	3	6	0	0	6	0	0
9	35909842	.	A	G	2	2	4	0	0	4	0	0
9	35910390	.	C	G	6	5	11	0	0	11	0	0
9	35912661	.	G	C	1	3	4	0	0	4	0	0
9	35915327	.	C	A	1	3	4	0	0	4	0	0
9	35915548	.	C	T	2	10	12	0	0	12	0	0
9	35915557	.	G	A	1	7	8	0	3	11	0	0
9	35916518	.	T	G	8	6	14	0	1	15	0	0
9	35916786	.	G	A	7	7	14	0	1	15	0	0
9	35922046	.	T	G	11	21	32	1	0	33	0	0
9	35922115	.	T	C	8	11	19	0	1	20	0	0
9	36540309	.	C	T	2	2	4	0	1	5	0	0
9	36555951	.	C	T	2	3	5	0	0	5	0	0
9	36577315	.	T	C	6	3	9	0	0	9	0	0
9	36610202	.	C	T	1	3	4	0	0	4	0	0
9	36613178	.	C	T	3	3	6	0	0	6	0	0
9	36613202	.	C	T	2	2	4	0	0	4	0	0
9	36659702	.	T	G	5	6	11	0	0	11	0	0
9	36896270	.	A	G	1	2	3	0	0	3	0	0
9	36896761	.	C	A	0	5	5	0	3	8	0	0
9	36896791	.	C	T	4	3	7	0	2	9	0	0
9	36898724	.	C	T	12	4	16	0	0	16	0	0
9	36899065	.	C	T	0	8	8	0	11	19	0	0
9	36973147	.	T	C	1	2	3	0	0	3	0	0
9	36973841	.	C	G	1	3	4	0	0	4	0	0
9	36974170	.	G	T	5	3	8	0	0	8	0	0
9	36974191	.	T	C	3	3	6	0	0	6	0	0
9	36974460	.	C	T	3	3	6	0	0	6	0	0
9	37296192	.	G	A	3	2	5	0	0	5	0	0
9	37341551	.	T	C	2	2	4	0	0	4	0	0
9	37341554	.	T	C	1	2	3	0	1	4	0	0
9	37354220	.	A	G	2	3	5	0	0	5	0	0
9	37371515	.	A	T	3	4	7	0	1	8	0	0
9	37390314	.	C	T	2	2	4	0	0	4	0	0
9	37431935	.	G	A	0	4	4	0	6	10	0	0
9	37451609	.	T	G	8	5	13	0	0	13	0	0
9	37451809	.	A	G	4	10	14	0	0	14	0	0
9	37452012	.	A	T	11	8	19	0	0	19	0	0
9	37452223	.	C	T	8	7	15	0	1	16	0	0
9	37452432	.	G	A	9	8	17	0	2	19	0	0
9	37452499	.	T	G	8	3	11	1	1	13	0	0
9	37452515	.	G	T	6	6	12	1	1	14	0	0
9	37452616	.	T	G	21	12	33	0	1	34	0	0
9	37452819	.	G	C	11	8	19	0	0	19	0	0
9	37452924	.	C	G	9	6	15	0	0	15	0	0
9	37508255	.	T	C	1	2	3	0	0	3	0	0
9	37815520	.	A	T	4	5	9	0	1	10	0	0
9	37839796	.	G	A	4	3	7	0	0	7	0	0
9	37840024	.	G	T	2	2	4	0	0	4	0	0
9	37850479	.	G	C	5	5	10	0	0	10	0	0
9	37856541	.	C	T	9	6	15	0	0	15	0	0
9	37856895	.	T	A	11	5	16	0	1	17	0	0
9	37859807	.	G	T	13	10	23	0	0	23	0	0
9	37859881	.	T	G	12	19	31	0	1	32	0	0
9	37860116	.	T	C	4	4	8	1	0	9	0	0
9	37860645	.	A	T	2	2	4	0	1	5	0	0
9	37861458	.	T	G	2	4	6	0	0	6	0	0
9	37861468	.	A	G	1	4	5	0	0	5	0	0
9	37861560	.	A	G	2	0	2	0	4	6	0	0
9	37862065	.	T	G	2	0	2	0	9	11	0	0
9	37862376	.	T	C	2	2	4	0	0	4	0	0
9	38021242	.	C	T	1	3	4	0	0	4	0	0
9	38030131	.	A	T	14	19	33	0	1	34	0	0
9	38030366	.	A	T	10	6	16	0	3	19	0	0
9	38030485	.	A	T	8	9	17	0	3	20	0	0
9	38030503	.	C	T	1	9	10	0	10	20	0	0
9	38030574	.	G	A	8	10	18	0	0	18	0	0
9	38033363	.	T	C	9	1	10	0	9	19	0	0
9	38033578	.	A	G	12	10	22	0	0	23	1	0
9	38042752	.	G	A	6	5	11	0	2	13	0	0
9	38043476	.	T	C	1	2	3	0	0	3	0	0
9	38058608	.	T	C	2	5	7	0	0	7	0	0
9	38059042	.	C	T	2	3	5	0	0	5	0	0
9	38061311	.	G	A	7	4	11	0	0	11	0	0
9	38061525	.	G	T	2	5	7	0	5	12	0	0
9	38061699	.	T	C	8	8	16	0	0	16	0	0
9	38061788	.	T	C	10	9	19	0	0	19	0	0
9	38063688	.	C	A	10	7	17	0	0	17	0	0
9	38063689	.	C	A	9	7	16	0	1	17	0	0
9	38064165	.	A	T	3	4	7	0	0	7	0	0
9	38064268	.	T	C	6	4	10	0	1	11	0	0
9	38064420	.	T	G	8	7	15	0	0	15	0	0
9	38064421	.	C	A	8	7	15	0	0	15	0	0
9	38064672	.	A	C	7	5	12	0	0	12	0	0
9	38129632	.	A	G	3	0	3	0	4	7	0	0
9	38142493	.	A	G	3	3	6	0	0	6	0	0
9	38161842	.	C	T	5	4	9	0	0	9	0	0
9	38161905	.	G	A	2	2	4	0	0	4	0	0
9	38167875	.	T	C	1	4	5	0	0	5	0	0
9	38168065	.	G	A	0	3	3	0	2	5	0	0
9	38207504	.	C	T	3	3	6	0	0	6	0	0
9	38207964	.	G	A	1	2	3	0	0	3	0	0
9	38238917	.	G	A	1	3	4	0	6	10	0	0
9	38251409	.	T	C	2	8	10	0	0	10	0	0
9	38266131	.	T	C	2	3	5	0	0	5	0	0
9	38269630	.	A	G	6	5	11	0	0	11	0	0
9	38273171	.	G	A	14	10	24	0	2	26	0	0
9	38273264	.	T	A	15	13	28	0	0	28	0	0
9	38276558	.	T	G	11	0	11	0	6	17	0	0
9	38277513	.	A	G	12	10	22	0	0	22	0	0
9	38278121	.	A	G	10	12	22	0	1	23	0	0
9	38278289	.	C	T	13	8	21	0	0	21	0	0
9	38278301	.	T	C	16	11	27	0	0	27	0	0
9	38278337	.	T	C	12	8	20	0	0	20	0	0
9	38283647	.	G	A	14	9	23	0	0	23	0	0
9	38283659	.	C	T	17	7	24	0	0	24	0	0
9	38284317	.	A	G	15	0	15	0	13	28	0	0
9	38285598	.	A	G	18	18	36	0	1	37	0	0
9	38286823	.	G	A	24	12	36	0	1	37	0	0
9	38290165	.	C	T	11	16	27	0	0	27	0	0
9	38290210	.	A	G	12	8	20	0	3	23	0	0
9	38290220	.	T	G	15	0	15	0	8	23	0	0
9	38290245	.	C	T	22	7	29	0	0	29	0	0
9	38290414	.	A	G	12	9	21	0	0	21	0	0
9	38290517	.	A	C	6	7	13	0	1	14	0	0
9	38290530	.	A	T	7	6	13	0	3	16	0	0
9	38290777	.	G	T	3	9	12	0	16	28	0	0
9	38290959	.	A	C	25	17	42	0	1	43	0	0
9	38291439	.	G	T	18	14	32	0	2	34	0	0
9	38291616	.	C	T	14	15	29	0	1	30	0	0
9	38291737	.	C	A	4	3	7	0	4	11	0	0
9	38315827	.	C	G	3	6	9	0	0	9	0	0
9	38316758	.	G	A	6	0	6	0	2	8	0	0
9	38316769	.	T	C	5	2	7	0	1	8	0	0
9	38348252	.	G	A	2	4	6	0	0	6	0	0
9	38351016	.	T	C	4	8	12	0	0	12	0	0
9	38353794	.	T	C	9	14	23	0	3	26	0	0
9	38354000	.	T	C	12	6	18	0	0	18	0	0
9	38354224	.	A	G	9	10	19	0	1	20	0	0
9	38354689	.	G	A	7	4	11	0	1	12	0	0
9	38359027	.	A	C	13	1	14	0	7	21	0	0
9	38359737	.	G	A	5	4	9	0	1	10	0	0
9	38360102	.	C	T	0	4	4	0	7	11	0	0
9	38362354	.	G	A	10	6	16	0	0	17	1	0
9	38362380	.	C	T	10	6	16	1	0	17	0	0
9	38366653	.	T	C	3	3	6	0	1	7	0	0
9	38366656	.	C	A	0	3	3	0	4	7	0	0
9	38366826	.	A	G	4	3	7	0	0	7	0	0
9	38368055	.	A	G	3	3	6	0	0	6	0	0
9	38372264	.	C	T	3	2	5	0	0	5	0	0
9	38376006	.	G	A	3	2	5	0	0	5	0	0
9	38376231	.	T	C	1	5	6	0	0	6	0	0
9	38376248	.	A	T	1	4	5	0	0	5	0	0
9	38377858	.	G	A	3	2	5	0	1	6	0	0
9	38385734	.	G	A	3	2	5	0	1	6	0	0
9	38386066	.	A	G	3	0	3	0	4	7	0	0
9	38386205	.	C	T	4	6	10	0	1	11	0	0
9	38386615	.	C	A	4	4	8	0	0	8	0	0
9	38388017	.	G	A	1	3	4	0	1	5	0	0
9	38388492	.	C	T	11	8	19	1	1	21	0	0
9	38388493	.	C	T	4	7	11	1	9	21	0	0
9	38388703	.	T	C	10	3	13	0	3	16	0	0
9	38389026	.	T	A	5	3	8	0	0	8	0	0
9	38389194	.	C	T	5	3	8	0	0	8	0	0
9	38389263	.	T	A	3	5	8	0	0	8	0	0
9	38389426	.	G	A	11	8	19	0	2	21	0	0
9	38389603	.	A	G	15	1	16	0	5	21	0	0
9	38389616	.	C	T	14	7	21	0	0	21	0	0
9	38389644	.	A	T	11	6	17	0	0	17	0	0
9	38389722	.	G	T	5	3	8	0	1	9	0	0
9	38389746	.	T	C	13	5	18	0	0	18	0	0
9	38389886	.	C	T	7	9	16	0	1	17	0	0
9	38390973	.	A	G	3	4	7	0	0	7	0	0
9	38390976	.	G	A	3	3	6	0	0	6	0	0
9	38392097	.	T	C	4	2	6	0	0	6	0	0
9	38393275	.	A	C	3	4	7	0	0	7	0	0
9	38393276	.	T	C	3	4	7	0	0	7	0	0
9	38400232	.	T	A	2	2	4	0	1	5	0	0
9	38400233	.	T	C	2	3	5	0	0	5	0	0
9	38405238	.	A	G	10	6	16	0	0	16	0	0
9	38405271	.	G	C	8	4	12	0	0	12	0	0
9	38413298	.	C	T	5	3	8	0	1	9	0	0
9	38418864	.	T	C	1	3	4	0	0	4	0	0
9	38423558	.	T	A	4	2	6	0	0	6	0	0
9	38429624	.	G	T	5	4	9	0	0	9	0	0
9	38429707	.	T	C	6	2	8	0	0	8	0	0
9	38429716	.	A	C	6	2	8	0	1	9	0	0
9	38456091	.	A	C	1	6	7	0	0	7	0	0
9	38456111	.	T	C	3	5	8	1	0	9	0	0
9	38456862	.	C	T	1	3	4	0	0	4	0	0
9	38470376	.	C	T	3	3	6	0	0	6	0	0
9	38475598	.	T	C	4	2	6	0	0	6	0	0
9	38476842	.	G	T	0	2	2	0	3	5	0	0
9	38478252	.	A	G	7	3	10	0	0	10	0	0
9	38478477	.	G	A	0	2	2	0	3	5	0	0
9	38478643	.	A	T	2	5	7	0	0	7	0	0
9	38494774	.	G	A	1	2	3	0	0	3	0	0
9	38495985	.	C	T	1	3	4	0	0	4	0	0
9	38502640	.	A	G	1	4	5	0	0	5	0	0
9	38506389	.	T	A	3	2	5	0	0	5	0	0
9	38525125	.	T	C	1	2	3	0	0	3	0	0
9	38530916	.	G	A	1	3	4	0	0	4	0	0
9	38600006	.	G	A	1	3	4	0	4	8	0	0
9	38603338	.	A	T	15	6	21	0	2	23	0	0
9	38603742	.	T	C	16	6	22	0	1	23	0	0
9	38620058	.	C	T	9	10	19	0	0	19	0	0
9	38620308	.	C	A	5	8	13	0	0	13	0	0
9	38620673	.	A	G	18	13	31	0	0	31	0	0
9	38636413	.	G	T	0	3	3	0	6	9	0	0
9	38636722	.	T	C	7	4	11	0	0	11	0	0
9	38636797	.	T	C	5	3	8	0	0	8	0	0
9	38637072	.	G	T	1	2	3	0	0	3	0	0
9	38637438	.	T	A	3	2	5	0	0	5	0	0
9	38637445	.	A	G	3	0	3	0	2	5	0	0
9	38637872	.	T	C	2	4	6	0	0	6	0	0
9	38637879	.	A	C	2	4	6	0	0	6	0	0
9	38638197	.	C	T	6	5	11	0	1	12	0	0
9	38638452	.	A	T	5	4	9	0	0	9	0	0
9	38638461	.	C	G	6	5	11	0	0	11	0	0
9	38638492	.	A	G	5	0	5	0	9	14	0	0
9	38638518	.	T	C	12	8	20	0	0	20	0	0
9	38638743	.	T	C	10	5	15	0	1	16	0	0
9	38638862	.	C	T	2	3	5	0	0	5	0	0
9	38638863	.	C	A	2	3	5	0	0	5	0	0
9	38638970	.	G	A	5	8	13	0	0	13	0	0
9	38639799	.	T	C	2	6	8	0	1	9	0	0
9	38639846	.	C	T	3	6	9	0	0	9	0	0
9	38639907	.	A	C	9	8	17	0	0	17	0	0
9	38639999	.	C	T	4	9	13	0	2	15	0	0
9	38640114	.	T	A	4	5	9	0	0	9	0	0
9	38640186	.	T	C	9	7	16	0	0	16	0	0
9	38640193	.	T	C	8	7	15	0	0	15	0	0
9	38640598	.	A	G	4	0	4	0	4	8	0	0
9	38640773	.	A	T	4	2	6	0	0	6	0	0
9	38641111	.	C	T	3	4	7	0	0	7	0	0
9	38707417	.	T	C	1	2	3	0	0	3	0	0
9	40928199	.	T	C	6	5	11	0	1	12	0	0
9	40928245	.	T	C	13	5	18	0	1	19	0	0
9	40928284	.	T	C	12	0	12	0	5	17	0	0
9	40928706	.	T	C	3	6	9	0	0	9	0	0
9	40928720	.	T	C	5	6	11	0	0	11	0	0
9	40930319	.	T	C	1	4	5	0	1	6	0	0
9	41479972	.	A	G	2	2	4	0	1	5	0	0
9	41479978	.	A	G	5	2	7	0	0	7	0	0
9	41680441	.	A	G	22	7	29	0	4	33	0	0
9	41680581	.	A	G	27	10	37	0	0	37	0	0
9	42360743	.	C	G	4	5	9	0	2	11	0	0
9	42360893	.	C	T	1	6	7	0	7	14	0	0
9	42360899	.	G	A	7	6	13	0	0	13	0	0
9	42644892	.	A	G	12	0	12	0	11	23	0	0
9	42649583	.	A	G	4	4	8	0	0	8	0	0
9	42649636	.	T	A	2	4	6	0	0	6	0	0
9	42649653	.	T	C	2	4	6	0	1	7	0	0
9	42649739	.	C	T	7	4	11	0	0	11	0	0
9	42649743	.	A	G	7	4	11	0	0	11	0	0
9	42649923	.	A	G	5	4	9	0	0	9	0	0
9	42653475	.	A	T	1	2	3	0	0	3	0	0
9	42653737	.	T	C	2	3	5	0	0	5	0	0
9	42657418	.	A	T	3	4	7	0	0	7	0	0
9	42658401	.	G	C	2	3	5	0	0	6	1	0
9	42658788	.	A	G	2	2	4	0	0	4	0	0
9	42658818	.	T	C	2	0	2	0	5	7	0	0
9	43082373	.	A	T	2	5	7	0	0	7	0	0
9	43082398	.	A	G	3	6	9	0	0	9	0	0
9	43082519	.	C	A	0	2	2	0	2	4	0	0
9	43082541	.	A	C	3	1	4	0	0	4	0	0
9	43085471	.	G	C	4	2	6	0	1	7	0	0
9	43085527	.	A	T	5	5	10	0	0	10	0	0
9	43085728	.	A	C	3	2	5	0	0	5	0	0
9	43085879	.	C	T	8	3	11	0	0	11	0	0
9	43085949	.	A	C	4	2	6	0	0	6	0	0
9	43088884	.	G	A	1	2	3	0	0	3	0	0
9	43107296	.	C	T	0	2	2	0	3	5	0	0
9	43107318	.	A	T	2	2	4	0	0	4	0	0
9	43113730	.	A	G	1	2	3	0	0	3	0	0
9	43150018	.	T	A	8	4	12	0	3	15	0	0
9	43150278	.	T	G	14	12	26	0	1	27	0	0
9	43150604	.	A	G	14	20	34	3	1	38	0	0
9	43150817	.	C	T	0	15	15	0	16	31	0	0
9	43153287	.	C	T	16	11	27	0	1	28	0	0
9	43154841	.	C	T	10	11	21	0	0	21	0	0
9	43175527	.	C	T	2	14	16	0	7	23	0	0
9	43202097	.	T	C	6	0	6	0	7	13	0	0
9	43207727	.	G	A	6	8	14	0	0	14	0	0
9	43243265	.	A	C	6	5	11	0	0	11	0	0
9	43243266	.	T	C	6	5	11	0	0	11	0	0
9	43261951	.	T	A	5	4	9	0	1	10	0	0
9	43287748	.	G	A	3	4	7	0	0	7	0	0
9	43375122	.	G	A	3	3	6	0	0	6	0	0
9	43552604	.	C	A	2	5	7	0	0	7	0	0
9	43552687	.	A	C	11	3	14	4	1	19	0	0
9	43553036	.	G	T	9	13	22	0	3	25	0	0
9	43559501	.	A	C	6	9	15	0	0	15	0	0
9	43612482	.	T	G	2	3	5	0	0	5	0	0
9	43617899	.	A	G	3	6	9	0	1	10	0	0
9	43617962	.	A	G	9	10	19	0	1	20	0	0
9	43630057	.	C	T	0	3	3	0	4	7	0	0
9	44109589	.	T	C	6	0	6	0	3	9	0	0
9	44124323	.	C	T	3	3	6	0	0	6	0	0
9	44207771	.	G	A	2	2	4	0	0	4	0	0
9	44292285	.	A	C	24	0	24	0	26	50	0	0
9	44292737	.	T	C	30	24	54	0	3	57	0	0
9	44292909	.	C	T	2	33	35	0	18	53	0	0
9	44293488	.	C	T	24	22	46	0	3	49	0	0
9	44294792	.	A	G	14	8	22	0	0	22	0	0
9	44411647	.	A	G	6	5	11	0	2	13	0	0
9	44411652	.	C	A	8	4	12	0	0	12	0	0
9	44419652	.	T	A	7	6	13	0	1	14	0	0
9	44419793	.	C	A	3	2	5	0	0	5	0	0
9	44431117	.	G	A	10	3	13	0	1	14	0	0
9	44443998	.	T	C	19	13	32	0	0	32	0	0
9	44469318	.	A	G	19	0	19	0	24	43	0	0
9	44488578	.	T	A	7	6	13	0	1	14	0	0
9	44489843	.	G	A	1	4	5	0	3	8	0	0
9	44489844	.	T	A	3	4	7	0	1	8	0	0
9	44498332	.	T	C	4	15	19	0	1	20	0	0
9	44509181	.	G	A	9	7	16	0	1	17	0	0
9	44511218	.	C	T	5	6	11	0	0	11	0	0
9	44515937	.	G	A	1	7	8	0	0	8	0	0
9	44526546	.	G	A	2	8	10	0	1	11	0	0
9	44641974	.	A	T	2	5	7	0	0	7	0	0
9	44642017	.	G	A	2	7	9	0	0	9	0	0
9	44642057	.	T	C	2	0	2	0	11	13	0	0
9	45504485	.	A	G	6	3	9	0	0	9	0	0
9	45504819	.	A	G	2	0	2	0	6	8	0	0
9	45504888	.	G	A	0	8	8	0	2	10	0	0
9	45523190	.	G	A	5	5	10	0	0	10	0	0
9	45536096	.	A	G	1	3	4	0	0	4	0	0
9	45541036	.	C	A	3	3	6	0	0	6	0	0
9	45551273	.	T	C	15	14	29	1	3	33	0	0
9	45552338	.	T	G	9	11	20	0	0	20	0	0
9	45552364	.	G	A	0	6	6	0	5	11	0	0
9	45552386	.	C	G	8	14	22	0	1	23	0	0
9	45552567	.	G	A	4	16	20	0	23	43	0	0
9	45552715	.	C	T	14	13	27	0	1	28	0	0
9	45552806	.	G	A	2	14	16	0	15	31	0	0
9	45552881	.	T	C	9	22	31	0	0	31	0	0
9	45552924	.	C	A	9	11	20	0	1	21	0	0
9	45552957	.	C	T	13	17	30	0	0	30	0	0
9	45617551	.	T	C	1	2	3	0	1	4	0	0
9	45623346	.	C	T	7	4	11	0	1	12	0	0
9	45623446	.	A	G	3	4	7	0	0	7	0	0
9	45637002	.	C	G	1	0	1	0	2	3	0	0
9	45666600	.	G	A	4	4	8	0	0	8	0	0
9	45667103	.	C	T	2	2	4	0	0	4	0	0
9	45667473	.	C	T	1	3	4	0	0	4	0	0
9	45884711	.	G	A	3	5	8	0	0	8	0	0
9	45934065	.	A	G	2	4	6	0	0	6	0	0
9	45945935	.	A	C	7	5	12	0	0	12	0	0
9	45969254	.	C	T	1	5	6	0	2	8	0	0
9	45975846	.	C	T	0	5	5	0	2	7	0	0
9	45997103	.	G	A	7	5	12	0	0	12	0	0
9	46029344	.	G	A	3	7	10	0	0	10	0	0
9	46409361	.	G	C	1	2	3	0	0	3	0	0
9	46525673	.	A	G	1	3	4	0	1	5	0	0
9	46604056	.	T	C	1	3	4	0	0	4	0	0
9	46604068	.	A	G	1	0	1	0	3	4	0	0
9	46650764	.	T	C	1	5	6	0	0	6	0	0
9	46657128	.	T	C	5	3	8	0	0	8	0	0
9	46667831	.	A	T	2	2	4	0	0	4	0	0
9	46672436	.	G	A	1	2	3	0	1	4	0	0
9	46676385	.	C	T	3	8	11	0	0	11	0	0
9	46676393	.	C	G	2	8	10	0	0	10	0	0
9	46678159	.	A	C	4	2	6	0	1	7	0	0
9	46678196	.	C	T	5	4	9	0	0	9	0	0
9	46678255	.	T	C	3	8	11	0	0	11	0	0
9	46683760	.	C	A	3	4	7	0	0	7	0	0
9	46683861	.	A	C	10	5	15	0	0	15	0	0
9	46684000	.	A	C	4	3	7	0	0	7	0	0
9	46684175	.	C	A	3	3	6	0	0	6	0	0
9	46684191	.	G	T	1	3	4	0	0	4	0	0
9	46692261	.	T	G	15	19	34	0	1	35	0	0
9	46692890	.	T	C	1	3	4	0	0	4	0	0
9	46745653	.	A	G	1	8	9	0	0	9	0	0
9	46784333	.	G	A	3	2	5	0	0	5	0	0
9	46799102	.	T	C	4	4	8	0	0	8	0	0
9	46799264	.	T	C	2	1	3	0	0	3	0	0
9	46799280	.	T	A	3	2	5	0	0	5	0	0
9	46821853	.	G	A	3	8	11	0	0	11	0	0
9	46821855	.	G	T	3	8	11	0	0	11	0	0
9	46821905	.	A	G	5	8	13	0	0	13	0	0
9	46821916	.	A	T	6	6	12	0	1	13	0	0
9	46822002	.	T	C	8	4	12	3	1	16	0	0
9	46822120	.	C	T	2	3	5	0	10	15	0	0
9	46822144	.	T	C	9	5	14	0	0	14	0	0
9	46823198	.	C	T	10	13	23	0	2	25	0	0
9	46823325	.	G	A	10	12	22	0	2	24	0	0
9	46823366	.	T	C	12	6	18	1	1	20	0	0
9	46823524	.	A	G	11	11	22	0	1	23	0	0
9	46824110	.	A	G	9	9	18	0	1	19	0	0
9	46824160	.	T	A	6	5	11	0	1	12	0	0
9	46825094	.	A	T	5	8	13	0	0	13	0	0
9	46841787	.	C	G	3	2	5	0	0	5	0	0
9	47464728	.	A	G	4	2	6	0	0	6	0	0
9	47464731	.	C	T	0	2	2	0	4	6	0	0
9	47502415	.	G	A	2	2	4	0	0	4	0	0
9	48054753	.	G	A	21	28	49	0	3	52	0	0
9	48060592	.	G	C	23	19	42	0	3	45	0	0
9	48076973	.	C	T	13	20	33	0	1	34	0	0
9	48123109	.	C	G	2	2	4	0	0	4	0	0
9	48123142	.	G	A	4	5	9	0	0	9	0	0
9	48131814	.	A	T	1	7	8	0	1	9	0	0
9	48131865	.	G	A	2	3	5	0	0	5	0	0
9	48131883	.	A	G	2	2	4	0	0	4	0	0
9	48131956	.	G	A	4	3	7	0	1	8	0	0
9	48131997	.	C	T	1	7	8	0	4	12	0	0
9	48132029	.	T	C	5	1	6	0	8	14	0	0
9	48132037	.	T	A	4	9	13	0	1	14	0	0
9	48132095	.	A	C	3	12	15	0	0	15	0	0
9	48132156	.	A	C	4	6	10	0	0	10	0	0
9	48132176	.	C	T	4	5	9	0	1	10	0	0
9	48132194	.	G	T	3	5	8	0	1	9	0	0
9	48132309	.	G	T	3	4	7	0	1	8	0	0
9	48132336	.	C	T	2	9	11	0	4	15	0	0
9	48132439	.	G	A	4	4	8	0	0	8	0	0
9	48132441	.	A	G	4	4	8	0	0	8	0	0
9	48132531	.	G	A	4	6	10	0	0	10	0	0
9	48132592	.	G	T	6	8	14	0	0	14	0	0
9	48132865	.	A	C	2	3	5	0	0	5	0	0
9	48133013	.	T	C	3	2	5	0	1	6	0	0
9	48133105	.	G	T	4	8	12	0	1	13	0	0
9	48133541	.	T	C	3	5	8	0	1	9	0	0
9	48133687	.	A	G	3	3	6	0	0	6	0	0
9	48133900	.	G	T	4	6	10	0	0	10	0	0
9	48134012	.	T	A	4	6	10	0	1	11	0	0
9	48134201	.	A	T	5	3	8	0	0	8	0	0
9	48134568	.	G	A	3	5	8	0	5	13	0	0
9	48178424	.	C	T	0	2	2	0	2	4	0	0
9	48189403	.	C	G	0	4	4	0	1	5	0	0
9	48189411	.	T	C	2	5	7	0	0	7	0	0
9	48201122	.	A	G	1	2	3	0	0	3	0	0
9	48201127	.	G	A	1	2	3	0	0	3	0	0
9	48203875	.	G	A	1	3	4	0	1	5	0	0
9	48203896	.	A	G	1	3	4	0	0	4	0	0
9	48214157	.	T	A	1	4	5	0	0	5	0	0
9	48225854	.	G	A	5	2	7	0	0	7	0	0
9	48228950	.	T	C	3	2	5	0	0	5	0	0
9	48243390	.	C	T	3	3	6	0	0	6	0	0
9	48252433	.	C	T	2	3	5	0	0	5	0	0
9	48264034	.	C	T	1	4	5	0	0	5	0	0
9	48266227	.	A	G	2	0	2	0	1	3	0	0
9	48266242	.	C	G	1	2	3	0	0	3	0	0
9	48284901	.	T	C	10	6	16	0	0	16	0	0
9	48284917	.	C	A	0	7	7	0	10	17	0	0
9	48284972	.	T	C	7	12	19	1	0	20	0	0
9	48285019	.	G	A	5	6	11	1	0	12	0	0
9	48287441	.	G	A	10	7	17	0	2	19	0	0
9	48289758	.	G	A	8	6	14	0	0	14	0	0
9	48289797	.	A	T	7	5	12	0	0	12	0	0
9	48289961	.	A	G	5	2	7	0	2	9	0	0
9	48290030	.	A	G	1	6	7	0	0	7	0	0
9	48295210	.	G	A	7	2	9	0	0	9	0	0
9	48295211	.	T	G	7	2	9	0	0	9	0	0
9	48296346	.	C	T	1	4	5	0	4	9	0	0
9	48390858	.	G	T	4	3	7	0	0	7	0	0
9	48407342	.	C	T	1	3	4	0	0	4	0	0
9	48407365	.	T	G	2	3	5	0	0	5	0	0
9	48665654	.	G	A	1	3	4	0	0	4	0	0
9	48666890	.	A	G	4	2	6	0	1	7	0	0
9	48668834	.	C	G	4	6	10	0	0	10	0	0
9	48670316	.	C	T	3	2	5	0	0	5	0	0
9	48670747	.	T	G	5	0	5	0	3	8	0	0
9	48670748	.	T	C	5	3	8	0	0	8	0	0
9	48671052	.	A	G	2	2	4	0	0	4	0	0
9	48671167	.	A	C	2	3	5	0	0	5	0	0
9	48831028	.	A	T	2	2	4	0	0	4	0	0
9	48870578	.	T	C	12	0	12	0	11	23	0	0
9	48870593	.	A	T	11	11	22	0	1	23	0	0
9	48870627	.	T	A	13	6	19	0	0	19	0	0
9	48870680	.	A	G	10	3	13	0	0	13	0	0
9	48870886	.	C	T	13	7	20	0	1	21	0	0
9	48871080	.	G	C	3	6	9	0	2	11	0	0
9	48871966	.	T	G	9	4	13	4	1	18	0	0
9	48871996	.	A	T	9	6	15	5	0	20	0	0
9	48872615	.	A	G	9	2	11	0	1	12	0	0
9	48872620	.	C	T	8	2	10	0	1	11	0	0
9	48872688	.	A	T	2	3	5	0	1	6	0	0
9	48872694	.	A	G	3	3	6	0	1	7	0	0
9	48872890	.	C	A	5	4	9	0	0	9	0	0
9	48872924	.	A	G	5	9	14	0	0	14	0	0
9	48872926	.	C	T	1	7	8	0	6	14	0	0
9	48872960	.	A	G	8	1	9	0	2	11	0	0
9	48872988	.	T	A	1	3	4	0	0	4	0	0
9	48873302	.	T	C	3	3	6	0	0	6	0	0
9	48873371	.	A	G	3	5	8	0	0	8	0	0
9	48873522	.	C	G	10	5	15	0	1	16	0	0
9	48873831	.	A	C	3	0	3	0	2	5	0	0
9	48873853	.	G	A	0	2	2	0	2	4	0	0
9	48874305	.	G	C	1	3	4	0	0	4	0	0
9	48874562	.	G	A	8	3	11	0	0	11	0	0
9	48874577	.	G	A	6	3	9	0	1	10	0	0
9	48874728	.	T	C	4	2	6	1	0	7	0	0
9	48875171	.	C	T	2	2	4	0	0	4	0	0
9	48875208	.	C	G	2	5	7	0	0	7	0	0
9	48875218	.	G	T	6	2	8	0	0	8	0	0
9	48875510	.	T	C	4	3	7	0	1	8	0	0
9	48875516	.	G	A	3	2	5	0	1	6	0	0
9	48875595	.	A	C	4	3	7	0	0	7	0	0
9	48875598	.	T	A	4	3	7	0	0	7	0	0
9	48875674	.	A	G	1	5	6	0	0	6	0	0
9	48876007	.	T	C	0	0	0	0	7	7	0	0
9	48876017	.	C	T	2	4	6	0	0	6	0	0
9	48876349	.	T	A	1	2	3	0	0	3	0	0
9	48876544	.	C	T	5	5	10	0	0	10	0	0
9	48876587	.	A	G	3	7	10	0	0	10	0	0
9	48876798	.	C	T	0	3	3	0	2	5	0	0
9	48877129	.	T	C	1	0	1	1	5	7	0	0
9	48877132	.	G	A	3	3	6	1	0	7	0	0
9	48877348	.	A	G	1	3	4	0	0	4	0	0
9	50334706	.	A	T	1	3	4	0	0	4	0	0
9	50334717	.	A	T	1	2	3	0	0	3	0	0
9	50750917	.	A	G	1	3	4	0	0	4	0	0
9	51292956	.	A	G	26	10	36	0	1	37	0	0
9	51302422	.	A	G	18	16	34	0	2	36	0	0
9	51307238	.	T	C	14	12	26	0	2	28	0	0
9	51307387	.	G	T	11	10	21	0	0	21	0	0
9	51317030	.	T	C	15	0	15	0	13	28	0	0
9	51340645	.	A	G	5	6	11	1	2	14	0	0
9	51528055	.	G	A	1	2	3	0	0	3	0	0
9	51804640	.	A	C	6	3	9	0	0	9	0	0
9	51996280	.	T	A	9	4	13	0	0	13	0	0
9	51996281	.	G	A	9	4	13	0	0	13	0	0
9	51996444	.	T	G	14	12	26	0	1	27	0	0
9	51996868	.	T	A	3	3	6	0	0	6	0	0
9	51996974	.	C	T	4	6	10	0	1	11	0	0
9	51998495	.	A	C	6	1	7	0	2	9	0	0
9	51998648	.	C	T	5	6	11	0	0	11	0	0
9	51998784	.	T	G	9	4	13	0	0	13	0	0
9	51998841	.	G	T	8	7	15	0	0	15	0	0
9	51998866	.	A	T	6	7	13	0	0	13	0	0
9	51998927	.	A	G	3	2	5	1	0	6	0	0
9	51999842	.	C	G	5	2	7	0	0	7	0	0
9	51999855	.	T	G	4	2	6	0	0	6	0	0
9	51999885	.	C	T	3	5	8	0	0	8	0	0
9	51999924	.	T	A	4	5	9	0	2	11	0	0
9	52000032	.	C	T	0	4	4	0	5	9	0	0
9	52000127	.	C	G	2	6	8	0	1	9	0	0
9	52000139	.	G	A	2	7	9	0	0	9	0	0
9	52000164	.	G	A	3	4	7	0	0	7	0	0
9	52000248	.	T	A	7	3	10	0	1	11	0	0
9	52000293	.	T	C	8	0	8	0	5	13	0	0
9	52000335	.	A	T	10	3	13	0	1	14	0	0
9	52000827	.	T	A	2	6	8	0	0	8	0	0
9	52000869	.	G	C	5	0	5	0	5	10	0	0
9	52021296	.	T	C	4	3	7	0	0	7	0	0
9	52037940	.	G	T	5	4	9	0	0	9	0	0
9	52378529	.	A	G	7	2	9	0	0	9	0	0
9	52378682	.	C	T	18	5	23	0	0	23	0	0
9	52378697	.	A	G	16	10	26	0	1	27	0	0
9	52378832	.	T	A	20	12	32	1	0	34	1	0
9	52428661	.	A	G	1	0	1	0	2	3	0	0
9	52433132	.	T	C	1	2	3	0	0	3	0	0
9	52433174	.	A	C	3	4	7	0	0	7	0	0
9	52435028	.	T	C	2	2	4	0	0	4	0	0
9	52435100	.	G	A	5	2	7	0	0	7	0	0
9	52435112	.	C	T	5	2	7	0	0	7	0	0
9	52439166	.	G	A	1	3	4	0	0	4	0	0
9	52439171	.	C	A	1	3	4	0	1	5	0	0
9	52479822	.	C	G	1	6	7	0	0	7	0	0
9	52479901	.	C	T	3	2	5	0	1	6	0	0
9	52490015	.	A	G	1	2	3	0	0	3	0	0
9	52492641	.	A	C	8	4	12	0	0	12	0	0
9	52492688	.	C	G	14	0	14	0	10	24	0	0
9	52492705	.	A	G	5	19	24	0	2	26	0	0
9	52493059	.	A	T	12	3	15	0	0	15	0	0
9	52493231	.	A	T	4	14	18	0	1	19	0	0
9	52493406	.	C	T	11	3	14	0	1	15	0	0
9	52532370	.	C	G	13	7	20	0	0	20	0	0
9	52539290	.	G	A	2	6	8	0	17	25	0	0
9	52539453	.	C	T	9	24	33	0	1	34	0	0
9	52539629	.	C	T	15	9	24	0	3	27	0	0
9	52564578	.	T	C	6	0	6	0	5	11	0	0
9	52564622	.	T	C	4	3	7	0	1	8	0	0
9	52572555	.	C	T	6	2	8	0	1	9	0	0
9	52572573	.	G	A	5	3	8	0	2	10	0	0
9	52572609	.	C	G	5	3	8	0	0	8	0	0
9	52574737	.	C	G	3	2	5	0	0	5	0	0
9	52595710	.	C	T	2	1	3	0	1	4	0	0
9	52608615	.	G	T	2	2	4	0	0	4	0	0
9	52629113	.	C	T	2	18	20	0	1	21	0	0
9	52629155	.	T	C	5	7	12	0	2	14	0	0
9	52631620	.	G	A	6	5	11	0	1	12	0	0
9	52633151	.	C	T	7	4	11	0	0	11	0	0
9	52633184	.	C	G	7	4	11	0	0	11	0	0
9	52642012	.	G	A	9	3	12	0	1	13	0	0
9	52645687	.	C	T	0	8	8	0	6	14	0	0
9	52649704	.	C	T	0	4	4	0	3	7	0	0
9	52651985	.	T	C	3	3	6	0	0	6	0	0
9	52652015	.	A	G	4	2	6	0	0	6	0	0
9	53276550	.	A	C	7	9	16	0	0	16	0	0
9	53276681	.	G	A	0	3	3	0	5	8	0	0
9	53276976	.	C	T	5	7	12	0	0	12	0	0
9	53276978	.	A	G	7	5	12	0	1	13	0	0
9	53277068	.	C	G	7	0	7	0	5	12	0	0
9	53277131	.	A	T	12	8	20	0	0	20	0	0
9	53277453	.	G	A	0	7	7	0	8	15	0	0
9	53277493	.	A	T	8	7	15	0	0	15	0	0
9	53707638	.	G	C	0	4	4	0	5	9	0	0
9	53707653	.	A	T	4	6	10	0	1	11	0	0
9	53707761	.	A	G	3	4	7	0	1	8	0	0
9	53707995	.	C	T	2	4	6	0	0	6	0	0
9	53708037	.	G	A	2	2	4	0	0	4	0	0
9	53708055	.	T	C	4	3	7	0	0	7	0	0
9	53709003	.	C	T	6	6	12	0	0	12	0	0
9	53709184	.	T	C	4	9	13	0	2	15	0	0
9	53709365	.	C	T	4	4	8	0	0	8	0	0
9	53715525	.	G	A	9	4	13	0	2	15	0	0
9	53719342	.	T	C	5	10	15	0	1	16	0	0
9	53843404	.	C	T	9	15	24	0	0	24	0	0
9	53843590	.	A	T	6	7	13	0	2	15	0	0
9	53843737	.	T	C	5	0	5	0	3	8	0	0
9	53843813	.	G	A	7	5	12	0	0	12	0	0
9	53844188	.	T	C	6	1	7	0	5	12	0	0
9	53845537	.	A	G	5	12	17	0	1	18	0	0
9	53849389	.	T	C	7	0	7	0	11	18	0	0
9	53849440	.	G	A	8	7	15	0	0	15	0	0
9	53851676	.	C	T	9	7	16	0	1	17	0	0
9	53864227	.	A	C	2	2	4	0	1	6	1	0
9	53867508	.	A	G	3	3	6	0	0	6	0	0
9	53867511	.	A	G	3	3	6	0	0	6	0	0
9	53869247	.	G	A	4	4	8	0	0	8	0	0
9	53869344	.	T	C	5	3	8	0	0	8	0	0
9	53890327	.	C	A	2	3	5	0	0	5	0	0
9	53890345	.	G	T	2	2	4	0	0	4	0	0
9	53909815	.	C	A	0	2	2	0	4	6	0	0
9	53914095	.	C	G	0	2	2	0	1	3	0	0
9	54112469	.	T	C	3	9	12	0	0	12	0	0
9	54112526	.	T	A	6	6	12	0	0	12	0	0
9	54112571	.	A	G	3	4	7	0	0	7	0	0
9	54112779	.	G	T	2	3	5	0	1	6	0	0
9	54112781	.	G	A	0	3	3	0	3	6	0	0
9	54113324	.	C	T	1	5	6	0	1	7	0	0
9	54113954	.	C	T	4	8	12	0	0	12	0	0
9	54114050	.	A	G	3	0	3	0	6	9	0	0
9	54114242	.	T	G	5	0	5	0	7	12	0	0
9	54239528	.	T	C	5	2	7	0	1	8	0	0
9	54245010	.	T	A	4	4	8	0	0	8	0	0
9	54247334	.	A	G	3	3	6	0	0	6	0	0
9	54247336	.	T	C	3	3	6	0	0	6	0	0
9	54255362	.	C	G	5	2	7	0	0	7	0	0
9	54256221	.	C	G	2	2	4	0	1	5	0	0
9	54261104	.	G	A	0	2	2	0	4	6	0	0
9	54264236	.	T	C	7	5	12	0	0	12	0	0
9	54264245	.	T	C	6	5	11	0	0	11	0	0
9	54264272	.	C	T	6	5	11	0	1	12	0	0
9	54264299	.	C	A	6	4	10	0	0	10	0	0
9	54270324	.	C	T	4	3	7	0	1	8	0	0
9	54270348	.	T	A	4	5	9	0	1	10	0	0
9	54273797	.	C	T	7	5	12	0	0	12	0	0
9	54315617	.	T	G	2	3	5	0	0	5	0	0
9	54329644	.	T	C	1	4	5	0	0	5	0	0
9	54331562	.	G	A	3	5	8	0	0	8	0	0
9	54331768	.	G	A	6	3	9	0	1	10	0	0
9	54335139	.	A	G	2	3	5	0	0	5	0	0
9	54335197	.	C	T	3	3	6	0	0	6	0	0
9	54336738	.	A	G	1	3	4	0	0	4	0	0
9	54340140	.	C	T	1	2	3	0	0	3	0	0
9	54347521	.	T	C	1	3	4	0	0	4	0	0
9	54349735	.	G	C	1	2	3	0	0	3	0	0
9	54351604	.	T	C	1	0	1	0	3	4	0	0
9	54351610	.	C	T	2	2	4	0	0	4	0	0
9	54418577	.	G	T	0	2	2	0	1	3	0	0
9	54418687	.	T	C	1	1	2	0	1	3	0	0
9	54418906	.	T	A	2	4	6	0	0	6	0	0
9	54671597	.	A	G	1	2	3	0	0	3	0	0
9	54679277	.	T	C	1	2	3	0	0	3	0	0
9	54711020	.	G	T	13	7	20	0	0	20	0	0
9	54712704	.	A	G	18	10	28	0	0	28	0	0
9	54712745	.	T	C	12	21	33	0	3	36	0	0
9	54712751	.	C	T	9	21	30	0	3	33	0	0
9	54712917	.	A	T	8	15	23	0	2	25	0	0
9	54712945	.	G	A	12	14	26	0	3	29	0	0
9	54712985	.	A	C	13	13	26	0	2	28	0	0
9	54715157	.	T	C	9	7	16	0	0	16	0	0
9	54716349	.	G	A	10	7	17	0	0	17	0	0
9	54722532	.	T	G	2	0	2	0	2	4	0	0
9	54722553	.	T	C	2	2	4	0	0	4	0	0
9	54723323	.	G	A	1	4	5	0	0	5	0	0
9	54728780	.	A	G	1	2	3	0	0	3	0	0
9	54730650	.	G	C	2	3	5	0	0	5	0	0
9	54738987	.	C	T	3	6	9	0	0	9	0	0
9	54739015	.	A	T	4	3	7	0	0	7	0	0
9	54739181	.	C	G	2	3	5	0	0	5	0	0
9	54739182	.	C	A	2	2	4	0	1	5	0	0
9	54739605	.	C	A	5	2	7	0	1	8	0	0
9	54763880	.	C	A	3	3	6	0	0	6	0	0
9	54764102	.	C	T	2	2	4	0	0	4	0	0
9	54764143	.	G	A	4	3	7	0	0	7	0	0
9	54764349	.	G	A	6	3	9	0	0	9	0	0
9	54769705	.	T	C	6	0	6	0	4	10	0	0
9	54770768	.	G	A	1	2	3	0	0	3	0	0
9	54776055	.	T	C	1	0	1	0	2	3	0	0
9	54776075	.	G	A	1	2	3	0	1	4	0	0
9	55382620	.	G	C	0	2	2	0	1	3	0	0
9	55382662	.	A	G	0	0	0	0	3	3	0	0
9	55413395	.	C	A	2	2	4	0	0	4	0	0
9	55413485	.	C	A	4	3	7	0	0	7	0	0
9	55413677	.	C	T	2	2	4	0	0	4	0	0
9	55417638	.	G	A	1	3	4	0	2	6	0	0
9	55417665	.	A	G	1	0	1	0	4	5	0	0
9	55418025	.	G	A	1	4	5	0	9	14	0	0
9	55418067	.	C	T	3	7	10	0	1	11	0	0
9	55418095	.	A	G	6	3	9	0	0	9	0	0
9	55666354	.	A	T	1	2	3	0	0	3	0	0
9	55736311	.	G	A	1	6	7	0	0	7	0	0
9	55748586	.	T	C	7	3	10	0	0	10	0	0
9	55748631	.	T	C	4	0	4	0	5	9	0	0
9	55748855	.	C	A	3	6	9	0	1	10	0	0
9	55748983	.	G	A	5	5	10	0	0	10	0	0
9	55749040	.	A	G	3	4	7	0	0	7	0	0
9	55749083	.	T	C	1	0	1	0	8	9	0	0
9	55749151	.	T	C	3	0	3	0	4	7	0	0
9	55749369	.	C	G	3	3	6	0	0	6	0	0
9	55750092	.	G	T	0	2	2	0	1	3	0	0
9	55750151	.	C	T	5	2	7	0	1	8	0	0
9	55750255	.	C	G	1	4	5	0	4	9	0	0
9	55750306	.	C	T	5	7	12	0	0	12	0	0
9	55750357	.	A	C	5	0	5	0	4	9	0	0
9	55750367	.	G	A	6	2	8	0	0	8	0	0
9	55750649	.	G	C	4	4	8	0	0	8	0	0
9	55750792	.	C	T	2	8	10	0	8	18	0	0
9	55756519	.	A	T	2	3	5	0	1	6	0	0
9	55756582	.	T	A	4	2	6	0	0	6	0	0
9	55771721	.	G	C	3	2	5	0	1	6	0	0
9	55771841	.	C	T	3	3	6	0	0	6	0	0
9	55784001	.	C	T	1	2	3	0	4	7	0	0
9	55784148	.	C	T	2	4	6	0	1	7	0	0
9	55784256	.	G	T	2	4	6	0	0	6	0	0
9	55790393	.	A	G	3	2	5	1	0	6	0	0
9	55870475	.	G	A	1	2	3	7	0	10	0	0
9	55870562	.	C	A	5	6	11	0	1	12	0	0
9	55874434	.	T	A	0	6	6	0	0	6	0	0
9	55874548	.	A	T	6	4	10	0	0	10	0	0
9	55874753	.	T	G	2	4	6	0	0	6	0	0
9	55874973	.	C	A	2	2	4	0	0	4	0	0
9	56205024	.	A	G	1	0	1	0	2	3	0	0
9	56225580	.	A	G	12	0	12	0	4	16	0	0
9	56225591	.	C	T	5	9	14	0	0	14	0	0
9	56225620	.	C	T	8	11	19	0	0	19	0	0
9	56225740	.	T	A	5	12	17	0	1	18	0	0
9	56230655	.	A	G	35	39	74	0	2	76	0	0
9	56230676	.	G	T	35	36	71	0	3	74	0	0
9	56231322	.	T	C	31	41	72	1	3	76	0	0
9	56231325	.	A	G	31	40	71	1	5	77	0	0
9	56232588	.	C	G	5	4	9	0	0	9	0	0
9	56232646	.	C	A	3	4	7	0	0	7	0	0
9	56235538	.	C	T	5	6	11	0	0	11	0	0
9	56237727	.	T	C	4	5	9	0	0	9	0	0
9	56237883	.	T	C	13	6	19	0	0	19	0	0
9	56244635	.	G	T	1	9	10	3	1	14	0	0
9	56350968	.	C	T	0	5	5	0	3	8	0	0
9	56351059	.	C	T	6	9	15	0	1	16	0	0
9	56353479	.	G	A	9	13	22	0	0	22	0	0
9	56363292	.	T	A	6	11	17	0	0	17	0	0
9	56369168	.	G	T	10	10	20	0	0	20	0	0
9	56369252	.	G	A	10	8	18	0	0	18	0	0
9	56369319	.	C	A	8	11	19	0	0	19	0	0
9	56389303	.	A	G	4	6	10	0	1	11	0	0
9	56456064	.	C	T	1	7	8	0	0	8	0	0
9	56456065	.	G	C	0	7	7	0	1	8	0	0
9	56457107	.	C	T	1	4	5	0	0	5	0	0
9	56457309	.	A	T	13	6	19	0	1	20	0	0
