contig	position	variantID	refAllele	altAllele	refCount	altCount	totalCount	lowMAPQDepth	lowBaseQDepth	rawDepth	otherBases	improperPairs
1	6698	.	G	A	26	21	47	0	5	52	0	0
1	10093	.	C	T	48	25	73	2	3	78	0	0
1	14083	.	G	A	0	7	7	0	4	11	0	0
1	15050	.	G	A	0	5	5	0	5	10	0	0
1	15772	.	G	A	1	5	6	0	16	22	0	0
1	16072	.	C	T	6	5	11	0	0	11	0	0
1	20199	.	C	G	3	0	3	0	6	9	0	0
1	20714	.	C	T	1	2	3	0	0	3	0	0
1	32450	.	T	C	11	16	27	0	0	27	0	0
1	33036	.	C	T	19	7	26	0	0	26	0	0
1	34268	.	T	G	7	3	10	0	0	10	0	0
1	34271	.	T	G	6	2	8	0	0	8	0	0
1	38106	.	C	T	10	21	31	0	1	32	0	0
1	38814	.	G	A	3	19	22	0	16	38	0	0
1	39620	.	C	A	1	5	6	0	5	11	0	0
1	39621	.	G	C	5	4	9	0	1	10	0	0
1	39717	.	T	G	10	11	21	0	0	21	0	0
1	40409	.	T	C	2	6	8	0	0	8	0	0
1	41287	.	C	T	0	3	3	0	3	6	0	0
1	118893	.	C	T	1	2	3	0	0	3	0	0
1	118909	.	A	T	1	3	4	0	0	4	0	0
1	141737	.	G	A	1	3	4	0	0	4	0	0
1	153527	.	A	G	4	7	11	0	1	12	0	0
1	154104	.	G	C	1	5	6	0	1	7	0	0
1	154113	.	G	A	3	4	7	0	0	7	0	0
1	154140	.	C	A	0	4	4	0	1	5	0	0
1	161210	.	C	T	4	2	6	0	0	6	0	0
1	176774	.	C	T	2	3	5	0	1	6	0	0
1	181717	.	T	C	18	7	25	0	2	27	0	0
1	181754	.	C	T	11	18	29	0	2	31	0	0
1	181763	.	A	G	12	18	30	0	1	31	0	0
1	185010	.	A	G	4	3	7	0	0	7	0	0
1	185057	.	G	A	7	4	11	0	0	11	0	0
1	185126	.	G	A	6	2	8	0	0	8	0	0
1	185191	.	C	T	3	2	5	0	1	6	0	0
1	186389	.	C	T	4	4	8	0	0	8	0	0
1	186864	.	G	A	3	5	8	0	1	9	0	0
1	189782	.	A	G	1	8	9	0	0	9	0	0
1	191914	.	C	G	7	3	10	0	0	10	0	0
1	208262	.	G	A	14	5	19	0	0	19	0	0
1	208265	.	G	A	15	4	19	0	1	20	0	0
1	208564	.	T	C	6	9	15	0	3	18	0	0
1	208570	.	T	C	6	12	18	0	1	19	0	0
1	209113	.	T	C	3	5	8	0	2	10	0	0
1	209147	.	T	C	11	9	20	0	0	20	0	0
1	212162	.	G	A	2	5	7	0	1	8	0	0
1	213203	.	G	C	15	0	15	0	5	20	0	0
1	223511	.	T	C	2	5	7	0	1	8	0	0
1	225044	.	G	A	0	6	6	0	7	13	0	0
1	225083	.	C	T	5	7	12	0	1	13	0	0
1	442456	.	T	C	4	2	6	2	0	8	0	0
1	474171	.	G	T	0	4	4	1	0	5	0	0
1	474321	.	A	G	4	8	12	0	1	13	0	0
1	474465	.	C	T	15	6	21	0	4	25	0	0
1	474473	.	A	G	14	9	23	0	1	24	0	0
1	476034	.	G	A	7	5	12	0	1	13	0	0
1	477046	.	G	A	12	5	17	0	0	17	0	0
1	477070	.	C	T	2	4	6	0	8	14	0	0
1	477109	.	C	T	1	6	7	0	3	10	0	0
1	477817	.	C	T	8	2	10	0	0	10	0	0
1	477823	.	G	C	8	2	10	0	0	10	0	0
1	477951	.	C	T	6	8	14	0	0	14	0	0
1	479986	.	A	G	2	5	7	0	0	7	0	0
1	483820	.	T	A	2	5	7	0	0	7	0	0
1	483821	.	C	T	2	5	7	0	0	7	0	0
1	484094	.	G	A	5	3	8	0	0	8	0	0
1	484590	.	C	T	1	3	4	0	0	4	0	0
1	492141	.	T	C	1	5	6	0	0	6	0	0
1	494246	.	A	T	1	5	6	0	0	6	0	0
1	496303	.	A	G	2	5	7	0	0	7	0	0
1	496305	.	A	C	2	5	7	0	0	7	0	0
1	496760	.	A	G	3	0	3	0	4	7	0	0
1	501303	.	G	A	1	3	4	0	3	7	0	0
1	501381	.	T	A	3	3	6	0	0	6	0	0
1	502079	.	C	A	3	8	11	0	1	12	0	0
1	503900	.	C	T	7	4	11	0	1	12	0	0
1	504527	.	G	A	1	2	3	0	1	4	0	0
1	504535	.	A	G	2	3	5	0	0	5	0	0
1	504637	.	A	T	7	2	9	0	2	11	0	0
1	504663	.	C	G	8	7	15	0	0	15	0	0
1	504912	.	C	A	4	3	7	0	1	8	0	0
1	505178	.	G	A	6	7	13	0	0	13	0	0
1	505260	.	A	G	11	0	11	0	4	15	0	0
1	505298	.	C	T	17	5	22	0	0	22	0	0
1	505403	.	G	A	17	9	26	0	0	26	0	0
1	505499	.	C	G	2	9	11	0	1	12	0	0
1	509222	.	T	G	4	5	9	0	0	9	0	0
1	509387	.	A	G	4	5	9	0	0	9	0	0
1	509718	.	T	A	4	3	7	0	1	8	0	0
1	509769	.	G	T	5	7	12	0	0	12	0	0
1	511957	.	G	A	1	2	3	0	2	5	0	0
1	514114	.	G	A	0	3	3	0	5	8	0	0
1	514202	.	C	T	4	2	6	0	1	7	0	0
1	515549	.	G	A	5	5	10	0	0	10	0	0
1	515575	.	G	C	3	5	8	0	0	8	0	0
1	517515	.	C	T	11	13	24	0	1	25	0	0
1	517674	.	T	G	5	3	8	0	1	9	0	0
1	517675	.	C	T	5	3	8	0	0	8	0	0
1	517733	.	C	T	6	2	8	0	0	8	0	0
1	524806	.	G	A	8	7	15	0	2	17	0	0
1	524828	.	C	T	9	6	15	0	1	16	0	0
1	528522	.	G	A	0	14	14	0	16	30	0	0
1	528552	.	A	C	21	12	33	0	1	34	0	0
1	530497	.	T	A	7	10	17	0	0	17	0	0
1	530502	.	G	A	3	3	6	0	0	6	0	0
1	552881	.	C	G	0	2	2	0	1	3	0	0
1	586161	.	G	A	0	3	3	0	3	6	0	0
1	586165	.	C	T	3	3	6	0	0	6	0	0
1	586765	.	C	T	5	4	9	0	0	9	0	0
1	587200	.	G	T	5	8	13	0	0	14	1	0
1	588530	.	G	T	12	14	26	0	1	27	0	0
1	589044	.	A	T	14	13	27	0	2	29	0	0
1	589056	.	C	T	15	12	27	0	2	29	0	0
1	589115	.	G	A	1	11	12	0	16	28	0	0
1	603292	.	A	G	1	3	4	0	2	6	0	0
1	606128	.	A	C	3	8	11	0	0	11	0	0
1	610451	.	C	G	1	5	6	0	0	6	0	0
1	610491	.	T	G	1	5	6	0	0	6	0	0
1	610606	.	C	T	3	4	7	0	1	8	0	0
1	610722	.	T	C	13	22	35	0	1	36	0	0
1	611267	.	T	C	36	23	59	0	3	62	0	0
1	614568	.	C	G	0	16	16	0	16	32	0	0
1	617950	.	C	T	4	36	40	0	28	68	0	0
1	618190	.	A	C	39	1	40	0	24	64	0	0
1	618210	.	G	A	23	37	60	0	3	63	0	0
1	618277	.	A	G	23	35	58	0	2	60	0	0
1	618434	.	C	T	37	28	65	0	4	69	0	0
1	618760	.	C	T	2	8	10	0	9	19	0	0
1	618776	.	C	A	10	9	19	0	0	19	0	0
1	618826	.	C	T	22	9	31	0	1	32	0	0
1	618918	.	A	T	12	43	55	0	1	56	0	0
1	618932	.	A	G	13	42	55	0	3	58	0	0
1	619679	.	T	A	8	3	11	0	1	12	0	0
1	619703	.	C	T	0	7	7	0	5	12	0	0
1	619764	.	C	T	21	5	26	0	1	27	0	0
1	620244	.	A	T	32	17	49	0	6	55	0	0
1	620314	.	G	A	29	14	43	0	0	43	0	0
1	620516	.	A	T	19	31	50	0	1	51	0	0
1	620517	.	T	G	20	30	50	0	1	51	0	0
1	621027	.	C	T	2	7	9	0	7	16	0	0
1	621063	.	T	A	4	5	9	0	2	11	0	0
1	621069	.	G	A	5	5	10	0	1	11	0	0
1	621102	.	A	T	6	8	14	0	2	16	0	0
1	621141	.	T	A	6	9	15	1	0	16	0	0
1	621283	.	C	T	2	8	10	0	6	16	0	0
1	621336	.	G	A	9	11	20	0	1	21	0	0
1	621389	.	C	T	12	13	25	0	3	28	0	0
1	621440	.	C	T	14	18	32	0	2	34	0	0
1	626601	.	G	A	8	6	14	0	1	15	0	0
1	629610	.	G	A	2	8	10	0	0	10	0	0
1	629619	.	A	G	3	9	12	0	0	12	0	0
1	634933	.	T	C	2	1	3	0	1	5	1	0
1	638431	.	C	T	0	4	4	0	1	5	0	0
1	659130	.	G	A	1	4	5	0	0	5	0	0
1	659476	.	G	T	2	2	4	0	0	4	0	0
1	5276189	.	G	A	3	2	5	0	0	5	0	0
1	5276257	.	T	C	5	4	9	0	0	9	0	0
1	5276343	.	G	A	5	5	10	0	0	10	0	0
1	5276982	.	A	G	8	0	8	0	3	11	0	0
1	5354765	.	C	A	16	24	40	0	1	41	0	0
1	5354768	.	A	G	16	25	41	0	1	42	0	0
1	5354929	.	T	C	17	22	39	0	2	41	0	0
1	5355024	.	G	T	32	13	45	0	0	45	0	0
1	5355334	.	G	A	25	26	51	0	4	55	0	0
1	5355435	.	C	T	5	14	19	3	34	56	0	0
1	5355514	.	G	A	34	23	57	0	2	59	0	0
1	5355707	.	T	A	33	21	54	1	0	56	1	0
1	5355804	.	C	T	3	22	25	0	27	52	0	0
1	5356001	.	C	A	16	18	34	0	2	36	0	0
1	5356002	.	A	C	17	0	17	0	19	36	0	0
1	5356075	.	A	T	9	15	24	0	2	26	0	0
1	5356087	.	C	T	11	19	30	1	0	31	0	0
1	5356268	.	T	G	13	7	20	5	1	26	0	0
1	5356455	.	T	G	17	7	24	0	1	25	0	0
1	5356497	.	C	A	17	4	21	0	2	23	0	0
1	5356499	.	G	T	17	6	23	0	0	23	0	0
1	5356667	.	A	T	9	7	16	0	1	17	0	0
1	5356681	.	T	C	10	1	11	0	8	19	0	0
1	5356837	.	A	G	22	7	29	1	1	31	0	0
1	5357053	.	T	C	6	5	11	0	2	13	0	0
1	5357059	.	T	C	11	3	14	0	0	14	0	0
1	5357405	.	T	C	3	10	13	1	0	14	0	0
1	5357528	.	C	G	9	10	19	0	0	19	0	0
1	5357541	.	T	C	6	9	15	0	4	19	0	0
1	5357653	.	T	A	7	2	9	0	0	9	0	0
1	5357742	.	C	A	6	9	15	0	1	16	0	0
1	5357772	.	C	G	7	8	15	0	1	16	0	0
1	5357845	.	C	A	14	11	25	1	0	26	0	0
1	5358005	.	C	T	8	2	10	0	1	11	0	0
1	5358034	.	C	T	0	2	2	0	7	10	1	0
1	5358265	.	C	T	2	9	11	0	7	18	0	0
1	5358792	.	C	A	6	8	14	0	1	15	0	0
1	5365350	.	G	A	6	5	11	0	0	11	0	0
1	5365368	.	C	T	4	6	10	0	1	11	0	0
1	5375285	.	C	T	6	3	9	0	0	9	0	0
1	5378957	.	T	G	2	2	4	0	0	4	0	0
1	5402605	.	T	A	4	3	7	0	2	9	0	0
1	5414327	.	C	T	3	4	7	0	1	8	0	0
1	5415859	.	T	C	7	4	11	0	0	11	0	0
1	5415970	.	C	G	5	4	9	0	0	9	0	0
1	5418692	.	C	T	18	11	29	0	0	29	0	0
1	5418971	.	A	T	26	15	41	0	1	42	0	0
1	5419043	.	G	T	5	4	9	0	0	9	0	0
1	5425428	.	G	C	2	3	5	0	0	5	0	0
1	5433554	.	C	T	2	6	8	0	1	9	0	0
1	5433709	.	C	T	3	3	6	0	0	6	0	0
1	5433712	.	T	C	3	3	6	0	0	6	0	0
1	5433890	.	T	C	3	2	5	0	1	6	0	0
1	5503722	.	G	T	4	2	6	0	2	8	0	0
1	5503778	.	T	G	2	5	7	0	0	7	0	0
1	5503809	.	T	C	2	3	5	0	1	6	0	0
1	5503828	.	T	C	3	3	6	0	0	6	0	0
1	5503882	.	G	A	2	4	6	0	0	6	0	0
1	5503898	.	C	A	2	4	6	0	0	6	0	0
1	5504032	.	C	G	1	3	4	0	0	4	0	0
1	5504064	.	A	T	1	2	3	0	1	4	0	0
1	5504072	.	A	T	2	1	3	0	1	4	0	0
1	5504215	.	G	T	1	2	3	0	0	3	0	0
1	5504733	.	A	C	1	2	3	0	0	3	0	0
1	5504792	.	C	A	1	2	3	0	0	3	0	0
1	5504793	.	T	C	1	2	3	0	0	3	0	0
1	5606790	.	C	A	17	12	29	0	2	31	0	0
1	5607137	.	G	T	7	4	11	0	1	12	0	0
1	5607181	.	A	G	4	8	12	0	0	12	0	0
1	5607597	.	G	A	9	4	13	0	0	14	1	0
1	5607668	.	T	C	11	7	18	0	2	20	0	0
1	5607914	.	G	T	6	6	12	0	0	12	0	0
1	5607929	.	C	A	5	5	10	0	0	10	0	0
1	5608215	.	G	T	8	4	12	0	1	13	0	0
1	5632031	.	A	G	3	2	5	0	0	5	0	0
1	6153451	.	G	A	2	2	4	0	0	4	0	0
1	6158557	.	T	G	2	2	4	0	0	4	0	0
1	6165318	.	A	C	1	3	4	0	0	4	0	0
1	6167421	.	A	G	1	0	1	0	5	6	0	0
1	6168346	.	T	A	4	5	9	0	0	9	0	0
1	6168411	.	G	C	6	4	10	0	0	10	0	0
1	6168417	.	G	T	0	5	5	0	6	11	0	0
1	6168568	.	C	G	3	3	6	0	0	6	0	0
1	6168858	.	A	G	10	0	10	0	6	17	1	0
1	6168875	.	G	A	10	6	16	1	1	18	0	0
1	6168925	.	T	C	11	3	14	1	1	16	0	0
1	6169155	.	C	T	5	2	7	0	0	7	0	0
1	6169208	.	C	T	9	5	14	0	0	14	0	0
1	6169232	.	T	C	8	4	12	0	0	12	0	0
1	6169317	.	C	T	11	8	19	0	0	19	0	0
1	6169378	.	C	T	10	13	23	0	0	23	0	0
1	6169387	.	G	C	11	18	29	0	0	29	0	0
1	6169462	.	T	C	15	12	27	0	2	29	0	0
1	6169494	.	A	G	9	0	9	0	11	20	0	0
1	6169542	.	T	C	4	5	9	0	1	10	0	0
1	6169688	.	A	T	8	4	12	0	1	13	0	0
1	6169691	.	C	T	7	4	11	0	1	12	0	0
1	6169765	.	C	T	2	3	5	0	1	6	0	0
1	6176813	.	C	T	5	2	7	0	0	7	0	0
1	6185218	.	A	G	17	8	25	0	0	25	0	0
1	6185236	.	T	G	10	7	17	0	0	18	1	0
1	6185259	.	T	G	12	11	23	0	1	24	0	0
1	6185280	.	T	A	14	10	24	0	1	25	0	0
1	6185320	.	T	A	14	8	22	0	3	25	0	0
1	6185326	.	A	C	18	5	23	0	0	23	0	0
1	6185411	.	C	T	9	4	13	0	0	13	0	0
1	6185461	.	C	T	2	4	6	0	1	7	0	0
1	6190003	.	A	G	1	4	5	0	0	5	0	0
1	6201976	.	C	T	2	2	4	0	0	4	0	0
1	6209662	.	T	G	3	2	5	0	0	5	0	0
1	6209743	.	A	T	1	3	4	0	0	4	0	0
1	6209746	.	G	A	1	4	5	0	1	6	0	0
1	6210190	.	T	G	1	0	1	0	4	5	0	0
1	6210243	.	T	C	3	4	7	0	0	7	0	0
1	6226375	.	C	A	1	3	4	0	0	4	0	0
1	6236899	.	T	C	1	2	3	0	0	3	0	0
1	6238639	.	C	T	4	2	6	0	0	6	0	0
1	6240444	.	T	G	4	3	7	0	1	8	0	0
1	6240474	.	A	C	4	2	6	0	0	6	0	0
1	6241379	.	G	T	1	7	8	0	6	14	0	0
1	6243549	.	A	G	7	0	7	0	8	15	0	0
1	6243975	.	T	G	1	2	3	0	0	3	0	0
1	6261467	.	A	T	2	2	4	0	0	4	0	0
1	6271664	.	A	G	3	7	10	0	0	10	0	0
1	6271712	.	T	C	9	7	16	0	0	16	0	0
1	6271764	.	A	C	8	4	12	0	2	14	0	0
1	6357164	.	A	C	2	3	5	0	1	6	0	0
1	6357840	.	A	G	2	5	7	0	0	7	0	0
1	6365673	.	A	G	3	2	5	0	0	5	0	0
1	6404659	.	G	A	2	3	5	0	0	5	0	0
1	6404661	.	T	A	7	2	9	0	0	9	0	0
1	6655170	.	A	G	1	0	1	0	5	6	0	0
1	6662858	.	A	T	7	6	13	0	1	14	0	0
1	6663617	.	T	C	2	2	4	0	0	4	0	0
1	6663623	.	C	A	3	3	6	0	0	6	0	0
1	6663946	.	A	G	12	8	20	0	1	21	0	0
1	6924761	.	G	A	0	2	2	0	3	5	0	0
1	7518644	.	C	T	3	5	8	0	0	8	0	0
1	7526839	.	G	A	7	5	12	0	1	13	0	0
1	7528289	.	G	C	1	7	8	0	18	26	0	0
1	7529833	.	G	C	4	20	24	0	15	39	0	0
1	7530123	.	C	T	21	18	39	0	2	41	0	0
1	7538822	.	C	T	28	20	48	0	2	50	0	0
1	7539053	.	G	C	23	15	38	0	1	39	0	0
1	7554054	.	T	C	5	1	6	0	1	7	0	0
1	7554068	.	T	C	1	5	6	0	3	9	0	0
1	7632221	.	C	T	4	4	8	0	0	8	0	0
1	7662571	.	T	C	26	17	43	0	3	46	0	0
1	7662628	.	G	A	22	28	50	0	1	51	0	0
1	7662723	.	T	A	18	19	37	0	2	39	0	0
1	7662728	.	G	A	19	17	36	0	3	39	0	0
1	7662880	.	A	T	16	24	40	0	0	40	0	0
1	7670535	.	C	T	25	19	44	0	2	46	0	0
1	7672794	.	T	C	20	16	36	0	0	36	0	0
1	7672809	.	C	T	16	17	33	0	0	33	0	0
1	7673070	.	C	T	19	11	30	0	1	31	0	0
1	7673129	.	C	A	12	13	25	0	0	25	0	0
1	7673198	.	A	G	5	14	19	0	2	21	0	0
1	7682949	.	G	A	9	10	19	0	0	19	0	0
1	8022495	.	C	T	8	24	32	0	0	32	0	0
1	8022532	.	A	G	13	22	35	0	1	36	0	0
1	8022606	.	T	C	16	13	29	0	0	29	0	0
1	8022682	.	C	T	3	20	23	0	16	39	0	0
1	8023433	.	C	T	12	9	21	0	4	25	0	0
1	8023587	.	A	G	10	13	23	0	1	24	0	0
1	8023730	.	C	T	8	13	21	0	0	21	0	0
1	8024087	.	G	A	13	9	22	1	2	25	0	0
1	8025863	.	C	T	12	14	26	0	1	27	0	0
1	8026146	.	C	T	12	11	23	0	1	24	0	0
1	8026148	.	T	G	12	11	23	0	1	24	0	0
1	8026293	.	G	T	12	7	19	0	2	21	0	0
1	8026345	.	C	T	12	14	26	0	0	26	0	0
1	8026415	.	C	T	0	13	13	0	16	29	0	0
1	8026521	.	C	A	2	10	12	0	17	29	0	0
1	8026565	.	C	T	15	13	28	0	0	28	0	0
1	8026924	.	T	A	8	9	17	0	0	17	0	0
1	8027012	.	G	A	7	2	9	0	0	9	0	0
1	8028177	.	T	A	6	4	10	0	0	10	0	0
1	8028652	.	G	A	3	4	7	0	1	8	0	0
1	8028688	.	C	A	5	5	10	0	0	10	0	0
1	8028727	.	G	A	5	4	9	0	0	9	0	0
1	8028811	.	C	T	1	5	6	0	4	10	0	0
1	8032947	.	G	A	1	3	4	0	0	4	0	0
1	8055927	.	T	C	1	0	1	0	3	4	0	0
1	8055954	.	A	G	0	2	2	0	1	3	0	0
1	8129107	.	C	T	0	5	5	0	4	9	0	0
1	8129855	.	A	G	1	2	3	0	0	3	0	0
1	8165443	.	A	C	5	10	15	0	0	15	0	0
1	8165609	.	C	T	9	10	19	0	0	19	0	0
1	8165643	.	T	C	7	5	12	0	1	13	0	0
1	8165667	.	T	C	5	4	9	0	2	11	0	0
1	8165741	.	T	C	3	3	6	0	0	6	0	0
1	8166788	.	A	T	7	6	13	0	0	13	0	0
1	8166992	.	A	G	6	3	9	0	0	9	0	0
1	8167194	.	G	T	1	4	5	0	1	6	0	0
1	8167218	.	C	T	0	3	3	0	3	6	0	0
1	8167368	.	G	A	4	4	8	0	1	9	0	0
1	8167508	.	A	G	11	5	16	0	1	17	0	0
1	8167570	.	C	G	3	7	10	0	1	11	0	0
1	8167668	.	G	A	3	3	6	0	0	6	0	0
1	8169262	.	C	T	2	6	8	0	0	8	0	0
1	8169268	.	C	T	3	5	8	0	1	9	0	0
1	8169361	.	G	A	4	4	8	0	0	8	0	0
1	8185072	.	G	A	3	3	6	0	0	6	0	0
1	8185103	.	G	A	2	2	4	0	0	4	0	0
1	8192188	.	C	G	1	2	3	0	0	3	0	0
1	8192192	.	A	G	1	1	2	0	0	2	0	0
1	8192344	.	A	C	1	4	5	0	1	6	0	0
1	8416565	.	T	A	30	23	53	0	4	57	0	0
1	8416629	.	T	G	20	25	45	0	2	47	0	0
1	8416820	.	C	T	5	5	10	0	0	10	0	0
1	8417896	.	T	C	11	14	25	0	0	25	0	0
1	8417943	.	A	G	8	10	18	0	1	19	0	0
1	8418118	.	C	G	5	10	15	0	1	16	0	0
1	8418126	.	A	C	12	0	12	0	6	18	0	0
1	8422521	.	A	G	12	16	28	0	0	28	0	0
1	8424738	.	C	T	1	6	7	0	4	11	0	0
1	8424804	.	C	T	4	5	9	0	0	9	0	0
1	8424813	.	A	G	4	5	9	0	0	9	0	0
1	8508950	.	T	C	2	4	6	0	0	6	0	0
1	8511602	.	C	T	8	11	19	0	0	19	0	0
1	8511778	.	G	T	1	11	12	0	12	24	0	0
1	8516407	.	G	A	0	8	8	0	16	24	0	0
1	8516443	.	C	G	13	10	23	0	1	24	0	0
1	8516552	.	A	G	4	10	14	0	3	17	0	0
1	8531311	.	C	T	1	2	3	0	0	3	0	0
1	8531653	.	T	C	1	5	6	0	0	6	0	0
1	8543337	.	T	A	4	4	8	0	0	8	0	0
1	8543380	.	G	A	4	3	7	0	0	8	1	0
1	8543390	.	C	T	3	3	6	0	0	6	0	0
1	8543707	.	A	G	2	3	5	0	0	5	0	0
1	8544457	.	C	T	3	4	7	0	0	7	0	0
1	8544483	.	G	A	5	3	8	0	0	8	0	0
1	8547315	.	G	C	2	0	2	0	3	5	0	0
1	8548647	.	T	A	1	4	5	0	0	5	0	0
1	8555456	.	A	G	3	2	5	0	0	5	0	0
1	8557099	.	C	T	0	4	4	0	5	9	0	0
1	8560072	.	A	G	3	2	5	0	0	5	0	0
1	8560208	.	G	A	4	3	7	0	0	7	0	0
1	8563792	.	G	A	1	2	3	0	0	3	0	0
1	8566443	.	C	T	1	2	3	0	0	3	0	0
1	8606561	.	C	T	1	1	2	0	1	3	0	0
1	8607487	.	C	T	2	3	5	0	0	5	0	0
1	8607547	.	C	T	2	4	6	0	0	6	0	0
1	8607556	.	T	C	1	4	5	0	1	6	0	0
1	8608180	.	G	A	0	6	6	0	2	8	0	0
1	8610451	.	G	A	1	7	8	0	7	15	0	0
1	8638224	.	C	T	3	2	5	0	1	6	0	0
1	8638537	.	T	G	3	5	8	0	1	9	0	0
1	8642800	.	C	T	3	3	6	0	0	6	0	0
1	8642938	.	A	G	2	4	6	0	0	6	0	0
1	8642953	.	C	T	1	4	5	0	1	6	0	0
1	8649726	.	A	G	35	49	84	2	3	89	0	0
1	8649865	.	C	T	29	35	64	2	3	69	0	0
1	8649988	.	A	G	29	34	63	0	1	64	0	0
1	8649994	.	A	T	29	32	61	0	2	63	0	0
1	8650317	.	G	A	20	30	50	0	7	57	0	0
1	8650371	.	C	T	31	31	62	0	1	63	0	0
1	8650544	.	G	A	1	7	8	0	1	9	0	0
1	8650830	.	T	G	8	3	11	0	0	11	0	0
1	8651036	.	G	A	27	21	48	0	3	51	0	0
1	8651060	.	T	C	21	26	47	0	0	47	0	0
1	8651576	.	G	A	26	24	50	2	1	53	0	0
1	8662553	.	G	A	6	4	10	0	0	10	0	0
1	8663295	.	T	C	7	8	15	0	0	15	0	0
1	8667377	.	G	A	10	5	15	0	0	15	0	0
1	8667606	.	C	T	8	15	23	0	0	23	0	0
1	8668166	.	T	C	14	25	39	0	1	40	0	0
1	8668238	.	G	T	23	5	28	0	2	30	0	0
1	8669228	.	A	G	1	0	1	0	2	3	0	0
1	8669543	.	A	G	4	4	8	0	0	8	0	0
1	8669669	.	A	G	15	9	24	0	0	24	0	0
1	8669673	.	A	G	19	8	27	0	2	29	0	0
1	8669717	.	T	G	15	18	33	0	0	33	0	0
1	8669718	.	T	C	13	18	31	0	1	32	0	0
1	8669753	.	T	A	17	17	34	0	1	35	0	0
1	8669847	.	G	T	26	20	46	0	2	48	0	0
1	8670031	.	T	C	25	37	62	0	3	65	0	0
1	8670032	.	G	T	3	22	25	0	40	65	0	0
1	8670402	.	G	A	22	21	43	0	0	43	0	0
1	8694404	.	G	A	3	8	11	0	1	12	0	0
1	8698765	.	T	C	13	14	27	0	1	28	0	0
1	8701548	.	A	G	12	0	12	0	18	30	0	0
1	8702325	.	G	T	17	21	38	0	1	39	0	0
1	8702400	.	T	C	18	33	51	0	0	51	0	0
1	8764123	.	C	T	7	12	19	0	0	19	0	0
1	8764812	.	G	A	18	9	27	0	2	29	0	0
1	8765028	.	G	A	14	16	30	0	0	30	0	0
1	8765491	.	T	A	26	6	32	2	0	34	0	0
1	8765493	.	G	T	21	7	28	2	1	31	0	0
1	8766453	.	C	T	7	9	16	0	0	16	0	0
1	8766471	.	C	T	0	10	10	0	6	16	0	0
1	8766501	.	C	T	6	9	15	0	0	15	0	0
1	8766693	.	G	A	6	6	12	0	0	12	0	0
1	8766903	.	G	C	4	2	6	0	0	6	0	0
1	9118497	.	T	A	16	25	41	0	1	42	0	0
1	9123289	.	C	G	7	11	18	2	1	21	0	0
1	9225454	.	C	T	1	2	3	0	0	3	0	0
1	9261903	.	A	C	7	2	9	0	10	19	0	0
1	9261930	.	G	A	8	10	18	0	0	18	0	0
1	9262173	.	G	A	14	8	22	0	0	22	0	0
1	9262221	.	A	G	11	8	19	0	1	20	0	0
1	9265578	.	T	C	5	7	12	0	1	13	0	0
1	9270885	.	G	A	5	4	9	0	0	9	0	0
1	9270933	.	C	T	2	6	8	0	1	9	0	0
1	9273173	.	G	A	3	3	6	0	0	6	0	0
1	9273347	.	A	G	1	2	3	0	0	3	0	0
1	9276420	.	C	T	1	6	7	0	1	8	0	0
1	9278150	.	G	A	2	2	4	0	0	4	0	0
1	9290319	.	A	G	5	4	9	0	0	9	0	0
1	9290432	.	T	A	4	7	11	0	0	11	0	0
1	9290500	.	G	T	3	4	7	0	1	8	0	0
1	9292975	.	A	T	4	3	7	0	0	7	0	0
1	9293002	.	T	C	5	4	9	0	0	9	0	0
1	9293495	.	A	G	9	10	19	0	4	23	0	0
1	9499764	.	C	T	13	9	22	0	3	25	0	0
1	9500312	.	A	T	3	6	9	0	0	9	0	0
1	9500332	.	T	C	2	4	6	0	1	9	2	0
1	9500508	.	C	A	3	4	7	0	2	10	1	0
1	9500699	.	T	C	7	4	11	0	2	13	0	0
1	9500757	.	A	T	5	5	10	0	0	10	0	0
1	9500835	.	A	G	7	6	13	0	0	13	0	0
1	9500896	.	T	C	5	3	8	0	0	8	0	0
1	9500947	.	G	T	4	6	10	0	0	10	0	0
1	9500984	.	A	T	4	3	7	0	0	7	0	0
1	9501011	.	T	C	1	4	5	0	0	5	0	0
1	9501229	.	C	T	8	10	18	0	3	21	0	0
1	9501231	.	G	A	11	7	18	0	3	21	0	0
1	9501365	.	T	C	7	0	7	0	3	10	0	0
1	9501394	.	T	A	5	7	12	0	0	12	0	0
1	9508752	.	T	A	3	3	6	0	0	6	0	0
1	9510571	.	A	G	2	2	4	0	0	4	0	0
1	9510574	.	G	A	2	2	4	0	0	4	0	0
1	9710853	.	T	C	1	3	4	0	0	4	0	0
1	9711956	.	A	G	1	5	6	0	1	7	0	0
1	9808324	.	A	G	3	3	6	0	0	6	0	0
1	9808345	.	T	A	1	2	3	0	0	3	0	0
1	9808365	.	C	T	1	3	4	0	0	4	0	0
1	9866634	.	C	A	2	1	3	0	0	3	0	0
1	9866637	.	G	A	2	1	3	0	0	3	0	0
1	9873485	.	G	A	3	2	5	0	2	7	0	0
1	9873607	.	A	T	4	4	8	0	2	10	0	0
1	9873616	.	T	C	6	0	6	0	8	14	0	0
1	9873787	.	G	A	6	2	8	0	0	8	0	0
1	10463097	.	T	C	6	6	12	0	0	12	0	0
1	10673098	.	T	C	5	2	7	0	0	7	0	0
1	10673099	.	G	A	5	2	7	0	0	7	0	0
1	10680513	.	A	G	0	2	2	1	0	3	0	0
1	10680518	.	C	T	0	2	2	1	1	4	0	0
1	10683868	.	A	T	6	4	10	2	1	13	0	0
1	10683955	.	A	G	7	3	10	0	1	11	0	0
1	10683974	.	A	C	8	4	12	0	0	12	0	0
1	10684037	.	A	G	6	1	7	0	4	11	0	0
1	10684105	.	G	A	0	4	4	0	8	12	0	0
1	10692078	.	T	C	11	8	19	1	0	20	0	0
1	10692090	.	G	A	8	11	19	0	1	20	0	0
1	10736181	.	G	A	10	14	24	0	1	25	0	0
1	10738509	.	T	C	23	28	51	0	0	51	0	0
1	10738535	.	G	A	28	25	53	0	2	55	0	0
1	10738568	.	A	G	30	2	32	0	24	56	0	0
1	10738863	.	C	A	29	29	58	0	4	62	0	0
1	10841254	.	T	C	6	14	20	0	2	22	0	0
1	10841275	.	T	C	6	15	21	0	2	23	0	0
1	10841356	.	G	A	6	7	13	1	0	14	0	0
1	11125237	.	G	A	5	2	7	0	0	7	0	0
1	11125249	.	A	C	3	3	6	0	2	8	0	0
1	11670963	.	T	C	6	4	10	0	0	10	0	0
1	11671355	.	C	A	4	8	12	0	2	14	0	0
1	11671580	.	C	T	8	5	13	0	0	13	0	0
1	11671651	.	A	C	3	3	6	0	1	7	0	0
1	11783504	.	T	C	12	10	22	0	1	23	0	0
1	11783530	.	T	C	11	5	16	0	1	17	0	0
1	11783650	.	T	C	18	18	36	0	2	38	0	0
1	11784522	.	T	C	23	10	33	0	0	33	0	0
1	11784679	.	T	C	6	16	22	0	0	22	0	0
1	11907362	.	G	A	1	5	6	0	0	6	0	0
1	15254249	.	A	G	5	0	5	0	5	10	0	0
1	17538085	.	T	C	4	0	4	1	6	11	0	0
1	17538099	.	T	C	2	4	6	1	0	7	0	0
1	19123192	.	T	C	5	2	7	0	0	7	0	0
1	19886159	.	A	C	1	2	3	0	0	3	0	0
1	21611043	.	T	C	1	4	5	0	1	6	0	0
1	22806206	.	T	C	3	6	9	0	1	10	0	0
1	22807110	.	T	C	8	0	8	0	7	15	0	0
1	23284240	.	A	G	1	8	9	0	0	9	0	0
1	23298011	.	A	T	2	2	4	0	0	4	0	0
1	23909748	.	A	T	1	7	8	0	0	8	0	0
1	26385225	.	A	G	4	2	6	0	1	7	0	0
1	26740719	.	C	T	18	6	24	3	2	29	0	0
1	28046717	.	T	A	1	3	4	0	0	4	0	0
1	29741424	.	A	T	6	2	8	0	3	11	0	0
1	33668580	.	A	T	4	1	5	0	1	6	0	0
1	34233312	.	A	G	16	4	20	0	4	24	0	0
1	34258452	.	C	T	1	3	4	0	0	4	0	0
1	36739579	.	A	G	2	2	4	0	0	4	0	0
1	37287291	.	A	T	3	3	6	0	0	6	0	0
1	37287294	.	G	A	4	4	8	0	0	8	0	0
1	37304354	.	C	A	4	7	11	0	1	12	0	0
1	37304439	.	C	T	6	2	8	0	0	8	0	0
1	37304494	.	T	A	8	5	13	0	0	13	0	0
1	37304510	.	T	G	7	6	13	0	0	13	0	0
1	37304536	.	G	A	6	4	10	0	1	11	0	0
1	37304929	.	G	A	6	7	13	1	0	14	0	0
1	37305148	.	C	T	6	2	8	0	0	8	0	0
1	37306726	.	G	T	3	15	18	0	14	32	0	0
1	37306913	.	T	A	13	19	32	0	1	33	0	0
1	37306942	.	A	C	20	13	33	0	0	33	0	0
1	37355606	.	C	T	1	3	4	0	1	5	0	0
1	37359071	.	C	T	3	4	7	0	0	7	0	0
1	37359221	.	G	C	4	2	6	0	0	6	0	0
1	37359352	.	A	G	4	4	8	0	2	10	0	0
1	37361554	.	A	G	5	6	11	0	1	12	0	0
1	37361759	.	C	T	9	3	12	0	0	12	0	0
1	37361879	.	T	A	4	9	13	0	0	13	0	0
1	37361919	.	T	C	2	6	8	0	0	8	0	0
1	37361960	.	C	T	3	3	6	0	0	6	0	0
1	37362009	.	A	T	2	2	4	0	2	6	0	0
1	37399943	.	A	C	1	2	3	0	0	3	0	0
1	37399965	.	A	G	1	2	3	0	0	3	0	0
1	38125431	.	C	A	6	13	19	0	1	20	0	0
1	38125684	.	T	C	10	5	15	0	1	16	0	0
1	38131058	.	C	T	16	14	30	0	1	31	0	0
1	38131073	.	T	C	13	17	30	0	0	30	0	0
1	38131094	.	G	A	21	13	34	0	0	34	0	0
1	38131288	.	G	A	19	9	28	0	1	29	0	0
1	38131360	.	G	A	25	26	51	0	1	52	0	0
1	38131486	.	G	A	18	14	32	0	4	36	0	0
1	38131873	.	C	T	2	2	4	0	0	4	0	0
1	38132103	.	T	A	4	1	5	0	2	7	0	0
1	38132105	.	G	A	4	0	4	0	3	7	0	0
1	38150605	.	A	C	4	2	6	0	0	6	0	0
1	38163017	.	C	T	13	12	25	0	1	26	0	0
1	38163132	.	G	A	13	7	20	0	2	22	0	0
1	38166009	.	G	C	5	6	11	0	0	11	0	0
1	38166268	.	A	C	13	19	32	0	0	32	0	0
1	38166429	.	T	C	19	26	45	0	3	48	0	0
1	38166431	.	T	G	18	27	45	0	3	48	0	0
1	38166520	.	A	G	18	16	34	0	5	39	0	0
1	38169771	.	T	A	14	4	18	0	3	21	0	0
1	38169972	.	T	G	16	19	35	0	4	39	0	0
1	38170553	.	G	A	8	16	24	0	2	26	0	0
1	38346065	.	T	C	2	3	5	0	0	5	0	0
1	38346162	.	C	T	0	6	6	2	6	14	0	0
1	38346578	.	G	T	4	5	9	0	1	10	0	0
1	38346649	.	C	T	0	4	4	0	3	7	0	0
1	38346739	.	G	A	2	4	6	0	0	6	0	0
1	38354049	.	G	A	1	2	3	0	0	3	0	0
1	38416477	.	G	A	4	6	10	0	0	10	0	0
1	38417229	.	G	A	4	4	8	0	1	9	0	0
1	38417268	.	A	T	4	11	15	0	1	16	0	0
1	38417332	.	A	G	4	4	8	0	2	10	0	0
1	38417531	.	G	T	4	3	7	0	0	7	0	0
1	38417617	.	A	T	5	3	8	0	0	8	0	0
1	38417625	.	A	T	4	3	7	0	1	8	0	0
1	38417680	.	T	A	3	2	5	0	1	6	0	0
1	38418087	.	C	T	4	3	7	0	0	7	0	0
1	38418243	.	A	G	2	2	4	0	0	4	0	0
1	38418294	.	G	T	2	3	5	0	0	5	0	0
1	38649340	.	A	G	41	27	68	0	2	70	0	0
1	38649947	.	G	A	38	26	64	1	4	69	0	0
1	38650132	.	G	T	30	33	63	0	2	65	0	0
1	38650298	.	G	A	20	22	42	0	2	44	0	0
1	38650382	.	G	C	35	24	59	0	4	63	0	0
1	38650467	.	A	G	27	32	59	0	7	66	0	0
1	38650510	.	G	C	28	35	63	0	6	69	0	0
1	38650516	.	T	C	26	42	68	0	2	70	0	0
1	38650545	.	T	C	37	30	67	0	6	73	0	0
1	38651063	.	G	T	45	19	64	0	1	65	0	0
1	38651065	.	T	A	44	18	62	0	4	66	0	0
1	38651361	.	C	T	8	4	12	0	3	15	0	0
1	38651370	.	G	A	10	5	15	0	1	16	0	0
1	38651469	.	C	A	10	6	16	0	2	18	0	0
1	38651822	.	G	A	4	5	9	0	0	9	0	0
1	38655522	.	C	T	3	20	23	0	30	53	0	0
1	38657689	.	G	A	28	16	44	0	1	45	0	0
1	38660240	.	T	C	20	0	20	0	23	43	0	0
1	38660252	.	A	G	22	21	43	0	0	43	0	0
1	38660369	.	G	A	13	11	24	0	2	26	0	0
1	38791517	.	A	G	3	2	5	0	0	5	0	0
1	38791569	.	C	T	2	3	5	0	0	5	0	0
1	38793983	.	G	A	1	2	3	0	0	3	0	0
1	38797663	.	A	C	8	7	15	0	0	15	0	0
1	38799513	.	G	A	8	8	16	0	0	16	0	0
1	38799585	.	A	G	3	2	5	0	1	6	0	0
1	38799588	.	T	A	2	4	6	0	0	6	0	0
1	38802537	.	G	A	7	8	15	0	1	16	0	0
1	38802703	.	A	G	9	13	22	0	0	22	0	0
1	38802718	.	G	A	13	12	25	0	1	26	0	0
1	38802747	.	A	G	10	0	10	0	9	19	0	0
1	38802818	.	T	C	8	4	12	0	3	15	0	0
1	38802819	.	G	A	11	4	15	0	0	15	0	0
1	38802855	.	C	A	8	5	13	0	0	13	0	0
1	38803033	.	T	C	4	5	9	0	0	9	0	0
1	38803042	.	A	C	4	3	7	0	0	7	0	0
1	38803092	.	C	T	4	7	11	0	1	12	0	0
1	38803127	.	C	T	8	6	14	0	2	16	0	0
1	38803154	.	T	A	10	8	18	0	1	19	0	0
1	38803205	.	A	T	7	9	16	0	1	17	0	0
1	38803404	.	A	G	12	9	21	0	3	24	0	0
1	38805128	.	G	T	5	2	7	0	0	7	0	0
1	38805135	.	C	T	5	2	7	0	1	8	0	0
1	38805439	.	G	A	11	12	23	0	1	24	0	0
1	38805450	.	A	G	13	11	24	0	1	25	0	0
1	38805506	.	G	A	12	19	31	0	1	32	0	0
1	38807255	.	G	C	7	10	17	0	1	18	0	0
1	38808259	.	C	A	4	9	13	0	0	13	0	0
1	38808379	.	C	T	1	4	5	0	6	11	0	0
1	38808723	.	T	A	2	4	6	0	0	6	0	0
1	38810061	.	T	G	2	3	5	0	0	5	0	0
1	38820219	.	G	A	1	11	12	0	7	19	0	0
1	38822092	.	A	T	11	5	16	0	1	18	1	0
1	38851111	.	C	T	1	2	3	0	4	7	0	0
1	39770416	.	C	T	2	3	5	0	0	5	0	0
1	39771429	.	T	A	1	7	8	0	0	8	0	0
1	39772010	.	T	C	5	4	9	0	0	9	0	0
1	39772042	.	A	G	6	4	10	0	0	10	0	0
1	39772225	.	C	T	8	3	11	0	0	11	0	0
1	39774096	.	C	T	2	2	4	0	0	4	0	0
1	39774225	.	C	T	10	4	14	0	0	14	0	0
1	39774363	.	G	A	5	6	11	0	0	11	0	0
1	39774618	.	A	G	4	5	9	0	0	9	0	0
1	39774690	.	A	G	2	8	10	0	0	10	0	0
1	39774727	.	C	A	2	8	10	0	0	10	0	0
1	39774891	.	C	T	9	7	16	0	1	17	0	0
1	39774915	.	G	A	7	7	14	0	1	15	0	0
1	39775089	.	C	T	6	4	10	0	0	10	0	0
1	39775131	.	C	T	10	3	13	0	0	13	0	0
1	39775227	.	C	T	8	9	17	0	1	18	0	0
1	39776356	.	A	C	10	16	26	0	2	28	0	0
1	39777089	.	G	A	13	16	29	0	1	30	0	0
1	39777836	.	G	A	1	14	15	0	2	17	0	0
1	39777975	.	A	T	5	13	18	0	2	20	0	0
1	39778047	.	A	G	7	0	7	0	15	22	0	0
1	39778075	.	T	G	9	13	22	0	0	22	0	0
1	39778332	.	G	C	16	31	47	0	2	49	0	0
1	39778452	.	G	A	8	2	10	1	1	12	0	0
1	39778661	.	G	A	10	12	22	0	1	23	0	0
1	39778663	.	G	A	9	13	22	0	1	23	0	0
1	39778949	.	G	C	18	29	47	0	0	47	0	0
1	39779225	.	G	C	15	12	27	0	0	27	0	0
1	39779468	.	A	T	4	8	12	0	2	14	0	0
1	39779518	.	T	G	8	4	12	0	0	13	1	0
1	39865752	.	T	A	3	2	5	0	0	5	0	0
1	39865792	.	A	G	1	2	3	0	0	3	0	0
1	39869860	.	T	A	1	3	4	0	0	4	0	0
1	39869917	.	T	A	2	3	5	0	0	5	0	0
1	39869974	.	G	A	1	4	5	0	0	5	0	0
1	39870008	.	T	C	1	2	3	0	0	3	0	0
1	39882065	.	A	G	1	2	3	0	0	3	0	0
1	39882764	.	A	T	6	3	9	0	0	9	0	0
1	39882899	.	A	G	6	3	9	0	0	9	0	0
1	39882906	.	T	A	3	6	9	0	1	10	0	0
1	39899477	.	G	C	17	21	38	0	2	40	0	0
1	39899494	.	A	G	21	18	39	0	2	41	0	0
1	39899663	.	G	A	20	18	38	0	1	39	0	0
1	39900056	.	G	A	21	17	38	0	0	38	0	0
1	39900129	.	G	A	18	18	36	0	1	37	0	0
1	39900137	.	G	T	18	20	38	0	0	38	0	0
1	39900360	.	G	A	11	8	19	0	3	22	0	0
1	39900432	.	C	T	0	17	17	0	5	22	0	0
1	39900750	.	C	T	1	9	10	0	6	16	0	0
1	39901269	.	G	A	4	2	6	0	0	6	0	0
1	39901378	.	T	A	5	4	9	0	0	9	0	0
1	39901500	.	T	C	4	3	7	0	0	7	0	0
1	39901501	.	G	A	4	3	7	0	0	7	0	0
1	39901729	.	T	C	7	0	7	0	12	19	0	0
1	39907291	.	A	C	3	2	5	0	0	5	0	0
1	39907492	.	T	C	12	0	12	0	6	18	0	0
1	39907611	.	C	T	1	5	6	0	3	9	0	0
1	39908047	.	G	A	6	5	11	0	0	11	0	0
1	39909247	.	A	T	4	5	9	0	0	9	0	0
1	39981794	.	A	G	4	7	11	0	0	11	0	0
1	39995100	.	C	T	2	2	4	0	0	4	0	0
1	39998875	.	G	A	1	2	3	0	1	4	0	0
1	40001853	.	A	T	3	4	7	0	1	8	0	0
1	40001873	.	C	A	4	4	8	0	1	9	0	0
1	40002113	.	G	A	5	5	10	0	0	10	0	0
1	40002148	.	C	G	8	6	14	0	0	14	0	0
1	40008905	.	T	C	18	17	35	0	3	38	0	0
1	40008906	.	G	A	20	18	38	0	0	38	0	0
1	40009227	.	T	A	20	17	37	0	0	37	0	0
1	40009258	.	C	T	12	14	26	0	4	30	0	0
1	40009291	.	A	G	11	14	25	0	1	26	0	0
1	40009382	.	G	A	18	9	27	0	1	28	0	0
1	40009526	.	T	C	4	8	12	0	1	13	0	0
1	40009625	.	T	C	10	8	18	0	0	18	0	0
1	40009671	.	C	A	12	10	22	0	0	22	0	0
1	40009697	.	C	T	10	6	16	0	1	17	0	0
1	40015189	.	A	G	5	4	9	0	0	9	0	0
1	40015219	.	C	T	6	10	16	0	1	17	0	0
1	40015265	.	C	T	1	9	10	0	7	17	0	0
1	40015553	.	A	G	2	6	8	0	1	9	0	0
1	40015697	.	A	G	2	5	7	0	0	7	0	0
1	40028568	.	G	T	3	2	5	0	0	5	0	0
1	40041528	.	C	T	4	2	6	0	0	6	0	0
1	40042241	.	G	A	1	3	4	0	0	4	0	0
1	40044562	.	G	A	4	4	8	0	1	9	0	0
1	40044578	.	C	T	7	4	11	0	1	12	0	0
1	40047070	.	T	A	7	10	17	0	2	19	0	0
1	40051918	.	T	C	8	7	15	1	0	16	0	0
1	40051923	.	G	C	9	7	16	1	0	17	0	0
1	40051988	.	G	C	1	10	11	0	7	18	0	0
1	40052033	.	A	G	6	8	14	0	2	16	0	0
1	40052066	.	G	C	9	7	16	0	1	17	0	0
1	40052083	.	G	A	9	9	18	1	0	19	0	0
1	40052481	.	A	C	14	7	21	0	0	21	0	0
1	40052550	.	A	C	10	11	21	0	1	22	0	0
1	40052562	.	A	G	7	11	18	0	1	19	0	0
1	40052965	.	T	A	5	4	9	0	0	9	0	0
1	40057483	.	C	T	4	2	6	0	0	6	0	0
1	40057604	.	A	G	3	6	9	0	0	9	0	0
1	40057655	.	C	T	5	3	8	0	0	8	0	0
1	40057805	.	C	T	5	7	12	0	1	13	0	0
1	40060836	.	T	A	3	2	5	0	0	5	0	0
1	40060968	.	A	C	1	7	8	0	0	8	0	0
1	40060992	.	C	T	0	4	4	0	3	7	0	0
1	40061061	.	C	T	0	3	3	0	1	4	0	0
1	40061285	.	C	T	2	2	4	0	0	4	0	0
1	40107874	.	T	G	5	4	9	0	0	9	0	0
1	40111679	.	C	G	4	11	15	0	0	15	0	0
1	40111702	.	T	G	6	12	18	0	1	19	0	0
1	40111737	.	A	C	8	10	18	0	1	19	0	0
1	40111738	.	G	A	9	9	18	0	1	19	0	0
1	40111776	.	C	T	5	10	15	0	0	15	0	0
1	40111918	.	C	T	16	11	27	0	1	28	0	0
1	40112206	.	T	C	3	2	5	0	3	8	0	0
1	40112347	.	C	T	6	10	16	0	0	16	0	0
1	40112410	.	C	T	13	8	21	0	4	25	0	0
1	40112713	.	A	G	2	0	2	0	2	4	0	0
1	40112837	.	C	T	10	16	26	1	0	27	0	0
1	40112869	.	C	T	19	12	31	1	0	32	0	0
1	40112879	.	A	G	16	10	26	1	1	28	0	0
1	40112938	.	G	C	9	7	16	0	0	16	0	0
1	40113374	.	T	A	3	2	5	0	0	5	0	0
1	40114155	.	T	A	3	2	5	0	0	5	0	0
1	40114326	.	C	T	1	2	3	1	0	4	0	0
1	40114462	.	A	G	2	3	5	0	0	5	0	0
1	40114466	.	T	G	3	2	5	0	0	5	0	0
1	40115018	.	A	T	4	4	8	0	0	8	0	0
1	40115065	.	T	C	4	4	8	0	0	8	0	0
1	40116747	.	G	A	7	7	14	0	1	15	0	0
1	40116823	.	C	T	1	6	7	0	3	10	0	0
1	40116946	.	C	T	0	3	3	0	11	14	0	0
1	40117345	.	G	A	15	11	26	0	0	26	0	0
1	40210865	.	G	T	5	13	18	0	1	19	0	0
1	40211048	.	C	T	0	3	3	0	3	6	0	0
1	40211065	.	T	C	2	2	4	0	0	4	0	0
1	40211217	.	A	C	2	5	7	0	0	7	0	0
1	40211645	.	C	G	0	5	5	0	3	8	0	0
1	40212065	.	C	T	4	3	7	0	0	7	0	0
1	40212084	.	C	A	0	4	4	0	4	8	0	0
1	40212305	.	C	T	2	6	8	0	0	8	0	0
1	40248383	.	C	T	1	2	3	0	0	3	0	0
1	40252219	.	T	A	6	8	14	0	0	14	0	0
1	40257568	.	C	T	0	14	14	0	0	14	0	0
1	40257577	.	A	G	12	6	18	0	1	19	0	0
1	40257631	.	C	T	15	4	19	0	1	20	0	0
1	40257751	.	C	T	10	8	18	0	1	19	0	0
1	40257834	.	T	G	4	0	4	0	7	11	0	0
1	40263675	.	C	A	2	8	10	0	0	10	0	0
1	40266618	.	C	T	22	23	45	0	4	49	0	0
1	40269998	.	T	G	4	2	6	0	0	6	0	0
1	40270028	.	G	T	4	4	8	0	2	10	0	0
1	40270054	.	C	T	37	26	63	1	3	67	0	0
1	40270094	.	G	A	2	25	27	1	24	52	0	0
1	40270095	.	G	A	23	25	48	1	4	53	0	0
1	40336234	.	C	G	3	3	6	0	0	6	0	0
1	40336372	.	T	A	1	3	4	0	0	4	0	0
1	40336396	.	A	C	1	0	1	0	2	3	0	0
1	40337464	.	C	A	2	5	7	0	3	10	0	0
1	40340571	.	C	T	1	3	4	0	1	5	0	0
1	40340598	.	C	T	1	3	4	0	0	4	0	0
1	40410839	.	A	T	3	3	6	0	0	6	0	0
1	40410908	.	C	T	1	3	4	0	2	6	0	0
1	40568601	.	G	A	3	5	8	0	2	10	0	0
1	40568707	.	A	G	12	0	12	0	5	17	0	0
1	40568883	.	G	A	1	10	11	0	8	19	0	0
1	40568990	.	A	G	16	18	34	0	2	36	0	0
1	40569153	.	C	T	6	5	11	0	0	11	0	0
1	40569168	.	C	T	9	5	14	0	0	14	0	0
1	40569231	.	G	A	9	6	15	0	0	15	0	0
1	40569295	.	A	T	8	8	16	0	1	17	0	0
1	40569386	.	T	A	14	6	20	2	1	23	0	0
1	40569466	.	A	T	21	11	32	0	0	32	0	0
1	40569538	.	G	A	16	9	25	0	2	27	0	0
1	40569548	.	T	C	14	8	22	0	2	24	0	0
1	40573703	.	G	T	17	20	37	0	1	38	0	0
1	40590967	.	T	G	18	17	35	0	1	36	0	0
1	40591262	.	T	C	17	18	35	0	1	36	0	0
1	40591272	.	T	C	16	14	30	0	1	31	0	0
1	40594373	.	C	T	10	10	20	0	1	21	0	0
1	40594415	.	C	T	1	10	11	0	10	21	0	0
1	40594517	.	T	C	13	0	13	0	10	23	0	0
1	40594526	.	G	A	13	9	22	0	1	23	0	0
1	40597332	.	A	C	12	0	12	0	10	22	0	0
1	40600992	.	A	T	3	6	9	0	1	10	0	0
1	40601547	.	G	A	4	9	13	0	0	13	0	0
1	40601595	.	G	C	1	0	1	0	3	4	0	0
1	40618861	.	C	T	1	2	3	0	0	3	0	0
1	40627291	.	G	A	3	4	7	0	0	7	0	0
1	40638246	.	A	T	10	5	15	0	1	16	0	0
1	40797178	.	C	T	1	2	3	0	0	3	0	0
1	40910379	.	T	C	1	2	3	0	0	3	0	0
1	40992716	.	T	A	6	3	9	0	1	10	0	0
1	40992823	.	A	G	3	9	12	0	0	12	0	0
1	40992878	.	C	G	9	3	12	0	1	13	0	0
1	40993349	.	C	T	1	4	5	0	4	9	0	0
1	41131608	.	C	T	5	8	13	1	0	14	0	0
1	41131766	.	A	G	1	6	7	0	1	8	0	0
1	41133944	.	G	A	4	3	7	0	2	9	0	0
1	41136245	.	T	C	8	8	16	0	1	17	0	0
1	41138638	.	A	G	10	7	17	0	0	17	0	0
1	41138641	.	C	T	8	10	18	0	0	18	0	0
1	41140465	.	T	C	6	11	17	0	0	17	0	0
1	41140640	.	C	T	13	12	25	0	0	25	0	0
1	41215289	.	T	A	9	10	19	0	1	20	0	0
1	41215312	.	T	G	10	16	26	0	2	28	0	0
1	41215547	.	G	A	7	5	12	0	0	12	0	0
1	41215746	.	T	A	5	8	13	0	0	13	0	0
1	41215868	.	T	G	4	6	10	0	1	11	0	0
1	41215869	.	G	T	7	4	11	0	1	12	0	0
1	41294719	.	A	G	10	11	21	0	0	21	0	0
1	41294760	.	T	C	10	10	20	0	2	22	0	0
1	41294790	.	G	T	6	8	14	0	0	14	0	0
1	41297495	.	G	A	4	6	10	0	2	12	0	0
1	41297561	.	C	T	4	6	10	0	1	11	0	0
1	41297564	.	A	T	7	4	11	0	0	11	0	0
1	41300133	.	C	T	4	3	7	0	0	7	0	0
1	41309208	.	C	G	1	2	3	0	0	3	0	0
1	41470524	.	T	C	22	27	49	0	4	53	0	0
1	41471529	.	T	C	27	28	55	0	4	59	0	0
1	41487811	.	C	T	2	3	5	0	0	5	0	0
1	41488643	.	A	C	2	4	6	0	0	6	0	0
1	41489343	.	G	A	5	4	9	0	0	9	0	0
1	41489433	.	C	T	2	2	4	0	0	4	0	0
1	41491990	.	G	T	1	3	4	0	0	4	0	0
1	41492026	.	A	G	1	5	6	0	0	6	0	0
1	41492032	.	A	G	1	0	1	0	5	6	0	0
1	41596182	.	A	G	1	4	5	0	0	5	0	0
1	41596199	.	A	G	1	4	5	0	0	5	0	0
1	41596220	.	A	G	1	0	1	0	3	4	0	0
1	41596291	.	C	T	2	2	4	0	0	4	0	0
1	41604931	.	C	G	5	0	5	0	4	9	0	0
1	41604934	.	C	G	5	1	6	0	5	11	0	0
1	41604985	.	G	A	1	6	7	0	2	9	0	0
1	41605011	.	T	C	3	4	7	0	0	7	0	0
1	41605675	.	G	A	1	4	5	0	0	5	0	0
1	41605715	.	T	C	3	3	6	0	0	6	0	0
1	41615874	.	C	T	4	2	6	0	0	6	0	0
1	41615904	.	T	C	5	2	7	0	0	7	0	0
1	41615949	.	T	C	0	2	2	0	1	3	0	0
1	41616081	.	T	G	2	2	4	0	1	5	0	0
1	41616109	.	G	A	3	3	6	0	1	7	0	0
1	41744007	.	G	A	1	2	3	0	0	3	0	0
1	41744046	.	C	T	2	3	5	0	0	5	0	0
1	41755379	.	T	A	1	2	3	0	0	3	0	0
1	41770872	.	T	C	4	4	8	0	0	8	0	0
1	41770959	.	T	C	3	3	6	0	1	7	0	0
1	41859746	.	C	T	6	12	18	0	2	20	0	0
1	41860298	.	A	C	19	16	35	0	2	37	0	0
1	41862446	.	C	G	11	0	11	1	23	35	0	0
1	41958330	.	T	C	2	3	5	0	1	6	0	0
1	41958356	.	C	T	4	4	8	0	0	8	0	0
1	41959749	.	G	A	2	3	5	0	0	5	0	0
1	42375071	.	C	T	1	2	3	0	0	3	0	0
1	42776652	.	T	C	18	17	35	0	4	39	0	0
1	42776787	.	C	T	4	17	21	0	18	39	0	0
1	42776806	.	A	T	18	22	40	0	1	41	0	0
1	42776853	.	T	C	21	21	42	0	0	42	0	0
1	42776906	.	A	G	23	14	37	0	3	40	0	0
1	42777116	.	G	A	14	11	25	0	2	27	0	0
1	42777146	.	C	G	2	10	12	0	13	25	0	0
1	42777383	.	A	G	10	10	20	0	1	21	0	0
1	42777593	.	T	G	9	9	18	0	1	19	0	0
1	42777674	.	G	A	7	7	14	0	0	14	0	0
1	42882955	.	C	T	2	3	5	0	0	5	0	0
1	43034869	.	T	C	14	16	30	0	0	30	0	0
1	43035178	.	T	C	18	18	36	0	1	37	0	0
1	43035444	.	A	T	9	16	25	0	1	26	0	0
1	43035546	.	T	A	10	7	17	0	0	17	0	0
1	43652740	.	C	G	2	18	20	0	28	48	0	0
1	43659248	.	C	T	3	33	36	0	22	58	0	0
1	43670083	.	A	G	28	23	51	0	1	52	0	0
1	43670378	.	C	T	1	15	16	0	16	32	0	0
1	43675337	.	A	G	7	18	25	0	2	27	0	0
1	43994777	.	G	T	2	2	4	0	2	6	0	0
1	43994796	.	T	G	3	2	5	0	0	5	0	0
1	44000868	.	T	C	1	0	1	0	2	3	0	0
1	44000898	.	C	T	1	2	3	0	0	3	0	0
1	44011563	.	A	G	2	5	7	0	1	8	0	0
1	44021800	.	G	T	4	2	6	0	0	6	0	0
1	44021837	.	A	C	5	0	5	0	5	10	0	0
1	44022017	.	C	G	9	5	14	0	0	14	0	0
1	44027709	.	T	G	4	2	6	0	0	6	0	0
1	44027801	.	C	T	0	10	10	0	4	14	0	0
1	44027813	.	T	G	4	9	13	0	0	13	0	0
1	44027908	.	A	G	7	9	16	0	1	17	0	0
1	44028734	.	G	A	2	2	4	0	0	4	0	0
1	44040606	.	G	A	2	3	5	0	0	5	0	0
1	44040854	.	T	C	6	6	12	0	0	12	0	0
1	44041376	.	A	G	4	6	10	0	0	10	0	0
1	44041385	.	T	A	5	6	11	0	0	11	0	0
1	44041450	.	T	A	5	4	9	0	0	9	0	0
1	44046126	.	G	A	3	3	6	0	1	7	0	0
1	44048179	.	C	T	1	2	3	0	4	7	0	0
1	44048263	.	C	T	8	4	12	0	1	13	0	0
1	44210620	.	C	T	3	4	7	1	0	8	0	0
1	44227298	.	T	G	3	4	7	0	1	8	0	0
1	44227346	.	C	T	1	6	7	0	0	7	0	0
1	44227420	.	A	T	2	5	7	0	1	8	0	0
1	44227740	.	A	G	6	4	10	0	1	11	0	0
1	44227764	.	G	T	6	8	14	0	0	14	0	0
1	44227812	.	T	C	4	10	14	0	1	15	0	0
1	44228243	.	T	G	7	8	15	0	1	16	0	0
1	44228255	.	C	T	5	11	16	0	0	16	0	0
1	44228705	.	C	T	5	4	9	0	3	12	0	0
1	44390558	.	A	G	9	18	27	0	6	33	0	0
1	44390643	.	G	A	1	17	18	0	18	36	0	0
1	44393977	.	T	C	19	11	30	0	1	31	0	0
1	44394276	.	A	T	9	11	20	0	1	21	0	0
1	44394329	.	T	G	4	4	8	0	0	8	0	0
1	44394390	.	G	A	1	3	4	0	0	4	0	0
1	44492030	.	C	A	3	5	8	0	0	8	0	0
1	44492413	.	C	T	8	7	15	0	0	15	0	0
1	44492429	.	T	C	8	5	13	0	0	13	0	0
1	44492626	.	A	C	12	9	21	0	0	21	0	0
1	44492842	.	G	T	3	11	14	0	2	16	0	0
1	44492875	.	A	T	8	13	21	0	0	21	0	0
1	44493022	.	T	G	9	10	19	0	1	20	0	0
1	44493382	.	G	T	3	17	20	0	19	39	0	0
1	44493485	.	T	C	22	18	40	0	1	41	0	0
1	44493554	.	T	C	15	13	28	0	0	28	0	0
1	44493952	.	G	A	3	23	26	0	18	44	0	0
1	44493971	.	G	A	21	23	44	0	1	45	0	0
1	44494027	.	A	T	29	16	45	0	2	47	0	0
1	44494153	.	C	T	32	25	57	0	0	58	1	0
1	44494337	.	C	G	9	11	20	0	2	22	0	0
1	44494506	.	G	T	19	11	30	0	1	31	0	0
1	44494695	.	C	T	27	10	37	0	0	37	0	0
1	44494818	.	G	A	1	21	22	0	24	46	0	0
1	44494834	.	A	G	23	23	46	0	1	47	0	0
1	44494913	.	G	A	26	18	44	1	2	47	0	0
1	44494924	.	C	T	31	12	43	1	1	45	0	0
1	44495258	.	C	T	19	30	49	0	1	50	0	0
1	44495269	.	T	A	16	30	46	0	1	47	0	0
1	44540607	.	G	A	1	2	3	0	0	3	0	0
1	44554101	.	G	A	0	6	6	0	2	8	0	0
1	44554143	.	A	G	4	3	7	0	0	7	0	0
1	44558999	.	C	T	2	3	5	0	0	5	0	0
1	44559103	.	C	T	2	6	8	0	0	8	0	0
1	44559352	.	G	A	12	4	16	0	0	16	0	0
1	44559395	.	A	C	10	5	15	0	0	15	0	0
1	44564869	.	T	C	9	5	14	0	0	14	0	0
1	44564935	.	C	T	10	6	16	0	3	19	0	0
1	44565025	.	C	T	9	4	13	0	1	14	0	0
1	44565111	.	T	C	7	6	13	0	0	13	0	0
1	44565407	.	A	C	4	8	12	0	1	13	0	0
1	44565479	.	C	T	9	11	20	0	0	20	0	0
1	44566133	.	C	A	10	13	23	0	1	24	0	0
1	44569458	.	G	A	18	8	26	0	1	27	0	0
1	44569717	.	C	T	4	12	16	0	12	28	0	0
1	44569822	.	G	A	4	5	9	0	0	9	0	0
1	44570716	.	A	G	6	11	17	0	2	19	0	0
1	44570740	.	C	T	9	6	15	0	3	18	0	0
1	44571114	.	T	A	4	5	9	0	1	10	0	0
1	44571202	.	T	C	4	3	7	0	0	7	0	0
1	44571352	.	T	C	5	4	9	0	1	10	0	0
1	44571370	.	C	T	0	8	8	0	5	13	0	0
1	44571520	.	C	T	5	2	7	0	1	8	0	0
1	44571522	.	G	A	5	2	7	0	1	8	0	0
1	44571583	.	A	G	5	4	9	0	1	10	0	0
1	44571672	.	C	T	0	4	4	0	5	9	0	0
1	44571708	.	A	T	9	3	12	4	0	16	0	0
1	44575448	.	T	C	9	4	13	0	0	13	0	0
1	44582513	.	C	T	6	4	10	0	0	10	0	0
1	44582576	.	G	A	0	10	10	0	10	20	0	0
1	44582657	.	G	A	10	3	13	0	1	14	0	0
1	44591232	.	C	A	8	5	13	0	2	15	0	0
1	44651929	.	G	C	4	2	6	0	22	28	0	0
1	44652498	.	A	G	21	31	52	0	0	52	0	0
1	44652511	.	A	C	24	23	47	0	3	50	0	0
1	44652599	.	T	C	17	0	17	0	22	39	0	0
1	44652916	.	T	A	11	22	33	0	0	33	0	0
1	44653014	.	C	T	29	19	48	0	1	49	0	0
1	44653076	.	A	T	22	24	46	0	2	48	0	0
1	44653135	.	T	A	17	11	28	0	1	29	0	0
1	44653150	.	T	A	13	17	30	0	0	30	0	0
1	44653171	.	A	G	12	13	25	0	1	26	0	0
1	44658849	.	T	C	10	0	10	0	19	29	0	0
1	44669970	.	G	T	1	5	6	0	0	6	0	0
1	44672271	.	G	A	2	3	5	0	0	5	0	0
1	44672571	.	G	A	1	4	5	0	0	5	0	0
1	44729413	.	C	T	2	5	7	0	0	7	0	0
1	44729449	.	G	C	4	6	10	0	0	10	0	0
1	44729479	.	C	G	4	7	11	0	2	13	0	0
1	44737473	.	G	A	1	12	13	0	7	20	0	0
1	44737588	.	A	T	6	3	9	0	0	9	0	0
1	44737598	.	T	A	6	2	8	0	1	9	0	0
1	44737653	.	A	T	5	6	11	0	0	11	0	0
1	44737750	.	T	A	2	4	6	0	0	6	0	0
1	44816363	.	A	G	8	1	9	0	10	19	0	0
1	44816380	.	G	A	6	7	13	0	4	17	0	0
1	44818992	.	A	G	15	0	15	0	12	27	0	0
1	44846997	.	G	A	1	2	3	0	0	3	0	0
1	44849126	.	C	T	2	2	4	0	0	4	0	0
1	44852737	.	G	C	2	2	4	0	0	4	0	0
1	44852817	.	G	A	2	2	4	0	0	4	0	0
1	44861744	.	C	T	7	10	17	0	0	17	0	0
1	44861954	.	A	T	7	5	12	0	0	12	0	0
1	44862092	.	C	G	16	8	24	0	4	28	0	0
1	44862707	.	C	T	9	7	16	1	0	17	0	0
1	44862725	.	G	A	11	6	17	0	0	17	0	0
1	44869068	.	G	A	16	9	25	2	1	28	0	0
1	44869115	.	C	T	23	12	35	1	2	38	0	0
1	44869173	.	A	T	18	14	32	0	2	34	0	0
1	44869174	.	C	T	18	13	31	0	3	34	0	0
1	44869216	.	G	A	9	9	18	0	3	21	0	0
1	44869621	.	G	A	14	11	25	0	1	26	0	0
1	44869638	.	A	G	10	14	24	0	1	25	0	0
1	44869666	.	C	A	18	12	30	0	0	30	0	0
1	44869810	.	T	C	10	9	19	0	0	19	0	0
1	44872586	.	A	G	9	6	15	0	2	17	0	0
1	44872726	.	A	T	2	6	8	0	0	8	0	0
1	44872735	.	C	T	6	2	8	0	0	8	0	0
1	44872817	.	A	G	5	2	7	0	0	7	0	0
1	44889081	.	T	C	2	1	3	0	2	5	0	0
1	44893894	.	G	T	2	2	4	0	0	4	0	0
1	44925956	.	C	T	1	4	5	0	0	5	0	0
1	44959408	.	C	A	3	2	5	0	2	7	0	0
1	44959825	.	C	T	6	4	10	0	0	10	0	0
1	44959876	.	T	C	4	3	7	0	0	7	0	0
1	44959916	.	C	A	6	2	8	0	0	8	0	0
1	44960175	.	T	C	3	2	5	0	0	5	0	0
1	44961037	.	C	T	7	3	10	0	0	10	0	0
1	44961092	.	T	A	1	4	5	0	0	5	0	0
1	44961238	.	T	A	7	3	10	0	1	11	0	0
1	44961269	.	C	A	9	6	15	0	1	16	0	0
1	44961563	.	G	A	1	2	3	0	0	3	0	0
1	44961684	.	T	G	4	7	11	0	1	12	0	0
1	44961869	.	C	A	14	10	24	0	1	25	0	0
1	44961899	.	G	A	8	19	27	0	1	28	0	0
1	44961992	.	G	A	11	11	22	0	1	23	0	0
1	44962036	.	T	A	6	12	18	0	2	20	0	0
1	44962358	.	G	A	11	5	16	2	0	18	0	0
1	45004836	.	C	T	3	2	5	0	0	5	0	0
1	45011601	.	C	T	3	5	8	0	1	9	0	0
1	45013760	.	A	G	3	0	3	0	8	11	0	0
1	45013775	.	T	C	3	7	10	0	0	10	0	0
1	45013965	.	T	C	5	3	8	0	1	9	0	0
1	45014176	.	G	A	8	5	13	0	0	13	0	0
1	45014263	.	A	G	3	6	9	0	0	9	0	0
1	45014651	.	T	C	8	9	17	0	0	17	0	0
1	45014668	.	A	C	9	9	18	0	0	18	0	0
1	45014692	.	G	C	8	12	20	0	0	20	0	0
1	45014880	.	C	T	9	9	18	0	0	18	0	0
1	45014961	.	G	A	8	10	18	0	3	21	0	0
1	45015654	.	T	C	6	5	11	0	10	21	0	0
1	45015693	.	C	T	14	6	20	4	1	25	0	0
1	45015809	.	A	G	4	9	13	0	1	14	0	0
1	45015827	.	G	C	3	7	10	0	0	10	0	0
1	45016070	.	C	T	12	15	27	0	0	27	0	0
1	45016502	.	T	A	11	19	30	0	2	32	0	0
1	45016691	.	T	A	20	15	35	0	0	35	0	0
1	45016905	.	G	A	29	15	44	0	1	45	0	0
1	45022114	.	G	A	8	16	24	3	1	28	0	0
1	45038727	.	C	T	2	2	4	0	0	4	0	0
1	45038733	.	G	A	1	2	3	0	1	4	0	0
1	45039608	.	T	C	3	2	5	0	0	5	0	0
1	45047052	.	G	A	30	29	59	0	7	66	0	0
1	45048948	.	G	A	42	26	68	0	5	73	0	0
1	45085212	.	C	T	16	15	31	0	2	33	0	0
1	45086309	.	T	C	20	16	36	0	0	36	0	0
1	45086405	.	G	C	22	20	42	0	2	44	0	0
1	45093732	.	A	C	24	23	47	0	1	49	1	0
1	45093762	.	A	G	17	27	44	0	1	45	0	0
1	45093769	.	A	T	17	31	48	0	0	48	0	0
1	45093857	.	A	G	19	22	41	0	1	42	0	0
1	45095256	.	C	A	2	2	4	0	0	4	0	0
1	45095259	.	C	G	2	2	4	0	0	4	0	0
1	45096499	.	T	A	5	2	7	0	0	7	0	0
1	45208168	.	G	A	21	19	40	0	0	40	0	0
1	45208357	.	A	G	8	12	20	0	0	20	0	0
1	45208360	.	A	T	8	10	18	0	1	19	0	0
1	45208407	.	G	A	8	8	16	0	0	16	0	0
1	45211196	.	C	T	1	8	9	0	6	15	0	0
1	45211220	.	A	T	7	12	19	0	0	19	0	0
1	45211431	.	G	A	8	6	14	0	0	14	0	0
1	45211602	.	G	A	3	4	7	0	0	7	0	0
1	45213290	.	G	A	6	7	13	0	0	13	0	0
1	45323214	.	G	A	9	3	12	0	0	12	0	0
1	45327405	.	T	C	7	7	14	0	2	16	0	0
1	45330165	.	A	C	9	10	19	0	0	19	0	0
1	45330174	.	C	T	9	11	20	0	1	21	0	0
1	45330207	.	C	T	9	11	20	0	0	20	0	0
1	45330235	.	A	C	13	9	22	0	0	22	0	0
1	45330285	.	C	T	11	9	20	0	0	20	0	0
1	45330386	.	T	G	6	1	7	0	8	15	0	0
1	45332833	.	A	T	13	11	24	0	0	24	0	0
1	45333057	.	G	A	18	11	29	0	3	32	0	0
1	45333076	.	G	A	19	15	34	1	1	36	0	0
1	45335160	.	G	A	8	13	21	0	1	22	0	0
1	45337322	.	T	A	5	6	11	0	0	11	0	0
1	45339267	.	A	T	5	2	7	0	0	7	0	0
1	45340851	.	G	A	3	4	7	0	0	7	0	0
1	45366137	.	A	T	8	5	13	3	1	17	0	0
1	45366304	.	C	T	1	5	6	0	0	7	1	0
1	45373795	.	A	G	21	15	36	0	1	37	0	0
1	45373912	.	A	G	17	14	31	0	1	32	0	0
1	45374309	.	C	G	7	8	15	0	0	15	0	0
1	45374847	.	A	T	10	12	22	0	0	22	0	0
1	45375271	.	C	T	4	4	8	1	0	10	1	0
1	45375666	.	G	A	4	6	10	0	1	11	0	0
1	45375790	.	C	A	4	2	6	0	0	6	0	0
1	45376413	.	G	A	11	9	20	0	0	20	0	0
1	45377427	.	C	T	0	5	5	0	5	10	0	0
1	45553602	.	G	T	3	2	5	0	1	6	0	0
1	45570225	.	T	A	14	20	34	0	6	40	0	0
1	45570384	.	T	A	17	18	35	0	1	36	0	0
1	45570439	.	A	C	13	0	13	0	18	31	0	0
1	45570523	.	T	C	18	15	33	0	2	35	0	0
1	45574320	.	C	T	1	13	14	0	12	26	0	0
1	45574347	.	T	C	10	0	10	0	13	23	0	0
1	45574650	.	G	A	7	6	13	0	0	13	0	0
1	45575852	.	C	T	0	5	5	0	7	12	0	0
1	45576188	.	C	T	4	4	8	0	0	8	0	0
1	45577774	.	G	T	7	3	10	0	0	10	0	0
1	45616925	.	G	A	22	22	44	0	2	46	0	0
1	45617226	.	C	A	18	16	34	0	0	34	0	0
1	45617239	.	A	G	17	18	35	0	0	35	0	0
1	45617478	.	T	A	16	31	47	0	4	51	0	0
1	45617577	.	T	A	23	20	43	0	1	45	1	0
1	45617657	.	A	T	23	14	37	0	4	41	0	0
1	45617743	.	C	T	15	17	32	0	1	33	0	0
1	45622431	.	T	C	7	13	20	0	1	21	0	0
1	45624171	.	A	G	8	17	25	0	0	25	0	0
1	45631469	.	G	A	7	5	12	0	1	13	0	0
1	45663869	.	C	T	1	4	5	0	0	5	0	0
1	45663883	.	T	G	1	3	4	0	0	4	0	0
1	45663968	.	A	G	1	0	1	0	3	4	0	0
1	45663975	.	G	A	1	2	3	0	0	3	0	0
1	45664158	.	A	G	8	0	8	0	9	17	0	0
1	45664224	.	C	T	10	10	20	0	0	20	0	0
1	45668727	.	T	A	8	7	15	0	1	16	0	0
1	45668754	.	C	T	8	10	18	0	0	18	0	0
1	45668988	.	T	C	3	4	7	0	0	7	0	0
1	45669066	.	A	T	4	4	8	0	1	9	0	0
1	45669157	.	A	T	6	4	10	0	0	11	1	0
1	45699930	.	C	T	4	5	9	0	4	13	0	0
1	45700396	.	G	A	2	3	5	0	1	6	0	0
1	45730896	.	A	T	3	4	7	0	0	7	0	0
1	45736585	.	G	T	1	2	3	0	0	3	0	0
1	45737493	.	T	C	7	3	10	0	0	10	0	0
1	45738289	.	A	G	4	4	8	0	0	8	0	0
1	45738354	.	A	T	2	4	6	0	1	7	0	0
1	45738417	.	G	A	0	5	5	0	6	11	0	0
1	45738528	.	C	T	1	4	5	0	0	5	0	0
1	45741220	.	A	G	1	0	1	0	3	4	0	0
1	45742715	.	T	G	1	3	4	0	0	4	0	0
1	45742749	.	G	T	1	2	3	0	0	3	0	0
1	45742865	.	G	C	1	3	4	0	0	5	1	0
1	45742866	.	G	T	2	3	5	0	0	5	0	0
1	45743584	.	C	T	1	4	5	0	0	5	0	0
1	45743636	.	A	T	4	4	8	0	0	8	0	0
1	45743862	.	G	T	3	2	5	0	0	5	0	0
1	45743869	.	G	C	3	3	6	0	0	6	0	0
1	45743935	.	A	G	0	4	4	0	0	4	0	0
1	45743999	.	T	C	2	2	4	0	0	4	0	0
1	45744017	.	A	G	2	2	4	0	0	4	0	0
1	45744091	.	C	T	9	4	13	0	0	13	0	0
1	45744278	.	A	T	15	12	27	1	0	28	0	0
1	45744678	.	C	G	4	2	6	0	0	6	0	0
1	45833589	.	T	C	1	3	4	0	0	4	0	0
1	45834223	.	A	C	1	2	3	0	0	3	0	0
1	45834658	.	C	T	4	4	8	0	0	8	0	0
1	45834990	.	A	T	1	5	6	0	0	6	0	0
1	45835389	.	G	A	3	4	7	0	2	9	0	0
1	45835483	.	C	G	3	3	6	0	0	6	0	0
1	45835486	.	G	A	3	3	6	0	0	6	0	0
1	45835542	.	A	C	4	2	6	0	0	6	0	0
1	45835815	.	G	A	4	4	8	0	1	9	0	0
1	45836038	.	A	T	2	4	6	0	0	6	0	0
1	45867362	.	T	C	9	10	19	0	2	21	0	0
1	45867594	.	T	A	9	4	13	0	0	13	0	0
1	45867618	.	A	T	11	11	22	0	1	23	0	0
1	45867759	.	C	T	12	14	26	0	2	28	0	0
1	45867834	.	C	T	16	16	32	0	1	33	0	0
1	45867979	.	C	T	21	18	39	0	2	41	0	0
1	45868730	.	T	A	19	6	25	0	3	28	0	0
1	45869275	.	T	C	14	13	27	0	1	28	0	0
1	45869588	.	A	C	5	17	22	0	0	22	0	0
1	45869698	.	T	A	9	5	14	0	0	14	0	0
1	45870133	.	C	A	0	4	4	0	4	8	0	0
1	45870147	.	G	T	4	4	8	0	1	9	0	0
1	45870168	.	G	T	3	4	7	0	0	7	0	0
1	45870223	.	A	G	7	5	12	0	1	13	0	0
1	45870438	.	C	T	9	4	13	0	0	13	0	0
1	45870483	.	C	T	4	6	10	0	1	11	0	0
1	45870644	.	A	G	7	9	16	0	1	17	0	0
1	45871331	.	T	C	7	4	11	0	1	12	0	0
1	45871721	.	A	G	4	2	6	0	0	6	0	0
1	45892097	.	G	A	2	2	4	0	0	4	0	0
1	45923230	.	C	T	3	3	6	0	0	6	0	0
1	45923654	.	C	A	1	2	3	0	2	5	0	0
1	45923713	.	C	T	4	4	8	0	0	8	0	0
1	45923780	.	A	G	2	3	5	0	0	5	0	0
1	45935510	.	G	A	5	4	9	0	0	9	0	0
1	45935642	.	T	C	2	10	12	0	0	12	0	0
1	45935729	.	C	T	6	8	14	0	0	14	0	0
1	45935816	.	G	A	1	5	6	0	4	10	0	0
1	45935849	.	G	A	1	4	5	0	1	6	0	0
1	45939802	.	G	A	0	2	2	0	2	4	0	0
1	45939811	.	A	G	3	0	3	0	2	5	0	0
1	45941557	.	G	A	3	6	9	0	1	10	0	0
1	45944281	.	A	G	1	3	4	0	2	6	0	0
1	45946462	.	T	C	3	5	8	0	1	9	0	0
1	45948157	.	G	A	6	3	9	0	0	9	0	0
1	45950531	.	G	A	2	5	7	0	0	7	0	0
1	45952797	.	C	T	3	2	5	0	0	5	0	0
1	45953009	.	C	T	6	8	14	0	0	14	0	0
1	45955464	.	C	G	16	0	16	0	16	32	0	0
1	45956166	.	G	T	15	12	27	2	0	29	0	0
1	45956241	.	T	C	16	12	28	1	0	29	0	0
1	46002208	.	G	A	3	2	5	0	0	5	0	0
1	46004859	.	C	A	2	1	3	0	1	4	0	0
1	46004865	.	A	G	2	0	2	0	2	4	0	0
1	46010347	.	A	T	3	3	6	0	0	6	0	0
1	46010519	.	G	A	5	2	7	0	1	8	0	0
1	46010561	.	T	C	3	7	10	0	0	10	0	0
1	46010564	.	G	C	3	7	10	0	0	10	0	0
1	46015180	.	T	C	2	2	4	0	1	5	0	0
1	46019562	.	G	A	5	6	11	0	0	11	0	0
1	46019850	.	C	T	5	6	11	0	0	11	0	0
1	46019889	.	G	C	11	6	17	0	0	17	0	0
1	46195107	.	A	G	7	0	7	0	7	14	0	0
1	46195284	.	C	T	8	6	14	0	1	15	0	0
1	46195858	.	A	T	6	6	12	0	1	13	0	0
1	46195888	.	T	C	6	6	12	0	1	13	0	0
1	46196056	.	G	A	3	3	6	0	0	6	0	0
1	46263895	.	T	C	14	8	22	0	2	24	0	0
1	46263949	.	T	G	15	8	23	2	2	27	0	0
1	46264213	.	G	A	11	18	29	0	1	30	0	0
1	46264335	.	A	T	13	14	27	0	0	27	0	0
1	46265245	.	C	T	3	9	12	0	3	15	0	0
1	46265967	.	C	T	1	2	3	0	4	7	0	0
1	46266020	.	G	A	3	4	7	0	0	7	0	0
1	46266232	.	A	G	4	7	11	0	1	12	0	0
1	46266247	.	T	C	6	5	11	0	0	11	0	0
1	46266283	.	G	A	5	5	10	0	0	10	0	0
1	46266463	.	C	A	2	2	4	0	0	4	0	0
1	46266489	.	C	G	2	0	2	0	0	6	4	0
1	46266519	.	C	T	3	3	6	0	0	6	0	0
1	46266720	.	A	G	2	3	5	0	0	5	0	0
1	46267885	.	C	T	2	3	5	0	0	5	0	0
1	46267907	.	T	A	3	2	5	0	1	6	0	0
1	46267926	.	G	A	1	4	5	0	0	5	0	0
1	46268037	.	C	T	0	4	4	0	1	5	0	0
1	46268094	.	G	A	1	1	2	0	1	3	0	0
1	46268401	.	T	A	1	2	3	0	0	3	0	0
1	46269643	.	T	C	2	2	4	0	0	4	0	0
1	46444433	.	T	C	10	7	17	0	0	17	0	0
1	46446613	.	C	T	9	6	15	0	1	16	0	0
1	46449612	.	C	A	2	3	5	0	0	5	0	0
1	46449800	.	C	G	6	6	12	0	0	12	0	0
1	46450177	.	A	T	4	5	9	0	0	9	0	0
1	46450203	.	A	T	4	2	6	0	0	6	0	0
1	46582562	.	T	C	9	12	21	0	0	21	0	0
1	46590147	.	C	T	2	11	13	0	1	14	0	0
1	46593987	.	T	G	7	10	17	0	4	21	0	0
1	46598819	.	C	T	1	3	4	0	0	4	0	0
1	46611975	.	C	T	6	6	12	0	0	12	0	0
1	46611999	.	C	T	4	4	8	0	1	9	0	0
1	46613489	.	C	T	16	13	29	0	1	30	0	0
1	46615881	.	G	A	20	7	27	0	3	30	0	0
1	46616015	.	G	A	13	16	29	0	1	30	0	0
1	46616152	.	T	C	13	15	28	0	4	32	0	0
1	46616343	.	A	T	18	20	38	0	1	39	0	0
1	46616736	.	T	C	4	6	10	0	0	10	0	0
1	46616863	.	C	T	14	19	33	0	2	35	0	0
1	46617141	.	G	A	2	15	17	0	6	23	0	0
1	46617346	.	G	A	5	8	13	1	0	14	0	0
1	46617468	.	A	C	2	4	6	5	1	12	0	0
1	46617591	.	A	G	4	6	10	0	0	10	0	0
1	46619720	.	C	T	7	8	15	0	0	15	0	0
1	46636184	.	G	A	4	4	8	1	0	10	1	0
1	46666782	.	A	G	6	4	10	0	0	10	0	0
1	46667668	.	A	G	14	12	26	0	3	29	0	0
1	46668740	.	G	A	7	14	21	0	1	22	0	0
1	46668747	.	T	A	11	10	21	0	3	24	0	0
1	46668901	.	C	T	1	16	17	0	7	24	0	0
1	46669151	.	G	A	12	8	20	0	0	20	0	0
1	46710699	.	A	G	9	10	19	0	0	19	0	0
1	46710960	.	A	G	5	4	9	0	0	9	0	0
1	46711002	.	C	T	5	7	12	0	0	12	0	0
1	46711043	.	C	A	1	7	8	0	6	14	0	0
1	46711175	.	A	G	6	7	13	0	0	13	0	0
1	46715534	.	A	T	3	4	7	0	0	7	0	0
1	46725909	.	C	T	9	15	24	0	1	25	0	0
1	46830911	.	A	G	1	3	4	0	0	4	0	0
1	46831057	.	C	A	5	5	10	0	0	10	0	0
1	46831091	.	G	A	8	5	13	0	2	15	0	0
1	46831168	.	C	T	10	9	19	0	0	19	0	0
1	46831258	.	T	C	5	4	9	0	0	9	0	0
1	46831357	.	G	A	11	5	16	0	0	16	0	0
1	46831481	.	C	T	0	5	5	0	9	14	0	0
1	46831516	.	C	T	0	5	5	0	10	15	0	0
1	46832847	.	C	T	0	3	3	0	1	4	0	0
1	46837955	.	T	A	21	18	39	0	3	43	1	0
1	46838048	.	T	A	25	18	43	0	0	43	0	0
1	46838050	.	A	G	18	23	41	0	1	42	0	0
1	46838194	.	C	G	2	15	17	0	15	32	0	0
1	46838219	.	T	C	10	17	27	0	1	28	0	0
1	46838432	.	A	C	9	14	23	1	2	26	0	0
1	46838768	.	G	C	8	1	9	0	7	17	1	0
1	46841702	.	A	C	3	0	3	0	5	8	0	0
1	46841783	.	G	A	7	8	15	0	2	17	0	0
1	46857049	.	G	A	4	3	7	0	1	8	0	0
1	46964006	.	A	T	3	0	3	0	1	4	0	0
1	46986915	.	C	T	1	2	3	0	3	6	0	0
1	46986949	.	C	T	1	2	3	0	0	3	0	0
1	46989218	.	C	T	2	2	4	0	0	4	0	0
1	46989471	.	G	A	1	2	3	0	0	3	0	0
1	46999673	.	G	A	4	3	7	0	0	7	0	0
1	46999750	.	G	A	7	4	11	0	0	11	0	0
1	46999838	.	C	G	0	9	9	0	4	13	0	0
1	47002506	.	C	T	2	3	5	0	0	5	0	0
1	47005189	.	G	A	3	2	5	0	1	6	0	0
1	47007121	.	C	T	0	2	2	0	5	7	0	0
1	47019906	.	C	T	1	7	8	0	11	19	0	0
1	47022573	.	G	A	5	2	7	0	0	7	0	0
1	47022576	.	C	T	2	4	6	0	0	6	0	0
1	47047289	.	C	T	1	1	2	0	1	3	0	0
1	47091796	.	T	A	1	1	2	0	1	3	0	0
1	47091801	.	G	T	0	2	2	0	2	4	0	0
1	47092853	.	T	C	1	2	3	0	0	3	0	0
1	47093733	.	T	A	2	2	4	0	0	4	0	0
1	47095814	.	G	A	1	4	5	0	6	11	0	0
1	47098897	.	C	T	1	5	6	0	0	6	0	0
1	47104622	.	G	A	2	8	10	0	9	19	0	0
1	47104637	.	G	A	9	3	12	0	2	14	0	0
1	47104660	.	T	C	7	3	10	0	1	11	0	0
1	47104807	.	A	G	1	4	5	0	0	5	0	0
1	47104812	.	T	G	2	0	2	0	3	5	0	0
1	47104852	.	G	T	1	3	4	0	2	6	0	0
1	47104865	.	C	T	4	4	8	0	0	8	0	0
1	47105163	.	A	T	1	3	4	0	0	4	0	0
1	47106522	.	C	T	7	6	13	0	6	19	0	0
1	47106614	.	A	C	18	7	25	0	0	25	0	0
1	47106668	.	G	C	17	9	26	0	0	26	0	0
1	47106677	.	T	C	20	8	28	0	0	28	0	0
1	47106894	.	C	T	13	15	28	0	0	28	0	0
1	47106947	.	A	G	8	10	18	0	2	20	0	0
1	47108653	.	T	C	6	5	11	0	1	12	0	0
1	47111469	.	A	T	7	8	15	0	0	15	0	0
1	47113442	.	G	A	9	3	12	0	0	12	0	0
1	47116758	.	T	C	3	9	12	0	1	13	0	0
1	47116910	.	T	C	2	0	2	0	5	7	0	0
1	47120285	.	C	A	1	2	3	0	0	3	0	0
1	47120456	.	T	A	1	2	3	0	0	3	0	0
1	47125668	.	C	T	15	6	21	0	2	23	0	0
1	47130068	.	A	T	11	9	20	1	1	22	0	0
1	47130190	.	A	G	9	3	12	0	1	13	0	0
1	47130255	.	C	T	4	6	10	0	0	10	0	0
1	47135165	.	G	A	3	8	11	0	1	12	0	0
1	47156224	.	A	G	1	4	5	0	0	5	0	0
1	47159025	.	G	C	4	7	11	1	0	12	0	0
1	47168422	.	T	C	1	2	3	0	0	3	0	0
1	47170607	.	A	T	1	3	4	0	0	4	0	0
1	47170695	.	C	T	2	2	4	0	0	4	0	0
1	47171266	.	C	T	2	2	4	0	0	4	0	0
1	47171298	.	A	C	3	5	8	0	0	8	0	0
1	47171504	.	C	T	5	2	7	0	0	7	0	0
1	47171519	.	T	G	5	3	8	0	0	8	0	0
1	47171564	.	T	C	3	2	5	0	0	5	0	0
1	47171658	.	T	C	7	1	8	0	0	8	0	0
1	47172103	.	G	A	1	3	4	0	7	11	0	0
1	47172236	.	T	A	5	5	10	0	1	12	1	0
1	47172426	.	G	A	5	1	6	0	2	8	0	0
1	47172465	.	G	A	5	9	14	0	0	14	0	0
1	47172470	.	T	A	4	9	13	0	1	14	0	0
1	47172873	.	A	C	5	4	9	0	0	9	0	0
1	47172909	.	G	T	2	2	4	0	0	4	0	0
1	47406936	.	G	A	6	7	13	0	1	14	0	0
1	47407541	.	C	T	7	6	13	0	3	16	0	0
1	47407601	.	C	T	7	6	13	0	0	13	0	0
1	47407607	.	T	C	6	4	10	0	0	10	0	0
1	47408802	.	C	T	11	6	17	0	2	19	0	0
1	47409873	.	C	A	9	10	19	0	0	19	0	0
1	47410043	.	G	A	1	12	13	0	12	25	0	0
1	47503622	.	T	A	3	5	8	0	0	8	0	0
1	47505064	.	T	A	4	7	11	0	0	11	0	0
1	47506986	.	C	T	9	6	15	0	1	16	0	0
1	47510820	.	G	A	5	12	17	0	0	17	0	0
1	47510862	.	C	T	6	9	15	0	0	15	0	0
1	47686681	.	A	C	1	2	3	0	0	3	0	0
1	48583001	.	T	C	3	2	5	0	1	6	0	0
1	48583115	.	T	C	1	5	6	0	0	6	0	0
1	49482046	.	T	C	6	3	9	1	1	11	0	0
1	49482106	.	T	C	2	4	6	0	1	8	1	0
1	49483555	.	T	C	9	8	17	0	1	18	0	0
1	49483563	.	T	C	10	6	16	0	1	17	0	0
1	50929349	.	A	C	0	1	1	0	2	3	0	0
1	51230098	.	T	C	5	9	14	0	0	14	0	0
1	52073807	.	C	G	2	2	4	0	0	4	0	0
1	52111494	.	C	T	6	9	15	0	2	17	0	0
1	52113225	.	T	C	3	0	3	0	6	9	0	0
1	52115814	.	G	A	4	6	10	0	0	10	0	0
1	52115880	.	G	C	1	7	8	0	0	8	0	0
1	52117007	.	T	C	4	0	4	0	4	8	0	0
1	52117112	.	C	G	3	6	9	0	0	9	0	0
1	52121311	.	A	G	1	2	3	0	0	3	0	0
1	52121404	.	C	T	2	5	7	0	0	7	0	0
1	52121405	.	T	G	2	5	7	0	0	7	0	0
1	52130225	.	A	T	2	6	8	0	0	8	0	0
1	52130232	.	C	T	6	2	8	0	0	8	0	0
1	52130268	.	G	A	1	4	5	0	2	7	0	0
1	52130347	.	T	A	4	2	6	0	2	8	0	0
1	52130372	.	C	G	2	2	4	0	0	4	0	0
1	52134992	.	G	A	8	4	12	0	1	13	0	0
1	52135185	.	T	C	13	8	21	0	0	21	0	0
1	52135254	.	T	C	8	8	16	0	1	17	0	0
1	52135303	.	T	C	8	8	16	0	0	16	0	0
1	52135384	.	T	C	6	5	11	0	0	11	0	0
1	52135862	.	A	G	4	7	11	0	1	12	0	0
1	52135928	.	G	C	11	7	18	0	0	18	0	0
1	52135971	.	T	A	10	8	18	0	1	19	0	0
1	52135997	.	G	A	12	6	18	0	1	19	0	0
1	52136190	.	G	A	9	13	22	0	0	22	0	0
1	52136323	.	G	A	9	6	15	0	0	15	0	0
1	52136379	.	T	A	3	7	10	0	0	10	0	0
1	52136454	.	A	C	8	16	24	0	1	25	0	0
1	52136762	.	A	C	15	16	31	0	0	31	0	0
1	52136917	.	A	C	17	15	32	0	3	35	0	0
1	52136974	.	T	A	12	19	31	0	0	31	0	0
1	52137013	.	T	A	2	14	16	0	0	16	0	0
1	52139909	.	T	A	3	4	7	0	2	9	0	0
1	52146021	.	A	T	4	2	6	0	0	6	0	0
1	52149619	.	A	C	7	6	13	0	0	13	0	0
1	52149952	.	A	G	6	0	6	0	5	11	0	0
1	52150029	.	T	C	11	4	15	0	0	15	0	0
1	52150674	.	A	G	5	3	8	0	0	8	0	0
1	52150680	.	A	G	4	4	8	0	0	8	0	0
1	52150974	.	A	G	3	6	9	0	0	9	0	0
1	52151649	.	A	G	10	3	13	0	2	15	0	0
1	52151740	.	G	A	2	8	10	0	12	22	0	0
1	52151882	.	A	G	8	14	22	0	1	23	0	0
1	52151985	.	A	G	3	5	8	0	0	8	0	0
1	52152027	.	C	T	4	1	5	0	0	5	0	0
1	52152043	.	A	G	2	3	5	0	0	5	0	0
1	52152121	.	A	G	13	8	21	0	0	21	0	0
1	52152131	.	A	G	13	14	27	0	0	27	0	0
1	52152165	.	A	G	15	8	23	0	0	23	0	0
1	52152406	.	A	C	13	15	28	0	0	28	0	0
1	52152617	.	C	T	23	16	39	0	1	40	0	0
1	52179039	.	G	T	4	2	6	0	0	6	0	0
1	52452197	.	G	A	7	14	21	0	0	21	0	0
1	52452275	.	G	T	8	12	20	0	2	22	0	0
1	52455885	.	C	G	6	16	22	0	0	22	0	0
1	52455908	.	G	A	15	5	20	0	0	20	0	0
1	52455960	.	C	T	12	12	24	0	0	24	0	0
1	52456002	.	G	A	11	11	22	0	0	22	0	0
1	52460737	.	C	T	6	8	14	0	0	14	0	0
1	52460739	.	T	C	6	8	14	0	0	14	0	0
1	52460906	.	T	C	7	4	11	0	0	11	0	0
1	52460944	.	G	T	7	3	10	0	0	10	0	0
1	52461114	.	A	G	3	7	10	0	0	10	0	0
1	52461183	.	C	T	8	3	11	0	0	11	0	0
1	52461195	.	G	A	7	7	14	0	0	14	0	0
1	52475840	.	A	G	2	0	2	0	3	5	0	0
1	52475955	.	C	T	2	2	4	0	0	4	0	0
1	52478381	.	C	T	5	2	7	0	0	7	0	0
1	52478513	.	C	T	2	2	4	0	0	4	0	0
1	52478538	.	G	A	0	2	2	0	1	3	0	0
1	52478600	.	A	T	1	5	6	0	0	6	0	0
1	52489974	.	G	A	0	5	5	0	5	10	0	0
1	52495001	.	T	C	0	3	3	1	0	4	0	0
1	52495004	.	T	A	2	2	4	1	0	5	0	0
1	52499807	.	A	G	3	2	5	0	1	6	0	0
1	52501213	.	A	C	4	0	4	0	3	7	0	0
1	52501510	.	G	T	1	2	3	0	0	3	0	0
1	52501522	.	G	A	1	2	3	0	0	3	0	0
1	52618138	.	G	A	1	3	4	0	5	9	0	0
1	52623681	.	G	A	4	2	6	0	2	8	0	0
1	52623783	.	C	T	5	7	12	0	0	12	0	0
1	52625804	.	T	C	6	4	10	0	1	11	0	0
1	52625807	.	C	T	6	3	9	0	1	10	0	0
1	52626782	.	A	T	11	8	19	0	2	21	0	0
1	52626790	.	C	T	10	5	15	0	0	15	0	0
1	52626922	.	C	T	5	3	8	0	1	9	0	0
1	52626998	.	A	T	6	4	10	0	3	13	0	0
1	52627007	.	T	G	8	5	13	0	0	13	0	0
1	52627044	.	T	G	12	6	18	0	0	18	0	0
1	52627568	.	A	T	25	14	39	0	0	39	0	0
1	52627609	.	A	T	22	14	36	0	6	42	0	0
1	52627697	.	T	G	18	19	37	0	2	39	0	0
1	52627984	.	T	C	14	16	30	0	3	33	0	0
1	52628178	.	G	A	2	12	14	1	15	30	0	0
1	52628305	.	T	C	6	10	16	0	1	17	0	0
1	52653894	.	T	C	2	4	6	0	0	6	0	0
1	52656234	.	G	A	2	2	4	0	0	4	0	0
1	52656648	.	C	T	4	4	8	0	0	8	0	0
1	52657799	.	T	G	2	4	6	0	0	6	0	0
1	52698955	.	C	T	4	5	9	0	0	9	0	0
1	52764873	.	G	T	11	10	21	0	0	21	0	0
1	52764914	.	C	T	13	6	19	0	0	19	0	0
1	52765120	.	T	A	14	12	26	0	0	26	0	0
1	52773239	.	G	A	11	14	25	0	1	26	0	0
1	52775619	.	A	C	10	8	18	0	1	19	0	0
1	52775649	.	A	G	14	8	22	0	1	23	0	0
1	52780566	.	C	T	5	5	10	0	0	10	0	0
1	52782090	.	C	T	8	6	14	0	0	14	0	0
1	52811937	.	A	T	7	4	11	0	0	11	0	0
1	52811940	.	C	T	6	4	10	0	1	11	0	0
1	52812219	.	C	G	6	6	12	0	0	12	0	0
1	52816085	.	G	A	20	6	26	0	1	27	0	0
1	52816438	.	C	T	17	5	22	0	0	22	0	0
1	52816740	.	A	T	20	12	32	0	3	35	0	0
1	52816749	.	G	A	2	12	14	0	24	38	0	0
1	52817988	.	C	T	22	9	31	0	4	35	0	0
1	52820489	.	C	T	27	10	37	0	5	42	0	0
1	53007848	.	G	A	0	2	2	0	3	5	0	0
1	53007935	.	A	G	3	5	8	0	0	8	0	0
1	53061153	.	C	G	6	5	11	0	1	12	0	0
1	53065587	.	G	A	1	3	4	0	4	8	0	0
1	53065611	.	G	T	5	4	9	0	0	9	0	0
1	53099687	.	A	G	4	3	7	0	1	8	0	0
1	53099735	.	C	A	5	7	12	0	0	12	0	0
1	53132842	.	G	C	6	5	11	0	0	11	0	0
1	53132860	.	T	C	5	4	9	0	0	9	0	0
1	53156324	.	A	G	6	9	15	0	2	17	0	0
1	53166056	.	G	T	14	9	23	0	1	24	0	0
1	53168227	.	A	G	16	0	16	0	7	23	0	0
1	53185945	.	T	C	10	8	18	0	0	18	0	0
1	53193288	.	C	T	12	11	23	0	2	25	0	0
1	53198739	.	C	A	12	14	26	0	0	26	0	0
1	53201918	.	G	A	3	26	29	0	14	43	0	0
1	53266995	.	G	C	7	3	10	0	0	10	0	0
1	53266998	.	C	A	6	3	9	0	0	9	0	0
1	53267349	.	A	G	13	13	26	0	1	27	0	0
1	53352481	.	T	C	1	4	5	0	0	5	0	0
1	53353614	.	C	T	2	2	4	0	0	4	0	0
1	53353617	.	G	A	0	2	2	0	2	4	0	0
1	53360243	.	C	A	2	2	4	0	0	4	0	0
1	53360474	.	G	T	5	5	10	0	1	11	0	0
1	53364716	.	A	G	20	17	37	0	6	43	0	0
1	53364929	.	A	G	24	16	40	0	1	41	0	0
1	53364948	.	C	A	22	21	43	0	0	43	0	0
1	53380062	.	T	C	2	3	5	0	0	5	0	0
1	53381877	.	T	C	3	2	5	0	0	5	0	0
1	53385087	.	A	G	2	0	2	0	3	5	0	0
1	53387431	.	T	A	1	2	3	0	2	5	0	0
1	53387466	.	C	T	1	2	3	0	0	3	0	0
1	53387473	.	A	G	1	0	1	0	2	3	0	0
1	53387779	.	T	G	1	4	5	0	0	5	0	0
1	53387990	.	T	C	3	8	11	0	0	11	0	0
1	53388005	.	T	C	2	6	8	0	2	10	0	0
1	53388053	.	G	A	0	4	4	0	8	12	0	0
1	53388096	.	T	A	7	9	16	0	0	16	0	0
1	53388097	.	G	T	6	9	15	0	1	16	0	0
1	53388272	.	T	C	4	5	9	0	1	10	0	0
1	53388367	.	T	A	6	4	10	0	1	11	0	0
1	53388476	.	A	C	6	7	13	0	1	14	0	0
1	53388590	.	T	G	16	8	24	0	1	26	1	0
1	53388861	.	A	G	4	6	10	0	0	10	0	0
1	53391729	.	T	C	14	0	14	2	10	26	0	0
1	53391760	.	G	A	12	8	20	2	0	22	0	0
1	53392161	.	T	C	8	10	18	0	2	20	0	0
1	53392220	.	C	A	1	6	7	0	7	14	0	0
1	53491964	.	T	A	10	3	13	0	0	13	0	0
1	53501909	.	C	G	9	14	23	0	0	23	0	0
1	53501918	.	G	A	8	13	21	0	1	22	0	0
1	53568386	.	T	C	5	7	12	0	0	12	0	0
1	53568515	.	G	T	8	11	19	0	1	20	0	0
1	53568846	.	A	T	8	7	15	0	0	15	0	0
1	53570142	.	T	C	8	8	16	0	0	16	0	0
1	53572772	.	T	A	3	2	5	0	0	5	0	0
1	53575478	.	C	A	7	3	10	0	1	11	0	0
1	53579023	.	A	G	2	3	5	0	0	5	0	0
1	53581492	.	G	A	1	4	5	0	0	5	0	0
1	53585575	.	A	C	1	0	1	0	2	3	0	0
1	53585593	.	A	G	1	2	3	0	0	3	0	0
1	53659267	.	A	C	12	11	23	0	1	24	0	0
1	53661577	.	T	G	5	6	11	0	0	11	0	0
1	53663391	.	G	A	6	5	11	0	0	11	0	0
1	53663478	.	G	T	3	6	9	0	0	9	0	0
1	53663487	.	C	T	3	6	9	0	0	9	0	0
1	53664677	.	C	G	3	7	10	0	0	10	0	0
1	53666888	.	A	G	2	2	4	0	0	4	0	0
1	53666936	.	A	G	0	2	2	0	1	3	0	0
1	53667026	.	A	T	2	2	4	0	0	4	0	0
1	53667080	.	T	C	4	4	8	0	0	8	0	0
1	53701875	.	A	G	8	18	26	0	2	28	0	0
1	53701907	.	C	T	20	21	41	0	2	43	0	0
1	53703194	.	G	T	28	23	51	2	2	55	0	0
1	53704530	.	A	G	20	23	43	0	2	45	0	0
1	53705221	.	G	A	12	24	36	0	4	40	0	0
1	53705266	.	A	G	14	28	42	0	2	44	0	0
1	53707177	.	G	C	15	0	15	0	6	21	0	0
1	53709732	.	C	A	2	8	10	0	13	23	0	0
1	53709858	.	A	T	17	5	22	0	0	22	0	0
1	53709882	.	G	A	14	8	22	0	2	24	0	0
1	53714592	.	T	G	7	5	12	0	0	12	0	0
1	53714727	.	C	A	11	6	17	0	1	18	0	0
1	53714733	.	C	T	14	5	19	0	0	19	0	0
1	53715046	.	T	C	2	2	4	0	0	4	0	0
1	53719831	.	T	C	3	3	6	0	0	6	0	0
1	53724775	.	G	A	0	3	3	0	9	12	0	0
1	53726662	.	G	A	3	8	11	0	0	11	0	0
1	53729934	.	G	A	7	2	9	0	1	10	0	0
1	53729997	.	C	T	1	3	4	0	0	4	0	0
1	53735648	.	A	G	9	5	14	0	1	15	0	0
1	53735977	.	G	C	9	0	9	0	7	16	0	0
1	53737199	.	G	A	2	5	7	0	1	8	0	0
1	54255786	.	A	G	2	3	5	0	0	5	0	0
1	54255804	.	G	C	1	2	3	0	4	7	0	0
1	54255822	.	C	T	7	3	10	0	0	10	0	0
1	54264832	.	G	A	0	7	7	0	9	16	0	0
1	54264835	.	G	T	9	7	16	0	1	17	0	0
1	54271276	.	A	G	8	0	8	0	14	22	0	0
1	54271282	.	C	T	9	15	24	0	0	24	0	0
1	54273753	.	A	G	6	0	6	0	12	18	0	0
1	54273824	.	A	G	9	6	15	0	1	16	0	0
1	54274038	.	G	C	11	14	25	0	1	26	0	0
1	54274049	.	G	A	15	11	26	0	1	27	0	0
1	54274125	.	T	C	13	15	28	0	0	28	0	0
1	54274143	.	T	A	16	16	32	0	1	33	0	0
1	54274408	.	T	A	5	3	8	0	0	8	0	0
1	54274500	.	C	T	6	6	12	0	0	12	0	0
1	54274509	.	A	T	4	8	12	0	2	14	0	0
1	54274611	.	T	G	10	4	14	0	0	14	0	0
1	54274725	.	G	A	5	7	12	0	1	13	0	0
1	54614418	.	T	G	1	2	3	0	0	3	0	0
1	54614421	.	T	A	2	2	4	0	0	4	0	0
1	54674086	.	C	T	1	3	4	0	0	4	0	0
1	54677752	.	C	T	4	6	10	0	0	10	0	0
1	54677757	.	A	G	4	7	11	0	0	11	0	0
1	54677805	.	T	C	5	7	12	0	0	12	0	0
1	54677907	.	T	C	5	4	9	0	0	9	0	0
1	54677928	.	T	C	3	3	6	0	1	7	0	0
1	54677958	.	T	C	2	4	6	0	1	7	0	0
1	54677981	.	T	C	2	6	8	0	0	8	0	0
1	54678030	.	C	T	6	8	14	0	0	14	0	0
1	54678036	.	T	C	7	6	13	0	2	15	0	0
1	54678144	.	T	A	8	3	11	0	3	14	0	0
1	54679715	.	T	C	11	10	21	0	1	22	0	0
1	54683743	.	C	T	10	7	17	0	1	18	0	0
1	54685500	.	G	A	14	8	22	0	0	22	0	0
1	54685742	.	A	G	13	0	13	0	9	22	0	0
1	54687523	.	T	C	7	4	11	0	0	11	0	0
1	54687598	.	A	G	5	8	13	0	2	15	0	0
1	54687624	.	T	A	5	8	13	0	0	13	0	0
1	54687639	.	A	G	8	7	15	0	1	16	0	0
1	54687715	.	C	A	14	8	22	1	0	23	0	0
1	54687747	.	T	C	13	13	26	1	1	28	0	0
1	54687821	.	C	G	11	5	16	3	0	19	0	0
1	54687830	.	A	G	12	5	17	4	1	22	0	0
1	54689359	.	A	G	6	1	7	0	7	14	0	0
1	54701186	.	C	T	3	2	5	0	1	6	0	0
1	54701201	.	C	G	2	2	4	0	3	7	0	0
1	54703469	.	C	T	0	3	3	0	2	5	0	0
1	54707719	.	T	C	22	12	34	0	6	40	0	0
1	54707846	.	A	G	35	30	65	0	4	69	0	0
1	54707885	.	C	G	5	25	30	0	38	68	0	0
1	54707894	.	T	G	39	29	68	0	0	68	0	0
1	54707937	.	A	G	46	13	59	0	5	65	1	0
1	54708057	.	C	G	6	27	33	0	33	66	0	0
1	54708096	.	C	G	5	37	42	0	29	71	0	0
1	54708098	.	G	T	31	36	67	0	2	69	0	0
1	54708191	.	C	A	34	24	58	0	2	60	0	0
1	54708281	.	A	T	23	40	63	0	5	68	0	0
1	54708301	.	A	C	24	42	66	0	1	67	0	0
1	54708317	.	C	T	19	46	65	0	1	66	0	0
1	54708365	.	T	C	25	35	60	0	1	61	0	0
1	54708557	.	T	C	10	1	11	0	1	12	0	0
1	54708636	.	T	C	11	6	17	2	3	22	0	0
1	54709239	.	A	T	22	16	38	0	0	38	0	0
1	54709334	.	G	A	22	25	47	0	2	49	0	0
1	54709456	.	G	A	20	27	47	0	2	49	0	0
1	54711853	.	G	A	19	26	45	0	4	49	0	0
1	54714955	.	G	A	22	18	40	0	5	45	0	0
1	54715009	.	T	C	20	1	21	0	22	43	0	0
1	54715027	.	T	C	19	0	19	0	18	37	0	0
1	54715155	.	G	T	22	13	35	0	1	36	0	0
1	54715183	.	A	G	16	13	29	0	1	30	0	0
1	54721470	.	C	T	0	3	3	0	3	6	0	0
1	54728572	.	T	C	1	1	2	0	2	4	0	0
1	54750500	.	G	A	0	4	4	0	2	6	0	0
1	54753167	.	A	G	4	3	7	0	0	7	0	0
1	54753366	.	A	G	2	7	9	0	0	9	0	0
1	54753401	.	A	T	3	6	9	0	0	9	0	0
1	54753445	.	T	A	6	5	11	0	2	13	0	0
1	54754623	.	A	T	5	8	13	0	0	13	0	0
1	54754626	.	T	A	5	9	14	0	0	14	0	0
1	54754709	.	C	T	5	5	10	0	1	11	0	0
1	54754744	.	C	T	3	4	7	0	0	7	0	0
1	54754754	.	T	C	4	5	9	0	0	9	0	0
1	54754795	.	T	C	6	6	12	0	1	13	0	0
1	54754799	.	G	A	6	6	12	0	3	15	0	0
1	54754834	.	C	T	11	8	19	0	1	20	0	0
1	54754839	.	C	T	12	10	22	0	0	22	0	0
1	54754905	.	G	A	0	10	10	0	7	17	0	0
1	54755135	.	C	T	8	12	20	2	4	26	0	0
1	54755152	.	G	C	11	10	21	1	2	24	0	0
1	54755349	.	A	T	2	2	4	0	1	5	0	0
1	54755373	.	T	C	2	4	6	0	2	8	0	0
1	54755416	.	T	A	4	5	9	0	0	9	0	0
1	54758581	.	T	C	4	0	4	0	4	8	0	0
1	54758634	.	T	C	9	5	14	0	2	16	0	0
1	54758783	.	T	G	12	4	16	0	0	16	0	0
1	54758877	.	C	A	1	4	5	0	13	18	0	0
1	54758975	.	T	C	11	5	16	0	0	16	0	0
1	54759028	.	A	G	10	9	19	0	2	21	0	0
1	54762997	.	G	T	7	4	11	0	0	11	0	0
1	54763182	.	A	G	7	3	10	0	0	10	0	0
1	54897240	.	A	G	4	0	4	0	3	7	0	0
1	54906069	.	T	C	3	4	7	0	0	7	0	0
1	54906081	.	A	C	5	4	9	0	0	9	0	0
1	54906476	.	G	C	1	6	7	0	1	8	0	0
1	54906619	.	T	A	3	9	12	0	0	12	0	0
1	54906662	.	T	C	4	2	6	0	0	6	0	0
1	54906820	.	T	C	7	7	14	0	1	15	0	0
1	54907534	.	T	C	14	8	22	0	0	22	0	0
1	54907585	.	G	C	13	10	23	0	2	25	0	0
1	54907622	.	T	C	12	8	20	0	1	21	0	0
1	54907693	.	G	T	12	7	19	0	0	19	0	0
1	54907733	.	T	A	8	3	11	0	0	11	0	0
1	54927198	.	T	C	7	6	13	0	0	13	0	0
1	54929078	.	C	T	14	8	22	0	0	22	0	0
1	54929256	.	T	C	7	3	10	0	0	10	0	0
1	54929373	.	C	G	6	4	10	0	0	10	0	0
1	54929575	.	C	T	6	3	9	0	0	9	0	0
1	54929647	.	A	C	5	5	10	0	0	10	0	0
1	54929681	.	C	A	5	7	12	0	0	12	0	0
1	54929733	.	T	G	6	6	12	0	0	12	0	0
1	54929985	.	C	T	6	9	15	0	1	16	0	0
1	54930376	.	C	G	2	4	6	0	0	6	0	0
1	54930439	.	T	A	6	6	12	0	0	12	0	0
1	54930930	.	T	G	9	11	20	0	1	21	0	0
1	54931380	.	A	C	17	12	29	0	2	31	0	0
1	54931487	.	G	T	4	30	34	0	17	51	0	0
1	54931862	.	A	G	5	4	9	0	2	11	0	0
1	54936235	.	G	T	17	15	32	0	0	32	0	0
1	54936471	.	T	C	9	19	28	0	1	29	0	0
1	54936472	.	G	A	9	20	29	0	0	29	0	0
1	54938208	.	C	T	2	14	16	0	8	24	0	0
1	54938261	.	C	T	0	9	9	0	9	18	0	0
1	54939536	.	A	T	6	10	16	0	1	17	0	0
1	54939563	.	C	G	4	8	12	0	0	12	0	0
1	54939709	.	T	G	8	6	14	0	0	14	0	0
1	54941036	.	G	A	4	4	8	0	0	8	0	0
1	54942609	.	C	T	0	4	4	0	3	7	0	0
1	54943082	.	G	T	2	8	10	0	0	10	0	0
1	54948145	.	T	C	10	8	18	0	0	18	0	0
1	54950379	.	G	C	10	11	21	0	0	21	0	0
1	54950410	.	T	C	8	9	17	0	0	17	0	0
1	54950534	.	T	C	9	5	14	0	0	14	0	0
1	54950685	.	A	G	3	8	11	0	1	12	0	0
1	54950689	.	C	A	3	9	12	0	0	12	0	0
1	54950747	.	C	T	5	4	9	0	0	9	0	0
1	54950801	.	A	G	5	6	11	0	1	12	0	0
1	54955234	.	A	G	11	9	20	0	3	23	0	0
1	54958087	.	T	A	5	4	9	0	0	9	0	0
1	54958171	.	G	T	13	3	16	0	1	17	0	0
1	54958211	.	C	T	6	10	16	0	0	16	0	0
1	54958242	.	T	A	8	11	19	0	0	19	0	0
1	54958249	.	G	A	9	8	17	0	1	18	0	0
1	54958278	.	T	A	14	9	23	0	1	24	0	0
1	54960368	.	T	G	15	18	33	0	1	34	0	0
1	54960431	.	G	T	28	24	52	0	0	52	0	0
1	54960438	.	G	A	27	23	50	0	2	52	0	0
1	54960585	.	C	A	18	6	24	0	7	31	0	0
1	54960596	.	T	A	9	10	19	0	3	22	0	0
1	54960881	.	A	G	20	7	27	0	3	30	0	0
1	54962466	.	A	G	12	11	23	0	0	23	0	0
1	54963251	.	C	T	7	12	19	0	2	21	0	0
1	54964682	.	C	T	0	7	7	0	12	19	0	0
1	54964685	.	T	C	12	1	13	0	8	21	0	0
1	54964724	.	A	G	6	9	15	0	1	16	0	0
1	54964799	.	C	T	4	4	8	0	0	8	0	0
1	54974403	.	T	G	6	4	10	1	0	11	0	0
1	54974500	.	T	A	6	13	19	0	0	19	0	0
1	54974538	.	A	G	9	10	19	0	1	20	0	0
1	54974558	.	C	T	10	13	23	0	0	23	0	0
1	54974791	.	A	T	8	6	14	0	2	16	0	0
1	54974810	.	G	T	12	5	17	0	0	17	0	0
1	54975051	.	G	T	9	19	28	0	1	30	1	0
1	54975155	.	A	G	5	6	11	2	0	13	0	0
1	54975164	.	T	C	5	4	9	0	0	9	0	0
1	54975553	.	T	C	8	0	8	0	11	19	0	0
1	54975658	.	A	G	2	5	7	0	1	8	0	0
1	54975762	.	A	T	2	3	5	0	1	6	0	0
1	54975884	.	A	G	2	2	4	0	0	4	0	0
1	54976026	.	T	A	5	6	11	0	0	11	0	0
1	54976035	.	T	A	5	4	9	0	2	11	0	0
1	54976104	.	G	A	2	4	6	0	0	6	0	0
1	54976178	.	T	C	1	1	2	0	7	9	0	0
1	54977976	.	A	G	1	4	5	0	0	5	0	0
1	54978010	.	A	C	1	1	2	0	2	4	0	0
1	54978022	.	T	G	1	3	4	0	1	5	0	0
1	54978260	.	G	A	4	2	6	0	0	6	0	0
1	55007759	.	T	C	2	11	13	0	1	14	0	0
1	55007820	.	A	C	3	4	7	0	1	8	0	0
1	55008286	.	G	A	7	21	28	0	1	29	0	0
1	55008331	.	A	T	10	15	25	1	1	27	0	0
1	55008594	.	A	T	10	9	19	0	2	21	0	0
1	55008772	.	T	C	11	14	25	0	0	25	0	0
1	55009649	.	G	A	8	6	14	0	1	15	0	0
1	55009728	.	T	A	6	6	12	0	0	12	0	0
1	55009734	.	T	C	5	4	9	0	0	9	0	0
1	55010914	.	A	T	8	3	11	0	0	11	0	0
1	55011232	.	A	G	4	3	7	0	0	7	0	0
1	55011473	.	G	A	4	4	8	0	0	8	0	0
1	55011514	.	C	T	7	6	13	0	0	13	0	0
1	55011539	.	A	T	13	6	19	0	1	20	0	0
1	55011603	.	G	A	3	4	7	0	1	8	0	0
1	55013828	.	A	G	4	3	7	0	1	8	0	0
1	55013968	.	G	C	1	4	5	0	0	5	0	0
1	55015819	.	A	T	5	2	7	0	0	7	0	0
1	55015846	.	A	G	2	3	5	0	0	5	0	0
1	55046461	.	G	T	1	3	4	0	0	4	0	0
1	55088285	.	C	T	1	2	3	0	0	3	0	0
1	55089328	.	G	A	3	3	6	0	0	6	0	0
1	55089378	.	G	T	4	4	8	0	2	10	0	0
1	55089384	.	T	A	3	4	7	0	3	10	0	0
1	55099160	.	G	T	1	2	3	0	3	6	0	0
1	55099316	.	T	C	2	3	5	0	0	5	0	0
1	55099472	.	T	C	4	5	9	0	0	9	0	0
1	55100018	.	T	C	3	6	9	0	0	9	0	0
1	55100286	.	G	T	10	8	18	0	1	19	0	0
1	55100422	.	T	A	2	5	7	0	0	7	0	0
1	55100456	.	T	C	6	2	8	0	0	8	0	0
1	55101376	.	C	T	8	7	15	0	1	16	0	0
1	55101409	.	C	A	9	6	15	0	0	15	0	0
1	55103160	.	A	G	4	6	10	0	0	10	0	0
1	55105727	.	T	C	7	6	13	0	0	13	0	0
1	55108065	.	T	C	7	4	11	0	1	12	0	0
1	55113173	.	C	G	1	3	4	0	0	4	0	0
1	55113174	.	A	C	1	0	1	0	3	4	0	0
1	55127910	.	C	T	2	4	6	0	0	6	0	0
1	55161224	.	G	A	4	5	9	0	0	9	0	0
1	55161431	.	A	G	4	4	8	0	1	9	0	0
1	55162449	.	A	G	3	8	11	0	0	11	0	0
1	55166477	.	G	A	2	3	5	1	0	6	0	0
1	55169384	.	G	T	16	9	25	0	0	25	0	0
1	55169662	.	A	G	13	13	26	0	0	26	0	0
1	55169756	.	A	G	12	10	22	0	0	22	0	0
1	55169789	.	A	T	10	12	22	0	0	22	0	0
1	55169839	.	G	C	11	9	20	1	0	21	0	0
1	55169961	.	T	C	16	1	17	1	6	24	0	0
1	55169980	.	A	G	11	5	16	1	1	18	0	0
1	55169999	.	C	T	13	5	18	0	1	19	0	0
1	55170042	.	A	C	12	9	21	0	1	22	0	0
1	55170056	.	G	T	14	9	23	0	1	24	0	0
1	55170090	.	C	G	14	2	16	0	0	16	0	0
1	55170161	.	C	A	14	3	17	0	3	20	0	0
1	55170189	.	C	A	13	9	22	0	1	23	0	0
1	55170328	.	C	A	11	3	14	2	1	17	0	0
1	55170342	.	A	C	11	3	14	2	3	19	0	0
1	55170856	.	T	C	6	0	6	0	6	12	0	0
1	55170866	.	T	C	4	0	4	0	6	10	0	0
1	55170972	.	T	C	7	6	13	0	1	14	0	0
1	55171003	.	A	T	6	5	11	0	2	13	0	0
1	55171249	.	G	A	7	10	17	0	2	19	0	0
1	55173006	.	T	A	7	8	15	0	0	15	0	0
1	55176698	.	A	G	4	5	9	0	0	9	0	0
1	55177339	.	C	T	7	3	10	0	0	10	0	0
1	55177447	.	C	T	4	7	11	0	0	11	0	0
1	55178763	.	C	G	6	5	11	0	1	12	0	0
1	55178808	.	A	G	3	4	7	0	0	7	0	0
1	55180229	.	A	G	2	2	4	0	0	4	0	0
1	55182617	.	G	T	3	4	7	0	0	7	0	0
1	55182626	.	G	T	3	3	6	0	0	6	0	0
1	55182743	.	C	T	1	3	4	0	0	4	0	0
1	55182811	.	A	G	1	4	5	0	0	5	0	0
1	55182876	.	A	T	2	2	4	0	1	5	0	0
1	55182964	.	T	C	1	2	3	0	0	3	0	0
1	55183041	.	C	T	2	5	7	0	1	8	0	0
1	55218563	.	G	A	1	5	6	0	0	6	0	0
1	55264294	.	C	T	0	10	10	0	5	15	0	0
1	55264314	.	C	A	3	9	12	0	0	12	0	0
1	55264366	.	C	T	3	5	8	0	0	8	0	0
1	55264575	.	T	A	11	14	25	0	5	30	0	0
1	55762664	.	C	A	2	3	5	0	0	5	0	0
1	55772026	.	C	T	8	15	23	0	2	25	0	0
1	55776813	.	G	A	4	30	34	0	14	48	0	0
1	55776858	.	G	A	5	18	23	0	23	46	0	0
1	55776909	.	A	C	18	11	29	0	0	34	5	0
1	55776962	.	T	A	15	31	46	0	0	46	0	0
1	55777008	.	A	T	16	21	37	0	3	40	0	0
1	55783978	.	T	C	31	24	55	1	1	57	0	0
1	55785527	.	C	A	5	29	34	0	26	60	0	0
1	55785577	.	A	G	31	31	62	0	0	62	0	0
1	55785596	.	T	C	21	21	42	0	3	45	0	0
1	55785654	.	C	T	16	20	36	0	0	36	0	0
1	55785697	.	C	T	7	5	12	0	0	12	0	0
1	55787173	.	A	G	2	4	6	0	0	6	0	0
1	55787219	.	A	C	3	3	6	0	1	7	0	0
1	55787236	.	C	T	5	3	8	0	0	8	0	0
1	55787276	.	G	A	6	4	10	0	1	11	0	0
1	55787300	.	C	T	0	5	5	0	9	14	0	0
1	55787507	.	A	G	5	4	9	0	0	9	0	0
1	55789456	.	C	T	2	4	6	0	0	6	0	0
1	55789504	.	A	C	1	0	1	0	2	3	0	0
1	55789549	.	C	A	2	3	5	0	0	5	0	0
1	55797936	.	A	C	3	0	3	0	2	5	0	0
1	55817728	.	C	T	6	3	9	0	0	9	0	0
1	55817753	.	G	A	4	2	6	0	0	6	0	0
1	55833276	.	C	T	2	3	5	0	0	5	0	0
1	55833281	.	C	T	1	3	4	0	0	4	0	0
1	55843902	.	C	T	19	21	40	0	4	44	0	0
1	55843968	.	G	A	21	18	39	0	1	40	0	0
1	55844044	.	T	A	17	18	35	0	1	36	0	0
1	55844143	.	T	G	17	23	40	0	0	40	0	0
1	55851968	.	T	C	7	0	7	0	16	23	0	0
1	55853320	.	G	A	7	9	16	0	0	16	0	0
1	55872892	.	C	G	4	5	9	0	1	10	0	0
1	55873073	.	C	T	1	4	5	0	0	5	0	0
1	55878257	.	T	A	4	4	8	0	2	10	0	0
1	55878342	.	T	A	2	7	9	0	0	9	0	0
1	55878431	.	T	A	9	6	15	0	0	15	0	0
1	55878457	.	C	T	10	6	16	0	2	18	0	0
1	55878496	.	T	C	12	0	12	0	11	23	0	0
1	55878558	.	G	A	6	11	17	0	2	19	0	0
1	55878624	.	T	A	6	4	10	0	4	14	0	0
1	55878761	.	T	G	2	0	2	0	12	14	0	0
1	55885938	.	A	T	1	8	9	0	0	9	0	0
1	55888442	.	A	G	4	3	7	0	0	7	0	0
1	55888632	.	T	C	2	0	2	0	4	6	0	0
1	55888654	.	C	T	3	2	5	0	1	6	0	0
1	55888690	.	A	G	4	2	6	0	0	6	0	0
1	55888693	.	T	A	4	1	5	0	0	5	0	0
1	55888892	.	A	G	1	2	3	0	0	3	0	0
1	56217457	.	G	A	6	15	21	0	0	21	0	0
1	56217510	.	A	G	21	29	50	0	2	52	0	0
1	56217925	.	G	A	30	29	59	0	2	61	0	0
1	56218189	.	C	T	2	26	28	0	32	60	0	0
1	56218258	.	A	C	24	25	49	0	2	51	0	0
1	56220668	.	A	G	22	20	42	0	0	42	0	0
1	56422751	.	G	A	4	2	6	0	0	6	0	0
1	56422781	.	T	A	4	2	6	0	1	7	0	0
1	56422962	.	A	T	6	6	12	0	1	14	1	0
1	56422967	.	T	C	7	7	14	0	1	15	0	0
1	56423002	.	T	G	3	8	11	0	0	11	0	0
1	56423389	.	A	G	2	3	5	0	0	5	0	0
1	56423641	.	T	A	5	6	11	1	3	15	0	0
1	56423664	.	T	C	6	0	6	1	9	16	0	0
1	56425843	.	T	C	4	0	4	0	4	8	0	0
1	56425864	.	C	T	3	4	7	0	0	7	0	0
1	56428320	.	G	A	4	2	6	0	0	6	0	0
1	57170399	.	T	C	2	2	4	0	0	4	0	0
1	57278215	.	G	C	3	7	10	0	0	10	0	0
1	57280184	.	G	T	1	2	3	0	0	3	0	0
1	57306744	.	G	T	2	3	5	0	0	5	0	0
1	57340049	.	T	C	2	2	4	0	0	4	0	0
1	58013308	.	C	A	4	5	9	0	1	10	0	0
1	58013309	.	A	G	4	5	9	0	1	10	0	0
1	58014867	.	T	C	1	5	6	0	0	6	0	0
1	58014933	.	T	C	2	0	2	0	5	7	0	0
1	58015053	.	A	G	2	2	4	0	0	4	0	0
1	58015448	.	G	T	3	2	5	0	0	5	0	0
1	58015478	.	C	T	1	3	4	0	0	4	0	0
1	58015494	.	C	T	1	2	3	0	0	3	0	0
1	58015580	.	T	C	3	0	3	0	2	5	0	0
1	58017733	.	T	C	1	0	1	0	2	3	0	0
1	58023960	.	T	A	1	2	3	0	1	4	0	0
1	58092700	.	T	A	4	2	6	0	0	6	0	0
1	58092795	.	A	T	5	3	8	0	0	8	0	0
1	58092820	.	C	G	4	1	5	0	1	6	0	0
1	58092836	.	T	C	4	2	6	0	0	6	0	0
1	58094708	.	C	T	1	5	6	0	1	7	0	0
1	58094744	.	A	G	4	5	9	0	0	9	0	0
1	58094775	.	A	G	4	4	8	0	2	10	0	0
1	58095111	.	C	T	3	5	8	0	0	8	0	0
1	58095116	.	G	C	4	5	9	0	0	9	0	0
1	58098105	.	A	C	7	3	10	0	0	10	0	0
1	58098137	.	T	A	7	5	12	0	0	12	0	0
1	58102188	.	C	T	8	3	11	9	3	23	0	0
1	58102932	.	T	G	12	11	23	0	1	24	0	0
1	58225946	.	G	A	1	5	6	0	0	6	0	0
1	58547300	.	A	G	3	2	5	0	0	5	0	0
1	58564361	.	G	T	0	2	2	0	1	3	0	0
1	58564408	.	T	C	3	0	3	0	3	6	0	0
1	58566344	.	C	A	5	3	8	0	0	8	0	0
1	58568895	.	T	G	4	4	8	0	0	8	0	0
1	58568918	.	A	G	5	2	7	0	0	7	0	0
1	58583102	.	G	A	1	3	4	0	1	5	0	0
1	58593685	.	A	C	2	4	6	0	0	6	0	0
1	58593699	.	A	G	1	6	7	0	0	7	0	0
1	58593768	.	T	G	1	5	6	0	1	7	0	0
1	58593833	.	C	A	6	6	12	0	0	12	0	0
1	58593835	.	T	C	6	5	11	0	1	12	0	0
1	58593912	.	C	T	3	3	6	0	0	6	0	0
1	58593976	.	G	A	6	3	9	0	0	9	0	0
1	58594143	.	A	C	3	0	3	0	6	9	0	0
1	58594521	.	T	C	0	2	2	0	1	3	0	0
1	58594689	.	A	G	1	2	3	0	0	3	0	0
1	58595018	.	C	T	6	5	11	0	0	11	0	0
1	58595198	.	A	G	4	2	6	0	0	6	0	0
1	58598607	.	T	G	1	2	3	0	0	3	0	0
1	58603283	.	G	A	3	3	6	0	0	6	0	0
1	58605997	.	A	G	4	2	6	1	0	7	0	0
1	58610453	.	G	A	1	2	3	0	0	3	0	0
1	58612042	.	G	A	0	2	2	0	3	5	0	0
1	58612519	.	T	C	3	2	5	0	0	5	0	0
1	58612726	.	G	A	1	5	6	0	3	9	0	0
1	58612915	.	A	T	3	1	4	0	2	6	0	0
1	58613091	.	A	C	2	2	4	0	0	4	0	0
1	58613126	.	T	A	7	3	10	0	1	11	0	0
1	58613162	.	A	G	5	3	8	1	1	10	0	0
1	58613166	.	T	G	6	3	9	1	0	10	0	0
1	58618125	.	A	C	3	4	7	0	0	7	0	0
1	58631350	.	C	T	1	3	4	0	0	4	0	0
1	58631374	.	A	G	1	1	2	0	2	4	0	0
1	58631509	.	A	G	3	2	5	0	0	5	0	0
1	58631559	.	A	T	4	5	9	0	2	11	0	0
1	58677856	.	C	T	8	2	10	0	2	12	0	0
1	58677909	.	A	C	2	5	7	0	0	7	0	0
1	58677949	.	A	C	1	6	7	0	0	7	0	0
1	58677993	.	A	G	5	10	15	0	0	15	0	0
1	58678017	.	T	C	5	7	12	0	0	12	0	0
1	58678077	.	T	A	1	3	4	0	0	4	0	0
1	58680432	.	T	A	4	5	9	0	0	9	0	0
1	58680469	.	C	A	11	3	14	0	0	14	0	0
1	58680499	.	C	A	5	7	12	0	1	13	0	0
1	58680517	.	T	C	11	5	16	0	1	17	0	0
1	58680553	.	C	A	14	3	17	0	0	17	0	0
1	58680566	.	T	C	13	3	16	0	0	16	0	0
1	58680591	.	C	T	5	9	14	0	0	14	0	0
1	58680654	.	C	G	5	3	8	0	0	8	0	0
1	58680675	.	G	C	3	4	7	0	0	7	0	0
1	58680792	.	T	C	9	5	14	0	1	15	0	0
1	58681095	.	A	G	8	9	17	0	0	17	0	0
1	58681278	.	A	C	14	11	25	0	0	25	0	0
1	58681419	.	A	T	8	17	25	0	0	29	4	0
1	58681491	.	T	C	8	16	24	0	0	24	0	0
1	58846670	.	C	A	1	3	4	0	0	4	0	0
1	58850500	.	T	G	4	7	11	0	3	14	0	0
1	58850525	.	T	A	4	6	10	0	0	15	5	0
1	58850562	.	C	T	3	6	9	0	0	9	0	0
1	58850622	.	T	C	1	3	4	0	0	4	0	0
1	58978330	.	G	T	0	2	2	0	2	4	0	0
1	58982147	.	G	A	0	4	4	0	6	10	0	0
1	58982195	.	C	G	7	3	10	0	0	10	0	0
1	58984368	.	G	A	0	6	6	0	5	11	0	0
1	58984478	.	T	C	4	4	8	0	0	8	0	0
1	58984640	.	C	T	5	5	10	0	1	11	0	0
1	58985530	.	G	A	13	16	29	0	1	30	0	0
1	58985579	.	T	G	11	16	27	0	2	29	0	0
1	58985730	.	C	A	10	7	17	0	0	17	0	0
1	58999960	.	T	A	1	2	3	0	0	3	0	0
1	59018886	.	C	T	0	5	5	0	2	7	0	0
1	59019006	.	C	G	6	5	11	0	2	13	0	0
1	59062665	.	T	C	20	26	46	0	3	49	0	0
1	59065889	.	G	A	3	14	17	0	24	41	0	0
1	59140788	.	G	C	1	3	4	0	0	4	0	0
1	59141260	.	C	T	2	4	6	0	0	6	0	0
1	59141397	.	T	C	4	0	4	0	5	9	0	0
1	59141429	.	G	T	4	5	9	0	0	9	0	0
1	59141550	.	T	C	1	4	5	0	0	5	0	0
1	59141556	.	G	C	1	4	5	0	0	5	0	0
1	59143004	.	T	C	3	3	6	0	0	6	0	0
1	59146790	.	A	G	6	8	14	0	0	14	0	0
1	59148341	.	T	C	3	7	10	0	0	10	0	0
1	59149117	.	C	T	10	8	18	0	0	18	0	0
1	59149968	.	T	C	11	16	27	0	0	27	0	0
1	59150450	.	A	G	13	6	19	0	0	19	0	0
1	59150482	.	G	T	11	3	14	0	2	16	0	0
1	59150518	.	T	C	11	10	21	0	0	21	0	0
1	59150559	.	T	G	9	14	23	0	0	23	0	0
1	59150583	.	T	A	6	14	20	0	0	20	0	0
1	59150683	.	T	C	8	18	26	0	0	26	0	0
1	59150737	.	T	C	17	10	27	0	1	28	0	0
1	59150762	.	G	T	22	13	35	0	0	35	0	0
1	59150781	.	T	C	19	12	31	0	2	33	0	0
1	59156827	.	T	G	2	4	6	0	0	6	0	0
1	59157536	.	T	C	3	2	5	0	0	5	0	0
1	59157955	.	C	A	8	0	8	0	1	9	0	0
1	59157977	.	A	C	3	3	6	0	1	7	0	0
1	59172876	.	A	G	7	6	13	0	0	13	0	0
1	59172900	.	A	G	6	7	13	0	1	14	0	0
1	59172969	.	G	A	10	6	16	0	0	16	0	0
1	59173358	.	G	T	2	4	6	0	1	7	0	0
1	59173563	.	C	T	8	6	14	0	0	14	0	0
1	59173701	.	G	T	4	7	11	0	1	12	0	0
1	59173896	.	T	C	4	1	5	0	6	11	0	0
1	59174408	.	G	A	2	2	4	0	0	4	0	0
1	59174492	.	T	G	3	2	5	0	0	5	0	0
1	59174645	.	G	A	2	2	4	0	3	7	0	0
1	59175572	.	A	G	2	2	4	0	0	4	0	0
1	59175740	.	G	T	3	2	5	0	0	5	0	0
1	59175847	.	G	A	2	3	5	0	0	5	0	0
1	59175857	.	G	A	2	3	5	0	0	5	0	0
1	59218477	.	C	G	1	3	4	1	4	9	0	0
1	59218594	.	A	G	17	9	26	0	1	27	0	0
1	59226049	.	T	C	23	17	40	0	6	46	0	0
1	59226052	.	A	G	24	17	41	0	5	46	0	0
1	59226374	.	A	G	42	9	51	0	1	52	0	0
1	59228311	.	G	A	41	16	57	0	2	59	0	0
1	59228322	.	C	T	41	18	59	0	0	59	0	0
1	59228569	.	A	C	22	0	22	0	16	38	0	0
1	59229211	.	G	A	3	7	10	0	0	10	0	0
1	59232206	.	A	G	4	13	17	0	2	19	0	0
1	59232509	.	G	A	10	10	20	0	1	21	0	0
1	59235016	.	T	G	14	15	29	0	2	31	0	0
1	59244312	.	A	G	16	18	34	0	0	34	0	0
1	59244635	.	A	T	14	24	38	0	1	39	0	0
1	59244768	.	G	T	34	9	43	0	0	43	0	0
1	59244916	.	T	A	40	15	55	3	1	59	0	0
1	59244928	.	C	T	36	19	55	3	1	59	0	0
1	59245142	.	C	G	33	31	64	0	1	65	0	0
1	59245658	.	G	A	18	13	31	0	5	36	0	0
1	59245873	.	T	C	12	15	27	0	2	29	0	0
1	59245900	.	C	T	12	18	30	0	2	32	0	0
1	59246189	.	T	C	13	1	14	0	18	32	0	0
1	59247893	.	T	G	10	10	20	0	0	20	0	0
1	59247944	.	C	T	15	7	22	0	0	22	0	0
1	59251658	.	C	G	5	13	18	0	0	18	0	0
1	59251839	.	T	C	9	0	9	0	9	18	0	0
1	59293966	.	A	G	1	3	4	0	0	4	0	0
1	59298069	.	T	C	1	2	3	0	0	3	0	0
1	59298261	.	T	G	2	2	4	0	0	4	0	0
1	59302210	.	G	A	1	6	7	0	6	13	0	0
1	59302276	.	C	T	3	8	11	0	1	12	0	0
1	59302372	.	T	G	2	3	5	0	0	5	0	0
1	59302523	.	A	T	1	3	4	0	1	5	0	0
1	59302532	.	A	C	1	2	3	0	0	3	0	0
1	59302813	.	C	A	1	3	4	0	0	4	0	0
1	59303024	.	C	A	5	7	12	0	1	13	0	0
1	59303220	.	T	G	3	4	7	0	0	7	0	0
1	59304427	.	T	C	4	2	6	0	0	6	0	0
1	59304816	.	C	T	5	1	6	0	1	7	0	0
1	59305116	.	T	C	12	0	12	0	7	19	0	0
1	59314966	.	A	G	1	8	9	0	0	9	0	0
1	59318769	.	A	G	2	2	4	0	0	4	0	0
1	59318771	.	C	A	2	2	4	0	0	4	0	0
1	59318886	.	A	G	1	0	1	0	3	4	0	0
1	59321447	.	A	G	16	0	16	0	10	26	0	0
1	59324067	.	T	C	25	23	48	0	0	48	0	0
1	59328287	.	C	T	7	5	12	0	0	12	0	0
1	59328486	.	C	T	1	5	6	0	0	6	0	0
1	59329950	.	A	G	2	8	10	0	0	10	0	0
1	59329957	.	T	C	4	7	11	0	0	11	0	0
1	59330135	.	T	C	4	6	10	0	0	10	0	0
1	59330169	.	C	T	3	6	9	0	1	10	0	0
1	59555999	.	G	A	4	24	28	0	0	28	0	0
1	59563781	.	G	T	1	3	4	0	0	4	0	0
10	19245	.	G	A	3	2	5	0	0	5	0	0
10	22672	.	A	T	5	10	15	0	1	16	0	0
10	24014	.	G	A	1	2	3	0	0	3	0	0
10	27705	.	A	G	5	5	10	0	0	10	0	0
10	27787	.	G	T	0	8	8	0	5	13	0	0
10	27987	.	A	T	2	7	9	0	0	9	0	0
10	32998	.	G	T	4	7	11	0	0	11	0	0
10	33225	.	G	A	5	2	7	0	1	8	0	0
10	33427	.	G	A	11	3	14	0	0	14	0	0
10	33634	.	G	T	2	4	6	0	3	9	0	0
10	34799	.	G	C	2	0	2	0	2	4	0	0
10	53815	.	T	C	8	9	17	0	1	18	0	0
10	53816	.	G	A	9	9	18	0	0	18	0	0
10	53930	.	T	G	7	9	16	0	1	17	0	0
10	55627	.	C	T	0	4	4	0	7	11	0	0
10	55665	.	A	C	6	4	10	0	1	11	0	0
10	55666	.	G	C	6	0	6	0	5	11	0	0
10	62468	.	C	G	22	15	37	0	0	37	0	0
10	66886	.	A	G	3	4	7	0	1	8	0	0
10	66967	.	A	G	5	7	12	0	0	12	0	0
10	81276	.	C	T	20	21	41	1	4	46	0	0
10	81285	.	C	T	24	21	45	1	1	47	0	0
10	81348	.	C	T	19	15	34	1	2	37	0	0
10	81508	.	A	G	25	1	26	0	14	40	0	0
10	81579	.	G	T	2	7	9	0	5	14	0	0
10	82336	.	A	G	32	11	43	0	2	45	0	0
10	83401	.	G	A	12	7	19	0	0	19	0	0
10	85571	.	G	C	9	9	18	1	0	19	0	0
10	85585	.	C	T	13	7	20	1	4	25	0	0
10	85927	.	A	G	14	7	21	0	2	23	0	0
10	85948	.	G	C	15	9	24	0	0	24	0	0
10	87353	.	G	A	7	7	14	0	1	15	0	0
10	87592	.	C	T	2	6	8	0	4	12	0	0
10	87606	.	G	A	7	5	12	0	0	12	0	0
10	115088	.	G	A	12	7	19	0	1	20	0	0
10	115493	.	G	T	6	6	12	0	1	13	0	0
10	115506	.	T	G	3	7	10	0	0	10	0	0
10	115615	.	T	C	8	9	17	0	0	17	0	0
10	115626	.	C	A	9	9	18	0	1	19	0	0
10	115679	.	A	T	9	17	26	0	0	26	0	0
10	115773	.	A	G	13	7	20	0	0	20	0	0
10	115820	.	T	C	10	11	21	0	1	22	0	0
10	116020	.	T	G	5	3	8	0	0	8	0	0
10	134661	.	C	T	3	12	15	0	12	27	0	0
10	134749	.	C	T	2	8	10	1	15	26	0	0
10	187823	.	C	T	4	3	7	0	0	7	0	0
10	190039	.	G	A	1	3	4	0	0	4	0	0
10	190777	.	C	G	1	0	1	0	3	4	0	0
10	190917	.	C	T	11	4	15	0	0	15	0	0
10	193853	.	G	A	6	5	11	0	1	12	0	0
10	196307	.	C	T	9	5	14	0	1	15	0	0
10	196426	.	T	A	13	9	22	0	2	24	0	0
10	196429	.	A	T	10	11	21	0	1	22	0	0
10	196524	.	A	G	11	1	12	1	10	23	0	0
10	196563	.	C	G	9	8	17	2	1	20	0	0
10	196670	.	G	A	15	18	33	0	4	37	0	0
10	196782	.	C	A	6	5	11	0	0	11	0	0
10	207078	.	G	T	10	3	13	0	0	13	0	0
10	207128	.	G	A	9	10	19	0	1	20	0	0
10	207783	.	G	A	4	11	15	0	1	16	0	0
10	208034	.	A	T	13	9	22	0	1	23	0	0
10	208104	.	G	A	9	8	17	0	1	18	0	0
10	208674	.	G	A	8	3	11	0	0	11	0	0
10	208714	.	C	T	1	4	5	0	12	17	0	0
10	210568	.	A	G	5	4	9	0	0	9	0	0
10	210598	.	T	C	2	5	7	0	1	8	0	0
10	216238	.	C	T	2	2	4	0	0	4	0	0
10	286788	.	T	C	2	0	2	0	12	14	0	0
10	294113	.	G	A	1	4	5	0	0	5	0	0
10	294653	.	A	G	1	3	4	0	0	4	0	0
10	297823	.	C	T	2	2	4	0	0	4	0	0
10	306096	.	A	C	1	5	6	0	0	6	0	0
10	307976	.	G	T	11	3	14	0	1	15	0	0
10	307985	.	T	C	8	0	8	0	2	10	0	0
10	311901	.	A	G	5	9	14	0	0	14	0	0
10	313332	.	T	C	3	3	6	0	1	7	0	0
10	381157	.	G	C	1	2	3	0	0	3	0	0
10	381168	.	C	T	1	2	3	0	1	4	0	0
10	474834	.	T	C	3	5	8	0	1	9	0	0
10	478304	.	T	G	4	3	7	0	1	8	0	0
10	478508	.	T	C	7	8	15	0	1	16	0	0
10	478661	.	C	T	11	7	18	0	0	18	0	0
10	478724	.	G	A	14	8	22	0	0	22	0	0
10	478742	.	C	T	13	9	22	0	0	22	0	0
10	479063	.	A	G	12	7	19	0	0	19	0	0
10	482335	.	G	A	14	8	22	1	1	24	0	0
10	482371	.	T	G	11	11	22	1	0	23	0	0
10	486146	.	G	A	10	9	19	0	0	19	0	0
10	486153	.	T	C	10	10	20	0	1	21	0	0
10	500114	.	A	G	11	0	11	0	14	25	0	0
10	500168	.	G	A	2	19	21	0	14	35	0	0
10	500423	.	A	G	11	0	11	0	21	32	0	0
10	500473	.	T	C	13	18	31	0	1	32	0	0
10	501833	.	C	T	20	15	35	0	0	35	0	0
10	501899	.	G	C	18	19	37	0	0	37	0	0
10	505282	.	A	G	12	19	31	0	3	34	0	0
10	505316	.	G	A	3	18	21	0	17	38	0	0
10	580092	.	G	A	2	2	4	0	0	4	0	0
10	586563	.	C	A	1	3	4	0	0	4	0	0
10	589487	.	G	A	9	6	15	0	1	16	0	0
10	590067	.	A	C	1	2	3	0	0	3	0	0
10	590273	.	A	C	6	2	8	0	1	9	0	0
10	591017	.	T	C	15	3	18	1	0	19	0	0
10	591219	.	T	G	7	0	7	0	5	12	0	0
10	591220	.	C	T	5	5	10	0	1	11	0	0
10	591434	.	G	A	3	3	6	0	1	7	0	0
10	591476	.	A	G	6	0	6	0	9	15	0	0
10	591567	.	T	A	11	5	16	0	0	16	0	0
10	591634	.	T	G	8	12	20	0	0	20	0	0
10	591716	.	C	G	10	3	13	0	0	13	0	0
10	591720	.	G	A	1	2	3	0	11	14	0	0
10	591820	.	A	G	11	0	11	0	6	17	0	0
10	600584	.	G	A	1	3	4	0	1	5	0	0
10	650148	.	A	T	2	2	4	0	0	4	0	0
10	650153	.	C	T	0	2	2	0	2	4	0	0
10	1056460	.	T	C	2	4	6	0	1	7	0	0
10	1073456	.	T	C	3	3	6	0	0	6	0	0
10	1073519	.	G	C	0	3	3	0	3	6	0	0
10	1076044	.	C	T	5	4	9	0	0	9	0	0
10	1107441	.	G	A	1	16	17	1	14	32	0	0
10	1107460	.	C	T	20	12	32	1	1	34	0	0
10	1107540	.	C	A	14	6	20	0	0	20	0	0
10	1113781	.	C	T	1	1	2	0	1	3	0	0
10	1436596	.	C	G	0	6	6	0	5	11	0	0
10	1541357	.	G	C	20	0	20	0	11	31	0	0
10	1541359	.	T	C	14	0	14	0	17	31	0	0
10	1543805	.	C	G	0	7	7	0	12	19	0	0
10	1543848	.	G	C	8	0	8	1	8	17	0	0
10	1546089	.	A	C	12	0	12	0	8	20	0	0
10	1549013	.	C	A	1	11	12	0	7	19	0	0
10	1549088	.	C	T	3	8	11	0	7	18	0	0
10	1549409	.	T	C	7	0	7	0	11	18	0	0
10	1549494	.	G	A	11	12	23	0	2	25	0	0
10	1549532	.	A	G	5	7	12	0	0	12	0	0
10	1549714	.	G	A	5	4	9	0	0	9	0	0
10	1549769	.	A	G	2	6	8	0	0	8	0	0
10	1711499	.	T	C	11	4	15	0	1	16	0	0
10	1711502	.	T	C	4	8	12	0	1	13	0	0
10	1712457	.	C	A	8	6	14	3	2	19	0	0
10	2836139	.	T	A	2	2	4	0	1	5	0	0
10	2836235	.	T	A	1	2	3	0	0	3	0	0
10	2848976	.	A	G	1	2	3	0	0	3	0	0
10	2850332	.	A	G	1	2	3	0	0	3	0	0
10	2856558	.	G	A	1	5	6	0	1	7	0	0
10	2860806	.	G	A	6	4	10	0	0	10	0	0
10	2861679	.	T	C	4	0	4	0	3	7	0	0
10	2862538	.	T	A	2	3	5	0	0	5	0	0
10	2869760	.	G	A	1	2	3	0	0	3	0	0
10	2884136	.	G	C	0	5	5	0	2	7	0	0
10	2885852	.	C	T	7	2	9	0	0	9	0	0
10	2891893	.	C	T	6	6	12	0	0	12	0	0
10	2891905	.	G	A	7	4	11	0	0	11	0	0
10	2891981	.	A	T	4	4	8	0	0	8	0	0
10	2894193	.	T	G	2	0	2	0	9	11	0	0
10	2894451	.	G	A	0	10	10	0	6	16	0	0
10	2894610	.	G	C	11	16	27	0	0	27	0	0
10	2897110	.	A	C	10	8	18	0	2	20	0	0
10	2897720	.	T	A	14	11	25	0	0	25	0	0
10	2897817	.	T	G	13	1	14	1	12	27	0	0
10	2897897	.	A	G	4	2	6	0	0	6	0	0
10	2897911	.	G	T	4	3	7	0	0	7	0	0
10	2898087	.	T	C	2	5	7	0	0	7	0	0
10	2898212	.	T	G	1	1	2	0	1	3	0	0
10	2898213	.	C	G	1	2	3	0	0	3	0	0
10	2898269	.	C	T	1	9	10	0	3	13	0	0
10	2898346	.	T	A	5	6	11	0	0	11	0	0
10	2898390	.	A	T	2	2	4	0	1	5	0	0
10	2905862	.	G	A	1	2	3	0	0	3	0	0
10	2905868	.	T	C	2	1	3	0	0	3	0	0
10	2914955	.	G	A	0	3	3	0	4	7	0	0
10	2925056	.	A	T	5	5	10	0	0	10	0	0
10	2925089	.	A	G	7	5	12	0	1	13	0	0
10	2925379	.	G	T	3	2	5	0	0	5	0	0
10	2925639	.	G	A	6	10	16	0	0	16	0	0
10	2930577	.	C	A	1	2	3	0	0	3	0	0
10	3010820	.	C	G	2	2	4	0	1	5	0	0
10	3022076	.	G	T	4	3	7	0	0	7	0	0
10	3024637	.	C	G	3	4	7	0	2	9	0	0
10	3024706	.	C	T	5	2	7	0	1	8	0	0
10	3026264	.	A	C	3	5	8	0	0	8	0	0
10	3031670	.	T	C	3	0	3	0	4	7	0	0
10	3133204	.	T	A	5	12	17	0	1	18	0	0
10	3133598	.	A	C	7	5	12	0	0	12	0	0
10	3194054	.	T	C	5	2	7	0	0	7	0	0
10	3197593	.	A	G	2	3	5	0	0	5	0	0
10	3228531	.	A	G	2	3	5	0	0	5	0	0
10	3317675	.	C	T	14	5	19	0	1	20	0	0
10	3317800	.	C	A	6	5	11	0	0	11	0	0
10	3317823	.	G	T	9	4	13	0	0	13	0	0
10	3318112	.	G	C	5	2	7	0	0	7	0	0
10	3318490	.	G	A	2	2	4	0	2	6	0	0
10	3318502	.	A	G	3	2	5	0	0	5	0	0
10	3318973	.	A	G	7	2	9	1	1	11	0	0
10	3318978	.	A	G	5	0	5	0	4	9	0	0
10	3319029	.	A	T	7	5	12	0	0	12	0	0
10	3319035	.	C	T	7	3	10	0	1	11	0	0
10	3319352	.	A	G	4	6	10	2	0	12	0	0
10	3320072	.	T	G	8	7	15	0	0	15	0	0
10	3320229	.	G	A	7	12	19	0	0	19	0	0
10	3320287	.	T	G	10	4	14	0	0	14	0	0
10	3320355	.	A	T	12	9	21	0	1	22	0	0
10	3320487	.	A	G	10	0	10	1	8	19	0	0
10	3320561	.	A	T	7	10	17	0	1	19	1	0
10	3320705	.	G	A	8	9	17	0	0	17	0	0
10	3320834	.	A	C	15	11	26	0	2	28	0	0
10	3320850	.	C	T	13	5	18	0	3	21	0	0
10	3321262	.	A	G	11	28	39	0	1	40	0	0
10	3322004	.	C	G	22	10	32	1	2	35	0	0
10	3322012	.	C	T	23	12	35	1	0	36	0	0
10	3322276	.	G	C	19	5	24	0	0	24	0	0
10	3341412	.	C	T	3	2	5	0	0	5	0	0
10	3355651	.	T	C	3	4	7	0	0	7	0	0
10	3365312	.	T	C	5	3	8	0	0	8	0	0
10	3366199	.	C	T	0	6	6	0	7	13	0	0
10	3367810	.	C	T	8	8	16	0	0	16	0	0
10	3400126	.	A	T	3	2	5	0	1	6	0	0
10	3400216	.	C	T	1	7	8	0	1	9	0	0
10	3400225	.	T	C	1	9	10	0	1	11	0	0
10	3400360	.	G	A	1	4	5	0	0	5	0	0
10	3420148	.	G	A	24	16	40	0	0	40	0	0
10	3420358	.	T	C	12	7	19	3	0	22	0	0
10	3420480	.	C	G	18	12	30	0	3	33	0	0
10	3420487	.	T	C	18	2	20	0	15	35	0	0
10	3441753	.	T	A	1	2	3	0	1	4	0	0
10	3441973	.	T	C	2	2	4	0	0	4	0	0
10	3441980	.	T	C	2	3	5	0	0	5	0	0
10	3445818	.	C	T	4	4	8	0	0	8	0	0
10	3450861	.	A	G	2	8	10	0	0	10	0	0
10	3450863	.	A	T	3	7	10	0	0	10	0	0
10	3451349	.	T	A	5	4	9	0	0	9	0	0
10	3451429	.	G	A	1	4	5	0	7	12	0	0
10	3451688	.	C	T	6	2	8	0	1	9	0	0
10	3451848	.	G	A	0	3	3	0	9	12	0	0
10	3452007	.	A	T	5	3	8	0	1	9	0	0
10	3452045	.	G	A	3	5	8	0	0	8	0	0
10	3452073	.	A	G	4	10	14	0	0	14	0	0
10	3452183	.	G	A	9	2	11	0	0	11	0	0
10	3452185	.	T	A	10	2	12	0	0	12	0	0
10	3452314	.	T	C	11	4	15	0	0	15	0	0
10	3532171	.	G	T	1	3	4	0	1	5	0	0
10	3532469	.	C	T	3	2	5	0	0	5	0	0
10	3532470	.	G	A	0	2	2	0	3	5	0	0
10	3532626	.	A	C	2	2	4	0	0	4	0	0
10	4029813	.	C	T	3	2	5	0	0	5	0	0
10	4038334	.	G	A	7	6	13	0	1	14	0	0
10	4038697	.	C	T	4	3	7	0	1	8	0	0
10	4038721	.	G	A	0	6	6	0	5	11	0	0
10	4038772	.	G	A	5	8	13	0	0	13	0	0
10	4039094	.	G	A	10	11	21	0	2	23	0	0
10	4039123	.	C	T	15	8	23	0	2	25	0	0
10	4039129	.	C	T	17	9	26	0	0	26	0	0
10	4039315	.	A	T	14	9	23	0	1	24	0	0
10	4039636	.	T	C	11	15	26	0	0	26	0	0
10	4039714	.	T	C	14	10	24	0	0	24	0	0
10	4098235	.	C	T	4	3	7	0	0	7	0	0
10	4240887	.	T	C	5	6	11	0	1	12	0	0
10	4240899	.	C	T	6	6	12	0	1	13	0	0
10	4253636	.	C	T	10	7	17	0	0	17	0	0
10	4279716	.	C	T	2	3	5	0	0	5	0	0
10	4279800	.	A	G	1	6	7	0	0	7	0	0
10	4284078	.	C	T	2	2	4	0	3	7	0	0
10	4284081	.	A	G	3	1	4	0	1	6	1	0
10	4500050	.	G	A	3	3	6	0	0	6	0	0
10	4501817	.	A	G	2	3	5	0	0	5	0	0
10	4502929	.	C	T	3	8	11	0	0	11	0	0
10	4503291	.	G	T	4	5	9	0	0	9	0	0
10	4503465	.	A	C	9	3	12	0	0	12	0	0
10	4503467	.	A	T	10	3	13	0	0	13	0	0
10	4508518	.	G	T	2	11	13	0	8	21	0	0
10	4950854	.	G	A	5	7	12	0	1	13	0	0
10	4950857	.	T	C	5	7	12	0	1	13	0	0
10	4950914	.	T	C	7	0	7	0	6	13	0	0
10	4953443	.	C	T	4	4	8	0	0	8	0	0
10	4953461	.	C	A	2	3	5	0	0	5	0	0
10	4953987	.	A	C	4	0	4	0	7	11	0	0
10	4956942	.	C	T	0	2	2	0	2	4	0	0
10	4966683	.	G	A	2	14	16	0	17	33	0	0
10	4969014	.	T	A	11	10	21	0	3	24	0	0
10	4969036	.	T	G	10	0	10	0	8	18	0	0
10	4969069	.	C	A	8	7	15	0	0	15	0	0
10	4995830	.	A	C	1	3	4	0	0	4	0	0
10	5000719	.	C	T	2	13	15	2	17	34	0	0
10	5000753	.	C	T	2	14	16	0	20	36	0	0
10	5004215	.	C	T	8	10	18	0	1	19	0	0
10	5010287	.	G	A	15	17	32	0	3	35	0	0
10	5010344	.	T	G	17	22	39	0	1	40	0	0
10	5010407	.	G	A	13	13	26	0	2	28	0	0
10	5016797	.	G	A	19	21	40	0	0	40	0	0
10	5016917	.	C	G	23	20	43	0	2	45	0	0
10	5016922	.	A	G	23	19	42	0	3	45	0	0
10	5020320	.	G	A	27	29	56	0	1	57	0	0
10	5020326	.	T	C	30	23	53	0	2	55	0	0
10	5024410	.	C	T	18	17	35	0	2	37	0	0
10	5025848	.	C	A	4	6	10	0	0	10	0	0
10	5026058	.	C	T	5	3	8	0	1	9	0	0
10	5028877	.	A	G	3	6	9	0	1	10	0	0
10	5031869	.	T	C	5	8	13	0	0	13	0	0
10	5036521	.	G	A	0	15	15	1	5	21	0	0
10	5036522	.	A	G	5	14	19	1	0	21	1	0
10	5036729	.	C	T	15	7	22	0	3	25	0	0
10	5036881	.	A	G	5	1	6	0	3	9	0	0
10	5037119	.	T	A	10	13	23	0	0	23	0	0
10	5037147	.	C	T	9	7	16	0	0	16	0	0
10	5037181	.	T	G	9	8	17	0	0	17	0	0
10	5037260	.	A	C	2	11	13	0	0	13	0	0
10	5042113	.	C	T	3	4	7	0	1	8	0	0
10	5042217	.	A	G	6	3	9	0	0	9	0	0
10	5042239	.	G	A	5	2	7	0	0	7	0	0
10	5042469	.	G	A	4	3	7	0	0	7	0	0
10	5092764	.	T	C	7	9	16	3	0	19	0	0
10	5092772	.	A	G	4	8	12	4	1	17	0	0
10	5093222	.	A	G	10	11	21	0	0	21	0	0
10	5093240	.	C	A	10	9	19	0	0	19	0	0
10	5093274	.	A	G	7	10	17	0	1	18	0	0
10	5094649	.	C	A	2	5	7	0	0	7	0	0
10	5094778	.	G	T	4	3	7	0	0	7	0	0
10	5097478	.	G	A	2	3	5	0	1	6	0	0
10	5097520	.	A	G	2	4	6	0	0	6	0	0
10	5110777	.	G	A	1	2	3	0	0	3	0	0
10	5203569	.	G	A	1	3	4	0	0	4	0	0
10	5216249	.	A	G	2	2	4	0	0	4	0	0
10	5220608	.	C	T	5	5	10	0	0	10	0	0
10	5220992	.	C	T	1	4	5	0	1	6	0	0
10	5221039	.	G	A	1	3	4	0	0	4	0	0
10	5221238	.	C	A	2	2	4	0	1	5	0	0
10	5221292	.	C	A	1	3	4	0	0	4	0	0
10	5221297	.	T	G	1	2	3	0	0	3	0	0
10	5237199	.	C	A	1	2	3	0	0	3	0	0
10	5237213	.	C	T	0	2	2	0	0	2	0	0
10	5245143	.	G	A	0	2	2	0	2	4	0	0
10	5248247	.	T	C	3	3	6	0	1	7	0	0
10	5257980	.	C	T	3	2	5	0	0	5	0	0
10	5258914	.	T	A	5	2	7	0	3	10	0	0
10	5264280	.	A	G	7	8	15	0	0	15	0	0
10	5264310	.	G	A	8	7	15	0	3	18	0	0
10	5264458	.	G	A	4	7	11	0	0	11	0	0
10	5264534	.	C	A	3	6	9	0	0	9	0	0
10	5417669	.	T	A	2	3	5	0	0	5	0	0
10	5418509	.	A	G	4	7	11	0	1	12	0	0
10	5429905	.	G	A	0	5	5	0	2	7	0	0
10	5432576	.	T	C	3	3	6	0	0	6	0	0
10	5475206	.	G	C	11	8	19	0	0	19	0	0
10	5475214	.	T	G	12	7	19	0	1	20	0	0
10	5475406	.	A	T	4	2	6	0	1	7	0	0
10	5475436	.	A	G	5	4	9	0	0	9	0	0
10	5475526	.	T	C	6	8	14	0	0	14	0	0
10	5534179	.	T	A	6	3	9	0	0	9	0	0
10	5534369	.	T	A	4	3	7	0	0	7	0	0
10	5534483	.	T	C	9	2	11	0	1	12	0	0
10	5534487	.	C	T	2	2	4	0	9	13	0	0
10	5534527	.	G	T	9	3	12	0	0	12	0	0
10	5534611	.	C	T	9	8	17	1	1	19	0	0
10	5534612	.	A	G	8	8	16	1	1	18	0	0
10	5534646	.	A	G	6	7	13	0	1	14	0	0
10	5534878	.	C	T	9	7	16	0	0	16	0	0
10	5534946	.	A	G	6	6	12	0	0	12	0	0
10	5534950	.	A	T	5	6	11	0	1	12	0	0
10	5535047	.	A	T	6	3	9	1	2	12	0	0
10	5535048	.	C	G	9	3	12	1	0	13	0	0
10	5535359	.	A	T	7	4	11	1	1	13	0	0
10	5535368	.	T	A	7	2	9	1	1	11	0	0
10	5535436	.	C	T	2	3	5	0	0	5	0	0
10	5535445	.	T	C	2	3	5	0	2	7	0	0
10	5535483	.	A	T	4	9	13	0	1	14	0	0
10	5535540	.	T	G	2	10	12	0	1	13	0	0
10	5535561	.	T	A	4	6	10	0	1	11	0	0
10	5536240	.	T	C	3	2	5	0	0	5	0	0
10	5536256	.	G	A	2	2	4	0	0	4	0	0
10	5536831	.	G	T	1	2	3	0	0	3	0	0
10	5538302	.	T	G	2	3	5	0	1	6	0	0
10	5542152	.	T	C	3	2	5	0	0	5	0	0
10	5545438	.	C	T	3	3	6	0	0	6	0	0
10	5545465	.	T	C	2	3	5	0	0	5	0	0
10	5667411	.	G	A	3	3	6	0	0	6	0	0
10	5667439	.	A	T	2	5	7	0	1	8	0	0
10	5667467	.	T	A	4	8	12	0	1	13	0	0
10	5667504	.	G	A	7	5	12	0	0	12	0	0
10	5667676	.	C	A	1	2	3	0	0	3	0	0
10	5667792	.	G	A	0	6	6	0	0	6	0	0
10	5667813	.	T	A	1	6	7	0	0	7	0	0
10	5668103	.	C	T	1	4	5	0	0	5	0	0
10	5668135	.	G	A	3	5	8	0	0	8	0	0
10	5668218	.	G	C	2	2	4	0	0	4	0	0
10	5724095	.	T	C	1	2	3	0	0	3	0	0
10	5737757	.	G	A	3	3	6	0	0	6	0	0
10	5744934	.	C	T	2	3	5	0	0	5	0	0
10	5745015	.	C	A	6	4	10	0	1	11	0	0
10	5745290	.	T	C	3	2	5	2	0	7	0	0
10	5745299	.	C	T	2	2	4	2	1	7	0	0
10	5760455	.	T	C	3	3	6	0	2	8	0	0
10	5760461	.	A	G	6	5	11	0	0	11	0	0
10	5766958	.	A	G	8	10	18	0	1	19	0	0
10	5769541	.	G	T	12	9	21	0	1	22	0	0
10	5772568	.	A	G	18	16	34	0	5	39	0	0
10	5782337	.	C	T	28	26	54	0	1	55	0	0
10	5788755	.	A	C	5	9	14	0	0	14	0	0
10	5788806	.	G	A	9	10	19	0	0	19	0	0
10	5788877	.	G	A	10	5	15	1	1	17	0	0
10	5789155	.	G	T	5	6	11	0	0	11	0	0
10	5789415	.	A	G	5	5	10	0	0	10	0	0
10	5789417	.	G	C	5	4	9	0	1	10	0	0
10	5789806	.	C	T	10	5	15	0	0	15	0	0
10	5790080	.	A	G	6	5	11	0	0	11	0	0
10	5790097	.	G	A	7	4	11	0	0	11	0	0
10	5790135	.	T	C	3	4	7	0	0	7	0	0
10	5790210	.	C	T	9	6	15	0	0	15	0	0
10	5790278	.	G	T	3	2	5	1	0	6	0	0
10	5790570	.	A	C	4	5	9	0	1	10	0	0
10	5790640	.	T	G	2	2	4	0	0	4	0	0
10	5790866	.	A	C	6	4	10	0	0	10	0	0
10	5790913	.	A	C	3	3	6	0	1	7	0	0
10	5790922	.	C	A	2	3	5	0	1	6	0	0
10	5790956	.	C	G	1	3	4	0	6	10	0	0
10	5791030	.	A	G	4	6	10	0	0	10	0	0
10	5791044	.	C	T	0	5	5	0	4	9	0	0
10	5791184	.	G	A	3	4	7	0	0	7	0	0
10	5791224	.	C	G	3	2	5	0	0	5	0	0
10	5791387	.	G	A	4	2	6	0	0	6	0	0
10	5791417	.	C	T	1	2	3	0	2	5	0	0
10	5792512	.	A	T	4	2	6	0	0	6	0	0
10	5793376	.	G	A	1	2	3	0	0	3	0	0
10	5828639	.	C	T	8	7	15	0	1	16	0	0
10	5828645	.	A	G	7	7	14	0	0	14	0	0
10	5828704	.	C	A	1	7	8	0	4	12	0	0
10	5828840	.	A	G	2	8	10	0	0	10	0	0
10	5829041	.	A	G	4	4	8	0	0	8	0	0
10	6033612	.	G	A	1	7	8	0	7	15	0	0
10	6033627	.	A	T	7	5	12	0	1	13	0	0
10	6034194	.	A	T	10	5	15	0	1	16	0	0
10	6278202	.	A	G	1	2	3	0	0	3	0	0
10	6301828	.	C	T	3	3	6	0	0	6	0	0
10	6301930	.	C	T	4	5	9	0	2	11	0	0
10	6312954	.	A	T	1	5	6	0	1	7	0	0
10	6313172	.	T	C	5	2	7	0	0	7	0	0
10	6313643	.	C	T	5	5	10	0	1	11	0	0
10	6348571	.	C	A	6	3	9	0	0	9	0	0
10	6372915	.	G	A	5	6	11	0	0	11	0	0
10	6372964	.	T	C	1	3	4	0	0	4	0	0
10	6373332	.	A	T	4	2	6	0	1	7	0	0
10	6373336	.	C	G	4	2	6	0	1	7	0	0
10	6373378	.	A	C	2	2	4	0	0	4	0	0
10	6373472	.	T	A	2	2	4	0	0	4	0	0
10	6373522	.	A	T	3	5	8	0	0	9	1	0
10	6373524	.	A	G	5	4	9	0	0	9	0	0
10	6373679	.	A	G	7	6	13	0	0	13	0	0
10	6373758	.	A	C	11	10	21	0	1	22	0	0
10	6373868	.	A	G	10	5	15	0	0	15	0	0
10	6373900	.	A	G	9	3	12	0	1	13	0	0
10	6373975	.	A	G	13	3	16	0	1	17	0	0
10	6374017	.	A	G	11	7	18	0	0	18	0	0
10	6374041	.	A	T	11	7	18	0	1	19	0	0
10	6374068	.	G	T	7	9	16	0	0	16	0	0
10	6374235	.	T	C	15	16	31	0	0	31	0	0
10	6374279	.	G	A	2	15	17	0	16	33	0	0
10	6374352	.	C	T	16	17	33	0	1	34	0	0
10	6374501	.	A	G	4	14	18	0	2	20	0	0
10	6407559	.	A	T	4	3	7	1	0	8	0	0
10	6407733	.	A	G	1	3	4	0	0	4	0	0
10	6407764	.	C	A	1	3	4	0	0	4	0	0
10	6407871	.	A	G	1	3	4	1	1	6	0	0
10	6407904	.	C	T	5	3	8	1	0	9	0	0
10	6408955	.	T	G	4	0	4	0	6	10	0	0
10	6408986	.	A	G	7	3	10	0	0	10	0	0
10	6409095	.	G	A	0	3	3	0	6	9	0	0
10	6409120	.	G	A	6	3	9	0	2	11	0	0
10	6409145	.	G	C	6	5	11	0	1	12	0	0
10	6409267	.	C	A	4	3	7	0	0	7	0	0
10	6409379	.	A	G	3	6	9	0	0	9	0	0
10	6409448	.	C	T	5	5	10	0	0	10	0	0
10	6409455	.	T	A	5	5	10	0	0	10	0	0
10	6409506	.	A	G	5	8	13	0	0	13	0	0
10	6409583	.	C	T	7	4	11	0	0	11	0	0
10	6409695	.	C	A	2	2	4	0	0	4	0	0
10	6473544	.	T	C	11	14	25	0	2	27	0	0
10	6473685	.	T	C	9	10	19	0	1	20	0	0
10	6473704	.	C	G	7	15	22	0	0	22	0	0
10	6473851	.	A	G	12	8	20	0	2	22	0	0
10	6473862	.	C	T	2	9	11	0	10	21	0	0
10	6473908	.	A	G	10	8	18	0	0	18	0	0
10	6473996	.	T	C	7	5	12	0	1	13	0	0
10	6474057	.	T	A	11	7	18	0	0	18	0	0
10	6479444	.	T	C	11	0	11	0	8	19	0	0
10	6479471	.	C	T	1	5	6	0	12	18	0	0
10	6510756	.	T	C	13	27	40	0	0	40	0	0
10	6510786	.	T	G	16	22	38	0	1	39	0	0
10	6510825	.	T	C	18	22	40	0	2	42	0	0
10	6517593	.	T	A	27	34	61	0	1	62	0	0
10	6517663	.	A	G	25	0	25	0	20	45	0	0
10	6517726	.	C	T	27	20	47	0	1	48	0	0
10	6517959	.	A	G	27	16	43	0	1	44	0	0
10	6522267	.	A	T	7	5	12	0	1	13	0	0
10	6528005	.	A	G	2	8	10	0	0	10	0	0
10	6531002	.	A	G	4	4	8	0	0	8	0	0
10	6531297	.	T	C	7	4	11	0	1	12	0	0
10	6533850	.	T	A	5	4	9	0	1	10	0	0
10	6549360	.	C	T	1	2	3	0	0	3	0	0
10	6781239	.	G	A	7	7	14	0	1	15	0	0
10	6781278	.	T	A	10	9	19	1	0	20	0	0
10	6781286	.	G	T	11	8	19	1	0	20	0	0
10	6781362	.	G	A	20	22	42	0	1	43	0	0
10	6781372	.	T	A	17	27	44	0	3	47	0	0
10	6781450	.	T	C	23	15	38	0	1	39	0	0
10	6781506	.	A	T	17	10	27	0	0	27	0	0
10	6781664	.	A	T	14	12	26	0	1	27	0	0
10	6781742	.	G	T	8	12	20	0	4	24	0	0
10	6781786	.	A	T	9	8	17	0	0	17	0	0
10	6781867	.	C	A	4	7	11	0	1	12	0	0
10	6781903	.	T	G	4	11	15	0	0	15	0	0
10	6781918	.	A	T	2	12	14	0	4	18	0	0
10	6782020	.	G	C	9	14	23	0	1	24	0	0
10	6782036	.	T	C	9	1	10	0	10	20	0	0
10	6782220	.	A	G	4	4	8	4	0	12	0	0
10	6782267	.	T	A	4	5	9	4	0	13	0	0
10	6782279	.	A	C	4	8	12	1	1	14	0	0
10	6782454	.	C	G	10	15	25	0	1	26	0	0
10	6782489	.	T	G	13	12	25	0	0	25	0	0
10	6782624	.	A	G	12	14	26	0	1	27	0	0
10	6782636	.	T	A	10	21	31	0	0	31	0	0
10	6782664	.	A	G	13	28	41	0	0	41	0	0
10	6786326	.	C	T	0	21	21	0	11	32	0	0
10	6786564	.	A	G	12	18	30	0	3	33	0	0
10	6804756	.	T	C	3	0	3	0	5	8	0	0
10	6824761	.	A	C	4	6	10	0	1	11	0	0
10	6834065	.	A	T	3	2	5	0	0	5	0	0
10	6834341	.	G	A	2	5	7	0	0	7	0	0
10	6834380	.	C	A	0	4	4	0	3	7	0	0
10	6853641	.	A	G	2	3	5	0	0	5	0	0
10	7210001	.	G	A	0	7	7	0	8	15	0	0
10	7221810	.	A	G	7	6	13	0	0	13	0	0
10	7222213	.	T	C	5	14	19	0	0	19	0	0
10	7224964	.	A	G	5	19	24	0	1	25	0	0
10	7231728	.	T	C	16	9	25	0	3	28	0	0
10	7231821	.	T	A	23	11	34	0	2	36	0	0
10	7231964	.	G	C	26	14	40	0	0	40	0	0
10	7232043	.	T	A	10	11	21	0	1	22	0	0
10	7232058	.	G	T	1	11	12	0	8	20	0	0
10	7232104	.	A	T	12	12	24	0	0	24	0	0
10	7232309	.	C	T	5	3	8	0	0	8	0	0
10	7232416	.	T	C	14	14	28	0	2	30	0	0
10	7232420	.	T	C	16	13	29	0	2	31	0	0
10	7233038	.	T	C	17	16	33	0	0	33	0	0
10	7233218	.	A	G	27	17	44	0	1	45	0	0
10	7233440	.	A	T	28	30	58	0	6	64	0	0
10	7233457	.	C	G	31	26	57	0	4	61	0	0
10	7233518	.	T	C	30	21	51	0	1	52	0	0
10	7233854	.	A	T	21	16	37	0	3	40	0	0
10	7233939	.	C	T	9	6	15	0	1	16	0	0
10	7284182	.	T	A	6	5	11	0	0	11	0	0
10	7284403	.	C	T	3	3	6	0	0	6	0	0
10	7284556	.	T	A	4	2	6	1	0	7	0	0
10	7284629	.	T	C	0	4	4	0	1	5	0	0
10	7593246	.	A	T	1	5	6	0	1	7	0	0
10	7593349	.	C	A	2	3	5	0	0	5	0	0
10	7617113	.	A	T	24	35	59	0	4	64	1	0
10	7617126	.	T	C	25	34	59	0	1	60	0	0
10	7617242	.	G	A	28	30	58	0	6	64	0	0
10	7617327	.	A	C	9	29	38	2	13	53	0	0
10	7617350	.	A	T	15	33	48	3	6	57	0	0
10	7617636	.	A	G	19	1	20	0	24	44	0	0
10	7635245	.	C	T	1	3	4	0	1	5	0	0
10	7640501	.	C	T	20	24	44	0	3	47	0	0
10	7640676	.	G	A	24	18	42	0	1	43	0	0
10	7671368	.	T	C	4	9	13	0	1	14	0	0
10	7671425	.	G	A	7	8	15	0	0	15	0	0
10	7672832	.	A	C	15	4	19	0	1	20	0	0
10	7672853	.	G	A	12	9	21	0	3	24	0	0
10	7673774	.	G	A	5	2	7	0	1	8	0	0
10	7674079	.	T	G	6	4	10	0	0	10	0	0
10	7674471	.	A	G	3	3	6	0	0	6	0	0
10	7674506	.	A	G	6	5	11	0	1	12	0	0
10	7678121	.	T	C	11	11	22	0	0	22	0	0
10	7678154	.	C	T	0	8	8	0	10	18	0	0
10	7678525	.	C	T	0	5	5	0	6	11	0	0
10	7700564	.	T	G	3	4	7	0	0	7	0	0
10	7700615	.	A	G	2	4	6	0	0	6	0	0
10	7700676	.	G	A	2	3	5	0	0	5	0	0
10	7701852	.	A	C	2	0	2	0	2	4	0	0
10	7709761	.	T	C	1	2	3	0	0	3	0	0
10	7713924	.	A	G	1	0	1	0	3	4	0	0
10	7721459	.	A	G	3	6	9	0	1	10	0	0
10	7721746	.	G	A	4	5	9	0	0	9	0	0
10	7722595	.	A	G	3	8	11	0	2	13	0	0
10	7723004	.	T	C	2	6	8	1	0	9	0	0
10	7723157	.	A	G	13	12	25	0	1	26	0	0
10	7723218	.	T	C	14	20	34	0	0	34	0	0
10	7723275	.	C	A	12	21	33	0	0	33	0	0
10	7723337	.	C	G	8	9	17	0	1	18	0	0
10	7723413	.	T	G	5	3	8	0	0	8	0	0
10	7727393	.	T	C	1	2	3	0	0	3	0	0
10	7727505	.	T	A	2	2	4	0	1	5	0	0
10	7727704	.	T	A	2	5	7	0	0	7	0	0
10	7734401	.	G	A	1	4	5	0	0	5	0	0
10	7734465	.	C	T	3	2	5	0	0	5	0	0
10	7770200	.	A	G	1	5	6	0	1	7	0	0
10	7770201	.	G	A	1	6	7	0	0	7	0	0
10	7770425	.	T	C	2	0	2	0	5	7	0	0
10	7770467	.	C	T	0	3	3	0	1	4	0	0
10	7771015	.	G	A	1	2	3	0	0	3	0	0
10	7771634	.	T	A	3	5	8	0	0	8	0	0
10	7771735	.	A	C	2	3	5	0	0	5	0	0
10	7771769	.	C	T	4	4	8	0	0	8	0	0
10	7771778	.	G	A	4	4	8	0	0	8	0	0
10	7772012	.	T	G	6	6	12	0	0	12	0	0
10	7772272	.	C	T	3	3	6	0	1	7	0	0
10	7810461	.	A	T	20	16	36	0	1	37	0	0
10	7810565	.	G	A	15	15	30	0	0	30	0	0
10	7811062	.	T	A	3	5	8	0	0	8	0	0
10	7811075	.	T	C	3	4	7	0	0	7	0	0
10	7811935	.	A	G	4	4	8	0	1	9	0	0
10	7815118	.	G	A	8	5	13	0	0	13	0	0
10	7815187	.	G	A	11	5	16	0	0	16	0	0
10	7916836	.	A	C	16	9	25	0	2	27	0	0
10	7916930	.	C	A	11	14	25	0	2	27	0	0
10	7917036	.	A	T	12	23	35	0	0	35	0	0
10	7917114	.	T	C	18	17	35	0	3	38	0	0
10	7917411	.	C	A	1	12	13	0	14	27	0	0
10	7917483	.	C	A	11	12	23	0	3	26	0	0
10	7917551	.	A	G	17	16	33	0	0	33	0	0
10	7917592	.	T	C	16	16	32	0	1	33	0	0
10	7917686	.	T	C	17	19	36	0	2	38	0	0
10	7917690	.	A	T	17	19	36	0	2	38	0	0
10	7920910	.	T	G	14	16	30	0	0	30	0	0
10	7920913	.	C	T	14	12	26	0	5	31	0	0
10	7922210	.	G	T	7	12	19	0	2	21	0	0
10	7922294	.	C	A	9	5	14	0	0	14	0	0
10	7926899	.	A	G	9	12	21	0	0	21	0	0
10	7936283	.	T	G	2	10	12	0	0	12	0	0
10	7938683	.	T	C	4	3	7	0	0	7	0	0
10	7959655	.	T	A	2	3	5	0	0	5	0	0
10	7984677	.	A	T	7	8	15	0	2	17	0	0
10	7986217	.	T	C	4	8	12	0	0	12	0	0
10	7986307	.	C	T	0	4	4	0	11	15	0	0
10	7986432	.	C	T	1	8	9	0	10	19	0	0
10	7989000	.	C	T	8	4	12	0	1	13	0	0
10	7989162	.	T	G	7	7	14	0	0	14	0	0
10	7989237	.	G	A	5	7	12	0	0	12	0	0
10	7989287	.	G	A	8	10	18	0	0	18	0	0
10	7989348	.	C	T	8	11	19	0	1	20	0	0
10	7989576	.	C	T	5	11	16	0	1	17	0	0
10	7992197	.	T	C	7	10	17	0	1	18	0	0
10	8001365	.	A	G	3	8	11	0	0	11	0	0
10	8032910	.	C	T	1	2	3	0	0	3	0	0
10	8034855	.	C	T	2	2	4	0	0	4	0	0
10	8034890	.	T	C	3	2	5	0	0	5	0	0
10	8035058	.	T	G	5	2	7	0	0	7	0	0
10	8035178	.	G	A	1	2	3	0	1	4	0	0
10	8035195	.	T	A	1	3	4	0	0	4	0	0
10	8035262	.	C	T	0	3	3	0	7	10	0	0
10	8035419	.	A	T	1	2	3	0	0	3	0	0
10	8035510	.	C	T	1	2	3	0	6	9	0	0
10	8035702	.	C	T	3	3	6	0	0	6	0	0
10	8036409	.	T	C	2	1	3	0	0	5	2	0
10	8036428	.	G	T	2	2	4	0	0	4	0	0
10	8036813	.	C	T	4	5	9	1	1	11	0	0
10	8036839	.	G	A	4	3	7	1	0	8	0	0
10	8037351	.	C	T	0	3	3	0	1	4	0	0
10	8037395	.	A	T	2	3	5	0	0	5	0	0
10	8037425	.	A	G	6	4	10	0	0	10	0	0
10	8037820	.	A	T	1	2	3	0	0	3	0	0
10	8041874	.	C	T	1	3	4	0	0	4	0	0
10	8045699	.	G	A	1	2	3	0	0	3	0	0
10	8045702	.	G	T	1	2	3	0	0	3	0	0
10	8091169	.	G	T	3	3	6	0	0	6	0	0
10	8097929	.	C	G	21	19	40	0	2	42	0	0
10	8154892	.	C	T	11	7	18	0	0	18	0	0
10	8160813	.	T	G	6	5	11	1	0	12	0	0
10	8161027	.	A	G	3	4	7	0	0	7	0	0
10	8163440	.	G	A	3	6	9	0	0	9	0	0
10	8170083	.	C	A	2	5	7	0	0	7	0	0
10	8170468	.	C	A	0	2	2	0	2	4	0	0
10	8175098	.	T	C	1	0	1	0	1	2	0	0
10	8175123	.	T	C	0	2	2	0	0	2	0	0
10	8184599	.	C	T	1	2	3	0	0	3	0	0
10	8235946	.	A	G	2	0	2	0	3	5	0	0
10	8236775	.	T	C	2	3	5	0	0	5	0	0
10	8239318	.	T	C	5	3	8	0	0	8	0	0
10	8263045	.	G	A	11	6	17	0	1	18	0	0
10	8263081	.	T	C	6	6	12	0	2	14	0	0
10	8263919	.	C	T	8	9	17	1	0	18	0	0
10	8266383	.	A	G	11	12	23	1	1	25	0	0
10	8269377	.	G	A	13	14	27	0	0	27	0	0
10	8269515	.	T	C	1	4	5	0	0	5	0	0
10	8269772	.	C	A	0	2	2	0	2	4	0	0
10	8278160	.	T	C	9	3	12	0	2	14	0	0
10	8278214	.	A	G	5	3	8	1	2	11	0	0
10	8295026	.	C	T	1	2	3	0	0	3	0	0
10	8295295	.	C	A	0	3	3	0	2	5	0	0
10	8418671	.	A	G	4	2	6	0	0	6	0	0
10	8630402	.	G	T	0	7	7	0	7	14	0	0
10	8630428	.	A	G	5	12	17	0	0	17	0	0
10	8630452	.	G	T	3	12	15	0	0	15	0	0
10	8630527	.	G	A	7	8	15	0	0	15	0	0
10	8630618	.	C	T	7	7	14	0	0	14	0	0
10	8630631	.	T	C	6	8	14	0	0	14	0	0
10	8630702	.	T	C	9	7	16	1	1	18	0	0
10	8631135	.	A	G	8	12	20	0	0	20	0	0
10	8631152	.	A	T	8	9	17	0	1	18	0	0
10	8660722	.	C	T	16	7	23	0	0	23	0	0
10	8670139	.	G	A	9	3	12	0	0	12	0	0
10	8686713	.	G	C	1	4	5	0	1	6	0	0
10	8687402	.	A	T	1	2	3	0	0	3	0	0
10	8950055	.	G	A	3	7	10	0	0	10	0	0
10	8950108	.	A	G	8	8	16	0	0	16	0	0
10	8952018	.	T	C	4	5	9	0	1	10	0	0
10	8952601	.	A	G	2	2	4	0	0	4	0	0
10	8955356	.	C	A	1	2	3	0	1	4	0	0
10	8970757	.	T	C	2	2	4	0	0	4	0	0
10	8976311	.	T	G	2	2	4	0	0	4	0	0
10	9089524	.	A	C	1	0	1	0	4	5	0	0
10	9089569	.	T	A	2	3	5	0	0	5	0	0
10	9177363	.	T	C	7	7	14	0	1	15	0	0
10	9181508	.	T	A	13	10	23	0	0	23	0	0
10	9184326	.	T	A	12	4	16	1	1	18	0	0
10	9184533	.	C	T	10	11	21	0	0	21	0	0
10	9234573	.	G	T	1	2	3	0	0	3	0	0
10	9234742	.	G	A	1	2	3	0	2	5	0	0
10	9255670	.	G	A	3	12	15	0	1	16	0	0
10	9261398	.	A	G	3	2	5	0	1	6	0	0
10	9265007	.	C	A	3	3	6	0	1	7	0	0
10	9268272	.	T	G	2	5	7	0	0	7	0	0
10	9269228	.	G	A	2	4	6	0	1	7	0	0
10	9305277	.	G	A	4	5	9	0	0	9	0	0
10	9305433	.	A	G	9	6	15	0	0	15	0	0
10	9305534	.	A	C	7	4	11	0	1	12	0	0
10	9305543	.	C	T	7	6	13	0	0	13	0	0
10	9308057	.	C	T	9	6	15	0	1	16	0	0
10	9308092	.	G	A	6	4	10	0	0	10	0	0
10	9347928	.	C	G	4	0	4	0	4	8	0	0
10	9361037	.	C	T	1	2	3	0	0	3	0	0
10	9361891	.	G	A	4	5	9	0	0	9	0	0
10	9361924	.	G	C	3	5	8	0	1	9	0	0
10	9370121	.	A	T	7	5	12	0	2	14	0	0
10	9370274	.	G	A	6	6	12	0	0	12	0	0
10	9370755	.	A	G	18	6	24	0	1	25	0	0
10	9395012	.	C	T	5	5	10	0	2	12	0	0
10	9419821	.	G	A	5	28	33	0	0	33	0	0
10	9419901	.	T	A	10	14	24	0	0	24	0	0
10	9419902	.	A	G	9	14	23	0	0	23	0	0
10	9627603	.	T	C	1	2	3	0	0	3	0	0
10	9642832	.	T	G	1	0	1	0	2	3	0	0
10	9714771	.	T	C	1	5	6	0	0	6	0	0
10	9714819	.	A	G	1	4	5	0	1	6	0	0
10	9729611	.	G	A	0	6	6	0	4	10	0	0
10	9776699	.	C	T	13	8	21	0	2	23	0	0
10	9781455	.	G	A	8	11	19	0	3	22	0	0
10	9781509	.	G	A	13	9	22	0	2	24	0	0
10	9784087	.	C	T	16	14	30	0	1	31	0	0
10	9784238	.	G	A	0	13	13	0	20	33	0	0
10	9789262	.	C	T	9	17	26	0	1	27	0	0
10	9800719	.	G	T	15	13	28	1	3	32	0	0
10	9802771	.	T	C	14	22	36	0	1	37	0	0
10	9802804	.	C	T	16	11	27	0	1	28	0	0
10	9806731	.	A	G	11	0	11	0	20	31	0	0
10	9807014	.	T	G	22	9	31	0	4	35	0	0
10	9807203	.	G	A	27	14	41	0	1	42	0	0
10	9836752	.	C	T	1	6	7	0	0	7	0	0
10	9836936	.	C	A	2	2	4	0	0	4	0	0
10	9837027	.	T	C	2	2	4	0	0	4	0	0
10	9837100	.	T	C	5	3	8	0	0	8	0	0
10	9837191	.	A	G	6	6	12	0	1	13	0	0
10	9846240	.	A	G	10	9	19	0	0	19	0	0
10	9846261	.	G	A	10	10	20	0	0	20	0	0
10	9846285	.	T	G	7	5	12	0	2	14	0	0
10	9856390	.	T	C	1	0	1	0	4	5	0	0
10	10261887	.	G	C	1	2	3	0	0	3	0	0
10	10261893	.	C	A	2	2	4	0	0	4	0	0
10	10262013	.	T	C	1	2	3	0	1	4	0	0
10	10262157	.	A	G	1	2	3	0	0	3	0	0
10	10317392	.	A	T	5	4	9	0	0	9	0	0
10	10325451	.	T	C	6	5	11	0	0	11	0	0
10	10380074	.	G	A	2	2	4	0	1	5	0	0
10	10535877	.	C	T	1	2	3	0	0	3	0	0
10	10535884	.	C	A	1	2	3	0	0	3	0	0
10	10561156	.	T	A	4	4	8	0	1	9	0	0
10	10561657	.	G	T	1	1	2	0	1	3	0	0
10	10567262	.	A	G	2	2	4	0	0	4	0	0
10	11279555	.	G	A	7	8	15	0	0	15	0	0
10	11280118	.	C	T	7	7	14	0	0	14	0	0
10	11280146	.	C	T	7	9	16	0	0	16	0	0
10	11280834	.	A	C	1	2	3	0	0	3	0	0
10	11280839	.	G	C	1	2	3	0	0	3	0	0
10	11281148	.	G	A	3	2	5	0	0	5	0	0
10	11281421	.	T	C	2	4	6	0	0	6	0	0
10	11281422	.	T	C	1	4	5	0	1	6	0	0
10	11281690	.	A	G	1	2	3	0	0	3	0	0
10	11281845	.	T	A	1	2	3	0	0	3	0	0
10	11282072	.	G	A	1	4	5	0	0	5	0	0
10	11282099	.	A	G	4	2	6	0	0	6	0	0
10	11282194	.	A	G	4	5	9	0	0	9	0	0
10	11282335	.	A	G	1	8	9	0	1	10	0	0
10	11287343	.	A	G	2	0	2	0	3	5	0	0
10	11298955	.	T	C	3	3	6	0	0	6	0	0
10	11298975	.	C	T	2	3	5	0	0	5	0	0
10	11309859	.	C	G	7	0	7	0	3	10	0	0
10	11310041	.	G	A	4	12	16	0	0	16	0	0
10	11310618	.	A	C	11	10	21	0	1	22	0	0
10	11310648	.	G	A	9	7	16	0	0	16	0	0
10	11310739	.	G	A	1	2	3	0	0	3	0	0
10	11322985	.	T	C	2	2	4	0	0	4	0	0
10	11323032	.	G	A	3	3	6	0	0	6	0	0
10	11323092	.	G	A	2	4	6	0	1	7	0	0
10	11327484	.	C	T	1	3	4	0	6	10	0	0
10	11327703	.	C	T	6	5	11	0	1	12	0	0
10	11328246	.	G	C	4	4	8	0	0	8	0	0
10	11328263	.	G	A	5	3	8	0	0	8	0	0
10	11332206	.	A	G	5	2	7	0	1	8	0	0
10	11339235	.	G	A	2	3	5	0	0	5	0	0
10	11359991	.	A	G	5	1	6	0	3	9	0	0
10	11362275	.	C	T	14	18	32	0	1	33	0	0
10	11368116	.	G	T	13	9	22	0	0	22	0	0
10	11403954	.	T	C	3	6	9	0	0	9	0	0
10	11501181	.	C	A	7	3	10	0	1	11	0	0
10	11790947	.	T	C	4	6	10	0	0	10	0	0
10	11805601	.	T	C	3	2	5	0	0	5	0	0
10	12517338	.	C	T	1	2	3	0	0	3	0	0
10	13460381	.	A	G	1	4	5	0	1	6	0	0
10	13460494	.	A	C	7	13	20	0	0	20	0	0
10	13460671	.	G	A	12	14	26	0	1	27	0	0
10	13460691	.	T	C	14	12	26	0	1	27	0	0
10	13460745	.	C	A	0	19	19	0	17	36	0	0
10	13460765	.	C	T	18	16	34	0	1	35	0	0
10	13460814	.	A	T	12	17	29	0	0	29	0	0
10	13461080	.	T	C	16	0	16	0	18	34	0	0
10	13476010	.	A	G	10	15	25	0	2	27	0	0
10	13529250	.	C	G	4	8	12	0	0	12	0	0
10	13529270	.	T	C	5	6	11	0	0	11	0	0
10	14263906	.	T	G	2	2	4	0	0	4	0	0
10	14491139	.	C	T	12	6	18	0	1	19	0	0
10	14532271	.	T	C	3	8	11	0	1	12	0	0
10	14532398	.	T	C	11	0	11	0	10	21	0	0
10	14533352	.	A	G	4	5	9	0	1	10	0	0
10	14536393	.	G	A	5	4	9	0	0	9	0	0
10	14545572	.	A	G	11	12	23	0	1	24	0	0
10	14871245	.	T	A	14	6	20	0	5	25	0	0
10	14871292	.	G	A	16	5	21	0	3	24	0	0
10	14871758	.	C	G	17	8	25	0	1	26	0	0
10	14871768	.	A	G	16	12	28	0	1	29	0	0
10	14871801	.	A	C	16	12	28	0	2	30	0	0
10	14872258	.	T	G	4	2	6	0	1	7	0	0
10	14873175	.	T	G	13	9	22	0	3	25	0	0
10	14873220	.	A	G	14	11	25	0	1	26	0	0
10	14878863	.	C	G	7	2	9	0	0	9	0	0
10	14878890	.	T	C	6	0	6	0	4	10	0	0
10	14885337	.	A	G	4	2	6	0	0	6	0	0
10	14885957	.	C	A	0	3	3	0	2	5	0	0
10	14921086	.	A	C	2	0	2	0	2	4	0	0
10	15075575	.	G	T	1	2	3	0	0	3	0	0
10	15277481	.	T	C	2	3	5	0	0	5	0	0
10	15285852	.	T	G	3	0	3	0	3	6	0	0
10	15287883	.	C	A	5	3	8	0	1	9	0	0
10	15287933	.	C	T	3	5	8	0	1	9	0	0
10	15291157	.	G	A	1	11	12	0	10	22	0	0
10	15295913	.	T	C	5	6	11	0	1	12	0	0
10	15296219	.	G	A	3	9	12	0	8	20	0	0
10	15298458	.	G	C	6	12	18	0	1	19	0	0
10	15298518	.	G	A	16	12	28	0	1	29	0	0
10	15303975	.	A	T	20	23	43	0	2	45	0	0
10	15304167	.	A	G	6	9	15	0	0	15	0	0
10	15304331	.	C	A	16	12	28	0	1	29	0	0
10	15304782	.	A	G	21	19	40	0	1	41	0	0
10	15338917	.	T	G	1	2	3	0	0	3	0	0
10	15372708	.	G	T	12	11	23	1	4	28	0	0
10	15372726	.	G	A	12	9	21	1	2	24	0	0
10	15372889	.	G	A	19	13	32	0	2	34	0	0
10	15381782	.	C	G	9	8	17	0	1	18	0	0
10	15381784	.	A	C	8	9	17	0	1	18	0	0
10	15382352	.	A	G	10	10	20	0	0	20	0	0
10	15382546	.	A	G	14	9	23	0	1	24	0	0
10	15382669	.	G	A	20	16	36	0	0	36	0	0
10	15382681	.	A	T	19	17	36	0	1	37	0	0
10	15400027	.	G	A	12	17	29	0	0	29	0	0
10	15400692	.	T	G	7	7	14	0	0	14	0	0
10	15438451	.	G	A	1	2	3	0	0	3	0	0
10	15447471	.	T	C	3	3	6	0	0	6	0	0
10	15575364	.	C	T	1	2	3	0	1	4	0	0
10	15582906	.	C	T	4	4	8	0	0	8	0	0
10	15583105	.	C	T	2	2	4	0	0	4	0	0
10	15583153	.	G	C	4	3	7	0	0	7	0	0
10	15596752	.	C	T	4	5	9	0	0	9	0	0
10	15596767	.	C	G	2	4	6	0	0	6	0	0
10	15596958	.	G	C	1	4	5	0	0	5	0	0
10	15596995	.	C	T	4	6	10	0	1	11	0	0
10	15597662	.	G	C	2	3	5	0	0	5	0	0
10	15597822	.	G	A	2	3	5	0	2	7	0	0
10	15597834	.	A	T	3	3	6	0	0	6	0	0
10	15598303	.	A	T	5	5	10	0	0	10	0	0
10	15598358	.	T	G	8	9	17	0	3	20	0	0
10	15598412	.	T	C	4	10	14	0	1	15	0	0
10	15598598	.	T	G	12	7	19	0	1	20	0	0
10	15598681	.	G	A	1	11	12	0	8	20	0	0
10	15598921	.	T	A	16	7	23	0	1	24	0	0
10	15608373	.	T	C	5	4	9	0	0	9	0	0
10	15608756	.	T	C	4	16	20	0	0	20	0	0
10	15612238	.	C	T	16	10	26	0	1	27	0	0
10	15612602	.	G	A	15	9	24	1	0	25	0	0
10	15612675	.	T	A	29	10	39	0	1	40	0	0
10	15612705	.	C	T	25	14	39	0	2	41	0	0
10	15612758	.	G	A	19	17	36	0	1	37	0	0
10	15612859	.	G	T	2	19	21	0	15	36	0	0
10	15613076	.	G	A	1	11	12	0	12	24	0	0
10	15613174	.	A	C	5	5	10	0	0	10	0	0
10	15618227	.	C	A	1	3	4	0	0	4	0	0
10	15618411	.	A	G	4	6	10	0	0	10	0	0
10	15618606	.	A	G	4	2	6	0	0	6	0	0
10	15621499	.	A	G	7	2	9	0	0	9	0	0
10	15621529	.	C	T	1	3	4	0	9	13	0	0
10	15623124	.	T	C	5	3	8	0	1	9	0	0
10	15629349	.	C	T	2	5	7	0	0	7	0	0
10	15629642	.	C	T	1	3	4	0	0	4	0	0
10	15783637	.	A	G	6	0	6	0	12	18	0	0
10	15783721	.	A	G	4	7	11	0	3	14	0	0
10	15783777	.	G	A	3	3	6	0	0	6	0	0
10	15783934	.	T	C	3	5	8	0	0	8	0	0
10	15784613	.	G	A	0	13	13	0	10	23	0	0
10	15788562	.	A	T	10	12	22	0	3	25	0	0
10	15795197	.	A	G	14	0	14	0	14	28	0	0
10	15809215	.	C	T	23	9	32	0	2	34	0	0
10	15812950	.	A	G	12	0	12	0	27	39	0	0
10	15815984	.	A	T	6	2	8	0	0	8	0	0
10	15816029	.	T	A	4	6	10	0	0	10	0	0
10	15816577	.	C	A	1	2	3	0	0	3	0	0
10	15816852	.	C	G	0	6	6	0	8	14	0	0
10	15816879	.	G	A	6	5	11	0	1	12	0	0
10	15824645	.	A	G	8	5	13	0	0	13	0	0
10	15824648	.	A	G	8	3	11	0	0	11	0	0
10	15826905	.	G	A	1	2	3	0	1	4	0	0
10	15839025	.	G	A	1	2	3	0	0	3	0	0
10	15881732	.	G	T	7	2	9	0	2	11	0	0
10	15881819	.	T	G	11	7	18	0	1	19	0	0
10	15884833	.	G	A	10	8	18	0	1	19	0	0
10	15884872	.	T	C	7	0	7	0	8	15	0	0
10	15885056	.	C	G	6	8	14	0	1	15	0	0
10	15893297	.	A	T	3	4	7	0	0	7	0	0
10	15893347	.	G	A	3	2	5	0	0	5	0	0
10	15960967	.	T	A	9	3	12	0	0	12	0	0
10	15992712	.	T	A	2	2	4	0	0	4	0	0
10	15992731	.	A	T	2	2	4	0	0	4	0	0
10	15992968	.	A	C	2	5	7	0	0	7	0	0
10	16015332	.	G	A	12	6	18	0	1	19	0	0
10	16015509	.	C	A	0	3	3	0	3	6	0	0
10	16017676	.	A	T	6	6	12	0	0	12	0	0
10	16019482	.	G	A	4	3	7	0	0	7	0	0
10	16019881	.	A	G	1	3	4	0	5	9	0	0
10	16019902	.	C	T	1	5	6	0	0	6	0	0
10	16031378	.	T	C	2	8	10	0	2	12	0	0
10	16031555	.	C	T	3	5	8	0	0	8	0	0
10	16031648	.	C	G	9	5	14	0	0	14	0	0
10	16031690	.	A	G	7	5	12	0	0	12	0	0
10	16034782	.	A	G	10	6	16	0	0	16	0	0
10	16034796	.	C	T	10	5	15	0	0	15	0	0
10	16034887	.	G	A	5	4	9	0	0	9	0	0
10	16034901	.	A	C	2	8	10	0	1	11	0	0
10	16035084	.	G	A	13	4	17	0	0	17	0	0
10	16036615	.	T	C	3	3	6	0	0	6	0	0
10	16036818	.	C	T	2	2	4	0	0	4	0	0
10	16049522	.	T	C	6	2	8	0	0	8	0	0
10	16052536	.	T	C	9	10	19	0	0	19	0	0
10	16055878	.	C	T	5	6	11	0	0	11	0	0
10	16055906	.	C	T	7	5	12	0	0	12	0	0
10	16056137	.	T	A	7	2	9	0	0	9	0	0
10	16056145	.	A	G	7	2	9	0	0	9	0	0
10	16056181	.	T	A	6	3	9	0	0	9	0	0
10	16056511	.	T	C	11	9	20	0	0	20	0	0
10	16056739	.	A	G	3	2	5	0	0	5	0	0
10	16176720	.	C	T	1	3	4	0	0	4	0	0
10	16176906	.	G	A	4	4	8	0	0	8	0	0
10	16176915	.	G	A	6	4	10	0	0	10	0	0
10	16181904	.	T	C	2	2	4	0	0	4	0	0
10	16185500	.	T	C	4	3	7	1	1	9	0	0
10	16185915	.	T	G	5	4	9	0	0	9	0	0
10	16185927	.	C	G	5	5	10	0	0	10	0	0
10	16186158	.	T	C	6	9	15	0	1	16	0	0
10	16186405	.	T	A	10	9	19	0	0	19	0	0
10	16225872	.	C	T	3	2	5	0	1	6	0	0
10	16226250	.	A	C	2	3	5	0	0	5	0	0
10	16303060	.	A	T	6	2	8	0	0	8	0	0
10	16307651	.	T	A	5	9	14	0	0	14	0	0
10	16307679	.	T	A	5	9	14	0	0	14	0	0
10	16307952	.	A	G	5	2	7	0	0	7	0	0
10	16308206	.	T	C	1	6	7	0	1	8	0	0
10	16308272	.	A	G	5	3	8	0	1	9	0	0
10	16308643	.	G	A	1	6	7	0	9	16	0	0
10	16308648	.	G	T	0	6	6	0	9	15	0	0
10	16308923	.	G	A	0	9	9	0	15	24	0	0
10	16309001	.	T	A	14	9	23	3	0	26	0	0
10	16309017	.	G	A	13	4	17	3	3	23	0	0
10	16309167	.	T	C	12	14	26	0	2	28	0	0
10	16309364	.	A	G	2	2	4	0	0	4	0	0
10	16309498	.	C	T	7	15	22	0	3	25	0	0
10	16476113	.	C	T	1	2	3	0	0	3	0	0
10	16476122	.	G	A	1	2	3	0	0	3	0	0
10	16476267	.	A	T	1	1	2	0	1	3	0	0
10	16476352	.	A	G	2	3	5	0	0	5	0	0
10	16476742	.	A	T	2	7	9	0	0	9	0	0
10	16746706	.	C	A	1	5	6	0	0	6	0	0
10	16747465	.	A	C	5	3	8	0	0	8	0	0
10	16867505	.	G	T	1	2	3	0	0	3	0	0
10	17102971	.	C	T	37	27	64	0	4	68	0	0
10	17132501	.	C	T	11	25	36	0	1	37	0	0
10	17166889	.	C	T	0	6	6	0	12	18	0	0
10	17166955	.	A	G	7	14	21	0	1	22	0	0
10	17166982	.	A	G	11	18	29	0	1	30	0	0
10	17167637	.	A	G	22	23	45	0	2	47	0	0
10	17167733	.	T	C	24	18	42	0	4	46	0	0
10	17167757	.	G	A	21	18	39	0	3	42	0	0
10	17168039	.	C	T	15	16	31	0	1	32	0	0
10	17168096	.	A	G	15	14	29	0	2	31	0	0
10	17169948	.	C	G	11	13	24	0	1	25	0	0
10	17174687	.	C	T	4	2	6	0	1	7	0	0
10	17179400	.	G	A	1	2	3	0	0	3	0	0
10	17179557	.	C	T	12	4	16	0	0	16	0	0
10	17223867	.	T	A	5	2	7	0	1	8	0	0
10	17224218	.	G	A	4	3	7	0	2	9	0	0
10	17283386	.	A	G	4	4	8	0	0	8	0	0
10	17283720	.	T	A	3	1	4	0	1	5	0	0
10	17552889	.	A	T	4	2	6	0	0	6	0	0
10	17552976	.	T	C	4	6	10	0	1	11	0	0
10	17552994	.	T	C	4	7	11	0	0	11	0	0
10	17553184	.	T	C	5	5	10	0	0	10	0	0
10	17553271	.	G	A	13	6	19	0	1	20	0	0
10	17560030	.	G	A	8	9	17	0	0	17	0	0
10	17560390	.	T	C	5	6	11	0	0	11	0	0
10	17562978	.	G	C	10	3	13	0	2	15	0	0
10	17563180	.	A	G	4	5	9	0	0	9	0	0
10	17563279	.	C	T	5	5	10	0	3	13	0	0
10	17568878	.	C	T	3	2	5	0	0	5	0	0
10	17572866	.	C	A	0	3	3	0	2	6	1	0
10	17579715	.	A	C	4	2	6	0	0	6	0	0
10	17579855	.	T	A	2	2	4	0	0	4	0	0
10	17579865	.	G	T	2	1	3	0	1	4	0	0
10	17579948	.	T	A	2	2	4	0	0	4	0	0
10	17587553	.	G	A	1	3	4	0	0	4	0	0
10	17587628	.	A	T	1	2	3	0	0	3	0	0
10	17587742	.	G	A	2	3	5	0	0	5	0	0
10	17587789	.	G	A	3	2	5	0	0	5	0	0
10	17684736	.	C	T	7	4	11	0	0	11	0	0
10	17684739	.	C	T	5	4	9	0	2	11	0	0
10	17686174	.	T	C	11	10	21	0	0	21	0	0
10	17686216	.	T	C	9	11	20	0	2	22	0	0
10	17690998	.	C	T	8	8	16	0	3	19	0	0
10	17691127	.	T	G	8	4	12	0	0	12	0	0
10	17700237	.	T	C	3	1	4	0	9	13	0	0
10	17700365	.	A	T	11	10	21	0	1	22	0	0
10	17700458	.	T	C	4	10	14	0	0	14	0	0
10	17700484	.	A	T	4	4	8	0	1	9	0	0
10	17700753	.	C	A	5	3	8	0	0	8	0	0
10	17701002	.	C	G	10	9	19	0	1	20	0	0
10	17701003	.	C	A	0	10	10	0	10	20	0	0
10	17701222	.	C	T	0	7	7	0	6	13	0	0
10	17876862	.	A	G	3	0	3	0	3	6	0	0
10	17890850	.	G	A	5	7	12	0	0	12	0	0
10	17913424	.	A	C	8	8	16	0	0	16	0	0
10	17922444	.	A	G	9	7	16	0	1	17	0	0
10	17922540	.	A	T	18	5	23	0	1	24	0	0
10	17922582	.	C	T	9	10	19	0	1	20	0	0
10	17922651	.	G	C	9	8	17	0	1	18	0	0
10	17922718	.	C	T	11	7	18	0	1	19	0	0
10	17922807	.	A	G	13	0	13	0	7	20	0	0
10	17922894	.	T	G	2	9	11	0	1	12	0	0
10	17922955	.	A	T	2	4	6	0	0	6	0	0
10	17922973	.	T	C	3	4	7	0	0	7	0	0
10	17923490	.	A	T	9	9	18	0	2	20	0	0
10	17924398	.	A	C	6	6	12	0	1	13	0	0
10	17924420	.	T	C	6	5	11	0	0	11	0	0
10	17924740	.	T	G	13	12	25	0	1	26	0	0
10	17924779	.	G	A	18	15	33	0	1	34	0	0
10	17924836	.	T	A	16	11	27	0	1	28	0	0
10	17925146	.	T	C	17	15	32	0	1	33	0	0
10	17925301	.	T	A	12	10	22	0	1	23	0	0
10	17925302	.	G	T	12	11	23	0	0	23	0	0
10	17940303	.	G	A	0	7	7	0	28	35	0	0
10	17940352	.	G	A	27	16	43	0	0	43	0	0
10	17940356	.	A	G	24	12	36	0	4	40	0	0
10	17943696	.	G	A	30	17	47	0	3	50	0	0
10	17943714	.	T	C	33	20	53	0	2	55	0	0
10	17944017	.	C	T	35	13	48	0	0	48	0	0
10	17945447	.	A	G	27	18	45	0	4	49	0	0
10	17945522	.	C	T	20	18	38	4	1	43	0	0
10	17945581	.	G	T	34	18	52	0	2	54	0	0
10	17945629	.	T	C	30	27	57	0	0	57	0	0
10	17945725	.	A	G	31	20	51	0	1	52	0	0
10	17945738	.	T	A	33	19	52	0	1	53	0	0
10	17945779	.	T	A	21	12	33	0	2	35	0	0
10	17946030	.	A	T	6	4	10	0	2	12	0	0
10	18887816	.	C	T	5	3	8	0	1	9	0	0
10	18896228	.	A	C	7	3	10	0	0	10	0	0
10	18911166	.	A	G	1	4	5	0	0	5	0	0
10	18924407	.	C	G	3	2	5	0	0	5	0	0
10	18927910	.	C	T	1	3	4	0	1	5	0	0
10	18930403	.	T	C	6	5	11	0	0	11	0	0
10	18934119	.	A	T	4	3	7	0	1	8	0	0
10	18934291	.	T	C	7	6	13	0	1	14	0	0
10	18934393	.	T	G	4	0	4	0	4	8	0	0
10	18934409	.	T	A	5	6	11	0	0	11	0	0
10	18934590	.	A	C	11	11	22	0	2	24	0	0
10	18934683	.	T	C	13	6	19	0	0	19	0	0
10	18934963	.	G	A	0	6	6	0	7	13	0	0
10	18935271	.	C	T	16	9	25	0	0	25	0	0
10	18935874	.	T	A	8	7	15	0	0	15	0	0
10	18983512	.	C	A	10	6	16	0	0	16	0	0
10	18989018	.	C	G	5	5	10	0	1	11	0	0
10	18989047	.	T	C	7	4	11	0	1	12	0	0
10	19020475	.	A	G	9	8	17	0	1	18	0	0
10	19021032	.	C	A	4	3	7	0	1	8	0	0
10	19021102	.	C	G	6	12	18	0	1	19	0	0
10	19021192	.	A	G	7	8	15	0	1	16	0	0
10	19021243	.	G	A	5	6	11	0	0	11	0	0
10	19021378	.	T	C	1	2	3	0	1	4	0	0
10	19021383	.	A	T	2	2	4	0	0	4	0	0
10	19021456	.	A	G	1	4	5	0	0	5	0	0
10	19339538	.	G	C	0	3	3	0	3	6	0	0
10	19339647	.	C	T	1	2	3	0	1	4	0	0
10	19339859	.	C	G	5	2	7	0	1	8	0	0
10	19428498	.	C	T	2	6	8	0	0	8	0	0
10	19428509	.	T	C	2	6	8	0	0	8	0	0
10	19429634	.	A	T	2	3	5	0	0	5	0	0
10	19429713	.	T	C	2	2	4	0	0	4	0	0
10	19429718	.	A	G	2	2	4	0	0	4	0	0
10	19429759	.	A	G	3	3	6	0	0	6	0	0
10	19558489	.	C	A	1	4	5	0	0	5	0	0
10	19558558	.	T	A	5	8	13	0	0	13	0	0
10	19559235	.	A	G	2	3	5	0	1	6	0	0
10	19562006	.	T	G	13	12	25	0	1	26	0	0
10	19562015	.	A	T	14	11	25	0	2	27	0	0
10	19562945	.	C	T	20	20	40	0	1	41	0	0
10	19565704	.	A	T	17	27	44	2	1	47	0	0
10	19565771	.	T	C	20	31	51	0	2	53	0	0
10	19565782	.	A	C	21	28	49	0	3	52	0	0
10	19566400	.	T	A	13	16	29	0	2	31	0	0
10	19566445	.	T	C	8	11	19	0	0	19	0	0
10	20093914	.	C	T	3	5	8	0	0	8	0	0
10	20093959	.	A	G	5	4	9	0	1	10	0	0
10	20103429	.	A	T	8	6	14	0	1	15	0	0
10	20103448	.	A	G	8	7	15	0	0	15	0	0
10	20103601	.	G	T	4	4	8	0	0	8	0	0
10	20103639	.	A	G	5	3	8	0	0	8	0	0
10	20103662	.	C	T	3	5	8	0	0	8	0	0
10	20103731	.	C	T	5	6	11	0	2	13	0	0
10	20105347	.	A	G	7	7	14	0	0	14	0	0
10	20108575	.	T	A	3	7	10	0	0	10	0	0
10	20136107	.	T	C	7	7	14	0	1	15	0	0
10	20137862	.	A	G	2	8	10	0	1	11	0	0
10	20143850	.	T	A	2	4	6	0	0	6	0	0
10	20147452	.	A	G	18	0	18	0	20	38	0	0
10	20218342	.	C	G	4	3	7	0	0	7	0	0
10	20221281	.	C	T	6	5	11	0	0	11	0	0
10	20270867	.	T	C	5	2	7	0	1	8	0	0
10	20270919	.	C	T	0	2	2	0	5	7	0	0
10	20287188	.	A	G	4	4	8	0	0	8	0	0
10	20287251	.	C	A	1	4	5	0	2	7	0	0
10	20368883	.	C	T	9	13	22	0	4	26	0	0
10	20371675	.	A	T	9	13	22	0	3	25	0	0
10	20371715	.	T	C	9	8	17	0	0	17	0	0
10	20371723	.	A	C	6	9	15	0	0	15	0	0
10	20371827	.	C	T	15	6	21	0	0	21	0	0
10	20372029	.	G	A	1	2	3	0	3	6	0	0
10	20395629	.	T	C	2	3	5	0	0	5	0	0
10	20401613	.	C	A	2	6	8	0	0	8	0	0
10	20401813	.	A	G	5	2	7	0	1	8	0	0
10	20401984	.	G	T	3	2	5	0	0	5	0	0
10	20449009	.	C	T	4	11	15	0	0	15	0	0
10	20462884	.	G	A	10	5	15	0	0	15	0	0
10	20463890	.	G	A	7	10	17	0	1	18	0	0
10	20464238	.	A	G	4	6	10	0	1	11	0	0
10	20464245	.	A	G	3	6	9	0	0	9	0	0
10	20468843	.	T	A	1	3	4	0	2	6	0	0
10	20469878	.	G	C	1	3	4	0	0	4	0	0
10	20472926	.	T	C	4	3	7	0	0	7	0	0
10	20505467	.	T	C	9	0	9	0	11	20	0	0
10	20505679	.	T	G	6	4	10	0	0	10	0	0
10	20506482	.	T	A	6	3	9	0	0	9	0	0
10	20517889	.	A	G	1	2	3	0	0	3	0	0
10	20519543	.	T	C	2	3	5	0	0	5	0	0
10	20519549	.	T	C	2	0	2	0	3	5	0	0
10	20527553	.	G	A	8	4	12	0	1	13	0	0
10	20527571	.	C	T	10	7	17	0	1	18	0	0
10	20527653	.	C	T	10	8	18	0	0	18	0	0
10	20527736	.	C	T	0	12	12	0	11	23	0	0
10	20527837	.	C	A	1	5	6	0	11	17	0	0
10	20529384	.	G	A	10	7	17	0	1	18	0	0
10	20529389	.	G	T	8	6	14	0	1	15	0	0
10	20533079	.	A	C	2	3	5	0	0	5	0	0
10	20546530	.	G	A	2	3	5	0	0	5	0	0
10	20558156	.	G	C	4	3	7	0	0	7	0	0
10	20558270	.	G	A	4	3	7	0	0	7	0	0
10	20558300	.	G	C	2	0	2	0	3	5	0	0
10	20562894	.	C	T	1	2	3	0	0	3	0	0
10	20590317	.	T	C	5	2	7	0	0	7	0	0
10	20590436	.	A	C	3	3	6	0	0	6	0	0
10	20590461	.	G	T	3	6	9	0	1	10	0	0
10	20590547	.	T	C	5	3	8	0	0	8	0	0
10	20590569	.	C	T	5	3	8	0	0	8	0	0
10	20592420	.	C	T	5	4	9	0	1	10	0	0
10	20592598	.	G	T	5	2	7	0	1	8	0	0
10	20596178	.	C	G	1	9	10	0	0	10	0	0
10	20598177	.	C	A	6	7	13	0	1	14	0	0
10	20598270	.	G	A	6	2	8	1	1	10	0	0
10	20598345	.	C	G	7	4	11	8	0	19	0	0
10	20604548	.	A	G	15	11	26	0	0	26	0	0
10	20604703	.	G	T	12	7	19	0	0	19	0	0
10	20605150	.	C	T	15	14	29	0	0	29	0	0
10	20605171	.	A	T	13	16	29	0	1	30	0	0
10	20636072	.	A	C	12	8	20	0	0	20	0	0
10	20636082	.	C	T	12	6	18	0	2	20	0	0
10	20636211	.	G	A	7	3	10	0	0	10	0	0
10	20636262	.	T	A	6	6	12	0	0	12	0	0
10	20636542	.	G	A	3	2	5	0	0	5	0	0
10	20637069	.	C	T	5	9	14	0	1	15	0	0
10	20654817	.	A	T	3	4	7	0	0	7	0	0
10	20661288	.	A	G	5	5	10	0	0	10	0	0
10	21043461	.	G	A	1	2	3	0	0	3	0	0
10	21044037	.	G	A	2	3	5	0	0	5	0	0
10	21044064	.	G	A	2	2	4	0	0	4	0	0
10	21044361	.	A	T	2	2	4	0	0	4	0	0
10	21044385	.	G	T	3	2	5	0	0	5	0	0
10	21440173	.	T	C	4	4	8	0	0	8	0	0
10	21440486	.	T	A	11	8	19	0	0	19	0	0
10	21440786	.	A	G	4	7	11	0	1	12	0	0
10	21441305	.	C	T	7	8	15	0	2	17	0	0
10	21442994	.	T	A	23	21	44	0	1	45	0	0
10	21443135	.	G	A	0	15	15	0	12	27	0	0
10	21443193	.	T	G	17	12	29	0	1	30	0	0
10	21443476	.	T	C	16	21	37	0	2	39	0	0
10	21451996	.	C	T	2	3	5	0	0	5	0	0
10	21456498	.	T	C	8	4	12	0	0	12	0	0
10	21459017	.	G	A	2	6	8	0	6	14	0	0
10	21459403	.	G	A	1	7	8	0	6	14	0	0
10	21462585	.	A	G	6	10	16	0	4	20	0	0
10	21462612	.	T	C	14	9	23	0	1	24	0	0
10	21469977	.	G	A	2	16	18	0	20	38	0	0
10	21469997	.	A	C	19	16	35	0	0	35	0	0
10	21470192	.	G	A	2	12	14	0	15	29	0	0
10	21514095	.	T	C	1	2	3	0	0	3	0	0
10	21523014	.	C	T	1	2	3	0	0	3	0	0
10	21524919	.	C	G	1	0	1	0	2	3	0	0
10	21622317	.	G	A	24	16	40	1	2	43	0	0
10	21645994	.	G	A	16	11	27	1	3	31	0	0
10	21646216	.	T	C	20	6	26	0	2	28	0	0
10	21646225	.	G	A	20	7	27	0	1	28	0	0
10	21646400	.	C	G	18	18	36	0	2	38	0	0
10	21646621	.	C	T	27	11	38	0	3	41	0	0
10	21646668	.	T	A	26	14	40	0	2	42	0	0
10	21646797	.	C	T	26	13	39	0	1	40	0	0
10	21646802	.	A	G	29	13	42	0	0	42	0	0
10	21646848	.	A	G	20	9	29	0	1	30	0	0
10	21646908	.	C	A	27	15	42	0	0	42	0	0
10	21647008	.	A	C	19	17	36	0	0	36	0	0
10	21647200	.	C	T	25	17	42	0	2	44	0	0
10	21647539	.	T	C	32	31	63	0	1	64	0	0
10	21647582	.	C	A	32	30	62	0	1	63	0	0
10	21647614	.	A	C	37	20	57	0	7	64	0	0
10	21647691	.	G	A	25	24	49	0	5	54	0	0
10	21647898	.	C	T	29	23	52	0	6	58	0	0
10	21653230	.	A	G	0	4	4	0	1	5	0	0
10	21679496	.	G	A	7	4	11	1	0	12	0	0
10	21679497	.	C	A	4	6	10	1	1	12	0	0
10	21729191	.	T	C	1	3	4	2	0	6	0	0
10	21778980	.	C	T	1	3	4	3	0	7	0	0
10	21781710	.	T	C	9	4	13	0	0	13	0	0
10	21785677	.	C	T	11	3	14	1	0	15	0	0
10	21785734	.	C	T	2	4	6	6	1	13	0	0
10	21790121	.	C	A	2	2	4	0	0	4	0	0
10	21791375	.	G	A	3	4	7	0	0	7	0	0
10	21792024	.	A	C	5	3	8	6	0	14	0	0
10	21794410	.	T	A	2	2	4	0	0	4	0	0
10	21794598	.	A	C	1	2	3	0	1	4	0	0
10	21795337	.	C	T	2	2	4	2	0	6	0	0
10	21795655	.	A	T	4	3	7	1	2	10	0	0
10	21795805	.	G	A	1	3	4	9	1	14	0	0
10	21799408	.	T	A	1	3	4	1	1	6	0	0
10	21802959	.	T	C	4	3	7	10	0	17	0	0
10	21802989	.	T	C	4	3	7	7	1	15	0	0
10	21803004	.	G	A	8	2	10	2	2	14	0	0
10	21806984	.	T	A	1	2	3	4	0	7	0	0
10	21818916	.	C	T	27	30	57	0	0	57	0	0
10	21818978	.	G	T	28	34	62	0	3	65	0	0
10	21819019	.	G	A	3	28	31	0	27	58	0	0
10	21819038	.	C	A	27	33	60	0	4	64	0	0
10	21819105	.	G	T	22	28	50	0	4	54	0	0
10	21819214	.	G	C	33	22	55	0	7	62	0	0
10	21819506	.	G	A	36	6	42	0	6	48	0	0
10	21819653	.	T	C	39	34	73	0	1	74	0	0
10	21819966	.	A	T	6	5	11	0	3	14	0	0
10	21944789	.	C	T	1	1	2	2	1	5	0	0
10	22003847	.	T	C	10	9	19	0	0	19	0	0
10	22003874	.	A	G	10	5	15	0	1	16	0	0
10	22012534	.	G	A	7	5	12	0	0	12	0	0
10	22030798	.	C	T	29	15	44	0	3	47	0	0
10	22030827	.	G	A	16	23	39	0	2	41	0	0
10	22030887	.	T	G	23	20	43	0	1	44	0	0
10	22030985	.	T	C	26	20	46	0	2	48	0	0
10	22030986	.	C	T	21	22	43	0	4	47	0	0
10	22031034	.	C	T	22	27	49	0	2	51	0	0
10	22031375	.	A	C	24	25	49	0	0	49	0	0
10	22031805	.	G	C	14	18	32	0	2	34	0	0
10	22031806	.	G	A	14	17	31	0	3	34	0	0
10	22031854	.	G	A	14	15	29	0	1	30	0	0
10	22035638	.	A	G	1	2	3	0	1	4	0	0
10	22036169	.	A	G	5	4	9	0	0	9	0	0
10	22036235	.	T	A	6	5	11	0	1	12	0	0
10	22041546	.	C	T	10	8	18	0	0	18	0	0
10	22041717	.	T	C	7	8	15	0	0	15	0	0
10	22044982	.	C	T	9	8	17	0	1	18	0	0
10	22045014	.	G	T	12	3	15	0	0	15	0	0
10	22051201	.	A	T	2	6	8	0	0	8	0	0
10	22051436	.	A	G	2	3	5	0	0	5	0	0
10	22051465	.	G	C	2	3	5	0	1	6	0	0
10	22051474	.	A	C	3	4	7	0	0	7	0	0
10	22051548	.	C	T	0	5	5	0	3	8	0	0
10	22051933	.	A	G	2	4	6	0	0	6	0	0
10	22052133	.	T	C	8	4	12	0	0	12	0	0
10	22162187	.	T	C	16	1	17	0	15	32	0	0
10	22162576	.	A	G	7	6	13	0	1	14	0	0
10	22162673	.	T	G	2	8	10	0	1	11	0	0
10	22163144	.	A	T	5	7	12	0	0	12	0	0
10	22163165	.	A	G	7	6	13	0	0	13	0	0
10	22163235	.	C	T	0	2	2	0	6	8	0	0
10	22163244	.	C	G	5	3	8	0	0	8	0	0
10	22163660	.	C	T	2	4	6	0	0	6	0	0
10	22163801	.	A	T	8	7	15	0	1	16	0	0
10	22163867	.	T	C	4	4	8	0	0	8	0	0
10	22163928	.	C	A	4	3	7	0	1	8	0	0
10	22164144	.	A	T	3	3	6	0	0	6	0	0
10	22164518	.	T	A	3	3	6	0	0	6	0	0
10	22164672	.	G	A	2	2	4	0	0	4	0	0
10	22164686	.	A	T	2	3	5	0	0	5	0	0
10	22164756	.	T	C	1	3	4	0	1	5	0	0
10	22165607	.	T	G	2	6	8	0	0	8	0	0
10	22165644	.	T	C	1	3	4	0	0	4	0	0
10	22165709	.	G	A	1	2	3	0	0	3	0	0
10	22165719	.	C	A	0	2	2	0	2	4	0	0
10	22165768	.	T	A	3	2	5	0	0	5	0	0
10	22165879	.	T	A	4	4	8	0	0	8	0	0
10	22165880	.	T	C	3	3	6	0	2	8	0	0
10	22166504	.	C	T	2	2	4	0	0	4	0	0
10	22382454	.	C	T	1	2	3	0	0	3	0	0
10	22476565	.	C	T	2	2	4	0	0	4	0	0
10	22477229	.	A	G	1	4	5	0	1	6	0	0
10	22477580	.	C	T	1	2	3	0	1	4	0	0
10	22477694	.	C	A	2	5	7	0	0	7	0	0
10	22477724	.	G	A	2	2	4	0	1	5	0	0
10	22477952	.	A	T	7	13	20	0	2	22	0	0
10	22516643	.	C	G	2	2	4	0	0	4	0	0
10	22518293	.	C	T	5	3	8	0	0	8	0	0
10	22518294	.	C	T	4	3	7	0	0	7	0	0
10	22519465	.	A	G	1	3	4	0	0	4	0	0
10	22519668	.	A	T	4	2	6	0	1	7	0	0
10	22519931	.	C	T	1	2	3	0	0	3	0	0
10	22530812	.	T	C	9	6	15	0	1	16	0	0
10	22531422	.	A	G	5	0	5	0	7	12	0	0
10	22531472	.	T	C	7	7	14	0	1	15	0	0
10	22531946	.	T	G	10	10	20	0	0	20	0	0
10	22532139	.	C	T	11	3	14	0	2	16	0	0
10	22532211	.	G	A	9	7	16	0	2	18	0	0
10	22532287	.	T	A	16	10	26	0	1	27	0	0
10	22532918	.	A	T	15	17	32	0	2	34	0	0
10	22747995	.	T	C	3	2	5	0	0	5	0	0
10	22749623	.	C	T	2	3	5	0	0	5	0	0
10	22782648	.	A	C	10	11	21	0	3	24	0	0
10	22785632	.	C	T	12	8	20	0	0	20	0	0
10	22785820	.	C	A	16	12	28	0	2	30	0	0
10	22785983	.	C	T	11	6	17	0	1	18	0	0
10	22786044	.	C	A	12	11	23	0	0	23	0	0
10	22786054	.	A	G	10	13	23	0	2	25	0	0
10	22786227	.	C	T	11	11	22	0	0	22	0	0
10	22786281	.	G	A	3	3	6	0	0	6	0	0
10	22811042	.	A	T	4	4	8	0	0	8	0	0
10	22811197	.	C	T	5	3	8	0	0	8	0	0
10	22811542	.	A	G	8	4	12	0	0	12	0	0
10	22811633	.	C	T	11	4	15	0	0	15	0	0
10	22812716	.	A	G	5	2	7	0	0	7	0	0
10	22813273	.	T	C	1	3	4	0	0	4	0	0
10	22845286	.	C	A	13	14	27	0	3	30	0	0
10	22859971	.	T	G	1	9	10	0	2	12	0	0
10	22891212	.	A	G	2	3	5	0	1	6	0	0
10	22891237	.	A	T	3	2	5	0	0	5	0	0
10	22893992	.	A	G	3	4	7	0	0	7	0	0
10	22895327	.	T	C	2	3	5	0	0	5	0	0
10	22896775	.	C	T	6	6	12	0	0	12	0	0
10	22906434	.	C	T	15	4	19	0	1	20	0	0
10	22906783	.	T	C	9	15	24	0	2	26	0	0
10	22907242	.	A	T	19	9	28	0	4	33	1	0
10	22907330	.	G	A	6	3	9	0	0	9	0	0
10	22912283	.	G	T	0	3	3	0	4	7	0	0
10	22912540	.	A	G	7	4	11	0	0	11	0	0
10	22912547	.	C	T	6	4	10	0	0	10	0	0
10	22915421	.	C	G	8	7	15	0	1	16	0	0
10	22915777	.	T	C	8	9	17	1	0	18	0	0
10	22916422	.	A	C	24	29	53	0	3	56	0	0
10	22916426	.	T	A	25	29	54	0	1	55	0	0
10	22916490	.	G	A	16	21	37	0	6	43	0	0
10	22916520	.	T	C	17	19	36	0	9	45	0	0
10	22916661	.	G	C	36	19	55	0	4	59	0	0
10	22916664	.	C	T	35	23	58	0	1	59	0	0
10	22916730	.	A	G	36	22	58	0	1	59	0	0
10	22916739	.	G	A	37	26	63	0	0	63	0	0
10	22918122	.	A	T	23	33	56	0	0	56	0	0
10	22918124	.	A	C	22	0	22	0	33	55	0	0
10	22918164	.	T	C	17	25	42	0	0	42	0	0
10	22918174	.	G	A	15	19	34	0	1	35	0	0
10	22921976	.	A	T	1	2	3	0	0	3	0	0
10	22922089	.	A	G	2	0	2	0	3	5	0	0
10	22925851	.	T	C	3	2	5	0	0	5	0	0
10	23024360	.	C	T	6	4	10	0	0	10	0	0
10	23024405	.	T	C	3	5	8	0	2	10	0	0
10	23024584	.	A	C	11	12	23	0	0	23	0	0
10	23024660	.	A	G	16	12	28	0	0	28	0	0
10	23024708	.	T	C	8	15	23	0	0	23	0	0
10	23024762	.	A	G	6	10	16	0	0	16	0	0
10	23026025	.	T	C	21	19	40	0	1	41	0	0
10	23060643	.	C	T	2	3	5	0	2	7	0	0
10	23065084	.	G	A	5	3	8	0	0	8	0	0
10	23065247	.	T	C	5	5	10	0	1	11	0	0
10	23065295	.	C	T	2	7	9	0	0	9	0	0
10	23065777	.	T	C	5	5	10	0	0	10	0	0
10	23068630	.	A	G	12	16	28	0	0	28	0	0
10	23068962	.	A	G	10	10	20	0	2	22	0	0
10	23068963	.	C	T	10	9	19	0	3	22	0	0
10	23069068	.	C	T	5	10	15	0	0	15	0	0
10	23069120	.	T	C	3	7	10	3	1	14	0	0
10	23069253	.	T	C	1	7	8	0	1	9	0	0
10	23071248	.	C	A	2	3	5	0	0	5	0	0
10	23071273	.	C	A	1	3	4	0	0	4	0	0
10	23071697	.	G	A	4	5	9	0	0	9	0	0
10	23071705	.	G	C	2	4	6	0	1	7	0	0
10	23126678	.	T	C	1	2	3	0	0	3	0	0
10	23131977	.	C	A	1	2	3	0	0	3	0	0
10	23138428	.	G	A	0	3	3	0	3	6	0	0
10	23138486	.	A	G	1	3	4	0	0	4	0	0
10	23139227	.	C	A	0	1	1	0	2	3	0	0
10	23139237	.	A	T	1	2	3	0	0	3	0	0
10	24302893	.	C	T	2	2	4	0	0	4	0	0
10	24324014	.	G	T	23	5	28	0	2	30	0	0
10	24326236	.	C	T	9	9	18	0	1	19	0	0
10	24326242	.	C	T	9	10	19	0	2	21	0	0
10	24334810	.	G	A	5	8	13	0	4	17	0	0
10	24335002	.	C	T	9	10	19	0	0	19	0	0
10	24335402	.	C	T	9	4	13	0	0	13	0	0
10	24340993	.	T	C	5	0	5	0	7	12	0	0
10	24373239	.	C	A	1	3	4	0	0	4	0	0
10	24373255	.	C	T	2	5	7	0	0	7	0	0
10	24373701	.	A	T	1	2	3	0	0	3	0	0
10	24373721	.	G	T	2	4	6	0	0	6	0	0
10	24424363	.	G	C	0	7	7	0	2	9	0	0
10	24426038	.	A	T	1	3	4	0	0	4	0	0
10	24429342	.	T	C	3	8	11	0	0	11	0	0
10	24429357	.	T	C	7	4	11	0	1	12	0	0
10	24431479	.	C	T	8	6	14	0	2	16	0	0
10	24439910	.	A	G	22	1	23	0	7	30	0	0
10	24441916	.	C	T	16	13	29	1	4	34	0	0
10	24442371	.	C	T	18	6	24	1	1	26	0	0
10	24564904	.	G	A	0	2	2	0	1	3	0	0
10	24565366	.	A	T	3	2	5	0	0	5	0	0
10	24566124	.	T	C	1	3	4	0	0	4	0	0
10	24600110	.	A	G	3	1	4	0	7	11	0	0
10	24605406	.	A	C	1	3	4	0	1	5	0	0
10	24614505	.	A	T	5	3	8	0	1	9	0	0
10	24616839	.	C	A	1	3	4	0	0	4	0	0
10	24617621	.	G	C	0	2	2	0	3	5	0	0
10	24617624	.	G	A	3	3	6	0	0	6	0	0
10	24621543	.	G	A	7	5	12	0	1	13	0	0
10	24621687	.	G	A	1	3	4	0	0	4	0	0
10	24649813	.	T	G	7	7	14	0	5	19	0	0
10	24650194	.	A	G	6	5	11	0	0	11	0	0
10	24650889	.	T	A	8	4	12	0	0	12	0	0
10	24653833	.	G	A	4	2	6	0	1	7	0	0
10	24653920	.	C	T	3	7	10	0	0	10	0	0
10	24654319	.	A	C	7	4	11	0	1	12	0	0
10	24654501	.	C	T	0	5	5	0	5	10	0	0
10	24662642	.	T	C	7	4	11	0	0	11	0	0
10	24677227	.	G	A	2	4	6	0	0	6	0	0
10	24677253	.	T	A	2	2	4	0	0	4	0	0
10	24685378	.	A	G	2	2	4	0	0	4	0	0
10	24685863	.	C	G	1	3	4	0	0	4	0	0
10	24710938	.	T	G	2	4	6	0	0	6	0	0
10	24726532	.	T	C	3	2	5	0	0	5	0	0
10	24727085	.	G	A	1	2	3	0	0	3	0	0
10	24762269	.	A	G	1	2	3	0	0	3	0	0
10	24762284	.	A	G	1	2	3	0	0	3	0	0
10	24762377	.	G	A	7	2	9	0	0	9	0	0
10	24762427	.	C	T	7	6	13	0	1	14	0	0
10	24762510	.	A	G	10	14	24	0	0	24	0	0
10	24762579	.	T	C	6	1	7	0	4	11	0	0
10	24762589	.	G	A	6	4	10	0	0	10	0	0
10	24762615	.	T	C	6	1	7	0	3	10	0	0
10	24762759	.	T	A	8	8	16	0	0	16	0	0
10	24762774	.	T	G	8	5	13	0	0	13	0	0
10	24765589	.	A	C	7	3	10	0	0	10	0	0
10	24765893	.	A	G	1	3	4	0	0	4	0	0
10	25109234	.	C	T	1	1	2	0	1	3	0	0
10	25109288	.	G	A	1	2	3	0	0	3	0	0
10	25205338	.	C	A	5	2	7	0	0	7	0	0
10	25209935	.	C	T	12	7	19	0	1	20	0	0
10	25267863	.	C	T	5	7	12	0	0	12	0	0
10	25268191	.	C	A	4	2	6	0	0	6	0	0
10	25268389	.	T	C	4	2	6	0	0	6	0	0
10	25268394	.	C	T	4	2	6	0	0	6	0	0
10	25269310	.	G	T	12	6	18	0	2	20	0	0
10	25269325	.	T	G	12	7	19	0	1	20	0	0
10	25269413	.	A	G	10	6	16	0	2	18	0	0
10	25269530	.	T	A	17	5	22	2	1	25	0	0
10	25269592	.	A	G	14	1	15	0	16	31	0	0
10	25269742	.	C	T	23	9	32	0	0	32	0	0
10	25269946	.	G	A	3	15	18	0	27	45	0	0
10	25270019	.	C	G	21	8	29	1	3	33	0	0
10	25270044	.	C	A	14	16	30	1	3	34	0	0
10	25270125	.	A	G	23	8	31	1	0	32	0	0
10	25270395	.	A	G	16	7	23	0	0	23	0	0
10	25270470	.	A	G	5	12	17	0	2	19	0	0
10	25270471	.	A	G	8	11	19	0	0	19	0	0
10	25270618	.	C	G	11	15	26	0	2	28	0	0
10	25270803	.	A	T	13	22	35	0	3	38	0	0
10	25270942	.	G	C	17	15	32	0	1	33	0	0
10	25271051	.	T	A	10	13	23	0	1	24	0	0
10	25271121	.	G	A	27	13	40	0	1	41	0	0
10	25271338	.	T	C	13	20	33	0	1	34	0	0
10	25312828	.	T	G	6	17	23	0	1	24	0	0
10	25312906	.	A	C	3	4	7	0	0	7	0	0
10	25317306	.	A	G	3	3	6	0	0	6	0	0
10	25318957	.	A	G	3	4	7	0	0	7	0	0
10	25329648	.	G	T	19	9	28	0	9	37	0	0
10	25329649	.	A	T	19	11	30	0	6	36	0	0
10	25330646	.	G	A	20	25	45	0	0	45	0	0
10	25333961	.	C	T	2	23	25	0	16	41	0	0
10	25334178	.	T	C	19	15	34	0	1	35	0	0
10	25336095	.	G	A	21	20	41	0	1	42	0	0
10	25338585	.	C	G	10	7	17	0	0	17	0	0
10	25342889	.	A	G	10	13	23	0	0	23	0	0
10	25342915	.	A	T	8	9	17	0	0	17	0	0
10	25694637	.	G	A	26	22	48	0	2	50	0	0
10	25694844	.	G	A	29	20	49	0	1	50	0	0
10	25694848	.	C	T	30	19	49	0	2	51	0	0
10	25694920	.	G	A	33	29	62	0	4	66	0	0
10	25697655	.	A	G	19	24	43	0	2	45	0	0
10	25697715	.	G	C	10	19	29	0	3	32	0	0
10	25701673	.	T	A	12	17	29	2	2	33	0	0
10	25701928	.	T	C	6	0	6	0	4	10	0	0
10	25829536	.	T	A	3	4	7	0	0	7	0	0
10	25829724	.	C	T	0	5	5	0	1	6	0	0
10	25830373	.	A	G	4	6	10	0	0	10	0	0
10	25830544	.	T	G	3	6	9	0	0	9	0	0
10	25830687	.	A	G	5	4	9	0	0	9	0	0
10	25830723	.	T	G	4	3	7	0	0	7	0	0
10	25948190	.	A	T	10	4	14	0	2	16	0	0
10	25960676	.	A	C	13	8	21	0	1	22	0	0
10	25960718	.	T	C	16	6	22	0	0	22	0	0
10	25961200	.	A	G	2	2	4	0	0	4	0	0
10	25961348	.	T	C	3	3	6	0	0	6	0	0
10	25961355	.	C	A	3	3	6	0	0	6	0	0
10	25961396	.	T	C	3	7	10	0	1	11	0	0
10	25961397	.	T	A	2	8	10	0	1	11	0	0
10	25961454	.	G	C	6	15	21	0	0	21	0	0
10	25961510	.	A	C	7	17	24	0	0	24	0	0
10	25961778	.	A	G	11	13	24	0	1	25	0	0
10	25961933	.	C	T	4	3	7	1	0	10	2	0
10	26113931	.	C	T	7	7	14	0	0	14	0	0
10	26114562	.	C	G	2	3	5	0	1	6	0	0
10	26114668	.	C	A	2	2	4	0	0	4	0	0
10	26114894	.	A	T	1	7	8	0	0	8	0	0
10	26114922	.	A	C	1	5	6	0	0	6	0	0
10	26114952	.	A	T	3	5	8	0	0	8	0	0
10	26115080	.	G	C	8	10	18	0	1	19	0	0
10	26115225	.	C	T	11	3	14	0	1	15	0	0
10	26118717	.	G	C	2	3	5	0	0	5	0	0
10	26123308	.	A	C	1	2	3	0	0	3	0	0
10	26123649	.	A	T	3	2	5	0	0	5	0	0
10	26123667	.	A	C	4	3	7	0	0	7	0	0
10	26126995	.	A	T	4	8	12	0	3	15	0	0
10	26127054	.	G	A	6	8	14	0	0	14	0	0
10	26127075	.	T	C	3	6	9	0	3	12	0	0
10	26127291	.	T	C	18	8	26	0	0	26	0	0
10	26127479	.	C	A	4	12	16	0	1	17	0	0
10	26127484	.	C	T	4	12	16	0	0	16	0	0
10	26127643	.	G	A	10	7	17	0	0	17	0	0
10	26127731	.	C	T	12	8	20	0	0	20	0	0
10	26127968	.	G	T	9	5	14	0	1	15	0	0
10	26128067	.	A	T	8	8	16	0	0	16	0	0
10	26128107	.	C	T	2	3	5	0	0	5	0	0
10	26131166	.	G	A	12	11	23	0	0	23	0	0
10	26131195	.	C	T	2	7	9	0	9	18	0	0
10	26131551	.	C	G	12	17	29	0	1	30	0	0
10	26131622	.	T	C	15	0	15	0	12	27	0	0
10	26131653	.	C	T	18	9	27	0	5	32	0	0
10	26131717	.	A	T	9	9	18	0	0	18	0	0
10	26131719	.	T	C	9	8	17	0	1	18	0	0
10	26131989	.	C	T	4	8	12	0	0	12	0	0
10	26132356	.	A	G	4	3	7	0	0	7	0	0
10	26132437	.	A	T	13	9	22	0	0	22	0	0
10	26132553	.	A	G	12	12	24	0	0	24	0	0
10	26132630	.	C	A	0	15	15	0	12	27	0	0
10	26139304	.	G	A	15	9	24	0	2	26	0	0
10	26139352	.	A	T	10	7	17	0	1	18	0	0
10	26141198	.	C	T	8	5	13	0	0	13	0	0
10	26144153	.	T	G	4	5	9	0	1	10	0	0
10	26144180	.	A	G	9	7	16	0	1	17	0	0
10	26144243	.	A	G	8	4	12	0	0	12	0	0
10	26144249	.	C	A	8	3	11	0	0	11	0	0
10	26155871	.	T	G	2	2	4	0	1	5	0	0
10	26203499	.	T	G	3	4	7	0	0	7	0	0
10	26204834	.	C	A	5	3	8	0	0	9	1	0
10	26204886	.	A	T	7	8	15	0	0	15	0	0
10	26204897	.	G	C	7	6	13	0	2	16	1	0
10	26205057	.	A	T	4	4	8	1	0	9	0	0
10	26205303	.	A	G	1	2	3	0	0	3	0	0
10	26205715	.	G	A	1	3	4	0	0	4	0	0
10	26205805	.	A	T	3	8	11	0	0	11	0	0
10	26205909	.	C	A	4	3	7	0	1	8	0	0
10	26206101	.	T	C	7	0	7	0	5	12	0	0
10	26206371	.	A	G	2	5	7	0	0	7	0	0
10	26269180	.	C	G	1	2	3	0	1	4	0	0
10	26269186	.	A	G	3	2	5	0	0	5	0	0
10	26269728	.	G	A	6	6	12	0	0	12	0	0
10	26270388	.	C	A	3	6	9	0	0	9	0	0
10	26271159	.	G	T	2	2	4	0	1	5	0	0
10	26271168	.	G	A	3	1	4	0	1	5	0	0
10	26272155	.	C	T	2	2	4	0	0	4	0	0
10	26666839	.	T	C	10	18	28	1	3	32	0	0
10	26692581	.	C	T	2	2	4	0	0	4	0	0
10	26717237	.	C	T	11	13	24	0	2	26	0	0
10	26717246	.	G	A	11	15	26	0	0	26	0	0
10	26717582	.	T	A	12	4	16	0	1	17	0	0
10	26717687	.	G	A	12	6	18	0	1	19	0	0
10	26717740	.	A	G	10	13	23	0	2	25	0	0
10	26717783	.	A	G	8	14	22	0	0	22	0	0
10	26717954	.	G	T	8	8	16	0	1	17	0	0
10	26723422	.	C	T	0	11	11	0	6	17	0	0
10	26729687	.	T	C	2	6	8	0	1	9	0	0
10	26762841	.	C	A	1	2	3	0	0	3	0	0
10	26762944	.	T	C	2	8	10	0	1	11	0	0
10	26831989	.	A	C	3	10	13	0	1	14	0	0
10	26832007	.	A	C	3	8	11	0	1	12	0	0
10	26835227	.	G	T	1	4	5	1	0	6	0	0
10	26835299	.	G	A	4	5	9	0	0	9	0	0
10	26835316	.	G	C	3	4	7	0	0	7	0	0
10	26835389	.	A	T	5	6	11	0	0	11	0	0
10	26836990	.	G	A	7	22	29	0	1	30	0	0
10	26924408	.	C	A	3	2	5	0	0	5	0	0
10	26924542	.	T	C	5	4	9	0	1	10	0	0
10	26924729	.	A	G	3	2	5	0	0	5	0	0
10	26926741	.	A	G	13	7	20	0	0	20	0	0
10	26929291	.	A	T	19	6	25	0	0	25	0	0
10	26930061	.	C	A	17	16	33	0	1	34	0	0
10	26933176	.	G	T	10	5	15	0	0	15	0	0
10	26933222	.	C	T	5	11	16	0	1	17	0	0
10	26933250	.	C	A	4	9	13	0	2	15	0	0
10	26933323	.	G	T	1	2	3	0	0	3	0	0
10	26958666	.	G	C	1	3	4	0	0	4	0	0
10	26960058	.	G	A	3	5	8	0	1	9	0	0
10	26960065	.	G	A	1	6	7	0	3	10	0	0
10	26969077	.	G	T	2	6	8	0	5	13	0	0
10	26971982	.	C	T	12	9	21	0	1	22	0	0
10	26972009	.	T	C	11	10	21	0	0	21	0	0
10	26972018	.	C	T	11	8	19	0	0	19	0	0
10	26972064	.	T	C	9	8	17	0	2	19	0	0
10	26972321	.	T	A	4	7	11	0	1	12	0	0
10	26972349	.	T	C	7	5	12	0	0	12	0	0
10	26972364	.	T	C	6	9	15	0	1	16	0	0
10	26972392	.	A	T	11	5	16	0	0	16	0	0
10	26972429	.	A	T	4	3	7	0	0	7	0	0
10	26974519	.	G	A	2	2	4	0	0	4	0	0
10	26976729	.	C	A	2	3	5	0	1	6	0	0
10	26978031	.	C	T	16	12	28	0	0	28	0	0
10	26978169	.	C	G	16	15	31	0	2	33	0	0
10	26982338	.	T	C	3	2	5	0	0	5	0	0
10	26982455	.	C	T	4	4	8	0	0	8	0	0
10	26982495	.	T	C	5	4	9	0	0	9	0	0
10	26982565	.	G	A	4	4	8	0	0	8	0	0
10	26982572	.	C	G	5	3	8	0	0	8	0	0
10	26982670	.	G	A	3	2	5	0	0	5	0	0
10	26982786	.	C	T	0	2	2	0	3	5	0	0
10	26983020	.	T	C	2	2	4	0	0	4	0	0
10	26983092	.	A	C	1	2	3	0	0	3	0	0
10	26987399	.	T	C	14	4	18	0	12	30	0	0
10	26991556	.	C	T	13	11	24	0	1	25	0	0
10	26991914	.	A	T	8	6	14	0	0	14	0	0
10	26991917	.	A	G	6	6	12	0	0	12	0	0
10	26991984	.	G	C	13	10	23	1	1	25	0	0
10	26991990	.	T	C	15	2	17	1	10	28	0	0
10	26997077	.	C	A	17	16	33	0	3	36	0	0
10	26997139	.	G	T	14	9	23	0	0	23	0	0
10	26999102	.	C	T	2	11	13	0	12	25	0	0
10	26999407	.	A	T	11	11	22	0	0	22	0	0
10	26999414	.	A	G	9	9	18	0	0	18	0	0
10	27006512	.	T	A	22	12	34	0	1	35	0	0
10	27028146	.	A	G	22	12	34	0	0	34	0	0
10	27028334	.	G	T	18	15	33	0	1	34	0	0
10	27028346	.	A	G	18	12	30	0	1	31	0	0
10	27092727	.	G	A	3	2	5	0	1	6	0	0
10	27092735	.	C	T	2	3	5	0	0	5	0	0
10	27183418	.	C	T	17	12	29	0	2	31	0	0
10	27183580	.	T	C	12	0	12	0	14	26	0	0
10	27183685	.	A	T	16	12	28	0	1	29	0	0
10	27183735	.	C	T	1	13	14	0	13	27	0	0
10	27184351	.	C	T	9	11	20	0	5	25	0	0
10	27184384	.	C	T	11	11	22	0	1	23	0	0
10	27184456	.	A	G	7	4	11	0	1	12	0	0
10	27184600	.	G	A	2	5	7	0	1	8	0	0
10	27184729	.	C	T	9	6	15	0	0	15	0	0
10	27184789	.	G	A	9	6	15	0	1	16	0	0
10	27184824	.	C	A	0	8	8	0	6	14	0	0
10	27184843	.	G	A	6	7	13	0	1	14	0	0
10	27184891	.	T	A	4	6	10	0	0	10	0	0
10	27185104	.	G	A	8	8	16	0	0	16	0	0
10	27190783	.	G	A	2	2	4	0	0	4	0	0
10	27978342	.	A	C	2	4	6	0	0	6	0	0
10	27988415	.	G	A	3	2	5	0	1	6	0	0
10	27989627	.	A	T	2	3	5	0	0	5	0	0
10	28025392	.	A	G	1	2	3	0	0	3	0	0
10	28030710	.	C	T	2	8	10	0	6	16	0	0
10	28036370	.	G	A	11	10	21	0	0	21	0	0
10	28037735	.	C	T	6	11	17	0	0	17	0	0
10	28037759	.	C	T	6	10	16	0	1	17	0	0
10	28038008	.	A	G	8	10	18	0	0	18	0	0
10	28039040	.	C	T	8	5	13	0	2	15	0	0
10	28040705	.	G	T	4	2	6	0	0	6	0	0
10	28041218	.	G	C	5	5	10	0	1	11	0	0
10	28043769	.	C	T	0	2	2	0	4	6	0	0
10	28161671	.	C	G	1	2	3	0	0	3	0	0
10	28165212	.	T	C	2	2	4	0	0	4	0	0
10	28166640	.	G	A	0	2	2	0	1	3	0	0
10	28169061	.	G	A	1	4	5	0	0	5	0	0
10	28189165	.	A	G	3	3	6	0	0	6	0	0
10	28311161	.	A	G	27	25	52	0	1	53	0	0
10	28311301	.	C	T	21	23	44	0	1	45	0	0
10	28311553	.	G	T	33	15	48	4	5	57	0	0
10	28312156	.	T	A	24	24	48	0	2	50	0	0
10	28315149	.	G	A	16	17	33	0	2	35	0	0
10	28315396	.	A	G	11	20	31	0	0	31	0	0
10	28315421	.	C	G	16	18	34	1	0	35	0	0
10	28319489	.	A	G	3	11	14	0	0	14	0	0
10	28319552	.	G	A	11	6	17	0	0	17	0	0
10	28320381	.	A	G	10	11	21	0	0	21	0	0
10	28320675	.	G	A	5	4	9	0	0	9	0	0
10	28323048	.	T	G	5	7	12	0	0	12	0	0
10	28323054	.	A	G	5	7	12	0	0	12	0	0
10	28328174	.	T	C	2	2	4	0	0	4	0	0
10	28332868	.	T	C	1	3	4	0	0	4	0	0
10	28334806	.	G	A	1	4	5	0	1	6	0	0
10	28339621	.	C	T	2	2	4	0	0	4	0	0
10	28351484	.	C	T	0	2	2	0	3	5	0	0
10	28351520	.	G	T	2	2	4	0	0	4	0	0
10	28371045	.	A	G	1	3	4	0	0	4	0	0
10	28371198	.	G	A	12	10	22	0	0	22	0	0
10	28483561	.	G	A	1	2	3	0	0	3	0	0
10	28730128	.	C	T	1	2	3	0	0	3	0	0
10	28730216	.	C	T	5	2	7	0	1	8	0	0
10	28730325	.	T	G	5	7	12	0	0	12	0	0
10	28730337	.	T	G	5	4	9	0	0	9	0	0
10	28730437	.	G	T	3	3	6	0	0	6	0	0
10	28730503	.	G	A	6	6	12	0	0	12	0	0
10	28730738	.	C	T	2	3	5	0	0	5	0	0
10	28730869	.	C	T	6	14	20	0	1	21	0	0
10	28731333	.	C	T	11	7	18	0	0	18	0	0
10	28732104	.	T	C	23	8	31	0	1	32	0	0
10	28733132	.	T	A	15	17	32	0	0	32	0	0
10	28737345	.	C	T	11	8	19	0	1	20	0	0
10	28745583	.	G	A	3	8	11	0	1	12	0	0
10	28745833	.	G	A	3	4	7	0	0	7	0	0
10	29166502	.	A	G	1	4	5	0	0	5	0	0
10	29185800	.	C	G	5	0	5	0	9	14	0	0
10	29205679	.	G	T	2	10	12	0	12	24	0	0
10	29266279	.	C	A	12	17	29	0	0	29	0	0
10	29268521	.	T	A	2	4	6	0	0	6	0	0
10	29268551	.	T	A	1	4	5	0	0	5	0	0
10	29270092	.	A	C	7	3	10	0	1	11	0	0
10	29270291	.	T	C	7	9	16	0	1	17	0	0
10	29271980	.	A	C	8	0	8	0	3	11	0	0
10	29272693	.	C	T	2	6	8	0	1	9	0	0
10	29661410	.	C	T	1	2	3	0	0	3	0	0
10	29661419	.	C	G	1	0	1	0	2	3	0	0
10	29678256	.	A	G	2	0	2	0	4	6	0	0
10	29701347	.	C	T	3	3	6	0	2	8	0	0
10	29701405	.	G	A	0	5	5	0	3	8	0	0
10	29702103	.	G	A	4	2	6	0	0	6	0	0
10	29708101	.	C	T	9	13	22	0	2	24	0	0
10	29708154	.	A	G	14	1	15	0	13	28	0	0
10	29736314	.	C	T	0	4	4	0	7	11	0	0
10	29736746	.	C	T	1	12	13	0	11	24	0	0
10	29742625	.	C	T	1	5	6	0	5	11	0	0
10	29751221	.	T	C	9	1	10	0	9	19	0	0
10	29751328	.	G	A	16	14	30	0	1	31	0	0
10	29751638	.	G	T	11	11	22	0	0	22	0	0
10	29754464	.	G	T	7	10	17	0	0	17	0	0
10	29762926	.	G	A	1	5	6	0	0	6	0	0
10	29782273	.	A	G	1	0	1	0	3	4	0	0
10	29785682	.	C	A	6	2	8	0	0	8	0	0
10	29788229	.	G	T	5	3	8	0	0	8	0	0
10	29815697	.	A	C	5	0	5	0	4	9	0	0
10	29815802	.	A	G	28	28	56	0	1	57	0	0
10	29816113	.	T	C	26	26	52	0	2	54	0	0
10	29816290	.	T	A	26	21	47	0	3	50	0	0
10	29816439	.	A	T	15	14	29	0	1	30	0	0
10	29816904	.	C	T	27	29	56	0	5	61	0	0
10	29817111	.	C	T	41	34	75	0	1	76	0	0
10	29817207	.	C	T	37	33	70	0	1	71	0	0
10	29817416	.	A	T	32	29	61	0	1	62	0	0
10	29820414	.	G	C	2	4	6	0	0	6	0	0
10	29824248	.	C	T	1	6	7	0	0	7	0	0
10	29824262	.	C	T	3	6	9	0	2	11	0	0
10	29828696	.	T	G	1	3	4	0	0	4	0	0
10	29851177	.	C	T	14	20	34	0	1	35	0	0
10	29851722	.	C	T	24	21	45	0	1	46	0	0
10	29852317	.	G	A	37	27	64	0	1	65	0	0
10	29852476	.	A	G	37	0	37	0	25	62	0	0
10	29852485	.	A	G	37	1	38	0	27	65	0	0
10	29853684	.	A	G	21	5	26	2	18	46	0	0
10	29882732	.	G	A	1	2	3	0	0	3	0	0
10	30576061	.	G	A	2	2	4	0	0	4	0	0
10	30618429	.	A	T	3	3	6	0	0	6	0	0
10	31021450	.	C	T	6	7	13	0	0	13	0	0
10	31021505	.	T	C	13	5	18	0	0	18	0	0
10	31021550	.	G	A	11	7	18	0	0	18	0	0
10	31021811	.	C	T	0	5	5	0	16	21	0	0
10	31023520	.	A	G	4	16	20	0	1	21	0	0
10	31023824	.	C	T	12	5	17	0	2	19	0	0
10	31031543	.	C	T	2	4	6	0	3	9	0	0
10	31035030	.	G	A	1	3	4	0	0	4	0	0
10	31035147	.	C	T	1	5	6	0	0	6	0	0
10	31066888	.	C	T	0	3	3	0	2	5	0	0
10	31276808	.	T	C	2	2	4	0	0	4	0	0
10	31280410	.	C	T	2	4	6	0	0	6	0	0
10	31306727	.	C	T	3	12	15	0	17	32	0	0
10	31306956	.	C	G	2	10	12	0	10	22	0	0
10	31315631	.	C	T	0	10	10	0	4	14	0	0
10	31317976	.	T	C	7	17	24	0	0	24	0	0
10	31317978	.	A	G	6	16	22	0	2	24	0	0
10	31325248	.	C	A	4	8	12	0	0	12	0	0
10	31328373	.	A	T	1	5	6	0	1	7	0	0
10	31328531	.	C	T	2	7	9	0	0	9	0	0
10	31628325	.	A	C	1	2	3	0	1	4	0	0
10	31632838	.	C	T	3	3	6	0	0	6	0	0
10	31633077	.	A	C	7	4	11	0	2	13	0	0
10	31633589	.	G	T	5	1	6	0	11	17	0	0
10	31726330	.	C	T	1	4	5	0	0	5	0	0
10	31739181	.	G	T	30	26	56	0	3	59	0	0
10	31751941	.	C	T	21	26	47	0	1	48	0	0
10	31772041	.	G	A	17	12	29	0	1	30	0	0
10	31772112	.	A	G	14	12	26	0	0	26	0	0
10	31782605	.	C	T	14	12	26	0	0	26	0	0
10	31953744	.	C	A	4	4	8	0	0	8	0	0
10	32037794	.	T	A	5	2	7	0	0	7	0	0
10	32037951	.	C	T	3	3	6	0	0	6	0	0
10	32038054	.	A	T	3	4	7	0	1	8	0	0
10	32038071	.	A	T	2	4	6	0	1	7	0	0
10	32062738	.	C	T	3	2	5	0	0	5	0	0
10	32063401	.	C	T	3	2	5	0	0	5	0	0
10	32063809	.	A	G	2	4	6	0	0	6	0	0
10	32064121	.	A	T	3	3	6	0	0	6	0	0
10	32064138	.	C	T	4	3	7	0	0	7	0	0
10	32064222	.	A	T	6	5	11	0	0	11	0	0
10	32122840	.	T	A	4	2	6	0	0	6	0	0
10	32123050	.	G	C	1	2	3	0	0	3	0	0
10	32265199	.	G	A	4	2	6	0	0	6	0	0
10	32265605	.	C	G	0	2	2	0	4	6	0	0
10	32561338	.	G	A	1	3	4	0	0	4	0	0
10	32561437	.	T	A	3	2	5	0	0	5	0	0
10	32561564	.	A	C	3	2	5	0	1	6	0	0
10	32561575	.	C	T	4	2	6	0	0	6	0	0
10	32561817	.	G	A	0	3	3	0	5	8	0	0
10	32561820	.	G	T	5	3	8	0	1	9	0	0
10	32562267	.	C	T	6	6	12	0	0	12	0	0
10	32577486	.	G	A	10	4	14	0	1	15	0	0
10	32577489	.	A	G	11	3	14	0	0	14	0	0
10	32577522	.	C	T	9	9	18	0	1	19	0	0
10	32577549	.	T	C	10	7	17	0	3	20	0	0
10	32577621	.	G	A	5	7	12	0	1	13	0	0
10	32857329	.	T	C	24	1	25	1	7	33	0	0
10	32857382	.	T	C	28	0	28	1	13	42	0	0
10	32857386	.	C	T	6	37	43	1	1	45	0	0
10	32857419	.	T	C	36	0	36	0	12	48	0	0
10	33244455	.	G	A	2	2	4	0	0	4	0	0
10	33254786	.	C	G	4	2	6	0	1	7	0	0
10	33255113	.	G	A	11	5	16	0	1	17	0	0
10	33260682	.	G	A	2	2	4	0	1	5	0	0
10	33260799	.	T	C	2	2	4	0	0	4	0	0
10	33279104	.	G	A	2	3	5	0	0	5	0	0
10	33368560	.	G	A	2	2	4	0	0	4	0	0
10	33369860	.	T	A	10	6	16	1	1	18	0	0
10	33369973	.	C	A	18	8	26	0	2	28	0	0
10	33370260	.	G	T	9	6	15	0	1	16	0	0
10	33370284	.	A	G	7	9	16	0	0	16	0	0
10	33379580	.	G	A	6	8	14	0	0	14	0	0
10	33386316	.	G	A	19	20	39	0	2	41	0	0
10	33389469	.	A	G	17	0	17	1	24	42	0	0
10	33391844	.	G	A	21	32	53	0	5	58	0	0
10	33391930	.	G	A	19	18	37	0	4	41	0	0
10	33392065	.	C	T	23	16	39	1	0	40	0	0
10	33392103	.	G	A	16	15	31	1	3	35	0	0
10	33392111	.	T	C	20	14	34	0	0	34	0	0
10	33392264	.	C	T	14	24	38	2	2	42	0	0
10	33392370	.	T	C	19	10	29	1	1	31	0	0
10	33392396	.	T	G	19	8	27	0	0	27	0	0
10	33402255	.	A	T	1	3	4	0	0	4	0	0
10	33540056	.	G	T	0	2	2	0	2	4	0	0
10	33573861	.	A	T	2	1	3	0	0	3	0	0
10	33573866	.	A	T	2	2	4	0	0	4	0	0
10	33574250	.	T	G	7	0	7	0	4	11	0	0
10	33577656	.	A	G	7	6	13	0	1	14	0	0
10	33578816	.	T	A	10	5	15	0	0	15	0	0
10	33614968	.	G	A	1	2	3	0	0	3	0	0
10	33867160	.	G	A	0	4	4	0	4	8	0	0
10	33867365	.	C	T	5	3	8	0	1	9	0	0
10	33957780	.	C	T	3	2	5	0	0	5	0	0
10	33982141	.	G	C	6	4	10	1	0	11	0	0
10	33990957	.	C	T	7	10	17	0	0	17	0	0
10	33994424	.	A	G	13	13	26	0	1	27	0	0
10	33994445	.	A	G	13	12	25	0	0	25	0	0
10	33997759	.	A	T	21	36	57	0	4	61	0	0
10	33997970	.	T	C	8	16	24	0	2	26	0	0
10	33998010	.	C	T	14	20	34	0	0	34	0	0
10	33998106	.	G	C	4	4	8	0	1	9	0	0
10	34023669	.	A	G	1	0	1	0	3	4	0	0
10	34025077	.	T	C	3	4	7	0	1	8	0	0
10	34031696	.	T	A	2	4	6	0	0	6	0	0
10	34033394	.	C	T	2	3	5	0	0	5	0	0
10	34388888	.	G	A	4	2	6	0	0	6	0	0
10	34389617	.	C	T	1	2	3	0	0	3	0	0
10	34396026	.	G	A	1	5	6	0	0	6	0	0
10	34402546	.	C	T	3	3	6	0	0	6	0	0
10	34403157	.	G	A	4	2	6	0	0	6	0	0
10	34403349	.	C	G	7	13	20	0	0	20	0	0
10	34404552	.	T	G	12	18	30	0	0	30	0	0
10	34404593	.	T	C	6	5	11	0	2	13	0	0
10	34701434	.	A	C	1	2	3	0	0	3	0	0
10	34707043	.	C	T	4	2	6	0	0	6	0	0
10	34731660	.	C	T	18	23	41	0	4	45	0	0
10	34733578	.	A	G	26	0	26	0	18	44	0	0
10	34734568	.	G	T	3	19	22	0	21	43	0	0
10	34734590	.	A	G	23	20	43	0	3	46	0	0
10	34734784	.	G	T	3	20	23	1	16	40	0	0
10	34737599	.	G	A	23	26	49	0	5	54	0	0
10	34737686	.	A	G	20	22	42	0	3	45	0	0
10	34737959	.	G	A	23	15	38	0	0	38	0	0
10	34738125	.	T	C	23	24	47	0	2	49	0	0
10	34738378	.	T	G	23	32	55	1	0	56	0	0
10	34741649	.	T	A	21	17	38	0	2	40	0	0
10	34756936	.	A	C	1	4	5	0	0	5	0	0
10	34772168	.	A	G	4	5	9	0	0	9	0	0
10	34867259	.	T	C	0	0	0	0	4	4	0	0
10	34888980	.	T	G	1	2	3	0	0	3	0	0
10	34958760	.	A	T	6	9	15	0	0	15	0	0
10	34961149	.	C	A	15	12	27	0	1	28	0	0
10	34984836	.	A	G	12	14	26	0	2	28	0	0
10	34984923	.	T	C	19	9	28	0	0	28	0	0
10	34984931	.	C	A	3	8	11	0	17	28	0	0
10	34989149	.	T	C	8	0	8	0	8	16	0	0
10	34998281	.	G	C	9	6	15	0	0	15	0	0
10	35006036	.	A	T	8	4	12	0	0	12	0	0
10	35006358	.	T	C	4	4	8	0	0	8	0	0
10	35006504	.	C	A	2	7	9	0	0	9	0	0
10	35008963	.	C	T	8	7	15	0	0	15	0	0
10	35011325	.	C	T	11	5	16	0	1	17	0	0
10	35011337	.	A	G	7	10	17	0	0	17	0	0
10	35012184	.	C	T	2	7	9	0	7	16	0	0
10	35023235	.	C	T	3	3	6	0	0	6	0	0
10	35025832	.	G	C	2	2	4	0	0	4	0	0
10	35029172	.	G	A	5	4	9	0	1	10	0	0
10	35032814	.	T	C	2	3	5	0	0	5	0	0
10	36443018	.	T	C	9	9	18	0	0	18	0	0
10	36443541	.	T	C	9	7	16	0	0	16	0	0
10	36443676	.	G	A	1	7	8	0	3	11	0	0
10	36443714	.	G	A	5	7	12	0	2	14	0	0
10	36443818	.	T	G	5	0	5	0	4	9	0	0
10	36446799	.	A	T	7	8	15	0	0	15	0	0
10	36451615	.	T	C	9	8	17	0	0	17	0	0
10	36451661	.	G	A	16	10	26	0	0	26	0	0
10	36454567	.	C	A	13	14	27	0	2	29	0	0
10	36454649	.	A	G	15	0	15	0	22	37	0	0
10	36454650	.	C	A	14	19	33	0	3	36	0	0
10	36454902	.	G	T	16	17	33	0	1	34	0	0
10	36455146	.	C	T	15	20	35	0	1	36	0	0
10	36455215	.	T	C	12	16	28	0	0	28	0	0
10	36455229	.	C	G	15	13	28	0	1	29	0	0
10	36455344	.	A	G	14	14	28	0	2	30	0	0
10	36455847	.	G	A	1	5	6	0	8	14	0	0
10	36476481	.	C	T	1	14	15	0	17	32	0	0
10	36476529	.	C	T	9	16	25	0	3	28	0	0
10	36476639	.	C	T	3	11	14	0	13	27	0	0
10	36476717	.	A	G	11	17	28	0	1	29	0	0
10	36476834	.	G	A	16	14	30	0	0	30	0	0
10	36476852	.	A	G	18	13	31	0	2	33	0	0
10	36476922	.	C	T	17	8	25	0	1	26	0	0
10	36481915	.	A	C	15	10	25	0	1	26	0	0
10	36482588	.	G	A	5	14	19	0	0	19	0	0
10	36487530	.	G	A	10	9	19	0	1	20	0	0
10	36489882	.	A	G	7	8	15	0	0	15	0	0
10	36489893	.	A	G	8	7	15	0	0	15	0	0
10	36494590	.	C	G	4	3	7	0	0	7	0	0
10	36495580	.	T	G	4	3	7	0	0	7	0	0
10	36496544	.	A	G	7	4	11	0	2	13	0	0
10	36496595	.	G	A	3	2	5	0	0	5	0	0
10	36498379	.	C	T	0	2	2	0	5	7	0	0
10	36498397	.	G	A	4	2	6	0	0	6	0	0
10	36518643	.	C	T	2	2	4	0	0	4	0	0
10	36558895	.	G	A	2	4	6	0	0	6	0	0
10	36570469	.	A	G	3	3	6	0	0	6	0	0
10	36572814	.	A	T	1	2	3	0	0	3	0	0
10	36613145	.	G	T	6	4	10	0	1	11	0	0
10	36613164	.	C	T	0	5	5	0	6	11	0	0
10	36613276	.	C	T	5	7	12	0	2	14	0	0
10	36615367	.	G	A	6	5	11	0	0	11	0	0
10	36615907	.	C	A	7	4	11	0	2	13	0	0
10	36618435	.	C	T	2	4	6	0	6	12	0	0
10	36618787	.	C	T	11	6	17	0	0	17	0	0
10	36625534	.	G	A	2	8	10	0	1	11	0	0
10	36625602	.	C	G	4	3	7	0	1	8	0	0
10	36627009	.	G	C	1	4	5	1	0	6	0	0
10	36627517	.	C	T	2	3	5	0	1	6	0	0
10	36627820	.	C	T	1	2	3	0	1	4	0	0
10	36628569	.	C	T	0	4	4	0	1	5	0	0
10	36628804	.	G	T	1	3	4	0	0	4	0	0
10	36688455	.	C	T	4	4	8	0	0	8	0	0
10	36689850	.	G	T	7	3	10	0	0	10	0	0
10	36689893	.	A	G	5	5	10	0	0	10	0	0
10	36691372	.	C	A	0	3	3	0	3	6	0	0
10	36691636	.	G	A	2	2	4	0	1	5	0	0
10	36695781	.	G	C	2	4	6	0	0	6	0	0
10	36695785	.	C	T	2	4	6	0	0	6	0	0
10	36704842	.	A	G	12	6	18	0	1	19	0	0
10	36706217	.	T	A	6	11	17	0	5	22	0	0
10	36708401	.	A	G	12	0	12	0	20	32	0	0
10	36708453	.	C	T	11	14	25	0	3	28	0	0
10	36710559	.	A	C	12	15	27	0	1	28	0	0
10	36710599	.	C	T	15	7	22	0	1	23	0	0
10	36710871	.	G	A	3	20	23	0	17	40	0	0
10	36710893	.	G	T	1	17	18	0	17	35	0	0
10	36711260	.	T	A	3	3	6	0	1	7	0	0
10	36711329	.	T	A	5	6	11	0	1	12	0	0
10	36711613	.	C	T	21	11	32	0	1	33	0	0
10	36778293	.	C	T	2	2	4	0	0	4	0	0
10	36778302	.	C	A	2	2	4	0	0	4	0	0
10	36796131	.	T	A	5	2	7	0	0	7	0	0
10	36800465	.	G	A	7	6	13	0	0	13	0	0
10	36800518	.	C	T	4	6	10	0	1	11	0	0
10	36800600	.	G	A	1	2	3	0	0	3	0	0
10	36800642	.	A	G	2	2	4	0	0	4	0	0
10	36811815	.	A	G	13	8	21	0	1	22	0	0
10	36812214	.	A	C	12	12	24	0	2	26	0	0
10	36814912	.	G	A	6	13	19	0	0	19	0	0
10	36815330	.	T	C	4	0	4	0	5	9	0	0
10	36817197	.	A	C	4	3	7	0	0	7	0	0
10	36817530	.	C	T	3	7	10	0	1	11	0	0
10	36817940	.	T	C	4	4	8	0	0	8	0	0
10	36817979	.	T	G	3	2	5	0	1	6	0	0
10	36819664	.	G	T	3	4	7	0	0	7	0	0
10	36819671	.	C	T	3	2	5	0	1	6	0	0
10	36820664	.	C	T	6	2	8	0	1	9	0	0
10	36820688	.	C	G	1	2	3	0	5	8	0	0
10	36820769	.	T	A	3	5	8	0	2	10	0	0
10	36828110	.	A	T	1	3	4	0	0	4	0	0
10	36828227	.	T	C	13	10	23	0	1	24	0	0
10	36828265	.	G	A	12	10	22	0	1	23	0	0
10	36828295	.	G	T	9	7	16	0	3	19	0	0
10	36828469	.	T	C	11	0	11	1	10	22	0	0
10	36828475	.	C	T	7	11	18	1	1	20	0	0
10	36841230	.	G	T	1	6	7	0	0	7	0	0
10	36843060	.	G	A	1	2	3	0	0	3	0	0
10	36950935	.	A	T	6	6	12	0	0	12	0	0
10	36951044	.	A	T	8	9	17	0	3	20	0	0
10	36951076	.	G	C	10	7	17	0	0	17	0	0
10	36951223	.	A	C	5	11	16	0	2	18	0	0
10	36951378	.	A	G	1	6	7	0	0	7	0	0
10	36951582	.	C	G	10	6	16	0	0	16	0	0
10	36951660	.	T	A	5	12	17	0	1	18	0	0
10	36963456	.	G	A	2	4	6	0	0	6	0	0
10	36967206	.	T	C	7	8	15	0	1	16	0	0
10	36974901	.	G	A	1	3	4	0	0	4	0	0
10	37145178	.	G	A	4	6	10	0	0	10	0	0
10	37152081	.	G	A	11	15	26	0	0	26	0	0
10	37152105	.	A	G	12	0	12	0	14	26	0	0
10	37163252	.	C	A	12	16	28	0	1	29	0	0
10	37167151	.	G	C	10	7	17	0	2	19	0	0
10	37252054	.	G	A	0	3	3	0	3	6	0	0
10	37253986	.	A	G	3	3	6	0	0	6	0	0
10	37394478	.	G	A	3	2	5	0	0	5	0	0
10	37394525	.	A	G	2	1	3	0	0	3	0	0
10	37394535	.	C	T	1	2	3	0	0	3	0	0
10	37764473	.	C	T	6	4	10	0	0	10	0	0
10	37779765	.	A	C	8	10	18	0	1	19	0	0
10	37779778	.	T	A	8	9	17	0	1	18	0	0
10	37783114	.	A	G	8	9	17	0	0	17	0	0
10	37783179	.	A	G	12	0	12	0	6	18	0	0
10	37783323	.	A	G	8	6	14	0	0	14	0	0
10	37783558	.	T	C	2	2	4	1	0	5	0	0
10	37783567	.	C	A	2	1	3	0	0	3	0	0
10	37992653	.	C	T	3	2	5	0	0	5	0	0
10	37992679	.	G	A	0	2	2	0	3	5	0	0
10	37992839	.	A	T	4	3	7	0	0	7	0	0
10	37994630	.	C	T	4	2	6	0	0	6	0	0
10	37997567	.	C	G	2	3	5	0	2	7	0	0
10	38000082	.	C	G	2	9	11	0	0	11	0	0
10	38003011	.	A	G	14	5	19	0	0	19	0	0
10	38005466	.	A	C	5	5	10	0	0	10	0	0
10	38006849	.	G	C	0	2	2	0	1	3	0	0
10	38006855	.	G	A	0	2	2	0	1	3	0	0
10	38040372	.	A	G	14	13	27	0	1	28	0	0
10	38040378	.	A	G	13	13	26	0	3	29	0	0
10	38074570	.	G	T	2	5	7	0	1	8	0	0
10	38149713	.	C	A	1	3	4	0	7	11	0	0
10	38149715	.	A	G	6	3	9	0	1	10	0	0
10	38170573	.	G	A	5	8	13	2	1	16	0	0
10	38170574	.	A	G	10	3	13	2	0	15	0	0
10	38170737	.	G	A	12	10	22	0	1	23	0	0
10	38171149	.	G	C	13	1	14	0	11	25	0	0
10	38171196	.	G	A	12	9	21	0	3	24	0	0
10	38171207	.	C	A	6	15	21	0	1	22	0	0
10	38171356	.	A	T	17	10	27	0	1	28	0	0
10	38171490	.	T	A	15	11	26	0	3	29	0	0
10	38173383	.	C	A	1	7	8	0	10	18	0	0
10	38177999	.	C	T	2	9	11	0	6	17	0	0
10	38178357	.	G	A	8	7	15	0	0	15	0	0
10	38180732	.	A	T	5	5	10	0	0	10	0	0
10	38199097	.	G	A	3	2	5	0	0	5	0	0
10	38205149	.	T	C	3	0	3	0	2	5	0	0
10	38211810	.	C	G	3	4	7	0	0	7	0	0
10	38235957	.	G	C	4	2	6	0	0	6	0	0
10	38256723	.	G	A	2	2	4	0	0	4	0	0
10	38257295	.	G	A	8	5	13	0	3	16	0	0
10	38257509	.	C	G	3	10	13	0	7	20	0	0
10	38257558	.	C	T	8	6	14	0	1	15	0	0
10	38257870	.	T	C	13	17	30	0	2	32	0	0
10	38258729	.	C	G	8	5	13	0	3	16	0	0
10	38259033	.	C	T	4	2	6	0	0	6	0	0
10	38259034	.	A	G	4	2	6	0	0	6	0	0
10	38259204	.	G	A	4	5	9	0	0	9	0	0
10	38259217	.	A	G	3	4	7	0	1	8	0	0
10	38259268	.	G	C	2	5	7	1	0	8	0	0
10	38259276	.	A	G	3	2	5	1	0	6	0	0
10	38259339	.	A	T	2	2	4	0	1	5	0	0
10	38260002	.	G	A	1	4	5	0	0	5	0	0
10	38261085	.	T	G	1	2	3	0	0	3	0	0
10	38261109	.	T	C	1	2	3	0	0	3	0	0
10	38665994	.	C	T	6	2	8	0	0	8	0	0
10	38666063	.	T	C	3	5	8	0	0	8	0	0
10	38686126	.	T	C	7	6	13	0	0	13	0	0
10	38695152	.	A	C	28	14	42	0	2	44	0	0
10	38695656	.	A	G	11	12	23	0	1	24	0	0
10	38695877	.	C	T	12	8	20	1	1	22	0	0
10	38695888	.	C	T	10	7	17	1	0	18	0	0
10	38712403	.	A	G	5	1	6	0	10	16	0	0
10	38712431	.	C	T	6	7	13	0	0	13	0	0
10	38712508	.	C	T	2	4	6	0	0	6	0	0
10	38723491	.	T	C	1	3	4	0	0	4	0	0
10	38724101	.	C	T	4	3	7	0	0	7	0	0
10	38726441	.	C	T	2	3	5	0	1	6	0	0
10	38924557	.	C	T	6	4	10	0	0	10	0	0
10	38924560	.	T	C	5	4	9	0	0	9	0	0
10	38934391	.	A	G	1	3	4	0	0	4	0	0
10	38940232	.	A	G	4	4	8	0	0	8	0	0
10	38943265	.	C	G	5	4	9	0	0	9	0	0
10	38950115	.	T	C	5	7	12	0	0	12	0	0
10	38950430	.	G	A	2	12	14	0	4	18	0	0
10	38950484	.	A	G	6	9	15	0	2	17	0	0
10	38950538	.	T	C	11	12	23	0	1	24	0	0
10	38954126	.	C	T	16	5	21	0	0	21	0	0
10	38954141	.	T	C	14	6	20	0	1	21	0	0
10	38954798	.	T	C	8	13	21	0	0	21	0	0
10	38954801	.	C	T	10	12	22	0	1	23	0	0
10	38957061	.	T	C	8	14	22	0	1	23	0	0
10	38957127	.	G	A	2	14	16	0	8	24	0	0
10	38957193	.	C	T	14	12	26	0	0	26	0	0
10	38957748	.	A	C	10	7	17	0	1	18	0	0
10	38957754	.	A	C	11	6	17	0	2	19	0	0
10	38969552	.	A	C	44	12	56	0	3	59	0	0
10	38969598	.	A	C	30	17	47	0	2	49	0	0
10	38969629	.	C	T	25	26	51	0	1	52	0	0
10	38969685	.	A	G	26	28	54	0	2	56	0	0
10	38969778	.	C	T	21	23	44	0	1	45	0	0
10	39011484	.	C	T	9	13	22	0	1	23	0	0
10	39086981	.	G	A	30	18	48	0	0	48	0	0
10	39087391	.	A	G	38	0	38	0	25	63	0	0
10	39087625	.	T	A	28	28	56	0	1	58	1	0
10	39087659	.	T	A	26	29	55	0	2	57	0	0
10	39091792	.	A	G	1	0	1	0	4	5	0	0
10	39102776	.	T	C	5	7	12	0	0	12	0	0
10	39115595	.	G	T	3	9	12	0	0	12	0	0
10	39115596	.	T	C	3	8	11	0	1	12	0	0
10	39120132	.	T	C	6	16	22	0	1	23	0	0
10	39130460	.	C	T	36	33	69	0	5	74	0	0
10	39140465	.	A	G	2	3	5	0	0	5	0	0
10	39175139	.	T	C	1	2	3	0	0	3	0	0
10	39179992	.	G	C	2	3	5	0	0	5	0	0
10	39180884	.	A	G	3	1	4	0	2	6	0	0
10	39180912	.	T	C	5	2	7	0	1	8	0	0
10	39181325	.	G	T	0	3	3	0	11	14	0	0
10	39182173	.	A	G	7	12	19	0	0	19	0	0
10	39182310	.	C	A	8	6	14	0	0	14	0	0
10	39182342	.	A	T	11	6	17	0	0	17	0	0
10	39182401	.	C	A	11	4	15	0	0	15	0	0
10	39182602	.	G	A	0	3	3	0	7	10	0	0
10	39182640	.	T	A	4	3	7	0	0	7	0	0
10	39182659	.	G	T	3	3	6	0	0	6	0	0
10	39182877	.	G	A	5	3	8	0	1	9	0	0
10	39206945	.	A	G	4	4	8	0	0	8	0	0
10	39216625	.	C	T	3	2	5	0	0	5	0	0
10	39219390	.	T	C	2	6	8	0	0	8	0	0
10	39219540	.	T	A	2	4	6	0	0	6	0	0
10	39222134	.	A	C	10	10	20	0	1	21	0	0
10	39222182	.	A	G	9	5	14	0	0	14	0	0
10	39225504	.	A	C	16	9	25	0	1	26	0	0
10	39225555	.	T	C	12	10	22	0	4	26	0	0
10	39231387	.	G	A	27	14	41	0	2	43	0	0
10	39249061	.	G	T	1	1	2	0	1	3	0	0
10	39266350	.	G	T	0	3	3	0	1	4	0	0
10	39266669	.	A	C	1	3	4	0	0	4	0	0
10	39266702	.	A	G	3	0	3	0	3	6	0	0
10	39268678	.	T	C	0	0	0	0	3	3	0	0
10	39286967	.	C	T	1	2	3	0	0	3	0	0
10	39293897	.	T	A	3	2	5	0	0	5	0	0
10	39293898	.	G	A	3	2	5	0	0	5	0	0
10	39294067	.	T	G	1	5	6	0	1	7	0	0
10	39904774	.	G	A	0	6	6	0	5	11	0	0
10	39904780	.	C	T	5	5	10	0	1	11	0	0
10	39904851	.	A	T	3	9	12	0	0	12	0	0
10	39904915	.	A	G	12	11	23	0	2	25	0	0
10	39904966	.	T	C	5	11	16	0	0	16	0	0
10	39905085	.	A	T	5	5	10	0	0	10	0	0
10	39905089	.	T	G	5	5	10	0	0	10	0	0
10	40111904	.	G	T	2	3	5	0	0	5	0	0
10	40112096	.	C	A	2	2	4	0	0	4	0	0
10	40112347	.	A	T	1	2	3	0	0	3	0	0
10	40113197	.	G	A	0	3	3	0	2	5	0	0
10	40274541	.	G	A	0	4	4	0	1	5	0	0
10	40303924	.	G	C	2	2	4	0	0	4	0	0
10	40314175	.	A	C	1	2	3	0	0	3	0	0
10	40314177	.	A	C	1	2	3	0	0	3	0	0
10	40317190	.	T	G	1	2	3	0	1	4	0	0
10	40317192	.	G	T	1	3	4	0	0	4	0	0
10	40317285	.	A	T	4	3	7	0	0	7	0	0
10	40822252	.	C	T	0	6	6	0	12	18	0	0
10	40825192	.	T	C	5	6	11	0	0	11	0	0
10	40826516	.	A	G	1	2	3	0	0	3	0	0
10	40826589	.	C	T	5	6	11	0	1	12	0	0
10	40826590	.	A	G	6	6	12	0	0	12	0	0
10	40859722	.	A	G	4	8	12	0	0	12	0	0
10	40859885	.	A	G	4	5	9	0	0	9	0	0
10	40859968	.	T	C	6	9	15	0	0	15	0	0
10	40861563	.	C	A	5	3	8	0	2	10	0	0
10	40872771	.	G	A	5	2	7	0	0	7	0	0
10	41190192	.	G	C	1	3	4	0	0	4	0	0
10	41192675	.	C	T	2	3	5	0	0	5	0	0
10	41279966	.	C	G	2	3	5	0	0	5	0	0
10	41362665	.	G	A	14	13	27	0	2	29	0	0
10	41362771	.	C	T	1	16	17	0	13	30	0	0
10	41368569	.	G	A	12	9	21	0	1	22	0	0
10	41368626	.	C	T	2	8	10	0	15	25	0	0
10	41373231	.	G	A	8	3	11	0	1	12	0	0
10	41376895	.	G	A	4	3	7	0	0	7	0	0
10	41379992	.	G	A	10	3	13	0	1	14	0	0
10	41380079	.	G	C	9	0	9	0	9	18	0	0
10	41608600	.	C	A	3	3	6	0	0	6	0	0
10	42046689	.	A	C	1	2	3	0	0	3	0	0
10	42134649	.	T	C	7	3	10	0	0	10	0	0
10	42930781	.	T	C	1	1	2	0	7	9	0	0
10	42930814	.	T	C	4	6	10	0	0	10	0	0
10	42930828	.	T	C	1	8	9	0	0	9	0	0
10	43546593	.	C	T	3	8	11	0	5	16	0	0
10	43863164	.	C	T	3	4	7	0	0	7	0	0
10	43863742	.	A	C	1	5	6	0	0	6	0	0
10	43863779	.	A	C	2	2	4	0	0	4	0	0
10	43863792	.	T	G	2	2	4	0	0	4	0	0
10	43863990	.	C	G	1	2	3	0	0	3	0	0
10	43936313	.	A	T	1	3	4	0	0	4	0	0
10	43999448	.	G	A	5	3	8	0	0	8	0	0
10	43999628	.	T	C	6	7	13	0	0	13	0	0
10	43999718	.	T	A	5	8	13	0	0	13	0	0
10	44010073	.	C	T	0	6	6	0	3	9	0	0
10	44131346	.	A	G	2	3	5	0	0	5	0	0
10	44180320	.	C	T	3	3	6	0	0	6	0	0
10	44189322	.	G	T	4	5	9	0	0	9	0	0
10	44269591	.	G	T	2	1	3	0	0	3	0	0
10	44269592	.	C	G	2	1	3	0	0	3	0	0
10	44314569	.	C	T	13	7	20	0	1	21	0	0
10	44314579	.	A	G	7	13	20	0	1	21	0	0
10	44320823	.	G	C	6	5	11	0	0	11	0	0
10	44337487	.	C	G	1	3	4	0	0	4	0	0
10	44345005	.	C	T	0	3	3	0	3	6	0	0
10	44363242	.	G	T	6	4	10	0	1	11	0	0
10	44364604	.	A	T	9	3	12	0	0	12	0	0
10	44364610	.	C	T	10	5	15	0	0	15	0	0
10	44371710	.	G	T	3	10	13	0	16	29	0	0
10	44373367	.	T	C	2	3	5	0	0	5	0	0
10	44375785	.	G	A	0	4	4	0	6	10	0	0
10	44437145	.	T	C	14	17	31	0	0	31	0	0
10	44503882	.	G	A	1	2	3	0	0	3	0	0
10	44513232	.	T	C	4	2	6	0	0	7	1	0
10	44513402	.	T	C	9	1	10	0	7	17	0	0
10	44513421	.	C	T	0	9	9	0	9	18	0	0
10	44515911	.	G	C	3	6	9	0	1	10	0	0
10	44515927	.	T	C	2	9	11	0	0	11	0	0
10	44516907	.	G	T	1	2	3	0	0	3	0	0
10	44516908	.	T	C	1	0	1	0	2	3	0	0
10	44648627	.	C	T	1	2	3	0	0	3	0	0
10	44656905	.	G	A	2	2	4	0	0	4	0	0
10	44663025	.	C	T	4	3	7	0	0	7	0	0
10	44663082	.	A	G	3	4	7	0	0	7	0	0
10	44663109	.	A	G	4	7	11	0	1	12	0	0
10	44665345	.	G	T	0	3	3	0	1	4	0	0
10	44665536	.	A	T	2	3	5	0	0	5	0	0
10	44665620	.	C	T	3	10	13	0	1	14	0	0
10	44669402	.	G	A	2	4	6	1	7	14	0	0
10	44669779	.	A	G	13	0	13	0	12	25	0	0
10	44669825	.	T	G	10	4	14	0	2	16	0	0
10	44670437	.	A	G	13	7	20	0	1	21	0	0
10	44670894	.	C	T	6	17	23	0	1	24	0	0
10	44670923	.	T	C	5	15	20	0	1	21	0	0
10	44671630	.	A	G	5	6	11	9	3	23	0	0
10	44671651	.	A	G	1	0	1	2	10	13	0	0
10	44671818	.	A	C	15	17	32	0	2	34	0	0
10	44672009	.	T	A	26	22	48	0	1	49	0	0
10	44672036	.	T	A	29	20	49	0	0	49	0	0
10	44692308	.	A	T	8	11	19	0	0	19	0	0
10	44692314	.	C	A	10	14	24	0	0	24	0	0
10	44693445	.	G	A	7	2	9	27	2	38	0	0
10	44693523	.	T	G	36	0	36	0	16	52	0	0
10	44693556	.	C	T	14	9	23	3	2	28	0	0
10	44693769	.	C	T	29	27	56	26	7	89	0	0
10	44693799	.	T	C	21	13	34	48	2	84	0	0
10	44693868	.	G	A	22	3	25	10	7	42	0	0
10	44694081	.	G	A	34	4	38	38	3	79	0	0
10	44694096	.	A	G	20	9	29	29	11	69	0	0
10	44733828	.	T	C	2	3	5	0	0	5	0	0
10	44733835	.	T	C	2	2	4	0	1	5	0	0
10	44738221	.	G	A	0	6	6	0	3	9	0	0
10	44738290	.	C	T	5	8	13	0	0	13	0	0
10	44745648	.	T	G	7	3	10	0	1	11	0	0
10	44899932	.	G	A	1	3	4	0	1	5	0	0
10	44900312	.	G	A	3	2	5	0	0	5	0	0
10	44900592	.	G	A	2	3	5	0	0	5	0	0
10	44900901	.	T	G	1	3	4	0	0	4	0	0
10	44914623	.	A	G	3	0	3	0	2	5	0	0
10	44989378	.	C	T	19	19	38	0	2	40	0	0
10	44989384	.	T	C	16	21	37	0	2	39	0	0
10	44990917	.	C	T	20	22	42	0	1	43	0	0
10	45053620	.	C	A	3	2	5	0	0	5	0	0
10	45055879	.	G	A	8	10	18	0	0	18	0	0
10	45055948	.	G	A	3	8	11	0	0	11	0	0
10	45064957	.	C	T	8	7	15	0	1	16	0	0
10	45069978	.	A	C	12	11	23	0	0	23	0	0
10	45203109	.	T	C	4	8	12	0	0	12	0	0
10	45203154	.	A	G	6	4	10	0	1	11	0	0
10	45203271	.	T	A	5	3	8	0	1	9	0	0
10	45203385	.	T	A	4	3	7	0	1	8	0	0
10	45203419	.	A	T	2	2	4	0	0	4	0	0
10	45203446	.	A	G	1	3	4	1	0	5	0	0
10	45203856	.	G	A	5	4	9	0	0	9	0	0
10	45203882	.	A	G	3	2	5	0	1	6	0	0
10	45204024	.	A	G	2	3	5	0	0	5	0	0
10	45204029	.	A	T	1	3	4	0	0	4	0	0
10	45204185	.	T	C	2	2	4	0	0	4	0	0
10	45204218	.	A	G	1	0	1	0	2	3	0	0
10	45204527	.	A	G	2	3	5	0	0	5	0	0
10	45204568	.	G	T	4	2	6	0	0	6	0	0
10	45204621	.	T	C	4	4	8	0	0	8	0	0
10	45204786	.	A	C	1	2	3	0	0	3	0	0
10	45205166	.	A	C	7	8	15	0	1	16	0	0
10	45205175	.	A	G	8	0	8	0	6	14	0	0
10	45205226	.	A	G	9	0	9	0	11	20	0	0
10	45205237	.	C	G	8	0	8	0	13	21	0	0
10	45205284	.	A	C	4	9	13	0	3	16	0	0
10	45205295	.	A	G	6	0	6	0	11	17	0	0
10	45205400	.	C	A	7	7	14	0	1	15	0	0
10	45205506	.	A	C	4	6	10	0	0	10	0	0
10	45205518	.	T	G	3	7	10	0	1	11	0	0
10	45205757	.	C	A	1	4	5	0	0	5	0	0
10	45205758	.	A	G	1	4	5	0	0	5	0	0
10	45206103	.	C	G	4	9	13	0	0	14	1	0
10	45206289	.	G	C	10	0	10	0	11	21	0	0
10	45206326	.	G	T	8	5	13	0	0	13	0	0
10	45206825	.	A	G	9	14	23	0	0	23	0	0
10	45208153	.	A	G	4	7	11	0	0	11	0	0
10	45208667	.	C	T	0	3	3	0	2	5	0	0
10	45208875	.	G	A	3	5	8	0	2	10	0	0
10	45208899	.	C	A	3	8	11	0	0	11	0	0
10	45213798	.	C	T	0	3	3	0	7	10	0	0
10	45340105	.	G	T	0	2	2	0	2	4	0	0
10	45341403	.	A	G	1	4	5	0	1	6	0	0
10	45341410	.	A	G	1	0	1	0	6	7	0	0
10	45341452	.	T	G	1	4	5	0	1	6	0	0
10	45341537	.	A	C	5	6	11	0	1	12	0	0
10	45341546	.	A	C	5	8	13	0	0	13	0	0
10	45341572	.	G	C	0	6	6	0	7	13	0	0
10	45341596	.	C	T	6	3	9	0	0	9	0	0
10	45349924	.	G	A	41	30	71	0	2	73	0	0
10	45351037	.	C	T	37	38	75	0	4	79	0	0
10	45352231	.	C	T	22	25	47	0	1	48	0	0
10	45375714	.	G	T	8	7	15	0	1	16	0	0
10	45375732	.	C	T	7	6	13	0	1	14	0	0
11	126334	.	G	A	14	17	31	0	1	32	0	0
11	126595	.	A	T	13	12	25	0	0	25	0	0
11	127139	.	G	A	7	3	10	0	1	11	0	0
11	158688	.	C	T	1	3	4	0	0	4	0	0
11	185396	.	C	T	0	9	9	0	2	11	0	0
11	185624	.	T	A	16	23	39	0	1	40	0	0
11	185678	.	G	A	14	12	26	0	1	27	0	0
11	185775	.	C	T	0	23	23	0	15	38	0	0
11	185890	.	A	G	13	14	27	0	1	28	0	0
11	185902	.	A	G	13	15	28	0	0	28	0	0
11	186235	.	G	A	6	5	11	0	0	11	0	0
11	186526	.	A	T	6	4	10	0	0	10	0	0
11	186580	.	G	A	6	6	12	0	1	13	0	0
11	186745	.	G	T	4	8	12	0	0	12	0	0
11	186798	.	T	G	4	14	18	0	0	18	0	0
11	186939	.	A	G	10	12	22	0	0	22	0	0
11	187022	.	C	A	13	9	22	0	0	22	0	0
11	187104	.	T	A	7	13	20	0	3	23	0	0
11	187399	.	A	C	3	7	10	0	0	10	0	0
11	221929	.	T	C	18	3	21	0	21	42	0	0
11	222488	.	C	G	10	7	17	0	0	17	0	0
11	222722	.	C	T	1	7	8	0	10	18	0	0
11	222729	.	C	T	1	7	8	0	10	18	0	0
11	222776	.	C	T	7	4	11	0	1	12	0	0
11	222787	.	A	G	7	5	12	0	0	12	0	0
11	223174	.	A	G	2	6	8	1	1	10	0	0
11	223176	.	G	A	6	2	8	1	1	10	0	0
11	223319	.	G	A	4	3	7	0	0	7	0	0
11	223806	.	A	G	9	3	12	0	4	16	0	0
11	233672	.	A	T	1	5	6	0	0	6	0	0
11	233674	.	G	A	0	4	4	0	2	6	0	0
11	236515	.	T	C	1	2	3	0	1	4	0	0
11	236551	.	G	A	1	2	3	0	0	3	0	0
11	236602	.	A	C	1	0	1	0	2	3	0	0
11	260909	.	G	A	21	7	28	1	3	32	0	0
11	265097	.	T	G	8	16	24	0	1	25	0	0
11	265404	.	G	A	16	9	25	0	0	25	0	0
11	265497	.	C	T	2	5	7	0	13	20	0	0
11	265506	.	G	C	12	4	16	0	2	18	0	0
11	268887	.	G	A	10	7	17	0	0	17	0	0
11	270090	.	A	G	5	9	14	0	1	15	0	0
11	281887	.	A	T	2	10	12	0	0	12	0	0
11	281961	.	A	G	3	5	8	0	2	10	0	0
11	282193	.	T	G	5	8	13	0	0	13	0	0
11	282279	.	A	T	7	9	16	0	1	17	0	0
11	282546	.	G	T	9	5	14	0	0	14	0	0
11	282553	.	A	G	11	5	16	0	1	17	0	0
11	282602	.	T	G	9	6	15	0	1	16	0	0
11	284424	.	G	T	1	7	8	0	0	8	0	0
11	304015	.	C	T	18	7	25	8	1	34	0	0
11	322076	.	G	A	0	18	18	0	11	29	0	0
11	675382	.	G	C	28	24	52	0	1	53	0	0
11	676856	.	T	C	27	26	53	0	4	57	0	0
11	677100	.	A	G	14	4	18	0	0	18	0	0
11	677264	.	T	C	23	19	42	0	5	47	0	0
11	677341	.	T	C	15	17	32	0	2	34	0	0
11	682905	.	C	T	18	10	28	0	1	29	0	0
11	682926	.	A	G	16	6	22	0	1	23	0	0
11	682943	.	G	A	13	4	17	0	0	17	0	0
11	718214	.	G	A	19	6	25	0	1	26	0	0
11	718404	.	A	C	7	3	10	0	0	10	0	0
11	762445	.	A	G	3	4	7	0	0	7	0	0
11	779785	.	C	A	6	3	9	0	0	9	0	0
11	781714	.	G	A	1	5	6	0	2	8	0	0
11	813644	.	A	G	2	1	3	0	1	4	0	0
11	813851	.	T	C	2	0	2	0	6	8	0	0
11	1095064	.	G	A	1	3	4	0	0	4	0	0
11	1148869	.	G	A	15	12	27	0	1	28	0	0
11	1148889	.	G	A	11	14	25	0	0	25	0	0
11	1149105	.	C	T	18	24	42	0	3	45	0	0
11	1149593	.	A	G	34	9	43	3	0	46	0	0
11	1149812	.	C	T	3	25	28	0	29	57	0	0
11	1163295	.	C	T	24	22	46	0	0	46	0	0
11	1165993	.	G	A	26	16	42	0	2	44	0	0
11	1166326	.	G	C	11	0	11	0	13	24	0	0
11	1177389	.	C	A	2	10	12	0	3	15	0	0
11	1183007	.	G	A	2	8	10	0	0	10	0	0
11	1183602	.	C	T	0	6	6	0	3	9	0	0
11	1183739	.	G	T	2	3	5	0	0	5	0	0
11	1198390	.	G	C	5	7	12	0	0	12	0	0
11	1198419	.	G	A	5	5	10	0	1	11	0	0
11	1198450	.	G	A	12	5	17	0	0	17	0	0
11	1198507	.	G	T	4	8	12	0	1	13	0	0
11	1203619	.	G	A	4	2	6	0	0	6	0	0
11	1221865	.	A	G	6	5	11	0	0	11	0	0
11	1222025	.	T	G	5	3	8	0	0	8	0	0
11	1341402	.	C	T	0	4	4	0	5	9	0	0
11	1342778	.	G	A	4	3	7	0	0	7	0	0
11	1342826	.	A	G	5	5	10	0	0	10	0	0
11	1348596	.	A	G	6	13	19	0	0	19	0	0
11	1348821	.	A	C	5	7	12	0	0	12	0	0
11	1351542	.	C	T	1	2	3	0	6	9	0	0
11	1351563	.	T	G	2	3	5	0	2	7	0	0
11	1351611	.	A	G	2	2	4	0	0	4	0	0
11	1396343	.	T	C	12	25	37	0	3	40	0	0
11	1403797	.	T	C	1	0	1	0	4	5	0	0
11	1403821	.	A	C	1	7	8	0	0	8	0	0
11	1404031	.	A	C	2	4	6	0	1	7	0	0
11	1404481	.	C	A	3	2	5	0	0	5	0	0
11	1404640	.	T	C	2	0	2	0	2	4	0	0
11	1404642	.	A	G	2	2	4	0	0	4	0	0
11	1407178	.	A	C	3	2	5	0	1	6	0	0
11	1427981	.	T	C	15	0	15	0	17	32	0	0
11	1435736	.	A	G	3	5	8	0	0	8	0	0
11	1467114	.	T	C	13	0	13	0	6	19	0	0
11	1467130	.	C	A	1	10	11	0	10	21	0	0
11	1469842	.	C	T	7	4	11	0	0	11	0	0
11	1469859	.	A	G	7	11	18	0	1	19	0	0
11	1469895	.	A	G	7	14	21	0	1	22	0	0
11	1470503	.	G	A	5	6	11	0	1	12	0	0
11	1470535	.	G	C	3	5	8	0	0	8	0	0
11	1474629	.	C	T	8	6	14	0	1	15	0	0
11	1517289	.	C	A	3	3	6	0	0	6	0	0
11	1520797	.	A	G	1	2	3	0	0	3	0	0
11	1522194	.	C	G	16	0	16	0	6	22	0	0
11	1522205	.	G	T	16	6	22	0	1	23	0	0
11	1522291	.	T	C	6	4	10	0	0	10	0	0
11	1524079	.	T	C	3	3	6	0	0	6	0	0
11	1524108	.	C	T	2	2	4	0	0	4	0	0
11	1525081	.	G	C	8	4	12	0	1	14	1	0
11	1525389	.	G	T	19	14	33	2	1	36	0	0
11	1525416	.	T	A	17	17	34	1	3	38	0	0
11	1526749	.	A	G	16	16	32	0	1	33	0	0
11	1529260	.	A	G	19	16	35	0	1	36	0	0
11	1529526	.	G	A	12	16	28	0	0	28	0	0
11	1529743	.	G	A	14	10	24	0	1	25	0	0
11	1529789	.	A	C	10	8	18	0	1	19	0	0
11	1529796	.	A	T	9	8	17	0	0	17	0	0
11	1529838	.	A	G	5	12	17	0	0	17	0	0
11	1529852	.	A	G	9	6	15	0	3	18	0	0
11	1530027	.	G	A	3	7	10	0	0	10	0	0
11	1530295	.	A	C	14	22	36	0	0	36	0	0
11	1530363	.	A	G	11	23	34	0	4	38	0	0
11	1530489	.	A	G	15	0	15	0	15	30	0	0
11	1530541	.	A	G	15	15	30	0	2	32	0	0
11	1530584	.	G	A	3	18	21	0	16	37	0	0
11	1530593	.	G	T	15	18	33	0	3	36	0	0
11	1530642	.	G	A	18	10	28	0	2	30	0	0
11	1535427	.	C	A	1	2	3	0	0	3	0	0
11	1535877	.	G	A	2	4	6	0	0	6	0	0
11	1542605	.	A	G	7	0	7	0	6	13	0	0
11	1543974	.	A	G	7	6	13	0	0	13	0	0
11	1545883	.	A	C	4	3	7	0	0	7	0	0
11	1545958	.	G	A	4	2	6	0	0	6	0	0
11	1810104	.	C	T	3	3	6	0	0	6	0	0
11	1813240	.	A	G	1	2	3	0	0	3	0	0
11	1815978	.	C	T	5	4	9	0	0	9	0	0
11	1818005	.	C	T	5	3	8	0	0	8	0	0
11	1834124	.	T	C	8	3	11	0	0	11	0	0
11	1836100	.	C	A	9	5	14	0	1	15	0	0
11	1836995	.	C	G	2	0	2	0	6	8	0	0
11	1838725	.	G	C	2	3	5	0	9	14	0	0
11	1841961	.	G	C	12	7	19	0	0	19	0	0
11	1843339	.	G	T	10	8	18	0	2	20	0	0
11	1843771	.	C	A	7	8	15	0	2	17	0	0
11	1843812	.	A	G	4	0	4	0	7	11	0	0
11	1843818	.	G	A	4	4	8	0	1	9	0	0
11	1863846	.	T	G	17	21	38	0	2	40	0	0
11	1864095	.	C	A	26	16	42	0	0	42	0	0
11	1864216	.	C	T	15	15	30	0	0	30	0	0
11	1919016	.	T	A	1	3	4	0	0	4	0	0
11	1919876	.	C	T	9	8	17	0	0	17	0	0
11	1920069	.	A	T	5	4	9	0	0	9	0	0
11	1945034	.	T	A	8	4	12	0	0	12	0	0
11	1945036	.	C	T	7	4	11	0	0	11	0	0
11	1945229	.	C	T	5	6	11	0	0	11	0	0
11	1947965	.	A	G	1	5	6	0	0	6	0	0
11	1948373	.	A	T	1	3	4	0	0	4	0	0
11	2111697	.	A	G	2	3	5	0	0	5	0	0
11	2111894	.	G	C	1	3	4	0	0	4	0	0
11	2112267	.	C	T	1	2	3	0	0	3	0	0
11	2112554	.	A	G	1	3	4	0	0	4	0	0
11	2113450	.	C	T	2	2	4	0	1	5	0	0
11	2218261	.	C	G	0	2	2	0	1	3	0	0
11	2240120	.	A	C	19	7	26	0	2	28	0	0
11	2244436	.	A	G	5	2	7	1	0	8	0	0
11	2246875	.	G	T	5	5	10	0	0	10	0	0
11	2249884	.	A	G	23	26	49	0	3	52	0	0
11	2249920	.	C	T	25	25	50	0	3	53	0	0
11	2253154	.	G	A	9	3	12	0	1	13	0	0
11	2255025	.	T	G	5	3	8	0	0	8	0	0
11	2255027	.	T	G	5	3	8	0	0	8	0	0
11	2258159	.	G	A	1	8	9	0	0	9	0	0
11	2295604	.	A	G	1	2	3	0	0	3	0	0
11	2458371	.	T	G	1	2	3	0	1	4	0	0
11	2462659	.	C	T	5	3	8	0	1	9	0	0
11	2462665	.	A	T	6	2	8	0	1	9	0	0
11	2462749	.	A	G	1	4	5	0	2	7	0	0
11	2462791	.	A	G	3	9	12	0	0	12	0	0
11	2462830	.	A	G	3	3	6	0	0	6	0	0
11	2462831	.	G	A	3	3	6	0	0	6	0	0
11	2506937	.	C	G	2	2	4	0	0	4	0	0
11	2541430	.	T	C	1	0	1	0	2	3	0	0
11	2541797	.	T	C	3	4	7	0	0	7	0	0
11	2542391	.	C	T	4	10	14	0	0	14	0	0
11	2545018	.	A	G	2	4	6	0	0	6	0	0
11	2571635	.	A	G	8	6	14	0	0	14	0	0
11	2571685	.	C	A	2	2	4	0	0	4	0	0
11	2571686	.	A	T	2	2	4	0	0	4	0	0
11	2616881	.	T	A	1	3	4	0	0	4	0	0
11	2616956	.	T	C	14	13	27	0	1	28	0	0
11	2617031	.	T	A	17	16	33	0	0	33	0	0
11	2617072	.	A	G	14	10	24	0	1	25	0	0
11	2618072	.	T	A	5	3	8	0	0	8	0	0
11	2618073	.	G	A	5	3	8	0	0	8	0	0
11	2618114	.	C	A	1	4	5	0	1	6	0	0
11	2618653	.	C	A	3	3	6	0	0	6	0	0
11	2619089	.	G	A	5	8	13	0	1	14	0	0
11	2619129	.	C	A	4	10	14	0	1	15	0	0
11	2619180	.	T	C	3	5	8	0	0	8	0	0
11	2619181	.	T	A	3	5	8	0	0	8	0	0
11	2619515	.	T	A	4	5	9	0	0	9	0	0
11	2619538	.	T	A	7	6	13	0	0	13	0	0
11	2619588	.	G	C	6	0	6	0	5	11	0	0
11	2621839	.	G	A	1	8	9	0	0	9	0	0
11	2625178	.	G	A	3	2	5	0	0	5	0	0
11	2660602	.	T	C	2	3	5	0	0	5	0	0
11	2665236	.	T	A	2	2	4	0	0	4	0	0
11	2673624	.	T	C	1	4	5	0	1	6	0	0
11	2675447	.	C	A	3	2	5	0	1	6	0	0
11	2675454	.	A	C	3	2	5	0	0	5	0	0
11	2677377	.	G	C	2	4	6	0	0	6	0	0
11	2677428	.	A	G	4	2	6	0	0	6	0	0
11	2677440	.	C	T	4	3	7	0	0	7	0	0
11	2678064	.	G	A	3	5	8	0	1	9	0	0
11	2678088	.	G	A	4	3	7	0	0	7	0	0
11	2680570	.	G	A	0	2	2	0	1	3	0	0
11	2680747	.	C	T	3	4	7	0	0	7	0	0
11	2680797	.	G	C	4	4	8	0	0	8	0	0
11	2681964	.	A	G	1	2	3	0	0	3	0	0
11	2682001	.	C	T	2	2	4	0	0	4	0	0
11	2682441	.	A	T	2	4	6	0	0	6	0	0
11	2682644	.	A	T	2	3	5	0	0	5	0	0
11	2682664	.	T	A	3	6	9	0	0	9	0	0
11	2682693	.	A	C	7	4	11	0	0	11	0	0
11	2683509	.	T	C	7	26	33	2	1	36	0	0
11	2687526	.	G	A	3	2	5	0	0	5	0	0
11	2687550	.	A	C	3	2	5	0	0	5	0	0
11	2689336	.	G	A	2	6	8	0	0	8	0	0
11	2689337	.	G	A	2	6	8	0	0	8	0	0
11	2690233	.	G	T	2	3	5	0	0	5	0	0
11	2690303	.	G	C	13	4	17	0	1	18	0	0
11	2690445	.	G	T	11	6	17	1	1	19	0	0
11	2690499	.	C	T	9	6	15	0	0	15	0	0
11	2690612	.	A	C	10	6	16	0	0	16	0	0
11	2690869	.	C	A	4	5	9	0	0	9	0	0
11	2690873	.	G	A	1	4	5	0	3	8	0	0
11	2692109	.	A	C	3	2	5	0	0	5	0	0
11	2692180	.	C	T	5	2	7	0	1	8	0	0
11	2692325	.	G	A	3	4	7	2	0	9	0	0
11	2692579	.	T	G	1	0	1	0	2	3	0	0
11	2702718	.	T	C	6	3	9	0	0	9	0	0
11	2702766	.	C	T	4	4	8	0	1	9	0	0
11	2702808	.	T	C	2	3	5	0	1	6	0	0
11	2705206	.	C	T	4	2	6	0	0	6	0	0
11	2705215	.	G	T	0	4	4	0	4	8	0	0
11	2705273	.	A	G	3	0	3	0	5	8	0	0
11	2705325	.	G	A	4	3	7	0	0	7	0	0
11	2705355	.	T	A	5	3	8	0	0	8	0	0
11	2706517	.	T	G	5	8	13	0	1	14	0	0
11	2706838	.	A	G	6	7	13	0	1	14	0	0
11	2706988	.	C	A	4	2	6	0	0	6	0	0
11	2743631	.	A	G	1	0	1	0	2	3	0	0
11	2755120	.	A	T	1	4	5	0	0	5	0	0
11	2756250	.	C	T	5	3	8	0	0	8	0	0
11	2757582	.	T	C	9	6	15	0	0	15	0	0
11	2757611	.	T	A	3	6	9	0	1	10	0	0
11	2758204	.	C	T	10	11	21	0	2	23	0	0
11	2758737	.	T	A	2	2	4	0	0	4	0	0
11	2759043	.	A	T	2	6	8	3	0	11	0	0
11	2759461	.	T	C	5	5	10	3	2	15	0	0
11	2759475	.	G	T	8	6	14	4	0	19	1	0
11	2759498	.	G	A	6	13	19	3	2	24	0	0
11	2759541	.	C	A	3	10	13	6	0	19	0	0
11	2759833	.	G	A	2	10	12	0	17	29	0	0
11	2759843	.	G	A	2	13	15	0	17	32	0	0
11	2759901	.	T	G	17	16	33	0	0	33	0	0
11	2759903	.	A	T	15	16	31	0	3	34	0	0
11	2759938	.	A	G	19	14	33	0	1	34	0	0
11	2809804	.	A	G	3	3	6	0	0	6	0	0
11	2813856	.	G	C	2	4	6	0	1	7	0	0
11	2815790	.	C	G	11	5	16	0	0	16	0	0
11	2815845	.	C	T	11	7	18	0	1	19	0	0
11	2820876	.	T	G	6	6	12	0	1	13	0	0
11	2820900	.	A	C	5	7	12	0	0	12	0	0
11	2821427	.	T	C	4	5	9	0	1	10	0	0
11	2821430	.	C	G	5	0	5	0	6	11	0	0
11	2826184	.	T	C	15	6	21	0	0	21	0	0
11	2826338	.	G	T	10	9	19	0	0	19	0	0
11	2826485	.	C	A	8	5	13	0	2	15	0	0
11	2828174	.	A	G	11	19	30	0	1	31	0	0
11	2828180	.	A	G	24	7	31	0	1	32	0	0
11	2828276	.	C	A	13	10	23	0	0	23	0	0
11	2828388	.	G	A	9	14	23	0	3	26	0	0
11	3195739	.	G	T	1	2	3	0	0	3	0	0
11	3217970	.	C	T	2	2	4	0	0	4	0	0
11	3230284	.	G	A	1	2	3	0	0	3	0	0
11	3235543	.	C	T	1	2	3	0	0	3	0	0
11	3238720	.	T	C	6	4	10	0	1	11	0	0
11	3240457	.	G	A	0	4	4	0	6	10	0	0
11	3243124	.	A	G	6	0	6	0	8	14	0	0
11	3246120	.	A	G	7	8	15	0	1	16	0	0
11	3246133	.	A	G	8	10	18	0	1	19	0	0
11	3246590	.	A	C	7	5	12	14	0	26	0	0
11	3249253	.	C	T	5	7	12	0	0	12	0	0
11	3249346	.	C	T	10	8	18	0	0	18	0	0
11	3249370	.	A	G	6	0	6	0	6	12	0	0
11	3301686	.	C	T	2	3	5	0	0	5	0	0
11	3301724	.	C	T	0	2	2	0	1	3	0	0
11	3317226	.	T	C	11	13	24	0	0	24	0	0
11	3317229	.	G	T	12	13	25	0	1	26	0	0
11	3317389	.	A	T	22	17	39	0	0	39	0	0
11	3321141	.	A	T	5	1	6	0	1	7	0	0
11	3321152	.	C	T	1	2	3	0	5	8	0	0
11	3323377	.	G	T	4	3	7	0	1	8	0	0
11	3336700	.	T	G	28	26	54	0	0	54	0	0
11	3336793	.	C	T	31	41	72	0	1	73	0	0
11	3337038	.	A	G	32	37	69	0	5	74	0	0
11	3337253	.	A	G	27	38	65	0	2	67	0	0
11	3337256	.	T	C	29	0	29	0	36	65	0	0
11	3337481	.	T	G	30	33	63	0	2	65	0	0
11	3337482	.	A	T	28	31	59	0	5	64	0	0
11	3337718	.	G	C	21	22	43	0	1	44	0	0
11	3337948	.	A	T	8	4	12	0	1	13	0	0
11	3338060	.	C	G	26	14	40	0	0	40	0	0
11	3338144	.	T	C	34	24	58	0	4	62	0	0
11	3338236	.	T	C	34	1	35	0	22	57	0	0
11	3338288	.	T	A	33	21	54	0	3	57	0	0
11	3338299	.	T	G	27	23	50	0	4	54	0	0
11	3338420	.	A	T	26	26	52	0	5	57	0	0
11	3338431	.	C	T	4	21	25	0	31	56	0	0
11	3338491	.	G	A	24	24	48	0	3	51	0	0
11	3338514	.	C	A	24	27	51	0	0	51	0	0
11	3338618	.	T	C	25	22	47	0	3	50	0	0
11	3338638	.	A	G	27	21	48	0	3	51	0	0
11	3338933	.	A	G	19	17	36	0	0	36	0	0
11	3339098	.	T	C	14	0	14	0	10	24	0	0
11	3339152	.	C	T	8	7	15	0	0	15	0	0
11	3341296	.	G	A	4	8	12	0	0	12	0	0
11	3345676	.	A	G	6	5	11	0	0	11	0	0
11	3345952	.	T	C	6	7	13	0	1	14	0	0
11	3346128	.	T	G	3	3	6	0	0	6	0	0
11	3346902	.	C	G	4	6	10	0	0	10	0	0
11	3347279	.	G	A	4	2	6	0	0	6	0	0
11	3367789	.	T	C	5	1	6	1	8	15	0	0
11	3367924	.	G	C	10	8	18	0	0	18	0	0
11	3367937	.	T	C	11	7	18	0	0	18	0	0
11	3369843	.	G	A	9	3	12	0	1	13	0	0
11	3373418	.	A	G	10	6	16	0	0	16	0	0
11	3373448	.	G	A	8	5	13	0	2	15	0	0
11	3395069	.	G	A	2	5	7	0	1	8	0	0
11	3395070	.	A	T	2	6	8	0	1	9	0	0
11	3395303	.	G	A	3	6	9	0	0	9	0	0
11	3395324	.	C	T	3	5	8	0	0	8	0	0
11	3395501	.	A	G	3	4	7	0	0	7	0	0
11	3422086	.	T	C	1	2	3	0	0	3	0	0
11	3523724	.	A	G	9	11	20	0	0	20	0	0
11	3523826	.	G	A	4	7	11	0	0	11	0	0
11	3523976	.	A	C	6	0	6	0	7	13	0	0
11	3523991	.	C	T	6	8	14	0	1	15	0	0
11	3524064	.	G	T	8	5	13	0	1	14	0	0
11	3524111	.	G	A	11	8	19	0	0	19	0	0
11	3524121	.	A	G	12	9	21	0	0	21	0	0
11	3524236	.	C	T	14	8	22	0	0	22	0	0
11	3524397	.	T	C	5	5	10	0	0	10	0	0
11	3524462	.	C	T	1	4	5	0	0	5	0	0
11	3524541	.	A	T	7	5	12	0	0	12	0	0
11	3524849	.	G	A	8	6	14	0	1	15	0	0
11	3526521	.	A	G	7	6	13	0	0	13	0	0
11	3526605	.	C	G	9	5	14	0	0	14	0	0
11	3535397	.	A	G	1	3	4	0	0	4	0	0
11	3550448	.	A	G	5	8	13	0	1	15	1	0
11	3550454	.	T	A	9	10	19	0	0	19	0	0
11	3550588	.	T	C	19	0	19	0	26	45	0	0
11	3551309	.	A	G	30	19	49	0	2	51	0	0
11	3551944	.	G	A	28	22	50	0	3	53	0	0
11	3563569	.	T	C	5	5	10	0	0	10	0	0
11	3593309	.	T	C	4	5	9	0	1	10	0	0
11	3593490	.	A	C	5	20	25	0	0	25	0	0
11	3593748	.	A	G	15	14	29	0	1	30	0	0
11	3593791	.	G	C	10	9	19	0	0	19	0	0
11	3593896	.	A	C	12	7	19	0	0	19	0	0
11	3593988	.	G	T	8	22	30	0	1	31	0	0
11	3594217	.	G	T	14	10	24	0	0	24	0	0
11	3594277	.	T	G	7	10	17	0	5	22	0	0
11	3594321	.	T	C	10	1	11	0	14	25	0	0
11	3594327	.	T	A	11	15	26	0	0	26	0	0
11	3594366	.	A	G	14	14	28	0	1	29	0	0
11	3594419	.	A	G	6	10	16	0	3	19	0	0
11	3594452	.	T	G	2	7	9	2	7	18	0	0
11	3594639	.	T	A	7	3	10	0	0	10	0	0
11	3594649	.	T	G	8	3	11	0	0	11	0	0
11	3594828	.	T	C	6	0	6	0	4	10	0	0
11	3595308	.	G	A	1	4	5	0	0	5	0	0
11	3595579	.	A	G	3	4	7	0	0	7	0	0
11	3630875	.	G	A	2	4	6	0	0	6	0	0
11	3631100	.	A	G	3	2	5	0	0	5	0	0
11	3848041	.	G	A	2	1	3	0	1	4	0	0
11	3848283	.	G	A	15	19	34	0	1	35	0	0
11	3848323	.	C	T	0	19	19	0	18	37	0	0
11	3848656	.	C	T	9	14	23	0	1	24	0	0
11	3893635	.	C	T	17	14	31	0	0	31	0	0
11	3893636	.	T	G	15	13	28	0	2	30	0	0
11	3893918	.	G	A	21	16	37	0	2	39	0	0
11	3893928	.	G	C	20	14	34	0	2	36	0	0
11	3894023	.	T	C	19	27	46	0	1	47	0	0
11	3898730	.	C	A	1	14	15	0	8	23	0	0
11	3898736	.	A	G	9	15	24	0	0	24	0	0
11	3899066	.	C	A	0	4	4	0	10	14	0	0
11	3899117	.	G	A	5	7	12	0	1	13	0	0
11	3901733	.	C	G	1	6	7	0	4	11	0	0
11	3904469	.	A	G	4	9	13	0	0	13	0	0
11	3904517	.	C	G	1	8	9	0	3	12	0	0
11	3904564	.	C	T	2	11	13	0	1	14	0	0
11	3904666	.	A	G	2	4	6	0	1	7	0	0
11	3904674	.	T	G	2	5	7	0	0	7	0	0
11	3905928	.	A	G	1	5	6	0	0	6	0	0
11	3917723	.	A	G	15	15	30	0	0	30	0	0
11	3921491	.	A	G	15	12	27	0	0	27	0	0
11	3921563	.	T	A	15	14	29	0	1	30	0	0
11	3922983	.	G	A	10	9	19	0	0	19	0	0
11	3925822	.	T	C	6	0	6	0	4	10	0	0
11	3925906	.	A	G	4	5	9	0	2	11	0	0
11	3925939	.	T	C	4	7	11	0	0	11	0	0
11	3928044	.	A	T	3	3	6	0	0	6	0	0
11	3928168	.	T	C	2	3	5	0	0	5	0	0
11	3931773	.	C	T	1	3	4	0	0	4	0	0
11	3933956	.	A	G	2	2	4	0	0	4	0	0
11	3934190	.	A	G	1	2	3	0	0	3	0	0
11	3939291	.	C	G	1	2	3	0	0	3	0	0
11	3963608	.	G	T	1	2	3	0	0	3	0	0
11	3963639	.	T	A	2	4	6	0	0	6	0	0
11	3964193	.	T	A	1	4	5	0	0	5	0	0
11	3965837	.	G	A	3	5	8	0	0	8	0	0
11	3965867	.	C	T	2	5	7	0	1	8	0	0
11	3965984	.	T	A	7	7	14	0	0	14	0	0
11	3966360	.	G	C	1	3	4	0	3	7	0	0
11	3967408	.	A	G	2	0	2	0	13	15	0	0
11	3967445	.	A	G	2	8	10	0	2	12	0	0
11	3968866	.	T	C	6	10	16	0	1	17	0	0
11	3968877	.	G	A	8	10	18	0	1	19	0	0
11	3968915	.	T	G	7	11	18	0	0	18	0	0
11	3968930	.	A	G	5	0	5	0	14	19	0	0
11	3970955	.	C	A	3	3	6	0	2	8	0	0
11	3970973	.	C	T	4	2	6	0	1	7	0	0
11	3993452	.	G	A	4	8	12	0	5	17	0	0
11	3995459	.	G	A	6	4	10	0	0	10	0	0
11	3995479	.	G	T	7	9	16	0	0	16	0	0
11	3997023	.	T	C	1	0	1	0	6	7	0	0
11	3997029	.	C	A	0	6	6	0	1	7	0	0
11	4006924	.	C	T	0	4	4	0	5	9	0	0
11	4006956	.	C	T	3	6	9	0	0	9	0	0
11	4014458	.	A	G	5	3	8	0	0	8	0	0
11	4014758	.	T	C	2	0	2	0	2	4	0	0
11	4023875	.	T	C	2	0	2	0	2	4	0	0
11	4128836	.	A	T	2	10	12	0	0	12	0	0
11	4131095	.	A	G	2	4	6	0	0	6	0	0
11	4131229	.	G	A	5	1	6	0	1	7	0	0
11	4131234	.	A	G	1	5	6	0	1	7	0	0
11	4131300	.	A	T	4	3	7	0	1	8	0	0
11	4131423	.	T	A	9	6	15	0	0	15	0	0
11	4132110	.	G	T	14	9	23	0	2	25	0	0
11	4132296	.	A	C	33	19	52	0	4	56	0	0
11	4132378	.	G	C	21	9	30	1	1	32	0	0
11	4132440	.	A	G	19	14	33	0	1	34	0	0
11	4132599	.	T	C	11	7	18	0	0	18	0	0
11	5474384	.	T	G	1	0	1	0	4	5	0	0
11	5479555	.	T	C	3	3	6	0	0	6	0	0
11	5484288	.	G	C	1	4	5	0	7	12	0	0
11	5484294	.	T	C	8	3	11	0	0	11	0	0
11	5489221	.	A	G	12	12	24	0	1	25	0	0
11	5489356	.	C	T	5	16	21	0	1	22	0	0
11	5489634	.	A	T	20	8	28	4	2	35	1	0
11	5489688	.	T	C	11	18	29	0	1	30	0	0
11	5489689	.	T	C	9	16	25	0	5	30	0	0
11	5489769	.	C	G	11	17	28	0	1	29	0	0
11	5489781	.	G	A	15	11	26	0	2	28	0	0
11	5489835	.	A	C	3	18	21	0	2	23	0	0
11	5489973	.	A	G	11	0	11	0	3	14	0	0
11	5489974	.	A	G	10	3	13	0	1	14	0	0
11	5506111	.	C	T	2	2	4	0	0	4	0	0
11	5509526	.	C	T	2	3	5	0	0	5	0	0
11	5512128	.	A	G	4	0	4	0	3	7	0	0
11	5512436	.	A	T	5	3	8	0	1	9	0	0
11	5512520	.	C	T	4	2	6	0	0	6	0	0
11	5512921	.	A	G	5	0	5	0	9	14	0	0
11	5512947	.	T	G	2	5	7	0	0	7	0	0
11	5513181	.	A	C	9	3	12	0	1	13	0	0
11	5513210	.	G	A	7	2	9	0	0	9	0	0
11	5514254	.	G	A	0	2	2	0	10	12	0	0
11	5514259	.	C	T	8	3	11	0	1	12	0	0
11	5514677	.	C	T	12	6	18	0	1	19	0	0
11	5515016	.	G	C	6	12	18	0	1	19	0	0
11	5582731	.	T	C	3	3	6	0	0	6	0	0
11	5583059	.	T	C	4	4	8	0	0	8	0	0
11	5658587	.	T	A	2	3	5	0	0	5	0	0
11	5659026	.	C	T	7	2	9	0	1	10	0	0
11	5659054	.	C	G	6	2	8	0	0	8	0	0
11	5659097	.	G	A	7	2	9	0	0	9	0	0
11	5669917	.	A	T	2	3	5	0	0	5	0	0
11	5674704	.	C	T	6	2	8	0	0	8	0	0
11	5674779	.	G	A	1	1	2	0	5	7	0	0
11	5817307	.	G	C	3	3	6	0	0	6	0	0
11	5817472	.	C	A	3	2	5	0	0	5	0	0
11	5821084	.	G	T	7	3	10	0	0	10	0	0
11	5825415	.	C	T	7	2	9	0	5	14	0	0
11	5825477	.	T	C	6	6	12	0	1	13	0	0
11	5825620	.	A	G	12	5	17	0	0	17	0	0
11	5836012	.	G	A	9	17	26	0	0	26	0	0
11	5836049	.	A	C	15	8	23	0	2	25	0	0
11	5843388	.	T	C	16	15	31	0	4	35	0	0
11	5844303	.	T	A	15	21	36	0	1	37	0	0
11	5844333	.	T	C	20	12	32	0	1	33	0	0
11	5852424	.	G	T	3	23	26	2	26	54	0	0
11	5888504	.	C	T	5	3	8	0	0	8	0	0
11	6034421	.	G	A	0	2	2	0	5	7	0	0
11	6046585	.	C	T	2	2	4	0	0	4	0	0
11	6051299	.	T	C	1	2	3	0	1	4	0	0
11	6051362	.	C	G	5	6	11	0	1	12	0	0
11	6051419	.	A	G	11	5	16	0	0	16	0	0
11	6051477	.	G	A	13	6	19	0	2	21	0	0
11	6051481	.	T	C	15	6	21	0	2	23	0	0
11	6051557	.	A	T	13	5	18	0	1	19	0	0
11	6051717	.	G	A	4	10	14	0	0	14	0	0
11	6051839	.	A	C	9	15	24	0	1	25	0	0
11	6052011	.	T	A	9	6	15	0	2	17	0	0
11	6052211	.	G	A	5	6	11	0	1	12	0	0
11	6057335	.	G	A	9	5	14	0	0	14	0	0
11	6062107	.	T	A	7	2	9	0	2	11	0	0
11	6065129	.	C	G	0	5	5	0	6	11	0	0
11	6065150	.	C	T	0	4	4	0	6	10	0	0
11	6073736	.	C	T	1	1	2	0	1	3	0	0
11	6073759	.	G	T	2	3	5	0	0	5	0	0
11	6073887	.	A	G	1	2	3	0	0	3	0	0
11	6073995	.	A	G	1	2	3	0	0	3	0	0
11	6074071	.	T	G	4	1	5	0	0	5	0	0
11	6074110	.	T	G	1	5	6	0	1	7	0	0
11	6124807	.	C	T	1	3	4	0	1	5	0	0
11	6133293	.	G	C	5	4	9	0	0	9	0	0
11	6133335	.	G	A	3	3	6	0	0	6	0	0
11	6133477	.	T	A	2	5	7	0	1	8	0	0
11	6144776	.	T	C	3	8	11	0	1	12	0	0
11	6144800	.	G	A	3	6	9	0	0	9	0	0
11	6172366	.	T	G	1	2	3	0	0	3	0	0
11	6183030	.	T	C	18	12	30	0	2	32	0	0
11	6187412	.	C	G	0	11	11	0	18	29	0	0
11	6197446	.	A	T	7	4	11	0	0	11	0	0
11	6197495	.	C	T	0	10	10	0	9	19	0	0
11	6289556	.	T	C	2	4	6	0	0	6	0	0
11	6428893	.	G	T	15	14	29	0	2	31	0	0
11	6443555	.	T	G	5	0	5	0	7	12	0	0
11	6446730	.	G	A	2	3	5	0	1	6	0	0
11	6446950	.	G	A	2	2	4	0	0	4	0	0
11	6447304	.	T	G	1	3	4	0	0	4	0	0
11	6450624	.	G	A	2	2	4	0	1	5	0	0
11	6456400	.	A	C	3	1	4	0	3	7	0	0
11	6456408	.	G	A	4	2	6	0	1	7	0	0
11	6850576	.	A	G	7	4	11	0	0	11	0	0
11	6859934	.	A	G	1	4	5	0	0	5	0	0
11	6859935	.	T	C	1	0	1	0	4	5	0	0
11	6860020	.	A	G	5	17	22	0	0	22	0	0
11	6860050	.	T	C	10	20	30	0	1	32	1	0
11	6865051	.	C	T	15	20	35	0	1	36	0	0
11	6868156	.	G	T	12	14	26	0	2	28	0	0
11	6869685	.	A	G	9	9	18	0	1	19	0	0
11	6870794	.	C	T	2	10	12	0	4	16	0	0
11	6874110	.	T	C	3	3	6	0	1	7	0	0
11	6877210	.	T	C	2	2	4	0	0	4	0	0
11	6889957	.	G	C	4	2	6	0	0	6	0	0
11	6925032	.	C	G	1	3	4	0	0	4	0	0
11	6941654	.	T	G	8	5	13	0	1	14	0	0
11	6941987	.	C	T	10	5	15	0	1	16	0	0
11	6942040	.	G	A	4	9	13	0	1	14	0	0
11	6942409	.	G	A	2	3	5	0	1	6	0	0
11	6942797	.	T	C	10	9	19	0	0	19	0	0
11	6943013	.	C	T	8	7	15	0	0	15	0	0
11	6943048	.	A	G	6	0	6	0	12	18	0	0
11	6943055	.	T	G	6	10	16	0	2	18	0	0
11	6943462	.	T	A	9	4	13	0	0	13	0	0
11	6943715	.	G	A	0	12	12	0	9	21	0	0
11	6944143	.	T	A	10	8	18	0	1	19	0	0
11	6980913	.	C	T	6	2	8	0	0	8	0	0
11	6987213	.	C	T	1	4	5	0	1	6	0	0
11	7040973	.	T	A	3	6	9	0	0	9	0	0
11	7041002	.	A	G	4	6	10	0	0	10	0	0
11	7041291	.	T	C	5	6	11	0	1	12	0	0
11	7041300	.	A	G	7	7	14	0	1	15	0	0
11	7041475	.	C	G	3	5	8	0	0	8	0	0
11	7041476	.	T	C	2	0	2	0	5	7	0	0
11	7041527	.	T	C	3	3	6	0	0	6	0	0
11	7041528	.	G	C	3	3	6	0	0	6	0	0
11	7041580	.	T	C	2	5	7	0	0	7	0	0
11	7041598	.	A	C	1	6	7	0	1	8	0	0
11	7041621	.	T	G	2	5	7	0	0	7	0	0
11	7041915	.	T	A	6	6	12	0	0	12	0	0
11	7041940	.	A	C	6	6	12	0	0	12	0	0
11	7042209	.	T	A	5	2	7	0	0	7	0	0
11	7042210	.	T	C	5	0	5	0	2	7	0	0
11	7042244	.	A	T	3	2	5	0	0	5	0	0
11	7042513	.	T	A	2	2	4	0	0	4	0	0
11	7101067	.	G	A	2	2	4	0	0	4	0	0
11	7101366	.	C	A	3	2	5	0	0	5	0	0
11	7102978	.	G	A	1	6	7	0	6	13	0	0
11	7103010	.	A	T	3	4	7	0	0	7	0	0
11	7103099	.	G	A	0	3	3	0	4	7	0	0
11	7150189	.	T	C	3	4	7	0	0	7	0	0
11	7151773	.	G	T	14	27	41	0	2	43	0	0
11	7151806	.	C	A	2	34	36	0	17	53	0	0
11	7151842	.	G	T	23	23	46	0	4	50	0	0
11	7151860	.	A	T	34	10	44	0	2	46	0	0
11	7151910	.	G	A	12	17	29	1	1	31	0	0
11	7152102	.	G	A	16	11	27	0	1	28	0	0
11	7152274	.	G	A	13	11	24	0	0	24	0	0
11	7152426	.	A	T	10	11	21	2	0	23	0	0
11	7152428	.	A	G	9	11	20	1	1	22	0	0
11	7152594	.	C	T	10	6	16	0	1	17	0	0
11	7152609	.	C	T	6	6	12	0	0	12	0	0
11	7152639	.	C	A	2	9	11	0	5	16	0	0
11	7175215	.	G	C	1	6	7	0	5	12	0	0
11	7178941	.	G	C	0	15	15	0	6	21	0	0
11	7179018	.	C	T	7	5	12	0	1	13	0	0
11	7179259	.	T	C	2	7	9	0	2	11	0	0
11	7179376	.	G	A	8	3	11	0	0	11	0	0
11	7179378	.	A	G	8	3	11	0	0	11	0	0
11	7194867	.	T	C	3	3	6	0	0	6	0	0
11	7198484	.	G	A	3	2	5	0	0	5	0	0
11	7198517	.	A	G	2	4	6	0	1	7	0	0
11	7198607	.	G	A	2	5	7	0	0	7	0	0
11	7201648	.	T	C	5	5	10	0	1	11	0	0
11	7201654	.	C	T	6	5	11	0	0	11	0	0
11	7202315	.	C	T	5	4	9	0	2	11	0	0
11	7202321	.	G	A	0	7	7	0	7	14	0	0
11	7211908	.	A	G	13	18	31	0	4	35	0	0
11	7212029	.	A	G	3	5	8	0	1	9	0	0
11	7277061	.	A	G	7	4	11	0	0	11	0	0
11	7277310	.	T	C	10	19	29	0	0	29	0	0
11	7277315	.	T	C	10	17	27	0	1	28	0	0
11	7279587	.	G	A	9	6	15	0	0	15	0	0
11	7279904	.	G	A	1	4	5	0	0	5	0	0
11	7279913	.	G	T	1	4	5	0	0	5	0	0
11	7283033	.	G	T	5	2	7	0	0	7	0	0
11	7283839	.	C	T	1	1	2	0	0	2	0	0
11	7283846	.	C	A	3	2	5	0	0	5	0	0
11	7340143	.	A	G	25	22	47	0	1	48	0	0
11	7341031	.	G	A	29	33	62	0	2	64	0	0
11	7652642	.	T	C	1	2	3	0	0	3	0	0
11	7652648	.	G	C	1	2	3	0	0	3	0	0
11	7686796	.	T	C	1	2	3	0	0	3	0	0
11	7734898	.	A	G	10	0	10	0	11	21	0	0
11	7735869	.	C	G	18	14	32	0	0	32	0	0
11	7735905	.	T	A	24	13	37	0	1	38	0	0
11	7735937	.	T	A	16	13	29	0	1	30	0	0
11	7736482	.	T	G	15	0	15	0	6	21	0	0
11	7736576	.	G	A	25	20	45	0	3	48	0	0
11	7736589	.	G	T	27	23	50	0	3	53	0	0
11	7981303	.	A	C	4	5	9	0	2	11	0	0
11	7981427	.	C	T	8	6	14	0	0	14	0	0
11	7981613	.	T	C	27	20	47	0	2	49	0	0
11	7981912	.	T	C	11	0	11	0	15	26	0	0
11	7981915	.	T	A	11	13	24	0	1	25	0	0
11	7982114	.	C	T	11	8	19	0	0	19	0	0
11	7982122	.	T	A	11	8	19	0	1	20	0	0
11	7982205	.	T	C	11	0	11	0	9	20	0	0
11	7982263	.	T	G	8	4	12	0	0	12	0	0
11	7982321	.	T	A	7	7	14	0	2	16	0	0
11	7982566	.	T	A	7	4	11	0	2	13	0	0
11	7982774	.	T	A	8	7	15	0	0	15	0	0
11	7982791	.	C	T	10	7	17	0	0	17	0	0
11	7982835	.	C	T	11	5	16	0	0	16	0	0
11	7982869	.	C	T	9	5	14	0	0	14	0	0
11	7983348	.	C	A	5	3	8	0	0	8	0	0
11	7983631	.	C	T	1	7	8	0	7	15	0	0
11	7983709	.	T	A	2	8	10	0	2	12	0	0
11	7983734	.	A	G	1	6	7	0	0	7	0	0
11	7983757	.	A	T	3	5	8	0	1	9	0	0
11	7983877	.	C	A	1	2	3	0	0	3	0	0
11	7984264	.	A	T	2	7	9	0	0	9	0	0
11	7984350	.	A	T	3	5	8	0	0	8	0	0
11	7984666	.	T	A	4	5	9	0	1	10	0	0
11	8012466	.	T	A	3	5	8	0	1	9	0	0
11	8012535	.	A	G	4	4	8	0	0	8	0	0
11	8115252	.	A	G	1	2	3	0	1	4	0	0
11	8153771	.	C	T	4	4	8	0	0	8	0	0
11	8156967	.	C	T	6	4	10	0	0	10	0	0
11	8156972	.	C	T	4	4	8	0	1	9	0	0
11	8157002	.	C	G	9	6	15	0	0	15	0	0
11	8305367	.	A	G	3	2	5	0	0	5	0	0
11	8305395	.	A	C	1	2	3	0	0	3	0	0
11	8565678	.	A	G	1	2	3	0	0	3	0	0
11	8565961	.	T	C	1	2	3	0	0	3	0	0
11	8662864	.	G	A	0	6	6	0	4	10	0	0
11	8672749	.	A	C	4	4	8	0	2	10	0	0
11	8672992	.	G	T	0	3	3	0	4	7	0	0
11	8673002	.	T	C	4	2	6	0	0	6	0	0
11	8681619	.	G	T	16	16	32	0	2	34	0	0
11	8681714	.	T	C	13	16	29	0	1	30	0	0
11	8681750	.	G	A	10	10	20	0	0	20	0	0
11	10389284	.	A	G	1	7	8	0	0	8	0	0
11	10402081	.	G	A	4	4	8	0	1	9	0	0
11	10468756	.	T	C	1	2	3	0	0	3	0	0
11	10468772	.	T	A	1	1	2	0	1	3	0	0
11	10669933	.	G	T	35	18	53	0	5	59	1	0
11	10670112	.	T	A	17	18	35	0	4	39	0	0
11	10670394	.	C	T	30	17	47	0	0	47	0	0
11	10670439	.	T	C	32	13	45	1	12	58	0	0
11	10671525	.	A	G	11	20	31	0	0	31	0	0
11	10671546	.	A	G	9	15	24	0	0	24	0	0
11	10671578	.	A	T	8	14	22	0	0	22	0	0
11	10671636	.	C	T	2	9	11	0	4	15	0	0
11	10671997	.	T	C	5	4	9	0	0	9	0	0
11	10672707	.	T	G	6	6	12	0	0	12	0	0
11	10672726	.	T	A	4	9	13	0	1	14	0	0
11	10672750	.	T	C	5	9	14	0	1	15	0	0
11	10813404	.	A	T	1	2	3	0	0	3	0	0
11	10832957	.	G	T	11	14	25	0	2	27	0	0
11	10835571	.	T	C	9	0	9	0	16	25	0	0
11	10842537	.	T	C	3	1	4	0	12	16	0	0
11	10842714	.	A	C	2	0	2	0	8	10	0	0
11	10909461	.	G	A	0	3	3	0	1	4	0	0
11	10958321	.	A	G	5	0	5	0	7	12	0	0
11	10958903	.	G	A	0	2	2	0	1	3	0	0
11	10959499	.	T	A	7	7	14	0	0	14	0	0
11	11177436	.	T	C	3	2	5	0	0	5	0	0
11	11184743	.	A	C	2	3	5	0	0	5	0	0
11	11184818	.	T	C	2	2	4	0	0	4	0	0
11	11185053	.	G	A	2	3	5	0	0	5	0	0
11	11185074	.	G	C	1	3	4	0	0	4	0	0
11	11186248	.	G	C	1	2	3	0	0	3	0	0
11	11191840	.	C	T	5	6	11	0	3	14	0	0
11	11191845	.	C	T	6	7	13	0	2	15	0	0
11	11191995	.	T	C	11	16	27	0	1	28	0	0
11	11192053	.	C	T	5	7	12	0	0	12	0	0
11	11192170	.	T	A	2	4	6	0	1	7	0	0
11	11192276	.	G	A	7	10	17	0	1	18	0	0
11	11192342	.	T	G	6	5	11	0	0	11	0	0
11	11192724	.	T	C	9	11	20	0	1	21	0	0
11	11193030	.	C	T	3	3	6	0	2	8	0	0
11	11272175	.	C	T	0	2	2	0	1	3	0	0
11	11274615	.	A	T	21	16	37	0	3	40	0	0
11	11307969	.	T	C	1	4	5	0	0	5	0	0
11	11307981	.	C	A	1	2	3	0	1	4	0	0
11	11319180	.	A	G	3	3	6	0	0	6	0	0
11	11324286	.	T	G	8	8	16	0	0	16	0	0
11	11324295	.	T	G	8	7	15	0	2	17	0	0
11	11325486	.	G	A	12	10	22	0	0	22	0	0
11	11326502	.	A	G	9	8	17	1	0	18	0	0
11	11326671	.	G	A	11	9	20	1	0	21	0	0
11	11326968	.	C	A	0	6	6	0	6	12	0	0
11	11332933	.	T	A	0	1	1	0	2	3	0	0
11	11333116	.	C	A	4	6	10	0	0	10	0	0
11	11333135	.	C	T	3	6	9	0	0	9	0	0
11	11333661	.	T	G	4	2	6	0	0	6	0	0
11	11333670	.	T	G	4	3	7	0	0	7	0	0
11	11468756	.	T	G	15	9	24	0	0	24	0	0
11	11469128	.	C	T	9	6	15	0	1	16	0	0
11	11469143	.	C	T	7	8	15	0	0	15	0	0
11	11469203	.	G	A	10	7	17	0	0	17	0	0
11	11469215	.	C	T	7	6	13	1	0	14	0	0
11	11469632	.	G	A	10	6	16	1	0	17	0	0
11	11470994	.	T	C	2	4	6	0	1	7	0	0
11	11471147	.	C	A	3	3	6	0	1	7	0	0
11	11471372	.	A	C	5	0	5	0	4	9	0	0
11	11471434	.	T	A	5	2	7	0	0	7	0	0
11	11516245	.	T	G	4	4	8	0	1	9	0	0
11	11597120	.	A	T	2	6	8	0	0	8	0	0
11	11597221	.	T	C	6	6	12	0	0	12	0	0
11	11597401	.	C	A	7	20	27	0	2	29	0	0
11	11597523	.	A	G	14	12	26	0	0	26	0	0
11	11597679	.	G	C	6	6	12	0	1	13	0	0
11	11597798	.	A	T	11	11	22	0	0	22	0	0
11	11598334	.	G	C	5	12	17	0	0	17	0	0
11	11602628	.	G	A	2	6	8	0	1	9	0	0
11	11605172	.	T	C	12	0	12	0	8	20	0	0
11	11605744	.	C	T	0	7	7	0	10	17	0	0
11	11612758	.	A	G	2	2	4	0	0	4	0	0
11	11612773	.	C	T	2	2	4	0	0	4	0	0
11	11625153	.	T	C	1	0	1	0	2	3	0	0
11	11625169	.	C	G	2	2	4	0	1	5	0	0
11	11780790	.	A	C	1	3	4	0	0	4	0	0
11	11780863	.	A	G	3	0	3	0	7	10	0	0
11	11780935	.	T	C	1	6	7	0	0	7	0	0
11	11866865	.	G	A	1	2	3	0	0	3	0	0
11	11871042	.	A	C	1	2	3	0	1	4	0	0
11	11902088	.	C	T	2	2	4	0	0	4	0	0
11	11918439	.	T	C	1	0	1	0	4	5	0	0
11	11918712	.	T	G	1	5	6	0	2	8	0	0
11	11922424	.	G	C	1	4	5	0	0	5	0	0
11	11928205	.	C	T	1	1	2	0	1	3	0	0
11	11929271	.	C	G	3	4	7	0	0	7	0	0
11	11949197	.	C	G	1	2	3	0	0	3	0	0
11	11979321	.	A	G	2	1	3	0	1	4	0	0
11	11979494	.	A	G	3	4	7	0	0	7	0	0
11	11979495	.	C	T	2	4	6	0	1	7	0	0
11	11983868	.	C	T	0	2	2	0	7	9	0	0
11	11984120	.	A	G	2	5	7	0	0	7	0	0
11	11984227	.	G	A	4	3	7	0	1	8	0	0
11	11984408	.	A	C	10	4	14	0	1	15	0	0
11	11984409	.	G	C	10	5	15	0	0	15	0	0
11	11984480	.	T	C	7	0	7	0	8	15	0	0
11	11984501	.	A	T	9	6	15	0	0	15	0	0
11	11984548	.	C	T	6	5	11	0	0	11	0	0
11	12004070	.	A	G	2	3	5	0	0	5	0	0
11	12011325	.	G	A	4	7	11	0	1	12	0	0
11	12016638	.	A	G	12	9	21	0	0	21	0	0
11	12016650	.	G	A	11	9	20	0	0	20	0	0
11	12096578	.	C	T	7	4	11	0	2	13	0	0
11	12096593	.	G	A	7	5	12	0	3	15	0	0
11	12108486	.	T	C	14	10	24	0	1	25	0	0
11	12108725	.	G	A	7	10	17	0	0	17	0	0
11	12108822	.	C	A	8	9	17	0	2	19	0	0
11	12118079	.	C	T	10	10	20	0	1	21	0	0
11	12118097	.	T	A	7	8	15	0	2	17	0	0
11	12732419	.	T	C	9	3	12	0	0	12	0	0
11	12732569	.	C	T	3	12	15	0	0	15	0	0
11	12732980	.	T	C	4	5	9	0	0	9	0	0
11	14310584	.	C	A	1	2	3	0	0	3	0	0
11	14342032	.	C	T	4	2	6	0	0	6	0	0
11	14342081	.	C	T	3	2	5	0	0	5	0	0
11	15808761	.	T	C	4	0	4	4	3	11	0	0
11	16006030	.	C	T	2	3	5	0	0	5	0	0
11	16012829	.	G	T	20	20	40	0	2	42	0	0
11	16095020	.	T	C	5	7	12	0	0	12	0	0
11	16095042	.	C	G	5	11	16	0	0	16	0	0
11	16099700	.	G	A	2	9	11	0	1	12	0	0
11	16104175	.	T	C	4	7	11	0	0	11	0	0
11	16115692	.	C	T	5	3	8	0	1	9	0	0
11	16143740	.	G	A	34	22	56	0	2	58	0	0
11	16143781	.	T	C	19	23	42	1	3	46	0	0
11	16153368	.	G	A	1	5	6	0	5	11	0	0
11	16158555	.	G	A	4	4	8	0	0	8	0	0
11	16159101	.	C	T	9	6	15	0	0	15	0	0
11	16159316	.	C	T	5	4	9	0	0	9	0	0
11	16159875	.	T	C	5	8	13	0	0	13	0	0
11	16159903	.	C	T	3	10	13	0	0	13	0	0
11	16159926	.	C	T	12	5	17	0	0	17	0	0
11	16160074	.	C	T	7	5	12	0	4	16	0	0
11	16165233	.	A	G	10	9	19	0	1	20	0	0
11	16165395	.	G	A	13	14	27	0	1	28	0	0
11	16165474	.	C	T	9	3	12	0	2	14	0	0
11	16179830	.	T	A	19	19	38	0	3	41	0	0
11	16179882	.	T	A	19	15	34	0	1	35	0	0
11	16184865	.	A	T	9	4	13	0	1	14	0	0
11	16192224	.	G	A	8	8	16	0	0	16	0	0
11	16238173	.	C	T	3	3	6	0	1	7	0	0
11	16281796	.	C	T	2	4	6	1	0	7	0	0
11	16301085	.	A	G	2	0	2	0	6	8	0	0
11	16329862	.	G	T	2	6	8	0	0	8	0	0
11	16329929	.	T	C	3	5	8	0	0	8	0	0
11	16330072	.	A	C	2	6	8	0	1	9	0	0
11	16330300	.	C	A	9	6	15	1	0	16	0	0
11	16330585	.	A	G	3	9	12	0	0	12	0	0
11	16330686	.	T	G	3	5	8	0	1	9	0	0
11	16330720	.	G	A	6	5	11	0	1	12	0	0
11	16331143	.	T	A	2	2	4	0	0	4	0	0
11	16331219	.	T	C	2	2	4	0	0	4	0	0
11	16331363	.	A	G	2	2	4	0	0	4	0	0
11	16585694	.	A	G	2	2	4	0	0	4	0	0
11	16585724	.	C	A	2	2	4	0	0	4	0	0
11	16586083	.	A	G	2	4	6	0	0	6	0	0
11	16586094	.	A	G	2	2	4	0	0	4	0	0
11	16586272	.	A	T	1	2	3	0	0	3	0	0
11	16586326	.	T	C	1	3	4	0	0	4	0	0
11	16587529	.	C	T	3	1	4	1	2	7	0	0
11	16587682	.	A	C	6	2	8	0	0	8	0	0
11	16587782	.	C	T	7	5	12	0	1	13	0	0
11	16587884	.	T	A	1	2	3	0	0	3	0	0
11	16738655	.	C	T	1	2	3	0	1	4	0	0
11	16739064	.	A	G	7	3	10	0	0	10	0	0
11	17512289	.	T	C	11	13	24	0	4	28	0	0
11	17512522	.	C	A	1	3	4	0	1	5	0	0
11	17597188	.	C	T	0	4	4	0	1	5	0	0
11	17597224	.	G	A	2	7	9	0	0	9	0	0
11	17597225	.	T	G	2	7	9	0	0	9	0	0
11	17597424	.	G	A	5	4	9	0	0	9	0	0
11	17597541	.	G	A	4	5	9	0	0	9	0	0
11	17597564	.	T	C	2	0	2	0	4	6	0	0
11	17608441	.	G	A	6	9	15	0	0	15	0	0
11	17713672	.	T	C	2	2	4	0	0	4	0	0
11	17757623	.	G	T	11	12	23	0	0	23	0	0
11	17757624	.	A	G	10	12	22	0	0	22	0	0
11	17757772	.	G	A	12	7	19	0	0	19	0	0
11	17757931	.	T	C	6	3	9	0	0	9	0	0
11	17763904	.	C	T	4	5	9	0	2	11	0	0
11	17763928	.	C	T	6	6	12	0	1	13	0	0
11	17765182	.	C	A	6	5	11	0	0	11	0	0
11	17765281	.	T	C	10	0	10	0	9	19	0	0
11	17765293	.	C	T	7	10	17	0	1	18	0	0
11	17765489	.	G	A	5	6	11	0	0	11	0	0
11	17765585	.	T	C	4	0	4	0	3	7	0	0
11	17765618	.	T	C	5	0	5	0	3	8	0	0
11	17769200	.	C	T	5	3	8	0	0	8	0	0
11	17769236	.	T	C	7	1	8	0	6	14	0	0
11	17769238	.	C	T	8	6	14	0	1	15	0	0
11	17769711	.	C	T	11	7	18	0	0	18	0	0
11	17771185	.	T	C	6	3	9	0	1	10	0	0
11	17778528	.	T	C	1	0	1	0	3	4	0	0
11	17778618	.	T	G	1	2	3	0	0	3	0	0
11	17778639	.	C	T	0	2	2	0	1	3	0	0
11	17782529	.	A	C	1	0	1	0	2	3	0	0
11	17785428	.	T	C	23	20	43	0	1	44	0	0
11	17789104	.	C	T	2	8	10	0	15	25	0	0
11	17789243	.	G	A	12	11	23	0	0	23	0	0
11	17797072	.	T	C	1	1	2	0	5	7	0	0
11	17984405	.	G	A	0	4	4	0	2	6	0	0
11	17987007	.	A	G	2	5	7	0	1	8	0	0
11	17987038	.	A	T	2	4	6	0	0	6	0	0
11	17994323	.	G	A	0	6	6	0	6	12	0	0
11	18216643	.	G	A	4	2	6	0	0	6	0	0
11	18216767	.	C	T	1	2	3	0	1	4	0	0
11	18223337	.	C	T	6	3	9	0	0	9	0	0
11	18223365	.	T	C	3	4	7	0	1	8	0	0
11	18223383	.	C	T	6	2	8	0	0	8	0	0
11	18237862	.	G	A	5	6	11	0	1	12	0	0
11	18238076	.	C	T	3	9	12	0	0	12	0	0
11	18238171	.	T	C	8	11	19	0	1	20	0	0
11	18243966	.	A	G	8	7	15	0	2	17	0	0
11	18244388	.	T	C	13	14	27	0	5	32	0	0
11	18277370	.	C	T	0	2	2	0	2	4	0	0
11	18277388	.	G	A	1	2	3	0	0	3	0	0
11	18283211	.	C	T	1	2	3	0	0	3	0	0
11	18287283	.	A	T	4	5	9	0	1	10	0	0
11	18287378	.	C	T	0	13	13	0	11	24	0	0
11	18287506	.	A	G	6	5	11	0	0	11	0	0
11	18287687	.	T	A	7	5	12	0	0	12	0	0
11	18287779	.	G	A	7	12	19	0	1	20	0	0
11	18287940	.	A	T	11	5	16	0	1	17	0	0
11	18288212	.	T	C	9	4	13	0	1	14	0	0
11	18288275	.	C	A	1	5	6	0	4	10	0	0
11	18288347	.	G	A	5	10	15	0	1	16	0	0
11	18291853	.	T	A	7	7	14	0	1	15	0	0
11	18292595	.	C	T	0	3	3	0	2	5	0	0
11	18295057	.	T	C	2	4	6	0	0	6	0	0
11	18305804	.	C	G	1	2	3	0	0	3	0	0
11	18345272	.	C	A	1	3	4	0	0	4	0	0
11	18345288	.	C	T	1	4	5	0	0	5	0	0
11	18345343	.	T	A	3	3	6	0	0	6	0	0
11	18345390	.	C	A	4	4	8	0	0	8	0	0
11	18345635	.	G	A	2	4	6	0	1	7	0	0
11	18345719	.	T	G	4	3	7	0	0	7	0	0
11	18345825	.	A	T	1	4	5	0	0	5	0	0
11	18535112	.	T	C	3	6	9	0	0	9	0	0
11	18536769	.	G	A	12	9	21	0	1	22	0	0
11	18536800	.	C	T	1	11	12	0	11	23	0	0
11	18536864	.	G	T	9	12	21	0	0	21	0	0
11	18536866	.	G	A	8	11	19	0	1	20	0	0
11	18537180	.	A	G	7	6	13	0	2	15	0	0
11	18537244	.	G	A	8	14	22	0	1	23	0	0
11	18537447	.	T	C	6	6	12	0	0	12	0	0
11	18537636	.	T	A	8	3	11	0	2	13	0	0
11	18537649	.	G	A	9	7	16	0	0	16	0	0
11	18538122	.	A	T	4	5	9	0	1	10	0	0
11	18538336	.	A	C	7	0	7	0	11	18	0	0
11	18538362	.	T	C	7	0	7	0	11	18	0	0
11	18538910	.	C	T	2	6	8	0	1	9	0	0
11	18542691	.	C	T	1	2	3	0	0	3	0	0
11	18543558	.	T	C	1	0	1	0	2	3	0	0
11	18543870	.	A	G	2	2	4	0	0	4	0	0
11	18546357	.	T	A	5	3	8	0	0	8	0	0
11	18547125	.	A	G	10	15	25	0	1	26	0	0
11	18551089	.	G	A	3	4	7	0	0	7	0	0
11	18551120	.	C	T	1	4	5	0	5	10	0	0
11	18561144	.	T	C	11	5	16	0	0	16	0	0
11	18561432	.	C	G	2	2	4	0	0	4	0	0
11	18561590	.	G	A	6	3	9	0	1	10	0	0
11	18561635	.	T	A	6	5	11	0	1	12	0	0
11	18561674	.	C	T	7	7	14	0	1	15	0	0
11	18561792	.	T	C	17	0	17	0	15	32	0	0
11	18561816	.	A	G	15	15	30	0	1	31	0	0
11	18562059	.	T	G	10	7	17	0	2	19	0	0
11	18562132	.	G	T	4	5	9	0	0	9	0	0
11	18562420	.	G	T	5	6	11	0	1	12	0	0
11	18562448	.	T	C	10	0	10	0	4	14	0	0
11	18562655	.	T	C	5	0	5	0	6	11	0	0
11	18562730	.	G	T	9	11	20	0	1	21	0	0
11	18569158	.	A	T	6	2	8	0	3	11	0	0
11	18569298	.	G	A	5	8	13	0	0	13	0	0
11	18569379	.	A	G	9	6	15	0	1	16	0	0
11	18572364	.	T	C	9	0	9	0	9	18	0	0
11	18572586	.	C	T	1	6	7	0	1	9	1	0
11	18572640	.	T	G	5	4	9	0	1	10	0	0
11	18572648	.	G	A	6	4	10	0	0	10	0	0
11	18575031	.	G	C	3	3	6	0	0	6	0	0
11	18575148	.	C	T	1	4	5	0	1	6	0	0
11	18575299	.	A	G	1	2	3	0	0	3	0	0
11	18579868	.	G	A	2	2	4	0	0	4	0	0
11	18681631	.	G	T	0	3	3	0	1	4	0	0
11	18694013	.	C	T	9	5	14	0	0	14	0	0
11	18697817	.	T	G	9	4	13	0	0	13	0	0
11	18698138	.	A	G	2	0	2	0	5	7	0	0
11	18698256	.	G	T	0	5	5	0	3	8	0	0
11	18698687	.	A	T	1	2	3	0	0	3	0	0
11	18699104	.	T	C	10	14	24	0	0	24	0	0
11	18704500	.	G	A	19	11	30	0	0	30	0	0
11	18704620	.	C	T	2	19	21	0	18	39	0	0
11	18705108	.	A	G	13	7	20	0	0	20	0	0
11	18784949	.	A	T	14	8	22	0	0	22	0	0
11	18784975	.	C	A	15	15	30	0	1	31	0	0
11	18785019	.	G	A	9	24	33	0	2	35	0	0
11	18785022	.	G	A	10	24	34	0	1	35	0	0
11	18785159	.	G	T	19	18	37	0	2	39	0	0
11	18785214	.	T	C	18	21	39	0	3	42	0	0
11	18785309	.	G	A	13	20	33	0	2	35	0	0
11	18785410	.	G	A	11	13	24	0	0	24	0	0
11	18785421	.	A	G	12	10	22	0	2	24	0	0
11	18785854	.	A	G	5	10	15	0	1	16	0	0
11	18786085	.	A	T	5	8	13	0	1	14	0	0
11	18794073	.	T	A	1	6	7	0	0	7	0	0
11	18794157	.	C	A	0	2	2	0	1	3	0	0
11	18794329	.	A	G	2	4	6	0	0	6	0	0
11	18799832	.	A	T	2	2	4	0	0	4	0	0
11	18799841	.	C	G	2	2	4	0	0	4	0	0
11	18803095	.	C	T	0	7	7	0	1	8	0	0
11	18803621	.	A	G	2	3	5	0	0	5	0	0
11	18806030	.	A	G	1	3	4	0	0	4	0	0
11	19042020	.	T	C	2	2	4	0	1	5	0	0
11	19042026	.	A	G	2	3	5	0	0	5	0	0
11	19042092	.	T	C	1	4	5	0	1	6	0	0
11	19042212	.	T	C	5	4	9	0	0	9	0	0
11	19072566	.	A	T	9	13	22	0	2	24	0	0
11	19072695	.	G	A	4	11	15	0	0	15	0	0
11	19072728	.	G	A	1	11	12	0	5	17	0	0
11	19072746	.	A	T	11	9	20	0	0	20	0	0
11	19085099	.	G	A	2	4	6	0	0	6	0	0
11	19089724	.	T	C	26	14	40	0	0	40	0	0
11	19090455	.	C	T	24	21	45	0	4	49	0	0
11	19090597	.	A	G	26	27	53	0	3	56	0	0
11	19464837	.	C	T	1	2	3	0	0	3	0	0
11	19465029	.	T	C	6	6	12	0	0	12	0	0
11	19465080	.	T	C	5	3	8	0	0	8	0	0
11	19465149	.	T	C	7	3	10	0	0	10	0	0
11	19465174	.	C	T	7	3	10	0	1	11	0	0
11	19465269	.	T	C	2	6	8	0	0	8	0	0
11	19465302	.	A	T	1	4	5	0	0	5	0	0
11	19467673	.	G	A	3	8	11	0	1	12	0	0
11	19467838	.	C	T	11	5	16	0	1	17	0	0
11	19468104	.	C	T	17	11	28	0	1	29	0	0
11	19468123	.	T	C	14	15	29	0	0	29	0	0
11	19468147	.	C	T	16	15	31	0	1	32	0	0
11	19468301	.	A	G	14	0	14	0	7	21	0	0
11	19468330	.	A	G	17	0	17	0	10	27	0	0
11	19468547	.	C	A	18	9	27	0	1	28	0	0
11	19468697	.	G	T	18	12	30	0	2	32	0	0
11	19468718	.	A	G	17	14	31	0	1	32	0	0
11	19502479	.	T	C	15	9	24	0	1	25	0	0
11	19503920	.	T	A	11	11	22	0	2	24	0	0
11	19505967	.	T	C	12	14	26	0	1	27	0	0
11	19506155	.	A	G	15	16	31	0	1	32	0	0
11	19509643	.	T	C	19	20	39	0	4	43	0	0
11	19511392	.	G	A	17	20	37	1	1	39	0	0
11	19511922	.	A	C	3	4	7	0	0	7	0	0
11	19511983	.	G	A	5	6	11	0	0	11	0	0
11	19512947	.	A	T	2	3	5	0	0	5	0	0
11	19513109	.	A	C	1	2	3	0	0	3	0	0
11	19606676	.	T	C	11	6	17	0	1	18	0	0
11	19607131	.	T	C	8	13	21	0	1	22	0	0
11	19611215	.	C	T	10	6	16	0	1	17	0	0
11	19624531	.	A	T	2	3	5	0	0	5	0	0
11	19624552	.	C	T	3	9	12	0	0	12	0	0
11	19624686	.	T	C	4	13	17	0	0	17	0	0
11	19624730	.	T	G	8	12	20	0	0	20	0	0
11	19625302	.	C	T	0	1	1	0	21	22	0	0
11	19625524	.	C	T	1	5	6	1	1	8	0	0
11	19625535	.	C	T	2	4	6	1	2	9	0	0
11	19625732	.	A	G	2	7	9	0	1	10	0	0
11	19729842	.	A	T	2	2	4	0	0	4	0	0
11	19733160	.	A	G	3	2	5	0	0	5	0	0
11	20036591	.	G	A	5	2	7	0	0	7	0	0
11	20040014	.	T	A	1	2	3	0	0	3	0	0
11	20040145	.	T	G	4	0	4	0	3	7	0	0
11	20057875	.	G	A	2	3	5	0	0	5	0	0
11	20058915	.	C	T	3	3	6	0	1	7	0	0
11	20794150	.	T	C	2	2	4	0	0	4	0	0
11	20815757	.	A	G	2	0	2	0	3	5	0	0
11	20826358	.	T	C	24	11	35	0	0	35	0	0
11	21154727	.	G	A	3	4	7	0	1	8	0	0
11	21154747	.	A	T	5	5	10	0	2	12	0	0
11	21154786	.	A	C	4	9	13	0	2	15	0	0
11	21155290	.	G	A	9	6	15	0	0	15	0	0
11	21155829	.	A	G	3	5	8	0	0	8	0	0
11	21156085	.	T	G	2	2	4	0	0	4	0	0
11	21156278	.	G	A	4	5	9	0	0	9	0	0
11	21156372	.	G	A	1	4	5	0	0	5	0	0
11	21158423	.	C	A	0	2	2	0	5	7	0	0
11	21259665	.	T	A	6	8	14	0	0	14	0	0
11	21259773	.	G	C	4	8	12	0	1	13	0	0
11	21259968	.	A	G	4	6	10	0	0	10	0	0
11	21260009	.	T	C	3	5	8	0	0	8	0	0
11	21260018	.	A	T	2	5	7	0	0	7	0	0
11	21260092	.	T	C	3	0	3	0	5	8	0	0
11	21279025	.	G	A	17	15	32	0	0	32	0	0
11	21279885	.	A	G	2	8	10	0	0	10	0	0
11	21280003	.	T	C	0	6	6	0	1	7	0	0
11	21280149	.	G	T	4	8	12	0	1	13	0	0
11	21280202	.	A	T	9	6	15	0	0	15	0	0
11	21280236	.	C	A	6	10	16	0	0	16	0	0
11	21280284	.	T	A	2	6	8	0	0	8	0	0
11	21280690	.	T	C	6	2	8	0	0	8	0	0
11	21280848	.	T	A	5	4	9	0	0	9	0	0
11	21280864	.	A	G	2	3	5	0	0	5	0	0
11	21281017	.	A	T	2	6	8	0	2	10	0	0
11	21281110	.	G	A	10	10	20	0	0	20	0	0
11	21281138	.	G	A	8	11	19	0	2	21	0	0
11	21281148	.	G	A	7	10	17	0	1	18	0	0
11	21281311	.	A	T	3	8	11	0	0	11	0	0
11	21281328	.	C	T	2	9	11	0	0	11	0	0
11	21281599	.	T	C	3	7	10	0	1	11	0	0
11	21281951	.	A	G	6	2	8	0	0	8	0	0
11	21282673	.	G	T	5	5	10	0	0	10	0	0
11	21283211	.	G	A	1	2	3	0	1	4	0	0
11	21407073	.	C	A	1	10	11	0	17	28	0	0
11	21407091	.	T	C	13	0	13	0	12	25	0	0
11	21407500	.	G	A	5	8	13	0	2	15	0	0
11	21407540	.	A	G	12	6	18	0	1	19	0	0
11	21407591	.	G	A	15	8	23	0	1	24	0	0
11	21407692	.	C	G	12	8	20	0	1	21	0	0
11	21407782	.	G	T	17	7	24	0	0	24	0	0
11	21407843	.	C	T	5	10	15	0	1	16	0	0
11	21407862	.	A	T	5	10	15	0	0	15	0	0
11	21407895	.	C	G	6	9	15	0	0	15	0	0
11	21407901	.	T	C	5	8	13	0	0	13	0	0
11	21408103	.	G	T	3	2	5	0	0	5	0	0
11	21408201	.	T	A	9	6	15	0	0	15	0	0
11	21408202	.	T	C	9	6	15	0	0	15	0	0
11	21408242	.	C	T	8	6	14	0	0	14	0	0
11	21408423	.	T	A	1	2	3	0	1	4	0	0
11	21408525	.	A	G	1	5	6	0	0	6	0	0
11	21408962	.	C	T	4	4	8	0	0	8	0	0
11	21409122	.	C	T	6	2	8	0	0	8	0	0
11	21409251	.	A	G	6	2	8	0	0	8	0	0
11	21409289	.	T	G	6	5	11	0	0	11	0	0
11	21409331	.	A	G	7	4	11	0	0	11	0	0
11	21409690	.	A	G	6	9	15	0	1	16	0	0
11	21409981	.	C	A	7	3	10	0	0	10	0	0
11	21410542	.	T	C	7	0	7	0	8	15	0	0
11	21410584	.	G	A	2	2	4	0	0	4	0	0
11	21414067	.	T	C	2	0	2	0	4	6	0	0
11	21419637	.	A	C	4	2	6	0	0	6	0	0
11	21596994	.	T	G	2	3	5	0	0	5	0	0
11	21597256	.	A	C	1	5	6	0	0	6	0	0
11	21597584	.	T	C	5	5	10	0	1	11	0	0
11	21597988	.	C	T	5	6	11	0	1	12	0	0
11	22089575	.	T	C	2	2	4	0	0	4	0	0
11	22090903	.	C	T	3	2	5	0	0	5	0	0
11	22091956	.	C	A	13	6	19	0	0	19	0	0
11	22092158	.	G	A	7	13	20	0	3	23	0	0
11	22092181	.	A	T	10	7	17	0	0	17	0	0
11	22092244	.	A	T	8	3	11	0	2	13	0	0
11	22093634	.	G	A	11	18	29	0	3	32	0	0
11	22167813	.	A	T	1	4	5	0	0	5	0	0
11	22363768	.	A	T	8	8	16	0	0	16	0	0
11	22366703	.	C	T	2	7	9	0	10	19	0	0
11	22366709	.	G	T	10	6	16	0	0	16	0	0
11	22369922	.	G	A	2	6	8	0	1	9	0	0
11	22369932	.	G	A	7	2	9	0	1	10	0	0
11	22370049	.	G	A	6	8	14	0	0	14	0	0
11	22371990	.	T	G	1	2	3	0	2	5	0	0
11	22571657	.	G	A	2	5	7	0	0	7	0	0
11	22583150	.	G	A	0	4	4	0	2	6	0	0
11	22583372	.	C	G	1	2	3	0	2	6	1	0
11	22583424	.	G	T	3	4	7	0	1	8	0	0
11	22583514	.	G	A	1	3	4	0	1	5	0	0
11	22583547	.	G	T	6	2	8	0	0	8	0	0
11	22583701	.	A	C	1	2	3	0	0	3	0	0
11	22583807	.	T	C	5	3	8	0	1	9	0	0
11	22583884	.	G	T	1	5	6	0	0	6	0	0
11	22624467	.	C	T	1	2	3	0	0	3	0	0
11	22624777	.	C	A	4	2	6	0	0	6	0	0
11	22624778	.	C	A	4	2	6	0	0	6	0	0
11	22630168	.	G	A	1	6	7	0	0	7	0	0
11	22630303	.	G	A	0	2	2	0	1	3	0	0
11	22891251	.	T	C	17	16	33	0	0	33	0	0
11	22891477	.	G	A	19	14	33	0	2	35	0	0
11	22891490	.	A	C	18	12	30	0	1	31	0	0
11	22891624	.	C	T	17	13	30	2	0	32	0	0
11	22891683	.	G	A	26	14	40	0	4	44	0	0
11	22891890	.	C	A	10	11	21	0	1	22	0	0
11	22891979	.	A	T	9	10	19	0	0	19	0	0
11	22892028	.	C	T	16	9	25	0	2	27	0	0
11	22892092	.	G	A	11	11	22	0	0	22	0	0
11	22892205	.	A	G	19	24	43	0	0	43	0	0
11	22892345	.	C	A	2	8	10	0	9	19	0	0
11	22892395	.	G	A	15	9	24	0	1	25	0	0
11	22892432	.	C	T	18	6	24	0	0	24	0	0
11	22892573	.	G	A	8	12	20	0	1	21	0	0
11	22892859	.	A	T	11	15	26	0	1	27	0	0
11	22905743	.	T	G	7	8	15	0	0	15	0	0
11	22906383	.	T	C	3	1	4	0	1	5	0	0
11	22920796	.	T	A	10	13	23	0	0	23	0	0
11	22921048	.	T	G	20	23	43	0	10	53	0	0
11	22921168	.	C	T	40	26	66	0	3	69	0	0
11	22921326	.	G	A	22	22	44	0	2	46	0	0
11	22922115	.	A	T	17	33	50	0	1	51	0	0
11	22922392	.	G	C	19	17	36	0	3	39	0	0
11	22922645	.	G	A	23	18	41	0	0	41	0	0
11	22922784	.	G	A	23	16	39	0	1	40	0	0
11	22923168	.	G	A	12	16	28	0	1	29	0	0
11	22923410	.	T	C	12	0	12	0	9	21	0	0
11	22923441	.	T	G	17	10	27	0	2	29	0	0
11	22923485	.	G	T	24	8	32	0	3	35	0	0
11	22925901	.	G	A	15	8	23	0	0	23	0	0
11	22925902	.	A	C	16	8	24	0	0	24	0	0
11	22925966	.	A	T	6	7	13	0	1	14	0	0
11	22926213	.	A	C	3	0	3	0	5	8	0	0
11	22926272	.	C	A	5	2	7	0	0	7	0	0
11	22950984	.	C	T	2	4	6	0	0	6	0	0
11	22964006	.	G	T	4	4	8	0	0	8	0	0
11	23312245	.	A	C	2	2	4	0	0	4	0	0
11	23312451	.	T	A	1	2	3	0	0	3	0	0
11	23313911	.	G	A	2	2	4	0	0	4	0	0
11	23313928	.	T	C	0	3	3	0	2	5	0	0
11	23343154	.	A	G	7	11	18	0	0	18	0	0
11	23343231	.	G	A	12	10	22	0	0	22	0	0
11	23343594	.	T	A	9	7	16	0	0	16	0	0
11	23343775	.	A	G	9	8	17	0	0	17	0	0
11	23343842	.	A	T	9	9	18	0	0	18	0	0
11	23344109	.	G	A	7	6	13	0	0	13	0	0
11	23344421	.	G	C	5	8	13	0	3	16	0	0
11	23344608	.	A	C	6	5	11	0	1	13	1	0
11	23344790	.	T	A	6	9	15	0	0	15	0	0
11	23345040	.	G	A	6	4	10	0	0	10	0	0
11	23352639	.	T	G	0	2	2	0	1	3	0	0
11	23353706	.	C	T	2	3	5	0	0	5	0	0
11	23595627	.	C	T	4	2	6	0	3	9	0	0
11	23596264	.	G	A	18	7	25	0	1	26	0	0
11	23596918	.	T	C	5	2	7	0	1	8	0	0
11	23597248	.	T	A	4	6	10	0	1	11	0	0
11	23597262	.	G	A	5	7	12	0	0	12	0	0
11	23597310	.	A	G	4	5	9	0	0	9	0	0
11	23597365	.	T	G	2	5	7	0	1	8	0	0
11	23597372	.	T	G	3	5	8	0	0	8	0	0
11	23597480	.	A	C	5	0	5	0	3	8	0	0
11	23597522	.	C	T	0	5	5	0	6	11	0	0
11	23597537	.	T	C	5	0	5	0	5	10	0	0
11	23856499	.	A	G	1	0	1	0	2	3	0	0
11	23879521	.	C	T	5	9	14	0	0	14	0	0
11	23879825	.	A	T	3	5	8	0	0	8	0	0
11	23879915	.	A	T	3	2	5	0	0	5	0	0
11	23880084	.	T	C	4	2	6	0	0	6	0	0
11	23880429	.	A	T	8	0	8	0	0	8	0	0
11	23880607	.	C	T	2	4	6	0	0	6	0	0
11	23880698	.	C	T	1	7	8	0	1	9	0	0
11	23881683	.	A	T	1	2	3	0	0	3	0	0
11	23882646	.	A	T	9	12	21	0	1	22	0	0
11	23882655	.	C	T	15	8	23	0	1	24	0	0
11	23882836	.	A	G	4	8	12	0	1	13	0	0
11	23883340	.	C	T	8	3	11	0	0	11	0	0
11	23883466	.	C	G	15	13	28	0	0	28	0	0
11	23883699	.	A	T	3	8	11	0	0	11	0	0
11	23883725	.	G	A	5	12	17	0	3	20	0	0
11	23883747	.	C	T	17	12	29	0	2	31	0	0
11	23883810	.	T	A	13	12	25	0	2	27	0	0
11	23884419	.	T	A	26	21	47	0	0	47	0	0
11	23976169	.	C	T	4	3	7	0	0	7	0	0
11	23979519	.	C	T	2	3	5	0	2	7	0	0
11	24035841	.	G	T	0	3	3	0	5	8	0	0
11	24038115	.	A	G	3	7	10	0	0	10	0	0
11	24038795	.	T	G	10	11	21	0	0	21	0	0
11	24039086	.	A	G	8	9	17	0	0	18	1	0
11	24039241	.	A	G	21	0	21	0	8	29	0	0
11	24039246	.	T	G	9	18	27	0	0	27	0	0
11	24039728	.	G	A	9	12	21	0	0	21	0	0
11	24039732	.	C	T	8	12	20	0	4	24	0	0
11	24039773	.	A	C	11	16	27	0	1	28	0	0
11	24039791	.	A	C	10	17	27	0	1	28	0	0
11	24039912	.	T	C	8	19	27	0	6	33	0	0
11	24039949	.	C	A	10	19	29	0	0	29	0	0
11	24043500	.	C	T	10	11	21	0	2	23	0	0
11	24044318	.	G	T	15	8	23	0	1	24	0	0
11	24044351	.	C	T	10	10	20	0	3	23	0	0
11	24044413	.	T	A	8	9	17	0	1	18	0	0
11	24050607	.	G	A	5	3	8	0	0	8	0	0
11	24054807	.	C	A	1	3	4	0	2	6	0	0
11	24055409	.	A	G	3	2	5	0	0	5	0	0
11	24055699	.	A	T	9	4	13	0	0	13	0	0
11	24055884	.	A	G	6	0	6	0	12	18	0	0
11	24056205	.	C	T	18	7	25	0	2	27	0	0
11	24056377	.	G	C	19	14	33	0	8	41	0	0
11	24058749	.	G	A	9	7	16	0	1	17	0	0
11	24058963	.	G	A	4	6	10	0	0	10	0	0
11	24059236	.	T	A	3	6	9	0	0	9	0	0
11	24059476	.	A	T	1	3	4	0	1	5	0	0
11	24059630	.	C	A	2	2	4	0	1	5	0	0
11	24059873	.	A	T	3	4	7	0	1	8	0	0
11	24059933	.	G	A	4	3	7	0	0	7	0	0
11	24059963	.	G	A	5	2	7	0	0	7	0	0
11	24187748	.	A	G	4	8	12	0	2	14	0	0
11	24188088	.	G	T	9	6	15	0	3	18	0	0
11	24188221	.	C	T	1	5	6	0	6	12	0	0
11	24188227	.	G	T	5	6	11	0	0	11	0	0
11	24188385	.	T	A	6	10	16	0	0	17	1	0
11	24188436	.	T	A	7	7	14	0	0	14	0	0
11	24188437	.	G	T	7	7	14	0	0	14	0	0
11	24188884	.	C	T	0	11	11	0	5	16	0	0
11	24189765	.	G	A	4	4	8	0	0	8	0	0
11	24189786	.	C	T	0	3	3	0	6	9	0	0
11	24189811	.	G	C	2	4	6	0	1	7	0	0
11	24330319	.	C	T	1	3	4	0	1	5	0	0
11	24339459	.	C	T	5	5	10	0	1	11	0	0
11	24340807	.	A	G	2	3	5	0	1	6	0	0
11	24340931	.	G	A	3	4	7	0	0	7	0	0
11	24341085	.	T	A	5	4	9	0	1	10	0	0
11	24343437	.	C	A	15	21	36	0	1	38	1	0
11	24343537	.	T	C	17	16	33	0	0	33	0	0
11	24344284	.	C	T	26	18	44	0	1	45	0	0
11	24344490	.	G	A	23	25	48	0	0	48	0	0
11	24344902	.	A	C	26	25	51	0	2	53	0	0
11	24345221	.	C	T	9	16	25	0	0	25	0	0
11	24430106	.	A	C	3	2	5	0	0	5	0	0
11	24465598	.	A	C	3	4	7	0	0	7	0	0
11	24465967	.	A	G	3	4	7	0	0	7	0	0
11	24466237	.	C	A	0	5	5	0	8	13	0	0
11	24471280	.	G	C	3	5	8	0	0	8	0	0
11	24471483	.	G	A	7	3	10	0	1	11	0	0
11	24471540	.	G	A	6	3	9	0	0	9	0	0
11	24471563	.	C	T	1	5	6	0	4	10	0	0
11	24471583	.	C	T	0	4	4	0	5	9	0	0
11	24472065	.	A	G	3	5	8	0	0	8	0	0
11	24472176	.	A	G	2	3	5	0	0	5	0	0
11	24474181	.	G	A	4	3	7	0	0	7	0	0
11	24643023	.	A	T	1	4	5	0	0	5	0	0
11	24658606	.	G	A	1	5	6	0	3	9	0	0
11	24658696	.	C	T	7	4	11	0	0	11	0	0
11	24662794	.	A	G	2	0	2	0	4	6	0	0
11	24662859	.	T	A	6	4	10	0	1	11	0	0
11	24662898	.	C	A	4	6	10	0	0	10	0	0
11	24663349	.	C	G	5	2	7	0	0	7	0	0
11	24663426	.	T	G	1	2	3	0	0	3	0	0
11	24663768	.	G	A	6	5	11	1	0	12	0	0
11	24663808	.	T	C	7	6	13	1	0	14	0	0
11	24747871	.	G	A	2	3	5	0	0	5	0	0
11	24748102	.	C	T	1	3	4	0	0	4	0	0
11	24782271	.	G	A	0	3	3	0	3	6	0	0
11	24789357	.	C	G	5	3	8	0	0	8	0	0
11	24792201	.	G	A	7	2	9	0	0	9	0	0
11	24792460	.	T	C	9	12	21	0	3	24	0	0
11	24799378	.	G	A	12	4	16	0	2	18	0	0
11	24810510	.	C	A	11	12	23	0	2	25	0	0
11	24813128	.	C	T	17	11	28	0	0	28	0	0
11	24813378	.	C	T	11	20	31	0	1	32	0	0
11	24813500	.	C	A	11	7	18	0	2	20	0	0
11	24813651	.	G	A	6	13	19	0	1	20	0	0
11	24813855	.	C	T	12	18	30	0	1	31	0	0
11	24814110	.	G	T	26	18	44	0	2	46	0	0
11	24816471	.	C	T	4	2	6	0	0	6	0	0
11	24816472	.	C	T	4	2	6	0	0	6	0	0
11	24817054	.	T	A	9	6	15	0	1	16	0	0
11	24817247	.	A	G	2	5	7	0	0	7	0	0
11	24817304	.	C	A	2	5	7	0	0	7	0	0
11	24835762	.	A	C	3	2	5	0	0	5	0	0
11	24835764	.	A	G	2	2	4	0	1	5	0	0
11	24836384	.	C	T	9	7	16	0	1	17	0	0
11	24843031	.	C	A	6	9	15	0	1	16	0	0
11	24843058	.	G	A	0	8	8	0	7	15	0	0
11	24843079	.	A	G	5	0	5	0	6	11	0	0
11	24848409	.	G	T	13	14	27	0	1	28	0	0
11	24851182	.	A	T	7	10	17	0	1	18	0	0
11	24851804	.	T	C	0	2	2	0	1	3	0	0
11	24862737	.	C	T	1	2	3	0	0	3	0	0
11	24874841	.	A	G	7	4	11	0	2	13	0	0
11	24875331	.	T	C	7	13	20	0	1	21	0	0
11	24875382	.	G	C	4	10	14	0	0	14	0	0
11	24876225	.	G	A	3	3	6	0	0	6	0	0
11	24876236	.	C	T	2	4	6	0	0	6	0	0
11	24876382	.	A	T	1	2	3	0	1	4	0	0
11	24876425	.	T	A	7	0	7	0	2	9	0	0
11	24882864	.	G	A	5	4	9	0	1	10	0	0
11	24885128	.	C	T	3	4	7	0	0	7	0	0
11	24885384	.	C	T	1	3	4	0	0	4	0	0
11	24885598	.	C	A	1	2	3	0	2	5	0	0
11	24886152	.	C	A	18	15	33	1	0	34	0	0
11	24886245	.	C	T	8	15	23	0	0	23	0	0
11	24886273	.	G	A	0	13	13	0	8	21	0	0
11	24886429	.	A	G	3	1	4	0	2	6	0	0
11	24886672	.	T	C	13	5	18	0	0	18	0	0
11	24886847	.	C	T	20	6	26	0	2	28	0	0
11	24887321	.	T	C	13	21	34	0	1	35	0	0
11	24887523	.	A	G	14	11	25	0	1	26	0	0
11	24887524	.	A	G	18	7	25	0	0	25	0	0
11	24887703	.	C	T	11	11	22	0	3	25	0	0
11	24887803	.	A	C	12	19	31	0	0	31	0	0
11	24888021	.	A	T	4	3	7	0	1	8	0	0
11	24888379	.	C	A	16	16	32	0	1	33	0	0
11	24888560	.	A	T	6	4	10	0	0	10	0	0
11	24902157	.	A	T	20	14	34	0	3	37	0	0
11	24903143	.	G	T	23	15	38	0	2	41	1	0
11	24904588	.	T	C	19	16	35	0	6	41	0	0
11	24905817	.	G	A	17	18	35	0	3	38	0	0
11	24905831	.	G	A	24	18	42	0	0	42	0	0
11	24905985	.	G	T	8	11	19	0	2	21	0	0
11	24906069	.	C	T	14	18	32	0	2	34	0	0
11	24906125	.	A	G	19	10	29	0	2	31	0	0
11	24906128	.	T	A	17	12	29	0	2	31	0	0
11	24966981	.	A	G	1	2	3	0	0	3	0	0
11	24969654	.	A	G	1	0	1	0	3	4	0	0
11	24978617	.	A	C	1	2	3	0	0	3	0	0
11	24992298	.	A	G	11	5	16	0	0	16	0	0
11	24992559	.	C	A	9	4	13	0	4	17	0	0
11	24992560	.	A	G	9	6	15	0	3	18	0	0
11	24992928	.	G	A	7	8	15	0	1	16	0	0
11	24993109	.	G	A	1	2	3	0	6	9	0	0
11	24994833	.	A	C	2	5	7	0	0	7	0	0
11	25010873	.	A	G	1	0	1	0	2	3	0	0
11	25025783	.	T	G	3	6	9	0	0	9	0	0
11	25026437	.	A	G	4	9	13	0	1	14	0	0
11	25026450	.	A	T	5	7	12	0	0	12	0	0
11	25031086	.	T	A	10	8	18	0	0	18	0	0
11	25031272	.	A	C	12	9	21	0	1	22	0	0
11	25031362	.	C	T	7	4	11	0	1	12	0	0
11	25031527	.	G	A	13	9	22	0	0	22	0	0
11	25035439	.	C	T	6	17	23	0	0	23	0	0
11	25036942	.	C	T	11	6	17	0	0	17	0	0
11	25037017	.	C	T	11	10	21	0	0	21	0	0
11	25038572	.	T	C	16	12	28	0	0	28	0	0
11	25038625	.	G	C	13	20	33	0	0	33	0	0
11	25038652	.	G	A	0	14	14	0	13	27	0	0
11	25040729	.	A	G	6	10	16	0	2	18	0	0
11	25040857	.	C	T	18	13	31	0	2	33	0	0
11	25041190	.	A	T	8	11	19	0	3	22	0	0
11	25041204	.	C	T	12	14	26	0	0	26	0	0
11	25041464	.	T	C	21	10	31	0	0	31	0	0
11	25041607	.	G	C	1	21	22	0	17	39	0	0
11	25058993	.	A	C	3	2	5	0	0	5	0	0
11	25061104	.	G	A	3	4	7	0	0	7	0	0
11	25062382	.	T	A	1	2	3	0	0	3	0	0
11	25062395	.	A	C	1	2	3	0	0	3	0	0
11	25062625	.	G	A	3	3	6	0	0	6	0	0
11	25062644	.	A	T	1	3	4	0	0	4	0	0
11	25062867	.	C	G	2	3	5	0	0	5	0	0
11	25062879	.	C	T	2	2	4	0	0	4	0	0
11	25063291	.	A	T	6	6	12	0	0	12	0	0
11	25063293	.	T	C	6	6	12	0	0	12	0	0
11	25064623	.	C	G	4	9	13	0	1	14	0	0
11	25129232	.	C	G	29	0	29	0	22	51	0	0
11	25132510	.	T	C	40	29	69	0	1	70	0	0
11	25138485	.	A	C	32	29	61	0	4	65	0	0
11	25138656	.	T	C	30	36	66	0	4	70	0	0
11	25138673	.	T	A	25	41	66	0	1	67	0	0
11	25138845	.	C	T	32	35	67	0	2	69	0	0
11	25169704	.	T	C	1	2	3	0	0	3	0	0
11	25178862	.	C	T	7	6	13	0	0	13	0	0
11	25178865	.	T	A	5	5	10	0	2	12	0	0
11	25179014	.	C	T	6	5	11	0	3	14	0	0
11	25179057	.	A	C	5	5	10	0	0	10	0	0
11	25179069	.	A	G	3	4	7	0	0	7	0	0
11	25179099	.	C	T	5	3	8	0	1	9	0	0
11	25179430	.	T	A	2	2	4	0	0	4	0	0
11	25179641	.	C	T	13	10	23	0	0	23	0	0
11	25179659	.	A	T	9	9	18	0	1	19	0	0
11	25180225	.	C	T	7	9	16	0	1	17	0	0
11	25180243	.	A	G	9	7	16	0	0	16	0	0
11	25260136	.	G	T	3	3	6	0	1	7	0	0
11	25260142	.	T	G	4	5	9	0	0	9	0	0
11	25260206	.	T	A	6	8	14	0	1	15	0	0
11	25261665	.	C	T	7	4	11	0	0	11	0	0
11	25261753	.	G	A	0	10	10	0	8	18	0	0
11	25265867	.	A	T	9	11	20	0	1	22	1	0
11	25265980	.	A	G	6	15	21	0	0	21	0	0
11	25291227	.	C	A	1	1	2	0	0	2	0	0
11	25291236	.	C	T	0	2	2	0	1	3	0	0
11	25302183	.	C	T	4	3	7	0	0	7	0	0
11	25303887	.	T	C	2	5	7	0	0	7	0	0
11	25306433	.	T	C	4	3	7	0	0	7	0	0
11	25306445	.	G	A	5	3	8	0	0	8	0	0
11	25307009	.	C	T	7	10	17	0	2	19	0	0
11	25307234	.	G	A	7	12	19	0	0	19	0	0
11	25310859	.	A	T	9	11	20	0	3	23	0	0
11	25311091	.	T	C	18	2	20	0	2	22	0	0
11	25311276	.	A	G	14	8	22	0	1	23	0	0
11	25315658	.	T	C	6	5	11	0	0	11	0	0
11	25315701	.	T	A	10	8	18	0	0	18	0	0
11	25315762	.	A	C	4	8	12	0	1	13	0	0
11	25315828	.	A	G	5	4	9	0	1	10	0	0
11	25315894	.	G	A	8	4	12	0	1	13	0	0
11	25316150	.	G	A	4	4	8	0	0	8	0	0
11	25316216	.	T	C	5	5	10	0	0	10	0	0
11	25316963	.	G	T	1	3	4	0	0	4	0	0
11	25317676	.	T	C	1	5	6	0	0	6	0	0
11	25383350	.	C	G	3	5	8	0	1	9	0	0
11	25384098	.	C	T	1	2	3	0	0	3	0	0
11	25406343	.	A	G	5	2	7	0	0	7	0	0
11	25407014	.	G	A	4	3	7	0	0	7	0	0
11	25407380	.	C	T	3	9	12	0	0	12	0	0
11	25407626	.	T	C	6	7	13	0	0	13	0	0
11	25407987	.	A	T	5	11	16	0	0	16	0	0
11	25408022	.	G	T	12	9	21	0	2	23	0	0
11	25408139	.	C	T	14	8	22	0	0	22	0	0
11	25408283	.	C	G	15	7	22	0	0	22	0	0
11	25408352	.	T	C	7	8	15	0	2	17	0	0
11	25436686	.	C	A	3	12	15	0	0	15	0	0
11	25437501	.	C	T	7	14	21	3	7	31	0	0
11	25441009	.	G	A	2	5	7	0	0	7	0	0
11	25487521	.	T	C	1	3	4	0	1	5	0	0
11	25499577	.	A	C	11	4	15	0	0	15	0	0
11	25500587	.	C	T	5	14	19	0	0	19	0	0
11	25500843	.	A	G	8	0	8	0	6	14	0	0
11	25501962	.	C	T	6	10	16	0	1	17	0	0
11	25502058	.	C	T	7	16	23	0	0	23	0	0
11	25502319	.	T	C	10	10	20	0	1	21	0	0
11	25502350	.	A	T	5	5	10	0	1	11	0	0
11	25502382	.	C	T	4	4	8	0	0	8	0	0
11	25502395	.	T	G	3	4	7	0	0	7	0	0
11	25542320	.	A	T	2	2	4	0	2	6	0	0
11	25542399	.	G	A	4	6	10	0	0	10	0	0
11	25548172	.	G	A	3	7	10	0	0	10	0	0
11	25548190	.	C	T	2	4	6	0	0	6	0	0
11	25548305	.	A	C	4	3	7	0	0	7	0	0
11	25549953	.	C	G	9	10	19	0	0	19	0	0
11	25550770	.	C	G	4	5	9	0	0	9	0	0
11	25564003	.	C	T	2	3	5	0	0	5	0	0
11	25572090	.	G	A	1	3	4	0	1	5	0	0
11	25572627	.	T	G	4	0	4	0	9	13	0	0
11	25573888	.	T	A	6	9	15	0	0	15	0	0
11	25573921	.	T	A	5	4	9	0	0	9	0	0
11	25575100	.	T	C	7	8	15	0	1	16	0	0
11	25575139	.	A	G	8	8	16	0	2	18	0	0
11	25575365	.	C	T	6	5	11	0	0	11	0	0
11	25575725	.	A	T	10	10	20	0	1	21	0	0
11	25575872	.	A	G	12	1	13	0	9	22	0	0
11	25612719	.	A	G	2	0	2	0	4	6	0	0
11	25612824	.	C	T	4	3	7	0	0	7	0	0
11	25615943	.	T	G	4	2	6	0	0	6	0	0
11	25616642	.	T	C	3	5	8	0	0	8	0	0
11	25616679	.	T	A	4	6	10	0	1	11	0	0
11	25616691	.	A	G	6	0	6	0	5	11	0	0
11	25616719	.	G	A	2	3	5	0	3	8	0	0
11	25616947	.	G	T	1	6	7	0	0	7	0	0
11	25617023	.	T	A	6	4	10	0	0	10	0	0
11	25617027	.	C	A	6	4	10	0	0	10	0	0
11	25617096	.	T	C	3	4	7	0	0	7	0	0
11	25617118	.	A	G	2	5	7	0	1	8	0	0
11	25617192	.	T	A	4	3	7	0	0	7	0	0
11	25617378	.	T	A	5	3	8	1	0	9	0	0
11	25617433	.	A	C	13	4	17	0	0	17	0	0
11	25617437	.	T	C	11	4	15	0	2	17	0	0
11	25617900	.	C	T	1	9	10	0	0	10	0	0
11	25617944	.	A	G	11	4	15	0	1	16	0	0
11	25618037	.	T	C	10	4	14	0	0	14	0	0
11	25618094	.	G	A	0	5	5	0	9	14	0	0
11	25618127	.	T	C	9	10	19	0	0	19	0	0
11	25618218	.	C	T	6	10	16	0	1	17	0	0
11	25618297	.	A	C	4	3	7	0	0	7	0	0
11	25630391	.	G	A	1	2	3	0	0	3	0	0
11	25630660	.	C	T	3	3	6	0	0	6	0	0
11	25630852	.	C	G	4	4	8	0	0	8	0	0
11	25671502	.	A	G	3	3	6	0	0	6	0	0
11	25671523	.	C	T	2	4	6	0	0	6	0	0
11	25675599	.	A	G	0	2	2	0	2	4	0	0
11	25678397	.	T	C	4	4	8	0	1	9	0	0
11	25678596	.	T	A	4	2	6	0	1	7	0	0
11	25678670	.	C	T	3	4	7	0	0	7	0	0
11	25678870	.	A	G	3	2	5	0	0	5	0	0
11	25679010	.	A	T	3	4	7	0	0	7	0	0
11	25681439	.	T	C	3	3	6	0	0	6	0	0
11	25681659	.	G	A	0	2	2	0	6	8	0	0
11	25681677	.	G	A	0	2	2	0	4	6	0	0
11	25681855	.	A	T	1	2	3	0	0	3	0	0
11	25681863	.	C	T	1	2	3	0	0	3	0	0
11	25684562	.	C	A	5	3	8	0	0	8	0	0
11	25689209	.	T	G	12	0	12	0	11	23	0	0
11	25689551	.	T	C	8	6	14	0	0	14	0	0
11	25698866	.	T	C	3	2	5	0	0	5	0	0
11	25698869	.	G	C	2	2	4	0	2	6	0	0
11	25698917	.	C	T	1	2	3	0	0	3	0	0
11	25699346	.	C	T	2	6	8	0	0	8	0	0
11	25699406	.	G	A	1	2	3	0	2	5	0	0
11	25707869	.	G	T	0	5	5	0	7	12	0	0
11	25708008	.	A	G	7	2	9	0	1	10	0	0
11	25708678	.	G	C	3	4	7	0	0	7	0	0
11	25712952	.	T	G	6	4	10	0	1	11	0	0
11	25713028	.	A	G	1	2	3	0	0	3	0	0
11	25713340	.	T	G	2	4	6	0	0	6	0	0
11	25714148	.	G	A	3	2	5	0	0	5	0	0
11	25714425	.	G	T	1	3	4	0	1	5	0	0
11	25718054	.	C	T	0	6	6	0	3	9	0	0
11	25718179	.	C	T	4	3	7	0	0	7	0	0
11	25718438	.	T	G	2	3	5	0	1	6	0	0
11	25723425	.	C	T	0	3	3	0	2	5	0	0
11	25723434	.	G	A	2	4	6	0	0	6	0	0
11	25743158	.	C	T	1	4	5	0	0	5	0	0
11	25743414	.	G	A	6	4	10	0	0	10	0	0
11	25743465	.	G	A	0	5	5	0	7	12	0	0
11	25743531	.	G	A	1	5	6	0	9	15	0	0
11	25748876	.	A	G	7	8	15	0	0	15	0	0
11	25749736	.	G	A	22	11	33	0	0	33	0	0
11	25783353	.	T	A	7	3	10	0	0	10	0	0
11	25783432	.	G	A	7	5	12	0	0	12	0	0
11	25783435	.	T	G	7	5	12	0	0	12	0	0
11	25783704	.	C	T	10	9	19	0	1	20	0	0
11	25789211	.	C	G	1	4	5	0	0	5	0	0
11	25789218	.	A	G	1	5	6	0	0	6	0	0
11	25866443	.	A	T	5	4	9	0	0	9	0	0
11	25868801	.	C	T	3	3	6	0	0	6	0	0
11	25871408	.	G	A	4	2	6	0	0	6	0	0
11	25887514	.	G	A	4	6	10	0	0	10	0	0
11	25894003	.	T	C	4	4	8	0	2	10	0	0
11	25944661	.	A	C	1	2	3	0	0	3	0	0
11	26190763	.	C	T	8	7	15	0	0	15	0	0
11	26190876	.	C	A	3	4	7	0	0	7	0	0
11	26191029	.	G	A	5	3	8	0	1	9	0	0
11	26191478	.	T	A	6	5	11	0	1	12	0	0
11	26229093	.	G	A	22	14	36	0	2	38	0	0
11	26229464	.	C	A	21	17	38	0	2	40	0	0
11	26229801	.	G	A	17	12	29	0	0	29	0	0
11	26229900	.	C	T	1	17	18	0	15	33	0	0
11	26230302	.	G	A	10	8	18	0	1	19	0	0
11	26230425	.	G	C	7	12	19	0	3	22	0	0
11	26230756	.	T	G	1	4	5	0	0	5	0	0
11	26230774	.	T	A	3	4	7	0	0	7	0	0
11	26230847	.	C	T	5	6	11	2	0	13	0	0
11	26231804	.	T	C	5	10	15	0	2	17	0	0
11	26231890	.	G	A	4	4	8	0	1	9	0	0
11	26231971	.	T	C	2	4	6	0	0	6	0	0
11	26367201	.	C	T	3	3	6	0	1	7	0	0
11	26370720	.	A	T	2	3	5	0	0	5	0	0
11	26372296	.	C	T	0	11	11	0	5	16	0	0
11	26374063	.	G	A	1	2	3	0	0	3	0	0
11	26376034	.	G	T	1	2	3	0	0	3	0	0
11	26381908	.	G	A	2	3	5	0	2	7	0	0
11	26382551	.	A	G	3	0	3	0	4	7	0	0
11	26382578	.	T	A	5	3	8	0	0	8	0	0
11	26391453	.	A	G	2	2	4	0	0	4	0	0
11	26396076	.	G	A	1	4	5	0	3	8	0	0
11	26396408	.	T	C	2	6	8	0	0	8	0	0
11	26397833	.	A	G	10	0	10	0	12	22	0	0
11	26398012	.	T	C	5	8	13	0	0	13	0	0
11	26398057	.	T	A	4	7	11	0	0	11	0	0
11	26400503	.	G	A	6	9	15	0	0	15	0	0
11	26400782	.	G	C	1	2	3	0	0	3	0	0
11	26400796	.	C	T	3	3	6	0	0	6	0	0
11	26400817	.	G	T	6	5	11	0	0	11	0	0
11	26401146	.	C	A	2	2	4	0	1	5	0	0
11	26401407	.	C	T	15	9	24	1	0	25	0	0
11	26614552	.	G	C	5	25	30	0	34	64	0	0
11	26614615	.	T	A	29	24	53	0	2	55	0	0
11	26614713	.	C	A	28	8	36	0	1	37	0	0
11	26614718	.	G	A	1	5	6	0	27	33	0	0
11	26614755	.	C	A	20	6	26	0	0	26	0	0
11	26614910	.	C	T	31	16	47	0	2	49	0	0
11	26615201	.	A	G	21	29	50	0	3	53	0	0
11	26615294	.	G	A	29	9	38	0	2	40	0	0
11	26615425	.	T	C	14	27	41	0	1	42	0	0
11	26615525	.	A	C	3	3	6	0	0	6	0	0
11	26683200	.	C	A	8	5	13	0	0	13	0	0
11	26683692	.	A	T	2	4	6	0	0	6	0	0
11	26704347	.	C	A	4	20	24	0	24	48	0	0
11	26705105	.	T	C	9	6	15	0	2	17	0	0
11	26705111	.	G	A	12	6	18	0	1	19	0	0
11	26705196	.	C	T	14	14	28	0	0	28	0	0
11	26705540	.	G	A	5	6	11	0	0	11	0	0
11	26705851	.	C	A	1	9	10	0	6	16	0	0
11	26705898	.	T	C	9	6	15	0	0	15	0	0
11	26706124	.	A	T	5	4	9	0	1	10	0	0
11	26706522	.	A	G	6	14	20	0	1	21	0	0
11	26706572	.	C	T	0	6	6	0	9	15	0	0
11	26707367	.	C	A	1	5	6	0	15	21	0	0
11	26707634	.	A	G	3	11	14	0	2	16	0	0
11	26707679	.	G	A	3	9	12	0	0	12	0	0
11	26707733	.	A	G	7	7	14	0	0	14	0	0
11	26714379	.	C	T	3	3	6	0	1	7	0	0
11	27486692	.	A	T	7	8	15	0	0	15	0	0
11	27486825	.	C	T	8	12	20	0	1	21	0	0
11	27487689	.	T	C	9	3	12	0	0	12	0	0
11	27488158	.	C	T	6	4	10	0	0	10	0	0
11	27495512	.	G	A	1	2	3	0	0	3	0	0
11	27511470	.	C	A	2	1	3	0	1	4	0	0
11	27516861	.	C	T	0	2	2	0	4	6	0	0
11	27517157	.	G	A	1	3	4	0	0	4	0	0
11	27645617	.	T	G	16	6	22	0	1	23	0	0
11	27645740	.	A	T	4	4	8	0	1	9	0	0
11	27645935	.	C	T	3	4	7	0	0	7	0	0
11	27646063	.	T	A	6	3	9	0	2	11	0	0
11	27646681	.	C	T	7	7	14	0	0	14	0	0
11	27649454	.	G	A	8	8	16	0	2	18	0	0
11	27649527	.	G	A	9	9	18	0	2	20	0	0
11	27652623	.	C	T	0	6	6	0	5	11	0	0
11	27652641	.	G	A	6	8	14	0	0	14	0	0
11	27655855	.	T	A	4	8	12	0	0	12	0	0
11	27661241	.	C	T	1	4	5	0	3	8	0	0
11	27668314	.	A	G	1	3	4	0	0	4	0	0
11	27669744	.	G	C	1	3	4	0	0	4	0	0
11	27671163	.	C	T	4	2	6	0	0	6	0	0
11	27671251	.	G	A	3	3	6	0	1	7	0	0
11	27677815	.	C	T	0	2	2	0	1	3	0	0
11	27705165	.	G	A	10	10	20	0	1	21	0	0
11	27705219	.	G	T	7	20	27	0	3	30	0	0
11	27705308	.	G	A	19	12	31	0	0	31	0	0
11	27705660	.	C	A	6	4	10	0	1	11	0	0
11	27705762	.	C	T	7	3	10	0	0	10	0	0
11	27705960	.	G	A	7	12	19	0	0	19	0	0
11	27706060	.	G	A	9	5	14	0	0	14	0	0
11	27706308	.	G	A	3	1	4	0	1	5	0	0
11	27706434	.	T	A	3	4	7	0	1	8	0	0
11	27706741	.	T	A	6	4	10	0	0	10	0	0
11	27706742	.	A	C	6	4	10	0	0	10	0	0
11	27708665	.	A	C	4	4	8	0	0	8	0	0
11	27710381	.	G	T	5	2	7	0	0	7	0	0
11	27713556	.	G	T	2	2	4	0	1	5	0	0
11	27713663	.	C	T	2	3	5	0	0	5	0	0
11	27743780	.	C	T	3	2	5	0	0	5	0	0
11	27744111	.	A	G	2	2	4	0	0	4	0	0
11	27817486	.	C	T	3	3	6	0	0	6	0	0
11	27817948	.	C	T	1	3	4	0	4	8	0	0
11	27817986	.	C	T	3	5	8	0	0	8	0	0
11	27818117	.	A	G	4	3	7	0	0	7	0	0
11	27818188	.	G	C	4	12	16	0	1	17	0	0
11	27818236	.	A	C	17	6	23	0	0	23	0	0
11	27818722	.	T	C	12	14	26	0	1	27	0	0
11	27820431	.	T	G	3	5	8	0	0	8	0	0
11	27828919	.	A	T	10	14	24	0	1	25	0	0
11	27828950	.	T	A	22	12	34	0	0	34	0	0
11	27829089	.	C	T	0	17	17	0	24	41	0	0
11	27829157	.	T	C	25	10	35	0	1	36	0	0
11	27829201	.	A	G	24	18	42	0	0	42	0	0
11	27829222	.	C	T	2	19	21	0	20	41	0	0
11	27829264	.	G	A	12	19	31	0	2	33	0	0
11	27829555	.	G	A	3	8	11	0	1	12	0	0
11	27829700	.	T	C	17	1	18	0	12	30	0	0
11	27829772	.	G	A	9	12	21	0	1	22	0	0
11	27829928	.	G	A	10	10	20	0	1	21	0	0
11	27835073	.	T	C	7	12	19	0	0	19	0	0
11	27836045	.	T	C	5	8	13	0	1	14	0	0
11	27838670	.	C	T	8	6	14	0	1	15	0	0
11	27842815	.	G	A	9	4	13	0	0	13	0	0
11	27843024	.	A	G	7	8	15	0	0	15	0	0
11	27847409	.	C	T	11	4	15	0	0	15	0	0
11	28123099	.	C	T	3	2	5	0	0	5	0	0
11	28123139	.	T	G	2	2	4	0	0	4	0	0
11	28123141	.	C	T	3	2	5	0	0	5	0	0
11	28123585	.	T	C	1	2	3	0	0	3	0	0
11	28123627	.	C	T	1	2	3	0	0	3	0	0
11	28125578	.	A	T	5	3	8	0	0	8	0	0
11	28419753	.	C	T	1	2	3	0	0	3	0	0
11	28422160	.	A	C	3	6	9	0	0	9	0	0
11	28422263	.	T	C	5	5	10	0	1	11	0	0
11	28422662	.	C	A	9	8	17	0	0	17	0	0
11	28422836	.	G	T	0	6	6	0	9	15	0	0
11	28422854	.	G	A	0	5	5	0	9	14	0	0
11	28422929	.	T	G	7	0	7	0	8	15	0	0
11	28423061	.	C	T	6	8	14	0	1	15	0	0
11	28423064	.	T	A	5	9	14	0	2	16	0	0
11	28423147	.	T	A	4	8	12	0	1	13	0	0
11	28423457	.	T	C	15	11	26	0	0	26	0	0
11	28423497	.	G	T	15	12	27	0	2	29	0	0
11	28424012	.	C	T	10	13	23	0	5	28	0	0
11	28477338	.	T	C	1	2	3	0	0	3	0	0
11	28514357	.	T	G	2	0	2	0	2	4	0	0
11	28514362	.	G	A	2	2	4	0	0	4	0	0
11	28614120	.	C	T	0	2	2	0	2	4	0	0
11	28631268	.	A	G	1	3	4	0	0	4	0	0
11	28643064	.	G	T	26	32	58	0	0	58	0	0
11	28643155	.	G	A	28	20	48	0	1	49	0	0
11	28643281	.	A	T	19	30	49	0	3	52	0	0
11	28643890	.	G	C	20	20	40	0	1	41	0	0
11	28644087	.	A	C	17	30	47	0	3	50	0	0
11	28644110	.	T	C	19	0	19	0	24	43	0	0
11	28789260	.	C	T	4	4	8	0	0	8	0	0
11	28911158	.	T	C	2	4	6	0	0	6	0	0
11	29331516	.	T	C	3	4	7	0	0	7	0	0
11	29331915	.	T	A	4	6	10	0	1	11	0	0
11	29332454	.	C	A	2	6	8	0	2	10	0	0
11	29551879	.	C	A	3	3	6	0	0	6	0	0
11	29575177	.	T	A	20	16	36	0	4	40	0	0
11	29575429	.	G	T	23	20	43	0	0	43	0	0
11	29575527	.	C	T	23	13	36	0	5	41	0	0
11	29575736	.	C	A	18	16	34	0	3	37	0	0
11	29575897	.	C	T	15	15	30	0	0	30	0	0
11	29575964	.	G	A	7	8	15	0	0	15	0	0
11	29576408	.	C	T	3	2	5	0	0	5	0	0
11	29576409	.	C	A	3	2	5	0	0	5	0	0
11	29577230	.	C	T	20	5	25	0	2	27	0	0
11	29577651	.	A	T	9	6	15	0	1	16	0	0
11	29577890	.	G	A	1	7	8	0	0	8	0	0
11	29577927	.	T	G	2	6	8	0	2	10	0	0
11	29578091	.	C	T	9	6	15	0	2	17	0	0
11	29578217	.	G	T	7	4	11	0	1	12	0	0
11	29584517	.	G	A	5	3	8	0	0	8	0	0
11	29587963	.	C	T	8	6	14	0	0	14	0	0
11	29588525	.	G	A	6	7	13	0	0	13	0	0
11	29589186	.	T	A	4	5	9	0	0	9	0	0
11	29589199	.	T	C	6	4	10	0	2	12	0	0
11	29589502	.	A	G	3	7	10	0	1	11	0	0
11	29589512	.	T	G	6	4	10	0	0	10	0	0
11	29589578	.	T	C	2	0	2	0	3	5	0	0
11	29589602	.	T	A	2	3	5	0	0	5	0	0
11	29652547	.	A	G	2	2	4	0	0	4	0	0
11	29652586	.	C	A	2	3	5	0	0	5	0	0
11	29652838	.	T	C	25	29	54	1	2	57	0	0
11	29655418	.	C	T	35	26	61	0	5	66	0	0
11	29685328	.	C	T	3	2	5	0	0	5	0	0
11	29757636	.	A	C	8	14	22	0	1	23	0	0
11	29760548	.	C	T	0	6	6	0	11	17	0	0
11	29760659	.	A	G	8	9	17	0	1	18	0	0
11	29760674	.	A	G	7	11	18	0	0	18	0	0
11	29764554	.	A	G	9	8	17	0	1	18	0	0
11	29781081	.	G	T	0	4	4	0	1	5	0	0
11	29781082	.	T	C	1	4	5	0	0	5	0	0
11	29783880	.	C	A	2	3	5	0	0	5	0	0
11	29785019	.	C	T	2	2	4	0	0	4	0	0
11	29785844	.	C	G	3	2	5	0	0	5	0	0
11	29785942	.	C	G	1	4	5	0	0	5	0	0
11	29786398	.	G	A	1	3	4	0	0	4	0	0
11	29786401	.	T	C	2	3	5	0	0	5	0	0
11	29788042	.	G	A	9	9	18	0	0	18	0	0
11	29789405	.	A	C	6	8	14	0	2	16	0	0
11	29791911	.	C	A	17	22	39	0	2	41	0	0
11	29793547	.	T	C	26	23	49	0	2	51	0	0
11	29793553	.	T	C	27	23	50	0	2	52	0	0
11	29793694	.	A	C	13	9	22	0	0	22	0	0
11	29793726	.	C	A	14	11	25	0	0	25	0	0
11	29794009	.	A	G	17	21	38	0	2	40	0	0
11	29795893	.	A	C	2	2	4	0	0	4	0	0
11	29796270	.	A	C	7	0	7	0	9	16	0	0
11	29796512	.	A	C	3	0	3	0	2	5	0	0
11	29876974	.	C	A	2	2	4	0	0	4	0	0
11	29877077	.	A	G	1	2	3	0	0	3	0	0
11	29917814	.	G	T	6	2	8	0	0	8	0	0
11	29918069	.	T	C	3	6	9	0	1	10	0	0
11	29918070	.	T	C	3	8	11	0	0	11	0	0
11	29918294	.	G	T	7	6	13	0	0	13	0	0
11	29918306	.	A	G	6	6	12	0	0	12	0	0
11	30086845	.	A	C	2	2	4	0	0	4	0	0
11	30087429	.	G	A	3	5	8	0	3	11	0	0
11	30087756	.	A	T	4	3	7	0	0	7	0	0
11	30087885	.	C	T	6	3	9	0	0	9	0	0
11	30088392	.	A	T	7	9	16	0	1	17	0	0
11	30088427	.	G	A	6	4	10	0	0	10	0	0
11	30088506	.	C	T	4	2	6	0	3	9	0	0
11	30088560	.	G	T	8	5	13	0	0	13	0	0
11	30089649	.	A	G	19	10	29	0	0	29	0	0
11	30089671	.	G	A	15	10	25	0	2	27	0	0
11	30106429	.	C	T	1	3	4	0	0	4	0	0
11	30106790	.	A	C	3	2	5	0	1	6	0	0
11	30107299	.	T	G	6	3	9	0	0	9	0	0
11	30107366	.	A	G	7	10	17	0	0	17	0	0
11	30107405	.	T	C	6	6	12	0	1	13	0	0
11	30107417	.	C	T	6	4	10	0	0	10	0	0
11	30113047	.	C	T	0	2	2	0	4	6	0	0
11	30118970	.	A	G	3	5	8	0	0	8	0	0
11	30122741	.	G	A	1	3	4	0	0	4	0	0
11	30219477	.	G	A	1	6	7	0	5	12	0	0
11	30221173	.	A	G	10	0	10	0	11	21	0	0
11	30221188	.	A	G	8	8	16	0	1	17	0	0
11	30222942	.	G	A	9	7	16	0	2	18	0	0
11	30231104	.	C	T	13	17	30	0	1	31	0	0
11	30231269	.	A	G	22	16	38	0	4	42	0	0
11	30231416	.	T	A	15	10	25	0	5	30	0	0
11	30251411	.	G	A	1	2	3	0	1	4	0	0
11	30251529	.	A	T	1	2	3	0	0	3	0	0
11	30251551	.	T	C	1	2	3	0	0	3	0	0
11	30251912	.	A	G	3	4	7	0	1	8	0	0
11	30367024	.	T	A	5	2	7	0	1	8	0	0
11	30367029	.	C	A	2	2	4	0	1	5	0	0
11	30642164	.	A	G	8	5	13	0	0	13	0	0
11	31024887	.	A	G	3	6	9	0	1	10	0	0
11	33539693	.	T	C	2	2	4	0	0	4	0	0
11	33545056	.	A	T	1	4	5	0	0	5	0	0
11	33551200	.	T	C	2	5	7	0	0	7	0	0
11	33553873	.	T	C	7	11	18	0	1	19	0	0
11	33554087	.	G	A	3	4	7	0	0	7	0	0
11	33554116	.	G	A	6	4	10	0	0	10	0	0
11	33554535	.	T	C	10	6	16	0	1	17	0	0
11	33598663	.	T	A	3	3	6	0	0	6	0	0
11	33599038	.	T	C	6	9	15	0	2	17	0	0
11	33599148	.	T	C	7	14	21	0	0	21	0	0
11	33599187	.	T	C	12	0	12	0	11	23	0	0
11	33599223	.	A	G	17	10	27	0	2	29	0	0
11	33599240	.	A	T	17	10	27	0	1	28	0	0
11	33599464	.	C	T	1	7	8	0	9	17	0	0
11	33599900	.	C	T	0	2	2	0	2	4	0	0
11	33600015	.	G	A	3	2	5	0	1	6	0	0
11	33600125	.	A	G	4	3	7	0	2	9	0	0
11	33600572	.	T	A	2	2	4	0	0	4	0	0
11	33600646	.	T	C	2	0	2	0	2	4	0	0
11	33600862	.	G	A	3	2	5	0	0	5	0	0
11	33827023	.	G	A	2	3	5	0	0	5	0	0
11	33829443	.	A	G	2	6	8	0	0	8	0	0
11	33829515	.	A	G	4	6	10	0	2	12	0	0
11	33834700	.	A	G	4	15	19	0	2	21	0	0
11	33835385	.	C	A	7	8	15	0	0	15	0	0
11	33835542	.	T	C	7	5	12	0	0	12	0	0
11	33839169	.	C	T	11	8	19	0	0	19	0	0
11	33841788	.	C	T	12	14	26	0	1	27	0	0
11	33841984	.	C	T	9	8	17	0	3	20	0	0
11	33842542	.	C	T	5	7	12	0	0	12	0	0
11	33846519	.	T	C	13	8	21	0	2	23	0	0
11	33846566	.	T	C	4	12	16	0	0	16	0	0
11	33846577	.	T	C	7	4	11	0	2	13	0	0
11	33846657	.	G	A	1	3	4	0	0	4	0	0
11	33847080	.	T	G	2	3	5	0	0	5	0	0
11	33847123	.	C	T	1	3	4	0	0	4	0	0
11	33870434	.	A	G	2	2	4	0	0	4	0	0
11	33870464	.	A	T	4	5	9	0	1	10	0	0
11	33871043	.	T	G	2	2	4	0	0	5	1	0
11	33871099	.	G	A	1	2	3	0	1	4	0	0
11	33871343	.	G	T	10	5	15	0	0	15	0	0
11	33871378	.	G	T	15	7	22	0	0	22	0	0
11	33871466	.	A	G	19	10	29	0	1	30	0	0
11	33871575	.	A	G	15	13	28	0	0	28	0	0
11	33871897	.	C	T	14	4	18	1	5	24	0	0
11	33871931	.	G	C	19	3	22	1	0	23	0	0
11	33871932	.	C	A	16	3	19	1	3	23	0	0
11	33872289	.	T	C	14	0	14	0	8	22	0	0
11	33872411	.	A	C	7	5	12	0	1	13	0	0
11	33872442	.	A	G	7	3	10	0	0	10	0	0
11	33872564	.	G	T	11	6	17	0	1	18	0	0
11	33872661	.	A	G	10	4	14	1	2	17	0	0
11	33872684	.	C	T	11	5	16	0	0	16	0	0
11	33872699	.	A	G	7	5	12	0	2	14	0	0
11	33872759	.	A	G	4	5	9	0	1	10	0	0
11	33872763	.	A	C	3	5	8	0	0	8	0	0
11	33872829	.	C	T	0	4	4	0	8	12	0	0
11	33873539	.	C	T	0	4	4	0	4	8	0	0
11	33873578	.	A	C	5	7	12	0	1	13	0	0
11	33921533	.	A	T	1	3	4	0	0	4	0	0
11	33921537	.	A	T	1	2	3	0	0	3	0	0
11	34220083	.	G	A	2	2	4	0	0	4	0	0
11	34220129	.	C	T	5	3	8	0	0	8	0	0
11	34220436	.	T	C	2	0	2	0	9	11	0	0
11	34235427	.	C	A	3	12	15	0	0	15	0	0
11	34235498	.	C	G	1	3	4	0	0	4	0	0
11	34235825	.	A	T	3	6	9	0	1	10	0	0
11	34235858	.	A	C	9	8	17	0	0	17	0	0
11	34235918	.	A	G	13	0	13	0	10	23	0	0
11	34236092	.	G	T	11	6	17	0	1	18	0	0
11	34237150	.	C	T	1	5	6	0	0	6	0	0
11	34237217	.	A	G	5	10	15	0	2	17	0	0
11	34249644	.	G	A	1	2	3	0	0	3	0	0
11	34489227	.	G	A	2	2	4	0	0	4	0	0
11	34910585	.	A	G	3	1	4	0	3	7	0	0
11	34910601	.	A	G	1	1	2	0	3	5	0	0
11	34911094	.	A	G	2	5	7	0	1	8	0	0
11	34911103	.	C	T	0	6	6	0	0	6	0	0
11	34911229	.	G	A	3	10	13	1	1	15	0	0
11	35440173	.	T	A	5	3	8	0	1	9	0	0
11	35759755	.	T	A	8	3	11	0	1	12	0	0
11	36208199	.	G	A	2	3	5	0	1	6	0	0
11	36208328	.	G	A	0	4	4	0	1	5	0	0
11	36214517	.	C	T	14	14	28	0	1	29	0	0
11	36214815	.	G	A	0	9	9	0	17	26	0	0
11	36214859	.	C	T	8	15	23	0	1	24	0	0
11	36214955	.	A	T	12	11	23	0	2	25	0	0
11	36215346	.	G	A	12	14	26	0	1	27	0	0
11	36215399	.	A	G	19	13	32	0	2	34	0	0
11	36215906	.	C	T	1	2	3	0	0	3	0	0
11	36254334	.	C	T	1	2	3	0	0	3	0	0
11	36269768	.	A	G	3	4	7	0	0	7	0	0
11	36269788	.	A	G	3	4	7	0	0	7	0	0
11	36281814	.	G	A	0	14	14	0	1	15	0	0
11	36281939	.	T	G	3	12	15	0	2	17	0	0
11	36282259	.	A	T	15	4	19	0	0	19	0	0
11	36282417	.	G	T	9	5	14	0	0	14	0	0
11	36282450	.	G	T	12	3	15	0	0	15	0	0
11	36282494	.	G	T	7	2	9	0	1	10	0	0
11	36282501	.	C	T	8	2	10	0	0	10	0	0
11	36282631	.	T	C	3	5	8	0	0	8	0	0
11	36282961	.	G	A	3	2	5	1	1	7	0	0
11	36283728	.	A	G	6	4	10	0	0	10	0	0
11	36343167	.	G	C	16	21	37	0	1	38	0	0
11	36343339	.	A	T	13	13	26	0	2	28	0	0
11	36346578	.	A	T	2	8	10	0	2	12	0	0
11	36373200	.	C	T	1	3	4	0	0	4	0	0
11	36374897	.	T	C	2	2	4	0	0	4	0	0
11	36374944	.	T	G	3	2	5	0	0	5	0	0
11	36374958	.	T	C	5	2	7	0	0	7	0	0
11	36374993	.	G	T	5	3	8	0	0	8	0	0
11	36375028	.	A	G	3	0	3	0	6	9	0	0
11	36375293	.	G	A	2	3	5	1	0	6	0	0
11	36375367	.	T	C	2	4	6	0	0	6	0	0
11	36375671	.	C	T	6	6	12	0	1	13	0	0
11	36375708	.	A	G	11	12	23	0	0	23	0	0
11	36375774	.	A	T	7	6	13	0	1	14	0	0
11	36375852	.	T	G	7	9	16	0	1	17	0	0
11	36393111	.	A	G	7	0	7	0	3	10	0	0
11	36395136	.	A	T	1	5	6	0	1	7	0	0
11	36395728	.	T	C	6	4	10	0	0	10	0	0
11	36398192	.	G	A	1	2	3	0	6	9	0	0
11	36398318	.	A	G	8	5	13	0	1	14	0	0
11	36398531	.	A	G	5	0	5	0	7	12	0	0
11	36398558	.	T	A	7	4	11	0	2	13	0	0
11	36398624	.	C	T	4	6	10	0	5	15	0	0
11	36422295	.	G	T	3	2	5	0	0	5	0	0
11	36422342	.	C	G	3	3	6	0	0	6	0	0
11	36422351	.	G	A	3	3	6	0	0	6	0	0
11	36429500	.	T	C	2	3	5	0	0	5	0	0
11	36452372	.	G	A	5	8	13	0	0	13	0	0
11	36452453	.	C	A	4	7	11	0	0	11	0	0
11	36452534	.	C	A	4	3	7	0	0	7	0	0
11	36452688	.	A	G	13	5	18	0	0	18	0	0
11	36456011	.	C	T	0	3	3	0	4	7	0	0
11	36456056	.	T	C	6	3	9	0	1	10	0	0
11	36456058	.	T	G	5	4	9	0	1	10	0	0
11	36456101	.	T	A	6	7	13	0	0	13	0	0
11	36456125	.	A	C	6	0	6	0	7	13	0	0
11	36460829	.	G	A	8	9	17	0	0	17	0	0
11	36460988	.	A	G	5	5	10	0	0	10	0	0
11	36463965	.	T	C	4	5	9	0	0	9	0	0
11	36464376	.	G	T	4	3	7	0	0	7	0	0
11	36464396	.	T	C	1	0	1	0	4	5	0	0
11	36467942	.	G	A	3	2	5	0	0	5	0	0
11	36467948	.	C	T	2	3	5	0	0	5	0	0
11	36470493	.	C	T	0	3	3	0	1	4	0	0
11	36473924	.	G	A	2	2	4	0	0	4	0	0
11	36477626	.	G	A	2	2	4	0	0	4	0	0
11	36477777	.	C	T	2	5	7	0	0	7	0	0
11	36484836	.	G	A	5	2	7	0	0	7	0	0
11	36485042	.	A	G	3	0	3	0	3	6	0	0
11	36489169	.	G	C	5	5	10	0	1	11	0	0
11	36489205	.	T	C	5	5	10	0	0	10	0	0
11	36489428	.	A	T	3	8	11	0	0	11	0	0
11	36489584	.	T	G	3	2	5	0	0	5	0	0
11	36489706	.	T	C	6	6	12	0	0	12	0	0
11	36689486	.	A	G	3	3	6	0	0	6	0	0
11	36788123	.	C	T	2	4	6	0	0	6	0	0
11	36793697	.	G	T	2	4	6	0	0	6	0	0
11	36795564	.	G	T	3	2	5	0	0	5	0	0
11	36806296	.	A	G	4	2	6	0	0	6	0	0
11	37015956	.	C	T	2	2	4	0	0	4	0	0
11	37015968	.	T	C	2	3	5	0	0	5	0	0
11	37032546	.	C	T	1	2	3	0	1	4	0	0
11	37032610	.	A	T	2	3	5	0	1	6	0	0
11	37032626	.	T	C	3	4	7	0	0	7	0	0
11	37032739	.	C	T	3	2	5	0	0	5	0	0
11	37032740	.	A	T	3	2	5	0	0	5	0	0
11	37033333	.	A	C	11	3	14	0	0	14	0	0
11	37033348	.	C	A	13	3	16	0	0	16	0	0
11	37033373	.	C	T	5	4	9	0	1	10	0	0
11	37033676	.	C	T	8	4	12	0	0	12	0	0
11	37033767	.	C	T	5	3	8	0	0	8	0	0
11	37033813	.	C	G	5	5	10	0	0	10	0	0
11	37033846	.	G	C	2	3	5	0	1	6	0	0
11	37033855	.	T	A	3	5	8	0	0	8	0	0
11	37034403	.	A	G	3	2	5	0	0	5	0	0
11	37035240	.	T	A	7	8	15	0	6	21	0	0
11	37035454	.	A	G	12	2	14	0	22	36	0	0
11	37101475	.	A	G	2	2	4	0	1	5	0	0
11	37101479	.	A	T	3	3	6	0	0	6	0	0
11	37101616	.	T	A	1	4	5	0	0	5	0	0
11	37159241	.	A	T	7	2	9	0	0	9	0	0
11	37159490	.	C	T	1	3	4	0	0	4	0	0
11	37159994	.	T	A	1	0	1	0	0	1	0	0
11	37162529	.	G	A	2	2	4	0	0	4	0	0
11	37163874	.	A	G	4	2	6	0	0	6	0	0
11	37164191	.	G	C	2	2	4	0	0	4	0	0
11	37167289	.	A	G	1	5	6	0	0	6	0	0
11	37167402	.	A	G	3	0	3	0	3	6	0	0
11	37167669	.	C	T	4	4	8	0	0	8	0	0
11	37167955	.	G	A	2	5	7	0	0	7	0	0
11	37168147	.	T	C	5	2	7	0	0	7	0	0
11	37168162	.	T	A	6	4	10	0	0	10	0	0
11	37169108	.	A	G	5	6	11	0	1	12	0	0
11	37169144	.	G	A	6	6	12	0	1	13	0	0
11	37169269	.	G	A	5	10	15	0	1	16	0	0
11	37170409	.	A	G	11	0	11	0	13	24	0	0
11	37274811	.	G	A	2	2	4	0	0	4	0	0
11	37274839	.	G	A	6	2	8	0	0	8	0	0
11	37297811	.	A	T	33	22	55	1	1	57	0	0
11	37297951	.	T	C	30	18	48	0	0	48	0	0
11	37298028	.	T	A	12	16	28	2	4	34	0	0
11	37298718	.	G	A	15	12	27	0	2	29	0	0
11	37298796	.	G	A	15	5	20	0	1	21	0	0
11	37431722	.	C	T	3	5	8	0	1	9	0	0
11	37431953	.	C	T	32	36	68	0	0	68	0	0
11	37441257	.	T	G	17	16	33	0	3	36	0	0
11	37442557	.	G	A	2	2	4	0	0	5	1	0
11	37442772	.	G	T	3	3	6	0	0	6	0	0
11	37445084	.	G	A	4	3	7	0	1	8	0	0
11	37446700	.	C	T	1	3	4	0	0	4	0	0
11	37613577	.	G	A	6	7	13	0	1	14	0	0
11	37628230	.	C	T	24	29	53	0	0	53	0	0
11	37628595	.	T	C	25	18	43	0	0	43	0	0
11	37628816	.	T	C	19	19	38	0	1	39	0	0
11	37628831	.	C	T	22	20	42	0	1	43	0	0
11	37628863	.	T	A	19	24	43	0	1	44	0	0
11	37629046	.	G	A	20	24	44	0	3	47	0	0
11	37708992	.	A	C	14	6	20	0	0	20	0	0
11	37709133	.	G	A	11	8	19	2	1	22	0	0
11	37709303	.	C	A	16	9	25	0	0	25	0	0
11	37709334	.	T	C	11	10	21	0	5	26	0	0
11	37709450	.	T	C	10	0	10	0	12	22	0	0
11	37709475	.	C	A	9	8	17	0	0	17	0	0
11	37709542	.	T	C	4	8	12	0	2	14	0	0
11	37709545	.	G	A	5	9	14	0	0	14	0	0
11	37710328	.	T	A	5	1	6	0	0	6	0	0
11	37710333	.	T	C	5	2	7	0	0	7	0	0
11	37710680	.	A	G	4	6	10	0	1	11	0	0
11	37710709	.	T	C	3	0	3	0	6	9	0	0
11	37710790	.	G	A	1	2	3	0	0	3	0	0
11	37720622	.	C	A	9	17	26	0	4	30	0	0
11	37720658	.	G	A	13	22	35	0	1	36	0	0
11	37720671	.	A	G	15	16	31	0	0	31	0	0
11	37722445	.	G	A	29	17	46	0	1	47	0	0
11	37725854	.	C	T	11	15	26	0	1	27	0	0
11	38808397	.	T	C	2	0	2	0	2	4	0	0
11	38844445	.	G	C	4	6	10	0	0	10	0	0
11	38846017	.	G	A	0	2	2	0	2	4	0	0
11	38846361	.	G	A	4	3	7	0	0	7	0	0
11	38850244	.	G	A	1	2	3	0	2	5	0	0
11	38865710	.	A	G	12	12	24	0	1	25	0	0
11	38875221	.	A	G	13	17	30	0	1	31	0	0
11	38875283	.	A	T	12	19	31	0	3	34	0	0
11	38875352	.	G	A	25	19	44	0	0	44	0	0
11	38875397	.	T	G	24	16	40	0	3	43	0	0
11	38875484	.	A	C	16	17	33	0	2	35	0	0
11	38875660	.	T	C	24	14	38	0	0	38	0	0
11	38875867	.	T	C	9	9	18	0	0	18	0	0
11	39044541	.	G	C	1	3	4	0	0	4	0	0
11	39076002	.	T	A	4	3	7	0	0	7	0	0
11	39109555	.	C	T	2	5	7	0	0	7	0	0
11	39109968	.	C	T	10	7	17	0	0	17	0	0
11	39110046	.	C	T	9	8	17	0	1	18	0	0
11	39112035	.	A	G	15	5	20	0	0	20	0	0
11	39112168	.	A	G	1	3	4	0	0	4	0	0
11	39112957	.	G	A	2	2	4	0	0	4	0	0
11	39113219	.	T	A	0	2	2	0	1	3	0	0
11	39113224	.	C	T	1	2	3	0	0	3	0	0
11	39135160	.	T	A	12	12	24	0	0	24	0	0
11	39135834	.	C	G	16	12	28	0	0	28	0	0
11	39141536	.	A	C	28	26	54	0	0	54	0	0
11	39141732	.	T	G	5	12	17	0	1	18	0	0
11	40017293	.	T	A	5	2	7	1	0	8	0	0
11	40622932	.	T	A	1	2	3	0	0	3	0	0
11	40644458	.	A	G	1	3	4	0	0	4	0	0
11	40655819	.	T	C	4	4	8	0	0	8	0	0
11	40658079	.	A	C	8	7	15	0	1	16	0	0
11	40658091	.	A	T	7	5	12	0	2	14	0	0
11	40658154	.	C	G	11	0	11	0	8	19	0	0
11	40658232	.	C	T	2	3	5	0	0	5	0	0
11	40658352	.	G	A	0	4	4	0	6	10	0	0
11	40661378	.	T	C	8	4	12	1	1	14	0	0
11	40665545	.	T	C	16	12	28	0	1	29	0	0
11	40665602	.	G	T	2	12	14	0	22	36	0	0
11	40673797	.	C	T	13	23	36	0	1	37	0	0
11	40673877	.	A	G	17	16	33	0	0	33	0	0
11	40677891	.	A	T	19	25	44	0	4	48	0	0
11	40677967	.	T	C	38	19	57	1	3	61	0	0
11	40678385	.	T	G	37	29	66	0	1	68	1	0
11	40678445	.	A	C	33	1	34	0	28	62	0	0
11	40680890	.	A	G	32	23	55	0	1	57	1	0
11	40840407	.	T	C	2	2	4	0	0	4	0	0
11	40843814	.	T	C	1	4	5	0	0	5	0	0
11	40844162	.	T	C	5	2	7	0	0	7	0	0
11	40844195	.	A	T	3	5	8	0	4	12	0	0
11	40845117	.	T	C	3	8	11	1	2	14	0	0
11	40845515	.	T	C	6	8	14	0	1	15	0	0
11	41066190	.	T	G	16	0	16	0	11	27	0	0
11	41066765	.	T	G	20	6	26	0	2	28	0	0
11	41066871	.	C	T	11	12	23	0	1	24	0	0
11	41066888	.	C	T	12	13	25	0	0	25	0	0
11	41066950	.	A	G	14	16	30	0	0	30	0	0
11	41067430	.	A	T	3	8	11	0	0	11	0	0
11	41067442	.	C	T	2	12	14	0	1	15	0	0
11	41067613	.	A	G	2	8	10	0	1	11	0	0
11	41078522	.	C	A	6	4	10	0	0	10	0	0
11	41078578	.	A	T	9	4	13	0	1	14	0	0
11	41078762	.	A	T	16	9	25	0	1	26	0	0
11	41084325	.	T	G	10	4	14	0	2	16	0	0
11	41101666	.	A	G	3	4	7	0	1	8	0	0
11	41101910	.	G	A	1	1	2	0	1	3	0	0
11	41101918	.	C	T	1	1	2	0	1	3	0	0
11	41102013	.	A	G	2	1	3	0	1	4	0	0
11	41102026	.	T	C	1	2	3	0	0	3	0	0
11	41104934	.	G	A	1	8	9	0	0	9	0	0
11	41104954	.	C	T	4	8	12	0	0	12	0	0
11	41105030	.	G	A	0	3	3	0	5	8	0	0
11	41105144	.	T	G	2	0	2	0	4	6	0	0
11	41111301	.	A	G	7	12	19	0	0	19	0	0
11	41111334	.	T	C	9	10	19	0	0	19	0	0
11	41111370	.	C	T	5	11	16	0	3	19	0	0
11	41111422	.	A	G	4	6	10	0	0	10	0	0
11	41111431	.	A	C	4	3	7	0	0	7	0	0
11	41111561	.	T	A	4	4	8	0	0	8	0	0
11	41111603	.	T	A	4	2	6	0	0	6	0	0
11	41111735	.	G	A	2	4	6	0	0	6	0	0
11	41114055	.	C	T	0	3	3	0	3	6	0	0
11	41114090	.	G	T	3	2	5	0	0	5	0	0
11	41114186	.	A	C	2	3	5	0	0	5	0	0
11	41216395	.	A	G	4	7	11	0	0	11	0	0
11	41216413	.	C	A	4	4	8	0	1	9	0	0
11	41216455	.	T	C	2	0	2	0	6	8	0	0
11	41216505	.	G	C	3	9	12	0	0	12	0	0
11	41220596	.	G	A	12	9	21	0	1	22	0	0
11	41220613	.	C	T	1	8	9	0	12	21	0	0
11	41220683	.	T	A	9	12	21	0	0	21	0	0
11	41222940	.	A	G	6	6	12	0	0	12	0	0
11	41307691	.	T	C	4	4	8	0	0	8	0	0
11	41307733	.	A	G	2	5	7	0	1	8	0	0
11	41363778	.	G	A	0	1	1	0	3	4	0	0
11	41459981	.	G	C	1	14	15	0	20	35	0	0
11	41461417	.	C	G	22	21	43	0	1	44	0	0
11	41463534	.	C	G	18	16	34	2	1	37	0	0
11	41468791	.	C	T	19	22	41	2	3	46	0	0
11	41473980	.	G	T	13	15	28	0	1	29	0	0
11	41474041	.	T	A	12	8	20	0	0	20	0	0
11	41474042	.	G	T	10	8	18	0	2	20	0	0
11	41838873	.	G	A	1	2	3	0	0	3	0	0
11	41838878	.	G	C	2	2	4	0	0	4	0	0
11	41838930	.	T	A	2	4	6	0	0	6	0	0
11	41838933	.	C	A	2	4	6	0	0	6	0	0
11	41840493	.	T	C	2	4	6	0	0	6	0	0
11	41840601	.	A	T	2	3	5	0	0	5	0	0
11	41842313	.	C	T	3	2	5	0	1	6	0	0
11	41844192	.	C	A	9	6	15	0	0	15	0	0
11	41845852	.	A	T	10	2	12	0	0	12	0	0
11	41845887	.	A	T	9	4	13	1	1	15	0	0
11	41846699	.	C	T	4	3	7	0	1	8	0	0
11	41850058	.	A	G	5	2	7	0	0	7	0	0
11	42128561	.	G	A	4	2	6	0	0	6	0	0
11	42131413	.	T	C	2	0	2	0	4	6	0	0
11	42561188	.	T	A	12	3	15	0	3	18	0	0
11	42561212	.	C	A	2	3	5	0	0	5	0	0
11	42610466	.	C	T	3	2	5	0	0	5	0	0
11	42730657	.	A	G	17	16	33	0	1	34	0	0
11	42730895	.	C	T	14	10	24	0	1	25	0	0
11	42730974	.	T	G	19	0	19	0	10	29	0	0
11	42730982	.	T	C	20	10	30	0	1	31	0	0
11	42731172	.	G	T	18	16	34	0	0	34	0	0
11	42732358	.	T	C	17	15	32	0	5	37	0	0
11	42783922	.	G	A	0	2	2	0	1	3	0	0
11	42793640	.	T	A	2	2	4	0	0	4	0	0
11	42809031	.	C	G	1	2	3	0	0	3	0	0
11	42809558	.	A	G	5	1	6	0	1	7	0	0
11	42809578	.	A	T	3	2	5	0	0	5	0	0
11	42809717	.	G	A	0	2	2	0	7	9	0	0
11	42811938	.	G	A	1	4	5	0	2	7	0	0
11	42815261	.	G	A	6	3	9	0	0	9	0	0
11	42816352	.	C	G	6	11	17	0	2	19	0	0
11	42816372	.	T	C	7	9	16	0	0	16	0	0
11	42816446	.	A	G	10	6	16	0	2	18	0	0
11	42816464	.	G	T	16	4	20	0	0	20	0	0
11	42816496	.	A	G	10	5	15	0	0	15	0	0
11	42816617	.	G	T	12	8	20	0	0	20	0	0
11	42816719	.	T	C	8	2	10	0	0	10	0	0
11	42816720	.	T	C	7	1	8	0	2	10	0	0
11	42816765	.	C	A	6	2	8	0	1	9	0	0
11	42816803	.	T	A	5	5	10	0	0	10	0	0
11	42816897	.	T	C	5	3	8	0	0	8	0	0
11	42816985	.	T	C	1	3	4	0	0	4	0	0
11	42817067	.	A	G	1	9	10	0	1	11	0	0
11	42817075	.	T	G	1	0	1	0	10	11	0	0
11	42817193	.	C	A	2	2	4	0	1	5	0	0
11	42817257	.	T	A	3	7	10	0	2	12	0	0
11	42817359	.	A	T	4	8	12	0	5	17	0	0
11	42817411	.	T	C	10	6	16	0	0	17	1	0
11	42817598	.	A	G	9	1	10	0	8	18	0	0
11	42817604	.	G	T	7	7	14	0	3	17	0	0
11	42912784	.	A	G	3	3	6	0	0	6	0	0
11	42912791	.	G	A	4	3	7	0	0	7	0	0
11	42912837	.	T	A	5	3	8	0	0	8	0	0
11	42913020	.	A	G	3	2	5	0	0	5	0	0
11	42913021	.	C	T	0	2	2	0	3	5	0	0
11	42913422	.	T	C	1	2	3	0	2	5	0	0
11	42913428	.	G	A	2	2	4	0	0	4	0	0
11	42933019	.	A	G	1	3	4	0	0	4	0	0
11	42933696	.	A	G	10	13	23	0	0	23	0	0
11	42933703	.	T	C	13	11	24	0	2	26	0	0
11	42933780	.	G	A	10	8	18	0	0	18	0	0
11	42939803	.	T	C	5	5	10	0	2	12	0	0
11	42940748	.	C	T	3	3	6	0	0	6	0	0
11	43159295	.	T	C	6	0	6	0	5	11	0	0
11	43164302	.	G	T	4	5	9	0	0	9	0	0
11	43167677	.	A	T	6	8	14	0	1	15	0	0
11	43170792	.	A	C	5	0	5	0	6	11	0	0
11	43170804	.	G	A	5	5	10	0	0	10	0	0
11	43170924	.	A	G	6	5	11	0	0	11	0	0
11	43171230	.	T	A	1	3	4	0	1	5	0	0
11	43171281	.	A	G	1	4	5	0	0	5	0	0
11	43189275	.	T	G	1	3	4	0	0	4	0	0
11	44144697	.	T	C	2	3	5	0	0	5	0	0
11	44144928	.	G	A	25	22	47	0	2	49	0	0
11	44144958	.	T	G	33	21	54	0	3	57	0	0
11	44148453	.	A	G	14	21	35	0	0	35	0	0
11	44152693	.	T	G	15	15	30	0	1	31	0	0
11	44152795	.	T	C	21	17	38	0	0	38	0	0
11	44153038	.	G	A	4	6	10	0	0	10	0	0
11	44155422	.	G	A	5	3	8	0	0	8	0	0
11	44155706	.	C	T	1	6	7	0	3	10	0	0
11	44157752	.	G	A	3	5	8	0	0	8	0	0
11	44159320	.	G	C	2	3	5	0	0	5	0	0
11	44163064	.	G	T	4	3	7	0	0	7	0	0
11	44180634	.	C	T	0	3	3	0	1	4	0	0
11	44304360	.	G	A	1	6	7	0	3	10	0	0
11	44324817	.	C	T	1	3	4	13	0	17	0	0
11	44329208	.	G	A	24	20	44	0	3	47	0	0
11	44334915	.	C	T	27	19	46	0	4	50	0	0
11	44337497	.	A	G	2	2	4	0	1	5	0	0
11	44356772	.	T	A	6	10	16	0	0	16	0	0
11	44356791	.	A	G	9	10	19	0	0	19	0	0
11	44358904	.	C	T	11	4	15	0	0	15	0	0
11	44445095	.	T	A	2	5	7	0	0	7	0	0
11	44445778	.	C	T	6	6	12	0	0	12	0	0
11	44452668	.	G	A	5	7	12	0	1	13	0	0
11	44452732	.	T	C	13	14	27	0	0	27	0	0
11	44452790	.	T	C	13	0	13	0	13	26	0	0
11	44452797	.	C	T	1	12	13	0	12	25	0	0
11	44452886	.	A	G	14	14	28	1	0	29	0	0
11	44455901	.	C	T	14	15	29	0	0	29	0	0
11	44457239	.	G	A	16	13	29	0	2	31	0	0
11	44457254	.	A	G	17	15	32	0	1	33	0	0
11	44461386	.	G	C	11	13	24	0	2	26	0	0
11	44461458	.	G	A	12	11	23	0	0	23	0	0
11	44466598	.	T	C	1	2	3	14	0	17	0	0
11	44468838	.	G	A	2	5	7	0	1	8	0	0
11	44468842	.	T	C	2	5	7	0	2	9	0	0
11	44476325	.	A	G	1	1	2	0	1	3	0	0
11	44481079	.	A	C	1	0	1	0	5	6	0	0
11	44522002	.	C	G	6	4	10	0	0	10	0	0
11	44522158	.	G	T	2	2	4	0	0	4	0	0
11	44523229	.	C	T	1	5	6	0	0	6	0	0
11	44524164	.	A	G	4	0	4	0	5	9	0	0
11	44524391	.	G	A	9	6	15	0	0	15	0	0
11	44524423	.	T	G	6	8	14	0	0	14	0	0
11	44524448	.	G	A	0	5	5	0	6	11	0	0
11	44524583	.	T	C	7	5	12	2	4	18	0	0
11	44524631	.	T	C	12	7	19	0	2	21	0	0
11	44524673	.	T	C	7	10	17	0	0	17	0	0
11	44524834	.	G	T	0	10	10	0	9	19	0	0
11	44527025	.	T	C	7	4	11	0	0	11	0	0
11	44527053	.	G	A	11	4	15	0	1	16	0	0
11	44527087	.	G	T	17	6	23	0	1	24	0	0
11	44527115	.	T	A	19	11	30	0	0	30	0	0
11	44527134	.	G	C	21	16	37	0	1	38	0	0
11	44527183	.	T	C	18	1	19	0	19	38	0	0
11	44527367	.	G	A	23	13	36	0	2	38	0	0
11	44527744	.	G	A	14	8	22	0	1	23	0	0
11	44528307	.	C	T	16	8	24	0	0	24	0	0
11	44528311	.	C	T	1	8	9	0	14	23	0	0
11	44528351	.	A	C	10	12	22	0	0	22	0	0
11	44528405	.	G	A	7	10	17	0	3	20	0	0
11	44528481	.	A	G	13	12	25	0	0	25	0	0
11	44528539	.	A	G	11	8	19	0	0	19	0	0
11	44528694	.	A	G	7	7	14	0	0	14	0	0
11	44528877	.	A	T	5	16	21	0	1	22	0	0
11	44528927	.	G	T	8	5	13	0	1	14	0	0
11	44529149	.	G	A	3	3	6	0	0	6	0	0
11	44529193	.	T	C	2	4	6	0	0	6	0	0
11	44529195	.	T	A	4	2	6	0	0	6	0	0
11	44530262	.	T	C	6	0	6	0	6	12	0	0
11	44606861	.	C	T	13	7	20	0	1	22	1	0
11	44606883	.	G	C	12	10	22	0	0	22	0	0
11	44606908	.	T	G	9	3	12	0	2	14	0	0
11	44607291	.	T	A	12	9	21	0	3	24	0	0
11	44607303	.	A	T	14	10	24	0	0	24	0	0
11	44612357	.	A	G	3	4	7	0	0	7	0	0
11	44614945	.	C	G	1	2	3	0	7	10	0	0
11	44614960	.	C	T	3	4	7	0	0	7	0	0
11	44617110	.	T	G	1	3	4	0	0	4	0	0
11	44622514	.	A	T	1	2	3	0	0	3	0	0
11	44622516	.	G	A	1	2	3	0	0	3	0	0
11	44628707	.	G	A	0	5	5	0	3	8	0	0
11	44632351	.	A	G	5	4	9	0	0	9	0	0
11	44634802	.	A	C	6	6	12	0	1	13	0	0
11	44634828	.	C	A	6	8	14	0	0	14	0	0
11	44634965	.	G	A	3	3	6	0	0	6	0	0
11	44637569	.	T	A	10	8	18	0	0	18	0	0
11	44637704	.	C	T	4	16	20	0	24	44	0	0
11	44637714	.	T	C	24	1	25	0	17	42	0	0
11	44637802	.	G	A	18	17	35	0	3	38	0	0
11	44637950	.	A	G	32	29	61	1	4	66	0	0
11	44637953	.	G	T	32	34	66	1	0	67	0	0
11	44638006	.	G	A	35	28	63	1	2	66	0	0
11	44643882	.	C	T	27	18	45	0	5	50	0	0
11	44723130	.	C	G	7	6	13	0	0	13	0	0
11	44723353	.	G	A	1	15	16	0	18	34	0	0
11	44723500	.	C	T	15	13	28	0	0	28	0	0
11	44723746	.	A	G	17	17	34	0	2	36	0	0
11	44725376	.	C	T	23	16	39	0	2	41	0	0
11	44726119	.	C	T	23	12	35	1	8	44	0	0
11	44854847	.	A	G	2	2	4	0	0	4	0	0
11	44854850	.	T	C	2	2	4	0	0	4	0	0
11	44854996	.	T	C	7	5	12	0	0	12	0	0
11	44855027	.	G	A	0	6	6	0	7	13	0	0
11	44880288	.	A	G	20	14	34	0	5	39	0	0
11	44880291	.	T	A	17	19	36	0	3	39	0	0
11	44880332	.	G	A	20	18	38	0	3	41	0	0
11	44880345	.	C	G	19	21	40	0	1	41	0	0
11	44887200	.	G	A	15	13	28	0	0	28	0	0
11	44887224	.	T	C	22	1	23	0	16	39	0	0
11	44887612	.	G	T	19	19	38	0	0	38	0	0
11	44891507	.	G	A	16	15	31	0	1	32	0	0
11	44892859	.	T	A	15	18	33	0	1	34	0	0
11	44892883	.	G	A	14	13	27	0	1	28	0	0
11	44892943	.	G	A	11	6	17	0	1	18	0	0
11	44892979	.	T	A	5	8	13	0	1	14	0	0
11	44894409	.	T	C	7	0	7	0	6	13	0	0
11	44897584	.	C	T	9	3	12	0	1	13	0	0
11	44897647	.	A	C	5	4	9	0	0	9	0	0
11	44901315	.	C	T	3	12	15	0	10	25	0	0
11	44901373	.	C	A	32	38	70	0	3	73	0	0
11	44910758	.	T	G	12	6	18	0	1	19	0	0
11	44912992	.	C	T	0	5	5	0	6	11	0	0
11	44913176	.	C	A	0	3	3	0	4	7	0	0
11	44935861	.	G	C	8	15	23	0	0	23	0	0
11	44954090	.	G	A	1	3	4	0	0	4	0	0
11	45125829	.	C	T	9	3	12	0	0	12	0	0
11	45125831	.	A	T	8	3	11	0	0	11	0	0
11	45126658	.	C	T	1	7	8	0	14	22	0	0
11	45126730	.	C	A	3	2	5	0	0	5	0	0
11	45126772	.	G	A	3	4	7	0	0	7	0	0
11	45127266	.	A	G	6	10	16	0	0	16	0	0
11	45127329	.	G	A	3	3	6	0	0	6	0	0
11	45127352	.	C	G	2	2	4	0	0	4	0	0
11	45129347	.	C	A	3	4	7	0	0	7	0	0
11	45130676	.	A	G	3	2	5	0	0	5	0	0
11	45130909	.	G	A	1	4	5	0	0	5	0	0
11	45139797	.	A	C	2	0	2	0	6	8	0	0
11	45140001	.	A	T	7	6	13	0	1	14	0	0
11	45141271	.	G	A	11	8	19	0	2	21	0	0
11	45143417	.	G	T	4	5	9	0	1	10	0	0
11	45161336	.	C	T	1	4	5	0	1	6	0	0
11	45161381	.	A	T	8	4	12	0	2	14	0	0
11	45161844	.	C	T	5	1	6	0	1	7	0	0
11	45161878	.	T	C	3	3	6	0	0	6	0	0
11	45162241	.	A	T	8	6	14	0	1	15	0	0
11	45244942	.	G	A	1	2	3	0	0	3	0	0
11	45245488	.	C	T	0	2	2	0	1	3	0	0
11	45245493	.	C	T	0	1	1	0	1	2	0	0
11	45245718	.	T	C	2	0	2	0	2	4	0	0
11	45262014	.	T	C	4	3	7	0	1	8	0	0
11	45262178	.	C	T	5	8	13	0	0	13	0	0
11	45262186	.	G	A	1	5	6	0	7	13	0	0
11	45262342	.	C	T	3	12	15	0	0	15	0	0
11	45265829	.	G	A	0	15	15	0	4	19	0	0
11	45265898	.	C	T	5	6	11	0	0	11	0	0
11	45290463	.	A	G	3	3	6	0	0	6	0	0
11	45290839	.	A	G	3	0	3	0	6	9	0	0
11	45290869	.	C	T	8	2	10	0	1	11	0	0
11	45290884	.	C	A	7	4	11	0	0	11	0	0
11	45294389	.	C	T	10	11	21	1	1	23	0	0
11	45294553	.	C	A	14	14	28	1	3	32	0	0
11	45294673	.	T	A	15	7	22	0	0	22	0	0
11	45294971	.	G	A	0	18	18	0	6	24	0	0
11	45295130	.	G	T	1	3	4	0	0	4	0	0
11	45342697	.	T	G	1	3	4	0	0	4	0	0
11	45342757	.	A	G	2	3	5	0	0	5	0	0
11	45342823	.	G	A	3	2	5	0	0	5	0	0
11	45342891	.	C	T	3	2	5	0	0	5	0	0
11	45343231	.	T	A	3	2	5	0	0	5	0	0
11	45343492	.	G	A	0	2	2	0	1	3	0	0
11	45344080	.	C	T	5	3	8	0	0	8	0	0
11	45348490	.	G	A	0	11	11	0	5	16	0	0
11	45350728	.	C	T	3	7	10	0	0	10	0	0
11	45351639	.	G	A	13	4	17	0	1	18	0	0
11	45355011	.	C	T	1	19	20	0	15	35	0	0
11	45355022	.	C	G	15	18	33	0	1	34	0	0
11	45355436	.	C	G	13	19	32	0	1	33	0	0
11	45355606	.	G	C	4	12	16	0	2	18	0	0
11	45356114	.	G	A	6	13	19	0	2	21	0	0
11	45356296	.	C	T	0	3	3	0	7	11	1	0
11	45356352	.	G	A	10	4	14	0	0	14	0	0
11	45356355	.	C	T	0	10	10	0	5	15	0	0
11	45356666	.	A	G	10	11	21	0	1	22	0	0
11	45359173	.	G	A	11	12	23	0	2	25	0	0
11	45359923	.	A	G	11	4	15	0	0	15	0	0
11	45359980	.	G	A	2	4	6	0	1	7	0	0
11	45362324	.	T	C	4	5	9	0	1	10	0	0
11	45366754	.	T	C	2	0	2	0	2	4	0	0
11	45391400	.	C	T	11	9	20	0	1	21	0	0
11	45391430	.	G	T	6	4	10	0	0	10	0	0
11	45391725	.	A	G	5	2	7	0	0	7	0	0
11	45391727	.	T	C	6	2	8	0	0	8	0	0
11	45391788	.	C	T	5	2	7	0	2	9	0	0
11	45393395	.	C	T	24	17	41	0	0	41	0	0
11	45393468	.	G	T	42	29	71	0	4	75	0	0
11	45393522	.	A	C	5	2	7	0	49	56	0	0
11	45397372	.	C	T	31	28	59	1	2	62	0	0
11	45399389	.	A	G	38	28	66	0	3	69	0	0
11	45399491	.	C	T	31	21	52	1	7	60	0	0
11	45399589	.	A	G	33	26	59	0	1	60	0	0
11	45400130	.	T	A	5	2	7	0	0	7	0	0
11	45402861	.	G	A	14	13	27	0	1	28	0	0
11	45403209	.	A	T	16	12	28	0	2	30	0	0
11	45403712	.	G	A	16	15	31	0	1	32	0	0
11	45403782	.	T	C	14	0	14	0	6	20	0	0
11	45403866	.	G	A	13	14	27	0	0	27	0	0
11	45403914	.	C	T	0	16	16	0	20	36	0	0
11	45410613	.	A	G	8	5	13	0	0	13	0	0
11	45412505	.	C	T	0	6	6	0	5	11	0	0
11	45428466	.	A	T	4	4	8	0	0	8	0	0
11	45430139	.	C	T	2	2	4	1	0	5	0	0
11	45448277	.	G	A	0	2	2	0	1	3	0	0
11	45448289	.	C	T	1	2	3	0	0	3	0	0
11	45461498	.	G	A	0	7	7	0	7	14	0	0
11	45463352	.	T	C	13	4	17	0	0	17	0	0
11	45463490	.	G	T	0	9	9	0	19	28	0	0
11	45464554	.	T	C	5	5	10	0	1	11	0	0
11	45464817	.	T	G	11	9	20	0	0	20	0	0
11	45464880	.	C	T	15	8	23	0	0	23	0	0
11	45465080	.	T	A	15	18	33	0	0	33	0	0
11	45468899	.	C	T	2	9	11	0	2	13	0	0
11	45468906	.	T	A	8	5	13	0	1	14	0	0
11	45468951	.	C	T	7	5	12	1	0	13	0	0
11	45469739	.	G	A	2	2	4	0	0	4	0	0
11	45469829	.	C	T	3	4	7	0	0	7	0	0
11	45469868	.	T	C	3	2	5	0	0	5	0	0
11	45469969	.	C	T	7	5	12	0	1	13	0	0
11	45470010	.	G	A	1	5	6	0	7	13	0	0
11	45470243	.	C	T	3	10	13	0	5	18	0	0
11	45470277	.	C	T	6	11	17	0	6	23	0	0
11	45470279	.	C	A	4	10	14	0	9	23	0	0
12	497201	.	C	T	2	6	8	0	0	8	0	0
12	499855	.	C	T	8	5	13	0	0	13	0	0
12	499865	.	C	T	6	5	11	0	0	11	0	0
12	502221	.	C	T	15	9	24	0	0	24	0	0
12	503308	.	G	A	10	8	18	0	0	18	0	0
12	516845	.	C	T	13	10	23	0	1	24	0	0
12	518107	.	T	C	19	17	36	0	0	36	0	0
12	527402	.	A	C	19	16	35	0	1	36	0	0
12	527693	.	T	G	24	18	42	0	1	43	0	0
12	527712	.	T	C	21	16	37	0	1	38	0	0
12	550387	.	G	T	6	6	12	0	1	13	0	0
12	550513	.	T	A	3	4	7	0	0	7	0	0
12	550516	.	C	T	0	3	3	0	3	6	0	0
12	550582	.	C	G	1	3	4	0	0	4	0	0
12	550599	.	A	T	2	2	4	0	0	4	0	0
12	550973	.	T	C	3	3	6	0	0	6	0	0
12	551098	.	A	G	3	2	5	0	0	5	0	0
12	551192	.	A	G	3	3	6	0	0	6	0	0
12	551372	.	C	T	2	3	5	0	1	6	0	0
12	551398	.	C	T	3	3	6	0	0	6	0	0
12	551549	.	T	C	6	0	6	0	3	9	0	0
12	551892	.	T	C	1	0	1	0	2	3	0	0
12	560561	.	T	A	1	3	4	0	0	4	0	0
12	560609	.	G	A	2	3	5	0	0	5	0	0
12	560710	.	G	T	2	3	5	0	0	5	0	0
12	560732	.	T	A	1	3	4	0	0	4	0	0
12	560941	.	T	C	3	0	3	0	4	7	0	0
12	561131	.	G	T	5	5	10	0	1	11	0	0
12	561350	.	G	T	3	6	9	0	0	9	0	0
12	562200	.	C	T	7	7	14	0	1	15	0	0
12	562203	.	C	T	0	6	6	0	7	13	0	0
12	564552	.	C	T	0	5	5	0	5	10	0	0
12	564553	.	G	A	5	5	10	0	0	10	0	0
12	564650	.	G	T	3	4	7	0	1	8	0	0
12	565571	.	C	G	3	4	7	0	0	7	0	0
12	566983	.	A	G	2	5	7	0	0	7	0	0
12	567012	.	T	C	2	0	2	0	6	8	0	0
12	571873	.	T	C	3	4	7	0	0	7	0	0
12	571933	.	T	C	1	0	1	0	2	3	0	0
12	573414	.	C	T	1	2	3	0	0	3	0	0
12	630495	.	G	A	3	3	6	0	0	6	0	0
12	781433	.	T	A	1	3	4	0	0	4	0	0
12	847787	.	T	C	16	16	32	0	1	33	0	0
12	847935	.	G	T	15	21	36	0	2	38	0	0
12	848846	.	T	C	14	0	14	0	18	32	0	0
12	850303	.	T	C	14	17	31	0	0	31	0	0
12	906722	.	A	G	6	6	12	0	0	12	0	0
12	910704	.	T	C	6	0	6	0	10	16	0	0
12	911042	.	C	T	0	9	9	0	5	14	0	0
12	911162	.	G	C	5	2	7	0	1	8	0	0
12	911180	.	A	C	4	2	6	0	0	6	0	0
12	912274	.	G	C	7	11	18	0	0	18	0	0
12	927844	.	G	C	3	2	5	0	0	5	0	0
12	927853	.	G	A	3	2	5	0	0	5	0	0
12	931437	.	A	G	1	5	6	0	0	6	0	0
12	932092	.	G	T	6	2	8	0	0	8	0	0
12	964877	.	T	C	20	1	21	0	21	42	0	0
12	964888	.	T	G	22	17	39	0	1	40	0	0
12	972975	.	C	T	2	3	5	0	4	9	0	0
12	976154	.	C	G	0	2	2	0	1	3	0	0
12	982979	.	T	A	13	11	24	0	0	24	0	0
12	983074	.	C	T	7	8	15	0	2	17	0	0
12	983176	.	T	A	7	11	18	0	1	19	0	0
12	983222	.	G	A	7	6	13	0	0	13	0	0
12	983340	.	C	T	8	10	18	0	2	20	0	0
12	986792	.	T	G	3	3	6	0	0	6	0	0
12	986834	.	A	G	4	2	6	0	0	6	0	0
12	993176	.	T	C	4	4	8	0	0	8	0	0
12	993237	.	C	G	4	8	12	0	0	12	0	0
12	997320	.	G	A	4	3	7	0	0	7	0	0
12	997834	.	T	C	3	4	7	0	0	7	0	0
12	997849	.	T	C	2	2	4	0	0	4	0	0
12	999517	.	T	C	2	0	2	0	4	6	0	0
12	1014553	.	C	T	1	13	14	0	6	20	0	0
12	1014668	.	A	G	1	7	8	0	2	10	0	0
12	1015197	.	C	T	2	11	13	0	6	19	0	0
12	1015845	.	G	A	6	14	20	0	2	22	0	0
12	1019123	.	C	T	0	6	6	0	4	10	0	0
12	1019243	.	G	T	1	6	7	0	0	7	0	0
12	1019311	.	C	G	1	4	5	0	0	5	0	0
12	1019503	.	G	A	4	3	7	0	0	7	0	0
12	1030041	.	T	C	3	1	4	0	0	4	0	0
12	1030048	.	A	G	3	2	5	0	0	5	0	0
12	1524866	.	A	T	8	5	13	1	0	14	0	0
12	1947596	.	T	C	1	0	1	0	4	5	0	0
12	1947645	.	G	A	1	2	3	0	0	3	0	0
12	1947656	.	A	T	2	2	4	0	0	4	0	0
12	1947999	.	G	A	2	2	4	0	0	4	0	0
12	2744279	.	G	T	2	5	7	0	0	7	0	0
12	2744291	.	A	T	3	5	8	0	2	10	0	0
12	2744495	.	T	G	1	4	5	0	1	6	0	0
12	2744549	.	A	G	1	6	7	0	0	7	0	0
12	2849911	.	A	G	4	0	4	0	3	7	0	0
12	2849970	.	A	G	1	6	7	0	0	7	0	0
12	2849974	.	A	G	2	3	5	0	2	7	0	0
12	3271244	.	T	A	1	10	11	0	1	12	0	0
12	3271250	.	A	G	1	11	12	0	0	12	0	0
12	3271553	.	G	A	4	6	10	0	1	11	0	0
12	3271728	.	A	G	9	2	11	0	0	11	0	0
12	3271747	.	A	G	14	3	17	1	1	19	0	0
12	3272148	.	A	G	4	6	10	3	1	14	0	0
12	3272421	.	A	G	7	6	13	0	2	15	0	0
12	3571986	.	C	T	14	10	24	0	1	25	0	0
12	3574398	.	C	G	10	15	25	0	2	27	0	0
12	3714079	.	T	G	0	2	2	0	0	2	0	0
12	3714084	.	G	A	1	4	5	0	0	5	0	0
12	3714149	.	G	T	4	3	7	0	1	8	0	0
12	3714183	.	G	A	7	2	9	0	0	9	0	0
12	3714213	.	T	A	6	13	19	0	0	19	0	0
12	3714315	.	C	T	8	10	18	0	0	18	0	0
12	3714330	.	A	T	6	12	18	0	2	20	0	0
12	3714425	.	C	A	10	10	20	0	0	20	0	0
12	3714578	.	T	C	5	0	5	0	5	10	0	0
12	3714602	.	T	C	4	6	10	0	0	10	0	0
12	3715016	.	A	G	5	10	15	1	0	16	0	0
12	3715039	.	T	C	9	4	13	0	0	13	0	0
12	3715544	.	T	C	4	5	9	0	2	11	0	0
12	3715730	.	T	C	1	0	1	0	3	4	0	0
12	3715904	.	G	A	3	4	7	0	0	7	0	0
12	3719297	.	T	G	4	3	7	0	0	7	0	0
12	3719312	.	T	C	2	0	2	0	4	6	0	0
12	3726646	.	T	A	6	12	18	0	2	20	0	0
12	3731590	.	G	A	0	9	9	0	10	19	0	0
12	3731602	.	C	A	11	8	19	0	0	19	0	0
12	3740940	.	G	A	3	3	6	0	0	6	0	0
12	3789489	.	T	A	1	2	3	0	0	3	0	0
12	3840324	.	C	T	3	2	5	0	0	5	0	0
12	3875931	.	A	G	3	1	4	0	2	6	0	0
12	3877941	.	G	A	1	5	6	0	0	6	0	0
12	3885358	.	C	T	5	4	9	0	1	10	0	0
12	3889974	.	A	G	6	0	6	0	6	12	0	0
12	3922047	.	A	G	5	5	10	0	0	10	0	0
12	3922068	.	A	T	5	5	10	0	1	11	0	0
12	3922086	.	A	C	3	3	6	0	2	8	0	0
12	3922536	.	A	G	9	10	19	0	1	21	1	0
12	3922549	.	G	A	0	7	7	0	12	19	0	0
12	3922764	.	A	G	3	5	8	0	0	8	0	0
12	3922844	.	G	A	2	2	4	0	1	5	0	0
12	3944265	.	T	C	6	8	14	0	0	14	0	0
12	3946833	.	G	A	35	21	56	0	4	60	0	0
12	3948593	.	C	T	21	25	46	0	0	46	0	0
12	3949212	.	G	A	23	15	38	0	1	39	0	0
12	3951117	.	C	T	7	11	18	0	1	19	0	0
12	3953155	.	T	A	11	7	18	0	0	18	0	0
12	3954003	.	T	G	3	5	8	0	1	9	0	0
12	3954072	.	C	T	4	4	8	0	0	8	0	0
12	3955573	.	A	C	11	1	12	0	13	25	0	0
12	3956864	.	A	G	6	10	16	0	1	17	0	0
12	3958476	.	A	G	7	9	16	0	0	16	0	0
12	3964936	.	C	A	1	8	9	0	13	22	0	0
12	3965002	.	G	T	9	14	23	0	5	28	0	0
12	3965168	.	T	C	21	17	38	0	0	38	0	0
12	3965237	.	G	A	20	15	35	0	2	37	0	0
12	3974755	.	C	T	0	2	2	0	5	7	0	0
12	3978242	.	T	G	3	3	6	0	0	6	0	0
12	3998961	.	A	T	1	2	3	0	0	3	0	0
12	4002687	.	C	A	7	10	17	0	0	17	0	0
12	4002709	.	A	G	8	11	19	0	0	19	0	0
12	4009337	.	G	A	3	3	6	0	0	6	0	0
12	4009392	.	C	A	6	2	8	0	1	9	0	0
12	4009393	.	G	C	2	6	8	0	1	9	0	0
12	4009462	.	A	T	2	2	4	0	0	4	0	0
12	4052378	.	A	T	2	2	4	0	0	4	0	0
12	4220453	.	A	G	2	2	4	0	0	4	0	0
12	4220485	.	T	C	2	1	3	0	1	4	0	0
12	4227248	.	A	C	2	3	5	0	0	5	0	0
12	4227308	.	C	G	3	3	6	0	0	6	0	0
12	4231548	.	C	T	2	2	4	0	0	4	0	0
12	4231775	.	A	G	1	4	5	0	0	5	0	0
12	4231776	.	G	A	1	4	5	0	0	5	0	0
12	4232001	.	C	T	4	2	6	0	1	7	0	0
12	4232028	.	G	A	0	3	3	0	3	6	0	0
12	4232055	.	G	C	7	6	13	0	0	13	0	0
12	4232208	.	C	G	3	3	6	0	0	6	0	0
12	4232210	.	T	A	2	2	4	0	2	6	0	0
12	4232320	.	C	T	4	3	7	0	0	7	0	0
12	4232369	.	G	T	7	6	13	0	0	13	0	0
12	4232434	.	C	A	5	10	15	0	1	16	0	0
12	4234489	.	G	C	7	5	12	0	0	12	0	0
12	4238122	.	T	C	10	5	15	0	1	16	0	0
12	4238464	.	A	G	11	0	11	0	10	21	0	0
12	4238519	.	C	A	11	9	20	0	2	22	0	0
12	4238720	.	T	C	5	2	7	0	1	8	0	0
12	4601361	.	G	A	7	2	9	0	0	9	0	0
12	4602047	.	T	A	14	9	23	1	1	25	0	0
12	4602245	.	G	A	20	25	45	0	0	45	0	0
12	4602322	.	G	A	17	18	35	0	3	38	0	0
12	4602399	.	A	T	13	19	32	0	0	32	0	0
12	4602464	.	G	C	12	0	12	0	12	24	0	0
12	4602503	.	C	A	11	16	27	0	1	29	1	0
12	4606669	.	C	T	11	18	29	0	2	31	0	0
12	4606693	.	G	A	14	11	25	0	1	26	0	0
12	4609143	.	C	T	16	9	25	0	0	26	1	0
12	4609172	.	T	G	14	19	33	0	0	33	0	0
12	4609364	.	A	G	12	18	30	0	1	31	0	0
12	4609391	.	T	C	13	16	29	0	1	30	0	0
12	4609409	.	C	T	10	13	23	0	0	23	0	0
12	4611128	.	C	T	9	16	25	0	1	26	0	0
12	4615329	.	G	A	6	9	15	0	1	16	0	0
12	4616967	.	C	G	7	8	15	0	0	15	0	0
12	4617024	.	G	T	1	4	5	2	2	9	0	0
12	4617065	.	G	A	4	12	16	1	1	18	0	0
12	4617102	.	G	C	5	1	6	0	15	21	0	0
12	4617243	.	G	A	13	10	23	0	1	24	0	0
12	4618033	.	C	T	2	2	4	0	0	4	0	0
12	4618087	.	T	G	3	7	10	0	0	10	0	0
12	4619179	.	A	G	3	2	5	0	0	5	0	0
12	4619230	.	G	T	5	3	8	0	0	8	0	0
12	4619553	.	C	T	2	4	6	0	0	6	0	0
12	4644090	.	C	T	5	2	7	0	0	7	0	0
12	4653986	.	C	T	0	1	1	0	2	3	0	0
12	4690311	.	A	G	3	2	5	0	0	5	0	0
12	4713010	.	C	A	2	3	5	0	2	7	0	0
12	4715953	.	A	G	3	0	3	1	6	10	0	0
12	4715968	.	G	A	3	5	8	1	1	10	0	0
12	4716061	.	A	C	3	2	5	0	0	5	0	0
12	4716064	.	T	G	3	0	3	0	3	6	0	0
12	4716361	.	A	G	3	4	7	0	0	7	0	0
12	4716375	.	T	C	5	3	8	0	1	9	0	0
12	4720264	.	T	C	3	4	7	0	1	8	0	0
12	4724553	.	G	A	5	4	9	0	1	10	0	0
12	4724765	.	G	A	1	7	8	0	2	10	0	0
12	4725114	.	A	C	7	6	13	0	0	13	0	0
12	4725170	.	A	T	10	12	22	0	0	22	0	0
12	4733968	.	C	T	9	5	14	0	0	14	0	0
12	4734008	.	G	T	9	7	16	0	0	16	0	0
12	4734068	.	G	T	7	5	12	0	0	12	0	0
12	4734306	.	A	T	8	6	14	0	1	15	0	0
12	4734312	.	A	G	8	7	15	0	1	16	0	0
12	4734418	.	T	G	8	5	13	0	0	13	0	0
12	4734476	.	T	C	7	1	8	0	10	18	0	0
12	4734925	.	C	T	17	8	25	0	1	26	0	0
12	4734967	.	G	A	11	10	21	0	2	23	0	0
12	4734979	.	C	T	2	8	10	0	11	21	0	0
12	4752981	.	G	A	1	3	4	0	0	4	0	0
12	4754639	.	G	T	4	6	10	0	0	10	0	0
12	4961256	.	A	G	2	2	4	0	0	4	0	0
12	4961955	.	A	C	1	3	4	0	1	5	0	0
12	4962195	.	A	G	1	0	1	0	5	6	0	0
12	4962640	.	C	A	3	2	5	0	0	5	0	0
12	4962643	.	G	T	1	2	3	0	3	6	0	0
12	5044104	.	A	G	3	0	3	0	2	5	0	0
12	5044106	.	G	A	2	2	4	0	0	4	0	0
12	5059785	.	T	C	1	2	3	0	0	3	0	0
12	5064179	.	G	A	0	1	1	0	3	4	0	0
12	5070229	.	A	C	2	3	5	0	0	5	0	0
12	5070290	.	G	A	2	4	6	0	1	7	0	0
12	5070383	.	A	C	2	5	7	0	0	7	0	0
12	5071104	.	T	A	2	5	7	0	0	7	0	0
12	5084415	.	A	G	1	0	1	0	3	4	0	0
12	5090591	.	T	C	5	3	8	0	0	8	0	0
12	5091368	.	A	T	2	5	7	0	0	7	0	0
12	5116192	.	A	G	26	25	51	0	1	52	0	0
12	5119802	.	T	C	7	8	15	0	0	15	0	0
12	5153814	.	T	A	3	6	9	0	0	9	0	0
12	5156454	.	T	A	6	0	6	1	0	7	0	0
12	5156507	.	G	A	1	3	4	0	1	5	0	0
12	5156617	.	A	T	3	2	5	0	0	5	0	0
12	5156634	.	A	T	4	3	7	0	1	8	0	0
12	5156671	.	A	G	3	3	6	0	0	6	0	0
12	5180626	.	G	A	4	6	10	0	0	10	0	0
12	5180662	.	T	A	4	2	6	0	1	7	0	0
12	5182460	.	T	C	1	3	4	0	1	5	0	0
12	5182718	.	G	A	2	2	4	0	0	4	0	0
12	5185627	.	G	A	2	3	5	0	0	5	0	0
12	5398514	.	T	G	3	3	6	0	0	6	0	0
12	5404160	.	T	C	3	0	3	0	5	8	0	0
12	5404181	.	G	C	1	0	1	0	5	6	0	0
12	5412216	.	A	G	2	2	4	0	0	4	0	0
12	5412235	.	C	G	2	2	4	0	0	4	0	0
12	5434072	.	G	A	2	2	4	0	0	4	0	0
12	5576096	.	C	T	2	4	6	0	0	6	0	0
12	5581617	.	G	C	3	2	5	0	1	6	0	0
12	5587492	.	A	T	1	2	3	0	0	3	0	0
12	6465898	.	T	C	3	2	5	0	1	6	0	0
12	6543123	.	T	C	2	3	5	0	1	6	0	0
12	6543197	.	G	A	2	3	5	1	2	8	0	0
12	6543350	.	G	A	1	2	3	0	0	3	0	0
12	6543458	.	C	G	9	9	18	0	0	18	0	0
12	6543906	.	G	C	8	8	16	0	0	16	0	0
12	6547163	.	C	T	0	4	4	0	4	8	0	0
12	6547214	.	A	G	4	5	9	0	0	9	0	0
12	6576298	.	C	T	2	3	5	0	0	5	0	0
12	6612744	.	T	C	2	0	2	0	2	4	0	0
12	7193865	.	C	T	9	7	16	0	0	16	0	0
12	7193874	.	A	G	10	8	18	0	0	18	0	0
12	7194410	.	A	G	10	14	24	0	1	25	0	0
12	7194423	.	T	C	13	2	15	0	13	28	0	0
12	7194505	.	T	C	11	15	26	0	2	28	0	0
12	7194522	.	T	C	12	10	22	0	2	24	0	0
12	7194587	.	G	A	8	3	11	0	0	11	0	0
12	7194843	.	C	A	5	5	10	0	1	11	0	0
12	7194932	.	G	A	7	8	15	0	0	15	0	0
12	7195024	.	T	C	10	6	16	0	0	16	0	0
12	7195081	.	G	T	10	13	23	0	1	24	0	0
12	7195192	.	G	T	18	10	28	1	0	29	0	0
12	7195588	.	G	A	14	4	18	2	0	20	0	0
12	7195816	.	C	A	6	3	9	0	0	9	0	0
12	7196125	.	A	G	7	4	11	0	0	11	0	0
12	7196249	.	G	T	3	4	7	0	1	8	0	0
12	7196346	.	G	A	3	5	8	0	0	8	0	0
12	7197407	.	T	C	3	2	5	0	0	5	0	0
12	7254324	.	A	T	1	4	5	0	0	5	0	0
12	7254352	.	G	C	4	3	7	0	0	7	0	0
12	7263657	.	G	T	0	4	4	0	5	9	0	0
12	7263665	.	G	T	2	4	6	0	5	11	0	0
12	7271805	.	A	C	3	2	5	0	0	5	0	0
12	7271895	.	A	G	1	2	3	0	0	3	0	0
12	7275695	.	T	C	1	3	4	0	0	4	0	0
12	7507047	.	C	T	3	2	5	0	0	5	0	0
12	7512637	.	T	C	6	7	13	0	0	13	0	0
12	7512641	.	T	A	7	7	14	0	0	14	0	0
12	7512675	.	G	A	3	7	10	0	0	10	0	0
12	7512682	.	A	G	3	7	10	0	0	10	0	0
12	7512921	.	A	G	3	3	6	0	0	6	0	0
12	7512965	.	C	A	1	7	8	0	1	9	0	0
12	7513106	.	C	A	2	7	9	0	0	9	0	0
12	7513446	.	T	A	7	5	12	0	1	13	0	0
12	7513555	.	G	A	9	4	13	1	3	17	0	0
12	7513637	.	G	A	8	6	14	0	1	15	0	0
12	7513658	.	C	T	6	7	13	0	2	15	0	0
12	7513685	.	C	A	3	7	10	0	0	10	0	0
12	7610969	.	T	C	4	6	10	0	0	10	0	0
12	7610973	.	T	C	4	5	9	0	0	9	0	0
12	7611189	.	T	C	10	0	10	0	3	13	0	0
12	7611201	.	T	C	8	2	10	0	0	10	0	0
12	7611286	.	T	C	2	3	5	0	2	7	0	0
12	7611526	.	T	C	6	3	9	0	1	10	0	0
12	7611527	.	T	C	7	0	7	0	3	10	0	0
12	7612441	.	T	C	1	5	6	0	0	6	0	0
12	7612460	.	T	C	1	2	3	0	0	3	0	0
12	8822961	.	T	C	1	4	5	0	0	5	0	0
12	8863228	.	G	A	0	2	2	0	1	3	0	0
12	8863240	.	A	T	3	1	4	0	1	5	0	0
12	8877343	.	A	C	6	5	11	0	0	11	0	0
12	8877412	.	T	C	8	9	17	0	0	17	0	0
12	8881469	.	G	A	4	5	9	0	0	9	0	0
12	8881470	.	C	G	5	2	7	0	1	8	0	0
12	8881575	.	C	T	8	7	15	0	0	15	0	0
12	8882062	.	G	T	7	10	17	0	1	18	0	0
12	8955284	.	C	T	0	3	3	0	1	4	0	0
12	8968456	.	T	A	10	11	21	0	3	24	0	0
12	8968487	.	T	A	9	10	19	0	2	21	0	0
12	8968512	.	T	G	8	11	19	0	0	19	0	0
12	8968721	.	A	G	14	18	32	0	0	32	0	0
12	8968979	.	C	A	11	3	14	0	1	15	0	0
12	8969084	.	T	C	8	21	29	0	3	32	0	0
12	8969102	.	C	T	1	24	25	0	8	33	0	0
12	8969155	.	C	G	13	11	24	0	0	24	0	0
12	8969426	.	T	C	3	4	7	1	1	9	0	0
12	8969485	.	T	C	9	15	24	0	1	25	0	0
12	8969499	.	G	A	11	16	27	0	1	28	0	0
12	8987502	.	T	C	13	9	22	0	1	23	0	0
12	8997654	.	A	G	10	7	17	0	0	17	0	0
12	9010979	.	G	A	6	11	17	0	1	18	0	0
12	9010988	.	C	T	0	10	10	0	8	18	0	0
12	9039610	.	G	A	2	4	6	0	1	7	0	0
12	9048811	.	G	A	3	4	7	0	0	7	0	0
12	9049343	.	C	T	1	2	3	0	0	3	0	0
12	9187209	.	A	G	2	2	4	0	0	4	0	0
12	9188488	.	A	G	1	2	3	0	0	3	0	0
12	9200402	.	C	T	3	5	8	0	1	9	0	0
12	9206038	.	T	C	9	3	12	0	1	13	0	0
12	9206044	.	C	T	11	3	14	0	0	14	0	0
12	9206120	.	A	T	4	7	11	0	1	12	0	0
12	9208468	.	T	G	3	0	3	0	8	11	0	0
12	9210441	.	G	A	1	11	12	0	1	13	0	0
12	9210489	.	T	C	7	9	16	0	0	16	0	0
12	9210504	.	A	G	8	9	17	0	2	19	0	0
12	9210528	.	C	T	9	7	16	0	1	17	0	0
12	9217989	.	A	G	14	16	30	0	0	30	0	0
12	9218054	.	T	C	13	5	18	0	0	18	0	0
12	9218095	.	A	T	6	2	8	0	1	9	0	0
12	9218098	.	T	C	4	3	7	0	0	7	0	0
12	9218142	.	A	G	2	4	6	0	0	6	0	0
12	9218176	.	T	C	4	2	6	0	0	6	0	0
12	9218183	.	G	A	4	2	6	0	0	6	0	0
12	9623751	.	T	C	7	9	16	0	0	16	0	0
12	9626057	.	A	C	4	3	7	0	0	7	0	0
12	9627980	.	A	G	6	6	12	0	0	12	0	0
12	9628007	.	T	C	1	3	4	0	0	4	0	0
12	9630730	.	G	A	6	2	8	1	0	9	0	0
12	9630745	.	G	A	2	5	7	1	1	9	0	0
12	9633827	.	G	A	10	3	13	0	1	14	0	0
12	9636544	.	C	T	0	3	3	0	4	7	0	0
12	9636616	.	A	G	9	5	14	0	0	14	0	0
12	9640492	.	G	A	1	3	4	0	0	4	0	0
12	9642671	.	A	G	2	3	5	0	0	5	0	0
12	9744541	.	T	C	0	3	3	0	0	3	0	0
12	9744544	.	C	T	1	3	4	0	0	4	0	0
12	9749830	.	A	G	2	6	8	0	0	8	0	0
12	9755833	.	C	T	3	4	7	0	0	7	0	0
12	9755869	.	A	G	3	5	8	0	0	8	0	0
12	9761792	.	C	T	4	4	8	0	0	8	0	0
12	9773308	.	G	A	1	2	3	0	0	3	0	0
12	9781701	.	T	G	5	3	8	0	0	8	0	0
12	9782230	.	C	T	2	3	5	0	0	5	0	0
12	9782404	.	G	A	2	2	4	0	0	4	0	0
12	9782428	.	T	C	4	4	8	0	0	8	0	0
12	9782856	.	C	A	0	2	2	0	1	3	0	0
12	9817737	.	A	T	5	3	8	0	0	8	0	0
12	9817771	.	C	T	4	4	8	0	0	8	0	0
12	9817883	.	T	A	4	3	7	0	0	7	0	0
12	9824735	.	C	T	13	11	24	0	0	24	0	0
12	9824762	.	C	A	7	11	18	0	0	18	0	0
12	9824807	.	C	A	11	6	17	0	0	17	0	0
12	9829697	.	C	T	15	6	21	0	0	21	0	0
12	9830983	.	G	A	20	19	39	0	1	40	0	0
12	9830986	.	G	A	21	17	38	0	3	41	0	0
12	9875954	.	A	C	1	2	3	0	0	3	0	0
12	9875978	.	A	G	1	2	3	0	0	3	0	0
12	9883526	.	G	A	25	31	56	0	4	60	0	0
12	9883849	.	C	T	22	39	61	0	3	64	0	0
12	9883944	.	C	T	41	27	68	0	4	72	0	0
12	9950608	.	C	T	1	2	3	0	0	3	0	0
12	10124691	.	G	T	1	2	3	0	0	3	0	0
12	10124815	.	T	G	2	3	5	0	0	5	0	0
12	10124819	.	C	T	2	3	5	0	0	5	0	0
12	10167070	.	A	G	15	9	24	0	0	24	0	0
12	10169521	.	T	C	13	8	21	0	1	22	0	0
12	10169614	.	G	A	10	10	20	0	1	21	0	0
12	10169884	.	G	T	9	19	28	0	2	30	0	0
12	10175161	.	C	T	19	21	40	0	1	41	0	0
12	10199695	.	A	G	23	17	40	0	1	41	0	0
12	10199760	.	A	T	19	13	32	0	1	34	1	0
12	10199869	.	C	T	4	18	22	0	9	31	0	0
12	10200028	.	A	G	12	21	33	0	2	35	0	0
12	10209431	.	A	G	14	24	38	0	2	40	0	0
12	10209452	.	T	A	22	16	38	0	0	38	0	0
12	10217660	.	C	T	6	8	14	0	0	14	0	0
12	10217708	.	C	T	6	6	12	0	2	14	0	0
12	10220000	.	G	T	10	6	16	0	0	16	0	0
12	10220117	.	A	G	10	8	18	0	1	19	0	0
12	10243926	.	C	T	3	3	6	0	0	6	0	0
12	10243971	.	A	C	4	4	8	0	0	8	0	0
12	10304660	.	T	A	3	2	5	0	0	5	0	0
12	10354776	.	A	G	1	2	3	0	0	3	0	0
12	10369038	.	G	T	4	2	6	0	0	6	0	0
12	10369153	.	T	G	3	4	7	0	0	7	0	0
12	10382220	.	C	T	10	3	13	0	0	13	0	0
12	10382588	.	C	T	4	7	11	0	3	14	0	0
12	10384982	.	G	A	16	7	23	0	0	23	0	0
12	10387071	.	A	G	10	11	21	0	0	21	0	0
12	10391883	.	C	T	9	6	15	1	0	16	0	0
12	10393538	.	G	T	4	4	8	0	1	9	0	0
12	10398820	.	A	G	1	5	6	0	0	6	0	0
12	10399471	.	G	A	1	4	5	0	0	5	0	0
12	10399766	.	T	C	2	3	5	0	0	5	0	0
12	10424741	.	C	G	1	16	17	0	7	24	0	0
12	10425346	.	T	C	20	15	35	0	2	37	0	0
12	10425465	.	C	T	18	11	29	0	0	29	0	0
12	10425586	.	G	T	21	14	35	0	1	36	0	0
12	10425630	.	A	T	19	20	39	0	1	40	0	0
12	10429054	.	G	A	15	9	24	0	1	25	0	0
12	10429105	.	C	A	10	13	23	0	2	25	0	0
12	10430611	.	G	A	12	10	22	0	0	22	0	0
12	10439641	.	T	G	6	5	11	0	0	11	0	0
12	10439662	.	G	A	6	6	12	0	0	12	0	0
12	10443916	.	G	T	6	2	8	0	1	9	0	0
12	10443923	.	T	C	6	1	7	0	0	7	0	0
12	10444321	.	A	T	12	6	18	0	2	20	0	0
12	10462114	.	G	T	1	2	3	0	0	3	0	0
12	10465000	.	A	C	12	11	23	0	1	24	0	0
12	10465182	.	A	C	5	7	12	0	1	13	0	0
12	10471105	.	A	G	6	3	9	0	0	9	0	0
12	10471120	.	T	C	2	0	2	0	6	8	0	0
12	10475310	.	G	A	1	3	4	0	0	4	0	0
12	10478804	.	C	A	0	3	3	0	6	9	0	0
12	10478857	.	T	C	7	2	9	0	1	10	0	0
12	10478961	.	G	T	4	2	6	0	0	6	0	0
12	10482230	.	C	A	10	3	13	0	1	14	0	0
12	10482792	.	T	G	6	3	9	0	0	9	0	0
12	10487620	.	G	T	1	2	3	0	0	3	0	0
12	10487662	.	G	C	1	0	1	0	2	3	0	0
12	10493597	.	G	A	1	2	3	0	0	3	0	0
12	10505938	.	G	C	1	0	1	0	3	4	0	0
12	10646482	.	A	T	4	7	11	0	1	12	0	0
12	10651761	.	A	G	4	2	6	0	0	6	0	0
12	10679120	.	A	T	5	4	9	0	0	9	0	0
12	10679153	.	G	A	6	7	13	0	1	14	0	0
12	10679279	.	T	G	21	12	33	0	3	37	1	0
12	10679289	.	G	A	12	22	34	0	0	34	0	0
12	10682392	.	A	G	11	14	25	0	2	27	0	0
12	10685867	.	C	T	9	7	16	0	1	17	0	0
12	10688640	.	C	T	11	3	14	0	2	16	0	0
12	10688704	.	G	A	10	11	21	0	1	22	0	0
12	10705765	.	T	A	7	9	16	0	0	16	0	0
12	10705775	.	C	G	6	8	14	0	0	14	0	0
12	10733035	.	G	A	2	2	4	0	0	4	0	0
12	11124943	.	T	C	1	0	1	0	2	3	0	0
12	11124952	.	T	C	1	0	1	0	1	2	0	0
12	11389128	.	T	C	9	4	13	0	0	13	0	0
12	11762849	.	A	T	11	9	20	0	0	20	0	0
12	13473314	.	A	G	1	2	3	0	0	3	0	0
12	13474461	.	A	G	7	4	11	0	0	11	0	0
12	13475225	.	A	G	17	6	23	0	0	23	0	0
12	13741105	.	T	G	4	1	5	4	2	11	0	0
12	18713926	.	C	T	4	5	9	0	1	10	0	0
12	18714000	.	C	T	11	8	19	0	0	19	0	0
12	18716985	.	C	T	18	8	26	0	0	26	0	0
12	18717085	.	A	G	9	10	19	0	2	21	0	0
12	18717374	.	C	T	2	2	4	0	0	4	0	0
12	18779450	.	T	A	2	4	6	0	0	6	0	0
12	18779648	.	T	C	1	2	3	0	0	3	0	0
12	18782541	.	G	A	4	4	8	0	0	8	0	0
12	18782763	.	G	A	4	3	7	0	0	7	0	0
12	18786773	.	T	C	12	10	22	0	1	23	0	0
12	18786917	.	T	C	10	12	22	0	0	23	1	0
12	18787009	.	G	A	15	11	26	0	0	26	0	0
12	18787205	.	C	T	11	9	20	0	2	22	0	0
12	18794074	.	C	A	0	3	3	0	2	5	0	0
12	18895837	.	T	C	1	2	3	0	0	3	0	0
12	18913584	.	A	G	9	6	15	0	0	15	0	0
12	18913602	.	A	G	8	9	17	0	0	17	0	0
12	18913850	.	A	G	17	4	21	0	0	21	0	0
12	18913906	.	A	G	14	5	19	0	1	20	0	0
12	18913938	.	A	G	12	3	15	0	1	16	0	0
12	19062233	.	A	G	7	3	10	0	1	11	0	0
12	19063169	.	A	T	4	2	6	0	0	6	0	0
12	19064796	.	A	T	10	4	14	0	1	15	0	0
12	19144930	.	G	A	6	2	8	0	0	8	0	0
12	19301172	.	A	T	11	2	13	0	1	14	0	0
12	19317745	.	G	A	29	21	50	0	3	53	0	0
12	19317791	.	G	A	27	29	56	1	1	58	0	0
12	19317875	.	G	A	28	13	41	0	3	44	0	0
12	19317930	.	G	T	1	13	14	0	21	35	0	0
12	19318157	.	T	C	17	32	49	0	0	49	0	0
12	19318158	.	G	A	18	31	49	0	1	50	0	0
12	19318194	.	G	C	18	24	42	0	1	43	0	0
12	19318210	.	T	C	17	24	41	0	3	44	0	0
12	19318441	.	A	T	3	6	9	0	1	10	0	0
12	19318475	.	G	A	2	9	11	0	1	12	0	0
12	19318487	.	C	A	3	7	10	0	1	11	0	0
12	19318539	.	G	A	8	8	16	0	1	17	0	0
12	19318615	.	A	T	13	10	23	0	2	25	0	0
12	19318823	.	A	G	15	2	17	1	17	35	0	0
12	19318855	.	C	T	15	20	35	1	1	37	0	0
12	19337850	.	G	A	4	6	10	0	0	10	0	0
12	19338387	.	T	G	4	5	9	0	0	9	0	0
12	19339065	.	G	T	6	6	12	0	3	15	0	0
12	19339490	.	T	A	6	4	10	0	1	11	0	0
12	19339492	.	C	T	6	4	10	0	1	11	0	0
12	19340086	.	A	G	10	3	13	0	0	13	0	0
12	19340180	.	C	T	1	3	4	0	0	4	0	0
12	19341869	.	G	A	16	12	28	0	1	29	0	0
12	19348622	.	A	G	10	9	19	0	2	21	0	0
12	19348678	.	T	C	15	12	27	0	2	29	0	0
12	19353091	.	C	T	20	20	40	0	0	40	0	0
12	19353174	.	C	T	17	17	34	0	1	35	0	0
12	19353203	.	A	C	20	16	36	0	1	37	0	0
12	19353513	.	A	G	14	10	24	0	1	25	0	0
12	19353622	.	A	T	12	21	33	0	2	35	0	0
12	19362500	.	C	T	2	2	4	0	0	4	0	0
12	19369292	.	G	A	2	7	9	0	0	9	0	0
12	19373175	.	G	A	6	4	10	0	1	11	0	0
12	19375729	.	T	C	6	5	11	0	0	11	0	0
12	19375741	.	C	T	7	5	12	0	0	12	0	0
12	19379564	.	G	C	0	6	6	0	12	18	0	0
12	19379642	.	C	T	3	8	11	1	1	13	0	0
12	19380120	.	A	G	7	7	14	0	1	15	0	0
12	19383137	.	A	G	7	7	14	0	2	16	0	0
12	19383139	.	T	C	8	7	15	0	1	16	0	0
12	19383217	.	T	C	5	8	13	0	1	14	0	0
12	19383242	.	T	A	2	9	11	0	1	12	0	0
12	19383260	.	A	T	5	6	11	0	2	14	1	0
12	19383417	.	T	C	9	17	26	0	1	27	0	0
12	19383539	.	C	T	13	3	16	0	1	17	0	0
12	19383843	.	G	A	9	3	12	0	2	14	0	0
12	19385072	.	G	A	7	4	11	0	1	12	0	0
12	19385287	.	T	C	5	3	8	0	0	8	0	0
12	19385664	.	C	T	2	6	8	0	0	8	0	0
12	19393795	.	A	G	5	7	12	0	0	12	0	0
12	19422124	.	G	A	1	2	3	0	0	3	0	0
12	19422271	.	T	C	1	2	3	0	0	3	0	0
12	19433542	.	C	G	1	5	6	0	0	6	0	0
12	19637039	.	T	G	9	4	13	1	3	17	0	0
12	19658488	.	G	T	7	3	10	0	0	10	0	0
12	19658505	.	T	C	5	3	8	0	0	8	0	0
12	19658587	.	A	G	5	4	9	0	0	9	0	0
12	19658626	.	C	T	6	3	9	0	0	9	0	0
12	19658691	.	A	G	6	0	6	1	8	15	0	0
12	19658735	.	A	T	6	7	13	1	1	15	0	0
12	19658836	.	G	A	4	9	13	0	0	13	0	0
12	19792385	.	G	A	1	2	3	0	1	4	0	0
12	19792566	.	T	C	10	9	19	0	3	22	0	0
12	19792945	.	C	G	19	14	33	0	1	34	0	0
12	19792970	.	G	A	23	11	34	0	0	34	0	0
12	19793001	.	G	A	25	12	37	0	0	37	0	0
12	19793039	.	T	A	24	9	33	0	0	33	0	0
12	19793470	.	C	G	21	19	40	0	3	43	0	0
12	19793534	.	T	A	21	12	33	0	2	35	0	0
12	19793657	.	G	A	12	11	23	0	0	23	0	0
12	19793693	.	A	G	10	11	21	0	1	22	0	0
12	19865090	.	T	C	8	0	8	0	8	16	0	0
12	19865347	.	C	T	6	6	12	0	1	13	0	0
12	19865567	.	G	A	3	2	5	0	0	5	0	0
12	19931970	.	A	T	4	3	7	0	1	8	0	0
12	19932072	.	T	C	3	4	7	0	0	7	0	0
12	19932122	.	C	A	4	3	7	0	0	7	0	0
12	19932195	.	A	T	6	6	12	0	0	12	0	0
12	19973531	.	A	G	5	0	5	0	5	10	0	0
12	19973564	.	T	C	4	4	8	0	0	8	0	0
12	19973939	.	A	G	3	0	3	0	3	6	0	0
12	19973942	.	A	G	3	3	6	0	1	7	0	0
12	19974092	.	G	A	0	10	10	0	3	13	0	0
12	20099085	.	A	G	10	9	19	0	0	19	0	0
12	20099478	.	A	G	13	15	28	0	0	28	0	0
12	20099657	.	T	C	10	9	19	0	1	20	0	0
12	20099708	.	T	A	10	11	21	0	0	21	0	0
12	20100109	.	A	G	10	5	15	0	2	17	0	0
12	20100169	.	A	G	12	9	21	0	2	23	0	0
12	20100190	.	T	C	10	0	10	0	12	22	0	0
12	20100391	.	G	A	13	11	24	0	1	25	0	0
12	20122709	.	A	T	1	2	3	0	0	3	0	0
12	20147218	.	G	C	23	10	33	0	4	37	0	0
12	20147229	.	A	G	25	7	32	0	0	32	0	0
12	20147428	.	G	A	21	11	32	0	1	33	0	0
12	20147486	.	A	G	21	1	22	0	16	38	0	0
12	20147504	.	T	C	19	15	34	0	0	34	0	0
12	20147564	.	A	T	4	17	21	0	0	21	0	0
12	20156045	.	T	C	2	2	4	0	0	4	0	0
12	20156168	.	G	A	0	3	3	0	2	5	0	0
12	20156177	.	G	A	1	2	3	0	0	3	0	0
12	20227724	.	A	G	3	2	5	0	1	6	0	0
12	20378769	.	T	C	1	3	4	0	1	5	0	0
12	20379586	.	G	C	7	8	15	0	0	15	0	0
12	20380050	.	C	G	6	14	20	0	0	20	0	0
12	20396459	.	T	A	5	10	15	0	1	16	0	0
12	20406815	.	T	C	6	0	6	0	4	10	0	0
12	20406818	.	G	A	7	4	11	0	0	11	0	0
12	20407789	.	A	G	3	3	6	0	0	6	0	0
12	20409495	.	G	T	3	3	6	0	0	6	0	0
12	20409523	.	A	G	6	3	9	0	0	9	0	0
12	20409680	.	T	A	0	2	2	0	1	3	0	0
12	20478367	.	T	C	1	2	3	0	0	3	0	0
12	20607308	.	C	T	4	2	6	0	0	6	0	0
12	20607417	.	C	T	2	2	4	0	0	4	0	0
12	20607515	.	G	A	4	2	6	0	0	6	0	0
12	20607711	.	G	C	1	4	5	0	0	5	0	0
12	20608370	.	T	A	3	2	5	0	0	5	0	0
12	20653128	.	C	T	7	7	14	0	0	14	0	0
12	20653159	.	G	A	4	9	13	0	1	14	0	0
12	20653244	.	A	T	8	3	11	0	1	12	0	0
12	20653301	.	T	C	7	0	7	0	9	16	0	0
12	20658037	.	T	C	4	7	11	0	0	11	0	0
12	20676252	.	C	T	3	2	5	0	1	6	0	0
12	20677125	.	T	C	2	4	6	0	0	6	0	0
12	20677175	.	G	A	3	2	5	0	0	5	0	0
12	20677202	.	C	A	5	3	8	0	0	8	0	0
12	20677816	.	T	G	0	0	0	0	8	8	0	0
12	20677874	.	A	G	7	3	10	0	0	10	0	0
12	21539855	.	T	C	13	16	29	0	1	30	0	0
12	21549172	.	G	A	19	13	32	1	7	40	0	0
12	21684306	.	A	G	6	0	6	0	6	12	0	0
12	21687757	.	T	C	14	9	23	0	3	26	0	0
12	22233938	.	C	G	0	2	2	0	1	3	0	0
12	22310722	.	T	C	5	3	8	0	0	8	0	0
12	22410077	.	G	T	2	2	4	0	0	4	0	0
12	22412630	.	A	G	1	4	5	0	0	5	0	0
12	22418297	.	T	C	2	2	4	0	0	4	0	0
12	22420669	.	T	C	3	4	7	0	0	7	0	0
12	22431304	.	G	A	15	5	20	0	0	20	0	0
12	22435203	.	T	C	8	6	14	0	0	14	0	0
12	22437160	.	T	C	4	4	8	0	1	9	0	0
12	22444470	.	C	T	6	4	10	0	1	11	0	0
12	22444613	.	A	T	10	12	22	0	1	23	0	0
12	22451304	.	T	C	3	3	6	0	0	6	0	0
12	22451793	.	A	C	4	6	10	0	1	11	0	0
12	22451811	.	A	G	5	4	9	0	0	9	0	0
12	22456934	.	A	G	4	3	7	0	0	7	0	0
12	22460101	.	C	G	2	2	4	0	0	4	0	0
12	22460316	.	G	T	1	4	5	0	0	5	0	0
12	22462021	.	C	G	0	2	2	0	6	8	0	0
12	22480599	.	A	G	2	2	4	0	0	4	0	0
12	22480610	.	A	G	2	2	4	0	0	4	0	0
12	22528869	.	G	A	26	20	46	0	1	47	0	0
12	22529407	.	C	T	14	20	34	1	1	36	0	0
12	22529560	.	T	A	23	23	46	0	2	48	0	0
12	22529655	.	C	G	13	21	34	0	0	34	0	0
12	22529952	.	T	C	5	7	12	0	0	12	0	0
12	22530053	.	A	G	9	12	21	0	1	22	0	0
12	22530056	.	G	A	9	12	21	0	1	22	0	0
12	22530352	.	G	A	17	19	36	0	5	41	0	0
12	22530362	.	C	T	3	22	25	0	21	46	0	0
12	22530849	.	C	G	9	7	16	0	0	16	0	0
12	22531212	.	T	A	13	8	21	0	0	21	0	0
12	22531929	.	T	A	10	11	21	0	0	21	0	0
12	22532594	.	C	T	0	7	7	0	6	13	0	0
12	22533884	.	A	T	6	4	10	0	1	11	0	0
12	22534389	.	T	C	3	0	3	0	6	9	0	0
12	22535186	.	C	T	0	2	2	0	1	3	0	0
12	22570379	.	A	T	7	5	12	0	1	13	0	0
12	22570499	.	T	C	5	7	12	0	0	12	0	0
12	22571368	.	G	C	2	5	7	0	0	7	0	0
12	22571592	.	A	T	6	4	10	0	0	10	0	0
12	22572367	.	C	T	15	9	24	0	1	25	0	0
12	22572528	.	T	G	6	13	19	0	1	20	0	0
12	22572585	.	G	A	26	16	42	0	0	42	0	0
12	22572650	.	T	C	16	14	30	0	1	31	0	0
12	22572660	.	G	A	20	14	34	0	1	35	0	0
12	22572738	.	C	T	22	15	37	0	0	37	0	0
12	22572756	.	C	T	14	22	36	0	0	36	0	0
12	22572937	.	C	T	22	14	36	5	2	43	0	0
12	22573185	.	G	A	8	6	14	0	0	14	0	0
12	22643556	.	C	G	4	4	8	0	0	8	0	0
12	22643876	.	T	C	2	2	4	0	1	5	0	0
12	22644038	.	C	A	4	2	6	1	0	7	0	0
12	22644406	.	C	T	4	3	7	0	0	7	0	0
12	22644576	.	A	G	2	0	2	0	7	9	0	0
12	22644634	.	T	C	1	10	11	0	1	12	0	0
12	22644852	.	C	T	2	4	6	0	0	6	0	0
12	22644878	.	G	A	4	3	7	0	2	9	0	0
12	22644993	.	C	T	3	2	5	0	0	5	0	0
12	22644998	.	A	G	3	2	5	0	0	5	0	0
12	22645184	.	G	A	2	1	3	0	1	4	0	0
12	22645192	.	T	G	2	2	4	0	0	4	0	0
12	22645599	.	T	C	2	3	5	0	0	5	0	0
12	22648402	.	T	C	2	2	4	0	0	4	0	0
12	22814994	.	A	G	4	2	6	0	0	6	0	0
12	22815672	.	G	A	2	6	8	0	0	8	0	0
12	22927981	.	T	C	6	8	14	0	0	14	0	0
12	22932674	.	T	A	14	12	26	0	0	26	0	0
12	22932675	.	A	T	13	12	25	0	1	26	0	0
12	22962175	.	G	A	1	3	4	0	0	4	0	0
12	22962764	.	T	C	4	8	12	0	0	12	0	0
12	22962864	.	G	A	4	2	6	0	1	7	0	0
12	22962911	.	C	A	4	5	9	0	0	9	0	0
12	22963104	.	A	C	2	3	5	0	0	5	0	0
12	22963141	.	G	C	3	2	5	0	0	5	0	0
12	22963197	.	G	A	1	2	3	0	0	3	0	0
12	22963667	.	C	G	4	7	11	0	0	11	0	0
12	23385168	.	G	A	6	3	9	0	0	9	0	0
12	23403091	.	T	C	12	6	18	0	4	22	0	0
12	23403149	.	T	C	12	12	24	0	0	24	0	0
12	23406439	.	A	G	15	14	29	0	1	30	0	0
12	23415280	.	C	T	15	17	32	0	2	34	0	0
12	23415347	.	C	T	24	12	36	0	1	37	0	0
12	23415672	.	C	A	20	26	46	0	2	48	0	0
12	23415715	.	T	C	20	25	45	0	1	46	0	0
12	23415878	.	G	A	14	5	19	0	4	23	0	0
12	23429619	.	G	A	4	2	6	0	0	6	0	0
12	23429917	.	A	G	4	0	4	0	3	7	0	0
12	23674331	.	T	A	1	2	3	0	0	3	0	0
12	23674354	.	T	C	1	7	8	0	1	9	0	0
12	23674468	.	C	T	2	3	5	0	0	5	0	0
12	23674469	.	A	G	2	3	5	0	0	5	0	0
12	23788649	.	C	A	2	2	4	0	0	4	0	0
12	23794884	.	G	A	1	2	3	0	0	3	0	0
12	23912037	.	A	G	1	2	3	0	0	3	0	0
12	23923434	.	G	A	2	5	7	0	0	7	0	0
12	23932067	.	T	G	3	11	14	0	2	16	0	0
12	24030454	.	C	T	1	2	3	0	0	3	0	0
12	24038339	.	A	C	3	2	5	0	0	5	0	0
12	24038542	.	T	C	2	4	6	0	0	6	0	0
12	24041367	.	A	T	2	5	7	0	0	7	0	0
12	24043703	.	C	T	2	3	5	0	2	7	0	0
12	24043736	.	C	T	4	3	7	0	0	7	0	0
12	24043909	.	C	T	4	2	6	0	0	6	0	0
12	24043942	.	C	T	6	6	12	0	0	12	0	0
12	24045914	.	T	G	11	0	11	0	7	18	0	0
12	24051717	.	C	G	4	8	12	0	1	13	0	0
12	24051737	.	C	G	6	8	14	0	0	14	0	0
12	24051755	.	T	A	5	5	10	0	0	10	0	0
12	24051894	.	G	T	3	4	7	0	0	7	0	0
12	24051944	.	T	G	7	4	11	0	1	12	0	0
12	24052133	.	A	G	3	0	3	0	4	7	0	0
12	24052196	.	A	G	6	3	9	0	0	9	0	0
12	24052219	.	A	C	6	3	9	0	0	9	0	0
12	24052256	.	G	C	6	5	11	0	2	13	0	0
12	24052288	.	T	C	5	3	8	0	0	8	0	0
12	24465454	.	C	T	2	4	6	0	0	6	0	0
12	24465541	.	C	T	7	5	12	0	0	12	0	0
12	24465565	.	T	C	4	5	9	0	0	9	0	0
12	24465607	.	C	T	7	6	13	0	0	13	0	0
12	24484131	.	G	T	3	6	9	0	0	9	0	0
12	24484134	.	C	T	4	6	10	0	0	10	0	0
12	24484215	.	T	C	1	4	5	0	0	5	0	0
12	24562909	.	C	T	1	3	4	0	0	4	0	0
12	24606963	.	C	T	22	16	38	1	2	41	0	0
12	24635925	.	A	G	33	3	36	0	25	61	0	0
12	24636261	.	C	A	27	24	51	0	2	53	0	0
12	24636746	.	A	G	25	30	55	1	3	59	0	0
12	24637148	.	G	T	8	2	10	0	2	12	0	0
12	24637166	.	A	T	9	3	12	0	1	13	0	0
12	24796653	.	G	A	6	5	11	0	0	11	0	0
12	24797128	.	A	T	11	5	16	1	1	18	0	0
12	24797351	.	C	T	7	14	21	0	1	22	0	0
12	24797413	.	C	T	14	10	24	0	0	24	0	0
12	24797541	.	G	A	13	11	24	0	0	24	0	0
12	24797603	.	T	C	11	7	18	0	2	21	1	0
12	24797908	.	C	T	5	4	9	0	0	9	0	0
12	24798358	.	A	G	5	3	8	0	0	8	0	0
12	24811468	.	G	A	2	4	6	0	0	6	0	0
12	24842121	.	G	A	15	16	31	0	0	31	0	0
12	24842267	.	T	G	23	9	32	0	2	34	0	0
12	24843292	.	C	T	0	16	16	0	13	29	0	0
12	24843424	.	T	C	17	0	17	0	14	31	0	0
12	24843451	.	C	T	15	6	21	0	2	23	0	0
12	24847330	.	T	G	15	10	25	0	0	25	0	0
12	24848399	.	G	A	3	4	7	0	0	7	0	0
12	24851165	.	T	C	5	10	15	0	1	16	0	0
12	24851264	.	G	A	4	3	7	0	0	7	0	0
12	24851297	.	G	A	5	3	8	0	0	8	0	0
12	24857033	.	G	A	3	2	5	0	1	6	0	0
12	24857814	.	T	C	2	3	5	0	1	6	0	0
12	24904897	.	G	A	2	2	4	0	1	5	0	0
12	24906618	.	T	C	8	8	16	0	0	16	0	0
12	24910116	.	C	G	7	4	11	0	0	11	0	0
12	24913609	.	C	A	2	2	4	0	0	4	0	0
12	24953532	.	C	G	8	11	19	0	1	20	0	0
12	24957267	.	A	G	39	36	75	0	3	78	0	0
12	24957416	.	T	C	41	42	83	0	7	90	0	0
12	24957572	.	C	T	2	4	6	0	0	6	0	0
12	24957806	.	A	G	34	35	69	0	5	74	0	0
12	25043221	.	A	G	2	4	6	0	0	6	0	0
12	25044516	.	A	G	3	2	5	0	0	5	0	0
12	25044540	.	C	T	4	0	4	0	1	5	0	0
12	25044786	.	T	G	1	3	4	0	0	4	0	0
12	25094107	.	T	G	7	7	14	0	0	14	0	0
12	25094201	.	T	C	7	6	13	0	0	13	0	0
12	25094359	.	T	C	2	8	10	0	2	12	0	0
12	25094385	.	T	C	4	3	7	1	1	9	0	0
12	25149179	.	C	G	7	4	11	0	0	11	0	0
12	25149203	.	G	A	4	5	9	0	0	9	0	0
12	25266905	.	C	T	3	2	5	0	0	5	0	0
12	25284414	.	T	C	2	2	4	0	0	4	0	0
12	25284423	.	G	A	2	2	4	0	0	4	0	0
12	25377318	.	A	C	5	0	5	0	5	10	0	0
12	25377345	.	A	T	5	3	8	0	0	8	0	0
12	25377354	.	A	C	6	2	8	0	1	9	0	0
12	25377797	.	A	T	4	2	6	0	1	7	0	0
12	25377817	.	C	G	5	2	7	0	1	8	0	0
12	25378351	.	G	A	7	7	14	0	0	14	0	0
12	25378354	.	C	T	1	5	6	0	8	14	0	0
12	25378420	.	A	G	5	4	9	0	0	9	0	0
12	25378475	.	G	A	4	4	8	0	0	8	0	0
12	25378506	.	C	A	1	3	4	0	3	7	0	0
12	25468312	.	C	T	3	4	7	0	2	9	0	0
12	25472281	.	C	T	5	12	17	0	0	17	0	0
12	25472290	.	A	G	3	0	3	0	13	16	0	0
12	25484586	.	G	A	24	12	36	0	1	37	0	0
12	25484676	.	T	G	17	13	30	0	1	31	0	0
12	25485203	.	C	T	20	18	38	0	4	42	0	0
12	25485310	.	C	A	1	2	3	0	0	3	0	0
12	25485312	.	C	A	1	2	3	0	0	3	0	0
12	25485781	.	G	C	1	4	5	0	1	6	0	0
12	25486118	.	T	G	3	3	6	0	0	6	0	0
12	25486439	.	T	G	1	2	3	0	0	3	0	0
12	25600834	.	A	G	2	2	4	0	0	4	0	0
12	25602616	.	T	A	4	10	14	0	1	15	0	0
12	25602820	.	T	A	6	5	11	0	1	12	0	0
12	25602828	.	T	A	4	4	8	0	0	8	0	0
12	25703490	.	A	G	1	0	1	0	4	5	0	0
12	25713629	.	G	C	2	4	6	0	0	6	0	0
12	25714480	.	T	G	3	4	7	0	1	8	0	0
12	25754225	.	C	T	6	9	15	0	1	16	0	0
12	25768096	.	C	T	20	15	35	0	1	36	0	0
12	25768326	.	T	A	20	24	44	0	0	44	0	0
12	25768580	.	G	A	1	15	16	0	12	28	0	0
12	25768830	.	T	C	5	4	9	0	0	9	0	0
12	25769012	.	G	A	16	18	34	0	2	36	0	0
12	25769177	.	A	T	6	14	20	0	3	23	0	0
12	25769752	.	G	A	24	31	55	0	1	56	0	0
12	25769889	.	G	A	16	13	29	0	3	32	0	0
12	25829025	.	G	A	4	4	8	0	0	8	0	0
12	25829046	.	T	C	3	4	7	0	0	7	0	0
12	25829105	.	T	C	1	4	5	0	0	5	0	0
12	25846021	.	T	C	7	4	11	0	0	11	0	0
12	25856178	.	T	A	5	3	8	0	0	8	0	0
12	25861006	.	T	C	6	5	11	0	0	11	0	0
12	25866543	.	G	A	4	5	9	0	0	9	0	0
12	25872834	.	C	A	10	8	18	0	0	18	0	0
12	25872933	.	C	T	10	9	19	0	0	19	0	0
12	25872938	.	C	A	8	9	17	0	1	18	0	0
12	25873241	.	C	T	7	8	15	0	2	17	0	0
12	25873289	.	C	T	5	9	14	0	1	15	0	0
12	25881185	.	G	C	1	16	17	0	18	35	0	0
12	25881254	.	A	C	10	12	22	0	0	22	0	0
12	25881778	.	T	C	25	19	44	0	2	46	0	0
12	25886309	.	G	T	1	2	3	0	0	3	0	0
12	25886374	.	G	C	2	2	4	0	0	4	0	0
12	25887826	.	A	T	2	2	4	0	0	4	0	0
12	25887827	.	C	A	1	2	3	0	1	4	0	0
12	25950895	.	G	C	3	0	3	0	3	6	0	0
12	25951057	.	A	G	3	9	12	0	1	13	0	0
12	25951101	.	C	T	3	5	8	0	0	8	0	0
12	26203891	.	C	T	0	3	3	0	4	7	0	0
12	26203900	.	A	T	3	3	6	0	0	6	0	0
12	26227042	.	C	T	2	2	4	0	0	4	0	0
12	26410082	.	A	G	1	2	3	0	0	3	0	0
12	26411667	.	T	A	1	2	3	0	0	3	0	0
12	26476093	.	C	G	6	4	10	0	0	10	0	0
12	26476319	.	A	G	5	9	14	0	0	14	0	0
12	26476424	.	A	G	2	3	5	0	0	5	0	0
12	26486421	.	C	G	15	19	34	0	4	38	0	0
12	26486446	.	A	C	15	20	35	0	3	38	0	0
12	26486580	.	T	C	16	20	36	0	2	38	0	0
12	26486753	.	T	C	9	6	15	0	1	16	0	0
12	26486934	.	T	A	19	10	29	0	1	30	0	0
12	26487002	.	A	T	15	8	23	1	0	24	0	0
12	26487044	.	G	A	11	15	26	0	0	26	0	0
12	26487292	.	T	G	2	4	6	0	1	7	0	0
12	26489766	.	A	T	7	3	10	0	0	11	1	0
12	26493734	.	T	C	1	2	3	0	0	3	0	0
12	26493755	.	G	A	1	2	3	0	1	4	0	0
12	26493836	.	G	A	0	2	2	0	8	10	0	0
12	26493870	.	G	T	8	3	11	0	0	11	0	0
12	26524969	.	A	C	2	2	4	0	0	4	0	0
12	26546965	.	A	G	5	3	8	0	1	9	0	0
12	26546966	.	A	G	6	4	10	0	0	10	0	0
12	26547261	.	A	C	1	0	1	0	5	6	0	0
12	26547276	.	A	C	1	4	5	0	2	7	0	0
12	26547397	.	C	T	8	3	11	0	0	11	0	0
12	26549505	.	G	T	2	4	6	0	0	6	0	0
12	26611673	.	A	T	4	7	11	0	0	11	0	0
12	26612038	.	A	G	11	6	17	0	0	17	0	0
12	26612188	.	T	C	10	0	10	0	9	19	0	0
12	26612225	.	C	G	12	7	19	0	1	20	0	0
12	26612390	.	G	C	9	5	14	0	0	14	0	0
12	26617621	.	C	A	1	2	3	0	0	3	0	0
12	26708821	.	G	A	0	4	4	0	4	8	0	0
12	26724285	.	A	T	5	3	8	0	0	8	0	0
12	26724327	.	C	A	5	3	8	0	0	8	0	0
12	26724413	.	G	T	4	2	6	0	2	8	0	0
12	26724762	.	A	G	13	0	13	0	10	23	0	0
12	26724975	.	A	G	14	0	14	0	8	22	0	0
12	26724984	.	A	T	16	6	22	0	1	23	0	0
12	26725079	.	C	A	11	6	17	0	1	18	0	0
12	26725402	.	A	G	12	8	20	0	2	22	0	0
12	26750431	.	G	A	6	7	13	0	0	13	0	0
12	26750619	.	A	G	9	17	26	0	2	28	0	0
12	26750924	.	A	C	1	3	4	0	0	4	0	0
12	26751414	.	G	A	11	6	17	0	0	17	0	0
12	26751489	.	A	G	5	8	13	0	1	14	0	0
12	26752391	.	T	C	2	0	2	0	3	5	0	0
12	26752400	.	C	T	3	5	8	0	0	8	0	0
12	26752528	.	C	T	3	6	9	0	0	9	0	0
12	26752730	.	C	T	0	4	4	0	5	9	0	0
12	26752778	.	G	C	2	2	4	0	1	5	0	0
12	26752946	.	G	A	1	5	6	0	0	6	0	0
12	26758251	.	A	G	7	4	11	0	0	11	0	0
12	26758521	.	A	G	2	3	5	0	2	7	0	0
12	27023301	.	C	T	5	2	7	0	0	7	0	0
12	27023677	.	C	T	5	6	11	0	0	11	0	0
12	27024652	.	A	G	3	2	5	0	0	5	0	0
12	27024941	.	A	G	8	6	14	0	3	17	0	0
12	27025481	.	C	T	7	6	13	0	3	16	0	0
12	27026528	.	A	C	4	9	13	0	1	14	0	0
12	27029347	.	T	C	6	1	7	0	15	22	0	0
12	27029648	.	C	T	8	9	17	0	0	17	0	0
12	27030917	.	T	C	3	0	3	0	5	8	0	0
12	27059070	.	A	G	5	1	6	0	3	9	0	0
12	27059581	.	T	C	9	9	18	0	0	18	0	0
12	27059901	.	A	T	13	19	32	0	0	32	0	0
12	27059910	.	A	T	14	17	31	0	0	31	0	0
12	27060018	.	C	T	12	10	22	0	0	22	0	0
12	27060087	.	C	A	10	7	17	0	0	17	0	0
12	27060572	.	G	A	8	12	20	0	1	21	0	0
12	27086958	.	C	T	1	2	3	0	0	3	0	0
12	27087570	.	A	T	4	3	7	0	0	7	0	0
12	27087635	.	T	C	3	2	5	0	1	6	0	0
12	27087844	.	G	A	5	3	8	0	0	8	0	0
12	27088199	.	T	C	2	4	6	0	0	6	0	0
12	27088286	.	G	T	4	5	9	0	0	9	0	0
12	27088304	.	T	C	3	6	9	0	0	9	0	0
12	27088357	.	C	T	4	7	11	0	0	11	0	0
12	27088383	.	A	C	5	8	13	0	1	14	0	0
12	27088646	.	T	A	7	11	18	0	0	18	0	0
12	27088758	.	A	C	3	5	8	0	4	12	0	0
12	27088767	.	G	A	4	7	11	0	0	11	0	0
12	27088821	.	A	G	5	0	5	0	3	8	0	0
12	27088836	.	T	C	4	4	8	0	0	8	0	0
12	27089531	.	G	C	6	6	12	0	0	12	0	0
12	27089857	.	T	C	9	9	18	0	1	19	0	0
12	27090630	.	A	C	6	12	18	0	1	19	0	0
12	27090663	.	G	A	0	11	11	0	11	22	0	0
12	27090696	.	A	T	10	14	24	0	0	24	0	0
12	27090756	.	A	G	7	10	17	0	0	17	0	0
12	27090824	.	T	G	12	12	24	0	1	25	0	0
12	27090856	.	A	T	10	7	17	0	0	17	0	0
12	27090864	.	G	C	12	6	18	0	0	18	0	0
12	27090918	.	G	A	9	11	20	0	1	21	0	0
12	27091163	.	C	A	6	10	16	0	1	17	0	0
12	27091305	.	T	C	12	13	25	0	0	25	0	0
12	27114809	.	T	C	1	2	3	0	0	3	0	0
12	27207130	.	G	A	8	7	15	0	0	15	0	0
12	27207466	.	T	C	17	13	30	0	0	30	0	0
12	27219143	.	C	T	1	6	7	0	1	8	0	0
12	27219450	.	T	C	2	3	5	0	0	5	0	0
12	27219761	.	T	A	2	4	6	0	0	6	0	0
12	27219818	.	G	A	0	6	6	1	7	14	0	0
12	27220582	.	T	C	5	6	11	0	0	11	0	0
12	27221491	.	G	A	8	6	14	0	1	15	0	0
12	27221505	.	A	T	8	7	15	0	2	17	0	0
12	27224057	.	G	A	3	10	13	0	1	14	0	0
12	27224090	.	C	G	4	0	4	0	6	10	0	0
12	27224727	.	T	C	5	8	13	0	0	13	0	0
12	27229216	.	T	A	18	11	29	0	2	31	0	0
12	27229438	.	T	G	16	10	26	0	0	26	0	0
12	27229545	.	G	A	1	13	14	0	9	23	0	0
12	27236496	.	C	A	3	4	7	0	0	7	0	0
12	27236500	.	A	T	2	4	6	0	1	7	0	0
12	27241657	.	A	G	6	7	13	0	0	13	0	0
12	27242416	.	G	A	5	6	11	0	1	12	0	0
12	27243208	.	A	G	7	6	13	0	0	13	0	0
12	27243236	.	T	C	9	6	15	0	0	15	0	0
12	27303486	.	A	T	1	2	3	0	0	3	0	0
12	27303496	.	T	C	2	3	5	0	0	5	0	0
12	27303521	.	C	T	3	3	6	0	0	6	0	0
12	27304596	.	T	A	3	3	6	0	0	6	0	0
12	27304704	.	A	C	3	2	5	0	0	5	0	0
12	27305495	.	C	A	7	12	19	0	0	19	0	0
12	27305503	.	A	G	6	10	16	0	2	18	0	0
12	27559653	.	T	C	1	3	4	0	0	4	0	0
12	27568288	.	T	A	11	6	17	0	0	17	0	0
12	27570725	.	T	A	14	8	22	0	2	24	0	0
12	27570759	.	T	G	11	11	22	0	1	23	0	0
12	27570838	.	C	G	9	8	17	0	1	18	0	0
12	27570869	.	A	T	12	10	22	0	0	22	0	0
12	27570964	.	G	A	6	4	10	0	0	10	0	0
12	27570998	.	T	A	1	2	3	0	0	3	0	0
12	27571076	.	C	A	2	7	9	0	1	10	0	0
12	27571142	.	A	C	8	5	13	0	2	15	0	0
12	27571151	.	A	T	9	5	14	0	0	14	0	0
12	27571213	.	T	C	7	0	7	0	4	11	0	0
12	27571224	.	C	T	7	5	12	0	2	14	0	0
12	27571625	.	G	A	5	6	11	0	0	11	0	0
12	27573030	.	G	A	8	6	14	0	0	14	0	0
12	27573072	.	G	A	5	7	12	0	0	12	0	0
12	27575444	.	T	C	1	2	3	0	2	5	0	0
12	27602080	.	A	T	2	2	4	0	0	4	0	0
12	27615642	.	A	G	4	1	5	0	5	10	0	0
12	27622254	.	C	T	4	4	8	0	0	8	0	0
12	27622321	.	G	A	3	3	6	0	0	6	0	0
12	27622336	.	C	A	1	1	2	0	3	5	0	0
12	27627528	.	G	C	8	7	15	1	1	17	0	0
12	27665035	.	T	C	14	16	30	0	1	31	0	0
12	27665289	.	G	C	19	15	34	0	2	36	0	0
12	27665502	.	T	A	5	3	8	0	0	8	0	0
12	27665539	.	T	C	2	2	4	0	0	4	0	0
12	28180193	.	A	G	2	0	2	0	3	5	0	0
12	28350566	.	A	G	10	10	20	0	0	20	0	0
12	28351160	.	G	C	5	11	16	0	0	16	0	0
12	28355486	.	G	A	8	5	13	0	0	13	0	0
12	28367757	.	T	A	3	3	6	0	0	6	0	0
12	28369391	.	G	A	0	4	4	0	4	8	0	0
12	28369412	.	G	T	4	5	9	0	0	9	0	0
12	28369540	.	C	A	7	4	11	0	0	11	0	0
12	28369615	.	G	C	1	4	5	0	7	12	0	0
12	28369909	.	G	T	0	9	9	0	6	15	0	0
12	28369981	.	C	T	6	8	14	0	0	14	0	0
12	28370062	.	G	C	0	5	5	0	7	12	0	0
12	28370335	.	A	C	17	19	36	0	2	38	0	0
12	28370474	.	T	G	7	0	7	0	15	22	0	0
12	28377976	.	G	A	4	2	6	0	0	6	0	0
12	28378139	.	G	A	5	7	12	0	0	12	0	0
12	28378200	.	T	G	3	3	6	0	0	6	0	0
12	28378394	.	C	A	0	2	2	0	5	7	0	0
12	28378418	.	G	A	3	4	7	0	1	8	0	0
12	28379646	.	T	C	1	3	4	0	0	4	0	0
12	28379647	.	G	A	1	3	4	0	0	4	0	0
12	28379860	.	C	T	2	2	4	0	0	4	0	0
12	28559939	.	T	C	2	2	4	0	1	5	0	0
12	28560354	.	T	A	2	2	4	0	0	4	0	0
12	28560370	.	G	T	2	2	4	0	2	6	0	0
12	28560494	.	T	C	1	2	3	0	0	3	0	0
12	28560990	.	T	C	1	3	4	0	0	4	0	0
12	28668713	.	A	T	11	5	16	0	0	16	0	0
12	28676131	.	C	T	4	5	9	0	0	9	0	0
12	28676307	.	C	T	7	4	11	0	0	11	0	0
12	28676551	.	A	G	7	0	7	0	10	17	0	0
12	28676844	.	A	T	4	5	9	0	0	9	0	0
12	28677202	.	C	T	17	7	24	0	1	25	0	0
12	28677314	.	A	G	14	6	20	0	3	23	0	0
12	28677413	.	T	C	15	7	22	0	0	22	0	0
12	28677576	.	A	T	7	7	14	0	0	14	0	0
12	28801271	.	A	G	4	0	4	0	4	8	0	0
12	28802016	.	T	C	3	3	6	0	0	6	0	0
12	28806022	.	G	A	0	12	12	0	8	20	0	0
12	28806062	.	C	T	4	6	10	0	0	10	0	0
12	28806180	.	C	T	9	7	16	0	0	16	0	0
12	28806220	.	G	T	9	4	13	0	0	13	0	0
12	28806285	.	G	A	6	2	8	0	0	8	0	0
12	28806396	.	C	A	3	5	8	0	1	9	0	0
12	28806459	.	A	T	12	9	21	0	1	22	0	0
12	28806494	.	G	A	14	5	19	0	0	19	0	0
12	28806530	.	G	C	17	7	24	0	1	25	0	0
12	28806584	.	T	G	27	6	33	0	2	35	0	0
12	28806586	.	A	T	29	6	35	0	1	36	0	0
12	28828016	.	A	C	5	4	9	0	0	9	0	0
12	28828207	.	A	T	4	5	9	0	0	9	0	0
12	28828358	.	G	A	2	4	6	0	0	6	0	0
12	28830363	.	A	G	5	13	18	0	1	19	0	0
12	28844171	.	T	C	8	8	16	0	0	16	0	0
12	28847439	.	A	C	3	2	5	0	0	5	0	0
12	28863046	.	A	T	3	3	6	0	1	7	0	0
12	28863086	.	T	A	4	4	8	0	1	9	0	0
12	28863101	.	T	C	3	4	7	0	0	7	0	0
12	28863582	.	A	G	6	4	10	0	0	10	0	0
12	28863711	.	T	C	5	4	9	0	0	9	0	0
12	28863783	.	A	C	3	7	10	0	0	10	0	0
12	28863811	.	T	C	4	3	7	0	0	7	0	0
12	28864217	.	T	C	6	4	10	0	0	10	0	0
12	28864575	.	T	G	7	1	8	1	8	17	0	0
12	28864719	.	G	C	13	6	19	0	2	21	0	0
12	28864778	.	C	G	11	6	17	0	0	17	0	0
12	28864792	.	A	C	10	6	16	0	2	18	0	0
12	28864847	.	T	C	12	10	22	0	3	25	0	0
12	28865106	.	G	T	10	14	24	0	1	25	0	0
12	28865298	.	T	A	22	16	38	0	1	39	0	0
12	28865668	.	T	G	14	14	28	0	1	29	0	0
12	28865679	.	G	A	14	17	31	0	0	31	0	0
12	28865805	.	A	C	12	20	32	0	0	32	0	0
12	28870626	.	T	C	22	12	34	0	3	37	0	0
12	28870797	.	T	C	15	0	15	1	26	42	0	0
12	28870801	.	T	A	16	18	34	2	4	40	0	0
12	28870912	.	C	A	15	21	36	0	0	36	0	0
12	28871068	.	G	T	19	7	26	0	0	26	0	0
12	28871433	.	C	A	0	19	19	0	12	31	0	0
12	28878343	.	C	T	14	15	29	0	1	30	0	0
12	28889149	.	A	G	1	2	3	0	0	3	0	0
12	28924363	.	G	A	3	4	7	0	0	7	0	0
12	28927051	.	G	A	1	3	4	0	0	4	0	0
12	28930455	.	T	C	8	5	13	0	1	14	0	0
12	28932389	.	C	T	4	6	10	0	0	10	0	0
12	28932428	.	C	T	3	7	10	0	0	11	1	0
12	28932571	.	G	A	7	5	12	0	1	13	0	0
12	28932581	.	T	A	8	4	12	0	1	13	0	0
12	28959267	.	T	A	1	3	4	0	0	4	0	0
12	28960284	.	T	C	4	9	13	0	0	13	0	0
12	28960321	.	G	A	8	2	10	0	3	13	0	0
12	29102585	.	T	C	4	7	11	0	0	11	0	0
12	29103004	.	T	C	3	2	5	0	1	6	0	0
12	29103041	.	T	A	5	4	9	0	0	9	0	0
12	29105508	.	A	T	2	3	5	0	0	5	0	0
12	29105510	.	A	T	2	3	5	0	0	5	0	0
12	29207533	.	T	C	1	2	3	0	0	3	0	0
12	29207683	.	G	T	3	3	6	0	0	6	0	0
12	29209834	.	G	A	3	4	7	0	0	7	0	0
12	29209840	.	A	T	3	4	7	0	0	7	0	0
12	29209947	.	T	G	1	2	3	0	0	3	0	0
12	29210371	.	C	A	14	8	22	0	2	24	0	0
12	29210435	.	C	G	14	7	21	0	0	21	0	0
12	29210600	.	C	T	12	6	18	0	0	18	0	0
12	29210719	.	T	A	12	16	28	0	0	28	0	0
12	29210873	.	T	A	7	5	12	1	2	15	0	0
12	29210917	.	T	C	5	2	7	0	0	7	0	0
12	29211082	.	G	A	5	6	11	0	2	13	0	0
12	29211195	.	T	A	11	14	25	0	0	25	0	0
12	29211232	.	G	A	0	18	18	0	17	35	0	0
12	29211289	.	T	A	18	25	43	0	0	43	0	0
12	29211292	.	A	G	14	19	33	0	8	41	0	0
12	29223689	.	G	A	2	4	6	0	1	7	0	0
12	29223751	.	G	C	2	3	5	0	0	5	0	0
12	29223921	.	G	A	3	3	6	0	1	7	0	0
12	29224065	.	G	A	1	3	4	0	0	4	0	0
12	29224182	.	T	C	2	2	4	0	1	5	0	0
12	29224250	.	T	G	4	1	5	0	1	6	0	0
12	29224326	.	T	G	5	3	8	0	0	8	0	0
12	29224521	.	A	T	1	3	4	0	0	4	0	0
12	29224609	.	A	C	1	4	5	0	0	5	0	0
12	29226152	.	T	C	1	2	3	0	0	3	0	0
12	29251251	.	T	C	2	2	4	0	0	4	0	0
12	29266917	.	T	C	5	4	9	0	0	9	0	0
12	29269576	.	C	A	1	4	5	0	0	5	0	0
12	29269689	.	G	A	4	7	11	0	0	11	0	0
12	29269695	.	A	G	3	0	3	0	8	11	0	0
12	29269726	.	C	G	3	8	11	0	0	11	0	0
12	29269770	.	G	T	1	6	7	0	6	13	0	0
12	29269774	.	T	G	5	5	10	0	1	11	0	0
12	29350773	.	C	A	5	3	8	0	0	8	0	0
12	29351320	.	A	G	18	13	31	0	3	34	0	0
12	29351810	.	A	G	14	8	22	0	1	23	0	0
12	29358277	.	T	C	6	13	19	0	1	20	0	0
12	29358370	.	G	C	12	0	12	0	5	17	0	0
12	29358384	.	A	G	10	7	17	0	0	17	0	0
12	29358418	.	A	G	6	6	12	0	1	13	0	0
12	29624017	.	G	A	6	6	12	0	0	12	0	0
12	29843460	.	A	G	15	8	23	0	2	25	0	0
12	29844434	.	T	C	8	3	11	0	1	12	0	0
12	29873273	.	C	G	7	4	11	1	2	14	0	0
12	29921114	.	T	G	3	4	7	0	0	7	0	0
12	29947147	.	C	A	3	3	6	0	0	6	0	0
12	30036873	.	G	A	1	3	4	0	0	4	0	0
12	30216248	.	C	T	0	2	2	0	1	3	0	0
12	30217423	.	T	C	1	2	3	0	0	3	0	0
12	30217705	.	G	A	0	3	3	0	5	8	0	0
12	30217747	.	C	T	3	2	5	0	0	5	0	0
12	30218135	.	C	A	4	5	9	0	1	10	0	0
12	30218150	.	G	A	6	4	10	0	0	10	0	0
12	30218173	.	C	T	5	5	10	0	0	10	0	0
12	30219306	.	A	T	17	13	30	0	2	32	0	0
12	30219739	.	G	A	15	5	20	0	7	27	0	0
12	30219804	.	C	T	13	11	24	0	1	25	0	0
12	30303081	.	C	A	1	3	4	0	0	4	0	0
12	30307737	.	A	C	1	8	9	0	0	9	0	0
12	30307913	.	G	T	3	12	15	0	5	20	0	0
12	30382341	.	C	T	3	2	5	0	0	5	0	0
12	30382705	.	G	A	0	3	3	0	1	4	0	0
12	30391136	.	G	A	1	4	5	0	1	6	0	0
12	30418108	.	T	C	5	4	9	0	1	10	0	0
12	30418513	.	C	G	3	4	7	0	1	8	0	0
12	30419123	.	A	T	6	4	10	0	3	13	0	0
12	30419134	.	C	A	5	7	12	0	0	13	1	0
12	30419260	.	T	G	9	13	22	0	0	22	0	0
12	30419646	.	T	C	11	10	21	0	0	21	0	0
12	30419655	.	T	C	9	11	20	0	0	20	0	0
12	30419695	.	T	C	3	10	13	0	0	13	0	0
12	30419727	.	A	G	3	6	9	0	0	9	0	0
12	30442406	.	C	A	5	3	8	0	0	8	0	0
12	30442783	.	G	A	8	4	12	0	0	12	0	0
12	30443462	.	T	C	5	4	9	0	0	9	0	0
12	30458945	.	A	T	4	2	6	0	0	6	0	0
12	30459404	.	G	A	1	2	3	0	0	3	0	0
12	30459422	.	A	C	1	2	3	0	0	3	0	0
12	30460333	.	C	A	1	1	2	0	1	3	0	0
12	30566904	.	G	A	0	2	2	0	1	3	0	0
12	30566906	.	G	T	1	2	3	0	0	3	0	0
12	30741328	.	T	G	1	3	4	0	0	4	0	0
12	30796345	.	C	T	1	2	3	0	0	3	0	0
12	30803166	.	G	A	0	4	4	0	3	7	0	0
12	30803196	.	T	C	2	4	6	0	0	6	0	0
12	30803629	.	A	G	1	3	4	0	0	4	0	0
12	30805335	.	T	C	3	2	5	0	0	5	0	0
12	30805359	.	T	C	4	2	6	0	0	6	0	0
12	30805455	.	C	T	5	2	7	0	0	7	0	0
12	30806928	.	G	T	0	5	5	0	5	10	0	0
12	30807038	.	A	G	12	7	19	0	0	19	0	0
12	30807090	.	T	C	7	11	18	1	0	19	0	0
12	30807094	.	A	G	7	9	16	1	2	19	0	0
12	30807140	.	A	T	1	2	3	1	0	4	0	0
12	30807141	.	A	T	1	2	3	1	0	4	0	0
12	30807330	.	T	A	2	1	3	0	2	5	0	0
12	30807379	.	C	T	4	4	8	0	0	8	0	0
12	30807458	.	C	T	3	3	6	0	0	6	0	0
12	30807494	.	G	A	4	3	7	0	1	8	0	0
12	30807504	.	A	C	5	3	8	0	1	9	0	0
12	30807899	.	A	G	1	5	6	0	0	6	0	0
12	30808094	.	C	T	5	6	11	0	0	11	0	0
12	30808150	.	T	A	1	6	7	0	1	8	0	0
12	30808342	.	A	T	3	6	9	0	0	9	0	0
12	30808531	.	G	C	7	8	15	0	0	15	0	0
12	30808766	.	C	T	3	6	9	0	0	9	0	0
12	30808812	.	A	G	3	0	3	0	4	7	0	0
12	30808817	.	T	G	4	2	6	0	0	6	0	0
12	30979815	.	A	C	15	15	30	0	1	31	0	0
12	30980566	.	G	A	35	25	60	0	1	61	0	0
12	30980906	.	C	A	8	3	11	0	0	11	0	0
12	30981795	.	G	A	20	24	44	0	0	44	0	0
12	30986452	.	G	A	18	18	36	1	3	40	0	0
12	31102981	.	A	G	1	2	3	0	0	3	0	0
12	31435977	.	T	A	6	10	16	1	1	18	0	0
12	31438056	.	G	T	5	12	17	0	1	18	0	0
12	31438352	.	A	T	6	2	8	0	0	8	0	0
12	31479242	.	C	A	3	3	6	0	0	6	0	0
12	31528169	.	G	C	0	2	2	0	3	5	0	0
12	31532371	.	G	A	1	2	3	0	4	7	0	0
12	31532577	.	T	C	5	4	9	0	0	9	0	0
12	31532638	.	A	C	8	4	12	0	0	12	0	0
12	31532715	.	T	C	1	3	4	0	0	4	0	0
12	31533505	.	A	T	2	3	5	0	0	5	0	0
12	31533510	.	T	A	2	3	5	0	0	5	0	0
12	31629611	.	C	T	7	4	11	0	1	12	0	0
12	31630829	.	G	A	0	4	4	0	10	14	0	0
12	31631190	.	G	T	2	2	4	0	0	4	0	0
12	31704548	.	T	C	3	2	5	0	0	5	0	0
12	31708020	.	C	T	5	6	11	0	0	11	0	0
12	31708025	.	G	A	4	6	10	0	0	10	0	0
12	31708082	.	G	A	5	2	7	0	0	7	0	0
12	31708125	.	C	A	5	2	7	0	0	7	0	0
12	31709902	.	G	A	6	3	9	0	0	9	0	0
12	31709964	.	G	T	11	3	14	0	0	14	0	0
12	31720799	.	C	T	25	13	38	1	2	42	1	0
12	31721486	.	G	A	6	8	14	0	0	14	0	0
12	31722593	.	G	T	13	5	18	0	2	20	0	0
12	31722811	.	G	T	11	11	22	0	1	23	0	0
12	31722875	.	A	C	23	0	23	0	21	44	0	0
12	31724245	.	A	C	20	11	31	0	2	33	0	0
12	31724252	.	C	T	19	14	33	0	1	34	0	0
12	31753752	.	C	T	1	1	2	0	0	2	0	0
12	31753755	.	C	T	1	1	2	0	1	3	0	0
12	31764523	.	T	C	4	4	8	0	2	10	0	0
12	31764526	.	C	A	7	5	12	0	1	13	0	0
12	31765407	.	G	A	8	6	14	0	1	15	0	0
12	31765517	.	T	C	8	2	10	0	1	11	0	0
12	31765540	.	T	G	7	3	10	0	1	11	0	0
12	31783185	.	G	A	1	2	3	0	0	3	0	0
12	31785314	.	C	T	4	4	8	0	1	9	0	0
12	31789799	.	C	T	15	15	30	0	0	30	0	0
12	31794655	.	G	A	9	8	17	0	0	17	0	0
12	32039443	.	C	T	1	3	4	0	7	11	0	0
12	32039527	.	A	G	18	12	30	0	0	30	0	0
12	32039546	.	G	A	25	11	36	0	2	38	0	0
12	32039635	.	A	C	15	22	37	0	1	38	0	0
12	32039678	.	C	T	21	22	43	0	3	46	0	0
12	32039937	.	G	A	19	13	32	0	3	35	0	0
12	32039958	.	T	C	18	2	20	0	17	37	0	0
12	32040093	.	G	A	17	16	33	0	1	34	0	0
12	32045155	.	G	A	7	12	19	0	1	20	0	0
12	32045212	.	T	C	10	1	11	0	9	20	0	0
12	32051488	.	G	A	13	7	20	0	0	20	0	0
12	32066061	.	C	A	7	6	13	0	0	13	0	0
12	32068470	.	C	A	1	3	4	0	0	4	0	0
12	32068700	.	A	T	3	3	6	0	0	6	0	0
12	33151428	.	A	G	5	0	5	0	1	6	0	0
12	33151453	.	C	T	0	3	3	0	2	5	0	0
12	33440146	.	A	G	1	0	1	0	6	7	0	0
12	33604491	.	A	C	1	2	3	0	0	3	0	0
12	33738703	.	T	A	8	2	10	0	1	11	0	0
12	33797685	.	T	A	1	2	3	0	1	4	0	0
12	33966790	.	T	G	19	25	44	0	3	47	0	0
12	33966886	.	A	G	25	9	34	0	0	34	0	0
12	33966905	.	C	T	22	12	34	0	0	34	0	0
12	33967283	.	C	T	14	11	25	0	2	27	0	0
12	33968073	.	T	A	10	19	29	0	9	38	0	0
12	33971333	.	G	T	5	9	14	0	0	14	0	0
12	33972748	.	G	A	10	4	14	0	0	14	0	0
12	33982344	.	C	T	2	2	4	0	0	4	0	0
12	33988077	.	G	T	2	3	5	0	0	5	0	0
12	33988140	.	T	G	2	3	5	0	0	5	0	0
12	33988266	.	C	T	1	3	4	0	0	4	0	0
12	33988291	.	A	G	0	5	5	0	0	5	0	0
12	33988623	.	G	C	10	6	16	0	2	18	0	0
12	33988685	.	G	A	3	2	5	0	0	5	0	0
12	33988693	.	T	G	0	3	3	0	1	4	0	0
12	33991521	.	G	A	22	15	37	0	0	37	0	0
12	33991622	.	T	C	16	16	32	0	1	33	0	0
12	33991781	.	T	C	23	28	51	0	1	52	0	0
12	33991867	.	A	T	27	13	40	0	0	40	0	0
12	33991882	.	T	A	14	28	42	0	1	43	0	0
12	33991987	.	A	C	27	23	50	0	0	50	0	0
12	33992208	.	A	C	7	7	14	0	9	23	0	0
12	33992813	.	C	A	15	19	34	0	3	37	0	0
12	33993008	.	T	A	19	10	29	3	0	32	0	0
12	33993152	.	A	T	12	17	29	0	1	30	0	0
12	33993320	.	C	T	0	6	6	0	13	19	0	0
12	33997324	.	G	A	3	4	7	0	1	8	0	0
12	34187407	.	A	G	7	1	8	0	10	18	0	0
12	34192041	.	G	A	0	7	7	0	4	11	0	0
12	34192551	.	C	T	10	5	15	0	0	15	0	0
12	34192869	.	C	T	5	2	7	0	1	8	0	0
12	34192870	.	G	A	0	2	2	0	6	8	0	0
12	34209402	.	T	A	3	2	5	0	0	5	0	0
12	34219445	.	A	T	4	2	6	0	0	6	0	0
12	34219469	.	T	C	3	2	5	0	0	5	0	0
12	34434681	.	T	A	1	2	3	0	0	3	0	0
12	34563459	.	G	T	7	1	8	0	1	15	6	0
12	34563469	.	T	C	7	7	14	0	0	14	0	0
12	34564123	.	A	G	5	7	12	0	0	12	0	0
12	34564343	.	C	T	7	4	11	0	0	11	0	0
12	34564786	.	G	A	5	3	8	0	0	8	0	0
12	34564904	.	A	T	9	4	13	0	1	14	0	0
12	34565200	.	A	C	2	2	4	0	0	4	0	0
12	34565504	.	A	G	2	2	4	0	0	4	0	0
12	34566766	.	C	T	1	1	2	0	1	3	0	0
12	34581049	.	C	T	1	2	3	0	0	3	0	0
12	34581051	.	C	T	0	2	2	0	0	2	0	0
12	34732721	.	A	G	3	5	8	0	0	8	0	0
12	34732862	.	A	T	4	3	7	0	0	7	0	0
12	34732920	.	T	A	2	3	5	0	0	5	0	0
12	34810833	.	A	G	2	2	4	0	0	4	0	0
12	34820574	.	C	A	4	4	8	0	0	8	0	0
12	34821394	.	G	T	2	2	4	0	0	4	0	0
12	34821418	.	A	C	3	3	6	0	0	6	0	0
12	34822315	.	G	A	1	2	3	0	0	3	0	0
12	34822331	.	T	G	2	3	5	0	1	6	0	0
12	34826663	.	G	T	5	2	7	0	0	7	0	0
12	34840201	.	C	T	3	2	5	0	0	5	0	0
12	34841886	.	A	T	3	2	5	0	0	5	0	0
12	34841897	.	C	G	1	3	4	0	0	4	0	0
12	34841996	.	A	G	2	0	2	0	2	4	0	0
12	34845413	.	T	A	4	3	7	0	1	8	0	0
12	34845669	.	T	G	3	4	7	0	0	7	0	0
12	34845998	.	T	A	3	3	6	0	0	6	0	0
12	34845999	.	T	A	4	3	7	0	0	7	0	0
12	34847949	.	G	A	3	4	7	0	0	7	0	0
12	34847978	.	T	C	3	5	8	0	0	8	0	0
12	34851117	.	G	A	3	2	5	0	0	5	0	0
12	34876712	.	A	G	2	3	5	0	0	5	0	0
12	34876827	.	A	G	3	4	7	0	0	7	0	0
12	34877048	.	T	A	5	2	7	0	0	7	0	0
12	34883556	.	A	C	2	2	4	0	0	4	0	0
12	34883557	.	G	A	2	2	4	0	0	4	0	0
12	34891681	.	C	T	7	7	14	0	0	14	0	0
12	34891911	.	A	T	5	4	9	0	1	10	0	0
12	34892024	.	A	G	8	5	13	0	0	13	0	0
12	34892089	.	C	T	8	3	11	0	0	11	0	0
12	34892590	.	T	A	14	6	20	0	0	20	0	0
12	35012004	.	C	T	4	4	8	0	0	8	0	0
12	35012127	.	T	C	6	4	10	0	1	11	0	0
12	35018127	.	C	T	22	18	40	0	0	40	0	0
12	35018320	.	T	G	6	0	6	0	7	13	0	0
12	35018519	.	G	T	8	2	10	0	1	11	0	0
12	35021590	.	G	T	2	1	3	0	0	3	0	0
12	35021593	.	G	A	2	2	4	0	0	4	0	0
12	35051265	.	C	T	21	10	31	0	0	31	0	0
12	35082428	.	C	T	1	2	3	0	0	3	0	0
12	35099532	.	G	T	6	3	9	0	0	9	0	0
12	35099775	.	C	A	0	2	2	0	1	3	0	0
12	35103300	.	C	T	3	3	6	0	0	6	0	0
12	35191841	.	T	A	2	2	4	0	0	4	0	0
12	35328139	.	C	T	1	2	3	0	0	3	0	0
12	35334652	.	C	G	1	2	3	0	0	3	0	0
12	35339263	.	A	T	2	4	6	0	1	7	0	0
12	35346498	.	G	A	19	23	42	0	2	44	0	0
12	35346597	.	A	T	30	30	60	0	5	65	0	0
12	35346842	.	T	C	19	15	34	0	1	35	0	0
12	35346873	.	C	T	24	22	46	0	3	49	0	0
12	35347002	.	A	T	17	22	39	0	1	40	0	0
12	35347078	.	G	A	21	26	47	0	1	48	0	0
12	35347084	.	C	T	2	22	24	0	23	47	0	0
12	35347318	.	C	T	15	20	35	0	6	41	0	0
12	35347485	.	T	G	23	14	37	0	6	43	0	0
12	35347795	.	C	T	0	4	4	0	3	7	0	0
12	35347951	.	A	G	14	17	31	0	0	31	0	0
12	35350686	.	G	A	14	17	31	0	2	33	0	0
12	35351392	.	G	T	5	4	9	0	1	10	0	0
12	35381726	.	T	C	8	0	8	0	5	13	0	0
12	35381729	.	T	C	6	0	6	0	6	12	0	0
12	35386919	.	A	G	4	3	7	0	0	7	0	0
12	35543736	.	T	G	3	17	20	0	0	20	0	0
12	35543971	.	T	G	11	19	30	0	1	31	0	0
12	35544320	.	T	G	7	3	10	0	0	10	0	0
12	35544460	.	A	G	8	8	16	0	0	16	0	0
12	35544596	.	C	A	5	6	11	0	0	11	0	0
12	35544968	.	A	G	12	8	20	0	1	21	0	0
12	35593188	.	C	T	12	17	29	0	1	30	0	0
12	35593469	.	T	A	8	10	18	0	0	18	0	0
12	35593729	.	A	G	8	0	8	0	10	18	0	0
12	35594069	.	T	A	16	15	31	0	1	32	0	0
12	35594154	.	C	T	13	12	25	0	1	26	0	0
12	35594169	.	C	T	13	13	26	0	1	27	0	0
12	35594436	.	C	T	19	14	33	0	0	33	0	0
12	35594474	.	A	G	26	11	37	0	1	38	0	0
12	35594495	.	G	A	1	10	11	0	27	38	0	0
12	35594512	.	T	C	26	13	39	0	1	40	0	0
12	35594541	.	C	A	24	13	37	0	0	37	0	0
12	35594605	.	C	T	22	17	39	0	0	39	0	0
12	35594623	.	T	A	22	16	38	0	1	39	0	0
12	35674952	.	G	A	4	5	9	0	0	9	0	0
12	35689209	.	C	T	4	9	13	0	0	13	0	0
12	35689210	.	A	G	3	8	11	0	2	13	0	0
12	35704426	.	G	T	19	14	33	0	2	36	1	0
12	35704435	.	G	T	20	16	36	0	1	37	0	0
12	35704637	.	G	A	16	5	21	0	1	22	0	0
12	35704643	.	G	T	13	5	18	0	2	20	0	0
12	35704682	.	C	T	12	5	17	0	1	18	0	0
12	35704691	.	A	T	11	6	17	0	0	17	0	0
12	35704735	.	A	G	9	6	15	0	1	16	0	0
12	35704852	.	G	A	12	6	18	0	1	19	0	0
12	35704921	.	A	C	15	10	25	0	1	26	0	0
12	35704996	.	T	G	12	8	20	0	2	22	0	0
12	35705131	.	C	T	11	9	20	0	3	23	0	0
12	35705140	.	A	C	12	0	12	0	8	20	0	0
12	35705224	.	A	G	13	4	17	0	2	19	0	0
12	35705252	.	T	G	12	7	19	0	2	21	0	0
12	35705323	.	G	A	9	6	15	0	2	17	0	0
12	35705367	.	C	T	1	7	8	0	12	20	0	0
12	35705565	.	C	T	0	4	4	0	5	9	0	0
12	35705606	.	A	T	2	4	6	0	0	6	0	0
12	35705661	.	T	C	5	4	9	0	0	9	0	0
12	35705926	.	C	T	11	8	19	0	0	19	0	0
12	35706091	.	C	T	4	3	7	0	1	8	0	0
12	35706124	.	A	G	4	2	6	0	0	6	0	0
12	35706253	.	A	T	1	5	6	0	1	7	0	0
12	35706304	.	A	G	3	7	10	0	0	10	0	0
12	35706524	.	G	A	3	7	10	0	2	12	0	0
12	35706568	.	C	T	2	7	9	0	3	12	0	0
12	35706859	.	C	T	0	3	3	0	5	8	0	0
12	35706970	.	G	T	2	4	6	0	0	6	0	0
12	35707225	.	G	A	1	2	3	0	0	3	0	0
12	35707537	.	A	G	1	5	6	0	0	6	0	0
12	35707963	.	T	C	2	0	2	0	3	5	0	0
12	35707987	.	G	A	4	4	8	0	0	8	0	0
12	35708139	.	T	G	2	3	5	0	0	5	0	0
12	35837354	.	C	T	1	6	7	0	3	10	0	0
12	35837425	.	T	A	6	6	12	0	0	12	0	0
12	35837468	.	C	A	5	9	14	0	0	14	0	0
12	35837499	.	G	C	4	4	8	0	0	8	0	0
12	35837503	.	T	G	4	2	6	0	1	7	0	0
12	35837828	.	T	A	2	3	5	0	1	6	0	0
12	35837842	.	G	A	4	4	8	0	0	8	0	0
12	35838672	.	C	A	0	2	2	0	1	3	0	0
12	35838683	.	A	G	2	2	4	0	0	4	0	0
12	35839261	.	C	A	4	5	9	0	0	9	0	0
12	35839680	.	G	A	1	3	4	0	0	4	0	0
12	35839879	.	C	A	0	4	4	0	4	8	0	0
12	35839919	.	C	G	0	2	2	0	3	5	0	0
12	35839942	.	C	T	1	1	2	0	1	3	0	0
12	35841457	.	G	A	1	2	3	0	0	3	0	0
12	35963575	.	T	C	2	4	6	0	1	7	0	0
12	35967239	.	T	C	4	2	6	0	0	6	0	0
12	35980632	.	T	C	14	13	27	0	1	28	0	0
12	35980758	.	C	T	29	13	42	0	0	43	1	0
12	35980764	.	T	C	28	11	39	0	4	43	0	0
12	35980817	.	T	A	18	8	26	0	2	28	0	0
12	35981031	.	T	A	6	3	9	0	0	9	0	0
12	35981206	.	T	C	12	0	12	0	6	18	0	0
12	35981260	.	T	A	13	10	23	0	1	24	0	0
12	35981478	.	A	G	11	7	18	1	0	19	0	0
12	35981627	.	C	T	8	9	17	0	3	20	0	0
12	35981713	.	C	T	1	9	10	0	4	14	0	0
12	35981795	.	T	A	5	12	17	0	0	17	0	0
12	35981832	.	A	G	6	14	20	0	0	20	0	0
12	35988544	.	A	G	4	11	15	0	0	15	0	0
12	35988553	.	G	A	3	9	12	0	0	12	0	0
12	36135764	.	C	T	1	3	4	0	0	4	0	0
12	36158056	.	A	C	7	14	21	0	2	23	0	0
12	36158098	.	G	C	9	12	21	0	4	25	0	0
12	36158099	.	T	C	12	13	25	0	1	26	0	0
12	36158225	.	T	C	14	11	25	0	0	25	0	0
12	36158335	.	C	A	8	10	18	0	2	20	0	0
12	36158349	.	G	A	1	10	11	0	15	26	0	0
12	36158538	.	C	T	7	5	12	0	0	12	0	0
12	36159597	.	C	G	5	12	17	1	0	18	0	0
12	36416714	.	G	A	1	2	3	0	0	3	0	0
12	36416732	.	G	C	1	2	3	0	0	3	0	0
12	36420420	.	G	A	1	3	4	0	0	4	0	0
12	36422537	.	A	G	7	3	10	0	1	11	0	0
12	36422555	.	G	A	3	8	11	0	0	11	0	0
12	36422573	.	T	C	1	4	5	0	1	6	0	0
12	36424613	.	G	A	3	9	12	0	2	14	0	0
12	36424618	.	G	A	9	4	13	0	1	14	0	0
12	36471532	.	A	G	1	0	1	0	2	3	0	0
12	36670336	.	A	C	3	3	6	0	0	6	0	0
12	36671145	.	A	G	1	3	4	0	0	4	0	0
12	36952744	.	C	T	3	2	5	0	0	5	0	0
12	36960197	.	T	C	6	7	13	0	0	13	0	0
12	36960200	.	A	T	6	6	12	0	0	13	1	0
12	37004290	.	A	C	2	2	4	0	0	4	0	0
12	37004295	.	C	T	2	2	4	0	0	4	0	0
12	37004893	.	G	A	0	2	2	0	1	3	0	0
12	37004922	.	T	C	2	1	3	0	0	3	0	0
12	37275712	.	A	T	3	2	5	0	0	5	0	0
12	37275719	.	G	T	3	3	6	0	0	6	0	0
12	37275835	.	T	C	5	3	8	0	0	8	0	0
12	37407249	.	G	T	4	4	8	0	0	8	0	0
12	37407392	.	T	A	5	8	13	0	0	13	0	0
12	37407477	.	T	C	2	4	6	0	2	8	0	0
12	37407524	.	C	A	7	8	15	0	0	15	0	0
12	37407632	.	T	A	2	7	9	0	2	11	0	0
12	37407813	.	C	T	7	7	14	0	1	15	0	0
12	37408206	.	A	G	2	4	6	0	0	6	0	0
12	37408232	.	T	A	2	6	8	0	0	8	0	0
12	37408442	.	G	C	4	5	9	0	1	10	0	0
12	37409269	.	C	T	1	4	5	0	0	5	0	0
12	37409315	.	C	T	0	3	3	0	3	6	0	0
12	37409802	.	C	T	1	3	4	0	0	4	0	0
12	37409836	.	T	G	3	2	5	0	0	5	0	0
12	37410018	.	T	C	1	0	1	0	3	4	0	0
12	37410034	.	C	T	1	3	4	0	0	4	0	0
12	37463606	.	T	C	3	0	3	0	11	14	0	0
12	38561258	.	C	A	16	13	29	0	4	33	0	0
12	38799627	.	C	T	1	2	3	0	1	4	0	0
12	38799678	.	C	G	1	3	4	0	0	4	0	0
12	38802875	.	T	C	2	2	4	0	0	4	0	0
12	38803411	.	A	G	2	0	2	0	11	13	0	0
12	38804166	.	G	T	2	4	6	0	0	6	0	0
12	38804305	.	A	G	5	9	14	0	1	15	0	0
12	38804314	.	C	T	10	7	17	0	0	17	0	0
12	38804350	.	G	A	5	8	13	0	1	14	0	0
12	38804466	.	G	A	5	6	11	0	3	14	0	0
12	38804538	.	A	C	3	5	8	0	1	9	0	0
12	38855344	.	G	A	0	1	1	0	3	4	0	0
12	40497143	.	T	C	3	3	6	0	0	6	0	0
12	40518043	.	T	C	8	4	12	0	0	12	0	0
12	40518088	.	C	T	5	7	12	0	0	12	0	0
12	40518094	.	T	C	4	7	11	0	0	11	0	0
12	40945971	.	C	T	0	5	5	0	0	5	0	0
12	40945980	.	C	T	2	3	5	0	1	6	0	0
12	41000900	.	G	A	0	8	8	0	4	12	0	0
12	41000969	.	A	G	4	1	5	0	2	7	0	0
12	41028626	.	G	A	0	5	5	0	7	12	0	0
12	41037024	.	A	C	6	4	10	0	0	10	0	0
12	41071775	.	T	C	9	9	18	0	0	18	0	0
12	41071841	.	T	C	6	5	11	0	0	11	0	0
12	41112962	.	C	T	7	4	11	0	0	11	0	0
12	41113007	.	T	C	7	6	13	0	0	13	0	0
12	41113040	.	G	A	9	9	18	0	1	19	0	0
12	41113049	.	C	A	9	11	20	0	0	20	0	0
12	41113313	.	A	T	13	16	29	0	1	30	0	0
12	41113489	.	G	T	1	10	11	0	9	20	0	0
12	41437046	.	G	A	4	3	7	0	0	7	0	0
12	41449931	.	C	T	2	2	4	1	0	5	0	0
12	41461321	.	A	T	7	3	10	0	0	10	0	0
12	41541259	.	C	T	1	6	7	0	0	7	0	0
12	41547505	.	A	G	1	5	6	0	3	9	0	0
12	41549214	.	G	A	0	3	3	0	5	8	0	0
12	41549404	.	C	G	8	3	11	0	0	11	0	0
12	41549413	.	G	T	4	8	12	0	1	13	0	0
12	41549476	.	T	C	8	6	14	0	3	17	0	0
12	41581092	.	A	G	7	16	23	0	2	25	0	0
12	41581257	.	A	T	15	10	25	1	2	28	0	0
12	41593093	.	T	A	2	2	4	0	0	4	0	0
12	41631703	.	A	T	10	5	15	0	1	16	0	0
12	41632117	.	A	G	13	32	45	0	3	48	0	0
12	41633644	.	C	A	1	27	28	0	11	39	0	0
12	41636655	.	C	T	23	8	31	0	0	31	0	0
12	41636658	.	G	T	23	9	32	0	0	32	0	0
12	41643177	.	T	A	11	11	22	0	0	22	0	0
12	41643178	.	C	T	11	11	22	0	0	22	0	0
12	41643214	.	C	T	10	7	17	0	1	18	0	0
12	41643217	.	G	A	10	6	16	0	1	17	0	0
12	41647273	.	T	C	5	8	13	0	0	13	0	0
12	41647312	.	C	T	2	10	12	0	0	12	0	0
12	41653151	.	G	A	5	3	8	0	0	8	0	0
12	41656554	.	G	A	10	13	23	0	0	23	0	0
12	41661349	.	C	T	5	2	7	0	0	7	0	0
12	41684634	.	G	A	5	2	7	0	1	8	0	0
12	41698056	.	G	A	3	6	9	0	0	9	0	0
12	41702044	.	A	C	12	13	25	1	1	27	0	0
12	41723148	.	T	A	4	3	7	0	2	9	0	0
12	41723310	.	C	T	1	8	9	0	9	18	0	0
12	41723457	.	G	A	13	10	23	0	0	23	0	0
12	41723477	.	C	T	8	6	14	0	1	15	0	0
12	41723501	.	A	T	0	2	2	0	2	4	0	0
12	41723608	.	T	A	17	9	26	0	0	26	0	0
12	41723747	.	C	T	9	3	12	0	0	12	0	0
12	41732013	.	C	T	0	2	2	0	5	7	0	0
12	41735790	.	T	C	2	5	7	0	1	8	0	0
12	42007693	.	A	G	2	0	2	0	3	5	0	0
12	42153216	.	A	G	5	5	10	0	1	11	0	0
12	42182963	.	G	A	3	3	6	0	1	7	0	0
12	42186478	.	A	G	6	3	9	0	1	10	0	0
12	42195697	.	A	T	7	8	15	0	0	15	0	0
12	42196136	.	T	A	2	2	4	0	0	4	0	0
12	42196571	.	T	A	3	3	6	0	1	7	0	0
12	42196924	.	A	G	8	6	14	0	0	14	0	0
12	42196933	.	T	G	9	8	17	0	0	17	0	0
12	42197558	.	G	T	1	3	4	0	0	4	0	0
12	42197711	.	A	G	5	3	8	0	1	9	0	0
12	42197717	.	G	A	0	3	3	0	5	8	0	0
12	42197759	.	G	A	3	6	9	0	0	9	0	0
12	42364556	.	G	C	2	0	2	0	2	4	0	0
12	42364589	.	G	A	3	3	6	0	0	6	0	0
12	42364605	.	C	T	0	4	4	0	1	5	0	0
12	42365144	.	T	C	2	0	2	0	2	4	0	0
12	42365175	.	G	T	1	3	4	0	0	4	0	0
12	42369685	.	C	T	2	6	8	0	18	26	0	0
12	42369848	.	G	A	18	9	27	0	0	27	0	0
12	42369912	.	A	G	15	11	26	0	1	27	0	0
12	42384900	.	G	T	6	3	9	0	0	9	0	0
12	42406178	.	C	T	2	4	6	0	1	7	0	0
12	42406510	.	A	T	1	2	3	0	0	3	0	0
12	42407038	.	A	T	1	2	3	0	0	3	0	0
12	42576815	.	C	T	10	16	26	0	1	27	0	0
12	42577187	.	C	T	16	16	32	0	3	35	0	0
12	42578117	.	A	T	11	4	15	0	0	15	0	0
12	42578505	.	A	T	25	22	47	0	4	51	0	0
12	42578698	.	A	G	7	0	7	0	5	12	0	0
12	42578958	.	A	G	10	9	19	0	3	24	2	0
12	42578996	.	T	A	15	11	26	0	9	35	0	0
12	43376709	.	C	T	0	12	12	0	9	21	0	0
12	43376960	.	A	T	4	3	7	0	0	7	0	0
12	43377281	.	G	C	7	7	14	0	1	15	0	0
12	43377505	.	A	T	7	8	15	0	1	16	0	0
12	43377558	.	T	C	1	2	3	0	0	3	0	0
12	43395955	.	A	G	1	3	4	0	0	4	0	0
12	46763332	.	T	C	6	2	8	1	0	9	0	0
12	47295939	.	C	T	5	3	8	0	0	8	0	0
12	47302828	.	C	T	3	2	5	0	0	5	0	0
12	47302831	.	G	A	3	1	4	0	1	5	0	0
12	47331864	.	C	T	8	3	11	0	0	11	0	0
12	47332185	.	A	G	2	7	9	0	0	9	0	0
12	47332326	.	C	A	6	2	8	0	0	8	0	0
12	47332389	.	G	A	7	7	14	0	0	14	0	0
12	47332575	.	A	G	6	8	14	0	0	14	0	0
12	47332635	.	G	A	8	8	16	0	0	16	0	0
12	47332827	.	C	T	9	8	17	0	2	19	0	0
12	47335257	.	C	T	4	7	11	0	0	11	0	0
12	47335472	.	C	T	7	5	12	0	0	12	0	0
12	47344423	.	T	C	15	17	32	0	0	32	0	0
12	47347875	.	C	T	9	3	12	2	0	14	0	0
12	47355358	.	T	G	21	17	38	0	1	39	0	0
12	47449481	.	C	T	1	3	4	0	0	4	0	0
12	47449997	.	G	A	1	5	6	0	0	6	0	0
12	47461255	.	G	A	2	3	5	0	0	5	0	0
12	47469850	.	G	C	1	3	4	0	0	4	0	0
12	47480404	.	G	A	1	1	2	0	1	3	0	0
12	47480434	.	A	G	3	0	3	0	3	6	0	0
12	47480469	.	A	T	1	5	6	0	1	7	0	0
12	47480536	.	A	C	2	4	6	0	0	6	0	0
12	47480565	.	T	A	2	4	6	0	1	7	0	0
12	47480728	.	A	G	4	0	4	0	7	11	0	0
12	47480731	.	T	A	5	5	10	0	2	12	0	0
12	47481112	.	T	G	4	12	16	0	2	18	0	0
12	47481229	.	G	C	0	10	10	0	4	14	0	0
12	47481611	.	G	A	12	7	19	2	1	22	0	0
12	47510101	.	T	C	4	3	7	0	2	9	0	0
12	47523795	.	A	C	12	17	29	0	1	30	0	0
12	47540933	.	T	C	18	28	46	0	3	49	0	0
12	47540934	.	C	T	17	26	43	0	5	48	0	0
12	47540999	.	A	C	17	14	31	0	4	35	0	0
12	47544222	.	T	C	7	0	7	0	3	10	0	0
12	47593373	.	G	A	1	2	3	0	1	4	0	0
12	47918804	.	G	A	0	3	3	0	3	6	0	0
12	47922396	.	C	T	3	8	11	0	0	11	0	0
12	47922414	.	G	A	7	3	10	0	0	10	0	0
12	48094399	.	A	T	3	2	5	0	0	5	0	0
12	48118165	.	G	A	5	3	8	0	0	8	0	0
12	48118438	.	G	A	1	2	3	0	0	3	0	0
12	48118442	.	A	C	1	2	3	0	0	3	0	0
12	48118598	.	A	T	2	2	4	0	0	4	0	0
12	48118981	.	G	A	5	3	8	0	0	8	0	0
12	48119048	.	G	A	4	2	6	0	0	6	0	0
12	48119153	.	T	G	3	7	10	0	1	11	0	0
12	48119855	.	C	T	0	3	3	0	3	6	0	0
12	48120110	.	T	C	1	2	3	0	0	3	0	0
12	48133239	.	G	A	5	4	9	0	3	12	0	0
12	48137949	.	G	A	7	3	10	0	2	12	0	0
12	48138307	.	A	G	1	2	3	0	0	3	0	0
12	48146371	.	C	T	2	2	4	0	0	4	0	0
12	48146395	.	G	T	2	2	4	0	0	4	0	0
12	48211906	.	T	C	2	2	4	0	0	4	0	0
12	48228265	.	A	C	7	6	13	0	1	14	0	0
12	48231039	.	G	A	1	6	7	0	3	10	0	0
12	48231108	.	G	T	9	4	13	0	1	14	0	0
12	48239927	.	C	T	7	7	14	0	1	15	0	0
12	48319235	.	A	T	7	5	12	0	0	12	0	0
12	48327550	.	T	G	7	9	16	0	1	17	0	0
12	48340578	.	G	A	9	3	12	0	2	14	0	0
12	48341936	.	G	A	2	11	13	0	9	22	0	0
12	48349836	.	C	T	2	6	8	0	9	17	0	0
12	48367360	.	C	T	1	8	9	0	6	15	0	0
12	48367442	.	T	G	5	6	11	0	0	11	0	0
12	48432716	.	G	T	3	2	5	0	0	5	0	0
12	48469825	.	C	T	15	17	32	0	2	34	0	0
12	48476965	.	A	T	19	19	38	0	3	41	0	0
12	48476995	.	T	C	8	0	8	0	12	20	0	0
12	48680110	.	C	G	5	3	8	0	0	8	0	0
12	48680163	.	A	T	6	3	9	0	0	9	0	0
12	48681826	.	A	T	6	5	11	0	0	11	0	0
12	48681827	.	T	A	6	4	10	0	1	11	0	0
12	48682530	.	G	C	5	8	13	0	1	14	0	0
12	48804074	.	G	C	5	8	13	0	0	13	0	0
12	48810338	.	C	T	21	17	38	1	0	39	0	0
12	48810557	.	G	T	1	13	14	0	14	28	0	0
12	48810558	.	C	T	14	12	26	0	1	27	0	0
12	48810865	.	C	T	5	8	13	0	1	14	0	0
12	48811035	.	T	C	11	11	22	0	0	22	0	0
12	48826364	.	C	T	7	6	13	0	0	13	0	0
12	48832417	.	C	A	5	5	10	0	0	10	0	0
12	48833090	.	T	C	2	8	10	0	2	12	0	0
12	48833165	.	C	T	7	6	13	0	3	16	0	0
12	48836348	.	A	G	12	10	22	0	1	23	0	0
12	48836482	.	G	A	16	13	29	0	1	30	0	0
12	48959630	.	G	A	5	2	7	0	0	7	0	0
12	48979161	.	T	C	6	0	6	1	9	16	0	0
12	48979219	.	T	C	2	0	2	0	6	8	0	0
12	48979234	.	T	C	3	0	3	0	4	7	0	0
12	48979362	.	A	C	11	0	11	0	4	15	0	0
12	48979609	.	C	T	0	3	3	0	4	7	0	0
12	49004058	.	C	T	2	10	12	0	4	16	0	0
12	49004071	.	C	T	2	11	13	0	8	21	0	0
12	49005119	.	G	T	9	6	15	2	2	19	0	0
12	49005150	.	T	C	13	8	21	0	0	21	0	0
12	49010585	.	C	T	1	2	3	0	0	3	0	0
12	49035182	.	G	A	1	2	3	0	2	5	0	0
12	49035269	.	C	T	3	2	5	0	0	5	0	0
12	49037439	.	C	A	1	4	5	0	0	5	0	0
12	49037568	.	G	A	0	3	3	0	1	4	0	0
12	49037721	.	G	A	0	2	2	0	1	3	0	0
12	49100407	.	A	C	3	2	5	0	0	5	0	0
12	49100585	.	G	C	2	6	8	0	0	8	0	0
12	49114550	.	G	T	2	14	16	0	11	27	0	0
12	49125593	.	G	A	0	2	2	0	1	3	0	0
12	49125898	.	C	T	1	2	3	0	0	3	0	0
12	49125949	.	A	G	4	2	6	0	0	6	0	0
12	49148399	.	A	G	7	14	21	0	2	23	0	0
12	49159802	.	A	G	12	12	24	10	3	37	0	0
12	49160120	.	G	A	4	12	16	13	2	31	0	0
12	49161860	.	T	C	6	11	17	12	3	32	0	0
12	49166926	.	C	T	9	7	16	0	0	16	0	0
13	10935	.	C	T	6	2	8	0	0	8	0	0
13	11043	.	G	C	3	7	10	0	0	10	0	0
13	12252	.	C	G	11	19	30	0	3	33	0	0
13	40594	.	A	G	3	4	7	0	0	7	0	0
13	40622	.	C	G	2	4	6	0	1	7	0	0
13	40868	.	A	T	14	11	25	0	1	26	0	0
13	40965	.	T	G	5	19	24	0	1	25	0	0
13	41161	.	C	T	1	9	10	0	5	15	0	0
13	41529	.	A	G	2	4	6	0	1	7	0	0
13	42182	.	C	G	2	3	5	0	0	5	0	0
13	42771	.	C	T	1	4	5	0	1	6	0	0
13	46625	.	T	C	18	1	19	0	14	33	0	0
13	46637	.	G	A	17	12	29	0	0	30	1	0
13	49070	.	T	G	6	15	21	1	0	22	0	0
13	84188	.	T	A	3	3	6	0	0	6	0	0
13	111311	.	C	G	4	0	4	0	3	7	0	0
13	111572	.	G	A	0	6	6	0	1	7	0	0
13	111804	.	C	T	5	3	8	0	0	8	0	0
13	112606	.	G	A	2	2	4	0	1	5	0	0
13	112666	.	C	G	4	7	11	1	0	12	0	0
13	112705	.	C	G	6	3	9	1	0	10	0	0
13	214111	.	C	G	4	9	13	0	0	13	0	0
13	216562	.	A	G	15	18	33	0	0	33	0	0
13	217848	.	A	C	17	20	37	0	4	41	0	0
13	220842	.	T	C	15	1	16	0	9	25	0	0
13	220874	.	T	A	11	14	25	0	1	26	0	0
13	221131	.	C	A	12	6	18	0	0	18	0	0
13	221478	.	G	C	15	10	25	0	2	28	1	0
13	237954	.	T	C	33	18	51	0	1	52	0	0
13	269861	.	C	T	0	9	9	0	6	15	0	0
13	270083	.	G	A	11	14	25	0	0	25	0	0
13	270110	.	C	T	1	7	8	0	15	23	0	0
13	271736	.	G	A	6	3	9	0	0	9	0	0
13	281330	.	T	C	24	16	40	1	3	44	0	0
13	281405	.	T	G	26	0	26	0	18	44	0	0
13	321752	.	C	T	0	9	9	0	10	19	0	0
13	322033	.	G	A	10	7	17	0	2	19	0	0
13	325797	.	G	A	7	6	13	0	0	13	0	0
13	329835	.	G	C	5	4	9	0	0	9	0	0
13	329876	.	C	T	4	13	17	0	1	18	0	0
13	329922	.	G	A	9	3	12	0	0	12	0	0
13	343143	.	T	C	5	0	5	0	5	10	0	0
13	343336	.	G	T	9	8	17	0	0	17	0	0
13	343363	.	T	C	4	0	4	0	9	13	0	0
13	343510	.	C	T	1	9	10	0	0	10	0	0
13	353178	.	T	C	2	2	4	0	0	4	0	0
13	353686	.	C	T	5	3	8	0	0	8	0	0
13	421350	.	G	T	0	4	4	0	5	9	0	0
13	422990	.	T	C	4	4	8	0	0	8	0	0
13	425044	.	G	C	2	5	7	0	1	8	0	0
13	425063	.	C	T	3	2	5	0	2	7	0	0
13	425087	.	C	T	7	6	13	0	1	14	0	0
13	428646	.	G	A	12	11	23	0	0	23	0	0
13	428766	.	C	T	14	11	25	0	0	25	0	0
13	428841	.	C	T	13	13	26	0	1	27	0	0
13	429087	.	C	T	15	12	27	0	0	27	0	0
13	429144	.	A	G	11	1	12	0	17	29	0	0
13	429429	.	A	G	22	0	22	0	19	41	0	0
13	429514	.	C	T	22	7	29	0	0	29	0	0
13	429846	.	C	A	29	15	44	0	0	44	0	0
13	433939	.	C	T	1	4	5	0	0	5	0	0
13	433975	.	G	A	0	5	5	0	1	6	0	0
13	450040	.	C	T	1	5	6	0	5	11	0	0
13	450101	.	C	T	12	6	18	0	0	18	0	0
13	452598	.	C	A	9	7	16	0	1	17	0	0
13	452615	.	G	T	5	9	14	0	0	14	0	0
13	455473	.	G	A	4	5	9	0	0	9	0	0
13	462904	.	T	G	2	2	4	0	0	4	0	0
13	462925	.	A	G	0	3	3	0	0	3	0	0
13	483021	.	A	G	2	2	4	0	0	4	0	0
13	490479	.	C	G	4	0	4	0	6	10	0	0
13	514385	.	C	T	23	14	37	0	2	39	0	0
13	514664	.	G	A	6	9	15	0	2	17	0	0
13	514790	.	T	A	4	4	8	0	1	9	0	0
13	516347	.	G	C	11	4	15	0	1	16	0	0
13	516358	.	T	G	11	4	15	0	1	16	0	0
13	517163	.	G	T	14	12	26	0	0	26	0	0
13	518113	.	T	C	10	1	11	0	18	29	0	0
13	518915	.	G	A	11	4	15	0	1	16	0	0
13	522036	.	G	T	6	5	11	0	2	13	0	0
13	526943	.	G	A	2	3	5	0	1	6	0	0
13	527832	.	C	T	4	5	9	0	1	10	0	0
13	555325	.	C	T	8	7	15	0	0	15	0	0
13	555326	.	G	A	7	7	14	0	0	14	0	0
13	555751	.	C	G	6	2	8	0	2	10	0	0
13	556437	.	T	C	3	0	3	0	3	6	0	0
13	809779	.	A	G	6	8	14	1	1	16	0	0
13	1655881	.	C	T	7	2	9	0	0	9	0	0
13	2427331	.	T	C	1	5	6	0	2	8	0	0
13	2427355	.	T	C	5	2	7	0	1	8	0	0
13	2814421	.	T	C	7	4	11	0	0	11	0	0
13	2819432	.	C	T	7	6	13	0	0	13	0	0
13	2824513	.	T	C	11	6	17	0	0	17	0	0
13	2826324	.	A	G	12	0	12	0	13	25	0	0
13	2826397	.	T	C	11	12	23	0	0	23	0	0
13	2826445	.	G	C	4	6	10	0	18	28	0	0
13	2826608	.	T	A	23	10	33	0	0	33	0	0
13	2826611	.	C	T	23	9	32	0	0	32	0	0
13	2827560	.	A	C	11	19	30	0	1	31	0	0
13	2827578	.	C	A	12	24	36	0	1	37	0	0
13	2827605	.	G	T	17	26	43	0	2	45	0	0
13	2827700	.	G	C	18	23	41	0	0	41	0	0
13	2827808	.	A	G	21	4	25	0	2	27	0	0
13	2827867	.	A	G	9	24	33	0	0	33	0	0
13	2827918	.	A	T	7	7	14	0	0	14	0	0
13	2827998	.	G	A	14	19	33	0	3	36	0	0
13	2828028	.	T	C	16	22	38	0	2	40	0	0
13	2897475	.	T	A	1	2	3	0	2	5	0	0
13	2913844	.	T	C	10	10	20	0	1	21	0	0
13	2927778	.	G	A	2	6	8	0	0	8	0	0
13	2927832	.	T	A	5	5	10	0	3	13	0	0
13	3881289	.	G	A	1	2	3	0	1	4	0	0
13	3915333	.	A	G	5	9	14	0	0	14	0	0
13	3915383	.	C	A	11	9	20	0	0	20	0	0
13	3915476	.	A	C	19	13	32	0	0	32	0	0
13	3915644	.	A	C	15	9	24	0	0	24	0	0
13	3915908	.	A	G	5	5	10	0	0	10	0	0
13	3919353	.	T	G	4	9	13	0	0	13	0	0
13	3919632	.	A	G	5	5	10	0	0	10	0	0
13	3919672	.	T	G	3	4	7	0	1	8	0	0
13	3919686	.	G	A	5	3	8	0	1	9	0	0
13	3942055	.	G	A	0	5	5	0	2	7	0	0
13	3945643	.	C	T	4	3	7	0	0	7	0	0
13	3950007	.	G	A	18	7	25	0	1	27	1	0
13	3950044	.	A	G	14	12	26	0	1	27	0	0
13	3950307	.	A	G	6	9	15	0	1	16	0	0
13	3950577	.	C	G	13	14	27	0	1	28	0	0
13	3950669	.	T	A	6	9	15	0	0	15	0	0
13	3958895	.	C	T	4	3	7	0	0	7	0	0
13	3958913	.	A	G	3	3	6	0	1	7	0	0
13	3965910	.	T	C	18	10	28	0	1	29	0	0
13	3966055	.	T	A	12	9	21	0	1	22	0	0
13	3980349	.	C	T	0	5	5	0	8	13	0	0
13	3980947	.	T	C	13	1	14	0	7	21	0	0
13	3980962	.	G	A	13	5	18	0	0	18	0	0
13	3980993	.	C	T	1	9	10	0	8	18	0	0
13	3981579	.	G	T	3	2	5	0	1	6	0	0
13	3981723	.	T	C	1	3	4	0	0	4	0	0
13	3981725	.	A	T	1	1	2	0	2	4	0	0
13	4213861	.	T	C	4	7	11	0	0	11	0	0
13	4226678	.	C	A	9	8	17	0	2	19	0	0
13	4231368	.	G	T	4	15	19	0	15	34	0	0
13	4231396	.	C	T	17	11	28	0	0	28	0	0
13	4231438	.	T	A	9	6	15	0	0	15	0	0
13	4231643	.	T	A	7	9	16	0	0	16	0	0
13	4232014	.	T	A	5	5	10	0	1	15	4	0
13	4232016	.	G	A	0	4	4	0	11	15	0	0
13	4232054	.	A	T	9	3	12	0	1	13	0	0
13	4232112	.	A	G	15	10	25	0	0	25	0	0
13	4232171	.	C	T	17	18	35	0	0	35	0	0
13	4232737	.	A	G	15	20	35	0	0	35	0	0
13	4233030	.	C	T	0	17	17	0	19	36	0	0
13	4233033	.	G	A	18	16	34	0	1	35	0	0
13	4233361	.	G	T	15	10	25	0	0	25	0	0
13	4233365	.	G	A	10	13	23	0	0	23	0	0
13	4233625	.	T	A	6	9	15	0	0	15	0	0
13	4233779	.	G	A	8	13	21	0	0	21	0	0
13	4233889	.	G	A	7	2	9	0	0	9	0	0
13	4233970	.	A	G	9	6	15	0	0	15	0	0
13	4234139	.	A	T	7	4	11	2	1	14	0	0
13	4234337	.	G	A	7	5	12	0	0	12	0	0
13	4234349	.	G	T	6	6	12	0	0	12	0	0
13	4234402	.	A	T	5	8	13	0	0	13	0	0
13	4238449	.	T	C	3	3	6	0	0	6	0	0
13	4247007	.	G	A	1	2	3	0	1	4	0	0
13	4256617	.	A	G	4	3	7	0	0	7	0	0
13	4307782	.	C	T	21	10	31	0	1	32	0	0
13	4308714	.	C	A	12	13	25	0	1	26	0	0
13	4308948	.	C	T	14	9	23	0	2	25	0	0
13	4308983	.	G	C	8	1	9	0	16	25	0	0
13	4309166	.	T	G	11	10	21	0	2	23	0	0
13	4309607	.	T	C	8	4	12	0	1	13	0	0
13	4309746	.	A	G	3	6	9	0	1	10	0	0
13	4309778	.	T	A	3	5	8	0	1	9	0	0
13	4309866	.	T	C	7	6	13	0	0	13	0	0
13	4310247	.	G	A	9	5	14	0	1	15	0	0
13	4310349	.	T	A	8	9	17	0	2	19	0	0
13	4310367	.	C	G	2	10	12	0	8	20	0	0
13	4310511	.	C	T	0	9	9	0	16	25	0	0
13	4310565	.	G	A	14	7	21	0	0	21	0	0
13	4310610	.	C	T	12	7	19	0	0	19	0	0
13	4311114	.	A	G	6	2	8	0	0	8	0	0
13	4311912	.	C	T	9	3	12	0	0	12	0	0
13	4339638	.	T	C	10	0	10	0	11	21	0	0
13	4343183	.	C	T	0	6	6	0	8	14	0	0
13	4343437	.	C	T	0	6	6	0	6	12	0	0
13	4343468	.	T	A	4	9	13	0	0	13	0	0
13	4343490	.	G	A	3	9	12	0	0	12	0	0
13	4344378	.	A	T	1	2	3	0	1	4	0	0
13	4347531	.	T	C	1	2	3	0	0	3	0	0
13	4399311	.	A	G	2	2	4	0	0	4	0	0
13	4657474	.	T	A	1	2	3	0	0	3	0	0
13	4951747	.	T	C	7	8	15	0	0	15	0	0
13	4956118	.	G	A	8	8	16	0	2	18	0	0
13	4956151	.	C	T	11	7	18	0	2	20	0	0
13	4968421	.	A	G	9	16	25	0	1	26	0	0
13	4968583	.	T	A	7	10	17	0	2	19	0	0
13	4968849	.	A	G	14	10	24	0	3	27	0	0
13	4968890	.	T	C	16	8	24	0	2	26	0	0
13	4968905	.	T	C	18	8	26	0	1	27	0	0
13	4973701	.	T	A	9	6	15	0	1	16	0	0
13	4973775	.	C	A	9	3	12	0	2	14	0	0
13	4973856	.	C	T	2	6	8	0	9	17	0	0
13	4973979	.	A	G	4	7	11	0	0	11	0	0
13	4977950	.	C	T	0	6	6	0	10	16	0	0
13	4977962	.	A	G	7	5	12	0	1	13	0	0
13	4978620	.	G	A	7	4	11	0	0	11	0	0
13	4978680	.	A	G	13	3	16	0	2	18	0	0
13	4978707	.	T	C	9	0	9	0	8	17	0	0
13	4978821	.	T	C	6	0	6	0	16	22	0	0
13	4979150	.	C	T	1	2	3	0	1	4	0	0
13	4979163	.	A	T	1	1	2	0	1	3	0	0
13	4979190	.	T	C	3	2	5	0	0	5	0	0
13	4979550	.	A	G	5	2	7	0	0	7	0	0
13	4979754	.	A	G	6	6	12	0	0	12	0	0
13	4995638	.	G	T	0	6	6	0	23	29	0	0
13	4995902	.	A	G	15	16	31	0	3	34	0	0
13	4995916	.	T	A	13	19	32	0	0	32	0	0
13	5000490	.	G	A	0	20	20	0	11	31	0	0
13	5000606	.	G	A	5	6	11	0	1	12	0	0
13	5000615	.	T	A	5	5	10	0	0	10	0	0
13	5013813	.	T	C	2	5	7	0	0	7	0	0
13	5013999	.	A	G	3	2	5	0	1	6	0	0
13	5017657	.	A	G	7	10	17	0	2	19	0	0
13	5017699	.	G	A	7	12	19	0	1	20	0	0
13	5017866	.	T	C	11	14	25	0	1	26	0	0
13	5244569	.	T	A	1	2	3	0	0	3	0	0
13	5251175	.	G	T	2	2	4	0	0	4	0	0
13	5491234	.	G	A	28	22	50	0	3	53	0	0
13	5531709	.	A	G	21	19	40	0	0	40	0	0
13	5568993	.	G	A	3	5	8	0	0	8	0	0
13	5569344	.	C	T	3	2	5	0	0	5	0	0
13	5572922	.	C	T	1	2	3	0	0	3	0	0
13	5978865	.	T	C	1	5	6	0	0	6	0	0
13	5978871	.	A	G	1	0	1	0	6	7	0	0
13	5987702	.	T	C	5	2	7	0	0	7	0	0
13	5987712	.	A	G	5	4	9	0	2	11	0	0
13	6092064	.	G	A	1	1	2	0	1	3	0	0
13	6092065	.	A	C	1	1	2	0	1	3	0	0
13	6092108	.	C	G	1	2	3	0	0	3	0	0
13	7054454	.	G	A	1	1	2	0	1	3	0	0
13	7062945	.	A	T	2	2	4	0	0	4	0	0
13	7062963	.	T	G	2	2	4	0	0	4	0	0
13	7063446	.	T	C	7	5	12	0	1	13	0	0
13	7063494	.	G	T	0	7	7	0	10	17	0	0
13	7063602	.	C	G	10	5	15	0	0	15	0	0
13	7063708	.	T	A	7	5	12	0	0	12	0	0
13	7063709	.	G	A	7	4	11	0	1	12	0	0
13	7170061	.	C	T	1	2	3	0	2	5	0	0
13	7243056	.	T	C	2	3	5	0	0	5	0	0
13	7243059	.	G	A	0	2	2	0	3	5	0	0
13	7243431	.	A	G	1	2	3	0	0	3	0	0
13	7243445	.	T	G	1	0	1	0	2	3	0	0
13	7243484	.	C	T	3	4	7	0	2	9	0	0
13	7243610	.	C	G	4	0	4	0	7	11	0	0
13	7258946	.	T	C	4	8	12	0	1	13	0	0
13	7310288	.	A	G	1	2	3	0	0	3	0	0
13	7312527	.	G	A	0	4	4	0	1	5	0	0
13	7312931	.	A	G	1	2	3	0	0	3	0	0
13	7313324	.	T	A	4	2	6	0	0	6	0	0
13	7313613	.	C	T	2	3	5	0	0	5	0	0
13	7313703	.	C	T	4	5	9	0	0	9	0	0
13	7313898	.	C	T	5	5	10	0	0	10	0	0
13	7314451	.	A	G	3	0	3	0	4	7	0	0
13	7314509	.	C	T	5	2	7	0	0	7	0	0
13	7314736	.	A	C	2	10	12	0	4	16	0	0
13	7314859	.	C	A	6	11	17	0	0	17	0	0
13	7315123	.	C	T	11	12	23	0	2	25	0	0
13	7315174	.	C	A	14	20	34	0	0	34	0	0
13	7315197	.	A	G	11	0	11	0	18	29	0	0
13	7315234	.	A	G	8	17	25	0	0	25	0	0
13	7316746	.	A	G	16	0	16	0	8	24	0	0
13	7316784	.	G	A	9	8	17	0	0	17	0	0
13	7316830	.	C	G	12	5	17	0	0	17	0	0
13	7316849	.	A	T	6	9	15	0	0	15	0	0
13	7316903	.	G	A	2	2	4	0	0	4	0	0
13	7346655	.	C	A	17	6	23	0	0	23	0	0
13	7346683	.	A	G	16	9	25	0	0	25	0	0
13	7346798	.	A	G	18	14	32	0	2	34	0	0
13	7346965	.	A	G	11	5	16	0	4	20	0	0
13	7346966	.	A	T	15	5	20	0	1	21	0	0
13	7347026	.	A	G	18	8	26	0	1	27	0	0
13	7347060	.	G	T	10	9	19	0	0	19	0	0
13	7347061	.	A	T	10	9	19	0	0	19	0	0
13	7744443	.	G	A	5	3	8	0	0	8	0	0
13	7744624	.	T	G	4	9	13	0	1	14	0	0
13	7745463	.	C	G	2	6	8	0	1	9	0	0
13	7747513	.	C	G	8	6	14	0	2	16	0	0
13	7747760	.	T	C	3	10	13	0	1	14	0	0
13	7747831	.	T	G	22	6	28	0	0	28	0	0
13	7747943	.	C	T	12	2	14	0	1	15	0	0
13	7748021	.	G	T	6	8	14	0	0	14	0	0
13	7748164	.	A	G	8	0	8	0	3	11	0	0
13	7748218	.	T	C	10	9	19	0	0	19	0	0
13	7748424	.	T	C	2	13	15	4	1	20	0	0
13	7748533	.	T	G	6	5	11	0	2	13	0	0
13	7748688	.	A	G	9	7	16	0	2	18	0	0
13	7748882	.	A	T	16	15	31	0	0	31	0	0
13	7748995	.	T	A	9	24	33	2	0	35	0	0
13	7749000	.	G	C	9	25	34	2	1	37	0	0
13	7755764	.	A	C	28	0	28	0	21	49	0	0
13	7759403	.	T	C	20	23	43	0	1	44	0	0
13	7766936	.	C	T	1	7	8	0	5	13	0	0
13	8142558	.	A	G	1	5	6	0	2	8	0	0
13	8152765	.	C	T	8	3	11	0	0	11	0	0
13	8152771	.	T	C	3	8	11	0	0	11	0	0
13	8169139	.	T	A	1	2	3	0	0	3	0	0
13	8169143	.	G	A	0	2	2	0	0	2	0	0
13	8950846	.	A	G	1	8	9	0	1	10	0	0
13	9315178	.	T	C	53	17	70	0	5	75	0	0
13	9315192	.	T	C	21	48	69	0	3	72	0	0
13	9557442	.	A	T	1	1	2	0	1	3	0	0
13	9825882	.	G	A	1	5	6	0	2	8	0	0
13	9828933	.	G	T	7	7	14	0	1	15	0	0
13	9829007	.	A	G	2	5	7	0	0	7	0	0
13	9829013	.	C	T	1	6	7	0	0	7	0	0
13	9829361	.	G	T	4	2	6	0	0	6	0	0
13	9829855	.	C	T	3	3	6	0	0	6	0	0
13	9829944	.	A	G	2	0	2	0	2	4	0	0
13	9830066	.	A	T	4	6	10	0	0	10	0	0
13	9830089	.	T	C	5	4	9	0	0	9	0	0
13	9830591	.	A	T	2	2	4	0	0	4	0	0
13	9830597	.	C	A	2	2	4	0	0	4	0	0
13	9844440	.	G	A	11	10	21	0	0	21	0	0
13	9844527	.	A	G	10	0	10	0	5	15	0	0
13	9848385	.	G	A	15	13	28	0	5	33	0	0
13	9848577	.	A	G	23	24	47	0	2	49	0	0
13	9855508	.	G	T	17	17	34	0	0	34	0	0
13	9855874	.	G	A	17	17	34	0	1	35	0	0
13	9856319	.	A	G	2	12	14	0	2	16	0	0
13	9856427	.	A	G	10	10	20	0	4	24	0	0
13	9856493	.	A	T	10	19	29	0	0	29	0	0
13	9856658	.	A	G	17	19	36	0	1	37	0	0
13	9863888	.	G	A	2	2	4	0	0	4	0	0
13	9903744	.	G	T	1	2	3	0	0	3	0	0
13	10361463	.	C	T	1	3	4	0	1	5	0	0
13	10362715	.	G	A	1	2	3	0	0	3	0	0
13	10362728	.	A	T	0	2	2	0	1	3	0	0
13	11443349	.	C	A	7	0	7	1	14	23	1	0
13	12665595	.	T	C	6	3	9	0	0	9	0	0
13	12993890	.	C	T	0	3	3	0	1	4	0	0
13	12993928	.	C	T	4	9	13	0	0	13	0	0
13	12994043	.	C	A	3	2	5	0	1	6	0	0
13	12994738	.	A	T	16	6	22	0	2	24	0	0
13	12994743	.	G	T	8	16	24	0	2	26	0	0
13	12997845	.	C	T	4	3	7	0	2	9	0	0
13	12997984	.	A	G	3	3	6	0	1	7	0	0
13	13001540	.	G	T	2	3	5	0	0	5	0	0
13	13008496	.	G	A	1	2	3	0	0	3	0	0
13	13091046	.	C	A	2	4	6	0	0	6	0	0
13	13091079	.	T	C	3	3	6	0	0	6	0	0
13	13213863	.	G	A	3	3	6	0	2	8	0	0
13	13214262	.	T	G	7	0	7	0	2	9	0	0
13	13214412	.	G	A	13	13	26	0	0	26	0	0
13	13214571	.	T	A	5	2	7	0	1	8	0	0
13	13214648	.	C	T	3	3	6	0	0	6	0	0
13	13214883	.	A	T	2	4	6	0	0	6	0	0
13	13215474	.	C	T	2	6	8	0	0	8	0	0
13	13216156	.	G	A	1	3	4	0	0	4	0	0
13	13699913	.	C	T	1	2	3	0	0	3	0	0
13	13733417	.	G	T	12	21	33	0	4	37	0	0
13	13997299	.	C	T	1	4	5	0	0	5	0	0
13	13997446	.	G	T	0	2	2	0	2	4	0	0
13	13997829	.	G	A	2	2	4	0	0	4	0	0
13	14002936	.	A	T	4	5	9	0	0	9	0	0
13	14002979	.	G	T	1	2	3	1	0	4	0	0
13	14003099	.	A	G	1	3	4	0	0	4	0	0
13	14004141	.	C	T	6	7	13	0	1	14	0	0
13	14004209	.	C	T	4	6	10	0	1	11	0	0
13	14004246	.	T	A	10	8	18	0	1	19	0	0
13	14137061	.	C	T	5	4	9	0	1	10	0	0
13	14181846	.	A	T	5	5	10	0	0	10	0	0
13	14181912	.	A	C	3	5	8	0	1	10	1	0
13	14181952	.	T	C	6	6	12	0	0	12	0	0
13	14190780	.	C	T	1	18	19	0	20	39	0	0
13	14191033	.	T	C	14	9	23	0	2	25	0	0
13	14191045	.	G	C	13	11	24	0	0	24	0	0
13	14191724	.	G	A	15	8	23	0	1	24	0	0
13	14192110	.	T	C	5	6	11	0	0	11	0	0
13	14192178	.	A	T	1	8	9	0	1	10	0	0
13	14192511	.	A	T	5	2	7	0	0	7	0	0
13	14194241	.	C	G	0	4	4	1	4	9	0	0
13	14194256	.	A	G	5	5	10	1	1	12	0	0
13	14194640	.	C	T	3	4	7	0	0	7	0	0
13	14194660	.	G	A	5	4	9	0	2	11	0	0
13	14194836	.	C	T	0	9	9	0	4	13	0	0
13	14194968	.	T	A	2	7	9	0	1	11	1	0
13	14199220	.	A	T	4	3	7	0	0	7	0	0
13	14220900	.	G	A	1	5	6	0	0	6	0	0
13	14902500	.	C	A	6	10	16	0	1	17	0	0
13	14902507	.	T	C	7	8	15	0	0	15	0	0
13	14902546	.	C	T	9	7	16	0	0	16	0	0
13	14902702	.	G	A	12	5	17	0	0	17	0	0
13	14906587	.	G	C	10	7	17	0	0	17	0	0
13	14906614	.	G	A	10	9	19	0	0	19	0	0
13	14906754	.	A	G	5	9	14	0	0	15	1	0
13	14915618	.	A	T	4	3	7	0	1	8	0	0
13	14915669	.	G	A	2	3	5	0	0	5	0	0
13	15213130	.	A	T	5	3	8	0	0	8	0	0
13	15215789	.	A	T	6	6	12	0	3	15	0	0
13	15580864	.	T	A	4	6	10	0	0	10	0	0
13	15580879	.	T	G	5	0	5	0	6	11	0	0
13	15580948	.	G	T	1	4	5	0	0	5	0	0
13	15647444	.	A	G	6	9	15	0	0	15	0	0
13	15657987	.	A	G	15	26	41	0	0	41	0	0
13	15668124	.	A	T	6	9	15	0	3	18	0	0
13	15725311	.	A	T	4	4	8	0	0	8	0	0
13	15762306	.	T	C	1	1	2	0	2	4	0	0
13	15762320	.	A	C	0	2	2	0	1	3	0	0
13	15762515	.	T	C	4	7	11	0	1	12	0	0
13	15763061	.	G	T	1	2	3	0	0	3	0	0
13	15800977	.	T	G	3	4	7	0	0	7	0	0
13	15801705	.	T	A	6	8	14	0	1	15	0	0
13	15801726	.	T	C	7	4	11	0	0	11	0	0
13	15814429	.	A	G	6	12	18	2	3	23	0	0
13	15814724	.	T	A	3	2	5	0	0	5	0	0
13	15816637	.	G	A	2	2	4	0	0	4	0	0
13	15848817	.	A	G	2	2	4	0	1	5	0	0
13	15848901	.	A	G	5	6	11	1	0	12	0	0
13	15849541	.	T	C	3	4	7	0	0	7	0	0
13	15869322	.	A	G	4	9	13	1	0	14	0	0
13	15872256	.	A	G	4	10	14	0	0	14	0	0
13	15880940	.	T	G	11	16	27	0	0	27	0	0
13	15882860	.	A	C	8	19	27	0	0	27	0	0
13	16191517	.	A	T	1	2	3	0	0	3	0	0
13	16268675	.	T	C	1	2	3	0	0	3	0	0
13	16313525	.	G	C	1	6	7	0	0	7	0	0
13	16413254	.	A	G	1	0	1	0	2	3	0	0
13	16436786	.	T	C	1	3	4	0	0	4	0	0
13	16474382	.	A	G	3	0	3	0	7	10	0	0
13	16479914	.	T	A	7	6	13	0	1	14	0	0
13	16496254	.	T	C	12	3	15	0	1	16	0	0
13	16496377	.	G	A	1	6	7	0	3	10	0	0
13	16496770	.	T	A	19	17	36	0	1	37	0	0
13	16760572	.	A	G	1	2	3	0	0	3	0	0
13	16782972	.	A	G	2	3	5	0	0	5	0	0
13	16856045	.	T	A	3	7	10	0	0	10	0	0
13	16871830	.	A	C	5	3	8	0	1	9	0	0
13	16878895	.	A	C	11	5	16	0	4	20	0	0
13	16886040	.	C	T	13	8	21	0	0	21	0	0
13	16886068	.	C	T	9	5	14	0	0	14	0	0
13	17470079	.	C	T	3	5	8	0	2	10	0	0
13	17470112	.	A	G	2	1	3	0	9	12	0	0
13	17470430	.	T	C	10	12	22	0	0	22	0	0
13	17702802	.	C	T	3	2	5	0	0	5	0	0
13	17703043	.	C	T	6	2	8	0	0	8	0	0
13	17703097	.	A	G	2	0	2	0	2	4	0	0
13	17703308	.	G	A	2	2	4	0	0	4	0	0
13	17705633	.	C	T	5	2	7	0	1	8	0	0
13	17705669	.	C	T	6	2	8	0	0	8	0	0
13	17705681	.	C	T	2	5	7	0	1	8	0	0
13	17714530	.	C	A	25	30	55	0	4	59	0	0
13	17714905	.	T	C	25	22	47	0	2	49	0	0
13	17714942	.	A	G	25	23	48	0	3	51	0	0
13	17717608	.	G	A	26	18	44	1	1	46	0	0
13	17752932	.	A	T	4	6	10	0	0	10	0	0
13	17753144	.	A	C	9	0	9	0	6	15	0	0
13	17753668	.	A	C	18	9	27	0	2	29	0	0
13	17753732	.	A	T	8	15	23	0	0	23	0	0
13	17753821	.	A	T	8	7	15	0	0	15	0	0
13	17755579	.	A	G	3	6	9	0	0	9	0	0
13	17755743	.	G	C	3	0	3	0	2	5	0	0
13	17755830	.	C	A	3	2	5	0	0	5	0	0
13	17755898	.	G	A	1	3	4	0	0	4	0	0
13	17756112	.	G	A	1	2	3	0	0	3	0	0
13	17756131	.	A	T	1	3	4	0	0	4	0	0
13	17756186	.	C	A	1	3	4	0	1	5	0	0
13	18019724	.	T	C	0	2	2	0	1	3	0	0
13	18019786	.	C	T	1	5	6	0	3	9	0	0
13	18024418	.	C	T	4	5	9	0	0	9	0	0
13	18024419	.	A	G	4	5	9	0	0	9	0	0
13	18073433	.	A	G	11	23	34	0	2	36	0	0
13	18073524	.	G	T	14	7	21	0	0	21	0	0
13	18073582	.	G	T	6	13	19	0	0	19	0	0
13	18073706	.	G	A	10	12	22	0	1	23	0	0
13	18076710	.	T	G	9	9	18	0	0	18	0	0
13	18076788	.	G	C	16	10	26	0	3	29	0	0
13	18076818	.	G	A	10	16	26	0	0	26	0	0
13	18076996	.	C	T	15	11	26	0	0	26	0	0
13	18077056	.	G	T	10	12	22	0	3	25	0	0
13	18077116	.	G	A	8	9	17	0	1	18	0	0
13	18077191	.	C	G	9	6	15	0	2	17	0	0
13	18080348	.	G	A	10	3	13	0	0	13	0	0
13	18080411	.	G	T	2	6	8	0	1	9	0	0
13	18083391	.	C	T	0	4	4	0	4	8	0	0
13	18087946	.	G	A	1	4	5	0	0	5	0	0
13	18088276	.	T	G	5	7	12	0	0	12	0	0
13	18092084	.	A	G	4	4	8	0	0	8	0	0
13	18092108	.	T	C	2	2	4	0	1	5	0	0
13	18092417	.	A	G	1	2	3	0	1	4	0	0
13	18099947	.	T	C	3	0	3	0	6	9	0	0
13	18105175	.	G	A	1	2	3	0	0	3	0	0
13	18110003	.	T	C	1	0	1	0	4	5	0	0
13	18179391	.	G	C	4	0	4	0	9	13	0	0
13	18179521	.	A	G	3	8	11	0	1	12	0	0
13	18179535	.	G	T	2	7	9	0	1	10	0	0
13	18179757	.	T	C	8	14	22	0	2	24	0	0
13	18179859	.	C	A	9	12	21	0	2	23	0	0
13	18185457	.	A	C	5	0	5	0	2	7	0	0
13	18185463	.	C	A	4	2	6	0	0	6	0	0
13	18314113	.	T	G	4	0	4	0	2	6	0	0
13	18321156	.	T	C	2	5	7	0	0	7	0	0
13	18323464	.	A	G	8	9	17	0	0	17	0	0
13	18323595	.	G	A	0	9	9	0	15	24	0	0
13	18323653	.	A	G	10	1	11	0	13	24	0	0
13	18323787	.	T	A	15	10	25	0	2	27	0	0
13	18355119	.	T	C	3	4	7	0	0	7	0	0
13	18355149	.	T	A	2	3	5	0	1	6	0	0
13	18358890	.	G	C	9	8	17	0	0	17	0	0
13	18359112	.	G	C	14	16	30	0	5	35	0	0
13	18359304	.	A	T	9	8	17	0	3	20	0	0
13	18359374	.	C	T	12	15	27	0	0	27	0	0
13	18359507	.	A	T	11	10	21	0	1	22	0	0
13	18385512	.	C	T	2	4	6	0	0	6	0	0
13	18394755	.	T	A	1	4	5	0	0	5	0	0
13	18397138	.	C	G	2	3	5	0	0	5	0	0
13	18397449	.	T	C	1	2	3	0	0	3	0	0
13	18397452	.	T	C	1	3	4	0	0	4	0	0
13	18418528	.	G	A	7	11	18	0	0	18	0	0
13	18428103	.	A	G	12	11	23	0	0	23	0	0
13	18431278	.	T	A	11	11	22	0	0	22	0	0
13	18431301	.	C	T	14	8	22	0	0	22	0	0
13	18431430	.	C	T	10	6	16	0	0	16	0	0
13	18434427	.	C	T	8	6	14	0	0	14	0	0
13	18434519	.	C	A	7	6	13	0	0	13	0	0
13	18434520	.	G	C	1	5	6	0	7	13	0	0
13	18434818	.	C	G	13	16	29	0	0	29	0	0
13	18434902	.	C	T	5	11	16	0	1	17	0	0
13	18434957	.	G	A	9	9	18	0	1	19	0	0
13	18434962	.	A	G	10	9	19	0	0	19	0	0
13	18509925	.	T	C	4	3	7	0	1	8	0	0
13	18509940	.	C	T	3	5	8	0	0	8	0	0
13	18510319	.	C	A	5	3	8	0	0	8	0	0
13	18510324	.	A	G	5	3	8	0	0	8	0	0
13	18510540	.	G	A	1	3	4	0	5	9	0	0
13	18511023	.	C	T	7	4	11	0	3	14	0	0
13	18511140	.	A	G	14	0	14	0	10	24	0	0
13	18511637	.	A	C	5	8	13	0	2	15	0	0
13	18511763	.	T	A	9	11	20	0	0	20	0	0
13	18511996	.	A	T	11	7	18	0	3	21	0	0
13	18512030	.	A	T	17	8	25	0	0	25	0	0
13	18512082	.	C	G	16	9	25	0	2	27	0	0
13	18663947	.	G	A	17	14	31	0	2	33	0	0
13	18677467	.	G	A	2	2	4	0	0	4	0	0
13	19304688	.	A	G	18	12	30	0	1	31	0	0
13	19306817	.	C	G	16	4	20	0	1	21	0	0
13	19316930	.	G	C	11	12	23	0	0	23	0	0
13	19317016	.	T	A	5	3	8	0	0	8	0	0
13	19317018	.	C	G	5	3	8	0	0	8	0	0
13	19317051	.	T	G	10	5	15	0	0	15	0	0
13	19629266	.	C	G	1	2	3	0	0	3	0	0
13	19799192	.	A	G	14	11	25	0	1	26	0	0
13	19799467	.	G	A	19	10	29	1	0	30	0	0
13	19799522	.	C	T	12	11	23	0	2	25	0	0
13	19799535	.	T	A	12	9	21	0	2	23	0	0
13	19799623	.	T	C	14	5	19	0	4	23	0	0
13	19799646	.	C	A	3	6	9	0	18	27	0	0
13	19799705	.	A	G	11	9	20	0	0	20	0	0
13	19799799	.	C	T	1	2	3	0	6	9	0	0
13	20401263	.	C	A	1	7	8	0	9	17	0	0
13	20425396	.	C	T	0	4	4	0	3	7	0	0
13	20518711	.	C	T	1	2	3	0	0	3	0	0
13	21638916	.	G	A	2	2	4	0	1	5	0	0
13	21638955	.	C	A	1	2	3	0	0	3	0	0
13	21677621	.	T	C	3	2	5	0	0	5	0	0
13	21680844	.	A	T	5	3	8	0	0	8	0	0
13	21681224	.	A	T	2	4	6	0	0	6	0	0
13	21683057	.	A	C	2	6	8	0	0	8	0	0
13	21683077	.	T	C	3	5	8	0	1	9	0	0
13	21683488	.	A	T	23	17	40	0	0	40	0	0
13	21683511	.	T	G	18	18	36	0	1	37	0	0
13	21683546	.	C	T	14	17	31	0	1	32	0	0
13	21689373	.	G	A	3	4	7	0	0	7	0	0
13	21689438	.	A	C	12	9	21	0	1	22	0	0
13	21689439	.	C	T	13	10	23	0	0	23	0	0
13	21689530	.	A	T	9	6	15	0	0	15	0	0
13	21689839	.	C	T	3	13	16	0	0	16	0	0
13	21689854	.	C	T	13	3	16	0	0	16	0	0
13	21689982	.	G	A	7	10	17	0	0	17	0	0
13	21690053	.	T	A	2	5	7	0	0	7	0	0
13	21690055	.	A	G	5	2	7	0	0	7	0	0
13	21690229	.	A	C	7	7	14	0	2	16	0	0
13	21690374	.	G	A	16	7	23	0	0	23	0	0
13	21690530	.	C	T	2	6	8	0	12	20	0	0
13	21690724	.	A	T	6	3	9	1	0	10	0	0
13	21690877	.	A	C	3	1	4	0	5	9	0	0
13	21690907	.	G	A	7	2	9	0	0	9	0	0
13	21691324	.	G	A	3	2	5	2	0	7	0	0
13	21691611	.	G	A	2	2	4	0	0	4	0	0
13	21691794	.	G	A	2	4	6	0	1	7	0	0
13	21691947	.	A	G	1	10	11	0	0	11	0	0
13	21692328	.	C	A	8	2	10	0	0	10	0	0
13	21692338	.	C	T	8	4	12	0	0	12	0	0
13	21692705	.	C	G	0	4	4	0	4	8	0	0
13	21692859	.	C	T	5	4	9	0	2	11	0	0
13	21693187	.	A	G	3	2	5	0	1	7	1	0
13	21693208	.	A	C	2	0	2	0	5	7	0	0
13	21693361	.	C	T	1	3	4	0	0	4	0	0
13	21693410	.	G	C	1	2	3	0	0	3	0	0
13	21712507	.	G	A	3	6	9	0	1	10	0	0
13	21712526	.	G	A	4	9	13	0	0	13	0	0
13	21712755	.	G	C	4	8	12	0	0	12	0	0
13	21716581	.	T	C	1	3	4	0	0	4	0	0
13	21727796	.	T	A	2	2	4	0	0	4	0	0
13	21770891	.	T	C	6	12	18	0	1	19	0	0
13	21775469	.	C	T	21	8	29	0	0	29	0	0
13	21821393	.	A	C	2	2	4	0	0	4	0	0
13	21864182	.	T	A	1	1	2	0	1	3	0	0
13	21869927	.	C	T	2	7	9	0	0	9	0	0
13	21870467	.	G	C	0	7	7	0	11	18	0	0
13	21870575	.	A	G	11	0	11	0	7	18	0	0
13	21870608	.	A	T	6	4	10	0	0	10	0	0
13	21874107	.	C	T	9	10	19	0	0	19	0	0
13	21874149	.	G	T	1	10	11	0	5	16	0	0
13	21874649	.	C	T	4	9	13	0	0	13	0	0
13	21884298	.	C	T	12	7	19	0	1	20	0	0
13	21884328	.	G	A	13	6	19	0	3	22	0	0
13	21884407	.	T	C	10	9	19	0	0	19	0	0
13	21884408	.	C	T	10	9	19	0	0	19	0	0
13	21884979	.	T	C	12	5	17	0	3	20	0	0
13	21884980	.	C	T	12	8	20	0	0	20	0	0
13	21885143	.	C	A	15	18	33	0	1	34	0	0
13	21885198	.	T	A	17	20	37	0	1	38	0	0
13	22066066	.	C	T	1	2	3	0	0	3	0	0
13	22066078	.	T	G	2	2	4	0	0	4	0	0
13	22076892	.	C	T	2	5	7	0	0	7	0	0
13	22087098	.	C	T	9	7	16	0	0	16	0	0
13	22087508	.	C	T	4	3	7	0	0	7	0	0
13	22088061	.	T	G	4	0	4	0	6	10	0	0
13	22094800	.	T	C	6	13	19	0	1	20	0	0
13	22094871	.	T	G	9	11	20	0	0	20	0	0
13	22095589	.	G	A	7	7	14	0	1	15	0	0
13	22095594	.	T	A	6	10	16	0	0	16	0	0
13	22119879	.	G	A	5	2	7	0	1	8	0	0
13	22207003	.	C	T	6	5	11	0	2	13	0	0
13	22238125	.	C	A	13	12	25	0	1	26	0	0
13	22238209	.	T	C	11	6	17	0	0	17	0	0
13	22238233	.	G	A	11	7	18	0	2	20	0	0
13	22240672	.	T	A	18	14	32	0	1	33	0	0
13	22241103	.	T	A	13	19	32	0	0	32	0	0
13	22241123	.	G	T	1	8	9	0	15	24	0	0
13	22241374	.	A	C	24	8	32	0	2	34	0	0
13	22241482	.	G	C	8	14	22	0	0	22	0	0
13	22241648	.	T	G	17	13	30	0	2	32	0	0
13	22241730	.	G	C	26	17	43	0	3	46	0	0
13	22241731	.	A	T	29	17	46	0	0	46	0	0
13	22242197	.	G	C	22	23	45	0	0	45	0	0
13	22242299	.	C	G	20	22	42	0	0	42	0	0
13	22242394	.	C	G	27	16	43	0	0	43	0	0
13	22242837	.	T	G	22	21	43	0	4	47	0	0
13	22243211	.	A	C	10	20	30	0	3	33	0	0
13	22357236	.	T	G	2	2	4	0	0	4	0	0
13	22358021	.	A	G	2	3	5	0	0	5	0	0
13	22361332	.	G	A	1	3	4	0	0	4	0	0
13	22364908	.	T	C	3	11	14	0	0	14	0	0
13	22365016	.	C	T	7	4	11	0	1	12	0	0
13	22365404	.	C	T	9	11	20	0	0	20	0	0
13	22365461	.	A	G	4	11	15	0	0	15	0	0
13	22367600	.	C	A	12	13	25	0	0	25	0	0
13	22369295	.	T	C	6	9	15	0	0	15	0	0
13	22369349	.	C	T	3	6	9	0	0	9	0	0
13	22369445	.	C	T	1	6	7	0	0	7	0	0
13	22371981	.	G	A	3	15	18	0	16	34	0	0
13	22372015	.	C	G	18	26	44	0	0	44	0	0
13	22372075	.	T	C	14	13	27	0	3	30	0	0
13	22372105	.	G	A	3	14	17	0	18	35	0	0
13	22372126	.	C	T	13	15	28	0	1	29	0	0
13	22372205	.	A	G	22	7	29	0	0	29	0	0
13	22618393	.	T	A	1	3	4	0	0	4	0	0
13	22619067	.	G	A	2	4	6	0	3	9	0	0
13	22619157	.	C	T	8	6	14	0	0	14	0	0
13	22659195	.	C	G	15	0	15	0	13	28	0	0
13	22659196	.	A	G	15	13	28	0	0	28	0	0
13	22659231	.	G	A	3	14	17	0	18	35	0	0
13	22659291	.	A	G	14	13	27	0	2	29	0	0
13	22659363	.	G	A	7	12	19	0	1	20	0	0
13	22667102	.	G	A	9	12	21	0	1	22	0	0
13	22667111	.	T	C	11	10	21	0	2	23	0	0
13	22669319	.	T	C	8	20	28	0	0	28	0	0
13	22735063	.	T	C	8	5	13	0	1	14	0	0
13	22735139	.	A	G	6	5	11	0	0	11	0	0
13	22742791	.	G	A	3	4	7	0	0	7	0	0
13	22744347	.	A	T	4	0	4	0	1	5	0	0
13	22744359	.	A	G	4	2	6	0	0	6	0	0
13	22867888	.	G	A	0	4	4	0	6	10	0	0
13	22867910	.	A	G	5	3	8	0	0	8	0	0
13	22867953	.	G	T	6	3	9	0	0	9	0	0
13	22868017	.	G	A	3	3	6	0	0	6	0	0
13	22871900	.	C	A	2	2	4	0	0	4	0	0
13	22871989	.	A	G	4	3	7	0	0	7	0	0
13	22872433	.	A	G	3	2	5	0	0	5	0	0
13	22872862	.	A	G	1	3	4	0	0	4	0	0
13	22876576	.	T	C	12	0	12	0	10	22	0	0
13	22876623	.	G	A	12	14	26	0	3	29	0	0
13	22876678	.	A	T	8	21	29	0	3	32	0	0
13	22877076	.	C	T	13	15	28	0	2	30	0	0
13	22877130	.	G	T	15	19	34	0	0	34	0	0
13	22878754	.	G	A	18	17	35	0	1	36	0	0
13	22879149	.	A	T	8	18	26	0	0	26	0	0
13	22890835	.	A	C	12	1	13	0	16	29	0	0
13	22898042	.	A	G	7	7	14	0	1	15	0	0
13	22900733	.	G	A	3	6	9	0	1	10	0	0
13	22900742	.	A	T	4	4	8	0	2	10	0	0
13	22902987	.	G	A	5	4	9	0	0	9	0	0
13	22973314	.	A	G	29	27	56	0	2	58	0	0
13	22973348	.	A	G	20	28	48	0	3	51	0	0
13	22973531	.	T	C	22	0	22	0	23	45	0	0
13	22973895	.	A	G	12	21	33	0	5	38	0	0
13	22974033	.	A	G	19	22	41	0	0	41	0	0
13	22974108	.	C	T	14	16	30	0	2	32	0	0
13	22976067	.	C	A	17	9	26	0	1	27	0	0
13	22976070	.	G	A	16	9	25	0	0	25	0	0
13	22976383	.	T	C	9	0	9	0	9	18	0	0
13	22977283	.	G	A	10	13	23	0	1	24	0	0
13	22977319	.	A	G	6	12	18	0	0	18	0	0
13	22977343	.	A	G	8	7	15	0	0	15	0	0
13	22978059	.	T	C	7	2	9	0	14	23	0	0
13	22978062	.	G	A	8	15	23	0	0	23	0	0
13	22983106	.	A	G	2	2	4	0	0	4	0	0
13	22983109	.	A	G	2	3	5	0	0	5	0	0
13	23002697	.	G	A	1	3	4	0	0	4	0	0
13	23017590	.	C	G	6	2	8	0	0	8	0	0
13	23037831	.	C	A	5	6	11	0	1	12	0	0
13	23042676	.	A	G	6	6	12	0	0	12	0	0
13	23042745	.	G	A	7	6	13	0	0	13	0	0
13	23042929	.	G	T	5	5	10	0	2	12	0	0
13	23043112	.	T	C	7	4	11	0	0	11	0	0
13	23043117	.	A	G	6	4	10	0	1	11	0	0
13	23058975	.	G	A	4	5	9	0	4	13	0	0
13	23070787	.	C	T	1	5	6	0	0	6	0	0
13	23070895	.	T	C	4	13	17	0	1	18	0	0
13	23070994	.	A	G	1	5	6	0	0	6	0	0
13	23071016	.	T	A	1	2	3	0	0	3	0	0
13	23084177	.	C	G	22	12	34	1	1	36	0	0
13	23084841	.	G	C	4	4	8	0	1	9	0	0
13	23090190	.	A	C	6	10	16	0	0	16	0	0
13	23094356	.	T	C	3	0	3	0	5	8	0	0
13	23094895	.	G	T	2	5	7	0	0	7	0	0
13	23128675	.	A	G	5	0	5	0	3	8	0	0
13	23128685	.	A	G	6	3	9	0	0	9	0	0
13	23211195	.	A	T	2	2	4	0	0	4	0	0
13	23223469	.	T	A	1	4	5	0	0	5	0	0
13	23223486	.	C	T	1	5	6	0	0	6	0	0
13	23223567	.	C	T	5	1	6	0	0	6	0	0
13	23223572	.	C	T	5	2	7	0	0	7	0	0
13	23224087	.	G	A	7	5	12	0	1	13	0	0
13	23224113	.	A	T	5	5	10	0	1	11	0	0
13	23224360	.	A	G	4	2	6	0	0	6	0	0
13	23224363	.	T	G	4	2	6	0	0	6	0	0
13	23224427	.	C	T	3	9	12	0	0	12	0	0
13	23224470	.	G	A	3	7	10	0	0	10	0	0
13	23224605	.	G	T	11	4	15	0	2	17	0	0
13	23224727	.	C	T	6	7	13	0	0	13	0	0
13	23224735	.	A	G	6	6	12	0	0	12	0	0
13	23224821	.	T	A	9	7	16	0	0	16	0	0
13	23224860	.	T	A	14	5	19	0	1	20	0	0
13	23225541	.	T	C	13	7	20	0	2	22	0	0
13	23225776	.	T	A	10	7	17	0	0	17	0	0
13	23226114	.	G	A	3	11	14	1	21	36	0	0
13	23226213	.	A	C	8	13	21	0	2	23	0	0
13	23234499	.	A	G	1	3	4	0	0	4	0	0
13	23314904	.	T	G	5	4	9	0	0	9	0	0
13	23382393	.	G	A	13	11	24	0	1	25	0	0
13	23382572	.	T	C	13	15	28	0	0	28	0	0
13	23387252	.	T	C	5	4	9	0	0	9	0	0
13	23676913	.	C	A	2	2	4	0	0	4	0	0
13	23692515	.	C	T	3	5	8	0	0	8	0	0
13	23703048	.	G	C	2	7	9	0	0	9	0	0
13	23703053	.	T	C	2	7	9	0	0	9	0	0
13	23709532	.	C	T	10	4	14	0	1	15	0	0
13	23709562	.	T	C	12	9	21	0	1	22	0	0
13	23709592	.	A	G	15	9	24	0	1	25	0	0
13	23711937	.	G	A	16	11	27	0	2	29	0	0
13	23728490	.	T	A	1	5	6	0	1	7	0	0
13	23882686	.	C	T	2	2	4	0	0	4	0	0
13	23898045	.	T	G	22	17	39	0	2	41	0	0
13	23901334	.	C	T	13	14	27	0	0	27	0	0
13	23901349	.	T	C	9	14	23	0	2	25	0	0
13	23901502	.	A	G	10	14	24	0	2	26	0	0
13	23901555	.	A	G	15	1	16	0	12	28	0	0
13	23901570	.	T	C	15	10	25	0	1	26	0	0
13	23920791	.	A	G	6	6	12	0	0	12	0	0
13	23940708	.	T	C	3	0	3	0	2	5	0	0
13	23940754	.	C	A	3	4	7	0	1	8	0	0
13	23993705	.	C	T	2	1	3	0	1	4	0	0
13	23996192	.	G	A	5	4	9	0	0	9	0	0
13	23999129	.	G	A	3	4	7	0	0	7	0	0
13	23999264	.	G	C	2	5	7	0	0	7	0	0
13	23999274	.	T	A	2	5	7	0	0	7	0	0
13	24000394	.	G	A	4	2	6	0	1	7	0	0
13	24010630	.	C	T	1	2	3	0	0	3	0	0
13	24056221	.	C	T	3	6	9	0	0	9	0	0
13	24068790	.	C	T	2	12	14	0	21	35	0	0
13	24069624	.	C	A	14	7	21	0	0	21	0	0
13	24069902	.	A	T	12	9	21	0	1	22	0	0
13	24070242	.	C	T	1	5	6	0	6	12	0	0
13	24070730	.	C	T	1	4	5	0	1	6	0	0
13	24096437	.	G	T	1	2	3	0	0	3	0	0
13	24234815	.	C	A	3	2	5	0	1	6	0	0
13	24241436	.	A	G	2	2	4	0	0	4	0	0
13	24269693	.	T	G	2	1	3	0	1	4	0	0
13	24269697	.	C	T	2	2	4	0	0	4	0	0
13	24271061	.	C	A	3	4	7	0	1	8	0	0
13	24276354	.	A	G	2	6	8	0	0	8	0	0
13	24276366	.	C	T	3	3	6	0	0	6	0	0
13	24276497	.	A	G	9	0	9	0	8	17	0	0
13	24287895	.	C	T	1	2	3	0	0	3	0	0
13	24290132	.	A	T	4	4	8	0	1	9	0	0
13	24290140	.	A	G	3	3	6	0	1	7	0	0
13	24290169	.	T	G	5	0	5	0	4	9	0	0
13	24292374	.	A	G	1	4	5	0	0	5	0	0
13	24292675	.	A	G	6	8	14	0	0	14	0	0
13	24292727	.	G	A	13	15	28	0	2	30	0	0
13	24292796	.	T	A	11	17	28	0	1	29	0	0
13	24292800	.	A	T	11	18	29	0	0	29	0	0
13	24292947	.	A	T	3	14	17	0	0	17	0	0
13	24293381	.	A	T	16	32	48	0	1	49	0	0
13	24293465	.	C	T	13	16	29	0	15	44	0	0
13	24293516	.	G	A	9	28	37	0	7	44	0	0
13	24293518	.	C	A	16	27	43	0	1	44	0	0
13	24293615	.	G	A	19	25	44	0	15	59	0	0
13	24293698	.	C	T	33	11	44	0	1	45	0	0
13	24293793	.	A	G	17	9	26	0	0	26	0	0
13	24294046	.	A	G	7	12	19	0	1	20	0	0
13	24296071	.	G	A	5	5	10	0	0	10	0	0
13	24296094	.	A	C	4	3	7	0	0	7	0	0
13	24296141	.	G	A	1	2	3	0	0	3	0	0
13	24296198	.	A	T	6	3	9	0	0	9	0	0
13	24296250	.	A	G	2	4	6	0	1	7	0	0
13	24305975	.	T	G	3	4	7	0	0	7	0	0
13	24373081	.	A	G	1	2	3	0	0	3	0	0
13	24382137	.	G	A	0	6	6	0	1	7	0	0
13	24382152	.	T	C	1	6	7	0	0	7	0	0
13	24382539	.	T	C	5	6	11	0	1	12	0	0
13	24401087	.	C	G	1	3	4	0	0	4	0	0
13	24401618	.	A	G	2	4	6	0	1	7	0	0
13	24402560	.	T	C	5	5	10	0	0	10	0	0
13	24411029	.	A	G	16	25	41	0	4	45	0	0
13	24423930	.	T	C	1	2	3	0	0	3	0	0
13	24432096	.	C	T	10	9	19	0	3	22	0	0
13	24432162	.	G	C	5	9	14	0	1	16	1	0
13	24432350	.	C	T	1	7	8	0	9	17	0	0
13	24436011	.	C	G	4	5	9	0	0	9	0	0
13	24436054	.	G	A	4	5	9	0	0	9	0	0
13	24437225	.	G	A	1	2	3	0	0	3	0	0
13	24523425	.	A	G	5	4	9	0	1	10	0	0
13	24523469	.	G	A	1	5	6	0	8	14	0	0
13	24524206	.	G	A	10	4	14	0	0	14	0	0
13	24524305	.	T	G	5	4	9	0	0	9	0	0
13	24580372	.	G	A	5	11	16	0	1	17	0	0
13	24580411	.	G	A	9	12	21	0	1	22	0	0
13	24580705	.	C	T	6	5	11	0	0	11	0	0
13	24580756	.	G	C	0	6	6	0	12	18	0	0
13	24580869	.	T	C	8	10	18	0	0	18	0	0
13	24580941	.	T	C	8	6	14	0	0	14	0	0
13	24581274	.	G	A	11	11	22	0	1	23	0	0
13	24581316	.	C	A	17	13	30	0	2	32	0	0
13	24581334	.	G	C	18	19	37	0	1	38	0	0
13	24581358	.	T	C	22	19	41	0	2	43	0	0
13	24581748	.	A	C	15	6	21	0	2	23	0	0
13	24581798	.	T	A	7	10	17	0	1	18	0	0
13	24581840	.	T	G	19	10	29	0	1	30	0	0
13	24581854	.	C	T	21	10	31	0	2	33	0	0
13	24582047	.	A	G	14	12	26	0	0	26	0	0
13	24582110	.	C	T	10	13	23	0	0	23	0	0
13	24582122	.	T	C	11	11	22	0	0	22	0	0
13	24582211	.	C	T	3	8	11	0	0	11	0	0
13	24582213	.	G	A	8	3	11	0	0	11	0	0
13	24585352	.	C	T	2	5	7	1	0	8	0	0
13	24585402	.	T	A	3	2	5	0	0	5	0	0
13	24664144	.	T	A	2	2	4	0	0	4	0	0
13	24664317	.	T	G	1	2	3	0	0	3	0	0
13	24664424	.	C	A	1	2	3	0	0	3	0	0
13	24665407	.	C	T	3	2	5	0	0	5	0	0
13	24665421	.	G	T	3	2	5	0	0	5	0	0
13	24665759	.	T	G	5	4	9	0	0	9	0	0
13	24665869	.	C	T	3	5	8	0	1	9	0	0
13	24669108	.	T	C	2	2	4	0	0	4	0	0
13	24702033	.	C	A	2	10	12	0	9	21	0	0
13	24702198	.	T	C	2	7	9	0	0	9	0	0
13	24702415	.	T	C	5	12	17	0	2	19	0	0
13	24702478	.	T	G	6	11	17	0	0	17	0	0
13	24702602	.	T	A	12	8	20	0	1	21	0	0
13	24702652	.	A	T	5	8	13	0	1	14	0	0
13	24702724	.	C	T	6	7	13	0	0	13	0	0
13	24702883	.	A	T	15	6	21	0	0	21	0	0
13	24703276	.	C	T	3	2	5	0	0	5	0	0
13	24704102	.	C	A	8	4	12	0	3	15	0	0
13	24737309	.	A	C	1	2	3	0	0	3	0	0
13	24741212	.	G	A	4	2	6	0	0	6	0	0
13	24781536	.	G	A	13	10	23	0	1	24	0	0
13	24781580	.	T	C	15	11	26	0	1	27	0	0
13	24781605	.	T	C	17	13	30	0	0	30	0	0
13	24781640	.	G	A	17	11	28	0	0	28	0	0
13	24781713	.	A	G	12	7	19	0	0	19	0	0
13	24781885	.	G	A	5	9	14	0	1	15	0	0
13	24786900	.	T	A	11	7	18	0	2	20	0	0
13	24837627	.	A	G	11	15	26	0	1	27	0	0
13	24837876	.	T	C	2	7	9	0	1	10	0	0
13	24871866	.	A	G	16	5	21	0	1	22	0	0
13	24872667	.	A	G	5	7	12	0	0	12	0	0
13	24872733	.	G	A	0	3	3	0	1	4	0	0
13	24873141	.	C	A	0	7	7	0	3	10	0	0
13	24873186	.	A	T	4	3	7	0	1	8	0	0
13	24873480	.	A	G	6	3	9	0	0	9	0	0
13	24873579	.	C	T	3	6	9	0	0	9	0	0
13	24918814	.	T	A	14	10	24	0	1	25	0	0
13	24918820	.	T	C	16	10	26	0	0	26	0	0
13	24986203	.	G	A	9	4	13	0	0	13	0	0
13	24986238	.	G	T	5	7	12	0	0	12	0	0
13	24986272	.	T	C	1	0	1	0	7	8	0	0
13	25208484	.	T	G	3	7	10	0	2	12	0	0
13	25208545	.	T	A	3	3	6	0	0	6	0	0
13	25366380	.	T	G	1	2	3	0	1	4	0	0
13	25369449	.	C	T	3	2	5	0	1	6	0	0
13	25371475	.	C	A	3	2	5	0	0	5	0	0
13	25371918	.	A	G	5	6	11	0	0	11	0	0
13	25378924	.	T	G	7	7	14	1	0	15	0	0
13	25379263	.	A	T	13	16	29	0	2	31	0	0
13	25379304	.	A	G	15	0	15	0	20	35	0	0
13	25379352	.	A	C	9	15	24	0	3	27	0	0
13	25388389	.	G	A	2	6	8	0	2	10	0	0
13	25429018	.	C	T	5	1	6	0	1	7	0	0
13	25429145	.	G	A	5	2	7	0	0	7	0	0
13	25429158	.	G	A	2	4	6	0	0	6	0	0
13	25436360	.	A	T	11	13	24	0	0	24	0	0
13	25449867	.	C	A	1	3	4	0	0	4	0	0
13	25450114	.	G	A	1	2	3	0	0	3	0	0
13	25472084	.	C	T	6	4	10	0	0	10	0	0
13	25472336	.	G	A	30	14	44	0	1	45	0	0
13	25472735	.	G	A	8	19	27	0	2	29	0	0
13	25472859	.	G	A	13	15	28	0	0	28	0	0
13	25473084	.	T	A	20	29	49	0	1	50	0	0
13	25473325	.	G	A	16	9	25	0	1	26	0	0
13	25474019	.	G	T	15	15	30	0	0	30	0	0
13	25475904	.	A	G	10	16	26	0	0	26	0	0
13	25477304	.	A	G	5	4	9	0	1	10	0	0
13	25478897	.	G	A	1	2	3	0	0	3	0	0
13	25495556	.	C	T	1	3	4	0	1	5	0	0
13	25495781	.	G	A	4	5	9	0	0	9	0	0
13	25497575	.	T	C	6	3	9	0	0	9	0	0
13	25497581	.	C	T	6	4	10	0	1	11	0	0
13	25497700	.	G	C	6	5	11	0	0	11	0	0
13	25497769	.	T	A	9	5	14	0	0	14	0	0
13	25531776	.	T	C	2	2	4	0	0	4	0	0
13	25532352	.	C	T	9	5	14	0	0	14	0	0
13	25532574	.	C	A	11	8	19	0	0	19	0	0
13	25532857	.	A	G	5	5	10	0	0	10	0	0
13	25533233	.	G	A	11	6	17	0	0	17	0	0
13	25533258	.	T	A	10	5	15	0	2	17	0	0
13	25533452	.	A	T	5	7	12	0	0	12	0	0
13	25533657	.	C	G	5	0	5	0	9	14	0	0
13	25533767	.	G	T	13	10	23	0	0	23	0	0
13	25533846	.	G	A	11	8	19	0	3	22	0	0
13	25533897	.	C	T	6	4	10	0	1	11	0	0
13	25534172	.	T	A	11	10	21	0	1	22	0	0
13	25534368	.	A	G	16	0	16	0	24	40	0	0
13	25534551	.	G	A	7	4	11	0	0	11	0	0
13	25535405	.	G	A	5	4	9	0	3	12	0	0
13	25552219	.	T	C	1	3	4	0	0	4	0	0
13	25559610	.	G	A	3	3	6	0	0	6	0	0
13	25560458	.	A	T	2	3	5	0	0	5	0	0
13	25560471	.	G	A	0	2	2	0	3	5	0	0
13	25565379	.	T	C	7	11	18	0	0	18	0	0
13	25565985	.	G	A	4	9	13	0	0	13	0	0
13	25565988	.	A	C	4	7	11	0	2	13	0	0
13	25566205	.	A	T	8	4	12	0	0	12	0	0
13	25566222	.	C	T	9	3	12	0	0	12	0	0
13	25570044	.	C	T	0	2	2	0	5	7	0	0
13	25570104	.	C	T	4	4	8	0	0	8	0	0
13	25570410	.	A	G	7	6	13	0	2	15	0	0
13	25570477	.	G	A	10	4	14	0	0	14	0	0
13	25570532	.	A	C	4	0	4	0	5	9	0	0
13	25570618	.	A	T	6	3	9	0	0	9	0	0
13	25570709	.	T	C	6	0	6	0	6	12	0	0
13	25570715	.	C	T	5	5	10	0	0	10	0	0
13	25570854	.	A	T	2	3	5	0	0	5	0	0
13	25571274	.	C	T	6	6	12	0	2	14	0	0
13	25575396	.	C	T	3	3	6	0	1	7	0	0
13	25575411	.	A	C	3	4	7	0	0	7	0	0
13	25580764	.	C	A	2	2	4	0	1	5	0	0
13	25589241	.	G	A	1	3	4	0	0	4	0	0
13	25726201	.	C	T	5	7	12	0	0	12	0	0
13	25726308	.	A	C	3	2	5	0	0	5	0	0
13	25726504	.	T	G	3	2	5	0	0	5	0	0
13	25728305	.	G	A	6	2	8	0	0	8	0	0
13	25728453	.	A	C	4	4	8	0	1	9	0	0
13	25728606	.	A	T	3	5	8	0	1	9	0	0
13	25824718	.	C	T	20	17	37	0	0	37	0	0
13	25825016	.	G	A	19	18	37	0	0	37	0	0
13	25825445	.	A	T	4	8	12	0	0	12	0	0
13	25827421	.	G	A	5	14	19	0	0	19	0	0
13	25842020	.	T	C	4	0	4	0	4	8	0	0
13	25923392	.	A	G	2	3	5	0	3	8	0	0
13	25923450	.	A	T	3	3	6	0	0	6	0	0
13	25924388	.	C	T	8	5	13	0	0	13	0	0
13	26780130	.	C	T	4	4	8	0	0	8	0	0
13	26794304	.	G	C	2	4	6	0	0	6	0	0
13	27000394	.	C	T	0	2	2	0	3	5	0	0
13	27000518	.	C	T	1	4	5	0	0	5	0	0
13	27036660	.	T	C	1	5	6	0	0	6	0	0
13	27036898	.	T	C	4	3	7	0	0	7	0	0
13	27207707	.	G	T	2	2	4	0	0	4	0	0
13	27232479	.	C	A	1	3	4	0	2	6	0	0
13	27296278	.	A	G	2	5	7	0	0	7	0	0
13	27296291	.	T	C	2	4	6	0	0	6	0	0
13	27296396	.	G	A	3	2	5	0	1	6	0	0
13	27296433	.	A	G	4	2	6	0	0	6	0	0
13	27296576	.	C	T	8	6	14	0	0	14	0	0
13	27296616	.	T	C	4	8	12	0	0	12	0	0
13	27309080	.	C	T	2	3	5	0	1	6	0	0
13	27312888	.	G	A	3	3	6	0	1	7	0	0
13	27313025	.	T	A	1	3	4	0	0	4	0	0
13	27313236	.	A	G	8	7	15	0	0	15	0	0
13	27313258	.	G	T	8	7	15	0	1	16	0	0
13	27316688	.	T	A	2	2	4	0	0	4	0	0
13	27316862	.	T	G	5	6	11	0	0	11	0	0
13	27317499	.	C	T	12	10	22	0	0	22	0	0
13	27320574	.	T	C	20	22	42	0	3	45	0	0
13	27320583	.	C	T	23	20	43	0	1	44	0	0
13	27320628	.	T	A	19	20	39	0	3	42	0	0
13	27320771	.	C	T	11	13	24	0	1	25	0	0
13	27320849	.	T	C	13	19	32	0	2	34	0	0
13	27321072	.	A	T	1	2	3	0	0	3	0	0
13	27321211	.	C	T	23	29	52	0	5	57	0	0
13	27321271	.	G	A	3	31	34	0	19	53	0	0
13	27323970	.	G	A	4	24	28	0	25	53	0	0
13	27323976	.	G	A	3	28	31	0	21	52	0	0
13	27324341	.	A	T	34	27	61	0	0	61	0	0
13	27324346	.	T	C	35	27	62	0	1	63	0	0
13	27632915	.	C	T	3	26	29	0	16	45	0	0
13	27633628	.	G	A	26	13	39	0	5	44	0	0
13	27633833	.	A	G	13	14	27	0	0	27	0	0
13	27633906	.	A	G	28	16	44	0	3	47	0	0
13	27634634	.	A	G	19	11	30	0	1	31	0	0
13	27634670	.	G	T	23	19	42	0	1	43	0	0
13	27634678	.	G	T	24	21	45	0	0	45	0	0
13	27634726	.	T	C	17	0	17	0	23	41	1	0
13	27634789	.	A	G	11	15	26	0	1	27	0	0
13	27634903	.	A	G	18	18	36	0	1	37	0	0
13	27650537	.	G	A	11	13	24	0	1	25	0	0
13	27653458	.	C	A	1	11	12	0	7	19	0	0
13	27668056	.	G	T	9	12	21	0	0	21	0	0
13	27674408	.	C	T	4	13	17	0	0	17	0	0
13	27677945	.	C	T	1	3	4	0	3	7	0	0
13	27685233	.	G	A	6	2	8	0	1	9	0	0
13	27685329	.	C	T	1	2	3	0	4	7	0	0
13	27685363	.	G	A	4	4	8	0	0	8	0	0
13	27685446	.	C	T	2	2	4	0	0	4	0	0
13	27685552	.	G	A	6	5	11	0	1	12	0	0
13	27685583	.	C	T	1	4	5	0	7	12	0	0
13	27686252	.	G	A	7	4	11	0	0	11	0	0
13	27686259	.	C	T	7	5	12	0	0	12	0	0
13	27776846	.	A	G	10	6	16	0	0	16	0	0
13	27782086	.	C	A	7	7	14	0	0	14	0	0
13	27782585	.	G	A	7	3	10	0	0	10	0	0
13	27951758	.	T	A	6	4	10	0	0	10	0	0
13	27951989	.	A	C	8	4	12	0	0	13	1	0
13	27952207	.	G	A	8	7	15	0	1	16	0	0
13	27952330	.	G	T	10	7	17	0	2	19	0	0
13	27963912	.	T	C	9	12	21	0	1	22	0	0
13	28009108	.	C	T	15	21	36	0	0	36	0	0
13	28009159	.	G	A	11	22	33	0	1	34	0	0
13	28009178	.	A	C	11	18	29	0	0	29	0	0
13	28009246	.	A	T	17	18	35	0	1	36	0	0
13	28009302	.	G	A	1	17	18	0	20	38	0	0
13	28009567	.	G	A	17	16	33	0	0	33	0	0
13	28010214	.	C	A	9	31	40	0	26	66	0	0
13	28010572	.	C	A	26	20	46	0	1	47	0	0
13	28062552	.	T	G	12	7	19	0	1	20	0	0
13	28176651	.	T	C	7	6	13	0	1	14	0	0
13	28495945	.	C	T	3	5	8	0	0	8	0	0
13	28500674	.	T	C	3	3	6	0	0	6	0	0
13	28501360	.	C	T	9	7	16	0	1	17	0	0
13	28501535	.	G	C	1	4	5	0	2	7	0	0
13	28513240	.	G	A	3	2	5	0	0	5	0	0
13	28561116	.	T	C	2	7	9	0	0	9	0	0
13	28561184	.	T	C	3	4	7	0	0	7	0	0
13	28561190	.	A	T	5	4	9	0	0	9	0	0
13	28561244	.	G	C	10	5	15	0	0	15	0	0
13	28615556	.	C	T	8	4	12	1	0	13	0	0
13	28650349	.	A	T	10	13	23	1	1	25	0	0
13	28650416	.	G	C	8	17	25	0	0	25	0	0
13	28650683	.	A	G	18	10	28	0	0	28	0	0
13	28651365	.	A	G	14	17	31	0	0	31	0	0
13	28676472	.	C	G	4	0	4	0	4	8	0	0
13	28678176	.	C	G	5	9	14	0	1	15	0	0
13	28680879	.	T	C	6	8	14	0	2	16	0	0
13	28690442	.	T	C	1	2	3	0	0	3	0	0
13	28690457	.	C	T	1	2	3	0	0	3	0	0
13	28692778	.	C	T	3	6	9	0	1	10	0	0
13	28694447	.	G	A	16	7	23	0	1	24	0	0
13	28741042	.	A	T	3	9	12	0	2	14	0	0
13	28744690	.	C	T	13	14	27	1	1	29	0	0
13	28744831	.	C	T	7	8	15	0	0	15	0	0
13	28745188	.	G	A	19	13	32	0	2	34	0	0
13	28745825	.	G	A	5	13	18	0	4	22	0	0
13	28745899	.	A	G	5	11	16	0	0	16	0	0
13	28745963	.	C	T	11	10	21	0	0	21	0	0
13	28791714	.	A	G	3	3	6	0	0	6	0	0
13	28866485	.	A	G	11	7	18	0	0	18	0	0
13	28866518	.	C	A	9	4	13	0	1	14	0	0
13	28866553	.	A	G	8	10	18	0	0	18	0	0
13	28866590	.	A	G	13	8	21	0	3	24	0	0
13	28866615	.	C	T	11	10	21	0	1	22	0	0
13	28866722	.	T	C	5	7	12	0	0	12	0	0
13	28866857	.	G	T	2	7	9	0	9	18	0	0
13	28867071	.	G	T	12	9	21	0	0	21	0	0
13	28867382	.	A	T	8	14	22	0	1	23	0	0
13	28870698	.	A	T	27	22	49	0	2	51	0	0
13	28901463	.	T	A	31	26	57	0	0	57	0	0
13	28901714	.	T	A	35	25	60	0	1	61	0	0
13	28901871	.	A	T	19	11	30	4	0	34	0	0
13	28901957	.	A	G	8	17	25	0	2	27	0	0
13	28901996	.	T	C	10	24	34	0	1	35	0	0
13	28902058	.	C	T	19	14	33	0	2	35	0	0
13	29226842	.	T	C	2	2	4	0	0	4	0	0
13	29292193	.	C	T	1	2	3	0	0	3	0	0
13	29300574	.	A	G	2	0	2	0	2	4	0	0
13	29341522	.	C	T	3	6	9	0	0	9	0	0
13	29346927	.	G	A	1	3	4	0	8	12	0	0
13	29347034	.	A	G	7	3	10	0	0	10	0	0
13	29347252	.	T	C	3	4	7	0	0	7	0	0
13	29374514	.	C	T	1	3	4	0	0	4	0	0
13	29381011	.	C	T	1	3	4	0	0	4	0	0
13	29381047	.	A	C	1	3	4	0	1	5	0	0
13	29385786	.	A	G	3	3	6	0	1	7	0	0
13	29385894	.	G	A	6	3	9	0	0	9	0	0
13	29392238	.	C	T	4	5	9	0	0	9	0	0
13	29392261	.	G	A	4	3	7	0	1	8	0	0
13	29402613	.	T	G	10	6	16	0	0	16	0	0
13	29402669	.	C	T	7	6	13	0	3	16	0	0
13	29403953	.	A	C	6	3	9	0	0	9	0	0
13	29403957	.	C	T	3	5	8	0	0	8	0	0
13	29404145	.	T	C	7	5	12	0	1	13	0	0
13	29404217	.	A	T	2	14	16	0	3	19	0	0
13	29404218	.	T	A	11	10	21	0	0	21	0	0
13	29404323	.	G	T	20	13	33	0	2	35	0	0
13	29404399	.	A	T	17	21	38	0	1	39	0	0
13	29404400	.	C	T	17	21	38	0	2	40	0	0
13	29404576	.	A	G	18	19	37	0	1	38	0	0
13	29404633	.	C	T	19	20	39	0	1	40	0	0
13	29404660	.	T	G	17	0	17	0	21	38	0	0
13	29404754	.	T	A	5	8	13	0	0	13	0	0
13	29407196	.	C	T	11	7	18	0	0	18	0	0
13	29407397	.	C	A	2	5	7	0	4	11	0	0
13	29408009	.	G	T	3	1	4	0	3	7	0	0
13	29408052	.	G	T	4	6	10	0	0	10	0	0
13	29408192	.	T	A	7	10	17	0	0	17	0	0
13	29408650	.	A	G	9	5	14	0	0	14	0	0
13	29408677	.	T	A	7	7	14	0	0	14	0	0
13	29408745	.	G	A	4	5	9	0	1	10	0	0
13	29408989	.	G	A	3	7	10	0	0	10	0	0
13	29409206	.	T	G	3	4	7	0	0	7	0	0
13	29409210	.	T	A	4	3	7	0	0	7	0	0
13	29409530	.	G	A	4	4	8	0	0	8	0	0
13	29409558	.	G	A	7	4	11	0	0	11	0	0
13	29412379	.	G	T	1	6	7	0	1	8	0	0
13	29414441	.	G	C	2	2	4	0	0	4	0	0
13	29414509	.	G	A	2	2	4	0	0	4	0	0
13	29421211	.	G	T	2	2	4	0	0	4	0	0
13	29422211	.	C	T	11	2	13	1	1	15	0	0
13	29422391	.	A	C	2	3	5	0	1	6	0	0
13	29422459	.	C	T	1	4	5	0	0	5	0	0
13	29422511	.	T	A	4	3	7	0	0	7	0	0
13	29422808	.	G	A	5	4	9	0	0	9	0	0
13	29449280	.	C	A	6	4	10	0	1	11	0	0
13	29803832	.	T	C	2	3	5	0	0	5	0	0
13	29804075	.	T	C	5	5	10	0	1	11	0	0
13	29804178	.	T	A	5	2	7	0	0	7	0	0
13	29804362	.	T	C	5	3	8	0	0	8	0	0
13	29928675	.	A	G	7	3	10	0	0	10	0	0
13	29935678	.	T	G	4	1	5	0	0	5	0	0
13	29935682	.	T	C	4	2	6	0	0	6	0	0
13	29935885	.	C	A	2	6	8	0	1	9	0	0
13	29935983	.	C	G	2	4	6	0	0	6	0	0
13	29952902	.	C	T	5	3	8	0	0	8	0	0
13	29952914	.	G	A	5	3	8	0	0	8	0	0
13	29952972	.	C	T	6	6	12	0	0	12	0	0
13	29952973	.	A	T	6	6	12	0	0	12	0	0
13	29953265	.	T	G	13	5	18	0	0	18	0	0
13	29953267	.	C	A	13	5	18	0	0	18	0	0
13	29953383	.	G	T	11	4	15	0	0	15	0	0
13	29953522	.	T	C	8	0	8	0	5	13	0	0
13	29958513	.	T	A	9	10	19	0	3	22	0	0
13	29958551	.	G	A	10	8	18	0	2	20	0	0
13	29958725	.	A	G	5	10	15	0	1	16	0	0
13	29991300	.	T	C	1	0	1	0	2	3	0	0
13	29991317	.	T	A	1	1	2	0	0	2	0	0
13	30008596	.	A	T	33	20	53	0	1	54	0	0
13	30008631	.	T	C	26	12	38	0	3	41	0	0
13	30008737	.	T	C	19	15	34	0	2	36	0	0
13	30009128	.	G	C	4	2	6	0	0	6	0	0
13	30009818	.	A	C	22	25	47	0	0	47	0	0
13	30009968	.	T	C	21	13	34	3	1	38	0	0
13	30010059	.	C	A	21	19	40	0	1	41	0	0
13	30010137	.	T	C	26	10	36	0	1	37	0	0
13	30021321	.	T	A	4	6	10	0	2	12	0	0
13	30027523	.	T	A	6	2	8	0	0	8	0	0
13	30039013	.	C	T	3	3	6	0	0	6	0	0
13	30041662	.	G	A	7	16	23	0	0	23	0	0
13	30043579	.	A	G	7	9	16	0	2	18	0	0
13	30083348	.	A	C	6	3	9	0	0	9	0	0
13	30106137	.	C	G	1	0	1	0	3	4	0	0
13	30112396	.	C	T	16	9	25	0	2	27	0	0
13	30112414	.	T	A	17	9	26	0	0	26	0	0
13	30115125	.	A	G	14	9	23	0	2	25	0	0
13	30115217	.	C	T	7	9	16	0	1	17	0	0
13	30125106	.	G	A	20	5	25	0	3	28	0	0
13	30125107	.	T	C	19	7	26	0	1	27	0	0
13	30128388	.	A	T	16	8	24	0	3	27	0	0
13	30131722	.	G	T	15	12	27	0	1	28	0	0
13	30131804	.	G	A	19	11	30	0	0	30	0	0
13	30132190	.	T	C	25	12	37	0	5	42	0	0
13	30138790	.	C	T	3	2	5	0	0	5	0	0
13	30145000	.	A	C	2	5	7	0	0	7	0	0
13	30145217	.	A	G	4	5	9	0	1	10	0	0
13	30146199	.	C	A	2	4	6	0	0	6	0	0
13	30146447	.	T	A	2	2	4	0	3	7	0	0
13	30152310	.	A	C	8	5	13	0	0	13	0	0
13	30152502	.	G	C	25	20	45	0	0	45	0	0
13	30155934	.	C	T	14	9	23	0	0	23	0	0
13	30155973	.	T	A	12	9	21	0	2	23	0	0
13	30156176	.	T	C	10	8	18	0	1	19	0	0
13	30156347	.	A	T	8	8	16	0	0	16	0	0
13	30158975	.	A	G	5	7	12	0	0	12	0	0
13	30159823	.	C	T	3	4	7	0	0	7	0	0
13	30161553	.	T	A	6	7	13	0	0	13	0	0
13	30166340	.	C	A	12	8	20	0	0	20	0	0
13	30167430	.	T	G	8	11	19	0	2	21	0	0
13	30167432	.	A	G	8	11	19	0	2	21	0	0
13	30167711	.	G	A	22	14	36	0	1	37	0	0
13	30167716	.	T	C	20	17	37	0	1	38	0	0
13	30167807	.	G	A	3	21	24	0	15	39	0	0
13	30168662	.	T	A	22	9	31	0	7	38	0	0
13	30186997	.	C	T	1	3	4	0	0	4	0	0
13	30190019	.	A	T	3	2	5	0	0	5	0	0
13	30190031	.	C	T	2	2	4	0	0	4	0	0
13	30199107	.	T	G	6	6	12	0	1	13	0	0
13	30199148	.	G	A	6	4	10	0	0	10	0	0
13	30199190	.	T	C	6	6	12	0	0	12	0	0
13	30199210	.	T	C	5	8	13	0	0	13	0	0
13	30199225	.	T	C	5	7	12	0	0	12	0	0
13	30199255	.	C	T	7	3	10	0	0	10	0	0
13	30229090	.	A	G	24	3	27	0	41	68	0	0
13	30233353	.	A	G	4	2	6	0	0	6	0	0
13	30234351	.	A	C	31	18	49	1	0	50	0	0
13	30562673	.	T	C	9	6	15	0	0	16	1	0
13	30569650	.	A	C	2	6	8	0	1	9	0	0
13	30569687	.	A	G	5	3	8	0	0	8	0	0
13	30572333	.	A	C	1	2	3	0	0	3	0	0
13	30572778	.	C	T	2	2	4	0	0	4	0	0
13	30575206	.	G	A	11	6	17	0	2	19	0	0
13	30575325	.	A	G	10	8	18	0	0	18	0	0
13	30575452	.	C	A	5	5	10	0	0	10	0	0
13	30575637	.	T	A	6	7	13	0	1	14	0	0
13	30579552	.	A	G	1	7	8	0	0	8	0	0
13	30579565	.	A	G	2	6	8	0	0	8	0	0
13	30580935	.	T	C	4	0	4	0	3	7	0	0
13	30580966	.	T	G	2	2	4	0	1	5	0	0
13	30817617	.	G	T	2	3	5	0	2	7	0	0
13	30817633	.	G	A	3	4	7	0	0	7	0	0
13	30817872	.	A	G	5	0	5	0	5	10	0	0
13	30817951	.	C	T	3	9	12	0	1	13	0	0
13	30818107	.	C	G	8	6	14	0	0	14	0	0
13	30818246	.	C	T	9	20	29	0	1	30	0	0
13	30818319	.	A	T	5	6	11	0	0	11	0	0
13	30818849	.	A	G	7	10	17	0	0	17	0	0
13	30818876	.	C	T	6	17	23	0	0	23	0	0
13	30818986	.	T	A	11	15	26	0	0	26	0	0
13	30819133	.	G	C	19	16	35	1	2	38	0	0
13	30819334	.	T	C	15	16	31	0	0	31	0	0
13	30819444	.	A	T	4	9	13	0	0	13	0	0
13	30819445	.	T	G	4	9	13	0	0	13	0	0
13	30819645	.	T	C	5	6	11	0	0	11	0	0
13	30878624	.	A	T	2	2	4	0	0	4	0	0
13	30903345	.	A	G	3	5	8	0	0	8	0	0
13	30903921	.	T	A	2	4	6	0	0	6	0	0
13	30905716	.	T	C	7	4	11	0	0	11	0	0
13	30905827	.	G	A	2	5	7	0	3	10	0	0
13	30908977	.	T	C	6	7	13	0	0	13	0	0
13	30909200	.	C	T	3	2	5	0	0	5	0	0
13	30909296	.	G	T	1	2	3	0	0	3	0	0
13	30909449	.	G	T	1	4	5	0	0	5	0	0
13	30909624	.	T	A	4	3	7	0	0	7	0	0
13	30917890	.	C	A	2	2	4	0	0	4	0	0
13	30964041	.	G	T	0	3	3	0	1	4	0	0
13	30991541	.	T	C	2	2	4	0	0	4	0	0
13	31925599	.	C	T	1	2	3	0	0	3	0	0
13	31933666	.	A	G	3	2	5	0	1	6	0	0
13	31933684	.	G	A	3	2	5	0	0	5	0	0
13	31935926	.	C	T	2	3	5	0	0	5	0	0
13	31936053	.	C	G	1	2	3	0	0	3	0	0
13	32150021	.	T	C	2	3	5	0	0	5	0	0
13	32150193	.	A	C	2	2	4	0	0	4	0	0
13	32150245	.	A	C	1	2	3	0	1	4	0	0
13	32452658	.	C	T	2	2	4	0	0	4	0	0
13	32452949	.	T	G	0	5	5	0	1	6	0	0
13	32453362	.	T	G	4	6	10	0	0	10	0	0
13	32453661	.	G	T	3	2	5	0	0	5	0	0
13	32453721	.	A	C	3	2	5	0	0	5	0	0
13	32453730	.	C	T	3	2	5	0	0	5	0	0
13	32454381	.	A	T	6	7	13	0	0	13	0	0
13	32454546	.	A	G	2	0	2	0	2	4	0	0
13	32454565	.	T	A	1	3	4	0	0	4	0	0
13	32454617	.	G	A	0	2	2	0	5	7	0	0
13	32455754	.	C	T	6	7	13	0	0	13	0	0
13	32455943	.	A	G	5	4	9	0	0	9	0	0
13	32456312	.	C	G	10	11	21	0	0	21	0	0
13	32575859	.	T	G	1	2	3	0	0	3	0	0
13	32580556	.	T	G	6	7	13	0	0	13	0	0
13	32580572	.	A	C	7	8	15	0	0	15	0	0
13	32580616	.	G	A	3	8	11	0	0	11	0	0
13	32580618	.	C	G	4	8	12	0	0	12	0	0
13	32583864	.	C	T	14	10	24	0	1	25	0	0
13	32583930	.	A	G	13	12	25	0	0	25	0	0
13	32593009	.	T	C	4	0	4	0	5	9	0	0
13	32638670	.	T	C	5	7	12	0	0	12	0	0
13	32638718	.	A	G	4	6	10	0	1	11	0	0
13	32638737	.	T	C	8	7	15	0	1	16	0	0
13	32638991	.	T	C	8	5	13	0	1	14	0	0
13	32640975	.	C	A	4	8	12	0	1	13	0	0
13	32641146	.	A	T	7	3	10	0	0	10	0	0
13	32641165	.	G	A	5	3	8	0	0	8	0	0
13	32641480	.	T	C	3	3	6	0	0	6	0	0
13	32641979	.	C	T	3	3	6	0	1	7	0	0
13	32642012	.	A	C	5	4	9	0	0	9	0	0
13	32642015	.	T	A	5	4	9	0	0	9	0	0
13	32642047	.	G	C	4	4	8	0	0	8	0	0
13	32642050	.	G	C	4	3	7	0	1	8	0	0
13	32642238	.	A	G	9	6	15	0	1	16	0	0
13	32642284	.	C	A	6	5	11	0	1	12	0	0
13	32642293	.	A	G	6	5	11	0	0	11	0	0
13	32642488	.	A	G	7	11	18	0	0	18	0	0
13	32642964	.	C	T	1	2	3	0	0	3	0	0
13	32643073	.	A	G	1	3	4	0	0	4	0	0
13	32643366	.	G	A	1	2	3	0	0	3	0	0
13	32643414	.	A	T	1	3	4	0	0	4	0	0
13	32643696	.	T	G	1	2	3	0	0	3	0	0
13	32660774	.	T	C	2	4	6	0	0	6	0	0
13	32665008	.	A	C	4	5	9	0	0	9	0	0
13	32665035	.	G	A	4	4	8	0	0	8	0	0
13	32680039	.	C	T	0	2	2	0	4	6	0	0
13	32812788	.	A	C	5	2	7	0	1	8	0	0
13	32815668	.	G	A	9	10	19	0	0	19	0	0
13	32815765	.	C	T	4	6	10	0	0	10	0	0
13	32815884	.	T	C	11	8	19	0	1	20	0	0
13	32815981	.	A	T	10	12	22	0	1	23	0	0
13	32816055	.	G	C	8	19	27	0	0	27	0	0
13	32816128	.	T	G	12	15	27	0	0	27	0	0
13	32816338	.	C	G	12	9	21	0	0	21	0	0
13	32825086	.	C	T	4	5	9	0	1	10	0	0
13	32825137	.	G	A	6	9	15	0	1	16	0	0
13	32825503	.	A	G	5	4	9	0	1	10	0	0
13	32826966	.	T	C	2	3	5	0	0	5	0	0
13	32826978	.	A	G	3	3	6	0	0	6	0	0
13	32827754	.	A	G	3	2	5	0	0	5	0	0
13	32830255	.	G	T	1	4	5	0	1	6	0	0
13	32831770	.	C	T	1	3	4	0	1	5	0	0
13	32831965	.	T	C	3	3	6	0	0	6	0	0
13	32831971	.	T	C	4	3	7	0	0	7	0	0
13	32832055	.	A	G	4	4	8	0	0	8	0	0
13	32832058	.	T	A	3	3	6	0	0	6	0	0
13	32838254	.	C	T	2	3	5	0	0	5	0	0
13	32838276	.	T	A	4	2	6	0	0	6	0	0
13	32838399	.	T	C	2	0	2	0	5	7	0	0
13	32838417	.	T	C	2	0	2	0	4	6	0	0
13	32838507	.	T	C	1	1	2	0	1	3	0	0
13	32841377	.	C	T	1	2	3	0	0	3	0	0
13	32841598	.	A	G	2	3	5	0	0	5	0	0
13	32902537	.	T	G	2	2	4	0	0	4	0	0
13	32902545	.	G	A	3	2	5	0	0	5	0	0
13	33028797	.	A	G	9	9	18	0	2	20	0	0
13	33029624	.	G	T	1	9	10	0	10	20	0	0
13	33031915	.	A	G	13	10	23	0	3	26	0	0
13	33033354	.	A	G	17	22	39	0	4	43	0	0
13	33048095	.	T	C	2	0	2	0	4	6	0	0
13	33054598	.	T	C	3	2	5	0	0	5	0	0
13	33059182	.	C	T	3	5	8	0	0	8	0	0
13	33059257	.	T	C	8	6	14	0	0	14	0	0
13	33059260	.	A	G	8	5	13	0	0	13	0	0
13	33062352	.	G	C	4	4	8	0	0	8	0	0
13	33065614	.	A	C	16	13	29	0	1	30	0	0
13	33065670	.	G	A	14	10	24	0	0	24	0	0
13	33066691	.	C	A	0	6	6	0	7	13	0	0
13	33066778	.	T	C	2	6	8	0	0	8	0	0
13	33066782	.	G	T	2	4	6	0	2	8	0	0
13	33066882	.	A	C	1	3	4	0	0	4	0	0
13	33066893	.	A	T	1	3	4	0	0	4	0	0
13	33067116	.	T	A	3	6	9	0	0	9	0	0
13	33067129	.	A	T	3	5	8	0	0	9	1	0
13	33067157	.	T	G	3	5	8	0	0	8	0	0
13	33067522	.	A	G	2	2	4	0	0	4	0	0
13	33067624	.	C	T	4	3	7	0	0	7	0	0
13	33070366	.	G	A	5	3	8	0	0	8	0	0
13	33079270	.	A	G	1	2	3	0	0	3	0	0
13	33122594	.	G	A	2	4	6	0	1	7	0	0
13	33122941	.	C	T	12	16	28	0	2	30	0	0
13	33122949	.	G	C	16	7	23	0	5	28	0	0
13	35744630	.	A	T	5	2	7	0	0	7	0	0
13	36558152	.	C	T	1	7	8	0	0	8	0	0
13	36614574	.	C	T	1	3	4	0	1	5	0	0
13	36680611	.	G	A	1	7	8	0	5	13	0	0
13	36683911	.	C	T	10	7	17	0	0	17	0	0
13	36691543	.	T	C	11	11	22	0	0	22	0	0
13	36705778	.	A	G	2	2	4	0	0	4	0	0
13	36705895	.	G	A	2	5	7	0	0	7	0	0
13	36706013	.	T	G	7	6	13	0	0	13	0	0
13	36713450	.	T	C	1	3	4	0	0	4	0	0
13	36764791	.	C	T	11	7	18	0	0	18	0	0
13	36764838	.	C	G	5	9	14	0	0	14	0	0
13	36771815	.	G	A	7	8	15	0	1	16	0	0
13	36781068	.	G	C	0	18	18	0	12	30	0	0
13	36781407	.	A	G	27	0	27	0	19	46	0	0
13	36783998	.	G	A	4	24	28	0	31	59	0	0
13	36784262	.	G	A	0	12	12	0	16	28	0	0
13	36868564	.	G	A	27	13	40	0	0	40	0	0
13	36868635	.	T	G	30	9	39	0	0	39	0	0
13	36868938	.	C	A	27	20	47	1	4	52	0	0
13	36869639	.	C	T	2	29	31	0	24	55	0	0
13	36872777	.	A	G	17	15	32	0	2	34	0	0
13	36872814	.	A	C	16	0	16	0	16	32	0	0
13	36879965	.	T	C	10	1	11	0	4	15	0	0
13	36879983	.	G	A	7	4	11	0	0	11	0	0
13	36880028	.	A	C	7	0	7	0	8	15	0	0
13	36887746	.	C	A	0	5	5	0	4	9	0	0
13	36898229	.	G	A	4	9	13	0	0	13	0	0
13	36910378	.	G	A	5	3	8	0	0	8	0	0
13	36910387	.	C	T	6	3	9	0	0	9	0	0
13	36910729	.	G	C	2	4	6	0	2	8	0	0
13	36911037	.	T	C	4	1	5	0	2	7	0	0
13	36932023	.	C	T	10	8	18	0	1	19	0	0
13	36932289	.	G	A	10	4	14	0	0	14	0	0
13	36932356	.	A	G	4	8	12	0	1	13	0	0
13	36932581	.	A	C	2	3	5	0	1	6	0	0
13	36932970	.	T	G	3	2	5	0	2	7	0	0
13	36933206	.	C	T	8	4	12	0	0	12	0	0
13	36933279	.	A	T	3	2	5	0	0	5	0	0
13	36990431	.	G	A	1	3	4	0	0	4	0	0
13	36994954	.	T	G	1	2	3	0	0	3	0	0
13	36995832	.	G	A	1	2	3	0	0	3	0	0
13	36995873	.	G	T	3	2	5	0	0	5	0	0
13	36995874	.	A	G	2	2	4	0	1	5	0	0
13	36996681	.	C	T	1	5	6	0	0	6	0	0
13	36997170	.	G	T	1	2	3	0	0	3	0	0
13	36997459	.	G	A	0	5	5	0	10	15	0	0
13	36997724	.	C	T	1	2	3	0	0	3	0	0
13	37071826	.	G	A	0	1	1	0	1	2	0	0
13	37071841	.	A	G	0	2	2	0	1	3	0	0
13	37075501	.	T	A	6	5	11	0	0	11	0	0
13	37075528	.	T	A	4	3	7	0	0	7	0	0
13	37075547	.	T	A	1	3	4	0	3	7	0	0
13	37075970	.	A	G	8	6	14	0	0	14	0	0
13	37075986	.	C	G	10	7	17	0	0	17	0	0
13	37076093	.	A	T	6	7	13	0	0	13	0	0
13	37076152	.	A	G	2	4	6	0	0	6	0	0
13	37076269	.	T	C	18	7	25	0	0	25	0	0
13	37076373	.	T	G	14	8	22	0	1	23	0	0
13	37076382	.	C	T	2	10	12	0	12	24	0	0
13	37076415	.	T	C	10	6	16	0	2	18	0	0
13	37076501	.	C	T	6	4	10	0	0	10	0	0
13	37076510	.	C	T	6	3	9	0	0	9	0	0
13	37076710	.	C	T	4	3	7	0	0	7	0	0
13	37076934	.	C	T	3	3	6	0	0	6	0	0
13	37077127	.	T	C	4	5	9	0	0	9	0	0
13	37077903	.	A	G	4	5	9	0	0	9	0	0
13	37077961	.	C	T	0	3	3	0	3	7	1	0
13	37078181	.	C	T	1	4	5	0	3	8	0	0
13	37302643	.	C	A	3	3	6	0	0	6	0	0
13	37421509	.	C	T	1	16	17	0	7	24	0	0
13	37421604	.	A	C	13	17	30	0	1	31	0	0
13	37422417	.	C	T	2	20	22	0	18	40	0	0
13	37425730	.	G	A	4	4	8	0	0	8	0	0
13	37429222	.	C	T	1	2	3	0	0	3	0	0
13	37469155	.	C	A	1	2	3	0	2	5	0	0
13	37469340	.	C	G	1	3	4	0	0	4	0	0
13	37469396	.	T	C	4	3	7	0	0	7	0	0
13	37470562	.	T	C	1	3	4	0	0	4	0	0
13	37528544	.	T	C	3	2	5	0	1	6	0	0
13	37528612	.	T	A	4	4	8	0	0	8	0	0
13	37528624	.	T	C	3	0	3	0	3	6	0	0
13	37528793	.	T	G	1	2	3	0	0	3	0	0
13	37532764	.	G	T	1	2	3	0	1	4	0	0
13	37651177	.	T	A	11	6	17	0	0	17	0	0
13	37666322	.	C	T	2	3	5	0	0	5	0	0
13	37668539	.	C	A	1	2	3	0	0	3	0	0
13	37668546	.	A	G	1	3	4	0	0	4	0	0
13	37671948	.	T	C	1	7	8	0	0	8	0	0
13	37671949	.	T	C	1	7	8	0	0	8	0	0
13	37672082	.	T	G	2	6	8	0	1	9	0	0
13	37672087	.	A	C	1	6	7	0	1	8	0	0
13	37672129	.	G	A	1	7	8	0	5	13	0	0
13	37672133	.	G	A	6	9	15	0	0	15	0	0
13	37672716	.	C	T	12	8	20	0	2	22	0	0
13	37672777	.	A	G	12	10	22	0	1	23	0	0
13	37673230	.	A	T	3	10	13	0	0	13	0	0
13	39657068	.	A	G	3	2	5	0	0	5	0	0
13	39657156	.	T	G	1	4	5	0	0	5	0	0
13	39657358	.	C	T	1	2	3	0	0	3	0	0
13	40352476	.	A	G	13	12	25	0	0	25	0	0
13	40352512	.	A	G	18	7	25	0	1	26	0	0
13	40352830	.	A	G	19	3	22	0	1	23	0	0
13	40353199	.	A	G	11	4	15	0	0	15	0	0
13	41128286	.	G	A	1	8	9	0	1	10	0	0
13	42400473	.	C	T	3	2	5	0	0	5	0	0
13	42481169	.	T	C	4	12	16	0	0	16	0	0
13	42481256	.	A	G	19	8	27	0	2	29	0	0
13	42481267	.	G	A	15	9	24	0	3	27	0	0
13	42481306	.	T	C	13	8	21	0	3	24	0	0
13	42481512	.	A	G	13	17	30	0	1	31	0	0
13	42481538	.	A	G	16	14	30	0	1	31	0	0
13	42481575	.	T	C	16	20	36	0	1	37	0	0
13	42481599	.	A	G	13	19	32	0	2	34	0	0
13	42483050	.	A	G	9	17	26	1	1	28	0	0
13	42483082	.	A	G	10	16	26	1	1	28	0	0
13	42483089	.	T	C	11	17	28	1	0	29	0	0
13	42488440	.	C	T	6	5	11	0	0	11	0	0
13	42490778	.	T	C	5	4	9	0	0	9	0	0
13	42491406	.	G	A	1	4	5	1	1	7	0	0
13	42491448	.	C	T	0	4	4	1	2	7	0	0
13	42500513	.	A	T	3	2	5	0	0	5	0	0
13	42516915	.	C	G	0	3	3	0	1	4	0	0
13	42607276	.	C	G	2	2	4	0	0	4	0	0
13	42611117	.	G	C	3	5	8	0	0	8	0	0
13	42614968	.	G	T	1	3	4	0	3	7	0	0
13	42615004	.	A	T	2	7	9	0	0	9	0	0
13	42615073	.	T	G	8	3	11	0	0	11	0	0
13	42615094	.	G	A	5	3	8	0	0	8	0	0
13	42616301	.	A	C	2	4	6	0	0	6	0	0
13	42616527	.	C	A	4	2	6	0	1	7	0	0
13	42616563	.	T	C	5	2	7	0	0	7	0	0
13	42617552	.	C	T	2	5	7	0	0	7	0	0
13	42621864	.	A	G	1	3	4	0	1	5	0	0
13	42621870	.	A	C	2	2	4	0	0	4	0	0
13	42622006	.	C	T	3	4	7	0	0	7	0	0
13	42622013	.	C	T	3	5	8	0	0	8	0	0
13	42626622	.	C	T	0	5	5	0	7	12	0	0
13	42626763	.	C	T	1	2	3	0	0	3	0	0
13	42626766	.	T	A	1	2	3	0	0	3	0	0
13	42632966	.	A	G	1	3	4	0	0	4	0	0
13	42676262	.	T	A	12	8	20	0	1	21	0	0
13	42681027	.	G	T	4	2	6	0	0	6	0	0
13	42681759	.	G	T	9	6	15	0	0	15	0	0
13	42681856	.	T	G	9	15	24	0	1	25	0	0
13	42682033	.	T	A	14	12	26	1	0	27	0	0
13	42686420	.	G	T	2	2	4	0	1	5	0	0
13	42691482	.	G	T	3	3	6	0	0	6	0	0
13	42693030	.	G	A	4	3	7	0	0	7	0	0
13	42698930	.	A	T	3	3	6	0	0	6	0	0
13	42721011	.	G	A	4	2	6	0	0	6	0	0
13	43223679	.	G	A	14	15	29	0	1	30	0	0
13	43223722	.	T	G	21	23	44	0	1	45	0	0
13	43225093	.	C	T	11	22	33	0	2	35	0	0
13	43225201	.	T	C	9	2	11	0	18	29	0	0
13	43226423	.	T	A	10	15	25	0	1	26	0	0
13	43226429	.	C	T	0	13	13	0	12	25	0	0
13	43229872	.	A	C	7	15	22	0	1	23	0	0
13	43229923	.	G	A	14	12	26	0	0	26	0	0
13	43237237	.	T	C	5	4	9	0	0	9	0	0
13	43237255	.	A	C	5	0	5	0	4	9	0	0
13	43238513	.	C	A	6	5	11	0	0	11	0	0
13	44629339	.	G	A	1	2	3	0	0	3	0	0
13	44702469	.	T	C	16	1	17	0	17	34	0	0
13	44715290	.	G	A	6	8	14	0	2	16	0	0
13	44738328	.	G	A	12	6	18	0	0	18	0	0
13	44767765	.	T	C	10	13	23	0	0	23	0	0
13	44772073	.	A	G	3	2	5	0	0	5	0	0
13	44788217	.	C	T	5	3	8	0	2	10	0	0
13	44788358	.	G	A	13	6	19	0	2	21	0	0
13	44788361	.	T	A	14	5	19	0	1	20	0	0
13	44788815	.	C	T	22	6	28	0	0	28	0	0
13	44788827	.	A	C	21	6	27	0	0	27	0	0
13	44827595	.	T	C	1	1	2	0	1	3	0	0
13	44832437	.	T	A	1	2	3	1	0	4	0	0
13	44842832	.	C	A	1	2	3	0	3	6	0	0
13	44869386	.	G	T	9	6	15	0	1	16	0	0
13	44888282	.	C	T	8	6	14	0	1	15	0	0
13	45010064	.	A	G	11	15	26	1	0	27	0	0
13	45012835	.	A	T	25	30	55	0	5	60	0	0
13	45015355	.	A	T	16	14	30	0	0	30	0	0
13	45015443	.	T	C	10	41	51	0	1	52	0	0
13	45015503	.	T	C	9	23	32	0	4	36	0	0
13	45018600	.	A	G	26	27	53	0	10	63	0	0
13	45018732	.	G	A	22	35	57	0	7	64	0	0
13	45019001	.	A	C	23	0	23	0	36	59	0	0
13	45036033	.	A	C	5	0	5	0	4	9	0	0
13	45432170	.	A	G	19	5	24	0	0	24	0	0
13	45434952	.	T	G	19	14	33	0	3	36	0	0
13	45436554	.	A	G	12	22	34	0	0	34	0	0
13	45436561	.	G	T	13	23	36	0	1	37	0	0
13	45468567	.	A	T	16	45	61	3	2	66	0	0
13	45468827	.	G	C	32	5	37	0	44	81	0	0
13	45470601	.	A	G	26	33	59	3	2	64	0	0
13	45470815	.	A	T	25	22	47	0	2	49	0	0
13	45470926	.	G	C	14	17	31	0	2	33	0	0
13	45470983	.	A	G	11	7	18	0	2	20	0	0
13	45471048	.	A	G	5	9	14	0	1	15	0	0
13	45471052	.	A	G	6	8	14	0	1	15	0	0
13	45471243	.	G	A	24	22	46	0	1	47	0	0
13	45471367	.	A	T	29	16	45	0	2	47	0	0
13	45471475	.	C	A	22	12	34	0	0	34	0	0
13	45471669	.	C	T	24	28	52	0	3	55	0	0
13	45471888	.	C	T	1	14	15	0	18	33	0	0
13	45472124	.	T	G	8	5	13	0	1	14	0	0
13	45472215	.	G	C	21	21	42	0	1	43	0	0
13	45472653	.	G	A	23	32	55	0	1	56	0	0
13	45472924	.	G	A	41	24	65	0	4	69	0	0
13	45472954	.	G	A	39	31	70	0	3	73	0	0
13	45476360	.	A	C	6	5	11	0	0	11	0	0
13	45476711	.	C	T	13	11	24	0	0	24	0	0
13	45476731	.	A	T	11	10	21	0	2	23	0	0
13	45481475	.	G	A	22	17	39	0	1	40	0	0
13	45481792	.	A	G	2	5	7	0	1	8	0	0
13	45494912	.	G	C	11	23	34	0	2	36	0	0
13	45495227	.	C	A	17	27	44	0	3	47	0	0
13	45495442	.	G	T	3	2	5	0	0	5	0	0
13	45553072	.	G	A	1	4	5	0	0	5	0	0
13	45565508	.	C	T	6	5	11	0	0	11	0	0
13	45565637	.	G	A	2	4	6	0	5	11	0	0
13	45565646	.	G	A	1	3	4	0	7	11	0	0
13	45570300	.	A	C	3	3	6	0	0	6	0	0
13	45991772	.	T	C	19	22	41	0	1	42	0	0
13	45991801	.	C	T	20	16	36	0	1	37	0	0
13	45999530	.	G	A	2	19	21	0	15	36	0	0
13	45999723	.	C	T	18	23	41	0	2	43	0	0
13	46000060	.	G	A	2	6	8	0	6	14	0	0
13	46179340	.	C	T	27	25	52	0	2	54	0	0
13	46179387	.	C	T	31	29	60	0	5	65	0	0
13	46179392	.	G	A	32	24	56	0	8	64	0	0
13	46179806	.	T	A	22	35	57	0	3	60	0	0
13	46179814	.	A	G	25	37	62	0	1	63	0	0
13	46298734	.	G	A	16	8	24	0	1	25	0	0
13	46298973	.	T	C	4	3	7	0	1	8	0	0
13	46298988	.	T	C	5	2	7	0	0	7	0	0
13	46299677	.	G	T	2	4	6	0	0	6	0	0
13	46299873	.	T	A	3	5	8	0	0	8	0	0
13	46299875	.	T	G	2	5	7	0	0	7	0	0
13	46300224	.	T	A	3	6	9	0	0	9	0	0
13	46300247	.	A	T	4	5	9	0	0	9	0	0
13	46300259	.	T	G	6	5	11	0	1	12	0	0
13	46300421	.	C	T	5	5	10	0	1	11	0	0
13	46300450	.	C	T	4	4	8	0	1	9	0	0
13	46300694	.	T	A	7	5	12	0	0	12	0	0
13	46300737	.	G	A	10	7	17	0	2	19	0	0
13	46520845	.	T	C	3	5	8	0	0	8	0	0
13	46520924	.	T	C	10	9	19	0	0	19	0	0
13	46521542	.	C	T	0	3	3	0	5	8	0	0
13	46521633	.	G	A	8	5	13	0	0	13	0	0
13	46831698	.	C	T	2	6	8	0	7	15	0	0
13	46832231	.	T	C	13	4	17	0	0	17	0	0
13	46832371	.	A	C	10	4	14	1	1	16	0	0
13	46832374	.	T	C	10	4	14	0	1	15	0	0
13	46832449	.	A	T	10	5	15	0	0	15	0	0
13	46832471	.	A	C	9	11	20	0	0	20	0	0
13	46832724	.	C	A	1	5	6	0	6	12	0	0
13	46833050	.	C	G	4	3	7	0	0	7	0	0
13	46833064	.	C	T	3	3	6	0	0	6	0	0
13	46833197	.	A	G	4	3	7	0	0	7	0	0
13	46835304	.	C	T	1	2	3	0	0	3	0	0
13	46935089	.	C	T	2	3	5	0	0	5	0	0
13	46988299	.	C	T	11	19	30	0	2	32	0	0
13	46988390	.	T	C	7	1	8	0	30	38	0	0
13	46988457	.	C	A	1	22	23	0	11	34	0	0
13	46988561	.	A	G	9	22	31	0	1	32	0	0
13	46988588	.	A	G	15	24	39	0	0	39	0	0
13	46988638	.	T	G	12	23	35	0	0	35	0	0
13	46989607	.	C	T	1	12	13	0	10	23	0	0
13	47163748	.	A	G	6	0	6	0	7	13	0	0
13	47690269	.	A	T	1	3	4	0	0	4	0	0
13	47690300	.	A	T	1	2	3	0	0	3	0	0
13	47690383	.	C	G	3	2	5	0	0	5	0	0
13	47690766	.	T	C	4	1	5	0	0	5	0	0
13	47690779	.	G	A	1	2	3	0	5	8	0	0
13	47838052	.	G	A	0	2	2	0	3	5	0	0
13	47839071	.	C	T	1	2	3	0	0	3	0	0
13	48755122	.	T	C	3	3	6	0	0	6	0	0
13	48758775	.	T	C	1	0	1	0	2	3	0	0
13	48759105	.	A	T	2	3	5	0	0	5	0	0
13	49153904	.	T	C	5	4	9	0	0	9	0	0
13	49153938	.	G	A	4	9	13	0	0	13	0	0
13	49153953	.	A	G	6	8	14	0	0	14	0	0
13	49154048	.	G	A	10	6	16	0	1	17	0	0
13	49158734	.	G	A	0	3	3	0	1	4	0	0
13	49167185	.	T	G	6	2	8	0	0	8	0	0
13	49167195	.	C	T	5	2	7	0	0	7	0	0
13	49169071	.	A	T	3	3	6	0	1	7	0	0
13	49443721	.	C	T	21	11	32	0	1	33	0	0
13	49443868	.	T	C	11	1	12	0	15	27	0	0
13	49444090	.	C	T	12	13	25	0	2	27	0	0
13	49444177	.	C	A	1	13	14	0	16	30	0	0
13	49444224	.	G	A	12	11	23	0	1	24	0	0
13	49444446	.	C	A	7	11	18	0	2	20	0	0
13	49544535	.	G	A	1	4	5	1	0	6	0	0
13	49544683	.	C	A	4	2	6	0	0	6	0	0
13	49544833	.	C	T	23	23	46	0	3	49	0	0
13	49544873	.	T	A	26	20	46	0	1	47	0	0
13	49544973	.	G	T	22	13	35	0	0	35	0	0
13	49545039	.	A	G	17	17	34	2	1	37	0	0
13	49583976	.	A	G	15	16	31	0	1	32	0	0
13	49585341	.	T	A	15	7	22	0	3	25	0	0
13	49585344	.	A	T	15	8	23	0	2	25	0	0
13	49585384	.	T	G	6	2	8	0	0	8	0	0
13	49727448	.	A	G	1	4	5	0	0	5	0	0
13	49727463	.	T	G	1	3	4	0	1	5	0	0
13	49765774	.	A	C	1	2	3	0	0	3	0	0
13	49765806	.	C	T	1	4	5	0	0	5	0	0
13	49765815	.	G	T	0	3	3	0	1	4	0	0
13	49765896	.	T	C	2	2	4	0	1	5	0	0
13	49766022	.	T	C	2	2	4	0	0	4	0	0
13	49766268	.	G	A	0	5	5	0	3	8	0	0
13	49767539	.	A	G	6	4	10	0	1	11	0	0
13	49767570	.	G	A	9	5	14	0	0	14	0	0
13	49767736	.	T	G	4	8	12	0	1	13	0	0
13	49767806	.	T	A	2	5	7	0	0	7	0	0
13	49767807	.	G	T	2	5	7	0	0	7	0	0
13	49767905	.	C	A	2	2	4	0	0	4	0	0
13	49767953	.	T	A	5	6	11	0	1	12	0	0
13	49768095	.	A	G	7	7	14	0	5	19	0	0
13	49768207	.	C	T	8	7	15	0	1	16	0	0
13	49768401	.	C	T	11	10	21	0	0	21	0	0
13	49768402	.	A	C	11	9	20	0	1	21	0	0
13	49768646	.	A	G	1	8	9	0	0	9	0	0
13	49769060	.	C	T	12	7	19	3	0	22	0	0
13	49769274	.	G	A	0	4	4	0	6	10	0	0
13	49774860	.	A	C	3	0	3	0	5	8	0	0
13	49774893	.	G	T	5	9	14	0	0	14	0	0
13	49775018	.	T	G	7	8	15	0	1	16	0	0
13	49775048	.	C	G	4	3	7	0	0	7	0	0
13	49775075	.	T	G	6	2	8	0	0	8	0	0
13	49785412	.	C	T	4	7	11	0	0	11	0	0
13	49785417	.	T	C	4	8	12	0	0	12	0	0
13	49785455	.	C	G	6	10	16	0	0	16	0	0
13	49785456	.	A	G	5	10	15	0	1	16	0	0
13	49786114	.	A	G	8	8	16	0	0	16	0	0
13	49788102	.	A	T	6	5	11	0	1	12	0	0
13	49802010	.	C	A	6	4	10	0	0	10	0	0
13	49802025	.	T	G	7	3	10	0	0	10	0	0
13	49819001	.	C	A	0	2	2	0	2	4	0	0
13	49819019	.	A	G	3	2	5	0	0	5	0	0
13	50169004	.	C	T	4	8	12	0	2	14	0	0
13	51140665	.	A	G	3	3	6	0	0	6	0	0
13	51140782	.	A	G	4	3	7	0	0	7	0	0
13	51145614	.	T	G	3	3	6	0	0	6	0	0
14	355425	.	T	A	1	3	4	0	0	4	0	0
14	565260	.	A	T	1	2	3	0	0	3	0	0
14	684179	.	G	A	10	16	26	0	2	28	0	0
14	715201	.	C	T	2	2	4	0	0	4	0	0
14	715207	.	A	G	2	0	2	0	2	4	0	0
14	717927	.	G	A	3	3	6	0	0	6	0	0
14	718194	.	A	C	2	4	6	0	0	6	0	0
14	719926	.	A	G	1	2	3	0	0	3	0	0
14	723539	.	T	C	3	11	14	0	0	14	0	0
14	723542	.	T	C	3	11	14	0	0	14	0	0
14	729870	.	G	T	1	5	6	0	1	7	0	0
14	757469	.	G	T	1	2	3	0	0	3	0	0
14	757716	.	T	G	1	2	3	0	1	4	0	0
14	758889	.	A	T	1	2	3	0	0	3	0	0
14	758904	.	C	G	0	3	3	0	1	4	0	0
14	791067	.	C	G	2	1	3	0	4	7	0	0
14	791636	.	T	C	2	2	4	0	0	4	0	0
14	792133	.	C	A	3	3	6	0	0	6	0	0
14	792142	.	T	C	2	3	5	0	1	6	0	0
14	792173	.	C	A	4	2	6	0	0	6	0	0
14	792499	.	C	G	2	0	2	0	4	6	0	0
14	792536	.	A	C	2	6	8	0	0	8	0	0
14	792686	.	G	A	3	4	7	0	0	7	0	0
14	792917	.	T	G	1	4	5	0	0	5	0	0
14	863188	.	T	C	9	2	11	0	1	12	0	0
14	863515	.	T	C	4	0	4	0	6	10	0	0
14	863868	.	G	T	15	10	25	0	2	27	0	0
14	863949	.	T	C	9	9	18	0	1	19	0	0
14	868838	.	G	A	9	10	19	0	0	19	0	0
14	868855	.	A	G	8	8	16	0	1	17	0	0
14	914602	.	G	C	5	2	7	0	1	8	0	0
14	916908	.	A	T	3	2	5	0	0	5	0	0
14	937298	.	G	A	1	2	3	0	0	3	0	0
14	937345	.	G	A	2	2	4	0	0	4	0	0
14	937399	.	A	T	2	4	6	0	0	6	0	0
14	937849	.	A	C	2	3	5	0	0	5	0	0
14	973379	.	C	A	1	2	3	0	0	3	0	0
14	994353	.	G	T	0	2	2	0	1	3	0	0
14	994413	.	C	T	2	3	5	0	0	5	0	0
14	994437	.	T	C	1	3	4	0	0	4	0	0
14	997012	.	C	A	3	3	6	0	0	6	0	0
14	997603	.	T	C	1	3	4	0	1	5	0	0
14	997651	.	A	C	3	5	8	0	0	8	0	0
14	997705	.	C	A	6	7	13	0	1	14	0	0
14	997765	.	T	C	7	6	13	0	0	13	0	0
14	997783	.	A	G	2	5	7	0	0	7	0	0
14	997853	.	C	T	4	3	7	0	0	7	0	0
14	1119225	.	C	T	4	3	7	0	2	9	0	0
14	1119899	.	A	C	2	2	4	0	1	5	0	0
14	1119993	.	T	C	6	6	12	0	1	13	0	0
14	1120017	.	T	C	4	7	11	0	0	11	0	0
14	1120072	.	C	A	6	6	12	0	0	12	0	0
14	1120154	.	T	C	4	9	13	0	0	13	0	0
14	1120178	.	C	T	2	7	9	0	0	9	0	0
14	1120236	.	C	T	7	6	13	0	0	13	0	0
14	1120452	.	G	T	0	3	3	0	2	5	0	0
14	1120598	.	T	C	2	3	5	0	0	5	0	0
14	1121029	.	A	G	3	4	7	0	0	7	0	0
14	1121068	.	C	T	4	4	8	0	1	9	0	0
14	1121297	.	T	G	3	3	6	0	0	6	0	0
14	1121303	.	G	C	3	2	5	0	0	5	0	0
14	1121413	.	C	T	2	5	7	0	2	9	0	0
14	1124602	.	C	G	1	2	3	0	0	3	0	0
14	1138701	.	C	T	1	2	3	0	0	3	0	0
14	1150594	.	A	G	3	4	7	0	1	8	0	0
14	1152544	.	C	A	9	8	17	0	1	18	0	0
14	1153665	.	T	C	8	5	13	0	0	13	0	0
14	1153830	.	T	A	3	10	13	0	1	14	0	0
14	1159869	.	A	G	9	0	9	0	18	27	0	0
14	1160333	.	C	T	20	6	26	0	1	27	0	0
14	1160427	.	T	G	22	11	33	0	2	35	0	0
14	1171023	.	T	C	2	3	5	0	0	5	0	0
14	1171052	.	T	A	2	3	5	0	1	6	0	0
14	1177827	.	A	G	4	2	6	0	1	7	0	0
14	1177865	.	A	G	3	2	5	0	2	7	0	0
14	1192448	.	G	A	6	9	15	0	1	16	0	0
14	1192681	.	C	T	6	7	13	0	1	14	0	0
14	1196658	.	T	G	4	3	7	0	0	7	0	0
14	1200545	.	G	T	4	2	6	0	0	6	0	0
14	1203713	.	A	G	23	20	43	0	4	47	0	0
14	1203770	.	G	T	18	18	36	0	1	37	0	0
14	1204197	.	A	T	14	17	31	0	1	32	0	0
14	1204299	.	G	A	14	14	28	0	2	30	0	0
14	1225227	.	C	T	0	3	3	0	2	5	0	0
14	1889644	.	T	C	11	4	15	10	0	25	0	0
14	2120087	.	A	G	1	11	12	2	0	14	0	0
14	2123168	.	G	A	1	6	7	1	0	8	0	0
14	2386403	.	T	C	4	2	6	0	0	6	0	0
14	4043684	.	A	G	1	10	11	0	0	11	0	0
14	4183711	.	A	G	2	0	2	0	3	5	0	0
14	4183724	.	A	G	2	2	4	0	1	5	0	0
14	4193501	.	T	C	2	3	5	0	0	5	0	0
14	5588315	.	A	T	2	3	5	0	0	5	0	0
14	6332869	.	A	C	8	4	12	0	1	13	0	0
14	6332872	.	T	C	8	5	13	0	0	13	0	0
14	6333022	.	T	C	4	3	7	1	1	9	0	0
14	6599541	.	G	A	1	6	7	0	0	7	0	0
14	6624558	.	A	G	9	2	11	1	11	23	0	0
14	6624621	.	A	G	9	18	27	0	1	28	0	0
14	6625002	.	A	C	29	11	40	5	4	49	0	0
14	6625521	.	G	C	31	24	55	1	5	61	0	0
14	7170558	.	T	C	2	9	11	0	0	11	0	0
14	7170559	.	T	C	1	9	10	0	1	11	0	0
14	7916260	.	A	G	3	8	11	0	0	11	0	0
14	7916279	.	A	G	3	6	9	0	1	10	0	0
14	8495668	.	A	T	2	3	5	2	0	7	0	0
14	8569251	.	A	G	2	2	4	0	0	4	0	0
14	8569252	.	A	G	2	2	4	0	0	4	0	0
14	8571795	.	A	G	1	5	6	0	1	7	0	0
14	8770425	.	A	G	4	5	9	0	0	9	0	0
14	8770436	.	A	C	8	6	14	0	0	14	0	0
14	8770589	.	C	T	5	8	13	0	2	15	0	0
14	8770931	.	T	A	4	4	8	0	0	8	0	0
14	8806587	.	A	C	2	0	2	0	5	7	0	0
14	8806590	.	A	G	2	5	7	0	0	7	0	0
14	8806680	.	T	C	7	7	14	0	2	16	0	0
14	8806722	.	A	G	9	6	15	0	0	15	0	0
14	8806730	.	G	T	10	5	15	0	1	16	0	0
14	8809693	.	A	G	9	6	15	0	5	20	0	0
14	8816113	.	T	C	15	5	20	0	0	20	0	0
14	8816194	.	C	T	17	13	30	0	2	32	0	0
14	8816261	.	G	A	9	12	21	0	1	22	0	0
14	8816283	.	T	G	7	11	18	0	0	18	0	0
14	8816339	.	A	G	11	8	19	0	0	19	0	0
14	8816457	.	A	G	4	2	6	0	2	8	0	0
14	8816482	.	A	T	4	4	8	0	1	9	0	0
14	8816695	.	C	G	5	3	8	0	1	9	0	0
14	8816755	.	A	C	14	1	15	0	6	21	0	0
14	8816782	.	G	A	12	6	18	0	0	18	0	0
14	8816848	.	A	G	10	10	20	0	0	20	0	0
14	8816877	.	C	A	2	7	9	0	7	16	0	0
14	8819082	.	T	C	6	0	6	0	5	11	0	0
14	8821677	.	G	A	2	3	5	0	1	6	0	0
14	8830236	.	G	T	1	3	4	0	0	4	0	0
14	8830302	.	C	T	0	2	2	0	1	3	0	0
14	8913145	.	G	A	1	2	3	0	0	3	0	0
14	8913155	.	A	G	0	2	2	0	0	2	0	0
14	8947464	.	A	T	4	2	6	0	0	6	0	0
14	8947497	.	C	A	5	2	7	0	0	7	0	0
14	8982390	.	C	T	14	12	26	0	0	26	0	0
14	8991718	.	A	T	9	20	29	0	2	31	0	0
14	8991823	.	T	C	7	16	23	0	0	23	0	0
14	9001411	.	G	A	20	16	36	0	3	39	0	0
14	9001426	.	C	T	19	18	37	0	3	40	0	0
14	9001752	.	C	G	10	0	10	0	17	27	0	0
14	9001875	.	T	C	18	15	33	0	2	35	0	0
14	9033783	.	G	A	4	4	8	0	1	9	0	0
14	9034114	.	A	G	1	3	4	0	2	6	0	0
14	9034128	.	T	G	1	2	3	0	2	5	0	0
14	9034161	.	C	T	1	5	6	0	0	6	0	0
14	9034307	.	G	A	4	5	9	0	1	10	0	0
14	9034430	.	T	C	10	12	22	0	0	22	0	0
14	9034701	.	C	T	0	4	4	0	6	10	0	0
14	9034742	.	C	T	3	5	8	0	0	8	0	0
14	9034743	.	T	C	3	0	3	0	5	8	0	0
14	9034932	.	A	G	7	4	11	0	0	11	0	0
14	9035051	.	C	G	7	8	15	0	0	15	0	0
14	9035100	.	C	T	6	4	10	0	0	10	0	0
14	9035110	.	C	T	1	6	7	0	7	14	0	0
14	9035175	.	G	A	1	8	9	0	0	9	0	0
14	9035249	.	G	T	1	2	3	0	0	3	0	0
14	9035740	.	A	G	2	4	6	0	0	6	0	0
14	9035758	.	T	C	4	2	6	0	1	7	0	0
14	9035786	.	C	G	3	5	8	0	0	8	0	0
14	9035866	.	A	G	7	5	12	0	0	12	0	0
14	9035873	.	T	C	6	3	9	0	1	10	0	0
14	9036530	.	C	T	4	2	6	0	0	6	0	0
14	9142412	.	A	T	12	11	23	0	0	23	0	0
14	9142602	.	A	T	24	23	47	0	4	51	0	0
14	9142795	.	T	C	14	13	27	0	7	34	0	0
14	9142893	.	T	C	21	0	21	0	17	38	0	0
14	9142911	.	T	C	21	0	21	0	15	36	0	0
14	9142952	.	C	T	2	20	22	0	17	39	0	0
14	9143081	.	G	C	35	1	36	0	15	51	0	0
14	9143150	.	A	C	23	1	24	3	9	37	1	0
14	9143179	.	C	T	2	9	11	3	27	41	0	0
14	9143427	.	A	T	13	24	37	0	1	38	0	0
14	9143446	.	T	C	18	0	18	0	11	29	0	0
14	9143878	.	T	C	16	9	25	0	0	25	0	0
14	9144099	.	T	C	12	14	26	0	1	27	0	0
14	9144191	.	A	G	4	5	9	0	3	12	0	0
14	9144248	.	A	G	5	4	9	0	0	9	0	0
14	9144361	.	A	G	2	3	5	0	1	6	0	0
14	9145050	.	G	A	5	12	17	1	0	18	0	0
14	9157880	.	T	A	4	6	10	0	0	10	0	0
14	9159845	.	A	G	7	9	16	0	1	17	0	0
14	9159860	.	G	C	8	0	8	0	7	15	0	0
14	9163286	.	G	A	3	3	6	0	0	6	0	0
14	9177619	.	G	A	3	5	8	0	0	8	0	0
14	9344247	.	G	A	2	3	5	0	0	5	0	0
14	9344250	.	C	T	2	4	6	0	0	6	0	0
14	9344366	.	T	G	3	3	6	0	0	6	0	0
14	9405178	.	A	G	3	3	6	0	0	6	0	0
14	9405383	.	T	C	2	3	5	0	0	5	0	0
14	9405728	.	G	C	9	0	9	0	9	18	0	0
14	9405760	.	T	C	8	7	15	0	2	17	0	0
14	9405927	.	C	T	5	5	10	0	1	11	0	0
14	9405940	.	A	C	3	5	8	0	0	8	0	0
14	9406453	.	A	T	6	11	17	0	0	17	0	0
14	9406485	.	A	G	7	11	18	0	0	18	0	0
14	9406509	.	T	C	4	5	9	0	2	11	0	0
14	9406607	.	T	C	4	7	11	0	0	11	0	0
14	9406773	.	T	A	3	7	10	0	0	10	0	0
14	9406791	.	A	G	3	7	10	0	0	10	0	0
14	9407707	.	C	T	2	2	4	0	0	4	0	0
14	9408260	.	C	G	1	4	5	0	1	6	0	0
14	9408320	.	T	G	3	3	6	0	0	6	0	0
14	9494939	.	A	G	7	0	7	0	9	16	0	0
14	9495107	.	G	A	1	4	5	0	5	10	0	0
14	9498163	.	C	T	8	5	13	0	1	14	0	0
14	9498308	.	G	A	5	12	17	0	0	17	0	0
14	9498570	.	C	T	6	4	10	0	0	10	0	0
14	9498728	.	A	T	9	3	12	0	0	12	0	0
14	9498841	.	C	G	15	14	29	0	1	30	0	0
14	9498879	.	T	A	16	15	31	0	2	33	0	0
14	9499048	.	G	T	12	8	20	0	0	20	0	0
14	9507489	.	T	C	1	2	3	0	0	3	0	0
14	9507527	.	C	G	2	3	5	0	0	5	0	0
14	9516521	.	C	T	2	2	4	0	0	4	0	0
14	9516565	.	C	T	1	2	3	0	0	3	0	0
14	9584685	.	T	C	1	2	3	0	0	3	0	0
14	9584717	.	A	G	2	2	4	0	0	4	0	0
14	9587418	.	C	T	1	1	2	0	1	3	0	0
14	9588102	.	T	A	2	4	6	0	1	7	0	0
14	9588145	.	G	A	5	4	9	0	0	9	0	0
14	9590716	.	T	C	1	3	4	0	0	4	0	0
14	9593273	.	T	A	4	4	8	0	0	8	0	0
14	9593298	.	C	A	5	3	8	0	1	9	0	0
14	9593505	.	A	G	21	14	35	0	0	35	0	0
14	9593610	.	T	A	19	11	30	0	1	31	0	0
14	9593622	.	A	T	18	14	32	0	1	33	0	0
14	9593974	.	C	T	20	8	28	0	1	29	0	0
14	9594466	.	G	A	6	3	9	0	1	10	0	0
14	9594577	.	C	T	8	5	13	0	0	13	0	0
14	9594578	.	A	G	7	5	12	0	1	13	0	0
14	9594623	.	C	T	6	6	12	0	0	12	0	0
14	9594677	.	G	C	2	4	6	0	0	6	0	0
14	9595231	.	T	C	3	0	3	0	4	7	0	0
14	9595890	.	C	T	5	6	11	0	0	11	0	0
14	9595992	.	C	A	5	11	16	0	0	16	0	0
14	9596338	.	C	T	5	4	9	0	0	9	0	0
14	9717978	.	C	A	0	4	4	0	4	8	0	0
14	9739987	.	G	T	1	2	3	0	0	3	0	0
14	10338507	.	G	C	4	2	6	0	0	6	0	0
14	10338670	.	G	A	5	2	7	0	0	7	0	0
14	10338763	.	G	T	4	3	7	0	0	7	0	0
14	10338942	.	A	G	4	3	7	0	1	8	0	0
14	10339081	.	T	G	6	4	10	0	0	10	0	0
14	10339883	.	A	C	14	15	29	0	2	31	0	0
14	10339943	.	A	G	10	8	18	0	1	19	0	0
14	10340068	.	G	A	7	12	19	0	0	19	0	0
14	10340096	.	G	A	7	8	15	0	3	18	0	0
14	10340189	.	T	A	7	6	13	0	1	14	0	0
14	10340193	.	C	G	8	6	14	0	0	14	0	0
14	10340250	.	A	T	6	4	10	0	2	12	0	0
14	10340288	.	C	A	9	10	19	0	0	19	0	0
14	10340358	.	G	A	4	10	14	0	1	15	0	0
14	10340606	.	A	G	9	7	16	0	1	17	0	0
14	10340840	.	C	A	13	9	22	0	0	22	0	0
14	10341237	.	A	T	3	4	7	0	0	7	0	0
14	10341586	.	C	T	0	4	4	0	6	10	0	0
14	10341627	.	A	T	3	4	7	0	0	7	0	0
14	10341690	.	G	T	6	3	9	0	0	9	0	0
14	10341703	.	T	C	6	0	6	0	4	10	0	0
14	10342379	.	A	C	4	1	5	0	2	7	0	0
14	10342570	.	G	A	1	2	3	0	0	3	0	0
14	10342591	.	C	A	0	2	2	0	2	4	0	0
14	10342971	.	G	T	2	2	4	0	1	5	0	0
14	10374674	.	T	G	2	2	4	0	0	4	0	0
14	10374792	.	A	C	1	2	3	0	0	3	0	0
14	10379652	.	G	A	3	4	7	0	0	7	0	0
14	11053934	.	G	C	6	4	10	0	0	10	0	0
14	11069560	.	C	T	3	4	7	0	0	7	0	0
14	11069593	.	C	T	4	9	13	0	0	13	0	0
14	11070008	.	C	T	6	6	12	0	0	12	0	0
14	11070018	.	T	A	5	4	9	0	0	9	0	0
14	11263479	.	T	A	3	2	5	0	0	5	0	0
14	11264726	.	A	T	2	2	4	0	1	5	0	0
14	11265310	.	A	G	4	2	6	0	0	6	0	0
14	11265312	.	T	C	3	2	5	0	0	5	0	0
14	11265567	.	C	T	3	5	8	0	0	8	0	0
14	11266644	.	A	T	4	6	10	0	0	10	0	0
14	11267900	.	A	T	9	14	23	0	4	28	1	0
14	11268145	.	G	A	5	2	7	0	0	7	0	0
14	11300058	.	T	C	1	2	3	0	0	3	0	0
14	11300298	.	C	T	3	2	5	0	0	5	0	0
14	11301027	.	G	A	7	4	11	0	0	11	0	0
14	11301069	.	A	G	11	0	11	0	5	16	0	0
14	11302190	.	C	A	12	8	20	0	1	21	0	0
14	11302518	.	A	G	1	2	3	0	0	3	0	0
14	11302744	.	G	A	3	2	5	0	0	5	0	0
14	11303157	.	A	C	3	2	5	0	1	6	0	0
14	11303819	.	T	G	5	2	7	0	0	7	0	0
14	11303895	.	G	T	2	2	4	0	0	4	0	0
14	11303973	.	C	T	2	3	5	0	0	5	0	0
14	12021308	.	C	G	9	5	14	0	0	14	0	0
14	12021550	.	T	C	1	3	4	0	0	4	0	0
14	12021610	.	T	G	4	7	11	0	0	11	0	0
14	12021926	.	A	T	7	9	16	0	2	18	0	0
14	12022056	.	C	T	4	8	12	0	0	12	0	0
14	12036731	.	A	G	4	3	7	0	0	7	0	0
14	12036768	.	A	C	3	0	3	0	4	7	0	0
14	12069754	.	C	T	18	23	41	0	2	43	0	0
14	12071446	.	A	G	8	10	18	0	1	19	0	0
14	12077109	.	C	T	5	2	7	0	2	9	0	0
14	12085267	.	G	A	6	5	11	0	0	11	0	0
14	12099566	.	G	T	3	4	7	0	0	7	0	0
14	12099605	.	T	G	1	2	3	0	0	3	0	0
14	12110887	.	A	C	3	2	5	0	1	6	0	0
14	12159384	.	C	G	3	10	13	0	0	13	0	0
14	12162692	.	C	T	9	7	16	0	1	17	0	0
14	12162731	.	A	C	11	6	17	0	1	18	0	0
14	12164364	.	C	A	21	25	46	0	3	49	0	0
14	12166656	.	A	G	16	19	35	0	3	38	0	0
14	12166956	.	C	T	16	16	32	0	1	33	0	0
14	12166974	.	A	G	19	15	34	0	3	37	0	0
14	12167321	.	T	A	21	20	41	0	0	41	0	0
14	12167670	.	C	T	6	2	8	0	2	10	0	0
14	12167679	.	A	T	7	2	9	0	1	10	0	0
14	12175964	.	T	A	3	1	4	0	2	6	0	0
14	12175982	.	T	G	3	0	3	0	4	7	0	0
14	12176008	.	G	A	4	2	6	0	0	6	0	0
14	12189856	.	C	T	3	5	8	0	0	8	0	0
14	12195119	.	T	A	5	3	8	0	1	9	0	0
14	12205329	.	T	C	5	9	14	0	0	14	0	0
14	12205521	.	C	T	16	7	23	0	1	24	0	0
14	12205566	.	T	C	21	9	30	0	1	31	0	0
14	12452477	.	C	T	2	3	5	0	0	5	0	0
14	12452516	.	G	A	1	3	4	0	1	5	0	0
14	12465519	.	C	A	9	6	15	0	1	16	0	0
14	12472233	.	C	T	6	11	17	0	0	17	0	0
14	12473599	.	T	A	6	3	9	0	1	10	0	0
14	12473932	.	T	C	4	10	14	0	0	14	0	0
14	12473992	.	A	T	1	4	5	0	0	5	0	0
14	12474159	.	T	C	6	4	10	0	0	10	0	0
14	12481591	.	C	T	5	4	9	0	0	9	0	0
14	12481600	.	T	C	7	2	9	0	1	10	0	0
14	12486275	.	G	T	8	2	10	0	1	11	0	0
14	12535403	.	T	G	19	22	41	0	1	42	0	0
14	12535568	.	A	G	24	13	37	1	3	41	0	0
14	12535581	.	A	T	31	11	42	1	2	45	0	0
14	12535622	.	G	T	31	13	44	0	4	48	0	0
14	12535775	.	G	T	16	6	22	0	1	23	0	0
14	12536229	.	G	A	17	18	35	0	0	35	0	0
14	12536420	.	T	G	20	19	39	0	2	41	0	0
14	13524092	.	A	G	3	4	7	0	1	8	0	0
14	13525082	.	A	G	7	8	15	0	0	15	0	0
14	14502708	.	T	C	1	3	4	0	0	4	0	0
14	14502846	.	C	T	4	2	6	0	0	6	0	0
14	14502885	.	C	T	2	2	4	0	0	4	0	0
14	14532450	.	T	C	8	10	18	0	0	18	0	0
14	14532696	.	T	G	10	14	24	0	0	24	0	0
14	14532831	.	A	G	7	9	16	0	3	19	0	0
14	14534219	.	G	A	15	11	26	0	0	26	0	0
14	14593109	.	T	C	1	2	3	0	0	3	0	0
14	14593175	.	T	C	2	4	6	0	1	7	0	0
14	14593784	.	A	G	0	1	1	0	1	2	0	0
14	14593785	.	A	G	1	2	3	0	0	3	0	0
14	14593889	.	G	A	3	4	7	0	0	7	0	0
14	14595535	.	A	G	3	3	6	0	2	8	0	0
14	14595576	.	T	G	2	2	4	0	2	6	0	0
14	14595695	.	A	C	7	4	11	0	0	11	0	0
14	14595734	.	C	G	8	6	14	0	1	15	0	0
14	14595803	.	C	A	7	4	11	0	1	12	0	0
14	14596121	.	T	G	8	9	17	0	2	19	0	0
14	14596176	.	T	C	7	6	13	0	1	14	0	0
14	14662597	.	A	T	12	10	22	0	3	25	0	0
14	14662606	.	A	G	11	10	21	0	3	24	0	0
14	14662663	.	C	T	12	8	20	0	0	20	0	0
14	14662684	.	C	T	9	7	16	0	3	19	0	0
14	14664974	.	T	C	8	8	16	0	0	16	0	0
14	14664998	.	G	A	6	9	15	0	0	15	0	0
14	14665175	.	T	C	13	18	31	0	0	31	0	0
14	14665229	.	A	G	12	6	18	0	0	18	0	0
14	14665270	.	T	G	6	5	11	0	0	11	0	0
14	14666173	.	A	T	10	5	15	0	0	15	0	0
14	14666394	.	G	A	21	13	34	0	1	35	0	0
14	14690710	.	G	T	8	10	18	9	1	28	0	0
14	14690831	.	C	A	5	15	20	37	1	58	0	0
14	14690837	.	G	A	4	12	16	42	0	58	0	0
14	14694930	.	A	G	22	23	45	0	1	46	0	0
14	14695136	.	A	G	8	16	24	0	2	26	0	0
14	14695181	.	A	G	13	15	28	0	0	28	0	0
14	14695428	.	C	T	2	4	6	1	15	22	0	0
14	14695864	.	T	C	10	1	11	0	13	24	0	0
14	14722530	.	A	T	10	12	22	0	1	23	0	0
14	14722556	.	T	C	7	15	22	0	1	23	0	0
14	14722929	.	G	A	9	4	13	0	0	13	0	0
14	14723381	.	A	T	3	5	8	0	0	8	0	0
14	14723410	.	G	T	5	4	9	0	1	10	0	0
14	14724951	.	G	A	30	26	56	0	7	63	0	0
14	14724953	.	A	G	38	22	60	0	5	65	0	0
14	14724987	.	G	A	30	25	55	0	2	57	0	0
14	14725314	.	G	A	35	26	61	0	3	64	0	0
14	14728192	.	G	T	16	12	28	28	3	59	0	0
14	14729069	.	G	A	20	26	46	1	4	51	0	0
14	14739116	.	T	C	3	4	7	0	0	7	0	0
14	14836656	.	T	C	5	2	7	0	0	7	0	0
14	14837729	.	A	C	5	3	8	0	0	8	0	0
14	14844346	.	A	C	3	2	5	0	0	5	0	0
14	14844529	.	A	G	2	2	4	0	0	4	0	0
14	14855017	.	T	C	1	4	5	0	0	5	0	0
14	14855205	.	C	G	2	2	4	0	0	4	0	0
14	14855561	.	C	T	4	2	6	0	0	6	0	0
14	14856959	.	G	A	3	3	6	0	0	6	0	0
14	14856962	.	T	C	3	3	6	0	0	6	0	0
14	14864897	.	A	G	3	1	4	0	2	6	0	0
14	15067446	.	T	G	1	3	4	0	0	4	0	0
14	15067461	.	T	C	1	3	4	0	0	4	0	0
14	15070717	.	A	G	1	2	3	0	1	4	0	0
14	15070912	.	A	G	2	2	4	0	0	4	0	0
14	15071502	.	C	T	6	3	9	0	0	9	0	0
14	15086220	.	G	A	4	8	12	0	0	12	0	0
14	15155901	.	A	G	2	0	2	0	5	7	0	0
14	15662731	.	G	A	3	4	7	0	0	7	0	0
14	15662795	.	G	C	11	3	14	0	0	14	0	0
14	15662836	.	A	T	8	7	15	0	0	15	0	0
14	15663014	.	C	T	5	6	11	0	1	12	0	0
14	15663053	.	T	A	7	4	11	0	1	12	0	0
14	15663237	.	T	C	6	4	10	0	0	10	0	0
14	15760375	.	A	C	3	2	5	0	0	5	0	0
14	15808004	.	C	A	2	2	4	0	0	4	0	0
14	15813702	.	G	T	4	4	8	0	2	10	0	0
14	15814770	.	C	T	4	5	9	0	1	10	0	0
14	15814856	.	A	T	0	3	3	0	1	4	0	0
14	15814887	.	T	G	2	4	6	0	0	6	0	0
14	15972435	.	C	A	10	3	13	0	2	15	0	0
14	15972666	.	G	A	6	5	11	0	0	11	0	0
14	15973920	.	G	A	4	5	9	0	1	10	0	0
14	15973981	.	C	A	4	3	7	0	1	8	0	0
14	15974188	.	T	A	1	2	3	0	0	3	0	0
14	15983590	.	T	C	4	3	7	0	0	7	0	0
14	15983824	.	C	A	0	3	3	0	1	4	0	0
14	16090261	.	C	T	2	4	6	0	0	6	0	0
14	16090764	.	T	C	8	7	15	0	1	16	0	0
14	16090939	.	A	C	8	14	22	0	0	22	0	0
14	16091586	.	T	A	16	13	29	0	2	31	0	0
14	16091709	.	T	G	14	6	20	0	0	20	0	0
14	16091765	.	T	C	7	8	15	0	1	16	0	0
14	16093983	.	G	A	7	4	11	0	0	11	0	0
14	16095683	.	A	G	1	3	4	0	0	4	0	0
14	16097204	.	T	A	3	3	6	0	0	6	0	0
14	16115353	.	A	G	7	7	14	0	0	14	0	0
14	16122866	.	T	C	15	13	28	0	0	28	0	0
14	16122913	.	G	A	1	12	13	0	14	27	0	0
14	16127308	.	C	T	12	4	16	0	0	16	0	0
14	16127346	.	G	T	6	7	13	0	1	14	0	0
14	16127362	.	C	A	2	6	8	0	5	13	0	0
14	16130167	.	C	G	11	15	26	0	2	28	0	0
14	16145112	.	T	A	2	2	4	0	0	4	0	0
14	16208059	.	T	G	3	3	6	0	0	6	0	0
14	16296383	.	A	G	1	0	1	0	9	10	0	0
14	16434363	.	C	A	12	4	16	0	1	17	0	0
14	16435150	.	G	A	10	14	24	0	0	24	0	0
14	16484577	.	G	A	5	6	11	0	0	11	0	0
14	16484713	.	A	G	4	7	11	0	0	11	0	0
14	16485222	.	C	T	0	6	6	0	4	10	0	0
14	16769067	.	A	G	10	7	17	0	0	17	0	0
14	16769109	.	T	C	7	9	16	0	2	18	0	0
14	16769189	.	C	T	5	5	10	1	1	12	0	0
14	16769246	.	C	T	5	7	12	0	0	12	0	0
14	16769550	.	A	G	11	0	11	0	18	29	0	0
14	16770338	.	T	A	13	12	25	0	1	26	0	0
14	16770646	.	C	A	16	17	33	0	1	34	0	0
14	16770847	.	C	T	21	11	32	0	4	36	0	0
14	16770959	.	T	A	12	15	27	0	1	28	0	0
14	16771194	.	A	T	2	5	7	0	0	7	0	0
14	16771265	.	A	T	13	7	20	0	0	20	0	0
14	16771339	.	T	C	6	5	11	0	1	12	0	0
14	16771340	.	A	G	5	0	5	0	7	12	0	0
14	16777673	.	T	C	4	0	4	0	3	7	0	0
14	16777677	.	A	C	4	3	7	0	0	7	0	0
14	16777743	.	T	G	2	2	4	0	0	4	0	0
14	16777865	.	A	G	3	2	5	0	0	5	0	0
14	16996869	.	T	C	1	2	3	0	0	3	0	0
14	16996870	.	G	A	1	2	3	0	0	3	0	0
14	17016521	.	G	A	5	2	7	0	0	7	0	0
14	17025176	.	C	A	8	6	14	0	0	14	0	0
14	17025200	.	G	A	5	4	9	0	0	9	0	0
14	17025472	.	T	A	1	2	3	0	0	3	0	0
14	17025807	.	T	C	3	4	7	0	0	7	0	0
14	17026103	.	G	A	7	2	9	0	0	9	0	0
14	17026534	.	G	A	4	4	8	0	0	8	0	0
14	17026550	.	C	T	5	5	10	0	0	10	0	0
14	17026724	.	T	C	9	10	19	0	1	20	0	0
14	17026840	.	T	C	4	7	11	0	1	12	0	0
14	17197240	.	A	C	3	3	6	0	0	6	0	0
14	17198988	.	T	G	7	5	12	0	0	12	0	0
14	17199349	.	C	T	7	9	16	0	1	17	0	0
14	17199990	.	A	G	19	22	41	0	1	42	0	0
14	17200159	.	C	T	12	13	25	0	0	25	0	0
14	17200174	.	G	T	1	15	16	0	11	27	0	0
14	17200407	.	C	A	5	11	16	0	0	16	0	0
14	17200482	.	T	C	12	12	24	0	0	24	0	0
14	17200653	.	A	C	19	9	28	0	1	29	0	0
14	17230601	.	A	G	5	12	17	0	1	18	0	0
14	17233541	.	C	T	15	14	29	0	0	29	0	0
14	17240569	.	G	T	6	5	11	0	0	11	0	0
14	17240587	.	A	G	5	5	10	0	1	11	0	0
14	17266013	.	A	T	6	10	16	0	0	16	0	0
14	17275609	.	T	A	6	6	12	0	1	13	0	0
14	17275708	.	C	G	5	8	13	0	0	13	0	0
14	17278972	.	C	T	8	5	13	0	0	13	0	0
14	17279197	.	G	A	2	6	8	0	0	8	0	0
14	17279305	.	T	C	1	3	4	0	0	4	0	0
14	17281713	.	G	A	3	5	8	0	0	8	0	0
14	17281727	.	C	G	2	5	7	0	0	7	0	0
14	17282095	.	C	G	1	3	4	0	0	4	0	0
14	17282100	.	C	T	0	2	2	0	2	4	0	0
14	17348286	.	T	C	1	1	2	0	1	3	0	0
14	17349104	.	G	T	5	2	7	0	0	7	0	0
14	17349464	.	T	C	8	5	13	0	1	14	0	0
14	17349472	.	C	T	8	4	12	0	1	13	0	0
14	17349639	.	T	C	8	5	13	0	0	13	0	0
14	17349656	.	T	C	6	6	12	0	1	13	0	0
14	17349757	.	C	T	2	2	4	0	0	4	0	0
14	17349821	.	A	G	6	3	9	0	0	9	0	0
14	17350842	.	G	A	1	2	3	0	0	3	0	0
14	17567800	.	A	C	9	0	9	1	2	12	0	0
14	17567807	.	T	A	9	2	11	1	1	13	0	0
14	17568072	.	T	A	4	7	11	0	2	13	0	0
14	17568099	.	A	G	8	10	18	0	2	20	0	0
14	17575834	.	C	G	9	6	15	0	0	15	0	0
14	17575868	.	G	A	7	6	13	0	2	15	0	0
14	17575872	.	C	T	7	8	15	0	0	15	0	0
14	17580662	.	G	A	21	10	31	0	1	32	0	0
14	17580917	.	G	A	30	26	56	0	2	58	0	0
14	17580922	.	C	A	33	21	54	0	1	55	0	0
14	17581036	.	C	A	31	13	44	0	2	46	0	0
14	17586527	.	A	G	10	15	25	0	1	26	0	0
14	17586693	.	G	A	11	19	30	0	1	31	0	0
14	17588131	.	G	T	18	10	28	0	1	29	0	0
14	17593654	.	T	A	1	4	5	0	0	5	0	0
14	17593685	.	G	C	7	4	11	0	0	11	0	0
14	17593767	.	A	T	20	11	31	1	1	33	0	0
14	17593783	.	T	A	19	8	27	1	0	28	0	0
14	17593803	.	A	T	20	5	25	0	1	26	0	0
14	17593823	.	A	T	19	6	25	0	1	26	0	0
14	17593992	.	T	A	11	4	15	0	1	16	0	0
14	17594137	.	G	A	5	2	7	0	2	9	0	0
14	17594556	.	C	T	4	2	6	0	1	7	0	0
14	17595170	.	C	A	1	3	4	0	0	4	0	0
14	17595192	.	A	T	1	2	3	0	0	3	0	0
14	17595264	.	T	A	4	2	6	0	0	6	0	0
14	18667559	.	T	C	16	18	34	0	2	36	0	0
14	18667852	.	T	C	15	18	33	0	1	34	0	0
14	18668731	.	A	G	3	2	5	0	0	5	0	0
14	18669481	.	C	A	13	6	19	0	0	19	0	0
14	18670446	.	C	T	3	5	8	0	0	8	0	0
14	18670582	.	T	A	3	5	8	0	0	8	0	0
14	18671011	.	A	T	3	3	6	0	0	6	0	0
14	18672491	.	C	T	1	2	3	0	0	3	0	0
14	19259292	.	A	G	1	6	7	0	0	7	0	0
14	19260261	.	A	G	4	11	15	0	2	17	0	0
14	19261044	.	C	T	13	17	30	0	6	36	0	0
14	20159151	.	T	C	1	3	4	0	0	4	0	0
14	20188941	.	G	A	0	3	3	0	10	13	0	0
14	20189180	.	T	C	13	9	22	0	0	22	0	0
14	20189188	.	G	A	14	9	23	0	0	23	0	0
14	20190023	.	A	C	9	8	17	0	0	17	0	0
14	20190297	.	C	G	22	11	33	0	1	34	0	0
14	20190494	.	G	T	3	13	16	0	17	33	0	0
14	20190532	.	G	A	24	13	37	0	1	38	0	0
14	20731756	.	G	A	2	2	4	0	0	4	0	0
14	20735388	.	T	G	6	13	19	0	0	19	0	0
14	20735481	.	T	C	11	12	23	0	0	23	0	0
14	20735525	.	T	A	5	2	7	0	3	10	0	0
14	20735532	.	A	T	6	2	8	0	0	8	0	0
14	20735626	.	G	T	2	2	4	0	1	5	0	0
14	20735841	.	A	G	7	1	8	0	10	18	0	0
14	20736251	.	A	G	12	11	23	0	0	23	0	0
14	20736829	.	A	G	2	0	2	0	6	8	0	0
14	20869786	.	T	A	1	3	4	0	0	4	0	0
14	20869795	.	C	A	0	2	2	0	2	4	0	0
14	20869943	.	T	C	4	0	4	0	7	11	0	0
14	20869949	.	G	A	4	5	9	0	0	9	0	0
14	20870141	.	G	T	10	8	18	0	0	18	0	0
14	20870153	.	A	G	8	8	16	0	0	16	0	0
14	20870257	.	A	G	4	11	15	0	0	15	0	0
14	20870321	.	G	T	8	15	23	0	1	24	0	0
14	20881464	.	C	A	4	4	8	1	0	9	0	0
14	20881493	.	C	T	5	3	8	1	0	9	0	0
14	20882725	.	A	G	1	8	9	0	0	9	0	0
14	20896049	.	T	G	6	0	6	0	2	8	0	0
14	20896058	.	C	T	6	3	9	0	0	9	0	0
14	20898296	.	C	T	2	3	5	0	0	5	0	0
14	20994047	.	A	G	1	0	1	0	2	3	0	0
14	20994051	.	G	A	0	2	2	0	1	3	0	0
14	20994527	.	T	A	1	1	2	0	1	3	0	0
14	20994967	.	T	C	3	2	5	0	0	5	0	0
14	20996393	.	C	T	1	2	3	0	0	3	0	0
14	20996394	.	A	T	1	2	3	0	0	3	0	0
14	20999918	.	C	T	2	3	5	0	1	6	0	0
14	21000170	.	C	G	5	10	15	0	1	16	0	0
14	21000193	.	T	C	6	5	11	0	5	16	0	0
14	21000256	.	C	A	4	5	9	0	0	9	0	0
14	21000257	.	A	G	4	5	9	0	0	9	0	0
14	21000323	.	T	A	2	3	5	0	1	6	0	0
14	21000325	.	G	A	0	4	4	0	2	6	0	0
14	21000375	.	A	G	2	0	2	0	2	4	0	0
14	21067202	.	C	G	1	2	3	0	0	3	0	0
14	21067455	.	G	A	9	5	14	0	0	14	0	0
14	21067935	.	A	G	9	10	19	0	0	19	0	0
14	21067938	.	T	C	8	10	18	0	0	18	0	0
14	21071965	.	T	C	7	5	12	0	1	13	0	0
14	21072037	.	G	A	4	8	12	0	1	13	0	0
14	21072729	.	A	G	11	8	19	0	0	19	0	0
14	21072834	.	C	T	3	5	8	0	1	9	0	0
14	21072852	.	G	A	2	7	9	0	0	9	0	0
14	21087521	.	C	A	2	3	5	0	1	6	0	0
14	21124321	.	T	C	4	9	13	0	0	13	0	0
14	21124360	.	G	T	3	6	9	0	0	9	0	0
14	21124469	.	A	G	1	3	4	0	0	4	0	0
14	21129362	.	T	G	2	7	9	0	0	9	0	0
14	21129629	.	G	T	4	7	11	0	2	13	0	0
14	21132180	.	G	A	1	2	3	0	0	3	0	0
14	21159943	.	T	G	3	0	3	0	4	7	0	0
14	21159949	.	A	T	3	6	9	0	0	9	0	0
14	21183865	.	G	A	5	10	15	0	0	15	0	0
14	21183910	.	A	G	7	9	16	0	0	16	0	0
14	21187563	.	C	T	5	14	19	0	1	20	0	0
14	21187631	.	C	T	11	6	17	0	0	17	0	0
14	21195795	.	C	T	17	20	37	0	1	38	0	0
14	21198328	.	A	C	14	24	38	0	0	38	0	0
14	21198349	.	T	A	9	17	26	0	3	29	0	0
14	21198391	.	A	C	7	18	25	0	7	32	0	0
14	21198403	.	T	C	9	22	31	0	5	36	0	0
14	21198689	.	T	A	12	12	24	0	4	28	0	0
14	21198818	.	C	T	16	16	32	0	4	36	0	0
14	21199092	.	G	T	14	7	21	0	1	22	0	0
14	21204553	.	T	A	3	3	6	0	0	6	0	0
14	21204814	.	T	A	8	8	16	0	0	16	0	0
14	21205297	.	T	C	2	5	7	0	0	7	0	0
14	21205429	.	T	C	12	0	12	0	8	20	0	0
14	21205471	.	G	A	9	8	17	0	2	19	0	0
14	21205623	.	G	T	6	6	12	0	1	13	0	0
14	21211802	.	A	C	4	8	12	0	0	12	0	0
14	21211859	.	T	A	2	6	8	0	0	8	0	0
14	21238782	.	T	A	8	5	13	0	0	13	0	0
14	21241695	.	G	A	0	14	14	0	9	23	0	0
14	21241870	.	T	A	7	5	12	0	1	13	0	0
14	21241899	.	A	G	4	6	10	0	2	12	0	0
14	21242082	.	T	A	11	11	22	1	0	23	0	0
14	21242148	.	C	T	5	9	14	0	0	14	0	0
14	21245180	.	T	G	5	2	7	0	0	7	0	0
14	21245545	.	G	A	0	2	2	0	2	4	0	0
14	21245616	.	A	G	1	2	3	0	0	3	0	0
14	21245657	.	A	C	5	3	8	0	0	8	0	0
14	21332964	.	G	A	30	35	65	0	4	69	0	0
14	21333795	.	G	A	28	37	65	0	0	65	0	0
14	21333867	.	C	A	2	25	27	0	33	61	1	0
14	21333957	.	G	A	37	31	68	0	2	71	1	0
14	21334257	.	G	T	21	21	42	0	1	43	0	0
14	21334338	.	A	G	25	30	55	0	2	57	0	0
14	21334840	.	G	C	15	19	34	0	4	38	0	0
14	21334968	.	G	A	18	14	32	0	1	33	0	0
14	21334985	.	G	T	17	13	30	0	1	31	0	0
14	21597044	.	A	G	28	9	37	0	4	41	0	0
14	21597140	.	C	A	31	16	47	2	10	59	0	0
14	21597264	.	G	A	20	12	32	0	1	33	0	0
14	21597363	.	A	G	24	8	32	0	0	32	0	0
14	21597451	.	T	C	9	4	13	0	0	13	0	0
14	21597469	.	T	C	5	3	8	0	1	9	0	0
14	21597671	.	T	C	16	9	25	0	1	27	1	0
14	21597730	.	C	T	17	12	29	0	3	32	0	0
14	21597755	.	T	A	16	12	28	0	0	28	0	0
14	21597814	.	C	T	17	13	30	1	0	31	0	0
14	21598035	.	C	T	16	9	25	0	4	29	0	0
14	21598372	.	G	A	16	4	20	0	1	21	0	0
14	21598402	.	C	A	10	6	16	0	0	16	0	0
14	21598488	.	C	T	12	10	22	0	1	23	0	0
14	21598724	.	T	G	13	12	25	0	1	26	0	0
14	21598831	.	G	T	17	5	22	0	0	22	0	0
14	21603294	.	G	C	18	15	33	0	1	34	0	0
14	21603335	.	A	G	15	18	33	0	0	33	0	0
14	21609707	.	A	G	9	11	20	0	2	22	0	0
14	21609733	.	A	G	14	9	23	0	0	23	0	0
14	21617939	.	G	A	6	3	9	0	0	9	0	0
14	21617947	.	G	C	7	2	9	0	1	10	0	0
14	21623128	.	A	T	12	12	24	0	1	25	0	0
14	21623324	.	C	T	5	17	22	0	0	22	0	0
14	21630153	.	A	G	20	14	34	0	0	34	0	0
14	21636953	.	G	A	8	10	18	0	0	18	0	0
14	21636965	.	A	G	7	10	17	0	3	20	0	0
14	21639583	.	A	G	2	7	9	0	1	10	0	0
14	21646054	.	C	T	3	2	5	0	0	5	0	0
14	21646110	.	G	A	6	3	9	0	0	9	0	0
14	21655177	.	T	C	1	2	3	0	0	3	0	0
14	21689852	.	C	T	24	25	49	0	3	52	0	0
14	21693251	.	G	A	37	27	64	0	4	68	0	0
14	21693584	.	T	G	30	30	60	0	4	64	0	0
14	21733828	.	T	C	1	2	3	0	0	3	0	0
14	21745784	.	G	A	6	2	8	0	4	12	0	0
14	21745871	.	C	A	2	4	6	0	2	8	0	0
14	21745879	.	A	T	2	6	8	0	0	8	0	0
14	21745917	.	G	C	3	2	5	0	1	6	0	0
14	21745977	.	C	T	4	2	6	0	0	6	0	0
14	21745982	.	C	A	3	2	5	0	0	5	0	0
14	21746076	.	C	T	3	2	5	0	0	5	0	0
14	21746096	.	A	T	4	3	7	0	0	7	0	0
14	21746148	.	T	C	11	4	15	0	2	17	0	0
14	21746226	.	T	G	7	4	11	0	0	11	0	0
14	21750970	.	C	T	9	4	13	0	0	13	0	0
14	21768244	.	G	A	0	2	2	0	2	4	0	0
14	21770666	.	C	G	1	2	3	0	0	3	0	0
14	21779102	.	C	T	8	6	14	1	0	15	0	0
14	21779141	.	G	A	1	5	6	1	5	12	0	0
14	21779241	.	G	A	4	7	11	0	0	11	0	0
14	21779551	.	A	G	4	2	6	0	2	8	0	0
14	21779589	.	A	G	5	2	7	0	0	7	0	0
14	21779633	.	T	C	1	4	5	0	0	5	0	0
14	21779975	.	C	A	1	4	5	0	0	5	0	0
14	21780155	.	C	G	9	9	18	1	2	21	0	0
14	21780206	.	A	G	10	12	22	0	1	23	0	0
14	21780274	.	A	C	4	12	16	0	0	16	0	0
14	21780321	.	T	C	7	7	14	0	0	14	0	0
14	21790748	.	C	T	3	6	9	0	0	9	0	0
14	21801383	.	G	A	1	6	7	0	0	7	0	0
14	21804912	.	T	C	11	11	22	0	0	23	1	0
14	21806190	.	C	T	8	13	21	0	2	23	0	0
14	21806196	.	G	C	0	14	14	0	9	23	0	0
14	21813696	.	G	A	21	21	42	0	2	44	0	0
14	21816388	.	T	C	26	14	40	0	2	42	0	0
14	21838379	.	T	C	2	2	4	1	0	5	0	0
14	21840858	.	A	G	2	0	2	0	3	5	0	0
14	21842804	.	T	C	5	9	14	0	2	16	0	0
14	21843726	.	G	A	1	7	8	0	8	16	0	0
14	21844187	.	T	A	7	7	14	0	2	16	0	0
14	21923934	.	A	C	3	5	8	0	0	8	0	0
14	21924048	.	G	A	5	3	8	0	0	8	0	0
14	21924273	.	A	G	2	5	7	0	0	7	0	0
14	21924382	.	A	G	4	4	8	0	0	9	1	0
14	21924547	.	G	A	1	7	8	0	0	8	0	0
14	21999177	.	C	T	1	6	7	0	0	7	0	0
14	22104906	.	T	C	6	14	20	0	4	24	0	0
14	22104948	.	G	A	19	17	36	0	1	37	0	0
14	22108215	.	C	T	12	9	21	0	1	22	0	0
14	22132510	.	A	T	13	19	32	0	0	32	0	0
14	22132536	.	A	T	21	14	35	0	0	35	0	0
14	22134069	.	G	A	19	15	34	0	1	35	0	0
14	22139160	.	T	C	29	12	41	0	2	43	0	0
14	22139194	.	C	T	34	18	52	0	1	53	0	0
14	22139254	.	G	A	31	28	59	0	4	63	0	0
14	22139308	.	C	T	20	38	58	0	3	61	0	0
14	22139358	.	G	A	32	24	56	0	3	59	0	0
14	22139392	.	G	T	27	22	49	0	8	57	0	0
14	22139668	.	G	A	3	26	29	0	31	60	0	0
14	22139816	.	G	A	4	22	26	0	31	57	0	0
14	22140417	.	T	C	14	6	20	0	1	21	0	0
14	22140542	.	G	A	11	6	17	0	3	20	0	0
14	22145661	.	G	C	12	1	13	0	5	18	0	0
14	22151827	.	A	T	8	14	22	0	1	23	0	0
14	22151913	.	C	T	16	12	28	0	1	29	0	0
14	22151958	.	T	A	10	11	21	0	3	24	0	0
14	22151966	.	A	C	10	10	20	0	1	21	0	0
14	22152004	.	T	G	2	2	4	0	0	4	0	0
14	22172138	.	C	T	3	8	11	0	1	12	0	0
14	22249344	.	G	A	5	5	10	0	0	10	0	0
14	22254184	.	T	C	8	11	19	0	0	19	0	0
14	22272340	.	G	A	21	18	39	0	2	41	0	0
14	22272351	.	G	A	24	15	39	0	2	41	0	0
14	22272749	.	A	G	21	0	21	0	21	42	0	0
14	22367389	.	T	G	1	2	3	0	0	3	0	0
14	22367485	.	A	G	5	5	10	0	0	10	0	0
14	22367615	.	A	G	2	4	6	0	1	7	0	0
14	22432004	.	G	A	1	2	3	0	3	6	0	0
14	22437413	.	G	T	3	3	6	0	0	6	0	0
14	22438924	.	A	G	1	3	4	0	1	5	0	0
14	22439183	.	C	G	1	4	5	0	0	5	0	0
14	22439210	.	G	T	2	4	6	0	0	6	0	0
14	22440918	.	G	A	1	5	6	0	2	8	0	0
14	22441000	.	G	C	4	2	6	0	0	6	0	0
14	22441016	.	C	T	2	3	5	0	0	5	0	0
14	22441057	.	T	C	2	5	7	0	0	7	0	0
14	22441110	.	G	A	2	3	5	0	1	6	0	0
14	22441532	.	T	C	7	11	18	0	1	19	0	0
14	22441581	.	C	A	8	4	12	0	0	12	0	0
14	22441634	.	G	A	1	3	4	0	12	16	0	0
14	22441650	.	C	T	14	3	17	0	1	18	0	0
14	22441730	.	A	G	4	4	8	0	1	9	0	0
14	22441793	.	G	A	3	3	6	0	7	13	0	0
14	22441873	.	T	C	5	11	16	0	0	16	0	0
14	22470213	.	T	C	3	2	5	0	0	5	0	0
14	22478294	.	T	C	6	3	9	0	0	9	0	0
14	22478348	.	C	T	2	2	4	0	1	5	0	0
14	22478913	.	T	C	2	0	2	0	3	5	0	0
14	22478949	.	T	A	1	2	3	0	1	4	0	0
14	22479451	.	T	A	1	3	4	0	0	4	0	0
14	22509528	.	T	C	1	3	4	0	0	4	0	0
14	22523476	.	A	G	9	8	17	0	0	17	0	0
14	22523608	.	C	A	8	7	15	0	0	15	0	0
14	22696522	.	T	C	1	3	4	0	0	4	0	0
14	22708325	.	A	G	8	4	12	0	1	13	0	0
14	22708446	.	C	T	8	6	14	0	0	14	0	0
14	23405034	.	G	A	3	2	5	0	0	5	0	0
14	23411619	.	C	G	3	0	3	0	4	7	0	0
14	23455989	.	G	A	6	13	19	0	0	19	0	0
14	23463681	.	G	A	0	6	6	0	3	9	0	0
14	23463708	.	A	G	2	5	7	0	1	8	0	0
14	23463717	.	A	G	2	0	2	0	5	7	0	0
14	23463760	.	C	A	6	4	10	0	2	12	0	0
14	23478997	.	G	C	13	6	19	0	1	20	0	0
14	24097523	.	C	T	9	13	22	0	2	24	0	0
14	24097686	.	A	G	13	5	18	0	1	19	0	0
14	24097734	.	G	A	9	12	21	0	0	21	0	0
14	24098408	.	C	G	4	7	11	0	0	11	0	0
14	24098912	.	C	T	2	7	9	0	9	18	0	0
14	24108983	.	G	A	2	4	6	0	0	6	0	0
14	24109044	.	T	C	3	0	3	0	1	4	0	0
14	24109067	.	G	C	2	0	2	0	3	5	0	0
14	24109184	.	G	A	5	2	7	0	0	7	0	0
14	24220467	.	A	G	12	1	13	0	19	32	0	0
14	24220659	.	A	C	1	5	6	0	0	6	0	0
14	24221090	.	C	T	4	0	4	0	3	10	3	0
14	24221356	.	G	A	0	13	13	0	10	23	0	0
14	24241296	.	C	T	2	2	4	0	0	4	0	0
14	24241329	.	T	C	3	5	8	0	0	8	0	0
14	24242844	.	C	G	2	3	5	0	0	5	0	0
14	24243499	.	T	A	3	2	5	0	0	5	0	0
14	24248495	.	T	G	2	4	6	1	0	7	0	0
14	24250463	.	C	T	2	3	5	0	0	5	0	0
14	24250583	.	G	A	3	2	5	0	0	5	0	0
14	24268222	.	G	T	7	4	11	0	3	14	0	0
14	24268262	.	A	G	11	6	17	0	2	19	0	0
14	24268332	.	A	C	3	0	3	0	9	12	0	0
14	24268374	.	G	A	2	2	4	0	0	4	0	0
14	24268505	.	G	A	10	7	17	0	0	17	0	0
14	24268712	.	C	T	2	13	15	0	11	26	0	0
14	24274521	.	T	G	4	3	7	0	0	7	0	0
14	24274783	.	G	A	2	7	9	0	0	9	0	0
14	24276634	.	C	T	2	4	6	0	0	6	0	0
14	24278144	.	C	G	15	22	37	0	2	39	0	0
14	24278162	.	C	G	18	16	34	0	3	37	0	0
14	24278831	.	T	C	17	22	39	0	0	39	0	0
14	24278882	.	C	A	15	16	31	0	0	31	0	0
14	24278917	.	G	A	21	15	36	0	0	36	0	0
14	24279126	.	A	G	27	19	46	0	0	46	0	0
14	24279148	.	G	A	25	11	36	1	7	44	0	0
14	24279305	.	A	T	11	7	18	0	0	18	0	0
14	24279326	.	A	C	15	8	23	0	0	23	0	0
14	24279367	.	A	T	12	10	22	0	0	22	0	0
14	24279383	.	T	A	13	10	23	0	1	24	0	0
14	24279682	.	T	C	15	22	37	0	0	37	0	0
14	24279701	.	C	G	11	18	29	0	1	30	0	0
14	24280452	.	T	C	15	9	24	0	0	24	0	0
14	24280517	.	A	C	15	18	33	0	2	35	0	0
14	24280842	.	T	C	23	21	44	0	2	46	0	0
14	24280904	.	T	G	16	23	39	0	2	41	0	0
14	24280918	.	T	G	20	21	41	0	3	44	0	0
14	24280975	.	A	G	24	20	44	0	0	44	0	0
14	24281118	.	T	A	19	33	52	0	1	53	0	0
14	24281149	.	A	C	23	35	58	0	0	58	0	0
14	24281292	.	T	C	40	20	60	1	3	64	0	0
14	24283609	.	G	A	18	19	37	3	1	41	0	0
14	24301658	.	G	A	0	6	6	0	1	7	0	0
14	24301750	.	G	T	3	4	7	0	0	7	0	0
14	24301946	.	C	A	2	3	5	0	0	6	1	0
14	24302089	.	A	T	3	4	7	0	1	8	0	0
14	24302137	.	C	T	6	4	10	0	0	10	0	0
14	24302177	.	A	T	3	2	5	0	0	5	0	0
14	24302363	.	T	A	1	2	3	0	0	3	0	0
14	24302428	.	T	C	3	4	7	1	0	8	0	0
14	24302439	.	G	A	4	2	6	1	1	8	0	0
14	24302560	.	G	A	4	7	11	0	0	11	0	0
14	24302766	.	T	G	3	6	9	0	0	9	0	0
14	24302825	.	T	C	2	4	6	0	0	6	0	0
14	24303205	.	T	A	3	4	7	1	0	8	0	0
14	24303217	.	G	A	2	4	6	1	0	7	0	0
14	24303465	.	G	T	0	4	4	0	8	12	0	0
14	24303523	.	G	T	18	6	24	0	0	24	0	0
14	24303660	.	T	C	7	2	9	0	0	9	0	0
14	24303665	.	C	A	7	2	9	0	0	9	0	0
14	24303786	.	A	T	7	7	14	0	1	15	0	0
14	24303851	.	C	A	5	3	8	0	0	8	0	0
14	24303873	.	C	A	6	5	11	0	0	11	0	0
14	24304271	.	T	A	6	11	17	0	1	18	0	0
14	24304298	.	A	C	10	10	20	0	0	20	0	0
14	24304518	.	T	C	13	7	20	0	1	21	0	0
14	24304753	.	T	C	11	8	19	0	1	20	0	0
14	24317226	.	G	A	19	32	51	0	3	54	0	0
14	24317301	.	G	T	31	26	57	0	1	58	0	0
14	24317751	.	C	A	0	22	22	0	20	42	0	0
14	24318041	.	A	T	18	16	34	0	0	34	0	0
14	24318102	.	A	T	19	23	42	0	0	42	0	0
14	24318160	.	T	G	14	14	28	0	2	30	0	0
14	24318196	.	G	A	20	7	27	0	0	27	0	0
14	24318232	.	G	C	22	11	33	0	4	37	0	0
14	24318335	.	G	T	18	10	28	0	1	29	0	0
14	24318631	.	C	T	18	16	34	0	0	34	0	0
14	24318652	.	G	A	18	16	34	0	2	36	0	0
14	24318709	.	A	T	9	16	25	0	0	25	0	0
14	24318723	.	T	C	9	11	20	0	3	23	0	0
14	24369500	.	C	T	9	4	13	0	0	13	0	0
14	24369578	.	A	G	5	2	7	0	0	7	0	0
14	24376787	.	G	A	6	7	13	0	0	13	0	0
14	24406609	.	C	G	0	9	9	0	10	19	0	0
14	24410450	.	A	C	4	8	12	0	0	12	0	0
14	24410553	.	C	A	10	6	16	0	2	18	0	0
14	24497739	.	T	C	3	2	5	0	0	5	0	0
14	24497832	.	G	T	1	2	3	0	0	3	0	0
14	24497868	.	T	C	1	0	1	0	2	3	0	0
14	24873487	.	A	G	1	2	3	0	0	3	0	0
14	24994819	.	G	A	0	2	2	0	1	3	0	0
14	24997910	.	C	T	2	3	5	0	0	5	0	0
14	24997911	.	C	T	3	2	5	0	0	5	0	0
14	24998019	.	A	T	3	2	5	0	0	5	0	0
14	24998076	.	A	G	5	0	5	0	4	9	0	0
14	24998345	.	C	A	1	3	4	0	0	4	0	0
14	24998430	.	G	A	0	10	10	0	2	12	0	0
14	24998737	.	A	C	10	9	19	0	1	21	1	0
14	24998765	.	A	T	5	10	15	0	1	16	0	0
14	24999546	.	T	A	10	9	19	0	0	19	0	0
14	24999573	.	A	G	9	0	9	0	11	20	0	0
14	24999722	.	T	C	13	10	23	1	0	24	0	0
14	25000492	.	A	T	13	6	19	0	1	20	0	0
14	25040313	.	G	A	1	4	5	0	0	5	0	0
14	25063607	.	G	T	9	2	11	0	0	11	0	0
14	25066002	.	C	A	2	14	16	0	38	54	0	0
14	25066722	.	T	A	33	14	47	0	0	47	0	0
14	25067471	.	C	T	17	14	31	0	1	32	0	0
14	25067665	.	C	T	26	12	38	0	1	39	0	0
14	25067700	.	C	A	20	12	32	0	3	35	0	0
14	25067857	.	G	A	19	14	33	0	1	34	0	0
14	25067862	.	A	C	21	15	36	0	1	37	0	0
14	25067984	.	C	T	28	13	41	0	1	42	0	0
14	25068007	.	G	C	23	11	34	0	1	35	0	0
14	25068206	.	G	T	15	8	23	0	0	23	0	0
14	25068215	.	T	G	17	9	26	0	1	27	0	0
14	25071338	.	C	T	2	18	20	0	20	40	0	0
14	25072307	.	G	T	20	16	36	0	1	37	0	0
14	25072351	.	C	T	20	11	31	0	1	32	0	0
14	25072447	.	A	G	13	24	37	0	1	38	0	0
14	25072468	.	C	T	20	17	37	0	1	38	0	0
14	25072489	.	T	G	19	18	37	0	0	37	0	0
14	25072662	.	T	C	10	0	10	0	12	22	0	0
14	25072737	.	C	T	8	18	26	0	1	27	0	0
14	25073178	.	C	G	1	11	12	0	11	23	0	0
14	25073412	.	G	A	8	10	18	0	0	18	0	0
14	25073511	.	C	T	11	4	15	0	1	16	0	0
14	25075173	.	G	A	9	6	15	0	0	15	0	0
14	25076609	.	A	T	3	6	9	0	0	9	0	0
14	25076628	.	C	A	6	6	12	0	1	13	0	0
14	25079821	.	C	A	5	1	6	0	2	8	0	0
14	25080035	.	A	G	21	22	43	0	1	44	0	0
14	25080687	.	C	G	24	13	37	0	0	37	0	0
14	25090999	.	T	G	14	16	30	0	1	31	0	0
14	25091063	.	A	G	11	13	24	0	0	24	0	0
14	25091467	.	C	T	10	8	18	0	1	19	0	0
14	25091840	.	C	T	5	3	8	0	0	8	0	0
14	25100722	.	T	A	1	2	3	0	0	3	0	0
14	25496076	.	G	T	0	4	4	0	1	5	0	0
14	25498423	.	T	C	2	2	4	0	0	4	0	0
14	25500594	.	T	A	1	5	6	0	0	6	0	0
14	25501581	.	T	C	5	5	10	1	0	11	0	0
14	25501740	.	T	G	6	5	11	0	0	11	0	0
14	25501851	.	T	G	4	8	12	0	3	15	0	0
14	25502142	.	T	C	8	12	20	0	1	21	0	0
14	25510803	.	A	G	4	4	8	0	1	9	0	0
14	25534862	.	G	T	11	1	12	0	1	13	0	0
14	25535003	.	C	T	0	8	8	0	2	10	0	0
14	25535005	.	T	C	2	8	10	0	0	10	0	0
14	25535067	.	A	T	7	10	17	0	0	17	0	0
14	25535167	.	T	G	12	9	21	0	1	22	0	0
14	25535607	.	G	A	23	23	46	0	0	46	0	0
14	25535706	.	G	T	21	24	45	0	1	46	0	0
14	25535742	.	T	A	12	18	30	1	0	31	0	0
14	25535768	.	G	T	14	10	24	2	0	26	0	0
14	25535820	.	C	T	0	5	5	0	11	16	0	0
14	25535983	.	A	G	1	1	2	0	1	3	0	0
14	25536132	.	T	C	15	9	24	0	0	24	0	0
14	25536148	.	G	A	10	10	20	0	1	21	0	0
14	25536187	.	G	T	11	6	17	0	1	18	0	0
14	25536198	.	A	G	15	5	20	0	0	20	0	0
14	25536422	.	A	G	9	4	13	0	1	14	0	0
14	25536577	.	G	C	17	6	23	0	1	24	0	0
14	25536619	.	A	G	10	12	22	0	1	24	1	0
14	25536657	.	A	C	18	13	31	0	1	32	0	0
14	25536770	.	A	T	16	9	25	0	2	27	0	0
14	25536782	.	C	T	2	9	11	0	19	30	0	0
14	25537019	.	C	A	6	4	10	0	0	10	0	0
14	25537068	.	G	A	7	7	14	0	0	14	0	0
14	25537136	.	T	C	14	9	23	0	0	23	0	0
14	25537145	.	G	A	17	11	28	0	1	29	0	0
14	25537189	.	A	T	17	11	28	0	0	28	0	0
14	25537200	.	C	T	17	11	28	0	1	29	0	0
14	25537231	.	T	C	19	5	24	0	0	24	0	0
14	25537307	.	A	T	14	6	20	0	0	20	0	0
14	25537332	.	T	A	9	5	14	0	0	14	0	0
14	25537345	.	A	G	8	3	11	0	1	12	0	0
14	25537405	.	A	G	7	3	10	0	1	11	0	0
14	25537700	.	C	T	1	10	11	0	8	19	0	0
14	25537975	.	G	T	11	4	15	0	1	16	0	0
14	25538121	.	T	C	7	7	14	0	0	14	0	0
14	25538355	.	A	T	4	13	17	0	1	18	0	0
14	25538364	.	A	C	4	12	16	0	1	17	0	0
14	25538433	.	T	A	2	2	4	0	0	4	0	0
14	25539423	.	C	T	1	7	8	0	7	15	0	0
14	25591182	.	C	T	1	5	6	0	2	8	0	0
14	25908802	.	A	C	5	2	7	0	0	7	0	0
14	25908901	.	C	T	5	3	8	1	1	10	0	0
14	25908984	.	T	G	2	2	4	0	0	4	0	0
14	25909103	.	C	A	1	2	3	0	0	3	0	0
14	25909850	.	T	A	7	2	9	0	1	10	0	0
14	25910037	.	T	A	5	5	10	0	0	10	0	0
14	25910186	.	C	A	5	2	7	0	0	7	0	0
14	25910296	.	A	G	7	3	10	0	0	10	0	0
14	25910314	.	A	T	4	9	13	0	0	13	0	0
14	25910414	.	C	G	7	8	15	0	0	15	0	0
14	25910636	.	G	C	9	10	19	0	0	19	0	0
14	25910715	.	T	C	11	12	23	0	1	24	0	0
14	25910747	.	C	T	12	10	22	0	2	24	0	0
14	25910825	.	A	C	12	13	25	0	1	26	0	0
14	25910834	.	T	A	14	12	26	0	0	26	0	0
14	25911097	.	C	T	12	11	23	0	0	23	0	0
14	25911098	.	G	A	11	11	22	0	2	24	0	0
14	25923510	.	C	G	3	4	7	0	1	8	0	0
14	25924369	.	T	A	4	7	11	0	1	12	0	0
14	25924429	.	C	T	1	3	4	0	5	9	0	0
14	25924625	.	A	T	1	2	3	0	1	4	0	0
14	25924661	.	T	C	2	3	5	0	0	5	0	0
14	25924868	.	A	T	5	6	11	0	2	13	0	0
14	25924931	.	G	A	2	3	5	0	1	6	0	0
14	25925028	.	G	A	6	3	9	0	1	10	0	0
14	25925600	.	C	T	3	2	5	0	0	5	0	0
14	25925973	.	T	A	15	3	18	0	1	19	0	0
14	25926048	.	C	T	1	9	10	0	8	18	0	0
14	25926134	.	G	A	8	16	24	0	3	27	0	0
14	25926195	.	G	A	11	14	25	0	1	26	0	0
14	25926276	.	G	A	13	11	24	0	1	25	0	0
14	25932650	.	C	A	2	2	4	0	0	4	0	0
14	25939622	.	G	A	16	12	28	0	1	29	0	0
14	25942653	.	G	A	2	3	5	0	0	5	0	0
14	25985448	.	A	C	14	5	19	1	0	20	0	0
14	25985733	.	T	A	7	2	9	0	0	9	0	0
14	26065498	.	G	A	2	6	8	0	2	10	0	0
14	26066552	.	A	C	6	1	7	0	1	8	0	0
14	26066617	.	A	G	4	8	12	0	2	14	0	0
14	26067757	.	T	A	8	6	14	0	0	14	0	0
14	26067797	.	A	T	7	4	11	0	1	12	0	0
14	26067798	.	A	G	8	4	12	0	0	12	0	0
14	26103439	.	A	T	3	2	5	0	0	5	0	0
14	26103547	.	T	A	18	12	30	0	7	37	0	0
14	26104350	.	C	A	1	14	15	0	23	38	0	0
14	26104442	.	C	T	25	19	44	0	1	45	0	0
14	26104503	.	C	T	19	20	39	0	0	39	0	0
14	26104614	.	A	C	12	11	23	0	0	23	0	0
14	26104674	.	A	T	9	10	19	0	0	19	0	0
14	26104679	.	A	C	10	0	10	0	9	19	0	0
14	26104710	.	G	T	10	6	16	0	1	17	0	0
14	26104762	.	G	A	2	5	7	0	1	8	0	0
14	26104775	.	T	A	2	5	7	0	0	7	0	0
14	26104801	.	C	A	3	4	7	0	0	7	0	0
14	26104854	.	C	T	7	7	14	0	0	14	0	0
14	26105086	.	A	C	13	11	24	2	0	26	0	0
14	26106231	.	G	T	6	14	20	0	2	22	0	0
14	26106493	.	C	T	12	9	21	0	0	21	0	0
14	26106697	.	C	T	3	10	13	0	14	27	0	0
14	26108958	.	T	G	9	13	22	0	2	24	0	0
14	26109353	.	T	G	6	6	12	0	0	12	0	0
14	26109356	.	G	A	7	3	10	0	1	11	0	0
14	26111237	.	T	C	1	5	6	0	0	6	0	0
14	26114277	.	G	A	4	5	9	0	1	10	0	0
14	26114286	.	T	C	6	0	6	0	6	12	0	0
14	26127373	.	G	A	3	2	5	0	0	5	0	0
14	26127561	.	G	A	4	5	9	0	0	9	0	0
14	26127845	.	C	T	2	2	4	0	0	4	0	0
14	26127856	.	G	A	2	1	3	0	0	3	0	0
14	26227681	.	G	A	3	4	7	0	0	7	0	0
14	26363836	.	G	A	4	2	6	0	0	6	0	0
14	26404803	.	C	T	13	14	27	0	0	27	0	0
14	26404830	.	C	A	9	8	17	0	2	19	0	0
14	26405027	.	G	A	10	6	16	0	2	18	0	0
14	26405205	.	A	G	1	4	5	0	0	5	0	0
14	26413771	.	C	T	9	23	32	0	1	33	0	0
14	26414115	.	C	A	12	24	36	0	0	36	0	0
14	26414157	.	C	T	14	17	31	0	2	33	0	0
14	26414692	.	C	T	13	14	27	0	1	28	0	0
14	26718332	.	T	A	2	5	7	0	0	7	0	0
14	26718663	.	A	G	17	6	23	0	3	26	0	0
14	27281038	.	C	G	9	8	17	0	1	18	0	0
14	27281182	.	T	C	6	4	10	0	0	10	0	0
14	27998933	.	T	A	19	26	45	0	1	46	0	0
14	28001490	.	G	A	17	21	38	1	2	41	0	0
14	28351793	.	C	T	5	2	7	0	0	7	0	0
14	28385289	.	C	T	2	3	5	0	0	5	0	0
14	28437306	.	A	G	8	4	12	0	3	15	0	0
14	28437309	.	T	C	9	4	13	0	2	15	0	0
14	28448925	.	T	C	2	2	4	0	0	5	1	0
14	28449193	.	A	C	8	5	13	0	0	13	0	0
14	28452247	.	C	T	5	7	12	0	0	12	0	0
14	28452270	.	T	C	3	5	8	0	0	8	0	0
14	28454613	.	A	T	9	7	16	0	2	18	0	0
14	28458110	.	T	C	11	10	21	0	0	21	0	0
14	28458175	.	G	A	8	11	19	0	0	19	0	0
14	28458199	.	T	C	7	9	16	0	2	18	0	0
14	28458345	.	G	A	0	9	9	0	10	19	0	0
14	28458533	.	G	A	10	13	23	1	2	26	0	0
14	28458656	.	A	T	9	22	31	0	4	35	0	0
14	28458980	.	C	G	8	4	12	0	0	12	0	0
14	28459275	.	A	C	22	12	34	0	3	37	0	0
14	28459292	.	G	C	1	13	14	0	16	30	0	0
14	28459324	.	T	A	10	18	28	0	1	29	0	0
14	28459664	.	A	G	6	10	16	0	0	16	0	0
14	28459703	.	C	A	1	9	10	0	7	17	0	0
14	28463860	.	T	A	3	2	5	0	0	5	0	0
14	28464889	.	A	G	4	4	8	0	0	8	0	0
14	28464895	.	T	A	3	3	6	0	0	6	0	0
14	28476977	.	C	T	1	3	4	0	1	5	0	0
14	28477115	.	A	G	3	3	6	0	1	7	0	0
14	28477384	.	C	T	5	6	11	0	0	11	0	0
14	28477400	.	A	G	6	0	6	0	6	12	0	0
14	28483036	.	A	T	1	1	2	0	1	3	0	0
14	28497472	.	A	G	2	1	3	0	2	5	0	0
14	28497490	.	C	T	2	3	5	0	0	5	0	0
14	28502783	.	C	T	3	2	5	0	0	5	0	0
14	28507764	.	C	T	1	5	6	0	0	6	0	0
14	28512717	.	C	T	4	3	7	0	0	7	0	0
14	28514289	.	G	C	1	2	3	0	0	3	0	0
14	28514295	.	C	T	1	2	3	0	0	3	0	0
14	28520068	.	C	T	5	5	10	0	0	10	0	0
14	28520213	.	T	C	7	8	15	0	1	16	0	0
14	28525002	.	A	C	4	8	12	0	0	12	0	0
14	28525367	.	G	A	5	11	16	0	0	16	0	0
14	28526038	.	A	G	13	5	18	0	1	19	0	0
14	28526081	.	G	A	11	12	23	0	1	24	0	0
14	28526281	.	A	G	16	1	17	0	15	32	0	0
14	28526486	.	T	G	7	6	13	0	1	14	0	0
14	28526797	.	C	T	11	14	25	0	1	26	0	0
14	28526815	.	G	T	11	13	24	0	1	25	0	0
14	28526950	.	T	C	18	6	24	0	0	24	0	0
14	28527130	.	T	G	12	11	23	0	1	24	0	0
14	29759522	.	G	T	3	2	5	0	0	5	0	0
14	30106211	.	G	T	2	2	4	0	0	4	0	0
14	30156718	.	A	T	2	3	5	0	0	5	0	0
14	30156943	.	T	A	5	3	8	0	1	9	0	0
14	30158062	.	C	A	1	2	3	0	0	3	0	0
14	30158495	.	C	T	0	2	2	0	1	3	0	0
14	30159582	.	A	T	2	2	4	0	0	4	0	0
14	30276522	.	A	G	2	0	2	0	5	7	0	0
14	30277652	.	G	A	0	5	5	0	3	8	0	0
14	30356811	.	T	A	1	2	3	0	0	3	0	0
14	30356947	.	T	A	2	3	5	0	0	5	0	0
14	30357099	.	C	T	1	3	4	0	0	4	0	0
14	30360991	.	G	A	1	5	6	0	0	6	0	0
14	30361051	.	A	G	3	2	5	0	0	5	0	0
14	30369448	.	A	T	1	2	3	0	0	3	0	0
14	30401100	.	C	T	3	2	5	0	1	6	0	0
14	30403813	.	A	G	2	4	6	0	0	6	0	0
14	30403830	.	G	A	5	2	7	0	0	7	0	0
14	30407638	.	C	A	3	4	7	0	0	7	0	0
14	30410882	.	G	A	2	7	9	0	5	14	0	0
14	30410911	.	G	A	6	5	11	0	1	12	0	0
14	30411292	.	T	C	14	9	23	0	0	23	0	0
14	30411707	.	C	T	1	2	3	0	0	3	0	0
14	30411774	.	G	A	2	5	7	2	0	9	0	0
14	30424342	.	G	C	0	2	2	0	2	4	0	0
14	30427780	.	C	A	5	2	7	0	0	7	0	0
14	30427834	.	G	A	3	4	7	0	0	7	0	0
14	30428193	.	G	T	5	11	16	0	1	17	0	0
14	30454215	.	A	G	1	4	5	0	0	5	0	0
14	30456463	.	C	T	1	5	6	0	4	10	0	0
14	30460630	.	G	A	7	2	9	0	0	9	0	0
14	30493275	.	G	A	2	4	6	0	0	6	0	0
14	30493285	.	A	C	2	3	5	0	0	5	0	0
14	30551452	.	A	T	15	6	21	0	0	21	0	0
14	30551488	.	C	T	11	6	17	0	2	19	0	0
14	30551712	.	G	T	14	15	29	0	2	31	0	0
14	30551775	.	C	T	2	7	9	2	21	32	0	0
14	30551790	.	G	A	23	9	32	2	0	34	0	0
14	30569108	.	G	A	2	10	12	0	19	31	0	0
14	30580906	.	A	G	10	3	13	0	0	13	0	0
14	30581910	.	A	G	3	3	6	0	0	6	0	0
14	30613469	.	C	A	11	27	38	0	2	40	0	0
14	30620229	.	G	C	14	14	28	0	1	29	0	0
14	30637866	.	T	C	32	0	32	0	22	54	0	0
14	30637907	.	G	A	27	27	54	0	2	56	0	0
14	30638071	.	G	A	19	23	42	0	1	43	0	0
14	30638087	.	G	A	17	21	38	0	3	41	0	0
14	30638336	.	C	T	18	25	43	0	0	43	0	0
14	30638599	.	G	A	13	16	29	0	0	29	0	0
14	30642513	.	A	G	3	3	6	0	0	6	0	0
14	30642529	.	A	T	2	2	4	0	1	5	0	0
14	30642757	.	T	G	7	8	15	0	0	15	0	0
14	30670017	.	C	A	1	2	3	0	0	3	0	0
14	30713964	.	T	C	19	20	39	0	2	41	0	0
14	30720354	.	C	T	0	4	4	0	3	7	0	0
14	30720372	.	T	G	3	4	7	0	0	7	0	0
14	30731046	.	T	C	3	2	5	0	0	5	0	0
14	30731174	.	C	T	2	4	6	0	0	6	0	0
14	30731577	.	A	G	1	4	5	0	0	5	0	0
14	30732136	.	C	G	4	8	12	0	2	14	0	0
14	30732828	.	T	G	8	4	12	0	0	12	0	0
14	30732899	.	C	T	6	4	10	0	0	10	0	0
14	30733008	.	C	T	9	5	14	0	1	15	0	0
14	30733164	.	G	A	13	13	26	0	1	27	0	0
14	30733279	.	C	A	13	7	20	0	2	22	0	0
14	30733411	.	A	G	7	11	18	0	0	18	0	0
14	30733685	.	G	A	15	6	21	0	3	24	0	0
14	30733689	.	G	A	15	8	23	0	0	23	0	0
14	30733779	.	G	A	0	9	9	0	6	15	0	0
14	30733783	.	C	A	12	5	17	0	1	18	0	0
14	30733964	.	C	T	16	8	24	0	4	28	0	0
14	30734183	.	C	T	20	15	35	0	0	35	0	0
14	30734215	.	A	T	20	19	39	0	0	39	0	0
14	30734221	.	A	G	18	1	19	0	22	41	0	0
14	30734295	.	A	G	13	21	34	0	4	38	0	0
14	30734347	.	A	G	14	24	38	0	1	39	0	0
14	30734389	.	A	T	16	18	34	0	1	35	0	0
14	30734390	.	T	A	15	18	33	0	2	35	0	0
14	30734516	.	T	C	21	21	42	0	0	42	0	0
14	30734900	.	G	A	7	7	14	0	1	15	0	0
14	30741166	.	G	A	3	3	6	0	0	6	0	0
14	30759357	.	A	G	5	5	10	0	0	10	0	0
14	30759358	.	C	A	5	5	10	0	0	10	0	0
14	30791109	.	C	T	1	2	3	0	0	3	0	0
14	30791127	.	C	T	2	2	4	0	0	4	0	0
14	30792931	.	A	T	2	3	5	0	0	5	0	0
14	30800528	.	T	C	9	11	20	0	0	20	0	0
14	30800809	.	A	C	27	33	60	0	1	61	0	0
14	30801329	.	G	A	23	11	34	1	5	40	0	0
14	30801379	.	G	A	15	15	30	0	3	33	0	0
14	30801389	.	A	G	16	15	31	0	3	34	0	0
14	30801451	.	G	C	15	16	31	0	2	33	0	0
14	30801552	.	C	A	1	2	3	0	1	4	0	0
14	30802645	.	G	A	2	3	5	0	0	5	0	0
14	30802953	.	G	A	2	8	10	0	0	10	0	0
14	30803394	.	G	T	4	2	6	0	0	6	0	0
14	30803469	.	T	A	3	2	5	0	0	5	0	0
14	30803472	.	T	G	3	2	5	0	0	5	0	0
14	30803794	.	C	G	3	3	6	0	0	6	0	0
14	30803902	.	T	C	2	4	6	0	0	6	0	0
14	30803904	.	G	C	2	0	2	0	4	6	0	0
14	30854710	.	A	T	26	22	48	0	4	52	0	0
14	30854742	.	A	C	27	27	54	0	3	57	0	0
14	30855218	.	A	G	24	18	42	0	0	42	0	0
14	30855303	.	C	T	3	21	24	0	16	40	0	0
14	30855649	.	C	A	15	17	32	0	0	32	0	0
14	30855767	.	G	T	22	10	32	0	2	34	0	0
14	30855824	.	T	A	12	17	29	0	3	32	0	0
14	30878357	.	C	A	1	4	5	0	0	5	0	0
14	30878604	.	C	T	4	3	7	0	0	7	0	0
14	30879343	.	C	T	2	3	5	0	1	6	0	0
14	30879389	.	T	C	1	4	5	0	0	5	0	0
14	30879392	.	A	G	1	4	5	0	0	5	0	0
14	30899366	.	C	T	1	3	4	0	0	4	0	0
14	30913330	.	T	C	2	3	5	0	0	5	0	0
14	30913423	.	G	A	2	2	4	0	0	4	0	0
14	30915268	.	C	T	1	3	4	0	0	4	0	0
14	30915417	.	A	T	1	3	4	0	0	4	0	0
14	30915466	.	G	A	0	4	4	0	3	7	0	0
14	30916033	.	A	T	2	2	4	0	0	4	0	0
14	30916902	.	G	A	9	6	15	0	0	15	0	0
14	30925570	.	A	C	5	0	5	0	3	8	0	0
14	30927425	.	C	T	1	1	2	0	2	4	0	0
14	30927430	.	G	A	3	1	4	0	1	5	0	0
14	30929684	.	G	A	3	4	7	0	0	7	0	0
14	30967732	.	C	T	0	6	6	0	3	9	0	0
14	30970827	.	G	C	3	3	6	0	0	6	0	0
14	30970834	.	A	C	3	3	6	0	0	6	0	0
14	30975479	.	G	T	24	14	38	0	0	38	0	0
14	30978661	.	T	C	17	11	28	0	1	29	0	0
14	30982468	.	A	G	11	10	21	0	0	21	0	0
14	30987167	.	G	T	21	12	33	0	1	34	0	0
14	30987702	.	T	A	13	16	29	0	0	29	0	0
14	30987930	.	G	A	20	12	32	0	1	33	0	0
14	30987985	.	A	G	19	10	29	0	3	32	0	0
14	30988280	.	T	C	11	0	11	0	4	15	0	0
14	30988494	.	G	A	12	6	18	0	0	18	0	0
14	30988707	.	T	G	10	3	13	0	1	14	0	0
14	30989523	.	G	A	1	1	2	1	2	5	0	0
14	30989535	.	A	G	1	3	4	1	0	5	0	0
14	31024014	.	G	A	1	2	3	0	0	3	0	0
14	31081921	.	G	C	4	2	6	0	0	6	0	0
14	31082249	.	C	T	4	7	11	0	1	12	0	0
14	31082474	.	G	T	8	5	13	0	0	13	0	0
14	31082501	.	T	G	3	7	10	0	0	10	0	0
14	31082537	.	C	T	3	7	10	0	1	11	0	0
14	31082569	.	C	T	7	3	10	0	1	11	0	0
14	31082717	.	G	A	7	6	13	0	0	13	0	0
14	31082745	.	A	T	6	7	13	0	1	14	0	0
14	31082857	.	C	T	13	10	23	0	0	23	0	0
14	31091264	.	C	T	0	3	3	0	6	9	0	0
14	31091589	.	T	A	2	3	5	0	0	5	0	0
14	31474816	.	G	A	3	2	5	0	0	5	0	0
14	31474833	.	A	G	4	2	6	0	0	6	0	0
14	31477482	.	A	G	4	4	8	0	3	11	0	0
14	31478444	.	A	T	5	2	7	0	2	9	0	0
14	31493317	.	C	T	7	4	11	0	0	11	0	0
14	31497559	.	C	T	4	4	8	0	0	8	0	0
14	31498368	.	C	G	5	1	6	0	6	12	0	0
14	31498392	.	G	A	0	10	10	0	4	14	0	0
14	31507444	.	G	A	7	5	12	0	4	16	0	0
14	31516765	.	A	T	3	4	7	0	0	8	1	0
14	31519018	.	A	C	2	8	10	0	0	10	0	0
14	31519213	.	C	T	2	5	7	0	0	7	0	0
14	31519590	.	G	A	2	4	6	0	0	6	0	0
14	31519616	.	A	T	1	2	3	0	1	4	0	0
14	31519777	.	T	A	4	7	11	0	1	12	0	0
14	31520371	.	A	T	2	1	3	1	1	5	0	0
14	31520626	.	A	T	5	3	8	0	0	8	0	0
14	31520750	.	T	C	7	7	14	0	0	14	0	0
14	31521346	.	T	A	1	3	4	0	0	4	0	0
14	31530171	.	G	T	1	6	7	0	0	7	0	0
14	31530186	.	A	G	4	3	7	0	0	7	0	0
14	31530421	.	G	A	4	6	10	0	0	10	0	0
14	31541122	.	A	T	9	10	19	0	0	19	0	0
14	31541318	.	C	T	11	11	22	0	0	22	0	0
14	31544922	.	A	T	5	9	14	0	0	14	0	0
14	31544947	.	C	T	4	9	13	0	1	14	0	0
14	31545272	.	C	T	11	7	18	0	1	19	0	0
14	31545433	.	A	T	10	9	19	0	1	20	0	0
14	31545794	.	A	G	19	12	31	0	2	33	0	0
14	31545795	.	G	A	19	13	32	0	1	33	0	0
14	31545902	.	T	A	16	10	26	0	1	27	0	0
14	31545919	.	A	T	12	10	22	0	0	22	0	0
14	31546107	.	T	G	13	0	13	0	14	27	0	0
14	31546137	.	T	A	15	13	28	0	2	30	0	0
14	31546320	.	C	T	9	12	21	0	0	21	0	0
14	31551477	.	G	A	13	6	19	0	1	20	0	0
14	31556308	.	G	A	10	9	19	0	1	20	0	0
14	31556326	.	T	C	9	0	9	0	15	24	0	0
14	31556371	.	A	G	13	14	27	0	0	27	0	0
14	31559062	.	A	G	7	5	12	0	1	13	0	0
14	31562713	.	G	A	9	8	17	0	1	18	0	0
14	31615629	.	G	A	3	4	7	0	0	7	0	0
14	31615658	.	C	T	9	11	20	0	0	20	0	0
14	31616139	.	G	T	6	16	22	0	3	25	0	0
14	31616151	.	C	T	7	15	22	0	1	23	0	0
14	31641799	.	G	A	0	4	4	0	2	6	0	0
14	31641847	.	A	G	1	2	3	0	0	3	0	0
14	31644520	.	T	G	1	5	6	0	1	7	0	0
14	31644859	.	T	A	8	8	16	0	0	16	0	0
14	31645022	.	C	T	5	3	8	0	0	8	0	0
14	31646121	.	G	A	5	6	11	0	0	11	0	0
14	31646224	.	G	A	9	15	24	0	2	26	0	0
14	31646275	.	C	A	11	10	21	0	0	21	0	0
14	31646307	.	G	T	6	3	9	0	0	9	0	0
14	31646650	.	A	G	6	1	7	0	8	15	0	0
14	31646869	.	A	G	4	6	10	0	0	10	0	0
14	31647217	.	A	G	6	8	14	0	2	16	0	0
14	31647516	.	A	T	5	3	8	0	0	8	0	0
14	31647553	.	G	T	5	10	15	0	0	15	0	0
14	31647730	.	T	C	12	16	28	0	0	28	0	0
14	31647829	.	C	A	6	13	19	0	0	19	0	0
14	31668646	.	G	A	7	9	16	0	0	16	0	0
14	31668719	.	C	T	0	8	8	0	11	19	0	0
14	31668758	.	G	A	22	10	32	1	0	33	0	0
14	31669376	.	T	G	3	10	13	0	0	13	0	0
14	31669377	.	G	T	3	9	12	0	1	13	0	0
14	31669466	.	C	G	5	9	14	0	1	15	0	0
14	31669488	.	A	G	8	10	18	0	0	18	0	0
14	31669551	.	T	C	6	9	15	0	0	15	0	0
14	31669558	.	C	A	7	9	16	0	0	16	0	0
14	31669907	.	A	T	2	5	7	0	0	7	0	0
14	31677036	.	A	T	2	5	7	0	0	7	0	0
14	31777104	.	A	G	1	2	3	0	1	4	0	0
14	31779690	.	G	A	0	3	3	0	1	4	0	0
14	31780273	.	G	T	0	2	2	0	4	6	0	0
14	31780311	.	A	G	2	0	2	0	3	5	0	0
14	31800090	.	T	C	16	9	25	0	0	25	0	0
14	31800175	.	G	T	9	10	19	0	0	19	0	0
14	31800206	.	T	A	3	8	11	0	0	11	0	0
14	31800870	.	C	G	6	6	12	0	1	13	0	0
14	31801219	.	T	C	2	0	2	0	2	4	0	0
14	31801454	.	C	T	0	4	4	0	1	5	0	0
14	31802067	.	A	T	4	5	9	0	0	9	0	0
14	31802156	.	T	C	1	2	3	0	0	3	0	0
14	31803191	.	T	C	1	0	1	0	3	4	0	0
14	31806744	.	G	A	2	2	4	0	0	4	0	0
14	31860525	.	C	T	11	15	26	0	4	30	0	0
14	31861179	.	A	G	10	10	20	0	0	20	0	0
14	31882656	.	C	T	2	4	6	1	0	7	0	0
14	31882672	.	G	T	7	2	9	1	0	10	0	0
14	31882709	.	A	T	4	3	7	0	1	8	0	0
14	31882714	.	A	T	4	5	9	0	1	10	0	0
14	31883426	.	C	T	1	4	5	0	0	5	0	0
14	31883472	.	A	C	0	3	3	0	0	3	0	0
14	31883475	.	A	T	1	3	4	0	0	4	0	0
14	31883519	.	G	C	1	2	3	0	4	7	0	0
14	31883735	.	G	A	2	3	5	0	5	10	0	0
14	31884011	.	T	A	4	6	10	0	1	11	0	0
14	31936994	.	T	C	1	4	5	0	0	5	0	0
14	32011929	.	C	G	1	18	19	0	20	39	0	0
14	32013167	.	C	A	0	8	8	0	11	19	0	0
14	32023213	.	T	C	3	5	8	0	1	9	0	0
14	32025381	.	T	C	7	5	12	1	1	14	0	0
14	32025753	.	G	T	0	3	3	0	0	3	0	0
14	32025766	.	A	T	1	2	3	0	0	3	0	0
14	32184469	.	C	T	27	20	47	1	1	49	0	0
14	32184927	.	C	A	20	16	36	1	2	39	0	0
14	32184937	.	C	T	16	21	37	1	0	38	0	0
14	32185036	.	C	A	1	17	18	0	19	37	0	0
14	32185374	.	C	T	6	11	17	0	1	18	0	0
14	32443572	.	A	C	8	9	17	0	1	19	1	0
14	32443727	.	C	T	0	16	16	0	12	28	0	0
14	32443811	.	A	C	11	7	18	0	0	18	0	0
14	32444064	.	C	G	8	10	18	0	0	18	0	0
14	32444114	.	C	G	9	12	21	0	0	21	0	0
14	32444379	.	T	C	5	3	8	0	0	8	0	0
14	32444392	.	C	T	4	2	6	0	0	6	0	0
14	32444496	.	G	T	6	9	15	0	0	15	0	0
14	32444651	.	G	A	9	3	12	0	0	12	0	0
14	32444878	.	C	A	4	5	9	0	0	9	0	0
14	32857218	.	T	C	1	3	4	0	0	4	0	0
14	32945536	.	C	T	3	2	5	0	0	5	0	0
14	32952148	.	C	T	3	2	5	0	1	6	0	0
14	32952180	.	T	A	2	6	8	0	0	8	0	0
14	32952467	.	C	T	5	6	11	0	0	11	0	0
14	32952493	.	G	A	3	2	5	0	2	7	0	0
14	32952606	.	C	T	1	8	9	0	5	14	0	0
14	32952665	.	C	T	0	6	6	0	5	11	0	0
14	32952825	.	C	T	1	3	4	0	9	13	0	0
14	32984047	.	G	A	6	9	15	0	0	15	0	0
14	32984128	.	C	A	8	5	13	0	0	13	0	0
14	32984139	.	A	C	4	7	11	0	1	12	0	0
14	32984239	.	G	A	2	3	5	0	0	5	0	0
14	33068654	.	C	T	0	2	2	0	1	3	0	0
14	33071814	.	G	A	21	14	35	0	1	36	0	0
14	33073954	.	G	A	14	12	26	0	0	26	0	0
14	33120461	.	G	A	5	7	12	0	0	12	0	0
14	33177681	.	A	G	3	3	6	0	3	9	0	0
14	33177949	.	G	C	5	0	5	0	5	10	0	0
14	33268115	.	T	G	2	4	6	0	1	7	0	0
14	33268219	.	A	G	4	14	18	0	1	19	0	0
14	33268254	.	C	A	6	15	21	0	0	21	0	0
14	33268297	.	T	C	9	15	24	0	1	25	0	0
14	33268330	.	C	A	12	9	21	0	4	25	0	0
14	33268388	.	A	G	12	0	12	0	7	19	0	0
14	33280818	.	C	T	23	18	41	0	0	41	0	0
14	33281240	.	T	A	28	26	54	0	3	57	0	0
14	33281690	.	A	G	13	6	19	0	1	20	0	0
14	33281816	.	C	T	0	19	19	0	10	29	0	0
14	33281856	.	T	A	19	23	42	0	0	42	0	0
14	33281964	.	T	C	18	7	25	0	0	25	0	0
14	33282050	.	C	T	20	12	32	0	2	34	0	0
14	33288448	.	A	G	18	11	29	0	1	30	0	0
14	33297882	.	A	T	14	9	23	0	0	23	0	0
14	33298098	.	C	A	10	12	22	1	2	25	0	0
14	33298397	.	T	C	2	10	12	0	1	13	0	0
14	33298436	.	C	T	8	10	18	0	0	18	0	0
14	33298637	.	C	T	24	17	41	0	2	43	0	0
14	33302331	.	G	A	1	3	4	0	0	4	0	0
14	33302745	.	T	C	3	2	5	0	0	5	0	0
14	33306505	.	C	T	17	21	38	0	1	39	0	0
14	33307831	.	C	T	16	25	41	0	2	43	0	0
14	33308039	.	A	G	21	20	41	0	1	42	0	0
14	33308120	.	G	A	25	12	37	0	2	39	0	0
14	33333741	.	A	G	40	28	68	2	2	72	0	0
14	33333986	.	G	A	25	14	39	0	2	41	0	0
14	33339761	.	G	C	5	8	13	0	0	13	0	0
14	33339791	.	G	T	8	3	11	0	0	11	0	0
14	33339895	.	G	A	2	7	9	0	0	9	0	0
14	33340099	.	C	T	4	9	13	0	1	14	0	0
14	33414015	.	G	T	4	2	6	0	0	6	0	0
14	33414060	.	G	C	2	5	7	0	4	11	0	0
14	33414105	.	T	A	15	13	28	0	2	30	0	0
14	33414590	.	G	A	30	11	41	0	1	42	0	0
14	33414596	.	C	T	28	11	39	0	0	39	0	0
14	33414885	.	C	T	1	13	14	0	0	14	0	0
14	33414894	.	C	T	1	10	11	0	1	12	0	0
14	33419714	.	G	A	23	19	42	1	1	44	0	0
14	33423037	.	C	T	14	15	29	0	1	30	0	0
14	33424626	.	T	C	17	20	37	0	1	38	0	0
14	33424869	.	C	T	28	20	48	0	1	49	0	0
14	33424931	.	T	C	20	22	42	0	2	44	0	0
14	33425013	.	C	T	1	21	22	0	10	32	0	0
14	33433626	.	A	G	2	2	4	0	0	4	0	0
14	33433669	.	G	A	3	3	6	0	1	7	0	0
14	33434076	.	A	T	3	3	6	0	0	6	0	0
14	33435384	.	G	A	12	7	19	0	0	19	0	0
14	33435415	.	A	G	8	3	11	2	9	22	0	0
14	33435460	.	G	T	9	6	15	2	1	18	0	0
14	33435598	.	C	T	7	13	20	0	2	22	0	0
14	33435768	.	C	A	7	5	12	0	0	12	0	0
14	33436514	.	G	A	14	10	24	0	2	26	0	0
14	33437009	.	G	T	18	12	30	0	0	30	0	0
14	33437056	.	C	A	15	10	25	0	1	26	0	0
14	33441928	.	C	T	15	13	28	0	3	31	0	0
14	33442006	.	A	G	17	16	33	0	3	36	0	0
14	33442069	.	C	T	8	20	28	0	2	30	0	0
14	33454561	.	T	C	8	0	8	0	4	12	0	0
14	33454570	.	C	T	0	3	3	0	9	12	0	0
14	33469026	.	C	A	16	19	35	0	3	38	0	0
14	33469094	.	T	A	17	25	42	0	1	43	0	0
14	33469177	.	C	A	21	9	30	0	1	31	0	0
14	33469180	.	A	G	19	0	19	0	9	28	0	0
14	33469241	.	A	G	12	0	12	0	10	22	0	0
14	33469268	.	A	G	8	10	18	0	0	18	0	0
14	33469636	.	A	G	5	4	9	0	0	9	0	0
14	33474745	.	T	C	13	0	13	0	10	23	0	0
14	33474762	.	G	C	15	12	27	0	0	27	0	0
14	33474869	.	A	C	10	0	10	0	13	23	0	0
14	33475273	.	G	C	1	2	3	0	0	3	0	0
14	33475445	.	A	C	2	4	6	0	0	6	0	0
14	33486539	.	A	C	1	3	4	0	0	4	0	0
14	33486543	.	C	G	1	3	4	0	1	5	0	0
14	33487022	.	A	T	1	1	2	0	1	3	0	0
14	33497008	.	C	T	2	3	5	0	0	5	0	0
14	33498960	.	G	A	7	3	10	0	0	10	0	0
14	33499239	.	A	T	5	5	10	0	0	10	0	0
14	33501772	.	C	A	11	10	21	0	0	21	0	0
14	33505055	.	G	C	13	11	24	0	0	24	0	0
14	33507743	.	C	T	11	4	15	0	0	15	0	0
14	33515983	.	C	T	8	5	13	0	2	15	0	0
14	33516015	.	G	A	11	11	22	0	0	22	0	0
14	33516131	.	A	G	9	8	17	0	1	18	0	0
14	33516218	.	G	C	4	0	4	0	6	10	0	0
14	33516237	.	C	T	5	6	11	0	0	11	0	0
14	33516314	.	A	G	7	6	13	0	0	13	0	0
14	33516603	.	T	C	5	0	5	0	3	8	0	0
14	33516619	.	A	G	5	3	8	0	0	8	0	0
14	33517203	.	A	C	2	2	4	0	1	5	0	0
14	33517333	.	T	C	2	3	5	0	0	5	0	0
14	33517334	.	T	A	2	3	5	0	0	5	0	0
14	33517439	.	T	C	2	3	5	0	0	5	0	0
14	33517457	.	C	T	2	2	4	0	2	6	0	0
14	33518164	.	C	G	1	3	4	0	1	5	0	0
14	33564916	.	C	T	7	9	16	0	0	16	0	0
14	33564994	.	A	G	10	12	22	0	1	23	0	0
14	33565054	.	C	A	8	4	12	0	1	13	0	0
14	33565209	.	C	T	8	5	13	0	1	14	0	0
14	33565794	.	A	C	5	5	10	0	1	11	0	0
14	33566052	.	G	T	5	5	10	0	1	11	0	0
14	33566515	.	G	A	1	16	17	0	19	36	0	0
14	33566542	.	A	T	19	15	34	0	2	36	0	0
14	33566578	.	G	C	16	12	28	0	2	30	0	0
14	33566613	.	G	A	12	9	21	0	1	22	0	0
14	33566617	.	C	T	10	10	20	0	0	20	0	0
14	33566651	.	A	G	14	7	21	0	2	23	0	0
14	33566744	.	G	T	14	12	26	0	0	26	0	0
14	33566945	.	C	T	19	15	34	0	3	37	0	0
14	33567023	.	T	A	15	13	28	0	1	29	0	0
14	33567024	.	T	A	15	12	27	0	3	30	0	0
14	33567085	.	A	G	5	14	19	0	0	19	0	0
14	33567261	.	A	G	1	2	3	0	0	3	0	0
14	33573662	.	C	T	0	2	2	0	1	3	0	0
14	33591985	.	T	A	2	4	6	0	0	6	0	0
14	33754710	.	T	G	6	3	9	0	0	9	0	0
14	33755677	.	C	A	17	11	28	0	1	29	0	0
14	33755810	.	A	C	18	8	26	0	3	29	0	0
14	33755813	.	C	A	11	16	27	0	3	30	0	0
14	33755847	.	T	C	19	12	31	0	0	31	0	0
14	33756950	.	G	A	27	22	49	0	0	49	0	0
14	33757152	.	A	C	32	19	51	0	1	53	1	0
14	33826267	.	A	T	11	7	18	0	1	19	0	0
14	33826491	.	T	G	3	9	12	0	0	12	0	0
14	33826580	.	T	A	6	7	13	0	0	13	0	0
14	33826655	.	T	G	4	11	15	0	1	17	1	0
14	33826682	.	G	A	6	7	13	0	0	13	0	0
14	33826707	.	C	T	0	6	6	0	8	14	0	0
14	33826767	.	T	A	4	8	12	0	0	12	0	0
14	33826827	.	C	T	3	2	5	0	2	7	0	0
14	33826850	.	T	C	4	3	7	0	0	7	0	0
14	33827532	.	T	C	3	2	5	0	2	7	0	0
14	33827732	.	C	A	4	6	10	0	1	11	0	0
14	33827771	.	G	A	7	4	11	0	0	11	0	0
14	33827791	.	A	T	3	5	8	0	0	8	0	0
14	33827869	.	C	A	4	2	6	0	1	7	0	0
14	33827903	.	C	T	0	3	3	0	4	7	0	0
14	33828086	.	G	T	1	2	3	0	0	3	0	0
14	33828707	.	C	T	2	5	7	1	1	9	0	0
14	33829143	.	C	T	0	6	6	0	4	10	0	0
14	33830689	.	G	A	4	2	6	0	0	6	0	0
14	33860250	.	T	A	11	6	17	0	4	21	0	0
14	33860262	.	C	T	1	15	16	0	9	25	0	0
14	33860372	.	T	C	17	21	38	0	1	39	0	0
14	33860567	.	C	A	21	13	34	0	0	35	1	0
14	33864388	.	G	A	14	17	31	0	0	31	0	0
14	33865764	.	C	T	5	10	15	0	1	16	0	0
14	33865954	.	C	T	6	2	8	0	1	9	0	0
14	33866024	.	T	C	7	7	14	0	0	14	0	0
14	33889544	.	T	C	1	2	3	0	0	3	0	0
14	33891711	.	G	A	1	12	13	0	9	22	0	0
14	33891981	.	A	T	1	2	3	0	2	5	0	0
14	33892126	.	A	T	7	10	17	0	1	18	0	0
14	33892388	.	A	G	2	1	3	0	1	4	0	0
14	33892501	.	C	T	5	5	10	0	3	13	0	0
14	33899529	.	T	C	19	11	30	0	5	35	0	0
14	33899786	.	G	A	19	13	32	0	4	36	0	0
14	33899912	.	C	A	2	21	23	0	19	42	0	0
14	33900150	.	A	C	16	15	31	0	0	31	0	0
14	33900155	.	T	C	15	1	16	0	15	31	0	0
14	33900229	.	C	A	6	13	19	1	1	21	0	0
14	33900278	.	A	C	4	6	10	1	2	13	0	0
14	33900561	.	T	A	6	18	24	0	2	26	0	0
14	33900575	.	A	T	15	8	23	0	2	25	0	0
14	33900611	.	G	A	15	19	34	0	0	34	0	0
14	33900663	.	T	A	19	13	32	0	1	33	0	0
14	33901129	.	C	T	10	10	20	2	1	23	0	0
14	33901267	.	C	A	13	4	17	0	0	17	0	0
14	33901293	.	A	C	9	11	20	0	0	20	0	0
14	33901445	.	T	G	1	2	3	0	0	3	0	0
14	33901617	.	G	A	9	5	14	0	0	14	0	0
14	33901704	.	G	A	9	3	12	0	0	12	0	0
14	33901766	.	G	C	8	7	15	0	0	15	0	0
14	33901790	.	C	G	0	4	4	0	11	15	0	0
14	33901807	.	A	G	9	6	15	0	0	15	0	0
14	33901865	.	C	A	10	7	17	1	3	21	0	0
14	33901907	.	G	A	8	11	19	0	1	20	0	0
14	33901946	.	A	T	7	8	15	0	0	15	0	0
14	33901957	.	C	A	5	7	12	0	0	12	0	0
14	33901993	.	G	A	5	2	7	0	1	8	0	0
14	33902094	.	G	A	6	8	14	0	0	14	0	0
14	33903090	.	G	A	4	12	16	0	0	16	0	0
14	33909978	.	C	T	3	2	5	0	0	5	0	0
14	33916050	.	A	G	1	3	4	0	0	4	0	0
14	33936378	.	T	A	3	3	6	0	0	6	0	0
14	33941266	.	G	A	3	13	16	0	0	16	0	0
14	33941274	.	T	C	2	12	14	0	0	15	1	0
14	33941436	.	C	T	1	3	4	0	1	5	0	0
14	33941471	.	T	A	3	1	4	0	0	4	0	0
14	33941480	.	C	T	4	2	6	0	0	6	0	0
14	33941519	.	G	A	5	3	8	0	0	8	0	0
14	33983966	.	G	A	38	15	53	0	1	54	0	0
14	33984610	.	A	G	26	20	46	0	1	47	0	0
14	33987455	.	T	A	11	9	20	0	2	22	0	0
14	33989580	.	G	A	22	18	40	0	0	40	0	0
14	33991784	.	G	A	13	5	18	0	0	18	0	0
14	33991799	.	G	T	14	4	18	0	2	20	0	0
14	33997606	.	G	A	4	3	7	0	0	7	0	0
14	33997681	.	G	A	3	2	5	0	0	5	0	0
14	33997861	.	A	G	4	2	6	0	0	6	0	0
14	33997873	.	G	A	5	3	8	0	0	8	0	0
14	33998078	.	G	A	1	6	7	0	0	7	0	0
14	34002325	.	G	A	2	2	4	0	0	4	0	0
14	34002571	.	T	A	2	2	4	0	0	4	0	0
14	34064401	.	G	A	1	3	4	0	1	5	0	0
14	34065115	.	A	T	6	5	11	0	1	12	0	0
14	34065244	.	A	G	5	7	12	0	0	12	0	0
14	34065586	.	G	A	8	10	18	0	1	19	0	0
14	34065596	.	T	G	9	8	17	0	0	17	0	0
14	34065785	.	G	A	9	9	18	0	1	20	1	0
14	34075094	.	T	G	2	0	2	0	5	7	0	0
14	34077401	.	C	A	4	6	10	0	0	10	0	0
14	34082694	.	T	A	9	3	12	0	1	13	0	0
14	34082697	.	C	T	12	1	13	0	0	13	0	0
14	34089508	.	A	G	6	1	7	0	8	15	0	0
14	34089597	.	T	C	5	2	7	0	0	7	0	0
14	34089636	.	A	G	5	0	5	0	5	10	0	0
14	34089653	.	G	A	5	7	12	0	0	12	0	0
14	34089676	.	C	T	6	8	14	0	0	14	0	0
14	34089707	.	T	C	4	5	9	0	1	10	0	0
14	34090034	.	A	T	1	4	5	0	0	5	0	0
14	34090093	.	A	C	2	4	6	0	1	7	0	0
14	34090169	.	T	C	2	2	4	0	0	4	0	0
14	34090228	.	G	A	3	7	10	0	0	10	0	0
14	34090248	.	C	G	5	10	15	0	0	15	0	0
14	34090315	.	T	G	8	7	15	0	0	15	0	0
14	34090342	.	G	A	6	4	10	0	3	13	0	0
14	34090647	.	G	A	0	8	8	0	9	17	0	0
14	34091123	.	G	T	4	5	9	0	1	10	0	0
14	34091238	.	C	A	12	6	18	0	1	19	0	0
14	34091423	.	C	T	13	11	24	0	1	25	0	0
14	34091461	.	G	T	8	11	19	0	2	21	0	0
14	34091717	.	T	G	12	12	24	0	0	24	0	0
14	34091787	.	T	A	18	12	30	0	2	32	0	0
14	34092369	.	C	T	15	16	31	0	2	33	0	0
14	34092507	.	T	G	9	19	28	0	2	30	0	0
14	34125983	.	T	A	4	5	9	0	1	10	0	0
14	34126353	.	A	T	28	19	47	0	5	52	0	0
14	34127925	.	T	A	3	8	11	0	0	11	0	0
14	34128399	.	A	C	8	9	17	0	1	18	0	0
14	34128477	.	A	C	14	1	15	0	9	24	0	0
14	34128528	.	C	T	11	11	22	0	0	22	0	0
14	34128744	.	G	A	8	7	15	0	1	16	0	0
14	34128796	.	G	T	8	5	13	0	0	13	0	0
14	34128799	.	C	T	0	9	9	0	5	14	0	0
14	34128901	.	G	A	2	4	6	0	1	7	0	0
14	34128902	.	T	G	2	4	6	0	1	7	0	0
14	34128967	.	G	A	1	2	3	2	0	5	0	0
14	34128969	.	T	C	0	2	2	2	0	4	0	0
14	34129092	.	C	T	0	3	3	1	5	9	0	0
14	34129433	.	T	G	2	6	8	0	0	8	0	0
14	34129502	.	G	T	7	7	14	0	1	15	0	0
14	34129644	.	T	A	1	4	5	0	0	5	0	0
14	34129780	.	T	C	3	2	5	0	1	6	0	0
14	34130397	.	C	T	1	3	4	0	0	4	0	0
14	34131056	.	T	C	3	3	6	0	0	6	0	0
14	34139713	.	G	A	2	4	6	0	0	6	0	0
14	34154746	.	C	T	1	2	3	0	1	4	0	0
14	34487972	.	C	T	39	39	78	0	5	83	0	0
14	34488360	.	C	T	11	4	15	0	0	15	0	0
14	34488456	.	T	C	6	16	22	0	3	25	0	0
14	34488612	.	T	A	16	1	17	0	5	22	0	0
14	34488655	.	A	G	14	7	21	0	4	25	0	0
14	34488687	.	C	A	11	5	16	0	2	18	0	0
14	34488929	.	C	T	1	6	7	0	0	7	0	0
14	34497526	.	A	T	0	2	2	0	1	3	0	0
14	34556758	.	C	T	3	4	7	0	0	7	0	0
14	34556986	.	C	T	4	3	7	0	0	7	0	0
14	34635347	.	T	C	1	0	1	0	2	3	0	0
14	34637134	.	A	T	9	5	14	0	0	14	0	0
14	34648339	.	C	A	2	2	4	0	1	5	0	0
14	34658139	.	G	T	1	2	3	0	0	3	0	0
14	34790762	.	G	A	0	2	2	0	2	4	0	0
14	34794940	.	A	T	2	2	4	0	0	4	0	0
14	34797681	.	G	T	4	7	11	0	1	12	0	0
14	34797711	.	T	C	4	6	10	0	1	11	0	0
14	34797810	.	C	A	5	4	9	0	0	9	0	0
14	34797908	.	T	C	5	6	11	0	1	12	0	0
14	34797972	.	C	T	5	7	12	0	0	12	0	0
14	34798017	.	C	T	6	4	10	0	3	13	0	0
14	34825745	.	T	C	6	4	10	0	0	10	0	0
14	35003880	.	C	T	5	4	9	0	0	9	0	0
14	35008780	.	T	A	1	5	6	0	0	6	0	0
14	35008804	.	T	C	1	3	4	0	0	4	0	0
14	35008885	.	G	A	1	2	3	0	0	3	0	0
14	35008887	.	C	A	1	2	3	0	0	3	0	0
14	35009651	.	T	C	8	16	24	0	0	24	0	0
14	35009652	.	G	T	7	15	22	0	3	25	0	0
14	35009736	.	A	T	9	7	16	1	0	17	0	0
14	35009739	.	A	G	10	6	16	1	1	18	0	0
14	35010026	.	A	T	7	2	9	0	2	11	0	0
14	35010230	.	C	T	6	7	13	0	2	15	0	0
14	35010236	.	A	T	7	8	15	0	0	15	0	0
14	35010936	.	T	A	4	5	9	0	1	10	0	0
14	35011140	.	G	A	6	3	9	0	2	11	0	0
14	35011174	.	C	T	3	3	6	0	0	6	0	0
14	35011301	.	C	T	12	6	18	0	1	19	0	0
14	35011398	.	G	T	9	3	12	0	0	12	0	0
14	35011570	.	C	T	15	15	30	0	1	31	0	0
14	35011857	.	G	A	17	6	23	0	1	24	0	0
14	35011944	.	G	A	20	14	34	0	3	37	0	0
14	35387545	.	T	C	3	2	5	0	0	5	0	0
14	35406911	.	C	T	1	3	4	0	0	4	0	0
14	35407463	.	A	C	1	5	6	0	0	6	0	0
14	35408040	.	T	C	1	3	4	0	0	4	0	0
14	35409510	.	A	G	8	5	13	0	0	13	0	0
14	35409635	.	G	C	6	0	6	1	5	12	0	0
14	35409643	.	A	G	6	4	10	1	0	11	0	0
14	35409689	.	G	A	7	5	12	0	1	13	0	0
14	35409784	.	T	G	13	5	18	0	1	19	0	0
14	35409838	.	A	T	5	5	10	0	0	10	0	0
14	35409903	.	A	T	2	4	6	0	3	9	0	0
14	35409940	.	G	T	3	5	8	0	0	8	0	0
14	35409944	.	C	A	3	4	7	0	1	8	0	0
14	35410583	.	G	A	11	8	19	0	2	21	0	0
14	35410992	.	G	A	4	3	7	0	0	7	0	0
14	35411076	.	C	T	4	5	9	0	1	10	0	0
14	35422383	.	G	A	4	2	6	0	0	6	0	0
14	35422417	.	T	C	4	3	7	0	2	9	0	0
14	35500249	.	G	T	16	7	23	0	0	23	0	0
14	35505312	.	C	A	1	6	7	0	10	17	0	0
14	35505376	.	C	A	4	8	12	0	0	12	0	0
14	35692149	.	A	G	2	4	6	0	0	6	0	0
14	35699039	.	G	A	9	3	12	0	0	12	0	0
14	35699109	.	C	A	4	4	8	0	0	8	0	0
14	35715815	.	T	C	13	5	18	0	0	18	0	0
14	35719354	.	G	A	11	3	14	0	0	14	0	0
14	35731558	.	C	T	22	31	53	0	1	54	0	0
14	35732110	.	C	T	14	17	31	0	1	32	0	0
14	35732189	.	C	T	9	6	15	0	0	15	0	0
14	35732195	.	C	T	4	8	12	0	1	13	0	0
14	35780186	.	G	A	0	2	2	0	2	4	0	0
14	35797654	.	G	A	0	3	3	0	3	6	0	0
14	35799400	.	G	A	5	4	9	0	0	9	0	0
14	35799409	.	C	T	3	5	8	0	0	8	0	0
14	35804592	.	T	C	5	6	11	0	0	11	0	0
14	35804688	.	G	A	8	9	17	0	1	18	0	0
14	35804833	.	A	G	7	11	18	0	0	18	0	0
14	35811971	.	C	T	22	21	43	0	2	45	0	0
14	35812355	.	G	A	17	27	44	0	0	44	0	0
14	35812718	.	C	A	15	12	27	0	1	28	0	0
14	35813367	.	C	A	43	26	69	0	1	70	0	0
14	35813384	.	G	A	4	38	42	0	26	68	0	0
14	35813407	.	C	T	37	30	67	0	6	73	0	0
14	35813424	.	C	T	33	31	64	0	4	68	0	0
14	35813479	.	T	A	29	32	61	0	3	64	0	0
14	35896106	.	A	G	2	3	5	0	0	5	0	0
14	35897751	.	A	T	5	4	9	0	0	9	0	0
14	35905907	.	T	C	3	2	5	0	0	5	0	0
14	35906312	.	T	C	7	4	11	0	1	12	0	0
14	35906345	.	C	A	3	7	10	0	0	10	0	0
14	36229211	.	T	A	8	8	16	0	1	17	0	0
14	36229227	.	T	G	9	6	15	0	0	15	0	0
14	36229415	.	C	T	4	3	7	0	0	7	0	0
14	36246854	.	C	T	3	3	6	0	0	6	0	0
14	36259377	.	G	A	0	4	4	0	6	10	0	0
14	36267395	.	C	A	8	10	18	0	3	21	0	0
14	36268152	.	C	T	6	12	18	0	1	19	0	0
14	36268339	.	C	T	20	16	36	0	1	37	0	0
14	36268426	.	T	C	16	8	24	0	1	25	0	0
14	36329332	.	T	A	2	2	4	0	0	4	0	0
14	36332527	.	G	C	2	0	2	0	2	4	0	0
14	36348878	.	G	A	19	30	49	0	2	51	0	0
14	36349387	.	A	T	32	31	63	0	6	69	0	0
14	36349409	.	A	G	34	28	62	0	12	74	0	0
14	36349607	.	C	G	5	37	42	0	33	75	0	0
14	36350639	.	G	T	31	24	55	0	1	56	0	0
14	36350669	.	T	C	27	0	27	0	25	52	0	0
14	36350917	.	A	T	25	21	46	0	2	49	1	0
14	36350932	.	T	A	29	20	49	0	1	50	0	0
14	36350980	.	T	C	32	0	32	0	18	50	0	0
14	36351004	.	C	T	18	29	47	0	3	51	1	0
14	36351064	.	G	A	35	16	51	0	4	55	0	0
14	36351143	.	A	G	34	14	48	0	2	50	0	0
14	36351148	.	C	T	32	16	48	0	2	50	0	0
14	36351209	.	G	A	30	23	53	0	0	53	0	0
14	36351217	.	A	G	27	23	50	0	2	52	0	0
14	36351347	.	G	A	13	29	42	0	1	43	0	0
14	36351350	.	C	T	28	12	40	0	4	44	0	0
14	36352148	.	T	C	12	1	13	0	22	35	0	0
14	36352265	.	G	A	24	29	53	0	2	55	0	0
14	36363689	.	G	A	9	7	16	0	1	17	0	0
14	36394359	.	C	T	2	1	3	0	0	3	0	0
14	36428910	.	A	T	1	4	5	0	0	5	0	0
14	36430603	.	G	T	8	8	16	0	0	16	0	0
14	36433568	.	T	C	4	0	4	0	5	9	0	0
14	36434258	.	C	T	5	3	8	0	0	8	0	0
14	36717422	.	T	C	2	2	4	0	0	4	0	0
14	36717629	.	T	C	2	2	4	0	0	4	0	0
14	36718265	.	C	T	1	2	3	0	0	3	0	0
14	36720770	.	C	T	3	6	9	0	1	10	0	0
14	36720985	.	A	G	6	4	10	0	0	10	0	0
14	36721033	.	A	G	2	0	2	0	4	6	0	0
14	36721102	.	T	A	5	2	7	0	0	7	0	0
14	36721153	.	G	A	5	3	8	0	0	8	0	0
14	36721175	.	C	G	4	3	7	0	0	7	0	0
14	36721379	.	G	C	6	4	10	0	0	10	0	0
14	36721437	.	G	A	0	3	3	0	8	11	0	0
14	36721497	.	C	G	8	4	12	0	0	12	0	0
14	36721564	.	G	A	3	3	6	0	1	7	0	0
14	36721599	.	C	A	3	2	5	0	1	6	0	0
14	36721724	.	T	A	3	2	5	0	0	5	0	0
14	36721730	.	T	A	3	2	5	0	0	5	0	0
14	36721984	.	G	C	5	3	8	0	1	9	0	0
14	36722015	.	C	T	7	4	11	0	1	12	0	0
14	36722095	.	T	C	2	5	7	0	0	7	0	0
14	36722140	.	C	A	2	4	6	0	0	6	0	0
14	36722364	.	C	T	4	6	10	0	0	10	0	0
14	36722405	.	G	A	6	7	13	0	0	13	0	0
14	36722568	.	A	T	11	6	17	0	1	19	1	0
14	36722601	.	T	G	8	0	8	0	5	13	0	0
14	36722904	.	G	A	0	3	3	0	7	10	0	0
14	36723134	.	A	T	8	9	17	0	0	17	0	0
14	36723213	.	G	A	7	6	13	0	0	13	0	0
14	36723270	.	A	G	12	0	12	0	1	13	0	0
14	36723276	.	T	C	12	3	15	0	0	15	0	0
14	36723326	.	C	T	13	7	20	0	2	22	0	0
14	36723402	.	C	G	8	8	16	0	2	18	0	0
14	36723690	.	C	G	9	12	21	0	0	21	0	0
14	36723694	.	C	A	9	12	21	0	1	22	0	0
14	36761340	.	A	C	1	0	1	0	2	3	0	0
14	36763225	.	A	G	1	2	3	0	0	3	0	0
14	36765662	.	G	A	8	10	18	0	2	20	0	0
14	36765721	.	C	T	13	17	30	0	4	34	0	0
14	36766273	.	A	T	9	12	21	0	1	22	0	0
14	36766394	.	A	C	11	4	15	0	1	16	0	0
14	36777121	.	A	G	6	6	12	0	1	13	0	0
14	38668782	.	C	A	1	4	5	0	0	5	0	0
14	38668815	.	C	T	1	6	7	0	1	8	0	0
14	38670016	.	C	T	2	4	6	0	0	6	0	0
14	38672310	.	A	G	2	0	2	0	3	5	0	0
14	38672521	.	G	T	2	8	10	0	3	13	0	0
14	38688794	.	A	T	7	3	10	0	0	10	0	0
14	38688829	.	G	C	5	6	11	0	1	12	0	0
14	38689174	.	G	A	4	9	13	0	2	15	0	0
14	38689332	.	A	G	5	12	17	0	0	17	0	0
14	38689409	.	A	C	7	6	13	0	0	13	0	0
14	38689428	.	G	C	6	9	15	0	0	15	0	0
14	38689648	.	A	T	1	3	4	0	0	4	0	0
14	38763334	.	A	C	13	21	34	0	1	35	0	0
14	38763381	.	G	A	23	17	40	0	1	41	0	0
14	38763394	.	G	A	19	19	38	0	1	39	0	0
14	38783272	.	T	C	6	6	12	1	0	13	0	0
14	38802662	.	G	T	5	2	7	0	0	7	0	0
14	38802904	.	A	T	4	2	6	0	0	6	0	0
14	38802960	.	G	A	3	1	4	0	0	4	0	0
14	38802967	.	T	G	2	2	4	0	1	5	0	0
14	38806916	.	G	T	1	2	3	0	0	3	0	0
14	38812126	.	T	C	1	1	2	0	0	2	0	0
14	38812131	.	G	C	1	2	3	0	0	3	0	0
14	38845762	.	T	C	8	6	14	0	0	14	0	0
14	38845912	.	A	G	29	20	49	0	1	50	0	0
14	38846587	.	A	T	33	23	56	0	3	59	0	0
14	38847235	.	A	G	21	11	32	0	6	38	0	0
14	38849729	.	C	T	16	21	37	0	2	39	0	0
14	38849946	.	A	C	22	21	43	0	4	47	0	0
14	38853381	.	C	G	6	4	10	0	0	10	0	0
14	38853397	.	A	G	5	7	12	0	0	12	0	0
14	38853821	.	C	T	3	3	6	0	0	6	0	0
14	38862589	.	A	G	5	6	11	0	0	11	0	0
14	38862598	.	A	G	6	5	11	0	0	11	0	0
14	38872454	.	T	C	1	2	3	0	0	3	0	0
14	38878552	.	T	C	6	7	13	0	0	13	0	0
14	38881363	.	G	A	0	4	4	0	4	8	0	0
14	38937085	.	T	C	2	0	2	0	2	4	0	0
14	38937099	.	T	C	2	2	4	0	0	4	0	0
14	38937305	.	C	T	1	1	2	0	1	3	0	0
14	38941498	.	A	G	3	2	5	0	0	5	0	0
14	39002205	.	A	T	2	2	4	0	0	4	0	0
14	39002433	.	G	C	7	6	13	0	1	14	0	0
14	39002555	.	C	T	3	2	5	0	0	5	0	0
14	39002562	.	C	T	3	2	5	0	0	5	0	0
14	39002698	.	C	A	6	2	8	0	0	8	0	0
14	39002739	.	G	C	7	0	7	0	7	14	0	0
14	39002752	.	A	G	5	8	13	0	2	15	0	0
14	39002820	.	A	T	5	4	9	0	0	9	0	0
14	39002883	.	A	G	10	5	15	0	1	16	0	0
14	39003039	.	T	G	11	6	17	0	0	17	0	0
14	39953208	.	G	T	0	3	3	0	1	4	0	0
14	39954272	.	A	G	1	2	3	0	1	4	0	0
14	39954356	.	T	C	1	4	5	0	0	5	0	0
14	39954716	.	A	G	2	2	4	0	0	4	0	0
14	39954963	.	C	T	1	3	4	0	0	4	0	0
14	39955448	.	C	T	4	4	8	0	0	8	0	0
14	39955457	.	C	A	5	4	9	0	0	9	0	0
14	39955490	.	G	T	0	3	3	0	2	5	0	0
14	39955526	.	C	G	1	0	1	0	2	3	0	0
14	39955612	.	A	T	3	5	8	0	0	8	0	0
14	39955646	.	T	C	6	3	9	1	0	10	0	0
14	39955772	.	T	A	3	6	9	0	0	9	0	0
14	39955823	.	T	C	3	3	6	0	0	6	0	0
14	39955927	.	A	G	1	0	1	0	7	8	0	0
14	39956035	.	C	G	8	0	8	0	4	12	0	0
14	39956037	.	A	T	8	2	10	0	2	12	0	0
14	39956075	.	G	A	6	5	11	0	2	13	0	0
14	39956380	.	T	C	7	4	11	0	0	11	0	0
14	39956825	.	T	C	3	2	5	0	0	5	0	0
14	39957077	.	C	G	4	13	17	0	0	17	0	0
14	39957304	.	T	G	2	4	6	0	1	7	0	0
14	40303348	.	A	T	35	11	46	0	1	47	0	0
14	40303366	.	C	T	32	11	43	0	5	48	0	0
14	40303942	.	G	A	0	23	23	1	3	28	1	0
14	40304488	.	C	G	1	7	8	2	11	21	0	0
14	40305230	.	G	A	14	10	24	0	2	26	0	0
14	40305287	.	C	A	1	10	11	0	14	25	0	0
14	40305635	.	C	T	0	12	12	0	11	23	0	0
14	40305659	.	C	T	0	14	14	0	10	24	0	0
14	40387603	.	C	T	6	5	11	0	0	11	0	0
14	40387627	.	G	A	6	1	7	0	2	9	0	0
14	40388107	.	A	G	4	4	8	0	2	10	0	0
14	40388440	.	G	A	6	3	9	0	0	9	0	0
14	40388460	.	T	G	5	3	8	0	1	9	0	0
14	40389145	.	C	G	1	2	3	0	0	3	0	0
14	40389789	.	A	T	1	2	3	0	0	3	0	0
14	40852732	.	T	C	8	4	12	0	0	12	0	0
14	40853268	.	C	G	5	9	14	0	0	14	0	0
14	40857654	.	T	G	9	3	12	0	0	12	0	0
14	40857711	.	G	A	8	4	12	0	1	13	0	0
14	40857881	.	T	C	6	10	16	0	1	17	0	0
14	40857977	.	C	T	7	8	15	0	0	15	0	0
14	40859179	.	A	G	14	1	15	0	8	23	0	0
14	40860291	.	T	A	13	13	26	0	2	28	0	0
14	40860354	.	C	T	16	25	41	0	2	43	0	0
14	40863062	.	A	G	19	24	43	0	1	44	0	0
14	40863161	.	T	C	13	17	30	0	0	30	0	0
14	40863176	.	A	G	17	19	36	0	0	36	0	0
14	40869331	.	C	A	21	26	47	0	1	48	0	0
14	40869895	.	T	C	25	21	46	0	2	48	0	0
14	41276516	.	T	A	12	9	21	0	4	25	0	0
14	41276608	.	G	A	5	14	19	0	0	19	0	0
14	41277391	.	A	T	5	12	17	0	0	17	0	0
14	41277424	.	C	A	5	18	23	0	0	23	0	0
14	41277556	.	A	G	30	25	55	0	2	57	0	0
14	41277624	.	A	T	23	26	49	0	3	52	0	0
14	41278238	.	T	A	19	14	33	1	1	35	0	0
14	41278255	.	A	G	10	18	28	1	1	30	0	0
14	41278658	.	T	G	6	6	12	0	0	12	0	0
14	41278754	.	C	G	5	3	8	0	1	9	0	0
14	41279133	.	C	T	16	10	26	1	2	29	0	0
14	41279214	.	C	T	10	13	23	5	2	30	0	0
14	41279277	.	G	C	20	16	36	0	1	37	0	0
14	41279527	.	C	T	1	6	7	0	6	13	0	0
14	41279542	.	C	A	1	7	8	1	7	16	0	0
14	41279974	.	T	G	10	9	19	0	0	19	0	0
14	41279977	.	G	T	11	9	20	0	0	20	0	0
14	41280013	.	G	A	13	7	20	0	0	20	0	0
14	41280149	.	G	A	13	17	30	0	1	31	0	0
14	41280228	.	A	G	18	14	32	0	1	33	0	0
14	41280517	.	G	C	6	7	13	0	0	13	0	0
14	41339309	.	T	C	1	2	3	0	0	3	0	0
14	41339972	.	G	A	0	2	2	0	3	5	0	0
14	41340172	.	A	C	7	3	10	0	0	10	0	0
14	41340231	.	G	A	7	5	12	0	2	14	0	0
14	41340284	.	C	T	2	4	6	0	0	6	0	0
14	41361985	.	C	T	1	10	11	0	20	32	1	0
14	41362007	.	G	A	23	16	39	0	1	40	0	0
14	41362060	.	C	T	20	10	30	0	1	31	0	0
14	41366823	.	G	A	24	16	40	0	0	40	0	0
14	41366889	.	C	A	14	6	20	0	3	23	0	0
14	41385823	.	G	A	6	9	15	0	0	15	0	0
14	41385895	.	C	T	0	4	4	0	11	15	0	0
14	41388120	.	G	A	2	6	8	0	0	8	0	0
14	41388136	.	C	T	1	3	4	0	0	4	0	0
14	41428500	.	C	T	3	3	6	0	1	7	0	0
14	41435662	.	C	T	2	2	4	0	0	4	0	0
14	41436943	.	C	T	7	6	13	0	1	14	0	0
14	41438005	.	G	A	6	6	12	0	0	12	0	0
14	41466483	.	T	A	0	4	4	0	2	6	0	0
14	41466522	.	G	A	7	8	15	0	1	16	0	0
14	41466922	.	T	A	14	14	28	0	1	29	0	0
14	41467152	.	T	C	9	19	28	0	0	28	0	0
14	41467155	.	C	T	19	9	28	0	1	29	0	0
14	41467356	.	C	G	12	9	21	1	0	22	0	0
14	41469575	.	T	A	3	5	8	0	0	8	0	0
14	41469662	.	C	A	6	4	10	0	0	10	0	0
14	41469761	.	G	T	4	5	9	0	0	9	0	0
14	41469827	.	T	C	3	5	8	0	0	8	0	0
14	41469829	.	T	C	3	5	8	0	0	8	0	0
14	41469925	.	T	A	5	3	8	0	1	9	0	0
14	41469935	.	C	T	3	4	7	0	1	8	0	0
14	41470032	.	C	T	0	11	11	0	5	16	0	0
14	41470037	.	A	T	4	11	15	0	1	16	0	0
14	41514915	.	C	T	1	3	4	0	0	4	0	0
14	41601423	.	G	C	0	2	2	0	1	3	0	0
14	45294104	.	A	G	3	0	3	0	3	6	0	0
14	45314979	.	G	A	2	2	4	0	0	4	0	0
14	45327791	.	G	A	0	4	4	0	3	7	0	0
14	45327811	.	C	A	4	4	8	0	0	8	0	0
14	45327826	.	C	T	4	4	8	0	0	8	0	0
14	45332635	.	T	C	7	6	13	0	0	13	0	0
14	45334843	.	T	A	6	3	9	0	0	9	0	0
14	45334912	.	T	G	14	5	19	0	1	20	0	0
14	45335027	.	C	T	13	6	19	0	0	19	0	0
14	45335175	.	G	A	16	14	30	0	3	33	0	0
14	45335283	.	A	G	19	13	32	0	1	33	0	0
14	45340258	.	A	T	22	21	43	0	2	45	0	0
14	45340358	.	G	A	15	11	26	0	5	31	0	0
14	45340620	.	G	C	12	1	13	0	12	25	0	0
14	45340758	.	C	G	18	6	24	2	1	27	0	0
14	45340916	.	C	T	18	13	31	0	2	33	0	0
14	45340988	.	C	T	18	13	31	0	4	35	0	0
14	45341011	.	G	T	16	13	29	0	2	31	0	0
14	45341061	.	T	C	10	13	23	0	1	24	0	0
14	45341107	.	T	C	7	12	19	0	0	19	0	0
14	45341115	.	G	A	7	12	19	0	1	20	0	0
14	45341288	.	A	C	8	1	9	0	10	19	0	0
14	45341442	.	A	C	9	9	18	0	0	18	0	0
14	45341645	.	T	C	9	7	16	0	1	17	0	0
14	45341762	.	T	C	8	12	20	0	10	30	0	0
14	45341949	.	G	T	3	10	13	0	2	15	0	0
14	45341958	.	T	G	4	10	14	0	0	14	0	0
14	45342250	.	A	C	12	4	16	0	0	16	0	0
14	45342266	.	A	T	9	5	14	0	0	14	0	0
14	45342385	.	C	T	9	8	17	0	1	18	0	0
14	45342431	.	G	T	7	5	12	0	2	14	0	0
14	45342981	.	G	T	4	6	10	0	0	10	0	0
14	45343370	.	G	A	7	4	11	0	0	11	0	0
14	45343400	.	C	G	0	5	5	0	8	13	0	0
14	45343409	.	C	T	5	8	13	0	1	14	0	0
14	45346148	.	A	G	2	3	5	0	0	5	0	0
14	45346465	.	A	T	2	6	8	0	0	8	0	0
14	45354287	.	G	A	1	2	3	0	0	3	0	0
14	45363645	.	G	C	4	2	6	0	0	6	0	0
14	45365573	.	G	C	14	0	14	0	18	32	0	0
14	45365684	.	G	A	14	11	25	0	0	25	0	0
14	45367757	.	A	G	4	2	6	0	0	6	0	0
14	45422577	.	A	T	3	4	7	0	0	7	0	0
14	45422666	.	C	T	1	2	3	0	0	3	0	0
14	45435579	.	G	C	3	0	3	0	3	6	0	0
14	45435592	.	T	C	6	2	8	0	0	8	0	0
14	45435731	.	G	A	7	2	9	0	0	9	0	0
14	45435822	.	C	A	2	4	6	0	0	6	0	0
14	45435832	.	T	A	4	4	8	0	0	8	0	0
14	45472337	.	T	C	12	5	17	0	1	18	0	0
14	45482108	.	A	G	15	0	15	0	6	21	0	0
14	45514993	.	G	C	6	7	13	0	0	13	0	0
14	45515048	.	G	A	6	6	12	0	0	12	0	0
14	45515059	.	C	T	5	8	13	0	1	14	0	0
14	45515255	.	A	T	15	20	35	0	3	38	0	0
14	45542357	.	T	A	2	2	4	0	0	4	0	0
14	45568736	.	G	T	4	4	8	0	0	8	0	0
14	45570967	.	G	A	7	15	22	0	2	24	0	0
14	45571124	.	A	T	8	6	14	0	0	14	0	0
14	45571501	.	G	A	5	17	22	0	0	22	0	0
14	45571593	.	C	T	14	9	23	1	0	24	0	0
14	45571679	.	T	C	7	7	14	0	1	15	0	0
14	45575139	.	G	A	10	14	24	0	0	24	0	0
14	45575203	.	C	A	15	12	27	0	1	28	0	0
14	45575214	.	T	C	20	0	20	0	14	34	0	0
14	45575336	.	A	G	19	6	25	0	0	25	0	0
14	45575495	.	T	C	12	11	23	0	3	26	0	0
14	45581382	.	T	C	15	8	23	0	1	24	0	0
14	45582312	.	C	A	2	7	9	0	9	18	0	0
14	45582314	.	T	A	8	7	15	0	2	17	0	0
14	45584078	.	T	C	4	0	4	0	4	8	0	0
14	45584312	.	T	C	4	3	7	0	0	7	0	0
14	45586237	.	G	A	4	2	6	0	1	7	0	0
14	45590653	.	T	A	1	2	3	0	1	4	0	0
14	45592634	.	T	C	5	3	8	0	0	8	0	0
14	45596878	.	A	G	3	2	5	0	0	5	0	0
14	45603951	.	T	C	13	0	13	0	7	20	0	0
14	45603976	.	G	A	12	7	19	0	0	19	0	0
14	45604392	.	C	T	1	7	8	0	12	20	0	0
14	45608886	.	A	G	10	7	17	0	3	20	0	0
14	45614526	.	C	G	7	0	7	0	6	13	0	0
14	45614795	.	A	G	2	0	2	0	2	4	0	0
14	45631345	.	C	T	1	9	10	0	2	12	0	0
14	45631716	.	C	T	5	14	19	0	1	20	0	0
14	45631768	.	G	T	11	18	29	0	0	29	0	0
14	45632834	.	A	C	27	35	62	0	3	66	1	0
14	45632967	.	T	C	22	4	26	0	31	57	0	0
14	45634860	.	A	T	40	43	83	0	2	85	0	0
14	45634960	.	C	T	21	26	47	3	26	76	0	0
14	45635333	.	C	T	12	51	63	0	32	95	0	0
14	45635767	.	T	C	39	52	91	1	7	99	0	0
14	45636078	.	A	G	24	1	25	1	3	29	0	0
14	45636701	.	G	A	40	14	54	0	1	55	0	0
14	45636716	.	T	A	48	7	55	0	1	57	1	0
14	45636800	.	A	G	45	11	56	2	12	70	0	0
14	45636844	.	A	T	27	42	69	0	1	70	0	0
14	45637058	.	C	G	16	16	32	0	9	41	0	0
14	45637103	.	A	C	13	0	13	0	29	42	0	0
14	45637150	.	A	C	44	7	51	0	2	53	0	0
14	45637151	.	A	T	41	7	48	0	5	53	0	0
14	45637200	.	C	T	32	36	68	0	2	70	0	0
14	45637201	.	T	A	30	36	66	0	3	69	0	0
14	45637382	.	A	G	25	25	50	0	1	51	0	0
14	45637545	.	T	G	12	19	31	0	8	39	0	0
14	45637702	.	C	T	27	15	42	1	4	48	1	0
14	45637804	.	G	T	31	19	50	14	4	68	0	0
14	45638280	.	G	C	17	29	46	0	3	49	0	0
14	45638509	.	C	T	11	17	28	0	0	28	0	0
14	45638562	.	T	G	19	16	35	0	0	35	0	0
14	45638563	.	T	A	18	16	34	0	1	35	0	0
14	45929280	.	C	T	2	2	4	0	0	4	0	0
14	45929837	.	T	A	4	2	6	0	0	6	0	0
14	45929974	.	T	C	1	3	4	0	0	4	0	0
14	45930135	.	T	C	4	3	7	0	1	8	0	0
14	45930196	.	A	C	2	3	5	0	0	5	0	0
14	45930399	.	C	T	3	4	7	0	0	7	0	0
14	45930515	.	G	A	1	4	5	0	0	5	0	0
14	45930572	.	A	G	3	3	6	0	0	6	0	0
14	45930573	.	T	G	4	3	7	0	0	7	0	0
14	45930669	.	A	G	3	2	5	0	1	7	1	0
14	45930690	.	A	G	5	6	11	0	0	11	0	0
14	45930794	.	G	A	4	7	11	0	0	11	0	0
14	45931079	.	C	G	7	5	12	0	0	12	0	0
14	45931194	.	G	T	9	4	13	0	0	13	0	0
14	45931504	.	C	G	9	8	17	0	0	17	0	0
14	45931637	.	C	T	9	11	20	0	0	20	0	0
14	45931899	.	C	T	14	14	28	0	0	28	0	0
14	45932128	.	T	G	8	5	13	0	3	16	0	0
14	46007306	.	A	G	2	3	5	0	0	5	0	0
14	46007321	.	G	A	2	2	4	0	0	4	0	0
14	46009611	.	G	A	1	1	2	0	1	3	0	0
14	46010711	.	C	T	5	7	12	0	0	12	0	0
14	46010909	.	T	C	3	5	8	0	0	8	0	0
14	46012960	.	T	C	4	6	10	0	1	11	0	0
14	46013121	.	A	T	3	3	6	0	0	6	0	0
14	46013402	.	C	T	13	8	21	0	0	21	0	0
14	46015888	.	C	A	13	12	25	0	0	25	0	0
14	46016107	.	A	G	11	18	29	0	1	30	0	0
14	46017969	.	G	A	13	14	27	0	0	27	0	0
14	46018029	.	C	T	18	11	29	0	0	29	0	0
14	46041763	.	T	G	2	2	4	0	1	5	0	0
14	46041800	.	C	T	5	4	9	0	0	9	0	0
14	46041861	.	A	T	6	5	11	0	1	12	0	0
14	46042005	.	T	C	3	2	5	0	0	5	0	0
14	46048396	.	A	G	3	6	9	1	3	13	0	0
14	46048644	.	C	T	0	12	12	0	10	22	0	0
14	46048704	.	C	G	0	9	9	0	8	17	0	0
14	46048875	.	T	C	11	11	22	0	3	25	0	0
14	46052172	.	T	A	6	9	15	0	0	15	0	0
14	46052244	.	G	T	4	6	10	0	0	10	0	0
14	46067317	.	A	T	6	2	8	0	0	8	0	0
14	46074433	.	C	T	10	6	16	0	2	18	0	0
14	46074473	.	T	A	11	4	15	0	1	16	0	0
14	46074489	.	A	G	8	4	12	0	2	14	0	0
14	46076858	.	T	C	2	2	4	0	0	4	0	0
14	46077876	.	C	A	0	2	2	0	1	3	0	0
14	46077882	.	T	A	1	2	3	0	0	3	0	0
14	46088595	.	T	A	2	6	8	0	0	8	0	0
14	46088921	.	A	G	9	3	12	0	1	13	0	0
14	46089297	.	A	C	3	2	5	0	0	5	0	0
14	46089433	.	T	G	4	6	10	0	0	10	0	0
14	46089508	.	T	C	5	2	7	0	0	7	0	0
14	46090027	.	T	C	2	0	2	0	3	5	0	0
14	46090508	.	T	A	2	2	4	0	0	4	0	0
14	46094922	.	C	T	11	6	17	0	2	19	0	0
14	46095043	.	A	G	24	19	43	0	2	45	0	0
14	46095058	.	A	G	26	15	41	0	5	46	0	0
14	46095108	.	A	G	30	25	55	0	0	55	0	0
14	46104150	.	C	T	24	16	40	0	4	44	0	0
14	46104222	.	C	T	2	20	22	0	21	43	0	0
14	46104935	.	G	A	23	19	42	0	1	43	0	0
14	46113296	.	T	G	17	16	33	0	1	34	0	0
14	46113309	.	C	G	0	13	13	0	15	28	0	0
14	46114929	.	G	A	19	8	27	0	0	27	0	0
14	46116576	.	A	G	22	14	36	0	3	39	0	0
14	46129955	.	C	A	5	4	9	0	0	9	0	0
14	46133652	.	T	C	3	2	5	0	0	5	0	0
14	46133662	.	T	C	4	2	6	0	0	6	0	0
14	46134040	.	A	G	2	0	2	0	2	4	0	0
14	46140812	.	C	A	1	2	3	0	2	5	0	0
14	46146715	.	G	A	2	4	6	0	1	7	0	0
14	46146730	.	G	A	2	5	7	0	0	7	0	0
14	46154358	.	C	A	12	13	25	0	1	26	0	0
14	46154713	.	A	G	11	7	18	0	1	19	0	0
14	46154899	.	A	C	10	6	16	0	6	22	0	0
14	46154966	.	T	A	8	3	11	0	2	13	0	0
14	46154969	.	T	A	8	3	11	0	2	13	0	0
14	46183902	.	C	A	2	2	4	1	0	5	0	0
14	46184458	.	A	T	1	2	3	0	0	3	0	0
14	46185546	.	A	T	3	2	5	0	0	5	0	0
14	46185575	.	A	T	3	5	8	0	0	8	0	0
14	46186746	.	G	A	0	2	2	0	1	3	0	0
14	46186827	.	A	G	6	0	6	0	8	14	0	0
14	46187338	.	A	G	4	0	4	0	1	5	0	0
14	46187603	.	C	A	1	2	3	0	0	3	0	0
14	46187730	.	G	A	3	2	5	0	1	6	0	0
14	46187855	.	G	A	5	2	7	0	1	8	0	0
14	46187879	.	C	T	3	4	7	0	0	7	0	0
14	46188114	.	C	T	5	7	12	0	1	13	0	0
14	46188578	.	C	T	6	7	13	0	1	14	0	0
14	46188601	.	C	T	6	9	15	0	0	15	0	0
14	46188620	.	A	G	8	1	9	0	9	18	0	0
14	46188688	.	C	T	9	10	19	0	1	20	0	0
14	46188770	.	C	T	17	13	30	0	2	32	0	0
14	46188920	.	C	T	4	2	6	0	0	6	0	0
14	46189512	.	T	C	8	4	12	0	0	12	0	0
14	46200128	.	G	A	19	10	29	0	0	29	0	0
14	46200244	.	A	C	14	9	23	0	1	24	0	0
14	46206075	.	T	C	4	0	4	0	8	12	0	0
14	46206112	.	G	T	4	8	12	0	0	12	0	0
14	46208725	.	T	C	11	13	24	0	2	26	0	0
14	46213473	.	G	T	2	3	5	0	0	5	0	0
14	46219586	.	G	A	1	3	4	0	1	5	0	0
14	46297049	.	A	G	6	3	9	0	1	10	0	0
14	46300696	.	A	G	4	0	4	0	4	8	0	0
14	46346893	.	C	T	3	2	5	0	0	5	0	0
14	46350249	.	T	C	5	6	11	0	1	12	0	0
14	46352097	.	T	A	11	13	24	0	1	25	0	0
14	46352433	.	T	C	9	16	25	0	0	25	0	0
14	46352475	.	A	T	12	18	30	0	1	31	0	0
14	46352736	.	T	A	4	6	10	0	2	12	0	0
14	46358032	.	T	A	1	2	3	0	2	5	0	0
14	46377128	.	G	A	4	3	7	0	0	7	0	0
14	46377461	.	T	C	3	6	9	0	0	9	0	0
14	46382221	.	T	C	4	3	7	0	0	7	0	0
14	46385928	.	T	C	3	0	3	0	2	5	0	0
14	46386796	.	A	C	1	3	4	0	0	4	0	0
14	46388187	.	G	T	1	2	3	0	0	3	0	0
14	46441848	.	G	A	3	2	5	0	0	5	0	0
14	46441899	.	G	A	4	3	7	0	1	8	0	0
14	46456501	.	T	G	17	20	37	0	3	40	0	0
14	46456698	.	C	T	1	19	20	0	14	34	0	0
14	46456989	.	C	T	13	12	25	0	2	27	0	0
14	46457110	.	A	C	6	4	10	0	1	11	0	0
14	46457195	.	T	G	4	4	8	0	0	8	0	0
14	46457198	.	A	G	3	5	8	0	0	8	0	0
14	46457242	.	T	A	1	3	4	0	0	4	0	0
14	46457501	.	C	T	10	4	14	0	1	15	0	0
14	46457684	.	A	G	3	3	6	0	0	6	0	0
14	46457893	.	T	C	4	2	6	0	0	6	0	0
14	46459269	.	G	A	2	2	4	0	1	5	0	0
14	46462070	.	A	T	5	2	7	0	0	7	0	0
14	46630139	.	T	C	4	6	10	0	1	11	0	0
14	46630227	.	C	G	5	3	8	0	2	10	0	0
14	46630316	.	A	T	3	3	6	0	0	6	0	0
14	46630797	.	C	T	1	2	3	0	4	7	0	0
14	46634234	.	T	C	1	0	1	0	4	5	0	0
14	46634243	.	T	C	2	0	2	0	3	5	0	0
14	46634269	.	T	C	3	6	9	0	0	9	0	0
14	46636310	.	G	A	5	7	12	0	2	14	0	0
14	46678919	.	A	G	3	7	10	0	0	10	0	0
14	46679197	.	T	A	4	2	6	0	2	8	0	0
14	46679259	.	A	G	7	2	9	0	1	10	0	0
14	46679263	.	C	T	7	3	10	0	0	10	0	0
14	46679421	.	T	C	11	4	15	0	0	15	0	0
14	46679902	.	A	C	16	4	20	3	0	23	0	0
14	46679912	.	G	A	17	4	21	2	0	23	0	0
14	46679999	.	A	G	12	7	19	0	0	19	0	0
14	46680043	.	T	C	8	3	11	1	0	12	0	0
14	46680170	.	T	C	5	5	10	0	0	10	0	0
14	46680176	.	C	G	6	3	9	0	1	10	0	0
14	46680210	.	G	T	10	3	13	0	2	15	0	0
14	46680639	.	A	C	2	0	2	2	2	6	0	0
14	46680694	.	A	T	3	3	6	0	0	6	0	0
14	46681005	.	A	C	6	3	9	0	0	9	0	0
14	46681020	.	T	A	5	4	9	0	0	9	0	0
14	46681316	.	A	T	3	3	6	0	0	6	0	0
14	46682295	.	G	A	2	3	5	0	0	5	0	0
14	46682303	.	C	T	1	3	4	0	0	4	0	0
14	46684294	.	T	C	1	0	1	0	2	3	0	0
14	46684726	.	T	G	1	2	3	0	0	3	0	0
14	47003696	.	G	T	22	14	36	0	3	39	0	0
14	47003908	.	C	T	0	27	27	0	12	39	0	0
14	47003958	.	T	A	15	20	35	0	3	38	0	0
14	47004674	.	G	A	6	7	13	0	1	14	0	0
14	47004734	.	G	A	9	5	14	0	0	14	0	0
14	47027767	.	G	A	4	6	10	1	0	11	0	0
14	47783338	.	T	G	9	15	24	0	0	24	0	0
14	47783460	.	C	T	15	8	23	0	1	24	0	0
14	47784169	.	G	T	16	17	33	0	1	34	0	0
14	47784462	.	T	G	19	10	29	0	1	30	0	0
14	47784476	.	T	G	17	9	26	0	4	30	0	0
14	47790112	.	C	T	3	15	18	0	15	33	0	0
14	47790121	.	T	C	14	0	14	0	19	33	0	0
14	47795018	.	C	A	14	13	27	0	0	27	0	0
14	47795171	.	G	A	11	9	20	0	2	22	0	0
14	47797490	.	T	C	6	11	17	0	0	17	0	0
14	47797496	.	G	A	6	11	17	0	0	17	0	0
14	47818932	.	T	C	3	0	3	0	2	5	0	0
14	47818935	.	A	G	3	2	5	0	0	5	0	0
14	47819244	.	C	T	3	2	5	0	0	5	0	0
14	47819416	.	T	G	5	2	7	0	0	7	0	0
14	47819471	.	G	A	2	4	6	0	0	6	0	0
14	47822159	.	T	C	2	0	2	0	4	6	0	0
14	47823110	.	A	G	2	2	4	0	0	4	0	0
14	47832307	.	A	G	1	4	5	0	0	5	0	0
14	47832319	.	G	A	1	4	5	0	0	5	0	0
14	48767585	.	G	C	2	4	6	0	0	6	0	0
14	48767628	.	G	A	6	2	8	0	0	8	0	0
14	48773479	.	A	G	1	4	5	0	0	5	0	0
14	48775635	.	G	T	1	3	4	0	0	4	0	0
14	48775674	.	G	T	2	3	5	0	0	5	0	0
14	48775680	.	G	A	2	1	3	0	0	3	0	0
14	48779827	.	T	C	1	3	4	0	0	4	0	0
14	48932470	.	T	A	30	17	47	0	3	50	0	0
14	48932712	.	G	A	11	15	26	0	3	29	0	0
14	48932880	.	A	T	24	16	40	0	5	45	0	0
14	48932970	.	T	A	13	21	34	0	5	39	0	0
14	48933224	.	A	G	29	13	42	0	2	44	0	0
14	48933273	.	C	A	25	16	41	2	2	45	0	0
14	48933361	.	T	A	26	7	33	1	1	35	0	0
14	48933513	.	T	C	11	10	21	0	0	21	0	0
14	48933772	.	G	A	4	3	7	3	0	10	0	0
14	48934025	.	G	A	23	13	36	0	3	39	0	0
14	48934052	.	G	A	18	14	32	0	1	33	0	0
14	48934253	.	G	A	13	5	18	0	0	18	0	0
14	48934276	.	G	A	12	3	15	0	0	15	0	0
14	48934299	.	C	A	11	2	13	0	2	15	0	0
14	48934547	.	A	T	17	8	25	0	0	25	0	0
14	48934577	.	G	T	16	13	29	0	1	30	0	0
14	48934630	.	C	G	19	7	26	0	0	26	0	0
14	48934701	.	T	C	13	14	27	0	4	31	0	0
14	48934719	.	T	G	19	14	33	0	1	34	0	0
14	48934829	.	T	A	11	18	29	0	3	32	0	0
14	48964697	.	T	C	8	11	19	0	0	19	0	0
14	48995894	.	C	A	3	2	5	0	0	5	0	0
14	48997367	.	G	A	2	6	8	0	1	9	0	0
14	48998026	.	A	C	5	7	12	0	1	13	0	0
14	49022002	.	C	T	2	2	4	0	0	4	0	0
14	49022191	.	G	T	1	4	5	0	2	7	0	0
14	49022290	.	G	T	0	5	5	0	3	8	0	0
14	49028593	.	T	C	1	9	10	0	0	10	0	0
14	49029025	.	C	T	1	4	5	0	0	5	0	0
14	49029026	.	A	G	1	4	5	0	0	5	0	0
14	49030064	.	A	G	5	2	7	0	0	7	0	0
14	49031214	.	T	G	5	4	9	0	0	10	1	0
14	49031569	.	A	G	9	13	22	0	0	22	0	0
14	49031848	.	A	G	1	2	3	0	2	5	0	0
14	49040574	.	G	A	4	5	9	0	0	9	0	0
14	49047525	.	T	G	13	9	22	0	0	22	0	0
14	49050397	.	T	G	8	7	15	0	0	15	0	0
14	49053391	.	G	A	2	7	9	0	1	10	0	0
14	49053402	.	C	G	1	6	7	0	0	7	0	0
14	49054446	.	T	C	3	0	3	0	5	8	0	0
14	49054449	.	G	A	3	4	7	0	0	7	0	0
14	49119048	.	G	T	10	12	22	0	3	25	0	0
14	49119062	.	G	A	14	17	31	0	1	32	0	0
14	49119192	.	T	A	19	17	36	1	0	37	0	0
14	49119218	.	C	A	14	19	33	1	1	35	0	0
14	49119321	.	A	C	16	10	26	0	4	31	1	0
14	49119484	.	T	A	11	9	20	0	1	21	0	0
14	49126924	.	G	A	1	3	4	0	0	4	0	0
14	49136065	.	G	A	1	6	7	0	5	12	0	0
14	49136245	.	G	A	2	9	11	0	7	18	0	0
14	49136483	.	C	T	16	12	28	0	1	29	0	0
14	49136551	.	T	G	8	0	8	0	4	12	0	0
14	49136838	.	A	T	8	6	14	0	0	14	0	0
14	49136909	.	C	T	4	5	9	2	1	12	0	0
14	49206876	.	G	C	1	3	4	0	0	4	0	0
14	49206879	.	C	T	1	3	4	0	0	4	0	0
14	49209983	.	C	T	3	2	5	0	0	5	0	0
14	49210349	.	G	A	1	4	5	0	0	5	0	0
14	49210955	.	A	G	3	3	6	0	0	6	0	0
14	49211001	.	A	G	2	3	5	0	0	5	0	0
14	49211045	.	T	C	4	3	7	0	1	8	0	0
14	49211352	.	T	A	1	2	3	0	0	3	0	0
14	49212350	.	C	T	3	7	10	0	0	10	0	0
14	49212395	.	T	C	2	2	4	0	0	4	0	0
14	49212547	.	A	G	2	0	2	0	3	5	0	0
14	49212550	.	A	G	1	3	4	0	0	4	0	0
14	49212838	.	C	T	2	3	5	0	0	5	0	0
14	49212867	.	A	C	2	3	5	0	0	5	0	0
14	49213140	.	T	G	6	7	13	0	1	14	0	0
14	49213178	.	C	T	10	3	13	0	0	13	0	0
14	49213250	.	C	T	3	8	11	0	0	11	0	0
14	49213315	.	C	A	2	2	4	0	1	5	0	0
14	49213770	.	G	A	7	7	14	0	0	14	0	0
14	49213836	.	G	A	14	2	16	0	0	16	0	0
14	49213913	.	C	T	3	6	9	0	0	9	0	0
14	49214087	.	G	A	5	3	8	0	1	9	0	0
14	49214158	.	G	A	6	7	13	0	0	13	0	0
14	49214168	.	T	C	7	7	14	0	0	14	0	0
14	49214347	.	T	G	4	0	4	0	6	10	0	0
14	49214392	.	G	A	3	6	9	0	3	12	0	0
14	49231804	.	A	G	1	3	4	0	0	4	0	0
14	49231813	.	C	T	2	2	4	0	0	4	0	0
14	49236476	.	A	G	3	3	6	0	1	7	0	0
14	49237917	.	A	G	6	4	10	0	0	10	0	0
14	49244425	.	A	G	15	0	15	0	12	27	0	0
14	49244728	.	A	G	10	13	23	0	0	23	0	0
14	49244740	.	A	T	13	7	20	0	2	22	0	0
14	49245190	.	C	G	11	12	23	0	0	23	0	0
14	49430817	.	A	G	9	13	22	0	0	22	0	0
14	49430844	.	A	G	18	5	23	0	3	26	0	0
14	49488971	.	C	A	27	7	34	4	7	45	0	0
14	49865132	.	A	C	4	5	9	0	0	9	0	0
14	49865367	.	T	A	17	6	23	0	3	26	0	0
14	49865508	.	G	A	15	13	28	0	0	28	0	0
14	49865563	.	C	T	8	8	16	0	1	17	0	0
14	49865747	.	C	T	0	12	12	0	19	31	0	0
14	49878814	.	T	C	12	0	12	0	5	17	0	0
14	49943137	.	G	A	4	4	8	0	0	8	0	0
14	49943171	.	G	T	4	6	10	0	0	10	0	0
14	49943185	.	T	A	3	8	11	0	1	12	0	0
14	49947717	.	T	C	9	5	14	0	1	15	0	0
14	49947724	.	C	T	9	6	15	0	0	15	0	0
14	49947765	.	C	T	13	7	20	0	0	20	0	0
14	49947806	.	G	A	4	9	13	0	0	13	0	0
14	49947846	.	G	A	4	9	13	0	0	13	0	0
14	49947868	.	T	C	4	0	4	0	9	13	0	0
14	49948196	.	G	T	9	3	12	0	1	13	0	0
14	49948217	.	A	G	7	5	12	0	0	12	0	0
14	49948589	.	G	A	8	6	14	0	1	15	0	0
14	49952434	.	C	A	0	4	4	0	5	9	0	0
14	49952515	.	A	G	3	7	10	0	0	10	0	0
14	49952554	.	A	G	5	7	12	0	0	12	0	0
14	49952819	.	G	A	7	3	10	0	0	10	0	0
14	49962203	.	C	T	3	3	6	0	0	6	0	0
14	49996714	.	T	A	1	2	3	0	0	3	0	0
14	49996841	.	T	C	4	0	4	0	4	8	0	0
14	49996893	.	C	T	3	4	7	0	0	7	0	0
14	49997115	.	G	A	4	5	9	0	0	9	0	0
14	49997246	.	A	G	5	3	8	0	0	8	0	0
14	49997276	.	G	A	7	5	12	0	0	12	0	0
14	50798988	.	C	T	37	37	74	0	3	77	0	0
14	50962369	.	T	C	1	2	3	0	0	3	0	0
14	50973374	.	C	A	1	2	3	0	0	3	0	0
14	50994361	.	A	G	10	12	22	0	1	23	0	0
14	50994436	.	C	G	8	4	12	0	0	12	0	0
14	50994687	.	G	T	17	16	33	0	4	37	0	0
14	50994695	.	G	C	17	21	38	0	1	39	0	0
14	50999698	.	A	G	6	7	13	0	0	13	0	0
14	51002874	.	G	C	11	1	12	0	15	27	0	0
14	51012349	.	C	T	1	2	3	0	0	3	0	0
14	51014221	.	T	G	3	4	7	0	0	7	0	0
14	51015245	.	C	T	3	10	13	0	0	13	0	0
14	51015264	.	A	G	5	11	16	0	3	19	0	0
14	51015359	.	G	C	10	8	18	0	1	19	0	0
14	51017771	.	G	A	1	13	14	1	15	30	0	0
14	51017841	.	A	G	9	14	23	0	0	23	0	0
14	51017906	.	A	T	6	13	19	0	0	19	0	0
14	51017952	.	G	A	1	13	14	0	8	22	0	0
14	51829341	.	G	A	36	34	70	0	1	71	0	0
14	51830952	.	G	A	23	24	47	1	1	49	0	0
14	52354095	.	C	T	1	2	3	0	0	3	0	0
14	52354139	.	A	G	1	2	3	0	0	3	0	0
14	52354191	.	C	T	2	2	4	0	0	4	0	0
14	52356950	.	G	T	0	3	3	0	1	4	0	0
14	52357035	.	A	G	1	3	4	0	0	4	0	0
14	52358971	.	G	C	1	3	4	0	0	4	0	0
14	52379740	.	T	A	3	3	6	0	0	6	0	0
14	52379749	.	T	A	3	3	6	0	0	6	0	0
14	52381762	.	G	A	3	12	15	6	3	24	0	0
14	52383871	.	G	A	9	10	19	0	2	21	0	0
14	52386667	.	G	A	11	5	16	0	0	16	0	0
14	52388115	.	G	A	7	6	13	0	0	13	0	0
14	52388136	.	G	C	10	3	13	0	0	13	0	0
14	52388357	.	G	A	4	8	12	0	1	13	0	0
14	52388360	.	G	T	4	10	14	0	0	14	0	0
14	52397323	.	G	A	3	2	5	0	1	6	0	0
14	52397752	.	G	A	1	2	3	0	0	3	0	0
14	52408723	.	T	C	1	3	4	0	0	4	0	0
14	52411301	.	G	A	0	5	5	0	7	12	0	0
14	52411315	.	C	G	6	6	12	0	0	12	0	0
14	52413182	.	C	T	4	4	8	0	0	9	1	0
14	52417537	.	C	T	1	2	3	0	0	3	0	0
14	52417555	.	T	C	3	3	6	0	0	6	0	0
14	52418070	.	T	G	4	3	7	0	0	7	0	0
14	52418307	.	T	G	10	5	15	0	0	15	0	0
14	52418308	.	T	A	10	5	15	0	0	15	0	0
14	52418565	.	T	G	17	2	19	0	10	29	0	0
14	52418772	.	G	T	10	11	21	0	0	21	0	0
14	52418818	.	A	G	12	8	20	0	0	20	0	0
14	52418900	.	A	G	3	4	7	0	1	8	0	0
14	52419007	.	C	G	2	5	7	0	0	7	0	0
14	52419048	.	T	A	1	3	4	0	0	4	0	0
14	52476624	.	T	C	2	3	5	0	1	6	0	0
14	52490198	.	G	A	0	2	2	0	3	5	0	0
14	52517782	.	T	A	9	3	12	0	1	13	0	0
14	52517957	.	T	C	14	12	26	0	1	27	0	0
14	52518002	.	A	G	8	8	16	0	0	16	0	0
14	52518030	.	G	A	0	12	12	0	12	24	0	0
14	52518278	.	G	C	1	12	13	1	11	25	0	0
14	52522820	.	T	C	18	11	29	0	2	31	0	0
14	52522822	.	C	T	17	11	28	0	3	31	0	0
14	52522876	.	C	T	15	12	27	0	3	30	0	0
14	52523087	.	G	A	20	9	29	0	0	29	0	0
14	52523131	.	G	A	12	4	16	0	0	16	0	0
14	52523237	.	G	C	1	4	5	0	0	5	0	0
14	52523290	.	C	T	0	6	6	0	5	11	0	0
14	52523707	.	A	G	8	15	23	0	0	23	0	0
14	52524195	.	C	A	8	9	17	0	0	17	0	0
14	52524364	.	C	T	0	4	4	0	12	16	0	0
14	52524399	.	G	A	6	5	11	0	0	11	0	0
14	52524603	.	C	T	3	10	13	0	0	13	0	0
14	52524651	.	A	T	3	5	8	0	2	10	0	0
14	52524665	.	T	G	6	2	8	0	0	8	0	0
14	52524792	.	A	G	3	5	8	0	0	8	0	0
14	52525016	.	C	T	0	5	5	0	5	10	0	0
14	52525185	.	C	T	2	3	5	0	0	5	0	0
14	52525673	.	G	A	6	3	9	0	0	9	0	0
14	52525812	.	C	T	0	8	8	0	3	11	0	0
14	52531368	.	G	C	6	0	6	0	4	10	0	0
14	52531384	.	T	C	6	5	11	0	2	13	0	0
14	52533500	.	G	A	7	7	14	0	1	15	0	0
14	52533578	.	T	C	1	4	5	0	0	5	0	0
14	52533584	.	T	C	1	0	1	0	4	5	0	0
14	52565823	.	C	T	45	26	71	0	3	74	0	0
14	52574434	.	C	G	1	4	5	0	1	6	0	0
14	52574497	.	C	A	2	1	3	0	0	3	0	0
14	52575646	.	C	T	4	4	8	0	4	12	0	0
14	52575738	.	C	T	15	6	21	0	3	24	0	0
14	52575878	.	A	G	2	6	8	0	0	8	0	0
14	52575879	.	T	A	3	6	9	0	0	9	0	0
14	52575999	.	A	C	6	3	9	1	0	10	0	0
15	636867	.	A	C	1	3	4	0	0	4	0	0
15	894804	.	G	A	0	2	2	4	4	10	0	0
15	908257	.	T	C	1	3	4	4	0	8	0	0
15	909646	.	A	G	1	2	3	0	0	3	0	0
15	1026488	.	T	C	1	2	3	0	0	3	0	0
15	1033435	.	A	T	11	4	15	0	0	15	0	0
15	1033479	.	T	G	5	3	8	0	0	8	0	0
15	1033564	.	G	T	8	4	12	1	0	13	0	0
15	1033853	.	A	G	4	4	8	0	0	8	0	0
15	1033955	.	C	T	0	2	2	0	3	5	0	0
15	1036614	.	C	T	6	3	9	0	0	9	0	0
15	1173016	.	A	G	3	0	3	0	2	5	0	0
15	1173542	.	C	T	2	2	4	0	0	4	0	0
15	1176447	.	G	A	0	2	2	0	3	5	0	0
15	1178927	.	C	A	7	4	11	0	0	11	0	0
15	1181477	.	G	T	5	4	9	0	2	11	0	0
15	1181480	.	C	T	1	4	5	0	6	11	0	0
15	1183930	.	G	T	12	4	16	0	1	17	0	0
15	1184660	.	A	G	6	3	9	0	1	10	0	0
15	1186181	.	A	G	8	4	12	0	0	12	0	0
15	1186202	.	C	T	2	3	5	0	9	14	0	0
15	1191750	.	A	G	14	6	20	0	1	21	0	0
15	1191792	.	G	A	1	5	6	0	12	18	0	0
15	1191822	.	A	G	10	0	10	0	8	18	0	0
15	1194590	.	A	G	12	6	18	0	1	19	0	0
15	1194619	.	G	A	2	5	7	0	12	19	0	0
15	1194633	.	A	G	11	5	16	0	5	21	0	0
15	1194670	.	G	A	16	10	26	0	1	27	0	0
15	1194739	.	G	T	16	4	20	0	0	20	0	0
15	1749973	.	G	C	6	4	10	0	1	11	0	0
15	1749984	.	A	T	8	3	11	0	2	13	0	0
15	1753501	.	A	G	4	8	12	0	0	12	0	0
15	1758675	.	T	C	2	0	2	0	4	6	0	0
15	1766675	.	C	T	2	1	3	0	1	4	0	0
15	1774489	.	G	A	0	2	2	0	3	5	0	0
15	1777913	.	C	A	3	3	6	0	1	7	0	0
15	1782156	.	T	C	3	3	6	0	0	6	0	0
15	1828401	.	C	T	14	7	21	0	1	22	0	0
15	1830323	.	A	G	12	12	24	0	0	24	0	0
15	1847246	.	C	G	8	10	18	0	1	19	0	0
15	1847358	.	A	G	15	6	21	0	2	24	1	0
15	1847432	.	A	C	12	6	18	0	5	23	0	0
15	1847588	.	A	T	10	8	18	0	2	20	0	0
15	1847693	.	A	G	12	11	23	0	1	24	0	0
15	1847908	.	A	C	11	10	21	0	0	21	0	0
15	1848135	.	T	C	7	1	8	0	5	13	0	0
15	1848188	.	T	C	3	0	3	0	8	11	0	0
15	1848202	.	G	T	6	3	9	0	1	10	0	0
15	1848308	.	G	A	0	2	2	0	1	3	0	0
15	1848320	.	G	A	1	2	3	0	0	3	0	0
15	1853010	.	A	C	1	2	3	0	1	4	0	0
15	1853028	.	G	A	1	2	3	0	0	3	0	0
15	1858914	.	G	C	2	0	2	0	2	4	0	0
15	1893276	.	C	T	6	4	10	0	0	10	0	0
15	1893293	.	C	G	6	3	9	0	0	9	0	0
15	1893323	.	G	A	1	2	3	0	5	8	0	0
15	1893356	.	A	G	7	0	7	0	4	11	0	0
15	1894694	.	A	G	4	6	10	1	1	12	0	0
15	1895469	.	G	A	17	4	21	0	1	22	0	0
15	1895505	.	G	C	11	6	17	0	0	17	0	0
15	1897576	.	T	C	15	7	22	0	1	23	0	0
15	1899203	.	G	A	1	2	3	0	3	6	0	0
15	1899304	.	A	C	7	4	11	0	1	12	0	0
15	1899331	.	T	G	3	4	7	1	0	8	0	0
15	1899395	.	G	A	0	2	2	0	7	9	0	0
15	1899878	.	T	C	18	6	24	0	0	24	0	0
15	1902259	.	A	G	2	8	10	0	0	10	0	0
15	1905364	.	T	G	5	5	10	0	0	10	0	0
15	2182569	.	G	A	13	6	19	0	1	21	1	0
15	2182752	.	G	C	10	6	16	0	1	17	0	0
15	2182848	.	C	T	5	5	10	0	0	10	0	0
15	2413886	.	C	T	4	2	6	0	0	6	0	0
15	2413923	.	T	G	2	2	4	0	0	4	0	0
15	2414003	.	C	T	2	3	5	0	0	5	0	0
15	2414021	.	A	G	2	2	4	0	0	4	0	0
15	2414276	.	A	G	6	3	9	0	1	10	0	0
15	2414584	.	G	T	5	2	7	0	0	7	0	0
15	2414635	.	T	C	5	4	9	0	0	9	0	0
15	2414652	.	T	G	3	2	5	0	1	6	0	0
15	2415216	.	A	G	4	0	4	2	3	9	0	0
15	2415228	.	A	G	3	2	5	1	1	7	0	0
15	2415264	.	A	G	3	4	7	0	0	7	0	0
15	2458640	.	A	G	2	0	2	0	2	4	0	0
15	2458641	.	G	T	2	2	4	0	0	4	0	0
15	2485111	.	T	C	4	5	9	0	0	9	0	0
15	2507763	.	G	A	1	3	4	0	0	4	0	0
15	2515421	.	C	T	9	2	11	0	0	11	0	0
15	2529072	.	A	G	2	0	2	0	2	4	0	0
15	2533397	.	A	G	2	2	4	0	1	5	0	0
15	2533468	.	C	G	4	3	7	0	0	7	0	0
15	2534772	.	T	G	1	0	1	0	3	4	0	0
15	2539821	.	G	A	3	6	9	0	0	9	0	0
15	2543388	.	G	T	7	4	11	0	0	11	0	0
15	2543418	.	G	C	1	4	5	0	6	11	0	0
15	2543476	.	C	T	8	2	10	0	0	10	0	0
15	2543478	.	T	C	7	2	9	0	0	9	0	0
15	2543675	.	A	G	3	3	6	0	0	6	0	0
15	2578043	.	C	A	1	2	3	0	0	3	0	0
15	2590856	.	C	T	0	4	4	0	6	10	0	0
15	2591080	.	T	C	5	2	7	0	0	7	0	0
15	2593092	.	T	C	2	2	4	0	0	4	0	0
15	2655841	.	A	G	2	2	4	0	0	4	0	0
15	2655861	.	A	G	1	2	3	0	1	4	0	0
15	2727995	.	A	G	3	1	4	0	1	5	0	0
15	2728221	.	C	T	3	12	15	0	19	34	0	0
15	2728330	.	A	G	17	21	38	0	3	41	0	0
15	2728573	.	C	T	9	15	24	0	5	29	0	0
15	2728641	.	A	C	8	14	22	0	3	25	0	0
15	2728652	.	C	T	6	15	21	0	2	23	0	0
15	2728678	.	G	A	6	14	20	0	2	22	0	0
15	2728806	.	T	G	7	18	25	0	0	25	0	0
15	2728880	.	C	T	2	16	18	0	12	30	0	0
15	2729962	.	A	T	1	5	6	0	0	6	0	0
15	2729971	.	T	C	5	5	10	0	0	10	0	0
15	2730358	.	T	C	7	6	13	0	2	15	0	0
15	2730364	.	G	C	4	11	15	0	0	15	0	0
15	2730533	.	T	C	4	7	11	0	0	11	0	0
15	2730536	.	G	C	4	0	4	0	7	11	0	0
15	2730705	.	G	A	1	2	3	0	0	3	0	0
15	2730927	.	C	T	1	4	5	0	12	17	0	0
15	2739915	.	G	C	4	6	10	0	1	11	0	0
15	2744699	.	G	A	2	3	5	0	0	5	0	0
15	2851550	.	G	A	7	3	10	0	0	10	0	0
15	2851569	.	A	C	6	2	8	0	0	8	0	0
15	2851862	.	T	C	1	0	1	2	3	6	0	0
15	2855289	.	T	C	1	2	3	0	0	3	0	0
15	2855303	.	G	A	1	2	3	0	0	3	0	0
15	2855334	.	T	A	2	3	5	0	0	5	0	0
15	2857425	.	A	G	0	2	2	0	1	3	0	0
15	2875501	.	A	T	4	4	8	0	0	8	0	0
15	2876720	.	T	C	3	3	6	0	0	6	0	0
15	2876938	.	A	G	1	3	4	0	1	5	0	0
15	2988126	.	T	A	21	13	34	1	0	35	0	0
15	2988136	.	T	G	26	12	38	1	3	42	0	0
15	2988414	.	C	A	15	13	28	0	0	28	0	0
15	2988420	.	C	T	2	11	13	0	13	26	0	0
15	2989361	.	T	G	4	7	11	0	0	11	0	0
15	2994265	.	C	T	0	5	5	0	7	12	0	0
15	2994309	.	T	G	7	12	19	0	1	20	0	0
15	2995080	.	T	C	9	10	19	0	0	19	0	0
15	2999113	.	C	A	0	5	5	0	4	9	0	0
15	2999209	.	G	A	7	6	13	0	0	13	0	0
15	3000194	.	T	C	5	8	13	0	2	15	0	0
15	3000311	.	C	T	4	4	8	0	0	8	0	0
15	3000347	.	T	C	5	0	5	1	4	10	0	0
15	3000472	.	C	A	3	3	6	0	0	6	0	0
15	3003682	.	T	C	4	0	4	0	3	7	0	0
15	3005538	.	G	A	4	3	7	0	0	7	0	0
15	3005556	.	C	A	0	2	2	0	4	6	0	0
15	3005578	.	A	G	3	3	6	0	1	7	0	0
15	3011241	.	C	T	0	3	3	0	3	6	0	0
15	3020470	.	G	A	3	3	6	0	0	6	0	0
15	3020598	.	T	A	2	2	4	0	0	4	0	0
15	3024971	.	G	T	1	3	4	0	0	4	0	0
15	3027321	.	T	A	1	2	3	0	0	3	0	0
15	3376837	.	T	C	4	5	9	0	0	9	0	0
15	3376850	.	T	G	4	4	8	0	0	8	0	0
15	3377727	.	T	G	4	5	9	0	0	9	0	0
15	3378164	.	A	C	5	3	8	0	0	8	0	0
15	3378189	.	C	T	3	4	7	0	0	7	0	0
15	3456168	.	A	G	13	8	21	0	1	22	0	0
15	3456169	.	C	T	13	8	21	0	1	22	0	0
15	3456223	.	T	C	9	0	9	0	10	19	0	0
15	3456306	.	T	A	6	10	16	0	0	16	0	0
15	3456353	.	G	A	10	6	16	0	0	16	0	0
15	3477016	.	C	T	0	3	3	0	6	9	0	0
15	3534556	.	G	A	1	2	3	0	0	3	0	0
15	3534558	.	T	G	1	2	3	0	0	3	0	0
15	3675018	.	T	C	1	2	3	0	0	3	0	0
15	3685012	.	T	C	1	5	6	0	0	6	0	0
15	3686983	.	T	A	1	2	3	0	0	3	0	0
15	3734944	.	C	A	4	6	10	0	0	10	0	0
15	3734950	.	G	A	4	6	10	0	1	11	0	0
15	3735134	.	C	G	0	4	4	0	1	5	0	0
15	3735338	.	T	C	3	0	3	0	5	8	0	0
15	3921218	.	C	T	1	2	3	0	0	3	0	0
15	3922822	.	C	G	1	2	3	0	0	3	0	0
15	3922835	.	A	C	1	2	3	0	0	3	0	0
15	3924542	.	G	A	3	3	6	0	1	7	0	0
15	3924600	.	T	G	4	3	7	0	2	9	0	0
15	3924601	.	T	G	5	3	8	0	1	9	0	0
15	3927885	.	C	T	1	2	3	0	0	3	0	0
15	4104711	.	G	T	8	3	11	0	1	12	0	0
15	4105164	.	C	T	1	10	11	0	3	14	0	0
15	4105168	.	T	G	3	8	11	0	1	12	0	0
15	4105235	.	T	C	6	8	14	0	0	14	0	0
15	4111649	.	T	C	4	7	11	0	0	11	0	0
15	4112123	.	A	T	6	3	9	0	1	10	0	0
15	4112132	.	T	C	6	3	9	0	1	10	0	0
15	4119284	.	A	G	2	7	9	0	0	9	0	0
15	4119323	.	G	A	4	5	9	0	0	9	0	0
15	4119329	.	A	G	4	5	9	0	0	9	0	0
15	4353353	.	C	T	21	36	57	1	4	62	0	0
15	4353858	.	C	T	29	23	52	0	5	57	0	0
15	4354071	.	G	A	38	29	67	0	0	67	0	0
15	4354082	.	G	A	35	27	62	0	4	66	0	0
15	4367594	.	T	C	17	21	38	0	2	40	0	0
15	4376110	.	C	T	3	9	12	0	11	23	0	0
15	4422128	.	G	T	4	3	7	0	0	7	0	0
15	4422496	.	A	G	2	2	4	0	0	4	0	0
15	4422580	.	A	G	2	5	7	0	0	7	0	0
15	4585282	.	T	C	1	0	1	0	2	3	0	0
15	4585290	.	T	C	1	2	3	0	0	3	0	0
15	4585517	.	T	C	18	0	18	0	8	26	0	0
15	4585771	.	T	A	7	12	19	0	0	19	0	0
15	4586190	.	C	G	1	18	19	0	10	29	0	0
15	4586235	.	A	G	11	15	26	0	2	28	0	0
15	4586299	.	G	T	7	5	12	0	2	14	0	0
15	4633700	.	C	G	7	0	7	0	8	15	0	0
15	4634063	.	C	T	22	14	36	0	1	37	0	0
15	4634196	.	T	C	17	22	39	0	1	40	0	0
15	4634354	.	A	G	12	22	34	0	0	34	0	0
15	4634454	.	A	G	18	24	42	0	4	46	0	0
15	4634627	.	A	G	9	13	22	0	2	24	0	0
15	4634698	.	C	A	23	6	29	0	1	30	0	0
15	4635055	.	G	A	4	24	28	0	25	53	0	0
15	4635073	.	T	C	23	28	51	0	2	53	0	0
15	4635179	.	C	A	27	21	48	0	6	55	1	0
15	4635387	.	C	T	27	15	42	1	3	46	0	0
15	4635517	.	G	A	24	15	39	0	1	40	0	0
15	4635573	.	C	T	28	8	36	0	3	39	0	0
15	4982614	.	T	C	1	2	3	0	1	4	0	0
15	4982828	.	A	T	2	3	5	0	0	5	0	0
15	4983781	.	T	C	4	4	8	0	1	9	0	0
15	4984740	.	T	C	4	6	10	0	0	10	0	0
15	4984759	.	T	C	4	6	10	0	0	10	0	0
15	4991716	.	T	C	5	5	10	0	0	10	0	0
15	4991722	.	A	G	5	0	5	0	7	12	0	0
15	4995166	.	A	G	2	8	10	1	0	11	0	0
15	4999347	.	G	C	6	7	13	0	0	13	0	0
15	4999572	.	G	C	13	9	22	0	0	22	0	0
15	5069917	.	A	T	1	2	3	0	0	3	0	0
15	5074718	.	A	T	2	2	4	0	0	4	0	0
15	5074793	.	T	G	5	2	7	0	0	7	0	0
15	5074799	.	T	C	5	2	7	0	0	7	0	0
15	5074947	.	A	G	2	3	5	0	0	5	0	0
15	5144931	.	G	A	1	2	3	0	0	3	0	0
15	5147722	.	T	C	6	4	10	0	0	10	0	0
15	5147723	.	A	T	5	4	9	0	1	10	0	0
15	5147843	.	C	T	7	3	10	0	0	10	0	0
15	5147910	.	G	A	4	6	10	0	0	10	0	0
15	5147987	.	T	C	2	4	6	0	0	6	0	0
15	5148519	.	T	A	1	3	4	0	0	4	0	0
15	5148562	.	G	A	2	3	5	0	1	6	0	0
15	5916651	.	A	T	3	2	5	0	1	6	0	0
15	6957221	.	C	G	9	11	20	0	0	20	0	0
15	8425772	.	G	A	4	2	6	0	0	6	0	0
15	8426123	.	T	G	2	3	5	0	0	5	0	0
15	8426276	.	T	C	1	0	1	0	3	4	0	0
15	8606897	.	T	C	3	5	8	0	0	8	0	0
15	8799065	.	A	G	29	18	47	0	0	47	0	0
15	9367923	.	T	C	5	5	10	1	1	12	0	0
15	9369151	.	C	T	1	7	8	0	0	8	0	0
15	11669147	.	G	T	1	2	3	0	0	3	0	0
15	11691223	.	T	C	3	2	5	0	0	5	0	0
15	11953046	.	C	G	2	2	4	0	0	4	0	0
15	11953074	.	G	T	1	2	3	0	0	3	0	0
15	11953682	.	C	T	2	2	4	0	0	4	0	0
15	12293289	.	G	A	2	3	5	0	0	5	0	0
15	12319008	.	C	A	6	6	12	0	2	14	0	0
15	12521472	.	G	A	5	2	7	0	0	7	0	0
15	12521680	.	A	C	2	2	4	0	1	5	0	0
15	12521745	.	A	G	5	2	7	0	0	7	0	0
15	12522132	.	T	G	2	1	3	0	1	4	0	0
15	12522353	.	T	A	4	3	7	0	0	7	0	0
15	12522514	.	G	A	2	2	4	0	1	5	0	0
15	13107454	.	T	A	7	3	10	0	0	10	0	0
15	13107498	.	C	T	5	6	11	0	2	13	0	0
15	13107561	.	T	C	8	12	20	0	2	22	0	0
15	13107562	.	G	A	9	11	20	0	2	22	0	0
15	13127035	.	A	G	13	12	25	0	0	25	0	0
15	13127248	.	T	C	6	7	13	0	0	13	0	0
15	13129937	.	A	G	4	14	18	0	1	19	0	0
15	13207561	.	T	G	2	2	4	0	0	4	0	0
15	13207597	.	C	T	0	2	2	0	3	5	0	0
15	13207858	.	G	C	1	4	5	0	0	5	0	0
15	13207870	.	A	G	1	4	5	0	0	5	0	0
15	13985123	.	C	A	3	4	7	0	0	7	0	0
15	13985296	.	T	C	3	2	5	0	2	7	0	0
15	13985578	.	T	C	7	11	18	0	1	19	0	0
15	13985644	.	C	T	6	6	12	0	0	12	0	0
15	13985827	.	C	G	2	5	7	0	0	7	0	0
15	13986009	.	T	C	3	4	7	0	1	8	0	0
15	13986233	.	G	T	5	7	12	0	0	12	0	0
15	13986279	.	A	T	8	4	12	0	1	13	0	0
15	14076223	.	A	T	4	5	9	0	0	9	0	0
15	14076329	.	T	G	6	8	14	0	1	15	0	0
15	14076376	.	C	T	1	5	6	0	1	7	0	0
15	14079784	.	G	A	3	5	8	0	1	9	0	0
15	14079974	.	G	C	5	3	8	0	0	8	0	0
15	14082347	.	G	T	7	7	14	0	0	14	0	0
15	14085276	.	T	G	5	6	11	0	0	11	0	0
15	14085800	.	T	C	3	7	10	0	1	11	0	0
15	14085847	.	G	T	6	3	9	0	0	9	0	0
15	14085914	.	G	A	7	4	11	0	0	11	0	0
15	14088146	.	G	A	9	8	17	0	0	17	0	0
15	14088270	.	C	T	2	2	4	0	1	5	0	0
15	14092805	.	G	A	5	5	10	0	0	10	0	0
15	14092819	.	C	A	3	5	8	0	0	8	0	0
15	14093020	.	G	A	5	3	8	0	1	9	0	0
15	14093032	.	A	G	5	2	7	0	1	8	0	0
15	14093197	.	C	T	3	6	9	0	0	9	0	0
15	14098221	.	G	A	5	4	9	0	0	9	0	0
15	14179041	.	T	C	1	2	3	0	0	3	0	0
15	14206359	.	A	C	2	3	5	0	0	5	0	0
15	14206430	.	T	C	1	3	4	0	0	4	0	0
15	14206438	.	G	A	2	3	5	0	0	5	0	0
15	14206480	.	A	G	3	5	8	0	0	8	0	0
15	14206505	.	T	C	2	4	6	0	0	6	0	0
15	14303207	.	T	A	4	5	9	0	0	9	0	0
15	14317040	.	G	A	3	4	7	0	0	7	0	0
15	14420177	.	C	T	5	14	19	0	0	19	0	0
15	14436646	.	G	A	1	2	3	0	0	3	0	0
15	14436655	.	T	C	1	0	1	0	2	3	0	0
15	14554568	.	A	C	10	7	17	0	1	18	0	0
15	14554634	.	G	A	4	11	15	0	0	15	0	0
15	14554769	.	C	T	1	7	8	0	7	15	0	0
15	14557015	.	G	A	3	4	7	0	0	7	0	0
15	14557047	.	T	G	4	5	9	0	0	9	0	0
15	14558180	.	A	T	2	2	4	0	0	4	0	0
15	14576659	.	C	T	2	2	4	0	0	4	0	0
15	14597518	.	A	G	1	2	3	0	1	4	0	0
15	14597991	.	T	C	1	2	3	0	0	3	0	0
15	14598321	.	G	A	0	3	3	0	2	5	0	0
15	14598327	.	G	A	1	3	4	0	0	4	0	0
15	14598403	.	G	A	1	4	5	0	0	5	0	0
15	14598549	.	G	T	0	4	4	0	3	7	0	0
15	14598930	.	G	A	1	4	5	0	5	10	0	0
15	14599152	.	T	C	6	4	10	0	1	11	0	0
15	14599167	.	G	A	2	5	7	0	6	13	0	0
15	14599486	.	G	A	4	3	7	0	1	8	0	0
15	14599914	.	A	T	5	2	7	0	0	7	0	0
15	14630941	.	T	C	3	0	3	0	7	10	0	0
15	14631242	.	A	G	2	6	8	0	1	9	0	0
15	14631258	.	C	T	4	7	11	0	0	11	0	0
15	14631289	.	T	C	5	4	9	0	1	10	0	0
15	14631314	.	G	A	8	5	13	0	0	13	0	0
15	14631531	.	T	C	1	0	1	0	3	4	0	0
15	14631535	.	T	C	1	3	4	0	0	4	0	0
15	14631665	.	A	G	3	3	6	0	3	9	0	0
15	14631936	.	T	C	1	0	1	0	5	6	0	0
15	14631969	.	A	G	6	7	13	0	0	13	0	0
15	14632135	.	C	T	1	6	7	1	4	12	0	0
15	14632160	.	A	T	6	3	9	1	0	10	0	0
15	14632189	.	T	C	6	4	10	1	0	11	0	0
15	14632197	.	G	T	5	3	8	0	2	10	0	0
15	14632244	.	A	T	7	4	11	0	2	13	0	0
15	14632293	.	T	A	4	4	8	0	0	8	0	0
15	14632434	.	A	G	3	2	5	0	0	5	0	0
15	14632439	.	G	A	2	2	4	0	1	5	0	0
15	14632510	.	G	A	5	5	10	0	0	10	0	0
15	14632543	.	C	T	3	6	9	0	1	10	0	0
15	14632561	.	T	C	2	0	2	0	9	11	0	0
15	14632834	.	G	C	3	0	3	0	4	7	0	0
15	14632842	.	G	A	2	4	6	0	0	6	0	0
15	14633002	.	A	C	2	2	4	0	0	4	0	0
15	14633011	.	T	C	2	0	2	0	2	4	0	0
15	14633077	.	T	C	3	0	3	0	2	5	0	0
15	14633404	.	C	T	0	3	3	0	3	6	0	0
15	14633875	.	C	T	0	3	3	0	3	6	0	0
15	14633905	.	T	G	1	3	4	0	0	4	0	0
15	14633982	.	A	G	2	3	5	0	1	6	0	0
15	14634394	.	T	A	1	2	3	0	0	3	0	0
15	14636343	.	G	A	1	3	4	0	0	4	0	0
15	14638572	.	C	T	1	4	5	0	0	5	0	0
15	14638584	.	A	C	1	4	5	0	0	5	0	0
15	14639435	.	G	A	1	2	3	0	0	3	0	0
15	14665761	.	T	C	3	5	8	0	0	8	0	0
15	14855291	.	A	G	2	6	8	0	0	8	0	0
15	14856739	.	A	G	5	0	5	0	7	12	0	0
15	14856803	.	A	T	8	7	15	0	1	16	0	0
15	15349693	.	C	T	29	34	63	0	4	67	0	0
15	15349780	.	C	T	22	26	48	0	7	55	0	0
15	15349860	.	T	A	33	21	54	0	4	58	0	0
15	15403689	.	G	T	2	1	3	0	1	4	0	0
15	15415839	.	T	C	3	2	5	0	0	5	0	0
15	15445690	.	G	C	14	0	14	0	9	23	0	0
15	15445763	.	T	C	8	4	12	0	1	13	0	0
15	15445769	.	T	C	6	0	6	0	5	11	0	0
15	15445899	.	T	C	5	3	8	0	1	9	0	0
15	15446104	.	T	C	16	6	22	0	1	23	0	0
15	15446484	.	C	T	1	11	12	0	12	24	0	0
15	15446590	.	G	A	7	8	15	0	1	16	0	0
15	15446609	.	C	A	9	9	18	0	0	18	0	0
15	15447005	.	T	A	9	6	15	0	0	15	0	0
15	15447037	.	C	T	0	6	6	0	6	12	0	0
15	15447109	.	G	A	4	8	12	0	1	13	0	0
15	15447118	.	T	C	4	0	4	0	8	12	0	0
15	15449290	.	T	G	2	2	4	0	1	5	0	0
15	15449296	.	A	G	0	3	3	0	1	4	0	0
15	15449395	.	G	C	1	3	4	0	0	4	0	0
15	15460369	.	C	T	3	2	5	0	0	5	0	0
15	15460374	.	A	T	3	2	5	0	0	5	0	0
15	15460519	.	C	T	0	2	2	0	2	4	0	0
15	15513569	.	G	A	3	1	4	0	1	5	0	0
15	15513571	.	A	G	2	2	4	0	1	5	0	0
15	15587093	.	C	T	6	6	12	0	1	13	0	0
15	15587117	.	C	T	4	4	8	0	1	9	0	0
15	15589504	.	C	T	12	7	19	1	0	20	0	0
15	15591868	.	T	A	9	8	17	0	1	18	0	0
15	15592318	.	G	A	12	24	36	0	0	36	0	0
15	15592332	.	C	G	11	0	11	0	26	37	0	0
15	15592504	.	C	T	14	17	31	0	1	32	0	0
15	15592537	.	A	T	17	13	30	0	0	30	0	0
15	15592629	.	T	C	15	13	28	0	0	28	0	0
15	15592641	.	C	G	17	0	17	0	11	28	0	0
15	15592784	.	C	A	15	14	29	0	0	29	0	0
15	15592879	.	C	T	10	6	16	0	2	18	0	0
15	15592991	.	G	A	24	12	36	0	3	39	0	0
15	15593128	.	G	A	21	11	32	0	1	33	0	0
15	15786413	.	G	T	2	2	4	0	0	4	0	0
15	15789683	.	G	A	1	6	7	0	0	7	0	0
15	15811281	.	G	T	11	3	14	0	1	15	0	0
15	15813810	.	C	T	9	5	14	0	0	14	0	0
15	15819506	.	G	C	1	6	7	0	1	8	0	0
15	15856342	.	T	A	4	4	8	0	2	10	0	0
15	15876974	.	T	C	8	7	15	0	0	15	0	0
15	15877019	.	T	C	9	6	15	0	0	15	0	0
15	15877600	.	G	A	14	19	33	0	1	34	0	0
15	15877616	.	G	C	14	16	30	0	0	30	0	0
15	15886202	.	C	A	12	7	19	0	0	19	0	0
15	15886346	.	A	G	7	11	18	0	2	20	0	0
15	15886461	.	A	T	3	13	16	0	0	16	0	0
15	15886491	.	A	C	9	3	12	0	0	12	0	0
15	15886502	.	A	G	8	3	11	0	0	11	0	0
15	15886564	.	A	G	8	4	12	0	1	13	0	0
15	15886803	.	C	T	2	8	10	0	10	20	0	0
15	15886806	.	T	C	9	9	18	0	2	20	0	0
15	15906718	.	G	A	12	5	17	0	0	17	0	0
15	15906766	.	C	T	10	12	22	0	1	23	0	0
15	15916216	.	G	A	7	8	15	0	0	15	0	0
15	15923499	.	G	A	2	4	6	0	1	7	0	0
15	15923577	.	G	A	6	2	8	0	0	8	0	0
15	15923616	.	G	A	5	5	10	0	0	10	0	0
15	15923628	.	C	G	0	6	6	0	3	9	0	0
15	15923697	.	T	G	4	3	7	0	0	7	0	0
15	15944045	.	C	T	1	2	3	0	3	6	0	0
15	15944102	.	G	A	3	3	6	0	0	6	0	0
15	15944129	.	G	A	2	3	5	0	0	5	0	0
15	15944435	.	G	A	3	4	7	0	1	8	0	0
15	15947041	.	G	T	3	2	5	0	0	5	0	0
15	15947042	.	C	G	3	2	5	0	0	5	0	0
15	15950223	.	A	C	1	2	3	0	0	3	0	0
15	16066453	.	A	G	24	21	45	0	3	48	0	0
15	16066459	.	C	T	25	19	44	0	3	47	0	0
15	16066508	.	C	T	4	29	33	0	25	58	0	0
15	16067051	.	G	A	33	25	58	0	2	60	0	0
15	16072124	.	A	G	2	2	4	0	0	4	0	0
15	16072281	.	A	C	27	31	58	0	2	60	0	0
15	16072690	.	T	C	32	16	48	0	1	49	0	0
15	16072822	.	T	A	17	24	41	0	0	41	0	0
15	16073046	.	C	A	10	9	19	0	5	24	0	0
15	16073055	.	A	C	9	6	15	0	6	21	0	0
15	16073081	.	A	G	18	10	28	0	3	31	0	0
15	16076221	.	A	C	12	10	22	0	0	22	0	0
15	16079709	.	T	G	19	22	41	0	1	42	0	0
15	16079733	.	G	T	24	21	45	0	0	45	0	0
15	16080258	.	G	A	20	23	43	0	1	44	0	0
15	16086528	.	G	A	17	8	25	0	0	25	0	0
15	16086600	.	G	T	16	12	28	0	1	29	0	0
15	16094383	.	G	A	4	2	6	0	1	7	0	0
15	16094672	.	C	T	0	2	2	0	3	5	0	0
15	16101492	.	C	T	2	6	8	0	0	8	0	0
15	16123356	.	C	T	11	6	17	0	2	19	0	0
15	16123358	.	A	G	8	11	19	0	0	19	0	0
15	16123735	.	G	C	5	6	11	0	1	12	0	0
15	16123873	.	G	A	6	5	11	0	3	14	0	0
15	16123921	.	T	C	5	8	13	0	0	13	0	0
15	16124008	.	T	A	5	10	15	0	3	18	0	0
15	16124125	.	G	A	2	4	6	0	0	6	0	0
15	16124210	.	C	T	0	4	4	0	8	12	0	0
15	16125799	.	T	C	6	7	13	0	1	14	0	0
15	16127139	.	C	T	7	3	10	0	0	10	0	0
15	16130244	.	G	A	4	6	10	0	1	11	0	0
15	16136073	.	A	G	2	2	4	0	1	5	0	0
15	16139042	.	T	C	3	2	5	0	0	5	0	0
15	16144013	.	G	A	3	2	5	0	0	5	0	0
15	16144053	.	T	C	3	0	3	0	4	7	0	0
15	16144086	.	G	A	4	3	7	0	0	7	0	0
15	16178886	.	A	T	1	3	4	0	0	4	0	0
15	16178912	.	T	C	1	3	4	0	0	4	0	0
15	16194155	.	A	T	17	4	21	0	5	26	0	0
15	16194208	.	G	A	11	4	15	0	1	16	0	0
15	16194222	.	G	T	10	8	18	0	0	18	0	0
15	16194254	.	G	C	14	13	27	0	1	28	0	0
15	16194369	.	G	A	15	14	29	0	1	30	0	0
15	16194741	.	T	A	11	12	23	0	3	26	0	0
15	16226577	.	A	G	1	3	4	0	0	4	0	0
15	16328623	.	C	T	20	13	33	0	1	34	0	0
15	16332592	.	C	T	4	10	14	0	0	14	0	0
15	16332643	.	T	A	5	8	13	0	1	14	0	0
15	16332844	.	C	A	3	7	10	0	1	11	0	0
15	16377555	.	C	T	7	13	20	0	0	20	0	0
15	16378885	.	C	T	0	2	2	0	3	5	0	0
15	16398241	.	T	G	2	10	12	0	0	12	0	0
15	16398265	.	T	C	5	8	13	0	0	13	0	0
15	16401668	.	A	G	3	4	7	0	4	11	0	0
15	16406279	.	T	C	11	11	22	0	0	22	0	0
15	16407128	.	G	T	1	2	3	0	0	3	0	0
15	16407354	.	A	G	15	13	28	0	0	28	0	0
15	16407575	.	G	T	18	8	26	0	4	30	0	0
15	16407723	.	G	A	19	21	40	1	1	42	0	0
15	16935759	.	G	T	12	9	21	0	0	21	0	0
15	16935806	.	C	T	10	6	16	0	0	16	0	0
15	16935867	.	C	T	8	12	20	0	2	22	0	0
15	16936495	.	A	T	2	5	7	0	0	7	0	0
15	16936716	.	C	T	7	3	10	0	0	10	0	0
15	16937179	.	T	C	4	10	14	1	0	15	0	0
15	16937203	.	T	C	10	8	18	0	0	18	0	0
15	16937375	.	T	C	4	5	9	0	0	9	0	0
15	16937662	.	T	C	0	0	0	0	5	5	0	0
15	16938166	.	A	G	3	2	5	0	0	5	0	0
15	16944167	.	T	C	2	5	7	0	1	8	0	0
15	16944173	.	T	C	2	7	9	0	0	9	0	0
15	16944350	.	T	C	2	2	4	0	0	4	0	0
15	16946533	.	A	G	1	2	3	0	1	4	0	0
15	17085012	.	T	A	4	6	10	0	0	10	0	0
15	17091003	.	C	T	1	8	9	0	0	9	0	0
15	17091030	.	G	A	3	8	11	0	0	11	0	0
15	17091418	.	G	A	0	7	7	0	10	17	0	0
15	17095457	.	C	T	24	12	36	0	3	39	0	0
15	17123012	.	T	C	5	5	10	0	0	10	0	0
15	17123040	.	G	T	6	2	8	0	0	8	0	0
15	17123191	.	A	G	4	7	11	0	1	12	0	0
15	17123193	.	A	G	5	7	12	0	0	12	0	0
15	17123290	.	A	G	3	10	13	0	0	13	0	0
15	17123937	.	T	A	9	6	15	0	0	15	0	0
15	17123968	.	C	A	15	7	22	0	0	22	0	0
15	17124011	.	A	G	17	6	23	0	0	23	0	0
15	17124012	.	C	G	16	6	22	0	1	23	0	0
15	17124084	.	A	G	10	7	17	0	1	18	0	0
15	17124124	.	C	A	10	5	15	0	1	16	0	0
15	17124246	.	A	G	11	4	15	0	0	15	0	0
15	17124253	.	G	T	12	3	15	0	0	15	0	0
15	17124296	.	A	G	6	3	9	0	0	9	0	0
15	17124484	.	T	A	5	3	8	0	0	8	0	0
15	17124580	.	A	G	7	8	15	0	0	15	0	0
15	17124586	.	C	T	8	9	17	0	0	17	0	0
15	17124654	.	T	G	8	7	15	1	1	17	0	0
15	17124768	.	G	C	11	7	18	0	1	19	0	0
15	17124884	.	T	C	5	3	8	0	0	8	0	0
15	17125033	.	A	G	6	4	10	0	0	10	0	0
15	17125102	.	A	T	7	2	9	0	0	9	0	0
15	17128418	.	T	C	9	1	10	0	5	15	0	0
15	17128468	.	G	A	9	10	19	0	0	19	0	0
15	17131785	.	C	T	20	20	40	0	0	40	0	0
15	17134701	.	C	T	1	8	9	0	8	17	0	0
15	17147012	.	A	G	6	4	10	0	0	10	0	0
15	17147400	.	G	A	6	3	9	0	0	9	0	0
15	17268091	.	G	A	1	2	3	0	1	4	0	0
15	17280064	.	G	A	4	8	12	0	1	13	0	0
15	17299682	.	T	C	3	3	6	0	0	6	0	0
15	17308378	.	T	C	1	3	4	0	0	4	0	0
15	17312080	.	T	C	2	3	5	0	0	5	0	0
15	17312299	.	G	A	2	7	9	0	0	9	0	0
15	17312386	.	G	A	2	4	6	0	6	12	0	0
15	17317008	.	T	A	3	4	7	0	0	7	0	0
15	17317044	.	C	T	4	3	7	0	0	7	0	0
15	17317089	.	T	A	6	3	9	0	0	9	0	0
15	17318566	.	T	C	10	6	16	0	0	16	0	0
15	17319345	.	C	T	10	9	19	0	0	19	0	0
15	17320851	.	T	C	11	6	17	0	1	18	0	0
15	17321164	.	A	G	11	4	15	0	1	16	0	0
15	17321302	.	A	T	9	12	21	0	1	22	0	0
15	17324793	.	C	T	27	17	44	0	0	44	0	0
15	17327501	.	C	T	22	22	44	0	0	44	0	0
15	17339078	.	C	T	25	31	56	0	3	59	0	0
15	17339719	.	T	C	35	23	58	0	1	59	0	0
15	17340104	.	A	C	12	13	25	1	3	29	0	0
15	17350319	.	G	A	1	2	3	0	1	4	0	0
15	17372580	.	C	A	17	8	25	0	1	26	0	0
15	17372721	.	A	T	2	2	4	0	2	6	0	0
15	17372934	.	C	T	12	8	20	0	1	21	0	0
15	17423913	.	A	C	8	8	16	0	0	16	0	0
15	17424011	.	T	C	13	9	22	0	0	22	0	0
15	17424185	.	T	G	5	11	16	0	0	16	0	0
15	17424397	.	G	A	12	8	20	0	1	21	0	0
15	17424472	.	A	T	18	8	26	0	1	27	0	0
15	17424493	.	T	C	15	8	23	0	0	23	0	0
15	17424515	.	A	T	10	11	21	0	1	22	0	0
15	17424581	.	A	T	7	6	13	0	0	13	0	0
15	17445606	.	G	A	2	2	4	0	0	4	0	0
15	17445618	.	T	A	2	2	4	0	0	4	0	0
15	17486317	.	A	C	4	4	8	0	0	8	0	0
15	17486388	.	G	T	5	4	9	0	0	9	0	0
15	17486576	.	C	A	6	6	12	0	1	13	0	0
15	17486715	.	C	T	8	5	13	0	0	13	0	0
15	17486725	.	G	T	8	4	12	0	1	13	0	0
15	17487293	.	A	G	5	4	9	0	0	9	0	0
15	17487386	.	C	T	3	6	9	0	1	10	0	0
15	17487544	.	A	G	7	13	20	0	2	22	0	0
15	17487717	.	T	A	7	3	10	0	0	10	0	0
15	17488513	.	C	T	3	7	10	0	4	14	0	0
15	17488672	.	A	G	18	9	27	0	1	28	0	0
15	17488698	.	A	T	21	8	29	0	2	31	0	0
15	17488834	.	A	C	10	12	22	0	1	23	0	0
15	17489033	.	C	T	12	7	19	0	2	21	0	0
15	17489049	.	A	T	11	5	16	0	0	16	0	0
15	17489165	.	G	A	1	10	11	2	13	26	0	0
15	17489191	.	A	G	10	0	10	2	9	21	0	0
15	17489203	.	G	A	1	9	10	0	9	19	0	0
15	17489360	.	A	C	13	23	36	0	2	38	0	0
15	17489440	.	G	C	22	18	40	0	4	44	0	0
15	17489505	.	G	A	10	9	19	0	4	23	0	0
15	17489573	.	G	T	7	5	12	0	0	12	0	0
15	17489575	.	C	G	7	5	12	0	0	12	0	0
15	17866976	.	T	C	7	18	25	0	0	25	0	0
15	17867929	.	A	G	9	8	17	0	1	18	0	0
15	17868250	.	G	A	8	8	16	0	0	16	0	0
15	17868448	.	T	C	5	9	14	0	2	16	0	0
15	17868601	.	T	G	10	9	19	0	0	19	0	0
15	18102357	.	T	C	5	6	11	0	1	12	0	0
15	18102777	.	C	G	11	13	24	0	1	25	0	0
15	18102898	.	T	C	10	12	22	0	1	23	0	0
15	18103009	.	T	A	7	12	19	0	0	19	0	0
15	18103248	.	T	C	12	7	19	0	0	19	0	0
15	18103363	.	G	A	14	8	22	0	0	22	0	0
15	18106754	.	A	G	5	8	13	0	0	13	0	0
15	18107049	.	A	G	3	2	5	0	0	5	0	0
15	18107081	.	G	A	7	2	9	0	0	9	0	0
15	18111448	.	C	T	0	3	3	0	5	8	0	0
15	18130119	.	G	A	2	6	8	0	1	9	0	0
15	18130190	.	A	G	6	4	10	0	0	10	0	0
15	18130202	.	A	G	6	0	6	0	4	10	0	0
15	18130305	.	T	C	10	8	18	0	0	18	0	0
15	18141117	.	G	A	12	11	23	0	2	25	0	0
15	18143688	.	G	A	11	11	22	0	2	24	0	0
15	18146717	.	G	A	11	10	21	1	0	22	0	0
15	18148889	.	G	A	19	23	42	0	2	44	0	0
15	18148892	.	A	G	20	25	45	0	0	45	0	0
15	18148928	.	A	G	22	0	22	0	14	36	0	0
15	18151095	.	G	A	26	17	43	0	0	43	0	0
15	18155273	.	C	T	14	17	31	0	0	31	0	0
15	18155297	.	T	C	17	10	27	0	1	28	0	0
15	18155322	.	G	T	14	11	25	0	0	25	0	0
15	18155342	.	T	A	14	10	24	0	0	24	0	0
15	18155392	.	G	A	13	8	21	0	3	24	0	0
15	18155394	.	C	T	14	10	24	0	0	24	0	0
15	18155588	.	C	T	16	16	32	0	1	33	0	0
15	18155638	.	G	A	22	27	49	0	2	51	0	0
15	18155730	.	A	G	21	30	51	0	2	53	0	0
15	18253900	.	G	A	4	7	11	0	0	11	0	0
15	18254148	.	G	A	8	7	15	0	1	16	0	0
15	18254777	.	C	G	1	8	9	0	9	18	0	0
15	18254821	.	T	A	8	8	16	0	1	17	0	0
15	18254985	.	C	T	13	11	24	0	2	26	0	0
15	18255292	.	A	G	5	5	10	0	0	10	0	0
15	18255802	.	C	T	2	3	5	0	0	5	0	0
15	18256138	.	A	G	2	2	4	0	0	4	0	0
15	18256847	.	C	T	0	2	2	0	3	5	0	0
15	18257743	.	T	C	1	2	3	0	0	3	0	0
15	18257754	.	A	G	1	2	3	0	0	3	0	0
15	18369105	.	T	A	1	2	3	0	0	3	0	0
15	18371336	.	A	T	4	4	8	0	0	8	0	0
15	18371418	.	T	A	3	4	7	0	0	7	0	0
15	18371509	.	C	T	4	5	9	0	0	9	0	0
15	18371522	.	A	G	2	4	6	0	0	6	0	0
15	19037618	.	A	G	17	14	31	0	0	31	0	0
15	19037626	.	G	C	18	14	32	0	0	32	0	0
15	19037787	.	G	C	7	9	16	0	0	16	0	0
15	19037895	.	T	C	2	4	6	0	0	6	0	0
15	19038143	.	G	T	6	14	20	0	1	21	0	0
15	19038218	.	G	A	10	5	15	0	1	16	0	0
15	19039025	.	A	G	8	5	13	0	0	13	0	0
15	19039667	.	T	C	3	0	3	0	4	7	0	0
15	19039830	.	C	A	0	2	2	0	7	9	0	0
15	19039874	.	A	G	8	2	10	0	1	11	0	0
15	19042347	.	C	T	1	2	3	0	0	3	0	0
15	19132077	.	A	G	24	14	38	0	3	41	0	0
15	19132178	.	G	A	16	16	32	0	0	32	0	0
15	19132203	.	A	T	16	18	34	0	0	34	0	0
15	19132659	.	G	T	8	3	11	0	0	11	0	0
15	19132667	.	T	C	9	0	9	0	3	12	0	0
15	19132724	.	G	A	4	4	8	0	0	8	0	0
15	19133310	.	C	T	11	8	19	0	1	20	0	0
15	19133374	.	G	T	8	5	13	0	2	15	0	0
15	19133437	.	A	T	10	16	26	0	0	26	0	0
15	19133647	.	C	T	12	15	27	0	1	28	0	0
15	19133750	.	A	G	9	15	24	0	1	25	0	0
15	19134905	.	C	A	4	2	6	0	0	6	0	0
15	19135304	.	T	C	2	5	7	0	0	7	0	0
15	19135351	.	G	A	4	5	9	0	0	9	0	0
15	19301259	.	A	G	5	2	7	0	0	7	0	0
15	19311631	.	C	T	2	6	8	0	0	8	0	0
15	19312545	.	G	A	8	6	14	0	1	15	0	0
15	19316437	.	C	A	3	3	6	0	0	6	0	0
15	19316497	.	A	T	6	5	11	0	0	11	0	0
15	19316500	.	G	T	5	6	11	0	0	11	0	0
15	19317065	.	G	A	0	6	6	0	7	13	0	0
15	19317301	.	A	C	1	2	3	0	1	4	0	0
15	19318513	.	T	A	2	4	6	0	0	6	0	0
15	19318835	.	C	A	1	2	3	0	1	4	0	0
15	19318927	.	A	C	1	3	4	0	0	4	0	0
15	19318943	.	G	A	0	3	3	0	0	3	0	0
15	19319150	.	A	G	5	0	5	0	6	11	0	0
15	19319342	.	C	T	14	11	25	0	0	25	0	0
15	19319376	.	C	T	11	11	22	0	1	23	0	0
15	19319541	.	A	G	7	3	10	0	0	10	0	0
15	19319613	.	A	G	4	10	14	0	2	16	0	0
15	19319666	.	A	G	6	0	6	0	11	17	0	0
15	19329908	.	G	A	9	6	15	0	0	15	0	0
15	19330144	.	C	T	5	3	8	0	1	9	0	0
15	19330408	.	C	T	9	11	20	0	0	20	0	0
15	19330607	.	T	A	4	4	8	0	3	11	0	0
15	19330897	.	A	C	4	6	10	2	2	14	0	0
15	19331011	.	C	A	4	6	10	0	0	10	0	0
15	19331303	.	A	G	1	3	4	0	0	4	0	0
15	19339789	.	T	A	4	4	8	0	0	8	0	0
15	19345614	.	C	T	6	7	13	0	0	13	0	0
15	19347821	.	C	T	10	4	14	0	1	15	0	0
15	19347878	.	G	T	7	8	15	0	3	18	0	0
15	19348038	.	A	G	12	5	17	0	0	17	0	0
15	19348275	.	C	T	5	9	14	2	1	17	0	0
15	19574919	.	C	T	1	2	3	0	0	3	0	0
15	19577367	.	C	A	3	2	5	0	3	8	0	0
15	19577377	.	T	C	5	5	10	0	0	10	0	0
15	19595782	.	G	A	15	15	30	0	0	30	0	0
15	19661619	.	A	T	6	11	17	0	1	18	0	0
15	19668105	.	C	T	1	3	4	0	8	12	0	0
15	19668534	.	A	G	2	3	5	0	0	5	0	0
15	19668558	.	G	A	2	2	4	0	0	4	0	0
15	19727184	.	T	C	2	2	4	0	0	4	0	0
15	19728127	.	A	T	7	10	17	0	0	17	0	0
15	19728131	.	A	T	8	10	18	0	0	18	0	0
15	19728307	.	C	T	18	17	35	0	6	41	0	0
15	19728638	.	A	G	18	23	41	0	2	43	0	0
15	19728853	.	T	A	7	11	18	0	2	21	1	0
15	19728989	.	A	C	16	7	23	0	0	23	0	0
15	19737755	.	C	T	2	9	11	0	19	30	0	0
15	19742655	.	T	C	4	7	11	0	1	12	0	0
15	19745764	.	C	A	0	6	6	0	5	11	0	0
15	19878656	.	G	T	2	2	4	0	0	4	0	0
15	19893465	.	A	G	3	0	3	0	6	9	0	0
15	19893876	.	G	T	0	2	2	0	2	4	0	0
15	19895285	.	A	G	8	6	14	0	0	14	0	0
15	19895991	.	A	G	7	0	7	0	10	17	0	0
15	19896072	.	C	A	7	14	21	0	0	21	0	0
15	19896589	.	C	T	6	10	16	0	0	16	0	0
15	19908340	.	T	A	4	3	7	0	1	8	0	0
15	19932674	.	G	A	2	19	21	0	20	41	0	0
15	20005863	.	T	A	7	9	16	0	0	16	0	0
15	20005943	.	A	G	3	10	13	0	1	14	0	0
15	20006747	.	T	G	2	11	13	0	0	13	0	0
15	20066656	.	A	T	8	7	15	0	2	17	0	0
15	20069165	.	T	C	1	2	3	0	0	3	0	0
15	20069201	.	G	A	2	5	7	0	0	7	0	0
15	20074261	.	T	A	5	4	9	0	0	9	0	0
15	20081806	.	T	G	4	2	6	0	0	6	0	0
15	20086508	.	C	A	1	2	3	0	0	3	0	0
15	20205146	.	G	T	1	2	3	0	1	4	0	0
15	20363063	.	T	G	4	2	6	0	0	6	0	0
15	20363079	.	A	C	4	4	8	0	0	8	0	0
15	20363339	.	C	T	6	4	10	0	0	10	0	0
15	20363373	.	C	T	2	4	6	0	0	6	0	0
15	20367662	.	C	T	3	2	5	0	0	5	0	0
15	20377946	.	C	T	4	2	6	0	0	6	0	0
15	20378302	.	C	T	5	3	8	0	0	8	0	0
15	20379860	.	C	T	4	3	7	0	0	7	0	0
15	20382472	.	C	T	5	4	9	0	0	9	0	0
15	20383150	.	C	T	8	10	18	0	3	21	0	0
15	20383967	.	G	T	3	11	14	0	1	15	0	0
15	20384310	.	A	G	8	13	21	0	7	28	0	0
15	20384539	.	A	G	18	1	19	0	18	37	0	0
15	20386212	.	A	G	9	24	33	0	2	35	0	0
15	20394672	.	T	C	13	14	27	1	1	29	0	0
15	20394788	.	G	A	3	14	17	0	11	28	0	0
15	20394877	.	G	A	13	16	29	0	5	34	0	0
15	20394915	.	G	A	1	17	18	0	18	36	0	0
15	20395141	.	G	A	1	14	15	0	5	20	0	0
15	20399605	.	T	A	3	2	5	0	0	5	0	0
15	20406270	.	A	C	11	12	23	0	0	23	0	0
15	20406413	.	C	T	2	6	8	0	2	10	0	0
15	20406484	.	G	C	3	3	6	0	0	6	0	0
15	20406712	.	C	T	1	3	4	0	0	4	0	0
15	20406721	.	G	T	1	3	4	0	0	4	0	0
15	20407182	.	T	A	9	2	11	0	2	13	0	0
15	20407216	.	G	A	1	11	12	0	1	13	0	0
15	20407407	.	C	T	4	5	9	0	0	9	0	0
15	20407938	.	G	T	7	3	10	0	1	11	0	0
15	20407951	.	G	T	7	4	11	0	0	11	0	0
15	20411321	.	G	A	6	2	8	0	0	8	0	0
15	20412171	.	G	C	4	4	8	0	0	8	0	0
15	20475817	.	A	G	5	5	10	0	2	12	0	0
15	20475865	.	G	A	7	9	16	0	3	19	0	0
15	20476016	.	C	G	3	9	12	0	1	13	0	0
15	20476058	.	A	G	7	16	23	0	1	24	0	0
15	20476075	.	A	G	10	14	24	0	1	25	0	0
15	20479056	.	A	G	7	6	13	0	0	13	0	0
15	20489854	.	C	T	3	3	6	0	0	6	0	0
15	20489875	.	G	A	5	2	7	0	0	7	0	0
15	20652744	.	A	G	4	3	7	0	0	7	0	0
15	20652787	.	G	A	14	12	26	0	0	26	0	0
15	20652813	.	A	T	18	13	31	0	2	33	0	0
15	20652955	.	A	G	25	22	47	0	0	47	0	0
15	20653048	.	A	T	24	15	39	0	2	41	0	0
15	20653074	.	T	A	24	10	34	1	0	35	0	0
15	20655888	.	A	C	33	21	54	1	3	58	0	0
15	20709058	.	G	A	12	10	22	0	2	24	0	0
15	20709292	.	A	C	11	15	26	0	0	26	0	0
15	20709340	.	G	C	11	6	17	0	1	18	0	0
15	20709490	.	A	G	10	10	20	0	2	22	0	0
15	20709925	.	G	A	9	4	13	0	3	16	0	0
15	20731345	.	A	C	2	0	2	0	2	4	0	0
15	20731452	.	G	T	1	2	3	0	0	3	0	0
15	20731512	.	A	T	1	1	2	0	3	5	0	0
15	20830965	.	G	A	1	4	5	0	0	5	0	0
15	20830981	.	A	G	4	2	6	0	0	6	0	0
15	20831091	.	T	C	10	4	14	0	0	14	0	0
15	20831105	.	C	T	6	4	10	0	1	11	0	0
15	20832831	.	C	T	10	8	18	0	1	19	0	0
15	20833018	.	A	G	4	7	11	0	0	11	0	0
15	20835105	.	T	C	4	6	10	0	0	10	0	0
15	20883185	.	A	T	2	5	7	0	1	8	0	0
15	20883238	.	C	A	1	2	3	0	0	3	0	0
15	20884503	.	T	G	1	0	1	0	2	3	0	0
15	20884551	.	T	C	1	2	3	0	0	3	0	0
15	20886090	.	T	C	1	3	4	0	0	4	0	0
15	20893300	.	C	A	6	4	10	0	0	10	0	0
15	20893320	.	C	A	16	0	16	0	0	16	0	0
15	20893481	.	A	G	6	7	13	0	2	15	0	0
15	20893592	.	C	T	9	14	23	0	0	23	0	0
15	20893644	.	A	G	13	7	20	0	1	21	0	0
15	20893920	.	T	A	10	6	16	0	0	16	0	0
15	20894129	.	C	G	14	17	31	0	2	33	0	0
15	20894177	.	C	A	21	23	44	0	0	44	0	0
15	20894464	.	T	C	22	20	42	0	0	42	0	0
15	20894604	.	C	T	16	14	30	1	1	32	0	0
15	20901009	.	C	T	21	17	38	0	1	39	0	0
15	20901261	.	G	T	9	20	29	0	0	29	0	0
15	20901358	.	A	G	19	18	37	0	3	40	0	0
15	20907648	.	A	G	6	3	9	0	0	9	0	0
15	20907651	.	C	T	3	5	8	0	0	8	0	0
15	20907958	.	C	T	2	3	5	0	1	6	0	0
15	20907970	.	C	T	0	3	3	0	3	6	0	0
15	20941485	.	A	T	4	7	11	0	1	12	0	0
15	20943064	.	T	C	4	3	7	0	0	7	0	0
15	20943072	.	G	A	4	6	10	0	0	10	0	0
15	20943651	.	T	C	4	5	9	0	0	9	0	0
15	20943760	.	T	A	3	6	9	0	1	10	0	0
15	20944004	.	T	A	3	6	9	0	0	9	0	0
15	20944005	.	G	T	3	4	7	0	2	9	0	0
15	20944217	.	C	A	1	2	3	0	0	3	0	0
15	20944562	.	G	A	4	4	8	0	0	8	0	0
15	20944577	.	C	G	4	5	9	0	0	9	0	0
15	20944856	.	G	A	5	3	8	0	0	8	0	0
15	21255145	.	T	C	8	10	18	0	0	18	0	0
15	21258288	.	C	T	9	12	21	0	2	23	0	0
15	21260930	.	A	T	2	3	5	0	0	5	0	0
15	21260966	.	T	G	1	2	3	0	0	3	0	0
15	21262268	.	C	T	7	6	13	1	0	14	0	0
15	21265978	.	G	A	1	2	3	0	0	3	0	0
15	21272916	.	A	T	3	9	12	0	0	12	0	0
15	21275486	.	T	C	1	7	8	0	0	8	0	0
15	21307477	.	C	T	1	3	4	0	0	4	0	0
15	21316996	.	A	T	3	5	8	0	0	8	0	0
15	21317192	.	G	A	2	3	5	0	0	5	0	0
15	21319739	.	T	A	9	6	15	0	0	15	0	0
15	21320097	.	T	C	14	5	19	0	0	19	0	0
15	21320329	.	A	G	8	7	15	0	2	17	0	0
15	21320475	.	A	T	9	7	16	0	0	16	0	0
15	21320558	.	T	A	8	3	11	0	0	11	0	0
15	21541201	.	C	T	14	7	21	1	2	24	0	0
15	21541620	.	C	T	13	5	18	3	1	22	0	0
15	21541695	.	T	G	6	2	8	2	1	11	0	0
15	21542542	.	T	C	17	11	28	0	2	30	0	0
15	21542559	.	C	A	22	11	33	0	1	34	0	0
15	21542884	.	C	A	1	7	8	2	17	27	0	0
15	21545866	.	C	T	5	8	13	3	2	18	0	0
15	21545921	.	C	T	0	10	10	2	9	21	0	0
15	21546399	.	A	G	8	5	13	0	0	13	0	0
15	21548403	.	C	T	7	3	10	0	0	10	0	0
15	21552410	.	T	A	2	2	4	0	0	4	0	0
15	21557403	.	G	C	2	2	4	0	0	4	0	0
15	21558334	.	A	C	3	2	5	0	0	5	0	0
15	21571033	.	G	A	1	2	3	0	0	3	0	0
15	21684510	.	C	T	5	4	9	0	1	10	0	0
15	21684546	.	T	A	13	2	15	0	1	16	0	0
15	21684701	.	T	C	1	3	4	0	2	6	0	0
15	21684704	.	T	G	3	3	6	0	0	6	0	0
15	21684933	.	A	G	9	16	25	0	0	25	0	0
15	21685195	.	T	A	18	16	34	0	1	35	0	0
15	21685217	.	C	T	2	18	20	0	13	33	0	0
15	21685357	.	G	A	19	17	36	0	2	38	0	0
15	21685418	.	C	T	20	9	29	0	1	30	0	0
15	21685484	.	A	G	15	11	26	0	0	26	0	0
15	21715339	.	C	T	10	3	13	0	0	13	0	0
15	21715381	.	G	A	4	4	8	0	1	9	0	0
15	21716760	.	T	A	1	2	3	0	0	3	0	0
15	21716778	.	G	A	2	3	5	0	0	5	0	0
15	21747981	.	T	C	4	2	6	0	0	6	0	0
15	21757433	.	C	T	4	9	13	0	1	14	0	0
15	21769619	.	T	C	9	11	20	0	1	21	0	0
15	21769640	.	G	A	8	17	25	0	2	27	0	0
15	21771835	.	A	T	17	23	40	0	1	41	0	0
15	21772073	.	T	C	24	29	53	0	0	53	0	0
15	21772112	.	T	C	30	22	52	0	3	55	0	0
15	21772174	.	T	C	28	22	50	0	4	54	0	0
15	21772208	.	T	C	20	23	43	0	0	43	0	0
15	21772689	.	C	A	26	24	50	0	2	52	0	0
15	21782020	.	G	A	19	20	39	0	1	40	0	0
15	21782028	.	G	A	20	19	39	0	0	39	0	0
15	21782057	.	T	C	18	16	34	0	0	34	0	0
15	21782154	.	C	A	3	20	23	0	12	35	0	0
15	21782171	.	G	A	12	17	29	0	3	32	0	0
15	21782238	.	A	G	10	13	23	0	0	23	0	0
15	21782385	.	G	T	1	9	10	0	0	10	0	0
15	21782946	.	C	G	11	11	22	0	0	22	0	0
15	21783681	.	G	A	11	7	18	0	0	18	0	0
15	21784042	.	G	T	7	8	15	0	4	19	0	0
15	21784226	.	T	C	17	1	18	0	16	34	0	0
15	21784352	.	T	C	10	5	15	0	0	15	0	0
15	21784525	.	C	G	0	8	8	0	6	14	0	0
15	21791872	.	G	T	6	1	7	0	2	10	1	0
15	21791878	.	C	T	0	2	2	0	5	7	0	0
15	21792220	.	C	T	1	2	3	0	4	7	0	0
15	22047200	.	C	T	1	2	3	0	0	3	0	0
15	22143027	.	G	A	1	6	7	0	0	7	0	0
15	23188371	.	A	C	7	1	8	0	0	8	0	0
15	23188372	.	A	C	4	3	7	0	1	8	0	0
15	23818110	.	G	A	5	2	7	0	0	7	0	0
15	23818575	.	T	C	1	5	6	0	0	6	0	0
15	24736413	.	A	G	5	10	15	0	0	15	0	0
15	25173714	.	C	T	4	13	17	0	0	17	0	0
15	25377155	.	C	T	1	2	3	0	0	3	0	0
15	25485394	.	A	G	2	4	6	0	0	6	0	0
15	28539591	.	A	G	8	4	12	0	0	12	0	0
15	28539607	.	A	G	6	8	14	0	0	14	0	0
15	30838501	.	A	G	9	7	16	0	9	25	0	0
15	30838991	.	C	A	9	9	18	0	6	24	0	0
15	30862848	.	T	C	10	6	16	0	2	18	0	0
15	31889332	.	C	T	2	1	3	0	2	5	0	0
15	31905040	.	G	A	7	12	19	0	3	22	0	0
15	31905097	.	A	G	9	8	17	0	3	20	0	0
15	31909454	.	A	C	9	7	16	0	1	17	0	0
15	32197313	.	T	A	2	3	5	0	1	6	0	0
15	32197453	.	A	G	3	1	4	0	0	4	0	0
15	32197458	.	T	C	4	2	6	0	0	6	0	0
15	32249188	.	G	A	7	11	18	0	0	18	0	0
15	32259056	.	G	A	5	4	9	0	1	10	0	0
15	32261461	.	G	C	1	7	8	2	9	19	0	0
15	32261464	.	T	C	7	10	17	2	1	20	0	0
15	32265889	.	T	C	14	12	26	0	2	28	0	0
15	32266557	.	A	T	13	13	26	0	0	26	0	0
15	32266921	.	G	A	1	15	16	0	14	30	0	0
15	32267078	.	A	G	10	9	19	0	1	20	0	0
15	32267120	.	C	A	3	5	8	0	1	9	0	0
15	32350430	.	A	G	4	3	7	0	0	7	0	0
15	32350450	.	A	G	2	0	2	0	4	6	0	0
15	32350663	.	A	G	2	2	4	0	1	5	0	0
15	32350837	.	A	G	2	0	2	0	3	5	0	0
15	32350864	.	A	G	1	2	3	0	0	3	0	0
15	32351476	.	A	G	4	3	7	0	1	8	0	0
15	32353825	.	C	A	5	2	7	0	0	7	0	0
15	32353830	.	A	T	1	3	4	0	0	4	0	0
15	33853701	.	C	T	3	5	8	0	0	8	0	0
15	33864152	.	A	G	5	5	10	0	0	10	0	0
15	33864266	.	G	A	7	4	11	0	3	14	0	0
15	33864585	.	G	A	8	4	12	0	2	14	0	0
15	33864713	.	T	C	3	2	5	2	0	7	0	0
15	33891825	.	G	A	12	9	21	0	0	21	0	0
15	33891826	.	G	A	11	8	19	0	1	20	0	0
15	33891869	.	G	T	10	5	15	0	0	15	0	0
15	33891979	.	T	C	21	8	29	0	1	30	0	0
15	33896117	.	G	T	14	7	21	0	1	22	0	0
15	33896177	.	T	C	10	7	17	0	0	17	0	0
15	33896213	.	T	C	7	0	7	0	10	17	0	0
15	33896303	.	T	A	9	8	17	0	0	17	0	0
15	33896306	.	A	G	9	7	16	0	0	16	0	0
15	33899556	.	C	G	3	3	6	0	0	6	0	0
15	33899808	.	T	A	7	5	12	0	1	13	0	0
15	33902388	.	C	G	0	2	2	0	3	5	0	0
15	33910546	.	G	C	4	3	7	0	0	7	0	0
15	33970841	.	A	G	4	0	4	0	5	9	0	0
15	33970854	.	C	T	7	9	16	0	1	17	0	0
15	33970907	.	C	T	15	13	28	0	0	28	0	0
15	33971097	.	G	C	15	19	34	0	0	34	0	0
15	33977716	.	A	T	20	13	33	0	2	35	0	0
15	33977760	.	A	G	14	0	14	0	13	27	0	0
15	33977942	.	A	C	8	15	23	0	1	24	0	0
15	34074558	.	C	T	3	5	8	0	1	9	0	0
15	34174532	.	T	A	15	11	26	0	0	26	0	0
15	34174568	.	T	A	13	9	22	0	1	23	0	0
15	34175101	.	T	C	24	14	38	0	0	38	0	0
15	34175359	.	G	A	12	4	16	0	0	16	0	0
15	34175426	.	T	A	4	10	14	0	2	16	0	0
15	34175718	.	G	A	6	6	12	0	0	12	0	0
15	34175917	.	C	T	9	7	16	3	2	21	0	0
15	34175929	.	C	T	9	13	22	1	1	24	0	0
15	34176203	.	A	T	12	8	20	0	1	21	0	0
15	34176214	.	C	T	7	8	15	0	2	17	0	0
15	34176336	.	G	T	2	2	4	0	0	4	0	0
15	34176379	.	A	C	9	7	16	0	2	18	0	0
15	34176841	.	A	T	4	4	8	0	2	10	0	0
15	34176993	.	G	A	7	7	14	0	0	14	0	0
15	34186690	.	A	T	4	9	13	0	2	15	0	0
15	34189452	.	G	A	4	4	8	0	0	8	0	0
15	34223260	.	A	G	1	2	3	0	0	3	0	0
15	34534245	.	C	G	6	4	10	0	2	12	0	0
15	34534265	.	C	T	9	6	15	0	2	17	0	0
15	34562974	.	G	A	1	3	4	0	0	4	0	0
15	34573337	.	C	T	3	4	7	0	1	8	0	0
15	34573343	.	A	G	3	5	8	0	0	8	0	0
15	34573454	.	A	C	2	6	8	0	0	8	0	0
15	34573597	.	A	T	4	5	9	0	0	9	0	0
15	34573664	.	G	T	5	3	8	0	0	8	0	0
15	34574116	.	G	A	7	6	13	0	1	14	0	0
15	34577749	.	G	A	2	5	7	0	0	7	0	0
15	34618456	.	T	G	10	11	21	0	0	21	0	0
15	34618669	.	A	T	16	17	33	0	1	34	0	0
15	34618906	.	C	A	17	21	38	0	0	38	0	0
15	34618948	.	T	G	27	13	40	0	1	41	0	0
15	34618958	.	G	A	24	12	36	0	4	40	0	0
15	34621868	.	G	A	5	12	17	0	1	18	0	0
15	34621875	.	G	A	11	6	17	0	1	18	0	0
15	34627792	.	T	A	8	6	14	0	0	14	0	0
15	34627874	.	T	C	11	4	15	0	1	16	0	0
15	34635321	.	C	A	3	2	5	0	0	5	0	0
15	34635336	.	A	C	3	0	3	0	1	4	0	0
15	34637582	.	C	T	0	3	3	0	2	5	0	0
15	34638847	.	C	T	0	2	2	0	2	4	0	0
15	35076003	.	C	T	1	2	3	0	0	3	0	0
15	35091591	.	A	G	1	4	5	0	1	6	0	0
15	35102539	.	T	C	2	2	4	0	0	4	0	0
15	35115699	.	A	G	2	5	7	5	0	12	0	0
15	35156366	.	G	A	1	2	3	0	1	4	0	0
15	35157052	.	T	A	5	5	10	0	0	10	0	0
15	35157054	.	G	A	5	5	10	0	0	10	0	0
15	35158661	.	T	G	8	11	19	0	0	19	0	0
15	35163523	.	C	T	5	3	8	0	0	8	0	0
15	35214784	.	T	A	12	8	20	0	0	20	0	0
15	35214859	.	A	C	7	0	7	0	13	20	0	0
15	35214901	.	G	A	11	11	22	0	2	24	0	0
15	35217424	.	G	A	6	7	13	0	0	13	0	0
15	35217475	.	T	C	5	7	12	0	3	15	0	0
15	35217487	.	C	A	0	8	8	0	8	16	0	0
15	35224269	.	G	C	7	5	12	0	0	12	0	0
15	35227221	.	A	T	16	4	20	0	3	23	0	0
15	35247678	.	A	T	8	9	17	0	1	18	0	0
15	35247687	.	A	G	10	6	16	0	1	17	0	0
15	35247729	.	A	G	8	8	16	0	0	16	0	0
15	35247762	.	T	C	6	10	16	0	0	16	0	0
15	35889139	.	G	A	3	3	6	0	0	6	0	0
15	35889183	.	C	A	3	3	6	0	0	6	0	0
15	35889215	.	C	A	1	2	3	0	0	3	0	0
15	35889516	.	A	C	1	2	3	0	0	3	0	0
15	35889517	.	C	A	0	2	2	0	1	3	0	0
15	35889826	.	C	T	2	3	5	0	0	5	0	0
15	35889862	.	T	C	0	0	0	0	6	6	0	0
15	35889865	.	A	G	3	3	6	0	0	6	0	0
15	35890046	.	G	A	3	4	7	0	0	7	0	0
15	35891639	.	T	A	3	2	5	0	0	5	0	0
15	35944379	.	G	A	0	2	2	0	2	4	0	0
15	35944474	.	A	C	1	3	4	0	0	4	0	0
15	37228771	.	A	G	43	13	56	0	0	56	0	0
15	37459342	.	T	C	3	0	3	0	2	5	0	0
15	38218190	.	G	C	1	6	7	0	1	8	0	0
15	38218192	.	A	G	1	7	8	0	0	8	0	0
15	38223672	.	T	A	1	2	3	0	0	3	0	0
15	38223685	.	C	G	2	2	4	0	0	4	0	0
15	38239641	.	C	T	2	2	4	0	0	4	0	0
15	38268705	.	T	A	3	2	5	0	0	5	0	0
15	38287983	.	G	A	3	2	5	0	0	5	0	0
15	38287995	.	A	G	3	2	5	0	0	5	0	0
15	38288104	.	A	C	3	3	6	0	1	7	0	0
15	38289831	.	A	G	1	4	5	0	0	5	0	0
15	38295122	.	T	C	5	5	10	0	0	10	0	0
15	38295158	.	T	C	9	3	12	0	0	12	0	0
15	38295347	.	G	A	9	7	16	0	2	18	0	0
15	38295485	.	C	G	9	8	17	0	0	17	0	0
15	38295771	.	G	A	4	5	9	0	1	10	0	0
15	38296305	.	A	G	10	13	23	0	2	25	0	0
15	38296377	.	A	G	9	8	17	0	3	20	0	0
15	38296449	.	T	C	6	8	14	0	1	15	0	0
15	38296885	.	A	G	9	0	9	0	16	25	0	0
15	38296900	.	T	A	12	13	25	0	2	28	1	0
15	38297071	.	T	C	24	19	43	0	0	43	0	0
15	38297214	.	C	T	16	22	38	0	3	42	1	0
15	38297364	.	C	T	15	20	35	0	2	37	0	0
15	38297372	.	A	G	13	21	34	0	2	36	0	0
15	39141498	.	A	G	5	5	10	0	0	10	0	0
15	39207024	.	T	A	5	6	11	0	0	11	0	0
15	39208087	.	G	A	1	5	6	0	5	11	0	0
15	39210450	.	G	A	0	8	8	0	10	18	0	0
15	39223884	.	A	T	5	12	17	0	0	17	0	0
15	39223980	.	T	G	10	8	18	0	1	19	0	0
15	39226661	.	A	T	11	6	17	0	0	17	0	0
15	39228113	.	A	T	14	7	21	0	1	22	0	0
15	39228120	.	A	C	14	7	21	0	1	22	0	0
15	39228174	.	A	G	13	10	23	0	0	23	0	0
15	39281843	.	T	G	4	3	7	0	1	8	0	0
15	39281875	.	A	C	6	3	9	0	0	9	0	0
15	39282007	.	G	C	9	0	9	0	9	18	0	0
15	39296706	.	A	G	3	10	13	0	0	13	0	0
15	39296751	.	C	T	0	4	4	0	1	5	0	0
15	39296982	.	T	C	5	4	9	0	1	10	0	0
15	39296997	.	T	C	7	3	10	0	0	10	0	0
15	39297051	.	G	A	6	3	9	0	0	9	0	0
15	39994313	.	T	C	2	2	4	0	0	4	0	0
15	40002242	.	C	T	3	2	5	0	0	5	0	0
15	40002319	.	C	T	2	4	6	0	0	6	0	0
15	40002325	.	C	T	2	4	6	0	0	6	0	0
15	40002561	.	T	A	3	4	7	0	0	7	0	0
15	40005110	.	A	G	7	0	7	0	7	14	0	0
15	40005112	.	A	G	7	7	14	0	0	14	0	0
15	40005342	.	A	T	9	4	13	0	3	16	0	0
15	40005527	.	T	A	13	11	24	0	0	24	0	0
15	40006090	.	A	C	13	13	26	0	0	26	0	0
15	40006136	.	T	C	13	12	25	0	0	25	0	0
15	40008449	.	C	T	4	7	11	0	0	11	0	0
15	40008454	.	C	A	4	4	8	0	3	11	0	0
15	40008537	.	G	T	0	14	14	0	4	18	0	0
15	40008544	.	C	A	4	14	18	0	1	19	0	0
15	40017144	.	A	G	10	18	28	0	0	28	0	0
15	40018500	.	T	C	23	29	52	1	4	57	0	0
15	40027138	.	C	T	23	39	62	0	4	66	0	0
15	40027194	.	A	T	23	38	61	0	2	63	0	0
15	40027279	.	T	C	39	22	61	0	1	62	0	0
15	40027484	.	T	G	17	3	20	0	33	53	0	0
15	40027540	.	A	C	22	29	51	0	3	54	0	0
15	40028280	.	A	G	41	12	53	0	0	53	0	0
15	40028457	.	T	G	32	36	68	0	0	68	0	0
15	40028568	.	G	A	27	28	55	0	3	58	0	0
15	40028574	.	A	G	21	31	52	0	8	60	0	0
15	40130631	.	A	G	17	6	23	0	0	23	0	0
15	40212022	.	A	T	5	1	6	0	2	8	0	0
15	40217543	.	T	C	1	3	4	0	1	5	0	0
15	40218781	.	T	C	1	0	1	0	2	3	0	0
15	40218798	.	T	C	1	1	2	0	0	2	0	0
15	41238715	.	C	T	6	4	10	0	0	10	0	0
15	41238764	.	T	A	10	6	16	0	0	16	0	0
15	41238819	.	G	A	5	4	9	0	0	9	0	0
15	41291668	.	A	C	3	3	6	0	0	6	0	0
15	41291676	.	C	A	3	3	6	0	0	6	0	0
15	41291726	.	C	T	3	2	5	0	0	5	0	0
15	41292003	.	G	A	6	3	9	0	0	9	0	0
15	41292134	.	G	A	6	3	9	0	0	9	0	0
15	41294625	.	T	C	6	3	9	0	0	9	0	0
15	41296910	.	T	C	7	0	7	0	4	11	0	0
15	41297117	.	A	G	3	4	7	0	1	8	0	0
15	41298822	.	C	T	1	5	6	0	0	6	0	0
15	41299003	.	T	C	4	2	6	0	0	6	0	0
15	41302494	.	G	A	3	2	5	0	0	5	0	0
15	41302523	.	A	G	2	2	4	0	0	4	0	0
15	41303747	.	G	A	4	3	7	0	0	7	0	0
15	41303773	.	A	C	2	2	4	0	0	4	0	0
15	41303839	.	A	G	4	2	6	0	0	6	0	0
15	41303846	.	G	A	4	2	6	0	0	6	0	0
15	41310303	.	T	C	2	2	4	0	0	4	0	0
15	41657648	.	G	A	0	2	2	0	1	3	0	0
15	41663743	.	A	T	1	1	2	0	0	2	0	0
15	41663750	.	C	T	1	2	3	0	0	3	0	0
15	41664144	.	T	A	1	2	3	0	0	3	0	0
15	41664145	.	A	C	1	2	3	0	0	3	0	0
15	41676929	.	G	A	6	3	9	0	2	11	0	0
15	41676968	.	A	T	6	6	12	0	0	12	0	0
15	41677058	.	C	T	4	4	8	0	0	8	0	0
15	41677130	.	G	A	7	4	11	0	0	11	0	0
15	41683071	.	G	A	2	2	4	0	0	4	0	0
15	41689823	.	T	A	1	2	3	0	0	3	0	0
15	41694132	.	C	T	9	10	19	0	0	19	0	0
15	41694163	.	T	A	3	7	10	0	2	12	0	0
15	41694230	.	A	C	6	4	10	0	2	12	0	0
15	41694398	.	T	A	1	2	3	0	0	3	0	0
15	41694483	.	T	G	1	2	3	0	1	4	0	0
15	41694484	.	T	C	1	3	4	0	0	4	0	0
15	41694617	.	A	T	4	4	8	0	0	8	0	0
15	41694894	.	T	A	5	2	7	0	1	8	0	0
15	41695120	.	T	C	1	3	4	0	0	4	0	0
15	41695429	.	G	A	7	2	9	0	0	9	0	0
15	41695481	.	A	T	3	5	8	0	0	8	0	0
15	41695901	.	A	T	4	2	6	0	0	6	0	0
15	41696299	.	G	A	3	3	6	0	0	6	0	0
15	41696344	.	C	A	3	3	6	0	0	6	0	0
15	41697742	.	T	A	2	2	4	0	0	4	0	0
15	41697779	.	A	T	1	2	3	0	0	3	0	0
15	41767883	.	C	T	5	2	7	0	0	7	0	0
15	41768064	.	T	C	3	5	8	0	0	8	0	0
15	41769338	.	A	C	2	3	5	0	0	5	0	0
15	41843134	.	T	A	1	3	4	0	0	4	0	0
15	41843144	.	C	T	1	4	5	0	0	5	0	0
15	41845038	.	G	C	2	5	7	0	0	7	0	0
15	41845059	.	A	C	2	2	4	0	0	4	0	0
15	41845121	.	G	A	6	6	12	0	1	13	0	0
15	41845253	.	A	T	1	6	7	0	0	7	0	0
15	41948270	.	T	A	2	8	10	0	1	11	0	0
15	41948276	.	A	C	2	5	7	0	1	8	0	0
15	41949258	.	T	G	2	4	6	0	0	6	0	0
15	41949294	.	G	C	4	7	11	0	0	11	0	0
15	41949334	.	A	C	6	5	11	0	1	12	0	0
15	41949355	.	G	A	8	3	11	0	0	11	0	0
15	41949500	.	C	T	1	2	3	0	0	3	0	0
15	41949769	.	G	T	5	3	8	0	0	8	0	0
15	41949786	.	T	C	5	2	7	0	0	7	0	0
15	41949825	.	A	G	1	2	3	0	0	3	0	0
15	41950548	.	G	A	1	2	3	0	0	3	0	0
15	42265070	.	G	C	11	14	25	0	2	27	0	0
15	42265197	.	G	A	17	23	40	0	2	42	0	0
15	42267390	.	C	T	2	10	12	0	13	25	0	0
15	42272452	.	C	A	10	12	22	0	2	24	0	0
15	42278997	.	G	A	2	5	7	0	0	7	0	0
15	42296654	.	A	G	10	0	10	0	16	26	0	0
15	42296717	.	T	G	6	0	6	0	10	16	0	0
15	42296753	.	C	T	5	7	12	0	0	12	0	0
15	42297751	.	T	C	11	9	20	0	2	23	1	0
15	42302915	.	A	G	13	18	31	0	1	32	0	0
15	42302990	.	A	G	13	12	25	0	1	26	0	0
15	42303020	.	A	T	12	8	20	0	0	20	0	0
15	42304851	.	C	T	13	8	21	0	0	21	0	0
15	42317072	.	T	A	5	11	16	0	0	16	0	0
15	42317277	.	C	G	4	5	9	0	0	9	0	0
15	42344847	.	C	T	3	5	8	0	1	9	0	0
15	42344874	.	C	G	4	5	9	0	0	9	0	0
15	42346196	.	T	C	6	3	9	1	2	12	0	0
15	42346260	.	T	A	4	7	11	0	2	13	0	0
15	42346584	.	C	T	5	2	7	0	1	8	0	0
15	42346593	.	T	C	6	3	9	0	0	9	0	0
15	42346627	.	G	T	3	3	6	0	1	7	0	0
15	42346841	.	T	C	6	5	11	0	1	12	0	0
15	42346955	.	G	A	1	4	5	0	12	17	0	0
15	42346982	.	T	A	10	3	13	0	1	14	0	0
15	42347008	.	C	T	6	4	10	0	0	10	0	0
15	42347053	.	T	C	5	4	9	0	1	10	0	0
15	43245362	.	A	G	17	17	34	0	0	34	0	0
15	43245371	.	T	A	18	16	34	0	3	37	0	0
15	43257039	.	T	C	9	8	17	0	0	17	0	0
15	43260609	.	A	G	7	5	12	0	0	12	0	0
15	43287371	.	C	G	7	2	9	0	0	9	0	0
15	43287431	.	G	A	9	11	20	0	0	20	0	0
15	43287481	.	T	G	9	8	17	0	0	17	0	0
15	43488094	.	C	T	3	5	8	0	0	8	0	0
15	43489679	.	T	C	3	3	6	0	1	7	0	0
15	43509743	.	A	G	2	0	2	0	10	12	0	0
15	43509816	.	T	C	16	9	25	0	0	25	0	0
15	43509864	.	T	C	7	2	9	0	2	11	0	0
15	43509961	.	C	A	1	2	3	0	0	3	0	0
15	43510116	.	A	C	4	7	11	0	0	11	0	0
15	43510448	.	A	T	5	7	12	0	0	12	0	0
15	43510452	.	T	G	5	7	12	0	0	12	0	0
15	43604150	.	G	C	2	5	7	0	0	7	0	0
15	43604190	.	G	A	4	3	7	0	0	7	0	0
15	43604224	.	G	A	5	3	8	0	0	8	0	0
15	43604903	.	C	G	4	5	9	0	0	9	0	0
15	43604928	.	A	G	4	2	6	0	1	7	0	0
15	43604988	.	G	C	3	4	7	0	0	7	0	0
15	43604996	.	A	G	3	3	6	0	1	7	0	0
15	43605309	.	G	T	2	2	4	0	0	4	0	0
15	43605373	.	T	G	1	0	1	0	0	1	0	0
15	43931233	.	G	A	1	4	5	0	1	6	0	0
15	43931714	.	C	T	1	5	6	0	0	6	0	0
15	43984470	.	T	C	1	2	3	0	0	3	0	0
15	44062518	.	G	A	2	5	7	0	0	7	0	0
15	44140546	.	T	C	1	3	4	0	0	4	0	0
15	44141311	.	A	G	5	2	7	0	0	7	0	0
15	44254986	.	A	C	1	2	3	0	0	3	0	0
15	44255001	.	G	A	1	3	4	0	0	4	0	0
15	44255130	.	A	T	2	1	3	0	1	4	0	0
15	44255212	.	A	C	7	3	10	0	0	10	0	0
15	44290546	.	C	T	2	2	4	0	0	4	0	0
15	44295044	.	G	A	1	2	3	0	0	3	0	0
15	44323349	.	T	C	6	3	9	0	1	10	0	0
15	44345243	.	T	A	3	3	6	0	0	6	0	0
15	44385021	.	G	A	4	3	7	0	0	7	0	0
15	44399204	.	C	T	5	3	8	0	0	8	0	0
15	44445243	.	C	T	4	9	13	0	0	13	0	0
15	44447906	.	C	T	5	4	9	0	0	9	0	0
15	44462839	.	C	T	5	2	7	0	0	7	0	0
15	44499445	.	A	G	18	25	43	0	2	45	0	0
15	44499653	.	T	A	30	16	46	0	3	49	0	0
15	44499730	.	C	T	25	22	47	0	0	47	0	0
15	44534976	.	G	A	6	6	12	0	1	13	0	0
15	45027401	.	G	A	6	6	12	0	0	12	0	0
15	45034764	.	C	T	0	2	2	0	2	4	0	0
15	45048200	.	G	A	2	2	4	0	0	4	0	0
15	45056530	.	G	A	4	3	7	0	0	7	0	0
15	45662752	.	A	G	2	0	2	1	6	10	1	0
15	45662753	.	A	G	6	3	9	1	0	10	0	0
15	46662011	.	G	T	15	7	22	3	4	29	0	0
15	46727382	.	G	A	2	4	6	0	0	6	0	0
15	46727571	.	G	A	4	6	10	0	0	10	0	0
15	47336295	.	G	A	16	16	32	0	0	32	0	0
15	47386982	.	T	A	3	5	8	0	0	8	0	0
15	47410231	.	C	A	5	4	9	0	0	9	0	0
15	47418607	.	G	A	0	6	6	0	6	12	0	0
15	47418627	.	G	A	8	7	15	0	0	15	0	0
15	47419090	.	G	A	2	8	10	0	18	28	0	0
15	47419096	.	C	T	15	10	25	0	2	27	0	0
15	47419240	.	C	T	17	13	30	0	0	30	0	0
15	47419394	.	C	T	18	11	29	0	2	31	0	0
15	47419395	.	A	T	18	12	30	0	1	31	0	0
15	47420838	.	T	A	21	24	45	1	3	49	0	0
15	47420920	.	G	C	1	26	27	2	1	30	0	0
15	47421203	.	T	C	9	19	28	0	2	30	0	0
15	47421329	.	A	G	13	9	22	0	1	23	0	0
15	47421669	.	C	T	13	13	26	0	6	32	0	0
15	47421675	.	G	C	15	14	29	0	2	31	0	0
15	47453236	.	C	T	2	2	4	0	0	4	0	0
15	47571414	.	A	C	2	1	3	0	5	8	0	0
15	47571416	.	A	C	0	0	0	0	5	5	0	0
15	47830665	.	C	T	1	2	3	0	0	3	0	0
15	47830837	.	G	T	8	5	13	0	2	15	0	0
15	47830973	.	C	A	10	7	17	0	1	18	0	0
15	47831096	.	C	T	13	14	27	0	2	29	0	0
15	47831195	.	G	C	7	7	14	0	0	14	0	0
15	47831249	.	C	T	5	4	9	0	2	11	0	0
15	47831265	.	T	A	7	3	10	0	0	10	0	0
15	47831495	.	C	G	15	11	26	0	0	26	0	0
15	47831511	.	C	T	0	11	11	0	13	24	0	0
15	47831565	.	C	A	12	7	19	0	1	20	0	0
15	47832424	.	T	G	2	2	4	0	0	4	0	0
15	47833083	.	G	A	5	3	8	0	0	8	0	0
15	47833392	.	G	A	8	5	13	0	0	13	0	0
15	47833395	.	C	T	0	5	5	0	7	12	0	0
15	47833436	.	C	T	0	2	2	0	7	9	0	0
15	47833662	.	C	T	3	1	4	0	1	5	0	0
15	47833814	.	C	T	1	2	3	0	0	3	0	0
15	47845908	.	A	G	22	26	48	0	2	50	0	0
15	47847180	.	T	C	13	1	14	0	12	26	0	0
15	47847373	.	G	A	19	13	32	0	2	34	0	0
15	47848495	.	C	T	19	16	35	0	2	37	0	0
15	47851205	.	T	A	37	28	65	0	3	68	0	0
15	47851342	.	C	G	52	15	67	1	1	69	0	0
15	47851455	.	T	G	29	31	60	0	1	61	0	0
15	47851486	.	G	A	34	23	57	0	6	63	0	0
15	47851522	.	C	T	5	26	31	0	39	70	0	0
15	47851751	.	A	G	28	23	51	1	1	53	0	0
15	47851828	.	G	A	23	13	36	0	2	38	0	0
15	47851978	.	C	T	5	4	9	0	1	10	0	0
15	47851979	.	A	G	5	5	10	0	0	10	0	0
15	47852049	.	G	T	14	6	20	0	0	20	0	0
15	47855085	.	A	G	34	20	54	0	2	56	0	0
15	47856351	.	T	C	9	0	9	11	11	31	0	0
15	47856418	.	T	C	27	16	43	2	4	49	0	0
15	47860443	.	C	T	3	19	22	0	28	50	0	0
16	2009844	.	T	G	3	2	5	0	0	5	0	0
16	2043021	.	C	T	7	2	9	0	0	9	0	0
16	2043122	.	G	C	1	6	7	0	4	11	0	0
16	2102468	.	A	T	3	4	7	0	1	8	0	0
16	2102495	.	A	G	1	1	2	0	4	6	0	0
16	2102683	.	C	T	2	2	4	0	4	8	0	0
16	2102743	.	A	T	4	4	8	0	6	14	0	0
16	2103052	.	C	T	13	3	16	0	0	16	0	0
16	2103058	.	G	T	13	3	16	0	0	16	0	0
16	2103167	.	C	T	15	7	22	0	1	23	0	0
16	2103209	.	C	T	9	8	17	0	1	18	0	0
16	2103241	.	T	A	9	6	15	0	1	16	0	0
16	2103268	.	A	T	6	8	14	0	1	15	0	0
16	2103307	.	T	C	6	11	17	0	4	21	0	0
16	2103714	.	A	T	4	6	10	0	1	11	0	0
16	2103783	.	A	T	1	2	3	0	1	4	0	0
16	2104181	.	T	A	2	2	4	0	1	5	0	0
16	2104312	.	A	C	5	10	15	0	0	15	0	0
16	2104400	.	T	C	11	13	24	0	1	25	0	0
16	2104597	.	T	C	41	16	57	1	3	61	0	0
16	2104604	.	A	G	41	2	43	1	20	64	0	0
16	2105035	.	A	G	5	9	14	0	0	14	0	0
16	2353020	.	C	A	5	3	8	0	2	10	0	0
16	2353023	.	T	C	7	3	10	0	1	11	0	0
16	2353191	.	C	A	5	5	10	0	0	10	0	0
16	2353224	.	A	T	5	2	7	0	1	8	0	0
16	2353226	.	C	A	6	2	8	0	0	8	0	0
16	2360324	.	C	T	3	2	5	0	0	5	0	0
16	2373689	.	T	C	2	2	4	0	0	4	0	0
16	2472263	.	G	A	3	2	5	0	0	5	0	0
16	2472284	.	T	C	2	2	4	0	1	5	0	0
16	2484064	.	C	T	0	4	4	0	3	7	0	0
16	2494323	.	T	C	2	0	2	0	2	4	0	0
16	2495649	.	G	C	1	1	2	0	1	3	0	0
16	2517184	.	G	T	4	4	8	0	0	8	0	0
16	2539405	.	G	A	1	2	3	0	0	3	0	0
16	2567316	.	A	G	9	0	9	0	5	14	0	0
16	2568847	.	G	A	0	3	3	0	15	18	0	0
16	2574963	.	C	T	7	4	11	0	0	11	0	0
16	2577717	.	T	A	11	7	18	0	3	21	0	0
16	2580255	.	T	A	22	10	32	0	1	33	0	0
16	2580340	.	G	A	2	4	6	0	0	6	0	0
16	2637597	.	A	T	1	3	4	0	0	4	0	0
16	2637703	.	C	A	2	3	5	0	0	5	0	0
16	2638472	.	A	C	1	3	4	0	0	4	0	0
16	2638507	.	G	C	1	2	3	0	0	3	0	0
16	4317605	.	A	G	2	2	4	0	0	4	0	0
16	4514740	.	T	C	7	0	7	0	2	9	0	0
16	5014391	.	A	G	4	5	9	0	1	10	0	0
16	5014564	.	A	G	6	8	14	0	2	16	0	0
16	5025494	.	G	A	8	8	16	0	1	17	0	0
16	5086725	.	G	A	7	6	13	0	1	14	0	0
16	5091076	.	G	A	1	2	3	0	0	3	0	0
16	5105119	.	T	G	2	5	7	0	0	7	0	0
16	5105221	.	G	A	6	6	12	0	1	13	0	0
16	5167010	.	A	G	4	0	4	0	4	8	0	0
16	5167050	.	A	G	5	0	5	0	5	10	0	0
16	5167249	.	A	C	4	2	6	0	1	7	0	0
16	5187795	.	G	A	2	3	5	0	0	5	0	0
16	5196630	.	C	T	3	4	7	0	0	7	0	0
16	5199476	.	C	T	1	2	3	0	0	3	0	0
16	5221622	.	T	A	6	4	10	0	1	11	0	0
16	5223206	.	G	A	4	8	12	0	0	12	0	0
16	5223454	.	C	T	3	5	8	0	0	8	0	0
16	5223470	.	G	A	4	4	8	0	0	8	0	0
16	5223880	.	G	C	0	8	8	0	6	14	0	0
16	5224328	.	A	G	13	5	18	0	1	19	0	0
16	5224375	.	G	C	0	13	13	0	7	20	0	0
16	5224429	.	A	T	8	14	22	0	2	24	0	0
16	5496522	.	T	C	3	2	5	0	0	5	0	0
16	5497221	.	C	T	0	2	2	0	3	5	0	0
16	5580914	.	T	C	2	2	4	0	0	4	0	0
16	5601579	.	T	C	1	2	3	0	0	3	0	0
16	5604865	.	A	G	1	3	4	0	0	4	0	0
16	5636328	.	T	G	1	0	1	0	3	4	0	0
16	5700574	.	G	T	1	2	3	0	0	3	0	0
16	5776245	.	T	C	14	10	24	0	2	26	0	0
16	5776356	.	C	T	13	21	34	0	1	35	0	0
16	5776371	.	T	G	14	19	33	0	0	33	0	0
16	5786977	.	G	A	10	4	14	0	1	15	0	0
16	5787435	.	T	C	10	8	18	0	0	18	0	0
16	5787436	.	C	A	10	8	18	0	0	18	0	0
16	5787485	.	T	A	11	7	18	0	0	18	0	0
16	5787519	.	G	A	8	9	17	0	0	17	0	0
16	5787670	.	A	G	5	10	15	0	0	15	0	0
16	5787911	.	T	G	3	5	8	0	0	8	0	0
16	5787931	.	A	G	2	4	6	0	0	6	0	0
16	5787981	.	T	C	2	5	7	0	1	8	0	0
16	5788079	.	A	G	4	2	6	0	1	7	0	0
16	5788451	.	G	A	3	5	8	0	0	8	0	0
16	5788655	.	T	C	2	5	7	0	1	8	0	0
16	5788705	.	T	C	3	3	6	0	0	6	0	0
16	5789340	.	G	C	4	0	4	0	5	9	0	0
16	6101477	.	G	A	1	2	3	0	1	4	0	0
16	6101565	.	C	T	2	2	4	0	0	4	0	0
16	6174231	.	T	C	3	3	6	0	0	6	0	0
16	6182755	.	C	T	21	26	47	0	6	53	0	0
16	6183022	.	A	C	26	13	39	1	5	45	0	0
16	6183658	.	T	G	42	27	69	0	2	71	0	0
16	6191514	.	A	G	27	22	49	0	1	50	0	0
16	6191526	.	G	C	27	17	44	0	3	47	0	0
16	6197212	.	T	C	7	7	14	0	0	14	0	0
16	6356766	.	A	G	4	2	6	0	1	7	0	0
16	6356823	.	T	A	3	4	7	0	0	7	0	0
16	6356850	.	T	C	2	4	6	0	0	6	0	0
16	6356906	.	T	A	1	2	3	0	1	4	0	0
16	6735149	.	C	T	1	1	2	0	1	3	0	0
16	6735161	.	T	A	1	2	3	0	0	3	0	0
16	6745856	.	C	G	2	2	4	0	0	4	0	0
16	6745892	.	A	T	2	2	4	0	0	4	0	0
16	6747256	.	G	T	6	5	11	0	0	12	1	0
16	6782653	.	T	C	5	2	7	0	0	7	0	0
16	6782680	.	T	C	2	2	4	0	1	5	0	0
16	6784866	.	C	T	4	3	7	0	0	7	0	0
16	6787801	.	A	G	4	0	4	0	6	10	0	0
16	6790964	.	C	T	1	3	4	0	0	4	0	0
16	6790978	.	C	T	1	3	4	0	0	4	0	0
16	6792044	.	C	T	7	2	9	0	0	9	0	0
16	6792059	.	C	G	7	2	9	0	1	10	0	0
16	6793312	.	C	T	13	4	17	0	0	17	0	0
16	6793333	.	C	G	9	4	13	0	0	13	0	0
16	6796096	.	C	T	7	7	14	0	1	15	0	0
16	6796118	.	C	T	8	8	16	0	0	16	0	0
16	6796195	.	A	G	8	4	12	0	2	14	0	0
16	6796279	.	T	C	3	6	9	0	0	9	0	0
16	6800033	.	G	A	8	2	10	0	1	11	0	0
16	6800043	.	G	A	0	3	3	0	8	11	0	0
16	6800140	.	C	T	8	4	12	0	1	13	0	0
16	6800209	.	G	A	8	5	13	0	0	13	0	0
16	6800211	.	A	G	7	0	7	0	5	12	0	0
16	6800330	.	G	C	1	4	5	0	6	11	0	0
16	6800383	.	G	A	4	7	11	0	0	11	0	0
16	6803650	.	A	T	19	12	31	4	1	36	0	0
16	6803736	.	G	C	20	12	32	0	0	32	0	0
16	6809872	.	A	G	17	13	30	0	0	30	0	0
16	6820725	.	G	A	9	12	21	0	1	22	0	0
16	6820746	.	G	C	10	13	23	0	0	23	0	0
16	6821214	.	G	A	5	11	16	0	0	16	0	0
16	6821248	.	C	T	1	8	9	0	3	12	0	0
16	6821423	.	A	G	5	13	18	0	2	20	0	0
16	6822014	.	G	A	7	11	18	0	0	18	0	0
16	6864798	.	A	G	1	3	4	0	1	5	0	0
16	6864838	.	G	A	0	3	3	0	2	5	0	0
16	6923824	.	A	G	2	0	2	0	3	5	0	0
16	6932820	.	T	A	1	2	3	0	0	3	0	0
16	6947998	.	T	C	18	18	36	0	0	36	0	0
16	6955048	.	G	A	18	28	46	0	1	47	0	0
16	6955368	.	A	G	12	11	23	2	0	25	0	0
16	7217013	.	A	G	8	14	22	0	0	22	0	0
16	7217052	.	G	T	13	11	24	0	2	26	0	0
16	7220142	.	A	G	4	6	10	0	0	10	0	0
16	7220225	.	C	T	1	5	6	0	4	10	0	0
16	7221846	.	C	T	1	4	5	0	1	6	0	0
16	7239374	.	A	C	2	3	5	0	0	5	0	0
16	7242729	.	A	T	1	4	5	0	0	5	0	0
16	7242735	.	T	A	0	4	4	0	0	4	0	0
16	7250782	.	A	T	3	4	7	0	0	7	0	0
16	7252871	.	T	C	9	16	25	0	0	25	0	0
16	7259719	.	T	C	15	16	31	0	0	31	0	0
16	7259853	.	A	G	1	2	3	0	0	3	0	0
16	7259900	.	A	G	1	6	7	0	1	8	0	0
16	7259956	.	A	T	11	13	24	0	0	24	0	0
16	7259957	.	G	A	10	12	22	0	2	24	0	0
16	7260097	.	A	T	1	6	7	0	1	8	0	0
16	7260156	.	T	C	2	2	4	0	0	4	0	0
16	7260262	.	G	A	6	8	14	0	0	14	0	0
16	7260280	.	T	A	2	8	10	0	1	11	0	0
16	7728408	.	C	T	8	2	10	0	1	11	0	0
16	7730647	.	C	A	4	3	7	0	0	7	0	0
16	7743398	.	C	T	2	6	8	0	3	11	0	0
16	7743598	.	T	A	6	5	11	0	1	12	0	0
16	7745513	.	A	C	4	3	7	0	0	7	0	0
16	7746087	.	T	G	2	2	4	0	1	5	0	0
16	7803192	.	C	A	8	3	11	0	1	12	0	0
16	7803200	.	C	G	8	4	12	0	0	12	0	0
16	7803455	.	C	A	0	3	3	0	1	4	0	0
16	7803492	.	C	G	0	4	4	0	5	9	0	0
16	7803549	.	C	T	0	8	8	0	6	14	0	0
16	7803560	.	A	G	4	6	10	0	2	12	0	0
16	7803627	.	T	A	7	3	10	0	2	12	0	0
16	7803765	.	C	G	5	3	8	1	0	9	0	0
16	7803782	.	C	A	0	2	2	0	3	5	0	0
16	7803905	.	G	C	2	0	2	0	3	5	0	0
16	7803971	.	T	A	4	3	7	0	1	8	0	0
16	7804458	.	A	C	2	2	4	0	0	4	0	0
16	7805410	.	T	G	2	2	4	0	2	6	0	0
16	8027172	.	G	A	0	4	4	0	1	5	0	0
16	8040833	.	C	G	9	3	12	0	1	13	0	0
16	8040843	.	T	G	9	0	9	0	5	14	0	0
16	8040927	.	A	T	9	11	20	0	0	20	0	0
16	8041010	.	A	G	9	8	17	0	1	18	0	0
16	8041173	.	G	A	1	3	4	0	0	4	0	0
16	8041179	.	A	G	2	3	5	0	1	6	0	0
16	8051558	.	T	G	12	17	29	0	11	40	0	0
16	8051941	.	T	C	10	0	10	0	16	26	0	0
16	8052329	.	T	C	15	10	25	0	0	25	0	0
16	8052469	.	G	A	9	10	19	0	0	19	0	0
16	8052652	.	A	G	15	11	26	0	1	27	0	0
16	8052673	.	G	C	12	0	12	0	18	30	0	0
16	8052747	.	A	G	5	11	16	0	1	17	0	0
16	8052831	.	T	A	10	12	22	0	0	22	0	0
16	8052866	.	C	A	1	5	6	4	8	18	0	0
16	8052909	.	T	A	1	2	3	7	1	11	0	0
16	8052982	.	T	C	11	6	17	1	0	18	0	0
16	8053202	.	C	T	4	7	11	0	0	11	0	0
16	8053206	.	T	G	2	6	8	0	2	10	0	0
16	8053716	.	A	G	9	12	21	0	0	21	0	0
16	8053717	.	T	C	8	12	20	0	1	21	0	0
16	8053893	.	A	G	7	2	9	0	0	9	0	0
16	8054434	.	T	C	2	0	2	0	4	6	0	0
16	8298607	.	C	T	6	2	8	0	0	8	0	0
16	8298642	.	T	C	3	5	8	0	0	8	0	0
16	8298915	.	T	C	5	4	9	0	0	9	0	0
16	8299302	.	G	A	1	2	3	0	0	3	0	0
16	8299308	.	T	A	2	2	4	0	0	4	0	0
16	8299476	.	A	T	5	5	10	0	0	10	0	0
16	8300045	.	G	A	1	4	5	0	0	5	0	0
16	8300055	.	C	T	1	5	6	0	0	6	0	0
16	8300101	.	T	C	1	4	5	0	0	5	0	0
16	8300289	.	A	T	2	3	5	0	0	5	0	0
16	8531076	.	A	T	3	2	5	0	0	5	0	0
16	8531251	.	G	T	1	2	3	0	0	3	0	0
16	8531643	.	G	A	3	2	5	0	0	5	0	0
16	8531682	.	C	T	4	2	6	0	0	6	0	0
16	8531744	.	T	C	2	3	5	0	0	5	0	0
16	8532168	.	C	T	1	2	3	0	0	3	0	0
16	8535966	.	C	T	0	2	2	0	1	3	0	0
16	8536034	.	T	A	2	2	4	0	0	4	0	0
16	8536133	.	T	C	3	0	3	0	4	7	0	0
16	8816122	.	G	A	1	2	3	0	0	3	0	0
16	9257317	.	C	T	2	3	5	0	0	5	0	0
16	9275806	.	C	T	13	6	19	0	1	20	0	0
16	9276020	.	C	T	9	9	18	0	1	19	0	0
16	9282707	.	C	T	5	3	8	0	0	8	0	0
16	9286997	.	G	A	3	2	5	0	0	5	0	0
16	9299775	.	A	T	1	2	3	0	0	3	0	0
16	9300314	.	G	A	1	3	4	0	0	4	0	0
16	9412048	.	T	C	5	3	8	0	0	8	0	0
16	9412151	.	T	C	1	8	9	0	0	9	0	0
16	9412177	.	A	G	1	1	2	0	4	6	0	0
16	9412401	.	C	T	4	2	6	0	0	6	0	0
16	9412615	.	T	G	1	3	4	0	0	4	0	0
16	9415124	.	T	A	4	2	6	0	0	6	0	0
16	9415134	.	A	G	0	4	4	0	0	4	0	0
16	9415697	.	T	C	8	5	13	0	0	13	0	0
16	9415740	.	G	A	7	5	12	0	2	14	0	0
16	9415793	.	C	T	2	3	5	0	0	5	0	0
16	9420003	.	G	A	5	9	14	0	0	14	0	0
16	9433855	.	A	G	1	4	5	0	1	6	0	0
16	9446996	.	T	C	3	2	5	0	0	5	0	0
16	9602508	.	C	T	6	3	9	0	0	9	0	0
16	9602523	.	G	A	7	4	11	0	0	11	0	0
16	9602672	.	A	G	5	7	12	0	0	12	0	0
16	9605436	.	A	T	8	12	20	0	2	22	0	0
16	9605728	.	G	C	7	3	10	0	0	10	0	0
16	9605823	.	A	T	4	9	13	0	2	15	0	0
16	9605982	.	C	A	10	10	20	0	0	20	0	0
16	9718216	.	G	A	4	3	7	0	0	7	0	0
16	9724725	.	A	C	5	2	7	0	0	7	0	0
16	9724918	.	G	A	9	6	15	0	0	15	0	0
16	9724919	.	T	A	9	6	15	0	0	15	0	0
16	9724959	.	C	T	7	7	14	0	0	14	0	0
16	9725016	.	C	G	7	5	12	0	0	12	0	0
16	9758956	.	A	G	4	2	6	0	2	8	0	0
16	9759336	.	C	T	4	3	7	0	0	7	0	0
16	9759698	.	A	C	7	4	11	0	0	11	0	0
16	9759703	.	C	G	4	0	4	0	7	11	0	0
16	9759914	.	A	G	2	3	5	0	0	5	0	0
16	9760083	.	T	C	10	4	14	0	0	14	0	0
16	9760085	.	C	A	10	4	14	0	1	15	0	0
16	9760248	.	T	C	8	6	14	0	0	14	0	0
16	9760775	.	G	C	3	5	8	0	1	9	0	0
16	9760783	.	G	A	3	5	8	0	0	8	0	0
16	9760894	.	A	T	8	5	13	0	1	14	0	0
16	9761141	.	G	A	0	10	10	0	10	20	0	0
16	9761525	.	G	A	13	11	24	0	0	24	0	0
16	9771283	.	C	G	12	10	22	0	0	22	0	0
16	9771284	.	T	C	12	10	22	0	0	22	0	0
16	9774187	.	G	A	9	14	23	0	0	23	0	0
16	9774381	.	G	A	22	11	33	0	1	34	0	0
16	9777497	.	T	C	12	22	34	0	2	36	0	0
16	9777613	.	A	G	15	16	31	0	1	32	0	0
16	9777629	.	A	T	10	13	23	0	0	23	0	0
16	9777716	.	A	G	8	7	15	0	1	16	0	0
16	9777789	.	C	T	2	7	9	0	0	9	0	0
16	9785990	.	G	A	7	6	13	0	2	15	0	0
16	9786088	.	C	T	10	4	14	0	0	14	0	0
16	9786097	.	G	A	10	3	13	0	0	13	0	0
16	9787891	.	T	G	16	11	27	0	2	29	0	0
16	9787925	.	A	G	14	18	32	0	1	33	0	0
16	9788005	.	C	T	10	14	24	0	1	25	0	0
16	9788019	.	T	A	17	10	27	0	0	27	0	0
16	9788447	.	T	C	1	7	8	0	0	8	0	0
16	9788504	.	A	T	3	7	10	0	1	11	0	0
16	9788929	.	T	G	7	3	10	0	1	11	0	0
16	9789007	.	A	T	7	11	18	0	1	19	0	0
16	9789015	.	C	G	12	5	17	0	0	17	0	0
16	9789048	.	G	T	7	3	10	0	0	10	0	0
16	9789063	.	A	C	8	3	11	0	0	11	0	0
16	9789097	.	C	T	2	5	7	0	0	7	0	0
16	9789225	.	A	C	8	5	13	0	2	15	0	0
16	9789371	.	C	G	10	0	10	1	4	15	0	0
16	9789513	.	C	G	14	15	29	0	1	31	1	0
16	9810011	.	C	T	0	2	2	0	1	3	0	0
16	9813415	.	C	T	2	2	4	0	0	4	0	0
16	9833482	.	A	T	3	6	9	0	1	10	0	0
16	9833559	.	A	T	4	3	7	0	0	7	0	0
16	9833577	.	G	A	5	2	7	0	4	11	0	0
16	9833791	.	T	A	26	17	43	0	5	48	0	0
16	9833794	.	T	A	30	18	48	0	1	49	0	0
16	9833889	.	C	A	24	13	37	0	1	38	0	0
16	9833974	.	G	A	25	21	46	0	2	48	0	0
16	9834258	.	G	A	15	14	29	1	2	32	0	0
16	9834271	.	C	T	26	11	37	1	1	39	0	0
16	9834491	.	T	A	14	6	20	0	2	22	0	0
16	9834748	.	G	C	4	14	18	0	0	18	0	0
16	9834873	.	G	C	10	8	18	0	1	19	0	0
16	9847149	.	G	A	5	4	9	0	0	9	0	0
16	9978350	.	A	T	16	29	45	0	1	47	1	0
16	10027167	.	G	C	4	0	4	0	7	11	0	0
16	10038938	.	T	C	2	4	6	0	0	6	0	0
16	10038956	.	A	G	2	4	6	0	0	6	0	0
16	10055679	.	A	G	4	3	7	0	0	7	0	0
16	10055730	.	C	A	2	4	6	0	1	7	0	0
16	10055865	.	G	A	2	7	9	0	0	9	0	0
16	10065578	.	G	A	2	4	6	0	0	6	0	0
16	10065869	.	C	T	1	4	5	0	0	5	0	0
16	10066164	.	A	G	7	3	10	0	0	10	0	0
16	10066166	.	T	C	5	3	8	0	0	8	0	0
16	10068125	.	C	G	2	2	4	0	0	4	0	0
16	10199646	.	C	T	0	4	4	0	3	7	0	0
16	10199652	.	A	G	3	4	7	0	0	7	0	0
16	10279330	.	C	T	1	4	5	0	0	5	0	0
16	10283438	.	C	A	8	3	11	0	0	11	0	0
16	10287677	.	T	G	3	3	6	0	0	6	0	0
16	10287996	.	G	A	5	6	11	0	0	11	0	0
16	10288022	.	C	A	6	3	9	0	0	9	0	0
16	10288230	.	A	G	2	2	4	0	0	5	1	0
16	10288260	.	C	T	4	5	9	0	0	9	0	0
16	10288827	.	T	A	1	2	3	0	0	3	0	0
16	10292782	.	A	G	2	2	4	0	0	4	0	0
16	10325723	.	G	A	0	2	2	0	3	5	0	0
16	10325732	.	T	C	2	3	5	0	0	5	0	0
16	10325960	.	G	A	1	5	6	0	4	10	0	0
16	10326092	.	C	T	15	8	23	0	1	24	0	0
16	10326305	.	G	A	1	14	15	0	14	29	0	0
16	10326347	.	T	G	19	0	19	0	10	29	0	0
16	10326704	.	C	T	21	30	51	0	4	55	0	0
16	10326737	.	A	G	20	34	54	0	1	55	0	0
16	10326990	.	G	A	6	26	32	0	21	53	0	0
16	10326993	.	A	T	27	23	50	0	3	53	0	0
16	10327128	.	C	T	16	20	36	0	3	39	0	0
16	10327530	.	C	A	15	21	36	0	0	36	0	0
16	10339436	.	T	C	2	3	5	0	0	5	0	0
16	10339872	.	G	T	4	1	5	0	2	7	0	0
16	10339887	.	C	A	4	3	7	0	0	7	0	0
16	10340621	.	T	A	2	1	3	0	0	3	0	0
16	10340630	.	G	C	1	3	4	0	0	4	0	0
16	10340840	.	G	A	3	3	6	0	1	7	0	0
16	10340891	.	A	G	1	6	7	0	0	7	0	0
16	10340941	.	T	C	3	2	5	0	0	5	0	0
16	10341452	.	G	A	6	5	11	0	1	12	0	0
16	10341470	.	G	A	6	5	11	0	1	12	0	0
16	10341508	.	A	G	5	7	12	0	0	12	0	0
16	10341548	.	G	A	2	8	10	0	0	10	0	0
16	10341778	.	C	A	1	2	3	0	1	4	0	0
16	10342169	.	C	T	6	2	8	0	0	8	0	0
16	10342275	.	C	T	2	7	9	0	1	10	0	0
16	10345595	.	A	G	8	14	22	0	1	23	0	0
16	10367961	.	C	T	3	2	5	0	1	6	0	0
16	10368594	.	C	A	1	2	3	0	0	3	0	0
16	10413815	.	C	A	2	3	5	0	0	5	0	0
16	10422417	.	C	T	1	2	3	0	0	3	0	0
16	10422423	.	A	G	1	2	3	0	0	3	0	0
16	10427656	.	G	A	0	2	2	0	2	4	0	0
16	10427964	.	A	C	4	4	8	0	0	8	0	0
16	10448008	.	G	C	2	4	6	0	0	6	0	0
16	10454950	.	G	A	0	2	2	0	2	4	0	0
16	10461712	.	A	T	2	2	4	0	1	5	0	0
16	10464534	.	A	C	6	6	12	0	0	12	0	0
16	10464570	.	T	C	10	7	17	0	0	17	0	0
16	10464609	.	A	G	10	5	15	0	0	15	0	0
16	10468283	.	T	C	4	6	10	0	0	10	0	0
16	10472192	.	T	C	9	12	21	0	1	22	0	0
16	10475006	.	C	T	14	14	28	0	1	29	0	0
16	10475646	.	A	G	10	8	18	0	2	20	0	0
16	10477836	.	C	T	1	11	12	0	18	30	0	0
16	10478061	.	G	T	17	13	30	0	2	33	1	0
16	10481488	.	C	T	3	13	16	0	10	26	0	0
16	10485445	.	G	A	13	13	26	0	3	29	0	0
16	10489410	.	G	A	8	5	13	0	0	13	0	0
16	10502069	.	A	G	5	4	9	0	1	10	0	0
16	10504444	.	C	A	5	3	8	0	0	8	0	0
16	10634510	.	C	T	1	3	4	0	0	4	0	0
16	10635338	.	A	T	1	5	6	0	2	8	0	0
16	10635532	.	T	C	2	6	8	0	0	8	0	0
16	10635551	.	A	C	3	6	9	0	1	10	0	0
16	10635838	.	T	C	4	3	7	0	0	7	0	0
16	10635927	.	A	G	3	3	6	0	0	6	0	0
16	10636173	.	A	G	9	3	12	0	1	13	0	0
16	10636241	.	T	G	4	5	9	0	1	10	0	0
16	10636252	.	A	T	3	4	7	0	1	8	0	0
16	10636418	.	T	C	3	2	5	0	0	5	0	0
16	10636611	.	A	G	2	6	8	0	0	8	0	0
16	10636671	.	C	T	6	4	10	0	0	10	0	0
16	10636698	.	T	A	7	6	13	0	0	13	0	0
16	10636882	.	C	T	7	3	10	0	0	10	0	0
16	10636947	.	T	G	5	0	5	0	3	8	0	0
16	10637050	.	C	T	7	11	18	0	0	18	0	0
16	10637192	.	G	A	0	4	4	0	13	17	0	0
16	10637329	.	C	A	8	5	13	0	1	14	0	0
16	10637379	.	T	A	9	5	14	0	2	16	0	0
16	10637510	.	T	C	8	9	17	0	0	17	0	0
16	10637544	.	T	C	4	5	9	0	0	9	0	0
16	10637629	.	T	C	1	5	6	2	0	8	0	0
16	10637701	.	T	A	5	4	9	0	0	9	0	0
16	10637943	.	T	A	3	4	7	0	0	7	0	0
16	10731571	.	A	T	1	3	4	0	0	4	0	0
16	10732051	.	A	G	2	0	2	0	2	4	0	0
16	10732162	.	T	C	3	3	6	0	0	6	0	0
16	10732174	.	C	A	3	3	6	0	0	6	0	0
16	10732197	.	T	A	3	5	8	0	0	8	0	0
16	10732218	.	T	C	2	4	6	0	0	6	0	0
16	10732280	.	C	T	2	2	4	0	0	4	0	0
16	10732284	.	A	G	3	2	5	0	0	5	0	0
16	10734032	.	A	C	7	4	11	3	1	15	0	0
16	10801374	.	T	C	3	7	10	0	1	11	0	0
16	10801422	.	G	A	4	7	11	0	0	11	0	0
16	10801517	.	T	C	3	6	9	0	0	9	0	0
16	10807360	.	T	A	4	4	8	0	2	10	0	0
16	10807471	.	A	G	4	6	10	0	0	10	0	0
16	10807486	.	C	T	5	5	10	0	0	10	0	0
16	10813372	.	C	T	12	6	18	0	1	19	0	0
16	10815907	.	A	G	26	2	28	0	26	54	0	0
16	10819971	.	C	T	28	19	47	0	0	47	0	0
16	10819972	.	C	T	23	19	42	0	6	48	0	0
16	10820157	.	G	A	4	33	37	0	32	69	0	0
16	10820215	.	A	T	38	22	60	0	3	63	0	0
16	10820224	.	T	A	40	26	66	0	0	66	0	0
16	10820803	.	C	T	29	28	57	0	14	71	0	0
16	10820866	.	A	G	15	11	26	0	6	32	0	0
16	10828887	.	T	C	4	2	6	0	0	6	0	0
16	10829256	.	T	A	10	3	13	0	1	14	0	0
16	10829276	.	T	A	4	4	8	0	1	9	0	0
16	10829458	.	T	C	12	0	12	0	12	24	0	0
16	10829569	.	A	T	11	5	16	0	0	16	0	0
16	10829633	.	A	T	8	5	13	0	0	13	0	0
16	10829635	.	A	C	8	4	12	0	1	13	0	0
16	10829703	.	T	C	2	4	6	0	2	8	0	0
16	10829968	.	T	G	12	5	17	1	1	19	0	0
16	10830013	.	T	G	11	9	20	0	0	20	0	0
16	10830145	.	T	G	4	8	12	0	0	12	0	0
16	10830147	.	T	A	2	8	10	0	2	12	0	0
16	10830309	.	T	A	9	5	14	0	0	14	0	0
16	10830328	.	T	C	7	6	13	0	0	13	0	0
16	10830625	.	G	C	6	3	9	0	0	9	0	0
16	10833900	.	C	G	1	2	3	0	0	3	0	0
16	10841193	.	T	C	5	4	9	0	0	9	0	0
16	10841612	.	T	C	3	3	6	0	0	6	0	0
16	10843402	.	A	G	5	0	5	0	13	18	0	0
16	10846654	.	A	G	8	10	18	0	3	21	0	0
16	10855924	.	A	G	9	11	20	0	5	25	0	0
16	10856130	.	A	G	7	4	11	0	0	11	0	0
16	10856235	.	C	G	12	6	18	0	2	20	0	0
16	10856406	.	A	T	5	3	8	0	0	8	0	0
16	10858395	.	C	T	6	5	11	0	1	12	0	0
16	10858554	.	G	A	10	8	18	0	0	18	0	0
16	10858656	.	A	G	12	11	23	0	0	23	0	0
16	10859434	.	C	T	27	19	46	0	2	48	0	0
16	10859435	.	T	C	26	18	44	0	5	49	0	0
16	10859857	.	T	C	30	29	59	0	2	61	0	0
16	10861956	.	A	G	24	19	43	0	2	45	0	0
16	10861971	.	T	A	20	17	37	0	2	39	0	0
16	10862331	.	C	G	17	15	32	0	4	36	0	0
16	10862627	.	G	A	6	20	26	0	35	61	0	0
16	10862762	.	C	T	29	20	49	0	3	52	0	0
16	10862773	.	T	C	30	20	50	0	1	51	0	0
16	10919223	.	C	G	2	3	5	0	0	5	0	0
16	10919235	.	T	G	2	3	5	0	1	6	0	0
16	10919482	.	C	A	0	2	2	0	2	4	0	0
16	11139933	.	A	G	0	3	3	0	1	4	0	0
16	11140001	.	A	G	0	0	0	0	3	3	0	0
16	11140004	.	G	A	1	2	3	0	0	3	0	0
16	11140267	.	A	G	1	3	4	0	0	4	0	0
16	11140274	.	G	T	1	3	4	0	0	4	0	0
16	11140322	.	A	G	5	1	6	0	4	10	0	0
16	11140364	.	A	G	5	3	8	0	1	9	0	0
16	11140427	.	A	G	6	3	9	0	2	11	0	0
16	11140455	.	A	G	8	1	9	0	7	16	0	0
16	11140475	.	T	C	5	8	13	0	0	13	0	0
16	11140494	.	T	C	4	8	12	0	1	13	0	0
16	11140542	.	G	T	0	3	3	0	4	7	0	0
16	11140586	.	A	T	4	5	9	0	0	9	0	0
16	11140791	.	A	G	2	3	5	0	0	5	0	0
16	11140803	.	A	T	1	3	4	0	1	5	0	0
16	11141908	.	G	A	0	7	7	0	6	13	0	0
16	11142018	.	G	A	0	11	11	0	9	20	0	0
16	11142064	.	G	A	10	5	15	0	1	16	0	0
16	11142111	.	A	G	8	3	11	0	0	11	0	0
16	11170334	.	C	T	1	1	2	0	1	3	0	0
16	11188937	.	G	A	0	2	2	0	5	7	0	0
16	11195922	.	G	A	3	4	7	0	0	7	0	0
16	11199190	.	A	G	4	0	4	0	4	8	0	0
16	11199220	.	C	T	4	6	10	0	0	10	0	0
16	11206313	.	A	C	7	6	13	0	1	14	0	0
16	11206316	.	C	T	7	8	15	0	1	16	0	0
16	11212111	.	C	A	16	9	25	0	2	27	0	0
16	11212332	.	A	T	5	6	11	0	0	11	0	0
16	11212398	.	A	G	12	10	22	0	2	24	0	0
16	11212438	.	A	G	14	0	14	0	13	27	0	0
16	11215495	.	C	T	17	8	25	0	2	27	0	0
16	11215515	.	T	C	14	8	22	0	0	22	0	0
16	11221071	.	A	G	16	14	30	0	1	31	0	0
16	11221398	.	G	A	9	13	22	0	2	24	0	0
16	11221406	.	A	C	9	11	20	0	3	23	0	0
16	11221667	.	A	G	12	8	20	0	0	20	0	0
16	11222030	.	T	A	19	11	30	1	3	34	0	0
16	11222139	.	G	A	19	12	31	0	1	32	0	0
16	11222738	.	G	A	2	18	20	0	31	51	0	0
16	11227434	.	C	T	4	6	10	0	0	10	0	0
16	11227611	.	G	A	7	6	13	0	0	13	0	0
16	11227702	.	G	T	5	3	8	0	0	8	0	0
16	11227711	.	G	A	4	4	8	0	0	8	0	0
16	11227813	.	A	T	2	6	8	0	2	10	0	0
16	11227865	.	C	T	3	3	6	0	3	9	0	0
16	11228292	.	T	G	3	3	6	0	0	6	0	0
16	11229095	.	A	G	1	2	3	0	0	3	0	0
16	11229594	.	T	C	3	2	5	0	0	5	0	0
16	11242495	.	T	A	3	4	7	0	0	7	0	0
16	11242542	.	C	G	1	2	3	0	0	3	0	0
16	11275795	.	C	T	4	10	14	0	2	16	0	0
16	11275980	.	A	G	4	0	4	0	4	8	0	0
16	11290844	.	C	A	1	6	7	0	1	8	0	0
16	11290975	.	A	C	6	4	10	0	0	10	0	0
16	11291799	.	T	C	19	16	35	1	3	39	0	0
16	11291803	.	G	A	21	14	35	2	1	38	0	0
16	11533864	.	T	C	2	3	5	0	0	5	0	0
16	11542083	.	C	T	4	2	6	0	0	6	0	0
16	11544525	.	C	T	7	2	9	0	1	10	0	0
16	11544636	.	A	G	6	2	8	0	1	9	0	0
16	11544645	.	A	T	5	2	7	0	2	9	0	0
16	11544672	.	T	C	7	4	11	0	0	11	0	0
16	11554859	.	C	T	10	7	17	0	0	17	0	0
16	11554874	.	A	G	8	0	8	0	8	16	0	0
16	11554907	.	T	C	10	8	18	0	1	19	0	0
16	11554916	.	A	G	10	6	16	0	1	17	0	0
16	11554970	.	A	C	8	8	16	0	1	17	0	0
16	11555034	.	A	C	12	14	26	0	2	28	0	0
16	11555111	.	A	G	4	0	4	0	16	20	0	0
16	11555160	.	C	T	22	9	31	0	0	31	0	0
16	11555542	.	T	A	12	15	27	0	4	31	0	0
16	11774168	.	G	A	18	11	29	0	0	29	0	0
16	11774237	.	T	C	14	0	14	0	17	31	0	0
16	11774291	.	G	A	12	13	25	0	2	27	0	0
16	11774336	.	C	T	2	7	9	0	9	18	0	0
16	11774361	.	T	C	8	3	11	0	1	12	0	0
16	11774508	.	C	G	2	3	5	0	1	6	0	0
16	11774948	.	T	A	13	5	18	0	1	19	0	0
16	11775200	.	A	G	3	4	7	0	0	7	0	0
16	11775279	.	T	C	9	5	14	0	0	14	0	0
16	11775361	.	T	C	8	5	13	0	1	14	0	0
16	11775614	.	G	A	14	8	22	0	1	23	0	0
16	11775683	.	T	C	7	6	13	0	0	13	0	0
16	11778299	.	G	A	4	2	6	0	0	6	0	0
16	11778302	.	T	A	2	2	4	0	2	6	0	0
16	11965673	.	G	T	26	13	39	3	3	45	0	0
16	11965803	.	G	T	22	18	40	0	0	40	0	0
16	11965931	.	T	C	21	2	23	0	18	41	0	0
16	11968056	.	A	G	4	12	16	0	0	16	0	0
16	11970128	.	A	G	9	6	15	0	0	15	0	0
16	11970161	.	G	A	11	6	17	0	2	19	0	0
16	11978028	.	A	G	4	7	11	0	0	11	0	0
16	11978045	.	G	A	3	5	8	0	2	10	0	0
16	11978094	.	A	C	2	5	7	0	1	8	0	0
16	11979494	.	G	A	7	4	11	0	0	11	0	0
16	11982507	.	T	A	1	5	6	0	0	6	0	0
16	11982519	.	G	T	2	5	7	0	0	7	0	0
16	11986208	.	G	A	2	3	5	0	0	5	0	0
16	11986257	.	G	A	6	3	9	0	0	9	0	0
16	11986258	.	C	T	0	3	3	0	6	9	0	0
16	12052487	.	T	C	1	2	3	0	0	3	0	0
16	12054138	.	C	T	0	3	3	0	3	6	0	0
16	12064771	.	T	A	6	4	10	0	2	13	1	0
16	12064906	.	A	T	11	3	14	0	1	15	0	0
16	12064980	.	G	T	9	8	17	0	2	19	0	0
16	12065201	.	C	T	14	11	25	0	1	26	0	0
16	12065410	.	A	G	8	9	17	0	1	18	0	0
16	12069729	.	C	T	0	9	9	0	8	17	0	0
16	12076492	.	A	G	3	9	12	0	0	12	0	0
16	12076537	.	C	T	3	3	6	0	0	6	0	0
16	12078916	.	A	G	6	4	10	0	0	10	0	0
16	12078976	.	C	T	2	2	4	0	0	4	0	0
16	12102432	.	T	A	23	15	38	0	6	44	0	0
16	12102492	.	A	T	29	27	56	0	1	57	0	0
16	12102709	.	G	A	38	34	72	0	1	73	0	0
16	12103083	.	T	C	29	2	31	0	27	58	0	0
16	12103263	.	A	T	35	21	56	0	1	58	1	0
16	12103292	.	A	T	33	20	53	0	2	55	0	0
16	12103598	.	G	A	21	14	35	0	1	36	0	0
16	12103732	.	C	T	1	10	11	0	4	15	0	0
16	12103934	.	C	T	23	14	37	0	4	41	0	0
16	12103941	.	A	G	24	15	39	0	3	42	0	0
16	12104209	.	A	C	28	9	37	0	1	38	0	0
16	12104344	.	C	T	1	5	6	0	19	25	0	0
16	12104454	.	T	C	26	15	41	1	0	42	0	0
16	12104455	.	G	A	26	15	41	1	0	42	0	0
16	12104736	.	C	A	27	8	35	0	2	37	0	0
16	12104905	.	A	T	25	5	30	0	2	32	0	0
16	12104925	.	C	G	23	17	40	0	0	40	0	0
16	12105689	.	C	T	2	11	13	0	7	20	0	0
16	12105720	.	T	C	10	8	18	0	0	18	0	0
16	12105854	.	A	G	21	13	34	0	3	37	0	0
16	12108607	.	G	A	13	12	25	0	2	27	0	0
16	12114975	.	G	A	8	6	14	0	0	14	0	0
16	12115290	.	G	A	5	3	8	0	0	8	0	0
16	12150457	.	A	G	2	2	4	0	0	4	0	0
16	12150460	.	C	T	2	1	3	0	1	4	0	0
16	12175007	.	A	T	6	2	8	0	0	8	0	0
16	12175047	.	T	G	8	4	12	0	0	12	0	0
16	12340701	.	T	C	1	0	1	0	4	5	0	0
16	12504991	.	A	G	1	6	7	0	0	7	0	0
16	12505009	.	C	T	1	7	8	0	0	8	0	0
16	12505303	.	G	T	29	28	57	0	1	58	0	0
16	12637696	.	T	C	1	3	4	0	0	4	0	0
16	12637779	.	C	T	5	3	8	0	1	9	0	0
16	12638612	.	C	G	2	2	4	0	0	4	0	0
16	12639156	.	T	A	8	5	13	0	0	13	0	0
16	12639161	.	C	G	8	0	8	0	5	13	0	0
16	12639320	.	C	G	1	3	4	0	0	4	0	0
16	12639377	.	T	G	4	6	10	0	0	10	0	0
16	12639503	.	T	G	2	3	5	0	0	5	0	0
16	12639617	.	C	G	5	0	5	0	4	9	0	0
16	12674720	.	A	G	1	4	5	0	0	5	0	0
16	12711835	.	C	T	0	1	1	0	2	3	0	0
16	12730412	.	G	A	3	2	5	0	0	5	0	0
16	12738351	.	T	C	2	2	4	0	1	5	0	0
16	12740926	.	C	T	4	3	7	0	0	7	0	0
16	12740949	.	C	G	4	4	8	0	0	8	0	0
16	12747312	.	A	G	3	3	6	0	1	7	0	0
16	12748517	.	A	T	9	8	17	0	0	17	0	0
16	12748646	.	G	A	1	11	12	0	12	24	0	0
16	12748857	.	G	A	3	10	13	0	0	13	0	0
16	12748908	.	G	C	0	9	9	0	8	17	0	0
16	12748989	.	T	C	9	12	21	0	1	22	0	0
16	12754621	.	A	G	10	1	11	0	22	33	0	0
16	12754690	.	C	T	19	18	37	0	0	37	0	0
16	12754849	.	T	C	13	18	31	0	2	33	0	0
16	12755260	.	G	A	2	12	14	0	21	35	0	0
16	12755992	.	C	T	24	24	48	0	2	50	0	0
16	12756051	.	G	T	21	15	36	0	1	37	0	0
16	12756255	.	C	T	15	17	32	0	0	32	0	0
16	12794028	.	A	G	7	3	10	0	0	10	0	0
16	12816745	.	A	C	8	4	12	0	0	12	0	0
16	12818220	.	G	T	10	11	21	0	0	21	0	0
16	12963109	.	A	G	7	5	12	0	1	13	0	0
16	12963696	.	T	G	15	30	45	0	5	50	0	0
16	12963975	.	A	G	18	13	31	0	1	32	0	0
16	13180298	.	T	C	2	6	8	0	1	9	0	0
16	13180299	.	T	C	6	2	8	0	1	9	0	0
16	13180389	.	T	C	7	9	16	0	0	16	0	0
16	13181465	.	T	C	7	4	11	0	0	11	0	0
16	13453623	.	T	A	1	2	3	0	0	3	0	0
16	13568841	.	A	G	1	2	3	0	0	3	0	0
16	13568844	.	A	T	1	2	3	0	0	3	0	0
16	13569025	.	G	A	1	2	3	0	0	3	0	0
16	13569058	.	T	A	2	2	4	0	0	4	0	0
16	13599957	.	G	A	14	11	25	0	1	26	0	0
16	13601026	.	T	C	9	10	19	0	0	19	0	0
16	13602164	.	T	C	3	6	9	0	0	9	0	0
16	13602454	.	T	A	4	5	9	0	1	10	0	0
16	13602488	.	T	C	6	4	10	0	0	10	0	0
16	13602697	.	A	G	3	3	6	0	2	8	0	0
16	13602800	.	T	A	2	7	9	0	0	9	0	0
16	13602922	.	A	G	4	2	6	0	0	6	0	0
16	13603375	.	C	T	1	7	8	0	0	8	0	0
16	13606896	.	A	T	1	3	4	0	0	4	0	0
16	13606977	.	G	A	2	3	5	0	0	5	0	0
16	13610726	.	T	A	2	4	6	0	1	7	0	0
16	13610882	.	G	A	3	4	7	0	1	8	0	0
16	13616338	.	G	A	5	3	8	0	0	8	0	0
16	13617023	.	C	T	0	8	8	0	13	21	0	0
16	13617152	.	C	T	11	10	21	0	0	21	0	0
16	13617291	.	G	A	13	6	19	0	0	19	0	0
16	13617329	.	T	G	11	8	19	0	0	19	0	0
16	13618170	.	A	G	7	8	15	0	1	16	0	0
16	13618172	.	C	G	8	6	14	0	3	17	0	0
16	13618374	.	A	T	10	11	21	0	0	21	0	0
16	13618644	.	T	A	6	5	11	0	1	12	0	0
16	13619001	.	A	C	3	6	9	0	0	9	0	0
16	13619319	.	T	A	4	2	6	0	0	6	0	0
16	13619436	.	A	G	3	3	6	0	0	6	0	0
16	13619448	.	T	C	1	3	4	0	0	4	0	0
16	13619509	.	G	T	3	4	7	0	0	7	0	0
16	13621752	.	G	A	2	2	4	0	0	4	0	0
16	13623641	.	A	C	5	6	11	0	0	11	0	0
16	13636760	.	G	A	11	10	21	0	2	23	0	0
16	13643969	.	C	A	2	8	10	0	0	10	0	0
16	13644509	.	A	T	2	2	4	0	0	4	0	0
16	13645242	.	G	C	1	2	3	0	0	3	0	0
16	13673143	.	T	C	11	11	22	0	3	25	0	0
16	13673660	.	T	A	5	6	11	0	0	11	0	0
16	13673734	.	A	C	5	7	12	0	0	12	0	0
16	13679037	.	A	G	1	2	3	0	0	3	0	0
16	13701482	.	C	T	7	10	17	0	1	18	0	0
16	13701599	.	A	G	3	4	7	0	0	7	0	0
16	13706061	.	G	A	10	3	13	0	0	13	0	0
16	13706207	.	G	C	9	7	16	0	0	16	0	0
16	13706714	.	G	T	8	3	11	0	0	11	0	0
16	13721408	.	C	T	5	3	8	0	2	10	0	0
16	13721420	.	G	A	6	4	10	0	0	10	0	0
16	13729810	.	C	T	8	4	12	0	2	14	0	0
16	13789765	.	G	A	1	3	4	0	0	4	0	0
16	13826195	.	C	T	4	2	6	0	0	6	0	0
16	13841360	.	T	A	9	14	23	0	0	23	0	0
16	13845368	.	G	A	0	10	10	0	13	23	0	0
16	13845846	.	A	G	9	13	22	0	0	22	0	0
16	13855142	.	T	C	1	2	3	0	0	3	0	0
16	13855472	.	T	C	3	6	9	0	0	9	0	0
16	13855482	.	T	A	5	4	9	0	0	9	0	0
16	13870508	.	A	C	6	6	12	0	0	12	0	0
16	13870517	.	A	G	7	7	14	0	0	14	0	0
16	13870685	.	A	C	7	2	9	0	0	9	0	0
16	13870857	.	T	A	7	4	11	0	0	11	0	0
16	13883968	.	C	A	5	5	10	0	0	10	0	0
16	13883980	.	A	C	5	5	10	0	1	11	0	0
16	13911867	.	C	G	2	4	6	0	0	6	0	0
16	13911896	.	A	G	1	2	3	0	0	3	0	0
16	13912179	.	C	T	1	4	5	0	0	5	0	0
16	13912221	.	T	A	1	3	4	0	0	4	0	0
16	13912503	.	C	T	0	2	2	0	1	3	0	0
16	13912513	.	G	A	0	2	2	0	0	2	0	0
16	14016057	.	T	C	3	3	6	0	0	6	0	0
16	14021817	.	G	T	3	12	15	0	1	16	0	0
16	14021886	.	C	T	12	6	18	0	1	19	0	0
16	14021907	.	T	A	13	6	19	0	0	19	0	0
16	14022035	.	A	C	14	5	19	0	0	19	0	0
16	14022445	.	T	C	10	6	16	0	2	18	0	0
16	14022585	.	C	A	9	4	13	0	0	13	0	0
16	14022697	.	T	A	12	9	21	1	0	22	0	0
16	14022975	.	G	T	4	2	6	0	0	6	0	0
16	14022976	.	T	A	4	2	6	0	0	6	0	0
16	14051150	.	G	C	5	5	10	0	0	10	0	0
16	14051249	.	T	C	2	7	9	0	3	12	0	0
16	14051329	.	A	T	7	5	12	0	0	12	0	0
16	14051339	.	A	C	9	4	13	0	0	13	0	0
16	14052681	.	A	G	9	4	13	0	4	17	0	0
16	14093909	.	T	A	4	3	7	0	0	7	0	0
16	14094219	.	A	G	6	5	11	0	0	11	0	0
16	14094222	.	C	A	6	5	11	0	1	12	0	0
16	14094364	.	A	C	4	6	10	0	0	10	0	0
16	14094422	.	C	G	15	11	26	0	1	27	0	0
16	14094601	.	G	A	11	11	22	0	0	22	0	0
16	14094604	.	T	A	10	10	20	0	0	20	0	0
16	14094640	.	G	T	7	8	15	0	0	15	0	0
16	14094668	.	T	A	8	8	16	0	0	16	0	0
16	14094801	.	C	T	11	5	16	0	0	16	0	0
16	14094806	.	G	A	12	5	17	0	0	17	0	0
16	14095126	.	T	A	6	4	10	0	1	11	0	0
16	14095176	.	A	T	6	6	12	0	0	12	0	0
16	14095183	.	G	C	6	6	12	0	0	12	0	0
16	14095279	.	C	A	7	13	20	1	0	21	0	0
16	14095397	.	A	C	8	13	21	0	0	21	0	0
16	14095563	.	A	C	5	1	6	0	8	14	0	0
16	14098014	.	C	T	3	9	12	0	0	12	0	0
16	14101832	.	G	A	7	6	13	0	0	13	0	0
16	14101864	.	T	C	6	11	17	0	0	17	0	0
16	14126267	.	C	T	2	11	13	0	1	14	0	0
16	14126294	.	T	C	3	8	11	0	0	11	0	0
16	14133317	.	G	A	2	2	4	0	1	5	0	0
16	14133521	.	G	A	3	7	10	0	0	10	0	0
16	14133547	.	G	T	6	4	10	0	0	10	0	0
16	14133721	.	C	T	1	5	6	0	0	6	0	0
16	14133734	.	A	C	1	5	6	0	0	6	0	0
16	14133910	.	C	G	5	4	9	0	0	9	0	0
16	14134020	.	C	T	0	2	2	0	2	4	0	0
16	14154150	.	T	G	1	3	4	0	0	4	0	0
16	14154240	.	T	A	1	2	3	0	1	4	0	0
16	14155605	.	T	A	3	3	6	0	0	6	0	0
16	14156865	.	A	G	1	3	4	0	0	4	0	0
16	14202111	.	A	C	4	2	6	0	1	7	0	0
16	14202116	.	C	T	4	2	6	0	0	6	0	0
16	14202192	.	A	C	6	2	8	0	0	8	0	0
16	14209142	.	A	C	6	4	10	0	0	10	0	0
16	14209195	.	G	A	13	5	18	0	0	18	0	0
16	14209348	.	T	C	8	5	13	0	0	13	0	0
16	14210949	.	A	C	5	7	12	0	0	12	0	0
16	14212079	.	G	C	1	3	4	0	4	8	0	0
16	14214498	.	G	A	8	4	12	0	0	12	0	0
16	14214534	.	G	A	8	5	13	0	1	14	0	0
16	14214543	.	A	G	8	5	13	0	1	14	0	0
16	14214961	.	G	C	6	5	11	0	0	11	0	0
16	14230071	.	A	G	6	0	6	0	3	9	0	0
16	14230141	.	A	G	6	1	7	0	3	10	0	0
16	14230204	.	A	G	5	0	5	0	4	9	0	0
16	14230222	.	A	G	4	6	10	0	0	10	0	0
16	14230373	.	T	C	4	2	6	0	0	6	0	0
16	14231135	.	G	A	1	5	6	0	10	16	0	0
16	14231138	.	C	T	10	5	15	0	0	15	0	0
16	14231928	.	C	A	10	14	24	0	1	25	0	0
16	14240609	.	G	A	5	5	10	0	0	10	0	0
16	14242688	.	C	T	0	4	4	0	8	12	0	0
16	14269975	.	C	T	3	4	7	0	0	7	0	0
16	14416876	.	T	G	5	4	9	0	1	10	0	0
16	14671097	.	A	T	1	4	5	0	0	5	0	0
16	14671098	.	A	C	1	4	5	0	0	5	0	0
16	14671135	.	A	G	2	4	6	0	0	6	0	0
16	14674706	.	C	T	7	5	12	0	0	12	0	0
16	14674718	.	T	G	7	7	14	0	0	14	0	0
16	14674788	.	T	G	1	3	4	0	0	4	0	0
16	14674801	.	G	T	2	3	5	0	0	5	0	0
16	14674855	.	A	G	2	2	4	0	0	4	0	0
16	14674923	.	A	T	2	2	4	0	0	4	0	0
16	14675016	.	A	G	7	0	7	0	3	10	0	0
16	14675101	.	T	A	10	5	15	0	0	15	0	0
16	14675373	.	A	C	4	11	15	0	0	15	0	0
16	14675513	.	A	C	8	4	12	0	1	13	0	0
16	14675658	.	A	G	11	14	25	0	2	27	0	0
16	14675780	.	A	G	12	3	15	0	2	17	0	0
16	15028355	.	T	G	1	1	2	0	2	4	0	0
16	15034906	.	C	T	3	3	6	0	0	6	0	0
16	15037775	.	G	A	2	5	7	0	0	7	0	0
16	15037778	.	C	T	5	2	7	0	0	7	0	0
16	15048253	.	T	C	8	9	17	0	0	17	0	0
16	15048338	.	G	A	0	4	4	0	5	9	0	0
16	15049760	.	A	C	2	6	8	0	0	8	0	0
16	15050195	.	T	C	3	2	5	0	3	8	0	0
16	15050277	.	G	A	8	3	11	0	0	11	0	0
16	15050372	.	C	T	16	18	34	0	1	35	0	0
16	15050478	.	T	A	18	10	28	1	2	31	0	0
16	15140987	.	G	A	0	2	2	0	4	6	0	0
16	15165153	.	A	G	3	3	6	0	0	6	0	0
16	15168740	.	G	A	2	3	5	0	0	5	0	0
16	15943424	.	C	T	4	7	11	0	0	11	0	0
16	15944980	.	A	T	1	5	6	0	1	7	0	0
16	15958358	.	T	C	3	3	6	0	0	6	0	0
16	16042986	.	T	C	9	12	21	0	1	22	0	0
16	16165179	.	T	A	33	32	65	0	2	67	0	0
16	16165361	.	A	G	40	36	76	0	2	78	0	0
16	16165418	.	C	T	46	27	73	0	2	75	0	0
16	16165725	.	A	C	31	37	68	0	5	73	0	0
16	16232963	.	T	C	2	2	4	0	1	5	0	0
16	16233410	.	A	G	5	11	16	0	0	16	0	0
16	16234309	.	C	A	0	4	4	0	5	9	0	0
16	16234840	.	A	T	6	8	14	0	2	16	0	0
16	16234985	.	A	G	4	2	6	0	2	8	0	0
16	16275288	.	T	C	1	3	4	0	0	4	0	0
16	16278013	.	A	T	3	2	5	0	0	5	0	0
16	16278043	.	T	C	2	2	4	0	0	4	0	0
16	16278172	.	G	T	2	2	4	0	0	4	0	0
16	16281479	.	A	C	1	4	5	0	0	5	0	0
16	16281740	.	A	C	4	2	6	0	0	6	0	0
16	16281869	.	T	A	2	6	8	0	0	8	0	0
16	16284057	.	T	C	5	4	9	0	0	9	0	0
16	16284159	.	G	A	0	11	11	0	5	16	0	0
16	16284192	.	C	A	10	13	23	0	0	23	0	0
16	16289121	.	C	T	15	5	20	0	0	20	0	0
16	16297057	.	G	A	7	8	15	0	0	15	0	0
16	16302166	.	T	C	12	8	20	0	0	20	0	0
16	16302247	.	A	T	9	7	16	0	1	17	0	0
16	16302371	.	A	C	11	8	19	0	1	20	0	0
16	16302426	.	T	A	12	10	22	0	2	24	0	0
16	16302477	.	G	A	1	8	9	0	7	16	0	0
16	16302835	.	T	C	9	19	28	0	1	29	0	0
16	16303025	.	C	T	10	24	34	0	2	36	0	0
16	16303065	.	A	G	17	13	30	0	0	30	0	0
16	16303086	.	T	A	18	8	26	0	1	27	0	0
16	16303163	.	G	A	1	16	17	0	13	30	0	0
16	16303196	.	A	G	18	0	18	0	13	31	0	0
16	16303293	.	T	G	8	11	19	0	0	19	0	0
16	16547388	.	C	T	7	9	16	0	1	17	0	0
16	16553899	.	C	T	11	12	23	0	0	23	0	0
16	16555157	.	T	A	1	2	3	0	0	3	0	0
16	16555611	.	A	G	3	11	14	0	0	14	0	0
16	16565963	.	G	C	5	2	7	0	0	7	0	0
16	16566402	.	G	A	5	2	7	0	0	7	0	0
16	16569047	.	G	A	1	2	3	0	0	3	0	0
16	16597754	.	G	A	1	3	4	0	1	5	0	0
16	16940768	.	A	G	1	0	1	0	4	5	0	0
16	16941121	.	G	A	1	4	5	0	0	5	0	0
16	16941237	.	G	A	1	4	5	0	6	11	0	0
16	16941270	.	G	A	0	3	3	0	4	7	0	0
16	16941394	.	C	T	7	2	9	0	1	10	0	0
16	16941741	.	C	T	6	3	9	0	0	9	0	0
16	16942200	.	C	T	4	3	7	0	0	7	0	0
16	16942293	.	T	A	3	3	6	0	2	8	0	0
16	16942332	.	G	A	6	4	10	0	0	10	0	0
16	16942867	.	A	G	10	9	19	0	0	19	0	0
16	16942906	.	C	G	12	9	21	0	1	22	0	0
16	16942953	.	A	G	11	6	17	0	0	17	0	0
16	16943258	.	C	A	6	4	10	0	1	11	0	0
16	16943348	.	C	A	6	7	13	0	0	13	0	0
16	16943388	.	T	A	4	8	12	0	0	12	0	0
16	16943651	.	A	T	8	8	16	0	1	17	0	0
16	16944023	.	G	T	12	10	22	0	1	23	0	0
16	16944066	.	T	C	6	5	11	0	1	12	0	0
16	16944142	.	A	T	6	7	13	0	2	15	0	0
16	16944150	.	T	C	7	7	14	0	0	14	0	0
16	16944884	.	A	G	7	12	19	0	0	19	0	0
16	16945261	.	A	G	4	4	8	0	0	8	0	0
16	16945328	.	G	A	12	9	21	0	0	21	0	0
16	16945365	.	T	G	12	13	25	0	0	25	0	0
16	16945585	.	A	C	4	3	7	0	2	9	0	0
16	17194355	.	A	G	2	2	4	0	1	5	0	0
16	17194984	.	A	G	1	3	4	0	0	4	0	0
16	17195160	.	G	A	1	5	6	0	0	6	0	0
16	17207612	.	G	A	19	15	34	0	0	34	0	0
16	17235001	.	G	A	3	3	6	0	0	6	0	0
16	17235018	.	A	T	4	2	6	0	0	6	0	0
16	17235730	.	A	G	2	3	5	0	0	5	0	0
16	17238490	.	A	G	1	2	3	0	0	3	0	0
16	17240607	.	C	G	1	3	4	0	0	4	0	0
16	17252909	.	G	C	10	5	15	0	0	15	0	0
16	17253056	.	T	C	4	5	9	0	0	9	0	0
16	17253085	.	C	T	5	4	9	0	0	9	0	0
16	17253274	.	T	C	2	5	7	0	0	7	0	0
16	17254689	.	G	T	3	3	6	0	0	6	0	0
16	17254761	.	T	C	5	6	11	0	0	11	0	0
16	17256120	.	C	T	2	5	7	0	0	7	0	0
16	17302526	.	T	C	3	4	7	0	1	8	0	0
16	17311420	.	A	G	1	2	3	0	0	3	0	0
16	17311447	.	T	C	1	2	3	0	0	3	0	0
16	17316632	.	G	A	1	2	3	0	0	3	0	0
16	17549015	.	C	A	1	4	5	0	2	7	0	0
16	17580032	.	C	T	1	6	7	0	2	9	0	0
16	17580401	.	C	T	3	3	6	0	0	6	0	0
16	17580836	.	C	T	2	2	4	0	0	4	0	0
16	17581021	.	A	T	6	4	10	0	0	10	0	0
16	17639989	.	T	A	18	11	29	1	0	30	0	0
16	17640184	.	C	T	6	10	16	0	0	16	0	0
16	17640297	.	G	A	9	5	14	0	0	14	0	0
16	17640550	.	A	T	9	8	17	0	2	19	0	0
16	17640693	.	G	A	5	10	15	0	1	16	0	0
16	17646269	.	T	C	6	6	12	0	0	12	0	0
16	17764238	.	G	A	3	6	9	0	0	9	0	0
16	17798055	.	T	C	4	6	10	0	0	10	0	0
16	17798056	.	C	T	4	6	10	0	0	10	0	0
16	18087402	.	A	T	6	4	10	0	0	10	0	0
16	18146283	.	A	G	5	4	9	0	0	9	0	0
16	18535689	.	G	A	5	2	7	0	0	7	0	0
16	18552492	.	C	T	1	3	4	0	1	5	0	0
16	18570439	.	C	T	6	3	9	0	0	9	0	0
16	19126439	.	A	G	3	0	3	0	6	9	0	0
16	19136322	.	C	T	2	2	4	0	0	4	0	0
16	19150814	.	T	A	5	5	10	0	0	10	0	0
16	19150952	.	T	A	8	7	15	0	0	15	0	0
16	19151187	.	T	G	3	10	13	0	1	14	0	0
16	19151189	.	T	G	4	9	13	0	1	14	0	0
16	19151254	.	A	G	6	3	9	0	2	11	0	0
16	19151680	.	A	T	10	7	17	0	1	18	0	0
16	19151694	.	T	C	6	5	11	0	1	12	0	0
16	19151742	.	C	T	4	2	6	1	1	8	0	0
16	19151765	.	T	C	3	3	6	0	0	6	0	0
16	19182273	.	T	C	4	2	6	0	0	6	0	0
16	19537565	.	G	A	1	2	3	0	0	3	0	0
16	19538712	.	C	G	3	0	3	0	3	6	0	0
16	19538840	.	G	A	5	2	7	0	0	7	0	0
16	19538982	.	T	A	1	4	5	0	1	6	0	0
16	19539574	.	C	A	5	4	9	0	0	9	0	0
16	19840562	.	T	C	15	16	31	0	2	33	0	0
16	19840645	.	T	A	13	6	19	0	1	20	0	0
16	19840658	.	A	C	10	9	19	0	5	24	0	0
16	19840867	.	A	G	20	12	32	0	0	32	0	0
16	19841082	.	C	G	0	20	20	0	17	37	0	0
16	19841135	.	C	T	12	14	26	2	0	28	0	0
16	19841290	.	A	T	7	8	15	0	0	15	0	0
16	19841358	.	C	T	5	11	16	0	1	17	0	0
16	19841422	.	A	G	5	7	12	0	1	13	0	0
16	19841432	.	G	A	4	2	6	0	1	7	0	0
16	19841502	.	A	T	5	4	9	0	0	9	0	0
16	19841591	.	A	G	6	10	16	0	2	18	0	0
16	19841720	.	A	G	7	3	10	0	1	11	0	0
16	19841786	.	A	T	1	7	8	0	0	8	0	0
16	19842493	.	G	A	4	4	8	0	0	8	0	0
16	19842530	.	A	G	2	3	5	0	2	7	0	0
16	19843053	.	G	T	8	5	13	0	0	13	0	0
16	19843056	.	G	T	5	8	13	0	0	13	0	0
16	19853074	.	G	A	9	5	14	0	1	15	0	0
16	19853098	.	C	T	6	3	9	0	0	9	0	0
16	20151770	.	A	G	2	5	7	1	1	9	0	0
16	20151841	.	T	C	7	5	12	0	4	16	0	0
16	20151936	.	A	G	11	10	21	0	0	21	0	0
16	20152044	.	C	A	8	4	12	0	1	16	3	0
16	20152106	.	A	T	4	9	13	0	0	13	0	0
16	20152203	.	A	G	8	1	9	0	4	13	0	0
16	20152250	.	T	C	3	6	9	0	0	9	0	0
16	20152405	.	A	G	3	6	9	0	0	9	0	0
16	20152474	.	A	G	6	5	11	0	0	11	0	0
16	20152476	.	C	A	6	5	11	0	0	11	0	0
16	20193844	.	C	G	3	2	5	0	0	5	0	0
16	20238905	.	G	C	1	3	4	0	1	5	0	0
16	20238932	.	G	A	2	3	5	0	0	5	0	0
16	20265655	.	T	C	4	0	4	0	4	8	0	0
16	20265702	.	G	A	3	4	7	0	0	7	0	0
16	20265815	.	A	C	6	0	6	0	9	15	0	0
16	20265928	.	C	T	3	5	8	0	0	8	0	0
16	20265936	.	T	A	1	4	5	0	0	5	0	0
16	20266106	.	T	C	1	4	5	0	1	6	0	0
16	20266109	.	T	A	1	5	6	0	0	6	0	0
16	20266840	.	T	A	9	4	13	0	1	14	0	0
16	20267303	.	T	C	6	2	8	0	1	9	0	0
16	20324870	.	C	T	2	4	6	0	0	6	0	0
16	20371350	.	A	G	1	3	4	0	0	4	0	0
16	20402139	.	G	T	1	3	4	0	0	4	0	0
16	20403022	.	C	A	0	1	1	0	2	3	0	0
16	20513152	.	A	G	7	12	19	0	1	20	0	0
16	20514814	.	G	A	2	6	8	0	0	8	0	0
16	20514816	.	C	T	2	6	8	0	0	8	0	0
16	20792982	.	T	A	4	6	10	0	0	10	0	0
16	20800347	.	C	T	4	5	9	0	1	10	0	0
16	20806006	.	C	T	6	4	10	0	0	10	0	0
16	20806747	.	A	G	29	11	40	0	1	41	0	0
16	20813628	.	C	T	4	14	18	0	15	33	0	0
16	20815743	.	A	G	19	15	34	0	0	34	0	0
16	20822708	.	T	G	10	13	23	0	0	23	0	0
16	20822881	.	T	C	9	4	13	0	1	14	0	0
16	20824508	.	C	G	11	5	16	0	0	16	0	0
16	20824566	.	C	T	8	10	18	0	1	19	0	0
16	20826697	.	T	C	6	15	21	0	0	21	0	0
16	20836218	.	G	A	5	14	19	0	1	20	0	0
16	20836870	.	G	A	6	6	12	0	0	12	0	0
16	20855582	.	G	A	2	6	8	0	0	8	0	0
16	20874252	.	T	C	4	4	8	0	0	8	0	0
16	20889292	.	G	A	13	5	18	0	1	19	0	0
16	20889325	.	C	T	10	3	13	0	0	13	0	0
16	22006970	.	C	A	4	2	6	0	0	6	0	0
16	23353727	.	G	A	2	3	5	0	0	5	0	0
16	23385909	.	A	G	1	3	4	0	0	4	0	0
16	23388400	.	A	T	9	10	19	0	0	19	0	0
16	23399307	.	T	C	2	4	6	0	1	7	0	0
16	23431212	.	C	A	6	3	9	0	0	9	0	0
16	23515116	.	C	T	3	3	6	0	0	6	0	0
16	23515122	.	T	A	2	3	5	0	0	5	0	0
16	23556448	.	T	C	6	8	14	0	1	15	0	0
16	23556748	.	A	G	5	0	5	0	11	16	0	0
16	23556758	.	C	T	5	11	16	0	0	16	0	0
16	23556822	.	A	G	6	9	15	0	0	15	0	0
16	23557013	.	G	A	4	1	5	0	1	6	0	0
16	23557051	.	T	C	1	3	4	0	0	4	0	0
16	23557175	.	T	A	1	2	3	0	0	3	0	0
16	23718419	.	G	C	10	13	23	0	1	24	0	0
16	23718687	.	A	G	6	9	15	0	1	16	0	0
16	23718700	.	A	G	4	6	10	0	1	11	0	0
16	23788830	.	A	G	44	30	74	0	5	79	0	0
16	23809311	.	A	C	3	6	9	0	0	9	0	0
16	23821654	.	T	A	4	2	6	0	0	6	0	0
16	23831836	.	A	T	2	1	3	0	2	5	0	0
16	23831892	.	C	T	3	4	7	0	2	9	0	0
16	23832045	.	T	A	1	2	3	0	0	3	0	0
16	23832302	.	T	C	3	2	5	0	0	5	0	0
16	23832304	.	A	T	3	2	5	0	0	5	0	0
16	23832520	.	A	C	5	4	9	0	1	10	0	0
16	23832561	.	T	C	6	6	12	0	0	12	0	0
16	23832589	.	G	A	3	5	8	0	0	8	0	0
16	23832646	.	A	T	7	5	12	0	0	12	0	0
16	23832695	.	A	G	5	5	10	0	2	12	0	0
16	23833070	.	A	C	10	4	14	0	1	15	0	0
16	23833121	.	A	G	5	6	11	0	0	11	0	0
16	23833274	.	T	A	7	5	12	0	0	12	0	0
16	23833284	.	T	C	6	3	9	0	1	10	0	0
16	23833309	.	A	T	8	4	12	0	0	12	0	0
16	23833347	.	T	A	11	6	17	0	0	17	0	0
16	23833377	.	G	T	11	6	17	0	1	18	0	0
16	23833420	.	G	T	9	3	12	0	0	12	0	0
16	23833442	.	G	A	7	1	8	0	1	9	0	0
16	23833528	.	A	T	6	5	11	0	1	12	0	0
16	23833723	.	A	G	4	12	16	0	0	16	0	0
16	23833916	.	G	A	5	2	7	0	1	8	0	0
16	23834001	.	A	C	4	13	17	1	0	18	0	0
16	23834513	.	T	G	8	3	11	0	1	12	0	0
16	23834540	.	T	C	11	7	18	0	0	18	0	0
16	23834554	.	A	G	8	10	18	0	7	25	0	0
16	23834859	.	A	G	13	4	17	0	1	18	0	0
16	23834885	.	A	T	12	8	20	0	2	22	0	0
16	23864527	.	T	C	1	3	4	0	0	4	0	0
16	23864902	.	G	A	3	6	9	0	0	9	0	0
16	23864905	.	C	T	3	5	8	0	0	8	0	0
16	23869305	.	T	C	8	4	12	0	1	13	0	0
16	23901394	.	C	T	3	2	5	0	0	5	0	0
16	23901420	.	G	C	1	4	5	0	1	6	0	0
16	23902179	.	C	T	2	7	9	0	0	9	0	0
16	23902235	.	T	C	2	6	8	0	0	8	0	0
16	23902285	.	C	G	1	5	6	0	0	6	0	0
16	23902330	.	T	C	2	4	6	0	1	7	0	0
16	23961308	.	T	C	2	3	5	0	1	6	0	0
16	23961878	.	C	T	5	4	9	0	0	9	0	0
16	23962007	.	G	A	10	5	15	0	1	16	0	0
16	23963241	.	C	T	24	14	38	0	0	38	0	0
16	23963257	.	G	T	20	18	38	0	1	39	0	0
16	23972939	.	G	A	14	4	18	0	2	20	0	0
16	23973691	.	C	T	2	3	5	0	0	5	0	0
16	24517791	.	A	T	2	2	4	0	0	4	0	0
16	24552024	.	A	T	6	5	11	0	0	11	0	0
16	24552155	.	A	C	7	7	14	0	0	14	0	0
16	24552176	.	C	G	6	9	15	0	2	17	0	0
16	24552215	.	C	T	9	7	16	0	0	16	0	0
16	24552368	.	A	T	8	2	10	0	0	10	0	0
16	24552369	.	A	T	8	2	10	0	0	10	0	0
16	24552459	.	A	G	3	5	8	0	0	8	0	0
16	24552801	.	A	G	5	5	10	0	0	10	0	0
16	24552826	.	G	A	6	5	11	0	0	11	0	0
16	24553450	.	T	C	3	5	8	0	0	8	0	0
16	24553464	.	G	T	4	3	7	0	0	7	0	0
16	24553663	.	T	G	1	2	3	0	1	4	0	0
16	24590541	.	C	T	3	4	7	0	0	7	0	0
16	24590767	.	T	A	13	23	36	1	0	37	0	0
16	24590804	.	G	T	10	24	34	0	4	39	1	0
16	24590823	.	C	T	13	23	36	0	4	40	0	0
16	24590950	.	T	A	16	12	28	0	0	28	0	0
16	24590999	.	A	G	13	12	25	0	2	27	0	0
16	24591010	.	G	A	15	11	26	0	0	26	0	0
16	24591036	.	T	C	18	9	27	0	0	27	0	0
16	24591074	.	G	A	18	16	34	0	0	34	0	0
16	24591172	.	A	G	14	13	27	0	2	29	0	0
16	24591207	.	T	G	8	8	16	0	1	17	0	0
16	24591379	.	C	T	5	10	15	0	0	15	0	0
16	24591422	.	C	A	3	7	10	0	0	10	0	0
16	24596192	.	C	T	7	13	20	1	1	22	0	0
16	24632148	.	T	C	5	7	12	0	1	13	0	0
16	24632306	.	C	A	7	12	19	0	0	19	0	0
16	24637342	.	G	T	5	8	13	0	1	14	0	0
16	24637369	.	A	C	5	7	12	0	1	13	0	0
16	24639396	.	G	A	7	10	17	0	2	19	0	0
16	24645240	.	C	T	10	7	17	0	0	17	0	0
16	24645448	.	C	G	9	10	19	0	1	20	0	0
16	24645476	.	A	T	9	11	20	0	2	22	0	0
16	24645769	.	T	G	7	0	7	0	5	12	0	0
16	24645796	.	G	A	13	5	18	0	1	19	0	0
16	24645820	.	A	T	12	4	16	0	0	16	0	0
16	24645888	.	G	T	6	2	8	0	1	9	0	0
16	24645895	.	C	G	5	4	9	0	1	10	0	0
16	24645978	.	A	T	3	3	6	0	0	6	0	0
16	24646000	.	A	T	2	4	6	0	0	6	0	0
16	24646620	.	T	C	3	3	6	0	2	8	0	0
16	24669991	.	T	C	1	7	8	0	0	8	0	0
16	24670059	.	C	T	1	6	7	0	0	7	0	0
16	24670062	.	G	A	2	5	7	0	0	7	0	0
16	24692635	.	T	C	20	31	51	0	4	55	0	0
16	24692685	.	A	G	24	3	27	0	34	61	0	0
16	24695295	.	C	G	37	24	61	0	2	63	0	0
16	24695301	.	T	C	37	26	63	0	2	65	0	0
16	24695520	.	G	A	42	35	77	0	1	78	0	0
16	24695551	.	G	A	6	28	34	0	33	67	0	0
16	24725170	.	G	A	2	3	5	0	0	5	0	0
16	24727766	.	G	A	1	3	4	0	0	4	0	0
16	24727826	.	A	T	1	3	4	0	1	5	0	0
16	24729093	.	G	C	2	2	4	0	0	5	1	0
16	24732829	.	A	G	5	0	5	0	11	16	0	0
16	24732869	.	G	T	4	15	19	0	0	19	0	0
16	24732921	.	C	A	8	13	21	0	0	21	0	0
16	24733125	.	A	G	5	4	9	0	0	9	0	0
16	24733127	.	A	G	5	4	9	0	0	9	0	0
16	24991391	.	T	C	7	2	9	1	0	10	0	0
16	24991695	.	T	G	1	2	3	0	1	4	0	0
16	24991741	.	T	C	2	3	5	0	0	5	0	0
16	25033659	.	C	A	2	2	4	0	0	4	0	0
16	25033953	.	G	A	1	2	3	0	0	3	0	0
16	25034416	.	A	C	1	3	4	0	0	4	0	0
16	25034682	.	A	G	3	0	3	0	3	6	0	0
16	25035024	.	T	G	2	0	2	0	7	9	0	0
16	25035129	.	A	G	1	6	7	0	0	7	0	0
16	25035169	.	G	T	1	3	4	0	0	4	0	0
16	25035906	.	A	T	2	2	4	0	1	5	0	0
16	25038011	.	T	C	13	11	24	0	2	26	0	0
16	25038412	.	A	G	9	12	21	0	2	23	0	0
16	25038429	.	C	T	11	8	19	0	0	19	0	0
16	25038689	.	A	C	4	2	6	0	0	6	0	0
16	25038696	.	A	T	2	3	5	0	1	6	0	0
16	25078815	.	G	C	3	6	9	0	0	9	0	0
16	25095659	.	C	T	2	4	6	0	0	6	0	0
16	25096098	.	A	G	3	2	5	0	0	5	0	0
16	25104031	.	T	C	23	13	36	0	1	37	0	0
16	25104196	.	A	G	6	13	19	0	0	19	0	0
16	25104226	.	A	G	4	12	16	0	1	17	0	0
16	25104454	.	C	G	20	11	31	0	2	33	0	0
16	25104595	.	C	T	14	16	30	0	0	30	0	0
16	25104850	.	A	C	10	15	25	0	2	27	0	0
16	25107378	.	A	T	1	2	3	0	0	3	0	0
16	25112760	.	C	T	2	2	4	0	0	4	0	0
16	25114362	.	C	T	5	5	10	0	1	11	0	0
16	25114450	.	G	A	1	6	7	0	4	11	0	0
16	25114451	.	C	G	5	6	11	0	0	11	0	0
16	25114508	.	C	A	3	5	8	0	0	8	0	0
16	25114522	.	A	C	5	6	11	0	0	11	0	0
16	25114546	.	A	G	5	5	10	0	0	10	0	0
16	25114848	.	A	G	9	10	19	0	0	19	0	0
16	25114881	.	T	C	8	14	22	0	3	25	0	0
16	25114944	.	T	C	17	11	28	0	1	29	0	0
16	25122086	.	G	T	2	3	5	0	0	5	0	0
16	25122193	.	C	T	2	2	4	0	1	5	0	0
16	25122240	.	C	T	3	3	6	0	0	6	0	0
16	25122929	.	A	G	7	5	12	0	0	12	0	0
16	25122933	.	A	G	4	0	4	0	7	11	0	0
16	25122964	.	A	G	3	2	5	0	0	5	0	0
16	25123348	.	A	G	7	0	7	0	3	10	0	0
16	25123424	.	A	G	4	1	5	0	1	6	0	0
16	25123435	.	A	G	1	2	3	0	0	3	0	0
16	25123832	.	A	G	4	4	8	0	0	8	0	0
16	25123843	.	T	A	3	4	7	0	0	7	0	0
16	25123938	.	A	G	3	5	8	0	0	8	0	0
16	25124138	.	T	G	1	6	7	0	0	7	0	0
16	25124163	.	T	G	1	0	1	0	4	5	0	0
16	25124203	.	T	C	2	2	4	0	0	4	0	0
16	25124662	.	G	T	4	4	8	0	0	8	0	0
16	25124763	.	A	T	4	5	9	0	0	9	0	0
16	25124832	.	C	T	5	4	9	0	0	9	0	0
16	25149254	.	G	T	1	2	3	0	0	3	0	0
16	25149878	.	T	C	1	1	2	0	1	3	0	0
16	25150086	.	T	C	3	2	5	0	0	5	0	0
16	25150087	.	A	C	3	2	5	0	0	5	0	0
16	25151419	.	G	A	1	3	4	0	0	4	0	0
16	25151456	.	G	A	1	2	3	0	0	3	0	0
16	25161292	.	A	G	3	3	6	0	0	6	0	0
16	25161315	.	T	C	2	4	6	0	0	6	0	0
16	25161420	.	G	T	1	2	3	0	5	8	0	0
16	25161739	.	T	C	6	9	15	0	1	16	0	0
16	25161876	.	T	C	10	8	18	0	1	19	0	0
16	25162514	.	G	A	1	6	7	1	8	16	0	0
16	25162516	.	T	C	8	6	14	1	0	15	0	0
16	25162563	.	G	A	5	3	8	0	0	8	0	0
16	25162814	.	A	T	2	2	4	0	0	4	0	0
16	25167828	.	T	C	3	5	8	0	0	8	0	0
16	25169003	.	A	G	12	11	23	0	0	23	0	0
16	25177248	.	G	A	1	2	3	0	4	7	0	0
16	25180485	.	T	C	3	6	9	0	0	9	0	0
16	25180534	.	C	T	2	5	7	0	0	7	0	0
16	25180561	.	C	A	3	5	8	0	0	8	0	0
16	25180642	.	G	A	6	3	9	0	0	9	0	0
16	25180846	.	T	C	6	5	11	0	1	12	0	0
16	25181046	.	A	G	5	3	8	0	0	8	0	0
16	25181113	.	T	C	4	3	7	0	0	7	0	0
16	25181350	.	A	T	1	2	3	0	0	3	0	0
16	25272268	.	A	T	1	3	4	0	0	4	0	0
16	25275984	.	C	T	0	8	8	0	14	22	0	0
16	25283378	.	A	G	12	6	18	0	0	18	0	0
16	25283402	.	G	T	12	7	19	0	0	19	0	0
16	25311654	.	G	A	7	5	12	0	1	13	0	0
16	25314708	.	G	A	9	4	13	0	0	13	0	0
16	25314900	.	G	A	4	6	10	0	0	10	0	0
16	25314933	.	G	C	4	4	8	0	0	8	0	0
16	25327155	.	C	A	6	10	16	0	1	17	0	0
16	25327730	.	C	T	3	2	5	0	0	5	0	0
16	25329319	.	C	T	4	7	11	0	2	13	0	0
16	25334326	.	A	G	12	13	25	0	4	29	0	0
16	25334353	.	T	C	12	14	26	0	0	26	0	0
16	25337665	.	T	G	7	13	20	0	1	21	0	0
16	25348860	.	C	T	2	3	5	0	0	5	0	0
16	25349279	.	T	C	4	3	7	0	0	7	0	0
16	25352923	.	A	G	2	0	2	0	2	4	0	0
16	25354336	.	G	A	6	5	11	0	0	11	0	0
16	25354571	.	A	G	4	0	4	0	3	7	0	0
16	25357980	.	T	A	5	2	7	0	0	7	0	0
16	25357989	.	C	T	5	2	7	0	0	7	0	0
16	25360557	.	T	A	7	6	13	0	0	13	0	0
16	25360605	.	C	A	6	9	15	0	1	16	0	0
16	25373900	.	A	C	5	4	9	0	0	9	0	0
16	25373924	.	G	A	4	7	11	0	1	12	0	0
16	25373979	.	T	A	6	7	13	0	0	13	0	0
16	25374247	.	G	T	5	2	7	0	0	8	1	0
16	25374441	.	C	T	1	4	5	0	7	12	0	0
16	25374508	.	T	G	9	10	19	0	0	19	0	0
16	25391411	.	A	G	6	5	11	0	0	11	0	0
16	25393277	.	G	T	5	4	9	0	1	10	0	0
16	25395154	.	G	T	4	9	13	0	2	15	0	0
16	25395700	.	A	T	4	5	9	0	0	9	0	0
16	25395702	.	G	T	4	5	9	0	0	9	0	0
16	25399585	.	A	T	2	4	6	0	0	6	0	0
16	25399588	.	A	T	3	4	7	0	0	7	0	0
16	25500137	.	A	G	2	4	6	0	0	6	0	0
16	25504122	.	C	T	0	3	3	0	7	10	0	0
16	25504180	.	C	T	4	13	17	0	14	31	0	0
16	25504315	.	C	T	27	11	38	0	0	38	0	0
16	25504337	.	G	A	21	9	30	0	1	31	0	0
16	25504398	.	A	T	16	9	25	0	0	25	0	0
16	25504537	.	T	C	20	4	24	0	11	35	0	0
16	25504585	.	C	T	18	18	36	1	2	39	0	0
16	25504642	.	G	A	16	35	51	0	0	51	0	0
16	25507392	.	C	T	1	30	31	0	26	57	0	0
16	25507485	.	G	A	17	28	45	0	0	45	0	0
16	25507536	.	G	A	1	4	5	0	0	5	0	0
16	25507643	.	T	A	5	5	10	0	0	10	0	0
16	25507696	.	T	C	5	5	10	0	0	10	0	0
16	25519635	.	A	G	7	6	13	0	0	13	0	0
16	25527541	.	T	G	2	8	10	0	1	11	0	0
16	25535229	.	C	T	0	7	7	0	3	10	0	0
16	25535283	.	T	C	2	4	6	0	0	6	0	0
16	25555806	.	A	G	19	9	28	0	0	28	0	0
16	25556384	.	G	T	8	18	26	0	1	27	0	0
16	25557690	.	C	T	3	6	9	0	0	9	0	0
16	25558007	.	C	G	1	6	7	0	5	12	0	0
16	25558223	.	A	G	5	2	7	0	0	7	0	0
16	25558351	.	C	T	1	4	5	0	6	11	0	0
16	25558600	.	G	A	10	4	14	0	2	16	0	0
16	25558845	.	G	A	3	5	8	0	0	8	0	0
16	25558986	.	A	G	3	5	8	0	1	9	0	0
16	25559028	.	A	C	7	3	10	0	0	10	0	0
16	25559165	.	A	C	4	6	10	0	0	10	0	0
16	25559193	.	A	G	3	4	7	0	0	7	0	0
16	25559274	.	C	T	2	2	4	0	0	4	0	0
16	25559743	.	A	T	2	5	7	0	1	8	0	0
16	25559837	.	G	A	5	2	7	0	0	7	0	0
16	25593973	.	G	A	3	5	8	0	0	8	0	0
16	25594415	.	C	T	3	2	5	0	1	6	0	0
16	25641050	.	G	A	6	11	17	0	0	17	0	0
16	25642713	.	T	A	15	11	26	0	0	26	0	0
16	25642848	.	C	A	8	8	16	2	11	29	0	0
16	25643818	.	G	T	6	7	13	0	1	14	0	0
16	25649498	.	C	T	1	2	3	0	1	4	0	0
16	25673880	.	T	C	8	6	14	0	0	14	0	0
16	25683018	.	T	C	8	8	16	0	2	18	0	0
16	25683152	.	A	T	9	11	20	0	1	21	0	0
16	25683440	.	G	T	11	10	21	0	4	25	0	0
16	25688709	.	C	A	3	6	9	0	1	10	0	0
16	25798557	.	T	C	2	2	4	0	0	4	0	0
16	25798561	.	C	T	1	2	3	0	1	4	0	0
16	26021245	.	A	G	12	7	19	0	0	19	0	0
16	26021930	.	T	A	1	2	3	0	0	3	0	0
16	26027081	.	G	T	9	4	13	0	3	16	0	0
16	26027158	.	A	T	14	8	22	0	2	24	0	0
16	26030380	.	T	A	7	8	15	0	0	15	0	0
16	26039945	.	C	T	0	3	3	0	2	5	0	0
16	26141290	.	G	T	6	5	11	0	2	13	0	0
16	26141295	.	T	A	5	7	12	0	0	12	0	0
16	26141395	.	C	A	3	11	14	0	0	14	0	0
16	26141396	.	T	C	3	0	3	0	11	14	0	0
16	26141599	.	T	A	10	5	15	0	1	16	0	0
16	26141665	.	T	C	7	7	14	0	0	14	0	0
16	26141817	.	T	G	12	4	16	0	0	16	0	0
16	26141880	.	T	A	1	2	3	0	2	5	0	0
16	26142703	.	A	T	1	4	5	0	0	5	0	0
16	26151592	.	G	A	1	2	3	0	0	3	0	0
16	26234381	.	G	A	2	7	9	0	0	9	0	0
16	26234401	.	A	G	3	6	9	1	0	10	0	0
16	26234460	.	C	T	2	4	6	0	0	6	0	0
16	26234732	.	T	C	3	4	7	0	0	7	0	0
16	26234772	.	T	C	8	4	12	0	0	12	0	0
16	26236028	.	C	T	0	3	3	0	5	8	0	0
16	26236030	.	T	G	5	3	8	0	0	8	0	0
16	26237122	.	T	C	0	3	3	0	1	4	0	0
16	26381538	.	T	C	6	10	16	0	0	16	0	0
16	26384219	.	G	A	2	2	4	0	0	4	0	0
16	26444480	.	C	T	5	3	8	0	1	9	0	0
16	26444541	.	G	T	4	3	7	0	0	7	0	0
16	26444569	.	A	T	6	3	9	0	0	9	0	0
16	26444634	.	G	T	2	3	5	0	0	5	0	0
16	26444644	.	A	T	0	1	1	0	1	2	0	0
16	26444938	.	A	T	5	4	9	0	0	9	0	0
16	26444954	.	T	A	4	3	7	0	0	7	0	0
16	26444976	.	T	A	2	4	6	0	0	6	0	0
16	26445032	.	C	T	4	4	8	0	0	8	0	0
16	26445990	.	G	A	4	5	9	0	0	9	0	0
16	26446005	.	G	A	1	2	3	0	0	3	0	0
16	26510740	.	C	A	3	2	5	0	0	5	0	0
16	26510997	.	G	A	1	4	5	0	0	5	0	0
16	26513182	.	G	A	2	2	4	0	0	4	0	0
16	26516813	.	G	C	4	3	7	0	0	7	0	0
16	26600209	.	A	G	2	2	4	0	0	4	0	0
16	26631682	.	C	T	7	9	16	0	1	17	0	0
16	26634530	.	T	A	4	5	9	0	1	10	0	0
16	26643769	.	A	T	1	5	6	0	0	6	0	0
16	26702745	.	T	C	5	4	9	0	1	10	0	0
16	26702870	.	T	C	8	8	16	0	0	16	0	0
16	26703111	.	T	C	3	4	7	0	0	7	0	0
16	26706551	.	G	A	7	5	12	0	0	12	0	0
16	26706584	.	G	A	4	3	7	0	1	8	0	0
16	26706623	.	T	C	4	5	9	0	0	9	0	0
16	26706840	.	T	A	7	7	14	0	2	16	0	0
16	26710729	.	C	T	6	11	17	0	1	18	0	0
16	26710777	.	G	A	2	12	14	0	13	27	0	0
16	26710798	.	C	T	13	12	25	0	1	26	0	0
16	26710900	.	C	A	10	15	25	0	1	26	0	0
16	26710954	.	A	T	11	18	29	0	3	32	0	0
16	26710969	.	C	A	15	17	32	0	0	32	0	0
16	26713964	.	G	T	25	21	46	0	2	48	0	0
16	26768803	.	A	G	2	6	8	0	0	8	0	0
16	26769021	.	G	A	2	4	6	0	7	13	0	0
16	26769024	.	G	T	7	6	13	0	0	13	0	0
16	26769118	.	C	T	4	5	9	0	0	9	0	0
16	26769167	.	T	G	4	3	7	0	2	9	0	0
16	26816806	.	G	T	3	4	7	0	0	7	0	0
16	26816885	.	A	G	6	3	9	0	0	9	0	0
16	26817304	.	T	C	1	0	1	0	3	4	0	0
16	26848603	.	C	A	2	2	4	0	0	4	0	0
16	26850673	.	C	A	0	2	2	0	0	2	0	0
16	26850694	.	C	T	1	3	4	0	0	4	0	0
16	26850845	.	T	C	7	13	20	0	0	20	0	0
16	26850870	.	G	A	6	9	15	0	2	17	0	0
16	26850885	.	C	T	5	13	18	0	0	18	0	0
16	26851025	.	C	G	3	4	7	0	0	7	0	0
16	26851036	.	T	A	2	4	6	0	0	6	0	0
16	26851071	.	C	A	2	6	8	0	0	8	0	0
16	26851161	.	C	T	3	7	10	0	6	16	0	0
16	26851191	.	C	T	12	9	21	0	0	21	0	0
16	27069527	.	C	T	1	2	3	0	0	3	0	0
16	27089100	.	T	G	3	8	11	0	0	11	0	0
16	27098530	.	A	G	7	3	10	0	0	10	0	0
16	27098549	.	A	T	6	3	9	0	0	9	0	0
16	27098719	.	G	T	3	3	6	0	0	6	0	0
16	27098806	.	G	A	10	5	15	0	1	16	0	0
16	27099121	.	A	T	2	5	7	0	1	8	0	0
16	27099214	.	C	G	2	2	4	0	0	4	0	0
16	27099323	.	G	A	1	6	7	0	7	14	0	0
16	27099506	.	C	T	9	6	15	0	0	15	0	0
16	27100133	.	A	C	8	10	18	0	0	18	0	0
16	27100139	.	A	T	9	11	20	0	0	20	0	0
16	27100198	.	T	A	18	15	33	0	2	35	0	0
16	27126615	.	G	A	20	12	32	2	3	37	0	0
16	27126695	.	G	T	9	14	23	0	1	24	0	0
16	27126849	.	C	T	16	15	31	0	1	32	0	0
16	27126998	.	A	G	5	7	12	0	0	12	0	0
16	27126999	.	T	A	5	7	12	0	0	12	0	0
16	27127046	.	A	T	10	11	21	0	1	22	0	0
16	27127157	.	G	C	13	22	35	0	1	36	0	0
16	27127158	.	C	A	15	22	37	0	0	37	0	0
16	27127281	.	T	G	12	8	20	0	0	20	0	0
16	27127497	.	T	A	19	5	24	0	0	24	0	0
16	27127643	.	T	C	19	0	19	0	15	34	0	0
16	27159111	.	A	G	3	2	5	0	1	6	0	0
16	27166174	.	A	G	1	2	3	0	1	4	0	0
16	27166205	.	A	G	2	2	4	0	0	4	0	0
16	27166277	.	G	A	1	8	9	0	0	9	0	0
16	27169529	.	G	A	4	4	8	0	0	8	0	0
16	27169586	.	G	A	6	5	11	0	1	12	0	0
16	27169809	.	G	A	3	4	7	0	1	8	0	0
16	27170170	.	G	A	1	2	3	0	0	3	0	0
16	27216398	.	G	T	5	4	9	0	0	9	0	0
16	27216419	.	C	A	3	3	6	0	1	7	0	0
16	27231410	.	G	A	23	23	46	0	6	52	0	0
16	27231469	.	T	G	30	25	55	0	0	55	0	0
16	27363205	.	G	A	0	2	2	0	1	3	0	0
16	27367624	.	A	G	1	2	3	0	0	3	0	0
16	27367695	.	T	C	4	5	9	0	1	10	0	0
16	27368086	.	T	C	3	5	8	0	1	9	0	0
16	27368516	.	C	T	6	6	12	0	0	12	0	0
16	27368577	.	A	G	4	7	11	0	0	11	0	0
16	27368705	.	C	T	11	6	17	1	1	19	0	0
16	27368756	.	A	G	5	8	13	0	2	15	0	0
16	27369057	.	T	C	4	2	6	0	0	6	0	0
16	27417573	.	T	C	12	17	29	0	2	31	0	0
16	27427109	.	T	C	7	4	11	0	0	11	0	0
16	27510736	.	C	A	0	5	5	0	3	8	0	0
16	27543963	.	A	G	1	7	8	0	0	8	0	0
16	27548014	.	C	T	2	2	4	0	0	4	0	0
16	27550215	.	G	A	4	4	8	0	1	9	0	0
16	27555175	.	T	C	9	12	21	0	1	22	0	0
16	27555362	.	C	T	8	10	18	0	1	19	0	0
16	27571114	.	G	A	1	4	5	0	0	5	0	0
16	27573776	.	C	T	1	3	4	0	1	5	0	0
16	27578607	.	T	A	4	4	8	0	1	9	0	0
16	27581100	.	T	C	4	5	9	0	0	9	0	0
16	27615102	.	C	T	5	6	11	0	0	11	0	0
16	27615184	.	A	T	3	4	7	0	0	7	0	0
16	27615203	.	A	G	2	2	4	0	0	4	0	0
16	27617046	.	C	T	3	6	9	0	2	11	0	0
16	27617130	.	C	T	2	8	10	0	0	10	0	0
16	27621645	.	A	T	11	16	27	0	0	27	0	0
16	27621780	.	A	C	2	10	12	0	1	13	0	0
16	27621830	.	T	G	3	10	13	0	2	15	0	0
16	27621869	.	A	G	5	9	14	0	1	15	0	0
16	27621897	.	A	T	10	9	19	0	1	20	0	0
16	27626228	.	G	A	32	22	54	0	1	55	0	0
16	27626566	.	G	T	25	35	60	0	7	67	0	0
16	27627051	.	T	C	22	25	47	0	1	48	0	0
16	27628860	.	A	T	19	19	38	0	1	39	0	0
16	27629052	.	C	T	16	16	32	0	2	34	0	0
16	27629212	.	C	T	19	23	42	0	1	43	0	0
16	27629220	.	T	C	19	21	40	0	3	43	0	0
16	27629455	.	T	G	12	17	29	0	1	30	0	0
16	27629483	.	G	A	14	12	26	0	2	28	0	0
16	27629713	.	T	C	13	11	24	0	4	28	0	0
16	27630087	.	C	T	1	9	10	0	17	27	0	0
16	27630174	.	A	T	12	15	27	0	0	27	0	0
16	27630209	.	T	C	8	19	27	0	0	27	0	0
16	27630294	.	G	A	16	7	23	0	0	23	0	0
16	27630399	.	G	T	13	9	22	0	1	23	0	0
16	27630998	.	T	C	4	0	4	0	3	7	0	0
16	27631061	.	G	A	7	3	10	0	1	11	0	0
16	27631768	.	G	A	3	2	5	0	1	6	0	0
16	27632705	.	G	A	3	3	6	0	0	6	0	0
16	27633002	.	G	A	3	2	5	0	0	5	0	0
16	27660103	.	T	C	4	3	7	0	0	7	0	0
16	27660104	.	A	C	4	3	7	0	0	7	0	0
16	27660144	.	T	C	2	6	8	0	1	9	0	0
16	27660196	.	A	T	6	6	12	0	3	15	0	0
16	27660219	.	G	T	9	4	13	0	1	14	0	0
16	27660271	.	A	G	12	3	15	0	0	15	0	0
16	27660346	.	C	T	6	5	11	0	0	11	0	0
16	27660409	.	T	C	2	0	2	0	4	6	0	0
16	27660441	.	T	C	2	3	5	0	0	5	0	0
16	27660750	.	C	T	0	4	4	0	4	8	0	0
16	27660781	.	G	A	3	3	6	0	0	6	0	0
16	27660868	.	A	G	1	4	5	0	1	6	0	0
16	27660934	.	C	T	4	6	10	0	1	11	0	0
16	27667213	.	G	A	2	3	5	0	0	5	0	0
16	27667312	.	G	T	2	3	5	0	0	5	0	0
16	27735495	.	G	C	2	2	4	0	0	4	0	0
16	27736103	.	G	A	0	2	2	0	1	3	0	0
16	28112951	.	C	A	2	3	5	0	0	5	0	0
16	28112989	.	C	T	5	2	7	0	1	8	0	0
16	28113033	.	C	T	0	4	4	0	7	11	0	0
16	28113049	.	G	A	6	3	9	0	0	9	0	0
16	28256806	.	G	A	8	6	14	0	0	14	0	0
16	28263526	.	G	A	3	4	7	0	0	7	0	0
16	28263597	.	C	A	3	3	6	0	0	6	0	0
16	28265687	.	T	C	2	2	4	0	0	4	0	0
16	28270111	.	A	T	1	2	3	0	0	3	0	0
16	28270157	.	C	A	2	3	5	0	0	5	0	0
16	28270258	.	T	G	1	0	1	0	2	3	0	0
16	28270443	.	T	C	3	2	5	0	0	5	0	0
16	28272554	.	T	C	3	3	6	0	1	7	0	0
16	28276383	.	T	C	7	4	11	0	0	11	0	0
16	28276389	.	C	T	7	3	10	0	0	10	0	0
16	28276455	.	C	T	2	4	6	0	0	6	0	0
16	28277053	.	G	T	2	6	8	0	0	8	0	0
16	28277068	.	G	A	1	6	7	0	0	7	0	0
16	28277340	.	C	G	1	3	4	0	0	4	0	0
16	28277385	.	G	C	1	2	3	0	0	3	0	0
16	28278345	.	T	C	2	2	4	0	0	4	0	0
16	28278360	.	T	C	2	3	5	0	1	6	0	0
16	28278387	.	C	T	2	2	4	0	0	4	0	0
16	28280057	.	T	C	2	1	3	0	2	5	0	0
16	28309479	.	A	T	5	5	10	0	0	10	0	0
16	28313822	.	G	A	11	7	18	0	4	22	0	0
16	28313823	.	G	A	12	10	22	0	0	22	0	0
16	28370465	.	C	T	9	20	29	0	2	31	0	0
16	28370513	.	G	C	11	13	24	0	1	25	0	0
16	28370566	.	A	C	12	12	24	0	0	24	0	0
16	28370703	.	A	G	5	9	14	0	0	14	0	0
16	28370943	.	A	T	4	6	10	1	1	12	0	0
16	28371138	.	T	C	17	12	29	0	1	30	0	0
16	28371148	.	A	G	16	11	27	0	2	29	0	0
16	28573634	.	C	T	5	8	13	0	0	13	0	0
16	28573957	.	T	A	5	2	7	0	0	7	0	0
16	28574063	.	C	T	4	2	6	0	0	6	0	0
16	28574403	.	C	T	4	4	8	0	0	8	0	0
16	28574465	.	G	A	1	6	7	0	1	8	0	0
16	28581874	.	A	C	6	2	8	0	0	8	0	0
16	28591305	.	A	T	13	9	22	0	2	24	0	0
16	28591363	.	G	A	15	7	22	0	2	24	0	0
16	28591459	.	G	A	3	9	12	0	9	21	0	0
16	28592697	.	C	A	15	7	22	0	3	25	0	0
16	28592946	.	G	A	7	3	10	0	0	10	0	0
16	28593280	.	C	T	4	4	8	0	0	8	0	0
16	28593327	.	A	G	5	4	9	0	0	9	0	0
16	28593679	.	T	C	6	0	6	0	3	9	0	0
16	28593802	.	T	C	2	3	5	0	0	5	0	0
16	28593867	.	T	C	6	0	6	0	4	10	0	0
16	28593952	.	T	C	5	9	14	0	0	14	0	0
16	28598780	.	T	A	39	18	57	0	1	58	0	0
16	28598790	.	A	T	37	18	55	0	0	55	0	0
16	28598846	.	G	T	0	12	12	0	6	18	0	0
16	28598979	.	A	C	2	5	7	3	1	11	0	0
16	28624648	.	G	C	1	5	6	0	3	9	0	0
16	28626257	.	G	C	0	5	5	0	1	6	0	0
16	28626628	.	C	T	1	2	3	0	0	3	0	0
16	28626629	.	G	A	0	2	2	0	1	3	0	0
16	28626843	.	G	A	2	3	5	0	1	6	0	0
16	28626844	.	G	T	3	3	6	0	0	6	0	0
16	28626952	.	T	C	6	2	8	0	0	8	0	0
16	28627127	.	C	T	6	5	11	0	1	12	0	0
16	28627178	.	A	G	1	3	4	0	0	4	0	0
16	28627240	.	G	A	3	4	7	0	0	7	0	0
16	28627341	.	T	G	6	4	10	0	0	10	0	0
16	28627342	.	T	A	5	4	9	0	0	9	0	0
16	28627383	.	T	G	6	6	12	0	1	13	0	0
16	28627385	.	T	A	6	6	12	0	0	12	0	0
16	28627467	.	C	T	6	8	14	0	0	14	0	0
16	28627485	.	C	T	3	9	12	0	0	12	0	0
16	28627522	.	G	T	2	2	4	0	1	5	0	0
16	28629285	.	C	A	4	4	8	0	0	8	0	0
16	28632525	.	C	T	3	2	5	0	0	5	0	0
16	28638364	.	C	T	0	2	2	0	2	4	0	0
16	28664537	.	T	C	3	3	6	0	0	6	0	0
16	28664543	.	G	A	3	3	6	0	0	6	0	0
16	28842438	.	C	T	24	7	31	0	1	32	0	0
16	28846761	.	T	C	2	3	5	0	1	6	0	0
16	28856026	.	G	A	2	1	3	0	2	5	0	0
16	28856034	.	G	A	3	2	5	0	1	6	0	0
16	28986722	.	A	G	1	5	6	0	1	7	0	0
16	28986728	.	C	T	2	6	8	0	0	8	0	0
16	28990523	.	C	G	1	4	5	0	1	6	0	0
16	29003349	.	C	T	1	2	3	0	0	3	0	0
16	29012961	.	C	T	2	6	8	0	1	9	0	0
16	29012992	.	A	G	2	0	2	0	3	5	0	0
16	29013126	.	C	T	1	2	3	0	0	3	0	0
16	29013134	.	C	A	1	2	3	0	0	3	0	0
16	29013377	.	C	T	3	4	7	0	2	9	0	0
16	29014109	.	T	C	6	2	8	0	0	8	0	0
16	29016904	.	T	C	5	3	8	0	0	8	0	0
16	29017221	.	T	C	7	4	11	0	0	11	0	0
16	29019039	.	G	A	9	6	15	0	0	15	0	0
16	29020482	.	G	T	10	16	26	0	1	27	0	0
16	29022955	.	C	A	7	6	13	0	1	14	0	0
16	29022963	.	A	G	6	8	14	0	2	16	0	0
16	29023266	.	A	T	4	12	16	0	1	17	0	0
16	29024181	.	A	G	6	7	13	0	0	13	0	0
16	29024280	.	T	G	5	0	5	0	7	12	0	0
16	29024341	.	T	C	4	7	11	0	0	11	0	0
16	29024405	.	C	T	6	6	12	0	1	13	0	0
16	29024409	.	C	T	7	5	12	0	1	13	0	0
16	29024694	.	A	T	2	2	4	0	0	4	0	0
16	29027541	.	T	C	1	5	6	0	0	6	0	0
16	29029444	.	G	A	2	2	4	0	0	4	0	0
16	29029476	.	A	G	2	2	4	0	0	4	0	0
16	29029575	.	T	C	2	2	4	0	0	4	0	0
16	29029593	.	G	A	2	2	4	0	0	4	0	0
16	29029797	.	A	G	1	1	2	0	4	6	0	0
16	29030235	.	A	G	2	4	6	0	0	6	0	0
16	29030364	.	A	G	1	0	1	0	3	4	0	0
16	29030365	.	A	G	3	2	5	0	0	5	0	0
16	29052096	.	G	T	0	2	2	0	2	4	0	0
16	29052914	.	G	A	2	3	5	0	2	7	0	0
16	29052991	.	C	T	3	5	8	0	0	8	0	0
16	29053045	.	T	A	1	8	9	0	0	9	0	0
16	29053534	.	A	G	3	3	6	1	0	7	0	0
16	29053663	.	G	T	3	2	5	0	0	5	0	0
16	29053673	.	A	G	3	5	8	0	0	8	0	0
16	29053781	.	A	T	10	10	20	0	2	22	0	0
16	29053798	.	C	G	12	1	13	0	11	24	0	0
16	29053923	.	C	A	7	3	10	0	3	13	0	0
16	29073539	.	C	T	16	9	25	0	3	29	1	0
16	29073621	.	T	A	7	3	10	0	1	11	0	0
16	29074254	.	G	A	20	27	47	0	1	48	0	0
16	29074535	.	A	G	9	9	18	0	0	18	0	0
16	29074688	.	A	G	12	12	24	0	2	26	0	0
16	29075222	.	T	A	8	7	15	0	2	17	0	0
16	29075343	.	G	A	13	10	23	0	2	25	0	0
16	29075674	.	C	A	11	12	23	0	1	24	0	0
16	29075757	.	A	G	7	4	11	0	0	11	0	0
16	29075870	.	G	T	7	10	17	0	0	17	0	0
16	29075959	.	C	T	4	5	9	0	1	10	0	0
16	29076009	.	T	A	8	7	15	0	1	16	0	0
16	29076019	.	A	C	8	8	16	0	0	16	0	0
16	29076407	.	C	T	0	8	8	0	5	13	0	0
16	29076633	.	G	A	4	6	10	0	0	10	0	0
16	29076669	.	A	G	8	4	12	0	1	13	0	0
16	29076678	.	T	C	10	0	10	0	2	12	0	0
16	29091699	.	T	C	3	9	12	0	1	13	0	0
16	29222033	.	T	C	7	20	27	0	2	29	0	0
16	29222167	.	G	A	6	19	25	0	1	26	0	0
16	29225902	.	G	C	5	14	19	0	0	19	0	0
16	29226151	.	C	T	6	5	11	0	0	11	0	0
16	29226538	.	G	T	2	3	5	0	0	5	0	0
16	29226566	.	T	C	1	3	4	0	0	4	0	0
16	29306983	.	T	C	1	2	3	0	0	3	0	0
16	29307100	.	G	C	1	3	4	0	0	4	0	0
16	29310150	.	T	A	9	5	14	0	0	14	0	0
16	29310206	.	A	G	12	6	18	0	2	20	0	0
16	29310213	.	C	A	13	5	18	0	1	19	0	0
16	29310281	.	C	G	20	11	31	1	2	34	0	0
16	29310455	.	C	T	27	7	34	0	0	34	0	0
16	29310530	.	C	A	24	11	35	0	2	37	0	0
16	29310541	.	A	G	20	13	33	0	3	36	0	0
16	29311367	.	C	A	8	4	12	0	1	13	0	0
16	29311381	.	G	A	10	5	15	0	1	16	0	0
16	29311489	.	A	G	11	9	20	0	0	20	0	0
16	29311720	.	T	C	7	5	12	0	1	13	0	0
16	29381369	.	G	A	1	2	3	0	2	5	0	0
16	29383834	.	A	C	2	6	8	0	0	8	0	0
16	29384090	.	T	C	2	5	7	0	0	7	0	0
16	29384099	.	T	A	3	4	7	0	0	7	0	0
16	29384139	.	G	A	1	2	3	0	1	4	0	0
16	29384182	.	C	T	3	4	7	0	0	7	0	0
16	29384187	.	T	C	3	4	7	0	0	7	0	0
16	29384319	.	A	T	3	3	6	0	0	6	0	0
16	29407754	.	C	T	6	3	9	1	1	11	0	0
16	29408060	.	T	C	21	25	46	1	10	57	0	0
16	29408172	.	T	A	33	36	69	0	2	71	0	0
16	29408926	.	A	T	14	12	26	0	1	27	0	0
16	29409181	.	T	A	2	2	4	0	0	4	0	0
16	29409219	.	A	G	1	2	3	0	0	3	0	0
16	29409399	.	T	C	23	0	23	0	13	36	0	0
16	29409414	.	T	C	26	14	40	0	1	41	0	0
16	29409476	.	T	C	27	13	40	0	1	41	0	0
16	29409480	.	T	C	25	13	38	0	1	39	0	0
16	29409533	.	T	G	17	12	29	0	1	30	0	0
16	29409544	.	T	C	12	12	24	0	1	25	0	0
16	29409732	.	T	G	24	16	40	0	1	41	0	0
16	29409918	.	T	G	10	7	17	0	1	18	0	0
16	29410032	.	A	G	12	13	25	0	0	25	0	0
16	29410033	.	G	A	12	13	25	0	0	25	0	0
16	29410107	.	A	C	19	22	41	0	1	42	0	0
16	29410129	.	C	T	20	18	38	0	4	42	0	0
16	29410251	.	T	A	11	7	18	0	3	21	0	0
16	29410418	.	C	T	1	15	16	0	17	33	0	0
16	29410425	.	A	G	12	19	31	0	2	33	0	0
16	29410620	.	T	C	8	0	8	2	3	13	0	0
16	29410679	.	T	G	10	13	23	0	0	24	1	0
16	29410921	.	G	A	13	10	23	0	0	23	0	0
16	29411196	.	A	G	14	10	24	0	0	24	0	0
16	29411436	.	G	C	5	9	14	0	1	15	0	0
16	29411646	.	G	A	4	5	9	0	0	9	0	0
16	29413166	.	C	T	5	2	7	0	0	7	0	0
16	29457158	.	A	G	2	3	5	0	0	5	0	0
16	30268660	.	A	G	3	3	6	0	0	6	0	0
16	30521244	.	C	A	2	2	4	0	0	4	0	0
16	31516398	.	A	G	3	3	6	0	0	6	0	0
16	31516536	.	T	C	7	2	9	0	0	9	0	0
16	31516778	.	A	G	4	4	8	0	0	8	0	0
16	31602170	.	A	G	7	2	9	0	1	10	0	0
16	31608012	.	A	G	1	3	4	0	0	4	0	0
16	31608967	.	G	T	1	6	7	0	0	7	0	0
16	31613619	.	A	G	2	2	4	0	0	4	0	0
16	31614272	.	C	G	1	3	4	0	0	4	0	0
16	31614918	.	G	A	2	2	4	0	0	4	0	0
16	31723863	.	T	C	2	2	4	0	0	4	0	0
16	31762960	.	C	T	23	11	34	0	1	35	0	0
16	31763316	.	T	C	15	21	36	0	0	36	0	0
16	31763318	.	C	T	15	20	35	0	1	36	0	0
16	31763458	.	G	A	13	5	18	0	1	19	0	0
16	31763488	.	C	G	13	2	15	0	0	15	0	0
16	31763668	.	C	G	5	13	18	0	2	20	0	0
16	31763743	.	T	A	17	21	38	0	2	40	0	0
16	31763751	.	A	C	16	19	35	0	3	38	0	0
16	31763785	.	G	A	23	9	32	0	1	33	0	0
16	31763786	.	C	A	23	9	32	0	1	33	0	0
16	31763880	.	A	G	18	15	33	0	1	34	0	0
16	31764987	.	C	T	3	5	8	0	1	10	1	0
16	31766937	.	T	A	8	6	14	0	0	14	0	0
16	31767116	.	T	C	4	0	4	0	11	15	0	0
16	31767152	.	A	G	12	4	16	0	0	16	0	0
16	31767163	.	G	A	9	3	12	0	0	12	0	0
16	31768343	.	C	G	10	6	16	0	1	17	0	0
16	31768394	.	T	C	7	6	13	0	0	13	0	0
16	31768436	.	T	C	13	6	19	0	1	20	0	0
16	31769317	.	G	A	9	13	22	0	0	22	0	0
16	31769395	.	A	G	5	8	13	0	0	13	0	0
16	31769428	.	G	A	5	3	8	0	0	8	0	0
16	31770050	.	T	C	6	0	6	0	6	12	0	0
16	31776125	.	C	T	2	4	6	0	0	6	0	0
16	31815584	.	T	A	9	3	12	0	1	13	0	0
16	31815638	.	C	T	15	7	22	0	0	22	0	0
16	31815878	.	G	A	8	10	18	0	1	20	1	0
16	31816005	.	C	A	12	8	20	0	1	21	0	0
16	31816205	.	C	T	12	0	12	1	1	14	0	0
16	31816336	.	C	T	1	12	13	0	4	17	0	0
16	31816596	.	C	T	11	8	19	0	1	20	0	0
16	31827642	.	T	A	9	8	17	0	2	19	0	0
16	31827703	.	C	T	9	6	15	0	0	15	0	0
16	31832606	.	A	G	20	1	21	0	36	57	0	0
16	31858536	.	A	C	1	3	4	0	4	8	0	0
16	31858539	.	A	C	2	1	3	0	6	9	0	0
16	31859065	.	A	G	1	0	1	0	2	3	0	0
16	31859102	.	A	G	4	7	11	0	0	11	0	0
16	31859227	.	T	C	15	16	31	0	0	31	0	0
16	31859341	.	C	T	19	16	35	0	4	39	0	0
16	31859371	.	T	C	16	21	37	0	2	39	0	0
16	31859416	.	T	C	9	22	31	0	5	36	0	0
16	31859536	.	A	C	8	5	13	0	17	30	0	0
16	31859686	.	G	A	4	6	10	0	1	11	0	0
16	31868443	.	G	A	19	17	36	0	0	36	0	0
16	31922892	.	A	G	31	24	55	0	3	58	0	0
16	31923083	.	G	A	42	24	66	0	2	68	0	0
16	31923435	.	A	G	31	36	67	0	0	67	0	0
16	31924485	.	T	C	29	23	52	0	2	54	0	0
16	31924501	.	A	C	25	23	48	0	2	50	0	0
16	31958514	.	C	T	1	2	3	0	0	3	0	0
16	31958957	.	G	T	3	7	10	0	0	10	0	0
16	31959156	.	G	A	2	2	4	0	0	4	0	0
16	31959476	.	G	A	2	4	6	0	0	6	0	0
16	31959496	.	A	G	1	0	1	0	4	5	0	0
16	31959612	.	G	A	4	2	6	0	0	6	0	0
16	31959845	.	A	G	3	0	3	0	4	7	0	0
16	31960037	.	G	A	0	6	6	0	7	13	0	0
16	31960064	.	G	C	9	6	15	0	0	15	0	0
16	31960145	.	C	T	14	4	18	0	4	22	0	0
16	31960152	.	C	T	8	5	13	0	5	18	0	0
16	32009736	.	A	T	4	8	12	0	0	12	0	0
16	32011649	.	C	T	4	3	7	0	0	7	0	0
16	32013272	.	G	A	3	4	7	0	0	7	0	0
16	32021999	.	C	T	2	3	5	0	1	6	0	0
16	32023124	.	T	A	6	4	10	0	0	10	0	0
16	32025648	.	T	A	5	12	17	0	2	19	0	0
16	32025978	.	G	A	6	4	10	0	2	12	0	0
16	32025987	.	T	A	10	5	15	0	1	16	0	0
16	32026063	.	G	A	1	4	5	0	16	21	0	0
16	32026105	.	T	A	9	2	11	0	1	12	0	0
16	32026154	.	T	G	1	2	3	0	1	4	0	0
16	32051854	.	A	C	2	6	8	0	0	8	0	0
16	32052004	.	T	G	8	8	16	0	1	17	0	0
16	32052283	.	T	A	6	5	11	0	2	13	0	0
16	32052307	.	T	C	4	6	10	0	1	11	0	0
16	32052328	.	T	A	3	8	11	0	0	11	0	0
16	32052404	.	G	T	0	11	11	0	6	17	0	0
16	32055726	.	T	G	8	14	22	0	1	23	0	0
16	32057809	.	T	C	6	6	12	0	0	12	0	0
16	32057853	.	G	A	1	7	8	0	5	13	0	0
16	32069310	.	T	A	3	2	5	0	0	5	0	0
16	32072334	.	A	G	6	3	9	0	0	9	0	0
16	32073301	.	A	C	6	4	10	0	1	11	0	0
16	32073507	.	A	C	14	12	26	0	0	26	0	0
16	32073555	.	A	G	11	9	20	0	1	21	0	0
16	32073760	.	G	A	13	10	23	0	3	27	1	0
16	32074041	.	G	A	12	13	25	0	1	26	0	0
16	32074257	.	A	G	11	1	12	0	14	26	0	0
16	32074293	.	T	A	12	16	28	0	0	28	0	0
16	32074294	.	A	G	10	17	27	0	2	29	0	0
16	32080069	.	G	T	1	8	9	0	13	22	0	0
16	32080099	.	G	A	5	1	6	0	1	7	0	0
16	32080306	.	T	A	12	2	14	0	1	15	0	0
16	32080508	.	T	A	15	12	27	0	1	28	0	0
16	32080738	.	G	A	9	5	14	0	0	14	0	0
16	32082397	.	T	C	1	2	3	0	0	3	0	0
16	32082589	.	G	A	2	7	9	0	0	9	0	0
16	32082597	.	G	A	2	7	9	0	0	9	0	0
16	32085319	.	T	A	4	4	8	0	0	8	0	0
16	32085631	.	A	G	2	3	5	0	1	6	0	0
16	32085778	.	A	C	1	6	7	0	0	7	0	0
16	32086136	.	C	T	4	6	10	0	2	12	0	0
16	32088580	.	T	A	9	8	17	0	1	18	0	0
16	32090349	.	C	T	20	10	30	0	0	30	0	0
16	32090425	.	G	C	13	4	17	0	1	18	0	0
16	32110659	.	A	G	11	18	29	0	0	29	0	0
16	32111246	.	G	T	11	10	21	0	2	23	0	0
16	32113155	.	G	A	11	7	18	0	0	18	0	0
16	32113218	.	G	A	10	8	18	0	0	18	0	0
16	32116790	.	A	T	7	7	14	0	0	14	0	0
16	32117345	.	T	A	2	8	10	0	2	12	0	0
16	32119618	.	C	T	1	2	3	0	0	3	0	0
16	32120138	.	G	T	2	5	7	0	0	7	0	0
16	32120141	.	T	C	2	0	2	0	4	6	0	0
16	32120173	.	G	A	1	6	7	0	0	7	0	0
16	32141544	.	A	G	6	0	6	0	3	9	0	0
16	32141565	.	A	C	5	2	7	0	0	7	0	0
16	32144337	.	T	C	6	3	9	0	1	10	0	0
16	32144377	.	T	C	5	6	11	0	0	11	0	0
16	32144854	.	G	T	1	3	4	0	4	8	0	0
16	32144989	.	T	C	8	2	10	0	2	12	0	0
16	32145160	.	T	A	5	5	10	1	0	11	0	0
16	32145636	.	A	G	11	7	18	0	1	19	0	0
16	32145885	.	A	G	3	2	5	0	0	5	0	0
16	32197969	.	C	T	11	12	23	0	3	26	0	0
16	32252878	.	A	G	2	3	5	0	0	5	0	0
16	32267203	.	G	A	1	3	4	0	2	6	0	0
16	32273192	.	G	A	0	2	2	0	3	5	0	0
16	32274935	.	G	A	6	3	9	1	0	10	0	0
16	32275601	.	T	A	6	5	11	0	0	11	0	0
16	32275628	.	A	T	2	6	8	0	2	10	0	0
16	32562038	.	A	T	5	4	9	0	1	10	0	0
16	32562817	.	A	T	2	2	4	0	1	5	0	0
16	32579639	.	A	G	4	2	6	0	0	6	0	0
16	33004366	.	A	T	4	1	5	0	1	6	0	0
16	33004387	.	C	T	6	3	9	0	1	10	0	0
16	33735503	.	C	T	4	2	6	0	1	7	0	0
16	33735933	.	A	T	1	4	5	0	0	5	0	0
16	33735934	.	C	T	1	4	5	0	0	5	0	0
16	33773861	.	A	G	1	2	3	0	0	3	0	0
16	33919623	.	G	A	5	2	7	0	0	7	0	0
16	33923421	.	G	T	2	3	5	1	0	6	0	0
16	33923448	.	G	T	5	3	8	1	0	9	0	0
16	33923514	.	G	A	3	6	9	0	1	10	0	0
16	33925132	.	G	C	5	7	12	0	0	12	0	0
16	33925356	.	G	A	1	3	4	0	11	15	0	0
16	33925565	.	T	G	2	4	6	0	0	6	0	0
16	33926074	.	C	T	2	4	6	0	0	6	0	0
16	33928015	.	G	A	4	3	7	0	1	8	0	0
16	33933213	.	C	T	3	5	8	0	0	8	0	0
16	33933732	.	G	A	1	5	6	0	9	15	0	0
16	33939824	.	T	C	3	5	8	0	0	8	0	0
16	33939859	.	C	T	3	4	7	0	0	7	0	0
16	33940364	.	A	G	2	0	2	0	6	8	0	0
16	33940379	.	T	A	2	7	9	0	1	10	0	0
16	33972193	.	G	A	0	2	2	0	2	4	0	0
16	33978019	.	A	G	3	0	3	0	3	6	0	0
16	33981873	.	A	G	2	0	2	0	3	5	0	0
16	33983904	.	C	T	3	8	11	0	1	12	0	0
16	33984178	.	C	T	4	2	6	0	0	6	0	0
16	33984190	.	C	T	5	3	8	0	0	8	0	0
16	33985050	.	G	T	0	10	10	0	12	22	0	0
16	33985362	.	C	T	10	4	14	0	0	14	0	0
16	33986179	.	A	T	19	9	28	0	3	31	0	0
16	33986452	.	T	G	21	18	39	0	3	42	0	0
16	33989606	.	G	T	0	2	2	0	5	7	0	0
16	33989648	.	G	T	2	2	4	0	0	4	0	0
16	33989654	.	A	G	2	0	2	0	2	4	0	0
16	34004562	.	G	A	0	6	6	0	10	16	0	0
16	34004595	.	T	C	8	5	13	0	0	13	0	0
16	34004862	.	C	T	5	7	12	0	0	12	0	0
16	34005290	.	C	T	5	8	13	0	1	14	0	0
16	34005415	.	C	T	6	4	10	0	0	10	0	0
16	34005500	.	C	A	2	4	6	0	1	7	0	0
16	34005513	.	G	T	4	2	6	0	0	6	0	0
16	34005577	.	A	G	3	4	7	0	0	7	0	0
16	34005669	.	C	T	8	4	12	0	0	12	0	0
16	34005686	.	C	T	7	8	15	0	0	15	0	0
16	34005812	.	T	A	16	5	21	1	1	23	0	0
16	34005845	.	A	G	5	6	11	0	5	16	0	0
16	34006051	.	G	A	3	5	8	0	0	8	0	0
16	34054171	.	A	G	4	2	6	0	0	6	0	0
16	34054464	.	C	A	2	3	5	0	0	5	0	0
16	34054712	.	T	G	1	0	1	0	2	3	0	0
16	34054778	.	G	A	4	3	7	0	0	8	1	0
16	34054786	.	T	G	5	3	8	0	0	8	0	0
16	34054923	.	G	A	1	2	3	0	2	5	0	0
16	34056204	.	T	A	3	3	6	0	1	7	0	0
16	34056324	.	T	G	3	7	10	0	1	11	0	0
16	34173331	.	G	A	2	3	5	0	0	5	0	0
16	34185709	.	A	C	5	4	9	0	1	10	0	0
16	34185906	.	A	T	6	4	10	0	0	10	0	0
16	34200704	.	C	T	21	11	32	0	0	32	0	0
16	34201023	.	A	G	16	9	25	0	0	25	0	0
16	34208582	.	T	C	12	0	12	0	11	23	0	0
16	34208696	.	A	G	10	15	25	0	0	25	0	0
16	34212477	.	A	G	9	7	16	0	0	16	0	0
16	34212516	.	A	G	11	4	15	0	0	15	0	0
16	34212565	.	G	A	8	5	13	0	1	14	0	0
16	34212567	.	G	C	8	5	13	0	1	14	0	0
16	34212630	.	T	C	7	2	9	0	16	25	0	0
16	34212676	.	G	C	3	2	5	0	5	10	0	0
16	34222439	.	T	G	9	9	18	0	1	19	0	0
16	34225173	.	T	C	4	4	8	0	0	8	0	0
16	34225392	.	A	G	6	6	12	0	1	13	0	0
16	34225472	.	G	A	4	10	14	0	0	14	0	0
16	34267938	.	C	T	0	2	2	0	2	4	0	0
16	34321568	.	A	T	2	10	12	0	0	12	0	0
16	34322036	.	G	T	6	6	12	0	0	12	0	0
16	34322346	.	G	A	19	12	31	0	2	33	0	0
16	34322372	.	C	T	1	15	16	0	21	37	0	0
16	34337976	.	A	T	7	8	15	0	2	17	0	0
16	34338475	.	A	G	8	4	12	0	0	12	0	0
16	34339168	.	A	C	6	6	12	0	0	12	0	0
16	34339432	.	A	T	6	4	10	0	2	12	0	0
16	34339693	.	C	T	2	3	5	0	0	5	0	0
16	34339808	.	A	G	3	2	5	0	0	5	0	0
16	34339857	.	T	G	2	2	4	0	0	4	0	0
16	34340397	.	A	C	2	4	6	0	0	6	0	0
16	34497992	.	T	A	3	3	6	0	2	8	0	0
16	34498734	.	A	G	2	0	2	2	5	9	0	0
16	34498785	.	G	C	3	3	6	2	0	8	0	0
16	34498787	.	A	G	2	3	5	2	1	8	0	0
16	34498872	.	A	G	4	2	6	0	0	6	0	0
16	34499276	.	A	G	4	2	6	0	0	6	0	0
16	34499297	.	A	G	2	2	4	0	0	4	0	0
16	34499400	.	A	G	1	4	5	0	0	5	0	0
16	34500542	.	G	C	9	10	19	0	0	19	0	0
16	34500840	.	T	G	5	12	17	0	0	17	0	0
16	34500899	.	G	A	10	14	24	0	2	26	0	0
16	34501050	.	A	T	5	3	8	0	0	8	0	0
16	34501136	.	C	T	8	13	21	0	0	21	0	0
16	34501137	.	A	G	7	13	20	0	1	21	0	0
16	34501380	.	C	T	9	11	20	3	1	24	0	0
16	34501794	.	G	A	15	6	21	0	3	24	0	0
16	34525621	.	C	A	45	31	76	0	1	77	0	0
16	34526092	.	C	G	38	24	62	0	2	64	0	0
16	34526093	.	A	C	32	24	56	0	8	64	0	0
16	34526926	.	A	T	27	33	60	0	16	76	0	0
16	34532205	.	G	A	0	3	3	0	3	6	0	0
16	34930635	.	A	G	5	5	10	0	1	11	0	0
16	34930719	.	C	T	0	2	2	0	4	6	0	0
16	35376825	.	C	T	3	3	6	0	0	6	0	0
16	35376832	.	G	T	3	3	6	0	0	6	0	0
16	35376929	.	C	T	4	2	6	0	0	6	0	0
16	35376933	.	C	G	3	2	5	0	0	5	0	0
16	35411363	.	T	C	17	16	33	0	2	35	0	0
16	35414455	.	A	G	13	7	20	0	0	20	0	0
16	35414470	.	T	C	9	11	20	0	0	20	0	0
16	35415710	.	A	G	13	27	40	0	2	42	0	0
16	35415872	.	G	A	19	24	43	0	1	44	0	0
16	35416158	.	C	T	13	17	30	0	2	32	0	0
16	35418744	.	T	C	10	1	11	0	14	25	0	0
16	35418792	.	T	C	17	0	17	0	10	27	0	0
16	35418804	.	G	A	16	7	23	0	3	26	0	0
16	35420600	.	T	C	10	0	10	0	13	23	0	0
16	35422323	.	A	G	3	2	5	0	0	5	0	0
16	35423651	.	A	G	4	6	10	0	1	11	0	0
16	35423985	.	C	T	4	5	9	0	1	10	0	0
16	35424003	.	A	T	5	5	10	0	0	10	0	0
16	35426998	.	T	C	2	0	2	0	8	10	0	0
16	35535353	.	T	G	10	10	20	0	1	21	0	0
16	35536480	.	G	A	10	13	23	5	2	30	0	0
16	35536574	.	C	A	8	12	20	0	1	21	0	0
16	35536576	.	G	A	0	12	12	0	8	20	0	0
16	35536739	.	C	T	8	6	14	0	0	14	0	0
16	35536960	.	T	C	12	11	23	0	1	24	0	0
16	35537153	.	G	A	15	13	28	0	0	28	0	0
16	35556275	.	C	A	6	2	8	0	0	8	0	0
16	35560134	.	A	G	3	4	7	0	1	8	0	0
16	35572583	.	A	G	1	2	3	0	0	3	0	0
16	35718538	.	A	G	3	5	8	0	0	8	0	0
16	35729045	.	C	T	1	5	6	0	0	6	0	0
16	35743809	.	A	G	4	2	6	0	0	6	0	0
16	35750548	.	T	C	9	11	20	1	2	23	0	0
16	35750647	.	T	G	3	7	10	0	1	11	0	0
16	35750648	.	G	C	4	7	11	0	0	11	0	0
16	35750714	.	T	A	8	14	22	0	3	25	0	0
16	35762009	.	C	A	9	4	13	0	0	13	0	0
16	35762010	.	A	C	8	4	12	0	1	13	0	0
16	35764580	.	C	T	9	15	24	0	0	24	0	0
16	35772762	.	C	T	19	13	32	1	2	35	0	0
16	35772933	.	T	C	14	15	29	0	0	29	0	0
16	35773005	.	A	G	18	10	28	0	0	28	0	0
16	36041247	.	G	A	7	5	12	0	0	12	0	0
16	36062265	.	T	C	1	0	1	0	2	3	0	0
16	36075471	.	G	A	15	8	23	0	0	23	0	0
16	36075478	.	T	A	12	8	20	0	1	21	0	0
16	36075677	.	C	A	13	5	18	0	1	19	0	0
16	36075999	.	A	G	7	5	12	0	1	13	0	0
16	36076082	.	G	A	9	5	14	0	0	14	0	0
16	36080364	.	C	T	7	8	15	0	1	16	0	0
16	36080376	.	A	C	6	8	14	0	0	14	0	0
16	36118070	.	T	C	6	0	6	0	4	10	0	0
16	36118166	.	T	C	2	0	2	0	2	4	0	0
16	36150674	.	A	G	2	5	7	0	2	9	0	0
16	36150707	.	C	T	3	3	6	0	1	7	0	0
16	36150949	.	C	T	5	5	10	0	0	10	0	0
16	36150964	.	C	T	7	6	13	0	1	14	0	0
16	36151000	.	C	A	7	7	14	0	2	16	0	0
16	36159928	.	T	C	11	11	22	0	0	22	0	0
16	36162013	.	C	T	6	23	29	0	0	29	0	0
16	36162201	.	A	G	6	8	14	0	0	14	0	0
16	36162584	.	G	C	1	13	14	0	6	20	0	0
16	36162650	.	T	C	14	14	28	0	1	29	0	0
16	36162727	.	A	G	23	8	31	0	1	32	0	0
16	36162754	.	A	G	18	10	28	0	0	28	0	0
16	36162938	.	G	T	15	10	25	0	1	26	0	0
16	36163005	.	G	A	8	11	19	0	2	21	0	0
16	36163006	.	A	C	8	12	20	0	1	21	0	0
16	36168251	.	C	T	7	3	10	0	1	11	0	0
16	36168317	.	G	C	10	9	19	0	1	20	0	0
16	36168416	.	T	C	4	6	10	0	1	11	0	0
16	36168450	.	A	T	5	5	10	0	0	10	0	0
16	36168510	.	A	T	6	7	13	0	0	14	1	0
16	36168729	.	T	C	2	0	2	0	4	6	0	0
16	36168747	.	T	C	3	4	7	0	0	7	0	0
16	36168787	.	T	A	1	3	4	0	0	4	0	0
16	36168994	.	C	T	4	5	9	0	1	10	0	0
16	36169007	.	T	C	3	7	10	0	0	10	0	0
16	36169057	.	T	G	0	3	3	0	1	4	0	0
16	36169568	.	G	T	4	4	8	0	1	9	0	0
16	36169868	.	A	C	6	0	6	0	4	10	0	0
16	36172961	.	A	G	2	4	6	0	0	6	0	0
16	36172982	.	C	T	2	5	7	0	0	7	0	0
16	36173406	.	A	T	3	3	6	0	0	6	0	0
16	36721560	.	A	T	5	8	13	0	5	18	0	0
16	36721589	.	T	G	4	9	13	0	0	13	0	0
16	36724010	.	C	G	0	16	16	0	12	28	0	0
16	36729322	.	A	T	7	4	11	0	1	12	0	0
16	36729352	.	G	T	5	4	9	0	0	9	0	0
16	36729373	.	A	G	2	6	8	0	1	9	0	0
16	36731307	.	A	G	2	6	8	0	0	8	0	0
16	36735751	.	T	C	2	6	8	0	0	8	0	0
16	36735760	.	T	C	3	0	3	0	5	8	0	0
16	36743351	.	G	A	1	3	4	0	0	5	1	0
16	36759756	.	A	G	2	2	4	0	1	5	0	0
16	36759763	.	G	T	2	2	4	0	0	4	0	0
16	36759812	.	A	G	1	0	1	0	3	4	0	0
16	36759908	.	A	T	7	5	12	0	0	12	0	0
16	36759937	.	A	G	3	3	6	0	0	6	0	0
16	36766180	.	T	G	24	10	34	0	1	35	0	0
16	36766467	.	G	T	12	9	21	0	2	23	0	0
16	36923298	.	C	T	1	4	5	0	0	5	0	0
16	36928169	.	A	T	5	8	13	0	1	14	0	0
16	36928179	.	A	C	4	8	12	0	1	13	0	0
16	36928429	.	A	G	19	5	24	0	1	25	0	0
16	36931728	.	T	C	17	8	25	0	3	28	0	0
16	36931822	.	T	C	5	2	7	2	1	10	0	0
16	36934191	.	T	A	3	4	7	0	0	7	0	0
16	36934340	.	C	A	0	2	2	0	4	6	0	0
16	36934398	.	G	C	3	3	6	0	1	7	0	0
16	36939973	.	T	C	0	0	0	1	6	7	0	0
16	36939982	.	A	G	2	2	4	1	1	6	0	0
16	36940045	.	C	T	4	3	7	0	0	7	0	0
16	36942068	.	C	A	3	1	4	0	1	5	0	0
16	36945288	.	G	A	1	3	4	0	0	4	0	0
16	36974719	.	T	C	6	3	9	0	0	9	0	0
16	36975141	.	G	A	16	22	38	0	0	38	0	0
16	36975146	.	C	T	1	19	20	0	18	38	0	0
16	36975183	.	G	C	17	17	34	0	0	34	0	0
16	36975318	.	T	A	7	11	18	0	0	18	0	0
16	36976721	.	A	G	7	7	14	0	0	14	0	0
16	36977387	.	A	G	5	7	12	0	0	12	0	0
16	36979518	.	G	A	10	11	21	0	0	21	0	0
16	36979521	.	A	G	10	11	21	0	0	21	0	0
16	37167545	.	T	A	2	5	7	1	0	8	0	0
16	37167784	.	C	G	1	2	3	0	0	3	0	0
16	37323594	.	A	C	4	3	7	0	1	8	0	0
16	37563643	.	T	G	1	0	1	0	2	3	0	0
16	37596645	.	C	T	3	2	5	0	1	6	0	0
16	37596669	.	G	A	5	3	8	0	0	8	0	0
16	37614071	.	A	G	5	4	9	0	0	9	0	0
16	37617219	.	A	G	4	0	4	0	5	9	0	0
16	37617304	.	A	G	10	0	10	0	8	18	0	0
16	37617738	.	T	C	20	10	30	0	1	31	0	0
16	37627218	.	T	G	14	10	24	0	2	26	0	0
16	37627762	.	G	A	2	19	21	0	18	39	0	0
16	37627997	.	T	G	24	18	42	0	1	43	0	0
16	37944176	.	C	T	5	4	9	0	0	9	0	0
16	37944222	.	G	A	1	3	4	0	4	8	0	0
16	37944287	.	G	A	0	2	2	0	5	7	0	0
16	37947769	.	T	C	6	4	10	0	0	10	0	0
16	37947944	.	C	T	8	4	12	0	0	12	0	0
16	37948061	.	A	G	10	11	21	0	0	21	0	0
16	37948199	.	C	T	5	2	7	0	0	7	0	0
16	37948205	.	T	C	5	0	5	0	3	8	0	0
16	37948256	.	G	T	5	3	8	0	0	8	0	0
16	37948425	.	A	G	11	7	18	0	0	18	0	0
16	37948426	.	G	T	11	7	18	0	0	18	0	0
16	37948624	.	G	A	8	3	11	0	1	12	0	0
16	37948625	.	G	A	7	3	10	0	1	11	0	0
16	38131803	.	G	A	3	5	8	0	0	8	0	0
16	38131813	.	C	A	3	5	8	0	0	8	0	0
16	38132438	.	A	G	2	2	4	0	0	4	0	0
16	38132537	.	T	A	1	2	3	0	0	3	0	0
16	38133696	.	A	T	4	3	7	0	0	7	0	0
16	38133804	.	C	T	4	4	8	0	1	9	0	0
16	38133903	.	A	G	5	7	12	0	0	12	0	0
16	38134215	.	G	A	2	2	4	0	0	4	0	0
16	38134428	.	C	A	5	4	9	0	0	9	0	0
16	38134467	.	G	A	4	2	6	0	1	7	0	0
16	38134515	.	C	T	9	4	13	0	0	13	0	0
16	38134653	.	A	G	1	0	1	0	6	7	0	0
16	38134676	.	C	A	1	6	7	0	0	7	0	0
16	38134710	.	T	A	4	5	9	0	0	9	0	0
16	38134875	.	G	A	2	3	5	0	0	5	0	0
16	38134908	.	A	T	4	2	6	0	1	7	0	0
16	38135166	.	C	A	6	10	16	0	0	16	0	0
16	38135591	.	G	T	2	2	4	0	0	4	0	0
16	38135625	.	C	G	4	2	6	0	0	6	0	0
16	38135626	.	T	G	4	2	6	0	0	6	0	0
16	38135740	.	T	C	3	8	11	0	0	11	0	0
16	38135763	.	A	G	3	6	9	1	0	10	0	0
16	38135816	.	T	C	5	4	9	0	0	9	0	0
16	38136022	.	G	A	4	2	6	0	0	6	0	0
16	38136028	.	C	T	5	2	7	0	0	7	0	0
16	38136317	.	G	A	14	14	28	0	1	29	0	0
16	38188955	.	G	A	0	2	2	0	6	8	0	0
16	38194017	.	T	C	1	5	6	0	1	7	0	0
16	38198125	.	C	A	4	7	11	0	1	12	0	0
16	38198170	.	G	A	1	3	4	0	1	5	0	0
16	38198418	.	T	G	5	9	14	0	0	14	0	0
16	38198648	.	G	A	6	8	14	0	0	14	0	0
16	38198836	.	A	T	7	11	18	0	0	18	0	0
16	38199369	.	T	A	5	5	10	0	0	10	0	0
16	38354134	.	A	G	1	4	5	0	1	6	0	0
16	38355945	.	G	C	2	2	4	0	1	5	0	0
16	38454783	.	T	A	1	3	4	0	0	4	0	0
16	38568644	.	G	C	18	16	34	0	0	34	0	0
16	38590735	.	A	C	18	18	36	0	4	40	0	0
16	38626434	.	T	C	13	11	24	0	1	25	0	0
16	38663163	.	G	A	1	10	11	0	7	18	0	0
16	38729551	.	G	T	1	4	5	0	9	14	0	0
16	38940811	.	T	G	13	14	27	0	2	29	0	0
16	38943253	.	C	T	8	7	15	0	1	16	0	0
16	39147355	.	G	C	8	7	15	0	0	15	0	0
16	39147386	.	C	A	7	10	17	0	0	17	0	0
16	39157751	.	C	A	9	13	22	0	1	23	0	0
16	39157885	.	T	A	11	15	26	0	0	26	0	0
16	39160445	.	C	T	16	11	27	0	0	27	0	0
16	39166299	.	G	T	8	23	31	0	3	34	0	0
16	39166422	.	G	A	1	22	23	0	11	34	0	0
16	39166591	.	G	A	17	23	40	0	1	41	0	0
16	39166773	.	C	T	20	11	31	0	3	34	0	0
16	39166854	.	C	T	21	24	45	0	0	45	0	0
16	39167028	.	C	A	18	14	32	0	1	33	0	0
16	39167088	.	C	T	11	21	32	0	0	32	0	0
16	39190767	.	T	G	6	11	17	0	0	17	0	0
16	39191557	.	T	C	12	0	12	0	10	22	0	0
16	39194303	.	A	G	8	11	19	0	1	20	0	0
16	39238539	.	A	T	1	2	3	0	0	3	0	0
16	39238547	.	A	T	1	2	3	0	0	3	0	0
16	39238630	.	G	A	0	2	2	0	1	3	0	0
16	39245587	.	C	A	14	8	22	0	1	23	0	0
16	39249184	.	A	G	4	4	8	0	0	8	0	0
16	39271329	.	A	C	2	3	5	0	0	5	0	0
16	39287126	.	G	T	1	2	3	0	1	4	0	0
16	39325121	.	G	A	2	1	3	0	1	4	0	0
16	39362147	.	C	A	4	3	7	0	1	8	0	0
16	39362312	.	G	T	0	4	4	0	5	9	0	0
16	39372345	.	G	A	5	6	11	0	1	12	0	0
16	39372372	.	T	C	7	8	15	0	0	15	0	0
16	39372735	.	G	C	1	8	9	0	10	19	0	0
16	39372780	.	C	A	12	11	23	0	2	25	0	0
16	39382047	.	C	G	11	15	26	0	3	29	0	0
16	39382226	.	G	A	6	9	15	0	1	16	0	0
16	39382345	.	T	C	6	2	8	0	0	8	0	0
16	39382384	.	A	C	1	5	6	0	0	6	0	0
16	39382467	.	C	G	6	3	9	0	1	10	0	0
16	39385436	.	C	T	1	1	2	0	1	3	0	0
16	39385449	.	A	G	3	2	5	1	0	6	0	0
16	39385477	.	C	A	0	5	5	1	3	9	0	0
16	39385755	.	T	C	17	0	17	0	13	30	0	0
16	39386920	.	C	T	2	17	19	0	10	29	0	0
16	39393370	.	A	G	11	7	18	0	0	18	0	0
16	39394581	.	A	G	13	13	26	0	1	27	0	0
16	39396983	.	C	T	1	7	8	0	3	11	0	0
16	39413496	.	T	C	2	2	4	0	0	4	0	0
16	39413514	.	C	T	2	2	4	0	0	4	0	0
16	39505447	.	C	T	0	3	3	0	2	5	0	0
16	39901274	.	G	A	2	2	4	0	0	4	0	0
16	40031649	.	A	G	1	2	3	0	0	3	0	0
16	40048790	.	A	G	1	6	7	0	0	7	0	0
16	40340664	.	A	T	1	2	3	0	0	3	0	0
16	40340706	.	T	G	1	2	3	0	0	3	0	0
16	40340710	.	C	G	1	1	2	0	0	2	0	0
16	40340967	.	A	G	4	5	9	0	0	9	0	0
16	40343465	.	G	A	2	4	6	0	0	6	0	0
16	40343482	.	A	G	5	2	7	0	0	7	0	0
16	40343750	.	C	T	2	6	8	0	0	8	0	0
16	40344082	.	A	G	1	2	3	0	0	3	0	0
16	40348933	.	T	C	2	5	7	0	0	7	0	0
16	40503994	.	G	A	4	6	10	0	1	11	0	0
16	40569264	.	T	C	1	2	3	0	0	3	0	0
16	40569285	.	T	C	2	3	5	0	0	5	0	0
16	40569701	.	T	G	1	4	5	0	0	5	0	0
16	40954695	.	A	G	4	1	5	0	10	15	0	0
16	40954941	.	C	G	12	0	12	0	6	18	0	0
16	41023341	.	A	G	4	8	12	0	0	12	0	0
16	41023367	.	G	A	3	4	7	0	1	8	0	0
16	41023620	.	G	A	2	4	6	0	0	6	0	0
16	41023689	.	C	A	9	4	13	0	0	13	0	0
16	41023761	.	G	T	6	4	10	5	1	16	0	0
16	41028360	.	T	G	11	0	11	0	11	23	1	0
16	41029443	.	G	A	4	5	9	0	0	9	0	0
16	41029795	.	C	T	5	2	7	0	0	7	0	0
16	41029866	.	G	T	3	3	6	0	0	6	0	0
16	41029981	.	T	C	6	3	9	0	1	10	0	0
16	41030137	.	A	G	11	7	18	0	6	24	0	0
16	41030302	.	T	G	10	13	23	0	1	24	0	0
16	41030492	.	A	C	8	13	21	0	1	22	0	0
16	41030493	.	G	T	6	14	20	0	1	21	0	0
16	41030560	.	T	C	3	2	5	0	0	5	0	0
16	41112493	.	C	T	7	8	15	0	1	16	0	0
16	41112572	.	G	A	7	9	16	0	0	16	0	0
16	41112861	.	G	C	7	0	7	0	4	11	0	0
16	41112912	.	T	A	9	10	19	0	2	21	0	0
16	41113134	.	G	A	11	6	17	0	0	17	0	0
16	41113347	.	A	G	11	9	20	0	0	20	0	0
16	41113434	.	A	T	7	11	18	0	0	18	0	0
16	41113449	.	A	G	8	8	16	0	0	16	0	0
16	41113752	.	G	A	11	5	16	0	2	18	0	0
16	41115079	.	T	G	4	2	6	0	0	6	0	0
16	41117117	.	G	C	1	2	3	0	0	3	0	0
16	41117125	.	C	T	0	2	2	0	1	3	0	0
16	41353224	.	A	G	5	7	12	0	0	12	0	0
16	41354452	.	G	A	6	6	12	0	0	12	0	0
16	41413984	.	G	A	1	4	5	0	1	6	0	0
16	43228942	.	C	T	1	6	7	0	0	7	0	0
16	43375493	.	G	A	1	4	5	0	0	5	0	0
16	44892957	.	T	C	1	4	5	0	0	5	0	0
16	45688228	.	G	A	0	6	6	0	2	8	0	0
16	46198406	.	A	G	15	8	23	0	0	23	0	0
16	46200745	.	A	G	40	9	49	0	3	52	0	0
16	46464219	.	G	A	8	3	11	0	1	12	0	0
16	46464279	.	G	A	7	7	14	0	1	15	0	0
16	47390547	.	A	T	0	2	2	0	1	3	0	0
16	47390549	.	A	T	1	1	2	0	1	3	0	0
16	48746783	.	A	T	2	5	7	0	1	8	0	0
16	51183892	.	A	T	3	5	8	0	3	11	0	0
16	51885808	.	G	A	37	23	60	3	7	70	0	0
16	51885855	.	A	T	30	32	62	4	9	75	0	0
16	51888929	.	C	T	33	28	61	0	1	62	0	0
16	51950697	.	T	A	23	17	40	0	5	45	0	0
16	51950726	.	C	A	30	22	52	0	0	52	0	0
16	51950754	.	C	T	32	29	61	1	1	63	0	0
16	51950814	.	A	T	29	0	29	0	0	29	0	0
16	51950877	.	G	C	21	29	50	1	1	52	0	0
16	51951691	.	T	C	12	16	28	0	2	30	0	0
16	51951861	.	G	C	11	10	21	0	3	24	0	0
16	51952002	.	T	G	12	10	22	0	1	23	0	0
16	51952023	.	A	T	12	11	23	0	1	24	0	0
16	51952063	.	A	C	11	12	23	0	0	23	0	0
16	51952817	.	C	T	3	2	5	0	0	5	0	0
16	51952826	.	C	A	3	3	6	0	0	6	0	0
16	51953009	.	G	A	16	14	30	0	1	31	0	0
16	51953048	.	T	C	16	24	40	0	4	44	0	0
16	51953057	.	T	A	18	22	40	0	0	40	0	0
16	51953189	.	G	T	15	11	26	0	2	28	0	0
16	51954683	.	C	T	1	10	11	0	3	14	0	0
16	51955675	.	G	A	9	19	28	0	0	28	0	0
16	51955696	.	G	A	12	13	25	0	0	25	0	0
16	51962068	.	A	G	12	4	16	0	1	17	0	0
16	51962089	.	C	T	7	9	16	0	1	17	0	0
16	51966774	.	C	G	9	10	19	0	2	21	0	0
16	53708537	.	G	T	6	2	8	1	2	11	0	0
16	54474858	.	A	G	6	8	14	0	0	14	0	0
16	54475037	.	G	A	11	11	22	0	0	22	0	0
16	54475064	.	G	A	8	9	17	0	0	17	0	0
16	54478053	.	A	G	4	9	13	0	1	15	1	0
16	54479732	.	G	A	6	4	10	0	0	10	0	0
16	54498049	.	G	A	3	2	5	0	0	5	0	0
16	54580999	.	T	C	1	2	3	0	0	3	0	0
16	54585729	.	G	C	0	9	9	0	2	11	0	0
16	54586574	.	C	G	1	2	3	0	0	3	0	0
16	54590177	.	C	T	3	2	5	0	0	5	0	0
16	54590594	.	C	T	7	13	20	0	1	21	0	0
16	54592503	.	T	C	8	8	16	0	1	17	0	0
16	54593401	.	A	G	9	14	23	0	0	23	0	0
16	54594047	.	A	C	15	19	34	4	5	43	0	0
16	54594413	.	C	T	14	21	35	0	2	37	0	0
16	54594421	.	A	G	10	19	29	0	7	36	0	0
16	54594511	.	A	G	12	0	12	0	11	23	0	0
16	54594598	.	T	A	12	20	32	0	0	32	0	0
16	54594605	.	T	C	11	21	32	0	0	32	0	0
16	54636042	.	T	C	1	0	1	0	5	6	0	0
16	54636475	.	T	C	1	0	1	0	7	8	0	0
16	54636973	.	T	G	2	6	8	0	0	8	0	0
16	54780864	.	G	A	1	20	21	0	22	43	0	0
16	54782542	.	G	A	2	22	24	0	25	49	0	0
16	54782705	.	C	A	1	2	3	0	0	3	0	0
16	54785573	.	C	G	42	20	62	0	0	62	0	0
16	54785894	.	A	G	11	8	19	0	0	19	0	0
16	54785974	.	G	C	7	6	13	0	1	14	0	0
16	54785979	.	T	A	9	5	14	0	0	17	3	0
16	54787578	.	G	A	5	2	7	0	0	7	0	0
16	54787725	.	C	T	1	18	19	0	18	37	0	0
16	54794760	.	G	A	2	4	6	15	0	21	0	0
16	54795732	.	A	G	4	8	12	0	0	12	0	0
16	54795735	.	G	A	3	7	10	0	2	12	0	0
16	54805173	.	G	A	4	3	7	0	0	7	0	0
16	54805306	.	C	T	1	5	6	0	0	6	0	0
16	54806967	.	C	A	0	4	4	0	1	5	0	0
16	55102544	.	A	G	2	2	4	0	0	4	0	0
17	70497	.	G	C	6	3	9	0	0	9	0	0
17	71012	.	A	T	3	2	5	0	0	5	0	0
17	71063	.	T	C	4	4	8	0	0	8	0	0
17	132932	.	A	C	3	4	7	0	0	7	0	0
17	133232	.	G	A	0	6	6	0	9	15	0	0
17	136304	.	A	G	13	20	33	0	2	35	0	0
17	136599	.	G	A	13	16	29	0	1	30	0	0
17	139048	.	G	C	3	4	7	0	0	7	0	0
17	139103	.	C	T	1	7	8	0	0	8	0	0
17	445759	.	A	G	3	2	5	0	0	5	0	0
17	445770	.	A	G	3	4	7	0	0	7	0	0
17	599913	.	T	A	4	2	6	0	0	6	0	0
17	600039	.	A	T	2	2	4	1	0	5	0	0
17	660617	.	C	A	2	19	21	0	18	39	0	0
17	681127	.	G	A	8	9	17	0	1	18	0	0
17	734235	.	T	C	13	0	13	0	19	32	0	0
17	734244	.	T	C	13	17	30	0	2	32	0	0
17	734492	.	T	C	5	0	5	0	10	15	0	0
17	735297	.	C	G	0	2	2	2	2	6	0	0
17	735472	.	G	A	3	4	7	0	1	8	0	0
17	735511	.	T	C	1	0	1	0	2	3	0	0
17	742225	.	C	T	14	10	24	0	0	24	0	0
17	742274	.	A	T	8	15	23	0	0	23	0	0
17	743576	.	T	A	5	7	12	0	1	13	0	0
17	743851	.	C	A	12	16	28	0	0	28	0	0
17	860186	.	T	C	5	1	6	0	4	10	0	0
17	860339	.	G	A	10	7	17	0	0	17	0	0
17	860451	.	C	G	7	10	17	0	1	18	0	0
17	860501	.	G	A	11	15	26	0	0	26	0	0
17	860645	.	C	T	1	6	7	0	4	11	0	0
17	860704	.	G	A	1	3	4	0	0	4	0	0
17	860852	.	A	G	3	2	5	0	0	5	0	0
17	861065	.	G	A	2	3	5	0	2	7	0	0
17	973958	.	A	G	1	6	7	0	0	7	0	0
17	974775	.	C	T	2	6	8	0	0	8	0	0
17	974838	.	G	T	5	5	10	0	0	10	0	0
17	1068814	.	C	T	9	10	19	0	1	20	0	0
17	1069048	.	G	T	3	2	5	0	0	5	0	0
17	1144445	.	T	A	3	5	8	0	0	8	0	0
17	1355567	.	A	G	4	2	6	0	1	7	0	0
17	1355645	.	C	T	1	2	3	0	0	3	0	0
17	1360206	.	T	G	1	0	1	0	4	5	0	0
17	1362172	.	C	T	1	2	3	0	1	4	0	0
17	1369251	.	T	A	2	2	4	0	0	4	0	0
17	1602351	.	T	A	2	2	4	0	0	4	0	0
17	1605946	.	T	C	1	3	4	0	0	4	0	0
17	2063925	.	A	G	22	19	41	1	3	45	0	0
17	2091858	.	G	A	2	12	14	0	28	42	0	0
17	2095454	.	T	C	22	18	40	0	7	47	0	0
17	2095525	.	A	G	9	1	10	0	42	52	0	0
17	2109014	.	C	T	2	17	19	0	14	33	0	0
17	2110588	.	G	A	22	15	37	0	0	37	0	0
17	2110642	.	C	G	20	9	29	0	1	30	0	0
17	2110657	.	T	C	19	0	19	0	12	31	0	0
17	2115464	.	A	T	16	19	35	0	0	35	0	0
17	2122175	.	A	G	13	12	25	0	1	26	0	0
17	2122196	.	G	A	9	15	24	0	1	25	0	0
17	2146073	.	G	A	0	2	2	0	1	3	0	0
17	2354798	.	A	G	2	2	4	0	0	4	0	0
17	2354814	.	T	C	2	0	2	0	4	6	0	0
17	2366396	.	A	G	1	4	5	0	0	5	0	0
17	2369970	.	C	T	1	2	3	0	0	3	0	0
17	2374070	.	T	C	2	0	2	0	2	4	0	0
17	2479601	.	G	C	3	3	6	0	0	6	0	0
17	2498615	.	C	G	2	3	5	0	0	5	0	0
17	2552458	.	G	A	1	3	4	0	0	4	0	0
17	2696241	.	T	C	1	6	7	0	0	7	0	0
17	2697538	.	A	G	1	3	4	0	0	4	0	0
17	2697656	.	T	C	2	0	2	0	3	5	0	0
17	2698340	.	T	C	1	2	3	0	0	3	0	0
17	2698348	.	A	G	1	2	3	0	0	3	0	0
17	3446847	.	T	C	1	3	4	0	0	4	0	0
17	3530031	.	C	T	5	3	8	0	0	8	0	0
17	3530178	.	G	C	3	4	7	0	0	7	0	0
17	3556184	.	C	A	6	5	11	0	0	11	0	0
17	3569298	.	A	G	6	7	13	0	0	13	0	0
17	3850524	.	G	A	1	2	3	0	0	3	0	0
17	3854287	.	C	T	2	3	5	0	0	5	0	0
17	4299093	.	A	T	5	2	7	0	0	7	0	0
17	4299096	.	C	A	5	1	6	0	1	7	0	0
17	5081406	.	A	C	3	6	9	1	1	11	0	0
17	5087222	.	G	A	13	8	21	0	0	21	0	0
17	5090871	.	T	C	16	9	25	0	3	28	0	0
17	5091108	.	T	C	20	8	28	1	0	29	0	0
17	5094330	.	T	A	27	14	41	0	3	44	0	0
17	5094355	.	T	C	28	13	41	0	2	43	0	0
17	5094519	.	C	T	26	12	38	0	2	40	0	0
17	5096691	.	T	C	18	15	33	0	0	33	0	0
17	5105702	.	T	A	20	8	28	0	1	29	0	0
17	5162080	.	T	A	3	4	7	0	0	7	0	0
17	5215192	.	T	A	12	5	17	0	1	18	0	0
17	5296519	.	A	G	2	3	5	0	0	5	0	0
17	5296534	.	T	A	2	3	5	0	0	5	0	0
17	5629365	.	C	T	1	6	7	0	0	7	0	0
17	5756664	.	T	C	4	0	4	0	6	10	0	0
17	5766286	.	A	C	2	6	8	0	0	8	0	0
17	5768712	.	A	G	2	2	4	0	1	5	0	0
17	5768722	.	C	T	3	2	5	0	0	5	0	0
17	5768776	.	A	C	3	3	6	0	1	7	0	0
17	5768792	.	C	T	3	3	6	0	0	6	0	0
17	5820083	.	C	T	1	3	4	0	0	4	0	0
17	5821134	.	A	G	4	5	9	0	0	9	0	0
17	5821853	.	T	C	1	5	6	0	1	7	0	0
17	5895865	.	G	A	0	1	1	0	5	6	0	0
17	5896210	.	G	T	4	5	9	0	2	11	0	0
17	5916287	.	T	C	10	10	20	0	0	20	0	0
17	5926729	.	A	G	16	24	40	0	2	42	0	0
17	6016386	.	C	T	2	2	4	0	0	4	0	0
17	6770549	.	G	A	1	5	6	0	0	6	0	0
17	6808406	.	A	G	5	4	9	0	0	9	0	0
17	6808581	.	A	G	2	7	9	0	0	9	0	0
17	6808796	.	A	G	5	18	23	0	2	25	0	0
17	7783451	.	G	T	0	2	2	0	1	3	0	0
17	7783528	.	T	A	2	2	4	0	0	4	0	0
17	7795583	.	T	A	2	3	5	0	0	5	0	0
17	7795593	.	G	A	1	2	3	0	0	3	0	0
17	7795674	.	T	G	1	3	4	0	0	4	0	0
17	7799980	.	A	G	2	4	6	1	0	7	0	0
17	7815360	.	T	C	1	0	1	0	2	3	0	0
17	7845085	.	T	A	15	13	28	0	2	30	0	0
17	7845288	.	A	G	8	3	11	0	0	11	0	0
17	7845364	.	G	C	16	17	33	0	0	33	0	0
17	7845412	.	T	C	14	17	31	0	3	34	0	0
17	7845566	.	C	T	20	19	39	0	0	39	0	0
17	7845604	.	G	A	26	24	50	0	0	50	0	0
17	7845661	.	G	T	29	23	52	0	1	53	0	0
17	7845733	.	G	A	25	27	52	0	3	55	0	0
17	7845776	.	C	G	2	24	26	1	24	51	0	0
17	7845800	.	A	G	21	33	54	1	2	57	0	0
17	7861124	.	C	T	19	13	32	0	0	32	0	0
17	7868632	.	G	A	24	18	42	0	1	43	0	0
17	7879327	.	C	G	12	19	31	0	1	32	0	0
17	7882941	.	G	A	15	4	19	0	1	20	0	0
17	7882998	.	G	A	15	10	25	0	0	25	0	0
17	7883016	.	C	T	11	13	24	0	1	25	0	0
17	7885635	.	G	A	9	12	21	0	1	22	0	0
17	7885662	.	A	G	7	10	17	0	2	19	0	0
17	7888351	.	G	A	5	10	15	0	0	15	0	0
17	7888369	.	G	A	7	8	15	0	1	16	0	0
17	7896340	.	G	A	8	4	12	0	0	12	0	0
17	7896356	.	C	T	0	10	10	0	5	15	0	0
17	7902203	.	A	G	7	14	21	0	0	21	0	0
17	7906612	.	G	A	7	5	12	0	0	12	0	0
17	7910537	.	C	T	8	5	13	0	0	13	0	0
17	7917997	.	G	A	2	9	11	0	0	11	0	0
17	7918075	.	C	T	1	6	7	0	0	7	0	0
17	7918244	.	C	T	0	3	3	0	5	8	0	0
17	7918310	.	C	T	1	3	4	0	4	8	0	0
17	7924263	.	G	A	8	5	13	0	0	13	0	0
17	7928615	.	T	G	2	3	5	0	2	7	0	0
17	7929597	.	T	C	6	4	10	0	0	10	0	0
17	7931722	.	T	A	1	3	4	0	0	4	0	0
17	7931737	.	G	A	1	2	3	0	0	3	0	0
17	8203471	.	C	T	5	4	9	0	0	9	0	0
17	8203498	.	G	A	2	3	5	0	0	5	0	0
17	8203729	.	T	C	3	2	5	0	1	6	0	0
17	8204086	.	G	C	0	4	4	0	1	5	0	0
17	8204248	.	A	G	5	0	5	0	5	10	0	0
17	8204533	.	C	T	1	5	6	0	0	6	0	0
17	8204755	.	A	G	11	7	18	0	1	19	0	0
17	8204818	.	A	G	15	7	22	0	0	22	0	0
17	8204962	.	C	T	8	8	16	0	0	16	0	0
17	8205508	.	T	C	10	17	27	0	0	27	0	0
17	8209686	.	A	G	9	8	17	0	2	19	0	0
17	8209931	.	C	A	8	9	17	0	0	17	0	0
17	8210327	.	A	T	16	7	23	0	2	25	0	0
17	8210355	.	T	A	15	5	20	0	1	21	0	0
17	8210365	.	C	T	14	3	17	0	2	19	0	0
17	8210415	.	C	A	15	11	26	0	1	27	0	0
17	8210466	.	A	G	13	1	14	0	12	26	0	0
17	8210552	.	A	G	7	14	21	0	1	22	0	0
17	8210596	.	A	C	13	19	32	0	1	33	0	0
17	8210801	.	C	T	28	16	44	0	0	44	0	0
17	8229904	.	C	T	4	3	7	0	0	7	0	0
17	8229906	.	G	A	4	3	7	0	0	7	0	0
17	8234886	.	C	G	5	5	10	0	0	10	0	0
17	8234889	.	C	T	0	6	6	0	4	10	0	0
17	8245868	.	G	A	3	3	6	0	0	6	0	0
17	8502883	.	G	A	3	3	6	0	0	6	0	0
17	8502982	.	G	A	2	4	6	0	1	7	0	0
17	8597078	.	C	A	0	17	17	0	25	42	0	0
17	8597174	.	T	A	14	13	27	0	2	29	0	0
17	8597515	.	A	T	19	22	41	1	1	43	0	0
17	8597702	.	A	T	17	12	29	0	5	34	0	0
17	8597871	.	T	C	17	5	22	0	0	22	0	0
17	8598070	.	C	T	3	17	20	0	26	46	0	0
17	8598168	.	G	A	20	19	39	0	0	39	0	0
17	8598345	.	T	A	24	23	47	1	3	51	0	0
17	8623396	.	G	A	8	13	21	0	0	21	0	0
17	8623480	.	C	T	3	10	13	0	12	25	0	0
17	8623540	.	C	T	1	10	11	0	14	25	0	0
17	8630043	.	C	A	9	6	15	0	0	15	0	0
17	8784742	.	G	A	1	4	5	0	2	7	0	0
17	8784934	.	C	A	5	4	9	0	0	9	0	0
17	8791863	.	C	T	5	2	7	0	0	7	0	0
17	8791917	.	T	C	3	7	10	0	0	10	0	0
17	8927397	.	G	A	4	6	10	0	0	10	0	0
17	8927638	.	A	G	2	6	8	0	0	8	0	0
17	8927641	.	A	G	1	7	8	0	1	9	0	0
17	8930017	.	C	T	8	14	22	0	0	22	0	0
17	8934235	.	C	T	17	7	24	0	1	25	0	0
17	8938011	.	G	A	13	9	22	0	2	24	0	0
17	8938249	.	T	C	14	22	36	0	2	38	0	0
17	8938269	.	G	A	17	14	31	0	4	35	0	0
17	8941206	.	G	A	9	10	19	0	3	22	0	0
17	8941264	.	T	C	7	17	24	0	0	24	0	0
17	8951606	.	C	G	1	11	12	0	11	23	0	0
17	8951867	.	C	T	3	18	21	0	13	34	0	0
17	8954377	.	G	A	15	8	23	0	0	23	0	0
17	8954482	.	C	T	19	17	36	0	1	37	0	0
17	8969278	.	A	G	12	4	16	0	1	17	0	0
17	8972806	.	T	C	5	0	5	0	5	10	0	0
17	8972821	.	G	A	5	3	8	0	0	8	0	0
17	8976273	.	A	G	3	6	9	0	0	9	0	0
17	9248656	.	A	G	1	0	1	0	3	4	0	0
17	9254269	.	T	A	1	2	3	0	0	3	0	0
17	9255196	.	G	A	0	3	3	0	2	5	0	0
17	9255547	.	G	C	4	5	9	0	0	9	0	0
17	9255703	.	C	T	2	9	11	0	0	11	0	0
17	9266298	.	C	T	15	10	25	0	0	25	0	0
17	9266501	.	G	T	4	11	15	0	13	28	0	0
17	9309309	.	A	G	3	2	5	0	0	5	0	0
17	9889223	.	C	T	5	2	7	0	0	7	0	0
17	9889427	.	G	A	1	3	4	0	0	4	0	0
17	9944725	.	A	G	10	5	15	0	0	15	0	0
17	9944733	.	A	G	10	4	14	0	1	15	0	0
17	9944848	.	T	A	7	5	12	0	1	13	0	0
17	9944874	.	C	T	8	5	13	0	0	13	0	0
17	9944960	.	A	T	4	2	6	0	1	7	0	0
17	9951885	.	G	A	6	3	9	0	0	9	0	0
17	9952033	.	C	T	0	8	8	0	7	15	0	0
17	9955952	.	C	T	2	6	8	0	0	8	0	0
17	9964032	.	T	A	10	4	14	0	2	17	1	0
17	9964177	.	C	A	4	2	6	0	1	7	0	0
17	9965010	.	C	A	2	2	4	0	0	4	0	0
17	9965231	.	T	C	4	0	4	0	3	7	0	0
17	9965344	.	T	A	5	2	7	0	0	7	0	0
17	9967595	.	A	G	3	2	5	0	1	6	0	0
17	10007488	.	A	T	0	2	2	0	1	3	0	0
17	10008358	.	C	T	0	2	2	0	1	3	0	0
17	10032559	.	C	T	1	2	3	0	1	4	0	0
17	10062318	.	C	T	3	3	6	0	0	6	0	0
17	10062493	.	G	A	2	4	6	0	0	6	0	0
17	10079554	.	G	A	6	5	11	0	0	11	0	0
17	10142416	.	G	C	5	7	12	0	1	13	0	0
17	10142474	.	T	G	4	4	8	0	0	8	0	0
17	10142481	.	A	G	3	3	6	0	0	6	0	0
17	10144027	.	A	C	4	3	7	0	1	8	0	0
17	10144381	.	A	G	2	2	4	0	0	4	0	0
17	10145004	.	G	T	19	18	37	0	2	39	0	0
17	10145281	.	C	T	14	11	25	0	3	28	0	0
17	10243794	.	C	A	4	5	9	0	0	9	0	0
17	10248157	.	A	G	5	9	14	0	0	14	0	0
17	10320093	.	T	C	3	2	5	0	0	5	0	0
17	10325735	.	A	C	1	2	3	0	0	3	0	0
17	10577843	.	A	G	1	2	3	0	0	3	0	0
17	10585083	.	G	A	0	2	2	0	1	3	0	0
17	10585101	.	G	A	1	4	5	0	0	5	0	0
17	10585140	.	C	T	3	4	7	0	0	7	0	0
17	10586161	.	A	T	4	3	7	0	0	7	0	0
17	10586449	.	A	G	8	3	11	0	1	12	0	0
17	10586664	.	A	C	11	6	17	0	2	19	0	0
17	10587020	.	G	T	3	7	10	0	1	11	0	0
17	10587330	.	A	C	2	4	6	0	1	7	0	0
17	10587601	.	A	G	2	7	9	0	0	9	0	0
17	10698537	.	A	C	1	2	3	0	0	3	0	0
17	10698681	.	G	T	2	1	3	0	1	4	0	0
17	10698977	.	A	C	4	2	6	0	0	6	0	0
17	10699076	.	G	T	0	4	4	0	2	6	0	0
17	10699077	.	A	C	2	4	6	0	0	6	0	0
17	10703478	.	A	G	1	2	3	0	0	3	0	0
17	10703764	.	C	A	1	3	4	0	1	5	0	0
17	10726617	.	C	T	11	3	14	0	0	14	0	0
17	10736503	.	G	A	2	5	7	0	0	7	0	0
17	10748708	.	G	C	0	4	4	0	1	5	0	0
17	10750761	.	T	A	5	3	8	0	0	8	0	0
17	10750767	.	G	A	5	4	9	0	0	9	0	0
17	10751051	.	T	C	2	4	6	0	2	8	0	0
17	10755512	.	A	G	3	5	8	0	0	8	0	0
17	10755656	.	T	C	4	8	12	0	0	12	0	0
17	10761763	.	T	C	7	7	14	0	0	14	0	0
17	10765286	.	C	T	12	10	22	0	1	23	0	0
17	10765328	.	A	G	11	0	11	0	10	21	0	0
17	10765683	.	T	A	2	2	4	0	1	5	0	0
17	10765766	.	A	G	3	5	8	0	1	9	0	0
17	10765773	.	A	G	3	6	9	0	1	10	0	0
17	10766074	.	G	C	15	6	21	0	0	21	0	0
17	10766142	.	T	A	17	6	23	0	0	23	0	0
17	10766181	.	A	G	9	4	13	0	0	13	0	0
17	10766205	.	G	T	7	4	11	0	1	12	0	0
17	10766219	.	A	T	4	4	8	0	0	8	0	0
17	10783885	.	A	G	14	8	22	0	1	23	0	0
17	10784149	.	C	T	1	11	12	0	12	24	0	0
17	10784151	.	T	C	10	10	20	0	4	24	0	0
17	10784210	.	A	C	13	0	13	0	9	22	0	0
17	10784441	.	A	G	11	8	19	0	1	20	0	0
17	10784618	.	G	A	9	6	15	0	0	15	0	0
17	10784646	.	C	G	10	6	16	0	0	16	0	0
17	10784948	.	A	T	9	4	13	0	0	13	0	0
17	10785020	.	A	G	1	2	3	0	0	3	0	0
17	10785206	.	A	G	1	5	6	0	0	6	0	0
17	10785552	.	A	G	1	1	2	0	1	3	0	0
17	10786149	.	T	A	2	2	4	0	0	4	0	0
17	11476847	.	C	T	5	2	7	0	1	8	0	0
17	11504927	.	G	A	3	4	7	0	0	7	0	0
17	11711365	.	C	T	0	2	2	0	1	3	0	0
17	11714635	.	G	C	4	3	7	0	0	7	0	0
17	11715917	.	G	C	3	5	8	0	1	9	0	0
17	11716068	.	T	C	4	4	8	0	0	8	0	0
17	11716113	.	T	G	3	6	9	0	0	9	0	0
17	11716296	.	A	G	4	7	11	0	1	12	0	0
17	11716509	.	G	T	3	2	5	0	0	5	0	0
17	11716634	.	A	G	3	0	3	0	8	11	0	0
17	11716638	.	C	A	3	9	12	0	0	12	0	0
17	11716702	.	A	G	8	4	12	0	0	12	0	0
17	11717109	.	C	T	12	7	19	2	3	24	0	0
17	11717131	.	C	T	3	16	19	2	4	25	0	0
17	11718038	.	A	C	22	10	32	0	3	35	0	0
17	11718118	.	A	G	14	14	28	0	1	29	0	0
17	11768427	.	G	C	1	2	3	0	0	3	0	0
17	12021802	.	C	T	3	2	5	0	0	5	0	0
17	12021813	.	C	T	0	3	3	0	3	6	0	0
17	12058522	.	G	T	0	2	2	0	5	7	0	0
17	12060545	.	C	T	5	2	7	0	0	7	0	0
17	12060587	.	A	G	3	3	6	0	0	6	0	0
17	12060799	.	A	G	1	2	3	0	0	3	0	0
17	12072890	.	C	T	15	5	20	0	1	21	0	0
17	12072977	.	T	C	6	9	15	0	3	18	0	0
17	12073037	.	C	T	8	8	16	0	1	17	0	0
17	12221666	.	T	C	6	8	14	0	0	14	0	0
17	12221891	.	G	A	5	8	13	0	1	14	0	0
17	12221903	.	C	T	1	8	9	0	6	15	0	0
17	12222005	.	T	G	6	4	10	0	0	10	0	0
17	12222226	.	A	G	7	5	12	0	0	12	0	0
17	12222235	.	G	T	7	5	12	0	0	12	0	0
17	12223514	.	G	A	9	10	19	1	1	21	0	0
17	12223743	.	G	A	8	14	22	0	0	22	0	0
17	12223971	.	G	A	3	3	6	0	0	6	0	0
17	12223989	.	C	A	0	4	4	0	4	8	0	0
17	12224581	.	T	C	4	0	4	0	9	13	0	0
17	12224976	.	G	A	8	9	17	0	0	17	0	0
17	12225070	.	G	A	7	8	15	0	0	15	0	0
17	12225418	.	T	G	2	4	6	0	2	8	0	0
17	12225756	.	C	A	4	5	9	0	0	9	0	0
17	12226404	.	C	T	3	3	6	0	0	6	0	0
17	12227848	.	G	T	3	2	5	0	0	5	0	0
17	12227849	.	C	T	3	1	4	0	1	5	0	0
17	12298106	.	G	T	34	35	69	0	7	76	0	0
17	12302409	.	G	A	39	31	70	0	3	73	0	0
17	12302496	.	C	T	33	12	45	3	3	51	0	0
17	12418130	.	C	A	12	16	28	0	1	29	0	0
17	12422810	.	A	G	8	0	8	0	11	19	0	0
17	12422850	.	T	A	10	7	17	0	0	17	0	0
17	12700653	.	A	G	17	16	33	0	3	36	0	0
17	12702780	.	C	T	13	14	27	0	2	29	0	0
17	12702801	.	A	G	13	0	13	0	15	28	0	0
17	12702831	.	C	A	16	18	34	0	4	38	0	0
17	12708393	.	A	G	7	4	11	0	0	11	0	0
17	12708404	.	C	A	6	4	10	0	0	10	0	0
17	12708903	.	T	C	12	25	37	0	1	38	0	0
17	12753792	.	G	A	17	8	25	0	0	25	0	0
17	12753823	.	A	G	13	7	20	0	0	20	0	0
17	12753916	.	T	A	13	5	18	0	0	18	0	0
17	12753940	.	A	T	11	7	18	0	0	18	0	0
17	12754071	.	A	G	15	11	26	0	3	29	0	0
17	12754158	.	A	T	7	8	15	0	0	15	0	0
17	12754198	.	A	T	5	2	7	0	3	10	0	0
17	12758823	.	T	C	7	5	12	0	0	12	0	0
17	12759072	.	G	A	11	5	16	0	0	16	0	0
17	12759135	.	C	T	12	4	16	0	0	16	0	0
17	12761221	.	G	C	7	3	10	0	0	10	0	0
17	12762852	.	T	C	7	3	10	0	0	10	0	0
17	12858173	.	C	T	3	5	8	0	1	9	0	0
17	12858765	.	A	G	3	5	8	0	0	8	0	0
17	12865807	.	C	T	5	2	7	0	0	7	0	0
17	12867975	.	G	A	4	3	7	0	0	7	0	0
17	12881532	.	G	A	11	4	15	0	1	16	0	0
17	12881590	.	G	A	1	7	8	0	2	10	0	0
17	12922410	.	A	T	16	7	23	0	2	25	0	0
17	12923028	.	A	G	14	22	36	0	1	37	0	0
17	12923131	.	A	G	11	1	12	0	14	26	0	0
17	12923303	.	A	G	17	1	18	0	21	39	0	0
17	12923509	.	A	T	11	13	24	0	0	24	0	0
17	12958744	.	G	A	9	12	21	0	2	23	0	0
17	12963487	.	A	C	9	0	9	0	11	20	0	0
17	12963571	.	G	A	14	6	20	0	2	22	0	0
17	12965499	.	A	G	3	4	7	0	1	8	0	0
17	12972969	.	A	G	8	4	12	0	2	14	0	0
17	12977682	.	T	C	7	0	7	0	5	12	0	0
17	13004839	.	C	G	1	3	4	0	0	4	0	0
17	13004885	.	T	C	1	0	1	0	3	4	0	0
17	13019988	.	T	A	13	24	37	0	0	37	0	0
17	13020090	.	G	A	12	14	26	0	0	26	0	0
17	13020187	.	A	C	14	4	18	0	1	19	0	0
17	13020472	.	T	C	7	15	22	0	4	26	0	0
17	13020476	.	T	A	7	17	24	0	2	26	0	0
17	13020601	.	C	T	0	8	8	0	8	16	0	0
17	13020733	.	C	G	10	8	18	0	0	18	0	0
17	13023022	.	G	A	6	8	14	0	0	14	0	0
17	13023289	.	T	C	3	4	7	0	0	7	0	0
17	13023407	.	A	C	5	6	11	0	0	11	0	0
17	13032557	.	A	G	2	1	3	0	2	5	0	0
17	13032558	.	A	G	2	3	5	0	0	5	0	0
17	13045540	.	G	T	10	9	19	0	0	19	0	0
17	13045559	.	A	C	9	11	20	0	0	20	0	0
17	13045794	.	T	A	12	10	22	0	1	23	0	0
17	13045882	.	A	T	6	11	17	0	3	20	0	0
17	13045980	.	T	C	4	2	6	0	0	6	0	0
17	13046058	.	T	G	3	7	10	0	0	10	0	0
17	13046099	.	G	A	3	7	10	0	1	11	0	0
17	13052081	.	C	T	0	3	3	0	7	10	0	0
17	13058349	.	T	A	7	4	11	0	1	12	0	0
17	13058354	.	G	A	7	6	13	0	0	13	0	0
17	13066963	.	T	A	1	2	3	0	0	3	0	0
17	13091660	.	T	G	3	6	9	0	0	9	0	0
17	13094135	.	G	A	7	7	14	0	0	14	0	0
17	13097239	.	C	T	6	3	9	0	1	10	0	0
17	13102057	.	A	G	18	16	34	0	1	35	0	0
17	13107061	.	A	G	15	0	15	0	11	26	0	0
17	13108626	.	G	T	21	16	37	0	1	38	0	0
17	13109010	.	A	G	17	22	39	0	0	39	0	0
17	13109042	.	T	C	20	15	35	2	0	37	0	0
17	13109097	.	A	T	8	17	25	0	2	27	0	0
17	13109409	.	C	T	20	20	40	0	2	42	0	0
17	13109793	.	A	C	9	16	25	0	1	26	0	0
17	13109818	.	T	C	12	18	30	0	1	31	0	0
17	13109910	.	A	G	22	0	22	1	16	39	0	0
17	13109928	.	G	T	3	17	20	1	20	41	0	0
17	13109990	.	T	A	24	20	44	0	6	50	0	0
17	13110003	.	C	G	25	20	45	1	4	50	0	0
17	13110043	.	C	T	23	15	38	1	0	39	0	0
17	13110090	.	A	T	6	7	13	0	1	14	0	0
17	14443633	.	T	A	3	4	7	0	0	7	0	0
17	14443651	.	T	C	4	0	4	0	3	7	0	0
17	14443697	.	G	A	9	5	14	0	0	14	0	0
17	14443820	.	T	G	1	2	3	0	0	3	0	0
17	14444166	.	A	G	11	9	20	0	0	20	0	0
17	14444167	.	G	A	9	9	18	0	2	20	0	0
17	14457911	.	C	A	1	2	3	0	1	4	0	0
17	14467471	.	G	A	7	3	10	0	1	11	0	0
17	14468247	.	C	T	1	5	6	0	8	14	0	0
17	14468263	.	T	G	7	6	13	0	0	13	0	0
17	14468370	.	A	T	15	10	25	0	2	27	0	0
17	14468386	.	T	A	13	13	26	0	0	26	0	0
17	14468433	.	G	A	12	19	31	0	0	31	0	0
17	14470340	.	A	G	6	8	14	0	1	15	0	0
17	14494395	.	A	G	1	2	3	0	0	3	0	0
17	14494429	.	A	G	4	2	6	0	0	6	0	0
17	14502454	.	T	A	1	7	8	0	0	8	0	0
17	14614452	.	T	C	13	6	19	0	0	19	0	0
17	14614471	.	A	G	11	5	16	0	1	17	0	0
17	14614509	.	C	A	10	15	25	0	0	25	0	0
17	14614863	.	C	A	10	15	25	0	2	27	0	0
17	14614900	.	G	A	6	8	14	0	1	15	0	0
17	14614973	.	C	G	8	6	14	0	2	16	0	0
17	14615089	.	T	C	11	11	22	0	0	22	0	0
17	14617171	.	G	A	5	6	11	0	1	12	0	0
17	14618038	.	C	G	1	4	5	0	0	5	0	0
17	14618051	.	G	A	2	4	6	0	0	6	0	0
17	14694711	.	C	A	24	18	42	0	0	42	0	0
17	14694744	.	A	G	21	18	39	0	2	41	0	0
17	14694802	.	C	G	14	18	32	0	3	35	0	0
17	14722223	.	A	G	15	7	22	0	0	22	0	0
17	14723137	.	C	T	13	15	28	0	2	30	0	0
17	14723208	.	T	C	14	9	23	0	0	23	0	0
17	14723302	.	A	G	11	10	21	0	0	21	0	0
17	14724005	.	C	A	4	4	8	0	0	8	0	0
17	14724057	.	T	C	4	5	9	0	0	9	0	0
17	14724489	.	T	C	4	3	7	0	0	7	0	0
17	14724514	.	T	C	3	1	4	0	2	6	0	0
17	14731522	.	G	T	8	10	18	0	1	19	0	0
17	14731560	.	T	C	8	12	20	0	0	20	0	0
17	14731819	.	T	C	12	13	25	0	3	28	0	0
17	14734632	.	C	T	4	9	13	0	2	15	0	0
17	14734734	.	G	A	4	7	11	0	0	11	0	0
17	14737070	.	G	A	7	4	11	0	1	12	0	0
17	14751227	.	T	A	5	4	9	0	1	10	0	0
17	14753455	.	G	A	2	5	7	0	0	7	0	0
17	14755852	.	G	A	1	2	3	0	0	3	0	0
17	14756129	.	A	G	1	3	4	0	0	4	0	0
17	14758562	.	G	A	1	3	4	0	0	4	0	0
17	14784323	.	T	C	2	4	6	0	1	7	0	0
17	14794285	.	A	G	14	18	32	0	0	32	0	0
17	14794485	.	G	T	14	19	33	0	2	35	0	0
17	14794639	.	A	T	4	9	13	0	1	14	0	0
17	14794672	.	C	G	1	8	9	0	0	9	0	0
17	14918378	.	A	G	1	2	3	0	0	3	0	0
17	14918382	.	G	C	1	2	3	0	0	3	0	0
17	14918836	.	T	A	1	2	3	0	0	3	0	0
17	14919126	.	T	G	3	4	7	0	0	7	0	0
17	14933285	.	T	A	2	4	6	0	0	6	0	0
17	14933455	.	A	G	2	3	5	0	0	5	0	0
17	14941634	.	T	A	1	2	3	0	0	3	0	0
17	14953989	.	C	G	1	2	3	0	0	3	0	0
17	14953999	.	C	G	1	2	3	0	0	3	0	0
17	14954037	.	C	T	0	2	2	0	1	3	0	0
17	15021944	.	G	A	3	4	7	0	0	7	0	0
17	15029290	.	G	A	1	2	3	1	0	4	0	0
17	15041276	.	A	T	3	3	6	0	1	7	0	0
17	15049316	.	G	C	1	3	4	0	0	4	0	0
17	15122021	.	T	G	7	3	10	0	0	10	0	0
17	15122177	.	T	C	5	0	5	0	4	9	0	0
17	15123062	.	C	A	2	2	4	0	0	4	0	0
17	15217763	.	G	A	2	2	4	0	0	4	0	0
17	15219107	.	G	A	1	2	3	0	1	4	0	0
17	15219141	.	C	T	1	2	3	0	0	3	0	0
17	15219712	.	G	A	5	2	7	0	0	7	0	0
17	15219739	.	T	A	3	3	6	0	0	6	0	0
17	15220092	.	C	T	2	3	5	0	5	10	0	0
17	15224052	.	G	A	3	3	6	0	0	6	0	0
17	15229577	.	T	C	5	3	8	0	0	8	0	0
17	15247318	.	G	A	1	2	3	0	0	3	0	0
17	15316001	.	T	C	19	8	27	0	5	32	0	0
17	15316022	.	T	C	23	10	33	0	0	33	0	0
17	15353984	.	G	A	18	6	24	0	1	25	0	0
17	15374185	.	T	C	4	10	14	0	0	14	0	0
17	15374507	.	G	A	3	5	8	0	0	8	0	0
17	15374744	.	C	G	4	6	10	0	0	10	0	0
17	15382421	.	T	A	9	6	15	0	0	15	0	0
17	15538356	.	T	A	1	3	4	0	1	5	0	0
17	15633721	.	T	C	5	7	12	0	0	12	0	0
17	15892233	.	G	A	3	2	5	0	0	5	0	0
17	15965386	.	C	T	1	4	5	0	0	5	0	0
17	15965589	.	C	A	3	1	4	1	1	6	0	0
17	15965951	.	G	T	0	3	3	0	5	8	0	0
17	16022530	.	C	T	4	3	7	0	0	7	0	0
17	16027718	.	G	A	3	3	6	0	0	6	0	0
17	16027720	.	A	G	4	2	6	0	1	7	0	0
17	16027983	.	A	T	4	10	14	0	0	14	0	0
17	16028040	.	G	A	3	5	8	0	0	8	0	0
17	16028118	.	A	G	3	0	3	0	3	6	0	0
17	16052022	.	C	T	1	2	3	0	0	3	0	0
17	16052075	.	A	G	2	2	4	0	0	4	0	0
17	16052563	.	G	A	1	2	3	0	0	3	0	0
17	16055049	.	T	C	2	5	7	0	1	8	0	0
17	16055179	.	G	A	4	7	11	0	0	11	0	0
17	16057798	.	C	T	4	3	7	0	1	8	0	0
17	16064843	.	G	T	1	3	4	0	0	4	0	0
17	16107111	.	C	T	2	3	5	0	0	5	0	0
17	16107882	.	A	G	9	1	10	0	11	21	0	0
17	16110234	.	A	G	2	3	5	0	0	5	0	0
17	16110447	.	T	G	7	4	11	0	0	11	0	0
17	16110573	.	A	G	1	5	6	0	1	7	0	0
17	16110773	.	A	G	1	3	4	0	0	4	0	0
17	16804958	.	C	A	3	1	4	0	6	10	0	0
17	17492857	.	A	T	2	2	4	0	0	4	0	0
17	18176909	.	C	T	2	1	3	0	2	5	0	0
17	18179927	.	T	C	10	5	15	3	10	28	0	0
17	19712796	.	C	T	1	4	5	0	0	5	0	0
17	20587942	.	T	C	2	1	3	0	0	3	0	0
17	20587947	.	T	A	0	3	3	0	0	3	0	0
17	20725123	.	G	A	3	2	5	0	1	6	0	0
17	20968134	.	G	A	2	2	4	0	0	4	0	0
17	21156808	.	A	T	1	8	9	0	0	9	0	0
17	24615181	.	C	T	2	2	4	0	0	4	0	0
17	26335000	.	G	A	4	3	7	0	0	7	0	0
17	26346175	.	T	A	2	3	5	0	0	5	0	0
17	26362130	.	G	A	14	9	23	0	0	23	0	0
17	26362500	.	C	T	3	7	10	0	0	10	0	0
17	26362512	.	A	C	8	3	11	0	0	11	0	0
17	26362741	.	C	T	5	3	8	0	0	8	0	0
17	26477743	.	A	C	18	2	20	0	4	24	0	0
17	26477747	.	T	A	15	6	21	0	2	23	0	0
17	26477795	.	A	C	15	7	22	0	2	24	0	0
17	26477857	.	T	C	12	16	28	0	0	28	0	0
17	26477860	.	C	T	11	16	27	0	1	28	0	0
17	26478023	.	T	C	16	3	19	0	0	19	0	0
17	26478403	.	T	G	5	10	15	0	0	15	0	0
17	26478592	.	A	G	15	12	27	0	1	28	0	0
17	26478818	.	T	C	14	0	14	0	15	29	0	0
17	26478952	.	G	A	8	7	15	0	2	17	0	0
17	26478986	.	A	G	6	12	18	0	1	19	0	0
17	26479063	.	A	G	11	5	16	0	0	16	0	0
17	26479145	.	T	C	9	11	20	0	0	20	0	0
17	26479916	.	G	T	4	2	6	0	0	6	0	0
17	26479960	.	C	T	2	4	6	0	0	6	0	0
17	26480250	.	A	C	1	2	3	0	0	3	0	0
17	26480254	.	G	A	0	2	2	0	1	3	0	0
17	26480421	.	A	G	6	2	8	0	0	8	0	0
17	26480423	.	T	C	6	2	8	0	0	8	0	0
17	26480622	.	A	T	4	4	8	0	0	8	0	0
17	26480926	.	T	G	4	2	6	0	0	6	0	0
17	26517366	.	G	A	2	2	4	0	0	4	0	0
17	26585135	.	G	T	2	2	4	0	0	4	0	0
17	26585163	.	A	T	1	1	2	0	1	3	0	0
17	26585298	.	G	T	0	3	3	0	1	4	0	0
17	26585646	.	C	T	4	3	7	0	0	7	0	0
17	26585727	.	C	T	1	6	7	0	0	7	0	0
17	26585748	.	A	G	9	0	9	0	4	13	0	0
17	26585763	.	T	A	10	6	16	0	1	17	0	0
17	26590001	.	T	G	10	7	17	0	0	17	0	0
17	26590054	.	C	T	7	4	11	0	0	11	0	0
17	26590091	.	C	T	3	3	6	0	2	8	0	0
17	26590330	.	T	C	9	3	12	0	0	12	0	0
17	26590650	.	G	T	3	6	9	0	0	9	0	0
17	26600555	.	T	A	1	3	4	0	1	5	0	0
17	26600639	.	G	A	1	2	3	0	0	3	0	0
17	26600667	.	C	T	2	2	4	0	0	4	0	0
17	26600785	.	G	A	4	3	7	0	1	8	0	0
17	26604572	.	A	G	3	2	5	0	0	5	0	0
17	26639659	.	C	T	4	2	6	0	0	6	0	0
17	26639725	.	A	G	5	0	5	0	3	8	0	0
17	26642775	.	C	A	1	2	3	0	0	3	0	0
17	26642817	.	T	G	2	0	2	0	2	4	0	0
17	26642818	.	T	C	1	2	3	0	1	4	0	0
17	26657852	.	T	C	8	7	15	0	0	15	0	0
17	26662347	.	C	T	5	2	7	0	0	7	0	0
17	26683466	.	T	C	15	7	22	1	0	23	0	0
17	26683526	.	C	T	10	10	20	1	0	21	0	0
17	26689753	.	G	A	11	15	26	0	7	33	0	0
17	26689768	.	C	A	27	7	34	0	2	36	0	0
17	26689792	.	C	A	13	12	25	0	3	28	0	0
17	26690112	.	T	A	25	12	37	0	1	38	0	0
17	26690250	.	C	T	7	7	14	0	1	15	0	0
17	26690276	.	C	T	11	11	22	0	0	22	0	0
17	26690478	.	C	T	13	14	27	0	1	28	0	0
17	26690558	.	G	A	2	11	13	0	27	40	0	0
17	26714009	.	C	T	32	26	58	0	5	63	0	0
17	26744748	.	T	A	0	3	3	0	1	4	0	0
17	26744981	.	C	T	1	2	3	0	0	3	0	0
17	26747348	.	A	G	2	3	5	0	0	5	0	0
17	26747392	.	G	T	5	4	9	0	2	11	0	0
17	26749836	.	G	A	2	2	4	0	0	4	0	0
17	26810380	.	C	T	15	15	30	0	0	30	0	0
17	26812487	.	T	G	3	18	21	0	1	22	0	0
17	26813285	.	T	C	8	21	29	4	5	38	0	0
17	26832713	.	C	T	5	3	8	0	0	8	0	0
17	26832738	.	A	G	5	3	8	0	0	8	0	0
17	26846203	.	C	T	9	9	18	0	0	18	0	0
17	26846650	.	G	A	9	4	13	0	4	17	0	0
17	26846901	.	T	G	4	6	10	1	0	11	0	0
17	26879854	.	A	C	13	20	33	0	0	33	0	0
17	26879869	.	A	G	15	14	29	0	2	31	0	0
17	26879893	.	A	G	23	25	48	0	1	49	0	0
17	26880107	.	G	A	27	19	46	0	1	47	0	0
17	26880231	.	T	C	34	25	59	0	1	60	0	0
17	26880424	.	T	C	37	11	48	0	3	51	0	0
17	26880670	.	T	C	35	7	42	0	1	43	0	0
17	26880926	.	T	C	20	0	20	0	18	38	0	0
17	26880964	.	A	G	24	22	46	0	2	48	0	0
17	26881131	.	T	A	15	17	32	0	4	36	0	0
17	26881354	.	A	G	17	15	32	0	1	33	0	0
17	26881777	.	A	G	17	10	27	0	2	29	0	0
17	26911747	.	A	G	4	7	11	0	0	11	0	0
17	26924308	.	C	T	0	4	4	0	1	5	0	0
17	26928994	.	C	T	5	2	7	0	0	7	0	0
17	26929029	.	G	A	2	7	9	0	0	9	0	0
17	26929475	.	T	C	4	4	8	0	0	8	0	0
17	26929577	.	C	A	4	5	9	0	2	11	0	0
17	26929649	.	A	G	6	4	10	0	1	11	0	0
17	26929654	.	T	A	4	5	9	0	0	9	0	0
17	26929776	.	C	T	2	6	8	0	0	8	0	0
17	26929893	.	G	A	5	6	11	0	0	11	0	0
17	26933223	.	A	G	3	2	5	0	0	5	0	0
17	26985158	.	G	A	1	6	7	0	5	12	0	0
17	26985473	.	G	A	1	4	5	0	0	5	0	0
17	26985544	.	T	A	1	4	5	0	0	5	0	0
17	26985561	.	T	G	1	0	1	0	2	3	0	0
17	26985586	.	C	T	1	2	3	0	0	3	0	0
17	27160912	.	G	A	2	2	4	0	0	4	0	0
17	27164530	.	C	T	3	3	6	0	0	6	0	0
17	27166221	.	T	C	2	2	4	0	0	4	0	0
17	27166257	.	T	C	3	2	5	0	0	5	0	0
17	27168957	.	G	T	0	3	3	0	4	7	0	0
17	27169561	.	T	G	2	6	8	0	0	8	0	0
17	27169783	.	A	C	3	3	6	0	0	6	0	0
17	27170017	.	G	A	1	8	9	0	4	13	0	0
17	27170153	.	A	T	3	8	11	0	0	11	0	0
17	27170516	.	G	A	0	5	5	0	10	15	0	0
17	27170549	.	G	A	9	5	14	0	0	14	0	0
17	27170605	.	T	G	8	6	14	0	0	14	0	0
17	27170703	.	C	T	5	3	8	0	5	13	0	0
17	27170730	.	T	G	4	10	14	0	1	15	0	0
17	27170746	.	A	T	2	10	12	0	1	13	0	0
17	27171314	.	A	C	4	7	11	0	0	11	0	0
17	27178557	.	C	T	1	2	3	0	0	3	0	0
17	27178730	.	C	A	1	2	3	0	0	3	0	0
17	27178870	.	T	C	2	2	4	0	0	4	0	0
17	27179189	.	A	G	1	3	4	0	1	5	0	0
17	27181021	.	T	C	1	5	6	0	0	6	0	0
17	27181048	.	C	G	1	6	7	0	0	7	0	0
17	27181129	.	G	A	5	6	11	0	1	12	0	0
17	27181130	.	G	A	5	6	11	0	1	12	0	0
17	27181257	.	A	C	6	5	11	0	1	12	0	0
17	27181323	.	A	G	8	0	8	0	5	13	0	0
17	27181411	.	A	G	3	1	4	0	5	9	0	0
17	27181427	.	C	T	3	6	9	0	0	9	0	0
17	27181463	.	A	G	1	0	1	0	2	3	0	0
17	27181680	.	C	T	2	2	4	0	0	4	0	0
17	27182114	.	A	G	2	6	8	0	0	8	0	0
17	27182146	.	C	T	3	5	8	0	0	8	0	0
17	27182331	.	T	G	2	5	7	0	0	7	0	0
17	27182340	.	C	T	2	4	6	0	0	6	0	0
17	27182449	.	G	T	3	3	6	0	0	6	0	0
17	27182484	.	T	C	6	7	13	0	0	13	0	0
17	27182645	.	G	T	9	16	25	0	0	25	0	0
17	27182649	.	A	G	10	16	26	0	0	26	0	0
17	27182769	.	A	G	8	9	17	0	0	17	0	0
17	27182894	.	T	C	11	9	20	0	0	20	0	0
17	27182925	.	A	T	5	9	14	0	0	14	0	0
17	27182979	.	C	T	10	4	14	0	1	15	0	0
17	27194168	.	A	G	2	4	6	0	0	6	0	0
17	27194183	.	A	G	2	4	6	0	0	6	0	0
17	27272913	.	T	C	7	3	10	0	1	11	0	0
17	27273013	.	C	T	7	4	11	0	1	12	0	0
17	27401038	.	A	T	8	9	17	0	11	28	0	0
17	27408386	.	A	G	14	11	25	0	0	25	0	0
17	27408472	.	C	T	8	15	23	0	2	25	0	0
17	27408523	.	G	T	7	6	13	0	0	13	0	0
17	27408531	.	T	A	3	4	7	0	3	11	1	0
17	27408836	.	T	G	6	7	13	0	2	15	0	0
17	27408889	.	T	C	12	9	21	0	0	21	0	0
17	27413564	.	T	C	12	5	17	0	4	21	0	0
17	27413705	.	T	C	3	3	6	0	1	7	0	0
17	27414035	.	G	A	2	2	4	0	0	4	0	0
17	27414098	.	C	A	2	6	8	0	1	9	0	0
17	27414203	.	G	A	5	4	9	0	0	9	0	0
17	27414215	.	C	T	0	2	2	0	8	10	0	0
17	27414367	.	A	G	2	4	6	0	1	7	0	0
17	27414658	.	T	C	4	2	6	0	1	7	0	0
17	27414791	.	A	G	5	3	8	0	0	8	0	0
17	27414815	.	G	A	5	2	7	0	0	7	0	0
17	27415010	.	C	T	0	4	4	0	2	6	0	0
17	27723800	.	G	T	3	5	8	0	1	9	0	0
17	27807455	.	T	C	6	15	21	0	0	21	0	0
17	27808190	.	A	G	4	1	5	0	6	11	0	0
17	27808335	.	A	G	8	8	16	0	2	18	0	0
17	27808686	.	G	A	6	2	8	0	1	9	0	0
17	27808700	.	G	A	7	3	10	0	0	10	0	0
17	27808987	.	G	T	0	17	17	0	30	47	0	0
17	27809548	.	T	A	11	11	22	0	2	24	0	0
17	27809631	.	G	T	2	7	9	0	13	22	0	0
17	27809779	.	C	A	25	21	46	0	2	48	0	0
17	27809885	.	A	G	25	19	44	0	3	47	0	0
17	27811199	.	T	A	8	4	12	0	0	12	0	0
17	27811209	.	A	G	8	6	14	0	0	14	0	0
17	27811254	.	T	C	8	9	17	0	0	17	0	0
17	27811277	.	C	G	6	6	12	0	0	12	0	0
17	27812525	.	A	C	19	13	32	0	2	34	0	0
17	27812562	.	G	A	3	10	13	0	18	31	0	0
17	27812702	.	A	T	15	8	23	0	0	23	0	0
17	27812885	.	C	T	4	6	10	0	0	10	0	0
17	27813221	.	C	T	15	12	27	0	3	30	0	0
17	27813222	.	A	G	16	12	28	0	3	31	0	0
17	27813549	.	C	G	11	4	15	0	0	15	0	0
17	27813553	.	C	G	10	4	14	0	1	15	0	0
17	28067389	.	C	T	2	4	6	0	0	6	0	0
17	28067472	.	A	C	4	3	7	0	0	7	0	0
17	28067618	.	A	G	1	2	3	0	0	3	0	0
17	28067856	.	C	T	3	3	6	0	2	8	0	0
17	28068083	.	T	C	6	3	9	0	0	9	0	0
17	28068087	.	G	T	7	3	10	0	0	10	0	0
17	28068262	.	T	G	2	0	2	0	4	6	0	0
17	28068507	.	A	G	2	4	6	0	0	6	0	0
17	28068514	.	T	C	2	4	6	0	1	7	0	0
17	28068916	.	C	T	2	3	5	0	0	5	0	0
17	28069170	.	G	A	4	3	7	1	0	8	0	0
17	28069341	.	G	T	4	7	11	0	0	11	0	0
17	28069342	.	T	C	4	7	11	0	0	11	0	0
17	28069645	.	G	T	12	4	16	0	1	17	0	0
17	28069716	.	G	C	12	10	22	0	0	22	0	0
17	28069787	.	G	A	3	9	12	0	14	26	0	0
17	28070078	.	G	C	5	7	12	0	0	12	0	0
17	28070167	.	C	T	12	8	20	0	1	21	0	0
17	28070481	.	T	A	20	12	32	0	1	33	0	0
17	28070600	.	C	A	12	5	17	0	2	19	0	0
17	28070840	.	G	A	6	11	17	0	0	17	0	0
17	28070879	.	T	G	2	8	10	0	1	11	0	0
17	28070897	.	T	A	3	4	7	0	0	7	0	0
17	28071260	.	A	G	10	9	19	0	2	21	0	0
17	28084592	.	C	T	9	7	16	0	0	16	0	0
17	28084908	.	C	T	17	16	33	0	0	33	0	0
17	28097235	.	G	A	7	4	11	0	1	12	0	0
17	28100598	.	C	T	1	2	3	0	5	8	0	0
17	28167312	.	G	A	5	6	11	0	0	11	0	0
17	28167313	.	A	T	5	6	11	0	0	11	0	0
17	28169141	.	A	C	1	2	3	0	0	3	0	0
17	28661628	.	C	G	2	0	2	0	2	4	0	0
17	28661931	.	G	T	1	4	5	0	1	6	0	0
17	28666381	.	C	T	7	2	9	0	0	9	0	0
17	28668627	.	C	T	2	2	4	0	0	4	0	0
17	28694574	.	A	T	7	5	12	0	1	13	0	0
17	28694589	.	T	C	5	7	12	0	0	12	0	0
17	28695956	.	G	A	6	5	11	0	2	13	0	0
17	28696109	.	C	A	3	6	9	0	0	9	0	0
17	28696160	.	C	T	7	8	15	0	0	15	0	0
17	28696311	.	C	T	4	6	10	0	1	11	0	0
17	28696397	.	A	G	7	0	7	0	10	17	0	0
17	28700311	.	T	C	8	18	26	0	2	28	0	0
17	28700428	.	G	A	14	15	29	0	3	32	0	0
17	28701100	.	G	A	13	12	25	1	0	26	0	0
17	28707851	.	C	A	0	5	5	0	12	17	0	0
17	28730705	.	C	T	3	3	6	1	0	7	0	0
17	28738387	.	C	T	2	3	5	0	0	5	0	0
17	28738675	.	A	G	3	0	3	0	3	6	0	0
17	28741421	.	A	C	13	7	20	0	2	22	0	0
17	28741540	.	A	G	9	1	10	0	7	17	0	0
17	28741752	.	C	T	5	9	14	0	0	14	0	0
17	28741934	.	C	T	6	10	16	0	0	16	0	0
17	28742263	.	G	C	13	13	26	0	1	27	0	0
17	28742385	.	T	A	9	8	17	1	2	20	0	0
17	28742395	.	G	A	2	8	10	1	11	22	0	0
17	28742559	.	C	T	24	13	37	0	1	38	0	0
17	28771099	.	C	T	7	4	11	0	0	11	0	0
17	28771228	.	T	A	12	16	28	0	1	29	0	0
17	28777803	.	C	T	8	6	14	0	0	14	0	0
17	28784090	.	G	T	6	6	12	0	1	13	0	0
17	28784102	.	G	A	6	6	12	0	1	13	0	0
17	28785010	.	G	A	7	4	11	0	0	11	0	0
17	28785013	.	C	T	4	6	10	0	0	10	0	0
17	28789014	.	C	T	0	3	3	0	4	7	0	0
17	28793818	.	G	A	2	2	4	0	0	4	0	0
17	28959148	.	T	C	6	4	10	0	0	10	0	0
17	28968461	.	T	C	24	16	40	0	1	41	0	0
17	28968611	.	C	T	2	4	6	0	1	7	0	0
17	29117355	.	G	A	7	3	10	0	1	11	0	0
17	29227807	.	C	T	1	4	5	0	0	5	0	0
17	29252207	.	G	A	8	7	15	0	1	16	0	0
17	29252254	.	C	T	6	3	9	0	2	11	0	0
17	29253050	.	T	C	5	7	12	0	0	12	0	0
17	29282901	.	C	A	2	4	6	0	0	6	0	0
17	29282913	.	C	T	1	3	4	0	1	5	0	0
17	29283866	.	T	C	2	4	6	0	1	7	0	0
17	29283920	.	A	C	4	0	4	0	8	12	0	0
17	29283943	.	A	G	6	4	10	0	0	10	0	0
17	29283962	.	A	G	6	3	9	0	1	10	0	0
17	29288718	.	A	G	7	2	9	0	0	9	0	0
17	29334520	.	T	A	1	7	8	0	1	9	0	0
17	29334569	.	A	C	4	9	13	0	0	13	0	0
17	29335645	.	G	A	4	4	8	0	0	8	0	0
17	29341079	.	C	T	10	7	17	0	0	17	0	0
17	29341123	.	C	A	7	9	16	0	0	16	0	0
17	29369642	.	G	T	2	4	6	0	0	6	0	0
17	29369644	.	G	A	2	4	6	0	0	6	0	0
17	29797906	.	C	T	6	5	11	0	0	11	0	0
17	29877283	.	C	A	0	2	2	0	1	3	0	0
17	30417650	.	T	A	1	3	4	0	0	4	0	0
17	30590075	.	A	T	10	6	16	0	2	18	0	0
17	30979391	.	T	C	5	0	5	0	14	19	0	0
17	32524695	.	A	G	43	16	59	0	1	60	0	0
17	33502576	.	C	G	3	2	5	0	0	5	0	0
17	37317495	.	A	G	2	0	2	0	1	3	0	0
17	37363938	.	A	G	1	0	1	0	4	5	0	0
17	37445659	.	G	A	5	3	8	0	0	8	0	0
17	37445729	.	G	A	7	3	10	0	0	10	0	0
17	37445790	.	T	C	3	5	8	0	1	9	0	0
17	37445924	.	G	A	13	9	22	0	0	22	0	0
17	37445926	.	A	T	9	13	22	0	0	22	0	0
17	37446208	.	A	T	3	8	11	0	1	13	1	0
17	37446379	.	T	C	4	4	8	0	2	10	0	0
17	37446443	.	T	G	9	6	15	0	0	15	0	0
17	37446555	.	T	A	5	5	10	0	0	10	0	0
17	37446563	.	G	A	8	3	11	0	0	11	0	0
17	37446735	.	G	A	4	14	18	0	1	19	0	0
17	37446789	.	A	C	11	0	11	0	5	16	0	0
17	37450180	.	T	G	2	2	4	0	0	4	0	0
17	37474560	.	T	G	1	3	4	0	0	4	0	0
17	37593662	.	C	T	4	3	7	0	0	7	0	0
17	37603748	.	G	A	0	4	4	0	9	13	0	0
17	37605870	.	A	G	10	0	10	0	11	21	0	0
17	37606011	.	G	A	0	9	9	0	9	18	0	0
17	37606101	.	G	A	1	6	7	0	5	12	0	0
17	37606116	.	G	A	7	7	14	0	0	14	0	0
17	37618028	.	C	G	9	13	22	2	0	24	0	0
17	37618143	.	T	C	4	5	9	0	3	12	0	0
17	37618157	.	A	C	4	4	8	0	1	9	0	0
17	37618485	.	C	T	7	12	19	0	2	21	0	0
17	37624913	.	A	T	2	2	4	0	0	4	0	0
17	37792745	.	A	G	1	3	4	0	0	4	0	0
17	37793627	.	G	A	1	2	3	0	0	3	0	0
17	38263804	.	A	G	4	3	7	0	0	7	0	0
17	38264044	.	G	T	6	8	14	0	0	14	0	0
17	38296642	.	G	A	5	2	7	0	0	7	0	0
17	38296644	.	T	G	1	4	5	0	1	6	0	0
17	38303423	.	C	T	11	7	18	0	0	18	0	0
17	38303607	.	A	G	5	8	13	0	4	17	0	0
17	38303652	.	G	A	1	9	10	0	5	15	0	0
17	38473289	.	T	C	2	2	4	0	0	4	0	0
17	38713709	.	C	T	2	2	4	0	0	4	0	0
17	38714280	.	A	T	2	4	6	0	0	6	0	0
17	38714304	.	G	T	3	2	5	0	0	5	0	0
17	38714446	.	A	G	1	3	4	1	0	5	0	0
17	38714578	.	A	T	5	3	8	0	0	8	0	0
17	38714811	.	T	C	1	2	3	0	0	3	0	0
17	38740626	.	G	A	1	2	3	0	0	3	0	0
17	38740684	.	T	C	4	9	13	0	2	15	0	0
17	38740698	.	A	T	7	10	17	0	0	17	0	0
17	38751711	.	T	A	6	8	14	0	1	15	0	0
17	38754825	.	C	A	6	9	15	0	1	16	0	0
17	38755038	.	A	G	2	14	16	0	0	16	0	0
17	38756777	.	T	G	6	5	11	0	0	11	0	0
17	38758682	.	G	A	1	5	6	0	0	6	0	0
17	38768483	.	G	A	2	3	5	0	0	5	0	0
17	38769924	.	T	A	3	3	6	0	0	6	0	0
17	38769935	.	T	C	1	3	4	0	1	5	0	0
17	38769975	.	G	A	5	3	8	0	0	8	0	0
17	38787498	.	G	A	2	3	5	0	0	5	0	0
17	39717616	.	T	C	0	2	2	0	1	3	0	0
17	39728239	.	C	T	7	4	11	0	1	12	0	0
17	39728261	.	G	T	7	5	12	0	1	13	0	0
17	39728423	.	T	A	4	3	7	0	0	7	0	0
17	39729014	.	G	A	5	6	11	0	1	12	0	0
17	39732512	.	C	T	4	4	8	0	0	8	0	0
17	39732573	.	C	A	7	5	12	0	0	12	0	0
17	39732584	.	G	A	5	7	12	0	0	12	0	0
17	39736088	.	T	A	4	9	13	1	0	14	0	0
17	39736103	.	G	A	4	8	12	0	0	12	0	0
17	39736130	.	T	C	7	9	16	0	0	16	0	0
17	39739842	.	A	T	13	8	21	0	0	21	0	0
17	39862536	.	C	G	4	2	6	0	0	6	0	0
17	39863633	.	C	T	1	3	4	0	0	4	0	0
17	40900389	.	G	A	1	4	5	0	0	5	0	0
17	40901695	.	G	C	5	7	12	0	0	13	1	0
17	40901712	.	C	G	3	8	11	0	0	11	0	0
17	40902005	.	C	A	3	5	8	0	1	9	0	0
17	40902148	.	G	T	2	3	5	0	3	8	0	0
17	40902180	.	G	C	5	3	8	0	2	10	0	0
17	40902347	.	C	T	9	4	13	0	0	13	0	0
17	40902598	.	G	A	8	5	13	0	0	13	0	0
17	40902629	.	A	T	6	5	11	0	1	13	1	0
17	40902657	.	A	C	9	5	14	0	0	14	0	0
17	40902830	.	A	T	4	11	15	0	1	16	0	0
17	40903162	.	C	T	8	10	18	0	1	19	0	0
17	40932270	.	G	A	1	2	3	0	0	3	0	0
17	40990061	.	T	A	12	12	24	0	0	24	0	0
17	40990097	.	T	A	15	10	25	0	0	25	0	0
17	40999460	.	A	G	20	8	28	0	0	28	0	0
17	40999697	.	C	G	11	9	20	0	1	21	0	0
17	40999700	.	C	A	13	9	22	0	0	22	0	0
17	40999732	.	A	G	7	12	19	0	0	19	0	0
17	41220064	.	T	A	5	2	7	0	0	7	0	0
17	41254741	.	C	T	7	7	14	0	1	15	0	0
17	41264045	.	T	A	3	11	14	0	0	14	0	0
17	41264165	.	C	A	3	6	9	0	0	9	0	0
17	41314471	.	G	A	3	3	6	0	0	6	0	0
17	41317234	.	A	G	8	0	8	0	11	19	0	0
17	41317494	.	G	A	14	10	24	0	1	25	0	0
17	41317999	.	G	A	16	17	33	0	3	36	0	0
17	41318310	.	A	G	15	15	30	0	1	31	0	0
17	41318392	.	G	A	2	6	8	0	1	9	0	0
17	41464090	.	G	A	1	2	3	0	2	5	0	0
17	41465504	.	A	C	3	5	8	0	0	8	0	0
17	41465922	.	G	A	3	3	6	0	0	6	0	0
17	41475863	.	T	C	10	19	29	0	2	31	0	0
17	41476104	.	T	C	22	0	22	0	19	41	0	0
17	41476161	.	A	G	14	21	35	1	3	39	0	0
17	41476279	.	G	A	13	21	34	0	2	36	0	0
17	41476298	.	T	A	14	13	27	0	3	30	0	0
17	41476393	.	G	T	11	7	18	0	5	23	0	0
17	41476833	.	T	C	2	3	5	0	0	5	0	0
17	41476906	.	A	C	3	0	3	0	3	6	0	0
17	41476917	.	C	T	0	2	2	0	4	6	0	0
17	41476970	.	T	C	5	5	10	0	1	11	0	0
17	41476994	.	G	A	4	7	11	0	1	12	0	0
17	41477007	.	C	T	0	6	6	0	7	13	0	0
17	41477157	.	T	C	4	3	7	0	2	9	0	0
17	41477324	.	G	A	15	9	24	0	0	24	0	0
17	41558269	.	G	C	1	3	4	0	0	4	0	0
17	41571328	.	T	A	3	3	6	0	0	6	0	0
17	41583681	.	G	A	5	3	8	0	0	8	0	0
17	41583690	.	G	A	5	1	6	0	0	6	0	0
17	41583786	.	A	G	1	1	2	0	0	2	0	0
17	42027915	.	C	T	5	7	12	0	1	13	0	0
17	42030083	.	A	G	16	1	17	0	7	24	0	0
17	42032119	.	T	C	10	6	16	0	1	17	0	0
17	42095602	.	A	G	3	4	7	0	1	8	0	0
17	42095620	.	C	T	4	3	7	0	0	7	0	0
17	42566263	.	T	A	1	2	3	0	0	3	0	0
17	42871419	.	G	T	3	7	10	0	0	10	0	0
17	43013675	.	G	A	12	17	29	0	2	31	0	0
17	43017672	.	C	T	7	7	14	0	2	16	0	0
17	43017687	.	G	A	11	6	17	0	0	17	0	0
17	43017830	.	A	G	6	6	12	0	0	12	0	0
17	43017863	.	A	C	8	7	15	0	0	15	0	0
17	43018037	.	G	A	1	10	11	0	18	29	0	0
17	43018124	.	A	G	16	0	16	0	17	33	0	0
17	43018273	.	G	A	20	13	33	0	2	35	0	0
17	43018382	.	T	G	14	11	25	0	4	29	0	0
17	43018502	.	T	A	23	17	40	0	0	40	0	0
17	43018549	.	C	G	16	14	30	0	2	32	0	0
17	43018638	.	A	T	19	14	33	0	0	33	0	0
17	43018815	.	A	G	21	21	42	0	3	45	0	0
17	43018899	.	T	A	19	22	41	0	1	42	0	0
17	43030696	.	T	C	6	3	9	0	0	9	0	0
17	43030737	.	T	G	8	9	17	0	0	17	0	0
17	43030828	.	G	A	10	9	19	0	0	19	0	0
17	43031495	.	G	A	5	6	11	0	1	12	0	0
17	43033177	.	G	A	19	8	27	0	2	30	1	0
17	43035798	.	T	C	19	22	41	0	2	43	0	0
17	43035958	.	A	G	14	5	19	0	4	23	0	0
17	43039706	.	A	G	3	7	10	0	1	11	0	0
17	43040422	.	T	A	4	4	8	0	0	8	0	0
17	43082976	.	A	T	3	2	5	0	0	5	0	0
17	43297946	.	G	C	6	3	9	0	1	10	0	0
17	43298011	.	G	A	7	3	10	0	0	10	0	0
17	43298068	.	G	A	4	5	9	0	0	9	0	0
17	43302492	.	G	A	1	3	4	0	1	5	0	0
17	43309164	.	C	T	0	2	2	0	3	5	0	0
17	43348986	.	T	C	2	2	4	0	2	6	0	0
17	43436782	.	T	C	19	2	21	0	15	36	0	0
17	43437305	.	G	C	24	13	37	0	2	39	0	0
17	43437365	.	C	G	18	21	39	0	1	40	0	0
17	43439720	.	G	T	16	13	29	1	0	30	0	0
17	43441575	.	A	T	13	11	24	0	0	24	0	0
17	43453507	.	T	C	5	12	17	0	0	17	0	0
17	43453531	.	G	A	2	9	11	0	0	11	0	0
17	43456825	.	C	T	2	5	7	0	0	7	0	0
17	43456900	.	G	A	2	4	6	0	0	6	0	0
17	43461181	.	G	A	5	3	8	0	1	9	0	0
17	43469204	.	A	C	4	5	9	0	0	9	0	0
17	43469515	.	G	T	5	2	7	0	0	7	0	0
17	43473913	.	T	C	2	5	7	0	1	8	0	0
17	43475562	.	T	C	11	9	20	0	1	21	0	0
17	43475577	.	G	A	0	7	7	0	9	16	0	0
17	43475619	.	A	G	3	0	3	0	7	10	0	0
17	43475691	.	T	A	6	2	8	0	0	8	0	0
17	43475712	.	A	G	3	0	3	0	2	5	0	0
17	43476137	.	T	A	8	10	18	0	1	19	0	0
17	43476232	.	A	G	1	4	5	0	0	5	0	0
17	43513318	.	C	T	0	13	13	0	9	22	0	0
17	43516451	.	T	A	5	3	8	0	1	9	0	0
17	43516464	.	T	A	5	3	8	0	1	9	0	0
17	43516502	.	G	T	7	3	10	0	0	10	0	0
17	43516506	.	A	C	7	4	11	0	0	11	0	0
17	43516548	.	A	G	9	8	17	0	0	17	0	0
17	43522782	.	T	C	2	0	2	0	4	6	0	0
17	43525600	.	C	G	1	3	4	0	0	4	0	0
17	43525804	.	G	A	0	2	2	0	1	3	0	0
17	43538209	.	C	T	4	2	6	0	0	6	0	0
17	43611752	.	C	T	1	3	4	0	0	4	0	0
17	43612005	.	G	T	1	3	4	0	1	5	0	0
17	43612007	.	T	A	1	3	4	0	0	4	0	0
17	43615239	.	T	G	2	2	4	0	0	4	0	0
17	43615242	.	C	T	1	2	3	0	1	4	0	0
17	43660232	.	G	A	8	6	14	0	0	14	0	0
17	43660779	.	T	C	7	5	12	0	3	15	0	0
17	43661106	.	T	G	8	9	17	0	0	17	0	0
17	43663611	.	T	G	4	7	11	0	0	11	0	0
17	43663789	.	A	C	21	19	40	0	2	42	0	0
17	43663870	.	G	A	16	25	41	0	0	41	0	0
17	43664128	.	G	C	15	17	32	0	1	33	0	0
17	43664580	.	A	G	7	6	13	0	1	14	0	0
17	43664605	.	G	A	5	8	13	0	0	13	0	0
17	43665937	.	A	T	5	6	11	0	0	11	0	0
17	43665952	.	G	A	2	3	5	0	0	6	1	0
17	43708546	.	C	T	5	4	9	0	0	9	0	0
17	43708563	.	A	G	5	3	8	0	0	8	0	0
17	43708608	.	C	T	8	5	13	0	1	14	0	0
17	43708649	.	T	C	6	3	9	0	1	10	0	0
17	43711557	.	C	T	1	6	7	0	2	9	0	0
17	43715851	.	T	C	4	6	10	0	1	11	0	0
17	43851013	.	A	G	11	9	20	0	1	21	0	0
17	43853538	.	G	A	15	13	28	0	2	30	0	0
17	43853767	.	A	G	6	10	16	0	0	16	0	0
17	43853778	.	C	T	1	7	8	0	11	19	0	0
17	43853938	.	C	T	4	10	14	0	0	14	0	0
17	43854007	.	G	A	4	8	12	0	0	12	0	0
17	43854010	.	T	G	9	3	12	0	1	13	0	0
17	43859282	.	T	C	1	3	4	0	0	4	0	0
17	43863609	.	A	C	7	4	11	0	0	11	0	0
17	43863655	.	G	C	2	3	5	0	0	5	0	0
17	43863656	.	C	T	2	3	5	0	0	5	0	0
17	43879205	.	T	C	1	2	3	0	0	3	0	0
17	43883634	.	C	T	8	3	11	0	0	11	0	0
17	43946901	.	C	T	3	4	7	0	1	8	0	0
17	43987048	.	A	G	15	8	23	0	1	24	0	0
17	43996483	.	G	A	27	13	40	0	1	41	0	0
17	43996485	.	G	A	28	12	40	0	1	41	0	0
17	43996620	.	A	T	28	16	44	0	0	44	0	0
17	43996667	.	G	A	20	15	35	0	3	38	0	0
17	44001540	.	A	G	20	20	40	0	0	40	0	0
17	44001584	.	T	C	12	15	27	0	1	28	0	0
17	44002032	.	A	T	6	15	21	0	0	21	0	0
17	44007262	.	G	T	1	3	4	0	0	4	0	0
17	44007314	.	G	C	1	0	1	0	2	3	0	0
17	44007316	.	G	T	1	2	3	0	0	3	0	0
17	44007351	.	T	C	1	3	4	0	0	4	0	0
17	44474591	.	G	T	1	2	3	1	2	6	0	0
17	44963753	.	C	T	1	6	7	0	0	7	0	0
17	45138591	.	T	C	9	3	12	0	0	12	0	0
17	45138733	.	T	C	8	11	19	0	2	21	0	0
17	45138741	.	T	C	9	9	18	0	2	20	0	0
17	45139277	.	T	C	4	2	6	0	0	6	0	0
17	45139429	.	T	C	13	7	20	0	1	21	0	0
17	45402422	.	A	G	4	3	7	0	0	7	0	0
17	45402713	.	T	A	3	8	11	0	0	11	0	0
17	45402714	.	C	T	3	8	11	0	0	11	0	0
17	45402811	.	A	G	2	3	5	0	0	5	0	0
17	45402895	.	A	C	1	4	5	0	1	6	0	0
17	45458154	.	C	G	1	0	1	0	2	3	0	0
17	45482121	.	T	C	3	3	6	0	0	6	0	0
17	45482313	.	A	T	2	2	4	0	0	4	0	0
17	45731991	.	T	C	8	6	14	0	0	14	0	0
17	45732147	.	T	C	7	13	20	0	0	20	0	0
17	45732173	.	C	T	0	11	11	0	7	18	0	0
17	45732327	.	G	A	14	11	25	0	2	27	0	0
17	45733632	.	T	G	1	3	4	0	0	4	0	0
17	45756484	.	A	G	2	3	5	0	2	7	0	0
17	45765234	.	G	A	4	11	15	0	4	19	0	0
17	45774378	.	G	A	0	5	5	0	4	9	0	0
17	45774425	.	C	A	3	2	5	0	0	5	0	0
17	45984465	.	G	T	0	2	2	0	1	3	0	0
17	45987075	.	G	A	0	5	5	0	2	7	0	0
17	45987120	.	C	T	2	6	8	0	0	8	0	0
17	45987358	.	G	A	4	2	6	0	0	6	0	0
17	45988742	.	T	C	6	2	8	0	0	9	1	0
17	45988991	.	G	C	1	7	8	0	0	8	0	0
17	45989003	.	A	G	2	0	2	0	6	8	0	0
17	45989032	.	G	T	10	3	13	0	1	14	0	0
17	46457321	.	G	C	3	2	5	0	0	5	0	0
17	46457326	.	C	A	0	2	2	0	3	5	0	0
17	46852240	.	A	G	1	7	8	16	0	24	0	0
17	47164707	.	T	C	1	2	3	0	0	3	0	0
17	47189003	.	A	G	8	5	13	0	1	14	0	0
17	47189025	.	C	A	9	5	14	0	1	15	0	0
17	47189283	.	A	T	8	5	13	0	0	13	0	0
17	47189725	.	G	A	8	6	14	0	0	14	0	0
17	47189765	.	G	T	3	4	7	0	0	7	0	0
17	47189790	.	A	G	2	4	6	0	0	6	0	0
17	47189810	.	C	T	0	4	4	0	4	8	0	0
17	47189919	.	G	T	3	9	12	0	0	12	0	0
17	47190032	.	C	T	11	6	17	0	0	17	0	0
17	47190045	.	C	A	1	9	10	0	5	15	0	0
17	47190118	.	A	G	5	4	9	0	0	9	0	0
17	47190149	.	G	C	4	2	6	0	0	6	0	0
17	47190264	.	C	T	2	4	6	0	1	7	0	0
17	47190892	.	T	C	2	0	2	0	3	5	0	0
17	47190929	.	C	T	2	2	4	0	0	4	0	0
17	47191842	.	T	C	0	3	3	0	1	4	0	0
17	47192766	.	C	T	1	3	4	0	0	4	0	0
17	47192872	.	A	G	2	2	4	1	0	5	0	0
17	47193359	.	T	C	1	0	1	0	2	3	0	0
17	48139427	.	T	C	3	2	5	0	0	5	0	0
17	48908911	.	A	G	4	7	11	0	0	11	0	0
17	48911097	.	T	G	2	3	5	0	0	5	0	0
17	49011174	.	A	G	3	2	5	0	0	5	0	0
17	49011177	.	C	A	3	1	4	0	1	5	0	0
17	49016534	.	C	T	2	3	5	0	0	5	0	0
17	49018224	.	G	A	3	3	6	0	6	12	0	0
17	49018508	.	C	G	4	6	10	0	1	11	0	0
17	49018575	.	G	A	9	4	13	0	1	14	0	0
17	49019177	.	C	A	17	17	34	0	1	35	0	0
17	49300392	.	C	T	1	3	4	0	0	4	0	0
17	49306256	.	C	T	19	4	23	0	0	23	0	0
17	49306334	.	G	A	3	1	4	0	9	14	1	0
17	49306341	.	T	C	14	1	15	0	2	17	0	0
17	49416044	.	T	G	11	6	17	0	0	17	0	0
17	49416151	.	T	C	15	0	15	3	6	24	0	0
17	49416327	.	T	C	13	6	19	0	0	19	0	0
17	49416992	.	G	A	4	5	9	0	1	10	0	0
17	49417137	.	C	T	10	4	14	0	1	15	0	0
17	49417148	.	A	T	9	5	14	0	0	15	1	0
17	49417569	.	T	C	5	4	9	0	1	10	0	0
17	49417599	.	G	C	5	4	9	0	0	9	0	0
17	49417835	.	G	A	1	5	6	0	0	6	0	0
17	49417838	.	A	G	2	5	7	0	0	7	0	0
17	49417961	.	A	C	3	3	6	0	0	6	0	0
17	49417974	.	C	A	3	2	5	0	1	6	0	0
17	49419761	.	G	T	2	2	4	0	0	4	0	0
17	49527783	.	A	G	4	3	7	0	1	8	0	0
17	49983202	.	A	T	15	5	20	0	1	21	0	0
17	49983273	.	C	T	16	26	42	0	2	44	0	0
17	49983315	.	C	T	26	17	43	0	0	43	0	0
17	49992629	.	G	A	28	32	60	0	4	64	0	0
17	49998171	.	T	C	11	9	20	0	2	22	0	0
17	49998221	.	G	A	11	8	19	0	0	19	0	0
17	49998658	.	G	A	6	4	10	0	1	11	0	0
17	49998734	.	G	A	14	10	24	0	0	24	0	0
17	49998804	.	C	A	13	22	35	0	1	36	0	0
17	49999037	.	G	T	15	18	33	0	1	34	0	0
17	50002381	.	A	G	16	11	27	0	1	28	0	0
17	50007340	.	G	A	3	4	7	0	1	8	0	0
17	50010042	.	C	T	1	2	3	0	4	7	0	0
17	50010078	.	T	C	3	2	5	0	1	6	0	0
17	50010087	.	C	A	0	5	5	0	3	8	0	0
17	50110461	.	G	A	2	2	4	0	0	4	0	0
17	50111406	.	G	A	6	2	8	0	0	8	0	0
17	50111497	.	A	G	2	0	2	0	8	10	0	0
17	50111680	.	A	T	2	3	5	0	0	5	0	0
17	50111718	.	T	G	3	3	6	0	0	6	0	0
17	50112440	.	T	C	1	2	3	0	0	3	0	0
17	50112455	.	G	A	0	2	2	0	1	3	0	0
17	50113141	.	G	A	7	5	12	0	0	12	0	0
17	50113148	.	C	T	4	7	11	0	1	12	0	0
17	50113196	.	G	A	0	7	7	0	6	13	0	0
17	50113336	.	C	T	4	4	8	0	1	9	0	0
17	50113404	.	C	T	2	9	11	0	1	12	0	0
17	50141904	.	A	T	4	3	7	0	1	8	0	0
17	50172581	.	T	G	8	5	13	0	0	13	0	0
17	50176483	.	G	A	4	3	7	0	0	7	0	0
17	50176519	.	C	A	6	5	11	0	0	11	0	0
17	50180672	.	C	T	8	6	14	0	0	14	0	0
17	50185665	.	T	A	3	2	5	0	1	6	0	0
17	50185930	.	T	C	6	13	19	0	0	19	0	0
17	50185964	.	G	A	2	6	8	0	13	21	0	0
17	50186011	.	G	A	2	12	14	0	5	19	0	0
17	50186097	.	G	A	5	4	9	0	1	10	0	0
17	50186146	.	T	G	6	1	7	0	1	8	0	0
17	50186148	.	C	T	3	4	7	0	0	8	1	0
17	50229135	.	A	C	6	8	14	0	0	14	0	0
17	50229301	.	G	T	3	9	12	0	0	12	0	0
17	50229718	.	A	G	3	4	7	0	0	7	0	0
17	50245400	.	G	A	2	9	11	0	1	12	0	0
17	50245580	.	G	A	16	16	32	0	1	33	0	0
17	50245673	.	T	C	23	16	39	0	6	45	0	0
17	50245715	.	C	G	24	19	43	0	2	45	0	0
17	50245772	.	C	T	7	18	25	0	2	27	0	0
17	50246998	.	C	T	21	6	27	0	1	28	0	0
17	50247886	.	T	C	17	0	17	0	20	37	0	0
17	50275229	.	C	A	3	2	5	0	0	5	0	0
17	50278271	.	G	A	3	5	8	0	0	8	0	0
17	50278808	.	C	T	6	3	9	0	0	9	0	0
17	50278884	.	C	A	7	2	9	0	0	9	0	0
17	50284899	.	T	A	13	9	22	0	0	22	0	0
17	50285009	.	A	T	3	5	8	0	0	8	0	0
17	50285052	.	C	T	3	4	7	0	1	8	0	0
17	50285221	.	A	T	5	4	9	0	0	9	0	0
17	50415329	.	T	C	3	0	3	0	3	6	0	0
17	50415378	.	C	A	4	7	11	0	0	11	0	0
17	50415476	.	C	T	5	7	12	0	0	12	0	0
17	50415844	.	C	T	9	8	17	0	0	17	0	0
17	50415858	.	A	G	10	7	17	0	0	17	0	0
17	50415948	.	G	A	5	2	7	1	0	8	0	0
17	50416052	.	C	G	1	5	6	0	0	6	0	0
17	50416269	.	C	T	0	3	3	1	5	9	0	0
17	50416392	.	T	C	2	2	4	0	0	4	0	0
17	50416414	.	T	A	3	3	6	0	0	6	0	0
17	50416456	.	C	T	3	2	5	0	0	5	0	0
17	50416593	.	T	C	0	2	2	0	1	3	0	0
17	50417310	.	T	C	3	2	5	0	0	5	0	0
17	50417324	.	G	A	2	4	6	1	0	7	0	0
17	50417360	.	G	A	3	3	6	1	0	7	0	0
17	50424455	.	T	C	5	0	5	0	4	9	0	0
17	50424555	.	A	T	7	12	19	0	1	20	0	0
17	50424556	.	A	T	6	13	19	0	1	20	0	0
17	50424596	.	A	T	5	15	20	0	1	21	0	0
17	50424662	.	A	G	6	10	16	1	1	18	0	0
17	50424663	.	A	G	6	11	17	1	0	18	0	0
17	50424697	.	A	G	4	14	18	1	0	19	0	0
17	50424961	.	T	A	3	5	8	0	0	8	0	0
17	50425042	.	C	G	3	8	11	0	1	12	0	0
17	50425171	.	A	T	5	6	11	0	0	11	0	0
17	50425321	.	C	T	5	5	10	0	1	11	0	0
17	50425478	.	C	T	5	1	6	0	1	7	0	0
17	50425488	.	A	G	5	3	8	0	0	8	0	0
17	50425992	.	A	T	2	4	6	0	0	6	0	0
17	50426043	.	T	C	1	2	3	0	0	3	0	0
17	50426092	.	C	T	1	5	6	0	0	6	0	0
17	50426644	.	C	T	3	2	5	0	0	5	0	0
17	50430607	.	C	A	7	2	9	0	0	9	0	0
17	50430614	.	G	A	7	1	8	0	1	9	0	0
17	50461443	.	G	A	1	3	4	0	0	4	0	0
17	50688480	.	T	C	7	3	10	0	0	10	0	0
17	50689755	.	G	A	0	3	3	0	4	7	0	0
17	50689787	.	T	A	2	4	6	0	1	7	0	0
17	50689811	.	A	C	4	5	9	0	0	9	0	0
17	50689842	.	A	G	5	4	9	0	0	9	0	0
17	50839928	.	C	T	1	3	4	0	0	4	0	0
17	50976567	.	C	T	5	4	9	0	0	9	0	0
17	51020214	.	A	G	9	9	18	0	1	19	0	0
17	51206851	.	T	C	18	21	39	0	1	40	0	0
17	51231980	.	T	C	5	8	13	0	0	13	0	0
17	51232449	.	T	C	3	5	8	0	0	8	0	0
17	51823617	.	G	T	11	4	15	0	1	16	0	0
17	52528662	.	G	C	9	12	21	0	0	21	0	0
17	52533036	.	C	G	9	5	14	0	1	15	0	0
17	52533073	.	C	T	14	8	22	0	2	24	0	0
17	52534241	.	G	A	0	12	12	0	13	25	0	0
17	52534343	.	G	A	15	8	23	0	3	26	0	0
17	52541342	.	G	A	1	11	12	0	8	20	0	0
17	52553107	.	C	A	20	14	34	0	4	38	0	0
17	52553141	.	T	C	13	21	34	0	2	36	0	0
17	52553270	.	G	A	23	15	38	0	2	40	0	0
17	52560036	.	G	A	1	5	6	1	0	7	0	0
17	52560050	.	G	C	1	4	5	0	0	5	0	0
17	52629120	.	T	A	6	3	9	0	0	9	0	0
17	52630641	.	A	G	8	9	17	0	0	17	0	0
17	52630752	.	A	C	4	0	4	0	10	14	0	0
17	52630762	.	A	G	10	3	13	0	0	13	0	0
17	52630796	.	G	A	4	2	6	0	1	7	0	0
17	52630907	.	A	T	2	3	5	0	1	6	0	0
17	52632139	.	A	G	12	5	17	0	1	18	0	0
17	52632151	.	G	C	13	4	17	0	0	17	0	0
17	52635258	.	A	G	3	8	11	0	0	11	0	0
17	52635261	.	C	T	0	8	8	0	3	11	0	0
17	52635954	.	C	T	0	5	5	0	5	10	0	0
17	52636829	.	C	T	5	3	8	0	0	8	0	0
17	52636831	.	C	G	5	3	8	0	0	8	0	0
17	52639729	.	C	T	1	19	20	0	16	36	0	0
17	52640311	.	G	A	24	22	46	0	0	46	0	0
17	52640385	.	G	C	17	20	37	0	0	37	0	0
17	52640419	.	C	T	1	21	22	0	19	41	0	0
17	52640540	.	C	T	0	16	16	0	20	36	0	0
17	52640645	.	T	G	11	16	27	0	0	28	1	0
17	52641091	.	A	T	10	10	20	0	0	20	0	0
17	52641571	.	C	T	6	8	14	0	3	17	0	0
17	52641724	.	A	C	10	9	19	0	1	20	0	0
17	52641751	.	G	C	9	0	9	0	14	23	0	0
17	52650878	.	G	C	7	5	12	0	1	13	0	0
17	52840328	.	A	C	9	19	28	0	0	28	0	0
17	52919954	.	C	T	27	30	57	0	5	62	0	0
17	52920291	.	A	T	28	15	43	0	3	46	0	0
17	52920792	.	C	T	26	24	50	2	2	54	0	0
17	52940649	.	T	C	1	6	7	0	0	7	0	0
17	52940710	.	T	C	5	3	8	0	2	10	0	0
17	52940898	.	T	C	3	3	6	0	0	6	0	0
17	52984470	.	C	A	1	2	3	0	0	3	0	0
17	53186727	.	C	T	3	3	6	0	0	6	0	0
17	53250909	.	G	A	0	2	2	0	1	3	0	0
17	53251101	.	A	G	1	3	4	0	0	4	0	0
17	53255614	.	T	A	2	5	7	0	0	7	0	0
17	53298000	.	C	G	3	0	3	0	3	6	0	0
17	53298033	.	C	T	1	3	4	0	1	5	0	0
17	53298051	.	G	A	3	3	6	0	1	7	0	0
17	53301281	.	C	T	1	7	8	0	0	8	0	0
17	53303258	.	G	A	2	6	8	0	5	13	0	0
17	53303980	.	G	C	10	11	21	0	1	22	0	0
17	53304566	.	G	A	7	5	12	0	1	13	0	0
17	53305318	.	G	C	13	16	29	0	2	31	0	0
17	53305327	.	C	T	11	14	25	0	4	29	0	0
17	53307346	.	G	A	9	4	13	0	0	13	0	0
17	53307580	.	C	G	17	10	27	0	0	27	0	0
17	53308737	.	T	C	10	10	20	0	2	22	0	0
17	53308820	.	C	T	1	2	3	0	3	6	0	0
17	53315422	.	C	T	1	4	5	0	0	5	0	0
17	53315604	.	G	A	6	3	9	0	0	9	0	0
17	53315750	.	C	G	3	5	8	0	0	8	0	0
17	53317065	.	C	T	6	7	13	0	2	15	0	0
17	53317123	.	T	C	4	4	8	0	1	9	0	0
17	53317175	.	G	A	2	9	11	0	5	16	0	0
17	53317844	.	G	A	1	4	5	0	9	14	0	0
17	53346648	.	C	A	4	4	8	0	0	8	0	0
17	53349843	.	T	G	1	2	3	0	0	3	0	0
17	53364109	.	T	C	4	3	7	0	0	7	0	0
17	53364111	.	T	C	5	2	7	0	0	7	0	0
17	53393165	.	G	A	13	16	29	0	0	29	0	0
18	38848	.	T	C	1	2	3	1	0	4	0	0
18	302902	.	C	T	7	4	11	0	0	11	0	0
18	303136	.	G	T	1	3	4	0	1	5	0	0
18	316039	.	C	T	4	7	11	0	1	12	0	0
18	318821	.	T	C	10	4	14	0	0	14	0	0
18	318824	.	C	T	10	5	15	0	0	15	0	0
18	319731	.	G	A	6	7	13	0	0	13	0	0
18	321802	.	T	C	9	5	14	0	1	15	0	0
18	321820	.	C	T	6	6	12	0	2	14	0	0
18	321934	.	C	T	6	5	11	0	1	12	0	0
18	324190	.	T	C	8	5	13	0	0	13	0	0
18	324243	.	G	A	5	4	9	0	2	11	0	0
18	324317	.	G	A	8	4	12	0	2	14	0	0
18	324325	.	A	G	10	4	14	0	1	15	0	0
18	324380	.	T	G	11	7	18	0	0	18	0	0
18	324409	.	C	T	12	9	21	0	1	22	0	0
18	324465	.	T	C	13	7	20	0	1	21	0	0
18	324692	.	A	T	14	16	30	0	0	30	0	0
18	324834	.	T	G	18	0	18	0	14	32	0	0
18	324835	.	G	T	19	14	33	0	0	33	0	0
18	325044	.	A	G	23	22	45	0	1	46	0	0
18	325189	.	C	T	25	24	49	0	7	56	0	0
18	325290	.	G	A	3	22	25	0	23	48	0	0
18	325312	.	G	T	24	24	48	0	4	52	0	0
18	325407	.	T	G	19	18	37	0	1	38	0	0
18	328795	.	G	C	6	5	11	0	0	11	0	0
18	330474	.	A	G	4	8	12	0	1	13	0	0
18	333765	.	T	C	8	6	14	0	0	14	0	0
18	334018	.	C	T	10	6	16	0	0	16	0	0
18	334049	.	A	T	12	6	18	0	0	18	0	0
18	334097	.	T	C	8	4	12	0	1	13	0	0
18	334110	.	T	C	8	0	8	0	3	11	0	0
18	334151	.	T	C	5	2	7	0	0	7	0	0
18	334157	.	T	C	4	2	6	0	0	6	0	0
18	334361	.	T	C	3	3	6	0	0	6	0	0
18	334431	.	T	G	4	3	7	0	1	8	0	0
18	334436	.	G	T	5	3	8	0	2	10	0	0
18	335363	.	T	C	2	3	5	0	0	5	0	0
18	336607	.	T	G	4	3	7	0	0	7	0	0
18	344332	.	G	A	2	2	4	0	0	4	0	0
18	411817	.	G	T	1	3	4	0	0	4	0	0
18	609365	.	A	G	2	2	4	0	0	4	0	0
18	2225862	.	A	C	10	5	15	0	1	16	0	0
18	2377216	.	T	C	6	4	10	0	0	10	0	0
18	2377338	.	T	A	9	5	14	0	3	17	0	0
18	2377413	.	C	T	7	12	19	0	0	19	0	0
18	2377486	.	A	T	11	6	17	0	0	17	0	0
18	2377516	.	A	G	11	10	21	1	1	23	0	0
18	2377566	.	A	G	6	10	16	1	1	18	0	0
18	2377582	.	G	T	7	12	19	0	0	19	0	0
18	2377645	.	T	C	7	0	7	0	12	19	0	0
18	2377700	.	C	T	0	10	10	0	7	17	0	0
18	2377714	.	A	G	6	10	16	0	0	16	0	0
18	2377768	.	G	A	4	18	22	0	1	23	0	0
18	2377775	.	C	T	7	16	23	0	1	24	0	0
18	2377860	.	G	A	12	5	17	0	1	18	0	0
18	2378462	.	A	T	4	2	6	0	0	6	0	0
18	2378510	.	C	A	2	3	5	0	0	5	0	0
18	2378713	.	T	G	3	8	11	0	0	11	0	0
18	2683985	.	T	C	1	6	7	0	0	7	0	0
18	2684031	.	T	C	3	5	8	0	0	8	0	0
18	5087844	.	A	G	20	5	25	0	6	31	0	0
18	5167603	.	A	G	22	13	35	0	0	35	0	0
18	5167604	.	A	G	22	13	35	0	1	36	0	0
18	5170069	.	A	G	16	0	16	0	39	55	0	0
18	5519138	.	A	G	3	7	10	0	0	10	0	0
18	6727884	.	A	G	1	1	2	0	1	3	0	0
18	7099955	.	G	A	3	2	5	1	2	8	0	0
18	7099981	.	A	G	4	3	7	1	0	8	0	0
18	7393170	.	A	G	4	2	6	0	0	6	0	0
18	7562237	.	T	C	0	4	4	0	0	4	0	0
18	7562243	.	A	T	3	2	5	0	0	5	0	0
18	7571628	.	C	T	1	3	4	0	0	4	0	0
18	9720554	.	A	T	12	4	16	0	2	18	0	0
18	10693155	.	T	A	2	12	14	0	0	14	0	0
18	12035593	.	C	G	1	2	3	0	0	3	0	0
18	12112153	.	T	C	1	3	4	0	0	4	0	0
18	12112726	.	C	T	1	3	4	0	1	5	0	0
18	12112750	.	G	A	3	2	5	0	0	5	0	0
18	12113515	.	C	A	3	4	7	0	0	7	0	0
18	12113516	.	C	T	2	4	6	0	0	6	0	0
18	12228834	.	G	C	3	2	5	0	0	5	0	0
18	12229120	.	A	T	2	2	4	0	0	4	0	0
18	12229223	.	A	C	4	2	6	0	0	6	0	0
18	12229245	.	C	T	1	4	5	0	0	5	0	0
18	12236126	.	T	A	1	1	2	0	1	3	0	0
18	12236351	.	C	T	10	12	22	0	1	23	0	0
18	12238082	.	G	A	8	6	14	0	2	16	0	0
18	12240681	.	C	T	6	4	10	1	1	12	0	0
18	12240740	.	G	C	4	4	8	0	0	8	0	0
18	12242967	.	C	T	1	2	3	0	8	11	0	0
18	12276859	.	C	T	19	5	24	0	0	24	0	0
18	12277052	.	A	G	6	6	12	0	1	13	0	0
18	12277206	.	G	C	9	7	16	0	1	17	0	0
18	12277490	.	G	A	13	15	28	0	0	28	0	0
18	12280269	.	C	T	14	7	21	0	0	21	0	0
18	12327321	.	C	A	0	4	4	0	3	7	0	0
18	12776727	.	C	T	3	2	5	0	1	6	0	0
18	12779357	.	T	A	2	2	4	0	0	4	0	0
18	12833894	.	A	G	7	4	11	0	2	13	0	0
18	12833983	.	A	T	3	5	8	0	0	8	0	0
18	12871545	.	G	T	1	2	3	0	0	3	0	0
18	13063534	.	G	A	3	5	8	0	1	9	0	0
18	13121630	.	C	T	1	2	3	0	0	3	0	0
18	13124493	.	T	C	4	3	7	0	0	7	0	0
18	13124501	.	T	C	3	4	7	0	0	7	0	0
18	13125829	.	G	A	3	5	8	0	0	8	0	0
18	13125836	.	G	T	5	2	7	0	0	7	0	0
18	13133040	.	C	T	1	3	4	0	0	4	0	0
18	13196113	.	A	G	1	4	5	0	0	5	0	0
18	13215966	.	G	A	22	24	46	0	5	51	0	0
18	13216051	.	C	T	23	15	38	0	2	40	0	0
18	13216566	.	T	A	12	16	28	0	0	28	0	0
18	13238078	.	G	A	0	2	2	0	2	4	0	0
18	13245795	.	G	A	10	11	21	0	0	21	0	0
18	13245803	.	A	G	7	10	17	0	1	18	0	0
18	13324391	.	G	A	12	19	31	0	1	32	0	0
18	13324416	.	T	C	17	20	37	0	2	39	0	0
18	13324473	.	G	A	26	26	52	0	4	56	0	0
18	13324494	.	T	C	23	1	24	0	28	52	0	0
18	13324747	.	A	G	34	13	47	0	0	47	0	0
18	13325224	.	A	G	18	16	34	0	1	35	0	0
18	13325225	.	C	T	19	14	33	0	2	35	0	0
18	13325451	.	G	T	14	19	33	0	2	35	0	0
18	13325492	.	C	T	15	13	28	0	1	29	0	0
18	13325679	.	C	T	0	3	3	0	7	10	0	0
18	13325912	.	G	A	13	5	18	0	1	19	0	0
18	13326124	.	A	C	3	0	3	0	5	8	0	0
18	13326178	.	G	T	3	9	12	0	2	14	0	0
18	13326400	.	C	T	0	5	5	0	3	8	0	0
18	13326593	.	G	C	11	4	15	0	0	15	0	0
18	13336278	.	G	A	3	2	5	0	0	5	0	0
18	13345001	.	C	G	3	2	5	0	1	6	0	0
18	13356438	.	A	G	1	2	3	0	0	3	0	0
18	13888406	.	G	A	2	2	4	0	0	4	0	0
18	14041036	.	C	T	2	5	7	0	0	7	0	0
18	14075262	.	A	G	2	2	4	0	0	4	0	0
18	14114915	.	G	A	3	5	8	0	0	8	0	0
18	14114930	.	C	T	7	3	10	0	0	10	0	0
18	14115011	.	A	G	12	9	21	0	1	22	0	0
18	14115083	.	G	C	18	16	34	0	3	37	0	0
18	14132006	.	G	A	3	12	15	0	15	31	1	0
18	14132077	.	A	T	19	25	44	0	0	44	0	0
18	14132360	.	G	A	1	25	26	1	21	48	0	0
18	14132836	.	A	G	28	12	40	0	2	42	0	0
18	14132892	.	T	C	22	24	46	0	2	48	0	0
18	14334468	.	A	T	17	15	32	0	0	32	0	0
18	14337320	.	T	A	26	20	46	0	4	50	0	0
18	14529721	.	T	C	1	2	3	0	0	3	0	0
18	14529971	.	A	T	2	2	4	0	0	4	0	0
18	14530273	.	T	A	1	2	3	0	0	3	0	0
18	14633131	.	T	C	7	6	13	0	0	13	0	0
18	14637888	.	T	C	4	2	6	0	0	6	0	0
18	14647432	.	C	T	5	5	10	0	0	10	0	0
18	14648859	.	C	A	2	4	6	0	1	7	0	0
18	14649227	.	G	A	0	3	3	0	5	8	0	0
18	14649408	.	A	T	4	2	6	0	1	7	0	0
18	14652676	.	A	G	2	0	2	0	6	8	0	0
18	14660205	.	C	G	5	6	11	2	0	13	0	0
18	14667830	.	A	T	2	3	5	0	0	5	0	0
18	14672230	.	G	A	3	3	6	0	0	6	0	0
18	14672353	.	A	G	3	4	7	0	0	7	0	0
18	14672542	.	A	T	2	4	6	0	2	8	0	0
18	14690967	.	G	A	2	2	4	0	0	4	0	0
18	14691037	.	T	C	5	2	7	0	0	7	0	0
18	14691269	.	A	T	3	2	5	0	0	5	0	0
18	14691634	.	G	C	2	2	4	0	0	4	0	0
18	14698371	.	C	T	9	6	15	0	0	15	0	0
18	14698538	.	A	G	5	11	16	0	1	17	0	0
18	14698860	.	A	C	14	6	20	0	1	21	0	0
18	14699012	.	T	A	6	11	17	0	0	17	0	0
18	14700731	.	A	T	10	7	17	0	0	17	0	0
18	14702153	.	G	A	12	6	18	0	0	18	0	0
18	14702427	.	G	A	10	15	25	0	1	26	0	0
18	14702439	.	T	C	8	15	23	0	0	23	0	0
18	14702511	.	G	T	0	15	15	0	12	27	0	0
18	14705287	.	T	C	10	9	19	0	0	19	0	0
18	14705308	.	A	G	9	6	15	0	1	16	0	0
18	14705371	.	T	C	11	12	23	0	1	24	0	0
18	14705518	.	G	A	1	15	16	0	10	26	0	0
18	14705578	.	G	T	6	9	15	0	1	16	0	0
18	14705770	.	A	T	1	2	3	0	0	3	0	0
18	14705808	.	A	G	1	3	4	0	0	4	0	0
18	14731967	.	T	C	9	0	9	0	17	26	0	0
18	14732128	.	G	A	9	14	23	0	0	23	0	0
18	14732809	.	T	C	9	5	14	0	1	15	0	0
18	14732840	.	T	G	10	6	16	0	1	17	0	0
18	14732859	.	C	T	1	6	7	0	13	20	0	0
18	14732885	.	T	C	12	6	18	0	0	18	0	0
18	14732903	.	T	A	14	7	21	0	0	21	0	0
18	14732923	.	G	A	11	8	19	0	1	20	0	0
18	14732996	.	T	C	5	7	12	0	0	12	0	0
18	14733019	.	C	A	5	6	11	0	0	11	0	0
18	14733114	.	A	T	5	7	12	0	1	13	0	0
18	14733402	.	C	T	4	3	7	0	0	7	0	0
18	14733561	.	A	T	4	6	10	0	1	11	0	0
18	14733638	.	A	G	3	5	8	0	1	9	0	0
18	14733839	.	A	G	4	2	6	0	0	6	0	0
18	14772957	.	A	T	1	2	3	0	0	3	0	0
18	14773020	.	T	A	2	3	5	0	0	5	0	0
18	14773050	.	C	T	2	2	4	0	1	5	0	0
18	14773068	.	G	T	1	2	3	0	0	3	0	0
18	14773140	.	C	T	2	2	4	0	0	4	0	0
18	14779213	.	C	T	1	2	3	0	1	4	0	0
18	14863675	.	A	G	1	6	7	0	0	7	0	0
18	14863680	.	T	A	2	7	9	0	0	9	0	0
18	14867044	.	T	C	4	0	4	0	4	8	0	0
18	14886018	.	G	A	2	3	5	0	0	5	0	0
18	14928703	.	C	T	0	4	4	0	3	7	0	0
18	15139838	.	A	G	1	1	2	0	1	3	0	0
18	17535741	.	A	T	0	16	16	0	1	17	0	0
18	17535748	.	A	T	8	5	13	0	9	22	0	0
18	17994415	.	A	G	4	24	28	0	2	30	0	0
18	18976252	.	G	A	1	2	3	0	0	3	0	0
18	20249005	.	G	T	0	5	5	0	7	12	0	0
18	20252129	.	C	T	1	3	4	0	1	5	0	0
18	20254384	.	C	T	5	3	8	0	0	8	0	0
18	20254398	.	G	A	0	3	3	0	5	8	0	0
18	20256275	.	C	T	6	8	14	0	0	14	0	0
18	20256379	.	A	G	4	4	8	0	0	8	0	0
18	20256491	.	T	A	7	5	12	0	0	12	0	0
18	20256492	.	A	T	4	5	9	0	2	11	0	0
18	20256539	.	G	A	9	3	12	0	0	12	0	0
18	20257005	.	G	A	3	19	22	0	9	31	0	0
18	20257159	.	C	G	13	12	25	0	0	25	0	0
18	20257200	.	A	T	19	16	35	0	1	36	0	0
18	20468571	.	A	G	0	2	2	0	1	3	0	0
18	20475854	.	C	T	2	3	5	0	0	5	0	0
18	20482876	.	C	A	1	2	3	0	0	3	0	0
18	20488492	.	C	T	1	2	3	0	0	3	0	0
18	20490544	.	T	A	1	3	4	0	1	5	0	0
18	20490834	.	T	C	1	3	4	0	0	4	0	0
18	20516618	.	C	A	2	2	4	0	0	4	0	0
18	20516811	.	T	C	1	3	4	0	0	4	0	0
18	20516869	.	T	G	1	4	5	0	0	5	0	0
18	20517000	.	G	A	2	2	4	0	1	5	0	0
18	20520964	.	A	G	2	3	5	0	0	5	0	0
18	20521515	.	C	G	2	3	5	0	0	5	0	0
18	20532685	.	T	C	4	3	7	0	0	7	0	0
18	20541735	.	A	G	8	7	15	0	1	16	0	0
18	20542113	.	T	A	14	3	17	0	0	17	0	0
18	20542419	.	T	C	14	6	20	0	1	21	0	0
18	20542428	.	A	G	13	4	17	0	4	21	0	0
18	20542526	.	G	A	10	10	20	0	1	21	0	0
18	20542581	.	A	G	12	4	16	0	1	17	0	0
18	20542899	.	T	A	9	6	15	0	0	15	0	0
18	20542929	.	T	C	6	8	14	0	1	15	0	0
18	20543466	.	T	A	4	6	10	0	0	10	0	0
18	20544691	.	G	A	5	6	11	0	1	12	0	0
18	20553607	.	T	C	2	4	6	0	0	6	0	0
18	20554066	.	C	T	0	2	2	0	2	4	0	0
18	20559518	.	C	T	2	3	5	0	0	5	0	0
18	20582109	.	G	A	7	16	23	0	0	23	0	0
18	20582222	.	G	A	6	8	14	0	1	15	0	0
18	20582303	.	C	T	0	4	4	0	6	10	0	0
18	20582314	.	C	G	5	3	8	0	1	9	0	0
18	20582356	.	C	T	3	3	6	0	0	6	0	0
18	20582361	.	T	C	4	2	6	0	1	7	0	0
18	20582413	.	T	A	5	5	10	0	0	10	0	0
18	20726232	.	T	C	18	1	19	0	28	47	0	0
18	20726304	.	T	C	32	0	32	0	20	52	0	0
18	20729281	.	C	T	2	22	24	0	15	39	0	0
18	20730583	.	G	A	14	8	22	0	1	23	0	0
18	20735371	.	C	T	12	7	19	0	1	20	0	0
18	20735413	.	C	T	2	14	16	0	15	31	0	0
18	20738244	.	T	A	8	9	17	0	0	17	0	0
18	20738262	.	A	G	8	7	15	0	1	16	0	0
18	20738298	.	G	A	10	8	18	0	1	19	0	0
18	20738383	.	G	A	10	10	20	0	0	20	0	0
18	20739268	.	G	T	8	6	14	0	2	16	0	0
18	20742025	.	G	A	10	7	17	0	1	18	0	0
18	20742029	.	C	G	10	11	21	0	0	21	0	0
18	20744164	.	T	C	6	5	11	0	0	11	0	0
18	20752848	.	G	A	4	3	7	0	0	7	0	0
18	20752879	.	C	T	0	2	2	0	5	7	0	0
18	20755763	.	G	A	2	3	5	0	2	7	0	0
18	20755787	.	G	T	2	5	7	0	0	7	0	0
18	20755971	.	G	T	4	5	9	0	1	10	0	0
18	20757934	.	C	T	9	4	13	0	0	13	0	0
18	20757977	.	A	C	4	0	4	0	7	11	0	0
18	20757979	.	G	A	4	6	10	0	1	11	0	0
18	20760425	.	C	T	1	4	5	0	1	6	0	0
18	20768407	.	C	T	3	4	7	0	2	9	0	0
18	20768686	.	C	T	4	3	7	0	0	7	0	0
18	21102013	.	G	A	11	5	16	0	0	16	0	0
18	21102797	.	G	T	3	2	5	0	1	6	0	0
18	21102994	.	G	A	1	2	3	0	0	3	0	0
18	21102995	.	A	T	1	2	3	0	0	3	0	0
18	21103043	.	G	A	2	2	4	0	0	4	0	0
18	21113258	.	G	A	0	2	2	0	2	4	0	0
18	21117589	.	C	A	2	4	6	0	0	6	0	0
18	21117801	.	C	T	6	8	14	0	0	14	0	0
18	21119562	.	G	A	14	5	19	0	1	20	0	0
18	21119579	.	A	T	16	5	21	0	1	22	0	0
18	21119654	.	G	A	9	5	14	0	3	17	0	0
18	21119751	.	C	T	11	13	24	0	3	27	0	0
18	21119845	.	C	A	8	8	16	0	0	16	0	0
18	21123001	.	A	G	4	0	4	0	3	7	0	0
18	21144751	.	G	A	0	5	5	0	3	8	0	0
18	21144852	.	A	G	10	6	16	0	1	17	0	0
18	21144965	.	G	C	0	3	3	0	7	10	0	0
18	21144985	.	C	T	6	2	8	0	0	8	0	0
18	21178836	.	C	T	3	3	6	0	0	6	0	0
18	21178865	.	T	G	2	3	5	0	0	5	0	0
18	21179135	.	T	C	5	3	8	0	1	9	0	0
18	21179158	.	G	C	6	3	9	0	0	9	0	0
18	21179181	.	A	T	3	5	8	0	0	8	0	0
18	21179228	.	G	C	3	9	12	0	0	12	0	0
18	21179325	.	T	C	11	1	12	0	4	16	0	0
18	21179369	.	T	C	12	10	22	0	1	23	0	0
18	21179484	.	G	A	4	17	21	0	0	21	0	0
18	21179566	.	T	C	4	9	13	1	0	14	0	0
18	21179709	.	A	C	4	4	8	0	0	8	0	0
18	21182879	.	A	G	2	3	5	0	0	5	0	0
18	21199515	.	T	C	22	25	47	1	1	49	0	0
18	21201953	.	G	A	16	17	33	0	2	35	0	0
18	21203739	.	C	T	10	14	24	0	2	26	0	0
18	21214976	.	T	C	7	4	11	0	1	12	0	0
18	21218734	.	G	A	16	7	23	0	0	23	0	0
18	21257623	.	A	G	27	7	34	0	2	36	0	0
18	21257657	.	T	C	13	22	35	0	1	36	0	0
18	21257757	.	G	A	18	7	25	0	0	25	0	0
18	21257816	.	G	T	15	10	25	0	1	26	0	0
18	21257867	.	G	A	4	20	24	0	1	25	0	0
18	21257951	.	T	A	11	8	19	0	1	20	0	0
18	21263120	.	G	A	7	13	20	0	1	21	0	0
18	21266815	.	A	G	5	6	11	0	0	11	0	0
18	21399913	.	T	A	1	2	3	0	0	3	0	0
18	21409113	.	A	T	1	3	4	0	0	4	0	0
18	21861934	.	C	T	1	5	6	0	0	6	0	0
18	22031774	.	T	C	1	3	4	0	0	4	0	0
18	22406591	.	A	C	2	3	5	0	3	8	0	0
18	22680262	.	C	T	2	2	4	0	0	4	0	0
18	23071849	.	G	A	2	3	5	0	1	6	0	0
18	23869134	.	C	T	24	21	45	0	4	49	0	0
18	23870092	.	G	A	12	12	24	0	2	26	0	0
18	23870837	.	C	T	5	5	10	0	1	11	0	0
18	23875111	.	A	C	1	3	4	0	0	4	0	0
18	23888223	.	G	A	2	2	4	0	1	5	0	0
18	24929079	.	T	G	2	2	4	0	0	4	0	0
18	24929406	.	A	G	4	0	4	0	4	8	0	0
18	24929413	.	G	A	4	3	7	0	2	9	0	0
18	24929460	.	G	A	2	6	8	0	6	14	0	0
18	24929633	.	C	T	5	4	9	0	0	9	0	0
18	24930189	.	G	A	8	7	15	0	3	18	0	0
18	24930758	.	T	C	15	12	27	0	3	30	0	0
18	24931044	.	T	A	16	19	35	0	2	37	0	0
18	24931326	.	G	A	9	6	15	0	0	15	0	0
18	24931634	.	A	G	16	28	44	0	1	45	0	0
18	24931660	.	G	T	15	21	36	0	2	38	0	0
18	24931699	.	T	C	14	10	24	0	4	28	0	0
18	24933638	.	C	A	14	10	24	0	3	27	0	0
18	24933769	.	C	A	13	19	32	0	2	34	0	0
18	24933799	.	A	G	14	18	32	0	0	32	0	0
18	24933990	.	A	C	8	4	12	0	0	12	0	0
18	24934456	.	G	A	16	10	26	0	2	28	0	0
18	24934692	.	C	A	4	6	10	0	0	10	0	0
18	24934719	.	G	C	7	8	15	0	0	15	0	0
18	24934950	.	G	A	9	4	13	0	2	15	0	0
18	24946637	.	T	C	4	3	7	0	1	8	0	0
18	24947678	.	A	G	8	4	12	0	0	12	0	0
18	24952182	.	G	A	3	2	5	0	0	5	0	0
18	24952245	.	T	G	3	2	5	0	0	5	0	0
18	25009233	.	C	T	7	5	12	0	0	12	0	0
18	25009352	.	G	A	8	10	18	0	0	18	0	0
18	25009407	.	T	C	11	11	22	0	0	22	0	0
18	25009487	.	A	G	3	3	6	0	0	6	0	0
18	25741044	.	A	G	2	0	2	0	2	4	0	0
18	25745182	.	G	A	0	4	4	0	1	5	0	0
18	25745469	.	C	T	5	5	10	0	0	10	0	0
18	25752722	.	G	A	20	7	27	0	0	27	0	0
18	25754690	.	T	G	3	2	5	0	0	5	0	0
18	25754704	.	A	C	2	2	4	0	0	4	0	0
18	26094421	.	C	T	3	2	5	0	0	5	0	0
18	26094491	.	A	C	2	4	6	0	0	6	0	0
18	26099274	.	A	T	35	32	67	0	1	68	0	0
18	26389326	.	G	A	3	3	6	0	1	7	0	0
18	26389401	.	C	T	1	2	3	0	0	3	0	0
18	26401743	.	C	T	8	10	18	0	0	18	0	0
18	26401938	.	A	C	5	5	10	0	1	11	0	0
18	26405271	.	G	A	3	15	18	0	2	20	0	0
18	26410176	.	T	C	4	6	10	0	0	10	0	0
18	26412001	.	A	G	2	7	9	0	0	9	0	0
18	26417753	.	G	A	1	18	19	0	13	32	0	0
18	26453207	.	G	A	10	4	14	0	0	14	0	0
18	26460723	.	G	T	1	3	4	0	0	4	0	0
18	26776182	.	A	G	4	6	10	0	1	11	0	0
18	26790510	.	A	T	7	7	14	0	0	14	0	0
18	26793948	.	G	A	9	7	16	0	0	16	0	0
18	26800148	.	A	C	6	10	16	0	1	17	0	0
18	26800198	.	T	C	8	5	13	0	1	14	0	0
18	26800280	.	G	A	3	8	11	0	0	11	0	0
18	26800418	.	T	C	14	10	24	0	1	25	0	0
18	26807229	.	T	A	4	4	8	0	0	8	0	0
18	26807304	.	C	T	4	2	6	0	0	6	0	0
18	26809791	.	G	T	2	4	6	0	0	6	0	0
18	26810434	.	G	C	2	2	4	0	1	5	0	0
18	26863681	.	T	C	7	1	8	0	9	17	0	0
18	26891630	.	C	T	1	2	3	0	0	3	0	0
18	26896160	.	G	C	0	2	2	0	1	3	0	0
18	26899453	.	T	C	8	7	15	0	1	16	0	0
18	26909470	.	G	A	0	10	10	0	12	22	0	0
18	26913949	.	C	T	21	17	38	0	1	39	0	0
18	26919227	.	T	A	13	8	21	1	1	23	0	0
18	26919865	.	T	C	11	7	18	0	1	19	0	0
18	26968822	.	T	C	14	0	14	0	10	24	0	0
18	26971513	.	G	A	6	5	11	0	1	12	0	0
18	27066063	.	C	T	1	3	4	0	0	4	0	0
18	27066080	.	T	A	1	3	4	0	0	4	0	0
18	27072226	.	C	A	4	2	6	0	0	6	0	0
18	27072690	.	C	T	5	2	7	0	0	7	0	0
18	27072697	.	G	A	7	2	9	0	0	9	0	0
18	27080991	.	C	T	2	2	4	0	0	4	0	0
18	27081050	.	C	T	1	2	3	0	0	3	0	0
18	27081056	.	T	C	1	2	3	0	0	3	0	0
18	27085217	.	A	T	2	3	5	0	0	5	0	0
18	27085467	.	T	G	1	2	3	0	0	3	0	0
18	27285337	.	C	T	3	2	5	0	0	5	0	0
18	27285741	.	C	T	1	2	3	0	1	4	0	0
18	27309512	.	T	C	3	3	6	0	1	7	0	0
18	27309517	.	A	G	3	5	8	0	1	9	0	0
18	27309555	.	G	A	5	10	15	0	1	16	0	0
18	27309873	.	C	T	14	13	27	0	1	28	0	0
18	27335583	.	T	C	6	4	10	0	0	10	0	0
18	27335740	.	T	A	13	6	19	0	1	20	0	0
18	27335828	.	A	G	3	3	6	0	0	6	0	0
18	27335935	.	T	A	4	5	9	0	0	9	0	0
18	27336066	.	C	A	2	2	4	0	0	4	0	0
18	27357391	.	T	A	0	2	2	0	1	3	0	0
18	27625814	.	A	C	1	2	3	0	1	4	0	0
18	27625845	.	G	A	1	2	3	0	1	4	0	0
18	27625850	.	C	T	1	3	4	0	0	4	0	0
18	27802795	.	C	T	4	7	11	0	0	11	0	0
18	27812400	.	T	G	16	1	17	0	19	36	0	0
18	27812429	.	T	C	13	24	37	0	1	38	0	0
18	27812618	.	T	A	19	17	36	0	0	36	0	0
18	27993392	.	T	G	2	3	5	0	0	5	0	0
18	28564856	.	G	T	1	2	3	0	0	3	0	0
18	28564858	.	G	A	0	2	2	0	1	3	0	0
18	28565025	.	C	T	1	2	3	0	0	3	0	0
18	28876524	.	C	G	4	3	7	0	0	7	0	0
18	28879736	.	G	T	0	3	3	0	2	5	0	0
18	28879758	.	C	G	3	4	7	0	0	7	0	0
18	28879847	.	G	T	2	6	8	0	0	8	0	0
18	29008407	.	C	T	11	9	20	0	0	20	0	0
18	29058989	.	C	T	4	6	10	0	1	12	1	0
18	29059194	.	A	G	7	15	22	0	0	22	0	0
18	29405132	.	A	G	2	3	5	0	1	6	0	0
18	29405136	.	C	A	3	3	6	0	0	6	0	0
18	29887226	.	T	C	1	2	3	0	0	3	0	0
18	29889484	.	T	A	8	5	13	0	0	13	0	0
18	29889548	.	A	G	4	4	8	0	1	9	0	0
18	29896091	.	C	T	1	2	3	0	0	3	0	0
18	29896232	.	A	G	3	2	5	0	0	5	0	0
18	29898173	.	A	C	3	5	8	0	1	9	0	0
18	29898187	.	T	A	3	4	7	0	0	7	0	0
18	29898341	.	A	G	3	3	6	0	0	6	0	0
18	29954824	.	C	A	1	2	3	0	1	4	0	0
18	29958874	.	G	A	3	3	6	0	0	6	0	0
18	29958943	.	G	A	4	3	7	0	0	7	0	0
18	29959241	.	T	C	3	2	5	0	0	5	0	0
18	29969920	.	A	T	3	9	12	0	0	12	0	0
18	29970458	.	C	G	18	8	26	0	0	26	0	0
18	29970559	.	T	G	14	8	22	0	0	22	0	0
18	29970809	.	A	T	1	2	3	0	0	3	0	0
18	29970817	.	G	A	1	2	3	0	0	3	0	0
18	29976560	.	C	A	12	8	20	0	2	22	0	0
18	29976561	.	A	T	12	9	21	0	1	22	0	0
18	29977423	.	C	T	11	10	21	0	2	23	0	0
18	29977753	.	C	T	10	6	16	0	1	17	0	0
18	29977784	.	T	A	12	9	21	0	0	21	0	0
18	29977789	.	C	T	12	9	21	0	0	21	0	0
18	29980462	.	A	G	2	3	5	0	0	5	0	0
18	29980474	.	A	G	2	3	5	0	0	5	0	0
18	29980560	.	A	G	2	3	5	0	0	5	0	0
18	29980584	.	C	T	1	2	3	0	0	3	0	0
18	30466712	.	A	T	1	2	3	0	2	5	0	0
18	30466722	.	A	C	2	1	3	0	4	7	0	0
18	30470471	.	A	G	4	7	11	0	1	12	0	0
18	30470929	.	T	C	12	4	16	0	1	17	0	0
18	30470930	.	G	A	12	5	17	0	0	17	0	0
18	30473566	.	C	G	7	0	7	0	5	12	0	0
18	30473905	.	A	G	6	0	6	0	11	17	0	0
18	30476837	.	G	A	8	13	21	0	0	21	0	0
18	30477289	.	G	T	8	3	11	0	0	11	0	0
18	30477469	.	C	T	7	10	17	0	1	18	0	0
18	30477495	.	T	G	16	6	22	0	2	24	0	0
18	30477616	.	A	G	8	10	18	0	3	21	0	0
18	30477625	.	C	T	12	10	22	0	0	22	0	0
18	30477889	.	C	T	23	18	41	0	2	43	0	0
18	30478113	.	A	G	22	0	22	0	18	40	0	0
18	30478156	.	C	T	32	18	50	0	4	54	0	0
18	30500912	.	G	T	4	4	8	0	1	9	0	0
18	30500952	.	T	C	4	4	8	0	0	8	0	0
18	30501194	.	T	C	1	5	6	0	0	6	0	0
18	30501298	.	C	A	12	7	19	0	1	20	0	0
18	30501393	.	G	A	9	3	12	0	0	12	0	0
18	30501639	.	A	G	7	7	14	0	0	14	0	0
18	30501701	.	T	C	2	9	11	0	1	12	0	0
18	30503562	.	T	C	5	1	6	0	3	9	0	0
18	30504366	.	C	T	6	10	16	0	0	16	0	0
18	30556895	.	G	A	3	4	7	0	0	7	0	0
18	30564142	.	T	A	8	5	13	0	0	13	0	0
18	30564199	.	A	G	3	0	3	0	4	7	0	0
18	30564301	.	C	A	6	6	12	0	0	12	0	0
18	30564334	.	T	G	4	10	14	0	0	14	0	0
18	30564342	.	G	T	3	11	14	0	3	17	0	0
18	30564385	.	T	G	1	8	9	0	0	9	0	0
18	30949449	.	C	T	3	8	11	0	0	11	0	0
18	30949488	.	G	A	4	5	9	0	1	10	0	0
18	31033267	.	C	T	0	8	8	0	3	11	0	0
18	31036721	.	A	T	1	2	3	0	0	3	0	0
18	31036722	.	C	A	1	2	3	0	0	3	0	0
18	31041640	.	G	A	3	5	8	0	0	8	0	0
18	31064734	.	G	A	6	6	12	0	0	12	0	0
18	31068392	.	A	C	7	5	12	0	0	12	0	0
18	31068463	.	A	G	5	3	8	0	0	8	0	0
18	31068745	.	T	G	4	2	6	0	0	6	0	0
18	31075089	.	A	C	1	3	4	0	0	4	0	0
18	31105257	.	G	A	6	8	14	0	1	15	0	0
18	31151851	.	G	A	1	6	7	0	0	7	0	0
18	31152920	.	A	G	1	2	3	0	0	3	0	0
18	31201750	.	T	C	3	9	12	0	1	13	0	0
18	31206392	.	C	A	9	4	13	0	0	13	0	0
18	31281034	.	G	C	1	5	6	0	3	9	0	0
18	31281161	.	T	A	4	3	7	0	1	8	0	0
18	31281186	.	T	C	5	3	8	0	1	9	0	0
18	31281254	.	G	A	8	4	12	0	0	12	0	0
18	31775711	.	G	A	2	6	8	0	6	14	0	0
18	33982078	.	G	T	6	8	14	0	0	14	0	0
18	33982331	.	G	T	7	3	10	0	0	10	0	0
18	33982340	.	G	A	7	3	10	0	0	10	0	0
18	33982423	.	A	C	13	8	21	0	0	21	0	0
18	33982591	.	T	C	10	6	16	0	2	18	0	0
18	33982811	.	C	T	2	17	19	0	7	26	0	0
18	33983154	.	G	A	15	16	31	0	0	31	0	0
18	33983165	.	T	C	10	17	27	0	2	29	0	0
18	33983300	.	A	C	6	0	6	0	8	14	0	0
18	33983564	.	T	A	6	13	19	0	1	20	0	0
18	33983641	.	T	C	10	8	18	1	0	19	0	0
18	33983771	.	A	C	9	5	14	0	2	16	0	0
18	33984153	.	A	G	9	9	18	0	2	20	0	0
18	33984191	.	C	A	8	3	11	0	1	13	1	0
18	33984215	.	G	T	6	3	9	0	0	9	0	0
18	33984235	.	T	A	6	2	8	0	0	8	0	0
18	33984596	.	G	A	7	5	12	0	1	13	0	0
18	33984801	.	A	C	5	6	11	0	0	11	0	0
18	33985249	.	T	C	8	6	14	0	0	14	0	0
18	33985414	.	T	C	7	0	7	0	6	13	0	0
18	33985953	.	C	T	4	6	10	0	0	10	0	0
18	33986027	.	A	G	8	3	11	0	0	11	0	0
18	33986199	.	C	T	4	5	9	0	1	10	0	0
18	33988743	.	A	C	1	0	1	0	2	3	0	0
18	34146406	.	A	C	1	6	7	0	0	7	0	0
18	34146890	.	C	T	3	2	5	0	0	5	0	0
18	34156693	.	A	T	2	4	6	0	0	6	0	0
18	34160229	.	A	G	1	2	3	0	0	3	0	0
18	34163687	.	A	G	1	2	3	0	0	3	0	0
18	34207700	.	G	A	4	4	8	0	0	8	0	0
18	34213351	.	C	T	4	5	9	0	2	11	0	0
18	34213378	.	A	T	5	4	9	0	3	12	0	0
18	34213414	.	T	C	5	3	8	0	0	8	0	0
18	34213426	.	T	C	6	2	8	0	0	8	0	0
18	34213995	.	A	T	5	12	17	0	1	18	0	0
18	34214054	.	C	T	4	7	11	0	1	12	0	0
18	34214141	.	T	G	6	4	10	0	1	11	0	0
18	34214280	.	A	T	9	7	16	0	2	18	0	0
18	34214288	.	G	T	11	8	19	0	1	20	0	0
18	34214478	.	A	G	10	0	10	0	14	24	0	0
18	34214754	.	C	G	19	17	36	0	1	37	0	0
18	34214894	.	T	C	16	9	25	0	3	28	0	0
18	34542620	.	C	A	11	4	15	0	2	17	0	0
18	34601008	.	C	A	2	6	8	0	3	11	0	0
18	34601042	.	A	C	2	8	10	0	0	10	0	0
18	34601323	.	T	G	3	7	10	0	0	10	0	0
18	34601468	.	G	T	1	12	13	0	1	14	0	0
18	34601471	.	A	T	1	11	12	0	1	13	0	0
18	34601907	.	T	A	1	5	6	0	1	7	0	0
18	34641352	.	A	C	13	9	22	0	2	24	0	0
18	34641439	.	T	C	12	12	24	0	0	24	0	0
18	34641442	.	T	C	11	12	23	0	1	24	0	0
18	34641622	.	C	G	15	10	25	0	1	27	1	0
18	34641633	.	T	C	15	14	29	0	1	30	0	0
18	35147233	.	T	C	0	2	2	0	1	3	0	0
18	35179248	.	C	T	1	2	3	0	0	3	0	0
18	35179258	.	C	T	1	2	3	0	0	3	0	0
18	35195864	.	A	T	3	4	7	0	0	7	0	0
18	35405389	.	T	C	4	0	4	0	13	17	0	0
18	35406987	.	G	A	15	4	19	0	0	19	0	0
18	35407271	.	C	T	12	10	22	0	1	23	0	0
18	35407688	.	C	A	4	1	5	0	1	6	0	0
18	35407690	.	T	C	4	2	6	0	0	6	0	0
18	35430630	.	A	C	1	2	3	0	0	3	0	0
18	35493993	.	C	T	2	8	10	0	14	24	0	0
18	35501357	.	G	A	15	8	23	0	2	25	0	0
18	35503705	.	A	G	8	10	18	0	2	20	0	0
18	35506377	.	C	G	0	4	4	0	7	11	0	0
18	35506393	.	C	T	5	6	11	0	1	12	0	0
18	35508097	.	G	A	8	3	11	0	0	11	0	0
18	35516750	.	G	A	4	4	8	0	0	8	0	0
18	35520248	.	G	A	3	6	9	0	0	9	0	0
18	35794289	.	T	C	1	2	3	0	0	3	0	0
18	35802235	.	G	A	0	2	2	0	1	3	0	0
18	35807960	.	G	A	12	9	21	0	1	22	0	0
18	35808137	.	C	T	4	5	9	0	2	11	0	0
18	35814745	.	T	G	15	12	27	0	0	27	0	0
18	35827185	.	C	T	2	2	4	0	0	4	0	0
18	35827399	.	T	A	3	2	5	0	1	6	0	0
18	35827621	.	T	A	2	1	3	0	2	5	0	0
18	35832896	.	G	A	2	3	5	0	0	5	0	0
18	35832911	.	G	A	2	3	5	0	0	5	0	0
18	35832931	.	C	T	0	4	4	0	0	4	0	0
18	35838817	.	A	G	4	2	6	0	0	6	0	0
18	35839412	.	G	C	3	3	6	0	0	6	0	0
18	35839461	.	T	C	7	8	15	0	1	16	0	0
18	35839512	.	A	G	12	8	20	0	1	21	0	0
18	35839543	.	A	T	10	7	17	0	0	17	0	0
18	35839658	.	T	C	11	6	17	0	0	17	0	0
18	35839730	.	T	C	5	5	10	0	0	10	0	0
18	35839832	.	G	A	3	4	7	0	1	8	0	0
18	35842419	.	T	C	3	6	9	0	1	10	0	0
18	35842440	.	C	T	0	8	8	0	3	11	0	0
18	35842461	.	A	T	5	3	8	0	2	10	0	0
18	35842476	.	C	T	3	5	8	0	1	9	0	0
18	36037258	.	T	C	1	2	3	0	0	3	0	0
18	36071262	.	C	T	1	2	3	0	0	3	0	0
18	36075306	.	C	T	5	5	10	0	0	10	0	0
18	36080616	.	G	T	12	12	24	1	0	25	0	0
18	36081483	.	G	T	7	8	15	0	0	15	0	0
18	36081513	.	C	T	12	13	25	0	1	26	0	0
18	36081728	.	C	T	4	3	7	0	1	8	0	0
18	36081792	.	T	C	3	7	10	0	0	10	0	0
18	36106031	.	T	C	9	7	16	0	1	17	0	0
18	36128954	.	C	T	1	6	7	0	0	7	0	0
18	36129177	.	G	A	3	3	6	0	1	7	0	0
18	36129218	.	G	A	8	5	13	0	0	13	0	0
18	36591704	.	G	T	1	2	3	0	0	3	0	0
18	36598134	.	T	C	3	3	6	0	0	6	0	0
18	36598273	.	T	A	5	6	11	0	0	11	0	0
18	36598332	.	A	G	4	6	10	0	0	10	0	0
18	36598441	.	C	T	10	7	17	0	0	17	0	0
18	36598476	.	G	A	7	5	12	0	0	12	0	0
18	36615056	.	G	A	2	1	3	0	1	4	0	0
18	36623275	.	C	T	10	6	16	0	0	16	0	0
18	36630615	.	T	C	13	14	27	0	3	30	0	0
18	36630740	.	T	A	13	7	20	0	0	20	0	0
18	36630867	.	C	T	11	18	29	0	1	30	0	0
18	36647855	.	C	T	5	3	8	0	0	8	0	0
18	36869052	.	A	G	1	2	3	0	0	3	0	0
18	36869242	.	C	A	5	7	12	0	1	13	0	0
18	36869475	.	C	A	6	4	10	0	4	14	0	0
18	36869879	.	G	T	17	8	25	0	0	25	0	0
18	36870068	.	G	A	16	7	23	0	1	24	0	0
18	36870278	.	G	A	10	12	22	0	1	23	0	0
18	39104846	.	T	C	14	9	23	0	1	24	0	0
18	39523002	.	T	C	1	2	3	0	0	3	0	0
18	43869659	.	C	T	1	7	8	0	0	8	0	0
18	44321500	.	T	A	3	2	5	0	0	5	0	0
18	44321914	.	T	C	2	3	5	0	2	7	0	0
18	44321949	.	T	C	1	8	9	0	0	9	0	0
18	44321950	.	T	C	2	7	9	0	1	10	0	0
18	44365814	.	T	C	29	9	38	0	1	39	0	0
18	44366155	.	T	C	6	0	6	0	11	17	0	0
18	44580331	.	G	A	2	3	5	0	2	7	0	0
18	44580332	.	G	A	2	2	4	0	3	7	0	0
18	44597048	.	G	A	4	2	6	0	1	7	0	0
18	44599785	.	T	G	3	0	3	0	17	20	0	0
18	44611045	.	A	T	2	2	4	0	0	4	0	0
18	44615861	.	A	T	2	23	25	0	1	26	0	0
18	45260131	.	T	C	2	4	6	0	0	6	0	0
18	45260228	.	T	C	1	4	5	0	0	5	0	0
18	45261177	.	C	T	2	6	8	0	1	9	0	0
18	45261203	.	T	C	2	3	5	0	0	5	0	0
18	45261284	.	A	C	5	3	8	0	1	9	0	0
18	45261299	.	T	A	6	2	8	0	0	8	0	0
18	45261319	.	A	T	6	4	10	0	0	10	0	0
18	45261355	.	C	T	5	7	12	0	0	12	0	0
18	45261369	.	G	T	5	8	13	0	0	13	0	0
18	45261412	.	A	G	1	0	1	0	6	7	0	0
18	45261501	.	G	C	2	3	5	0	0	5	0	0
18	45261587	.	G	T	2	3	5	0	0	5	0	0
18	45261845	.	T	A	3	2	5	0	1	6	0	0
18	45262000	.	G	A	4	3	7	0	1	8	0	0
18	45262163	.	G	A	4	5	9	0	0	9	0	0
18	45262227	.	C	T	5	3	8	0	0	8	0	0
18	45262397	.	C	T	9	4	13	0	0	13	0	0
18	45262440	.	C	A	5	10	15	0	0	15	0	0
18	45550831	.	G	C	1	6	7	1	6	14	0	0
18	45550839	.	A	C	8	6	14	1	0	15	0	0
18	45550903	.	A	G	13	1	14	0	0	14	0	0
18	45561677	.	G	T	8	8	16	0	0	16	0	0
18	45563800	.	A	C	7	11	18	0	2	20	0	0
18	45574140	.	A	G	8	7	15	0	1	16	0	0
18	45574232	.	A	G	5	9	14	0	1	15	0	0
18	45575079	.	G	A	0	7	7	0	13	20	0	0
18	45581704	.	C	A	14	12	26	0	3	29	0	0
18	45584036	.	C	T	4	14	18	0	0	18	0	0
18	45586597	.	G	A	1	23	24	0	26	50	0	0
18	45591836	.	A	T	18	15	33	0	1	34	0	0
18	45591929	.	G	A	16	10	26	0	2	28	0	0
18	45592002	.	A	C	18	9	27	0	1	28	0	0
18	45592031	.	G	A	17	12	29	0	0	29	0	0
18	45649916	.	A	G	14	0	14	0	20	34	0	0
18	45651032	.	C	T	16	18	34	0	4	38	0	0
18	45651731	.	T	A	18	16	34	0	3	37	0	0
18	45656089	.	T	C	17	17	34	0	1	35	0	0
18	45684977	.	T	C	1	2	3	0	0	3	0	0
18	45686225	.	A	T	3	3	6	0	0	6	0	0
18	45686840	.	T	C	5	4	9	0	0	9	0	0
18	45687156	.	T	G	4	0	4	0	5	9	0	0
18	45687258	.	G	C	6	4	10	0	1	11	0	0
18	45689081	.	C	T	6	4	10	0	0	10	0	0
18	45689115	.	G	C	2	4	6	0	0	6	0	0
18	45694762	.	G	A	4	9	13	0	0	13	0	0
18	45697582	.	C	T	3	7	10	0	0	10	0	0
18	45697833	.	A	T	7	3	10	0	0	10	0	0
18	45698032	.	A	G	4	0	4	0	4	8	0	0
18	45698344	.	C	A	4	6	10	0	0	10	0	0
18	45734521	.	G	C	10	8	18	0	2	20	0	0
18	45740194	.	T	C	7	8	15	0	0	15	0	0
18	45743004	.	G	C	9	0	9	0	6	15	0	0
18	45743518	.	G	A	11	7	18	0	0	18	0	0
18	45743522	.	G	A	9	6	15	0	0	15	0	0
18	45743555	.	C	A	8	7	15	0	0	15	0	0
18	45745504	.	A	T	4	6	10	0	0	10	0	0
18	45759309	.	G	T	9	12	21	0	0	21	0	0
18	45786801	.	T	C	34	25	59	0	1	60	0	0
18	45807942	.	G	C	0	5	5	0	4	9	0	0
18	45818602	.	C	T	4	6	10	0	0	10	0	0
18	45820510	.	G	A	0	4	4	0	8	12	0	0
18	45820588	.	A	G	5	5	10	0	0	10	0	0
18	45821780	.	T	C	3	7	10	0	0	10	0	0
18	45824315	.	C	T	4	2	6	0	1	7	0	0
18	45824467	.	G	A	1	7	8	0	8	16	0	0
18	45840402	.	A	G	23	0	23	0	8	31	0	0
18	45842491	.	T	C	11	14	25	1	0	26	0	0
18	45842679	.	G	A	1	15	16	0	16	32	0	0
18	45844458	.	C	T	21	17	38	0	1	39	0	0
18	45844473	.	A	T	22	15	37	0	2	39	0	0
18	45849253	.	T	C	18	19	37	0	2	39	0	0
18	45849283	.	C	T	11	21	32	0	2	34	0	0
18	45851540	.	G	A	0	14	14	0	25	39	0	0
18	45887046	.	T	C	2	4	6	0	0	6	0	0
18	45955140	.	T	A	13	12	25	0	1	26	0	0
18	45955142	.	T	C	11	12	23	0	2	25	0	0
18	45962620	.	T	C	12	4	16	0	0	16	0	0
18	45967083	.	A	G	11	10	21	0	3	24	0	0
18	45967107	.	C	T	13	10	23	0	0	23	0	0
18	45969252	.	C	A	9	11	20	0	1	21	0	0
18	45979887	.	C	T	12	10	22	0	1	23	0	0
18	45983312	.	A	G	2	0	2	0	12	14	0	0
18	45983313	.	A	G	2	0	2	0	12	14	0	0
18	46010243	.	C	T	2	3	5	0	0	5	0	0
18	46015830	.	G	A	2	3	5	0	1	6	0	0
18	46061242	.	G	A	3	2	5	0	0	5	0	0
18	46063648	.	C	T	2	2	4	0	0	4	0	0
18	46154638	.	A	G	1	0	1	0	2	3	0	0
18	46194360	.	T	G	3	4	7	0	0	7	0	0
18	46196280	.	C	T	1	5	6	0	1	7	0	0
18	46198152	.	G	C	12	5	17	0	1	18	0	0
18	46198253	.	G	T	10	5	15	0	0	15	0	0
18	46202801	.	T	C	3	8	11	0	0	11	0	0
18	46203195	.	T	C	1	0	1	0	5	6	0	0
18	46203199	.	C	T	2	3	5	0	1	6	0	0
18	46203457	.	G	T	3	4	7	0	0	7	0	0
18	46203562	.	T	C	3	2	5	0	0	5	0	0
18	46203563	.	C	T	0	2	2	0	3	5	0	0
18	46211710	.	A	T	1	3	4	0	0	4	0	0
18	46211724	.	C	T	1	3	4	0	0	4	0	0
18	46361861	.	C	G	4	8	12	0	1	13	0	0
18	46362772	.	G	T	15	4	19	0	4	23	0	0
18	46367691	.	G	C	8	8	16	0	0	16	0	0
18	46368300	.	C	T	1	3	4	0	3	7	0	0
18	46369173	.	T	C	3	2	5	0	0	5	0	0
18	46393508	.	G	A	0	3	3	0	2	5	0	0
18	46395965	.	G	C	28	20	48	0	2	50	0	0
18	46400979	.	A	G	10	14	24	0	0	24	0	0
18	46401137	.	T	C	6	11	17	0	2	19	0	0
18	46414299	.	C	T	1	3	4	0	3	7	0	0
18	46417624	.	T	C	10	5	15	0	0	15	0	0
18	46417681	.	G	T	6	7	13	0	1	14	0	0
18	46417807	.	A	G	8	8	16	0	1	17	0	0
18	46418281	.	T	C	5	0	5	0	3	8	0	0
18	46418458	.	C	T	0	5	5	0	3	8	0	0
18	46418497	.	G	A	8	3	11	0	0	11	0	0
18	46418521	.	C	T	9	4	13	0	0	13	0	0
18	46418776	.	C	T	1	3	4	0	3	7	0	0
18	46453240	.	C	T	1	3	4	0	0	4	0	0
18	46699773	.	G	A	4	11	15	0	3	18	0	0
18	46702492	.	G	A	2	3	5	0	0	5	0	0
18	47301204	.	T	C	2	2	4	0	0	4	0	0
18	47305433	.	A	G	3	6	9	0	0	9	0	0
18	47306677	.	T	G	2	4	6	1	0	7	0	0
18	47306782	.	A	G	2	7	9	0	0	9	0	0
18	48808043	.	A	G	1	4	5	0	0	5	0	0
18	48808099	.	A	G	2	2	4	0	0	4	0	0
18	48808396	.	A	G	1	3	4	0	0	4	0	0
18	48808552	.	T	C	1	2	3	0	0	3	0	0
18	48808659	.	G	A	0	3	3	0	1	4	0	0
18	48808708	.	T	A	4	2	6	0	0	6	0	0
18	48809226	.	G	A	6	4	10	0	0	10	0	0
18	48809268	.	T	A	5	2	7	0	0	7	0	0
18	48864944	.	C	T	5	3	8	0	0	8	0	0
18	48928230	.	C	T	4	7	11	0	0	11	0	0
18	48928240	.	A	G	4	0	4	0	9	13	0	0
18	48928342	.	A	G	9	0	9	0	8	17	0	0
18	48928387	.	T	A	9	7	16	0	0	16	0	0
18	48934524	.	T	C	9	10	19	0	0	19	0	0
18	48934593	.	T	C	13	15	28	0	1	29	0	0
18	48934805	.	A	G	18	6	24	0	2	26	0	0
18	48934833	.	T	C	17	10	27	0	0	27	0	0
18	48935170	.	G	A	21	11	32	0	1	33	0	0
18	48935279	.	T	G	16	17	33	1	2	36	0	0
18	48935282	.	T	G	16	17	33	1	2	36	0	0
18	48935394	.	A	T	13	14	27	0	0	27	0	0
18	48935709	.	A	G	22	18	40	0	0	40	0	0
18	48935907	.	T	C	6	8	14	0	1	15	0	0
18	48951382	.	C	T	1	2	3	0	0	3	0	0
18	48971165	.	T	C	3	6	9	0	0	9	0	0
18	48971192	.	A	G	3	7	10	0	0	10	0	0
18	48972490	.	A	T	5	2	7	0	2	9	0	0
18	49154130	.	A	G	5	4	9	0	0	9	0	0
18	49154131	.	A	G	6	2	8	0	1	9	0	0
18	49154215	.	A	G	7	3	10	0	2	12	0	0
18	49154328	.	G	A	7	4	11	0	0	11	0	0
18	49154458	.	G	T	5	8	13	0	0	13	0	0
18	49154483	.	G	T	0	11	11	0	6	17	0	0
18	49154525	.	C	T	10	6	16	0	3	19	0	0
18	49154527	.	T	C	10	8	18	0	1	19	0	0
18	49154722	.	A	G	11	12	23	0	0	23	0	0
18	49154760	.	G	A	0	8	8	0	7	15	0	0
18	49154774	.	T	A	8	3	11	0	1	12	0	0
18	49155211	.	C	A	15	6	21	0	2	23	0	0
18	49155295	.	A	G	1	2	3	0	0	3	0	0
18	49155941	.	C	T	11	17	28	0	1	29	0	0
18	49155956	.	T	C	15	18	33	0	1	34	0	0
18	49155976	.	A	T	12	15	27	0	0	27	0	0
18	49156009	.	G	C	14	8	22	0	2	24	0	0
18	49156034	.	A	C	15	7	22	0	3	25	0	0
18	49156077	.	A	G	17	0	17	0	10	27	0	0
18	49156113	.	A	G	7	4	11	0	3	14	0	0
18	49156482	.	G	T	7	6	13	0	0	13	0	0
18	49214198	.	T	C	2	2	4	0	0	4	0	0
18	49239982	.	T	G	1	0	1	0	3	4	0	0
18	49242211	.	G	T	0	4	4	0	1	5	0	0
18	49244819	.	C	A	3	3	6	0	1	7	0	0
18	49244821	.	C	A	3	3	6	0	1	7	0	0
18	49245256	.	G	C	1	2	3	0	0	3	0	0
18	49246672	.	T	A	2	5	7	0	1	8	0	0
18	49247212	.	T	G	2	3	5	0	1	6	0	0
18	49265001	.	G	T	5	6	11	0	0	11	0	0
18	49265002	.	G	T	6	6	12	0	0	12	0	0
18	49266635	.	A	G	3	2	5	0	0	5	0	0
18	49266715	.	C	T	1	3	4	0	0	4	0	0
18	49266746	.	A	G	1	2	3	0	1	4	0	0
18	49267334	.	A	G	2	2	4	0	0	4	0	0
18	49267415	.	T	C	1	2	3	0	0	3	0	0
18	49267416	.	G	T	1	2	3	0	0	3	0	0
18	49267489	.	A	G	3	2	5	0	0	5	0	0
18	49267682	.	T	A	10	4	14	0	0	14	0	0
18	49267701	.	A	T	9	3	12	0	0	12	0	0
18	49267832	.	A	G	2	4	6	0	0	6	0	0
18	49274093	.	C	A	0	3	3	0	2	5	0	0
18	49274771	.	G	A	1	2	3	0	0	3	0	0
18	49310480	.	G	C	1	5	6	0	0	6	0	0
18	49310526	.	C	T	2	3	5	0	0	5	0	0
18	49310570	.	T	G	1	3	4	0	1	5	0	0
18	49428793	.	T	C	3	5	8	0	0	8	0	0
18	49446254	.	T	G	2	5	7	0	0	7	0	0
18	49446293	.	C	G	3	4	7	0	0	7	0	0
18	49446312	.	G	A	3	3	6	0	0	6	0	0
18	49447008	.	C	A	7	5	12	0	0	12	0	0
18	49447041	.	G	A	0	6	6	0	8	14	0	0
18	49969631	.	A	C	3	3	6	0	0	6	0	0
18	49969646	.	A	G	2	1	3	0	3	6	0	0
18	49969819	.	T	C	1	3	4	0	0	4	0	0
18	50034871	.	A	G	2	0	2	0	2	4	0	0
18	50038720	.	T	G	1	5	6	1	1	8	0	0
18	50038721	.	G	T	1	5	6	1	1	8	0	0
18	50039045	.	C	G	3	0	3	0	3	6	0	0
18	50039295	.	C	A	5	5	10	0	0	10	0	0
18	50039536	.	G	A	0	5	5	0	3	8	0	0
18	50039684	.	T	C	5	9	14	0	0	14	0	0
18	50039852	.	G	T	10	14	24	0	0	24	0	0
18	50039939	.	C	T	9	7	16	0	0	16	0	0
18	50276173	.	C	T	9	7	16	0	0	16	0	0
18	50276435	.	G	A	8	8	16	0	0	16	0	0
18	50276476	.	C	G	5	5	10	0	1	11	0	0
18	50279112	.	A	T	15	16	31	0	5	36	0	0
18	50353650	.	C	T	18	28	46	0	2	48	0	0
18	50356440	.	G	A	28	26	54	0	3	57	0	0
18	50356518	.	C	A	30	25	55	0	9	64	0	0
18	50356532	.	G	A	33	34	67	0	2	69	0	0
18	50356632	.	T	C	26	30	56	0	1	57	0	0
18	50443851	.	G	A	2	2	4	0	0	4	0	0
18	50443868	.	T	A	1	2	3	0	1	4	0	0
18	50443889	.	G	T	3	2	5	0	0	5	0	0
18	50457503	.	G	T	5	7	12	0	2	14	0	0
18	50495604	.	C	T	1	2	3	0	0	3	0	0
18	50532117	.	C	T	15	3	18	10	0	28	0	0
18	50532122	.	G	A	14	4	18	10	0	28	0	0
18	50532421	.	C	T	4	12	16	0	1	17	0	0
18	50536290	.	A	T	7	5	12	0	0	12	0	0
18	50536335	.	A	T	7	2	9	0	3	12	0	0
18	50537647	.	A	G	9	1	10	1	0	11	0	0
18	50537884	.	G	A	8	13	21	0	1	22	0	0
18	50538019	.	A	C	11	8	19	0	1	20	0	0
18	50538020	.	G	A	11	7	18	0	2	20	0	0
18	50538268	.	A	G	7	13	20	0	0	20	0	0
18	50538340	.	T	C	3	12	15	0	4	19	0	0
18	50538383	.	T	C	7	4	11	0	0	11	0	0
18	50538533	.	T	C	4	4	8	0	0	8	0	0
18	50538539	.	T	G	5	5	10	0	0	10	0	0
18	50538617	.	C	G	6	2	8	1	0	9	0	0
18	50538628	.	A	C	6	2	8	1	0	9	0	0
18	50538760	.	G	A	6	6	12	0	0	12	0	0
18	50538790	.	A	T	2	2	4	0	0	4	0	0
18	50538875	.	G	C	2	3	5	0	0	5	0	0
18	50539041	.	G	T	7	5	12	0	1	13	0	0
18	50539271	.	G	A	2	2	4	0	0	4	0	0
18	50579546	.	G	A	1	3	4	0	2	6	0	0
18	50579551	.	C	T	2	4	6	0	1	8	1	0
18	50601149	.	G	A	6	9	15	0	0	15	0	0
18	50601426	.	C	G	1	6	7	0	2	9	0	0
18	50601436	.	C	A	4	4	8	0	1	9	0	0
18	50601630	.	C	A	15	10	25	0	0	25	0	0
18	50601636	.	A	G	13	15	28	0	3	31	0	0
18	50606024	.	T	C	9	0	9	0	7	16	0	0
18	50614145	.	T	A	1	5	6	0	0	6	0	0
18	50689577	.	T	C	2	3	5	0	0	5	0	0
18	50689583	.	G	A	2	0	2	0	0	2	0	0
18	50709147	.	C	A	3	0	3	0	19	22	0	0
18	50823336	.	A	G	1	0	1	0	3	4	0	0
19	175381	.	A	G	5	7	12	0	0	12	0	0
19	192923	.	A	G	5	2	7	0	0	7	0	0
19	433681	.	T	C	3	3	6	0	1	7	0	0
19	861077	.	T	A	3	2	5	0	0	5	0	0
19	981432	.	C	T	2	10	12	0	6	18	0	0
19	981483	.	A	G	8	5	13	0	0	13	0	0
19	983651	.	T	G	4	6	10	1	0	11	0	0
19	987655	.	T	A	2	2	4	0	0	4	0	0
19	1013144	.	G	A	2	3	5	0	6	11	0	0
19	1019153	.	T	C	8	0	8	0	7	15	0	0
19	1097579	.	A	G	8	0	8	0	4	12	0	0
19	1097613	.	T	C	6	5	11	0	1	12	0	0
19	1097616	.	T	C	6	6	12	0	0	12	0	0
19	1108290	.	C	T	8	14	22	0	2	24	0	0
19	1110528	.	G	A	14	15	29	0	0	29	0	0
19	1111871	.	T	C	7	8	15	0	1	16	0	0
19	1111882	.	G	T	7	6	13	0	1	14	0	0
19	1112121	.	T	C	1	3	4	0	0	4	0	0
19	1185244	.	T	C	3	2	5	0	0	5	0	0
19	1185281	.	G	A	3	2	5	0	0	5	0	0
19	1185485	.	A	G	14	5	19	0	2	21	0	0
19	1330675	.	C	T	0	3	3	0	2	5	0	0
19	1331172	.	T	C	8	4	12	0	1	13	0	0
19	1331296	.	C	T	0	5	5	0	10	15	0	0
19	1331344	.	C	A	7	6	13	0	0	13	0	0
19	1331443	.	T	C	3	0	3	0	5	8	0	0
19	1331446	.	C	T	4	5	9	0	0	9	0	0
19	1389704	.	C	T	10	3	13	0	1	14	0	0
19	1389886	.	C	T	10	6	16	0	2	18	0	0
19	1389892	.	C	A	10	7	17	0	1	18	0	0
19	1392134	.	G	A	0	13	13	0	13	26	0	0
19	1392177	.	A	C	7	19	26	0	0	26	0	0
19	1392178	.	C	T	8	18	26	0	1	27	0	0
19	1392657	.	T	C	14	15	29	0	1	30	0	0
19	1392713	.	A	G	14	12	26	0	0	26	0	0
19	1392718	.	A	T	13	13	26	0	0	26	0	0
19	1392800	.	G	A	11	6	17	8	0	25	0	0
19	1393073	.	T	A	10	30	40	0	2	42	0	0
19	1393085	.	C	A	8	30	38	0	3	41	0	0
19	1393176	.	C	T	12	8	20	0	1	21	0	0
19	1393199	.	A	G	9	9	18	0	1	19	0	0
19	1406694	.	G	T	2	7	9	0	1	10	0	0
19	1407731	.	G	A	2	3	5	0	0	5	0	0
19	1685685	.	A	G	2	0	2	0	2	4	0	0
19	1685755	.	A	G	1	2	3	0	0	3	0	0
19	1737060	.	T	C	4	4	8	0	0	8	0	0
19	1737208	.	A	T	3	2	5	0	0	5	0	0
19	1848021	.	T	C	1	5	6	0	0	6	0	0
19	1848239	.	G	A	3	2	5	0	0	5	0	0
19	1856556	.	C	G	14	12	26	0	0	26	0	0
19	1856641	.	T	A	15	11	26	1	1	28	0	0
19	1858785	.	G	A	13	10	23	0	0	23	0	0
19	1872897	.	G	A	11	12	23	0	1	24	0	0
19	1877536	.	G	C	25	14	39	0	2	41	0	0
19	1877544	.	G	T	22	15	37	0	1	38	0	0
19	1877662	.	C	G	11	8	19	0	1	20	0	0
19	1879854	.	C	T	13	4	17	0	0	17	0	0
19	1879951	.	C	T	1	7	8	0	0	8	0	0
19	1880602	.	T	C	2	11	13	0	0	13	0	0
19	1880836	.	G	A	1	10	11	0	2	13	0	0
19	1953543	.	A	T	5	7	12	1	0	13	0	0
19	1953583	.	G	T	11	8	19	0	0	19	0	0
19	1953742	.	C	T	9	12	21	0	0	21	0	0
19	1960987	.	T	G	8	8	16	0	1	17	0	0
19	1995590	.	T	G	2	2	4	0	0	4	0	0
19	1995594	.	A	G	2	1	3	0	1	4	0	0
19	1996409	.	T	A	3	3	6	0	0	6	0	0
19	1996550	.	G	A	3	2	5	0	0	5	0	0
19	1996577	.	C	T	5	2	7	0	0	7	0	0
19	1996810	.	G	C	4	3	7	0	0	7	0	0
19	1997120	.	G	A	3	4	7	0	0	7	0	0
19	1997638	.	T	A	2	4	6	0	0	6	0	0
19	1997658	.	A	T	3	3	6	0	1	7	0	0
19	1997676	.	T	C	5	3	8	0	0	8	0	0
19	1997733	.	C	T	8	4	12	0	0	12	0	0
19	1997767	.	C	G	6	4	10	0	2	12	0	0
19	1997978	.	G	A	9	6	15	0	1	16	0	0
19	2000068	.	C	A	3	2	5	0	0	5	0	0
19	2000070	.	G	A	3	2	5	0	0	5	0	0
19	2002992	.	A	G	2	0	2	0	4	6	0	0
19	2003644	.	G	C	1	2	3	0	1	4	0	0
19	2003767	.	C	T	7	3	10	0	0	10	0	0
19	2003902	.	A	T	15	9	24	0	1	25	0	0
19	2003962	.	G	T	0	7	7	0	14	21	0	0
19	2279284	.	C	T	3	2	5	0	0	5	0	0
19	2298917	.	T	A	3	3	6	0	0	6	0	0
19	2300980	.	G	A	2	3	5	0	0	5	0	0
19	2307248	.	C	A	7	3	10	0	0	10	0	0
19	2307268	.	C	T	6	3	9	0	0	9	0	0
19	2307543	.	T	C	5	2	7	0	1	8	0	0
19	2315511	.	C	T	0	5	5	1	7	13	0	0
19	2315721	.	A	G	1	6	7	0	1	8	0	0
19	2316510	.	T	C	1	3	4	0	1	5	0	0
19	2395806	.	A	G	1	4	5	1	0	6	0	0
19	2396022	.	C	T	3	6	9	0	0	9	0	0
19	2396037	.	G	A	7	4	11	0	0	11	0	0
19	2396421	.	T	C	2	0	2	0	4	6	0	0
19	2396445	.	T	A	2	3	5	0	0	5	0	0
19	2397381	.	G	C	4	1	5	0	3	8	0	0
19	2397408	.	G	A	4	5	9	0	0	9	0	0
19	2397741	.	G	A	0	8	8	2	0	10	0	0
19	2550839	.	C	T	1	2	3	0	0	3	0	0
19	2551178	.	A	G	2	4	6	0	0	6	0	0
19	2551214	.	C	T	2	3	5	0	0	5	0	0
19	2551727	.	C	T	1	3	4	0	0	4	0	0
19	2561583	.	A	T	9	6	15	1	0	16	0	0
19	2561596	.	T	A	8	8	16	1	0	17	0	0
19	2561637	.	G	T	0	6	6	0	14	20	0	0
19	2561739	.	G	A	0	5	5	0	10	15	0	0
19	2561811	.	A	G	6	11	17	0	0	17	0	0
19	2664611	.	T	C	3	10	13	0	1	14	0	0
19	2853443	.	T	C	1	2	3	0	0	3	0	0
19	2871511	.	A	G	10	6	16	0	0	16	0	0
19	2871553	.	C	T	8	8	16	0	1	17	0	0
19	2872162	.	G	A	4	9	13	0	0	13	0	0
19	2877218	.	T	C	1	2	3	0	0	3	0	0
19	2877227	.	C	T	0	2	2	0	0	3	1	0
19	2880138	.	C	T	1	3	4	0	0	4	0	0
19	2882754	.	A	C	3	4	7	0	0	7	0	0
19	2930217	.	C	T	1	2	3	0	2	5	0	0
19	2930521	.	T	C	3	5	8	0	0	8	0	0
19	2934321	.	A	G	4	4	8	0	0	8	0	0
19	2960590	.	G	A	1	2	3	0	1	4	0	0
19	2960599	.	T	C	2	0	2	0	2	4	0	0
19	3009193	.	C	A	1	2	3	0	0	3	0	0
19	3009196	.	C	A	0	2	2	0	0	2	0	0
19	3052828	.	A	G	1	2	3	0	0	3	0	0
19	3052836	.	A	T	1	2	3	0	0	3	0	0
19	3080572	.	G	A	2	4	6	0	0	6	0	0
19	3080712	.	T	A	1	3	4	0	0	4	0	0
19	3080863	.	A	T	2	2	4	0	0	4	0	0
19	3080907	.	A	T	1	2	3	0	0	3	0	0
19	3081206	.	G	T	3	4	7	0	0	7	0	0
19	3081927	.	G	A	7	3	10	0	0	10	0	0
19	3081933	.	G	A	1	3	4	0	7	11	0	0
19	3082102	.	C	T	6	4	10	0	0	10	0	0
19	3082159	.	C	G	3	2	5	0	0	5	0	0
19	3087025	.	A	G	4	6	10	0	0	10	0	0
19	3087180	.	C	A	2	5	7	0	1	8	0	0
19	3096448	.	C	T	0	4	4	0	1	5	0	0
19	3137727	.	C	T	1	26	27	0	20	47	0	0
19	3137761	.	C	A	14	26	40	0	3	43	0	0
19	3137803	.	A	T	13	15	28	0	5	33	0	0
19	3137888	.	T	C	13	0	13	0	15	28	0	0
19	3138166	.	G	T	5	2	7	1	0	8	0	0
19	3138325	.	A	C	4	8	12	0	1	13	0	0
19	3138355	.	T	G	3	6	9	0	2	11	0	0
19	3386141	.	C	T	0	2	2	0	1	3	0	0
19	3386580	.	T	A	1	2	3	0	0	3	0	0
19	3866165	.	T	C	13	7	20	0	4	24	0	0
19	3866179	.	T	C	12	0	12	0	7	19	0	0
19	4010146	.	A	G	1	4	5	0	0	5	0	0
19	4341539	.	T	C	1	5	6	0	0	6	0	0
19	4446957	.	T	A	1	1	2	0	1	3	0	0
19	4857526	.	C	T	2	3	5	0	0	5	0	0
19	4857910	.	A	G	3	2	5	0	1	6	0	0
19	4858000	.	C	T	2	2	4	0	0	4	0	0
19	4866727	.	T	C	3	2	5	0	0	5	0	0
19	4866919	.	T	C	7	7	14	0	0	14	0	0
19	4867132	.	G	A	0	3	3	0	5	8	0	0
19	4867232	.	C	G	5	7	12	0	0	12	0	0
19	4867274	.	G	A	2	2	4	0	7	11	0	0
19	4878751	.	C	T	5	4	9	0	0	9	0	0
19	4881345	.	G	T	4	5	9	0	0	9	0	0
19	4881414	.	T	C	3	6	9	0	1	10	0	0
19	4885398	.	A	G	8	3	11	0	1	12	0	0
19	4885431	.	A	G	7	3	10	0	1	11	0	0
19	4888471	.	T	G	13	5	18	0	1	20	1	0
19	4888684	.	T	C	8	11	19	0	1	20	0	0
19	4888693	.	T	C	9	11	20	0	1	21	0	0
19	4888720	.	A	G	5	8	13	0	5	18	0	0
19	4888744	.	A	G	10	6	16	0	0	16	0	0
19	4892530	.	G	T	0	12	12	0	11	23	0	0
19	4892628	.	A	G	9	7	16	0	0	16	0	0
19	4892643	.	T	C	9	8	17	0	0	17	0	0
19	4892787	.	C	T	4	6	10	0	1	11	0	0
19	4892940	.	G	A	2	8	10	0	13	23	0	0
19	4893033	.	A	G	3	0	3	0	5	8	0	0
19	4903907	.	C	T	7	7	14	0	2	16	0	0
19	4903971	.	A	T	15	12	27	0	1	28	0	0
19	4903998	.	A	G	15	8	23	0	1	24	0	0
19	4904041	.	C	T	15	9	24	0	0	24	0	0
19	4904467	.	G	A	3	4	7	0	0	7	0	0
19	4904470	.	A	G	3	0	3	0	4	7	0	0
19	4904972	.	T	C	14	9	23	0	0	23	0	0
19	4904991	.	T	C	12	11	23	0	2	25	0	0
19	4905175	.	G	A	11	5	16	0	2	18	0	0
19	4905229	.	T	C	15	6	21	0	1	22	0	0
19	4905309	.	A	T	3	3	6	0	0	6	0	0
19	4913087	.	A	G	1	4	5	0	0	5	0	0
19	4951138	.	C	T	3	4	7	0	0	7	0	0
19	4961598	.	A	G	3	3	6	0	0	6	0	0
19	4961656	.	A	G	4	6	10	0	0	10	0	0
19	4961950	.	A	T	12	10	22	0	0	22	0	0
19	4961977	.	A	T	9	9	18	0	1	19	0	0
19	4976906	.	C	T	1	3	4	0	0	4	0	0
19	4976925	.	C	G	2	2	4	0	0	4	0	0
19	4981062	.	C	A	1	2	3	0	2	5	0	0
19	4985064	.	T	A	3	5	8	0	0	8	0	0
19	4985105	.	A	G	1	4	5	0	0	5	0	0
19	4985125	.	C	T	1	1	2	0	1	3	0	0
19	4985720	.	A	T	9	7	16	0	0	16	0	0
19	4985721	.	T	A	8	7	15	0	0	15	0	0
19	4993133	.	T	C	1	2	3	0	0	3	0	0
19	4998787	.	T	A	2	4	6	0	0	6	0	0
19	5001119	.	C	T	2	17	19	1	23	43	0	0
19	5009251	.	A	C	6	18	24	0	3	27	0	0
19	5009353	.	G	A	19	8	27	0	1	28	0	0
19	5016071	.	T	C	10	15	25	0	1	26	0	0
19	5016302	.	T	G	9	12	21	0	2	23	0	0
19	5018307	.	A	G	9	5	14	0	0	14	0	0
19	5018340	.	A	G	10	7	17	0	0	17	0	0
19	5020451	.	G	A	7	6	13	0	0	13	0	0
19	5022301	.	C	T	11	6	17	0	0	17	0	0
19	5024424	.	G	A	4	3	7	0	0	7	0	0
19	5024436	.	C	T	4	3	7	0	1	8	0	0
19	5024685	.	T	C	4	7	11	0	0	11	0	0
19	5026119	.	A	G	2	3	5	0	0	5	0	0
19	5028136	.	G	A	5	4	9	0	0	9	0	0
19	5028719	.	C	T	0	3	3	0	2	5	0	0
19	5030274	.	G	A	1	2	3	0	0	3	0	0
19	5031617	.	T	C	3	6	9	0	0	9	0	0
19	5032178	.	T	C	4	3	7	0	0	7	0	0
19	5035253	.	G	A	3	2	5	0	0	5	0	0
19	5039491	.	A	T	2	3	5	0	0	5	0	0
19	5077173	.	C	T	15	8	23	0	1	24	0	0
19	5080124	.	T	A	19	14	33	0	0	33	0	0
19	5081758	.	T	C	22	10	32	0	0	32	0	0
19	5081796	.	C	T	25	10	35	0	1	36	0	0
19	5081987	.	G	A	0	15	15	0	10	25	0	0
19	5082095	.	A	G	13	17	30	0	0	30	0	0
19	5089755	.	C	G	40	21	61	0	1	62	0	0
19	5089900	.	C	G	31	1	32	0	34	66	0	0
19	5090070	.	A	T	21	23	44	0	2	46	0	0
19	5090071	.	G	T	21	24	45	0	1	46	0	0
19	5090264	.	G	A	26	6	32	0	2	34	0	0
19	5090357	.	T	C	27	22	49	0	2	51	0	0
19	5090379	.	C	T	31	16	47	0	3	51	1	0
19	5090409	.	G	A	35	25	60	0	1	61	0	0
19	5090483	.	A	T	37	20	57	0	1	58	0	0
19	5090583	.	C	T	10	4	14	0	0	14	0	0
19	5090677	.	A	C	7	3	10	0	0	10	0	0
19	5090691	.	A	G	7	6	13	0	0	13	0	0
19	5091483	.	T	C	31	33	64	0	6	70	0	0
19	5091726	.	T	C	9	3	12	0	0	12	0	0
19	5094288	.	G	T	7	13	20	0	0	20	0	0
19	5094389	.	C	T	7	6	13	0	1	14	0	0
19	5094471	.	T	C	10	15	25	0	1	26	0	0
19	5094504	.	A	G	7	19	26	0	1	27	0	0
19	5094616	.	C	T	2	14	16	0	12	28	0	0
19	5100191	.	G	A	4	8	12	0	2	14	0	0
19	5146708	.	C	T	1	2	3	0	0	3	0	0
19	5158795	.	A	G	41	33	74	0	2	76	0	0
19	5159157	.	C	A	25	38	63	0	5	68	0	0
19	5160048	.	C	G	36	25	61	0	2	63	0	0
19	5160121	.	T	C	27	0	27	0	27	54	0	0
19	5160133	.	C	A	2	23	25	0	24	49	0	0
19	5160201	.	A	G	24	23	47	0	2	49	0	0
19	5160302	.	T	C	25	0	25	0	20	45	0	0
19	5160310	.	C	T	4	23	27	0	22	49	0	0
19	5160379	.	T	A	25	22	47	0	1	48	0	0
19	5160996	.	A	T	11	19	30	0	2	32	0	0
19	5161750	.	A	G	20	14	34	1	2	37	0	0
19	5162105	.	G	A	16	13	29	0	3	32	0	0
19	5162252	.	A	T	19	24	43	0	1	44	0	0
19	5162253	.	T	C	20	0	20	0	25	45	0	0
19	5162544	.	A	G	6	9	15	0	1	16	0	0
19	5162827	.	C	T	8	5	13	0	1	14	0	0
19	5162839	.	T	C	8	0	8	0	8	16	0	0
19	5162923	.	C	T	6	6	12	0	1	13	0	0
19	5163031	.	C	T	9	10	19	0	2	21	0	0
19	5163910	.	T	C	11	10	21	0	0	21	0	0
19	5254510	.	A	G	8	4	12	0	1	13	0	0
19	5582319	.	G	T	1	2	3	0	0	3	0	0
19	5611439	.	G	A	0	4	4	0	3	7	0	0
19	5611586	.	T	C	5	7	12	0	0	12	0	0
19	5617832	.	T	C	15	8	23	0	2	25	0	0
19	5619892	.	G	A	8	9	17	0	0	17	0	0
19	5619931	.	A	G	6	9	15	0	0	15	0	0
19	5620094	.	A	T	8	7	15	0	0	15	0	0
19	5620175	.	T	G	15	10	25	0	1	26	0	0
19	5620208	.	G	T	13	7	20	0	1	21	0	0
19	5620459	.	T	C	11	16	27	0	1	28	0	0
19	5620525	.	C	T	11	16	27	0	0	27	0	0
19	5620640	.	G	T	13	20	33	0	1	34	0	0
19	5620659	.	G	A	16	14	30	0	3	34	1	0
19	5621131	.	A	G	23	0	23	0	21	44	0	0
19	5621165	.	G	A	20	15	35	0	1	36	0	0
19	5686916	.	C	T	1	3	4	0	0	4	0	0
19	5687082	.	G	T	2	2	4	0	0	4	0	0
19	5687132	.	G	T	1	2	3	0	0	3	0	0
19	5779170	.	C	T	8	4	12	0	1	13	0	0
19	5779601	.	T	C	13	18	31	0	2	33	0	0
19	5779897	.	T	C	9	13	22	0	2	24	0	0
19	5779946	.	G	C	7	12	19	0	1	20	0	0
19	5780032	.	C	G	0	4	4	0	4	8	0	0
19	5780301	.	T	A	6	8	14	0	1	15	0	0
19	5780342	.	A	C	8	0	8	0	8	16	0	0
19	5780989	.	G	A	5	6	11	0	0	11	0	0
19	5781367	.	T	C	3	5	8	0	0	8	0	0
19	5781397	.	A	G	3	4	7	0	0	7	0	0
19	5793484	.	C	G	1	2	3	0	0	3	0	0
19	5793532	.	T	C	1	2	3	0	1	4	0	0
19	5805773	.	T	G	4	5	9	0	0	9	0	0
19	6060309	.	A	T	11	6	17	0	3	20	0	0
19	6073362	.	T	C	2	2	4	0	1	5	0	0
19	6076813	.	C	A	2	4	6	0	1	7	0	0
19	6085987	.	A	G	14	12	26	2	1	29	0	0
19	6086441	.	C	G	19	14	33	2	1	36	0	0
19	6086577	.	C	T	0	22	22	0	16	38	0	0
19	6087130	.	T	A	6	8	14	0	0	14	0	0
19	6087146	.	C	T	0	8	8	0	6	14	0	0
19	6087186	.	A	T	6	7	13	0	0	13	0	0
19	6087619	.	T	C	2	0	2	0	9	11	0	0
19	6087894	.	G	A	10	4	14	0	1	15	0	0
19	6087948	.	A	T	10	6	16	1	0	17	0	0
19	6088000	.	C	T	2	9	11	1	11	23	0	0
19	6088166	.	T	C	6	4	10	0	0	10	0	0
19	6088259	.	A	C	7	7	14	0	2	16	0	0
19	6088419	.	A	T	6	9	15	0	1	16	0	0
19	6090702	.	T	C	9	5	14	0	0	14	0	0
19	6090732	.	T	A	11	6	17	0	0	17	0	0
19	6097416	.	A	G	9	4	13	0	1	14	0	0
19	6099984	.	G	A	7	3	10	0	0	10	0	0
19	6099992	.	G	A	7	5	12	0	0	12	0	0
19	6100027	.	G	A	4	4	8	0	1	9	0	0
19	6100037	.	C	T	4	5	9	0	1	10	0	0
19	6100073	.	T	G	6	6	12	0	1	13	0	0
19	6100198	.	C	A	3	6	9	1	0	10	0	0
19	6111214	.	A	G	5	3	8	0	0	8	0	0
19	6111268	.	G	A	2	2	4	0	2	6	0	0
19	6111366	.	C	T	0	4	4	0	5	9	0	0
19	6125926	.	G	A	1	3	4	0	1	5	0	0
19	6125941	.	C	T	1	4	5	0	0	5	0	0
19	6142187	.	C	A	1	5	6	0	4	10	0	0
19	6142714	.	A	T	7	11	18	0	1	19	0	0
19	6142803	.	A	G	12	5	17	0	0	17	0	0
19	6142951	.	A	G	5	2	7	0	1	8	0	0
19	6142970	.	C	T	5	2	7	0	0	7	0	0
19	6143373	.	T	C	3	3	6	0	1	7	0	0
19	6143583	.	C	G	2	2	4	0	1	5	0	0
19	6144101	.	T	A	3	3	6	0	1	7	0	0
19	6144822	.	C	G	1	2	3	0	0	3	0	0
19	6214772	.	G	A	2	8	10	0	2	12	0	0
19	6217133	.	T	A	6	2	8	0	0	8	0	0
19	6328442	.	T	C	54	11	65	0	38	103	0	0
19	6328514	.	A	C	43	35	78	0	5	83	0	0
19	6329154	.	C	T	6	19	25	0	28	53	0	0
19	6329236	.	A	G	34	25	59	2	2	63	0	0
19	6329237	.	G	A	36	24	60	2	1	63	0	0
19	6329301	.	A	C	25	36	61	0	1	62	0	0
19	6329329	.	G	A	29	33	62	0	5	67	0	0
19	6329533	.	C	T	3	24	27	0	39	66	0	0
19	6329660	.	C	T	6	21	27	0	38	71	6	0
19	6330050	.	T	C	22	28	50	0	3	53	0	0
19	6332902	.	C	A	2	22	24	0	19	43	0	0
19	6333448	.	G	A	21	8	29	0	4	33	0	0
19	6338207	.	A	G	12	12	24	0	1	25	0	0
19	6338261	.	A	G	7	4	11	0	0	11	0	0
19	6339131	.	A	G	12	10	22	0	0	22	0	0
19	6341941	.	A	G	9	10	19	0	0	19	0	0
19	6342076	.	C	G	3	4	7	0	0	7	0	0
19	6344573	.	G	T	13	7	20	0	0	20	0	0
19	6344621	.	C	T	7	4	11	0	0	11	0	0
19	6346506	.	C	G	6	3	9	0	0	9	0	0
19	6346587	.	C	T	1	2	3	0	2	5	0	0
19	6362804	.	T	A	3	5	8	0	0	8	0	0
19	6907785	.	G	A	2	2	4	0	0	4	0	0
19	6908085	.	G	A	3	2	5	0	0	5	0	0
19	6908433	.	A	C	3	2	5	0	0	5	0	0
19	6908650	.	T	C	1	4	5	0	0	5	0	0
19	6908651	.	T	C	1	3	4	0	1	5	0	0
19	6915030	.	T	C	1	3	4	0	0	4	0	0
19	6915114	.	C	T	5	3	8	0	0	8	0	0
19	6916019	.	T	C	2	2	4	0	0	4	0	0
19	6916029	.	G	A	5	2	7	0	0	7	0	0
19	6916158	.	C	A	2	4	6	0	0	6	0	0
19	6933374	.	G	C	1	2	3	0	0	3	0	0
19	6934105	.	G	A	0	3	3	0	1	4	0	0
19	6934112	.	G	C	2	3	5	0	0	5	0	0
19	6940213	.	C	T	2	4	6	0	0	6	0	0
19	6947406	.	A	C	4	3	7	0	1	8	0	0
19	6947409	.	A	C	3	5	8	0	0	8	0	0
19	6949256	.	G	A	0	4	4	0	7	11	0	0
19	6949316	.	C	A	8	3	11	0	0	11	0	0
19	6950393	.	G	A	7	3	10	0	1	11	0	0
19	6952600	.	T	C	16	6	22	0	0	22	0	0
19	6955061	.	C	T	8	8	16	0	1	17	0	0
19	6955130	.	C	T	10	5	15	0	0	15	0	0
19	6955131	.	C	T	8	5	13	0	1	14	0	0
19	6955198	.	C	A	12	14	26	0	0	26	0	0
19	6955411	.	C	T	4	8	12	0	1	13	0	0
19	6955475	.	T	C	4	3	7	0	1	8	0	0
19	6955609	.	C	G	7	9	16	0	2	18	0	0
19	6955620	.	G	A	0	7	7	0	8	15	0	0
19	6955920	.	G	A	15	9	24	0	0	24	0	0
19	6956058	.	T	C	17	14	31	0	2	33	0	0
19	6956060	.	G	A	16	15	31	0	2	33	0	0
19	6956553	.	A	C	4	2	6	0	0	6	0	0
19	6956555	.	A	T	4	2	6	0	0	6	0	0
19	6956665	.	C	A	11	8	19	0	0	20	1	0
19	6956728	.	T	A	13	14	27	0	0	27	0	0
19	6956829	.	T	A	16	9	25	0	1	26	0	0
19	6956835	.	C	G	15	6	21	0	1	22	0	0
19	6956892	.	T	A	9	4	13	0	0	13	0	0
19	6957127	.	A	T	33	12	45	0	4	49	0	0
19	6957131	.	C	A	31	15	46	0	5	51	0	0
19	6960653	.	C	A	6	11	17	0	2	19	0	0
19	6961095	.	G	A	6	8	14	0	0	14	0	0
19	6961211	.	T	C	3	2	5	1	0	6	0	0
19	6961377	.	G	T	6	2	8	0	1	9	0	0
19	6961421	.	T	A	13	4	17	0	0	17	0	0
19	6961610	.	G	A	3	8	11	0	1	12	0	0
19	6961674	.	A	G	4	6	10	0	0	10	0	0
19	7000068	.	C	T	1	2	3	0	0	3	0	0
19	7014570	.	C	A	2	4	6	0	0	6	0	0
19	7014743	.	G	A	3	4	7	0	2	9	0	0
19	7014778	.	T	A	7	6	13	0	1	14	0	0
19	7014909	.	C	A	2	4	6	0	0	6	0	0
19	7014912	.	G	A	2	4	6	0	0	6	0	0
19	7020179	.	G	A	4	4	8	0	0	8	0	0
19	7020347	.	C	T	2	2	4	0	1	5	0	0
19	7022107	.	G	A	3	2	5	0	1	6	0	0
19	7022128	.	G	A	4	3	7	0	0	7	0	0
19	7027810	.	A	T	1	2	3	0	0	3	0	0
19	7028011	.	C	T	2	2	4	0	0	4	0	0
19	7038901	.	A	C	1	2	3	0	0	3	0	0
19	7039308	.	G	A	4	5	9	0	1	10	0	0
19	7039335	.	T	C	2	0	2	0	3	5	0	0
19	7039344	.	G	A	1	5	6	0	0	7	1	0
19	7100564	.	A	T	1	4	5	0	1	6	0	0
19	7106355	.	A	G	2	2	4	0	0	4	0	0
19	7106409	.	A	G	1	2	3	0	0	3	0	0
19	7111981	.	C	A	1	2	3	0	1	4	0	0
19	7128225	.	T	C	4	3	7	0	0	7	0	0
19	7128229	.	A	C	4	3	7	0	1	8	0	0
19	7128598	.	T	C	2	1	3	0	1	4	0	0
19	7128605	.	G	T	3	2	5	0	0	5	0	0
19	7152971	.	G	T	0	8	8	0	7	15	0	0
19	7152974	.	G	A	5	8	13	0	3	16	0	0
19	7154729	.	A	G	16	12	28	0	3	31	0	0
19	7154770	.	A	C	22	7	29	0	0	29	0	0
19	7155001	.	A	T	14	13	27	0	1	28	0	0
19	7155034	.	A	G	12	18	30	0	2	32	0	0
19	7155065	.	T	C	15	17	32	0	0	32	0	0
19	7158469	.	C	T	1	4	5	0	0	5	0	0
19	7159062	.	G	A	2	4	6	0	2	8	0	0
19	7159107	.	T	C	1	3	4	0	1	5	0	0
19	7161452	.	G	A	5	3	8	0	0	8	0	0
19	7161539	.	G	T	2	2	4	0	0	4	0	0
19	7163872	.	C	T	7	4	11	0	0	11	0	0
19	7163908	.	A	G	6	5	11	0	0	11	0	0
19	7164022	.	G	A	7	6	13	0	1	14	0	0
19	7166211	.	C	T	7	7	14	0	0	14	0	0
19	7166454	.	C	A	8	8	16	0	1	17	0	0
19	7169204	.	A	C	13	6	19	0	4	23	0	0
19	7169228	.	C	T	18	5	23	0	1	24	0	0
19	7169304	.	G	A	7	3	10	0	2	12	0	0
19	7169587	.	A	G	5	3	8	0	1	9	0	0
19	7169588	.	G	A	6	3	9	0	0	9	0	0
19	7169770	.	A	C	9	4	13	0	0	13	0	0
19	7169809	.	C	T	10	4	14	0	0	15	1	0
19	7169880	.	T	C	17	5	22	0	1	23	0	0
19	7169886	.	G	A	12	8	20	0	3	23	0	0
19	7169929	.	G	A	14	10	24	0	2	26	0	0
19	7170014	.	A	C	10	3	13	0	1	14	0	0
19	7170015	.	T	C	11	3	14	0	0	14	0	0
19	7170128	.	A	G	10	6	16	0	0	16	0	0
19	7170191	.	A	C	9	14	23	0	0	23	0	0
19	7170228	.	A	T	8	8	16	0	2	18	0	0
19	7170642	.	C	T	2	3	5	0	0	5	0	0
19	7174669	.	T	C	7	3	10	0	0	10	0	0
19	7174672	.	T	A	9	3	12	0	0	12	0	0
19	7176913	.	G	A	1	2	3	0	7	10	0	0
19	7176915	.	C	A	8	2	10	0	0	10	0	0
19	7249800	.	A	G	2	5	7	0	0	7	0	0
19	7249811	.	T	C	2	3	5	0	1	6	0	0
19	7258085	.	A	G	1	3	4	0	0	4	0	0
19	7270102	.	G	A	2	2	4	0	0	4	0	0
19	7276063	.	A	T	1	2	3	0	1	4	0	0
19	7276106	.	G	A	7	18	25	0	6	31	0	0
19	7276149	.	A	G	21	23	44	0	2	46	0	0
19	7276194	.	T	A	30	25	55	0	0	55	0	0
19	7276559	.	G	A	30	29	59	0	3	62	0	0
19	7276610	.	G	A	34	29	63	0	4	68	1	0
19	7279235	.	A	G	26	31	57	4	4	65	0	0
19	7279721	.	A	G	26	17	43	0	1	44	0	0
19	7282541	.	C	T	24	20	44	0	3	47	0	0
19	7282554	.	G	A	21	27	48	0	0	48	0	0
19	7283427	.	C	A	18	11	29	0	0	29	0	0
19	7283499	.	A	G	23	11	34	0	0	34	0	0
19	7284840	.	C	T	2	12	14	0	13	27	0	0
19	7286301	.	A	G	10	10	20	0	0	20	0	0
19	7286355	.	A	G	17	11	28	0	0	28	0	0
19	7286421	.	T	A	7	8	15	0	1	16	0	0
19	7286742	.	A	G	5	6	11	0	0	11	0	0
19	7287600	.	T	C	7	2	9	0	0	9	0	0
19	7287603	.	G	A	7	2	9	0	0	9	0	0
19	7288195	.	A	G	6	7	13	0	0	13	0	0
19	7290175	.	A	G	6	3	9	0	0	9	0	0
19	7290214	.	A	G	5	7	12	0	2	14	0	0
19	7291642	.	A	T	5	5	10	0	0	10	0	0
19	7293138	.	A	G	1	3	4	0	0	4	0	0
19	7295279	.	G	A	6	5	11	0	0	11	0	0
19	7295572	.	G	C	2	3	5	0	0	5	0	0
19	7309154	.	G	A	11	15	26	0	2	28	0	0
19	7309391	.	C	A	28	25	53	0	1	54	0	0
19	7309522	.	G	C	35	17	52	0	3	55	0	0
19	7309556	.	T	A	20	14	34	0	5	39	0	0
19	7309557	.	T	A	21	16	37	0	1	38	0	0
19	7309754	.	T	G	8	15	23	0	1	24	0	0
19	7309929	.	A	T	25	11	36	1	1	38	0	0
19	7309968	.	G	T	17	8	25	0	1	26	0	0
19	7310117	.	T	C	21	0	21	0	13	34	0	0
19	7310131	.	C	T	18	13	31	0	0	31	0	0
19	7310154	.	A	T	13	12	25	0	2	27	0	0
19	7311678	.	T	G	12	5	17	0	0	17	0	0
19	7313933	.	C	G	13	14	27	0	0	27	0	0
19	7327462	.	A	G	6	4	10	0	1	11	0	0
19	7327519	.	C	T	7	6	13	0	2	15	0	0
19	7327564	.	G	T	6	9	15	0	1	16	0	0
19	7327570	.	T	C	5	9	14	0	0	14	0	0
19	7337862	.	C	A	5	3	8	0	0	8	0	0
19	7338033	.	C	T	1	2	3	0	6	9	0	0
19	7338125	.	C	T	3	3	6	0	0	6	0	0
19	7338218	.	A	T	1	1	2	0	1	3	0	0
19	7338309	.	C	T	0	3	3	0	5	8	0	0
19	7338969	.	C	T	1	2	3	0	0	3	0	0
19	7338978	.	T	C	2	0	2	0	3	5	0	0
19	7339008	.	T	G	3	2	5	0	0	5	0	0
19	7411975	.	T	C	2	5	7	0	0	7	0	0
19	7412062	.	T	C	7	10	17	0	0	17	0	0
19	7412358	.	A	T	5	10	15	0	0	15	0	0
19	7412441	.	C	A	4	5	9	0	0	9	0	0
19	7412490	.	T	C	4	5	9	0	1	10	0	0
19	7424794	.	G	A	3	3	6	0	1	7	0	0
19	7426637	.	C	T	2	3	5	0	0	5	0	0
19	7426814	.	C	T	4	2	6	0	0	6	0	0
19	7426832	.	G	A	6	2	8	0	0	8	0	0
19	7426967	.	T	C	8	8	16	0	0	16	0	0
19	7427099	.	C	A	5	9	14	0	1	15	0	0
19	7430160	.	T	C	15	8	23	0	0	23	0	0
19	7430607	.	G	A	0	13	13	0	15	28	0	0
19	7430652	.	C	T	13	8	21	0	1	22	0	0
19	7430700	.	A	G	8	0	8	0	10	18	0	0
19	7430715	.	C	A	9	10	19	0	0	19	0	0
19	7432806	.	A	C	4	1	5	0	1	6	0	0
19	7433068	.	T	A	5	5	10	0	0	10	0	0
19	7433637	.	C	A	2	4	6	0	0	6	0	0
19	7433841	.	G	T	1	5	6	0	0	6	0	0
19	7434010	.	T	C	2	2	4	0	0	4	0	0
19	7434139	.	T	C	2	3	5	0	0	5	0	0
19	7434161	.	G	T	2	2	4	0	0	4	0	0
19	7434252	.	T	C	3	2	5	0	0	5	0	0
19	7434555	.	C	T	5	2	7	0	0	7	0	0
19	7434611	.	G	C	5	3	8	0	1	9	0	0
19	7435410	.	A	G	1	3	4	0	0	4	0	0
19	7435422	.	G	A	1	3	4	0	0	4	0	0
19	7435605	.	T	C	3	2	5	0	0	5	0	0
19	7445676	.	G	A	6	11	17	5	0	22	0	0
19	7445897	.	C	T	29	33	62	0	3	65	0	0
19	7446050	.	T	C	25	29	54	0	0	54	0	0
19	7446137	.	G	T	18	24	42	0	2	44	0	0
19	7446286	.	G	T	24	27	51	0	2	53	0	0
19	7446495	.	G	T	35	32	67	0	3	70	0	0
19	7446621	.	C	A	32	26	58	0	4	62	0	0
19	7446702	.	T	C	21	33	54	0	1	55	0	0
19	7450572	.	G	A	27	29	56	0	3	59	0	0
19	7450658	.	T	C	12	10	22	0	0	22	0	0
19	7450750	.	A	G	2	6	8	0	0	8	0	0
19	7450783	.	C	T	0	2	2	0	3	5	0	0
19	7456364	.	T	C	1	3	4	0	1	5	0	0
19	7456371	.	A	C	2	4	6	0	0	6	0	0
19	7456722	.	C	G	3	9	12	0	0	12	0	0
19	7456793	.	A	G	2	9	11	0	0	11	0	0
19	7468556	.	G	T	1	1	2	0	3	5	0	0
19	7468580	.	C	T	1	8	9	0	0	9	0	0
19	7468746	.	T	A	3	7	10	0	2	12	0	0
19	7474242	.	T	C	7	9	16	0	1	17	0	0
19	7474245	.	T	G	7	0	7	0	9	16	0	0
19	7478159	.	A	G	6	17	23	0	0	23	0	0
19	7478283	.	C	T	4	11	15	0	1	16	0	0
19	7478356	.	G	A	7	13	20	0	0	20	0	0
19	7482931	.	C	T	4	5	9	0	0	9	0	0
19	7482993	.	G	A	7	4	11	1	1	13	0	0
19	7483059	.	A	T	5	2	7	0	2	9	0	0
19	7483155	.	A	T	10	3	13	0	0	13	0	0
19	7483173	.	A	T	13	3	16	0	0	16	0	0
19	7483469	.	T	G	3	6	9	0	0	9	0	0
19	7484763	.	T	A	0	2	2	0	0	2	0	0
19	7484770	.	T	C	2	1	3	0	0	3	0	0
19	7495867	.	A	T	12	6	18	0	4	22	0	0
19	7498046	.	T	C	11	14	25	0	0	25	0	0
19	7498079	.	A	G	5	15	20	0	3	23	0	0
19	7498103	.	A	G	8	14	22	0	0	22	0	0
19	7505591	.	A	G	12	13	25	0	0	25	0	0
19	7505907	.	A	G	11	1	12	0	16	28	0	0
19	7506036	.	A	G	10	1	11	0	9	20	0	0
19	7506097	.	T	C	3	2	5	0	1	6	0	0
19	7507833	.	A	T	3	2	5	0	0	5	0	0
19	7510223	.	T	C	4	4	8	0	0	8	0	0
19	7510501	.	G	A	0	7	7	0	2	9	0	0
19	7510567	.	C	T	6	8	14	0	0	14	0	0
19	7512406	.	C	G	6	5	11	0	0	11	0	0
19	7513085	.	C	T	4	7	11	0	0	11	0	0
19	7513291	.	A	C	9	3	12	0	0	12	0	0
19	7513406	.	A	T	5	8	13	0	0	13	0	0
19	7513631	.	A	G	3	8	11	0	0	11	0	0
19	7513651	.	A	G	6	4	10	0	0	10	0	0
19	7513879	.	A	G	2	0	2	0	6	8	0	0
19	7513945	.	A	G	7	0	7	0	4	11	0	0
19	7513946	.	A	G	5	6	11	0	0	11	0	0
19	7514066	.	C	T	7	2	9	0	0	9	0	0
19	7514069	.	G	T	7	2	9	0	0	9	0	0
19	7514137	.	G	A	0	2	2	0	5	7	0	0
19	7514150	.	C	G	3	1	4	0	1	5	0	0
19	7514697	.	A	G	6	0	6	1	5	12	0	0
19	7514708	.	A	G	10	3	13	1	1	15	0	0
19	7514786	.	A	G	5	10	15	1	0	16	0	0
19	7514852	.	A	G	8	6	14	0	0	14	0	0
19	7514917	.	A	G	3	3	6	0	0	6	0	0
19	7515336	.	A	T	7	8	15	0	0	15	0	0
19	7515356	.	G	A	4	10	14	1	0	15	0	0
19	7515423	.	A	G	8	4	12	0	4	16	0	0
19	7515458	.	A	G	9	6	15	0	0	15	0	0
19	7515468	.	T	G	9	6	15	0	0	15	0	0
19	7515787	.	A	T	10	9	19	0	1	20	0	0
19	7515829	.	C	T	12	18	30	0	1	31	0	0
19	7515845	.	A	T	15	17	32	0	4	36	0	0
19	7516035	.	A	G	18	9	27	0	0	27	0	0
19	7516063	.	A	C	18	17	35	0	1	36	0	0
19	7516169	.	C	A	20	15	35	0	2	37	0	0
19	7516183	.	T	G	16	10	26	0	2	28	0	0
19	7525148	.	C	T	0	6	6	0	2	8	0	0
19	7549916	.	G	A	3	4	7	0	0	7	0	0
19	7552736	.	C	G	1	3	4	0	0	4	0	0
19	7552737	.	G	T	0	3	3	0	1	4	0	0
19	7552875	.	G	C	0	4	4	0	3	7	0	0
19	7552887	.	A	G	2	5	7	0	0	7	0	0
19	7557538	.	T	C	6	5	11	0	1	12	0	0
19	7557589	.	T	G	6	0	6	0	6	12	0	0
19	7557619	.	A	T	5	5	10	0	2	12	0	0
19	7557773	.	A	T	9	5	14	0	2	16	0	0
19	7557793	.	G	C	11	3	14	0	1	15	0	0
19	7557992	.	C	T	4	8	12	0	0	12	0	0
19	7558009	.	G	A	6	10	16	0	1	17	0	0
19	7559818	.	G	T	9	7	16	0	1	17	0	0
19	7559905	.	A	G	6	4	10	0	0	10	0	0
19	7564073	.	A	G	2	7	9	0	1	10	0	0
19	7565142	.	G	A	14	12	26	0	1	27	0	0
19	7565244	.	A	G	20	12	32	0	0	32	0	0
19	7566493	.	A	T	12	4	16	0	2	18	0	0
19	7567021	.	T	A	21	16	37	0	0	37	0	0
19	7567196	.	A	C	2	2	4	0	0	4	0	0
19	7590964	.	G	A	0	2	2	0	4	6	0	0
19	7591001	.	A	T	1	2	3	0	0	3	0	0
19	7608836	.	G	T	1	2	3	0	1	4	0	0
19	7630689	.	A	T	2	5	7	0	0	7	0	0
19	7631700	.	G	A	1	12	13	0	8	21	0	0
19	7631784	.	A	G	7	4	11	0	2	13	0	0
19	7631829	.	C	A	7	8	15	0	0	15	0	0
19	7631860	.	T	C	10	10	20	0	1	21	0	0
19	7632216	.	C	T	15	9	24	0	0	24	0	0
19	7632348	.	G	A	0	10	10	0	10	20	0	0
19	7632470	.	C	T	9	8	17	0	2	19	0	0
19	7632526	.	T	C	13	10	23	0	1	24	0	0
19	7632837	.	C	T	10	10	20	0	1	21	0	0
19	7761855	.	C	T	2	2	4	0	0	4	0	0
19	7773457	.	A	G	1	0	1	0	3	4	0	0
19	7773459	.	A	C	1	3	4	0	0	4	0	0
19	7775547	.	A	T	3	7	10	0	2	12	0	0
19	7775552	.	T	C	4	7	11	0	0	11	0	0
19	7775789	.	G	A	0	3	3	0	4	7	0	0
19	7784681	.	T	A	8	7	15	0	1	16	0	0
19	7784684	.	T	A	8	8	16	0	0	16	0	0
19	7785138	.	C	T	12	16	28	0	0	28	0	0
19	7794887	.	C	T	13	12	25	0	4	29	0	0
19	7794893	.	A	T	16	13	29	0	1	30	0	0
19	7796842	.	C	A	10	10	20	0	0	20	0	0
19	7796951	.	T	C	10	13	23	0	1	24	0	0
19	7796975	.	T	C	15	8	23	0	3	26	0	0
19	7796986	.	A	T	14	9	23	0	1	24	0	0
19	7797259	.	T	A	16	24	40	0	1	41	0	0
19	7797651	.	G	T	7	5	12	0	0	12	0	0
19	7799225	.	A	G	1	2	3	0	0	3	0	0
19	7799226	.	A	T	0	2	2	0	0	2	0	0
19	7802700	.	G	A	3	4	7	0	0	7	0	0
19	7803424	.	C	A	7	5	12	0	0	12	0	0
19	7803435	.	A	T	8	5	13	0	0	13	0	0
19	7803460	.	G	T	1	5	6	0	6	12	0	0
19	7804785	.	A	C	9	11	20	0	2	22	0	0
19	7804937	.	C	T	4	4	8	0	0	8	0	0
19	7820040	.	T	C	3	9	12	0	1	13	0	0
19	7820079	.	T	A	6	7	13	0	2	15	0	0
19	7820107	.	G	A	7	8	15	0	0	15	0	0
19	7820466	.	C	A	1	2	3	0	11	14	0	0
19	7823306	.	G	A	10	2	12	0	1	13	0	0
19	7823330	.	C	T	6	2	8	0	1	9	0	0
19	7825127	.	T	C	3	4	7	0	0	7	0	0
19	7825163	.	C	T	3	4	7	0	0	7	0	0
19	7825181	.	G	C	4	3	7	0	0	7	0	0
19	7825259	.	G	A	5	7	12	0	2	14	0	0
19	7825300	.	A	G	6	5	11	0	4	15	0	0
19	7827016	.	G	A	7	9	16	0	1	17	0	0
19	7827377	.	C	T	0	2	2	0	3	5	0	0
19	7827666	.	A	G	3	1	4	0	1	5	0	0
19	7827672	.	G	C	2	2	4	0	0	4	0	0
19	7837747	.	C	T	1	6	7	0	0	7	0	0
19	7837962	.	C	T	1	4	5	0	0	5	0	0
19	7837978	.	C	G	1	4	5	0	0	5	0	0
19	8315244	.	T	C	3	4	7	0	1	8	0	0
19	8315418	.	G	A	4	2	6	0	0	6	0	0
19	8336640	.	G	C	5	6	11	0	0	11	0	0
19	8336642	.	C	T	6	6	12	0	0	12	0	0
19	8336689	.	G	A	4	5	9	0	0	9	0	0
19	8338616	.	T	A	6	13	19	0	1	20	0	0
19	8338649	.	T	A	8	12	20	0	0	20	0	0
19	8338711	.	C	G	2	7	9	0	1	10	0	0
19	8339202	.	T	A	14	15	29	0	2	31	0	0
19	8339302	.	A	G	14	21	35	0	1	36	0	0
19	8482053	.	T	A	1	2	3	0	1	4	0	0
19	8496737	.	T	A	1	2	3	0	0	3	0	0
19	8501067	.	C	T	4	3	7	0	0	7	0	0
19	8501075	.	A	T	4	1	5	0	0	5	0	0
19	8501218	.	G	A	6	9	15	0	1	16	0	0
19	8501448	.	A	T	10	4	14	0	0	14	0	0
19	8501490	.	G	T	7	4	11	0	2	13	0	0
19	8501499	.	T	C	9	4	13	0	1	14	0	0
19	8501526	.	T	A	8	8	16	0	0	16	0	0
19	8501535	.	C	T	9	6	15	0	1	16	0	0
19	8501660	.	G	T	0	4	4	0	3	7	0	0
19	8501663	.	C	T	3	4	7	0	0	7	0	0
19	8501703	.	A	C	4	2	6	0	0	6	0	0
19	8501901	.	A	T	5	6	11	0	2	13	0	0
19	8501961	.	G	A	1	3	4	0	11	15	0	0
19	8501962	.	G	A	11	3	14	0	1	15	0	0
19	8502104	.	C	G	3	9	12	0	0	12	0	0
19	8502133	.	C	T	2	8	10	0	0	10	0	0
19	8502166	.	G	T	0	10	10	0	4	14	0	0
19	8502225	.	T	A	8	14	22	0	0	22	0	0
19	8502244	.	G	A	8	17	25	0	0	25	0	0
19	8534126	.	G	C	6	4	10	0	0	10	0	0
19	8534320	.	C	A	7	5	12	0	1	13	0	0
19	8534339	.	A	C	12	9	21	0	1	22	0	0
19	8534426	.	G	A	18	6	24	0	2	26	0	0
19	8534428	.	A	G	19	6	25	0	0	25	0	0
19	8582809	.	A	G	5	4	9	0	0	9	0	0
19	8583065	.	A	G	3	5	8	0	0	8	0	0
19	8681509	.	G	A	1	2	3	0	1	4	0	0
19	8747688	.	G	A	31	37	68	0	6	74	0	0
19	8817121	.	C	A	6	8	14	0	2	16	0	0
19	8817480	.	A	G	16	19	35	1	4	40	0	0
19	8817608	.	G	A	26	18	44	0	2	46	0	0
19	8822347	.	A	G	11	13	24	0	2	26	0	0
19	8824364	.	A	G	13	6	19	0	2	21	0	0
19	8831907	.	C	T	4	7	11	0	14	25	0	0
19	8836805	.	C	T	3	3	6	0	2	8	0	0
19	8880614	.	C	G	6	5	11	0	0	11	0	0
19	8894119	.	T	A	13	4	17	0	1	18	0	0
19	8894138	.	A	G	13	4	17	0	0	17	0	0
19	8894229	.	T	C	4	7	11	0	0	11	0	0
19	8894905	.	G	T	8	8	16	0	0	16	0	0
19	8895074	.	G	A	11	11	22	0	0	22	0	0
19	8895163	.	T	C	3	8	11	0	0	11	0	0
19	8895514	.	C	A	0	3	3	0	2	5	0	0
19	8898597	.	A	C	1	0	1	0	2	3	0	0
19	8928718	.	G	A	9	4	13	0	0	13	0	0
19	8928767	.	G	C	14	10	24	0	1	25	0	0
19	8929488	.	C	T	0	17	17	0	5	22	0	0
19	8929549	.	T	C	5	0	5	0	9	14	0	0
19	8929669	.	A	G	5	4	9	0	4	13	0	0
19	8929678	.	A	G	9	4	13	0	1	14	0	0
19	8929743	.	T	A	2	3	5	0	0	5	0	0
19	8930187	.	A	G	8	4	12	0	0	12	0	0
19	8937377	.	T	C	3	2	5	0	0	5	0	0
19	8958892	.	A	G	9	20	29	0	0	29	0	0
19	8962835	.	C	T	10	8	18	0	0	18	0	0
19	8962840	.	A	C	8	0	8	0	8	16	0	0
19	8997627	.	T	C	3	5	8	0	0	8	0	0
19	9000665	.	C	T	16	26	42	0	2	44	0	0
19	9000674	.	T	C	16	26	42	0	3	45	0	0
19	9000718	.	G	A	1	24	25	0	14	39	0	0
19	9000838	.	C	T	15	20	35	0	2	37	0	0
19	9000855	.	T	A	16	21	37	0	2	39	0	0
19	9000907	.	A	G	14	0	14	0	19	33	0	0
19	9001100	.	C	T	9	14	23	0	1	24	0	0
19	9001180	.	A	G	16	14	30	0	0	30	0	0
19	9001246	.	C	T	12	13	25	0	0	25	0	0
19	9001317	.	G	A	17	14	31	0	6	37	0	0
19	9043096	.	T	C	1	2	3	0	0	3	0	0
19	9044331	.	C	T	1	2	3	0	0	3	0	0
19	9050609	.	C	G	7	5	12	0	0	12	0	0
19	9050631	.	T	C	5	4	9	0	1	10	0	0
19	9050737	.	G	C	3	3	6	0	0	6	0	0
19	9050745	.	A	G	3	0	3	0	1	4	0	0
19	9064759	.	T	C	8	5	13	0	0	13	0	0
19	9064777	.	C	A	6	5	11	0	1	12	0	0
19	9064822	.	A	G	5	8	13	0	1	14	0	0
19	9064853	.	T	C	5	8	13	0	0	13	0	0
19	9064885	.	G	A	6	3	9	0	2	11	0	0
19	9067211	.	G	A	5	8	13	0	1	14	0	0
19	9070546	.	T	G	13	0	13	0	6	19	0	0
19	9072451	.	C	T	5	5	10	0	1	11	0	0
19	9078840	.	A	T	11	13	24	0	2	26	0	0
19	9079084	.	T	C	9	12	21	0	0	21	0	0
19	9081228	.	T	C	14	10	24	0	0	24	0	0
19	9081272	.	C	T	10	11	21	2	1	24	0	0
19	9084630	.	G	A	2	17	19	0	12	31	0	0
19	9084634	.	A	G	11	1	12	0	17	29	0	0
19	9084797	.	A	T	17	13	30	0	0	30	0	0
19	9084848	.	G	A	0	14	14	0	19	33	0	0
19	9084859	.	G	T	19	14	33	0	1	34	0	0
19	9085835	.	A	G	19	15	34	0	2	36	0	0
19	9086132	.	C	A	21	23	44	0	1	45	0	0
19	9086416	.	T	A	8	4	12	0	2	14	0	0
19	9117731	.	G	T	4	2	6	0	0	6	0	0
19	9125062	.	G	A	6	2	8	0	0	8	0	0
19	9134017	.	G	A	0	3	3	0	6	9	0	0
19	9135065	.	A	G	8	0	8	0	8	16	0	0
19	9135754	.	A	T	8	7	15	0	1	16	0	0
19	9138695	.	A	G	9	0	9	0	9	18	0	0
19	9138850	.	C	A	6	10	16	0	0	16	0	0
19	9140675	.	A	T	10	13	23	1	2	26	0	0
19	9140750	.	T	C	16	9	25	0	2	27	0	0
19	9140950	.	T	C	10	12	22	0	0	22	0	0
19	9144175	.	G	A	1	9	10	0	6	16	0	0
19	9144228	.	T	G	6	4	10	0	0	10	0	0
19	9150074	.	T	C	3	3	6	0	2	8	0	0
19	9152720	.	C	A	10	14	24	0	0	24	0	0
19	9152841	.	A	T	4	6	10	0	3	13	0	0
19	9155603	.	A	G	6	0	6	0	7	13	0	0
19	9155691	.	C	T	8	8	16	0	1	17	0	0
19	9158481	.	A	T	5	8	13	0	0	13	0	0
19	9161621	.	C	T	20	25	45	0	2	47	0	0
19	9161631	.	T	G	17	29	46	0	1	47	0	0
19	9161824	.	T	C	14	11	25	0	3	28	0	0
19	9168699	.	T	C	27	12	39	0	4	43	0	0
19	9169162	.	G	C	11	13	24	0	2	26	0	0
19	9216201	.	T	A	6	4	10	0	0	10	0	0
19	9216221	.	A	C	6	5	11	0	0	11	0	0
19	9216367	.	G	A	1	6	7	0	0	7	0	0
19	9217143	.	C	T	9	8	17	0	1	18	0	0
19	9218405	.	G	A	4	12	16	0	0	16	0	0
19	9220849	.	T	C	7	14	21	0	0	21	0	0
19	9225567	.	C	T	17	17	34	0	4	38	0	0
19	9228326	.	A	T	20	19	39	0	1	40	0	0
19	9228378	.	A	G	27	0	27	0	7	34	0	0
19	9228380	.	C	T	27	7	34	0	1	35	0	0
19	9265048	.	T	C	3	2	5	0	0	5	0	0
19	9266162	.	G	A	1	3	4	0	0	4	0	0
19	9266749	.	T	C	1	4	5	0	0	5	0	0
19	9266793	.	A	C	2	2	4	0	0	4	0	0
19	9270836	.	T	C	6	4	10	0	0	10	0	0
19	9273997	.	A	G	9	0	9	0	6	15	0	0
19	9274428	.	T	A	10	7	17	0	1	18	0	0
19	9274574	.	C	T	3	2	5	0	0	5	0	0
19	9274705	.	C	T	3	11	14	0	1	15	0	0
19	9274891	.	G	T	12	12	24	0	0	24	0	0
19	9685695	.	A	G	25	25	50	0	2	52	0	0
19	9685714	.	A	C	20	26	46	0	3	49	0	0
19	9686078	.	C	A	8	4	12	0	1	13	0	0
19	9686099	.	G	T	9	5	14	0	1	15	0	0
19	9686160	.	T	C	10	10	20	0	0	20	0	0
19	9686199	.	G	T	14	8	22	0	1	23	0	0
19	9686474	.	G	A	13	10	23	0	0	23	0	0
19	9686503	.	A	G	11	8	19	0	1	20	0	0
19	9686548	.	T	A	6	6	12	0	2	14	0	0
19	9686575	.	T	A	5	9	14	0	1	15	0	0
19	9686616	.	A	T	10	7	17	0	0	17	0	0
19	9686646	.	C	T	10	3	13	0	0	13	0	0
19	9687033	.	C	T	10	9	19	0	3	22	0	0
19	9687073	.	G	A	13	10	23	0	2	25	0	0
19	9687146	.	T	C	17	11	28	0	0	28	0	0
19	9813608	.	G	A	25	19	44	0	1	45	0	0
19	9813905	.	A	G	7	8	15	0	0	15	0	0
19	9813942	.	A	G	4	11	15	0	0	15	0	0
19	9822610	.	G	A	9	6	15	0	0	15	0	0
19	9840924	.	C	T	14	13	27	0	0	27	0	0
19	9841006	.	A	G	9	15	24	0	1	25	0	0
19	9841035	.	G	A	6	12	18	0	1	19	0	0
19	9841054	.	T	C	4	0	4	0	12	16	0	0
19	9841523	.	G	A	5	11	16	0	0	16	0	0
19	9841728	.	T	C	3	4	7	0	0	7	0	0
19	9841825	.	C	T	9	6	15	0	2	17	0	0
19	9841902	.	A	T	9	6	15	0	0	15	0	0
19	9842252	.	T	C	8	10	18	0	1	19	0	0
19	9842306	.	A	G	9	8	17	0	2	19	0	0
19	9910842	.	G	A	8	15	23	0	0	23	0	0
19	9911419	.	G	A	3	3	6	0	0	6	0	0
19	9911855	.	G	A	6	2	8	0	0	8	0	0
19	9911863	.	A	T	4	2	6	0	0	6	0	0
19	9912063	.	C	T	8	5	13	0	0	13	0	0
19	9912756	.	C	A	4	5	9	0	0	9	0	0
19	9912807	.	C	T	1	4	5	0	0	5	0	0
19	9912824	.	A	T	3	2	5	0	0	5	0	0
19	9912946	.	A	T	1	4	5	0	0	5	0	0
19	9914845	.	G	A	1	3	4	0	0	4	0	0
19	9914866	.	T	A	1	2	3	0	0	3	0	0
19	10177290	.	G	A	9	5	14	0	0	14	0	0
19	10177397	.	T	G	12	11	23	0	0	23	0	0
19	10177951	.	A	G	15	13	28	0	0	28	0	0
19	10178339	.	T	A	10	9	19	0	1	20	0	0
19	10180561	.	C	T	0	4	4	0	3	7	0	0
19	10196070	.	T	A	2	1	3	0	0	5	2	0
19	10196113	.	T	C	4	2	6	0	1	7	0	0
19	10201566	.	T	G	9	13	22	0	1	23	0	0
19	10201719	.	A	G	19	17	36	0	1	37	0	0
19	10202598	.	T	C	9	0	9	0	10	19	0	0
19	10202682	.	T	C	5	0	5	0	11	16	0	0
19	10202756	.	T	A	6	5	11	0	0	11	0	0
19	10203024	.	C	A	1	7	8	0	5	13	0	0
19	10204407	.	G	C	1	3	4	0	0	4	0	0
19	10217742	.	A	G	6	11	17	0	4	21	0	0
19	10217844	.	T	A	8	11	19	0	3	22	0	0
19	10218136	.	T	A	17	15	32	0	0	32	0	0
19	10218807	.	C	T	3	9	12	0	5	17	0	0
19	10219001	.	C	T	11	7	18	0	1	19	0	0
19	10219051	.	T	A	6	10	16	0	2	18	0	0
19	10219186	.	C	A	17	12	29	0	1	30	0	0
19	10219209	.	T	G	15	9	24	0	0	24	0	0
19	10219387	.	T	C	9	12	21	0	1	22	0	0
19	10219542	.	G	A	15	16	31	0	0	31	0	0
19	10219547	.	T	C	14	14	28	0	2	30	0	0
19	10219749	.	C	T	7	8	15	0	1	16	0	0
19	10220013	.	G	A	15	16	31	0	0	31	0	0
19	10220064	.	A	T	18	13	31	1	2	35	1	0
19	10220421	.	A	G	14	9	23	0	1	24	0	0
19	10220448	.	C	G	1	13	14	0	11	25	0	0
19	10220651	.	T	C	22	1	23	0	18	41	0	0
19	10220790	.	C	T	11	15	26	0	1	27	0	0
19	10237365	.	C	A	0	2	2	0	2	4	0	0
19	10252679	.	A	T	4	2	6	0	1	7	0	0
19	10253058	.	A	T	3	7	10	0	1	11	0	0
19	10253316	.	T	C	8	5	13	0	1	14	0	0
19	10253516	.	T	A	3	4	7	0	0	7	0	0
19	10253517	.	C	A	2	4	6	0	1	7	0	0
19	10253759	.	A	G	2	4	6	0	0	6	0	0
19	10253915	.	T	C	3	6	9	0	0	9	0	0
19	10254192	.	C	T	4	2	6	0	1	7	0	0
19	10254196	.	G	A	3	2	5	0	0	5	0	0
19	10254772	.	C	T	3	2	5	0	1	6	0	0
19	10264727	.	T	G	2	4	6	0	0	6	0	0
19	10299174	.	A	C	14	11	25	0	2	27	0	0
19	10299383	.	G	A	18	20	38	0	1	39	0	0
19	10299579	.	C	A	14	9	23	0	0	23	0	0
19	10299593	.	A	G	10	4	14	0	1	15	0	0
19	10299706	.	C	T	1	14	15	0	17	32	0	0
19	10301236	.	T	C	18	11	29	0	1	30	0	0
19	10376610	.	A	C	21	19	40	0	1	41	0	0
19	10377097	.	C	T	12	36	48	1	1	50	0	0
19	10377534	.	G	T	7	12	19	0	1	20	0	0
19	10377633	.	A	G	6	12	18	0	1	19	0	0
19	10377815	.	A	C	14	14	28	0	0	28	0	0
19	10377892	.	A	C	14	17	31	1	0	32	0	0
19	10377911	.	A	T	13	15	28	1	1	30	0	0
19	10378192	.	G	A	12	17	29	0	0	29	0	0
19	10378457	.	A	T	11	10	21	0	2	23	0	0
19	10378544	.	C	T	14	6	20	0	1	21	0	0
19	10378618	.	C	T	4	7	11	0	3	14	0	0
19	10378848	.	C	T	12	10	22	0	2	24	0	0
19	10378868	.	T	C	8	0	8	0	9	17	0	0
19	10378889	.	C	T	8	8	16	0	1	17	0	0
19	10378959	.	C	A	16	7	23	0	1	24	0	0
19	10379183	.	C	A	7	10	17	0	1	18	0	0
19	10379192	.	C	T	7	10	17	0	2	19	0	0
19	10379314	.	C	T	1	2	3	0	10	13	0	0
19	10379321	.	C	T	10	3	13	0	0	13	0	0
19	10379369	.	C	T	5	7	12	0	0	12	0	0
19	10379475	.	A	G	11	10	21	0	0	21	0	0
19	10379555	.	T	G	4	6	10	0	0	10	0	0
19	10379575	.	A	G	4	6	10	0	0	10	0	0
19	10379821	.	T	A	8	11	19	0	1	20	0	0
19	10379833	.	T	G	10	12	22	0	1	23	0	0
19	10379873	.	A	G	3	11	14	0	1	15	0	0
19	10379965	.	T	C	7	3	10	0	1	11	0	0
19	10383100	.	A	G	3	4	7	0	0	7	0	0
19	10383112	.	G	T	3	3	6	0	2	8	0	0
19	10386619	.	C	T	5	6	11	0	0	11	0	0
19	10407312	.	C	T	19	20	39	0	1	40	0	0
19	10407546	.	A	T	23	27	50	0	0	50	0	0
19	10407732	.	T	A	33	30	63	0	3	66	0	0
19	10407767	.	G	T	24	31	55	0	7	62	0	0
19	10561001	.	A	G	5	2	7	0	0	7	0	0
19	10562737	.	T	C	6	6	12	0	0	12	0	0
19	10569122	.	T	C	3	5	8	0	2	10	0	0
19	10575315	.	T	C	7	3	10	0	0	10	0	0
19	10575318	.	G	T	6	3	9	0	1	10	0	0
19	10575565	.	G	C	0	8	8	0	3	11	0	0
19	10575824	.	T	G	4	8	12	0	0	12	0	0
19	10576138	.	G	T	3	1	4	0	1	5	0	0
19	10576338	.	G	A	0	2	2	0	1	3	0	0
19	10576520	.	T	C	5	2	7	0	1	8	0	0
19	10576909	.	G	A	14	7	21	0	1	22	0	0
19	10576970	.	A	T	10	14	24	0	0	24	0	0
19	10577011	.	T	G	14	0	14	0	15	29	0	0
19	10577194	.	T	A	5	7	12	0	1	13	0	0
19	10577253	.	T	A	4	10	14	0	1	15	0	0
19	10649711	.	T	A	4	4	8	0	0	8	0	0
19	10649722	.	T	C	4	3	7	0	2	9	0	0
19	10649830	.	G	T	6	6	12	0	0	12	0	0
19	10653644	.	C	T	2	2	4	0	0	4	0	0
19	10841477	.	G	T	7	6	13	0	1	14	0	0
19	10867611	.	G	T	0	2	2	0	1	3	0	0
19	10868103	.	T	C	1	3	4	0	0	4	0	0
19	10870305	.	A	G	6	0	6	0	4	10	0	0
19	10870361	.	C	T	5	6	11	0	0	11	0	0
19	10870602	.	G	A	3	3	6	0	0	6	0	0
19	10870737	.	A	G	1	4	5	0	0	5	0	0
19	10870956	.	A	G	4	3	7	1	0	8	0	0
19	10871235	.	G	A	6	5	11	0	1	12	0	0
19	10871259	.	A	T	8	4	12	0	0	12	0	0
19	10871719	.	A	G	9	5	14	0	2	16	0	0
19	10871803	.	C	T	0	11	11	0	11	22	0	0
19	10871823	.	A	G	15	13	28	0	2	30	0	0
19	10872397	.	C	T	15	12	27	0	6	33	0	0
19	10875854	.	A	G	11	9	20	0	2	22	0	0
19	12188083	.	G	T	20	13	33	0	2	35	0	0
19	12188207	.	A	G	19	14	33	0	1	34	0	0
19	12188243	.	A	G	23	12	35	0	1	36	0	0
19	12188249	.	A	G	24	14	38	0	1	39	0	0
19	12193578	.	G	C	11	16	27	0	0	27	0	0
19	12206504	.	T	G	15	10	25	0	1	26	0	0
19	12211809	.	T	C	16	8	24	0	1	25	0	0
19	12297178	.	C	T	3	3	6	0	0	6	0	0
19	12300840	.	G	A	1	3	4	0	1	5	0	0
19	12356418	.	G	A	0	6	6	0	5	11	0	0
19	12356511	.	C	A	5	5	10	0	0	10	0	0
19	12363275	.	C	T	12	11	23	1	1	25	0	0
19	12380004	.	A	T	12	8	20	0	1	21	0	0
19	12380029	.	A	T	12	10	22	0	1	23	0	0
19	12383623	.	G	A	6	5	11	0	0	11	0	0
19	12385998	.	A	G	3	5	8	0	0	8	0	0
19	12413422	.	C	A	3	3	6	0	1	7	0	0
19	12420188	.	G	A	0	7	7	0	5	12	0	0
19	12424420	.	A	T	5	4	9	0	0	9	0	0
19	12427675	.	G	A	6	10	16	0	0	16	0	0
19	12428454	.	A	G	1	2	3	0	0	3	0	0
19	12428634	.	A	G	8	8	16	0	1	17	0	0
19	12428646	.	A	G	9	9	18	0	1	19	0	0
19	12428741	.	T	C	10	14	24	0	0	24	0	0
19	12428754	.	A	G	12	12	24	0	1	25	0	0
19	12631448	.	C	T	1	5	6	0	1	7	0	0
19	12645583	.	G	T	3	3	6	0	1	7	0	0
19	12645661	.	C	T	6	2	8	0	1	9	0	0
19	12655554	.	G	A	0	2	2	0	2	4	0	0
19	12802956	.	C	T	3	3	6	0	0	6	0	0
19	12803218	.	A	G	9	2	11	0	1	12	0	0
19	12937143	.	A	G	6	11	17	0	0	17	0	0
19	12937176	.	G	C	6	12	18	0	1	19	0	0
19	12937249	.	A	G	25	21	46	0	0	46	0	0
19	12937364	.	G	A	15	22	37	0	0	37	0	0
19	12937444	.	T	C	21	0	21	0	20	41	0	0
19	12937542	.	C	T	15	14	29	0	4	33	0	0
19	12937574	.	A	G	14	15	29	0	2	31	0	0
19	12937785	.	G	A	6	4	10	0	0	10	0	0
19	12938160	.	G	T	5	2	7	0	0	7	0	0
19	12938802	.	T	C	2	2	4	0	0	4	0	0
19	12939223	.	G	A	4	2	6	0	0	6	0	0
19	12939298	.	A	C	3	4	7	0	0	7	0	0
19	12939317	.	A	G	6	2	8	0	3	11	0	0
19	12939380	.	T	C	5	3	8	0	0	8	0	0
19	12939385	.	G	A	6	3	9	0	0	9	0	0
19	12964728	.	C	T	3	2	5	0	1	6	0	0
19	13121476	.	C	T	4	2	6	0	1	7	0	0
19	13184781	.	A	T	13	7	20	0	0	20	0	0
19	13185127	.	G	A	17	9	26	0	5	31	0	0
19	13185378	.	C	A	28	11	39	0	3	42	0	0
19	13186340	.	C	T	18	23	41	1	1	43	0	0
19	13186357	.	A	G	14	20	34	1	5	40	0	0
19	13186673	.	A	G	22	14	36	0	1	37	0	0
19	13193382	.	T	A	8	8	16	0	0	17	1	0
19	13193894	.	G	A	1	2	3	0	0	3	0	0
19	13194073	.	T	A	2	12	14	0	0	14	0	0
19	13194133	.	C	T	5	9	14	0	0	14	0	0
19	13194309	.	T	G	5	6	11	0	0	11	0	0
19	13194522	.	T	C	4	0	4	0	6	10	0	0
19	13194812	.	T	A	3	4	7	0	1	8	0	0
19	13194902	.	G	T	7	5	12	0	0	12	0	0
19	13194930	.	T	C	7	3	10	0	0	10	0	0
19	13194974	.	C	G	2	2	4	0	0	4	0	0
19	13395156	.	T	A	1	2	3	0	0	3	0	0
19	13395347	.	G	A	0	6	6	0	4	10	0	0
19	13395737	.	A	G	9	4	13	0	2	15	0	0
19	13395819	.	T	C	9	3	12	0	1	13	0	0
19	13395959	.	G	T	6	9	15	0	0	15	0	0
19	13395962	.	T	G	6	7	13	0	2	15	0	0
19	13396252	.	C	T	3	7	10	0	1	11	0	0
19	13396481	.	T	C	16	12	28	0	0	28	0	0
19	13396486	.	G	C	13	12	25	0	2	27	0	0
19	13396619	.	C	A	10	7	17	0	0	17	0	0
19	13396702	.	C	G	12	4	16	0	0	16	0	0
19	13397219	.	A	G	2	5	7	0	3	10	0	0
19	13413068	.	A	T	3	2	5	0	0	5	0	0
19	13413387	.	T	C	1	4	5	0	0	5	0	0
19	13413432	.	C	A	2	4	6	0	2	8	0	0
19	13413445	.	A	G	2	6	8	0	0	8	0	0
19	13413547	.	A	G	1	3	4	0	0	4	0	0
19	13413683	.	A	G	1	6	7	0	1	8	0	0
19	13413727	.	G	A	1	2	3	0	0	3	0	0
19	13414896	.	C	T	4	4	8	0	0	8	0	0
19	13415169	.	C	T	12	15	27	0	1	28	0	0
19	13419582	.	T	C	20	19	39	0	0	39	0	0
19	13419696	.	A	G	23	0	23	0	22	45	0	0
19	13419948	.	A	C	6	7	13	0	5	18	0	0
19	13419986	.	C	G	9	17	26	0	1	27	0	0
19	13425618	.	T	C	7	6	13	0	3	16	0	0
19	13425707	.	A	G	3	5	8	0	0	8	0	0
19	13426090	.	A	T	2	4	6	0	0	6	0	0
19	13426863	.	T	G	8	0	8	0	5	13	0	0
19	13426961	.	T	C	4	4	8	0	1	9	0	0
19	13639492	.	T	A	5	8	13	0	0	13	0	0
19	13698141	.	G	A	4	3	7	0	1	8	0	0
19	13698643	.	G	A	9	4	13	0	1	14	0	0
19	13698685	.	T	C	7	8	15	0	1	16	0	0
19	13714963	.	A	G	13	8	21	0	1	22	0	0
19	13724014	.	T	C	24	32	56	0	6	62	0	0
19	13724320	.	T	G	13	9	22	0	2	24	0	0
19	13733583	.	C	G	23	19	42	0	0	42	0	0
19	13905442	.	T	A	10	15	25	0	1	26	0	0
19	13905469	.	T	G	12	9	21	0	0	21	0	0
19	13915686	.	G	T	5	5	10	0	1	11	0	0
19	13919292	.	A	T	1	4	5	0	1	6	0	0
19	13939827	.	T	C	18	4	22	0	1	23	0	0
19	13939839	.	G	C	19	10	29	0	0	29	0	0
19	13939883	.	C	G	16	24	40	0	0	40	0	0
19	13940106	.	A	G	15	20	35	0	1	36	0	0
19	13940123	.	A	T	13	16	29	0	1	30	0	0
19	13940168	.	G	A	14	25	39	0	0	39	0	0
19	13940227	.	G	T	20	20	40	0	2	42	0	0
19	13940423	.	G	T	15	19	34	0	1	35	0	0
19	13940500	.	C	T	13	15	28	0	1	29	0	0
19	13940614	.	T	C	9	11	20	0	0	20	0	0
19	13940728	.	A	G	2	3	5	0	0	5	0	0
19	13940911	.	T	C	0	1	1	0	4	5	0	0
19	13940936	.	C	A	8	4	12	0	2	14	0	0
19	13941161	.	C	T	19	12	31	0	3	34	0	0
19	13941285	.	T	C	8	15	23	0	3	26	0	0
19	13941311	.	C	T	12	12	24	0	0	24	0	0
19	13941403	.	T	A	6	7	13	0	2	15	0	0
19	13941442	.	T	C	5	11	16	0	0	17	1	0
19	13941448	.	A	G	9	11	20	0	1	21	0	0
19	13941505	.	G	C	20	10	30	1	0	31	0	0
19	13941526	.	G	T	21	6	27	1	1	29	0	0
19	13941667	.	T	A	13	21	34	0	1	35	0	0
19	13950183	.	T	C	4	3	7	0	1	8	0	0
19	14035672	.	G	A	2	4	6	0	0	6	0	0
19	14165408	.	G	A	1	9	10	0	9	19	0	0
19	14169238	.	T	A	9	17	26	0	0	26	0	0
19	14434077	.	A	G	6	2	8	0	1	9	0	0
19	14434078	.	G	A	6	3	9	0	0	9	0	0
19	14434441	.	A	T	4	5	9	0	0	9	0	0
19	14435968	.	T	C	12	11	23	0	1	24	0	0
19	14436033	.	A	T	2	10	12	0	0	12	0	0
19	14436060	.	C	T	7	2	9	0	0	9	0	0
19	15142926	.	C	T	5	3	8	0	1	9	0	0
19	15142936	.	G	A	4	4	8	0	0	8	0	0
19	15308389	.	G	T	6	3	9	0	1	10	0	0
19	15331663	.	T	C	4	2	6	0	0	6	0	0
19	15331686	.	T	C	3	3	6	0	0	6	0	0
19	15331699	.	C	T	0	2	2	0	5	7	0	0
19	15331805	.	C	A	2	2	4	0	0	4	0	0
19	15331970	.	T	C	1	0	1	0	3	4	0	0
19	15331978	.	G	A	1	3	4	0	0	4	0	0
19	15411142	.	G	A	1	2	3	0	0	3	0	0
19	15510543	.	T	C	1	2	3	0	0	3	0	0
19	15532386	.	G	C	2	2	4	0	0	4	0	0
19	15532391	.	C	T	3	2	5	0	0	5	0	0
19	15618813	.	C	T	2	3	5	0	0	5	0	0
19	15618951	.	G	A	5	2	7	0	0	7	0	0
19	15619503	.	C	T	3	4	7	0	0	7	0	0
19	15619584	.	A	G	3	9	12	0	0	12	0	0
19	15619675	.	A	G	4	0	4	0	10	14	0	0
19	15851707	.	C	A	11	8	19	0	2	21	0	0
19	15851710	.	G	A	9	12	21	0	0	21	0	0
19	15851777	.	G	A	9	13	22	0	0	22	0	0
19	15851890	.	C	T	8	9	17	0	1	18	0	0
19	15852389	.	T	A	12	5	17	0	2	19	0	0
19	15852965	.	C	T	0	3	3	0	6	9	0	0
19	15853008	.	C	T	1	6	7	0	5	12	0	0
19	15853153	.	C	T	6	6	12	0	0	12	0	0
19	15853275	.	A	G	6	8	14	0	1	15	0	0
19	15855335	.	A	T	4	2	6	0	0	6	0	0
19	16022671	.	G	A	2	3	5	0	0	5	0	0
19	16026881	.	G	A	8	3	11	0	0	11	0	0
19	16026907	.	G	T	0	4	4	0	6	10	0	0
19	16026993	.	G	A	1	3	4	0	1	5	0	0
19	16027319	.	A	T	3	4	7	0	0	7	0	0
19	16027334	.	G	A	5	4	9	0	0	9	0	0
19	16027503	.	T	A	5	3	8	0	0	8	0	0
19	16027840	.	C	A	2	5	7	0	0	7	0	0
19	16027849	.	G	A	2	5	7	0	0	7	0	0
19	16061860	.	G	A	3	2	5	0	0	5	0	0
19	16061892	.	T	C	2	4	6	0	0	6	0	0
19	16070475	.	A	G	2	4	6	0	0	6	0	0
19	16077033	.	C	T	1	2	3	0	0	3	0	0
19	16082756	.	G	A	4	4	8	0	1	9	0	0
19	16085862	.	A	T	4	5	9	0	1	10	0	0
19	16086025	.	T	A	10	7	17	0	2	19	0	0
19	16086937	.	G	A	8	6	14	0	0	14	0	0
19	16086957	.	T	C	8	7	15	0	1	16	0	0
19	16087201	.	T	C	6	5	11	0	0	11	0	0
19	16625154	.	G	T	4	3	7	0	0	7	0	0
19	16629317	.	A	G	2	4	6	0	0	6	0	0
19	16638661	.	C	T	7	10	17	0	0	17	0	0
19	16638786	.	C	T	9	7	16	0	1	17	0	0
19	16638906	.	C	G	5	4	9	0	0	9	0	0
19	16651469	.	T	C	15	8	23	0	0	23	0	0
19	16653867	.	T	C	8	9	17	0	2	19	0	0
19	16653977	.	T	C	10	10	20	0	1	21	0	0
19	16653998	.	T	C	7	9	16	0	1	17	0	0
19	16654012	.	T	C	9	11	20	0	1	21	0	0
19	16654277	.	G	A	0	14	14	0	8	22	0	0
19	16654640	.	A	G	21	18	39	0	0	39	0	0
19	17208187	.	G	A	2	2	4	0	1	5	0	0
19	17276921	.	A	T	16	6	22	0	0	22	0	0
19	17292898	.	T	A	7	2	9	0	0	10	1	0
19	17292905	.	G	A	6	4	10	0	1	11	0	0
19	17292936	.	C	T	1	5	6	0	0	6	0	0
19	17295656	.	G	A	14	7	21	0	0	21	0	0
19	17295674	.	C	T	12	5	17	0	0	17	0	0
19	17300130	.	G	A	7	4	11	0	0	11	0	0
19	17301292	.	A	G	7	7	14	0	1	15	0	0
19	17302363	.	T	A	8	3	11	0	1	12	0	0
19	17304888	.	A	G	2	4	6	0	0	6	0	0
19	17304891	.	T	C	2	3	5	0	0	5	0	0
19	17377786	.	T	G	4	3	7	0	0	7	0	0
19	17378142	.	G	A	4	3	7	0	0	7	0	0
19	17378361	.	C	T	3	3	6	0	1	7	0	0
19	17386556	.	G	T	28	27	55	0	2	57	0	0
19	17393069	.	T	C	31	27	58	0	3	61	0	0
19	17400653	.	G	C	1	2	3	0	0	3	0	0
19	17404237	.	C	T	13	8	21	0	2	23	0	0
19	17405304	.	C	T	26	24	50	0	1	51	0	0
19	17405364	.	C	T	27	19	46	0	3	49	0	0
19	17406014	.	A	T	21	23	44	0	1	45	0	0
19	17406081	.	A	C	19	19	38	0	4	42	0	0
19	17406082	.	G	A	20	21	41	0	1	42	0	0
19	17406271	.	T	G	15	14	29	0	1	30	0	0
19	17406656	.	C	G	20	1	21	0	32	53	0	0
19	17406770	.	T	G	37	20	57	0	0	57	0	0
19	17406918	.	T	C	21	17	38	0	3	41	0	0
19	17514860	.	T	A	16	15	31	0	4	35	0	0
19	17514897	.	T	C	20	0	20	0	22	42	0	0
19	17515048	.	T	C	14	6	20	0	0	20	0	0
19	17515142	.	T	A	4	3	7	0	0	7	0	0
19	17515297	.	T	A	5	3	8	0	1	9	0	0
19	17515347	.	G	C	13	6	19	0	1	20	0	0
19	17516039	.	G	A	5	4	9	0	0	9	0	0
19	17516070	.	A	G	8	3	11	0	1	12	0	0
19	17516103	.	G	C	6	0	6	0	6	12	0	0
19	17516130	.	T	C	8	14	22	0	0	22	0	0
19	17516162	.	A	T	10	14	24	0	1	25	0	0
19	17516195	.	T	C	9	0	9	0	17	26	0	0
19	17516211	.	G	T	12	12	24	1	0	25	0	0
19	17516330	.	A	G	11	15	26	0	3	29	0	0
19	17516390	.	A	G	16	19	35	0	2	37	0	0
19	17516482	.	A	C	27	4	31	0	4	35	0	0
19	17516489	.	T	A	16	9	25	0	3	28	0	0
19	17516920	.	A	G	4	6	10	0	0	10	0	0
19	17516922	.	A	G	4	6	10	0	0	10	0	0
19	17516962	.	T	C	3	2	5	0	0	5	0	0
19	17516997	.	A	G	4	2	6	0	1	7	0	0
19	17517241	.	T	G	5	2	7	0	0	7	0	0
19	17517768	.	T	G	11	5	16	0	0	16	0	0
19	17517816	.	T	C	9	12	21	0	0	21	0	0
19	17517821	.	A	G	9	12	21	0	0	21	0	0
19	17517912	.	T	G	6	7	13	0	3	16	0	0
19	17517928	.	C	G	8	6	14	0	1	15	0	0
19	17518071	.	C	T	5	2	7	0	0	7	0	0
19	17518179	.	A	T	5	4	9	0	1	10	0	0
19	17518330	.	T	C	3	3	6	0	0	6	0	0
19	17518351	.	C	A	0	3	3	0	3	6	0	0
19	17518366	.	A	T	4	2	6	0	1	7	0	0
19	17518489	.	T	A	8	3	11	0	1	12	0	0
19	17518531	.	T	G	8	4	12	2	0	14	0	0
19	17521027	.	A	T	5	10	15	0	1	16	0	0
19	17722355	.	T	C	2	4	6	0	1	7	0	0
19	17733001	.	G	A	4	3	7	0	0	7	0	0
19	17834633	.	T	A	3	4	7	0	0	7	0	0
19	17834671	.	T	A	2	5	7	0	0	7	0	0
19	17916790	.	A	G	2	1	3	0	1	4	0	0
19	17972837	.	C	T	0	2	2	0	1	3	0	0
19	18143837	.	C	T	7	6	13	2	0	15	0	0
19	18638347	.	T	G	5	1	6	0	0	6	0	0
19	18747247	.	G	A	2	2	4	0	0	4	0	0
19	18990243	.	G	A	20	8	28	0	3	32	1	0
19	19200483	.	A	G	6	3	9	0	0	9	0	0
19	19201301	.	T	G	12	10	22	0	0	22	0	0
19	19213871	.	C	T	7	6	13	0	0	13	0	0
19	19214295	.	T	G	6	9	15	0	2	17	0	0
19	19214316	.	T	A	11	9	20	0	0	20	0	0
19	19217233	.	T	C	1	2	3	0	0	3	0	0
19	19269659	.	T	C	4	2	6	0	0	6	0	0
19	19270468	.	C	T	5	5	10	0	0	10	0	0
19	19270623	.	T	C	2	3	5	0	0	5	0	0
19	19287981	.	G	A	22	23	45	0	2	47	0	0
19	19319164	.	T	C	17	13	30	0	0	30	0	0
19	19319229	.	C	T	16	15	31	0	1	32	0	0
19	19319315	.	G	A	9	14	23	0	1	24	0	0
19	19319337	.	A	G	15	9	24	0	1	25	0	0
19	19319556	.	T	C	3	0	3	0	4	7	0	0
19	19319626	.	A	C	6	5	11	0	0	11	0	0
19	19319692	.	C	T	1	5	6	0	7	13	0	0
19	19319724	.	A	G	6	7	13	0	1	14	0	0
19	19319814	.	T	A	6	13	19	0	3	22	0	0
19	19319852	.	T	A	6	7	13	0	1	14	0	0
19	19319864	.	T	A	7	7	14	0	0	14	0	0
19	19338885	.	T	A	3	7	10	0	0	10	0	0
19	19339071	.	C	G	4	2	6	0	1	7	0	0
19	19339232	.	C	A	0	3	3	0	5	8	0	0
19	19339275	.	A	C	1	2	3	0	0	3	0	0
19	19342328	.	C	T	2	2	4	0	0	4	0	0
19	19353790	.	G	A	3	2	5	0	0	5	0	0
19	19418066	.	G	A	6	6	12	0	1	13	0	0
19	19432598	.	C	T	8	11	19	0	0	19	0	0
19	19549131	.	A	G	1	4	5	0	0	5	0	0
19	19549921	.	T	C	5	9	14	0	1	15	0	0
19	19550141	.	T	G	7	5	12	0	0	12	0	0
19	19550184	.	G	T	9	8	17	0	1	18	0	0
19	19550381	.	T	G	9	10	19	0	1	20	0	0
19	19550601	.	C	A	16	6	22	0	0	22	0	0
19	19551819	.	G	A	5	6	11	0	0	11	0	0
19	19551828	.	A	G	6	5	11	0	0	11	0	0
19	19652494	.	G	A	1	3	4	0	3	7	0	0
19	19657179	.	C	A	1	2	3	0	0	3	0	0
19	19657198	.	C	T	1	2	3	0	0	3	0	0
19	19769016	.	C	A	6	2	8	0	0	8	0	0
19	20112056	.	G	C	25	31	56	0	4	60	0	0
19	20113526	.	G	A	26	25	51	0	1	52	0	0
19	20173621	.	A	T	3	3	6	0	1	7	0	0
19	20173622	.	A	T	3	4	7	0	0	7	0	0
19	20173714	.	G	A	0	2	2	0	6	8	0	0
19	20176418	.	G	A	0	2	2	0	3	5	0	0
19	20176665	.	G	T	6	8	14	0	0	14	0	0
19	20179257	.	G	A	10	4	14	0	0	14	0	0
19	20179291	.	G	A	11	6	17	0	3	20	0	0
19	20185030	.	C	T	22	14	36	0	0	36	0	0
19	20237989	.	G	A	0	2	2	0	1	3	0	0
19	20243814	.	G	A	1	3	4	0	0	4	0	0
19	20244114	.	C	T	3	6	9	0	0	9	0	0
19	20292279	.	A	T	1	2	3	0	0	3	0	0
19	20301691	.	A	C	2	0	2	0	4	6	0	0
19	20301843	.	T	A	2	2	4	0	1	5	0	0
19	20305514	.	A	G	4	2	6	0	0	6	0	0
19	20414805	.	C	G	1	2	3	0	3	6	0	0
19	20415143	.	T	A	2	3	5	0	0	5	0	0
19	20415146	.	T	C	3	1	4	0	1	5	0	0
19	20720782	.	T	C	17	14	31	0	2	33	0	0
19	20721025	.	C	T	20	11	31	1	2	34	0	0
19	20721135	.	G	A	28	18	46	0	1	47	0	0
19	20721215	.	C	T	17	19	36	0	7	43	0	0
19	20721761	.	A	C	7	16	23	0	5	28	0	0
19	20722093	.	C	A	15	16	31	0	4	35	0	0
19	20722144	.	C	T	18	10	28	0	0	28	0	0
19	20722330	.	C	G	4	4	8	0	0	8	0	0
19	20761382	.	C	T	1	7	8	0	3	11	0	0
19	20761710	.	T	G	5	2	7	0	1	8	0	0
19	20762228	.	T	C	3	8	11	0	0	11	0	0
19	20762239	.	G	A	7	5	12	0	1	13	0	0
19	20790572	.	T	C	7	5	12	0	0	12	0	0
19	20790809	.	C	T	7	13	20	0	0	20	0	0
19	20791295	.	T	C	16	8	24	0	1	25	0	0
19	20791525	.	T	G	1	9	10	0	1	11	0	0
19	20792054	.	C	T	3	1	4	0	1	5	0	0
19	20796566	.	C	T	16	17	33	0	1	34	0	0
19	20796605	.	C	T	10	14	24	0	1	25	0	0
19	20823024	.	C	T	4	2	6	0	0	6	0	0
19	21366681	.	C	T	0	3	3	0	1	4	0	0
19	21366697	.	C	T	0	2	2	0	4	6	0	0
19	21410404	.	G	A	7	4	11	0	1	12	0	0
19	21411022	.	C	T	8	3	11	0	0	11	0	0
19	21412041	.	C	T	10	20	30	0	3	33	0	0
19	21412293	.	A	G	7	3	10	0	0	10	0	0
19	21412755	.	T	C	7	9	16	0	2	18	0	0
19	21413152	.	G	A	0	13	13	0	20	33	0	0
19	21698413	.	G	A	6	2	8	0	0	8	0	0
19	21711187	.	G	C	3	0	3	0	3	6	0	0
19	21711267	.	G	C	4	2	6	0	0	6	0	0
19	21711681	.	A	G	2	4	6	0	0	6	0	0
19	21712031	.	A	T	1	3	4	0	0	4	0	0
19	21712032	.	C	G	1	3	4	0	0	4	0	0
19	21814362	.	A	C	33	45	78	0	8	87	1	0
19	21814372	.	T	A	37	54	91	0	2	93	0	0
19	21814408	.	T	C	30	53	83	1	1	85	0	0
19	21814457	.	C	T	35	67	102	0	6	108	0	0
19	21814515	.	C	T	58	41	99	0	4	103	0	0
19	21814644	.	T	G	31	43	74	0	1	75	0	0
19	21814852	.	T	C	23	51	74	0	1	75	0	0
19	21815151	.	C	T	8	38	46	0	39	85	0	0
19	21819663	.	A	G	6	2	8	0	0	8	0	0
19	22070497	.	G	A	1	2	3	0	0	3	0	0
19	22073191	.	A	T	3	2	5	0	0	5	0	0
19	22177104	.	G	A	0	2	2	0	3	5	0	0
19	22177122	.	G	A	0	5	5	0	4	9	0	0
19	22177164	.	T	C	2	3	5	0	0	5	0	0
19	22303813	.	C	T	1	3	4	0	0	4	0	0
19	22303825	.	A	T	1	2	3	0	0	3	0	0
19	22303980	.	C	A	1	2	3	0	0	3	0	0
19	22361962	.	A	C	5	8	13	0	2	15	0	0
19	22362260	.	A	C	3	3	6	0	0	6	0	0
19	22408905	.	G	A	6	6	12	0	0	12	0	0
19	22409431	.	G	T	2	2	4	0	0	4	0	0
19	22409533	.	G	A	2	4	6	0	0	6	0	0
19	22409994	.	G	C	4	3	7	0	0	7	0	0
19	22410447	.	C	T	1	2	3	0	1	4	0	0
19	22410578	.	C	G	0	4	4	0	4	8	0	0
19	22410665	.	G	A	4	7	11	0	1	12	0	0
19	22410707	.	C	T	0	5	5	0	2	7	0	0
19	22410923	.	T	A	4	3	7	0	0	7	0	0
19	22411136	.	G	A	1	4	5	0	0	5	0	0
19	22411187	.	A	G	1	4	5	0	0	5	0	0
19	22411991	.	T	G	4	2	6	0	1	7	0	0
19	22413296	.	C	T	2	2	4	0	0	4	0	0
19	22623421	.	G	A	3	2	5	0	0	5	0	0
19	22623596	.	G	A	5	2	7	0	0	7	0	0
19	22623724	.	G	T	1	4	5	0	0	5	0	0
19	22624554	.	G	A	11	3	14	0	0	14	0	0
19	22624557	.	G	A	10	3	13	0	0	13	0	0
19	22634093	.	G	A	14	4	18	0	2	20	0	0
19	22638187	.	T	C	3	17	20	0	2	22	0	0
19	22638250	.	C	A	6	13	19	0	1	20	0	0
19	22655690	.	T	C	5	4	9	0	1	10	0	0
19	22759523	.	C	A	2	5	7	0	5	12	0	0
19	22764168	.	T	G	1	3	4	0	0	4	0	0
19	22764259	.	A	G	1	3	4	0	0	4	0	0
19	22764274	.	G	A	2	3	5	0	1	6	0	0
19	23877478	.	A	T	2	2	4	0	0	4	0	0
19	23877497	.	C	T	2	2	4	0	0	4	0	0
19	23920598	.	G	T	1	6	7	0	8	15	0	0
19	23920826	.	T	G	4	4	8	0	0	8	0	0
19	23921127	.	T	C	9	2	11	0	3	14	0	0
19	23921147	.	C	G	10	0	10	0	4	14	0	0
19	23921282	.	T	A	8	11	19	0	3	22	0	0
19	23921381	.	G	A	6	9	15	0	0	15	0	0
19	23921617	.	A	G	14	12	26	0	1	27	0	0
19	23921662	.	A	G	11	0	11	0	13	24	0	0
19	23921669	.	G	A	2	9	11	0	19	30	0	0
19	23921858	.	A	G	4	4	8	0	0	8	0	0
19	23921996	.	T	A	2	2	4	0	0	4	0	0
19	23922030	.	T	C	2	4	6	0	0	6	0	0
19	23922237	.	T	G	11	0	11	0	9	20	0	0
19	23922260	.	A	T	7	9	16	0	1	17	0	0
19	24007465	.	G	A	5	3	8	0	0	8	0	0
19	24007471	.	C	T	3	5	8	0	0	8	0	0
19	24031592	.	C	T	17	11	28	0	1	29	0	0
19	24031761	.	T	A	21	8	29	0	1	30	0	0
19	24032122	.	T	A	11	10	21	0	2	23	0	0
19	24032386	.	G	A	0	6	6	0	2	8	0	0
19	24032407	.	C	A	3	2	5	0	2	7	0	0
19	24032528	.	C	T	2	4	6	0	1	7	0	0
19	24032766	.	A	T	14	24	38	0	2	40	0	0
19	24032867	.	T	A	23	19	42	0	1	43	0	0
19	24032907	.	T	C	18	22	40	1	1	42	0	0
19	24033226	.	A	C	23	19	42	0	8	50	0	0
19	24033288	.	A	G	20	26	46	0	1	47	0	0
19	24033494	.	G	A	4	26	30	0	33	63	0	0
19	24033686	.	C	T	33	22	55	0	4	59	0	0
19	24033804	.	C	T	37	18	55	0	2	57	0	0
19	24033856	.	A	C	17	31	48	0	4	52	0	0
19	24034115	.	C	T	32	29	61	0	3	64	0	0
19	24034148	.	T	C	26	29	55	1	10	66	0	0
19	24034169	.	T	C	35	24	59	1	4	64	0	0
19	24034276	.	T	G	25	38	63	0	4	67	0	0
19	24034410	.	G	A	26	39	65	0	1	66	0	0
19	24034437	.	G	A	0	36	36	0	26	62	0	0
19	24034525	.	C	T	31	28	59	0	5	64	0	0
19	24034573	.	T	A	38	24	62	0	2	65	1	0
19	24065367	.	T	G	1	3	4	0	0	4	0	0
19	24072644	.	T	G	1	0	1	0	3	4	0	0
19	24074533	.	T	C	1	4	5	0	1	6	0	0
19	24074617	.	G	A	0	5	5	0	3	8	0	0
19	24074632	.	C	A	4	5	9	0	0	9	0	0
19	24074679	.	C	T	4	5	9	0	0	9	0	0
19	24074716	.	A	G	2	0	2	0	6	8	0	0
19	24074773	.	C	A	3	2	5	0	0	5	0	0
19	24074794	.	A	G	2	2	4	0	0	4	0	0
19	24123690	.	A	C	1	2	3	0	1	4	0	0
19	24123693	.	T	A	1	2	3	0	0	3	0	0
19	24124448	.	C	T	2	4	6	0	0	6	0	0
19	24124577	.	C	A	5	2	7	0	0	7	0	0
19	24127973	.	C	A	0	2	2	0	1	3	0	0
19	24127981	.	T	C	0	0	0	0	2	2	0	0
19	24128178	.	A	G	1	1	2	0	1	3	0	0
19	24128743	.	A	T	2	3	5	0	1	6	0	0
19	24129244	.	C	T	1	3	4	0	0	4	0	0
19	24129343	.	C	T	1	4	5	0	1	6	0	0
19	24129347	.	T	C	1	0	1	0	4	5	0	0
19	24129398	.	G	A	1	8	9	0	0	9	0	0
19	24129616	.	A	T	2	6	8	0	0	8	0	0
19	24129728	.	C	A	1	7	8	0	0	8	0	0
19	24130139	.	G	A	5	7	12	0	0	12	0	0
19	24130179	.	G	T	3	5	8	0	0	8	0	0
19	24130541	.	T	G	3	3	6	0	0	6	0	0
19	24130685	.	C	G	1	6	7	0	0	7	0	0
19	24263893	.	G	T	2	5	7	0	0	7	0	0
19	24264105	.	G	A	1	4	5	0	0	5	0	0
19	24264106	.	C	G	0	4	4	0	1	5	0	0
19	24390379	.	A	C	1	3	4	0	0	4	0	0
19	24391232	.	A	G	1	0	1	0	2	3	0	0
19	24391234	.	A	T	1	2	3	0	0	3	0	0
19	24391280	.	T	G	2	3	5	0	0	5	0	0
19	24391289	.	G	A	2	3	5	0	0	5	0	0
19	24391477	.	A	T	3	9	12	0	1	13	0	0
19	24391726	.	G	A	3	6	9	0	0	9	0	0
19	24391839	.	C	T	3	7	10	0	1	11	0	0
19	24448940	.	T	C	4	2	6	0	2	8	0	0
19	24448985	.	T	C	2	0	2	0	5	7	0	0
19	24491268	.	C	T	1	2	3	0	0	3	0	0
19	24491588	.	T	A	3	2	5	0	0	5	0	0
19	24491982	.	G	C	7	6	13	0	0	13	0	0
19	24758037	.	G	C	7	6	13	0	1	14	0	0
19	24758040	.	T	G	8	6	14	0	0	14	0	0
19	24883750	.	G	A	1	5	6	0	1	7	0	0
19	24888024	.	A	G	11	10	21	0	1	22	0	0
19	24888090	.	A	T	17	9	26	0	0	26	0	0
19	24888187	.	C	T	18	10	28	0	3	31	0	0
19	24888195	.	A	T	9	17	26	0	1	27	0	0
19	24888398	.	G	A	2	14	16	0	19	35	0	0
19	24888748	.	T	C	22	20	42	0	2	44	0	0
19	24914462	.	C	T	3	7	10	0	0	10	0	0
19	24915782	.	G	A	0	4	4	0	3	7	0	0
19	24915796	.	A	G	2	4	6	0	1	7	0	0
19	24916007	.	T	G	4	6	10	0	0	10	0	0
19	24916427	.	C	T	10	5	15	0	1	16	0	0
19	24916445	.	A	T	10	7	17	0	1	18	0	0
19	24916766	.	T	G	5	4	9	0	2	12	1	0
19	25089839	.	A	G	9	7	16	0	1	17	0	0
19	25089979	.	A	G	12	5	17	0	1	18	0	0
19	25090032	.	T	G	9	9	18	0	1	19	0	0
19	25090079	.	A	G	9	7	16	0	0	16	0	0
19	25090231	.	T	C	12	11	23	0	1	24	0	0
19	25113207	.	C	A	4	9	13	0	1	14	0	0
19	25113524	.	T	C	14	9	23	0	1	24	0	0
19	25156572	.	C	T	7	4	11	0	1	12	0	0
19	25156639	.	T	C	1	0	1	0	5	6	0	0
19	25156669	.	T	C	3	7	10	0	1	11	0	0
19	25156717	.	A	C	6	10	16	0	0	16	0	0
19	25156774	.	T	A	16	8	24	0	0	24	0	0
19	25156959	.	A	T	12	18	30	0	1	31	0	0
19	25163633	.	G	T	2	2	4	1	0	5	0	0
19	25270949	.	A	G	1	3	4	0	0	4	0	0
19	25352327	.	T	C	4	3	7	0	0	7	0	0
19	25352503	.	G	A	8	4	12	0	0	12	0	0
19	25352702	.	A	C	7	5	12	2	2	16	0	0
19	25352789	.	T	C	3	4	7	0	3	10	0	0
19	25352901	.	A	T	9	7	16	0	0	16	0	0
19	25353088	.	A	G	6	10	16	0	0	16	0	0
19	25367414	.	A	C	5	0	5	0	3	8	0	0
19	25370392	.	G	A	4	5	9	0	0	9	0	0
19	25370730	.	C	T	1	4	5	0	0	5	0	0
19	25526483	.	G	A	1	6	7	0	3	10	0	0
19	25526529	.	T	C	2	5	7	0	0	7	0	0
19	25548114	.	C	G	13	9	22	0	2	24	0	0
19	25652962	.	C	T	20	18	38	1	5	44	0	0
19	25653042	.	C	T	14	20	34	0	3	37	0	0
19	25653147	.	C	T	12	17	29	0	3	32	0	0
19	25653170	.	G	T	5	15	20	0	7	27	0	0
19	25657306	.	C	A	5	4	9	0	0	9	0	0
19	25680169	.	A	T	7	10	17	0	1	18	0	0
19	25680170	.	C	T	7	11	18	0	0	18	0	0
19	25680248	.	A	T	9	3	12	0	2	14	0	0
19	25682029	.	G	A	2	7	9	0	1	10	0	0
19	25682044	.	A	G	6	2	8	0	2	10	0	0
19	25693539	.	T	C	1	2	3	0	1	4	0	0
19	25699618	.	T	A	2	3	5	0	0	5	0	0
19	25699903	.	G	A	2	3	5	0	0	5	0	0
19	25699929	.	G	A	3	3	6	0	0	6	0	0
19	25699959	.	C	A	2	3	5	0	0	5	0	0
19	25699965	.	G	A	3	1	4	0	1	5	0	0
19	26156423	.	C	T	1	2	3	0	0	3	0	0
19	26164906	.	G	A	19	20	39	0	0	39	0	0
19	26235083	.	G	A	3	3	6	0	0	6	0	0
19	26235089	.	C	T	2	2	4	0	3	7	0	0
19	26370720	.	A	T	3	2	5	0	0	5	0	0
19	26370726	.	C	T	2	3	5	0	0	5	0	0
19	26375471	.	C	T	4	3	7	0	0	7	0	0
19	26375643	.	T	G	4	7	11	0	3	14	0	0
19	26375699	.	G	T	10	7	17	0	0	17	0	0
19	26378250	.	T	C	4	4	8	0	1	9	0	0
19	26378265	.	G	A	5	2	7	0	3	10	0	0
19	26378285	.	G	A	8	5	13	0	0	13	0	0
19	26378447	.	T	A	11	8	19	0	0	19	0	0
19	26378451	.	G	A	7	7	14	0	3	17	0	0
19	26627729	.	T	A	0	2	2	0	2	4	0	0
19	26627730	.	C	T	0	2	2	0	2	4	0	0
19	26628244	.	C	T	3	2	5	0	0	5	0	0
19	26628279	.	C	T	2	4	6	0	0	6	0	0
19	26628287	.	G	A	2	3	5	0	0	5	0	0
19	26657193	.	T	C	2	4	6	0	0	6	0	0
19	26669225	.	G	A	3	2	5	0	0	5	0	0
19	26669228	.	T	C	3	2	5	0	0	5	0	0
19	26670618	.	A	G	4	0	4	0	10	14	0	0
19	26706947	.	C	T	7	2	9	0	0	9	0	0
19	26707384	.	T	C	4	3	7	0	0	7	0	0
19	26707435	.	C	G	2	0	2	0	2	4	0	0
19	26710899	.	T	A	1	2	3	0	0	3	0	0
19	26711447	.	G	A	2	3	5	0	0	5	0	0
19	26715006	.	A	G	6	0	6	0	8	14	0	0
19	26717549	.	T	C	2	4	6	0	0	6	0	0
19	26723690	.	G	A	3	4	7	0	0	7	0	0
19	26723705	.	A	T	3	4	7	0	0	7	0	0
19	26728070	.	G	A	10	4	14	0	0	14	0	0
19	26728079	.	A	C	4	9	13	0	1	14	0	0
19	26729597	.	A	T	10	5	15	0	0	15	0	0
19	26729651	.	T	C	9	7	16	0	0	16	0	0
19	26729811	.	A	C	4	9	13	0	0	13	0	0
19	26729867	.	C	T	6	6	12	1	0	13	0	0
19	26729887	.	T	A	3	5	8	1	1	10	0	0
19	26730073	.	A	T	4	6	10	0	1	11	0	0
19	26730077	.	G	T	8	3	11	0	1	12	0	0
19	26730108	.	A	G	9	0	9	0	7	16	0	0
19	26730545	.	C	T	22	27	49	0	1	50	0	0
19	26730642	.	T	C	23	1	24	0	27	51	0	0
19	26731183	.	C	T	1	11	12	0	13	25	0	0
19	26731249	.	C	T	0	2	2	0	1	3	0	0
19	26741296	.	C	G	16	22	38	0	3	42	1	0
19	26741378	.	T	C	27	0	27	0	17	44	0	0
19	26741427	.	G	A	17	24	41	0	6	47	0	0
19	26741831	.	C	T	3	14	17	0	15	32	0	0
19	26741918	.	G	T	11	13	24	0	1	25	0	0
19	26742224	.	T	C	9	6	15	0	1	16	0	0
19	26742321	.	G	A	10	8	18	0	0	18	0	0
19	26742379	.	A	C	8	0	8	0	7	15	0	0
19	26742598	.	A	T	8	16	24	0	0	24	0	0
19	26742716	.	T	A	15	19	34	0	0	34	0	0
19	26742732	.	A	G	17	18	35	0	1	36	0	0
19	26742751	.	C	T	15	18	33	0	5	38	0	0
19	26743295	.	A	T	11	7	18	0	1	19	0	0
19	26743446	.	T	A	21	17	38	0	0	38	0	0
19	26743781	.	G	A	12	8	20	0	1	21	0	0
19	26743808	.	C	T	8	9	17	0	0	17	0	0
19	26743900	.	T	A	6	8	14	0	1	15	0	0
19	26743943	.	C	T	4	8	12	0	2	14	0	0
19	26743984	.	A	G	4	8	12	0	0	12	0	0
19	26744235	.	G	T	8	8	16	0	2	18	0	0
19	26744840	.	C	T	6	9	15	0	2	17	0	0
19	26745392	.	T	A	3	3	6	0	1	7	0	0
19	26746246	.	C	T	4	3	7	0	0	7	0	0
19	26747979	.	C	T	3	2	5	0	0	5	0	0
19	26860799	.	T	C	4	1	5	0	3	8	0	0
19	26863569	.	T	G	1	0	1	0	4	5	0	0
19	26868876	.	C	T	4	5	9	0	0	9	0	0
19	26868899	.	G	A	4	2	6	0	0	6	0	0
19	26872742	.	C	A	1	3	4	0	0	4	0	0
19	26872886	.	T	C	2	2	4	0	8	12	0	0
19	26872898	.	C	T	1	10	11	0	0	11	0	0
19	26873020	.	C	T	17	7	24	0	3	27	0	0
19	26910814	.	T	G	3	2	5	0	0	5	0	0
19	26925280	.	G	A	4	6	10	0	0	10	0	0
19	26925296	.	T	C	3	6	9	0	0	9	0	0
19	26925526	.	G	A	4	2	6	0	1	7	0	0
19	26928320	.	C	T	12	11	23	1	3	27	0	0
19	26928356	.	A	G	15	12	27	0	1	28	0	0
19	26928399	.	A	C	12	9	21	0	1	22	0	0
19	26931520	.	G	A	7	7	14	0	1	15	0	0
19	26931680	.	T	A	10	8	18	0	0	18	0	0
19	26931730	.	T	A	7	5	12	0	1	13	0	0
19	26931732	.	A	T	6	7	13	0	0	13	0	0
19	26931765	.	G	A	0	8	8	0	4	12	0	0
19	26958040	.	G	A	2	2	4	0	1	5	0	0
19	26967634	.	G	T	3	5	8	0	0	9	1	0
19	26967780	.	C	T	3	2	5	0	1	6	0	0
19	26967783	.	T	G	3	2	5	0	0	5	0	0
19	27283342	.	C	G	1	2	3	0	0	3	0	0
19	27283472	.	A	T	4	2	6	0	0	6	0	0
19	27283557	.	C	A	6	2	8	0	0	8	0	0
19	27283612	.	A	G	3	2	5	0	0	5	0	0
19	27283940	.	C	T	4	4	8	0	0	8	0	0
19	27284178	.	G	A	2	2	4	0	0	4	0	0
19	27284195	.	T	G	1	3	4	0	0	4	0	0
19	27284387	.	A	G	1	3	4	0	0	4	0	0
19	27284817	.	A	C	2	2	4	0	1	5	0	0
19	27284860	.	C	T	4	2	6	0	0	6	0	0
19	27284957	.	G	A	2	3	5	0	0	5	0	0
19	27285085	.	T	C	2	0	2	0	6	8	0	0
19	27286390	.	G	T	1	0	1	0	2	3	0	0
19	27287204	.	T	C	2	4	6	0	0	6	0	0
19	27287294	.	T	G	3	3	6	0	1	7	0	0
19	27287492	.	T	A	1	1	2	0	1	3	0	0
19	27321573	.	C	G	11	11	22	0	0	22	0	0
19	27321615	.	A	G	11	7	18	0	0	18	0	0
19	27351218	.	G	A	2	6	8	0	0	8	0	0
19	27357250	.	C	A	9	7	16	0	1	17	0	0
19	27357485	.	A	T	14	11	25	0	0	25	0	0
19	27357567	.	T	A	13	8	21	0	0	21	0	0
19	27368719	.	T	C	5	8	13	0	0	13	0	0
19	27369553	.	T	C	5	4	9	0	1	10	0	0
19	27369853	.	T	A	2	3	5	0	0	5	0	0
19	27370273	.	C	T	0	3	3	0	2	5	0	0
19	27401412	.	G	A	3	4	7	0	0	7	0	0
19	27401515	.	C	T	4	6	10	0	1	11	0	0
19	27401680	.	G	A	5	7	12	0	0	12	0	0
19	27415248	.	G	A	6	2	8	0	0	8	0	0
19	27457166	.	T	C	8	0	8	0	13	21	0	0
19	27457213	.	T	C	9	8	17	0	0	17	0	0
19	27457505	.	G	T	14	6	20	0	0	20	0	0
19	27457516	.	T	G	6	11	17	0	0	17	0	0
19	27457607	.	C	T	10	5	15	0	0	15	0	0
19	27457621	.	T	A	4	11	15	0	0	15	0	0
19	27457749	.	C	T	6	7	13	0	0	13	0	0
19	27457892	.	T	C	6	9	15	0	2	17	0	0
19	27457989	.	T	A	4	5	9	0	0	9	0	0
19	27461139	.	C	T	0	10	10	0	10	20	0	0
19	27461183	.	C	T	4	9	13	0	0	13	0	0
19	27461560	.	C	T	1	6	7	0	4	11	0	0
19	27464344	.	A	T	21	11	32	0	1	33	0	0
19	27466189	.	C	G	18	16	34	0	2	36	0	0
19	27468598	.	G	A	15	23	38	0	1	39	0	0
19	27468606	.	C	T	13	22	35	0	1	36	0	0
19	27468983	.	A	C	9	9	18	8	3	29	0	0
19	27469060	.	C	G	1	11	12	0	10	22	0	0
19	27469130	.	A	G	11	4	15	0	0	15	0	0
19	27469178	.	A	C	10	11	21	0	2	23	0	0
19	27469184	.	G	A	9	12	21	0	0	21	0	0
19	27469224	.	A	C	2	6	8	0	0	8	0	0
19	27505122	.	G	A	1	3	4	0	5	9	0	0
19	27505191	.	G	A	1	8	9	0	9	18	0	0
19	27505211	.	G	A	17	6	23	0	1	24	0	0
19	27505962	.	G	T	8	8	16	0	0	16	0	0
19	27609998	.	C	T	11	6	17	0	1	18	0	0
19	27616055	.	C	T	19	15	34	0	0	34	0	0
19	27616337	.	G	A	12	11	23	0	1	24	0	0
19	27623285	.	C	T	6	6	12	0	0	12	0	0
19	27634823	.	C	T	5	6	11	0	0	11	0	0
19	28281242	.	T	A	1	3	4	0	0	4	0	0
19	28281343	.	G	A	22	16	38	0	2	40	0	0
19	28281351	.	T	G	12	26	38	0	0	38	0	0
19	28283749	.	C	T	3	22	25	0	25	50	0	0
19	28283786	.	C	T	24	26	50	0	3	53	0	0
19	28284146	.	T	A	5	7	12	0	0	12	0	0
19	28284203	.	A	T	12	15	27	0	1	28	0	0
19	28284220	.	T	A	7	11	18	0	2	20	0	0
19	28288148	.	C	T	14	14	28	0	0	28	0	0
19	28288480	.	G	A	20	7	27	0	2	29	0	0
19	28288489	.	C	T	22	9	31	0	0	31	0	0
19	28289039	.	T	C	1	2	3	0	0	3	0	0
19	28359920	.	G	A	5	4	9	0	1	10	0	0
19	28360028	.	T	G	12	9	21	0	1	22	0	0
19	28360029	.	C	T	12	9	21	0	1	22	0	0
19	28787154	.	C	T	13	21	34	0	0	34	0	0
19	28788220	.	A	G	12	3	15	0	2	17	0	0
19	28788430	.	T	A	16	5	21	0	2	23	0	0
19	28802039	.	A	G	4	3	7	0	0	7	0	0
19	28802469	.	G	A	1	7	8	0	0	8	0	0
19	28802487	.	G	T	2	6	8	0	0	8	0	0
19	28802954	.	C	A	13	10	23	0	2	25	0	0
19	28803173	.	G	A	19	15	34	0	1	35	0	0
19	28803267	.	G	A	3	16	19	1	16	36	0	0
19	28820643	.	C	T	21	15	36	0	0	36	0	0
19	28821230	.	G	A	5	8	13	0	0	13	0	0
19	28821333	.	G	A	0	13	13	1	5	19	0	0
19	28821334	.	G	T	3	14	17	1	1	19	0	0
19	28821383	.	A	C	9	5	14	0	0	14	0	0
19	28821666	.	G	C	12	15	27	0	0	27	0	0
19	28822057	.	T	C	7	12	19	0	1	20	0	0
19	28822187	.	C	T	15	9	24	0	0	24	0	0
19	28822521	.	A	G	1	2	3	0	0	3	0	0
19	28822794	.	A	T	2	3	5	0	0	5	0	0
19	28823987	.	C	G	5	3	8	0	1	9	0	0
19	29296494	.	C	A	1	2	3	0	0	3	0	0
19	29301650	.	C	G	1	1	2	0	1	3	0	0
19	29301708	.	T	C	1	2	3	0	0	3	0	0
19	29318861	.	A	C	1	5	6	0	0	6	0	0
19	29327825	.	A	G	1	0	1	0	7	8	0	0
19	29333382	.	C	T	3	4	7	0	2	9	0	0
19	29333597	.	A	C	2	5	7	0	0	7	0	0
19	29337897	.	A	T	2	2	4	0	1	5	0	0
19	29337923	.	G	A	1	2	3	0	0	3	0	0
19	29358141	.	A	C	0	2	2	0	2	4	0	0
19	29358144	.	C	T	1	3	4	0	0	4	0	0
19	29799885	.	C	T	39	39	78	0	12	90	0	0
19	29799900	.	T	C	43	32	75	0	9	84	0	0
19	29800229	.	A	G	36	33	69	0	4	73	0	0
19	29812799	.	G	T	1	4	5	0	2	7	0	0
19	29815096	.	T	C	28	20	48	0	4	52	0	0
19	29817914	.	C	G	26	22	48	0	1	49	0	0
19	29818142	.	C	T	29	27	56	0	3	59	0	0
19	29822615	.	C	T	2	14	16	0	17	33	0	0
19	29830215	.	G	A	13	16	29	0	2	31	0	0
19	29832781	.	G	A	4	8	12	3	1	16	0	0
19	29836645	.	T	C	8	0	8	0	11	19	0	0
19	29836779	.	A	G	3	6	9	0	0	9	0	0
19	29836821	.	T	G	4	6	10	0	0	10	0	0
19	29837251	.	T	C	1	2	3	0	0	3	0	0
19	29837310	.	A	G	5	6	11	0	0	11	0	0
19	29837371	.	G	T	2	5	7	0	1	8	0	0
19	29837380	.	A	G	3	3	6	0	1	7	0	0
19	29837619	.	T	A	1	2	3	0	0	3	0	0
19	29837705	.	C	T	0	2	2	0	3	5	0	0
19	29837964	.	C	T	4	2	6	0	1	7	0	0
19	29840445	.	C	G	0	2	2	0	2	4	0	0
19	29859831	.	G	A	1	4	5	0	0	5	0	0
19	29859841	.	G	A	1	3	4	0	0	4	0	0
19	29859872	.	G	A	1	2	3	0	0	3	0	0
19	29861961	.	C	A	4	10	14	0	6	20	0	0
19	29866630	.	C	T	2	2	4	0	2	6	0	0
19	29872768	.	C	T	0	3	3	0	2	5	0	0
19	29872783	.	C	T	0	2	2	0	2	4	0	0
19	30348804	.	G	A	23	8	31	0	3	34	0	0
19	30349310	.	A	T	14	12	26	0	2	28	0	0
19	30349553	.	C	G	1	12	13	0	5	18	0	0
19	30355383	.	T	C	9	12	21	0	1	22	0	0
19	30355907	.	A	T	6	6	12	0	0	12	0	0
19	30388169	.	G	T	1	2	3	0	1	4	0	0
19	30396440	.	T	G	12	0	12	0	7	19	0	0
19	30396777	.	C	T	13	11	24	0	0	24	0	0
19	30398392	.	T	C	5	14	19	0	0	19	0	0
19	30398395	.	T	C	4	13	17	0	1	18	0	0
19	30398487	.	G	A	10	7	17	0	1	18	0	0
19	30398632	.	T	C	3	4	7	0	1	8	0	0
19	30398763	.	T	G	2	4	6	0	0	6	0	0
19	30398909	.	T	C	4	2	6	0	0	6	0	0
19	30399047	.	A	T	8	4	12	0	0	12	0	0
19	30410519	.	C	A	19	9	28	0	1	29	0	0
19	30413354	.	G	A	9	14	23	0	0	23	0	0
19	30414279	.	G	A	3	5	8	0	0	8	0	0
19	30416170	.	T	C	1	0	1	0	2	3	0	0
19	30423199	.	A	T	3	4	7	0	0	7	0	0
19	30423209	.	A	G	3	4	7	0	0	7	0	0
19	30423366	.	A	G	4	4	8	0	0	8	0	0
19	30423368	.	G	A	4	4	8	0	0	8	0	0
19	30426436	.	C	A	10	8	18	0	1	19	0	0
19	30432697	.	A	G	12	11	23	0	1	24	0	0
19	30434753	.	A	G	3	9	12	0	1	13	0	0
19	30434939	.	C	T	4	9	13	0	0	13	0	0
19	30436629	.	G	A	7	4	11	0	0	11	0	0
19	30438496	.	G	A	3	3	6	0	0	6	0	0
19	30439733	.	C	T	4	2	6	0	2	8	0	0
19	30439754	.	C	T	3	5	8	0	0	8	0	0
19	30441396	.	A	G	2	2	4	0	0	4	0	0
19	30441399	.	A	G	0	3	3	0	0	3	0	0
19	30445915	.	C	A	4	4	8	0	0	8	0	0
19	30445927	.	A	G	4	4	8	0	0	8	0	0
19	30446181	.	T	A	2	3	5	0	0	5	0	0
19	30446552	.	T	C	2	2	4	0	0	4	0	0
19	30446567	.	G	T	1	2	3	0	1	4	0	0
19	30450375	.	C	T	3	2	5	0	0	5	0	0
19	30455675	.	T	C	2	2	4	0	0	4	0	0
19	30458121	.	C	T	2	3	5	0	0	5	0	0
19	30463210	.	G	C	6	2	8	0	0	8	0	0
19	30481692	.	T	C	14	0	14	0	7	21	0	0
19	30481799	.	T	A	16	9	25	0	2	27	0	0
19	30485029	.	G	A	10	7	17	0	0	17	0	0
19	30485085	.	T	C	6	7	13	0	1	14	0	0
19	30485247	.	T	G	8	4	12	0	0	12	0	0
19	30485253	.	A	G	7	3	10	0	0	10	0	0
19	30495908	.	C	T	3	1	4	0	1	5	0	0
19	30518480	.	T	A	3	18	21	0	2	23	0	0
19	30518646	.	A	C	17	34	51	0	1	52	0	0
19	30518906	.	A	G	18	30	48	0	2	50	0	0
19	30518973	.	C	T	29	16	45	2	4	51	0	0
19	30519319	.	A	G	4	3	7	0	0	7	0	0
19	30519324	.	C	T	4	3	7	0	0	7	0	0
19	30519459	.	T	A	2	2	4	0	0	4	0	0
19	30519802	.	C	T	16	11	27	0	0	27	0	0
19	30519803	.	T	G	12	11	23	0	4	27	0	0
19	30519858	.	A	G	7	8	15	0	2	17	0	0
19	30520061	.	T	G	8	11	19	0	0	19	0	0
19	30520214	.	C	T	12	17	29	0	4	33	0	0
19	30520337	.	A	G	13	11	24	0	0	24	0	0
19	30520419	.	G	A	9	12	21	0	0	21	0	0
19	30520431	.	C	G	7	9	16	0	2	18	0	0
19	30520567	.	T	A	14	4	18	0	1	19	0	0
19	30520569	.	T	A	13	4	17	0	1	18	0	0
19	30521256	.	G	A	3	3	6	0	0	6	0	0
19	30521443	.	C	A	1	2	3	0	0	3	0	0
19	30522182	.	T	C	3	4	7	0	0	7	0	0
19	30669900	.	G	A	0	7	7	0	13	20	0	0
19	30669930	.	A	G	12	9	21	0	0	21	0	0
19	30672935	.	T	C	12	11	23	0	1	24	0	0
19	30673004	.	T	A	18	13	31	0	2	33	0	0
19	30676543	.	G	A	12	12	24	0	1	25	0	0
19	30676699	.	C	T	11	14	25	0	2	27	0	0
19	30681938	.	G	A	0	14	14	0	19	33	0	0
19	30682680	.	G	A	31	26	57	1	4	62	0	0
19	30682781	.	C	A	24	26	50	0	1	51	0	0
19	30682947	.	A	G	19	24	43	0	3	46	0	0
19	30683129	.	A	C	22	24	46	0	2	48	0	0
19	30683395	.	A	T	28	22	50	0	1	51	0	0
19	30723172	.	C	T	6	3	9	0	0	9	0	0
19	30723251	.	A	T	3	2	5	0	0	5	0	0
19	30723554	.	C	G	2	2	4	0	0	4	0	0
19	30755362	.	C	A	3	3	6	0	0	6	0	0
19	30805617	.	C	T	6	4	10	0	2	12	0	0
19	30805698	.	C	G	10	4	14	0	0	14	0	0
19	30805886	.	A	C	2	3	5	0	0	5	0	0
19	30807557	.	A	G	3	3	6	0	3	9	0	0
19	30876908	.	C	T	1	2	3	0	1	4	0	0
19	30876941	.	G	A	2	2	4	0	0	4	0	0
19	30878424	.	G	A	1	2	3	0	0	3	0	0
19	30878655	.	G	T	2	2	4	0	0	4	0	0
19	30878688	.	C	T	1	2	3	0	0	3	0	0
19	30882688	.	T	C	4	6	10	0	0	10	0	0
19	30882743	.	G	A	4	2	6	0	0	6	0	0
19	30882973	.	A	T	8	14	22	0	0	22	0	0
19	30883224	.	C	T	7	2	9	0	0	9	0	0
19	30883298	.	G	A	8	5	13	0	0	13	0	0
19	30883302	.	G	A	8	5	13	0	0	13	0	0
19	30883476	.	A	T	13	5	18	0	0	18	0	0
19	30883549	.	T	C	4	4	8	0	1	9	0	0
19	30894883	.	G	A	13	11	24	0	0	24	0	0
19	30894980	.	A	G	11	7	18	0	2	20	0	0
19	30895163	.	G	A	7	7	14	0	1	15	0	0
19	30897438	.	T	C	1	0	1	0	4	5	0	0
19	30897545	.	T	A	3	4	7	0	0	7	0	0
19	30897585	.	A	C	5	6	11	0	0	11	0	0
19	30897916	.	C	A	5	2	7	0	0	7	0	0
19	30898050	.	C	T	2	2	4	0	0	4	0	0
19	30898841	.	C	A	4	3	7	0	1	8	0	0
19	30899213	.	T	A	3	2	5	0	0	5	0	0
19	30899256	.	T	C	1	5	6	0	0	6	0	0
19	30899280	.	T	G	1	3	4	0	0	4	0	0
19	30997246	.	C	A	2	2	4	0	0	4	0	0
19	30997247	.	A	C	2	2	4	0	0	4	0	0
19	30999947	.	T	C	3	0	3	0	10	13	0	0
19	31000077	.	C	T	2	10	12	0	8	20	0	0
19	31000207	.	T	C	11	11	22	0	3	25	0	0
19	31001318	.	T	G	6	4	10	0	0	10	0	0
19	31001417	.	A	G	5	3	8	0	0	8	0	0
19	31003330	.	A	T	4	3	7	0	0	7	0	0
19	31010033	.	A	C	21	14	35	0	0	35	0	0
19	31010061	.	T	A	16	11	27	0	1	28	0	0
19	31012900	.	G	A	7	8	15	0	1	16	0	0
19	31016410	.	A	T	9	12	21	0	1	22	0	0
19	31016458	.	C	A	16	5	21	0	0	21	0	0
19	31340089	.	G	A	12	4	16	0	0	16	0	0
19	31340777	.	A	G	2	4	6	0	0	6	0	0
19	31340882	.	C	G	0	4	4	0	2	6	0	0
19	31341000	.	C	T	4	6	10	0	0	10	0	0
19	31348726	.	G	C	1	2	3	0	0	3	0	0
19	31348772	.	A	G	2	2	4	0	0	4	0	0
19	31348774	.	A	C	2	1	3	0	1	4	0	0
19	31392375	.	C	T	4	4	8	0	0	8	0	0
19	31392700	.	G	A	9	6	15	0	0	15	0	0
19	31392803	.	C	T	0	5	5	0	7	12	0	0
19	31394550	.	A	G	2	2	4	0	0	4	0	0
19	31424215	.	C	G	2	0	2	0	2	4	0	0
19	31437701	.	T	C	4	2	6	0	0	6	0	0
19	31437956	.	A	G	12	11	23	0	2	25	0	0
19	31437974	.	G	A	10	10	20	0	1	21	0	0
19	31438009	.	G	T	7	7	14	1	1	16	0	0
19	31438016	.	T	C	7	0	7	1	7	15	0	0
19	31449834	.	T	G	15	12	27	0	0	27	0	0
19	31455562	.	T	C	10	6	16	0	1	17	0	0
19	31461620	.	C	G	4	4	8	0	1	9	0	0
19	32050593	.	A	T	7	10	17	0	0	17	0	0
19	32497694	.	T	C	4	2	6	0	0	6	0	0
19	32895873	.	T	A	5	4	9	0	10	19	0	0
19	33847935	.	A	T	3	4	7	0	0	7	0	0
19	33861796	.	A	G	2	3	5	0	0	5	0	0
19	33861817	.	A	G	1	0	1	0	3	4	0	0
19	33871868	.	C	T	3	4	7	0	0	7	0	0
19	33872816	.	T	G	6	7	13	0	1	14	0	0
19	33872859	.	G	A	0	6	6	0	11	17	0	0
19	33888520	.	A	C	18	14	32	0	4	36	0	0
19	33888881	.	T	G	15	16	31	0	2	33	0	0
19	33902586	.	G	A	9	7	16	0	2	18	0	0
19	33915802	.	C	T	6	3	9	0	0	9	0	0
19	33921715	.	A	G	5	3	8	0	1	9	0	0
19	33956909	.	C	T	3	4	7	0	0	7	0	0
19	33960517	.	G	A	1	3	4	0	0	4	0	0
19	33963773	.	G	T	1	2	3	0	0	3	0	0
19	34074028	.	G	A	10	7	17	0	1	18	0	0
19	34074072	.	A	G	13	4	17	0	0	17	0	0
19	34074386	.	T	G	11	14	25	0	2	27	0	0
19	34081003	.	A	G	17	11	28	0	0	28	0	0
19	34089132	.	T	G	7	4	11	0	0	11	0	0
19	34691678	.	T	C	1	0	1	0	4	5	0	0
19	34696829	.	T	A	7	5	12	0	0	12	0	0
19	34696921	.	C	T	3	7	10	0	1	11	0	0
19	34738118	.	T	C	1	3	4	0	0	4	0	0
19	34742382	.	C	T	2	2	4	0	0	4	0	0
19	34744060	.	T	G	3	5	8	0	0	8	0	0
19	34744231	.	T	C	3	7	10	0	0	10	0	0
19	34744288	.	C	A	5	4	9	0	0	9	0	0
19	34746659	.	G	A	2	5	7	0	0	7	0	0
19	34746810	.	T	G	4	4	8	0	0	8	0	0
19	34746826	.	G	A	2	2	4	0	0	4	0	0
19	34960061	.	A	T	15	7	22	0	0	22	0	0
19	34960099	.	A	G	15	6	21	0	1	22	0	0
19	34960143	.	A	G	18	5	23	0	2	25	0	0
19	34960147	.	G	A	17	6	23	0	1	24	0	0
19	34960190	.	C	G	1	13	14	0	22	36	0	0
19	34960198	.	T	C	22	10	32	0	3	35	0	0
19	34960315	.	T	A	6	7	13	0	1	14	0	0
19	34960562	.	G	A	2	2	4	0	3	7	0	0
19	34961152	.	C	T	4	3	7	0	1	8	0	0
19	34961269	.	A	G	1	2	3	0	0	3	0	0
19	35002450	.	G	A	1	5	6	0	0	6	0	0
19	35002714	.	A	C	1	4	5	0	1	6	0	0
19	35002723	.	T	C	2	4	6	0	0	6	0	0
19	35004117	.	A	C	8	3	11	0	1	12	0	0
19	35004135	.	C	T	6	4	10	0	1	11	0	0
19	35004868	.	C	A	3	2	5	0	0	5	0	0
19	35004869	.	C	A	3	2	5	0	0	5	0	0
19	35004941	.	T	C	2	5	7	0	0	7	0	0
19	35005136	.	A	C	4	2	6	0	0	6	0	0
19	35005137	.	A	T	3	2	5	0	1	6	0	0
19	35005318	.	G	A	10	16	26	0	6	32	0	0
19	35007021	.	G	A	1	3	4	0	3	7	0	0
19	35007220	.	G	A	16	18	34	0	2	36	0	0
19	35007235	.	G	A	19	14	33	0	1	34	0	0
19	35013166	.	G	T	3	2	5	0	2	7	0	0
19	35013806	.	C	T	27	14	41	0	1	42	0	0
19	35016477	.	C	T	24	18	42	0	0	42	0	0
19	35016553	.	T	G	18	12	30	0	2	32	0	0
19	35016646	.	A	T	22	13	35	0	5	40	0	0
19	35016696	.	T	G	16	17	33	0	0	33	0	0
19	35016835	.	C	T	9	15	24	0	2	26	0	0
19	35016962	.	T	A	9	8	17	0	0	17	0	0
19	35019339	.	C	A	2	2	4	0	0	4	0	0
19	35019490	.	T	A	2	2	4	0	0	4	0	0
19	35019560	.	A	G	2	3	5	0	0	5	0	0
19	35040003	.	G	T	6	7	13	0	1	14	0	0
19	35041158	.	T	A	24	19	43	0	3	46	0	0
19	35041308	.	A	G	21	21	42	0	2	44	0	0
19	35041458	.	T	C	25	0	25	0	21	46	0	0
19	35052411	.	G	T	16	12	28	0	0	28	0	0
19	35052435	.	T	C	9	0	9	0	16	25	0	0
19	35055889	.	A	G	11	7	18	0	0	18	0	0
19	35057860	.	G	T	4	11	15	0	0	15	0	0
19	35057869	.	C	T	10	4	14	0	3	17	0	0
19	35058232	.	T	C	12	11	23	0	1	24	0	0
19	35060217	.	A	C	9	9	18	0	0	18	0	0
19	35067367	.	G	A	3	4	7	0	1	8	0	0
19	35069299	.	G	T	6	6	12	0	1	13	0	0
19	35069755	.	C	A	5	5	10	0	1	11	0	0
19	35069934	.	T	G	3	2	5	0	1	6	0	0
19	35070015	.	C	T	5	5	10	0	1	11	0	0
19	35072613	.	A	C	9	3	12	0	0	12	0	0
19	35072712	.	G	C	5	0	5	0	3	8	0	0
19	35075637	.	C	T	0	5	5	0	3	8	0	0
19	35078584	.	T	C	2	0	2	0	3	5	0	0
19	35078632	.	T	C	2	0	2	0	2	4	0	0
19	35079259	.	C	T	1	2	3	0	0	3	0	0
19	35079515	.	A	T	1	2	3	0	0	3	0	0
19	35083010	.	G	A	2	5	7	0	0	7	0	0
19	35083019	.	C	T	3	5	8	0	0	8	0	0
19	35083182	.	C	T	1	6	7	0	0	7	0	0
19	35116297	.	T	C	3	3	6	0	0	6	0	0
19	35116405	.	A	G	2	2	4	0	0	4	0	0
19	35116438	.	G	A	1	2	3	0	0	3	0	0
19	35119436	.	C	T	1	4	5	0	0	5	0	0
19	35135927	.	T	G	2	2	4	0	0	4	0	0
19	35359341	.	C	T	23	26	49	0	2	51	0	0
19	35379998	.	A	G	1	2	3	0	0	3	0	0
19	35419026	.	C	T	0	3	3	0	2	5	0	0
19	35419202	.	A	G	4	3	7	0	0	7	0	0
19	35419292	.	T	A	1	5	6	0	0	6	0	0
19	35419300	.	A	T	1	4	5	0	1	6	0	0
19	35422354	.	T	C	7	11	18	0	2	20	0	0
19	35428735	.	G	A	7	9	16	0	0	16	0	0
19	35433982	.	T	A	1	2	3	0	0	3	0	0
19	35459414	.	A	G	25	12	37	1	5	43	0	0
19	35459737	.	G	A	16	23	39	0	3	42	0	0
19	35459801	.	A	T	20	20	40	0	1	41	0	0
19	35473080	.	C	A	2	8	10	0	16	26	0	0
19	36120265	.	C	T	0	3	3	0	3	6	0	0
19	37133533	.	C	A	6	5	11	0	0	11	0	0
19	37133825	.	G	A	5	4	9	0	0	9	0	0
19	37133844	.	C	T	6	3	9	0	0	9	0	0
19	37133872	.	T	C	2	4	6	0	0	6	0	0
19	37138388	.	G	A	0	5	5	0	13	19	1	0
19	37138643	.	G	A	0	5	5	0	13	18	0	0
19	37138743	.	C	T	8	4	12	0	2	14	0	0
19	37138955	.	A	G	16	9	25	0	0	25	0	0
19	37488830	.	C	T	3	3	6	0	0	6	0	0
19	37501935	.	A	G	22	24	46	0	4	50	0	0
19	37502105	.	A	G	30	25	55	0	4	60	1	0
19	37505808	.	G	A	4	6	10	0	0	10	0	0
19	37858144	.	G	C	5	3	8	0	0	8	0	0
19	37926003	.	C	T	16	8	24	0	3	27	0	0
19	37926066	.	C	A	13	5	18	0	1	19	0	0
19	37926653	.	A	T	4	7	11	0	2	13	0	0
19	37926666	.	C	A	6	9	15	0	0	15	0	0
19	37926816	.	T	G	33	12	45	0	1	46	0	0
19	37926865	.	G	A	27	12	39	0	0	39	0	0
19	37927304	.	G	T	2	24	26	0	12	38	0	0
19	38175515	.	G	C	4	2	6	0	0	6	0	0
19	38240541	.	A	G	3	0	3	0	5	8	0	0
19	40026661	.	T	C	13	8	21	0	1	22	0	0
19	40031002	.	G	A	28	22	50	0	2	52	0	0
19	40039603	.	G	A	1	12	13	0	0	13	0	0
19	40039606	.	T	A	1	11	12	1	1	14	0	0
19	40053055	.	A	G	24	0	24	0	26	50	0	0
19	40053061	.	A	T	24	24	48	0	5	53	0	0
19	40055030	.	A	G	19	35	54	0	1	55	0	0
19	40055305	.	A	G	24	0	24	0	13	37	0	0
19	40055318	.	A	G	21	13	34	0	4	38	0	0
19	40102040	.	A	C	1	3	4	0	0	4	0	0
19	40110840	.	G	A	0	5	5	0	6	11	0	0
19	40113305	.	G	A	0	12	12	0	6	18	0	0
19	40113425	.	C	A	10	7	17	0	2	19	0	0
19	40113549	.	T	G	4	8	12	0	0	12	0	0
19	40113677	.	C	G	7	16	23	0	0	23	0	0
19	40113692	.	G	T	7	12	19	0	0	19	0	0
19	40147821	.	G	A	0	4	4	0	2	6	0	0
19	40151970	.	G	A	4	2	6	0	0	6	0	0
19	40151983	.	C	T	4	2	6	0	0	6	0	0
19	40155144	.	C	A	5	2	7	0	0	7	0	0
19	40156870	.	T	C	6	8	14	0	0	14	0	0
19	40160049	.	T	C	7	3	10	0	0	10	0	0
19	40162945	.	C	A	14	11	25	0	0	25	0	0
19	40163256	.	C	T	18	12	30	0	0	30	0	0
19	40165405	.	A	G	20	14	34	0	0	34	0	0
19	40165681	.	A	G	2	0	2	0	4	6	0	0
19	40177762	.	T	C	2	2	4	0	0	4	0	0
19	40179763	.	G	A	1	3	4	0	4	8	0	0
19	40179858	.	C	A	4	2	6	0	0	6	0	0
19	40180011	.	C	T	4	4	8	0	0	8	0	0
19	40180100	.	A	G	7	3	10	0	1	11	0	0
19	40340319	.	A	G	22	11	33	0	2	35	0	0
19	40344730	.	A	C	14	17	31	1	0	32	0	0
19	40345966	.	G	T	18	28	46	0	1	47	0	0
19	40347600	.	T	G	18	0	18	0	20	38	0	0
19	40347702	.	T	A	28	15	43	0	1	45	1	0
19	40347760	.	T	A	27	18	45	0	3	48	0	0
19	40347785	.	A	T	22	16	38	1	3	42	0	0
19	40347842	.	G	T	3	7	10	1	5	16	0	0
19	40558281	.	A	G	2	6	8	0	0	8	0	0
19	40641433	.	T	C	1	2	3	0	1	4	0	0
19	40685447	.	A	G	8	0	8	0	4	12	0	0
19	40685518	.	G	A	0	3	3	0	3	6	0	0
19	40685520	.	T	C	3	3	6	0	0	6	0	0
19	40685664	.	A	G	1	2	3	0	0	3	0	0
19	40685923	.	T	C	3	4	7	0	0	7	0	0
19	40685935	.	A	G	3	6	9	0	0	9	0	0
19	40686662	.	T	A	4	4	8	0	0	8	0	0
19	40717209	.	T	A	3	2	5	0	1	6	0	0
19	40717649	.	C	A	3	4	7	0	0	7	0	0
19	40859012	.	T	C	14	11	25	0	1	26	0	0
19	40859147	.	C	A	13	12	25	0	0	26	1	0
19	40859207	.	A	G	14	8	22	0	0	22	0	0
19	40859369	.	A	G	17	5	22	0	0	22	0	0
19	40859378	.	T	C	12	4	16	0	3	19	0	0
19	40892312	.	T	C	2	5	7	0	1	8	0	0
19	40895763	.	G	A	5	6	11	0	0	11	0	0
19	40895826	.	T	C	6	7	13	0	0	13	0	0
19	40898468	.	C	T	7	8	15	0	0	15	0	0
19	40900059	.	T	A	7	8	15	0	0	15	0	0
19	40903335	.	G	A	1	6	7	0	0	7	0	0
19	40906094	.	G	A	10	5	15	0	0	15	0	0
19	41021048	.	T	C	1	3	4	0	0	4	0	0
19	41030324	.	A	C	4	4	8	0	0	8	0	0
19	41031941	.	G	A	1	8	9	0	4	13	0	0
19	41033898	.	C	T	9	13	22	0	1	23	0	0
19	41038942	.	C	A	22	27	49	0	1	50	0	0
19	41039012	.	G	C	22	3	25	0	31	56	0	0
19	41052229	.	G	A	24	17	41	0	4	45	0	0
19	41054464	.	T	C	20	0	20	0	25	45	0	0
19	41057049	.	C	A	13	8	21	0	4	25	0	0
19	41057079	.	G	A	13	10	23	0	0	23	0	0
19	41060384	.	C	T	1	6	7	0	8	15	0	0
19	41401637	.	C	A	7	9	16	0	4	20	0	0
19	41401727	.	C	T	0	13	13	0	9	22	0	0
19	41401878	.	G	A	13	10	23	0	1	24	0	0
19	41401926	.	A	G	24	16	40	0	2	42	0	0
19	41401928	.	G	A	25	17	42	0	1	43	0	0
19	41401979	.	G	C	36	15	51	2	2	56	1	0
19	41404250	.	G	A	38	25	63	0	1	64	0	0
19	41404273	.	C	T	3	26	29	0	39	68	0	0
19	41447257	.	A	G	1	6	7	0	0	7	0	0
19	41447368	.	G	A	1	2	3	0	0	3	0	0
19	41447548	.	A	G	4	3	7	0	1	8	0	0
19	41447600	.	G	T	4	2	6	0	0	6	0	0
19	41448040	.	G	A	2	2	4	0	0	4	0	0
19	41448047	.	G	T	2	2	4	0	0	4	0	0
19	41466725	.	T	C	7	8	15	0	0	15	0	0
19	41466726	.	G	A	8	6	14	0	2	16	0	0
19	41466777	.	G	A	1	5	6	0	6	12	0	0
19	41466783	.	T	C	7	4	11	0	0	11	0	0
19	41516204	.	G	T	8	3	11	0	0	11	0	0
19	41516209	.	A	C	9	0	9	0	3	12	0	0
19	41533610	.	T	A	1	2	3	0	0	3	0	0
19	41537398	.	A	C	2	2	4	0	0	4	0	0
19	41537442	.	G	A	3	2	5	0	0	5	0	0
19	41538865	.	A	G	2	2	4	0	0	4	0	0
19	41539065	.	G	A	1	2	3	0	0	3	0	0
19	41539133	.	C	T	1	3	4	0	0	4	0	0
19	41539467	.	T	C	2	3	5	0	0	5	0	0
19	41539516	.	A	T	3	2	5	0	0	5	0	0
19	41539517	.	A	C	3	2	5	0	0	5	0	0
19	41539606	.	T	C	2	2	4	0	0	4	0	0
19	41539708	.	G	C	4	3	7	0	0	7	0	0
19	41539821	.	G	T	1	5	6	0	0	6	0	0
19	41539868	.	A	C	2	4	6	0	0	6	0	0
19	41717013	.	G	C	1	4	5	0	0	5	0	0
19	41723561	.	C	T	5	2	7	0	1	8	0	0
19	41724049	.	G	A	1	3	4	0	1	5	0	0
19	41846849	.	G	T	5	4	9	0	0	9	0	0
19	41849679	.	A	G	8	4	12	0	1	13	0	0
19	41853967	.	G	T	6	4	10	0	0	10	0	0
19	41857795	.	G	A	1	1	2	0	1	3	0	0
19	41857846	.	C	T	3	3	6	0	0	6	0	0
19	41865215	.	C	T	2	3	5	0	0	5	0	0
19	41884108	.	A	G	1	2	3	0	0	3	0	0
19	42047783	.	C	T	1	2	3	0	1	4	0	0
19	42061290	.	C	T	11	7	18	0	0	18	0	0
19	42061441	.	C	G	14	3	17	0	1	18	0	0
19	42061455	.	A	G	13	6	19	0	0	19	0	0
19	42061491	.	C	T	12	6	18	0	2	20	0	0
19	42061521	.	A	G	11	11	22	0	1	23	0	0
19	42061605	.	A	G	16	1	17	0	8	25	0	0
19	42063771	.	A	G	1	0	1	0	4	5	0	0
19	42065010	.	C	T	17	14	31	0	0	31	0	0
19	42066899	.	T	C	16	17	33	0	2	35	0	0
19	42067065	.	T	C	17	19	36	0	1	37	0	0
19	42067149	.	T	C	19	16	35	0	0	35	0	0
19	42068537	.	A	C	21	23	44	0	0	44	0	0
19	42117777	.	A	T	8	11	19	0	0	19	0	0
19	42118040	.	T	G	17	8	25	0	1	26	0	0
19	42118441	.	T	A	7	3	10	0	0	10	0	0
19	42235042	.	G	C	4	4	8	0	1	9	0	0
19	42235161	.	G	T	5	6	11	0	0	11	0	0
19	42235205	.	A	G	2	7	9	0	0	9	0	0
19	42235286	.	A	T	12	6	18	0	0	18	0	0
19	42235655	.	A	C	9	9	18	0	2	20	0	0
19	42241740	.	G	T	4	4	8	0	0	8	0	0
19	42241755	.	G	T	5	6	11	0	0	11	0	0
19	42244118	.	G	A	5	4	9	0	0	9	0	0
19	42244281	.	T	C	4	0	4	0	3	7	0	0
19	42244342	.	G	T	1	2	3	0	0	3	0	0
19	42328467	.	T	C	13	14	27	0	1	28	0	0
19	42328510	.	C	T	16	17	33	1	0	34	0	0
19	42336375	.	G	A	21	9	30	0	0	30	0	0
19	42336526	.	C	T	21	15	36	0	2	38	0	0
19	42336636	.	C	T	19	15	34	0	3	37	0	0
19	42336675	.	C	T	17	17	34	1	1	36	0	0
19	42340452	.	A	G	10	1	11	0	6	17	0	0
19	42340455	.	C	T	10	7	17	0	0	17	0	0
19	42340508	.	G	C	24	13	37	0	1	38	0	0
19	42340658	.	G	A	3	25	28	0	26	54	0	0
19	42340855	.	G	A	1	17	18	0	22	40	0	0
19	42341530	.	T	C	20	29	49	0	2	53	2	0
19	42341613	.	T	A	14	36	50	0	8	58	0	0
19	42341693	.	G	A	25	22	47	0	2	49	0	0
19	42367500	.	T	A	3	4	7	0	0	7	0	0
19	42367531	.	G	A	3	3	6	0	0	6	0	0
19	42368065	.	C	T	1	4	5	0	9	14	0	0
19	42368511	.	A	C	1	2	3	0	0	3	0	0
19	42368619	.	T	A	3	2	5	0	0	5	0	0
19	42368620	.	T	C	3	0	3	0	2	5	0	0
19	42374298	.	C	A	1	4	5	0	0	5	0	0
19	42397530	.	A	G	3	5	8	0	1	9	0	0
19	42397975	.	G	A	17	9	26	0	1	28	1	0
19	42400567	.	A	G	12	17	29	1	2	32	0	0
19	42402060	.	G	A	15	8	23	0	0	23	0	0
19	42402382	.	A	G	5	9	14	0	0	14	0	0
19	42455352	.	G	A	1	3	4	0	1	5	0	0
19	42458099	.	T	C	12	15	27	0	1	28	0	0
19	42458112	.	T	A	11	20	31	0	1	32	0	0
19	42459868	.	T	A	28	15	43	0	3	46	0	0
19	42491132	.	G	T	8	8	16	0	1	17	0	0
19	42493255	.	C	T	15	6	21	0	0	21	0	0
19	42493353	.	T	A	11	9	20	0	3	23	0	0
19	42493986	.	G	T	9	7	16	0	0	16	0	0
19	42494130	.	T	C	11	1	12	0	5	17	0	0
19	42495678	.	T	G	12	6	18	0	0	18	0	0
19	42495829	.	G	A	11	5	16	0	0	16	0	0
19	42495850	.	G	A	6	4	10	0	2	12	0	0
19	42502572	.	T	G	1	2	3	0	0	3	0	0
19	42573150	.	A	G	2	2	4	0	0	4	0	0
19	42573153	.	T	A	2	2	4	0	0	4	0	0
19	42574042	.	C	A	2	5	7	0	1	8	0	0
19	42574523	.	A	T	1	3	4	0	0	4	0	0
19	42678624	.	G	A	2	2	4	0	4	8	0	0
19	42682502	.	A	G	4	5	9	0	1	10	0	0
19	42682504	.	G	A	0	4	4	0	6	10	0	0
19	42682628	.	G	A	6	4	10	0	0	10	0	0
19	42682678	.	C	T	4	5	9	0	0	9	0	0
19	42682699	.	C	A	4	5	9	0	0	9	0	0
19	42720227	.	G	A	5	2	7	0	0	7	0	0
19	42720248	.	C	T	1	3	4	0	1	5	0	0
19	42735350	.	C	A	2	3	5	0	1	6	0	0
19	42740353	.	G	C	2	3	5	0	0	5	0	0
19	42743837	.	G	A	1	2	3	0	0	3	0	0
19	42747212	.	G	A	0	3	3	0	4	7	0	0
19	42754892	.	C	T	3	7	10	0	0	10	0	0
19	42774755	.	G	A	16	7	23	0	0	23	0	0
19	42791291	.	T	C	23	19	42	0	2	44	0	0
19	42795751	.	A	G	20	25	45	0	2	47	0	0
19	42795799	.	C	T	22	24	46	0	4	50	0	0
19	42798696	.	C	T	35	19	54	0	1	55	0	0
19	42801687	.	G	A	7	26	33	0	32	65	0	0
19	42801708	.	T	A	34	21	55	0	4	59	0	0
19	42802018	.	C	A	29	38	67	0	1	68	0	0
19	42802075	.	T	C	30	27	57	0	2	59	0	0
19	42802077	.	C	T	28	26	54	0	5	59	0	0
19	42826201	.	T	C	1	3	4	0	0	4	0	0
19	42835133	.	C	T	2	4	6	0	0	6	0	0
19	42841599	.	A	C	3	4	7	0	0	7	0	0
19	42843725	.	A	C	9	4	13	0	0	13	0	0
19	42843751	.	A	T	3	4	7	0	3	10	0	0
19	42843894	.	A	G	7	10	17	0	2	19	0	0
19	42843917	.	T	C	12	5	17	0	2	19	0	0
19	42868330	.	T	C	5	5	10	0	1	11	0	0
19	42868446	.	A	G	3	3	6	0	0	6	0	0
19	42870307	.	T	G	8	0	8	0	8	16	0	0
19	42870512	.	C	T	6	7	13	0	1	14	0	0
19	42872200	.	G	C	15	11	26	0	1	28	1	0
19	42873858	.	G	A	2	10	12	0	11	23	0	0
19	42874075	.	C	G	3	15	18	0	0	18	0	0
19	42874172	.	C	T	13	10	23	0	1	24	0	0
19	42874188	.	A	G	9	0	9	0	15	24	0	0
19	42874231	.	C	T	16	12	28	0	3	31	0	0
19	42874301	.	G	A	15	13	28	0	0	28	0	0
19	42874336	.	G	C	13	11	24	0	2	26	0	0
19	42874414	.	T	C	18	7	25	0	3	28	0	0
19	42874439	.	T	G	17	0	17	0	4	21	0	0
19	42874564	.	G	A	10	6	16	0	1	17	0	0
19	42874674	.	A	G	13	18	31	0	0	31	0	0
19	42875103	.	A	T	13	6	19	0	1	20	0	0
19	42894574	.	G	A	1	3	4	0	0	4	0	0
19	42894603	.	A	T	1	2	3	0	0	3	0	0
19	42908916	.	T	A	4	6	10	0	0	10	0	0
19	42909168	.	C	T	3	6	9	0	1	10	0	0
19	42912376	.	C	A	9	14	23	0	0	23	0	0
19	42912394	.	G	A	2	5	7	0	14	21	0	0
19	42919465	.	C	T	0	5	5	0	7	12	0	0
19	42928242	.	C	T	1	3	4	0	2	6	0	0
19	42928647	.	C	T	0	8	8	0	2	10	0	0
19	42928845	.	C	A	0	2	2	0	2	4	0	0
19	42988059	.	C	T	27	27	54	0	1	56	1	0
19	42997087	.	G	A	9	3	12	0	0	12	0	0
19	42997106	.	C	G	13	4	17	0	0	17	0	0
19	43000034	.	G	C	15	0	15	0	13	28	0	0
19	43000067	.	C	T	10	12	22	0	0	22	0	0
19	43000070	.	A	G	8	12	20	0	0	20	0	0
19	43002605	.	A	C	8	5	13	0	0	13	0	0
19	43004118	.	G	A	4	5	9	0	2	11	0	0
19	43004133	.	T	C	3	5	8	0	0	8	0	0
19	43004221	.	T	G	6	7	13	0	1	14	0	0
19	43004259	.	A	G	7	9	16	0	1	17	0	0
19	43004283	.	T	C	7	7	14	0	0	14	0	0
19	43004297	.	C	A	5	6	11	0	0	11	0	0
19	43007838	.	T	C	3	3	6	0	0	6	0	0
19	43007913	.	C	T	1	3	4	0	1	5	0	0
19	43009476	.	C	T	4	5	9	0	0	9	0	0
19	43015255	.	A	C	3	3	6	0	0	6	0	0
19	43015276	.	C	A	2	2	4	0	0	4	0	0
19	43015564	.	C	T	3	2	5	0	1	6	0	0
19	43018257	.	G	A	1	16	17	0	4	21	0	0
19	43018352	.	T	C	5	8	13	0	1	14	0	0
19	43029462	.	G	A	0	21	21	0	27	48	0	0
19	43030654	.	G	A	25	23	48	0	3	51	0	0
19	43030655	.	A	G	27	25	52	0	0	52	0	0
19	43031169	.	G	A	3	21	24	0	26	50	0	0
19	43031261	.	G	A	1	9	10	0	9	19	0	0
19	43031264	.	A	G	15	3	18	0	0	18	0	0
19	43062374	.	T	A	1	3	4	0	1	5	0	0
19	43068174	.	C	G	2	3	5	0	0	5	0	0
19	43072588	.	T	C	6	3	9	0	0	9	0	0
19	43072645	.	G	A	1	2	3	0	6	9	0	0
19	43072663	.	C	T	3	6	9	0	1	10	0	0
19	43074584	.	T	A	6	7	13	0	2	15	0	0
19	43074635	.	C	T	8	5	13	0	1	14	0	0
19	43074668	.	G	T	11	3	14	0	0	14	0	0
19	43074692	.	G	C	4	12	16	0	0	16	0	0
19	43074716	.	G	A	4	8	12	0	0	12	0	0
19	43076458	.	C	T	5	9	14	0	0	14	0	0
19	43083844	.	C	T	14	16	30	0	1	31	0	0
19	43120316	.	C	T	26	24	50	11	3	64	0	0
19	43120471	.	T	C	27	34	61	0	4	65	0	0
19	43121440	.	G	A	24	45	69	1	2	72	0	0
19	43121700	.	G	A	4	5	9	78	0	87	0	0
19	43121736	.	G	A	29	17	46	38	0	84	0	0
19	43121784	.	C	T	27	38	65	2	2	69	0	0
19	43121826	.	T	C	39	36	75	3	4	82	0	0
19	43126014	.	G	A	12	23	35	11	1	47	0	0
19	43126104	.	C	T	6	13	19	30	0	49	0	0
19	43126113	.	C	T	13	7	20	23	1	44	0	0
19	43126140	.	C	T	20	11	31	0	2	33	0	0
19	43129049	.	G	T	1	14	15	0	17	32	0	0
19	43129076	.	A	G	17	14	31	0	5	36	0	0
19	43133087	.	A	G	12	13	25	0	2	27	0	0
19	43305757	.	G	A	0	3	3	0	2	5	0	0
19	43350276	.	T	G	1	2	3	0	0	3	0	0
19	43357197	.	C	A	2	1	3	0	2	5	0	0
19	43494040	.	A	C	5	4	9	0	0	9	0	0
19	43494452	.	G	T	1	2	3	0	0	3	0	0
19	43494456	.	G	C	1	2	3	0	0	3	0	0
19	43494700	.	C	T	5	5	10	0	0	10	0	0
19	43494911	.	C	T	7	5	12	0	1	13	0	0
19	43495202	.	C	G	6	0	6	0	9	15	0	0
19	43495376	.	G	A	1	9	10	0	5	15	0	0
19	43498940	.	A	G	10	7	17	0	0	17	0	0
19	43499311	.	C	T	10	15	25	0	0	25	0	0
19	43499616	.	T	C	14	16	30	0	2	32	0	0
19	43499930	.	G	T	12	9	21	0	1	22	0	0
19	43499942	.	A	T	9	8	17	0	3	20	0	0
19	43542758	.	A	C	2	2	4	0	0	4	0	0
19	43547605	.	T	C	7	5	12	0	1	13	0	0
19	43547685	.	A	T	2	5	7	0	0	7	0	0
19	43547876	.	C	A	4	5	9	1	0	10	0	0
19	43547906	.	C	T	0	2	2	1	8	11	0	0
19	43548910	.	T	A	6	6	12	0	1	13	0	0
19	43549200	.	C	T	1	10	11	0	15	26	0	0
19	43549215	.	T	C	7	14	21	0	0	21	0	0
19	43549305	.	A	G	8	7	15	0	0	15	0	0
19	43549554	.	C	T	3	4	7	0	1	8	0	0
19	43549860	.	G	T	2	5	7	0	0	7	0	0
19	43552189	.	C	A	0	3	3	0	1	4	0	0
19	43688667	.	G	A	1	1	2	0	1	3	0	0
19	43693915	.	C	T	1	2	3	0	1	4	0	0
19	43704744	.	C	T	3	3	6	0	0	6	0	0
19	43706681	.	T	C	7	4	11	0	0	11	0	0
19	43706684	.	C	T	6	4	10	0	0	10	0	0
19	43706736	.	G	A	0	3	3	0	4	7	0	0
19	43706808	.	G	C	5	2	7	0	0	7	0	0
19	43707228	.	T	G	1	2	3	0	0	3	0	0
19	43707261	.	A	T	2	1	3	0	1	4	0	0
19	43725331	.	T	C	2	2	4	0	0	4	0	0
19	43727110	.	A	C	1	2	3	0	0	3	0	0
19	43736765	.	G	A	0	2	2	0	2	4	0	0
19	43738237	.	C	T	15	20	35	1	2	38	0	0
19	43740988	.	A	C	29	12	41	0	0	41	0	0
19	43748671	.	A	C	9	5	14	0	0	14	0	0
19	43748672	.	G	C	9	5	14	0	0	14	0	0
19	43750020	.	T	C	5	0	5	0	4	9	0	0
19	43750085	.	A	G	4	3	7	0	0	7	0	0
19	43782397	.	G	T	28	32	60	0	3	63	0	0
19	43783581	.	C	T	27	22	49	0	2	51	0	0
19	43825877	.	G	T	7	5	12	0	0	12	0	0
19	43831544	.	G	A	5	7	12	0	1	13	0	0
19	43831701	.	C	T	4	7	11	0	2	13	0	0
19	43878258	.	C	T	3	12	15	0	0	15	0	0
19	43880674	.	C	T	9	10	19	0	1	20	0	0
19	43890059	.	G	A	0	2	2	0	2	4	0	0
19	43890068	.	G	A	0	2	2	0	1	3	0	0
19	43891949	.	C	T	4	2	6	0	0	6	0	0
19	43898915	.	C	A	19	10	29	0	0	29	0	0
19	43899451	.	A	T	7	7	14	0	0	14	0	0
19	43899721	.	G	T	2	3	5	0	1	6	0	0
19	43899765	.	G	T	1	2	3	0	0	3	0	0
19	43899767	.	A	G	1	2	3	0	0	3	0	0
19	43899811	.	T	A	2	6	8	0	2	10	0	0
19	43899851	.	A	G	7	4	11	0	2	13	0	0
19	43899891	.	G	A	3	4	7	0	2	9	0	0
19	43899936	.	G	A	7	7	14	0	2	16	0	0
19	43900013	.	A	G	3	4	7	0	0	7	0	0
19	43900568	.	G	A	3	5	8	0	0	8	0	0
19	43900585	.	A	T	3	7	10	0	0	10	0	0
19	43900630	.	C	T	7	11	18	0	0	18	0	0
19	43901305	.	A	C	15	11	26	0	0	26	0	0
19	43971087	.	A	G	1	3	4	0	1	5	0	0
19	43971171	.	T	C	1	2	3	0	0	3	0	0
19	43974224	.	A	T	10	3	13	1	0	14	0	0
19	43976249	.	G	A	7	7	14	0	1	15	0	0
19	43976286	.	C	T	6	6	12	0	0	12	0	0
19	44049755	.	G	A	37	12	49	0	3	52	0	0
19	44052585	.	A	C	34	34	68	0	4	73	1	0
19	44052588	.	A	G	33	34	67	0	3	70	0	0
19	44054457	.	C	T	33	23	56	0	5	61	0	0
19	44059793	.	G	C	5	3	8	0	0	8	0	0
19	44063597	.	A	G	6	7	13	0	0	13	0	0
19	44063620	.	T	C	8	7	15	0	0	15	0	0
19	44063765	.	G	T	2	7	9	0	0	9	0	0
19	44063766	.	T	G	1	7	8	0	1	9	0	0
19	44068272	.	G	A	15	6	21	0	0	21	0	0
19	44068292	.	A	G	15	7	22	0	0	22	0	0
19	44068328	.	G	A	15	7	22	0	2	24	0	0
19	44068378	.	C	A	4	17	21	0	0	21	0	0
19	44068543	.	G	A	12	12	24	0	0	24	0	0
19	44084043	.	G	A	6	5	11	0	0	11	0	0
19	45856213	.	T	C	4	8	12	0	0	12	0	0
19	45856414	.	A	G	25	18	43	0	1	44	0	0
19	45859824	.	C	T	11	15	26	2	6	34	0	0
19	45896193	.	C	T	12	7	19	0	2	21	0	0
19	45965617	.	A	G	10	0	10	0	3	13	0	0
19	45967297	.	C	G	7	0	7	0	7	14	0	0
19	45967372	.	G	A	8	12	20	0	1	21	0	0
19	45980423	.	T	A	5	1	6	0	1	7	0	0
19	45980428	.	A	C	5	1	6	0	1	7	0	0
19	45994212	.	A	G	7	5	12	0	0	12	0	0
19	45994263	.	T	C	3	5	8	0	0	8	0	0
19	45997919	.	T	A	4	3	7	0	0	7	0	0
19	45997964	.	A	G	1	4	5	0	0	5	0	0
19	45999081	.	G	A	2	5	7	0	0	7	0	0
19	46001101	.	A	G	3	4	7	0	0	7	0	0
19	46020177	.	A	C	6	0	6	0	10	16	0	0
19	46020228	.	G	A	11	8	19	0	2	21	0	0
19	46020276	.	C	T	1	11	12	0	6	18	0	0
19	46020462	.	G	A	16	8	24	0	0	24	0	0
19	46020471	.	G	T	16	7	23	0	1	24	0	0
19	46020544	.	G	C	8	0	8	0	10	18	0	0
19	46022418	.	A	G	9	7	16	0	0	16	0	0
19	46028151	.	T	A	5	6	11	0	0	11	0	0
19	46202060	.	T	C	1	2	3	0	0	3	0	0
19	46202110	.	G	A	1	2	3	0	0	3	0	0
19	46209433	.	G	A	0	2	2	0	1	3	0	0
19	46210120	.	G	T	3	2	5	0	2	7	0	0
19	46210209	.	A	T	4	5	9	0	0	9	0	0
19	46210242	.	G	C	3	3	6	0	1	7	0	0
19	46210286	.	A	G	3	4	7	0	0	7	0	0
19	46210354	.	A	T	2	4	6	0	0	6	0	0
19	46210355	.	T	G	1	3	4	0	2	6	0	0
19	46210565	.	A	T	2	2	4	0	1	5	0	0
19	46225972	.	G	A	12	5	17	0	0	17	0	0
19	46237787	.	C	T	14	13	27	0	1	28	0	0
19	46237794	.	A	T	11	15	26	0	3	29	0	0
19	46237844	.	G	T	0	13	13	0	12	25	0	0
19	46238297	.	T	G	1	5	6	0	0	6	0	0
19	46238366	.	T	C	1	2	3	0	0	3	0	0
19	46238382	.	G	A	0	4	4	0	1	5	0	0
19	46238538	.	C	T	3	2	5	0	0	5	0	0
19	46259649	.	A	G	1	2	3	0	0	3	0	0
19	46259660	.	A	T	1	2	3	0	0	3	0	0
19	46259709	.	G	A	1	3	4	0	0	4	0	0
19	46280672	.	G	T	1	4	5	0	4	9	0	0
19	46288632	.	T	C	5	2	7	0	1	8	0	0
19	46303140	.	C	T	14	15	29	0	1	30	0	0
19	46303320	.	G	A	17	10	27	0	1	28	0	0
19	46303330	.	G	A	1	10	11	0	19	30	0	0
19	46303414	.	C	T	22	20	42	0	0	42	0	0
19	46303457	.	A	T	19	23	42	0	0	42	0	0
19	46309664	.	C	A	2	3	5	0	0	5	0	0
19	46309686	.	A	G	1	1	2	0	1	3	0	0
19	46373704	.	T	G	12	11	23	0	0	23	0	0
19	46373705	.	G	T	11	11	22	0	1	23	0	0
19	47976325	.	C	T	22	34	56	0	2	58	0	0
19	47976449	.	A	T	14	5	19	0	3	22	0	0
19	47982897	.	A	G	10	19	29	0	1	30	0	0
19	47983014	.	C	G	15	12	27	0	1	28	0	0
19	47983859	.	G	A	12	9	21	0	1	22	0	0
19	47984483	.	C	T	9	8	17	0	3	20	0	0
19	47986324	.	C	T	1	11	12	0	6	18	0	0
19	47989417	.	T	C	6	6	12	0	3	15	0	0
19	48013142	.	G	A	10	7	17	0	0	17	0	0
19	48013172	.	A	G	7	8	15	0	0	15	0	0
19	48014266	.	A	G	1	2	3	0	0	3	0	0
19	48022023	.	G	A	3	13	16	0	21	37	0	0
19	48022989	.	T	G	20	19	39	0	1	40	0	0
19	48023309	.	A	G	25	3	28	0	22	50	0	0
19	48031094	.	T	C	5	5	10	0	0	10	0	0
19	48032167	.	G	A	0	6	6	0	5	11	0	0
19	48033631	.	A	G	13	12	25	0	0	25	0	0
19	48036809	.	T	G	15	0	15	0	23	38	0	0
19	48049279	.	T	G	5	4	9	0	0	9	0	0
19	48053315	.	A	C	11	7	18	0	0	18	0	0
19	48064790	.	C	T	1	2	3	0	0	3	0	0
19	48065164	.	T	C	3	2	5	0	0	5	0	0
19	48067046	.	C	T	6	3	9	0	1	10	0	0
19	48069366	.	T	C	11	9	20	0	2	22	0	0
19	48102625	.	A	G	4	0	4	0	8	12	0	0
19	48102652	.	C	T	3	7	10	0	1	11	0	0
19	48114344	.	T	A	6	6	12	0	0	12	0	0
19	48119203	.	T	C	28	23	51	6	4	61	0	0
19	48120238	.	A	G	9	1	10	0	17	27	0	0
19	48284234	.	A	T	3	5	8	0	0	8	0	0
19	48363331	.	T	G	1	1	2	0	1	3	0	0
19	48364835	.	T	A	3	9	12	0	0	12	0	0
19	48364848	.	C	T	0	8	8	0	3	11	0	0
19	48364870	.	T	C	13	8	21	0	1	22	0	0
2	19225	.	T	C	27	16	43	0	1	44	0	0
2	19568	.	G	A	20	9	29	0	6	35	0	0
2	21074	.	A	G	15	14	29	0	3	32	0	0
2	21479	.	C	T	2	15	17	0	10	27	0	0
2	98426	.	T	G	2	3	5	0	0	5	0	0
2	108000	.	C	T	7	8	15	0	0	15	0	0
2	108586	.	G	A	1	11	12	0	10	22	0	0
2	109030	.	G	A	6	21	27	0	1	28	0	0
2	109075	.	T	C	4	14	18	1	3	22	0	0
2	113654	.	A	G	1	2	3	0	0	3	0	0
2	280612	.	A	G	4	3	7	0	1	8	0	0
2	1213640	.	C	T	2	3	5	0	0	5	0	0
2	1215156	.	G	A	0	2	2	0	1	3	0	0
2	1215160	.	A	G	0	2	2	0	0	2	0	0
2	1220802	.	T	C	12	12	24	0	1	25	0	0
2	1595275	.	T	C	9	19	28	0	0	28	0	0
2	1595897	.	T	C	4	8	12	0	0	12	0	0
2	1596159	.	C	T	0	3	3	0	1	4	0	0
2	1596165	.	T	C	2	3	5	0	1	6	0	0
2	1596717	.	T	C	2	3	5	0	1	6	0	0
2	2737855	.	T	C	2	3	5	0	0	5	0	0
2	2748969	.	C	G	1	4	5	0	0	5	0	0
2	2748971	.	A	C	1	4	5	0	0	5	0	0
2	3027065	.	T	A	4	3	7	1	0	8	0	0
2	3027066	.	A	T	4	3	7	1	0	8	0	0
2	3028893	.	A	G	2	4	6	0	0	6	0	0
2	3028908	.	A	T	1	3	4	0	1	5	0	0
2	4045400	.	T	C	11	5	16	0	0	16	0	0
2	4045640	.	T	C	5	5	10	0	0	10	0	0
2	4387329	.	A	G	3	2	5	0	0	5	0	0
2	4900650	.	T	C	39	9	48	0	4	52	0	0
2	4900798	.	T	C	18	27	45	0	2	47	0	0
2	5407096	.	A	G	4	3	7	0	0	7	0	0
2	5407137	.	A	G	4	4	8	0	0	8	0	0
2	5407142	.	A	G	4	4	8	0	0	8	0	0
2	5480576	.	C	T	4	3	7	0	0	7	0	0
2	5480620	.	T	C	5	3	8	0	0	8	0	0
2	5480710	.	A	G	3	10	13	0	0	13	0	0
2	5480733	.	C	T	4	5	9	0	1	10	0	0
2	5481067	.	G	A	16	6	22	0	0	22	0	0
2	5482081	.	G	T	1	5	6	0	0	6	0	0
2	5482112	.	T	A	4	8	12	0	0	12	0	0
2	5482157	.	G	A	4	9	13	1	2	16	0	0
2	5482175	.	A	G	4	9	13	1	0	14	0	0
2	5513504	.	G	C	1	2	3	0	0	3	0	0
2	5544076	.	T	C	6	0	6	0	4	10	0	0
2	5544261	.	C	G	11	10	21	0	2	23	0	0
2	5578745	.	C	T	2	7	9	0	1	10	0	0
2	5578772	.	C	T	2	4	6	0	1	7	0	0
2	5578820	.	T	A	1	6	7	0	0	7	0	0
2	5578872	.	A	G	3	1	4	0	3	7	0	0
2	5578936	.	A	T	4	4	8	0	0	8	0	0
2	5579111	.	A	G	2	4	6	0	0	6	0	0
2	5579120	.	G	A	1	3	4	0	2	6	0	0
2	5579246	.	A	G	2	4	6	0	2	8	0	0
2	5579415	.	G	A	1	2	3	0	0	3	0	0
2	5579721	.	G	A	1	4	5	0	0	5	0	0
2	5579989	.	C	T	6	5	11	0	0	11	0	0
2	5580017	.	A	G	6	5	11	0	0	11	0	0
2	5580046	.	A	G	8	4	12	0	0	12	0	0
2	5580140	.	G	A	6	5	11	1	0	12	0	0
2	5580249	.	A	G	4	2	6	0	0	6	0	0
2	5580439	.	T	C	8	7	15	0	2	17	0	0
2	5580510	.	C	T	5	14	19	0	0	19	0	0
2	5580544	.	A	G	7	19	26	0	0	26	0	0
2	5580592	.	C	T	12	10	22	0	0	22	0	0
2	5580644	.	A	G	7	0	7	2	6	15	0	0
2	5580887	.	G	T	7	2	9	5	0	14	0	0
2	5581233	.	C	T	5	12	17	0	1	18	0	0
2	5581234	.	G	T	1	10	11	0	7	18	0	0
2	5581482	.	T	A	11	9	20	0	4	24	0	0
2	5581612	.	A	G	10	7	17	0	1	18	0	0
2	5581660	.	T	A	15	10	25	0	1	26	0	0
2	5601282	.	A	T	1	4	5	0	0	5	0	0
2	5621176	.	A	T	5	5	10	0	0	10	0	0
2	5621360	.	C	T	5	4	9	0	0	9	0	0
2	5621394	.	A	C	5	5	10	0	1	11	0	0
2	5644548	.	C	T	8	9	17	0	1	18	0	0
2	5677650	.	C	T	11	10	21	0	0	21	0	0
2	5681049	.	A	C	21	19	40	0	3	43	0	0
2	5681388	.	T	G	17	1	18	0	17	35	0	0
2	5681446	.	T	C	14	16	30	0	1	31	0	0
2	5709579	.	T	C	8	0	8	1	12	21	0	0
2	5709663	.	C	G	7	12	19	0	0	19	0	0
2	5709670	.	T	A	11	13	24	0	0	24	0	0
2	5709746	.	T	A	15	8	23	0	1	24	0	0
2	5709782	.	C	T	14	6	20	0	0	20	0	0
2	5709843	.	C	A	18	8	26	0	1	27	0	0
2	5709850	.	T	G	16	6	22	0	3	25	0	0
2	5711684	.	C	A	14	12	26	0	1	27	0	0
2	5714194	.	A	G	11	8	19	0	0	19	0	0
2	5714303	.	G	T	11	21	32	0	0	32	0	0
2	5714789	.	C	T	14	15	29	0	1	30	0	0
2	5714813	.	C	T	4	8	12	0	13	25	0	0
2	5716793	.	T	C	3	14	17	0	1	18	0	0
2	5721008	.	C	T	0	2	2	0	8	11	1	0
2	5723497	.	A	G	7	4	11	0	1	12	0	0
2	5723515	.	A	G	6	3	9	0	0	9	0	0
2	5735134	.	C	T	0	3	3	0	3	6	0	0
2	5741305	.	C	G	2	4	6	0	0	6	0	0
2	5811620	.	A	C	1	2	3	0	0	3	0	0
2	5811863	.	A	G	5	6	11	0	1	12	0	0
2	5812007	.	G	A	2	4	6	0	0	6	0	0
2	5812046	.	A	G	2	5	7	0	0	7	0	0
2	5812133	.	T	C	6	3	9	0	0	9	0	0
2	5817327	.	T	G	2	3	5	0	0	5	0	0
2	5843885	.	G	A	2	3	5	0	0	5	0	0
2	5844126	.	A	T	2	3	5	0	0	5	0	0
2	5872652	.	C	T	5	2	7	0	0	7	0	0
2	5873674	.	T	C	1	3	4	0	0	4	0	0
2	5880396	.	G	A	6	3	9	0	0	9	0	0
2	5880435	.	T	C	3	6	9	0	0	9	0	0
2	5882441	.	A	G	7	2	9	0	2	11	0	0
2	5882527	.	C	T	3	2	5	0	1	6	0	0
2	5882726	.	T	C	4	5	9	0	0	9	0	0
2	5884008	.	C	T	8	5	13	0	0	13	0	0
2	5884019	.	A	T	7	4	11	0	0	11	0	0
2	5884263	.	A	T	13	3	16	0	1	17	0	0
2	5884265	.	A	G	13	0	13	0	4	17	0	0
2	5884322	.	C	T	7	13	20	0	0	20	0	0
2	5912288	.	C	G	3	0	3	0	2	5	0	0
2	5921661	.	C	T	2	4	6	0	0	6	0	0
2	5924085	.	A	T	4	4	8	0	0	8	0	0
2	5924135	.	G	A	3	4	7	0	0	7	0	0
2	5924170	.	T	A	2	2	4	0	0	4	0	0
2	5934076	.	T	A	8	6	14	3	1	18	0	0
2	5934256	.	A	T	3	10	13	0	3	16	0	0
2	5934781	.	G	A	9	6	15	0	2	17	0	0
2	5934806	.	C	T	5	10	15	0	1	16	0	0
2	5934828	.	A	T	8	11	19	0	0	19	0	0
2	5934920	.	G	C	4	9	13	0	0	13	0	0
2	5935097	.	A	G	6	2	8	1	2	11	0	0
2	5935132	.	C	T	7	4	11	2	0	13	0	0
2	5935134	.	A	C	7	4	11	2	0	13	0	0
2	5936465	.	G	T	1	2	3	0	0	3	0	0
2	5942155	.	C	T	2	2	4	0	0	4	0	0
2	6015472	.	G	A	1	4	5	0	1	6	0	0
2	6266369	.	T	C	2	2	4	0	0	4	0	0
2	7150995	.	T	A	5	4	9	0	0	9	0	0
2	7150997	.	T	G	5	4	9	0	0	9	0	0
2	7422927	.	C	T	0	2	2	0	3	5	0	0
2	7422939	.	T	C	3	0	3	0	4	7	0	0
2	7423142	.	T	C	2	0	2	0	3	5	0	0
2	7764894	.	C	T	5	17	22	0	14	36	0	0
2	7764983	.	T	C	15	0	15	0	16	31	0	0
2	7765145	.	A	G	3	4	7	0	0	7	0	0
2	7765308	.	A	T	8	6	14	0	0	14	0	0
2	7765613	.	C	T	6	3	9	0	0	9	0	0
2	7765685	.	A	G	4	8	12	0	1	13	0	0
2	7923987	.	T	C	1	8	9	0	1	10	0	0
2	7924183	.	A	T	11	21	32	0	0	32	0	0
2	7924713	.	T	C	20	23	43	0	1	44	0	0
2	7924867	.	G	A	20	16	36	0	2	38	0	0
2	7937238	.	C	T	2	9	11	0	17	28	0	0
2	7943854	.	G	A	8	7	15	0	0	15	0	0
2	7954914	.	G	A	5	7	12	0	0	12	0	0
2	7956982	.	T	C	3	8	11	0	0	11	0	0
2	7959294	.	T	C	10	3	13	0	0	13	0	0
2	7979881	.	T	C	1	2	3	0	0	3	0	0
2	7979938	.	G	A	2	3	5	0	0	5	0	0
2	7982680	.	G	A	1	2	3	0	2	5	0	0
2	8017314	.	C	T	3	2	5	0	0	5	0	0
2	8064838	.	G	A	2	4	6	0	0	6	0	0
2	8112516	.	C	T	10	5	15	0	0	15	0	0
2	8112611	.	G	A	4	5	9	0	0	9	0	0
2	8112679	.	C	A	4	7	11	0	1	12	0	0
2	8112687	.	A	T	1	7	8	0	3	11	0	0
2	8113705	.	T	C	12	13	25	0	0	25	0	0
2	8114005	.	G	T	2	12	14	0	17	31	0	0
2	8114362	.	A	T	7	20	27	1	1	29	0	0
2	10149883	.	C	G	10	0	10	2	10	25	3	0
2	10604787	.	A	T	2	2	4	0	0	4	0	0
2	10604898	.	A	C	1	5	6	0	0	6	0	0
2	10605096	.	T	G	5	8	13	0	1	14	0	0
2	10605213	.	G	C	3	2	5	0	1	6	0	0
2	10605845	.	G	T	1	3	4	0	0	4	0	0
2	10606297	.	C	T	4	4	8	0	0	8	0	0
2	10606315	.	G	C	4	2	6	0	0	6	0	0
2	10606509	.	A	G	2	2	4	0	0	4	0	0
2	10606516	.	T	G	2	2	4	0	0	4	0	0
2	10678202	.	C	T	2	4	6	0	0	6	0	0
2	10678244	.	G	T	2	2	4	0	0	4	0	0
2	10685672	.	A	G	6	0	6	0	6	12	0	0
2	10685850	.	T	C	4	3	7	0	0	7	0	0
2	10685890	.	G	C	5	3	8	0	0	8	0	0
2	10686209	.	G	A	0	3	3	0	5	8	0	0
2	10686277	.	A	C	5	2	7	0	1	8	0	0
2	10686280	.	G	A	6	2	8	0	0	8	0	0
2	10686341	.	A	C	2	4	6	0	0	6	0	0
2	10686805	.	A	G	3	0	3	0	4	7	0	0
2	10686898	.	G	C	2	8	10	0	3	13	0	0
2	10687002	.	G	T	1	3	4	0	0	4	0	0
2	10698150	.	T	C	36	25	61	0	1	62	0	0
2	10791593	.	A	G	3	3	6	0	1	7	0	0
2	10791702	.	A	G	2	4	6	0	0	6	0	0
2	10813148	.	G	C	2	3	5	0	0	5	0	0
2	10813152	.	C	T	3	3	6	0	1	7	0	0
2	10813298	.	T	A	2	2	4	0	0	4	0	0
2	10813438	.	C	G	1	2	3	0	0	3	0	0
2	10813499	.	C	T	0	2	2	0	1	3	0	0
2	10813500	.	G	T	1	2	3	0	0	3	0	0
2	10846471	.	C	T	10	4	14	0	0	14	0	0
2	10857439	.	G	T	7	2	9	0	0	9	0	0
2	10857833	.	A	G	2	4	6	0	0	6	0	0
2	10879844	.	G	C	1	3	4	0	0	4	0	0
2	10880529	.	A	C	0	5	5	1	1	7	0	0
2	10914340	.	C	A	5	5	10	0	0	10	0	0
2	10916419	.	T	C	3	4	7	0	0	7	0	0
2	10926449	.	T	C	8	10	18	0	0	18	0	0
2	10931675	.	C	G	7	9	16	0	0	16	0	0
2	11125863	.	C	T	1	3	4	0	0	4	0	0
2	11126039	.	A	C	3	7	10	0	0	10	0	0
2	11209756	.	G	A	2	6	8	0	5	13	0	0
2	11483197	.	T	C	5	3	8	0	0	8	0	0
2	11497307	.	C	T	0	4	4	0	1	5	0	0
2	11508771	.	A	G	9	6	15	0	1	16	0	0
2	11508780	.	G	A	11	8	19	0	0	19	0	0
2	11509016	.	A	G	18	10	28	0	5	33	0	0
2	11643077	.	C	T	2	2	4	0	0	4	0	0
2	11654370	.	G	A	8	9	17	0	0	17	0	0
2	11661162	.	T	C	5	2	7	0	2	9	0	0
2	11661234	.	G	A	3	4	7	0	0	7	0	0
2	11661287	.	C	T	1	4	5	0	5	10	0	0
2	11662575	.	G	T	8	4	12	1	0	13	0	0
2	11662590	.	G	T	10	5	15	1	0	16	0	0
2	11832162	.	C	G	4	2	6	0	0	6	0	0
2	11832876	.	A	C	8	5	13	0	0	13	0	0
2	11849167	.	A	G	10	16	26	0	1	27	0	0
2	11849190	.	T	C	8	13	21	0	1	22	0	0
2	11849637	.	G	A	6	3	9	0	0	9	0	0
2	11849911	.	A	T	1	2	3	0	0	3	0	0
2	11850244	.	T	A	9	3	12	0	0	12	0	0
2	11850350	.	A	T	9	3	12	1	0	13	0	0
2	11850385	.	C	T	0	6	6	1	14	21	0	0
2	11850395	.	G	A	14	6	20	1	1	22	0	0
2	11851189	.	A	C	7	3	10	0	1	11	0	0
2	11851205	.	T	A	7	6	13	0	0	13	0	0
2	11851256	.	T	G	6	6	12	0	3	15	0	0
2	11851260	.	T	G	7	6	13	0	0	13	0	0
2	11926447	.	C	G	1	0	1	0	2	3	0	0
2	11965262	.	G	A	3	5	8	0	0	8	0	0
2	11969431	.	A	G	8	5	13	0	0	13	0	0
2	11970199	.	C	T	7	5	12	0	0	12	0	0
2	11976603	.	T	C	8	0	8	0	12	20	0	0
2	11976633	.	A	G	8	7	15	0	3	18	0	0
2	11976700	.	G	T	6	11	17	0	0	17	0	0
2	11976741	.	C	T	0	5	5	0	8	13	0	0
2	11976980	.	A	G	7	10	17	0	0	17	0	0
2	11977104	.	C	T	1	7	8	0	4	12	0	0
2	11977146	.	A	T	8	5	13	0	1	14	0	0
2	11977163	.	T	C	8	3	11	0	0	11	0	0
2	11977495	.	A	G	7	4	11	0	0	11	0	0
2	11978296	.	G	A	1	2	3	0	0	3	0	0
2	11993409	.	A	G	5	4	9	0	0	9	0	0
2	11998037	.	C	T	8	11	19	0	0	19	0	0
2	11998058	.	T	C	10	8	18	0	0	18	0	0
2	12002385	.	T	A	8	5	13	0	0	13	0	0
2	12002766	.	A	G	4	11	15	0	0	15	0	0
2	12002797	.	A	G	2	10	12	0	0	12	0	0
2	12002885	.	T	C	4	5	9	0	0	9	0	0
2	12002899	.	T	G	4	5	9	0	0	10	1	0
2	12002945	.	A	T	1	7	8	0	0	8	0	0
2	12002950	.	T	C	1	6	7	0	0	7	0	0
2	12002993	.	C	G	5	4	9	0	0	9	0	0
2	12104948	.	T	A	15	10	25	0	0	25	0	0
2	12104949	.	C	T	15	10	25	0	0	25	0	0
2	12105078	.	A	T	10	11	21	0	1	22	0	0
2	12106289	.	A	G	9	19	28	0	1	29	0	0
2	12106363	.	T	C	7	4	11	0	1	12	0	0
2	12106443	.	T	C	7	5	12	0	2	14	0	0
2	12106508	.	A	T	8	5	13	0	0	13	0	0
2	12106603	.	C	T	8	7	15	0	0	15	0	0
2	12106701	.	G	T	10	8	18	0	3	21	0	0
2	12106721	.	G	A	10	13	23	0	0	23	0	0
2	12106792	.	A	G	5	8	13	0	0	13	0	0
2	12107063	.	G	A	3	2	5	0	0	5	0	0
2	12107176	.	G	A	1	2	3	0	1	4	0	0
2	12107879	.	A	T	2	3	5	0	0	5	0	0
2	12107908	.	T	C	1	0	1	0	2	3	0	0
2	12108248	.	G	C	1	4	5	0	0	5	0	0
2	12108381	.	C	T	0	5	5	0	1	6	0	0
2	12108696	.	T	A	4	4	8	0	0	8	0	0
2	12108754	.	G	C	1	4	5	0	0	5	0	0
2	12108810	.	G	T	2	4	6	0	0	6	0	0
2	12109065	.	G	A	3	6	9	0	1	10	0	0
2	12109153	.	T	A	6	5	11	0	0	11	0	0
2	12109637	.	C	T	2	2	4	0	1	5	0	0
2	12265808	.	T	C	4	3	7	0	1	8	0	0
2	12269834	.	G	T	5	2	7	0	0	7	0	0
2	12279203	.	A	G	7	6	13	0	2	15	0	0
2	12279303	.	C	T	10	2	12	0	0	12	0	0
2	12279328	.	T	C	9	6	15	0	0	15	0	0
2	12279419	.	C	T	11	10	21	0	0	21	0	0
2	12279508	.	G	C	2	7	9	0	0	9	0	0
2	12279540	.	T	C	3	6	9	0	0	9	0	0
2	12279594	.	A	C	1	3	4	0	0	4	0	0
2	12379585	.	A	C	3	4	7	0	0	7	0	0
2	12394569	.	G	A	1	8	9	0	4	13	0	0
2	12394644	.	C	A	3	3	6	0	0	6	0	0
2	12394650	.	A	G	2	0	2	0	4	6	0	0
2	12396788	.	T	G	9	0	9	0	7	16	0	0
2	12397418	.	A	G	3	5	8	0	0	8	0	0
2	12404169	.	A	C	22	17	39	0	1	40	0	0
2	12404411	.	T	C	16	19	35	0	0	35	0	0
2	12405310	.	G	A	1	11	12	0	9	21	0	0
2	12406022	.	A	T	22	12	34	0	0	34	0	0
2	12407106	.	G	A	22	15	37	0	0	37	0	0
2	12407113	.	C	G	21	12	33	0	3	36	0	0
2	12407188	.	A	C	25	11	36	0	3	40	1	0
2	12407586	.	G	T	18	11	29	0	1	30	0	0
2	12407610	.	G	A	22	11	33	0	2	35	0	0
2	12407626	.	T	A	25	7	32	0	2	34	0	0
2	12407799	.	C	T	19	14	33	0	3	36	0	0
2	12407992	.	T	C	31	21	52	0	1	53	0	0
2	12408081	.	T	G	24	13	37	1	0	39	1	0
2	12408085	.	G	A	23	13	36	1	2	39	0	0
2	12410548	.	A	G	18	12	30	0	2	32	0	0
2	12417224	.	G	T	9	5	14	0	0	14	0	0
2	12502394	.	G	A	2	2	4	0	0	4	0	0
2	13010241	.	G	T	2	4	6	0	0	6	0	0
2	13010262	.	A	C	3	4	7	0	0	7	0	0
2	13018408	.	T	C	3	2	5	0	0	5	0	0
2	13020122	.	T	A	4	2	6	0	0	6	0	0
2	13020284	.	G	C	0	3	3	0	3	6	0	0
2	13020541	.	G	A	1	2	3	0	5	8	0	0
2	13035942	.	C	A	10	6	16	0	0	16	0	0
2	13036154	.	T	A	7	13	20	0	0	20	0	0
2	13036649	.	G	C	0	6	6	0	6	12	0	0
2	13187003	.	T	A	8	4	12	0	2	14	0	0
2	13187634	.	A	G	5	5	10	0	2	12	0	0
2	13187749	.	T	A	4	2	6	0	0	6	0	0
2	13215795	.	G	T	4	4	8	0	0	8	0	0
2	13215967	.	G	A	3	4	7	0	0	7	0	0
2	13223761	.	T	C	5	2	7	0	0	7	0	0
2	13223815	.	T	A	2	2	4	0	0	4	0	0
2	13223853	.	A	G	3	3	6	0	0	6	0	0
2	13223864	.	T	A	3	2	5	0	0	5	0	0
2	13224981	.	A	G	1	4	5	0	0	5	0	0
2	13242171	.	G	A	2	2	4	0	1	5	0	0
2	13256795	.	G	C	3	6	9	0	0	9	0	0
2	13265122	.	T	A	1	4	5	0	0	5	0	0
2	14278173	.	A	T	2	2	4	0	0	4	0	0
2	14278412	.	A	C	6	10	16	0	0	16	0	0
2	14278828	.	A	C	3	0	3	0	5	8	0	0
2	14298495	.	G	A	4	4	8	0	1	9	0	0
2	14366676	.	T	A	4	7	11	0	0	11	0	0
2	14655769	.	C	G	1	3	4	0	0	4	0	0
2	14998640	.	C	T	3	2	5	0	0	5	0	0
2	14998679	.	A	T	2	3	5	1	0	6	0	0
2	14998699	.	T	A	3	7	10	1	0	11	0	0
2	14998764	.	A	G	4	2	6	0	1	7	0	0
2	15010440	.	G	A	1	2	3	2	0	5	0	0
2	15031023	.	G	A	2	2	4	0	0	4	0	0
2	15031096	.	A	C	3	0	3	0	3	6	0	0
2	15035425	.	A	G	3	5	8	0	0	8	0	0
2	15109639	.	A	T	7	2	9	0	1	10	0	0
2	15112025	.	G	T	2	4	6	0	0	6	0	0
2	15197811	.	T	A	2	2	4	0	0	4	0	0
2	15197817	.	C	G	2	2	4	0	0	4	0	0
2	15864586	.	C	T	1	2	3	0	0	3	0	0
2	15942544	.	A	G	8	10	18	0	1	19	0	0
2	15942637	.	A	G	9	3	12	0	0	12	0	0
2	15942671	.	G	A	4	7	11	0	0	11	0	0
2	15942674	.	A	T	4	7	11	0	0	11	0	0
2	15942774	.	G	A	7	8	15	0	1	17	1	0
2	15942817	.	T	C	7	13	20	0	0	20	0	0
2	15942843	.	C	T	10	11	21	1	0	22	0	0
2	15942897	.	C	G	9	9	18	1	0	19	0	0
2	15942964	.	T	C	5	6	11	0	1	12	0	0
2	15943048	.	G	T	6	3	9	0	1	10	0	0
2	15943120	.	T	G	8	7	15	0	1	16	0	0
2	15943267	.	G	A	0	6	6	0	4	10	0	0
2	15993631	.	A	G	2	3	5	0	0	5	0	0
2	15993847	.	A	C	2	4	6	0	0	6	0	0
2	16161232	.	A	G	3	3	6	0	2	8	0	0
2	16164536	.	A	G	2	6	8	0	2	10	0	0
2	16165809	.	C	A	4	6	10	0	2	12	0	0
2	16169397	.	A	G	3	9	12	0	1	13	0	0
2	16172088	.	T	G	1	8	9	0	0	9	0	0
2	16172160	.	T	C	2	3	5	0	0	5	0	0
2	16174117	.	A	C	3	3	6	0	1	7	0	0
2	16174139	.	A	C	5	3	8	0	0	8	0	0
2	16174346	.	T	C	3	2	5	0	0	5	0	0
2	16177521	.	A	G	3	2	5	0	0	6	1	0
2	16188827	.	A	T	1	2	3	0	0	3	0	0
2	16191718	.	G	A	3	9	12	0	19	31	0	0
2	16191748	.	A	G	15	9	24	0	3	27	0	0
2	16191829	.	C	T	17	8	25	0	1	26	0	0
2	16191892	.	T	G	12	1	13	0	13	26	0	0
2	16194018	.	A	G	13	0	13	0	7	20	0	0
2	16194019	.	T	C	12	7	19	0	1	20	0	0
2	16198807	.	T	C	4	7	11	0	0	11	0	0
2	16198932	.	A	G	21	25	46	0	2	48	0	0
2	16199018	.	G	A	26	27	53	0	7	60	0	0
2	16204689	.	T	G	24	24	48	1	0	49	0	0
2	16206840	.	C	T	15	22	37	0	0	37	0	0
2	16207151	.	G	A	7	8	15	0	2	17	0	0
2	16207346	.	T	C	10	17	27	0	2	29	0	0
2	16216524	.	A	T	4	4	8	0	0	8	0	0
2	16221213	.	T	C	3	0	3	0	3	6	0	0
2	16257132	.	T	G	2	3	5	0	0	5	0	0
2	16257134	.	C	T	0	1	1	0	4	5	0	0
2	16387964	.	G	A	3	4	7	0	0	7	0	0
2	16452973	.	T	A	2	3	5	0	0	5	0	0
2	16454119	.	A	G	7	4	11	0	0	11	0	0
2	16454182	.	T	A	3	2	5	0	0	5	0	0
2	16458163	.	T	C	4	3	7	0	0	7	0	0
2	16458187	.	T	G	5	2	7	0	0	7	0	0
2	16463862	.	T	C	1	2	3	0	0	3	0	0
2	16466383	.	A	G	2	0	2	0	2	4	0	0
2	16466720	.	A	G	4	0	4	0	8	12	0	0
2	16472243	.	T	C	6	9	15	0	1	16	0	0
2	16472284	.	T	C	3	7	10	0	1	11	0	0
2	16472288	.	C	G	1	0	1	0	7	8	0	0
2	16475415	.	C	G	8	1	9	0	21	30	0	0
2	16475469	.	C	A	11	11	22	0	1	23	0	0
2	16475484	.	G	A	3	11	14	0	9	23	0	0
2	16478577	.	G	A	1	11	12	0	10	22	0	0
2	16478587	.	A	G	10	12	22	0	0	22	0	0
2	16479015	.	A	G	20	9	29	0	3	32	0	0
2	16543445	.	A	G	3	2	5	0	0	5	0	0
2	16543589	.	A	T	1	2	3	0	0	3	0	0
2	16543603	.	A	G	1	2	3	0	0	3	0	0
2	16547866	.	T	C	11	16	27	0	1	28	0	0
2	16548120	.	A	T	8	8	16	0	0	16	0	0
2	16548178	.	C	T	0	4	4	0	7	11	0	0
2	16548286	.	T	C	21	0	21	0	7	28	0	0
2	16548289	.	C	T	21	7	28	0	1	29	0	0
2	16548514	.	T	C	22	15	37	0	1	38	0	0
2	16565424	.	T	C	4	3	7	0	0	7	0	0
2	16594896	.	T	A	1	3	4	0	0	4	0	0
2	16594906	.	C	T	2	5	7	0	0	7	0	0
2	16632812	.	T	C	1	2	3	0	0	3	0	0
2	16635588	.	G	A	3	2	5	0	0	5	0	0
2	16635733	.	G	A	3	3	6	0	0	6	0	0
2	16638432	.	C	G	1	2	3	0	0	3	0	0
2	16638459	.	C	T	1	2	3	0	1	4	0	0
2	16639684	.	G	A	3	4	7	0	0	7	0	0
2	16645821	.	A	C	8	9	17	0	0	17	0	0
2	16646117	.	C	T	5	2	7	0	0	7	0	0
2	16646222	.	C	T	5	4	9	0	0	9	0	0
2	16646475	.	T	C	6	6	12	0	1	13	0	0
2	16646593	.	T	C	6	5	11	1	1	13	0	0
2	16646714	.	T	A	3	4	7	0	0	7	0	0
2	16646808	.	A	C	5	6	11	0	0	11	0	0
2	16647219	.	T	G	1	3	4	0	0	4	0	0
2	16694018	.	C	T	1	2	3	0	0	3	0	0
2	16698199	.	A	G	8	5	13	0	0	13	0	0
2	16698384	.	C	A	8	4	12	0	0	12	0	0
2	16699560	.	C	T	9	6	15	0	1	16	0	0
2	16699565	.	A	T	9	7	16	0	1	17	0	0
2	16699595	.	T	C	10	12	22	0	0	22	0	0
2	16702570	.	G	A	1	8	9	0	6	15	0	0
2	16706549	.	A	C	28	19	47	0	0	47	0	0
2	16706563	.	T	C	25	17	42	0	4	46	0	0
2	16706618	.	G	A	2	21	23	0	22	45	0	0
2	16706737	.	G	A	1	12	13	0	25	38	0	0
2	16707209	.	A	G	8	0	8	0	4	12	0	0
2	16707211	.	T	G	8	4	12	0	0	12	0	0
2	16707290	.	G	T	14	8	22	0	0	22	0	0
2	16707329	.	A	C	18	13	31	0	0	31	0	0
2	16707371	.	C	T	23	15	38	0	1	39	0	0
2	16707374	.	C	A	23	14	37	0	1	39	1	0
2	16707582	.	T	A	21	12	33	0	1	34	0	0
2	16707631	.	C	G	18	16	34	0	3	37	0	0
2	16728507	.	T	C	5	4	9	0	1	10	0	0
2	16734657	.	A	G	2	2	4	0	0	4	0	0
2	16735052	.	G	T	8	4	12	0	1	13	0	0
2	16735160	.	G	A	4	7	11	0	0	11	0	0
2	16735262	.	G	A	0	7	7	0	7	14	0	0
2	16736612	.	C	T	13	10	23	1	0	24	0	0
2	16736678	.	T	C	17	11	28	0	2	30	0	0
2	16736941	.	T	A	9	9	18	0	0	18	0	0
2	16736964	.	T	C	10	5	15	0	0	15	0	0
2	16737086	.	C	T	9	8	17	0	0	17	0	0
2	16791991	.	T	G	4	7	11	0	0	11	0	0
2	16792030	.	A	T	2	2	4	0	0	4	0	0
2	16821704	.	A	T	1	2	3	0	0	3	0	0
2	16824536	.	T	C	2	3	5	0	0	5	0	0
2	16827129	.	G	A	2	5	7	0	2	9	0	0
2	16829221	.	C	A	3	2	5	0	1	6	0	0
2	16833650	.	C	A	3	4	7	0	0	7	0	0
2	16833884	.	A	T	4	6	10	0	1	11	0	0
2	17450424	.	T	A	12	3	15	0	0	15	0	0
2	17450642	.	C	T	5	7	12	0	0	12	0	0
2	17450707	.	T	C	7	0	7	0	6	13	0	0
2	17450744	.	G	A	9	4	13	0	1	14	0	0
2	17450841	.	A	T	5	5	10	0	0	10	0	0
2	17450859	.	C	A	3	4	7	0	4	11	0	0
2	17450967	.	T	C	3	0	3	0	6	9	0	0
2	17451003	.	G	A	4	5	9	0	0	9	0	0
2	17451233	.	T	C	5	6	11	0	1	12	0	0
2	17451387	.	T	C	6	11	17	0	0	17	0	0
2	17468914	.	T	C	1	3	4	0	0	4	0	0
2	17469413	.	T	C	1	0	1	0	2	3	0	0
2	17477335	.	G	T	4	5	9	0	0	9	0	0
2	17477480	.	G	T	2	3	5	0	2	7	0	0
2	17578480	.	A	T	4	1	5	0	2	7	0	0
2	17578593	.	A	G	11	27	38	0	1	39	0	0
2	17578658	.	T	A	8	33	41	0	3	44	0	0
2	17578710	.	A	G	13	34	47	0	3	50	0	0
2	17578853	.	C	T	13	33	46	0	3	49	0	0
2	17579639	.	G	A	4	3	7	0	1	8	0	0
2	17629935	.	T	C	4	17	21	0	0	21	0	0
2	17644609	.	T	C	2	1	3	0	13	16	0	0
2	17651565	.	C	T	3	12	15	0	1	16	0	0
2	17651574	.	C	T	3	8	11	0	2	13	0	0
2	17656439	.	A	T	2	4	6	0	0	6	0	0
2	18698517	.	C	A	21	19	40	0	3	43	0	0
2	18698560	.	T	A	25	12	37	0	2	39	0	0
2	18698648	.	G	A	17	11	28	0	2	30	0	0
2	18698659	.	G	T	16	11	27	0	1	28	0	0
2	18698686	.	C	T	12	15	27	0	2	29	0	0
2	18698912	.	C	G	14	16	30	0	1	31	0	0
2	18698920	.	G	A	11	16	27	0	2	29	0	0
2	18698957	.	A	T	20	17	37	0	2	39	0	0
2	18699071	.	G	A	13	13	26	0	3	29	0	0
2	18699192	.	C	T	7	8	15	0	0	15	0	0
2	18699315	.	C	G	15	13	28	0	0	28	0	0
2	18699474	.	G	T	15	17	32	0	3	35	0	0
2	18699533	.	T	A	17	18	35	0	2	37	0	0
2	18699586	.	G	T	10	17	27	0	0	27	0	0
2	18699590	.	G	T	10	15	25	0	1	26	0	0
2	18700102	.	T	A	9	4	13	1	1	15	0	0
2	18700148	.	G	A	6	6	12	0	0	12	0	0
2	18700194	.	T	A	10	4	14	0	0	14	0	0
2	18700750	.	G	A	7	11	18	0	0	18	0	0
2	18700753	.	G	A	7	10	17	0	1	18	0	0
2	18701033	.	G	A	6	8	14	0	1	15	0	0
2	18701228	.	A	G	2	5	7	0	0	7	0	0
2	18701232	.	T	C	2	5	7	0	0	7	0	0
2	18701437	.	A	G	3	3	6	0	0	6	0	0
2	18701779	.	T	C	7	7	14	1	0	15	0	0
2	18701827	.	A	C	8	4	12	0	1	13	0	0
2	18701982	.	T	A	6	2	8	0	2	10	0	0
2	18702029	.	C	T	5	3	8	0	0	8	0	0
2	18702199	.	A	T	6	3	9	0	0	9	0	0
2	18702222	.	G	T	5	2	7	0	0	7	0	0
2	18702657	.	G	T	6	13	19	0	1	20	0	0
2	18702710	.	T	C	7	0	7	0	14	21	0	0
2	18702716	.	A	C	8	12	20	0	2	22	0	0
2	18702772	.	G	A	6	8	14	0	0	14	0	0
2	18702825	.	T	G	3	13	16	0	0	16	0	0
2	18702861	.	C	A	2	9	11	0	0	11	0	0
2	18702862	.	A	G	2	9	11	0	0	11	0	0
2	18703265	.	T	A	15	11	26	0	5	31	0	0
2	18703273	.	A	G	17	12	29	0	1	30	0	0
2	18703344	.	A	T	13	18	31	0	0	31	0	0
2	18703345	.	T	G	14	18	32	0	0	32	0	0
2	18714519	.	A	G	10	18	28	1	0	29	0	0
2	18725918	.	G	A	4	4	8	0	0	8	0	0
2	18990241	.	G	C	15	8	23	0	1	24	0	0
2	18991317	.	T	C	24	20	44	0	3	47	0	0
2	18991362	.	T	C	28	16	44	0	1	45	0	0
2	18992144	.	G	C	23	18	41	0	1	42	0	0
2	19101732	.	C	G	9	7	16	0	0	16	0	0
2	19101950	.	A	G	5	4	9	0	0	9	0	0
2	19214616	.	C	T	3	3	6	0	0	6	0	0
2	19214770	.	C	G	4	0	4	0	2	6	0	0
2	19214771	.	C	A	3	2	5	0	0	5	0	0
2	19281432	.	T	A	4	6	10	0	0	10	0	0
2	19290129	.	A	G	1	5	6	0	1	7	0	0
2	19308439	.	G	C	5	3	8	0	0	8	0	0
2	19784751	.	C	T	2	2	4	0	0	4	0	0
2	19794484	.	C	T	8	5	13	0	2	15	0	0
2	19794753	.	A	G	8	18	26	0	1	27	0	0
2	19794847	.	T	G	8	0	8	0	16	24	0	0
2	19794937	.	C	T	15	12	27	0	2	29	0	0
2	19795249	.	C	T	10	11	21	0	0	21	0	0
2	19795301	.	A	G	11	19	30	0	2	32	0	0
2	19795333	.	G	C	11	16	27	0	1	28	0	0
2	19795344	.	G	A	1	14	15	0	14	29	0	0
2	19795400	.	A	G	16	13	29	0	1	30	0	0
2	19825476	.	A	G	4	2	6	0	0	6	0	0
2	19831164	.	A	G	2	2	4	0	0	4	0	0
2	20262850	.	T	C	2	0	2	0	2	4	0	0
2	20262856	.	C	A	3	2	5	0	0	5	0	0
2	20262889	.	C	A	1	2	3	0	0	3	0	0
2	20367846	.	A	C	3	2	5	0	1	6	0	0
2	20368101	.	T	C	4	2	6	0	0	6	0	0
2	20368173	.	T	C	1	2	3	0	0	3	0	0
2	20368537	.	A	C	9	3	12	0	0	12	0	0
2	20368630	.	G	A	0	4	4	0	5	9	0	0
2	20368761	.	T	C	4	10	14	0	0	14	0	0
2	20369162	.	A	C	5	3	8	0	3	11	0	0
2	20369240	.	T	G	6	7	13	0	1	14	0	0
2	20370012	.	C	T	8	9	17	0	2	19	0	0
2	20437826	.	G	A	1	6	7	0	1	8	0	0
2	20437834	.	C	T	1	6	7	0	0	7	0	0
2	20438054	.	G	A	5	6	11	0	0	11	0	0
2	20438110	.	C	A	1	5	6	0	0	6	0	0
2	20438167	.	G	A	0	4	4	0	2	6	0	0
2	20438219	.	G	A	2	7	9	0	0	9	0	0
2	20438373	.	A	G	1	6	7	0	1	8	0	0
2	20438443	.	G	A	2	11	13	0	2	15	0	0
2	20438876	.	A	C	2	8	10	0	1	11	0	0
2	20439070	.	A	G	2	0	2	0	11	13	0	0
2	20439089	.	T	C	4	7	11	0	1	12	0	0
2	20439223	.	G	T	10	8	18	0	0	18	0	0
2	20439490	.	A	G	9	19	28	0	1	29	0	0
2	20440307	.	A	C	11	19	30	0	2	32	0	0
2	20440314	.	A	G	14	21	35	0	2	37	0	0
2	20442735	.	G	A	14	31	45	0	1	46	0	0
2	20496616	.	T	A	1	2	3	0	0	3	0	0
2	20505994	.	C	T	1	6	7	0	0	7	0	0
2	20509603	.	A	T	2	6	8	0	0	8	0	0
2	20511713	.	C	A	2	6	8	0	0	8	0	0
2	20511725	.	T	C	1	7	8	0	0	8	0	0
2	20511770	.	C	T	2	4	6	0	0	6	0	0
2	20515013	.	G	A	4	4	8	0	0	8	0	0
2	20515056	.	G	A	6	3	9	0	1	10	0	0
2	20515060	.	T	G	8	2	10	0	0	10	0	0
2	20520618	.	T	C	9	8	17	0	0	17	0	0
2	20520636	.	T	C	9	7	16	0	0	16	0	0
2	20523002	.	C	T	11	9	20	0	0	20	0	0
2	20523004	.	C	T	11	9	20	0	0	20	0	0
2	20523351	.	T	A	12	16	28	0	3	31	0	0
2	20523364	.	A	G	11	18	29	0	1	30	0	0
2	20526411	.	T	C	14	23	37	0	2	39	0	0
2	20526592	.	A	G	16	0	16	0	17	33	0	0
2	20526599	.	T	A	19	17	36	0	0	36	0	0
2	20662405	.	C	G	3	2	5	0	0	5	0	0
2	20811104	.	G	A	5	2	7	0	0	7	0	0
2	20811136	.	C	A	3	2	5	0	1	6	0	0
2	20811652	.	A	T	1	8	9	0	3	12	0	0
2	20811728	.	A	T	1	2	3	0	0	3	0	0
2	20811792	.	A	C	2	7	9	0	1	10	0	0
2	20814225	.	A	T	11	10	21	0	1	22	0	0
2	20814291	.	T	G	12	7	19	0	2	21	0	0
2	20814488	.	C	T	15	5	20	0	1	21	0	0
2	20814688	.	G	C	10	0	10	0	11	21	0	0
2	20819762	.	G	T	10	4	14	0	4	18	0	0
2	20822794	.	A	G	4	5	9	0	2	11	0	0
2	20824654	.	T	C	1	0	1	0	4	5	0	0
2	20828235	.	C	T	0	7	7	0	4	11	0	0
2	20828322	.	A	G	9	4	13	0	2	15	0	0
2	20830336	.	A	G	4	1	5	0	0	5	0	0
2	20830342	.	C	T	3	2	5	0	0	5	0	0
2	20830387	.	A	G	4	4	8	0	0	8	0	0
2	20830405	.	A	G	1	6	7	0	0	7	0	0
2	20830993	.	C	G	2	3	5	0	1	6	0	0
2	20836438	.	A	C	2	3	5	0	1	6	0	0
2	20843816	.	A	G	4	2	6	0	0	6	0	0
2	20870961	.	T	C	1	2	3	0	0	3	0	0
2	20872069	.	A	T	1	2	3	0	0	3	0	0
2	20872079	.	A	G	1	2	3	0	0	3	0	0
2	20875175	.	A	G	3	6	9	0	0	9	0	0
2	20875860	.	A	G	3	10	13	0	0	13	0	0
2	20972877	.	A	G	1	2	3	0	0	3	0	0
2	20973369	.	G	A	1	2	3	0	0	3	0	0
2	20973794	.	A	T	3	4	7	0	0	7	0	0
2	20973934	.	T	C	2	2	4	0	0	4	0	0
2	20974433	.	A	C	1	3	4	0	1	5	0	0
2	20974867	.	G	A	5	4	9	0	0	9	0	0
2	20974880	.	T	C	6	5	11	0	0	11	0	0
2	20975075	.	A	T	2	2	4	0	0	4	0	0
2	20975198	.	C	G	5	3	8	0	0	8	0	0
2	20975255	.	G	C	7	8	15	0	0	15	0	0
2	20975283	.	C	T	6	11	17	0	1	18	0	0
2	20975451	.	T	C	6	9	15	0	1	16	0	0
2	20975460	.	T	C	4	7	11	0	2	13	0	0
2	20980356	.	T	C	9	10	19	0	0	19	0	0
2	21064752	.	T	C	3	4	7	0	0	7	0	0
2	21064754	.	T	C	3	4	7	0	0	7	0	0
2	21064800	.	T	A	2	4	6	0	0	6	0	0
2	21068339	.	A	T	1	3	4	0	0	4	0	0
2	21076466	.	G	T	10	5	15	0	0	15	0	0
2	21076499	.	T	G	5	3	8	0	1	9	0	0
2	21076763	.	G	A	7	3	10	0	0	10	0	0
2	21076774	.	C	T	7	3	10	0	1	11	0	0
2	21077101	.	A	T	3	2	5	0	0	5	0	0
2	21077182	.	G	A	11	22	33	1	3	37	0	0
2	21077208	.	C	G	18	19	37	0	0	37	0	0
2	21077268	.	G	T	15	14	29	0	1	30	0	0
2	21077299	.	C	T	17	15	32	0	1	33	0	0
2	21077385	.	C	T	14	6	20	0	0	20	0	0
2	21077389	.	C	T	2	6	8	0	12	20	0	0
2	21077466	.	C	A	3	5	8	0	0	8	0	0
2	21077967	.	G	A	18	16	34	0	3	37	0	0
2	21079612	.	T	C	22	16	38	0	2	40	0	0
2	21080291	.	G	A	16	21	37	0	0	37	0	0
2	21081087	.	T	A	16	10	26	0	1	27	0	0
2	21082460	.	C	A	13	8	21	0	0	21	0	0
2	21138516	.	A	G	2	3	5	0	0	5	0	0
2	21151002	.	T	C	3	4	7	0	0	7	0	0
2	21155996	.	C	T	2	2	4	0	0	4	0	0
2	21156809	.	T	A	3	3	6	0	0	6	0	0
2	21165176	.	G	A	23	11	34	0	0	34	0	0
2	21166042	.	A	G	8	10	18	0	1	19	0	0
2	21167395	.	G	A	2	3	5	0	1	6	0	0
2	21175143	.	A	G	3	0	3	0	4	7	0	0
2	21179467	.	C	T	12	6	18	0	1	19	0	0
2	21179651	.	A	G	16	17	33	0	1	34	0	0
2	21179866	.	T	G	13	9	22	0	0	22	0	0
2	21179939	.	A	G	20	20	40	0	2	42	0	0
2	21182335	.	T	C	6	17	23	0	0	23	0	0
2	21182345	.	T	C	9	16	25	0	1	26	0	0
2	21315952	.	C	T	1	2	3	0	0	3	0	0
2	21320759	.	T	A	2	2	4	0	0	4	0	0
2	21320768	.	G	A	2	1	3	0	0	3	0	0
2	21320837	.	A	G	2	4	6	0	0	6	0	0
2	21321129	.	T	A	4	3	7	0	0	7	0	0
2	21338095	.	G	A	1	3	4	0	0	4	0	0
2	21340519	.	C	T	5	6	11	0	0	11	0	0
2	21349413	.	C	T	1	2	3	0	0	3	0	0
2	21367952	.	A	G	2	3	5	0	0	5	0	0
2	21462185	.	A	G	3	2	5	0	0	5	0	0
2	21462191	.	A	G	3	2	5	0	0	5	0	0
2	21463923	.	A	T	11	7	18	0	0	18	0	0
2	21468732	.	T	G	17	11	28	0	1	29	0	0
2	21468807	.	G	A	13	17	30	0	1	31	0	0
2	21468953	.	C	T	10	10	20	0	0	20	0	0
2	21469080	.	T	G	10	7	17	0	0	17	0	0
2	21469405	.	T	C	11	6	17	0	1	18	0	0
2	21469577	.	A	G	6	9	15	0	3	18	0	0
2	21469579	.	T	G	10	8	18	0	1	19	0	0
2	21469830	.	T	A	6	6	12	1	0	13	0	0
2	21502540	.	G	C	8	6	14	0	1	15	0	0
2	21503511	.	T	C	3	2	5	0	0	5	0	0
2	21503584	.	A	G	1	2	3	0	1	4	0	0
2	21605724	.	T	C	1	3	4	0	1	5	0	0
2	21608710	.	T	A	12	6	18	0	0	18	0	0
2	21608781	.	T	G	4	6	10	0	1	11	0	0
2	21608880	.	T	A	3	3	6	0	0	6	0	0
2	21612356	.	T	G	1	3	4	0	0	4	0	0
2	21613008	.	T	C	2	2	4	0	2	6	0	0
2	21620412	.	A	G	7	5	12	0	0	12	0	0
2	21620469	.	T	C	9	0	9	0	6	15	0	0
2	21620691	.	G	A	9	7	16	0	0	16	0	0
2	21620856	.	C	T	6	7	13	0	0	13	0	0
2	21621151	.	G	A	5	2	7	0	0	7	0	0
2	21621400	.	C	T	0	3	3	0	2	5	0	0
2	21621423	.	C	T	0	3	3	0	4	7	0	0
2	21621507	.	T	C	6	3	9	0	0	9	0	0
2	21765814	.	G	A	1	2	3	0	1	4	0	0
2	21766212	.	A	G	5	15	20	0	2	22	0	0
2	21766785	.	G	A	8	7	15	0	1	17	1	0
2	21767244	.	A	T	10	7	17	0	0	17	0	0
2	21768392	.	A	C	4	3	7	0	1	8	0	0
2	21768821	.	T	A	5	4	9	0	2	11	0	0
2	21769256	.	A	G	5	4	9	0	0	9	0	0
2	21769928	.	A	G	1	2	3	0	1	4	0	0
2	21769947	.	A	G	0	2	2	0	2	4	0	0
2	21770775	.	G	A	4	3	7	0	0	7	0	0
2	21770888	.	T	C	3	3	6	0	1	7	0	0
2	21771245	.	A	T	3	6	9	0	0	9	0	0
2	21772099	.	G	A	1	4	5	0	0	5	0	0
2	21821936	.	A	G	25	26	51	0	1	52	0	0
2	21822304	.	A	G	27	14	41	0	4	45	0	0
2	21823100	.	C	A	25	19	44	0	2	46	0	0
2	21827276	.	A	G	18	22	40	0	2	42	0	0
2	21862511	.	C	T	3	3	6	0	0	6	0	0
2	21869023	.	T	C	10	8	18	0	0	18	0	0
2	21877560	.	G	A	12	5	17	0	1	18	0	0
2	21877743	.	T	G	8	7	15	0	0	15	0	0
2	21877774	.	A	G	6	5	11	0	1	12	0	0
2	21877795	.	T	C	5	5	10	0	1	11	0	0
2	21877931	.	T	A	2	6	8	0	0	8	0	0
2	21878053	.	T	C	12	16	28	0	1	29	0	0
2	21878147	.	C	T	13	16	29	0	0	29	0	0
2	21878155	.	T	A	17	15	32	0	0	32	0	0
2	21878197	.	T	C	18	14	32	0	0	32	0	0
2	21878258	.	A	T	17	16	33	0	1	34	0	0
2	21878462	.	T	C	12	14	26	0	1	27	0	0
2	22058071	.	A	G	3	0	3	0	4	7	0	0
2	22058200	.	C	T	3	3	6	0	3	9	0	0
2	22073020	.	A	G	3	5	8	0	1	9	0	0
2	22093084	.	A	G	11	0	11	0	5	16	0	0
2	22101657	.	C	T	24	8	32	0	0	32	0	0
2	22101699	.	A	C	20	6	26	0	1	27	0	0
2	22104292	.	C	T	20	16	36	0	1	37	0	0
2	22104309	.	C	G	20	15	35	0	2	37	0	0
2	22104912	.	T	C	21	19	40	0	0	40	0	0
2	22104999	.	A	G	24	21	45	0	3	48	0	0
2	22208514	.	G	T	6	6	12	0	1	13	0	0
2	22208638	.	A	G	11	16	27	0	0	27	0	0
2	22208767	.	G	A	16	8	24	0	1	25	0	0
2	22208778	.	A	G	20	13	33	0	0	33	0	0
2	22209722	.	C	T	5	4	9	0	0	9	0	0
2	22209914	.	C	T	1	4	5	0	3	8	0	0
2	22209943	.	G	C	3	5	8	0	0	8	0	0
2	22210137	.	T	C	6	0	6	0	6	12	0	0
2	22353522	.	T	C	17	0	17	0	20	37	0	0
2	22353662	.	A	C	19	20	39	0	0	39	0	0
2	22353722	.	T	A	27	30	57	0	1	58	0	0
2	22353768	.	A	C	19	31	50	0	1	51	0	0
2	22353769	.	A	C	19	30	49	0	2	51	0	0
2	22353993	.	T	C	15	15	30	0	2	32	0	0
2	22362347	.	T	C	12	0	12	0	15	27	0	0
2	22397012	.	G	T	1	2	3	0	0	3	0	0
2	22397029	.	A	G	1	2	3	0	0	3	0	0
2	22397461	.	C	T	3	5	8	0	0	8	0	0
2	22397527	.	G	T	3	5	8	0	0	8	0	0
2	22397534	.	A	G	3	5	8	0	1	9	0	0
2	22480272	.	T	C	11	0	11	0	8	19	0	0
2	22480321	.	G	T	6	7	13	0	0	13	0	0
2	22480759	.	G	A	22	15	37	0	0	37	0	0
2	22483222	.	G	A	10	11	21	0	2	23	0	0
2	22483351	.	A	G	10	9	19	0	1	20	0	0
2	22483423	.	C	T	5	8	13	0	1	14	0	0
2	22483444	.	A	G	3	9	12	0	0	12	0	0
2	22507132	.	T	A	12	8	20	0	1	21	0	0
2	22522211	.	G	T	2	2	4	0	0	4	0	0
2	22565341	.	C	A	1	3	4	0	0	4	0	0
2	22565448	.	G	T	3	4	7	0	0	7	0	0
2	22602808	.	C	T	12	6	18	0	0	18	0	0
2	22612623	.	T	C	12	9	21	0	1	22	0	0
2	22614355	.	G	A	5	4	9	0	1	10	0	0
2	22614529	.	C	T	12	7	19	0	0	19	0	0
2	22614568	.	A	G	11	8	19	0	0	19	0	0
2	22614959	.	A	T	10	10	20	0	2	22	0	0
2	22614988	.	T	C	14	10	24	0	2	26	0	0
2	22615055	.	T	A	11	10	21	0	1	22	0	0
2	22615155	.	G	A	7	4	11	0	2	13	0	0
2	22617848	.	A	G	15	7	22	1	0	23	0	0
2	22617932	.	G	A	37	15	52	1	6	59	0	0
2	22626878	.	T	A	18	11	29	0	4	33	0	0
2	22628981	.	A	G	20	11	31	0	2	33	0	0
2	22629684	.	C	T	2	11	13	0	13	26	0	0
2	22633869	.	G	A	16	13	29	0	1	30	0	0
2	22634040	.	T	G	10	10	20	1	1	22	0	0
2	22634070	.	A	G	11	13	24	1	0	25	0	0
2	22656651	.	G	A	7	12	19	0	1	20	0	0
2	22656708	.	T	C	6	5	11	0	0	11	0	0
2	22716770	.	T	C	2	2	4	0	0	4	0	0
2	22721695	.	T	C	1	3	4	0	0	4	0	0
2	22742027	.	T	A	2	2	4	0	0	4	0	0
2	22742034	.	A	C	2	2	4	0	0	4	0	0
2	22749202	.	A	C	2	2	4	0	0	4	0	0
2	22749221	.	A	G	3	0	3	0	4	7	0	0
2	22756245	.	T	G	7	5	12	0	1	13	0	0
2	22756289	.	A	G	8	6	14	0	1	15	0	0
2	22756528	.	C	T	9	16	25	0	2	27	0	0
2	22795615	.	A	G	7	6	13	0	2	15	0	0
2	22801748	.	T	C	29	17	46	0	2	48	0	0
2	22801899	.	A	T	21	18	39	0	1	40	0	0
2	22802030	.	G	A	1	13	14	1	29	44	0	0
2	22803110	.	T	A	22	26	48	0	1	50	1	0
2	22803190	.	C	T	27	23	50	0	3	53	0	0
2	22803366	.	C	T	31	32	63	0	0	63	0	0
2	22803467	.	A	G	27	1	28	0	28	56	0	0
2	22860413	.	C	A	2	3	5	0	0	5	0	0
2	22860541	.	C	T	3	3	6	0	0	6	0	0
2	22860840	.	C	T	3	2	5	0	0	5	0	0
2	22932369	.	G	C	1	2	3	0	0	3	0	0
2	22932931	.	A	G	5	3	8	0	0	8	0	0
2	22933539	.	G	A	9	4	13	0	0	13	0	0
2	22933554	.	G	A	11	4	15	0	0	15	0	0
2	22935753	.	A	G	3	3	6	0	0	6	0	0
2	22935766	.	A	T	4	3	7	0	0	7	0	0
2	22935792	.	A	G	5	2	7	0	0	7	0	0
2	22944464	.	G	A	3	2	5	0	1	6	0	0
2	22970361	.	A	G	8	2	10	0	0	10	0	0
2	22970363	.	C	A	8	2	10	0	0	10	0	0
2	22970413	.	G	A	9	4	13	0	0	13	0	0
2	22970485	.	A	G	1	3	4	0	0	4	0	0
2	22970683	.	C	G	3	3	6	0	1	7	0	0
2	22970707	.	G	A	3	2	5	0	0	5	0	0
2	22979768	.	G	T	3	2	5	0	1	6	0	0
2	22980020	.	G	C	4	0	4	0	3	7	0	0
2	22986552	.	T	C	1	2	3	0	0	3	0	0
2	22994264	.	T	G	7	12	19	0	0	19	0	0
2	22994412	.	C	T	3	9	12	0	0	12	0	0
2	22996520	.	A	T	10	3	13	0	0	13	0	0
2	23001638	.	G	T	12	4	16	0	0	16	0	0
2	23020948	.	C	T	2	3	5	0	0	5	0	0
2	23022896	.	A	G	5	3	8	0	0	8	0	0
2	23023524	.	G	T	2	3	5	0	0	5	0	0
2	23023535	.	A	T	2	1	3	0	2	5	0	0
2	23023675	.	G	A	5	3	8	0	0	8	0	0
2	23023741	.	A	C	1	3	4	0	0	4	0	0
2	23023804	.	A	G	5	2	7	0	1	8	0	0
2	23023890	.	G	T	3	2	5	0	0	5	0	0
2	23024747	.	G	T	2	1	3	1	0	4	0	0
2	23061791	.	T	C	3	5	8	0	1	9	0	0
2	23071236	.	G	A	12	8	20	0	0	20	0	0
2	23073536	.	A	G	11	7	18	1	2	21	0	0
2	23077432	.	A	G	13	5	18	4	3	25	0	0
2	23077839	.	A	C	11	7	18	0	2	20	0	0
2	23078082	.	A	G	3	6	9	0	0	9	0	0
2	23078244	.	T	C	16	23	39	1	1	41	0	0
2	23083338	.	C	T	1	2	3	0	0	3	0	0
2	23085223	.	G	A	2	1	3	0	0	3	0	0
2	23085242	.	A	G	3	0	3	0	3	6	0	0
2	23098385	.	A	T	5	3	8	0	0	8	0	0
2	23098464	.	A	G	3	1	4	0	0	4	0	0
2	23098472	.	A	T	3	2	5	0	0	5	0	0
2	23098916	.	T	C	4	3	7	0	0	7	0	0
2	23099104	.	T	C	1	3	4	0	0	4	0	0
2	23099141	.	G	A	1	2	3	0	1	4	0	0
2	23099307	.	T	C	5	4	9	0	1	10	0	0
2	23099369	.	G	C	10	4	14	0	0	14	0	0
2	23165559	.	A	G	0	3	3	0	1	4	0	0
2	23223037	.	C	T	2	3	5	0	0	5	0	0
2	23226584	.	C	T	1	3	4	0	0	4	0	0
2	23254074	.	A	G	3	5	8	0	1	9	0	0
2	23263294	.	T	A	6	7	13	0	0	13	0	0
2	23292123	.	A	T	7	14	21	0	0	21	0	0
2	23292262	.	G	A	5	7	12	0	1	13	0	0
2	23292429	.	A	T	11	9	20	0	2	22	0	0
2	23292516	.	G	A	1	9	10	0	5	15	0	0
2	23292549	.	C	A	4	7	11	0	2	13	0	0
2	23292584	.	C	A	6	5	11	0	0	11	0	0
2	23292690	.	T	A	3	4	7	0	1	8	0	0
2	23293123	.	G	C	15	6	21	0	0	21	0	0
2	23293230	.	A	T	8	17	25	1	0	26	0	0
2	23293246	.	T	C	10	13	23	1	1	25	0	0
2	23361784	.	A	T	11	10	21	0	1	22	0	0
2	23379532	.	G	A	5	5	10	0	0	10	0	0
2	23379588	.	C	T	6	4	10	0	0	10	0	0
2	23624072	.	T	A	0	2	2	0	0	2	0	0
2	23624075	.	T	A	1	2	3	0	0	3	0	0
2	23716575	.	T	C	2	2	4	0	0	4	0	0
2	23716617	.	C	T	2	2	4	0	0	4	0	0
2	23725144	.	T	C	9	4	13	0	0	13	0	0
2	23725184	.	C	A	9	6	15	0	0	15	0	0
2	23725239	.	C	T	1	4	5	0	0	5	0	0
2	23725683	.	T	A	12	2	14	0	2	16	0	0
2	23725684	.	A	G	11	2	13	0	3	16	0	0
2	23725834	.	G	C	1	3	4	0	3	7	0	0
2	23725872	.	T	C	3	3	6	0	0	6	0	0
2	23725886	.	C	A	1	4	5	0	2	7	0	0
2	23726099	.	A	T	12	10	22	0	0	22	0	0
2	23726155	.	C	A	16	2	18	0	1	19	0	0
2	23726162	.	C	A	15	3	18	0	0	18	0	0
2	23726230	.	A	T	9	2	11	0	1	12	0	0
2	23818271	.	G	A	0	2	2	0	2	4	0	0
2	23818765	.	A	G	5	3	8	0	0	8	0	0
2	23818835	.	T	C	2	2	4	0	0	4	0	0
2	23819125	.	A	G	1	3	4	0	0	4	0	0
2	23819603	.	T	C	2	3	5	0	0	5	0	0
2	23819640	.	T	A	1	3	4	0	0	4	0	0
2	23819862	.	A	C	2	11	13	0	0	13	0	0
2	23820027	.	T	G	2	3	5	0	0	5	0	0
2	23835261	.	A	C	1	2	3	0	0	3	0	0
2	23836807	.	A	C	1	2	3	0	0	3	0	0
2	23937227	.	G	A	1	2	3	0	0	3	0	0
2	23937231	.	C	G	1	2	3	0	0	3	0	0
2	23937310	.	T	C	1	3	4	0	0	4	0	0
2	24199338	.	C	A	4	3	7	0	0	7	0	0
2	24218922	.	A	T	7	4	11	0	0	11	0	0
2	24219115	.	G	A	3	6	9	0	0	9	0	0
2	24222069	.	A	C	12	7	19	0	1	20	0	0
2	24223991	.	A	G	6	10	16	0	8	24	0	0
2	24238809	.	A	G	15	4	19	0	0	19	0	0
2	24248498	.	C	T	20	15	35	0	3	38	0	0
2	24248619	.	T	G	27	13	40	0	1	41	0	0
2	24248657	.	A	G	23	11	34	0	1	35	0	0
2	24248677	.	A	T	22	9	31	0	2	33	0	0
2	24248702	.	T	C	16	15	31	0	0	31	0	0
2	24248767	.	T	C	22	5	27	0	1	28	0	0
2	24248768	.	A	G	22	0	22	0	6	28	0	0
2	24248809	.	C	T	19	16	35	0	1	36	0	0
2	24248871	.	A	G	14	0	14	0	21	35	0	0
2	24249044	.	A	C	13	14	27	0	1	28	0	0
2	24249083	.	T	A	13	3	16	0	1	17	0	0
2	24249299	.	A	G	23	15	38	0	2	40	0	0
2	24249320	.	A	G	20	0	20	0	19	39	0	0
2	24249397	.	G	T	2	21	23	0	18	41	0	0
2	24249411	.	T	A	22	20	42	0	4	46	0	0
2	24249516	.	A	G	16	0	16	0	21	37	0	0
2	24249662	.	A	G	25	19	44	0	4	48	0	0
2	24249669	.	A	G	28	0	28	0	21	49	0	0
2	24250001	.	G	T	5	7	12	0	0	12	0	0
2	24250097	.	T	C	6	16	22	0	0	22	0	0
2	24250140	.	T	C	2	7	9	0	1	10	0	0
2	24250147	.	G	A	1	7	8	0	3	11	0	0
2	24250212	.	G	C	6	2	8	0	0	8	0	0
2	24250303	.	C	T	8	15	23	0	2	25	0	0
2	24250419	.	C	T	16	9	25	1	1	30	3	0
2	24250577	.	A	T	25	15	40	0	1	41	0	0
2	24250625	.	T	A	21	12	33	0	0	33	0	0
2	24250681	.	T	C	21	22	43	0	2	45	0	0
2	24250879	.	T	G	28	27	55	0	0	55	0	0
2	24250972	.	C	A	34	19	53	0	2	55	0	0
2	24251690	.	G	A	29	23	52	0	3	55	0	0
2	24251909	.	A	T	47	23	70	0	1	72	1	0
2	24252078	.	A	T	49	26	75	0	1	76	0	0
2	24252088	.	C	T	43	26	69	0	5	74	0	0
2	24252192	.	T	A	35	28	63	0	1	64	0	0
2	24252196	.	G	T	7	27	34	0	29	63	0	0
2	24310739	.	G	T	5	8	13	0	0	13	0	0
2	24310850	.	G	C	16	13	29	0	3	32	0	0
2	24310897	.	G	A	15	19	34	0	2	36	0	0
2	24311122	.	A	T	6	2	8	0	0	8	0	0
2	24311151	.	G	A	9	4	13	0	0	13	0	0
2	24311218	.	T	A	7	6	13	1	1	15	0	0
2	24311296	.	G	C	14	13	27	0	4	31	0	0
2	24311703	.	A	G	16	15	31	0	4	35	0	0
2	24313884	.	T	C	8	6	14	0	1	15	0	0
2	24313896	.	G	A	9	6	15	0	0	15	0	0
2	24314221	.	T	C	5	4	9	0	1	10	0	0
2	24317537	.	G	A	6	7	13	0	2	15	0	0
2	24319740	.	A	G	13	12	25	0	3	28	0	0
2	24319945	.	T	G	2	6	8	0	2	10	0	0
2	24320173	.	C	T	10	10	20	0	3	23	0	0
2	24321853	.	T	C	6	2	8	0	9	17	0	0
2	24322189	.	G	C	12	11	23	0	0	23	0	0
2	24326455	.	A	G	3	10	13	0	0	13	0	0
2	24326509	.	G	A	6	7	13	0	0	13	0	0
2	24328453	.	A	T	3	4	7	0	0	7	0	0
2	24335246	.	G	A	2	2	4	0	0	4	0	0
2	24376282	.	T	A	2	2	4	0	0	4	0	0
2	24385210	.	C	T	5	4	9	0	0	9	0	0
2	24385361	.	T	C	3	6	9	0	1	10	0	0
2	24385402	.	A	G	3	9	12	0	2	14	0	0
2	24385447	.	T	C	9	11	20	0	1	21	0	0
2	24385685	.	T	C	7	7	14	0	1	15	0	0
2	24385837	.	A	G	5	1	6	0	4	10	0	0
2	24390847	.	T	G	2	2	4	0	0	4	0	0
2	24390856	.	T	C	1	2	3	0	0	3	0	0
2	24410851	.	C	T	21	21	42	0	4	46	0	0
2	24410882	.	G	A	19	25	44	0	1	45	0	0
2	24411053	.	A	G	24	16	40	0	2	42	0	0
2	24411056	.	C	T	0	17	17	0	25	42	0	0
2	24411501	.	T	G	8	10	18	0	2	20	0	0
2	24411781	.	T	A	18	9	27	0	0	27	0	0
2	24411989	.	C	T	6	4	10	0	0	10	0	0
2	24412097	.	A	G	11	13	24	0	1	25	0	0
2	24412107	.	G	C	15	0	15	0	10	25	0	0
2	24412150	.	T	C	18	0	18	0	7	25	0	0
2	24412856	.	A	G	5	8	13	0	1	14	0	0
2	24412908	.	C	A	6	3	9	0	1	10	0	0
2	24412947	.	A	T	4	2	6	0	0	6	0	0
2	24413155	.	C	T	12	5	17	0	1	18	0	0
2	24413710	.	T	C	8	7	15	0	0	15	0	0
2	24413882	.	T	C	2	4	6	0	0	6	0	0
2	24414032	.	G	C	5	7	12	0	1	13	0	0
2	24416775	.	A	G	5	6	11	0	0	11	0	0
2	24421686	.	G	A	6	3	9	0	0	9	0	0
2	24421816	.	G	A	3	2	5	0	0	5	0	0
2	24508107	.	C	T	32	34	66	0	2	68	0	0
2	24542121	.	T	A	1	2	3	0	0	3	0	0
2	24558570	.	C	T	4	5	9	0	0	9	0	0
2	24558836	.	T	C	8	5	13	0	1	14	0	0
2	24559091	.	A	T	4	3	7	0	0	7	0	0
2	24559434	.	G	A	2	3	5	1	5	11	0	0
2	24560218	.	G	C	2	0	2	0	4	6	0	0
2	24560248	.	A	G	3	4	7	0	1	8	0	0
2	24560323	.	T	A	4	1	5	0	1	6	0	0
2	24560324	.	T	C	4	0	4	0	2	6	0	0
2	24560359	.	G	A	5	2	7	0	1	8	0	0
2	24677139	.	A	G	1	2	3	0	0	3	0	0
2	24683093	.	A	G	5	2	7	0	3	10	0	0
2	24749467	.	G	A	1	3	4	0	0	4	0	0
2	24751430	.	C	T	1	2	3	0	0	3	0	0
2	24751450	.	T	C	2	1	3	0	0	3	0	0
2	24751526	.	G	A	2	2	4	0	1	5	0	0
2	24751572	.	A	G	1	3	4	0	0	4	0	0
2	24751888	.	A	G	2	0	2	0	2	4	0	0
2	24751948	.	C	T	4	4	8	0	1	9	0	0
2	24751986	.	T	G	4	0	4	0	5	9	0	0
2	24751991	.	A	G	3	5	8	0	1	9	0	0
2	24752181	.	T	A	3	8	11	0	0	11	0	0
2	24752193	.	C	T	3	7	10	0	0	10	0	0
2	24752293	.	C	T	2	3	5	0	0	5	0	0
2	24752385	.	C	T	4	6	10	0	1	11	0	0
2	24752391	.	A	G	3	7	10	0	1	11	0	0
2	24752842	.	G	T	2	3	5	0	0	5	0	0
2	24754226	.	T	A	1	1	2	0	1	3	0	0
2	24754796	.	A	C	19	17	36	0	3	39	0	0
2	24755018	.	T	C	18	13	31	0	2	33	0	0
2	24766980	.	C	T	5	8	13	0	1	14	0	0
2	24767285	.	T	C	4	8	12	0	0	12	0	0
2	24767291	.	C	T	4	6	10	0	1	11	0	0
2	24767429	.	A	C	2	2	4	0	0	4	0	0
2	24770726	.	A	T	1	2	3	0	0	3	0	0
2	24770755	.	G	C	2	3	5	0	0	5	0	0
2	24770898	.	T	C	4	2	6	0	0	6	0	0
2	24770928	.	A	G	3	1	4	0	3	7	0	0
2	24773724	.	A	G	3	4	7	0	0	7	0	0
2	24773726	.	G	A	0	4	4	0	2	6	0	0
2	24774452	.	C	T	6	8	14	0	1	15	0	0
2	24778317	.	C	T	5	4	9	0	2	11	0	0
2	24863597	.	T	C	2	2	4	0	0	4	0	0
2	24865360	.	T	C	3	4	7	0	0	7	0	0
2	24865961	.	A	G	4	4	8	0	0	8	0	0
2	24866075	.	G	C	3	9	12	0	0	12	0	0
2	24866568	.	C	T	3	5	8	0	0	8	0	0
2	24875201	.	T	C	9	6	15	0	0	15	0	0
2	24877010	.	A	G	5	7	12	0	3	15	0	0
2	24877227	.	C	T	10	5	15	0	0	15	0	0
2	24878026	.	G	T	2	19	21	0	11	32	0	0
2	24878211	.	C	T	17	12	29	0	5	34	0	0
2	24878265	.	G	T	12	8	20	0	3	23	0	0
2	24943717	.	C	T	6	9	15	0	0	15	0	0
2	24943855	.	C	A	13	6	19	0	0	19	0	0
2	24944067	.	A	G	13	0	13	0	8	21	0	0
2	24944112	.	T	G	13	12	25	0	1	26	0	0
2	24944485	.	T	G	7	11	18	0	1	19	0	0
2	24944487	.	G	A	7	12	19	0	0	19	0	0
2	24947651	.	G	A	6	9	15	0	0	15	0	0
2	24952607	.	T	C	5	4	9	0	1	10	0	0
2	24964335	.	A	G	2	4	6	0	0	6	0	0
2	24969895	.	A	C	2	2	4	0	0	4	0	0
2	24991149	.	G	A	14	12	26	0	2	28	0	0
2	24991153	.	T	C	17	14	31	0	1	32	0	0
2	24991476	.	G	A	17	14	31	0	2	33	0	0
2	24991564	.	A	C	12	0	12	0	10	22	0	0
2	24991573	.	A	G	12	8	20	0	2	22	0	0
2	24991639	.	G	A	11	10	21	0	1	22	0	0
2	24991825	.	G	A	14	9	23	0	0	23	0	0
2	24992002	.	T	C	10	0	10	0	3	13	0	0
2	24992035	.	A	C	8	4	12	0	1	13	0	0
2	24992110	.	G	A	11	9	20	0	0	20	0	0
2	24992185	.	T	C	5	5	10	0	2	12	0	0
2	24992242	.	C	T	0	10	10	0	7	17	0	0
2	24992352	.	G	A	6	4	10	0	0	10	0	0
2	24992407	.	G	A	6	10	16	0	0	16	0	0
2	24992422	.	G	A	6	14	20	0	0	20	0	0
2	25086854	.	G	A	3	2	5	0	0	5	0	0
2	25091203	.	G	A	2	2	4	0	0	4	0	0
2	25095118	.	T	C	1	3	4	0	0	4	0	0
2	25095177	.	T	C	3	2	5	0	0	5	0	0
2	25099926	.	T	C	2	2	4	0	0	4	0	0
2	25101118	.	A	G	9	2	11	0	1	12	0	0
2	25101124	.	T	C	11	3	14	0	0	14	0	0
2	25101160	.	A	G	6	0	6	0	6	12	0	0
2	25102571	.	C	T	4	7	11	0	1	12	0	0
2	25105482	.	G	A	4	2	6	0	0	6	0	0
2	25105507	.	G	C	4	4	8	0	0	8	0	0
2	25105586	.	C	T	4	8	12	0	0	12	0	0
2	25105612	.	T	C	5	6	11	0	1	12	0	0
2	25105681	.	G	T	5	2	7	0	0	7	0	0
2	25105683	.	C	T	5	2	7	0	0	7	0	0
2	25105716	.	T	C	4	5	9	0	0	9	0	0
2	25106082	.	G	A	0	3	3	0	2	5	0	0
2	25106098	.	T	C	2	2	4	0	0	4	0	0
2	25106244	.	A	T	2	5	7	0	2	9	0	0
2	25106477	.	G	A	2	6	8	0	2	10	0	0
2	25106508	.	G	C	6	4	10	0	1	11	0	0
2	25106671	.	A	C	1	4	5	0	0	5	0	0
2	25106874	.	A	C	6	3	9	0	0	9	0	0
2	25107571	.	G	T	3	2	5	0	0	5	0	0
2	25107617	.	G	T	4	8	12	0	0	12	0	0
2	25107673	.	T	G	7	11	18	0	1	19	0	0
2	25107851	.	G	A	6	9	15	0	0	15	0	0
2	25107869	.	C	T	6	12	18	0	2	20	0	0
2	25107942	.	C	A	22	7	29	0	0	29	0	0
2	25108042	.	A	G	19	12	31	0	0	31	0	0
2	25108137	.	C	T	14	12	26	0	1	27	0	0
2	25108377	.	T	A	12	12	24	0	1	25	0	0
2	25108597	.	T	A	1	2	3	0	1	4	0	0
2	25108633	.	C	T	2	3	5	0	6	11	0	0
2	25113448	.	A	G	3	3	6	0	0	6	0	0
2	25118023	.	A	G	1	2	3	0	0	3	0	0
2	25119637	.	A	G	2	2	4	0	0	4	0	0
2	25119667	.	G	T	1	4	5	0	0	5	0	0
2	25119950	.	T	G	1	1	2	0	1	3	0	0
2	25126882	.	T	C	3	3	6	0	1	7	0	0
2	25126886	.	T	C	2	2	4	0	2	6	0	0
2	25127042	.	G	T	1	2	3	0	0	3	0	0
2	25127219	.	T	C	1	3	4	0	0	4	0	0
2	25127897	.	T	C	3	3	6	0	0	6	0	0
2	25128328	.	G	A	2	3	5	0	0	5	0	0
2	25128458	.	C	T	3	3	6	0	0	6	0	0
2	25128668	.	C	T	11	6	17	0	0	17	0	0
2	25128920	.	G	T	4	5	9	0	0	9	0	0
2	25128934	.	A	G	4	8	12	0	1	13	0	0
2	25128997	.	C	G	4	1	5	0	2	7	0	0
2	25129116	.	A	T	6	6	12	0	0	12	0	0
2	25129293	.	C	T	1	2	3	0	0	3	0	0
2	25542867	.	A	T	1	4	5	0	2	7	0	0
2	25542890	.	C	A	7	5	12	0	3	15	0	0
2	25789394	.	C	T	2	2	4	0	0	4	0	0
2	25800881	.	C	T	3	5	8	0	0	8	0	0
2	25809736	.	C	T	2	6	8	0	1	9	0	0
2	25814694	.	C	T	4	6	10	0	2	12	0	0
2	25815329	.	G	C	4	7	11	0	3	14	0	0
2	25815407	.	A	T	6	5	11	0	1	12	0	0
2	25815452	.	G	A	5	9	14	0	2	16	0	0
2	25815758	.	C	T	6	2	8	0	0	8	0	0
2	25984913	.	T	C	1	2	3	0	0	3	0	0
2	25988269	.	A	G	7	7	14	0	0	14	0	0
2	25988551	.	A	T	3	2	5	1	1	7	0	0
2	25988633	.	A	G	2	5	7	0	1	8	0	0
2	25988635	.	A	G	3	6	9	0	0	9	0	0
2	25988874	.	T	C	5	7	12	0	1	13	0	0
2	25989059	.	G	A	1	2	3	0	3	6	0	0
2	25989134	.	A	G	8	4	12	0	0	12	0	0
2	25989142	.	T	G	8	2	10	0	1	11	0	0
2	25989213	.	T	G	10	6	16	0	1	17	0	0
2	25989241	.	T	C	10	8	18	0	1	19	0	0
2	25989610	.	C	T	16	8	24	0	1	25	0	0
2	25989827	.	C	T	3	5	8	0	0	8	0	0
2	25989884	.	T	A	1	6	7	0	0	7	0	0
2	25989905	.	C	A	2	6	8	0	0	8	0	0
2	25989994	.	A	G	12	15	27	0	1	28	0	0
2	25990180	.	C	T	14	18	32	0	1	33	0	0
2	25990302	.	A	G	20	7	27	0	0	27	0	0
2	25990447	.	G	A	14	15	29	0	3	32	0	0
2	25990563	.	A	G	6	8	14	0	0	14	0	0
2	25990772	.	T	C	22	6	28	1	2	31	0	0
2	26207038	.	A	C	3	4	7	0	1	8	0	0
2	26207071	.	C	T	7	2	9	0	0	9	0	0
2	26207254	.	A	G	6	3	9	0	2	11	0	0
2	26207263	.	T	A	9	4	13	0	0	13	0	0
2	26207350	.	G	A	6	4	10	0	0	10	0	0
2	26207368	.	A	G	5	2	7	0	1	8	0	0
2	26207944	.	T	C	10	9	19	0	0	19	0	0
2	26207977	.	G	A	1	6	7	0	11	18	0	0
2	26208369	.	A	G	10	6	16	0	1	17	0	0
2	26208416	.	G	A	8	9	17	0	1	18	0	0
2	26208425	.	G	A	10	10	20	0	0	20	0	0
2	26208480	.	A	C	7	8	15	0	1	16	0	0
2	26208520	.	A	G	10	8	18	0	1	19	0	0
2	26208589	.	A	G	15	9	24	0	1	25	0	0
2	26208621	.	T	C	20	10	30	0	0	30	0	0
2	26208668	.	T	G	21	0	21	0	9	30	0	0
2	26208815	.	G	T	13	11	24	0	2	26	0	0
2	26208832	.	C	G	17	0	17	0	17	34	0	0
2	26208904	.	T	C	19	16	35	0	1	36	0	0
2	26208987	.	G	A	5	8	13	0	24	38	1	0
2	26209030	.	G	A	23	9	32	0	3	35	0	0
2	26209058	.	C	T	17	10	27	0	4	31	0	0
2	26209169	.	C	T	12	3	15	0	0	15	0	0
2	26209266	.	A	C	7	7	14	0	0	14	0	0
2	26240805	.	T	C	7	16	23	0	2	25	0	0
2	26240930	.	A	T	22	16	38	0	1	39	0	0
2	26278044	.	G	A	26	19	45	0	1	46	0	0
2	26282688	.	C	T	23	22	45	0	1	46	0	0
2	26282814	.	T	C	24	18	42	0	0	42	0	0
2	26282916	.	A	G	19	1	20	0	26	46	0	0
2	26283181	.	C	T	14	18	32	0	2	34	0	0
2	26283922	.	T	G	26	23	49	0	2	51	0	0
2	26300016	.	T	C	10	5	15	0	0	15	0	0
2	26300245	.	C	T	2	3	5	0	0	5	0	0
2	26300291	.	C	T	1	2	3	0	1	4	0	0
2	26304266	.	A	G	2	2	4	0	0	4	0	0
2	26422332	.	C	T	4	4	8	0	0	8	0	0
2	26422359	.	C	T	4	3	7	0	0	7	0	0
2	26443211	.	A	C	7	9	16	0	0	16	0	0
2	26443476	.	C	T	9	4	13	0	0	13	0	0
2	26443859	.	A	G	6	10	16	0	1	17	0	0
2	26444170	.	T	C	10	3	13	0	1	14	0	0
2	26463124	.	T	G	6	7	13	0	0	13	0	0
2	26463329	.	G	A	8	8	16	0	0	16	0	0
2	26463348	.	C	G	0	10	10	0	8	18	0	0
2	26463459	.	C	T	1	7	8	0	6	14	0	0
2	26463598	.	T	C	6	0	6	0	6	12	0	0
2	26463622	.	A	G	7	7	14	0	0	14	0	0
2	26467072	.	A	G	5	2	7	0	0	7	0	0
2	26468243	.	G	A	3	4	7	0	0	7	0	0
2	26470087	.	A	G	2	7	9	0	0	9	0	0
2	26470208	.	G	A	25	11	36	0	0	36	0	0
2	26470237	.	G	T	15	10	25	0	2	27	0	0
2	26470267	.	G	A	13	9	22	0	1	23	0	0
2	26470666	.	A	G	20	11	31	0	0	31	0	0
2	26473361	.	C	T	11	3	14	0	2	16	0	0
2	26479799	.	C	T	2	2	4	0	1	5	0	0
2	26479824	.	T	C	1	2	3	0	0	3	0	0
2	26481029	.	C	T	4	4	8	0	0	8	0	0
2	26481053	.	T	C	2	3	5	0	0	5	0	0
2	26481430	.	G	A	0	2	2	0	6	8	0	0
2	26486605	.	A	G	4	4	8	0	3	11	0	0
2	26489681	.	T	C	9	6	15	0	0	15	0	0
2	26491457	.	G	C	9	7	16	0	0	16	0	0
2	26491667	.	G	A	11	10	21	0	2	23	0	0
2	26491830	.	C	G	16	13	29	0	0	29	0	0
2	26494366	.	C	T	15	8	23	0	0	23	0	0
2	26577189	.	T	C	8	5	13	0	1	14	0	0
2	26577210	.	C	T	11	7	18	0	0	18	0	0
2	26583609	.	G	A	1	3	4	0	0	4	0	0
2	26610677	.	T	C	3	3	6	0	0	6	0	0
2	26610852	.	G	A	2	2	4	0	0	4	0	0
2	26612624	.	G	C	8	8	16	0	0	16	0	0
2	26612676	.	A	T	11	20	31	0	0	31	0	0
2	26612893	.	T	C	16	13	29	0	1	30	0	0
2	26613106	.	G	A	22	20	42	0	3	45	0	0
2	26617098	.	A	G	9	12	21	0	0	21	0	0
2	26619786	.	C	T	11	8	19	0	0	19	0	0
2	26620695	.	A	G	5	2	7	0	0	7	0	0
2	26623587	.	C	T	20	22	42	0	2	44	0	0
2	26623832	.	T	C	23	28	51	0	5	56	0	0
2	26627301	.	C	A	19	20	39	0	2	41	0	0
2	26627332	.	T	A	19	17	36	0	1	37	0	0
2	26630587	.	C	T	1	13	14	0	15	29	0	0
2	26630855	.	A	G	16	15	31	0	2	33	0	0
2	26631084	.	G	A	16	10	26	0	3	29	0	0
2	26632627	.	G	C	18	19	37	0	2	39	0	0
2	26638355	.	T	G	3	7	10	0	0	10	0	0
2	26638809	.	C	T	3	4	7	0	0	7	0	0
2	26639217	.	A	G	9	4	13	0	0	13	0	0
2	26665065	.	A	G	2	3	5	0	0	5	0	0
2	26665081	.	A	G	2	5	7	0	0	7	0	0
2	26665198	.	T	C	2	3	5	0	1	6	0	0
2	26665199	.	T	C	3	3	6	0	0	6	0	0
2	26665794	.	A	G	2	1	3	0	3	6	0	0
2	26665796	.	G	A	1	2	3	0	3	6	0	0
2	26672266	.	A	G	17	16	33	0	2	35	0	0
2	26672320	.	G	A	14	12	26	0	1	27	0	0
2	26672395	.	G	A	7	9	16	0	0	16	0	0
2	26672440	.	A	G	15	7	22	0	0	22	0	0
2	26672672	.	G	A	14	13	27	0	0	27	0	0
2	26672761	.	T	G	4	1	5	0	5	10	0	0
2	26677125	.	C	G	1	2	3	0	1	4	0	0
2	26680919	.	G	A	0	3	3	0	2	5	0	0
2	26680920	.	T	G	2	3	5	0	0	5	0	0
2	26681064	.	A	T	5	6	11	0	0	11	0	0
2	26681076	.	A	G	4	3	7	0	0	7	0	0
2	26681837	.	G	A	5	14	19	0	0	19	0	0
2	26681942	.	A	C	11	10	21	0	0	21	0	0
2	26682031	.	G	T	1	8	9	0	10	19	0	0
2	26686752	.	T	C	7	3	10	0	1	11	0	0
2	26688691	.	A	T	11	9	20	0	0	20	0	0
2	26688737	.	G	A	3	7	10	0	0	10	0	0
2	26688747	.	A	G	3	0	3	0	8	11	0	0
2	27049123	.	C	A	1	2	3	0	0	3	0	0
2	27372537	.	C	G	3	2	5	0	0	5	0	0
2	27377590	.	T	C	2	5	7	0	0	7	0	0
2	27378524	.	T	A	6	6	12	0	0	12	0	0
2	27379170	.	C	T	1	2	3	0	0	3	0	0
2	27380114	.	A	G	1	2	3	0	0	3	0	0
2	27380147	.	G	A	2	2	4	0	1	5	0	0
2	27380150	.	G	A	2	3	5	0	0	5	0	0
2	27380336	.	G	A	6	2	8	0	0	8	0	0
2	27380500	.	G	T	5	5	10	0	0	10	0	0
2	27382516	.	A	G	4	2	6	0	0	6	0	0
2	27390973	.	A	G	1	0	1	0	2	3	0	0
2	27538619	.	G	A	1	3	4	0	0	4	0	0
2	27541512	.	A	G	2	3	5	0	1	6	0	0
2	27541740	.	C	T	8	7	15	0	0	15	0	0
2	27541743	.	A	G	7	6	13	0	1	14	0	0
2	27542058	.	A	G	12	2	14	0	6	20	0	0
2	27542083	.	G	A	9	5	14	2	0	16	0	0
2	27543499	.	C	A	10	4	14	0	1	15	0	0
2	27614007	.	A	G	4	10	14	0	0	14	0	0
2	27614046	.	A	G	3	6	9	0	1	10	0	0
2	27614082	.	G	C	8	3	11	0	0	11	0	0
2	27635488	.	T	C	1	3	4	0	0	4	0	0
2	27635849	.	C	A	2	8	10	0	0	10	0	0
2	27635935	.	C	T	1	4	5	0	0	5	0	0
2	27636010	.	G	C	4	2	6	0	0	6	0	0
2	27642776	.	C	G	1	4	5	0	0	5	0	0
2	27646419	.	G	A	2	2	4	0	1	5	0	0
2	27646430	.	T	A	2	3	5	0	0	5	0	0
2	27658579	.	C	T	2	3	5	0	0	5	0	0
2	27658973	.	T	G	3	2	5	0	0	5	0	0
2	27659018	.	T	C	3	4	7	0	0	7	0	0
2	27663616	.	T	G	5	6	11	0	1	12	0	0
2	27663867	.	C	T	5	7	12	0	1	13	0	0
2	27664105	.	G	C	6	2	8	0	1	9	0	0
2	27664202	.	T	C	2	5	7	0	1	8	0	0
2	27664215	.	A	C	1	6	7	0	0	7	0	0
2	27664317	.	G	T	3	6	9	0	0	9	0	0
2	27664343	.	C	T	3	7	10	0	1	11	0	0
2	27664380	.	G	A	5	6	11	0	1	12	0	0
2	27664482	.	G	C	3	3	6	0	0	6	0	0
2	27664665	.	A	C	5	3	8	0	0	8	0	0
2	27670884	.	T	G	6	7	13	0	2	15	0	0
2	27670886	.	T	C	8	0	8	0	7	15	0	0
2	27671172	.	C	T	8	9	17	0	0	17	0	0
2	27671290	.	G	T	3	2	5	0	3	8	0	0
2	27671334	.	T	C	3	4	7	0	0	7	0	0
2	27671485	.	A	T	5	2	7	0	0	7	0	0
2	27671486	.	G	A	5	2	7	0	0	7	0	0
2	27671623	.	A	T	4	5	9	0	1	10	0	0
2	27671650	.	C	A	0	4	4	0	4	8	0	0
2	27671681	.	G	T	3	4	7	0	0	7	0	0
2	27671704	.	C	T	2	4	6	0	1	7	0	0
2	27671724	.	G	A	3	5	8	0	0	8	0	0
2	27672103	.	T	C	1	4	5	0	0	5	0	0
2	27673041	.	A	G	4	4	8	0	0	8	0	0
2	27812578	.	G	A	5	3	8	0	1	9	0	0
2	27843848	.	C	T	2	2	4	0	1	5	0	0
2	27843937	.	A	G	3	4	7	0	0	7	0	0
2	27846071	.	G	A	3	3	6	0	0	6	0	0
2	27848151	.	T	G	3	2	5	0	0	5	0	0
2	27933764	.	G	T	4	3	7	0	0	7	0	0
2	27957786	.	T	A	4	2	6	0	0	6	0	0
2	27957939	.	G	A	6	4	10	0	0	10	0	0
2	28049445	.	T	C	14	15	29	0	0	29	0	0
2	28049996	.	A	G	8	6	14	0	1	15	0	0
2	28050759	.	A	G	5	3	8	0	0	8	0	0
2	28050933	.	G	A	3	2	5	0	0	5	0	0
2	28057518	.	G	A	3	5	8	0	0	8	0	0
2	28085730	.	T	A	1	2	3	0	0	3	0	0
2	28085746	.	A	G	1	2	3	0	0	3	0	0
2	28650422	.	T	C	2	4	6	0	0	6	0	0
2	28650504	.	T	C	7	4	11	0	0	11	0	0
2	28650612	.	T	G	9	3	12	0	1	13	0	0
2	28650629	.	G	T	10	5	15	0	0	15	0	0
2	28651128	.	T	A	7	13	20	0	0	20	0	0
2	28651193	.	A	G	4	7	11	0	0	11	0	0
2	28651497	.	G	A	2	5	7	0	0	7	0	0
2	28934011	.	C	T	6	3	9	0	0	9	0	0
2	28934041	.	A	G	2	1	3	0	3	6	0	0
2	29310996	.	G	A	2	6	8	0	8	16	0	0
2	29317718	.	G	A	7	7	14	0	1	15	0	0
2	29352333	.	G	A	1	12	13	0	8	21	0	0
2	29352479	.	C	T	6	7	13	0	2	15	0	0
2	29477538	.	A	G	1	3	4	0	0	4	0	0
2	29477733	.	A	T	18	17	35	0	1	36	0	0
2	29477769	.	G	T	18	9	27	0	1	28	0	0
2	29477895	.	A	T	7	12	19	0	1	20	0	0
2	29477979	.	T	G	5	5	10	0	1	11	0	0
2	29484113	.	A	G	7	3	10	0	0	10	0	0
2	29485046	.	G	A	7	3	10	0	2	13	1	0
2	29894409	.	A	T	1	2	3	0	0	3	0	0
2	29894410	.	C	T	1	2	3	0	0	3	0	0
2	29915902	.	A	G	4	2	6	0	0	6	0	0
2	29915908	.	A	G	4	2	6	0	0	6	0	0
2	29976452	.	A	T	1	2	3	0	1	4	0	0
2	29976960	.	T	A	5	3	8	0	1	9	0	0
2	29986609	.	C	G	0	6	6	0	2	8	0	0
2	29988297	.	G	A	2	2	4	0	1	5	0	0
2	30106271	.	A	G	7	11	18	0	1	19	0	0
2	30108443	.	T	C	11	10	21	0	1	22	0	0
2	30108456	.	T	C	11	11	22	0	1	23	0	0
2	30108542	.	T	G	5	3	8	0	1	9	0	0
2	30109678	.	C	T	10	7	17	0	0	17	0	0
2	30116206	.	C	T	2	7	9	0	1	10	0	0
2	30116586	.	C	A	2	5	7	0	0	7	0	0
2	30116589	.	C	T	2	5	7	0	0	7	0	0
2	30116688	.	A	C	6	3	9	0	1	10	0	0
2	30116808	.	T	A	8	4	12	1	0	13	0	0
2	30116889	.	C	A	4	3	7	1	1	9	0	0
2	30116905	.	A	G	5	4	9	0	0	9	0	0
2	30117169	.	T	C	2	3	5	0	0	5	0	0
2	30117201	.	T	C	1	3	4	0	0	4	0	0
2	30117249	.	A	T	2	8	10	0	1	11	0	0
2	30178100	.	C	T	32	23	55	0	1	56	0	0
2	30194777	.	C	T	10	3	13	0	3	16	0	0
2	30194938	.	G	A	6	4	10	0	0	10	0	0
2	30195040	.	A	G	4	3	7	0	0	7	0	0
2	30245900	.	G	C	4	7	11	0	2	13	0	0
2	30245922	.	T	C	9	12	21	0	0	21	0	0
2	30246029	.	T	A	11	15	26	0	0	26	0	0
2	30251622	.	A	G	4	2	6	0	0	6	0	0
2	30252029	.	T	C	6	7	13	0	0	13	0	0
2	30252071	.	G	A	0	4	4	0	4	8	0	0
2	30252206	.	T	C	3	2	5	0	0	5	0	0
2	30290749	.	A	G	8	2	10	0	0	10	0	0
2	30290843	.	C	A	3	6	9	0	0	9	0	0
2	30290858	.	G	A	4	4	8	0	0	8	0	0
2	30291072	.	A	C	8	8	16	0	1	17	0	0
2	30295050	.	T	A	3	3	6	0	1	7	0	0
2	30295052	.	T	G	3	3	6	0	1	7	0	0
2	30295155	.	G	C	3	3	6	0	2	8	0	0
2	30295156	.	G	A	3	1	4	0	4	8	0	0
2	30295288	.	A	G	5	7	12	0	0	12	0	0
2	30319374	.	C	T	2	2	4	0	0	4	0	0
2	30319375	.	T	G	2	2	4	0	0	4	0	0
2	30428637	.	A	G	3	0	3	0	3	6	0	0
2	30429710	.	A	T	6	5	11	0	1	12	0	0
2	30429711	.	T	C	4	6	10	0	1	11	0	0
2	30458754	.	G	A	22	12	34	0	1	35	0	0
2	30459984	.	T	A	11	4	15	0	0	15	0	0
2	30459985	.	A	C	12	4	16	0	0	16	0	0
2	30519768	.	C	T	5	3	8	0	1	9	0	0
2	30519975	.	G	A	2	7	9	0	4	13	0	0
2	30520026	.	G	T	7	9	16	0	2	18	0	0
2	30523047	.	A	G	5	5	10	0	0	10	0	0
2	30523053	.	C	T	5	4	9	0	1	10	0	0
2	30524966	.	C	T	14	10	24	0	2	26	0	0
2	30524992	.	T	C	14	12	26	0	0	26	0	0
2	30525062	.	A	G	12	10	22	0	0	22	0	0
2	30525105	.	A	G	12	13	25	0	3	28	0	0
2	30525117	.	C	T	17	13	30	0	0	30	0	0
2	30525169	.	G	T	2	8	10	5	15	30	0	0
2	30525297	.	T	C	6	5	11	0	0	11	0	0
2	30525378	.	C	A	6	8	14	0	0	15	1	0
2	30525596	.	A	G	17	0	17	0	9	26	0	0
2	30525970	.	A	G	26	8	34	0	2	36	0	0
2	30554512	.	G	A	22	9	31	0	1	32	0	0
2	30555869	.	G	A	9	3	12	0	2	14	0	0
2	30555882	.	T	A	6	3	9	0	2	11	0	0
2	30556102	.	C	A	1	12	13	0	11	24	0	0
2	30556103	.	G	T	12	11	23	0	1	24	0	0
2	30556386	.	G	A	10	10	20	0	2	22	0	0
2	30556419	.	G	T	12	9	21	0	1	22	0	0
2	30561285	.	T	C	7	6	13	0	1	14	0	0
2	30574092	.	C	T	0	4	4	0	1	5	0	0
2	30579831	.	G	A	4	4	8	0	0	8	0	0
2	30613764	.	G	A	2	3	5	0	0	5	0	0
2	30741192	.	C	T	6	7	13	0	0	13	0	0
2	30752796	.	G	A	4	6	10	0	0	10	0	0
2	30753813	.	G	A	7	9	16	0	0	16	0	0
2	30753888	.	A	G	11	8	19	0	0	19	0	0
2	30753899	.	C	T	14	5	19	0	1	20	0	0
2	30754030	.	A	T	4	10	14	0	0	14	0	0
2	30754306	.	G	A	11	18	29	0	2	31	0	0
2	30754733	.	A	G	3	5	8	0	0	8	0	0
2	30754741	.	A	G	3	5	8	0	1	9	0	0
2	30754885	.	A	T	6	6	12	0	1	13	0	0
2	30754894	.	A	T	6	7	13	0	0	13	0	0
2	30755272	.	T	C	6	0	6	0	3	9	0	0
2	30755278	.	C	A	0	4	4	0	7	11	0	0
2	30755345	.	T	G	2	9	11	0	0	11	0	0
2	30755359	.	A	T	1	12	13	0	0	13	0	0
2	30755461	.	A	G	3	7	10	0	0	10	0	0
2	30755482	.	A	T	2	7	9	0	0	9	0	0
2	30755522	.	G	T	1	4	5	0	0	5	0	0
2	30755717	.	C	A	5	2	7	0	0	7	0	0
2	30755886	.	C	G	3	2	5	0	1	6	0	0
2	30755887	.	C	A	3	2	5	0	1	6	0	0
2	30756157	.	G	T	3	2	5	0	0	5	0	0
2	30756264	.	A	G	4	4	8	0	1	9	0	0
2	30756320	.	T	A	1	3	4	0	0	4	0	0
2	30756903	.	A	G	2	3	5	0	0	5	0	0
2	30786795	.	T	C	2	3	5	0	0	5	0	0
2	30794792	.	T	C	11	5	16	0	0	16	0	0
2	30821859	.	G	A	13	19	32	0	1	33	0	0
2	30821965	.	C	T	21	22	43	0	3	46	0	0
2	30823438	.	T	G	27	0	27	1	29	57	0	0
2	30846719	.	A	G	25	11	36	0	4	40	0	0
2	30846870	.	C	A	3	3	6	0	1	7	0	0
2	30897111	.	C	T	10	5	15	0	0	15	0	0
2	30897990	.	C	T	11	10	21	0	1	22	0	0
2	30898196	.	T	C	12	5	17	0	0	17	0	0
2	30900927	.	C	A	4	8	12	0	2	14	0	0
2	30900945	.	G	C	5	6	11	0	1	12	0	0
2	30900994	.	T	A	8	11	19	0	1	20	0	0
2	30901060	.	A	G	18	1	19	1	8	28	0	0
2	30904137	.	G	A	11	8	19	0	1	20	0	0
2	30905298	.	G	A	8	13	21	0	0	21	0	0
2	30906386	.	C	T	12	10	22	0	0	22	0	0
2	30907655	.	T	A	19	11	30	2	0	32	0	0
2	30971951	.	G	A	1	2	3	0	0	3	0	0
2	30982409	.	T	C	11	10	21	0	0	21	0	0
2	30982612	.	T	C	13	11	24	0	0	24	0	0
2	30982640	.	A	G	10	10	20	0	1	21	0	0
2	30982897	.	A	G	1	6	7	0	0	7	0	0
2	30982929	.	T	A	4	3	7	0	0	7	0	0
2	30983267	.	G	A	16	8	24	0	1	25	0	0
2	30983294	.	T	C	12	8	20	0	1	21	0	0
2	31297980	.	A	G	18	24	42	0	2	44	0	0
2	31298077	.	A	G	27	21	48	0	1	50	1	0
2	31298280	.	A	G	25	16	41	0	2	43	0	0
2	31298342	.	G	A	23	26	49	0	1	50	0	0
2	31298483	.	C	A	26	17	43	0	3	46	0	0
2	31298550	.	T	C	18	14	32	0	0	32	0	0
2	31298703	.	T	G	12	21	33	0	0	33	0	0
2	31298723	.	C	T	13	21	34	0	3	37	0	0
2	31298824	.	A	C	23	17	40	0	3	44	1	0
2	31299241	.	A	C	4	4	8	0	0	8	0	0
2	31360724	.	G	A	3	6	9	0	0	9	0	0
2	31360799	.	G	A	4	2	6	0	1	7	0	0
2	31361205	.	C	T	1	4	5	0	0	5	0	0
2	31361380	.	A	C	1	2	3	0	0	3	0	0
2	31361466	.	C	G	3	2	5	0	0	5	0	0
2	31362285	.	A	G	11	4	15	0	1	16	0	0
2	31362642	.	T	C	10	5	15	0	0	15	0	0
2	31362681	.	T	C	9	9	18	0	1	19	0	0
2	31362730	.	A	T	7	7	14	0	1	15	0	0
2	31362859	.	T	A	5	6	11	0	3	14	0	0
2	31362896	.	T	C	10	8	18	0	0	18	0	0
2	31363190	.	C	T	15	18	33	1	1	35	0	0
2	31363322	.	A	T	5	3	8	0	0	8	0	0
2	31434685	.	A	G	1	2	3	0	0	3	0	0
2	31451354	.	A	T	2	2	4	0	0	4	0	0
2	31451518	.	G	A	6	3	9	0	1	10	0	0
2	31451542	.	G	A	8	7	15	0	0	15	0	0
2	31451568	.	C	T	7	9	16	0	1	17	0	0
2	31451778	.	G	T	6	9	15	0	2	17	0	0
2	31451871	.	T	A	15	4	19	0	2	21	0	0
2	31452078	.	C	T	13	14	27	0	1	28	0	0
2	31452226	.	T	C	20	20	40	0	1	41	0	0
2	31452354	.	C	T	22	19	41	0	2	43	0	0
2	31511810	.	C	A	3	2	5	0	0	5	0	0
2	31511884	.	A	C	3	3	6	0	1	7	0	0
2	31517270	.	G	A	0	1	1	0	2	3	0	0
2	31517311	.	G	A	1	2	3	0	0	3	0	0
2	31517312	.	G	A	1	2	3	0	0	3	0	0
2	31627079	.	T	A	7	6	13	0	0	13	0	0
2	31627150	.	C	A	13	8	21	0	2	23	0	0
2	31627173	.	C	T	13	9	22	0	1	23	0	0
2	31627212	.	C	G	6	7	13	0	2	15	0	0
2	31627219	.	C	T	7	7	14	0	0	14	0	0
2	31627423	.	C	G	1	4	5	0	4	9	0	0
2	31630129	.	A	T	9	4	13	0	1	14	0	0
2	31630443	.	G	A	10	8	18	0	0	18	0	0
2	31634870	.	A	G	5	6	11	0	0	11	0	0
2	31634929	.	A	C	6	7	13	0	1	14	0	0
2	31635007	.	A	T	8	5	13	0	1	14	0	0
2	31635161	.	A	G	5	5	10	0	1	11	0	0
2	31635229	.	C	T	10	5	15	0	3	18	0	0
2	31635287	.	T	C	12	11	23	0	1	24	0	0
2	31635395	.	T	G	4	14	18	0	0	18	0	0
2	31635490	.	A	T	16	8	24	0	1	25	0	0
2	31635599	.	T	C	5	6	11	0	0	11	0	0
2	31635803	.	G	T	3	7	10	0	0	10	0	0
2	31635824	.	C	T	4	4	8	0	0	8	0	0
2	31635859	.	C	T	4	4	8	0	0	8	0	0
2	31635860	.	T	C	4	4	8	0	0	8	0	0
2	31635900	.	T	C	4	5	9	0	0	9	0	0
2	31636048	.	A	G	3	5	8	0	2	10	0	0
2	31636057	.	T	C	4	0	4	0	6	10	0	0
2	31638004	.	C	T	3	4	7	0	0	7	0	0
2	31638323	.	A	C	4	0	4	0	7	11	0	0
2	31640561	.	T	C	1	2	3	0	0	3	0	0
2	31640573	.	C	A	1	2	3	0	0	3	0	0
2	31687529	.	A	G	0	4	4	0	0	4	0	0
2	31687537	.	A	C	1	0	1	0	5	6	0	0
2	31687697	.	G	A	3	4	7	0	0	7	0	0
2	31690434	.	T	A	9	9	18	0	0	18	0	0
2	31690442	.	A	C	8	10	18	0	1	19	0	0
2	31692370	.	T	C	5	10	15	0	2	17	0	0
2	31700250	.	A	C	2	7	9	0	0	9	0	0
2	31700352	.	A	T	3	6	9	0	0	9	0	0
2	31700378	.	T	G	4	8	12	0	1	13	0	0
2	31703368	.	T	A	2	6	8	0	0	8	0	0
2	31703407	.	A	G	3	8	11	0	0	11	0	0
2	31703443	.	C	T	3	3	6	0	3	9	0	0
2	31703678	.	C	T	1	5	6	0	2	8	0	0
2	31707724	.	C	G	1	2	3	0	0	3	0	0
2	31710374	.	A	T	2	4	6	0	0	6	0	0
2	31719452	.	C	T	1	5	6	0	0	6	0	0
2	31722631	.	A	T	6	6	12	0	0	12	0	0
2	31820830	.	T	C	2	7	9	0	1	10	0	0
2	31821290	.	C	A	6	14	20	0	0	20	0	0
2	31826750	.	C	T	19	15	34	0	4	38	0	0
2	31826942	.	C	A	11	10	21	0	1	22	0	0
2	31827649	.	A	G	18	11	29	0	2	31	0	0
2	31827714	.	A	G	13	1	14	0	8	22	0	0
2	31827944	.	A	G	1	0	1	0	2	3	0	0
2	31830382	.	C	A	9	3	12	0	1	13	0	0
2	31830410	.	G	A	10	5	15	0	0	15	0	0
2	31832360	.	T	C	6	4	10	0	0	10	0	0
2	31833082	.	C	T	8	4	12	0	0	12	0	0
2	31834099	.	G	T	4	8	12	0	1	13	0	0
2	31834110	.	T	C	3	9	12	0	1	13	0	0
2	31834187	.	C	T	6	2	8	0	1	9	0	0
2	31836113	.	T	G	14	6	20	0	1	21	0	0
2	31836119	.	G	T	1	8	9	0	13	22	0	0
2	31836307	.	T	A	22	10	32	0	2	34	0	0
2	31836440	.	A	G	8	0	8	0	6	14	0	0
2	31836550	.	C	A	6	2	8	0	1	9	0	0
2	31836588	.	T	C	5	4	9	0	0	9	0	0
2	31838524	.	A	G	4	4	8	0	0	8	0	0
2	31848541	.	A	G	4	2	6	0	1	7	0	0
2	31891344	.	T	A	21	15	36	0	1	37	0	0
2	31891447	.	A	T	21	24	45	0	2	47	0	0
2	31891513	.	T	C	19	22	41	0	4	45	0	0
2	31891549	.	C	A	28	23	51	0	3	54	0	0
2	31891618	.	A	G	31	27	58	0	0	58	0	0
2	31892076	.	A	G	17	24	41	0	1	42	0	0
2	31892100	.	C	T	4	25	29	1	21	51	0	0
2	31894220	.	T	C	22	13	35	0	2	37	0	0
2	31901953	.	T	C	7	11	18	0	0	18	0	0
2	31902939	.	G	A	11	3	14	0	0	14	0	0
2	31902954	.	C	T	9	4	13	0	0	13	0	0
2	31913491	.	A	G	5	4	9	0	0	9	0	0
2	31927266	.	C	T	1	3	4	0	4	9	1	0
2	31943041	.	A	G	2	5	7	0	2	9	0	0
2	31943187	.	A	G	1	5	6	0	0	6	0	0
2	31948424	.	A	G	2	3	5	0	2	7	0	0
2	31948438	.	A	G	2	2	4	0	2	6	0	0
2	31948459	.	C	T	2	3	5	0	0	5	0	0
2	31957808	.	T	C	2	4	6	0	0	6	0	0
2	31987352	.	A	C	8	3	11	0	0	11	0	0
2	31987360	.	C	T	9	3	12	0	0	12	0	0
2	31989876	.	T	C	9	5	14	0	0	14	0	0
2	31993886	.	T	C	8	8	16	0	2	18	0	0
2	32005371	.	G	A	19	18	37	1	2	40	0	0
2	32018077	.	A	C	5	8	13	0	0	13	0	0
2	32018141	.	A	G	7	0	7	0	8	15	0	0
2	32018219	.	A	T	2	1	3	0	1	4	0	0
2	32089567	.	T	A	2	2	4	0	0	4	0	0
2	32089590	.	T	C	1	4	5	0	0	5	0	0
2	32264673	.	T	C	17	0	17	0	23	40	0	0
2	32264879	.	G	A	17	11	28	0	6	34	0	0
2	32264927	.	T	A	21	14	35	0	2	37	0	0
2	32265437	.	T	A	8	9	17	0	2	19	0	0
2	32265508	.	T	C	7	5	12	0	0	12	0	0
2	32265525	.	T	C	9	1	10	0	3	13	0	0
2	32265543	.	A	T	10	6	16	0	1	17	0	0
2	32265911	.	T	C	7	3	10	0	0	10	0	0
2	32266064	.	G	C	9	14	23	0	0	23	0	0
2	32266101	.	T	G	6	11	17	1	3	22	1	0
2	32266895	.	A	G	4	6	10	0	1	11	0	0
2	32266961	.	T	C	3	3	6	0	0	6	0	0
2	32267105	.	T	G	1	9	10	0	1	12	1	0
2	32267117	.	C	T	0	10	10	0	4	14	0	0
2	32267285	.	A	G	5	6	11	0	0	11	0	0
2	32267506	.	T	C	5	6	11	0	1	12	0	0
2	32268096	.	C	T	0	2	2	0	5	7	0	0
2	32357638	.	A	G	2	4	6	0	0	6	0	0
2	32357811	.	G	A	16	15	31	0	0	31	0	0
2	32357888	.	A	G	11	8	19	0	0	19	0	0
2	32357980	.	T	C	8	0	8	0	13	21	0	0
2	32358059	.	T	C	10	1	11	0	8	19	0	0
2	32358081	.	A	T	11	5	16	0	0	16	0	0
2	32361446	.	A	T	6	5	11	0	0	11	0	0
2	32361447	.	G	T	6	5	11	0	0	11	0	0
2	32361687	.	T	C	21	2	23	0	13	36	0	0
2	32366137	.	T	C	13	14	27	0	3	30	0	0
2	32366191	.	C	T	7	14	21	0	0	21	0	0
2	32378607	.	T	C	3	2	5	0	0	5	0	0
2	32380649	.	A	G	2	7	9	0	0	9	0	0
2	32392166	.	A	G	5	4	9	0	0	9	0	0
2	32392244	.	C	G	1	4	5	0	0	5	0	0
2	32392314	.	C	T	3	3	6	0	0	6	0	0
2	32392724	.	A	G	2	2	4	0	0	4	0	0
2	32392787	.	C	A	0	2	2	0	3	5	0	0
2	32393101	.	A	G	2	2	4	0	1	5	0	0
2	32393259	.	A	G	3	7	10	0	0	10	0	0
2	32393281	.	T	A	3	3	6	0	0	6	0	0
2	32393579	.	T	C	4	2	6	0	0	6	0	0
2	32393670	.	A	G	3	3	6	0	1	7	0	0
2	32393731	.	G	A	4	2	6	0	1	7	0	0
2	32393966	.	A	G	1	2	3	0	0	3	0	0
2	32393985	.	A	G	1	1	2	0	1	3	0	0
2	32394067	.	G	C	2	2	4	0	0	4	0	0
2	32394424	.	T	C	1	2	3	0	0	3	0	0
2	32475941	.	A	T	8	10	18	0	2	20	0	0
2	32476018	.	T	G	7	7	14	0	1	15	0	0
2	32476288	.	C	T	10	20	30	0	1	31	0	0
2	32479556	.	T	C	9	0	9	0	14	23	0	0
2	32479616	.	G	A	7	6	13	0	1	14	0	0
2	32485832	.	A	G	6	2	8	0	0	8	0	0
2	32485895	.	C	T	0	3	3	0	3	6	0	0
2	32485962	.	G	A	2	4	6	0	0	6	0	0
2	32494705	.	C	T	0	2	2	0	2	4	0	0
2	32505664	.	G	A	8	9	17	0	2	19	0	0
2	32505713	.	A	G	17	4	21	0	7	28	0	0
2	32505715	.	A	G	21	0	21	0	6	27	0	0
2	32509247	.	G	A	2	2	4	0	0	4	0	0
2	32516268	.	C	A	2	12	14	0	11	25	0	0
2	32516509	.	A	T	6	7	13	0	1	14	0	0
2	32519666	.	A	G	5	6	11	0	0	11	0	0
2	32519690	.	G	A	3	4	7	0	0	7	0	0
2	32569745	.	A	G	5	4	9	0	0	9	0	0
2	32569909	.	T	C	3	0	3	0	4	7	0	0
2	32577552	.	C	A	10	8	18	0	0	18	0	0
2	32578124	.	A	T	12	11	23	0	2	25	0	0
2	32578330	.	A	G	3	9	12	0	0	12	0	0
2	32578642	.	A	G	8	17	25	0	1	26	0	0
2	32579109	.	C	T	4	7	11	0	0	11	0	0
2	32579170	.	C	A	3	0	3	0	0	3	0	0
2	32579330	.	G	T	2	6	8	0	1	9	0	0
2	32583144	.	A	G	6	6	12	0	0	12	0	0
2	32583345	.	C	T	4	4	8	0	0	8	0	0
2	32583528	.	C	T	1	3	4	0	1	5	0	0
2	32583600	.	A	G	2	3	5	0	1	6	0	0
2	32583629	.	A	C	3	0	3	0	3	6	0	0
2	32583639	.	T	C	3	0	3	0	4	7	0	0
2	32590861	.	A	G	1	3	4	0	0	4	0	0
2	32643639	.	A	G	4	3	7	0	1	8	0	0
2	32643644	.	T	C	2	2	4	0	1	5	0	0
2	32654034	.	A	G	3	8	11	0	1	12	0	0
2	32654040	.	T	C	5	0	5	0	11	16	0	0
2	32654570	.	T	C	23	15	38	0	2	40	0	0
2	32655542	.	T	C	18	0	18	0	12	30	0	0
2	32670836	.	C	T	0	5	5	0	1	6	0	0
2	32676292	.	G	A	4	4	8	0	0	8	0	0
2	32680338	.	C	T	1	4	5	0	1	6	0	0
2	32680356	.	C	T	2	5	7	0	0	7	0	0
2	32680383	.	A	C	1	0	1	0	5	6	0	0
2	32686597	.	A	G	1	2	3	0	0	3	0	0
2	32752378	.	C	T	1	4	5	0	0	5	0	0
2	32814677	.	G	C	4	3	7	0	1	8	0	0
2	32815234	.	G	A	4	4	8	0	0	8	0	0
2	32820806	.	G	T	3	3	6	0	0	6	0	0
2	32824745	.	C	A	1	3	4	0	0	4	0	0
2	32824778	.	G	A	2	3	5	0	0	5	0	0
2	32827055	.	T	C	1	4	5	0	0	5	0	0
2	32828704	.	C	T	1	4	5	0	1	6	0	0
2	32833524	.	T	C	3	8	11	0	0	11	0	0
2	32833563	.	T	G	2	9	11	0	0	11	0	0
2	32833590	.	C	T	5	9	14	0	0	14	0	0
2	33645157	.	A	G	1	2	3	0	0	3	0	0
2	33681337	.	A	T	26	11	37	0	3	40	0	0
2	33687090	.	G	A	4	7	11	0	1	12	0	0
2	33687110	.	C	A	8	7	15	0	1	16	0	0
2	33950050	.	C	A	2	2	4	0	0	4	0	0
2	34009014	.	G	A	3	3	6	0	0	6	0	0
2	34022992	.	T	A	5	14	19	0	1	21	1	0
2	34024832	.	A	G	8	5	13	0	2	15	0	0
2	34025167	.	G	A	5	6	11	0	0	11	0	0
2	34029353	.	G	A	2	5	7	0	0	7	0	0
2	34119783	.	G	A	0	6	6	0	4	10	0	0
2	34122859	.	A	G	4	3	7	0	0	7	0	0
2	34122985	.	C	T	1	5	6	0	0	6	0	0
2	34126040	.	T	C	4	3	7	0	0	7	0	0
2	34126514	.	G	T	8	5	13	0	1	14	0	0
2	34173253	.	C	T	3	3	6	0	1	7	0	0
2	34173335	.	A	C	4	5	9	0	1	10	0	0
2	34173336	.	G	A	4	6	10	0	0	10	0	0
2	34381013	.	T	G	12	5	17	0	0	17	0	0
2	34381032	.	T	C	11	4	15	0	0	15	0	0
2	34381066	.	C	T	9	3	12	0	1	13	0	0
2	34555410	.	A	G	3	3	6	0	0	6	0	0
2	34573032	.	A	T	2	2	4	0	0	4	0	0
2	34714557	.	A	G	3	0	3	0	2	5	0	0
2	34793415	.	C	T	1	5	6	0	1	7	0	0
2	34924412	.	A	G	4	11	15	0	0	15	0	0
2	35473715	.	G	A	0	3	3	0	2	5	0	0
2	35593848	.	T	C	7	11	18	0	0	18	0	0
2	35594003	.	G	A	11	8	19	1	0	20	0	0
2	35595551	.	A	T	7	6	13	0	2	15	0	0
2	35595561	.	A	G	5	9	14	0	0	14	0	0
2	35596842	.	A	G	8	12	20	0	1	21	0	0
2	35598219	.	A	T	11	13	24	0	1	25	0	0
2	35598257	.	C	G	16	13	29	0	0	29	0	0
2	35603795	.	A	G	2	2	4	0	0	4	0	0
2	35607077	.	G	C	2	6	8	0	1	9	0	0
2	35607191	.	C	T	7	7	14	0	2	16	0	0
2	35607206	.	C	T	8	8	16	0	0	16	0	0
2	35610541	.	T	C	10	14	24	0	0	24	0	0
2	35610598	.	T	C	12	22	34	0	1	35	0	0
2	35611279	.	C	T	10	18	28	1	4	33	0	0
2	35611595	.	T	G	16	21	37	0	1	38	0	0
2	35611765	.	G	A	5	4	9	0	0	9	0	0
2	35837252	.	A	C	1	5	6	0	0	6	0	0
2	35837270	.	A	G	1	5	6	0	0	6	0	0
2	35839687	.	G	A	0	4	4	0	3	7	0	0
2	35839714	.	G	A	0	3	3	0	5	8	0	0
2	35841933	.	G	A	0	4	4	0	3	7	0	0
2	35842020	.	G	A	4	2	6	0	1	7	0	0
2	35843680	.	A	G	6	3	9	0	0	9	0	0
2	35843812	.	G	A	12	5	17	0	3	20	0	0
2	35844070	.	A	G	10	0	10	0	6	16	0	0
2	35844160	.	A	C	3	5	8	0	0	8	0	0
2	35844433	.	A	G	8	8	16	0	6	22	0	0
2	35846511	.	A	G	12	0	12	0	9	21	0	0
2	35850881	.	G	T	4	1	5	0	1	6	0	0
2	35851120	.	G	T	10	4	14	0	0	14	0	0
2	35851152	.	C	T	8	4	12	0	1	13	0	0
2	35861334	.	C	T	4	4	8	0	1	9	0	0
2	35861363	.	T	A	4	3	7	0	0	7	0	0
2	35861746	.	T	C	3	3	6	0	0	6	0	0
2	35862971	.	T	C	3	7	10	0	0	10	0	0
2	35866515	.	T	G	3	6	9	0	0	9	0	0
2	35866593	.	G	A	1	6	7	0	2	9	0	0
2	35866787	.	T	C	6	8	14	0	1	15	0	0
2	35868275	.	T	G	10	7	17	0	0	17	0	0
2	35868319	.	A	G	8	4	12	0	0	12	0	0
2	35868568	.	G	A	3	7	10	0	0	10	0	0
2	35868896	.	A	G	6	6	12	0	0	12	0	0
2	35873561	.	T	A	1	3	4	0	0	4	0	0
2	36028724	.	T	G	22	21	43	0	5	48	0	0
2	36028957	.	G	A	17	12	29	0	0	29	0	0
2	36032791	.	C	T	8	10	18	0	1	19	0	0
2	36040733	.	T	C	11	14	25	0	1	26	0	0
2	36062111	.	T	C	1	2	3	0	0	3	0	0
2	36065871	.	A	G	4	6	10	0	1	11	0	0
2	36065976	.	A	G	3	0	3	0	5	8	0	0
2	36067656	.	G	A	3	4	7	0	0	7	0	0
2	36076419	.	T	G	11	6	17	0	0	17	0	0
2	36076501	.	A	G	8	1	9	0	15	24	0	0
2	36077276	.	A	G	20	0	20	0	14	34	0	0
2	36077384	.	A	G	6	3	9	0	1	10	0	0
2	36077542	.	T	C	10	18	28	0	1	29	0	0
2	36077543	.	T	G	10	0	10	0	19	29	0	0
2	36077664	.	C	T	15	16	31	0	1	32	0	0
2	36078370	.	T	G	16	17	33	0	2	35	0	0
2	36635902	.	C	T	1	4	5	0	0	5	0	0
2	36636028	.	G	A	0	4	4	0	2	6	0	0
2	36664493	.	T	G	19	11	30	0	1	31	0	0
2	36664545	.	A	G	12	14	26	0	1	27	0	0
2	36664679	.	C	G	20	13	33	0	1	34	0	0
2	36664799	.	G	T	18	18	36	0	1	37	0	0
2	36668765	.	G	A	14	7	21	1	1	23	0	0
2	36670595	.	A	G	11	7	18	0	0	18	0	0
2	36670778	.	G	A	7	4	11	0	0	11	0	0
2	36670785	.	T	G	4	4	8	0	0	8	0	0
2	36673261	.	G	A	4	5	9	0	0	9	0	0
2	36673264	.	T	C	4	5	9	0	0	9	0	0
2	36673643	.	T	A	3	2	5	0	1	6	0	0
2	36673805	.	C	T	10	3	13	0	1	14	0	0
2	36673866	.	G	T	14	5	19	1	1	21	0	0
2	36919311	.	T	C	1	2	3	0	0	3	0	0
2	36919383	.	T	C	3	0	3	0	2	5	0	0
2	37124546	.	G	A	6	3	9	0	4	13	0	0
2	38214974	.	T	G	13	7	20	30	1	52	1	0
2	39551159	.	A	G	4	3	7	1	1	9	0	0
2	39554873	.	A	G	25	6	31	0	1	32	0	0
2	39731366	.	A	C	0	5	5	0	10	15	0	0
2	39733437	.	T	A	6	2	8	0	0	8	0	0
2	41563509	.	T	C	1	2	3	0	0	3	0	0
2	41563513	.	T	C	1	2	3	0	0	3	0	0
2	43098294	.	G	T	1	2	3	0	0	3	0	0
2	43113478	.	T	C	2	3	5	0	1	6	0	0
2	43159217	.	T	G	11	6	17	0	4	21	0	0
2	43159613	.	A	G	1	3	4	0	0	4	0	0
2	43159781	.	A	G	4	3	7	0	1	8	0	0
2	43159868	.	T	C	1	2	3	0	0	3	0	0
2	43586793	.	A	C	16	14	30	0	1	31	0	0
2	43587478	.	A	T	11	8	19	0	0	19	0	0
2	43589691	.	C	G	15	10	25	0	0	25	0	0
2	43589856	.	T	C	13	18	31	0	1	32	0	0
2	43590136	.	A	T	8	8	16	1	3	20	0	0
2	43593210	.	C	T	1	5	6	0	5	11	0	0
2	43593651	.	T	C	7	3	10	0	0	10	0	0
2	43593696	.	T	G	5	3	8	0	2	10	0	0
2	43714362	.	A	G	6	12	18	0	0	18	0	0
2	43723092	.	C	T	2	7	9	0	0	9	0	0
2	43739401	.	G	C	1	2	3	0	1	4	0	0
2	43796756	.	G	A	0	9	9	0	4	13	0	0
2	43962071	.	C	G	4	13	17	0	0	17	0	0
2	43962108	.	C	A	0	12	12	0	8	20	0	0
2	43962242	.	T	A	5	6	11	0	0	11	0	0
2	43962279	.	C	T	2	11	13	0	3	16	0	0
2	43962328	.	T	A	8	10	18	0	1	19	0	0
2	43962483	.	T	A	4	8	12	0	1	13	0	0
2	43962600	.	C	T	1	3	4	0	0	4	0	0
2	43962610	.	T	C	4	2	6	0	0	6	0	0
2	43962864	.	C	T	1	6	7	0	9	16	0	0
2	43962983	.	T	C	7	5	12	0	0	12	0	0
2	43963097	.	G	C	4	5	9	0	0	9	0	0
2	43963136	.	C	T	0	6	6	0	3	9	0	0
2	43963163	.	C	T	0	9	9	0	6	15	0	0
2	43963202	.	T	C	4	0	4	0	7	11	0	0
2	43963454	.	A	T	6	10	16	0	1	17	0	0
2	43963493	.	A	G	2	8	10	0	0	10	0	0
2	43976333	.	C	A	1	3	4	0	0	4	0	0
2	43976339	.	T	C	1	0	1	0	2	3	0	0
2	44192871	.	T	C	21	19	40	0	2	42	0	0
2	44192893	.	T	C	25	23	48	0	2	50	0	0
2	44193029	.	T	A	28	22	50	0	3	53	0	0
2	44193742	.	C	T	2	19	21	1	9	31	0	0
2	44193769	.	T	G	9	22	31	1	2	34	0	0
2	44259855	.	G	A	38	32	70	0	2	72	0	0
2	44260002	.	C	T	35	48	83	1	2	86	0	0
2	44260088	.	A	G	30	36	66	0	1	68	1	0
2	44260100	.	A	T	33	36	69	0	2	71	0	0
2	44260358	.	G	A	30	29	59	0	3	62	0	0
2	44260836	.	T	C	32	0	32	5	21	58	0	0
2	44261028	.	A	G	29	15	44	0	0	44	0	0
2	44276731	.	A	G	23	23	46	0	2	48	0	0
2	44301404	.	C	T	1	3	4	0	2	6	0	0
2	44304374	.	A	G	6	3	9	0	0	9	0	0
2	44304386	.	T	C	4	4	8	0	1	9	0	0
2	44304485	.	G	C	3	0	3	0	3	6	0	0
2	44304515	.	T	C	8	4	12	0	0	12	0	0
2	44338569	.	T	C	2	2	4	0	0	4	0	0
2	44362435	.	G	A	2	4	6	0	0	6	0	0
2	44362475	.	G	A	0	2	2	0	2	4	0	0
2	44362483	.	G	A	2	2	4	0	0	4	0	0
2	44362806	.	A	G	1	2	3	0	0	3	0	0
2	44383457	.	A	G	10	9	19	0	0	19	0	0
2	44398551	.	A	C	2	4	6	0	0	6	0	0
2	44446240	.	T	C	2	1	3	0	0	3	0	0
2	44446246	.	G	A	1	2	3	0	1	4	0	0
2	44470110	.	A	G	1	0	1	0	4	5	0	0
2	44484882	.	T	C	4	2	6	0	1	7	0	0
2	44508273	.	A	G	8	10	18	0	0	18	0	0
2	44509873	.	T	C	11	10	21	0	2	23	0	0
2	44510073	.	T	C	15	15	30	0	2	32	0	0
2	44510263	.	T	A	6	7	13	0	0	13	0	0
2	44510273	.	T	G	5	6	11	0	2	13	0	0
2	44510506	.	A	G	8	0	8	0	9	17	0	0
2	44510569	.	T	C	12	10	22	0	0	22	0	0
2	44510596	.	A	G	9	6	15	0	0	15	0	0
2	44550950	.	C	T	1	3	4	0	1	5	0	0
2	44554362	.	A	T	6	5	11	0	0	11	0	0
2	44556982	.	G	A	1	10	11	0	12	23	0	0
2	44556983	.	G	A	12	10	22	0	1	23	0	0
2	44557141	.	C	T	9	5	14	0	2	16	0	0
2	44557187	.	T	C	7	8	15	0	2	17	0	0
2	44557264	.	T	C	4	2	6	0	0	6	0	0
2	44557265	.	A	T	4	2	6	0	0	6	0	0
2	44669595	.	G	T	2	2	4	0	0	4	0	0
2	44678904	.	C	G	2	3	5	0	0	5	0	0
2	44678913	.	A	G	1	3	4	0	2	6	0	0
2	44682684	.	C	T	1	2	3	0	0	3	0	0
2	44692527	.	T	C	2	4	6	0	0	6	0	0
2	44692529	.	C	T	2	4	6	0	0	6	0	0
2	44692746	.	C	T	1	2	3	0	0	3	0	0
2	44697590	.	T	C	18	12	30	0	1	31	0	0
2	44720175	.	A	G	13	14	27	0	1	28	0	0
2	44720201	.	G	A	13	11	24	0	0	24	0	0
2	44720423	.	G	A	10	7	17	0	1	18	0	0
2	44752545	.	A	G	2	5	7	0	0	7	0	0
2	44757781	.	G	A	1	1	2	0	1	3	0	0
2	44757790	.	C	T	0	1	1	0	1	2	0	0
2	44923110	.	T	G	3	2	5	0	0	5	0	0
2	44924662	.	G	A	0	2	2	0	4	6	0	0
2	44944789	.	A	T	27	28	55	0	2	57	0	0
2	44961505	.	G	A	5	3	8	0	0	8	0	0
2	44961734	.	G	T	1	3	4	0	0	4	0	0
2	44961792	.	G	T	3	2	5	0	0	5	0	0
2	44961830	.	G	A	3	3	6	0	0	6	0	0
2	44961831	.	G	A	3	2	5	0	1	6	0	0
2	44962870	.	T	G	1	2	3	0	1	4	0	0
2	44962973	.	A	T	1	1	2	0	1	3	0	0
2	44963010	.	G	A	2	2	4	0	0	4	0	0
2	44963011	.	A	G	1	2	3	0	1	4	0	0
2	44980270	.	T	C	4	3	7	0	0	7	0	0
2	44980341	.	C	T	4	5	9	0	0	9	0	0
2	44980359	.	C	T	2	7	9	0	0	9	0	0
2	44980422	.	T	C	3	7	10	0	0	10	0	0
2	44980562	.	A	G	4	4	8	1	0	9	0	0
2	44980625	.	T	A	2	6	8	0	0	8	0	0
2	44980997	.	G	T	8	4	12	0	0	12	0	0
2	44981043	.	C	T	8	5	13	0	0	13	0	0
2	45116988	.	C	G	2	14	16	0	11	27	0	0
2	45117063	.	A	G	7	15	22	1	1	24	0	0
2	45117076	.	T	C	5	14	19	1	1	21	0	0
2	45117280	.	C	A	16	14	30	0	2	32	0	0
2	45117354	.	G	C	15	27	42	1	1	44	0	0
2	45117440	.	T	A	15	16	31	0	3	34	0	0
2	45117712	.	T	A	14	12	26	0	0	26	0	0
2	45129977	.	G	A	10	12	22	0	0	22	0	0
2	45132677	.	A	G	6	8	14	0	0	14	0	0
2	45139622	.	A	G	3	2	5	0	0	5	0	0
2	45139633	.	T	A	3	3	6	0	1	7	0	0
2	45139669	.	A	G	4	4	8	0	0	8	0	0
2	45139729	.	T	G	1	4	5	0	0	5	0	0
2	45139894	.	C	T	6	9	15	0	0	15	0	0
2	45142971	.	G	A	6	4	10	0	1	11	0	0
2	45143036	.	T	G	4	6	10	0	0	10	0	0
2	45144030	.	G	A	2	7	9	0	0	9	0	0
2	45144163	.	G	A	3	2	5	0	0	5	0	0
2	45145817	.	A	T	2	4	6	0	1	7	0	0
2	45145969	.	G	C	3	3	6	0	1	7	0	0
2	45145973	.	C	T	3	2	5	0	1	6	0	0
2	45149649	.	G	A	5	4	9	0	0	9	0	0
2	45149751	.	C	T	1	3	4	0	0	4	0	0
2	45359394	.	A	G	2	4	6	0	0	6	0	0
2	45359400	.	A	G	2	3	5	0	0	5	0	0
2	45359492	.	T	G	2	3	5	0	0	5	0	0
2	45359504	.	T	G	2	2	4	0	0	4	0	0
2	45362087	.	G	A	2	3	5	0	0	5	0	0
2	45362117	.	G	A	1	3	4	0	0	4	0	0
2	45362129	.	A	T	2	3	5	0	0	5	0	0
2	45376148	.	T	C	5	5	10	0	0	10	0	0
2	45410956	.	A	C	3	2	5	0	0	5	0	0
2	45491103	.	A	G	1	2	3	0	0	3	0	0
2	45491595	.	A	C	3	4	7	0	0	7	0	0
2	45491596	.	C	T	3	4	7	0	0	7	0	0
2	45491633	.	T	G	3	5	8	0	0	8	0	0
2	45492300	.	C	T	2	2	4	0	1	5	0	0
2	45492575	.	G	A	3	4	7	0	0	7	0	0
2	45496283	.	T	C	1	0	1	0	2	3	0	0
2	45655555	.	G	C	8	11	19	0	0	19	0	0
2	45655644	.	A	G	8	20	28	0	0	28	0	0
2	45656177	.	A	T	19	10	29	0	1	30	0	0
2	45656198	.	C	T	20	11	31	0	3	34	0	0
2	45656234	.	T	C	17	14	31	0	3	34	0	0
2	45656260	.	C	T	3	10	13	0	20	33	0	0
2	45656447	.	G	A	18	14	32	0	2	34	0	0
2	45661511	.	C	A	1	3	4	0	7	11	0	0
2	45663532	.	C	T	6	3	9	0	0	9	0	0
2	45663794	.	G	C	3	2	5	0	0	5	0	0
2	45665692	.	G	A	1	2	3	0	0	3	0	0
2	45665693	.	A	T	1	1	2	0	1	3	0	0
2	47512938	.	T	C	4	2	6	0	0	6	0	0
2	47587386	.	A	G	7	2	9	0	0	9	0	0
2	47955414	.	T	C	5	6	11	0	0	11	0	0
2	47955533	.	T	C	6	0	6	0	2	8	0	0
2	47955535	.	T	C	4	3	7	0	1	8	0	0
2	48120835	.	T	A	5	3	8	0	1	9	0	0
2	48120838	.	C	A	5	2	7	0	2	9	0	0
2	52052790	.	T	C	5	3	8	0	0	8	0	0
2	52057394	.	A	G	5	0	5	0	8	13	0	0
2	52060070	.	T	G	2	8	10	0	1	11	0	0
2	52060365	.	C	T	4	6	10	0	0	10	0	0
2	52060390	.	T	C	2	7	9	0	0	9	0	0
2	52060409	.	A	G	4	6	10	0	1	11	0	0
2	52060450	.	G	A	7	9	16	0	1	17	0	0
2	52060492	.	A	T	8	4	12	0	0	12	0	0
2	52062918	.	G	A	0	16	16	0	6	22	0	0
2	52062989	.	T	A	6	7	13	0	0	13	0	0
2	52063101	.	T	A	3	8	11	0	0	11	0	0
2	52063207	.	T	C	4	2	6	0	0	6	0	0
2	52063208	.	C	T	3	2	5	0	1	6	0	0
2	52063250	.	C	G	5	7	12	0	1	13	0	0
2	52814146	.	C	T	2	3	5	0	0	5	0	0
2	52815260	.	G	A	2	4	6	0	0	6	0	0
2	52815292	.	C	T	2	5	7	0	0	7	0	0
2	52826659	.	A	G	2	3	5	0	0	5	0	0
2	53065149	.	C	T	2	5	7	0	0	7	0	0
2	53065392	.	G	A	7	6	13	0	3	16	0	0
2	53065421	.	A	G	10	7	17	0	1	18	0	0
2	53665098	.	A	G	4	3	7	0	1	8	0	0
2	53673285	.	G	A	0	9	9	0	10	19	0	0
2	53673342	.	G	A	13	12	25	0	1	26	0	0
2	53673354	.	T	G	14	11	25	0	2	27	0	0
2	53673393	.	C	A	15	13	28	0	0	28	0	0
2	53675227	.	C	T	19	8	27	0	2	29	0	0
2	53720058	.	G	C	0	2	2	0	2	4	0	0
2	53720098	.	A	G	1	0	1	0	2	3	0	0
2	53721966	.	G	C	2	2	4	0	0	4	0	0
2	53721976	.	A	G	2	4	6	0	0	6	0	0
2	53724856	.	G	A	2	2	4	0	1	5	0	0
2	53750668	.	T	C	10	7	17	0	1	18	0	0
2	53750707	.	C	T	12	5	17	0	1	18	0	0
2	53750719	.	C	T	9	6	15	0	0	15	0	0
2	53893969	.	C	T	2	3	5	0	0	5	0	0
2	54049402	.	T	C	2	2	4	0	0	4	0	0
2	54774957	.	C	T	1	2	3	0	1	4	0	0
2	54775406	.	C	T	8	4	12	0	0	12	0	0
2	54775415	.	A	G	8	5	13	0	0	13	0	0
2	54775475	.	G	A	6	3	9	0	0	9	0	0
2	54775929	.	G	C	2	4	6	0	0	6	0	0
2	54775940	.	T	C	3	2	5	0	1	6	0	0
2	54775998	.	T	C	1	3	4	0	0	4	0	0
2	54776108	.	G	T	0	5	5	0	1	6	0	0
2	54776170	.	G	T	2	2	4	0	0	4	0	0
2	54776560	.	T	C	4	5	9	0	1	10	0	0
2	54776870	.	C	T	5	3	8	0	0	8	0	0
2	54776966	.	A	G	2	5	7	0	1	8	0	0
2	54777178	.	T	G	7	9	16	0	0	16	0	0
2	54777642	.	G	A	5	4	9	0	0	9	0	0
2	54777849	.	G	A	6	7	13	0	1	14	0	0
2	54777855	.	C	A	6	8	14	0	0	14	0	0
2	54778064	.	G	A	1	3	4	0	1	5	0	0
2	54778255	.	C	T	3	10	13	0	0	13	0	0
2	54778577	.	C	G	14	12	26	0	2	28	0	0
2	54786533	.	G	A	9	9	18	0	1	19	0	0
2	54832405	.	A	G	3	2	5	0	0	5	0	0
2	54832709	.	T	C	1	4	5	0	0	5	0	0
2	54832750	.	T	A	4	4	8	0	0	8	0	0
2	54832961	.	A	G	3	0	3	0	5	8	0	0
2	54977337	.	A	G	1	0	1	0	5	6	0	0
2	54977431	.	C	T	5	3	8	0	0	8	0	0
2	54978640	.	T	G	4	0	4	0	2	6	0	0
2	54978647	.	T	A	4	2	6	0	0	6	0	0
2	54979273	.	G	C	0	5	5	0	3	8	0	0
2	55489017	.	A	G	2	0	2	0	2	4	0	0
2	55489261	.	C	T	6	2	8	0	0	8	0	0
2	55489317	.	T	A	12	13	25	0	0	25	0	0
2	55489342	.	T	G	12	16	28	0	0	28	0	0
2	55490181	.	A	G	9	15	24	0	1	25	0	0
2	55490232	.	T	C	15	7	22	1	0	23	0	0
2	55490325	.	T	A	11	11	22	0	2	24	0	0
2	55490326	.	C	T	13	11	24	0	0	24	0	0
2	55490377	.	A	G	12	8	20	0	0	20	0	0
2	55490378	.	G	A	11	6	17	0	2	19	0	0
2	55490521	.	T	C	14	7	21	0	0	21	0	0
2	55490686	.	T	A	14	6	20	0	1	21	0	0
2	55490812	.	T	C	13	8	21	0	0	21	0	0
2	55491380	.	A	G	7	9	16	0	2	18	0	0
2	55491445	.	T	G	15	13	28	0	0	28	0	0
2	55491471	.	C	T	20	11	31	0	2	33	0	0
2	55491666	.	G	A	27	8	35	0	0	35	0	0
2	55491717	.	G	A	18	18	36	0	0	36	0	0
2	55491884	.	T	C	12	20	32	0	2	34	0	0
2	55491893	.	T	C	11	22	33	0	1	34	0	0
2	55492010	.	G	A	19	19	38	0	0	38	0	0
2	55492064	.	T	C	16	19	35	0	6	41	0	0
2	55492108	.	A	G	15	0	15	0	19	34	0	0
2	55492127	.	T	A	13	15	28	0	2	30	0	0
2	55492285	.	T	C	4	7	11	0	0	11	0	0
2	55492286	.	C	T	4	7	11	0	0	11	0	0
2	55668454	.	G	A	0	2	2	0	1	3	0	0
2	55784084	.	T	C	4	2	6	0	0	6	0	0
2	55784269	.	A	G	1	3	4	0	0	4	0	0
2	55784674	.	G	A	1	3	4	0	0	4	0	0
2	55785502	.	T	C	3	2	5	0	0	5	0	0
2	55785636	.	C	A	1	4	5	0	0	5	0	0
2	55964935	.	A	T	2	3	5	0	0	5	0	0
2	55964953	.	G	A	0	3	3	0	2	5	0	0
2	55965050	.	T	C	1	2	3	0	0	3	0	0
2	55967195	.	T	C	2	4	6	0	0	6	0	0
2	55967341	.	A	T	9	5	14	3	0	17	0	0
2	55967471	.	A	T	4	9	13	0	1	14	0	0
2	55967473	.	C	T	10	4	14	0	0	14	0	0
2	55967758	.	T	C	13	8	21	1	0	22	0	0
2	55968056	.	C	A	3	4	7	0	0	7	0	0
2	55968117	.	G	A	2	5	7	0	0	7	0	0
2	55968383	.	A	C	14	12	26	0	0	26	0	0
2	55968447	.	C	T	16	8	24	0	0	24	0	0
2	55968472	.	A	G	12	0	12	0	8	20	0	0
2	55990139	.	G	A	1	3	4	0	0	4	0	0
2	56060821	.	G	A	2	4	6	0	0	6	0	0
2	56060838	.	G	A	2	4	6	0	0	6	0	0
2	56061488	.	A	G	3	3	6	3	0	9	0	0
2	56061520	.	C	T	0	3	3	2	3	8	0	0
2	56125687	.	T	C	18	21	39	0	1	40	0	0
2	56125744	.	G	C	22	0	22	0	22	44	0	0
2	56125773	.	C	T	22	22	44	0	0	44	0	0
2	56125945	.	T	C	7	1	8	0	0	10	2	0
2	56126011	.	T	A	3	2	5	0	0	5	0	0
2	56126359	.	A	G	2	2	4	0	0	4	0	0
2	56127185	.	A	T	2	2	4	0	0	4	0	0
2	56127493	.	T	C	5	10	15	0	0	15	0	0
2	56127693	.	T	G	8	9	17	0	1	18	0	0
2	56127720	.	C	G	8	12	20	0	0	20	0	0
2	56127848	.	T	A	2	5	7	0	0	7	0	0
2	56127951	.	A	T	3	5	8	0	0	8	0	0
2	56127962	.	T	C	2	8	10	0	0	10	0	0
2	56128025	.	A	G	7	14	21	0	0	21	0	0
2	56128527	.	A	G	4	5	9	0	1	10	0	0
2	56128622	.	T	C	5	5	10	0	1	11	0	0
2	56128677	.	C	T	7	2	9	0	0	9	0	0
2	56128687	.	A	T	7	2	9	0	1	10	0	0
2	56128768	.	A	T	4	2	6	0	0	6	0	0
2	56129001	.	A	G	6	8	14	0	0	14	0	0
2	56129633	.	A	G	7	7	14	0	0	14	0	0
2	56129920	.	T	A	3	4	7	0	1	8	0	0
2	56129931	.	A	G	4	4	8	0	0	8	0	0
2	56130019	.	A	C	5	2	7	0	0	7	0	0
2	56130259	.	A	G	4	2	6	0	0	6	0	0
2	56130260	.	C	A	4	2	6	0	0	6	0	0
2	56131264	.	A	T	8	5	13	0	0	13	0	0
2	56162404	.	C	G	2	2	4	0	0	4	0	0
2	56162412	.	C	T	2	2	4	0	0	4	0	0
2	56219233	.	G	A	4	7	11	0	0	11	0	0
2	56233253	.	C	T	6	7	13	0	3	16	0	0
2	56233498	.	C	G	11	5	16	0	0	16	0	0
2	56233508	.	G	T	10	6	16	0	1	17	0	0
2	56234286	.	C	T	10	13	23	0	4	27	0	0
2	56234580	.	T	G	23	12	35	0	4	39	0	0
2	56234584	.	G	T	15	15	30	0	1	31	0	0
2	56234670	.	A	T	19	16	35	0	0	35	0	0
2	56234700	.	C	T	19	20	39	0	3	42	0	0
2	56234872	.	A	T	17	16	33	0	0	33	0	0
2	56342894	.	G	A	34	37	71	0	1	72	0	0
2	56344833	.	A	G	33	33	66	0	4	70	0	0
2	56356730	.	G	T	6	9	15	0	0	15	0	0
2	56356806	.	T	C	7	3	10	0	0	10	0	0
2	56359434	.	A	G	7	5	12	0	0	12	0	0
2	56359495	.	G	A	1	3	4	0	1	5	0	0
2	56361406	.	G	A	2	3	5	0	0	5	0	0
2	56463308	.	C	T	8	9	17	2	1	20	0	0
2	56463333	.	C	A	12	5	17	0	0	17	0	0
2	56474451	.	C	T	15	17	32	9	1	42	0	0
2	56476732	.	C	T	21	21	42	0	4	46	0	0
2	56476762	.	A	G	23	14	37	0	4	41	0	0
2	56508695	.	T	C	32	11	43	0	8	51	0	0
2	56508715	.	C	G	26	15	41	0	0	41	0	0
2	56508769	.	T	G	28	15	43	0	2	45	0	0
2	56508797	.	A	T	29	16	45	0	2	47	0	0
2	56508878	.	A	G	15	8	23	0	2	25	0	0
2	56508880	.	C	T	14	9	23	0	2	25	0	0
2	56509165	.	T	C	20	7	27	1	2	30	0	0
2	56509183	.	T	C	21	10	31	0	3	34	0	0
2	56509912	.	A	T	20	16	36	0	1	37	0	0
2	56509929	.	A	C	16	26	42	0	1	43	0	0
2	56510040	.	T	C	11	0	11	0	14	25	0	0
2	56510216	.	G	A	7	18	25	1	2	28	0	0
2	56510424	.	G	T	13	4	17	2	0	19	0	0
2	56510450	.	T	C	12	3	15	1	0	16	0	0
2	56510492	.	T	C	6	11	17	1	2	20	0	0
2	56511047	.	C	T	5	7	12	0	1	13	0	0
2	56511064	.	G	T	3	7	10	0	0	10	0	0
2	56511463	.	A	C	1	2	3	0	0	3	0	0
2	56511575	.	C	T	8	6	14	0	0	14	0	0
2	56512032	.	C	T	5	7	12	0	3	15	0	0
2	56512054	.	T	C	8	0	8	1	10	19	0	0
2	56512162	.	C	T	4	10	14	0	0	14	0	0
2	56512173	.	A	C	3	11	14	0	1	15	0	0
2	56512265	.	T	A	4	5	9	0	0	9	0	0
2	56512266	.	A	T	5	4	9	0	0	9	0	0
2	56513510	.	A	C	3	3	6	0	0	6	0	0
2	56513660	.	C	T	0	4	4	0	2	6	0	0
2	56513742	.	C	A	6	6	12	0	1	13	0	0
2	56533104	.	C	G	3	5	8	0	3	11	0	0
2	56533178	.	A	C	5	0	5	0	4	9	0	0
2	56533234	.	A	T	3	5	8	0	1	9	0	0
2	56642185	.	C	G	19	13	32	0	1	33	0	0
2	56642365	.	A	T	39	14	53	0	1	55	1	0
2	56643465	.	G	A	31	26	57	0	1	58	0	0
2	56645018	.	G	A	33	30	63	0	0	63	0	0
2	56645027	.	G	A	31	28	59	0	3	62	0	0
2	57076329	.	G	T	3	3	6	0	0	6	0	0
2	57121623	.	A	T	1	2	3	0	0	3	0	0
2	57121773	.	C	T	1	2	3	0	1	4	0	0
2	57130154	.	G	A	1	2	3	0	0	3	0	0
2	57133362	.	C	T	1	2	3	0	1	4	0	0
2	57151194	.	G	A	17	23	40	0	1	41	0	0
2	57151242	.	G	T	11	25	36	0	1	37	0	0
2	57151326	.	A	G	16	0	16	0	11	27	0	0
2	57152858	.	T	G	24	12	36	0	0	36	0	0
2	57156050	.	C	A	13	16	29	0	1	30	0	0
2	57156092	.	C	A	11	16	27	0	0	27	0	0
2	57157952	.	C	T	27	18	45	0	1	46	0	0
2	57159557	.	G	A	19	24	43	0	1	44	0	0
2	57159668	.	G	A	17	30	47	0	6	53	0	0
2	57160272	.	C	T	17	22	39	0	2	41	0	0
2	57164902	.	A	G	30	21	51	0	2	53	0	0
2	57165001	.	C	T	28	19	47	0	1	48	0	0
2	57165544	.	C	T	26	31	57	0	3	60	0	0
2	57165565	.	C	T	34	25	59	0	4	63	0	0
2	57174931	.	T	A	10	2	12	0	4	16	0	0
2	57174934	.	T	A	9	1	10	0	6	16	0	0
2	57212864	.	G	A	1	2	3	0	0	3	0	0
2	57212966	.	T	C	2	0	2	0	3	5	0	0
2	57225181	.	C	T	0	3	3	0	3	6	0	0
2	57225187	.	A	G	2	3	5	0	0	5	0	0
2	57240649	.	C	T	0	6	6	0	4	10	0	0
2	57240668	.	G	T	5	5	10	0	0	10	0	0
2	57247280	.	C	A	0	5	5	1	12	18	0	0
2	57247385	.	C	G	9	3	12	1	0	13	0	0
2	57251501	.	A	T	5	2	7	0	0	7	0	0
2	57268947	.	C	A	29	22	51	0	1	52	0	0
2	57269031	.	C	G	25	25	50	0	3	53	0	0
2	57269123	.	C	A	24	26	50	0	6	56	0	0
2	57269136	.	T	A	25	28	53	0	0	53	0	0
2	57417062	.	C	T	2	2	4	0	0	4	0	0
2	57417223	.	G	A	4	9	13	0	0	13	0	0
2	57830385	.	T	C	16	0	16	1	14	31	0	0
2	57830581	.	A	G	15	14	29	0	2	31	0	0
2	57831603	.	A	T	8	8	16	0	1	17	0	0
2	57834927	.	T	C	13	8	21	0	1	22	0	0
2	57834930	.	T	C	13	9	22	0	0	22	0	0
2	57848889	.	G	C	3	2	5	0	0	5	0	0
2	57856706	.	C	T	5	2	7	0	0	7	0	0
2	57868433	.	T	C	4	8	12	3	0	15	0	0
2	57868580	.	A	G	15	14	29	0	2	31	0	0
2	57870003	.	A	G	6	4	10	0	0	10	0	0
2	57870049	.	G	A	7	3	10	3	1	14	0	0
2	57870051	.	A	G	9	1	10	3	2	15	0	0
2	57870155	.	C	T	16	6	22	1	0	23	0	0
2	57870180	.	T	C	21	10	31	0	2	33	0	0
2	57870323	.	G	T	12	3	15	2	0	17	0	0
2	57870343	.	A	G	11	1	12	1	6	19	0	0
2	57870383	.	G	A	7	6	13	0	0	13	0	0
2	57870622	.	G	C	3	2	5	0	0	5	0	0
2	57870659	.	A	T	7	4	11	0	1	12	0	0
2	57870713	.	C	G	6	7	13	0	1	14	0	0
2	57870794	.	G	T	25	9	34	0	1	35	0	0
2	57870795	.	T	A	26	9	35	0	0	35	0	0
2	57870830	.	A	G	22	6	28	0	7	35	0	0
2	57870868	.	G	A	0	7	7	0	25	32	0	0
2	57870887	.	A	G	24	0	24	0	9	33	0	0
2	57870934	.	T	C	13	8	21	0	3	24	0	0
2	57870984	.	A	T	7	11	18	0	2	20	0	0
2	57879582	.	T	C	8	19	27	0	2	29	0	0
2	57879615	.	T	C	9	2	11	0	15	26	0	0
2	57879618	.	T	C	7	15	22	0	2	24	0	0
2	57883433	.	C	T	16	26	42	0	2	44	0	0
2	57883452	.	C	T	23	19	42	0	1	43	0	0
2	57883509	.	C	T	1	27	28	0	13	41	0	0
2	57891444	.	G	A	6	11	17	0	0	17	0	0
2	57891463	.	T	C	3	5	8	0	0	8	0	0
2	57893054	.	C	T	4	2	6	0	0	6	0	0
2	57893082	.	A	C	5	2	7	0	0	7	0	0
2	57893340	.	A	T	2	3	5	2	0	7	0	0
2	57893346	.	G	A	2	2	4	2	1	7	0	0
2	57893494	.	G	A	3	5	8	0	0	8	0	0
2	57893547	.	A	G	2	4	6	0	1	7	0	0
2	57893826	.	A	G	4	2	6	0	0	6	0	0
2	57893933	.	C	G	1	3	4	0	0	4	0	0
2	57894012	.	T	C	5	1	6	0	5	11	0	0
2	57894127	.	T	G	3	6	9	0	0	9	0	0
2	57897379	.	T	C	1	2	3	1	1	5	0	0
2	57897388	.	C	T	2	2	4	2	0	6	0	0
2	57898875	.	G	A	1	3	4	0	0	4	0	0
2	57974883	.	T	C	1	2	3	0	0	3	0	0
2	58012041	.	T	G	3	6	9	0	0	9	0	0
2	58012271	.	T	C	4	3	7	0	0	7	0	0
2	58012293	.	T	C	3	3	6	0	0	6	0	0
2	58013448	.	G	A	5	3	8	1	0	9	0	0
2	58013903	.	A	G	7	0	7	0	6	13	0	0
2	58014110	.	G	T	8	6	14	0	1	15	0	0
2	58014156	.	A	T	10	11	21	0	1	22	0	0
2	58014364	.	G	A	8	7	15	0	1	16	0	0
2	58014502	.	G	A	3	8	11	0	0	11	0	0
2	58014537	.	T	C	2	8	10	0	0	10	0	0
2	58077869	.	T	C	4	3	7	0	2	9	0	0
2	58078071	.	G	C	4	7	11	0	0	11	0	0
2	58081768	.	G	A	4	6	10	0	1	11	0	0
2	58137902	.	A	C	1	2	3	0	0	3	0	0
2	58186872	.	T	C	5	4	9	0	0	9	0	0
2	58186891	.	G	T	5	5	10	0	2	12	0	0
2	58346702	.	T	A	1	3	4	0	0	4	0	0
2	58347944	.	C	T	6	8	14	0	0	14	0	0
2	58347965	.	G	C	2	4	6	0	1	7	0	0
2	58349274	.	T	C	9	3	12	0	0	12	0	0
2	58355559	.	A	C	3	0	3	0	2	5	0	0
2	58358563	.	A	T	1	2	3	0	0	3	0	0
2	58411998	.	T	C	13	14	27	0	0	27	0	0
2	58412124	.	G	A	1	12	13	0	15	28	0	0
2	58514819	.	T	C	15	8	23	0	1	24	0	0
2	58523710	.	C	A	0	7	7	0	3	10	0	0
2	58541894	.	C	T	8	10	18	0	3	21	0	0
2	58546821	.	G	T	7	6	13	0	1	14	0	0
2	58560081	.	G	C	5	4	9	0	0	9	0	0
2	58739173	.	G	C	12	6	18	0	1	19	0	0
2	58739511	.	C	T	3	5	8	0	0	8	0	0
2	58739714	.	G	A	4	14	18	0	1	19	0	0
2	58742525	.	C	T	1	2	3	0	0	3	0	0
2	58742652	.	G	A	0	11	11	0	10	21	0	0
2	58778264	.	G	A	7	8	15	0	1	16	0	0
2	58785866	.	T	C	4	5	9	0	1	10	0	0
2	58841219	.	T	C	15	13	28	0	0	28	0	0
2	58843563	.	G	A	0	9	9	12	10	31	0	0
2	58843569	.	T	C	10	8	18	7	1	26	0	0
2	58845396	.	T	C	5	12	17	0	0	17	0	0
2	58868190	.	G	A	6	7	13	0	1	14	0	0
2	58868193	.	G	A	7	6	13	0	3	16	0	0
2	58868508	.	A	C	10	1	11	0	7	18	0	0
2	58868577	.	G	C	10	0	10	0	5	15	0	0
2	58869142	.	G	A	4	4	8	0	0	8	0	0
2	58869166	.	G	A	3	4	7	0	0	7	0	0
2	58869268	.	A	G	0	3	3	0	1	4	0	0
2	58878288	.	G	A	0	4	4	0	5	9	0	0
2	58878612	.	C	T	11	8	19	0	0	19	0	0
2	58879122	.	C	G	17	1	18	0	13	31	0	0
2	58887668	.	T	C	3	4	7	0	2	9	0	0
2	58888966	.	C	A	9	6	15	1	2	18	0	0
2	58892160	.	C	T	7	6	13	0	1	14	0	0
2	58914896	.	A	G	0	2	2	0	1	3	0	0
2	59023901	.	T	C	2	3	5	0	0	5	0	0
2	59032670	.	T	C	6	9	15	0	2	17	0	0
2	59045797	.	G	A	0	4	4	0	3	7	0	0
2	59045912	.	A	G	4	0	4	0	4	8	0	0
2	59050160	.	C	T	4	8	12	0	0	12	0	0
2	59054254	.	A	G	13	20	33	0	4	37	0	0
2	59136533	.	G	A	1	3	4	1	0	5	0	0
2	59136859	.	T	C	3	3	6	0	0	6	0	0
2	59137027	.	C	G	7	5	12	10	0	22	0	0
2	59137050	.	T	A	6	6	12	4	1	17	0	0
2	59137113	.	C	T	2	7	9	0	1	10	0	0
2	59137184	.	G	T	2	5	7	0	1	8	0	0
2	59137356	.	G	C	2	0	2	0	2	4	0	0
2	59137357	.	A	G	2	2	4	0	0	4	0	0
2	59143183	.	A	G	1	5	6	0	1	7	0	0
20	22552	.	A	C	2	1	3	0	1	4	0	0
20	1241523	.	T	C	4	4	8	0	0	8	0	0
20	1295017	.	T	C	7	3	10	2	2	14	0	0
20	1295018	.	T	C	5	5	10	2	1	13	0	0
20	1295273	.	T	C	1	2	3	0	0	3	0	0
20	1295302	.	T	C	2	4	6	0	0	6	0	0
20	2034382	.	G	A	1	2	3	0	0	3	0	0
20	2241179	.	A	C	1	2	3	0	0	3	0	0
20	2241871	.	C	T	1	3	4	0	0	4	0	0
20	2241905	.	T	C	2	3	5	0	0	5	0	0
20	2290470	.	G	A	5	7	12	0	0	12	0	0
20	2295306	.	T	C	10	8	18	0	5	23	0	0
20	2295532	.	G	A	10	12	22	0	3	25	0	0
20	2295640	.	A	G	11	9	20	0	3	23	0	0
20	2318995	.	A	G	2	6	8	0	0	8	0	0
20	2319013	.	C	T	0	5	5	0	3	8	0	0
20	2359155	.	T	A	1	3	4	0	0	4	0	0
20	2361074	.	G	A	2	2	4	0	0	4	0	0
20	2361194	.	C	T	3	3	6	0	0	6	0	0
20	2361200	.	C	T	0	4	4	0	3	7	0	0
20	2460902	.	G	C	1	6	7	0	1	8	0	0
20	2479225	.	C	T	4	7	11	0	1	12	0	0
20	2499748	.	T	G	4	6	10	0	0	10	0	0
20	2499749	.	G	T	4	6	10	0	0	10	0	0
20	2499995	.	C	T	11	19	30	0	3	33	0	0
20	2500083	.	G	A	10	15	25	0	2	27	0	0
20	2506085	.	G	T	11	4	15	0	2	17	0	0
20	2515792	.	A	G	4	4	8	0	0	8	0	0
20	2515807	.	C	T	4	3	7	0	0	7	0	0
20	2515903	.	G	A	2	3	5	0	0	5	0	0
20	2519064	.	G	A	3	3	6	0	0	6	0	0
20	2519136	.	G	A	7	5	12	0	0	12	0	0
20	2519854	.	G	A	3	2	5	0	0	5	0	0
20	2524484	.	C	T	2	2	4	0	0	4	0	0
20	2524499	.	G	A	4	4	8	0	0	8	0	0
20	2544891	.	T	C	1	2	3	0	0	3	0	0
20	2716055	.	A	G	9	4	13	0	1	14	0	0
20	2716234	.	A	G	16	13	29	0	0	29	0	0
20	2716614	.	A	G	26	19	45	0	0	45	0	0
20	2718643	.	C	T	11	13	24	0	0	24	0	0
20	2718866	.	G	A	9	9	18	0	2	20	0	0
20	2721834	.	G	A	9	14	23	0	0	23	0	0
20	2725716	.	C	T	7	8	15	0	0	15	0	0
20	2737535	.	G	A	4	9	13	0	1	14	0	0
20	2738620	.	C	T	12	14	26	0	1	27	0	0
20	2739065	.	C	T	15	8	23	0	0	23	0	0
20	2739543	.	T	C	18	9	27	0	2	29	0	0
20	2739760	.	A	T	16	9	25	0	0	25	0	0
20	2741340	.	T	C	15	13	28	0	1	29	0	0
20	2744280	.	A	T	10	9	19	0	0	20	1	0
20	2744455	.	A	T	12	8	20	0	2	22	0	0
20	2744759	.	G	T	13	23	36	0	0	36	0	0
20	2744945	.	C	A	15	11	26	0	1	27	0	0
20	2975121	.	A	C	2	4	6	0	0	6	0	0
20	2975271	.	C	T	7	6	13	0	0	13	0	0
20	2976263	.	A	G	11	3	14	3	0	17	0	0
20	2976909	.	C	A	16	4	20	1	1	22	0	0
20	2977257	.	C	T	16	17	33	1	3	37	0	0
20	2982464	.	C	T	3	3	6	0	0	6	0	0
20	2982755	.	G	T	8	10	18	0	1	19	0	0
20	2982943	.	T	C	6	4	10	1	0	11	0	0
20	2983673	.	G	T	10	6	16	0	0	16	0	0
20	2986822	.	G	C	12	11	23	0	0	23	0	0
20	2986861	.	G	A	11	10	21	0	1	22	0	0
20	2996621	.	C	T	4	2	6	0	0	6	0	0
20	3005826	.	A	T	10	9	19	0	1	20	0	0
20	3005855	.	A	C	12	8	20	0	2	22	0	0
20	3016311	.	G	A	11	6	17	0	1	18	0	0
20	3017445	.	C	T	13	4	17	0	0	17	0	0
20	3017513	.	C	A	1	8	9	0	4	13	0	0
20	3017529	.	C	T	1	8	9	0	4	13	0	0
20	3017604	.	G	C	5	4	9	0	0	9	0	0
20	3022582	.	T	A	4	7	11	0	0	11	0	0
20	3039818	.	G	A	2	3	5	0	0	5	0	0
20	3130185	.	C	T	2	4	6	0	0	6	0	0
20	3130487	.	T	C	2	3	5	0	0	5	0	0
20	3130596	.	C	A	2	4	6	0	0	6	0	0
20	3130601	.	C	A	2	4	6	0	0	6	0	0
20	3239205	.	C	G	0	7	7	0	7	14	0	0
20	3239383	.	A	T	11	10	21	0	2	23	0	0
20	3239450	.	A	T	5	12	17	0	0	17	0	0
20	3239466	.	G	C	4	12	16	0	0	16	0	0
20	3242661	.	C	T	8	13	21	0	4	25	0	0
20	3242664	.	T	A	9	15	24	0	1	25	0	0
20	3242733	.	G	A	15	5	20	0	0	20	0	0
20	3242887	.	T	A	9	3	12	0	1	13	0	0
20	3246643	.	A	G	9	4	13	0	0	13	0	0
20	3248766	.	G	A	10	13	23	0	0	23	0	0
20	3248778	.	C	A	11	13	24	0	2	26	0	0
20	3248817	.	T	C	6	0	6	0	12	18	0	0
20	3248880	.	T	C	8	0	8	0	11	19	0	0
20	3248883	.	G	C	7	10	17	0	1	18	0	0
20	3248919	.	T	A	4	8	12	0	2	14	0	0
20	3249060	.	A	T	9	4	13	0	0	14	1	0
20	3249414	.	A	T	4	6	10	0	0	10	0	0
20	3249445	.	G	A	6	5	11	0	0	11	0	0
20	3249500	.	T	G	2	6	8	0	0	8	0	0
20	3249600	.	C	A	0	2	2	0	6	8	0	0
20	3249725	.	C	T	4	6	10	0	1	11	0	0
20	3249796	.	G	T	3	3	6	0	0	6	0	0
20	3254364	.	A	T	2	2	4	0	0	4	0	0
20	3282039	.	G	T	3	2	5	0	0	5	0	0
20	3283238	.	G	T	3	1	4	0	1	5	0	0
20	3283313	.	C	T	1	6	7	0	0	7	0	0
20	3284553	.	C	T	3	6	9	0	0	9	0	0
20	3288058	.	C	T	5	2	7	0	1	8	0	0
20	3288086	.	T	G	6	0	6	0	3	9	0	0
20	3290378	.	G	T	8	5	13	0	0	13	0	0
20	3290462	.	G	A	13	10	23	0	0	23	0	0
20	3290744	.	G	A	8	5	13	0	1	14	0	0
20	3292039	.	C	T	5	5	10	0	0	10	0	0
20	3292722	.	A	G	5	10	15	0	0	15	0	0
20	3292873	.	C	T	12	10	22	0	0	22	0	0
20	3295009	.	T	C	4	6	10	0	1	11	0	0
20	3298096	.	T	C	1	6	7	0	0	7	0	0
20	3298321	.	T	C	3	5	8	0	0	8	0	0
20	3300724	.	C	T	0	3	3	0	2	5	0	0
20	3307934	.	A	G	1	3	4	0	0	4	0	0
20	3312997	.	T	C	6	7	13	0	0	13	0	0
20	3313037	.	C	G	6	4	10	0	3	13	0	0
20	3313282	.	C	T	9	11	20	0	0	20	0	0
20	3344324	.	C	T	2	2	4	0	0	4	0	0
20	3344696	.	G	T	0	3	3	0	6	9	0	0
20	3344735	.	A	C	7	6	13	0	0	13	0	0
20	3344918	.	T	G	3	1	4	0	7	11	0	0
20	3344951	.	C	T	4	9	13	0	0	13	0	0
20	3344975	.	T	C	8	5	13	0	0	13	0	0
20	3345151	.	G	A	0	7	7	0	6	13	0	0
20	3345197	.	G	T	1	3	4	0	0	4	0	0
20	3345417	.	A	T	5	4	9	0	0	9	0	0
20	3346490	.	A	T	17	5	22	0	5	27	0	0
20	3346497	.	C	A	0	8	8	0	16	24	0	0
20	3346599	.	G	A	15	15	30	0	2	33	1	0
20	3346629	.	C	T	13	10	23	0	1	24	0	0
20	3346710	.	C	T	14	10	24	0	1	25	0	0
20	3346865	.	C	G	1	6	7	0	7	14	0	0
20	3346907	.	C	T	8	5	13	2	0	15	0	0
20	3349067	.	T	A	14	4	18	0	0	18	0	0
20	3351627	.	A	T	7	4	11	0	0	11	0	0
20	3351661	.	A	C	6	8	14	0	1	15	0	0
20	3353337	.	C	T	11	6	17	0	0	17	0	0
20	3355695	.	A	T	3	5	8	0	0	8	0	0
20	3357024	.	C	T	7	6	13	0	0	13	0	0
20	3359346	.	C	T	4	5	9	0	0	10	1	0
20	3361480	.	A	T	3	3	6	0	1	7	0	0
20	3365752	.	C	A	0	2	2	0	1	3	0	0
20	3365809	.	C	T	2	2	4	0	0	4	0	0
20	3365934	.	A	G	4	3	7	0	0	7	0	0
20	3372643	.	T	G	2	3	5	0	0	5	0	0
20	3375982	.	C	T	1	2	3	0	0	3	0	0
20	3920873	.	T	A	3	4	7	0	0	7	0	0
20	3920875	.	G	A	3	4	7	0	0	7	0	0
20	3921127	.	A	T	7	6	13	0	0	13	0	0
20	3921184	.	G	A	3	3	6	0	0	6	0	0
20	3921202	.	T	C	2	4	6	0	1	7	0	0
20	3923735	.	C	G	6	4	10	0	0	10	0	0
20	3923794	.	A	T	1	4	5	0	0	5	0	0
20	3923983	.	G	A	1	5	6	0	4	10	0	0
20	3924349	.	G	A	4	3	7	0	1	8	0	0
20	3924430	.	G	A	0	2	2	0	5	7	0	0
20	3924528	.	C	A	4	5	9	0	0	9	0	0
20	3924824	.	A	C	3	2	5	0	0	5	0	0
20	3924943	.	T	G	7	0	7	0	4	11	0	0
20	3925537	.	T	C	5	9	14	1	1	16	0	0
20	3925546	.	T	C	12	3	15	1	0	16	0	0
20	3925842	.	C	A	7	3	10	0	1	11	0	0
20	3925889	.	C	T	12	5	17	2	1	20	0	0
20	3925907	.	T	A	3	10	13	2	1	17	1	0
20	3925934	.	C	T	4	1	5	2	1	8	0	0
20	3925942	.	A	G	4	2	6	0	0	6	0	0
20	3926020	.	C	T	12	3	15	0	0	15	0	0
20	3926655	.	T	C	24	4	28	1	1	30	0	0
20	3926679	.	G	T	18	4	22	2	1	25	0	0
20	3926721	.	T	C	23	6	29	1	0	30	0	0
20	3926736	.	T	A	22	7	29	1	1	31	0	0
20	3926907	.	T	G	17	17	34	0	3	37	0	0
20	3926928	.	T	A	20	19	39	0	3	42	0	0
20	3926951	.	A	G	31	20	51	0	1	52	0	0
20	3927267	.	C	A	25	16	41	0	4	45	0	0
20	3927326	.	A	G	17	24	41	0	0	41	0	0
20	3927446	.	C	G	18	12	30	0	0	30	0	0
20	3927601	.	A	G	2	2	4	0	0	4	0	0
20	3947006	.	T	G	2	3	5	0	1	6	0	0
20	3947058	.	C	A	2	3	5	0	2	7	0	0
20	3953593	.	T	C	3	6	9	0	0	9	0	0
20	3954813	.	G	C	3	4	7	0	0	7	0	0
20	3954846	.	A	T	4	2	6	0	0	6	0	0
20	4010256	.	T	C	5	8	13	0	0	13	0	0
20	4010462	.	C	T	2	11	13	0	0	13	0	0
20	4035837	.	G	A	9	5	14	0	1	15	0	0
20	4036462	.	A	G	1	6	7	0	0	7	0	0
20	4036559	.	T	G	3	5	8	0	1	9	0	0
20	4036587	.	T	C	3	3	6	0	0	6	0	0
20	4037349	.	T	C	5	2	7	0	0	7	0	0
20	4037461	.	G	T	1	2	3	0	0	3	0	0
20	4037823	.	G	C	3	0	3	0	3	6	0	0
20	4037824	.	T	G	3	3	6	0	0	6	0	0
20	4037942	.	C	T	1	2	3	0	0	3	0	0
20	4052313	.	T	C	1	3	4	0	0	4	0	0
20	4052854	.	G	C	1	2	3	0	0	3	0	0
20	4153436	.	A	G	2	5	7	0	0	7	0	0
20	4153540	.	T	C	1	3	4	0	0	4	0	0
20	4175807	.	T	A	1	1	2	0	1	3	0	0
20	4712880	.	G	A	13	7	20	0	0	20	0	0
20	4712979	.	A	T	16	20	36	0	2	38	0	0
20	4713027	.	T	A	10	18	28	0	0	29	1	0
20	4713033	.	C	T	15	16	31	0	2	33	0	0
20	4713169	.	G	T	18	14	32	0	6	38	0	0
20	4713654	.	G	A	15	18	33	0	1	34	0	0
20	4713716	.	G	A	10	25	35	0	1	36	0	0
20	4713956	.	C	T	20	24	44	1	1	46	0	0
20	4716436	.	A	G	14	16	30	0	1	31	0	0
20	4717647	.	C	T	12	5	17	0	1	18	0	0
20	4726955	.	A	T	4	9	13	0	1	14	0	0
20	4726973	.	A	G	5	11	16	0	0	16	0	0
20	4728808	.	C	T	15	8	23	0	1	24	0	0
20	4730914	.	G	A	14	10	24	1	0	25	0	0
20	4730935	.	C	T	14	12	26	1	0	27	0	0
20	4734412	.	C	T	12	9	21	0	0	21	0	0
20	4738004	.	T	C	6	7	13	0	1	14	0	0
20	4745754	.	T	C	12	6	18	0	1	19	0	0
20	4745774	.	C	T	7	6	13	0	2	15	0	0
20	4747480	.	G	T	7	4	11	0	0	11	0	0
20	4756640	.	A	C	5	2	7	0	1	8	0	0
20	4756643	.	A	G	6	2	8	0	0	8	0	0
20	4756804	.	C	A	5	2	7	0	0	7	0	0
20	4756917	.	T	C	1	0	1	0	2	3	0	0
20	4761674	.	A	G	1	2	3	0	0	3	0	0
20	4761680	.	A	G	2	2	4	0	0	4	0	0
20	4828170	.	T	A	2	3	5	0	0	5	0	0
20	4828230	.	A	G	2	7	9	0	0	9	0	0
20	4885321	.	A	G	1	2	3	0	0	3	0	0
20	4895176	.	A	C	2	3	5	0	0	5	0	0
20	4895955	.	C	T	11	9	20	0	1	21	0	0
20	4896120	.	G	T	15	10	25	0	3	28	0	0
20	4896201	.	G	A	9	9	18	0	1	19	0	0
20	4898515	.	C	T	21	16	37	0	2	39	0	0
20	4898563	.	A	T	20	12	32	0	3	35	0	0
20	4898575	.	A	T	12	20	32	0	2	35	1	0
20	4898631	.	A	T	21	16	37	6	3	46	0	0
20	4898683	.	C	T	16	19	35	1	5	41	0	0
20	4898776	.	C	T	18	16	34	0	7	41	0	0
20	4898784	.	T	C	20	15	35	0	2	37	0	0
20	4898855	.	C	T	0	16	16	0	13	29	0	0
20	4899479	.	A	G	8	5	13	0	0	13	0	0
20	4899969	.	T	G	9	9	18	0	1	19	0	0
20	4900495	.	C	T	1	5	6	0	5	11	0	0
20	4900600	.	G	A	6	3	9	0	0	9	0	0
20	4900855	.	C	T	8	3	11	0	0	11	0	0
20	4900909	.	T	C	5	0	5	0	5	10	0	0
20	4900921	.	A	G	6	2	8	0	0	8	0	0
20	4901013	.	C	T	5	3	8	0	0	8	0	0
20	4902954	.	A	G	1	2	3	0	0	3	0	0
20	5003079	.	A	G	1	2	3	0	0	3	0	0
20	6803097	.	A	T	0	11	11	0	0	11	0	0
20	6803105	.	A	T	4	7	11	0	2	13	0	0
20	6803170	.	G	T	4	6	10	0	1	11	0	0
20	6803213	.	T	G	3	5	8	0	0	8	0	0
20	7449851	.	C	T	1	3	4	0	0	4	0	0
20	7459071	.	T	G	2	2	4	0	0	4	0	0
20	7464122	.	G	T	1	1	2	0	1	3	0	0
20	7965965	.	G	A	4	8	12	0	1	13	0	0
20	7966006	.	A	T	7	8	15	0	0	15	0	0
20	7966049	.	T	G	6	3	9	0	2	11	0	0
20	7966555	.	C	G	4	5	9	0	0	9	0	0
20	7967030	.	T	C	2	0	2	0	3	5	0	0
20	7967128	.	C	T	0	3	3	0	5	8	0	0
20	7967251	.	C	T	4	3	7	0	0	7	0	0
20	8122926	.	A	G	2	1	3	0	0	3	0	0
20	8122938	.	T	A	1	3	4	0	0	4	0	0
20	9115200	.	C	A	1	2	3	0	0	3	0	0
20	9120687	.	C	T	1	4	5	0	0	5	0	0
20	9124503	.	A	T	3	3	6	0	0	6	0	0
20	9124759	.	C	T	1	3	4	0	0	4	0	0
20	9124996	.	A	G	2	0	2	0	7	9	0	0
20	9125264	.	G	A	1	2	3	0	0	3	0	0
20	9125291	.	T	A	1	3	4	0	1	5	0	0
20	9125335	.	T	A	1	5	6	0	0	6	0	0
20	9133127	.	T	G	3	3	6	0	0	6	0	0
20	9148121	.	G	C	6	4	10	0	2	12	0	0
20	9183337	.	T	C	9	0	9	0	13	22	0	0
20	9184696	.	T	C	3	5	8	0	2	10	0	0
20	9184928	.	C	A	6	4	10	0	1	11	0	0
20	9186281	.	T	C	4	0	4	0	10	14	0	0
20	9186310	.	T	C	3	7	10	0	1	11	0	0
20	9190991	.	A	G	6	2	8	0	1	9	0	0
20	9191144	.	G	A	4	4	8	0	0	8	0	0
20	9191255	.	T	C	7	1	8	0	4	12	0	0
20	9191267	.	T	A	4	3	7	0	1	8	0	0
20	9191461	.	C	T	4	2	6	0	0	6	0	0
20	9192444	.	C	T	1	2	3	0	0	3	0	0
20	9193285	.	C	T	2	2	4	0	0	4	0	0
20	9242422	.	G	C	7	5	12	0	0	12	0	0
20	9248482	.	T	C	2	0	2	0	2	4	0	0
20	9355967	.	C	T	2	7	9	0	0	9	0	0
20	9412642	.	C	T	6	5	11	0	0	11	0	0
20	9418744	.	A	G	5	5	10	0	0	10	0	0
20	9418804	.	T	C	4	4	8	0	0	8	0	0
20	9419014	.	A	T	7	5	12	0	1	13	0	0
20	9419218	.	G	A	7	9	16	0	0	16	0	0
20	9419314	.	C	T	9	5	14	0	1	15	0	0
20	9419575	.	C	T	12	13	25	0	1	26	0	0
20	9419716	.	T	C	11	12	23	0	0	23	0	0
20	9420018	.	C	T	8	13	21	0	1	22	0	0
20	9420168	.	T	C	7	13	20	0	0	20	0	0
20	9421011	.	A	G	24	1	25	0	27	52	0	0
20	9421515	.	G	A	2	3	5	0	0	5	0	0
20	9421672	.	C	T	1	12	13	0	13	26	0	0
20	9421690	.	G	T	11	11	22	0	0	22	0	0
20	9421732	.	T	A	9	13	22	0	1	23	0	0
20	9421781	.	T	C	12	0	12	0	14	26	0	0
20	9422045	.	G	A	10	9	19	0	0	19	0	0
20	9422536	.	G	A	8	7	15	0	0	15	0	0
20	9422566	.	G	A	6	6	12	0	0	12	0	0
20	9427737	.	G	T	3	4	7	0	0	7	0	0
20	9429315	.	G	T	20	11	31	4	0	35	0	0
20	9429363	.	G	A	28	18	46	3	1	50	0	0
20	9429370	.	C	T	28	17	45	2	1	48	0	0
20	9429414	.	T	C	30	1	31	0	24	55	0	0
20	9429648	.	A	G	19	22	41	0	0	41	0	0
20	9436314	.	A	T	9	8	17	0	4	21	0	0
20	9436363	.	A	G	11	15	26	0	1	27	0	0
20	9462312	.	T	A	8	9	17	0	0	17	0	0
20	9462412	.	G	T	5	6	11	0	0	11	0	0
20	9566423	.	G	A	0	2	2	0	2	4	0	0
20	9575868	.	T	C	8	0	8	0	11	19	0	0
20	9576710	.	C	G	0	4	4	0	2	6	0	0
20	9577157	.	G	A	3	2	5	0	0	5	0	0
20	9577250	.	A	G	1	3	4	0	0	4	0	0
20	9577487	.	G	A	1	6	7	0	0	7	0	0
20	9764211	.	T	C	4	6	10	0	1	11	0	0
20	9766973	.	G	A	5	4	9	0	0	9	0	0
20	9768191	.	C	T	12	10	22	0	0	22	0	0
20	9768230	.	C	T	12	11	23	0	1	24	0	0
20	9768330	.	A	G	11	12	23	0	2	25	0	0
20	9775889	.	A	G	19	20	39	0	3	42	0	0
20	9775934	.	T	C	18	19	37	0	2	39	0	0
20	9776270	.	G	A	10	11	21	0	2	23	0	0
20	9776579	.	T	C	1	2	3	0	0	3	0	0
20	9777447	.	G	A	2	2	4	0	0	4	0	0
20	9779200	.	T	A	2	2	4	0	0	4	0	0
20	9782747	.	C	A	2	2	4	0	0	4	0	0
20	9782913	.	T	C	1	2	3	0	0	3	0	0
20	9820430	.	T	C	3	2	5	0	1	6	0	0
20	9830642	.	T	C	19	21	40	0	8	48	0	0
20	9830684	.	G	T	19	18	37	0	2	39	0	0
20	9831443	.	G	A	21	20	41	0	0	41	0	0
20	9831703	.	T	A	34	20	54	0	3	57	0	0
20	9837587	.	G	A	29	21	50	0	4	54	0	0
20	9837593	.	T	C	27	22	49	0	2	51	0	0
20	9846751	.	A	G	31	26	57	1	0	58	0	0
20	9846989	.	T	C	32	29	61	0	4	65	0	0
20	9846997	.	A	T	27	29	56	0	1	57	0	0
20	9847078	.	T	C	22	34	56	0	2	58	0	0
20	9847252	.	G	T	8	7	15	0	1	16	0	0
20	9847298	.	T	G	6	12	18	0	0	18	0	0
20	9847304	.	G	A	7	10	17	0	1	18	0	0
20	9847529	.	A	T	30	14	44	0	0	44	0	0
20	9847772	.	T	C	28	21	49	0	0	49	0	0
20	9847895	.	C	T	23	24	47	0	3	50	0	0
20	9848116	.	C	T	41	25	66	0	1	67	0	0
20	9848181	.	A	T	49	12	61	0	6	67	0	0
20	9848196	.	T	G	48	17	65	0	3	68	0	0
20	9959377	.	G	A	2	2	4	0	0	4	0	0
20	9959699	.	T	A	5	7	12	1	0	13	0	0
20	9959725	.	C	T	2	4	6	1	0	7	0	0
20	10057929	.	T	C	1	3	4	0	0	4	0	0
20	10057993	.	C	G	1	8	9	0	9	18	0	0
20	10058109	.	T	A	12	14	26	0	0	26	0	0
20	10058111	.	A	G	11	14	25	0	1	26	0	0
20	10058242	.	T	C	13	12	25	0	1	26	0	0
20	10058350	.	C	T	9	10	19	0	0	19	0	0
20	10058441	.	A	T	10	10	20	0	3	23	0	0
20	10058476	.	T	A	14	10	24	0	0	24	0	0
20	10058796	.	G	A	1	4	5	0	0	5	0	0
20	10058829	.	T	A	2	2	4	0	1	5	0	0
20	10058853	.	C	A	3	4	7	0	0	7	0	0
20	10058897	.	C	T	2	2	4	0	1	5	0	0
20	10058901	.	G	C	3	2	5	0	0	5	0	0
20	10058993	.	T	C	8	0	8	0	3	11	0	0
20	10059194	.	G	A	5	8	13	0	0	13	0	0
20	10059278	.	A	G	2	8	10	0	0	10	0	0
20	10059815	.	A	G	2	2	4	0	0	4	0	0
20	10060586	.	C	T	1	4	5	0	0	5	0	0
20	10060768	.	G	C	3	2	5	0	0	5	0	0
20	10061481	.	T	G	2	2	4	0	0	4	0	0
20	10099362	.	T	A	6	2	8	0	0	8	0	0
20	10099363	.	C	T	6	2	8	0	0	8	0	0
20	10099521	.	T	G	6	5	11	0	1	12	0	0
20	10099602	.	C	A	2	4	6	0	5	11	0	0
20	10099603	.	C	A	3	6	9	0	2	11	0	0
20	10099816	.	C	T	9	8	17	0	1	18	0	0
20	10116067	.	A	G	8	7	15	0	0	15	0	0
20	10118393	.	A	T	1	2	3	0	1	4	0	0
20	10220138	.	T	C	2	3	5	0	0	5	0	0
20	10353718	.	G	T	1	2	3	0	0	3	0	0
20	10353728	.	A	G	1	2	3	0	0	3	0	0
20	10422619	.	A	C	1	3	4	0	0	4	0	0
20	10489564	.	A	G	5	3	8	0	1	9	0	0
20	11098255	.	G	A	5	4	9	0	4	13	0	0
20	11098301	.	T	C	7	4	11	0	1	12	0	0
20	11098547	.	T	A	7	2	9	0	0	9	0	0
20	11098710	.	C	A	6	2	8	0	0	8	0	0
20	11098960	.	G	A	2	6	8	0	0	8	0	0
20	11099013	.	G	A	11	5	16	0	0	16	0	0
20	11099064	.	C	T	3	4	7	0	1	8	0	0
20	14893339	.	A	C	4	8	12	0	1	13	0	0
20	14977165	.	G	A	2	7	9	0	7	16	0	0
20	14983779	.	C	T	9	7	16	0	1	17	0	0
20	14983788	.	C	T	9	6	15	0	1	16	0	0
20	14997711	.	G	C	11	7	18	0	1	19	0	0
20	14997729	.	G	A	12	6	18	0	0	18	0	0
20	14997753	.	T	A	12	9	21	0	1	22	0	0
20	15004153	.	T	C	16	13	29	0	2	31	0	0
20	15004205	.	C	T	18	14	32	0	1	33	0	0
20	15004321	.	C	T	12	19	31	0	0	31	0	0
20	15004334	.	A	C	10	22	32	0	1	33	0	0
20	15004518	.	A	G	9	13	22	0	0	22	0	0
20	15004575	.	C	A	7	19	26	0	1	27	0	0
20	15004611	.	A	C	12	20	32	0	0	32	0	0
20	15004710	.	C	T	13	8	21	0	0	21	0	0
20	15004746	.	T	A	12	7	19	0	1	20	0	0
20	15004751	.	T	G	14	6	20	0	0	20	0	0
20	15004806	.	C	T	15	9	24	0	0	24	0	0
20	15004825	.	A	T	14	7	21	0	2	23	0	0
20	15004862	.	T	C	14	10	24	0	0	24	0	0
20	15004874	.	A	G	12	0	12	0	12	24	0	0
20	15005055	.	A	C	6	5	11	0	1	12	0	0
20	15005092	.	G	A	2	3	5	0	3	8	0	0
20	15023488	.	T	C	11	4	15	0	3	18	0	0
20	15026847	.	C	T	0	10	10	0	10	20	0	0
20	15033954	.	A	G	9	4	13	2	1	16	0	0
20	15039385	.	C	T	0	1	1	0	2	3	0	0
20	15094116	.	G	A	2	2	4	0	0	4	0	0
20	15094133	.	G	C	2	1	3	0	1	4	0	0
20	15094168	.	A	G	2	2	4	0	1	5	0	0
20	15171711	.	C	T	8	3	11	0	0	11	0	0
20	15184455	.	C	T	22	16	38	0	3	42	1	0
20	15184458	.	A	G	17	2	19	0	20	39	0	0
20	15184527	.	T	A	19	19	38	0	0	38	0	0
20	15184568	.	T	G	22	19	41	0	2	43	0	0
20	15184611	.	A	T	16	17	33	0	0	33	0	0
20	15184629	.	T	G	17	9	26	0	0	26	0	0
20	15184654	.	C	T	7	13	20	0	0	20	0	0
20	15553003	.	C	T	16	8	24	0	0	24	0	0
20	15553159	.	A	G	12	8	20	0	1	21	0	0
20	15553366	.	G	T	16	9	25	0	1	26	0	0
20	15554247	.	A	G	20	14	34	0	0	34	0	0
20	15578007	.	G	A	0	3	3	0	3	6	0	0
20	15857317	.	G	C	11	20	31	0	1	32	0	0
20	15857761	.	T	A	18	19	37	0	0	37	0	0
20	15857805	.	T	A	20	19	39	0	2	41	0	0
20	15857850	.	C	T	17	14	31	0	1	32	0	0
20	15866267	.	A	G	17	10	27	0	0	27	0	0
20	15866414	.	T	C	11	5	16	0	3	19	0	0
20	15876778	.	A	G	17	6	23	0	0	23	0	0
20	15876812	.	G	A	14	9	23	0	1	24	0	0
20	15876824	.	C	A	2	6	8	0	14	22	0	0
20	15912192	.	C	T	0	4	4	0	3	7	0	0
20	15912906	.	T	C	6	4	10	0	0	10	0	0
20	15933068	.	C	T	1	5	6	0	3	9	0	0
20	15933168	.	G	C	12	16	28	1	1	30	0	0
20	15933223	.	C	A	15	10	25	1	4	30	0	0
20	15933229	.	T	C	16	12	28	1	1	30	0	0
20	15933258	.	C	T	14	12	26	1	1	28	0	0
20	15933289	.	G	A	10	18	28	0	1	29	0	0
20	15933419	.	G	A	13	9	22	0	0	22	0	0
20	15933424	.	T	C	11	12	23	0	0	23	0	0
20	15933489	.	T	C	8	0	8	0	11	19	0	0
20	15933553	.	G	A	7	4	11	0	0	11	0	0
20	15933566	.	G	A	5	8	13	0	0	13	0	0
20	15933852	.	C	T	5	14	19	0	2	21	0	0
20	15933961	.	C	T	3	6	9	0	3	12	0	0
20	15937278	.	C	G	1	3	4	0	0	4	0	0
20	16163282	.	C	T	7	12	19	0	2	21	0	0
20	16163333	.	T	C	11	2	13	0	12	25	0	0
20	16163348	.	T	C	16	11	27	0	2	29	0	0
20	16163384	.	A	G	14	21	35	0	1	36	0	0
20	16163447	.	T	C	11	0	11	0	7	18	0	0
20	16163552	.	G	A	8	6	14	0	1	15	0	0
20	16171113	.	G	C	2	0	2	0	5	7	0	0
20	16193658	.	T	C	3	8	11	0	0	11	0	0
20	16193899	.	C	T	1	4	5	0	0	5	0	0
20	16198986	.	G	A	2	11	13	0	15	28	0	0
20	16201109	.	T	A	9	5	14	0	0	14	0	0
20	16201111	.	G	A	0	6	6	0	5	11	0	0
20	16201200	.	C	T	10	13	23	1	3	27	0	0
20	16201649	.	A	C	14	13	27	0	1	28	0	0
20	16201709	.	A	G	12	6	18	0	1	19	0	0
20	16201759	.	T	C	12	9	21	0	0	21	0	0
20	16201812	.	A	G	4	6	10	0	0	10	0	0
20	16437895	.	A	G	8	9	17	0	0	17	0	0
20	16437958	.	A	G	5	10	15	0	2	17	0	0
20	16438097	.	G	A	11	16	27	0	0	27	0	0
20	16438119	.	T	A	11	15	26	0	0	26	0	0
20	16438252	.	G	A	11	9	20	0	1	21	0	0
20	16438258	.	A	T	11	10	21	0	1	22	0	0
20	16438658	.	A	T	10	4	14	0	1	15	0	0
20	16438854	.	T	C	4	6	10	0	2	12	0	0
20	16441658	.	C	T	6	6	12	0	0	12	0	0
20	16443545	.	G	A	3	6	9	0	0	9	0	0
20	16443740	.	C	T	2	7	9	0	2	11	0	0
20	16448930	.	T	C	2	2	4	0	0	4	0	0
20	16640049	.	C	T	1	2	3	0	0	3	0	0
20	16734343	.	C	T	16	10	26	0	0	26	0	0
20	16736960	.	G	A	16	8	24	0	4	28	0	0
20	16737485	.	C	T	14	21	35	0	3	38	0	0
20	16737512	.	C	T	19	17	36	0	3	39	0	0
20	16737524	.	T	C	19	21	40	0	2	42	0	0
20	16740834	.	G	A	17	11	28	0	2	30	0	0
20	16774513	.	A	T	30	27	57	0	3	60	0	0
20	16774868	.	A	G	36	16	52	2	4	58	0	0
20	16775173	.	C	T	31	22	53	0	1	54	0	0
20	16833019	.	C	T	0	5	5	0	10	15	0	0
20	16833089	.	A	G	8	9	17	0	1	18	0	0
20	16833096	.	A	G	9	8	17	0	0	17	0	0
20	16833125	.	C	T	10	7	17	0	0	17	0	0
20	16833213	.	G	C	3	5	8	0	0	8	0	0
20	16833560	.	T	C	3	5	8	0	0	8	0	0
20	16833806	.	C	A	3	8	11	0	2	13	0	0
20	16834096	.	T	C	2	5	7	0	1	8	0	0
20	16834525	.	A	G	6	3	9	0	0	9	0	0
20	16834572	.	C	T	0	5	5	0	5	11	1	0
20	16834647	.	T	C	6	3	9	0	1	10	0	0
20	16848908	.	C	T	3	2	5	0	0	5	0	0
20	16884434	.	C	T	3	7	10	0	1	11	0	0
20	17798876	.	C	T	1	4	5	0	1	6	0	0
20	17798906	.	T	C	5	2	7	0	1	8	0	0
20	17798930	.	C	T	4	5	9	0	0	9	0	0
20	17800867	.	T	C	4	6	10	0	0	10	0	0
20	17802979	.	C	T	5	5	10	0	1	11	0	0
20	17809123	.	G	A	10	11	21	0	0	21	0	0
20	17809177	.	C	T	11	12	23	0	0	23	0	0
20	17811587	.	G	A	6	16	22	0	0	22	0	0
20	17813702	.	C	T	21	13	34	0	0	34	0	0
20	17817659	.	G	T	9	16	25	0	1	26	0	0
20	17817886	.	T	A	10	15	25	0	2	27	0	0
20	17818445	.	T	A	12	21	33	0	1	34	0	0
20	18255474	.	A	G	8	0	8	0	18	26	0	0
20	18255810	.	T	C	14	16	30	0	1	31	0	0
20	18255931	.	A	T	16	13	29	0	0	29	0	0
20	18256176	.	T	A	1	6	7	0	1	8	0	0
20	18306290	.	T	A	7	14	21	0	1	22	0	0
20	18306298	.	T	G	9	14	23	0	1	24	0	0
20	18307075	.	T	C	17	1	18	0	17	35	0	0
20	18309277	.	C	T	15	11	26	0	2	28	0	0
20	18312803	.	T	C	15	9	24	0	0	24	0	0
20	18312839	.	T	C	18	7	25	0	0	25	0	0
20	18354307	.	A	C	1	2	3	0	0	3	0	0
20	18357820	.	T	C	6	10	16	0	5	21	0	0
20	18358002	.	T	C	7	6	13	0	0	13	0	0
20	18369979	.	G	A	2	2	4	0	1	5	0	0
20	18373014	.	T	G	1	4	5	0	0	5	0	0
20	18392845	.	C	T	21	10	31	0	1	32	0	0
20	18393249	.	T	C	10	8	18	1	0	19	0	0
20	18393359	.	A	T	6	12	18	1	0	19	0	0
20	18393376	.	C	T	7	11	18	1	1	20	0	0
20	18396134	.	A	G	10	15	25	0	2	27	0	0
20	18414262	.	C	T	5	4	9	0	0	9	0	0
20	18431770	.	T	C	2	0	2	0	2	4	0	0
20	18591638	.	G	T	12	13	25	1	1	27	0	0
20	18591704	.	G	A	22	13	35	0	1	36	0	0
20	18591716	.	A	C	19	15	34	0	1	35	0	0
20	18591743	.	A	T	15	13	28	0	1	29	0	0
20	18594958	.	C	A	21	20	41	0	0	41	0	0
20	18594980	.	T	A	19	21	40	0	1	41	0	0
20	18595296	.	T	G	13	1	14	0	16	30	0	0
20	18669600	.	G	A	5	4	9	0	0	9	0	0
20	18672064	.	C	T	2	7	9	0	2	11	0	0
20	18672094	.	T	C	2	6	8	0	2	10	0	0
20	18672193	.	G	A	1	4	5	0	5	10	0	0
20	18672733	.	A	T	4	5	9	0	0	9	0	0
20	18673132	.	C	T	3	13	16	0	1	17	0	0
20	18678466	.	C	T	12	8	20	0	0	20	0	0
20	18683158	.	T	C	7	21	28	0	0	28	0	0
20	18684922	.	A	T	17	9	26	0	2	28	0	0
20	18685139	.	G	A	15	12	27	0	1	28	0	0
20	18708770	.	T	C	25	22	47	0	1	48	0	0
20	18713067	.	T	C	36	25	61	0	0	61	0	0
20	18714024	.	C	T	3	3	6	0	0	6	0	0
20	18714242	.	C	A	2	2	4	1	0	5	0	0
20	18714733	.	A	G	2	6	8	0	0	8	0	0
20	18714824	.	G	A	2	2	4	0	0	4	0	0
20	18721910	.	G	A	5	3	8	0	0	8	0	0
20	18722089	.	G	C	6	3	9	0	0	9	0	0
20	18722312	.	A	C	4	8	12	0	0	12	0	0
20	18722565	.	A	T	9	4	13	0	2	15	0	0
20	18723062	.	C	T	3	3	6	0	0	6	0	0
20	18723105	.	C	T	8	6	14	0	2	16	0	0
20	18723401	.	T	C	1	0	1	1	5	7	0	0
20	18723441	.	G	A	2	7	9	0	0	9	0	0
20	18723781	.	T	G	2	6	8	0	2	10	0	0
20	18730498	.	G	A	2	2	4	0	0	4	0	0
20	18731068	.	C	T	3	2	5	0	0	5	0	0
20	18755824	.	A	C	1	2	3	0	0	3	0	0
20	18968826	.	C	T	1	3	4	0	0	4	0	0
20	18972850	.	T	A	8	4	12	0	1	13	0	0
20	18996331	.	C	T	6	3	9	0	0	9	0	0
20	18997305	.	A	G	17	10	27	0	2	29	0	0
20	18997610	.	A	G	13	9	22	0	4	26	0	0
20	18997875	.	A	G	12	6	18	0	2	20	0	0
20	19018520	.	G	A	2	5	7	0	0	7	0	0
20	19058143	.	G	A	8	4	12	0	0	12	0	0
20	19058152	.	T	G	9	4	13	0	0	13	0	0
20	19058188	.	A	G	7	5	12	0	0	12	0	0
20	19058194	.	T	C	7	6	13	0	1	14	0	0
20	19058241	.	A	C	7	9	16	0	0	16	0	0
20	19058326	.	A	G	7	4	11	0	0	11	0	0
20	19058475	.	T	G	3	3	6	0	0	6	0	0
20	19058500	.	A	G	3	3	6	0	0	6	0	0
20	19076873	.	C	T	1	3	4	0	0	4	0	0
20	19077156	.	T	C	2	5	7	0	0	7	0	0
20	19077628	.	A	G	6	6	12	0	5	17	0	0
20	19213235	.	G	A	5	4	9	0	0	9	0	0
20	19213586	.	T	A	2	6	8	0	1	9	0	0
20	19213587	.	G	C	1	7	8	0	1	9	0	0
20	19238509	.	A	T	3	7	10	0	0	10	0	0
20	19258639	.	T	C	6	8	14	0	1	15	0	0
20	19276967	.	G	C	3	1	4	0	1	5	0	0
20	19277712	.	G	T	4	1	5	0	0	5	0	0
20	19277728	.	G	A	4	4	8	0	0	8	0	0
20	19278132	.	C	T	2	3	5	0	0	5	0	0
20	19278143	.	C	T	2	2	4	0	0	4	0	0
20	19290547	.	C	T	1	3	4	0	0	4	0	0
20	19373597	.	G	A	6	8	14	1	0	15	0	0
20	19373616	.	T	C	4	12	16	1	0	17	0	0
20	19373647	.	C	T	8	17	25	1	1	27	0	0
20	19373653	.	T	A	10	18	28	1	3	32	0	0
20	19373720	.	T	C	16	1	17	0	13	30	0	0
20	19373852	.	A	G	8	9	17	0	0	17	0	0
20	19373919	.	A	G	9	13	22	0	0	22	0	0
20	19373939	.	G	A	12	13	25	0	1	26	0	0
20	19374058	.	C	T	2	5	7	0	2	10	1	0
20	19374093	.	A	T	5	8	13	0	0	13	0	0
20	19374120	.	G	T	4	4	8	0	0	8	0	0
20	19374242	.	G	T	3	2	5	0	0	5	0	0
20	19374415	.	C	T	0	6	6	0	4	10	0	0
20	19374524	.	G	A	6	4	10	0	0	10	0	0
20	19374714	.	G	A	5	4	9	0	0	9	0	0
20	19374755	.	A	G	3	3	6	0	1	7	0	0
20	19391677	.	T	A	4	3	7	0	0	7	0	0
20	19391704	.	A	G	3	2	5	0	3	8	0	0
20	19430352	.	C	A	3	6	9	0	0	9	0	0
20	19430778	.	C	A	5	6	11	0	2	13	0	0
20	19430790	.	C	T	6	6	12	0	0	12	0	0
20	19431360	.	C	A	7	2	9	0	0	9	0	0
20	19431385	.	A	G	5	3	8	0	0	8	0	0
20	19431631	.	G	C	6	8	14	0	0	14	0	0
20	19431960	.	C	G	2	7	9	0	0	9	0	0
20	19432007	.	G	T	2	5	7	0	0	7	0	0
20	19432150	.	T	A	8	11	19	0	1	20	0	0
20	19436389	.	G	C	9	5	14	0	0	14	0	0
20	19436890	.	T	C	9	0	9	0	1	10	0	0
20	19436899	.	C	A	9	6	15	0	3	18	0	0
20	19437434	.	T	C	1	0	1	0	2	3	0	0
20	19437624	.	T	C	6	0	6	0	6	12	0	0
20	19437848	.	T	C	4	0	4	0	5	9	0	0
20	19438082	.	T	G	2	6	8	0	0	8	0	0
20	19438110	.	C	A	5	5	10	0	0	10	0	0
20	19438146	.	T	C	5	0	5	0	8	13	0	0
20	19438181	.	C	T	0	4	4	0	5	9	0	0
20	19438193	.	T	A	4	3	7	0	0	7	0	0
20	19438425	.	G	A	1	2	3	0	0	3	0	0
20	19443045	.	G	T	2	2	4	0	0	4	0	0
20	19514744	.	G	A	1	3	4	0	0	4	0	0
20	19515205	.	C	T	1	2	3	0	1	4	0	0
20	19515966	.	G	T	4	5	9	0	0	9	0	0
20	19516009	.	A	G	3	4	7	0	0	7	0	0
20	19516068	.	C	T	5	10	15	0	1	16	0	0
20	19516096	.	T	A	8	9	17	0	3	20	0	0
20	19516315	.	G	C	9	4	13	0	0	13	0	0
20	19516392	.	T	C	8	7	15	0	0	15	0	0
20	19516406	.	T	G	12	0	12	0	8	20	0	0
20	19516537	.	T	C	2	11	13	0	0	13	0	0
20	19516772	.	T	C	5	9	14	0	0	14	0	0
20	19516837	.	G	A	10	14	24	1	2	27	0	0
20	19517027	.	C	G	17	10	27	0	0	27	0	0
20	19518685	.	A	G	7	16	23	0	0	23	0	0
20	19519403	.	C	G	9	6	15	0	0	15	0	0
20	19519454	.	T	G	6	6	12	0	1	13	0	0
20	19521657	.	C	T	5	9	14	0	0	14	0	0
20	19524966	.	A	G	7	7	14	0	0	14	0	0
20	19524978	.	G	A	7	6	13	0	0	13	0	0
20	19530702	.	G	A	4	6	10	0	0	10	0	0
20	19562536	.	C	A	3	4	7	0	0	7	0	0
20	19562630	.	G	T	0	2	2	0	2	4	0	0
20	19562743	.	G	T	4	7	11	0	1	12	0	0
20	19562853	.	T	A	4	6	10	0	1	11	0	0
20	19575264	.	G	A	10	14	24	0	0	24	0	0
20	19575271	.	A	G	6	13	19	0	4	23	0	0
20	19579897	.	G	A	4	7	11	0	2	13	0	0
20	19580091	.	A	T	9	10	19	0	0	19	0	0
20	19580331	.	C	T	15	4	19	0	1	20	0	0
20	19580367	.	T	A	12	5	17	0	0	18	1	0
20	19580397	.	A	G	6	3	9	0	2	11	0	0
20	19580405	.	G	A	7	4	11	0	1	12	0	0
20	19580441	.	A	G	8	6	14	0	1	15	0	0
20	19580525	.	C	A	11	13	24	0	0	24	0	0
20	19580584	.	T	C	16	1	17	0	14	31	0	0
20	19583028	.	C	G	7	5	12	0	0	12	0	0
20	19785587	.	G	A	0	2	2	0	1	3	0	0
20	19823761	.	A	T	3	3	6	0	0	6	0	0
20	19823939	.	T	C	2	2	4	0	1	5	0	0
20	20231995	.	G	C	16	10	26	0	2	28	0	0
20	20232347	.	A	T	14	13	27	0	0	27	0	0
20	20232456	.	G	T	13	13	26	0	1	28	1	0
20	20275088	.	G	A	4	3	7	0	0	7	0	0
20	20275095	.	A	T	3	4	7	0	0	7	0	0
20	20275193	.	A	T	14	11	25	0	1	26	0	0
20	20275196	.	C	A	16	11	27	0	0	27	0	0
20	20275306	.	C	T	10	10	20	0	3	23	0	0
20	20275322	.	T	A	14	9	23	0	1	24	0	0
20	20275434	.	T	A	18	10	28	0	0	28	0	0
20	20275455	.	C	T	20	10	30	0	0	30	0	0
20	20275661	.	C	T	3	13	16	0	12	28	0	0
20	20275674	.	A	G	14	13	27	0	0	27	0	0
20	20275766	.	T	G	14	14	28	0	2	30	0	0
20	20275776	.	T	C	14	0	14	0	17	31	0	0
20	20326945	.	A	T	7	2	9	0	1	10	0	0
20	20328055	.	A	G	18	18	36	0	7	43	0	0
20	20328137	.	G	A	28	22	50	0	4	54	0	0
20	20330095	.	C	A	12	16	28	0	3	31	0	0
20	20330256	.	T	C	13	16	29	0	1	30	0	0
20	20331235	.	T	A	7	13	20	0	2	22	0	0
20	20331740	.	A	G	7	7	14	0	0	14	0	0
20	20332079	.	G	A	7	9	16	1	0	17	0	0
20	20334705	.	G	A	2	6	8	0	0	8	0	0
20	20337215	.	G	A	5	2	7	0	0	7	0	0
20	20601233	.	C	G	11	10	21	1	0	22	0	0
20	20601651	.	T	G	8	11	19	0	2	21	0	0
20	20601883	.	A	T	8	15	23	0	3	26	0	0
20	20601884	.	A	C	10	15	25	0	2	27	0	0
20	20601985	.	T	C	14	7	21	2	1	24	0	0
20	20602097	.	A	T	6	14	20	0	1	21	0	0
20	20602167	.	T	C	3	4	7	0	0	7	0	0
20	20602232	.	T	C	13	5	18	1	0	19	0	0
20	20602259	.	T	C	12	5	17	1	1	19	0	0
20	20602290	.	G	T	5	3	8	0	1	9	0	0
20	20602370	.	A	T	9	8	17	0	0	18	1	0
20	20603131	.	T	A	7	2	9	0	0	9	0	0
20	20654977	.	A	G	2	0	2	0	2	4	0	0
20	20655339	.	A	T	3	2	5	0	3	8	0	0
20	20655357	.	G	A	0	3	3	0	5	8	0	0
20	20655394	.	C	G	3	0	3	0	5	8	0	0
20	20658954	.	C	T	7	3	10	0	0	10	0	0
20	20659067	.	G	A	3	5	8	0	1	9	0	0
20	20659305	.	T	C	2	11	13	0	1	14	0	0
20	20659306	.	C	T	4	11	15	0	0	15	0	0
20	20672289	.	T	C	21	20	41	0	1	42	0	0
20	20672335	.	C	T	12	21	33	3	0	36	0	0
20	20694918	.	A	T	26	37	63	0	5	68	0	0
20	20694999	.	C	T	19	16	35	0	9	44	0	0
20	20695642	.	G	T	3	30	33	0	34	67	0	0
20	20695779	.	T	A	31	32	63	0	6	69	0	0
20	20695829	.	A	T	30	28	58	0	2	60	0	0
20	20695856	.	A	T	28	22	50	0	1	51	0	0
20	20722032	.	T	C	1	2	3	0	0	3	0	0
20	20722071	.	A	G	1	2	3	0	0	3	0	0
20	20726287	.	G	T	26	29	55	0	2	57	0	0
20	20726291	.	G	A	2	25	27	0	35	62	0	0
20	20726966	.	T	C	24	37	61	0	1	62	0	0
20	20726993	.	C	A	28	26	54	0	8	62	0	0
20	20729975	.	C	T	26	29	55	0	4	59	0	0
20	20730061	.	C	G	27	22	49	0	3	52	0	0
20	20793358	.	G	A	1	3	4	0	0	4	0	0
20	20802754	.	C	A	3	9	12	0	0	12	0	0
20	20805250	.	T	G	1	1	2	0	6	8	0	0
20	20805643	.	G	C	0	8	8	0	3	11	0	0
20	20805690	.	C	T	4	11	15	0	1	16	0	0
20	20808044	.	C	A	6	12	18	0	0	18	0	0
20	20809666	.	T	C	4	18	22	0	1	23	0	0
20	20809702	.	T	C	7	14	21	0	0	21	0	0
20	20812680	.	C	T	8	26	34	0	2	36	0	0
20	20812728	.	T	C	10	28	38	0	3	41	0	0
20	20812898	.	T	C	4	9	13	0	1	14	0	0
20	20813116	.	A	T	9	23	32	0	3	35	0	0
20	20813162	.	T	C	12	33	45	0	0	45	0	0
20	20813197	.	A	C	11	38	49	0	1	50	0	0
20	20813270	.	C	T	10	34	44	0	3	47	0	0
20	20813336	.	T	C	12	34	46	0	0	46	0	0
20	20813460	.	C	T	12	29	41	0	1	42	0	0
20	20813568	.	A	C	14	28	42	1	1	44	0	0
20	20813731	.	T	C	2	8	10	0	2	12	0	0
20	20813750	.	A	T	1	2	3	0	0	3	0	0
20	20817263	.	A	G	36	32	68	0	2	70	0	0
20	20817921	.	A	G	38	25	63	0	1	64	0	0
20	20896956	.	A	G	2	2	4	0	0	4	0	0
20	20927973	.	A	C	7	0	7	0	7	14	0	0
20	20928239	.	C	G	0	16	16	0	20	36	0	0
20	20928536	.	G	A	17	16	33	0	3	36	0	0
20	20928932	.	A	G	13	13	26	0	1	27	0	0
20	20929166	.	G	A	13	11	24	0	1	25	0	0
20	20931142	.	C	G	3	4	7	0	1	8	0	0
20	20974065	.	T	C	3	2	5	0	0	5	0	0
20	20974071	.	T	G	3	2	5	0	0	5	0	0
20	21008471	.	T	A	3	3	6	0	0	6	0	0
20	21015748	.	G	A	3	6	9	0	1	10	0	0
20	21016348	.	C	T	3	5	8	0	0	8	0	0
20	21473681	.	T	C	6	4	10	0	1	11	0	0
20	21474159	.	T	C	5	3	8	0	0	8	0	0
20	21474664	.	A	G	17	0	17	0	5	22	0	0
20	21474700	.	A	G	9	6	15	0	0	15	0	0
20	21474715	.	A	C	7	7	14	0	0	14	0	0
20	21638431	.	C	A	6	4	10	0	0	10	0	0
20	21638575	.	T	C	2	3	5	0	1	6	0	0
20	21639502	.	A	G	2	2	4	0	1	5	0	0
20	21815659	.	G	T	8	12	20	0	3	23	0	0
20	21815986	.	C	T	1	15	16	0	13	29	0	0
20	21816061	.	C	G	8	17	25	0	0	25	0	0
20	21819062	.	T	C	11	18	29	0	1	30	0	0
20	21828117	.	T	C	6	3	9	0	0	9	0	0
20	21841312	.	G	A	8	8	16	0	0	16	0	0
20	21841316	.	G	T	6	8	14	0	0	14	0	0
20	21855195	.	T	C	5	2	7	0	0	7	0	0
20	21862975	.	C	T	0	3	3	0	2	5	0	0
20	22053358	.	T	C	5	3	8	0	0	8	0	0
20	23447279	.	T	A	1	2	3	0	0	3	0	0
20	23694241	.	C	T	1	3	4	0	0	4	0	0
20	24818238	.	T	A	6	3	9	0	2	11	0	0
20	24818673	.	G	A	9	13	22	0	2	24	0	0
20	24818922	.	T	C	17	13	30	0	0	30	0	0
20	24819184	.	G	A	1	3	4	0	1	5	0	0
20	24819582	.	C	T	2	8	10	0	5	15	0	0
20	24820566	.	A	T	1	5	6	0	0	6	0	0
20	24821023	.	T	G	4	8	12	0	0	12	0	0
20	24821094	.	C	T	0	8	8	0	3	11	0	0
20	24821604	.	G	A	5	5	10	0	0	10	0	0
20	25342837	.	G	A	1	6	7	0	7	14	0	0
20	25352192	.	T	A	1	2	3	0	0	3	0	0
20	25368785	.	A	G	3	3	6	0	0	6	0	0
20	25374908	.	G	A	5	2	7	0	0	7	0	0
20	25374912	.	G	A	5	2	7	0	0	7	0	0
20	25378787	.	C	A	2	2	4	0	0	4	0	0
20	25379771	.	T	C	1	2	3	0	0	3	0	0
20	25385938	.	A	C	3	3	6	0	1	7	0	0
20	25393387	.	C	G	0	1	1	0	2	3	0	0
20	25440607	.	A	G	10	6	16	0	0	16	0	0
20	25440628	.	T	G	4	10	14	0	1	15	0	0
20	25440648	.	C	G	10	13	23	0	0	23	0	0
20	25440731	.	G	A	3	14	17	0	1	18	0	0
20	25444903	.	G	A	3	5	8	0	0	8	0	0
20	25444943	.	G	A	3	3	6	0	0	6	0	0
20	25445182	.	A	T	1	4	5	0	0	5	0	0
20	25510331	.	A	G	5	7	12	0	0	12	0	0
20	25510798	.	C	T	9	3	12	0	0	12	0	0
20	25927310	.	A	G	20	9	29	0	2	31	0	0
20	25927436	.	T	G	0	22	22	0	1	23	0	0
20	26023822	.	T	C	4	3	7	0	0	7	0	0
20	26907743	.	G	A	2	2	4	0	0	4	0	0
20	26907893	.	C	T	4	2	6	0	0	6	0	0
20	26913282	.	G	C	4	2	6	0	0	6	0	0
20	26944090	.	C	T	9	14	23	0	1	24	0	0
20	26944762	.	C	A	13	6	19	0	0	19	0	0
20	26944951	.	C	T	4	5	9	0	2	11	0	0
20	26944971	.	G	A	3	7	10	0	0	10	0	0
20	26945115	.	A	T	5	4	9	0	0	9	0	0
20	26945394	.	C	T	10	13	23	0	0	23	0	0
20	26945793	.	T	A	22	5	27	0	2	29	0	0
20	26945950	.	T	A	3	11	14	0	1	15	0	0
20	26959572	.	C	T	3	2	5	0	0	5	0	0
20	26960102	.	T	C	2	5	7	0	0	7	0	0
20	26960220	.	C	A	5	8	13	0	0	13	0	0
20	26960580	.	G	A	3	2	5	0	0	5	0	0
20	26960843	.	C	T	1	4	5	0	0	5	0	0
20	26960877	.	G	A	0	3	3	0	5	8	0	0
20	26961149	.	A	G	3	6	9	0	0	9	0	0
20	26961353	.	G	A	3	5	8	0	0	8	0	0
20	26961419	.	A	T	10	6	16	0	1	17	0	0
20	26961469	.	A	G	2	4	6	0	1	7	0	0
20	26961694	.	A	T	2	2	4	0	1	5	0	0
20	26961862	.	T	C	6	9	15	0	1	16	0	0
20	26962057	.	A	G	13	0	13	0	7	20	0	0
20	26962077	.	G	A	0	13	13	0	12	25	0	0
20	26962225	.	T	A	17	13	30	0	2	32	0	0
20	26962318	.	G	A	2	8	10	0	11	21	0	0
20	27001864	.	T	A	6	7	13	0	1	14	0	0
20	27001867	.	C	T	7	7	14	0	0	14	0	0
20	27001903	.	C	T	11	11	22	0	2	24	0	0
20	27001915	.	T	C	10	9	19	0	2	21	0	0
20	27002007	.	A	G	7	4	11	0	1	12	0	0
20	27002175	.	T	G	7	8	15	0	1	16	0	0
20	27002595	.	T	G	8	8	16	0	0	16	0	0
20	27002769	.	T	A	7	5	12	0	1	13	0	0
20	27002778	.	A	G	6	5	11	0	1	12	0	0
20	27002989	.	G	A	7	8	15	0	3	18	0	0
20	27003134	.	C	A	6	6	12	0	0	12	0	0
20	27021593	.	C	A	10	11	21	0	0	21	0	0
20	27039339	.	A	C	13	30	43	0	1	44	0	0
20	27039400	.	G	A	16	28	44	0	1	45	0	0
20	27039523	.	C	T	20	22	42	0	2	44	0	0
20	27039550	.	A	T	16	24	40	0	2	42	0	0
20	27039577	.	C	T	16	27	43	0	2	45	0	0
20	27045501	.	G	A	20	29	49	0	1	50	0	0
20	27045703	.	A	G	18	19	37	0	1	38	0	0
20	27045719	.	T	C	16	14	30	0	4	34	0	0
20	27045858	.	T	A	2	11	13	0	1	14	0	0
20	27087600	.	T	A	1	2	3	0	0	3	0	0
20	27089281	.	C	T	3	2	5	0	2	7	0	0
20	27089613	.	T	C	2	2	4	0	1	5	0	0
20	27090409	.	C	T	5	9	14	0	0	14	0	0
20	27090551	.	A	T	4	4	8	0	0	8	0	0
20	27091064	.	G	A	6	2	8	0	0	8	0	0
20	27091179	.	T	A	8	6	14	0	2	16	0	0
20	27091206	.	G	A	14	7	21	0	1	22	0	0
20	27092182	.	C	T	14	7	21	0	0	21	0	0
20	27092231	.	C	T	13	9	22	0	3	25	0	0
20	27092245	.	A	G	12	9	21	0	0	21	0	0
20	27094615	.	A	G	1	3	4	0	0	4	0	0
20	27096400	.	C	A	6	2	8	0	1	9	0	0
20	27100005	.	T	C	6	11	17	0	1	18	0	0
20	27100011	.	A	T	8	10	18	0	0	18	0	0
20	27102325	.	C	T	4	3	7	0	1	8	0	0
20	27104562	.	C	T	8	12	20	0	0	20	0	0
20	27107089	.	C	T	6	12	18	0	1	19	0	0
20	27107140	.	C	A	7	13	20	0	0	20	0	0
20	27107173	.	A	C	11	10	21	0	2	23	0	0
20	27107545	.	G	T	1	5	6	0	5	11	0	0
20	27194918	.	T	C	4	2	6	0	0	6	0	0
20	27281678	.	A	C	4	6	10	0	0	10	0	0
20	27282340	.	A	C	3	6	9	0	1	10	0	0
20	27282561	.	T	C	7	3	10	0	0	10	0	0
20	27282598	.	T	A	4	4	8	0	0	8	0	0
20	27283404	.	A	C	9	5	14	0	0	14	0	0
20	27283604	.	G	A	4	4	8	0	0	8	0	0
20	27353250	.	G	A	8	3	11	0	0	11	0	0
20	27353265	.	C	T	8	3	11	0	0	11	0	0
20	27358859	.	G	A	4	8	12	0	1	13	0	0
20	27366122	.	G	A	7	8	15	0	1	16	0	0
20	27366597	.	T	G	8	10	18	0	1	19	0	0
20	27368882	.	A	C	17	16	33	0	2	35	0	0
20	27370340	.	G	A	14	14	28	0	1	29	0	0
20	27396384	.	T	A	8	14	22	0	0	22	0	0
20	27396385	.	A	T	7	14	21	0	1	22	0	0
20	27396478	.	A	T	11	11	22	0	0	22	0	0
20	27396489	.	C	T	11	8	19	0	1	20	0	0
20	27546071	.	A	G	1	3	4	0	0	4	0	0
20	27549217	.	A	G	1	3	4	0	0	4	0	0
20	27550104	.	G	T	1	3	4	0	0	4	0	0
20	27550959	.	G	A	1	4	5	0	0	5	0	0
20	27551113	.	A	T	6	4	10	0	0	10	0	0
20	27551123	.	G	T	4	6	10	0	0	10	0	0
20	27551253	.	A	C	2	4	6	0	1	7	0	0
20	27551329	.	A	G	5	5	10	0	0	10	0	0
20	27551363	.	G	A	4	6	10	0	1	11	0	0
20	27551624	.	C	T	2	6	8	0	1	9	0	0
20	27692934	.	T	C	1	1	2	0	1	3	0	0
20	27708306	.	A	G	1	2	3	0	0	3	0	0
20	27718091	.	G	A	3	2	5	0	0	5	0	0
20	27718097	.	A	T	3	2	5	0	0	5	0	0
20	27718329	.	A	T	4	3	7	0	0	7	0	0
20	27718418	.	A	C	2	3	5	0	0	5	0	0
20	27718824	.	C	G	1	2	3	0	0	3	0	0
20	27718834	.	G	T	1	3	4	0	0	4	0	0
20	27719088	.	A	G	4	6	10	0	1	11	0	0
20	27719099	.	A	G	2	5	7	0	1	8	0	0
20	27719693	.	C	T	7	6	13	0	1	14	0	0
20	27719713	.	G	A	10	6	16	0	1	17	0	0
20	27719859	.	T	C	9	7	16	0	1	17	0	0
20	27719869	.	T	A	9	7	16	0	1	17	0	0
20	27732628	.	A	G	3	2	5	0	0	5	0	0
20	27732688	.	A	T	10	7	17	0	0	17	0	0
20	27732832	.	A	G	1	6	7	0	0	7	0	0
20	27732911	.	T	A	1	2	3	0	0	3	0	0
20	27733009	.	C	T	1	2	3	0	4	7	0	0
20	27857235	.	A	G	1	1	2	0	1	3	0	0
20	28252167	.	A	G	2	3	5	0	0	5	0	0
20	28253682	.	G	A	2	4	6	0	0	6	0	0
20	28253930	.	A	C	6	3	9	0	0	9	0	0
20	28254141	.	A	G	2	7	9	0	0	9	0	0
20	28267512	.	A	T	32	16	48	0	9	57	0	0
20	28268828	.	A	G	32	1	33	0	31	64	0	0
20	28268888	.	C	T	33	24	57	0	1	58	0	0
20	28269024	.	A	T	30	23	53	0	1	54	0	0
20	28269165	.	G	A	34	15	49	0	1	50	0	0
20	28269181	.	C	T	29	17	46	0	3	49	0	0
20	28269210	.	A	G	33	0	33	0	18	51	0	0
20	28269219	.	A	C	33	20	53	0	0	54	1	0
20	28269355	.	T	C	25	29	54	0	3	57	0	0
20	28269418	.	T	G	4	12	16	0	1	17	0	0
20	28269842	.	T	A	3	2	5	0	0	5	0	0
20	28269958	.	T	A	2	4	6	0	0	6	0	0
20	28270416	.	A	G	5	2	7	0	0	7	0	0
20	28270442	.	A	G	2	3	5	0	0	5	0	0
20	28270493	.	C	T	1	3	4	0	1	5	0	0
20	28273541	.	C	T	1	2	3	0	3	6	0	0
20	28273631	.	A	G	4	5	9	0	0	9	0	0
20	28281509	.	A	C	2	5	7	0	2	9	0	0
20	28281515	.	A	G	2	5	7	0	1	8	0	0
20	28281578	.	C	G	1	3	4	0	0	4	0	0
20	28310920	.	A	G	1	2	3	0	0	3	0	0
20	28354951	.	A	G	5	4	9	0	1	10	0	0
20	28355029	.	C	T	6	3	9	0	2	11	0	0
20	28356989	.	T	C	4	2	6	0	0	6	0	0
20	28356998	.	G	A	3	2	5	0	0	5	0	0
20	28357055	.	G	T	3	5	8	0	1	9	0	0
20	28357184	.	A	G	5	2	7	0	0	7	0	0
20	28357190	.	C	T	7	2	9	0	0	9	0	0
20	28357610	.	A	G	2	3	5	0	0	5	0	0
20	28400232	.	A	T	3	1	4	0	1	5	0	0
20	28400422	.	C	T	1	2	3	0	1	4	0	0
20	28400455	.	A	C	3	6	9	0	1	10	0	0
20	28400506	.	T	A	6	9	15	0	1	16	0	0
20	28400704	.	A	G	6	11	17	0	0	17	0	0
20	28400783	.	C	A	8	3	11	0	1	12	0	0
20	28400945	.	C	G	4	3	7	0	0	7	0	0
20	28401084	.	C	G	3	4	7	0	1	8	0	0
20	28401147	.	A	G	4	7	11	0	0	11	0	0
20	28413925	.	C	T	1	4	5	0	0	5	0	0
20	28414423	.	T	C	2	2	4	0	0	4	0	0
20	28417175	.	G	C	3	7	10	0	0	10	0	0
20	28417184	.	G	A	3	7	10	0	0	10	0	0
20	28418494	.	T	A	1	4	5	0	1	6	0	0
20	28418503	.	C	T	2	4	6	0	1	7	0	0
20	28418587	.	C	T	3	2	5	0	0	5	0	0
20	28418939	.	T	C	5	2	7	0	0	7	0	0
20	28418951	.	T	A	3	6	9	0	0	9	0	0
20	28419015	.	A	T	5	5	10	0	0	10	0	0
20	28419807	.	T	A	0	5	5	0	0	5	0	0
20	28419831	.	T	C	3	5	8	0	1	9	0	0
20	28420234	.	T	A	4	8	12	0	1	13	0	0
20	28420361	.	C	T	15	10	25	0	2	27	0	0
20	28420438	.	C	G	7	12	19	0	2	21	0	0
20	28420522	.	G	A	9	6	15	0	0	15	0	0
20	28422842	.	C	A	2	3	5	0	0	5	0	0
20	28422920	.	A	G	3	8	11	0	0	11	0	0
20	28422927	.	T	C	4	0	4	0	9	13	0	0
20	28423035	.	G	T	8	3	11	0	0	11	0	0
20	28456574	.	T	C	4	3	7	0	0	7	0	0
20	28469934	.	G	A	3	3	6	0	0	6	0	0
20	28469982	.	A	G	2	6	8	0	0	8	0	0
20	28470057	.	T	C	4	2	6	0	0	6	0	0
20	28476107	.	T	C	4	4	8	0	0	8	0	0
20	28487287	.	T	C	5	4	9	0	1	10	0	0
20	28514878	.	T	C	1	2	3	0	0	3	0	0
20	28650328	.	A	C	17	20	37	0	1	38	0	0
20	28650394	.	G	A	13	9	22	1	6	29	0	0
20	28650945	.	A	T	15	8	23	0	3	26	0	0
20	28650946	.	T	G	14	9	23	0	3	26	0	0
20	28650980	.	T	C	15	6	21	0	3	24	0	0
20	28651239	.	A	G	10	11	21	0	2	23	0	0
20	28651693	.	G	T	9	8	17	0	1	18	0	0
20	28651958	.	T	G	7	3	10	0	3	13	0	0
20	28652277	.	G	C	12	16	28	0	0	28	0	0
20	28652449	.	G	C	8	9	17	0	0	17	0	0
20	28652485	.	G	A	9	11	20	0	3	23	0	0
20	28652597	.	G	C	4	3	7	0	0	7	0	0
20	28658597	.	T	C	2	3	5	0	1	6	0	0
20	28658666	.	A	C	3	4	7	0	0	7	0	0
20	28660729	.	T	C	2	0	2	0	3	5	0	0
20	28834629	.	T	C	3	0	3	0	3	6	0	0
20	28888106	.	T	C	19	6	25	0	0	25	0	0
20	29216103	.	G	T	4	2	6	0	1	7	0	0
20	29268367	.	A	G	9	1	10	0	3	13	0	0
20	29269095	.	T	C	11	0	11	0	10	21	0	0
20	30894603	.	A	G	4	2	6	0	0	6	0	0
20	31429700	.	T	C	25	4	29	0	1	30	0	0
20	31746445	.	C	T	15	16	31	0	3	34	0	0
20	31746604	.	C	T	22	8	30	0	1	31	0	0
20	31746611	.	A	T	23	7	30	0	0	30	0	0
20	31747116	.	A	T	5	9	14	4	0	18	0	0
20	31747673	.	C	A	1	13	14	0	13	27	0	0
20	31747792	.	C	T	1	8	9	0	4	13	0	0
20	31747860	.	C	T	2	5	7	0	8	15	0	0
20	31747984	.	C	T	5	9	14	0	1	15	0	0
20	31747988	.	A	C	5	7	12	0	3	15	0	0
20	31748032	.	G	T	5	9	14	0	1	15	0	0
20	31748124	.	T	C	7	0	7	0	9	16	0	0
20	31748178	.	T	C	4	12	16	0	2	18	0	0
20	31748363	.	A	G	4	6	10	0	0	10	0	0
20	31748431	.	A	G	10	5	15	0	0	15	0	0
20	31749207	.	C	T	0	6	6	0	8	14	0	0
20	32009889	.	C	T	3	2	5	0	0	5	0	0
20	32047448	.	T	A	9	12	21	0	0	21	0	0
20	32047546	.	C	T	10	10	20	0	0	20	0	0
20	32047640	.	T	A	19	18	37	0	2	39	0	0
20	32047741	.	A	C	9	24	33	0	0	33	0	0
20	32048117	.	A	G	26	5	31	0	3	34	0	0
20	32048369	.	T	A	16	14	30	0	2	32	0	0
20	32049056	.	G	T	11	6	17	0	1	18	0	0
20	32049178	.	G	T	15	4	19	0	4	23	0	0
20	32052708	.	G	A	11	4	15	0	3	18	0	0
20	32052873	.	C	T	1	9	10	0	6	16	0	0
20	32053122	.	G	A	3	3	6	0	0	6	0	0
20	32065517	.	G	A	2	2	4	0	0	4	0	0
20	32136921	.	G	A	1	4	5	0	1	6	0	0
20	32137638	.	A	G	4	6	10	0	0	10	0	0
20	32137866	.	C	T	2	5	7	0	1	8	0	0
20	32137886	.	C	T	5	4	9	0	1	10	0	0
20	32138111	.	C	T	4	11	15	0	1	16	0	0
20	32138127	.	C	T	9	6	15	0	1	16	0	0
20	32138305	.	T	C	10	11	21	0	2	23	0	0
20	32138360	.	T	C	17	10	27	0	0	27	0	0
20	32138400	.	A	G	18	5	23	0	1	24	0	0
20	32138478	.	A	G	10	12	22	0	4	26	0	0
20	32138692	.	G	A	18	13	31	0	4	35	0	0
20	32138754	.	T	C	10	13	23	0	2	25	0	0
20	32138828	.	C	T	20	23	43	0	3	46	0	0
20	32138965	.	A	T	6	3	9	0	1	10	0	0
20	32138977	.	G	A	0	3	3	0	4	7	0	0
20	32141838	.	G	A	1	2	3	0	0	3	0	0
20	32226995	.	G	T	5	3	8	0	0	8	0	0
20	32227025	.	C	T	4	3	7	0	0	7	0	0
20	32227268	.	G	A	3	4	7	0	0	7	0	0
20	32228872	.	A	G	10	12	22	0	4	26	0	0
20	32229047	.	G	A	10	11	21	0	2	23	0	0
20	32229828	.	G	T	10	14	24	0	8	32	0	0
20	32230017	.	A	C	23	17	40	0	1	41	0	0
20	32230205	.	T	G	18	0	18	0	12	30	0	0
20	32230362	.	C	A	10	5	15	0	0	15	0	0
20	32230470	.	T	C	18	12	30	0	0	30	0	0
20	32230472	.	A	C	18	12	30	0	0	30	0	0
20	32230518	.	C	A	15	11	26	0	2	28	0	0
20	32230521	.	G	A	3	11	14	0	14	28	0	0
20	32230555	.	C	A	16	11	27	0	2	29	0	0
20	32230680	.	A	G	18	17	35	0	1	36	0	0
20	32230720	.	C	G	12	12	24	0	2	26	0	0
20	32230893	.	C	T	15	19	34	0	0	34	0	0
20	32230957	.	C	T	17	26	43	0	1	44	0	0
20	32286875	.	C	T	5	8	13	0	0	13	0	0
20	32287178	.	G	A	5	5	10	0	0	10	0	0
20	32287203	.	G	A	3	4	7	0	1	8	0	0
20	32287349	.	C	G	5	8	13	0	0	13	0	0
20	32287736	.	T	C	5	7	12	0	1	13	0	0
20	32288208	.	T	A	1	2	3	0	0	3	0	0
20	32290149	.	T	A	2	6	8	0	0	8	0	0
20	32290160	.	G	A	2	6	8	0	0	8	0	0
20	32290435	.	A	G	5	2	7	0	1	8	0	0
20	32290679	.	G	A	2	1	3	0	1	4	0	0
20	32290828	.	C	T	0	3	3	0	2	5	0	0
20	32337625	.	T	C	4	4	8	0	0	8	0	0
20	32339234	.	G	A	3	1	4	0	1	5	0	0
20	32406066	.	T	C	2	5	7	0	0	7	0	0
20	32432156	.	T	C	13	17	30	0	1	31	0	0
20	32432532	.	C	T	15	11	26	0	2	28	0	0
20	32484549	.	T	C	1	2	3	0	1	4	0	0
20	32487507	.	T	C	1	3	4	0	0	4	0	0
20	32490403	.	C	T	10	6	16	0	0	16	0	0
20	32490480	.	C	T	8	5	13	0	0	13	0	0
20	32498517	.	C	T	2	4	6	0	0	6	0	0
20	32498662	.	G	A	1	5	6	0	0	6	0	0
20	32498771	.	C	G	5	3	8	0	1	9	0	0
20	32498869	.	A	G	3	5	8	0	0	8	0	0
20	32513987	.	G	A	5	5	10	0	0	10	0	0
20	32515968	.	C	T	5	7	12	0	0	12	0	0
20	32520330	.	T	C	11	6	17	0	1	18	0	0
20	32520461	.	G	A	5	4	9	0	1	10	0	0
20	32520779	.	A	G	7	5	12	0	0	12	0	0
20	32521048	.	A	T	4	4	8	0	0	8	0	0
20	32521175	.	T	A	10	17	27	0	0	27	0	0
20	32521186	.	T	C	11	17	28	0	0	28	0	0
20	32521220	.	T	C	19	7	26	0	1	27	0	0
20	32521266	.	T	G	18	13	31	1	2	34	0	0
20	32521477	.	C	T	12	3	15	0	3	18	0	0
20	32521488	.	T	C	8	14	22	0	0	22	0	0
20	32521517	.	A	T	8	19	27	0	4	31	0	0
20	32521534	.	T	A	12	20	32	0	3	35	0	0
20	32521605	.	G	A	20	15	35	0	3	38	0	0
20	32521618	.	T	C	20	15	35	0	1	36	0	0
20	32521719	.	A	C	16	20	36	0	5	41	0	0
20	32574190	.	G	A	1	2	3	0	0	3	0	0
20	32838695	.	C	A	4	2	6	0	1	7	0	0
20	32838710	.	A	T	2	4	6	0	2	8	0	0
20	32863413	.	A	G	2	3	5	0	0	5	0	0
20	32927191	.	C	T	1	2	3	0	0	3	0	0
20	33175232	.	A	G	4	0	4	0	4	8	0	0
20	33180111	.	T	C	4	2	6	0	0	6	0	0
20	33294503	.	A	T	3	2	5	0	1	6	0	0
20	33494027	.	C	A	13	10	23	0	2	25	0	0
20	33494165	.	A	G	14	13	27	0	2	29	0	0
20	33497087	.	A	T	4	3	7	0	0	7	0	0
20	33530200	.	A	G	2	2	4	0	0	4	0	0
20	33668777	.	G	A	1	3	4	0	0	4	0	0
20	33748745	.	G	A	2	2	4	0	2	6	0	0
20	33749113	.	T	A	1	7	8	0	0	9	1	0
20	33759067	.	C	T	0	5	5	0	2	7	0	0
20	33809707	.	A	G	8	17	25	0	3	28	0	0
20	33809783	.	C	A	18	17	35	0	0	35	0	0
20	33809846	.	G	C	16	17	33	0	0	33	0	0
20	33809927	.	T	A	13	16	29	0	1	30	0	0
20	33809971	.	C	A	7	10	17	0	1	18	0	0
20	33810099	.	G	A	3	2	5	0	0	5	0	0
20	33810101	.	G	A	3	2	5	0	0	5	0	0
20	33810558	.	C	A	5	2	7	0	0	7	0	0
20	33810921	.	T	C	3	0	3	0	11	14	0	0
20	33811400	.	A	T	4	4	8	0	0	8	0	0
20	33811435	.	G	A	4	4	8	0	0	8	0	0
20	33811436	.	C	A	3	4	7	0	0	7	0	0
20	33811519	.	G	T	10	4	14	0	0	14	0	0
20	33811574	.	G	T	3	7	10	0	3	14	1	0
20	33840657	.	T	C	3	1	4	0	0	4	0	0
20	33982016	.	G	A	9	2	11	0	1	12	0	0
20	33984086	.	G	C	8	16	24	0	0	24	0	0
20	34003047	.	G	A	0	2	2	0	1	3	0	0
20	34007128	.	G	A	3	2	5	0	0	5	0	0
20	34007589	.	G	C	1	3	4	0	0	4	0	0
20	34007607	.	G	A	4	2	6	0	0	6	0	0
20	34008178	.	C	A	2	4	6	0	1	7	0	0
20	34009225	.	C	G	2	0	2	0	2	4	0	0
20	34009919	.	G	A	0	9	9	0	7	16	0	0
20	34012790	.	T	A	6	6	12	0	2	14	0	0
20	34012798	.	T	C	10	7	17	0	0	17	0	0
20	34012837	.	A	T	7	4	11	0	2	13	0	0
20	34012885	.	G	A	8	9	17	0	0	17	0	0
20	34013073	.	T	G	9	11	20	0	1	22	1	0
20	34015654	.	C	T	0	7	7	0	6	13	0	0
20	34015845	.	C	T	2	8	10	0	0	10	0	0
20	34018783	.	C	T	4	5	9	0	0	9	0	0
20	34018852	.	C	A	3	3	6	0	1	7	0	0
20	34023948	.	C	T	1	2	3	0	0	3	0	0
20	34039390	.	G	A	3	8	11	0	0	11	0	0
20	34040132	.	C	A	15	11	26	0	1	27	0	0
20	34051237	.	C	T	8	6	14	0	1	15	0	0
20	34056162	.	A	G	1	8	9	0	0	9	0	0
20	34056656	.	A	G	4	4	8	0	0	8	0	0
20	34062250	.	G	T	1	2	3	0	0	3	0	0
20	34151818	.	C	A	4	4	8	0	0	8	0	0
20	34154076	.	C	T	4	4	8	0	0	8	0	0
20	34154982	.	G	T	3	11	14	0	2	16	0	0
20	34155192	.	T	C	6	14	20	0	1	21	0	0
20	34157901	.	C	G	1	2	3	0	0	3	0	0
20	34157903	.	T	A	1	2	3	0	0	3	0	0
20	34332683	.	C	A	8	5	13	0	1	14	0	0
20	34333733	.	T	C	6	7	13	0	0	13	0	0
20	34338371	.	T	C	6	8	14	0	0	14	0	0
20	34338884	.	G	A	1	14	15	0	19	34	0	0
20	34339786	.	T	A	24	23	47	0	2	49	0	0
20	34340047	.	C	T	26	20	46	0	2	48	0	0
20	34340176	.	G	A	3	29	32	0	20	52	0	0
20	34340200	.	C	T	17	26	43	0	4	47	0	0
20	34340520	.	T	C	33	9	42	0	2	44	0	0
20	34340675	.	A	C	20	22	42	0	4	46	0	0
20	34340678	.	A	T	23	21	44	0	2	46	0	0
20	34341000	.	C	T	27	18	45	0	1	46	0	0
20	34344358	.	T	G	3	2	5	0	0	5	0	0
20	34364267	.	A	G	1	4	5	0	0	5	0	0
20	34364936	.	A	G	4	3	7	0	0	7	0	0
20	34396763	.	T	G	1	2	3	0	1	4	0	0
20	34420823	.	A	G	20	23	43	0	2	45	0	0
20	34420860	.	A	G	31	13	44	0	2	46	0	0
20	34421155	.	C	T	22	10	32	0	1	33	0	0
20	34421159	.	G	A	22	10	32	0	1	33	0	0
20	34421672	.	G	A	11	3	14	0	0	14	0	0
20	34421701	.	T	C	12	6	18	0	0	18	0	0
20	34426660	.	T	G	7	13	20	0	1	21	0	0
20	34426759	.	A	C	16	5	21	0	0	21	0	0
20	34431337	.	G	A	2	2	4	0	0	4	0	0
20	34431467	.	G	C	2	3	5	0	0	5	0	0
20	34447025	.	A	G	2	3	5	0	0	5	0	0
20	34447522	.	T	C	1	2	3	0	0	3	0	0
20	34506934	.	T	A	2	2	4	0	0	4	0	0
20	34596468	.	A	T	2	4	6	0	0	6	0	0
20	34596617	.	T	C	2	2	4	0	0	4	0	0
20	34597127	.	C	T	2	2	4	0	0	4	0	0
20	34597292	.	G	A	1	3	4	0	1	5	0	0
20	34597631	.	C	T	5	3	8	0	0	8	0	0
20	34598076	.	T	A	2	6	8	0	1	9	0	0
20	34601127	.	A	G	16	8	24	0	0	24	0	0
20	34601175	.	G	A	10	9	19	0	1	20	0	0
20	34601214	.	A	T	9	9	18	0	0	18	0	0
20	34602340	.	C	T	10	7	17	0	0	17	0	0
20	34602576	.	T	G	11	10	21	0	1	22	0	0
20	34603575	.	G	T	11	7	18	0	3	21	0	0
20	34603661	.	C	T	18	8	26	0	2	28	0	0
20	34604241	.	C	A	22	17	39	0	3	43	1	0
20	34607970	.	C	T	6	6	12	0	1	13	0	0
20	34608194	.	C	T	13	9	22	0	1	23	0	0
20	34608272	.	T	C	8	10	18	0	0	18	0	0
20	34608404	.	T	G	5	3	8	0	2	10	0	0
20	34608458	.	A	C	5	7	12	0	0	12	0	0
20	34608519	.	T	C	7	7	14	0	1	15	0	0
20	34617780	.	A	T	1	2	3	0	0	3	0	0
20	34630192	.	T	C	2	5	7	0	1	8	0	0
20	34630381	.	C	T	2	3	5	0	0	5	0	0
20	34630861	.	C	T	6	7	13	0	0	13	0	0
20	34632577	.	T	C	3	5	8	0	1	9	0	0
20	34632587	.	C	T	2	4	6	0	1	7	0	0
20	34632911	.	T	A	2	5	7	0	1	8	0	0
20	34634979	.	T	C	4	2	6	0	0	6	0	0
20	34634988	.	T	C	4	3	7	0	0	7	0	0
20	34636529	.	A	T	8	8	16	0	0	16	0	0
20	34636536	.	G	A	7	6	13	0	0	13	0	0
20	34638185	.	A	G	4	0	4	0	5	9	0	0
20	34638235	.	G	A	0	4	4	0	9	13	0	0
20	34638251	.	G	A	11	3	14	0	1	15	0	0
20	34642805	.	A	G	7	3	10	0	0	10	0	0
20	34642931	.	G	A	2	9	11	0	1	12	0	0
20	34643007	.	A	G	6	8	14	0	2	16	0	0
20	34643051	.	T	C	14	9	23	0	0	23	0	0
20	34643054	.	A	G	13	9	22	0	1	23	0	0
20	34643163	.	A	G	9	9	18	0	1	19	0	0
20	34643800	.	C	T	5	9	14	2	1	17	0	0
20	34655929	.	G	A	1	2	3	0	0	3	0	0
20	34695326	.	C	T	2	2	4	0	0	4	0	0
20	34696329	.	A	C	6	5	11	0	0	11	0	0
20	34696628	.	A	T	6	5	11	0	0	11	0	0
20	34700135	.	G	T	4	5	9	0	0	9	0	0
20	34700237	.	G	T	0	5	5	0	3	8	0	0
20	34700238	.	T	C	3	5	8	0	0	8	0	0
20	34733259	.	A	G	2	0	2	0	5	7	0	0
20	34733553	.	C	A	7	10	17	0	1	18	0	0
20	34733752	.	C	T	19	10	29	0	0	29	0	0
20	34733819	.	G	A	10	14	24	2	1	27	0	0
20	34737818	.	A	G	3	7	10	0	0	10	0	0
20	34737886	.	T	A	1	3	4	0	0	4	0	0
20	34738198	.	G	A	24	18	42	0	1	43	0	0
20	34738205	.	C	T	3	24	27	0	17	44	0	0
20	34738272	.	A	G	22	17	39	0	0	39	0	0
20	34738314	.	G	A	16	14	30	1	5	36	0	0
20	34738397	.	G	T	7	11	18	0	0	18	0	0
20	34738756	.	A	G	16	14	30	0	1	31	0	0
20	34742840	.	G	A	12	11	23	0	0	23	0	0
20	34746019	.	G	A	9	5	14	0	0	14	0	0
20	34749672	.	G	A	5	5	10	0	0	10	0	0
20	34749747	.	G	A	4	9	13	0	0	13	0	0
20	34749754	.	C	T	9	3	12	0	1	13	0	0
20	34749793	.	C	T	2	2	4	0	0	4	0	0
20	34749794	.	A	G	2	2	4	0	0	4	0	0
20	34750025	.	G	C	10	2	12	0	0	12	0	0
20	34794939	.	C	T	34	24	58	0	3	61	0	0
20	34794988	.	C	G	33	28	61	0	2	63	0	0
20	34795111	.	C	A	31	37	68	0	4	72	0	0
20	34795126	.	A	G	30	39	69	0	4	73	0	0
20	34795221	.	A	T	33	27	60	0	2	62	0	0
20	34795418	.	G	C	29	20	49	0	2	51	0	0
20	34795559	.	C	T	7	35	42	0	28	70	0	0
20	34795631	.	T	G	36	19	55	0	6	62	1	0
20	34795689	.	C	T	40	36	76	0	3	79	0	0
20	34797252	.	G	T	41	30	71	0	2	73	0	0
20	34797532	.	C	A	23	27	50	0	4	54	0	0
20	34933209	.	C	A	29	33	62	5	2	69	0	0
20	34955791	.	C	T	36	27	63	1	8	72	0	0
20	34955810	.	T	G	59	9	68	2	7	77	0	0
20	34956159	.	A	T	11	3	14	0	1	15	0	0
20	34956164	.	T	A	10	4	14	0	0	14	0	0
20	35000163	.	C	T	0	2	2	0	2	4	0	0
20	35013931	.	G	C	1	4	5	0	0	5	0	0
20	35014182	.	C	T	1	2	3	0	0	3	0	0
20	35018847	.	C	A	1	2	3	0	0	3	0	0
20	35058727	.	T	A	6	4	10	0	0	10	0	0
20	35064521	.	G	A	6	11	17	0	0	17	0	0
20	35065345	.	G	A	1	16	17	0	23	40	0	0
20	35065588	.	G	A	16	19	35	1	3	39	0	0
20	35066821	.	G	A	0	17	17	0	28	45	0	0
20	35068765	.	A	T	5	12	17	1	3	21	0	0
20	35069756	.	A	G	9	14	23	0	2	25	0	0
20	35069928	.	C	T	15	16	31	0	1	32	0	0
20	35069963	.	A	C	21	16	37	0	1	38	0	0
20	35070176	.	C	T	16	20	36	0	1	37	0	0
20	35070340	.	C	T	19	15	34	0	2	36	0	0
20	35159500	.	C	A	1	1	2	0	1	3	0	0
20	35198810	.	A	C	1	6	7	0	0	7	0	0
20	35205061	.	C	T	3	8	11	0	0	11	0	0
20	35205182	.	T	C	3	5	8	0	0	8	0	0
20	35205552	.	T	G	3	0	3	0	7	10	0	0
20	35205600	.	A	T	4	12	16	0	0	16	0	0
20	35205626	.	T	G	8	0	8	0	3	11	0	0
20	35205772	.	T	A	3	1	4	0	1	5	0	0
20	35206023	.	G	A	6	4	10	0	0	10	0	0
20	35206101	.	A	T	2	8	10	0	1	11	0	0
20	35206272	.	T	C	2	2	4	0	0	4	0	0
20	35208046	.	A	G	7	7	14	0	0	14	0	0
20	35209012	.	G	A	2	4	6	0	0	6	0	0
20	35209080	.	T	A	8	4	12	0	1	13	0	0
20	35209405	.	C	T	12	16	28	0	1	29	0	0
20	35209625	.	G	A	11	5	16	0	0	16	0	0
20	35209680	.	A	T	12	3	15	0	0	15	0	0
20	35209681	.	T	A	11	3	14	0	0	14	0	0
20	35210176	.	T	C	3	1	4	0	18	22	0	0
20	35210212	.	G	T	12	5	17	0	0	17	0	0
20	35210282	.	T	C	2	0	2	0	11	13	0	0
20	35210306	.	T	C	5	9	14	0	0	14	0	0
20	35210538	.	C	G	5	2	7	0	1	8	0	0
20	35210575	.	C	T	1	4	5	0	1	6	0	0
20	35210853	.	A	T	6	3	9	0	1	10	0	0
20	35211515	.	C	T	0	2	2	0	1	3	0	0
20	35211641	.	C	T	1	4	5	0	0	5	0	0
20	35212128	.	G	T	1	4	5	0	1	6	0	0
20	35212946	.	T	A	1	4	5	0	0	5	0	0
20	35295208	.	C	T	6	2	8	0	0	8	0	0
20	35297212	.	T	G	7	0	7	0	4	11	0	0
20	35297648	.	C	T	10	5	15	0	0	15	0	0
20	35297693	.	G	A	3	5	8	0	1	9	0	0
20	35297819	.	T	C	6	5	11	0	0	11	0	0
20	35297832	.	A	C	12	0	12	0	1	13	0	0
20	35297867	.	C	T	7	8	15	0	0	15	0	0
20	35297931	.	C	T	3	3	6	0	0	6	0	0
20	35297968	.	T	C	2	2	4	0	2	6	0	0
20	35428633	.	T	C	27	36	63	0	6	69	0	0
20	35428910	.	A	G	31	25	56	0	3	59	0	0
20	35428931	.	T	A	31	30	61	0	3	64	0	0
20	35429017	.	T	A	31	12	43	0	0	43	0	0
20	35429269	.	C	T	39	34	73	0	3	76	0	0
20	35429299	.	A	G	35	31	66	0	4	70	0	0
20	35429610	.	A	T	35	45	80	0	4	84	0	0
20	35433262	.	G	C	9	11	20	0	0	20	0	0
20	35433264	.	G	C	9	11	20	0	0	20	0	0
20	35462408	.	C	T	2	1	3	0	0	3	0	0
20	35462426	.	G	A	4	3	7	0	0	7	0	0
20	35464735	.	C	G	1	3	4	0	1	5	0	0
20	35798083	.	C	G	13	6	19	0	0	19	0	0
20	35798370	.	G	A	12	20	32	0	4	36	0	0
20	35798717	.	A	G	7	5	12	0	0	12	0	0
20	35798973	.	T	A	9	7	16	0	0	16	0	0
20	35799889	.	A	T	2	8	10	0	1	11	0	0
20	35799913	.	T	G	2	4	6	0	0	6	0	0
20	35800001	.	G	A	7	6	13	0	5	18	0	0
20	35800249	.	C	T	3	4	7	0	2	9	0	0
20	35800349	.	C	T	5	2	7	0	0	7	0	0
20	35800520	.	G	A	5	2	7	0	0	7	0	0
20	35800749	.	G	A	2	6	8	0	0	8	0	0
20	35816606	.	G	A	4	2	6	0	0	6	0	0
20	35972539	.	T	C	4	2	6	0	0	6	0	0
20	35972544	.	G	A	3	2	5	0	1	6	0	0
20	35979899	.	G	T	6	8	14	0	0	14	0	0
20	35979910	.	T	G	4	7	11	0	0	11	0	0
20	35979983	.	G	C	2	2	4	0	1	5	0	0
20	35980091	.	T	C	1	6	7	0	1	8	0	0
20	36234334	.	T	A	1	3	4	0	0	4	0	0
20	36297304	.	C	T	6	11	17	0	0	17	0	0
20	36297356	.	G	A	3	6	9	0	15	24	0	0
20	36297418	.	C	A	10	5	15	0	0	15	0	0
20	36297448	.	C	T	6	6	12	0	2	14	0	0
20	36297518	.	G	A	1	18	19	0	7	26	0	0
20	36297832	.	C	T	4	11	15	0	0	15	0	0
20	36395895	.	G	A	3	3	6	0	0	6	0	0
20	36396668	.	A	G	3	3	6	0	0	6	0	0
20	36420218	.	A	C	21	13	34	0	0	34	0	0
20	36420713	.	C	T	2	19	21	0	21	42	0	0
20	36420804	.	G	T	16	13	29	0	0	29	0	0
20	36420982	.	G	A	15	12	27	0	0	27	0	0
20	36421218	.	G	A	7	11	18	0	0	18	0	0
20	36421530	.	A	C	2	0	2	0	13	15	0	0
20	36421757	.	C	T	0	8	8	0	4	12	0	0
20	36422043	.	G	A	15	21	36	0	1	37	0	0
20	36422098	.	C	A	4	17	21	0	0	21	0	0
20	36422291	.	G	T	4	5	9	0	1	10	0	0
20	36433247	.	G	A	7	4	11	0	1	12	0	0
20	36437314	.	A	G	5	2	7	0	1	8	0	0
20	36449385	.	C	T	6	3	9	0	0	9	0	0
20	36626195	.	A	G	17	0	17	0	18	35	0	0
20	36626248	.	G	A	19	17	36	0	1	37	0	0
20	36626335	.	C	T	15	10	25	0	0	25	0	0
20	36637941	.	C	T	5	3	8	0	0	8	0	0
20	36637999	.	G	A	5	2	7	0	0	7	0	0
20	36638133	.	A	T	6	2	8	0	0	8	0	0
20	36638169	.	T	C	1	6	7	0	1	8	0	0
20	36675273	.	T	C	7	5	12	0	0	12	0	0
20	36677574	.	G	A	7	4	11	0	1	12	0	0
20	36798128	.	T	A	5	2	7	0	0	7	0	0
20	36798154	.	C	G	5	5	10	0	0	10	0	0
20	36799816	.	A	G	7	8	15	0	0	15	0	0
20	36799934	.	C	T	1	8	9	0	6	15	0	0
20	36816972	.	C	T	5	5	10	0	1	11	0	0
20	36817162	.	T	G	2	3	5	0	1	6	0	0
20	36817184	.	G	A	0	3	3	0	4	7	0	0
20	36817368	.	G	C	1	2	3	0	0	3	0	0
20	36828948	.	A	C	8	5	13	0	0	13	0	0
20	36838717	.	C	T	10	8	18	0	1	19	0	0
20	36838871	.	C	T	13	13	26	0	0	26	0	0
20	36838946	.	A	C	8	7	15	3	0	18	0	0
20	36915481	.	G	A	14	15	29	0	1	30	0	0
20	36915493	.	A	T	13	12	25	0	1	26	0	0
20	36915529	.	G	A	17	5	22	0	2	24	0	0
20	36915826	.	C	A	11	11	22	0	0	22	0	0
20	36916050	.	A	G	16	9	25	0	0	25	0	0
20	36916187	.	T	C	9	1	10	0	5	15	0	0
20	36916428	.	A	T	4	4	8	0	0	8	0	0
20	36916429	.	A	T	3	4	7	0	1	8	0	0
20	36917037	.	C	T	12	5	17	0	0	18	1	0
20	36917631	.	C	T	2	2	4	0	0	4	0	0
20	37300798	.	G	A	2	1	3	0	1	4	0	0
20	37358885	.	G	A	0	10	10	0	10	20	0	0
20	37512259	.	G	A	17	16	33	0	1	34	0	0
20	37513257	.	C	A	14	19	33	0	1	34	0	0
20	37513632	.	A	G	33	19	52	0	1	53	0	0
20	37513702	.	G	A	36	19	55	0	0	55	0	0
20	37513753	.	G	T	25	22	47	0	4	51	0	0
20	37515525	.	G	T	11	7	18	0	0	18	0	0
20	37515607	.	T	G	11	10	21	0	0	21	0	0
20	37516363	.	C	T	12	8	20	0	0	20	0	0
20	37517962	.	T	C	11	0	11	0	10	21	0	0
20	37518718	.	A	T	3	4	7	0	0	7	0	0
20	37518823	.	A	G	2	3	5	0	0	5	0	0
20	37519429	.	A	T	1	2	3	0	0	3	0	0
20	37519453	.	G	T	1	2	3	0	0	3	0	0
20	37736041	.	T	A	7	13	20	0	1	21	0	0
20	37760614	.	C	A	2	2	4	0	1	5	0	0
20	37768543	.	G	A	6	14	20	0	0	20	0	0
20	37768627	.	T	A	8	10	18	0	3	21	0	0
20	37768712	.	A	C	9	6	15	0	0	15	0	0
20	37768862	.	T	C	10	4	14	0	0	14	0	0
20	37768995	.	T	A	11	8	19	0	0	19	0	0
20	37796473	.	A	C	1	2	3	0	0	3	0	0
20	37798627	.	G	A	2	4	6	0	1	7	0	0
20	37799164	.	A	T	1	2	3	0	1	4	0	0
20	37799497	.	T	C	2	2	4	0	1	5	0	0
20	37800444	.	C	A	1	4	5	0	0	5	0	0
20	37800476	.	T	C	1	3	4	0	0	4	0	0
20	37844090	.	A	T	2	2	4	0	0	4	0	0
20	37859577	.	T	C	5	7	12	0	0	12	0	0
20	37862133	.	T	C	13	6	19	0	1	20	0	0
20	37862144	.	A	G	16	5	21	0	1	22	0	0
20	37862303	.	C	G	3	4	7	0	0	7	0	0
20	37862414	.	T	C	6	7	13	0	2	15	0	0
20	37862466	.	C	G	5	3	8	0	0	8	0	0
20	37896247	.	T	C	1	2	3	0	0	3	0	0
20	37896256	.	T	C	1	2	3	0	0	3	0	0
20	37899220	.	A	G	3	3	6	0	2	8	0	0
20	37899289	.	T	C	3	3	6	0	0	6	0	0
20	37913237	.	G	A	1	2	3	0	1	4	0	0
20	37913988	.	T	G	4	4	8	0	0	8	0	0
20	37914001	.	A	G	4	2	6	0	0	6	0	0
20	37914497	.	T	C	3	3	6	0	0	6	0	0
20	37914517	.	C	T	4	1	5	0	0	5	0	0
20	37914651	.	C	T	1	4	5	0	0	5	0	0
20	37914668	.	G	T	2	3	5	0	1	6	0	0
20	37914709	.	A	C	2	5	7	0	0	7	0	0
20	37914722	.	C	T	1	3	4	0	1	5	0	0
20	37914750	.	C	A	1	4	5	0	0	5	0	0
20	37914838	.	C	T	5	2	7	0	0	7	0	0
20	37915027	.	C	T	2	7	9	0	0	9	0	0
20	37915217	.	A	T	11	4	15	0	0	15	0	0
20	37915479	.	C	T	12	5	17	0	0	17	0	0
20	37915619	.	T	G	4	5	9	0	0	9	0	0
20	37915658	.	T	C	3	4	7	0	0	7	0	0
20	37915859	.	C	T	1	10	11	1	2	14	0	0
20	37916043	.	T	A	4	4	8	0	1	9	0	0
20	37916154	.	A	G	3	3	6	0	0	6	0	0
20	37920726	.	A	G	9	6	15	0	0	15	0	0
20	37920822	.	C	T	1	8	9	0	8	17	0	0
20	37924995	.	G	T	4	5	9	0	0	9	0	0
20	37925455	.	A	C	1	4	5	0	1	6	0	0
20	37928136	.	T	G	2	3	5	0	0	5	0	0
20	37930514	.	C	G	1	3	4	0	0	4	0	0
20	37930605	.	A	G	1	6	7	0	0	7	0	0
20	37930672	.	C	G	2	3	5	0	0	5	0	0
20	38091838	.	G	A	22	5	27	0	1	28	0	0
20	38099500	.	C	T	12	12	24	0	1	25	0	0
20	38104076	.	G	A	23	9	32	0	2	34	0	0
20	38104077	.	T	A	25	8	33	0	2	35	0	0
20	38241264	.	C	T	1	2	3	0	0	3	0	0
20	38241825	.	T	G	1	3	4	0	0	4	0	0
20	38358534	.	T	C	2	3	5	0	0	5	0	0
20	38359258	.	G	A	1	3	4	0	0	4	0	0
20	38473886	.	T	C	2	2	4	0	1	5	0	0
20	38473940	.	T	G	2	0	2	0	5	7	0	0
20	38517640	.	C	T	14	7	21	0	1	22	0	0
20	38517929	.	T	A	10	6	16	0	0	16	0	0
20	38517941	.	C	T	12	7	19	0	0	19	0	0
20	38518015	.	C	T	8	8	16	0	1	17	0	0
20	38518082	.	T	G	13	9	22	0	2	24	0	0
20	38518267	.	A	G	13	10	23	0	0	23	0	0
20	38518454	.	T	G	10	10	20	0	0	20	0	0
20	38518861	.	C	G	3	5	8	0	0	8	0	0
20	38518878	.	T	A	7	3	10	0	0	10	0	0
20	38518906	.	C	T	5	3	8	0	0	8	0	0
20	38518920	.	T	C	3	3	6	0	0	6	0	0
20	38538249	.	G	A	0	4	4	0	1	5	0	0
20	38538471	.	G	A	0	2	2	0	1	3	0	0
20	38647369	.	T	C	1	2	3	0	1	4	0	0
20	38657824	.	C	T	4	4	8	0	0	8	0	0
20	38662649	.	A	G	6	4	10	0	1	11	0	0
20	38662697	.	G	T	2	4	6	0	1	7	0	0
20	38665194	.	G	A	7	3	10	0	0	10	0	0
20	38670230	.	G	A	11	11	22	0	0	22	0	0
20	38670397	.	C	T	1	3	4	0	2	6	0	0
20	38726664	.	C	T	7	10	17	0	0	17	0	0
20	38726721	.	C	A	7	6	13	0	0	13	0	0
20	38726935	.	C	T	18	8	26	0	0	26	0	0
20	38727047	.	A	G	12	13	25	0	4	29	0	0
20	38787014	.	T	A	4	5	9	0	0	9	0	0
20	38788332	.	T	C	1	2	3	0	0	3	0	0
20	38788358	.	C	A	3	5	8	0	0	8	0	0
20	38788624	.	G	A	4	3	7	0	0	7	0	0
20	38788676	.	C	T	5	3	8	0	0	8	0	0
20	38788749	.	A	C	3	6	9	0	0	9	0	0
20	38788887	.	G	A	8	13	21	0	2	23	0	0
20	38789855	.	T	C	4	9	13	0	0	13	0	0
20	38790051	.	C	T	0	10	10	0	9	19	0	0
20	38790283	.	A	G	4	8	12	0	1	13	0	0
20	38793405	.	G	A	7	4	11	0	0	11	0	0
20	38793414	.	C	T	0	5	5	0	5	10	0	0
20	38798501	.	A	C	5	4	9	0	0	9	0	0
20	38802704	.	A	G	2	3	5	0	0	5	0	0
20	38854083	.	C	T	1	2	3	0	0	3	0	0
20	38857835	.	C	T	2	2	4	0	0	4	0	0
20	38861646	.	T	C	4	2	6	0	0	6	0	0
20	38864559	.	A	G	2	3	5	0	0	5	0	0
20	38866779	.	T	C	4	3	7	0	0	7	0	0
20	38871129	.	A	G	6	3	9	0	0	9	0	0
20	38872436	.	T	C	7	3	10	0	0	10	0	0
20	38877848	.	G	A	1	5	6	0	0	6	0	0
20	38884042	.	C	T	1	5	6	0	0	6	0	0
20	38889148	.	C	T	6	2	8	0	0	8	0	0
20	38910374	.	A	G	13	5	18	0	1	19	0	0
20	39045960	.	A	T	6	18	24	0	2	26	0	0
20	39046032	.	T	C	9	10	19	0	1	20	0	0
20	39052063	.	A	T	9	13	22	0	0	22	0	0
20	39052100	.	T	A	14	15	29	0	2	31	0	0
20	39052254	.	C	T	2	16	18	0	23	41	0	0
20	39052505	.	C	A	16	10	26	0	1	27	0	0
20	39055868	.	T	A	3	4	7	0	0	7	0	0
20	39081322	.	C	T	2	2	4	0	0	4	0	0
20	39190930	.	C	A	2	2	4	0	0	4	0	0
20	39190993	.	C	T	2	2	4	0	1	5	0	0
20	39191354	.	T	C	5	4	9	0	0	9	0	0
20	39191486	.	A	G	1	3	4	0	1	5	0	0
20	39191708	.	C	T	4	5	9	0	0	9	0	0
20	39256968	.	C	T	1	3	4	0	0	4	0	0
20	39259836	.	G	A	1	8	9	0	0	9	0	0
20	39260481	.	T	A	2	5	7	0	0	7	0	0
20	39260755	.	C	T	27	28	55	0	4	59	0	0
20	39260837	.	G	A	24	31	55	0	3	58	0	0
20	39260865	.	T	G	31	32	63	0	2	66	1	0
20	39267227	.	T	G	7	14	21	0	0	21	0	0
20	39271725	.	T	C	9	9	18	0	0	18	0	0
20	39271731	.	G	A	10	9	19	0	0	19	0	0
20	39271833	.	C	G	10	5	15	0	1	16	0	0
20	39273910	.	A	T	4	8	12	0	4	16	0	0
20	39338845	.	C	T	2	4	6	0	0	6	0	0
20	39338929	.	C	T	5	9	14	0	0	14	0	0
20	39338965	.	T	C	7	8	15	0	0	15	0	0
20	39338981	.	G	T	10	7	17	0	1	18	0	0
20	39339030	.	T	C	13	7	20	0	0	20	0	0
20	39339169	.	A	G	14	12	26	0	0	26	0	0
20	39341517	.	G	A	15	6	21	0	1	22	0	0
20	39341520	.	T	C	15	6	21	0	1	22	0	0
20	39343397	.	T	C	6	3	9	0	0	9	0	0
20	39344011	.	C	A	2	3	5	0	0	5	0	0
20	39344085	.	T	C	3	3	6	0	0	6	0	0
20	39520835	.	T	C	3	2	5	0	1	6	0	0
20	39554698	.	G	A	2	4	6	0	0	6	0	0
20	39557001	.	A	G	2	2	4	0	0	4	0	0
20	39589080	.	A	T	2	3	5	0	2	7	0	0
20	39689513	.	T	C	1	7	8	0	0	8	0	0
20	39692208	.	A	T	1	2	3	0	1	4	0	0
20	39692433	.	C	A	7	3	10	0	0	10	0	0
20	39807080	.	G	A	1	3	4	0	0	4	0	0
20	40269926	.	T	C	2	0	2	0	5	7	0	0
20	40280404	.	G	A	1	2	3	0	0	3	0	0
20	40369463	.	C	A	3	5	8	0	0	8	0	0
20	40372729	.	G	A	22	9	31	0	0	31	0	0
20	40372760	.	T	A	16	11	27	0	1	28	0	0
20	40372811	.	A	G	9	14	23	0	0	23	0	0
20	40461580	.	C	T	2	3	5	0	0	5	0	0
20	40466540	.	C	T	14	10	24	0	2	26	0	0
20	40466662	.	C	T	13	17	30	0	2	32	0	0
20	40467044	.	C	T	27	19	46	0	1	47	0	0
20	40471756	.	A	T	34	38	72	0	5	77	0	0
20	40471844	.	C	T	31	16	47	1	0	48	0	0
20	40471886	.	T	A	8	15	23	2	13	38	0	0
20	40472009	.	T	A	41	29	70	0	2	72	0	0
20	40472075	.	C	A	31	31	62	1	2	65	0	0
20	40472175	.	G	C	41	32	73	1	0	74	0	0
20	40472399	.	T	A	1	2	3	0	2	5	0	0
20	40475815	.	C	T	16	11	27	0	0	27	0	0
20	40475872	.	G	A	11	10	21	0	2	23	0	0
20	40476094	.	G	A	12	5	17	0	1	18	0	0
20	40476165	.	C	T	20	9	29	0	5	34	0	0
20	40476214	.	A	T	17	12	29	0	5	34	0	0
20	40478035	.	G	A	14	9	23	0	1	24	0	0
20	40478289	.	A	C	15	7	22	0	1	23	0	0
20	40480227	.	G	T	6	10	16	0	0	16	0	0
20	40480250	.	C	T	6	6	12	0	0	12	0	0
20	40485077	.	T	G	4	4	8	0	0	8	0	0
20	40715260	.	A	G	30	27	57	0	3	60	0	0
20	40716899	.	G	A	17	22	39	0	0	39	0	0
20	40716911	.	A	G	21	18	39	0	1	40	0	0
20	40717271	.	G	T	9	6	15	0	2	17	0	0
20	40762073	.	A	G	1	6	7	0	0	7	0	0
20	40762361	.	T	C	1	3	4	0	0	4	0	0
20	40819423	.	C	G	3	3	6	0	0	6	0	0
20	40835131	.	A	G	5	6	11	0	0	11	0	0
20	40840963	.	A	C	1	4	5	0	0	5	0	0
20	41239439	.	T	C	3	4	7	0	2	9	0	0
20	41239461	.	C	T	2	4	6	0	0	6	0	0
20	41239604	.	C	T	3	3	6	0	0	6	0	0
20	41239624	.	G	A	3	3	6	0	0	6	0	0
20	41239753	.	G	T	1	4	5	0	2	7	0	0
20	41239760	.	G	A	0	4	4	0	2	6	0	0
20	41239899	.	G	T	1	2	3	0	2	5	0	0
20	41239916	.	A	T	1	3	4	0	0	4	0	0
20	41239946	.	A	G	4	3	7	0	0	7	0	0
20	41239977	.	T	C	4	2	6	0	0	6	0	0
20	41240107	.	G	C	4	2	6	0	0	6	0	0
20	41240108	.	A	G	4	0	4	0	2	6	0	0
20	41240148	.	A	G	2	0	2	0	2	4	0	0
20	41240176	.	C	T	1	0	1	0	0	3	2	0
20	41240480	.	A	G	3	0	3	0	8	11	0	0
20	41240512	.	A	C	2	6	8	0	0	8	0	0
20	41240643	.	G	A	0	4	4	0	3	7	0	0
20	41240736	.	T	C	2	6	8	0	0	8	0	0
20	41240958	.	A	G	10	11	21	0	1	22	0	0
20	41240986	.	A	G	12	0	12	0	11	23	0	0
20	41241316	.	G	C	5	4	9	0	3	12	0	0
20	41241350	.	C	A	8	3	11	0	3	14	0	0
20	41241355	.	C	T	8	6	14	0	1	15	0	0
20	41241443	.	A	C	3	7	10	0	1	11	0	0
20	41242045	.	G	A	1	10	11	0	18	29	0	0
20	41640903	.	T	C	2	2	4	0	1	5	0	0
20	41640917	.	A	G	4	3	7	0	0	7	0	0
20	41641019	.	A	T	6	5	11	0	1	12	0	0
20	41643457	.	C	T	10	8	18	0	0	18	0	0
20	41651639	.	C	T	3	2	5	0	1	6	0	0
20	41655513	.	G	A	3	5	8	0	7	15	0	0
20	41689967	.	A	G	8	7	15	0	0	15	0	0
20	41689979	.	C	T	5	8	13	0	2	15	0	0
20	41734344	.	C	T	7	9	16	0	1	17	0	0
20	41757835	.	A	G	6	14	20	0	3	23	0	0
20	41765105	.	T	C	8	11	19	0	1	20	0	0
20	41961113	.	C	T	1	1	2	0	1	3	0	0
20	41961170	.	T	G	3	3	6	0	0	6	0	0
20	41961171	.	A	T	3	3	6	0	0	6	0	0
20	41961779	.	C	T	1	2	3	0	0	3	0	0
20	41962872	.	A	G	5	4	9	0	1	10	0	0
20	41962923	.	A	T	5	5	10	1	0	11	0	0
20	41963188	.	G	A	5	3	8	0	0	8	0	0
20	41963398	.	T	G	4	3	7	0	0	7	0	0
20	41963451	.	G	A	0	6	6	0	9	15	0	0
20	41963530	.	A	G	6	8	14	0	0	14	0	0
20	41963652	.	C	T	7	5	12	1	1	14	0	0
20	41963660	.	C	T	6	4	10	1	0	11	0	0
20	41998601	.	C	G	2	2	4	0	0	4	0	0
20	41999025	.	C	A	5	2	7	0	0	7	0	0
20	41999046	.	G	A	6	4	10	0	0	10	0	0
20	41999106	.	A	G	3	6	9	0	1	10	0	0
20	42047386	.	C	T	2	2	4	0	0	4	0	0
20	42221387	.	A	T	7	3	10	0	0	10	0	0
20	42221710	.	C	T	13	5	18	0	3	21	0	0
20	42221713	.	C	T	13	8	21	0	0	21	0	0
20	42222444	.	A	T	3	7	10	0	0	10	0	0
20	42222546	.	A	T	7	5	12	0	0	12	0	0
20	42222549	.	A	T	5	5	10	0	0	10	0	0
20	42222621	.	T	C	4	9	13	0	1	14	0	0
20	42222769	.	T	C	8	3	11	0	0	11	0	0
20	42222770	.	T	C	4	7	11	0	0	11	0	0
20	42223350	.	A	T	4	5	9	0	0	9	0	0
20	42277974	.	A	G	1	4	5	0	0	5	0	0
20	42278043	.	C	T	2	3	5	0	0	5	0	0
20	42280829	.	C	T	1	4	5	0	0	5	0	0
20	43120256	.	T	G	14	11	25	0	4	29	0	0
20	43121404	.	T	C	1	4	5	0	0	5	0	0
20	44372854	.	G	C	7	6	13	0	0	13	0	0
20	44372902	.	A	T	10	6	16	0	0	16	0	0
20	44373336	.	G	A	26	7	33	0	3	36	0	0
20	44373378	.	A	G	24	10	34	0	3	37	0	0
20	44386501	.	A	G	19	11	30	0	0	30	0	0
20	44386556	.	C	T	19	10	29	0	0	29	0	0
20	44386562	.	G	T	16	11	27	0	4	31	0	0
20	44389647	.	G	A	8	11	19	0	2	21	0	0
20	44402797	.	C	T	5	9	14	0	1	15	0	0
20	44447798	.	G	T	7	5	12	0	0	12	0	0
20	44451262	.	G	A	4	2	6	0	0	6	0	0
20	44457278	.	C	T	1	2	3	0	1	4	0	0
20	44457311	.	G	C	2	0	2	0	3	5	0	0
20	44457314	.	A	G	3	2	5	0	0	5	0	0
20	44464502	.	G	T	2	1	3	0	1	4	0	0
20	44464579	.	T	C	9	12	21	0	1	22	0	0
20	44464835	.	C	G	11	10	21	0	2	23	0	0
20	44464875	.	G	T	19	10	29	0	2	31	0	0
20	44465778	.	G	T	18	12	30	1	2	33	0	0
20	44518070	.	G	T	2	3	5	0	0	5	0	0
20	44566955	.	T	G	4	5	9	0	0	9	0	0
20	44567001	.	G	A	2	10	12	0	0	12	0	0
20	44567107	.	T	C	5	7	12	0	1	13	0	0
20	45406735	.	C	T	0	3	3	0	6	19	10	0
20	45406997	.	T	C	6	7	13	0	2	15	0	0
20	45408436	.	G	A	2	3	5	0	1	6	0	0
20	45644163	.	G	T	8	4	12	2	0	14	0	0
20	45645392	.	G	A	4	4	8	0	0	8	0	0
20	45660924	.	G	A	2	4	6	0	0	6	0	0
20	45669353	.	C	T	0	9	9	0	10	19	0	0
20	45679302	.	T	G	2	4	6	0	0	6	0	0
20	45679303	.	T	A	2	4	6	0	0	6	0	0
20	45682240	.	A	C	3	3	6	0	1	7	0	0
20	45709854	.	G	A	1	3	4	0	0	4	0	0
20	45709857	.	A	G	1	2	3	0	1	4	0	0
20	45742126	.	C	T	3	2	5	0	0	5	0	0
20	45745523	.	C	T	2	5	7	0	1	8	0	0
20	45746063	.	C	T	2	5	7	0	0	7	0	0
20	45746064	.	A	G	2	5	7	0	0	7	0	0
20	45746150	.	G	A	8	6	14	0	1	15	0	0
20	45746297	.	C	T	8	7	15	0	0	15	0	0
20	45746524	.	T	A	12	10	22	0	2	24	0	0
20	45746567	.	C	T	12	5	17	0	2	19	0	0
20	45746674	.	C	A	18	15	33	0	0	33	0	0
20	45746678	.	C	T	16	16	32	0	1	33	0	0
20	45746936	.	C	G	9	10	19	0	0	19	0	0
20	45746977	.	G	A	2	6	8	0	19	27	0	0
20	45746978	.	A	C	16	9	25	0	2	27	0	0
20	45747032	.	G	C	1	14	15	0	20	35	0	0
20	45751466	.	G	A	13	18	31	0	4	35	0	0
20	45751526	.	T	G	11	17	28	0	0	28	0	0
20	45751561	.	G	C	1	12	13	0	18	31	0	0
20	45751563	.	T	C	16	16	32	0	0	32	0	0
20	45751668	.	G	A	5	12	17	1	0	18	0	0
20	45751989	.	T	A	7	3	10	0	2	12	0	0
20	45759508	.	G	A	2	2	4	0	0	4	0	0
20	45764764	.	T	C	2	2	4	0	1	5	0	0
20	45764770	.	C	A	0	1	1	0	4	5	0	0
20	46352444	.	G	C	1	2	3	0	0	3	0	0
20	46441695	.	G	C	2	11	13	0	0	13	0	0
20	46441749	.	G	A	2	3	5	0	1	6	0	0
20	46442397	.	T	C	9	3	12	0	0	12	0	0
20	46442459	.	A	G	11	14	25	0	0	25	0	0
20	46451592	.	G	A	13	10	23	0	1	24	0	0
20	46451910	.	A	G	11	10	21	0	1	22	0	0
20	46463315	.	T	A	13	4	17	0	0	17	0	0
20	46466920	.	G	A	4	4	8	0	0	8	0	0
20	46466934	.	G	T	3	4	7	0	0	7	0	0
20	46502505	.	C	T	2	3	5	0	0	5	0	0
20	46502535	.	C	A	3	2	5	0	0	5	0	0
20	46506203	.	T	A	4	3	7	0	0	7	0	0
20	46508767	.	C	T	4	9	13	0	0	13	0	0
20	46515625	.	G	A	6	5	11	0	0	11	0	0
20	46517286	.	C	G	7	5	12	0	1	13	0	0
20	46519148	.	T	A	4	7	11	0	3	14	0	0
20	46522932	.	G	A	2	6	8	0	4	12	0	0
20	46523109	.	A	T	2	3	5	0	0	5	0	0
20	46523196	.	G	A	6	5	11	0	0	11	0	0
20	46533981	.	T	G	5	5	10	0	1	11	0	0
20	46536936	.	G	T	26	15	41	0	2	43	0	0
20	46536981	.	C	T	25	19	44	0	2	46	0	0
20	46537039	.	A	T	19	21	40	0	2	42	0	0
20	46537143	.	A	T	30	16	46	0	5	51	0	0
20	46537239	.	C	T	15	23	38	0	4	42	0	0
20	46537404	.	G	A	12	9	21	0	0	21	0	0
20	46537563	.	A	G	19	22	41	0	1	42	0	0
20	46537636	.	G	A	16	18	34	2	1	39	2	0
20	46539619	.	A	G	17	16	33	0	0	33	0	0
20	46540898	.	A	G	13	8	21	0	2	23	0	0
20	46552431	.	C	T	2	8	10	0	9	19	0	0
20	46552965	.	G	T	37	23	60	0	2	62	0	0
20	46552966	.	G	T	38	23	61	0	1	62	0	0
20	46733096	.	C	T	1	3	4	0	3	7	0	0
20	47297733	.	T	G	2	1	3	0	2	5	0	0
20	48483184	.	T	A	3	3	6	0	1	7	0	0
20	48483989	.	A	T	2	3	5	0	0	5	0	0
20	48484411	.	A	C	5	0	5	0	4	9	0	0
20	48598493	.	C	T	5	15	20	0	1	21	0	0
20	48844050	.	T	C	13	0	13	0	10	23	0	0
20	48844134	.	A	G	11	9	20	0	1	21	0	0
20	48844259	.	G	T	9	12	21	0	0	21	0	0
20	48844295	.	C	T	0	9	9	0	10	19	0	0
20	48845298	.	A	G	10	7	17	0	0	17	0	0
20	48860755	.	G	A	4	6	10	0	0	10	0	0
20	48869895	.	G	A	2	3	5	0	2	7	0	0
20	49094970	.	C	T	5	6	11	0	1	12	0	0
20	49094973	.	T	C	4	6	10	0	1	11	0	0
20	49099900	.	A	G	5	5	10	0	0	10	0	0
20	49100237	.	C	T	11	10	21	0	2	23	0	0
20	49103131	.	G	A	13	10	23	0	4	27	0	0
20	49103164	.	G	A	12	11	23	0	0	23	0	0
20	49103217	.	A	T	7	6	13	0	0	13	0	0
20	49105469	.	A	T	2	4	6	0	0	6	0	0
20	49719213	.	T	C	2	0	2	0	2	4	0	0
20	49725935	.	A	G	2	2	4	0	0	4	0	0
20	49726499	.	C	T	1	2	3	0	0	3	0	0
20	49726514	.	G	A	1	3	4	0	0	4	0	0
20	49727455	.	A	G	1	4	5	0	0	5	0	0
20	50921211	.	T	C	4	3	7	0	0	7	0	0
20	50923848	.	G	A	1	4	5	0	0	5	0	0
20	50926713	.	A	G	4	0	4	0	4	8	0	0
20	51089236	.	T	C	18	0	18	10	28	56	0	0
20	51089243	.	T	C	18	27	45	10	3	58	0	0
20	51647926	.	T	C	2	11	13	0	1	14	0	0
20	51647927	.	T	C	4	7	11	0	3	14	0	0
20	51649197	.	T	C	2	2	4	0	0	4	0	0
20	52333070	.	A	G	3	1	4	0	1	5	0	0
20	53069778	.	C	T	0	3	3	0	12	15	0	0
20	53069784	.	G	A	11	4	15	0	0	15	0	0
20	53074615	.	T	C	2	0	2	0	3	5	0	0
20	53171938	.	C	G	0	2	2	0	4	6	0	0
20	53181091	.	G	A	0	3	3	0	2	5	0	0
20	53215338	.	A	G	3	1	4	0	4	8	0	0
20	53224585	.	A	G	7	6	13	0	0	13	0	0
20	53312604	.	G	T	2	3	5	0	3	8	0	0
20	53318814	.	G	T	5	4	9	0	1	10	0	0
20	53318884	.	C	T	0	4	4	0	2	6	0	0
20	53365862	.	C	T	1	3	4	0	0	4	0	0
20	53377661	.	A	G	2	1	3	0	8	11	0	0
20	53377691	.	G	A	2	5	7	0	3	10	0	0
20	53378919	.	T	G	3	1	4	0	1	5	0	0
20	53393594	.	T	C	3	13	16	0	0	16	0	0
20	53393669	.	C	A	4	4	8	0	0	8	0	0
20	53398784	.	T	A	17	7	24	0	1	25	0	0
20	53401771	.	T	C	11	13	24	0	0	24	0	0
20	53401778	.	A	G	9	10	19	0	0	19	0	0
20	53408394	.	A	C	1	3	4	0	1	5	0	0
20	53408532	.	G	A	2	5	7	0	0	7	0	0
20	53639152	.	C	T	1	3	4	0	0	4	0	0
20	53639358	.	C	T	2	3	5	0	0	5	0	0
20	53640054	.	C	T	1	2	3	0	0	3	0	0
20	53803637	.	C	T	2	7	9	0	1	10	0	0
20	53803783	.	T	A	1	4	5	0	0	5	0	0
20	53804306	.	A	G	1	5	6	0	0	6	0	0
20	53804342	.	A	G	3	4	7	0	1	8	0	0
20	53810197	.	A	T	14	18	32	0	1	33	0	0
20	53898735	.	T	A	17	16	33	0	2	35	0	0
20	53898770	.	C	T	2	16	18	0	13	31	0	0
20	53898930	.	G	A	1	10	11	0	0	11	0	0
20	53899023	.	G	C	6	23	29	0	1	30	0	0
20	53899035	.	G	A	7	23	30	0	2	32	0	0
20	53901183	.	A	G	2	4	6	1	0	7	0	0
20	53901324	.	C	G	2	2	4	0	0	4	0	0
20	53901325	.	T	G	2	2	4	0	0	4	0	0
20	53968105	.	A	G	22	26	48	0	2	50	0	0
20	54051059	.	C	T	2	3	5	0	0	5	0	0
20	54067345	.	A	G	7	5	12	0	0	12	0	0
20	54067399	.	G	A	10	3	13	0	0	13	0	0
20	54067414	.	G	A	8	4	12	0	0	12	0	0
20	54067714	.	A	G	3	4	7	0	1	8	0	0
20	54085851	.	T	C	33	25	58	0	2	60	0	0
20	54197221	.	A	C	12	0	12	0	23	35	0	0
20	54197287	.	A	T	10	16	26	0	2	28	0	0
20	54197383	.	G	A	16	17	33	0	0	33	0	0
20	54197473	.	A	G	9	12	21	0	1	22	0	0
20	54197485	.	C	T	0	12	12	0	9	21	0	0
20	54197751	.	A	G	7	7	14	0	1	15	0	0
20	54197752	.	G	A	7	6	13	0	2	15	0	0
20	54205704	.	C	T	39	24	63	0	6	69	0	0
20	54215073	.	C	A	8	10	18	0	1	19	0	0
20	54215081	.	T	C	9	0	9	0	11	20	0	0
20	54215133	.	A	C	23	12	35	0	0	35	0	0
20	54219286	.	T	C	27	0	27	0	25	52	0	0
20	54228003	.	A	T	25	26	51	0	1	52	0	0
20	54233207	.	T	C	8	0	8	0	10	18	0	0
20	54235969	.	G	A	5	11	16	0	0	16	0	0
20	54236421	.	A	C	3	5	8	0	0	8	0	0
20	54236423	.	G	A	3	5	8	0	0	8	0	0
20	54249577	.	G	C	18	28	46	0	3	49	0	0
20	54251406	.	T	C	24	28	52	0	2	54	0	0
20	54283833	.	T	C	10	8	18	0	1	19	0	0
20	54284869	.	A	G	16	1	17	0	17	34	0	0
20	54284986	.	A	G	20	19	39	0	0	39	0	0
20	54285758	.	T	C	13	30	43	0	1	44	0	0
20	54285799	.	C	T	14	27	41	0	3	44	0	0
20	54285804	.	C	T	15	29	44	0	3	47	0	0
20	54285853	.	A	T	14	22	36	3	2	41	0	0
20	54286016	.	G	A	17	22	39	2	3	44	0	0
20	54286097	.	A	T	31	11	42	0	1	43	0	0
20	54286454	.	C	A	15	9	24	0	1	25	0	0
20	54286635	.	A	G	31	11	42	0	1	43	0	0
20	54286666	.	C	T	25	18	43	0	0	43	0	0
20	54286682	.	G	A	20	16	36	0	4	40	0	0
20	54286797	.	G	T	11	9	20	0	1	21	0	0
20	54286798	.	A	G	10	9	19	0	1	20	0	0
20	54286858	.	C	A	1	1	2	0	1	3	0	0
20	54334478	.	C	T	3	2	5	0	0	5	0	0
20	54340018	.	G	C	1	2	3	0	0	3	0	0
20	54340285	.	C	T	6	4	10	0	0	10	0	0
20	54341082	.	A	C	1	5	6	0	0	6	0	0
20	54341108	.	G	T	0	1	1	0	2	3	0	0
20	54341203	.	T	A	2	2	4	0	0	4	0	0
20	54342589	.	A	T	3	4	7	0	0	7	0	0
20	54343496	.	G	A	3	5	8	0	1	9	0	0
20	54343566	.	G	C	0	9	9	0	3	12	0	0
20	54343639	.	C	A	2	3	5	0	0	5	0	0
20	54343866	.	G	A	4	5	9	0	2	11	0	0
20	54343928	.	A	G	5	3	8	0	0	8	0	0
20	54344711	.	A	G	7	0	7	0	9	16	0	0
20	54344748	.	T	C	7	7	14	0	3	17	0	0
20	54344795	.	G	A	5	12	17	0	1	18	0	0
20	54344815	.	G	T	2	16	18	0	0	18	0	0
20	54344910	.	C	T	4	2	6	0	1	7	0	0
20	54345226	.	C	T	1	2	3	0	0	3	0	0
20	54345955	.	A	T	15	11	26	0	2	28	0	0
20	54345979	.	A	G	20	11	31	1	1	33	0	0
20	54346012	.	G	C	3	8	11	1	20	38	6	0
20	54346124	.	A	T	15	9	24	0	2	26	0	0
20	54346159	.	G	T	2	18	20	0	15	35	0	0
20	54346178	.	G	T	18	13	31	0	1	32	0	0
20	54346239	.	A	G	9	11	20	0	1	21	0	0
20	54356452	.	G	C	20	13	33	0	3	36	0	0
20	54357955	.	C	T	14	11	25	0	0	25	0	0
20	54358656	.	T	C	2	3	5	0	0	5	0	0
20	54360143	.	G	A	4	5	9	0	0	9	0	0
20	54360148	.	G	T	0	5	5	0	3	8	0	0
20	54384628	.	T	C	2	3	5	0	0	5	0	0
20	54397812	.	T	C	2	3	5	0	0	5	0	0
20	54398242	.	C	T	3	2	5	0	0	5	0	0
20	54398380	.	T	A	6	3	9	0	0	9	0	0
20	54398443	.	A	G	3	3	6	0	0	6	0	0
20	54402157	.	G	T	1	10	11	0	4	15	0	0
20	54402346	.	G	A	6	5	11	0	0	11	0	0
20	54402489	.	G	A	12	12	24	0	0	24	0	0
20	54406699	.	A	T	11	7	18	0	2	20	0	0
20	54406813	.	A	G	8	16	24	0	1	25	0	0
20	54407401	.	G	C	17	23	40	0	3	43	0	0
20	54407456	.	T	C	13	20	33	0	0	33	0	0
20	54407556	.	C	T	14	5	19	0	1	20	0	0
20	54422636	.	G	A	16	29	45	1	0	46	0	0
20	54422780	.	C	G	10	10	20	0	1	21	0	0
20	54422830	.	T	C	23	1	24	0	7	31	0	0
20	54422909	.	C	T	8	24	32	0	0	32	0	0
20	54422929	.	G	A	8	21	29	0	0	29	0	0
20	54423005	.	T	C	15	12	27	0	0	27	0	0
20	54423027	.	C	G	18	14	32	0	0	32	0	0
20	54428696	.	A	G	5	10	15	0	1	16	0	0
20	54432835	.	T	C	8	0	8	0	13	21	0	0
20	54432855	.	T	C	9	0	9	0	10	19	0	0
20	54434895	.	G	A	10	17	27	0	4	31	0	0
20	54434918	.	C	T	10	11	21	0	4	25	0	0
20	54441757	.	A	C	27	36	63	0	3	66	0	0
20	54446877	.	G	A	26	23	49	0	0	49	0	0
20	54462151	.	G	C	15	14	29	0	2	31	0	0
20	54512339	.	G	A	2	4	6	0	0	6	0	0
20	54525439	.	T	C	7	4	11	0	0	11	0	0
20	54563425	.	A	G	6	10	16	0	0	16	0	0
20	54563722	.	C	A	0	3	3	0	2	5	0	0
20	54670746	.	T	C	3	2	5	0	0	5	0	0
20	54670836	.	C	G	4	2	6	0	0	6	0	0
20	54670966	.	A	G	5	4	9	0	1	10	0	0
20	54670984	.	T	A	4	6	10	0	0	10	0	0
20	54671032	.	A	C	3	4	7	0	1	8	0	0
20	54671864	.	T	G	3	3	6	0	0	6	0	0
20	54671989	.	G	A	1	3	4	0	5	9	0	0
20	54672009	.	A	C	5	4	9	0	0	9	0	0
20	54672839	.	A	G	4	0	4	0	7	11	0	0
20	54672869	.	T	C	5	8	13	0	0	13	0	0
20	54672891	.	T	C	5	7	12	0	1	13	0	0
20	54672974	.	G	A	0	7	7	0	7	14	0	0
20	54673175	.	T	C	2	9	11	0	1	12	0	0
20	54673198	.	T	A	3	7	10	0	1	11	0	0
20	54675294	.	T	C	5	7	12	0	1	13	0	0
20	54675308	.	C	G	4	0	4	0	11	15	0	0
20	54675356	.	C	T	7	14	21	0	2	23	0	0
20	54675391	.	T	C	1	15	16	0	3	19	0	0
20	54681734	.	G	A	6	17	23	0	1	24	0	0
20	54681797	.	T	A	7	15	22	0	0	23	1	0
20	54681944	.	A	T	14	7	21	0	1	22	0	0
20	54698791	.	C	T	1	3	4	0	0	4	0	0
20	54708193	.	T	C	3	6	9	0	0	9	0	0
20	54708277	.	G	A	0	2	2	0	3	5	0	0
20	54711535	.	G	C	2	5	7	0	0	7	0	0
20	54738249	.	C	G	2	2	4	1	0	5	0	0
20	54740904	.	G	A	12	7	19	0	0	19	0	0
20	54740907	.	A	G	12	0	12	0	7	19	0	0
20	54740955	.	C	T	8	5	13	0	1	14	0	0
20	54740976	.	G	T	0	8	8	0	8	16	0	0
20	54741763	.	G	A	4	5	9	0	1	10	0	0
20	54742641	.	C	G	15	8	23	0	2	25	0	0
20	54742714	.	C	T	8	7	15	0	2	17	0	0
20	54742912	.	A	C	7	5	12	0	1	13	0	0
20	54743492	.	A	G	22	6	28	2	0	30	0	0
20	54743565	.	T	C	14	15	29	3	2	34	0	0
20	54743917	.	G	A	33	9	42	0	2	44	0	0
20	54743937	.	C	T	32	9	41	0	1	42	0	0
20	54743981	.	A	G	20	0	20	0	8	28	0	0
20	54744230	.	C	T	21	20	41	0	1	42	0	0
20	54744314	.	A	G	26	1	27	0	19	46	0	0
20	54744363	.	A	G	27	1	28	0	18	46	0	0
20	54744419	.	A	G	23	20	43	1	0	44	0	0
20	54744451	.	A	G	33	9	42	1	0	43	0	0
21	734962	.	A	G	13	0	13	0	21	34	0	0
21	735222	.	A	G	39	0	39	0	30	69	0	0
21	965591	.	T	C	3	3	6	0	0	6	0	0
21	1991007	.	G	T	11	10	21	0	0	21	0	0
21	1991097	.	A	G	14	8	22	0	0	22	0	0
21	1991118	.	G	A	14	6	20	0	1	21	0	0
21	1991160	.	G	A	14	5	19	0	2	21	0	0
21	1996944	.	T	C	7	7	14	0	1	15	0	0
21	2014639	.	G	A	5	5	10	0	0	10	0	0
21	2025607	.	C	T	3	2	5	0	0	5	0	0
21	2031843	.	A	G	2	3	5	0	0	5	0	0
21	2031849	.	A	G	2	2	4	0	0	4	0	0
21	2119814	.	G	A	4	2	6	0	0	6	0	0
21	2119973	.	G	T	1	2	3	0	0	3	0	0
21	2120061	.	C	G	0	2	2	0	3	5	0	0
21	2120073	.	G	A	2	3	5	0	0	5	0	0
21	2171521	.	T	C	1	4	5	0	0	5	0	0
21	2171532	.	T	C	0	4	4	0	0	4	0	0
21	2738221	.	C	T	12	6	18	0	0	18	0	0
21	2932299	.	T	C	1	3	4	0	0	4	0	0
21	2932405	.	G	T	2	2	4	0	0	4	0	0
21	2932448	.	T	C	4	5	9	0	0	9	0	0
21	2949336	.	G	A	2	3	5	0	0	5	0	0
21	2949352	.	C	A	0	3	3	0	2	5	0	0
21	2949528	.	C	T	0	2	2	0	5	7	0	0
21	2949861	.	A	G	1	4	5	0	0	5	0	0
21	2949945	.	G	A	1	2	3	0	0	3	0	0
21	3422565	.	T	G	7	10	17	0	3	20	0	0
21	3452462	.	A	G	4	3	7	0	0	7	0	0
21	3478014	.	A	G	1	2	3	0	0	3	0	0
21	3485351	.	T	C	5	0	5	0	6	11	0	0
21	3536050	.	A	G	2	2	4	0	0	4	0	0
21	3536056	.	T	A	1	2	3	0	0	3	0	0
21	3567722	.	A	G	2	2	4	0	0	4	0	0
21	3715986	.	T	A	4	4	8	0	0	8	0	0
21	3715989	.	A	G	4	4	8	0	0	8	0	0
21	3716058	.	T	A	3	7	10	0	0	10	0	0
21	3716732	.	G	T	7	10	17	0	0	17	0	0
21	3716930	.	G	A	9	9	18	0	1	19	0	0
21	3717055	.	G	A	7	11	18	0	0	18	0	0
21	3786377	.	C	T	5	6	11	0	0	11	0	0
21	3789871	.	A	G	9	2	11	0	2	13	0	0
21	3789922	.	T	A	20	12	32	0	2	34	0	0
21	3789930	.	C	T	24	12	36	0	1	37	0	0
21	3789998	.	A	G	15	22	37	0	2	39	0	0
21	3793211	.	G	A	15	19	34	0	1	35	0	0
21	3793309	.	T	C	13	18	31	0	0	31	0	0
21	3793413	.	C	T	16	24	40	0	0	40	0	0
21	3796376	.	G	T	15	11	26	0	4	30	0	0
21	3796398	.	G	T	13	6	19	0	2	21	0	0
21	3822827	.	T	G	1	3	4	0	0	4	0	0
21	3918186	.	G	A	6	3	9	0	1	10	0	0
21	3961084	.	A	C	1	2	3	0	0	3	0	0
21	3972766	.	G	A	5	3	8	0	0	8	0	0
21	3995529	.	A	G	6	4	10	0	3	13	0	0
21	4025201	.	T	A	4	4	8	0	0	8	0	0
21	4219400	.	T	A	5	2	7	0	0	7	0	0
21	4219450	.	C	T	4	2	6	0	0	6	0	0
21	4219518	.	C	T	4	4	8	0	0	8	0	0
21	4227788	.	G	A	6	2	8	0	0	8	0	0
21	4228026	.	G	A	6	2	8	0	0	8	0	0
21	4237466	.	T	A	1	2	3	0	1	4	0	0
21	4247684	.	A	G	7	4	11	0	1	12	0	0
21	4250360	.	T	C	5	4	9	0	0	9	0	0
21	4250401	.	C	T	6	5	11	0	1	12	0	0
21	4250463	.	G	C	2	5	7	0	0	7	0	0
21	4250465	.	T	G	1	5	6	0	1	7	0	0
21	4250583	.	C	A	2	2	4	0	0	4	0	0
21	4250596	.	C	T	1	3	4	0	1	5	0	0
21	4250634	.	G	A	1	2	3	0	0	3	0	0
21	4250642	.	T	A	1	2	3	0	0	3	0	0
21	4518530	.	A	G	4	2	6	0	0	6	0	0
21	4573597	.	A	G	1	2	3	0	0	3	0	0
21	4576310	.	G	C	2	2	4	0	0	4	0	0
21	4576319	.	G	C	0	2	2	0	2	4	0	0
21	4578137	.	G	A	0	2	2	0	1	3	0	0
21	4583663	.	A	G	1	0	1	0	3	4	0	0
21	4585012	.	A	C	1	4	5	0	1	6	0	0
21	4585027	.	A	G	2	0	2	0	2	4	0	0
21	4589826	.	A	G	1	4	5	0	0	5	0	0
21	4591407	.	C	G	4	6	10	0	0	10	0	0
21	4591410	.	A	T	3	6	9	0	1	10	0	0
21	4591443	.	A	G	1	3	4	0	0	4	0	0
21	4593008	.	A	T	3	3	6	0	0	6	0	0
21	4596883	.	G	T	7	6	13	0	1	14	0	0
21	4596970	.	A	G	3	7	10	0	1	11	0	0
21	4600889	.	A	G	4	0	4	0	12	16	0	0
21	4603372	.	C	T	7	12	19	0	0	19	0	0
21	4712490	.	C	T	8	4	12	1	1	14	0	0
21	4712499	.	A	T	5	2	7	1	0	8	0	0
21	4712743	.	A	G	4	5	9	0	0	9	0	0
21	4712756	.	T	C	6	0	6	0	4	10	0	0
21	4713252	.	T	C	16	0	16	0	6	22	0	0
21	4718518	.	G	A	10	10	20	0	1	21	0	0
21	4720325	.	C	T	6	9	15	0	1	16	0	0
21	4723670	.	G	A	5	5	10	0	0	10	0	0
21	4724351	.	C	T	0	2	2	0	2	4	0	0
21	4724428	.	A	G	2	2	4	0	0	4	0	0
21	4724810	.	T	C	2	2	4	0	0	4	0	0
21	4729876	.	G	A	2	5	7	0	0	7	0	0
21	5034630	.	A	T	2	4	6	0	0	6	0	0
21	5034791	.	G	A	1	3	4	0	1	5	0	0
21	5034793	.	A	C	1	3	4	0	1	5	0	0
21	5159695	.	T	C	6	6	12	0	0	12	0	0
21	5160428	.	G	A	6	4	10	0	0	10	0	0
21	5162305	.	T	A	1	2	3	0	1	4	0	0
21	5169217	.	T	A	18	14	32	0	0	32	0	0
21	5171036	.	C	T	20	30	50	0	2	52	0	0
21	5173402	.	T	G	39	2	41	0	27	68	0	0
21	5173447	.	C	T	33	29	62	0	4	66	0	0
21	5173638	.	T	C	34	25	59	1	0	60	0	0
21	5199875	.	G	A	41	29	70	0	2	72	0	0
21	5200683	.	C	T	36	32	68	0	1	69	0	0
21	5240259	.	C	T	2	8	10	0	0	10	0	0
21	5368346	.	G	A	4	3	7	0	2	9	0	0
21	5368417	.	C	T	0	13	13	0	8	21	0	0
21	5368461	.	C	T	2	15	17	0	11	28	0	0
21	5368510	.	C	T	0	10	10	0	12	22	0	0
21	5370451	.	T	A	1	4	5	0	1	6	0	0
21	5372598	.	G	A	2	3	5	0	0	5	0	0
21	5372673	.	G	A	5	2	7	0	0	7	0	0
21	5374209	.	C	T	0	2	2	0	5	7	0	0
21	5376720	.	A	C	0	3	3	0	1	4	0	0
21	5781134	.	C	T	36	36	72	0	3	75	0	0
21	5782043	.	T	C	34	2	36	0	36	72	0	0
21	5789938	.	G	A	29	27	56	0	1	57	0	0
21	5796060	.	T	C	29	23	52	1	4	57	0	0
21	5797960	.	T	C	38	18	56	0	3	59	0	0
21	5798978	.	T	A	19	22	41	0	1	42	0	0
21	5803474	.	C	T	7	5	12	0	0	12	0	0
21	5803495	.	T	C	6	3	9	0	2	11	0	0
21	5803546	.	G	A	2	4	6	0	0	6	0	0
21	5807177	.	A	C	12	4	16	0	1	17	0	0
21	5884836	.	G	A	2	24	26	0	27	53	0	0
21	5884897	.	T	A	31	30	61	0	0	61	0	0
21	5884945	.	G	A	27	27	54	0	1	55	0	0
21	5920426	.	C	T	2	2	4	0	0	4	0	0
21	5938364	.	T	C	2	2	4	0	0	4	0	0
21	5942661	.	G	T	13	6	19	0	0	19	0	0
21	5942868	.	T	G	7	12	19	0	2	22	1	0
21	5942906	.	C	A	17	5	22	0	0	22	0	0
21	5942927	.	C	T	6	11	17	0	0	17	0	0
21	5971839	.	A	T	7	6	13	0	0	13	0	0
21	5971949	.	A	T	6	5	11	0	0	11	0	0
21	5971983	.	C	T	8	9	17	0	1	18	0	0
21	5972087	.	G	T	1	6	7	0	18	25	0	0
21	5972092	.	T	C	18	5	23	0	0	23	0	0
21	5972252	.	A	G	11	7	18	0	2	20	0	0
21	5972543	.	C	T	6	4	10	0	0	10	0	0
21	6133407	.	G	A	2	2	4	0	0	4	0	0
21	6133434	.	G	A	0	2	2	0	2	4	0	0
21	6133588	.	T	C	3	6	9	0	0	9	0	0
21	6134098	.	A	T	2	3	5	0	0	5	0	0
21	6134234	.	T	C	4	5	9	0	0	9	0	0
21	6134238	.	G	T	0	5	5	1	3	9	0	0
21	6134276	.	A	T	2	2	4	1	0	5	0	0
21	6134289	.	G	A	4	2	6	1	0	7	0	0
21	6134314	.	A	G	4	0	4	0	3	7	0	0
21	6134348	.	A	T	2	5	7	0	1	8	0	0
21	6145991	.	G	A	3	11	14	0	1	15	0	0
21	6148091	.	G	A	1	13	14	0	8	22	0	0
21	6149938	.	T	C	21	15	36	0	1	37	0	0
21	6150113	.	T	A	6	6	12	0	0	12	0	0
21	6212959	.	C	T	1	2	3	0	0	3	0	0
21	6414807	.	C	T	1	2	3	0	0	3	0	0
21	7570704	.	C	T	1	8	9	0	0	9	0	0
21	7758409	.	C	T	1	7	8	0	0	8	0	0
21	8343954	.	T	C	11	4	15	0	0	15	0	0
21	8344326	.	T	C	17	16	33	0	2	35	0	0
21	8346125	.	T	C	13	12	25	1	1	27	0	0
21	8347256	.	C	T	28	18	46	0	2	48	0	0
21	8348920	.	G	A	3	24	27	0	14	41	0	0
21	8348959	.	T	C	14	17	31	0	0	31	0	0
21	8348980	.	A	G	13	12	25	0	1	26	0	0
21	8348998	.	T	C	13	13	26	0	1	27	0	0
21	8352010	.	T	A	10	11	21	0	0	21	0	0
21	8454802	.	T	C	2	2	4	0	0	4	0	0
21	9370684	.	C	T	0	4	4	0	9	13	0	0
21	9370780	.	G	A	10	6	16	0	0	16	0	0
21	9391712	.	C	T	0	5	5	0	4	9	0	0
21	9391847	.	A	C	2	0	2	0	4	6	0	0
21	9399918	.	G	C	1	3	4	0	0	4	0	0
21	9401182	.	T	A	1	2	3	0	0	3	0	0
21	9401191	.	C	T	1	3	4	0	1	5	0	0
21	9401649	.	T	C	1	2	3	0	0	3	0	0
21	9987496	.	T	A	4	2	6	0	0	6	0	0
21	9989373	.	A	G	5	5	10	0	3	13	0	0
21	10715855	.	T	C	4	3	7	0	0	7	0	0
21	10729109	.	C	T	9	5	14	0	0	14	0	0
21	10731101	.	A	G	12	9	21	0	2	23	0	0
21	10731133	.	A	G	11	8	19	0	3	22	0	0
21	10731142	.	G	C	10	9	19	0	2	21	0	0
21	10892031	.	A	G	4	4	8	0	0	8	0	0
21	11135186	.	C	T	4	2	6	0	0	6	0	0
21	11135188	.	T	G	4	2	6	0	0	6	0	0
21	11135721	.	G	A	1	2	3	0	0	3	0	0
21	11180201	.	T	C	7	7	14	0	1	15	0	0
21	11180215	.	C	T	7	9	16	0	0	16	0	0
21	11182127	.	G	T	4	4	8	0	0	8	0	0
21	11188405	.	A	G	1	1	2	0	1	3	0	0
21	11189725	.	C	T	2	2	4	0	0	4	0	0
21	11191971	.	A	T	1	2	3	0	0	3	0	0
21	11193317	.	A	G	2	2	4	0	0	4	0	0
21	11330241	.	C	T	0	2	2	0	1	3	0	0
21	11330252	.	C	A	1	2	3	0	0	3	0	0
21	11330670	.	T	A	7	6	13	0	1	14	0	0
21	11330903	.	T	G	5	2	7	0	1	8	0	0
21	11339704	.	T	C	4	3	7	0	0	7	0	0
21	11339710	.	T	C	4	0	4	0	3	7	0	0
21	11339790	.	A	C	8	3	11	0	0	11	0	0
21	11339795	.	T	C	7	2	9	0	0	9	0	0
21	11354077	.	A	G	1	2	3	0	1	4	0	0
21	11380368	.	A	G	3	3	6	0	0	6	0	0
21	11382887	.	C	T	5	12	17	0	1	18	0	0
21	11382899	.	T	C	6	10	16	0	0	16	0	0
21	11415494	.	G	A	0	4	4	0	1	5	0	0
21	11425152	.	C	T	7	6	13	0	1	14	0	0
21	11425182	.	G	A	9	5	14	0	1	15	0	0
21	11425218	.	T	C	4	4	8	0	0	8	0	0
21	11427850	.	T	C	5	6	11	0	1	12	0	0
21	11431070	.	G	T	5	4	9	0	2	11	0	0
21	11434022	.	C	A	10	21	31	0	3	34	0	0
21	11434116	.	T	C	9	12	21	0	4	25	0	0
21	11468957	.	A	C	1	7	8	0	0	8	0	0
21	11469119	.	A	G	5	8	13	0	0	13	0	0
21	11477418	.	A	G	3	0	3	0	3	6	0	0
21	11477496	.	T	C	4	7	11	0	1	12	0	0
21	11486933	.	T	C	6	9	15	0	0	15	0	0
21	11492826	.	C	T	13	31	44	0	1	45	0	0
21	11493661	.	A	G	35	11	46	0	0	46	0	0
21	11494536	.	A	G	25	0	25	0	34	59	0	0
21	11501618	.	T	A	16	20	36	0	0	36	0	0
21	11501665	.	C	T	21	18	39	0	2	41	0	0
21	11501975	.	A	G	41	11	52	0	0	52	0	0
21	11502120	.	T	C	31	23	54	0	8	62	0	0
21	11502143	.	A	G	21	31	52	0	5	57	0	0
21	11502807	.	G	T	3	23	26	0	24	50	0	0
21	11527950	.	A	G	2	0	2	0	3	5	0	0
21	11527977	.	C	T	3	2	5	0	1	6	0	0
21	11528094	.	G	A	4	3	7	0	0	7	0	0
21	11566285	.	T	G	1	4	5	0	0	5	0	0
21	11566478	.	G	T	4	6	10	0	2	12	0	0
21	11571108	.	G	A	2	2	4	0	0	4	0	0
21	11571147	.	T	C	4	4	8	0	0	8	0	0
21	11571159	.	G	T	5	4	9	0	0	9	0	0
21	11571279	.	C	G	3	3	6	0	0	6	0	0
21	11571287	.	T	A	4	3	7	0	0	7	0	0
21	11571353	.	G	A	3	5	8	0	1	9	0	0
21	11575748	.	G	A	2	3	5	0	0	5	0	0
21	11579624	.	T	C	1	2	3	0	0	3	0	0
21	11713042	.	G	A	0	2	2	0	3	5	0	0
21	11718420	.	T	C	4	5	9	0	0	9	0	0
21	11721984	.	A	G	2	0	2	0	3	5	0	0
21	11774398	.	T	G	3	0	3	0	3	6	0	0
21	11774860	.	C	T	1	3	4	0	0	4	0	0
21	11781541	.	A	G	9	3	12	0	0	12	0	0
21	11791948	.	G	A	4	2	6	0	0	6	0	0
21	11799553	.	A	G	1	2	3	0	0	3	0	0
21	11869420	.	T	A	9	3	12	0	0	12	0	0
21	11869495	.	C	A	4	4	8	0	1	9	0	0
21	11869774	.	G	C	0	5	5	0	2	7	0	0
21	11869870	.	C	T	9	9	18	0	0	18	0	0
21	11880927	.	G	A	7	9	16	0	1	17	0	0
21	11880996	.	G	A	6	11	17	0	3	20	0	0
21	11881129	.	G	C	8	6	14	0	0	14	0	0
21	11881140	.	C	T	11	7	18	0	1	19	0	0
21	11881344	.	G	A	15	7	22	0	0	22	0	0
21	11881715	.	C	T	14	10	24	0	1	25	0	0
21	11882687	.	C	A	1	2	3	0	0	3	0	0
21	11882712	.	A	G	1	2	3	0	0	3	0	0
21	11883984	.	C	A	4	8	12	0	0	12	0	0
21	11883991	.	A	T	4	9	13	0	0	13	0	0
21	11911722	.	A	T	6	6	12	0	1	13	0	0
21	11911730	.	A	T	7	6	13	0	1	14	0	0
21	11911921	.	C	T	9	8	17	0	1	18	0	0
21	11927809	.	G	C	0	3	3	0	2	5	0	0
21	11937522	.	A	G	3	5	8	0	1	9	0	0
21	11942334	.	T	C	14	8	22	0	2	24	0	0
21	11942407	.	T	C	6	12	18	0	1	19	0	0
21	11945863	.	C	T	14	8	22	0	1	23	0	0
21	11946133	.	C	T	14	8	22	0	0	22	0	0
21	11949317	.	C	T	9	11	20	0	1	21	0	0
21	11950217	.	C	A	12	13	25	0	0	25	0	0
21	11955208	.	A	C	9	7	16	0	12	28	0	0
21	11958852	.	A	T	13	18	31	0	1	32	0	0
21	11958928	.	A	G	10	14	24	0	1	25	0	0
21	11958971	.	G	T	8	10	18	0	2	20	0	0
21	11958982	.	C	T	8	11	19	0	2	21	0	0
21	11959034	.	G	A	10	15	25	0	4	29	0	0
21	11959061	.	T	G	8	15	23	0	1	24	0	0
21	11959185	.	A	G	21	20	41	0	3	44	0	0
21	11959309	.	T	C	19	19	38	0	2	40	0	0
21	11961122	.	C	T	16	15	31	1	0	32	0	0
21	11963778	.	C	A	6	11	17	0	1	18	0	0
21	11965035	.	T	G	4	4	8	0	0	8	0	0
21	11967077	.	T	C	4	5	9	0	1	10	0	0
21	11967857	.	A	C	2	6	8	0	1	9	0	0
21	11970139	.	C	T	0	6	6	0	7	13	0	0
21	12023880	.	A	C	2	5	7	0	2	9	0	0
21	12028080	.	G	A	15	11	26	0	0	26	0	0
21	12036013	.	C	T	1	5	6	0	1	7	0	0
21	12041221	.	T	C	1	2	3	0	0	3	0	0
21	12058705	.	C	T	4	3	7	0	0	7	0	0
21	12073880	.	G	A	0	4	4	0	3	7	0	0
21	12073944	.	T	C	3	2	5	0	0	5	0	0
21	12080051	.	C	G	1	21	22	0	12	34	0	0
21	12095798	.	A	G	5	6	11	0	1	12	0	0
21	12272375	.	T	G	4	2	6	0	0	6	0	0
21	13193928	.	C	T	11	12	23	0	2	25	0	0
21	13329495	.	C	T	11	16	27	0	2	29	0	0
21	13360446	.	C	T	2	3	5	0	0	5	0	0
21	13362830	.	A	C	5	5	10	0	0	10	0	0
21	13362896	.	C	T	7	5	12	0	0	12	0	0
21	13364790	.	T	A	4	6	10	0	0	10	0	0
21	13364802	.	T	C	5	4	9	0	0	9	0	0
21	13383483	.	T	C	2	2	4	0	0	4	0	0
21	13389877	.	G	T	1	2	3	0	0	3	0	0
21	13389943	.	G	A	0	2	2	0	3	5	0	0
21	13410331	.	A	G	5	8	13	0	1	14	0	0
21	13431198	.	G	A	6	10	16	0	1	17	0	0
21	13431261	.	G	C	6	9	15	0	1	16	0	0
21	13431309	.	A	G	7	0	7	0	6	13	0	0
21	13431363	.	A	T	7	4	11	0	0	11	0	0
21	13431379	.	T	A	3	3	6	0	0	6	0	0
21	13431573	.	T	C	3	4	7	0	0	7	0	0
21	13431620	.	T	C	2	3	5	0	0	5	0	0
21	13431639	.	C	T	4	3	7	0	0	7	0	0
21	13431668	.	T	A	2	2	4	0	0	4	0	0
21	13431697	.	C	A	2	3	5	0	0	5	0	0
21	13431924	.	A	G	2	4	6	0	0	6	0	0
21	13431947	.	A	T	5	3	8	0	0	8	0	0
21	13432049	.	A	G	10	8	18	0	0	18	0	0
21	13432071	.	A	C	6	10	16	0	0	16	0	0
21	13432315	.	T	C	11	14	25	0	1	26	0	0
21	13432369	.	C	A	14	6	20	0	3	23	0	0
21	13796850	.	A	G	4	0	4	0	2	6	0	0
21	13909005	.	T	C	23	26	49	0	1	50	0	0
21	13919482	.	C	T	9	17	26	0	5	31	0	0
21	13919498	.	C	A	12	14	26	0	4	30	0	0
21	13920204	.	G	C	3	33	36	0	31	67	0	0
21	13920308	.	C	T	35	30	65	0	11	76	0	0
21	13920510	.	G	A	5	37	42	0	34	76	0	0
21	13920648	.	G	A	4	37	41	0	27	68	0	0
21	13924122	.	T	A	2	3	5	0	0	5	0	0
21	13980445	.	T	A	5	10	15	0	1	16	0	0
21	13980490	.	T	C	7	3	10	0	0	10	0	0
21	13980516	.	G	A	6	3	9	0	0	9	0	0
21	13980628	.	G	T	6	3	9	0	1	10	0	0
21	13980743	.	A	G	4	3	7	0	0	7	0	0
21	13981564	.	C	T	0	3	3	0	2	5	0	0
21	13981620	.	C	T	0	3	3	0	4	7	0	0
21	13983649	.	G	T	2	5	7	0	0	7	0	0
21	13983757	.	G	A	1	2	3	0	0	3	0	0
21	14217519	.	C	A	3	5	8	1	0	9	0	0
21	14217595	.	T	C	11	4	15	0	1	16	0	0
21	14217612	.	T	C	11	0	11	0	13	24	0	0
21	14217657	.	T	G	20	12	32	0	1	33	0	0
21	14217664	.	T	C	14	0	14	0	19	33	0	0
21	14217762	.	G	T	7	6	13	0	0	13	0	0
21	14224135	.	A	T	6	4	10	0	1	11	0	0
21	14224168	.	C	T	3	5	8	0	2	10	0	0
21	14226571	.	T	A	6	4	10	0	2	12	0	0
21	14226601	.	C	T	1	9	10	0	6	16	0	0
21	14226685	.	C	T	9	4	13	0	0	13	0	0
21	14232498	.	G	A	4	2	6	0	0	6	0	0
21	14239988	.	C	T	2	2	4	0	0	4	0	0
21	14240025	.	G	T	3	3	6	0	0	6	0	0
21	14240037	.	C	T	1	5	6	0	0	6	0	0
21	14241936	.	C	A	1	3	4	0	0	4	0	0
21	14250993	.	T	C	1	3	4	0	0	4	0	0
21	14254590	.	T	A	1	3	4	0	0	4	0	0
21	14381740	.	A	T	1	2	3	0	0	3	0	0
21	14644558	.	G	A	6	11	17	0	3	20	0	0
21	14644567	.	G	A	3	7	10	0	2	12	0	0
21	14644702	.	A	T	7	11	18	0	1	19	0	0
21	14644814	.	C	T	10	12	22	0	0	22	0	0
21	14644917	.	T	G	9	16	25	0	1	26	0	0
21	14644949	.	C	T	2	16	18	0	5	23	0	0
21	14644981	.	G	C	12	5	17	0	1	18	0	0
21	14645399	.	C	T	8	9	17	0	3	20	0	0
21	14645401	.	C	T	8	11	19	0	1	20	0	0
21	14645490	.	C	T	6	6	12	0	0	12	0	0
21	14645574	.	C	T	3	10	13	0	0	13	0	0
21	14645641	.	C	A	5	10	15	0	0	15	0	0
21	14645642	.	A	C	3	9	12	0	2	14	0	0
21	14645724	.	G	T	8	18	26	0	3	29	0	0
21	14645728	.	A	G	8	19	27	0	1	28	0	0
21	14645873	.	C	T	13	15	28	0	1	29	0	0
21	14660057	.	C	A	1	2	3	0	0	3	0	0
21	14663911	.	T	C	1	2	3	0	0	3	0	0
21	14701803	.	G	A	2	3	5	0	2	7	0	0
21	14701890	.	A	G	4	5	9	0	2	11	0	0
21	14701953	.	T	C	1	0	1	0	3	4	0	0
21	14704871	.	G	A	3	5	8	0	0	8	0	0
21	14810988	.	T	C	3	3	6	0	0	6	0	0
21	14812964	.	G	A	4	4	8	0	0	8	0	0
21	14813064	.	A	G	3	3	6	0	0	6	0	0
21	14813282	.	C	G	11	6	17	0	0	17	0	0
21	14813380	.	G	C	4	5	9	0	0	9	0	0
21	14813402	.	T	A	3	5	8	0	0	8	0	0
21	14813479	.	T	C	8	0	8	0	3	11	0	0
21	14815804	.	A	G	3	5	8	0	0	8	0	0
21	14817351	.	G	A	1	2	3	0	0	3	0	0
21	14819421	.	C	G	0	3	3	0	6	9	0	0
21	14819766	.	G	A	3	2	5	0	1	6	0	0
21	14825952	.	T	C	1	2	3	0	0	3	0	0
21	14828692	.	C	T	3	4	7	0	3	10	0	0
21	14828722	.	A	C	5	5	10	0	0	10	0	0
21	14828935	.	T	C	5	3	8	0	1	9	0	0
21	14829081	.	C	A	0	4	4	0	2	6	0	0
21	14829091	.	G	A	3	3	6	0	1	7	0	0
21	14829145	.	A	G	4	2	6	0	0	6	0	0
21	14842944	.	T	C	5	3	8	0	0	8	0	0
21	14843085	.	C	T	2	4	6	0	1	7	0	0
21	14846607	.	T	C	1	3	4	0	0	4	0	0
21	15125603	.	A	C	12	1	13	0	1	14	0	0
21	15125661	.	G	A	29	10	39	0	2	41	0	0
21	15125667	.	G	A	31	9	40	0	1	41	0	0
21	15125825	.	T	C	19	0	19	0	13	32	0	0
21	15125859	.	T	C	16	19	35	0	0	35	0	0
21	15125867	.	C	T	15	20	35	0	1	36	0	0
21	15126048	.	G	A	25	18	43	0	1	44	0	0
21	15126068	.	G	T	22	14	36	0	0	36	0	0
21	15126088	.	G	A	18	13	31	0	1	32	0	0
21	15154547	.	A	T	18	15	33	1	1	35	0	0
21	15154625	.	A	G	21	13	34	0	3	38	1	0
21	15230556	.	C	T	0	7	7	0	20	27	0	0
21	15234284	.	T	A	16	20	36	0	3	39	0	0
21	15252402	.	G	A	15	18	33	0	0	33	0	0
21	15252491	.	C	A	1	7	8	0	16	24	0	0
21	15263962	.	C	T	1	8	9	0	13	22	0	0
21	16308823	.	C	T	1	6	7	0	0	7	0	0
21	17246756	.	G	A	4	4	8	0	0	8	0	0
21	17253268	.	A	G	2	5	7	0	0	7	0	0
21	17255815	.	C	G	2	2	4	0	0	4	0	0
21	17256590	.	A	C	11	4	15	0	1	16	0	0
21	17256656	.	A	G	5	5	10	0	0	10	0	0
21	17258362	.	A	G	3	4	7	0	0	7	0	0
21	17258421	.	T	A	5	7	12	0	0	12	0	0
21	17258486	.	C	T	4	6	10	0	0	10	0	0
21	17258576	.	T	G	2	3	5	0	1	6	0	0
21	17258670	.	A	G	6	0	6	0	3	9	0	0
21	17258771	.	G	A	0	5	5	0	9	14	0	0
21	17258784	.	A	C	7	5	12	0	1	13	0	0
21	17259081	.	C	G	3	4	7	0	0	7	0	0
21	17259279	.	G	T	1	5	6	0	8	14	0	0
21	17259332	.	T	C	9	9	18	0	1	19	0	0
21	17259466	.	A	T	8	13	21	0	2	23	0	0
21	17260532	.	C	G	8	11	19	0	1	20	0	0
21	17322472	.	G	A	0	2	2	0	3	5	0	0
21	17322478	.	C	A	3	2	5	0	0	5	0	0
21	17325413	.	G	A	1	4	5	0	0	5	0	0
21	17325965	.	G	A	3	2	5	0	0	5	0	0
21	17335595	.	T	C	5	3	8	0	1	9	0	0
21	17335709	.	C	T	6	2	8	0	1	9	0	0
21	17337807	.	C	T	2	6	8	0	0	8	0	0
21	17337865	.	C	T	6	7	13	0	1	14	0	0
21	17337898	.	A	T	7	8	15	0	1	16	0	0
21	17338101	.	A	C	6	7	13	0	1	14	0	0
21	17338141	.	T	G	10	5	15	0	0	15	0	0
21	17338352	.	A	G	3	1	4	0	1	5	0	0
21	17338593	.	G	A	4	3	7	0	1	8	0	0
21	17339664	.	C	T	14	23	37	0	1	38	0	0
21	17339716	.	G	A	9	8	17	1	0	18	0	0
21	17413852	.	C	T	6	4	10	0	0	10	0	0
21	17419933	.	A	T	2	4	6	0	0	6	0	0
21	17419958	.	C	T	1	4	5	0	2	7	0	0
21	17420492	.	G	A	2	2	4	0	0	4	0	0
21	17424390	.	G	C	2	0	2	0	3	5	0	0
21	17478552	.	T	A	3	2	5	0	0	5	0	0
21	17478936	.	C	T	1	17	18	0	17	35	0	0
21	17482237	.	A	G	11	4	15	0	2	17	0	0
21	17567289	.	G	A	5	8	13	0	1	14	0	0
21	17567642	.	T	C	5	2	7	0	1	8	0	0
21	17567649	.	T	C	5	3	8	0	1	9	0	0
21	17567880	.	A	T	8	4	12	0	1	13	0	0
21	17567911	.	C	T	9	3	12	0	0	12	0	0
21	17567940	.	C	A	7	2	9	0	0	9	0	0
21	17568027	.	G	A	4	2	6	0	1	7	0	0
21	17568482	.	A	G	8	5	13	0	1	14	0	0
21	17568507	.	A	T	10	5	15	0	0	15	0	0
21	17568521	.	A	G	12	3	15	0	1	16	0	0
21	17568543	.	A	G	7	7	14	0	2	16	0	0
21	17568655	.	G	A	1	10	11	0	10	21	0	0
21	17568819	.	G	A	2	4	6	0	7	13	0	0
21	17568825	.	T	A	7	4	11	0	0	11	0	0
21	17569131	.	A	G	6	5	11	1	1	13	0	0
21	17569200	.	A	G	4	7	11	0	0	11	0	0
21	17569587	.	C	A	16	13	29	0	6	35	0	0
21	17569745	.	T	A	9	13	22	0	0	22	0	0
21	17569747	.	T	A	8	13	21	0	0	21	0	0
21	17569808	.	A	C	13	8	21	0	1	22	0	0
21	17569812	.	C	G	14	6	20	0	1	21	0	0
21	17572916	.	C	T	0	3	3	0	2	5	0	0
21	17572988	.	C	A	4	4	8	0	1	9	0	0
21	17577997	.	G	C	1	0	1	0	4	5	0	0
21	17578010	.	G	T	1	4	5	0	0	5	0	0
21	17578655	.	C	T	0	5	5	0	2	7	0	0
21	17580599	.	C	T	2	2	4	0	0	4	0	0
21	17984484	.	C	A	11	14	25	0	0	25	0	0
21	17984685	.	G	A	14	8	22	0	0	22	0	0
21	17984919	.	G	A	2	5	7	0	0	7	0	0
21	17984965	.	G	A	3	4	7	0	0	7	0	0
21	17985047	.	C	T	3	4	7	0	0	7	0	0
21	18022981	.	C	T	12	4	16	0	2	18	0	0
21	18023170	.	G	T	9	17	26	0	3	29	0	0
21	18023283	.	G	A	9	8	17	0	2	19	0	0
21	18023309	.	T	G	7	7	14	0	2	16	0	0
21	18023704	.	A	G	10	7	17	0	0	17	0	0
21	18023717	.	A	G	12	8	20	0	0	20	0	0
21	18023792	.	G	T	4	6	10	0	1	11	0	0
21	18024032	.	A	C	7	4	11	0	0	11	0	0
21	18024633	.	C	T	0	7	7	0	4	11	0	0
21	18269653	.	C	T	2	10	12	0	10	22	0	0
21	18269695	.	C	T	8	7	15	0	1	16	0	0
21	18270975	.	T	C	1	0	1	0	3	4	0	0
21	18271138	.	C	T	11	15	26	0	0	26	0	0
21	18272195	.	T	C	5	2	7	0	0	7	0	0
21	18273485	.	A	T	7	2	9	0	0	9	0	0
21	18276073	.	A	G	2	0	2	0	2	4	0	0
21	18285868	.	C	T	5	6	11	0	0	11	0	0
21	18289749	.	T	C	5	15	20	0	3	23	0	0
21	18289909	.	G	C	9	8	17	0	1	18	0	0
21	18372902	.	G	A	5	5	10	1	2	13	0	0
21	18375442	.	A	G	5	3	8	0	0	8	0	0
21	18375662	.	G	A	0	6	6	0	8	14	0	0
21	18382501	.	T	C	4	4	8	0	1	9	0	0
21	18382546	.	C	T	4	4	8	0	0	8	0	0
21	18385061	.	C	T	8	8	16	0	0	16	0	0
21	18386849	.	C	T	3	5	8	0	0	8	0	0
21	18600375	.	T	A	1	2	3	0	0	3	0	0
21	18600454	.	T	C	3	6	9	0	0	9	0	0
21	18600495	.	G	A	3	7	10	0	0	10	0	0
21	18600505	.	G	A	5	5	10	0	0	10	0	0
21	18600750	.	T	A	5	5	10	0	0	10	0	0
21	18600764	.	A	G	5	5	10	0	0	10	0	0
21	18922973	.	G	A	2	3	5	0	0	5	0	0
21	18923115	.	A	G	2	3	5	0	0	5	0	0
21	18924082	.	G	A	1	4	5	0	0	5	0	0
21	18924676	.	C	T	3	2	5	0	1	6	0	0
21	18924716	.	A	G	2	0	2	0	2	4	0	0
21	18924751	.	T	C	2	2	4	0	0	4	0	0
21	18925078	.	G	A	2	4	6	0	4	10	0	0
21	18925411	.	G	C	4	3	7	0	0	7	0	0
21	18925521	.	A	G	5	5	10	0	1	11	0	0
21	18925531	.	A	G	6	5	11	0	0	11	0	0
21	18929509	.	T	C	13	11	24	0	1	25	0	0
21	18932088	.	A	G	12	11	23	0	0	23	0	0
21	18932287	.	C	T	3	7	10	0	11	21	0	0
21	18932717	.	G	A	10	9	19	0	0	19	0	0
21	18933748	.	G	T	4	8	12	0	1	13	0	0
21	18934265	.	C	A	0	9	9	0	9	18	0	0
21	18934289	.	C	T	0	5	5	0	13	18	0	0
21	18950997	.	T	G	3	4	7	0	1	8	0	0
21	18956779	.	C	T	11	8	19	0	1	20	0	0
21	18956883	.	T	A	6	5	11	0	1	12	0	0
21	18957259	.	G	A	11	13	24	0	2	26	0	0
21	18957601	.	C	G	9	9	18	0	0	18	0	0
21	18957624	.	T	C	8	9	17	0	3	20	0	0
21	18957776	.	T	C	10	12	22	0	0	22	0	0
21	19008736	.	G	A	4	4	8	0	0	8	0	0
21	19008845	.	C	T	6	6	12	0	1	13	0	0
21	19009346	.	T	C	13	15	28	0	0	28	0	0
21	19013852	.	T	A	5	4	9	0	6	15	0	0
21	19014036	.	T	G	15	18	33	0	3	36	0	0
21	19014298	.	C	T	33	24	57	0	0	57	0	0
21	19015460	.	C	A	15	10	25	0	0	25	0	0
21	19015461	.	C	A	14	9	23	0	2	25	0	0
21	19017819	.	G	A	6	17	23	0	2	25	0	0
21	19018434	.	T	A	4	9	13	0	3	16	0	0
21	19067092	.	A	G	41	42	83	0	3	86	0	0
21	19073046	.	A	T	2	4	6	0	0	6	0	0
21	19073143	.	G	T	4	3	7	0	0	7	0	0
21	19301854	.	G	A	1	2	3	0	0	3	0	0
21	19328984	.	T	A	1	2	3	0	0	3	0	0
21	19329002	.	T	A	1	2	3	0	0	3	0	0
21	19329135	.	C	T	15	10	25	0	0	25	0	0
21	19329971	.	C	G	1	7	8	0	19	27	0	0
21	19345807	.	C	T	3	3	6	0	0	6	0	0
21	19347379	.	T	G	3	2	5	0	0	5	0	0
21	19347416	.	A	G	3	3	6	0	0	6	0	0
21	19347707	.	T	G	3	2	5	0	0	5	0	0
21	19347715	.	A	C	2	2	4	0	1	5	0	0
21	19353416	.	C	T	4	3	7	0	0	7	0	0
21	19353645	.	T	C	6	4	10	0	0	10	0	0
21	19354185	.	C	G	3	3	6	0	1	7	0	0
21	19607864	.	T	G	2	2	4	0	0	4	0	0
21	19763668	.	C	T	23	25	48	0	1	49	0	0
21	19763692	.	A	T	28	27	55	0	2	57	0	0
21	19763715	.	T	G	29	27	56	0	3	59	0	0
21	19763942	.	G	A	26	29	55	0	2	57	0	0
21	19764230	.	C	T	25	26	51	0	6	57	0	0
21	19764432	.	G	A	22	19	41	0	0	41	0	0
21	19785355	.	G	T	8	5	13	0	4	17	0	0
21	19785379	.	A	T	13	8	21	0	0	21	0	0
21	19790527	.	A	C	8	9	17	0	1	18	0	0
21	19790590	.	G	A	6	5	11	0	0	11	0	0
21	19792767	.	T	G	3	4	7	0	0	7	0	0
21	19792803	.	G	A	4	4	8	0	0	8	0	0
21	19804193	.	T	G	1	2	3	0	0	3	0	0
21	19868489	.	C	T	8	8	16	0	1	17	0	0
21	19868674	.	G	A	11	6	17	0	2	19	0	0
21	19869129	.	C	T	13	3	16	0	2	18	0	0
21	19872681	.	A	G	6	2	8	0	0	8	0	0
21	19872707	.	G	A	3	5	8	0	1	9	0	0
21	19872772	.	G	A	3	4	7	0	2	9	0	0
21	19872904	.	C	T	3	7	10	0	1	11	0	0
21	19903584	.	G	A	6	7	13	0	0	13	0	0
21	19905553	.	C	T	1	2	3	0	0	3	0	0
21	19905564	.	G	A	1	2	3	0	0	3	0	0
21	19905609	.	C	G	1	2	3	0	0	3	0	0
21	19906513	.	T	C	1	2	3	0	0	3	0	0
21	19906589	.	G	C	1	2	3	0	0	3	0	0
21	19906590	.	A	C	0	0	0	0	2	2	0	0
21	19911433	.	G	T	3	3	6	0	2	8	0	0
21	19911467	.	C	A	4	7	11	0	1	12	0	0
21	19913445	.	G	C	5	4	9	0	0	9	0	0
21	19914241	.	C	T	4	2	6	0	0	6	0	0
21	19914263	.	T	G	5	2	7	0	0	7	0	0
21	19915594	.	T	G	2	3	5	0	0	5	0	0
21	20089886	.	C	T	1	2	3	0	0	3	0	0
21	20106551	.	A	G	8	6	14	0	1	15	0	0
21	20113519	.	C	A	5	7	12	0	0	12	0	0
21	20113659	.	A	G	1	3	4	0	0	4	0	0
21	20113767	.	T	C	4	3	7	0	0	7	0	0
21	20114148	.	G	A	5	5	10	0	1	11	0	0
21	20120404	.	G	A	2	3	5	0	0	5	0	0
21	20339796	.	C	T	1	14	15	0	14	29	0	0
21	20340157	.	G	A	4	10	14	0	0	14	0	0
21	20341491	.	T	G	1	2	3	0	0	3	0	0
21	20341506	.	C	A	0	3	3	0	1	4	0	0
21	20377931	.	C	T	10	8	18	0	1	19	0	0
21	20377944	.	C	T	10	15	25	0	2	27	0	0
21	20395245	.	C	A	4	2	6	0	1	7	0	0
21	20395811	.	C	T	2	3	5	0	0	5	0	0
21	20634883	.	T	A	4	2	6	0	0	6	0	0
21	20636063	.	G	T	0	4	4	0	2	6	0	0
21	20636403	.	C	T	5	4	9	0	0	9	0	0
21	20950679	.	T	C	3	4	7	0	1	8	0	0
21	20950811	.	C	G	3	2	5	0	0	5	0	0
21	20950841	.	A	G	4	2	6	0	0	6	0	0
21	21013693	.	C	G	16	3	19	1	8	28	0	0
21	21017513	.	C	T	13	10	23	0	3	26	0	0
21	21020589	.	C	T	4	2	6	0	0	6	0	0
21	21029465	.	G	C	2	3	5	0	0	5	0	0
21	21038891	.	G	T	2	5	7	0	0	7	0	0
21	21046882	.	C	T	1	3	4	0	0	4	0	0
21	21049323	.	G	A	6	3	9	0	0	9	0	0
21	21051688	.	G	A	1	3	4	0	0	4	0	0
21	21057398	.	T	A	1	2	3	0	0	3	0	0
21	21233182	.	G	A	2	2	4	0	0	4	0	0
21	21236883	.	G	A	2	2	4	0	0	4	0	0
21	21236886	.	G	A	2	2	4	0	0	4	0	0
21	21239969	.	A	G	5	3	8	0	0	8	0	0
21	21239977	.	A	C	3	3	6	0	1	7	0	0
21	21240079	.	G	A	2	3	5	0	0	5	0	0
21	21240651	.	C	T	9	3	12	0	1	13	0	0
21	21241218	.	T	A	1	3	4	0	1	5	0	0
21	21241223	.	T	A	1	4	5	0	0	5	0	0
21	21241364	.	T	A	5	4	9	0	0	9	0	0
21	21241412	.	A	T	6	2	8	0	1	9	0	0
21	21241598	.	A	G	4	3	7	0	0	7	0	0
21	21241802	.	C	T	4	10	14	0	2	16	0	0
21	21241900	.	C	T	4	4	8	0	0	8	0	0
21	21242132	.	A	G	3	7	10	0	0	10	0	0
21	21269737	.	A	G	1	3	4	0	0	4	0	0
21	21272549	.	C	T	4	2	6	0	0	6	0	0
21	21273096	.	A	G	6	4	10	0	0	10	0	0
21	21277089	.	G	A	0	6	6	0	5	11	0	0
21	21294260	.	C	T	6	2	8	0	0	8	0	0
21	21294272	.	C	T	5	4	9	0	0	9	0	0
21	21295195	.	A	C	2	7	9	0	0	9	0	0
21	21298158	.	G	T	7	4	11	0	1	12	0	0
21	21298340	.	G	A	15	13	28	0	2	30	0	0
21	21298387	.	A	G	14	0	14	0	12	26	0	0
21	21314061	.	A	G	2	3	5	0	0	5	0	0
21	21333080	.	T	G	1	2	3	0	1	4	0	0
21	21333164	.	C	T	1	1	2	0	1	3	0	0
21	21342595	.	A	G	6	4	10	0	1	11	0	0
21	21342738	.	C	T	1	2	3	0	0	3	0	0
21	21343122	.	A	G	5	0	5	0	2	7	0	0
21	21343123	.	A	G	2	4	6	0	1	7	0	0
21	21343266	.	A	G	3	4	7	0	0	7	0	0
21	21346850	.	C	T	21	11	32	0	1	33	0	0
21	21347010	.	C	T	7	2	9	0	2	11	0	0
21	21347039	.	G	A	7	7	14	0	1	15	0	0
21	21347053	.	T	A	8	6	14	0	2	16	0	0
21	21347180	.	G	C	3	6	9	0	0	9	0	0
21	21368363	.	A	G	19	9	28	0	0	28	0	0
21	21370406	.	T	C	10	0	10	0	21	31	0	0
21	21372874	.	T	A	5	8	13	0	2	15	0	0
21	21451013	.	T	C	4	0	4	0	4	8	0	0
21	21451025	.	C	A	5	5	10	0	0	10	0	0
21	21523303	.	T	A	6	6	12	0	1	13	0	0
21	21523344	.	A	G	5	8	13	0	0	13	0	0
21	21523465	.	A	G	3	8	11	0	0	11	0	0
21	21523612	.	G	T	3	7	10	0	0	10	0	0
21	21525887	.	T	C	2	2	4	0	0	4	0	0
21	21525895	.	A	G	2	2	4	0	0	4	0	0
21	21615351	.	T	G	3	6	9	0	1	10	0	0
21	21633601	.	G	A	6	5	11	0	0	11	0	0
21	21633774	.	G	A	6	2	8	0	0	8	0	0
21	21746132	.	G	A	0	2	2	0	2	4	0	0
21	21746136	.	G	T	2	2	4	0	0	4	0	0
21	21793873	.	A	C	1	3	4	0	0	4	0	0
21	21793903	.	C	T	1	3	4	0	0	4	0	0
21	21820136	.	A	G	4	5	9	0	0	9	0	0
21	21996637	.	G	A	7	3	10	0	0	10	0	0
21	22038369	.	T	C	8	6	14	0	0	14	0	0
21	22048143	.	G	A	2	2	4	0	1	5	0	0
21	22070522	.	C	T	5	4	9	0	0	9	0	0
21	22070591	.	G	A	1	4	5	0	2	7	0	0
21	22070633	.	C	T	3	6	9	0	0	9	0	0
21	22082184	.	C	T	15	12	27	0	1	28	0	0
21	22082257	.	C	T	16	12	28	0	1	29	0	0
21	22099610	.	A	G	11	7	18	0	2	20	0	0
21	22099698	.	A	G	25	29	54	0	2	56	0	0
21	22099727	.	A	G	28	26	54	0	5	59	0	0
21	22099869	.	G	A	38	29	67	0	2	69	0	0
21	22100026	.	A	G	39	25	64	0	2	66	0	0
21	22100156	.	A	G	30	7	37	3	7	47	0	0
21	22100453	.	C	T	30	29	59	0	3	63	1	0
21	22100511	.	G	A	31	15	46	1	1	48	0	0
21	22100594	.	A	G	25	25	50	0	4	54	0	0
21	22100767	.	C	T	26	20	46	0	3	49	0	0
21	22101056	.	C	A	26	10	36	0	4	41	1	0
21	22101423	.	C	T	5	15	20	0	31	51	0	0
21	22101460	.	C	T	32	15	47	0	4	51	0	0
21	22101540	.	G	A	32	16	48	0	2	50	0	0
21	22101637	.	T	C	16	0	16	0	23	39	0	0
21	22101769	.	A	G	20	15	35	0	1	36	0	0
21	22101777	.	G	A	17	16	33	0	2	35	0	0
21	22101827	.	C	G	5	19	24	0	18	42	0	0
21	22101835	.	C	T	21	15	36	0	6	42	0	0
21	22101917	.	A	T	27	18	45	0	5	50	0	0
21	22102037	.	G	A	19	15	34	0	2	36	0	0
21	22102154	.	C	A	19	15	34	0	0	34	0	0
21	22102281	.	A	C	16	11	27	0	1	28	0	0
21	22102361	.	C	G	9	17	26	0	0	26	0	0
21	22102365	.	A	T	10	16	26	0	1	27	0	0
21	22102416	.	C	T	0	21	21	0	9	30	0	0
21	22102440	.	A	C	7	16	23	0	1	24	0	0
21	22102457	.	A	C	6	12	18	0	3	21	0	0
21	22102542	.	C	T	7	8	15	0	4	19	0	0
21	22102586	.	C	A	3	13	16	0	0	17	1	0
21	22102653	.	A	G	7	15	22	0	0	22	0	0
21	22102838	.	T	G	14	12	26	0	0	26	0	0
21	22102930	.	C	T	17	14	31	0	1	32	0	0
21	22110288	.	T	C	7	1	8	0	5	13	0	0
21	22110303	.	G	A	6	8	14	0	0	14	0	0
21	22111880	.	G	A	5	4	9	0	0	9	0	0
21	22135934	.	G	A	0	5	5	0	2	7	0	0
21	22138571	.	C	G	6	3	9	0	0	9	0	0
21	22140654	.	C	G	6	6	12	0	0	12	0	0
21	22140937	.	C	A	5	4	9	0	0	9	0	0
21	22142362	.	A	G	4	8	12	0	0	12	0	0
21	22142820	.	G	A	1	17	18	0	5	23	0	0
21	22330700	.	G	A	1	2	3	0	0	3	0	0
21	22347502	.	C	T	3	3	6	0	0	6	0	0
21	22347507	.	T	A	3	3	6	0	0	6	0	0
21	22347645	.	G	T	1	2	3	0	0	3	0	0
21	22347765	.	C	T	3	3	6	0	0	6	0	0
21	22385617	.	C	T	3	4	7	0	0	7	0	0
21	22385837	.	T	A	1	2	3	0	0	3	0	0
21	22387556	.	G	T	1	3	4	0	0	4	0	0
21	22412343	.	C	T	2	5	7	0	1	8	0	0
21	22421808	.	A	T	6	2	8	0	1	9	0	0
21	22421867	.	T	G	7	6	13	0	1	14	0	0
21	22422052	.	A	G	12	19	31	0	1	32	0	0
21	22422184	.	A	G	18	10	28	0	2	30	0	0
21	22422565	.	C	G	11	6	17	0	0	17	0	0
21	22422733	.	A	G	10	14	24	0	0	24	0	0
21	22847304	.	G	A	1	6	7	0	4	11	0	0
21	22847329	.	A	G	2	7	9	0	0	9	0	0
21	22880016	.	A	T	3	18	21	0	0	21	0	0
21	23160558	.	T	G	3	6	9	0	2	11	0	0
21	25045347	.	A	G	5	2	7	0	0	7	0	0
21	25103676	.	T	A	5	3	8	0	1	9	0	0
21	25380817	.	T	A	6	2	8	0	1	9	0	0
21	25817230	.	A	G	1	6	7	0	0	7	0	0
21	28863254	.	A	G	0	7	7	0	1	8	0	0
21	28863268	.	G	T	12	0	12	0	0	12	0	0
21	29090907	.	T	A	8	3	11	0	5	16	0	0
21	29974063	.	C	T	1	1	2	1	1	4	0	0
21	30692794	.	A	G	1	3	4	0	0	4	0	0
21	30692817	.	A	G	1	0	1	0	4	5	0	0
21	30693311	.	A	G	3	8	11	0	1	12	0	0
21	30693312	.	A	G	8	4	12	0	0	12	0	0
21	30693346	.	A	G	2	0	2	0	4	6	0	0
21	30693348	.	A	G	0	4	4	0	0	4	0	0
21	30694009	.	A	G	4	7	11	0	0	11	0	0
21	32281076	.	G	A	5	11	16	0	2	18	0	0
21	32281122	.	G	A	7	16	23	0	1	24	0	0
21	32281155	.	G	A	7	14	21	0	2	23	0	0
21	32283519	.	G	A	14	15	29	0	1	30	0	0
21	32284398	.	A	G	8	10	18	0	1	19	0	0
21	32285080	.	C	T	4	3	7	0	0	7	0	0
21	32343248	.	C	A	9	4	13	0	0	13	0	0
21	32343316	.	T	A	7	3	10	0	0	10	0	0
21	32343577	.	T	C	1	3	4	0	0	4	0	0
21	32343649	.	C	A	6	3	9	0	0	9	0	0
21	32344021	.	C	A	6	5	11	0	0	11	0	0
21	32345162	.	T	C	8	4	12	0	1	13	0	0
21	32345318	.	G	A	0	4	4	0	2	6	0	0
21	32345499	.	A	G	4	4	8	0	2	10	0	0
21	32345607	.	C	T	6	5	11	0	1	12	0	0
21	32345724	.	A	G	4	6	10	1	1	12	0	0
21	32345749	.	A	G	6	4	10	1	0	11	0	0
21	32345774	.	A	T	5	4	9	1	1	11	0	0
21	32345899	.	G	A	1	3	4	0	3	7	0	0
21	32346021	.	A	C	4	3	7	0	1	8	0	0
21	32346273	.	G	A	15	18	33	0	1	34	0	0
21	32346603	.	G	C	21	14	35	0	4	39	0	0
21	32346630	.	T	C	17	14	31	0	2	33	0	0
21	32346674	.	T	A	12	13	25	0	0	25	0	0
21	32346689	.	A	G	11	9	20	0	2	22	0	0
21	32346799	.	G	A	9	9	18	0	1	19	0	0
21	32346800	.	T	A	8	8	16	0	3	19	0	0
21	32346899	.	A	G	16	12	28	0	1	29	0	0
21	32346901	.	A	G	17	12	29	0	1	30	0	0
21	32347134	.	T	A	13	14	27	0	1	28	0	0
21	32347569	.	G	T	19	8	27	0	0	27	0	0
21	32347855	.	T	C	8	4	12	0	0	12	0	0
21	32347966	.	A	C	8	0	8	0	10	18	0	0
21	32348230	.	A	T	5	4	9	0	0	9	0	0
21	32348321	.	C	A	2	2	4	0	0	4	0	0
21	32348512	.	G	T	3	5	8	0	0	8	0	0
21	32348542	.	A	T	5	7	12	0	2	14	0	0
21	32348570	.	C	T	6	7	13	0	0	13	0	0
21	32348600	.	C	T	7	3	10	0	3	13	0	0
21	32348664	.	G	A	5	5	10	0	0	10	0	0
21	32353049	.	G	A	3	3	6	0	0	6	0	0
21	32354980	.	A	G	2	3	5	0	0	5	0	0
21	32457785	.	T	C	22	13	35	0	2	37	0	0
21	32457923	.	C	A	16	20	36	1	2	39	0	0
21	32457931	.	T	G	18	16	34	0	1	35	0	0
21	32457983	.	G	A	17	14	31	0	1	32	0	0
21	32458261	.	A	G	15	26	41	0	0	41	0	0
21	32458315	.	T	A	21	12	33	0	2	35	0	0
21	32460782	.	G	C	5	2	7	0	1	8	0	0
21	32460912	.	A	G	17	13	30	0	3	33	0	0
21	32466140	.	G	C	8	5	13	0	1	14	0	0
21	32467724	.	T	C	13	6	19	0	0	19	0	0
21	32476760	.	A	G	22	27	49	0	0	49	0	0
21	32477584	.	T	C	19	27	46	0	0	46	0	0
21	32477967	.	C	T	19	23	42	0	2	44	0	0
21	32477987	.	A	T	18	17	35	0	9	44	0	0
21	32478227	.	G	T	27	19	46	1	0	47	0	0
21	32482797	.	C	T	23	19	42	0	1	43	0	0
21	32482854	.	T	C	20	0	20	1	18	39	0	0
21	32758254	.	G	A	7	6	13	0	0	13	0	0
21	32758351	.	C	T	9	12	21	0	0	21	0	0
21	32758584	.	G	A	8	15	23	0	0	23	0	0
21	32766389	.	G	A	1	4	5	0	0	5	0	0
21	33058940	.	G	C	4	8	12	0	2	14	0	0
21	33066214	.	T	G	17	7	24	0	3	27	0	0
21	33069896	.	A	G	11	12	23	0	0	23	0	0
21	33211161	.	A	G	3	2	5	0	0	5	0	0
21	33211506	.	T	A	12	12	24	0	2	26	0	0
21	33211568	.	C	T	11	14	25	0	0	25	0	0
21	33211664	.	T	G	12	7	19	0	6	25	0	0
21	33211720	.	A	T	10	8	18	0	0	18	0	0
21	33211809	.	A	T	15	13	28	0	1	29	0	0
21	33213315	.	C	T	8	4	12	0	0	12	0	0
21	33213384	.	G	A	3	3	6	0	0	6	0	0
21	33447251	.	A	G	14	8	22	0	6	28	0	0
21	33463486	.	A	G	7	7	14	0	1	15	0	0
21	34001982	.	C	T	12	12	24	0	1	25	0	0
21	34002041	.	C	A	12	13	25	0	1	26	0	0
21	34002154	.	A	C	12	7	19	0	3	22	0	0
21	34002155	.	A	T	11	9	20	0	1	21	0	0
21	34002333	.	T	C	7	3	10	0	0	10	0	0
21	34002455	.	G	A	4	5	9	0	0	9	0	0
21	34002507	.	A	G	6	16	22	0	0	22	0	0
21	34031232	.	G	A	2	2	4	0	0	4	0	0
21	34057611	.	T	G	2	2	4	0	1	5	0	0
21	34059079	.	A	C	2	3	5	0	0	5	0	0
21	34074618	.	A	G	4	14	18	0	1	19	0	0
21	34074684	.	G	A	8	5	13	0	0	13	0	0
21	34074712	.	T	C	7	6	13	0	1	14	0	0
21	34074978	.	T	A	2	2	4	0	0	4	0	0
21	34103275	.	G	A	1	2	3	0	1	4	0	0
21	34114058	.	C	A	2	3	5	0	0	5	0	0
21	34114410	.	G	A	4	4	8	0	0	8	0	0
21	34128660	.	A	G	10	13	23	0	1	24	0	0
21	34129007	.	C	G	14	0	14	0	24	38	0	0
21	34129073	.	G	C	14	19	33	0	1	34	0	0
21	34129195	.	G	T	7	15	22	0	1	23	0	0
21	34129279	.	A	G	11	22	33	0	2	35	0	0
21	34129629	.	A	G	2	7	9	0	0	9	0	0
21	34195790	.	T	C	3	2	5	0	0	5	0	0
21	34210970	.	G	A	7	2	9	0	0	9	0	0
21	34211206	.	T	C	9	5	14	0	1	15	0	0
21	34211344	.	G	A	12	8	20	0	0	20	0	0
21	34211418	.	G	A	2	9	11	0	11	22	0	0
21	34211427	.	A	C	8	10	18	0	0	18	0	0
21	34211511	.	A	T	7	6	13	0	0	13	0	0
21	34364595	.	G	A	7	3	10	0	0	10	0	0
21	34364774	.	G	A	3	2	5	0	0	5	0	0
21	34364962	.	G	T	6	6	12	0	1	13	0	0
21	34391104	.	C	T	10	6	16	1	2	19	0	0
21	34391155	.	T	C	5	6	11	1	1	13	0	0
21	34392786	.	C	T	2	4	6	0	0	6	0	0
21	34392828	.	G	T	3	4	7	0	0	7	0	0
21	34424116	.	A	G	2	1	3	0	3	6	0	0
21	34430533	.	A	G	6	2	8	0	1	9	0	0
21	34430544	.	A	G	4	3	7	0	2	9	0	0
21	34724797	.	G	A	1	2	3	0	0	3	0	0
21	34741120	.	T	C	0	2	2	0	1	3	0	0
21	34770460	.	G	A	2	6	8	0	2	10	0	0
21	34770483	.	G	A	2	6	8	0	4	12	0	0
21	34770510	.	C	T	8	7	15	0	1	16	0	0
21	34792896	.	G	A	5	8	13	0	4	17	0	0
21	34793224	.	C	T	18	10	28	0	0	28	0	0
21	34793405	.	C	T	15	7	22	0	1	23	0	0
21	34793660	.	T	A	9	4	13	0	0	13	0	0
21	34793694	.	T	C	3	4	7	0	0	7	0	0
21	34793753	.	A	C	2	3	5	0	0	5	0	0
21	34815276	.	T	A	1	2	3	0	0	3	0	0
21	34834430	.	G	C	0	4	4	0	3	7	0	0
21	34834495	.	G	A	3	2	5	0	0	5	0	0
21	34834508	.	T	A	3	2	5	0	0	5	0	0
21	34834829	.	T	A	2	2	4	0	0	4	0	0
21	34856770	.	C	T	2	3	5	0	0	5	0	0
21	34878938	.	A	C	8	14	22	0	0	22	0	0
21	34879230	.	C	T	1	3	4	0	0	4	0	0
21	34987505	.	C	T	9	5	14	0	0	14	0	0
21	34987612	.	G	A	0	7	7	0	5	12	0	0
21	34987662	.	G	T	7	2	9	0	0	9	0	0
21	35009472	.	C	T	4	2	6	0	0	6	0	0
21	35009706	.	C	T	2	2	4	1	0	5	0	0
21	35010135	.	A	T	1	4	5	0	0	5	0	0
21	35013762	.	A	G	3	2	5	0	0	5	0	0
21	35033847	.	G	A	5	7	12	0	1	13	0	0
21	35033853	.	G	A	3	8	11	0	1	12	0	0
21	35035560	.	G	A	0	9	9	0	6	15	0	0
21	35040310	.	C	T	10	6	16	0	0	16	0	0
21	35040888	.	T	C	1	2	3	0	0	3	0	0
21	35040912	.	G	T	1	7	8	0	0	8	0	0
21	35048278	.	T	A	1	2	3	0	1	4	0	0
21	35048320	.	A	G	2	0	2	0	3	5	0	0
21	35051605	.	G	T	3	3	6	0	0	6	0	0
21	35054515	.	C	T	2	5	7	0	0	7	0	0
21	35054521	.	C	A	2	5	7	0	0	7	0	0
21	35054738	.	G	T	1	3	4	0	0	4	0	0
21	35279874	.	C	T	4	4	8	0	0	8	0	0
21	35280099	.	A	G	5	4	9	0	0	9	0	0
21	35280209	.	G	A	0	4	4	0	2	6	0	0
21	35280233	.	T	C	2	3	5	0	0	5	0	0
21	35280285	.	G	A	3	3	6	0	0	6	0	0
21	35280388	.	T	A	6	3	9	0	1	10	0	0
21	35280389	.	A	T	6	3	9	0	1	10	0	0
21	35280482	.	G	T	2	3	5	0	0	5	0	0
21	35280938	.	C	T	15	11	26	0	2	28	0	0
21	35281246	.	A	C	8	15	23	0	1	25	1	0
21	35302246	.	T	C	1	6	7	1	0	8	0	0
21	35305792	.	T	C	0	2	2	2	2	6	0	0
21	35306037	.	C	T	5	2	7	1	1	9	0	0
21	35319331	.	T	C	1	3	4	2	0	6	0	0
21	35652761	.	G	C	5	4	9	0	0	9	0	0
21	36386928	.	G	A	15	5	20	0	1	21	0	0
21	36387018	.	A	G	16	12	28	0	1	29	0	0
21	36387051	.	T	C	14	7	21	0	1	22	0	0
21	36392696	.	A	G	3	7	10	0	0	10	0	0
21	36392866	.	T	C	8	6	14	0	1	15	0	0
21	36417026	.	C	T	1	2	3	0	0	3	0	0
21	36419430	.	A	G	1	3	4	0	0	4	0	0
21	36435575	.	G	C	5	4	9	0	0	9	0	0
21	36435851	.	G	A	0	2	2	0	4	6	0	0
21	36435859	.	G	A	0	2	2	0	4	6	0	0
21	36442260	.	T	A	5	6	11	0	2	13	0	0
21	36442633	.	G	A	12	9	21	0	0	21	0	0
21	36446952	.	A	G	4	2	6	0	1	7	0	0
21	36449427	.	G	A	3	2	5	0	1	6	0	0
21	36449686	.	T	C	3	3	6	0	1	7	0	0
21	36449716	.	G	A	1	2	3	0	0	3	0	0
21	36570995	.	A	G	1	4	5	0	0	5	0	0
21	36592117	.	T	C	2	6	8	0	0	8	0	0
21	36592164	.	G	A	5	3	8	0	1	9	0	0
21	36592212	.	T	C	2	4	6	0	1	7	0	0
21	36598047	.	T	C	7	4	11	0	0	11	0	0
21	36598143	.	G	A	0	5	5	0	4	9	0	0
21	36598471	.	T	C	3	4	7	0	1	8	0	0
21	36598474	.	C	A	4	4	8	0	0	8	0	0
21	36598529	.	G	T	4	5	9	0	0	9	0	0
21	36598750	.	A	G	3	2	5	1	0	6	0	0
21	36598853	.	G	A	0	7	7	0	4	11	0	0
21	36598959	.	A	T	2	4	6	1	0	7	0	0
21	36599020	.	A	T	10	9	19	0	1	20	0	0
21	36599077	.	T	C	15	5	20	1	0	21	0	0
21	36599358	.	A	C	12	5	17	0	0	17	0	0
21	36599847	.	G	A	7	3	10	0	0	10	0	0
21	36599944	.	C	T	1	7	8	0	0	8	0	0
21	36600174	.	C	A	9	7	16	1	0	17	0	0
21	36612586	.	T	A	2	2	4	0	0	4	0	0
21	36612633	.	T	C	4	4	8	0	0	8	0	0
21	37107035	.	T	A	15	12	27	0	3	30	0	0
21	37107307	.	G	A	7	7	14	0	0	14	0	0
21	37107432	.	A	T	5	5	10	0	1	11	0	0
21	37107614	.	T	C	3	4	7	0	0	7	0	0
21	37107861	.	T	C	12	10	22	0	1	23	0	0
21	37108022	.	A	G	7	10	17	1	2	20	0	0
21	37108204	.	A	T	19	16	35	0	1	36	0	0
21	37108413	.	G	T	8	2	10	0	2	12	0	0
21	37108414	.	C	T	4	2	6	0	6	12	0	0
21	37184314	.	G	A	7	2	9	1	0	10	0	0
21	37637792	.	G	A	6	10	16	0	0	16	0	0
21	37637794	.	A	T	7	9	16	0	1	17	0	0
21	37640005	.	G	A	1	4	5	0	0	5	0	0
21	37686849	.	C	T	3	2	5	0	0	5	0	0
21	37686850	.	A	G	4	2	6	0	0	6	0	0
21	37687523	.	G	A	7	9	16	0	0	16	0	0
21	37687729	.	C	T	5	10	15	0	0	15	0	0
21	37689192	.	T	G	2	1	3	1	1	5	0	0
21	38587378	.	T	C	4	4	8	1	1	10	0	0
21	38589677	.	A	G	4	2	6	0	0	6	0	0
21	39381093	.	T	C	5	2	7	0	0	7	0	0
21	39511364	.	A	G	1	5	6	0	1	7	0	0
21	39972998	.	A	G	1	2	3	0	0	3	0	0
21	40045441	.	T	C	5	5	10	0	1	11	0	0
21	40045569	.	G	T	6	7	13	0	2	15	0	0
21	40045665	.	G	A	13	16	29	0	0	29	0	0
21	40045701	.	G	A	10	15	25	0	1	26	0	0
21	40045754	.	G	A	9	12	21	0	1	22	0	0
21	40048640	.	A	G	10	5	15	0	2	17	0	0
21	40048981	.	C	A	0	4	4	0	4	8	0	0
21	40049524	.	A	G	2	4	6	0	1	7	0	0
21	40049556	.	T	G	4	3	7	0	1	8	0	0
21	40354884	.	A	G	5	5	10	0	0	10	0	0
21	40354894	.	A	T	6	4	10	0	0	10	0	0
21	40355063	.	A	C	5	11	16	0	0	16	0	0
21	40355113	.	A	G	5	11	16	0	0	16	0	0
21	40355226	.	G	A	9	7	16	0	0	16	0	0
21	40355350	.	T	C	6	9	15	0	1	16	0	0
21	40355539	.	G	T	3	19	22	0	1	23	0	0
21	40355710	.	A	T	14	6	20	0	0	20	0	0
21	40355764	.	C	T	8	5	13	1	1	15	0	0
21	40355844	.	A	T	7	5	12	0	0	12	0	0
21	40355886	.	T	G	6	4	10	0	0	10	0	0
21	40356104	.	T	C	3	1	4	0	11	15	0	0
21	40365404	.	G	A	3	2	5	0	0	5	0	0
21	40373048	.	G	T	1	2	3	0	0	3	0	0
21	40373049	.	G	T	1	2	3	0	0	3	0	0
21	40373200	.	A	C	2	2	4	0	0	4	0	0
21	40402644	.	G	A	6	5	11	0	1	12	0	0
21	40402864	.	C	T	0	11	11	0	12	23	0	0
21	40403465	.	G	A	6	9	15	0	0	15	0	0
21	40406485	.	A	G	7	10	17	0	0	17	0	0
21	40411505	.	G	T	4	2	6	0	0	6	0	0
21	40475427	.	C	T	3	3	6	0	0	6	0	0
21	40475563	.	C	G	4	3	7	0	1	8	0	0
21	40528986	.	C	T	28	15	43	0	2	45	0	0
21	40529616	.	T	C	7	4	11	0	0	11	0	0
21	40530901	.	A	G	7	22	29	0	0	29	0	0
21	40531101	.	T	C	7	0	7	0	6	13	0	0
21	40531110	.	C	T	7	5	12	0	0	12	0	0
21	40531217	.	A	C	5	5	10	0	1	11	0	0
21	40531240	.	C	T	0	4	4	0	3	7	0	0
21	40531328	.	T	C	8	14	22	0	1	23	0	0
21	40532886	.	T	C	2	2	4	0	0	4	0	0
21	40532891	.	A	G	3	3	6	0	0	6	0	0
21	40532931	.	G	C	3	2	5	0	1	6	0	0
21	40532989	.	A	G	3	2	5	0	0	5	0	0
21	40532990	.	T	A	3	2	5	0	0	5	0	0
21	40537149	.	C	T	3	2	5	0	0	5	0	0
21	40537152	.	G	A	2	2	4	0	1	5	0	0
21	40553497	.	G	A	1	3	4	0	1	5	0	0
21	40686139	.	C	T	3	2	5	0	0	5	0	0
21	40691449	.	A	G	5	0	5	0	5	10	0	0
21	40703190	.	C	T	14	8	22	0	1	23	0	0
21	40703402	.	A	C	11	11	22	0	0	22	0	0
21	40703445	.	G	A	3	11	14	0	7	21	0	0
21	40708974	.	T	A	12	19	31	0	2	33	0	0
21	40708978	.	C	A	13	20	33	0	1	34	0	0
21	40714691	.	C	T	19	21	40	0	0	40	0	0
21	40715622	.	A	G	19	15	34	0	3	37	0	0
21	40715730	.	T	C	15	16	31	0	1	32	0	0
21	40715808	.	A	G	12	12	24	0	1	25	0	0
21	40930430	.	C	G	3	3	6	0	0	6	0	0
21	40930469	.	T	C	4	5	9	0	0	9	0	0
21	40930528	.	C	A	8	6	14	0	0	14	0	0
21	40930650	.	T	A	12	11	23	0	0	23	0	0
21	40930651	.	G	A	11	9	20	0	3	23	0	0
21	40931215	.	A	G	3	6	9	0	0	9	0	0
21	40931236	.	T	C	4	0	4	0	6	10	0	0
21	40932951	.	A	T	4	2	6	0	0	6	0	0
21	40932954	.	T	C	3	2	5	0	0	5	0	0
21	40934586	.	G	A	3	3	6	0	0	6	0	0
21	40934703	.	T	C	3	0	3	0	4	7	0	0
21	41311129	.	G	A	6	2	8	0	1	9	0	0
21	41312822	.	C	G	22	9	31	0	5	36	0	0
21	41313042	.	A	G	13	7	20	0	2	22	0	0
21	41313124	.	G	A	19	15	34	0	0	34	0	0
21	41313216	.	G	A	16	8	24	0	1	25	0	0
21	41313257	.	T	C	12	13	25	1	2	28	0	0
21	41316974	.	C	T	3	7	10	0	0	10	0	0
21	41323551	.	C	T	0	3	3	0	7	10	0	0
21	41598942	.	G	C	15	9	24	0	0	24	0	0
21	41598961	.	T	C	18	0	18	0	13	31	0	0
21	41599060	.	T	C	6	19	25	1	2	28	0	0
21	41599147	.	G	A	16	4	20	0	0	20	0	0
21	41601921	.	G	A	1	6	7	0	0	7	0	0
21	42044215	.	C	T	2	3	5	0	0	5	0	0
21	42778937	.	G	A	1	3	4	0	1	5	0	0
21	42954434	.	A	G	3	5	8	0	0	8	0	0
21	42971463	.	T	C	31	16	47	0	10	57	0	0
21	43176819	.	A	G	3	2	5	0	0	5	0	0
21	43363939	.	A	G	4	2	6	0	0	6	0	0
21	43363957	.	G	C	3	2	5	0	1	6	0	0
21	43421460	.	T	A	1	2	3	0	0	3	0	0
21	43461123	.	T	C	4	2	6	0	1	7	0	0
21	43476276	.	T	C	12	6	18	0	1	19	0	0
21	43476821	.	T	C	17	5	22	1	2	25	0	0
21	43477858	.	T	C	4	7	11	0	2	13	0	0
21	43477894	.	T	C	10	6	16	0	3	19	0	0
21	43506966	.	T	G	3	4	7	0	1	8	0	0
21	43506980	.	G	A	2	4	6	0	0	6	0	0
21	43507055	.	A	G	4	4	8	0	1	9	0	0
21	43507058	.	C	T	4	5	9	0	0	9	0	0
21	43507114	.	T	G	4	7	11	0	0	11	0	0
21	43507142	.	A	G	5	0	5	0	5	10	0	0
21	43507204	.	T	C	4	6	10	2	1	13	0	0
21	43507768	.	C	A	2	2	4	0	0	4	0	0
21	43507954	.	A	G	5	2	7	0	0	7	0	0
21	43508356	.	C	T	1	3	4	0	0	4	0	0
21	43524271	.	G	A	6	8	14	0	0	14	0	0
21	43524778	.	T	C	6	4	10	0	0	10	0	0
21	43525429	.	T	C	1	2	3	0	0	3	0	0
21	43525618	.	T	G	0	2	2	0	1	3	0	0
21	43525978	.	G	A	3	2	5	0	0	5	0	0
21	43526371	.	G	A	1	3	4	0	0	4	0	0
21	43581478	.	A	G	8	8	16	0	2	18	0	0
21	43581505	.	T	C	5	0	5	0	9	14	0	0
21	43581606	.	A	G	10	8	18	0	1	19	0	0
21	43584745	.	G	A	9	13	22	0	0	22	0	0
21	43584822	.	A	G	11	14	25	0	1	26	0	0
21	43586774	.	C	T	0	9	9	0	6	15	0	0
21	43595384	.	C	T	1	3	4	0	0	4	0	0
21	43710834	.	A	C	6	5	11	0	0	11	0	0
21	43710842	.	A	G	6	0	6	0	6	12	0	0
21	43713566	.	A	G	7	0	7	0	5	12	0	0
21	43891196	.	A	G	2	3	5	0	0	5	0	0
21	43897365	.	C	T	13	12	25	0	2	27	0	0
21	43900196	.	T	C	7	11	18	0	0	18	0	0
21	43906670	.	G	A	5	6	11	0	2	13	0	0
21	43926773	.	C	A	1	2	3	0	0	3	0	0
21	44005524	.	A	C	2	3	5	0	1	6	0	0
21	44005548	.	G	A	5	11	16	0	0	16	0	0
21	44005583	.	G	A	12	25	37	0	1	38	0	0
21	44005587	.	A	C	14	22	36	0	1	37	0	0
21	44005637	.	T	G	22	18	40	0	2	42	0	0
21	44019151	.	C	T	6	4	10	1	2	13	0	0
21	44022008	.	T	A	13	16	29	0	3	32	0	0
21	44022014	.	A	G	15	15	30	0	0	30	0	0
21	44025907	.	A	G	18	13	31	0	1	32	0	0
21	44027975	.	A	T	12	23	35	0	3	38	0	0
21	44028691	.	G	A	20	24	44	0	3	47	0	0
21	44028755	.	C	A	11	14	25	0	1	26	0	0
21	44031139	.	T	C	17	24	41	0	1	42	0	0
21	44031145	.	T	A	18	25	43	0	1	44	0	0
21	44036872	.	A	T	8	13	21	0	0	21	0	0
21	44036912	.	A	C	8	9	17	0	1	18	0	0
21	44036984	.	T	A	13	11	24	0	2	26	0	0
21	44037011	.	T	A	8	15	23	0	8	31	0	0
21	44037040	.	G	A	2	11	13	0	9	22	0	0
21	44037046	.	A	G	10	1	11	0	10	21	0	0
21	44037090	.	A	G	4	3	7	0	0	7	0	0
21	44037092	.	A	G	4	1	5	0	2	7	0	0
21	44687941	.	A	G	5	0	5	0	6	11	0	0
21	44687949	.	T	C	5	4	9	0	0	9	0	0
21	44688711	.	G	A	5	6	11	0	0	11	0	0
21	44689277	.	A	T	4	7	11	0	2	13	0	0
21	44689476	.	C	T	12	5	17	0	0	17	0	0
21	44689503	.	A	T	9	8	17	0	0	17	0	0
21	44689528	.	A	G	9	0	9	0	8	17	0	0
21	44689655	.	C	T	15	7	22	0	0	22	0	0
21	44690520	.	A	G	19	1	20	0	9	29	0	0
21	45043527	.	G	T	4	3	7	0	0	7	0	0
21	45043548	.	G	A	4	2	6	0	0	6	0	0
21	45043590	.	T	C	7	0	7	0	4	11	0	0
21	45043611	.	A	G	8	4	12	0	0	12	0	0
21	45052584	.	G	A	8	7	15	0	0	15	0	0
21	45054887	.	G	A	7	5	12	0	1	13	0	0
21	45058331	.	T	G	4	2	6	0	2	8	0	0
21	45114489	.	G	T	0	2	2	0	1	3	0	0
21	45117430	.	T	A	5	8	13	0	0	14	1	0
21	45117465	.	T	C	4	4	8	0	1	9	0	0
21	45117469	.	T	G	3	3	6	0	1	7	0	0
21	45182687	.	T	C	2	2	4	0	0	4	0	0
21	45186175	.	G	A	2	4	6	0	0	6	0	0
21	45190704	.	A	G	26	34	60	0	3	63	0	0
21	45190766	.	T	A	29	22	51	0	3	54	0	0
21	45190861	.	A	T	35	21	56	0	3	59	0	0
21	45190926	.	C	T	29	22	51	0	3	54	0	0
21	45193365	.	G	A	30	26	56	0	3	59	0	0
21	45341958	.	A	T	29	23	52	1	0	53	0	0
21	45342043	.	G	T	22	38	60	0	1	61	0	0
21	45349469	.	G	A	19	17	36	0	0	36	0	0
21	45352211	.	G	A	26	7	33	0	2	35	0	0
21	45352212	.	G	A	29	7	36	0	1	37	0	0
21	45352415	.	C	T	4	16	20	0	29	49	0	0
21	45359397	.	G	A	16	11	27	1	1	29	0	0
21	45363684	.	C	T	13	10	23	0	1	24	0	0
21	45363728	.	C	T	15	9	24	0	0	24	0	0
21	45363778	.	T	G	13	18	31	0	2	33	0	0
21	45374413	.	C	A	6	5	11	0	0	11	0	0
21	45374583	.	A	T	1	4	5	0	0	5	0	0
21	45374725	.	G	A	2	2	4	0	2	6	0	0
21	45374747	.	T	G	3	6	9	0	0	9	0	0
21	45377351	.	G	T	14	6	20	0	1	21	0	0
21	45377404	.	T	C	14	9	23	0	0	23	0	0
21	45377409	.	T	C	12	9	21	0	2	23	0	0
21	45377546	.	G	A	11	19	30	0	0	30	0	0
21	45377604	.	T	G	15	7	22	0	0	22	0	0
21	45377685	.	G	A	19	17	36	0	1	37	0	0
21	45382162	.	G	A	3	2	5	0	0	5	0	0
21	45550244	.	C	G	1	6	7	0	0	7	0	0
21	45550734	.	T	C	4	2	6	0	0	6	0	0
21	45550736	.	C	T	4	2	6	0	0	6	0	0
21	45550928	.	A	T	3	4	7	0	0	7	0	0
21	45551095	.	A	C	2	4	6	0	0	6	0	0
21	45551096	.	G	A	2	4	6	0	0	6	0	0
21	45551386	.	G	C	3	2	5	0	1	6	0	0
21	45551391	.	A	G	4	2	6	0	0	6	0	0
21	45551421	.	T	C	4	2	6	0	0	6	0	0
21	45551785	.	G	A	4	4	8	0	0	8	0	0
21	45551845	.	C	T	4	5	9	0	0	9	0	0
21	45551972	.	G	A	0	5	5	0	7	12	0	0
21	45552187	.	T	C	6	11	17	0	1	18	0	0
21	45552282	.	T	C	10	7	17	0	2	19	0	0
21	45552286	.	C	T	10	9	19	0	0	19	0	0
21	45552676	.	G	A	8	10	18	0	0	18	0	0
21	45552924	.	C	T	10	4	14	0	1	15	0	0
21	45582048	.	T	C	4	4	8	0	0	8	0	0
21	45582907	.	A	G	4	3	7	0	1	8	0	0
21	45584817	.	C	T	3	6	9	0	2	11	0	0
21	45632866	.	T	C	2	4	6	0	0	6	0	0
21	45673667	.	T	A	26	18	44	0	6	50	0	0
21	45673826	.	G	A	17	14	31	0	1	32	0	0
21	45673960	.	C	T	2	15	17	1	29	47	0	0
21	45674321	.	T	C	17	28	45	0	1	46	0	0
21	45694166	.	C	T	2	4	6	0	0	6	0	0
21	45696135	.	C	T	3	3	6	0	1	7	0	0
21	45704975	.	C	T	4	3	7	0	0	7	0	0
21	45704999	.	C	T	5	2	7	0	0	7	0	0
21	45705267	.	T	C	7	2	9	0	0	9	0	0
21	45705276	.	T	C	5	2	7	0	0	7	0	0
21	45705375	.	A	G	2	8	10	0	0	10	0	0
21	45705948	.	T	C	7	4	11	0	2	13	0	0
21	45707154	.	T	C	7	9	16	0	1	17	0	0
21	45707734	.	T	C	9	4	13	0	3	16	0	0
21	45714390	.	T	C	13	7	20	0	0	20	0	0
21	45715241	.	T	C	19	20	39	1	3	43	0	0
21	45715271	.	G	A	19	7	26	3	21	50	0	0
21	45715478	.	T	C	11	4	15	0	0	15	0	0
21	45715558	.	G	C	10	3	13	0	0	13	0	0
21	45716032	.	T	C	7	5	12	0	0	12	0	0
21	45716112	.	A	G	3	7	10	0	0	10	0	0
21	45719205	.	T	G	6	0	6	0	7	13	0	0
21	45721245	.	T	C	6	4	10	0	2	12	0	0
21	45721246	.	C	G	7	0	7	0	5	12	0	0
21	45721760	.	G	A	5	10	15	0	2	17	0	0
21	45723174	.	G	C	7	4	11	0	1	12	0	0
21	45726391	.	C	T	7	12	19	0	0	19	0	0
21	45726600	.	C	T	12	11	23	0	1	24	0	0
21	45728723	.	T	G	10	9	19	0	0	19	0	0
21	45728774	.	T	C	8	9	17	0	1	18	0	0
21	45729365	.	C	G	11	6	17	0	0	17	0	0
21	45730150	.	G	C	23	27	50	0	2	52	0	0
21	45732018	.	C	G	9	15	24	0	2	26	0	0
21	45733905	.	C	T	7	3	10	0	0	10	0	0
21	45736157	.	T	G	4	0	4	0	7	11	0	0
21	45736179	.	T	C	4	6	10	0	0	10	0	0
21	45736244	.	T	C	7	6	13	0	0	13	0	0
21	45736463	.	T	A	5	7	12	0	0	12	0	0
21	45737960	.	T	G	3	6	9	0	0	9	0	0
21	45738043	.	T	C	4	3	7	0	0	7	0	0
21	45738046	.	T	C	4	3	7	0	0	7	0	0
21	45738125	.	C	T	3	3	6	1	0	7	0	0
21	45738525	.	G	A	1	5	6	0	13	19	0	0
21	45738658	.	A	C	5	6	11	0	1	12	0	0
21	45738775	.	A	G	7	5	12	0	0	12	0	0
21	45738852	.	G	A	10	8	18	0	0	18	0	0
21	45738856	.	C	T	11	7	18	0	1	19	0	0
21	45738945	.	A	G	5	0	5	0	6	11	0	0
21	45739074	.	A	C	6	11	17	0	0	17	0	0
21	45739087	.	A	C	6	12	18	0	0	18	0	0
21	45739125	.	A	G	11	12	23	0	1	24	0	0
21	45739139	.	C	T	9	9	18	0	2	20	0	0
21	45739169	.	T	A	9	9	18	0	1	19	0	0
21	45739235	.	T	C	6	3	9	0	2	11	0	0
21	45739519	.	C	G	9	6	15	0	1	16	0	0
21	45739613	.	A	T	11	10	21	0	2	23	0	0
21	45739642	.	G	A	0	9	9	0	14	23	0	0
21	45739724	.	A	T	13	20	33	0	1	34	0	0
21	45761690	.	A	T	1	3	4	0	1	5	0	0
21	45767470	.	C	A	1	4	5	0	0	5	0	0
21	45767676	.	A	T	5	2	7	0	0	7	0	0
21	45767716	.	C	A	3	4	7	0	0	7	0	0
21	45767758	.	C	G	2	4	6	0	1	7	0	0
21	45767848	.	T	A	1	2	3	0	0	3	0	0
21	45767965	.	A	T	3	2	5	0	0	5	0	0
21	45768031	.	G	A	0	2	2	0	3	5	0	0
21	45768043	.	T	C	2	3	5	0	0	5	0	0
21	45768260	.	T	A	3	4	7	0	0	7	0	0
21	45768317	.	A	C	6	6	12	0	0	12	0	0
21	45768597	.	G	C	4	2	6	0	0	6	0	0
21	45769130	.	C	G	12	8	20	0	0	20	0	0
21	45769199	.	C	A	16	11	27	0	0	27	0	0
21	45769379	.	T	G	3	1	4	0	1	5	0	0
21	45823564	.	A	T	1	2	3	0	0	3	0	0
21	45838192	.	T	A	6	2	8	0	1	9	0	0
21	45838304	.	C	T	15	21	36	0	3	39	0	0
21	45839258	.	A	G	11	17	28	0	1	29	0	0
21	45840307	.	C	A	1	5	6	0	9	15	0	0
21	45840317	.	G	T	7	4	11	0	0	11	0	0
21	45848701	.	T	C	1	3	4	0	0	4	0	0
21	45850905	.	G	A	0	9	9	0	14	23	0	0
21	45851180	.	T	C	4	8	12	0	2	14	0	0
21	45851493	.	A	T	17	7	24	0	1	25	0	0
21	45851496	.	A	C	20	6	26	0	1	27	0	0
21	45851563	.	A	C	27	12	39	0	0	39	0	0
21	45851925	.	C	G	14	0	14	0	3	17	0	0
21	45851930	.	G	A	2	3	5	0	10	15	0	0
21	45856614	.	G	A	14	18	32	0	0	32	0	0
21	45857425	.	G	A	17	12	29	0	0	29	0	0
21	45857954	.	T	G	4	9	13	0	0	13	0	0
21	45859589	.	C	T	5	12	17	0	2	19	0	0
21	45863053	.	G	A	8	6	14	0	1	15	0	0
21	45865174	.	C	T	5	5	10	0	0	10	0	0
21	45866065	.	G	A	7	4	11	0	0	11	0	0
21	45866066	.	G	A	7	4	11	0	0	11	0	0
21	45875861	.	C	T	0	1	1	0	3	4	0	0
21	45875870	.	A	T	3	2	5	0	0	5	0	0
21	45875907	.	G	A	4	2	6	0	0	6	0	0
21	45875940	.	T	C	5	5	10	0	0	10	0	0
21	45876230	.	T	C	5	9	14	0	1	15	0	0
21	45876253	.	A	T	5	11	16	0	2	18	0	0
21	45876638	.	A	G	22	1	23	0	2	31	6	0
21	45876642	.	C	A	0	7	7	0	22	29	0	0
21	45884210	.	A	G	2	2	4	0	0	4	0	0
21	45905257	.	C	G	4	2	6	0	1	7	0	0
21	45914182	.	A	G	6	3	9	0	0	9	0	0
21	45916436	.	C	T	2	7	9	0	0	9	0	0
21	45919139	.	G	T	6	3	9	0	2	11	0	0
21	45919290	.	C	T	6	2	8	0	0	8	0	0
22	337121	.	A	C	5	2	7	0	22	29	0	0
22	337127	.	A	C	4	0	4	0	23	27	0	0
22	583118	.	A	G	5	3	8	0	0	8	0	0
22	866080	.	T	G	3	0	3	0	3	6	0	0
22	912528	.	G	A	1	2	3	2	0	5	0	0
22	912531	.	T	A	0	3	3	2	0	6	1	0
22	912563	.	T	C	2	2	4	0	0	4	0	0
22	1632641	.	A	T	5	2	7	2	0	9	0	0
22	1925329	.	C	G	1	2	3	2	0	5	0	0
22	1925330	.	T	C	1	2	3	2	0	5	0	0
22	2033740	.	C	T	1	5	6	0	0	6	0	0
22	2627773	.	A	T	1	6	7	2	0	9	0	0
22	3232373	.	A	G	5	2	7	0	0	7	0	0
22	4747456	.	C	A	5	3	8	0	1	9	0	0
22	4962472	.	T	A	4	7	11	0	1	12	0	0
22	4962559	.	G	A	12	11	23	0	1	24	0	0
22	4962610	.	A	T	16	12	28	0	1	29	0	0
22	4962635	.	A	G	16	13	29	0	1	30	0	0
22	4962696	.	T	C	11	17	28	0	2	30	0	0
22	4962878	.	G	A	13	19	32	0	0	32	0	0
22	4968955	.	A	G	12	13	25	1	1	27	0	0
22	4969051	.	G	A	7	11	18	0	0	18	0	0
22	4970773	.	T	C	7	1	8	0	9	17	0	0
22	4970797	.	G	C	7	5	12	0	1	13	0	0
22	4972848	.	T	G	3	5	8	0	0	8	0	0
22	4972980	.	C	T	0	4	4	0	8	12	0	0
22	4975236	.	T	A	7	12	19	0	2	21	0	0
22	4977106	.	G	A	5	3	8	0	0	8	0	0
22	5056425	.	G	T	16	15	31	0	1	32	0	0
22	5056706	.	G	A	8	8	16	0	2	18	0	0
22	5056760	.	T	G	15	16	31	0	0	31	0	0
22	5056978	.	A	T	2	5	7	0	0	7	0	0
22	5057443	.	T	C	3	0	3	0	15	18	0	0
22	5057489	.	T	A	6	4	10	0	0	10	0	0
22	5057504	.	T	A	5	5	10	0	1	11	0	0
22	5059916	.	A	G	7	12	19	0	1	20	0	0
22	5060087	.	T	G	4	4	8	0	0	8	0	0
22	5060162	.	T	A	10	5	15	0	1	16	0	0
22	5062457	.	G	A	5	4	9	0	0	9	0	0
22	5075673	.	A	G	1	2	3	0	0	3	0	0
22	5075732	.	T	C	2	2	4	0	0	4	0	0
22	5087488	.	G	A	3	5	8	0	0	8	0	0
22	5098433	.	G	T	1	3	4	0	0	4	0	0
22	5109554	.	G	A	11	9	20	0	0	20	0	0
22	5109560	.	T	A	11	10	21	0	1	22	0	0
22	5112644	.	G	T	15	13	28	0	0	28	0	0
22	5112749	.	T	C	16	16	32	0	2	34	0	0
22	5112864	.	G	A	17	11	28	0	0	29	1	0
22	5112915	.	A	C	20	15	35	0	1	36	0	0
22	5114380	.	G	C	2	25	27	0	27	54	0	0
22	5116267	.	A	C	9	7	16	0	1	17	0	0
22	5119541	.	C	T	1	2	3	0	0	3	0	0
22	5121464	.	C	T	2	12	14	0	0	14	0	0
22	5121471	.	C	T	2	10	12	0	1	13	0	0
22	5121623	.	A	G	6	0	6	0	8	14	0	0
22	5140750	.	G	A	3	4	7	0	1	8	0	0
22	5140774	.	G	C	2	0	2	0	3	5	0	0
22	5140840	.	C	T	0	6	6	0	5	11	0	0
22	5140851	.	C	G	4	4	8	0	2	10	0	0
22	5144566	.	G	C	5	3	8	0	0	8	0	0
22	5144645	.	C	T	11	8	19	0	1	20	0	0
22	5144750	.	T	A	7	6	13	0	0	13	0	0
22	5144981	.	T	C	4	7	11	0	0	11	0	0
22	5145109	.	C	A	6	5	11	0	0	11	0	0
22	5145199	.	C	G	2	4	6	0	0	6	0	0
22	5229058	.	G	C	3	2	5	0	0	5	0	0
22	5756066	.	G	A	24	16	40	0	2	42	0	0
22	5756317	.	C	T	7	2	9	0	0	9	0	0
22	5758678	.	C	T	12	11	23	0	1	24	0	0
22	5758689	.	A	T	11	9	20	0	2	22	0	0
22	5761968	.	G	A	4	3	7	0	0	7	0	0
22	5762097	.	C	T	3	2	5	0	0	5	0	0
22	5763881	.	A	G	1	2	3	0	0	3	0	0
22	5773482	.	G	A	1	3	4	0	1	5	0	0
22	6075714	.	A	C	1	2	3	0	0	3	0	0
22	6078223	.	C	A	2	3	5	0	0	5	0	0
22	6183380	.	A	G	1	3	4	0	0	4	0	0
22	6300409	.	G	T	1	2	3	0	0	3	0	0
22	6314629	.	G	A	5	3	8	2	0	10	0	0
22	6487855	.	T	G	9	12	21	0	0	21	0	0
22	6487920	.	C	A	4	5	9	0	2	11	0	0
22	6487932	.	A	G	3	6	9	0	0	9	0	0
22	6488007	.	T	G	3	3	6	0	1	7	0	0
22	6488050	.	A	T	12	8	20	0	1	21	0	0
22	6488068	.	G	A	15	7	22	0	1	23	0	0
22	6488117	.	A	G	17	6	23	0	0	23	0	0
22	6488129	.	C	G	15	4	19	0	1	20	0	0
22	6488204	.	G	A	9	7	16	0	1	17	0	0
22	6488261	.	A	G	10	6	16	1	1	18	0	0
22	6488266	.	A	C	10	6	16	1	0	17	0	0
22	6488313	.	T	A	3	5	8	0	1	9	0	0
22	6488433	.	G	T	1	5	6	1	0	7	0	0
22	6488528	.	G	C	2	0	2	0	7	9	0	0
22	6488548	.	T	C	2	7	9	0	0	9	0	0
22	6488565	.	A	G	1	3	4	0	1	5	0	0
22	6488598	.	G	T	3	3	6	0	0	6	0	0
22	6494840	.	G	A	5	4	9	0	0	9	0	0
22	6494855	.	A	T	6	5	11	0	0	11	0	0
22	6527546	.	C	T	9	3	12	0	0	12	0	0
22	6527758	.	G	T	1	3	4	0	0	4	0	0
22	6528134	.	A	G	4	4	8	1	0	9	0	0
22	6528151	.	T	C	3	2	5	1	0	6	0	0
22	6528177	.	C	T	0	3	3	0	2	5	0	0
22	6528586	.	C	T	6	3	9	0	0	9	0	0
22	6765599	.	G	A	4	2	6	0	0	6	0	0
22	6996116	.	T	C	3	1	4	0	5	9	0	0
22	6996343	.	G	A	6	7	13	0	0	13	0	0
22	6998904	.	A	G	7	6	13	0	1	14	0	0
22	6998949	.	G	T	6	7	13	0	0	13	0	0
22	6998988	.	T	C	6	8	14	0	1	16	1	0
22	6999006	.	A	G	7	8	15	0	0	15	0	0
22	6999060	.	G	C	4	1	5	0	5	10	0	0
22	6999148	.	T	A	3	5	8	0	1	9	0	0
22	7006913	.	T	C	1	0	1	0	2	3	0	0
22	7009333	.	A	T	23	11	34	1	1	36	0	0
22	7009833	.	C	T	4	4	8	0	1	9	0	0
22	7009835	.	T	G	5	4	9	0	0	9	0	0
22	7009911	.	A	G	7	8	15	0	1	16	0	0
22	7009915	.	C	T	2	8	10	0	7	17	0	0
22	7010011	.	A	C	16	21	37	0	2	39	0	0
22	7010100	.	T	C	18	0	18	0	17	35	0	0
22	7010151	.	T	C	15	15	30	0	1	31	0	0
22	7012898	.	C	T	1	5	6	0	16	22	0	0
22	7012931	.	C	G	16	8	24	0	0	24	0	0
22	7016655	.	A	G	7	8	15	0	2	17	0	0
22	7018223	.	G	A	4	4	8	0	0	8	0	0
22	7019397	.	C	A	0	9	9	0	7	16	0	0
22	7019701	.	T	A	5	7	12	0	2	14	0	0
22	7044634	.	C	G	7	6	13	0	1	14	0	0
22	7044667	.	T	G	3	6	9	0	0	9	0	0
22	7044681	.	T	C	1	4	5	0	0	5	0	0
22	7045031	.	G	A	10	6	16	0	0	16	0	0
22	7045041	.	C	A	10	5	15	0	1	16	0	0
22	7045070	.	C	T	10	3	13	0	1	14	0	0
22	7045215	.	A	G	2	3	5	0	0	5	0	0
22	7056645	.	C	T	2	4	6	0	0	6	0	0
22	7682820	.	T	A	5	2	7	6	0	13	0	0
22	7682825	.	T	G	4	2	6	6	1	13	0	0
22	7683065	.	G	C	2	4	6	0	0	6	0	0
22	7972538	.	C	T	1	2	3	3	4	10	0	0
22	7972544	.	G	A	3	5	8	3	0	11	0	0
22	7972792	.	A	G	5	5	10	2	1	13	0	0
22	7972848	.	A	G	10	7	17	1	0	18	0	0
22	7972851	.	T	C	10	6	16	1	0	17	0	0
22	7974164	.	C	A	6	6	12	2	0	14	0	0
22	7974302	.	C	G	2	3	5	0	0	5	0	0
22	8074067	.	C	T	0	2	2	0	2	4	0	0
22	8074093	.	T	A	2	2	4	2	0	6	0	0
22	8161804	.	T	G	3	2	5	0	0	5	0	0
22	8161809	.	T	C	2	0	2	0	2	4	0	0
22	8162059	.	C	T	0	3	3	0	7	10	0	0
22	8163863	.	T	C	1	0	1	0	3	4	0	0
22	8163917	.	G	A	5	3	8	0	0	8	0	0
22	8164035	.	C	T	4	3	7	0	0	7	0	0
22	8239945	.	T	C	3	6	9	0	0	9	0	0
22	8239955	.	G	T	3	6	9	0	1	10	0	0
22	8240175	.	C	A	0	7	7	0	4	11	0	0
22	8240449	.	C	T	4	2	6	0	0	6	0	0
22	8240459	.	G	T	4	2	6	0	0	6	0	0
22	8240737	.	A	C	3	3	6	0	0	6	0	0
22	8241054	.	G	A	1	2	3	0	0	3	0	0
22	8241066	.	A	G	1	2	3	0	0	3	0	0
22	8243184	.	T	A	2	2	4	0	0	4	0	0
22	8296763	.	G	T	4	2	6	0	0	6	0	0
22	8341943	.	C	T	1	2	3	0	0	3	0	0
22	8715470	.	A	T	1	3	4	0	0	4	0	0
22	8769388	.	G	A	4	2	6	0	1	7	0	0
22	8769393	.	C	T	3	4	7	0	0	7	0	0
22	8769431	.	A	G	2	2	4	1	0	5	0	0
22	8769518	.	G	C	5	3	8	0	0	8	0	0
22	8769782	.	C	T	2	2	4	0	0	4	0	0
22	8770013	.	G	A	1	4	5	0	1	6	0	0
22	8770302	.	T	C	1	2	3	0	1	4	0	0
22	8785914	.	C	T	1	3	4	0	0	4	0	0
22	9056761	.	G	T	4	2	6	6	6	18	0	0
22	9191254	.	C	T	2	3	5	0	0	5	0	0
22	9192769	.	G	A	3	3	6	0	0	6	0	0
22	9192810	.	T	G	4	4	8	0	0	8	0	0
22	9192811	.	C	T	4	4	8	0	0	8	0	0
22	9192849	.	T	G	2	3	5	0	0	5	0	0
22	9192853	.	G	C	2	3	5	0	0	5	0	0
22	9306945	.	A	G	2	3	5	2	0	7	0	0
22	9306948	.	C	G	2	3	5	2	0	7	0	0
22	9499762	.	T	C	2	3	5	0	0	5	0	0
22	9504689	.	C	T	4	3	7	0	0	7	0	0
22	9509637	.	G	A	0	3	3	0	4	7	0	0
22	9512565	.	A	C	2	10	12	0	4	16	0	0
22	9512829	.	A	G	1	4	5	1	1	7	0	0
22	9512881	.	T	G	6	2	8	1	2	11	0	0
22	9512885	.	T	G	6	6	12	1	0	13	0	0
22	9513039	.	C	T	6	4	10	0	0	10	0	0
22	9527409	.	T	C	1	2	3	0	0	3	0	0
22	9527439	.	G	T	1	3	4	0	0	4	0	0
22	9530328	.	T	C	2	2	4	0	0	4	0	0
22	9530388	.	C	T	2	2	4	0	0	4	0	0
22	9532431	.	G	A	5	4	9	0	0	9	0	0
22	9532455	.	T	C	1	7	8	0	0	8	0	0
22	9534066	.	C	T	6	4	10	0	5	15	0	0
22	9535914	.	G	A	5	10	15	1	0	16	0	0
22	9535932	.	C	A	10	6	16	1	1	18	0	0
22	9536134	.	G	A	8	7	15	0	8	23	0	0
22	9537583	.	T	C	10	23	33	0	16	49	0	0
22	9537640	.	T	C	30	12	42	0	1	43	0	0
22	9537859	.	C	T	13	10	23	0	2	25	0	0
22	9559554	.	C	T	1	2	3	2	0	5	0	0
22	9828638	.	A	G	0	2	2	0	1	3	0	0
22	9828661	.	T	C	1	0	1	0	2	3	0	0
22	9835108	.	C	T	2	2	4	0	0	4	0	0
22	9886990	.	C	T	0	5	5	0	3	8	0	0
22	9887434	.	G	A	3	6	9	0	0	9	0	0
22	9887881	.	A	G	2	3	5	1	0	6	0	0
22	9896120	.	G	A	1	2	3	0	0	3	0	0
22	9899279	.	A	G	1	1	2	2	1	5	0	0
22	9899402	.	A	G	5	4	9	0	1	10	0	0
22	9899453	.	T	C	2	2	4	0	0	4	0	0
22	9926475	.	A	G	2	3	5	0	0	5	0	0
22	10048389	.	G	T	4	3	7	0	0	7	0	0
22	10048454	.	T	C	1	3	4	0	0	4	0	0
22	10123910	.	G	C	8	13	21	0	0	21	0	0
22	10123962	.	T	C	11	0	11	0	11	22	0	0
22	10123998	.	C	T	1	13	14	0	19	33	0	0
22	10129878	.	A	G	4	4	8	0	1	9	0	0
22	10159001	.	C	T	3	3	6	0	0	6	0	0
22	10159339	.	C	T	1	4	5	0	0	5	0	0
22	10162958	.	A	T	4	5	9	0	0	9	0	0
22	10190801	.	T	C	5	3	8	0	0	8	0	0
22	10196055	.	A	T	3	5	8	0	0	8	0	0
22	10196058	.	T	A	3	4	7	0	0	7	0	0
22	10196291	.	T	C	7	5	12	0	0	12	0	0
22	10196297	.	A	T	4	6	10	0	1	11	0	0
22	10196330	.	C	T	9	3	12	1	0	13	0	0
22	10196468	.	A	T	6	4	10	0	0	10	0	0
22	10196483	.	A	G	7	3	10	0	0	10	0	0
22	10196508	.	T	A	4	5	9	0	0	9	0	0
22	10196813	.	A	G	12	0	12	0	11	23	0	0
22	10196821	.	C	T	11	12	23	0	1	24	0	0
22	10196928	.	G	A	0	7	7	0	8	15	0	0
22	10196929	.	G	A	8	7	15	0	0	15	0	0
22	10197180	.	T	A	17	8	25	0	0	25	0	0
22	10197195	.	T	C	13	6	19	0	0	19	0	0
22	10197215	.	A	G	8	10	18	0	1	19	0	0
22	10197395	.	G	T	1	6	7	1	13	21	0	0
22	10197404	.	T	G	0	21	21	1	1	23	0	0
22	10197433	.	T	A	16	8	24	0	0	24	0	0
22	10197957	.	C	A	13	9	22	0	1	23	0	0
22	10197966	.	C	T	12	11	23	0	0	23	0	0
22	10198018	.	A	C	14	7	21	0	1	22	0	0
22	10198075	.	T	G	7	1	8	0	6	14	0	0
22	10198120	.	A	T	9	2	11	0	0	11	0	0
22	10198167	.	G	A	6	10	16	0	1	17	0	0
22	10198211	.	T	C	5	10	15	0	0	15	0	0
22	10198232	.	T	A	5	10	15	0	0	15	0	0
22	10198335	.	A	C	16	12	28	0	5	33	0	0
22	10198359	.	G	A	21	14	35	0	2	37	0	0
22	10198399	.	T	A	21	18	39	0	2	41	0	0
22	10205736	.	C	T	12	6	18	0	0	18	0	0
22	10208212	.	C	T	20	11	31	0	0	31	0	0
22	10210467	.	T	C	17	16	33	0	2	35	0	0
22	10212089	.	C	T	29	22	51	0	1	52	0	0
22	10212161	.	A	C	25	27	52	0	3	55	0	0
22	10212307	.	C	T	22	21	43	0	2	45	0	0
22	10212416	.	T	A	9	11	20	0	0	20	0	0
22	10218916	.	T	A	1	2	3	0	0	3	0	0
22	10219030	.	T	C	5	2	7	0	0	7	0	0
22	10261512	.	G	T	4	2	6	0	2	8	0	0
22	10261723	.	A	G	5	5	10	0	1	11	0	0
22	10261792	.	T	A	6	7	13	0	2	15	0	0
22	10261853	.	G	A	9	11	20	0	0	20	0	0
22	10261905	.	T	C	9	14	23	0	0	23	0	0
22	10262236	.	T	G	13	11	24	0	1	25	0	0
22	10282401	.	C	A	1	2	3	0	0	3	0	0
22	10361190	.	A	T	2	2	4	0	0	4	0	0
22	10361385	.	C	G	7	5	12	0	0	13	1	0
22	10361391	.	T	C	5	6	11	0	0	11	0	0
22	10361577	.	G	C	7	0	7	0	12	19	0	0
22	10361937	.	C	T	2	9	11	0	6	17	0	0
22	10362072	.	G	A	15	4	19	0	1	20	0	0
22	10362239	.	G	A	6	5	11	0	2	13	0	0
22	10368054	.	A	T	3	6	9	0	1	10	0	0
22	10372950	.	A	C	3	0	3	0	5	8	0	0
22	10427283	.	C	T	0	2	2	0	3	5	0	0
22	10430183	.	C	A	1	2	3	0	3	6	0	0
22	10430369	.	A	T	3	6	9	0	0	9	0	0
22	10432072	.	A	G	3	3	6	0	0	6	0	0
22	10432123	.	A	G	1	3	4	0	1	5	0	0
22	10513731	.	G	A	0	2	2	0	5	7	0	0
22	10513750	.	G	A	6	2	8	0	1	9	0	0
22	10513783	.	T	C	5	3	8	0	0	8	0	0
22	10514288	.	G	T	9	16	25	0	3	28	0	0
22	10514302	.	C	T	0	10	10	0	9	19	0	0
22	10517306	.	G	T	0	2	2	0	1	3	0	0
22	10540812	.	G	T	8	7	15	0	0	15	0	0
22	10553526	.	G	A	4	4	8	0	0	8	0	0
22	10553532	.	C	T	4	4	8	0	0	8	0	0
22	10553620	.	G	T	2	2	4	0	1	5	0	0
22	10553626	.	G	A	3	4	7	0	0	7	0	0
22	10557870	.	T	G	4	4	8	0	0	8	0	0
22	10557898	.	C	T	6	8	14	0	0	14	0	0
22	10558913	.	G	A	1	4	5	0	5	10	0	0
22	10561255	.	A	T	15	10	25	0	1	26	0	0
22	10561514	.	A	G	9	8	17	0	0	17	0	0
22	10561758	.	A	G	13	5	18	0	0	18	0	0
22	10592056	.	A	G	4	4	8	0	0	8	0	0
22	10592059	.	A	G	4	4	8	0	0	8	0	0
22	10592426	.	C	A	5	4	9	0	1	10	0	0
22	10592719	.	T	C	12	8	20	0	0	20	0	0
22	10593310	.	A	G	11	7	18	0	1	19	0	0
22	10593527	.	A	G	9	8	17	0	1	18	0	0
22	10593531	.	G	A	9	7	16	0	1	17	0	0
22	10593831	.	T	C	7	4	11	0	2	13	0	0
22	10593990	.	A	G	4	5	9	0	0	9	0	0
22	10594008	.	G	T	4	4	8	0	0	8	0	0
22	10594074	.	C	T	5	4	9	0	0	9	0	0
22	10594098	.	G	A	7	5	12	0	0	12	0	0
22	10597470	.	A	T	4	2	6	0	5	11	0	0
22	10597715	.	T	C	4	0	4	0	4	8	0	0
22	10599510	.	A	G	2	4	6	0	0	6	0	0
22	10600175	.	T	C	1	2	3	0	0	3	0	0
22	10626873	.	C	T	2	2	4	0	0	4	0	0
22	10631774	.	C	G	1	2	3	0	0	3	0	0
22	10634437	.	G	A	2	3	5	0	2	7	0	0
22	10634810	.	T	C	1	2	3	0	1	4	0	0
22	10634822	.	G	A	3	3	6	0	0	6	0	0
22	10635402	.	G	A	2	3	5	0	0	5	0	0
22	10636581	.	T	C	2	7	9	0	0	9	0	0
22	10636974	.	G	C	7	6	13	0	1	14	0	0
22	10637232	.	A	G	11	16	27	0	0	27	0	0
22	10637253	.	T	C	12	10	22	0	1	23	0	0
22	10637298	.	C	A	14	7	21	0	1	22	0	0
22	10637669	.	G	T	6	6	12	0	2	14	0	0
22	10637729	.	T	C	8	6	14	0	0	14	0	0
22	10638536	.	A	T	11	12	23	0	0	23	0	0
22	10638700	.	T	C	4	4	8	0	0	8	0	0
22	10638887	.	T	C	6	15	21	0	1	22	0	0
22	10638932	.	G	A	0	9	9	0	5	14	0	0
22	10638974	.	G	A	4	2	6	0	0	6	0	0
22	10654549	.	C	T	3	2	5	0	1	6	0	0
22	10657947	.	T	C	3	4	7	0	0	7	0	0
22	10657955	.	G	A	0	2	2	0	4	6	0	0
22	10660261	.	A	T	11	14	25	0	1	26	0	0
22	10662886	.	C	T	8	9	17	0	1	18	0	0
22	10662952	.	C	T	15	11	26	0	0	26	0	0
22	10663090	.	G	T	2	14	16	0	14	30	0	0
22	10663390	.	T	G	11	7	18	0	1	19	0	0
22	10663433	.	A	T	13	8	21	0	3	24	0	0
22	10663469	.	T	A	13	10	23	0	0	23	0	0
22	10663504	.	T	A	15	14	29	0	0	29	0	0
22	10663567	.	A	T	16	20	36	0	4	40	0	0
22	10663915	.	A	T	1	2	3	0	1	4	0	0
22	10690497	.	T	A	6	3	9	0	1	10	0	0
22	10704081	.	T	G	2	0	2	0	2	4	0	0
22	10704255	.	A	C	5	2	7	0	0	7	0	0
22	10706462	.	G	A	0	9	9	0	7	16	0	0
22	10706586	.	T	G	2	8	10	0	1	11	0	0
22	10706603	.	G	A	0	8	8	0	3	11	0	0
22	10726968	.	T	C	2	5	7	0	0	7	0	0
22	10729626	.	C	T	5	4	9	0	0	9	0	0
22	10729675	.	C	A	8	6	14	0	1	15	0	0
22	10733284	.	C	G	5	0	5	1	13	19	0	0
22	10733360	.	A	G	7	0	7	0	7	14	0	0
22	10733512	.	C	T	8	6	14	0	0	14	0	0
22	10733554	.	G	A	8	7	15	0	1	16	0	0
22	10733977	.	A	G	4	2	6	0	2	8	0	0
22	10733992	.	A	T	5	2	7	0	1	8	0	0
22	10734916	.	G	A	13	6	19	0	0	19	0	0
22	10734941	.	C	T	10	3	13	0	3	16	0	0
22	10735015	.	C	A	3	4	7	0	0	7	0	0
22	10755600	.	A	G	14	14	28	0	2	30	0	0
22	10755652	.	T	A	9	8	17	0	1	18	0	0
22	10755746	.	G	T	33	9	42	0	3	45	0	0
22	10755888	.	T	C	21	12	33	0	0	33	0	0
22	10771195	.	C	T	1	10	11	0	8	19	0	0
22	10771284	.	T	C	9	8	17	0	1	18	0	0
22	10771369	.	G	A	14	18	32	0	2	34	0	0
22	10771415	.	A	T	9	14	23	0	3	26	0	0
22	10771628	.	T	C	9	3	12	0	0	12	0	0
22	10771743	.	C	G	12	4	16	0	1	17	0	0
22	10771752	.	G	A	9	4	13	0	0	13	0	0
22	10771919	.	T	C	7	1	8	0	11	19	0	0
22	10774628	.	G	A	6	6	12	0	1	13	0	0
22	10774632	.	T	C	5	6	11	0	1	12	0	0
22	10795696	.	C	G	5	5	10	0	0	10	0	0
22	10795745	.	T	C	4	2	6	0	1	7	0	0
22	10816880	.	T	C	2	0	2	0	2	4	0	0
22	11071416	.	G	C	2	4	6	0	0	6	0	0
22	11071505	.	A	G	2	3	5	0	0	5	0	0
22	11071568	.	C	A	9	3	12	0	0	12	0	0
22	11071698	.	T	G	3	4	7	0	2	9	0	0
22	11075978	.	A	G	2	3	5	0	0	5	0	0
22	11078944	.	C	A	0	2	2	0	1	3	0	0
22	11123770	.	C	T	30	16	46	0	5	51	0	0
22	11123889	.	T	C	24	12	36	0	3	39	0	0
22	11124524	.	T	C	23	27	50	0	0	50	0	0
22	11126857	.	A	G	26	17	43	0	1	44	0	0
22	11126866	.	G	A	25	17	42	0	1	43	0	0
22	11129995	.	G	A	18	11	29	0	0	29	0	0
22	11130058	.	T	C	14	0	14	0	8	22	0	0
22	11135408	.	G	A	15	9	24	1	0	25	0	0
22	11135446	.	G	A	16	7	23	1	3	27	0	0
22	11136606	.	G	A	7	7	14	0	1	15	0	0
22	11157302	.	G	T	6	2	8	0	0	8	0	0
22	11161201	.	T	C	2	3	5	0	1	6	0	0
22	11170855	.	T	C	4	5	9	1	2	12	0	0
22	11170954	.	T	C	10	4	14	0	0	14	0	0
22	11170966	.	T	G	9	1	10	0	2	12	0	0
22	11171086	.	G	A	13	10	23	0	0	23	0	0
22	11188598	.	C	T	4	5	9	0	0	9	0	0
22	11199942	.	T	A	21	15	36	0	1	37	0	0
22	11200242	.	T	G	2	6	8	0	0	8	0	0
22	11200401	.	G	A	1	17	18	0	10	28	0	0
22	12163370	.	T	A	1	2	3	0	0	3	0	0
22	12171293	.	G	A	4	2	6	0	0	6	0	0
22	12174573	.	T	G	7	6	13	0	0	13	0	0
22	12174740	.	A	G	5	6	11	0	1	12	0	0
22	12175021	.	T	G	17	1	18	0	11	29	0	0
22	12175181	.	T	C	8	6	14	0	0	14	0	0
22	12175556	.	A	G	7	0	7	0	8	15	0	0
22	12175583	.	A	T	8	9	17	0	1	18	0	0
22	12176043	.	G	T	12	6	18	0	1	19	0	0
22	12243380	.	G	A	2	2	4	0	0	4	0	0
22	12247778	.	G	A	1	2	3	0	0	3	0	0
22	12259405	.	C	T	1	3	4	0	0	4	0	0
22	12641723	.	G	A	3	2	5	0	0	5	0	0
22	12641724	.	G	A	3	2	5	0	0	5	0	0
22	13459294	.	A	G	7	6	13	0	0	13	0	0
22	13459472	.	T	A	10	9	19	0	2	21	0	0
22	13459596	.	T	C	10	0	10	0	4	14	0	0
22	13459611	.	A	G	9	5	14	0	0	14	0	0
22	13459636	.	G	T	13	6	19	0	2	21	0	0
22	13459718	.	A	G	8	10	18	0	1	19	0	0
22	13459865	.	G	C	4	0	4	0	9	13	0	0
22	13460191	.	T	C	13	9	22	0	0	22	0	0
22	13460406	.	T	C	10	12	22	0	0	22	0	0
22	13460441	.	C	T	3	7	10	0	7	17	0	0
22	13460483	.	A	G	9	6	15	0	1	16	0	0
22	13460509	.	T	G	6	5	11	0	2	13	0	0
22	13461012	.	A	G	5	3	8	0	0	8	0	0
22	13461529	.	T	G	4	4	8	0	0	8	0	0
22	13462863	.	T	C	5	5	10	0	1	11	0	0
22	13463071	.	A	G	1	6	7	0	0	7	0	0
22	13472514	.	G	A	3	3	6	0	0	6	0	0
22	13479802	.	G	A	2	3	5	0	0	5	0	0
22	13716333	.	T	A	4	2	6	0	0	6	0	0
22	13846395	.	T	A	13	11	24	0	0	24	0	0
22	13846606	.	G	A	14	11	25	0	1	26	0	0
22	13846788	.	C	A	6	9	15	0	0	15	0	0
22	13847783	.	A	G	30	31	61	0	1	62	0	0
22	13847797	.	C	G	29	28	57	0	4	61	0	0
22	13847940	.	G	A	21	14	35	0	1	36	0	0
22	13848006	.	A	C	16	0	16	0	23	39	0	0
22	13848031	.	G	A	18	23	41	0	1	42	0	0
22	13848085	.	G	A	27	13	40	0	0	40	0	0
22	13848106	.	A	G	28	7	35	0	1	36	0	0
22	13850865	.	A	G	25	18	43	0	2	45	0	0
22	13939993	.	G	C	1	3	4	0	0	4	0	0
22	13940036	.	T	C	1	3	4	0	0	4	0	0
22	14366222	.	G	A	2	2	4	0	0	4	0	0
22	14366267	.	C	T	1	2	3	0	0	3	0	0
22	14381857	.	T	G	1	2	3	0	0	3	0	0
22	14381873	.	T	C	1	2	3	0	0	3	0	0
22	14851158	.	A	C	1	5	6	0	0	6	0	0
22	15721562	.	C	T	1	2	3	0	3	6	0	0
22	16312414	.	T	C	7	3	10	0	0	10	0	0
22	16341498	.	G	A	0	2	2	0	1	3	0	0
22	16345485	.	A	G	1	3	4	0	0	4	0	0
22	16345630	.	C	T	1	4	5	0	0	5	0	0
22	16345668	.	C	A	2	2	4	0	0	4	0	0
22	16350682	.	G	A	14	19	33	0	3	36	0	0
22	16350792	.	T	A	21	27	48	0	3	51	0	0
22	16350811	.	T	G	21	15	36	0	8	44	0	0
22	16350862	.	C	T	26	5	31	0	0	31	0	0
22	16350877	.	T	A	26	6	32	0	1	33	0	0
22	16351141	.	G	A	17	7	24	0	0	24	0	0
22	16351199	.	C	G	18	9	27	0	2	29	0	0
22	16351345	.	A	T	6	4	10	0	0	10	0	0
22	16351353	.	G	A	5	3	8	0	0	8	0	0
22	16352215	.	A	G	6	6	12	0	1	13	0	0
22	16352249	.	T	C	5	7	12	0	1	13	0	0
22	16352269	.	T	G	5	8	13	0	0	13	0	0
22	16352668	.	T	C	11	0	11	0	7	18	0	0
22	16352768	.	A	G	12	7	19	0	0	19	0	0
22	16357818	.	A	G	3	4	7	0	0	7	0	0
22	16357831	.	A	G	4	4	8	0	0	8	0	0
22	16357867	.	G	A	4	3	7	0	0	7	0	0
22	16357909	.	C	T	4	3	7	0	1	8	0	0
22	16367007	.	T	C	1	0	1	0	4	5	0	0
22	16367055	.	A	G	3	4	7	0	0	7	0	0
22	16377364	.	A	G	2	4	6	0	0	6	0	0
22	16407115	.	A	T	2	4	6	0	0	6	0	0
22	16407136	.	C	T	3	6	9	0	0	9	0	0
22	16412091	.	A	G	1	3	4	0	0	4	0	0
22	16423042	.	G	A	1	11	12	0	7	19	0	0
22	16424576	.	T	C	7	5	12	0	0	12	0	0
22	16427969	.	A	G	16	0	16	0	12	28	0	0
22	16428005	.	C	A	19	8	27	0	0	27	0	0
22	16430623	.	G	A	12	11	23	0	3	26	0	0
22	16430782	.	T	A	14	13	27	0	0	27	0	0
22	16433009	.	G	A	4	4	8	0	1	9	0	0
22	16433054	.	T	A	7	11	18	0	0	18	0	0
22	16433078	.	G	A	8	10	18	0	0	18	0	0
22	16433096	.	A	G	10	13	23	0	0	23	0	0
22	16433895	.	T	C	7	3	10	0	0	10	0	0
22	16433912	.	T	A	9	3	12	0	1	13	0	0
22	16433940	.	C	T	9	4	13	0	4	17	0	0
22	16434056	.	G	A	11	6	17	0	0	17	0	0
22	16440072	.	G	A	1	4	5	0	1	6	0	0
22	16440086	.	T	C	4	0	4	0	5	9	0	0
22	16442789	.	A	G	5	7	12	0	0	12	0	0
22	16442796	.	T	A	6	7	13	0	0	13	0	0
22	16477548	.	C	T	1	3	4	0	0	4	0	0
22	16484167	.	A	T	4	4	8	0	0	8	0	0
22	16484489	.	G	C	29	1	30	0	10	40	0	0
22	16484712	.	C	T	5	5	10	0	0	10	0	0
22	16484877	.	A	T	7	7	14	0	3	17	0	0
22	16484938	.	A	G	11	16	27	0	0	27	0	0
22	16484944	.	T	C	12	13	25	0	0	25	0	0
22	16485238	.	A	C	12	9	21	0	3	24	0	0
22	16485379	.	A	T	8	10	18	0	1	19	0	0
22	16485538	.	T	C	2	0	2	0	10	12	0	0
22	16485563	.	A	T	3	6	9	0	0	9	0	0
22	16485688	.	G	A	2	2	4	0	0	4	0	0
22	16485768	.	G	A	2	2	4	0	0	4	0	0
22	16485920	.	G	A	7	5	12	0	0	12	0	0
22	16485962	.	C	G	9	5	14	0	0	14	0	0
22	16486027	.	G	A	5	5	10	0	1	11	0	0
22	16486102	.	G	A	4	5	9	0	0	9	0	0
22	16486112	.	T	C	5	5	10	0	0	10	0	0
22	16491711	.	C	A	10	4	14	0	0	14	0	0
22	16491942	.	G	A	5	10	15	0	0	15	0	0
22	16498232	.	T	C	15	15	30	0	1	31	0	0
22	16498333	.	A	C	15	15	30	0	2	32	0	0
22	16498661	.	A	G	16	0	16	0	13	29	0	0
22	16537854	.	C	T	5	2	7	0	0	7	0	0
22	16537878	.	C	A	6	4	10	0	0	10	0	0
22	16544243	.	C	T	6	6	12	0	1	13	0	0
22	16544384	.	G	A	7	8	15	0	2	17	0	0
22	16544400	.	T	G	10	7	17	0	1	18	0	0
22	16544599	.	A	G	13	1	14	0	11	25	0	0
22	16544674	.	T	G	15	17	32	0	2	34	0	0
22	16544780	.	A	T	13	10	23	0	3	26	0	0
22	16544800	.	G	A	13	13	26	0	0	26	0	0
22	16594852	.	G	A	2	2	4	0	2	6	0	0
22	16594870	.	T	A	4	3	7	0	0	7	0	0
22	16601400	.	C	T	2	2	4	0	0	4	0	0
22	16601422	.	C	T	1	4	5	0	2	7	0	0
22	16775197	.	G	A	2	13	15	0	14	29	0	0
22	16775284	.	T	G	12	13	25	0	2	27	0	0
22	16775306	.	C	T	11	12	23	0	3	26	0	0
22	16862842	.	A	G	2	4	6	0	0	6	0	0
22	17197209	.	T	A	1	5	6	0	2	8	0	0
22	17197367	.	A	T	7	5	12	0	1	13	0	0
22	17200635	.	G	A	17	8	25	0	0	25	0	0
22	17200890	.	G	A	9	15	24	0	0	24	0	0
22	17200985	.	A	C	8	16	24	0	0	24	0	0
22	17201015	.	C	G	9	11	20	0	1	21	0	0
22	17201102	.	C	G	14	12	26	0	1	27	0	0
22	17201135	.	G	A	9	11	20	0	1	21	0	0
22	17201172	.	C	T	3	5	8	0	0	8	0	0
22	17201617	.	T	G	2	3	5	0	1	6	0	0
22	17208695	.	A	G	1	2	3	0	1	4	0	0
22	17208770	.	T	C	3	2	5	0	0	5	0	0
22	17208913	.	A	C	2	3	5	0	0	5	0	0
22	17208973	.	G	A	4	2	6	0	0	6	0	0
22	17208983	.	T	C	5	2	7	0	0	7	0	0
22	17209384	.	A	C	6	4	10	0	0	10	0	0
22	17209413	.	T	A	9	4	13	0	1	14	0	0
22	17209484	.	T	A	10	3	13	0	0	13	0	0
22	17209492	.	T	A	8	4	12	0	2	14	0	0
22	17209523	.	A	T	9	8	17	0	0	17	0	0
22	17209737	.	T	C	7	3	10	0	1	11	0	0
22	17209762	.	T	C	9	4	13	0	1	14	0	0
22	17209858	.	C	A	7	5	12	0	1	13	0	0
22	17209872	.	A	G	11	0	11	0	4	15	0	0
22	17209986	.	A	T	7	2	9	0	2	11	0	0
22	17209993	.	A	T	6	3	9	0	1	10	0	0
22	17210053	.	C	G	5	3	8	0	0	8	0	0
22	17210157	.	T	A	15	8	23	0	0	23	0	0
22	17210196	.	C	G	15	0	15	0	7	22	0	0
22	17210820	.	A	C	30	13	43	0	3	46	0	0
22	17210825	.	G	A	2	14	16	0	30	46	0	0
22	17211295	.	T	C	15	6	21	0	0	21	0	0
22	17211343	.	C	T	16	12	28	0	0	28	0	0
22	17211361	.	A	G	16	12	28	0	0	28	0	0
22	17211431	.	C	T	12	15	27	0	2	29	0	0
22	17211438	.	T	C	13	13	26	0	3	29	0	0
22	17211875	.	G	C	24	15	39	0	1	40	0	0
22	17211990	.	A	G	16	24	40	0	0	40	0	0
22	17212235	.	T	A	14	17	31	0	4	35	0	0
22	17212236	.	T	C	13	20	33	0	1	34	0	0
22	17231190	.	C	T	6	2	8	0	0	8	0	0
22	17231194	.	T	C	5	2	7	0	0	7	0	0
22	17234620	.	G	A	1	5	6	0	6	12	0	0
22	17318635	.	G	T	0	2	2	0	2	4	0	0
22	17359735	.	A	G	1	0	1	0	3	4	0	0
22	17359816	.	G	C	0	3	3	0	1	4	0	0
22	17360107	.	C	A	6	8	14	0	0	14	0	0
22	17360428	.	G	A	0	3	3	0	5	8	0	0
22	17446858	.	T	C	13	17	30	0	0	30	0	0
22	17448778	.	G	A	10	9	19	0	1	20	0	0
22	17448781	.	C	T	9	8	17	0	2	19	0	0
22	17450115	.	G	A	1	11	12	0	11	23	0	0
22	17452798	.	C	T	8	14	22	0	3	25	0	0
22	17453286	.	T	G	22	18	40	0	3	43	0	0
22	17453336	.	A	G	15	0	15	0	16	31	0	0
22	17453419	.	G	A	12	9	21	0	1	22	0	0
22	17453478	.	T	A	15	15	30	0	1	31	0	0
22	17453552	.	T	C	8	6	14	0	2	16	0	0
22	17453680	.	C	T	16	8	24	0	2	26	0	0
22	17453688	.	A	G	13	10	23	0	3	26	0	0
22	17453742	.	A	G	8	10	18	0	1	19	0	0
22	17453836	.	A	G	11	13	24	0	3	27	0	0
22	17453883	.	A	T	16	15	31	0	0	31	0	0
22	17453884	.	T	C	17	14	31	0	1	32	0	0
22	17454015	.	T	C	20	12	32	0	0	32	0	0
22	17454038	.	G	T	16	13	29	0	0	29	0	0
22	17454120	.	C	T	8	10	18	0	0	18	0	0
22	17454178	.	A	G	11	0	11	0	14	25	0	0
22	17454179	.	T	G	11	13	24	0	1	25	0	0
22	17454320	.	T	C	18	18	36	0	1	37	0	0
22	17454424	.	C	T	3	3	6	0	0	6	0	0
22	17501623	.	G	C	8	12	20	0	0	20	0	0
22	17505820	.	A	C	26	24	50	0	4	54	0	0
22	17506536	.	A	T	25	15	40	0	2	42	0	0
22	17506537	.	T	G	23	17	40	0	1	41	0	0
22	17531044	.	G	A	0	8	8	0	6	14	0	0
22	17531188	.	A	G	10	9	19	0	1	20	0	0
22	17533907	.	C	T	6	13	19	0	0	19	0	0
22	17539297	.	C	T	30	25	55	0	2	57	0	0
22	17539633	.	G	A	33	26	59	0	2	61	0	0
22	17540807	.	C	T	28	31	59	0	1	60	0	0
22	17541191	.	T	G	6	5	11	0	1	12	0	0
22	17541450	.	C	A	17	11	28	0	4	32	0	0
22	17541593	.	G	A	17	17	34	1	1	36	0	0
22	17542016	.	C	T	18	15	33	0	0	33	0	0
22	17542057	.	C	T	16	10	26	0	1	27	0	0
22	17542117	.	T	C	11	10	21	0	0	21	0	0
22	17542136	.	G	A	10	11	21	0	1	22	0	0
22	17542199	.	A	T	3	9	12	0	0	12	0	0
22	17542293	.	C	T	11	6	17	0	0	17	0	0
22	17542594	.	G	T	8	4	12	0	1	13	0	0
22	17542702	.	G	A	3	3	6	0	0	6	0	0
22	17542944	.	T	C	3	3	6	0	2	8	0	0
22	17542978	.	A	G	4	2	6	0	0	6	0	0
22	17543079	.	C	G	2	2	4	0	0	4	0	0
22	17543408	.	A	G	3	4	7	0	0	7	0	0
22	17543421	.	G	A	1	2	3	0	2	5	0	0
22	17543552	.	G	A	4	4	8	0	0	8	0	0
22	17543634	.	A	C	7	4	11	0	0	11	0	0
22	17543668	.	A	T	3	2	5	0	1	6	0	0
22	17543903	.	A	G	6	5	11	0	0	11	0	0
22	17550643	.	T	C	6	0	6	0	3	9	0	0
22	17550664	.	G	A	5	3	8	0	0	8	0	0
22	17550684	.	C	T	0	4	4	0	8	12	0	0
22	17550724	.	T	G	4	3	7	0	0	7	0	0
22	17552526	.	A	G	4	4	8	0	0	8	0	0
22	17554785	.	G	A	7	5	12	0	0	12	0	0
22	17560376	.	A	C	3	2	5	0	0	5	0	0
22	17564009	.	T	C	3	2	5	0	1	6	0	0
22	17565735	.	C	T	4	4	8	0	0	8	0	0
22	17590019	.	G	A	30	20	50	0	2	52	0	0
22	17590037	.	C	T	24	26	50	0	2	52	0	0
22	17591712	.	G	A	19	25	44	1	0	45	0	0
22	17596874	.	G	A	12	23	35	0	2	37	0	0
22	17596903	.	C	G	8	34	42	0	2	44	0	0
22	17596943	.	A	T	9	22	31	0	1	32	0	0
22	17606908	.	A	C	4	6	10	0	0	10	0	0
22	17607226	.	G	A	13	12	25	0	1	26	0	0
22	17609589	.	C	G	5	8	13	0	0	13	0	0
22	17830632	.	A	G	18	7	25	0	0	25	0	0
22	17830640	.	A	G	16	6	22	0	1	23	0	0
22	18156402	.	G	A	0	3	3	0	4	7	0	0
22	18168776	.	A	T	1	2	3	0	0	3	0	0
22	18213480	.	A	C	2	2	4	0	0	4	0	0
22	18214077	.	A	T	2	2	4	0	0	4	0	0
22	18231080	.	A	G	4	2	6	0	1	7	0	0
22	18231234	.	A	G	5	2	7	0	0	7	0	0
22	18231370	.	A	G	6	9	15	0	1	16	0	0
22	18231492	.	G	C	4	4	8	0	1	9	0	0
22	18231673	.	T	A	8	5	13	0	1	14	0	0
22	18231903	.	T	A	1	2	3	0	0	3	0	0
22	18231942	.	A	G	2	2	4	0	0	4	0	0
22	18232527	.	C	T	2	1	3	0	1	4	0	0
22	18232612	.	C	T	5	2	7	0	0	7	0	0
22	18232754	.	T	C	3	5	8	0	1	9	0	0
22	18232868	.	G	T	1	5	6	0	0	6	0	0
22	18232935	.	T	G	4	7	11	0	0	11	0	0
22	18233053	.	C	A	5	4	9	0	1	10	0	0
22	18233143	.	T	A	1	4	5	0	0	5	0	0
22	18233367	.	T	A	1	6	7	0	0	7	0	0
22	18233747	.	T	C	3	5	8	0	1	9	0	0
22	18376359	.	C	A	3	1	4	0	1	5	0	0
22	18376467	.	A	C	1	2	3	0	0	3	0	0
22	18383311	.	G	T	0	5	5	0	3	8	0	0
22	18383996	.	C	T	5	1	6	0	2	8	0	0
22	18384306	.	G	T	6	8	14	0	1	15	0	0
22	18384330	.	T	G	7	8	15	0	0	15	0	0
22	18384352	.	G	C	6	12	18	0	1	19	0	0
22	18459182	.	C	T	6	4	10	0	0	10	0	0
22	18461964	.	C	T	6	4	10	0	2	12	0	0
22	18462018	.	A	G	8	5	13	0	1	14	0	0
22	18462239	.	C	T	5	9	14	0	1	15	0	0
22	18464455	.	T	C	13	5	18	0	0	18	0	0
22	18488823	.	T	C	6	4	10	0	0	10	0	0
22	18488952	.	C	A	1	2	3	0	0	3	0	0
22	18489191	.	A	G	5	4	9	0	0	9	0	0
22	18530449	.	G	C	0	2	2	0	1	3	0	0
22	18530697	.	A	C	2	3	5	0	0	5	0	0
22	18542090	.	C	T	40	17	57	1	3	61	0	0
22	18542393	.	C	T	20	14	34	0	0	34	0	0
22	18542720	.	A	T	22	19	41	0	3	44	0	0
22	18543819	.	C	G	31	27	58	0	0	58	0	0
22	18543847	.	T	G	33	29	62	0	0	62	0	0
22	18544465	.	C	T	3	18	21	1	52	74	0	0
22	18544992	.	T	C	31	26	57	0	6	63	0	0
22	18725485	.	T	A	7	7	14	0	0	14	0	0
22	18726040	.	A	T	17	16	33	0	2	36	1	0
22	18726470	.	A	T	15	21	36	0	3	39	0	0
22	18726505	.	T	A	16	23	39	0	0	39	0	0
22	18726668	.	C	A	11	16	27	0	1	28	0	0
22	18727787	.	C	A	1	3	4	0	7	11	0	0
22	18727841	.	A	G	9	2	11	0	0	11	0	0
22	18727845	.	T	C	8	3	11	0	0	11	0	0
22	18727890	.	G	A	7	9	16	0	0	16	0	0
22	18736155	.	T	C	14	0	14	0	7	21	0	0
22	18736182	.	C	T	8	8	16	0	0	16	0	0
22	18736859	.	A	G	8	4	12	0	2	14	0	0
22	18778872	.	C	T	19	17	36	0	2	38	0	0
22	18778895	.	A	C	18	17	35	0	1	36	0	0
22	20951286	.	C	T	3	2	5	0	1	6	0	0
22	21303773	.	A	T	3	2	5	0	0	5	0	0
22	21361753	.	T	C	2	3	5	0	0	5	0	0
22	21365143	.	C	T	1	4	5	0	4	9	0	0
22	21465109	.	T	C	2	4	6	0	0	6	0	0
22	21465156	.	T	C	3	2	5	0	0	5	0	0
22	21465232	.	T	C	4	2	6	0	0	6	0	0
22	21465461	.	G	A	3	4	7	0	0	7	0	0
22	21465597	.	G	T	1	6	7	0	1	8	0	0
22	21465606	.	T	C	1	5	6	0	1	7	0	0
22	21583985	.	G	A	1	2	3	0	0	3	0	0
22	21657871	.	C	T	2	8	10	0	1	11	0	0
22	21661258	.	T	A	4	10	14	0	1	15	0	0
22	21661611	.	A	G	1	0	1	0	2	3	0	0
22	21661789	.	G	A	6	3	9	2	1	12	0	0
22	21662138	.	G	A	1	5	6	1	4	11	0	0
22	21852158	.	C	T	6	4	10	0	0	10	0	0
22	21852269	.	A	G	3	4	7	0	0	7	0	0
22	21852281	.	T	C	3	0	3	0	3	6	0	0
22	22129568	.	T	A	2	3	5	0	0	5	0	0
22	22129586	.	T	C	2	4	6	0	0	6	0	0
22	22130015	.	T	A	1	2	3	0	1	4	0	0
22	22130414	.	A	C	1	0	1	0	3	4	0	0
22	22130528	.	G	A	1	2	3	0	0	3	0	0
22	22141323	.	G	C	3	2	5	0	0	5	0	0
22	22141567	.	G	A	2	3	5	0	1	6	0	0
22	22141979	.	G	A	1	1	2	0	1	3	0	0
22	22179714	.	A	G	2	4	6	0	0	6	0	0
22	22179825	.	C	T	4	4	8	0	0	8	0	0
22	22188682	.	T	C	3	5	8	0	0	8	0	0
22	22188715	.	T	C	2	7	9	0	1	10	0	0
22	22188717	.	C	T	3	6	9	0	1	10	0	0
22	22234418	.	C	T	1	14	15	1	10	26	0	0
22	22234750	.	G	A	21	12	33	1	1	35	0	0
22	22240918	.	G	A	20	6	26	1	1	28	0	0
22	22241769	.	A	G	3	15	18	0	1	19	0	0
22	22245435	.	C	T	5	4	9	0	1	10	0	0
22	22245617	.	A	G	7	4	11	0	0	11	0	0
22	22245781	.	G	T	6	6	12	0	0	12	0	0
22	22245812	.	C	T	7	7	14	0	0	14	0	0
22	22259142	.	A	G	2	1	3	0	0	3	0	0
22	22259155	.	G	A	3	2	5	0	0	5	0	0
22	22273388	.	C	T	5	2	7	0	0	7	0	0
22	22273465	.	G	A	3	6	9	0	1	10	0	0
22	22274249	.	T	G	2	2	4	0	0	4	0	0
22	22276714	.	C	T	1	2	3	0	0	3	0	0
22	22277208	.	A	G	1	2	3	0	0	3	0	0
22	22277209	.	T	C	1	0	1	0	2	3	0	0
22	22313794	.	G	A	3	3	6	0	0	6	0	0
22	22314043	.	T	G	4	2	6	0	0	6	0	0
22	22314046	.	G	A	3	2	5	0	0	5	0	0
22	22314094	.	T	C	3	3	6	0	1	7	0	0
22	22314135	.	A	G	4	3	7	0	0	7	0	0
22	22314547	.	T	G	6	6	12	0	1	13	0	0
22	22314564	.	C	A	5	7	12	0	1	13	0	0
22	22314991	.	T	C	4	3	7	1	1	9	0	0
22	22315211	.	A	G	5	4	9	0	2	11	0	0
22	22315277	.	A	G	5	4	9	0	0	9	0	0
22	22345197	.	C	T	5	4	9	0	1	10	0	0
22	22348234	.	A	G	2	4	6	0	0	6	0	0
22	22351180	.	A	T	4	4	8	0	0	8	0	0
22	22352249	.	C	T	3	4	7	0	0	7	0	0
22	22352312	.	T	C	2	3	5	0	0	5	0	0
22	22352611	.	A	C	1	2	3	0	1	4	0	0
22	22353779	.	G	A	1	1	2	0	1	3	0	0
22	22418446	.	A	G	1	0	1	0	2	3	0	0
22	22418465	.	A	T	1	2	3	0	1	4	0	0
22	22420420	.	A	G	3	4	7	0	0	7	0	0
22	22420604	.	T	C	2	4	6	0	0	6	0	0
22	22420609	.	G	A	2	3	5	0	0	5	0	0
22	22420646	.	G	T	0	2	2	0	2	4	0	0
22	22421991	.	G	A	0	4	4	0	2	6	0	0
22	22422123	.	A	T	2	2	4	0	0	4	0	0
22	22424034	.	G	A	4	2	6	0	1	7	0	0
22	22424085	.	A	T	3	10	13	0	0	13	0	0
22	22424106	.	G	A	0	6	6	0	3	9	0	0
22	22425439	.	T	C	2	6	8	0	0	8	0	0
22	22427415	.	T	C	3	12	15	0	0	15	0	0
22	22427442	.	T	C	7	14	21	0	1	22	0	0
22	22427694	.	C	T	15	11	26	0	0	26	0	0
22	22428125	.	T	C	2	2	4	0	0	4	0	0
22	22979127	.	C	T	1	2	3	0	3	6	0	0
22	22981064	.	G	A	1	2	3	0	0	3	0	0
22	22982792	.	G	A	2	2	4	0	0	4	0	0
22	22982867	.	T	C	2	0	2	0	2	4	0	0
22	23105283	.	G	A	1	8	9	0	0	9	0	0
22	24157961	.	G	C	7	3	10	0	2	12	0	0
22	24158190	.	C	T	11	4	15	0	0	15	0	0
22	24158242	.	C	A	6	10	16	0	1	17	0	0
22	24158275	.	G	C	6	9	15	0	2	17	0	0
22	24167633	.	C	T	13	7	20	0	0	20	0	0
22	24168125	.	T	C	16	14	30	0	0	30	0	0
22	24168573	.	T	C	18	16	34	0	2	36	0	0
22	24168610	.	T	A	21	21	42	0	1	43	0	0
22	24218631	.	A	G	2	0	2	0	5	7	0	0
22	24218656	.	T	A	4	5	9	0	0	9	0	0
22	24220962	.	A	G	3	3	6	0	1	7	0	0
22	24221009	.	C	T	4	5	9	0	1	10	0	0
22	24224676	.	A	T	2	2	4	0	2	6	0	0
22	24225409	.	T	C	7	4	11	0	0	11	0	0
22	24229293	.	C	T	8	10	18	0	1	19	0	0
22	24229513	.	T	C	13	14	27	0	0	27	0	0
22	24229890	.	T	C	16	12	28	0	0	28	0	0
22	24230005	.	G	A	2	18	20	0	16	36	0	0
22	24230020	.	G	A	19	17	36	0	3	39	0	0
22	24233536	.	G	T	20	18	38	0	2	40	0	0
22	24359927	.	G	T	1	2	3	0	0	3	0	0
22	24360169	.	C	T	1	2	3	0	2	5	0	0
22	24361095	.	A	G	13	6	19	0	1	20	0	0
22	24621787	.	A	G	6	2	8	0	0	8	0	0
22	24715404	.	A	G	5	0	5	0	7	12	0	0
22	24716636	.	T	A	9	15	24	0	0	24	0	0
22	24717105	.	G	A	4	18	22	0	2	24	0	0
22	24718973	.	T	C	15	21	36	0	1	37	0	0
22	24724279	.	T	C	6	4	10	11	0	21	0	0
22	24724459	.	A	G	8	6	14	5	0	19	0	0
22	24975668	.	C	T	1	2	3	0	5	8	0	0
22	24975792	.	C	T	1	2	3	0	0	3	0	0
22	24981171	.	T	C	2	2	4	0	0	4	0	0
22	25028660	.	G	A	7	10	17	0	2	19	0	0
22	25028694	.	G	A	5	5	10	0	1	11	0	0
22	25028751	.	A	G	4	6	10	0	1	11	0	0
22	25029136	.	T	A	3	4	7	0	1	8	0	0
22	25032266	.	C	T	9	6	15	0	0	15	0	0
22	25032293	.	T	C	5	4	9	0	1	10	0	0
22	25032344	.	C	T	0	5	5	0	2	7	0	0
22	25032665	.	T	C	11	3	14	0	4	18	0	0
22	25032693	.	T	C	12	6	18	0	0	18	0	0
22	25038315	.	C	T	6	4	10	0	0	10	0	0
22	25038360	.	T	C	6	3	9	0	0	9	0	0
22	25038387	.	A	G	7	5	12	0	2	14	0	0
22	25038432	.	T	C	11	7	18	0	1	19	0	0
22	25040814	.	G	A	4	3	7	0	0	7	0	0
22	25040867	.	G	A	3	4	7	0	0	7	0	0
22	25059919	.	G	A	0	6	6	0	2	8	0	0
22	25063696	.	A	G	2	0	2	0	9	11	0	0
22	25063745	.	C	A	3	14	17	0	0	17	0	0
22	25063767	.	C	A	2	11	13	0	1	14	0	0
22	25066332	.	C	T	1	8	9	1	9	19	0	0
22	25066410	.	T	C	10	6	16	0	0	16	0	0
22	25066583	.	A	G	5	5	10	0	0	10	0	0
22	25066939	.	C	T	6	7	13	0	0	13	0	0
22	25067274	.	A	G	1	4	5	0	0	5	0	0
22	25067596	.	C	T	5	5	10	0	0	10	0	0
22	25076727	.	A	G	2	7	9	0	0	9	0	0
22	25078630	.	A	C	6	6	12	0	0	12	0	0
22	25101582	.	T	C	1	2	3	0	0	3	0	0
22	25566614	.	G	A	1	3	4	0	0	4	0	0
22	25573313	.	G	A	2	3	5	0	1	6	0	0
22	25580014	.	T	A	2	2	4	0	0	4	0	0
22	25582764	.	T	C	2	6	8	0	0	8	0	0
22	25586906	.	T	A	2	2	4	0	0	4	0	0
22	25587071	.	C	G	1	2	3	0	0	3	0	0
22	25845521	.	A	G	2	4	6	0	1	7	0	0
22	25845719	.	A	T	2	3	5	0	0	5	0	0
22	25934659	.	G	A	0	4	4	0	4	8	0	0
22	25934662	.	A	G	4	4	8	0	0	8	0	0
22	25935627	.	G	A	0	5	5	0	1	6	0	0
22	25937001	.	G	A	2	7	9	0	6	15	0	0
22	25937037	.	T	A	6	5	11	0	1	12	0	0
22	25937052	.	T	C	6	4	10	0	0	10	0	0
22	25939060	.	C	T	9	4	13	0	0	13	0	0
22	25939066	.	A	G	4	9	13	0	0	13	0	0
22	25940965	.	A	T	14	4	18	0	0	18	0	0
22	25942390	.	A	C	14	6	20	0	2	22	0	0
22	25942392	.	C	A	13	6	19	0	1	20	0	0
22	25942586	.	G	T	6	5	11	0	1	12	0	0
22	25942659	.	A	G	6	5	11	0	0	11	0	0
22	25942769	.	T	C	8	7	15	0	1	16	0	0
22	25942934	.	T	G	1	7	8	0	0	8	0	0
22	25942985	.	G	T	3	9	12	0	0	12	0	0
22	26239610	.	G	A	3	11	14	0	1	15	0	0
22	26239654	.	A	T	14	5	19	0	0	19	0	0
22	26239752	.	G	A	7	9	16	0	0	16	0	0
22	26239798	.	C	A	1	7	8	0	7	15	0	0
22	26239873	.	T	A	7	12	19	0	0	19	0	0
22	26239879	.	G	A	6	10	16	0	0	16	0	0
22	26244704	.	C	T	4	8	12	0	0	12	0	0
22	26264646	.	G	A	1	3	4	0	0	4	0	0
22	26264805	.	T	A	2	3	5	0	0	5	0	0
22	26264807	.	A	G	2	3	5	0	0	5	0	0
22	26265477	.	C	T	0	5	5	0	2	7	0	0
22	26266765	.	C	T	4	9	13	0	0	13	0	0
22	26266798	.	C	A	3	6	9	0	0	9	0	0
22	26266807	.	T	A	6	2	8	0	0	8	0	0
22	26274099	.	G	A	1	2	3	0	0	3	0	0
22	26274106	.	A	T	1	1	2	0	1	3	0	0
22	26277695	.	T	C	5	7	12	0	0	12	0	0
22	26277735	.	A	C	1	5	6	0	2	8	0	0
22	26277773	.	G	A	2	5	7	0	1	9	1	0
22	26277820	.	T	C	4	5	9	0	0	9	0	0
22	26277871	.	C	A	3	3	6	0	1	7	0	0
22	26278042	.	T	C	2	4	6	0	1	7	0	0
22	26278081	.	C	T	5	4	9	0	0	9	0	0
22	26281043	.	A	G	2	8	10	0	2	12	0	0
22	26289243	.	T	G	1	2	3	0	0	3	0	0
22	26290324	.	C	T	4	7	11	0	1	12	0	0
22	26290508	.	C	T	16	7	23	0	5	28	0	0
22	26301324	.	G	A	4	3	7	0	0	7	0	0
22	26311254	.	A	G	6	2	8	0	0	8	0	0
22	26524896	.	G	A	5	8	13	0	1	14	0	0
22	26524910	.	A	T	5	6	11	0	0	11	0	0
22	26526057	.	C	T	0	6	6	0	2	8	0	0
22	26526127	.	G	T	7	6	13	0	1	14	0	0
22	26526135	.	G	C	7	5	12	0	2	14	0	0
22	26526178	.	T	C	4	3	7	0	0	7	0	0
22	26526293	.	A	C	3	3	6	0	2	8	0	0
22	26526637	.	C	T	1	4	5	0	4	9	0	0
22	26526710	.	G	A	4	6	10	0	0	10	0	0
22	26526722	.	A	G	1	5	6	0	0	6	0	0
22	26526969	.	A	T	4	4	8	0	0	8	0	0
22	26527493	.	A	G	1	1	2	0	1	3	0	0
22	26527499	.	T	G	0	1	1	0	2	3	0	0
22	26527792	.	A	G	3	2	5	0	0	5	0	0
22	26528290	.	G	A	1	2	3	0	0	3	0	0
22	26528313	.	T	C	2	0	2	0	2	4	0	0
22	26528690	.	T	C	1	0	1	0	1	2	0	0
22	26528704	.	A	T	1	1	2	0	0	2	0	0
22	26528861	.	A	T	1	2	3	0	0	3	0	0
22	26858066	.	T	C	10	7	17	0	1	18	0	0
22	29858935	.	T	C	17	12	29	0	2	31	0	0
22	29858936	.	T	C	15	16	31	0	0	31	0	0
22	30020957	.	G	A	0	2	2	0	1	3	0	0
22	31668049	.	T	C	16	0	16	0	14	30	0	0
22	32291832	.	T	C	14	0	14	0	5	19	0	0
22	32291834	.	T	C	10	0	10	0	11	21	0	0
22	33592309	.	T	C	6	9	15	0	2	17	0	0
22	33592530	.	G	T	10	5	15	0	0	15	0	0
22	33639388	.	G	A	4	3	7	0	0	7	0	0
22	33791208	.	G	A	4	2	6	0	0	6	0	0
22	35473126	.	G	A	1	3	4	0	0	4	0	0
22	35531196	.	G	A	2	5	7	0	1	8	0	0
22	35531281	.	G	A	5	3	8	0	0	8	0	0
22	35531376	.	A	G	4	3	7	0	0	7	0	0
22	36524302	.	T	C	2	3	5	0	0	5	0	0
22	36524374	.	T	A	4	2	6	0	1	7	0	0
22	36527075	.	C	T	4	2	6	0	0	6	0	0
22	36527591	.	A	G	4	4	8	0	0	8	0	0
22	36596817	.	A	G	2	5	7	0	1	8	0	0
22	36598444	.	C	T	2	7	9	0	0	9	0	0
22	36598459	.	G	C	4	7	11	0	1	12	0	0
22	36601758	.	A	G	2	0	2	0	4	6	0	0
22	36601761	.	A	C	2	3	5	0	0	5	0	0
22	36616814	.	G	A	0	6	6	0	3	9	0	0
22	36622717	.	A	G	8	6	14	0	1	15	0	0
22	36634111	.	T	C	4	4	8	0	0	8	0	0
22	36634167	.	G	C	1	7	8	0	3	11	0	0
22	36634210	.	G	C	6	2	8	0	0	8	0	0
22	36674186	.	G	A	39	18	57	0	2	59	0	0
22	36674646	.	A	G	7	11	18	0	1	19	0	0
22	36674658	.	G	A	10	17	27	0	0	27	0	0
22	36676056	.	G	C	27	18	45	0	1	46	0	0
22	36681357	.	T	G	6	16	22	0	1	24	1	0
22	36681359	.	A	G	8	16	24	0	1	25	0	0
22	36683803	.	C	A	9	8	17	0	1	18	0	0
22	36684170	.	A	G	7	9	16	2	3	21	0	0
22	36685768	.	T	C	13	1	14	0	16	30	0	0
22	36687328	.	G	A	8	2	10	0	0	10	0	0
22	36687403	.	G	A	8	8	16	0	1	17	0	0
22	36687418	.	C	T	0	7	7	0	10	17	0	0
22	36687616	.	C	T	0	6	6	0	6	12	0	0
22	36741483	.	T	G	3	2	5	0	0	5	0	0
22	36741498	.	G	A	2	4	6	0	0	6	0	0
22	36742674	.	T	A	4	4	8	0	0	8	0	0
22	36755582	.	T	C	5	0	5	0	4	9	0	0
22	36755586	.	A	G	5	4	9	0	0	9	0	0
22	36755732	.	G	T	7	2	9	1	0	10	0	0
22	36756005	.	T	C	4	10	14	0	3	17	0	0
22	36756112	.	A	G	2	10	12	0	1	13	0	0
22	36756258	.	G	A	4	8	12	0	0	12	0	0
22	36756264	.	T	G	3	7	10	0	0	10	0	0
22	36756325	.	G	A	4	7	11	0	0	11	0	0
22	36756400	.	C	T	6	4	10	0	0	10	0	0
22	36756404	.	G	C	7	4	11	0	0	11	0	0
22	36756464	.	T	A	7	5	12	0	1	13	0	0
22	36757170	.	C	T	6	7	13	0	0	13	0	0
22	36770566	.	G	C	3	0	3	0	2	5	0	0
22	36770568	.	T	C	2	0	2	0	3	5	0	0
22	36795279	.	C	T	2	4	6	0	1	7	0	0
22	36795755	.	G	C	7	3	10	0	1	11	0	0
22	36795803	.	T	C	8	0	8	0	5	13	0	0
22	36800685	.	T	A	2	3	5	0	0	5	0	0
22	36835966	.	C	T	5	4	9	0	0	9	0	0
22	36875533	.	T	C	1	2	3	0	0	3	0	0
22	36877344	.	T	C	3	4	7	0	0	7	0	0
22	36878044	.	T	A	1	2	3	0	0	3	0	0
22	36882388	.	T	C	6	4	10	0	0	10	0	0
22	36882409	.	T	A	5	4	9	0	0	9	0	0
22	36885065	.	T	G	3	0	3	0	3	6	0	0
22	36893357	.	G	A	5	10	15	0	0	15	0	0
22	36893411	.	A	C	7	8	15	0	1	16	0	0
22	36894283	.	T	A	5	7	12	0	3	15	0	0
22	36894410	.	A	C	11	8	19	0	0	19	0	0
22	36896641	.	G	A	1	5	6	0	6	12	0	0
22	36896681	.	C	T	5	8	13	0	1	14	0	0
22	36896705	.	C	T	4	10	14	0	0	14	0	0
22	36898727	.	T	C	12	12	24	0	0	24	0	0
22	36899149	.	G	A	1	16	17	0	12	29	0	0
22	36899269	.	C	T	15	20	35	1	2	38	0	0
22	36899574	.	A	G	8	11	19	0	1	20	0	0
22	36899621	.	A	T	8	5	13	0	0	13	0	0
22	36947793	.	T	A	9	7	16	0	1	17	0	0
22	36947797	.	G	T	10	9	19	0	1	20	0	0
22	36947963	.	T	C	10	0	10	0	12	22	0	0
22	36948177	.	C	A	7	8	15	0	0	15	0	0
22	36948237	.	A	T	6	6	12	0	2	14	0	0
22	36948242	.	A	G	7	5	12	0	1	13	0	0
22	36948312	.	C	T	1	7	8	0	6	14	0	0
22	36948410	.	G	A	7	13	20	0	0	20	0	0
22	36948530	.	A	G	10	7	17	0	0	17	0	0
22	37276606	.	C	A	6	11	17	0	1	18	0	0
22	37276709	.	C	T	2	8	10	0	8	18	0	0
22	37276717	.	A	G	8	10	18	0	0	18	0	0
22	37278385	.	G	A	2	6	8	0	0	8	0	0
22	37278475	.	A	G	15	5	20	0	0	20	0	0
22	37589848	.	T	A	1	7	8	0	0	8	0	0
22	37805329	.	C	T	11	15	26	0	2	28	0	0
22	37823332	.	C	A	0	7	7	0	11	18	0	0
22	37881126	.	C	T	7	6	13	0	0	13	0	0
22	37881134	.	G	A	7	8	15	0	0	15	0	0
22	38037578	.	A	T	4	5	9	0	0	9	0	0
22	38037603	.	G	T	2	4	6	0	0	6	0	0
22	38037613	.	G	T	0	4	4	0	0	5	1	0
22	38040050	.	G	A	0	4	4	0	3	7	0	0
22	38040070	.	T	G	5	5	10	0	0	10	0	0
22	38044902	.	G	C	1	12	13	0	5	18	0	0
22	38045009	.	T	A	8	9	17	0	7	24	0	0
22	38191718	.	T	A	2	6	8	0	0	8	0	0
22	38194106	.	C	T	9	9	18	0	0	18	0	0
22	38194415	.	A	G	12	11	23	0	2	25	0	0
22	38194419	.	G	C	14	11	25	0	0	25	0	0
22	38195217	.	G	A	14	12	26	1	1	28	0	0
22	38197777	.	C	T	30	32	62	0	3	65	0	0
22	38197783	.	G	C	30	33	63	0	3	66	0	0
22	38199812	.	A	G	7	6	13	0	2	15	0	0
22	38202898	.	T	C	3	3	6	0	0	6	0	0
22	38202904	.	C	T	2	2	4	0	2	6	0	0
22	38209295	.	A	G	1	2	3	0	0	3	0	0
22	38283993	.	A	G	1	2	3	0	0	3	0	0
23	252280	.	T	C	8	0	8	0	3	11	0	0
23	252305	.	T	C	6	4	10	0	0	10	0	0
23	527384	.	T	C	2	6	8	0	0	8	0	0
23	552367	.	T	C	2	4	6	0	1	7	0	0
23	552392	.	C	G	0	6	6	0	3	9	0	0
23	570688	.	G	A	7	10	17	0	0	17	0	0
23	570702	.	A	C	8	9	17	0	1	18	0	0
23	571355	.	A	G	7	7	14	0	0	14	0	0
23	571415	.	C	A	0	6	6	0	7	13	0	0
23	584380	.	G	A	1	3	4	0	5	9	0	0
23	584411	.	A	T	7	2	9	0	0	9	0	0
23	584580	.	G	A	0	3	3	0	4	7	0	0
23	584621	.	G	A	0	4	4	0	4	8	0	0
23	584652	.	A	G	9	3	12	0	0	12	0	0
23	584790	.	G	A	0	3	3	0	4	7	0	0
23	585756	.	T	A	6	5	11	0	1	12	0	0
23	585825	.	A	G	0	2	2	0	2	4	0	0
23	585877	.	A	T	5	7	12	0	1	13	0	0
23	586149	.	T	C	4	1	5	1	0	6	0	0
23	586158	.	A	T	4	2	6	1	2	9	0	0
23	586614	.	A	T	6	2	8	0	1	9	0	0
23	586653	.	T	G	2	2	4	0	0	4	0	0
23	586874	.	G	A	3	7	10	0	0	10	0	0
23	587119	.	A	C	3	2	5	0	1	6	0	0
23	587161	.	A	G	7	4	11	0	0	11	0	0
23	587169	.	A	C	9	5	14	0	0	14	0	0
23	587412	.	A	G	15	4	19	0	0	19	0	0
23	587437	.	G	T	12	5	17	0	0	17	0	0
23	587581	.	G	A	14	14	28	0	0	28	0	0
23	587614	.	T	G	11	15	26	0	1	27	0	0
23	587806	.	T	G	11	13	24	0	0	24	0	0
23	587830	.	A	C	14	7	21	0	1	23	1	0
23	587890	.	A	C	15	15	30	0	0	30	0	0
23	587924	.	A	T	11	24	35	1	3	39	0	0
23	587966	.	C	T	20	20	40	1	1	42	0	0
23	588102	.	C	A	8	10	18	0	6	24	0	0
23	597657	.	G	A	1	4	5	0	0	5	0	0
23	864125	.	T	C	2	1	3	0	0	3	0	0
23	864134	.	T	C	1	4	5	0	0	5	0	0
23	2770169	.	G	A	3	2	5	0	0	5	0	0
23	2770171	.	A	C	3	2	5	0	0	5	0	0
23	2932088	.	C	T	9	3	12	0	0	12	0	0
23	4271730	.	G	C	16	15	31	1	1	33	0	0
23	6421788	.	G	A	4	5	9	0	0	9	0	0
23	6421954	.	G	A	4	3	7	0	0	7	0	0
23	6571798	.	A	C	2	2	4	0	1	5	0	0
23	6571799	.	C	T	3	2	5	0	0	5	0	0
23	6573783	.	A	G	2	2	4	0	0	4	0	0
23	6631499	.	G	T	3	2	5	0	0	5	0	0
23	6673694	.	T	A	10	7	17	0	2	19	0	0
23	6673724	.	C	A	4	9	13	0	11	24	0	0
23	6673956	.	A	G	17	6	23	0	2	25	0	0
23	6673991	.	A	C	9	13	22	0	1	23	0	0
23	6675100	.	C	T	2	9	11	0	0	11	0	0
23	6675135	.	G	A	5	5	10	0	0	10	0	0
23	6675325	.	G	T	8	11	19	0	0	19	0	0
23	6675537	.	G	A	6	13	19	0	0	19	0	0
23	6675550	.	A	T	5	7	12	0	1	13	0	0
23	6675828	.	C	G	0	4	4	0	1	5	0	0
23	6675835	.	G	A	3	4	7	0	0	7	0	0
23	6675959	.	C	G	5	7	12	0	1	13	0	0
23	6680805	.	G	A	8	3	11	0	0	11	0	0
23	6680880	.	C	T	4	2	6	0	0	6	0	0
23	6683992	.	C	A	0	2	2	0	4	6	0	0
23	6694340	.	G	A	3	2	5	0	0	5	0	0
23	6694341	.	A	T	3	2	5	0	0	5	0	0
23	6694608	.	A	T	4	2	6	0	0	6	0	0
23	6694634	.	G	T	4	3	7	0	0	7	0	0
23	6703099	.	G	A	3	3	6	0	0	6	0	0
23	6736121	.	T	A	7	11	18	0	1	19	0	0
23	6736166	.	C	T	1	9	10	0	5	15	0	0
23	6744328	.	C	T	12	6	18	0	1	19	0	0
23	6744385	.	C	T	5	7	12	0	1	13	0	0
23	6744576	.	T	G	7	8	15	0	1	16	0	0
23	6749754	.	C	G	5	6	11	0	0	11	0	0
23	6753363	.	C	T	6	2	8	0	0	8	0	0
23	6753414	.	C	T	4	4	8	0	0	8	0	0
23	6753462	.	G	T	1	9	10	0	4	14	0	0
23	6773392	.	G	A	5	3	8	0	0	8	0	0
23	6780803	.	A	G	6	6	12	0	0	12	0	0
23	6780856	.	G	A	2	7	9	0	6	15	0	0
23	6780859	.	G	A	5	6	11	0	2	13	0	0
23	6780895	.	A	G	9	10	19	0	1	20	0	0
23	6783757	.	A	C	1	0	1	0	15	16	0	0
23	6783957	.	C	T	7	12	19	0	0	19	0	0
23	6784176	.	C	T	9	11	20	0	1	21	0	0
23	6788768	.	T	C	4	5	9	0	0	9	0	0
23	6795737	.	A	T	2	3	5	0	0	5	0	0
23	6809524	.	G	A	4	3	7	0	0	7	0	0
23	6814119	.	T	G	3	3	6	0	0	6	0	0
23	6827511	.	C	T	10	9	19	0	1	20	0	0
23	6841005	.	T	C	15	19	34	0	0	34	0	0
23	6841021	.	G	A	4	15	19	0	15	34	0	0
23	6955860	.	G	A	3	3	6	0	0	6	0	0
23	6958256	.	A	G	1	2	3	0	0	3	0	0
23	6961424	.	G	A	1	3	4	0	1	5	0	0
23	6961490	.	A	G	0	2	2	0	1	3	0	0
23	7003572	.	G	T	12	13	25	0	0	25	0	0
23	7007480	.	C	T	8	5	13	0	1	14	0	0
23	7007879	.	C	T	9	3	12	0	1	13	0	0
23	7017443	.	A	G	7	4	11	0	0	11	0	0
23	7024631	.	T	C	6	11	17	0	0	17	0	0
23	7027534	.	C	T	1	4	5	0	3	8	0	0
23	7029585	.	G	A	3	7	10	0	0	10	0	0
23	7029777	.	A	T	4	5	9	0	0	9	0	0
23	7029964	.	A	C	3	0	3	0	2	5	0	0
23	7040708	.	T	A	1	2	3	0	0	3	0	0
23	7040725	.	G	A	1	4	5	0	0	5	0	0
23	7046813	.	G	A	3	5	8	0	0	8	0	0
23	7046816	.	G	C	4	0	4	0	5	9	0	0
23	7573845	.	T	C	3	2	5	0	0	5	0	0
23	7718380	.	G	A	1	1	2	0	1	3	0	0
23	7728594	.	T	C	3	4	7	0	0	7	0	0
23	7728606	.	C	T	4	4	8	0	0	8	0	0
23	7732760	.	C	G	3	2	5	0	1	6	0	0
23	7732918	.	G	A	2	6	8	0	1	9	0	0
23	7733043	.	C	T	2	4	6	0	0	6	0	0
23	7733081	.	A	G	3	2	5	0	0	5	0	0
23	7733088	.	C	G	4	3	7	0	0	7	0	0
23	7733374	.	C	T	1	3	4	0	0	4	0	0
23	7733732	.	T	C	2	4	6	0	0	6	0	0
23	7734321	.	C	T	1	3	4	0	0	4	0	0
23	7735464	.	T	C	5	3	8	0	0	8	0	0
23	7735497	.	T	C	6	7	13	0	0	13	0	0
23	7735695	.	C	T	4	5	9	0	0	9	0	0
23	7735830	.	G	A	1	2	3	0	5	8	0	0
23	7736024	.	A	G	2	7	9	0	0	9	0	0
23	7743961	.	G	A	2	5	7	0	1	8	0	0
23	7768578	.	C	T	2	2	4	0	3	7	0	0
23	7771378	.	A	T	5	2	7	0	0	7	0	0
23	7771440	.	G	A	3	2	5	0	0	5	0	0
23	7778670	.	G	A	3	2	5	0	0	5	0	0
23	7783606	.	C	T	3	4	7	0	0	7	0	0
23	7792432	.	C	T	2	2	4	0	0	4	0	0
23	7808944	.	C	T	1	2	3	0	0	3	0	0
23	8284779	.	C	T	3	4	7	0	1	8	0	0
23	8284791	.	C	T	4	3	7	0	1	8	0	0
23	8284903	.	C	T	7	4	11	0	0	11	0	0
23	8284991	.	G	T	10	11	21	0	0	21	0	0
23	8285094	.	G	T	3	4	7	0	0	7	0	0
23	8285220	.	G	A	20	9	29	0	2	31	0	0
23	8285297	.	C	T	2	20	22	0	19	41	0	0
23	8285332	.	C	T	17	17	34	0	2	36	0	0
23	8285468	.	T	C	6	3	9	0	1	10	0	0
23	8285585	.	A	T	13	10	23	0	2	25	0	0
23	8285640	.	C	T	12	11	23	0	0	23	0	0
23	8286237	.	G	A	9	5	14	0	0	14	0	0
23	8286261	.	C	T	0	4	4	0	6	10	0	0
23	8286342	.	C	T	0	4	4	0	2	6	0	0
23	8286483	.	G	A	1	2	3	0	0	3	0	0
23	8372159	.	T	C	1	0	1	0	2	3	0	0
23	8729994	.	C	T	12	7	19	0	0	19	0	0
23	8730081	.	C	G	4	9	13	0	1	14	0	0
23	9013456	.	C	G	3	0	3	0	3	6	0	0
23	9014985	.	C	A	0	3	3	0	1	4	0	0
23	9058048	.	G	A	0	2	2	0	1	3	0	0
23	9058108	.	C	A	2	3	5	0	0	5	0	0
23	9058444	.	A	T	2	4	6	0	0	6	0	0
23	9081490	.	T	G	2	5	7	0	0	7	0	0
23	9794733	.	T	C	14	4	18	4	1	23	0	0
23	9794959	.	T	A	20	14	34	0	3	37	0	0
23	9795057	.	A	G	26	20	46	0	0	46	0	0
23	9795097	.	C	T	2	18	20	0	23	43	0	0
23	9795663	.	A	C	9	12	21	0	1	22	0	0
23	9795908	.	C	T	12	12	24	0	0	24	0	0
23	9800761	.	T	G	9	7	16	0	1	17	0	0
23	9800993	.	G	T	6	7	13	0	0	13	0	0
23	9809863	.	A	G	13	22	35	0	0	35	0	0
23	9809977	.	C	T	0	9	9	1	12	22	0	0
23	9810491	.	C	G	18	16	34	0	1	35	0	0
23	10449755	.	A	G	1	2	3	0	0	3	0	0
23	10449769	.	A	G	2	0	2	0	2	4	0	0
23	10639037	.	A	G	1	4	5	0	0	5	0	0
23	10724336	.	A	G	19	17	36	0	3	39	0	0
23	10724695	.	A	C	7	0	7	0	10	17	0	0
23	10725012	.	T	C	8	6	14	0	2	16	0	0
23	10725013	.	G	A	9	5	14	0	2	16	0	0
23	10725491	.	T	G	6	5	11	0	1	12	0	0
23	10725753	.	A	C	5	4	9	0	0	9	0	0
23	10745139	.	T	G	3	2	5	0	0	5	0	0
23	10762922	.	G	A	17	6	23	0	0	23	0	0
23	10763070	.	G	A	10	7	17	0	1	18	0	0
23	10763301	.	T	C	14	5	19	0	2	21	0	0
23	10763303	.	T	C	14	5	19	0	1	20	0	0
23	10771991	.	C	A	0	5	5	0	7	12	0	0
23	10825569	.	A	G	3	0	3	0	4	7	0	0
23	10825591	.	C	T	3	6	9	0	1	10	0	0
23	10825996	.	G	A	4	1	5	0	1	6	0	0
23	10826120	.	C	T	6	2	8	0	3	11	0	0
23	10826194	.	C	A	5	5	10	0	2	12	0	0
23	10826618	.	T	C	12	6	18	0	1	19	0	0
23	10826856	.	A	T	2	5	7	0	1	8	0	0
23	11848645	.	C	T	3	2	5	0	0	5	0	0
23	11851545	.	T	C	1	2	3	0	0	3	0	0
23	11861321	.	T	C	2	4	6	0	0	6	0	0
23	11861367	.	C	T	4	3	7	0	1	8	0	0
23	11861378	.	G	C	3	2	5	0	1	6	0	0
23	11864948	.	T	C	15	29	44	1	1	46	0	0
23	11865055	.	T	A	8	13	21	0	1	22	0	0
23	11865274	.	A	C	5	8	13	0	1	14	0	0
23	11865510	.	T	C	13	16	29	0	1	30	0	0
23	11865545	.	A	G	14	23	37	0	0	37	0	0
23	11866086	.	G	A	16	14	30	0	3	33	0	0
23	11866259	.	T	C	12	18	30	0	1	31	0	0
23	11870063	.	T	C	14	0	14	0	8	22	0	0
23	11871807	.	G	A	8	10	18	0	1	19	0	0
23	11872533	.	A	G	8	6	14	0	0	14	0	0
23	11920705	.	G	A	4	2	6	0	0	6	0	0
23	12150623	.	T	C	2	3	5	0	0	5	0	0
23	12150658	.	G	A	1	6	7	0	0	7	0	0
23	12155166	.	G	A	4	2	6	0	0	6	0	0
23	12155638	.	A	C	1	2	3	0	0	3	0	0
23	12232873	.	G	A	9	6	15	0	4	19	0	0
23	12233117	.	G	A	10	14	24	0	0	24	0	0
23	12245797	.	G	T	4	3	7	0	0	7	0	0
23	12260903	.	T	C	10	4	14	0	1	15	0	0
23	12278655	.	A	C	2	4	6	0	1	7	0	0
23	12487331	.	C	T	1	4	5	0	0	5	0	0
23	12612350	.	A	G	1	3	4	0	0	4	0	0
23	12612427	.	A	G	1	0	1	0	3	4	0	0
23	13589383	.	A	G	1	2	3	0	0	3	0	0
23	13598094	.	C	T	1	4	5	0	0	5	0	0
23	13598632	.	T	C	14	5	19	0	0	19	0	0
23	13598679	.	C	T	12	10	22	0	1	23	0	0
23	13598766	.	A	C	7	6	13	0	1	14	0	0
23	13599079	.	G	A	0	4	4	0	4	8	0	0
23	13722335	.	T	G	1	0	1	0	2	3	0	0
23	13806444	.	T	C	6	4	10	0	1	11	0	0
23	13833376	.	T	A	22	13	35	0	1	36	0	0
23	13835932	.	C	A	10	8	18	0	1	19	0	0
23	13839846	.	A	G	14	7	21	0	0	21	0	0
23	13840362	.	C	T	0	3	3	0	3	6	0	0
23	13845114	.	A	C	7	7	14	0	1	15	0	0
23	13845149	.	T	G	11	9	20	0	1	21	0	0
23	13845201	.	A	G	13	6	19	0	0	19	0	0
23	13845247	.	G	T	7	9	16	0	0	16	0	0
23	13845411	.	G	T	5	8	13	0	0	13	0	0
23	13845447	.	T	C	11	9	20	0	1	21	0	0
23	13845544	.	C	T	9	8	17	0	1	18	0	0
23	13845558	.	C	T	2	7	9	0	7	16	0	0
23	13846207	.	A	T	5	3	8	0	1	9	0	0
23	13846631	.	C	T	2	3	5	0	0	5	0	0
23	13846917	.	T	G	2	6	8	0	0	8	0	0
23	13847142	.	G	A	2	2	4	0	0	4	0	0
23	13847220	.	T	C	1	3	4	0	1	5	0	0
23	13851386	.	A	C	1	2	3	0	0	3	0	0
23	13941275	.	C	T	4	4	8	0	1	9	0	0
23	13944394	.	A	G	3	6	9	0	0	9	0	0
23	13949074	.	T	C	6	5	11	0	0	11	0	0
23	13949089	.	T	C	5	5	10	0	0	10	0	0
23	13949110	.	C	T	2	6	8	0	1	9	0	0
23	14193640	.	T	C	3	12	15	0	1	16	0	0
23	14193649	.	G	T	3	14	17	0	0	17	0	0
23	14193777	.	C	T	14	13	27	0	0	27	0	0
23	14193851	.	A	G	19	16	35	0	1	36	0	0
23	14193991	.	T	A	8	7	15	0	6	21	0	0
23	14193996	.	C	A	10	9	19	0	3	22	0	0
23	14194101	.	T	A	13	18	31	0	0	31	0	0
23	14194125	.	A	G	14	16	30	0	1	31	0	0
23	14198137	.	G	A	11	12	23	0	0	23	0	0
23	14201512	.	T	C	5	5	10	0	0	10	0	0
23	14201521	.	T	C	4	4	8	0	0	8	0	0
23	14203829	.	T	G	2	3	5	0	0	5	0	0
23	14208718	.	A	G	4	3	7	0	0	7	0	0
23	14208817	.	A	T	3	6	9	0	2	11	0	0
23	14209024	.	T	G	4	6	10	0	0	10	0	0
23	14211707	.	C	T	8	7	15	0	1	16	0	0
23	14230410	.	A	T	2	3	5	0	0	5	0	0
23	14780393	.	C	A	1	3	4	0	0	4	0	0
23	14786347	.	T	C	2	2	4	0	0	4	0	0
23	14786429	.	A	T	2	7	9	0	1	10	0	0
23	14787409	.	G	A	0	2	2	0	1	3	0	0
23	14787426	.	G	A	2	2	4	0	0	4	0	0
23	14790429	.	G	A	3	3	6	0	0	6	0	0
23	14790659	.	T	C	2	2	4	0	0	4	0	0
23	14790827	.	G	A	3	2	5	0	0	5	0	0
23	14790881	.	A	T	3	3	6	0	0	6	0	0
23	14799653	.	T	C	3	10	13	0	0	13	0	0
23	14808293	.	T	C	2	0	2	0	3	5	0	0
23	14808335	.	C	T	3	2	5	0	2	7	0	0
23	14808399	.	G	A	5	6	11	1	0	12	0	0
23	14808537	.	G	T	4	10	14	0	0	14	0	0
23	14809613	.	C	A	4	7	11	0	1	12	0	0
23	14832585	.	T	G	6	14	20	0	6	26	0	0
23	14832733	.	G	A	21	26	47	0	5	52	0	0
23	14832740	.	A	C	23	27	50	0	3	53	0	0
23	14832866	.	C	T	33	28	61	0	2	63	0	0
23	14832941	.	C	A	3	31	34	0	24	58	0	0
23	14833142	.	A	T	27	25	52	0	1	53	0	0
23	14833143	.	A	T	28	24	52	0	1	53	0	0
23	14833389	.	A	C	35	11	46	0	1	47	0	0
23	14861741	.	A	G	15	15	30	0	0	30	0	0
23	14990819	.	G	T	2	4	6	0	0	6	0	0
23	14993074	.	T	A	19	4	23	0	2	25	0	0
23	14993089	.	G	A	16	6	22	0	1	23	0	0
23	14993302	.	A	C	11	12	23	0	1	24	0	0
23	14993393	.	C	A	9	6	15	0	1	16	0	0
23	14993421	.	G	A	7	3	10	0	0	10	0	0
23	14993438	.	A	G	6	5	11	0	0	11	0	0
23	14993493	.	A	T	11	8	19	0	0	19	0	0
23	14993525	.	A	T	13	5	18	0	0	18	0	0
23	14993563	.	C	G	14	10	24	0	1	25	0	0
23	14997341	.	A	G	7	12	19	0	1	20	0	0
23	14999053	.	C	T	11	13	24	0	1	25	0	0
23	14999095	.	C	T	1	13	14	0	10	24	0	0
23	15003551	.	T	C	4	0	4	0	10	14	0	0
23	15022206	.	T	C	5	0	5	0	3	8	0	0
23	15025084	.	G	C	1	1	2	0	1	3	0	0
23	15204028	.	C	T	28	10	38	1	3	42	0	0
23	15204038	.	T	G	30	8	38	1	1	40	0	0
23	15204222	.	C	T	2	12	14	0	26	40	0	0
23	15204321	.	T	A	13	12	25	0	1	27	1	0
23	15204324	.	T	A	15	12	27	0	0	27	0	0
23	15204417	.	A	G	9	13	22	0	1	23	0	0
23	15204926	.	C	A	7	7	14	0	1	15	0	0
23	15204936	.	G	T	6	7	13	0	1	14	0	0
23	15205100	.	T	G	10	14	24	0	5	29	0	0
23	15205428	.	A	T	16	5	21	0	0	21	0	0
23	15205487	.	C	G	9	17	26	0	0	26	0	0
23	15211253	.	G	C	8	12	20	0	0	20	0	0
23	15222509	.	G	A	2	3	5	0	0	5	0	0
23	15222521	.	C	T	2	3	5	0	0	5	0	0
23	15259821	.	G	A	1	2	3	0	0	3	0	0
23	15851064	.	A	G	26	6	32	0	1	33	0	0
23	15851506	.	C	G	15	17	32	0	0	32	0	0
23	15854004	.	T	C	17	9	26	0	0	26	0	0
23	15854102	.	A	C	11	7	18	0	1	19	0	0
23	15861092	.	C	T	0	2	2	0	6	8	0	0
23	15872605	.	T	A	4	2	6	1	0	7	0	0
23	15900255	.	C	T	8	9	17	0	3	20	0	0
23	15900330	.	G	A	14	18	32	0	1	33	0	0
23	15900387	.	G	A	11	14	25	0	2	27	0	0
23	15916232	.	A	T	6	7	13	0	1	14	0	0
23	16649012	.	C	T	9	9	18	0	2	20	0	0
23	16649021	.	C	G	8	0	8	2	2	21	9	0
23	16660094	.	G	T	4	6	10	0	1	11	0	0
23	16753735	.	T	C	8	4	12	0	0	12	0	0
23	16757414	.	T	G	6	0	6	0	9	15	0	0
23	16761407	.	A	G	1	3	4	0	0	4	0	0
23	16769385	.	T	A	1	2	3	0	0	3	0	0
23	16769949	.	T	C	1	7	8	0	0	8	0	0
23	16770091	.	A	G	3	0	3	4	4	11	0	0
23	16770261	.	T	G	1	3	4	0	0	4	0	0
23	16770262	.	G	T	1	3	4	0	0	4	0	0
23	16770340	.	G	C	3	2	5	1	0	6	0	0
23	16831822	.	G	A	1	3	4	0	1	5	0	0
23	16848889	.	C	G	1	2	3	0	1	4	0	0
23	16849383	.	A	G	4	3	7	2	0	9	0	0
23	16883618	.	T	A	1	2	3	0	0	3	0	0
23	16917710	.	G	C	1	2	3	1	0	4	0	0
23	16953147	.	G	A	1	2	3	1	0	4	0	0
23	16966670	.	A	G	2	2	4	0	0	4	0	0
23	17113842	.	A	G	7	3	10	0	0	10	0	0
23	17113923	.	T	C	1	4	5	0	0	5	0	0
23	17812711	.	C	T	26	8	34	0	1	35	0	0
23	17812720	.	T	A	9	25	34	0	2	36	0	0
23	17812755	.	G	T	10	18	28	0	2	30	0	0
23	17813057	.	G	A	12	10	22	0	3	25	0	0
23	17813161	.	T	A	12	8	20	3	2	25	0	0
23	17813717	.	G	A	18	21	39	0	1	40	0	0
23	17813952	.	G	T	7	12	19	0	0	19	0	0
23	17814056	.	G	A	29	17	46	0	2	48	0	0
23	17814223	.	C	T	15	23	38	0	6	44	0	0
23	17814281	.	G	T	25	20	45	0	3	48	0	0
23	17814299	.	A	C	25	21	46	0	0	46	0	0
23	17814408	.	A	C	19	13	32	0	1	33	0	0
23	17849275	.	T	G	10	11	21	0	0	21	0	0
23	17849296	.	C	G	2	10	12	0	11	23	0	0
23	17849627	.	C	T	7	13	20	0	0	20	0	0
23	17849699	.	C	G	9	9	18	1	0	19	0	0
23	17851768	.	C	T	0	5	5	0	4	9	0	0
23	17855427	.	C	A	2	1	3	0	1	4	0	0
23	17873750	.	C	A	48	29	77	0	0	77	0	0
23	17879107	.	C	T	1	2	3	0	0	3	0	0
23	17879152	.	A	T	1	3	4	0	0	4	0	0
23	17880800	.	C	T	6	8	14	0	0	14	0	0
23	17881252	.	T	C	8	7	15	0	0	15	0	0
23	17994148	.	A	T	3	4	7	0	0	7	0	0
23	17994274	.	C	G	12	3	15	0	0	15	0	0
23	17994359	.	C	T	12	1	13	0	1	14	0	0
23	17995469	.	G	T	9	5	14	0	0	14	0	0
23	17997033	.	A	G	1	2	3	0	1	4	0	0
23	17997043	.	T	C	2	0	2	0	2	4	0	0
23	18004297	.	A	G	3	2	5	0	0	5	0	0
23	18032772	.	G	A	4	6	10	0	0	10	0	0
23	18032912	.	A	C	3	8	11	0	1	12	0	0
23	18032924	.	T	A	9	4	13	0	0	13	0	0
23	18118653	.	A	T	4	5	9	0	0	9	0	0
23	18118922	.	G	A	27	19	46	0	0	46	0	0
23	18119166	.	C	T	20	17	37	0	2	39	0	0
23	18119192	.	T	C	17	1	18	0	12	30	0	0
23	18119399	.	A	G	15	11	26	0	0	26	0	0
23	18286781	.	G	A	3	2	5	0	0	5	0	0
23	18286782	.	C	T	3	2	5	0	0	5	0	0
23	18372124	.	A	T	2	5	7	0	0	7	0	0
23	18372135	.	C	T	2	5	7	0	1	8	0	0
23	18375847	.	G	A	7	9	16	0	0	16	0	0
23	18375853	.	T	C	8	0	8	0	8	16	0	0
23	18387709	.	T	A	25	28	53	0	2	55	0	0
23	18388004	.	G	A	16	12	28	0	0	28	0	0
23	18388166	.	T	A	6	9	15	0	1	16	0	0
23	18388476	.	G	A	5	8	13	0	0	13	0	0
23	18388555	.	A	G	9	10	19	0	0	19	0	0
23	18388620	.	A	C	6	9	15	0	2	17	0	0
23	18388685	.	G	A	7	3	10	0	0	10	0	0
23	18388764	.	G	A	4	5	9	0	0	9	0	0
23	18388954	.	G	A	6	3	9	0	0	9	0	0
23	18389594	.	G	T	6	5	11	0	1	12	0	0
23	18390402	.	G	A	6	3	9	0	0	9	0	0
23	18390635	.	G	A	4	6	10	0	0	10	0	0
23	18390758	.	T	C	5	0	5	0	5	10	0	0
23	18390780	.	C	T	5	5	10	0	0	10	0	0
23	18394401	.	T	G	2	2	4	0	0	4	0	0
23	18561289	.	T	A	24	15	39	0	1	40	0	0
23	18561434	.	C	T	0	15	15	0	14	29	0	0
23	18562484	.	G	A	7	5	12	0	1	13	0	0
23	18562522	.	A	C	9	5	14	1	0	15	0	0
23	18562623	.	C	T	6	10	16	0	0	16	0	0
23	18562911	.	C	A	0	10	10	0	11	21	0	0
23	18563951	.	G	T	4	6	10	0	0	10	0	0
23	18563952	.	T	C	4	0	4	0	6	10	0	0
23	18568144	.	G	A	1	2	3	0	0	3	0	0
23	18568468	.	G	A	5	4	9	0	0	9	0	0
23	18569380	.	T	A	9	12	21	0	0	21	0	0
23	18569399	.	C	A	1	7	8	0	8	16	0	0
23	18569455	.	T	G	7	7	14	0	1	15	0	0
23	18569462	.	T	A	9	7	16	0	0	16	0	0
23	18569543	.	T	C	12	20	32	0	1	33	0	0
23	18569625	.	A	G	24	15	39	0	2	41	0	0
23	18570887	.	C	T	16	16	32	0	4	36	0	0
23	18570941	.	A	T	16	21	37	0	1	38	0	0
23	18572547	.	T	A	10	4	14	0	1	15	0	0
23	18572605	.	T	A	2	3	5	0	1	6	0	0
23	18572618	.	G	A	3	2	5	0	0	5	0	0
23	18574353	.	G	A	12	15	27	0	0	27	0	0
23	18574720	.	T	C	15	13	28	0	2	30	0	0
23	18574800	.	C	T	0	17	17	0	6	23	0	0
23	18580933	.	C	A	12	7	19	0	1	20	0	0
23	18580939	.	C	A	2	11	13	0	9	22	0	0
23	18581835	.	G	A	9	15	24	0	2	26	0	0
23	18581933	.	T	G	13	13	26	0	1	27	0	0
23	18584225	.	G	A	11	7	18	0	0	18	0	0
23	18586793	.	C	T	0	7	7	0	6	13	0	0
23	18588969	.	C	T	7	6	13	0	1	14	0	0
23	18597667	.	G	A	4	3	7	0	0	7	0	0
23	18616517	.	A	T	7	3	10	0	1	11	0	0
23	18616880	.	T	A	13	4	17	0	0	17	0	0
23	18616980	.	C	G	7	7	14	0	1	15	0	0
23	18617300	.	G	A	8	7	15	0	1	16	0	0
23	18619766	.	C	T	8	3	11	0	2	13	0	0
23	18622541	.	T	G	7	7	14	0	1	15	0	0
23	18628460	.	T	G	4	7	11	0	1	12	0	0
23	18628746	.	C	T	3	4	7	0	1	8	0	0
23	18629024	.	T	C	4	2	6	0	1	7	0	0
23	18651918	.	C	A	5	3	8	0	0	8	0	0
23	18702811	.	C	A	0	1	1	0	1	2	0	0
23	18702818	.	C	T	1	5	6	0	0	6	0	0
23	18759802	.	C	A	9	7	16	0	1	17	0	0
23	18759827	.	T	C	6	8	14	0	1	15	0	0
23	18760004	.	G	C	10	0	10	1	8	19	0	0
23	18760049	.	T	A	9	8	17	0	0	17	0	0
23	18760256	.	C	T	3	2	5	0	0	5	0	0
23	18760519	.	T	A	5	3	8	0	0	8	0	0
23	18764770	.	A	C	2	3	5	0	0	5	0	0
23	18769161	.	T	C	1	0	1	0	2	3	0	0
23	18795055	.	T	C	8	5	13	0	0	13	0	0
23	18795620	.	A	G	26	12	38	0	2	40	0	0
23	18795721	.	C	T	22	15	37	0	2	39	0	0
23	18869550	.	C	A	0	3	3	0	2	5	0	0
23	18944417	.	C	A	2	2	4	0	0	4	0	0
23	18944441	.	T	A	1	2	3	0	1	4	0	0
23	18944489	.	A	G	4	2	6	0	0	6	0	0
23	18944543	.	G	A	0	8	8	0	8	16	0	0
23	18947344	.	C	A	7	14	21	0	1	22	0	0
23	18947385	.	G	C	10	9	19	0	0	19	0	0
23	18950968	.	T	C	16	13	29	0	0	29	0	0
23	18950970	.	T	A	16	12	28	0	0	28	0	0
23	18951010	.	G	A	12	10	22	0	4	26	0	0
23	18954023	.	A	G	4	5	9	0	0	9	0	0
23	18954100	.	A	G	3	3	6	0	1	7	0	0
23	18954151	.	G	A	3	7	10	0	0	10	0	0
23	18954759	.	T	G	12	8	20	0	0	20	0	0
23	18979756	.	T	C	3	3	6	0	1	7	0	0
23	18982375	.	G	A	2	3	5	0	0	5	0	0
23	18986338	.	G	A	9	6	15	0	0	15	0	0
23	18986344	.	G	A	7	9	16	0	0	16	0	0
23	18990914	.	C	T	2	6	8	0	7	15	0	0
23	18993525	.	T	C	6	7	13	0	2	15	0	0
23	18993827	.	C	T	1	4	5	0	5	10	0	0
23	18996030	.	C	T	8	4	12	0	0	12	0	0
23	19003263	.	A	G	4	5	9	0	0	9	0	0
23	19005426	.	G	T	3	6	9	0	1	10	0	0
23	19005486	.	T	C	5	2	7	0	0	7	0	0
23	19007389	.	G	T	2	2	4	0	1	5	0	0
23	19017421	.	C	A	2	1	3	0	1	4	0	0
23	19027510	.	A	C	1	0	1	0	2	3	0	0
23	19118372	.	G	T	2	3	5	0	0	5	0	0
23	19118960	.	G	T	4	3	7	0	0	7	0	0
23	19198348	.	A	T	3	3	6	0	1	7	0	0
23	19198588	.	A	T	7	6	13	0	1	14	0	0
23	19200168	.	G	A	6	7	13	0	1	14	0	0
23	19201103	.	C	A	7	16	23	0	0	23	0	0
23	19201148	.	G	T	2	9	11	0	1	12	0	0
23	19203952	.	C	T	0	2	2	0	1	3	0	0
23	19206052	.	C	T	3	2	5	0	1	6	0	0
23	19474823	.	G	T	7	13	20	0	2	22	0	0
23	19575044	.	G	A	0	2	2	0	4	6	0	0
23	19577464	.	G	A	0	7	7	0	7	14	0	0
23	19582481	.	T	C	19	12	31	0	0	31	0	0
23	19582559	.	G	T	7	8	15	0	1	16	0	0
23	19582668	.	T	C	10	17	27	0	0	27	0	0
23	19582678	.	C	T	14	13	27	0	1	28	0	0
23	19583208	.	G	A	2	12	14	0	13	27	0	0
23	19583252	.	C	T	18	14	32	0	1	33	0	0
23	19603630	.	T	C	31	30	61	0	2	63	0	0
23	19603753	.	T	C	32	25	57	0	1	58	0	0
23	19603803	.	T	C	22	24	46	0	2	48	0	0
23	19603880	.	A	T	16	14	30	0	8	39	1	0
23	19603994	.	G	A	27	21	48	0	1	49	0	0
23	19604263	.	A	G	17	0	17	0	20	37	0	0
23	19604351	.	G	T	13	13	26	0	3	29	0	0
23	19672720	.	T	C	4	5	9	0	1	10	0	0
23	19673170	.	C	T	15	12	27	0	1	28	0	0
23	19673376	.	C	T	11	9	20	0	0	20	0	0
23	19712898	.	G	A	34	30	64	0	4	68	0	0
23	19713291	.	A	G	25	41	66	0	3	69	0	0
23	19713324	.	A	G	27	31	58	0	6	64	0	0
23	19800228	.	T	C	1	3	4	0	1	5	0	0
23	19804543	.	C	A	3	3	6	0	0	6	0	0
23	19805577	.	A	T	1	6	7	0	1	8	0	0
23	19808022	.	C	T	9	8	17	0	1	18	0	0
23	19808078	.	T	C	9	5	14	0	2	16	0	0
23	19808691	.	G	A	1	10	11	0	15	26	0	0
23	19815467	.	G	A	4	4	8	0	1	9	0	0
23	19816699	.	A	T	4	6	10	0	0	10	0	0
23	19821136	.	A	G	5	1	6	0	11	17	0	0
23	19821150	.	C	T	5	13	18	0	2	20	0	0
23	19821277	.	A	C	8	12	20	0	0	20	0	0
23	19821470	.	G	A	0	1	1	0	1	2	0	0
23	19821489	.	A	T	1	3	4	0	1	5	0	0
23	19825629	.	C	T	1	5	6	0	1	7	0	0
23	19825653	.	G	C	2	4	6	0	0	6	0	0
23	19834286	.	A	T	5	3	8	0	0	8	0	0
23	19835308	.	T	C	34	16	50	0	2	52	0	0
23	19836260	.	C	T	26	25	51	0	2	53	0	0
23	19837080	.	T	C	16	19	35	0	3	38	0	0
23	19837503	.	G	A	9	16	25	0	1	26	0	0
23	19837939	.	A	G	3	6	9	0	0	9	0	0
23	19837974	.	G	A	2	4	6	0	0	6	0	0
23	19838100	.	C	A	7	8	15	1	0	16	0	0
23	19838387	.	A	T	3	2	5	0	1	6	0	0
23	19838388	.	T	A	3	3	6	0	0	6	0	0
23	19838458	.	A	T	4	3	7	0	0	7	0	0
23	19838459	.	A	C	4	3	7	0	0	7	0	0
23	19871615	.	A	G	2	3	5	0	0	5	0	0
23	19893409	.	A	T	1	4	5	0	0	5	0	0
23	19969109	.	A	T	3	2	5	0	0	5	0	0
23	19969136	.	C	A	2	2	4	0	0	4	0	0
23	19969710	.	G	A	5	4	9	0	0	9	0	0
23	19974092	.	G	A	2	2	4	0	0	4	0	0
23	19981510	.	G	T	13	4	17	0	0	17	0	0
23	19981554	.	T	C	8	7	15	0	0	15	0	0
23	19981608	.	A	T	3	2	5	0	1	6	0	0
23	20113599	.	T	C	14	13	27	0	1	28	0	0
23	20113848	.	G	T	22	13	35	0	0	35	0	0
23	20114327	.	C	A	25	12	37	0	2	39	0	0
23	20117830	.	A	G	9	12	21	0	3	24	0	0
23	20117938	.	A	C	7	1	8	0	5	13	0	0
23	20118597	.	T	G	7	3	10	0	0	10	0	0
23	20120646	.	T	C	2	0	2	0	3	5	0	0
23	20121265	.	T	A	5	6	11	0	0	11	0	0
23	20121270	.	G	T	4	7	11	0	0	11	0	0
23	20121326	.	G	A	5	5	10	0	0	10	0	0
23	20123375	.	G	A	1	2	3	0	0	3	0	0
23	20123629	.	A	G	2	3	5	0	0	5	0	0
23	20129795	.	T	G	1	2	3	0	0	3	0	0
23	20139248	.	T	C	2	2	4	0	0	4	0	0
23	20141748	.	C	A	1	1	2	0	1	3	0	0
23	20145420	.	T	A	18	14	32	0	2	34	0	0
23	20145823	.	T	C	8	7	15	0	2	17	0	0
23	20146080	.	A	G	6	9	15	0	1	16	0	0
23	20152477	.	T	C	2	7	9	0	0	9	0	0
23	20152640	.	G	A	8	15	23	0	0	23	0	0
23	20157790	.	G	A	4	5	9	0	0	9	0	0
23	20157923	.	G	C	1	0	1	0	5	6	0	0
23	20157930	.	T	C	2	1	3	0	4	7	0	0
23	20167944	.	T	C	1	4	5	0	0	5	0	0
23	20167966	.	G	A	2	4	6	0	0	6	0	0
23	20168739	.	T	C	2	2	4	0	1	5	0	0
23	20183551	.	A	G	1	2	3	0	0	3	0	0
23	20931095	.	C	A	5	7	12	0	1	13	0	0
23	20931119	.	C	T	4	6	10	0	0	10	0	0
23	20936395	.	T	A	2	8	10	0	0	10	0	0
23	20936467	.	T	C	4	2	6	0	0	6	0	0
23	21089840	.	C	A	1	2	3	0	0	3	0	0
23	21276362	.	T	C	5	4	9	0	1	10	0	0
23	21277247	.	T	A	7	5	12	0	0	12	0	0
23	21356056	.	C	T	2	2	4	0	1	5	0	0
23	21362178	.	G	A	0	1	1	0	2	3	0	0
23	21362822	.	C	T	3	2	5	0	1	6	0	0
23	21364431	.	G	A	3	5	8	0	0	8	0	0
23	21364449	.	G	A	1	4	5	0	2	7	0	0
23	21364632	.	T	C	4	4	8	0	1	9	0	0
23	21364725	.	C	T	3	6	9	0	0	9	0	0
23	21366588	.	C	T	5	2	7	0	0	7	0	0
23	21366743	.	A	C	6	6	12	0	0	12	0	0
23	21366764	.	C	T	7	5	12	0	0	12	0	0
23	21367861	.	A	G	7	7	14	0	3	17	0	0
23	21367994	.	A	T	10	7	17	0	3	20	0	0
23	21368078	.	C	T	11	6	17	0	1	18	0	0
23	21368090	.	G	A	11	7	18	0	0	18	0	0
23	21368156	.	A	G	9	6	15	0	0	15	0	0
23	21368183	.	G	A	7	5	12	0	1	13	0	0
23	21369126	.	G	C	0	13	13	0	7	20	0	0
23	21369678	.	T	C	16	11	27	0	1	28	0	0
23	21369703	.	C	A	18	10	28	0	0	28	0	0
23	21369750	.	C	T	20	7	27	0	0	27	0	0
23	21376413	.	T	A	17	19	36	0	0	36	0	0
23	21376570	.	C	T	24	13	37	0	2	39	0	0
23	21376617	.	A	G	24	0	24	0	12	36	0	0
23	21376787	.	C	G	8	10	18	0	1	19	0	0
23	21452700	.	C	T	2	3	5	0	0	5	0	0
23	21488054	.	T	C	2	2	4	0	1	5	0	0
23	21488208	.	A	G	2	1	3	0	1	4	0	0
23	21488221	.	A	T	2	2	4	0	0	4	0	0
23	21488630	.	A	C	2	2	4	0	0	4	0	0
23	21489121	.	C	T	2	5	7	0	0	7	0	0
23	21489233	.	T	C	8	5	13	0	0	13	0	0
23	21489567	.	T	C	9	10	19	0	1	20	0	0
23	21489929	.	A	G	1	3	4	0	2	6	0	0
23	21490211	.	G	A	4	3	7	0	1	8	0	0
23	21497808	.	C	T	5	2	7	0	0	7	0	0
23	21498240	.	A	G	2	1	3	0	4	7	0	0
23	21498291	.	T	C	3	1	4	0	1	5	0	0
23	21498326	.	C	T	1	2	3	0	0	3	0	0
23	21498449	.	T	C	3	4	7	0	0	7	0	0
23	21498478	.	T	C	3	6	9	0	0	9	0	0
23	21618055	.	C	T	2	4	6	0	0	6	0	0
23	21626211	.	C	T	2	2	4	0	2	6	0	0
23	21630393	.	G	A	3	3	6	0	0	6	0	0
23	21630676	.	G	A	1	2	3	0	0	3	0	0
23	21630973	.	C	T	2	3	5	0	0	5	0	0
23	21638300	.	C	T	4	2	6	0	0	6	0	0
23	21661227	.	C	T	5	10	15	0	0	15	0	0
23	21661483	.	G	A	0	7	7	0	8	15	0	0
23	21721868	.	G	A	1	2	3	0	1	4	0	0
23	21744521	.	T	A	2	1	3	0	1	4	0	0
23	21744522	.	C	T	2	2	4	0	0	4	0	0
23	21803801	.	T	C	0	2	2	0	1	3	0	0
23	22051380	.	C	T	4	3	7	0	1	8	0	0
23	22054542	.	C	A	2	7	9	0	2	11	0	0
23	22060088	.	T	A	6	6	12	0	1	13	0	0
23	22064493	.	A	G	8	6	14	0	0	14	0	0
23	22067865	.	G	T	5	7	12	0	0	12	0	0
23	22084627	.	A	G	1	1	2	0	1	3	0	0
23	22496525	.	C	A	6	7	13	0	0	13	0	0
23	22496589	.	A	G	9	16	25	0	0	25	0	0
23	22496785	.	A	G	3	9	12	0	0	12	0	0
23	22497049	.	A	T	8	6	14	0	0	14	0	0
23	22497550	.	A	G	8	5	13	0	0	13	0	0
23	22591304	.	C	A	2	2	4	0	0	4	0	0
23	22635284	.	G	A	7	5	12	0	1	13	0	0
23	22635466	.	T	C	2	2	4	0	0	4	0	0
23	22635490	.	C	G	2	4	6	0	0	6	0	0
23	22667247	.	C	T	16	12	28	0	1	29	0	0
23	22674704	.	C	T	27	24	51	0	1	52	0	0
23	22677394	.	A	C	30	47	77	0	3	80	0	0
23	22677496	.	C	T	31	46	77	0	3	80	0	0
23	22677638	.	C	T	35	33	68	0	2	70	0	0
23	22922775	.	A	C	6	6	12	0	0	12	0	0
23	22922795	.	G	T	11	8	19	0	0	19	0	0
23	22923021	.	A	C	13	7	20	0	1	21	0	0
23	22923033	.	C	T	15	8	23	0	1	24	0	0
23	22923198	.	C	T	5	6	11	0	1	12	0	0
23	22923339	.	C	T	10	11	21	0	0	21	0	0
23	22923537	.	C	T	10	7	17	0	0	17	0	0
23	22923603	.	T	C	12	15	27	0	1	28	0	0
23	22925490	.	C	A	9	10	19	0	0	19	0	0
23	23096495	.	A	G	1	0	1	0	2	3	0	0
23	23118653	.	A	T	1	4	5	0	0	5	0	0
23	23122381	.	C	T	8	4	12	0	2	14	0	0
23	23122955	.	G	T	6	7	13	0	0	13	0	0
23	23123146	.	G	T	3	7	10	0	3	13	0	0
23	23123715	.	C	T	3	4	7	0	1	8	0	0
23	23126589	.	A	C	2	6	8	0	1	9	0	0
23	23126621	.	T	C	2	6	8	0	0	8	0	0
23	23205469	.	A	G	3	0	3	1	4	8	0	0
23	23205511	.	T	C	4	3	7	1	2	10	0	0
23	23210288	.	A	G	6	6	12	0	1	13	0	0
23	23210303	.	A	G	7	8	15	0	0	15	0	0
23	23210339	.	C	T	2	8	10	0	1	11	0	0
23	23212257	.	C	T	5	5	10	0	0	10	0	0
23	23212567	.	C	T	5	6	11	0	0	11	0	0
23	23213219	.	T	C	11	16	27	0	0	27	0	0
23	23213437	.	G	A	2	9	11	0	17	28	0	0
23	23213582	.	C	A	16	11	27	0	0	27	0	0
23	23213613	.	T	A	12	18	30	0	0	30	0	0
23	23213657	.	G	A	23	16	39	0	2	41	0	0
23	23213757	.	G	A	19	16	35	0	4	39	0	0
23	23213800	.	G	A	2	13	15	0	13	28	0	0
23	23213917	.	T	A	5	19	24	0	0	24	0	0
23	23213939	.	T	A	7	17	24	0	1	25	0	0
23	23214070	.	C	T	5	3	8	0	0	8	0	0
23	23214417	.	C	T	10	5	15	0	2	17	0	0
23	23399987	.	T	C	6	9	15	0	0	15	0	0
23	23400332	.	G	C	2	4	6	0	0	6	0	0
23	23816509	.	A	C	2	2	4	0	0	4	0	0
23	23860113	.	T	A	2	5	7	0	0	7	0	0
23	23860117	.	G	A	1	5	6	0	1	7	0	0
23	23877088	.	A	G	6	0	6	0	5	11	0	0
23	23888136	.	G	A	0	8	8	0	6	14	0	0
23	23891551	.	G	A	0	11	11	0	11	22	0	0
23	23903278	.	G	A	2	12	14	0	8	22	0	0
23	23903432	.	C	T	11	8	19	0	0	19	0	0
23	23912720	.	G	T	22	13	35	0	1	36	0	0
23	23912723	.	C	A	22	13	35	0	0	35	0	0
23	23912900	.	C	G	16	8	24	0	0	24	0	0
23	23913240	.	G	T	18	18	36	1	3	40	0	0
23	23913818	.	A	T	16	16	32	0	2	34	0	0
23	23913858	.	A	C	23	21	44	0	4	48	0	0
23	23914017	.	G	A	4	16	20	0	27	47	0	0
23	23914176	.	A	T	27	16	43	0	2	45	0	0
23	23994537	.	T	C	2	2	4	0	0	4	0	0
23	23994595	.	C	T	1	2	3	0	1	4	0	0
23	23995111	.	G	T	2	2	4	0	0	4	0	0
23	24143464	.	T	A	1	1	2	0	1	3	0	0
23	24143471	.	G	A	1	3	4	0	0	4	0	0
23	24170870	.	G	A	15	9	24	0	0	24	0	0
23	24195469	.	C	T	4	2	6	0	0	6	0	0
23	24195611	.	T	C	1	0	1	0	3	4	0	0
23	24202602	.	C	T	4	3	7	0	0	7	0	0
23	24202658	.	G	A	3	3	6	0	0	6	0	0
23	24202858	.	C	T	2	3	5	0	0	5	0	0
23	24202985	.	T	C	4	2	6	0	0	6	0	0
23	24208176	.	G	A	1	2	3	0	0	3	0	0
23	24227315	.	T	C	2	3	5	0	0	5	0	0
23	24227352	.	A	T	8	10	18	0	0	18	0	0
23	24227380	.	A	G	8	13	21	0	3	24	0	0
23	24227458	.	T	C	13	13	26	0	3	29	0	0
23	24227673	.	C	A	24	18	42	0	1	43	0	0
23	24228767	.	G	A	13	12	25	0	1	26	0	0
23	24229110	.	G	A	9	11	20	0	0	20	0	0
23	24231222	.	A	G	7	2	9	0	1	10	0	0
23	24233458	.	A	G	3	2	5	0	0	5	0	0
23	24238551	.	G	A	1	2	3	0	0	3	0	0
23	24240979	.	G	T	3	10	13	0	0	13	0	0
23	24243168	.	G	A	7	10	17	0	0	17	0	0
23	24244694	.	C	T	0	6	6	0	2	8	0	0
23	24251829	.	T	A	1	2	3	0	1	4	0	0
23	24439480	.	G	T	13	5	18	0	1	19	0	0
23	24439780	.	G	A	17	10	27	0	0	27	0	0
23	24440397	.	C	T	8	10	18	0	4	23	1	0
23	24442787	.	T	G	17	15	32	0	0	32	0	0
23	24443161	.	G	T	8	7	15	0	0	15	0	0
23	24443576	.	A	G	11	5	16	0	1	17	0	0
23	24443609	.	C	T	0	4	4	0	8	12	0	0
23	24444291	.	A	G	9	10	19	0	0	19	0	0
23	24444344	.	C	G	8	5	13	0	0	13	0	0
23	24444543	.	C	T	0	4	4	0	2	6	0	0
23	24444861	.	G	A	4	3	7	0	0	7	0	0
23	24445112	.	G	T	5	5	10	0	1	11	0	0
23	24445338	.	A	G	5	4	9	0	1	10	0	0
23	24445584	.	A	G	2	2	4	0	2	6	0	0
23	24445876	.	A	G	1	3	4	0	0	4	0	0
23	24445906	.	G	C	4	3	7	0	0	7	0	0
23	24448273	.	G	C	4	2	6	0	0	6	0	0
23	24504389	.	A	G	5	0	5	0	9	14	0	0
23	24591764	.	G	A	3	2	5	0	0	5	0	0
23	24600513	.	C	T	2	4	6	0	0	6	0	0
23	24600947	.	T	C	3	3	6	0	0	6	0	0
23	24604042	.	C	T	6	9	15	0	2	17	0	0
23	24604323	.	C	T	10	7	17	0	0	17	0	0
23	24604461	.	A	G	9	0	9	0	8	17	0	0
23	24605243	.	T	A	12	7	19	0	2	21	0	0
23	24608805	.	G	A	13	6	19	0	0	19	0	0
23	24608847	.	G	A	1	13	14	0	8	22	0	0
23	24655761	.	T	G	1	0	1	0	2	3	0	0
23	24669381	.	C	T	2	11	13	0	13	26	0	0
23	24669633	.	T	C	12	1	13	0	16	29	0	0
23	24676192	.	G	C	8	7	15	0	0	15	0	0
23	24694242	.	C	A	12	7	19	0	0	20	1	0
23	24694756	.	C	T	12	14	26	0	1	27	0	0
23	24694763	.	T	A	13	12	25	0	1	26	0	0
23	24697036	.	G	A	10	9	19	0	1	20	0	0
23	24699281	.	T	A	3	2	5	0	2	7	0	0
23	24750203	.	G	A	1	2	3	0	0	3	0	0
23	24803130	.	C	T	12	9	21	0	3	24	0	0
23	24803221	.	T	C	5	0	5	0	14	19	0	0
23	24926470	.	G	A	2	2	4	0	0	4	0	0
23	24932979	.	G	A	3	2	5	0	0	5	0	0
23	24933121	.	C	T	5	5	10	0	0	10	0	0
23	24934567	.	T	C	4	5	9	0	0	9	0	0
23	24934597	.	C	G	5	6	11	0	0	11	0	0
23	24959374	.	G	C	1	2	3	0	0	3	0	0
23	24965393	.	C	T	7	4	11	0	0	11	0	0
23	24965396	.	G	A	7	4	11	0	0	11	0	0
23	24965432	.	G	T	8	5	13	0	0	13	0	0
23	24968676	.	C	A	2	4	6	0	1	7	0	0
23	24970331	.	A	G	4	0	4	0	7	11	0	0
23	24970372	.	G	A	5	4	9	0	2	11	0	0
23	24970589	.	A	G	5	2	7	0	0	7	0	0
23	24970593	.	G	A	6	1	7	0	1	8	0	0
23	24973871	.	T	C	1	2	3	0	0	3	0	0
23	24980349	.	T	A	2	2	4	0	0	4	0	0
23	24980448	.	A	G	0	2	2	0	1	3	0	0
23	24983469	.	C	G	1	2	3	0	0	3	0	0
23	24983479	.	G	C	1	2	3	0	0	3	0	0
23	24983572	.	C	T	2	4	6	0	0	6	0	0
23	24984969	.	A	C	4	3	7	0	1	8	0	0
23	25015332	.	G	A	2	2	4	0	0	4	0	0
23	25767757	.	G	A	0	4	4	0	6	10	0	0
23	25768133	.	C	G	2	2	4	0	0	4	0	0
23	25768384	.	C	T	2	2	4	0	0	4	0	0
23	25770414	.	G	A	2	2	4	0	0	4	0	0
23	25772369	.	A	G	7	8	15	0	2	17	0	0
23	25772799	.	G	A	2	2	4	0	0	4	0	0
23	25773460	.	G	A	3	2	5	0	1	6	0	0
23	25773469	.	G	A	2	5	7	0	0	7	0	0
23	25773505	.	G	T	3	6	9	0	0	9	0	0
23	25796410	.	T	A	3	4	7	0	0	7	0	0
23	25797011	.	T	A	5	5	10	0	0	10	0	0
23	25797022	.	T	A	4	4	8	0	0	8	0	0
23	25797216	.	G	A	3	3	6	0	0	6	0	0
23	25869658	.	C	T	4	4	8	0	1	9	0	0
23	25869706	.	A	G	2	2	4	0	0	4	0	0
23	25871764	.	C	A	5	4	9	0	0	9	0	0
23	25872703	.	G	A	0	9	9	0	3	12	0	0
23	25873444	.	C	A	4	5	9	0	0	9	0	0
23	25873570	.	G	A	2	3	5	0	2	7	0	0
23	25873965	.	T	A	5	1	6	0	0	6	0	0
23	25873976	.	T	A	6	5	11	0	0	11	0	0
23	25874249	.	A	G	11	0	11	0	10	21	0	0
23	25874261	.	T	A	11	9	20	0	1	21	0	0
23	25874334	.	C	G	1	8	9	0	0	9	0	0
23	25874355	.	A	T	2	6	8	0	0	8	0	0
23	25874459	.	A	T	13	7	20	0	0	20	0	0
23	25874498	.	G	A	11	10	21	0	0	21	0	0
23	25874615	.	G	A	2	6	8	0	0	8	0	0
23	25879786	.	A	G	5	4	9	0	2	11	0	0
23	25879930	.	A	C	8	8	16	1	0	17	0	0
23	25930689	.	C	T	16	17	33	0	0	33	0	0
23	25942399	.	T	G	20	1	21	0	13	34	0	0
23	25942559	.	T	A	5	14	19	0	0	19	0	0
23	25942708	.	G	A	1	4	5	0	1	6	0	0
23	25946732	.	A	G	1	3	4	0	0	4	0	0
23	26063372	.	G	A	13	3	16	0	2	18	0	0
23	26063560	.	A	T	26	23	49	0	5	54	0	0
23	26063614	.	A	C	22	30	52	0	5	57	0	0
23	26063734	.	G	A	31	18	49	0	0	49	0	0
23	26063843	.	G	A	21	36	57	0	3	60	0	0
23	26063985	.	A	T	32	18	50	0	5	55	0	0
23	26064050	.	T	A	27	17	44	1	2	47	0	0
23	26064122	.	T	A	12	18	30	1	0	31	0	0
23	26064124	.	T	A	23	5	28	1	2	31	0	0
23	26064266	.	T	A	11	3	14	0	0	15	1	0
23	26064923	.	T	C	30	2	32	0	24	56	0	0
23	26064948	.	T	G	27	21	48	0	3	51	0	0
23	26064989	.	A	G	22	27	49	0	0	49	0	0
23	26065079	.	T	C	26	30	56	0	2	58	0	0
23	26074123	.	G	A	7	7	14	0	0	14	0	0
23	26074252	.	T	A	4	5	9	0	0	9	0	0
23	26093095	.	C	T	6	3	9	0	0	9	0	0
23	26093331	.	T	C	4	1	5	0	1	6	0	0
23	26093597	.	A	G	4	6	10	0	0	10	0	0
23	26093868	.	T	C	3	2	5	0	0	5	0	0
23	26093933	.	A	T	3	2	5	0	0	5	0	0
23	26094063	.	A	G	5	3	8	0	0	8	0	0
23	26094533	.	A	G	5	14	19	0	1	20	0	0
23	26094589	.	G	C	10	22	32	0	1	33	0	0
23	26094617	.	T	C	13	22	35	0	3	38	0	0
23	26094626	.	T	C	13	0	13	0	27	40	0	0
23	26094694	.	A	C	3	17	20	0	0	20	0	0
23	26094877	.	A	G	6	5	11	0	0	11	0	0
23	26094932	.	G	A	6	4	10	0	1	11	0	0
23	26094938	.	C	A	8	5	13	0	0	13	0	0
23	26095081	.	G	A	12	11	23	0	0	23	0	0
23	26095096	.	C	T	10	18	28	0	1	29	0	0
23	26095153	.	G	A	8	15	23	0	2	25	0	0
23	26095285	.	T	A	9	13	22	0	1	23	0	0
23	26095400	.	C	T	20	25	45	0	3	48	0	0
23	26095416	.	T	G	25	23	48	0	2	50	0	0
23	26110735	.	G	A	8	14	22	0	0	22	0	0
23	26111090	.	C	G	9	3	12	0	0	12	0	0
23	26126392	.	T	C	1	2	3	0	1	4	0	0
23	26187603	.	C	A	0	2	2	0	2	4	0	0
23	26187735	.	C	T	2	3	5	0	0	5	0	0
23	26232509	.	C	A	2	4	6	0	0	6	0	0
23	26240860	.	G	A	5	5	10	0	0	10	0	0
23	26498568	.	T	C	1	3	4	0	1	5	0	0
23	26503884	.	T	C	39	3	42	0	19	61	0	0
23	26504202	.	A	T	42	19	61	0	6	67	0	0
23	26504254	.	G	A	40	18	58	0	3	61	0	0
23	26504264	.	C	T	40	18	58	0	0	58	0	0
23	26507741	.	G	A	22	31	53	0	1	54	0	0
23	26509764	.	G	A	22	26	48	0	2	50	0	0
23	26517183	.	G	A	9	13	22	0	2	24	0	0
23	26522647	.	A	G	2	6	8	0	2	10	0	0
23	26522892	.	G	A	4	2	6	0	2	8	0	0
23	26763798	.	A	T	6	8	14	0	1	15	0	0
23	26763994	.	C	A	6	4	10	0	1	11	0	0
23	26766668	.	A	G	4	3	7	0	0	7	0	0
23	26797166	.	G	A	1	2	3	0	0	3	0	0
23	26958483	.	A	G	1	2	3	0	0	3	0	0
23	26979223	.	C	A	5	2	7	0	0	7	0	0
23	27003630	.	T	A	10	10	20	1	1	22	0	0
23	27003720	.	G	A	13	15	28	0	1	29	0	0
23	27003801	.	T	C	15	17	32	0	1	33	0	0
23	27004310	.	C	T	14	16	30	0	0	30	0	0
23	27004339	.	C	T	15	14	29	0	1	30	0	0
23	27004347	.	G	A	15	13	28	0	1	29	0	0
23	27004383	.	C	T	18	14	32	0	1	33	0	0
23	27004397	.	T	C	18	13	31	0	2	33	0	0
23	27004665	.	T	C	11	12	23	0	2	25	0	0
23	27005195	.	G	A	18	15	33	0	5	38	0	0
23	27005514	.	A	G	10	1	11	0	10	21	0	0
23	27041461	.	A	T	1	2	3	0	0	3	0	0
23	27042132	.	A	G	5	3	8	0	0	8	0	0
23	27052123	.	C	A	7	10	17	0	0	17	0	0
23	27052125	.	C	T	7	10	17	0	0	17	0	0
23	27054361	.	C	T	8	3	11	0	1	12	0	0
23	27059120	.	G	A	0	13	13	0	13	26	0	0
23	27059376	.	T	A	17	10	27	0	0	27	0	0
23	27059422	.	C	T	17	10	27	0	3	30	0	0
23	27059459	.	A	G	16	0	16	0	17	33	0	0
23	27059526	.	G	A	1	15	16	0	16	32	0	0
23	27135377	.	A	G	1	2	3	0	0	3	0	0
23	27251789	.	G	C	14	15	29	0	3	32	0	0
23	27251859	.	G	A	15	17	32	0	3	35	0	0
23	27251872	.	C	T	0	16	16	0	16	32	0	0
23	27252425	.	G	A	10	24	34	0	1	35	0	0
23	27252587	.	A	G	11	14	25	0	0	25	0	0
23	27252833	.	A	G	5	9	14	0	3	17	0	0
23	27254226	.	T	C	1	4	5	0	0	5	0	0
23	27279281	.	A	G	2	3	5	0	0	5	0	0
23	27279320	.	A	G	2	2	4	0	0	4	0	0
23	27296964	.	G	C	1	0	1	0	2	3	0	0
23	27358990	.	A	T	5	10	15	0	1	16	0	0
23	27359203	.	A	G	6	8	14	0	0	14	0	0
23	27359410	.	G	A	11	4	15	0	1	16	0	0
23	27359526	.	T	C	10	7	17	0	2	19	0	0
23	27359755	.	C	T	1	4	5	0	5	10	0	0
23	27359825	.	C	A	4	6	10	0	1	11	0	0
23	27359867	.	A	C	7	5	12	0	0	12	0	0
23	27360007	.	G	A	3	3	6	0	1	7	0	0
23	27366669	.	C	T	2	3	5	0	0	5	0	0
23	27497960	.	A	T	14	15	29	0	0	30	1	0
23	27498027	.	A	T	8	22	30	0	0	30	0	0
23	27498040	.	C	G	17	10	27	0	3	30	0	0
23	27498195	.	A	T	11	17	28	0	1	29	0	0
23	27498441	.	A	T	7	8	15	0	1	16	0	0
23	27498798	.	C	T	0	18	18	0	18	36	0	0
23	27499096	.	G	A	9	7	16	0	1	17	0	0
23	27499195	.	A	T	6	11	17	0	1	18	0	0
23	27499246	.	G	A	11	8	19	0	0	19	0	0
23	27499306	.	C	T	9	6	15	0	0	15	0	0
23	27501872	.	A	G	5	2	7	0	0	7	0	0
23	27513952	.	A	G	6	6	12	0	0	12	0	0
23	27515931	.	G	A	7	6	13	0	1	14	0	0
23	27518434	.	G	A	0	3	3	0	1	4	0	0
23	27576533	.	T	G	2	3	5	0	0	5	0	0
23	27591466	.	C	A	6	2	8	0	0	8	0	0
23	27591467	.	T	A	6	2	8	0	0	8	0	0
23	27591629	.	T	A	2	2	4	0	1	5	0	0
23	27591834	.	C	T	5	9	14	0	1	15	0	0
23	27591859	.	C	T	6	8	14	0	2	16	0	0
23	27591939	.	A	G	3	8	11	0	0	11	0	0
23	27592411	.	A	C	5	5	10	0	1	11	0	0
23	27592615	.	T	C	4	2	6	0	1	7	0	0
23	27592796	.	T	C	5	1	6	0	7	13	0	0
23	27593230	.	C	T	4	5	9	0	0	9	0	0
23	27597141	.	C	A	0	3	3	0	4	7	0	0
23	27597808	.	G	A	1	2	3	0	0	3	0	0
23	27599110	.	A	C	2	2	4	0	0	4	0	0
23	27599365	.	G	A	5	2	7	0	0	7	0	0
23	27601803	.	C	T	1	3	4	0	0	4	0	0
23	27622036	.	T	A	21	20	41	0	1	42	0	0
23	27622212	.	C	A	13	9	22	0	1	23	0	0
23	27622258	.	T	C	9	11	20	0	0	20	0	0
23	27622324	.	T	C	8	7	15	0	0	15	0	0
23	27622386	.	T	G	2	4	6	0	1	7	0	0
23	27629923	.	A	T	2	4	6	0	1	7	0	0
23	27677263	.	G	A	44	19	63	0	1	64	0	0
23	27677278	.	G	A	20	35	55	0	8	63	0	0
23	27683371	.	C	T	0	7	7	0	3	10	0	0
23	27683497	.	C	T	2	6	8	0	0	8	0	0
23	27788768	.	G	A	2	3	5	0	0	5	0	0
23	27793510	.	T	C	2	7	9	0	0	9	0	0
23	27800681	.	G	T	8	4	12	0	0	12	0	0
23	27800954	.	A	C	20	12	32	0	1	33	0	0
23	27800977	.	C	T	18	15	33	0	0	33	0	0
23	27801101	.	T	C	11	0	11	0	5	16	0	0
23	27801104	.	T	C	9	3	12	0	2	14	0	0
23	27801237	.	T	C	8	12	20	0	2	22	0	0
23	27801268	.	C	A	6	15	21	2	3	26	0	0
23	27801629	.	C	T	5	3	8	0	1	9	0	0
23	27801849	.	G	A	5	5	10	0	2	12	0	0
23	27801880	.	G	T	5	7	12	0	0	12	0	0
23	27807294	.	A	G	4	4	8	0	0	8	0	0
23	27836003	.	C	G	3	3	6	0	0	6	0	0
23	28023784	.	T	C	9	11	20	0	1	21	0	0
23	28025586	.	G	A	2	3	5	0	0	5	0	0
23	28131047	.	T	C	2	2	4	0	1	5	0	0
23	28131083	.	A	G	3	2	5	0	0	5	0	0
23	28131248	.	C	T	4	2	6	0	0	6	0	0
23	28131251	.	C	T	4	2	6	0	0	6	0	0
23	28136167	.	G	T	5	6	11	0	1	12	0	0
23	28136471	.	T	G	5	2	7	0	0	7	0	0
23	28139515	.	C	T	3	2	5	0	0	5	0	0
23	28139564	.	A	G	2	4	6	0	3	9	0	0
23	28139633	.	T	C	6	7	13	0	0	13	0	0
23	28139812	.	A	G	9	12	21	0	0	21	0	0
23	28186060	.	T	A	3	2	5	0	1	6	0	0
23	28186688	.	T	G	4	2	6	0	0	6	0	0
23	28374570	.	G	A	8	12	20	0	2	22	0	0
23	28374711	.	C	A	8	9	17	0	1	18	0	0
23	28374756	.	A	G	6	15	21	0	0	21	0	0
23	28382953	.	C	T	17	31	48	0	1	49	0	0
23	28388013	.	C	A	27	22	49	0	4	53	0	0
23	28388318	.	C	T	24	17	41	0	0	41	0	0
23	28388325	.	T	C	21	16	37	0	1	38	0	0
23	28539279	.	G	A	0	2	2	0	1	3	0	0
23	28541633	.	A	G	3	3	6	0	1	7	0	0
23	28541638	.	C	T	4	3	7	0	0	7	0	0
23	28541683	.	G	T	4	2	6	0	0	6	0	0
23	28561248	.	T	C	14	10	24	0	1	25	0	0
23	28561502	.	C	A	14	13	27	0	1	28	0	0
23	28561836	.	C	T	17	12	29	0	1	30	0	0
23	28564191	.	C	A	21	16	37	0	1	38	0	0
23	28674890	.	A	C	3	2	5	0	0	5	0	0
23	28679693	.	A	G	2	2	4	0	0	4	0	0
23	28679696	.	C	T	3	2	5	0	0	5	0	0
23	28679753	.	C	T	5	2	7	0	0	7	0	0
23	28680239	.	A	G	6	6	12	0	0	12	0	0
23	28681558	.	G	C	10	11	21	0	1	22	0	0
23	28681559	.	C	A	10	10	20	0	2	22	0	0
23	28681723	.	T	A	17	15	32	0	0	32	0	0
23	28687637	.	G	T	5	4	9	0	0	9	0	0
23	28687766	.	C	T	5	2	7	0	0	7	0	0
23	28691837	.	C	T	0	2	2	0	1	3	0	0
23	28691851	.	G	A	1	2	3	0	0	3	0	0
23	28707195	.	T	A	2	3	5	0	0	5	0	0
23	28710429	.	T	C	6	3	9	0	0	9	0	0
23	28724964	.	A	G	2	4	6	0	0	6	0	0
23	28725600	.	A	T	6	4	10	0	0	10	0	0
23	28725743	.	A	G	1	3	4	0	0	4	0	0
23	28725804	.	G	A	4	4	8	0	0	8	0	0
23	28725830	.	T	C	4	2	6	0	0	6	0	0
23	28725847	.	A	G	2	2	4	0	0	4	0	0
23	28726521	.	A	G	4	5	9	0	1	10	0	0
23	28726634	.	A	C	4	4	8	0	0	8	0	0
23	28726985	.	A	T	4	4	8	0	0	8	0	0
23	28731489	.	A	C	23	19	42	0	2	44	0	0
23	28731499	.	C	T	23	19	42	0	0	42	0	0
23	28731834	.	C	T	31	35	66	0	2	68	0	0
23	28731914	.	T	C	34	21	55	0	1	56	0	0
23	28732305	.	A	T	2	9	11	0	0	11	0	0
23	28803167	.	A	G	1	3	4	0	1	5	0	0
23	28803302	.	T	C	4	5	9	0	2	11	0	0
23	28803305	.	C	T	4	5	9	0	1	10	0	0
23	28806171	.	A	G	2	3	5	0	1	6	0	0
23	28923760	.	T	A	4	6	10	0	0	10	0	0
23	28923962	.	A	G	4	5	9	0	0	9	0	0
23	28924117	.	G	C	3	2	5	0	0	5	0	0
23	28924399	.	C	G	4	3	7	0	2	9	0	0
23	28924672	.	C	T	3	2	5	0	1	6	0	0
23	28925275	.	T	C	4	6	10	0	1	11	0	0
23	28925354	.	T	C	8	9	17	0	0	17	0	0
23	28925441	.	G	A	5	8	13	0	0	13	0	0
23	28925451	.	A	T	3	9	12	0	1	13	0	0
23	28925620	.	A	G	2	4	6	0	1	7	0	0
23	29358241	.	G	A	5	11	16	0	18	34	0	0
23	29358253	.	C	T	22	13	35	0	1	36	0	0
23	29359664	.	T	A	16	6	22	0	0	22	0	0
23	29360407	.	G	T	1	12	13	0	12	25	0	0
23	29360687	.	G	T	5	5	10	0	0	10	0	0
23	29360707	.	G	T	5	4	9	0	0	9	0	0
23	29361357	.	C	A	18	19	37	0	1	38	0	0
23	29361365	.	A	C	21	17	38	0	1	39	0	0
23	29376410	.	C	T	6	4	10	0	0	10	0	0
23	29381612	.	C	A	8	13	21	0	1	22	0	0
23	29386735	.	C	T	2	2	4	0	0	4	0	0
23	29396452	.	C	T	5	31	36	0	24	60	0	0
23	29397116	.	C	G	21	15	36	0	2	38	0	0
23	29397230	.	T	A	30	19	49	0	2	51	0	0
23	29397563	.	C	T	2	24	26	0	17	43	0	0
23	29397665	.	T	G	13	19	32	0	0	32	0	0
23	29397816	.	G	A	20	20	40	0	3	43	0	0
23	29397907	.	T	C	33	13	46	0	0	47	1	0
23	29398065	.	T	C	18	20	38	0	1	39	0	0
23	29398544	.	C	A	2	11	13	0	17	30	0	0
23	29398548	.	A	G	19	10	29	0	0	29	0	0
23	29399085	.	T	C	21	0	21	0	16	37	0	0
23	29403306	.	T	G	15	13	28	0	3	32	1	0
23	29403437	.	G	A	17	17	34	0	1	35	0	0
23	29403491	.	C	A	16	17	33	0	2	35	0	0
23	29403515	.	A	C	15	17	32	0	5	37	0	0
23	29405829	.	A	G	10	17	27	0	1	28	0	0
23	29408773	.	A	G	8	10	18	0	0	18	0	0
23	29412411	.	A	G	8	8	16	0	0	16	0	0
23	29415484	.	A	G	4	4	8	0	1	9	0	0
23	29421959	.	C	G	6	4	10	0	1	11	0	0
23	29431995	.	T	C	1	3	4	0	0	4	0	0
23	29432867	.	T	G	3	3	6	0	0	6	0	0
23	29435044	.	T	C	0	2	2	0	1	3	0	0
23	29507723	.	A	T	20	16	36	0	0	36	0	0
23	29507825	.	T	C	14	0	14	0	11	25	0	0
23	29507859	.	T	G	9	9	18	0	0	18	0	0
23	29507883	.	G	A	10	9	19	0	1	20	0	0
23	29508247	.	G	C	13	1	14	0	15	29	0	0
23	29516726	.	T	C	3	3	6	0	2	8	0	0
23	29519565	.	G	A	3	3	6	0	1	7	0	0
23	29519769	.	G	C	5	2	7	0	0	7	0	0
23	29570627	.	C	G	5	7	12	0	1	13	0	0
23	29580587	.	A	T	8	3	11	0	3	14	0	0
23	29582416	.	T	C	13	33	46	0	4	50	0	0
23	29582420	.	T	C	10	41	51	0	1	52	0	0
23	29582476	.	T	C	8	44	52	0	1	53	0	0
23	29582496	.	T	C	25	22	47	0	2	49	0	0
23	29582634	.	C	A	31	16	47	0	2	49	0	0
23	29582673	.	A	G	38	13	51	0	4	55	0	0
23	29583417	.	T	A	24	19	43	0	3	46	0	0
23	29583708	.	G	A	29	18	47	0	1	48	0	0
23	29583814	.	T	A	23	30	53	0	2	55	0	0
23	29583882	.	A	G	29	31	60	3	2	65	0	0
23	29583960	.	G	A	30	26	56	0	4	60	0	0
23	29586380	.	G	A	26	24	50	0	3	53	0	0
23	29589392	.	A	G	14	14	28	0	1	29	0	0
23	29592588	.	T	C	15	0	15	0	14	29	0	0
23	29592708	.	G	A	14	12	26	0	2	28	0	0
23	29592741	.	C	T	13	10	23	0	4	27	0	0
23	29592927	.	T	C	11	0	11	0	6	17	0	0
23	29594441	.	A	G	8	4	12	0	0	12	0	0
23	29601269	.	C	T	3	3	6	0	0	6	0	0
23	29603174	.	T	C	3	2	5	0	1	6	0	0
23	29608769	.	A	G	5	3	8	0	1	9	0	0
23	29667473	.	A	C	4	2	6	0	0	6	0	0
23	29667480	.	G	A	5	3	8	0	0	8	0	0
23	29711788	.	G	A	19	13	32	0	2	34	0	0
23	29711911	.	C	T	23	8	31	0	1	32	0	0
23	29711998	.	G	A	16	19	35	0	1	36	0	0
23	29712140	.	G	A	3	8	11	0	0	11	0	0
23	29712465	.	G	A	7	12	19	0	4	23	0	0
23	29712493	.	C	T	0	9	9	0	5	14	0	0
23	29712922	.	C	A	5	7	12	0	0	12	0	0
23	29756865	.	A	T	9	8	17	0	3	20	0	0
23	29758030	.	C	T	0	3	3	0	7	10	0	0
23	29758088	.	A	G	5	8	13	0	0	13	0	0
23	29764120	.	T	C	3	3	6	0	1	7	0	0
23	29781868	.	G	A	1	4	5	0	0	5	0	0
23	29823422	.	T	C	1	4	5	0	0	5	0	0
23	29827748	.	G	A	6	4	10	0	2	12	0	0
23	29829160	.	A	T	1	5	6	0	1	7	0	0
23	29829186	.	A	C	6	4	10	0	1	11	0	0
23	29840171	.	T	C	1	0	1	0	4	5	0	0
23	29840178	.	A	G	2	4	6	0	0	6	0	0
23	29840274	.	C	A	1	3	4	0	0	4	0	0
23	29841374	.	T	C	6	7	13	0	0	13	0	0
23	29841961	.	T	C	5	3	8	0	1	9	0	0
23	29841965	.	T	C	7	3	10	0	0	10	0	0
23	29842966	.	C	T	2	2	4	0	0	4	0	0
23	29842967	.	T	G	2	2	4	0	0	4	0	0
23	29843847	.	A	C	1	2	3	0	0	3	0	0
23	29843863	.	T	C	1	0	1	0	2	3	0	0
23	29854491	.	C	T	1	2	3	0	1	4	0	0
23	29861645	.	A	T	7	10	17	0	1	18	0	0
23	29861973	.	A	G	10	22	32	0	0	32	0	0
23	29861976	.	T	C	9	1	10	0	21	31	0	0
23	29867576	.	G	A	3	6	9	0	1	10	0	0
23	29886897	.	G	C	17	16	33	0	0	33	0	0
23	29886937	.	T	A	14	16	30	0	3	33	0	0
23	30014160	.	T	A	2	2	4	0	0	4	0	0
23	30014162	.	C	A	0	2	2	0	2	4	0	0
23	30055707	.	T	A	1	2	3	0	1	4	0	0
23	30061763	.	C	T	3	37	40	0	16	56	0	0
23	30061804	.	A	C	20	28	48	0	3	51	0	0
23	30061960	.	T	C	26	3	29	0	18	47	0	0
23	30062364	.	T	A	26	15	41	0	1	42	0	0
23	30062792	.	C	T	9	6	15	0	3	18	0	0
23	30062888	.	C	T	0	9	9	0	11	20	0	0
23	30063216	.	T	C	11	0	11	0	10	21	0	0
23	30063217	.	T	G	11	10	21	0	0	21	0	0
23	30063527	.	G	A	8	5	13	0	0	13	0	0
23	30063578	.	A	G	7	8	15	0	2	17	0	0
23	30063643	.	C	T	8	5	13	0	0	13	0	0
23	30063722	.	G	A	5	3	8	0	0	8	0	0
23	30064289	.	T	C	2	3	5	0	2	7	0	0
23	30064579	.	A	G	6	6	12	0	0	12	0	0
23	30064743	.	C	A	7	4	11	0	1	12	0	0
23	30064853	.	A	G	5	3	8	0	0	8	0	0
23	30065144	.	G	A	1	4	5	0	1	6	0	0
23	30074633	.	A	G	1	4	5	0	0	5	0	0
23	30074651	.	G	T	1	1	2	0	1	3	0	0
23	30075367	.	A	T	3	3	6	0	0	6	0	0
23	30715328	.	T	C	1	3	4	0	0	4	0	0
23	30715397	.	G	A	0	2	2	0	5	7	0	0
23	30715991	.	A	G	2	0	2	0	3	5	0	0
23	30718514	.	T	A	5	6	11	0	1	12	0	0
23	30718554	.	A	G	5	0	5	0	5	10	0	0
23	30724230	.	C	A	7	6	13	0	0	13	0	0
23	30724698	.	T	A	4	6	10	0	1	11	0	0
23	30724828	.	G	C	3	3	6	0	0	6	0	0
23	30725890	.	G	A	1	2	3	0	0	3	0	0
23	30750183	.	G	A	0	6	6	0	6	12	0	0
23	30750402	.	C	A	6	4	10	0	2	12	0	0
23	30752095	.	C	A	10	13	23	0	0	23	0	0
23	30752233	.	T	G	4	5	9	0	0	9	0	0
23	30752352	.	A	T	7	10	17	0	1	18	0	0
23	30761144	.	G	A	2	4	6	0	0	6	0	0
23	30764212	.	T	C	3	3	6	0	0	6	0	0
23	30770193	.	A	G	5	9	14	0	1	15	0	0
23	30772902	.	C	T	7	3	10	0	1	11	0	0
23	30775273	.	T	C	10	6	16	0	3	19	0	0
23	30778499	.	G	A	5	5	10	0	2	12	0	0
23	30859543	.	C	A	1	4	5	0	0	5	0	0
23	30898297	.	T	C	1	2	3	0	0	3	0	0
23	31248605	.	A	T	3	3	6	0	1	7	0	0
23	31248779	.	T	C	3	2	5	0	0	5	0	0
23	31278183	.	G	T	1	2	3	0	0	3	0	0
23	31278417	.	G	T	1	3	4	0	3	7	0	0
23	31278450	.	T	A	1	6	7	0	0	7	0	0
23	31358342	.	A	T	20	30	50	1	3	54	0	0
23	31358344	.	A	T	17	32	49	1	1	51	0	0
23	31358489	.	T	G	24	26	50	0	1	51	0	0
23	31358631	.	G	A	27	28	55	1	2	58	0	0
23	31405570	.	A	C	4	7	11	0	1	12	0	0
23	31419172	.	A	T	6	2	8	0	0	8	0	0
23	31422369	.	A	T	1	2	3	0	0	3	0	0
23	31422429	.	C	T	3	2	5	0	0	5	0	0
23	31422577	.	A	G	2	6	8	0	0	8	0	0
23	31422979	.	T	A	11	4	15	0	0	15	0	0
23	31423091	.	T	C	3	4	7	0	0	7	0	0
23	31423145	.	G	A	1	6	7	0	4	11	0	0
23	31423392	.	C	A	23	7	30	0	1	31	0	0
23	31423427	.	A	G	27	1	28	0	6	34	0	0
23	31423432	.	C	A	26	8	34	0	1	35	0	0
23	31432102	.	A	G	6	1	7	0	11	18	0	0
23	31440119	.	T	A	2	3	5	0	0	5	0	0
23	31596584	.	T	G	1	0	1	0	4	5	0	0
23	31597571	.	T	C	5	2	7	0	0	7	0	0
23	31604900	.	C	T	4	6	10	0	0	10	0	0
23	31604912	.	G	T	4	6	10	0	0	10	0	0
23	31640363	.	A	G	2	2	4	0	0	4	0	0
23	31641153	.	C	A	21	23	44	0	1	45	0	0
23	31641197	.	A	G	20	17	37	0	6	43	0	0
23	31641270	.	G	A	20	16	36	0	1	37	0	0
23	31643818	.	A	G	11	4	15	0	0	15	0	0
23	31644368	.	A	G	6	8	14	0	0	14	0	0
23	31644419	.	A	G	5	5	10	0	0	10	0	0
23	31644602	.	T	G	5	5	10	0	1	11	0	0
23	31684244	.	A	G	2	3	5	0	0	5	0	0
23	31684352	.	G	A	3	6	9	0	0	9	0	0
23	31767918	.	T	A	5	3	8	0	1	9	0	0
23	31768596	.	T	C	7	4	11	0	0	11	0	0
23	31771282	.	T	C	5	6	11	0	0	11	0	0
23	31774194	.	G	A	5	3	8	0	0	8	0	0
23	31785175	.	G	A	4	3	7	0	2	9	0	0
23	31785183	.	T	G	4	5	9	0	1	10	0	0
23	31787127	.	C	G	2	3	5	0	0	5	0	0
23	31918978	.	A	C	2	2	4	0	0	4	0	0
23	31933739	.	T	G	1	2	3	0	0	3	0	0
23	31940681	.	C	A	3	2	5	0	0	5	0	0
23	31953501	.	A	G	3	3	6	0	1	7	0	0
23	31953518	.	C	T	2	2	4	0	0	4	0	0
23	31953537	.	A	C	1	2	3	0	0	3	0	0
23	31962971	.	T	C	10	9	19	0	0	19	0	0
23	31963226	.	C	T	7	9	16	0	0	16	0	0
23	31964680	.	C	T	6	8	14	0	0	14	0	0
23	31997582	.	G	A	2	2	4	0	0	4	0	0
23	31998162	.	T	C	2	3	5	0	0	5	0	0
23	31998741	.	A	G	3	0	3	0	3	6	0	0
23	32000336	.	G	C	3	2	5	0	0	5	0	0
23	32001190	.	C	T	1	2	3	0	1	4	0	0
23	32003354	.	T	A	6	3	9	0	0	9	0	0
23	32003808	.	T	C	2	7	9	0	0	9	0	0
23	32003820	.	G	T	2	8	10	0	0	10	0	0
23	32007376	.	T	G	5	6	11	0	1	12	0	0
23	32007445	.	T	A	13	8	21	0	1	22	0	0
23	32007520	.	T	C	10	6	16	0	0	16	0	0
23	32007526	.	C	G	9	7	16	0	0	16	0	0
23	32026927	.	T	C	11	15	26	0	0	26	0	0
23	32026978	.	C	T	1	8	9	0	0	9	0	0
23	32026996	.	G	T	0	2	2	0	1	7	4	0
23	32037265	.	C	T	3	2	5	0	0	5	0	0
23	32081708	.	C	T	9	5	14	0	0	14	0	0
23	32081717	.	T	C	7	4	11	0	2	13	0	0
23	32088077	.	T	G	1	2	3	0	0	3	0	0
23	32128727	.	A	G	1	1	2	0	0	2	0	0
23	32128736	.	A	G	1	2	3	0	0	3	0	0
23	32128848	.	A	T	2	3	5	0	0	5	0	0
23	32128893	.	T	C	2	3	5	0	0	5	0	0
23	32129476	.	G	T	2	2	4	0	0	4	0	0
23	32150992	.	T	C	2	2	4	0	0	4	0	0
23	32151669	.	A	C	21	17	38	0	0	38	0	0
23	32152022	.	C	T	19	20	39	0	0	39	0	0
23	32154021	.	G	T	1	5	6	0	0	6	0	0
23	32155325	.	A	G	5	3	8	0	0	8	0	0
23	32155864	.	A	C	2	0	2	0	2	4	0	0
23	32200071	.	A	G	4	2	6	0	0	6	0	0
23	32200076	.	T	G	4	2	6	0	0	6	0	0
23	32200482	.	T	C	1	2	3	0	0	3	0	0
23	32200689	.	G	A	1	2	3	0	1	4	0	0
23	32239474	.	A	G	6	3	9	0	0	9	0	0
23	32239672	.	G	A	9	6	15	0	2	17	0	0
23	32239688	.	C	A	13	8	21	0	0	21	0	0
23	32239708	.	G	A	14	10	24	0	0	24	0	0
23	32239824	.	G	A	8	8	16	1	0	17	0	0
23	32240258	.	C	T	6	4	10	0	1	11	0	0
23	32240290	.	A	G	6	4	10	0	0	10	0	0
23	32242086	.	C	A	6	4	10	0	1	11	0	0
23	32246169	.	A	G	1	3	4	0	0	4	0	0
23	32309187	.	T	C	20	15	35	0	4	39	0	0
23	32309193	.	G	A	23	14	37	0	0	37	0	0
23	32309323	.	G	A	16	13	29	0	0	29	0	0
23	32309533	.	A	G	14	15	29	0	0	29	0	0
23	32309659	.	C	A	1	10	11	0	6	17	0	0
23	32309709	.	G	A	7	6	13	0	2	15	0	0
23	32309787	.	A	C	10	7	17	0	0	17	0	0
23	32309943	.	A	G	3	3	6	0	1	7	0	0
23	32310148	.	G	T	2	1	3	0	1	4	0	0
23	32310151	.	G	A	1	3	4	0	0	4	0	0
23	32310209	.	C	T	1	4	5	0	0	5	0	0
23	32310864	.	G	A	5	3	8	0	1	9	0	0
23	32311418	.	T	C	3	4	7	0	0	7	0	0
23	32311555	.	G	C	5	7	12	0	0	12	0	0
23	32311612	.	G	A	7	5	12	0	0	12	0	0
23	32318047	.	A	G	9	5	14	0	1	15	0	0
23	33447740	.	A	T	3	2	5	0	0	5	0	0
23	33447741	.	T	G	0	2	2	0	3	5	0	0
23	33657205	.	A	G	19	25	44	0	3	47	0	0
23	33657451	.	A	G	13	20	33	0	5	38	0	0
23	33658013	.	T	G	3	7	10	0	2	12	0	0
23	33658031	.	A	C	7	8	15	0	0	15	0	0
23	33658052	.	G	A	6	7	13	0	0	13	0	0
23	33663285	.	C	T	8	7	15	0	1	16	0	0
23	33664546	.	C	T	7	5	12	0	0	12	0	0
23	33728877	.	T	A	5	39	44	0	1	45	0	0
23	34753803	.	A	G	6	6	12	0	0	12	0	0
23	35027189	.	T	C	4	2	6	0	0	6	0	0
23	35027248	.	A	G	1	2	3	0	1	4	0	0
23	35027386	.	T	G	4	4	8	0	1	9	0	0
23	35027480	.	T	G	8	3	11	0	1	12	0	0
23	35027518	.	T	A	6	8	14	0	1	15	0	0
23	35027541	.	A	G	5	9	14	0	1	15	0	0
23	35362951	.	C	T	11	10	21	0	1	22	0	0
23	35362973	.	G	T	8	13	21	0	0	21	0	0
23	35363024	.	A	T	7	7	14	0	3	17	0	0
23	35363067	.	A	T	8	5	13	0	4	17	0	0
23	35363106	.	G	A	20	12	32	0	0	32	0	0
23	35363111	.	C	G	22	13	35	0	1	36	0	0
23	35363226	.	T	C	16	0	16	0	17	33	0	0
23	35363341	.	A	G	14	7	21	0	1	22	0	0
23	35469006	.	T	A	2	5	7	0	0	7	0	0
23	35469135	.	T	C	5	2	7	0	0	7	0	0
23	35469136	.	G	A	5	2	7	0	0	7	0	0
23	35469479	.	A	G	8	12	20	0	0	20	0	0
23	35469668	.	G	T	12	3	15	0	0	15	0	0
23	35473640	.	A	G	4	6	10	0	0	10	0	0
23	35537599	.	G	A	16	8	24	0	0	24	0	0
23	35537617	.	G	A	10	9	19	0	0	19	0	0
23	35642195	.	C	T	7	6	13	0	2	15	0	0
23	35642327	.	T	G	8	9	17	0	1	18	0	0
23	35664298	.	A	G	2	2	4	0	0	4	0	0
23	35691968	.	T	G	22	10	32	0	0	32	0	0
23	35691989	.	G	A	22	2	24	1	1	26	0	0
23	35709839	.	T	C	26	12	38	17	2	57	0	0
23	35709857	.	C	T	27	7	34	17	2	53	0	0
23	35710179	.	A	C	46	19	65	1	1	67	0	0
23	35710620	.	A	C	29	25	54	0	0	54	0	0
23	35714883	.	T	C	2	4	6	17	0	23	0	0
23	35727222	.	A	C	1	1	2	0	1	3	0	0
23	35771483	.	T	C	1	3	4	0	0	4	0	0
23	35771486	.	T	C	1	3	4	0	0	4	0	0
23	35782311	.	T	C	1	2	3	0	1	4	0	0
23	35786945	.	A	T	3	2	5	0	0	5	0	0
23	35787110	.	T	A	3	7	10	0	0	10	0	0
23	35787266	.	G	A	4	3	7	0	0	7	0	0
23	35787299	.	A	C	4	2	6	0	0	6	0	0
23	35787331	.	T	G	2	4	6	0	1	7	0	0
23	35787449	.	A	G	4	2	6	0	0	6	0	0
23	35787841	.	G	T	1	4	5	0	0	5	0	0
23	35788256	.	G	A	10	6	16	0	0	16	0	0
23	35788328	.	G	A	5	4	9	0	1	10	0	0
23	35800550	.	C	T	0	4	4	0	8	12	0	0
23	35800591	.	C	T	4	2	6	0	0	6	0	0
23	35960683	.	G	A	9	6	15	0	0	15	0	0
23	35963076	.	G	T	0	5	5	0	6	11	0	0
23	35963176	.	T	G	7	5	12	0	1	13	0	0
23	35963718	.	C	A	1	2	3	0	2	5	0	0
23	35982441	.	A	G	10	7	17	0	1	18	0	0
23	35982533	.	G	A	9	5	14	0	0	14	0	0
23	35982637	.	G	A	2	5	7	0	0	7	0	0
23	35982726	.	C	G	4	7	11	1	1	13	0	0
23	35982755	.	T	C	4	10	14	0	0	14	0	0
23	35983029	.	A	G	11	8	19	0	1	20	0	0
23	35993540	.	T	A	1	2	3	0	1	4	0	0
23	35993793	.	T	C	2	5	7	0	0	7	0	0
23	36000704	.	T	C	1	0	1	0	3	4	0	0
23	36132338	.	C	A	5	7	12	0	0	12	0	0
23	36297367	.	C	T	5	3	8	0	3	11	0	0
23	36297471	.	C	T	9	6	15	0	0	15	0	0
23	36297916	.	C	T	4	8	12	0	0	12	0	0
23	36298320	.	T	A	17	19	36	0	2	38	0	0
23	36298327	.	A	T	15	17	32	0	2	34	0	0
23	36298375	.	T	C	13	20	33	0	2	35	0	0
23	36298719	.	G	A	9	18	27	0	2	29	0	0
23	36301544	.	G	A	14	10	24	0	0	24	0	0
23	36301679	.	A	G	16	14	30	0	0	30	0	0
23	36303266	.	G	C	11	6	17	0	0	17	0	0
23	36306566	.	G	T	2	5	7	0	8	15	0	0
23	36307656	.	A	T	17	12	29	0	4	33	0	0
23	36307779	.	C	T	18	10	28	0	0	28	0	0
23	36307906	.	C	G	10	8	18	1	0	19	0	0
23	36310375	.	C	T	2	3	5	0	0	5	0	0
23	36343467	.	T	C	10	14	24	0	0	24	0	0
23	36353698	.	A	G	16	17	33	0	2	35	0	0
23	36353869	.	C	G	17	21	38	0	1	39	0	0
23	36353876	.	G	T	1	16	17	0	18	35	0	0
23	36353979	.	G	T	2	8	10	0	11	21	0	0
23	36401772	.	T	G	3	2	5	0	3	8	0	0
23	36401801	.	G	T	7	2	9	0	0	9	0	0
23	36401844	.	A	G	5	4	9	0	0	9	0	0
23	36401926	.	T	C	3	4	7	0	0	7	0	0
23	36404967	.	A	G	2	3	5	0	0	5	0	0
23	36405429	.	A	G	2	6	8	0	0	8	0	0
23	36443511	.	A	T	9	7	16	0	3	19	0	0
23	36443865	.	C	A	7	7	14	0	1	15	0	0
23	36444201	.	G	C	9	0	9	0	7	16	0	0
23	36445967	.	C	G	3	7	10	0	2	12	0	0
23	36446132	.	A	G	4	3	7	0	0	7	0	0
23	36446190	.	A	T	3	5	8	0	0	8	0	0
23	36446258	.	T	C	1	0	1	0	3	4	0	0
23	36491169	.	C	G	1	6	7	0	8	15	0	0
23	36500273	.	G	A	3	2	5	0	0	5	0	0
23	36616998	.	C	T	4	4	8	0	1	9	0	0
23	36627793	.	C	T	3	8	11	0	0	11	0	0
23	36627859	.	G	C	3	5	8	0	0	8	0	0
23	36638542	.	G	A	4	10	14	0	0	14	0	0
23	36644423	.	T	G	21	16	37	0	3	40	0	0
23	36644907	.	C	T	18	15	33	0	1	34	0	0
23	36662097	.	A	G	6	2	8	0	0	8	0	0
23	36662098	.	C	G	1	2	3	0	5	8	0	0
23	36662273	.	G	A	3	2	5	0	1	6	0	0
23	36662327	.	T	A	3	5	8	0	0	8	0	0
23	36662449	.	A	C	2	2	4	0	1	5	0	0
23	36662651	.	G	C	6	3	9	0	0	9	0	0
23	36662714	.	G	A	3	2	5	0	0	5	0	0
23	36663346	.	G	A	1	2	3	0	0	3	0	0
23	36663407	.	G	A	2	4	6	0	0	6	0	0
23	36666666	.	A	G	1	2	3	0	0	3	0	0
23	36666669	.	A	G	1	2	3	0	0	3	0	0
23	36679751	.	C	T	15	20	35	0	2	37	0	0
23	36679829	.	G	C	19	0	19	0	23	42	0	0
23	36679874	.	T	C	13	1	14	0	21	35	0	0
23	36681545	.	C	T	2	17	19	0	18	37	0	0
23	36681557	.	A	G	17	15	32	0	1	33	0	0
23	36681927	.	T	C	18	18	36	0	5	41	0	0
23	36683801	.	G	A	17	14	31	1	2	34	0	0
23	36688236	.	T	C	16	2	18	0	12	30	0	0
23	36690595	.	G	A	8	6	14	0	0	14	0	0
23	36690641	.	T	A	12	6	18	0	2	20	0	0
23	36700836	.	T	G	12	6	18	0	1	19	0	0
23	36700891	.	G	A	10	8	18	0	0	18	0	0
23	36700896	.	T	A	9	9	18	0	0	18	0	0
23	36749380	.	G	A	3	21	24	0	16	40	0	0
23	36750005	.	C	G	15	19	34	0	2	36	0	0
23	36772018	.	G	A	2	6	8	0	12	20	0	0
23	36798184	.	C	T	12	15	27	0	0	27	0	0
23	36798220	.	G	A	16	12	28	0	0	28	0	0
23	36798612	.	G	A	1	18	19	0	11	30	0	0
23	36816698	.	G	T	1	2	3	0	0	4	1	0
23	36907624	.	G	A	1	2	3	0	0	3	0	0
23	37068571	.	T	C	8	3	11	0	1	12	0	0
23	37086288	.	A	C	2	2	4	0	0	4	0	0
23	37089042	.	G	A	2	2	4	0	0	4	0	0
23	37089102	.	G	A	2	4	6	0	0	6	0	0
23	37089162	.	C	T	4	2	6	0	0	6	0	0
23	37089192	.	C	T	4	3	7	0	2	9	0	0
23	37089333	.	C	T	7	3	10	0	0	10	0	0
23	37089568	.	C	T	5	2	7	0	1	8	0	0
23	37089609	.	T	G	4	6	10	0	1	11	0	0
23	37089852	.	A	T	9	5	14	0	1	15	0	0
23	37090003	.	T	C	5	10	15	0	1	16	0	0
23	37093189	.	C	A	2	2	4	0	0	4	0	0
23	37277157	.	A	G	3	7	10	0	0	10	0	0
23	37277289	.	G	A	5	3	8	0	0	8	0	0
23	37280658	.	C	T	7	8	15	0	0	15	0	0
23	37324009	.	A	G	4	0	4	0	6	10	0	0
23	37324638	.	A	C	10	11	21	0	0	21	0	0
23	37324848	.	G	A	10	6	16	1	1	18	0	0
23	37324868	.	G	C	9	3	12	1	2	15	0	0
23	37324990	.	A	G	14	12	26	0	0	26	0	0
23	37325026	.	C	T	20	16	36	0	0	36	0	0
23	37325138	.	T	G	17	1	18	0	17	35	0	0
23	37325570	.	A	C	27	18	45	0	0	45	0	0
23	37325817	.	T	G	8	14	22	1	0	23	0	0
23	37458748	.	G	A	6	7	13	0	0	13	0	0
23	37458791	.	A	T	8	4	12	0	1	13	0	0
23	37461642	.	T	C	6	7	13	0	0	13	0	0
23	37464452	.	A	G	14	5	19	0	0	19	0	0
23	37465007	.	T	C	4	4	8	0	0	8	0	0
23	37465332	.	A	T	8	3	11	0	0	11	0	0
23	37465414	.	G	A	6	5	11	0	0	11	0	0
23	37465479	.	G	C	7	8	15	0	1	16	0	0
23	37465505	.	A	G	7	6	13	0	0	13	0	0
23	37465527	.	A	G	6	4	10	0	0	10	0	0
23	37465584	.	T	C	1	2	3	0	0	3	0	0
23	37476475	.	T	C	8	4	12	0	0	12	0	0
23	37476675	.	G	A	1	6	7	0	4	11	0	0
23	37478227	.	G	T	3	5	8	0	0	8	0	0
23	37478506	.	C	G	2	2	4	0	0	4	0	0
23	37479992	.	G	T	39	12	51	0	3	54	0	0
23	37970998	.	C	T	3	2	5	0	0	5	0	0
23	37973729	.	C	T	1	4	5	0	0	5	0	0
23	38093419	.	G	A	2	3	5	3	0	8	0	0
23	38151520	.	C	T	12	13	25	0	1	26	0	0
23	38379786	.	C	T	1	13	14	0	19	33	0	0
23	38380005	.	C	T	17	15	32	0	1	33	0	0
23	38380047	.	G	A	21	14	35	0	0	35	0	0
23	38381217	.	C	T	0	8	8	0	5	13	0	0
23	38381281	.	T	C	1	9	10	0	1	11	0	0
23	38381316	.	T	C	2	0	2	0	8	10	0	0
23	38817350	.	T	G	1	2	3	0	0	3	0	0
23	38818001	.	G	A	4	5	9	0	0	9	0	0
23	38818004	.	G	A	4	4	8	0	0	8	0	0
23	38818249	.	G	T	2	5	7	0	0	7	0	0
23	38818351	.	A	G	2	2	4	0	1	5	0	0
23	39322043	.	T	C	2	2	4	0	0	4	0	0
23	39413176	.	C	T	1	2	3	0	0	3	0	0
23	39448012	.	A	G	1	0	1	0	4	5	0	0
23	39449770	.	C	G	1	2	3	0	1	4	0	0
23	39450022	.	A	G	3	3	6	0	0	6	0	0
23	39594141	.	C	T	2	2	4	0	0	4	0	0
23	39594993	.	A	G	1	0	1	0	5	6	0	0
23	39595026	.	A	G	5	2	7	0	0	7	0	0
23	39596545	.	A	C	1	2	3	0	0	3	0	0
23	39596776	.	T	C	3	2	5	0	0	5	0	0
23	39596919	.	G	A	0	2	2	0	3	5	0	0
23	39597119	.	G	T	5	10	15	0	1	16	0	0
23	39597309	.	G	A	3	3	6	0	8	14	0	0
23	39597657	.	A	T	4	4	8	0	0	8	0	0
23	39611787	.	G	T	0	2	2	0	3	5	0	0
23	39621173	.	G	C	5	3	8	0	0	8	0	0
23	39623042	.	G	A	1	9	10	0	8	18	0	0
23	39626230	.	G	C	4	9	13	0	0	13	0	0
23	39626311	.	C	T	5	16	21	0	0	21	0	0
23	39626395	.	C	T	9	6	15	0	0	15	0	0
23	39626525	.	G	A	5	5	10	0	0	10	0	0
23	39626554	.	G	A	5	6	11	0	1	12	0	0
23	39632901	.	A	G	4	9	13	0	0	13	0	0
23	39633114	.	C	T	4	8	12	0	6	18	0	0
23	39633150	.	C	T	5	2	7	0	0	7	0	0
23	39635959	.	C	T	4	4	8	0	9	17	0	0
23	39636079	.	G	T	2	5	7	0	0	7	0	0
23	39636181	.	C	T	3	5	8	0	0	8	0	0
23	39638537	.	C	T	0	3	3	0	1	4	0	0
23	39744501	.	A	G	7	6	13	0	0	13	0	0
23	39744788	.	T	A	15	0	15	0	0	15	0	0
23	39744943	.	A	T	24	13	37	0	1	38	0	0
23	39756650	.	G	A	4	4	8	0	1	9	0	0
23	39756666	.	A	G	3	11	14	0	1	15	0	0
23	39756775	.	T	G	11	9	20	0	1	21	0	0
23	39756958	.	A	G	11	6	17	0	0	18	1	0
23	39758678	.	G	A	1	3	4	3	1	8	0	0
23	39758689	.	T	C	1	4	5	3	0	8	0	0
23	39759290	.	A	C	1	3	4	0	0	4	0	0
23	39759344	.	A	C	3	0	3	0	5	8	0	0
23	39759355	.	T	C	2	0	2	0	5	7	0	0
23	39759400	.	T	C	2	0	2	0	4	6	0	0
23	39764906	.	C	T	1	3	4	0	0	4	0	0
23	39765105	.	G	A	2	3	5	0	0	5	0	0
23	39767894	.	A	G	2	5	7	0	0	7	0	0
23	39768001	.	T	G	4	5	9	0	0	9	0	0
23	39808332	.	G	A	16	13	29	0	1	30	0	0
23	39808337	.	G	C	18	12	30	0	2	32	0	0
23	39808439	.	A	G	29	22	51	0	5	56	0	0
23	39808644	.	A	C	21	20	41	0	1	42	0	0
23	39808705	.	A	G	13	17	30	0	0	30	0	0
23	39808818	.	T	G	12	8	20	2	0	22	0	0
23	39808824	.	G	A	13	3	16	0	0	16	0	0
23	39809381	.	A	T	10	11	21	13	1	35	0	0
23	39809437	.	A	G	12	14	26	1	2	29	0	0
23	39809454	.	T	G	15	9	24	1	1	26	0	0
23	39809876	.	C	T	2	14	16	2	15	33	0	0
23	39810685	.	A	G	6	5	11	1	0	12	0	0
23	39810696	.	C	G	5	5	10	1	1	12	0	0
23	39811187	.	C	T	0	6	6	0	3	9	0	0
23	39811191	.	C	A	2	9	11	0	0	11	0	0
23	39811242	.	T	C	5	13	18	0	0	18	0	0
23	39811324	.	A	G	6	12	18	0	1	19	0	0
23	39811548	.	A	G	3	5	8	0	1	9	0	0
23	39811587	.	G	A	5	2	7	0	0	7	0	0
23	39811612	.	T	C	2	4	6	0	1	7	0	0
23	39811647	.	C	G	1	6	7	0	0	7	0	0
23	39811741	.	G	A	6	5	11	0	1	12	0	0
23	39811956	.	T	A	2	4	6	0	0	6	0	0
23	39812003	.	A	G	3	2	5	0	0	5	0	0
23	39812482	.	G	A	3	3	6	0	0	6	0	0
23	39812535	.	T	C	6	7	13	0	0	13	0	0
23	39812608	.	C	T	0	8	8	0	7	15	0	0
23	39812633	.	A	T	4	9	13	0	1	14	0	0
23	39812643	.	C	T	0	9	9	0	7	16	0	0
23	39936259	.	T	G	2	2	4	0	0	4	0	0
23	39936352	.	A	G	3	0	3	0	3	6	0	0
23	39940362	.	A	G	3	3	6	0	0	6	0	0
23	39940371	.	T	C	2	3	5	0	1	6	0	0
23	40234943	.	C	A	1	3	4	0	0	4	0	0
23	40234945	.	G	A	1	3	4	0	0	4	0	0
23	40285775	.	T	A	1	2	3	0	0	4	1	0
23	40285845	.	A	T	3	4	7	0	2	9	0	0
23	40437858	.	A	T	1	2	3	0	2	5	0	0
23	40438000	.	T	A	1	2	3	0	0	3	0	0
23	40460860	.	G	C	1	5	6	0	0	6	0	0
23	40462538	.	G	A	5	5	10	0	2	12	0	0
23	40466623	.	C	G	1	4	5	0	1	6	0	0
23	40466714	.	T	A	5	2	7	0	0	7	0	0
23	40471963	.	G	A	0	12	12	0	5	17	0	0
23	40472068	.	A	G	9	0	9	0	5	14	0	0
23	40480255	.	C	A	9	14	23	0	0	23	0	0
23	40480263	.	C	T	9	11	20	0	1	21	0	0
23	40526361	.	T	C	3	3	6	0	0	6	0	0
23	40526745	.	G	T	4	3	7	0	0	7	0	0
23	40526883	.	T	G	3	4	7	0	0	7	0	0
23	40527608	.	T	C	4	3	7	3	0	10	0	0
23	40527653	.	T	G	4	2	6	2	0	8	0	0
23	40528019	.	C	T	1	2	3	0	0	3	0	0
23	40528669	.	C	T	0	6	6	0	2	8	0	0
23	40528727	.	G	A	5	4	9	0	0	9	0	0
23	40528886	.	T	A	5	2	7	0	0	7	0	0
23	40528998	.	G	A	3	4	7	0	0	7	0	0
23	40529137	.	T	C	2	2	4	0	0	4	0	0
23	40742067	.	G	A	0	2	2	0	1	3	0	0
23	40742145	.	A	G	4	0	4	0	3	7	0	0
23	40756296	.	A	C	3	5	8	0	0	8	0	0
23	40761073	.	T	A	2	7	9	0	2	11	0	0
23	41313116	.	G	C	7	3	10	0	0	10	0	0
23	41801492	.	C	T	6	4	10	0	0	10	0	0
23	41801555	.	G	A	6	7	13	0	0	13	0	0
23	41801940	.	G	T	14	5	19	0	0	19	0	0
23	41802130	.	T	G	6	12	18	0	1	19	0	0
23	41802856	.	G	A	1	2	3	0	0	3	0	0
23	41802944	.	G	T	2	6	8	0	0	8	0	0
23	41803017	.	G	A	2	7	9	0	1	10	0	0
23	41803124	.	G	T	4	15	19	0	3	22	0	0
23	41803160	.	C	T	8	11	19	0	0	19	0	0
23	41803217	.	T	C	5	0	5	0	5	10	0	0
23	41803447	.	G	A	8	10	18	0	1	19	0	0
23	41803473	.	A	G	9	8	17	0	0	17	0	0
23	41803672	.	C	T	2	6	8	0	1	9	0	0
23	41803740	.	A	G	2	9	11	0	0	11	0	0
23	41804039	.	A	G	1	3	4	0	0	4	0	0
23	41804202	.	T	A	3	3	6	0	0	6	0	0
23	41804287	.	C	A	2	2	4	0	0	4	0	0
23	41804518	.	A	C	5	4	9	0	0	9	0	0
23	41804600	.	T	A	5	6	11	0	1	12	0	0
23	41804776	.	G	C	1	2	3	0	0	3	0	0
23	41804779	.	A	T	0	2	2	0	0	2	0	0
23	41805158	.	C	T	3	5	8	0	2	10	0	0
23	41805348	.	G	A	3	7	10	0	0	10	0	0
23	41831305	.	T	A	3	4	7	0	0	7	0	0
23	41831306	.	C	T	3	4	7	0	0	7	0	0
23	41839373	.	G	A	0	4	4	0	4	8	0	0
23	41853782	.	T	C	4	9	13	0	0	13	0	0
23	41853876	.	T	C	2	3	5	0	0	5	0	0
23	41853892	.	A	T	3	4	7	0	0	7	0	0
23	41949748	.	T	G	1	3	4	0	0	4	0	0
23	41949751	.	A	G	1	3	4	0	0	4	0	0
23	42283476	.	A	G	4	9	13	0	0	13	0	0
23	42289260	.	C	A	3	2	5	0	0	5	0	0
23	42640417	.	C	T	3	2	5	0	0	5	0	0
23	42641651	.	A	G	1	2	3	0	0	3	0	0
23	42641652	.	A	G	1	2	3	0	0	3	0	0
23	42641879	.	T	C	4	2	6	0	0	6	0	0
23	42641950	.	T	A	5	2	7	0	1	8	0	0
23	42641952	.	T	C	6	2	8	0	0	8	0	0
23	42642044	.	G	A	5	5	10	0	1	11	0	0
23	42642211	.	A	C	3	3	6	0	6	12	0	0
23	42642672	.	T	C	6	6	12	0	0	12	0	0
23	42642673	.	G	A	6	6	12	0	0	12	0	0
23	42642780	.	G	T	12	3	15	0	1	16	0	0
23	42766378	.	A	G	1	2	3	0	0	3	0	0
23	42766607	.	G	A	1	2	3	0	0	3	0	0
23	42766609	.	A	T	1	1	2	0	1	3	0	0
23	43517448	.	G	A	4	2	6	0	0	6	0	0
23	43517458	.	A	G	4	2	6	0	0	6	0	0
23	43519354	.	C	G	1	1	2	0	1	3	0	0
23	43642345	.	A	G	1	0	1	0	2	3	0	0
23	43650505	.	T	A	1	2	3	0	1	4	0	0
23	43652261	.	A	G	4	2	6	0	0	6	0	0
23	43652819	.	T	C	9	3	12	0	0	12	0	0
23	43689026	.	A	T	0	3	3	0	1	4	0	0
23	43689034	.	C	G	0	3	3	0	0	3	0	0
23	43690913	.	T	G	3	2	5	0	0	5	0	0
23	43691045	.	T	C	2	4	6	0	0	6	0	0
23	43691528	.	C	T	4	6	10	0	0	10	0	0
23	43691595	.	A	G	2	3	5	0	0	5	0	0
23	43691810	.	A	T	5	3	8	0	0	8	0	0
23	43691915	.	A	G	1	0	1	0	4	5	0	0
23	43691992	.	T	C	3	3	6	0	0	6	0	0
23	43695927	.	C	A	0	8	8	0	14	22	0	0
23	43696095	.	G	A	28	16	44	0	3	47	0	0
23	43696211	.	G	T	19	16	35	1	2	38	0	0
23	43696355	.	G	A	26	20	46	0	0	46	0	0
23	43699846	.	A	G	12	18	30	0	3	33	0	0
23	43700064	.	T	C	9	0	9	0	16	25	0	0
23	43700114	.	G	A	6	10	16	0	4	20	0	0
23	43700121	.	G	A	5	14	19	0	0	19	0	0
23	43705961	.	G	T	11	15	26	0	1	27	0	0
23	43706003	.	A	G	12	19	31	0	1	32	0	0
23	43706102	.	T	G	8	18	26	0	0	26	0	0
23	43713692	.	T	A	1	2	3	0	0	3	0	0
23	43718169	.	T	A	5	4	9	0	0	9	0	0
23	43718185	.	T	A	5	4	9	0	0	9	0	0
23	43723615	.	G	A	7	11	18	0	0	18	0	0
23	43723633	.	C	T	9	7	16	0	1	17	0	0
23	43723765	.	C	T	7	6	13	0	1	14	0	0
23	43770240	.	A	C	4	2	6	0	0	6	0	0
23	43770414	.	T	C	1	3	4	0	0	4	0	0
23	43770433	.	T	C	1	3	4	0	0	4	0	0
23	43770583	.	C	A	5	3	8	0	0	8	0	0
23	43778396	.	T	G	5	5	10	0	1	11	0	0
23	43780214	.	C	T	2	6	8	0	0	8	0	0
23	43781781	.	C	T	2	4	6	0	1	7	0	0
23	43784985	.	C	T	7	10	17	0	1	18	0	0
23	43799835	.	A	G	1	0	1	0	3	4	0	0
23	43800621	.	G	C	1	4	5	0	0	5	0	0
23	43800684	.	G	A	0	2	2	0	3	5	0	0
23	43800701	.	T	C	2	3	5	0	1	6	0	0
23	43800723	.	G	A	0	6	6	0	3	9	0	0
23	43800747	.	A	C	3	6	9	0	1	10	0	0
23	43800912	.	C	T	1	3	4	0	0	4	0	0
23	43800968	.	T	G	3	2	5	0	0	5	0	0
23	43800983	.	G	A	3	3	6	0	0	6	0	0
23	43801090	.	A	C	2	4	6	0	0	6	0	0
23	43801284	.	C	G	3	5	8	0	4	12	0	0
23	43801408	.	A	T	1	0	1	0	0	3	2	0
23	43801536	.	A	G	2	0	2	0	2	4	0	0
23	43801687	.	C	T	3	4	7	1	0	8	0	0
23	43802049	.	C	T	1	3	4	0	0	4	0	0
23	43802158	.	A	T	3	5	8	0	0	8	0	0
23	43830137	.	T	A	3	3	6	0	0	6	0	0
23	43830185	.	T	C	6	3	9	0	0	9	0	0
23	43830408	.	C	T	2	2	4	0	1	5	0	0
23	43830412	.	T	C	2	2	4	0	0	4	0	0
23	44521330	.	A	G	6	8	14	0	1	15	0	0
23	45423068	.	C	T	2	7	9	0	4	13	0	0
23	45423138	.	A	C	5	5	10	0	1	11	0	0
23	45423167	.	T	C	6	2	8	0	1	9	0	0
23	45423324	.	G	T	8	4	12	1	1	14	0	0
23	45424249	.	A	C	2	2	4	0	0	4	0	0
23	45515570	.	C	G	1	2	3	0	5	8	0	0
23	45516336	.	C	T	6	3	9	0	0	9	0	0
23	45516804	.	T	A	2	4	6	0	0	6	0	0
23	45516867	.	C	G	3	4	7	0	0	7	0	0
23	45521246	.	G	C	5	3	8	0	0	8	0	0
23	45521285	.	G	C	6	2	8	0	1	9	0	0
23	45521385	.	T	G	3	2	5	0	0	5	0	0
23	45521492	.	G	A	7	4	11	0	3	14	0	0
23	45521557	.	A	G	3	5	8	0	0	8	0	0
23	45521622	.	C	T	7	4	11	0	1	12	0	0
23	45521775	.	C	T	1	2	3	0	1	4	0	0
23	45521811	.	A	G	5	7	12	0	0	12	0	0
23	45521816	.	T	A	6	6	12	0	1	13	0	0
23	45521853	.	G	A	6	8	14	0	0	14	0	0
23	45521857	.	G	A	7	7	14	0	0	14	0	0
23	45521942	.	A	G	12	9	21	0	0	21	0	0
23	45522046	.	G	A	8	3	11	0	1	12	0	0
23	45522166	.	T	G	6	14	20	0	1	21	0	0
23	45522170	.	T	G	8	12	20	0	2	22	0	0
23	45522238	.	A	G	6	13	19	0	2	21	0	0
23	45522434	.	G	A	9	5	14	0	1	15	0	0
23	45523409	.	T	C	16	16	32	0	0	32	0	0
23	45523562	.	A	G	10	0	10	0	7	17	0	0
23	45523619	.	C	T	13	7	20	0	0	20	0	0
23	45523669	.	A	T	13	14	27	0	0	27	0	0
23	45547600	.	A	C	6	3	9	0	0	9	0	0
23	45547807	.	A	G	1	0	1	0	4	5	0	0
23	45547902	.	C	T	2	3	5	0	0	5	0	0
23	45548034	.	G	C	3	3	6	0	0	6	0	0
23	45548140	.	G	A	4	2	6	0	1	7	0	0
23	45548355	.	A	G	3	3	6	0	0	6	0	0
23	45579547	.	A	G	11	14	25	0	2	27	0	0
23	45579629	.	A	C	12	21	33	0	2	35	0	0
23	45580052	.	C	T	13	12	25	0	0	25	0	0
23	45580442	.	C	T	20	19	39	0	0	39	0	0
23	45580508	.	C	T	21	24	45	0	5	50	0	0
23	45580562	.	C	T	34	18	52	0	3	55	0	0
23	45581181	.	C	T	31	18	49	0	2	51	0	0
23	45588412	.	G	A	0	3	3	0	2	5	0	0
23	45591606	.	A	G	2	0	2	0	3	5	0	0
23	45591639	.	A	G	3	4	7	0	2	9	0	0
23	45595178	.	C	T	3	3	6	0	0	6	0	0
24	788327	.	A	G	1	3	4	0	0	4	0	0
24	788335	.	A	G	4	2	6	0	1	7	0	0
24	788384	.	A	G	4	11	15	0	0	15	0	0
24	788409	.	A	G	7	0	7	0	8	15	0	0
24	945903	.	T	C	12	5	17	0	3	20	0	0
24	945915	.	T	C	13	4	17	0	2	19	0	0
24	985258	.	T	G	18	10	28	0	0	28	0	0
24	985438	.	A	C	6	21	27	0	0	27	0	0
24	1111055	.	C	A	1	4	5	0	0	5	0	0
24	3470093	.	T	C	5	4	9	0	0	9	0	0
24	3470115	.	T	C	8	3	11	0	0	11	0	0
24	3470188	.	T	C	8	5	13	0	1	14	0	0
24	3470405	.	T	C	6	4	10	0	0	10	0	0
24	3470408	.	T	C	4	6	10	0	0	10	0	0
24	3470608	.	T	C	4	4	8	0	2	10	0	0
24	8861555	.	T	C	4	3	7	0	0	7	0	0
24	8979615	.	C	G	4	8	12	0	0	12	0	0
24	8979618	.	G	A	5	8	13	0	0	13	0	0
24	8979708	.	C	T	1	17	18	0	13	31	0	0
24	8979917	.	G	A	8	4	12	0	1	13	0	0
24	8979937	.	G	A	4	2	6	0	2	8	0	0
24	8980122	.	G	A	3	2	5	0	0	5	0	0
24	8988945	.	G	C	2	1	3	0	3	6	0	0
24	9288889	.	G	T	4	12	16	0	2	18	0	0
24	9293831	.	A	G	2	2	4	0	0	4	0	0
24	9298312	.	G	A	1	2	3	0	0	3	0	0
24	9298678	.	T	A	1	2	3	0	0	3	0	0
24	9594999	.	T	C	3	3	6	0	1	7	0	0
24	9595831	.	A	T	1	2	3	0	0	3	0	0
24	9596093	.	A	C	1	3	4	0	0	4	0	0
24	9596350	.	G	A	4	2	6	0	0	6	0	0
24	9596366	.	T	A	3	4	7	0	0	7	0	0
24	9596423	.	T	C	4	4	8	0	1	9	0	0
24	9676147	.	T	A	14	10	24	0	0	24	0	0
24	9676204	.	C	A	18	11	29	0	1	30	0	0
24	9678514	.	A	T	15	10	25	0	1	26	0	0
24	9683072	.	G	A	8	8	16	0	0	16	0	0
24	9689613	.	G	T	1	2	3	0	0	3	0	0
24	9714423	.	T	C	2	2	4	0	0	4	0	0
24	9723632	.	A	G	2	0	2	0	2	4	0	0
24	9724925	.	A	G	3	6	9	0	0	9	0	0
24	9725084	.	C	G	9	3	12	0	0	12	0	0
24	9726828	.	C	G	1	3	4	0	0	4	0	0
24	9729966	.	A	T	6	8	14	0	0	14	0	0
24	9730134	.	G	A	6	5	11	0	0	11	0	0
24	9734938	.	G	A	1	2	3	0	1	4	0	0
24	9866192	.	A	T	2	3	5	0	0	5	0	0
24	9866270	.	G	A	2	1	3	0	1	4	0	0
24	9866562	.	A	T	8	4	12	0	0	12	0	0
24	9866721	.	C	T	5	4	9	0	0	9	0	0
24	9867105	.	T	A	6	5	11	0	2	13	0	0
24	10309119	.	G	C	0	3	3	0	3	6	0	0
24	10309244	.	G	A	5	5	10	0	0	10	0	0
24	10309382	.	T	C	6	2	8	0	0	8	0	0
24	10309454	.	C	T	6	3	9	0	0	9	0	0
24	10349671	.	C	T	1	5	6	0	0	6	0	0
24	10349783	.	G	T	2	3	5	0	1	6	0	0
24	10349818	.	G	A	2	3	5	0	0	5	0	0
24	10349865	.	T	G	1	5	6	0	0	6	0	0
24	10349898	.	T	C	1	4	5	0	0	5	0	0
24	10350135	.	A	T	1	3	4	0	0	4	0	0
24	10356563	.	G	A	1	2	3	0	0	3	0	0
24	10413706	.	T	C	1	3	4	0	0	4	0	0
24	10415193	.	A	G	5	7	12	0	1	13	0	0
24	10415424	.	A	C	11	6	17	1	0	18	0	0
24	10415487	.	G	A	0	9	9	0	11	20	0	0
24	10828512	.	A	G	4	5	9	0	0	9	0	0
24	10897254	.	G	A	4	3	7	0	0	7	0	0
24	10901467	.	A	C	6	7	13	0	1	14	0	0
24	10901696	.	C	G	23	32	55	1	3	59	0	0
24	10901759	.	G	T	16	28	44	0	5	49	0	0
24	10901946	.	C	T	12	13	25	0	3	28	0	0
24	10902065	.	T	G	12	13	25	0	2	27	0	0
24	10902192	.	T	A	12	4	16	0	2	18	0	0
24	10902268	.	G	A	7	9	16	0	0	16	0	0
24	10902688	.	G	A	17	18	35	0	0	35	0	0
24	10907000	.	T	C	17	13	30	0	1	31	0	0
24	10907473	.	C	T	12	11	23	0	3	26	0	0
24	10907587	.	G	T	5	8	13	0	1	14	0	0
24	10915813	.	A	G	5	7	12	0	0	12	0	0
24	10917040	.	C	T	5	8	13	0	1	14	0	0
24	10917046	.	C	T	0	6	6	0	6	12	0	0
24	10917238	.	C	T	9	4	13	0	1	14	0	0
24	10919519	.	A	G	1	4	5	0	0	5	0	0
24	10919563	.	G	T	2	3	5	0	0	5	0	0
24	10924880	.	C	T	3	6	9	0	1	10	0	0
24	11083860	.	C	T	5	3	8	0	0	8	0	0
24	11084035	.	G	A	4	5	9	0	0	9	0	0
24	11086752	.	A	G	7	11	18	0	1	19	0	0
24	11087015	.	G	A	6	4	10	0	0	10	0	0
24	11113156	.	T	C	5	13	18	1	1	20	0	0
24	11113493	.	T	C	4	0	4	0	3	7	0	0
24	11114040	.	A	C	3	2	5	0	0	5	0	0
24	11114048	.	C	A	3	2	5	0	0	5	0	0
24	11114236	.	A	T	2	4	6	0	1	7	0	0
24	11114288	.	T	C	5	4	9	0	0	9	0	0
24	11114290	.	A	G	5	4	9	0	0	9	0	0
24	11114356	.	C	T	2	2	4	0	0	4	0	0
24	11114408	.	T	C	2	2	4	0	0	4	0	0
24	11114560	.	T	C	11	0	11	0	9	20	0	0
24	11114583	.	A	T	12	8	20	0	2	22	0	0
24	11114670	.	C	T	0	5	5	0	7	12	0	0
24	11114688	.	T	G	6	4	10	0	0	10	0	0
24	11114709	.	T	A	7	6	13	0	0	13	0	0
24	11115048	.	T	A	1	2	3	0	0	3	0	0
24	11115269	.	C	A	5	3	8	0	1	9	0	0
24	11115280	.	C	G	4	5	9	0	0	9	0	0
24	11115513	.	G	A	1	3	4	0	0	4	0	0
24	11115719	.	T	A	2	3	5	0	0	5	0	0
24	11115720	.	A	G	1	3	4	0	1	5	0	0
24	11116025	.	G	C	2	0	2	0	3	5	0	0
24	11116032	.	C	T	2	3	5	0	0	5	0	0
24	11124199	.	C	T	1	5	6	0	0	6	0	0
24	11141150	.	G	T	2	2	4	0	1	5	0	0
24	11141253	.	A	C	1	2	3	0	1	4	0	0
24	11141849	.	G	A	3	2	5	0	0	5	0	0
24	11350825	.	A	G	1	3	4	0	0	4	0	0
24	11389716	.	C	T	1	3	4	0	0	4	0	0
24	11390461	.	G	A	3	3	6	0	0	6	0	0
24	11390514	.	G	A	3	4	7	0	0	7	0	0
24	11473351	.	G	T	1	2	3	0	1	4	0	0
24	11473788	.	T	A	3	3	6	0	0	6	0	0
24	11473857	.	C	A	6	2	8	0	1	9	0	0
24	11473891	.	G	A	8	4	12	0	0	12	0	0
24	11474103	.	C	G	8	11	19	0	1	20	0	0
24	11474110	.	G	A	6	11	17	0	0	17	0	0
24	11474167	.	T	C	9	10	19	0	0	19	0	0
24	11474730	.	A	G	5	7	12	0	0	12	0	0
24	11487067	.	G	C	4	3	7	0	1	8	0	0
24	11496640	.	T	A	2	2	4	0	1	5	0	0
24	11530529	.	G	A	3	3	6	0	0	6	0	0
24	11888694	.	G	A	7	10	17	0	1	18	0	0
24	11888788	.	G	A	15	12	27	0	1	28	0	0
24	11888799	.	T	C	10	12	22	0	4	26	0	0
24	11888854	.	T	C	14	8	22	0	0	22	0	0
24	11889038	.	C	G	4	6	10	0	0	10	0	0
24	11889107	.	T	C	7	3	10	0	1	11	0	0
24	11889155	.	T	C	1	0	1	0	3	4	0	0
24	11889157	.	T	C	1	3	4	0	0	4	0	0
24	11889353	.	C	T	4	4	8	0	0	8	0	0
24	11909441	.	T	G	1	1	2	0	1	3	0	0
24	11909452	.	A	G	1	1	2	0	1	3	0	0
24	11918846	.	G	A	10	7	17	0	1	18	0	0
24	11919170	.	A	G	6	2	8	0	0	8	0	0
24	12133963	.	C	A	5	2	7	0	1	8	0	0
24	12252675	.	G	T	8	13	21	0	1	22	0	0
24	12253067	.	G	A	6	9	15	0	1	16	0	0
24	12253154	.	T	G	3	12	15	0	0	15	0	0
24	12630352	.	A	G	21	8	29	1	0	30	0	0
24	12634439	.	C	T	4	8	12	0	0	12	0	0
24	12638007	.	C	T	1	5	6	0	8	14	0	0
24	12686316	.	A	T	6	7	13	1	2	16	0	0
24	12748468	.	A	G	6	7	13	0	0	13	0	0
24	12749046	.	G	A	5	7	12	0	0	12	0	0
24	12963161	.	T	A	15	5	20	0	2	22	0	0
24	12966730	.	C	T	18	16	34	0	0	34	0	0
24	12966981	.	G	A	4	8	12	0	0	12	0	0
24	12967041	.	C	T	8	5	13	0	1	14	0	0
24	12967214	.	T	C	5	0	5	0	9	14	0	0
24	12970814	.	A	T	6	8	14	0	0	14	0	0
24	12975210	.	A	G	4	8	12	0	0	12	0	0
24	12983478	.	A	T	4	4	8	0	0	8	0	0
24	13009351	.	T	A	1	2	3	0	0	3	0	0
24	13013596	.	T	C	1	3	4	0	1	5	0	0
24	13015293	.	A	T	1	2	3	0	0	3	0	0
24	13015843	.	C	G	1	2	3	0	0	3	0	0
24	13023054	.	C	T	35	10	45	0	1	46	0	0
24	13026060	.	G	A	16	9	25	0	4	29	0	0
24	13026449	.	T	C	19	19	38	0	2	40	0	0
24	13101128	.	A	G	31	13	44	0	2	46	0	0
24	13101143	.	C	A	29	17	46	0	3	49	0	0
24	13101185	.	A	G	28	0	28	0	28	56	0	0
24	13138165	.	T	C	37	16	53	1	2	56	0	0
24	13239045	.	A	T	12	12	24	0	3	27	0	0
24	13239124	.	T	A	22	15	37	2	4	43	0	0
24	13239248	.	A	G	20	10	30	1	16	47	0	0
24	13239985	.	G	C	26	16	42	0	4	46	0	0
24	13251801	.	A	C	9	8	17	0	1	18	0	0
24	13252065	.	G	A	5	6	11	0	2	13	0	0
24	13252122	.	A	C	5	0	5	0	4	9	0	0
24	13252448	.	A	G	3	4	7	0	0	7	0	0
24	13255400	.	C	T	1	3	4	0	1	5	0	0
24	14014748	.	C	T	1	2	3	0	0	3	0	0
24	14233716	.	C	A	2	2	4	1	0	5	0	0
24	14233798	.	G	C	4	4	8	0	0	8	0	0
24	14233840	.	T	G	5	3	8	0	0	8	0	0
24	14233841	.	G	A	5	3	8	0	0	8	0	0
24	14234355	.	A	G	3	3	6	0	0	6	0	0
24	14234412	.	T	G	3	5	8	0	0	8	0	0
24	14415965	.	G	A	1	2	3	0	0	3	0	0
24	14416018	.	G	C	0	5	5	0	1	6	0	0
24	14442861	.	G	A	2	6	8	0	1	9	0	0
24	14443212	.	G	T	4	2	6	0	1	7	0	0
24	14443578	.	A	G	5	8	13	0	0	13	0	0
24	14542501	.	A	G	2	2	4	0	0	4	0	0
24	14549344	.	T	A	6	4	10	0	3	13	0	0
24	14550545	.	C	T	8	13	21	0	0	21	0	0
24	14550554	.	G	A	8	9	17	0	1	18	0	0
24	14550596	.	T	C	8	9	17	0	1	18	0	0
24	14559391	.	A	G	18	11	29	0	3	32	0	0
24	14559778	.	A	T	44	28	72	0	7	79	0	0
24	14559828	.	T	A	44	21	65	0	4	69	0	0
24	14568300	.	G	T	35	28	63	0	1	65	1	0
24	14575607	.	G	A	25	30	55	0	5	60	0	0
24	14576693	.	A	G	15	13	28	0	3	31	0	0
24	14576782	.	A	G	5	7	12	0	1	13	0	0
24	14713927	.	T	C	11	10	21	0	1	22	0	0
24	14718163	.	T	C	23	15	38	0	0	38	0	0
24	14725164	.	A	G	26	15	41	0	1	42	0	0
24	14725417	.	G	A	8	32	40	0	1	41	0	0
24	14725551	.	G	A	8	13	21	0	2	23	0	0
24	15061866	.	G	A	2	2	4	0	0	4	0	0
24	15124785	.	A	T	1	5	6	0	1	7	0	0
24	15124880	.	T	C	6	0	6	0	5	11	0	0
24	15124890	.	A	G	8	4	12	0	0	12	0	0
24	15127487	.	A	T	4	3	7	0	0	7	0	0
24	15127639	.	T	C	1	4	5	0	0	5	0	0
24	15645617	.	G	T	9	12	21	1	16	38	0	0
24	15645669	.	G	T	15	12	27	2	1	30	0	0
24	15648158	.	A	G	7	10	17	0	1	18	0	0
24	15648504	.	T	C	3	2	5	0	0	5	0	0
24	16111914	.	T	C	3	2	5	0	0	5	0	0
24	16121362	.	G	A	0	8	8	0	7	15	0	0
24	16121462	.	G	A	4	3	7	0	1	8	0	0
24	16572266	.	G	A	1	2	3	0	0	3	0	0
24	16693526	.	T	C	1	8	9	0	0	9	0	0
24	16696713	.	G	C	13	13	26	0	0	26	0	0
24	16702886	.	G	T	1	9	10	0	10	20	0	0
24	16705878	.	C	T	15	12	27	0	1	28	0	0
24	16705948	.	C	T	14	15	29	0	3	32	0	0
24	16705949	.	A	G	16	13	29	0	3	32	0	0
24	16706108	.	A	G	14	17	31	0	1	32	0	0
24	16706709	.	A	C	2	3	5	0	0	5	0	0
24	16706834	.	A	G	4	6	10	0	0	10	0	0
24	16908827	.	G	A	10	9	19	0	1	20	0	0
24	16908908	.	C	T	6	10	16	0	1	17	0	0
24	16909052	.	T	C	12	13	25	0	0	25	0	0
24	16911600	.	A	C	17	23	40	0	6	46	0	0
24	16911898	.	C	T	20	17	37	0	1	38	0	0
24	16912191	.	G	A	26	22	48	0	1	49	0	0
24	16914700	.	C	T	0	3	3	0	1	4	0	0
24	16964353	.	C	A	4	5	9	0	1	10	0	0
24	16964452	.	G	A	6	7	13	0	0	13	0	0
24	16964500	.	C	T	9	9	18	0	1	19	0	0
24	16964787	.	T	A	2	3	5	0	0	5	0	0
24	16964819	.	T	C	2	2	4	0	0	5	1	0
24	16964839	.	A	C	2	3	5	0	0	5	0	0
24	16964854	.	T	C	2	3	5	0	0	5	0	0
24	16964881	.	G	C	2	4	6	0	0	6	0	0
24	16964889	.	A	G	2	4	6	0	0	6	0	0
24	16964943	.	A	T	5	4	9	0	1	10	0	0
24	16965020	.	C	T	8	7	15	0	1	16	0	0
24	16965032	.	G	A	8	5	13	0	2	15	0	0
24	16965545	.	C	A	5	2	7	0	0	7	0	0
24	16965648	.	C	G	4	3	7	0	0	7	0	0
24	16965729	.	A	C	4	6	10	0	0	10	0	0
24	16965765	.	T	C	3	5	8	0	0	8	0	0
24	16965770	.	T	C	3	6	9	0	1	10	0	0
24	16965900	.	A	C	6	0	6	0	5	11	0	0
24	16966176	.	G	A	3	6	9	0	0	9	0	0
24	16966185	.	T	C	5	0	5	0	5	10	0	0
24	16966389	.	A	G	5	4	9	0	1	10	0	0
24	16985547	.	C	T	10	9	19	0	1	20	0	0
24	16992605	.	G	A	1	11	12	0	17	29	0	0
24	16992915	.	C	T	30	12	42	0	1	43	0	0
24	16998976	.	A	T	35	23	58	0	5	63	0	0
24	17002611	.	C	T	30	24	54	0	3	57	0	0
24	17002666	.	A	T	27	30	57	2	1	60	0	0
24	17007501	.	C	G	1	2	3	0	0	3	0	0
24	17010932	.	G	T	1	3	4	0	0	4	0	0
24	17016658	.	T	C	2	3	5	0	0	5	0	0
24	17017060	.	T	C	2	3	5	0	0	5	0	0
24	17019252	.	A	G	4	0	4	0	4	8	0	0
24	17019843	.	A	G	6	0	6	0	4	10	0	0
24	17020128	.	C	T	3	6	9	0	1	10	0	0
24	17020761	.	T	A	5	2	7	0	0	7	0	0
24	17020764	.	A	T	5	2	7	0	0	7	0	0
24	17020874	.	T	C	6	2	8	0	0	8	0	0
24	17021848	.	G	A	28	19	47	0	2	49	0	0
24	17021894	.	T	C	35	1	36	0	15	51	0	0
24	17022028	.	A	G	24	11	35	2	2	39	0	0
24	17022029	.	T	A	22	12	34	2	3	39	0	0
24	17022265	.	A	G	1	2	3	0	0	3	0	0
24	17023063	.	G	A	13	13	26	0	1	27	0	0
24	17028690	.	T	A	12	11	23	0	1	24	0	0
24	17040627	.	C	T	5	4	9	0	0	9	0	0
24	17041159	.	G	C	4	2	6	0	0	6	0	0
24	17041208	.	T	G	5	3	8	0	0	8	0	0
24	17041267	.	T	A	5	4	9	0	1	10	0	0
24	17041968	.	A	G	1	2	3	0	0	3	0	0
24	17041978	.	T	G	1	2	3	0	0	3	0	0
24	17042420	.	G	A	2	2	4	0	0	4	0	0
24	17042763	.	C	T	6	5	11	0	0	11	0	0
24	17124124	.	C	T	2	3	5	0	0	5	0	0
24	17124476	.	G	A	2	8	10	0	6	16	0	0
24	17124567	.	T	C	6	11	17	0	2	19	0	0
24	17124591	.	T	A	7	14	21	0	1	22	0	0
24	17126069	.	G	A	13	16	29	0	5	34	0	0
24	17126341	.	C	T	21	20	41	0	2	43	0	0
24	17189815	.	T	A	2	2	4	1	1	6	0	0
24	17211821	.	C	A	7	7	14	0	1	15	0	0
24	17214493	.	A	T	12	9	21	0	2	23	0	0
24	17214756	.	C	T	4	5	9	1	0	10	0	0
24	17215186	.	T	C	9	12	21	0	0	21	0	0
24	17215855	.	C	T	2	3	5	0	4	9	0	0
24	17215894	.	A	G	3	5	8	0	1	9	0	0
24	17257693	.	C	A	9	11	20	0	2	22	0	0
24	17257866	.	T	C	3	10	13	0	2	15	0	0
24	17258426	.	G	A	10	12	22	0	2	24	0	0
24	17258451	.	G	T	10	17	27	0	1	28	0	0
24	17259535	.	G	T	3	3	6	1	0	7	0	0
24	17266382	.	G	A	6	8	14	0	0	14	0	0
24	17266564	.	G	T	4	5	9	0	0	9	0	0
24	17266886	.	T	A	12	12	24	0	1	25	0	0
24	17266909	.	T	A	10	11	21	0	1	22	0	0
24	17276447	.	T	C	4	3	7	0	1	8	0	0
24	17363740	.	A	G	4	3	7	0	0	7	0	0
24	17363745	.	T	G	3	3	6	0	0	6	0	0
24	17363811	.	T	C	5	4	9	0	4	13	0	0
24	17364010	.	G	A	2	6	8	0	5	13	0	0
24	17364076	.	A	T	4	8	12	0	0	12	0	0
24	17364287	.	T	C	2	4	6	0	1	7	0	0
24	17364411	.	A	G	3	3	6	0	0	6	0	0
24	17364985	.	G	A	19	11	30	0	1	31	0	0
24	17365081	.	A	G	17	8	25	0	4	29	0	0
24	17366374	.	G	A	17	12	29	0	1	30	0	0
24	17367882	.	G	A	8	10	18	0	3	21	0	0
24	17368343	.	T	A	3	6	9	0	1	10	0	0
24	17368816	.	G	A	8	4	12	0	0	12	0	0
24	17372074	.	G	A	4	7	11	0	0	11	0	0
24	17374611	.	T	C	1	1	2	0	1	3	0	0
24	17377871	.	G	A	3	8	11	0	1	12	0	0
24	17377874	.	G	A	3	9	12	0	0	12	0	0
24	17378123	.	T	C	5	1	6	0	10	16	0	0
24	17404219	.	G	A	5	3	8	0	0	8	0	0
24	17410039	.	G	C	3	3	6	0	0	6	0	0
24	17417535	.	T	G	20	18	38	0	2	40	0	0
24	17417855	.	G	C	10	12	22	0	1	23	0	0
24	17417899	.	G	C	5	8	13	0	1	14	0	0
24	17417947	.	A	G	3	6	9	0	0	9	0	0
24	17418024	.	C	A	13	8	21	0	1	22	0	0
24	17418180	.	G	T	13	4	17	0	0	17	0	0
24	17419604	.	C	A	4	4	8	0	1	9	0	0
24	17419607	.	A	T	4	4	8	0	0	8	0	0
24	17420516	.	G	A	6	5	11	0	0	11	0	0
24	17420519	.	T	C	6	0	6	0	5	11	0	0
24	17420595	.	T	A	3	5	8	0	0	8	0	0
24	17420761	.	G	T	3	6	9	0	0	9	0	0
24	17421216	.	G	T	9	10	19	0	0	19	0	0
24	17421270	.	C	T	0	12	12	0	11	23	0	0
24	17421311	.	G	C	19	9	28	0	2	30	0	0
24	17421338	.	A	T	23	9	32	0	0	32	0	0
24	17421396	.	C	A	11	16	27	0	2	29	0	0
24	17421655	.	G	A	10	8	18	0	1	19	0	0
24	17465715	.	C	T	1	3	4	0	1	5	0	0
24	17465722	.	A	T	1	2	3	0	2	5	0	0
24	18444097	.	A	T	5	6	11	0	1	12	0	0
24	18444153	.	G	C	3	7	10	0	0	10	0	0
24	18444267	.	T	C	18	4	22	0	21	43	0	0
24	18444334	.	G	T	37	31	68	0	4	72	0	0
24	18444373	.	C	T	1	4	5	0	1	6	0	0
24	18445784	.	A	G	20	34	54	0	3	57	0	0
24	18446545	.	G	A	27	8	35	0	0	35	0	0
24	18461007	.	C	T	0	2	2	0	1	3	0	0
24	18521384	.	T	A	3	3	6	0	0	6	0	0
24	18521467	.	C	A	6	4	10	0	3	13	0	0
24	18549400	.	G	A	8	8	16	0	0	16	0	0
24	18553898	.	C	T	3	5	8	0	0	8	0	0
24	18563695	.	G	A	1	4	5	0	0	5	0	0
24	18563714	.	A	G	2	2	4	0	0	4	0	0
24	18565564	.	A	G	2	2	4	0	0	4	0	0
24	18731867	.	T	C	3	7	10	0	0	10	0	0
24	18731951	.	T	C	2	4	6	0	0	6	0	0
24	18732188	.	T	C	2	2	4	0	0	4	0	0
24	18732216	.	A	T	3	2	5	0	0	5	0	0
24	18737472	.	G	T	10	9	19	0	0	19	0	0
24	18737876	.	C	T	7	6	13	0	0	13	0	0
24	18738073	.	C	T	0	2	2	1	3	6	0	0
24	18746161	.	C	T	8	8	16	0	0	16	0	0
24	18749985	.	A	G	13	10	23	0	0	23	0	0
24	18750012	.	G	C	9	15	24	0	0	24	0	0
24	18751734	.	T	A	7	6	13	0	0	13	0	0
24	18751740	.	C	T	1	6	7	0	8	15	0	0
24	18751833	.	A	G	4	4	8	0	4	12	0	0
24	18769652	.	A	G	3	3	6	0	1	7	0	0
24	19260876	.	G	A	0	2	2	0	3	5	0	0
24	19373816	.	A	T	1	2	3	0	1	4	0	0
24	19402505	.	G	T	8	2	10	0	0	10	0	0
24	19696060	.	T	C	1	3	4	0	0	4	0	0
24	19696090	.	C	T	1	4	5	0	0	5	0	0
24	19696728	.	G	A	1	2	3	0	1	4	0	0
24	19708085	.	A	G	10	5	15	0	0	15	0	0
24	19708448	.	G	T	5	5	10	0	3	13	0	0
24	19711576	.	G	T	4	2	6	0	0	6	0	0
24	20064128	.	C	T	4	7	11	0	0	11	0	0
24	20064130	.	G	T	4	7	11	0	0	11	0	0
24	20064232	.	G	A	8	5	13	0	1	14	0	0
24	20064341	.	C	T	4	2	6	0	0	6	0	0
24	20064368	.	T	C	2	0	2	0	2	4	0	0
24	20064924	.	A	G	1	3	4	0	0	4	0	0
24	20064988	.	A	C	1	4	5	0	0	5	0	0
24	20065733	.	T	C	2	2	4	0	0	4	0	0
24	20192418	.	A	G	1	2	3	0	0	3	0	0
24	20194475	.	A	G	5	3	8	0	0	8	0	0
24	20196172	.	A	G	5	5	10	0	0	10	0	0
24	20197755	.	C	A	2	4	6	0	0	6	0	0
24	20328349	.	A	G	3	2	5	0	0	5	0	0
24	20328370	.	G	T	0	2	2	0	4	6	0	0
24	20328609	.	G	A	1	7	8	0	1	9	0	0
24	20328821	.	C	A	6	6	12	0	0	12	0	0
24	20328999	.	T	A	2	4	6	0	0	6	0	0
24	20329493	.	G	A	9	10	19	0	0	19	0	0
24	20329589	.	G	C	4	9	13	0	2	15	0	0
24	20332145	.	A	G	2	5	7	0	0	7	0	0
24	20332187	.	A	T	1	2	3	0	0	3	0	0
24	20336686	.	T	C	2	2	4	0	0	4	0	0
24	20336694	.	A	G	2	1	3	0	1	4	0	0
24	20450191	.	A	G	16	10	26	0	0	26	0	0
24	20450424	.	A	T	5	10	15	0	2	17	0	0
24	20450475	.	G	A	6	10	16	0	0	16	0	0
24	20450536	.	C	T	10	6	16	0	2	18	0	0
24	20450672	.	C	G	8	13	21	0	2	23	0	0
24	20450766	.	G	A	14	20	34	0	1	35	0	0
24	20470788	.	A	G	5	5	10	0	0	10	0	0
24	20501116	.	A	G	4	5	9	0	0	9	0	0
24	20536110	.	G	C	2	3	5	0	0	5	0	0
24	20536235	.	G	A	0	2	2	0	3	5	0	0
24	20539454	.	G	A	2	2	4	0	1	5	0	0
24	20552578	.	A	C	17	16	33	0	0	33	0	0
24	20554732	.	A	G	12	14	26	0	1	27	0	0
24	20554812	.	T	A	14	12	26	0	2	28	0	0
24	20591775	.	G	A	1	2	3	0	1	4	0	0
24	20644548	.	A	G	23	23	46	0	3	49	0	0
24	20645101	.	T	C	17	19	36	0	1	37	0	0
24	20645273	.	T	C	15	20	35	0	0	35	0	0
24	20645858	.	A	T	15	15	30	0	3	33	0	0
24	20646289	.	T	A	11	10	21	0	2	23	0	0
24	20646694	.	G	A	5	11	16	0	1	17	0	0
24	20648945	.	T	C	5	14	19	0	2	21	0	0
24	20649013	.	T	C	8	10	18	0	0	18	0	0
24	20649039	.	T	G	6	9	15	0	0	15	0	0
24	20893161	.	C	T	3	3	6	0	0	6	0	0
24	20893203	.	G	C	3	3	6	0	0	6	0	0
24	20895293	.	T	A	1	4	5	0	1	6	0	0
24	20895308	.	A	G	1	5	6	0	0	6	0	0
24	20897954	.	G	A	5	4	9	0	0	9	0	0
24	20898439	.	G	T	1	2	3	0	0	3	0	0
24	20902081	.	G	A	1	2	3	0	0	3	0	0
24	20913315	.	G	A	1	6	7	1	0	8	0	0
24	20913316	.	G	A	2	5	7	1	1	9	0	0
24	20913403	.	C	T	0	4	4	0	1	5	0	0
24	20913408	.	T	A	1	4	5	0	0	5	0	0
24	20916788	.	A	G	3	3	6	0	0	6	0	0
24	20916841	.	C	A	4	3	7	0	0	7	0	0
24	20917017	.	T	C	4	7	11	2	0	13	0	0
24	20917029	.	T	C	2	9	11	3	0	14	0	0
24	20917075	.	G	C	4	3	7	0	1	8	0	0
24	20920648	.	G	C	2	11	13	0	8	21	0	0
24	20920852	.	T	C	14	23	37	0	2	39	0	0
24	20920864	.	G	C	0	14	14	0	18	32	0	0
24	20920910	.	C	G	16	7	23	7	0	30	0	0
24	20921431	.	C	T	14	5	19	16	0	35	0	0
24	20921530	.	A	G	8	12	20	0	0	20	0	0
24	20921537	.	G	T	7	11	18	0	0	18	0	0
24	20921565	.	C	A	7	9	16	0	1	17	0	0
24	20921594	.	C	T	5	9	14	0	1	15	0	0
24	20921615	.	A	G	3	5	8	0	2	10	0	0
24	20921645	.	A	G	2	5	7	0	0	7	0	0
24	20922708	.	T	G	4	4	8	0	1	9	0	0
24	20922721	.	G	A	2	4	6	0	1	7	0	0
24	20922783	.	G	A	8	6	14	0	0	14	0	0
24	20924996	.	C	T	5	5	10	0	1	11	0	0
24	20931626	.	G	A	11	8	19	0	2	21	0	0
24	20934223	.	C	T	23	19	42	0	3	45	0	0
24	20934528	.	G	A	11	14	25	0	1	26	0	0
24	20941540	.	G	A	8	8	16	0	3	19	0	0
24	20946263	.	G	A	8	6	14	0	1	15	0	0
24	20948122	.	C	T	5	6	11	0	0	11	0	0
24	20949494	.	A	G	1	2	3	0	0	3	0	0
24	20954151	.	C	A	4	3	7	0	0	7	0	0
24	20954154	.	T	C	4	2	6	0	1	7	0	0
24	20987798	.	T	C	5	3	8	0	0	8	0	0
24	20987834	.	G	A	2	3	5	0	0	5	0	0
24	20987865	.	A	G	1	4	5	0	0	5	0	0
24	21005908	.	A	T	16	10	26	0	0	26	0	0
24	21006053	.	A	G	8	12	20	0	1	21	0	0
24	21006082	.	G	A	7	14	21	0	2	23	0	0
24	21006188	.	T	G	13	7	20	0	0	20	0	0
24	21006237	.	G	A	2	2	4	0	2	6	0	0
24	21059947	.	G	A	1	2	3	0	0	3	0	0
24	21060365	.	G	A	1	3	4	0	0	4	0	0
24	21122974	.	C	T	2	1	3	0	1	4	0	0
24	21154165	.	G	A	7	8	15	0	1	16	0	0
24	21154203	.	C	T	14	14	28	0	2	30	0	0
24	21154421	.	A	T	21	6	27	0	2	29	0	0
24	21154496	.	C	A	5	22	27	0	19	46	0	0
24	21154707	.	A	G	20	26	46	0	2	48	0	0
24	21157712	.	G	A	24	14	38	0	1	39	0	0
24	21159814	.	A	G	11	9	20	0	0	20	0	0
24	21161459	.	C	T	0	5	5	0	6	11	0	0
24	21177180	.	T	C	2	4	6	0	1	7	0	0
24	21182444	.	A	G	6	7	13	0	0	13	0	0
24	21182783	.	C	T	8	16	24	0	3	27	0	0
24	21182834	.	G	A	3	18	21	0	12	33	0	0
24	21182911	.	G	A	0	8	8	0	5	13	0	0
24	21183181	.	C	T	14	13	27	0	0	27	0	0
24	21183228	.	C	G	19	17	36	0	0	36	0	0
24	21183467	.	T	C	13	5	18	0	0	18	0	0
24	21202203	.	A	G	3	4	7	0	0	7	0	0
24	21202225	.	C	T	3	3	6	0	0	6	0	0
24	21206347	.	T	A	7	3	10	0	0	10	0	0
24	21206352	.	G	T	8	3	11	0	0	11	0	0
24	21206903	.	T	A	3	5	8	0	1	9	0	0
24	21210704	.	A	G	1	2	3	0	0	3	0	0
24	21210728	.	G	T	1	2	3	0	0	3	0	0
24	21212594	.	A	C	2	0	2	0	2	4	0	0
24	21214898	.	G	A	1	5	6	0	0	6	0	0
24	21371282	.	A	C	4	4	8	0	0	8	0	0
24	21371801	.	T	G	25	24	49	0	2	51	0	0
24	21371919	.	G	A	26	13	39	2	1	42	0	0
24	21372389	.	T	A	23	11	34	0	2	36	0	0
24	21372417	.	A	G	18	11	29	0	2	31	0	0
24	21392168	.	T	C	18	11	29	0	1	30	0	0
24	21392258	.	T	C	12	9	21	0	2	23	0	0
24	21442815	.	A	G	6	4	10	0	0	10	0	0
24	21447610	.	T	G	5	5	10	0	0	10	0	0
24	21502007	.	A	G	3	9	12	0	1	13	0	0
24	21502069	.	G	A	11	9	20	0	2	22	0	0
24	21502133	.	T	C	6	0	6	0	14	20	0	0
24	21502305	.	A	G	14	12	26	0	0	26	0	0
24	21502817	.	C	A	8	3	11	0	1	12	0	0
24	21502999	.	G	A	6	5	11	0	3	14	0	0
24	21504169	.	T	G	1	3	4	0	0	4	0	0
24	21504467	.	A	G	4	5	9	1	0	10	0	0
24	21504725	.	C	T	1	4	5	0	5	10	0	0
24	21504785	.	A	G	2	3	5	0	1	6	0	0
24	21504860	.	G	T	2	2	4	0	0	4	0	0
24	21505255	.	T	G	3	2	5	0	1	6	0	0
24	21505606	.	T	C	0	2	2	0	1	3	0	0
24	21505623	.	G	A	1	2	3	0	0	3	0	0
24	21538430	.	C	T	19	11	30	0	1	31	0	0
24	21538441	.	T	G	15	0	15	0	9	24	0	0
24	21538568	.	A	C	3	9	12	0	1	13	0	0
24	21538628	.	C	T	2	4	6	0	0	6	0	0
24	21561074	.	C	T	4	5	9	0	0	9	0	0
24	21575273	.	T	A	14	10	24	0	1	25	0	0
24	21575311	.	G	C	12	10	22	0	0	22	0	0
24	21575449	.	A	C	4	0	4	0	9	13	0	0
24	21575461	.	A	C	3	3	6	0	5	11	0	0
24	21577239	.	G	A	4	9	13	0	1	14	0	0
24	21577488	.	T	C	8	13	21	0	3	24	0	0
24	21577620	.	T	G	5	10	15	0	0	15	0	0
24	21600984	.	C	A	16	22	38	0	0	38	0	0
24	21606035	.	G	A	15	9	24	0	1	25	0	0
24	21606325	.	C	T	1	9	10	0	14	24	0	0
24	21610064	.	G	A	9	10	19	0	1	20	0	0
24	21621694	.	T	C	1	3	4	0	0	4	0	0
24	21621730	.	G	T	14	14	28	0	0	28	0	0
24	21646375	.	G	A	7	14	21	0	0	21	0	0
24	21646704	.	G	T	25	27	52	0	2	54	0	0
24	21646847	.	A	C	16	18	34	0	0	34	0	0
24	21650034	.	T	A	20	18	38	0	2	40	0	0
24	21657567	.	C	G	12	10	22	0	0	22	0	0
24	21657606	.	T	C	11	7	18	0	1	19	0	0
24	21657639	.	G	A	13	4	17	0	1	18	0	0
24	21657642	.	G	A	13	6	19	0	1	20	0	0
24	21657738	.	T	C	9	0	9	0	13	22	0	0
24	21659864	.	A	T	4	5	9	0	1	10	0	0
24	21659873	.	A	G	4	3	7	0	0	7	0	0
24	21662298	.	T	G	4	2	6	0	0	6	0	0
24	21671114	.	G	A	11	10	21	0	0	21	0	0
24	21679971	.	G	A	6	2	8	0	0	8	0	0
24	21680010	.	G	A	0	2	2	1	7	10	0	0
24	21680143	.	T	C	7	5	12	0	0	12	0	0
24	21680747	.	C	G	2	2	4	0	0	4	0	0
24	21680811	.	C	G	2	2	4	0	1	5	0	0
24	21681074	.	G	T	8	9	17	0	0	17	0	0
24	21681112	.	T	A	7	4	11	0	0	11	0	0
24	21681162	.	C	T	4	6	10	0	0	10	0	0
24	21744266	.	A	G	3	3	6	0	0	6	0	0
24	21747705	.	T	C	6	5	11	0	0	11	0	0
24	21747821	.	A	T	5	2	7	0	0	7	0	0
24	21748175	.	A	G	10	8	18	0	0	18	0	0
24	21748249	.	T	C	17	18	35	0	0	35	0	0
24	21748279	.	C	T	14	20	34	0	0	34	0	0
24	21748374	.	T	C	7	6	13	0	0	13	0	0
24	21781146	.	A	G	3	3	6	0	0	6	0	0
24	21781451	.	T	G	2	2	4	0	0	4	0	0
24	21781452	.	T	A	2	2	4	0	0	4	0	0
24	21788128	.	G	C	2	2	4	0	0	4	0	0
24	21865207	.	G	A	2	4	6	0	0	6	0	0
24	21917502	.	T	C	3	4	7	0	0	7	0	0
24	21917518	.	G	A	3	2	5	0	0	5	0	0
24	21917654	.	C	G	0	3	3	0	1	4	0	0
24	21917745	.	T	G	10	6	16	0	0	16	0	0
24	21917955	.	G	A	2	5	7	0	1	8	0	0
24	21927438	.	G	A	1	8	9	0	1	10	0	0
24	21927456	.	C	T	1	8	9	0	0	9	0	0
24	21927506	.	A	G	2	5	7	0	0	7	0	0
24	22740589	.	T	C	16	6	22	0	0	22	0	0
24	22740897	.	A	T	10	12	22	0	1	23	0	0
24	22740949	.	A	G	9	12	21	0	1	22	0	0
24	22740996	.	C	T	9	6	15	0	0	15	0	0
24	22741088	.	C	T	8	6	14	0	2	16	0	0
24	22741403	.	T	A	16	7	23	0	0	23	0	0
24	22741453	.	C	T	14	7	21	0	0	21	0	0
24	22744502	.	A	G	10	10	20	0	1	21	0	0
24	22746843	.	T	G	11	13	24	0	1	25	0	0
24	22748633	.	C	T	5	6	11	0	1	12	0	0
24	22769225	.	A	T	9	19	28	0	1	29	0	0
24	22769333	.	A	G	8	0	8	0	8	16	0	0
24	22769447	.	G	A	3	6	9	0	1	10	0	0
24	22769484	.	C	T	2	3	5	0	0	5	0	0
24	23213411	.	C	A	2	3	5	0	0	5	0	0
24	23213419	.	A	C	2	2	4	0	0	4	0	0
24	23243257	.	A	G	0	4	4	0	0	4	0	0
24	23243946	.	C	A	1	9	10	0	0	10	0	0
24	23759787	.	T	G	3	7	10	0	0	10	0	0
24	23816498	.	G	C	1	2	3	0	0	3	0	0
24	23817395	.	T	G	1	2	3	0	0	3	0	0
24	23817479	.	T	A	1	5	6	0	0	6	0	0
24	23838823	.	C	T	3	4	7	0	1	8	0	0
24	23839024	.	T	C	5	4	9	0	2	11	0	0
24	23839303	.	A	G	5	5	10	0	1	11	0	0
24	23839342	.	T	C	4	2	6	0	1	7	0	0
24	23941618	.	G	T	4	2	6	0	0	6	0	0
24	24017837	.	C	T	6	6	12	0	0	12	0	0
24	24020314	.	C	T	7	9	16	0	1	17	0	0
24	24027914	.	T	A	7	8	15	0	0	15	0	0
24	24027939	.	A	G	8	8	16	0	2	18	0	0
24	24028016	.	C	T	14	8	22	0	1	23	0	0
24	24028032	.	G	C	15	8	23	0	0	23	0	0
24	24028059	.	T	A	10	12	22	0	0	22	0	0
24	24102091	.	T	C	15	0	15	0	27	42	0	0
24	24110789	.	A	T	17	23	40	0	0	40	0	0
24	24110935	.	C	T	16	19	35	0	0	35	0	0
24	24111470	.	G	A	7	11	18	0	0	18	0	0
24	24114272	.	G	C	6	5	11	0	0	11	0	0
24	24114321	.	C	T	6	3	9	0	0	9	0	0
24	24114417	.	C	T	7	4	11	0	0	11	0	0
24	24118213	.	A	C	4	2	6	0	1	7	0	0
24	24118222	.	A	G	5	2	7	0	1	8	0	0
24	24119200	.	T	C	1	2	3	0	0	3	0	0
24	24121130	.	C	T	21	27	48	0	2	50	0	0
24	24121282	.	C	G	1	21	22	0	22	44	0	0
24	24121366	.	A	G	30	27	57	0	1	58	0	0
24	24121375	.	G	C	26	1	27	0	28	55	0	0
24	24121502	.	T	A	11	7	18	0	2	20	0	0
24	24121826	.	G	T	20	21	41	0	1	42	0	0
24	24121851	.	A	T	19	22	41	0	7	48	0	0
24	24124517	.	G	A	28	18	46	0	0	46	0	0
24	24127078	.	A	T	16	21	37	0	0	37	0	0
24	24130794	.	A	G	19	29	48	0	3	51	0	0
24	24130824	.	T	C	26	20	46	0	3	49	0	0
24	24135906	.	G	A	16	13	29	0	1	30	0	0
24	24136047	.	T	G	11	15	26	0	3	29	0	0
24	24146669	.	T	C	15	1	16	0	10	26	0	0
24	24155586	.	T	C	3	7	10	0	0	10	0	0
24	24155607	.	G	A	3	6	9	0	0	9	0	0
24	24155655	.	A	G	7	5	12	0	0	12	0	0
24	24155664	.	C	A	8	5	13	0	1	14	0	0
24	24155718	.	A	T	6	6	12	0	0	12	0	0
24	24163114	.	C	T	2	3	5	0	0	5	0	0
24	24164812	.	A	T	13	20	33	0	0	33	0	0
24	24164935	.	A	C	10	11	21	0	2	23	0	0
24	24168359	.	G	C	22	17	39	0	2	41	0	0
24	24177137	.	A	G	8	4	12	0	3	15	0	0
24	24177158	.	T	C	6	5	11	0	0	11	0	0
24	24177213	.	G	C	5	4	9	0	1	10	0	0
24	24177288	.	G	A	1	5	6	0	0	6	0	0
24	24177367	.	C	T	1	3	4	0	0	4	0	0
24	24184677	.	T	A	4	2	6	0	1	7	0	0
24	24273914	.	A	G	2	2	4	0	0	4	0	0
24	24300125	.	C	T	3	2	5	0	1	6	0	0
24	24461710	.	T	A	2	2	4	0	0	4	0	0
24	24462021	.	C	T	4	5	9	0	0	9	0	0
24	24463030	.	T	A	21	9	30	0	2	32	0	0
24	24463060	.	A	G	22	14	36	0	1	37	0	0
24	24701885	.	C	G	3	9	12	0	0	12	0	0
24	24701938	.	T	C	3	11	14	0	0	14	0	0
24	24702119	.	A	C	2	0	2	0	4	6	0	0
24	24702674	.	C	T	9	6	15	0	0	15	0	0
24	24731396	.	T	C	1	2	3	0	0	3	0	0
24	24848118	.	C	T	4	20	24	0	24	48	0	0
24	24934347	.	T	C	3	6	9	0	0	9	0	0
24	24935527	.	G	A	5	9	14	0	1	15	0	0
24	24935560	.	A	G	6	0	6	0	8	14	0	0
24	24935810	.	T	C	1	2	3	0	0	3	0	0
24	24948089	.	T	A	2	2	4	0	0	4	0	0
24	24989368	.	C	T	0	7	7	0	10	17	0	0
24	24992522	.	G	A	1	6	7	0	0	7	0	0
24	24992832	.	A	G	2	2	4	0	0	4	0	0
24	25008378	.	G	C	2	0	2	0	2	4	0	0
24	25008884	.	G	A	11	5	16	0	0	16	0	0
24	25008887	.	G	A	10	4	14	0	2	16	0	0
24	25026278	.	G	A	1	4	5	0	0	5	0	0
24	25026344	.	C	T	0	3	3	0	1	4	0	0
24	25032485	.	G	A	1	2	3	0	0	3	0	0
24	25047572	.	C	G	2	0	2	0	3	5	0	0
24	25052078	.	C	T	2	2	4	0	0	4	0	0
24	25052723	.	T	A	4	2	6	0	0	6	0	0
24	25052774	.	C	T	5	6	11	0	0	11	0	0
24	25053032	.	C	A	7	6	13	0	0	13	0	0
24	25059127	.	C	T	6	5	11	0	0	11	0	0
24	25059129	.	T	C	6	5	11	0	0	11	0	0
24	25069926	.	A	G	1	0	1	0	4	5	0	0
24	25070289	.	C	T	2	4	6	0	0	6	0	0
24	25070745	.	G	A	1	3	4	0	5	9	0	0
24	25070921	.	C	T	4	2	6	0	0	6	0	0
24	25070922	.	T	G	4	1	5	0	1	6	0	0
24	25071270	.	T	A	9	6	15	0	0	15	0	0
24	25071474	.	T	C	13	8	21	0	2	23	0	0
24	25071486	.	A	T	10	11	21	0	0	21	0	0
24	25071726	.	G	A	4	8	12	0	0	12	0	0
24	25071742	.	T	C	5	6	11	0	0	11	0	0
24	25072088	.	T	C	7	8	15	0	0	15	0	0
24	25072102	.	T	C	9	6	15	0	2	17	0	0
24	25072311	.	C	T	11	4	15	0	0	15	0	0
24	25072358	.	C	A	4	3	7	0	1	8	0	0
24	25072487	.	A	G	20	12	32	0	2	34	0	0
24	25072511	.	T	G	15	12	27	0	2	29	0	0
24	25072711	.	G	A	12	16	28	0	2	30	0	0
24	25223821	.	A	C	1	1	2	0	1	3	0	0
24	25347794	.	G	T	13	4	17	0	1	19	1	0
24	25348187	.	C	A	7	3	10	0	0	10	0	0
24	25348354	.	C	T	5	7	12	0	1	13	0	0
24	25448002	.	T	A	1	2	3	0	0	3	0	0
24	25448155	.	G	A	11	5	16	0	1	17	0	0
24	25448185	.	C	A	2	6	8	0	6	14	0	0
24	25449182	.	G	A	3	3	6	0	0	6	0	0
24	25449319	.	G	A	3	6	9	0	0	9	0	0
24	25452620	.	G	A	1	3	4	0	0	4	0	0
24	25454912	.	G	A	1	2	3	0	0	3	0	0
24	25496789	.	T	C	2	4	6	0	0	6	0	0
24	25497085	.	C	G	3	3	6	0	0	6	0	0
24	25497099	.	G	C	2	3	5	0	0	5	0	0
24	25497273	.	A	T	4	2	6	0	2	8	0	0
24	25497327	.	T	C	3	3	6	0	1	7	0	0
24	25497353	.	G	A	0	3	3	0	5	8	0	0
24	25497677	.	G	A	10	8	18	0	0	18	0	0
24	25693003	.	G	A	12	9	21	0	2	23	0	0
24	25693026	.	C	T	14	12	26	0	3	29	0	0
24	25693948	.	A	G	19	28	47	0	1	48	0	0
24	25693992	.	T	A	19	21	40	0	5	45	0	0
24	25694537	.	A	C	19	25	44	0	2	46	0	0
24	25761637	.	T	C	2	2	4	0	0	4	0	0
24	25762272	.	G	A	2	3	5	0	2	7	0	0
24	25762600	.	T	C	1	3	4	0	0	4	0	0
24	25762930	.	C	A	1	3	4	0	1	5	0	0
24	25762968	.	G	A	1	3	4	0	0	4	0	0
24	25764207	.	A	T	2	2	4	0	0	4	0	0
24	25872390	.	C	T	5	5	10	0	0	10	0	0
24	26030340	.	T	G	8	5	13	0	0	13	0	0
24	26030571	.	C	T	11	6	17	0	0	17	0	0
24	26030663	.	T	C	4	7	11	0	0	11	0	0
24	26030827	.	A	C	6	15	21	0	2	23	0	0
24	26030849	.	T	A	10	15	25	0	0	25	0	0
24	26030893	.	G	A	12	13	25	0	3	28	0	0
24	26030985	.	A	T	4	14	18	0	1	19	0	0
24	26049946	.	A	C	2	2	4	0	0	4	0	0
24	26050066	.	A	T	3	3	6	0	0	6	0	0
24	26279971	.	C	T	4	2	6	0	1	7	0	0
24	26280058	.	G	A	5	8	13	0	1	14	0	0
24	26280163	.	A	G	7	6	13	0	1	14	0	0
24	26280505	.	G	A	6	5	11	0	0	11	0	0
24	26280756	.	G	A	3	3	6	0	0	6	0	0
24	26284612	.	G	T	12	3	15	0	0	15	0	0
24	26331250	.	C	T	1	3	4	0	0	4	0	0
24	26333366	.	G	A	2	2	4	0	0	4	0	0
24	26333597	.	C	T	2	4	6	0	0	6	0	0
24	26333801	.	C	T	2	2	4	0	0	4	0	0
24	26373473	.	G	A	2	3	5	0	0	5	0	0
24	26383604	.	T	A	2	2	4	0	0	4	0	0
24	26383829	.	C	T	0	3	3	0	2	5	0	0
24	26383840	.	C	T	3	2	5	0	0	5	0	0
24	26415190	.	T	C	1	3	4	0	0	4	0	0
24	26420141	.	T	C	7	4	11	0	1	12	0	0
24	26429443	.	T	C	11	8	19	0	0	19	0	0
24	26429456	.	C	T	12	8	20	0	1	21	0	0
24	26475434	.	C	T	13	19	32	0	2	34	0	0
24	26478889	.	C	T	2	20	22	0	27	49	0	0
24	26482337	.	T	C	31	35	66	0	4	70	0	0
24	26492062	.	T	A	10	2	12	0	7	19	0	0
24	26492113	.	C	T	0	7	7	0	16	23	0	0
24	26492505	.	G	T	9	4	13	1	0	14	0	0
24	26493158	.	A	C	4	0	4	0	6	10	0	0
24	26493542	.	C	A	4	12	16	0	0	16	0	0
24	26493691	.	T	A	3	4	7	0	0	7	0	0
24	26494077	.	C	A	3	6	9	0	0	9	0	0
24	26511001	.	C	T	0	2	2	0	1	3	0	0
24	26662895	.	A	G	6	4	10	0	0	10	0	0
24	26663944	.	A	G	3	2	5	0	0	5	0	0
24	26891144	.	G	T	2	2	4	1	0	5	0	0
24	26891149	.	A	G	2	2	4	1	0	5	0	0
24	26901690	.	T	C	1	2	3	0	0	3	0	0
24	26901727	.	G	A	1	4	5	0	3	8	0	0
24	26941247	.	G	C	1	0	1	0	2	3	0	0
24	26941493	.	T	G	8	2	10	0	0	10	0	0
24	26941496	.	G	T	7	2	9	0	0	9	0	0
24	26941713	.	C	T	9	7	16	0	3	19	0	0
24	26941996	.	A	G	7	7	14	0	2	16	0	0
24	26942242	.	C	G	13	5	18	0	0	18	0	0
24	26942711	.	T	C	5	7	12	0	1	13	0	0
24	26942880	.	A	T	6	6	12	0	0	12	0	0
24	26943103	.	C	G	7	4	11	1	0	12	0	0
24	26943148	.	C	T	4	2	6	0	0	6	0	0
24	26945274	.	T	A	4	4	8	0	1	9	0	0
24	26948933	.	A	T	4	5	9	0	0	9	0	0
24	26949164	.	T	A	0	8	8	0	0	8	0	0
24	26949426	.	A	C	3	6	9	0	0	9	0	0
24	26949555	.	T	G	8	5	13	0	1	14	0	0
24	26962277	.	C	T	3	2	5	0	0	5	0	0
24	26968308	.	G	A	2	3	5	0	0	5	0	0
24	27185574	.	A	G	4	4	8	0	0	8	0	0
24	27203410	.	C	T	1	4	5	1	0	6	0	0
24	27207238	.	G	T	4	2	6	0	0	6	0	0
24	27216987	.	G	A	0	1	1	0	4	5	0	0
24	27222574	.	G	A	8	8	16	0	0	16	0	0
24	27222662	.	C	T	11	9	20	0	0	20	0	0
24	27222731	.	A	G	5	2	7	0	10	17	0	0
24	27222937	.	G	A	1	4	5	0	13	18	0	0
24	27223018	.	C	T	5	4	9	0	0	9	0	0
24	27224064	.	T	A	22	18	40	0	0	40	0	0
24	27224598	.	G	A	5	7	12	0	0	12	0	0
24	27224863	.	C	A	17	10	27	0	2	29	0	0
24	27225096	.	T	C	18	13	31	0	2	33	0	0
24	27225423	.	C	A	15	7	22	0	0	22	0	0
24	27226044	.	A	G	1	7	8	0	0	8	0	0
24	27226057	.	C	T	5	3	8	0	0	8	0	0
24	27238808	.	C	T	0	5	5	0	10	15	0	0
24	27238826	.	G	A	4	4	8	0	0	8	0	0
24	27251249	.	C	T	2	3	5	0	0	5	0	0
24	27399969	.	T	C	5	5	10	0	0	10	0	0
24	28252608	.	C	T	8	10	18	0	0	18	0	0
24	28252699	.	G	A	13	9	22	0	1	23	0	0
24	28252898	.	C	A	15	11	26	0	1	27	0	0
24	28253740	.	A	T	14	13	27	0	2	29	0	0
24	28253802	.	T	C	10	0	10	1	15	26	0	0
24	28259134	.	T	C	9	7	16	0	2	18	0	0
24	28263856	.	G	C	7	5	12	1	1	14	0	0
24	28263964	.	G	A	11	7	18	0	0	18	0	0
24	28276193	.	C	T	0	4	4	0	1	5	0	0
24	28381103	.	C	T	1	1	2	0	1	3	0	0
24	28392421	.	T	C	1	2	3	0	0	3	0	0
24	28394482	.	C	T	3	2	5	0	0	5	0	0
24	28397232	.	G	T	0	3	3	0	3	6	0	0
24	28426082	.	T	A	16	8	24	0	3	27	0	0
24	28426244	.	G	C	13	8	21	0	1	22	0	0
24	28426597	.	G	A	16	20	36	0	0	36	0	0
24	28432465	.	C	T	12	12	24	0	1	25	0	0
24	28437375	.	A	G	13	15	28	0	0	28	0	0
24	28437562	.	G	C	9	4	13	0	1	14	0	0
24	28556150	.	C	T	1	2	3	0	0	3	0	0
24	28556766	.	T	G	1	2	3	0	0	3	0	0
24	28687424	.	C	T	0	9	9	0	17	26	0	0
24	28687576	.	A	G	11	8	19	0	1	20	0	0
24	28688416	.	G	A	5	5	10	0	0	10	0	0
24	28691457	.	C	T	0	3	3	0	6	9	0	0
24	28710825	.	A	G	5	2	7	0	0	7	0	0
24	28764251	.	A	C	2	2	4	0	0	4	0	0
24	28936771	.	C	T	15	7	22	0	2	24	0	0
24	28936801	.	A	T	14	8	22	0	1	23	0	0
24	28953040	.	C	A	7	14	21	0	0	21	0	0
24	28960786	.	T	G	17	10	27	0	1	28	0	0
24	28960808	.	A	C	17	10	27	0	4	31	0	0
24	28965616	.	C	T	3	4	7	0	0	7	0	0
24	28966034	.	C	G	1	2	3	0	0	3	0	0
24	28966873	.	C	A	5	8	13	1	0	14	0	0
24	28966892	.	T	C	9	8	17	1	0	18	0	0
24	29352703	.	T	C	2	4	6	0	0	6	0	0
24	29450222	.	C	T	2	6	8	0	1	9	0	0
24	29525169	.	T	A	14	9	23	0	4	27	0	0
24	29525262	.	T	C	15	9	24	0	2	26	0	0
24	29961703	.	C	T	1	2	3	0	0	3	0	0
24	30054147	.	A	C	1	2	3	0	0	3	0	0
24	30054152	.	T	A	1	2	3	0	0	3	0	0
24	30352907	.	T	C	14	13	27	0	1	28	0	0
24	30352940	.	T	A	17	14	31	0	0	31	0	0
24	30353036	.	T	A	12	14	26	0	1	27	0	0
24	30353065	.	G	A	9	14	23	0	3	26	0	0
24	30353083	.	G	A	9	13	22	0	3	25	0	0
24	30353298	.	A	G	13	9	22	0	1	23	0	0
24	30353447	.	T	C	16	8	24	0	1	25	0	0
24	30353683	.	A	G	3	7	10	0	3	13	0	0
24	30353893	.	C	A	15	13	28	0	1	29	0	0
24	30353918	.	C	T	10	13	23	0	2	25	0	0
24	30835992	.	G	T	6	7	13	0	3	16	0	0
24	30836132	.	A	G	3	4	7	0	0	7	0	0
24	30837512	.	A	G	3	7	10	0	0	10	0	0
24	30837682	.	G	C	5	4	9	0	0	9	0	0
24	31082078	.	A	G	3	8	11	0	0	11	0	0
24	31082432	.	G	T	4	7	11	0	1	12	0	0
24	31082758	.	A	T	6	5	11	0	0	11	0	0
24	31082774	.	C	A	6	5	11	0	0	11	0	0
24	31098655	.	C	A	4	3	7	0	2	9	0	0
24	31170701	.	C	T	1	10	11	0	2	13	0	0
24	31311080	.	A	C	14	13	27	0	0	27	0	0
24	31311323	.	C	G	2	3	5	0	5	10	0	0
24	31311334	.	G	C	7	5	12	0	0	12	0	0
24	31313234	.	G	A	12	12	24	0	2	26	0	0
24	31319044	.	A	G	6	3	9	0	0	9	0	0
24	31320049	.	G	A	1	3	4	0	0	4	0	0
24	31322911	.	G	C	3	0	3	0	5	8	0	0
24	31322950	.	T	G	1	5	6	0	0	6	0	0
24	31323142	.	C	T	1	4	5	0	0	5	0	0
24	31325202	.	T	C	1	3	4	0	0	4	0	0
24	31334313	.	A	G	7	10	17	0	1	18	0	0
24	31340673	.	T	C	19	23	42	0	1	43	0	0
24	31340819	.	A	T	11	22	33	0	3	37	1	0
24	31342807	.	T	C	3	2	5	0	0	5	0	0
24	31342846	.	G	C	3	3	6	0	1	7	0	0
24	31342855	.	G	A	3	3	6	0	0	6	0	0
24	31342883	.	T	A	4	3	7	0	0	7	0	0
24	31346647	.	G	T	21	15	36	0	4	40	0	0
24	31367491	.	A	G	4	2	6	0	0	6	0	0
24	31367841	.	C	A	3	1	4	0	1	5	0	0
24	31367851	.	G	A	4	2	6	0	0	6	0	0
24	31367891	.	C	T	5	4	9	0	1	10	0	0
24	31367999	.	A	G	3	3	6	0	1	7	0	0
24	31368370	.	A	T	3	5	8	0	0	8	0	0
24	31368390	.	T	A	5	6	11	0	0	11	0	0
24	31397840	.	G	A	1	3	4	0	0	4	0	0
24	31402435	.	G	A	1	2	3	0	0	3	0	0
24	31402467	.	A	C	1	2	3	0	0	3	0	0
24	31452671	.	C	T	1	3	4	0	0	4	0	0
24	31832549	.	G	A	5	7	12	0	2	14	0	0
24	31832615	.	T	G	6	3	9	0	0	9	0	0
24	31832657	.	G	A	4	4	8	0	1	9	0	0
24	31832761	.	G	A	2	3	5	0	0	5	0	0
24	31833114	.	A	T	6	6	12	0	0	12	0	0
24	31833991	.	G	A	4	5	9	0	0	9	0	0
24	31834396	.	G	A	4	4	8	0	0	8	0	0
24	31834681	.	A	T	5	5	10	0	0	10	0	0
24	31838995	.	C	A	1	2	3	0	0	3	0	0
24	31839067	.	G	A	2	2	4	0	0	4	0	0
24	31853381	.	C	T	3	3	6	0	0	6	0	0
24	31853438	.	C	T	4	2	6	0	0	6	0	0
24	31854465	.	C	T	2	2	4	0	0	4	0	0
24	32152862	.	A	G	2	4	6	0	0	6	0	0
24	32152877	.	T	G	0	5	5	0	0	5	0	0
24	32163890	.	C	T	2	7	9	0	0	9	0	0
24	32164366	.	A	G	1	2	3	0	1	4	0	0
24	32173646	.	A	G	3	5	8	0	1	9	0	0
24	32176448	.	C	T	3	10	13	0	2	15	0	0
24	32176716	.	G	C	10	5	15	0	2	17	0	0
24	32184363	.	C	T	7	5	12	0	0	12	0	0
24	32184379	.	C	A	13	7	20	0	0	20	0	0
24	32187534	.	G	A	21	11	32	0	3	35	0	0
24	32192622	.	T	C	24	12	36	0	1	37	0	0
24	32415367	.	C	G	4	3	7	0	0	7	0	0
24	32425845	.	A	C	1	2	3	0	0	3	0	0
24	32473291	.	C	T	6	5	11	0	0	11	0	0
24	32473326	.	C	G	6	0	6	0	8	14	0	0
24	32473386	.	C	T	12	9	21	0	1	22	0	0
24	32473464	.	T	C	8	4	12	0	1	13	0	0
24	32473597	.	G	A	0	10	10	0	10	20	0	0
24	32473829	.	A	G	1	4	5	0	0	5	0	0
24	32474198	.	T	G	1	4	5	0	0	5	0	0
24	32474229	.	T	A	1	3	4	0	1	5	0	0
24	32474546	.	A	C	5	14	19	0	1	20	0	0
24	32517984	.	G	A	11	18	29	0	1	30	0	0
24	32519471	.	G	A	26	27	53	0	2	55	0	0
24	32519528	.	C	T	3	20	23	0	27	50	0	0
24	32522462	.	T	A	16	15	31	0	2	34	1	0
24	32547959	.	A	T	3	3	6	0	0	6	0	0
24	32548481	.	A	G	3	2	5	0	0	5	0	0
24	32650263	.	T	G	2	5	7	0	0	7	0	0
24	32658577	.	C	T	2	2	4	0	0	4	0	0
24	32668834	.	G	A	3	3	6	0	0	6	0	0
24	32668880	.	T	A	6	12	18	0	0	18	0	0
24	32674708	.	C	T	12	6	18	0	0	18	0	0
24	32674960	.	T	A	5	2	7	0	0	7	0	0
24	33228611	.	A	G	3	3	6	0	1	7	0	0
24	33228620	.	C	T	4	2	6	0	1	7	0	0
24	33279954	.	G	T	1	2	3	0	0	3	0	0
24	33283197	.	G	A	1	5	6	0	0	6	0	0
24	33284817	.	A	G	2	2	4	0	0	4	0	0
24	33284823	.	G	A	2	2	4	0	0	4	0	0
24	33289036	.	A	C	1	1	2	0	0	2	0	0
24	33289043	.	C	T	1	2	3	0	0	3	0	0
24	33289134	.	G	T	7	3	10	0	0	10	0	0
24	33290618	.	T	G	2	3	5	0	1	6	0	0
24	33291549	.	A	G	5	2	7	0	0	7	0	0
24	33837192	.	A	G	7	4	11	0	0	11	0	0
24	33837196	.	A	G	4	6	10	0	0	10	0	0
24	33837865	.	A	G	1	4	5	0	1	6	0	0
24	33837873	.	A	G	3	3	6	0	0	6	0	0
24	33837914	.	A	G	2	5	7	0	0	7	0	0
24	33837916	.	A	G	3	3	6	0	1	7	0	0
24	34991185	.	A	G	6	11	17	0	1	18	0	0
24	34993400	.	A	G	12	5	17	0	1	18	0	0
24	34993406	.	T	C	10	6	16	0	2	18	0	0
24	34996173	.	C	T	10	5	15	0	1	16	0	0
24	35000961	.	G	T	0	11	11	0	12	23	0	0
24	35002871	.	G	A	12	5	17	0	0	17	0	0
24	35196166	.	C	T	6	3	9	0	4	13	0	0
24	35196205	.	C	G	6	6	12	0	0	12	0	0
24	35213755	.	T	C	9	9	18	0	1	19	0	0
24	35213764	.	G	A	1	11	12	0	8	20	0	0
24	35216439	.	A	T	23	16	39	0	3	42	0	0
24	35216541	.	C	T	21	13	34	0	1	35	0	0
24	35216835	.	A	G	12	6	18	0	3	21	0	0
24	35217255	.	G	A	12	10	22	0	1	23	0	0
24	35217258	.	C	G	13	9	22	0	0	22	0	0
24	35217302	.	T	G	11	6	17	0	0	17	0	0
24	35523365	.	T	G	16	0	16	0	20	36	0	0
24	35523385	.	T	C	0	21	21	0	3	24	0	0
24	36399642	.	A	G	3	2	5	1	0	6	0	0
24	37319851	.	G	A	1	4	5	0	0	5	0	0
24	37649810	.	T	C	1	2	3	0	0	3	0	0
24	37650143	.	A	G	2	0	2	0	2	4	0	0
24	37650146	.	T	C	2	2	4	0	0	4	0	0
24	37655196	.	A	T	4	2	6	0	0	6	0	0
24	37655213	.	C	T	1	4	5	0	0	5	0	0
24	37657773	.	G	A	0	3	3	0	2	5	0	0
24	37661521	.	C	A	1	3	4	0	0	4	0	0
24	37681556	.	G	T	4	4	8	0	0	8	0	0
24	37685925	.	C	T	3	5	8	0	0	8	0	0
24	37685942	.	C	T	1	5	6	0	5	11	0	0
24	37686132	.	C	T	7	2	9	0	0	9	0	0
24	37689919	.	T	C	31	20	51	0	2	53	0	0
24	37692529	.	G	A	26	29	55	0	2	57	0	0
24	37695870	.	C	T	1	3	4	0	2	6	0	0
24	37696508	.	T	C	3	6	9	0	2	11	0	0
24	37704287	.	G	C	5	2	7	0	1	8	0	0
24	37705635	.	G	A	4	2	6	0	0	6	0	0
24	37705648	.	C	A	3	3	6	0	0	6	0	0
24	37708017	.	T	C	3	9	12	0	0	12	0	0
24	37708207	.	T	A	4	5	9	0	0	9	0	0
24	37718769	.	T	C	3	3	6	0	0	6	0	0
24	37718813	.	C	T	3	2	5	0	0	5	0	0
24	37718892	.	C	T	1	2	3	0	0	3	0	0
24	37791099	.	C	T	1	2	3	0	0	3	0	0
24	37793725	.	C	T	1	4	5	0	1	6	0	0
24	37816851	.	T	C	3	2	5	0	0	5	0	0
24	37823329	.	T	C	3	5	8	0	0	8	0	0
24	37888518	.	C	T	1	3	4	0	0	4	0	0
24	37893269	.	A	G	3	3	6	0	1	7	0	0
24	37893391	.	A	T	2	4	6	0	0	6	0	0
24	37896875	.	C	T	2	4	6	0	0	6	0	0
24	37899479	.	A	T	6	3	9	0	0	9	0	0
24	37900945	.	G	A	1	6	7	0	6	13	0	0
24	37901148	.	A	G	10	4	14	0	0	14	0	0
24	37901178	.	C	T	13	4	17	0	0	17	0	0
24	37941922	.	A	C	8	6	14	0	1	15	0	0
24	37942032	.	C	T	11	3	14	0	0	14	0	0
24	37942183	.	A	T	4	3	7	0	0	7	0	0
24	37942664	.	T	C	3	2	5	0	0	5	0	0
24	38073247	.	A	G	3	6	9	0	0	9	0	0
24	38073271	.	G	A	5	8	13	0	0	13	0	0
24	38073754	.	A	C	1	2	3	0	0	3	0	0
24	38190594	.	G	T	0	2	2	0	2	4	0	0
24	38190606	.	A	T	1	2	3	0	1	4	0	0
24	38190654	.	T	C	2	2	4	0	0	4	0	0
24	38190768	.	G	A	2	2	4	0	0	4	0	0
24	38190868	.	A	G	2	2	4	0	0	4	0	0
24	38190894	.	G	A	3	4	7	0	0	7	0	0
24	38191537	.	C	T	1	6	7	0	0	7	0	0
24	38191590	.	T	C	2	2	4	0	0	4	0	0
24	38191643	.	A	G	3	3	6	0	1	7	0	0
24	38191652	.	A	T	6	3	9	0	0	9	0	0
24	38191841	.	C	T	9	5	14	0	0	14	0	0
24	38191900	.	A	G	2	3	5	0	0	5	0	0
24	38369559	.	T	A	10	7	17	0	0	17	0	0
24	38369873	.	G	A	10	11	21	0	1	22	0	0
24	38370188	.	A	G	7	5	12	0	0	12	0	0
24	38370245	.	C	G	1	6	7	0	4	11	0	0
24	38370998	.	A	G	1	3	4	0	0	4	0	0
24	38815105	.	T	A	6	7	13	0	1	14	0	0
24	38816010	.	G	T	5	3	8	0	0	8	0	0
24	38816340	.	T	G	1	4	5	0	0	5	0	0
24	39051803	.	A	C	1	2	3	0	1	4	0	0
24	39052200	.	C	T	2	3	5	0	0	5	0	0
24	39052236	.	G	T	1	4	5	0	2	7	0	0
24	39052302	.	G	A	1	4	5	0	0	5	0	0
24	39052311	.	C	T	4	2	6	0	0	6	0	0
24	39075534	.	T	C	3	4	7	0	0	7	0	0
24	39078597	.	A	G	2	0	2	0	5	7	0	0
24	39081150	.	C	T	2	2	4	0	0	4	0	0
24	39137777	.	G	A	0	2	2	0	1	3	0	0
24	39137785	.	G	T	1	2	3	0	0	3	0	0
24	39152794	.	A	G	6	5	11	0	0	11	0	0
24	39272041	.	A	G	2	2	4	0	0	4	0	0
24	39277575	.	C	G	1	2	3	0	0	3	0	0
24	39309684	.	A	G	2	0	2	0	4	6	0	0
24	39309889	.	A	T	3	6	9	0	1	10	0	0
24	39310129	.	G	A	3	3	6	0	0	6	0	0
24	39310163	.	G	T	3	2	5	0	0	5	0	0
24	39321017	.	T	C	10	15	25	0	3	28	0	0
24	39322945	.	G	T	0	18	18	0	16	34	0	0
24	39323791	.	C	T	18	24	42	0	0	42	0	0
24	39333916	.	C	T	11	19	30	0	2	32	0	0
24	39334153	.	T	G	19	18	37	0	1	38	0	0
24	39334388	.	A	G	18	27	45	0	2	47	0	0
24	39334681	.	G	T	11	43	54	0	4	58	0	0
24	39334796	.	G	A	1	16	17	0	18	35	0	0
24	39510891	.	T	C	4	4	8	0	0	8	0	0
24	39511016	.	T	C	10	4	14	0	0	14	0	0
24	39511034	.	G	A	8	5	13	0	1	14	0	0
24	39511157	.	G	A	8	7	15	0	1	16	0	0
24	39511298	.	A	C	3	3	6	0	0	6	0	0
24	39511477	.	C	T	1	3	4	0	1	5	0	0
24	39514075	.	A	C	3	4	7	0	1	8	0	0
24	39514296	.	C	G	4	5	9	0	0	9	0	0
24	39518554	.	C	G	0	6	6	0	8	14	0	0
24	39530034	.	G	A	1	4	5	0	3	8	0	0
24	39533337	.	A	G	4	2	6	0	1	7	0	0
24	39533836	.	C	T	3	2	5	0	0	5	0	0
24	39533871	.	T	A	1	1	2	0	1	3	0	0
24	39533987	.	T	A	5	5	10	0	2	12	0	0
24	39556760	.	G	A	0	2	2	0	1	3	0	0
24	39559386	.	G	A	2	3	5	0	0	5	0	0
24	39576071	.	A	T	1	4	5	0	0	5	0	0
24	39576166	.	G	A	0	2	2	0	2	4	0	0
24	39576414	.	C	T	2	4	6	0	0	6	0	0
24	39579569	.	G	A	2	4	6	0	1	7	0	0
24	39579730	.	A	G	3	3	6	0	0	6	0	0
24	39579989	.	G	A	0	3	3	0	2	5	0	0
24	39586778	.	A	T	5	7	12	0	0	12	0	0
24	39593009	.	T	C	6	5	11	0	0	11	0	0
24	39593038	.	G	A	0	5	5	0	6	11	0	0
24	39595866	.	A	C	5	3	8	0	0	8	0	0
24	39606237	.	G	A	24	21	45	0	1	46	0	0
24	39610535	.	G	T	15	9	24	0	0	24	0	0
24	39614901	.	G	A	2	3	5	0	0	5	0	0
24	39614940	.	T	G	1	2	3	0	0	3	0	0
24	39615406	.	G	A	19	8	27	1	1	29	0	0
24	39616170	.	C	A	3	7	10	0	0	10	0	0
24	39638642	.	G	A	15	10	25	0	1	26	0	0
24	39642072	.	A	T	10	7	17	0	3	20	0	0
24	39642220	.	A	G	11	3	14	0	0	14	0	0
24	39642229	.	A	G	8	4	12	0	1	13	0	0
24	39642336	.	C	A	19	7	26	0	0	26	0	0
24	39642361	.	G	T	15	8	23	0	1	24	0	0
24	39644259	.	T	C	18	10	28	0	0	28	0	0
24	39646762	.	C	T	21	13	34	0	0	34	0	0
24	39647021	.	C	T	16	13	29	0	2	31	0	0
24	39647042	.	G	C	18	14	32	0	1	33	0	0
24	39648806	.	C	T	25	17	42	0	1	43	0	0
24	39651567	.	T	G	22	22	44	0	3	47	0	0
24	39651612	.	A	T	23	15	38	0	5	43	0	0
24	39653626	.	G	A	29	14	43	20	1	64	0	0
24	39660219	.	C	T	11	6	17	0	0	17	0	0
24	39661890	.	T	A	8	7	15	0	1	16	0	0
24	39661905	.	C	T	6	8	14	0	1	15	0	0
24	39662074	.	T	C	10	10	20	0	0	20	0	0
24	39663197	.	A	G	8	7	15	0	0	15	0	0
24	39778970	.	C	T	5	4	9	0	0	9	0	0
24	39778982	.	C	G	7	4	11	0	0	11	0	0
24	39779637	.	A	G	3	3	6	0	0	6	0	0
24	40608954	.	C	T	2	5	7	0	0	7	0	0
24	40608962	.	G	T	3	4	7	0	0	7	0	0
24	40609001	.	A	G	2	5	7	0	1	8	0	0
24	40648270	.	C	T	6	11	17	0	3	20	0	0
24	40648284	.	T	A	12	4	16	0	2	19	1	0
24	40876873	.	G	T	3	2	5	0	0	5	0	0
24	40881240	.	T	A	1	3	4	0	0	4	0	0
24	40885816	.	A	G	1	1	2	0	1	3	0	0
24	41309374	.	T	C	1	1	2	0	1	3	0	0
24	41317090	.	A	T	18	8	26	2	6	34	0	0
24	41317132	.	G	A	17	11	28	2	3	33	0	0
24	41317350	.	G	C	4	1	5	0	20	25	0	0
24	41473576	.	T	C	9	0	9	0	5	14	0	0
24	41478831	.	C	T	6	3	9	0	0	9	0	0
24	41753759	.	A	G	1	2	3	0	0	3	0	0
24	41781968	.	C	T	2	8	10	0	1	11	0	0
24	41783906	.	G	A	0	8	8	0	7	15	0	0
24	41783999	.	C	T	7	11	18	0	1	19	0	0
24	41786281	.	C	G	0	2	2	0	0	2	0	0
24	41786304	.	G	A	1	3	4	0	0	4	0	0
24	41917543	.	T	C	1	2	3	0	0	3	0	0
24	41964610	.	G	A	0	9	9	0	4	13	0	0
24	41965111	.	G	A	9	8	17	0	0	17	0	0
24	41965147	.	T	C	10	9	19	0	0	19	0	0
24	41974704	.	G	A	13	9	22	0	0	23	1	0
24	41974736	.	C	T	9	7	16	0	0	16	0	0
24	41974769	.	C	T	9	7	16	0	0	16	0	0
24	41986273	.	C	T	21	16	37	2	2	41	0	0
24	41986311	.	C	A	19	21	40	0	1	41	0	0
24	41986704	.	C	T	19	24	43	0	1	44	0	0
24	41991010	.	A	G	4	8	12	0	0	12	0	0
24	41994096	.	G	A	11	11	22	0	2	24	0	0
24	41994147	.	G	T	11	11	22	0	0	22	0	0
24	42061364	.	G	T	6	3	9	0	0	9	0	0
24	42061369	.	C	T	4	5	9	0	0	9	0	0
24	42061423	.	G	T	1	2	3	0	0	3	0	0
24	42061426	.	G	A	1	1	2	0	0	2	0	0
24	42061460	.	A	G	1	3	4	0	1	5	0	0
24	42083840	.	G	A	8	7	15	0	1	16	0	0
24	42083876	.	A	G	6	9	15	0	0	15	0	0
24	42083906	.	G	A	8	5	13	0	0	13	0	0
24	42090574	.	A	T	5	5	10	0	0	10	0	0
24	42094925	.	G	A	7	4	11	5	0	16	0	0
24	42102416	.	T	A	2	5	7	0	0	7	0	0
24	42102549	.	G	C	0	1	1	0	0	6	5	0
24	42102571	.	C	G	3	4	7	0	0	7	0	0
24	42102647	.	G	A	1	4	5	0	0	5	0	0
24	42105278	.	C	A	3	3	6	0	0	6	0	0
24	42105335	.	G	A	2	3	5	0	0	5	0	0
24	42108547	.	G	A	3	3	6	0	0	6	0	0
24	42117761	.	A	G	5	10	15	0	0	15	0	0
24	42118145	.	C	T	7	4	11	0	0	11	0	0
24	42120459	.	G	C	10	4	14	0	0	14	0	0
24	42132148	.	C	T	4	3	7	10	0	17	0	0
24	42133270	.	G	A	1	11	12	1	6	19	0	0
24	42133646	.	C	T	9	6	15	4	0	19	0	0
24	42139889	.	C	T	19	12	31	0	2	33	0	0
24	42141381	.	A	G	3	7	10	0	1	11	0	0
24	42141460	.	C	T	8	10	18	0	3	21	0	0
24	42141793	.	A	G	10	19	29	1	0	31	1	0
24	42142938	.	C	T	11	15	26	0	0	26	0	0
24	42148189	.	G	A	5	9	14	1	1	16	0	0
24	42153199	.	C	T	13	13	26	0	0	26	0	0
24	42153205	.	C	T	11	10	21	0	1	23	1	0
24	42153476	.	G	A	0	12	12	0	13	25	0	0
24	42153503	.	G	A	12	14	26	0	2	28	0	0
24	42157498	.	C	T	12	15	27	0	0	27	0	0
24	42157571	.	A	G	16	19	35	0	2	37	0	0
24	42157602	.	C	T	19	22	41	0	0	41	0	0
24	42157817	.	C	T	6	4	10	1	0	11	0	0
25	15764	.	A	G	4	0	4	0	3	7	0	0
25	136788	.	T	C	20	12	32	0	0	32	0	0
25	136857	.	C	T	24	15	39	0	2	41	0	0
25	136986	.	C	T	24	11	35	0	3	38	0	0
25	137043	.	C	A	13	6	19	4	3	26	0	0
25	137492	.	C	A	10	17	27	0	0	27	0	0
25	146159	.	G	A	3	13	16	0	17	33	0	0
25	146282	.	C	T	17	10	27	0	2	29	0	0
25	146735	.	C	G	17	13	30	0	1	31	0	0
25	154440	.	C	T	3	2	5	0	1	6	0	0
25	156522	.	C	T	2	4	6	0	0	6	0	0
25	156608	.	C	T	5	5	10	0	0	10	0	0
25	157151	.	T	C	4	2	6	0	0	6	0	0
25	157157	.	C	T	4	2	6	0	0	6	0	0
25	158641	.	T	C	3	2	5	0	0	5	0	0
25	158770	.	C	T	4	6	10	0	1	11	0	0
25	159510	.	C	T	7	6	13	0	0	13	0	0
25	159543	.	T	C	5	8	13	0	0	13	0	0
25	187241	.	T	G	6	5	11	0	1	12	0	0
25	196495	.	T	C	28	36	64	0	6	70	0	0
25	203396	.	T	C	24	11	35	0	4	39	0	0
25	238295	.	G	C	0	5	5	0	4	9	0	0
25	238588	.	A	G	2	4	6	0	0	6	0	0
25	241694	.	C	T	8	4	12	0	0	12	0	0
25	241695	.	A	G	8	4	12	0	0	12	0	0
25	244180	.	C	T	10	5	15	0	1	16	0	0
25	269134	.	A	C	1	1	2	0	1	3	0	0
25	315157	.	C	T	2	3	5	0	0	5	0	0
25	315753	.	G	A	1	2	3	0	0	3	0	0
25	401363	.	T	C	1	2	3	0	0	3	0	0
25	401810	.	T	C	2	2	4	0	0	4	0	0
25	402348	.	G	A	0	1	1	0	3	4	0	0
25	402359	.	T	G	2	0	2	0	2	4	0	0
25	403935	.	T	G	4	3	7	0	0	7	0	0
25	404795	.	T	A	11	6	17	0	1	18	0	0
25	405253	.	G	A	8	14	22	0	2	24	0	0
25	450354	.	C	T	8	11	19	0	0	19	0	0
25	474938	.	T	A	20	18	38	0	2	40	0	0
25	485437	.	C	T	13	14	27	0	1	28	0	0
25	485612	.	C	T	5	25	30	0	18	48	0	0
25	485772	.	C	A	22	15	37	0	1	38	0	0
25	485802	.	T	C	22	19	41	0	1	42	0	0
25	485847	.	T	C	21	20	41	0	2	43	0	0
25	485863	.	A	T	19	16	35	0	4	39	0	0
25	486284	.	G	A	10	14	24	0	2	26	0	0
25	486472	.	A	T	7	4	11	0	2	13	0	0
25	486712	.	G	A	7	9	16	0	0	16	0	0
25	486895	.	C	T	7	8	15	0	0	15	0	0
25	487039	.	C	A	6	14	20	0	1	21	0	0
25	487045	.	C	T	15	7	22	0	0	22	0	0
25	487078	.	T	G	10	16	26	0	3	29	0	0
25	487910	.	T	C	3	6	9	2	1	12	0	0
25	487919	.	T	C	3	7	10	2	1	13	0	0
25	487957	.	A	T	7	3	10	0	2	12	0	0
25	488701	.	G	C	6	0	6	0	6	12	0	0
25	488817	.	G	T	4	8	12	0	0	12	0	0
25	495366	.	G	A	10	3	13	0	2	15	0	0
25	498814	.	T	C	2	6	8	0	2	10	0	0
25	502608	.	G	A	2	6	8	0	0	8	0	0
25	509744	.	A	T	2	3	5	0	0	5	0	0
25	510505	.	T	C	1	0	1	0	6	7	0	0
25	523342	.	C	T	0	1	1	0	2	3	0	0
25	663178	.	C	T	23	10	33	0	1	34	0	0
25	663284	.	G	A	1	11	12	0	20	32	0	0
25	664590	.	A	C	18	14	32	0	2	34	0	0
25	763774	.	T	C	13	9	22	0	1	23	0	0
25	771649	.	T	G	1	3	4	0	0	4	0	0
25	824774	.	C	T	1	2	3	0	0	3	0	0
25	825902	.	G	T	1	4	5	0	0	5	0	0
25	825968	.	A	C	3	2	5	0	0	5	0	0
25	1089010	.	G	A	19	14	33	0	1	34	0	0
25	1089026	.	G	A	12	14	26	0	0	26	0	0
25	1091806	.	G	A	8	13	21	0	0	21	0	0
25	1092442	.	C	A	1	10	11	0	2	13	0	0
25	1093520	.	G	A	7	4	11	0	0	11	0	0
25	1093567	.	G	A	18	7	25	0	1	27	1	0
25	1101431	.	A	G	1	2	3	0	0	3	0	0
25	1101659	.	A	G	1	4	5	0	0	5	0	0
25	1103369	.	G	T	2	2	4	0	0	4	0	0
25	1103980	.	G	A	1	3	4	0	1	5	0	0
25	1104000	.	T	C	0	4	4	0	1	5	0	0
25	1106247	.	C	G	1	2	3	0	0	3	0	0
25	1107992	.	G	A	2	4	6	0	0	6	0	0
25	1108057	.	T	C	2	0	2	0	3	5	0	0
25	1108210	.	G	A	1	2	3	0	0	3	0	0
25	1132509	.	G	A	6	8	14	0	0	14	0	0
25	1132543	.	G	A	10	7	17	0	0	17	0	0
25	1220400	.	G	T	5	8	13	0	1	15	1	0
25	1305338	.	T	G	8	3	11	0	0	11	0	0
25	1338263	.	C	T	3	3	6	0	0	6	0	0
25	1338272	.	G	T	1	3	4	0	1	5	0	0
25	1339403	.	C	T	6	7	13	0	1	14	0	0
25	1339601	.	G	T	0	2	2	0	7	9	0	0
25	1340215	.	G	A	6	7	13	0	0	13	0	0
25	1672426	.	A	G	2	2	4	0	0	4	0	0
25	2264091	.	C	A	1	5	6	0	0	6	0	0
25	2264112	.	T	C	1	7	8	0	0	8	0	0
25	2273945	.	C	T	3	4	7	0	0	7	0	0
25	2276781	.	A	G	1	3	4	0	0	4	0	0
25	2276828	.	T	A	2	4	6	0	0	6	0	0
25	2276869	.	C	T	1	2	3	0	0	3	0	0
25	2282566	.	A	G	11	2	13	0	10	23	0	0
25	2282846	.	A	C	11	12	23	0	2	25	0	0
25	2286066	.	C	T	13	13	26	0	0	26	0	0
25	2286120	.	G	A	15	8	23	0	1	24	0	0
25	2286502	.	T	C	13	8	21	0	1	22	0	0
25	2286600	.	A	T	7	9	16	0	4	20	0	0
25	2286762	.	A	C	7	9	16	0	2	18	0	0
25	2286798	.	A	C	10	16	26	0	0	26	0	0
25	2286837	.	C	T	18	15	33	0	0	33	0	0
25	2286841	.	C	A	17	14	31	0	4	35	0	0
25	2287072	.	G	T	5	2	7	0	0	7	0	0
25	2702718	.	A	G	5	0	5	0	5	10	0	0
25	2702722	.	A	G	6	4	10	0	0	10	0	0
25	3047549	.	T	C	1	2	3	0	0	3	0	0
25	3245895	.	A	G	7	3	10	0	0	10	0	0
25	3245938	.	A	G	2	3	5	0	0	5	0	0
25	4689688	.	A	G	2	3	5	0	0	5	0	0
25	6206292	.	A	T	2	2	4	0	0	4	0	0
25	7324580	.	C	T	13	9	22	1	0	23	0	0
25	7327718	.	C	T	12	9	21	0	1	22	0	0
25	7333751	.	G	A	19	13	32	0	2	34	0	0
25	7333841	.	C	T	20	19	39	0	4	43	0	0
25	7334900	.	A	G	25	2	27	0	16	43	0	0
25	7334951	.	T	C	16	17	33	0	3	36	0	0
25	7334987	.	G	C	17	18	35	0	0	35	0	0
25	7336096	.	T	A	13	6	19	0	2	21	0	0
25	7336269	.	A	G	6	4	10	0	1	11	0	0
25	7428932	.	A	C	3	2	5	0	1	6	0	0
25	7428944	.	T	C	2	3	5	0	0	5	0	0
25	7428971	.	A	T	0	3	3	0	1	4	0	0
25	7429028	.	C	A	2	4	6	0	0	6	0	0
25	7431310	.	A	C	3	3	6	0	1	7	0	0
25	7431334	.	G	A	5	3	8	0	0	8	0	0
25	7431611	.	G	A	5	2	7	0	0	7	0	0
25	7431626	.	T	C	2	4	6	0	0	6	0	0
25	7433584	.	T	C	2	2	4	0	0	4	0	0
25	7454578	.	T	C	3	3	6	0	0	6	0	0
25	7454599	.	T	C	2	3	5	0	0	5	0	0
25	7456535	.	C	A	2	8	10	0	1	11	0	0
25	7456843	.	G	A	0	8	8	0	3	11	0	0
25	7456860	.	G	A	1	3	4	0	9	13	0	0
25	7477641	.	C	T	10	12	22	0	1	23	0	0
25	7487835	.	G	C	22	21	43	0	0	43	0	0
25	7488407	.	T	C	9	21	30	0	1	31	0	0
25	7488599	.	G	T	28	10	38	0	0	38	0	0
25	7488660	.	C	T	29	7	36	0	1	37	0	0
25	7488812	.	G	A	24	24	48	0	3	51	0	0
25	7488813	.	G	T	25	24	49	0	2	51	0	0
25	7489011	.	A	T	30	31	61	0	2	63	0	0
25	7489034	.	G	A	5	27	32	0	30	62	0	0
25	7489197	.	G	T	19	13	32	0	1	33	0	0
25	7494243	.	G	A	0	2	2	0	2	4	0	0
25	7496003	.	C	T	2	3	5	0	0	5	0	0
25	7496992	.	G	C	0	2	2	0	6	8	0	0
25	7500473	.	T	C	12	15	27	0	0	28	1	0
25	7501997	.	G	A	11	16	27	0	1	28	0	0
25	7502022	.	G	C	13	11	24	0	0	24	0	0
25	7502119	.	T	C	7	7	14	0	0	14	0	0
25	7502271	.	T	G	6	0	6	0	6	12	0	0
25	7549339	.	G	C	0	2	2	0	1	3	0	0
25	7678424	.	T	C	1	16	17	0	4	21	0	0
25	7890540	.	T	C	4	2	6	0	0	6	0	0
25	7890621	.	T	C	3	3	6	0	1	7	0	0
25	8627943	.	T	C	1	5	6	0	2	8	0	0
25	8642262	.	C	T	1	6	7	0	1	8	0	0
25	12401527	.	A	G	3	4	7	0	1	8	0	0
25	12406490	.	C	T	3	2	5	0	0	5	0	0
25	12494253	.	A	C	10	11	21	0	0	21	0	0
25	12504795	.	G	A	25	11	36	0	3	39	0	0
25	12504863	.	C	T	28	18	46	0	2	48	0	0
25	12504913	.	A	T	28	20	48	0	1	49	0	0
25	12504926	.	T	G	27	18	45	0	1	46	0	0
25	12505103	.	C	T	26	11	37	0	2	39	0	0
25	12505121	.	A	G	20	0	20	0	19	39	0	0
25	12505185	.	T	C	30	12	42	0	0	42	0	0
25	12505222	.	T	C	28	16	44	0	1	45	0	0
25	12505299	.	C	T	22	21	43	0	1	44	0	0
25	12505327	.	T	C	22	19	41	0	2	43	0	0
25	12505356	.	T	G	25	17	42	0	5	47	0	0
25	12505542	.	A	G	27	0	27	0	18	45	0	0
25	12657103	.	C	T	2	2	4	0	0	4	0	0
25	12695205	.	C	G	2	0	2	0	9	11	0	0
25	12695452	.	C	T	5	1	6	0	1	7	0	0
25	12695460	.	C	T	6	2	8	0	0	8	0	0
25	12695750	.	T	A	5	5	10	0	1	11	0	0
25	12695779	.	T	C	5	8	13	0	3	16	0	0
25	12695810	.	T	A	5	10	15	0	0	15	0	0
25	12707716	.	C	T	1	10	11	0	2	13	0	0
25	12707730	.	A	G	1	12	13	0	0	13	0	0
25	12707849	.	T	C	7	0	7	0	12	19	0	0
25	12707884	.	A	G	8	9	17	0	1	18	0	0
25	12719939	.	T	A	1	3	4	0	1	5	0	0
25	12719946	.	G	T	1	3	4	0	0	4	0	0
25	12723971	.	G	A	3	4	7	0	1	8	0	0
25	12798560	.	G	A	2	4	6	0	0	6	0	0
25	12804512	.	A	T	2	3	5	0	0	5	0	0
25	12809088	.	T	A	2	2	4	0	0	4	0	0
25	12811755	.	A	G	4	10	14	0	1	15	0	0
25	12811901	.	G	A	9	14	23	0	2	25	0	0
25	12816557	.	G	A	8	4	12	0	0	12	0	0
25	12816683	.	G	A	8	8	16	0	0	16	0	0
25	12816888	.	G	A	7	5	12	0	0	12	0	0
25	12816913	.	G	A	4	4	8	0	0	8	0	0
25	12819014	.	C	A	4	3	7	0	1	8	0	0
25	12819353	.	A	G	1	3	4	0	0	4	0	0
25	12853211	.	C	T	1	3	4	0	3	7	0	0
25	12853318	.	C	A	9	23	32	0	1	33	0	0
25	12853377	.	T	C	25	2	27	0	26	53	0	0
25	12853498	.	A	C	29	16	45	0	3	48	0	0
25	12853519	.	A	G	28	21	49	0	5	54	0	0
25	12853640	.	G	A	41	12	53	0	3	56	0	0
25	12853691	.	C	T	27	24	51	0	2	53	0	0
25	12853811	.	G	A	20	5	25	0	1	26	0	0
25	12853971	.	T	A	33	16	49	0	2	51	0	0
25	12854201	.	C	T	27	12	39	1	0	40	0	0
25	12854230	.	T	G	8	17	25	2	1	28	0	0
25	12854266	.	A	T	4	22	26	2	6	34	0	0
25	12856663	.	G	A	21	9	30	0	0	30	0	0
25	12858013	.	C	T	14	15	29	0	1	30	0	0
25	12858025	.	G	T	16	13	29	0	3	32	0	0
25	12859458	.	T	C	15	25	40	0	2	42	0	0
25	12859464	.	T	C	15	1	16	0	24	40	0	0
25	12866625	.	C	T	17	15	32	0	1	33	0	0
25	12871405	.	G	A	6	10	16	0	0	16	0	0
25	12901551	.	G	A	6	4	10	1	0	11	0	0
25	12906738	.	A	G	2	3	5	0	0	5	0	0
25	12906775	.	G	T	4	4	8	0	0	8	0	0
25	12906777	.	C	A	5	3	8	0	1	9	0	0
25	12997846	.	G	T	1	2	3	0	0	3	0	0
25	13069954	.	C	T	4	2	6	0	0	6	0	0
25	13069960	.	T	G	4	2	6	0	0	6	0	0
25	13180109	.	C	A	1	2	3	0	0	3	0	0
25	13332531	.	C	T	28	35	63	0	5	68	0	0
25	13332693	.	G	A	38	37	75	1	4	80	0	0
25	13332737	.	A	G	44	28	72	1	12	85	0	0
25	13333027	.	A	G	30	24	54	2	5	61	0	0
25	13333287	.	A	G	36	32	68	0	4	72	0	0
25	13333809	.	G	A	29	29	58	1	3	62	0	0
25	13333986	.	T	A	41	26	67	0	4	71	0	0
25	13333994	.	C	T	44	30	74	0	1	75	0	0
25	13334023	.	T	A	39	29	68	0	2	70	0	0
25	13334049	.	A	T	39	32	71	0	2	73	0	0
25	13334061	.	A	G	42	28	70	0	3	73	0	0
25	13334258	.	G	T	36	10	46	0	1	47	0	0
25	13334334	.	A	T	17	14	31	0	1	33	1	0
25	13334371	.	T	C	16	19	35	0	2	37	0	0
25	13334429	.	T	C	19	27	46	0	2	48	0	0
25	13334526	.	A	G	29	19	48	0	2	50	0	0
25	13334537	.	T	C	35	1	36	0	14	50	0	0
25	13334729	.	C	T	39	33	72	0	1	73	0	0
25	13334744	.	C	T	35	31	66	0	1	67	0	0
25	13334990	.	A	T	33	31	64	0	3	67	0	0
25	13335012	.	A	G	39	25	64	0	3	67	0	0
25	13335040	.	T	C	38	0	38	0	24	62	0	0
25	13335279	.	A	G	23	26	49	0	2	51	0	0
25	13335331	.	T	C	18	37	55	0	3	58	0	0
25	13335359	.	C	T	2	36	38	0	23	61	0	0
25	13335378	.	T	C	21	28	49	0	3	52	0	0
25	13335421	.	G	T	29	23	52	0	0	52	0	0
25	13335607	.	G	T	25	23	48	0	4	52	0	0
25	13335674	.	A	T	17	19	36	0	1	37	0	0
25	13335892	.	A	G	21	15	36	0	1	37	0	0
25	13336129	.	C	A	21	21	42	0	1	43	0	0
25	13336236	.	G	T	27	16	43	0	2	45	0	0
25	13336391	.	G	A	19	37	56	0	2	58	0	0
25	13336409	.	A	C	17	39	56	0	0	56	0	0
25	13336755	.	G	T	30	21	51	0	1	52	0	0
25	13336846	.	T	C	17	22	39	0	6	45	0	0
25	13336926	.	C	T	20	16	36	0	2	38	0	0
25	13336930	.	C	T	20	16	36	0	0	36	0	0
25	13337044	.	G	A	15	11	26	1	3	30	0	0
25	13337047	.	A	G	14	11	25	1	2	28	0	0
25	13337196	.	A	G	18	15	33	0	0	33	0	0
25	13340198	.	T	C	21	0	21	0	22	43	0	0
25	13351894	.	T	A	6	12	18	0	1	19	0	0
25	13351957	.	T	C	11	9	20	0	0	20	0	0
25	13352008	.	G	A	11	6	17	0	0	17	0	0
25	13469858	.	T	C	10	7	17	0	2	19	0	0
25	13470336	.	G	T	0	5	5	1	12	18	0	0
25	13470544	.	A	T	13	12	25	0	0	25	0	0
25	13471127	.	A	G	26	0	26	0	19	45	0	0
25	13479710	.	G	A	2	3	5	0	1	6	0	0
25	13486323	.	C	T	0	3	3	0	4	7	0	0
25	13488501	.	C	T	1	2	3	0	0	3	0	0
25	13525295	.	C	G	6	6	12	0	0	12	0	0
25	13525633	.	A	C	4	2	6	0	2	8	0	0
25	13525848	.	A	T	3	4	7	0	0	7	0	0
25	13525864	.	G	A	3	6	9	0	1	10	0	0
25	13525890	.	A	C	5	5	10	0	0	10	0	0
25	13526171	.	A	C	8	11	19	0	0	19	0	0
25	13529294	.	A	G	2	2	4	0	0	4	0	0
25	13559168	.	T	G	6	7	13	0	0	13	0	0
25	13559194	.	G	A	8	9	17	1	1	19	0	0
25	13559220	.	G	A	8	10	18	1	3	22	0	0
25	13559446	.	T	A	8	11	19	0	2	21	0	0
25	13559500	.	T	C	4	4	8	0	0	8	0	0
25	13559760	.	T	C	1	0	1	0	2	3	0	0
25	13559844	.	C	T	0	2	2	0	5	7	0	0
25	13559864	.	T	C	2	5	7	0	1	8	0	0
25	13560080	.	C	T	5	3	8	0	1	9	0	0
25	13560136	.	C	T	3	3	6	0	0	6	0	0
25	13560149	.	C	T	1	3	4	0	0	4	0	0
25	13560186	.	A	G	5	4	9	0	0	9	0	0
25	13560207	.	T	C	6	5	11	0	0	11	0	0
25	13560547	.	C	T	0	3	3	0	3	6	0	0
25	13560576	.	C	T	1	3	4	0	0	4	0	0
25	13643476	.	G	A	18	12	30	0	0	30	0	0
25	13651394	.	A	T	8	3	11	0	0	11	0	0
25	13658316	.	C	T	0	7	7	0	3	10	0	0
25	13658380	.	A	C	5	4	9	0	1	10	0	0
25	13658468	.	C	T	1	2	3	0	2	5	0	0
25	13658976	.	T	C	1	0	1	0	4	5	0	0
25	13659075	.	T	A	4	2	6	0	1	7	0	0
25	13672106	.	T	A	3	3	6	0	0	6	0	0
25	13672576	.	A	G	2	2	4	0	0	4	0	0
25	13672592	.	A	G	2	2	4	0	0	4	0	0
25	13680319	.	G	A	0	2	2	0	2	4	0	0
25	13689166	.	G	A	6	2	8	0	0	8	0	0
25	13689341	.	T	C	3	2	5	0	0	5	0	0
25	13689359	.	C	A	3	3	6	0	0	6	0	0
25	13689440	.	G	A	3	2	5	0	1	6	0	0
25	13689486	.	T	C	7	0	7	0	6	13	0	0
25	13689575	.	A	G	3	5	8	0	0	8	0	0
25	13689972	.	G	A	3	3	6	0	0	6	0	0
25	13741678	.	C	T	2	2	4	0	0	4	0	0
25	13741917	.	A	G	3	2	5	0	0	5	0	0
25	13744372	.	C	T	1	2	3	0	1	4	0	0
25	13744388	.	C	A	3	2	5	0	0	5	0	0
25	13744547	.	G	T	2	2	4	0	0	4	0	0
25	13745659	.	A	G	31	27	58	0	0	58	0	0
25	13745788	.	A	C	28	2	30	0	26	56	0	0
25	13747722	.	G	C	24	2	26	0	21	47	0	0
25	13747948	.	T	C	16	2	18	0	20	38	0	0
25	13750695	.	G	A	16	11	27	0	2	29	0	0
25	13754015	.	A	G	15	9	24	0	2	26	0	0
25	13754094	.	T	A	17	10	27	0	1	29	1	0
25	13754338	.	T	G	12	9	21	0	1	22	0	0
25	13754359	.	A	G	11	6	17	0	0	17	0	0
25	13759547	.	G	A	8	8	16	0	0	16	0	0
25	13762759	.	G	C	8	6	14	0	0	14	0	0
25	13766021	.	G	T	2	2	4	0	0	4	0	0
25	13766062	.	G	A	2	2	4	0	0	4	0	0
25	13767726	.	G	A	2	2	4	0	0	4	0	0
25	13791853	.	A	C	4	3	7	0	0	7	0	0
25	13795332	.	G	A	5	13	18	0	2	20	0	0
25	13795440	.	T	C	6	12	18	0	1	19	0	0
25	13795441	.	G	A	5	12	17	0	2	19	0	0
25	13795494	.	A	G	9	12	21	0	1	22	0	0
25	13796379	.	T	C	12	9	21	0	1	22	0	0
25	13799226	.	C	T	2	3	5	0	0	5	0	0
25	13799359	.	A	C	11	15	26	0	0	26	0	0
25	13799434	.	T	C	11	23	34	0	1	35	0	0
25	13799458	.	T	C	13	19	32	0	2	34	0	0
25	13799537	.	G	C	13	6	19	0	2	21	0	0
25	13799620	.	T	A	17	7	24	0	0	24	0	0
25	13799625	.	T	G	16	7	23	0	0	23	0	0
25	13799830	.	A	G	14	17	31	0	2	33	0	0
25	13801768	.	C	A	6	6	12	0	2	14	0	0
25	13802235	.	T	A	15	7	22	0	3	25	0	0
25	13802451	.	A	G	17	11	28	0	1	29	0	0
25	13803193	.	C	G	7	11	18	0	0	18	0	0
25	13803903	.	C	T	12	11	23	0	0	23	0	0
25	13804000	.	A	C	12	1	13	0	8	21	0	0
25	13804093	.	A	G	10	9	19	0	1	20	0	0
25	13804097	.	T	A	10	9	19	0	1	20	0	0
25	13804169	.	G	T	9	13	22	0	2	24	0	0
25	13808756	.	A	G	5	7	12	0	5	17	0	0
25	13813656	.	A	G	4	9	13	0	1	14	0	0
25	13813659	.	G	A	6	9	15	0	1	16	0	0
25	13813824	.	G	T	9	5	14	0	1	15	0	0
25	13813827	.	A	G	9	4	13	0	4	17	0	0
25	13815361	.	A	G	8	8	16	0	0	16	0	0
25	13816252	.	A	G	5	2	7	0	0	7	0	0
25	13816589	.	A	G	4	3	7	0	0	7	0	0
25	13817168	.	T	A	2	3	5	0	0	5	0	0
25	13847301	.	C	T	0	13	13	0	7	20	0	0
25	13848801	.	G	A	10	8	18	0	1	19	0	0
25	13848930	.	A	G	7	16	23	0	0	23	0	0
25	14017660	.	C	T	1	2	3	0	0	3	0	0
25	14019501	.	G	T	3	8	11	0	1	12	0	0
25	14019879	.	A	T	9	13	22	0	0	22	0	0
25	14020279	.	G	A	17	8	25	0	1	26	0	0
25	14033013	.	G	C	4	10	14	0	0	14	0	0
25	14033031	.	C	A	5	2	7	0	1	8	0	0
25	14033657	.	T	C	12	12	24	0	1	25	0	0
25	14033670	.	T	G	12	14	26	0	0	26	0	0
25	14033711	.	T	A	9	8	17	0	0	17	0	0
25	14033719	.	T	C	9	0	9	0	10	19	0	0
25	14033984	.	G	T	5	3	8	0	1	9	0	0
25	14034065	.	T	C	2	4	6	0	0	6	0	0
25	14034354	.	T	G	7	8	15	0	1	16	0	0
25	14034422	.	C	T	6	4	10	0	0	10	0	0
25	14034637	.	G	A	5	4	9	0	2	11	0	0
25	14034667	.	C	T	7	3	10	0	0	10	0	0
25	14034725	.	T	A	6	3	9	0	0	9	0	0
25	14034805	.	C	G	0	2	2	0	6	8	0	0
25	14034824	.	C	T	5	2	7	0	1	8	0	0
25	14034911	.	C	G	7	3	10	0	0	10	0	0
25	14034929	.	G	A	7	3	10	0	0	10	0	0
25	14035012	.	T	G	1	5	6	0	0	6	0	0
25	14035035	.	A	T	2	5	7	0	0	7	0	0
25	14035292	.	C	T	1	3	4	0	1	5	0	0
25	14035306	.	G	A	2	5	7	0	0	7	0	0
25	14035500	.	T	C	4	3	7	0	1	8	0	0
25	14035505	.	T	C	5	2	7	0	0	7	0	0
25	14035990	.	T	C	4	0	4	0	3	7	0	0
25	14036172	.	C	A	2	2	4	0	0	4	0	0
25	14036187	.	A	T	3	2	5	0	0	5	0	0
25	14123040	.	A	C	1	2	3	0	0	3	0	0
25	14123104	.	T	C	3	2	5	0	0	5	0	0
25	14361815	.	T	C	3	2	5	0	0	5	0	0
25	14362292	.	T	A	5	4	9	0	1	10	0	0
25	14362340	.	C	T	1	4	5	0	0	5	0	0
25	14363216	.	C	T	3	5	8	0	0	8	0	0
25	14363291	.	T	A	5	4	9	0	0	9	0	0
25	14363572	.	G	T	7	3	10	0	0	10	0	0
25	14365546	.	G	A	12	17	29	0	0	29	0	0
25	14365618	.	C	T	11	12	23	0	1	24	0	0
25	14365781	.	C	T	8	6	14	0	0	14	0	0
25	14365834	.	C	T	5	7	12	0	2	14	0	0
25	14366056	.	T	A	8	6	14	0	1	15	0	0
25	14369506	.	A	G	5	2	7	0	0	7	0	0
25	14369631	.	C	T	9	18	27	0	3	30	0	0
25	14369712	.	G	A	5	24	29	0	8	37	0	0
25	14369869	.	T	A	14	5	19	0	3	22	0	0
25	14381564	.	A	G	16	14	30	0	2	32	0	0
25	14381763	.	G	A	15	20	35	0	1	36	0	0
25	14384028	.	G	T	17	20	37	0	0	37	0	0
25	14387391	.	G	A	23	9	32	1	0	33	0	0
25	14387616	.	C	T	8	19	27	0	1	28	0	0
25	14392808	.	C	G	6	6	12	0	0	12	0	0
25	14392871	.	T	C	5	2	7	0	0	7	0	0
25	14393438	.	T	C	10	0	10	0	8	18	0	0
25	14393509	.	A	G	7	9	16	0	1	17	0	0
25	14393511	.	G	A	9	6	15	0	0	15	0	0
25	14398193	.	A	T	9	3	12	0	0	12	0	0
25	14398703	.	A	C	2	3	5	0	0	5	0	0
25	14398741	.	T	C	6	5	11	0	0	11	0	0
25	14403297	.	C	T	8	3	11	0	0	11	0	0
25	14403351	.	G	T	6	6	12	0	0	12	0	0
25	14403354	.	G	T	0	4	4	0	8	12	0	0
25	14403404	.	C	T	9	5	14	0	0	14	0	0
25	14403961	.	C	T	16	6	22	0	0	22	0	0
25	14406621	.	T	C	6	11	17	0	0	17	0	0
25	14406649	.	A	T	5	8	13	0	0	13	0	0
25	14409123	.	C	T	1	1	2	0	0	2	0	0
25	14409140	.	C	T	0	3	3	0	1	4	0	0
25	14409936	.	T	C	5	0	5	0	6	11	0	0
25	14511493	.	G	T	3	3	6	0	0	6	0	0
25	14700609	.	T	C	2	3	5	0	0	5	0	0
25	14702794	.	G	C	3	2	5	0	1	6	0	0
25	14734122	.	A	G	6	5	11	0	1	12	0	0
25	14738298	.	T	C	4	4	8	0	1	9	0	0
25	14738499	.	T	G	2	3	5	0	0	5	0	0
25	14738716	.	T	C	4	5	9	0	1	10	0	0
25	14738868	.	T	C	3	5	8	0	0	8	0	0
25	15029225	.	C	T	11	7	18	0	3	21	0	0
25	15029575	.	C	T	17	10	27	0	1	28	0	0
25	15031773	.	G	A	14	4	18	0	0	18	0	0
25	15031851	.	A	G	15	7	22	0	1	23	0	0
25	15032087	.	A	G	16	10	26	0	0	26	0	0
25	15038561	.	C	T	7	7	14	0	0	14	0	0
25	15284485	.	T	C	2	2	4	0	1	5	0	0
25	15284611	.	T	C	9	4	13	0	1	14	0	0
25	15284644	.	C	G	8	0	8	0	5	13	0	0
25	15284959	.	T	C	15	10	25	0	0	25	0	0
25	15284979	.	T	A	9	13	22	0	0	22	0	0
25	15285004	.	A	C	8	13	21	0	0	21	0	0
25	15285202	.	A	C	5	12	17	0	1	18	0	0
25	15285255	.	C	A	6	15	21	0	1	22	0	0
25	15285374	.	A	G	16	18	34	0	0	34	0	0
25	15285384	.	G	A	17	19	36	0	1	37	0	0
25	15348359	.	A	G	1	2	3	0	0	3	0	0
25	15350016	.	G	A	6	3	9	0	0	9	0	0
25	15350402	.	T	G	7	11	18	0	1	19	0	0
25	15350467	.	T	C	11	5	16	0	0	16	0	0
25	15408816	.	G	A	0	5	5	0	3	8	0	0
25	15408883	.	G	A	3	4	7	0	1	8	0	0
25	15408918	.	C	T	2	3	5	0	0	5	0	0
25	15408939	.	C	T	2	3	5	0	1	6	0	0
25	15408987	.	G	T	0	4	4	0	2	6	0	0
25	15434479	.	T	A	4	5	9	0	0	9	0	0
25	15434566	.	T	C	8	5	13	0	2	15	0	0
25	15438723	.	G	A	0	3	3	0	10	13	0	0
25	15450807	.	C	G	7	10	17	2	0	19	0	0
25	15465167	.	T	C	15	5	20	0	1	21	0	0
25	15472103	.	C	T	13	16	29	0	1	30	0	0
25	15478474	.	T	C	20	30	50	0	1	51	0	0
25	15480711	.	T	C	31	25	56	0	2	58	0	0
25	15480712	.	T	C	29	23	52	0	5	57	0	0
25	15481240	.	A	G	17	26	43	0	4	47	0	0
25	15481759	.	G	A	24	15	39	0	2	41	0	0
25	15482014	.	A	T	28	10	38	0	0	39	1	0
25	15482138	.	A	G	9	0	9	0	14	23	0	0
25	15482251	.	T	C	2	2	4	1	0	5	0	0
25	15769320	.	C	G	2	3	5	0	0	5	0	0
25	15792621	.	C	T	9	8	17	0	1	18	0	0
25	15792625	.	A	G	10	9	19	0	1	20	0	0
25	15799767	.	C	A	13	18	31	0	2	33	0	0
25	15800559	.	A	G	6	0	6	0	11	18	1	0
25	15800590	.	A	G	5	3	8	0	0	8	0	0
25	15800651	.	C	A	2	2	4	0	0	4	0	0
25	15841757	.	T	C	3	5	8	0	0	8	0	0
25	15841767	.	T	C	3	4	7	0	0	7	0	0
25	15857126	.	C	G	9	10	19	0	1	20	0	0
25	15857129	.	C	T	11	11	22	0	1	23	0	0
25	15888282	.	G	T	8	14	22	0	1	23	0	0
25	15893140	.	C	T	19	13	32	0	1	33	0	0
25	15905378	.	A	G	20	0	20	0	13	33	0	0
25	15905654	.	G	A	0	10	10	0	20	30	0	0
25	16032614	.	C	A	1	2	3	0	0	3	0	0
25	16035983	.	G	T	0	3	3	0	1	4	0	0
25	16036013	.	G	A	1	4	5	0	1	6	0	0
25	16036064	.	G	A	2	2	4	0	1	5	0	0
25	16042428	.	C	A	2	1	3	0	1	4	0	0
25	16044986	.	T	A	1	2	3	0	0	3	0	0
25	16045418	.	C	G	4	2	6	0	0	6	0	0
25	16045427	.	C	G	5	2	7	0	0	7	0	0
25	16045517	.	T	C	0	6	6	0	2	8	0	0
25	16045574	.	T	C	2	4	6	0	1	7	0	0
25	16045656	.	A	G	1	0	1	0	4	5	0	0
25	16045686	.	G	C	1	2	3	0	1	4	0	0
25	16045700	.	A	G	1	3	4	0	0	4	0	0
25	16045889	.	G	T	1	4	5	0	0	5	0	0
25	16046004	.	C	T	3	5	8	0	0	8	0	0
25	16046080	.	T	C	1	3	4	0	0	4	0	0
25	16046083	.	G	A	1	3	4	0	0	4	0	0
25	16046473	.	T	G	4	6	10	0	0	10	0	0
25	16046492	.	T	G	2	10	12	0	1	13	0	0
25	16049295	.	T	G	2	2	4	0	0	4	0	0
25	17479273	.	T	C	3	0	3	0	3	6	0	0
25	17479278	.	T	C	1	6	7	0	0	7	0	0
25	17479760	.	G	A	8	9	17	0	1	18	0	0
25	17490629	.	A	G	1	2	3	0	0	3	0	0
25	17495836	.	A	C	2	0	2	0	3	5	0	0
25	17495845	.	C	T	3	3	6	0	0	6	0	0
25	17605418	.	A	C	4	3	7	0	0	7	0	0
25	17605433	.	A	G	4	0	4	0	5	9	0	0
25	17606587	.	C	T	9	7	16	0	0	16	0	0
25	17610834	.	T	C	14	6	20	0	0	20	0	0
25	17610867	.	A	G	13	0	13	0	8	21	0	0
25	17611017	.	C	T	8	9	17	0	0	17	0	0
25	17611157	.	T	A	3	2	5	0	0	5	0	0
25	17611217	.	C	A	6	4	10	0	0	10	0	0
25	17807652	.	G	A	2	6	8	0	0	8	0	0
25	17807679	.	A	T	1	3	4	0	0	4	0	0
25	17825136	.	T	C	4	2	6	0	0	6	0	0
25	17825137	.	A	C	4	1	5	0	1	6	0	0
25	17825186	.	G	A	0	5	5	0	1	6	0	0
25	17825326	.	A	T	3	1	4	0	1	5	0	0
25	17825336	.	A	G	2	2	4	0	0	4	0	0
25	17847117	.	C	T	3	6	9	0	0	9	0	0
25	17847242	.	T	C	14	6	20	0	1	21	0	0
25	17847251	.	G	T	15	7	22	0	2	24	0	0
25	17847328	.	A	G	12	0	12	0	7	19	0	0
25	17849049	.	G	A	1	8	9	0	13	22	0	0
25	17849306	.	G	C	6	7	13	0	0	13	0	0
25	17850151	.	T	G	4	2	6	0	0	6	0	0
25	17850219	.	A	G	2	0	2	0	3	5	0	0
25	17862464	.	C	A	2	2	4	0	0	4	0	0
25	17887154	.	A	G	8	14	22	0	2	24	0	0
25	17891011	.	G	A	19	9	28	0	1	29	0	0
25	17891616	.	A	T	6	2	8	0	0	8	0	0
25	17891654	.	G	A	8	6	14	0	0	14	0	0
25	17892405	.	A	T	7	16	23	0	2	25	0	0
25	17892517	.	T	G	18	14	32	0	1	33	0	0
25	17901093	.	C	T	3	13	16	0	9	25	0	0
25	17904020	.	G	A	7	9	16	0	1	17	0	0
25	17904131	.	G	A	7	10	17	0	1	18	0	0
25	17905153	.	C	T	4	7	11	0	1	12	0	0
25	17905297	.	T	C	8	3	11	0	1	12	0	0
25	17905486	.	A	G	3	5	8	0	0	8	0	0
25	17907138	.	G	A	4	3	7	0	0	7	0	0
25	17907476	.	C	A	0	4	4	0	6	10	0	0
25	17918735	.	T	C	1	6	7	0	2	9	0	0
25	17921450	.	G	A	0	3	3	0	6	9	0	0
25	17924018	.	C	T	5	7	12	0	0	12	0	0
25	17932234	.	T	C	4	3	7	0	0	7	0	0
25	17932249	.	G	A	3	2	5	0	1	6	0	0
25	17932486	.	G	A	8	2	10	0	1	11	0	0
25	17934417	.	G	A	5	6	11	0	0	11	0	0
25	17934452	.	G	A	10	11	21	0	0	21	0	0
25	17934557	.	T	A	2	3	5	0	1	6	0	0
25	17934587	.	G	C	4	3	7	0	0	9	2	0
25	17934604	.	C	A	6	2	8	0	1	9	0	0
25	17934711	.	C	T	5	13	18	0	6	24	0	0
25	17934813	.	A	G	13	6	19	0	9	28	0	0
25	17938365	.	G	A	11	8	19	1	0	20	0	0
25	17954003	.	C	T	3	2	5	0	0	5	0	0
25	17954993	.	G	A	1	3	4	0	0	4	0	0
25	17955037	.	C	T	3	4	7	0	0	7	0	0
25	17955906	.	C	T	0	3	3	0	3	6	0	0
25	17955987	.	C	T	2	4	6	0	0	6	0	0
25	17956157	.	T	C	2	0	2	0	3	5	0	0
25	17977799	.	A	T	2	2	4	0	1	5	0	0
25	17990393	.	T	A	3	3	6	0	0	6	0	0
25	18052840	.	T	C	2	2	4	0	0	4	0	0
25	18053319	.	T	G	1	3	4	0	0	4	0	0
25	18053338	.	A	G	1	2	3	0	0	3	0	0
25	18053440	.	T	A	1	2	3	0	0	3	0	0
25	18054030	.	G	C	1	4	5	0	0	5	0	0
25	18054317	.	T	C	5	5	10	0	0	10	0	0
25	18054503	.	G	C	10	4	14	0	0	14	0	0
25	18054573	.	C	A	7	8	15	0	1	16	0	0
25	18054723	.	T	C	10	11	21	0	0	21	0	0
25	18054965	.	G	T	1	3	4	0	5	9	0	0
25	18119387	.	C	A	2	3	5	0	0	5	0	0
25	18326988	.	T	G	18	17	35	0	0	35	0	0
25	18327559	.	G	A	11	5	16	0	0	16	0	0
25	18328884	.	G	C	11	0	11	0	13	24	0	0
25	18561555	.	A	G	4	0	4	0	2	6	0	0
25	18561575	.	A	T	4	3	7	0	0	7	0	0
25	18577142	.	A	G	2	3	5	0	0	5	0	0
25	18711986	.	A	G	1	1	2	0	1	3	0	0
25	18714979	.	C	T	3	2	5	0	2	7	0	0
25	18720166	.	G	A	6	3	9	0	0	9	0	0
25	18720205	.	T	A	4	3	7	0	0	7	0	0
25	18720216	.	T	C	2	4	6	0	1	7	0	0
25	18720384	.	C	T	5	5	10	0	0	10	0	0
25	18720512	.	A	G	5	6	11	0	1	12	0	0
25	18886448	.	G	A	0	3	3	0	2	5	0	0
25	18886899	.	C	A	4	2	6	0	0	6	0	0
25	18887600	.	T	G	4	3	7	0	0	7	0	0
25	18887774	.	A	G	8	3	11	0	0	11	0	0
25	18906540	.	A	G	1	2	3	0	0	3	0	0
25	18906917	.	A	G	3	3	6	1	0	7	0	0
25	18907043	.	A	T	4	2	6	0	0	6	0	0
25	18907074	.	C	T	3	2	5	0	1	6	0	0
25	18907213	.	G	A	6	2	8	0	1	9	0	0
25	18907218	.	C	T	8	3	11	0	0	11	0	0
25	18907645	.	T	A	1	4	5	0	0	5	0	0
25	18908054	.	G	C	2	2	4	0	0	4	0	0
25	18908255	.	T	C	3	5	8	0	0	8	0	0
25	18908313	.	G	A	3	4	7	1	1	9	0	0
25	18908647	.	A	G	3	2	5	1	1	7	0	0
25	18908650	.	A	G	5	0	5	1	2	8	0	0
25	18908774	.	T	C	2	4	6	0	0	6	0	0
25	18908794	.	T	A	2	2	4	0	0	4	0	0
25	18908810	.	G	A	4	2	6	0	0	6	0	0
25	18951829	.	G	A	9	9	18	0	0	18	0	0
25	18952163	.	A	G	8	7	15	0	0	15	0	0
25	18952238	.	G	A	8	5	13	0	0	13	0	0
25	18959251	.	G	A	3	4	7	0	0	7	0	0
25	18962235	.	A	G	2	3	5	0	0	5	0	0
25	18962782	.	G	T	8	6	14	0	0	14	0	0
25	18962802	.	T	C	6	6	12	0	2	14	0	0
25	18976498	.	C	T	2	5	7	0	0	7	0	0
25	18976522	.	A	G	5	0	5	0	6	11	0	0
25	18976555	.	C	T	4	5	9	0	0	9	0	0
25	18977364	.	A	G	5	3	8	0	1	9	0	0
25	18977469	.	T	A	8	7	15	0	1	17	1	0
25	19009527	.	T	C	2	3	5	0	0	5	0	0
25	19013611	.	C	T	4	3	7	0	0	7	0	0
25	19016529	.	A	G	5	0	5	0	3	8	0	0
25	19016690	.	T	C	10	12	22	0	1	23	0	0
25	19016736	.	C	T	9	13	22	0	2	24	0	0
25	19018845	.	T	C	11	9	20	0	1	21	0	0
25	19019003	.	A	T	18	8	26	0	1	27	0	0
25	19020981	.	G	A	0	20	20	1	15	36	0	0
25	19021062	.	T	C	15	13	28	0	0	28	0	0
25	19021618	.	C	A	10	11	21	0	0	21	0	0
25	19021647	.	T	G	14	0	14	1	8	23	0	0
25	19021680	.	A	G	11	12	23	1	1	25	0	0
25	19026877	.	A	C	8	9	17	1	2	20	0	0
25	19026941	.	G	A	9	5	14	1	0	15	0	0
25	19028610	.	G	A	6	6	12	0	0	12	0	0
25	19028637	.	C	T	8	4	12	0	1	13	0	0
25	19049548	.	T	C	3	0	3	0	3	6	0	0
25	19051746	.	T	C	6	0	6	0	3	9	0	0
25	19051761	.	A	G	5	4	9	0	0	9	0	0
25	19063190	.	A	G	4	2	6	0	0	6	0	0
25	19097035	.	A	T	2	4	6	0	0	6	0	0
25	19097082	.	A	T	5	3	8	0	0	8	0	0
25	19097214	.	A	C	4	2	6	0	0	6	0	0
25	19097247	.	A	G	3	5	8	0	1	9	0	0
25	19098388	.	C	T	8	7	15	0	1	16	0	0
25	19100030	.	T	A	11	11	22	0	0	22	0	0
25	19100353	.	G	T	1	2	3	0	0	3	0	0
25	19100358	.	T	C	1	2	3	0	0	3	0	0
25	19107718	.	G	A	0	4	4	0	4	8	0	0
25	19109211	.	T	G	1	4	5	0	0	5	0	0
25	19111574	.	C	T	1	4	5	0	0	5	0	0
25	19111758	.	C	T	1	3	4	0	0	4	0	0
25	19111806	.	C	T	1	3	4	0	0	4	0	0
25	19111878	.	A	G	1	3	4	0	0	4	0	0
25	19112824	.	T	C	2	8	10	0	0	10	0	0
25	19117611	.	T	C	2	3	5	0	0	5	0	0
25	19117743	.	A	G	1	0	1	0	6	7	0	0
25	19120764	.	A	G	2	2	4	0	0	4	0	0
25	19120800	.	C	T	2	3	5	0	0	5	0	0
25	19120918	.	T	C	3	3	6	0	0	6	0	0
25	19120926	.	T	C	2	3	5	0	1	6	0	0
25	19121092	.	T	C	5	4	9	0	1	10	0	0
25	19121126	.	T	C	8	1	9	0	6	15	0	0
25	19121147	.	A	G	11	10	21	0	0	21	0	0
25	19181396	.	T	C	1	5	6	0	0	6	0	0
25	19184051	.	T	C	5	5	10	0	0	10	0	0
25	19184105	.	T	G	3	0	3	0	5	8	0	0
25	19184159	.	A	C	2	5	7	0	0	7	0	0
25	19188454	.	C	T	10	9	19	0	0	19	0	0
25	19189113	.	T	G	2	4	6	0	0	6	0	0
25	19189144	.	T	C	1	4	5	0	0	5	0	0
25	19189769	.	C	T	2	2	4	0	0	4	0	0
25	19190111	.	T	C	4	7	11	0	0	11	0	0
25	19190183	.	G	A	1	6	7	0	1	8	0	0
25	19190244	.	C	A	1	5	6	0	1	7	0	0
25	19190408	.	C	T	6	3	9	0	0	9	0	0
25	19190731	.	C	T	3	2	5	1	0	6	0	0
25	19191575	.	C	T	13	12	25	0	1	26	0	0
25	19191652	.	T	G	16	0	16	0	26	42	0	0
25	19191797	.	A	C	13	19	32	0	5	37	0	0
25	19191959	.	A	T	6	7	13	0	0	13	0	0
25	19357346	.	A	C	33	34	67	0	2	69	0	0
25	19357359	.	T	G	31	30	61	0	8	69	0	0
25	19357782	.	G	C	18	15	33	0	1	34	0	0
25	19357800	.	T	C	12	19	31	0	0	31	0	0
25	19357934	.	G	A	23	19	42	0	1	43	0	0
25	19358924	.	T	A	10	5	15	0	2	17	0	0
25	19359191	.	T	C	1	5	6	0	0	6	0	0
25	19359205	.	G	A	1	7	8	0	0	8	0	0
25	19361012	.	C	T	13	4	17	0	1	18	0	0
25	19363616	.	G	A	5	11	16	0	0	16	0	0
25	19363994	.	G	C	6	0	6	0	5	11	0	0
25	19364155	.	G	A	9	3	12	0	0	12	0	0
25	19364184	.	T	A	12	4	16	0	0	16	0	0
25	19364210	.	T	G	9	10	19	0	0	19	0	0
25	19364279	.	T	A	11	6	17	0	3	20	0	0
25	19364519	.	T	A	12	6	18	0	0	18	0	0
25	19364598	.	T	G	7	4	11	0	0	11	0	0
25	19364642	.	C	T	6	5	11	0	0	11	0	0
25	19364717	.	A	G	8	7	15	0	0	15	0	0
25	19365053	.	G	A	7	7	14	0	0	14	0	0
25	19365559	.	G	A	5	6	11	0	0	11	0	0
25	19365647	.	A	G	7	3	10	0	0	10	0	0
25	19366124	.	A	G	4	2	6	0	0	6	0	0
25	19366175	.	A	T	3	4	7	0	2	9	0	0
25	19366363	.	T	C	3	2	5	0	0	5	0	0
25	19366741	.	A	C	5	4	9	0	1	10	0	0
25	19368016	.	A	T	1	3	4	0	0	4	0	0
25	19368105	.	A	G	1	4	5	0	0	5	0	0
25	19368429	.	G	A	12	4	16	0	0	16	0	0
25	19368548	.	G	T	6	11	17	0	1	18	0	0
25	19368620	.	T	A	14	7	21	0	1	22	0	0
25	19368803	.	T	C	5	3	8	0	0	8	0	0
25	19369326	.	A	G	3	2	5	0	0	5	0	0
25	19369331	.	G	A	3	2	5	0	0	5	0	0
25	19369822	.	C	T	1	3	4	0	0	4	0	0
25	19370308	.	G	C	2	3	5	0	0	5	0	0
25	19370464	.	T	C	4	4	8	0	3	11	0	0
25	19370507	.	T	C	5	6	11	0	1	12	0	0
25	19370670	.	A	T	8	5	13	0	0	13	0	0
25	19371087	.	G	A	4	2	6	0	0	6	0	0
25	19372175	.	C	T	3	3	6	0	0	6	0	0
25	19372297	.	A	G	6	6	12	0	1	13	0	0
25	19372490	.	A	T	1	2	3	0	0	3	0	0
25	19372491	.	T	G	1	2	3	0	0	3	0	0
25	19372943	.	T	G	5	7	12	0	0	12	0	0
25	19442049	.	T	C	3	3	6	0	0	6	0	0
25	19443192	.	T	C	24	17	41	0	3	44	0	0
25	19486270	.	C	T	1	9	10	0	7	17	0	0
25	19486287	.	G	T	5	6	11	0	3	14	0	0
25	19486356	.	A	C	8	0	8	0	7	15	0	0
25	19531894	.	T	A	3	2	5	0	0	5	0	0
25	19535304	.	A	G	3	0	3	0	2	5	0	0
25	19560556	.	T	C	1	2	3	0	0	3	0	0
25	19560890	.	T	C	2	4	6	0	1	7	0	0
25	19586000	.	G	C	7	8	15	0	1	16	0	0
25	19586249	.	A	T	8	6	14	0	1	15	0	0
25	19586712	.	G	A	8	10	18	0	0	18	0	0
25	19586743	.	A	G	9	6	15	0	0	15	0	0
25	19588294	.	A	G	8	4	12	0	0	12	0	0
25	19591549	.	C	T	6	3	9	0	0	9	0	0
25	19593478	.	G	A	8	2	10	0	0	10	0	0
25	19609988	.	T	C	6	3	9	0	1	10	0	0
25	19610438	.	T	C	1	2	3	0	0	3	0	0
25	19610467	.	T	C	1	2	3	0	0	3	0	0
25	19610569	.	C	T	0	4	4	0	7	11	0	0
25	19610645	.	G	A	4	2	6	0	0	6	0	0
25	19667602	.	G	C	0	6	6	0	4	10	0	0
25	19667653	.	T	C	5	3	8	0	0	8	0	0
25	19676276	.	C	A	2	5	7	0	0	7	0	0
25	19714119	.	G	A	1	5	6	0	1	7	0	0
25	19714180	.	C	T	1	2	3	0	0	3	0	0
25	19730643	.	G	T	1	3	4	0	0	4	0	0
25	19730645	.	G	T	1	3	4	0	0	4	0	0
25	19741229	.	A	G	4	5	9	0	0	9	0	0
25	19743556	.	A	T	3	2	5	0	0	5	0	0
25	19743751	.	A	G	1	4	5	0	1	6	0	0
25	19746661	.	A	G	4	0	4	0	4	8	0	0
25	19747150	.	T	C	11	9	20	0	1	21	0	0
25	19747630	.	G	A	7	8	15	0	0	15	0	0
25	19747668	.	A	T	4	6	10	0	1	11	0	0
25	19747692	.	G	A	6	5	11	0	0	11	0	0
25	19865815	.	C	T	1	2	3	0	0	3	0	0
25	19865904	.	G	T	1	2	3	0	0	3	0	0
25	19865986	.	G	C	3	2	5	1	0	6	0	0
25	19866660	.	A	G	1	0	1	0	4	5	0	0
25	19866713	.	C	T	2	3	5	0	0	5	0	0
25	19866749	.	T	A	3	3	6	0	0	6	0	0
25	19866752	.	G	T	3	3	6	0	1	7	0	0
25	19866902	.	T	C	1	1	2	0	2	4	0	0
25	19867045	.	G	C	1	4	5	0	0	5	0	0
25	19867046	.	C	T	1	4	5	0	0	5	0	0
25	19867103	.	C	T	4	5	9	0	0	9	0	0
25	19867143	.	A	G	4	0	4	0	4	8	0	0
25	19867180	.	C	T	4	3	7	0	0	7	0	0
25	19867208	.	T	C	3	2	5	0	0	5	0	0
25	19867383	.	T	C	6	4	10	0	0	10	0	0
25	19867436	.	A	T	2	2	4	0	1	5	0	0
25	19867442	.	G	A	0	3	3	0	2	5	0	0
25	19867848	.	A	G	4	0	4	0	5	9	0	0
25	19867948	.	C	T	3	2	5	0	0	5	0	0
25	19868056	.	C	T	4	2	6	0	0	6	0	0
25	19933793	.	G	A	1	3	4	0	3	7	0	0
25	19933807	.	A	C	1	4	5	0	3	8	0	0
25	19933831	.	T	G	2	1	3	0	1	4	0	0
25	19933842	.	A	T	2	2	4	0	0	4	0	0
25	19934181	.	A	G	2	2	4	0	0	4	0	0
25	19934942	.	A	G	1	0	1	0	5	6	0	0
25	19934966	.	A	G	2	0	2	0	6	8	0	0
25	19935059	.	C	G	1	5	6	0	0	6	0	0
25	19935213	.	A	C	6	12	18	0	0	18	0	0
25	19935222	.	T	A	4	10	14	0	1	15	0	0
25	19935269	.	C	T	6	7	13	1	0	14	0	0
25	19935313	.	G	A	0	5	5	1	5	11	0	0
25	19935330	.	G	A	5	5	10	1	1	12	0	0
25	19935538	.	T	C	5	8	13	0	0	13	0	0
25	19935556	.	G	A	5	3	8	2	1	11	0	0
25	19935700	.	A	G	9	6	15	1	2	18	0	0
25	19935791	.	A	G	5	0	5	0	4	9	0	0
25	19935951	.	G	A	7	9	16	0	0	16	0	0
25	19936101	.	G	A	4	7	11	0	0	11	0	0
25	19936123	.	A	G	7	6	13	0	2	15	0	0
25	19936304	.	A	T	9	15	24	0	1	25	0	0
25	19936445	.	T	G	6	0	6	2	14	22	0	0
25	19956833	.	T	C	2	3	5	0	0	5	0	0
25	20003413	.	G	C	2	12	14	1	29	44	0	0
25	20121387	.	T	C	6	14	20	0	0	20	0	0
25	20121447	.	A	G	10	0	10	0	7	17	0	0
25	20121462	.	G	A	10	10	20	0	0	20	0	0
25	20125827	.	C	T	13	12	25	0	0	25	0	0
25	20125879	.	T	A	14	9	23	0	0	23	0	0
25	20125897	.	T	C	15	13	28	0	3	31	0	0
25	20125934	.	G	T	15	11	26	0	0	26	0	0
25	20125949	.	C	T	14	10	24	0	1	25	0	0
25	20126004	.	T	A	8	13	21	0	0	21	0	0
25	20126152	.	T	C	1	5	6	1	0	7	0	0
25	20126157	.	T	A	1	4	5	1	1	7	0	0
25	20126204	.	G	T	4	6	10	0	0	10	0	0
25	20126305	.	T	A	10	3	13	0	1	14	0	0
25	20126356	.	G	A	4	2	6	0	0	6	0	0
25	20126433	.	G	A	0	7	7	0	5	12	0	0
25	20126661	.	G	T	4	2	6	0	0	6	0	0
25	20126688	.	A	T	1	5	6	0	1	7	0	0
25	20126702	.	A	G	3	3	6	0	1	7	0	0
25	20126750	.	T	A	9	3	12	0	1	13	0	0
25	20126870	.	T	G	14	10	24	0	0	24	0	0
25	20126915	.	A	G	8	3	11	0	2	13	0	0
25	20126953	.	G	A	1	4	5	0	5	10	0	0
25	20126971	.	G	T	4	4	8	0	1	9	0	0
25	20225966	.	T	C	2	2	4	0	0	4	0	0
25	20229802	.	C	T	2	20	22	0	27	49	0	0
25	20229843	.	T	C	17	1	18	0	17	35	0	0
25	20229887	.	C	A	26	22	48	0	1	50	1	0
25	20231657	.	G	A	24	17	41	0	2	43	0	0
25	20241699	.	T	A	7	4	11	0	0	11	0	0
25	20241705	.	T	G	6	4	10	0	1	11	0	0
25	20241759	.	A	G	6	8	14	0	1	15	0	0
25	20241884	.	C	T	0	7	7	0	8	15	0	0
25	20247968	.	T	C	6	4	10	0	0	10	0	0
25	20253053	.	C	T	1	7	8	0	7	15	0	0
25	20253092	.	C	T	4	5	9	0	2	11	0	0
25	20290255	.	G	A	1	2	3	0	0	3	0	0
25	20355326	.	G	C	1	5	6	0	1	7	0	0
25	20358708	.	A	T	16	15	31	0	0	31	0	0
25	20358999	.	G	A	12	10	22	0	3	25	0	0
25	20359005	.	C	A	1	10	11	0	15	26	0	0
25	20359639	.	G	A	3	3	6	0	0	6	0	0
25	20366747	.	C	T	7	6	13	0	0	13	0	0
25	20378086	.	G	A	4	3	7	0	0	7	0	0
25	20378095	.	T	C	5	2	7	0	2	9	0	0
25	20388721	.	C	T	5	5	10	0	0	10	0	0
25	20388899	.	G	A	4	3	7	0	1	8	0	0
25	20389337	.	G	A	3	2	5	0	0	5	0	0
25	20389529	.	G	A	2	2	4	0	0	4	0	0
25	20389664	.	C	T	4	2	6	0	0	6	0	0
25	20389682	.	C	T	2	2	4	0	0	4	0	0
25	20568565	.	T	C	3	2	5	0	0	5	0	0
25	20601690	.	A	T	2	3	5	0	0	5	0	0
25	20602316	.	T	A	19	14	33	0	1	34	0	0
25	20602347	.	C	T	10	15	25	0	2	27	0	0
25	20602373	.	C	T	9	14	23	0	4	27	0	0
25	20602716	.	A	G	16	7	23	0	1	24	0	0
25	20631440	.	C	T	1	4	5	0	3	8	0	0
25	20668724	.	A	G	6	5	11	0	0	11	0	0
25	20668936	.	C	T	3	6	9	0	3	12	0	0
25	20669130	.	G	T	9	4	13	0	1	14	0	0
25	20669323	.	C	T	8	2	10	0	1	11	0	0
25	20669332	.	G	A	2	8	10	0	0	10	0	0
25	20669565	.	T	C	8	3	11	0	1	12	0	0
25	20669585	.	A	C	6	5	11	0	0	11	0	0
25	20669657	.	A	G	11	7	18	0	1	19	0	0
25	20669777	.	G	T	1	6	7	0	0	7	0	0
25	20670029	.	A	G	3	2	5	0	0	5	0	0
25	20670036	.	T	C	4	3	7	0	0	7	0	0
25	20670127	.	G	A	11	6	17	0	1	18	0	0
25	20670370	.	C	T	2	4	6	0	0	6	0	0
25	20670632	.	A	T	2	3	5	0	0	5	0	0
25	20670669	.	G	A	1	4	5	0	0	5	0	0
25	20670708	.	T	C	1	2	3	0	1	4	0	0
25	20687279	.	G	A	1	2	3	0	0	3	0	0
25	20701369	.	G	A	9	6	15	0	0	15	0	0
25	20701408	.	T	C	8	12	20	0	1	21	0	0
25	20701409	.	G	A	6	12	18	0	3	21	0	0
25	20701516	.	A	G	5	1	6	0	8	14	0	0
25	20701594	.	C	A	8	9	17	0	0	17	0	0
25	20716627	.	G	A	4	2	6	0	1	7	0	0
25	20723017	.	A	C	8	8	16	0	1	17	0	0
25	20726884	.	G	T	7	4	11	0	1	12	0	0
25	20730169	.	G	A	7	3	10	0	1	11	0	0
25	20730661	.	T	C	4	3	7	0	1	8	0	0
25	20730707	.	T	A	5	4	9	0	0	9	0	0
25	20997813	.	C	T	0	3	3	0	2	5	0	0
25	20997876	.	T	G	12	3	15	1	0	16	0	0
25	20998037	.	A	G	10	5	15	0	0	15	0	0
25	20998245	.	T	C	6	4	10	0	0	10	0	0
25	20998250	.	G	T	6	3	9	0	0	9	0	0
25	20998300	.	T	A	3	3	6	0	1	7	0	0
25	20998326	.	T	C	5	0	5	0	2	7	0	0
25	20999203	.	A	G	2	2	4	0	0	4	0	0
25	21064154	.	C	T	7	4	11	0	0	11	0	0
25	21064519	.	T	A	8	3	11	0	0	11	0	0
25	21065024	.	T	C	6	5	11	0	2	13	0	0
25	21065071	.	G	A	6	6	12	0	0	12	0	0
25	21075383	.	C	T	0	3	3	0	3	6	0	0
25	21110562	.	A	T	3	2	5	0	0	5	0	0
25	21110624	.	T	C	2	3	5	0	1	6	0	0
25	21115672	.	T	C	17	17	34	0	2	36	0	0
25	21115761	.	A	G	11	25	36	0	0	36	0	0
25	21117001	.	A	T	10	11	21	0	0	21	0	0
25	21119697	.	T	C	12	0	12	0	17	29	0	0
25	21121788	.	A	G	17	14	31	0	0	31	0	0
25	21122011	.	A	G	8	12	20	0	1	21	0	0
25	21122138	.	C	G	9	10	19	0	0	19	0	0
25	21122140	.	A	G	10	10	20	0	0	20	0	0
25	21122194	.	T	C	13	11	24	0	0	24	0	0
25	21122490	.	C	T	10	9	19	0	2	21	0	0
25	21122535	.	A	T	11	12	23	0	1	24	0	0
25	21122540	.	C	A	11	11	22	0	2	24	0	0
25	21124889	.	A	T	10	7	17	0	0	17	0	0
25	21125075	.	G	A	6	13	19	1	0	20	0	0
25	21125289	.	C	G	7	14	21	0	1	22	0	0
25	21125391	.	T	C	11	10	21	0	0	21	0	0
25	21125583	.	C	T	0	2	2	0	7	9	0	0
25	21125676	.	T	A	6	4	10	0	0	10	0	0
25	21126004	.	C	T	7	2	9	0	1	10	0	0
25	21129729	.	G	A	4	3	7	0	1	8	0	0
25	21133118	.	T	C	3	0	3	0	8	11	0	0
25	21134398	.	A	T	1	2	3	0	0	3	0	0
25	21134399	.	C	T	0	2	2	0	1	3	0	0
25	21194387	.	C	T	7	6	13	1	0	14	0	0
25	21194663	.	A	T	4	11	15	0	0	15	0	0
25	21194672	.	T	C	4	7	11	0	2	13	0	0
25	21206481	.	G	A	13	5	18	0	0	18	0	0
25	21208597	.	G	A	9	5	14	0	1	15	0	0
25	21222077	.	T	C	9	11	20	0	2	22	0	0
25	21222128	.	G	A	8	13	21	0	0	21	0	0
25	21229653	.	G	A	13	14	27	0	1	28	0	0
25	21239861	.	A	G	13	12	25	0	1	26	0	0
25	21239870	.	G	A	11	11	22	0	0	22	0	0
25	21240198	.	G	A	1	5	6	0	13	19	0	0
25	21240258	.	G	A	2	15	17	0	14	31	0	0
25	21253053	.	T	C	21	26	47	0	1	48	0	0
25	21253106	.	C	T	27	17	44	0	2	46	0	0
25	21277721	.	A	G	2	5	7	0	1	8	0	0
25	21277739	.	C	T	1	5	6	0	2	9	1	0
25	21277783	.	A	G	5	6	11	0	0	11	0	0
25	21277811	.	C	T	10	4	14	0	1	15	0	0
25	21277892	.	C	A	1	8	9	1	4	14	0	0
25	21277927	.	G	T	11	7	18	0	0	18	0	0
25	21278053	.	T	A	8	3	11	0	0	11	0	0
25	21278055	.	A	G	7	2	9	0	1	10	0	0
25	21278193	.	G	A	5	3	8	0	0	8	0	0
25	21298370	.	A	C	4	0	4	0	4	8	0	0
25	21298444	.	C	T	2	2	4	0	0	4	0	0
25	21324661	.	C	T	1	1	2	0	1	3	0	0
25	21324726	.	C	A	3	2	5	0	0	5	0	0
25	21342512	.	C	T	11	3	14	0	0	14	0	0
25	21343301	.	C	T	6	7	13	0	0	13	0	0
25	21343408	.	T	C	10	9	19	0	1	20	0	0
25	21343420	.	A	T	10	8	18	0	1	19	0	0
25	21343631	.	T	A	12	9	21	0	2	23	0	0
25	21343643	.	A	G	10	0	10	0	16	26	0	0
25	21343843	.	C	T	19	12	31	0	0	31	0	0
25	21343901	.	T	C	10	28	38	0	2	40	0	0
25	21344201	.	T	G	16	23	39	0	1	40	0	0
25	21344290	.	G	T	16	14	30	0	0	30	0	0
25	21344417	.	A	G	5	11	16	0	1	17	0	0
25	21492520	.	T	C	1	0	1	0	2	3	0	0
25	21518033	.	G	T	1	2	3	0	0	3	0	0
25	21726776	.	C	T	4	2	6	0	0	6	0	0
25	21738460	.	G	A	2	3	5	0	1	6	0	0
25	21739116	.	T	C	2	5	7	0	0	7	0	0
25	21741444	.	A	G	6	4	10	0	0	10	0	0
25	21743694	.	A	G	2	0	2	0	3	5	0	0
25	21743838	.	T	G	1	3	4	0	0	4	0	0
25	21743843	.	T	G	1	2	3	0	1	4	0	0
25	21771898	.	T	G	1	2	3	0	0	3	0	0
25	21835081	.	T	C	19	17	36	0	0	36	0	0
25	21835268	.	T	C	19	14	33	0	1	34	0	0
25	21838627	.	A	T	11	23	34	0	0	34	0	0
25	21838951	.	G	A	27	13	40	0	1	41	0	0
25	21838963	.	A	G	28	14	42	0	1	43	0	0
25	21838987	.	C	T	31	10	41	0	0	41	0	0
25	21843369	.	G	T	29	31	60	0	2	62	0	0
25	21860969	.	G	T	2	3	5	0	0	5	0	0
25	21861070	.	C	T	0	5	5	0	3	8	0	0
25	22092134	.	T	A	1	2	3	0	0	3	0	0
25	22092137	.	G	A	1	2	3	0	0	3	0	0
25	22291766	.	T	C	4	6	10	0	0	10	0	0
25	22291805	.	G	A	4	5	9	0	0	9	0	0
25	22292640	.	T	A	1	3	4	0	0	4	0	0
25	22292647	.	A	G	1	0	1	0	3	4	0	0
25	22635999	.	C	A	26	13	39	1	0	40	0	0
25	22636020	.	T	A	22	11	33	1	0	34	0	0
25	22636075	.	C	A	13	11	24	0	4	28	0	0
25	22636565	.	A	T	19	22	41	0	4	45	0	0
25	22637012	.	C	T	9	10	19	0	0	19	0	0
25	22637101	.	T	C	2	10	12	0	1	13	0	0
25	22637273	.	A	G	6	14	20	0	1	21	0	0
25	22637873	.	C	A	5	6	11	0	0	11	0	0
25	22638101	.	G	A	2	2	4	0	0	4	0	0
25	22779492	.	G	A	1	4	5	0	0	5	0	0
25	22782284	.	A	C	3	3	6	0	0	6	0	0
25	22798671	.	T	C	2	6	8	0	0	8	0	0
25	22807977	.	T	C	3	5	8	0	0	8	0	0
25	22808076	.	A	G	4	3	7	0	0	7	0	0
25	22821577	.	A	G	3	0	3	0	7	10	0	0
25	22829738	.	C	T	4	2	6	0	0	6	0	0
25	22834487	.	G	A	9	10	19	0	0	19	0	0
25	22853789	.	A	T	1	2	3	0	0	3	0	0
25	22853810	.	G	A	2	2	4	0	0	4	0	0
25	22854194	.	A	T	1	2	3	0	0	3	0	0
25	22854378	.	A	C	1	5	6	0	0	6	0	0
25	22854452	.	A	C	2	5	7	0	0	7	0	0
25	22854563	.	G	A	3	2	5	0	0	5	0	0
25	22854653	.	T	C	3	5	8	0	0	8	0	0
25	22981075	.	A	C	3	4	7	0	0	7	0	0
25	22981774	.	T	C	4	2	6	0	0	6	0	0
25	23448584	.	A	G	3	0	3	0	5	8	0	0
25	23450319	.	T	A	6	4	10	0	1	11	0	0
25	23450388	.	A	G	2	2	4	0	1	5	0	0
25	23450390	.	C	A	3	2	5	0	0	5	0	0
25	23525518	.	G	T	8	5	13	0	0	13	0	0
25	23525524	.	A	T	8	5	13	0	0	13	0	0
25	23525983	.	A	C	1	0	1	0	5	6	0	0
25	23555998	.	A	T	5	9	14	0	0	14	0	0
25	23556378	.	C	G	6	13	19	0	0	19	0	0
25	23556452	.	T	C	10	7	17	1	2	21	1	0
25	23562487	.	C	T	1	5	6	0	7	13	0	0
25	23571614	.	A	G	4	2	6	0	0	6	0	0
25	23571823	.	T	C	3	3	6	0	0	6	0	0
25	23631148	.	C	T	2	4	6	0	0	6	0	0
25	23636329	.	C	T	2	4	6	0	0	6	0	0
25	23643477	.	C	T	2	3	5	0	0	5	0	0
25	23643840	.	A	C	2	2	4	0	0	4	0	0
25	23777510	.	C	A	5	6	11	0	0	11	0	0
25	23777545	.	G	A	6	7	13	0	2	15	0	0
25	23815540	.	C	T	16	9	25	0	0	25	0	0
25	24055419	.	T	C	2	0	2	0	4	6	0	0
25	24059983	.	A	G	5	3	8	0	0	8	0	0
25	24059991	.	A	G	4	3	7	0	1	8	0	0
25	24060460	.	G	A	1	2	3	0	0	3	0	0
25	24181456	.	T	C	2	4	6	0	0	6	0	0
25	24188421	.	C	T	2	2	4	0	4	8	0	0
25	24232061	.	C	A	4	3	7	0	0	7	0	0
25	24232070	.	T	G	4	3	7	0	0	7	0	0
25	24237184	.	C	T	1	5	6	0	1	7	0	0
25	24237196	.	T	C	1	6	7	0	0	7	0	0
25	24237636	.	G	A	13	13	26	0	0	26	0	0
25	24238066	.	T	G	9	15	24	0	2	26	0	0
25	24238134	.	A	C	15	1	16	0	0	16	0	0
25	24238243	.	T	C	4	3	7	0	0	7	0	0
25	24240918	.	C	T	6	11	17	0	1	18	0	0
25	24241338	.	T	G	6	8	14	0	2	16	0	0
25	24241350	.	G	A	5	9	14	0	1	15	0	0
25	24242103	.	A	G	5	11	16	0	1	17	0	0
25	24242115	.	T	C	6	11	17	0	0	17	0	0
25	24247267	.	C	G	6	9	15	0	0	15	0	0
25	24247282	.	A	C	8	9	17	0	1	18	0	0
25	24247758	.	A	C	4	0	4	0	5	9	0	0
25	24247765	.	T	C	4	5	9	0	0	9	0	0
25	24247814	.	T	C	1	3	4	0	0	4	0	0
25	24247852	.	A	G	3	5	8	0	0	8	0	0
25	24247985	.	G	A	2	6	8	0	0	8	0	0
25	24605595	.	G	T	2	4	6	0	0	6	0	0
25	24605598	.	A	C	2	4	6	0	0	6	0	0
25	24609515	.	A	G	3	2	5	0	1	6	0	0
25	24610543	.	A	T	1	5	6	0	0	6	0	0
25	24610544	.	A	G	1	4	5	0	1	6	0	0
25	24720580	.	A	G	2	3	5	0	0	5	0	0
25	24720595	.	A	G	2	0	2	0	2	4	0	0
25	24723447	.	C	T	2	2	4	0	0	4	0	0
25	24723468	.	T	C	3	2	5	0	0	5	0	0
25	24736579	.	A	T	10	18	28	0	3	31	0	0
25	24736828	.	A	T	4	11	15	0	3	18	0	0
25	24736875	.	T	G	7	13	20	0	0	20	0	0
25	24736921	.	G	A	9	10	19	0	1	20	0	0
25	24737026	.	C	T	4	5	9	0	0	9	0	0
25	24737215	.	C	T	10	3	13	0	0	13	0	0
25	24737664	.	C	A	4	5	9	0	0	9	0	0
25	24737961	.	C	T	2	3	5	0	0	5	0	0
25	24738023	.	T	C	2	0	2	0	5	7	0	0
25	24738084	.	T	C	9	0	9	0	10	19	0	0
25	24738114	.	C	G	9	9	18	0	0	18	0	0
25	24738826	.	G	A	1	3	4	0	1	5	0	0
25	24739029	.	A	G	7	6	13	0	0	13	0	0
25	24752181	.	A	G	4	5	9	0	0	9	0	0
25	24770089	.	G	A	2	6	8	0	1	9	0	0
25	25123445	.	T	C	6	4	10	0	0	10	0	0
25	25124779	.	A	T	3	4	7	0	1	8	0	0
25	25127090	.	C	T	11	17	28	0	3	31	0	0
25	25127250	.	A	G	13	11	24	0	0	24	0	0
25	25130648	.	C	T	21	20	41	0	1	42	0	0
25	25130693	.	C	T	17	26	43	0	0	43	0	0
25	25130747	.	C	T	17	22	39	0	2	41	0	0
25	25130782	.	G	A	24	22	46	0	4	50	0	0
25	25130908	.	C	T	27	15	42	1	0	43	0	0
25	25130924	.	T	C	29	18	47	1	1	49	0	0
25	25130968	.	C	T	23	24	47	0	2	49	0	0
25	25131274	.	A	G	16	12	28	0	0	28	0	0
25	25131298	.	A	T	16	21	37	0	1	38	0	0
25	25131389	.	A	T	23	20	43	0	3	46	0	0
25	25131464	.	G	A	31	29	60	0	3	63	0	0
25	25131631	.	C	T	29	24	53	0	2	60	5	0
25	25131710	.	A	G	23	23	46	0	1	47	0	0
25	25132985	.	C	T	10	7	17	0	1	18	0	0
25	25133030	.	G	A	14	8	22	0	1	23	0	0
25	25133123	.	T	G	17	12	29	0	1	30	0	0
25	25133171	.	A	G	20	14	34	0	1	35	0	0
25	25133353	.	G	A	11	11	22	0	2	24	0	0
25	25133365	.	T	A	9	11	20	0	2	22	0	0
25	25133509	.	A	G	6	5	11	0	0	11	0	0
25	25142127	.	G	A	0	2	2	0	2	4	0	0
25	25396237	.	T	C	10	13	23	0	1	24	0	0
25	25396295	.	T	C	7	15	22	0	1	23	0	0
25	25539270	.	C	A	2	4	6	0	0	6	0	0
25	25539398	.	G	A	3	4	7	0	0	7	0	0
25	25539434	.	G	A	0	2	2	0	5	7	0	0
25	25539723	.	C	A	7	4	11	0	0	11	0	0
25	25539783	.	G	C	7	6	13	0	0	13	0	0
25	25539800	.	A	G	5	7	12	0	2	14	0	0
25	25539834	.	A	T	5	8	13	0	0	13	0	0
25	25539928	.	A	G	5	1	6	0	4	10	0	0
25	25540245	.	A	G	2	5	7	0	0	7	0	0
25	25540444	.	T	C	2	5	7	0	0	7	0	0
25	25540490	.	C	T	3	5	8	0	1	9	0	0
25	25540954	.	G	A	4	6	10	0	2	12	0	0
25	25545131	.	T	C	4	7	11	0	0	11	0	0
25	25545149	.	G	C	2	7	9	0	1	10	0	0
25	25545365	.	G	C	3	8	11	0	1	12	0	0
25	25545420	.	G	A	0	2	2	0	6	8	0	0
25	25545700	.	A	T	1	2	3	0	0	3	0	0
25	25545722	.	T	C	1	3	4	0	0	4	0	0
25	25545989	.	G	C	2	6	8	0	0	8	0	0
25	25546053	.	G	A	1	5	6	0	0	6	0	0
25	25547043	.	C	A	3	2	5	0	0	5	0	0
25	25547137	.	C	A	5	3	8	0	0	8	0	0
25	25547150	.	T	A	3	2	5	0	2	7	0	0
25	25547228	.	G	A	2	6	8	0	0	8	0	0
25	25548032	.	G	T	2	3	5	0	0	5	0	0
25	25548076	.	T	A	1	3	4	0	0	4	0	0
25	25548220	.	G	C	1	3	4	0	0	4	0	0
25	25736865	.	T	C	4	0	4	0	9	13	0	0
25	25736923	.	C	G	3	11	14	0	1	15	0	0
25	25736949	.	C	T	3	9	12	0	1	13	0	0
25	25747119	.	C	A	2	2	4	0	0	4	0	0
25	25782997	.	T	C	9	6	15	0	1	16	0	0
25	26738746	.	T	C	7	3	10	0	0	10	0	0
25	26739161	.	G	T	5	4	9	0	0	9	0	0
25	26739184	.	T	C	3	3	6	0	0	6	0	0
25	26823436	.	A	T	2	5	7	0	0	7	0	0
25	26827274	.	T	C	3	5	8	0	1	9	0	0
25	26827435	.	T	C	2	7	9	0	2	11	0	0
25	26827440	.	A	G	4	7	11	0	2	13	0	0
25	26829261	.	C	T	8	12	20	0	1	21	0	0
25	26830555	.	G	A	3	4	7	0	1	8	0	0
25	26831730	.	G	C	3	2	5	0	0	5	0	0
25	26831784	.	A	G	1	4	5	0	0	5	0	0
25	26831874	.	G	A	4	4	8	0	1	9	0	0
25	26831958	.	G	A	1	3	4	0	0	4	0	0
25	26834061	.	A	T	6	2	8	0	0	8	0	0
25	26867237	.	C	A	3	1	4	0	1	5	0	0
25	26867671	.	A	T	3	2	5	0	0	5	0	0
25	26867787	.	C	T	1	5	6	0	0	6	0	0
25	26879592	.	T	C	17	19	36	0	2	38	0	0
25	26884407	.	C	T	5	8	13	0	0	13	0	0
25	26890845	.	A	G	8	5	13	0	1	14	0	0
25	26909197	.	G	A	3	2	5	0	0	5	0	0
25	26909269	.	A	G	6	3	9	0	0	9	0	0
25	26909392	.	A	T	6	7	13	0	0	13	0	0
25	26909560	.	T	C	4	6	10	0	0	10	0	0
25	26909572	.	A	G	4	0	4	0	6	10	0	0
25	26911236	.	A	C	8	6	14	0	0	14	0	0
25	26911350	.	T	A	4	2	6	0	0	6	0	0
25	26911554	.	T	A	7	6	13	0	1	14	0	0
25	26911605	.	C	A	10	4	14	0	1	15	0	0
25	26911768	.	A	G	3	4	7	0	0	7	0	0
25	26911883	.	A	G	8	12	20	0	2	22	0	0
25	27174500	.	G	A	8	6	14	0	1	15	0	0
25	27174512	.	A	G	6	0	6	0	8	14	0	0
25	27237022	.	A	G	10	6	16	0	5	21	0	0
25	27500038	.	C	A	1	2	3	0	0	3	0	0
25	27544385	.	T	C	1	2	3	0	0	3	0	0
25	27715234	.	A	G	9	10	19	0	1	20	0	0
25	27715335	.	T	G	6	6	12	0	0	12	0	0
25	27715423	.	A	T	4	5	9	0	0	9	0	0
25	27715429	.	A	G	5	6	11	0	0	11	0	0
25	27715499	.	T	A	7	5	12	0	0	12	0	0
25	27716110	.	C	A	3	4	7	0	8	15	0	0
25	27716160	.	C	T	3	9	12	0	9	21	0	0
25	27716204	.	C	A	12	11	23	0	2	25	0	0
25	27716265	.	T	C	10	5	15	0	0	15	0	0
25	27716270	.	A	T	10	3	13	0	1	14	0	0
25	27716374	.	G	A	3	9	12	0	1	13	0	0
25	27718481	.	C	T	2	3	5	0	0	5	0	0
25	27718698	.	A	G	9	3	12	0	0	12	0	0
25	27718709	.	T	C	8	5	13	0	1	14	0	0
25	27718739	.	G	A	5	6	11	0	0	11	0	0
25	27801873	.	T	G	6	0	6	0	19	25	0	0
25	27801876	.	A	C	3	0	3	0	21	24	0	0
25	29427959	.	A	C	14	4	18	1	7	26	0	0
25	29427963	.	A	C	12	6	18	1	5	24	0	0
25	29429187	.	A	G	1	16	17	0	5	22	0	0
25	29429203	.	C	A	14	3	17	0	0	17	0	0
25	29666468	.	A	T	3	3	6	2	4	12	0	0
25	30343055	.	T	A	1	2	3	3	12	18	0	0
25	33225248	.	A	G	9	15	24	0	0	24	0	0
25	33225287	.	G	A	10	13	23	0	1	24	0	0
25	33226972	.	A	G	4	9	13	0	0	13	0	0
25	33226984	.	A	G	5	9	14	0	0	14	0	0
25	33242605	.	A	T	2	8	10	0	2	12	0	0
25	33242606	.	T	G	3	5	8	0	4	12	0	0
25	33249905	.	T	G	10	23	33	0	1	34	0	0
25	33250017	.	C	A	12	6	18	0	2	20	0	0
25	33250053	.	A	G	13	7	20	0	2	22	0	0
25	33258739	.	G	A	0	4	4	0	3	7	0	0
25	33258745	.	T	G	2	0	2	0	4	7	1	0
25	33258817	.	C	T	1	3	4	0	0	4	0	0
25	33259568	.	A	G	4	0	4	0	5	9	0	0
25	33259778	.	T	C	3	4	7	0	1	8	0	0
25	33262180	.	A	G	7	7	14	0	0	14	0	0
25	33265759	.	A	G	4	3	7	0	0	7	0	0
25	33265898	.	C	T	7	4	11	0	1	12	0	0
25	33266029	.	G	A	2	15	17	0	0	17	0	0
25	33266128	.	A	G	2	1	3	0	10	13	0	0
25	33266157	.	A	C	3	13	16	0	1	17	0	0
25	33962809	.	G	A	1	2	3	0	1	4	0	0
25	33964962	.	A	G	1	1	2	0	1	3	0	0
25	33964968	.	A	G	1	2	3	0	0	3	0	0
25	33965414	.	A	T	2	3	5	0	0	5	0	0
25	33965518	.	G	T	3	3	6	0	0	6	0	0
25	33965893	.	C	T	4	1	5	0	1	6	0	0
25	33966585	.	C	G	4	0	4	0	7	11	0	0
25	33966731	.	T	C	2	4	6	0	0	6	0	0
25	33966854	.	C	T	3	6	9	0	0	9	0	0
25	33966969	.	T	A	6	5	11	0	0	11	0	0
25	33967361	.	A	G	13	7	20	0	1	21	0	0
25	33967495	.	T	C	2	5	7	0	0	7	0	0
25	33967695	.	T	C	4	3	7	0	1	8	0	0
25	33967791	.	C	T	9	6	15	0	1	16	0	0
25	33967803	.	G	A	9	5	14	0	0	14	0	0
25	33968091	.	C	T	12	9	21	0	0	21	0	0
25	33968470	.	T	A	14	6	20	0	0	20	0	0
25	33968691	.	A	G	9	23	32	0	0	32	0	0
25	33968842	.	G	C	27	15	42	0	2	44	0	0
25	33968857	.	C	T	22	17	39	0	1	40	0	0
25	33968881	.	T	A	25	15	40	0	1	41	0	0
25	33983031	.	G	A	1	2	3	0	0	3	0	0
25	33987881	.	A	G	3	2	5	0	0	5	0	0
25	33988864	.	T	G	4	2	6	0	2	8	0	0
25	33988893	.	G	A	5	2	7	0	0	7	0	0
25	33988899	.	T	C	6	1	7	0	0	7	0	0
25	33991881	.	G	T	0	4	4	0	1	5	0	0
25	34002853	.	T	C	5	6	11	0	1	12	0	0
25	34014573	.	A	G	2	4	6	0	1	7	0	0
25	34017089	.	A	G	4	2	6	0	0	6	0	0
25	34018537	.	C	T	4	3	7	0	0	7	0	0
25	34020631	.	T	A	3	5	8	0	1	9	0	0
25	34022288	.	T	C	6	14	20	0	0	20	0	0
25	34022309	.	T	C	9	14	23	0	2	25	0	0
25	34027086	.	A	T	10	5	15	0	1	16	0	0
25	34027215	.	C	A	4	9	13	0	0	13	0	0
25	34027263	.	G	T	3	9	12	0	0	12	0	0
25	34154496	.	A	T	13	10	23	0	1	24	0	0
25	34154540	.	T	G	15	15	30	0	0	30	0	0
25	34154678	.	G	A	22	19	41	0	2	43	0	0
25	34457928	.	T	C	2	2	4	0	0	4	0	0
25	34973090	.	C	A	1	2	3	0	0	3	0	0
25	35002394	.	G	A	19	29	48	1	2	51	0	0
25	35005362	.	G	A	30	15	45	1	2	48	0	0
25	35006830	.	G	A	4	25	29	0	17	46	0	0
25	35006989	.	C	T	26	23	49	0	2	51	0	0
25	35007857	.	C	T	21	21	42	0	1	43	0	0
25	35007864	.	G	A	22	20	42	0	2	44	0	0
25	35270407	.	A	G	4	4	8	0	1	9	0	0
25	35713260	.	G	A	1	3	4	0	2	6	0	0
25	35713263	.	G	C	2	3	5	0	0	5	0	0
25	35765181	.	A	G	8	12	20	0	1	21	0	0
25	35952721	.	T	A	7	2	9	0	2	11	0	0
25	36074915	.	T	C	2	2	4	0	0	4	0	0
25	37336710	.	A	G	2	7	9	0	0	9	0	0
25	37460642	.	C	T	1	7	8	0	0	8	0	0
3	158210	.	C	G	2	0	2	0	2	4	0	0
3	1096863	.	A	G	2	0	2	0	3	5	0	0
3	1101705	.	T	C	5	4	9	0	1	10	0	0
3	1101709	.	C	A	8	6	14	0	1	15	0	0
3	1101781	.	A	G	4	3	7	0	0	7	0	0
3	1101910	.	G	A	2	3	5	0	0	5	0	0
3	1101925	.	C	T	5	3	8	0	1	9	0	0
3	1105108	.	G	A	0	6	6	0	14	20	0	0
3	1105133	.	T	C	8	10	18	0	3	21	0	0
3	1105175	.	T	C	8	17	25	0	1	26	0	0
3	1105286	.	T	A	2	6	8	0	1	9	0	0
3	1105290	.	G	A	0	6	6	0	3	9	0	0
3	1105331	.	T	G	2	0	2	0	4	6	0	0
3	1105385	.	A	C	4	2	6	0	0	6	0	0
3	1105427	.	G	A	0	3	3	0	4	7	0	0
3	1105436	.	T	A	6	4	10	0	0	10	0	0
3	1105566	.	C	T	9	12	21	0	1	22	0	0
3	1105760	.	G	A	10	16	26	0	1	27	0	0
3	1105983	.	G	A	9	7	16	0	2	18	0	0
3	1105991	.	C	T	9	8	17	0	0	17	0	0
3	1106083	.	A	G	9	12	21	0	0	21	0	0
3	1106160	.	A	C	9	20	29	0	1	30	0	0
3	1106261	.	T	C	2	7	9	0	1	10	0	0
3	1113879	.	A	G	1	5	6	0	1	7	0	0
3	1118431	.	C	T	4	4	8	0	0	8	0	0
3	1122833	.	T	G	7	0	7	0	6	13	0	0
3	1123335	.	G	A	0	6	6	0	5	11	0	0
3	1123598	.	C	T	6	6	12	0	0	12	0	0
3	1123848	.	G	A	1	3	4	0	5	9	0	0
3	1123860	.	A	T	6	4	10	0	0	10	0	0
3	1126605	.	A	G	9	1	10	0	14	24	0	0
3	1126632	.	A	G	9	0	9	0	16	25	0	0
3	1129313	.	C	T	27	18	45	0	1	46	0	0
3	1129325	.	C	T	19	23	42	0	2	44	0	0
3	1129364	.	G	A	21	29	50	0	0	50	0	0
3	1129768	.	T	A	29	18	47	0	0	47	0	0
3	1129840	.	G	A	2	20	22	0	23	45	0	0
3	1130299	.	C	A	11	4	15	0	1	16	0	0
3	1130481	.	T	C	27	16	43	3	11	57	0	0
3	1130501	.	T	C	28	14	42	2	1	45	0	0
3	1130528	.	C	T	20	11	31	0	7	38	0	0
3	1130620	.	G	A	19	9	28	0	5	33	0	0
3	1130623	.	G	A	18	12	30	0	3	33	0	0
3	1130716	.	A	T	21	8	29	1	3	33	0	0
3	1130874	.	A	G	3	2	5	0	1	6	0	0
3	1133176	.	G	A	5	3	8	0	0	8	0	0
3	1133305	.	T	C	14	1	15	0	8	23	0	0
3	1133480	.	T	A	10	6	16	0	0	16	0	0
3	1133573	.	A	G	6	7	13	0	0	13	0	0
3	1133669	.	C	T	4	7	11	0	2	13	0	0
3	1133695	.	G	C	6	8	14	0	0	14	0	0
3	1133780	.	T	C	5	11	16	0	1	17	0	0
3	1133805	.	T	C	5	11	16	0	3	19	0	0
3	1133815	.	T	A	9	10	19	0	0	19	0	0
3	1133861	.	G	C	6	8	14	0	1	15	0	0
3	1133894	.	G	C	3	7	10	0	0	10	0	0
3	1133909	.	A	C	4	7	11	0	0	11	0	0
3	1134009	.	C	G	6	3	9	1	0	10	0	0
3	1134012	.	C	T	6	3	9	1	0	10	0	0
3	1135550	.	T	C	9	0	9	0	11	20	0	0
3	1135598	.	C	T	4	14	18	0	1	19	0	0
3	1141878	.	A	G	4	5	9	0	0	9	0	0
3	1141894	.	T	C	4	0	4	0	7	11	0	0
3	1142074	.	T	C	1	1	2	0	6	8	0	0
3	1142089	.	T	C	1	9	10	0	0	10	0	0
3	1150419	.	G	A	1	3	4	0	4	8	0	0
3	1150462	.	G	T	7	4	11	0	1	12	0	0
3	1150463	.	G	T	8	4	12	0	0	12	0	0
3	1155326	.	A	G	2	0	2	0	3	5	0	0
3	1167097	.	C	G	1	0	1	0	2	3	0	0
3	1178562	.	G	A	1	6	7	0	7	14	0	0
3	1178605	.	A	G	7	0	7	0	5	12	0	0
3	1179097	.	T	C	9	5	14	0	0	14	0	0
3	1179609	.	G	C	3	7	10	0	0	10	0	0
3	1187069	.	C	T	4	15	19	0	15	34	0	0
3	1187075	.	A	G	18	13	31	0	3	34	0	0
3	1187174	.	A	G	19	20	39	0	0	39	0	0
3	1187177	.	T	C	18	0	18	0	20	38	0	0
3	1191482	.	C	T	21	14	35	0	3	38	0	0
3	1191573	.	A	C	22	13	35	0	1	36	0	0
3	1191685	.	A	G	24	11	35	0	1	36	0	0
3	1191965	.	T	C	27	1	28	4	11	43	0	0
3	1191972	.	G	A	27	12	39	3	0	42	0	0
3	1192677	.	G	A	17	9	26	0	1	27	0	0
3	1192748	.	A	G	17	8	25	0	1	26	0	0
3	1195669	.	A	G	5	6	11	0	0	11	0	0
3	1196926	.	C	T	1	8	9	0	5	14	0	0
3	1196938	.	A	G	6	7	13	0	1	14	0	0
3	1197157	.	A	G	5	13	18	0	1	19	0	0
3	1197161	.	T	C	6	1	7	0	12	19	0	0
3	1209085	.	C	G	6	1	7	0	7	14	0	0
3	1211489	.	T	C	7	3	10	0	0	10	0	0
3	1211586	.	T	C	7	4	11	0	0	11	0	0
3	1211753	.	G	A	6	3	9	0	0	9	0	0
3	1211804	.	A	G	6	4	10	0	0	10	0	0
3	1211810	.	C	T	5	6	11	0	0	11	0	0
3	1212141	.	T	A	9	16	25	0	2	27	0	0
3	1215082	.	C	T	9	9	18	0	1	19	0	0
3	1215233	.	A	G	4	0	4	0	12	16	0	0
3	1218176	.	T	C	18	9	27	0	3	30	0	0
3	1220373	.	C	T	7	2	9	0	0	9	0	0
3	1220420	.	C	T	9	4	13	0	0	13	0	0
3	1220423	.	C	A	9	4	13	0	0	13	0	0
3	1220612	.	T	C	12	7	19	0	0	19	0	0
3	1220621	.	A	G	10	0	10	0	13	23	0	0
3	1223892	.	G	A	1	18	19	0	12	31	0	0
3	1226959	.	T	C	19	31	50	0	3	53	0	0
3	1227040	.	G	C	2	22	24	0	23	47	0	0
3	1227230	.	T	C	24	38	62	0	3	65	0	0
3	1230094	.	A	G	22	15	37	0	3	40	0	0
3	1260566	.	T	C	22	8	30	0	1	31	0	0
3	1260572	.	C	T	0	7	7	0	24	31	0	0
3	1261214	.	A	G	20	23	43	0	1	44	0	0
3	1262641	.	A	G	19	13	32	0	1	33	0	0
3	1263068	.	C	T	12	10	22	0	0	22	0	0
3	1263376	.	T	C	7	0	7	0	7	14	0	0
3	1263420	.	G	A	14	4	18	0	0	18	0	0
3	1263584	.	G	T	9	7	16	0	0	16	0	0
3	1263606	.	G	T	7	6	13	0	0	13	0	0
3	1263690	.	T	A	4	5	9	0	0	9	0	0
3	1264045	.	C	G	4	3	7	0	0	7	0	0
3	1264312	.	A	G	6	2	8	0	0	8	0	0
3	1264342	.	T	C	7	6	13	0	0	13	0	0
3	1264361	.	G	A	6	10	16	0	1	17	0	0
3	1264448	.	C	G	4	4	8	0	0	8	0	0
3	1264749	.	G	A	1	3	4	0	0	4	0	0
3	1264822	.	C	T	4	3	7	0	0	7	0	0
3	1265019	.	T	A	5	5	10	0	0	10	0	0
3	1265064	.	G	A	5	3	8	0	0	8	0	0
3	1267201	.	C	T	1	2	3	0	0	3	0	0
3	1267678	.	T	C	1	2	3	0	0	3	0	0
3	1267684	.	T	A	2	2	4	0	0	4	0	0
3	1304772	.	C	T	2	6	8	0	0	8	0	0
3	1323879	.	T	A	5	10	15	0	0	15	0	0
3	1323895	.	C	A	8	5	13	0	0	13	0	0
3	1324045	.	C	A	21	11	32	0	1	33	0	0
3	1324064	.	C	A	20	10	30	0	0	30	0	0
3	1324281	.	G	T	6	7	13	0	0	13	0	0
3	1324300	.	T	C	5	9	14	0	1	15	0	0
3	1324509	.	C	A	3	8	11	0	1	12	0	0
3	1324515	.	C	T	5	9	14	0	1	15	0	0
3	1324688	.	T	C	11	6	17	0	1	18	0	0
3	1339147	.	T	A	1	7	8	0	0	8	0	0
3	1339164	.	A	T	2	6	8	0	0	8	0	0
3	1386456	.	G	A	9	8	17	0	1	18	0	0
3	1388867	.	A	G	13	11	24	1	10	35	0	0
3	1395837	.	A	G	23	31	54	0	2	56	0	0
3	1395861	.	C	T	1	24	25	0	27	52	0	0
3	1395918	.	C	T	2	10	12	25	9	46	0	0
3	1397544	.	T	C	8	0	8	6	10	24	0	0
3	1397946	.	C	T	2	2	4	6	1	11	0	0
3	1408451	.	G	A	1	3	4	0	0	4	0	0
3	1415312	.	A	T	4	2	6	0	0	6	0	0
3	1497102	.	T	C	1	2	3	0	0	3	0	0
3	1499548	.	G	A	4	4	8	0	2	10	0	0
3	1499581	.	T	C	4	7	11	0	0	11	0	0
3	1499677	.	A	G	4	8	12	0	0	12	0	0
3	1500004	.	A	T	15	2	17	0	1	18	0	0
3	1500232	.	T	A	7	3	10	0	1	11	0	0
3	1500648	.	G	A	7	3	10	0	0	10	0	0
3	1500933	.	T	C	1	3	4	0	0	4	0	0
3	1501016	.	T	C	3	3	6	0	0	6	0	0
3	1501131	.	C	T	10	7	17	0	1	18	0	0
3	1511215	.	G	T	1	3	4	0	0	4	0	0
3	1511271	.	G	A	7	11	18	0	1	19	0	0
3	1515168	.	G	A	7	41	48	0	2	50	0	0
3	1520510	.	A	C	13	25	38	0	3	41	0	0
3	3622281	.	A	G	1	2	3	0	0	3	0	0
3	3626185	.	T	C	1	5	6	0	0	6	0	0
3	3630587	.	T	C	3	3	6	0	0	6	0	0
3	3634393	.	G	C	4	2	6	0	0	6	0	0
3	4502158	.	C	A	5	7	12	0	1	13	0	0
3	4502161	.	T	C	7	8	15	0	2	17	0	0
3	4504739	.	A	G	7	9	16	0	0	16	0	0
3	4504808	.	A	G	2	6	8	0	0	8	0	0
3	4506897	.	A	G	4	3	7	0	0	7	0	0
3	4506961	.	G	A	1	3	4	0	4	8	0	0
3	4508042	.	A	C	2	5	7	0	0	7	0	0
3	4508093	.	C	A	5	5	10	0	3	13	0	0
3	4508120	.	C	T	9	7	16	0	1	17	0	0
3	4511052	.	T	C	2	3	5	0	1	6	0	0
3	4514030	.	G	A	2	4	6	0	0	6	0	0
3	4530061	.	G	A	15	10	25	0	0	25	0	0
3	4530118	.	T	A	5	10	15	0	0	15	0	0
3	4644400	.	A	G	1	3	4	0	0	4	0	0
3	5010664	.	A	T	1	3	4	0	0	4	0	0
3	5019643	.	C	T	1	2	3	0	0	3	0	0
3	5019660	.	T	C	1	3	4	0	0	4	0	0
3	5019687	.	T	C	3	2	5	0	0	5	0	0
3	5019701	.	C	A	3	3	6	0	1	7	0	0
3	5019801	.	A	G	10	5	15	0	0	15	0	0
3	5019839	.	A	T	7	8	15	0	1	16	0	0
3	5021453	.	C	T	1	11	12	0	14	26	0	0
3	5027635	.	A	G	17	14	31	0	1	32	0	0
3	5029924	.	A	C	14	12	26	0	0	26	0	0
3	5029982	.	A	T	15	7	22	0	0	22	0	0
3	5053060	.	C	T	1	10	11	0	14	25	0	0
3	5053084	.	C	T	0	13	13	0	16	29	0	0
3	5053108	.	A	C	9	8	17	0	0	17	0	0
3	5053246	.	G	A	6	3	9	0	0	9	0	0
3	5053260	.	C	T	5	3	8	0	0	8	0	0
3	5053387	.	C	T	5	3	8	0	0	8	0	0
3	5053586	.	C	T	0	12	12	0	10	22	0	0
3	5053934	.	G	A	9	9	18	0	0	18	0	0
3	5054018	.	A	G	7	5	12	0	1	13	0	0
3	5056247	.	G	A	11	4	15	0	0	15	0	0
3	5056390	.	A	T	9	5	14	0	0	14	0	0
3	5062927	.	G	A	4	3	7	0	1	8	0	0
3	5063011	.	T	C	5	0	5	0	3	8	0	0
3	5063176	.	G	A	4	4	8	0	0	8	0	0
3	5130791	.	C	A	3	2	5	0	0	5	0	0
3	5130851	.	T	C	3	4	7	0	0	7	0	0
3	5134122	.	G	A	2	6	8	0	1	9	0	0
3	5134669	.	T	C	3	2	5	0	0	5	0	0
3	5139493	.	T	C	5	2	7	0	0	7	0	0
3	5141035	.	C	T	2	2	4	0	0	4	0	0
3	5141152	.	C	T	2	4	6	0	0	6	0	0
3	5143119	.	C	T	1	3	4	0	0	4	0	0
3	5145139	.	C	A	0	4	4	0	1	5	0	0
3	5145797	.	C	T	1	3	4	0	0	4	0	0
3	5265754	.	C	T	9	14	23	0	0	23	0	0
3	5267221	.	G	A	7	15	22	1	1	24	0	0
3	5267251	.	C	T	16	8	24	1	1	26	0	0
3	5270274	.	C	T	0	11	11	0	12	23	0	0
3	5623807	.	C	T	2	24	26	0	20	46	0	0
3	5624487	.	C	T	4	20	24	0	14	38	0	0
3	5624604	.	C	A	21	16	37	0	3	40	0	0
3	5627917	.	G	A	15	17	32	0	0	32	0	0
3	5633089	.	G	A	6	11	17	0	0	17	0	0
3	5719007	.	G	T	1	2	3	0	0	3	0	0
3	5778981	.	G	A	12	13	25	0	0	25	0	0
3	5779044	.	T	A	14	14	28	0	0	28	0	0
3	5779093	.	G	T	21	10	31	0	1	32	0	0
3	5782501	.	A	G	10	9	19	0	2	21	0	0
3	5782715	.	A	G	12	15	27	0	1	28	0	0
3	5792569	.	T	A	13	10	23	0	0	23	0	0
3	5812205	.	C	T	4	12	16	0	1	17	0	0
3	5812802	.	C	T	1	5	6	0	8	14	0	0
3	5814475	.	C	T	1	6	7	1	1	9	0	0
3	5814478	.	C	T	1	6	7	1	1	9	0	0
3	5823477	.	G	A	7	3	10	0	0	10	0	0
3	5823483	.	C	A	1	2	3	0	7	10	0	0
3	5829469	.	G	A	8	4	12	0	0	12	0	0
3	5829472	.	G	T	9	4	13	0	0	13	0	0
3	5886917	.	C	T	3	23	26	0	17	43	0	0
3	5887223	.	T	C	12	6	18	0	1	19	0	0
3	5887463	.	T	G	9	11	20	0	0	20	0	0
3	5887661	.	A	T	10	6	16	0	1	17	0	0
3	5887673	.	G	C	11	1	12	0	8	20	0	0
3	5887715	.	T	C	8	5	13	0	0	13	0	0
3	5887841	.	T	A	12	9	21	0	3	24	0	0
3	5887931	.	A	T	8	8	16	0	2	18	0	0
3	5888245	.	C	T	8	6	14	0	0	14	0	0
3	5888664	.	G	A	2	7	9	0	0	9	0	0
3	5888868	.	G	A	3	6	9	0	0	9	0	0
3	5889077	.	G	T	3	2	5	0	0	5	0	0
3	5890698	.	C	T	0	3	3	0	4	7	0	0
3	5906633	.	C	T	0	0	0	0	8	8	0	0
3	5906637	.	T	C	6	2	8	0	1	9	0	0
3	6380368	.	T	C	36	18	54	0	1	55	0	0
3	6417172	.	G	A	17	24	41	0	2	43	0	0
3	6444075	.	C	A	1	2	3	0	1	4	0	0
3	6454507	.	G	A	2	2	4	0	0	4	0	0
3	6466036	.	C	T	1	2	3	0	0	3	0	0
3	6474593	.	A	G	8	9	17	0	0	17	0	0
3	6477596	.	G	C	4	7	11	0	0	11	0	0
3	6491011	.	T	G	2	3	5	0	0	5	0	0
3	6491881	.	G	T	1	3	4	0	0	4	0	0
3	6491906	.	T	C	1	3	4	0	0	4	0	0
3	6608276	.	T	A	1	2	3	0	0	3	0	0
3	6608296	.	G	A	1	2	3	0	0	3	0	0
3	6659702	.	G	A	0	3	3	0	2	5	0	0
3	6664609	.	T	C	4	2	6	0	0	6	0	0
3	6665479	.	A	G	4	2	6	0	0	6	0	0
3	6665902	.	G	T	1	3	4	0	0	4	0	0
3	6665951	.	C	A	6	3	9	0	0	9	0	0
3	6665985	.	A	T	6	4	10	0	0	10	0	0
3	6666027	.	C	T	4	2	6	0	0	6	0	0
3	6666080	.	A	G	8	11	19	0	1	20	0	0
3	6666092	.	T	C	10	7	17	0	0	17	0	0
3	6666194	.	G	C	6	11	17	0	0	17	0	0
3	6666283	.	A	T	5	11	16	0	0	16	0	0
3	6666342	.	A	G	10	1	11	0	0	11	0	0
3	6666362	.	G	A	3	6	9	0	2	11	0	0
3	6667060	.	G	C	20	7	27	0	1	28	0	0
3	6667209	.	C	T	5	17	22	0	0	22	0	0
3	6667836	.	T	A	0	5	5	4	0	9	0	0
3	6667865	.	T	C	2	2	4	5	0	9	0	0
3	6667983	.	C	G	1	0	1	5	3	9	0	0
3	6669034	.	C	T	2	2	4	1	0	5	0	0
3	6721286	.	G	C	12	6	18	0	0	18	0	0
3	6721421	.	T	G	13	9	22	0	0	22	0	0
3	6721430	.	T	C	10	7	17	0	0	17	0	0
3	6721456	.	A	T	7	7	14	0	1	15	0	0
3	6721579	.	G	A	5	6	11	0	1	12	0	0
3	6721763	.	T	C	3	7	10	0	2	12	0	0
3	6721851	.	C	T	11	7	18	0	0	18	0	0
3	6721971	.	A	T	6	6	12	0	0	12	0	0
3	6722438	.	C	T	2	3	5	0	3	8	0	0
3	6722638	.	G	C	8	3	11	0	1	12	0	0
3	6722643	.	C	T	9	1	10	0	1	11	0	0
3	6722981	.	G	A	6	9	15	0	1	16	0	0
3	6722986	.	A	T	6	8	14	0	0	14	0	0
3	6723078	.	A	C	2	4	6	0	0	6	0	0
3	6725332	.	T	G	1	2	3	0	0	3	0	0
3	6726455	.	A	T	2	3	5	0	0	5	0	0
3	7008750	.	C	T	1	4	5	2	0	7	0	0
3	7008772	.	T	C	1	3	4	3	1	8	0	0
3	7106146	.	T	C	2	3	5	1	0	6	0	0
3	7112697	.	A	G	3	2	5	0	1	6	0	0
3	7112701	.	C	G	0	1	1	0	5	6	0	0
3	7113025	.	C	T	0	7	7	0	10	17	0	0
3	7113330	.	T	C	7	8	15	0	3	18	0	0
3	7113660	.	A	G	3	5	8	0	1	9	0	0
3	7113669	.	C	T	4	3	7	0	0	7	0	0
3	7113720	.	G	A	7	3	10	0	0	10	0	0
3	7113742	.	G	A	2	5	7	3	0	10	0	0
3	7113772	.	A	G	3	3	6	5	1	12	0	0
3	7113934	.	A	G	4	4	8	2	1	11	0	0
3	7124157	.	C	G	2	5	7	0	0	7	0	0
3	7124206	.	A	C	3	2	5	0	0	5	0	0
3	7124300	.	G	A	2	2	4	0	0	4	0	0
3	7124437	.	A	G	1	4	5	0	0	5	0	0
3	7133388	.	G	A	2	6	8	0	0	8	0	0
3	7133435	.	T	G	1	8	9	0	0	9	0	0
3	7134022	.	G	C	1	2	3	0	0	3	0	0
3	7141527	.	G	T	1	7	8	0	0	8	0	0
3	7142143	.	G	A	4	2	6	0	0	6	0	0
3	7155048	.	T	A	1	3	4	0	1	5	0	0
3	7155403	.	A	G	9	8	17	0	1	18	0	0
3	7155428	.	G	A	6	6	12	0	1	13	0	0
3	7155462	.	C	T	2	8	10	0	2	12	0	0
3	7155771	.	G	A	3	4	7	0	1	8	0	0
3	7170561	.	C	T	2	2	4	2	0	6	0	0
3	7276674	.	T	C	3	0	3	0	2	5	0	0
3	7276854	.	C	T	0	3	3	0	1	4	0	0
3	7277008	.	A	T	1	4	5	0	0	5	0	0
3	7509668	.	G	A	6	2	8	2	0	10	0	0
3	7638616	.	A	C	2	2	4	0	0	4	0	0
3	7654833	.	C	G	3	25	28	0	31	59	0	0
3	7654835	.	T	C	21	27	48	0	11	59	0	0
3	7655186	.	A	G	20	29	49	0	1	50	0	0
3	7655588	.	T	C	25	3	28	0	22	50	0	0
3	7655660	.	C	T	20	16	36	0	1	37	0	0
3	7655780	.	T	G	24	17	41	0	1	42	0	0
3	7655817	.	A	T	23	7	30	0	2	32	0	0
3	7655819	.	C	T	4	7	11	0	20	31	0	0
3	7655908	.	A	G	23	12	35	0	0	35	0	0
3	7801997	.	G	A	0	3	3	0	2	5	0	0
3	7818839	.	A	T	4	2	6	0	0	6	0	0
3	7818905	.	C	G	3	0	3	0	2	5	0	0
3	7818929	.	G	A	0	2	2	0	2	4	0	0
3	7823333	.	G	A	9	23	32	0	0	32	0	0
3	7833801	.	T	C	4	12	16	0	4	20	0	0
3	7833897	.	T	C	15	19	34	0	5	39	0	0
3	7833928	.	C	G	9	27	36	1	0	37	0	0
3	7833995	.	T	C	15	9	24	0	1	25	0	0
3	7839984	.	T	G	1	2	3	0	2	5	0	0
3	7840106	.	A	G	6	4	10	1	4	15	0	0
3	7853231	.	A	T	4	5	9	0	1	10	0	0
3	7853248	.	A	G	3	3	6	0	0	6	0	0
3	7853274	.	A	C	2	4	6	0	0	6	0	0
3	7853304	.	T	C	4	1	5	0	0	5	0	0
3	7853320	.	G	A	1	6	7	0	0	7	0	0
3	7853755	.	T	A	4	2	6	0	0	6	0	0
3	7853805	.	T	C	3	0	3	0	3	6	0	0
3	7853827	.	A	C	2	3	5	0	0	5	0	0
3	7853886	.	G	T	3	1	4	0	1	5	0	0
3	7853965	.	T	C	3	3	6	0	1	7	0	0
3	7854082	.	G	A	4	3	7	0	0	7	0	0
3	7854178	.	G	A	2	5	7	0	0	7	0	0
3	7870712	.	A	G	1	2	3	0	0	3	0	0
3	7870868	.	T	C	1	2	3	0	0	3	0	0
3	8080840	.	T	C	2	4	6	0	0	6	0	0
3	9421878	.	C	A	5	5	10	0	0	10	0	0
3	9422176	.	T	A	1	2	3	0	0	3	0	0
3	9593488	.	A	C	0	2	2	0	1	3	0	0
3	9593494	.	C	A	1	3	4	0	0	4	0	0
3	9595572	.	C	T	1	3	4	0	0	4	0	0
3	9609502	.	G	A	3	2	5	0	1	6	0	0
3	9611371	.	G	A	0	3	3	0	7	10	0	0
3	9616399	.	C	T	6	10	16	0	0	16	0	0
3	9624849	.	G	A	11	5	16	0	1	17	0	0
3	9624882	.	G	A	12	6	18	0	0	18	0	0
3	9625735	.	C	T	6	7	13	0	2	15	0	0
3	9626276	.	G	T	4	3	7	0	0	7	0	0
3	9626307	.	T	G	6	6	12	0	2	14	0	0
3	9626373	.	T	C	3	4	7	0	0	7	0	0
3	9639162	.	A	G	15	16	31	0	1	32	0	0
3	9640322	.	C	T	1	4	5	0	12	17	0	0
3	9640467	.	A	G	10	8	18	0	1	19	0	0
3	9640659	.	A	G	12	6	18	0	1	19	0	0
3	9641337	.	C	T	10	7	17	0	4	21	0	0
3	9641451	.	C	T	2	12	14	0	11	25	0	0
3	9644745	.	G	A	1	3	4	0	0	4	0	0
3	9650327	.	A	G	2	4	6	0	0	6	0	0
3	9650403	.	A	G	3	2	5	0	0	5	0	0
3	9650706	.	A	G	1	4	5	0	0	5	0	0
3	9654675	.	G	A	1	3	4	0	0	4	0	0
3	10163405	.	T	C	2	2	4	0	0	4	0	0
3	10163785	.	A	G	4	0	4	0	3	7	0	0
3	10163815	.	G	A	2	6	8	0	0	8	0	0
3	10163971	.	G	A	3	2	5	0	0	5	0	0
3	10164338	.	C	G	2	3	5	0	0	5	0	0
3	10536157	.	T	G	6	11	17	0	1	18	0	0
3	10536511	.	C	T	15	6	21	0	1	22	0	0
3	10551014	.	G	A	1	8	9	0	0	9	0	0
3	10559821	.	T	C	1	0	1	0	4	5	0	0
3	10559824	.	G	T	2	3	5	0	0	5	0	0
3	10561044	.	C	T	1	2	3	0	0	3	0	0
3	10561127	.	G	C	1	3	4	0	0	4	0	0
3	10567608	.	T	A	6	2	8	0	0	8	0	0
3	10576463	.	A	T	2	2	4	0	0	4	0	0
3	11073388	.	A	G	2	8	10	0	0	10	0	0
3	11073431	.	C	T	6	5	11	0	0	11	0	0
3	11073454	.	T	C	7	8	15	0	0	15	0	0
3	11073517	.	C	T	5	11	16	0	1	17	0	0
3	11074764	.	C	G	11	0	11	0	8	19	0	0
3	11075120	.	G	A	20	14	34	0	0	34	0	0
3	11075190	.	G	A	1	16	17	0	17	34	0	0
3	11075310	.	A	G	17	0	17	0	17	35	1	0
3	11075431	.	A	G	3	2	5	0	0	5	0	0
3	11564499	.	G	A	1	3	4	0	1	5	0	0
3	11564523	.	T	C	3	4	7	0	0	7	0	0
3	11564592	.	C	T	1	4	5	0	0	5	0	0
3	11585488	.	T	A	20	10	30	0	3	33	0	0
3	11585492	.	G	A	22	8	30	0	1	31	0	0
3	11585815	.	A	G	13	8	21	0	0	21	0	0
3	11585852	.	T	A	16	6	22	0	1	23	0	0
3	11585937	.	G	A	11	11	22	0	1	23	0	0
3	11586331	.	C	T	4	12	16	0	17	33	0	0
3	11586346	.	C	T	20	12	32	0	1	33	0	0
3	11586382	.	G	A	30	12	42	0	0	42	0	0
3	11586635	.	A	G	18	6	24	0	0	24	0	0
3	11586679	.	C	T	12	5	17	3	1	21	0	0
3	11586695	.	C	T	1	4	5	4	9	18	0	0
3	11615041	.	T	C	13	1	14	0	13	27	0	0
3	11615109	.	G	A	8	10	18	0	0	18	0	0
3	11615133	.	A	G	10	7	17	0	1	18	0	0
3	11615224	.	A	G	6	10	16	0	0	16	0	0
3	11624298	.	A	G	6	5	11	0	0	11	0	0
3	11781003	.	A	C	14	11	25	6	3	34	0	0
3	11781079	.	T	C	14	10	24	0	2	26	0	0
3	11781113	.	G	A	16	14	30	0	3	33	0	0
3	11784743	.	G	A	11	12	23	0	1	24	0	0
3	11797076	.	C	T	0	2	2	0	4	6	0	0
3	11934072	.	C	T	4	7	11	0	2	13	0	0
3	11937063	.	G	A	10	12	22	0	1	23	0	0
3	11937093	.	T	C	14	10	24	0	1	25	0	0
3	11937295	.	C	T	3	3	6	0	3	9	0	0
3	11937499	.	T	C	10	8	18	0	0	18	0	0
3	11941226	.	A	C	11	9	20	0	2	22	0	0
3	11947012	.	A	G	17	0	17	0	8	25	0	0
3	11947401	.	A	T	8	16	24	0	0	24	0	0
3	11947462	.	G	A	9	4	13	0	2	15	0	0
3	12203028	.	C	G	1	2	3	0	0	3	0	0
3	12345351	.	T	C	12	11	23	0	1	24	0	0
3	12345373	.	G	T	17	13	30	0	0	30	0	0
3	12349672	.	A	G	10	11	21	0	2	23	0	0
3	12586069	.	T	C	2	3	5	0	1	6	0	0
3	12586093	.	T	C	4	2	6	0	0	6	0	0
3	12586123	.	A	G	3	0	3	0	2	5	0	0
3	12672195	.	C	A	3	2	5	0	0	5	0	0
3	12678383	.	G	A	4	2	6	0	0	6	0	0
3	12678993	.	T	C	8	3	11	0	0	11	0	0
3	12681141	.	C	T	9	4	13	0	0	13	0	0
3	12681359	.	G	A	6	2	8	0	0	8	0	0
3	12689490	.	T	C	6	6	12	0	0	12	0	0
3	12689511	.	A	G	6	0	6	0	4	10	0	0
3	12691823	.	C	A	3	4	7	0	0	7	0	0
3	12692858	.	G	T	19	5	24	0	0	24	0	0
3	12692859	.	T	G	19	5	24	0	0	24	0	0
3	12698502	.	A	G	8	0	8	0	10	18	0	0
3	12698831	.	A	T	14	8	22	0	2	24	0	0
3	12698890	.	T	C	15	8	23	0	0	23	0	0
3	12698897	.	A	G	14	6	20	0	1	21	0	0
3	12698976	.	C	A	10	13	23	0	2	25	0	0
3	12699026	.	T	A	12	8	20	0	1	21	0	0
3	12699044	.	T	C	12	7	19	0	0	19	0	0
3	12699073	.	T	A	15	5	20	0	0	20	0	0
3	12699260	.	A	G	12	9	21	0	1	22	0	0
3	12699274	.	C	T	17	10	27	0	0	27	0	0
3	12699311	.	A	T	14	16	30	0	0	30	0	0
3	12699525	.	C	T	22	14	36	0	1	37	0	0
3	12699645	.	G	C	18	9	27	0	1	28	0	0
3	12699662	.	C	T	20	8	28	0	1	29	0	0
3	13424069	.	C	A	4	3	7	0	0	7	0	0
3	13424467	.	C	A	3	4	7	0	0	7	0	0
3	13424847	.	G	T	8	5	13	0	0	13	0	0
3	13424877	.	T	C	10	9	19	0	0	19	0	0
3	13424919	.	T	C	7	7	14	0	2	16	0	0
3	13424950	.	A	T	5	8	13	0	1	14	0	0
3	13424968	.	C	T	7	8	15	0	2	17	0	0
3	13424989	.	C	A	0	8	8	0	9	17	0	0
3	13426691	.	G	A	9	9	18	0	1	19	0	0
3	13426754	.	C	A	2	9	11	0	6	17	0	0
3	13430606	.	A	G	11	11	22	0	0	22	0	0
3	13431327	.	G	A	4	4	8	0	0	8	0	0
3	13432609	.	C	T	6	7	13	0	0	13	0	0
3	13434860	.	C	T	1	4	5	0	5	10	0	0
3	13434888	.	A	G	4	6	10	0	0	10	0	0
3	13434920	.	C	G	3	5	8	0	1	9	0	0
3	13434930	.	A	T	4	5	9	0	1	10	0	0
3	13437767	.	G	A	3	4	7	0	1	8	0	0
3	13441459	.	G	A	0	5	5	0	4	9	0	0
3	13445758	.	G	A	0	5	5	0	4	9	0	0
3	13445819	.	T	C	4	4	8	0	0	8	0	0
3	13445884	.	T	G	4	5	9	0	0	9	0	0
3	13446019	.	C	T	8	3	11	0	0	11	0	0
3	13447870	.	C	T	3	2	5	0	0	5	0	0
3	13453494	.	C	T	1	4	5	0	0	5	0	0
3	13453500	.	A	G	1	4	5	0	0	5	0	0
3	13488486	.	T	A	5	2	7	0	0	7	0	0
3	13524649	.	G	T	3	2	5	0	0	5	0	0
3	13524688	.	T	G	3	3	6	0	0	6	0	0
3	13525976	.	C	G	4	4	8	0	0	8	0	0
3	13534291	.	C	T	0	4	4	0	1	5	0	0
3	13534311	.	G	C	1	2	3	0	0	3	0	0
3	13541879	.	C	T	0	3	3	0	2	5	0	0
3	13542252	.	C	T	2	3	5	0	0	5	0	0
3	13582031	.	A	T	2	2	4	0	0	4	0	0
3	13582156	.	T	C	15	7	22	1	0	23	0	0
3	13582181	.	G	A	15	10	25	0	1	26	0	0
3	13582217	.	G	T	17	13	30	0	1	31	0	0
3	13582220	.	A	T	16	12	28	0	4	32	0	0
3	13582288	.	A	T	19	14	33	0	3	36	0	0
3	13582295	.	T	A	14	17	31	0	3	34	0	0
3	13582547	.	C	G	3	14	17	0	5	22	0	0
3	13589391	.	G	T	9	8	17	0	0	17	0	0
3	13589412	.	G	A	10	8	18	0	1	19	0	0
3	13589469	.	A	G	9	13	22	0	2	24	0	0
3	13593605	.	C	T	6	8	14	0	1	15	0	0
3	13595100	.	A	G	2	3	5	0	0	5	0	0
3	13595686	.	C	T	8	6	14	0	0	14	0	0
3	13599436	.	A	G	6	4	10	0	0	10	0	0
3	13609168	.	T	A	1	1	2	0	1	3	0	0
3	13618203	.	A	T	4	4	8	0	1	9	0	0
3	13860363	.	G	A	13	11	24	0	3	27	0	0
3	14580598	.	A	C	3	2	5	0	0	5	0	0
3	14580728	.	G	A	2	2	4	0	0	4	0	0
3	14580746	.	G	A	3	2	5	0	0	5	0	0
3	14598409	.	C	T	2	2	4	0	0	4	0	0
3	14605750	.	T	C	1	7	8	0	0	8	0	0
3	14692201	.	T	C	17	22	39	0	1	40	0	0
3	14692204	.	T	C	17	0	17	0	21	38	0	0
3	14694835	.	G	A	16	15	31	0	0	31	0	0
3	14860158	.	C	T	3	3	6	0	0	6	0	0
3	15020506	.	C	T	2	4	6	0	1	7	0	0
3	15020548	.	T	A	2	3	5	0	3	8	0	0
3	15020572	.	C	T	1	3	4	0	1	5	0	0
3	15041021	.	C	T	3	2	5	0	2	7	0	0
3	15041084	.	T	C	9	4	13	0	0	13	0	0
3	15057214	.	G	T	6	3	9	0	1	10	0	0
3	15057538	.	C	T	5	4	9	0	0	9	0	0
3	15057549	.	T	G	5	4	9	0	1	10	0	0
3	15058323	.	A	G	3	2	5	0	1	6	0	0
3	15085528	.	C	T	8	8	16	0	1	17	0	0
3	15085530	.	G	T	7	9	16	0	0	16	0	0
3	15085669	.	A	G	16	12	28	0	2	30	0	0
3	15085821	.	C	T	9	11	20	0	3	23	0	0
3	15091183	.	C	T	0	6	6	0	4	10	0	0
3	15091201	.	A	G	5	6	11	0	0	11	0	0
3	15095987	.	A	G	7	3	10	0	0	10	0	0
3	15110967	.	T	C	1	2	3	0	0	3	0	0
3	15113378	.	A	G	2	2	4	0	0	4	0	0
3	15114793	.	G	A	1	2	3	0	0	3	0	0
3	15115138	.	G	A	3	3	6	0	0	6	0	0
3	15134493	.	T	C	2	2	4	0	0	4	0	0
3	15134894	.	T	A	10	5	15	0	0	15	0	0
3	15137023	.	C	T	6	7	13	0	2	15	0	0
3	15137045	.	A	G	9	9	18	0	0	18	0	0
3	15193773	.	T	A	7	10	17	0	3	20	0	0
3	15198701	.	A	G	15	14	29	0	1	30	0	0
3	15203329	.	C	A	20	12	32	0	4	36	0	0
3	15203371	.	A	C	13	18	31	0	4	35	0	0
3	15203388	.	T	G	23	13	36	0	2	38	0	0
3	15203935	.	C	T	9	9	18	0	1	19	0	0
3	15203977	.	G	A	12	12	24	0	0	24	0	0
3	15207876	.	T	A	12	3	15	1	0	16	0	0
3	15214252	.	A	C	8	13	21	0	3	24	0	0
3	15214300	.	T	A	11	7	18	0	1	19	0	0
3	15214462	.	C	A	6	11	17	0	2	19	0	0
3	15214475	.	T	A	6	12	18	0	0	18	0	0
3	15214683	.	C	T	8	3	11	0	1	12	0	0
3	15215101	.	T	A	1	5	6	0	0	6	0	0
3	15217246	.	A	G	10	9	19	0	0	19	0	0
3	15217255	.	C	T	10	9	19	0	0	19	0	0
3	15223921	.	G	A	1	5	6	0	0	6	0	0
3	15232447	.	A	G	30	20	50	0	1	51	0	0
3	15232481	.	G	A	21	20	41	0	2	43	0	0
3	15232498	.	G	A	17	17	34	1	0	35	0	0
3	15242201	.	C	T	0	6	6	0	16	22	0	0
3	15245973	.	C	T	7	9	16	0	0	16	0	0
3	15246060	.	T	C	11	6	17	0	0	17	0	0
3	15246871	.	C	T	8	4	12	0	0	12	0	0
3	15274280	.	G	A	0	4	4	0	4	8	0	0
3	15274320	.	G	A	4	3	7	0	2	9	0	0
3	15274649	.	G	A	0	5	5	0	11	16	0	0
3	15274691	.	T	C	11	4	15	0	0	15	0	0
3	15278931	.	A	G	10	0	10	0	8	18	0	0
3	15279045	.	C	G	10	8	18	0	2	20	0	0
3	15282328	.	C	T	12	14	26	0	0	26	0	0
3	15284041	.	C	T	9	8	17	0	1	18	0	0
3	15284047	.	C	T	9	9	18	0	0	18	0	0
3	15284513	.	C	A	3	8	11	1	28	41	1	0
3	15284604	.	G	A	1	6	7	0	15	22	0	0
3	15332476	.	C	A	21	17	38	0	0	38	0	0
3	15332538	.	C	G	20	20	40	0	4	44	0	0
3	15332641	.	C	T	20	17	37	1	0	38	0	0
3	15562804	.	G	A	1	3	4	0	6	10	0	0
3	15562834	.	A	C	3	3	6	0	0	6	0	0
3	15591107	.	C	T	3	3	6	0	0	6	0	0
3	15599576	.	A	G	3	0	3	0	2	5	0	0
3	15607970	.	T	G	6	6	12	0	0	12	0	0
3	15608000	.	C	A	8	5	13	0	0	13	0	0
3	15627502	.	G	A	4	5	9	0	0	9	0	0
3	15627806	.	G	C	15	7	22	0	0	22	0	0
3	15628782	.	G	A	1	3	4	0	0	4	0	0
3	15637713	.	T	A	8	5	13	0	1	14	0	0
3	15637716	.	C	G	5	7	12	0	1	13	0	0
3	15642367	.	C	T	4	7	11	0	0	11	0	0
3	15642384	.	T	C	4	7	11	0	0	11	0	0
3	15642539	.	C	T	1	5	6	0	0	6	0	0
3	15642812	.	T	A	2	3	5	0	0	5	0	0
3	15646974	.	T	A	7	7	14	0	0	14	0	0
3	15647784	.	G	A	2	3	5	0	0	5	0	0
3	15648759	.	T	C	2	2	4	0	0	4	0	0
3	15648767	.	C	T	1	2	3	0	0	3	0	0
3	15648886	.	C	T	1	3	4	0	0	4	0	0
3	15649094	.	T	C	1	3	4	0	0	4	0	0
3	15649096	.	G	A	1	3	4	0	0	4	0	0
3	15649731	.	C	T	1	6	7	0	0	7	0	0
3	15670246	.	C	T	2	4	6	0	0	6	0	0
3	15670351	.	G	T	3	2	5	0	0	5	0	0
3	15670364	.	A	C	1	3	4	0	1	5	0	0
3	15670639	.	T	C	4	2	6	0	0	6	0	0
3	15670746	.	A	G	5	6	11	0	0	11	0	0
3	15670769	.	C	T	1	3	4	0	3	7	0	0
3	15670854	.	C	A	3	2	5	0	0	5	0	0
3	15671574	.	A	G	0	3	3	0	0	3	0	0
3	15671578	.	A	T	2	2	4	0	0	4	0	0
3	15741954	.	C	T	6	5	11	0	1	12	0	0
3	15744752	.	A	G	12	0	12	0	14	26	0	0
3	15744895	.	G	A	17	15	32	0	0	32	0	0
3	15746427	.	T	A	16	14	30	0	0	30	0	0
3	15746488	.	T	C	11	14	25	0	1	26	0	0
3	15746518	.	G	T	10	18	28	0	0	28	0	0
3	15746612	.	G	A	18	19	37	0	3	40	0	0
3	15746613	.	T	C	17	23	40	0	0	40	0	0
3	15746701	.	C	T	16	9	25	0	2	27	0	0
3	15746884	.	G	T	8	25	33	0	0	33	0	0
3	15746937	.	A	T	5	8	13	0	0	13	0	0
3	15746938	.	C	T	4	8	12	0	0	12	0	0
3	15776377	.	G	A	1	3	4	1	0	5	0	0
3	15776603	.	T	A	2	2	4	0	0	4	0	0
3	15794907	.	C	G	3	0	3	0	3	6	0	0
3	15795090	.	C	T	7	6	13	0	1	14	0	0
3	15795192	.	A	G	7	9	16	0	0	16	0	0
3	15818992	.	T	C	3	3	6	0	0	6	0	0
3	15821653	.	C	T	7	5	12	1	0	13	0	0
3	15821763	.	C	T	4	4	8	0	1	9	0	0
3	15821919	.	C	T	3	4	7	0	0	7	0	0
3	15822193	.	A	T	2	3	5	0	0	5	0	0
3	15822260	.	G	A	0	2	2	0	2	4	0	0
3	15822354	.	A	G	1	0	1	0	4	5	0	0
3	15822491	.	A	T	1	2	3	0	1	4	0	0
3	15822542	.	A	T	1	3	4	0	3	7	0	0
3	15822628	.	A	T	4	3	7	0	1	8	0	0
3	15822668	.	T	C	6	4	10	0	1	11	0	0
3	15822706	.	A	T	7	5	12	0	1	13	0	0
3	15822721	.	T	C	6	4	10	0	0	10	0	0
3	15822758	.	T	C	6	3	9	0	0	9	0	0
3	15823137	.	G	C	11	3	14	0	0	14	0	0
3	15823252	.	T	A	15	5	20	0	0	20	0	0
3	15823267	.	C	A	6	9	15	0	0	15	0	0
3	15823373	.	C	A	8	5	13	0	1	14	0	0
3	15823578	.	T	A	13	6	19	0	0	19	0	0
3	15823695	.	C	T	19	8	27	0	1	28	0	0
3	15823701	.	T	C	22	5	27	0	1	28	0	0
3	15823857	.	T	A	12	17	29	0	1	30	0	0
3	15823858	.	C	T	12	18	30	0	0	30	0	0
3	15835605	.	A	C	18	13	31	0	0	31	0	0
3	15835616	.	G	A	2	16	18	0	13	31	0	0
3	15835777	.	G	A	3	19	22	0	13	35	0	0
3	15852739	.	T	A	6	6	12	0	1	13	0	0
3	15862581	.	A	T	13	15	28	0	2	30	0	0
3	15862687	.	G	A	14	14	28	0	0	28	0	0
3	15862895	.	G	A	13	6	19	0	0	19	0	0
3	15863398	.	G	C	11	7	18	0	0	18	0	0
3	15867593	.	G	A	4	9	13	0	2	15	0	0
3	15868504	.	C	T	7	6	13	0	2	15	0	0
3	15873653	.	A	G	1	3	4	0	0	4	0	0
3	15876085	.	T	A	3	5	8	0	0	8	0	0
3	15878957	.	A	G	1	3	4	0	0	4	0	0
3	15882141	.	A	G	1	1	2	0	1	3	0	0
3	15900668	.	A	C	3	4	7	1	1	9	0	0
3	15900764	.	C	T	2	2	4	0	0	4	0	0
3	15901147	.	A	T	5	2	7	0	0	7	0	0
3	15901187	.	A	G	2	0	2	0	3	5	0	0
3	15901291	.	C	T	1	2	3	0	9	12	0	0
3	15901481	.	C	T	5	8	13	0	1	14	0	0
3	15902013	.	A	C	12	16	28	0	2	30	0	0
3	15907421	.	T	C	2	5	7	0	1	8	0	0
3	15907523	.	T	G	3	4	7	0	0	7	0	0
3	15907610	.	T	G	2	3	5	0	0	5	0	0
3	15907619	.	C	T	2	2	4	0	0	4	0	0
3	15921020	.	A	G	1	3	4	0	0	4	0	0
3	15921045	.	T	C	1	4	5	0	1	6	0	0
3	15921089	.	T	C	3	3	6	0	0	6	0	0
3	15957830	.	T	G	12	0	12	0	8	20	0	0
3	15957896	.	T	C	14	7	21	0	0	21	0	0
3	15957962	.	T	C	6	8	14	0	1	15	0	0
3	15969632	.	A	C	10	12	22	0	0	22	0	0
3	15974017	.	A	T	11	13	24	0	1	25	0	0
3	15986073	.	G	A	1	21	22	0	24	46	0	0
3	15988337	.	A	G	25	13	38	8	2	48	0	0
3	15990607	.	C	T	1	10	11	0	1	12	0	0
3	15990688	.	C	A	7	7	14	0	0	14	0	0
3	15990698	.	A	G	7	4	11	0	1	12	0	0
3	15990797	.	C	T	6	11	17	0	0	17	0	0
3	15990891	.	G	A	4	5	9	0	0	9	0	0
3	15990929	.	A	T	5	3	8	0	1	9	0	0
3	15991141	.	C	T	1	6	7	1	2	10	0	0
3	15994064	.	C	T	2	5	7	0	1	8	0	0
3	15996759	.	G	T	2	9	11	0	1	12	0	0
3	16003208	.	T	C	3	8	11	0	0	11	0	0
3	16003276	.	T	A	8	10	18	0	1	19	0	0
3	16003282	.	A	T	10	10	20	0	1	21	0	0
3	16003331	.	T	A	8	16	24	0	2	26	0	0
3	16004015	.	G	A	18	17	35	0	0	35	0	0
3	16004240	.	G	A	14	13	27	0	1	28	0	0
3	16018463	.	A	T	9	5	14	0	1	15	0	0
3	16018813	.	G	A	2	2	4	0	0	4	0	0
3	16019165	.	C	A	10	5	15	0	1	16	0	0
3	16019256	.	A	T	2	3	5	0	0	5	0	0
3	16020526	.	T	A	2	2	4	0	0	4	0	0
3	16021208	.	G	A	1	2	3	0	0	3	0	0
3	16021210	.	T	G	1	2	3	0	0	3	0	0
3	16021397	.	C	T	1	6	7	0	0	7	0	0
3	16021491	.	T	C	1	3	4	1	0	5	0	0
3	16045215	.	G	A	12	15	27	0	3	30	0	0
3	16045404	.	A	C	26	41	67	1	5	73	0	0
3	16045544	.	A	G	34	33	67	1	5	73	0	0
3	16045569	.	C	G	40	33	73	2	1	76	0	0
3	16045592	.	T	A	41	28	69	1	3	73	0	0
3	16064902	.	T	A	6	1	7	0	0	7	0	0
3	16068159	.	T	G	21	17	38	1	1	40	0	0
3	16073274	.	A	T	21	20	41	0	1	42	0	0
3	16073434	.	A	C	14	0	14	1	18	33	0	0
3	16073453	.	G	A	13	21	34	1	1	36	0	0
3	16073481	.	C	T	14	23	37	0	2	39	0	0
3	16073547	.	C	T	22	14	36	0	3	39	0	0
3	16073594	.	C	T	4	20	24	0	22	46	0	0
3	16073991	.	G	A	22	23	45	0	1	46	0	0
3	16074016	.	T	A	23	22	45	0	2	47	0	0
3	16074031	.	G	A	23	20	43	0	1	44	0	0
3	16074141	.	G	T	28	15	43	0	2	45	0	0
3	16074155	.	G	A	24	15	39	1	1	41	0	0
3	16074340	.	C	G	13	20	33	0	1	34	0	0
3	16074376	.	C	T	1	16	17	0	15	32	0	0
3	16138950	.	C	G	4	7	11	0	0	11	0	0
3	16141709	.	A	T	2	3	5	0	0	5	0	0
3	16157220	.	T	G	1	2	3	0	0	3	0	0
3	16157243	.	T	A	2	4	6	0	0	6	0	0
3	16157328	.	G	T	2	10	12	0	0	12	0	0
3	16161653	.	G	T	1	2	3	0	0	3	0	0
3	16241695	.	A	G	5	4	9	0	0	9	0	0
3	16241699	.	C	A	4	4	8	0	1	9	0	0
3	16283989	.	G	T	3	4	7	0	0	7	0	0
3	16389180	.	G	T	6	9	15	0	0	15	0	0
3	16389230	.	C	T	13	7	20	0	1	21	0	0
3	16389517	.	C	T	16	7	23	0	2	25	0	0
3	16391695	.	G	A	5	6	11	0	0	11	0	0
3	16391719	.	T	C	3	0	3	0	8	11	0	0
3	16397627	.	A	T	1	2	3	0	2	5	0	0
3	16404204	.	T	C	2	2	4	0	0	4	0	0
3	16456909	.	G	A	1	2	3	0	0	3	0	0
3	16457404	.	A	G	1	6	7	0	0	7	0	0
3	16457412	.	C	G	2	7	9	0	1	10	0	0
3	16457532	.	G	A	3	5	8	0	0	8	0	0
3	16473242	.	C	T	1	2	3	0	0	3	0	0
3	16522493	.	G	A	1	2	3	0	0	3	0	0
3	16637877	.	G	A	4	2	6	0	0	6	0	0
3	16638069	.	C	T	1	4	5	0	1	6	0	0
3	16644899	.	G	T	0	8	8	0	4	12	0	0
3	16645507	.	A	C	9	7	16	0	2	18	0	0
3	16646520	.	A	G	7	3	10	0	1	11	0	0
3	16646562	.	T	C	3	8	11	0	2	13	0	0
3	16664476	.	T	C	2	6	8	0	0	8	0	0
3	16668671	.	C	T	5	4	9	0	0	9	0	0
3	16670880	.	T	G	4	0	4	0	5	9	0	0
3	16671831	.	A	G	9	0	9	0	8	17	0	0
3	16671849	.	A	G	10	0	10	0	5	15	0	0
3	16678830	.	C	T	5	6	11	0	0	11	0	0
3	16679136	.	C	T	10	7	17	0	1	18	0	0
3	16679171	.	T	G	12	9	21	0	0	21	0	0
3	16679172	.	G	T	13	9	22	0	0	22	0	0
3	16679238	.	C	T	10	6	16	0	0	16	0	0
3	16679248	.	C	T	9	4	13	0	0	13	0	0
3	16679349	.	G	A	8	5	13	0	0	13	0	0
3	16679520	.	G	A	6	9	15	0	1	16	0	0
3	16679556	.	G	A	0	11	11	0	6	17	0	0
3	16679561	.	A	G	6	0	6	0	11	17	0	0
3	16679708	.	A	G	5	2	7	0	1	8	0	0
3	16692232	.	A	G	4	2	6	0	1	7	0	0
3	16694188	.	G	C	2	0	2	0	4	6	0	0
3	16731938	.	A	G	2	0	2	0	4	6	0	0
3	16746036	.	T	C	13	15	28	0	0	28	0	0
3	16746153	.	A	C	16	17	33	0	1	34	0	0
3	16746659	.	A	T	4	3	7	0	0	7	0	0
3	16746666	.	T	C	3	3	6	0	0	6	0	0
3	16746756	.	G	A	3	3	6	0	0	6	0	0
3	16746782	.	A	G	2	6	8	0	0	8	0	0
3	16746849	.	C	A	10	17	27	0	0	27	0	0
3	16746871	.	T	G	10	15	25	0	0	25	0	0
3	16747148	.	T	C	16	18	34	0	2	36	0	0
3	16872084	.	A	G	2	3	5	0	0	5	0	0
3	16872200	.	C	T	5	2	7	0	0	7	0	0
3	16872453	.	A	T	3	3	6	0	0	6	0	0
3	16872493	.	T	C	4	4	8	0	0	8	0	0
3	16872572	.	T	C	5	7	12	0	2	14	0	0
3	16872584	.	G	A	0	8	8	0	5	13	0	0
3	16872634	.	A	G	1	4	5	0	1	6	0	0
3	16972863	.	G	T	4	2	6	0	0	6	0	0
3	16972991	.	T	C	5	6	11	0	0	11	0	0
3	17104220	.	T	C	2	2	4	0	0	4	0	0
3	17602332	.	A	C	3	4	7	0	1	8	0	0
3	17634816	.	T	C	8	9	17	0	3	20	0	0
3	17640544	.	C	T	16	6	22	0	1	23	0	0
3	17647236	.	T	C	8	10	18	0	4	22	0	0
3	17650732	.	A	G	19	28	47	0	6	53	0	0
3	17650927	.	C	G	16	15	31	0	0	31	0	0
3	17651072	.	A	G	22	0	22	0	22	44	0	0
3	17651382	.	C	T	10	11	21	0	2	23	0	0
3	17651718	.	C	T	31	17	48	0	2	50	0	0
3	17651837	.	C	T	14	15	29	0	2	31	0	0
3	17660084	.	A	G	1	2	3	0	0	3	0	0
3	17853488	.	C	T	1	6	7	0	1	8	0	0
3	17859877	.	A	C	1	0	1	0	5	6	0	0
3	17867440	.	T	C	15	8	23	0	0	23	0	0
3	17867668	.	T	A	12	11	23	0	2	25	0	0
3	17867683	.	T	A	12	10	22	0	0	22	0	0
3	17867716	.	C	A	7	11	18	0	0	18	0	0
3	17867784	.	T	C	9	3	12	1	0	13	0	0
3	17867961	.	T	C	13	14	27	0	2	29	0	0
3	17868231	.	T	C	4	8	12	0	0	12	0	0
3	17868540	.	T	C	6	0	6	0	7	13	0	0
3	17868585	.	G	A	4	4	8	0	0	8	0	0
3	17868586	.	T	C	4	4	8	0	0	8	0	0
3	17894416	.	A	G	3	5	8	0	1	9	0	0
3	17896956	.	T	C	6	3	9	0	0	9	0	0
3	17897723	.	T	C	5	3	8	0	1	9	0	0
3	17899820	.	A	G	7	0	7	0	12	19	0	0
3	17902600	.	C	T	14	10	24	0	0	24	0	0
3	17907520	.	C	T	14	14	28	0	1	29	0	0
3	17907545	.	T	C	13	13	26	0	2	28	0	0
3	17907626	.	T	C	17	16	33	0	0	33	0	0
3	17907741	.	A	T	19	13	32	0	7	39	0	0
3	17907801	.	T	A	22	14	36	0	0	36	0	0
3	17907812	.	T	C	17	12	29	0	3	32	0	0
3	17907861	.	G	T	17	17	34	0	2	36	0	0
3	17907907	.	T	C	23	16	39	0	3	42	0	0
3	17907976	.	G	A	3	15	18	0	17	35	0	0
3	17908002	.	A	G	23	14	37	0	1	38	0	0
3	17908034	.	G	T	24	18	42	0	1	43	0	0
3	17908730	.	T	C	20	24	44	0	2	46	0	0
3	17928048	.	T	C	1	2	3	0	0	3	0	0
3	17928070	.	C	G	2	2	4	0	0	4	0	0
3	17940057	.	G	C	1	2	3	0	1	4	0	0
3	17940184	.	G	A	0	3	3	0	1	4	0	0
3	17940289	.	T	G	0	2	2	0	1	3	0	0
3	17941047	.	T	C	7	2	9	0	0	9	0	0
3	17942432	.	C	T	3	2	5	0	0	5	0	0
3	17942468	.	G	A	0	3	3	0	3	6	0	0
3	17942471	.	C	T	3	3	6	0	0	6	0	0
3	17942627	.	C	A	6	2	8	0	0	8	0	0
3	17942948	.	G	C	3	2	5	0	0	5	0	0
3	17943523	.	G	T	1	11	12	0	0	12	0	0
3	17943529	.	C	A	1	11	12	0	0	12	0	0
3	17943567	.	C	A	3	9	12	0	0	12	0	0
3	17943679	.	C	T	11	4	15	0	0	15	0	0
3	17944149	.	A	G	7	13	20	0	1	21	0	0
3	17986376	.	A	C	1	3	4	0	0	4	0	0
3	17991465	.	C	T	1	2	3	0	0	3	0	0
3	17991468	.	A	G	1	0	1	0	2	3	0	0
3	17993540	.	G	A	3	3	6	0	0	6	0	0
3	17993892	.	C	T	1	4	5	0	0	5	0	0
3	17995833	.	G	A	4	2	6	0	0	6	0	0
3	17995860	.	T	C	2	3	5	0	0	5	0	0
3	17996133	.	T	C	3	3	6	0	0	6	0	0
3	17999665	.	T	G	6	6	12	0	1	13	0	0
3	17999722	.	C	A	8	2	10	0	0	10	0	0
3	17999728	.	C	T	6	2	8	0	2	10	0	0
3	17999773	.	T	C	8	7	15	0	0	15	0	0
3	18002989	.	T	G	12	14	26	0	1	27	0	0
3	18004984	.	T	C	21	10	31	0	0	31	0	0
3	18004987	.	C	T	20	10	30	0	0	30	0	0
3	18006423	.	T	C	15	20	35	0	4	39	0	0
3	18007841	.	A	G	5	8	13	0	3	16	0	0
3	18007946	.	T	G	21	18	39	0	1	40	0	0
3	18008040	.	C	G	15	25	40	0	0	40	0	0
3	18008083	.	T	C	13	21	34	0	2	36	0	0
3	18008095	.	A	T	14	24	38	0	0	38	0	0
3	18008273	.	T	A	13	16	29	1	2	32	0	0
3	18008351	.	C	G	18	29	47	0	1	48	0	0
3	18008510	.	T	C	25	19	44	1	0	45	0	0
3	18008564	.	A	G	25	20	45	0	5	50	0	0
3	18008642	.	G	C	20	19	39	0	0	39	0	0
3	18008833	.	C	A	7	5	12	0	2	14	0	0
3	18059698	.	G	A	5	3	8	0	0	8	0	0
3	18061548	.	A	G	1	2	3	0	0	3	0	0
3	18063189	.	G	A	0	2	2	0	1	3	0	0
3	18066006	.	T	C	1	3	4	0	0	4	0	0
3	18069821	.	C	T	2	4	6	0	0	6	0	0
3	18070082	.	T	C	1	6	7	0	0	7	0	0
3	18079296	.	G	A	2	8	10	0	2	12	0	0
3	18079331	.	C	G	5	10	15	0	0	15	0	0
3	18079754	.	T	C	5	8	13	0	0	13	0	0
3	18079787	.	C	T	4	6	10	0	0	10	0	0
3	18080208	.	G	A	10	7	17	0	0	17	0	0
3	18186295	.	C	T	0	20	20	0	17	37	0	0
3	18189151	.	C	A	14	13	27	0	2	29	0	0
3	18189250	.	A	T	9	10	19	0	0	19	0	0
3	18376403	.	A	T	8	18	26	0	3	29	0	0
3	18376408	.	A	T	8	21	29	0	1	30	0	0
3	18377514	.	T	C	2	8	10	1	0	11	0	0
3	18839017	.	C	T	3	3	6	0	2	8	0	0
3	19717541	.	G	T	0	37	37	0	3	41	1	0
3	20108790	.	T	C	16	16	32	3	1	36	0	0
3	21140872	.	T	C	3	3	6	0	0	6	0	0
3	21889268	.	A	G	1	2	3	0	0	3	0	0
3	22153116	.	C	T	5	6	11	0	0	11	0	0
3	22153849	.	A	G	1	5	6	0	1	7	0	0
3	22153850	.	A	G	2	3	5	0	2	7	0	0
3	22153885	.	A	G	1	4	5	0	0	5	0	0
3	22153944	.	T	G	3	0	3	0	2	5	0	0
3	22154051	.	A	G	3	4	7	0	2	9	0	0
3	22154078	.	A	G	9	3	12	0	0	12	0	0
3	22154174	.	A	G	6	3	9	0	0	9	0	0
3	22154368	.	A	G	5	6	11	0	1	12	0	0
3	22154554	.	A	G	18	5	23	0	1	24	0	0
3	22154555	.	A	G	19	5	24	0	0	24	0	0
3	22154745	.	C	T	4	9	13	0	2	15	0	0
3	22158243	.	T	A	31	21	52	0	5	57	0	0
3	22158364	.	T	C	20	18	38	0	2	40	0	0
3	22158414	.	G	A	28	24	52	0	1	53	0	0
3	22158416	.	G	C	25	26	51	0	0	51	0	0
3	22158489	.	G	A	26	30	56	0	3	59	0	0
3	22158904	.	A	T	31	27	58	1	0	59	0	0
3	22159081	.	T	C	29	33	62	0	1	63	0	0
3	22159520	.	T	G	13	20	33	1	0	34	0	0
3	22159525	.	A	T	11	19	30	1	1	32	0	0
3	22159569	.	A	G	16	11	27	2	2	31	0	0
3	22159697	.	A	G	6	25	31	1	0	32	0	0
3	22159797	.	G	A	4	6	10	0	0	10	0	0
3	22159943	.	C	T	3	4	7	0	0	7	0	0
3	22160007	.	G	A	13	8	21	0	3	24	0	0
3	22160131	.	C	G	6	5	11	0	0	11	0	0
3	22160436	.	A	C	12	12	24	0	4	28	0	0
3	22160706	.	T	A	6	5	11	0	0	11	0	0
3	22160767	.	G	T	4	7	11	0	2	16	3	0
3	22160779	.	C	T	4	10	14	0	0	14	0	0
3	22160888	.	A	T	4	4	8	0	2	10	0	0
3	22160947	.	C	A	2	3	5	0	0	6	1	0
3	22161153	.	A	G	5	5	10	0	0	10	0	0
3	22161317	.	C	T	1	3	4	0	6	10	0	0
3	22161366	.	G	A	5	9	14	0	0	14	0	0
3	22161389	.	T	A	5	9	14	0	0	14	0	0
3	22161588	.	C	T	10	3	13	0	0	13	0	0
3	22168615	.	C	T	2	8	10	0	0	10	0	0
3	22172837	.	G	A	3	3	6	0	0	6	0	0
3	22191042	.	T	C	4	2	6	0	0	6	0	0
3	22191044	.	C	A	4	2	6	0	0	6	0	0
3	22213993	.	T	A	4	2	6	0	0	6	0	0
3	22432213	.	G	T	6	21	27	0	1	28	0	0
3	22547182	.	A	G	4	4	8	0	0	8	0	0
3	22547227	.	C	T	1	3	4	0	1	5	0	0
3	22548052	.	G	A	7	4	11	0	0	11	0	0
3	22548094	.	A	G	7	2	9	0	1	10	0	0
3	22548095	.	G	T	7	3	10	0	0	10	0	0
3	22548177	.	G	T	1	4	5	0	0	5	0	0
3	22548388	.	G	A	4	7	11	0	1	12	0	0
3	22548666	.	C	G	10	5	15	0	0	15	0	0
3	22548677	.	C	T	9	4	13	0	2	15	0	0
3	22548903	.	A	C	12	18	30	0	0	30	0	0
3	22548928	.	T	A	8	16	24	0	0	24	0	0
3	22783277	.	A	G	1	2	3	0	0	3	0	0
3	22783298	.	G	A	1	2	3	0	0	3	0	0
3	22789725	.	G	T	3	2	5	0	0	5	0	0
3	22811835	.	G	A	1	7	8	0	4	12	0	0
3	22812753	.	A	G	9	1	10	0	6	16	0	0
3	22812759	.	C	A	11	5	16	0	2	18	0	0
3	22813052	.	G	A	3	8	11	0	11	22	0	0
3	22813515	.	T	A	10	10	20	0	0	21	1	0
3	22813563	.	G	T	10	11	21	0	0	21	0	0
3	22813569	.	T	G	9	11	20	0	0	20	0	0
3	22813628	.	C	A	9	12	21	0	2	23	0	0
3	22813629	.	T	A	9	14	23	0	0	23	0	0
3	22813778	.	C	T	9	5	14	0	2	16	0	0
3	22813998	.	T	G	6	3	9	0	0	9	0	0
3	22814109	.	G	A	10	16	26	0	1	27	0	0
3	22814147	.	G	A	0	18	18	0	12	30	0	0
3	22814209	.	T	C	19	14	33	0	2	35	0	0
3	22814230	.	A	G	19	0	19	0	17	36	0	0
3	22814453	.	A	G	9	18	27	0	4	31	0	0
3	22814478	.	A	G	11	18	29	0	5	34	0	0
3	22814546	.	G	A	13	22	35	1	1	37	0	0
3	22815296	.	C	A	1	4	5	0	0	5	0	0
3	22815994	.	C	T	1	7	8	0	11	19	0	0
3	22816030	.	A	G	11	3	14	0	0	14	0	0
3	22816166	.	T	C	8	4	12	0	0	12	0	0
3	22816167	.	G	A	7	4	11	0	1	12	0	0
3	22816586	.	G	A	11	5	16	0	3	19	0	0
3	22816616	.	T	A	11	5	16	0	0	16	0	0
3	22816652	.	A	G	7	4	11	0	1	12	0	0
3	22816676	.	T	C	8	4	12	0	0	12	0	0
3	22816989	.	C	T	6	4	10	1	0	11	0	0
3	22993279	.	A	C	6	2	8	0	2	10	0	0
3	22993542	.	G	A	5	3	8	0	0	8	0	0
3	22993614	.	C	T	3	4	7	0	0	7	0	0
3	22994078	.	G	T	4	11	15	0	14	29	0	0
3	22994318	.	A	G	8	0	8	0	8	16	0	0
3	22994344	.	G	T	0	6	6	0	4	10	0	0
3	23020496	.	A	G	2	2	4	0	0	4	0	0
3	23020537	.	T	C	1	2	3	0	0	3	0	0
3	23092841	.	C	A	1	3	4	0	0	4	0	0
3	23095945	.	A	G	2	4	6	0	0	6	0	0
3	23236054	.	C	T	1	4	5	0	0	5	0	0
3	24203767	.	A	G	1	5	6	0	0	6	0	0
3	25282644	.	C	A	8	2	10	0	1	11	0	0
3	25379041	.	G	A	6	2	8	0	1	9	0	0
3	26157623	.	T	C	2	3	5	0	0	5	0	0
3	26351448	.	A	G	9	19	28	0	0	28	0	0
3	27767288	.	A	G	7	8	15	0	0	15	0	0
3	27831725	.	A	G	2	0	2	0	3	5	0	0
3	27833093	.	T	C	19	8	27	0	0	27	0	0
3	27834134	.	T	C	12	4	16	0	2	18	0	0
3	27834305	.	T	C	12	7	19	0	1	20	0	0
3	27834412	.	T	C	11	11	22	0	0	22	0	0
3	27836036	.	T	C	2	3	5	0	1	6	0	0
3	28068210	.	T	G	5	0	5	0	17	22	0	0
3	28594831	.	T	C	1	3	4	0	0	4	0	0
3	28626340	.	A	C	1	7	8	0	0	8	0	0
3	28627044	.	T	A	7	6	13	0	0	13	0	0
3	28634549	.	A	G	9	14	23	0	0	23	0	0
3	28634883	.	C	A	10	6	16	1	6	23	0	0
3	28634884	.	A	C	9	6	15	1	6	22	0	0
3	28635106	.	G	A	5	10	15	0	2	17	0	0
3	28640608	.	C	T	0	2	2	0	5	7	0	0
3	28640734	.	G	A	5	5	10	0	0	10	0	0
3	28719103	.	G	A	8	5	13	0	3	16	0	0
3	28719506	.	C	G	9	5	14	0	2	16	0	0
3	28719592	.	T	G	12	6	18	0	0	18	0	0
3	28719636	.	T	A	8	6	14	0	1	15	0	0
3	28719649	.	C	T	9	7	16	0	0	16	0	0
3	28719730	.	G	T	9	6	15	0	1	16	0	0
3	28719852	.	T	C	6	8	14	0	0	14	0	0
3	28719878	.	G	A	8	9	17	0	0	17	0	0
3	28719905	.	C	A	0	7	7	0	5	12	0	0
3	28719971	.	C	A	1	6	7	0	0	7	0	0
3	28720010	.	G	A	1	2	3	0	0	3	0	0
3	28750223	.	G	T	1	2	3	0	0	3	0	0
3	29950927	.	T	C	6	9	15	0	2	17	0	0
3	29951384	.	T	C	8	8	16	0	2	18	0	0
3	30073092	.	A	T	5	0	5	0	10	15	0	0
3	30868853	.	T	G	5	4	9	0	0	9	0	0
3	30868855	.	T	C	4	4	8	0	0	8	0	0
3	30869205	.	A	G	6	6	12	0	0	12	0	0
3	30869206	.	C	T	6	6	12	0	1	13	0	0
3	30869662	.	C	T	4	2	6	0	0	6	0	0
3	30869728	.	C	T	0	5	5	0	3	8	0	0
3	30869938	.	A	G	1	2	3	0	0	3	0	0
3	30870382	.	T	G	2	3	5	0	0	5	0	0
3	30870409	.	G	A	3	2	5	0	0	5	0	0
3	30870508	.	G	A	2	3	5	0	0	5	0	0
3	30870670	.	G	A	1	2	3	0	0	3	0	0
3	30890630	.	T	A	9	11	20	0	1	21	0	0
3	30890869	.	G	A	19	12	31	0	2	33	0	0
3	30891201	.	A	G	17	12	29	0	2	31	0	0
3	30926689	.	A	G	5	3	8	0	0	8	0	0
3	31043650	.	G	A	4	2	6	0	0	6	0	0
3	31043733	.	A	C	1	2	3	0	0	3	0	0
3	31043800	.	T	C	2	1	3	0	1	4	0	0
3	31044205	.	A	G	2	3	5	0	0	5	0	0
3	31044431	.	C	T	5	4	9	0	0	9	0	0
3	31044493	.	A	C	2	3	5	0	0	5	0	0
3	31044579	.	A	G	6	8	14	0	0	14	0	0
3	31044649	.	T	C	6	3	9	0	0	9	0	0
3	31044916	.	G	C	2	2	4	0	0	4	0	0
3	31044923	.	A	G	2	2	4	0	0	4	0	0
3	31045098	.	G	A	1	2	3	0	0	3	0	0
3	31045407	.	C	A	0	2	2	0	1	3	0	0
3	31045415	.	A	T	1	2	3	0	0	3	0	0
3	31050126	.	T	A	1	1	2	0	1	3	0	0
3	31060219	.	A	G	4	0	4	0	5	9	0	0
3	31060366	.	C	T	3	4	7	0	0	7	0	0
3	31063319	.	A	G	4	3	7	0	0	7	0	0
3	31063625	.	A	T	1	3	4	0	1	5	0	0
3	31066143	.	C	G	5	3	8	0	0	8	0	0
3	31066637	.	G	A	1	2	3	0	1	4	0	0
3	31069634	.	T	C	16	14	30	1	3	34	0	0
3	31070892	.	A	G	10	18	28	0	3	31	0	0
3	31080994	.	G	A	8	7	15	0	0	15	0	0
3	31081017	.	T	C	8	5	13	0	0	13	0	0
3	31082995	.	T	A	1	3	4	0	0	4	0	0
3	31090471	.	A	G	1	2	3	0	0	3	0	0
3	31090477	.	A	G	1	1	2	0	1	3	0	0
3	31104355	.	G	A	11	3	14	0	1	15	0	0
3	31104943	.	C	T	2	5	7	0	1	8	0	0
3	31104969	.	G	A	12	4	16	0	0	16	0	0
3	31105259	.	A	C	24	30	54	0	2	56	0	0
3	31120249	.	C	T	23	18	41	0	0	41	0	0
3	31122581	.	T	G	9	10	19	0	1	20	0	0
3	31135832	.	T	C	1	0	1	0	3	4	0	0
3	31135898	.	T	C	1	0	1	0	4	5	0	0
3	31137926	.	T	C	1	2	3	0	0	3	0	0
3	31138225	.	A	G	2	2	4	0	0	4	0	0
3	31187564	.	C	G	5	3	8	0	0	8	0	0
3	31187608	.	C	T	3	2	5	0	0	5	0	0
3	31217897	.	G	A	1	2	3	0	0	3	0	0
3	31217933	.	A	T	2	2	4	0	0	4	0	0
3	31217942	.	T	A	2	2	4	0	0	4	0	0
3	31396679	.	A	G	2	2	4	0	0	4	0	0
3	31396826	.	T	C	2	3	5	1	0	6	0	0
3	31603925	.	A	G	3	2	5	0	1	6	0	0
3	31603976	.	G	A	3	3	6	0	0	6	0	0
3	31604133	.	T	C	1	3	4	0	0	4	0	0
3	31604834	.	A	T	3	5	8	0	2	10	0	0
3	31706607	.	C	A	12	13	25	0	1	26	0	0
3	31706966	.	T	C	7	5	12	0	1	13	0	0
3	31709010	.	C	T	13	14	27	0	0	27	0	0
3	31709079	.	G	A	20	12	32	0	4	36	0	0
3	31711526	.	T	C	3	7	10	0	0	10	0	0
3	31712328	.	G	T	4	2	6	0	0	6	0	0
3	31722101	.	A	T	11	21	32	0	0	32	0	0
3	31722342	.	A	G	21	24	45	0	1	46	0	0
3	31725824	.	C	T	22	14	36	0	1	37	0	0
3	31726066	.	T	C	23	16	39	1	0	40	0	0
3	31726395	.	G	A	1	5	6	0	3	9	0	0
3	31726541	.	A	T	10	9	19	0	2	21	0	0
3	31726829	.	C	T	11	19	30	0	1	31	0	0
3	31729087	.	T	G	1	2	3	0	0	3	0	0
3	31729328	.	A	G	2	3	5	0	0	5	0	0
3	31792683	.	G	T	12	7	19	0	0	19	0	0
3	31792856	.	G	A	13	5	18	0	0	18	0	0
3	31793080	.	C	T	5	7	12	0	1	13	0	0
3	31793515	.	T	G	2	7	9	0	0	9	0	0
3	31793557	.	A	G	3	2	5	0	0	5	0	0
3	31797749	.	A	G	2	3	5	0	0	5	0	0
3	31874969	.	G	T	3	2	5	0	0	5	0	0
3	31879513	.	T	A	10	5	15	0	0	15	0	0
3	31879626	.	G	A	6	8	14	0	1	15	0	0
3	31879725	.	T	A	13	7	20	1	1	22	0	0
3	31879726	.	C	A	12	7	19	1	2	22	0	0
3	31879880	.	G	T	12	9	21	0	1	22	0	0
3	31879911	.	T	C	10	11	21	0	2	23	0	0
3	31880184	.	C	G	0	6	6	0	5	11	0	0
3	31880641	.	C	T	2	8	10	0	10	20	0	0
3	31884001	.	A	G	3	2	5	0	0	5	0	0
3	31884321	.	C	T	0	3	3	0	4	7	0	0
3	31890010	.	T	C	1	2	3	0	0	3	0	0
3	31897070	.	A	G	1	2	3	0	0	3	0	0
3	31916624	.	T	G	6	2	8	2	11	21	0	0
3	31916701	.	A	T	8	7	15	0	0	15	0	0
3	31916724	.	A	G	11	11	22	0	0	22	0	0
3	31916787	.	G	T	17	13	30	0	3	33	0	0
3	31916863	.	T	C	18	12	30	0	0	30	0	0
3	31917075	.	T	G	6	1	7	0	10	17	0	0
3	31917279	.	G	T	6	4	10	0	0	10	0	0
3	31922838	.	G	C	5	5	10	0	0	10	0	0
3	31926052	.	C	A	6	12	18	0	0	18	0	0
3	31939272	.	A	G	9	5	14	0	0	14	0	0
3	31939473	.	G	T	0	16	16	0	12	28	0	0
3	31939566	.	C	A	10	13	23	0	2	25	0	0
3	31941152	.	C	T	13	16	29	0	1	30	0	0
3	31944357	.	A	T	12	10	22	3	0	25	0	0
3	32098130	.	G	A	0	5	5	0	5	10	0	0
3	32098194	.	C	T	1	3	4	1	0	5	0	0
3	32098379	.	A	G	4	6	10	0	1	11	0	0
3	32099841	.	A	G	29	0	29	0	22	51	0	0
3	32100183	.	G	T	20	10	30	20	1	51	0	0
3	32100206	.	T	C	12	5	17	31	0	48	0	0
3	32100755	.	T	C	26	13	39	17	1	57	0	0
3	32105746	.	C	A	10	7	17	0	1	18	0	0
3	32120187	.	A	T	3	3	6	8	0	14	0	0
3	32139671	.	G	A	4	6	10	0	1	11	0	0
3	32139701	.	C	G	5	5	10	0	1	11	0	0
3	32157262	.	C	G	1	2	3	0	0	3	0	0
3	32169545	.	G	A	1	9	10	1	2	13	0	0
3	32169677	.	C	T	1	3	4	0	0	4	0	0
3	32170835	.	C	T	7	2	9	0	1	10	0	0
3	32175918	.	C	A	2	5	7	0	0	7	0	0
3	32176806	.	C	T	0	2	2	0	1	3	0	0
3	32176824	.	C	T	1	2	3	0	1	4	0	0
3	32294745	.	G	A	16	17	33	0	0	33	0	0
3	32294869	.	C	G	1	10	11	0	27	38	0	0
3	32295151	.	C	T	13	13	26	0	2	28	0	0
3	32295294	.	G	A	18	9	27	4	2	33	0	0
3	32295519	.	A	C	14	11	25	0	1	26	0	0
3	32295635	.	T	A	4	6	10	0	0	10	0	0
3	32296122	.	C	T	6	9	15	0	0	15	0	0
3	32296202	.	G	A	3	6	9	0	0	9	0	0
3	32296253	.	T	A	3	3	6	0	0	6	0	0
3	32296283	.	G	A	5	2	7	0	1	8	0	0
3	32296379	.	A	G	10	5	15	0	2	17	0	0
3	32296559	.	G	A	5	7	12	0	0	12	0	0
3	32296560	.	C	T	0	4	4	0	7	11	0	0
3	32296673	.	A	G	7	7	14	0	0	14	0	0
3	32296873	.	G	A	4	5	9	0	1	10	0	0
3	32303045	.	G	A	2	2	4	0	1	5	0	0
3	32303698	.	A	G	4	8	12	0	0	12	0	0
3	32325218	.	A	G	6	9	15	0	0	15	0	0
3	32329167	.	A	T	14	18	32	0	0	32	0	0
3	32357596	.	C	T	20	24	44	2	11	57	0	0
3	32357799	.	A	C	27	27	54	0	1	55	0	0
3	32360978	.	G	A	4	7	11	0	1	12	0	0
3	32361669	.	G	A	5	8	13	0	0	13	0	0
3	32361865	.	A	G	8	3	11	0	1	12	0	0
3	32366131	.	T	C	2	4	6	0	0	6	0	0
3	32400967	.	C	T	31	29	60	0	6	66	0	0
3	32401159	.	C	A	34	32	66	0	1	67	0	0
3	32401252	.	C	T	23	32	55	0	3	58	0	0
3	32403959	.	T	G	3	0	3	0	6	9	0	0
3	32405571	.	C	T	10	10	20	0	0	20	0	0
3	32405865	.	G	C	13	19	32	0	2	34	0	0
3	32405910	.	C	T	21	9	30	0	2	32	0	0
3	32406447	.	T	C	26	29	55	0	4	59	0	0
3	32406547	.	T	C	31	20	51	1	1	53	0	0
3	32406618	.	G	A	35	25	60	0	1	61	0	0
3	32406631	.	C	G	21	31	52	0	4	56	0	0
3	32414109	.	T	C	0	2	2	0	1	3	0	0
3	32434974	.	G	A	0	2	2	0	1	3	0	0
3	32436426	.	C	T	1	3	4	0	1	5	0	0
3	32438425	.	A	C	4	6	10	0	0	10	0	0
3	32440805	.	A	G	5	8	13	0	0	13	0	0
3	32441156	.	T	G	10	1	11	0	14	25	0	0
3	32441297	.	C	A	10	6	16	0	0	16	0	0
3	32441385	.	G	C	10	12	22	0	0	22	0	0
3	32441532	.	G	A	8	9	17	0	4	21	0	0
3	32441779	.	C	T	12	16	28	0	2	30	0	0
3	32447386	.	G	A	15	12	27	1	0	28	0	0
3	32447505	.	G	T	20	12	32	0	2	34	0	0
3	32447674	.	C	G	17	14	31	0	1	32	0	0
3	32447800	.	T	C	13	15	28	0	1	29	0	0
3	32450399	.	T	C	16	15	31	0	3	34	0	0
3	32453727	.	G	A	24	13	37	0	0	37	0	0
3	32457325	.	G	A	3	20	23	1	27	51	0	0
3	32457620	.	T	C	13	20	33	0	0	33	0	0
3	32457686	.	T	C	15	24	39	0	1	40	0	0
3	32458627	.	C	T	12	14	26	0	0	26	0	0
3	32458964	.	G	A	2	2	4	0	1	5	0	0
3	32476803	.	T	G	1	2	3	0	0	3	0	0
3	32477950	.	T	A	1	2	3	0	0	3	0	0
3	32482495	.	G	T	0	2	2	0	2	4	0	0
3	32482834	.	A	G	3	1	4	0	1	5	0	0
3	32483956	.	T	C	6	3	9	0	0	9	0	0
3	32484034	.	A	G	4	0	4	0	5	9	0	0
3	32484039	.	A	G	4	0	4	0	4	8	0	0
3	32484204	.	T	C	9	3	12	0	1	13	0	0
3	32484472	.	T	C	3	3	6	0	0	6	0	0
3	32484676	.	T	G	6	6	12	0	0	12	0	0
3	32484892	.	A	G	4	3	7	0	0	7	0	0
3	32485306	.	A	G	14	10	24	0	2	26	0	0
3	32485324	.	C	T	13	9	22	0	2	24	0	0
3	32485366	.	A	G	9	12	21	0	0	21	0	0
3	32485519	.	A	C	12	12	24	0	2	26	0	0
3	32485967	.	C	A	27	13	40	1	3	44	0	0
3	32486049	.	A	T	15	22	37	0	3	40	0	0
3	32486069	.	C	G	15	1	16	0	18	34	0	0
3	32489613	.	C	T	22	20	42	0	5	47	0	0
3	32490098	.	C	T	17	12	29	0	2	31	0	0
3	32490251	.	G	T	18	17	35	1	1	37	0	0
3	32490264	.	G	A	14	14	28	0	2	30	0	0
3	32490487	.	G	T	12	18	30	0	1	31	0	0
3	32534263	.	A	G	6	11	17	0	0	17	0	0
3	32534353	.	C	T	9	7	16	0	3	19	0	0
3	32534365	.	T	A	10	7	17	0	0	17	0	0
3	32615862	.	G	A	0	4	4	0	1	5	0	0
3	32615895	.	G	A	1	1	2	0	1	3	0	0
3	32641716	.	T	G	5	5	10	0	0	10	0	0
3	32643512	.	G	A	6	8	14	0	2	16	0	0
3	32647124	.	T	C	11	15	26	0	1	27	0	0
3	32647252	.	G	A	11	7	18	0	2	20	0	0
3	32647308	.	G	C	8	12	20	1	2	23	0	0
3	32647414	.	A	G	11	12	23	0	1	24	0	0
3	32647558	.	A	G	11	1	12	0	17	29	0	0
3	32649846	.	C	T	13	11	24	0	1	25	0	0
3	32649960	.	G	A	13	17	30	0	2	32	0	0
3	32650004	.	A	G	17	13	30	0	2	32	0	0
3	32650199	.	C	A	8	8	16	0	0	16	0	0
3	32658265	.	T	G	2	2	4	0	0	4	0	0
3	32663485	.	T	C	3	2	5	0	0	5	0	0
3	32663638	.	A	G	3	2	5	0	0	5	0	0
3	32663764	.	T	G	3	5	8	0	0	8	0	0
3	32667118	.	A	C	9	5	14	0	0	14	0	0
3	32668806	.	A	G	7	7	14	0	1	15	0	0
3	32668818	.	A	G	7	7	14	0	1	15	0	0
3	32669040	.	C	G	1	7	8	0	1	9	0	0
3	32672501	.	C	A	2	6	8	0	2	10	0	0
3	32675236	.	G	A	9	7	16	0	0	16	0	0
3	32679267	.	T	A	17	8	25	0	2	27	0	0
3	32679289	.	T	A	20	11	31	0	1	32	0	0
3	32679332	.	C	T	20	20	40	0	1	41	0	0
3	32679528	.	C	A	10	14	24	0	0	24	0	0
3	32685708	.	A	G	10	0	10	0	10	20	0	0
3	32686230	.	A	G	10	1	11	0	16	27	0	0
3	32686245	.	T	C	13	15	28	0	1	29	0	0
3	32698500	.	A	G	5	8	13	0	2	15	0	0
3	32700697	.	A	G	6	6	12	0	1	13	0	0
3	32700758	.	A	G	3	4	7	0	1	8	0	0
3	32700988	.	C	T	7	4	11	0	0	11	0	0
3	32701031	.	T	G	5	0	5	0	11	16	0	0
3	32702596	.	T	A	15	5	20	0	0	20	0	0
3	32707219	.	G	A	12	6	18	0	1	19	0	0
3	32707267	.	T	C	6	13	19	0	1	20	0	0
3	32707272	.	C	A	6	14	20	0	0	20	0	0
3	32707480	.	C	T	12	8	20	0	0	20	0	0
3	32707621	.	C	G	23	16	39	0	0	39	0	0
3	32707813	.	C	G	24	19	43	0	0	43	0	0
3	32708077	.	T	C	29	21	50	0	2	52	0	0
3	32710705	.	A	G	34	25	59	0	2	61	0	0
3	32710812	.	G	A	3	24	27	2	31	60	0	0
3	32710999	.	C	A	11	5	16	1	0	18	1	0
3	32711117	.	T	C	4	3	7	0	0	7	0	0
3	32711147	.	T	A	4	3	7	0	0	7	0	0
3	32723497	.	A	G	1	0	1	0	3	4	0	0
3	32729150	.	T	C	2	2	4	0	1	5	0	0
3	32729232	.	T	C	4	7	11	0	0	11	0	0
3	32729429	.	T	A	1	2	3	0	0	3	0	0
3	32729759	.	C	A	1	3	4	0	0	4	0	0
3	32730011	.	A	G	2	0	2	0	3	5	0	0
3	32730071	.	T	A	4	4	8	0	0	8	0	0
3	32730131	.	A	G	2	4	6	0	0	6	0	0
3	32731418	.	C	T	7	4	11	0	1	12	0	0
3	32731750	.	A	G	1	0	1	0	4	5	0	0
3	32731804	.	T	C	4	4	8	0	0	8	0	0
3	32731840	.	T	C	6	7	13	0	0	13	0	0
3	32731855	.	T	C	5	5	10	0	2	12	0	0
3	32731879	.	A	G	6	1	7	0	3	10	0	0
3	32734926	.	G	A	0	3	3	0	4	7	0	0
3	32737727	.	C	T	5	5	10	0	0	10	0	0
3	32741137	.	G	A	0	7	7	0	6	13	0	0
3	32741809	.	A	G	14	0	14	0	15	29	0	0
3	32777481	.	A	C	12	10	22	0	0	22	0	0
3	32777733	.	G	T	7	9	16	0	0	16	0	0
3	32795068	.	C	T	2	2	4	0	0	4	0	0
3	32808023	.	T	A	5	2	7	0	0	7	0	0
3	32808185	.	T	C	6	10	16	0	0	16	0	0
3	32808214	.	G	A	6	8	14	0	3	17	0	0
3	32808338	.	A	C	8	9	17	0	5	22	0	0
3	32808554	.	T	G	6	5	11	0	0	11	0	0
3	32808771	.	G	A	5	8	13	0	0	13	0	0
3	32808772	.	G	C	3	8	11	0	1	12	0	0
3	32808979	.	T	G	8	5	13	0	0	14	1	0
3	32809154	.	A	T	4	7	11	0	0	11	0	0
3	32809368	.	G	A	7	10	17	0	0	17	0	0
3	32809410	.	G	A	6	7	13	0	1	14	0	0
3	32809432	.	T	A	5	6	11	0	2	13	0	0
3	32809548	.	T	C	7	3	10	0	0	10	0	0
3	32809561	.	G	A	6	4	10	0	0	10	0	0
3	32809836	.	A	G	4	0	4	0	15	19	0	0
3	32809927	.	T	C	8	6	14	0	1	15	0	0
3	32810011	.	T	A	6	7	13	0	0	13	0	0
3	32810580	.	C	T	10	22	32	0	3	35	0	0
3	32810715	.	A	G	18	21	39	0	2	41	0	0
3	32811094	.	A	T	5	7	12	0	1	13	0	0
3	32825564	.	T	A	2	2	4	0	0	4	0	0
3	32825565	.	C	T	2	2	4	0	0	4	0	0
3	32837514	.	G	A	26	15	41	0	4	45	0	0
3	32837643	.	G	A	20	11	31	0	4	35	0	0
3	32837904	.	A	G	26	0	26	0	11	37	0	0
3	32838033	.	G	A	1	22	23	0	16	39	0	0
3	32838039	.	A	G	16	22	38	0	0	38	0	0
3	32842163	.	C	T	14	13	27	1	1	29	0	0
3	32842235	.	G	T	13	4	17	0	0	17	0	0
3	32842318	.	C	T	8	5	13	0	1	14	0	0
3	32847607	.	C	T	1	3	4	0	1	5	0	0
3	32847887	.	C	G	2	2	4	0	0	4	0	0
3	32847923	.	C	A	2	2	4	0	0	4	0	0
3	32848418	.	C	T	1	4	5	0	0	5	0	0
3	32849079	.	C	T	2	2	4	0	0	4	0	0
3	32849679	.	T	A	9	8	17	0	0	17	0	0
3	32850029	.	A	T	7	8	15	0	1	16	0	0
3	32850265	.	A	G	8	0	8	0	6	14	0	0
3	32850499	.	T	C	5	4	9	0	0	9	0	0
3	32854276	.	T	C	5	5	10	0	0	10	0	0
3	32854533	.	T	C	7	7	14	1	2	17	0	0
3	32854743	.	C	G	16	0	16	0	10	26	0	0
3	32854744	.	A	G	17	9	26	0	1	27	0	0
3	32855066	.	G	A	8	11	19	0	2	21	0	0
3	32855359	.	C	T	0	2	2	0	1	3	0	0
3	32855362	.	G	A	0	2	2	0	0	2	0	0
3	32863016	.	A	G	2	6	8	0	1	9	0	0
3	32863128	.	C	A	1	3	4	0	0	4	0	0
3	32867711	.	C	A	1	6	7	0	0	7	0	0
3	32867865	.	A	G	1	2	3	0	1	4	0	0
3	32868114	.	G	T	5	4	9	0	0	9	0	0
3	32868143	.	C	T	6	5	11	0	0	11	0	0
3	32868519	.	G	T	2	7	9	0	2	11	0	0
3	32868590	.	C	T	3	6	9	0	0	9	0	0
3	32868593	.	A	G	3	4	7	0	2	9	0	0
3	32869770	.	C	T	4	5	9	0	0	9	0	0
3	32869773	.	G	A	5	5	10	0	0	10	0	0
3	32869913	.	C	T	1	5	6	0	0	6	0	0
3	32869930	.	C	T	1	5	6	0	0	6	0	0
3	32870756	.	A	G	1	0	1	0	3	4	0	0
3	32870766	.	G	A	1	3	4	0	0	4	0	0
3	32870947	.	A	G	4	4	8	0	0	8	0	0
3	32871023	.	G	C	3	4	7	0	0	7	0	0
3	32871247	.	A	G	2	0	2	0	3	5	0	0
3	32871350	.	T	C	1	1	2	0	1	3	0	0
3	32873596	.	A	G	2	2	4	0	0	4	0	0
3	32889849	.	T	C	6	1	7	0	13	20	0	0
3	32890002	.	G	T	22	17	39	0	0	39	0	0
3	32890058	.	A	G	15	21	36	0	2	38	0	0
3	32892061	.	G	A	13	16	29	0	2	31	0	0
3	32892422	.	A	G	10	10	20	0	1	21	0	0
3	32900428	.	A	G	8	4	12	0	1	13	0	0
3	32924386	.	G	A	1	5	6	0	0	6	0	0
3	32924643	.	G	A	3	5	8	0	0	8	0	0
3	32924836	.	T	A	9	5	14	0	0	14	0	0
3	32924989	.	G	A	6	6	12	0	0	12	0	0
3	32925066	.	G	A	4	4	8	0	0	8	0	0
3	32925248	.	C	T	3	5	8	0	0	8	0	0
3	32925264	.	G	T	2	2	4	0	0	4	0	0
3	32925400	.	C	T	1	2	3	0	1	4	0	0
3	32926058	.	A	G	1	3	4	0	0	4	0	0
3	32933774	.	A	C	1	2	3	0	1	4	0	0
3	32937628	.	A	G	3	5	8	0	0	8	0	0
3	32941242	.	G	A	4	9	13	0	0	13	0	0
3	32941661	.	A	G	7	3	10	0	0	10	0	0
3	32944203	.	C	A	4	14	18	0	0	18	0	0
3	32944569	.	C	T	12	6	18	0	0	18	0	0
3	32944668	.	C	A	3	9	12	0	0	12	0	0
3	32944854	.	C	T	14	13	27	0	2	29	0	0
3	32947971	.	T	C	19	11	30	0	1	31	0	0
3	32950959	.	G	A	13	15	28	0	1	29	0	0
3	32950977	.	G	A	2	17	19	0	10	29	0	0
3	32951001	.	G	T	1	16	17	0	13	30	0	0
3	32951394	.	G	A	22	22	44	0	1	45	0	0
3	32951564	.	A	C	8	14	22	0	2	24	0	0
3	32951637	.	G	A	12	11	23	0	1	24	0	0
3	32951778	.	C	T	25	13	38	0	2	40	0	0
3	32951891	.	T	C	13	20	33	0	0	33	0	0
3	33047597	.	G	T	2	2	4	0	0	4	0	0
3	33065643	.	T	A	3	5	8	1	0	9	0	0
3	33065985	.	A	G	4	5	9	1	0	10	0	0
3	33066155	.	C	T	0	9	9	0	3	12	0	0
3	33066241	.	C	T	1	7	8	2	10	20	0	0
3	33066714	.	A	T	2	4	6	0	0	6	0	0
3	33066969	.	T	C	5	1	6	0	4	10	0	0
3	33066976	.	T	C	5	4	9	0	1	10	0	0
3	33067376	.	G	A	2	3	5	0	0	5	0	0
3	33067438	.	G	A	2	3	5	0	0	5	0	0
3	33069274	.	A	C	3	2	5	0	1	6	0	0
3	33069596	.	G	A	6	2	8	0	0	8	0	0
3	33341072	.	T	A	11	9	20	0	0	20	0	0
3	33344470	.	T	A	19	15	34	0	0	34	0	0
3	33344636	.	A	T	7	4	11	0	0	11	0	0
3	33345482	.	G	A	0	2	2	0	3	5	0	0
3	33368134	.	T	C	1	4	5	0	0	5	0	0
3	33373443	.	T	C	2	3	5	0	1	6	0	0
3	33373540	.	A	C	2	2	4	0	0	4	0	0
3	33379072	.	C	T	2	3	5	0	0	5	0	0
3	33379162	.	G	T	5	3	8	0	1	9	0	0
3	33420561	.	C	T	2	3	5	0	0	5	0	0
3	33424010	.	C	T	3	12	15	0	11	26	0	0
3	33424420	.	G	A	31	30	61	0	8	69	0	0
3	33426513	.	G	A	41	31	72	0	2	74	0	0
3	33433621	.	G	A	5	5	10	0	0	10	0	0
3	33437399	.	T	C	5	2	7	0	0	7	0	0
3	33445039	.	A	T	4	3	7	0	0	7	0	0
3	33445090	.	G	C	0	6	6	0	1	7	0	0
3	33449405	.	C	T	8	4	12	0	0	12	0	0
3	33449554	.	G	A	0	5	5	0	5	10	0	0
3	33452168	.	C	T	15	12	27	0	0	27	0	0
3	33455809	.	G	A	3	12	15	1	14	30	0	0
3	33458803	.	C	T	11	18	29	0	7	36	0	0
3	33458911	.	A	T	20	10	30	0	0	30	0	0
3	33459394	.	T	A	8	10	18	0	1	19	0	0
3	33459489	.	C	T	11	6	17	0	1	18	0	0
3	33459517	.	C	T	11	9	20	0	3	23	0	0
3	33459532	.	G	A	14	10	24	0	1	25	0	0
3	33461366	.	C	T	0	13	13	0	18	31	0	0
3	33461646	.	C	T	3	8	11	0	12	23	0	0
3	33461796	.	A	T	13	11	24	0	0	24	0	0
3	33469413	.	A	G	8	16	24	0	1	25	0	0
3	33469614	.	T	A	8	8	16	0	0	16	0	0
3	33476589	.	T	C	1	5	6	0	0	6	0	0
3	33494089	.	A	T	1	6	7	0	1	8	0	0
3	33494091	.	G	C	1	5	6	0	2	8	0	0
3	33761597	.	C	T	10	7	17	0	0	17	0	0
3	33761705	.	G	A	2	14	16	0	14	30	0	0
3	33761834	.	G	A	20	16	36	0	1	37	0	0
3	33761835	.	A	T	18	16	34	0	3	37	0	0
3	33762068	.	A	G	15	6	21	0	1	22	0	0
3	33762278	.	A	G	11	14	25	0	3	28	0	0
3	33762310	.	C	A	8	19	27	0	1	28	0	0
3	33762408	.	T	A	10	15	25	0	1	26	0	0
3	33762480	.	C	T	8	12	20	0	1	21	0	0
3	33773294	.	A	G	12	7	19	0	1	20	0	0
3	33777317	.	T	G	12	9	21	0	3	24	0	0
3	33777425	.	A	G	4	9	13	0	0	13	0	0
3	33777807	.	A	G	9	7	16	0	2	18	0	0
3	33918611	.	A	G	1	4	5	0	2	7	0	0
3	33918775	.	A	G	7	3	10	0	0	10	0	0
3	33921663	.	A	C	3	8	11	0	2	13	0	0
3	33922198	.	C	T	1	2	3	0	0	3	0	0
3	33922359	.	G	A	10	8	18	0	1	19	0	0
3	33922413	.	T	A	8	12	20	0	0	20	0	0
3	33922415	.	G	A	8	12	20	0	0	20	0	0
3	33922471	.	T	C	6	10	16	0	1	17	0	0
3	33932170	.	C	T	0	8	8	1	7	16	0	0
3	33932430	.	T	A	8	3	11	0	2	13	0	0
3	33932628	.	G	A	6	2	8	0	1	9	0	0
3	33934848	.	T	C	3	1	4	0	1	5	0	0
3	33934849	.	G	C	3	1	4	0	1	5	0	0
3	33936783	.	G	C	4	2	6	0	0	6	0	0
3	34129941	.	C	T	0	13	13	0	14	27	0	0
3	34135868	.	C	T	2	2	4	0	0	4	0	0
3	34146882	.	G	T	8	10	18	0	0	18	0	0
3	34146955	.	A	G	6	6	12	0	0	12	0	0
3	34166288	.	C	A	5	5	10	1	0	11	0	0
3	34170913	.	G	A	8	11	19	0	3	22	0	0
3	34182164	.	C	T	6	6	12	0	0	12	0	0
3	34182306	.	G	C	10	7	17	0	0	17	0	0
3	34182376	.	A	C	7	8	15	0	2	17	0	0
3	34182386	.	G	A	0	9	9	0	7	16	0	0
3	34220359	.	A	T	1	4	5	0	0	5	0	0
3	34244901	.	G	C	10	9	19	0	0	19	0	0
3	34258965	.	G	A	14	18	32	0	1	33	0	0
3	34259013	.	C	G	24	14	38	0	3	41	0	0
3	34259060	.	C	T	24	23	47	0	3	50	0	0
3	34259868	.	A	G	11	4	15	1	7	24	1	0
3	34260325	.	T	C	12	10	22	0	2	24	0	0
3	34260808	.	T	C	8	5	13	0	0	13	0	0
3	34261204	.	T	C	3	4	7	0	0	7	0	0
3	34261795	.	G	A	6	10	16	0	1	17	0	0
3	34262290	.	C	T	7	5	12	0	1	13	0	0
3	34262421	.	C	A	3	4	7	0	2	9	0	0
3	34262639	.	G	A	8	8	16	0	0	16	0	0
3	34262823	.	A	T	6	6	12	0	0	12	0	0
3	34263101	.	T	A	5	3	8	0	0	8	0	0
3	34264634	.	T	A	2	2	4	0	0	4	0	0
3	34264657	.	A	T	3	3	6	0	0	6	0	0
3	34327103	.	G	A	5	4	9	0	0	9	0	0
3	34455822	.	T	C	1	0	1	0	2	3	0	0
3	34588493	.	A	G	1	2	3	0	0	3	0	0
3	34588788	.	G	A	5	3	8	0	0	8	0	0
3	34589396	.	A	C	3	2	5	0	0	5	0	0
3	34604202	.	A	G	3	3	6	0	0	6	0	0
3	34697461	.	G	A	5	5	10	0	1	11	0	0
3	34697514	.	T	C	3	0	3	0	5	8	0	0
3	34714488	.	C	T	1	2	3	0	0	3	0	0
3	34766992	.	T	C	12	2	14	0	2	16	0	0
3	34766993	.	G	T	11	3	14	0	2	16	0	0
3	34767112	.	G	T	32	30	62	0	4	66	0	0
3	34767662	.	T	G	33	20	53	0	4	57	0	0
3	34767669	.	G	A	35	19	54	0	1	55	0	0
3	34772941	.	T	G	30	32	62	0	2	65	1	0
3	34775942	.	G	A	29	24	53	0	3	56	0	0
3	34776115	.	T	G	21	20	41	0	8	49	0	0
3	34776133	.	G	C	26	17	43	0	5	48	0	0
3	34776151	.	C	A	32	18	50	0	3	53	0	0
3	34781074	.	A	G	12	16	28	0	0	28	0	0
3	34781095	.	C	T	11	18	29	0	0	29	0	0
3	34781448	.	T	C	2	7	9	0	0	9	0	0
3	34781586	.	T	C	3	0	3	0	5	8	0	0
3	34783970	.	G	A	2	5	7	0	0	7	0	0
3	34783982	.	A	G	1	4	5	0	1	6	0	0
3	34804427	.	A	G	17	6	23	0	2	25	0	0
3	34822049	.	C	T	5	4	9	0	1	10	0	0
3	34822169	.	C	T	6	4	10	0	0	10	0	0
3	34822214	.	T	C	4	3	7	0	1	8	0	0
3	34919853	.	A	G	1	0	1	0	2	3	0	0
3	34919892	.	C	T	3	2	5	0	0	5	0	0
3	34977497	.	A	G	14	2	16	1	7	24	0	0
3	34977508	.	A	G	10	1	11	1	8	20	0	0
3	34981394	.	T	C	8	4	12	0	0	12	0	0
3	34994140	.	C	T	33	29	62	1	0	63	0	0
3	34994750	.	A	G	9	25	34	0	1	35	0	0
3	35170112	.	T	C	1	3	4	0	0	4	0	0
3	35225160	.	A	G	12	0	12	0	8	20	0	0
3	35225202	.	C	T	9	5	14	0	0	14	0	0
3	35248470	.	T	C	8	9	17	0	0	17	0	0
3	35248492	.	T	A	9	10	19	0	0	19	0	0
3	35249369	.	T	C	16	13	29	0	1	30	0	0
3	35249535	.	T	C	16	11	27	0	1	28	0	0
3	35250145	.	A	T	17	19	36	0	0	36	0	0
3	35250188	.	A	G	4	14	18	0	2	20	0	0
3	35264406	.	T	G	23	14	37	0	0	37	0	0
3	35264460	.	C	T	21	16	37	1	3	41	0	0
3	35264744	.	T	A	12	10	22	0	1	23	0	0
3	35264951	.	G	A	20	7	27	1	1	29	0	0
3	35265350	.	T	C	24	15	39	5	0	44	0	0
3	35265419	.	T	G	17	24	41	0	0	41	0	0
3	35265654	.	G	A	3	26	29	0	27	56	0	0
3	35266006	.	G	A	5	2	7	0	0	7	0	0
3	35298725	.	T	A	2	3	5	0	0	5	0	0
3	35374514	.	C	T	1	2	3	0	0	3	0	0
3	35374719	.	C	T	8	7	15	0	2	17	0	0
3	35375112	.	G	A	15	6	21	0	1	22	0	0
3	35375162	.	T	A	19	11	30	0	2	32	0	0
3	35375279	.	A	T	10	13	23	0	0	23	0	0
3	35375306	.	T	C	11	9	20	0	0	20	0	0
3	35375448	.	T	G	22	0	22	0	15	37	0	0
3	35375638	.	T	A	20	17	37	0	2	39	0	0
3	35418047	.	A	G	6	3	9	0	1	10	0	0
3	35419683	.	A	T	9	7	16	0	1	17	0	0
3	35420588	.	A	G	3	8	11	0	2	13	0	0
3	35420604	.	C	T	3	8	11	0	0	11	0	0
3	35518464	.	A	C	1	2	3	0	0	3	0	0
3	35527024	.	T	C	2	7	9	1	0	10	0	0
3	35529040	.	T	C	7	4	11	0	0	11	0	0
3	35531018	.	T	C	4	8	12	0	0	12	0	0
3	35531028	.	T	C	8	7	15	0	0	15	0	0
3	35531328	.	G	A	0	5	5	0	3	8	0	0
3	35531329	.	A	T	3	5	8	0	0	8	0	0
3	35531671	.	A	T	9	10	19	0	0	19	0	0
3	35531791	.	A	G	24	0	24	0	12	36	0	0
3	35531866	.	T	A	14	10	24	0	2	26	0	0
3	35531985	.	G	A	23	19	42	0	3	45	0	0
3	35532074	.	A	T	15	13	28	0	1	29	0	0
3	35532452	.	A	T	23	14	37	0	0	37	0	0
3	35532634	.	A	G	20	0	20	0	16	36	0	0
3	35532665	.	C	T	21	15	36	0	0	36	0	0
3	35532736	.	A	C	20	10	30	0	0	30	0	0
3	35535484	.	G	A	3	2	5	0	0	5	0	0
3	35535525	.	T	G	3	2	5	0	0	5	0	0
3	35535695	.	A	C	3	3	6	0	0	6	0	0
3	35535702	.	G	T	3	3	6	0	0	6	0	0
3	35536115	.	C	G	18	18	36	0	1	37	0	0
3	35536269	.	G	A	12	13	25	0	1	26	0	0
3	35541273	.	A	G	21	24	45	0	4	49	0	0
3	35548636	.	T	C	3	2	5	0	0	5	0	0
3	35548642	.	G	A	3	2	5	0	0	5	0	0
3	35549002	.	G	A	1	6	7	0	0	7	0	0
3	35551047	.	A	T	15	16	31	0	1	32	0	0
3	35551190	.	C	T	0	12	12	0	16	28	0	0
3	35589548	.	C	T	22	26	48	0	1	49	0	0
3	35589881	.	T	C	16	18	34	0	2	36	0	0
3	35589908	.	A	G	20	12	32	0	2	34	0	0
3	35589918	.	G	A	22	12	34	0	3	37	0	0
3	35590270	.	T	C	22	1	23	0	23	46	0	0
3	35602007	.	A	C	18	0	18	0	14	32	0	0
3	35602047	.	A	G	13	13	26	0	3	29	0	0
3	35602153	.	A	G	8	6	14	0	0	14	0	0
3	35602154	.	T	A	8	6	14	0	0	14	0	0
3	35634953	.	A	G	1	3	4	0	0	4	0	0
3	35635039	.	C	T	10	4	14	0	1	15	0	0
3	35635629	.	A	G	1	2	3	0	1	4	0	0
3	35636183	.	A	G	7	3	10	0	0	10	0	0
3	35636410	.	A	G	3	3	6	0	0	6	0	0
3	35638008	.	T	A	18	13	31	0	1	32	0	0
3	35638119	.	A	C	20	15	35	0	4	39	0	0
3	35638201	.	A	G	16	24	40	0	2	42	0	0
3	35638240	.	C	T	22	17	39	0	0	39	0	0
3	35638366	.	T	C	10	4	14	0	1	15	0	0
3	35638450	.	T	A	11	4	15	0	1	16	0	0
3	35638513	.	G	A	22	6	28	0	2	30	0	0
3	35638908	.	C	T	3	23	26	0	14	40	0	0
3	35638986	.	C	A	13	25	38	0	0	38	0	0
3	35639020	.	A	G	16	21	37	0	1	38	0	0
3	35639021	.	G	A	17	21	38	0	0	38	0	0
3	35639194	.	T	C	17	20	37	0	2	39	0	0
3	35639621	.	A	C	8	12	20	0	1	21	0	0
3	35639817	.	T	A	8	4	12	0	0	12	0	0
3	35639862	.	G	T	9	4	13	0	1	14	0	0
3	35639884	.	T	C	6	0	6	0	5	11	0	0
3	35639958	.	T	C	8	5	13	1	0	14	0	0
3	35640042	.	A	G	7	13	20	0	0	20	0	0
3	35640122	.	G	T	5	10	15	0	0	15	0	0
3	35640313	.	A	G	7	6	13	0	0	13	0	0
3	35640331	.	G	A	3	5	8	0	1	9	0	0
3	35640441	.	C	A	5	2	7	0	1	8	0	0
3	35640588	.	A	G	2	3	5	0	0	5	0	0
3	35640625	.	C	T	3	5	8	0	0	8	0	0
3	35640784	.	T	C	11	6	17	0	0	17	0	0
3	35640828	.	A	G	3	3	6	0	1	7	0	0
3	35641173	.	C	T	4	4	8	0	0	8	0	0
3	35641371	.	C	T	2	8	10	0	7	17	0	0
3	35641382	.	G	A	8	9	17	0	0	17	0	0
3	35641595	.	A	T	5	9	14	0	1	15	0	0
3	35641663	.	T	C	5	2	7	0	0	7	0	0
3	35641785	.	C	T	0	2	2	0	1	3	0	0
3	35642012	.	A	T	3	6	9	0	0	9	0	0
3	35642072	.	A	G	2	3	5	0	0	5	0	0
3	35642242	.	T	C	2	0	2	0	4	6	0	0
3	35642462	.	T	C	2	1	3	0	3	6	0	0
3	35643320	.	G	A	4	3	7	0	0	7	0	0
3	35643357	.	G	A	1	2	3	0	1	4	0	0
3	35643540	.	G	A	10	10	20	0	0	20	0	0
3	35643546	.	A	T	8	9	17	0	1	18	0	0
3	35645380	.	T	C	9	0	9	0	3	12	0	0
3	35645411	.	G	A	11	5	16	0	2	18	0	0
3	35645661	.	T	G	3	9	12	0	1	13	0	0
3	35646025	.	G	T	2	6	8	0	0	8	0	0
3	35646160	.	G	T	2	5	7	0	0	7	0	0
3	35646611	.	T	G	2	3	5	0	0	5	0	0
3	35647181	.	A	G	5	2	7	0	0	7	0	0
3	35837532	.	C	T	1	2	3	0	0	3	0	0
3	35845805	.	A	G	2	3	5	0	0	5	0	0
3	35846120	.	C	G	4	4	8	0	1	9	0	0
3	35846410	.	A	T	4	5	9	0	0	10	1	0
3	35846440	.	G	A	5	7	12	0	0	12	0	0
3	35846823	.	A	G	8	5	13	0	1	14	0	0
3	35849855	.	T	C	3	3	6	0	1	7	0	0
3	35850254	.	G	A	3	3	6	0	1	7	0	0
3	35850364	.	A	G	5	3	8	0	0	8	0	0
3	35850380	.	C	T	3	3	6	0	1	7	0	0
3	36023342	.	T	G	9	6	15	0	0	15	0	0
3	36023455	.	A	G	6	3	9	0	0	9	0	0
3	36023465	.	A	G	6	4	10	0	0	10	0	0
3	36026294	.	C	G	1	7	8	0	10	18	0	0
3	36032241	.	G	A	4	5	9	0	0	9	0	0
3	36038631	.	G	A	5	4	9	0	0	9	0	0
3	36041017	.	A	C	4	2	6	0	1	7	0	0
3	36123546	.	G	A	1	3	4	0	0	4	0	0
3	36125256	.	C	G	1	2	3	0	5	8	0	0
3	36131883	.	T	A	1	6	7	0	0	7	0	0
3	36132099	.	C	T	5	3	8	0	0	8	0	0
3	36132740	.	T	C	5	6	11	0	0	11	0	0
3	36135084	.	A	G	5	4	9	0	0	9	0	0
3	36135481	.	A	G	1	6	7	0	0	7	0	0
3	36135641	.	T	A	1	3	4	0	0	4	0	0
3	36136533	.	T	A	2	3	5	0	0	5	0	0
3	36136537	.	T	A	3	3	6	0	0	6	0	0
3	36173633	.	T	C	16	9	25	1	0	26	0	0
3	36174175	.	C	A	15	12	27	0	5	32	0	0
3	36174248	.	C	G	12	14	26	0	1	27	0	0
3	36174276	.	T	C	11	1	12	0	12	24	0	0
3	36184806	.	A	G	4	10	14	0	1	15	0	0
3	36188400	.	A	G	4	3	7	0	1	8	0	0
3	36228295	.	G	A	2	2	4	0	1	5	0	0
3	36232218	.	A	G	5	2	7	0	0	7	0	0
3	36232331	.	C	T	8	6	14	0	0	14	0	0
3	36232368	.	A	C	2	4	6	0	1	7	0	0
3	36241839	.	T	C	3	2	5	0	0	5	0	0
3	36241938	.	T	C	7	0	7	0	5	12	0	0
3	36242239	.	C	T	1	2	3	0	4	7	0	0
3	36249172	.	C	T	5	3	8	0	1	9	0	0
3	36249419	.	G	A	20	7	27	0	1	28	0	0
3	36249476	.	T	A	23	15	38	0	1	39	0	0
3	36249516	.	T	A	17	10	27	0	3	30	0	0
3	36249518	.	A	C	19	9	28	0	2	30	0	0
3	36253186	.	G	A	10	12	22	0	1	23	0	0
3	36255436	.	A	G	12	8	20	0	4	24	0	0
3	36259855	.	T	C	2	5	7	0	1	8	0	0
3	36262799	.	A	C	27	0	27	0	21	48	0	0
3	36263099	.	T	C	9	2	11	0	23	34	0	0
3	36263151	.	A	G	10	31	41	0	4	45	0	0
3	36263163	.	C	T	13	31	44	0	1	45	0	0
3	36263464	.	C	A	14	16	30	0	2	32	0	0
3	36263557	.	A	G	11	12	23	0	0	23	0	0
3	36263563	.	T	A	11	13	24	0	0	24	0	0
3	36263596	.	T	C	6	0	6	0	14	20	0	0
3	36263666	.	T	C	3	0	3	0	8	11	0	0
3	36263824	.	T	C	12	22	34	0	1	35	0	0
3	36263895	.	A	T	21	12	33	0	1	34	0	0
3	36264028	.	T	C	17	0	17	0	10	27	0	0
3	36264204	.	T	G	9	10	19	0	0	19	0	0
3	36264217	.	A	C	9	9	18	0	1	19	0	0
3	36264248	.	T	C	10	9	19	0	1	20	0	0
3	36264498	.	G	A	6	8	14	0	1	15	0	0
3	36264822	.	C	A	2	4	6	0	0	6	0	0
3	36265895	.	C	T	1	5	6	0	4	10	0	0
3	36266137	.	T	A	4	5	9	0	0	9	0	0
3	36266173	.	A	G	3	3	6	0	0	6	0	0
3	36268616	.	A	G	2	3	5	0	0	5	0	0
3	36292481	.	G	C	1	6	7	0	6	13	0	0
3	36292657	.	T	C	5	4	9	0	0	9	0	0
3	36293950	.	C	T	3	2	5	0	1	6	0	0
3	36293964	.	C	T	7	1	8	0	1	9	0	0
3	36305854	.	A	G	17	25	42	0	3	45	0	0
3	36305860	.	A	G	17	0	17	0	27	44	0	0
3	36305971	.	T	A	18	14	32	0	1	33	0	0
3	36306346	.	A	G	4	3	7	0	1	8	0	0
3	36306349	.	G	A	5	2	7	0	0	7	0	0
3	36323598	.	A	C	1	2	3	0	0	3	0	0
3	36323604	.	C	T	0	2	2	0	1	3	0	0
3	36325569	.	T	A	1	2	3	0	0	3	0	0
3	36326108	.	A	T	1	2	3	0	0	3	0	0
3	36326139	.	T	G	3	2	5	0	0	5	0	0
3	36326252	.	A	G	2	1	3	0	0	3	0	0
3	36326270	.	A	G	3	2	5	0	0	5	0	0
3	36326370	.	A	G	2	2	4	0	0	4	0	0
3	36326681	.	T	C	5	2	7	0	0	7	0	0
3	36326685	.	T	A	5	2	7	0	1	8	0	0
3	36327129	.	G	A	8	3	11	0	0	11	0	0
3	36327553	.	T	C	1	2	3	0	0	3	0	0
3	36327872	.	G	A	5	4	9	0	0	9	0	0
3	36327906	.	G	T	3	3	6	0	0	6	0	0
3	36327909	.	G	T	0	3	3	0	3	6	0	0
3	36328083	.	G	T	2	4	6	0	0	6	0	0
3	36328204	.	C	A	6	5	11	0	2	13	0	0
3	36328218	.	G	A	11	7	18	0	1	19	0	0
3	36328339	.	G	A	1	3	4	0	0	4	0	0
3	36328414	.	T	A	3	2	5	0	0	5	0	0
3	36402930	.	T	C	2	0	2	0	4	6	0	0
3	36407283	.	C	A	5	3	8	0	0	8	0	0
3	36407604	.	A	G	3	4	7	0	0	7	0	0
3	36408402	.	G	T	1	2	3	0	0	3	0	0
3	36409721	.	G	A	1	2	3	0	0	3	0	0
3	36409877	.	C	T	2	7	9	0	0	9	0	0
3	36409969	.	T	C	1	4	5	0	0	5	0	0
3	36409995	.	T	C	1	0	1	0	3	4	0	0
3	36410157	.	A	G	3	2	5	0	0	5	0	0
3	36428612	.	T	A	23	13	36	0	1	37	0	0
3	36428620	.	T	A	19	9	28	0	4	32	0	0
3	36431380	.	T	C	10	11	21	0	1	22	0	0
3	36442021	.	T	C	4	6	10	0	2	12	0	0
3	36442029	.	A	G	5	4	9	0	0	9	0	0
3	36442071	.	A	G	3	5	8	0	0	8	0	0
3	36442551	.	C	T	2	9	11	0	11	22	0	0
3	36442661	.	T	G	12	7	19	0	1	20	0	0
3	36442726	.	A	G	12	11	23	0	0	23	0	0
3	36443189	.	G	A	10	12	22	0	0	22	0	0
3	36446613	.	A	G	2	3	5	0	0	5	0	0
3	36859720	.	C	T	6	2	8	0	0	8	0	0
3	36871254	.	A	T	2	3	5	0	1	6	0	0
3	36871260	.	G	A	0	2	2	0	3	5	0	0
3	36871310	.	A	G	4	0	4	0	4	8	0	0
3	36871316	.	A	G	5	0	5	0	3	8	0	0
3	36877656	.	A	G	11	5	16	0	0	16	0	0
3	36888169	.	T	C	17	5	22	0	1	23	0	0
3	36888395	.	G	A	17	4	21	0	4	25	0	0
3	36889316	.	C	G	20	0	20	0	15	35	0	0
3	36889376	.	G	A	3	10	13	0	23	36	0	0
3	36889821	.	A	G	23	0	23	0	16	39	0	0
3	36892130	.	C	T	23	16	39	0	1	40	0	0
3	36892457	.	T	G	1	4	5	0	0	5	0	0
3	36892469	.	T	G	1	2	3	0	0	3	0	0
3	36895506	.	A	T	2	2	4	0	0	4	0	0
3	36895509	.	A	C	2	2	4	0	0	4	0	0
3	37107240	.	G	T	10	2	12	0	1	13	0	0
3	37234561	.	C	A	6	2	8	0	0	8	0	0
3	37237750	.	T	C	3	2	5	0	0	5	0	0
3	37559334	.	A	T	21	30	51	0	2	53	0	0
3	37559905	.	A	C	12	22	34	0	0	34	0	0
3	37564769	.	G	A	10	10	20	0	1	21	0	0
3	37660307	.	G	A	13	8	21	0	0	21	0	0
3	37660661	.	A	G	12	1	13	0	3	16	0	0
3	37664117	.	A	T	11	12	23	0	0	23	0	0
3	37664635	.	A	G	15	12	27	0	0	27	0	0
3	37665855	.	G	A	17	15	32	0	2	34	0	0
3	37666774	.	C	T	0	10	10	0	10	20	0	0
3	37667562	.	C	T	2	15	17	0	15	32	0	0
3	37667608	.	G	C	15	16	31	0	1	32	0	0
3	37667646	.	C	T	16	13	29	0	0	29	0	0
3	37667952	.	C	T	1	9	10	0	10	20	0	0
3	37668319	.	A	G	2	2	4	0	1	5	0	0
3	37668578	.	T	A	5	5	10	0	0	10	0	0
3	37668667	.	C	A	4	4	8	0	0	8	0	0
3	37725453	.	A	G	3	0	3	0	4	7	0	0
3	37737680	.	C	A	3	9	12	0	0	12	0	0
3	37737735	.	T	G	7	0	7	0	5	12	0	0
3	37737736	.	C	T	7	5	12	0	0	12	0	0
3	37737852	.	A	G	7	7	14	0	1	15	0	0
3	37738050	.	C	G	12	5	17	0	0	17	0	0
3	37742116	.	A	C	3	7	10	0	0	10	0	0
3	37742152	.	T	C	3	6	9	0	0	9	0	0
3	37742245	.	C	T	2	6	8	0	0	8	0	0
3	37742247	.	A	G	2	6	8	0	0	8	0	0
3	37742284	.	T	G	2	4	6	0	1	7	0	0
3	37742363	.	C	T	2	4	6	0	0	6	0	0
3	37759044	.	G	T	7	3	10	23	0	33	0	0
3	37766854	.	T	G	0	2	2	0	1	3	0	0
3	37776713	.	T	C	3	7	10	0	0	10	0	0
3	37777309	.	A	T	6	8	14	0	1	15	0	0
3	37777417	.	G	C	4	6	10	0	0	10	0	0
3	37777590	.	C	T	7	4	11	0	0	11	0	0
3	37777811	.	C	T	1	16	17	0	6	23	0	0
3	37781162	.	A	G	2	2	4	0	0	4	0	0
3	37788401	.	T	C	30	32	62	0	1	63	0	0
3	37803375	.	A	G	1	0	1	0	2	3	0	0
3	38505629	.	A	G	8	4	12	0	1	13	0	0
3	38614366	.	C	T	5	4	9	0	1	10	0	0
3	38614426	.	A	G	2	0	2	0	2	4	0	0
3	38614562	.	C	T	6	2	8	0	0	8	0	0
3	38625098	.	A	C	10	10	20	0	0	20	0	0
3	38625497	.	G	T	7	5	12	0	0	12	0	0
3	38625605	.	G	A	13	6	19	0	1	20	0	0
3	38625751	.	A	C	10	4	14	0	0	14	0	0
3	38625901	.	T	G	6	6	12	0	0	12	0	0
3	38649991	.	A	T	10	7	17	0	0	17	0	0
3	38650342	.	T	C	4	2	6	1	0	7	0	0
3	38650440	.	T	C	4	4	8	0	2	10	0	0
3	38650462	.	T	C	4	3	7	0	0	7	0	0
3	38763153	.	T	A	9	13	22	0	4	26	0	0
3	38763174	.	G	A	3	7	10	0	17	27	0	0
3	38763391	.	A	G	6	6	12	0	1	13	0	0
3	38763527	.	C	T	0	3	3	0	6	9	0	0
3	38763564	.	C	A	8	5	13	0	0	13	0	0
3	38763700	.	G	A	8	9	17	0	1	18	0	0
3	38764227	.	C	T	1	3	4	0	1	5	0	0
3	38764229	.	G	A	1	4	5	0	0	5	0	0
3	38764990	.	G	T	1	2	3	0	0	3	0	0
3	38765149	.	A	T	2	3	5	0	0	5	0	0
3	38794422	.	G	C	1	2	3	0	0	3	0	0
3	38858649	.	A	G	1	2	3	0	0	3	0	0
3	38858722	.	G	A	1	2	3	0	0	3	0	0
3	38859126	.	A	T	2	2	4	0	1	5	0	0
3	39181560	.	A	C	2	3	5	0	0	5	0	0
3	39181635	.	C	T	5	3	8	0	0	8	0	0
3	39181823	.	A	G	4	5	9	0	0	9	0	0
3	39181849	.	A	G	5	7	12	0	2	14	0	0
3	39184156	.	A	G	3	4	7	0	0	7	0	0
3	39184180	.	C	T	5	3	8	0	2	10	0	0
3	39238579	.	C	A	13	7	20	0	1	21	0	0
3	39238580	.	C	A	15	7	22	0	0	22	0	0
3	39239380	.	A	G	12	17	29	0	0	29	0	0
3	39241350	.	G	T	12	12	24	0	1	25	0	0
3	39251020	.	G	T	2	4	6	0	0	6	0	0
3	39259624	.	T	C	5	0	5	0	3	8	0	0
3	39261182	.	C	A	0	2	2	0	3	5	0	0
3	39261230	.	C	T	5	3	8	0	0	8	0	0
3	39261270	.	C	T	0	2	2	0	2	4	0	0
3	39313310	.	A	G	8	7	15	0	2	17	0	0
3	39313625	.	T	C	4	4	8	0	1	9	0	0
3	39314028	.	C	T	10	13	23	0	0	23	0	0
3	39314101	.	T	C	10	16	26	0	0	26	0	0
3	39314146	.	C	G	11	10	21	0	0	21	0	0
3	39314260	.	A	G	7	3	10	0	0	10	0	0
3	39314502	.	G	C	4	6	10	0	0	10	0	0
3	39314677	.	C	T	2	3	5	0	0	5	0	0
3	39315154	.	C	A	3	5	8	0	0	8	0	0
3	39315169	.	C	G	3	5	8	0	1	9	0	0
3	39315191	.	C	G	2	4	6	0	0	6	0	0
3	39315874	.	C	A	3	4	7	0	1	8	0	0
3	39315876	.	C	T	4	3	7	0	1	8	0	0
3	39316846	.	T	C	3	4	7	0	1	8	0	0
3	39316906	.	C	A	3	3	6	0	0	6	0	0
3	39316912	.	G	A	2	2	4	0	0	4	0	0
3	39316996	.	A	G	5	3	8	0	0	8	0	0
3	39317279	.	C	T	3	4	7	0	0	7	0	0
3	39317310	.	T	C	5	3	8	0	0	8	0	0
3	39328095	.	G	C	1	2	3	0	0	3	0	0
3	39568368	.	T	G	12	9	21	0	0	21	0	0
3	39568856	.	A	G	9	19	28	1	1	30	0	0
3	39574883	.	C	A	26	26	52	0	7	59	0	0
3	39574961	.	G	A	23	43	66	0	1	67	0	0
3	39576621	.	T	G	40	2	42	0	34	76	0	0
3	39576663	.	A	G	29	48	77	0	2	79	0	0
3	39576866	.	T	C	21	21	42	0	5	47	0	0
3	39586473	.	A	T	5	3	8	0	0	8	0	0
3	39592640	.	T	G	4	6	10	0	0	10	0	0
3	39592797	.	C	T	3	6	9	0	1	10	0	0
3	39592800	.	G	C	0	8	8	0	3	11	0	0
3	39606220	.	C	T	2	5	7	0	0	7	0	0
3	39612261	.	T	A	17	12	29	0	0	29	0	0
3	39612430	.	T	C	12	10	22	0	2	24	0	0
3	39612579	.	G	C	13	13	26	0	0	26	0	0
3	39612715	.	A	T	11	10	21	0	0	21	0	0
3	39613024	.	T	C	17	19	36	0	1	37	0	0
3	39631505	.	T	C	2	4	6	0	1	7	0	0
3	39686776	.	T	A	2	2	4	0	0	4	0	0
3	39686807	.	A	T	2	3	5	0	0	5	0	0
3	39688558	.	T	G	1	2	3	0	0	3	0	0
3	39688892	.	T	C	4	3	7	0	0	7	0	0
3	39688906	.	C	T	3	1	4	0	0	4	0	0
3	39689234	.	G	T	1	5	6	0	2	8	0	0
3	39689277	.	A	G	4	4	8	0	0	8	0	0
3	39691978	.	C	G	4	3	7	0	1	8	0	0
3	39692008	.	G	T	3	6	9	0	1	10	0	0
3	39692165	.	A	T	1	4	5	0	0	5	0	0
3	39692196	.	C	T	1	6	7	0	5	12	0	0
3	39692206	.	C	T	6	5	11	0	1	12	0	0
3	39692235	.	C	A	7	9	16	0	1	17	0	0
3	39692265	.	G	A	11	10	21	0	0	21	0	0
3	39692307	.	A	G	10	13	23	0	2	25	0	0
3	39945696	.	A	G	2	3	5	0	1	6	0	0
3	39949389	.	G	A	3	2	5	0	0	5	0	0
3	39949650	.	G	A	0	8	8	0	3	11	0	0
3	39950340	.	C	T	5	4	9	0	0	9	0	0
3	39950414	.	T	C	12	5	17	0	0	17	0	0
3	39950954	.	T	C	3	5	8	0	0	8	0	0
3	39951124	.	C	T	6	3	9	0	2	11	0	0
3	39951703	.	A	T	3	4	7	0	2	9	0	0
3	39952025	.	T	C	8	7	15	0	0	15	0	0
3	39952272	.	A	G	13	7	20	0	0	20	0	0
3	39952273	.	A	T	13	7	20	0	0	20	0	0
3	39959679	.	A	C	4	5	9	0	0	9	0	0
3	39960535	.	G	C	3	3	6	0	4	10	0	0
3	39962906	.	T	G	10	4	14	0	1	15	0	0
3	39962981	.	T	C	6	12	18	0	0	18	0	0
3	39963053	.	T	C	7	10	17	0	0	17	0	0
3	39963089	.	A	G	3	5	8	0	2	10	0	0
3	39963128	.	G	A	6	9	15	0	0	15	0	0
3	39963131	.	A	G	6	8	14	0	1	15	0	0
3	39970555	.	G	A	7	5	12	0	0	13	1	0
3	39970641	.	T	G	7	13	20	0	3	23	0	0
3	39971447	.	T	C	6	3	9	0	0	9	0	0
3	39971470	.	T	C	4	3	7	0	1	8	0	0
3	39971499	.	T	C	5	4	9	0	0	9	0	0
3	39971592	.	T	C	3	5	8	0	0	8	0	0
3	39971615	.	T	C	7	4	11	0	0	11	0	0
3	39971894	.	T	C	5	4	9	0	0	9	0	0
3	39982019	.	C	T	1	3	4	0	0	4	0	0
3	40154310	.	G	A	3	2	5	0	0	5	0	0
3	40154387	.	C	T	6	4	10	0	0	10	0	0
3	40158383	.	C	G	8	17	25	0	3	28	0	0
3	40160676	.	G	A	4	3	7	0	0	7	0	0
3	40161564	.	T	C	3	0	3	0	3	6	0	0
3	40164156	.	C	T	5	5	10	0	0	10	0	0
3	40164233	.	T	C	10	4	14	0	0	14	0	0
3	40164238	.	G	T	8	3	11	0	3	14	0	0
3	40165637	.	T	C	6	7	13	0	0	13	0	0
3	40165733	.	T	C	6	13	19	0	1	20	0	0
3	40168006	.	A	C	7	15	22	0	0	22	0	0
3	40168007	.	G	A	8	15	23	0	0	23	0	0
3	40168192	.	T	G	3	8	11	0	1	12	0	0
3	40168424	.	T	G	2	4	6	0	0	6	0	0
3	40172218	.	C	T	7	4	11	0	0	11	0	0
3	40178148	.	C	T	15	8	23	0	0	23	0	0
3	40178154	.	C	T	20	8	28	0	0	28	0	0
3	40178343	.	G	A	9	11	20	0	0	20	0	0
3	40178956	.	G	T	7	7	14	0	0	14	0	0
3	40179025	.	G	C	10	9	19	0	1	20	0	0
3	40179331	.	A	T	24	13	37	0	0	37	0	0
3	40179457	.	A	T	14	7	21	0	0	21	0	0
3	40179476	.	T	C	13	6	19	0	1	20	0	0
3	40179528	.	G	T	18	10	28	0	0	28	0	0
3	40179533	.	T	A	17	9	26	0	2	28	0	0
3	40179604	.	T	A	15	18	33	0	1	34	0	0
3	40179608	.	A	G	14	17	31	0	3	34	0	0
3	40179642	.	C	T	22	11	33	0	6	39	0	0
3	40179669	.	G	A	27	10	37	0	5	42	0	0
3	40179849	.	C	T	27	13	40	0	2	42	0	0
3	40179870	.	C	A	29	20	49	0	1	50	0	0
3	40180023	.	A	G	25	0	25	0	19	44	0	0
3	40180091	.	A	G	23	19	42	0	1	43	0	0
3	40180092	.	A	G	25	17	42	0	1	43	0	0
3	40180197	.	A	T	8	6	14	0	0	14	0	0
3	40186041	.	C	T	10	5	15	0	0	15	0	0
3	40188830	.	A	G	7	4	11	0	2	13	0	0
3	40189828	.	A	C	1	0	1	0	4	5	0	0
3	40191061	.	A	T	2	2	4	0	0	4	0	0
3	40191116	.	C	T	2	3	5	0	0	5	0	0
3	40193140	.	A	G	2	2	4	0	0	4	0	0
3	40193176	.	C	T	1	2	3	0	2	5	0	0
3	40206184	.	G	A	9	9	18	0	0	18	0	0
3	40206355	.	C	A	9	5	14	0	3	17	0	0
3	40206430	.	G	T	20	6	26	0	1	27	0	0
3	40206440	.	T	C	18	6	24	0	0	24	0	0
3	40206597	.	A	T	19	5	24	0	1	25	0	0
3	40206736	.	T	G	15	4	19	0	1	20	0	0
3	40207449	.	C	A	4	3	7	0	0	7	0	0
3	40216281	.	G	A	5	6	11	0	0	11	0	0
3	40237124	.	A	G	4	2	6	0	0	6	0	0
3	40237174	.	A	C	5	4	9	0	0	9	0	0
3	40237325	.	C	T	3	2	5	0	0	5	0	0
3	40237555	.	G	A	4	2	6	0	1	7	0	0
3	40237574	.	A	T	4	1	5	0	1	6	0	0
3	40241580	.	A	G	3	2	5	0	0	5	0	0
3	40245398	.	C	T	1	2	3	0	3	6	0	0
3	40246693	.	G	A	3	2	5	0	0	5	0	0
3	40261306	.	T	A	1	2	3	0	0	3	0	0
3	40280034	.	T	C	9	4	13	0	2	15	0	0
3	40284375	.	T	C	6	0	6	0	7	13	0	0
3	40284447	.	T	A	5	7	12	0	1	13	0	0
3	40284860	.	G	T	5	10	15	1	1	17	0	0
3	40287538	.	C	T	2	2	4	0	1	5	0	0
3	40287574	.	A	G	3	4	7	0	1	8	0	0
3	40287831	.	T	C	8	2	10	0	2	12	0	0
3	40294179	.	G	A	6	10	16	0	0	16	0	0
3	40299905	.	A	T	34	24	58	0	4	62	0	0
3	40318555	.	C	G	1	2	3	0	0	3	0	0
3	40318556	.	C	G	1	2	3	0	0	3	0	0
3	40333592	.	C	T	1	2	3	0	1	4	0	0
3	40333793	.	T	C	1	2	3	0	0	3	0	0
3	40346035	.	C	T	8	10	18	0	0	18	0	0
3	40348839	.	T	C	12	13	25	0	1	26	0	0
3	40349123	.	C	T	8	9	17	0	0	17	0	0
3	40349354	.	T	G	12	9	21	0	0	21	0	0
3	40349417	.	A	C	7	13	20	0	0	20	0	0
3	40404508	.	T	A	3	3	6	0	0	6	0	0
3	40404688	.	A	T	3	5	8	0	1	9	0	0
3	40404981	.	G	A	1	1	2	0	1	3	0	0
3	40467687	.	G	A	2	3	5	0	0	5	0	0
3	40467756	.	C	T	3	2	5	0	0	5	0	0
3	40479736	.	A	T	1	8	9	0	0	9	0	0
3	40480986	.	G	T	5	5	10	0	0	10	0	0
3	40484376	.	A	T	3	8	11	0	1	12	0	0
3	40484454	.	C	A	4	7	11	0	0	11	0	0
3	40485219	.	T	A	6	2	8	0	0	8	0	0
3	40485360	.	C	A	14	7	21	0	0	21	0	0
3	40485499	.	G	A	10	12	22	0	2	24	0	0
3	40485582	.	C	T	7	8	15	0	1	16	0	0
3	40485965	.	G	C	5	5	10	0	0	10	0	0
3	40486256	.	C	T	10	16	26	0	0	26	0	0
3	40486294	.	C	T	15	12	27	0	0	27	0	0
3	40487095	.	G	T	16	8	24	0	0	25	1	0
3	40487185	.	T	A	4	2	6	1	0	7	0	0
3	40487197	.	T	A	6	8	14	1	1	16	0	0
3	40487628	.	T	C	15	19	34	0	1	35	0	0
3	40487704	.	T	C	20	20	40	2	2	44	0	0
3	40487957	.	G	A	20	17	37	0	2	39	0	0
3	40488212	.	C	T	21	22	43	0	1	44	0	0
3	40488266	.	T	C	27	11	38	0	10	48	0	0
3	40488630	.	T	C	4	4	8	0	0	8	0	0
3	40488640	.	T	C	2	3	5	0	0	5	0	0
3	40527028	.	G	A	34	46	80	0	3	83	0	0
3	40527575	.	G	A	43	40	83	3	7	93	0	0
3	40528241	.	A	T	35	25	60	0	5	65	0	0
3	40576600	.	C	T	13	4	17	0	2	19	0	0
3	40576780	.	C	T	8	6	14	0	0	14	0	0
3	40577032	.	C	T	13	7	20	0	1	21	0	0
3	40581432	.	C	T	3	10	13	0	0	13	0	0
3	40587884	.	G	A	0	22	22	0	22	44	0	0
3	40587901	.	G	A	0	18	18	0	22	40	0	0
3	40588109	.	A	T	25	24	49	0	0	49	0	0
3	40588363	.	C	T	22	22	44	0	2	46	0	0
3	40588410	.	C	A	28	23	51	0	0	51	0	0
3	40588746	.	C	G	19	18	37	0	2	39	0	0
3	40589117	.	T	A	27	28	55	0	4	59	0	0
3	40589214	.	C	A	22	33	55	0	1	56	0	0
3	40589348	.	A	G	17	26	43	0	4	47	0	0
3	40589356	.	A	G	17	27	44	0	2	46	0	0
3	40615891	.	A	G	11	8	19	0	2	21	0	0
3	40615948	.	G	A	4	5	9	0	0	9	0	0
3	40690901	.	G	A	6	6	12	0	0	12	0	0
3	40690937	.	T	A	3	5	8	0	1	9	0	0
3	40690949	.	G	A	7	2	9	0	2	11	0	0
3	40691643	.	A	T	5	6	11	0	1	12	0	0
3	40691969	.	C	T	6	10	16	0	0	16	0	0
3	40692064	.	A	T	2	2	4	0	0	4	0	0
3	40692099	.	A	G	2	4	6	0	0	6	0	0
3	40698424	.	C	A	4	4	8	2	3	13	0	0
3	40716045	.	G	A	1	2	3	0	0	3	0	0
3	40804286	.	T	G	36	6	42	0	6	48	0	0
3	40804382	.	G	A	1	19	20	0	12	32	0	0
3	40817213	.	G	A	2	3	5	0	0	5	0	0
3	40817712	.	G	A	2	6	8	0	0	8	0	0
3	40819959	.	A	C	4	5	9	0	2	11	0	0
3	40820007	.	A	G	2	4	6	0	0	6	0	0
3	40821871	.	A	T	10	13	23	0	0	23	0	0
3	40826707	.	G	T	8	6	14	0	0	14	0	0
3	40833733	.	C	T	3	2	5	0	0	5	0	0
3	40876757	.	G	A	3	4	7	0	1	8	0	0
3	40876770	.	G	C	3	4	7	0	0	7	0	0
3	40913590	.	G	A	1	2	3	0	0	3	0	0
3	40913730	.	G	A	2	6	8	0	0	8	0	0
3	40927653	.	C	T	3	3	6	0	0	6	0	0
3	40927656	.	C	T	0	3	3	0	3	6	0	0
3	40933029	.	A	C	1	1	2	0	1	3	0	0
3	40969547	.	C	T	0	3	3	0	4	7	0	0
3	40979597	.	G	C	3	12	15	0	1	16	0	0
3	40979746	.	T	A	2	14	16	0	0	16	0	0
3	40980024	.	G	A	9	6	15	0	0	15	0	0
3	40980167	.	T	A	3	14	17	0	0	17	0	0
3	40980245	.	G	T	2	6	8	0	2	10	0	0
3	40995278	.	G	A	2	3	5	0	0	5	0	0
3	41030891	.	C	T	0	1	1	0	2	3	0	0
3	41704687	.	G	A	2	2	4	0	1	5	0	0
3	41705789	.	T	C	1	2	3	0	0	3	0	0
3	41705807	.	T	C	1	2	3	0	0	3	0	0
3	41705949	.	G	A	1	2	3	1	1	5	0	0
3	41715646	.	G	A	0	2	2	0	2	4	0	0
3	41719049	.	G	A	5	4	9	0	2	11	0	0
3	41719219	.	A	G	9	0	9	0	8	17	0	0
3	41721916	.	G	A	13	12	25	0	0	25	0	0
3	41723069	.	G	A	11	5	16	0	0	16	0	0
3	41723437	.	G	A	14	14	28	0	2	30	0	0
3	41724298	.	C	T	17	18	35	0	2	37	0	0
3	41724806	.	G	A	24	14	38	0	4	42	0	0
3	41917830	.	T	C	1	3	4	0	0	4	0	0
3	41922243	.	C	T	1	2	3	0	0	3	0	0
3	41923195	.	T	C	1	2	3	0	0	3	0	0
3	41923288	.	C	T	1	2	3	0	0	3	0	0
3	41925154	.	C	T	3	1	4	0	1	5	0	0
3	41925541	.	C	G	3	3	6	0	0	6	0	0
3	41925823	.	C	T	3	2	5	0	0	5	0	0
3	41926020	.	T	A	4	5	9	0	0	9	0	0
3	41926557	.	G	A	4	2	6	0	0	6	0	0
3	41926633	.	T	A	5	2	7	0	0	7	0	0
3	41926695	.	T	C	4	3	7	0	0	7	0	0
3	41955526	.	C	T	5	5	10	0	0	10	0	0
3	41955613	.	G	T	19	12	31	0	0	31	0	0
3	41955911	.	C	G	17	15	32	0	0	32	0	0
3	41956040	.	G	T	14	10	24	0	2	26	0	0
3	41956299	.	T	C	11	5	16	0	2	18	0	0
3	41956353	.	T	A	4	13	17	0	0	17	0	0
3	41956467	.	T	A	4	2	6	0	1	7	0	0
3	41956504	.	C	T	3	2	5	0	1	6	0	0
3	41956792	.	A	T	6	8	14	0	1	15	0	0
3	41956818	.	T	C	6	4	10	0	0	10	0	0
3	41956855	.	C	T	7	2	9	0	0	9	0	0
3	41956921	.	T	A	3	7	10	0	0	10	0	0
3	41956941	.	T	C	3	4	7	0	0	7	0	0
3	41956978	.	G	A	5	5	10	0	0	10	0	0
3	41957580	.	G	T	3	2	5	0	0	5	0	0
3	41957918	.	T	G	1	2	3	0	0	3	0	0
3	41957924	.	C	T	0	2	2	0	1	3	0	0
3	41958291	.	T	G	1	3	4	0	0	4	0	0
3	41958829	.	A	G	2	5	7	0	0	7	0	0
3	41959370	.	G	T	6	3	9	0	0	9	0	0
3	41959658	.	G	T	2	4	6	0	0	6	0	0
3	41959772	.	A	G	2	6	8	0	1	9	0	0
3	41959943	.	T	C	1	2	3	0	0	3	0	0
3	41959958	.	A	G	1	1	2	0	0	2	0	0
3	41960005	.	C	A	1	2	3	0	0	3	0	0
3	41960069	.	G	T	2	1	3	0	1	4	0	0
3	41961587	.	T	G	1	3	4	0	0	4	0	0
3	41961651	.	G	A	3	4	7	0	0	7	0	0
3	41961688	.	T	C	6	1	7	0	5	12	0	0
3	41962098	.	T	C	1	3	4	0	0	4	0	0
3	41962610	.	T	G	3	2	5	0	0	5	0	0
3	41962614	.	C	T	0	2	2	0	3	5	0	0
3	42121500	.	G	A	1	3	4	0	0	4	0	0
3	42918924	.	C	A	5	5	10	0	1	11	0	0
3	42919474	.	C	T	8	3	11	0	0	11	0	0
3	42919510	.	C	T	6	5	11	0	0	11	0	0
3	42919664	.	C	T	6	2	8	0	0	8	0	0
3	42919846	.	T	G	6	9	15	0	1	16	0	0
3	42919849	.	C	T	6	8	14	0	2	16	0	0
3	42919881	.	C	T	6	5	11	0	1	12	0	0
3	42919895	.	A	G	5	4	9	0	0	9	0	0
3	42919943	.	G	C	6	2	8	0	1	9	0	0
3	42919959	.	A	T	4	3	7	0	0	7	0	0
3	43036193	.	T	C	1	2	3	0	0	3	0	0
3	43038222	.	G	A	2	3	5	0	0	5	0	0
3	43040677	.	G	A	0	6	6	0	3	9	0	0
3	43052230	.	T	C	3	6	9	0	0	9	0	0
3	43059090	.	A	G	6	13	19	0	1	20	0	0
3	43059153	.	A	G	6	7	13	0	1	14	0	0
3	43060866	.	T	C	5	5	10	0	1	11	0	0
3	43373985	.	G	T	4	2	6	0	0	6	0	0
3	43380283	.	C	T	6	3	9	0	0	9	0	0
3	43392755	.	T	A	10	11	21	0	0	21	0	0
3	43392795	.	C	A	6	4	10	0	1	11	0	0
3	43475184	.	C	T	1	3	4	0	0	4	0	0
3	43475265	.	G	A	1	3	4	0	0	4	0	0
3	43475325	.	A	G	3	5	8	0	0	8	0	0
3	43475376	.	T	C	2	4	6	0	0	6	0	0
3	43475397	.	C	T	1	3	4	0	0	4	0	0
3	43475592	.	A	C	1	3	4	0	0	4	0	0
3	43475617	.	G	T	0	3	3	0	1	4	0	0
3	43476435	.	G	T	1	3	4	0	0	4	0	0
3	43476514	.	A	C	4	6	10	0	0	10	0	0
3	43476698	.	A	G	4	4	8	0	0	8	0	0
3	43476880	.	C	T	4	2	6	0	0	6	0	0
3	43476887	.	T	G	3	2	5	0	1	6	0	0
3	43477749	.	G	C	1	3	4	0	1	5	0	0
3	43478137	.	T	C	9	8	17	0	0	17	0	0
3	43478238	.	C	T	6	5	11	0	0	11	0	0
3	43478310	.	T	G	15	10	25	0	1	26	0	0
3	43478321	.	A	G	14	0	14	0	9	23	0	0
3	43478433	.	A	T	8	7	15	0	1	16	0	0
3	43478586	.	C	T	4	4	8	0	1	9	0	0
3	43579820	.	C	T	1	9	10	0	11	21	0	0
3	43580055	.	A	G	10	13	23	0	2	25	0	0
3	43580195	.	A	T	11	16	27	0	0	27	0	0
3	43580583	.	T	C	10	11	21	0	0	21	0	0
3	43581272	.	A	C	6	9	15	0	0	15	0	0
3	43584423	.	T	C	5	0	5	0	14	19	0	0
3	43584453	.	T	C	4	14	18	0	2	20	0	0
3	43594358	.	C	T	5	5	10	0	1	11	0	0
3	43594376	.	C	T	0	6	6	0	5	11	0	0
3	43594577	.	G	A	6	8	14	0	0	14	0	0
3	43594655	.	C	T	0	4	4	0	3	7	0	0
3	43594658	.	G	A	3	4	7	0	0	7	0	0
3	43594735	.	T	C	2	3	5	0	0	5	0	0
3	43600999	.	C	T	0	2	2	0	6	8	0	0
3	43645900	.	G	C	3	8	11	0	0	11	0	0
3	43646161	.	A	G	2	3	5	0	0	5	0	0
3	43774440	.	C	A	1	3	4	0	0	4	0	0
3	43791284	.	T	C	7	6	13	0	1	14	0	0
3	43791317	.	G	A	4	6	10	0	0	10	0	0
3	43793147	.	T	C	2	4	6	0	0	6	0	0
3	43797073	.	C	T	1	3	4	0	0	4	0	0
3	43801338	.	C	T	4	15	19	0	1	20	0	0
3	43807512	.	T	C	8	4	12	0	0	12	0	0
3	43807921	.	C	A	9	14	23	0	0	23	0	0
3	43807945	.	T	A	6	6	12	0	0	17	5	0
3	43828631	.	T	A	1	2	3	0	0	3	0	0
3	43828865	.	C	A	5	2	7	0	0	7	0	0
3	43828870	.	T	C	3	3	6	0	1	7	0	0
3	43829154	.	G	C	1	4	5	0	0	5	0	0
3	43829179	.	G	C	2	4	6	0	0	6	0	0
3	43829370	.	A	C	4	4	8	0	0	8	0	0
3	43829411	.	C	T	1	3	4	0	0	4	0	0
3	43829413	.	C	T	1	3	4	0	0	4	0	0
3	43829712	.	G	A	1	3	4	0	3	7	0	0
3	43942053	.	A	C	1	3	4	0	0	4	0	0
3	43944611	.	A	G	4	8	12	0	1	13	0	0
3	43953883	.	T	C	4	0	4	0	3	7	0	0
3	43986937	.	G	A	0	2	2	0	2	4	0	0
3	44077508	.	C	T	6	5	11	0	0	11	0	0
3	44077543	.	G	T	3	7	10	0	0	10	0	0
3	44082427	.	A	G	2	2	4	0	0	4	0	0
3	44082439	.	A	G	1	1	2	0	0	2	0	0
3	45283827	.	T	A	9	2	11	0	1	12	0	0
3	45284618	.	T	C	8	9	17	2	0	19	0	0
3	45284619	.	T	C	12	5	17	2	0	19	0	0
3	45286379	.	T	C	1	2	3	0	0	3	0	0
3	45605514	.	A	G	1	0	1	1	2	4	0	0
3	45715655	.	A	G	1	5	6	0	0	6	0	0
3	45715716	.	C	T	5	2	7	0	1	8	0	0
3	45715776	.	T	C	3	3	6	0	1	7	0	0
3	45716687	.	A	G	3	4	7	0	0	7	0	0
3	45716705	.	A	G	4	3	7	0	0	7	0	0
3	45717180	.	C	T	8	5	13	0	2	15	0	0
3	45776520	.	T	C	18	1	19	0	33	52	0	0
3	45776721	.	T	C	26	33	59	0	2	62	1	0
3	45814631	.	A	T	1	2	3	0	1	4	0	0
3	45815997	.	G	A	1	2	3	0	2	5	0	0
3	45816549	.	A	G	4	6	10	0	0	10	0	0
3	45816618	.	T	C	6	7	13	0	1	14	0	0
3	46043483	.	G	A	4	3	7	0	0	7	0	0
3	46114925	.	C	G	1	2	3	0	0	3	0	0
3	46795113	.	G	T	2	3	5	0	1	6	0	0
3	46802864	.	G	A	3	4	7	1	12	20	0	0
3	46923453	.	T	C	3	1	4	0	0	4	0	0
3	49425941	.	G	A	0	11	11	0	0	14	3	0
3	50365808	.	C	A	3	6	9	0	0	9	0	0
3	50419868	.	A	C	7	2	9	0	1	10	0	0
3	52947610	.	T	C	4	2	6	0	0	6	0	0
3	55098813	.	G	T	13	22	35	28	1	64	0	0
3	55100228	.	T	C	21	9	30	2	2	34	0	0
3	55100413	.	C	A	21	13	34	10	4	48	0	0
3	55103801	.	G	T	1	5	6	1	0	7	0	0
3	55104129	.	T	C	20	10	30	16	5	51	0	0
3	55104214	.	T	C	4	0	4	18	8	30	0	0
3	55104215	.	A	G	4	7	11	18	1	30	0	0
3	55218772	.	G	A	0	1	1	0	1	2	0	0
3	55218775	.	A	G	2	1	3	0	0	3	0	0
3	55422041	.	T	A	5	2	7	0	0	7	0	0
3	57423485	.	A	C	2	2	4	0	0	4	0	0
3	57423489	.	C	T	2	2	4	0	0	4	0	0
3	57423533	.	A	G	2	2	4	0	0	4	0	0
3	57423909	.	T	C	1	2	3	0	0	3	0	0
3	57423929	.	T	C	2	2	4	0	0	4	0	0
3	57423952	.	T	G	4	3	7	0	0	7	0	0
3	57462490	.	G	T	9	21	30	0	0	30	0	0
3	57462548	.	C	T	1	17	18	0	18	36	0	0
3	57462584	.	C	T	17	16	33	0	2	35	0	0
3	57462598	.	A	G	14	15	29	0	0	29	0	0
3	57462643	.	A	C	14	4	18	0	0	18	0	0
3	57462751	.	G	C	9	10	19	0	1	20	0	0
3	57462953	.	T	C	10	5	15	0	3	18	0	0
3	57462962	.	T	C	2	10	12	0	3	15	0	0
3	57462990	.	T	C	8	5	13	0	0	13	0	0
3	57463446	.	A	T	9	11	20	0	1	21	0	0
3	57463470	.	C	T	9	6	15	0	2	17	0	0
3	57463628	.	G	T	5	1	6	1	2	9	0	0
3	57463817	.	C	G	3	4	7	2	3	12	0	0
3	57463933	.	G	A	14	5	19	2	1	22	0	0
3	57464484	.	G	A	4	5	9	0	0	9	0	0
3	57464706	.	C	A	5	5	10	0	0	10	0	0
3	57464735	.	T	A	5	4	9	0	0	9	0	0
3	57464746	.	C	T	0	2	2	0	4	6	0	0
3	57464884	.	T	A	2	2	4	0	0	4	0	0
3	57464986	.	A	C	3	4	7	0	1	8	0	0
3	57465090	.	G	C	2	9	11	0	0	11	0	0
3	57465176	.	G	C	2	6	8	0	2	10	0	0
3	57465308	.	T	C	3	0	3	0	5	8	0	0
3	57465544	.	A	T	3	6	9	0	0	9	0	0
3	57465550	.	A	G	3	6	9	0	1	10	0	0
3	57583954	.	C	T	13	14	27	0	0	27	0	0
3	57584599	.	A	T	5	12	17	0	4	21	0	0
3	57584606	.	A	G	7	11	18	0	1	19	0	0
3	57584656	.	A	C	9	4	13	0	1	14	0	0
3	57584783	.	T	C	7	0	7	0	6	13	0	0
3	57585015	.	C	T	1	4	5	0	11	16	0	0
3	57585033	.	C	T	7	9	16	0	1	17	0	0
3	57585150	.	C	T	1	11	12	0	9	21	0	0
3	57593524	.	C	T	9	9	18	0	0	18	0	0
3	57593977	.	G	A	4	4	8	0	1	9	0	0
3	57593978	.	G	A	4	5	9	0	0	9	0	0
3	57594016	.	G	A	5	5	10	0	0	10	0	0
3	57604181	.	C	T	1	3	4	0	0	4	0	0
3	57634139	.	G	T	5	3	8	0	0	8	0	0
3	57634480	.	G	A	3	3	6	0	1	7	0	0
3	57646269	.	A	G	3	2	5	0	0	5	0	0
3	57646437	.	C	T	2	2	4	0	1	5	0	0
3	57649281	.	G	T	1	3	4	0	0	4	0	0
3	57742220	.	G	A	2	10	12	0	0	12	0	0
3	57742262	.	C	G	11	10	21	0	0	21	0	0
3	57742636	.	A	G	1	3	4	0	0	4	0	0
3	57748246	.	C	T	7	5	12	0	1	13	0	0
3	57748342	.	T	A	9	9	18	0	0	18	0	0
3	57748437	.	A	G	5	5	10	0	0	10	0	0
3	57748449	.	G	A	5	5	10	0	0	10	0	0
3	57748494	.	T	C	5	3	8	0	0	8	0	0
3	57748581	.	C	G	1	7	8	0	10	18	0	0
3	57751835	.	G	A	6	9	15	0	1	16	0	0
3	57754460	.	C	T	3	5	8	0	1	9	0	0
3	57767106	.	A	C	1	4	5	0	1	6	0	0
3	57829926	.	T	A	2	5	7	0	0	7	0	0
3	58004532	.	C	T	2	2	4	0	0	4	0	0
3	58139640	.	A	G	0	0	0	0	3	3	0	0
3	58139655	.	C	T	2	3	5	0	0	5	0	0
3	58140344	.	G	A	2	5	7	1	0	8	0	0
3	58153829	.	C	T	6	2	8	0	0	8	0	0
3	58153889	.	T	A	4	2	6	0	0	6	0	0
3	58171761	.	C	T	7	5	12	0	0	12	0	0
3	58172028	.	T	C	6	4	10	0	0	10	0	0
3	58174380	.	C	T	3	8	11	0	4	15	0	0
3	58178032	.	G	A	3	13	16	0	12	28	0	0
3	58180664	.	G	A	16	11	27	0	3	30	0	0
3	58180695	.	C	T	19	20	39	0	1	40	0	0
3	58197648	.	C	T	5	5	10	5	0	15	0	0
3	58197871	.	G	A	1	2	3	3	1	7	0	0
3	58221912	.	C	A	1	3	4	0	0	4	0	0
3	58221914	.	A	G	1	3	4	0	0	4	0	0
3	58608283	.	C	G	0	7	7	4	1	12	0	0
3	58608335	.	G	A	1	2	3	6	0	9	0	0
3	58615466	.	C	T	2	2	4	1	0	5	0	0
3	58710350	.	T	C	3	6	9	1	0	10	0	0
3	58710351	.	T	A	6	3	9	1	0	10	0	0
3	60055408	.	G	A	5	2	7	0	0	7	0	0
3	60596020	.	G	A	9	2	11	1	1	13	0	0
3	60601907	.	A	T	2	4	6	0	1	7	0	0
3	60601958	.	G	A	5	3	8	1	0	9	0	0
3	60731330	.	G	A	0	2	2	0	1	3	0	0
3	60731916	.	G	A	2	3	5	3	1	9	0	0
3	60731956	.	G	A	0	2	2	1	4	7	0	0
3	60732306	.	C	A	4	2	6	0	0	6	0	0
3	60732406	.	C	T	3	5	8	1	0	9	0	0
3	60732416	.	G	A	3	3	6	1	1	8	0	0
3	60732551	.	C	T	4	2	6	0	0	6	0	0
3	60789730	.	C	A	2	3	5	0	0	5	0	0
3	60795738	.	A	G	2	0	2	0	2	4	0	0
3	60816434	.	A	C	1	2	3	0	0	3	0	0
3	60976921	.	C	T	5	2	7	0	0	7	0	0
3	60982492	.	A	C	1	3	4	0	1	5	0	0
3	60985862	.	C	T	4	2	6	0	0	6	0	0
3	60992134	.	A	G	3	0	3	0	5	8	0	0
3	60994781	.	G	C	6	3	9	0	0	9	0	0
3	60997781	.	C	G	9	6	15	0	0	15	0	0
3	61004295	.	G	A	0	6	6	0	6	12	0	0
3	61004397	.	C	T	4	4	8	0	0	8	0	0
3	61004442	.	G	T	4	3	7	0	1	8	0	0
3	61013397	.	C	T	6	5	11	0	0	11	0	0
3	61026883	.	G	T	12	7	19	0	0	19	0	0
3	61030127	.	G	A	11	9	20	0	3	23	0	0
3	61030181	.	C	T	15	9	24	0	1	25	0	0
3	61030220	.	C	T	19	7	26	0	1	27	0	0
3	61030699	.	G	C	15	11	26	0	0	26	0	0
3	61030800	.	G	A	18	8	26	0	4	30	0	0
3	61030829	.	G	A	16	15	31	0	2	33	0	0
3	61033183	.	C	T	25	20	45	0	3	48	0	0
3	61033859	.	C	A	22	20	42	0	10	52	0	0
3	61033979	.	C	A	27	34	61	0	1	62	0	0
3	61034060	.	T	G	27	0	27	0	36	63	0	0
3	61034096	.	T	C	26	30	56	1	4	61	0	0
3	61034418	.	T	A	1	2	3	1	0	4	0	0
3	61108600	.	G	T	22	9	31	0	0	31	0	0
3	61108732	.	A	G	18	17	35	0	3	38	0	0
3	61108734	.	T	C	19	1	20	0	18	38	0	0
3	61108830	.	C	A	1	17	18	0	18	36	0	0
3	61111826	.	G	T	9	3	12	0	3	15	0	0
3	61116160	.	C	T	3	3	6	0	0	6	0	0
3	61280579	.	T	G	2	0	2	0	4	6	0	0
3	61280717	.	A	G	5	0	5	0	7	12	0	0
3	61285784	.	C	T	5	6	11	0	1	12	0	0
3	61285947	.	A	G	2	0	2	0	8	10	0	0
3	61286325	.	C	G	5	0	5	0	5	10	0	0
3	61286468	.	C	T	2	5	7	0	0	7	0	0
3	61286528	.	A	T	5	5	10	0	0	10	0	0
3	61286576	.	C	T	4	7	11	0	1	12	0	0
3	61286889	.	T	C	2	12	14	0	1	15	0	0
3	61286998	.	G	A	0	13	13	0	11	24	0	0
3	61287010	.	A	G	10	11	21	0	0	21	0	0
3	61287094	.	A	G	6	0	6	0	5	11	0	0
3	61287214	.	A	T	11	6	17	0	0	17	0	0
3	61287260	.	G	T	7	7	14	0	0	14	0	0
3	61287289	.	C	T	7	7	14	0	0	14	0	0
3	61287343	.	G	T	15	8	23	0	0	23	0	0
3	61287491	.	T	A	15	5	20	0	0	20	0	0
3	61287627	.	C	G	10	11	21	0	1	22	0	0
3	61287893	.	T	G	15	0	15	0	22	37	0	0
3	61288028	.	T	C	17	15	32	0	0	32	0	0
3	61288238	.	A	C	11	23	34	0	1	35	0	0
3	61307099	.	C	T	0	2	2	0	1	3	0	0
3	61342032	.	C	T	0	7	7	0	5	12	0	0
3	61342341	.	G	T	6	3	9	0	0	9	0	0
3	61342770	.	G	A	5	8	13	0	2	15	0	0
3	61343014	.	T	A	6	5	11	0	0	11	0	0
3	61343019	.	T	A	7	4	11	0	0	11	0	0
3	61343076	.	C	T	2	3	5	0	2	7	0	0
3	61343077	.	A	G	4	3	7	0	0	7	0	0
3	61343589	.	T	C	1	2	3	0	0	3	0	0
3	61349556	.	C	G	4	6	10	0	0	10	0	0
3	61349602	.	G	A	5	5	10	0	0	10	0	0
3	61349654	.	C	T	3	4	7	0	0	7	0	0
3	61349734	.	G	A	5	5	10	0	0	10	0	0
3	61349887	.	A	T	4	2	6	0	0	6	0	0
3	61350466	.	T	A	1	3	4	0	0	4	0	0
3	61350487	.	T	C	2	2	4	0	0	4	0	0
3	61350667	.	C	T	2	3	5	0	0	5	0	0
3	61358195	.	T	C	4	4	8	0	0	8	0	0
3	61358196	.	T	C	4	4	8	0	0	8	0	0
3	61358265	.	C	T	3	4	7	0	1	8	0	0
3	61358269	.	G	A	5	3	8	0	0	8	0	0
3	61358547	.	C	T	1	1	2	0	0	2	0	0
3	61358787	.	C	T	2	2	4	0	0	4	0	0
3	61359056	.	G	A	2	2	4	0	0	4	0	0
3	61365083	.	C	T	6	2	8	3	1	12	0	0
3	61365135	.	G	A	5	3	8	1	1	10	0	0
3	61372259	.	G	A	2	3	5	0	0	5	0	0
3	61383062	.	A	T	2	2	4	1	1	6	0	0
3	61383072	.	C	T	0	3	3	1	2	6	0	0
3	61392048	.	A	G	2	0	2	0	4	6	0	0
3	61396523	.	C	T	4	2	6	0	0	6	0	0
3	61396891	.	C	A	2	2	4	0	0	4	0	0
3	61396936	.	G	T	3	4	7	0	0	7	0	0
3	61396958	.	A	G	5	2	7	0	0	7	0	0
3	61397093	.	C	T	4	4	8	0	0	8	0	0
3	61397231	.	C	A	6	5	11	0	0	11	0	0
3	61397294	.	C	T	5	5	10	0	0	10	0	0
3	61398272	.	A	T	1	3	4	0	0	4	0	0
3	61398456	.	C	T	3	2	5	0	0	5	0	0
3	61398582	.	A	G	9	5	14	0	0	14	0	0
3	61398612	.	C	T	10	8	18	0	1	19	0	0
3	61398728	.	A	G	9	10	19	0	2	21	0	0
3	61398809	.	T	C	10	16	26	0	1	27	0	0
3	61398882	.	T	C	2	3	5	0	0	5	0	0
3	61401523	.	T	C	3	3	6	0	0	6	0	0
3	61401583	.	A	C	1	2	3	0	1	4	0	0
3	61401662	.	T	G	1	2	3	0	0	3	0	0
3	61401715	.	T	C	5	2	7	0	0	7	0	0
3	61430396	.	T	C	1	3	4	0	0	4	0	0
3	61430403	.	C	G	0	3	3	0	1	4	0	0
3	61542663	.	G	A	1	3	4	0	2	6	0	0
3	61542700	.	C	T	1	2	3	0	0	3	0	0
3	61566559	.	G	A	2	4	6	0	0	6	0	0
3	62035030	.	G	A	0	2	2	0	2	4	0	0
3	62037105	.	T	C	2	3	5	0	0	5	0	0
3	62037430	.	A	G	2	0	2	0	2	4	0	0
3	62038526	.	T	C	4	4	8	0	0	8	0	0
3	62038739	.	G	C	4	3	7	0	0	7	0	0
3	62038993	.	G	A	0	5	5	0	4	9	0	0
3	62039278	.	A	G	8	0	8	0	13	21	0	0
3	62039657	.	G	A	1	5	6	0	5	11	0	0
3	62039689	.	C	A	7	8	15	0	0	15	0	0
3	62039718	.	G	A	8	9	17	0	1	18	0	0
3	62039813	.	T	A	11	8	19	0	0	19	0	0
3	62040555	.	G	A	13	10	23	0	2	25	0	0
3	62051107	.	C	T	12	6	18	0	0	18	0	0
3	62051125	.	C	T	9	4	13	0	0	13	0	0
3	62051395	.	A	G	9	9	18	0	0	18	0	0
3	62051660	.	T	A	12	8	20	0	2	22	0	0
3	62051731	.	G	A	2	3	5	0	0	5	0	0
3	62091398	.	A	G	1	5	6	0	0	6	0	0
3	62091632	.	T	A	7	13	20	0	0	20	0	0
3	62091660	.	T	A	7	13	20	0	3	23	0	0
3	62091880	.	C	T	13	14	27	0	3	30	0	0
3	62091975	.	C	A	19	10	29	0	1	30	0	0
3	62091995	.	G	T	20	9	29	0	0	29	0	0
3	62092025	.	C	T	0	9	9	0	17	26	0	0
3	62092262	.	T	A	6	9	15	0	2	17	0	0
3	62092279	.	A	T	5	6	11	0	1	12	0	0
3	62092666	.	G	A	11	5	16	0	1	17	0	0
3	62092715	.	A	C	7	14	21	0	0	21	0	0
3	62092749	.	G	C	4	10	14	0	0	14	0	0
3	62092801	.	C	T	7	5	12	0	1	13	0	0
3	62092902	.	A	T	3	5	8	0	2	10	0	0
3	62093241	.	T	A	9	5	14	0	0	14	0	0
3	62095887	.	T	C	1	0	1	0	2	3	0	0
3	62095940	.	G	C	1	2	3	0	0	3	0	0
3	62095980	.	A	C	1	3	4	0	0	4	0	0
3	62126986	.	C	T	1	1	2	0	0	2	0	0
3	62126992	.	T	A	1	1	2	0	1	3	0	0
3	62127168	.	C	T	3	2	5	0	0	5	0	0
3	62138746	.	A	G	15	5	20	0	0	20	0	0
3	62149774	.	C	T	3	2	5	0	0	5	0	0
3	62167559	.	G	A	0	2	2	0	2	4	0	0
3	62173443	.	A	T	7	6	13	0	0	13	0	0
3	62173459	.	C	T	3	3	6	0	1	7	0	0
3	62173503	.	G	T	5	6	11	0	1	12	0	0
3	62173546	.	C	T	3	12	15	0	1	16	0	0
3	62173593	.	T	C	7	8	15	0	0	15	0	0
3	62173628	.	T	C	10	9	19	0	2	21	0	0
3	62196977	.	C	T	4	9	13	0	0	13	0	0
3	62203509	.	G	A	7	6	13	0	1	14	0	0
3	62203653	.	T	A	6	4	10	0	1	11	0	0
3	62208925	.	G	A	1	2	3	0	4	7	0	0
3	62209024	.	A	G	3	6	9	0	0	9	0	0
3	62209033	.	A	G	4	4	8	0	0	8	0	0
3	62209183	.	A	G	3	0	3	0	4	7	0	0
3	62209216	.	A	G	7	4	11	0	0	11	0	0
3	62238997	.	T	G	2	1	3	0	3	6	0	0
3	62275115	.	A	T	1	2	3	0	0	3	0	0
3	62276009	.	A	T	4	3	7	0	0	7	0	0
3	62276101	.	G	A	1	4	5	0	1	6	0	0
3	62276104	.	A	G	2	3	5	0	1	6	0	0
3	62323564	.	C	T	1	5	6	0	0	6	0	0
3	62324109	.	G	A	0	2	2	0	2	4	0	0
3	62324125	.	C	T	3	2	5	1	0	6	0	0
3	62324312	.	T	C	2	5	7	1	0	8	0	0
3	62328846	.	G	C	5	5	10	0	0	10	0	0
3	62328970	.	A	G	2	7	9	2	0	11	0	0
3	62329199	.	A	G	4	0	4	3	4	11	0	0
3	62329545	.	G	T	5	5	10	0	0	10	0	0
3	62345770	.	A	T	3	3	6	0	0	6	0	0
3	62353952	.	G	A	2	1	3	0	2	5	0	0
3	62359440	.	G	T	11	11	22	0	2	24	0	0
3	62360484	.	C	T	12	11	23	0	4	27	0	0
3	62360686	.	G	A	1	3	4	0	0	4	0	0
3	62360736	.	C	A	3	3	6	0	0	6	0	0
3	62370381	.	A	G	1	3	4	0	0	4	0	0
3	62382863	.	A	G	40	33	73	0	2	76	1	0
3	62383438	.	G	A	30	25	55	0	1	56	0	0
3	62383439	.	A	G	30	27	57	0	0	57	0	0
3	62383565	.	T	A	29	21	50	0	5	55	0	0
3	62383589	.	A	C	31	20	51	0	0	51	0	0
3	62383610	.	G	C	28	1	29	0	20	49	0	0
3	62383706	.	C	T	31	20	51	0	2	53	0	0
3	62383992	.	C	G	11	15	26	2	0	28	0	0
3	62384055	.	G	A	11	13	24	4	0	28	0	0
3	62384112	.	T	A	4	4	8	2	1	11	0	0
3	62384208	.	C	T	2	30	32	0	18	50	0	0
3	62384219	.	G	A	32	10	42	0	2	45	1	0
3	62384423	.	C	G	26	23	49	0	2	51	0	0
3	62384428	.	T	A	23	25	48	0	6	54	0	0
3	62384565	.	C	G	21	16	37	1	3	41	0	0
3	62386420	.	T	C	22	0	22	0	18	40	0	0
3	62386955	.	G	T	13	15	28	0	1	29	0	0
3	62387141	.	C	T	1	7	8	0	12	20	0	0
3	62387144	.	C	T	7	11	18	0	0	18	0	0
3	62433064	.	C	T	9	4	13	0	1	14	0	0
3	62433138	.	T	G	8	7	15	0	2	17	0	0
3	62521137	.	G	A	8	7	15	0	0	15	0	0
3	62521142	.	T	C	7	0	7	0	8	15	0	0
3	62521263	.	T	A	14	13	27	0	1	28	0	0
3	62521956	.	G	A	5	5	10	0	2	12	0	0
3	62522063	.	A	T	9	3	12	0	0	12	0	0
3	62522065	.	G	T	8	2	10	0	1	11	0	0
3	62522564	.	T	A	2	3	5	0	0	5	0	0
3	62522899	.	C	G	5	2	7	0	0	7	0	0
3	62523031	.	A	G	1	8	9	1	1	11	0	0
3	62523032	.	A	T	8	2	10	1	0	11	0	0
3	62523325	.	G	T	2	3	5	0	0	5	0	0
3	62527379	.	G	T	2	3	5	0	1	6	0	0
3	62527397	.	G	T	2	2	4	0	0	4	0	0
4	307642	.	A	G	1	0	1	0	2	3	0	0
4	308804	.	T	A	20	5	25	0	4	29	0	0
4	313108	.	A	C	21	20	41	0	0	41	0	0
4	317091	.	A	G	13	27	40	0	0	40	0	0
4	317275	.	G	T	6	8	14	0	2	16	0	0
4	317658	.	C	T	1	2	3	0	1	4	0	0
4	317872	.	G	A	5	2	7	0	1	8	0	0
4	325073	.	C	T	1	4	5	0	0	5	0	0
4	325126	.	G	A	2	9	11	0	1	12	0	0
4	325136	.	G	A	2	10	12	0	3	15	0	0
4	325161	.	A	C	7	1	8	0	15	23	0	0
4	352284	.	A	G	3	0	3	0	3	6	0	0
4	352289	.	T	C	2	3	5	0	0	5	0	0
4	352504	.	T	C	2	9	11	0	0	11	0	0
4	353049	.	A	T	3	5	8	0	0	8	0	0
4	353064	.	C	G	3	6	9	0	0	9	0	0
4	353379	.	A	T	4	4	8	0	0	8	0	0
4	353481	.	A	G	6	0	6	0	3	9	0	0
4	353638	.	C	T	3	3	6	0	1	7	0	0
4	353778	.	T	A	3	2	5	0	0	5	0	0
4	357887	.	T	G	1	2	3	0	0	3	0	0
4	385092	.	C	T	18	10	28	0	8	36	0	0
4	385625	.	A	T	3	2	5	1	1	7	0	0
4	385668	.	G	A	6	10	16	0	0	16	0	0
4	385710	.	T	C	14	9	23	0	2	25	0	0
4	386014	.	A	C	29	8	37	0	6	43	0	0
4	386037	.	T	G	23	12	35	0	2	37	0	0
4	386085	.	G	A	15	11	26	0	1	27	0	0
4	386124	.	C	A	7	6	13	0	7	20	0	0
4	386537	.	T	A	26	19	45	0	8	53	0	0
4	386538	.	T	A	39	20	59	0	1	60	0	0
4	386961	.	G	A	32	18	50	7	3	60	0	0
4	387118	.	T	C	8	3	11	0	9	20	0	0
4	394020	.	T	C	47	24	71	0	8	80	1	0
4	397913	.	A	G	7	9	16	0	0	16	0	0
4	659345	.	T	C	2	3	5	0	0	5	0	0
4	660571	.	G	A	1	6	7	0	0	7	0	0
4	667358	.	T	C	6	8	14	0	1	15	0	0
4	667382	.	A	G	7	0	7	0	7	14	0	0
4	674838	.	T	C	13	9	22	0	1	23	0	0
4	675080	.	T	C	4	8	12	0	1	13	0	0
4	676942	.	A	G	9	8	17	0	1	18	0	0
4	678853	.	C	T	8	13	21	0	1	22	0	0
4	679441	.	C	G	1	6	7	0	14	21	0	0
4	680314	.	G	T	7	3	10	0	1	11	0	0
4	680320	.	C	T	7	4	11	0	1	12	0	0
4	680359	.	C	T	9	6	15	0	1	16	0	0
4	680395	.	T	C	10	0	10	0	9	19	0	0
4	680404	.	G	A	10	8	18	0	0	18	0	0
4	681595	.	G	A	5	2	7	0	0	7	0	0
4	686987	.	G	A	0	2	2	0	1	3	0	0
4	686999	.	C	G	4	2	6	0	0	6	0	0
4	694254	.	T	C	3	4	7	0	2	9	0	0
4	694680	.	A	C	3	6	9	0	0	9	0	0
4	694718	.	G	A	1	7	8	0	0	8	0	0
4	694741	.	T	G	2	5	7	0	1	8	0	0
4	694757	.	A	T	2	5	7	0	1	8	0	0
4	700281	.	A	C	9	8	17	0	1	18	0	0
4	700284	.	G	T	1	9	10	0	9	19	0	0
4	700563	.	G	T	14	8	22	0	1	23	0	0
4	700569	.	G	A	2	8	10	0	11	21	0	0
4	700598	.	A	T	3	8	11	0	4	15	0	0
4	700606	.	T	C	5	9	14	0	0	14	0	0
4	700634	.	A	C	6	4	10	0	0	10	0	0
4	702130	.	G	A	2	15	17	0	0	17	0	0
4	736442	.	A	G	9	12	21	0	0	21	0	0
4	737636	.	A	T	10	10	20	0	1	21	0	0
4	737927	.	T	G	5	5	10	0	1	11	0	0
4	740435	.	A	T	8	9	17	0	1	18	0	0
4	740921	.	T	C	7	7	14	0	1	15	0	0
4	749803	.	G	A	6	3	9	0	0	9	0	0
4	749989	.	G	T	6	6	12	0	0	12	0	0
4	750016	.	T	C	4	0	4	0	7	11	0	0
4	750526	.	C	G	5	4	9	0	0	9	0	0
4	750531	.	C	T	6	4	10	0	0	10	0	0
4	750661	.	C	T	0	5	5	0	5	10	0	0
4	751275	.	A	G	1	3	4	0	0	4	0	0
4	751640	.	T	G	5	4	9	0	0	9	0	0
4	765112	.	A	G	6	9	15	0	3	18	0	0
4	766575	.	G	A	10	10	20	0	1	21	0	0
4	766588	.	G	A	13	7	20	0	1	21	0	0
4	766613	.	A	C	10	7	17	0	1	18	0	0
4	769533	.	A	T	7	6	13	0	0	13	0	0
4	769726	.	G	A	6	7	13	0	1	14	0	0
4	772363	.	C	T	3	9	12	0	0	12	0	0
4	778111	.	G	A	5	2	7	0	0	7	0	0
4	779310	.	G	A	4	3	7	0	0	7	0	0
4	783816	.	G	T	22	22	44	0	2	46	0	0
4	783835	.	A	G	19	21	40	0	3	43	0	0
4	784002	.	T	A	20	19	39	0	1	41	1	0
4	784177	.	T	C	26	20	46	0	5	51	0	0
4	784325	.	A	T	14	10	24	0	2	26	0	0
4	784373	.	T	A	5	7	12	0	0	12	0	0
4	784733	.	T	A	7	3	10	0	0	10	0	0
4	784854	.	C	A	5	2	7	0	0	7	0	0
4	784990	.	T	A	11	17	28	0	3	31	0	0
4	785011	.	T	C	12	8	20	0	6	26	0	0
4	785132	.	G	A	20	17	37	0	1	38	0	0
4	787098	.	T	G	4	1	5	0	9	14	0	0
4	788970	.	G	C	6	0	6	0	6	12	0	0
4	789589	.	A	G	9	4	13	0	0	13	0	0
4	798743	.	G	C	4	5	9	0	0	9	0	0
4	798804	.	G	A	14	16	30	0	1	31	0	0
4	798850	.	A	C	24	12	36	0	3	39	0	0
4	798861	.	G	T	29	13	42	0	1	43	0	0
4	799006	.	G	T	22	17	39	0	2	41	0	0
4	799090	.	T	C	19	12	31	1	1	33	0	0
4	799127	.	T	G	21	15	36	0	1	37	0	0
4	799245	.	G	A	19	11	30	0	0	30	0	0
4	799385	.	C	G	4	4	8	0	0	8	0	0
4	799475	.	A	G	9	13	22	0	0	22	0	0
4	799513	.	G	A	14	17	31	0	3	34	0	0
4	799620	.	C	T	23	14	37	0	0	37	0	0
4	799643	.	T	A	23	10	33	0	6	39	0	0
4	799933	.	C	T	23	18	41	0	2	43	0	0
4	800027	.	C	T	13	13	26	0	0	26	0	0
4	800094	.	A	G	22	12	34	0	0	34	0	0
4	800113	.	A	G	21	13	34	0	2	36	0	0
4	800363	.	C	T	2	19	21	0	13	34	0	0
4	800520	.	T	C	22	15	37	0	1	38	0	0
4	802909	.	T	A	21	15	36	0	4	40	0	0
4	803862	.	T	C	11	0	11	0	7	18	0	0
4	806319	.	G	A	6	8	14	0	0	14	0	0
4	806322	.	T	C	6	8	14	0	0	14	0	0
4	807895	.	C	G	4	7	11	0	2	13	0	0
4	807898	.	A	G	5	8	13	0	2	15	0	0
4	809512	.	T	C	8	0	8	0	4	12	0	0
4	809549	.	A	G	3	5	8	0	0	8	0	0
4	813157	.	G	A	2	3	5	0	0	5	0	0
4	813226	.	A	G	2	6	8	0	0	8	0	0
4	844545	.	C	A	10	3	13	0	0	13	0	0
4	844547	.	T	C	10	1	11	0	2	13	0	0
4	861856	.	T	A	2	4	6	0	0	6	0	0
4	862009	.	A	G	6	6	12	0	1	13	0	0
4	864324	.	T	A	8	5	13	0	1	14	0	0
4	864712	.	C	T	6	6	12	0	0	12	0	0
4	864739	.	G	C	6	7	13	0	0	13	0	0
4	867454	.	A	G	3	3	6	0	0	6	0	0
4	867601	.	G	C	4	2	6	0	0	6	0	0
4	870833	.	C	T	0	2	2	0	5	7	0	0
4	870876	.	C	T	4	3	7	0	0	7	0	0
4	872296	.	T	C	3	0	3	0	4	7	0	0
4	873763	.	C	G	5	4	9	0	0	9	0	0
4	874241	.	G	T	4	2	6	0	0	6	0	0
4	880318	.	G	T	1	2	3	0	0	3	0	0
4	880323	.	C	G	2	2	4	0	0	4	0	0
4	958978	.	A	T	3	2	5	0	0	5	0	0
4	961542	.	G	A	2	4	6	0	1	7	0	0
4	965124	.	C	G	0	2	2	0	1	3	0	0
4	971765	.	A	G	7	3	10	0	1	11	0	0
4	971842	.	G	C	2	4	6	0	8	14	0	0
4	974482	.	C	T	5	4	9	0	0	9	0	0
4	975735	.	G	C	0	10	10	0	15	25	0	0
4	975758	.	C	T	10	12	22	0	1	23	0	0
4	975792	.	G	C	0	7	7	0	7	14	0	0
4	975938	.	T	C	11	9	20	0	0	20	0	0
4	982892	.	G	A	4	10	14	0	3	17	0	0
4	982893	.	T	C	10	5	15	0	1	16	0	0
4	982938	.	C	G	4	4	8	0	0	8	0	0
4	986133	.	A	G	2	3	5	0	0	5	0	0
4	986210	.	T	C	1	3	4	0	0	4	0	0
4	986350	.	C	A	1	7	8	0	5	13	0	0
4	1054775	.	G	A	14	19	33	0	0	33	0	0
4	1055081	.	C	T	20	4	24	0	1	25	0	0
4	1055095	.	T	A	14	3	17	0	2	19	0	0
4	1055149	.	A	G	6	2	8	0	0	8	0	0
4	1055454	.	T	G	22	25	47	0	3	50	0	0
4	1055526	.	T	C	19	13	32	4	0	36	0	0
4	1055671	.	G	A	14	10	24	1	2	27	0	0
4	1055724	.	C	T	11	10	21	0	1	22	0	0
4	1055770	.	A	G	17	11	28	0	2	30	0	0
4	1055807	.	G	C	10	14	24	0	6	30	0	0
4	1055831	.	T	A	17	8	25	0	3	28	0	0
4	1055863	.	A	T	10	19	29	0	2	31	0	0
4	1055868	.	G	A	17	14	31	0	0	31	0	0
4	1389028	.	A	G	9	14	23	0	0	23	0	0
4	1392957	.	G	A	5	8	13	0	0	13	0	0
4	1652192	.	C	T	1	4	5	0	6	11	0	0
4	1844939	.	A	G	1	2	3	0	0	3	0	0
4	2548968	.	T	C	6	9	15	0	0	15	0	0
4	3338195	.	A	G	2	5	7	0	1	8	0	0
4	3338219	.	A	G	3	0	3	1	3	7	0	0
4	4111252	.	A	T	2	0	2	0	17	19	0	0
4	4225967	.	A	G	17	3	20	0	0	20	0	0
4	4225969	.	A	T	17	3	20	0	1	21	0	0
4	4228648	.	G	A	3	2	5	8	0	13	0	0
4	4228654	.	G	A	1	2	3	8	1	12	0	0
4	5422305	.	T	G	2	1	3	6	0	9	0	0
4	5422325	.	G	A	2	2	4	4	1	9	0	0
4	5457025	.	C	T	1	3	4	1	1	6	0	0
4	5849745	.	C	T	0	6	6	0	2	8	0	0
4	5849758	.	A	G	5	4	9	0	2	11	0	0
4	6432112	.	G	A	7	6	13	0	1	14	0	0
4	6436701	.	G	A	6	3	9	0	0	9	0	0
4	6436845	.	G	A	4	6	10	0	0	10	0	0
4	6449366	.	G	A	2	2	4	0	1	5	0	0
4	6455849	.	G	A	1	3	4	0	0	4	0	0
4	6506457	.	G	A	0	3	3	0	4	7	0	0
4	6508193	.	A	G	2	4	6	0	1	7	0	0
4	6508482	.	A	C	4	3	7	0	0	7	0	0
4	6579603	.	A	G	2	5	7	0	1	8	0	0
4	6579625	.	T	C	4	2	6	0	0	6	0	0
4	6639440	.	A	G	8	12	20	0	1	21	0	0
4	6639665	.	G	A	12	11	23	1	1	25	0	0
4	6639786	.	C	T	10	10	20	0	1	21	0	0
4	6640145	.	G	C	8	21	29	0	0	29	0	0
4	6640156	.	T	C	8	21	29	0	0	29	0	0
4	6645994	.	C	T	11	6	17	0	0	17	0	0
4	6646283	.	A	C	8	8	16	0	0	16	0	0
4	6646851	.	G	A	9	6	15	0	1	16	0	0
4	6749054	.	T	C	3	3	6	0	0	6	0	0
4	6749060	.	C	G	2	2	4	0	0	4	0	0
4	6749222	.	C	T	4	2	6	0	0	6	0	0
4	6799942	.	A	G	29	21	50	0	1	51	0	0
4	6800153	.	T	C	17	17	34	0	5	39	0	0
4	6800162	.	C	T	18	23	41	0	2	43	0	0
4	6800393	.	G	A	21	22	43	0	0	43	0	0
4	6802173	.	T	G	20	15	35	0	1	36	0	0
4	6802506	.	A	C	14	25	39	0	2	41	0	0
4	6802518	.	C	G	2	24	26	0	15	41	0	0
4	6990096	.	C	T	7	6	13	0	2	15	0	0
4	6990392	.	G	T	1	2	3	0	1	4	0	0
4	6990421	.	T	C	2	3	5	0	0	5	0	0
4	6990621	.	G	A	0	5	5	0	2	7	0	0
4	6990632	.	A	G	5	2	7	0	0	7	0	0
4	6991480	.	T	G	9	5	14	0	1	15	0	0
4	6991582	.	C	A	7	5	12	0	0	12	0	0
4	6991764	.	G	T	10	8	18	0	0	18	0	0
4	6991825	.	C	A	10	8	18	0	1	19	0	0
4	6991975	.	T	A	13	7	20	0	0	20	0	0
4	6992348	.	C	A	16	15	31	0	1	32	0	0
4	6992808	.	T	C	13	16	29	0	0	29	0	0
4	6992918	.	G	C	17	11	28	0	1	29	0	0
4	7211013	.	G	A	18	13	31	0	2	33	0	0
4	7211097	.	C	T	14	7	21	0	2	23	0	0
4	7211264	.	A	G	10	15	25	0	1	26	0	0
4	7211364	.	C	T	1	11	12	0	10	22	0	0
4	7212228	.	G	A	2	6	8	0	0	8	0	0
4	7212236	.	G	A	1	5	6	0	0	6	0	0
4	7212342	.	G	A	2	3	5	0	0	5	0	0
4	7212606	.	A	G	2	4	6	0	0	6	0	0
4	7212624	.	G	A	2	2	4	0	0	4	0	0
4	7222118	.	G	T	1	3	4	0	0	4	0	0
4	7546046	.	T	A	2	7	9	9	2	20	0	0
4	7549361	.	G	A	2	4	6	0	3	9	0	0
4	7652726	.	G	A	1	2	3	3	1	7	0	0
4	7653670	.	T	C	3	4	7	0	0	7	0	0
4	7653671	.	T	A	2	4	6	0	1	7	0	0
4	7653887	.	C	T	9	5	14	0	0	14	0	0
4	7653951	.	A	T	5	4	9	0	0	9	0	0
4	7659924	.	G	A	2	2	4	0	0	4	0	0
4	7665110	.	T	A	2	2	4	0	0	4	0	0
4	7666604	.	A	C	2	0	2	0	2	4	0	0
4	7713041	.	A	G	3	0	3	0	2	5	0	0
4	7713070	.	T	C	3	2	5	0	0	5	0	0
4	7713580	.	C	T	2	4	6	0	0	6	0	0
4	7718868	.	C	T	2	4	6	0	1	7	0	0
4	7726665	.	G	A	1	2	3	0	0	3	0	0
4	7726752	.	T	C	4	1	5	0	1	6	0	0
4	7729807	.	G	A	2	4	6	0	0	6	0	0
4	9012215	.	T	G	1	0	1	0	5	6	0	0
4	9012218	.	T	C	0	5	5	0	1	6	0	0
4	9104721	.	A	G	3	2	5	0	0	5	0	0
4	9208888	.	T	C	2	2	4	0	0	4	0	0
4	9618867	.	A	C	11	11	22	0	0	22	0	0
4	9838875	.	T	C	1	6	7	0	0	7	0	0
4	9854054	.	G	A	5	3	8	0	2	10	0	0
4	10044556	.	G	A	4	3	7	0	0	7	0	0
4	10044605	.	C	T	4	9	13	0	0	13	0	0
4	10044777	.	A	G	7	13	20	0	1	21	0	0
4	10045599	.	C	T	3	6	9	0	0	9	0	0
4	10045605	.	A	G	4	6	10	0	0	10	0	0
4	10128828	.	A	C	1	3	4	0	0	4	0	0
4	10553452	.	C	T	2	6	8	0	0	8	0	0
4	10553528	.	G	A	1	2	3	0	0	3	0	0
4	10558403	.	G	A	1	4	5	0	4	9	0	0
4	10559621	.	C	A	1	2	3	1	0	4	0	0
4	10560246	.	G	A	12	11	23	0	1	24	0	0
4	10560253	.	A	T	10	16	26	0	1	27	0	0
4	10560284	.	C	T	9	20	29	0	0	29	0	0
4	10560437	.	A	C	12	11	23	0	1	24	0	0
4	10560507	.	C	T	12	14	26	0	0	26	0	0
4	10560607	.	A	G	9	4	13	0	2	15	0	0
4	10560916	.	C	T	9	10	19	0	0	19	0	0
4	10561101	.	T	A	6	28	34	0	2	36	0	0
4	10612052	.	T	G	11	0	11	0	6	17	0	0
4	10614856	.	T	C	11	7	18	0	3	21	0	0
4	10614862	.	T	C	12	5	17	0	4	21	0	0
4	10712852	.	C	T	2	3	5	0	0	5	0	0
4	10761803	.	C	G	1	0	1	0	6	7	0	0
4	10783836	.	C	T	0	2	2	2	1	5	0	0
4	10784418	.	C	T	1	2	3	5	0	8	0	0
4	10904784	.	C	T	3	2	5	0	0	5	0	0
4	10908001	.	C	T	12	13	25	0	2	27	0	0
4	10908182	.	T	C	7	2	9	0	1	10	0	0
4	10908294	.	C	T	9	3	12	0	0	12	0	0
4	10908726	.	T	C	12	6	18	0	1	19	0	0
4	10974650	.	C	T	3	9	12	0	1	13	0	0
4	10974722	.	G	A	8	4	12	0	0	12	0	0
4	10974747	.	A	T	8	5	13	0	0	13	0	0
4	10975629	.	A	G	6	5	11	0	0	11	0	0
4	10975632	.	G	A	6	6	12	0	1	13	0	0
4	10976944	.	G	A	7	6	13	0	0	13	0	0
4	10982291	.	C	T	2	6	8	0	2	10	0	0
4	10982339	.	T	G	3	2	5	0	0	5	0	0
4	10982390	.	C	A	0	4	4	0	2	6	0	0
4	10987895	.	T	A	3	4	7	0	0	7	0	0
4	10988147	.	A	G	2	2	4	0	0	4	0	0
4	11053745	.	T	C	1	2	3	0	1	4	0	0
4	11053771	.	G	A	0	2	2	0	3	5	0	0
4	11053851	.	G	A	0	7	7	0	5	12	0	0
4	11054484	.	A	C	5	1	6	0	0	6	0	0
4	11054509	.	G	C	5	3	8	0	0	8	0	0
4	11366360	.	T	C	4	2	6	0	0	6	0	0
4	11366481	.	G	A	3	4	7	0	1	8	0	0
4	11366848	.	A	G	4	12	16	0	1	17	0	0
4	11366984	.	T	A	8	4	12	0	1	13	0	0
4	11367668	.	T	A	8	8	16	0	0	16	0	0
4	11367884	.	C	T	13	6	19	0	0	19	0	0
4	11367896	.	A	G	12	6	18	0	0	18	0	0
4	11368076	.	G	T	13	26	39	0	1	40	0	0
4	11368143	.	C	T	25	16	41	0	1	42	0	0
4	11368171	.	G	A	2	19	21	0	22	43	0	0
4	11368432	.	A	T	6	3	9	0	0	9	0	0
4	11414799	.	T	C	3	2	5	0	0	5	0	0
4	11414937	.	A	G	3	2	5	0	0	5	0	0
4	11419062	.	G	A	1	2	3	0	0	3	0	0
4	11422664	.	T	C	4	4	8	0	0	8	0	0
4	11427820	.	A	C	11	3	14	1	0	15	0	0
4	11431768	.	A	C	3	11	14	0	0	14	0	0
4	11432273	.	T	C	3	4	7	0	0	7	0	0
4	11432535	.	C	G	1	0	1	0	3	4	0	0
4	11441789	.	T	A	17	8	25	0	1	26	0	0
4	11442085	.	C	T	8	19	27	1	0	28	0	0
4	11444080	.	C	T	11	21	32	0	0	32	0	0
4	11444209	.	C	A	10	12	22	0	3	25	0	0
4	11445978	.	T	C	12	13	25	0	0	25	0	0
4	11446365	.	A	T	13	11	24	0	2	26	0	0
4	11446703	.	C	T	13	7	20	0	2	22	0	0
4	11446783	.	A	G	11	3	14	0	0	14	0	0
4	11447037	.	T	G	13	11	24	0	0	24	0	0
4	11447144	.	G	A	17	17	34	0	1	35	0	0
4	11447226	.	T	G	11	0	11	0	15	26	0	0
4	11447251	.	T	C	16	14	30	0	1	31	0	0
4	11447599	.	C	T	26	15	41	0	1	42	0	0
4	11447632	.	C	G	27	11	38	0	0	38	0	0
4	11448403	.	G	A	4	29	33	0	20	53	0	0
4	11448680	.	A	G	17	20	37	0	5	42	0	0
4	11458318	.	T	G	5	4	9	0	0	9	0	0
4	11461181	.	C	G	3	4	7	0	0	7	0	0
4	11461914	.	A	G	4	5	9	0	1	10	0	0
4	11462054	.	A	T	17	10	27	0	1	28	0	0
4	11470854	.	A	G	7	6	13	0	0	13	0	0
4	11470920	.	C	T	9	5	14	0	2	16	0	0
4	11471203	.	T	C	9	5	14	0	0	14	0	0
4	11472674	.	T	C	9	12	21	0	2	23	0	0
4	11476406	.	T	C	20	15	35	1	0	36	0	0
4	11476472	.	G	A	3	28	31	0	19	50	0	0
4	11476487	.	C	T	20	29	49	0	2	51	0	0
4	11476740	.	C	T	45	20	65	0	1	66	0	0
4	11477566	.	G	A	24	19	43	0	4	47	0	0
4	11480083	.	A	G	2	0	2	0	2	4	0	0
4	11480866	.	C	T	7	10	17	0	0	17	0	0
4	11482259	.	G	A	2	6	8	0	0	8	0	0
4	11482358	.	T	G	6	5	11	0	0	12	1	0
4	11482367	.	C	G	6	6	12	0	0	12	0	0
4	11482592	.	C	T	9	3	12	0	0	12	0	0
4	11487176	.	C	T	2	3	5	0	0	5	0	0
4	11573918	.	C	T	1	2	3	0	0	3	0	0
4	11709544	.	C	T	2	3	5	0	0	5	0	0
4	11712704	.	G	T	0	2	2	0	1	3	0	0
4	11712722	.	T	A	2	2	4	0	0	4	0	0
4	11713065	.	C	T	1	2	3	0	1	4	0	0
4	11728959	.	G	A	2	10	12	0	7	19	0	0
4	11729471	.	A	T	2	5	7	0	0	7	0	0
4	11729719	.	G	A	9	9	18	0	2	20	0	0
4	11729792	.	G	A	12	6	18	0	2	20	0	0
4	11730033	.	G	A	1	6	7	0	5	12	0	0
4	11730088	.	A	T	6	6	12	0	1	13	0	0
4	11730199	.	C	T	7	10	17	0	0	17	0	0
4	11730317	.	T	G	7	6	13	0	2	15	0	0
4	11730515	.	C	A	16	5	21	0	1	22	0	0
4	11732213	.	G	A	4	2	6	0	0	6	0	0
4	11732222	.	G	A	5	2	7	0	1	8	0	0
4	11732956	.	A	G	2	2	4	0	0	4	0	0
4	11733140	.	T	C	2	0	2	0	2	4	0	0
4	11733155	.	T	C	2	2	4	0	0	4	0	0
4	11780027	.	T	G	1	4	5	0	0	5	0	0
4	11780031	.	C	T	0	4	4	0	1	5	0	0
4	11780577	.	T	G	3	2	5	5	0	10	0	0
4	11780598	.	C	A	5	2	7	3	0	10	0	0
4	11780629	.	T	C	5	2	7	1	0	8	0	0
4	11804769	.	T	A	1	3	4	0	0	4	0	0
4	11804932	.	G	A	8	5	13	0	0	13	0	0
4	11805095	.	G	T	8	6	14	0	0	14	0	0
4	11805149	.	C	A	10	5	15	0	0	15	0	0
4	11805396	.	G	T	1	4	5	0	0	5	0	0
4	11805557	.	G	A	7	2	9	0	1	10	0	0
4	11806934	.	G	A	6	4	10	0	0	10	0	0
4	11806965	.	G	C	5	3	8	0	0	8	0	0
4	11814055	.	C	T	2	26	28	1	21	50	0	0
4	11814074	.	T	A	21	27	48	1	1	50	0	0
4	11814264	.	A	C	6	9	15	0	0	15	0	0
4	11814407	.	G	A	6	8	14	0	2	16	0	0
4	11814429	.	A	T	10	9	19	0	1	20	0	0
4	11814471	.	G	A	8	8	16	0	0	16	0	0
4	11814494	.	C	T	7	8	15	0	0	15	0	0
4	11814641	.	T	A	8	10	18	0	0	18	0	0
4	11814723	.	A	C	10	11	21	0	1	22	0	0
4	11814997	.	G	A	14	12	26	0	0	26	0	0
4	11815137	.	G	T	9	14	23	0	0	23	0	0
4	11815143	.	C	G	10	14	24	0	0	24	0	0
4	11815324	.	A	C	11	12	23	0	0	23	0	0
4	11815413	.	A	G	10	11	21	0	1	22	0	0
4	11815417	.	T	A	10	10	20	0	1	21	0	0
4	11815772	.	C	A	3	3	6	0	0	6	0	0
4	11816346	.	C	A	4	3	7	0	0	7	0	0
4	11816347	.	C	A	0	3	3	0	4	7	0	0
4	11816420	.	G	A	6	6	12	0	0	12	0	0
4	11816687	.	C	T	9	3	12	0	0	12	0	0
4	12013583	.	T	A	3	2	5	0	0	5	0	0
4	12020263	.	C	T	5	6	11	0	0	11	0	0
4	12021748	.	G	T	1	8	9	0	9	18	0	0
4	12021754	.	C	T	8	11	19	0	0	19	0	0
4	12022108	.	A	G	7	0	7	0	6	13	0	0
4	12023382	.	C	T	10	13	23	0	0	23	0	0
4	12025771	.	G	A	37	10	47	2	3	52	0	0
4	12026098	.	G	A	5	8	13	0	0	13	0	0
4	12026305	.	T	C	15	22	37	0	0	37	0	0
4	12026363	.	G	A	20	9	29	0	1	30	0	0
4	12026369	.	G	T	11	18	29	0	0	29	0	0
4	12026429	.	C	A	10	12	22	0	2	24	0	0
4	12026488	.	T	C	3	7	10	0	0	10	0	0
4	12034618	.	G	T	1	1	2	0	1	3	0	0
4	12075100	.	G	A	7	5	12	0	0	12	0	0
4	12076395	.	T	C	4	8	12	0	2	14	0	0
4	12089200	.	T	C	1	3	4	0	0	4	0	0
4	12103602	.	G	A	7	8	15	0	0	15	0	0
4	12103911	.	A	T	1	5	6	0	1	7	0	0
4	12104100	.	T	C	23	14	37	0	2	39	0	0
4	12230443	.	T	C	1	2	3	0	1	4	0	0
4	12231732	.	A	G	2	2	4	0	0	4	0	0
4	12232254	.	C	T	4	4	8	0	1	9	0	0
4	12232323	.	A	T	3	3	6	0	0	6	0	0
4	12232644	.	A	T	1	4	5	0	0	5	0	0
4	12233220	.	C	T	2	3	5	0	0	5	0	0
4	12233252	.	A	T	1	2	3	0	0	3	0	0
4	12234458	.	C	T	3	3	6	0	0	6	0	0
4	12234603	.	A	G	3	2	5	0	0	5	0	0
4	12234792	.	A	G	8	3	11	0	0	11	0	0
4	12234955	.	C	T	5	3	8	0	1	9	0	0
4	12235123	.	G	A	12	3	15	0	1	16	0	0
4	12235414	.	A	C	3	4	7	0	0	7	0	0
4	12235416	.	A	C	0	4	4	0	0	4	0	0
4	12235636	.	T	A	6	2	8	0	1	9	0	0
4	12235679	.	T	C	4	4	8	0	0	8	0	0
4	12235838	.	T	A	5	5	10	0	0	10	0	0
4	12236171	.	G	A	5	9	14	3	0	17	0	0
4	12236667	.	C	A	4	2	6	0	0	6	0	0
4	12237508	.	A	G	11	18	29	0	0	29	0	0
4	12238418	.	C	T	22	24	46	0	0	46	0	0
4	12238711	.	G	A	20	13	33	0	0	33	0	0
4	12238956	.	G	A	31	12	43	1	10	54	0	0
4	12243779	.	T	C	4	8	12	1	2	15	0	0
4	12244153	.	T	A	17	12	29	0	0	29	0	0
4	12244258	.	T	C	9	10	19	0	0	19	0	0
4	12244322	.	C	T	17	10	27	0	1	28	0	0
4	12244373	.	G	A	16	15	31	0	1	32	0	0
4	12245058	.	G	A	9	5	14	0	1	15	0	0
4	12245324	.	T	A	4	4	8	0	2	10	0	0
4	12245470	.	G	A	7	7	14	0	1	15	0	0
4	12265268	.	T	A	1	3	4	0	2	6	0	0
4	12265355	.	T	C	1	3	4	0	0	4	0	0
4	12270202	.	A	T	1	2	3	0	0	3	0	0
4	12298513	.	A	T	13	7	20	1	0	21	0	0
4	12304561	.	C	T	4	8	12	0	0	12	0	0
4	12306880	.	G	A	8	17	25	0	1	26	0	0
4	12317636	.	T	G	4	5	9	0	3	12	0	0
4	12317645	.	C	G	6	4	10	0	2	12	0	0
4	12317764	.	G	A	0	2	2	0	5	7	0	0
4	12381781	.	G	A	1	3	4	0	0	4	0	0
4	12381900	.	T	C	12	4	16	0	2	18	0	0
4	12382076	.	A	G	14	8	22	0	5	27	0	0
4	12382190	.	C	T	4	2	6	0	1	7	0	0
4	12382673	.	A	T	5	5	10	0	0	10	0	0
4	12382712	.	G	A	13	9	22	0	1	23	0	0
4	12382871	.	G	A	9	9	18	0	0	18	0	0
4	12382921	.	G	A	8	6	14	0	0	14	0	0
4	12384840	.	G	A	5	3	8	0	0	8	0	0
4	12384873	.	C	G	1	4	5	0	3	8	0	0
4	12612715	.	T	A	3	2	5	0	0	5	0	0
4	12620983	.	G	A	13	12	25	0	3	28	0	0
4	12657838	.	G	A	1	10	11	0	20	31	0	0
4	12657905	.	G	C	21	24	45	2	1	48	0	0
4	12678204	.	C	G	27	20	47	0	3	50	0	0
4	12678283	.	G	T	12	4	16	1	21	38	0	0
4	12678676	.	C	A	19	18	37	0	0	37	0	0
4	12678885	.	T	C	36	21	57	0	1	58	0	0
4	12679190	.	C	T	2	2	4	0	1	5	0	0
4	12715800	.	C	T	5	5	10	1	0	11	0	0
4	12715830	.	C	T	3	9	12	1	0	13	0	0
4	12715837	.	G	A	2	8	10	1	1	12	0	0
4	12715871	.	C	T	2	11	13	0	0	13	0	0
4	12719052	.	G	A	2	2	4	0	0	4	0	0
4	12719526	.	C	T	1	3	4	0	0	4	0	0
4	12755207	.	C	A	5	3	8	0	0	8	0	0
4	12755275	.	G	T	2	2	4	0	0	4	0	0
4	12760655	.	C	A	3	3	6	0	0	6	0	0
4	12772832	.	T	C	3	2	5	0	0	5	0	0
4	12793632	.	G	A	5	14	19	0	1	20	0	0
4	12793806	.	G	A	5	3	8	0	0	8	0	0
4	12793893	.	G	A	6	3	9	0	0	9	0	0
4	12793914	.	T	A	1	5	6	0	0	6	0	0
4	12793943	.	C	G	2	9	11	0	1	12	0	0
4	12794153	.	C	A	4	7	11	0	2	13	0	0
4	12794160	.	T	G	6	9	15	0	0	15	0	0
4	12795394	.	G	A	5	6	11	0	0	11	0	0
4	12893073	.	T	C	3	3	6	0	0	6	0	0
4	12893825	.	A	C	1	2	3	0	0	3	0	0
4	12893880	.	A	G	1	6	7	0	0	7	0	0
4	12902609	.	G	A	2	2	4	0	0	4	0	0
4	12917237	.	G	T	17	6	23	0	1	24	0	0
4	12917348	.	A	G	5	5	10	0	1	11	0	0
4	12917534	.	C	T	1	6	7	0	9	16	0	0
4	12917796	.	A	G	9	4	13	0	0	13	0	0
4	12971436	.	A	G	24	22	46	0	1	48	1	0
4	12971495	.	C	A	29	13	42	0	4	46	0	0
4	12971935	.	A	T	11	9	20	0	2	22	0	0
4	12972000	.	T	A	9	9	18	0	0	18	0	0
4	12972215	.	C	T	3	33	36	0	21	57	0	0
4	12976983	.	T	C	9	0	9	0	9	18	0	0
4	12978779	.	G	A	4	3	7	0	0	7	0	0
4	12978843	.	A	C	8	7	15	0	0	15	0	0
4	13035881	.	A	G	16	7	23	0	0	23	0	0
4	13035962	.	T	C	11	8	19	0	4	23	0	0
4	13036046	.	G	A	12	10	22	0	1	23	0	0
4	13036572	.	G	A	6	3	9	0	0	9	0	0
4	13041589	.	C	T	1	4	5	0	5	10	0	0
4	13054610	.	G	A	4	2	6	0	0	6	0	0
4	13056441	.	G	A	6	2	8	0	0	8	0	0
4	13457587	.	T	G	1	2	3	0	0	3	0	0
4	13457770	.	G	C	1	5	6	0	0	6	0	0
4	13458010	.	T	C	3	3	6	0	0	6	0	0
4	13458052	.	G	T	0	5	5	0	3	8	0	0
4	13458241	.	C	G	3	3	6	0	0	6	0	0
4	13458469	.	C	T	3	2	5	0	0	5	0	0
4	13458703	.	C	G	5	9	14	0	0	14	0	0
4	13458800	.	C	T	3	5	8	0	0	8	0	0
4	13458888	.	G	A	0	3	3	0	3	6	0	0
4	13459453	.	A	G	2	2	4	0	1	5	0	0
4	13459596	.	G	T	5	3	8	0	1	9	0	0
4	13459602	.	T	G	4	3	7	0	3	10	0	0
4	13459670	.	A	G	2	2	4	0	1	5	0	0
4	13459917	.	G	A	8	4	12	0	0	12	0	0
4	13459964	.	A	T	4	5	9	0	0	9	0	0
4	13460125	.	G	A	5	4	9	0	0	9	0	0
4	13460244	.	A	G	6	5	11	0	4	15	0	0
4	13460289	.	G	A	4	5	9	0	2	11	0	0
4	13460653	.	G	A	5	7	12	0	2	14	0	0
4	13460937	.	T	C	12	6	18	0	2	20	0	0
4	13461216	.	T	A	12	13	25	0	3	28	0	0
4	13461302	.	T	C	7	12	19	0	0	19	0	0
4	13555289	.	C	G	2	2	4	0	0	4	0	0
4	13555327	.	G	A	3	3	6	0	0	6	0	0
4	13557878	.	G	A	2	2	4	0	0	4	0	0
4	13557898	.	A	G	3	3	6	0	0	6	0	0
4	13557934	.	G	T	2	2	4	0	0	4	0	0
4	13564842	.	C	T	1	2	3	0	0	3	0	0
4	13570609	.	G	A	4	2	6	0	0	6	0	0
4	13570899	.	T	C	6	3	9	0	1	10	0	0
4	13571711	.	T	C	7	6	13	0	0	13	0	0
4	13572951	.	G	A	0	5	5	0	9	14	0	0
4	13575521	.	C	T	3	7	10	0	0	10	0	0
4	13575570	.	A	G	4	0	4	0	4	8	0	0
4	13575618	.	G	A	0	3	3	0	7	10	0	0
4	13575623	.	A	G	7	2	9	0	0	9	0	0
4	13575701	.	C	T	1	2	3	0	0	3	0	0
4	13575709	.	A	C	1	2	3	0	0	3	0	0
4	13575853	.	C	T	11	3	14	0	1	15	0	0
4	13575996	.	C	T	15	6	21	0	2	23	0	0
4	13576105	.	G	T	8	8	16	2	1	19	0	0
4	13576139	.	G	A	0	6	6	1	8	15	0	0
4	13591793	.	A	G	2	2	4	0	0	4	0	0
4	13592863	.	G	A	3	4	7	0	0	7	0	0
4	13593078	.	T	C	4	5	9	0	1	10	0	0
4	13593097	.	T	C	4	4	8	0	0	8	0	0
4	13595838	.	G	A	0	4	4	0	6	10	0	0
4	13597393	.	A	T	5	3	8	0	2	10	0	0
4	13597399	.	A	G	8	3	11	0	0	11	0	0
4	13597646	.	A	G	1	3	4	0	1	5	0	0
4	13597782	.	C	G	2	0	2	0	5	7	0	0
4	13597849	.	C	T	6	7	13	0	1	14	0	0
4	13604574	.	T	C	20	23	43	0	2	45	0	0
4	13626695	.	T	C	2	3	5	0	0	5	0	0
4	13628583	.	G	A	1	2	3	0	0	3	0	0
4	13629927	.	T	G	1	3	4	0	1	5	0	0
4	13631269	.	G	A	3	3	6	0	0	6	0	0
4	13640812	.	C	T	9	6	15	0	2	17	0	0
4	13642486	.	C	T	7	9	16	0	2	18	0	0
4	13642676	.	T	G	8	1	9	0	15	24	0	0
4	13643251	.	G	T	2	10	12	0	5	17	0	0
4	13643349	.	A	T	6	7	13	0	0	13	0	0
4	13643461	.	G	A	0	8	8	0	3	11	0	0
4	13643547	.	C	T	6	8	14	0	2	16	0	0
4	13723446	.	C	T	7	5	12	0	0	12	0	0
4	13723458	.	C	T	6	6	12	0	0	12	0	0
4	13724578	.	G	A	11	9	20	0	1	21	0	0
4	13724581	.	T	C	10	9	19	0	2	21	0	0
4	13728097	.	T	C	12	15	27	0	1	28	0	0
4	13747503	.	C	T	3	2	5	0	0	5	0	0
4	13747566	.	A	C	2	4	6	0	0	6	0	0
4	13747793	.	C	A	1	1	2	0	0	2	0	0
4	13747799	.	C	T	0	2	2	0	1	3	0	0
4	13750453	.	T	A	6	3	9	0	0	9	0	0
4	13753404	.	G	A	11	10	21	0	3	24	0	0
4	13755213	.	G	A	31	17	48	0	3	51	0	0
4	13755254	.	T	G	22	12	34	0	7	41	0	0
4	13755392	.	G	A	2	14	16	0	19	35	0	0
4	13755731	.	A	G	4	10	14	0	1	15	0	0
4	13755742	.	A	G	6	8	14	0	1	15	0	0
4	13755813	.	C	T	12	6	18	0	0	18	0	0
4	13756124	.	A	G	1	0	1	0	4	5	0	0
4	13756269	.	A	T	6	12	18	0	1	19	0	0
4	13756273	.	C	A	6	12	18	0	0	18	0	0
4	13859984	.	G	A	2	2	4	0	0	4	0	0
4	13861022	.	A	G	3	2	5	0	0	5	0	0
4	13893341	.	G	A	3	2	5	0	0	5	0	0
4	13893369	.	C	T	2	2	4	0	0	4	0	0
4	13893413	.	T	A	1	2	3	0	0	3	0	0
4	13905730	.	T	C	8	1	9	0	5	14	0	0
4	13905846	.	A	G	6	10	16	0	1	17	0	0
4	13905926	.	T	A	7	13	20	0	3	23	0	0
4	13906051	.	T	C	2	0	2	0	5	7	0	0
4	13906567	.	A	G	5	9	14	0	3	17	0	0
4	13925621	.	A	G	5	2	7	0	0	7	0	0
4	13925714	.	C	T	15	8	23	0	1	24	0	0
4	13928522	.	C	T	5	4	9	0	0	9	0	0
4	13929511	.	A	G	6	6	12	0	0	12	0	0
4	13943890	.	A	T	1	4	5	0	2	7	0	0
4	13943911	.	T	A	4	4	8	0	1	9	0	0
4	13944129	.	T	A	7	3	10	0	0	10	0	0
4	13963048	.	T	A	12	15	27	0	0	27	0	0
4	13963202	.	T	A	7	3	10	0	0	10	0	0
4	13963274	.	C	G	1	2	3	0	0	3	0	0
4	13963554	.	C	T	1	3	4	0	0	4	0	0
4	13963702	.	A	G	4	2	6	0	0	6	0	0
4	13964679	.	C	G	2	3	5	0	0	5	0	0
4	13965149	.	A	G	1	2	3	0	0	3	0	0
4	13965185	.	C	T	3	2	5	0	0	5	0	0
4	13965824	.	T	G	1	4	5	0	0	5	0	0
4	14190378	.	C	T	4	2	6	0	0	6	0	0
4	14193462	.	G	T	9	11	20	0	2	22	0	0
4	14193473	.	C	A	7	11	18	0	2	20	0	0
4	14194650	.	G	A	9	7	16	0	1	17	0	0
4	14247890	.	G	C	25	22	47	2	1	50	0	0
4	14248043	.	A	G	34	37	71	0	1	72	0	0
4	14248157	.	G	A	39	25	64	0	3	67	0	0
4	14248277	.	A	T	28	19	47	0	2	49	0	0
4	14248279	.	G	A	28	20	48	0	0	48	0	0
4	14248332	.	C	A	3	18	21	0	32	53	0	0
4	14248419	.	T	C	44	3	47	1	15	63	0	0
4	14248433	.	A	T	40	19	59	1	3	63	0	0
4	14248643	.	A	G	28	29	57	0	3	60	0	0
4	14248715	.	G	A	32	22	54	0	0	54	0	0
4	14248716	.	A	T	28	20	48	0	5	53	0	0
4	14248750	.	T	G	35	11	46	0	5	51	0	0
4	14248751	.	A	G	38	11	49	0	2	51	0	0
4	14248804	.	G	A	25	22	47	0	2	49	0	0
4	14248848	.	G	A	19	19	38	0	0	38	0	0
4	14248856	.	C	T	18	17	35	0	0	35	0	0
4	14248906	.	C	T	24	9	33	0	1	34	0	0
4	14248948	.	A	G	17	8	25	0	3	28	0	0
4	14248969	.	T	G	13	9	22	0	1	23	0	0
4	14249043	.	C	T	6	6	12	0	0	12	0	0
4	14249329	.	C	T	1	3	4	0	0	4	0	0
4	14249358	.	T	A	5	2	7	0	0	7	0	0
4	14249374	.	G	T	3	1	4	0	1	5	0	0
4	14249583	.	A	T	1	2	3	0	0	3	0	0
4	14249588	.	A	T	1	2	3	0	0	3	0	0
4	14249710	.	T	A	3	8	11	0	1	12	0	0
4	14249725	.	T	G	3	5	8	0	5	13	0	0
4	14249799	.	T	C	2	9	11	0	0	11	0	0
4	14249984	.	T	G	22	15	37	0	2	39	0	0
4	14250053	.	G	A	17	4	21	1	6	28	0	0
4	14250678	.	G	A	17	17	34	0	1	35	0	0
4	14250840	.	T	C	18	1	19	0	22	41	0	0
4	14282192	.	G	T	8	9	17	0	1	18	0	0
4	14282244	.	A	G	6	8	14	0	0	14	0	0
4	14282301	.	C	T	5	5	10	0	1	11	0	0
4	14303321	.	A	G	14	8	22	0	0	22	0	0
4	14311380	.	G	A	2	4	6	0	0	6	0	0
4	14326376	.	A	G	2	2	4	0	1	5	0	0
4	14906291	.	G	A	2	3	5	0	0	5	0	0
4	14909287	.	G	C	9	5	14	0	0	14	0	0
4	14909532	.	T	C	3	4	7	0	1	8	0	0
4	14917895	.	G	A	4	5	9	0	0	9	0	0
4	14918473	.	G	A	4	3	7	0	1	8	0	0
4	14918476	.	A	G	4	3	7	0	0	7	0	0
4	14918590	.	C	A	3	2	5	0	1	6	0	0
4	14919678	.	C	T	1	3	4	0	4	8	0	0
4	14926967	.	C	T	8	4	12	0	2	14	0	0
4	14928719	.	C	T	4	2	6	0	0	6	0	0
4	14928731	.	G	A	3	3	6	0	0	6	0	0
4	14928973	.	G	A	0	5	5	0	3	8	0	0
4	14929107	.	T	G	7	4	11	0	0	11	0	0
4	14932200	.	T	C	20	15	35	0	0	35	0	0
4	14932676	.	A	T	3	1	4	0	3	7	0	0
4	14932821	.	G	C	9	9	18	0	1	19	0	0
4	14932915	.	C	G	8	6	14	0	1	15	0	0
4	14933337	.	A	G	1	5	6	0	1	7	0	0
4	14933513	.	G	T	3	5	8	0	2	10	0	0
4	14938320	.	G	A	1	3	4	0	0	4	0	0
4	14938326	.	T	C	2	2	4	0	1	5	0	0
4	14968310	.	A	T	1	3	4	0	0	4	0	0
4	14979755	.	C	T	1	1	2	0	0	2	0	0
4	14979763	.	C	T	2	2	4	0	0	4	0	0
4	14992080	.	A	G	3	2	5	0	1	6	0	0
4	14992081	.	T	C	4	2	6	0	0	6	0	0
4	14992529	.	T	C	7	6	13	1	0	14	0	0
4	14993076	.	T	C	4	3	7	0	0	7	0	0
4	14994200	.	C	T	0	7	7	0	1	8	0	0
4	14995395	.	G	T	1	4	5	0	1	6	0	0
4	15003761	.	G	A	3	2	5	0	0	5	0	0
4	15009947	.	G	A	3	5	8	0	0	8	0	0
4	15009971	.	A	T	5	6	11	0	0	11	0	0
4	15010172	.	T	A	6	5	11	0	1	12	0	0
4	15010557	.	A	G	5	0	5	0	10	15	0	0
4	15010680	.	A	G	6	4	10	0	0	10	0	0
4	15058352	.	A	G	10	18	28	0	1	29	0	0
4	15058663	.	A	C	10	4	14	1	0	15	0	0
4	15058968	.	T	G	10	2	12	0	8	20	0	0
4	15059028	.	G	A	1	6	7	0	6	13	0	0
4	15059070	.	A	T	8	6	14	0	2	16	0	0
4	15059147	.	A	G	7	9	16	0	8	24	0	0
4	15059367	.	A	G	13	11	24	0	1	25	0	0
4	15059498	.	T	A	12	13	25	0	2	27	0	0
4	15059823	.	A	T	19	10	29	0	0	29	0	0
4	15081490	.	C	T	10	3	13	0	0	13	0	0
4	15081703	.	G	A	10	12	22	0	2	24	0	0
4	15081829	.	T	C	10	11	21	0	0	21	0	0
4	15081871	.	C	T	11	17	28	0	0	28	0	0
4	15081985	.	T	C	15	9	24	0	2	26	0	0
4	15082090	.	T	C	7	5	12	0	2	14	0	0
4	15082573	.	C	G	2	3	5	0	0	5	0	0
4	15096627	.	A	G	2	6	8	0	0	8	0	0
4	15218134	.	T	C	19	0	19	0	18	37	0	0
4	15218258	.	A	G	24	16	40	0	2	42	0	0
4	15218342	.	T	A	21	24	45	0	2	47	0	0
4	15218389	.	C	T	20	28	48	0	1	49	0	0
4	15218505	.	C	T	14	17	31	0	1	32	0	0
4	15218595	.	T	C	6	8	14	0	2	16	0	0
4	15218656	.	G	A	6	11	17	0	0	17	0	0
4	15218772	.	C	A	12	19	31	0	2	33	0	0
4	15218886	.	A	C	12	11	23	0	0	23	0	0
4	15219291	.	G	A	10	15	25	0	1	26	0	0
4	15219368	.	C	T	1	13	14	0	14	28	0	0
4	15219533	.	T	A	10	8	18	0	1	19	0	0
4	15219787	.	T	C	12	11	23	0	1	25	1	0
4	15219840	.	G	T	15	7	22	0	0	22	0	0
4	15219955	.	G	A	13	14	27	0	2	29	0	0
4	15220001	.	A	T	15	10	25	0	3	28	0	0
4	15220022	.	A	G	13	7	20	0	0	20	0	0
4	15238347	.	G	A	2	4	6	0	0	6	0	0
4	15500617	.	G	T	8	4	12	0	1	13	0	0
4	15500663	.	T	C	10	0	10	0	8	18	0	0
4	15500720	.	T	C	11	4	15	0	0	15	0	0
4	15585852	.	G	T	3	3	6	0	1	7	0	0
4	15601126	.	C	T	0	2	2	0	4	6	0	0
4	15603487	.	G	C	2	2	4	0	0	4	0	0
4	15630128	.	A	G	1	1	2	0	1	3	0	0
4	15630131	.	G	A	1	2	3	0	0	3	0	0
4	15636947	.	A	G	2	2	4	0	0	4	0	0
4	15799452	.	G	T	5	1	6	0	1	7	0	0
4	15799488	.	T	C	4	3	7	0	2	9	0	0
4	15816414	.	G	A	1	4	5	0	11	16	0	0
4	15981260	.	A	G	14	9	23	0	1	24	0	0
4	15981266	.	C	T	14	10	24	0	1	25	0	0
4	15981362	.	T	C	9	15	24	0	0	24	0	0
4	15981428	.	C	T	11	16	27	0	1	28	0	0
4	15984753	.	C	T	1	2	3	0	0	3	0	0
4	15988446	.	T	C	3	4	7	1	0	8	0	0
4	15989142	.	G	A	0	3	3	0	4	7	0	0
4	15989313	.	A	C	6	4	10	0	0	10	0	0
4	15989643	.	T	C	2	6	8	0	1	9	0	0
4	15989661	.	A	G	3	6	9	0	1	10	0	0
4	15989988	.	C	T	7	6	13	0	1	14	0	0
4	15991026	.	C	T	7	7	14	0	0	14	0	0
4	15992146	.	G	A	15	12	27	0	0	27	0	0
4	15992206	.	T	C	14	6	20	0	1	21	0	0
4	15993801	.	C	T	17	15	32	0	2	34	0	0
4	15993917	.	G	C	17	16	33	0	0	33	0	0
4	15993959	.	C	T	13	17	30	0	1	31	0	0
4	15995876	.	A	G	15	14	29	0	0	29	0	0
4	15996044	.	T	C	16	11	27	0	1	28	0	0
4	15996066	.	C	G	12	10	22	0	1	23	0	0
4	15998315	.	A	T	6	4	10	0	2	12	0	0
4	15999618	.	A	T	3	4	7	0	1	8	0	0
4	15999783	.	T	A	3	11	14	0	0	14	0	0
4	16001060	.	T	A	1	3	4	0	0	4	0	0
4	16077260	.	T	C	24	17	41	0	2	43	0	0
4	16078080	.	A	T	13	12	25	0	6	31	0	0
4	16078203	.	C	T	23	14	37	0	2	39	0	0
4	16078979	.	A	G	19	27	46	0	2	48	0	0
4	16081306	.	G	T	16	15	31	0	1	32	0	0
4	16085420	.	T	G	5	5	10	0	0	10	0	0
4	16086969	.	A	G	3	8	11	0	2	13	0	0
4	16086987	.	C	G	3	6	9	0	1	10	0	0
4	16087595	.	T	G	2	2	4	0	0	4	0	0
4	16088528	.	C	T	4	5	9	0	0	9	0	0
4	16088673	.	C	T	1	2	3	0	0	3	0	0
4	16090262	.	A	G	3	7	10	0	1	11	0	0
4	16098903	.	A	C	5	8	13	0	0	13	0	0
4	16098930	.	C	T	7	6	13	0	0	13	0	0
4	16319377	.	C	T	2	4	6	0	1	7	0	0
4	16319839	.	T	A	1	5	6	0	1	7	0	0
4	16320319	.	T	A	2	2	4	0	1	5	0	0
4	16320389	.	T	A	2	3	5	0	0	5	0	0
4	16368805	.	T	C	15	0	15	0	16	31	0	0
4	16368977	.	G	A	10	13	23	0	0	23	0	0
4	16369033	.	T	A	8	12	20	0	0	20	0	0
4	16369335	.	T	C	7	0	7	0	7	14	0	0
4	16369375	.	G	C	3	4	7	0	1	8	0	0
4	16369384	.	T	C	3	6	9	0	0	9	0	0
4	16536356	.	G	A	3	10	13	0	3	16	0	0
4	16536946	.	C	A	15	23	38	0	0	38	0	0
4	16537045	.	T	C	26	13	39	1	5	45	0	0
4	16537099	.	A	T	34	18	52	1	4	57	0	0
4	16537575	.	T	G	29	23	52	0	0	52	0	0
4	16537770	.	G	A	21	24	45	0	3	48	0	0
4	16538055	.	T	A	17	12	29	0	2	31	0	0
4	16539253	.	A	G	10	16	26	0	0	26	0	0
4	16615212	.	A	C	1	0	1	0	5	6	0	0
4	16632415	.	G	A	10	8	18	0	2	20	0	0
4	16632650	.	A	T	10	8	18	0	1	19	0	0
4	16632762	.	A	T	7	10	17	0	0	17	0	0
4	16632907	.	T	A	4	2	6	0	0	6	0	0
4	16633208	.	C	T	5	8	13	0	0	13	0	0
4	16633451	.	T	C	4	2	6	0	1	7	0	0
4	16634916	.	A	G	2	4	6	0	0	6	0	0
4	16634929	.	A	T	1	2	3	0	1	4	0	0
4	16635162	.	G	A	3	7	10	0	0	10	0	0
4	16635208	.	G	A	5	6	11	0	0	11	0	0
4	16635326	.	T	C	2	0	2	0	4	6	0	0
4	16641677	.	T	C	1	3	4	0	0	4	0	0
4	16649554	.	C	T	0	2	2	0	1	3	0	0
4	16650102	.	T	C	8	3	11	0	0	11	0	0
4	16650142	.	A	T	7	4	11	0	2	13	0	0
4	16650433	.	A	C	20	15	35	0	2	37	0	0
4	16650482	.	T	C	17	11	28	0	0	28	0	0
4	16650611	.	T	G	4	13	17	0	0	17	0	0
4	16650618	.	A	G	4	13	17	0	1	18	0	0
4	16651010	.	G	C	8	0	8	0	6	14	0	0
4	16651046	.	G	C	9	6	15	0	0	15	0	0
4	16651121	.	A	G	15	7	22	0	2	24	0	0
4	16651414	.	G	A	13	9	22	0	1	23	0	0
4	16652890	.	A	G	6	2	8	0	1	9	0	0
4	16654337	.	G	C	7	9	16	0	2	18	0	0
4	16654349	.	C	T	0	7	7	0	8	15	0	0
4	16666267	.	C	T	3	5	8	0	0	8	0	0
4	16671133	.	T	C	1	2	3	0	0	3	0	0
4	16671232	.	C	T	0	2	2	0	1	3	0	0
4	16672481	.	G	T	1	2	3	0	0	3	0	0
4	16672771	.	C	T	2	2	4	0	1	5	0	0
4	16733585	.	G	A	1	2	3	0	0	3	0	0
4	16739122	.	G	A	0	2	2	0	3	5	0	0
4	16741979	.	T	G	5	7	12	0	1	13	0	0
4	16742444	.	G	C	13	12	25	0	1	26	0	0
4	16784712	.	A	T	2	2	4	0	1	5	0	0
4	16784840	.	G	T	20	18	38	0	0	38	0	0
4	16784876	.	C	T	18	13	31	0	3	34	0	0
4	16785393	.	A	G	20	20	40	0	3	43	0	0
4	16785664	.	A	T	17	14	31	0	1	32	0	0
4	16785766	.	T	C	6	10	16	0	1	17	0	0
4	16786002	.	C	A	2	3	5	0	3	8	0	0
4	16786018	.	A	T	1	7	8	0	2	10	0	0
4	16786059	.	T	C	3	8	11	0	0	11	0	0
4	16786077	.	G	A	2	6	8	0	1	9	0	0
4	16786208	.	C	T	7	14	21	0	0	21	0	0
4	16791616	.	G	A	5	7	12	0	2	14	0	0
4	16791673	.	C	A	7	3	10	0	1	11	0	0
4	16791780	.	A	G	13	0	13	0	7	20	0	0
4	16791781	.	G	C	13	7	20	0	0	20	0	0
4	16791883	.	T	A	5	8	13	0	0	13	0	0
4	16791934	.	C	T	4	2	6	0	1	7	0	0
4	16829355	.	T	C	38	30	68	0	4	72	0	0
4	16829387	.	T	G	37	31	68	0	1	69	0	0
4	16829651	.	G	A	25	37	62	0	7	69	0	0
4	16831399	.	A	T	25	20	45	0	3	48	0	0
4	16832124	.	C	A	1	19	20	0	10	30	0	0
4	16832894	.	G	A	14	15	29	0	4	33	0	0
4	16858074	.	A	T	3	6	9	0	0	9	0	0
4	16858075	.	A	G	3	6	9	0	0	9	0	0
4	16858155	.	G	A	2	4	6	0	0	6	0	0
4	16858190	.	T	G	2	4	6	0	0	6	0	0
4	16858289	.	G	C	4	0	4	0	7	11	0	0
4	16858414	.	A	T	3	2	5	0	1	6	0	0
4	16858442	.	C	G	1	4	5	0	1	6	0	0
4	16876881	.	A	T	1	2	3	0	0	3	0	0
4	16877387	.	C	T	1	22	23	0	13	36	0	0
4	16879505	.	T	C	17	0	17	0	23	40	0	0
4	16881865	.	T	G	10	7	17	0	0	17	0	0
4	16893050	.	A	G	2	2	4	0	0	4	0	0
4	16893062	.	T	C	2	1	3	0	1	4	0	0
4	16898904	.	A	T	4	8	12	0	1	13	0	0
4	16899273	.	T	C	6	8	14	0	0	14	0	0
4	16904521	.	C	G	11	16	27	0	1	28	0	0
4	16904527	.	A	G	8	0	8	0	19	27	0	0
4	16905090	.	T	C	16	10	26	0	1	27	0	0
4	16905119	.	T	C	12	18	30	0	3	33	0	0
4	16905184	.	T	C	14	14	28	0	1	29	0	0
4	16905224	.	A	G	10	15	25	0	3	28	0	0
4	16905318	.	G	A	18	8	26	2	0	28	0	0
4	16905370	.	G	A	9	6	15	0	0	15	0	0
4	16905511	.	C	T	4	3	7	0	0	7	0	0
4	16905684	.	T	G	6	9	15	0	0	15	0	0
4	16905708	.	T	A	5	12	17	0	2	19	0	0
4	16905723	.	C	A	8	12	20	0	0	20	0	0
4	16905853	.	T	A	11	12	23	0	4	27	0	0
4	16906173	.	C	A	23	12	35	0	1	37	1	0
4	16906198	.	C	A	23	16	39	0	1	40	0	0
4	16906244	.	A	T	26	20	46	0	2	48	0	0
4	16906562	.	G	A	28	23	51	0	2	53	0	0
4	16982269	.	G	A	10	14	24	0	1	25	0	0
4	16982682	.	C	A	10	11	21	0	0	21	0	0
4	16983131	.	A	G	4	3	7	0	1	8	0	0
4	16983434	.	T	C	15	0	15	0	13	28	0	0
4	16984252	.	C	G	5	5	10	0	0	10	0	0
4	16988139	.	A	G	2	3	5	0	1	6	0	0
4	17253737	.	A	G	8	11	19	0	0	19	0	0
4	17253758	.	C	T	6	14	20	0	1	21	0	0
4	17253813	.	A	C	10	8	18	0	0	18	0	0
4	17253818	.	A	G	10	8	18	0	0	18	0	0
4	17253925	.	T	A	7	13	20	0	2	22	0	0
4	17253927	.	T	A	6	13	19	0	3	22	0	0
4	17254046	.	A	G	12	7	19	0	2	21	0	0
4	17257386	.	G	A	6	4	10	0	0	10	0	0
4	17260535	.	G	A	1	3	4	0	0	4	0	0
4	17287446	.	T	G	2	7	9	0	0	9	0	0
4	17288964	.	T	C	9	7	16	0	1	17	0	0
4	17291024	.	A	G	6	5	11	0	3	14	0	0
4	17292575	.	C	A	20	12	32	0	1	33	0	0
4	17292770	.	G	A	27	11	38	0	1	39	0	0
4	17292789	.	A	C	26	15	41	0	3	44	0	0
4	17292837	.	A	G	27	17	44	0	3	47	0	0
4	17294947	.	T	C	11	27	38	0	1	39	0	0
4	17296974	.	A	G	8	11	19	0	3	22	0	0
4	17297086	.	C	A	18	22	40	0	1	41	0	0
4	17336693	.	G	A	3	4	7	0	0	7	0	0
4	17337593	.	A	T	3	3	6	0	1	7	0	0
4	17338664	.	T	C	6	5	11	0	0	11	0	0
4	17354824	.	T	C	2	2	4	0	0	4	0	0
4	17380828	.	C	A	3	3	6	0	0	6	0	0
4	17382878	.	G	A	8	3	11	0	1	12	0	0
4	17383774	.	G	C	2	2	4	0	0	4	0	0
4	17384624	.	A	T	2	3	5	0	0	5	0	0
4	17417668	.	T	G	1	0	1	0	4	5	0	0
4	17417692	.	C	T	1	3	4	0	0	4	0	0
4	17534198	.	A	G	4	0	4	0	4	8	0	0
4	17536140	.	T	G	4	6	10	0	1	11	0	0
4	17537639	.	A	G	7	5	12	0	0	12	0	0
4	17537939	.	G	T	0	6	6	0	4	10	0	0
4	17539261	.	T	G	2	2	4	0	0	4	0	0
4	17541666	.	A	G	6	3	9	0	0	9	0	0
4	17541730	.	G	A	1	2	3	0	1	4	0	0
4	17545083	.	A	G	16	0	16	0	12	28	0	0
4	17572583	.	C	T	17	16	33	0	0	33	0	0
4	17572589	.	C	A	14	15	29	0	0	29	0	0
4	17572898	.	T	C	16	10	26	1	1	28	0	0
4	17572901	.	A	C	17	11	28	1	0	29	0	0
4	17573071	.	A	T	9	8	17	0	2	19	0	0
4	17573081	.	G	C	10	7	17	0	1	18	0	0
4	17573464	.	A	G	10	5	15	0	1	16	0	0
4	17573465	.	A	G	9	5	14	0	2	16	0	0
4	17573594	.	T	A	8	6	14	0	1	15	0	0
4	17573616	.	A	G	5	9	14	0	0	14	0	0
4	17573644	.	A	C	4	5	9	0	0	9	0	0
4	17573697	.	G	A	7	3	10	2	0	12	0	0
4	17573706	.	A	G	9	4	13	2	0	15	0	0
4	17573802	.	T	C	5	10	15	0	2	17	0	0
4	17573841	.	A	G	10	7	17	0	6	23	0	0
4	17573865	.	T	A	10	10	20	0	2	22	0	0
4	17573959	.	T	A	8	3	11	0	1	12	0	0
4	17573982	.	A	T	12	5	17	0	0	17	0	0
4	17574093	.	A	G	8	9	17	0	0	17	0	0
4	17574390	.	C	T	10	5	15	0	1	16	0	0
4	17574608	.	A	C	5	6	11	0	2	13	0	0
4	17580468	.	A	T	7	4	11	0	0	11	0	0
4	17596433	.	T	C	4	0	4	0	4	8	0	0
4	17629266	.	C	A	3	3	6	0	0	6	0	0
4	17635891	.	A	G	1	2	3	0	0	3	0	0
4	17635900	.	G	T	1	3	4	0	0	4	0	0
4	17636575	.	C	T	2	2	4	0	0	4	0	0
4	17636616	.	C	T	0	2	2	0	3	5	0	0
4	17644913	.	A	G	3	4	7	0	0	7	0	0
4	17644964	.	G	A	2	5	7	0	1	8	0	0
4	17645493	.	T	C	7	2	9	0	0	9	0	0
4	17645495	.	T	A	7	2	9	0	0	9	0	0
4	17645890	.	A	C	6	5	11	0	0	11	0	0
4	17645962	.	C	T	3	6	9	0	0	9	0	0
4	17653340	.	T	C	2	7	9	0	0	9	0	0
4	17653516	.	T	A	1	2	3	0	0	3	0	0
4	17653517	.	A	C	1	2	3	0	0	3	0	0
4	17657549	.	A	G	5	0	5	0	5	10	0	0
4	17660732	.	A	G	6	2	8	0	0	8	0	0
4	17660859	.	G	A	7	4	11	0	1	12	0	0
4	17660871	.	A	G	8	4	12	0	0	12	0	0
4	17661265	.	A	G	6	4	10	0	0	10	0	0
4	17661387	.	A	G	6	2	8	0	0	8	0	0
4	17661421	.	G	T	4	3	7	0	1	8	0	0
4	17688726	.	G	A	3	2	5	0	0	5	0	0
4	17688795	.	T	C	1	2	3	0	0	3	0	0
4	17688849	.	T	C	1	2	3	0	0	3	0	0
4	17688874	.	T	C	3	2	5	0	0	5	0	0
4	17688897	.	C	T	3	4	7	0	0	7	0	0
4	17693400	.	A	G	7	5	12	0	0	12	0	0
4	17695054	.	A	G	6	6	12	0	0	12	0	0
4	17696254	.	G	A	2	2	4	0	0	4	0	0
4	17704067	.	G	A	0	4	4	0	1	5	0	0
4	17704123	.	T	C	2	6	8	0	0	8	0	0
4	17704279	.	T	A	4	5	9	0	0	9	0	0
4	17704393	.	A	T	1	4	5	0	0	5	0	0
4	17704560	.	A	G	3	3	6	0	1	7	0	0
4	17704928	.	T	A	1	3	4	0	0	4	0	0
4	17708230	.	T	C	6	5	11	0	1	12	0	0
4	17708346	.	G	A	2	5	7	0	0	7	0	0
4	17712719	.	A	G	0	2	2	0	1	3	0	0
4	17873351	.	A	G	6	10	16	0	0	16	0	0
4	17873530	.	T	G	6	14	20	0	0	20	0	0
4	17873711	.	A	T	6	10	16	0	2	18	0	0
4	17873743	.	C	T	5	8	13	0	0	13	0	0
4	17873787	.	G	A	0	6	6	0	4	10	0	0
4	17873808	.	G	C	4	4	8	0	0	8	0	0
4	17874009	.	T	A	5	4	9	1	0	10	0	0
4	17874010	.	G	A	5	4	9	1	0	10	0	0
4	17887059	.	T	C	24	13	37	1	0	38	0	0
4	17887388	.	A	T	16	20	36	0	3	39	0	0
4	17902098	.	A	G	15	12	27	0	2	29	0	0
4	17904325	.	A	C	8	0	8	0	10	18	0	0
4	17915070	.	G	A	10	7	17	0	4	21	0	0
4	17949261	.	C	T	7	3	10	0	0	10	0	0
4	18207890	.	T	C	1	1	2	0	2	4	0	0
4	18208005	.	A	G	12	3	15	0	0	15	0	0
4	18208068	.	A	G	13	10	23	0	0	23	0	0
4	18208347	.	C	G	4	6	10	0	3	13	0	0
4	18208415	.	C	A	1	2	3	0	0	3	0	0
4	18208416	.	A	C	1	0	1	0	2	3	0	0
4	18208635	.	T	A	2	3	5	0	0	5	0	0
4	18208760	.	G	A	8	3	11	0	0	11	0	0
4	18208769	.	A	G	7	4	11	0	0	11	0	0
4	18208939	.	C	T	4	2	6	0	1	7	0	0
4	18209107	.	G	C	8	4	12	0	1	13	0	0
4	18213267	.	C	T	3	3	6	0	0	6	0	0
4	18216182	.	A	G	6	7	13	0	0	13	0	0
4	18216251	.	T	C	2	6	8	0	0	8	0	0
4	18216332	.	A	G	5	3	8	0	0	8	0	0
4	18240356	.	A	G	1	3	4	0	1	5	0	0
4	18240451	.	G	A	2	2	4	0	0	4	0	0
4	18240475	.	C	T	2	2	4	0	3	7	0	0
4	18240536	.	G	T	2	2	4	0	0	4	0	0
4	18287263	.	T	C	5	2	7	0	0	7	0	0
4	18287449	.	T	G	7	3	10	0	0	10	0	0
4	18287739	.	T	G	4	2	6	0	1	7	0	0
4	18287744	.	A	G	5	2	7	0	0	7	0	0
4	18301293	.	C	A	0	3	3	0	2	5	0	0
4	18454352	.	A	G	6	4	10	0	2	12	0	0
4	18454363	.	T	A	7	4	11	0	1	12	0	0
4	18454400	.	C	T	0	2	2	0	6	8	0	0
4	18593839	.	G	A	12	6	18	0	2	20	0	0
4	18593980	.	G	A	8	3	11	0	4	15	0	0
4	18594019	.	G	T	4	3	7	0	2	9	0	0
4	18594045	.	T	C	6	4	10	0	0	10	0	0
4	18594125	.	T	A	7	8	15	0	0	15	0	0
4	18597683	.	C	G	4	3	7	0	0	7	0	0
4	18597841	.	C	G	25	16	41	0	0	41	0	0
4	18603017	.	T	A	7	3	10	0	0	10	0	0
4	18606501	.	G	T	24	14	38	0	5	43	0	0
4	18606512	.	C	T	18	18	36	0	2	38	0	0
4	18609613	.	T	G	2	4	6	0	0	6	0	0
4	18609759	.	C	G	2	3	5	0	0	5	0	0
4	18609769	.	A	G	2	3	5	0	0	5	0	0
4	18614034	.	A	G	5	5	10	0	0	10	0	0
4	18614484	.	G	A	2	5	7	0	0	7	0	0
4	18623708	.	A	G	2	2	4	0	0	4	0	0
4	18707376	.	C	T	1	3	4	0	1	5	0	0
4	18713937	.	T	C	1	3	4	0	0	4	0	0
4	18720871	.	C	T	2	3	5	0	0	5	0	0
4	18720942	.	C	T	1	3	4	0	1	5	0	0
4	18720947	.	G	T	1	5	6	0	0	6	0	0
4	18837898	.	A	T	4	4	8	0	2	10	0	0
4	18848977	.	A	C	1	2	3	0	1	4	0	0
4	18853105	.	C	T	6	2	8	0	0	8	0	0
4	18853153	.	C	T	4	3	7	0	0	7	0	0
4	18853972	.	C	G	9	5	14	0	2	16	0	0
4	18854250	.	A	C	10	0	10	0	12	22	0	0
4	18963897	.	G	A	0	3	3	0	2	5	0	0
4	18963908	.	C	A	2	3	5	0	0	5	0	0
4	18979820	.	T	A	4	7	11	0	0	11	0	0
4	18985807	.	T	A	16	13	29	0	0	29	0	0
4	18985846	.	A	G	16	18	34	0	1	35	0	0
4	18985995	.	G	A	13	10	23	0	1	24	0	0
4	18986107	.	C	T	4	5	9	0	1	10	0	0
4	18986282	.	T	C	5	0	5	0	7	12	0	0
4	18986293	.	T	G	4	6	10	0	1	11	0	0
4	18986413	.	G	A	7	13	20	0	1	21	0	0
4	18986497	.	C	T	1	19	20	0	9	29	0	0
4	18986771	.	A	T	2	2	4	0	0	4	0	0
4	18986805	.	G	T	4	4	8	0	0	8	0	0
4	18986893	.	C	G	2	4	6	0	0	6	0	0
4	18986897	.	T	A	3	4	7	0	0	7	0	0
4	18987202	.	C	A	10	3	13	0	0	13	0	0
4	18987250	.	G	A	7	2	9	0	1	10	0	0
4	18987275	.	A	G	3	4	7	0	1	8	0	0
4	18987391	.	G	A	2	6	8	0	1	9	0	0
4	18987523	.	T	C	3	7	10	0	2	12	0	0
4	18987835	.	G	C	5	0	5	0	7	12	0	0
4	18988068	.	T	C	3	0	3	0	4	7	0	0
4	18988084	.	G	A	4	3	7	0	0	7	0	0
4	18988426	.	G	C	3	4	7	0	0	7	0	0
4	19414905	.	G	A	3	9	12	0	1	13	0	0
4	19421890	.	G	A	6	6	12	0	0	12	0	0
4	19493773	.	G	T	6	6	12	0	0	12	0	0
4	19493808	.	G	A	4	3	7	0	0	7	0	0
4	19535841	.	T	G	2	6	8	0	1	9	0	0
4	19536422	.	T	C	4	9	13	0	0	13	0	0
4	19536917	.	C	T	12	11	23	0	0	23	0	0
4	19537703	.	A	G	20	24	44	0	3	47	0	0
4	19537937	.	A	G	21	0	21	0	24	45	0	0
4	19539017	.	C	T	12	7	19	0	1	20	0	0
4	19567605	.	A	G	8	5	13	0	0	13	0	0
4	19611739	.	T	G	4	2	6	0	0	6	0	0
4	19776011	.	G	A	1	2	3	0	0	3	0	0
4	19776014	.	G	C	2	0	2	0	2	4	0	0
4	19947781	.	G	T	1	5	6	0	1	7	0	0
4	19948131	.	G	A	3	2	5	0	0	5	0	0
4	19948312	.	A	G	4	8	12	0	0	12	0	0
4	19948313	.	A	G	3	6	9	0	3	12	0	0
4	19948746	.	T	C	2	3	5	0	0	5	0	0
4	19949148	.	T	C	5	3	8	0	4	12	0	0
4	19949178	.	A	T	2	4	6	0	0	6	0	0
4	19949260	.	A	G	3	2	5	0	0	5	0	0
4	19949900	.	T	C	8	3	11	0	0	11	0	0
4	19949963	.	T	C	2	6	8	0	0	8	0	0
4	20049543	.	C	T	31	24	55	0	0	55	0	0
4	20051021	.	A	G	22	13	35	0	0	35	0	0
4	20051092	.	C	T	0	15	15	0	7	22	0	0
4	20053199	.	T	C	17	19	36	0	1	37	0	0
4	20053211	.	A	G	19	20	39	0	1	40	0	0
4	20053901	.	C	T	24	10	34	0	1	35	0	0
4	20054036	.	C	T	17	13	30	0	0	30	0	0
4	20054135	.	A	G	6	9	15	0	0	15	0	0
4	20054190	.	T	G	5	4	9	0	1	10	0	0
4	20054243	.	A	G	7	3	10	0	1	11	0	0
4	20066263	.	T	C	4	3	7	0	0	7	0	0
4	20068149	.	T	G	6	6	12	0	0	12	0	0
4	20068185	.	A	G	3	5	8	0	0	8	0	0
4	20068266	.	A	G	1	6	7	0	0	7	0	0
4	20068446	.	G	A	4	8	12	0	0	12	0	0
4	20068470	.	C	G	1	8	9	0	1	10	0	0
4	20068717	.	G	A	7	4	11	0	1	12	0	0
4	20068890	.	G	A	6	5	11	0	2	13	0	0
4	20068903	.	T	C	7	7	14	0	2	16	0	0
4	20069091	.	T	C	6	3	9	0	0	9	0	0
4	20069343	.	C	A	9	8	17	0	0	17	0	0
4	20071344	.	A	T	3	6	9	0	1	10	0	0
4	20071401	.	G	T	5	9	14	0	0	14	0	0
4	20072084	.	G	C	1	3	4	0	0	4	0	0
4	20072094	.	C	T	2	4	6	0	0	6	0	0
4	20072394	.	C	G	6	6	12	0	0	12	0	0
4	20072429	.	T	G	5	6	11	0	0	11	0	0
4	20073790	.	T	C	5	9	14	0	0	14	0	0
4	20073799	.	A	G	3	8	11	0	0	11	0	0
4	20080778	.	T	A	1	2	3	0	0	3	0	0
4	20099022	.	G	A	4	2	6	0	1	7	0	0
4	20101105	.	G	T	8	8	16	0	1	17	0	0
4	20102901	.	C	A	3	5	8	0	0	8	0	0
4	20103813	.	T	A	4	2	6	0	0	6	0	0
4	20105455	.	T	A	1	2	3	0	0	3	0	0
4	20129617	.	T	C	1	0	1	0	4	5	0	0
4	20130216	.	T	C	2	2	4	0	0	4	0	0
4	20142829	.	A	G	1	2	3	0	0	3	0	0
4	20226677	.	A	G	6	5	11	0	0	11	0	0
4	20226826	.	T	C	7	4	11	0	0	11	0	0
4	20226916	.	A	C	7	7	14	0	0	14	0	0
4	20229626	.	C	T	5	9	14	0	0	14	0	0
4	20229920	.	C	A	1	6	7	0	6	13	0	0
4	20230213	.	G	A	2	4	6	0	0	6	0	0
4	20232838	.	A	G	1	2	3	0	0	3	0	0
4	20265309	.	C	T	3	2	5	0	0	5	0	0
4	20303423	.	T	C	2	3	5	0	0	5	0	0
4	20303545	.	T	C	2	2	4	0	1	5	0	0
4	20303604	.	T	C	1	4	5	0	0	5	0	0
4	20305777	.	T	G	1	3	4	0	0	4	0	0
4	20473127	.	G	A	0	3	3	0	2	5	0	0
4	20473142	.	C	T	1	3	4	0	1	5	0	0
4	20473175	.	C	T	2	4	6	0	0	6	0	0
4	20474969	.	A	G	1	0	1	0	4	5	0	0
4	20480734	.	G	A	6	12	18	0	1	19	0	0
4	20482150	.	T	C	3	5	8	0	0	8	0	0
4	20482506	.	C	T	4	5	9	0	0	9	0	0
4	20482615	.	G	T	1	2	3	0	1	4	0	0
4	20494332	.	C	T	7	5	12	0	0	12	0	0
4	20496617	.	T	C	5	2	7	0	0	7	0	0
4	20496653	.	A	G	6	4	10	0	1	11	0	0
4	20496655	.	C	T	7	4	11	0	0	11	0	0
4	20498240	.	A	G	6	9	15	0	1	16	0	0
4	20499421	.	G	C	7	12	19	0	0	19	0	0
4	20499440	.	A	G	6	11	17	0	0	17	0	0
4	20499493	.	T	G	6	9	15	0	1	16	0	0
4	20499516	.	G	T	6	9	15	0	0	15	0	0
4	20499557	.	G	A	4	5	9	0	0	9	0	0
4	20507121	.	T	A	9	7	16	0	0	16	0	0
4	20507155	.	A	C	7	9	16	0	3	19	0	0
4	20507473	.	T	A	1	5	6	0	0	6	0	0
4	20508691	.	G	A	4	3	7	0	0	7	0	0
4	20508913	.	A	G	4	8	12	0	1	13	0	0
4	20508928	.	A	G	7	9	16	0	0	16	0	0
4	20508992	.	C	T	5	2	7	0	0	7	0	0
4	20981198	.	G	A	1	3	4	0	1	5	0	0
4	21290798	.	G	A	8	4	12	0	0	12	0	0
4	21295949	.	T	C	6	9	15	0	1	16	0	0
4	21297417	.	A	C	11	10	21	0	0	21	0	0
4	21312642	.	T	C	17	15	32	0	3	36	1	0
4	21312981	.	C	T	19	27	46	0	5	51	0	0
4	21313120	.	A	G	24	1	25	0	29	54	0	0
4	21313136	.	T	C	23	25	48	0	4	52	0	0
4	21313779	.	T	G	36	22	58	0	2	60	0	0
4	21313805	.	G	A	3	32	35	0	35	70	0	0
4	21314120	.	T	C	21	15	36	0	0	36	0	0
4	21314204	.	G	T	21	17	38	1	2	41	0	0
4	21314338	.	G	T	29	34	63	0	2	65	0	0
4	21314583	.	T	C	36	23	59	0	1	60	0	0
4	21323174	.	T	A	2	2	4	0	0	4	0	0
4	21323215	.	T	C	1	0	1	0	2	3	0	0
4	21323216	.	T	G	2	2	4	0	0	4	0	0
4	21323363	.	G	C	2	6	8	0	0	8	0	0
4	21369434	.	G	A	2	2	4	0	0	4	0	0
4	21489550	.	A	G	17	1	18	0	3	21	0	0
4	21489629	.	G	T	16	6	22	0	1	24	1	0
4	21490320	.	T	C	18	10	28	0	1	29	0	0
4	21490344	.	A	G	18	7	25	0	1	26	0	0
4	21499521	.	G	A	8	9	17	0	1	18	0	0
4	21507026	.	G	A	2	7	9	0	1	10	0	0
4	21508353	.	C	T	4	7	11	0	1	12	0	0
4	21512191	.	C	T	5	4	9	0	3	12	0	0
4	21517970	.	A	G	3	3	6	0	0	6	0	0
4	21523541	.	A	T	3	6	9	1	1	11	0	0
4	21525430	.	G	T	2	3	5	0	0	5	0	0
4	21526300	.	A	G	1	3	4	0	2	6	0	0
4	21649505	.	G	A	33	36	69	1	6	76	0	0
4	21651486	.	G	A	33	38	71	0	1	72	0	0
4	21752284	.	G	A	14	6	20	1	1	22	0	0
4	21752291	.	C	T	11	6	17	1	1	19	0	0
4	21752372	.	T	A	7	7	14	0	0	14	0	0
4	21752493	.	T	C	4	2	6	0	0	6	0	0
4	21752495	.	C	G	4	2	6	0	0	6	0	0
4	21752688	.	G	C	15	0	15	0	6	21	0	0
4	21752736	.	T	C	13	6	19	0	2	21	0	0
4	21752941	.	T	A	9	4	13	0	0	13	0	0
4	21752969	.	C	T	8	4	12	0	0	12	0	0
4	21752984	.	C	A	8	3	11	0	1	12	0	0
4	21753139	.	C	T	7	12	19	0	0	19	0	0
4	21753185	.	T	C	12	10	22	0	0	22	0	0
4	21753316	.	T	C	6	12	18	1	1	20	0	0
4	21753344	.	G	A	5	12	17	1	0	18	0	0
4	21761688	.	A	T	8	8	16	0	0	16	0	0
4	21958043	.	A	G	12	15	27	0	2	29	0	0
4	21958150	.	C	T	10	12	22	0	2	24	0	0
4	21958226	.	T	G	24	12	36	0	0	36	0	0
4	21958276	.	C	T	0	12	12	0	17	29	0	0
4	21975248	.	G	A	7	4	11	0	0	11	0	0
4	21975489	.	G	T	2	6	8	0	1	9	0	0
4	21988402	.	G	A	1	2	3	0	0	3	0	0
4	21988481	.	G	A	3	3	6	0	1	7	0	0
4	22006507	.	C	A	0	3	3	0	1	4	0	0
4	22299747	.	G	A	7	5	12	0	0	12	0	0
4	22299954	.	C	T	4	5	9	0	0	9	0	0
4	22300125	.	A	C	5	8	13	0	0	13	0	0
4	22300153	.	T	A	6	6	12	0	0	12	0	0
4	22300178	.	C	T	8	2	10	0	0	10	0	0
4	22300257	.	C	T	2	2	4	0	0	4	0	0
4	22313107	.	A	T	9	9	18	0	2	20	0	0
4	22313195	.	G	C	14	9	23	0	3	26	0	0
4	22313216	.	T	G	11	10	21	0	1	22	0	0
4	22313244	.	G	A	11	10	21	0	0	21	0	0
4	22313351	.	G	A	13	5	18	0	0	18	0	0
4	22313398	.	T	A	4	6	10	0	5	15	0	0
4	22313582	.	T	C	3	0	3	0	6	9	0	0
4	22313722	.	A	C	5	6	11	0	0	11	0	0
4	22314001	.	A	T	2	3	5	0	0	5	0	0
4	22314085	.	G	A	5	7	12	0	0	12	0	0
4	22316148	.	T	C	6	5	11	0	1	12	0	0
4	22316321	.	C	T	5	5	10	0	1	11	0	0
4	22316624	.	A	T	9	4	13	0	1	14	0	0
4	22318828	.	G	A	3	5	8	0	1	9	0	0
4	22328871	.	T	C	2	3	5	0	0	5	0	0
4	22350556	.	A	T	1	2	3	0	0	3	0	0
4	22353656	.	G	A	1	3	4	0	0	4	0	0
4	22365251	.	G	A	4	2	6	0	0	6	0	0
4	22365747	.	C	T	14	15	29	0	1	30	0	0
4	22419473	.	C	A	31	31	62	0	0	62	0	0
4	22419483	.	G	T	30	28	58	0	4	62	0	0
4	22419663	.	T	G	6	14	20	1	2	23	0	0
4	22424854	.	G	A	12	14	26	0	1	27	0	0
4	22424891	.	A	G	23	16	39	0	0	39	0	0
4	22425115	.	G	A	20	14	34	0	2	36	0	0
4	22428110	.	G	A	7	4	11	0	0	11	0	0
4	22428745	.	C	T	1	5	6	0	4	10	0	0
4	22428871	.	C	T	0	6	6	0	1	7	0	0
4	22430827	.	C	T	1	6	7	0	12	19	0	0
4	22432794	.	T	A	1	1	2	0	2	4	0	0
4	22433307	.	A	G	3	5	8	0	1	9	0	0
4	22445415	.	C	T	0	2	2	0	2	4	0	0
4	22756239	.	T	C	15	7	22	0	0	22	0	0
4	23773192	.	A	T	2	2	4	0	2	6	0	0
4	23773210	.	T	A	2	2	4	0	1	5	0	0
4	23773529	.	A	G	4	2	6	0	1	7	0	0
4	23773977	.	A	G	4	5	9	0	0	9	0	0
4	23773982	.	T	G	5	5	10	0	0	10	0	0
4	23775252	.	C	A	5	3	8	0	0	8	0	0
4	23775630	.	G	C	2	0	2	0	5	7	0	0
4	23887175	.	G	A	3	2	5	1	3	9	0	0
4	23887318	.	C	T	0	5	5	0	5	10	0	0
4	23888406	.	A	T	2	2	4	0	0	4	0	0
4	23893052	.	C	A	2	2	4	0	0	4	0	0
4	23908758	.	C	T	3	3	6	0	0	6	0	0
4	23938614	.	G	A	4	3	7	0	0	7	0	0
4	23938617	.	C	T	5	2	7	0	0	7	0	0
4	25054826	.	G	A	29	3	32	0	6	38	0	0
4	25055230	.	G	A	27	18	45	0	3	48	0	0
4	25055479	.	C	G	5	14	19	0	24	43	0	0
4	25055602	.	A	G	35	20	55	0	0	55	0	0
4	25084487	.	T	G	10	7	17	0	1	18	0	0
4	25084744	.	A	G	5	2	7	0	1	8	0	0
4	25105502	.	G	T	11	6	17	0	1	18	0	0
4	25105662	.	A	G	2	3	5	0	0	5	0	0
4	25173387	.	T	C	34	24	58	0	0	59	1	0
4	25173396	.	A	G	33	21	54	0	7	61	0	0
4	25176093	.	A	G	31	29	60	0	2	62	0	0
4	25176420	.	C	T	32	28	60	3	0	63	0	0
4	25178069	.	G	T	12	20	32	0	1	33	0	0
4	25178402	.	G	C	15	16	31	0	2	33	0	0
4	25179897	.	A	G	13	17	30	0	1	31	0	0
4	25179948	.	C	T	0	15	15	0	12	27	0	0
4	25179996	.	A	G	11	17	28	0	3	31	0	0
4	25184718	.	G	A	5	4	9	0	0	9	0	0
4	25184757	.	C	T	6	5	11	0	0	11	0	0
4	25184760	.	C	T	6	7	13	0	0	13	0	0
4	25252405	.	T	C	2	2	4	0	0	4	0	0
4	25473316	.	T	G	7	6	13	0	0	13	0	0
4	25473934	.	T	G	10	5	15	0	0	15	0	0
4	25474177	.	T	C	8	10	18	0	1	19	0	0
4	25474301	.	T	C	12	11	23	0	0	23	0	0
4	25474305	.	A	T	12	10	22	0	1	23	0	0
4	25474417	.	G	A	5	7	12	0	0	12	0	0
4	25474419	.	C	T	0	7	7	0	5	12	0	0
4	25476524	.	A	T	5	6	11	0	1	12	0	0
4	25481164	.	T	G	1	2	3	0	0	3	0	0
4	25481188	.	A	G	1	2	3	0	0	3	0	0
4	25497398	.	G	A	2	5	7	0	0	7	0	0
4	25497464	.	T	C	6	0	6	0	7	13	0	0
4	25503078	.	T	C	7	0	7	0	7	14	0	0
4	25506417	.	G	A	7	11	18	0	0	18	0	0
4	25506896	.	A	G	4	8	12	0	0	12	0	0
4	25506944	.	T	C	7	0	7	0	5	12	0	0
4	25515157	.	C	T	3	3	6	0	0	6	0	0
4	25700800	.	A	T	2	4	6	0	0	6	0	0
4	25702919	.	C	T	6	3	9	0	0	9	0	0
4	25703290	.	T	G	4	0	4	0	2	6	0	0
4	25750850	.	G	A	2	4	6	0	0	6	0	0
4	25751003	.	A	G	2	0	2	0	3	5	0	0
4	25755269	.	C	T	8	4	12	0	0	12	0	0
4	25755341	.	T	A	1	3	4	0	0	4	0	0
4	25755359	.	G	T	2	4	6	0	0	6	0	0
4	25756387	.	T	G	1	3	4	0	0	4	0	0
4	25756432	.	A	G	2	3	5	0	0	5	0	0
4	25756453	.	G	T	2	3	5	0	0	5	0	0
4	25759088	.	T	A	1	3	4	0	0	4	0	0
4	25829939	.	G	A	14	10	24	0	2	26	0	0
4	25833146	.	A	G	18	31	49	0	2	51	0	0
4	25833221	.	G	A	27	18	45	0	2	47	0	0
4	25839832	.	A	G	2	4	6	0	0	6	0	0
4	25842788	.	C	T	5	5	10	0	0	10	0	0
4	25843659	.	A	G	4	2	6	0	1	7	0	0
4	25846927	.	G	A	2	2	4	0	0	4	0	0
4	25853058	.	C	T	1	2	3	0	0	3	0	0
4	25860509	.	T	C	2	6	8	2	0	10	0	0
4	25862009	.	A	G	1	2	3	0	0	3	0	0
4	25864355	.	G	T	1	2	3	0	0	3	0	0
4	25934722	.	T	C	2	3	5	0	0	5	0	0
4	25936437	.	A	G	1	2	3	0	0	3	0	0
4	25936491	.	A	G	2	4	6	0	0	6	0	0
4	25939158	.	A	G	1	3	4	0	1	5	0	0
4	25946261	.	G	A	2	6	8	0	0	8	0	0
4	25946283	.	A	C	2	3	5	0	0	5	0	0
4	26021876	.	G	A	5	2	7	0	2	9	0	0
4	26021910	.	A	G	4	8	12	0	1	13	0	0
4	26021970	.	C	A	7	10	17	0	1	18	0	0
4	26022076	.	T	C	3	0	3	0	5	8	0	0
4	26022351	.	C	G	3	7	10	0	0	10	0	0
4	26022413	.	C	T	9	2	11	0	1	12	0	0
4	26022447	.	T	C	3	0	3	0	3	6	0	0
4	26026444	.	T	C	3	3	6	0	1	7	0	0
4	26027022	.	A	G	4	3	7	0	0	7	0	0
4	26028813	.	C	T	1	2	3	0	1	4	0	0
4	26029413	.	T	C	3	0	3	0	2	5	0	0
4	26072844	.	G	A	1	3	4	0	0	4	0	0
4	26075882	.	A	G	2	0	2	0	3	5	0	0
4	26077671	.	A	T	4	3	7	0	0	7	0	0
4	26078008	.	T	C	2	2	4	0	2	6	0	0
4	26078847	.	A	G	3	3	6	0	1	7	0	0
4	26078911	.	A	G	4	2	6	0	0	6	0	0
4	26079096	.	A	C	5	2	7	0	0	7	0	0
4	26079116	.	T	C	5	2	7	0	0	7	0	0
4	26079721	.	T	A	2	3	5	0	1	6	0	0
4	26079761	.	A	T	3	3	6	0	0	6	0	0
4	26079838	.	A	G	3	4	7	0	0	7	0	0
4	26079844	.	A	G	1	6	7	0	0	7	0	0
4	26080071	.	T	C	7	2	9	0	0	9	0	0
4	26080294	.	A	G	12	10	22	0	0	22	0	0
4	26080321	.	A	G	16	6	22	0	0	22	0	0
4	26080375	.	A	C	13	3	16	0	1	17	0	0
4	26080387	.	T	A	10	5	15	0	5	20	0	0
4	26080441	.	C	T	5	11	16	0	0	16	0	0
4	26080593	.	T	C	5	4	9	0	0	9	0	0
4	26304240	.	T	G	12	16	28	0	1	29	0	0
4	26304451	.	T	C	18	13	31	0	1	32	0	0
4	26304730	.	G	T	3	3	6	0	0	6	0	0
4	26305191	.	T	C	6	3	9	0	2	11	0	0
4	26305286	.	C	A	2	7	9	0	0	9	0	0
4	26305309	.	T	A	4	8	12	0	1	13	0	0
4	26305324	.	C	T	4	6	10	0	0	10	0	0
4	26305413	.	A	C	9	3	12	0	0	12	0	0
4	26305468	.	A	T	7	3	10	0	0	10	0	0
4	26305516	.	A	T	5	2	7	0	0	7	0	0
4	26305578	.	A	T	2	6	8	0	0	8	0	0
4	26306209	.	A	G	1	3	4	0	0	4	0	0
4	26321216	.	A	G	2	2	4	0	0	4	0	0
4	26322655	.	C	A	0	3	3	0	7	10	0	0
4	26762518	.	G	T	4	3	7	0	1	8	0	0
4	26763314	.	A	T	1	2	3	0	0	3	0	0
4	26763461	.	G	T	5	3	8	0	1	9	0	0
4	26764217	.	C	T	8	3	11	0	0	11	0	0
4	26765359	.	A	T	4	5	9	0	0	9	0	0
4	27082166	.	T	C	6	3	9	0	0	9	0	0
4	27109491	.	A	G	1	2	3	0	0	3	0	0
4	27112663	.	T	A	3	2	5	0	1	6	0	0
4	27113093	.	A	G	2	5	7	0	1	8	0	0
4	27113265	.	T	A	2	2	4	0	0	4	0	0
4	27113479	.	G	A	5	3	8	0	0	8	0	0
4	27113986	.	G	A	4	3	7	0	0	7	0	0
4	27137991	.	T	G	2	4	6	0	0	6	0	0
4	27145549	.	T	C	3	2	5	0	0	5	0	0
4	27147440	.	T	G	5	3	8	0	0	8	0	0
4	27147510	.	T	C	1	4	5	0	0	5	0	0
4	27147712	.	C	T	3	9	12	0	0	12	0	0
4	27148291	.	G	T	3	6	9	0	0	9	0	0
4	27148417	.	T	C	5	5	10	0	1	11	0	0
4	27148425	.	A	T	6	4	10	0	0	10	0	0
4	27148545	.	A	C	3	6	9	0	1	10	0	0
4	27148943	.	A	C	4	5	9	0	0	9	0	0
4	27149017	.	G	A	0	2	2	0	5	7	0	0
4	27149634	.	A	T	5	1	6	0	1	7	0	0
4	27252027	.	T	C	7	8	15	0	1	17	1	0
4	27252096	.	C	T	19	6	25	0	0	25	0	0
4	27252178	.	C	T	2	5	7	0	15	22	0	0
4	27252581	.	G	A	12	12	24	0	1	25	0	0
4	27350432	.	G	T	3	3	6	0	0	6	0	0
4	27350666	.	G	A	2	3	5	0	0	5	0	0
4	27350674	.	C	G	0	3	3	0	1	4	0	0
4	27627569	.	C	T	2	2	4	0	0	4	0	0
4	27628373	.	G	A	3	3	6	0	0	6	0	0
4	27628788	.	T	A	5	3	8	0	1	9	0	0
4	27713785	.	A	T	3	2	5	0	0	5	0	0
4	28062649	.	C	A	1	2	3	0	0	3	0	0
4	28062652	.	A	G	1	2	3	0	0	3	0	0
4	28062699	.	T	C	2	5	7	0	0	7	0	0
4	28063715	.	A	G	1	3	4	0	0	4	0	0
4	28066425	.	C	T	2	2	4	0	0	4	0	0
4	28191752	.	C	T	0	4	4	0	2	6	0	0
4	28194359	.	G	A	3	4	7	0	0	7	0	0
4	28195380	.	A	C	4	2	6	0	0	6	0	0
4	28195396	.	T	C	4	3	7	0	0	7	0	0
4	28195552	.	G	A	1	4	5	0	0	5	0	0
4	28195558	.	C	T	1	2	3	0	0	3	0	0
4	28200250	.	T	C	1	0	1	0	2	3	0	0
4	28211121	.	C	A	1	2	3	0	0	3	0	0
4	28373691	.	A	G	3	4	7	0	0	7	0	0
4	28373791	.	T	G	4	3	7	0	0	7	0	0
4	28379740	.	G	A	1	3	4	0	0	4	0	0
4	28423435	.	G	T	1	4	5	0	0	5	0	0
4	28423436	.	G	A	1	4	5	0	0	5	0	0
4	28423483	.	T	C	1	3	4	0	0	4	0	0
4	28423499	.	A	T	3	3	6	0	0	6	0	0
4	28423528	.	C	G	2	0	2	0	2	4	0	0
4	28423547	.	C	T	2	3	5	0	0	5	0	0
4	28423595	.	A	G	1	3	4	0	0	4	0	0
4	28423669	.	A	G	4	4	8	0	0	8	0	0
4	28423735	.	C	T	1	6	7	0	0	7	0	0
4	28423775	.	T	G	1	0	1	0	5	6	0	0
4	28423786	.	A	T	2	3	5	0	1	6	0	0
4	28423886	.	A	C	1	3	4	0	0	4	0	0
4	28821220	.	C	A	4	2	6	0	0	6	0	0
4	28975577	.	T	C	1	1	2	0	0	2	0	0
4	28975587	.	A	C	2	2	4	0	0	4	0	0
4	28975635	.	C	A	2	2	4	0	0	4	0	0
4	28975750	.	A	G	3	0	3	0	2	5	0	0
4	29040548	.	A	G	7	4	11	0	0	11	0	0
4	29040677	.	G	A	2	5	7	0	0	7	0	0
4	29040980	.	C	A	1	3	4	0	1	5	0	0
4	29041388	.	T	C	1	2	3	0	0	3	0	0
4	29050168	.	T	A	1	3	4	0	0	4	0	0
4	29285430	.	T	C	2	2	4	0	0	4	0	0
4	29287864	.	A	C	2	4	6	0	0	6	0	0
4	29287874	.	T	C	3	4	7	0	1	8	0	0
4	29287956	.	G	A	2	3	5	0	0	5	0	0
4	35893649	.	A	T	1	2	3	1	0	4	0	0
4	44752146	.	A	G	1	0	1	0	2	3	0	0
4	49552227	.	T	C	1	2	3	0	1	4	0	0
4	49554053	.	C	A	4	2	6	0	1	7	0	0
4	51172528	.	A	C	0	2	2	0	1	3	0	0
4	56380035	.	A	G	1	3	4	0	0	4	0	0
4	57351478	.	G	A	2	3	5	0	0	5	0	0
4	57351521	.	A	G	3	3	6	0	0	6	0	0
4	57351533	.	T	G	3	2	5	1	0	6	0	0
4	61802443	.	T	A	2	2	4	0	0	4	0	0
4	65727802	.	C	T	2	4	6	0	0	6	0	0
4	65727822	.	G	A	2	3	5	1	1	7	0	0
4	65727875	.	T	G	1	2	3	0	0	4	1	0
4	70851202	.	T	C	3	0	3	1	7	11	0	0
4	70855931	.	T	C	8	0	8	0	5	13	0	0
4	70855939	.	C	T	1	7	8	0	6	14	0	0
4	70860166	.	A	G	7	6	13	5	0	18	0	0
4	70864034	.	G	A	7	3	10	0	1	11	0	0
4	70864037	.	C	T	0	2	2	0	8	10	0	0
4	70867005	.	G	C	3	2	5	0	0	5	0	0
4	72216932	.	A	C	1	3	4	0	0	4	0	0
4	72217405	.	C	T	4	4	8	0	0	8	0	0
4	72217438	.	A	C	5	2	7	0	1	8	0	0
4	72217495	.	C	A	3	3	6	0	1	7	0	0
4	72217508	.	C	T	2	4	6	0	0	6	0	0
4	72217779	.	A	G	1	0	1	0	3	4	0	0
4	72217813	.	T	C	1	6	7	0	1	8	0	0
4	72217847	.	G	A	0	4	4	0	4	8	0	0
4	72217903	.	A	G	2	3	5	0	0	5	0	0
4	72272239	.	G	A	7	4	11	0	0	11	0	0
4	72272617	.	G	A	1	3	4	0	0	4	0	0
4	72559171	.	G	T	3	2	5	0	0	5	0	0
4	72559396	.	G	A	1	4	5	0	1	6	0	0
4	72559558	.	A	G	2	2	4	0	0	4	0	0
4	72559585	.	A	G	1	2	3	0	0	3	0	0
4	72559612	.	A	G	3	3	6	0	0	6	0	0
4	72603483	.	C	A	4	3	7	0	0	7	0	0
4	72603620	.	G	A	3	5	8	0	0	8	0	0
4	72603653	.	G	A	1	4	5	0	0	5	0	0
4	72604764	.	T	A	1	2	3	0	0	3	0	0
4	72604765	.	G	A	1	2	3	0	0	3	0	0
4	72629131	.	T	C	1	0	1	0	1	2	0	0
4	72629138	.	C	T	0	2	2	0	1	3	0	0
4	72629250	.	T	A	2	2	4	0	0	4	0	0
4	72630231	.	G	A	1	2	3	0	0	3	0	0
4	72678592	.	G	C	2	2	4	0	0	4	0	0
4	72754244	.	C	T	18	12	30	0	0	30	0	0
4	72772769	.	T	C	10	10	20	0	1	21	0	0
4	72775687	.	C	A	15	16	31	0	0	31	0	0
4	72781277	.	A	G	26	16	42	0	1	43	0	0
4	72784800	.	T	C	10	9	19	0	0	19	0	0
4	72784939	.	T	G	2	0	2	0	8	10	0	0
4	72784940	.	A	C	2	8	10	0	0	10	0	0
4	72785129	.	C	G	2	3	5	1	0	6	0	0
4	72785238	.	T	A	2	3	5	0	1	6	0	0
4	72785245	.	C	T	2	3	5	0	1	6	0	0
4	72785632	.	A	G	2	0	2	0	3	5	0	0
4	72785692	.	C	G	4	7	11	0	0	11	0	0
4	72785903	.	G	A	3	4	7	0	0	7	0	0
4	72785914	.	T	C	2	4	6	0	0	6	0	0
4	73059149	.	C	T	1	2	3	0	0	3	0	0
4	73059245	.	C	T	1	2	3	0	0	3	0	0
4	73059299	.	T	A	3	3	6	0	0	6	0	0
4	73059408	.	T	C	4	3	7	0	0	7	0	0
4	73063117	.	C	T	4	2	6	0	3	9	0	0
4	73186138	.	T	C	1	2	3	0	0	3	0	0
4	73186143	.	C	A	1	2	3	0	0	3	0	0
4	73186242	.	A	C	2	2	4	0	0	4	0	0
4	73186351	.	G	A	1	2	3	0	0	3	0	0
4	73187473	.	G	A	1	2	3	0	0	3	0	0
4	73335530	.	A	G	3	2	5	0	0	5	0	0
4	73335956	.	G	A	1	3	4	0	0	4	0	0
4	73335990	.	T	A	2	3	5	0	1	6	0	0
4	73336818	.	C	T	3	2	5	0	1	6	0	0
4	73336863	.	A	C	5	3	8	0	0	8	0	0
4	73336869	.	G	C	4	5	9	0	0	9	0	0
4	73336909	.	G	A	3	2	5	0	0	5	0	0
4	73337244	.	A	G	3	2	5	1	0	6	0	0
4	73337248	.	G	A	3	2	5	1	0	6	0	0
4	73338265	.	G	T	1	2	3	0	0	3	0	0
4	73418744	.	A	T	2	9	11	0	0	11	0	0
4	73418823	.	T	C	4	6	10	0	1	11	0	0
4	73418974	.	T	C	1	0	1	0	6	7	0	0
4	73419010	.	G	A	3	3	6	1	0	7	0	0
4	73419026	.	C	T	3	3	6	1	1	8	0	0
4	73419550	.	G	A	1	2	3	0	0	3	0	0
4	73472873	.	A	T	3	2	5	1	0	6	0	0
4	73500038	.	T	C	2	2	4	0	0	4	0	0
4	73500041	.	T	C	2	2	4	0	0	4	0	0
4	73500405	.	T	C	2	0	2	0	2	4	0	0
4	73500748	.	G	A	1	1	2	0	1	3	0	0
4	73500783	.	T	A	2	2	4	0	0	4	0	0
4	73519301	.	T	A	2	2	4	0	1	5	0	0
4	73519433	.	A	G	2	2	4	0	0	4	0	0
4	73542536	.	G	A	5	6	11	0	0	11	0	0
4	73542582	.	A	G	4	2	6	0	0	6	0	0
4	73542707	.	T	G	4	4	8	0	0	8	0	0
4	73542757	.	C	A	5	4	9	0	0	9	0	0
4	73542775	.	C	T	1	4	5	0	2	7	0	0
4	73542830	.	C	T	1	2	3	0	0	3	0	0
4	73542913	.	A	G	6	5	11	0	0	11	0	0
4	73550570	.	A	T	1	5	6	0	0	6	0	0
4	73550610	.	A	T	2	9	11	0	0	11	0	0
4	73551240	.	T	C	1	3	4	0	0	4	0	0
4	73551456	.	T	C	2	2	4	0	1	5	0	0
4	73573799	.	T	A	1	2	3	0	1	4	0	0
4	73573870	.	T	G	3	5	8	1	0	9	0	0
4	73573887	.	A	C	3	4	7	1	0	8	0	0
4	73574134	.	C	A	5	6	11	0	0	11	0	0
4	73574325	.	C	T	3	2	5	0	0	5	0	0
4	73574332	.	G	A	5	3	8	0	0	8	0	0
4	73574374	.	G	A	5	4	9	0	1	10	0	0
4	73574386	.	T	A	5	4	9	0	1	10	0	0
4	73574579	.	A	G	4	3	7	0	0	7	0	0
4	73574583	.	C	G	4	2	6	0	1	7	0	0
4	73575381	.	G	A	3	2	5	0	0	5	0	0
4	73690525	.	A	T	2	4	6	0	0	6	0	0
4	73690572	.	G	T	5	3	8	0	0	8	0	0
4	73690653	.	T	C	1	4	5	0	0	5	0	0
4	73711963	.	T	G	2	3	5	0	0	5	0	0
4	73712311	.	A	T	3	3	6	0	0	6	0	0
4	73712313	.	C	T	3	3	6	0	0	6	0	0
4	73712748	.	G	T	1	2	3	0	0	3	0	0
4	73713018	.	T	G	1	2	3	0	0	3	0	0
4	73713039	.	C	G	1	3	4	0	0	4	0	0
4	73729780	.	C	A	4	2	6	0	0	6	0	0
4	73729818	.	C	T	1	2	3	0	0	3	0	0
4	73740301	.	G	A	8	6	14	0	1	15	0	0
4	73740391	.	C	G	3	4	7	0	2	9	0	0
4	73740409	.	C	A	2	9	11	0	0	11	0	0
4	73740487	.	C	G	3	2	5	0	1	6	0	0
4	73740517	.	A	G	6	2	8	0	0	8	0	0
4	73740651	.	G	C	2	4	6	0	0	6	0	0
4	73740691	.	T	A	3	2	5	0	2	7	0	0
4	73740763	.	T	A	2	3	5	0	0	5	0	0
4	73740879	.	A	C	4	5	9	0	0	9	0	0
4	73741749	.	G	T	1	3	4	0	0	4	0	0
4	73741764	.	G	A	1	4	5	0	0	5	0	0
4	73758107	.	G	C	2	2	4	0	0	4	0	0
4	73815178	.	C	T	2	1	3	0	1	4	0	0
4	73815860	.	C	A	3	2	5	0	0	5	0	0
4	73815897	.	T	A	5	2	7	0	0	7	0	0
4	73899078	.	T	A	2	4	6	1	1	8	0	0
4	73899370	.	G	A	1	2	3	0	1	4	0	0
4	73899511	.	A	G	4	0	4	0	3	7	0	0
4	73899670	.	A	C	1	2	3	1	1	5	0	0
4	73980836	.	C	A	1	2	3	0	0	3	0	0
4	73981397	.	C	T	1	3	4	0	0	4	0	0
4	73981489	.	G	T	1	2	3	0	1	4	0	0
4	73981496	.	G	A	2	1	3	0	1	4	0	0
4	73981558	.	G	A	0	2	2	0	3	5	0	0
4	73983003	.	A	G	3	3	6	0	0	6	0	0
4	74006572	.	C	T	1	3	4	0	0	4	0	0
4	74008621	.	A	G	3	0	3	0	5	8	0	0
4	74008704	.	C	T	3	2	5	0	1	6	0	0
4	74008708	.	A	G	4	3	7	0	0	7	0	0
4	74087781	.	G	A	6	10	16	0	3	19	0	0
4	74087785	.	G	C	8	11	19	0	0	19	0	0
4	74087949	.	G	A	10	4	14	0	3	17	0	0
4	74088060	.	T	G	9	12	21	0	3	25	1	0
4	74135244	.	G	T	1	4	5	0	0	5	0	0
4	74135295	.	A	G	1	2	3	0	1	4	0	0
4	74141580	.	C	A	2	2	4	0	0	4	0	0
4	74180788	.	T	C	3	4	7	0	1	8	0	0
4	74182382	.	G	C	6	6	12	0	0	12	0	0
4	74182389	.	G	T	7	5	12	0	2	14	0	0
4	74193480	.	C	G	7	3	10	0	0	10	0	0
4	74196686	.	T	C	9	3	12	0	0	12	0	0
4	74196704	.	T	C	9	4	13	0	0	13	0	0
4	74196764	.	G	T	1	4	5	0	2	7	0	0
4	74200292	.	C	T	6	10	16	0	0	16	0	0
4	74200304	.	T	C	4	13	17	0	0	17	0	0
4	74204177	.	T	C	9	10	19	0	0	19	0	0
4	74204236	.	G	T	0	7	7	0	8	15	0	0
4	74204387	.	G	T	5	4	9	0	1	10	0	0
4	74204494	.	A	T	2	6	8	0	0	8	0	0
4	74204842	.	A	G	5	9	14	0	0	14	0	0
4	74205295	.	T	C	2	5	7	0	0	7	0	0
4	74267225	.	A	G	6	7	13	0	0	13	0	0
4	74267519	.	A	G	19	10	29	0	2	31	0	0
4	74267540	.	G	A	2	20	22	0	11	33	0	0
4	74267582	.	T	G	10	17	27	0	0	27	0	0
4	74267639	.	T	A	16	7	23	0	2	25	0	0
4	74267733	.	A	T	14	14	28	0	1	29	0	0
4	74267748	.	C	T	14	15	29	0	2	31	0	0
4	74267865	.	A	C	12	8	20	0	1	21	0	0
4	74268175	.	A	G	10	4	14	0	0	14	0	0
4	74268182	.	C	T	5	9	14	0	1	15	0	0
4	74271251	.	G	A	4	4	8	0	0	8	0	0
4	74278079	.	T	G	5	3	8	0	0	8	0	0
4	74278093	.	C	T	0	3	3	0	3	6	0	0
4	74282709	.	C	T	0	3	3	0	1	4	0	0
4	74282917	.	G	A	4	3	7	0	1	8	0	0
4	74284790	.	A	C	3	5	8	0	0	8	0	0
4	74287776	.	T	A	1	3	4	1	0	5	0	0
4	74943202	.	A	T	3	8	11	0	0	11	0	0
4	74952477	.	G	A	10	7	17	0	1	18	0	0
4	74952525	.	A	G	7	0	7	0	10	18	1	0
4	74952660	.	G	T	0	4	4	0	13	17	0	0
4	74960826	.	C	T	19	11	30	0	1	31	0	0
4	74961011	.	C	T	18	5	23	2	3	28	0	0
4	74961075	.	G	A	20	12	32	0	0	32	0	0
4	74961520	.	T	A	9	10	19	0	0	19	0	0
4	75138707	.	G	A	6	8	14	0	1	15	0	0
4	75138750	.	A	G	9	4	13	0	2	15	0	0
4	75138987	.	C	T	15	6	21	1	2	24	0	0
4	75139002	.	A	T	14	3	17	2	0	19	0	0
4	75139194	.	C	T	9	13	22	0	1	23	0	0
4	75139264	.	T	C	14	9	23	0	3	26	0	0
4	75142269	.	G	A	8	13	21	0	0	21	0	0
4	75149056	.	C	T	13	9	22	0	2	24	0	0
4	75149071	.	T	A	17	10	27	0	1	28	0	0
4	75149125	.	C	A	1	9	10	0	8	18	0	0
4	75149149	.	C	T	1	10	11	0	4	15	0	0
4	75150806	.	T	G	9	3	12	0	0	12	0	0
4	75153925	.	C	T	8	6	14	0	1	15	0	0
4	75153930	.	G	A	7	6	13	0	0	13	0	0
4	75157596	.	C	T	0	1	1	0	1	2	0	0
4	75157620	.	T	G	1	4	5	0	1	6	0	0
4	75157664	.	T	C	1	5	6	0	0	6	0	0
4	75416647	.	G	A	1	2	3	0	0	3	0	0
4	75419353	.	C	T	3	3	6	0	0	6	0	0
4	75419421	.	G	T	2	2	4	0	0	4	0	0
4	75419428	.	C	T	1	1	2	0	0	2	0	0
4	75419653	.	G	A	4	3	7	0	0	7	0	0
4	75419819	.	C	G	4	6	10	0	1	11	0	0
4	75419822	.	A	C	4	6	10	0	0	10	0	0
4	75419916	.	G	T	9	4	13	0	1	14	0	0
4	75419928	.	T	G	6	0	6	0	6	12	0	0
4	75419961	.	A	C	7	6	13	0	1	14	0	0
4	75419970	.	G	A	1	4	5	0	8	13	0	0
4	75420086	.	C	T	11	3	14	0	2	16	0	0
4	75420270	.	A	G	7	3	10	0	1	11	0	0
4	75420318	.	T	A	6	4	10	0	0	10	0	0
4	75420558	.	A	T	10	5	15	1	0	16	0	0
4	75420779	.	G	A	7	0	7	0	0	7	0	0
4	75420873	.	A	C	3	7	10	0	0	10	0	0
4	75420931	.	A	T	2	6	8	0	1	9	0	0
4	75420934	.	A	G	3	5	8	0	0	8	0	0
4	75604344	.	A	T	3	4	7	1	0	8	0	0
4	75604345	.	T	G	3	4	7	1	0	8	0	0
4	75631387	.	A	C	1	3	4	0	1	5	0	0
4	75631390	.	T	A	1	4	5	0	0	5	0	0
4	75883206	.	C	A	1	2	3	1	0	4	0	0
4	76317041	.	T	C	3	2	5	0	0	5	0	0
4	76320439	.	C	T	2	5	7	0	0	7	0	0
4	76320752	.	G	A	4	3	7	0	2	9	0	0
4	76320798	.	C	G	3	6	9	0	0	9	0	0
4	76334633	.	A	G	3	0	3	1	2	6	0	0
4	76345974	.	A	G	2	2	4	0	0	4	0	0
4	76346188	.	T	A	3	4	7	0	0	7	0	0
4	76346238	.	C	A	3	3	6	3	0	10	1	0
4	76346509	.	C	A	6	3	9	9	0	18	0	0
4	76346554	.	A	G	5	0	5	0	3	8	0	0
4	76346564	.	C	T	4	2	6	0	0	6	0	0
4	76347135	.	A	G	5	2	7	1	1	9	0	0
4	76347280	.	A	G	8	3	11	0	0	11	0	0
4	76347332	.	A	G	4	2	6	2	3	11	0	0
4	76347508	.	T	G	11	8	19	0	0	19	0	0
4	76348066	.	T	G	4	0	4	0	4	8	0	0
4	76359632	.	C	T	2	2	4	0	0	4	0	0
4	76359636	.	C	T	1	4	5	0	0	5	0	0
4	76359969	.	C	T	3	2	5	0	0	5	0	0
4	76359993	.	C	T	4	2	6	0	0	6	0	0
4	76360216	.	G	T	0	2	2	0	2	4	0	0
4	76360241	.	T	A	1	2	3	0	0	3	0	0
4	76360416	.	A	T	3	2	5	0	0	5	0	0
4	76361349	.	T	C	1	3	4	0	0	4	0	0
4	76361388	.	G	A	2	2	4	0	0	4	0	0
4	76361624	.	T	A	8	4	12	0	0	12	0	0
4	76361627	.	G	A	0	4	4	0	9	13	0	0
4	76362977	.	T	G	1	3	4	0	1	5	0	0
4	76408988	.	G	A	1	3	4	0	0	4	0	0
4	76409192	.	A	G	1	2	3	0	2	5	0	0
4	76410634	.	A	G	2	2	4	0	0	4	0	0
4	76410940	.	G	T	2	4	6	0	0	6	0	0
4	76410955	.	C	T	1	3	4	0	0	4	0	0
4	76411005	.	A	G	2	3	5	0	0	5	0	0
4	76411990	.	A	G	3	0	3	0	2	5	0	0
4	76412061	.	A	G	4	3	7	0	0	7	0	0
4	76412107	.	C	T	3	2	5	0	0	5	0	0
4	76412108	.	T	G	3	2	5	0	0	5	0	0
4	76412531	.	A	T	5	4	9	0	0	9	0	0
4	76412884	.	G	T	17	5	22	0	1	23	0	0
4	76412887	.	G	A	18	4	22	0	0	23	1	0
4	76416857	.	G	T	2	2	4	0	0	4	0	0
4	76420875	.	C	T	1	0	1	0	1	2	0	0
4	76420883	.	G	A	1	2	3	0	0	3	0	0
4	76420930	.	T	A	1	2	3	0	0	3	0	0
4	76421193	.	C	T	2	2	4	0	0	4	0	0
4	76421739	.	T	C	2	2	4	0	0	4	0	0
4	76421958	.	C	T	1	7	8	0	0	8	0	0
4	76421987	.	G	T	1	5	6	0	0	6	0	0
4	76422424	.	A	G	1	5	6	0	0	6	0	0
4	76427137	.	G	C	3	2	5	0	0	5	0	0
4	76427145	.	A	G	2	3	5	0	1	6	0	0
4	76429102	.	A	G	1	3	4	0	0	4	0	0
4	76429191	.	G	A	5	3	8	0	0	8	0	0
4	76429202	.	A	C	2	3	5	0	0	5	0	0
4	76429545	.	C	A	1	2	3	0	0	3	0	0
4	76429684	.	A	C	2	5	7	1	0	8	0	0
4	76430256	.	G	A	1	3	4	0	0	4	0	0
4	76430257	.	A	G	1	3	4	0	0	4	0	0
4	76430388	.	C	G	3	2	5	0	0	5	0	0
4	76430404	.	A	G	3	5	8	0	1	9	0	0
4	76438049	.	T	C	1	2	3	0	1	4	0	0
4	76438803	.	C	A	2	2	4	0	0	4	0	0
4	76438832	.	C	T	1	2	3	0	0	3	0	0
4	76439339	.	C	A	4	2	6	0	0	6	0	0
4	76439374	.	C	T	1	2	3	0	0	3	0	0
4	76464319	.	T	G	1	2	3	0	0	3	0	0
4	76464324	.	T	G	1	3	4	0	0	4	0	0
4	76464354	.	C	T	1	4	5	0	1	6	0	0
4	76466770	.	G	C	2	2	4	0	0	4	0	0
4	76481403	.	T	A	5	9	14	0	1	15	0	0
4	76481409	.	T	G	5	8	13	0	0	13	0	0
4	76481511	.	A	G	6	3	9	0	0	9	0	0
4	76481665	.	A	T	1	3	4	0	0	4	0	0
4	76481692	.	T	C	2	0	2	0	2	4	0	0
4	76482245	.	C	T	1	3	4	0	0	4	0	0
4	76488742	.	G	C	1	2	3	0	0	3	0	0
4	76504227	.	T	A	2	3	5	0	0	5	0	0
4	76587462	.	T	C	1	5	6	0	0	6	0	0
4	76587474	.	C	T	3	4	7	2	0	9	0	0
4	76588133	.	A	C	7	8	15	4	1	20	0	0
4	76588134	.	C	G	7	0	7	3	9	19	0	0
4	76588177	.	T	C	5	7	12	0	0	12	0	0
4	76588295	.	G	T	13	4	17	0	1	18	0	0
4	76866989	.	A	G	3	3	6	0	0	6	0	0
4	76866993	.	A	G	4	2	6	0	0	6	0	0
4	76867743	.	T	C	19	5	24	0	0	24	0	0
4	76867829	.	C	G	11	4	15	0	1	16	0	0
4	77051459	.	A	T	2	2	4	0	0	4	0	0
4	77052192	.	T	G	1	0	1	0	2	3	0	0
4	77052213	.	C	T	0	1	1	0	1	2	0	0
4	77052419	.	A	G	2	0	2	0	2	4	0	0
4	77052631	.	G	A	6	2	8	0	2	10	0	0
4	77053734	.	A	T	2	3	5	0	0	5	0	0
4	77053738	.	G	A	0	3	3	0	2	5	0	0
4	77057243	.	G	C	2	4	6	0	0	6	0	0
4	77057635	.	C	T	1	4	5	0	1	6	0	0
4	77057671	.	G	A	1	1	2	0	0	2	0	0
4	77057695	.	C	G	1	0	1	0	4	5	0	0
4	77058097	.	T	C	2	4	6	0	0	6	0	0
4	77058108	.	A	G	3	2	5	0	0	5	0	0
4	77058420	.	C	G	3	2	5	0	0	5	0	0
4	77058503	.	G	C	2	4	6	0	0	6	0	0
4	77058543	.	G	A	1	3	4	0	0	4	0	0
4	77058603	.	A	T	2	3	5	0	0	5	0	0
4	77058604	.	A	G	2	3	5	0	0	5	0	0
4	77058723	.	A	G	3	6	9	0	1	10	0	0
4	77058754	.	T	C	1	2	3	0	4	7	0	0
4	77059850	.	A	G	3	7	10	0	2	12	0	0
4	77060175	.	A	G	2	2	4	0	0	4	0	0
4	77060179	.	A	G	2	2	4	0	0	4	0	0
4	77060222	.	G	C	8	2	10	0	0	10	0	0
4	77060260	.	G	A	5	1	6	0	1	7	0	0
4	77065342	.	A	T	6	2	8	0	0	8	0	0
4	77065472	.	G	A	0	2	2	0	3	5	0	0
4	77065540	.	G	A	2	3	5	0	0	5	0	0
4	77065582	.	A	C	3	2	5	0	1	6	0	0
4	77148661	.	T	C	1	2	3	0	0	3	0	0
4	77148695	.	G	T	2	3	5	0	0	5	0	0
4	77148706	.	G	C	3	3	6	0	0	6	0	0
4	77149111	.	G	C	1	2	3	0	0	3	0	0
4	77149412	.	G	A	0	3	3	0	2	5	0	0
4	77149414	.	C	T	2	3	5	0	0	5	0	0
4	77149765	.	C	T	1	4	5	0	0	5	0	0
4	77149888	.	C	T	6	4	10	0	0	10	0	0
4	77158574	.	G	C	1	2	3	0	0	3	0	0
4	77158575	.	A	G	1	0	1	0	2	3	0	0
4	77207768	.	G	C	2	6	8	0	0	8	0	0
4	77207903	.	C	T	2	7	9	0	10	19	0	0
4	77209054	.	A	G	7	8	15	0	8	23	0	0
4	77211866	.	G	A	6	5	11	0	0	11	0	0
4	77211872	.	G	A	7	5	12	0	0	12	0	0
4	77212126	.	G	T	2	4	6	0	0	6	0	0
4	77214843	.	C	A	1	4	5	0	1	6	0	0
4	77214846	.	G	A	2	4	6	0	0	6	0	0
4	77216563	.	C	A	4	5	9	0	0	9	0	0
4	77219373	.	T	G	3	6	9	0	0	9	0	0
4	77219421	.	C	G	5	3	8	1	0	9	0	0
4	77220252	.	T	C	1	0	1	0	4	5	0	0
4	77220296	.	G	C	1	4	5	0	0	5	0	0
4	77229875	.	G	A	3	4	7	0	0	7	0	0
4	77229982	.	T	A	1	3	4	0	1	5	0	0
4	77233790	.	C	T	1	4	5	0	1	6	0	0
4	77250925	.	T	C	5	5	10	0	0	10	0	0
4	77322898	.	A	G	1	2	3	0	0	3	0	0
4	77349372	.	A	G	3	2	5	0	0	5	0	0
4	77349374	.	G	A	3	2	5	0	0	5	0	0
4	77389776	.	A	C	3	2	5	0	0	5	0	0
4	77389877	.	C	T	8	6	14	0	0	14	0	0
4	77390006	.	G	A	7	9	16	0	0	16	0	0
4	77390083	.	A	T	4	5	9	0	0	9	0	0
4	77390164	.	G	T	3	4	7	0	0	7	0	0
4	77390174	.	C	T	3	7	10	0	1	11	0	0
4	77390254	.	T	G	1	7	8	0	1	9	0	0
4	77390288	.	A	C	4	6	10	0	0	10	0	0
4	77390314	.	A	G	7	5	12	0	0	12	0	0
4	77390347	.	G	C	9	6	15	0	0	15	0	0
4	77390400	.	G	A	5	4	9	0	1	10	0	0
4	77400439	.	G	T	1	2	3	0	0	3	0	0
4	77400454	.	A	T	1	2	3	0	0	3	0	0
4	77928526	.	G	C	3	3	6	0	1	7	0	0
4	77928565	.	T	C	14	16	30	0	0	30	0	0
4	77931408	.	G	A	21	15	36	0	2	38	0	0
4	77932143	.	C	T	30	17	47	0	3	50	0	0
4	77932186	.	T	C	28	12	40	0	1	41	0	0
4	77932198	.	A	G	20	11	31	0	6	37	0	0
4	77932221	.	A	G	14	14	28	0	3	31	0	0
4	77932408	.	G	C	13	13	26	0	3	29	0	0
4	77932414	.	T	C	12	11	23	0	1	24	0	0
4	77945088	.	A	G	1	3	4	0	0	4	0	0
4	77945109	.	G	A	1	2	3	0	0	3	0	0
4	77948591	.	G	A	1	2	3	0	1	4	0	0
4	77951184	.	T	C	1	0	1	0	3	4	0	0
4	77954290	.	T	A	4	2	6	0	2	8	0	0
4	77957718	.	C	A	5	2	7	0	0	7	0	0
4	77959360	.	C	G	3	3	6	0	0	6	0	0
4	77960215	.	T	A	10	3	13	0	0	13	0	0
4	77963210	.	C	G	8	6	14	0	2	16	0	0
4	77963637	.	T	G	5	0	5	0	9	14	0	0
4	77963819	.	C	T	8	8	16	0	1	17	0	0
4	77964574	.	C	A	8	16	24	0	1	25	0	0
4	77964609	.	G	A	1	12	13	0	14	27	0	0
4	77966234	.	A	G	1	0	1	0	2	3	0	0
4	77967578	.	G	C	1	4	5	0	0	5	0	0
4	77972217	.	A	G	2	2	4	0	0	4	0	0
4	77975404	.	C	G	0	3	3	0	1	4	0	0
4	77981599	.	C	T	2	2	4	0	0	4	0	0
4	77993813	.	T	C	5	2	7	0	0	8	1	0
4	77993916	.	G	A	6	9	15	0	1	16	0	0
4	77995476	.	T	C	11	11	22	0	0	22	0	0
4	77995941	.	C	T	9	9	18	1	5	24	0	0
4	77995990	.	C	G	9	11	20	1	0	21	0	0
4	77996032	.	C	A	4	11	15	0	0	16	1	0
4	77996171	.	C	T	3	8	11	0	1	12	0	0
4	78008782	.	T	C	6	8	14	0	1	15	0	0
4	78022570	.	A	G	8	10	18	0	0	18	0	0
4	78024247	.	A	G	25	26	51	0	0	51	0	0
4	78024558	.	C	T	3	32	35	0	24	59	0	0
4	78025223	.	C	T	2	26	28	0	21	49	0	0
5	318077	.	G	A	4	10	14	0	0	14	0	0
5	318125	.	C	T	4	10	14	0	1	15	0	0
5	320383	.	T	C	3	0	3	0	3	6	0	0
5	340614	.	A	G	12	8	20	0	2	22	0	0
5	340667	.	T	C	8	3	11	0	0	11	0	0
5	341288	.	T	C	9	8	17	0	2	19	0	0
5	341331	.	C	T	11	9	20	0	0	20	0	0
5	341740	.	A	C	21	12	33	0	1	34	0	0
5	342001	.	T	C	9	4	13	0	2	15	0	0
5	342047	.	A	G	17	11	28	0	0	28	0	0
5	342076	.	A	G	4	0	4	0	18	22	0	0
5	342134	.	A	G	7	5	12	0	2	14	0	0
5	393858	.	G	A	7	4	11	0	0	11	0	0
5	394181	.	G	A	7	7	14	0	1	15	0	0
5	394184	.	T	C	5	8	13	0	2	15	0	0
5	394238	.	A	G	12	9	21	0	3	24	0	0
5	394239	.	T	G	15	9	24	0	0	24	0	0
5	394360	.	C	G	8	4	12	0	3	15	0	0
5	394417	.	G	A	0	5	5	0	13	18	0	0
5	394484	.	A	G	3	2	5	0	2	7	0	0
5	395404	.	T	A	4	8	12	0	3	15	0	0
5	395405	.	T	C	4	10	14	0	1	15	0	0
5	440032	.	A	G	8	0	8	0	7	15	0	0
5	440033	.	A	C	8	6	14	0	2	16	0	0
5	440106	.	T	C	3	6	9	0	1	10	0	0
5	457736	.	C	G	9	7	16	0	1	17	0	0
5	486312	.	G	A	1	2	3	0	3	6	0	0
5	486313	.	C	T	3	2	5	0	0	5	0	0
5	496604	.	G	T	1	6	7	0	14	21	0	0
5	899907	.	C	T	1	0	1	0	2	3	0	0
5	899931	.	G	A	2	4	6	0	0	6	0	0
5	899952	.	C	T	4	2	6	0	0	6	0	0
5	905263	.	C	A	1	6	7	0	0	7	0	0
5	917336	.	C	T	13	5	18	0	0	18	0	0
5	1055103	.	C	T	17	10	27	0	1	28	0	0
5	1064013	.	A	G	22	10	32	0	1	33	0	0
5	1068116	.	T	A	15	16	31	0	0	31	0	0
5	1079480	.	C	T	7	8	15	0	0	15	0	0
5	1083073	.	A	G	1	0	1	0	4	5	0	0
5	1083237	.	T	A	1	3	4	0	0	4	0	0
5	1083242	.	T	C	1	2	3	0	0	3	0	0
5	1083679	.	G	A	0	3	3	3	2	8	0	0
5	1083894	.	T	G	12	0	12	0	8	20	0	0
5	1147566	.	T	G	1	2	3	0	0	3	0	0
5	1147569	.	A	G	1	0	1	0	2	3	0	0
5	1155594	.	G	A	1	3	4	0	0	4	0	0
5	1207835	.	C	T	12	8	20	0	2	22	0	0
5	1216494	.	A	G	3	9	12	0	0	12	0	0
5	1216536	.	C	T	0	6	6	0	7	13	0	0
5	1216575	.	G	A	6	6	12	0	0	12	0	0
5	1219263	.	C	T	8	11	19	0	0	19	0	0
5	1219381	.	G	A	13	12	25	0	1	26	0	0
5	1223368	.	A	T	10	15	25	0	3	28	0	0
5	1223369	.	C	T	12	16	28	0	1	29	0	0
5	1223460	.	G	A	8	9	17	0	4	21	0	0
5	1223487	.	G	T	14	5	19	0	2	21	0	0
5	1240403	.	C	A	0	3	3	1	3	7	0	0
5	1240589	.	C	T	0	2	2	0	2	4	0	0
5	1306307	.	G	C	1	2	3	0	1	4	0	0
5	1420729	.	A	G	2	10	12	0	0	12	0	0
5	1445964	.	G	A	1	1	2	0	0	2	0	0
5	1445989	.	A	G	0	2	2	0	0	2	0	0
5	1519571	.	G	C	7	8	15	0	2	17	0	0
5	1519574	.	T	A	8	6	14	0	3	17	0	0
5	1990836	.	A	T	5	1	6	1	2	9	0	0
5	1990838	.	A	T	5	1	6	1	2	9	0	0
5	2068299	.	C	A	3	2	5	0	0	5	0	0
5	2068959	.	A	T	7	6	13	3	6	22	0	0
5	2086223	.	C	G	1	2	3	0	1	4	0	0
5	2681146	.	G	T	1	3	4	0	0	4	0	0
5	2686225	.	G	C	3	3	6	0	1	7	0	0
5	2709533	.	A	G	1	8	9	0	0	9	0	0
5	2713967	.	A	G	22	23	45	0	2	47	0	0
5	2714042	.	C	T	35	17	52	0	0	52	0	0
5	2714135	.	C	T	29	23	52	0	2	54	0	0
5	2714237	.	G	A	24	26	50	0	1	51	0	0
5	2714495	.	G	A	28	21	49	0	1	50	0	0
5	2714507	.	A	G	29	20	49	0	1	50	0	0
5	2714531	.	T	C	23	0	23	0	17	40	0	0
5	2716930	.	G	A	11	9	20	2	0	22	0	0
5	2716963	.	G	A	13	11	24	0	0	24	0	0
5	2717014	.	G	A	10	11	21	0	1	22	0	0
5	2717022	.	G	A	9	11	20	0	0	20	0	0
5	2717260	.	T	C	8	8	16	0	0	16	0	0
5	2717350	.	G	C	6	0	6	0	10	16	0	0
5	2717611	.	C	T	4	8	12	0	1	13	0	0
5	2717623	.	A	G	3	7	10	0	1	11	0	0
5	2717960	.	A	G	3	7	10	0	0	10	0	0
5	2718696	.	A	G	6	3	9	0	0	9	0	0
5	2718834	.	G	A	6	2	8	0	0	8	0	0
5	2721588	.	C	T	6	4	10	0	1	11	0	0
5	2750127	.	G	A	1	2	3	0	0	3	0	0
5	2750244	.	G	A	2	3	5	0	0	5	0	0
5	2750256	.	G	A	3	2	5	0	0	5	0	0
5	3362996	.	G	A	1	3	4	0	0	4	0	0
5	3363014	.	C	T	2	3	5	0	0	5	0	0
5	3363050	.	C	T	1	3	4	0	0	4	0	0
5	3544098	.	C	T	16	13	29	0	2	31	0	0
5	3544380	.	C	T	24	19	43	0	2	45	0	0
5	3544955	.	T	C	10	18	28	0	1	29	0	0
5	3545011	.	T	A	23	13	36	0	3	39	0	0
5	3568494	.	C	T	8	13	21	0	0	21	0	0
5	3568518	.	G	T	6	10	16	0	0	16	0	0
5	3568530	.	C	T	10	6	16	0	1	17	0	0
5	3612254	.	A	G	1	3	4	0	1	5	0	0
5	3901564	.	A	C	1	5	6	0	0	6	0	0
5	3914638	.	T	G	15	17	32	0	0	32	0	0
5	3925732	.	A	C	11	1	12	0	12	24	0	0
5	3925769	.	T	C	7	12	19	0	1	20	0	0
5	3927524	.	G	A	4	3	7	0	1	8	0	0
5	3937644	.	T	C	1	3	4	0	0	4	0	0
5	4010639	.	G	C	2	4	6	0	0	6	0	0
5	4010666	.	A	G	1	0	1	0	4	5	0	0
5	4010735	.	C	T	1	6	7	0	1	8	0	0
5	4010747	.	T	C	1	6	7	0	0	7	0	0
5	4052191	.	G	A	7	9	16	0	0	16	0	0
5	4052225	.	A	G	6	3	9	0	1	10	0	0
5	4254061	.	C	T	2	12	14	0	14	28	0	0
5	4260424	.	T	C	14	11	25	1	0	26	0	0
5	4265417	.	T	C	6	7	13	0	2	15	0	0
5	4270791	.	C	A	1	7	8	0	7	15	0	0
5	4273144	.	T	C	10	7	17	0	1	18	0	0
5	4273159	.	T	C	11	8	19	0	1	20	0	0
5	4275481	.	C	T	2	10	12	0	12	24	0	0
5	4281626	.	A	G	9	6	15	0	2	17	0	0
5	4281634	.	A	G	11	5	16	0	1	17	0	0
5	4292545	.	A	T	4	2	6	0	0	6	0	0
5	4293975	.	T	C	1	2	3	0	0	3	0	0
5	4293978	.	C	A	2	2	4	0	0	4	0	0
5	4296556	.	C	G	4	4	8	0	0	8	0	0
5	4298902	.	G	C	8	6	14	0	3	17	0	0
5	4373684	.	C	T	13	7	20	0	2	22	0	0
5	4373701	.	G	T	2	4	6	0	10	16	0	0
5	4374299	.	A	G	2	2	4	0	0	4	0	0
5	4382543	.	A	G	13	8	21	0	0	21	0	0
5	4384706	.	G	A	6	5	11	0	2	13	0	0
5	4397741	.	A	G	5	3	8	0	0	8	0	0
5	4414178	.	C	T	5	4	9	0	2	11	0	0
5	5708595	.	C	G	3	6	9	0	1	10	0	0
5	5736673	.	A	G	2	2	4	0	0	4	0	0
5	5736683	.	C	T	1	2	3	0	3	6	0	0
5	5778624	.	G	A	2	4	6	0	0	6	0	0
5	6717505	.	C	T	2	2	4	0	0	4	0	0
5	6717804	.	T	C	3	3	6	0	0	6	0	0
5	6717809	.	G	A	2	4	6	0	0	6	0	0
5	6726416	.	T	C	3	2	5	0	0	5	0	0
5	6726866	.	A	C	6	1	7	0	0	7	0	0
5	6735293	.	A	G	0	2	2	0	1	3	0	0
5	6828589	.	A	T	1	2	3	0	0	3	0	0
5	6844179	.	C	T	1	3	4	0	0	4	0	0
5	6858380	.	C	A	10	7	17	0	0	17	0	0
5	6858389	.	T	A	2	13	15	0	0	15	0	0
5	6858540	.	T	A	15	8	23	0	1	24	0	0
5	6858779	.	G	T	2	10	12	0	12	24	0	0
5	6863577	.	C	T	22	10	32	0	2	34	0	0
5	6863647	.	C	T	19	6	25	0	5	30	0	0
5	6863768	.	G	C	9	17	26	0	0	26	0	0
5	6863793	.	G	A	6	25	31	0	0	31	0	0
5	6863834	.	A	G	4	0	4	0	17	22	1	0
5	6863855	.	G	A	13	8	21	0	1	22	0	0
5	6863912	.	A	C	14	4	18	0	0	18	0	0
5	6864010	.	C	T	7	4	11	0	1	12	0	0
5	6958910	.	T	C	3	2	5	0	0	5	0	0
5	6958965	.	G	C	3	2	5	0	0	5	0	0
5	6959148	.	C	A	4	2	6	0	0	6	0	0
5	6959158	.	C	A	0	3	3	0	0	3	0	0
5	6959363	.	T	C	1	6	7	0	0	7	0	0
5	7488233	.	C	T	2	2	4	0	0	4	0	0
5	7498844	.	C	A	4	3	7	0	0	7	0	0
5	8006206	.	A	G	7	5	12	0	2	14	0	0
5	8006474	.	A	G	8	4	12	0	8	20	0	0
5	8006503	.	A	G	15	9	24	0	2	26	0	0
5	8006977	.	A	G	14	7	21	0	0	21	0	0
5	8015099	.	C	T	0	4	4	0	6	10	0	0
5	8015165	.	G	A	6	3	9	0	0	9	0	0
5	8015192	.	C	T	0	5	5	0	4	9	0	0
5	8015252	.	C	T	3	7	10	0	0	10	0	0
5	8015361	.	G	T	6	10	16	1	0	17	0	0
5	8019962	.	A	G	5	5	10	0	0	10	0	0
5	8020001	.	C	T	6	7	13	0	0	13	0	0
5	8033036	.	A	G	3	3	6	0	1	7	0	0
5	8041956	.	A	T	1	2	3	0	0	3	0	0
5	10053867	.	C	T	1	3	4	0	1	5	0	0
5	10084310	.	C	T	2	3	5	0	0	5	0	0
5	10766286	.	G	A	7	13	20	0	1	21	0	0
5	10766505	.	A	G	19	18	37	4	0	41	0	0
5	10766529	.	G	A	18	17	35	7	5	47	0	0
5	10766879	.	A	G	8	14	22	0	1	23	0	0
5	10767113	.	C	T	8	7	15	0	0	15	0	0
5	10767259	.	A	G	18	11	29	0	0	29	0	0
5	10767588	.	C	T	1	2	3	0	0	3	0	0
5	10768089	.	G	A	3	3	6	0	1	7	0	0
5	10768215	.	T	C	1	0	1	0	3	4	0	0
5	11244625	.	T	C	3	3	6	0	0	6	0	0
5	11244675	.	A	G	6	5	11	0	1	12	0	0
5	11244741	.	G	A	6	4	10	0	0	10	0	0
5	11250049	.	C	T	2	3	5	0	0	5	0	0
5	11727397	.	T	A	4	2	6	0	0	6	0	0
5	11727417	.	C	T	0	4	4	0	3	7	0	0
5	11826347	.	T	C	2	5	7	0	0	7	0	0
5	11836437	.	T	C	4	4	8	0	2	10	0	0
5	11863501	.	G	A	1	3	4	0	0	4	0	0
5	11864542	.	G	T	2	2	4	0	0	4	0	0
5	11864572	.	C	G	4	3	7	0	1	8	0	0
5	11864593	.	A	G	5	4	9	0	0	9	0	0
5	11864774	.	T	G	13	9	22	0	2	24	0	0
5	11869576	.	C	A	0	5	5	0	9	14	0	0
5	11900230	.	T	C	8	1	9	0	2	11	0	0
5	11905661	.	T	C	3	1	4	0	1	5	0	0
5	11905890	.	A	G	5	7	12	0	0	12	0	0
5	11905903	.	T	G	6	2	8	0	0	8	0	0
5	11917125	.	C	T	10	9	19	0	1	20	0	0
5	11917405	.	G	A	10	8	18	0	2	20	0	0
5	11917485	.	G	A	15	3	18	0	1	19	0	0
5	11917596	.	C	A	1	17	18	0	10	28	0	0
5	11933155	.	A	G	2	9	11	1	1	13	0	0
5	11935444	.	G	A	2	4	6	0	1	7	0	0
5	11937486	.	G	A	4	4	8	0	0	8	0	0
5	11943674	.	A	G	1	2	3	0	1	4	0	0
5	11943934	.	C	A	2	4	6	0	0	6	0	0
5	11943948	.	T	A	2	2	4	0	1	5	0	0
5	11949244	.	G	T	5	9	14	0	0	14	0	0
5	11959776	.	G	T	0	19	19	0	6	25	0	0
5	11959777	.	C	T	20	5	25	0	0	25	0	0
5	11959818	.	C	T	13	16	29	0	2	31	0	0
5	11959966	.	C	G	14	13	27	0	2	29	0	0
5	11959988	.	G	A	3	11	14	0	15	29	0	0
5	11983017	.	T	C	9	4	13	0	1	14	0	0
5	11983085	.	C	T	1	1	2	0	1	3	0	0
5	11983395	.	T	A	6	4	10	0	0	10	0	0
5	11983548	.	C	G	4	11	15	0	0	15	0	0
5	11983959	.	C	T	1	2	3	0	0	3	0	0
5	11984086	.	T	C	2	3	5	0	0	5	0	0
5	11984133	.	C	T	4	5	9	0	0	9	0	0
5	11986647	.	C	G	1	2	3	0	1	4	0	0
5	11986649	.	T	C	2	2	4	0	0	4	0	0
5	12044753	.	T	C	1	0	1	0	2	3	0	0
5	12284075	.	C	T	15	19	34	0	1	35	0	0
5	12285172	.	T	C	5	0	5	0	10	15	0	0
5	12285316	.	C	T	1	3	4	0	0	4	0	0
5	12288511	.	T	C	4	4	8	0	2	10	0	0
5	12288541	.	A	G	6	5	11	0	1	12	0	0
5	12297084	.	C	T	3	7	10	0	0	10	0	0
5	12322321	.	G	A	2	6	8	0	0	8	0	0
5	12454563	.	T	C	2	0	2	0	3	5	0	0
5	12530423	.	G	T	3	3	6	0	0	6	0	0
5	12530425	.	C	A	3	3	6	0	0	6	0	0
5	12533197	.	C	T	3	4	7	0	2	9	0	0
5	12535785	.	A	T	2	4	6	0	0	6	0	0
5	12549258	.	C	T	7	9	16	0	3	19	0	0
5	12549326	.	C	T	4	6	10	0	0	10	0	0
5	12549981	.	G	T	1	2	3	0	0	3	0	0
5	12553935	.	C	T	0	2	2	0	3	5	0	0
5	12724121	.	C	T	13	8	21	0	4	25	0	0
5	12724224	.	G	A	15	8	23	0	0	23	0	0
5	12724249	.	A	C	5	13	18	0	0	18	0	0
5	12724292	.	C	A	7	7	14	0	2	16	0	0
5	12724307	.	A	G	8	9	17	0	1	18	0	0
5	12724412	.	A	G	6	2	8	0	0	8	0	0
5	12724505	.	C	A	7	10	17	0	1	18	0	0
5	12724518	.	G	C	7	1	8	0	16	24	0	0
5	12724567	.	A	G	18	12	30	0	1	31	0	0
5	12724694	.	C	T	1	11	12	0	15	27	0	0
5	12725930	.	G	A	12	19	31	0	1	32	0	0
5	12726842	.	A	G	19	11	30	0	0	30	0	0
5	12729397	.	C	T	4	8	12	0	0	12	0	0
5	12734883	.	G	T	6	3	9	0	0	9	0	0
5	12797446	.	T	C	3	2	5	0	0	5	0	0
5	12837064	.	G	A	1	2	3	0	0	3	0	0
5	12859258	.	T	C	15	16	31	0	1	32	0	0
5	12865111	.	A	G	14	6	20	0	2	22	0	0
5	12865134	.	A	G	7	13	20	0	0	20	0	0
5	12906273	.	C	T	3	7	10	0	0	10	0	0
5	12956918	.	T	C	5	5	10	0	0	10	0	0
5	12956960	.	C	T	2	6	8	0	0	8	0	0
5	12975297	.	G	A	1	5	6	0	11	17	0	0
5	12975532	.	C	T	12	4	16	0	1	17	0	0
5	13037199	.	C	T	0	2	2	0	1	3	0	0
5	13037967	.	G	A	3	3	6	0	0	6	0	0
5	13037998	.	A	G	5	3	8	0	0	8	0	0
5	13105020	.	C	T	10	11	21	0	0	21	0	0
5	13105070	.	C	A	0	7	7	0	10	17	0	0
5	13214048	.	T	C	3	2	5	0	1	6	0	0
5	13214802	.	C	G	4	2	6	0	0	6	0	0
5	13308959	.	G	A	4	4	8	0	0	8	0	0
5	13308985	.	T	C	3	5	8	0	0	8	0	0
5	13308997	.	G	T	10	4	14	0	0	14	0	0
5	13309174	.	T	C	10	0	10	0	17	27	0	0
5	13309215	.	C	T	12	9	21	0	1	22	0	0
5	13309273	.	C	T	8	10	18	0	1	19	0	0
5	13309309	.	G	A	11	14	25	0	0	25	0	0
5	13309402	.	A	G	8	11	19	0	0	19	0	0
5	13309435	.	A	T	12	11	23	0	0	23	0	0
5	13309522	.	G	A	7	15	22	1	1	24	0	0
5	13312671	.	A	T	12	12	24	0	1	25	0	0
5	13312746	.	G	A	9	10	19	0	1	20	0	0
5	13315490	.	G	C	15	6	21	0	0	21	0	0
5	13315526	.	T	C	8	3	11	0	0	11	0	0
5	13332930	.	A	G	2	2	4	0	0	4	0	0
5	13337803	.	C	T	13	15	28	0	0	28	0	0
5	13337883	.	T	A	14	21	35	0	2	37	0	0
5	13338441	.	C	T	1	15	16	1	17	34	0	0
5	13338762	.	A	T	9	8	17	0	0	17	0	0
5	13339038	.	G	C	14	11	25	2	11	38	0	0
5	13385888	.	A	G	2	0	2	0	3	5	0	0
5	13419418	.	T	C	2	2	4	0	0	4	0	0
5	13468172	.	C	T	2	6	8	0	0	8	0	0
5	13468574	.	G	A	2	3	5	0	0	5	0	0
5	13469137	.	C	A	1	3	4	0	0	4	0	0
5	13540689	.	C	T	1	2	3	0	1	4	0	0
5	13643325	.	G	A	19	14	33	0	1	34	0	0
5	13643411	.	C	T	3	22	25	0	27	52	0	0
5	13643824	.	G	A	7	11	18	0	1	19	0	0
5	13644126	.	A	T	21	17	38	0	1	39	0	0
5	13644185	.	T	G	17	11	28	0	0	28	0	0
5	13644189	.	T	G	18	11	29	0	0	29	0	0
5	13644227	.	A	G	15	7	22	1	2	25	0	0
5	13644256	.	A	T	12	10	22	3	2	27	0	0
5	13644581	.	T	G	14	14	28	0	2	30	0	0
5	13644602	.	T	A	17	11	28	0	0	28	0	0
5	13644781	.	C	T	9	8	17	0	2	19	0	0
5	13644797	.	A	G	7	7	14	0	0	14	0	0
5	13645047	.	C	G	7	12	19	0	2	21	0	0
5	13645746	.	A	G	12	6	18	0	2	20	0	0
5	13645885	.	T	C	8	7	15	0	0	15	0	0
5	13649518	.	C	T	11	11	22	0	2	24	0	0
5	13652410	.	T	C	16	17	33	0	4	37	0	0
5	13671899	.	C	G	5	10	15	0	1	16	0	0
5	13672004	.	C	T	1	19	20	0	10	30	0	0
5	13672211	.	C	T	11	14	25	0	0	25	0	0
5	13672232	.	C	T	14	9	23	0	1	24	0	0
5	13673016	.	C	G	3	9	12	0	7	19	0	0
5	13684132	.	A	G	4	5	9	0	0	9	0	0
5	13684502	.	C	A	5	12	17	0	7	24	0	0
5	13684983	.	G	T	3	2	5	0	1	6	0	0
5	13772666	.	T	C	27	17	44	1	3	48	0	0
5	13778659	.	G	T	17	20	37	0	1	38	0	0
5	13778663	.	C	T	14	20	34	0	0	34	0	0
5	13782325	.	T	C	33	19	52	0	0	52	0	0
5	13782786	.	C	A	10	7	17	0	0	17	0	0
5	13783516	.	A	C	4	3	7	0	1	8	0	0
5	13784243	.	T	A	4	3	7	0	0	7	0	0
5	13784486	.	G	T	4	3	7	0	0	7	0	0
5	13784559	.	T	A	6	2	8	1	1	10	0	0
5	13785289	.	T	C	4	0	4	1	3	8	0	0
5	13785304	.	A	G	5	2	7	1	0	8	0	0
5	13785441	.	A	G	4	6	10	0	0	10	0	0
5	13785485	.	T	C	4	0	4	0	3	7	0	0
5	13785490	.	G	A	4	4	8	0	0	8	0	0
5	13785522	.	T	C	3	4	7	0	0	7	0	0
5	13785559	.	G	A	1	2	3	0	0	3	0	0
5	13785563	.	T	C	2	2	4	0	0	4	0	0
5	13785735	.	C	T	3	3	6	0	0	6	0	0
5	13799613	.	G	A	1	5	6	0	0	6	0	0
5	13799635	.	C	T	1	4	5	0	0	5	0	0
5	13799704	.	G	A	1	4	5	0	1	6	0	0
5	13800062	.	C	T	2	2	4	0	2	6	0	0
5	14306793	.	G	T	21	23	44	0	3	47	0	0
5	14307459	.	G	A	10	9	19	0	2	21	0	0
5	14307720	.	C	T	12	13	25	0	0	25	0	0
5	14308710	.	A	G	11	10	21	0	1	22	0	0
5	14308773	.	G	A	6	8	14	0	0	14	0	0
5	14308792	.	C	A	7	14	21	0	1	22	0	0
5	14309219	.	A	G	2	5	7	0	0	7	0	0
5	14309334	.	C	T	1	6	7	0	4	11	0	0
5	14310874	.	T	A	6	5	11	0	1	12	0	0
5	14312030	.	C	T	0	6	6	0	3	9	0	0
5	14322212	.	C	T	1	2	3	0	0	3	0	0
5	14375330	.	T	A	6	3	9	0	2	11	0	0
5	14375529	.	A	G	9	18	27	0	2	29	0	0
5	14375598	.	A	G	17	14	31	0	1	32	0	0
5	14375623	.	A	G	14	16	30	0	2	32	0	0
5	14375881	.	T	C	7	6	13	1	1	15	0	0
5	14376155	.	A	G	21	12	33	1	0	34	0	0
5	14380632	.	C	T	7	9	16	0	0	16	0	0
5	14382534	.	C	G	10	5	15	0	0	15	0	0
5	14383193	.	G	A	5	5	10	0	1	11	0	0
5	14386045	.	T	A	4	5	9	0	0	9	0	0
5	14386277	.	A	G	1	2	3	0	0	4	1	0
5	14394466	.	A	G	21	19	40	0	1	41	0	0
5	14394515	.	G	A	17	22	39	0	1	40	0	0
5	14394698	.	G	A	11	3	14	0	4	18	0	0
5	14394872	.	T	A	14	8	22	0	0	22	0	0
5	14395430	.	G	A	9	6	15	0	3	18	0	0
5	14395664	.	G	A	13	11	24	0	0	24	0	0
5	14395697	.	G	A	7	11	18	0	2	20	0	0
5	14396438	.	C	G	0	5	5	0	10	15	0	0
5	14396876	.	C	T	4	2	6	0	0	6	0	0
5	14396893	.	G	T	2	4	6	0	0	6	0	0
5	14397231	.	T	A	5	2	7	0	0	7	0	0
5	14397232	.	G	T	5	2	7	0	0	7	0	0
5	14398876	.	A	T	0	2	2	0	1	3	0	0
5	14529221	.	C	T	4	12	16	0	12	28	0	0
5	14529450	.	C	T	11	11	22	0	0	22	0	0
5	14530091	.	T	G	2	3	5	0	0	5	0	0
5	14530457	.	G	A	2	2	4	0	0	4	0	0
5	14533937	.	C	T	0	3	3	0	1	4	0	0
5	15357517	.	A	G	5	5	10	0	1	11	0	0
5	15394285	.	G	T	6	6	12	0	1	13	0	0
5	15394354	.	G	A	2	8	10	0	1	11	0	0
5	15394357	.	A	G	0	8	8	0	2	10	0	0
5	15394396	.	C	T	0	7	7	0	2	9	0	0
5	16126203	.	C	T	2	3	5	0	0	5	0	0
5	16126440	.	T	C	1	3	4	0	1	5	0	0
5	16128533	.	G	A	2	4	6	0	0	6	0	0
5	16128798	.	C	T	8	7	15	0	1	16	0	0
5	16128841	.	G	A	10	8	18	0	0	18	0	0
5	16134766	.	C	T	0	6	6	0	4	10	0	0
5	16138840	.	G	C	1	2	3	0	0	3	0	0
5	16720830	.	G	A	2	4	6	0	0	6	0	0
5	16800437	.	A	G	20	12	32	0	1	33	0	0
5	16800710	.	T	C	16	0	16	0	15	31	0	0
5	16800955	.	C	T	2	12	14	0	6	20	0	0
5	16815222	.	C	G	7	10	17	0	0	17	0	0
5	16818828	.	G	A	13	11	24	0	1	25	0	0
5	16818858	.	T	G	10	10	20	0	1	21	0	0
5	16833631	.	A	G	11	7	18	0	0	18	0	0
5	16928099	.	T	C	6	0	6	0	3	9	0	0
5	16956501	.	G	A	3	4	7	0	1	8	0	0
5	16956615	.	C	T	5	13	18	0	0	18	0	0
5	16983206	.	C	T	2	6	8	0	0	8	0	0
5	17738720	.	G	A	0	7	7	0	3	10	0	0
5	17751894	.	A	T	8	8	16	0	1	17	0	0
5	17751939	.	A	G	9	6	15	0	0	15	0	0
5	17752545	.	A	G	17	17	34	0	2	36	0	0
5	17752778	.	A	T	8	5	13	0	0	13	0	0
5	17753214	.	G	A	5	9	14	0	4	18	0	0
5	17753216	.	G	A	7	8	15	0	3	18	0	0
5	17753584	.	C	G	16	0	16	0	19	35	0	0
5	17809748	.	T	A	3	4	7	0	0	7	0	0
5	17813051	.	T	G	2	2	4	0	0	4	0	0
5	17813181	.	C	T	4	2	6	0	0	6	0	0
5	17882282	.	T	A	4	6	10	0	0	10	0	0
5	17882291	.	C	T	4	6	10	0	0	10	0	0
5	17882438	.	G	A	4	2	6	0	0	6	0	0
5	17882454	.	G	A	5	2	7	0	0	7	0	0
5	17885194	.	T	C	2	0	2	0	5	7	0	0
5	17885287	.	A	C	4	2	6	0	2	8	0	0
5	17885863	.	G	A	3	2	5	0	2	7	0	0
5	17885920	.	C	T	1	4	5	0	0	5	0	0
5	18827368	.	T	C	2	3	5	0	0	5	0	0
5	18905088	.	T	A	6	7	13	0	1	14	0	0
5	18913004	.	T	C	2	2	4	0	0	4	0	0
5	18913313	.	G	C	3	6	9	0	0	9	0	0
5	18913435	.	G	C	8	8	16	0	0	16	0	0
5	18913480	.	C	A	2	10	12	0	6	18	0	0
5	18913580	.	C	T	7	7	14	0	1	15	0	0
5	18913587	.	T	G	7	6	13	0	0	14	1	0
5	18913772	.	T	A	7	11	18	0	0	18	0	0
5	18913792	.	T	A	12	8	20	0	1	21	0	0
5	18917589	.	T	A	1	4	5	0	1	6	0	0
5	18927412	.	A	C	2	5	7	0	1	8	0	0
5	18934879	.	C	T	6	9	15	0	1	16	0	0
5	18935317	.	G	A	3	9	12	1	0	13	0	0
5	18935327	.	G	A	6	4	10	1	0	11	0	0
5	18935437	.	G	T	8	8	16	0	0	16	0	0
5	18935553	.	A	T	2	5	7	0	0	7	0	0
5	18935661	.	A	T	2	2	4	0	1	5	0	0
5	18935677	.	C	T	3	4	7	0	0	7	0	0
5	18935752	.	C	T	4	8	12	0	0	12	0	0
5	18935832	.	G	A	0	6	6	0	11	17	0	0
5	18965845	.	G	A	7	5	12	0	0	12	0	0
5	18966343	.	C	T	1	3	4	0	5	9	0	0
5	18966410	.	A	G	1	3	4	0	0	4	0	0
5	18966553	.	G	A	6	5	11	0	0	11	0	0
5	18966611	.	C	T	5	4	9	0	1	10	0	0
5	18966695	.	C	T	4	5	9	0	0	9	0	0
5	18968390	.	C	T	4	2	6	0	0	6	0	0
5	18970922	.	C	G	2	3	5	0	0	5	0	0
5	18970923	.	G	A	3	2	5	0	0	5	0	0
5	18970983	.	G	A	5	3	8	0	1	9	0	0
5	18979769	.	T	A	1	2	3	0	0	3	0	0
5	18985806	.	G	A	1	2	3	0	0	3	0	0
5	19007201	.	G	A	4	5	9	0	1	10	0	0
5	19007282	.	C	T	7	4	11	0	1	12	0	0
5	19007306	.	A	G	5	7	12	0	0	12	0	0
5	19007355	.	C	T	7	3	10	0	0	10	0	0
5	19007374	.	T	A	4	5	9	0	0	9	0	0
5	19007392	.	G	A	5	5	10	0	0	10	0	0
5	19007452	.	T	A	6	8	14	0	2	16	0	0
5	19007498	.	C	T	10	9	19	0	0	19	0	0
5	19007606	.	G	A	12	7	19	0	0	19	0	0
5	19007686	.	C	T	8	6	14	0	0	14	0	0
5	19007702	.	C	T	7	7	14	0	3	17	0	0
5	19007760	.	G	A	13	12	25	0	0	25	0	0
5	19008334	.	A	G	35	3	38	1	14	53	0	0
5	19008335	.	A	G	34	8	42	1	9	52	0	0
5	19008379	.	G	A	23	20	43	0	4	47	0	0
5	19021922	.	C	T	2	3	5	0	1	6	0	0
5	19022146	.	T	C	11	9	20	0	0	20	0	0
5	19022250	.	C	T	22	14	36	0	1	37	0	0
5	19031187	.	G	C	7	7	14	0	0	14	0	0
5	19035241	.	T	C	6	0	6	0	3	9	0	0
5	19035286	.	C	T	0	7	7	0	0	7	0	0
5	19035299	.	T	C	2	6	8	0	0	8	0	0
5	19035328	.	C	A	2	3	5	0	1	6	0	0
5	19035507	.	A	G	3	2	5	0	1	6	0	0
5	19040491	.	G	A	2	2	4	0	0	4	0	0
5	19191559	.	T	C	1	3	4	0	0	4	0	0
5	19237466	.	G	A	1	3	4	0	0	4	0	0
5	19313317	.	G	A	2	2	4	0	0	4	0	0
5	19313338	.	C	A	3	2	5	0	0	5	0	0
5	19325641	.	G	T	10	10	20	0	2	22	0	0
5	19326549	.	G	C	9	11	20	0	2	22	0	0
5	19327072	.	G	C	13	13	26	0	2	28	0	0
5	19327221	.	G	A	15	9	24	0	2	26	0	0
5	19327700	.	A	T	11	18	29	0	0	29	0	0
5	19327815	.	T	A	7	11	18	0	2	20	0	0
5	19327979	.	G	T	12	9	21	0	0	21	0	0
5	19328135	.	G	A	18	14	32	0	5	37	0	0
5	19328216	.	A	G	20	15	35	0	0	35	0	0
5	19385849	.	A	T	2	2	4	0	0	4	0	0
5	19436667	.	T	C	5	0	5	0	5	10	0	0
5	19436677	.	G	A	7	5	12	0	0	12	0	0
5	19436704	.	C	G	4	7	11	0	0	11	0	0
5	19437002	.	C	G	11	5	16	0	0	16	0	0
5	19437013	.	A	T	9	4	13	0	2	15	0	0
5	19437162	.	G	A	4	5	9	0	0	9	0	0
5	19437213	.	G	A	7	8	15	0	0	15	0	0
5	19437253	.	G	A	10	13	23	0	2	25	0	0
5	19437608	.	G	A	8	3	11	0	0	11	0	0
5	19437640	.	T	C	9	4	13	0	0	13	0	0
5	19438084	.	C	T	0	3	3	0	6	9	0	0
5	19438097	.	G	A	4	2	6	0	1	7	0	0
5	19438458	.	G	T	3	2	5	0	1	6	0	0
5	19438572	.	A	G	4	2	6	0	0	6	0	0
5	19438744	.	T	C	3	5	8	0	1	9	0	0
5	19438865	.	T	A	3	2	5	0	1	6	0	0
5	19438954	.	A	T	2	2	4	0	2	6	0	0
5	19487093	.	C	T	0	1	1	0	1	2	0	0
5	19487102	.	A	G	1	2	3	0	0	3	0	0
5	19489764	.	T	G	8	6	14	0	1	15	0	0
5	19489821	.	C	A	10	7	17	0	0	17	0	0
5	19489964	.	C	G	10	9	19	0	1	20	0	0
5	19492344	.	G	A	5	8	13	0	0	13	0	0
5	19493896	.	C	A	5	3	8	0	1	9	0	0
5	19504322	.	C	A	1	4	5	0	0	5	0	0
5	19962395	.	C	T	1	3	4	0	0	4	0	0
5	19962412	.	A	C	1	4	5	0	0	5	0	0
5	19962431	.	A	T	1	3	4	0	0	4	0	0
5	19962527	.	G	T	5	8	13	0	0	13	0	0
5	19962590	.	C	A	10	9	19	0	1	20	0	0
5	19962721	.	T	A	7	11	18	0	0	18	0	0
5	19962880	.	T	C	7	0	7	0	10	17	0	0
5	19962891	.	G	A	7	11	18	0	0	18	0	0
5	19962959	.	G	T	6	18	24	0	0	24	0	0
5	19963023	.	A	G	8	17	25	0	6	31	0	0
5	19963065	.	A	T	11	15	26	0	0	26	0	0
5	20103255	.	C	A	2	7	9	0	0	9	0	0
5	20103314	.	G	T	6	7	13	0	0	13	0	0
5	20103315	.	C	T	7	7	14	0	0	14	0	0
5	20103410	.	G	A	9	2	11	0	0	11	0	0
5	20103416	.	T	A	9	3	12	0	1	13	0	0
5	20105039	.	A	G	6	3	9	0	1	10	0	0
5	20108008	.	C	G	13	5	18	1	0	19	0	0
5	20112585	.	T	A	3	2	5	0	0	5	0	0
5	20112599	.	C	T	1	2	3	0	1	4	0	0
5	20125939	.	T	A	9	2	11	0	1	12	0	0
5	20125995	.	C	A	3	2	5	0	0	5	0	0
5	20126133	.	A	G	6	5	11	0	1	12	0	0
5	20126407	.	A	C	2	0	2	0	2	4	0	0
5	20126416	.	C	T	0	1	1	0	2	3	0	0
5	20165544	.	C	T	3	4	7	0	1	8	0	0
5	20170985	.	T	C	18	10	28	0	2	30	0	0
5	20416958	.	T	C	3	4	7	0	0	7	0	0
5	20416976	.	C	T	3	2	5	0	1	6	0	0
5	20417274	.	G	A	2	2	4	0	5	9	0	0
5	20417515	.	T	C	2	2	4	0	0	4	0	0
5	20419008	.	A	T	4	4	8	0	0	8	0	0
5	20419087	.	A	G	9	4	13	0	0	13	0	0
5	20419563	.	A	C	6	5	11	0	0	11	0	0
5	20419613	.	G	A	5	6	11	0	0	11	0	0
5	20443918	.	T	A	1	3	4	0	0	4	0	0
5	20443949	.	A	G	3	7	10	0	1	11	0	0
5	20444017	.	G	T	3	13	16	0	1	17	0	0
5	20444216	.	G	C	25	25	50	0	1	51	0	0
5	20445065	.	G	A	13	9	22	0	1	23	0	0
5	20445985	.	A	T	12	17	29	0	1	30	0	0
5	20446021	.	T	A	9	11	20	0	0	20	0	0
5	20457390	.	C	T	2	3	5	0	0	5	0	0
5	20471875	.	G	C	3	5	8	0	0	8	0	0
5	20473812	.	A	G	1	0	1	0	6	7	0	0
5	20473818	.	G	A	0	3	3	0	3	6	0	0
5	20474076	.	A	G	7	5	12	0	4	16	0	0
5	20475730	.	A	G	4	7	11	0	0	11	0	0
5	20477419	.	T	C	5	11	16	0	1	17	0	0
5	20479990	.	A	G	2	10	12	0	1	13	0	0
5	20480036	.	A	T	3	4	7	0	0	7	0	0
5	20480369	.	T	C	3	4	7	0	1	8	0	0
5	20480401	.	G	A	2	3	5	0	1	6	0	0
5	20480758	.	T	A	19	10	29	0	1	30	0	0
5	20481132	.	G	A	7	5	12	0	2	14	0	0
5	20485863	.	A	C	1	3	4	0	0	4	0	0
5	20485896	.	T	C	1	2	3	0	0	3	0	0
5	20485965	.	C	T	1	2	3	0	0	3	0	0
5	20486727	.	G	T	7	2	9	0	1	10	0	0
5	20486746	.	A	G	6	2	8	0	1	9	0	0
5	20486866	.	T	C	5	2	7	0	0	7	0	0
5	20487175	.	A	G	6	3	9	0	0	9	0	0
5	20787190	.	T	C	7	8	15	0	2	17	0	0
5	20933332	.	T	C	5	0	5	3	35	43	0	0
5	22012345	.	T	C	4	3	7	0	0	7	0	0
5	22012459	.	T	C	3	5	8	0	2	10	0	0
5	22557201	.	T	C	1	9	10	0	0	10	0	0
5	23027521	.	T	A	12	0	12	0	0	12	0	0
5	23132256	.	G	T	5	2	7	0	1	8	0	0
5	23574618	.	T	A	3	2	5	0	0	5	0	0
5	23574916	.	T	C	2	7	9	0	0	9	0	0
5	23575646	.	T	C	4	4	8	0	0	8	0	0
5	23575661	.	T	C	5	2	7	0	0	7	0	0
5	24163289	.	A	G	1	2	3	0	0	3	0	0
5	24306251	.	G	A	1	2	3	0	0	3	0	0
5	24521408	.	A	G	2	2	4	0	0	4	0	0
5	24818461	.	T	C	4	2	6	0	1	7	0	0
5	24818523	.	T	C	4	8	12	0	1	13	0	0
5	24818529	.	T	C	8	6	14	0	1	15	0	0
5	24818941	.	T	C	1	4	5	0	1	6	0	0
5	26062531	.	A	G	3	3	6	0	0	6	0	0
5	26062532	.	A	G	3	3	6	0	0	6	0	0
5	26062582	.	A	G	3	4	7	0	0	7	0	0
5	26884903	.	A	G	2	2	4	0	0	4	0	0
5	29549150	.	G	A	6	2	8	0	0	8	0	0
5	29598984	.	T	C	40	0	40	0	15	55	0	0
5	30055414	.	T	C	1	2	3	0	0	3	0	0
5	30605614	.	A	G	3	3	6	0	0	6	0	0
5	30606225	.	A	G	5	2	7	0	1	8	0	0
5	32148443	.	G	A	7	2	9	0	0	9	0	0
5	32796645	.	T	C	6	2	8	0	0	8	0	0
5	32796648	.	T	C	5	3	8	0	0	8	0	0
5	32796772	.	T	C	2	2	4	0	0	4	0	0
5	33239220	.	C	A	2	2	4	0	0	4	0	0
5	33329786	.	A	G	9	11	20	0	2	22	0	0
5	34638474	.	C	T	8	3	11	0	1	12	0	0
5	35124435	.	T	C	10	1	11	0	9	20	0	0
5	35124479	.	C	T	1	10	11	0	9	20	0	0
5	35124859	.	C	T	3	2	5	0	1	6	0	0
5	35124939	.	G	A	9	2	11	0	1	12	0	0
5	35125882	.	G	A	3	3	6	0	0	6	0	0
5	35125883	.	A	T	3	2	5	0	1	6	0	0
5	35202876	.	A	T	7	14	21	0	1	22	0	0
5	35202958	.	G	A	7	10	17	0	2	26	7	0
5	35202959	.	A	T	13	11	24	0	2	26	0	0
5	35203092	.	G	A	12	4	16	0	1	17	0	0
5	35203629	.	C	T	1	14	15	0	8	23	0	0
5	35204077	.	T	G	7	6	13	0	1	14	0	0
5	35204159	.	C	T	5	7	12	0	1	13	0	0
5	35204280	.	A	T	5	4	9	0	1	10	0	0
5	35204322	.	A	G	5	4	9	0	0	9	0	0
5	35204353	.	C	T	5	7	12	0	0	12	0	0
5	35204390	.	G	A	4	7	11	0	1	12	0	0
5	35204754	.	C	T	4	5	9	0	0	9	0	0
5	35205005	.	G	A	9	6	15	0	0	15	0	0
5	35207914	.	T	G	3	3	6	0	0	6	0	0
5	35271001	.	C	T	33	19	52	0	1	53	0	0
5	35271154	.	A	T	22	20	42	0	2	44	0	0
5	35271181	.	A	G	25	25	50	0	2	52	0	0
5	35271194	.	G	A	25	29	54	0	0	54	0	0
5	35271309	.	T	A	30	29	59	0	2	61	0	0
5	35271465	.	T	C	25	24	49	0	3	52	0	0
5	35271824	.	C	A	17	20	37	0	1	38	0	0
5	35272032	.	G	A	7	10	17	0	1	18	0	0
5	35272560	.	T	G	10	8	18	0	0	18	0	0
5	35273062	.	G	A	20	12	32	0	2	34	0	0
5	35273225	.	T	C	5	9	14	0	1	15	0	0
5	35273447	.	A	G	12	4	16	0	0	16	0	0
5	35273509	.	A	T	6	8	14	0	2	16	0	0
5	35273546	.	A	T	5	10	15	0	0	15	0	0
5	35273564	.	G	A	3	10	13	0	0	13	0	0
5	35273708	.	T	C	6	4	10	0	0	10	0	0
5	35273793	.	A	T	5	11	16	0	0	16	0	0
5	35273838	.	A	C	10	10	20	0	0	20	0	0
5	35273992	.	A	G	6	4	10	0	1	11	0	0
5	35275103	.	C	T	7	4	11	0	0	11	0	0
5	35275859	.	G	T	6	4	10	0	0	10	0	0
5	35276303	.	G	C	1	5	6	0	0	6	0	0
5	35279230	.	T	G	3	4	7	0	1	8	0	0
5	35279275	.	T	G	5	5	10	0	2	12	0	0
5	35421824	.	C	T	1	4	5	0	2	7	0	0
5	35421840	.	A	G	2	5	7	0	1	8	0	0
5	35422324	.	T	C	4	9	13	0	1	14	0	0
5	35422402	.	A	G	2	5	7	0	1	8	0	0
5	35422530	.	C	T	6	8	14	0	1	15	0	0
5	35431641	.	A	G	4	6	10	0	2	12	0	0
5	35431703	.	T	G	4	11	15	0	1	16	0	0
5	35454464	.	C	T	12	8	20	0	1	21	0	0
5	35486714	.	T	C	1	2	3	0	1	4	0	0
5	35486955	.	T	C	1	3	4	0	0	4	0	0
5	35487030	.	A	G	2	6	8	0	1	9	0	0
5	35487416	.	G	C	3	2	5	0	0	5	0	0
5	35487767	.	T	G	5	0	5	0	6	11	0	0
5	35487781	.	C	G	3	5	8	0	0	8	0	0
5	35682874	.	A	G	2	3	5	0	0	5	0	0
5	35682967	.	C	A	1	4	5	0	0	5	0	0
5	35683116	.	G	A	3	2	5	0	0	5	0	0
5	35683134	.	C	A	3	2	5	0	0	5	0	0
5	35683950	.	T	A	2	2	4	0	0	4	0	0
5	35683965	.	C	T	0	2	2	0	3	5	0	0
5	35748938	.	T	C	2	2	4	0	0	4	0	0
5	35751883	.	G	T	2	2	4	0	1	5	0	0
5	35751977	.	A	G	4	17	21	0	2	23	0	0
5	35754284	.	A	G	16	0	16	0	11	27	0	0
5	35754424	.	T	C	17	11	28	0	2	30	0	0
5	35754431	.	A	G	15	0	15	0	13	28	0	0
5	35754503	.	A	C	18	13	31	0	1	32	0	0
5	35754599	.	T	A	20	16	36	0	1	37	0	0
5	35754663	.	A	G	15	12	27	0	2	29	0	0
5	35955514	.	T	C	7	6	13	0	0	13	0	0
5	35967234	.	C	T	11	15	26	0	1	27	0	0
5	35967270	.	T	A	7	6	13	0	0	13	0	0
5	35967438	.	A	T	2	4	6	0	0	6	0	0
5	35967500	.	A	G	2	0	2	0	4	6	0	0
5	35967910	.	A	G	1	4	5	0	0	5	0	0
5	36271160	.	T	G	2	2	4	0	0	4	0	0
5	36416204	.	A	G	4	5	9	0	3	12	0	0
5	36416307	.	C	G	7	0	7	0	9	16	0	0
5	36416367	.	G	A	2	5	7	0	9	16	0	0
5	36416478	.	G	T	16	9	25	0	1	26	0	0
5	36416583	.	C	T	17	16	33	0	0	33	0	0
5	36421991	.	G	A	2	13	15	0	7	22	0	0
5	36530959	.	A	T	2	1	3	0	1	4	0	0
5	36536665	.	T	C	12	4	16	0	1	17	0	0
5	36536742	.	C	T	9	11	20	0	0	20	0	0
5	36537020	.	A	G	4	5	9	0	2	11	0	0
5	36537021	.	T	A	6	5	11	0	0	11	0	0
5	36537057	.	G	A	6	4	10	0	0	10	0	0
5	36537073	.	A	C	8	5	13	0	0	13	0	0
5	36537246	.	A	G	14	1	15	0	7	22	0	0
5	36537334	.	A	T	11	3	14	0	0	14	0	0
5	36537352	.	G	A	9	4	13	0	1	14	0	0
5	36537611	.	C	A	9	8	17	0	1	18	0	0
5	36537672	.	C	A	10	4	14	0	1	15	0	0
5	36537927	.	T	C	3	2	5	0	1	6	0	0
5	36558059	.	G	A	27	17	44	0	4	48	0	0
5	36558348	.	A	G	18	14	32	0	3	35	0	0
5	36558369	.	G	A	18	16	34	0	3	37	0	0
5	36558441	.	C	T	24	17	41	0	2	43	0	0
5	36563257	.	T	C	6	12	18	0	1	19	0	0
5	36564205	.	A	G	1	8	9	0	0	9	0	0
5	36564206	.	A	T	1	8	9	0	0	9	0	0
5	36567750	.	C	A	1	3	4	0	6	10	0	0
5	36570280	.	G	A	4	5	9	0	0	9	0	0
5	36583575	.	C	T	1	4	5	0	3	8	0	0
5	36586867	.	A	G	2	3	5	0	0	5	0	0
5	36595912	.	G	A	5	3	8	0	0	8	0	0
5	36596106	.	A	G	1	3	4	0	0	4	0	0
5	36650289	.	T	G	1	3	4	0	0	4	0	0
5	36653522	.	G	A	1	2	3	0	0	3	0	0
5	36654147	.	G	A	0	9	9	0	6	15	0	0
5	36654334	.	A	T	1	4	5	0	0	5	0	0
5	36654344	.	G	A	3	4	7	0	0	7	0	0
5	36665351	.	C	T	8	15	23	0	1	24	0	0
5	36665680	.	C	T	1	3	4	0	0	4	0	0
5	36673347	.	C	T	4	5	9	0	0	9	0	0
5	36673470	.	C	A	3	5	8	0	0	8	0	0
5	36673609	.	A	G	4	4	8	0	0	8	0	0
5	36674796	.	G	C	5	8	13	0	0	13	0	0
5	36674831	.	C	T	6	8	14	0	1	15	0	0
5	36674911	.	C	T	2	4	6	0	0	6	0	0
5	36674925	.	T	C	1	2	3	0	1	4	0	0
5	36732199	.	G	C	13	14	27	0	0	27	0	0
5	36732217	.	A	G	12	12	24	0	1	25	0	0
5	36739134	.	T	C	10	12	22	0	0	22	0	0
5	36739310	.	T	A	13	14	27	0	1	28	0	0
5	36739316	.	T	C	12	13	25	0	1	26	0	0
5	36739352	.	T	A	10	8	18	0	3	21	0	0
5	36739361	.	T	C	11	7	18	0	0	18	0	0
5	36851191	.	C	T	1	6	7	0	0	7	0	0
5	36852564	.	A	G	3	0	3	0	6	9	0	0
5	36853849	.	C	G	9	12	21	0	1	22	0	0
5	36898476	.	C	T	29	12	41	0	1	42	0	0
5	36898668	.	A	G	28	0	28	0	27	55	0	0
5	36901003	.	T	G	8	4	12	0	1	13	0	0
5	36902610	.	A	G	9	0	9	0	7	16	0	0
5	36902628	.	T	C	10	5	15	0	0	15	0	0
5	36907182	.	G	T	6	3	9	0	1	10	0	0
5	36908034	.	T	C	18	15	33	0	1	34	0	0
5	36914002	.	C	T	4	6	10	0	1	11	0	0
5	36914018	.	A	C	5	1	6	0	6	12	0	0
5	36922399	.	A	G	1	3	4	0	0	4	0	0
5	36935627	.	A	C	1	2	3	0	0	3	0	0
5	36935815	.	A	G	1	4	5	0	0	5	0	0
5	36945378	.	T	A	20	16	36	6	2	44	0	0
5	36945383	.	A	T	20	19	39	6	2	47	0	0
5	36945463	.	T	A	36	17	53	0	2	55	0	0
5	36945518	.	T	G	24	25	49	0	7	56	0	0
5	36945719	.	G	T	27	38	65	2	11	78	0	0
5	36945747	.	T	A	21	30	51	2	21	74	0	0
5	36945927	.	A	C	35	28	63	0	4	67	0	0
5	36945937	.	C	T	31	29	60	0	2	62	0	0
5	36946244	.	A	G	30	31	61	0	5	66	0	0
5	36946261	.	T	C	27	2	29	0	40	69	0	0
5	36946341	.	C	T	7	29	36	0	31	67	0	0
5	36996458	.	A	G	3	8	11	0	1	12	0	0
5	36996638	.	A	G	8	0	8	0	12	20	0	0
5	36997133	.	A	G	11	8	19	0	1	20	0	0
5	37032095	.	A	G	2	9	11	0	0	11	0	0
5	37032191	.	T	C	2	5	7	0	1	8	0	0
5	37032280	.	C	G	5	9	14	0	0	14	0	0
5	37032339	.	A	G	2	0	2	0	5	7	0	0
5	37032611	.	T	C	5	2	7	0	0	7	0	0
5	37032782	.	G	A	6	4	10	0	0	10	0	0
5	37032799	.	A	T	7	6	13	0	0	13	0	0
5	37032959	.	A	G	6	9	15	0	0	15	0	0
5	37034111	.	T	C	6	6	12	0	0	12	0	0
5	37036404	.	T	C	9	6	15	0	0	15	0	0
5	37036856	.	T	C	8	16	24	0	0	24	0	0
5	37036975	.	A	T	3	4	7	0	0	8	1	0
5	37037079	.	C	T	13	6	19	0	1	20	0	0
5	37037152	.	T	C	12	20	32	0	1	33	0	0
5	37037308	.	C	A	4	8	12	0	1	13	0	0
5	37037436	.	G	T	2	4	6	0	4	10	0	0
5	37037583	.	T	C	10	13	23	0	1	24	0	0
5	37037617	.	A	T	10	25	35	0	0	35	0	0
5	37037669	.	T	G	13	21	34	0	1	35	0	0
5	37037742	.	A	T	21	21	42	0	2	44	0	0
5	37038017	.	T	C	4	9	13	0	1	14	0	0
5	37061485	.	G	A	7	3	10	0	1	11	0	0
5	37061487	.	C	T	6	3	9	0	1	10	0	0
5	37065416	.	T	C	18	17	35	0	1	36	0	0
5	37065729	.	C	T	17	4	21	0	0	23	2	0
5	37095076	.	A	T	5	1	6	0	1	7	0	0
5	37095320	.	T	A	1	2	3	0	1	4	0	0
5	37280343	.	T	G	2	6	8	0	0	8	0	0
5	37280856	.	C	T	2	4	6	0	0	6	0	0
5	37286325	.	A	G	6	0	6	0	6	12	0	0
5	37293768	.	G	A	2	4	6	0	0	6	0	0
5	37293815	.	T	C	1	4	5	0	0	5	0	0
5	37293841	.	G	A	1	3	4	0	0	4	0	0
5	37295646	.	C	T	3	3	6	0	0	6	0	0
5	37301236	.	G	A	7	10	17	0	0	17	0	0
5	37301249	.	C	T	6	9	15	0	2	17	0	0
5	37301282	.	C	T	4	7	11	0	2	13	0	0
5	37301505	.	A	G	11	8	19	0	0	19	0	0
5	37301783	.	A	G	11	6	17	0	1	18	0	0
5	37304028	.	T	C	9	8	17	0	0	17	0	0
5	37304070	.	G	T	7	7	14	0	1	15	0	0
5	37307921	.	C	G	18	21	39	0	0	39	0	0
5	37309734	.	A	G	14	22	36	0	2	38	0	0
5	37309881	.	C	T	23	27	50	0	4	54	0	0
5	37333870	.	G	A	4	6	10	0	0	10	0	0
5	37334264	.	T	A	2	2	4	0	0	4	0	0
5	37413762	.	G	A	1	2	3	0	0	3	0	0
5	37423193	.	G	A	2	3	5	0	0	5	0	0
5	37439388	.	C	T	5	9	14	0	0	14	0	0
5	37439418	.	C	T	2	10	12	0	0	12	0	0
5	37439505	.	T	C	3	4	7	0	0	7	0	0
5	37439517	.	A	C	2	3	5	0	2	7	0	0
5	37439891	.	T	C	18	12	30	0	0	30	0	0
5	37507901	.	C	T	1	2	3	0	0	3	0	0
5	37509296	.	G	C	9	10	19	0	0	19	0	0
5	37509703	.	C	T	7	16	23	0	1	24	0	0
5	37509766	.	G	A	0	10	10	1	5	16	0	0
5	37509857	.	A	G	5	10	15	0	2	17	0	0
5	37509916	.	A	G	2	6	8	0	3	11	0	0
5	37510292	.	C	T	4	7	11	0	0	11	0	0
5	37510293	.	T	C	4	7	11	0	0	11	0	0
5	37581111	.	G	A	2	3	5	0	0	5	0	0
5	37584380	.	G	A	0	1	1	0	2	3	0	0
5	37699115	.	A	G	4	4	8	0	0	8	0	0
5	37700908	.	T	C	2	4	6	0	1	7	0	0
5	37701262	.	T	A	1	4	5	0	0	5	0	0
5	37702934	.	C	T	5	5	10	0	3	13	0	0
5	37703176	.	G	A	0	5	5	0	7	12	0	0
5	37706798	.	C	T	6	11	17	1	0	18	0	0
5	37707190	.	G	A	9	7	16	0	0	16	0	0
5	37708995	.	A	T	14	14	28	1	0	29	0	0
5	37709057	.	T	A	6	16	22	0	2	24	0	0
5	37757677	.	C	T	2	7	9	0	0	9	0	0
5	37757690	.	T	C	4	7	11	0	0	11	0	0
5	37812090	.	C	T	3	2	5	0	1	6	0	0
5	37838415	.	T	C	25	34	59	0	6	65	0	0
5	37839029	.	G	T	61	32	93	0	1	94	0	0
5	37851294	.	G	A	0	4	4	0	1	5	0	0
5	37851528	.	T	C	1	2	3	0	0	3	0	0
5	37851542	.	G	A	1	2	3	0	0	3	0	0
5	37851742	.	G	A	2	5	7	0	1	8	0	0
5	37851758	.	T	A	3	4	7	0	0	7	0	0
5	37851830	.	C	A	4	6	10	0	0	10	0	0
5	37851876	.	C	T	4	5	9	0	0	9	0	0
5	37851923	.	G	A	3	4	7	0	0	7	0	0
5	37851970	.	A	C	3	2	5	0	1	6	0	0
5	37864845	.	A	G	5	5	10	0	2	12	0	0
5	37865142	.	C	T	6	4	10	0	0	10	0	0
5	37866310	.	C	T	2	2	4	0	0	4	0	0
5	37912292	.	T	A	22	14	36	0	0	36	0	0
5	37912442	.	A	G	8	13	21	0	1	22	0	0
5	37912489	.	T	A	8	17	25	0	0	25	0	0
5	37912748	.	A	T	13	6	19	0	0	19	0	0
5	37912859	.	A	C	7	5	12	0	0	12	0	0
5	37912970	.	A	C	10	3	13	0	0	13	0	0
5	37913041	.	C	G	8	9	17	0	0	17	0	0
5	37913064	.	T	C	4	10	14	0	2	16	0	0
5	37963259	.	C	T	2	3	5	0	0	5	0	0
5	37963262	.	G	T	3	2	5	0	0	5	0	0
5	37963316	.	C	A	2	4	6	0	0	6	0	0
5	37963326	.	C	A	1	2	3	0	0	3	0	0
5	37968912	.	T	G	1	3	4	0	0	4	0	0
5	37968951	.	G	A	4	4	8	0	0	8	0	0
5	37968966	.	T	C	2	3	5	0	0	5	0	0
5	37970764	.	C	T	4	3	7	0	2	9	0	0
5	37970773	.	A	T	3	4	7	0	1	8	0	0
5	37970818	.	T	G	3	0	3	0	5	8	0	0
5	37982156	.	G	C	6	0	6	0	4	10	0	0
5	37987325	.	C	T	1	3	4	0	7	11	0	0
5	37989090	.	G	A	8	5	13	0	1	14	0	0
5	37989135	.	A	G	4	5	9	0	0	9	0	0
5	37989325	.	G	A	10	5	15	0	0	15	0	0
5	37989379	.	G	T	4	5	9	0	1	10	0	0
5	37989443	.	A	C	1	5	6	0	0	6	0	0
5	37989447	.	A	G	1	4	5	0	0	5	0	0
5	38089930	.	G	T	2	2	4	0	0	4	0	0
5	38101869	.	C	T	1	2	3	0	1	4	0	0
5	38106815	.	C	T	1	3	4	0	0	4	0	0
5	38110826	.	G	T	9	6	15	0	0	15	0	0
5	38110908	.	A	T	17	8	25	0	0	25	0	0
5	38111060	.	T	C	12	0	12	0	7	19	0	0
5	38115349	.	T	C	3	5	8	0	1	9	0	0
5	38115361	.	T	C	2	5	7	0	1	8	0	0
5	38115395	.	A	G	3	4	7	0	1	8	0	0
5	38115502	.	C	T	6	4	10	0	0	10	0	0
5	38115582	.	C	T	7	7	14	0	0	14	0	0
5	38115940	.	T	C	1	0	1	0	5	6	0	0
5	38121914	.	T	A	2	5	7	0	0	7	0	0
5	38121942	.	A	G	2	4	6	0	0	6	0	0
5	38121991	.	A	T	4	3	7	0	1	8	0	0
5	38121993	.	T	C	4	4	8	0	0	8	0	0
5	38122100	.	C	A	4	3	7	0	0	7	0	0
5	38122112	.	T	A	3	3	6	0	0	6	0	0
5	38214567	.	T	G	1	1	2	0	1	3	0	0
5	38216140	.	C	T	5	5	10	0	0	10	0	0
5	38216204	.	G	A	7	2	9	0	0	9	0	0
5	38216469	.	C	A	2	3	5	0	0	5	0	0
5	38216471	.	C	T	1	3	4	0	2	6	0	0
5	38216661	.	G	A	1	4	5	0	0	5	0	0
5	38217422	.	G	T	3	4	7	0	0	7	0	0
5	38251120	.	A	C	2	5	7	0	0	7	0	0
5	38251506	.	C	T	0	3	3	0	2	5	0	0
5	38251968	.	T	G	4	4	8	0	0	8	0	0
5	38254919	.	A	G	1	2	3	0	0	3	0	0
5	38254958	.	C	T	0	2	2	0	3	5	0	0
5	38255108	.	G	T	1	2	3	0	0	3	0	0
5	38255132	.	G	A	1	2	3	0	0	3	0	0
5	38255219	.	A	C	1	0	1	0	3	4	0	0
5	38263870	.	C	T	5	3	8	0	0	8	0	0
5	38281540	.	G	C	2	6	8	0	6	14	0	0
5	38287103	.	C	T	6	13	19	0	1	20	0	0
5	38288313	.	T	A	8	8	16	0	0	16	0	0
5	38288346	.	T	A	5	12	17	0	1	18	0	0
5	38289358	.	A	C	7	14	21	0	1	22	0	0
5	38296192	.	C	T	14	16	30	0	2	32	0	0
5	38296193	.	A	G	14	16	30	0	2	32	0	0
5	38296475	.	G	A	17	12	29	0	0	29	0	0
5	38296765	.	A	C	20	16	36	0	1	37	0	0
5	38296799	.	A	C	20	12	32	0	2	34	0	0
5	38297305	.	A	G	20	2	22	0	27	49	0	0
5	38302085	.	G	A	19	12	31	0	0	31	0	0
5	38302158	.	C	A	25	10	35	0	5	40	0	0
5	38302159	.	A	C	32	9	41	0	1	42	0	0
5	38302490	.	A	G	23	22	45	0	2	47	0	0
5	38302589	.	T	A	22	19	41	0	1	42	0	0
5	38302753	.	G	T	24	18	42	0	4	46	0	0
5	38302859	.	C	T	20	21	41	0	2	43	0	0
5	38302911	.	A	T	15	13	28	0	1	29	0	0
5	38303028	.	G	T	14	28	42	0	0	42	0	0
5	38303301	.	T	C	7	1	8	2	11	21	0	0
5	38303895	.	A	T	16	13	29	0	1	30	0	0
5	38303896	.	G	A	14	15	29	0	1	30	0	0
5	38304578	.	C	T	15	13	28	0	1	29	0	0
5	38304633	.	T	G	7	19	26	0	1	27	0	0
5	38304768	.	G	A	12	10	22	0	0	22	0	0
5	38305068	.	G	A	10	13	23	0	2	25	0	0
5	38305127	.	T	C	5	11	16	0	1	19	2	0
5	38305493	.	C	T	1	3	4	0	0	4	0	0
5	38305698	.	G	A	2	4	6	0	0	6	0	0
5	38308378	.	C	A	7	9	16	0	0	16	0	0
5	38314069	.	C	T	3	2	5	0	0	5	0	0
5	38389087	.	C	G	4	2	6	0	0	6	0	0
5	38389089	.	G	A	4	2	6	0	0	6	0	0
5	38389147	.	T	C	6	5	11	0	0	11	0	0
5	38389165	.	G	T	4	4	8	0	1	9	0	0
5	38389538	.	G	A	4	3	7	0	0	7	0	0
5	38532535	.	A	G	1	2	3	0	0	3	0	0
5	38533392	.	G	T	5	3	8	0	0	8	0	0
5	38533404	.	C	T	0	3	3	0	5	8	0	0
5	38604964	.	T	A	2	2	4	0	0	4	0	0
5	38605094	.	C	T	9	7	16	0	1	17	0	0
5	38605106	.	A	T	12	7	19	0	2	21	0	0
5	38605164	.	C	T	9	5	14	0	0	14	0	0
5	38605201	.	A	C	9	3	12	0	2	14	0	0
5	38605347	.	G	T	20	6	26	2	1	29	0	0
5	38611096	.	G	T	7	6	13	0	0	13	0	0
5	38611108	.	T	C	6	0	6	0	5	12	1	0
5	38721044	.	G	C	3	7	10	0	0	10	0	0
5	38745925	.	C	T	3	2	5	0	0	5	0	0
5	38745962	.	A	T	3	2	5	0	0	5	0	0
5	38745980	.	G	T	0	3	3	0	2	5	0	0
5	38749541	.	T	A	5	2	7	0	1	8	0	0
5	38749814	.	G	A	1	3	4	0	1	5	0	0
5	38749892	.	C	T	3	2	5	0	1	6	0	0
5	38749893	.	C	T	3	3	6	0	0	6	0	0
5	38749939	.	C	A	4	2	6	0	0	6	0	0
5	38750033	.	A	C	7	2	9	0	0	9	0	0
5	38750035	.	A	G	7	2	9	0	0	9	0	0
5	38750125	.	A	G	4	0	4	0	5	9	0	0
5	38750127	.	T	A	4	5	9	0	0	9	0	0
5	38750354	.	T	G	3	2	5	0	0	5	0	0
5	38786808	.	C	T	8	3	11	0	0	11	0	0
5	38786823	.	G	A	9	3	12	0	0	12	0	0
5	38786922	.	T	C	4	5	9	0	1	10	0	0
5	38826047	.	A	C	1	2	3	0	1	4	0	0
5	38827340	.	T	A	6	3	9	0	0	9	0	0
5	38831573	.	A	G	7	3	10	0	1	11	0	0
5	39081359	.	C	G	2	0	2	0	7	9	0	0
5	39083116	.	T	C	2	3	5	0	1	6	0	0
5	39083125	.	G	A	2	4	6	0	0	6	0	0
5	39085302	.	T	A	3	1	4	0	1	5	0	0
5	39085328	.	C	T	1	3	4	0	0	4	0	0
5	39085976	.	C	T	6	5	11	0	0	11	0	0
5	39143447	.	C	T	3	3	6	0	1	7	0	0
5	39151045	.	A	T	2	3	5	0	0	5	0	0
5	39151493	.	G	A	0	2	2	0	2	4	0	0
5	39151610	.	T	A	2	2	4	0	0	4	0	0
5	39152155	.	G	A	1	3	4	0	1	5	0	0
5	39152156	.	T	C	2	2	4	0	1	5	0	0
5	39152411	.	C	T	5	5	10	0	2	12	0	0
5	39152582	.	A	G	3	5	8	0	0	8	0	0
5	39152613	.	T	A	5	3	8	0	0	8	0	0
5	39154819	.	C	G	10	13	23	0	0	23	0	0
5	39154829	.	G	T	11	13	24	0	1	25	0	0
5	39154919	.	A	G	10	16	26	0	0	26	0	0
5	39154958	.	C	G	9	10	19	0	0	19	0	0
5	39154979	.	C	T	0	12	12	0	10	22	0	0
5	39155006	.	T	A	7	19	26	0	1	27	0	0
5	39155044	.	A	G	10	14	24	0	0	24	0	0
5	39155146	.	T	A	2	4	6	0	0	6	0	0
5	39155419	.	C	T	3	4	7	0	0	7	0	0
5	39155474	.	G	T	7	2	9	0	1	10	0	0
5	39155511	.	A	G	4	7	11	0	0	11	0	0
5	39160584	.	G	A	5	2	7	0	0	7	0	0
5	39386667	.	A	G	6	4	10	0	0	10	0	0
5	39386685	.	A	G	8	3	11	0	0	11	0	0
5	39508009	.	C	T	19	17	36	0	0	36	0	0
5	39508059	.	T	A	21	10	31	0	4	35	0	0
5	39508540	.	G	A	2	7	9	2	12	23	0	0
5	39707665	.	A	T	3	2	5	0	0	5	0	0
5	39707758	.	A	C	4	10	14	0	0	14	0	0
5	39707825	.	G	A	13	9	22	0	0	22	0	0
5	39708046	.	A	G	9	15	24	0	0	24	0	0
5	39712557	.	T	C	8	11	19	0	0	19	0	0
5	39714917	.	T	C	5	7	12	0	0	12	0	0
5	39715249	.	G	A	10	8	18	0	0	18	0	0
5	39730511	.	A	G	1	3	4	0	1	5	0	0
5	39730575	.	C	T	2	2	4	0	0	4	0	0
5	39730713	.	T	C	3	2	5	0	0	5	0	0
5	39736279	.	C	T	2	2	4	0	0	4	0	0
5	40052933	.	A	G	4	22	26	1	0	27	0	0
5	40054407	.	C	G	6	10	16	0	1	17	0	0
5	40059722	.	C	G	6	6	12	0	1	13	0	0
5	40059761	.	T	C	6	8	14	0	0	14	0	0
5	40062351	.	A	G	4	4	8	0	1	9	0	0
5	40062390	.	G	A	3	5	8	0	0	8	0	0
5	40203540	.	G	A	8	5	13	0	0	13	0	0
5	40206117	.	G	A	3	4	7	0	0	7	0	0
5	40206358	.	A	C	2	2	4	0	0	4	0	0
5	40210379	.	A	C	1	3	4	0	0	4	0	0
5	40273444	.	A	C	5	4	9	0	0	9	0	0
5	40273468	.	T	C	2	2	4	0	1	5	0	0
5	40273864	.	G	A	2	4	6	0	0	6	0	0
5	40506670	.	G	A	2	2	4	0	0	4	0	0
5	40728810	.	T	C	1	0	1	0	2	3	0	0
5	40728852	.	A	G	2	4	6	0	0	6	0	0
5	40729081	.	A	C	4	5	9	0	1	10	0	0
5	40729147	.	T	C	7	4	11	0	0	11	0	0
5	40729270	.	G	C	2	2	4	0	1	5	0	0
5	40729408	.	G	A	4	12	16	0	0	16	0	0
5	40729618	.	A	G	7	4	11	0	0	11	0	0
5	40845312	.	A	G	7	5	12	0	0	12	0	0
5	40845344	.	G	C	6	5	11	0	0	11	0	0
5	40845387	.	A	G	4	5	9	0	0	9	0	0
5	40845389	.	A	T	4	4	8	0	1	9	0	0
5	40845433	.	A	G	3	4	7	0	0	7	0	0
5	40845434	.	G	A	3	4	7	0	0	7	0	0
5	40845556	.	C	A	5	4	9	0	0	9	0	0
5	40845893	.	A	G	1	3	4	0	0	4	0	0
5	40846122	.	G	A	4	4	8	0	0	8	0	0
5	40856738	.	T	G	4	2	6	0	0	6	0	0
5	41082921	.	C	G	9	15	24	0	0	24	0	0
5	41082951	.	A	C	7	0	7	0	15	22	0	0
5	41083000	.	C	A	10	12	22	0	0	22	0	0
5	41083001	.	T	C	10	0	10	0	12	22	0	0
5	41083118	.	C	T	1	5	6	0	3	9	0	0
5	41083227	.	A	G	5	4	9	0	1	10	0	0
5	41083763	.	A	G	3	9	12	0	2	14	0	0
5	41083986	.	T	C	16	6	22	0	0	22	0	0
5	41084063	.	G	C	8	4	12	0	0	12	0	0
5	41084274	.	A	G	13	14	27	0	1	28	0	0
5	41084367	.	C	A	0	4	4	0	3	7	0	0
5	41085118	.	A	G	1	4	5	0	0	5	0	0
5	41085511	.	C	T	0	3	3	0	3	6	0	0
5	41086082	.	T	G	7	5	12	0	0	12	0	0
5	41086156	.	C	A	7	2	9	0	2	11	0	0
5	41086195	.	A	T	1	2	3	0	0	3	0	0
5	41103286	.	T	C	3	4	7	0	2	9	0	0
5	41103462	.	A	G	4	2	6	0	1	7	0	0
5	41103469	.	G	A	5	2	7	0	0	7	0	0
5	41124738	.	G	T	0	2	2	0	0	2	0	0
5	41124760	.	T	C	4	2	6	0	6	12	0	0
5	41125097	.	C	T	2	4	6	0	0	6	0	0
5	41125229	.	G	T	1	5	6	0	0	6	0	0
5	41125310	.	A	C	17	26	43	0	4	47	0	0
5	41125311	.	A	C	19	27	46	0	2	48	0	0
5	41125354	.	C	A	27	19	46	0	2	48	0	0
5	41125996	.	T	C	22	17	39	0	1	40	0	0
5	41126059	.	G	A	14	18	32	0	3	35	0	0
5	41127078	.	A	G	14	15	29	0	0	29	0	0
5	41127111	.	T	C	15	15	30	0	0	30	0	0
5	41127132	.	C	T	13	12	25	0	1	26	0	0
5	41128808	.	T	G	8	12	20	0	2	23	1	0
5	41133401	.	A	T	7	7	14	0	0	14	0	0
5	41134921	.	A	T	3	2	5	0	0	5	0	0
5	41134942	.	A	G	3	2	5	0	0	5	0	0
5	41135002	.	A	G	7	4	11	0	0	11	0	0
5	41137311	.	G	A	1	4	5	0	0	5	0	0
5	41137341	.	G	A	2	3	5	0	0	5	0	0
5	41138377	.	C	T	4	4	8	0	1	9	0	0
5	41146801	.	G	A	20	18	38	0	2	40	0	0
5	41150615	.	C	T	22	14	36	0	0	36	0	0
5	41150898	.	T	A	12	23	35	0	3	38	0	0
5	41150979	.	A	C	31	23	54	0	1	55	0	0
5	41151265	.	G	A	17	7	24	0	2	26	0	0
5	41260937	.	C	T	3	11	14	0	0	14	0	0
5	41261032	.	A	G	4	3	7	0	0	7	0	0
5	41261901	.	G	C	2	2	4	0	0	4	0	0
5	41261907	.	G	A	2	2	4	0	0	4	0	0
5	41478237	.	G	A	1	3	4	0	0	4	0	0
5	41478264	.	A	G	3	0	3	0	3	6	0	0
5	41481405	.	A	G	8	8	16	0	0	16	0	0
5	41484391	.	A	C	9	11	20	0	1	21	0	0
5	41484496	.	T	C	11	15	26	0	0	26	0	0
5	41484680	.	C	T	9	17	26	0	1	27	0	0
5	41484797	.	C	A	13	16	29	0	0	29	0	0
5	41485363	.	C	G	21	16	37	0	2	39	0	0
5	41485365	.	A	G	22	17	39	0	0	39	0	0
5	41485497	.	C	G	31	16	47	0	0	47	0	0
5	41485533	.	C	T	2	20	22	0	32	54	0	0
5	41485709	.	A	T	27	36	63	0	2	65	0	0
5	41485814	.	A	T	27	30	57	0	0	57	0	0
5	41486025	.	A	G	27	30	57	0	4	61	0	0
5	41486031	.	T	G	29	30	59	0	0	59	0	0
5	41486803	.	G	A	26	22	48	0	2	50	0	0
5	41486890	.	C	T	18	29	47	0	6	53	0	0
5	41488903	.	A	G	15	26	41	0	0	41	0	0
5	41489487	.	G	T	13	13	26	0	1	27	0	0
5	41489493	.	C	T	13	14	27	0	1	28	0	0
5	41489748	.	T	C	16	14	30	0	2	32	0	0
5	41492135	.	C	T	12	8	20	0	1	21	0	0
5	41492183	.	C	T	3	12	15	0	13	28	0	0
5	41492234	.	G	A	18	13	31	0	1	32	0	0
5	41492279	.	G	A	12	19	31	0	0	31	0	0
5	41492901	.	G	A	5	13	18	0	2	20	0	0
5	41492934	.	A	G	9	6	15	0	1	16	0	0
5	41508353	.	T	A	5	5	10	0	0	10	0	0
5	41508900	.	C	G	3	4	7	0	0	7	0	0
5	41513013	.	T	C	3	3	6	0	1	7	0	0
5	41514127	.	A	G	5	3	8	0	0	8	0	0
5	41516322	.	A	C	3	3	6	0	0	6	0	0
5	41516521	.	G	A	5	4	9	0	0	9	0	0
5	41518836	.	T	C	13	9	22	0	1	23	0	0
5	41519423	.	A	C	18	28	46	1	0	47	0	0
5	41519459	.	T	C	21	28	49	1	1	51	0	0
5	41520822	.	A	T	21	26	47	0	3	50	0	0
5	41520823	.	T	C	22	26	48	0	2	50	0	0
5	41520886	.	G	A	13	4	17	0	3	20	0	0
5	41521171	.	T	C	1	2	3	0	0	3	0	0
5	41560836	.	T	A	1	2	3	0	0	3	0	0
5	41585126	.	C	T	3	2	5	0	0	5	0	0
5	41585186	.	G	A	3	4	7	0	0	7	0	0
5	41639787	.	A	T	6	8	14	0	1	15	0	0
5	41639814	.	A	G	6	8	14	0	1	15	0	0
5	41639874	.	G	T	7	10	17	0	0	17	0	0
5	41641750	.	G	A	11	7	18	1	1	20	0	0
5	41641835	.	G	C	7	15	22	0	0	22	0	0
5	41641887	.	A	G	7	13	20	0	0	20	0	0
5	41642167	.	A	G	5	4	9	0	0	9	0	0
5	41645652	.	A	G	18	20	38	0	3	41	0	0
5	41645815	.	C	G	17	8	25	0	0	25	0	0
5	41645827	.	T	A	17	12	29	0	0	29	0	0
5	41645982	.	A	G	26	17	43	0	2	45	0	0
5	41650451	.	T	C	10	1	11	0	17	28	0	0
5	41650505	.	T	G	5	3	8	0	17	25	0	0
5	41655134	.	G	A	4	9	13	0	1	14	0	0
5	41655155	.	T	A	6	8	14	0	0	14	0	0
5	41670193	.	G	A	6	2	8	0	0	8	0	0
5	41675669	.	T	C	3	4	7	0	0	7	0	0
5	41684870	.	A	G	1	2	3	0	0	3	0	0
5	41684885	.	A	T	1	3	4	0	1	5	0	0
5	41691606	.	A	G	3	5	8	0	0	8	0	0
5	41878612	.	A	C	8	11	19	0	0	19	0	0
5	41878660	.	A	G	13	13	26	0	0	26	0	0
5	41878711	.	C	T	1	16	17	0	9	26	0	0
5	41878965	.	G	C	5	4	9	0	2	11	0	0
5	41880240	.	T	C	12	0	12	0	9	21	0	0
5	41880243	.	T	C	13	0	13	0	10	23	0	0
5	41880280	.	C	G	12	10	22	0	1	23	0	0
5	41880288	.	G	A	12	9	21	0	0	21	0	0
5	41882364	.	T	C	2	3	5	0	2	7	0	0
5	41890054	.	G	A	3	4	7	0	1	8	0	0
5	41890092	.	A	G	1	3	4	0	0	4	0	0
5	41891324	.	T	C	1	0	1	0	3	4	0	0
5	41900012	.	A	C	2	3	5	0	0	5	0	0
5	41900020	.	A	G	2	3	5	0	0	5	0	0
5	42053399	.	T	C	1	3	4	0	0	4	0	0
5	42053465	.	G	C	3	2	5	0	1	6	0	0
5	42066958	.	C	T	16	8	24	5	0	29	0	0
5	42067486	.	T	C	15	10	25	12	3	40	0	0
5	42067588	.	G	A	12	6	18	22	4	44	0	0
5	42122907	.	C	T	13	11	24	0	0	24	0	0
5	42122914	.	C	T	7	12	19	0	2	21	0	0
5	42123023	.	C	T	22	15	37	0	0	37	0	0
5	42123125	.	C	T	20	19	39	0	4	43	0	0
5	42123375	.	C	A	11	4	15	0	1	16	0	0
5	42123664	.	A	G	9	7	16	0	0	16	0	0
5	42123697	.	G	C	8	8	16	0	0	16	0	0
5	42123766	.	G	T	8	5	13	0	0	13	0	0
5	44795146	.	A	G	3	11	14	0	0	14	0	0
5	45224048	.	C	T	2	2	4	0	0	4	0	0
5	45230659	.	C	A	2	4	6	0	0	6	0	0
5	45261926	.	C	T	2	15	17	0	0	17	0	0
5	45269380	.	A	G	14	4	18	0	1	19	0	0
5	45269386	.	A	G	13	4	17	0	2	19	0	0
5	45272009	.	A	G	13	0	13	0	7	20	0	0
5	45272056	.	C	T	11	11	22	0	1	23	0	0
5	45272068	.	G	A	9	11	20	0	0	20	0	0
5	45274486	.	C	T	6	15	21	0	1	22	0	0
5	45282910	.	G	A	5	8	13	0	0	13	0	0
5	45283046	.	G	T	3	5	8	0	1	9	0	0
5	45283074	.	G	A	0	5	5	0	2	7	0	0
5	45283117	.	A	C	3	4	7	0	0	7	0	0
5	45283165	.	C	T	1	4	5	0	0	5	0	0
5	45283274	.	T	C	5	9	14	0	0	14	0	0
5	45283284	.	T	C	4	10	14	0	0	14	0	0
5	45283365	.	G	A	9	8	17	0	1	18	0	0
5	45283645	.	C	T	7	7	14	0	0	14	0	0
5	45747118	.	G	T	7	5	12	0	0	12	0	0
5	45747455	.	C	T	14	14	28	0	0	28	0	0
5	45747475	.	C	T	3	9	12	0	10	22	0	0
5	45747647	.	A	G	15	9	24	0	0	24	0	0
5	45747845	.	C	A	2	2	4	0	0	4	0	0
5	45747924	.	A	T	2	5	7	0	0	7	0	0
5	45748172	.	T	A	1	2	3	0	1	4	0	0
5	45748339	.	T	G	6	9	15	0	1	16	0	0
5	45748528	.	T	C	6	3	9	0	1	10	0	0
5	45748726	.	A	C	7	0	7	0	7	14	0	0
5	45751207	.	G	A	3	2	5	0	0	5	0	0
5	45751208	.	C	T	0	3	3	0	2	5	0	0
5	45754818	.	C	T	2	7	9	0	0	9	0	0
5	45754851	.	A	G	2	12	14	0	1	15	0	0
5	45754899	.	G	A	2	10	12	0	0	12	0	0
5	45762709	.	A	G	0	2	2	0	1	3	0	0
5	45890036	.	A	T	7	9	16	0	2	18	0	0
5	45890086	.	A	T	12	11	23	0	1	24	0	0
5	45890087	.	A	T	13	10	23	0	1	24	0	0
5	45890159	.	A	G	2	4	6	0	0	6	0	0
5	45890195	.	A	G	5	9	14	0	0	14	0	0
5	45890219	.	A	T	6	10	16	0	1	17	0	0
5	45890625	.	C	T	14	4	18	0	0	18	0	0
5	45890908	.	C	T	0	11	11	0	9	20	0	0
5	45890915	.	C	T	11	9	20	0	2	22	0	0
5	45891074	.	A	G	6	6	12	0	0	12	0	0
5	45891090	.	A	G	7	9	16	0	0	16	0	0
5	45891147	.	T	A	7	9	16	0	1	17	0	0
5	45891226	.	T	A	6	7	13	0	0	13	0	0
5	45891327	.	G	T	9	5	14	0	1	15	0	0
5	45892671	.	C	A	2	8	10	0	0	10	0	0
5	45894720	.	T	C	4	2	6	0	0	6	0	0
5	45894737	.	T	C	4	2	6	0	0	6	0	0
5	45900422	.	T	G	1	3	4	0	0	4	0	0
5	45941013	.	A	C	1	3	4	0	0	4	0	0
5	46209051	.	G	T	6	5	11	0	1	12	0	0
5	46327798	.	G	T	7	6	13	0	2	15	0	0
5	46328476	.	T	C	3	0	3	0	6	9	0	0
5	46328611	.	C	T	5	5	10	0	3	13	0	0
5	46490769	.	T	G	1	2	3	0	0	3	0	0
5	46490783	.	T	G	1	3	4	0	0	4	0	0
5	46659285	.	T	G	18	21	39	0	4	43	0	0
5	46659401	.	A	G	22	20	42	0	1	43	0	0
5	46659666	.	T	A	31	13	44	0	0	44	0	0
5	46659707	.	C	A	31	23	54	0	3	57	0	0
5	46659861	.	G	A	13	17	30	0	6	36	0	0
5	46659950	.	C	T	22	9	31	0	3	34	0	0
5	46659985	.	A	G	15	30	45	0	1	46	0	0
5	46660068	.	C	T	10	16	26	0	1	27	0	0
5	46660116	.	C	T	16	9	25	0	0	25	0	0
5	46660120	.	A	G	9	12	21	0	3	24	0	0
5	46660162	.	C	G	15	9	24	0	5	29	0	0
5	46660672	.	G	A	15	16	31	1	1	33	0	0
5	46660940	.	G	A	14	13	27	2	0	29	0	0
5	46660941	.	A	T	13	13	26	1	1	28	0	0
5	46661073	.	G	A	9	8	17	0	0	17	0	0
5	46661168	.	T	A	4	3	7	0	0	7	0	0
5	46661213	.	A	G	5	6	11	0	0	11	0	0
5	46661240	.	A	G	7	5	12	0	0	12	0	0
5	46661423	.	T	C	15	0	15	0	16	31	0	0
5	46661519	.	C	T	7	10	17	0	0	17	0	0
5	46661678	.	T	A	4	3	7	0	0	7	0	0
5	46662271	.	A	G	3	5	8	0	0	8	0	0
5	46662316	.	A	G	3	5	8	0	0	8	0	0
5	46685872	.	A	G	1	3	4	0	0	4	0	0
5	46724893	.	G	T	4	5	9	1	1	11	0	0
5	47727760	.	C	T	1	14	15	0	17	32	0	0
5	47949989	.	A	G	1	0	1	0	3	4	0	0
5	47953562	.	G	A	1	4	5	0	0	5	0	0
5	47968970	.	C	T	6	9	15	0	0	15	0	0
5	47970622	.	A	G	2	5	7	0	0	7	0	0
5	47972770	.	T	C	5	0	5	0	3	8	0	0
5	47973386	.	T	G	1	3	4	0	0	4	0	0
5	47976728	.	C	G	3	3	6	0	0	6	0	0
5	47976747	.	C	A	5	5	10	0	1	11	0	0
5	47976827	.	A	G	5	3	8	0	1	9	0	0
5	48022757	.	T	C	1	2	3	0	0	3	0	0
5	48023209	.	C	T	3	2	5	0	0	5	0	0
5	48028228	.	A	G	3	2	5	0	1	6	0	0
5	48028338	.	C	A	5	4	9	0	0	9	0	0
5	48028406	.	A	C	7	13	20	0	2	22	0	0
5	48028435	.	G	T	6	11	17	0	2	19	0	0
5	48028508	.	T	C	6	5	11	0	0	11	0	0
5	48029494	.	A	C	6	0	6	0	0	9	3	0
5	48029510	.	C	A	2	6	8	0	0	8	0	0
5	48029633	.	C	A	5	3	8	0	0	8	0	0
5	48029667	.	G	A	4	4	8	0	0	8	0	0
5	48029720	.	T	G	6	6	12	0	0	12	0	0
5	48029732	.	C	T	1	7	8	0	6	14	0	0
5	48029793	.	C	T	5	3	8	0	0	8	0	0
5	48029805	.	A	C	4	1	5	0	1	6	0	0
5	48029828	.	A	T	3	3	6	0	0	6	0	0
5	48110331	.	G	A	8	11	19	0	2	21	0	0
5	48154436	.	G	A	17	21	38	1	0	39	0	0
5	48154456	.	T	A	17	24	41	1	1	43	0	0
5	48172446	.	C	A	0	4	4	0	6	10	0	0
5	48182088	.	A	G	11	2	13	0	0	13	0	0
5	48182265	.	A	G	3	3	6	0	1	7	0	0
5	48182550	.	A	T	3	5	8	0	0	8	0	0
5	48182725	.	T	C	4	5	9	0	4	13	0	0
5	48183577	.	C	T	0	4	4	0	4	8	0	0
5	48183579	.	A	G	4	3	7	0	1	8	0	0
5	48183628	.	T	C	5	0	5	0	3	8	0	0
5	48242610	.	G	A	1	2	3	0	0	3	0	0
5	48672641	.	A	G	3	2	5	0	1	6	0	0
5	48672740	.	G	A	9	7	16	0	0	16	0	0
5	48672970	.	G	A	1	5	6	0	0	6	0	0
5	48673501	.	A	G	8	6	14	0	1	15	0	0
5	48673639	.	C	A	1	2	3	0	2	5	0	0
5	48673720	.	A	G	3	3	6	0	0	6	0	0
5	48679428	.	A	T	4	4	8	0	0	8	0	0
5	48679482	.	A	T	3	5	8	0	0	8	0	0
5	48935981	.	C	T	7	2	9	0	0	9	0	0
5	48936032	.	C	T	5	3	8	0	0	8	0	0
5	48940038	.	C	T	2	4	6	0	0	6	0	0
5	48986109	.	G	A	8	16	24	0	1	25	0	0
5	48986405	.	T	A	13	15	28	1	0	29	0	0
5	48986410	.	G	T	13	14	27	1	1	29	0	0
5	48986565	.	A	G	6	23	29	0	1	30	0	0
5	48986626	.	A	T	14	18	32	0	1	33	0	0
5	48986939	.	C	T	22	9	31	2	1	34	0	0
5	48987007	.	A	T	19	11	30	0	2	32	0	0
5	48987199	.	C	T	10	12	22	0	3	25	0	0
5	48987356	.	G	T	9	11	20	0	0	20	0	0
5	48987920	.	T	C	8	9	17	0	4	21	0	0
5	48992401	.	T	C	6	0	6	0	4	10	0	0
5	48992972	.	C	T	0	2	2	0	2	4	0	0
5	48993345	.	T	C	2	7	9	0	0	9	0	0
5	48995613	.	A	G	5	4	9	0	1	10	0	0
5	48995637	.	A	T	8	4	12	0	0	12	0	0
5	48995860	.	A	G	1	4	5	0	0	5	0	0
5	48995884	.	G	A	6	7	13	0	0	13	0	0
5	48995945	.	G	A	3	3	6	0	0	6	0	0
5	49019451	.	G	A	3	7	10	1	1	12	0	0
5	49019456	.	G	A	2	8	10	1	0	11	0	0
5	49019528	.	T	C	5	2	7	0	0	7	0	0
5	49019744	.	A	T	2	3	5	1	0	6	0	0
5	49019746	.	C	A	2	3	5	1	0	6	0	0
5	49019821	.	T	A	2	2	4	0	0	4	0	0
5	49019880	.	G	T	1	1	2	0	1	3	0	0
5	49020200	.	T	A	1	4	5	0	0	5	0	0
5	49020221	.	G	C	2	0	2	0	4	6	0	0
5	49021535	.	G	T	1	3	4	0	1	5	0	0
5	49021567	.	T	C	2	2	4	0	0	4	0	0
5	49021573	.	A	G	2	2	4	0	0	4	0	0
5	49734545	.	G	A	8	8	16	0	0	16	0	0
5	49734581	.	C	T	9	5	14	0	0	14	0	0
5	49734682	.	C	A	10	10	20	0	2	22	0	0
5	49734889	.	C	T	5	4	9	0	0	9	0	0
5	49735022	.	G	T	4	2	6	0	0	6	0	0
5	49735135	.	C	A	1	3	4	0	0	4	0	0
5	49735169	.	A	T	3	4	7	0	0	7	0	0
5	49735942	.	T	G	4	6	10	0	0	10	0	0
5	49743020	.	A	T	2	4	6	0	0	6	0	0
5	49745130	.	T	A	1	2	3	0	0	3	0	0
5	49745292	.	T	C	4	2	6	0	1	7	0	0
5	49747271	.	G	T	0	8	8	0	11	19	0	0
5	49750796	.	A	C	12	11	23	0	1	24	0	0
5	49750834	.	A	C	8	10	18	0	5	23	0	0
5	49768324	.	G	T	2	5	7	0	0	7	0	0
5	49768341	.	T	C	2	3	5	0	0	5	0	0
5	49768429	.	A	T	4	6	10	0	0	10	0	0
5	49768885	.	T	C	5	3	8	0	0	8	0	0
5	49768977	.	A	G	5	4	9	0	0	9	0	0
5	49769217	.	A	G	2	3	5	0	0	5	0	0
5	49769277	.	G	T	3	2	5	0	0	5	0	0
5	49769665	.	T	A	6	2	8	0	0	8	0	0
5	49773649	.	C	T	3	6	9	0	0	9	0	0
5	49773772	.	G	A	1	2	3	0	5	8	0	0
5	49951020	.	C	A	0	3	3	0	2	5	0	0
5	50035831	.	G	A	1	3	4	0	0	4	0	0
5	50081865	.	T	A	1	3	4	0	0	4	0	0
5	50086611	.	A	T	2	2	4	0	0	4	0	0
5	50086657	.	C	T	1	2	3	0	0	3	0	0
5	50253750	.	G	A	1	2	3	0	0	3	0	0
5	50256327	.	T	G	1	2	3	0	0	3	0	0
5	50386605	.	A	T	1	2	3	0	0	3	0	0
5	50407324	.	T	C	4	2	6	0	0	6	0	0
5	50436015	.	C	G	9	3	12	0	1	13	0	0
5	50436038	.	C	A	1	6	7	0	0	7	0	0
5	50436069	.	C	T	4	4	8	0	0	8	0	0
5	50436354	.	G	A	6	2	8	0	0	8	0	0
5	50436359	.	G	T	2	4	6	0	0	6	0	0
5	50443077	.	T	C	14	20	34	0	5	39	0	0
5	50443184	.	A	G	8	20	28	0	3	31	0	0
5	50443211	.	C	A	19	9	28	0	0	28	0	0
5	50443399	.	G	C	21	13	34	0	1	35	0	0
5	50443418	.	T	A	20	21	41	0	1	42	0	0
5	50443466	.	A	G	12	17	29	0	2	31	0	0
5	50520009	.	G	A	4	2	6	0	0	6	0	0
5	50543929	.	C	T	1	4	5	0	0	5	0	0
5	50544281	.	T	C	2	3	5	0	0	5	0	0
5	50576705	.	A	G	2	1	3	0	1	4	0	0
5	50582271	.	G	A	1	1	2	0	1	3	0	0
5	50582482	.	T	G	2	4	6	0	0	6	0	0
5	50817403	.	C	T	2	2	4	0	2	6	0	0
5	50817414	.	C	T	2	5	7	0	0	7	0	0
5	50819775	.	C	T	5	8	13	0	0	13	0	0
5	50819811	.	G	A	5	5	10	0	0	10	0	0
5	50821027	.	G	A	5	2	7	0	0	7	0	0
5	50821075	.	A	T	1	4	5	0	0	5	0	0
5	50843442	.	G	A	1	2	3	0	0	3	0	0
5	50886405	.	G	A	3	2	5	0	1	6	0	0
5	50893082	.	A	G	3	0	3	0	5	8	0	0
5	50893654	.	C	T	5	3	8	0	0	8	0	0
5	50895544	.	C	T	5	2	7	0	0	7	0	0
5	50895606	.	C	T	3	3	6	0	0	6	0	0
5	50896056	.	C	T	11	3	14	0	0	14	0	0
5	50897509	.	C	T	4	4	8	0	0	8	0	0
5	50897528	.	C	A	0	2	2	0	1	3	0	0
5	50963250	.	C	G	1	2	3	0	0	3	0	0
5	50973014	.	C	T	7	1	8	0	1	9	0	0
5	50973039	.	C	T	11	4	15	0	2	17	0	0
5	50973357	.	T	A	2	5	7	0	2	9	0	0
5	50973471	.	C	G	2	3	5	0	0	5	0	0
5	50973518	.	A	C	9	7	16	0	0	16	0	0
5	50973625	.	A	T	4	4	8	0	1	9	0	0
5	50973748	.	C	T	2	3	5	0	0	5	0	0
5	50980806	.	T	C	1	3	4	0	1	5	0	0
5	50981123	.	C	T	0	3	3	0	1	4	0	0
5	51102602	.	T	G	1	3	4	0	0	4	0	0
5	51102641	.	T	C	2	4	6	0	0	6	0	0
5	51103411	.	G	A	2	2	4	0	0	4	0	0
5	51103904	.	A	T	2	2	4	0	0	4	0	0
5	51103944	.	A	T	3	4	7	0	0	7	0	0
5	51104010	.	G	A	3	3	6	0	0	6	0	0
5	51104031	.	G	A	0	4	4	0	3	7	0	0
5	51104050	.	T	G	1	4	5	0	0	5	0	0
5	51121295	.	G	A	2	3	5	0	0	5	0	0
5	51125695	.	C	A	3	2	5	0	0	5	0	0
5	51126885	.	A	T	3	2	5	0	0	5	0	0
5	51127305	.	A	T	5	5	10	0	0	10	0	0
5	51127335	.	C	T	3	4	7	1	0	8	0	0
5	51127348	.	C	T	4	4	8	1	0	9	0	0
5	51127396	.	C	G	5	8	13	1	2	16	0	0
5	51127467	.	C	A	3	7	10	0	0	10	0	0
5	51127718	.	T	A	4	5	9	0	4	13	0	0
5	51133499	.	T	C	1	2	3	0	1	4	0	0
5	51169022	.	G	T	4	6	10	0	0	10	0	0
5	51169069	.	T	A	2	3	5	0	0	5	0	0
5	51169077	.	C	T	3	2	5	0	0	5	0	0
5	51169127	.	C	T	2	2	4	0	0	4	0	0
5	51169354	.	A	T	10	4	14	0	0	14	0	0
5	51169376	.	T	C	14	0	14	0	3	17	0	0
5	51169732	.	G	A	4	4	8	0	0	8	0	0
5	51169749	.	C	T	3	6	9	0	0	9	0	0
5	51169858	.	T	C	2	2	4	0	0	4	0	0
5	51169859	.	T	A	2	2	4	0	0	4	0	0
5	51170048	.	C	T	3	3	6	0	1	7	0	0
5	51170171	.	T	C	2	4	6	0	2	8	0	0
5	51170375	.	C	T	4	2	6	0	0	6	0	0
5	51170577	.	G	A	1	2	3	0	0	3	0	0
5	51170595	.	A	G	2	2	4	0	0	4	0	0
5	51170694	.	G	A	1	4	5	0	0	5	0	0
5	51171189	.	G	A	3	2	5	0	0	5	0	0
5	51171202	.	T	A	3	2	5	0	0	5	0	0
5	51200506	.	A	G	2	5	7	0	0	7	0	0
5	51200697	.	G	A	5	4	9	0	1	10	0	0
5	51202374	.	T	A	3	6	9	0	1	10	0	0
5	51202938	.	G	A	7	3	10	0	1	11	0	0
5	51203146	.	C	T	11	3	14	0	0	14	0	0
5	51205473	.	T	A	3	2	5	0	0	5	0	0
5	51205593	.	G	A	4	3	7	0	0	7	0	0
5	51232024	.	G	A	2	2	4	0	0	4	0	0
5	51241023	.	A	G	4	4	8	0	0	8	0	0
5	51241046	.	T	C	4	5	9	0	1	10	0	0
5	51241095	.	C	T	3	4	7	0	1	8	0	0
5	51242049	.	A	C	1	3	4	0	0	4	0	0
5	51242489	.	A	G	5	0	5	0	4	9	0	0
5	51242882	.	A	G	6	6	12	0	1	13	0	0
5	51243106	.	A	G	9	8	17	0	3	20	0	0
5	51243287	.	G	A	5	4	9	0	1	10	0	0
5	51243341	.	G	A	4	6	10	0	0	10	0	0
5	51439900	.	G	C	1	2	3	0	0	3	0	0
5	51439950	.	C	T	2	4	6	0	0	6	0	0
5	51439958	.	G	T	2	4	6	0	0	6	0	0
5	51616478	.	T	A	4	2	6	0	1	7	0	0
5	51617022	.	T	C	3	7	10	0	0	10	0	0
5	51746920	.	C	T	0	2	2	0	1	3	0	0
5	51775052	.	A	G	3	8	11	0	1	12	0	0
5	51775291	.	A	T	14	16	30	0	0	30	0	0
5	51775391	.	A	G	23	14	37	0	1	38	0	0
5	51775458	.	A	C	27	14	41	0	1	42	0	0
5	51775501	.	T	G	20	19	39	0	2	41	0	0
5	51775805	.	A	G	6	21	27	0	0	27	0	0
5	51775837	.	G	C	11	16	27	0	0	27	0	0
5	51775962	.	G	T	10	17	27	0	1	28	0	0
5	51775997	.	A	T	19	9	28	0	1	29	0	0
5	51776150	.	C	A	8	13	21	0	0	21	0	0
5	51779513	.	C	T	19	6	25	0	0	25	0	0
5	51789180	.	C	T	0	5	5	0	7	12	0	0
5	51789264	.	T	G	7	4	11	0	1	12	0	0
5	51789646	.	T	C	3	0	3	0	4	7	0	0
5	51840420	.	C	T	6	2	8	0	0	8	0	0
5	51846285	.	C	A	3	8	11	0	0	11	0	0
5	51847274	.	T	C	5	8	13	0	0	13	0	0
5	51847429	.	T	C	7	3	10	0	0	10	0	0
5	51847675	.	C	G	3	3	6	0	1	7	0	0
5	51894040	.	T	C	4	4	8	0	0	8	0	0
5	51935050	.	T	C	2	2	4	0	0	4	0	0
5	51935065	.	C	T	2	2	4	0	0	4	0	0
5	51938801	.	C	T	3	2	5	0	0	5	0	0
5	51947497	.	C	T	20	7	27	0	2	29	0	0
5	51947551	.	T	C	10	11	21	0	0	21	0	0
5	51947650	.	T	C	13	4	17	0	0	17	0	0
5	51947696	.	A	T	16	11	27	0	0	27	0	0
5	51947770	.	T	G	9	8	17	0	0	17	0	0
5	51947976	.	C	G	2	3	5	0	0	5	0	0
5	51948017	.	G	T	4	2	6	0	0	6	0	0
5	51948389	.	A	T	4	3	7	0	0	7	0	0
5	51948708	.	A	T	6	4	10	0	2	12	0	0
5	51948737	.	C	T	1	7	8	0	7	15	0	0
5	51948755	.	C	A	7	5	12	0	1	13	0	0
5	51948919	.	G	A	7	9	16	0	1	17	0	0
5	51948946	.	T	C	10	0	10	0	8	18	0	0
5	51949069	.	T	A	6	6	12	0	0	12	0	0
5	51949071	.	T	A	5	6	11	0	0	11	0	0
5	51949896	.	G	A	3	3	6	0	0	6	0	0
5	51950032	.	G	C	4	6	10	0	2	12	0	0
5	52002660	.	T	G	7	10	17	2	1	20	0	0
5	52002708	.	T	C	6	7	13	0	4	17	0	0
5	52002743	.	T	G	2	7	9	0	4	13	0	0
5	52132561	.	C	T	3	2	5	0	1	6	0	0
5	52190969	.	A	G	2	4	6	0	1	7	0	0
5	52191039	.	C	T	0	4	4	0	1	5	0	0
5	52191185	.	G	T	1	4	5	0	1	6	0	0
5	52191263	.	T	C	5	5	10	0	2	12	0	0
5	52191288	.	C	A	10	7	17	0	0	17	0	0
5	52191499	.	G	A	3	3	6	0	0	6	0	0
5	52191758	.	C	T	3	2	5	0	1	6	0	0
5	52191987	.	A	G	7	5	12	0	0	12	0	0
5	52192032	.	T	G	4	3	7	0	0	7	0	0
5	52192470	.	G	T	2	4	6	0	0	6	0	0
5	52192494	.	A	T	1	3	4	0	0	4	0	0
5	52192557	.	C	T	1	2	3	0	1	4	0	0
5	52192572	.	T	C	2	1	3	0	2	5	0	0
5	52193066	.	C	T	1	2	3	0	0	3	0	0
5	52193240	.	A	T	1	3	4	0	0	4	0	0
5	52197793	.	C	T	2	3	5	0	0	5	0	0
5	52198066	.	G	A	2	2	4	0	0	4	0	0
5	52227660	.	T	A	2	6	8	0	0	8	0	0
5	52234708	.	A	G	1	3	4	0	1	5	0	0
5	52235027	.	T	A	2	4	6	0	0	6	0	0
5	52257106	.	A	C	6	0	6	4	15	25	0	0
5	52257299	.	G	A	8	12	20	0	1	21	0	0
5	52257463	.	T	C	10	15	25	0	3	28	0	0
5	52257530	.	A	G	15	13	28	0	1	29	0	0
5	52257976	.	G	T	18	6	24	1	0	25	0	0
5	52258036	.	G	A	11	8	19	0	0	19	0	0
5	52258182	.	G	A	2	13	15	0	0	15	0	0
5	52258234	.	G	A	4	7	11	0	1	12	0	0
5	52258464	.	T	C	2	0	2	0	13	15	0	0
5	52258653	.	C	G	2	2	4	0	1	5	0	0
5	52258701	.	A	T	3	4	7	0	0	7	0	0
5	52258703	.	G	A	3	4	7	0	0	7	0	0
5	52258921	.	T	G	4	9	13	0	0	13	0	0
5	52259221	.	T	A	5	2	7	0	0	7	0	0
5	52259289	.	A	G	6	3	9	0	1	10	0	0
5	52259887	.	G	A	2	3	5	0	0	5	0	0
5	52264354	.	C	T	0	4	4	0	2	6	0	0
5	52264456	.	C	G	0	3	3	0	1	4	0	0
5	52264549	.	C	T	1	2	3	0	0	3	0	0
5	52264654	.	C	G	0	2	2	0	1	3	0	0
5	52621801	.	C	G	2	0	2	0	2	4	0	0
5	52710951	.	A	G	2	2	4	0	0	4	0	0
5	52710957	.	G	A	2	2	4	0	0	4	0	0
5	52731647	.	G	A	0	8	8	0	4	12	0	0
5	52731664	.	C	T	6	9	15	0	0	15	0	0
5	52731711	.	A	T	6	4	10	0	0	10	0	0
5	52731787	.	G	A	4	5	9	0	0	9	0	0
5	52731845	.	T	C	6	7	13	0	0	13	0	0
5	52732818	.	G	T	2	14	16	0	1	17	0	0
5	52732931	.	C	T	8	10	18	0	0	18	0	0
5	52733022	.	G	T	9	8	17	0	0	17	0	0
5	52733201	.	C	T	7	14	21	0	1	22	0	0
5	52733230	.	G	A	18	10	28	0	2	30	0	0
5	52733259	.	T	G	17	18	35	0	2	37	0	0
5	52733266	.	T	G	17	19	36	0	0	36	0	0
5	52733370	.	A	T	16	13	29	0	3	32	0	0
5	52733411	.	G	A	14	8	22	0	2	24	0	0
5	52745571	.	T	G	1	7	8	0	0	8	0	0
5	52745637	.	T	C	3	4	7	0	1	8	0	0
5	52748724	.	T	C	3	5	8	0	0	8	0	0
5	52761212	.	A	T	4	5	9	0	0	9	0	0
5	52783758	.	C	T	3	2	5	0	0	5	0	0
5	52859912	.	G	A	4	7	11	0	1	12	0	0
5	52860863	.	G	T	6	5	11	0	1	12	0	0
5	52861185	.	A	T	2	2	4	0	1	5	0	0
5	52861213	.	T	C	3	5	8	0	2	10	0	0
5	52861334	.	T	A	3	15	18	0	0	18	0	0
5	52861396	.	C	G	7	0	7	0	6	13	0	0
5	52861410	.	A	T	7	6	13	0	0	13	0	0
5	52937785	.	G	T	2	2	4	0	0	4	0	0
5	52937849	.	A	T	6	2	8	0	0	8	0	0
5	52937901	.	C	A	2	6	8	0	2	10	0	0
5	52937956	.	A	T	9	7	16	0	0	16	0	0
5	52938498	.	C	T	1	2	3	0	0	3	0	0
5	52971471	.	T	A	1	3	4	0	0	4	0	0
5	52971478	.	C	T	2	3	5	0	0	5	0	0
5	52972260	.	A	G	5	7	12	0	0	12	0	0
5	52972323	.	C	A	7	4	11	0	0	11	0	0
5	52988108	.	C	T	2	4	6	0	2	8	0	0
5	52988147	.	C	T	5	4	9	0	1	10	0	0
5	53003455	.	A	C	5	0	5	0	8	13	0	0
5	53003463	.	C	G	0	4	4	0	8	12	0	0
5	53003640	.	C	G	3	3	6	0	0	6	0	0
5	53003896	.	G	A	3	4	7	0	0	7	0	0
5	53748244	.	C	T	3	3	6	0	0	6	0	0
5	53761461	.	C	T	13	10	23	0	0	23	0	0
5	53761541	.	A	T	11	8	19	0	0	19	0	0
5	53825047	.	G	A	2	4	6	0	0	6	0	0
5	53825054	.	T	A	1	3	4	0	1	5	0	0
5	53829592	.	A	G	2	4	6	0	2	8	0	0
5	53865040	.	A	C	4	4	8	0	2	10	0	0
5	53865402	.	A	C	2	2	4	0	0	4	0	0
5	53899573	.	T	C	7	6	13	0	0	13	0	0
5	53908333	.	C	T	6	9	15	0	1	16	0	0
5	53908892	.	A	G	3	2	5	0	0	5	0	0
5	53908893	.	G	A	3	2	5	0	0	5	0	0
5	53909000	.	G	C	4	7	11	0	2	13	0	0
5	53909031	.	T	A	4	7	11	0	1	12	0	0
5	53909509	.	G	A	0	4	4	0	1	5	0	0
5	53909538	.	T	G	1	5	6	0	0	6	0	0
5	53909659	.	T	C	4	5	9	0	0	9	0	0
5	53910324	.	C	T	1	4	5	0	0	5	0	0
5	53913085	.	A	G	1	3	4	0	0	4	0	0
5	53913496	.	G	A	0	5	5	0	3	8	0	0
5	54280460	.	T	G	1	2	3	0	0	3	0	0
5	54280495	.	T	G	3	3	6	0	0	6	0	0
5	54280672	.	C	T	5	4	9	0	0	9	0	0
5	54280801	.	G	A	3	4	7	0	0	7	0	0
5	54297461	.	T	G	2	3	5	0	0	5	0	0
5	54297655	.	G	A	7	3	10	0	0	10	0	0
5	54297668	.	C	T	3	7	10	0	1	11	0	0
5	54304666	.	C	G	2	5	7	0	0	7	0	0
5	54304731	.	T	A	6	4	10	0	0	10	0	0
5	54304736	.	G	T	5	4	9	0	0	9	0	0
5	54305209	.	G	A	6	10	16	0	0	16	0	0
5	54309365	.	C	T	6	3	9	0	0	9	0	0
5	54337079	.	T	C	6	0	6	0	3	9	0	0
5	54337296	.	A	C	5	0	5	0	4	9	0	0
5	54337485	.	A	G	3	8	11	0	1	12	0	0
5	54337517	.	A	T	9	7	16	0	0	16	0	0
5	54337524	.	G	T	6	6	12	0	4	16	0	0
5	54337831	.	T	A	5	9	14	0	1	15	0	0
5	54337880	.	T	C	8	0	8	0	8	16	0	0
5	54337934	.	C	A	4	5	9	0	2	11	0	0
5	54338040	.	C	A	6	2	8	0	0	8	0	0
5	54339734	.	A	G	1	2	3	0	0	3	0	0
5	54457983	.	G	A	8	10	18	0	1	19	0	0
5	54458053	.	A	C	6	5	11	0	0	11	0	0
5	54458125	.	T	C	3	6	9	0	3	12	0	0
5	54458127	.	A	G	6	7	13	0	0	13	0	0
5	54458326	.	G	A	15	14	29	0	1	30	0	0
5	54458345	.	T	A	17	11	28	0	0	28	0	0
5	54458668	.	C	A	10	8	18	0	2	20	0	0
5	54458774	.	A	C	7	0	7	0	13	20	0	0
5	54458791	.	C	G	0	6	6	0	12	18	0	0
5	54458899	.	C	A	4	9	13	0	1	14	0	0
5	54459073	.	T	G	4	3	7	0	1	8	0	0
5	54459086	.	G	T	3	2	5	0	2	7	0	0
5	54459454	.	C	T	2	3	5	0	0	5	0	0
5	54459682	.	C	T	3	2	5	0	0	5	0	0
5	54459740	.	T	C	2	2	4	0	0	4	0	0
5	54460218	.	A	C	1	5	6	0	0	6	0	0
5	54460237	.	T	A	2	6	8	0	0	8	0	0
5	54460259	.	G	A	6	2	8	0	0	8	0	0
5	54460274	.	T	A	7	3	10	0	0	10	0	0
5	54460322	.	T	A	7	4	11	0	0	11	0	0
5	54460371	.	T	A	6	2	8	0	0	8	0	0
5	54460555	.	G	A	4	3	7	0	2	9	0	0
5	54460558	.	A	T	4	2	6	0	4	10	0	0
5	54465149	.	T	C	3	0	3	0	6	9	0	0
5	54468506	.	G	A	1	5	6	0	0	6	0	0
5	54470845	.	C	G	1	2	3	0	2	5	0	0
5	54470912	.	C	G	1	3	4	2	0	6	0	0
5	54482550	.	G	A	2	2	4	0	0	4	0	0
5	54482561	.	A	C	2	2	4	0	0	4	0	0
5	54482806	.	C	T	3	2	5	0	0	5	0	0
5	54482927	.	T	C	5	2	7	0	0	7	0	0
5	54483295	.	G	A	1	2	3	0	0	3	0	0
5	54498363	.	C	T	6	6	12	0	1	13	0	0
5	54498375	.	T	G	7	6	13	0	1	14	0	0
5	54498452	.	C	T	5	3	8	0	1	9	0	0
5	54502414	.	G	C	2	3	5	0	0	5	0	0
5	54565223	.	T	G	4	0	4	0	6	10	0	0
5	54576142	.	C	T	4	3	7	0	1	8	0	0
5	54576223	.	C	T	5	6	11	0	1	12	0	0
5	54576238	.	G	A	4	7	11	0	0	11	0	0
5	54576562	.	G	T	1	3	4	0	10	14	0	0
5	54580125	.	G	A	6	8	14	0	0	14	0	0
5	54633277	.	C	T	3	2	5	0	0	5	0	0
5	54633313	.	C	T	3	4	7	0	0	7	0	0
5	54643746	.	T	A	5	11	16	0	0	16	0	0
5	54652941	.	T	A	5	8	13	0	0	13	0	0
5	54652947	.	C	A	6	4	10	0	1	11	0	0
5	54656583	.	A	G	8	0	8	0	5	13	0	0
5	54656613	.	T	C	6	10	16	0	0	16	0	0
5	54685371	.	A	T	4	1	5	0	1	6	0	0
5	54716828	.	T	C	9	0	9	0	6	15	0	0
5	54719503	.	A	G	3	4	7	0	2	9	0	0
5	54719844	.	G	A	5	16	21	0	0	21	0	0
5	54724444	.	A	T	2	2	4	0	0	4	0	0
5	54767734	.	T	A	13	11	24	0	1	25	0	0
5	54769091	.	A	G	10	7	17	0	0	17	0	0
5	54769133	.	A	G	9	4	13	2	0	15	0	0
5	54769896	.	A	G	11	8	19	0	1	20	0	0
5	54769914	.	C	T	13	10	23	0	2	25	0	0
5	54770121	.	T	C	9	4	13	0	0	13	0	0
5	54770370	.	G	A	8	15	23	0	0	23	0	0
5	54770889	.	C	T	6	9	15	0	0	15	0	0
5	54773250	.	A	G	3	2	5	0	0	5	0	0
5	54945035	.	T	G	9	10	19	0	0	19	0	0
5	54945048	.	A	G	8	10	18	0	0	18	0	0
5	55160470	.	A	G	2	4	6	0	0	6	0	0
5	55160572	.	G	A	8	7	15	0	0	15	0	0
5	55168177	.	G	T	6	10	16	1	1	18	0	0
5	55168436	.	T	A	15	11	26	0	0	26	0	0
5	55171359	.	G	A	5	7	12	0	0	12	0	0
5	55371356	.	C	T	8	5	13	0	1	14	0	0
5	55372218	.	A	G	11	12	23	0	2	25	0	0
5	55372425	.	A	C	19	15	34	0	0	34	0	0
5	55372773	.	A	T	5	6	11	0	0	11	0	0
5	55373299	.	G	A	9	10	19	0	2	21	0	0
5	55588449	.	G	A	8	3	11	0	0	11	0	0
5	55588458	.	T	C	8	2	10	0	0	10	0	0
5	55588562	.	T	C	3	4	7	0	0	7	0	0
5	55592805	.	A	G	1	2	3	0	0	3	0	0
5	55593011	.	G	T	3	3	6	0	0	6	0	0
5	55596851	.	C	G	0	2	2	0	5	7	0	0
5	55598383	.	T	C	2	6	8	0	0	8	0	0
5	55600108	.	A	C	1	2	3	0	1	4	0	0
5	55604037	.	G	C	16	13	29	0	1	30	0	0
5	55604162	.	G	C	26	10	36	0	1	37	0	0
5	55604211	.	A	T	31	8	39	1	1	41	0	0
5	55604228	.	G	T	24	12	36	1	2	39	0	0
5	55604438	.	A	G	19	20	39	1	3	43	0	0
5	55609426	.	T	G	22	16	38	0	1	39	0	0
5	55613789	.	G	A	10	9	19	0	0	19	0	0
5	55613813	.	A	C	14	7	21	0	2	23	0	0
5	55613864	.	A	G	15	9	24	0	0	24	0	0
5	55613999	.	G	A	8	9	17	0	0	17	0	0
5	55720486	.	C	T	1	7	8	0	10	19	1	0
5	55763283	.	C	T	4	2	6	0	0	6	0	0
5	55763752	.	G	T	24	23	47	0	4	51	0	0
5	55764509	.	G	A	26	20	46	0	0	46	0	0
5	55773856	.	A	G	13	13	26	0	0	26	0	0
5	55801489	.	G	A	16	6	22	0	1	23	0	0
5	55848084	.	C	T	7	10	17	0	0	17	0	0
5	55866925	.	C	T	0	3	3	0	3	6	0	0
5	55873688	.	G	T	1	5	6	0	0	6	0	0
5	55876508	.	C	G	3	7	10	0	0	10	0	0
5	55920943	.	A	T	4	5	9	0	0	9	0	0
5	55921076	.	A	T	9	11	20	0	2	22	0	0
5	55921335	.	G	A	18	21	39	0	1	40	0	0
5	55928142	.	G	A	2	4	6	0	0	6	0	0
5	55929926	.	G	A	1	2	3	0	0	3	0	0
5	56100260	.	T	A	6	3	9	1	1	11	0	0
5	56122807	.	C	T	2	3	5	0	0	5	0	0
5	56280184	.	T	G	1	2	3	0	0	3	0	0
5	56280498	.	C	T	1	2	3	0	0	3	0	0
5	56289884	.	A	G	3	4	7	0	1	8	0	0
5	56289904	.	T	C	4	4	8	0	0	8	0	0
5	56289925	.	G	A	0	3	3	0	3	6	0	0
5	56294045	.	C	T	3	2	5	0	0	5	0	0
5	56294160	.	T	C	2	3	5	0	0	5	0	0
5	56294202	.	C	T	1	2	3	0	0	3	0	0
5	56305525	.	C	T	6	2	8	0	0	8	0	0
5	56305526	.	T	C	6	2	8	0	0	8	0	0
5	56308698	.	T	C	5	1	6	0	8	14	0	0
5	56308816	.	C	T	3	11	14	0	22	36	0	0
5	56309013	.	G	C	19	7	26	1	0	27	0	0
5	56309109	.	C	T	0	19	19	1	19	39	0	0
5	56309115	.	A	T	19	19	38	1	0	39	0	0
5	56309445	.	C	T	7	22	29	0	1	30	0	0
5	56309454	.	A	G	20	8	28	0	1	29	0	0
5	56309506	.	G	A	9	14	23	0	0	23	0	0
5	56309517	.	T	C	9	8	17	0	2	19	0	0
5	56309672	.	C	A	0	7	7	0	20	27	0	0
5	56309677	.	C	A	20	9	29	0	1	30	0	0
5	56313207	.	G	A	20	14	34	0	0	34	0	0
5	56313246	.	C	T	13	16	29	0	5	34	0	0
5	56317153	.	T	A	17	14	31	0	1	32	0	0
5	56317170	.	C	T	16	15	31	0	1	32	0	0
5	56317377	.	G	A	19	11	30	0	1	31	0	0
5	56317470	.	C	T	10	15	25	0	1	26	0	0
5	56317473	.	T	G	10	13	23	0	2	25	0	0
5	56322205	.	C	T	9	8	17	0	3	20	0	0
5	56322404	.	A	G	7	5	12	0	1	13	0	0
5	56322680	.	A	G	9	7	16	0	1	17	0	0
5	56343032	.	C	T	2	3	5	0	4	9	0	0
5	56343053	.	G	A	2	5	7	0	0	7	0	0
5	56343095	.	C	T	3	4	7	0	0	7	0	0
5	56345036	.	G	C	3	2	5	0	0	5	0	0
5	56345109	.	A	G	2	3	5	0	0	5	0	0
5	56355129	.	C	T	1	3	4	0	0	4	0	0
5	56355296	.	C	A	1	1	2	0	1	3	0	0
5	56364946	.	G	A	2	2	4	0	1	5	0	0
5	56375262	.	G	T	1	2	3	0	0	3	0	0
5	56915023	.	G	A	4	3	7	0	0	7	0	0
5	56915190	.	C	T	12	3	15	0	7	22	0	0
5	56915250	.	T	A	2	5	7	0	9	16	0	0
5	56915422	.	G	A	4	8	12	0	1	13	0	0
5	56915457	.	T	C	4	0	4	0	11	15	0	0
5	56918932	.	G	A	5	5	10	0	1	11	0	0
5	56918974	.	A	G	4	5	9	0	0	9	0	0
5	56927772	.	C	T	6	3	9	0	0	9	0	0
5	56927784	.	G	A	5	4	9	0	0	9	0	0
5	56934960	.	A	G	3	2	5	0	0	5	0	0
5	56951034	.	G	A	10	18	28	0	1	29	0	0
5	56951156	.	C	T	14	13	27	1	1	29	0	0
5	56951229	.	C	T	14	17	31	0	2	33	0	0
5	56951258	.	A	C	11	10	21	0	1	22	0	0
5	56951686	.	G	A	5	9	14	1	0	15	0	0
5	56951713	.	T	C	11	3	14	0	0	14	0	0
5	56951769	.	A	G	6	10	16	0	3	19	0	0
5	56951830	.	T	A	11	3	14	0	3	17	0	0
5	56952295	.	G	A	21	16	37	0	1	38	0	0
5	56952316	.	A	G	21	12	33	0	1	34	0	0
5	56956359	.	G	A	8	9	17	0	0	17	0	0
5	56961194	.	A	G	1	2	3	0	0	3	0	0
5	56962827	.	T	C	1	0	1	0	7	8	0	0
5	56964475	.	G	A	1	5	6	0	0	6	0	0
5	57210284	.	G	A	1	3	4	0	1	5	0	0
5	57210293	.	T	C	2	4	6	0	0	6	0	0
5	57217249	.	G	A	0	6	6	0	1	7	0	0
5	57217343	.	T	G	1	4	5	0	0	5	0	0
5	57219496	.	G	A	3	2	5	0	0	5	0	0
5	57219938	.	G	C	0	3	3	0	3	6	0	0
5	57220033	.	T	C	3	4	7	0	0	7	0	0
5	57220108	.	G	A	1	5	6	0	2	8	0	0
5	57220190	.	A	G	4	0	4	0	4	8	0	0
5	57220324	.	T	C	6	4	10	0	0	10	0	0
5	57225496	.	C	G	4	0	4	0	6	10	0	0
5	57234053	.	A	C	9	3	12	0	0	12	0	0
5	57234074	.	C	T	4	1	5	0	0	5	0	0
5	57320235	.	C	T	20	26	46	0	2	48	0	0
5	57320274	.	G	A	26	30	56	0	1	57	0	0
5	57324956	.	A	C	34	21	55	0	1	56	0	0
5	57325158	.	T	G	36	26	62	0	4	66	0	0
5	57325204	.	T	G	35	2	37	0	32	69	0	0
5	57325210	.	G	A	34	32	66	0	2	68	0	0
5	57325359	.	G	A	33	23	56	0	5	62	1	0
5	57325537	.	C	T	7	11	18	0	0	18	0	0
5	57340438	.	A	G	1	0	1	0	5	6	0	0
5	57353492	.	G	A	0	2	2	0	5	7	0	0
5	57353959	.	C	A	4	10	14	0	0	14	0	0
5	57353981	.	C	T	6	11	17	0	0	17	0	0
5	57354046	.	G	A	6	3	9	0	1	10	0	0
5	57354166	.	T	C	5	8	13	0	1	14	0	0
5	57354552	.	C	T	4	3	7	0	2	9	0	0
5	57354596	.	C	T	5	6	11	0	1	12	0	0
5	57354656	.	A	G	7	8	15	0	0	15	0	0
5	57354680	.	G	A	0	14	14	0	6	20	0	0
5	57354719	.	T	G	8	18	26	0	0	26	0	0
5	57354786	.	G	T	8	9	17	0	2	19	0	0
5	57354839	.	A	G	3	0	3	0	4	7	0	0
5	57359740	.	G	A	8	14	22	0	0	22	0	0
5	57359811	.	A	G	9	13	22	0	1	23	0	0
5	57361541	.	T	C	2	12	14	0	0	14	0	0
5	57446925	.	G	A	1	2	3	0	0	3	0	0
5	57447301	.	C	T	2	2	4	0	0	4	0	0
5	57450440	.	C	A	4	3	7	0	1	8	0	0
5	57450973	.	A	G	2	0	2	0	6	8	0	0
5	57453587	.	T	C	3	9	12	0	0	12	0	0
5	57453635	.	T	C	1	5	6	0	0	6	0	0
5	57489777	.	T	C	18	1	19	0	8	27	0	0
5	57490081	.	C	A	8	5	13	0	0	13	0	0
5	57490099	.	G	A	7	5	12	0	1	13	0	0
5	57490153	.	T	C	7	10	17	0	1	18	0	0
5	57500086	.	T	C	8	11	19	0	1	20	0	0
5	57506568	.	A	C	6	4	10	0	1	11	0	0
5	57506622	.	A	G	7	3	10	0	0	10	0	0
5	57514332	.	G	A	8	7	15	0	0	15	0	0
5	57514428	.	G	A	3	14	17	0	0	17	0	0
5	57641751	.	C	T	1	2	3	0	1	4	0	0
5	57644184	.	T	G	3	6	9	0	0	9	0	0
5	57644256	.	G	A	1	6	7	0	1	8	0	0
5	57644388	.	G	T	1	4	5	0	1	6	0	0
5	57699936	.	C	T	2	2	4	0	0	4	0	0
5	57704805	.	T	C	1	0	1	0	3	4	0	0
5	57715904	.	T	C	7	8	15	0	0	15	0	0
5	57716169	.	T	C	10	8	18	0	0	18	0	0
5	57718488	.	A	C	14	7	21	0	0	22	1	0
5	57718554	.	T	G	8	5	13	0	1	14	0	0
5	57718558	.	G	T	8	3	11	0	1	12	0	0
5	57718649	.	A	G	19	0	19	0	0	20	1	0
5	57718659	.	C	T	10	14	24	0	1	25	0	0
5	57718716	.	T	C	6	14	20	0	0	20	0	0
5	57726573	.	T	A	4	1	5	0	1	6	0	0
5	57735420	.	A	G	5	2	7	0	1	8	0	0
5	57737337	.	A	G	3	2	5	0	1	6	0	0
5	57737389	.	C	T	5	3	8	0	0	8	0	0
5	57737395	.	T	C	7	3	10	0	1	11	0	0
5	57737637	.	A	G	3	0	3	0	4	7	0	0
5	57737704	.	C	T	1	5	6	0	1	7	0	0
5	57737727	.	A	T	3	4	7	0	0	7	0	0
5	57737862	.	T	A	6	5	11	0	0	11	0	0
5	57737863	.	A	C	6	4	10	0	1	11	0	0
5	57738078	.	C	T	4	5	9	0	0	9	0	0
5	57738233	.	C	T	6	5	11	0	0	11	0	0
5	57738321	.	G	A	1	4	5	0	0	5	0	0
5	57751676	.	T	A	1	2	3	0	1	4	0	0
5	57753827	.	A	G	1	0	1	0	6	7	0	0
5	57755422	.	T	C	2	6	8	0	0	8	0	0
5	57755844	.	C	T	3	16	19	0	1	20	0	0
5	57762423	.	A	T	9	18	27	1	3	31	0	0
5	57762468	.	G	T	16	21	37	0	1	38	0	0
5	57762479	.	A	T	13	25	38	0	1	40	1	0
5	57762656	.	T	G	14	16	30	0	2	32	0	0
5	57762849	.	A	T	16	18	34	0	0	34	0	0
5	57762868	.	A	G	13	17	30	0	5	35	0	0
5	57762900	.	T	C	14	18	32	0	2	34	0	0
5	57762938	.	A	T	12	22	34	0	2	36	0	0
5	57762986	.	C	G	16	11	27	0	0	27	0	0
5	57777906	.	C	G	3	0	3	0	4	7	0	0
5	57787630	.	C	T	13	12	25	0	0	25	0	0
5	57790313	.	G	A	20	11	31	0	0	31	0	0
5	57790583	.	G	A	26	19	45	0	2	47	0	0
5	57797085	.	A	C	21	27	48	0	7	55	0	0
5	57797152	.	G	A	2	26	28	0	28	56	0	0
5	57797844	.	C	T	23	32	55	0	7	62	0	0
5	57797887	.	A	T	22	41	63	0	2	65	0	0
5	57797914	.	A	G	26	4	30	0	27	57	0	0
5	57797954	.	T	C	32	17	49	0	0	49	0	0
5	57814523	.	A	G	1	3	4	0	0	4	0	0
5	57814627	.	G	A	4	4	8	0	0	8	0	0
5	57814685	.	A	G	3	2	5	0	0	5	0	0
5	58075686	.	A	G	3	3	6	0	0	6	0	0
5	58075815	.	T	G	0	2	2	0	1	3	0	0
5	58075863	.	G	A	1	3	4	0	1	5	0	0
5	58372217	.	G	A	9	6	15	0	1	16	0	0
5	58372226	.	C	T	13	13	26	0	3	29	0	0
5	58372268	.	T	C	24	19	43	0	0	43	0	0
5	58382159	.	A	G	24	1	25	0	38	63	0	0
5	58382358	.	C	T	18	32	50	0	2	52	0	0
5	58382440	.	T	A	25	12	37	1	6	55	11	0
5	58382457	.	C	G	31	3	34	1	13	48	0	0
5	58457014	.	T	C	5	3	8	0	0	8	0	0
5	58459461	.	T	C	3	4	7	0	0	7	0	0
5	58459476	.	A	C	2	5	7	0	0	7	0	0
5	58462891	.	A	G	5	0	5	0	8	13	0	0
5	58468137	.	T	C	8	4	12	0	1	13	0	0
5	58470952	.	C	G	5	3	8	0	1	9	0	0
5	58477239	.	C	A	9	8	17	0	2	19	0	0
5	58477248	.	T	A	7	10	17	0	1	18	0	0
5	58477449	.	A	T	5	9	14	0	1	15	0	0
5	58478136	.	T	C	13	12	25	0	1	26	0	0
5	58478188	.	C	T	13	17	30	0	4	34	0	0
5	58481826	.	T	C	3	7	10	0	2	12	0	0
5	58687623	.	A	T	8	5	13	0	0	13	0	0
5	58687649	.	C	A	9	5	14	0	0	14	0	0
5	58687673	.	T	C	8	2	10	0	1	11	0	0
5	58687690	.	T	A	5	3	8	0	1	9	0	0
5	58687739	.	G	A	0	5	5	0	2	7	0	0
5	58688621	.	T	A	2	2	4	0	2	6	0	0
5	58688644	.	A	G	3	3	6	0	1	7	0	0
5	58688687	.	G	A	0	4	4	0	6	10	0	0
5	58691748	.	A	G	6	13	19	0	1	20	0	0
5	58691763	.	T	G	10	17	27	0	2	29	0	0
5	58695746	.	A	T	5	12	17	0	1	18	0	0
5	58695764	.	G	A	1	8	9	0	3	12	0	0
5	58695783	.	A	C	3	5	8	0	1	9	0	0
5	58696063	.	G	A	4	6	10	0	1	11	0	0
5	58696412	.	A	C	7	11	18	0	0	18	0	0
5	58696670	.	T	C	11	1	12	0	18	30	0	0
5	58696840	.	G	A	12	8	20	0	0	20	0	0
5	58696997	.	T	G	7	12	19	0	0	19	0	0
5	58697007	.	A	C	5	12	17	0	1	18	0	0
5	58697050	.	C	T	9	12	21	0	1	22	0	0
5	58699888	.	C	T	1	7	8	0	0	8	0	0
5	58704284	.	G	C	5	4	9	0	0	9	0	0
5	58707265	.	A	G	5	6	11	0	1	12	0	0
5	58708812	.	T	G	6	4	10	0	0	10	0	0
5	58708832	.	T	G	7	5	12	0	0	12	0	0
5	58708996	.	G	T	4	8	12	0	1	13	0	0
5	58711159	.	G	T	2	6	8	0	1	9	0	0
5	58713579	.	C	T	7	5	12	0	0	12	0	0
5	58717412	.	C	T	5	5	10	0	0	10	0	0
5	58717535	.	C	G	1	6	7	0	3	10	0	0
5	58721406	.	C	T	0	2	2	0	2	4	0	0
5	58726558	.	C	T	3	2	5	0	0	5	0	0
5	58726575	.	C	T	4	2	6	0	1	7	0	0
5	58850883	.	A	T	15	21	36	0	2	38	0	0
5	58850923	.	A	C	21	17	38	0	0	38	0	0
5	58850958	.	T	C	26	0	26	0	13	39	0	0
5	58850981	.	A	T	22	15	37	0	0	37	0	0
5	58851041	.	G	T	13	15	28	0	5	33	0	0
5	58852256	.	G	A	11	6	17	0	0	17	0	0
5	58852582	.	G	A	5	4	9	4	0	13	0	0
5	58852687	.	A	G	6	12	18	0	1	19	0	0
5	58852784	.	A	G	3	12	15	0	0	15	0	0
5	58852825	.	A	C	7	9	16	0	0	16	0	0
5	58853407	.	C	T	6	2	8	0	0	8	0	0
5	59079594	.	A	G	2	12	14	0	0	14	0	0
5	59079726	.	C	A	5	3	8	0	0	8	0	0
5	59079732	.	A	C	3	4	7	0	1	8	0	0
5	59079919	.	G	A	1	4	5	0	0	5	0	0
5	59080392	.	C	A	2	2	4	0	0	4	0	0
5	59080682	.	A	T	1	3	4	0	0	4	0	0
5	59080874	.	A	G	3	3	6	0	1	7	0	0
5	59082497	.	A	T	9	12	21	0	1	22	0	0
5	59082540	.	C	T	11	8	19	0	0	19	0	0
5	59082581	.	T	A	5	5	10	0	1	11	0	0
5	59082685	.	G	A	13	10	23	0	1	24	0	0
5	59082703	.	T	C	9	9	18	0	2	20	0	0
5	59082882	.	C	T	15	12	27	0	3	30	0	0
5	59083136	.	T	G	12	14	26	0	2	28	0	0
5	59083180	.	G	T	1	15	16	0	7	23	0	0
5	59083201	.	T	A	9	11	20	0	2	22	0	0
5	59092513	.	A	G	13	11	24	0	0	24	0	0
5	59092644	.	G	A	13	8	21	0	1	22	0	0
5	59101813	.	G	A	1	3	4	0	1	5	0	0
5	59200206	.	G	T	2	3	5	0	0	5	0	0
5	59200444	.	G	A	1	1	2	0	1	3	0	0
5	59200523	.	C	G	2	3	5	0	1	6	0	0
5	59200721	.	G	A	0	2	2	0	3	5	0	0
5	59200733	.	G	A	2	3	5	0	0	5	0	0
5	59201199	.	C	T	3	4	7	0	0	7	0	0
5	59201211	.	A	T	3	3	6	0	0	6	0	0
5	59201259	.	G	A	2	3	5	0	0	5	0	0
5	59201263	.	G	A	1	3	4	0	0	4	0	0
5	59201364	.	C	T	1	2	3	0	1	4	0	0
5	59201420	.	A	G	3	4	7	0	0	7	0	0
5	59201427	.	C	G	2	3	5	0	0	5	0	0
5	59201474	.	C	T	2	7	9	0	0	9	0	0
5	59201609	.	A	T	2	2	4	0	0	4	0	0
5	59201883	.	T	G	16	7	23	0	0	23	0	0
5	59239773	.	C	G	5	7	12	0	0	12	0	0
5	59367819	.	C	G	2	3	5	0	1	6	0	0
5	59386512	.	C	G	1	2	3	0	1	4	0	0
5	59387476	.	C	A	6	2	8	0	0	8	0	0
5	59387478	.	C	A	6	2	8	0	0	8	0	0
5	59388343	.	T	C	2	5	7	0	0	7	0	0
5	59388586	.	T	A	7	6	13	0	1	14	0	0
5	59388604	.	T	C	6	11	17	0	0	17	0	0
5	59388951	.	T	A	5	6	11	0	2	13	0	0
5	59389440	.	T	A	2	2	4	0	1	5	0	0
5	59389444	.	T	A	2	2	4	0	0	4	0	0
5	59389688	.	G	A	14	6	20	0	3	23	0	0
5	59444562	.	C	A	2	4	6	0	0	6	0	0
5	59449767	.	C	T	1	6	7	0	0	7	0	0
5	59462595	.	C	T	4	4	8	0	1	9	0	0
5	59462679	.	C	T	2	3	5	0	0	5	0	0
5	59462991	.	T	C	0	4	4	0	1	5	0	0
5	59462994	.	A	T	0	4	4	0	1	5	0	0
5	59463327	.	A	C	5	3	8	0	0	8	0	0
5	59466867	.	T	G	4	0	4	0	10	14	0	0
5	59466882	.	G	A	1	12	13	0	3	16	0	0
5	59466930	.	A	G	3	4	7	0	1	8	0	0
5	59472724	.	T	C	7	10	17	0	1	18	0	0
5	59473728	.	T	C	6	4	10	0	2	12	0	0
5	59479541	.	C	A	5	6	11	0	3	14	0	0
5	59479546	.	A	C	8	7	15	0	1	16	0	0
5	59479973	.	C	T	8	11	19	0	0	19	0	0
5	59515509	.	A	G	1	2	3	0	0	3	0	0
5	59544291	.	T	C	5	2	7	0	0	7	0	0
5	59544327	.	C	T	3	5	8	0	0	8	0	0
5	59544645	.	G	T	8	6	14	0	0	14	0	0
5	59548976	.	C	G	6	3	9	0	2	11	0	0
5	59549006	.	G	A	0	5	5	0	6	11	0	0
5	59549143	.	A	G	4	0	4	0	3	7	0	0
5	59549148	.	G	A	5	2	7	0	0	7	0	0
5	59549382	.	A	G	5	3	8	0	1	9	0	0
5	59549389	.	G	A	3	4	7	0	1	8	0	0
5	59550097	.	A	G	5	8	13	0	0	13	0	0
5	59550260	.	A	T	2	8	10	0	1	11	0	0
5	59550529	.	T	G	9	5	14	0	2	16	0	0
5	59550581	.	T	C	10	4	14	0	1	15	0	0
5	59550636	.	A	T	7	6	13	0	0	13	0	0
5	59560110	.	T	C	1	6	7	0	0	7	0	0
5	59560131	.	A	G	3	0	3	0	5	8	0	0
5	59560163	.	G	T	1	2	3	0	3	6	0	0
5	59593297	.	G	C	1	4	5	0	6	11	0	0
5	59593408	.	G	T	6	6	12	0	1	13	0	0
5	59593523	.	C	T	4	2	6	0	0	6	0	0
5	59593685	.	A	T	2	5	7	0	1	8	0	0
5	59593773	.	G	C	6	3	9	0	0	9	0	0
5	59593822	.	G	T	4	6	10	0	0	10	0	0
5	59593884	.	T	G	2	3	5	0	1	6	0	0
5	59594328	.	T	C	3	7	10	0	0	10	0	0
5	59594485	.	G	T	8	11	19	0	2	21	0	0
5	59594551	.	A	G	14	0	14	0	7	21	0	0
5	59594648	.	A	T	3	6	9	0	0	9	0	0
5	59595127	.	T	C	4	3	7	0	2	9	0	0
5	59595241	.	T	C	6	10	16	0	0	16	0	0
5	59595252	.	C	T	9	8	17	0	1	18	0	0
5	59595502	.	T	C	7	3	10	0	0	10	0	0
5	59595503	.	G	C	6	3	9	0	1	10	0	0
5	60684603	.	A	G	2	0	2	0	6	8	0	0
5	60684866	.	C	T	2	3	5	0	0	5	0	0
5	60685481	.	G	A	5	5	10	0	2	12	0	0
5	60685513	.	A	G	5	3	8	0	0	8	0	0
5	60685758	.	T	C	4	10	14	0	0	14	0	0
5	60685773	.	C	T	2	13	15	0	1	16	0	0
5	60685851	.	G	A	3	6	9	0	1	10	0	0
5	60685952	.	A	C	1	4	5	0	0	5	0	0
5	60686374	.	A	T	1	8	9	0	0	9	0	0
5	60686380	.	C	A	2	7	9	0	3	12	0	0
5	60686686	.	C	G	4	7	11	0	3	14	0	0
5	60686910	.	G	T	10	11	21	0	1	22	0	0
5	60687537	.	T	C	8	7	15	0	0	15	0	0
5	60863107	.	C	T	2	2	4	0	0	4	0	0
5	60866063	.	G	T	4	5	9	0	1	10	0	0
5	60868009	.	A	G	6	0	6	0	6	12	0	0
5	60868173	.	G	A	2	3	5	0	4	9	0	0
5	60868216	.	G	A	5	3	8	0	0	8	0	0
5	60868958	.	T	C	1	2	3	0	0	3	0	0
5	60868960	.	G	A	0	2	2	0	1	3	0	0
5	60869015	.	C	A	5	7	12	0	0	12	0	0
5	60871999	.	A	T	6	10	16	0	0	16	0	0
5	60872126	.	G	A	12	14	26	0	1	27	0	0
5	60872299	.	T	G	5	9	14	0	0	14	0	0
5	60872320	.	T	C	6	9	15	0	0	15	0	0
5	60872472	.	G	A	10	3	13	0	0	13	0	0
5	60872708	.	T	C	6	6	12	0	0	12	0	0
5	60872926	.	T	C	2	4	6	0	1	7	0	0
5	61270901	.	G	A	5	3	8	0	1	9	0	0
5	61270905	.	C	T	5	4	9	0	0	9	0	0
5	61329486	.	G	A	7	9	16	0	1	17	0	0
5	61329604	.	C	T	2	3	5	0	1	6	0	0
5	61351582	.	C	A	5	7	12	0	1	13	0	0
5	61351600	.	C	A	8	9	17	0	0	17	0	0
5	61351851	.	C	T	6	9	15	0	3	18	0	0
5	61353710	.	G	C	8	5	13	1	9	23	0	0
5	61354112	.	G	T	6	5	11	0	1	12	0	0
5	61380103	.	T	A	7	5	12	0	0	12	0	0
5	61380130	.	C	T	7	5	12	0	0	12	0	0
5	61392719	.	C	T	17	9	26	0	0	26	0	0
5	61396054	.	G	A	5	8	13	0	0	13	0	0
5	61402030	.	G	A	5	11	16	0	0	16	0	0
5	61402455	.	A	T	16	12	28	0	1	29	0	0
5	61402479	.	G	A	11	17	28	0	1	29	0	0
5	61402570	.	T	C	22	12	34	0	0	34	0	0
5	61402584	.	A	G	14	1	15	0	18	33	0	0
5	61402761	.	T	A	19	22	41	0	0	41	0	0
5	61402999	.	T	A	19	17	36	0	2	38	0	0
5	61404563	.	C	T	6	5	11	0	0	11	0	0
5	61404702	.	A	T	5	5	10	0	0	10	0	0
5	61405203	.	C	T	6	11	17	0	2	19	0	0
5	61405245	.	C	A	6	16	22	0	1	23	0	0
5	61405885	.	A	G	8	4	12	0	0	12	0	0
5	61405954	.	A	G	4	8	12	0	0	12	0	0
5	61414619	.	C	T	5	6	11	0	0	11	0	0
5	61416963	.	C	A	5	5	10	0	0	10	0	0
5	61425708	.	C	T	3	6	9	0	1	10	0	0
5	61425723	.	C	T	4	4	8	0	0	8	0	0
5	61425795	.	G	C	1	4	5	0	0	5	0	0
5	61425800	.	A	G	1	4	5	0	0	5	0	0
5	61428878	.	A	G	1	3	4	0	2	6	0	0
5	61428915	.	C	G	3	2	5	0	0	5	0	0
5	61428984	.	C	T	2	2	4	0	0	4	0	0
5	61429013	.	C	A	3	2	5	0	0	5	0	0
5	61429058	.	G	T	2	4	6	0	0	6	0	0
5	61429149	.	C	T	1	3	4	0	0	4	0	0
5	61433080	.	A	T	3	1	4	0	0	4	0	0
5	61433102	.	G	T	1	2	3	0	1	4	0	0
5	61433196	.	A	T	0	4	4	0	0	4	0	0
5	61459502	.	T	C	5	8	13	0	1	14	0	0
5	61464874	.	G	T	6	9	15	0	5	20	0	0
5	61464900	.	G	T	15	5	20	0	0	20	0	0
5	61472429	.	G	A	3	10	13	0	0	13	0	0
5	61472457	.	C	T	8	4	12	0	0	12	0	0
5	61472543	.	C	G	5	4	9	0	0	9	0	0
5	61472598	.	C	G	3	2	5	0	0	5	0	0
5	61508648	.	G	T	2	2	4	0	0	4	0	0
5	61548819	.	T	G	10	0	10	0	8	18	0	0
5	61552787	.	T	A	4	9	13	0	1	14	0	0
5	61553022	.	G	A	10	12	22	0	0	22	0	0
5	61553207	.	C	T	2	6	8	0	0	8	0	0
5	61553309	.	A	G	2	0	2	0	5	7	0	0
5	61553409	.	A	T	16	9	25	0	0	26	1	0
5	61553418	.	G	A	9	17	26	0	1	27	0	0
5	61553452	.	C	T	14	13	27	0	1	28	0	0
5	61553556	.	A	T	10	13	23	1	0	24	0	0
5	61553614	.	C	T	16	6	22	1	5	28	0	0
5	61553699	.	G	T	17	14	31	0	0	31	0	0
5	61584144	.	G	C	6	5	11	0	0	11	0	0
5	61586142	.	C	A	1	8	9	0	1	10	0	0
5	61658315	.	A	C	2	2	4	0	0	4	0	0
5	61660526	.	C	T	1	2	3	0	0	3	0	0
5	61676739	.	A	C	3	4	7	0	0	7	0	0
5	61682715	.	A	C	2	4	6	0	2	8	0	0
5	61682721	.	C	T	4	4	8	0	0	8	0	0
5	61696396	.	C	T	3	7	10	0	0	10	0	0
5	61701969	.	C	A	19	12	31	0	0	31	0	0
5	61706220	.	T	C	11	15	26	0	0	26	0	0
5	61723061	.	G	A	24	20	44	0	7	51	0	0
5	61723481	.	G	T	2	29	31	0	21	52	0	0
5	61723584	.	A	T	15	28	43	0	2	45	0	0
5	61723637	.	A	G	18	18	36	0	1	37	0	0
5	61723674	.	G	A	31	17	48	0	0	48	0	0
5	61723694	.	T	G	20	28	48	0	0	48	0	0
5	61723914	.	T	C	20	32	52	0	4	56	0	0
5	61723979	.	C	T	16	10	26	0	0	26	0	0
5	61790154	.	C	T	2	3	5	0	0	5	0	0
5	61790157	.	T	C	1	3	4	0	1	5	0	0
5	61793019	.	T	A	3	3	6	0	0	6	0	0
5	61793886	.	T	A	5	2	7	0	0	7	0	0
5	61794545	.	T	C	2	2	4	0	0	4	0	0
5	61951038	.	A	G	6	7	13	0	1	14	0	0
5	62639596	.	G	A	18	23	41	0	1	42	0	0
5	62642989	.	A	G	14	5	19	1	0	20	0	0
5	62806599	.	T	A	7	2	9	0	1	10	0	0
5	62806675	.	A	G	10	9	19	0	0	19	0	0
5	62806701	.	A	G	6	5	11	0	2	13	0	0
5	62806786	.	C	A	5	5	10	0	0	10	0	0
5	62806867	.	C	T	1	3	4	0	9	13	0	0
5	62806951	.	A	G	5	5	10	0	1	11	0	0
5	62807044	.	T	A	1	4	5	0	3	8	0	0
5	62807056	.	T	C	1	2	3	0	1	4	0	0
5	62807258	.	T	A	4	3	7	0	0	7	0	0
5	62807263	.	G	A	4	3	7	0	0	7	0	0
5	62807294	.	G	A	5	4	9	0	2	11	0	0
5	62807519	.	G	A	4	9	13	0	0	13	0	0
5	62860901	.	A	G	5	3	8	0	0	8	0	0
5	62860902	.	G	T	5	3	8	0	0	8	0	0
5	62860943	.	T	C	3	3	6	0	1	7	0	0
5	62860969	.	T	A	4	3	7	0	1	8	0	0
5	62865289	.	G	A	3	3	6	0	0	6	0	0
5	62989260	.	C	T	5	2	7	0	0	7	0	0
5	63193716	.	T	C	2	2	4	0	0	4	0	0
5	63248486	.	G	A	1	2	3	0	0	3	0	0
5	63308418	.	C	T	2	2	4	0	0	4	0	0
5	63310766	.	T	A	2	2	4	0	0	4	0	0
5	63311258	.	C	A	1	4	5	0	1	6	0	0
5	63329526	.	G	A	3	3	6	0	0	6	0	0
5	63338422	.	C	T	4	3	7	1	0	8	0	0
5	63338518	.	A	T	5	4	9	0	0	9	0	0
5	63338557	.	C	T	3	5	8	0	0	8	0	0
5	63338563	.	A	G	3	4	7	0	0	7	0	0
5	63359863	.	T	A	1	2	3	0	0	3	0	0
5	63360290	.	A	G	1	2	3	0	0	3	0	0
5	63360311	.	A	G	1	2	3	0	0	3	0	0
5	63362964	.	A	G	1	0	1	0	4	5	0	0
5	63363040	.	A	G	4	1	5	0	0	5	0	0
5	63363058	.	C	T	4	3	7	0	0	7	0	0
5	63373157	.	T	C	3	3	6	0	1	7	0	0
5	63382081	.	G	A	4	2	6	0	0	6	0	0
5	63394174	.	C	A	9	9	18	0	0	18	0	0
5	63395057	.	A	T	12	15	27	0	2	29	0	0
5	63398847	.	T	C	7	11	18	0	1	19	0	0
5	63398973	.	G	A	18	10	28	0	4	32	0	0
5	63399066	.	G	C	17	24	41	0	2	43	0	0
5	63399111	.	T	A	24	25	49	0	1	50	0	0
5	63399683	.	T	A	14	16	30	0	2	32	0	0
5	63400476	.	G	A	3	3	6	0	0	6	0	0
5	63407424	.	A	G	1	2	3	0	0	3	0	0
5	63510713	.	C	G	1	2	3	0	3	6	0	0
5	63510908	.	G	T	9	7	16	0	2	18	0	0
5	63511045	.	A	G	3	8	11	0	1	12	0	0
5	63511110	.	T	C	2	0	2	0	7	9	0	0
5	63511315	.	A	G	6	2	8	0	0	8	0	0
5	63511788	.	A	T	5	8	13	0	0	13	0	0
5	63511791	.	A	G	5	8	13	0	0	13	0	0
5	63648324	.	C	T	1	2	3	0	0	3	0	0
5	63648376	.	T	C	1	0	1	0	3	4	0	0
5	63648410	.	T	C	2	3	5	0	0	5	0	0
5	63648412	.	T	C	2	3	5	0	0	5	0	0
5	63648811	.	A	G	2	3	5	0	0	5	0	0
5	63655829	.	T	C	4	2	6	0	0	6	0	0
5	63695760	.	C	T	3	3	6	0	0	6	0	0
5	63698549	.	T	C	5	3	8	0	0	8	0	0
5	63720639	.	A	G	4	4	8	0	0	8	0	0
5	63723807	.	G	A	0	4	4	0	4	8	0	0
5	63730115	.	G	A	0	13	13	0	13	26	0	0
5	63740093	.	C	T	19	13	32	0	1	33	0	0
5	63740097	.	T	A	19	14	33	0	0	33	0	0
5	63740149	.	T	C	10	16	26	0	0	26	0	0
5	63740167	.	A	G	5	15	20	0	3	26	3	0
5	63740815	.	A	C	24	25	49	0	1	50	0	0
5	63740874	.	A	C	33	17	50	0	4	54	0	0
5	63740895	.	A	C	32	20	52	0	2	54	0	0
5	63740910	.	A	G	23	25	48	0	2	50	0	0
5	63741023	.	T	A	19	10	29	0	1	30	0	0
5	63741077	.	A	T	21	8	29	0	1	30	0	0
5	63863945	.	G	C	4	3	7	0	0	7	0	0
5	63864117	.	C	T	11	7	18	0	0	18	0	0
5	63864150	.	T	C	8	6	14	0	0	14	0	0
5	64205784	.	T	C	12	5	17	0	0	17	0	0
5	66252054	.	G	A	0	2	2	0	3	5	0	0
5	66252127	.	A	T	1	2	3	0	1	4	0	0
5	66268964	.	A	G	5	0	5	0	3	8	0	0
5	66676766	.	C	G	5	8	13	1	2	16	0	0
5	66676768	.	G	A	6	8	14	1	1	16	0	0
5	66699135	.	G	T	9	4	13	1	1	15	0	0
5	66699138	.	C	G	10	3	13	1	0	14	0	0
5	66733572	.	C	T	1	5	6	0	8	14	0	0
5	66733682	.	T	C	14	14	28	0	2	30	0	0
5	66733694	.	T	C	15	0	15	0	12	27	0	0
5	66733891	.	G	C	10	6	16	0	1	17	0	0
5	66736211	.	T	C	3	5	8	0	1	9	0	0
5	66736280	.	A	G	1	6	7	0	0	7	0	0
5	66740183	.	A	T	5	4	9	0	0	9	0	0
5	66740239	.	T	G	2	5	7	0	2	9	0	0
5	66740273	.	A	T	3	2	5	0	0	5	0	0
5	66807482	.	C	T	21	15	36	0	1	37	0	0
5	66807543	.	C	T	2	24	26	0	19	45	0	0
5	66807735	.	A	G	9	14	23	0	2	25	0	0
5	66807771	.	T	G	18	12	30	0	0	30	0	0
5	66807788	.	C	T	2	14	16	0	13	29	0	0
5	66807830	.	G	A	7	14	21	0	0	21	0	0
5	66807831	.	A	G	7	13	20	0	1	21	0	0
5	66807881	.	A	G	15	12	27	0	3	30	0	0
5	66807916	.	T	C	25	15	40	0	2	42	0	0
5	66813647	.	T	C	5	1	6	0	5	11	0	0
5	66813674	.	G	A	3	6	9	0	1	10	0	0
5	66813722	.	A	G	6	8	14	0	0	14	0	0
5	66814504	.	T	C	8	6	14	0	1	15	0	0
5	66814522	.	A	G	10	4	14	1	1	16	0	0
5	66818699	.	C	T	7	6	13	0	0	13	0	0
5	66819515	.	T	C	6	7	13	0	1	14	0	0
5	66820859	.	A	T	2	4	6	0	0	6	0	0
5	67273140	.	A	G	2	0	2	0	3	5	0	0
5	67273141	.	A	G	1	2	3	0	2	5	0	0
5	67273276	.	A	G	2	4	6	0	0	6	0	0
5	67273308	.	A	G	5	3	8	0	0	8	0	0
5	67884737	.	A	T	1	5	6	0	1	7	0	0
5	68767339	.	T	C	7	0	7	0	4	11	0	0
5	68767342	.	T	C	5	6	11	0	0	11	0	0
5	68767712	.	A	C	5	4	9	0	2	11	0	0
5	68767722	.	A	C	7	3	10	0	1	11	0	0
5	68891782	.	A	G	0	3	3	0	0	3	0	0
5	68891791	.	G	T	5	3	8	0	3	11	0	0
5	68892515	.	A	C	18	21	39	7	0	46	0	0
5	68892872	.	T	C	3	13	16	0	0	16	0	0
5	68892972	.	T	C	2	19	21	1	0	22	0	0
5	69140658	.	T	C	7	6	13	0	2	15	0	0
5	69588720	.	A	T	1	6	7	0	0	7	0	0
5	69595361	.	G	A	4	5	9	0	0	9	0	0
5	69599798	.	G	T	6	14	20	1	0	21	0	0
5	69607398	.	T	C	1	2	3	0	0	3	0	0
5	69608211	.	G	A	1	4	5	3	1	9	0	0
5	69725486	.	C	T	8	2	10	0	0	10	0	0
5	69732213	.	G	T	5	1	6	0	1	7	0	0
5	69783588	.	A	G	2	2	4	0	0	4	0	0
5	69907537	.	T	C	11	4	15	0	1	16	0	0
5	70182082	.	A	G	19	28	47	0	2	49	0	0
5	70182599	.	T	G	30	1	31	0	25	56	0	0
5	71253271	.	C	T	5	3	8	2	0	10	0	0
5	71253282	.	T	C	5	0	5	2	3	10	0	0
6	42301	.	A	T	6	27	33	0	2	35	0	0
6	842264	.	T	C	8	3	11	0	1	12	0	0
6	1798081	.	G	T	4	7	11	0	0	11	0	0
6	1798088	.	T	C	4	7	11	0	0	11	0	0
6	2197818	.	C	T	3	2	5	0	0	5	0	0
6	3142968	.	T	C	3	1	4	0	2	6	0	0
6	3143609	.	G	A	1	3	4	0	0	4	0	0
6	3197028	.	C	T	2	6	8	0	1	9	0	0
6	3223245	.	C	T	1	3	4	0	0	4	0	0
6	3223341	.	C	G	3	4	7	0	0	7	0	0
6	3249490	.	C	T	5	6	11	0	3	14	0	0
6	3256066	.	C	A	5	14	19	0	1	20	0	0
6	3268327	.	T	C	8	17	25	0	1	26	0	0
6	3269864	.	A	G	13	1	14	0	11	25	0	0
6	3270011	.	G	A	13	21	34	0	0	34	0	0
6	3273272	.	A	T	11	20	31	0	2	33	0	0
6	3273341	.	T	A	9	13	22	0	2	24	0	0
6	3273379	.	A	G	7	10	17	0	0	17	0	0
6	3273901	.	T	G	18	0	18	0	26	44	0	0
6	3274114	.	G	C	1	28	29	0	18	47	0	0
6	3274191	.	G	C	23	18	41	3	2	46	0	0
6	3318673	.	T	C	2	3	5	0	0	5	0	0
6	3318721	.	G	A	0	5	5	0	1	6	0	0
6	3398906	.	A	G	4	6	10	0	0	10	0	0
6	3404913	.	A	C	3	4	7	0	0	7	0	0
6	3404956	.	G	A	0	4	4	0	5	9	0	0
6	3404974	.	C	T	7	3	10	0	0	10	0	0
6	3405052	.	G	A	5	7	12	0	0	12	0	0
6	3405060	.	G	A	0	8	8	0	4	12	0	0
6	3405143	.	T	C	5	4	9	0	1	10	0	0
6	3405191	.	G	C	9	5	14	0	0	14	0	0
6	3405244	.	A	G	7	4	11	0	0	11	0	0
6	3405245	.	C	A	8	4	12	0	0	12	0	0
6	3509041	.	T	G	2	3	5	0	0	5	0	0
6	3514481	.	A	C	27	25	52	2	4	58	0	0
6	3698558	.	C	T	3	3	6	0	0	6	0	0
6	3704391	.	G	A	0	7	7	0	3	10	0	0
6	3707095	.	A	G	9	4	13	0	1	14	0	0
6	3707116	.	G	A	12	4	16	0	0	16	0	0
6	3707371	.	G	A	1	6	7	0	9	16	0	0
6	3707372	.	A	G	8	6	14	0	2	16	0	0
6	3707407	.	T	C	7	13	20	0	2	22	0	0
6	3708061	.	A	G	9	7	16	0	0	16	0	0
6	3708149	.	T	C	8	10	18	0	0	18	0	0
6	3711282	.	T	G	4	0	4	0	4	8	0	0
6	3711338	.	A	G	1	3	4	0	0	4	0	0
6	3711386	.	T	C	3	4	7	0	0	7	0	0
6	3711419	.	A	G	2	2	4	0	1	5	0	0
6	3711616	.	G	A	1	4	5	0	0	5	0	0
6	3711665	.	A	T	3	3	6	0	0	6	0	0
6	3711971	.	G	A	6	3	9	0	0	9	0	0
6	3712045	.	T	A	3	2	5	0	0	5	0	0
6	3712198	.	G	T	1	3	4	0	0	4	0	0
6	3712199	.	A	C	1	2	3	0	0	4	1	0
6	3712238	.	A	T	2	3	5	0	0	5	0	0
6	3712264	.	A	C	4	3	7	0	0	7	0	0
6	3717110	.	A	T	4	4	8	0	0	8	0	0
6	3717843	.	C	T	2	2	4	0	0	4	0	0
6	3724870	.	A	C	5	4	9	0	0	9	0	0
6	3725767	.	C	A	13	17	30	0	0	30	0	0
6	3727891	.	C	T	8	14	22	0	0	22	0	0
6	3728295	.	A	T	5	6	11	0	1	12	0	0
6	3728559	.	G	C	4	9	13	0	0	13	0	0
6	3821586	.	G	A	1	2	3	0	0	3	0	0
6	3821601	.	T	C	1	2	3	0	0	3	0	0
6	3834630	.	G	C	11	11	22	0	1	23	0	0
6	3853120	.	T	G	25	0	25	0	17	42	0	0
6	3853165	.	T	C	26	14	40	0	3	43	0	0
6	3862018	.	A	G	9	16	25	0	2	27	0	0
6	3867542	.	A	T	3	2	5	0	0	5	0	0
6	3869891	.	C	T	13	7	20	0	1	21	0	0
6	3871982	.	T	A	12	9	21	0	2	23	0	0
6	3874504	.	G	A	2	19	21	0	21	42	0	0
6	3874533	.	C	T	20	19	39	0	3	42	0	0
6	3874686	.	A	G	14	7	21	0	0	21	0	0
6	3878513	.	T	A	4	3	7	0	0	7	0	0
6	3878593	.	A	G	3	13	16	0	0	16	0	0
6	3878983	.	A	T	9	7	16	0	1	17	0	0
6	3879158	.	A	G	4	13	17	0	1	18	0	0
6	3879247	.	C	A	2	10	12	0	7	19	0	0
6	3879314	.	C	G	1	11	12	0	7	19	0	0
6	3879335	.	C	T	4	11	15	0	4	19	0	0
6	3879367	.	G	A	5	11	16	0	0	16	0	0
6	3881078	.	G	A	11	3	14	0	0	14	0	0
6	3885451	.	C	T	10	9	19	0	1	20	0	0
6	3906051	.	C	T	1	3	4	0	1	5	0	0
6	3907796	.	A	T	4	4	8	0	0	8	0	0
6	3950270	.	C	T	1	2	3	0	0	3	0	0
6	3953280	.	T	C	4	5	9	0	0	9	0	0
6	3953302	.	A	C	4	4	8	0	0	8	0	0
6	3961387	.	G	A	10	6	16	0	0	16	0	0
6	3962132	.	G	A	27	20	47	0	0	47	0	0
6	3962192	.	A	T	16	16	32	0	0	32	0	0
6	3965461	.	A	G	8	5	13	0	1	14	0	0
6	3973638	.	T	G	3	3	6	0	0	6	0	0
6	3974047	.	G	A	2	3	5	0	0	5	0	0
6	3984909	.	T	A	3	1	4	0	1	5	0	0
6	3985137	.	G	A	5	14	19	0	1	20	0	0
6	3989704	.	C	A	1	3	4	0	0	4	0	0
6	4185678	.	G	A	4	2	6	0	1	7	0	0
6	4219961	.	G	A	2	2	4	0	0	4	0	0
6	4219972	.	A	G	1	2	3	0	0	3	0	0
6	4245276	.	C	T	2	3	5	0	0	5	0	0
6	4246496	.	G	A	0	2	2	0	2	4	0	0
6	4246638	.	A	C	0	2	2	0	1	3	0	0
6	4247928	.	C	T	5	5	10	0	0	10	0	0
6	4248231	.	A	G	3	0	3	0	3	6	0	0
6	4248399	.	A	T	5	4	9	0	0	9	0	0
6	4248412	.	T	A	4	3	7	0	0	7	0	0
6	4248527	.	T	A	1	2	3	0	0	3	0	0
6	4249420	.	C	T	7	3	10	0	0	10	0	0
6	4249437	.	A	G	6	3	9	0	0	9	0	0
6	4249684	.	A	G	3	3	6	0	0	6	0	0
6	4249821	.	G	A	4	2	6	0	0	6	0	0
6	4401088	.	A	T	4	8	12	0	0	12	0	0
6	6232217	.	G	A	5	2	7	0	4	11	0	0
6	6795490	.	A	T	5	4	9	0	0	9	0	0
6	7542491	.	G	T	0	3	3	0	4	7	0	0
6	7545794	.	C	T	7	4	11	0	0	11	0	0
6	7545824	.	T	C	8	5	13	0	0	13	0	0
6	7547451	.	C	T	2	5	7	0	0	7	0	0
6	7549967	.	G	A	21	11	32	0	1	33	0	0
6	7550210	.	A	C	8	4	12	0	2	14	0	0
6	7550405	.	C	T	10	12	22	0	2	24	0	0
6	7551087	.	C	A	2	9	11	0	0	11	0	0
6	7626457	.	C	T	1	1	2	0	2	4	0	0
6	7636811	.	A	T	11	9	20	0	0	20	0	0
6	7637195	.	C	T	7	4	11	0	0	11	0	0
6	7638717	.	G	A	2	4	6	0	1	7	0	0
6	7645319	.	T	C	8	8	16	0	0	16	0	0
6	7646039	.	A	G	7	7	14	0	0	14	0	0
6	7646102	.	G	A	3	7	10	0	0	10	0	0
6	7646111	.	G	C	3	7	10	0	0	10	0	0
6	7648224	.	A	G	7	0	7	0	4	11	0	0
6	7652458	.	C	T	17	20	37	0	0	37	0	0
6	7652470	.	A	C	18	17	35	0	1	36	0	0
6	7652896	.	G	A	2	18	20	0	12	32	0	0
6	7652959	.	C	T	12	23	35	0	2	37	0	0
6	7652989	.	C	T	14	22	36	0	1	37	0	0
6	7656920	.	A	G	17	1	18	0	21	39	0	0
6	7656932	.	A	G	15	19	34	0	4	38	0	0
6	7657177	.	C	T	14	8	22	0	4	26	0	0
6	7657793	.	A	C	20	16	36	0	0	36	0	0
6	7657886	.	T	A	23	19	42	0	0	42	0	0
6	7657887	.	G	T	23	18	41	0	2	43	0	0
6	7657972	.	T	G	18	11	29	0	3	33	1	0
6	7658076	.	G	A	18	17	35	0	3	38	0	0
6	7659833	.	A	T	8	0	8	1	0	9	0	0
6	7659915	.	G	A	7	7	14	0	2	16	0	0
6	7660063	.	C	A	6	3	9	1	0	10	0	0
6	7660119	.	A	G	11	10	21	0	0	21	0	0
6	7660300	.	T	C	2	0	2	0	5	7	0	0
6	7660369	.	T	C	2	3	5	0	0	5	0	0
6	7660458	.	A	C	4	0	4	0	6	10	0	0
6	7660594	.	C	T	5	3	8	0	0	8	0	0
6	7660659	.	C	A	0	3	3	0	4	7	0	0
6	7660707	.	C	T	1	5	6	0	2	8	0	0
6	7688598	.	C	T	0	3	3	0	1	4	0	0
6	7688757	.	A	C	4	0	4	0	6	10	0	0
6	7697573	.	G	A	5	4	9	0	0	9	0	0
6	7713433	.	G	A	23	29	52	0	4	56	0	0
6	7721530	.	T	A	7	12	19	0	1	20	0	0
6	7721860	.	G	A	6	5	11	0	0	11	0	0
6	7721906	.	G	A	10	17	27	1	0	28	0	0
6	7721958	.	C	A	9	16	25	2	0	27	0	0
6	7722143	.	G	T	22	18	40	0	0	40	0	0
6	7722159	.	A	T	22	16	38	0	4	42	0	0
6	7722195	.	G	T	18	17	35	0	2	37	0	0
6	7722205	.	G	A	13	14	27	0	3	30	0	0
6	7722333	.	G	A	5	6	11	2	0	13	0	0
6	7722402	.	T	C	7	8	15	1	1	17	0	0
6	7722577	.	C	T	1	9	10	0	8	18	0	0
6	7722625	.	T	C	18	4	22	0	0	22	0	0
6	7722634	.	T	C	16	5	21	0	1	22	0	0
6	7723008	.	G	T	5	5	10	0	1	11	0	0
6	7723155	.	A	C	13	5	18	0	0	18	0	0
6	7723232	.	A	T	8	4	12	0	1	13	0	0
6	7723850	.	C	T	0	4	4	0	4	8	0	0
6	7723961	.	G	A	5	6	11	0	0	11	0	0
6	7726824	.	G	A	1	3	4	0	0	4	0	0
6	7795698	.	C	T	7	8	15	0	4	19	0	0
6	7842013	.	C	T	0	3	3	0	1	4	0	0
6	8176101	.	A	G	3	2	5	0	0	5	0	0
6	8176575	.	C	T	1	4	5	0	0	5	0	0
6	8177399	.	T	C	3	3	6	0	0	6	0	0
6	8177600	.	T	C	8	4	12	0	2	14	0	0
6	8178002	.	T	C	12	10	22	0	0	22	0	0
6	8178053	.	G	A	1	5	6	0	12	18	0	0
6	8178113	.	T	C	6	5	11	0	1	12	0	0
6	8178351	.	G	A	8	3	11	0	0	11	0	0
6	8179022	.	G	T	1	13	14	0	12	26	0	0
6	8179205	.	A	T	18	8	26	0	2	28	0	0
6	8179373	.	G	A	11	13	24	0	3	27	0	0
6	8179683	.	A	T	8	8	16	0	0	16	0	0
6	8210404	.	C	T	4	2	6	0	0	6	0	0
6	8211075	.	C	T	4	7	11	0	1	12	0	0
6	8211106	.	T	C	4	4	8	0	1	9	0	0
6	8211143	.	A	T	5	5	10	0	1	11	0	0
6	8211154	.	T	C	6	5	11	0	0	11	0	0
6	8212174	.	G	A	3	3	6	0	0	6	0	0
6	8214118	.	T	C	3	4	7	0	0	7	0	0
6	8217870	.	G	A	2	3	5	0	0	5	0	0
6	8265214	.	G	A	4	2	6	0	0	6	0	0
6	8265282	.	G	A	4	8	12	0	0	12	0	0
6	8267111	.	C	T	12	6	18	0	3	21	0	0
6	8267266	.	A	G	13	10	23	0	0	23	0	0
6	8267284	.	G	A	11	7	18	0	1	19	0	0
6	8267519	.	G	A	18	6	24	0	1	25	0	0
6	8267563	.	G	T	16	9	25	0	3	28	0	0
6	8267635	.	T	C	13	16	29	0	1	30	0	0
6	8267795	.	T	A	4	9	13	0	0	13	0	0
6	8267880	.	G	A	6	7	13	0	0	13	0	0
6	8268529	.	A	G	3	4	7	0	1	8	0	0
6	8273066	.	G	A	3	5	8	0	0	8	0	0
6	8315076	.	A	G	1	4	5	0	0	5	0	0
6	8315078	.	A	G	1	4	5	0	0	5	0	0
6	8316947	.	A	G	3	3	6	0	0	6	0	0
6	8318001	.	T	C	1	3	4	0	1	5	0	0
6	8318037	.	G	A	1	3	4	0	1	5	0	0
6	8328181	.	G	T	11	17	28	0	1	29	0	0
6	8365753	.	T	C	7	4	11	0	2	13	0	0
6	8366006	.	A	T	7	7	14	0	1	15	0	0
6	8366167	.	C	T	17	10	27	1	0	28	0	0
6	8370489	.	T	C	7	6	13	0	3	16	0	0
6	8374716	.	G	A	5	10	15	0	0	15	0	0
6	8375089	.	C	T	13	9	22	0	1	23	0	0
6	8380345	.	G	A	2	7	9	0	0	9	0	0
6	8454024	.	G	A	1	2	3	0	0	3	0	0
6	8455483	.	T	C	4	0	4	0	6	10	0	0
6	8457125	.	T	C	1	3	4	0	0	4	0	0
6	9130575	.	A	G	8	10	18	0	1	19	0	0
6	9130579	.	A	G	12	0	12	0	4	16	0	0
6	9595591	.	C	A	3	2	5	0	1	6	0	0
6	10983029	.	A	C	4	8	12	0	0	12	0	0
6	10983066	.	T	C	4	7	11	0	0	11	0	0
6	10983193	.	T	A	3	3	6	0	0	6	0	0
6	10983203	.	C	T	2	2	4	0	2	6	0	0
6	10983356	.	G	A	1	3	4	0	0	4	0	0
6	10983465	.	A	T	2	4	6	0	1	7	0	0
6	10985878	.	C	T	13	8	21	0	0	21	0	0
6	10986131	.	C	T	1	10	11	0	6	17	0	0
6	10986652	.	A	G	4	5	9	0	0	9	0	0
6	11067480	.	A	G	1	3	4	0	0	4	0	0
6	11070411	.	G	C	32	11	43	0	0	43	0	0
6	11070563	.	A	C	33	35	68	0	2	70	0	0
6	11070806	.	G	A	41	20	61	0	3	64	0	0
6	11071056	.	T	A	21	24	45	0	3	48	0	0
6	11071222	.	A	G	19	30	49	1	3	53	0	0
6	11071345	.	G	A	30	25	55	2	4	61	0	0
6	11071357	.	A	G	32	21	53	0	5	58	0	0
6	11253881	.	T	C	2	2	4	0	0	4	0	0
6	11253890	.	C	T	2	2	4	0	0	4	0	0
6	11254196	.	C	T	4	3	7	0	0	7	0	0
6	11257788	.	C	T	10	14	24	0	0	24	0	0
6	11261308	.	C	A	16	12	28	0	1	29	0	0
6	11262080	.	C	T	12	14	26	0	0	26	0	0
6	11264258	.	G	A	9	18	27	1	2	30	0	0
6	11265321	.	G	T	13	11	24	0	1	25	0	0
6	11265424	.	T	C	11	11	22	0	3	25	0	0
6	11265505	.	A	T	15	9	24	0	1	25	0	0
6	11265562	.	T	A	17	9	26	0	1	27	0	0
6	11265761	.	A	T	19	25	44	0	0	44	0	0
6	11265833	.	A	G	23	1	24	0	20	44	0	0
6	11266104	.	A	G	6	21	27	0	0	27	0	0
6	11266111	.	A	G	12	1	13	0	15	28	0	0
6	11266164	.	T	C	28	16	44	0	0	44	0	0
6	11266176	.	C	T	25	14	39	0	0	39	0	0
6	11266360	.	T	G	17	24	41	0	2	43	0	0
6	11266490	.	A	T	4	6	10	0	0	10	0	0
6	11266496	.	T	C	4	4	8	0	0	8	0	0
6	11276827	.	T	A	3	4	7	0	0	7	0	0
6	11276912	.	A	G	13	5	18	0	0	18	0	0
6	11279686	.	T	C	8	7	15	0	2	17	0	0
6	11279815	.	T	C	6	3	9	0	0	9	0	0
6	11281923	.	A	G	6	5	11	0	0	11	0	0
6	11281973	.	G	A	8	5	13	0	1	14	0	0
6	11282272	.	G	C	2	0	2	0	5	7	0	0
6	11282741	.	C	T	2	3	5	0	0	5	0	0
6	11285310	.	C	T	2	4	6	0	1	7	0	0
6	11285362	.	T	C	6	0	6	0	5	11	0	0
6	11285374	.	C	T	6	4	10	0	0	10	0	0
6	11285453	.	T	C	3	8	11	0	0	11	0	0
6	11285459	.	C	G	4	7	11	0	0	11	0	0
6	11285583	.	C	T	3	4	7	0	0	7	0	0
6	11285772	.	C	T	5	4	9	0	0	9	0	0
6	11285835	.	G	A	3	2	5	0	0	5	0	0
6	11288179	.	T	A	1	4	5	0	0	5	0	0
6	11288265	.	T	G	2	3	5	0	0	5	0	0
6	11288558	.	T	C	3	0	3	0	2	5	0	0
6	11295553	.	A	G	5	4	9	0	0	9	0	0
6	11298514	.	A	G	2	4	6	0	0	6	0	0
6	11298557	.	G	A	1	1	2	0	1	3	0	0
6	11299718	.	G	A	1	2	3	0	0	3	0	0
6	11299961	.	C	A	3	2	5	0	0	5	0	0
6	11299963	.	C	T	2	2	4	0	0	4	0	0
6	11316705	.	T	C	1	2	3	0	0	3	0	0
6	11398324	.	G	T	2	3	5	0	0	5	0	0
6	11407918	.	G	A	3	5	8	0	2	10	0	0
6	11407944	.	A	G	6	3	9	0	0	9	0	0
6	11414431	.	A	G	19	0	19	0	9	28	0	0
6	11414448	.	T	C	20	11	31	0	1	32	0	0
6	11414748	.	G	A	8	5	13	0	2	15	0	0
6	11414777	.	A	T	9	7	16	0	0	16	0	0
6	11414822	.	T	G	4	0	4	0	9	13	0	0
6	11415089	.	G	A	6	6	12	1	0	13	0	0
6	11415104	.	C	T	4	8	12	1	4	17	0	0
6	11504430	.	A	T	1	2	3	0	0	3	0	0
6	11508125	.	T	C	2	4	6	0	2	8	0	0
6	11765506	.	A	G	18	27	45	0	5	50	0	0
6	11766190	.	T	A	13	19	32	0	1	33	0	0
6	11766267	.	G	A	23	11	34	0	1	35	0	0
6	11766276	.	A	G	25	9	34	0	1	35	0	0
6	11766765	.	T	C	14	11	25	0	1	26	0	0
6	12529163	.	C	T	6	2	8	0	0	8	0	0
6	12550437	.	G	A	13	11	24	0	0	24	0	0
6	12550764	.	G	A	13	8	21	0	1	22	0	0
6	12550934	.	C	T	14	10	24	0	2	26	0	0
6	12627321	.	T	A	1	3	4	0	0	4	0	0
6	12629345	.	T	C	3	2	5	0	0	5	0	0
6	12797815	.	A	G	5	5	10	0	1	11	0	0
6	13510565	.	T	C	3	2	5	0	0	5	0	0
6	13513936	.	C	T	3	2	5	0	1	6	0	0
6	13513962	.	A	G	2	2	4	0	0	4	0	0
6	13514013	.	T	A	1	2	3	0	0	3	0	0
6	13734439	.	C	T	3	2	5	0	0	5	0	0
6	13734449	.	C	T	1	2	3	0	0	3	0	0
6	13734474	.	C	T	0	2	2	0	1	3	0	0
6	13743317	.	G	A	15	23	38	0	1	39	0	0
6	13743753	.	T	C	19	29	48	0	1	49	0	0
6	13743923	.	C	T	29	28	57	0	2	59	0	0
6	13744099	.	C	T	37	25	62	0	4	66	0	0
6	13746346	.	T	A	6	2	8	0	0	8	0	0
6	13806522	.	C	T	4	2	6	0	0	6	0	0
6	13862171	.	C	T	4	9	13	0	0	13	0	0
6	13862576	.	A	C	16	8	24	0	0	24	0	0
6	13866551	.	G	A	19	15	34	0	0	34	0	0
6	13868823	.	A	G	15	13	28	0	5	33	0	0
6	13868850	.	A	T	19	12	31	0	1	34	2	0
6	13869540	.	C	A	26	10	36	0	1	37	0	0
6	13869608	.	C	T	20	15	35	0	3	38	0	0
6	13897552	.	G	A	1	2	3	0	0	3	0	0
6	13900918	.	C	G	1	0	1	0	3	4	0	0
6	13901213	.	G	A	1	2	3	0	2	5	0	0
6	13901312	.	C	T	2	4	6	0	0	6	0	0
6	13901538	.	G	C	0	3	3	0	2	5	0	0
6	13901547	.	G	A	1	2	3	0	2	5	0	0
6	13907856	.	T	A	2	5	7	0	0	7	0	0
6	13908633	.	G	A	0	14	14	0	5	19	0	0
6	13914821	.	T	C	8	6	14	0	2	16	0	0
6	13914824	.	G	A	9	6	15	0	0	15	0	0
6	13920194	.	A	G	10	8	18	0	2	20	0	0
6	13920275	.	T	G	2	4	6	0	0	6	0	0
6	13967328	.	G	A	4	2	6	0	0	6	0	0
6	13967512	.	C	A	4	5	9	0	1	14	4	0
6	13977567	.	G	T	7	4	11	0	0	11	0	0
6	13977588	.	C	T	4	3	7	0	0	7	0	0
6	13987287	.	G	C	8	4	12	0	0	12	0	0
6	13987299	.	A	T	7	7	14	0	0	14	0	0
6	13987346	.	C	T	2	4	6	0	0	6	0	0
6	13987560	.	T	C	8	6	14	0	1	15	0	0
6	13987631	.	G	A	6	12	18	0	0	18	0	0
6	13987663	.	T	A	7	4	11	0	1	12	0	0
6	13987710	.	G	A	3	6	9	0	0	9	0	0
6	13987713	.	T	G	3	6	9	0	0	9	0	0
6	14010445	.	G	A	4	2	6	0	0	6	0	0
6	14032693	.	T	C	30	9	39	0	0	39	0	0
6	14032698	.	T	A	31	9	40	0	0	40	0	0
6	14032739	.	G	A	16	13	29	0	0	29	0	0
6	14033030	.	G	T	12	7	19	0	1	20	0	0
6	14033167	.	G	A	21	13	34	0	0	34	0	0
6	14033556	.	T	A	7	5	12	0	0	12	0	0
6	14033836	.	G	C	5	4	9	0	0	9	0	0
6	14034887	.	G	C	10	6	16	0	0	16	0	0
6	14034907	.	C	T	0	4	4	0	11	15	0	0
6	14034949	.	G	A	3	8	11	0	0	11	0	0
6	14038306	.	C	T	2	2	4	0	1	5	0	0
6	14038506	.	T	A	1	2	3	0	1	4	0	0
6	14086810	.	T	C	23	28	51	0	4	55	0	0
6	14086901	.	G	T	26	25	51	0	5	56	0	0
6	14086942	.	G	C	35	19	54	0	1	55	0	0
6	14087182	.	C	A	22	24	46	0	4	50	0	0
6	14087220	.	T	A	31	23	54	0	0	54	0	0
6	14087569	.	T	G	20	28	48	0	0	48	0	0
6	14087641	.	A	C	22	22	44	0	4	48	0	0
6	14087883	.	T	C	10	11	21	0	2	23	0	0
6	14088095	.	C	T	13	18	31	0	7	38	0	0
6	14092942	.	T	A	15	20	35	0	1	36	0	0
6	14096684	.	C	T	1	14	15	0	10	25	0	0
6	14098760	.	C	T	2	9	11	0	16	27	0	0
6	14105071	.	G	T	9	9	18	0	0	18	0	0
6	14173159	.	C	A	5	2	7	0	0	7	0	0
6	14173599	.	A	G	3	4	7	0	0	7	0	0
6	14173641	.	G	A	2	5	7	0	0	7	0	0
6	15242641	.	C	T	1	3	4	0	0	4	0	0
6	15527385	.	G	A	1	4	5	0	0	5	0	0
6	15752417	.	A	C	3	6	9	0	1	10	0	0
6	15752641	.	C	T	3	2	5	0	2	7	0	0
6	15752681	.	A	C	3	3	6	0	2	8	0	0
6	15790083	.	C	T	1	2	3	0	1	4	0	0
6	15798119	.	A	C	3	5	8	0	0	8	0	0
6	15798145	.	A	G	3	0	3	0	5	8	0	0
6	15824535	.	A	G	3	3	6	0	0	6	0	0
6	15824597	.	T	A	3	4	7	0	0	7	0	0
6	16031714	.	C	T	1	3	4	0	0	4	0	0
6	16043950	.	C	T	1	14	15	0	17	32	0	0
6	16043980	.	A	G	17	10	27	0	1	28	0	0
6	16043999	.	T	C	21	9	30	0	0	30	0	0
6	16044019	.	T	C	17	0	17	0	13	30	0	0
6	16044282	.	A	G	8	13	21	0	2	23	0	0
6	16044597	.	C	T	10	9	19	0	1	20	0	0
6	16045046	.	G	C	4	3	7	0	5	12	0	0
6	16045413	.	T	C	8	5	13	0	0	13	0	0
6	16045516	.	G	C	7	7	14	0	0	14	0	0
6	16045712	.	C	T	4	6	10	0	0	10	0	0
6	16045946	.	A	C	8	14	22	1	1	24	0	0
6	16045947	.	A	T	8	9	17	1	5	24	1	0
6	16046049	.	G	T	11	4	15	1	0	18	2	0
6	16046098	.	T	C	12	4	16	0	0	16	0	0
6	16046110	.	T	C	8	6	14	0	0	14	0	0
6	16046272	.	G	T	4	3	7	0	0	8	1	0
6	16046435	.	T	C	4	2	6	1	0	7	0	0
6	16046676	.	G	A	4	5	9	0	0	9	0	0
6	16046761	.	A	C	3	4	7	0	0	7	0	0
6	16046850	.	G	A	5	9	14	0	0	14	0	0
6	16046934	.	A	C	7	7	14	0	0	14	0	0
6	16104463	.	T	C	1	0	1	0	2	3	0	0
6	16214658	.	C	T	0	2	2	0	1	3	0	0
6	16473889	.	C	G	1	0	1	0	4	5	0	0
6	16474381	.	T	C	3	3	6	0	0	6	0	0
6	16475047	.	T	A	7	5	12	0	0	12	0	0
6	16475269	.	C	G	1	5	6	0	2	8	0	0
6	16475395	.	A	C	11	7	18	0	0	18	0	0
6	16475559	.	T	A	7	3	10	0	1	11	0	0
6	16475582	.	G	T	4	2	6	0	0	6	0	0
6	16475611	.	A	C	1	3	4	1	1	6	0	0
6	16475728	.	G	A	0	8	8	0	14	22	0	0
6	16478198	.	C	A	1	6	7	0	8	15	0	0
6	16491056	.	G	A	6	6	12	0	0	12	0	0
6	16493381	.	A	T	8	6	14	0	0	14	0	0
6	16493415	.	T	C	6	7	13	0	1	14	0	0
6	16499260	.	A	G	3	2	5	0	0	5	0	0
6	16499311	.	C	T	5	4	9	0	0	9	0	0
6	16509980	.	G	A	2	6	8	0	0	8	0	0
6	16673876	.	C	T	2	1	3	0	1	4	0	0
6	16674296	.	A	G	11	14	25	0	0	25	0	0
6	16674344	.	T	A	22	13	35	0	3	38	0	0
6	16674371	.	T	C	14	8	22	0	10	32	0	0
6	16674435	.	A	C	16	13	29	1	0	30	0	0
6	16674618	.	G	A	11	10	21	0	1	22	0	0
6	16674808	.	T	C	6	12	18	0	1	19	0	0
6	16683385	.	T	C	9	6	15	0	1	16	0	0
6	16684004	.	A	G	2	3	5	0	0	5	0	0
6	16687429	.	C	A	6	6	12	0	1	13	0	0
6	16687432	.	T	A	6	6	12	0	0	12	0	0
6	16688900	.	T	C	2	2	4	0	0	4	0	0
6	17726078	.	G	A	1	2	3	0	2	5	0	0
6	18203782	.	C	A	15	22	37	0	1	38	0	0
6	18203974	.	A	T	5	9	14	0	1	15	0	0
6	18204420	.	A	G	11	9	20	0	0	20	0	0
6	18226653	.	T	G	1	3	4	0	1	5	0	0
6	18245385	.	G	A	25	21	46	0	1	47	0	0
6	18274076	.	G	A	0	4	4	0	1	5	0	0
6	18359376	.	C	T	2	2	4	0	0	4	0	0
6	18361359	.	A	T	4	9	13	0	0	13	0	0
6	18361444	.	C	G	4	11	15	0	0	15	0	0
6	18361609	.	T	C	4	5	9	0	0	9	0	0
6	18361729	.	G	C	7	4	11	0	1	12	0	0
6	18362043	.	T	G	4	0	4	0	4	8	0	0
6	18364051	.	A	T	1	2	3	0	1	4	0	0
6	18364081	.	G	A	0	3	3	0	2	5	0	0
6	18364543	.	A	T	4	5	9	0	0	9	0	0
6	18388387	.	T	G	4	4	8	0	0	8	0	0
6	18388517	.	G	C	3	5	8	0	1	9	0	0
6	18388569	.	C	T	2	8	10	0	0	11	1	0
6	18388835	.	C	A	5	6	11	0	0	11	0	0
6	18388975	.	G	A	5	4	9	0	2	11	0	0
6	18389220	.	G	A	7	7	14	0	0	14	0	0
6	18389324	.	T	C	7	1	8	0	7	15	0	0
6	18389541	.	C	T	4	4	8	0	0	8	0	0
6	18436500	.	C	T	9	9	18	0	1	19	0	0
6	18436880	.	C	A	6	8	14	0	0	14	0	0
6	18436966	.	G	A	10	11	21	0	1	22	0	0
6	18436969	.	T	C	10	11	21	0	0	21	0	0
6	18439222	.	C	T	10	8	18	0	0	18	0	0
6	18439256	.	C	A	12	3	15	0	0	15	0	0
6	18439540	.	G	A	8	10	18	0	1	19	0	0
6	18439683	.	C	T	15	3	18	0	1	19	0	0
6	18520930	.	T	A	16	16	32	0	0	32	0	0
6	18523549	.	C	A	16	11	27	0	1	28	0	0
6	18523770	.	A	T	19	17	36	0	1	37	0	0
6	18523772	.	C	G	18	14	32	0	1	33	0	0
6	18523817	.	T	A	14	11	25	0	2	27	0	0
6	18523895	.	C	G	4	3	7	0	3	10	0	0
6	18524550	.	A	G	4	7	11	0	2	13	0	0
6	18524579	.	A	G	7	6	13	0	1	14	0	0
6	18526432	.	A	G	6	4	10	0	0	10	0	0
6	18526754	.	G	T	4	2	6	0	1	7	0	0
6	18531296	.	T	G	3	2	5	0	0	5	0	0
6	18540911	.	T	C	9	7	16	0	1	17	0	0
6	18540932	.	C	T	12	8	20	0	1	21	0	0
6	18543253	.	G	A	0	7	7	0	12	19	0	0
6	18543400	.	A	G	15	9	24	0	4	28	0	0
6	18543637	.	A	G	14	4	18	0	2	20	0	0
6	18543950	.	G	T	7	8	15	0	1	16	0	0
6	18544301	.	T	A	12	9	21	0	0	21	0	0
6	18552872	.	C	G	2	2	4	0	0	4	0	0
6	18552875	.	A	T	2	2	4	0	0	4	0	0
6	18554431	.	G	A	3	3	6	0	2	8	0	0
6	18554541	.	G	A	1	2	3	0	0	3	0	0
6	18554580	.	C	T	2	3	5	0	0	5	0	0
6	18554719	.	T	C	1	1	2	0	2	4	0	0
6	18554836	.	T	G	2	3	5	0	0	5	0	0
6	18585103	.	C	T	3	3	6	0	0	6	0	0
6	18588570	.	G	A	2	4	6	0	1	7	0	0
6	18589090	.	T	C	2	7	9	0	0	9	0	0
6	18589235	.	T	C	9	4	13	0	1	14	0	0
6	18594539	.	A	C	2	5	7	0	1	8	0	0
6	18594604	.	C	T	4	2	6	0	0	6	0	0
6	18594656	.	T	C	7	3	10	0	0	10	0	0
6	18594916	.	T	A	3	2	5	0	0	5	0	0
6	18595059	.	G	A	1	2	3	0	0	3	0	0
6	18595156	.	T	G	3	3	6	0	0	6	0	0
6	18598494	.	A	T	5	7	12	0	0	13	1	0
6	18606063	.	T	C	6	11	17	0	1	18	0	0
6	18606230	.	G	T	15	15	30	0	2	32	0	0
6	18607151	.	G	A	12	11	23	0	2	25	0	0
6	18607557	.	C	T	13	12	25	0	1	26	0	0
6	18612230	.	C	T	7	11	18	0	0	18	0	0
6	18617255	.	A	T	6	5	11	0	1	12	0	0
6	18625021	.	G	A	6	3	9	0	0	9	0	0
6	18936455	.	T	C	6	0	6	0	8	14	0	0
6	19263902	.	G	A	1	2	3	0	0	3	0	0
6	19265802	.	C	A	1	2	3	0	0	3	0	0
6	19295454	.	C	T	20	22	42	0	0	42	0	0
6	19295469	.	T	C	21	0	21	0	17	38	0	0
6	19295609	.	A	T	11	13	24	0	0	24	0	0
6	19295625	.	T	A	9	12	21	0	2	23	0	0
6	19295644	.	C	T	0	12	12	0	10	22	0	0
6	19320696	.	C	T	2	2	4	0	4	8	0	0
6	19327380	.	C	T	2	2	4	0	0	4	0	0
6	19334899	.	A	G	4	4	8	0	0	8	0	0
6	19344846	.	C	T	4	7	11	0	1	12	0	0
6	19344862	.	T	C	9	3	12	0	0	12	0	0
6	19344930	.	G	C	5	4	9	0	0	9	0	0
6	19345191	.	G	A	3	4	7	1	0	8	0	0
6	19715552	.	G	A	0	2	2	0	5	7	0	0
6	19802042	.	T	C	9	5	14	0	0	14	0	0
6	19802145	.	G	T	1	4	5	0	13	18	0	0
6	19802148	.	C	A	14	4	18	0	1	19	0	0
6	19802242	.	C	T	15	5	20	0	3	23	0	0
6	19802330	.	G	A	11	8	19	0	1	20	0	0
6	19802354	.	G	A	8	10	18	0	0	18	0	0
6	19802415	.	G	A	0	8	8	0	6	14	0	0
6	19804702	.	A	C	6	7	13	0	1	14	0	0
6	19804878	.	C	T	2	4	6	0	0	6	0	0
6	19806990	.	C	T	1	1	2	0	1	3	0	0
6	20766299	.	G	A	23	16	39	0	1	40	0	0
6	20766307	.	A	G	17	21	38	0	0	38	0	0
6	20766352	.	C	T	18	15	33	0	1	34	0	0
6	20766500	.	G	T	9	5	14	0	0	14	0	0
6	20766565	.	C	G	0	14	14	0	15	29	0	0
6	20767015	.	T	A	17	16	33	0	0	33	0	0
6	20767167	.	C	A	5	5	10	0	0	10	0	0
6	20767502	.	A	G	9	23	32	0	1	33	0	0
6	20767575	.	G	C	12	0	12	0	19	31	0	0
6	20767830	.	T	G	9	5	14	0	1	15	0	0
6	20767910	.	A	G	1	2	3	0	0	3	0	0
6	20767958	.	T	G	6	6	12	0	0	12	0	0
6	20768107	.	A	T	11	3	14	1	5	20	0	0
6	20768338	.	G	A	8	10	18	0	0	18	0	0
6	20768346	.	T	G	8	9	17	0	0	17	0	0
6	20768407	.	A	T	4	7	11	0	0	11	0	0
6	20773961	.	G	A	8	5	13	0	0	13	0	0
6	20774048	.	A	C	3	7	10	0	1	11	0	0
6	20774701	.	G	A	3	5	8	0	0	8	0	0
6	20774752	.	G	A	3	3	6	0	0	6	0	0
6	20917730	.	A	T	2	2	4	0	0	4	0	0
6	20917780	.	T	A	2	2	4	0	0	4	0	0
6	20917991	.	A	T	0	2	2	0	2	4	0	0
6	20917994	.	C	T	1	2	3	0	0	4	1	0
6	20921859	.	G	A	6	4	10	0	0	10	0	0
6	20921919	.	G	A	5	8	13	0	0	13	0	0
6	20922271	.	G	T	5	5	10	0	1	11	0	0
6	20922316	.	G	C	3	0	3	0	6	9	0	0
6	20922330	.	G	A	2	6	8	0	0	8	0	0
6	20922396	.	G	A	3	6	9	0	0	9	0	0
6	20965723	.	G	A	0	4	4	0	1	5	0	0
6	20965780	.	A	G	1	0	1	0	4	5	0	0
6	20965855	.	A	G	5	4	9	0	0	9	0	0
6	20965921	.	A	T	2	2	4	0	0	4	0	0
6	20965922	.	A	T	2	2	4	0	0	4	0	0
6	20969124	.	A	T	3	2	5	0	1	6	0	0
6	20969126	.	G	T	4	2	6	0	0	6	0	0
6	20976263	.	A	G	2	2	4	0	0	4	0	0
6	20979015	.	C	T	1	4	5	0	1	6	0	0
6	20986906	.	C	G	4	0	4	0	6	10	0	0
6	20997031	.	A	T	15	4	19	0	0	19	0	0
6	20997166	.	C	T	5	8	13	0	2	15	0	0
6	20997529	.	A	T	0	4	4	0	1	5	0	0
6	21146252	.	C	T	4	3	7	0	0	7	0	0
6	21146648	.	G	A	3	4	7	0	2	9	0	0
6	21147837	.	A	G	3	2	5	0	0	5	0	0
6	21147920	.	A	C	3	2	5	0	0	5	0	0
6	21148166	.	A	T	3	4	7	0	0	7	0	0
6	21148167	.	T	C	3	4	7	0	0	7	0	0
6	21148289	.	A	G	3	2	5	0	0	5	0	0
6	21150672	.	G	A	10	5	15	0	1	16	0	0
6	21150712	.	A	T	8	5	13	0	0	13	0	0
6	21150772	.	A	T	11	7	18	0	2	20	0	0
6	21150872	.	C	T	8	17	25	0	4	29	0	0
6	21151664	.	T	G	9	6	15	0	1	16	0	0
6	21151751	.	C	T	16	8	24	0	0	24	0	0
6	21390653	.	G	T	1	2	3	0	0	3	0	0
6	21390667	.	A	T	1	2	3	0	0	3	0	0
6	21392049	.	A	T	1	3	4	0	0	4	0	0
6	21392057	.	C	A	1	2	3	0	0	3	0	0
6	21454984	.	C	A	2	3	5	0	0	5	0	0
6	21455532	.	A	T	1	2	3	0	1	4	0	0
6	21455548	.	A	T	1	3	4	0	0	4	0	0
6	21513767	.	G	T	4	4	8	0	1	9	0	0
6	21513778	.	A	G	4	6	10	0	0	10	0	0
6	21513826	.	C	A	2	5	7	0	0	7	0	0
6	21513968	.	G	A	1	4	5	0	0	5	0	0
6	21514651	.	G	T	4	2	6	0	0	6	0	0
6	21514961	.	C	T	0	2	2	0	2	4	0	0
6	21515100	.	C	T	1	2	3	0	0	3	0	0
6	21526395	.	A	G	7	13	20	0	0	20	0	0
6	21526620	.	T	C	10	6	16	0	0	16	0	0
6	21526783	.	G	A	13	6	19	0	1	20	0	0
6	21529229	.	A	G	3	5	8	0	0	8	0	0
6	21529379	.	A	T	12	7	19	0	1	20	0	0
6	21529767	.	A	T	6	3	9	0	0	9	0	0
6	21532427	.	T	C	1	0	1	0	6	7	0	0
6	21588285	.	C	T	11	9	20	0	0	20	0	0
6	21588516	.	G	A	8	4	12	1	0	13	0	0
6	21589102	.	A	G	3	4	7	0	0	7	0	0
6	21589103	.	G	A	3	3	6	0	1	7	0	0
6	21589325	.	C	T	0	2	2	0	1	3	0	0
6	21589344	.	A	G	3	1	4	0	0	4	0	0
6	21596632	.	A	G	8	6	14	0	0	14	0	0
6	21602529	.	T	A	10	8	18	0	0	18	0	0
6	21602679	.	T	G	4	7	11	0	0	11	0	0
6	21602849	.	C	A	2	4	6	0	0	6	0	0
6	21615621	.	T	A	3	2	5	0	2	7	0	0
6	21693589	.	G	T	0	3	3	0	4	7	0	0
6	21693969	.	C	T	1	2	3	0	0	3	0	0
6	21694306	.	G	A	9	4	13	0	1	14	0	0
6	21694401	.	C	A	9	7	16	0	1	17	0	0
6	21694544	.	A	G	5	2	7	0	4	11	0	0
6	21699249	.	A	T	3	2	5	0	0	5	0	0
6	21699689	.	A	T	3	2	5	0	0	5	0	0
6	21699902	.	A	G	1	3	4	0	0	4	0	0
6	21700062	.	T	C	1	3	4	0	0	4	0	0
6	21700138	.	G	A	5	4	9	0	1	10	0	0
6	21700212	.	A	G	4	3	7	0	0	7	0	0
6	21700263	.	A	G	4	6	10	0	1	11	0	0
6	21861324	.	G	T	19	20	39	0	2	41	0	0
6	21861490	.	C	A	1	24	25	0	20	45	0	0
6	21861526	.	T	G	17	16	33	0	1	34	0	0
6	21861736	.	T	G	3	2	5	0	1	6	0	0
6	21861771	.	G	A	9	4	13	0	0	13	0	0
6	21861949	.	G	A	21	18	39	0	3	42	0	0
6	21862288	.	G	A	17	19	36	0	1	37	0	0
6	21862359	.	A	T	21	16	37	0	1	38	0	0
6	21862460	.	A	G	24	11	35	0	0	35	0	0
6	21871928	.	T	C	13	14	27	0	0	27	0	0
6	21871931	.	G	T	12	15	27	0	1	28	0	0
6	21875429	.	A	C	1	5	6	0	0	6	0	0
6	21875741	.	G	T	7	4	11	0	0	11	0	0
6	21876006	.	G	A	3	6	9	0	0	9	0	0
6	21876182	.	T	C	5	6	11	0	0	11	0	0
6	21876183	.	T	C	3	8	11	0	0	11	0	0
6	21876852	.	C	T	0	7	7	0	6	13	0	0
6	22026339	.	T	A	1	2	3	0	0	3	0	0
6	22026431	.	G	C	2	3	5	0	0	5	0	0
6	22026440	.	G	A	3	2	5	0	0	5	0	0
6	22026825	.	C	A	1	2	3	0	0	3	0	0
6	22028009	.	A	T	4	2	6	0	0	6	0	0
6	22030296	.	G	A	2	3	5	0	0	5	0	0
6	22034802	.	A	G	8	7	15	0	1	16	0	0
6	22034961	.	A	C	5	4	9	0	1	10	0	0
6	22034985	.	A	C	4	3	7	0	0	7	0	0
6	22035352	.	A	G	5	7	12	0	2	14	0	0
6	22035426	.	A	G	8	10	18	0	1	19	0	0
6	22035534	.	G	A	8	7	15	0	0	15	0	0
6	22037715	.	A	T	7	11	18	0	0	18	0	0
6	22037743	.	C	T	5	13	18	0	0	18	0	0
6	22053067	.	C	T	1	4	5	0	1	6	0	0
6	22090275	.	T	C	1	3	4	0	0	4	0	0
6	22093501	.	A	G	1	2	3	0	0	3	0	0
6	22093683	.	T	G	2	0	2	0	2	4	0	0
6	22093707	.	A	G	2	2	4	0	0	4	0	0
6	22105062	.	A	T	2	2	4	0	0	4	0	0
6	22105071	.	G	A	2	2	4	0	0	4	0	0
6	22105554	.	A	G	1	3	4	0	1	5	0	0
6	22112395	.	A	G	4	0	4	0	6	10	0	0
6	22112416	.	C	T	9	5	14	0	1	15	0	0
6	22118165	.	T	C	13	24	37	0	0	37	0	0
6	22118216	.	G	A	18	29	47	0	2	49	0	0
6	22118630	.	G	A	27	20	47	4	1	52	0	0
6	22118681	.	C	T	11	15	26	0	1	27	0	0
6	22118690	.	C	T	13	9	22	0	1	24	1	0
6	22118885	.	T	G	27	0	27	2	21	50	0	0
6	22119056	.	C	T	21	39	60	0	3	63	0	0
6	22119582	.	T	C	24	17	41	0	1	42	0	0
6	22119836	.	T	A	7	6	13	0	2	15	0	0
6	22119977	.	T	A	26	15	41	0	0	41	0	0
6	22120074	.	C	T	13	13	26	0	0	26	0	0
6	22120342	.	T	A	8	3	11	0	1	12	0	0
6	22120877	.	A	G	3	5	8	0	1	9	0	0
6	22127197	.	A	G	2	2	4	0	2	6	0	0
6	22128520	.	G	A	2	2	4	0	0	4	0	0
6	22330400	.	A	T	18	14	32	0	0	32	0	0
6	22338938	.	A	G	5	9	14	0	2	16	0	0
6	22344003	.	A	T	8	4	12	0	0	12	0	0
6	22344452	.	C	T	9	13	22	0	0	22	0	0
6	22347259	.	G	A	16	11	27	0	0	27	0	0
6	22348271	.	T	A	13	22	35	0	1	36	0	0
6	22348274	.	G	C	12	22	34	0	2	36	0	0
6	22351770	.	A	C	28	28	56	0	2	58	0	0
6	22352229	.	T	C	3	18	21	0	2	23	0	0
6	22352370	.	C	T	4	6	10	0	1	11	0	0
6	22354738	.	C	A	5	6	11	0	1	12	0	0
6	22355040	.	T	C	0	1	1	0	4	5	0	0
6	22628997	.	T	G	5	0	5	0	7	12	0	0
6	22683308	.	A	G	2	3	5	0	1	6	0	0
6	22683362	.	A	G	4	4	8	0	0	8	0	0
6	22986242	.	T	G	1	3	4	0	1	5	0	0
6	22998625	.	A	G	1	3	4	0	0	4	0	0
6	22998653	.	C	A	3	2	5	0	0	5	0	0
6	23001704	.	C	T	1	3	4	0	0	4	0	0
6	23018861	.	G	A	5	3	8	0	0	8	0	0
6	23053296	.	A	G	7	4	11	0	1	12	0	0
6	23053393	.	C	A	9	9	18	0	0	18	0	0
6	23053482	.	G	C	10	7	17	0	0	17	0	0
6	23053761	.	A	G	3	6	9	0	1	10	0	0
6	23053824	.	T	C	4	10	14	0	1	15	0	0
6	23053968	.	A	G	12	7	19	0	0	19	0	0
6	23053980	.	A	T	14	8	22	0	0	22	0	0
6	23054266	.	C	T	17	14	31	0	3	34	0	0
6	23054334	.	A	T	20	12	32	0	2	34	0	0
6	23054404	.	A	G	11	9	20	0	1	21	0	0
6	23054569	.	C	T	7	10	17	0	6	23	0	0
6	23054705	.	A	G	4	1	5	0	11	16	0	0
6	23055478	.	T	C	3	2	5	0	0	5	0	0
6	23128699	.	C	T	1	2	3	0	0	3	0	0
6	23778255	.	G	A	3	8	11	0	0	11	0	0
6	23781314	.	C	T	6	6	12	0	0	12	0	0
6	23810922	.	G	C	4	4	8	0	0	8	0	0
6	23811154	.	C	T	6	5	11	0	0	11	0	0
6	23812885	.	T	C	4	7	11	0	1	12	0	0
6	23813361	.	G	A	0	5	5	0	12	17	0	0
6	23813437	.	G	C	12	6	18	0	0	18	0	0
6	23813554	.	C	A	7	14	21	0	1	22	0	0
6	23938676	.	A	C	8	5	13	0	0	13	0	0
6	23938738	.	A	G	6	5	11	0	1	12	0	0
6	23938829	.	G	A	9	4	13	0	1	14	0	0
6	24056103	.	C	T	0	9	9	0	6	15	0	0
6	24056319	.	T	C	5	5	10	0	1	11	0	0
6	24065975	.	C	G	1	3	4	0	4	8	0	0
6	24066296	.	G	A	5	2	7	0	1	8	0	0
6	24066382	.	T	A	3	4	7	0	0	7	0	0
6	24066611	.	G	A	2	5	7	0	0	7	0	0
6	24153075	.	G	A	18	35	53	0	1	54	0	0
6	24153114	.	A	G	22	27	49	0	1	50	0	0
6	24153159	.	C	T	22	19	41	0	3	44	0	0
6	24153297	.	T	C	28	27	55	0	0	55	0	0
6	24155357	.	C	T	16	16	32	0	2	34	0	0
6	24155442	.	A	T	19	9	28	0	1	29	0	0
6	24155459	.	T	G	17	9	26	0	0	26	0	0
6	24155744	.	T	C	5	10	15	0	0	15	0	0
6	24156027	.	T	C	16	5	21	0	0	21	0	0
6	24156219	.	T	C	8	0	8	0	8	16	0	0
6	24156344	.	T	G	4	2	6	0	1	7	0	0
6	24156399	.	C	G	4	7	11	0	0	11	0	0
6	24156428	.	A	T	6	9	15	0	0	15	0	0
6	24156476	.	T	G	4	4	8	0	0	8	0	0
6	24156567	.	T	C	3	0	3	0	6	9	0	0
6	24157177	.	C	T	2	2	4	0	1	5	0	0
6	24330029	.	C	T	15	10	25	0	0	25	0	0
6	24330196	.	G	A	23	22	45	0	0	45	0	0
6	24330229	.	G	A	16	13	29	0	0	29	0	0
6	24338496	.	T	A	14	13	27	0	0	27	0	0
6	24338526	.	G	A	8	10	18	0	0	18	0	0
6	24340631	.	G	A	7	6	13	0	1	14	0	0
6	24340688	.	G	T	4	8	12	0	0	12	0	0
6	24358323	.	A	T	3	2	5	0	1	6	0	0
6	24358596	.	G	A	3	4	7	0	0	7	0	0
6	24358720	.	C	T	1	4	5	0	1	6	0	0
6	24364750	.	C	T	4	4	8	0	0	8	0	0
6	24364878	.	G	T	6	4	10	0	2	12	0	0
6	24365102	.	C	G	4	9	13	0	0	13	0	0
6	24365276	.	C	A	10	11	21	0	0	21	0	0
6	24365453	.	G	A	6	8	14	0	2	16	0	0
6	24365482	.	C	A	6	7	13	0	0	13	0	0
6	24365838	.	G	A	10	7	17	0	0	17	0	0
6	24384613	.	T	C	6	5	11	0	0	11	0	0
6	24392318	.	C	T	4	4	8	0	0	8	0	0
6	24392562	.	T	C	8	0	8	0	6	14	0	0
6	24682720	.	T	A	1	4	5	0	1	6	0	0
6	24682913	.	A	T	4	4	8	0	0	8	0	0
6	24682950	.	G	A	2	5	7	0	0	7	0	0
6	24683723	.	A	T	4	4	8	0	0	8	0	0
6	24690886	.	A	G	3	4	7	0	0	7	0	0
6	24691366	.	C	T	5	12	17	0	0	17	0	0
6	24691718	.	A	T	5	4	9	0	1	10	0	0
6	24691845	.	A	T	9	7	16	0	0	16	0	0
6	24692307	.	A	G	8	7	15	0	0	15	0	0
6	24697891	.	T	G	8	4	12	0	1	13	0	0
6	24698036	.	A	G	7	0	7	0	3	10	0	0
6	24818037	.	G	T	4	2	6	0	1	7	0	0
6	24821631	.	G	A	6	5	11	0	0	11	0	0
6	25168647	.	G	C	15	5	20	0	0	20	0	0
6	25169241	.	A	T	2	3	5	0	0	5	0	0
6	25169385	.	T	A	2	2	4	0	0	4	0	0
6	25170438	.	T	C	4	2	6	0	0	6	0	0
6	25170579	.	A	G	1	4	5	0	0	5	0	0
6	25171100	.	A	G	1	3	4	0	0	4	0	0
6	25171285	.	A	G	3	2	5	0	0	5	0	0
6	25264512	.	C	T	5	2	7	0	1	8	0	0
6	25265306	.	G	A	5	2	7	2	0	9	0	0
6	25265479	.	C	T	2	2	4	2	0	6	0	0
6	25314577	.	T	A	2	5	7	0	1	8	0	0
6	25315051	.	A	G	2	3	5	0	0	5	0	0
6	26892028	.	C	T	0	2	2	0	2	4	0	0
6	27088476	.	C	T	1	2	3	0	1	4	0	0
6	27234250	.	C	T	3	6	9	0	0	9	0	0
6	27265350	.	T	C	4	3	7	0	0	7	0	0
6	27265434	.	C	T	8	6	14	0	0	14	0	0
6	27269268	.	G	A	2	8	10	0	1	11	0	0
6	27269425	.	G	A	2	10	12	0	4	16	0	0
6	27269612	.	T	A	3	11	14	0	0	14	0	0
6	27269662	.	A	T	6	9	15	0	1	16	0	0
6	27269674	.	C	T	5	10	15	0	0	15	0	0
6	27269862	.	G	A	0	8	8	0	5	13	0	0
6	27269902	.	T	A	6	6	12	0	0	12	0	0
6	27270288	.	A	C	8	5	13	0	1	14	0	0
6	27270548	.	G	A	8	11	19	0	1	20	0	0
6	27270664	.	T	A	12	11	23	0	3	26	0	0
6	27270738	.	A	G	8	0	8	0	9	17	0	0
6	27270959	.	C	A	7	2	9	0	1	10	0	0
6	27271114	.	A	G	20	0	20	0	16	36	0	0
6	27271115	.	A	T	19	16	35	0	1	36	0	0
6	27271208	.	A	G	17	1	18	0	13	31	0	0
6	27271409	.	G	A	17	11	28	0	1	29	0	0
6	27271443	.	G	A	15	15	30	0	2	32	0	0
6	27271610	.	A	T	9	20	29	0	0	29	0	0
6	27271617	.	G	A	9	17	26	0	2	28	0	0
6	27272081	.	T	C	28	25	53	0	1	54	0	0
6	27272205	.	G	C	16	25	41	0	1	42	0	0
6	27272364	.	T	A	15	16	31	0	2	33	0	0
6	27272373	.	A	T	11	17	28	0	0	28	0	0
6	27272440	.	C	T	11	24	35	0	0	35	0	0
6	27272555	.	T	C	16	38	54	0	0	54	0	0
6	27272623	.	A	G	20	29	49	0	3	52	0	0
6	27272660	.	C	G	19	30	49	0	1	50	0	0
6	27272835	.	G	T	20	17	37	0	1	38	0	0
6	27574439	.	C	G	3	2	5	0	0	5	0	0
6	27574472	.	G	A	2	2	4	0	1	5	0	0
6	27607528	.	C	T	1	3	4	0	0	4	0	0
6	27614446	.	T	C	4	5	9	0	0	9	0	0
6	27615210	.	G	A	0	3	3	0	4	7	0	0
6	27615242	.	A	C	2	2	4	0	0	4	0	0
6	27667378	.	C	A	4	5	9	0	0	9	0	0
6	27775416	.	T	A	4	8	12	0	2	14	0	0
6	27816260	.	T	C	6	7	13	0	0	13	0	0
6	27874309	.	T	C	6	7	13	0	1	14	0	0
6	27874487	.	G	A	21	11	32	0	6	38	0	0
6	27874529	.	G	A	3	23	26	0	14	40	0	0
6	27874591	.	T	A	20	19	39	0	2	41	0	0
6	27875383	.	G	T	30	22	52	0	1	53	0	0
6	27875519	.	G	T	36	22	58	1	1	60	0	0
6	27875555	.	C	T	25	37	62	1	3	66	0	0
6	27875598	.	T	C	0	42	42	0	0	43	1	0
6	27875876	.	T	G	23	20	43	0	3	46	0	0
6	27875941	.	C	G	26	27	53	0	2	55	0	0
6	27875944	.	G	A	5	28	33	0	23	56	0	0
6	27876503	.	G	A	1	2	3	0	0	3	0	0
6	27922994	.	A	T	2	2	4	0	0	4	0	0
6	27922995	.	G	A	2	1	3	0	1	4	0	0
6	27998329	.	C	A	1	4	5	0	0	5	0	0
6	28000316	.	G	A	0	8	8	0	6	14	0	0
6	28000535	.	T	C	5	2	7	0	0	7	0	0
6	28000768	.	G	T	2	8	10	0	0	10	0	0
6	28033036	.	C	T	1	2	3	0	0	3	0	0
6	28038882	.	C	G	6	5	11	0	0	11	0	0
6	28044308	.	C	T	5	6	11	0	0	11	0	0
6	28044398	.	C	T	8	4	12	0	1	13	0	0
6	28044401	.	A	G	4	9	13	0	0	13	0	0
6	28048870	.	C	T	2	5	7	1	1	9	0	0
6	28048923	.	C	A	4	2	6	0	2	8	0	0
6	28049173	.	A	C	4	4	8	0	0	8	0	0
6	28049185	.	G	A	0	5	5	0	5	10	0	0
6	28206112	.	C	T	8	8	16	0	0	16	0	0
6	28206124	.	T	C	8	8	16	0	1	17	0	0
6	28207532	.	C	A	3	4	7	0	0	7	0	0
6	28207534	.	A	G	3	4	7	0	0	7	0	0
6	28209026	.	T	G	1	2	3	0	0	3	0	0
6	28216496	.	G	A	9	2	11	0	1	12	0	0
6	28216535	.	C	T	17	10	27	0	1	28	0	0
6	28217058	.	C	G	3	11	14	0	1	15	0	0
6	28217103	.	T	C	4	2	6	0	5	11	0	0
6	28217674	.	T	C	8	0	8	1	4	13	0	0
6	28218159	.	G	T	5	2	7	0	1	8	0	0
6	28218367	.	G	A	3	4	7	0	0	7	0	0
6	28218555	.	T	G	3	3	6	0	0	6	0	0
6	28223683	.	G	C	1	3	4	0	0	4	0	0
6	28223707	.	C	A	1	3	4	0	0	4	0	0
6	28223731	.	A	T	1	2	3	0	0	3	0	0
6	28224481	.	A	T	1	2	3	0	0	3	0	0
6	28914336	.	C	T	5	5	10	0	0	10	0	0
6	28914790	.	G	A	15	12	27	0	1	28	0	0
6	28914975	.	T	A	10	8	18	0	2	20	0	0
6	28915342	.	T	G	7	4	11	0	0	11	0	0
6	28931649	.	A	G	2	2	4	0	0	4	0	0
6	28946048	.	A	T	10	10	20	0	2	22	0	0
6	28956350	.	T	A	6	6	12	0	0	12	0	0
6	28957820	.	G	T	1	2	3	0	0	3	0	0
6	28961407	.	A	G	3	4	7	0	0	7	0	0
6	28971956	.	T	C	1	2	3	0	0	3	0	0
6	29011988	.	C	T	9	5	14	0	0	14	0	0
6	29012037	.	A	T	9	6	15	0	1	16	0	0
6	29034576	.	G	C	3	7	10	0	0	10	0	0
6	29039981	.	A	C	6	0	6	0	8	14	0	0
6	29040066	.	A	C	3	11	14	0	0	14	0	0
6	29040789	.	C	T	1	2	3	0	3	6	0	0
6	29040870	.	C	T	0	5	5	1	2	8	0	0
6	29040885	.	C	T	0	3	3	1	5	9	0	0
6	29043162	.	T	G	1	2	3	0	0	3	0	0
6	29044900	.	G	A	2	2	4	0	0	4	0	0
6	29086676	.	A	T	30	23	53	0	1	54	0	0
6	29089480	.	T	A	30	29	59	0	2	61	0	0
6	29096659	.	A	C	32	31	63	0	6	69	0	0
6	29103470	.	T	C	1	3	4	0	1	5	0	0
6	29147764	.	C	T	6	4	10	0	0	10	0	0
6	29152208	.	C	T	7	7	14	0	0	14	0	0
6	29152334	.	G	A	5	4	9	0	0	9	0	0
6	29152669	.	A	G	5	2	7	0	0	7	0	0
6	29152769	.	G	A	4	2	6	0	0	6	0	0
6	29154889	.	C	A	1	2	3	0	1	4	0	0
6	29158227	.	T	C	1	2	3	0	0	3	0	0
6	29226070	.	G	C	4	3	7	0	0	7	0	0
6	29226077	.	A	C	4	3	7	0	0	7	0	0
6	29226186	.	A	G	10	5	15	0	0	15	0	0
6	29226189	.	C	T	6	10	16	0	0	16	0	0
6	29226767	.	A	T	11	12	23	0	0	23	0	0
6	29226790	.	G	A	8	15	23	0	1	24	0	0
6	29226823	.	A	C	7	17	24	0	0	24	0	0
6	29227149	.	A	G	18	12	30	0	7	44	7	0
6	29227555	.	T	C	3	7	10	0	2	12	0	0
6	29258214	.	T	A	7	10	17	0	0	17	0	0
6	29278868	.	T	G	2	3	5	0	0	5	0	0
6	29278874	.	G	A	2	4	6	0	0	6	0	0
6	29289411	.	G	A	0	3	3	0	2	5	0	0
6	29289905	.	G	A	2	2	4	0	0	4	0	0
6	29291606	.	C	T	6	5	11	0	0	11	0	0
6	29291614	.	T	C	6	5	11	0	0	11	0	0
6	29291666	.	G	A	6	5	11	0	0	11	0	0
6	29295492	.	T	A	8	8	16	0	1	17	0	0
6	29295517	.	G	C	10	9	19	0	1	20	0	0
6	29295535	.	T	A	7	6	13	0	5	18	0	0
6	29295714	.	G	A	4	4	8	0	0	8	0	0
6	29295851	.	G	A	7	4	11	0	0	11	0	0
6	29295860	.	C	T	7	4	11	0	0	11	0	0
6	29297379	.	G	T	3	3	6	0	0	6	0	0
6	29303630	.	G	A	1	2	3	0	0	3	0	0
6	29303778	.	C	T	0	3	3	0	4	7	0	0
6	29313312	.	C	A	4	9	13	0	0	13	0	0
6	29313607	.	A	T	10	13	23	0	1	24	0	0
6	29313679	.	A	G	8	7	15	0	3	18	0	0
6	29322029	.	T	C	2	0	2	0	9	11	0	0
6	29322595	.	C	G	6	6	12	0	1	13	0	0
6	29343892	.	G	A	1	2	3	0	0	3	0	0
6	29387493	.	G	A	2	3	5	0	0	5	0	0
6	29391718	.	T	C	3	4	7	0	0	7	0	0
6	29393533	.	T	A	6	6	12	0	2	14	0	0
6	29393714	.	C	T	6	9	15	0	0	15	0	0
6	29395297	.	C	T	15	13	28	0	0	28	0	0
6	29395424	.	G	A	11	18	29	0	0	29	0	0
6	29395497	.	T	A	18	9	27	0	0	27	0	0
6	29395592	.	T	A	1	3	4	0	1	5	0	0
6	29397697	.	G	A	13	9	22	0	0	22	0	0
6	29402220	.	C	T	4	8	12	0	2	14	0	0
6	29403052	.	G	T	0	9	9	0	7	16	0	0
6	29403550	.	G	A	15	12	27	0	1	28	0	0
6	29404094	.	T	C	24	29	53	0	3	56	0	0
6	29410040	.	C	T	2	3	5	0	0	5	0	0
6	29466968	.	G	T	3	2	5	0	0	5	0	0
6	29466993	.	T	A	2	2	4	0	0	4	0	0
6	29467159	.	G	C	1	3	4	0	0	4	0	0
6	29703526	.	C	T	1	3	4	0	0	4	0	0
6	29703846	.	A	C	7	6	13	0	0	13	0	0
6	29703865	.	A	T	9	7	16	0	0	16	0	0
6	29705597	.	T	C	13	2	15	0	0	15	0	0
6	29705614	.	G	A	2	7	9	0	3	12	0	0
6	29705767	.	A	G	10	13	23	0	1	24	0	0
6	29705901	.	T	C	2	3	5	0	1	6	0	0
6	29705932	.	T	C	1	2	3	0	0	3	0	0
6	29708010	.	T	C	3	7	10	0	1	11	0	0
6	29708073	.	A	C	5	5	10	0	1	11	0	0
6	29710111	.	C	T	3	4	7	0	0	7	0	0
6	29710157	.	A	G	4	0	4	0	5	9	0	0
6	29710216	.	C	T	5	5	10	0	0	10	0	0
6	29710927	.	G	A	4	3	7	0	0	7	0	0
6	29712470	.	T	C	3	7	10	0	1	11	0	0
6	29712651	.	G	A	5	13	18	0	3	21	0	0
6	29713920	.	G	T	11	2	13	0	1	14	0	0
6	29713926	.	T	C	12	7	19	0	1	20	0	0
6	29714017	.	A	G	4	6	10	0	1	11	0	0
6	29714054	.	A	C	2	3	5	0	1	6	0	0
6	29714064	.	C	T	2	2	4	0	0	4	0	0
6	29714171	.	A	G	1	3	4	0	0	4	0	0
6	29714190	.	A	G	1	2	3	0	1	4	0	0
6	29791206	.	C	G	9	8	17	0	1	18	0	0
6	29791310	.	A	C	41	28	69	0	0	69	0	0
6	29793798	.	C	A	27	46	73	0	2	75	0	0
6	29794003	.	T	G	31	40	71	0	2	73	0	0
6	29794639	.	T	C	37	26	63	1	4	68	0	0
6	30027896	.	C	A	11	8	19	0	0	19	0	0
6	30048421	.	G	A	0	9	9	0	4	13	0	0
6	30052061	.	C	A	14	14	28	0	1	29	0	0
6	30052085	.	A	G	18	14	32	0	2	34	0	0
6	30066414	.	A	T	4	4	8	0	1	9	0	0
6	30082255	.	G	A	6	9	15	0	1	16	0	0
6	30082752	.	T	G	29	22	51	2	1	54	0	0
6	30113800	.	C	T	2	2	4	0	0	4	0	0
6	30121872	.	G	T	8	6	14	0	0	14	0	0
6	30122248	.	A	T	5	5	10	0	1	11	0	0
6	30124575	.	C	T	13	12	25	0	2	27	0	0
6	30134052	.	C	T	4	5	9	0	22	31	0	0
6	30147219	.	G	A	7	13	20	0	1	21	0	0
6	30147249	.	T	C	14	1	15	0	8	23	0	0
6	30147831	.	C	T	6	2	8	0	3	11	0	0
6	30148056	.	A	T	4	4	8	0	1	9	0	0
6	30148143	.	G	A	1	4	5	0	0	5	0	0
6	30148422	.	C	T	3	2	5	0	1	6	0	0
6	30151537	.	G	A	2	3	5	0	0	5	0	0
6	30441333	.	G	A	1	3	4	0	0	4	0	0
6	30450458	.	T	C	1	2	3	0	0	3	0	0
6	30450464	.	G	A	1	2	3	0	0	3	0	0
6	30452316	.	T	C	5	3	8	0	2	10	0	0
6	30452811	.	C	T	3	2	5	0	0	5	0	0
6	30452843	.	G	T	2	2	4	0	1	5	0	0
6	30626227	.	A	G	15	14	29	0	4	33	0	0
6	30626240	.	A	T	16	14	30	0	3	33	0	0
6	30626276	.	T	C	19	9	28	0	2	30	0	0
6	30626715	.	T	G	14	7	21	0	0	21	0	0
6	30626765	.	C	T	11	9	20	0	2	22	0	0
6	30626908	.	G	A	8	4	12	0	0	12	0	0
6	30626931	.	T	C	4	3	7	0	1	8	0	0
6	30626944	.	A	T	7	2	9	0	0	9	0	0
6	30627292	.	T	C	17	16	33	0	4	37	0	0
6	30627433	.	A	T	16	10	26	1	0	27	0	0
6	30627549	.	G	A	13	7	20	0	1	21	0	0
6	30627605	.	G	C	21	10	31	0	1	32	0	0
6	30627606	.	A	C	22	0	22	0	11	33	0	0
6	30627660	.	A	C	17	8	25	0	2	27	0	0
6	30627714	.	C	T	0	12	12	0	16	28	0	0
6	30627724	.	A	T	18	10	28	0	3	31	0	0
6	30627807	.	G	T	15	6	21	0	1	22	0	0
6	30627914	.	T	C	8	8	16	0	0	16	0	0
6	30627921	.	G	T	8	8	16	0	0	16	0	0
6	30627996	.	A	C	3	0	3	0	2	5	0	0
6	30627998	.	T	C	3	0	3	0	2	5	0	0
6	30628066	.	T	C	9	5	14	0	0	14	0	0
6	30628170	.	T	C	4	5	9	0	0	9	0	0
6	30628185	.	G	A	4	4	8	0	1	9	0	0
6	30628228	.	A	G	3	5	8	0	1	9	0	0
6	30628447	.	G	A	1	4	5	0	0	5	0	0
6	30628459	.	A	G	1	3	4	0	0	4	0	0
6	30628540	.	T	C	3	0	3	0	3	6	0	0
6	30628651	.	G	A	2	8	10	0	0	10	0	0
6	30628684	.	C	A	6	4	10	0	1	11	0	0
6	30628978	.	C	T	5	2	7	0	1	8	0	0
6	30629627	.	A	G	3	4	7	0	2	9	0	0
6	30629656	.	T	G	3	2	5	0	0	5	0	0
6	30629850	.	G	C	1	2	3	0	0	3	0	0
6	30630438	.	G	A	2	3	5	0	0	5	0	0
6	30630454	.	T	G	2	3	5	0	0	5	0	0
6	30677445	.	G	C	7	4	11	0	1	12	0	0
6	30677654	.	A	C	3	4	7	0	1	8	0	0
6	30678279	.	T	G	4	4	8	0	0	8	0	0
6	30678396	.	T	C	2	4	6	0	0	6	0	0
6	30685044	.	A	G	5	2	7	0	0	7	0	0
6	30685527	.	T	C	1	3	4	0	0	4	0	0
6	30685544	.	A	G	2	2	4	0	0	4	0	0
6	30687858	.	T	C	2	2	4	0	0	4	0	0
6	30710270	.	A	G	24	31	55	0	2	57	0	0
6	30710342	.	T	G	23	29	52	0	2	54	0	0
6	30710351	.	G	T	20	31	51	0	1	52	0	0
6	30710547	.	T	C	12	13	25	0	0	25	0	0
6	30710591	.	G	A	6	4	10	0	1	11	0	0
6	30710886	.	A	G	1	2	3	0	0	3	0	0
6	30711407	.	T	C	1	2	3	0	1	4	0	0
6	30711409	.	T	C	2	2	4	0	0	4	0	0
6	30711447	.	C	T	2	3	5	0	1	6	0	0
6	30711485	.	A	T	11	10	21	0	0	21	0	0
6	30711511	.	C	T	18	10	28	0	1	29	0	0
6	30711586	.	A	C	19	0	19	0	16	35	0	0
6	30711612	.	G	A	12	18	30	0	2	32	0	0
6	30711851	.	T	C	11	9	20	0	0	20	0	0
6	30711852	.	A	T	11	8	19	0	1	20	0	0
6	30711948	.	A	G	18	8	26	0	1	27	0	0
6	30711957	.	T	C	16	11	27	0	1	28	0	0
6	30712121	.	G	T	13	10	23	0	3	26	0	0
6	30712265	.	T	C	13	11	24	0	0	24	0	0
6	30712455	.	A	T	4	5	9	0	1	10	0	0
6	30712458	.	A	G	5	5	10	0	0	10	0	0
6	30713184	.	T	A	2	3	5	0	0	5	0	0
6	30713296	.	C	T	5	9	14	0	0	14	0	0
6	30713341	.	G	A	4	6	10	0	3	13	0	0
6	30713666	.	T	C	2	6	8	0	0	8	0	0
6	30713724	.	C	T	4	2	6	0	0	6	0	0
6	30713725	.	A	T	5	2	7	0	0	7	0	0
6	30713761	.	G	C	5	4	9	0	0	9	0	0
6	30713869	.	C	T	2	6	8	0	4	12	0	0
6	30713929	.	C	G	14	8	22	0	0	22	0	0
6	30715647	.	A	T	6	4	10	0	0	10	0	0
6	30715865	.	A	T	7	7	14	0	0	14	0	0
6	30717579	.	T	C	6	7	13	0	2	15	0	0
6	30717636	.	T	C	6	0	6	0	13	19	0	0
6	30719319	.	G	A	5	2	7	0	0	7	0	0
6	30719348	.	G	C	6	2	8	0	1	9	0	0
6	30719391	.	A	T	7	7	14	0	2	16	0	0
6	30721397	.	G	A	5	6	11	0	0	11	0	0
6	30742651	.	A	G	6	2	8	0	0	8	0	0
6	30853053	.	T	A	28	29	57	0	1	58	0	0
6	30859381	.	T	A	3	4	7	0	0	7	0	0
6	31184651	.	T	C	3	2	5	0	0	5	0	0
6	31185066	.	C	T	8	3	11	0	0	11	0	0
6	31185067	.	C	T	8	3	11	0	0	11	0	0
6	31185133	.	G	A	7	6	13	0	0	13	0	0
6	31185247	.	C	G	3	2	5	0	0	5	0	0
6	31185292	.	A	C	3	4	7	0	0	7	0	0
6	31185515	.	A	T	4	3	7	0	0	7	0	0
6	31185523	.	C	T	3	2	5	0	1	6	0	0
6	31280164	.	T	C	23	22	45	0	3	48	0	0
6	31280238	.	T	C	17	18	35	0	0	35	0	0
6	31280253	.	T	A	18	14	32	0	0	32	0	0
6	31280495	.	C	T	16	9	25	0	1	26	0	0
6	31280586	.	A	G	8	16	24	0	2	26	0	0
6	31280645	.	C	T	6	4	10	0	0	10	0	0
6	31280646	.	A	C	6	4	10	0	0	10	0	0
6	31280945	.	A	T	8	9	17	0	2	19	0	0
6	31281006	.	C	T	2	12	14	0	11	25	0	0
6	31281130	.	A	G	16	15	31	0	2	33	0	0
6	31281249	.	G	A	4	17	21	0	0	21	0	0
6	31281262	.	T	C	9	0	9	0	14	23	0	0
6	31281674	.	T	C	12	4	16	0	0	16	0	0
6	31281732	.	T	A	5	3	8	0	1	9	0	0
6	31281994	.	T	A	7	7	14	0	0	14	0	0
6	31282028	.	T	G	7	2	9	0	0	9	0	0
6	31282118	.	T	G	2	2	4	0	0	4	0	0
6	31282170	.	T	C	5	0	5	0	3	8	0	0
6	31282494	.	C	T	8	4	12	0	1	13	0	0
6	31283049	.	C	A	5	2	7	0	2	9	0	0
6	31283167	.	G	T	1	4	5	0	0	5	0	0
6	31283210	.	T	G	2	5	7	0	0	7	0	0
6	31283299	.	G	A	4	4	8	0	0	8	0	0
6	31285874	.	G	A	4	5	9	0	0	9	0	0
6	31288637	.	C	G	3	8	11	0	0	11	0	0
6	31288642	.	C	G	1	7	8	0	3	11	0	0
6	31288742	.	T	C	5	0	5	0	5	10	0	0
6	31288894	.	T	A	7	3	10	0	0	10	0	0
6	31336156	.	G	A	3	2	5	0	0	5	0	0
6	31352334	.	T	A	16	6	22	0	3	25	0	0
6	31352339	.	T	A	14	7	21	0	2	23	0	0
6	31352907	.	T	C	11	6	17	0	1	18	0	0
6	31352922	.	T	C	11	2	13	0	2	15	0	0
6	31352963	.	A	G	9	8	17	0	3	20	0	0
6	31353613	.	G	A	14	6	20	0	2	22	0	0
6	31417667	.	C	T	4	4	8	0	0	8	0	0
6	31426246	.	A	G	6	0	6	0	3	9	0	0
6	31426287	.	G	T	2	3	5	0	1	6	0	0
6	31426465	.	T	C	12	7	19	0	1	20	0	0
6	31426556	.	C	A	4	2	6	0	0	6	0	0
6	31426881	.	C	T	7	8	15	0	0	15	0	0
6	31427240	.	A	G	2	4	6	0	0	6	0	0
6	31427261	.	T	C	3	3	6	0	0	6	0	0
6	31427437	.	C	A	6	5	11	0	0	11	0	0
6	31427522	.	A	G	4	0	4	0	9	13	0	0
6	31427538	.	A	G	2	8	10	0	0	10	0	0
6	31427646	.	A	T	7	4	11	0	0	11	0	0
6	31428204	.	T	C	14	9	23	2	1	26	0	0
6	31428283	.	C	A	17	13	30	1	0	31	0	0
6	31428770	.	G	A	16	14	30	0	5	35	0	0
6	31428780	.	T	G	14	16	30	0	2	32	0	0
6	31428908	.	G	T	2	2	4	0	4	8	0	0
6	31430950	.	T	C	4	0	4	0	4	8	0	0
6	31431145	.	T	G	5	4	9	0	0	9	0	0
6	31431422	.	A	G	19	16	35	0	0	35	0	0
6	31431646	.	A	T	12	12	24	0	0	24	0	0
6	31431870	.	G	A	14	9	23	0	2	25	0	0
6	31432213	.	G	A	2	2	4	0	0	4	0	0
6	31432214	.	C	A	1	2	3	0	0	3	0	0
6	31432563	.	T	C	3	2	5	0	0	5	0	0
6	31432684	.	T	C	1	2	3	0	0	3	0	0
6	31432892	.	G	A	4	7	11	0	1	12	0	0
6	31432950	.	G	A	3	4	7	0	2	9	0	0
6	31432955	.	T	C	4	4	8	0	1	9	0	0
6	31432991	.	T	C	3	3	6	0	0	6	0	0
6	31433033	.	T	G	3	2	5	0	0	5	0	0
6	31434245	.	A	T	2	3	5	0	0	5	0	0
6	31434470	.	G	T	1	2	3	0	0	3	0	0
6	31591123	.	C	T	6	7	13	0	7	20	0	0
6	31591163	.	A	G	9	9	18	0	1	19	0	0
6	31591619	.	G	A	9	7	16	0	1	17	0	0
6	31591841	.	G	A	16	16	32	0	7	39	0	0
6	31591884	.	A	G	10	17	27	0	8	35	0	0
6	31607768	.	T	G	10	5	15	0	0	15	0	0
6	31611647	.	T	A	3	5	8	0	0	8	0	0
6	31617167	.	C	G	0	3	3	0	2	5	0	0
6	31624107	.	T	C	4	4	8	0	0	8	0	0
6	32010215	.	C	T	4	2	6	0	0	6	0	0
6	32010259	.	G	A	13	6	19	0	0	19	0	0
6	32010341	.	C	T	5	16	21	0	18	40	1	0
6	32010475	.	A	G	23	33	56	0	1	57	0	0
6	32014771	.	T	G	25	19	44	0	2	46	0	0
6	32016492	.	T	C	12	10	22	0	0	22	0	0
6	32029267	.	A	T	2	2	4	0	0	4	0	0
6	32029269	.	A	T	3	2	5	0	0	5	0	0
6	32032371	.	A	C	9	9	18	0	0	18	0	0
6	32032374	.	A	C	9	10	19	0	1	20	0	0
6	32032479	.	C	T	6	9	15	0	0	15	0	0
6	32035921	.	G	A	5	2	7	0	0	7	0	0
6	32035947	.	A	G	3	2	5	0	0	5	0	0
6	32065238	.	A	G	3	3	6	0	0	6	0	0
6	32068411	.	G	C	1	3	4	0	0	4	0	0
6	32068488	.	G	A	2	4	6	0	1	7	0	0
6	32071935	.	G	A	3	2	5	0	1	6	0	0
6	32371414	.	A	G	2	2	4	0	0	4	0	0
6	32378689	.	T	C	1	5	6	0	0	6	0	0
6	32382629	.	C	T	1	4	5	0	0	5	0	0
6	32385091	.	A	G	8	3	11	0	0	11	0	0
6	32386908	.	T	C	6	3	9	0	0	9	0	0
6	32396755	.	T	C	8	5	13	0	0	13	0	0
6	32397588	.	C	T	20	17	37	0	0	37	0	0
6	32397659	.	T	C	12	16	28	0	1	29	0	0
6	32404206	.	C	G	14	11	25	0	1	26	0	0
6	32404863	.	C	T	2	5	7	0	16	23	0	0
6	32405054	.	A	T	8	9	17	0	0	17	0	0
6	32405478	.	A	T	5	3	8	0	0	8	0	0
6	32405741	.	A	T	5	7	12	0	1	13	0	0
6	32405952	.	C	T	8	5	13	0	1	14	0	0
6	32406216	.	G	A	8	5	13	0	0	13	0	0
6	32408182	.	A	G	1	2	3	0	0	3	0	0
6	32409846	.	G	A	3	2	5	0	0	5	0	0
6	32415658	.	T	G	1	3	4	0	0	4	0	0
6	32497549	.	A	G	3	3	6	0	0	6	0	0
6	32506349	.	T	A	2	3	5	0	0	5	0	0
6	32506350	.	G	A	2	3	5	0	0	5	0	0
6	33550455	.	C	T	2	4	6	0	1	7	0	0
6	33550691	.	C	A	2	3	5	0	0	5	0	0
6	33550947	.	G	A	4	5	9	0	1	10	0	0
6	33552574	.	T	C	6	7	13	0	0	13	0	0
6	33552601	.	A	T	5	9	14	0	0	14	0	0
6	33554231	.	T	C	2	2	4	0	0	4	0	0
6	33554356	.	T	C	4	2	6	0	0	6	0	0
6	33554786	.	T	C	3	3	6	0	0	6	0	0
6	33554809	.	G	C	4	2	6	0	0	6	0	0
6	33554904	.	T	G	1	5	6	0	0	6	0	0
6	33555736	.	G	T	4	4	8	1	2	11	0	0
6	33555738	.	T	G	6	0	6	1	3	10	0	0
6	33555808	.	C	G	5	5	10	0	0	10	0	0
6	33556036	.	T	A	8	10	18	0	0	18	0	0
6	33556316	.	C	T	5	5	10	0	1	11	0	0
6	33556325	.	A	T	7	5	12	0	0	12	0	0
6	33556424	.	A	G	3	11	14	0	0	14	0	0
6	33556497	.	A	T	1	11	12	0	1	13	0	0
6	33556706	.	G	C	10	8	18	0	0	18	0	0
6	33556730	.	A	G	8	9	17	0	1	18	0	0
6	33556772	.	A	T	8	8	16	0	1	17	0	0
6	33556819	.	G	A	7	7	14	0	1	15	0	0
6	33556835	.	T	C	7	9	16	0	2	18	0	0
6	33556877	.	G	A	0	13	13	0	14	27	0	0
6	33557227	.	A	G	11	5	16	0	2	18	0	0
6	33557377	.	A	C	6	11	17	0	2	19	0	0
6	33557562	.	T	G	25	15	40	0	4	44	0	0
6	33557625	.	C	T	18	14	32	0	3	35	0	0
6	33558437	.	G	A	18	26	44	0	3	47	0	0
6	33663690	.	T	C	2	6	8	0	1	9	0	0
6	33663701	.	T	C	7	3	10	0	1	11	0	0
6	33663776	.	A	T	4	10	14	0	0	14	0	0
6	33663839	.	C	T	0	15	15	0	16	31	0	0
6	33663842	.	T	A	14	16	30	0	2	32	0	0
6	33664137	.	C	G	1	4	5	0	4	9	0	0
6	33664390	.	A	G	2	4	6	0	1	7	0	0
6	33664518	.	G	A	2	2	4	0	2	6	0	0
6	33664556	.	C	T	8	3	11	0	0	11	0	0
6	33664612	.	T	C	6	0	6	0	7	13	0	0
6	33664852	.	T	C	5	4	9	0	0	9	0	0
6	33664917	.	C	T	0	3	3	0	4	7	0	0
6	33664937	.	G	C	5	4	9	0	2	11	0	0
6	33665062	.	A	G	7	3	10	0	0	10	0	0
6	33665097	.	A	G	6	3	9	0	1	10	0	0
6	33665578	.	A	T	6	3	9	0	0	9	0	0
6	33665734	.	C	T	4	4	8	0	0	8	0	0
6	33665968	.	C	T	5	3	8	0	0	8	0	0
6	33666472	.	G	T	5	3	8	0	0	8	0	0
6	33666499	.	A	G	4	4	8	0	0	8	0	0
6	33666511	.	C	T	2	3	5	0	5	10	0	0
6	33666578	.	G	T	5	3	8	0	1	9	0	0
6	33666631	.	C	T	5	4	9	0	0	9	0	0
6	33666660	.	A	T	6	3	9	0	0	9	0	0
6	33666777	.	C	T	1	5	6	0	1	7	0	0
6	33667435	.	G	A	2	2	4	0	1	5	0	0
6	33667546	.	G	A	1	4	5	0	0	5	0	0
6	33668228	.	A	T	1	2	3	0	0	3	0	0
6	33668681	.	A	G	3	2	5	0	0	5	0	0
6	33668729	.	A	T	2	2	4	0	0	4	0	0
6	33883916	.	T	A	1	6	7	0	0	7	0	0
6	33884447	.	G	A	2	8	10	0	1	11	0	0
6	33896406	.	T	G	17	0	17	0	14	31	0	0
6	33896457	.	A	G	21	12	33	0	0	33	0	0
6	33896538	.	T	C	21	14	35	0	2	37	0	0
6	33896562	.	A	G	22	14	36	0	0	36	0	0
6	33896615	.	G	A	1	9	10	0	23	33	0	0
6	33896858	.	T	C	17	17	34	0	0	34	0	0
6	33896975	.	A	C	17	15	32	0	0	32	0	0
6	33897472	.	T	A	13	16	29	0	0	29	0	0
6	33897505	.	G	A	9	14	23	0	1	24	0	0
6	33897766	.	A	T	7	7	14	0	2	16	0	0
6	33909978	.	T	C	1	1	2	0	1	3	0	0
6	33912228	.	G	T	5	8	13	0	0	13	0	0
6	33912240	.	G	A	6	7	13	0	0	13	0	0
6	33912708	.	A	C	5	0	5	0	4	9	0	0
6	33913345	.	A	T	3	7	10	0	1	11	0	0
6	33913504	.	G	A	0	2	2	0	1	3	0	0
6	33914024	.	C	T	1	3	4	0	0	4	0	0
6	33914813	.	G	A	4	2	6	0	0	6	0	0
6	33916648	.	T	C	3	1	4	0	1	5	0	0
6	33918916	.	A	G	3	8	11	0	0	11	0	0
6	33921304	.	T	C	2	3	5	0	2	7	0	0
6	33921559	.	G	A	3	3	6	0	0	6	0	0
6	33924693	.	A	G	1	3	4	0	0	4	0	0
6	33927271	.	G	T	11	8	19	0	1	20	0	0
6	33929724	.	G	C	3	5	8	0	0	8	0	0
6	33982486	.	A	T	1	3	4	0	0	4	0	0
6	33982539	.	A	G	1	2	3	0	0	3	0	0
6	34072785	.	T	C	1	2	3	0	0	3	0	0
6	34807999	.	G	T	2	2	4	0	0	4	0	0
6	34808835	.	C	A	3	2	5	0	1	6	0	0
6	34808914	.	C	T	3	7	10	0	0	10	0	0
6	34808996	.	A	G	2	0	2	0	5	7	0	0
6	34809040	.	G	A	2	5	7	0	1	8	0	0
6	34809564	.	A	T	4	7	11	0	0	11	0	0
6	34809697	.	C	G	4	1	5	0	7	12	0	0
6	34809826	.	C	A	2	7	9	0	1	10	0	0
6	34809850	.	G	T	7	8	15	0	1	16	0	0
6	34810313	.	C	T	10	13	23	0	2	25	0	0
6	34810415	.	A	G	14	0	14	0	13	27	0	0
6	34810490	.	G	A	0	8	8	0	9	17	0	0
6	34810748	.	A	G	12	8	20	0	0	20	0	0
6	34810763	.	T	A	9	12	21	0	3	24	0	0
6	34810890	.	T	C	7	7	14	0	1	15	0	0
6	34810896	.	G	A	7	8	15	0	0	15	0	0
6	34811130	.	A	T	8	4	12	0	0	12	0	0
6	34811150	.	A	C	7	8	15	0	0	15	0	0
6	34811175	.	T	C	10	6	16	0	2	18	0	0
6	34825910	.	A	C	2	4	6	0	0	6	0	0
6	34826002	.	T	C	8	5	13	0	1	14	0	0
6	34826151	.	C	T	0	2	2	0	2	4	0	0
6	34826214	.	G	A	2	3	5	0	1	6	0	0
6	34826711	.	A	T	0	3	3	0	2	5	0	0
6	34826736	.	A	T	5	5	10	0	0	10	0	0
6	34826750	.	C	G	3	6	9	0	7	16	0	0
6	34826850	.	G	C	7	10	17	0	1	19	1	0
6	34826882	.	T	G	8	10	18	0	0	18	0	0
6	34831124	.	A	C	1	0	1	0	3	4	0	0
6	34851921	.	G	A	2	3	5	0	1	6	0	0
6	34932657	.	G	A	23	28	51	0	2	53	0	0
6	34932927	.	A	T	33	23	56	0	2	58	0	0
6	34933574	.	C	T	32	16	48	0	1	49	0	0
6	34934870	.	C	T	4	18	22	0	30	52	0	0
6	34934903	.	G	T	21	31	52	0	1	53	0	0
6	34943451	.	G	T	5	2	7	0	0	7	0	0
6	34943550	.	A	G	1	4	5	0	0	5	0	0
6	34943760	.	A	G	5	3	8	0	1	9	0	0
6	34944523	.	G	A	4	3	7	0	0	7	0	0
6	34947415	.	G	A	2	4	6	0	0	6	0	0
6	35036275	.	A	C	5	2	7	0	0	7	0	0
6	35036303	.	C	T	3	7	10	0	1	11	0	0
6	35036320	.	C	T	6	9	15	0	0	15	0	0
6	35036459	.	A	T	7	5	12	0	4	16	0	0
6	35036463	.	T	C	8	0	8	0	7	15	0	0
6	35036525	.	T	G	9	5	14	0	2	16	0	0
6	35039966	.	C	T	6	2	8	0	0	8	0	0
6	35042176	.	C	T	2	2	4	0	0	4	0	0
6	35046783	.	G	A	1	3	4	0	0	4	0	0
6	35099980	.	T	C	3	5	8	0	0	8	0	0
6	35100084	.	G	A	6	3	9	0	0	9	0	0
6	35100230	.	T	A	4	4	8	0	2	10	0	0
6	35100423	.	C	T	5	4	9	0	1	10	0	0
6	35100442	.	T	C	4	3	7	0	0	7	0	0
6	35100461	.	T	A	4	5	9	0	0	9	0	0
6	35100528	.	A	G	8	3	11	0	2	13	0	0
6	35100795	.	C	G	1	8	9	0	8	17	0	0
6	35100801	.	T	G	7	9	16	0	0	16	0	0
6	35100857	.	A	G	7	10	17	0	0	17	0	0
6	35100868	.	T	A	7	9	16	0	1	17	0	0
6	35100894	.	C	T	0	6	6	0	7	13	0	0
6	35100933	.	A	G	7	5	12	1	0	13	0	0
6	35101184	.	A	T	4	3	7	0	0	7	0	0
6	35101641	.	A	T	2	2	4	0	0	4	0	0
6	35101645	.	T	C	2	2	4	0	0	4	0	0
6	35101696	.	C	T	3	4	7	0	1	8	0	0
6	35101703	.	T	G	4	5	9	0	0	9	0	0
6	35101749	.	T	C	2	3	5	0	1	6	0	0
6	35102089	.	C	G	0	3	3	0	2	5	0	0
6	35102136	.	C	A	2	2	4	0	0	4	0	0
6	35102305	.	T	A	2	1	3	0	2	5	0	0
6	35136505	.	T	A	4	3	7	0	0	7	0	0
6	35137587	.	A	G	4	2	6	0	0	6	0	0
6	35365768	.	C	T	5	2	7	0	0	7	0	0
6	35365785	.	C	G	6	3	9	0	0	9	0	0
6	35366140	.	G	T	1	4	5	0	2	7	0	0
6	35366141	.	A	G	3	4	7	0	0	7	0	0
6	35366253	.	C	T	3	3	6	0	1	7	0	0
6	35366544	.	A	G	4	8	12	0	0	12	0	0
6	35366640	.	C	G	5	5	10	0	0	10	0	0
6	35388025	.	G	C	7	0	7	0	4	11	0	0
6	35389254	.	T	C	2	2	4	0	0	4	0	0
6	35389773	.	G	A	2	2	4	0	1	5	0	0
6	35389826	.	A	G	3	2	5	0	0	5	0	0
6	35389915	.	C	T	0	2	2	0	1	3	0	0
6	35443518	.	T	A	1	2	3	0	0	3	0	0
6	35443604	.	T	G	2	2	4	0	0	4	0	0
6	35443622	.	G	A	3	2	5	0	0	5	0	0
6	35443819	.	G	T	17	21	38	0	1	39	0	0
6	35443822	.	C	T	18	16	34	0	6	40	0	0
6	35443951	.	T	C	25	19	44	0	0	44	0	0
6	35443960	.	C	T	1	16	17	0	28	45	0	0
6	35444467	.	G	A	21	27	48	0	1	49	0	0
6	35676724	.	C	T	9	3	12	4	0	16	0	0
6	35676799	.	C	T	9	12	21	0	1	22	0	0
6	35677534	.	T	A	1	4	5	0	0	5	0	0
6	35688231	.	G	A	3	2	5	0	0	5	0	0
6	35688251	.	T	C	2	0	2	0	2	4	0	0
6	35693656	.	C	T	1	3	4	0	0	4	0	0
6	36129060	.	A	G	1	1	2	0	0	2	0	0
6	36129115	.	C	G	4	5	9	0	1	10	0	0
6	36129164	.	T	C	5	7	12	0	0	12	0	0
6	36129946	.	T	G	1	2	3	0	1	4	0	0
6	36130962	.	G	A	2	2	4	0	0	4	0	0
6	36130963	.	A	G	2	2	4	0	0	4	0	0
6	36131538	.	C	T	0	6	6	0	2	8	0	0
6	36132072	.	C	T	0	2	2	0	3	5	0	0
6	36136977	.	A	G	1	2	3	0	1	4	0	0
6	36720006	.	G	A	4	4	8	0	0	8	0	0
6	36720083	.	C	T	6	3	9	0	0	9	0	0
6	36720457	.	C	T	8	7	15	0	2	17	0	0
6	36720936	.	C	T	10	4	14	0	0	14	0	0
6	36721061	.	T	A	12	15	27	0	0	27	0	0
6	36721066	.	G	T	11	19	30	0	2	32	0	0
6	36721125	.	A	T	15	16	31	0	1	32	0	0
6	36721159	.	A	T	11	19	30	0	1	31	0	0
6	36721339	.	G	T	17	18	35	0	2	37	0	0
6	36721366	.	G	A	15	21	36	0	1	37	0	0
6	36721380	.	C	G	22	12	34	0	1	35	0	0
6	36724345	.	A	G	18	17	35	0	2	37	0	0
6	36724375	.	G	A	21	17	38	1	2	41	0	0
6	36758758	.	A	G	9	6	15	0	0	15	0	0
6	36760065	.	A	C	13	0	13	0	4	17	0	0
6	36760080	.	T	A	13	5	18	0	0	18	0	0
6	36760140	.	C	T	5	2	7	0	0	7	0	0
6	36783178	.	T	C	3	5	8	0	0	8	0	0
6	36783187	.	T	A	3	5	8	0	0	8	0	0
6	36789072	.	A	G	1	4	5	0	0	5	0	0
6	36792028	.	A	C	1	3	4	0	0	4	0	0
6	36792294	.	A	G	1	4	5	0	0	5	0	0
6	36819202	.	C	G	2	7	9	0	0	9	0	0
6	36877037	.	G	C	4	2	6	0	0	6	0	0
6	36877053	.	A	G	3	1	4	0	0	4	0	0
6	36877078	.	G	A	6	3	9	0	0	9	0	0
6	36877097	.	A	T	8	2	10	0	1	11	0	0
6	36877293	.	A	C	11	6	17	0	2	19	0	0
6	36897492	.	C	G	1	8	9	0	0	9	0	0
6	37071353	.	G	A	1	2	3	0	0	3	0	0
6	37163449	.	G	A	0	5	5	0	15	20	0	0
6	37163488	.	G	A	5	7	12	0	1	13	0	0
6	37163588	.	G	T	1	6	7	0	8	15	0	0
6	38859938	.	A	G	12	8	20	0	0	20	0	0
6	39124100	.	T	A	2	2	4	0	0	4	0	0
6	39993727	.	T	C	1	6	7	0	1	8	0	0
6	40708607	.	T	A	6	2	8	0	1	9	0	0
6	40761940	.	T	C	3	2	5	0	0	5	0	0
6	40761959	.	T	C	2	5	7	0	0	7	0	0
6	40761975	.	T	C	4	4	8	0	0	8	0	0
6	41435866	.	A	G	23	11	34	0	1	35	0	0
6	41445564	.	A	T	2	1	3	0	1	4	0	0
6	41445566	.	T	C	0	2	2	0	0	2	0	0
6	41460563	.	A	T	0	9	9	0	0	9	0	0
6	42597998	.	A	G	7	4	11	0	1	12	0	0
6	42657682	.	A	C	5	3	8	1	0	9	0	0
6	44007062	.	T	A	6	2	8	0	1	9	0	0
6	44245051	.	C	A	4	3	7	0	0	7	0	0
6	44945585	.	C	T	1	2	3	0	0	3	0	0
6	44977406	.	G	A	9	5	14	0	0	14	0	0
6	45375002	.	A	G	4	3	7	0	1	8	0	0
6	46346865	.	A	C	1	2	3	0	0	3	0	0
6	46346966	.	C	T	1	2	3	0	0	3	0	0
6	46346968	.	A	G	1	2	3	0	0	3	0	0
6	46357708	.	C	A	1	2	3	0	1	4	0	0
6	46413092	.	A	G	1	2	3	0	0	3	0	0
6	46419928	.	A	T	1	3	4	0	0	4	0	0
6	46422955	.	G	A	3	5	8	1	0	9	0	0
6	46423593	.	G	T	4	5	9	0	1	10	0	0
6	46428718	.	A	C	17	9	26	0	1	27	0	0
6	46431113	.	G	A	3	6	9	0	11	20	0	0
6	46431950	.	A	G	17	11	28	0	0	28	0	0
6	46432016	.	G	A	12	15	27	0	1	28	0	0
6	46450487	.	C	G	26	24	50	0	2	52	0	0
6	46450547	.	T	C	30	19	49	0	3	52	0	0
6	46450804	.	C	T	23	18	41	0	7	48	0	0
6	46452997	.	C	T	26	19	45	0	3	48	0	0
6	46454103	.	C	A	19	17	36	0	1	37	0	0
6	46454148	.	G	A	20	11	31	0	1	32	0	0
6	46454173	.	T	G	19	21	40	0	0	40	0	0
6	46454396	.	T	A	27	24	51	0	2	53	0	0
6	46582435	.	C	T	0	2	2	0	1	3	0	0
6	46582451	.	A	G	1	2	3	0	0	3	0	0
6	46701953	.	C	T	2	2	4	0	0	4	0	0
6	46715399	.	A	G	2	2	4	0	0	4	0	0
6	46715454	.	T	A	3	2	5	0	0	5	0	0
6	46716897	.	T	C	1	2	3	0	0	3	0	0
6	46716915	.	C	T	1	3	4	0	0	4	0	0
6	46716954	.	T	C	2	5	7	0	0	7	0	0
6	46717535	.	T	C	3	2	5	0	0	5	0	0
6	46717772	.	T	C	1	2	3	0	1	4	0	0
6	46718193	.	G	T	3	3	6	0	1	7	0	0
6	46718237	.	G	A	6	1	7	1	0	8	0	0
6	46718243	.	G	A	7	2	9	1	0	10	0	0
6	46721369	.	C	T	12	5	17	1	0	18	0	0
6	46722670	.	G	A	7	6	13	0	0	13	0	0
6	46722671	.	G	T	6	6	12	0	0	12	0	0
6	46726080	.	A	G	12	6	18	0	0	18	0	0
6	46726901	.	C	T	7	3	10	0	1	11	0	0
6	47006599	.	G	A	12	9	21	0	1	22	0	0
6	47006611	.	A	G	12	11	23	0	1	24	0	0
6	47032679	.	C	T	3	6	9	0	0	9	0	0
6	47809905	.	T	G	6	5	11	0	0	11	0	0
6	47810323	.	A	G	7	8	15	0	0	15	0	0
6	47810671	.	T	A	4	8	12	0	1	13	0	0
6	47810688	.	T	C	6	0	6	0	7	13	0	0
6	47810804	.	A	T	1	5	6	0	1	7	0	0
6	47811024	.	G	A	2	7	9	0	1	10	0	0
6	47811463	.	G	A	2	2	4	0	0	4	0	0
6	47811473	.	G	A	1	1	2	0	1	3	0	0
6	47811875	.	A	C	1	2	3	0	1	4	0	0
6	47811890	.	G	A	2	3	5	0	0	5	0	0
6	47811940	.	G	A	2	2	4	0	0	4	0	0
6	47812280	.	G	C	5	0	5	0	3	8	0	0
6	47865287	.	C	A	5	7	12	0	0	12	0	0
6	47865322	.	C	T	5	7	12	0	0	12	0	0
6	47865391	.	C	T	7	2	9	0	0	9	0	0
6	47865553	.	T	C	1	2	3	0	1	4	0	0
6	47865554	.	C	G	2	0	2	0	2	4	0	0
6	47865588	.	T	C	2	2	4	0	0	4	0	0
6	47865626	.	G	T	3	5	8	0	0	8	0	0
6	47865661	.	A	T	2	8	10	0	0	10	0	0
6	47865770	.	A	C	0	3	3	0	1	4	0	0
6	47865780	.	C	G	1	2	3	0	0	3	0	0
6	47869454	.	C	T	3	2	5	0	0	5	0	0
6	47869510	.	C	G	1	3	4	0	0	4	0	0
6	47869802	.	C	A	2	2	4	0	1	5	0	0
6	47869982	.	G	A	1	2	3	0	0	3	0	0
6	47872510	.	G	A	2	4	6	0	0	6	0	0
6	47879230	.	C	T	3	2	5	0	0	5	0	0
6	48051920	.	T	C	2	2	4	0	0	4	0	0
6	48052310	.	C	T	3	3	6	0	0	6	0	0
6	48052346	.	T	C	1	4	5	0	0	5	0	0
6	48054766	.	C	T	2	3	5	0	0	5	0	0
6	48057928	.	C	T	9	13	22	0	0	22	0	0
6	48058088	.	T	A	4	4	8	0	0	8	0	0
6	48058160	.	T	G	4	2	6	0	0	6	0	0
6	48058628	.	A	G	10	6	16	0	0	16	0	0
6	48058719	.	A	G	9	0	9	0	5	14	0	0
6	48058720	.	C	T	8	4	12	0	1	13	0	0
6	49107668	.	T	C	41	14	55	0	3	58	0	0
6	49108157	.	T	C	4	4	8	0	0	8	0	0
6	49738006	.	A	G	3	3	6	0	0	6	0	0
6	49738153	.	A	G	4	2	6	0	0	6	0	0
6	49738171	.	A	G	3	0	3	0	6	9	0	0
6	49738490	.	A	G	8	5	13	0	1	14	0	0
6	49738534	.	A	G	6	0	6	0	9	15	0	0
6	49738565	.	A	G	2	6	8	0	1	9	0	0
6	49738760	.	A	G	7	0	7	0	4	11	0	0
6	49738823	.	A	G	4	10	14	0	1	15	0	0
6	51577666	.	T	A	5	2	7	0	0	7	0	0
6	52223623	.	A	G	11	26	37	0	1	38	0	0
6	52223645	.	A	G	25	11	36	0	1	37	0	0
6	52223936	.	A	G	22	11	33	0	2	35	0	0
6	52224090	.	A	G	29	18	47	0	3	50	0	0
6	52224406	.	A	G	42	23	65	0	0	65	0	0
6	52224537	.	A	G	21	10	31	0	1	32	0	0
6	52224543	.	A	G	25	7	32	0	1	33	0	0
6	54806565	.	T	C	8	3	11	0	1	12	0	0
6	54806566	.	T	C	7	6	13	0	0	13	0	0
6	55217796	.	A	G	7	7	14	0	3	17	0	0
6	55217907	.	A	G	5	4	9	0	0	9	0	0
6	55218047	.	A	G	4	6	10	0	0	10	0	0
6	55218127	.	A	G	9	8	17	0	3	20	0	0
6	55218137	.	A	G	3	13	16	0	1	17	0	0
6	57439429	.	C	T	10	9	19	0	0	19	0	0
6	57455557	.	T	C	4	4	8	0	0	8	0	0
6	57459817	.	C	T	1	2	3	0	0	3	0	0
6	57459823	.	T	G	1	2	3	0	0	3	0	0
6	57478900	.	C	T	3	17	20	0	27	47	0	0
6	57479568	.	C	T	1	2	3	0	0	3	0	0
6	57481377	.	A	G	28	22	50	1	3	54	0	0
6	57492086	.	G	A	7	9	16	0	0	16	0	0
6	57492148	.	T	G	3	5	8	0	0	8	0	0
6	57494354	.	C	G	0	3	3	0	1	4	0	0
6	57498040	.	G	A	1	2	3	0	1	4	0	0
6	57498088	.	T	C	2	2	4	0	0	4	0	0
6	57503925	.	C	T	0	5	5	0	4	9	0	0
6	57541942	.	T	A	1	4	5	0	0	5	0	0
6	57595160	.	T	C	3	5	8	0	0	8	0	0
6	57618934	.	C	T	12	11	23	0	0	23	0	0
6	57620177	.	T	C	10	9	19	0	0	19	0	0
6	57620315	.	A	C	11	5	16	0	1	17	0	0
6	57630819	.	A	G	15	13	28	0	1	29	0	0
6	57630879	.	C	A	4	2	6	0	1	7	0	0
6	57630989	.	T	C	24	6	30	0	3	33	0	0
6	57634949	.	G	A	4	3	7	0	0	7	0	0
6	57638474	.	T	G	4	2	6	0	0	6	0	0
6	57644779	.	C	T	3	3	6	0	3	9	0	0
6	57900462	.	C	T	1	2	3	0	0	3	0	0
6	57909090	.	T	C	2	0	2	0	5	7	0	0
6	58382846	.	A	G	2	0	2	0	4	6	0	0
6	58395444	.	G	A	1	4	5	0	7	12	0	0
6	58395451	.	C	A	7	4	11	0	1	12	0	0
6	58499600	.	A	C	3	2	5	0	0	5	0	0
6	58522771	.	A	G	6	5	11	0	0	11	0	0
6	58524509	.	C	A	7	2	9	0	0	9	0	0
6	58549100	.	A	G	11	0	11	0	16	27	0	0
6	58553387	.	G	A	3	13	16	0	0	16	0	0
6	58553424	.	T	C	6	12	18	0	0	18	0	0
6	58560682	.	G	A	17	21	38	0	1	39	0	0
6	58560718	.	G	A	17	20	37	0	9	46	0	0
6	58561057	.	T	C	6	14	20	0	1	21	0	0
6	58561081	.	A	C	10	18	28	0	0	28	0	0
6	58561190	.	C	G	8	14	22	0	0	22	0	0
6	58563093	.	T	A	20	32	52	0	1	53	0	0
6	58563157	.	T	C	17	23	40	0	5	45	0	0
6	58563159	.	G	A	18	26	44	0	2	46	0	0
6	58563229	.	A	C	21	15	36	1	3	40	0	0
6	58563374	.	C	T	17	15	32	0	1	34	1	0
6	58563415	.	A	T	7	14	21	0	0	21	0	0
6	58698673	.	A	G	1	2	3	0	0	3	0	0
6	58712458	.	G	C	4	2	6	0	0	6	0	0
6	58723383	.	T	G	4	3	7	0	1	8	0	0
6	58725930	.	T	C	4	7	11	0	1	12	0	0
6	58726154	.	A	G	5	7	12	0	4	16	0	0
6	58728706	.	G	A	0	3	3	0	11	14	0	0
6	58728825	.	A	G	6	6	12	1	0	13	0	0
6	58728858	.	G	A	0	11	11	0	5	16	0	0
6	58729053	.	T	A	3	3	6	1	1	8	0	0
6	58729059	.	T	G	4	0	4	1	4	9	0	0
6	58729100	.	C	G	2	0	2	0	5	7	0	0
6	58729120	.	T	C	3	10	13	0	1	14	0	0
6	58729145	.	G	A	4	7	11	0	0	11	0	0
6	58730208	.	A	T	2	4	6	0	1	7	0	0
6	58730657	.	T	C	3	4	7	0	1	8	0	0
6	58732475	.	C	G	19	11	30	0	0	30	0	0
6	58752223	.	G	A	1	2	3	0	0	3	0	0
6	58752231	.	A	C	1	0	1	0	2	3	0	0
6	58772271	.	T	A	11	7	18	0	1	19	0	0
6	58772272	.	G	A	11	7	18	0	1	19	0	0
6	58773647	.	T	G	12	4	16	0	0	16	0	0
6	58773785	.	C	T	1	7	8	0	5	13	0	0
6	58773788	.	A	G	5	8	13	0	1	14	0	0
6	58778896	.	G	C	6	0	6	0	4	10	0	0
6	58828036	.	A	G	1	4	5	0	0	5	0	0
6	58855648	.	C	T	7	9	16	0	2	18	0	0
6	58857964	.	A	G	15	0	15	0	12	27	0	0
6	58859737	.	G	A	0	11	11	0	12	23	0	0
6	58861707	.	A	G	11	13	24	0	3	27	0	0
6	58862341	.	G	A	3	20	23	0	20	43	0	0
6	58867018	.	A	G	23	1	24	0	20	44	0	0
6	58867240	.	A	G	20	5	25	0	2	27	0	0
6	58867362	.	A	G	15	10	25	0	1	26	0	0
6	58867453	.	A	G	38	10	48	0	4	52	0	0
6	58867470	.	C	A	21	22	43	0	3	46	0	0
6	58918095	.	T	C	7	9	16	0	2	18	0	0
6	58918506	.	A	G	16	0	16	0	15	31	0	0
6	58918676	.	T	G	20	12	32	0	2	34	0	0
6	58918693	.	T	C	17	16	33	0	1	34	0	0
6	58921434	.	C	A	10	6	16	0	0	16	0	0
6	58921506	.	G	T	5	9	14	0	0	14	0	0
6	58923246	.	T	C	5	5	10	0	3	13	0	0
6	58939261	.	T	C	2	5	7	0	0	7	0	0
6	58939303	.	G	T	3	3	6	0	1	7	0	0
6	58948931	.	C	T	2	4	6	0	1	7	0	0
6	59681450	.	A	T	1	2	3	0	0	3	0	0
6	59813578	.	G	A	4	9	13	0	18	31	0	0
6	59813608	.	A	G	15	8	23	0	3	26	0	0
6	59813857	.	G	A	2	11	13	0	14	27	0	0
6	59813905	.	A	G	18	0	18	0	15	33	0	0
6	59819362	.	C	T	16	13	29	0	3	32	0	0
6	59824482	.	C	T	25	23	48	0	0	48	0	0
6	59824496	.	C	T	24	19	43	0	1	44	0	0
6	59824672	.	C	T	26	27	53	2	8	63	0	0
6	59824736	.	C	T	23	23	46	0	5	51	0	0
6	59832922	.	T	C	3	2	5	0	0	5	0	0
6	59833006	.	T	A	4	3	7	0	1	8	0	0
6	59833007	.	A	G	4	3	7	0	1	8	0	0
6	59837587	.	C	G	4	3	7	0	2	9	0	0
6	59837710	.	A	G	2	6	8	0	1	9	0	0
6	59837747	.	G	A	1	7	8	0	2	10	0	0
6	59839033	.	G	A	1	8	9	0	4	13	0	0
6	59839048	.	G	A	5	10	15	0	0	15	0	0
6	59841394	.	G	A	1	4	5	0	9	14	0	0
6	59848119	.	C	T	25	19	44	0	0	44	0	0
6	59848345	.	T	C	20	20	40	0	6	46	0	0
6	59848624	.	C	G	19	5	24	0	0	24	0	0
6	59848894	.	T	C	22	18	40	0	0	40	0	0
6	59850253	.	C	T	26	21	47	0	2	49	0	0
6	59850308	.	T	C	21	22	43	0	5	48	0	0
6	59874147	.	G	A	1	2	3	0	4	7	0	0
6	59882680	.	T	C	4	7	11	0	1	12	0	0
6	59882704	.	T	C	5	6	11	0	0	11	0	0
6	59883154	.	G	A	4	4	8	0	0	8	0	0
6	59889640	.	G	T	1	12	13	0	8	21	0	0
6	59889964	.	A	G	9	0	9	0	10	19	0	0
6	59889978	.	C	T	6	8	14	0	0	14	0	0
6	59890125	.	C	T	7	5	12	0	1	13	0	0
6	59891289	.	T	C	15	8	23	0	1	24	0	0
6	59892864	.	C	T	8	14	22	0	0	22	0	0
6	59894548	.	T	C	12	17	29	0	5	34	0	0
6	59894580	.	T	A	18	8	26	0	1	27	0	0
6	59894719	.	T	C	18	9	27	0	0	27	0	0
6	59915599	.	T	C	8	7	15	0	1	16	0	0
6	59915608	.	T	C	10	8	18	0	0	18	0	0
6	59917077	.	T	C	5	13	18	0	0	18	0	0
6	59921661	.	T	G	15	20	35	0	3	38	0	0
6	59921685	.	T	C	14	16	30	0	1	31	0	0
6	59921788	.	A	C	9	12	21	0	2	23	0	0
6	59939277	.	G	A	19	15	34	0	0	34	0	0
6	59951038	.	C	T	5	3	8	0	1	9	0	0
6	59951483	.	C	G	2	4	6	0	2	8	0	0
6	59968016	.	T	C	7	5	12	0	1	13	0	0
6	59968057	.	T	C	0	21	21	1	0	22	0	0
6	59971416	.	C	T	20	20	40	0	2	42	0	0
6	59971711	.	G	A	25	18	43	3	1	47	0	0
6	59971718	.	C	A	19	17	36	4	5	45	0	0
6	59971897	.	G	A	3	5	8	2	1	11	0	0
6	59972259	.	T	A	16	14	30	2	1	33	0	0
6	59985833	.	C	T	5	2	7	0	0	7	0	0
6	60024846	.	G	A	11	3	14	0	0	14	0	0
6	60031520	.	G	A	3	7	10	0	0	10	0	0
6	60031641	.	C	T	0	1	1	0	5	6	0	0
6	60043094	.	G	A	3	1	4	0	0	4	0	0
6	60043150	.	A	G	3	3	6	0	0	6	0	0
6	60043179	.	T	C	2	2	4	0	1	5	0	0
6	60043413	.	G	A	6	5	11	0	1	12	0	0
6	60043792	.	T	C	5	7	12	0	0	12	0	0
6	60043842	.	C	T	5	13	18	0	0	18	0	0
6	60044319	.	T	A	5	3	8	0	0	8	0	0
6	60044320	.	A	T	4	3	7	0	0	7	0	0
7	742828	.	T	C	9	30	39	0	1	40	0	0
7	762320	.	A	G	5	0	5	0	1	6	0	0
7	762326	.	G	A	4	3	7	0	0	7	0	0
7	846819	.	T	A	1	3	4	0	0	4	0	0
7	847189	.	A	T	4	5	9	0	0	9	0	0
7	1417308	.	C	G	1	3	4	0	0	4	0	0
7	1418299	.	A	G	3	6	9	2	0	11	0	0
7	1418310	.	T	C	3	6	9	2	2	13	0	0
7	1418631	.	T	C	2	3	5	0	0	5	0	0
7	1618769	.	G	A	1	4	5	2	10	17	0	0
7	1618771	.	G	A	0	9	9	2	6	17	0	0
7	3931029	.	A	G	36	20	56	0	5	61	0	0
7	3931264	.	C	T	27	30	57	0	1	58	0	0
7	3931396	.	A	T	35	28	63	0	2	65	0	0
7	3931543	.	A	T	31	26	57	0	1	58	0	0
7	3931598	.	G	T	29	25	54	0	5	59	0	0
7	3931644	.	T	C	35	0	35	0	12	47	0	0
7	3932209	.	A	T	11	17	28	0	0	28	0	0
7	3932402	.	T	C	10	12	22	0	1	23	0	0
7	3932405	.	A	T	11	12	23	0	0	23	0	0
7	3932463	.	T	G	9	9	18	0	2	20	0	0
7	3932694	.	G	A	19	8	27	0	1	28	0	0
7	3932698	.	T	C	20	12	32	0	2	34	0	0
7	3932731	.	C	A	23	12	35	0	2	37	0	0
7	3932935	.	C	A	9	12	21	0	3	24	0	0
7	3933121	.	G	A	22	16	38	0	1	39	0	0
7	3933243	.	C	A	14	7	21	0	0	21	0	0
7	3933271	.	C	T	19	8	27	0	2	29	0	0
7	3933383	.	A	C	9	0	9	0	8	17	0	0
7	3933481	.	T	C	14	0	14	0	11	25	0	0
7	3933483	.	C	T	2	9	11	0	14	25	0	0
7	3933998	.	C	T	7	9	16	0	3	19	0	0
7	3934038	.	A	T	8	6	14	0	2	16	0	0
7	3934387	.	C	T	16	10	26	0	1	27	0	0
7	3934428	.	G	T	12	12	24	0	2	26	0	0
7	3934696	.	A	G	1	2	3	0	1	4	0	0
7	3934710	.	G	A	3	3	6	0	0	6	0	0
7	3934970	.	A	G	3	2	5	0	0	5	0	0
7	3935055	.	T	C	7	3	10	0	0	10	0	0
7	3935123	.	A	G	8	11	19	0	0	19	0	0
7	3935283	.	G	A	3	8	11	0	0	11	0	0
7	3935737	.	C	T	1	3	4	0	10	14	0	0
7	3935788	.	C	A	1	5	6	0	0	6	0	0
7	3935908	.	G	T	3	2	5	0	0	5	0	0
7	3936127	.	C	T	0	12	12	0	4	16	0	0
7	3936764	.	G	A	3	2	5	0	0	5	0	0
7	3955628	.	G	A	1	3	4	0	0	4	0	0
7	4088334	.	C	T	12	26	38	0	1	39	0	0
7	4088545	.	C	T	0	19	19	0	14	33	0	0
7	4088680	.	G	A	14	15	29	0	2	31	0	0
7	4088727	.	A	T	22	23	45	0	2	47	0	0
7	4088832	.	A	G	14	26	40	0	0	40	0	0
7	4089042	.	A	G	22	8	30	0	3	33	0	0
7	4089090	.	G	A	17	6	23	0	0	23	0	0
7	4095265	.	C	T	2	13	15	0	10	25	0	0
7	4100931	.	C	T	11	8	19	0	1	20	0	0
7	4100967	.	G	A	10	9	19	1	0	20	0	0
7	4110441	.	T	C	2	0	2	0	3	5	0	0
7	4175054	.	G	A	2	3	5	0	0	5	0	0
7	4175078	.	G	A	2	4	6	0	0	6	0	0
7	4184203	.	G	C	1	2	3	0	0	3	0	0
7	4184897	.	G	T	1	3	4	0	0	4	0	0
7	4185160	.	A	T	8	5	13	0	0	13	0	0
7	4186499	.	A	G	6	4	10	4	1	15	0	0
7	5520617	.	A	G	5	2	7	0	0	7	0	0
7	7248193	.	C	T	3	6	9	0	3	12	0	0
7	7248212	.	A	T	1	4	5	0	5	10	0	0
7	7368834	.	G	T	1	4	5	0	0	5	0	0
7	7372254	.	A	G	3	1	4	0	1	5	0	0
7	7372287	.	A	G	4	5	9	0	1	10	0	0
7	7372404	.	A	G	15	8	23	4	1	28	0	0
7	7372502	.	A	G	5	3	8	3	0	11	0	0
7	7552113	.	G	A	1	2	3	0	0	3	0	0
7	7608920	.	G	A	0	4	4	0	2	6	0	0
7	7608944	.	T	G	0	0	0	0	4	4	0	0
7	7611866	.	T	C	7	6	13	0	1	14	0	0
7	7617855	.	T	C	6	7	13	0	0	13	0	0
7	7617963	.	C	G	5	5	10	0	0	10	0	0
7	7624082	.	A	G	10	11	21	0	2	23	0	0
7	7624090	.	T	C	11	12	23	0	1	24	0	0
7	7641230	.	A	T	10	8	18	0	0	18	0	0
7	7641351	.	G	A	12	14	26	0	1	27	0	0
7	7641353	.	G	A	11	15	26	0	0	26	0	0
7	7641559	.	C	T	18	13	31	0	3	34	0	0
7	7641567	.	C	T	16	14	30	0	3	33	0	0
7	7641608	.	A	G	9	17	26	0	3	29	0	0
7	7641678	.	T	A	11	6	17	0	1	18	0	0
7	7641976	.	T	C	12	5	17	0	0	17	0	0
7	7641984	.	G	T	9	5	14	0	1	15	0	0
7	7642819	.	G	A	16	16	32	0	0	32	0	0
7	7642840	.	T	A	16	14	30	0	2	32	0	0
7	7642856	.	C	T	18	16	34	0	0	34	0	0
7	7642944	.	C	T	5	3	8	0	0	8	0	0
7	7642991	.	T	A	2	2	4	0	0	4	0	0
7	7643184	.	A	G	17	1	18	0	16	34	0	0
7	7643348	.	G	A	27	21	48	0	3	51	0	0
7	7643362	.	T	A	26	24	50	1	1	52	0	0
7	7643488	.	A	G	30	20	50	0	5	55	0	0
7	7643629	.	A	G	30	30	60	1	6	67	0	0
7	7643820	.	C	T	8	2	10	0	3	13	0	0
7	7662467	.	C	G	8	12	20	0	0	20	0	0
7	7662475	.	T	C	10	0	10	0	13	23	0	0
7	7662527	.	A	C	13	14	27	0	0	27	0	0
7	7662580	.	G	A	3	28	31	0	0	31	0	0
7	7662872	.	A	C	16	12	28	0	0	28	0	0
7	7662978	.	A	C	7	8	15	0	2	17	0	0
7	7663017	.	T	A	11	16	27	0	1	28	0	0
7	7663048	.	A	G	15	16	31	0	1	32	0	0
7	7663132	.	A	G	10	10	20	1	1	22	0	0
7	7663152	.	A	T	9	6	15	1	1	17	0	0
7	7663236	.	T	C	8	0	8	0	0	9	1	0
7	7663254	.	G	A	6	4	10	0	1	11	0	0
7	7663320	.	C	G	8	9	17	0	1	18	0	0
7	7663449	.	A	C	15	0	15	0	9	24	0	0
7	7663453	.	A	T	14	8	22	0	0	22	0	0
7	7663682	.	C	T	0	6	6	0	5	11	0	0
7	7664558	.	G	T	4	4	8	1	0	9	0	0
7	7664838	.	G	T	3	3	6	0	0	6	0	0
7	7665338	.	G	T	3	3	6	0	0	6	0	0
7	7665353	.	T	A	3	3	6	0	0	6	0	0
7	7665480	.	A	C	3	4	7	0	0	7	0	0
7	7666388	.	G	A	3	2	5	0	0	5	0	0
7	7674378	.	T	C	1	0	1	0	2	3	0	0
7	7680073	.	C	T	3	2	5	0	0	5	0	0
7	7681415	.	T	G	2	2	4	0	0	4	0	0
7	7681419	.	C	G	0	3	3	0	2	5	0	0
7	7683342	.	G	A	1	2	3	0	0	3	0	0
7	7696785	.	T	A	2	2	4	0	0	4	0	0
7	7696794	.	G	T	0	2	2	0	3	5	0	0
7	7700965	.	T	G	2	0	2	0	4	6	0	0
7	7700987	.	T	C	3	4	7	0	0	7	0	0
7	7701016	.	G	C	2	5	7	0	0	7	0	0
7	7701293	.	T	C	1	4	5	0	0	5	0	0
7	7705993	.	C	G	5	0	5	0	8	13	0	0
7	7706005	.	C	T	4	9	13	0	0	13	0	0
7	7706702	.	G	A	0	11	11	0	7	18	0	0
7	7706869	.	A	G	2	3	5	0	2	7	0	0
7	7706997	.	C	A	4	9	13	0	0	13	0	0
7	7707029	.	T	G	9	7	16	0	1	17	0	0
7	7708640	.	C	G	2	3	5	0	0	5	0	0
7	7708666	.	A	C	1	3	4	0	0	4	0	0
7	7708714	.	T	C	3	4	7	0	0	7	0	0
7	7708826	.	T	G	2	4	6	0	0	6	0	0
7	7708840	.	C	A	2	5	7	0	0	7	0	0
7	7709061	.	A	G	2	4	6	0	0	6	0	0
7	7709835	.	T	C	1	2	3	0	0	3	0	0
7	7710831	.	T	G	3	2	5	0	0	5	0	0
7	7779060	.	G	A	0	10	10	0	3	13	0	0
7	7779091	.	A	G	2	7	9	0	1	10	0	0
7	7785550	.	T	C	2	2	4	0	0	4	0	0
7	7785604	.	C	T	1	2	3	0	0	3	0	0
7	7796088	.	T	C	2	4	6	0	0	6	0	0
7	7797397	.	T	G	4	2	6	0	0	6	0	0
7	8694818	.	T	G	5	2	7	0	0	7	0	0
7	8694893	.	A	C	0	7	7	0	0	7	0	0
7	8890495	.	C	T	1	8	9	0	3	12	0	0
7	8890515	.	G	C	5	0	5	0	11	16	0	0
7	8891675	.	T	A	1	5	6	0	0	6	0	0
7	8891710	.	A	G	2	10	12	0	0	12	0	0
7	8891717	.	A	G	2	8	10	0	0	10	0	0
7	8891755	.	T	G	1	7	8	0	0	8	0	0
7	8891813	.	T	C	2	0	2	0	2	4	0	0
7	8891823	.	T	C	3	0	3	0	2	5	0	0
7	9232531	.	T	C	1	2	3	0	0	3	0	0
7	9261589	.	T	C	2	3	5	0	1	6	0	0
7	9299699	.	G	A	1	3	4	0	0	4	0	0
7	9299726	.	A	G	1	3	4	0	0	4	0	0
7	9299776	.	T	A	5	2	7	0	1	8	0	0
7	9302654	.	G	A	0	5	5	0	4	9	0	0
7	9302664	.	T	C	7	5	12	0	0	12	0	0
7	9302736	.	C	A	10	6	16	0	0	17	1	0
7	9302750	.	A	G	12	6	18	0	1	19	0	0
7	9302905	.	A	G	20	0	20	0	10	30	0	0
7	9302990	.	T	A	17	10	27	0	2	29	0	0
7	9303000	.	T	A	13	11	24	0	5	29	0	0
7	9303033	.	C	A	25	5	30	0	1	31	0	0
7	9304692	.	T	C	27	22	49	0	0	49	0	0
7	9305501	.	G	A	2	3	5	0	0	5	0	0
7	9308683	.	A	G	5	9	14	0	0	14	0	0
7	9308715	.	C	T	6	6	12	0	2	14	0	0
7	9308817	.	A	G	9	6	15	0	0	15	0	0
7	9312770	.	G	A	1	13	14	0	10	24	0	0
7	9317990	.	G	A	9	8	17	0	2	19	0	0
7	9319626	.	T	C	9	13	22	0	1	23	0	0
7	9320431	.	A	T	9	8	17	0	0	17	0	0
7	9320489	.	A	G	14	7	21	0	0	21	0	0
7	9320647	.	A	G	7	4	11	0	2	13	0	0
7	9320719	.	C	T	8	9	17	0	1	18	0	0
7	9321374	.	C	T	1	3	4	0	0	4	0	0
7	9321375	.	T	A	2	3	5	0	0	5	0	0
7	9321528	.	A	C	1	2	3	0	0	3	0	0
7	9321529	.	C	G	1	0	1	0	2	3	0	0
7	9321800	.	G	A	0	9	9	0	12	21	0	0
7	9321981	.	G	T	17	26	43	0	2	45	0	0
7	9322070	.	A	T	23	17	40	0	3	44	1	0
7	9322073	.	A	C	26	19	45	0	2	47	0	0
7	9322176	.	C	A	16	7	23	2	1	32	6	0
7	9322178	.	T	C	21	7	28	2	3	33	0	0
7	9322271	.	G	C	11	18	29	0	2	31	0	0
7	9322441	.	C	T	5	10	15	0	0	15	0	0
7	9511184	.	C	T	6	3	9	0	2	11	0	0
7	10582829	.	A	T	5	3	8	0	0	8	0	0
7	10875386	.	A	G	12	5	17	0	2	19	0	0
7	10875552	.	A	G	7	7	14	0	1	15	0	0
7	11004613	.	G	T	2	1	3	0	1	4	0	0
7	11340626	.	A	G	2	0	2	0	3	5	0	0
7	11340654	.	A	G	7	5	12	0	1	13	0	0
7	11341006	.	A	G	5	3	8	0	0	8	0	0
7	12141666	.	T	C	1	2	3	0	0	3	0	0
7	13353712	.	T	C	6	3	9	0	2	11	0	0
7	13858725	.	T	C	3	2	5	0	0	5	0	0
7	13858831	.	G	A	4	4	8	0	1	9	0	0
7	13858929	.	G	A	2	6	8	0	1	9	0	0
7	13897711	.	T	C	3	2	5	0	0	5	0	0
7	13897765	.	A	C	5	2	7	0	0	7	0	0
7	13897768	.	A	C	6	0	6	0	2	8	0	0
7	13897822	.	G	A	1	3	4	0	0	4	0	0
7	13897878	.	G	A	1	2	3	0	1	4	0	0
7	13897897	.	T	C	2	2	4	0	0	4	0	0
7	14205559	.	T	C	3	2	5	0	0	5	0	0
7	14205857	.	C	A	3	3	6	0	0	6	0	0
7	14205881	.	A	G	3	3	6	0	1	7	0	0
7	14206790	.	T	G	7	8	15	0	1	16	0	0
7	14206847	.	C	A	2	4	6	0	1	7	0	0
7	14262108	.	A	T	4	3	7	0	1	8	0	0
7	14262111	.	G	T	0	4	4	0	5	9	0	0
7	14350822	.	G	A	1	4	5	0	0	5	0	0
7	14354038	.	T	C	2	3	5	0	0	5	0	0
7	14381282	.	C	G	4	5	9	0	0	9	0	0
7	14394824	.	G	T	3	4	7	0	1	8	0	0
7	14394839	.	G	C	6	7	13	0	0	13	0	0
7	14394860	.	A	C	5	7	12	0	0	12	0	0
7	14394925	.	A	G	4	7	11	0	0	11	0	0
7	14397850	.	A	G	1	2	3	0	0	3	0	0
7	14417122	.	C	T	1	2	3	0	1	4	0	0
7	14423500	.	T	G	1	2	3	0	0	3	0	0
7	14512064	.	G	A	4	7	11	0	1	12	0	0
7	14512081	.	A	C	6	7	13	0	0	13	0	0
7	14512099	.	C	G	7	7	14	0	0	14	0	0
7	14532066	.	T	C	11	11	22	0	1	23	0	0
7	14534326	.	T	C	11	1	12	0	12	24	0	0
7	14534789	.	T	C	10	12	22	0	3	25	0	0
7	14535719	.	T	C	6	12	18	0	1	19	0	0
7	14535749	.	T	A	9	9	18	0	1	19	0	0
7	14535782	.	G	T	11	9	20	0	0	20	0	0
7	14539470	.	T	C	4	6	10	0	1	11	0	0
7	14542854	.	C	T	2	5	7	0	1	8	0	0
7	14542893	.	C	T	3	8	11	0	1	12	0	0
7	14543002	.	T	C	6	6	12	0	0	12	0	0
7	14543031	.	G	A	6	6	12	0	0	12	0	0
7	14543128	.	A	T	3	3	6	0	0	6	0	0
7	14543156	.	T	G	2	3	5	0	0	5	0	0
7	14543391	.	A	G	1	5	6	0	0	6	0	0
7	14543454	.	G	T	3	2	5	0	0	5	0	0
7	14543463	.	T	C	2	2	4	0	1	5	0	0
7	14774086	.	C	A	2	2	4	0	0	4	0	0
7	14789964	.	G	A	1	6	7	0	1	8	0	0
7	14860521	.	C	T	5	3	8	0	0	8	0	0
7	14860524	.	A	C	5	3	8	0	0	8	0	0
7	14900869	.	G	A	2	5	7	0	0	7	0	0
7	14934738	.	G	A	3	5	8	0	0	8	0	0
7	14938134	.	C	T	13	7	20	0	1	21	0	0
7	15087435	.	G	C	1	2	3	0	0	3	0	0
7	15087643	.	G	A	2	3	5	0	0	5	0	0
7	15087995	.	A	T	1	2	3	0	0	3	0	0
7	15088130	.	A	G	1	1	2	0	1	3	0	0
7	15605844	.	C	T	1	2	3	0	0	3	0	0
7	15605846	.	T	C	1	2	3	0	0	3	0	0
7	15605950	.	T	C	4	3	7	0	1	8	0	0
7	15605968	.	T	A	3	2	5	0	0	5	0	0
7	15607650	.	C	T	3	7	10	0	2	12	0	0
7	15607757	.	G	A	0	6	6	0	3	10	1	0
7	15608108	.	A	C	2	1	3	0	0	3	0	0
7	15608113	.	T	C	2	2	4	0	0	4	0	0
7	15608471	.	C	T	7	7	14	0	0	14	0	0
7	15608487	.	A	G	10	0	10	0	4	14	0	0
7	15608620	.	G	A	1	3	4	0	0	4	0	0
7	15608707	.	T	G	1	2	3	0	0	3	0	0
7	15608730	.	A	C	2	2	4	0	1	5	0	0
7	15608767	.	T	A	4	4	8	0	0	8	0	0
7	15608774	.	C	G	3	3	6	0	1	7	0	0
7	15609037	.	A	G	11	6	17	0	1	18	0	0
7	15609104	.	A	G	8	3	11	0	3	14	0	0
7	15609137	.	A	C	7	5	12	0	0	12	0	0
7	15609156	.	G	A	5	4	9	0	0	9	0	0
7	15609387	.	T	A	5	9	14	0	0	14	0	0
7	15609469	.	C	T	8	12	20	0	1	21	0	0
7	15609520	.	G	A	6	8	14	0	0	14	0	0
7	15609673	.	C	A	3	2	5	0	0	5	0	0
7	15609675	.	G	C	3	2	5	0	0	5	0	0
7	15609826	.	C	T	9	9	18	0	0	18	0	0
7	15609961	.	C	T	10	21	31	0	0	31	0	0
7	15819692	.	C	T	4	7	11	0	0	11	0	0
7	15825888	.	T	C	3	0	3	0	6	9	0	0
7	15825932	.	T	C	3	0	3	0	7	10	0	0
7	15896959	.	G	C	1	3	4	0	0	4	0	0
7	15896998	.	G	A	0	3	3	0	2	5	0	0
7	15897024	.	G	A	3	3	6	0	1	7	0	0
7	15897671	.	G	T	1	8	9	0	0	9	0	0
7	15897676	.	T	C	1	8	9	0	0	9	0	0
7	15897755	.	A	G	4	2	6	0	0	6	0	0
7	15898400	.	T	C	3	3	6	0	0	6	0	0
7	15899189	.	T	C	4	3	7	0	0	7	0	0
7	15899191	.	A	G	4	3	7	0	0	7	0	0
7	15899286	.	A	G	6	5	11	0	2	13	0	0
7	15899468	.	A	T	4	14	18	0	0	18	0	0
7	15899532	.	T	A	11	13	24	0	1	25	0	0
7	16348898	.	A	G	1	2	3	0	1	4	0	0
7	16388262	.	C	T	2	6	8	0	0	8	0	0
7	16388307	.	C	T	4	6	10	0	1	11	0	0
7	16388310	.	G	C	4	7	11	0	0	11	0	0
7	16388358	.	T	C	2	3	5	0	0	5	0	0
7	16456854	.	C	T	9	6	15	0	2	17	0	0
7	16460093	.	C	T	5	7	12	0	2	14	0	0
7	16460252	.	G	A	9	3	12	0	1	13	0	0
7	16461094	.	G	T	1	3	4	0	1	5	0	0
7	16545638	.	C	T	13	6	19	0	0	19	0	0
7	16546048	.	T	A	1	4	5	0	0	5	0	0
7	16546052	.	G	C	0	3	3	0	1	4	0	0
7	17000956	.	G	A	0	2	2	0	1	3	0	0
7	17013825	.	T	C	1	3	4	0	0	4	0	0
7	17013827	.	T	A	1	3	4	0	0	4	0	0
7	17013899	.	C	T	2	2	4	0	1	5	0	0
7	17014453	.	A	C	4	6	10	0	2	12	0	0
7	17014531	.	C	A	7	12	19	0	0	19	0	0
7	17014548	.	G	T	8	12	20	0	1	21	0	0
7	17014621	.	T	A	11	9	20	0	1	21	0	0
7	17014653	.	C	T	9	8	17	0	1	18	0	0
7	17014748	.	T	C	8	10	18	0	0	18	0	0
7	17014914	.	A	G	3	9	12	0	3	15	0	0
7	17097176	.	G	A	4	7	11	0	1	12	0	0
7	17097191	.	C	T	4	9	13	0	1	14	0	0
7	17100076	.	T	C	14	4	18	0	0	18	0	0
7	17250832	.	C	T	1	4	5	0	0	5	0	0
7	17250861	.	A	G	1	7	8	0	0	8	0	0
7	17251098	.	C	A	9	8	17	0	0	17	0	0
7	17251126	.	A	T	10	8	18	0	0	18	0	0
7	17251222	.	G	A	2	12	14	0	13	27	0	0
7	17251234	.	A	G	16	11	27	0	1	28	0	0
7	17695039	.	C	T	3	6	9	0	0	9	0	0
7	17695051	.	A	G	6	2	8	0	1	9	0	0
7	17695425	.	A	G	1	3	4	0	0	4	0	0
7	17754299	.	G	A	13	6	19	1	0	20	0	0
7	17755699	.	C	T	3	3	6	0	0	6	0	0
7	17757019	.	A	G	31	28	59	0	6	65	0	0
7	17757024	.	C	T	33	32	65	0	3	68	0	0
7	17757078	.	A	G	35	31	66	0	7	73	0	0
7	17757243	.	T	G	36	15	51	1	3	55	0	0
7	17757261	.	T	G	8	46	54	1	4	59	0	0
7	17757371	.	T	C	31	31	62	0	8	70	0	0
7	17757408	.	G	A	40	32	72	0	2	74	0	0
7	17761022	.	T	C	7	4	11	0	0	11	0	0
7	17761028	.	T	A	8	5	13	0	0	13	0	0
7	17761063	.	A	C	5	8	13	0	0	13	0	0
7	17761117	.	T	G	3	2	5	0	0	5	0	0
7	17761303	.	C	T	0	2	2	0	2	4	0	0
7	17761342	.	T	G	2	2	4	0	0	4	0	0
7	17761676	.	T	C	2	0	2	0	2	4	0	0
7	17761699	.	T	C	1	2	3	0	1	4	0	0
7	17762455	.	C	G	0	2	2	0	5	7	0	0
7	17762480	.	G	C	2	3	5	0	0	5	0	0
7	17801775	.	T	C	1	2	3	0	0	3	0	0
7	17801778	.	C	T	1	2	3	0	0	3	0	0
7	17801841	.	C	T	2	3	5	0	0	5	0	0
7	17801857	.	C	A	3	3	6	0	0	6	0	0
7	17801896	.	T	G	3	2	5	0	1	6	0	0
7	17801900	.	A	G	3	1	4	0	1	5	0	0
7	17802645	.	G	A	3	2	5	1	1	7	0	0
7	17802648	.	C	T	4	2	6	1	0	7	0	0
7	17802968	.	T	C	3	3	6	0	1	7	0	0
7	17803484	.	A	G	1	4	5	0	0	5	0	0
7	17805706	.	C	G	4	6	10	0	2	12	0	0
7	17809860	.	C	T	4	5	9	0	0	9	0	0
7	17810581	.	C	T	5	3	8	0	1	9	0	0
7	17810611	.	G	A	6	5	11	0	0	11	0	0
7	17811052	.	T	C	6	0	6	0	3	9	0	0
7	17812892	.	T	A	8	7	15	0	0	15	0	0
7	17933314	.	C	G	2	3	5	0	0	5	0	0
7	17933323	.	C	T	3	4	7	0	0	7	0	0
7	17933350	.	G	A	0	4	4	0	7	11	0	0
7	17933413	.	T	A	2	2	4	0	0	4	0	0
7	17933777	.	G	A	1	3	4	0	1	5	0	0
7	17936753	.	C	G	7	8	15	0	1	16	0	0
7	17936795	.	G	A	1	9	10	0	8	18	0	0
7	17938069	.	C	A	4	4	8	0	0	8	0	0
7	17941936	.	C	T	10	4	14	0	2	16	0	0
7	17942883	.	T	G	8	12	20	0	0	21	1	0
7	17943078	.	A	G	10	11	21	0	2	23	0	0
7	17943133	.	C	T	16	11	27	0	1	28	0	0
7	17943170	.	G	A	1	18	19	0	21	40	0	0
7	17943376	.	C	G	18	16	34	0	1	35	0	0
7	17943509	.	A	G	19	0	19	0	34	53	0	0
7	17943851	.	G	C	1	5	6	0	0	6	0	0
7	17965749	.	G	A	2	3	5	0	0	5	0	0
7	17969145	.	C	T	7	5	12	0	0	12	0	0
7	17969792	.	A	G	4	5	9	0	0	9	0	0
7	17969851	.	A	G	4	5	9	0	1	10	0	0
7	17969883	.	G	C	0	2	2	0	7	9	0	0
7	17969949	.	A	G	0	4	4	0	1	5	0	0
7	17970016	.	C	T	3	2	5	0	0	5	0	0
7	17970124	.	T	A	2	3	5	0	2	7	0	0
7	17970654	.	G	A	7	5	12	0	0	12	0	0
7	17970790	.	A	G	2	3	5	0	0	5	0	0
7	18114316	.	G	A	1	13	14	0	28	42	0	0
7	18114495	.	C	T	9	16	25	0	2	27	0	0
7	18114518	.	A	T	7	5	12	0	13	25	0	0
7	18115220	.	T	A	16	25	41	0	0	41	0	0
7	18115261	.	G	T	19	21	40	0	0	40	0	0
7	18115302	.	G	A	1	16	17	0	10	27	0	0
7	18115470	.	C	T	26	10	36	0	2	38	0	0
7	18115584	.	T	G	10	22	32	1	4	37	0	0
7	18115721	.	G	A	2	29	31	0	15	46	0	0
7	18116037	.	C	T	10	14	24	0	2	26	0	0
7	18116204	.	G	A	37	22	59	0	1	60	0	0
7	18122445	.	C	G	10	12	22	0	0	22	0	0
7	18122541	.	G	C	21	3	24	0	30	54	0	0
7	18124218	.	C	T	23	9	32	0	4	36	0	0
7	18124314	.	C	T	15	19	34	0	0	34	0	0
7	18124329	.	T	A	15	16	31	0	2	33	0	0
7	18137325	.	C	T	0	19	19	0	19	38	0	0
7	18146699	.	T	G	6	10	16	1	0	17	0	0
7	18168253	.	T	A	9	10	19	0	0	19	0	0
7	18366571	.	C	G	2	1	3	0	0	3	0	0
7	18366583	.	T	A	2	3	5	0	0	5	0	0
7	18366932	.	T	C	3	2	5	0	0	5	0	0
7	18366936	.	A	T	3	2	5	0	0	5	0	0
7	18367052	.	C	T	3	2	5	0	0	5	0	0
7	18367075	.	A	C	3	3	6	0	0	6	0	0
7	18367165	.	A	T	2	4	6	0	0	6	0	0
7	18413054	.	G	T	1	4	5	0	1	6	0	0
7	18413348	.	C	G	1	3	4	0	0	4	0	0
7	18413585	.	A	C	1	5	6	0	2	8	0	0
7	18413798	.	G	A	1	2	3	0	1	4	0	0
7	18462498	.	A	G	2	3	5	0	0	5	0	0
7	18462587	.	G	A	2	3	5	0	0	5	0	0
7	18462733	.	G	A	7	9	16	0	1	17	0	0
7	18463132	.	T	A	3	10	13	0	0	13	0	0
7	18463259	.	T	C	4	6	10	0	0	10	0	0
7	18463488	.	A	T	4	5	9	0	0	9	0	0
7	18464394	.	T	A	1	2	3	0	0	3	0	0
7	18464919	.	C	T	5	7	12	0	0	12	0	0
7	18465000	.	G	A	7	4	11	0	0	11	0	0
7	18465096	.	A	G	5	5	10	0	0	10	0	0
7	18465435	.	T	G	7	4	11	0	0	11	0	0
7	18470573	.	C	A	1	3	4	0	0	4	0	0
7	18475150	.	C	G	3	2	5	0	0	5	0	0
7	18550224	.	C	T	1	2	3	0	0	3	0	0
7	18550292	.	G	A	1	2	3	0	0	3	0	0
7	18550499	.	C	T	1	2	3	0	0	3	0	0
7	18558504	.	C	T	14	11	25	0	2	27	0	0
7	18558806	.	A	T	11	21	32	0	1	33	0	0
7	18558871	.	G	A	11	9	20	0	0	20	0	0
7	18558906	.	T	G	8	11	19	0	0	19	0	0
7	18559197	.	G	T	8	6	14	0	0	14	0	0
7	18559212	.	C	A	10	9	19	0	0	19	0	0
7	18559258	.	A	G	10	15	25	0	0	25	0	0
7	18559402	.	G	T	7	13	20	0	1	21	0	0
7	18559416	.	T	C	10	6	16	0	1	17	0	0
7	18559548	.	C	T	4	7	11	0	1	12	0	0
7	18560013	.	C	A	7	7	14	0	2	16	0	0
7	18560047	.	G	A	5	4	9	0	2	11	0	0
7	18560397	.	C	T	0	3	3	0	4	7	0	0
7	18560474	.	C	T	1	5	6	0	2	8	0	0
7	18560478	.	T	A	4	3	7	0	1	8	0	0
7	18560952	.	C	T	1	3	4	0	3	7	0	0
7	18594557	.	T	C	5	0	5	0	7	12	0	0
7	18606967	.	A	G	1	2	3	0	0	3	0	0
7	18607790	.	A	G	1	2	3	0	0	3	0	0
7	18607928	.	A	T	1	3	4	0	0	4	0	0
7	18618113	.	T	A	10	13	23	0	2	25	0	0
7	18618776	.	T	C	5	7	12	0	0	12	0	0
7	18618860	.	T	C	2	0	2	0	6	8	0	0
7	18618927	.	T	C	9	9	18	0	0	18	0	0
7	18619466	.	C	T	1	4	5	0	0	5	0	0
7	18619990	.	C	T	2	8	10	0	1	11	0	0
7	18620027	.	A	T	2	2	4	0	0	4	0	0
7	18620049	.	A	C	2	3	5	0	1	6	0	0
7	18620223	.	C	T	0	6	6	0	1	7	0	0
7	18620481	.	C	A	1	2	3	0	0	3	0	0
7	18705665	.	G	A	1	3	4	0	0	4	0	0
7	18710367	.	T	G	2	4	6	0	0	6	0	0
7	18711374	.	G	C	5	2	7	0	0	7	0	0
7	18711378	.	G	C	5	2	7	0	0	7	0	0
7	18779690	.	G	T	1	1	2	0	2	4	0	0
7	18780119	.	A	G	6	2	8	0	0	8	0	0
7	18780196	.	A	G	6	4	10	0	0	10	0	0
7	18810926	.	T	C	2	3	5	0	0	5	0	0
7	18810971	.	C	T	1	3	4	0	2	6	0	0
7	18810990	.	C	A	1	5	6	0	0	6	0	0
7	18811128	.	A	G	3	5	8	0	1	9	0	0
7	18876519	.	G	A	3	2	5	0	0	5	0	0
7	18971066	.	G	T	2	3	5	0	0	5	0	0
7	18971068	.	C	A	2	3	5	0	0	5	0	0
7	18983123	.	G	A	0	3	3	0	4	7	0	0
7	19055605	.	C	T	16	12	28	1	0	29	0	0
7	19065861	.	A	G	4	6	10	0	0	10	0	0
7	19070994	.	C	T	1	17	18	0	22	40	0	0
7	19071420	.	T	C	12	1	13	0	7	20	0	0
7	19071617	.	T	C	13	6	19	0	2	21	0	0
7	19071639	.	C	A	12	5	17	0	0	17	0	0
7	19072665	.	T	C	10	6	16	0	1	17	0	0
7	19072767	.	T	A	3	4	7	0	1	8	0	0
7	19073481	.	T	C	5	6	11	0	1	12	0	0
7	19073495	.	G	A	5	5	10	0	1	11	0	0
7	19073563	.	A	T	3	2	5	0	0	5	0	0
7	19073576	.	T	A	3	3	6	0	1	7	0	0
7	19073918	.	G	A	4	2	6	0	0	6	0	0
7	19074173	.	C	T	5	5	10	0	4	14	0	0
7	19074194	.	A	T	7	4	11	0	0	11	0	0
7	19074270	.	G	A	1	2	3	0	0	3	0	0
7	19074363	.	T	C	2	4	6	0	0	6	0	0
7	19075058	.	T	C	1	0	1	0	3	4	0	0
7	19179977	.	C	T	2	4	6	0	5	11	0	0
7	19180024	.	T	C	7	0	7	0	3	10	0	0
7	19180029	.	A	G	7	2	9	0	0	9	0	0
7	19180152	.	T	A	4	8	12	0	1	13	0	0
7	19180589	.	C	T	6	2	8	0	1	9	0	0
7	19681539	.	G	C	2	0	2	0	3	5	0	0
7	19684891	.	T	C	5	2	7	0	0	7	0	0
7	19745853	.	G	A	0	4	4	0	5	9	0	0
7	19753008	.	C	A	10	3	13	0	0	13	0	0
7	19753702	.	C	T	10	7	17	0	0	17	0	0
7	19759079	.	G	T	13	8	21	0	1	22	0	0
7	19759194	.	C	A	8	14	22	0	0	22	0	0
7	19759209	.	G	A	0	10	10	0	11	21	0	0
7	19759263	.	T	A	5	7	12	0	1	13	0	0
7	19759296	.	C	T	3	6	9	0	1	10	0	0
7	19759299	.	A	T	3	6	9	0	0	9	0	0
7	19759550	.	C	T	6	4	10	0	0	10	0	0
7	19759895	.	C	T	5	3	8	0	0	8	0	0
7	19892880	.	G	A	0	3	3	0	1	4	0	0
7	19895683	.	C	T	2	2	4	0	0	4	0	0
7	19896400	.	A	C	2	2	4	0	0	4	0	0
7	19897599	.	G	A	5	2	7	0	0	7	0	0
7	19897959	.	T	C	6	7	13	0	0	13	0	0
7	19899331	.	A	G	12	0	12	0	4	16	0	0
7	19909988	.	C	T	1	3	4	0	0	4	0	0
7	19909995	.	C	T	1	3	4	0	0	4	0	0
7	19961730	.	C	T	0	2	2	0	1	3	0	0
7	19965281	.	G	A	2	3	5	0	0	5	0	0
7	19978616	.	G	A	4	4	8	0	0	8	0	0
7	19978847	.	G	A	4	2	6	0	0	6	0	0
7	19978875	.	T	A	3	2	5	0	0	5	0	0
7	19979028	.	C	T	3	2	5	0	0	5	0	0
7	19979133	.	C	T	3	5	8	0	2	10	0	0
7	19979200	.	A	G	8	4	12	0	0	12	0	0
7	19979943	.	A	T	2	4	6	0	0	6	0	0
7	19979968	.	C	A	0	2	2	0	2	4	0	0
7	20024319	.	G	A	1	2	3	0	0	3	0	0
7	20026805	.	C	A	1	2	3	0	0	3	0	0
7	20027595	.	A	T	6	2	8	0	0	8	0	0
7	20027717	.	G	A	8	11	19	0	1	20	0	0
7	20027806	.	T	C	1	4	5	0	0	5	0	0
7	20027807	.	G	A	1	2	3	0	2	5	0	0
7	20027943	.	T	C	2	2	4	0	0	4	0	0
7	20028007	.	T	C	6	2	8	0	0	8	0	0
7	20028011	.	G	A	2	6	8	0	0	8	0	0
7	20118228	.	C	G	3	5	8	0	0	8	0	0
7	20118330	.	T	C	5	8	13	0	0	13	0	0
7	20141697	.	T	C	13	20	33	0	0	33	0	0
7	20141823	.	A	G	19	7	26	0	0	26	0	0
7	20141916	.	T	C	14	14	28	0	1	29	0	0
7	20142253	.	A	T	2	3	5	0	0	5	0	0
7	20142360	.	A	G	1	2	3	0	0	3	0	0
7	20142361	.	A	T	1	2	3	0	0	3	0	0
7	20142497	.	T	A	8	5	13	0	0	13	0	0
7	20142523	.	T	C	2	4	6	0	1	7	0	0
7	20176444	.	A	T	2	2	4	0	0	4	0	0
7	20222385	.	A	G	4	2	6	0	0	6	0	0
7	20222861	.	C	G	2	3	5	0	1	6	0	0
7	20222949	.	A	C	3	3	6	0	0	6	0	0
7	20222993	.	A	T	8	3	11	0	0	11	0	0
7	20223074	.	G	A	3	3	6	0	0	6	0	0
7	20223079	.	A	G	3	3	6	0	1	7	0	0
7	20223384	.	A	C	1	6	7	0	0	7	0	0
7	20223385	.	C	T	1	6	7	0	0	7	0	0
7	20223478	.	T	A	14	6	20	0	2	22	0	0
7	20223568	.	C	T	5	12	17	0	1	18	0	0
7	20223632	.	C	T	9	7	16	0	1	17	0	0
7	20298501	.	G	A	2	2	4	0	0	4	0	0
7	20298516	.	C	T	1	0	1	0	1	2	0	0
7	20298598	.	A	T	1	1	2	0	1	3	0	0
7	20301839	.	C	T	1	3	4	0	0	4	0	0
7	20302952	.	A	G	5	4	9	0	0	9	0	0
7	20305694	.	C	T	2	4	6	0	0	6	0	0
7	20305697	.	C	T	2	6	8	0	0	8	0	0
7	20310893	.	T	C	1	2	3	0	0	3	0	0
7	20310929	.	T	C	2	3	5	0	0	5	0	0
7	20315913	.	G	A	6	3	9	0	2	11	0	0
7	20325995	.	C	T	1	7	8	0	2	10	0	0
7	20332513	.	T	C	14	11	25	0	0	25	0	0
7	20332775	.	A	T	12	10	22	0	0	22	0	0
7	20332784	.	G	A	13	12	25	1	0	26	0	0
7	20332959	.	G	A	16	13	29	0	3	32	0	0
7	20332963	.	G	A	16	15	31	0	1	32	0	0
7	20333061	.	A	G	11	0	11	0	10	21	0	0
7	20333076	.	C	A	8	6	14	0	1	16	1	0
7	20333120	.	A	C	7	6	13	0	1	14	0	0
7	20333276	.	T	G	7	8	15	0	0	15	0	0
7	20334388	.	A	C	2	3	5	0	0	5	0	0
7	20334603	.	T	C	2	4	6	0	1	7	0	0
7	20335283	.	T	C	1	5	6	0	0	6	0	0
7	20335323	.	G	A	0	8	8	0	1	9	0	0
7	20335331	.	A	G	1	6	7	0	2	9	0	0
7	20529578	.	A	C	10	3	13	0	0	13	0	0
7	20529725	.	C	T	5	7	12	0	0	12	0	0
7	20529728	.	G	A	5	7	12	0	0	12	0	0
7	20529760	.	C	T	4	9	13	0	0	13	0	0
7	20529773	.	T	C	5	8	13	0	0	13	0	0
7	20530284	.	A	T	5	9	14	0	0	14	0	0
7	20530314	.	G	A	7	13	20	0	0	20	0	0
7	20530338	.	C	T	9	11	20	0	2	22	0	0
7	20530373	.	T	A	11	10	21	0	1	22	0	0
7	20542251	.	G	A	5	6	11	0	1	12	0	0
7	20542262	.	C	A	5	6	11	0	0	11	0	0
7	20587812	.	T	C	1	4	5	0	1	6	0	0
7	20588280	.	C	G	1	7	8	0	1	9	0	0
7	20593682	.	G	A	1	5	6	0	4	10	0	0
7	20593809	.	G	A	3	11	14	0	3	17	0	0
7	20597033	.	G	A	9	10	19	0	2	21	0	0
7	20597132	.	C	T	9	5	14	0	1	15	0	0
7	20600211	.	T	A	9	7	16	0	1	18	1	0
7	20600398	.	C	T	11	4	15	0	3	18	0	0
7	20600447	.	A	G	4	0	4	0	9	13	0	0
7	20601052	.	G	A	15	4	19	0	1	20	0	0
7	20601072	.	T	C	8	8	16	0	0	16	0	0
7	20601192	.	C	T	7	6	13	0	1	14	0	0
7	20601250	.	A	G	4	2	6	0	0	6	0	0
7	20601325	.	A	G	4	5	9	0	0	9	0	0
7	20601410	.	T	A	6	4	10	0	1	11	0	0
7	20601524	.	G	A	5	2	7	0	1	8	0	0
7	20601539	.	T	C	4	2	6	0	0	6	0	0
7	20601578	.	T	C	2	2	4	0	2	6	0	0
7	20601583	.	T	C	3	3	6	0	0	6	0	0
7	20601713	.	A	T	5	2	7	0	0	7	0	0
7	20601835	.	G	T	1	4	5	0	1	6	0	0
7	20601907	.	A	T	5	4	9	0	0	9	0	0
7	20602053	.	T	C	1	6	7	0	1	8	0	0
7	20634577	.	T	G	6	7	13	0	1	14	0	0
7	20635475	.	A	G	5	8	13	0	0	13	0	0
7	20635495	.	T	A	4	5	9	0	1	10	0	0
7	20635519	.	A	G	6	4	10	0	0	10	0	0
7	20635616	.	T	C	3	7	10	0	0	10	0	0
7	20635760	.	A	G	2	5	7	0	0	7	0	0
7	20636379	.	A	T	3	14	17	0	2	19	0	0
7	20636410	.	C	T	5	17	22	0	1	23	0	0
7	20636414	.	T	G	6	13	19	0	1	20	0	0
7	20636464	.	G	A	6	10	16	0	1	17	0	0
7	20636465	.	A	G	5	11	16	0	1	17	0	0
7	20636833	.	A	G	4	21	25	0	0	25	0	0
7	20636844	.	T	A	5	18	23	0	2	25	0	0
7	20693673	.	G	T	11	10	21	0	2	23	0	0
7	20695949	.	G	T	6	10	16	0	0	16	0	0
7	20698208	.	T	A	5	7	12	0	0	12	0	0
7	20712555	.	C	T	6	3	9	0	0	9	0	0
7	20715178	.	G	A	6	2	8	0	0	8	0	0
7	20731052	.	C	T	1	3	4	0	0	4	0	0
7	20731166	.	A	G	4	2	6	0	0	6	0	0
7	20772180	.	G	A	2	2	4	0	0	4	0	0
7	20780285	.	G	A	8	4	12	0	1	13	0	0
7	20780317	.	C	T	10	5	15	0	2	17	0	0
7	20780337	.	A	C	10	10	20	0	0	21	1	0
7	20780356	.	A	G	14	9	23	0	0	23	0	0
7	20780424	.	A	T	10	7	17	0	0	17	0	0
7	20780453	.	C	A	7	5	12	0	0	12	0	0
7	20780500	.	A	C	3	0	3	0	3	6	0	0
7	20780576	.	A	T	0	8	8	0	0	8	0	0
7	20780732	.	A	C	4	5	9	0	1	10	0	0
7	20780794	.	T	C	5	3	8	0	2	10	0	0
7	20780797	.	T	C	6	2	8	0	4	12	0	0
7	20780918	.	C	T	1	6	7	0	8	15	0	0
7	20780987	.	G	A	5	2	7	0	0	7	0	0
7	20781104	.	A	G	0	7	7	0	0	7	0	0
7	20781110	.	C	T	2	6	8	0	0	8	0	0
7	20781327	.	A	G	4	5	9	0	0	9	0	0
7	20781592	.	T	C	1	3	4	0	0	4	0	0
7	20781593	.	T	C	0	3	3	0	0	3	0	0
7	20781996	.	T	G	2	2	4	0	0	4	0	0
7	20784772	.	G	A	3	2	5	0	1	6	0	0
7	20859446	.	G	C	6	5	11	0	0	11	0	0
7	20859823	.	T	A	3	3	6	0	0	6	0	0
7	20864097	.	A	G	6	8	14	0	1	15	0	0
7	20864256	.	T	C	4	9	13	0	1	14	0	0
7	20892307	.	A	T	2	2	4	0	0	4	0	0
7	20935058	.	T	C	1	2	3	0	0	3	0	0
7	20935684	.	C	T	4	2	6	0	0	6	0	0
7	20935737	.	T	A	3	2	5	0	1	6	0	0
7	20935765	.	A	G	2	2	4	0	0	4	0	0
7	20938812	.	C	T	6	2	8	0	0	8	0	0
7	20938928	.	C	T	1	3	4	0	0	4	0	0
7	21626312	.	G	A	2	2	4	0	0	4	0	0
7	21768002	.	T	C	2	3	5	0	0	5	0	0
7	21768060	.	A	G	3	2	5	0	0	5	0	0
7	21768270	.	G	A	5	2	7	0	0	7	0	0
7	21768540	.	T	A	2	2	4	0	0	4	0	0
7	21769286	.	T	G	1	2	3	0	0	3	0	0
7	21769733	.	G	A	2	3	5	0	0	5	0	0
7	21772869	.	A	T	5	9	14	0	0	14	0	0
7	21773542	.	C	T	8	9	17	0	0	17	0	0
7	21773626	.	C	T	7	5	12	0	0	12	0	0
7	21774127	.	G	A	11	6	17	0	1	18	0	0
7	21776426	.	C	T	13	5	18	0	0	18	0	0
7	21776683	.	G	A	6	8	14	0	1	15	0	0
7	21776693	.	T	C	6	7	13	0	0	13	0	0
7	21777203	.	G	T	4	5	9	0	1	10	0	0
7	21777213	.	A	T	10	2	12	0	2	14	0	0
7	21777720	.	G	A	15	15	30	0	1	31	0	0
7	21777978	.	T	G	13	14	27	0	1	28	0	0
7	21778055	.	G	A	5	8	13	0	2	15	0	0
7	21778070	.	T	C	3	8	11	0	1	12	0	0
7	21778131	.	T	A	1	1	2	0	1	3	0	0
7	21873342	.	A	C	2	3	5	0	0	5	0	0
7	21873350	.	G	A	3	2	5	0	0	5	0	0
7	21878507	.	G	A	3	3	6	0	0	6	0	0
7	21881863	.	C	T	5	2	7	0	1	8	0	0
7	21887797	.	A	T	12	17	29	0	1	30	0	0
7	21887967	.	C	T	22	16	38	0	2	40	0	0
7	21888084	.	T	A	20	19	39	0	0	39	0	0
7	21888274	.	T	A	13	15	28	0	2	30	0	0
7	21891031	.	G	A	2	2	4	0	1	5	0	0
7	21891208	.	C	T	3	2	5	0	0	5	0	0
7	21891510	.	T	G	1	2	3	0	0	3	0	0
7	21917927	.	C	A	1	4	5	0	0	5	0	0
7	21940965	.	T	G	5	17	22	0	3	25	0	0
7	21940992	.	A	G	10	23	33	0	0	33	0	0
7	21941016	.	T	G	15	27	42	0	1	43	0	0
7	21941460	.	G	A	10	14	24	0	0	24	0	0
7	21941477	.	C	A	14	10	24	0	1	25	0	0
7	21941568	.	C	T	17	14	31	0	4	35	0	0
7	21941579	.	A	C	13	14	27	0	0	27	0	0
7	21942513	.	A	T	13	6	19	0	2	21	0	0
7	21942644	.	T	A	5	11	16	0	1	18	1	0
7	21942672	.	C	T	11	11	22	0	1	23	0	0
7	21943553	.	A	G	5	7	12	0	2	14	0	0
7	21943625	.	G	A	2	4	6	0	1	7	0	0
7	21943716	.	T	G	4	4	8	0	0	8	0	0
7	21943772	.	T	C	5	3	8	0	0	8	0	0
7	21945347	.	C	T	0	3	3	0	3	6	0	0
7	22324727	.	A	G	1	9	10	0	0	10	0	0
7	22793731	.	A	C	2	5	7	0	5	12	0	0
7	23750360	.	T	C	8	8	16	0	1	17	0	0
7	23751876	.	G	A	8	3	11	0	2	13	0	0
7	23907784	.	G	T	13	6	19	0	1	20	0	0
7	23909369	.	A	C	9	15	24	0	0	24	0	0
7	23909456	.	T	G	7	10	17	0	1	18	0	0
7	23915104	.	G	A	3	30	33	1	18	52	0	0
7	23915296	.	C	T	26	30	56	0	4	60	0	0
7	23915359	.	G	A	1	25	26	0	30	56	0	0
7	23915379	.	T	A	28	28	56	0	2	58	0	0
7	23915700	.	G	T	18	16	34	1	1	36	0	0
7	23915731	.	G	T	20	23	43	1	0	44	0	0
7	23915926	.	C	T	40	27	67	0	5	72	0	0
7	23915963	.	A	G	28	1	29	0	33	62	0	0
7	23915964	.	A	T	28	32	60	0	2	62	0	0
7	23967515	.	A	C	12	0	12	0	12	24	0	0
7	23967522	.	G	A	11	12	23	0	0	23	0	0
7	23967591	.	G	A	8	10	18	0	1	19	0	0
7	23967596	.	G	A	7	7	14	0	2	16	0	0
7	23967705	.	G	A	11	7	18	0	0	18	0	0
7	23967772	.	A	G	15	16	31	0	1	32	0	0
7	23967861	.	C	T	0	16	16	0	20	36	0	0
7	23967878	.	G	A	13	16	29	0	2	31	0	0
7	23967930	.	A	G	18	24	42	0	0	42	0	0
7	23968009	.	T	C	17	0	17	0	18	35	0	0
7	23968174	.	A	C	6	9	15	0	2	17	0	0
7	23968267	.	A	C	8	9	17	0	2	19	0	0
7	23968292	.	T	G	6	7	13	0	2	15	0	0
7	23968414	.	A	C	1	2	3	0	0	3	0	0
7	23969226	.	G	A	3	2	5	0	0	5	0	0
7	23969446	.	C	T	2	5	7	0	0	7	0	0
7	23969593	.	G	A	4	11	15	0	0	15	0	0
7	23970236	.	T	A	2	6	8	0	1	9	0	0
7	23970320	.	G	T	7	3	10	0	0	10	0	0
7	23970331	.	G	A	6	3	9	0	0	9	0	0
7	23970428	.	T	C	4	7	11	0	0	11	0	0
7	24011926	.	T	C	2	5	7	0	0	7	0	0
7	24012794	.	T	C	9	4	13	0	0	13	0	0
7	24013269	.	G	A	1	5	6	0	0	6	0	0
7	24013489	.	G	A	0	8	8	0	15	23	0	0
7	24033639	.	C	G	4	2	6	0	0	6	0	0
7	24034008	.	C	T	1	2	3	0	0	3	0	0
7	24034020	.	C	T	1	1	2	0	1	3	0	0
7	24041600	.	G	A	2	2	4	0	0	4	0	0
7	24043250	.	C	T	2	2	4	0	0	4	0	0
7	24043391	.	G	A	4	3	7	0	0	7	0	0
7	24053673	.	A	G	2	2	4	0	0	4	0	0
7	24059570	.	C	T	1	3	4	0	0	4	0	0
7	24059861	.	C	G	1	3	4	0	0	4	0	0
7	24059873	.	C	T	1	4	5	0	0	5	0	0
7	24068078	.	T	G	5	6	11	0	0	11	0	0
7	24068224	.	A	T	5	10	15	0	0	15	0	0
7	24068586	.	C	T	9	4	13	0	0	13	0	0
7	24068669	.	T	G	1	4	5	0	0	5	0	0
7	24068868	.	G	A	1	3	4	0	6	10	0	0
7	24072217	.	C	T	1	2	3	0	0	3	0	0
7	24075776	.	C	T	2	3	5	0	0	5	0	0
7	24075842	.	A	C	3	2	5	0	1	6	0	0
7	24076009	.	A	T	1	2	3	0	0	3	0	0
7	24076269	.	C	T	1	4	5	0	0	5	0	0
7	24076329	.	C	T	3	3	6	0	1	7	0	0
7	24076583	.	T	A	6	2	8	0	0	8	0	0
7	24076599	.	A	T	6	5	11	0	0	11	0	0
7	24084783	.	C	T	4	6	10	0	0	10	0	0
7	24084879	.	C	T	4	6	10	0	0	10	0	0
7	24087362	.	A	T	4	2	6	0	0	6	0	0
7	24087365	.	T	C	2	4	6	0	1	7	0	0
7	24087724	.	C	A	2	4	6	0	0	6	0	0
7	24090182	.	G	A	4	5	9	0	2	11	0	0
7	24091054	.	G	A	13	11	24	0	0	24	0	0
7	24091269	.	G	A	1	4	5	0	9	14	0	0
7	24092626	.	C	T	12	5	17	0	0	17	0	0
7	24093165	.	C	G	15	15	30	0	0	30	0	0
7	24093300	.	C	T	13	14	27	1	1	29	0	0
7	24093301	.	A	C	13	13	26	1	2	29	0	0
7	24093372	.	A	G	13	23	36	0	0	36	0	0
7	24095515	.	C	G	27	19	46	0	1	47	0	0
7	24095717	.	G	A	3	16	19	1	19	39	0	0
7	24095776	.	G	A	14	19	33	0	2	35	0	0
7	24095788	.	A	G	10	19	29	0	0	30	1	0
7	24095836	.	C	T	17	7	24	0	1	25	0	0
7	24095848	.	G	A	16	9	25	0	2	27	0	0
7	24095883	.	T	A	18	15	33	0	1	34	0	0
7	24095926	.	A	C	18	15	33	0	2	35	0	0
7	24095978	.	T	A	27	13	40	0	1	41	0	0
7	24096399	.	C	A	15	17	32	0	2	34	0	0
7	24096505	.	G	A	1	12	13	0	16	29	0	0
7	24096541	.	C	T	14	13	27	0	0	27	0	0
7	24096767	.	A	C	15	27	42	0	3	45	0	0
7	24115186	.	G	A	16	10	26	0	0	26	0	0
7	24156994	.	G	A	0	4	4	0	1	5	0	0
7	24158843	.	A	G	2	0	2	0	4	6	0	0
7	24161591	.	C	A	9	4	13	0	3	16	0	0
7	24161648	.	G	A	1	7	8	0	6	14	0	0
7	24162019	.	G	A	1	5	6	0	0	6	0	0
7	24162368	.	A	T	5	10	15	0	2	17	0	0
7	24162369	.	A	C	8	10	18	0	0	18	0	0
7	24162485	.	C	T	13	12	25	0	0	25	0	0
7	24162567	.	T	C	9	6	15	0	0	15	0	0
7	24162761	.	G	T	7	4	11	0	0	11	0	0
7	24197574	.	C	A	4	4	8	0	0	8	0	0
7	24197607	.	A	T	2	3	5	0	3	8	0	0
7	24198170	.	C	A	6	4	10	0	1	11	0	0
7	24198334	.	C	T	2	4	6	0	0	6	0	0
7	24198335	.	C	T	0	4	4	0	2	6	0	0
7	24207520	.	A	C	20	15	35	0	0	35	0	0
7	24207552	.	A	G	19	0	19	0	21	40	0	0
7	24207590	.	A	T	23	25	48	0	1	49	0	0
7	24207632	.	G	C	19	13	32	0	3	35	0	0
7	24210323	.	C	A	0	17	17	0	16	33	0	0
7	24210422	.	T	C	16	8	24	0	4	28	0	0
7	24210629	.	T	A	19	14	33	1	2	36	0	0
7	24210659	.	A	G	19	19	38	1	2	41	0	0
7	24210676	.	A	G	17	18	35	0	5	40	0	0
7	24211015	.	A	T	12	8	20	1	2	23	0	0
7	24211054	.	G	A	13	9	22	3	0	25	0	0
7	24211081	.	T	A	11	9	20	2	0	22	0	0
7	24211342	.	C	T	0	8	8	0	13	21	0	0
7	24211443	.	C	T	0	8	8	0	12	20	0	0
7	24211522	.	G	A	7	3	10	0	0	10	0	0
7	24211542	.	G	T	5	2	7	0	0	7	0	0
7	24211560	.	A	T	1	4	5	0	0	5	0	0
7	24211646	.	C	T	0	2	2	0	2	4	0	0
7	24211978	.	G	A	6	10	16	2	0	18	0	0
7	24212093	.	C	G	8	9	17	0	0	17	0	0
7	24212122	.	T	C	8	5	13	0	1	14	0	0
7	24212159	.	G	C	8	1	9	0	7	16	0	0
7	24212383	.	G	A	13	8	21	0	0	21	0	0
7	24214655	.	C	T	5	4	9	0	1	10	0	0
7	24214673	.	C	A	4	4	8	0	0	8	0	0
7	24457691	.	C	A	27	25	52	0	4	56	0	0
7	24457788	.	C	A	28	18	46	0	1	47	0	0
7	24457803	.	A	C	28	16	44	0	1	45	0	0
7	24458103	.	C	A	23	14	37	0	2	39	0	0
7	24458128	.	G	C	22	16	38	0	1	39	0	0
7	24458205	.	G	A	37	11	48	0	1	49	0	0
7	24458282	.	C	T	25	11	36	0	1	37	0	0
7	24458339	.	A	G	26	18	44	0	1	45	0	0
7	24458866	.	T	C	16	16	32	0	2	34	0	0
7	24458894	.	T	A	14	13	27	0	3	30	0	0
7	24459452	.	G	A	15	13	28	0	0	28	0	0
7	24459847	.	A	G	18	16	34	0	1	35	0	0
7	24459932	.	T	C	17	20	37	0	1	38	0	0
7	24460025	.	G	A	9	11	20	0	0	20	0	0
7	24460026	.	C	T	8	9	17	0	3	20	0	0
7	24460189	.	T	C	8	5	13	0	1	14	0	0
7	24460443	.	G	A	9	12	21	0	3	24	0	0
7	24460461	.	G	A	11	10	21	0	4	25	0	0
7	24461115	.	A	C	4	10	14	0	0	14	0	0
7	24461298	.	G	A	5	4	9	0	0	9	0	0
7	24461601	.	A	G	6	4	10	0	0	10	0	0
7	24462394	.	A	G	5	7	12	0	0	12	0	0
7	24470812	.	A	G	3	7	10	0	0	10	0	0
7	24485944	.	T	C	5	2	7	0	0	7	0	0
7	24486345	.	A	G	20	28	48	0	3	51	0	0
7	24486515	.	A	C	29	34	63	0	3	66	0	0
7	24486546	.	G	C	28	29	57	0	3	62	2	0
7	24486721	.	G	A	31	32	63	0	3	66	0	0
7	24486822	.	G	A	42	24	66	0	1	67	0	0
7	24489888	.	A	G	23	25	48	0	0	48	0	0
7	24498912	.	C	T	8	5	13	0	0	13	0	0
7	24501156	.	T	C	2	2	4	0	1	5	0	0
7	24504508	.	C	T	7	8	15	0	0	15	0	0
7	24504875	.	C	T	14	5	19	0	0	19	0	0
7	24505063	.	A	G	7	5	12	0	1	13	0	0
7	24569961	.	T	C	3	4	7	0	0	7	0	0
7	24569990	.	T	G	2	2	4	0	1	5	0	0
7	24570012	.	A	T	2	4	6	0	1	7	0	0
7	24570714	.	G	A	1	4	5	0	6	11	0	0
7	24570973	.	G	A	2	3	5	0	0	5	0	0
7	24581191	.	C	T	0	2	2	0	1	3	0	0
7	24581458	.	T	A	5	2	7	0	0	7	0	0
7	24593439	.	T	C	15	12	27	0	3	30	0	0
7	24593452	.	T	A	17	13	30	0	0	30	0	0
7	24594860	.	T	A	18	8	26	0	0	26	0	0
7	24598728	.	G	T	8	4	12	0	0	12	0	0
7	24603028	.	G	T	5	5	10	0	0	10	0	0
7	24603231	.	C	T	1	3	4	0	7	11	0	0
7	24632080	.	C	T	1	7	8	0	9	17	0	0
7	24640622	.	T	C	2	3	5	0	0	5	0	0
7	24651636	.	C	T	4	2	6	0	0	6	0	0
7	24651645	.	G	A	2	3	5	0	0	5	0	0
7	24655086	.	T	A	1	3	4	0	0	4	0	0
7	24655094	.	T	C	1	3	4	0	0	4	0	0
7	24655261	.	A	G	1	4	5	0	0	5	0	0
7	24658938	.	G	A	0	3	3	0	4	7	0	0
7	24663995	.	T	C	1	5	6	0	0	6	0	0
7	24672147	.	A	G	12	0	12	0	12	24	0	0
7	24672257	.	G	C	11	15	26	0	0	26	0	0
7	24672721	.	G	T	0	3	3	0	2	5	0	0
7	24672766	.	A	G	3	4	7	0	0	7	0	0
7	24681673	.	A	G	14	18	32	0	2	34	0	0
7	24681731	.	T	C	13	13	26	0	4	30	0	0
7	24681755	.	A	G	16	11	27	0	1	28	0	0
7	24681806	.	A	G	12	11	23	0	2	25	0	0
7	24715143	.	G	A	1	2	3	0	1	4	0	0
7	24715168	.	A	C	3	1	4	0	0	4	0	0
7	24715870	.	C	T	0	3	3	0	2	5	0	0
7	24715879	.	C	T	2	3	5	0	0	5	0	0
7	24716169	.	G	A	1	2	3	0	0	3	0	0
7	24716172	.	G	A	1	2	3	0	0	3	0	0
7	24716258	.	C	T	3	3	6	0	3	9	0	0
7	24716393	.	G	T	1	3	4	0	0	4	0	0
7	24812267	.	C	T	2	2	4	0	0	4	0	0
7	24812587	.	C	T	4	2	6	0	0	6	0	0
7	24812783	.	A	G	1	0	1	0	4	5	0	0
7	24815992	.	C	T	8	8	16	0	1	17	0	0
7	24819788	.	G	A	19	13	32	0	0	32	0	0
7	24819812	.	G	A	17	14	31	0	0	31	0	0
7	24822914	.	G	A	9	7	16	0	2	18	0	0
7	24888052	.	A	C	1	2	3	0	0	3	0	0
7	24974916	.	T	C	8	6	14	1	0	15	0	0
7	24974937	.	T	C	5	7	12	1	0	13	0	0
7	24975264	.	T	C	7	8	15	0	1	16	0	0
7	24975646	.	C	T	10	12	22	0	0	22	0	0
7	24975678	.	G	A	11	13	24	0	1	25	0	0
7	24976245	.	T	A	19	10	29	1	1	31	0	0
7	24976539	.	T	C	19	18	37	0	0	37	0	0
7	24979979	.	A	G	7	8	15	0	1	16	0	0
7	24980107	.	T	G	10	5	15	0	0	15	0	0
7	24980185	.	T	G	5	6	11	0	2	13	0	0
7	24980469	.	C	T	9	12	21	0	0	21	0	0
7	25010745	.	C	T	22	12	34	0	0	34	0	0
7	25011238	.	A	G	18	10	28	0	1	29	0	0
7	25011375	.	T	C	4	6	10	0	0	10	0	0
7	25011585	.	T	G	5	6	11	0	1	12	0	0
7	25015154	.	C	T	1	3	4	0	0	4	0	0
7	25017967	.	G	C	6	2	8	0	0	8	0	0
7	25018043	.	G	T	1	2	3	0	0	3	0	0
7	25021718	.	C	T	1	2	3	0	1	4	0	0
7	25024266	.	T	C	4	5	9	0	1	10	0	0
7	25024277	.	A	T	7	6	13	0	0	13	0	0
7	25024346	.	G	C	2	9	11	1	2	14	0	0
7	25026873	.	C	T	4	6	10	0	0	10	0	0
7	25026960	.	C	T	1	4	5	0	0	5	0	0
7	25027022	.	T	C	5	4	9	0	0	9	0	0
7	25027034	.	A	G	4	5	9	0	0	9	0	0
7	25027266	.	T	C	3	3	6	0	1	7	0	0
7	25027466	.	C	A	5	3	8	0	0	8	0	0
7	25027561	.	C	T	5	4	9	0	1	10	0	0
7	25027571	.	A	G	8	5	13	0	0	13	0	0
7	25027756	.	T	C	6	4	10	0	1	11	0	0
7	25028034	.	C	T	6	9	15	0	0	15	0	0
7	25028081	.	A	G	8	9	17	0	0	17	0	0
7	25028085	.	G	C	8	11	19	0	0	19	0	0
7	25028205	.	T	A	8	6	14	1	0	15	0	0
7	25029003	.	T	C	5	5	10	0	0	10	0	0
7	25029129	.	C	T	3	10	13	0	0	13	0	0
7	25029140	.	T	A	2	10	12	0	2	14	0	0
7	25029169	.	G	A	3	11	14	0	0	14	0	0
7	25029191	.	G	A	0	6	6	0	3	9	0	0
7	25042942	.	A	C	12	6	18	0	1	19	0	0
7	25045777	.	A	G	10	7	17	0	0	17	0	0
7	25047307	.	G	C	4	8	12	0	1	13	0	0
7	25047318	.	A	C	6	12	18	0	1	19	0	0
7	25047604	.	T	A	10	12	22	0	0	22	0	0
7	25047954	.	G	A	14	12	26	0	2	28	0	0
7	25049262	.	A	G	4	9	13	0	0	13	0	0
7	25059856	.	C	T	4	2	6	0	0	6	0	0
7	25096889	.	T	C	7	8	15	0	0	15	0	0
7	25098910	.	G	A	20	26	46	0	2	48	0	0
7	25099133	.	A	G	28	3	31	0	16	47	0	0
7	25099302	.	T	C	8	12	20	0	0	20	0	0
7	25099594	.	T	G	13	7	20	0	2	22	0	0
7	25099704	.	T	C	19	13	32	0	3	35	0	0
7	25129180	.	G	T	2	2	4	0	1	5	0	0
7	25129213	.	A	C	1	2	3	0	1	4	0	0
7	25129868	.	T	C	2	2	4	0	0	4	0	0
7	25129889	.	A	G	2	2	4	0	0	4	0	0
7	25293261	.	T	C	4	4	8	0	0	8	0	0
7	25293666	.	A	G	3	6	9	0	0	9	0	0
7	25346765	.	T	C	3	2	5	0	0	5	0	0
7	25346924	.	G	C	2	3	5	0	7	12	0	0
7	25347024	.	C	T	3	5	8	1	1	10	0	0
7	25347459	.	T	G	12	18	30	0	1	31	0	0
7	25347679	.	A	T	7	4	11	0	0	11	0	0
7	25348031	.	C	T	6	5	11	0	0	11	0	0
7	25348396	.	A	T	0	2	2	0	1	3	0	0
7	25559093	.	A	G	4	3	7	0	0	7	0	0
7	25559814	.	C	T	2	2	4	0	0	4	0	0
7	25854239	.	T	C	4	2	6	0	0	6	0	0
7	25854245	.	C	G	3	2	5	0	0	5	0	0
7	25863708	.	C	T	6	3	9	0	1	10	0	0
7	25869617	.	C	T	4	4	8	0	0	8	0	0
7	25872580	.	C	T	9	5	14	0	0	14	0	0
7	25872691	.	G	A	0	3	3	0	4	7	0	0
7	25873009	.	C	T	13	5	18	0	0	18	0	0
7	25873601	.	A	T	13	6	19	0	0	19	0	0
7	25873728	.	T	G	10	0	10	0	13	23	0	0
7	25873743	.	C	A	12	12	24	0	1	25	0	0
7	25873857	.	T	C	10	5	15	0	3	18	0	0
7	25876947	.	A	C	8	6	14	0	1	15	0	0
7	25877033	.	A	T	12	5	17	0	0	17	0	0
7	25877038	.	G	A	14	3	17	0	2	19	0	0
7	25877420	.	T	C	18	9	27	0	0	27	0	0
7	25877445	.	G	C	17	10	27	0	0	27	0	0
7	25877615	.	A	G	1	1	2	0	1	3	0	0
7	25878417	.	T	G	11	12	23	0	1	24	0	0
7	25878642	.	G	T	23	14	37	0	2	39	0	0
7	25878723	.	A	C	23	20	43	0	2	45	0	0
7	25878786	.	C	T	2	26	28	0	27	55	0	0
7	25878849	.	T	C	20	18	38	0	7	45	0	0
7	25878977	.	A	G	21	19	40	0	2	42	0	0
7	25879116	.	T	G	15	23	38	0	5	43	0	0
7	25879130	.	G	C	19	28	47	0	1	48	0	0
7	25879514	.	T	A	20	22	42	0	0	42	0	0
7	25879905	.	G	A	16	19	35	0	0	35	0	0
7	25879920	.	G	T	17	13	30	0	0	30	0	0
7	25880033	.	A	T	13	9	22	0	3	25	0	0
7	25880046	.	C	A	10	11	21	0	2	23	0	0
7	25880226	.	G	A	8	4	12	0	1	13	0	0
7	25880313	.	T	A	16	11	27	0	0	27	0	0
7	25880340	.	C	T	1	12	13	0	16	29	0	0
7	25880754	.	C	T	0	7	7	0	8	15	0	0
7	25880843	.	G	A	3	8	11	0	0	11	0	0
7	25881583	.	G	A	11	2	13	1	2	16	0	0
7	25881605	.	A	C	6	6	12	1	2	15	0	0
7	25884007	.	G	T	6	3	9	0	0	9	0	0
7	25884148	.	A	G	4	8	12	0	0	12	0	0
7	25917046	.	A	G	31	31	62	0	5	67	0	0
7	25917473	.	G	A	4	23	27	3	34	64	0	0
7	25917634	.	A	T	30	36	66	0	4	70	0	0
7	25918056	.	C	T	26	42	68	3	2	73	0	0
7	25918101	.	T	G	27	3	30	0	35	65	0	0
7	25920966	.	A	G	5	0	5	0	5	10	0	0
7	25979203	.	T	C	2	2	4	0	1	5	0	0
7	25979417	.	C	T	7	7	14	0	0	14	0	0
7	25979468	.	C	T	13	5	18	0	0	18	0	0
7	25979510	.	T	C	12	10	22	0	0	22	0	0
7	25986069	.	G	T	2	8	10	0	10	20	0	0
7	25986099	.	C	T	9	11	20	0	1	21	0	0
7	25988324	.	C	A	8	7	15	0	1	16	0	0
7	26002674	.	C	T	14	17	31	0	3	34	0	0
7	26002915	.	T	A	15	14	29	0	3	32	0	0
7	26003853	.	C	T	3	2	5	0	1	6	0	0
7	26004616	.	A	G	12	4	16	0	2	18	0	0
7	26004876	.	T	A	8	8	16	0	1	17	0	0
7	26004907	.	A	G	10	0	10	0	4	14	0	0
7	26004922	.	C	T	10	2	12	0	0	12	0	0
7	26004951	.	A	G	12	4	16	0	1	17	0	0
7	26005033	.	A	G	6	6	12	0	0	12	0	0
7	26005574	.	A	T	3	4	7	0	1	8	0	0
7	26015376	.	C	T	5	2	7	0	0	7	0	0
7	26015378	.	A	G	4	2	6	0	1	7	0	0
7	26015544	.	G	T	2	3	5	0	1	6	0	0
7	26015595	.	C	A	2	2	4	0	1	5	0	0
7	26015628	.	T	C	3	3	6	0	0	6	0	0
7	26015663	.	T	C	6	8	14	0	0	14	0	0
7	26015693	.	C	A	10	8	18	0	0	18	0	0
7	26020078	.	T	C	9	5	14	0	0	14	0	0
7	26020192	.	C	T	4	4	8	0	1	9	0	0
7	26020273	.	G	A	1	12	13	0	5	18	0	0
7	26020370	.	T	C	5	5	10	0	1	11	0	0
7	26020408	.	A	C	5	4	9	0	1	10	0	0
7	26020659	.	C	T	16	11	27	0	1	28	0	0
7	26021146	.	A	G	16	14	30	0	3	33	0	0
7	26026114	.	A	G	11	0	11	0	17	28	0	0
7	26026176	.	C	T	10	13	23	0	2	25	0	0
7	26026188	.	C	A	12	14	26	0	1	27	0	0
7	26026241	.	G	A	13	10	23	0	0	23	0	0
7	26026264	.	C	G	13	6	19	0	1	20	0	0
7	26026298	.	T	G	9	0	9	0	7	16	0	0
7	26026330	.	A	T	12	8	20	0	1	21	0	0
7	26026358	.	A	C	9	5	14	0	0	15	1	0
7	26026379	.	C	T	6	3	9	0	0	9	0	0
7	26026491	.	T	G	4	4	8	0	0	8	0	0
7	26048364	.	T	A	1	2	3	0	0	3	0	0
7	26048541	.	G	A	1	2	3	0	0	3	0	0
7	26057418	.	C	T	2	2	4	0	0	4	0	0
7	26076368	.	A	G	3	4	7	0	1	8	0	0
7	26076458	.	A	T	1	3	4	0	0	4	0	0
7	26077845	.	G	T	20	21	41	0	0	41	0	0
7	26077947	.	T	A	22	25	47	0	1	48	0	0
7	26077949	.	C	T	23	24	47	0	1	48	0	0
7	26078061	.	T	C	10	22	32	2	2	36	0	0
7	26078243	.	A	C	20	24	44	0	2	46	0	0
7	26078284	.	C	T	21	19	40	0	4	44	0	0
7	26078345	.	T	A	24	20	44	0	1	45	0	0
7	26078435	.	G	T	11	6	17	0	1	18	0	0
7	26078516	.	T	A	17	5	22	0	2	24	0	0
7	26078897	.	G	A	20	11	31	0	4	35	0	0
7	26078947	.	G	A	18	9	27	0	0	27	0	0
7	26079370	.	T	G	12	23	35	0	0	35	0	0
7	26079667	.	C	G	3	10	13	0	19	32	0	0
7	26081171	.	C	T	6	6	12	0	0	12	0	0
7	26081252	.	A	G	8	9	17	0	0	17	0	0
7	26081744	.	T	C	4	3	7	0	1	8	0	0
7	26116397	.	A	G	1	2	3	0	0	3	0	0
7	26141394	.	G	C	1	2	3	0	0	3	0	0
7	26141568	.	T	A	1	6	7	0	1	8	0	0
7	26142339	.	T	C	4	2	6	0	0	6	0	0
7	26142525	.	T	G	4	0	4	0	2	6	0	0
7	26142702	.	A	G	3	3	6	0	0	6	0	0
7	26143760	.	G	A	4	6	10	0	0	10	0	0
7	26145605	.	T	C	11	14	25	0	0	25	0	0
7	26145873	.	C	T	1	2	3	0	0	3	0	0
7	26145910	.	T	C	1	2	3	0	1	4	0	0
7	26146176	.	A	C	15	14	29	0	0	29	0	0
7	26146188	.	T	C	16	17	33	0	2	35	0	0
7	26146796	.	A	G	29	0	29	0	12	41	0	0
7	26146993	.	C	T	28	24	52	0	3	55	0	0
7	26148181	.	A	C	35	20	55	1	5	61	0	0
7	26148263	.	A	G	43	11	54	0	2	56	0	0
7	26148312	.	T	G	25	19	44	0	0	45	1	0
7	26148773	.	G	A	3	3	6	0	0	6	0	0
7	26148796	.	C	T	3	4	7	0	0	7	0	0
7	26149252	.	G	A	31	32	63	0	1	64	0	0
7	26149690	.	C	T	26	28	54	0	5	59	0	0
7	26150096	.	T	A	22	19	41	0	2	43	0	0
7	26224365	.	A	T	3	3	6	0	0	6	0	0
7	26226772	.	G	C	3	4	7	0	1	8	0	0
7	26227119	.	C	T	6	3	9	0	0	9	0	0
7	26227149	.	C	T	5	2	7	0	0	7	0	0
7	26227527	.	T	C	5	3	8	0	0	8	0	0
7	26227539	.	T	C	5	2	7	0	0	7	0	0
7	26228290	.	C	T	14	15	29	0	3	32	0	0
7	26228639	.	T	C	17	22	39	0	2	41	0	0
7	26229449	.	G	A	13	12	25	0	2	27	0	0
7	26229529	.	C	T	25	20	45	0	1	46	0	0
7	26229551	.	T	A	37	14	51	0	6	57	0	0
7	26229640	.	T	C	24	25	49	0	7	56	0	0
7	26229935	.	C	T	19	22	41	0	1	42	0	0
7	26229979	.	A	G	6	12	18	1	6	25	0	0
7	26245668	.	T	C	7	14	21	0	3	24	0	0
7	26245714	.	A	T	13	14	27	0	0	27	0	0
7	26263153	.	C	T	3	2	5	0	0	5	0	0
7	26265832	.	C	A	1	2	3	0	2	5	0	0
7	26265917	.	T	C	2	2	4	0	0	4	0	0
7	26265961	.	G	A	1	4	5	0	0	5	0	0
7	26266069	.	G	C	3	7	10	0	0	10	0	0
7	26300117	.	A	T	2	3	5	0	0	5	0	0
7	26300118	.	G	A	2	3	5	0	0	5	0	0
7	26300184	.	A	G	3	3	6	0	0	6	0	0
7	26300263	.	A	G	10	7	17	0	0	17	0	0
7	26300359	.	A	G	4	7	11	0	0	11	0	0
7	26300955	.	T	C	2	0	2	0	3	5	0	0
7	26366620	.	T	C	10	12	22	0	0	22	0	0
7	26366684	.	C	T	9	15	24	0	0	24	0	0
7	26366778	.	G	A	9	12	21	0	0	21	0	0
7	26366919	.	G	A	8	5	13	0	1	14	0	0
7	26367056	.	T	C	7	0	7	0	8	15	0	0
7	26367280	.	C	T	0	2	2	0	8	10	0	0
7	26367470	.	C	G	12	6	18	0	0	18	0	0
7	26367486	.	A	C	9	6	15	0	0	15	0	0
7	26367525	.	A	G	4	7	11	0	1	12	0	0
7	26367797	.	T	C	1	2	3	0	0	3	0	0
7	26367944	.	G	A	4	4	8	0	1	9	0	0
7	26368080	.	T	A	4	7	11	0	1	12	0	0
7	26368240	.	C	A	2	2	4	0	1	5	0	0
7	26368291	.	A	C	1	3	4	0	0	4	0	0
7	26368333	.	A	T	3	3	6	0	1	7	0	0
7	26368483	.	T	A	2	5	7	0	0	7	0	0
7	26368637	.	T	C	2	2	4	0	0	4	0	0
7	26368836	.	A	T	1	4	5	0	1	6	0	0
7	26368955	.	G	T	2	3	5	0	0	5	0	0
7	26369030	.	C	T	3	4	7	0	0	7	0	0
7	26369034	.	G	C	4	3	7	0	0	7	0	0
7	26369439	.	T	C	1	2	3	0	0	3	0	0
7	26369440	.	G	T	1	2	3	0	0	3	0	0
7	26369583	.	A	C	3	0	3	0	3	6	0	0
7	26371702	.	G	A	3	2	5	0	0	5	0	0
7	26371711	.	G	A	3	3	6	0	1	7	0	0
7	26394208	.	A	T	17	21	38	1	3	42	0	0
7	26394285	.	A	T	15	12	27	0	3	30	0	0
7	26394382	.	C	T	3	18	21	0	10	31	0	0
7	26394476	.	G	A	15	19	34	0	2	36	0	0
7	26394791	.	A	G	11	22	33	0	2	35	0	0
7	26394848	.	G	A	13	11	24	0	1	25	0	0
7	26394951	.	T	A	12	3	15	0	1	16	0	0
7	26395538	.	T	C	10	11	21	0	0	21	0	0
7	26395778	.	T	G	6	4	10	0	1	11	0	0
7	26396560	.	C	G	3	4	7	0	0	7	0	0
7	26396768	.	G	A	8	8	16	0	0	16	0	0
7	26396915	.	A	C	1	3	4	0	0	4	0	0
7	26397096	.	T	C	4	0	4	0	4	8	0	0
7	26397243	.	G	A	6	3	9	0	0	9	0	0
7	26397475	.	T	A	2	4	6	0	0	6	0	0
7	26397541	.	G	A	7	2	9	0	0	9	0	0
7	26397760	.	C	T	5	4	9	0	1	10	0	0
7	26398159	.	A	T	3	5	8	0	0	8	0	0
7	26398351	.	A	G	2	2	4	0	0	4	0	0
7	26398867	.	G	A	2	3	5	0	0	5	0	0
7	26432105	.	G	A	2	2	4	0	0	4	0	0
7	26432464	.	A	T	3	2	5	0	0	5	0	0
7	26457046	.	G	C	1	0	1	0	5	6	0	0
7	26457085	.	A	G	3	2	5	0	1	6	0	0
7	26457103	.	C	T	0	3	3	0	2	5	0	0
7	26469820	.	G	A	0	2	2	0	2	4	0	0
7	26472340	.	A	C	7	3	10	0	2	12	0	0
7	26472346	.	A	T	6	4	10	0	1	11	0	0
7	26472398	.	C	T	6	8	14	0	0	14	0	0
7	26472413	.	A	G	3	7	10	0	2	12	0	0
7	26472512	.	G	T	2	4	6	0	0	6	0	0
7	26473040	.	A	G	5	0	5	0	9	14	0	0
7	26511439	.	A	T	15	20	35	0	4	39	0	0
7	26511691	.	G	A	20	29	49	0	4	53	0	0
7	26511760	.	A	G	21	15	36	0	1	37	0	0
7	26511801	.	T	G	18	12	30	0	3	33	0	0
7	26519052	.	A	G	8	7	15	0	0	15	0	0
7	26519150	.	A	T	15	10	25	0	3	28	0	0
7	26522358	.	T	C	9	7	16	0	2	18	0	0
7	26522364	.	C	T	11	6	17	0	2	19	0	0
7	26523169	.	A	G	5	8	13	0	0	13	0	0
7	26525463	.	C	T	5	3	8	0	0	8	0	0
7	27450188	.	C	T	0	3	3	0	1	4	0	0
7	27681025	.	G	T	7	10	17	0	1	18	0	0
7	27681071	.	A	T	13	12	25	0	0	25	0	0
7	27682919	.	C	T	8	11	19	0	0	19	0	0
7	27700517	.	G	A	18	9	27	0	0	27	0	0
7	27700777	.	C	T	2	10	12	0	15	27	0	0
7	27701155	.	C	G	0	3	3	0	3	6	0	0
7	27701231	.	T	A	8	4	12	0	0	12	0	0
7	27701348	.	A	C	3	4	7	0	0	7	0	0
7	27701561	.	A	T	8	7	15	0	0	15	0	0
7	27701623	.	C	A	4	8	12	0	0	12	0	0
7	27701634	.	A	G	5	5	10	0	0	10	0	0
7	27702003	.	A	C	2	4	6	0	0	6	0	0
7	27702571	.	T	G	6	6	12	0	1	13	0	0
7	27702934	.	G	A	3	4	7	0	0	7	0	0
7	27702998	.	T	A	7	3	10	0	0	10	0	0
7	27703102	.	T	C	6	6	12	0	2	14	0	0
7	27705837	.	G	A	2	4	6	0	1	7	0	0
7	27720520	.	A	G	3	1	4	0	1	5	0	0
7	27722513	.	A	G	1	3	4	0	0	4	0	0
7	27806074	.	G	A	0	4	4	0	2	6	0	0
7	27811770	.	C	T	2	5	7	0	0	7	0	0
7	27813749	.	C	T	6	3	9	0	1	10	0	0
7	27813942	.	G	A	1	7	8	0	0	8	0	0
7	27813978	.	A	G	3	0	3	0	6	9	0	0
7	27814326	.	C	T	5	10	15	0	0	15	0	0
7	27816668	.	T	C	12	8	20	0	0	20	0	0
7	27816875	.	C	T	10	10	20	0	2	22	0	0
7	27817229	.	C	A	17	12	29	0	2	31	0	0
7	27817283	.	A	G	24	0	24	0	12	36	0	0
7	27817755	.	G	C	18	19	37	0	1	38	0	0
7	27820177	.	G	A	5	9	14	0	0	14	0	0
7	27820838	.	G	A	2	4	6	0	2	8	0	0
7	27884211	.	A	G	3	3	6	0	0	6	0	0
7	27884904	.	A	G	2	2	4	0	0	4	0	0
7	27884908	.	A	G	2	0	2	0	2	4	0	0
7	27885118	.	T	C	1	2	3	0	0	3	0	0
7	27885703	.	A	T	3	4	7	0	0	7	0	0
7	27885706	.	C	T	3	4	7	0	0	7	0	0
7	27885941	.	G	A	8	4	12	0	1	13	0	0
7	27886602	.	C	A	7	9	16	0	0	16	0	0
7	27886923	.	A	G	12	7	19	0	1	20	0	0
7	27886924	.	A	G	13	7	20	0	0	20	0	0
7	27887044	.	T	A	14	8	22	0	1	23	0	0
7	28039990	.	G	A	0	2	2	0	1	3	0	0
7	28041246	.	T	G	1	0	1	0	2	3	0	0
7	28041842	.	T	C	1	2	3	0	0	3	0	0
7	28042060	.	G	A	1	3	4	0	1	5	0	0
7	28043416	.	A	G	1	3	4	0	0	4	0	0
7	28043837	.	T	G	1	0	1	0	4	5	0	0
7	28043852	.	G	A	3	4	7	0	1	8	0	0
7	28044193	.	A	G	3	9	12	0	0	12	0	0
7	28045160	.	G	A	0	5	5	1	3	9	0	0
7	28045263	.	C	G	7	3	10	0	3	13	0	0
7	28045318	.	G	A	4	5	9	0	1	10	0	0
7	28045323	.	C	A	3	4	7	0	2	9	0	0
7	28045444	.	T	A	4	4	8	0	0	8	0	0
7	28045600	.	C	T	7	5	12	1	1	14	0	0
7	28046436	.	T	C	10	7	17	1	0	18	0	0
7	28046530	.	A	G	12	14	26	0	0	26	0	0
7	28046572	.	T	C	15	7	22	0	2	24	0	0
7	28046580	.	A	G	8	14	22	0	2	24	0	0
7	28046619	.	A	G	22	0	22	4	8	34	0	0
7	28046718	.	G	A	4	3	7	1	0	8	0	0
7	28046723	.	G	A	3	3	6	0	1	7	0	0
7	28046784	.	C	T	3	2	5	0	0	5	0	0
7	28047004	.	G	A	8	6	14	0	1	15	0	0
7	28047072	.	C	T	5	5	10	0	0	10	0	0
7	28047163	.	C	T	1	4	5	0	0	5	0	0
7	28147806	.	T	A	7	10	17	0	1	18	0	0
7	28406514	.	G	A	2	4	6	0	0	6	0	0
7	28407339	.	A	G	1	2	3	0	0	3	0	0
7	28424237	.	C	G	14	9	23	0	1	24	0	0
7	28424381	.	A	T	12	9	21	0	1	22	0	0
7	28430010	.	G	A	8	6	14	0	0	14	0	0
7	28430127	.	C	A	4	7	11	0	0	11	0	0
7	28430430	.	C	T	4	3	7	0	1	8	0	0
7	28430503	.	G	A	5	2	7	0	1	8	0	0
7	28430528	.	G	T	3	2	5	0	1	6	0	0
7	28434034	.	A	T	3	3	6	0	3	9	0	0
7	28436486	.	G	C	5	4	9	0	0	9	0	0
7	28465338	.	G	A	8	9	17	0	0	17	0	0
7	28467182	.	A	G	5	7	12	0	2	14	0	0
7	28559253	.	G	A	2	2	4	0	0	4	0	0
7	28559302	.	T	A	1	2	3	0	0	3	0	0
7	28559598	.	C	T	0	2	2	0	1	3	0	0
7	28559907	.	G	A	12	18	30	0	1	31	0	0
7	28559969	.	G	T	11	15	26	0	1	27	0	0
7	28560250	.	G	C	17	13	30	0	2	32	0	0
7	28560256	.	G	A	17	13	30	0	1	31	0	0
7	28560467	.	C	G	16	18	34	0	0	34	0	0
7	28562196	.	A	G	7	15	22	0	0	22	0	0
7	28570209	.	T	C	3	4	7	0	1	8	0	0
7	28612726	.	T	C	11	12	23	0	1	24	0	0
7	28612899	.	G	A	0	8	8	0	7	15	0	0
7	28612929	.	A	G	6	6	12	0	0	12	0	0
7	28612962	.	G	A	3	6	9	0	0	9	0	0
7	28615709	.	T	C	11	7	18	0	2	20	0	0
7	28615850	.	G	A	9	14	23	1	0	24	0	0
7	28615922	.	A	G	7	0	7	0	4	11	0	0
7	28618813	.	C	T	27	13	40	1	2	43	0	0
7	28622856	.	G	A	30	13	43	0	8	51	0	0
7	28622970	.	T	C	25	21	46	0	1	47	0	0
7	28623506	.	T	A	4	9	13	0	1	14	0	0
7	28623533	.	A	T	3	6	9	0	0	9	0	0
7	28623803	.	G	A	2	3	5	0	0	5	0	0
7	28623823	.	G	T	7	5	12	0	0	12	0	0
7	28623860	.	A	G	9	5	14	0	0	14	0	0
7	28623863	.	A	G	9	6	15	0	0	15	0	0
7	28624106	.	A	T	3	3	6	0	2	8	0	0
7	28624157	.	C	G	4	3	7	0	0	7	0	0
7	28624490	.	T	G	1	3	4	0	0	4	0	0
7	28624688	.	A	T	3	4	7	0	1	8	0	0
7	28624692	.	T	C	5	3	8	0	1	9	0	0
7	28625080	.	G	T	3	3	6	0	0	6	0	0
7	28625145	.	A	T	1	6	7	0	0	7	0	0
7	29051855	.	A	G	2	3	5	0	1	6	0	0
7	29939651	.	T	C	5	2	7	0	0	7	0	0
7	29969704	.	A	G	2	4	6	0	0	6	0	0
7	30080872	.	G	A	1	6	7	0	0	7	0	0
7	30137667	.	C	T	1	10	11	0	0	11	0	0
7	30409234	.	G	A	1	2	3	0	1	4	0	0
7	30562645	.	T	A	4	15	19	0	2	21	0	0
7	30565773	.	C	T	3	2	5	0	1	6	0	0
7	31366865	.	C	T	11	2	13	0	1	14	0	0
7	31497837	.	T	C	1	2	3	0	0	3	0	0
7	32745052	.	A	G	5	3	8	0	0	8	0	0
7	32746213	.	A	G	18	8	26	0	1	27	0	0
7	32747956	.	A	G	15	0	15	0	14	29	0	0
7	32747973	.	A	G	13	21	34	0	1	35	0	0
7	32748203	.	A	G	22	8	30	0	3	33	0	0
7	33442491	.	C	T	0	2	2	0	0	2	0	0
7	34242358	.	C	T	1	5	6	0	4	10	0	0
7	34292207	.	T	A	4	2	6	0	0	6	0	0
7	34292434	.	C	A	2	3	5	0	1	6	0	0
7	34292617	.	G	A	4	3	7	0	1	8	0	0
7	34317746	.	C	T	6	20	26	0	22	48	0	0
7	34318079	.	T	C	29	21	50	0	3	53	0	0
7	34318485	.	G	A	30	19	49	0	2	51	0	0
7	34321735	.	G	A	7	4	11	0	0	11	0	0
7	34321887	.	T	G	6	9	15	0	0	15	0	0
7	34324215	.	T	C	6	6	12	0	1	13	0	0
7	34329845	.	A	G	10	13	23	0	0	23	0	0
7	34341457	.	A	G	6	13	19	0	1	20	0	0
7	34341538	.	A	G	7	12	19	0	0	19	0	0
7	34342185	.	T	C	8	6	14	0	1	15	0	0
7	34342251	.	C	T	5	5	10	0	0	10	0	0
7	34342266	.	G	C	7	5	12	0	0	12	0	0
7	34352928	.	G	A	5	3	8	0	0	8	0	0
7	34353161	.	C	T	1	4	5	0	4	9	0	0
7	35283238	.	T	A	2	3	5	0	0	5	0	0
7	37585016	.	T	A	4	2	6	0	0	6	0	0
7	38575775	.	G	C	1	2	3	0	0	3	0	0
7	38575802	.	C	A	1	2	3	0	0	3	0	0
7	38704065	.	T	C	6	4	10	0	1	11	0	0
7	38704184	.	T	C	2	2	4	0	0	4	0	0
7	38704201	.	T	C	3	2	5	0	2	7	0	0
7	39156736	.	A	G	12	4	16	0	0	16	0	0
7	39177132	.	A	T	1	4	5	0	0	5	0	0
7	39660240	.	A	T	7	22	29	0	2	31	0	0
7	39676947	.	T	G	5	10	15	0	3	18	0	0
7	39731015	.	T	A	1	5	6	0	0	6	0	0
7	39731036	.	G	T	0	3	3	0	1	4	0	0
7	40053490	.	T	C	3	2	5	0	0	5	0	0
7	40053978	.	C	T	2	4	6	0	0	6	0	0
7	40054901	.	G	T	2	5	7	0	0	7	0	0
7	40054925	.	G	T	0	5	5	0	3	8	0	0
7	40055080	.	T	C	2	2	4	0	1	5	0	0
7	40055099	.	C	T	3	2	5	0	1	6	0	0
7	40055178	.	C	G	3	2	5	0	1	6	0	0
7	40055353	.	A	G	3	0	3	0	3	6	0	0
7	40055612	.	C	T	3	2	5	0	0	5	0	0
7	40055628	.	G	A	2	3	5	0	0	5	0	0
7	40055672	.	G	A	3	2	5	0	1	6	0	0
7	40055711	.	A	T	2	4	6	0	0	6	0	0
7	40055844	.	C	T	5	5	10	0	0	10	0	0
7	40056060	.	C	T	4	6	10	0	0	10	0	0
7	40056112	.	T	G	11	4	15	0	1	16	0	0
7	40056307	.	C	T	8	5	13	0	0	13	0	0
7	40056353	.	G	A	6	4	10	0	2	12	0	0
7	40056417	.	C	A	5	4	9	0	0	9	0	0
7	40056542	.	A	T	6	3	9	0	1	10	0	0
7	40056587	.	C	T	10	4	14	0	0	14	0	0
7	40056589	.	T	C	10	4	14	0	0	14	0	0
7	40056729	.	A	T	4	6	10	0	1	11	0	0
7	40056851	.	T	C	3	5	8	0	0	8	0	0
7	40056854	.	C	T	6	3	9	0	1	10	0	0
7	40056982	.	C	T	4	7	11	0	0	11	0	0
7	40057140	.	G	A	8	7	15	0	0	15	0	0
7	40057393	.	C	T	8	8	16	0	0	16	0	0
7	40057581	.	T	G	6	10	16	0	2	18	0	0
7	40057674	.	A	G	5	3	8	0	0	8	0	0
7	40059207	.	G	A	7	7	14	0	0	14	0	0
7	40059248	.	T	C	15	5	20	0	0	20	0	0
7	40059673	.	G	A	4	3	7	0	0	7	0	0
7	40059984	.	T	C	4	0	4	0	0	4	0	0
7	40070531	.	C	G	3	4	7	0	0	7	0	0
7	40070567	.	A	C	3	3	6	0	0	6	0	0
7	40070590	.	G	A	2	4	6	0	0	6	0	0
7	40072184	.	T	C	3	2	5	0	0	5	0	0
7	40072371	.	T	G	2	2	4	0	1	5	0	0
7	40080166	.	C	T	1	3	4	0	0	4	0	0
7	40083683	.	T	A	3	6	9	0	0	9	0	0
7	40083786	.	A	T	4	2	6	0	0	6	0	0
7	40083815	.	T	A	4	2	6	0	0	6	0	0
7	40090547	.	T	A	10	11	21	1	0	22	0	0
7	40090602	.	T	C	15	10	25	0	3	28	0	0
7	40091332	.	C	A	7	6	13	0	0	13	0	0
7	40091460	.	C	T	7	8	15	0	0	15	0	0
7	40091510	.	G	T	6	3	9	0	0	9	0	0
7	40091543	.	T	C	6	4	10	0	0	10	0	0
7	40091622	.	C	G	20	4	24	0	3	27	0	0
7	40091718	.	G	A	23	12	35	0	2	37	0	0
7	40091749	.	T	C	21	11	32	0	2	34	0	0
7	40091818	.	T	G	13	9	22	0	0	22	0	0
7	40091951	.	A	T	7	4	11	0	0	11	0	0
7	40097271	.	C	G	1	2	3	0	0	3	0	0
7	40097345	.	A	G	3	3	6	0	0	6	0	0
7	40097395	.	A	G	1	3	4	0	0	4	0	0
7	40097396	.	T	C	1	3	4	0	0	4	0	0
7	40097681	.	T	A	2	2	4	0	1	5	0	0
7	40100168	.	A	C	2	3	5	0	0	5	0	0
7	40100976	.	C	T	3	5	8	0	0	8	0	0
7	40101983	.	C	T	3	3	6	0	0	6	0	0
7	40123073	.	T	A	1	2	3	0	0	3	0	0
7	40123342	.	T	C	3	6	9	0	0	9	0	0
7	40123350	.	A	T	5	5	10	0	0	10	0	0
7	40123989	.	T	C	2	0	2	0	7	9	0	0
7	40126615	.	T	C	1	2	3	0	0	3	0	0
7	40127153	.	A	G	2	3	5	0	0	5	0	0
7	40188991	.	C	T	2	3	5	0	0	5	0	0
7	40200740	.	G	A	4	3	7	0	0	7	0	0
7	40201016	.	C	T	4	7	11	0	1	12	0	0
7	40201108	.	G	T	6	5	11	0	0	11	0	0
7	40201135	.	G	A	6	3	9	0	0	9	0	0
7	40201149	.	G	A	5	3	8	0	1	9	0	0
7	40201719	.	A	C	2	2	4	0	0	4	0	0
7	40292834	.	T	C	1	2	3	0	0	3	0	0
7	40318309	.	T	A	1	3	4	0	1	5	0	0
7	40318486	.	A	G	1	0	1	0	3	4	0	0
7	40320956	.	A	C	3	4	7	0	0	7	0	0
7	40321174	.	C	T	5	3	8	0	2	10	0	0
7	40321224	.	A	G	4	3	7	0	0	7	0	0
7	40321273	.	G	T	6	8	14	0	0	14	0	0
7	40321443	.	C	T	4	6	10	0	0	10	0	0
7	40460256	.	T	C	12	10	22	0	1	23	0	0
7	40460371	.	C	T	11	12	23	0	1	24	0	0
7	40466026	.	A	G	22	9	31	0	0	31	0	0
7	40471301	.	A	G	17	15	32	0	2	34	0	0
7	40492740	.	T	A	41	22	63	0	1	64	0	0
7	40492764	.	G	C	3	25	28	0	38	66	0	0
7	40492789	.	T	C	41	20	61	0	5	66	0	0
7	40492800	.	G	T	44	14	58	0	3	61	0	0
7	40498598	.	G	A	29	17	46	0	6	52	0	0
7	40498934	.	C	A	21	25	46	0	1	47	0	0
7	40499177	.	A	C	3	16	19	0	2	21	0	0
7	40499182	.	A	G	3	11	14	0	4	18	0	0
7	40537064	.	A	G	0	3	3	0	1	4	0	0
7	40560934	.	G	A	9	11	20	0	1	21	0	0
7	40561366	.	G	A	3	4	7	1	0	8	0	0
7	40562662	.	C	T	0	5	5	0	3	8	0	0
7	40562743	.	G	A	5	4	9	0	0	9	0	0
7	40562757	.	T	G	5	2	7	0	0	7	0	0
7	40584065	.	A	C	14	5	19	0	0	19	0	0
7	40584121	.	A	C	19	16	35	0	0	36	1	0
7	40584148	.	T	C	20	0	20	0	15	35	0	0
7	40584395	.	G	C	21	5	26	0	4	30	0	0
7	40584415	.	G	C	20	11	31	0	0	31	0	0
7	40584469	.	C	T	7	11	18	0	0	18	0	0
7	40585217	.	T	C	3	4	7	0	1	8	0	0
7	40585546	.	A	T	4	4	8	0	0	8	0	0
7	40645217	.	A	G	9	5	14	0	0	14	0	0
7	40649674	.	G	A	2	2	4	0	0	4	0	0
7	40890410	.	A	G	4	4	8	0	1	9	0	0
7	40890678	.	G	A	7	4	11	0	1	12	0	0
7	40891190	.	C	T	1	2	3	0	0	3	0	0
7	40900772	.	G	A	10	11	21	1	2	24	0	0
7	40900785	.	C	A	1	11	12	1	11	24	0	0
7	40901126	.	A	T	4	3	7	0	0	7	0	0
7	40901704	.	C	T	1	4	5	0	2	7	0	0
7	40901779	.	C	G	8	5	13	0	1	14	0	0
7	40901945	.	T	C	4	6	10	0	0	10	0	0
7	40902177	.	A	T	2	2	4	0	0	4	0	0
7	40902183	.	A	G	0	3	3	0	0	3	0	0
7	40904762	.	T	A	1	2	3	0	1	4	0	0
7	40904949	.	G	T	1	3	4	0	0	4	0	0
7	40905695	.	A	T	7	12	19	0	1	20	0	0
7	40905774	.	C	T	0	13	13	0	10	23	0	0
7	40906286	.	T	C	5	5	10	0	0	10	0	0
7	40906377	.	T	C	3	4	7	0	0	7	0	0
7	40906415	.	T	A	3	2	5	0	1	6	0	0
7	40990473	.	G	C	3	5	8	0	0	8	0	0
7	40993298	.	G	A	2	2	4	0	0	4	0	0
7	41008618	.	T	C	8	14	22	0	1	23	0	0
7	41008856	.	C	T	1	9	10	0	13	23	0	0
7	41009217	.	C	T	2	11	13	0	17	30	0	0
7	41009797	.	T	A	13	14	27	0	3	30	0	0
7	41012081	.	A	T	9	6	15	0	1	16	0	0
7	41012505	.	C	T	0	4	4	0	2	6	0	0
7	41014175	.	C	T	4	3	7	0	0	7	0	0
7	41082391	.	T	G	4	3	7	0	0	7	0	0
7	41147792	.	A	G	3	2	5	0	7	12	0	0
7	41157531	.	G	C	14	26	40	0	0	40	0	0
7	41157735	.	T	C	19	19	38	0	1	39	0	0
7	41157805	.	C	A	23	17	40	1	1	42	0	0
7	41157997	.	G	A	28	11	39	1	0	40	0	0
7	41158057	.	C	T	18	17	35	0	1	36	0	0
7	41250813	.	T	C	1	2	3	0	0	3	0	0
7	41258015	.	T	C	4	5	9	0	0	9	0	0
7	41261343	.	C	A	6	4	10	0	1	11	0	0
7	41262277	.	A	G	7	6	13	0	0	13	0	0
7	41262361	.	G	A	5	4	9	0	0	9	0	0
7	41263277	.	G	A	0	6	6	0	3	9	0	0
7	41267424	.	C	T	11	6	17	0	1	18	0	0
7	41269653	.	C	G	15	11	26	0	0	26	0	0
7	41273527	.	T	C	2	7	9	0	1	10	0	0
7	41273889	.	T	C	7	8	15	0	0	15	0	0
7	41274080	.	T	G	7	14	21	0	0	21	0	0
7	41274258	.	T	C	10	9	19	0	1	20	0	0
7	41274261	.	A	G	12	0	12	0	9	21	0	0
7	41274802	.	C	A	18	11	29	0	2	31	0	0
7	41274896	.	A	C	12	13	25	0	3	28	0	0
7	41274916	.	A	C	17	15	32	0	2	34	0	0
7	41274943	.	T	A	19	18	37	0	1	38	0	0
7	41313715	.	T	C	1	2	3	0	0	3	0	0
7	41313853	.	C	A	3	5	8	0	0	8	0	0
7	41313894	.	G	C	3	2	5	0	0	5	0	0
7	41316722	.	T	G	5	5	10	0	0	10	0	0
7	41329674	.	T	G	2	2	4	0	0	4	0	0
7	41329683	.	A	G	2	2	4	0	0	4	0	0
7	41333320	.	G	T	1	3	4	0	0	4	0	0
7	41345105	.	C	T	1	2	3	0	0	3	0	0
7	41345123	.	C	T	2	2	4	0	0	4	0	0
7	41345282	.	A	C	2	2	4	0	0	4	0	0
7	41345828	.	G	T	1	4	5	0	0	5	0	0
7	41347813	.	C	T	2	2	4	0	0	4	0	0
7	41349128	.	C	T	1	12	13	0	8	21	0	0
7	41349454	.	G	T	18	8	26	0	1	27	0	0
7	41350424	.	A	G	2	4	6	0	0	6	0	0
7	41352145	.	T	A	10	10	20	1	0	21	0	0
7	41353258	.	G	A	6	6	12	0	1	13	0	0
7	41356547	.	C	T	2	3	5	0	0	5	0	0
7	41357602	.	G	A	3	4	7	0	0	7	0	0
7	41357623	.	G	C	1	2	3	0	0	3	0	0
7	41358645	.	A	G	2	3	5	0	0	5	0	0
7	41362945	.	A	G	1	2	3	0	0	3	0	0
7	41402040	.	A	G	2	2	4	0	1	5	0	0
7	41402079	.	C	T	0	4	4	0	1	5	0	0
7	41402943	.	C	G	3	4	7	1	0	8	0	0
7	41402988	.	G	C	2	6	8	0	1	9	0	0
7	41404081	.	C	T	17	2	19	0	0	19	0	0
7	41404090	.	T	C	12	2	14	0	1	15	0	0
7	41430417	.	T	C	5	4	9	0	1	10	0	0
7	41432220	.	G	A	0	6	6	0	3	9	0	0
7	41432324	.	T	A	2	3	5	0	0	5	0	0
7	41432676	.	T	C	6	8	14	0	1	15	0	0
7	41432732	.	A	T	1	8	9	0	0	9	0	0
7	41432906	.	T	C	9	5	14	0	0	14	0	0
7	41433244	.	A	G	7	0	7	0	3	10	0	0
7	41433390	.	T	A	6	6	12	0	0	12	0	0
7	41436575	.	T	C	8	0	8	0	4	12	0	0
7	41436811	.	T	A	11	4	15	0	0	15	0	0
7	41436902	.	A	G	8	5	13	0	1	14	0	0
7	41436907	.	G	A	10	8	18	0	0	18	0	0
7	41437342	.	A	C	13	13	26	0	0	26	0	0
7	41437363	.	A	G	10	17	27	0	0	27	0	0
7	41437623	.	C	A	8	7	15	0	2	17	0	0
7	41437715	.	T	G	8	9	17	0	0	17	0	0
7	41437827	.	C	A	0	9	9	0	9	18	0	0
7	41437948	.	G	A	4	11	15	0	1	16	0	0
7	41438036	.	A	C	3	5	8	0	1	9	0	0
7	41438417	.	T	A	3	4	7	0	1	8	0	0
7	41438502	.	C	T	0	3	3	0	6	9	0	0
7	41438676	.	G	T	4	3	7	0	0	8	1	0
7	41438677	.	T	C	2	4	6	0	2	8	0	0
7	41438826	.	C	T	1	6	7	0	3	10	0	0
7	41438871	.	C	T	0	2	2	0	4	6	0	0
7	41438896	.	C	T	0	2	2	0	4	6	0	0
7	41438970	.	G	A	3	3	6	0	0	6	0	0
7	41439411	.	C	T	0	2	2	0	6	8	0	0
7	41443186	.	C	T	0	5	5	0	4	9	0	0
7	41491528	.	T	A	3	2	5	0	0	5	0	0
7	41491530	.	C	T	3	2	5	0	0	5	0	0
7	41491635	.	T	G	10	6	16	0	2	18	0	0
7	41491652	.	C	T	14	4	18	0	0	18	0	0
7	41491701	.	A	T	11	5	16	0	0	16	0	0
7	41491785	.	A	G	10	6	16	0	0	16	0	0
7	41491841	.	T	C	6	4	10	0	0	10	0	0
7	41496791	.	G	A	11	14	25	0	0	25	0	0
7	41500538	.	A	G	7	6	13	0	0	13	0	0
7	41500676	.	G	A	6	2	8	0	0	8	0	0
7	41501061	.	A	G	3	2	5	0	0	5	0	0
7	41501124	.	A	G	6	8	14	0	0	14	0	0
7	41503775	.	G	A	2	2	4	0	0	4	0	0
7	41506677	.	A	G	6	2	8	0	0	8	0	0
7	41506683	.	T	C	5	3	8	0	0	8	0	0
7	41517442	.	C	G	8	6	14	0	0	14	0	0
7	41517467	.	A	G	9	6	15	0	0	15	0	0
7	41517593	.	G	T	6	5	11	0	0	11	0	0
7	41517607	.	T	A	5	4	9	0	0	9	0	0
7	41517777	.	T	A	4	3	7	0	0	7	0	0
7	41517909	.	T	A	11	4	15	0	0	15	0	0
7	41517978	.	A	G	10	8	18	0	1	20	1	0
7	41518033	.	G	A	5	13	18	0	1	19	0	0
7	41518109	.	C	A	7	5	12	0	0	12	0	0
7	41518146	.	G	A	10	5	15	0	0	15	0	0
7	41518147	.	C	G	10	4	14	0	1	15	0	0
7	41518217	.	C	A	1	6	7	0	9	16	0	0
7	41518328	.	T	G	8	8	16	0	0	16	0	0
7	41518420	.	G	C	4	10	14	0	0	14	0	0
7	41518721	.	G	T	6	7	13	0	1	14	0	0
7	41518727	.	C	T	5	5	10	0	1	11	0	0
7	41713997	.	G	A	4	4	8	0	0	8	0	0
7	41714059	.	C	T	0	9	9	0	4	13	0	0
7	41714076	.	A	T	3	7	10	0	1	11	0	0
7	41714140	.	C	T	1	11	12	0	3	15	0	0
7	41714196	.	T	A	10	12	22	0	0	22	0	0
7	41714205	.	C	T	9	12	21	0	0	21	0	0
7	41714244	.	A	G	10	6	16	0	1	17	0	0
7	41714923	.	G	A	7	7	14	0	1	15	0	0
7	41715288	.	C	T	0	2	2	0	3	5	0	0
7	41715594	.	T	A	4	9	13	0	2	15	0	0
7	41715721	.	T	A	4	3	7	0	0	7	0	0
7	41715794	.	C	T	0	3	3	0	4	7	0	0
7	41726186	.	C	T	1	1	2	0	1	3	0	0
7	41726355	.	G	T	3	1	4	0	1	5	0	0
7	41726535	.	G	T	1	3	4	0	0	4	0	0
7	41749150	.	A	G	1	3	4	0	0	4	0	0
7	41751146	.	C	T	3	6	9	0	0	9	0	0
7	41751671	.	C	T	5	4	9	0	1	10	0	0
7	41752151	.	C	T	7	2	9	0	0	9	0	0
7	41752152	.	A	T	7	2	9	0	0	9	0	0
7	41752210	.	A	G	13	3	16	0	1	17	0	0
7	41752224	.	A	G	14	5	19	0	0	19	0	0
7	41752440	.	A	C	21	4	25	5	0	30	0	0
7	41752463	.	A	G	19	0	19	4	9	32	0	0
7	41752497	.	C	A	18	9	27	1	0	28	0	0
7	41752507	.	C	G	17	5	22	2	1	25	0	0
7	41752590	.	T	C	7	3	10	4	1	15	0	0
7	41752631	.	A	G	16	8	24	0	1	25	0	0
7	41752662	.	G	A	15	7	22	0	2	24	0	0
7	41752892	.	T	A	8	6	14	0	0	14	0	0
7	41752974	.	T	G	10	2	12	0	5	17	0	0
7	41753038	.	C	T	12	6	18	1	0	19	0	0
7	41753061	.	A	G	8	8	16	0	2	18	0	0
7	41753093	.	T	A	11	3	14	0	0	14	0	0
7	41753107	.	T	A	2	2	4	0	1	5	0	0
7	41753195	.	A	T	3	2	5	0	0	5	0	0
7	41757730	.	G	A	20	21	41	0	0	41	0	0
7	41773951	.	T	G	7	6	13	0	2	15	0	0
7	41774020	.	A	G	8	15	23	0	0	23	0	0
7	41774035	.	G	A	10	14	24	0	1	25	0	0
7	41774125	.	A	G	12	8	20	0	0	20	0	0
7	41780925	.	A	T	2	3	5	0	3	8	0	0
7	41791391	.	A	G	1	2	3	0	0	3	0	0
7	41791469	.	T	C	1	4	5	0	0	5	0	0
7	41791857	.	C	T	2	3	5	0	0	5	0	0
7	41791920	.	C	T	1	3	4	0	0	4	0	0
7	41805215	.	G	T	3	3	6	0	0	6	0	0
7	41873177	.	C	T	7	3	10	0	0	10	0	0
7	41873215	.	A	T	13	9	22	0	1	23	0	0
7	41873256	.	C	T	19	10	29	0	0	29	0	0
7	41873257	.	T	G	18	10	28	0	1	29	0	0
7	41873368	.	T	A	21	6	27	0	1	28	0	0
7	41873426	.	T	C	21	13	34	0	1	35	0	0
7	41873503	.	A	G	15	14	29	0	0	29	0	0
7	41873554	.	A	T	23	16	39	0	3	42	0	0
7	41873691	.	T	C	14	13	27	0	1	28	0	0
7	41875951	.	T	C	17	9	26	0	1	27	0	0
7	41899051	.	A	C	3	3	6	0	2	8	0	0
7	41899426	.	C	A	1	2	3	0	0	3	0	0
7	41899674	.	T	C	1	5	6	0	0	6	0	0
7	41900402	.	G	C	3	4	7	0	0	7	0	0
7	41901355	.	A	G	7	11	18	0	1	19	0	0
7	41903555	.	A	G	3	3	6	0	0	6	0	0
7	41903633	.	T	A	15	17	32	0	1	33	0	0
7	41903681	.	C	T	22	18	40	0	2	42	0	0
7	41903907	.	A	G	6	9	15	0	1	16	0	0
7	41904152	.	A	G	23	29	52	0	1	53	0	0
7	41904520	.	G	A	24	30	54	0	3	57	0	0
7	41911604	.	C	T	1	19	20	0	13	33	0	0
7	41912618	.	T	C	8	4	12	0	0	12	0	0
7	41995046	.	T	C	3	2	5	0	1	6	0	0
7	42338816	.	A	G	7	10	17	3	0	20	0	0
7	42345361	.	G	T	13	10	23	0	1	24	0	0
7	42345681	.	T	A	18	13	31	0	3	34	0	0
7	42545468	.	G	A	1	2	3	0	0	3	0	0
7	43174642	.	G	A	3	3	6	0	0	6	0	0
7	43760755	.	T	C	18	7	25	0	5	30	0	0
7	43760822	.	G	A	14	8	22	0	1	23	0	0
7	43760875	.	T	A	9	6	15	0	4	19	0	0
7	43760881	.	G	A	5	11	16	0	1	17	0	0
7	43761810	.	T	A	2	8	10	0	0	10	0	0
7	43765189	.	A	G	7	7	14	0	0	14	0	0
7	43765197	.	A	G	6	6	12	0	0	12	0	0
7	43765348	.	G	A	7	4	11	0	0	11	0	0
7	43775054	.	G	A	5	7	12	0	0	12	0	0
7	43778690	.	C	G	6	5	11	0	1	12	0	0
7	43781554	.	G	T	5	2	7	0	0	7	0	0
7	43840624	.	C	T	1	2	3	0	0	3	0	0
7	44469702	.	A	C	1	6	7	0	0	7	0	0
7	45400790	.	C	T	7	4	11	0	0	11	0	0
7	45402452	.	C	T	15	18	33	0	0	33	0	0
7	45402887	.	C	A	13	17	30	0	0	30	0	0
7	45402989	.	C	T	12	23	35	0	1	36	0	0
7	45403244	.	C	T	20	12	32	0	0	32	0	0
7	45403292	.	G	A	19	15	34	0	2	36	0	0
7	45403294	.	A	T	18	14	32	0	4	36	0	0
7	45403360	.	T	G	9	14	23	0	2	25	0	0
7	45403370	.	A	T	14	15	29	0	0	29	0	0
7	45403416	.	C	T	14	11	25	1	1	27	0	0
7	45403735	.	G	A	0	1	1	0	2	3	0	0
7	45403793	.	G	A	2	2	4	0	0	4	0	0
7	45404490	.	C	T	6	4	10	0	1	11	0	0
7	45404554	.	A	T	1	8	9	0	0	9	0	0
7	45404559	.	G	A	1	8	9	0	0	9	0	0
7	45405163	.	C	T	5	9	14	0	1	15	0	0
7	45405179	.	G	T	6	8	14	0	1	15	0	0
7	45405236	.	T	G	4	0	4	0	6	10	0	0
7	45405244	.	T	C	4	5	9	0	1	10	0	0
7	45405871	.	A	C	5	4	9	0	1	10	0	0
7	45405992	.	C	T	3	4	7	0	2	9	0	0
7	45840234	.	T	A	3	2	5	0	0	5	0	0
7	45966120	.	C	T	1	2	3	0	0	3	0	0
7	45971454	.	A	T	4	8	12	0	2	14	0	0
7	46004948	.	T	G	3	2	5	0	0	5	0	0
7	46004971	.	C	G	3	4	7	0	0	7	0	0
7	46004991	.	C	G	2	1	3	0	3	6	0	0
7	46373463	.	T	C	2	2	4	0	0	4	0	0
7	46430696	.	T	A	4	4	8	0	1	9	0	0
7	46431108	.	T	A	1	7	8	0	0	8	0	0
7	46431256	.	C	A	6	6	12	0	0	12	0	0
7	46431273	.	C	G	3	5	8	0	1	9	0	0
7	46431577	.	G	A	13	6	19	0	1	20	0	0
7	46486048	.	C	T	3	9	12	0	1	13	0	0
7	46486244	.	A	C	10	8	18	0	0	18	0	0
7	46486629	.	G	A	0	13	13	0	12	25	0	0
7	46486719	.	G	T	11	11	22	0	1	23	0	0
7	46487322	.	C	T	11	15	26	0	1	27	0	0
7	46487652	.	G	A	0	6	6	3	1	11	1	0
7	46487662	.	C	A	7	3	10	3	3	16	0	0
7	46728687	.	G	A	5	4	9	0	0	9	0	0
7	46728721	.	A	C	7	0	7	0	8	15	0	0
7	46728784	.	A	T	7	2	9	1	1	11	0	0
7	46728785	.	C	A	5	2	7	1	2	10	0	0
7	46729545	.	C	T	0	3	3	0	10	13	0	0
7	46730076	.	A	G	4	3	7	0	0	7	0	0
7	46730469	.	C	T	8	4	12	0	0	12	0	0
7	46730705	.	C	T	3	3	6	0	0	6	0	0
7	46730754	.	G	A	2	3	5	0	0	5	0	0
7	46730820	.	T	C	4	0	4	0	5	9	0	0
7	46731141	.	C	T	1	2	3	0	0	3	0	0
7	46732134	.	G	A	3	2	5	0	0	5	0	0
7	47265898	.	G	A	1	4	5	0	7	12	0	0
7	47265934	.	G	A	0	2	2	0	3	5	0	0
7	47411934	.	C	T	4	2	6	0	0	6	0	0
7	47411962	.	C	A	3	4	7	0	0	7	0	0
7	47411977	.	C	T	4	2	6	0	0	6	0	0
7	47412040	.	C	T	3	2	5	0	0	5	0	0
7	47414726	.	A	T	4	4	8	1	0	9	0	0
7	47415036	.	G	A	8	5	13	0	0	13	0	0
7	47415181	.	G	T	1	4	5	0	0	5	0	0
7	47416825	.	A	G	13	1	14	0	18	32	0	0
7	47417002	.	C	A	15	7	22	0	0	22	0	0
7	47417080	.	T	C	17	5	22	0	0	22	0	0
7	47417195	.	T	A	6	9	15	0	0	15	0	0
7	47417810	.	C	T	12	6	18	0	3	21	0	0
7	47417821	.	C	T	13	8	21	0	1	22	0	0
7	47418320	.	C	T	10	11	21	0	0	21	0	0
7	47418526	.	T	C	12	8	20	0	0	20	0	0
7	47418657	.	G	A	12	11	23	0	1	24	0	0
7	47418697	.	C	A	10	12	22	0	2	24	0	0
7	47418847	.	T	A	9	9	18	0	0	18	0	0
7	47419070	.	T	A	10	6	16	0	0	16	0	0
7	47419114	.	A	C	6	6	12	0	0	12	0	0
7	47419842	.	G	A	13	5	18	0	2	20	0	0
7	47420208	.	A	G	8	9	17	0	0	17	0	0
7	47563381	.	A	T	2	2	4	0	0	4	0	0
7	47563614	.	C	A	1	2	3	0	0	3	0	0
7	47564703	.	A	G	3	2	5	0	0	5	0	0
7	48041808	.	A	T	2	4	6	0	0	6	0	0
7	48041967	.	G	A	1	1	2	0	1	3	0	0
7	48054990	.	G	A	2	2	4	0	0	4	0	0
7	48288848	.	A	G	4	4	8	0	1	9	0	0
7	48291864	.	G	A	5	8	13	0	0	13	0	0
7	48295850	.	A	T	9	11	20	0	0	20	0	0
7	48295902	.	G	T	6	14	20	0	0	20	0	0
7	48295910	.	C	T	8	12	20	0	0	20	0	0
7	48303198	.	T	A	2	1	3	0	1	4	0	0
7	48303216	.	G	A	2	2	4	0	0	4	0	0
7	48303273	.	A	T	1	2	3	0	0	3	0	0
7	48303274	.	A	C	1	2	3	0	0	3	0	0
7	48303814	.	G	A	1	7	8	0	2	10	0	0
7	48303838	.	C	T	3	8	11	0	1	12	0	0
7	48303954	.	T	C	7	12	19	0	3	22	0	0
7	48304060	.	C	G	4	4	8	0	1	9	0	0
7	48304396	.	G	A	2	4	6	0	0	6	0	0
7	48304419	.	A	G	6	4	10	0	0	10	0	0
7	48304457	.	T	G	11	4	15	0	2	17	0	0
7	48304548	.	A	T	5	3	8	0	2	10	0	0
7	48304554	.	G	A	2	7	9	0	1	10	0	0
7	48304589	.	A	T	8	5	13	0	1	14	0	0
7	48342482	.	G	C	5	3	8	1	0	9	0	0
7	48342519	.	A	T	3	4	7	1	2	10	0	0
7	48342526	.	T	C	4	5	9	1	1	11	0	0
7	48342575	.	C	T	3	7	10	0	1	11	0	0
7	48347562	.	G	T	11	13	24	0	2	26	0	0
7	48347680	.	A	C	8	14	22	0	1	23	0	0
7	48348003	.	G	A	12	9	21	0	0	21	0	0
7	48348148	.	T	A	7	3	10	0	0	10	0	0
7	48348149	.	C	A	7	3	10	0	0	10	0	0
7	48348335	.	G	A	8	5	13	0	1	14	0	0
7	48348554	.	G	A	6	3	9	0	0	9	0	0
7	48358792	.	A	T	5	3	8	0	1	9	0	0
7	48361334	.	C	A	7	8	15	0	0	15	0	0
7	48368758	.	C	T	0	4	4	0	1	5	0	0
7	48368821	.	G	A	4	5	9	0	0	9	0	0
7	48368977	.	T	G	5	3	8	0	0	8	0	0
7	48368995	.	G	A	7	4	11	0	0	11	0	0
7	48369999	.	C	T	3	4	7	0	1	8	0	0
7	48460315	.	C	T	1	2	3	0	0	3	0	0
7	48482286	.	C	A	1	1	2	0	1	3	0	0
7	48482370	.	C	T	1	2	3	0	0	3	0	0
7	48484269	.	T	C	16	6	22	0	3	25	0	0
7	48484307	.	G	A	1	8	9	0	9	18	0	0
7	48484416	.	G	A	8	6	14	0	1	15	0	0
7	48484736	.	A	G	13	21	34	0	0	34	0	0
7	48663980	.	T	A	5	3	8	0	1	9	0	0
7	48720187	.	G	T	2	3	5	0	0	5	0	0
7	48721781	.	A	T	1	3	4	0	0	4	0	0
7	48788389	.	G	C	9	0	9	0	13	22	0	0
7	48788498	.	T	A	8	18	26	1	2	29	0	0
7	48788790	.	A	T	4	6	10	0	0	10	0	0
7	48788791	.	T	A	3	6	9	0	1	10	0	0
7	48788873	.	G	A	10	4	14	0	0	14	0	0
7	48788910	.	C	T	4	8	12	0	0	12	0	0
7	48789579	.	T	C	3	0	3	0	5	8	0	0
7	48818286	.	C	G	5	1	6	0	4	10	0	0
7	48818563	.	T	C	6	10	16	1	0	17	0	0
7	48821362	.	C	T	7	8	15	0	1	16	0	0
7	48829728	.	A	G	12	11	23	0	1	24	0	0
7	48829926	.	A	T	3	4	7	0	2	9	0	0
7	49052112	.	C	T	4	4	8	0	0	8	0	0
7	49052359	.	A	G	1	2	3	0	0	3	0	0
7	49052413	.	C	T	2	2	4	0	1	5	0	0
7	49052476	.	G	A	1	3	4	0	1	5	0	0
7	49052777	.	C	T	6	5	11	0	0	11	0	0
7	49052957	.	C	G	5	4	9	0	0	9	0	0
7	49053260	.	C	T	2	5	7	0	1	8	0	0
7	49053531	.	C	T	3	5	8	0	0	8	0	0
7	49053566	.	G	A	0	3	3	0	4	7	0	0
7	49053627	.	C	T	2	5	7	0	0	7	0	0
7	49053677	.	G	A	0	6	6	0	4	10	0	0
7	49054076	.	T	G	2	0	2	0	5	7	0	0
7	49054419	.	A	G	4	2	6	0	1	7	0	0
7	49054885	.	C	T	2	6	8	0	0	8	0	0
7	49055197	.	C	T	5	10	15	0	2	17	0	0
7	49055371	.	A	C	14	16	30	0	0	30	0	0
7	49055411	.	T	C	13	11	24	0	2	26	0	0
7	49055812	.	T	G	3	0	3	0	4	7	0	0
7	49055880	.	C	T	2	5	7	0	0	7	0	0
7	49055930	.	A	C	6	3	9	0	0	9	0	0
7	49170028	.	G	A	0	3	3	0	2	5	0	0
7	49170029	.	G	T	2	3	5	0	0	5	0	0
7	49251540	.	A	G	1	2	3	0	0	3	0	0
7	49257220	.	C	T	6	4	10	0	0	10	0	0
7	49257841	.	C	T	4	8	12	0	1	13	0	0
7	49257979	.	A	G	7	2	9	0	1	10	0	0
7	49258012	.	G	A	9	4	13	0	2	15	0	0
7	49266497	.	G	A	7	3	10	0	0	10	0	0
7	49271067	.	C	A	9	7	16	0	1	17	0	0
7	49271069	.	C	T	7	9	16	0	0	16	0	0
7	49271208	.	C	T	11	8	19	0	0	19	0	0
7	49271363	.	A	G	5	0	5	0	3	8	0	0
7	49320342	.	A	T	5	3	8	0	0	8	0	0
7	49325033	.	T	A	12	4	16	0	3	19	0	0
7	49338309	.	G	A	7	7	14	0	0	14	0	0
7	49342391	.	G	A	11	6	17	0	2	19	0	0
7	49354829	.	A	T	1	2	3	0	0	3	0	0
7	49357357	.	G	A	2	5	7	0	0	7	0	0
7	50476653	.	T	C	2	3	5	0	0	5	0	0
7	50877064	.	T	C	4	11	15	0	0	15	0	0
7	50877100	.	T	C	7	4	11	0	2	13	0	0
7	51220278	.	T	C	11	11	22	0	0	22	0	0
7	51220557	.	G	A	6	6	12	0	0	12	0	0
7	51315177	.	G	T	3	2	5	0	0	5	0	0
7	51352871	.	T	C	3	2	5	0	0	5	0	0
7	51353421	.	C	T	2	3	5	0	0	5	0	0
7	51353447	.	G	T	3	2	5	0	0	5	0	0
7	51353935	.	G	A	4	2	6	0	0	6	0	0
7	51354066	.	G	A	0	2	2	0	2	4	0	0
7	51354424	.	T	A	2	4	6	0	0	6	0	0
7	51354442	.	C	A	1	5	6	0	0	6	0	0
7	51354672	.	T	A	3	5	8	0	0	8	0	0
7	51354696	.	C	T	4	5	9	0	0	9	0	0
7	51354756	.	T	C	4	8	12	0	1	13	0	0
7	51355531	.	T	A	2	3	5	0	0	5	0	0
7	51355936	.	G	T	8	5	13	0	1	14	0	0
7	51355972	.	T	A	5	4	9	0	1	10	0	0
7	51355993	.	T	A	4	4	8	0	1	9	0	0
7	51356150	.	A	G	5	3	8	0	1	9	0	0
7	51356542	.	C	G	11	15	26	0	0	26	0	0
7	51468042	.	C	T	3	18	21	0	15	36	0	0
7	51468199	.	C	T	26	19	45	0	1	46	0	0
7	51468389	.	C	T	1	21	22	0	10	32	0	0
7	51468411	.	A	T	12	14	26	0	2	28	0	0
7	51468556	.	G	C	15	20	35	1	3	39	0	0
7	51468577	.	C	A	20	19	39	1	2	42	0	0
7	51468928	.	G	A	11	6	17	0	5	22	0	0
7	51469048	.	T	G	17	25	42	0	1	43	0	0
7	51469166	.	A	T	17	16	33	0	2	35	0	0
7	51469340	.	G	A	7	11	18	0	1	19	0	0
7	51469361	.	A	G	11	9	20	0	0	20	0	0
7	51469578	.	T	G	12	11	23	0	1	24	0	0
7	51469897	.	A	G	8	4	12	0	0	12	0	0
7	51469952	.	A	T	6	16	22	0	0	22	0	0
7	51469956	.	C	T	1	15	16	0	5	21	0	0
7	51470070	.	T	C	8	0	8	0	8	16	0	0
7	51470423	.	T	C	3	1	4	1	3	8	0	0
7	51470569	.	G	T	4	4	8	0	0	8	0	0
7	51471107	.	G	A	2	9	11	0	0	11	0	0
7	51471117	.	A	G	3	9	12	0	0	12	0	0
7	51471217	.	C	T	2	8	10	0	0	10	0	0
7	51471365	.	T	C	7	0	7	0	0	7	0	0
7	51471554	.	T	C	1	0	1	0	8	9	0	0
7	51471714	.	A	G	2	5	7	0	0	7	0	0
7	51471775	.	G	A	4	4	8	0	0	8	0	0
7	51472693	.	C	T	0	3	3	0	2	5	0	0
7	51472702	.	A	G	3	3	6	0	0	6	0	0
7	51472793	.	A	C	2	0	2	0	4	6	0	0
7	51473000	.	C	T	3	2	5	0	0	5	0	0
7	51473585	.	T	C	3	0	3	0	2	5	0	0
7	51473673	.	G	A	2	2	4	0	0	4	0	0
7	51473814	.	C	T	2	2	4	0	0	4	0	0
7	51474238	.	G	A	3	5	8	0	0	8	0	0
7	51474279	.	C	A	1	2	3	0	1	4	0	0
7	51475288	.	G	A	1	3	4	0	0	4	0	0
7	51634231	.	A	G	29	35	64	0	6	70	0	0
7	51634285	.	C	T	31	39	70	0	1	71	0	0
7	51634480	.	G	A	39	32	71	0	1	72	0	0
7	51643363	.	G	A	3	5	8	0	0	8	0	0
7	51643366	.	G	A	4	4	8	0	0	8	0	0
7	51643639	.	A	C	1	6	7	0	1	8	0	0
7	51656560	.	A	T	2	2	4	0	0	4	0	0
7	51698403	.	T	A	3	3	6	0	0	6	0	0
7	51709472	.	G	A	1	2	3	0	0	3	0	0
7	51779552	.	G	A	0	5	5	0	10	15	0	0
7	51779636	.	T	C	8	6	14	0	0	14	0	0
7	51786442	.	T	G	11	1	12	0	8	20	0	0
7	51788729	.	C	T	9	14	23	3	1	27	0	0
7	51788756	.	A	C	10	11	21	3	4	28	0	0
7	51793623	.	C	T	16	18	34	0	0	34	0	0
7	51793747	.	C	T	20	18	38	0	0	38	0	0
7	51793813	.	G	C	10	10	20	0	3	23	0	0
7	51813764	.	G	A	3	5	8	0	0	8	0	0
7	51814287	.	C	G	5	8	13	0	0	13	0	0
7	51814385	.	G	C	14	5	19	0	0	19	0	0
7	51814416	.	T	A	8	5	13	0	0	13	0	0
7	51814512	.	C	T	6	3	9	0	0	9	0	0
7	51824718	.	A	C	5	4	9	0	1	10	0	0
7	51824772	.	T	G	5	3	8	0	0	8	0	0
7	52150910	.	G	T	1	2	3	0	0	3	0	0
7	52150911	.	A	G	1	2	3	0	0	3	0	0
7	52153001	.	G	A	1	2	3	0	0	3	0	0
7	52153006	.	C	T	1	2	3	0	0	3	0	0
7	52156113	.	G	A	0	3	3	0	1	4	0	0
7	52156137	.	T	A	2	2	4	0	0	4	0	0
7	52157531	.	T	G	3	7	10	0	0	10	0	0
7	52157782	.	T	C	2	3	5	0	0	5	0	0
7	52157814	.	G	T	3	6	9	0	1	10	0	0
7	52158210	.	G	T	6	3	9	0	0	9	0	0
7	52158304	.	G	A	11	4	15	0	0	15	0	0
7	52158339	.	G	C	14	7	21	0	2	23	0	0
7	52158362	.	T	A	14	5	19	0	2	21	0	0
7	52158435	.	A	T	3	7	10	0	0	10	0	0
7	52165016	.	T	A	4	3	7	0	0	7	0	0
7	52175362	.	T	C	5	7	12	0	0	12	0	0
7	52178542	.	T	C	9	4	13	0	1	14	0	0
7	52282674	.	G	T	10	16	26	0	1	27	0	0
7	52285113	.	C	G	8	6	14	0	1	15	0	0
7	52294403	.	G	A	12	12	24	0	1	25	0	0
7	52294540	.	A	T	13	9	22	0	0	22	0	0
7	52294746	.	C	T	2	6	8	0	7	15	0	0
7	52295795	.	C	T	2	7	9	0	1	10	0	0
7	52296018	.	T	C	7	4	11	0	0	11	0	0
7	52296215	.	T	C	8	3	11	0	0	11	0	0
7	52296281	.	T	C	5	3	8	0	1	9	0	0
7	52296400	.	C	A	3	3	6	0	1	7	0	0
7	52309924	.	G	A	1	3	4	0	0	4	0	0
7	52431954	.	C	T	2	3	5	0	0	5	0	0
7	52517561	.	C	G	11	4	15	0	0	15	0	0
7	52518134	.	G	C	8	0	8	0	5	13	0	0
7	52518271	.	A	T	10	5	15	0	0	15	0	0
7	52518813	.	C	T	5	6	11	0	0	11	0	0
7	52519134	.	G	A	3	11	14	0	1	15	0	0
7	52521352	.	G	A	2	2	4	0	0	4	0	0
7	52551570	.	A	T	0	3	3	0	1	4	0	0
7	52717095	.	T	C	2	3	5	0	0	5	0	0
7	52728713	.	G	A	1	2	3	0	0	3	0	0
7	52729079	.	T	G	2	0	2	0	4	6	0	0
7	52744228	.	T	C	5	5	10	0	0	10	0	0
7	52750565	.	C	T	14	10	24	0	1	25	0	0
7	52750847	.	C	T	13	9	22	0	0	22	0	0
7	52751306	.	T	C	8	10	18	0	1	19	0	0
7	52751341	.	T	A	7	3	10	0	0	10	0	0
7	52820320	.	C	T	1	3	4	0	0	4	0	0
7	52822708	.	C	T	2	9	11	0	0	11	0	0
7	52822791	.	T	A	2	2	4	0	1	5	0	0
7	52822793	.	A	G	2	3	5	0	0	5	0	0
7	52823429	.	A	T	16	17	33	0	1	34	0	0
7	52830447	.	G	T	2	8	10	0	0	10	0	0
7	52830601	.	T	G	24	18	42	0	1	43	0	0
7	52831053	.	G	T	23	23	46	0	1	47	0	0
7	52831413	.	C	T	15	14	29	0	2	31	0	0
7	52831622	.	T	C	11	6	17	1	1	19	0	0
7	52832127	.	C	T	9	11	20	0	0	20	0	0
7	52832129	.	C	T	9	10	19	0	2	21	0	0
7	52833126	.	C	G	5	4	9	0	0	9	0	0
7	52833248	.	A	T	9	3	12	0	1	13	0	0
7	52833606	.	G	A	16	13	29	0	2	31	0	0
7	52833792	.	G	A	4	8	12	0	0	12	0	0
7	52837804	.	T	G	6	7	13	0	1	14	0	0
7	52837908	.	G	A	5	3	8	0	0	8	0	0
7	52838681	.	G	A	5	2	7	0	0	7	0	0
7	52900928	.	A	C	5	6	11	0	0	11	0	0
7	52901531	.	C	T	3	5	8	0	0	8	0	0
7	52902160	.	G	A	10	7	17	0	0	17	0	0
7	52929182	.	G	A	27	25	52	0	4	56	0	0
7	52933191	.	C	T	9	5	14	0	2	16	0	0
7	52937334	.	G	A	5	3	8	0	1	9	0	0
7	52942312	.	G	T	3	4	7	0	1	8	0	0
7	52944199	.	G	A	3	4	7	0	0	7	0	0
7	52958995	.	T	C	2	3	5	0	0	5	0	0
7	52959409	.	A	G	2	3	5	0	0	5	0	0
7	52959500	.	G	A	1	2	3	0	0	3	0	0
7	52959505	.	T	A	1	2	3	0	0	3	0	0
7	52962765	.	T	C	3	0	3	0	7	10	0	0
7	54307309	.	T	A	2	2	4	0	0	4	0	0
7	54307660	.	A	G	3	2	5	0	0	5	0	0
7	54307898	.	T	C	3	3	6	0	0	6	0	0
7	54307917	.	G	A	1	4	5	0	3	8	0	0
7	54323986	.	T	C	10	0	10	0	8	18	0	0
7	54331379	.	G	C	2	3	5	0	0	5	0	0
7	54655025	.	A	T	2	10	12	0	1	13	0	0
7	54655245	.	C	T	4	2	6	0	0	6	0	0
7	55261074	.	C	T	1	2	3	0	0	3	0	0
7	55315941	.	G	A	0	2	2	1	2	5	0	0
7	55315946	.	C	G	2	2	4	1	0	5	0	0
7	55321423	.	C	A	2	2	4	0	2	6	0	0
7	55531105	.	A	G	13	11	24	0	0	24	0	0
7	55531112	.	G	A	12	11	23	0	1	24	0	0
7	55531430	.	G	T	8	5	13	0	0	13	0	0
7	55532281	.	G	A	5	2	7	0	0	7	0	0
7	55532316	.	A	G	3	3	6	0	0	6	0	0
7	55532327	.	C	A	3	3	6	0	0	6	0	0
7	55532380	.	T	C	3	0	3	0	5	8	0	0
7	55532424	.	C	A	2	3	5	0	0	5	0	0
7	55532429	.	T	C	4	1	5	0	1	6	0	0
7	55532656	.	A	G	5	6	11	0	1	12	0	0
7	55535754	.	T	A	3	5	8	0	0	8	0	0
7	55536419	.	C	G	2	6	8	0	0	8	0	0
7	55536451	.	G	A	1	5	6	0	0	7	1	0
7	55536487	.	G	A	1	2	3	0	0	3	0	0
7	55635355	.	G	A	0	4	4	0	5	9	0	0
7	55636389	.	T	G	1	2	3	0	1	4	0	0
7	55637122	.	C	A	7	9	16	0	0	16	0	0
7	56152363	.	C	A	10	5	15	0	1	16	0	0
7	56152436	.	G	A	6	7	13	0	0	13	0	0
7	56152437	.	G	A	5	7	12	0	0	12	0	0
7	56152660	.	T	C	11	7	18	0	2	20	0	0
7	56152740	.	G	A	14	12	26	0	3	29	0	0
7	56152759	.	C	G	1	14	15	0	14	29	0	0
7	56158197	.	G	A	10	5	15	0	0	15	0	0
7	56164219	.	T	G	7	3	10	0	0	10	0	0
7	56164267	.	G	A	4	4	8	0	0	8	0	0
7	56167349	.	C	A	11	2	13	0	1	14	0	0
7	56396599	.	G	A	0	3	3	0	2	5	0	0
7	56397859	.	G	A	3	4	7	0	0	7	0	0
7	56400428	.	C	T	3	2	5	0	0	5	0	0
7	56401049	.	A	G	3	3	6	0	1	7	0	0
7	56483052	.	G	A	3	2	5	0	0	5	0	0
7	56483772	.	T	G	11	7	18	0	1	19	0	0
7	56483928	.	C	T	8	8	16	0	0	16	0	0
7	56484288	.	G	C	19	15	34	0	0	34	0	0
7	56523233	.	A	G	3	4	7	0	0	7	0	0
7	56528922	.	G	A	8	3	11	0	0	11	0	0
7	56529301	.	T	A	4	3	7	0	1	8	0	0
7	56529352	.	T	C	2	3	5	0	0	5	0	0
7	56721953	.	G	A	0	2	2	0	3	5	0	0
7	56721963	.	T	A	3	2	5	0	0	5	0	0
7	56746311	.	C	T	2	8	10	0	0	10	0	0
7	56761482	.	G	T	6	7	13	0	0	13	0	0
7	56764603	.	G	A	2	3	5	0	1	6	0	0
7	56778235	.	T	A	20	19	39	0	2	41	0	0
7	56778251	.	T	C	19	17	36	0	2	38	0	0
7	56778282	.	C	T	4	17	21	0	15	36	0	0
7	56778605	.	A	T	28	24	52	0	3	55	0	0
7	56778817	.	G	A	7	9	16	0	0	16	0	0
7	56778822	.	A	T	5	10	15	0	0	15	0	0
7	56784046	.	C	T	5	13	18	0	2	20	0	0
7	56784070	.	A	T	5	13	18	0	0	18	0	0
7	56785006	.	T	C	9	7	16	0	0	16	0	0
7	56785093	.	A	C	7	9	16	0	1	17	0	0
7	56785315	.	G	A	10	5	15	0	2	17	0	0
7	56787414	.	A	T	3	8	11	0	2	13	0	0
7	56787483	.	T	A	8	5	13	0	0	13	0	0
7	56787527	.	C	T	3	7	10	0	0	10	0	0
7	56787671	.	T	A	1	2	3	0	0	3	0	0
7	56793647	.	C	A	1	2	3	0	5	8	0	0
7	57081143	.	C	T	2	3	5	0	0	5	0	0
7	57081146	.	T	C	2	3	5	0	0	5	0	0
7	57083156	.	A	T	4	5	9	0	0	9	0	0
7	57086216	.	G	A	1	2	3	0	3	6	0	0
7	57086277	.	G	A	0	5	5	0	6	11	0	0
7	57086383	.	C	A	2	8	10	0	0	10	0	0
7	57113135	.	A	G	1	2	3	0	0	3	0	0
7	57123438	.	A	G	1	2	3	0	0	3	0	0
7	57123513	.	T	G	1	0	1	0	6	7	0	0
7	57129474	.	A	G	3	4	7	0	1	8	0	0
7	57129518	.	C	T	3	5	8	0	0	8	0	0
7	57129520	.	A	T	3	5	8	0	0	8	0	0
7	57129553	.	C	A	3	6	9	0	0	9	0	0
7	57129729	.	G	T	4	3	7	0	0	7	0	0
7	57129766	.	A	T	4	6	10	0	0	10	0	0
7	57469531	.	C	A	1	2	3	0	0	3	0	0
7	57469559	.	G	T	2	4	6	0	0	6	0	0
7	57469701	.	T	A	1	3	4	0	1	5	0	0
7	57485461	.	T	C	11	7	18	0	0	18	0	0
7	57485811	.	C	A	13	6	19	0	1	20	0	0
7	57485847	.	G	A	14	7	21	0	0	21	0	0
7	57494184	.	C	T	1	8	9	0	14	23	0	0
7	57497353	.	T	C	6	5	11	0	0	11	0	0
7	57497455	.	C	G	7	2	9	0	0	9	0	0
7	57497456	.	T	C	7	0	7	0	2	9	0	0
7	57504671	.	A	G	3	6	9	0	1	10	0	0
7	58259561	.	A	G	1	8	9	0	0	9	0	0
7	61174005	.	A	T	5	0	5	0	1	6	0	0
7	61804880	.	A	T	4	6	10	0	0	10	0	0
7	61804909	.	C	A	4	5	9	0	0	9	0	0
7	61805102	.	G	A	8	3	11	0	0	11	0	0
7	61805104	.	T	A	8	3	11	0	0	11	0	0
7	61977229	.	C	T	5	9	14	0	0	14	0	0
7	61977256	.	A	T	7	6	13	0	2	15	0	0
7	61977499	.	T	C	7	5	12	0	4	16	0	0
7	61977514	.	G	A	10	6	16	0	2	18	0	0
7	61977744	.	G	A	4	6	10	0	0	10	0	0
7	61981518	.	A	G	2	2	4	0	0	4	0	0
7	61989033	.	A	C	1	3	4	0	0	4	0	0
7	62009652	.	G	A	0	11	11	0	8	19	0	0
7	62009677	.	G	A	0	9	9	0	8	17	0	0
7	62009701	.	C	T	6	9	15	0	0	15	0	0
7	62268259	.	C	T	1	3	4	0	0	4	0	0
7	63328446	.	T	A	4	3	7	0	0	7	0	0
7	63328485	.	C	T	6	3	9	0	0	9	0	0
7	63328599	.	A	G	6	0	6	0	6	12	0	0
7	63328632	.	C	A	6	5	11	0	0	11	0	0
7	63328746	.	G	T	5	4	9	0	2	11	0	0
7	63328764	.	G	A	1	4	5	0	6	11	0	0
7	64963482	.	T	C	3	2	5	0	0	5	0	0
7	64978891	.	A	C	3	4	7	0	0	7	0	0
7	64980793	.	A	G	2	3	5	0	0	5	0	0
7	64980820	.	A	G	2	2	4	0	0	4	0	0
7	64988061	.	A	G	3	3	6	0	0	6	0	0
7	64991495	.	T	C	3	2	5	0	1	6	0	0
7	64991501	.	A	G	3	2	5	0	1	6	0	0
7	65035275	.	A	G	3	5	8	0	0	8	0	0
7	65035416	.	G	T	2	3	5	0	0	5	0	0
7	65035437	.	C	T	1	2	3	0	0	3	0	0
7	65039374	.	T	A	8	4	12	0	0	12	0	0
7	65039436	.	A	C	12	0	12	0	8	20	0	0
7	65049706	.	C	T	0	3	3	0	1	4	0	0
7	65104792	.	C	T	2	3	5	0	0	5	0	0
7	65157397	.	A	C	3	2	5	0	1	6	0	0
7	65162339	.	G	A	0	6	6	0	5	11	0	0
7	65173289	.	A	T	17	9	26	0	2	28	0	0
7	65173534	.	C	T	11	11	22	0	0	22	0	0
7	65173829	.	A	T	2	3	5	0	0	5	0	0
7	65178135	.	C	T	0	4	4	0	4	8	0	0
7	65178270	.	C	T	5	2	7	0	0	7	0	0
7	65178664	.	C	T	1	2	3	0	0	3	0	0
7	65297041	.	A	T	1	4	5	0	0	5	0	0
7	65297313	.	G	T	4	4	8	0	0	8	0	0
7	65306067	.	T	C	8	6	14	0	0	14	0	0
7	65306229	.	G	A	6	11	17	0	3	20	0	0
7	65433092	.	T	C	1	3	4	0	0	4	0	0
7	65440308	.	T	A	1	3	4	0	0	4	0	0
7	65443396	.	G	A	3	2	5	0	0	5	0	0
7	65451324	.	T	A	1	4	5	0	0	5	0	0
7	65451369	.	C	T	4	3	7	0	0	7	0	0
7	65452005	.	G	A	0	3	3	0	3	6	0	0
7	65452017	.	G	A	3	3	6	0	0	6	0	0
7	65453057	.	G	A	1	5	6	0	4	10	0	0
7	65457103	.	A	G	6	0	6	0	5	11	0	0
7	65461040	.	G	A	0	3	3	0	9	12	0	0
7	65463165	.	C	A	10	11	21	0	1	22	0	0
7	65463297	.	G	T	1	12	13	0	11	24	0	0
7	65463511	.	G	A	0	19	19	0	20	39	0	0
7	65463586	.	C	T	12	12	24	0	3	27	0	0
7	65463608	.	A	C	2	3	5	0	4	9	0	0
7	65463906	.	T	C	8	12	20	0	1	21	0	0
7	65464120	.	T	G	6	13	19	1	1	21	0	0
7	65464132	.	T	G	16	0	16	1	6	23	0	0
7	65473137	.	G	T	11	25	36	0	2	38	0	0
7	65473421	.	G	C	28	20	48	0	0	48	0	0
7	65473775	.	G	T	10	30	40	0	0	40	0	0
7	65473814	.	T	C	28	11	39	0	1	40	0	0
7	65473972	.	T	C	19	16	35	0	1	36	0	0
7	65475422	.	T	G	17	18	35	0	1	36	0	0
7	65475708	.	T	G	9	8	17	0	0	17	0	0
7	65491835	.	G	A	7	10	17	0	0	17	0	0
7	65920618	.	G	A	1	2	3	0	0	3	0	0
7	65921467	.	G	C	2	2	4	0	0	4	0	0
7	65923238	.	C	T	2	2	4	0	0	4	0	0
7	65923921	.	T	C	2	5	7	0	0	7	0	0
7	65923944	.	T	G	4	3	7	0	0	7	0	0
7	65924277	.	T	C	8	4	12	0	0	12	0	0
7	65924554	.	A	G	5	2	7	0	1	8	0	0
7	65924558	.	C	T	7	2	9	0	0	9	0	0
7	65924621	.	T	C	7	5	12	0	1	13	0	0
7	65924634	.	A	G	5	4	9	0	1	10	0	0
7	66105498	.	C	T	2	2	4	0	0	4	0	0
7	66105663	.	A	G	2	0	2	0	3	5	0	0
7	66112702	.	T	C	12	3	15	0	0	15	0	0
7	66113100	.	G	A	5	8	13	0	1	14	0	0
7	66113124	.	G	A	2	6	8	0	0	8	0	0
7	66126466	.	T	C	3	2	5	0	0	5	0	0
7	66259574	.	A	T	7	6	13	0	0	13	0	0
7	66276243	.	G	A	8	9	17	0	0	17	0	0
7	66361984	.	A	G	2	5	7	0	0	7	0	0
7	66368605	.	G	C	1	0	1	0	3	4	0	0
7	67434693	.	A	C	7	8	15	0	0	15	0	0
7	67434807	.	T	C	2	5	7	0	0	7	0	0
7	67435587	.	T	C	8	9	17	0	0	17	0	0
7	67436273	.	C	T	8	8	16	0	1	17	0	0
7	67439428	.	A	C	2	3	5	0	1	6	0	0
7	67439496	.	T	A	6	5	11	0	1	12	0	0
7	67439520	.	T	A	3	8	11	0	1	12	0	0
7	67439742	.	T	C	9	8	17	0	0	17	0	0
7	67439743	.	C	T	8	8	16	0	0	16	0	0
7	67439781	.	T	C	12	7	19	0	0	19	0	0
7	67443766	.	T	C	18	10	28	0	0	28	0	0
7	67444837	.	G	A	11	13	24	0	5	29	0	0
7	67446295	.	C	T	23	12	35	1	0	36	0	0
7	67448338	.	T	C	24	19	43	0	1	44	0	0
7	67448363	.	A	T	21	14	35	0	3	38	0	0
7	67448373	.	T	A	22	14	36	0	0	36	0	0
7	67476376	.	T	C	38	26	64	0	3	67	0	0
7	67747819	.	T	C	14	7	21	0	0	21	0	0
7	67747826	.	T	G	15	6	21	0	1	22	0	0
7	67747869	.	G	C	14	5	19	0	0	19	0	0
7	67770477	.	T	G	3	2	5	0	0	5	0	0
7	67795367	.	T	C	2	5	7	0	0	7	0	0
7	67795386	.	A	G	3	4	7	0	0	7	0	0
7	67795429	.	G	A	3	6	9	0	0	9	0	0
7	67796494	.	G	A	1	5	6	0	5	11	0	0
7	67797037	.	C	G	9	8	17	0	0	17	0	0
7	67797087	.	G	T	10	5	15	0	0	15	0	0
7	67797097	.	C	T	10	5	15	0	0	15	0	0
7	67817399	.	C	T	2	4	6	0	0	6	0	0
7	67833051	.	G	A	3	2	5	0	0	5	0	0
7	67835264	.	A	G	0	2	2	0	1	3	0	0
7	67835269	.	A	C	1	2	3	0	0	3	0	0
7	67842641	.	G	T	1	7	8	0	0	8	0	0
7	69145032	.	T	C	1	4	5	0	1	6	0	0
7	69145672	.	T	C	3	0	3	0	3	6	0	0
7	69583139	.	C	T	1	5	6	0	0	6	0	0
7	69946917	.	G	A	0	2	2	0	3	5	0	0
7	69947656	.	C	G	1	0	1	0	2	3	0	0
7	69950322	.	G	A	5	2	7	0	0	7	0	0
7	69959980	.	G	A	1	2	3	0	0	3	0	0
7	70601377	.	C	T	1	2	3	0	0	3	0	0
7	72018290	.	G	T	0	5	5	0	4	9	0	0
7	72024034	.	T	G	2	4	6	0	0	6	0	0
7	72024081	.	G	T	2	7	9	0	0	9	0	0
7	72024117	.	C	G	2	10	12	0	0	12	0	0
7	72024239	.	T	A	3	7	10	0	0	10	0	0
7	72024446	.	C	G	2	6	8	0	0	8	0	0
7	72024491	.	A	T	3	7	10	0	0	10	0	0
7	72024733	.	A	G	5	3	8	0	0	8	0	0
7	72025428	.	T	A	10	6	16	0	1	17	0	0
7	72025430	.	G	A	0	7	7	0	10	17	0	0
7	72025548	.	A	T	2	8	10	0	2	12	0	0
7	72025688	.	A	G	6	1	7	0	13	20	0	0
7	72025689	.	C	G	6	12	18	0	1	19	0	0
7	72025748	.	G	A	4	14	18	0	0	18	0	0
7	72025774	.	T	C	5	13	18	0	0	18	0	0
7	72027982	.	C	T	24	17	41	0	0	41	0	0
7	72028015	.	C	T	33	9	42	0	1	43	0	0
7	72028326	.	A	G	32	12	44	0	2	46	0	0
7	72028386	.	T	A	31	9	40	0	3	43	0	0
7	72028442	.	G	T	26	7	33	2	3	38	0	0
7	72028458	.	T	C	24	9	33	2	4	39	0	0
7	72028841	.	A	G	24	17	41	0	2	43	0	0
7	72028893	.	G	T	1	4	5	0	13	18	0	0
7	72028976	.	A	T	17	8	25	0	0	25	0	0
7	72029011	.	C	T	17	11	28	0	1	29	0	0
7	72029083	.	T	C	20	15	35	0	1	36	0	0
7	72029127	.	G	T	25	19	44	0	2	46	0	0
7	72029383	.	G	C	25	20	45	0	1	46	0	0
7	72029424	.	G	A	20	23	43	0	3	46	0	0
7	72029429	.	T	G	22	0	22	0	23	45	0	0
7	72032982	.	A	T	28	15	43	0	1	44	0	0
7	72033024	.	G	C	20	12	32	0	5	37	0	0
7	72033053	.	A	C	14	21	35	0	3	38	0	0
7	72033186	.	A	C	19	31	50	0	0	50	0	0
7	72033264	.	G	A	17	25	42	2	1	45	0	0
7	72033286	.	C	T	20	20	40	2	2	44	0	0
7	72033312	.	G	A	22	17	39	0	3	42	0	0
7	72033370	.	A	C	11	26	37	0	3	40	0	0
7	72033384	.	A	C	12	26	38	0	2	40	0	0
7	72034012	.	T	C	12	5	17	0	1	18	0	0
7	72034024	.	C	T	11	7	18	0	2	20	0	0
7	72034151	.	T	C	11	13	24	0	0	24	0	0
7	72034304	.	G	A	13	8	21	0	0	21	0	0
7	72034339	.	C	A	24	9	33	0	3	36	0	0
7	72034776	.	C	T	3	6	9	0	1	10	0	0
7	72034805	.	T	C	3	0	3	0	9	12	0	0
7	72034856	.	A	G	3	10	13	1	2	16	0	0
7	72034874	.	T	C	7	10	17	2	2	21	0	0
7	72035075	.	G	A	6	17	23	0	1	24	0	0
7	72035321	.	A	T	6	13	19	0	0	19	0	0
7	72035339	.	T	G	7	18	25	0	0	25	0	0
7	72035475	.	C	T	0	6	6	0	1	7	0	0
7	72035526	.	C	T	2	3	5	0	0	5	0	0
7	72279715	.	G	A	0	5	5	0	1	6	0	0
7	72415298	.	A	T	1	2	3	0	0	3	0	0
7	72417355	.	T	A	0	2	2	0	1	3	0	0
7	72454275	.	A	G	3	1	4	0	1	5	0	0
7	72454277	.	G	T	1	2	3	0	2	5	0	0
7	72570359	.	A	G	4	2	6	0	0	6	0	0
7	72578005	.	C	G	4	6	10	0	0	10	0	0
7	73087250	.	A	C	1	9	10	0	0	10	0	0
7	73617589	.	A	G	1	5	6	0	0	6	0	0
7	73617726	.	A	G	8	2	10	0	0	10	0	0
7	73618739	.	A	G	2	5	7	0	3	10	0	0
7	73656361	.	G	A	5	3	8	0	0	8	0	0
7	73928172	.	A	G	3	2	5	0	0	5	0	0
7	74056606	.	G	T	1	2	3	0	0	3	0	0
7	74134988	.	T	C	24	10	34	0	1	35	0	0
7	74135136	.	G	A	2	21	23	0	21	44	0	0
7	74135375	.	C	T	28	18	46	0	7	53	0	0
7	74135462	.	A	G	20	14	34	0	1	35	0	0
7	74143628	.	C	T	4	5	9	0	2	11	0	0
7	74144167	.	A	G	7	0	7	0	5	12	0	0
7	74154066	.	C	T	29	25	54	1	2	57	0	0
8	5733	.	T	C	24	16	40	0	0	40	0	0
8	6265	.	C	T	41	26	67	0	2	69	0	0
8	6368	.	T	C	36	6	42	1	11	57	3	0
8	6440	.	A	T	27	11	38	0	5	43	0	0
8	6468	.	G	A	6	12	18	0	22	42	2	0
8	7184	.	T	C	6	6	12	0	0	12	0	0
8	7276	.	G	A	4	5	9	0	0	9	0	0
8	41751	.	G	C	12	21	33	0	1	34	0	0
8	41754	.	C	T	10	23	33	0	2	35	0	0
8	41925	.	T	C	18	0	18	0	19	37	0	0
8	41948	.	A	G	15	18	33	0	2	35	0	0
8	43740	.	T	C	10	2	12	0	15	27	0	0
8	43800	.	A	G	10	19	29	0	2	31	0	0
8	44337	.	G	A	5	14	19	0	0	19	0	0
8	52280	.	C	T	8	14	22	0	2	24	0	0
8	56225	.	T	G	9	3	12	0	0	12	0	0
8	56285	.	A	G	3	5	8	0	0	8	0	0
8	56884	.	C	T	4	6	10	0	2	12	0	0
8	58399	.	C	G	1	6	7	0	0	7	0	0
8	61833	.	G	A	6	8	14	0	0	14	0	0
8	75188	.	C	A	5	4	9	0	1	10	0	0
8	75446	.	G	T	1	7	8	0	3	11	0	0
8	75646	.	G	C	0	6	6	0	8	14	0	0
8	75669	.	C	G	4	5	9	0	0	9	0	0
8	81536	.	A	G	6	0	6	0	9	15	0	0
8	120282	.	G	A	2	2	4	0	0	4	0	0
8	120839	.	G	A	0	2	2	0	7	9	0	0
8	120896	.	T	C	7	4	11	0	0	11	0	0
8	173841	.	A	G	16	9	25	0	1	26	0	0
8	174020	.	G	A	12	11	23	1	2	26	0	0
8	262012	.	C	T	4	5	9	0	0	9	0	0
8	262054	.	C	A	5	4	9	0	1	10	0	0
8	262858	.	G	T	1	2	3	0	1	4	0	0
8	268215	.	G	A	3	7	10	0	0	10	0	0
8	269360	.	G	T	4	3	7	0	0	7	0	0
8	276277	.	C	T	3	12	15	0	0	15	0	0
8	276334	.	A	G	8	9	17	0	1	18	0	0
8	286192	.	A	G	12	8	20	0	0	20	0	0
8	286251	.	C	T	13	7	20	0	1	21	0	0
8	286302	.	G	A	14	8	22	0	2	24	0	0
8	387853	.	A	T	3	7	10	0	0	10	0	0
8	387915	.	A	G	7	4	11	0	0	11	0	0
8	387926	.	G	A	5	3	8	0	1	9	0	0
8	388885	.	C	T	23	19	42	0	0	42	0	0
8	391712	.	T	C	19	4	23	0	1	24	0	0
8	391715	.	T	C	17	4	21	0	3	24	0	0
8	392047	.	G	T	8	17	25	0	2	27	0	0
8	392160	.	C	A	9	5	14	0	1	15	0	0
8	392389	.	T	C	7	0	7	0	11	18	0	0
8	392689	.	C	T	3	7	10	2	17	29	0	0
8	395281	.	C	A	1	6	7	0	3	10	0	0
8	395287	.	C	T	2	4	6	0	1	7	0	0
8	397338	.	T	C	5	9	14	0	0	14	0	0
8	397341	.	C	T	1	9	10	0	4	14	0	0
8	406330	.	T	G	2	4	6	0	0	6	0	0
8	406432	.	A	C	1	2	3	0	0	3	0	0
8	412296	.	T	C	15	1	16	0	12	28	0	0
8	412303	.	G	A	16	7	23	0	1	24	0	0
8	412355	.	A	G	16	19	35	0	2	37	0	0
8	412358	.	A	G	15	21	36	0	0	36	0	0
8	412504	.	T	C	15	1	16	0	14	30	0	0
8	413845	.	G	C	8	0	8	0	15	23	0	0
8	418575	.	A	G	2	3	5	0	0	5	0	0
8	423723	.	C	T	12	14	26	0	3	29	0	0
8	424969	.	G	A	5	10	15	0	0	15	0	0
8	478889	.	G	T	1	4	5	0	0	5	0	0
8	482033	.	A	G	5	3	8	0	0	8	0	0
8	484780	.	A	G	1	0	1	0	5	6	0	0
8	487241	.	T	C	8	4	12	0	0	12	0	0
8	489120	.	C	T	3	4	7	0	0	7	0	0
8	489135	.	C	T	3	3	6	0	1	7	0	0
8	534387	.	G	C	1	4	5	0	0	5	0	0
8	539973	.	T	G	3	0	3	0	7	10	0	0
8	539979	.	C	G	3	6	9	0	0	9	0	0
8	541376	.	C	A	6	9	15	0	0	15	0	0
8	705549	.	C	T	1	2	3	0	1	4	0	0
8	926941	.	T	C	1	2	3	0	0	3	0	0
8	927105	.	T	C	6	2	8	0	0	8	0	0
8	928341	.	G	A	7	13	20	0	0	20	0	0
8	941343	.	T	C	3	4	7	0	0	7	0	0
8	941369	.	T	C	5	3	8	0	0	8	0	0
8	941378	.	C	T	0	4	4	0	5	9	0	0
8	943953	.	G	C	4	2	6	0	0	6	0	0
8	1094388	.	G	A	2	4	6	0	0	6	0	0
8	1094542	.	T	C	5	4	9	0	0	9	0	0
8	1094566	.	C	T	4	5	9	0	0	9	0	0
8	1094590	.	G	A	0	3	3	0	1	4	0	0
8	1094910	.	T	A	4	3	7	0	0	7	0	0
8	1100463	.	C	T	5	8	13	0	0	13	0	0
8	1102404	.	T	C	8	5	13	0	0	13	0	0
8	1104980	.	A	G	7	0	7	0	4	11	0	0
8	1106149	.	C	T	9	7	16	0	0	16	0	0
8	1106494	.	C	A	5	5	10	0	0	10	0	0
8	1130331	.	C	T	1	2	3	0	0	3	0	0
8	1130450	.	C	G	3	0	3	0	10	13	0	0
8	1130544	.	T	C	4	9	13	0	0	13	0	0
8	1133743	.	A	G	4	0	4	0	5	9	0	0
8	1133753	.	C	G	3	4	7	0	2	9	0	0
8	1133889	.	T	G	3	2	5	0	1	6	0	0
8	1151416	.	T	C	9	13	22	0	0	22	0	0
8	1222356	.	A	T	4	2	6	0	1	7	0	0
8	1222357	.	G	A	4	3	7	0	0	7	0	0
8	1222417	.	T	C	7	1	8	0	7	15	0	0
8	1222504	.	T	C	17	0	17	0	20	37	0	0
8	1222558	.	A	G	21	16	37	0	2	39	0	0
8	1253651	.	G	A	16	19	35	0	0	35	0	0
8	1254337	.	C	T	11	10	21	0	2	23	0	0
8	1255292	.	C	G	1	9	10	0	10	20	0	0
8	1255304	.	G	A	10	7	17	0	1	18	0	0
8	1259023	.	G	A	14	11	25	0	0	25	0	0
8	1264645	.	A	G	4	6	10	0	2	12	0	0
8	1270107	.	T	G	1	2	3	0	0	3	0	0
8	1852180	.	A	G	2	2	4	0	0	4	0	0
8	1855256	.	A	G	8	4	12	0	0	12	0	0
8	2215809	.	G	C	7	0	7	0	3	10	0	0
8	2215965	.	T	A	1	5	6	0	0	6	0	0
8	2219604	.	G	A	2	2	4	0	0	4	0	0
8	2574688	.	A	G	3	2	5	0	1	6	0	0
8	2574695	.	T	G	4	1	5	0	0	5	0	0
8	2585280	.	A	T	2	3	5	0	2	7	0	0
8	2787035	.	C	T	1	2	3	0	0	3	0	0
8	3085565	.	A	G	2	3	5	0	0	5	0	0
8	3101277	.	T	C	3	6	9	0	0	9	0	0
8	3605171	.	C	T	1	2	3	0	0	3	0	0
8	3624208	.	G	C	4	13	17	0	0	17	0	0
8	3628683	.	C	T	7	6	13	0	0	13	0	0
8	3628747	.	C	A	11	4	15	0	1	16	0	0
8	3628758	.	T	A	10	4	14	0	0	14	0	0
8	3628782	.	G	A	1	7	8	0	12	20	0	0
8	3629231	.	G	T	2	8	10	0	14	24	0	0
8	3629232	.	T	C	15	8	23	0	0	23	0	0
8	3630935	.	A	T	9	3	12	0	1	13	0	0
8	3631371	.	T	C	10	5	15	0	1	16	0	0
8	3641224	.	C	T	19	17	36	0	0	36	0	0
8	3643299	.	T	C	23	25	48	1	0	49	0	0
8	3659979	.	T	C	1	2	3	0	0	3	0	0
8	3859383	.	T	A	2	3	5	0	0	5	0	0
8	3883831	.	C	G	3	2	5	0	0	5	0	0
8	3904963	.	C	T	1	3	4	0	0	4	0	0
8	3906073	.	C	A	1	2	3	0	0	3	0	0
8	3915909	.	G	A	3	5	8	0	0	8	0	0
8	3918567	.	C	T	3	7	10	0	0	10	0	0
8	3932842	.	T	G	5	2	7	1	0	8	0	0
8	3932889	.	A	T	4	4	8	1	2	11	0	0
8	3932990	.	A	G	6	3	9	0	0	9	0	0
8	3950039	.	C	G	3	4	7	0	0	7	0	0
8	3950317	.	G	A	4	3	7	0	1	8	0	0
8	3950341	.	A	G	2	2	4	0	0	4	0	0
8	3956898	.	G	A	1	2	3	0	0	3	0	0
8	4762881	.	G	A	1	5	6	0	4	10	0	0
8	4771987	.	C	T	13	16	29	0	2	31	0	0
8	4780110	.	A	C	8	6	14	0	1	15	0	0
8	4780238	.	T	A	5	7	12	0	0	12	0	0
8	4780324	.	G	A	5	3	8	0	0	8	0	0
8	4780586	.	G	A	16	6	22	0	1	23	0	0
8	4780637	.	G	T	15	4	19	0	1	20	0	0
8	4782879	.	C	T	0	4	4	0	4	8	0	0
8	4806795	.	T	C	1	3	4	0	0	4	0	0
8	4813479	.	A	C	1	3	4	0	0	4	0	0
8	4813493	.	T	C	1	2	3	0	0	3	0	0
8	4813592	.	C	T	1	5	6	0	0	6	0	0
8	4813635	.	G	A	1	5	6	0	1	7	0	0
8	4848815	.	A	G	1	6	7	0	0	7	0	0
8	4848818	.	G	T	0	6	6	0	1	7	0	0
8	4964228	.	A	G	4	7	11	0	2	13	0	0
8	4964236	.	T	C	10	11	21	0	0	21	0	0
8	4964521	.	G	A	14	9	23	0	1	24	0	0
8	4972812	.	C	T	4	4	8	0	1	9	0	0
8	5119396	.	A	G	1	4	5	0	0	5	0	0
8	7022305	.	C	T	4	4	8	0	0	8	0	0
8	7023091	.	T	G	12	0	12	0	3	15	0	0
8	7118497	.	T	C	2	2	4	0	1	5	0	0
8	7118520	.	T	G	4	0	4	0	1	5	0	0
8	7118809	.	G	A	1	3	4	0	0	4	0	0
8	7119013	.	G	A	0	3	3	0	2	5	0	0
8	7120546	.	A	G	5	3	8	0	0	8	0	0
8	7120572	.	C	G	2	2	4	0	0	4	0	0
8	7120604	.	T	C	4	3	7	0	0	7	0	0
8	7121011	.	T	A	9	4	13	0	1	14	0	0
8	7121347	.	A	T	3	2	5	0	0	5	0	0
8	7121649	.	T	C	4	4	8	0	0	8	0	0
8	7121681	.	A	G	3	5	8	0	0	8	0	0
8	7121868	.	C	T	3	2	5	0	0	5	0	0
8	7121877	.	A	G	3	2	5	0	0	5	0	0
8	7122171	.	A	T	3	2	5	0	0	5	0	0
8	7122186	.	T	C	3	2	5	0	0	5	0	0
8	7122221	.	T	A	1	4	5	0	0	5	0	0
8	7122396	.	C	A	5	3	8	0	0	8	0	0
8	7122403	.	A	G	4	0	4	0	5	9	0	0
8	7122459	.	A	G	4	5	9	0	0	9	0	0
8	7122460	.	A	T	4	5	9	0	0	9	0	0
8	7122931	.	G	A	1	6	7	0	7	14	0	0
8	7123171	.	G	C	2	14	16	0	13	29	0	0
8	7123233	.	A	T	20	8	28	0	1	29	0	0
8	7123257	.	T	C	17	9	26	0	5	31	0	0
8	7123323	.	C	A	14	9	23	0	0	23	0	0
8	7123326	.	A	G	11	7	18	0	2	20	0	0
8	7123360	.	A	T	12	6	18	0	2	20	0	0
8	7123414	.	G	A	1	11	12	0	7	19	0	0
8	7123415	.	G	C	7	11	18	0	1	19	0	0
8	7123452	.	G	A	11	15	26	0	3	29	0	0
8	7123472	.	A	G	14	16	30	0	3	33	0	0
8	7123491	.	T	C	16	13	29	0	1	30	0	0
8	7123538	.	G	A	11	8	19	0	0	19	0	0
8	7912664	.	A	T	3	1	4	0	2	6	0	0
8	8686394	.	T	C	2	3	5	0	1	6	0	0
8	8686413	.	T	C	3	3	6	0	0	6	0	0
8	8686442	.	T	C	6	2	8	0	0	8	0	0
8	8699211	.	C	T	2	2	4	0	0	4	0	0
8	8704215	.	C	T	7	8	15	0	0	15	0	0
8	8704274	.	A	G	2	0	2	0	3	5	0	0
8	8847648	.	T	A	1	4	5	0	0	5	0	0
8	8847893	.	A	T	5	4	9	0	0	9	0	0
8	8848122	.	C	A	2	3	5	0	0	5	0	0
8	8861240	.	G	A	0	3	3	0	2	5	0	0
8	8914911	.	C	T	9	4	13	0	0	13	0	0
8	8919045	.	G	A	1	14	15	0	17	33	1	0
8	8993240	.	A	G	3	2	5	0	0	5	0	0
8	9015855	.	A	G	5	4	9	0	0	9	0	0
8	9015894	.	G	C	3	4	7	0	0	7	0	0
8	9028945	.	G	A	0	3	3	0	4	7	0	0
8	9093623	.	A	T	2	2	4	0	0	4	0	0
8	9390769	.	G	A	1	2	3	0	0	3	0	0
8	9748783	.	A	G	2	2	4	0	0	4	0	0
8	9781903	.	G	A	4	2	6	0	0	6	0	0
8	9791577	.	G	A	1	4	5	0	1	6	0	0
8	9791902	.	T	C	3	3	6	0	0	6	0	0
8	9985326	.	C	T	3	9	12	0	3	15	0	0
8	9985374	.	A	G	9	6	15	0	0	15	0	0
8	10305260	.	C	T	7	6	13	0	2	15	0	0
8	10306061	.	C	T	13	5	18	0	1	19	0	0
8	10307924	.	G	A	10	15	25	0	2	27	0	0
8	10308278	.	G	T	22	17	39	0	0	39	0	0
8	10857026	.	C	A	1	2	3	0	0	3	0	0
8	10884375	.	G	A	0	2	2	0	1	3	0	0
8	10890079	.	C	T	2	2	4	0	0	4	0	0
8	10890169	.	T	C	6	9	15	0	0	15	0	0
8	10894887	.	C	T	4	7	11	0	1	12	0	0
8	10937661	.	A	G	1	2	3	0	0	3	0	0
8	10956561	.	G	T	8	5	13	0	0	13	0	0
8	10956794	.	G	C	6	11	17	0	0	17	0	0
8	10956824	.	A	G	12	6	18	1	0	19	0	0
8	10957045	.	G	T	13	13	26	0	1	28	1	0
8	10967342	.	T	C	9	0	9	0	14	23	0	0
8	10969694	.	C	T	7	4	11	0	1	12	0	0
8	10972414	.	G	A	1	8	9	0	0	9	0	0
8	11004597	.	G	T	2	2	4	0	0	4	0	0
8	11010149	.	T	C	7	7	14	0	3	17	0	0
8	11115005	.	A	T	2	3	5	0	0	5	0	0
8	11115117	.	A	T	6	1	7	0	1	8	0	0
8	11115164	.	A	C	4	3	7	0	0	7	0	0
8	11116617	.	G	A	2	2	4	0	0	4	0	0
8	11136791	.	G	A	5	5	10	0	0	10	0	0
8	11144820	.	T	C	1	0	1	0	3	4	0	0
8	11174659	.	T	C	1	2	3	0	0	3	0	0
8	11174689	.	T	A	1	2	3	0	0	3	0	0
8	11179228	.	T	A	3	5	8	0	0	8	0	0
8	11180061	.	C	T	4	6	10	0	1	11	0	0
8	11180063	.	T	G	4	6	10	0	1	11	0	0
8	11182905	.	A	C	2	3	5	0	0	5	0	0
8	11204441	.	C	T	2	5	7	1	0	8	0	0
8	11204481	.	C	G	2	2	4	1	0	5	0	0
8	11234522	.	T	G	4	5	9	0	0	9	0	0
8	11236914	.	T	C	6	3	9	0	1	10	0	0
8	11241284	.	A	T	3	2	5	0	1	6	0	0
8	11246006	.	G	A	2	2	4	0	0	4	0	0
8	11477573	.	C	T	2	3	5	0	0	5	0	0
8	11483097	.	G	A	1	6	7	0	5	12	0	0
8	11483163	.	C	T	6	12	18	0	1	19	0	0
8	11488468	.	C	T	7	11	18	0	0	18	0	0
8	11491332	.	C	T	10	4	14	0	2	16	0	0
8	11511403	.	C	T	5	2	7	0	0	7	0	0
8	11520599	.	C	T	3	4	7	0	0	7	0	0
8	11521145	.	G	A	5	5	10	0	1	11	0	0
8	11521229	.	C	T	1	3	4	0	0	4	0	0
8	11540815	.	G	T	9	12	21	0	1	22	0	0
8	11541829	.	A	G	12	6	18	0	1	19	0	0
8	11541844	.	C	A	10	6	16	0	0	16	0	0
8	11542207	.	C	G	12	10	22	0	2	24	0	0
8	11661816	.	A	C	1	2	3	0	0	3	0	0
8	11744619	.	A	G	7	9	16	0	2	18	0	0
8	11744660	.	A	G	14	7	21	0	0	21	0	0
8	11744723	.	T	G	4	12	16	0	1	17	0	0
8	11744758	.	A	G	5	11	16	0	0	16	0	0
8	11744810	.	G	A	12	5	17	0	0	17	0	0
8	11746647	.	A	G	7	3	10	0	0	10	0	0
8	11746684	.	A	G	2	10	12	0	0	13	1	0
8	11746701	.	G	T	1	10	11	0	0	11	0	0
8	11746741	.	G	A	3	6	9	0	0	9	0	0
8	11746759	.	G	A	7	3	10	0	0	10	0	0
8	11752669	.	C	T	0	2	2	0	2	4	0	0
8	11770027	.	A	G	3	2	5	0	0	5	0	0
8	11884919	.	T	A	6	3	9	0	0	9	0	0
8	11884930	.	A	G	3	4	7	0	1	8	0	0
8	11985228	.	A	G	5	3	8	0	0	8	0	0
8	12016553	.	G	A	4	2	6	0	0	6	0	0
8	12111198	.	C	T	10	8	18	0	2	20	0	0
8	12340621	.	C	T	1	2	3	1	1	5	0	0
8	14441120	.	A	G	10	4	14	0	1	15	0	0
8	14441524	.	A	G	15	10	25	1	1	27	0	0
8	14441596	.	A	G	15	6	21	0	0	21	0	0
8	14982477	.	A	C	0	4	4	0	0	4	0	0
8	15094443	.	G	A	2	2	4	0	0	4	0	0
8	15276864	.	A	T	3	2	5	1	2	8	0	0
8	16115928	.	C	T	3	1	4	0	1	5	0	0
8	16516832	.	A	T	2	10	12	0	2	14	0	0
8	16517152	.	C	A	1	3	4	0	2	6	0	0
8	16517310	.	C	G	3	2	5	0	0	5	0	0
8	16518493	.	T	A	2	3	5	0	0	5	0	0
8	16519055	.	C	T	1	3	4	0	0	4	0	0
8	16519084	.	C	A	1	4	5	0	0	5	0	0
8	16519637	.	C	T	2	2	4	0	1	5	0	0
8	16519646	.	G	T	3	2	5	0	0	5	0	0
8	16519692	.	G	A	2	4	6	0	0	6	0	0
8	16519695	.	G	C	3	3	6	0	1	7	0	0
8	16519727	.	C	T	6	2	8	0	1	9	0	0
8	16519782	.	C	T	13	2	15	0	0	15	0	0
8	16519821	.	G	A	4	13	17	0	0	17	0	0
8	16583043	.	G	A	10	7	17	11	1	29	0	0
8	16584037	.	C	T	1	17	18	13	14	45	0	0
8	16587964	.	A	T	14	5	19	0	0	19	0	0
8	16588421	.	C	T	8	5	13	0	0	13	0	0
8	16588444	.	G	A	6	2	8	0	1	9	0	0
8	16591864	.	A	G	1	4	5	0	0	5	0	0
8	16597374	.	T	C	13	4	17	1	3	21	0	0
8	16597377	.	T	C	16	4	20	1	1	22	0	0
8	16597424	.	T	C	3	6	9	1	0	10	0	0
8	16598076	.	C	T	0	2	2	0	2	4	0	0
8	16605597	.	A	G	4	2	6	0	0	6	0	0
8	16605615	.	G	A	2	3	5	0	1	6	0	0
8	16610107	.	T	C	9	0	9	0	11	20	0	0
8	16610142	.	C	T	15	12	27	0	0	27	0	0
8	16610196	.	A	G	1	4	5	0	0	5	0	0
8	16610387	.	G	A	8	5	13	0	2	15	0	0
8	16610585	.	T	C	5	10	15	0	0	15	0	0
8	16611008	.	A	G	6	3	9	0	0	9	0	0
8	16615866	.	T	C	5	4	9	0	0	9	0	0
8	16615867	.	A	G	4	5	9	0	0	9	0	0
8	16615929	.	A	T	8	9	17	0	5	23	1	0
8	16616190	.	C	A	9	9	18	1	2	22	1	0
8	16616697	.	C	T	2	16	18	0	20	38	0	0
8	16616899	.	G	A	14	5	19	0	1	20	0	0
8	16621919	.	A	G	8	9	17	0	3	20	0	0
8	16625575	.	C	A	3	3	6	0	0	6	0	0
8	16686289	.	G	A	0	1	1	0	2	3	0	0
8	16686301	.	G	C	2	3	5	0	0	5	0	0
8	16686479	.	C	G	5	2	7	0	0	7	0	0
8	16688316	.	T	G	4	2	6	0	0	6	0	0
8	16689153	.	G	A	1	2	3	3	0	6	0	0
8	16702396	.	A	T	1	4	5	0	1	6	0	0
8	17055727	.	C	T	1	18	19	0	26	45	0	0
8	17055751	.	C	T	22	9	31	0	15	46	0	0
8	17055766	.	G	A	17	26	43	0	2	45	0	0
8	17055802	.	C	T	4	16	20	0	33	53	0	0
8	17062173	.	G	A	17	11	28	0	0	28	0	0
8	17067268	.	A	T	6	8	14	0	1	15	0	0
8	17067269	.	T	C	8	5	13	0	2	15	0	0
8	17081728	.	G	T	4	9	13	0	2	15	0	0
8	17081734	.	G	A	5	11	16	0	1	17	0	0
8	17081976	.	C	T	8	7	15	0	1	16	0	0
8	17082696	.	C	A	12	8	20	0	0	20	0	0
8	17084696	.	G	C	14	17	31	0	2	33	0	0
8	17085921	.	G	A	18	19	37	0	4	41	0	0
8	17086033	.	C	T	18	7	25	2	1	28	0	0
8	17086096	.	A	T	4	4	8	0	0	8	0	0
8	17154128	.	A	G	2	0	2	0	2	4	0	0
8	17154406	.	T	C	1	3	4	0	0	4	0	0
8	17156869	.	C	T	1	3	4	0	0	4	0	0
8	17163611	.	A	G	11	7	18	0	0	18	0	0
8	17163704	.	C	T	7	9	16	0	1	17	0	0
8	17163766	.	T	A	12	12	24	0	1	25	0	0
8	17163771	.	A	G	13	9	22	0	1	23	0	0
8	17164208	.	G	A	17	22	39	0	3	42	0	0
8	17164302	.	A	G	26	16	42	0	2	44	0	0
8	17166577	.	C	T	11	11	22	0	0	22	0	0
8	17174965	.	G	C	1	5	6	0	0	6	0	0
8	17186987	.	C	T	2	2	4	0	0	4	0	0
8	17190128	.	C	T	2	3	5	0	0	5	0	0
8	17191921	.	A	G	4	2	6	0	0	6	0	0
8	17192435	.	A	G	4	2	6	0	0	6	0	0
8	17396186	.	T	G	31	18	49	0	5	54	0	0
8	17396814	.	T	A	14	0	14	1	0	16	1	0
8	17396815	.	T	A	14	3	17	1	0	18	0	0
8	17396904	.	T	C	21	1	22	0	9	31	0	0
8	17397780	.	T	C	3	5	8	0	0	8	0	0
8	17397793	.	T	A	5	6	11	0	0	11	0	0
8	17397995	.	A	T	15	8	23	0	0	23	0	0
8	17398070	.	T	C	6	13	19	0	1	20	0	0
8	17398113	.	C	T	0	5	5	0	9	14	0	0
8	17398277	.	G	A	6	2	8	0	0	8	0	0
8	17398712	.	G	A	5	5	10	0	0	10	0	0
8	17399061	.	C	T	7	4	11	0	1	12	0	0
8	17399609	.	C	T	8	9	17	0	1	18	0	0
8	17407150	.	G	A	3	3	6	0	0	6	0	0
8	17407210	.	C	G	1	6	7	0	0	7	0	0
8	17781076	.	G	A	0	6	6	0	1	7	0	0
8	17781096	.	C	A	1	6	7	0	2	9	0	0
8	17781537	.	T	C	4	8	12	0	0	12	0	0
8	17781721	.	A	G	1	2	3	0	0	3	0	0
8	17783703	.	G	T	7	3	10	0	0	10	0	0
8	17783775	.	C	T	8	4	12	0	0	12	0	0
8	17784308	.	A	G	7	12	19	0	0	19	0	0
8	17784322	.	T	A	8	14	22	0	0	22	0	0
8	17784466	.	G	A	6	2	8	0	0	8	0	0
8	17983718	.	G	C	1	5	6	0	0	6	0	0
8	18024959	.	C	T	2	8	10	0	0	10	0	0
8	18026052	.	G	A	0	3	3	0	5	8	0	0
8	18033113	.	T	C	7	4	11	0	1	12	0	0
8	18035129	.	A	T	16	6	22	0	1	23	0	0
8	18035428	.	G	A	14	11	25	0	1	26	0	0
8	18035786	.	C	T	12	12	24	0	1	25	0	0
8	18035946	.	T	A	9	11	20	0	2	22	0	0
8	18036167	.	T	C	10	14	24	0	0	24	0	0
8	18036592	.	G	A	6	12	18	0	1	19	0	0
8	18036610	.	C	T	2	6	8	0	1	9	0	0
8	18040581	.	G	A	1	6	7	0	0	7	0	0
8	18193373	.	C	G	10	6	16	0	0	16	0	0
8	18193420	.	C	G	9	4	13	0	0	13	0	0
8	18193503	.	G	T	4	3	7	0	0	7	0	0
8	18193591	.	A	T	4	8	12	0	0	13	1	0
8	18193628	.	T	C	14	14	28	0	0	28	0	0
8	18193707	.	T	C	10	16	26	0	1	27	0	0
8	18194238	.	T	C	22	15	37	0	2	39	0	0
8	18194283	.	G	A	23	16	39	0	1	40	0	0
8	18196444	.	C	T	2	11	13	0	20	33	0	0
8	18198801	.	C	T	13	9	22	0	3	25	0	0
8	18206793	.	A	G	2	2	4	0	0	4	0	0
8	18210162	.	G	T	1	2	3	0	0	3	0	0
8	18210185	.	A	G	1	3	4	0	0	4	0	0
8	18210961	.	G	A	2	5	7	0	0	7	0	0
8	18210966	.	A	T	2	5	7	0	0	7	0	0
8	18231197	.	C	T	1	2	3	0	0	3	0	0
8	18242651	.	A	G	4	2	6	0	0	6	0	0
8	18242762	.	G	T	7	7	14	0	1	15	0	0
8	18242944	.	G	C	2	3	5	0	0	5	0	0
8	18242945	.	T	A	2	3	5	0	0	5	0	0
8	18243082	.	C	A	1	2	3	0	1	4	0	0
8	18243119	.	C	T	1	2	3	0	0	3	0	0
8	18243578	.	C	T	1	3	4	0	0	4	0	0
8	18243633	.	C	T	2	3	5	0	0	5	0	0
8	18243671	.	G	T	3	2	5	0	0	5	0	0
8	18243810	.	C	T	2	1	3	0	1	4	0	0
8	18244063	.	A	C	2	2	4	0	0	4	0	0
8	18356524	.	G	A	12	15	27	0	3	30	0	0
8	18356688	.	G	A	11	9	20	0	2	22	0	0
8	18358694	.	T	G	5	5	10	0	0	10	0	0
8	18358709	.	T	C	3	5	8	0	1	9	0	0
8	18361223	.	G	A	4	5	9	0	0	9	0	0
8	18364066	.	G	A	8	6	14	0	0	14	0	0
8	18367707	.	G	T	2	2	4	0	0	4	0	0
8	18367709	.	A	G	2	2	4	0	0	4	0	0
8	18487274	.	A	G	0	0	0	0	3	3	0	0
8	18487276	.	C	T	1	2	3	0	0	3	0	0
8	18512195	.	G	A	1	3	4	0	0	4	0	0
8	18517971	.	A	G	1	5	6	0	0	6	0	0
8	18519279	.	T	C	1	2	3	0	0	3	0	0
8	18554825	.	T	C	2	4	6	0	0	6	0	0
8	18562153	.	A	G	12	18	30	0	5	35	0	0
8	18562225	.	C	A	13	14	27	0	0	27	0	0
8	18562283	.	G	A	4	12	16	0	16	32	0	0
8	18562317	.	C	T	11	16	27	0	1	28	0	0
8	18562570	.	C	T	3	17	20	0	0	20	0	0
8	18562950	.	T	C	4	3	7	0	0	7	0	0
8	18566278	.	G	A	14	17	31	0	3	34	0	0
8	18566327	.	C	A	13	12	25	0	1	26	0	0
8	18566419	.	T	A	13	7	20	0	0	20	0	0
8	18566466	.	A	T	9	4	13	0	0	13	0	0
8	18566615	.	T	G	14	18	32	0	0	32	0	0
8	18566669	.	C	T	10	25	35	0	0	35	0	0
8	18566687	.	T	C	8	26	34	0	1	35	0	0
8	18567230	.	G	A	8	4	12	0	5	17	0	0
8	18567453	.	A	G	6	9	15	0	0	15	0	0
8	18568167	.	G	T	9	3	12	0	1	13	0	0
8	18568189	.	C	A	14	4	18	0	0	18	0	0
8	18568264	.	T	A	3	4	7	0	2	9	0	0
8	18568350	.	C	G	4	7	11	0	0	11	0	0
8	18568571	.	T	G	3	4	7	1	0	8	0	0
8	18568677	.	C	T	2	4	6	0	10	16	0	0
8	18568687	.	A	G	10	5	15	0	1	16	0	0
8	18569039	.	T	C	5	4	9	0	1	10	0	0
8	18569763	.	C	G	0	3	3	0	2	5	0	0
8	18570190	.	G	C	1	3	4	0	0	4	0	0
8	18570201	.	C	T	1	2	3	0	0	3	0	0
8	18598306	.	C	T	5	7	12	0	1	13	0	0
8	18598333	.	A	T	12	7	19	0	0	19	0	0
8	18598391	.	T	A	6	12	18	0	1	19	0	0
8	18598593	.	C	G	13	2	15	0	0	15	0	0
8	18598628	.	A	T	2	12	14	0	5	19	0	0
8	18598915	.	A	G	10	13	23	0	2	25	0	0
8	18598920	.	G	C	11	15	26	0	0	26	0	0
8	18599014	.	G	T	2	13	15	0	12	27	0	0
8	18599088	.	C	A	17	13	30	1	2	33	0	0
8	18599235	.	G	A	12	6	18	0	0	18	0	0
8	18609265	.	A	T	4	4	8	0	0	8	0	0
8	18609272	.	C	A	4	4	8	0	0	8	0	0
8	18611048	.	G	A	2	4	6	0	2	8	0	0
8	18613661	.	A	T	5	3	8	0	0	8	0	0
8	18623095	.	G	C	2	2	4	0	0	4	0	0
8	18646867	.	T	G	2	4	6	0	0	6	0	0
8	18646894	.	C	T	1	4	5	0	1	6	0	0
8	18647113	.	T	C	1	7	8	0	0	8	0	0
8	18647298	.	G	A	5	2	7	0	0	7	0	0
8	18837255	.	C	A	3	4	7	0	0	7	0	0
8	18837494	.	C	A	5	6	11	0	0	11	0	0
8	18837533	.	A	G	6	6	12	0	0	12	0	0
8	18837864	.	C	T	5	12	17	0	0	17	0	0
8	18840330	.	C	T	6	6	12	0	0	12	0	0
8	18885207	.	G	A	2	3	5	0	0	5	0	0
8	19253718	.	G	A	3	5	8	0	0	8	0	0
8	19258761	.	G	A	3	4	7	0	0	7	0	0
8	19283418	.	A	C	4	5	9	0	0	9	0	0
8	19284169	.	A	G	2	2	4	0	0	4	0	0
8	19402136	.	G	T	8	7	15	0	1	16	0	0
8	19402363	.	A	G	10	21	31	0	0	31	0	0
8	19402374	.	C	T	1	21	22	0	14	36	0	0
8	19474072	.	T	C	4	0	4	0	5	9	0	0
8	19476600	.	A	G	4	3	7	0	0	7	0	0
8	19477798	.	C	T	0	4	4	0	5	9	0	0
8	19477928	.	A	G	3	2	5	0	1	6	0	0
8	19478140	.	C	T	3	2	5	0	0	5	0	0
8	19489979	.	G	A	2	2	4	0	0	4	0	0
8	19490196	.	T	G	4	0	4	0	3	7	0	0
8	19490204	.	A	G	4	2	6	0	0	6	0	0
8	19499684	.	C	A	2	2	4	0	0	4	0	0
8	19499867	.	T	C	2	2	4	0	0	4	0	0
8	19504144	.	A	G	5	3	8	0	0	8	0	0
8	19506793	.	C	T	5	2	7	2	0	9	0	0
8	19508927	.	A	G	8	5	13	0	0	13	0	0
8	19508961	.	C	A	9	8	17	0	2	19	0	0
8	19511480	.	G	A	2	11	13	0	12	25	0	0
8	19512186	.	A	G	18	0	18	0	10	28	0	0
8	19512187	.	C	A	19	8	27	0	1	28	0	0
8	19632757	.	G	A	1	2	3	0	0	3	0	0
8	19674530	.	C	T	1	2	3	0	0	3	0	0
8	19997858	.	A	T	2	3	5	0	0	5	0	0
8	19998074	.	T	C	4	2	6	0	1	7	0	0
8	20062344	.	C	T	4	2	6	0	0	6	0	0
8	20065519	.	T	G	3	1	4	0	4	8	0	0
8	20068125	.	T	C	3	4	7	0	0	7	0	0
8	20073872	.	G	C	1	3	4	0	0	4	0	0
8	20082877	.	A	G	1	3	4	0	0	4	0	0
8	20175907	.	A	C	2	2	4	0	0	4	0	0
8	20183420	.	T	C	4	5	9	0	0	9	0	0
8	20184545	.	A	G	3	3	6	0	1	7	0	0
8	20185652	.	A	G	6	0	6	0	5	11	0	0
8	20185664	.	A	G	4	0	4	0	6	10	0	0
8	20185694	.	C	T	6	7	13	0	0	13	0	0
8	20185718	.	G	T	8	8	16	0	2	18	0	0
8	20185793	.	G	A	1	5	6	0	3	9	0	0
8	20185796	.	G	C	3	6	9	0	0	9	0	0
8	20187793	.	T	C	11	8	19	0	0	19	0	0
8	20187829	.	A	T	15	9	24	0	0	24	0	0
8	20187835	.	A	G	14	0	14	0	8	23	1	0
8	20190489	.	A	G	13	10	23	0	1	24	0	0
8	20190764	.	G	C	11	9	20	0	2	22	0	0
8	20190790	.	T	C	9	20	29	1	4	34	0	0
8	20190809	.	G	C	9	27	36	1	1	38	0	0
8	20190876	.	A	G	12	7	19	3	3	25	0	0
8	20190967	.	G	A	1	14	15	0	17	32	0	0
8	20191067	.	T	C	9	6	15	0	1	16	0	0
8	20191286	.	A	G	19	0	19	0	19	38	0	0
8	20191301	.	C	A	22	11	33	0	2	36	1	0
8	20191354	.	A	G	12	11	23	0	5	28	0	0
8	20191561	.	A	G	18	17	35	0	2	37	0	0
8	20191651	.	T	C	18	19	37	0	2	39	0	0
8	20191965	.	T	A	21	20	41	0	2	43	0	0
8	20191999	.	C	T	15	16	31	0	1	32	0	0
8	20192046	.	A	G	16	1	17	0	7	24	0	0
8	20192049	.	G	A	16	10	26	0	1	27	0	0
8	20194236	.	C	T	2	2	4	0	2	6	0	0
8	20194246	.	C	T	4	2	6	0	1	7	0	0
8	20194583	.	C	T	10	7	17	0	0	17	0	0
8	20194647	.	T	C	7	7	14	0	1	15	0	0
8	20194830	.	C	A	6	3	9	0	0	9	0	0
8	20194832	.	G	A	5	3	8	0	1	9	0	0
8	20195228	.	A	G	3	2	5	0	0	5	0	0
8	20195308	.	T	A	1	2	3	0	0	3	0	0
8	20471391	.	C	T	10	5	15	0	0	15	0	0
8	20471480	.	C	T	6	4	10	0	0	10	0	0
8	20471508	.	T	A	2	2	4	0	1	5	0	0
8	20503829	.	C	T	3	2	5	0	0	5	0	0
8	20546122	.	T	C	9	9	18	0	0	18	0	0
8	20546182	.	T	C	8	9	17	0	2	19	0	0
8	20559241	.	G	A	24	16	40	0	3	43	0	0
8	20574318	.	T	A	2	2	4	0	0	4	0	0
8	20577519	.	G	T	0	2	2	0	1	3	0	0
8	20846483	.	G	A	8	9	17	0	0	17	0	0
8	20846495	.	A	G	11	10	21	0	1	22	0	0
8	20846613	.	G	A	9	5	14	0	0	14	0	0
8	20848614	.	C	T	4	4	8	0	0	8	0	0
8	20850311	.	T	A	3	4	7	0	0	7	0	0
8	20853149	.	A	G	12	10	22	0	1	23	0	0
8	20853314	.	A	G	12	17	29	0	1	30	0	0
8	20853335	.	A	T	15	11	26	0	2	28	0	0
8	20853803	.	G	A	7	6	13	0	0	13	0	0
8	20853900	.	G	A	7	9	16	0	0	16	0	0
8	20853951	.	G	C	5	4	9	0	1	10	0	0
8	20856365	.	T	G	3	17	20	0	1	21	0	0
8	20856383	.	G	A	3	14	17	0	1	18	0	0
8	20856505	.	A	G	8	9	17	0	0	17	0	0
8	20856643	.	G	A	6	4	10	0	0	10	0	0
8	20856646	.	C	A	5	6	11	0	0	11	0	0
8	20863117	.	A	G	1	2	3	0	0	3	0	0
8	20868122	.	G	A	5	5	10	0	0	10	0	0
8	20868167	.	T	A	6	7	13	0	1	14	0	0
8	20868191	.	G	A	6	5	11	0	2	13	0	0
8	20868203	.	C	A	7	6	13	0	0	13	0	0
8	20871596	.	A	G	3	5	8	0	0	8	0	0
8	20872987	.	G	T	5	3	8	0	4	12	0	0
8	20873116	.	T	C	11	5	16	0	1	17	0	0
8	21047673	.	G	T	5	3	8	0	0	8	0	0
8	21047698	.	C	G	10	3	13	0	0	13	0	0
8	21047824	.	C	A	5	5	10	0	1	11	0	0
8	21048116	.	G	A	1	4	5	0	0	5	0	0
8	21050616	.	T	A	1	3	4	0	0	4	0	0
8	21052694	.	A	G	4	4	8	0	0	8	0	0
8	21053030	.	G	A	12	13	25	0	0	25	0	0
8	21053084	.	A	T	10	8	18	0	1	19	0	0
8	21053122	.	G	A	3	9	12	0	3	15	0	0
8	21053345	.	T	C	6	0	6	0	9	15	0	0
8	21053371	.	G	A	6	7	13	0	0	13	0	0
8	21053404	.	T	C	3	3	6	0	0	6	0	0
8	21053744	.	G	A	3	5	8	0	0	8	0	0
8	21053754	.	A	G	4	8	12	0	0	12	0	0
8	21071433	.	G	A	1	5	6	0	0	6	0	0
8	21071672	.	T	C	1	0	1	0	4	5	0	0
8	21095288	.	G	A	20	7	27	0	0	27	0	0
8	21095439	.	G	C	7	18	25	0	1	26	0	0
8	21095504	.	A	C	11	7	18	0	4	22	0	0
8	21101847	.	G	A	1	3	4	0	1	5	0	0
8	21104853	.	G	T	2	8	10	0	0	10	0	0
8	21110172	.	C	T	2	4	6	0	0	6	0	0
8	21114444	.	C	T	4	4	8	0	0	8	0	0
8	21130049	.	C	T	1	1	2	0	1	3	0	0
8	21130158	.	G	A	2	6	8	0	0	8	0	0
8	21131996	.	A	G	2	0	2	0	3	5	0	0
8	21132300	.	C	T	11	12	23	1	1	25	0	0
8	21132318	.	G	A	9	14	23	1	0	24	0	0
8	21132538	.	C	G	17	8	25	0	1	26	0	0
8	21132599	.	G	A	1	9	10	0	15	25	0	0
8	21132648	.	T	C	10	13	23	0	3	26	0	0
8	21132696	.	C	T	17	15	32	0	2	34	0	0
8	21134088	.	G	T	17	9	26	0	1	27	0	0
8	21134536	.	T	C	16	16	32	0	2	34	0	0
8	21137733	.	T	C	5	6	11	0	0	11	0	0
8	21139950	.	C	A	1	3	4	0	3	7	0	0
8	21140679	.	T	C	1	2	3	0	1	4	0	0
8	21140937	.	C	G	2	2	4	0	0	4	0	0
8	21146936	.	C	T	1	2	3	0	0	3	0	0
8	21153257	.	A	T	1	4	5	0	0	5	0	0
8	21155439	.	G	A	4	4	8	0	0	8	0	0
8	21155445	.	A	G	4	3	7	0	0	7	0	0
8	21155864	.	A	G	4	6	10	0	1	11	0	0
8	21159196	.	A	G	3	4	7	0	0	7	0	0
8	21159288	.	A	G	2	2	4	0	0	4	0	0
8	21162056	.	C	T	5	3	8	0	0	8	0	0
8	21162161	.	C	T	3	7	10	0	0	10	0	0
8	21162191	.	C	T	8	9	17	0	0	17	0	0
8	21162284	.	A	G	8	0	8	0	7	15	0	0
8	21162318	.	T	C	9	9	18	0	0	18	0	0
8	21218919	.	G	C	0	2	2	0	1	3	0	0
8	21218932	.	T	G	1	2	3	0	0	3	0	0
8	21229867	.	T	C	2	6	8	0	0	8	0	0
8	21239835	.	A	C	6	2	8	0	0	8	0	0
8	21240124	.	T	C	3	3	6	0	1	7	0	0
8	21245803	.	C	T	4	3	7	0	0	7	0	0
8	21248852	.	C	A	20	13	33	0	0	33	0	0
8	21248879	.	G	A	18	15	33	0	2	35	0	0
8	21250132	.	T	A	13	10	23	0	0	23	0	0
8	21250458	.	C	A	4	4	8	0	0	8	0	0
8	21250485	.	C	A	6	3	9	0	0	9	0	0
8	21250549	.	C	T	7	2	9	0	11	20	0	0
8	21250550	.	A	T	17	2	19	0	1	20	0	0
8	21250709	.	C	A	15	14	29	0	0	29	0	0
8	21250897	.	G	A	2	5	7	0	6	13	0	0
8	21250982	.	G	A	14	4	18	0	0	18	0	0
8	21250988	.	C	T	16	4	20	0	2	22	0	0
8	21251241	.	G	A	29	17	46	0	3	49	0	0
8	21251325	.	C	A	20	20	40	0	1	41	0	0
8	21251456	.	T	G	35	12	47	1	3	51	0	0
8	21251604	.	A	G	15	6	21	0	2	23	0	0
8	21251820	.	A	T	18	8	26	0	2	28	0	0
8	21251856	.	G	A	20	8	28	0	1	29	0	0
8	21251993	.	A	C	5	11	16	0	3	19	0	0
8	21252125	.	A	T	15	30	45	0	2	47	0	0
8	21252155	.	T	C	24	30	54	0	0	54	0	0
8	21252215	.	A	T	29	20	49	0	5	54	0	0
8	21252237	.	T	C	27	23	50	0	4	54	0	0
8	21368892	.	G	A	4	2	6	1	3	10	0	0
8	21368912	.	C	A	6	1	7	1	1	9	0	0
8	21408468	.	G	A	2	6	8	0	0	8	0	0
8	21413092	.	G	A	3	2	5	0	3	8	0	0
8	21416365	.	C	G	1	3	4	0	1	5	0	0
8	21671568	.	G	A	0	3	3	0	1	4	0	0
8	21671593	.	A	T	1	2	3	0	0	3	0	0
8	21672688	.	T	G	4	3	7	0	0	7	0	0
8	21673516	.	G	A	0	5	5	0	3	8	0	0
8	21673629	.	T	G	2	2	4	0	0	4	0	0
8	21673650	.	G	T	1	2	3	0	1	4	0	0
8	21674662	.	T	C	3	2	5	0	0	5	0	0
8	21674815	.	A	T	4	2	6	0	0	6	0	0
8	21674841	.	A	G	2	0	2	0	7	9	0	0
8	21675054	.	A	G	11	0	11	0	0	11	0	0
8	21675208	.	T	C	5	3	8	0	1	9	0	0
8	21675745	.	G	A	3	5	8	0	0	8	0	0
8	21978302	.	A	C	3	5	8	0	0	8	0	0
8	21978306	.	G	A	3	5	8	0	0	8	0	0
8	21978455	.	A	G	1	4	5	0	0	5	0	0
8	21978475	.	A	G	1	3	4	0	0	4	0	0
8	21982767	.	C	T	6	4	10	0	2	12	0	0
8	21982860	.	T	A	3	4	7	0	0	7	0	0
8	21988698	.	A	G	1	2	3	0	0	3	0	0
8	22277346	.	T	C	2	2	4	0	1	5	0	0
8	22279922	.	C	A	5	2	7	0	0	7	0	0
8	22284266	.	C	T	9	5	14	0	0	14	0	0
8	22284316	.	C	T	11	6	17	0	0	17	0	0
8	22284379	.	T	G	5	7	12	0	0	12	0	0
8	22286820	.	G	A	15	10	25	0	0	25	0	0
8	22287063	.	A	C	6	0	6	0	10	16	0	0
8	22345747	.	A	C	3	4	7	0	0	7	0	0
8	22346508	.	T	C	8	4	12	0	0	12	0	0
8	22394611	.	T	C	3	3	6	0	1	7	0	0
8	22500148	.	A	G	0	3	3	1	1	5	0	0
8	22500274	.	C	T	0	4	4	0	4	8	0	0
8	22500293	.	C	T	4	4	8	0	0	8	0	0
8	22500436	.	G	A	5	3	8	0	0	8	0	0
8	22500739	.	G	A	3	3	6	0	0	6	0	0
8	22503494	.	G	T	4	3	7	0	0	7	0	0
8	22503725	.	T	G	3	3	6	0	1	7	0	0
8	22503748	.	C	T	3	3	6	0	0	6	0	0
8	22503782	.	C	T	1	2	3	0	2	5	0	0
8	22504329	.	C	G	1	1	2	0	0	2	0	0
8	22504337	.	A	C	1	2	3	0	0	3	0	0
8	22504424	.	T	A	2	2	4	0	0	4	0	0
8	22504844	.	G	A	1	2	3	0	0	3	0	0
8	22504847	.	A	G	1	2	3	0	0	3	0	0
8	22511045	.	G	A	1	2	3	0	0	3	0	0
8	22511092	.	A	C	2	3	5	0	1	6	0	0
8	22511123	.	A	G	3	4	7	0	0	7	0	0
8	22511375	.	C	T	6	8	14	0	0	14	0	0
8	22511387	.	G	A	5	4	9	0	0	9	0	0
8	22511471	.	C	T	8	10	18	0	1	19	0	0
8	22511518	.	C	T	3	8	11	0	5	16	0	0
8	22511718	.	G	A	1	3	4	0	0	4	0	0
8	22511852	.	G	A	3	3	6	0	0	6	0	0
8	22511945	.	T	G	3	3	6	0	0	6	0	0
8	22512537	.	T	G	3	3	6	0	0	6	0	0
8	22521792	.	G	C	11	15	26	0	1	27	0	0
8	22522035	.	G	A	17	25	42	1	9	52	0	0
8	22522136	.	A	G	23	25	48	0	1	49	0	0
8	22522385	.	T	C	7	0	7	0	6	13	0	0
8	22522397	.	G	A	5	5	10	0	0	10	0	0
8	22522742	.	T	C	18	14	32	0	0	32	0	0
8	22522744	.	A	G	16	14	30	0	1	31	0	0
8	22523010	.	A	T	24	8	32	0	0	32	0	0
8	22523118	.	G	A	14	17	31	0	0	31	0	0
8	22525228	.	G	A	14	8	22	0	2	24	0	0
8	22525336	.	G	A	14	14	28	0	3	31	0	0
8	22530423	.	T	C	9	7	16	0	0	16	0	0
8	22530633	.	A	G	10	11	21	0	1	22	0	0
8	22544985	.	G	A	1	4	5	0	1	6	0	0
8	22551016	.	T	A	1	2	3	0	0	3	0	0
8	22608378	.	C	T	3	1	4	0	1	5	0	0
8	22612068	.	C	A	1	3	4	0	0	4	0	0
8	22612069	.	C	A	1	3	4	0	0	4	0	0
8	22612158	.	A	C	5	2	7	0	0	7	0	0
8	22612258	.	G	A	1	2	3	0	0	3	0	0
8	22612608	.	T	C	3	6	9	0	0	9	0	0
8	22612712	.	C	T	2	3	5	0	0	5	0	0
8	22612869	.	C	A	2	2	4	0	0	4	0	0
8	22612917	.	T	G	2	2	4	0	0	4	0	0
8	22612950	.	C	T	3	3	6	0	0	6	0	0
8	22613346	.	G	T	4	2	6	0	1	7	0	0
8	22613493	.	G	A	2	4	6	0	0	6	0	0
8	22613553	.	A	G	1	2	3	0	0	3	0	0
8	22619110	.	G	A	9	12	21	0	1	22	0	0
8	22622712	.	C	T	0	4	4	0	2	6	0	0
8	22631898	.	C	A	0	3	3	0	3	6	0	0
8	22660118	.	A	T	1	2	3	0	0	3	0	0
8	22926876	.	A	C	2	2	4	0	0	4	0	0
8	22926934	.	T	C	4	4	8	0	0	8	0	0
8	22945179	.	G	T	7	7	14	0	1	15	0	0
8	22945572	.	T	C	11	11	22	0	3	25	0	0
8	22945605	.	T	C	13	6	19	0	1	20	0	0
8	22946780	.	T	C	9	11	20	0	0	20	0	0
8	22946987	.	G	C	22	13	35	0	1	36	0	0
8	22947209	.	C	T	31	20	51	0	6	57	0	0
8	22950810	.	C	G	2	8	10	0	0	10	0	0
8	22951053	.	G	A	28	22	50	0	0	50	0	0
8	22951054	.	C	G	27	21	48	0	1	50	1	0
8	22951364	.	A	T	15	9	24	1	7	32	0	0
8	22951406	.	T	A	12	7	19	1	11	31	0	0
8	22951691	.	A	T	22	15	37	0	1	38	0	0
8	22951847	.	A	T	25	28	53	0	3	56	0	0
8	22951880	.	A	G	32	28	60	0	3	63	0	0
8	22951919	.	C	T	35	22	57	0	2	59	0	0
8	22952243	.	T	A	30	41	71	0	1	72	0	0
8	22952330	.	A	T	35	31	66	0	3	69	0	0
8	22952758	.	G	A	1	2	3	0	3	6	0	0
8	22985516	.	G	C	2	3	5	0	0	5	0	0
8	23026459	.	T	A	1	2	3	0	0	3	0	0
8	23040902	.	G	A	11	8	19	0	0	19	0	0
8	23040913	.	G	C	10	6	16	0	0	16	0	0
8	23041461	.	C	T	1	2	3	0	8	11	0	0
8	23044752	.	A	G	10	9	19	0	0	19	0	0
8	23101463	.	A	G	4	4	8	0	0	8	0	0
8	23102846	.	C	T	10	3	13	0	0	13	0	0
8	23102951	.	T	A	12	5	17	0	3	20	0	0
8	23103153	.	T	C	1	3	4	0	1	5	0	0
8	23103307	.	C	T	10	13	23	0	0	23	0	0
8	23103379	.	T	C	7	5	12	0	0	12	0	0
8	23109443	.	G	A	1	3	4	0	0	4	0	0
8	23109890	.	T	C	4	6	10	0	0	10	0	0
8	23110301	.	T	A	17	12	29	0	2	31	0	0
8	23110475	.	A	G	3	6	9	0	0	9	0	0
8	23118396	.	A	G	5	10	15	0	1	16	0	0
8	23118830	.	T	C	8	7	15	0	0	15	0	0
8	23119524	.	C	A	24	10	34	1	3	38	0	0
8	23122210	.	T	G	2	2	4	0	0	4	0	0
8	23122348	.	A	G	6	10	16	0	1	17	0	0
8	23149815	.	C	G	8	10	18	0	0	18	0	0
8	23151375	.	C	T	10	10	20	0	0	20	0	0
8	23151428	.	T	A	6	7	13	0	0	13	0	0
8	23151740	.	A	T	3	3	6	0	1	7	0	0
8	23151786	.	C	T	3	3	6	0	0	6	0	0
8	23177298	.	C	T	11	10	21	0	3	24	0	0
8	23194322	.	A	T	2	3	5	0	2	7	0	0
8	23202689	.	C	T	4	6	10	0	0	10	0	0
8	23202730	.	T	C	6	4	10	0	1	11	0	0
8	23202757	.	C	T	6	3	9	1	0	10	0	0
8	23206939	.	C	T	1	3	4	0	0	4	0	0
8	23210432	.	C	T	15	13	28	0	0	28	0	0
8	23210441	.	T	C	18	12	30	0	0	30	0	0
8	23210598	.	G	C	11	11	22	0	0	22	0	0
8	23210767	.	G	A	1	4	5	0	2	7	0	0
8	23210832	.	A	T	10	5	15	0	0	15	0	0
8	23210857	.	A	G	6	4	10	0	1	11	0	0
8	23210944	.	T	C	10	6	16	0	1	17	0	0
8	23210955	.	C	T	10	7	17	0	1	18	0	0
8	23211109	.	G	T	8	5	13	0	1	14	0	0
8	23211200	.	G	T	17	5	22	0	1	23	0	0
8	23211519	.	T	C	8	5	13	0	0	13	0	0
8	23211527	.	G	A	10	4	14	0	0	14	0	0
8	23211615	.	A	G	2	0	2	0	4	6	0	0
8	23211624	.	A	G	3	2	5	0	1	6	0	0
8	23213414	.	C	T	12	9	21	0	1	22	0	0
8	23215631	.	C	T	16	8	24	0	0	24	0	0
8	23215634	.	C	T	17	10	27	0	0	27	0	0
8	23215697	.	G	A	2	11	13	0	18	31	0	0
8	23215762	.	T	C	27	12	39	0	0	39	0	0
8	23380170	.	G	T	4	3	7	0	0	7	0	0
8	23380838	.	G	A	2	3	5	0	0	5	0	0
8	23380851	.	A	T	2	4	6	0	0	6	0	0
8	23380919	.	T	C	3	4	7	0	0	7	0	0
8	23415717	.	A	G	4	2	6	0	0	6	0	0
8	23567740	.	G	T	2	1	3	0	1	4	0	0
8	23615202	.	T	A	1	2	3	0	0	3	0	0
8	23615206	.	A	T	0	2	2	0	1	3	0	0
8	23615247	.	C	T	2	2	4	0	0	4	0	0
8	23617372	.	C	T	2	3	5	0	0	5	0	0
8	23620494	.	G	A	10	3	13	0	0	13	0	0
8	23627345	.	G	A	0	3	3	0	3	6	0	0
8	23627371	.	T	C	3	3	6	0	0	6	0	0
8	23627494	.	T	C	6	6	12	0	0	12	0	0
8	23636923	.	C	T	5	6	11	0	0	11	0	0
8	23636973	.	T	G	4	7	11	0	0	11	0	0
8	23637140	.	A	G	10	6	16	0	1	17	0	0
8	23637791	.	A	G	1	2	3	0	0	3	0	0
8	23640048	.	A	G	1	1	2	0	1	3	0	0
8	23647389	.	T	A	1	3	4	0	2	6	0	0
8	23651328	.	C	T	3	3	6	0	0	6	0	0
8	23651370	.	C	T	8	3	11	0	0	11	0	0
8	23651397	.	G	A	0	3	3	0	7	10	0	0
8	23655968	.	C	T	6	5	11	0	0	11	0	0
8	23656058	.	G	A	5	5	10	0	0	10	0	0
8	23656125	.	G	T	10	6	16	0	1	17	0	0
8	23656151	.	C	T	10	12	22	0	0	22	0	0
8	23656212	.	A	T	8	9	17	0	0	17	0	0
8	23656321	.	C	A	5	5	10	0	0	10	0	0
8	23667281	.	T	C	1	2	3	0	0	3	0	0
8	23667290	.	A	G	1	0	1	0	2	3	0	0
8	23668371	.	A	T	1	3	4	0	0	4	0	0
8	23669307	.	T	C	4	4	8	0	0	8	0	0
8	23669617	.	T	C	13	6	19	0	0	19	0	0
8	23669885	.	G	T	5	9	14	0	2	16	0	0
8	23670246	.	T	G	8	0	8	0	3	11	0	0
8	23672505	.	C	T	7	3	10	0	2	12	0	0
8	23673096	.	T	C	1	4	5	0	0	5	0	0
8	23673133	.	G	T	2	2	4	0	0	4	0	0
8	23711882	.	C	T	5	3	8	0	0	8	0	0
8	23712098	.	C	T	1	2	3	0	0	3	0	0
8	23713465	.	G	A	1	2	3	0	0	3	0	0
8	23723621	.	C	T	1	2	3	0	0	3	0	0
8	23724045	.	A	C	6	5	11	0	0	11	0	0
8	23735521	.	T	C	3	2	5	0	0	5	0	0
8	23735548	.	A	C	3	2	5	0	1	6	0	0
8	23738160	.	C	G	9	16	25	0	1	26	0	0
8	23740148	.	T	C	10	5	15	0	0	15	0	0
8	23740519	.	G	A	25	32	57	0	2	59	0	0
8	23753566	.	T	A	5	6	11	0	1	12	0	0
8	23753793	.	C	T	0	3	3	0	4	7	0	0
8	23753834	.	C	G	0	6	6	0	4	10	0	0
8	23753934	.	G	A	6	3	9	0	2	11	0	0
8	23756172	.	C	T	0	3	3	0	6	9	0	0
8	23756221	.	T	A	5	8	13	0	0	13	0	0
8	23756557	.	G	A	8	7	15	0	0	15	0	0
8	23756680	.	T	A	2	4	6	0	0	6	0	0
8	23760297	.	C	T	0	3	3	0	2	5	0	0
8	23760323	.	G	A	4	3	7	0	0	7	0	0
8	23763809	.	T	C	1	2	3	0	0	3	0	0
8	23781194	.	G	A	2	7	9	0	0	9	0	0
8	23781195	.	C	A	1	7	8	0	0	8	0	0
8	23783502	.	T	C	1	0	1	0	2	3	0	0
8	23824264	.	A	G	1	2	3	0	0	3	0	0
8	23827610	.	C	T	0	3	3	0	0	3	0	0
8	23827617	.	G	A	1	2	3	0	0	3	0	0
8	23857845	.	T	C	8	4	12	0	0	12	0	0
8	23857997	.	G	A	4	4	8	0	1	9	0	0
8	23860641	.	G	T	1	10	11	0	9	20	0	0
8	23865804	.	A	C	3	3	6	0	0	6	0	0
8	23865837	.	A	G	2	3	5	0	0	5	0	0
8	23867417	.	A	G	4	3	7	0	0	7	0	0
8	23868598	.	T	C	4	4	8	0	0	8	0	0
8	23871782	.	C	T	4	4	8	0	0	8	0	0
8	23878905	.	T	A	6	10	16	0	1	17	0	0
8	23878994	.	G	A	18	12	30	0	1	31	0	0
8	23879044	.	T	A	14	12	26	0	1	27	0	0
8	23879238	.	T	A	12	10	22	0	3	25	0	0
8	23879365	.	G	A	19	12	31	0	1	32	0	0
8	23879461	.	C	T	6	6	12	0	1	13	0	0
8	24108749	.	T	G	4	6	10	0	0	10	0	0
8	24109195	.	A	T	9	9	18	0	1	19	0	0
8	24109336	.	A	G	5	6	11	0	0	11	0	0
8	24109399	.	A	G	6	4	10	0	0	10	0	0
8	24109496	.	C	T	0	10	10	0	5	15	0	0
8	24109561	.	C	T	7	4	11	0	0	11	0	0
8	24109562	.	T	C	6	4	10	0	1	11	0	0
8	24109693	.	A	G	8	3	11	0	1	12	0	0
8	24109787	.	C	T	4	7	11	0	0	11	0	0
8	24111073	.	A	G	2	3	5	0	0	5	0	0
8	24120176	.	T	A	3	4	7	0	1	8	0	0
8	24120187	.	A	T	2	4	6	0	2	8	0	0
8	24123072	.	C	T	1	2	3	0	0	3	0	0
8	24312737	.	T	C	2	2	4	0	0	4	0	0
8	24314382	.	G	A	0	3	3	0	1	4	0	0
8	24315553	.	T	C	2	2	4	0	0	4	0	0
8	24316484	.	A	G	4	0	4	0	3	7	0	0
8	24316499	.	G	A	3	4	7	0	0	7	0	0
8	24318472	.	G	A	1	3	4	0	0	4	0	0
8	24318866	.	T	C	2	2	4	0	0	4	0	0
8	24322223	.	G	A	5	3	8	2	0	10	0	0
8	24322229	.	G	T	5	5	10	0	0	10	0	0
8	24322489	.	T	C	4	2	6	0	0	6	0	0
8	24323336	.	T	C	10	8	18	0	0	18	0	0
8	24325254	.	G	A	10	14	24	0	1	25	0	0
8	24740093	.	T	A	2	3	5	0	0	5	0	0
8	24740094	.	A	C	2	3	5	0	0	5	0	0
8	24740168	.	C	A	5	7	12	0	0	12	0	0
8	24741031	.	A	T	7	7	14	0	1	15	0	0
8	24743676	.	A	T	5	10	15	0	0	15	0	0
8	24743696	.	T	G	6	0	6	0	8	14	0	0
8	24743756	.	A	C	2	3	5	0	0	5	0	0
8	24743823	.	C	A	4	6	10	0	0	10	0	0
8	24789324	.	C	T	0	2	2	0	3	5	0	0
8	24790139	.	A	G	1	2	3	0	0	3	0	0
8	24889586	.	C	T	5	3	8	0	2	10	0	0
8	24890891	.	C	T	3	2	5	0	0	5	0	0
8	24968342	.	C	T	1	2	3	0	0	3	0	0
8	24972006	.	T	C	21	21	42	0	2	44	0	0
8	24972594	.	T	C	18	15	33	0	3	36	0	0
8	24972595	.	T	A	22	15	37	0	0	37	0	0
8	24972665	.	T	C	12	20	32	0	1	33	0	0
8	24972743	.	C	T	1	11	12	0	18	30	0	0
8	24972776	.	C	T	4	11	15	0	16	31	0	0
8	24973010	.	T	A	13	14	27	0	1	28	0	0
8	24973116	.	C	G	11	7	18	0	0	18	0	0
8	24973276	.	A	G	11	4	15	0	2	17	0	0
8	24973462	.	A	G	4	3	7	1	1	9	0	0
8	24983245	.	C	G	0	5	5	0	14	19	0	0
8	24986965	.	G	A	4	7	11	0	0	11	0	0
8	25028646	.	A	G	2	4	6	0	1	7	0	0
8	25036367	.	A	T	2	6	8	1	1	10	0	0
8	25036493	.	C	T	5	4	9	0	1	10	0	0
8	25036520	.	T	C	3	3	6	0	0	6	0	0
8	25036679	.	T	A	4	5	9	0	1	10	0	0
8	25036694	.	C	G	6	4	10	0	0	10	0	0
8	25039704	.	T	C	5	6	11	0	0	11	0	0
8	25039840	.	T	C	6	4	10	0	0	10	0	0
8	25040349	.	A	G	6	5	11	0	0	11	0	0
8	25041986	.	G	A	7	8	15	0	0	15	0	0
8	25042447	.	T	C	9	10	19	0	1	20	0	0
8	25042578	.	A	G	10	9	19	0	3	22	0	0
8	25043021	.	A	G	6	4	10	4	1	15	0	0
8	25043066	.	T	C	11	0	11	0	5	16	0	0
8	25043112	.	T	G	9	7	16	0	1	17	0	0
8	25044564	.	C	G	2	7	9	0	8	17	0	0
8	25044591	.	C	T	1	7	8	0	8	16	0	0
8	25045766	.	T	C	6	7	13	0	0	13	0	0
8	25055972	.	G	T	1	1	2	0	2	4	0	0
8	25094117	.	A	G	1	0	1	0	5	6	0	0
8	25094489	.	C	G	2	2	4	0	0	4	0	0
8	25103719	.	T	C	5	8	13	0	0	13	0	0
8	25103731	.	T	C	5	10	15	0	1	16	0	0
8	25103887	.	G	A	4	6	10	0	4	14	0	0
8	25176250	.	T	C	6	6	12	0	0	12	0	0
8	25177264	.	G	C	7	6	13	0	0	13	0	0
8	25177501	.	T	G	7	9	16	0	0	16	0	0
8	25283768	.	A	G	5	3	8	0	0	8	0	0
8	25283771	.	T	C	5	4	9	0	0	9	0	0
8	25288980	.	T	C	4	3	7	0	0	7	0	0
8	25289180	.	C	T	7	4	11	0	0	11	0	0
8	25291308	.	C	T	4	10	14	0	0	14	0	0
8	25291478	.	A	T	2	3	5	0	0	5	0	0
8	25291573	.	C	A	1	2	3	0	3	6	0	0
8	25291839	.	T	C	16	9	25	0	1	26	0	0
8	25291876	.	A	G	16	10	26	0	2	28	0	0
8	25292020	.	A	T	9	15	24	0	3	27	0	0
8	25292188	.	C	T	4	3	7	0	0	7	0	0
8	25292274	.	G	A	3	4	7	0	9	16	0	0
8	25292330	.	C	T	8	10	18	0	0	18	0	0
8	25292370	.	A	G	7	10	17	0	0	17	0	0
8	25292482	.	T	C	11	13	24	0	0	24	0	0
8	25292492	.	A	T	13	13	26	0	0	26	0	0
8	25292608	.	T	C	22	7	29	0	1	30	0	0
8	25292865	.	G	C	13	17	30	0	0	31	1	0
8	25293008	.	A	G	18	16	34	0	2	36	0	0
8	25293064	.	C	T	15	15	30	0	2	32	0	0
8	25293111	.	G	T	13	18	31	0	4	35	0	0
8	25293145	.	C	T	29	15	44	0	1	45	0	0
8	25293184	.	C	T	14	26	40	0	1	41	0	0
8	25293225	.	T	A	21	12	33	0	0	33	0	0
8	25293346	.	C	T	15	23	38	0	2	40	0	0
8	25293459	.	T	C	1	2	3	0	1	4	0	0
8	25295219	.	A	T	4	2	6	0	0	6	0	0
8	25297326	.	A	G	10	0	10	0	31	41	0	0
8	25297617	.	G	C	11	24	35	0	2	37	0	0
8	25297741	.	C	T	11	22	33	0	2	35	0	0
8	25299819	.	A	G	0	3	3	0	3	6	0	0
8	25299967	.	A	G	1	2	3	0	0	3	0	0
8	25300511	.	C	T	1	7	8	0	0	8	0	0
8	25301389	.	G	A	0	5	5	0	2	7	0	0
8	25301456	.	C	T	10	3	13	0	0	13	0	0
8	25330065	.	T	A	21	8	29	0	1	30	0	0
8	25330181	.	C	T	9	4	13	0	1	14	0	0
8	25332708	.	C	T	30	36	66	0	4	70	0	0
8	25332900	.	A	G	32	34	66	0	1	67	0	0
8	25332945	.	G	A	25	30	55	0	2	57	0	0
8	25335063	.	G	A	26	18	44	0	2	46	0	0
8	25336097	.	T	A	25	17	42	0	0	42	0	0
8	25336102	.	T	G	25	15	40	0	2	42	0	0
8	25366990	.	T	A	2	2	4	0	0	4	0	0
8	25368613	.	G	A	5	6	11	0	0	11	0	0
8	25370776	.	T	C	6	8	14	0	1	15	0	0
8	25424272	.	C	T	8	6	14	0	0	14	0	0
8	25424411	.	T	A	4	7	11	0	0	11	0	0
8	25424658	.	G	A	3	3	6	0	0	6	0	0
8	25425033	.	T	C	2	3	5	0	0	5	0	0
8	25425103	.	A	G	2	3	5	0	0	5	0	0
8	25425391	.	C	T	1	2	3	0	0	3	0	0
8	25426338	.	T	G	3	2	5	0	0	5	0	0
8	25708263	.	A	G	3	8	11	0	0	11	0	0
8	25708311	.	C	T	4	3	7	0	1	8	0	0
8	25709085	.	T	G	6	7	13	1	2	16	0	0
8	25709694	.	T	G	13	7	20	0	1	21	0	0
8	25712660	.	G	T	12	5	17	0	1	18	0	0
8	25713035	.	T	A	6	6	12	0	0	12	0	0
8	25713053	.	G	A	3	7	10	0	1	11	0	0
8	25715028	.	T	A	5	5	10	0	0	10	0	0
8	25745724	.	C	T	3	3	6	0	0	6	0	0
8	25745840	.	C	T	3	2	5	0	0	5	0	0
8	25745877	.	T	A	3	3	6	0	0	6	0	0
8	25746125	.	C	T	2	3	5	0	0	5	0	0
8	25746183	.	G	A	0	1	1	1	2	4	0	0
8	25746213	.	A	G	1	0	1	1	4	6	0	0
8	25746376	.	G	A	5	3	8	0	0	8	0	0
8	25746508	.	A	G	1	3	4	0	0	4	0	0
8	25746788	.	C	G	3	2	5	0	0	5	0	0
8	25746999	.	G	A	0	3	3	0	1	4	0	0
8	25747202	.	A	C	3	6	9	0	1	10	0	0
8	25747644	.	T	G	3	5	8	0	0	8	0	0
8	25747704	.	C	A	2	5	7	0	1	8	0	0
8	25747993	.	G	A	0	10	10	0	2	12	0	0
8	25748047	.	G	A	1	6	7	0	1	8	0	0
8	25748147	.	C	T	3	2	5	0	0	5	0	0
8	25748244	.	G	A	6	2	8	0	1	9	0	0
8	25748283	.	G	T	4	4	8	0	1	9	0	0
8	25748329	.	A	T	4	3	7	0	0	7	0	0
8	25748330	.	T	A	4	2	6	0	1	7	0	0
8	25748562	.	T	A	7	8	15	0	2	17	0	0
8	25748685	.	G	A	5	7	12	0	0	12	0	0
8	25751348	.	A	T	2	6	8	0	0	8	0	0
8	25761886	.	T	C	1	5	6	0	0	6	0	0
8	25764192	.	T	C	14	21	35	0	0	35	0	0
8	25765640	.	T	A	7	8	15	0	1	16	0	0
8	25765647	.	G	A	1	7	8	0	12	20	0	0
8	25765788	.	G	A	1	13	14	0	26	40	0	0
8	25765794	.	G	A	26	10	36	0	3	39	0	0
8	25766098	.	G	A	12	8	20	0	0	20	0	0
8	25766131	.	T	C	11	13	24	0	0	24	0	0
8	25766188	.	A	C	8	16	24	0	0	24	0	0
8	25812075	.	T	C	22	9	31	0	2	33	0	0
8	25812113	.	G	A	20	11	31	0	1	32	0	0
8	25812324	.	A	G	17	12	29	0	5	34	0	0
8	25813740	.	A	G	11	23	34	0	0	34	0	0
8	25813904	.	A	G	14	13	27	0	0	27	0	0
8	25813937	.	G	T	11	7	18	0	3	21	0	0
8	25813987	.	G	A	11	6	17	0	0	17	0	0
8	25814003	.	C	T	0	6	6	0	14	20	0	0
8	25816811	.	T	A	8	11	19	0	4	23	0	0
8	25816916	.	G	T	11	9	20	0	0	20	0	0
8	25816917	.	C	G	11	9	20	0	0	20	0	0
8	25819057	.	T	A	17	13	30	0	2	32	0	0
8	25819095	.	A	T	11	10	21	0	1	22	0	0
8	25819196	.	G	A	3	3	6	0	0	6	0	0
8	25819248	.	G	A	2	4	6	0	0	6	0	0
8	25819349	.	A	G	10	8	18	0	0	18	0	0
8	25819430	.	A	T	5	9	14	0	1	15	0	0
8	25819434	.	C	G	6	11	17	0	0	17	0	0
8	25819478	.	G	A	11	6	17	0	0	17	0	0
8	25819548	.	C	G	18	7	25	0	0	25	0	0
8	25821140	.	G	A	7	8	15	0	0	15	0	0
8	25845780	.	C	T	5	4	9	0	0	9	0	0
8	25845830	.	T	C	2	2	4	0	1	5	0	0
8	25858618	.	C	T	1	4	5	0	0	5	0	0
8	25893862	.	C	T	2	2	4	0	0	4	0	0
8	25893937	.	C	T	2	4	6	0	0	6	0	0
8	25894108	.	C	T	4	6	10	0	0	10	0	0
8	25894222	.	G	A	1	3	4	0	4	8	0	0
8	25894300	.	C	T	6	5	11	0	0	11	0	0
8	25897145	.	T	A	12	11	23	3	0	26	0	0
8	25897287	.	C	T	5	7	12	0	1	13	0	0
8	25897489	.	G	A	6	2	8	0	0	8	0	0
8	25897694	.	C	T	10	4	14	0	0	14	0	0
8	25897861	.	G	A	2	2	4	0	3	7	0	0
8	25902319	.	C	T	20	20	40	0	2	42	0	0
8	25905524	.	T	A	25	15	40	0	1	41	0	0
8	25905744	.	T	G	26	17	43	0	3	47	1	0
8	25905919	.	T	C	4	7	11	0	1	12	0	0
8	25950577	.	G	A	5	2	7	0	0	7	0	0
8	25950877	.	C	T	12	4	16	0	1	17	0	0
8	25950999	.	G	A	1	7	8	0	10	18	0	0
8	25951162	.	G	A	0	2	2	0	3	5	0	0
8	25951194	.	A	T	5	2	7	0	1	8	0	0
8	25951197	.	G	A	7	1	8	0	0	8	0	0
8	25951366	.	C	T	8	9	17	0	1	18	0	0
8	25951417	.	A	T	8	10	18	0	2	20	0	0
8	25951437	.	A	C	10	11	21	0	2	23	0	0
8	25951473	.	A	T	7	6	13	0	0	13	0	0
8	25951517	.	C	T	4	6	10	0	0	10	0	0
8	25951697	.	A	T	5	3	8	0	0	8	0	0
8	25951804	.	A	G	4	3	7	0	0	7	0	0
8	25951806	.	A	T	4	3	7	0	0	7	0	0
8	25963223	.	A	C	3	2	5	0	0	5	0	0
8	25964397	.	A	C	8	5	13	0	0	13	0	0
8	25964398	.	T	C	8	5	13	0	0	13	0	0
8	25964468	.	A	G	3	0	3	0	5	8	0	0
8	25964489	.	A	G	1	0	1	0	9	10	0	0
8	25969833	.	A	G	4	0	4	0	5	9	0	0
8	25969845	.	A	G	5	4	9	0	0	9	0	0
8	25970772	.	A	G	12	9	21	0	2	23	0	0
8	26019711	.	A	G	1	2	3	0	1	4	0	0
8	26025040	.	T	C	1	4	5	0	0	5	0	0
8	26026772	.	C	T	4	2	6	0	0	6	0	0
8	26026787	.	C	T	4	2	6	0	0	6	0	0
8	26030223	.	C	T	9	5	14	0	0	14	0	0
8	26030226	.	G	A	9	5	14	0	0	14	0	0
8	26030808	.	C	A	2	10	12	0	1	13	0	0
8	26030852	.	A	G	3	6	9	0	2	11	0	0
8	26034654	.	A	G	1	2	3	0	0	3	0	0
8	26038309	.	G	A	6	7	13	0	1	14	0	0
8	26046168	.	G	C	1	7	8	0	4	12	0	0
8	26056935	.	T	C	20	18	38	0	8	46	0	0
8	26056970	.	T	C	18	16	34	0	5	39	0	0
8	26056990	.	T	C	21	23	44	0	2	46	0	0
8	26057014	.	T	C	25	28	53	0	2	55	0	0
8	26057130	.	T	C	22	29	51	0	2	53	0	0
8	26066234	.	C	T	3	5	8	0	1	9	0	0
8	26073777	.	G	A	2	6	8	0	1	9	0	0
8	26075413	.	T	C	5	4	9	0	0	9	0	0
8	26075518	.	C	T	5	2	7	0	0	7	0	0
8	26078879	.	T	G	11	6	17	0	0	17	0	0
8	26078898	.	C	A	11	5	16	0	1	17	0	0
8	26091845	.	A	G	2	0	2	0	7	9	0	0
8	26093660	.	G	A	2	5	7	0	0	7	0	0
8	26097321	.	C	T	19	20	39	0	2	41	0	0
8	26097399	.	T	C	22	19	41	0	4	45	0	0
8	26097744	.	G	T	1	8	9	0	12	21	0	0
8	26097749	.	C	T	13	8	21	0	1	22	0	0
8	26097881	.	T	C	5	9	14	0	2	16	0	0
8	26097966	.	C	T	12	9	21	0	2	23	0	0
8	26210178	.	G	A	2	2	4	0	0	4	0	0
8	26210523	.	A	T	3	2	5	0	0	5	0	0
8	26210781	.	C	T	2	2	4	0	0	4	0	0
8	26234027	.	A	G	2	2	4	0	0	4	0	0
8	26234044	.	G	A	1	2	3	0	1	4	0	0
8	26234114	.	G	T	1	2	3	0	4	7	0	0
8	26234123	.	T	A	5	1	6	0	1	7	0	0
8	26234154	.	G	A	5	3	8	0	0	8	0	0
8	26234169	.	G	A	4	2	6	0	0	6	0	0
8	26235323	.	T	C	4	2	6	0	0	6	0	0
8	26235554	.	C	T	8	7	15	0	1	16	0	0
8	26235560	.	T	G	9	7	16	0	0	16	0	0
8	26239871	.	T	G	10	0	10	0	4	14	0	0
8	26239938	.	G	A	10	6	16	0	1	17	0	0
8	26240007	.	C	T	14	4	18	0	0	18	0	0
8	26240047	.	T	G	13	5	18	0	1	19	0	0
8	26240346	.	G	A	1	3	4	0	8	12	0	0
8	26240348	.	A	T	9	3	12	0	0	12	0	0
8	26317376	.	T	C	3	3	6	0	0	6	0	0
8	26321296	.	C	T	7	4	11	0	0	11	0	0
8	26321359	.	G	A	4	5	9	0	1	10	0	0
8	26323458	.	A	T	4	4	8	0	0	8	0	0
8	26323511	.	T	A	3	3	6	0	0	6	0	0
8	26324575	.	G	C	2	2	4	0	0	4	0	0
8	26324584	.	A	T	2	2	4	0	0	4	0	0
8	26324691	.	C	A	4	4	8	0	0	8	0	0
8	26324905	.	A	G	3	2	5	0	1	6	0	0
8	26325332	.	T	A	25	14	39	0	2	41	0	0
8	26325333	.	A	T	25	15	40	0	0	40	0	0
8	26325680	.	G	A	1	15	16	0	23	39	0	0
8	26325888	.	G	A	2	7	9	0	22	31	0	0
8	26330190	.	T	C	2	3	5	0	0	5	0	0
8	26330545	.	C	T	1	3	4	0	2	6	0	0
8	26330666	.	T	C	3	3	6	0	1	7	0	0
8	26357826	.	A	G	16	11	27	0	0	27	0	0
8	26360974	.	G	T	11	7	18	0	0	18	0	0
8	26367891	.	T	G	23	16	39	0	6	45	0	0
8	26368019	.	C	T	20	16	36	5	3	44	0	0
8	26368025	.	C	T	26	10	36	5	2	43	0	0
8	26368171	.	T	C	32	21	53	1	2	56	0	0
8	26368356	.	G	A	1	15	16	0	14	30	0	0
8	26369055	.	C	T	6	6	12	0	0	12	0	0
8	26426163	.	T	C	4	6	10	0	1	11	0	0
8	26426478	.	G	A	4	5	9	0	1	10	0	0
8	26426487	.	G	A	5	4	9	0	0	9	0	0
8	26426596	.	T	G	3	5	8	0	1	9	0	0
8	26426771	.	C	T	3	7	10	0	0	10	0	0
8	26426978	.	A	C	12	5	17	0	0	17	0	0
8	26427081	.	C	T	9	7	16	0	0	16	0	0
8	26427137	.	A	T	8	6	14	0	1	16	1	0
8	26433541	.	T	C	3	2	5	0	0	5	0	0
8	26439033	.	C	T	2	6	8	0	0	8	0	0
8	26439046	.	A	G	2	6	8	0	0	8	0	0
8	26444701	.	T	C	3	2	5	0	0	5	0	0
8	26444877	.	C	T	6	2	8	0	0	8	0	0
8	26444892	.	T	A	4	4	8	0	0	8	0	0
8	26445037	.	T	C	4	9	13	0	0	13	0	0
8	26445119	.	A	G	4	6	10	0	0	10	0	0
8	26445166	.	G	A	1	9	10	0	3	13	0	0
8	26449581	.	C	T	2	1	3	0	2	5	0	0
8	26586558	.	G	A	7	5	12	0	1	13	0	0
8	26586634	.	A	C	3	2	5	0	2	7	0	0
8	26586900	.	G	T	3	3	6	0	1	7	0	0
8	26587137	.	C	G	0	2	2	0	1	3	0	0
8	26709844	.	T	C	1	3	4	0	0	4	0	0
8	26709876	.	A	T	2	3	5	0	0	5	0	0
8	26718306	.	A	G	4	2	6	0	1	7	0	0
8	26718309	.	T	G	5	2	7	0	0	7	0	0
8	26718354	.	T	G	2	2	4	0	0	4	0	0
8	26718355	.	G	T	2	2	4	0	0	4	0	0
8	26838547	.	C	T	4	5	9	0	0	9	0	0
8	26862002	.	A	C	1	4	5	0	0	5	0	0
8	26862526	.	C	A	1	3	4	0	0	4	0	0
8	26863804	.	C	A	8	5	13	0	2	15	0	0
8	26864121	.	A	G	5	12	17	0	0	17	0	0
8	26864150	.	G	C	5	13	18	0	1	19	0	0
8	26864195	.	G	C	11	12	23	0	0	23	0	0
8	26868369	.	C	T	4	2	6	0	0	6	0	0
8	26868418	.	T	C	5	6	11	0	0	11	0	0
8	26881205	.	T	G	4	0	4	0	15	19	0	0
8	26884298	.	T	C	9	11	20	0	2	22	0	0
8	26884313	.	A	G	9	13	22	0	0	22	0	0
8	26884619	.	C	T	20	27	47	0	0	47	0	0
8	26884767	.	C	T	20	25	45	0	1	46	0	0
8	26884903	.	T	A	14	15	29	0	1	30	0	0
8	26885382	.	C	A	18	18	36	0	3	39	0	0
8	26886025	.	C	T	17	19	36	0	2	38	0	0
8	26886177	.	T	C	17	26	43	0	1	44	0	0
8	26886259	.	A	G	16	21	37	0	3	40	0	0
8	26886399	.	C	G	25	18	43	0	1	44	0	0
8	26886667	.	T	A	39	22	61	0	0	63	2	0
8	26886766	.	T	C	31	25	56	0	2	58	0	0
8	26886972	.	A	T	21	28	49	0	0	49	0	0
8	26887013	.	T	C	25	22	47	0	1	48	0	0
8	26887122	.	A	C	20	22	42	0	3	45	0	0
8	27362288	.	C	G	3	10	13	0	1	14	0	0
8	27515239	.	T	C	1	5	6	0	0	6	0	0
8	27624026	.	T	A	24	13	37	0	3	40	0	0
8	27624027	.	T	C	24	14	38	0	2	40	0	0
8	27624222	.	T	C	2	2	4	0	0	4	0	0
8	27813611	.	C	A	2	8	10	0	0	10	0	0
8	27816560	.	C	A	28	26	54	0	4	58	0	0
8	27816680	.	C	T	25	22	47	0	2	49	0	0
8	28229971	.	C	T	5	4	9	0	0	9	0	0
8	28232512	.	G	T	2	4	6	0	0	6	0	0
8	28232745	.	G	T	6	11	17	0	0	17	0	0
8	28232812	.	G	T	5	5	10	0	0	10	0	0
8	28243362	.	A	G	1	2	3	0	0	3	0	0
8	28243437	.	A	G	2	3	5	0	0	5	0	0
8	28243579	.	C	T	8	7	15	0	1	16	0	0
8	28243707	.	C	G	9	7	16	0	2	18	0	0
8	28243830	.	T	G	3	2	5	0	0	5	0	0
8	28244063	.	C	T	1	3	4	0	0	4	0	0
8	28244076	.	C	T	1	5	6	0	0	6	0	0
8	28244116	.	G	A	5	2	7	0	1	8	0	0
8	28244193	.	G	A	7	5	12	0	0	12	0	0
8	28244267	.	C	A	3	3	6	0	1	7	0	0
8	28248692	.	G	T	3	3	6	0	0	6	0	0
8	28268062	.	G	T	2	6	8	0	1	9	0	0
8	28313256	.	G	A	20	18	38	0	3	41	0	0
8	28315258	.	A	G	16	8	24	0	0	24	0	0
8	28315301	.	T	C	13	0	13	0	11	24	0	0
8	28315378	.	A	G	10	12	22	0	1	23	0	0
8	28315424	.	C	G	5	10	15	0	0	15	0	0
8	28315436	.	G	T	3	8	11	0	2	13	0	0
8	28315481	.	A	G	4	11	15	0	0	15	0	0
8	28315694	.	A	G	7	4	11	0	0	11	0	0
8	28315699	.	A	G	6	5	11	0	1	12	0	0
8	28317748	.	A	T	3	7	10	0	0	10	0	0
8	28317844	.	T	C	5	0	5	0	4	9	0	0
8	28323403	.	C	A	1	7	8	0	2	10	0	0
8	28323442	.	A	G	3	5	8	0	0	8	0	0
8	28346284	.	G	A	1	6	7	0	0	7	0	0
8	28346569	.	A	G	1	3	4	0	0	4	0	0
8	28351147	.	T	A	9	8	17	0	0	17	0	0
8	28351678	.	T	C	7	3	10	0	1	11	0	0
8	28351679	.	C	T	7	4	11	0	0	11	0	0
8	28356317	.	A	G	4	6	10	0	1	11	0	0
8	28358501	.	C	A	4	4	8	0	2	10	0	0
8	28364854	.	G	A	2	4	6	0	12	18	0	0
8	28364923	.	T	A	9	12	21	1	0	22	0	0
8	28365119	.	C	T	7	7	14	0	0	14	0	0
8	28365328	.	A	T	7	11	18	0	0	18	0	0
8	28365361	.	C	T	8	11	19	0	1	20	0	0
8	28365417	.	A	G	7	10	17	0	0	17	0	0
8	28365479	.	C	T	9	7	16	0	0	16	0	0
8	28365496	.	C	A	8	4	12	0	0	12	0	0
8	28398893	.	C	A	5	2	7	0	0	7	0	0
8	28399129	.	G	A	9	7	16	0	0	16	0	0
8	28399297	.	T	A	4	8	12	0	1	13	0	0
8	28399580	.	T	A	6	6	12	0	0	12	0	0
8	28399625	.	A	C	5	6	11	0	1	12	0	0
8	28399672	.	A	G	8	5	13	1	1	15	0	0
8	28401003	.	C	A	3	3	6	0	0	6	0	0
8	28463587	.	T	C	1	3	4	0	0	4	0	0
8	28463785	.	A	T	3	7	10	0	1	11	0	0
8	28464556	.	C	T	8	5	13	0	3	16	0	0
8	28465184	.	G	A	5	3	8	0	0	8	0	0
8	28532490	.	C	T	2	2	4	0	0	4	0	0
8	28532715	.	C	T	1	2	3	0	0	3	0	0
8	28594221	.	G	A	4	2	6	0	1	7	0	0
8	28594395	.	C	T	2	2	4	0	0	4	0	0
8	29427918	.	G	A	1	3	4	0	1	5	0	0
8	29574985	.	C	A	4	7	11	0	0	11	0	0
8	29587232	.	C	T	9	8	17	0	0	17	0	0
8	29587262	.	C	A	6	7	13	0	0	13	0	0
8	29587500	.	C	A	10	8	18	0	1	19	0	0
8	29587651	.	C	T	7	6	13	0	0	13	0	0
8	29718850	.	G	A	2	2	4	0	0	4	0	0
8	29719306	.	C	T	2	3	5	0	0	5	0	0
8	29734653	.	A	T	3	2	5	0	0	5	0	0
8	29763390	.	G	C	1	3	4	0	0	4	0	0
8	29763822	.	A	G	3	0	3	0	3	6	0	0
8	29764968	.	T	C	4	2	6	0	0	6	0	0
8	29765178	.	C	T	3	4	7	0	0	7	0	0
8	29765264	.	A	C	1	3	4	0	0	4	0	0
8	29765447	.	A	G	3	2	5	0	1	6	0	0
8	29765872	.	A	C	1	3	4	0	0	4	0	0
8	29765899	.	T	G	1	4	5	0	0	5	0	0
8	29766204	.	G	A	1	4	5	0	0	5	0	0
8	29766247	.	T	C	2	7	9	0	1	10	0	0
8	29766576	.	G	T	1	4	5	0	0	5	0	0
8	29770185	.	C	T	17	10	27	0	0	27	0	0
8	29770207	.	G	A	20	15	35	0	2	37	0	0
8	29770371	.	T	A	34	30	64	0	2	66	0	0
8	29770511	.	C	T	33	28	61	0	1	62	0	0
8	29770775	.	A	T	23	21	44	0	2	46	0	0
8	29771053	.	A	G	21	18	39	0	1	40	0	0
8	29771173	.	G	A	12	13	25	0	1	26	0	0
8	29771336	.	T	C	2	0	2	0	5	7	0	0
8	29771774	.	G	A	1	2	3	0	0	3	0	0
8	29772910	.	G	T	1	5	6	0	0	6	0	0
8	29772933	.	C	T	0	7	7	0	4	11	0	0
8	29773127	.	T	A	7	5	12	0	1	13	0	0
8	29773329	.	C	A	3	8	11	0	0	11	0	0
8	29774258	.	C	T	2	5	7	0	0	7	0	0
8	29774263	.	C	A	2	4	6	0	0	6	0	0
8	29774370	.	T	A	2	3	5	0	1	6	0	0
8	29774528	.	C	T	0	3	3	0	1	4	0	0
8	29774827	.	C	T	1	2	3	0	2	5	0	0
8	29787265	.	C	T	0	3	3	0	2	5	0	0
8	29799168	.	C	T	1	2	3	0	0	3	0	0
8	29865862	.	T	A	1	2	3	0	0	3	0	0
8	29865886	.	C	T	3	2	5	0	0	5	0	0
8	29871800	.	T	C	4	3	7	0	0	7	0	0
8	29875559	.	A	T	2	2	4	0	0	4	0	0
8	29898947	.	T	C	6	3	9	0	1	10	0	0
8	29899117	.	G	A	8	4	12	0	0	12	0	0
8	29899373	.	G	A	11	4	15	0	1	16	0	0
8	29899453	.	A	G	4	2	6	0	0	6	0	0
8	29902904	.	T	C	1	2	3	0	0	3	0	0
8	29904949	.	G	T	1	2	3	0	0	3	0	0
8	29907764	.	C	T	2	2	4	0	0	4	0	0
8	30159420	.	C	T	7	7	14	0	0	14	0	0
8	30159560	.	A	C	14	0	14	0	15	29	0	0
8	30330667	.	C	T	8	3	11	0	1	12	0	0
8	30430521	.	C	T	3	4	7	0	0	7	0	0
8	30437530	.	A	G	0	3	3	0	0	3	0	0
8	30437538	.	T	C	2	2	4	0	0	4	0	0
8	30449074	.	G	A	2	6	8	0	0	8	0	0
8	30593567	.	G	A	2	6	8	0	0	8	0	0
8	30600565	.	C	T	3	3	6	0	0	6	0	0
8	30600606	.	T	A	4	3	7	0	0	7	0	0
8	30623379	.	G	A	2	2	4	0	0	4	0	0
8	30624247	.	G	A	2	3	5	0	0	5	0	0
8	30661270	.	C	T	4	7	11	0	0	11	0	0
8	30661762	.	A	G	1	0	1	0	2	3	0	0
8	30662278	.	T	G	3	2	5	0	3	8	0	0
8	30662279	.	G	A	6	2	8	0	0	8	0	0
8	30662343	.	G	C	3	2	5	0	0	5	0	0
8	30662488	.	T	A	16	8	24	0	0	24	0	0
8	30662505	.	A	T	7	10	17	0	4	21	0	0
8	30662627	.	A	T	3	3	6	0	0	6	0	0
8	30730983	.	A	C	7	9	16	0	0	16	0	0
8	30731178	.	G	A	10	3	13	0	0	13	0	0
8	30731187	.	A	G	5	8	13	0	0	13	0	0
8	30731492	.	C	T	2	3	5	0	0	5	0	0
8	30731709	.	A	C	7	2	9	0	1	10	0	0
8	30731720	.	G	A	5	2	7	0	0	7	0	0
8	30735082	.	T	A	4	4	8	0	0	8	0	0
8	30735085	.	A	G	4	4	8	0	0	8	0	0
8	30741991	.	C	G	2	4	6	0	0	6	0	0
8	30742022	.	C	A	1	2	3	0	2	5	0	0
8	30742075	.	C	T	2	3	5	0	0	5	0	0
8	30743345	.	A	G	2	6	8	0	0	8	0	0
8	30744468	.	G	A	0	5	5	0	7	12	0	0
8	30758237	.	C	T	1	2	3	0	0	3	0	0
8	30758334	.	T	C	1	2	3	0	0	3	0	0
8	30765075	.	A	G	1	2	3	0	0	3	0	0
8	30925834	.	C	T	3	2	5	0	0	5	0	0
8	30928624	.	G	A	6	3	9	0	1	10	0	0
8	30929267	.	A	G	6	0	6	0	7	13	0	0
8	30929958	.	T	A	17	18	35	1	1	37	0	0
8	30930764	.	C	A	25	20	45	0	1	46	0	0
8	30940027	.	T	A	8	9	17	0	1	18	0	0
8	30940072	.	T	G	7	4	11	0	1	12	0	0
8	31008426	.	G	A	0	2	2	0	5	7	0	0
8	31012948	.	A	C	16	13	29	0	0	29	0	0
8	31012993	.	C	T	15	17	32	0	0	32	0	0
8	31013176	.	A	T	11	5	16	0	1	17	0	0
8	31029026	.	C	T	1	2	3	0	0	3	0	0
8	31030717	.	A	C	2	3	5	0	1	6	0	0
8	31030914	.	A	T	15	19	34	0	0	34	0	0
8	31031068	.	A	G	6	7	13	0	2	15	0	0
8	31031069	.	A	T	8	7	15	0	0	15	0	0
8	31031535	.	G	A	0	2	2	0	1	3	0	0
8	31031603	.	A	T	9	12	21	0	2	23	0	0
8	31031740	.	A	G	21	20	41	0	1	42	0	0
8	31031993	.	G	A	23	21	44	0	0	44	0	0
8	31032379	.	C	T	15	9	24	0	5	29	0	0
8	31033861	.	A	T	12	13	25	0	1	26	0	0
8	31034924	.	A	G	13	12	25	0	0	25	0	0
8	31036057	.	G	A	16	15	31	0	2	33	0	0
8	31036126	.	G	A	18	10	28	0	3	31	0	0
8	31037403	.	C	T	2	4	6	0	1	7	0	0
8	31038890	.	C	T	8	3	11	0	0	11	0	0
8	31040157	.	G	A	4	4	8	0	0	8	0	0
8	31040175	.	A	G	4	4	8	0	1	9	0	0
8	31040211	.	A	G	4	4	8	0	0	8	0	0
8	31040861	.	G	A	2	2	4	0	0	4	0	0
8	31046698	.	A	G	1	2	3	0	0	3	0	0
8	31119730	.	A	G	1	2	3	0	0	3	0	0
8	31119909	.	T	G	1	1	2	0	2	4	0	0
8	31123029	.	T	C	2	3	5	0	0	5	0	0
8	31142074	.	G	A	9	1	10	0	9	19	0	0
8	31146748	.	G	A	16	23	39	0	6	45	0	0
8	31146913	.	G	A	20	24	44	1	3	48	0	0
8	31147380	.	T	G	17	18	35	0	2	37	0	0
8	31147526	.	G	A	24	23	47	0	2	49	0	0
8	31249605	.	A	G	1	2	3	0	0	3	0	0
8	31249881	.	T	A	2	1	3	0	2	5	0	0
8	31250032	.	A	G	3	0	3	1	4	8	0	0
8	31250183	.	C	A	2	3	5	0	0	5	0	0
8	31250823	.	G	A	4	8	12	0	1	13	0	0
8	31251129	.	G	A	9	10	19	0	1	20	0	0
8	31251282	.	A	C	10	9	19	0	1	20	0	0
8	31253582	.	C	T	18	15	33	0	2	35	0	0
8	31253722	.	T	C	14	8	22	0	0	22	0	0
8	31253729	.	T	A	5	10	15	0	0	15	0	0
8	31254163	.	G	A	18	21	39	0	3	42	0	0
8	31254219	.	T	C	4	13	17	0	0	17	0	0
8	31254281	.	G	T	6	3	9	0	0	9	0	0
8	31367747	.	T	C	1	2	3	0	0	3	0	0
8	31368010	.	G	A	20	18	38	0	0	38	0	0
8	31368279	.	T	G	9	6	15	0	1	16	0	0
8	31368524	.	C	T	9	5	14	0	0	14	0	0
8	31368889	.	C	T	9	3	12	0	0	12	0	0
8	31369071	.	G	C	8	7	15	0	1	16	0	0
8	31375457	.	A	G	12	12	24	0	0	24	0	0
8	31379542	.	C	T	2	3	5	0	5	10	0	0
8	31381731	.	T	A	1	2	3	0	1	4	0	0
8	31387695	.	A	G	5	4	9	0	0	9	0	0
8	31406847	.	G	C	5	0	5	0	11	16	0	0
8	31407153	.	C	T	8	9	17	0	0	17	0	0
8	31410872	.	C	T	3	6	9	0	0	9	0	0
8	31410887	.	G	A	4	7	11	0	0	11	0	0
8	31411089	.	C	T	0	4	4	0	6	10	0	0
8	31411176	.	T	G	4	2	6	0	1	7	0	0
8	31411569	.	A	C	5	0	5	0	4	9	0	0
8	31411638	.	G	T	6	5	11	0	0	11	0	0
8	31411858	.	A	G	3	6	9	0	0	9	0	0
8	31437611	.	C	T	21	9	30	0	1	31	0	0
8	31437671	.	T	C	9	19	28	0	1	29	0	0
8	31441724	.	G	T	9	26	35	0	1	36	0	0
8	31441733	.	C	A	29	9	38	0	1	39	0	0
8	31441814	.	G	A	19	24	43	0	1	44	0	0
8	31442595	.	G	A	20	15	35	0	1	36	0	0
8	31442648	.	C	T	31	15	46	0	0	46	0	0
8	31442835	.	T	A	2	30	32	0	4	36	0	0
8	31443023	.	A	C	36	19	55	2	11	68	0	0
8	31705267	.	G	A	23	16	39	0	3	42	0	0
8	31710941	.	G	A	8	4	12	0	1	13	0	0
8	31711411	.	T	C	6	0	6	0	8	14	0	0
8	31719077	.	T	C	3	3	6	0	0	6	0	0
8	31730762	.	C	A	2	5	7	0	0	7	0	0
8	31730771	.	C	T	2	6	8	0	0	8	0	0
8	31730801	.	C	G	3	6	9	0	1	10	0	0
8	31730813	.	A	C	6	8	14	0	0	14	0	0
8	31756865	.	T	C	7	7	14	0	0	14	0	0
8	31756940	.	T	C	10	4	14	0	0	14	0	0
8	31756946	.	T	C	10	4	14	0	0	14	0	0
8	31764858	.	G	A	8	5	13	0	2	15	0	0
8	31765077	.	C	T	14	7	21	0	1	23	1	0
8	31818022	.	G	A	2	17	19	0	18	37	0	0
8	31818083	.	A	T	14	15	29	0	2	31	0	0
8	31818349	.	A	C	10	14	24	0	0	24	0	0
8	31818371	.	A	G	12	11	23	0	1	24	0	0
8	31818549	.	C	T	9	7	16	0	0	16	0	0
8	31818745	.	C	T	13	8	21	0	0	21	0	0
8	31850976	.	G	T	6	5	11	0	2	13	0	0
8	31851270	.	G	A	1	3	4	0	0	4	0	0
8	31851594	.	T	C	19	9	28	0	4	32	0	0
8	31861425	.	A	G	10	13	23	0	1	24	0	0
8	31861580	.	G	A	16	9	25	0	2	27	0	0
8	31861615	.	A	C	10	21	31	0	1	32	0	0
8	31861742	.	G	A	16	12	28	0	2	30	0	0
8	31861746	.	C	T	14	15	29	0	1	30	0	0
8	31862179	.	A	G	9	17	26	0	5	31	0	0
8	31862312	.	G	A	1	19	20	0	29	49	0	0
8	31898671	.	A	G	4	1	5	0	4	9	0	0
8	31901760	.	C	T	2	2	4	0	0	4	0	0
8	31901925	.	G	A	13	8	21	0	1	22	0	0
8	31906927	.	G	A	13	15	28	0	2	30	0	0
8	31919451	.	G	T	2	3	5	0	4	9	0	0
8	31919526	.	C	A	8	9	17	0	0	17	0	0
8	31942099	.	C	T	7	4	11	0	0	11	0	0
8	31942174	.	G	A	2	5	7	0	7	14	0	0
8	31942771	.	C	T	6	12	18	0	0	18	0	0
8	31943276	.	G	A	5	9	14	0	1	15	0	0
8	31943301	.	T	G	6	6	12	0	0	12	0	0
8	32028856	.	G	T	8	7	15	0	0	15	0	0
8	32029573	.	T	C	2	0	2	0	7	9	0	0
8	32029810	.	G	C	4	2	6	0	0	6	0	0
8	32029843	.	T	C	2	3	5	0	0	5	0	0
8	32030144	.	A	G	5	3	8	0	0	8	0	0
8	32030837	.	T	A	3	5	8	0	0	8	0	0
8	32129255	.	T	C	1	2	3	0	0	3	0	0
8	32482851	.	C	T	17	13	30	0	0	30	0	0
8	32483536	.	C	T	9	6	15	0	2	17	0	0
8	32483905	.	G	C	7	11	18	0	0	18	0	0
8	32486956	.	C	T	0	8	8	0	5	13	0	0
8	32501541	.	A	G	5	4	9	0	0	9	0	0
8	32502932	.	C	T	1	3	4	0	0	4	0	0
8	32516557	.	T	C	3	5	8	0	1	9	0	0
8	32516629	.	A	C	1	6	7	0	0	7	0	0
8	32577794	.	G	A	4	4	8	0	1	9	0	0
8	32598954	.	A	G	10	7	17	0	0	17	0	0
8	32599413	.	T	C	11	13	24	0	0	24	0	0
8	32599586	.	C	T	5	10	15	0	0	15	0	0
8	32599805	.	T	C	4	4	8	0	1	9	0	0
8	32914694	.	C	T	8	7	15	0	2	17	0	0
8	32914782	.	T	A	7	5	12	0	0	12	0	0
8	32914813	.	A	T	4	3	7	0	1	8	0	0
8	32949287	.	C	T	0	2	2	0	1	3	0	0
8	33896326	.	A	T	15	12	27	1	3	32	1	0
8	33896585	.	C	T	21	26	47	0	0	47	0	0
8	33896902	.	G	A	22	19	41	0	2	43	0	0
8	33896922	.	G	A	21	24	45	0	0	45	0	0
8	33897266	.	T	C	27	0	27	0	18	45	0	0
8	33897274	.	C	T	3	25	28	0	20	48	0	0
8	33910008	.	G	A	23	13	36	2	3	41	0	0
8	33910017	.	G	A	13	21	34	2	2	38	0	0
8	33924284	.	A	G	9	11	20	0	0	20	0	0
8	33924432	.	C	T	1	14	15	0	6	21	0	0
8	34051719	.	G	A	7	4	11	0	0	11	0	0
8	34051850	.	G	A	2	3	5	0	0	5	0	0
8	34051930	.	T	G	2	2	4	0	2	6	0	0
8	34342146	.	G	A	7	6	13	0	0	13	0	0
8	34342214	.	A	T	20	8	28	0	0	28	0	0
8	34342462	.	A	G	10	3	13	4	2	19	0	0
8	34345285	.	G	A	10	9	19	0	1	20	0	0
8	34345372	.	T	C	9	13	22	0	0	22	0	0
8	34345390	.	A	G	5	11	16	0	2	18	0	0
8	34345583	.	A	G	1	9	10	0	2	12	0	0
8	34347281	.	T	C	9	8	17	0	1	18	0	0
8	34348958	.	A	C	1	4	5	0	0	5	0	0
8	35759213	.	G	C	2	2	4	0	0	4	0	0
8	35759363	.	T	G	2	3	5	0	0	5	0	0
8	35759402	.	C	T	1	3	4	0	0	4	0	0
8	35759444	.	C	T	2	3	5	0	0	5	0	0
8	35759726	.	C	T	1	2	3	0	0	3	0	0
8	35759999	.	C	T	2	2	4	0	1	5	0	0
8	35760218	.	C	T	11	6	17	0	0	17	0	0
8	36059333	.	T	C	1	3	4	0	0	4	0	0
8	36061619	.	G	A	3	2	5	0	0	5	0	0
8	36474411	.	A	G	1	2	3	0	0	3	0	0
8	36560180	.	C	T	5	4	9	0	0	9	0	0
8	36561942	.	A	T	10	5	15	0	0	15	0	0
8	36562451	.	A	G	13	0	13	0	6	19	0	0
8	36564005	.	A	G	10	4	14	0	1	15	0	0
8	36564746	.	C	T	2	4	6	0	7	13	0	0
8	36566125	.	C	T	18	9	27	0	0	27	0	0
8	36566167	.	G	A	15	7	22	0	1	23	0	0
8	36566182	.	T	C	16	7	23	0	2	25	0	0
8	36566353	.	T	C	11	6	17	0	0	17	0	0
8	36567283	.	C	T	24	11	35	0	1	36	0	0
8	36568561	.	A	G	26	10	36	0	1	37	0	0
8	36568755	.	T	C	14	8	22	0	2	24	0	0
8	36569810	.	T	C	14	10	24	0	2	26	0	0
8	36569924	.	C	A	16	6	22	0	0	22	0	0
8	36569925	.	T	A	16	5	21	0	1	22	0	0
8	36569968	.	A	C	19	6	25	0	0	26	1	0
8	36569990	.	A	G	20	6	26	0	1	27	0	0
8	36570147	.	T	C	4	2	6	0	0	6	0	0
8	36575325	.	T	C	9	3	12	0	2	14	0	0
8	36577083	.	T	C	8	6	14	0	0	14	0	0
8	36577368	.	T	A	2	2	4	0	1	5	0	0
8	36577404	.	T	A	2	4	6	0	1	7	0	0
8	36578763	.	C	T	5	2	7	0	0	7	0	0
8	36583834	.	T	C	2	5	7	0	0	7	0	0
8	36587934	.	A	G	10	17	27	0	1	28	0	0
8	36587936	.	A	G	9	0	9	0	18	27	0	0
8	36587970	.	C	A	9	15	24	0	0	24	0	0
8	36587981	.	G	T	9	12	21	0	0	21	0	0
8	36588124	.	G	A	15	16	31	0	1	32	0	0
8	36589197	.	C	T	10	10	20	0	0	21	1	0
8	36589260	.	T	A	6	5	11	0	1	12	0	0
8	36591868	.	A	C	7	7	14	0	2	16	0	0
8	36591985	.	C	T	7	6	13	0	1	14	0	0
8	36592018	.	A	G	4	9	13	0	1	14	0	0
8	36592021	.	C	A	0	10	10	0	5	15	0	0
8	36592159	.	A	G	1	4	5	1	0	6	0	0
8	36592160	.	A	G	1	4	5	1	0	6	0	0
8	36592297	.	G	A	6	6	12	1	2	15	0	0
8	36592374	.	A	G	19	5	24	0	1	25	0	0
8	36594354	.	T	C	10	1	11	0	11	22	0	0
8	36594481	.	T	G	8	11	19	0	1	20	0	0
8	36594509	.	G	A	8	10	18	0	0	18	0	0
8	36598244	.	T	C	3	0	3	0	7	10	0	0
8	36598441	.	C	T	0	4	4	0	6	10	0	0
8	36600867	.	C	T	6	8	14	0	0	14	0	0
8	36600879	.	G	A	8	8	16	0	0	16	0	0
8	36602459	.	C	T	5	3	8	0	1	9	0	0
8	36617635	.	C	G	3	4	7	0	0	7	0	0
8	36617669	.	A	G	2	2	4	0	2	6	0	0
8	36617728	.	G	A	1	4	5	0	0	5	0	0
8	36951346	.	C	T	1	2	3	0	0	3	0	0
8	36952015	.	A	G	1	0	1	0	6	7	0	0
8	36953884	.	A	G	1	3	4	0	0	4	0	0
8	36956254	.	C	T	3	3	6	0	2	8	0	0
8	36956269	.	T	C	3	4	7	0	0	7	0	0
8	36964126	.	G	A	3	3	6	0	0	6	0	0
8	36969205	.	T	C	5	5	10	0	0	10	0	0
8	36974328	.	C	T	12	5	17	0	2	19	0	0
8	36974514	.	C	T	10	10	20	0	1	21	0	0
8	36975826	.	A	G	6	6	12	0	3	15	0	0
8	36975928	.	T	C	9	5	14	0	1	15	0	0
8	36976089	.	T	C	4	4	8	0	0	8	0	0
8	36976319	.	T	A	1	3	4	0	0	4	0	0
8	36976352	.	G	T	0	6	6	0	2	8	0	0
8	36976388	.	A	T	6	4	10	0	1	11	0	0
8	36976432	.	T	A	11	7	18	0	2	20	0	0
8	36976557	.	G	A	16	15	31	0	1	32	0	0
8	36976836	.	C	A	17	16	33	0	1	34	0	0
8	36977178	.	A	G	26	16	42	0	3	45	0	0
8	36977199	.	C	A	17	18	35	0	3	38	0	0
8	36977520	.	G	A	19	18	37	0	1	38	0	0
8	36977848	.	T	C	6	17	23	0	1	24	0	0
8	37010662	.	T	C	3	2	5	0	0	5	0	0
8	37012762	.	T	A	3	2	5	0	2	7	0	0
8	37012825	.	C	T	1	2	3	0	0	3	0	0
8	37012872	.	C	G	3	6	9	0	0	9	0	0
8	37013093	.	A	G	2	4	6	0	1	7	0	0
8	37013255	.	T	C	2	3	5	0	0	5	0	0
8	37014582	.	T	C	9	6	15	0	0	15	0	0
8	37016584	.	G	T	0	5	5	0	8	13	0	0
8	37016616	.	C	T	4	6	10	0	0	10	0	0
8	37016638	.	A	G	5	5	10	0	0	10	0	0
8	37016784	.	G	A	1	12	13	0	6	19	0	0
8	37016790	.	T	C	6	12	18	0	0	18	0	0
8	37017149	.	G	A	9	8	17	0	0	17	0	0
8	37017159	.	C	T	11	6	17	0	1	18	0	0
8	37018904	.	A	G	13	1	14	0	9	23	0	0
8	37019048	.	G	A	14	12	26	0	1	27	0	0
8	37019062	.	C	A	16	12	28	0	1	29	0	0
8	37025576	.	A	T	14	16	30	0	0	30	0	0
8	37025614	.	T	A	16	17	33	0	1	34	0	0
8	37025633	.	A	G	17	1	18	0	17	35	0	0
8	37025896	.	T	C	11	8	19	0	3	22	0	0
8	37026130	.	G	A	13	11	24	0	0	24	0	0
8	37031447	.	T	A	1	2	3	0	0	3	0	0
8	37059976	.	A	G	4	9	13	0	0	13	0	0
8	37060595	.	A	C	14	10	24	0	0	24	0	0
8	37060640	.	A	G	8	9	17	0	0	17	0	0
8	37229473	.	G	A	3	2	5	0	0	5	0	0
8	37232122	.	C	T	0	9	9	0	11	20	0	0
8	37232189	.	A	C	12	0	12	0	9	21	0	0
8	37232442	.	A	C	16	0	16	0	12	28	0	0
8	37232487	.	A	C	28	12	40	0	2	42	0	0
8	37241078	.	A	G	7	2	9	0	0	9	0	0
8	37242367	.	T	G	2	4	6	0	0	6	0	0
8	37242374	.	A	T	3	3	6	0	1	7	0	0
8	37242438	.	T	C	2	4	6	0	0	6	0	0
8	37280726	.	C	T	5	6	11	0	1	12	0	0
8	37280858	.	C	T	4	3	7	0	0	7	0	0
8	37281109	.	T	C	3	9	12	0	2	14	0	0
8	37282610	.	G	A	6	2	8	0	0	8	0	0
8	37282752	.	C	T	9	3	12	0	0	12	0	0
8	37282866	.	T	G	5	5	10	0	0	10	0	0
8	37282907	.	A	T	4	2	6	0	0	6	0	0
8	37282911	.	G	T	3	2	5	0	0	5	0	0
8	40217948	.	G	A	1	2	3	0	0	3	0	0
8	40234640	.	C	T	2	3	5	0	0	5	0	0
8	40234764	.	C	T	0	3	3	2	1	6	0	0
8	40234830	.	A	G	1	5	6	0	0	6	0	0
8	40234831	.	T	A	1	5	6	0	0	6	0	0
8	40235184	.	A	T	2	4	6	0	0	6	0	0
8	40235192	.	C	T	6	2	8	0	1	9	0	0
8	40235244	.	C	T	3	3	6	0	1	7	0	0
8	40235281	.	G	A	3	3	6	0	1	7	0	0
8	40235348	.	G	C	3	7	10	0	0	10	0	0
8	40235419	.	T	A	1	2	3	0	0	3	0	0
8	40236139	.	A	G	1	3	4	0	0	4	0	0
8	40236168	.	C	G	2	5	7	0	1	8	0	0
8	40237906	.	C	T	4	11	15	0	1	16	0	0
8	40239590	.	G	A	1	2	3	0	0	3	0	0
8	40240922	.	C	G	18	12	30	0	0	30	0	0
8	40241441	.	A	G	32	13	45	9	2	56	0	0
8	40241446	.	A	G	35	13	48	9	1	58	0	0
8	40241640	.	A	T	24	11	35	5	2	42	0	0
8	40241681	.	A	G	30	11	41	0	1	42	0	0
8	40241695	.	T	A	25	8	33	0	2	35	0	0
8	40242103	.	G	A	12	16	28	0	0	28	0	0
8	40242453	.	G	A	11	11	22	0	1	23	0	0
8	40242613	.	T	A	5	4	9	0	2	11	0	0
8	40242653	.	C	T	7	3	10	0	0	10	0	0
8	40243052	.	G	C	5	12	17	0	0	17	0	0
8	40243148	.	T	C	10	8	18	0	0	18	0	0
8	40248373	.	T	G	6	7	13	0	0	13	0	0
8	40248673	.	T	C	3	4	7	0	0	7	0	0
8	40248976	.	G	T	3	7	10	0	0	10	0	0
8	40251444	.	T	G	3	6	9	0	0	9	0	0
8	40254366	.	A	G	3	2	5	0	0	5	0	0
8	40254375	.	T	G	2	2	4	0	0	4	0	0
8	40325709	.	G	T	15	4	19	0	0	19	0	0
8	40326039	.	A	G	18	7	25	0	1	26	0	0
8	40326128	.	C	T	13	11	24	0	1	25	0	0
8	40427489	.	T	C	7	6	13	0	0	13	0	0
8	40427500	.	T	C	5	7	12	0	1	13	0	0
8	40429498	.	T	C	2	2	4	0	0	4	0	0
8	40631823	.	C	T	3	2	5	0	2	7	0	0
8	40631862	.	C	T	2	2	4	0	0	4	0	0
8	40632014	.	T	C	1	4	5	0	0	5	0	0
8	40632065	.	T	C	2	3	5	0	0	5	0	0
8	40632313	.	C	G	4	3	7	0	0	7	0	0
8	40632411	.	A	T	4	2	6	0	1	7	0	0
8	40632758	.	A	C	5	9	14	0	1	15	0	0
8	40632793	.	A	T	2	6	8	0	0	8	0	0
8	40633172	.	G	C	6	2	8	0	2	10	0	0
8	41186191	.	C	A	0	5	5	0	1	6	0	0
8	41186455	.	A	C	2	3	5	0	0	5	0	0
8	41194542	.	C	G	2	4	6	0	0	6	0	0
8	41201716	.	G	A	2	2	4	0	0	4	0	0
8	41201744	.	A	G	1	2	3	0	0	3	0	0
8	41201863	.	C	T	0	2	2	0	3	5	0	0
8	41240949	.	T	C	2	2	4	0	0	4	0	0
8	41249879	.	A	G	6	5	11	0	2	13	0	0
8	41249882	.	T	C	6	6	12	0	0	12	0	0
8	41249942	.	T	C	5	5	10	0	0	10	0	0
8	41255346	.	C	T	6	6	12	0	0	12	0	0
8	41255439	.	G	A	10	19	29	0	2	31	0	0
8	41255554	.	C	T	15	10	25	0	1	27	1	0
8	41255573	.	T	C	14	10	24	0	0	24	0	0
8	41255750	.	G	A	4	5	9	0	0	9	0	0
8	41260534	.	C	T	17	23	40	0	4	44	0	0
8	41260634	.	A	G	28	22	50	0	2	52	0	0
8	41260668	.	A	G	29	19	48	0	0	48	0	0
8	41260823	.	G	C	25	18	43	0	0	43	0	0
8	41260877	.	A	G	21	23	44	0	3	47	0	0
8	41260880	.	T	C	22	5	27	0	21	48	0	0
8	41260923	.	T	A	31	18	49	0	1	50	0	0
8	41260985	.	G	A	27	15	42	0	1	43	0	0
8	41261178	.	T	C	18	16	34	0	3	37	0	0
8	41261190	.	A	G	20	14	34	0	3	37	0	0
8	41261294	.	A	G	18	19	37	0	1	38	0	0
8	41263005	.	A	G	15	26	41	0	2	43	0	0
8	41263085	.	G	A	21	17	38	0	0	38	0	0
8	41263206	.	A	G	17	10	27	1	1	29	0	0
8	41263220	.	T	C	15	12	27	1	1	29	0	0
8	41264447	.	A	T	20	11	31	0	2	33	0	0
8	41264549	.	C	G	20	21	41	0	1	42	0	0
8	41264786	.	A	C	28	11	39	0	1	40	0	0
8	41264788	.	T	A	25	11	36	0	5	41	0	0
8	41265180	.	T	C	16	21	37	0	2	39	0	0
8	41265264	.	G	A	20	14	34	0	1	35	0	0
8	41265549	.	T	C	13	8	21	0	2	23	0	0
8	41266567	.	T	C	11	11	22	0	1	23	0	0
8	41266573	.	A	T	10	10	20	0	0	21	1	0
8	41267976	.	C	T	9	7	16	0	4	20	0	0
8	41273680	.	C	T	2	4	6	0	0	6	0	0
8	41274561	.	T	C	5	2	7	0	0	7	0	0
8	41274617	.	G	A	5	6	11	0	0	11	0	0
8	41468868	.	C	T	5	7	12	0	1	13	0	0
8	41474547	.	T	C	4	3	7	0	0	7	0	0
8	41474556	.	G	A	6	3	9	0	0	9	0	0
8	41482466	.	C	T	1	2	3	0	0	3	0	0
8	41484219	.	G	A	2	3	5	0	0	5	0	0
8	41485132	.	A	G	4	3	7	0	1	8	0	0
8	41488641	.	C	G	1	3	4	0	0	4	0	0
8	41493936	.	C	G	1	2	3	0	0	3	0	0
8	41533605	.	T	C	1	2	3	0	0	3	0	0
8	42834091	.	C	G	1	2	3	0	0	3	0	0
8	44296292	.	C	T	0	3	3	0	4	7	0	0
8	44296595	.	A	C	7	0	7	0	6	13	0	0
8	44296672	.	G	A	5	15	20	0	0	20	0	0
8	44297174	.	A	C	1	2	3	0	0	3	0	0
8	44567015	.	G	A	1	2	3	0	0	3	0	0
8	44602264	.	A	G	5	3	8	0	0	8	0	0
8	44604588	.	C	T	1	4	5	0	2	7	0	0
8	44617902	.	G	A	5	10	15	0	0	15	0	0
8	44617903	.	A	T	5	10	15	0	0	15	0	0
8	44618024	.	C	T	2	8	10	0	0	10	0	0
8	44671767	.	T	C	1	2	3	0	0	3	0	0
8	44677544	.	C	T	1	2	3	0	0	3	0	0
8	44677613	.	T	C	4	5	9	0	0	9	0	0
8	44694956	.	G	A	0	4	4	0	6	10	0	0
8	44695043	.	A	C	3	3	6	0	1	7	0	0
8	44695140	.	A	C	7	7	14	0	0	14	0	0
8	44695230	.	A	T	8	6	14	0	0	14	0	0
8	44707591	.	T	C	3	3	6	0	0	6	0	0
8	44707599	.	C	A	2	2	4	0	2	6	0	0
8	44894604	.	C	T	4	3	7	0	0	7	0	0
8	44894631	.	G	C	4	7	11	0	0	11	0	0
8	44897853	.	C	A	1	8	9	0	2	11	0	0
8	44923622	.	T	G	2	2	4	0	1	5	0	0
8	44959583	.	C	T	0	3	3	0	1	4	0	0
8	44959589	.	A	G	1	3	4	0	0	4	0	0
8	44975939	.	G	C	1	3	4	0	0	4	0	0
8	44976047	.	G	T	1	5	6	0	0	6	0	0
8	44976120	.	G	A	2	2	4	0	0	4	0	0
8	44976144	.	G	A	2	2	4	0	0	4	0	0
8	44976155	.	A	G	2	3	5	0	1	6	0	0
8	44976197	.	T	C	1	5	6	0	0	6	0	0
8	45298603	.	G	A	6	2	8	0	0	8	0	0
8	45298943	.	G	C	3	4	7	0	0	7	0	0
8	45308963	.	A	C	4	5	9	0	1	10	0	0
8	45311761	.	T	G	6	8	14	0	0	14	0	0
8	45312285	.	C	A	4	4	8	0	1	9	0	0
8	45313023	.	A	C	6	5	11	0	1	12	0	0
8	45315444	.	T	C	5	14	19	0	0	19	0	0
8	45317898	.	A	T	10	13	23	0	2	25	0	0
8	45317976	.	G	A	0	7	7	0	12	19	0	0
8	45318124	.	C	T	6	6	12	0	1	13	0	0
8	45319659	.	A	G	13	0	13	0	19	32	0	0
8	45325269	.	G	C	20	15	35	0	5	40	0	0
8	45328278	.	T	A	13	6	19	1	1	21	0	0
8	45361816	.	A	G	5	7	12	0	0	12	0	0
8	45365789	.	T	C	4	6	10	0	0	10	0	0
8	45374151	.	A	T	13	10	23	0	1	24	0	0
8	45374477	.	A	G	5	7	12	0	0	12	0	0
8	45374665	.	T	A	15	15	30	0	0	30	0	0
8	45374828	.	A	C	12	9	21	0	6	27	0	0
8	45374884	.	T	G	16	12	28	0	0	28	0	0
8	45374966	.	G	T	6	8	14	0	1	15	0	0
8	45374970	.	A	G	5	7	12	0	1	13	0	0
8	45381596	.	G	T	0	3	3	0	4	7	0	0
8	45392034	.	G	A	0	3	3	0	3	6	0	0
8	45395002	.	C	A	1	1	2	0	1	3	0	0
8	45395024	.	C	A	6	3	9	0	0	9	0	0
8	45395114	.	T	A	10	10	20	0	0	20	0	0
8	45395127	.	C	T	6	10	16	0	1	17	0	0
8	45395357	.	C	T	3	6	9	0	1	10	0	0
8	45396028	.	T	C	10	0	10	0	13	23	0	0
8	45427189	.	C	A	9	16	25	0	1	26	0	0
8	45428039	.	C	T	8	7	15	0	0	15	0	0
8	45430757	.	G	A	9	9	18	0	0	18	0	0
8	45755040	.	T	C	4	2	6	0	0	6	0	0
8	45755117	.	G	A	3	6	9	0	0	9	0	0
8	45755185	.	T	C	2	8	10	0	1	11	0	0
8	45755212	.	G	T	4	5	9	0	0	9	0	0
8	45755442	.	G	A	6	4	10	0	0	10	0	0
8	45755577	.	G	A	4	6	10	0	0	10	0	0
8	45755816	.	T	C	39	22	61	0	7	68	0	0
8	45755973	.	C	G	29	34	63	0	3	66	0	0
8	45756191	.	A	G	31	14	45	0	1	46	0	0
8	45756206	.	G	A	28	13	41	0	4	45	0	0
8	45760071	.	A	C	5	0	5	0	5	10	0	0
8	45762571	.	A	G	1	2	3	0	0	3	0	0
8	45762594	.	T	C	2	3	5	0	0	5	0	0
8	45762619	.	A	G	2	3	5	0	0	5	0	0
8	45762987	.	A	G	2	6	8	0	0	8	0	0
8	45763562	.	G	A	23	13	36	0	5	41	0	0
8	45763991	.	A	G	15	21	36	0	1	37	0	0
8	45764006	.	G	C	22	16	38	0	1	39	0	0
8	45764118	.	C	T	4	9	13	0	18	31	0	0
8	45764697	.	T	C	10	8	18	0	0	18	0	0
8	45764873	.	T	C	5	12	17	0	0	17	0	0
8	45764893	.	T	C	9	13	22	0	2	24	0	0
8	45764939	.	G	A	22	16	38	0	0	38	0	0
8	45764988	.	A	T	21	12	33	0	0	33	0	0
8	45765023	.	T	A	19	11	30	1	5	36	0	0
8	45765024	.	T	A	22	13	35	1	0	36	0	0
8	45765305	.	G	A	16	18	34	0	2	36	0	0
8	45772915	.	C	A	8	14	22	0	0	22	0	0
8	45774471	.	C	T	1	5	6	0	4	10	0	0
8	45775047	.	C	T	1	2	3	0	0	3	0	0
8	45775304	.	G	A	2	4	6	0	1	7	0	0
8	45775319	.	G	T	3	3	6	0	1	7	0	0
8	45779729	.	A	C	2	3	5	0	0	5	0	0
8	45786528	.	A	G	1	2	3	0	1	4	0	0
8	45786615	.	A	G	1	2	3	0	0	3	0	0
8	45788941	.	T	G	2	2	4	0	0	4	0	0
8	45853626	.	G	A	2	2	4	0	1	5	0	0
8	45864652	.	G	C	6	2	8	0	1	9	0	0
8	45944896	.	T	A	6	3	9	0	0	9	0	0
8	45944983	.	G	A	6	3	9	0	0	9	0	0
8	45951974	.	G	A	0	5	5	0	3	9	1	0
8	45952152	.	A	T	3	2	5	0	0	5	0	0
8	45952281	.	C	T	9	8	17	0	0	17	0	0
8	45952352	.	G	C	2	9	11	0	1	12	0	0
8	45952461	.	G	A	1	5	6	1	7	14	0	0
8	45952547	.	G	T	2	7	9	0	0	9	0	0
8	45965528	.	G	T	4	2	6	0	0	6	0	0
8	45965749	.	G	A	3	4	7	0	0	7	0	0
8	46014147	.	T	C	3	3	6	0	0	6	0	0
8	46077850	.	T	A	10	6	16	1	1	18	0	0
8	46077879	.	C	A	8	6	14	0	0	14	0	0
8	46078144	.	A	T	1	2	3	0	0	3	0	0
8	46078168	.	C	A	5	4	9	0	0	9	0	0
8	46078241	.	A	T	11	7	18	0	5	23	0	0
8	46078264	.	A	T	13	9	22	0	3	25	0	0
8	46078287	.	A	G	16	8	24	0	1	25	0	0
8	46078342	.	C	G	10	7	17	0	0	17	0	0
8	46089052	.	T	C	12	15	27	0	3	30	0	0
8	46094790	.	G	A	8	4	12	0	0	12	0	0
8	46123717	.	G	A	4	4	8	0	0	8	0	0
8	46123731	.	G	A	4	4	8	0	0	8	0	0
8	46132662	.	G	C	2	0	2	0	2	4	0	0
8	46188003	.	A	G	1	2	3	0	0	3	0	0
8	46347099	.	A	T	2	2	4	0	0	4	0	0
8	46348145	.	G	T	3	5	8	0	0	8	0	0
8	46353362	.	C	A	1	3	4	0	1	5	0	0
8	46353365	.	G	C	2	2	4	0	0	4	0	0
8	46356282	.	G	A	5	7	12	0	0	12	0	0
8	46362293	.	G	A	2	2	4	0	1	5	0	0
8	46499385	.	T	A	1	3	4	0	0	4	0	0
8	46499645	.	T	C	1	2	3	0	0	3	0	0
8	46853005	.	A	T	5	5	10	0	0	10	0	0
8	46853015	.	A	T	5	5	10	0	1	11	0	0
8	46855313	.	G	A	1	3	4	0	0	4	0	0
8	47145008	.	A	G	40	35	75	1	8	84	0	0
8	47147333	.	A	T	37	29	66	0	4	70	0	0
8	47149394	.	A	G	35	29	64	0	1	65	0	0
8	47159514	.	G	A	4	6	10	0	0	10	0	0
8	47159557	.	C	A	7	4	11	0	0	11	0	0
8	47163244	.	G	A	5	2	7	0	0	7	0	0
8	47178393	.	T	A	3	2	5	0	1	6	0	0
8	47835146	.	T	C	2	3	5	0	0	5	0	0
8	47835148	.	C	T	2	3	5	0	0	5	0	0
8	47932409	.	C	T	4	2	6	0	0	6	0	0
8	47932442	.	G	A	2	2	4	0	0	4	0	0
8	47937152	.	T	C	6	3	9	0	0	9	0	0
8	47937156	.	A	G	6	0	6	0	3	9	0	0
8	47946517	.	T	C	8	13	21	0	2	23	0	0
8	47946674	.	G	A	4	5	9	0	1	10	0	0
8	47946753	.	C	T	4	9	13	0	0	13	0	0
8	47946776	.	T	C	7	6	13	0	1	14	0	0
8	47946833	.	A	G	8	8	16	0	0	16	0	0
8	47946846	.	A	G	7	8	15	0	0	15	0	0
8	47947052	.	A	C	6	3	9	0	1	10	0	0
8	47947297	.	C	T	7	7	14	0	0	14	0	0
8	47947341	.	C	A	7	9	16	0	1	17	0	0
8	47947649	.	T	A	11	13	24	0	1	25	0	0
8	47947772	.	A	G	7	2	9	0	12	21	0	0
8	47947996	.	T	G	11	9	20	0	1	21	0	0
8	47948102	.	T	A	18	15	33	0	1	34	0	0
8	47948602	.	G	A	2	18	20	0	19	39	0	0
8	47948755	.	C	T	12	22	34	0	4	38	0	0
8	47948820	.	A	C	13	10	23	0	1	24	0	0
8	47948866	.	C	A	6	10	16	0	0	16	0	0
8	48093139	.	T	C	1	3	4	0	1	5	0	0
8	48603788	.	G	C	0	4	4	0	3	7	0	0
8	48603978	.	T	A	4	4	8	0	0	8	0	0
8	48604114	.	T	A	5	6	11	0	1	12	0	0
8	48629640	.	T	A	4	4	8	0	0	8	0	0
8	48629668	.	G	A	5	2	7	0	1	8	0	0
8	48629797	.	C	A	5	4	9	0	0	9	0	0
8	48630017	.	A	G	3	4	7	0	0	7	0	0
8	48642496	.	A	G	2	3	5	0	0	5	0	0
8	48809678	.	A	C	1	3	4	0	1	5	0	0
8	48816147	.	C	T	1	4	5	0	1	6	0	0
8	48816242	.	T	C	2	8	10	0	4	14	0	0
8	48816438	.	T	G	2	2	4	0	0	4	0	0
8	48816447	.	C	T	0	2	2	0	3	5	0	0
8	48819365	.	C	T	0	3	3	0	2	5	0	0
8	48958468	.	C	T	1	2	3	0	0	3	0	0
8	48958637	.	A	G	3	8	11	0	0	11	0	0
8	48959047	.	G	A	7	9	16	0	0	16	0	0
8	49071207	.	T	A	3	2	5	0	0	5	0	0
8	49071212	.	A	C	3	2	5	0	0	5	0	0
8	49073021	.	G	A	2	3	5	0	0	5	0	0
8	49078792	.	G	A	1	4	5	0	4	9	0	0
8	49082598	.	C	A	4	3	7	0	1	8	0	0
8	49086105	.	G	T	3	4	7	0	0	7	0	0
8	49092108	.	C	T	2	4	6	0	1	7	0	0
8	49092129	.	C	T	3	3	6	0	0	6	0	0
8	49096541	.	G	T	5	6	11	0	0	11	0	0
8	49108347	.	A	T	11	10	21	0	3	24	0	0
8	49170190	.	T	A	6	5	11	0	2	13	0	0
8	49170366	.	T	A	40	31	71	0	4	75	0	0
8	49172338	.	A	G	35	26	61	0	1	62	0	0
8	49310830	.	C	T	1	4	5	0	0	5	0	0
8	49311090	.	C	T	5	7	12	0	1	13	0	0
8	49311355	.	T	C	7	11	18	0	1	19	0	0
8	49311396	.	C	A	6	5	11	0	0	11	0	0
8	49311398	.	G	C	6	5	11	0	0	11	0	0
8	49345191	.	T	C	3	2	5	0	0	5	0	0
8	49345212	.	G	T	2	2	4	0	0	4	0	0
8	49404152	.	G	T	24	20	44	2	8	54	0	0
8	49404262	.	C	T	41	21	62	1	3	66	0	0
8	49404502	.	C	T	45	26	71	1	3	75	0	0
8	49404928	.	C	T	36	36	72	0	0	72	0	0
8	49405188	.	C	T	0	2	2	0	3	5	0	0
8	49405214	.	G	C	3	3	6	0	0	6	0	0
8	49406062	.	G	C	1	3	4	2	1	7	0	0
8	49413417	.	G	T	31	24	55	0	1	56	0	0
8	49413444	.	G	A	24	33	57	0	3	60	0	0
8	49413459	.	G	A	25	33	58	0	2	60	0	0
8	49415718	.	G	C	21	12	33	0	2	35	0	0
8	49435964	.	C	G	11	5	16	0	1	17	0	0
8	49443191	.	A	G	9	0	9	0	7	16	0	0
8	49447519	.	G	A	4	8	12	0	1	13	0	0
8	49447657	.	C	A	5	6	11	0	0	11	0	0
8	49706428	.	T	C	1	2	3	0	0	3	0	0
8	49710686	.	G	A	12	8	20	0	1	21	0	0
8	49722313	.	T	C	4	4	8	0	0	8	0	0
8	49728659	.	T	A	8	7	15	0	2	17	0	0
8	49745727	.	T	G	1	4	5	0	1	6	0	0
8	49746224	.	T	C	6	8	14	0	2	16	0	0
8	49746256	.	G	A	8	6	14	0	2	16	0	0
8	49746440	.	T	C	21	16	37	1	4	42	0	0
8	49746456	.	T	G	21	15	36	1	2	39	0	0
8	49755801	.	A	C	11	20	31	0	2	33	0	0
8	49755867	.	A	T	17	13	30	0	1	31	0	0
8	49756121	.	A	T	14	11	25	0	2	27	0	0
8	49759453	.	A	G	6	6	12	0	1	13	0	0
8	49769213	.	T	A	1	3	4	0	0	4	0	0
8	49769237	.	G	A	2	4	6	0	0	6	0	0
8	49769496	.	G	A	8	3	11	0	2	13	0	0
8	49864531	.	G	A	1	2	3	0	3	6	0	0
8	49864973	.	T	G	1	3	4	0	0	4	0	0
8	49864985	.	A	T	1	2	3	0	0	3	0	0
8	49899621	.	G	A	1	5	6	0	0	6	0	0
8	49912682	.	G	A	1	2	3	0	0	3	0	0
8	49952260	.	C	T	1	2	3	0	0	3	0	0
8	49969037	.	C	T	7	4	11	0	0	11	0	0
8	49969135	.	G	C	0	3	3	0	6	9	0	0
8	50170889	.	T	C	3	3	6	0	0	6	0	0
8	50179868	.	T	A	2	8	10	0	1	11	0	0
8	50818102	.	G	T	2	2	4	0	0	4	0	0
8	50818180	.	C	T	8	3	11	0	1	12	0	0
8	50838854	.	G	A	2	6	8	0	0	8	0	0
8	50845104	.	T	C	3	3	6	0	0	6	0	0
8	50890422	.	A	T	4	6	10	0	1	11	0	0
8	50898126	.	C	T	1	6	7	0	8	15	0	0
8	50942296	.	T	G	5	4	9	0	1	10	0	0
8	50947386	.	G	C	12	17	29	0	0	29	0	0
8	50947648	.	T	A	7	11	18	0	1	19	0	0
8	50948620	.	A	G	4	0	4	0	17	21	0	0
8	50948623	.	T	C	6	18	24	0	0	24	0	0
8	50949040	.	T	A	9	12	21	1	4	26	0	0
8	50949086	.	T	A	4	7	11	2	0	13	0	0
8	50949128	.	T	C	12	7	19	1	0	20	0	0
8	50949160	.	A	T	10	12	22	0	0	23	1	0
8	50949188	.	C	T	7	12	19	0	0	19	0	0
8	50949430	.	T	A	20	16	36	0	3	39	0	0
8	50949479	.	A	G	17	24	41	0	1	42	0	0
8	50949501	.	A	T	28	21	49	0	1	50	0	0
8	50949570	.	G	A	20	26	46	1	4	51	0	0
8	50949573	.	G	A	26	19	45	1	1	47	0	0
8	50949639	.	C	T	20	18	38	7	1	46	0	0
8	50949766	.	C	T	11	7	18	0	0	18	0	0
8	50949903	.	A	G	25	0	25	0	24	49	0	0
8	50960443	.	C	A	11	11	22	0	0	22	0	0
8	50960542	.	T	C	12	10	22	0	2	24	0	0
8	50962536	.	T	C	13	20	33	0	1	34	0	0
8	50962623	.	T	G	16	1	17	0	15	32	0	0
8	50967774	.	C	G	2	9	11	0	0	11	0	0
8	50967890	.	C	T	2	10	12	0	1	13	0	0
8	50969141	.	T	C	0	2	2	0	2	4	0	0
8	50969150	.	A	G	1	4	5	0	0	5	0	0
8	50969367	.	G	A	7	2	9	0	0	9	0	0
8	50969493	.	T	A	3	4	7	1	0	8	0	0
8	50971524	.	G	A	2	3	5	0	0	5	0	0
8	50972267	.	C	T	5	3	8	0	1	9	0	0
8	51027069	.	C	T	1	2	3	0	0	3	0	0
8	51165572	.	T	C	11	7	18	0	3	21	0	0
8	51165786	.	C	A	0	4	4	0	11	15	0	0
8	51173843	.	A	G	5	2	7	0	0	7	0	0
8	51309145	.	T	G	5	12	17	0	0	17	0	0
8	51309311	.	A	G	4	13	17	0	1	18	0	0
8	51314087	.	G	A	12	11	23	0	0	23	0	0
8	51320547	.	C	T	7	3	10	0	2	12	0	0
8	51320652	.	C	T	4	4	8	0	0	8	0	0
8	51325510	.	T	G	6	6	12	0	0	12	0	0
8	51351121	.	C	T	14	10	24	0	0	24	0	0
8	51351155	.	T	A	6	8	14	0	0	14	0	0
8	51351200	.	A	T	6	15	21	0	0	21	0	0
8	51352480	.	A	G	10	19	29	0	0	29	0	0
8	51352525	.	A	T	16	10	26	0	4	30	0	0
8	51358769	.	G	A	18	11	29	0	1	30	0	0
8	51364515	.	T	C	6	4	10	0	1	11	0	0
8	51364644	.	C	A	0	3	3	0	8	11	0	0
8	51364665	.	T	C	8	5	13	0	1	14	0	0
8	51364696	.	C	G	8	3	11	0	0	11	0	0
8	51364713	.	C	A	1	2	3	0	4	7	0	0
8	51367206	.	C	T	2	2	4	0	0	4	0	0
8	51367217	.	C	T	4	4	8	0	0	8	0	0
8	51367267	.	A	T	4	4	8	0	0	8	0	0
8	51375405	.	T	G	4	3	7	0	1	8	0	0
8	51431321	.	T	A	8	3	11	0	0	11	0	0
8	51431396	.	C	T	0	2	2	0	3	5	0	0
8	51431412	.	A	G	5	0	5	0	0	5	0	0
8	51431468	.	A	T	2	1	3	0	0	3	0	0
8	51431477	.	G	A	1	3	4	0	0	4	0	0
8	51431526	.	A	T	1	5	6	0	0	6	0	0
8	51431561	.	A	G	1	2	3	0	0	3	0	0
8	51431805	.	T	A	3	4	7	0	0	7	0	0
8	51434330	.	C	A	0	3	3	0	1	4	0	0
8	51434357	.	C	G	1	3	4	0	0	4	0	0
8	51573293	.	A	G	1	2	3	0	1	4	0	0
8	51573346	.	C	G	1	5	6	0	0	6	0	0
8	51576856	.	C	T	0	2	2	0	5	7	0	0
8	51723249	.	A	G	2	4	6	2	0	8	0	0
8	51723320	.	A	G	2	9	11	0	2	13	0	0
8	51782044	.	A	G	3	4	7	0	0	7	0	0
8	51992393	.	C	A	5	2	7	0	1	8	0	0
8	51992501	.	G	T	12	8	20	0	0	20	0	0
8	51996707	.	A	G	10	11	21	0	1	22	0	0
8	51996727	.	A	G	10	14	24	0	1	25	0	0
8	52001776	.	C	T	2	12	14	0	11	25	0	0
8	52001785	.	A	G	12	14	26	0	1	27	0	0
8	52002903	.	C	T	1	12	13	0	13	26	0	0
8	52002945	.	T	A	10	10	20	0	2	22	0	0
8	52005582	.	A	C	8	10	18	0	0	18	0	0
8	52006139	.	C	T	1	4	5	0	6	11	0	0
8	52010799	.	T	C	7	8	15	0	1	16	0	0
8	52012737	.	T	A	3	5	8	0	1	9	0	0
8	52015712	.	G	T	2	6	8	0	0	8	0	0
8	52016041	.	G	A	5	4	9	0	0	9	0	0
8	52026501	.	G	A	1	3	4	0	0	4	0	0
8	52026702	.	C	A	2	2	4	0	0	4	0	0
8	52029978	.	C	T	0	4	4	0	1	5	0	0
8	52030109	.	A	G	1	3	4	0	0	4	0	0
8	52030116	.	G	A	1	3	4	0	0	4	0	0
8	52030185	.	G	A	1	3	4	0	0	4	0	0
8	52031962	.	A	G	2	3	5	0	0	5	0	0
8	52031965	.	A	G	1	3	4	0	0	4	0	0
8	52037800	.	A	G	1	2	3	0	0	3	0	0
8	52042891	.	T	C	1	3	4	0	1	5	0	0
8	52042893	.	G	A	2	3	5	0	0	5	0	0
8	52108329	.	T	C	4	4	8	1	2	11	0	0
8	52108373	.	T	C	4	0	4	0	4	8	0	0
8	52108512	.	T	A	1	2	3	0	0	3	0	0
8	52108533	.	G	A	2	1	3	0	0	3	0	0
8	52109581	.	A	G	3	2	5	0	0	5	0	0
8	52109686	.	T	G	4	3	7	0	0	7	0	0
8	52109689	.	T	G	4	3	7	0	1	8	0	0
8	52109730	.	T	G	5	2	7	0	0	7	0	0
8	52336870	.	T	C	1	2	3	0	0	3	0	0
8	52345733	.	T	C	2	4	6	0	0	6	0	0
8	52345751	.	T	C	2	3	5	0	1	6	0	0
8	52345915	.	T	C	4	3	7	0	2	9	0	0
8	52346035	.	T	C	1	1	2	0	1	3	0	0
8	52346072	.	A	T	1	2	3	0	1	4	0	0
8	52347642	.	A	G	1	2	3	0	0	3	0	0
8	52348575	.	A	G	4	2	6	0	0	6	0	0
8	52348576	.	A	G	3	3	6	0	0	6	0	0
8	52348685	.	T	C	4	5	9	0	0	9	0	0
8	52349080	.	T	G	8	5	13	0	1	14	0	0
8	52349544	.	A	G	6	18	24	0	1	25	0	0
8	52350101	.	A	G	17	0	17	0	8	28	3	0
8	52350146	.	A	G	12	0	12	0	13	25	0	0
8	52350251	.	A	G	12	13	25	0	2	27	0	0
8	52350322	.	T	G	7	9	16	0	0	16	0	0
8	52408619	.	G	A	22	15	37	0	2	39	0	0
8	52411451	.	T	C	12	11	23	0	2	25	0	0
8	52412982	.	A	G	9	14	23	1	1	25	0	0
8	52412985	.	C	G	9	14	23	1	0	24	0	0
8	52509624	.	G	A	1	2	3	0	0	3	0	0
8	52509762	.	A	T	1	2	3	0	0	3	0	0
8	52524436	.	A	T	3	6	9	0	1	10	0	0
8	52528585	.	A	G	4	4	8	0	1	9	0	0
8	52528607	.	A	G	2	0	2	0	4	6	0	0
8	52528665	.	A	G	6	7	13	0	2	15	0	0
8	52528717	.	A	G	6	11	17	0	2	19	0	0
8	52529123	.	C	T	3	6	9	0	0	9	0	0
8	52529206	.	T	C	10	5	15	0	0	15	0	0
8	52529235	.	G	A	9	5	14	0	2	16	0	0
8	52529397	.	A	G	10	13	23	0	0	23	0	0
8	52538056	.	G	A	0	2	2	0	2	4	0	0
8	52538062	.	G	A	0	2	2	0	2	4	0	0
8	52547038	.	T	G	8	7	15	1	0	16	0	0
8	52547091	.	T	C	3	5	8	0	1	9	0	0
8	52547356	.	A	G	9	5	14	1	0	15	0	0
8	52547519	.	C	G	3	1	4	0	10	14	0	0
8	52547569	.	T	A	3	6	9	0	1	10	0	0
8	52547664	.	A	C	2	3	5	0	0	5	0	0
8	52547727	.	G	C	2	3	5	0	0	5	0	0
8	52547829	.	T	G	1	3	4	0	0	4	0	0
8	52550462	.	A	G	2	4	6	0	0	6	0	0
8	52553162	.	G	A	7	10	17	0	0	17	0	0
8	52553193	.	A	T	4	4	8	0	5	13	0	0
8	52553197	.	A	G	4	8	12	0	0	12	0	0
8	52555050	.	G	A	5	13	18	0	1	19	0	0
8	52555077	.	C	G	6	15	21	0	0	21	0	0
8	52555137	.	G	A	5	8	13	0	0	13	0	0
8	52557454	.	G	T	3	4	7	0	0	7	0	0
8	52559996	.	G	T	4	2	6	0	0	6	0	0
8	52560034	.	T	C	6	6	12	0	1	13	0	0
8	52560058	.	T	C	8	4	12	0	1	13	0	0
8	52561397	.	C	T	9	4	13	0	1	14	0	0
8	52561421	.	C	A	8	5	13	0	0	13	0	0
8	52563316	.	T	G	1	5	6	0	0	6	0	0
8	52563364	.	C	T	3	4	7	0	0	7	0	0
8	52563427	.	C	T	0	4	4	0	7	11	0	0
8	52565222	.	C	A	3	7	10	0	0	10	0	0
8	52584246	.	T	A	3	2	5	0	1	6	0	0
8	52584249	.	A	T	3	1	4	0	2	6	0	0
8	52602546	.	G	A	1	2	3	0	3	6	0	0
8	52630849	.	A	G	2	3	5	0	0	5	0	0
8	52630866	.	T	C	3	3	6	0	0	6	0	0
8	52713677	.	T	G	44	23	67	0	0	67	0	0
8	52713776	.	G	A	36	25	61	0	2	63	0	0
8	52713932	.	G	A	39	23	62	0	3	65	0	0
8	52713974	.	A	G	42	19	61	0	6	67	0	0
8	52713989	.	G	A	36	21	57	0	3	60	0	0
8	52714343	.	T	G	25	15	40	0	1	41	0	0
8	52715821	.	C	T	12	12	24	0	1	25	0	0
8	53147465	.	T	A	1	3	4	0	0	4	0	0
8	53148951	.	T	C	1	3	4	0	1	5	0	0
8	53148976	.	T	C	1	4	5	0	1	6	0	0
8	53260420	.	A	G	0	3	3	0	2	5	0	0
8	53401230	.	C	A	1	3	4	3	2	9	0	0
8	54221390	.	T	C	13	10	23	0	8	31	0	0
8	54303407	.	A	G	26	23	49	0	2	51	0	0
9	134999	.	C	T	0	3	3	0	1	4	0	0
9	234328	.	G	A	1	5	6	0	0	6	0	0
9	263664	.	A	C	15	0	15	0	35	50	0	0
9	265991	.	C	T	2	2	4	0	0	4	0	0
9	266875	.	T	C	28	9	37	0	1	38	0	0
9	355324	.	A	G	1	5	6	0	0	6	0	0
9	462959	.	T	G	11	3	14	0	1	15	0	0
9	529675	.	A	G	6	3	9	0	0	9	0	0
9	529692	.	A	G	4	2	6	0	0	6	0	0
9	529824	.	C	A	2	6	8	0	0	8	0	0
9	529849	.	G	A	1	8	9	0	2	11	0	0
9	529957	.	C	T	4	2	6	0	0	6	0	0
9	531182	.	C	T	2	3	5	0	0	5	0	0
9	531226	.	C	T	3	3	6	0	0	6	0	0
9	531629	.	G	A	2	7	9	0	0	9	0	0
9	585887	.	A	G	1	2	3	0	0	3	0	0
9	701934	.	T	C	3	2	5	0	0	5	0	0
9	704662	.	T	A	9	3	12	0	1	13	0	0
9	707558	.	T	C	1	2	3	0	0	3	0	0
9	708075	.	T	C	34	0	34	0	27	61	0	0
9	712883	.	C	T	6	2	8	1	0	9	0	0
9	712898	.	T	C	10	5	15	2	1	18	0	0
9	716225	.	A	G	9	10	19	0	0	19	0	0
9	717849	.	T	C	15	6	21	0	1	22	0	0
9	719825	.	A	G	7	6	13	0	2	15	0	0
9	723428	.	T	A	11	4	15	0	0	15	0	0
9	724664	.	G	C	13	3	16	0	0	16	0	0
9	724670	.	A	C	12	4	16	0	1	17	0	0
9	732227	.	C	T	4	3	7	0	0	7	0	0
9	734643	.	T	G	2	4	6	0	0	6	0	0
9	746071	.	T	C	0	3	3	0	1	4	0	0
9	748018	.	T	C	1	5	6	0	1	7	0	0
9	751441	.	A	G	2	2	4	0	0	4	0	0
9	781983	.	G	C	3	3	6	0	1	7	0	0
9	881678	.	A	T	4	3	7	0	0	7	0	0
9	881735	.	A	T	3	1	4	0	2	6	0	0
9	881999	.	C	T	15	5	20	0	0	20	0	0
9	882143	.	T	C	3	0	3	0	5	8	0	0
9	884904	.	C	T	2	3	5	0	0	5	0	0
9	900592	.	G	A	1	6	7	0	0	7	0	0
9	901137	.	A	G	8	12	20	1	0	21	0	0
9	902265	.	T	C	7	0	7	0	10	17	0	0
9	902877	.	A	G	7	9	16	0	0	16	0	0
9	904118	.	A	T	3	4	7	0	1	8	0	0
9	907564	.	A	G	16	20	36	0	2	38	0	0
9	910882	.	C	T	27	23	50	0	2	52	0	0
9	913874	.	T	C	32	28	60	0	5	65	0	0
9	913882	.	C	T	32	34	66	0	0	66	0	0
9	913909	.	G	A	5	32	37	0	20	57	0	0
9	914190	.	C	T	1	4	5	0	0	5	0	0
9	914282	.	A	G	4	3	7	0	0	7	0	0
9	914291	.	T	C	4	2	6	0	0	6	0	0
9	914445	.	T	C	7	5	12	0	1	13	0	0
9	914506	.	C	A	2	4	6	0	0	6	0	0
9	914507	.	C	T	2	4	6	0	0	6	0	0
9	914616	.	C	G	8	4	12	0	0	12	0	0
9	914675	.	C	T	9	5	14	2	0	16	0	0
9	914702	.	A	T	11	4	15	2	0	17	0	0
9	1373000	.	A	G	2	4	6	0	2	8	0	0
9	1373409	.	G	T	3	2	5	0	0	5	0	0
9	1376405	.	C	A	1	3	4	0	0	4	0	0
9	1376413	.	C	A	1	3	4	0	0	4	0	0
9	1463287	.	T	C	4	4	8	0	0	8	0	0
9	1469002	.	T	C	2	3	5	0	0	5	0	0
9	1479215	.	G	A	1	2	3	0	0	3	0	0
9	1479254	.	C	T	0	4	4	0	2	6	0	0
9	1479290	.	G	T	2	3	5	0	0	5	0	0
9	1576074	.	T	C	1	3	4	0	0	4	0	0
9	1579792	.	T	C	8	5	13	0	0	13	0	0
9	1644303	.	C	A	5	3	8	0	0	8	0	0
9	1644349	.	T	C	8	4	12	0	1	13	0	0
9	1644531	.	C	T	2	2	4	0	0	4	0	0
9	1644564	.	T	G	2	2	4	0	0	4	0	0
9	1673601	.	C	T	2	2	4	0	0	4	0	0
9	1682647	.	A	T	6	2	8	1	0	9	0	0
9	1682740	.	G	C	1	9	10	0	12	22	0	0
9	1693082	.	A	C	20	10	30	0	0	30	0	0
9	1693092	.	G	A	18	9	27	0	0	27	0	0
9	1693443	.	G	A	17	8	25	0	0	25	0	0
9	1693494	.	T	G	19	9	28	0	0	28	0	0
9	1693585	.	C	T	2	4	6	0	8	14	0	0
9	1694277	.	A	G	12	6	18	0	2	20	0	0
9	2006875	.	A	G	1	0	1	1	4	6	0	0
9	2045125	.	T	G	4	3	7	0	0	7	0	0
9	2045265	.	G	A	5	3	8	0	1	9	0	0
9	2334164	.	C	T	9	10	19	1	0	20	0	0
9	2336682	.	A	G	22	1	23	0	10	33	0	0
9	2337291	.	C	T	18	21	39	0	0	39	0	0
9	2340561	.	G	A	19	11	30	1	2	33	0	0
9	2340564	.	G	A	19	10	29	1	3	33	0	0
9	2340618	.	C	T	28	16	44	0	3	47	0	0
9	2340776	.	C	T	36	33	69	0	7	76	0	0
9	2340957	.	T	A	20	14	34	1	3	38	0	0
9	2423047	.	C	T	3	4	7	0	0	7	0	0
9	2423119	.	C	T	1	3	4	0	0	4	0	0
9	2452697	.	T	C	5	9	14	0	0	14	0	0
9	2483525	.	A	G	4	5	9	0	0	9	0	0
9	2557621	.	A	G	3	2	5	0	0	5	0	0
9	2558355	.	G	T	1	3	4	0	0	4	0	0
9	2559047	.	G	A	2	3	5	0	1	6	0	0
9	2559080	.	A	T	2	2	4	0	1	5	0	0
9	2559138	.	C	T	3	2	5	0	0	5	0	0
9	2559177	.	C	T	7	5	12	1	1	14	0	0
9	2559204	.	C	T	5	11	16	1	1	18	0	0
9	2559566	.	C	A	3	5	8	0	0	8	0	0
9	2559587	.	G	C	0	2	2	0	3	5	0	0
9	2559792	.	G	A	1	3	4	0	0	4	0	0
9	2559912	.	A	C	2	9	11	0	2	13	0	0
9	2560765	.	C	T	1	4	5	0	0	5	0	0
9	2561162	.	T	G	3	3	6	0	0	6	0	0
9	2561182	.	A	G	3	3	6	0	0	6	0	0
9	2561205	.	G	T	3	4	7	0	1	8	0	0
9	2561254	.	C	T	0	3	3	0	2	5	0	0
9	2561383	.	C	A	1	1	2	0	0	2	0	0
9	2561604	.	C	T	17	13	30	0	2	32	0	0
9	2561632	.	A	T	19	16	35	0	1	36	0	0
9	2564178	.	C	A	15	13	28	0	4	32	0	0
9	2564699	.	A	G	8	6	14	0	0	14	0	0
9	2564788	.	A	T	8	11	19	0	1	20	0	0
9	2567323	.	G	A	11	9	20	0	0	20	0	0
9	2568670	.	T	A	14	4	18	0	2	20	0	0
9	2568768	.	G	T	15	4	19	0	0	19	0	0
9	2568777	.	C	T	4	16	20	0	0	20	0	0
9	2569372	.	T	G	6	6	12	0	0	12	0	0
9	2572316	.	G	A	10	4	14	0	1	15	0	0
9	2574159	.	T	C	3	3	6	0	0	6	0	0
9	2574225	.	T	C	4	5	9	0	0	9	0	0
9	2574227	.	A	G	4	5	9	0	0	9	0	0
9	2576099	.	T	C	2	3	5	0	0	5	0	0
9	2579867	.	C	T	3	5	8	0	0	8	0	0
9	2582003	.	G	A	3	2	5	0	0	5	0	0
9	2592246	.	C	T	13	14	27	0	3	30	0	0
9	2592933	.	T	C	7	7	14	0	1	15	0	0
9	2592984	.	C	A	0	4	4	0	2	6	0	0
9	3135171	.	T	C	4	0	4	0	8	12	0	0
9	3135794	.	A	G	7	2	9	0	1	10	0	0
9	3135809	.	A	G	7	3	10	0	0	10	0	0
9	3136107	.	C	T	0	8	8	0	5	13	0	0
9	3231242	.	C	T	1	2	3	0	0	3	0	0
9	3231378	.	C	A	0	6	6	0	0	6	0	0
9	3231746	.	C	A	2	2	4	0	0	4	0	0
9	3232180	.	T	A	3	5	8	0	0	8	0	0
9	3232198	.	C	T	3	4	7	0	0	7	0	0
9	3232523	.	T	G	8	6	14	0	2	16	0	0
9	3232607	.	T	A	4	5	9	0	1	10	0	0
9	3232672	.	C	T	3	6	9	0	0	9	0	0
9	3232763	.	T	C	4	5	9	0	0	9	0	0
9	3232808	.	A	T	1	5	6	0	0	6	0	0
9	3232818	.	T	G	2	0	2	0	6	8	0	0
9	3232949	.	A	G	5	7	12	0	1	13	0	0
9	3284007	.	G	C	1	2	3	0	3	6	0	0
9	3286386	.	G	A	1	3	4	0	1	5	0	0
9	3313920	.	G	T	16	11	27	0	1	28	0	0
9	3388974	.	C	T	1	2	3	0	1	4	0	0
9	3389545	.	G	A	1	3	4	0	1	5	0	0
9	3389921	.	A	G	9	0	9	0	8	17	0	0
9	3390035	.	G	A	11	5	16	0	0	16	0	0
9	3398243	.	T	A	8	3	11	0	1	12	0	0
9	3398247	.	G	A	9	3	12	0	0	12	0	0
9	3398328	.	C	A	1	7	8	0	4	12	0	0
9	3398354	.	T	C	2	0	2	0	8	10	0	0
9	3400331	.	A	G	1	2	3	0	0	3	0	0
9	3466114	.	G	A	0	2	2	0	1	3	0	0
9	3474856	.	T	C	1	5	6	0	0	6	0	0
9	3477113	.	T	G	3	3	6	0	0	6	0	0
9	3480057	.	A	G	3	11	14	0	1	15	0	0
9	3480076	.	C	T	3	7	10	0	0	10	0	0
9	3483164	.	T	C	3	9	12	0	2	14	0	0
9	3485822	.	G	A	0	6	6	0	6	12	0	0
9	3485867	.	A	T	1	6	7	0	0	7	0	0
9	3485868	.	T	C	1	6	7	0	0	7	0	0
9	3486134	.	T	G	7	6	13	0	0	13	0	0
9	3486220	.	C	T	2	3	5	0	0	5	0	0
9	3486223	.	C	T	2	2	4	0	0	4	0	0
9	3499266	.	G	T	1	2	3	0	0	3	0	0
9	3501269	.	A	G	1	2	3	0	0	3	0	0
9	3503954	.	G	A	1	2	3	0	0	3	0	0
9	3524316	.	C	T	2	2	4	0	0	4	0	0
9	3532562	.	C	A	3	2	5	0	0	5	0	0
9	3534748	.	G	A	2	2	4	0	1	5	0	0
9	3535012	.	T	A	2	2	4	0	0	4	0	0
9	3605652	.	C	T	11	8	19	0	1	20	0	0
9	3605682	.	A	G	11	0	11	0	12	23	0	0
9	3608867	.	T	A	13	8	21	0	0	21	0	0
9	3627189	.	T	C	1	4	5	0	0	6	1	0
9	3666458	.	G	A	2	2	4	0	0	4	0	0
9	3666469	.	C	T	3	6	9	0	0	9	0	0
9	3666494	.	C	T	4	10	14	0	1	15	0	0
9	3666511	.	A	G	11	12	23	0	1	24	0	0
9	3666541	.	A	C	15	13	28	0	2	30	0	0
9	3666601	.	A	T	15	10	25	0	2	27	0	0
9	3666666	.	T	C	6	19	25	0	2	27	0	0
9	3667136	.	G	A	12	4	16	0	3	19	0	0
9	3667338	.	T	A	12	10	22	0	1	23	0	0
9	3667377	.	C	A	8	7	15	0	1	16	0	0
9	3667398	.	C	A	6	8	14	0	1	15	0	0
9	3667459	.	C	T	5	6	11	0	0	11	0	0
9	3667496	.	C	T	7	3	10	0	0	10	0	0
9	3667497	.	T	G	5	3	8	0	0	10	2	0
9	3667572	.	A	C	5	2	7	1	1	9	0	0
9	3667575	.	T	C	5	2	7	1	0	8	0	0
9	3755708	.	G	A	2	1	3	0	1	4	0	0
9	3898275	.	T	C	2	6	8	0	0	8	0	0
9	3898276	.	T	C	2	1	3	0	5	8	0	0
9	3900878	.	T	A	6	2	8	0	2	10	0	0
9	3901007	.	A	T	2	3	5	0	0	5	0	0
9	3901081	.	C	T	2	4	6	0	0	6	0	0
9	3901187	.	T	A	5	4	9	0	2	11	0	0
9	3905921	.	G	A	4	3	7	0	0	7	0	0
9	4332223	.	C	T	4	2	6	0	0	6	0	0
9	4333299	.	C	T	1	4	5	0	1	6	0	0
9	4336543	.	A	G	2	6	8	0	0	8	0	0
9	4344553	.	C	T	4	2	6	0	1	7	0	0
9	5893831	.	G	A	2	1	3	0	0	3	0	0
9	5893837	.	T	C	2	2	4	0	0	4	0	0
9	5904957	.	G	A	1	2	3	0	0	3	0	0
9	5911943	.	G	A	1	2	3	0	0	3	0	0
9	6009282	.	C	T	1	3	4	0	1	5	0	0
9	6109544	.	A	G	5	3	8	0	0	8	0	0
9	6118842	.	G	A	1	4	5	0	0	5	0	0
9	6123441	.	G	A	6	9	15	0	0	15	0	0
9	6123490	.	G	T	3	6	9	0	1	10	0	0
9	6123742	.	A	C	3	3	6	0	0	6	0	0
9	6124057	.	G	A	0	5	5	0	1	6	0	0
9	6124100	.	T	C	3	3	6	0	0	6	0	0
9	6124393	.	C	T	2	2	4	0	0	4	0	0
9	6124478	.	G	A	4	3	7	0	1	8	0	0
9	6124759	.	T	A	6	7	13	0	2	15	0	0
9	6124761	.	T	G	8	5	13	0	0	13	0	0
9	6124884	.	T	C	8	4	12	0	1	13	0	0
9	6125501	.	A	C	1	2	3	0	1	4	0	0
9	6125761	.	G	T	2	2	4	0	1	5	0	0
9	6125859	.	T	A	3	14	17	1	0	18	0	0
9	6126288	.	A	C	7	9	16	0	2	18	0	0
9	6126410	.	G	A	15	9	24	0	6	30	0	0
9	6126469	.	G	A	14	13	27	0	2	29	0	0
9	6126781	.	T	G	18	10	28	1	1	30	0	0
9	6126900	.	C	T	17	14	31	0	0	31	0	0
9	6126911	.	C	A	14	12	26	0	0	26	0	0
9	6127075	.	G	A	3	21	24	0	27	51	0	0
9	6127346	.	C	A	18	8	26	0	2	28	0	0
9	6127357	.	C	T	14	14	28	0	0	28	0	0
9	6362976	.	G	A	5	7	12	0	1	13	0	0
9	6395548	.	T	C	5	0	5	0	9	14	0	0
9	6395679	.	C	G	13	20	33	0	0	33	0	0
9	6395713	.	G	A	11	14	25	0	3	28	0	0
9	6395792	.	T	A	15	11	26	0	0	26	0	0
9	6395859	.	G	A	9	4	13	0	0	13	0	0
9	6396181	.	G	A	6	10	16	0	1	17	0	0
9	6396235	.	A	G	7	8	15	0	2	17	0	0
9	6396242	.	G	A	8	9	17	0	1	18	0	0
9	6399592	.	C	T	1	2	3	0	7	10	0	0
9	6399610	.	A	G	7	6	13	0	1	14	0	0
9	6399762	.	C	T	5	2	7	0	0	7	0	0
9	6399784	.	A	G	1	5	6	0	0	6	0	0
9	6400240	.	C	T	1	2	3	0	1	4	0	0
9	6415385	.	G	A	3	4	7	0	0	7	0	0
9	7092403	.	T	C	10	1	11	1	7	19	0	0
9	7092424	.	T	C	10	6	16	0	2	18	0	0
9	7092457	.	T	C	14	5	19	0	1	20	0	0
9	7093825	.	T	C	5	2	7	0	1	8	0	0
9	7094141	.	T	C	9	4	13	0	0	13	0	0
9	7094211	.	T	C	7	3	10	0	0	10	0	0
9	7094898	.	T	C	7	7	14	0	0	14	0	0
9	7228805	.	T	A	4	5	9	0	0	9	0	0
9	9670634	.	T	C	1	2	3	0	0	3	0	0
9	9736493	.	T	C	3	13	16	0	1	17	0	0
9	10154490	.	A	T	0	5	5	0	1	6	0	0
9	11598044	.	G	A	4	2	6	0	0	6	0	0
9	11907497	.	G	A	1	4	5	0	0	5	0	0
9	12866399	.	G	A	1	5	6	0	0	6	0	0
9	16849920	.	G	A	1	2	3	0	0	3	0	0
9	16867634	.	C	T	1	2	3	0	0	3	0	0
9	16867646	.	G	A	1	2	3	0	0	3	0	0
9	16867806	.	A	G	3	2	5	0	0	5	0	0
9	16867909	.	A	G	5	6	11	0	0	11	0	0
9	16868233	.	A	G	2	3	5	0	0	5	0	0
9	16868242	.	G	A	3	3	6	0	0	6	0	0
9	16877408	.	G	A	1	2	3	0	0	3	0	0
9	17046020	.	T	C	25	24	49	1	3	53	0	0
9	17046736	.	A	G	16	22	38	0	1	39	0	0
9	17047014	.	A	G	23	11	34	3	3	40	0	0
9	17057365	.	T	C	10	11	21	0	5	26	0	0
9	17060311	.	G	A	4	5	9	0	3	12	0	0
9	17067934	.	C	T	5	8	13	0	0	13	0	0
9	17068057	.	T	G	11	7	18	0	0	18	0	0
9	17073498	.	T	C	8	5	13	0	1	14	0	0
9	17074714	.	T	C	5	2	7	0	1	8	0	0
9	17074720	.	T	C	6	4	10	0	0	10	0	0
9	17074792	.	G	A	4	6	10	0	0	10	0	0
9	17077376	.	A	G	3	3	6	0	0	6	0	0
9	17077430	.	C	T	0	3	3	0	2	5	0	0
9	17077439	.	A	G	1	4	5	0	1	6	0	0
9	17080224	.	G	T	2	2	4	0	1	5	0	0
9	17080517	.	G	A	2	3	5	0	0	5	0	0
9	17080970	.	A	G	1	7	8	0	0	8	0	0
9	17082273	.	A	T	4	5	9	0	0	9	0	0
9	17083908	.	T	C	1	0	1	0	3	4	0	0
9	17349073	.	T	C	1	2	3	0	0	3	0	0
9	17364337	.	C	G	5	4	9	1	0	10	0	0
9	17365231	.	G	A	4	4	8	0	1	9	0	0
9	17368889	.	A	C	5	6	11	0	1	12	0	0
9	17368904	.	C	T	5	7	12	0	0	12	0	0
9	17369071	.	G	A	7	6	13	0	0	13	0	0
9	17378203	.	A	G	8	10	18	0	1	19	0	0
9	17379954	.	C	T	8	13	21	0	2	23	0	0
9	17386152	.	C	A	10	5	15	0	0	15	0	0
9	17386154	.	C	T	9	5	14	0	1	15	0	0
9	17386338	.	A	G	6	0	6	0	5	11	0	0
9	17386341	.	G	T	6	5	11	0	0	11	0	0
9	17431709	.	T	A	1	2	3	0	0	3	0	0
9	17431720	.	A	G	1	2	3	0	0	3	0	0
9	17431798	.	A	G	2	2	4	0	1	5	0	0
9	17431818	.	C	T	2	3	5	0	0	5	0	0
9	17432155	.	C	T	2	5	7	0	0	7	0	0
9	17432170	.	T	C	2	5	7	0	0	7	0	0
9	17432297	.	G	T	3	4	7	0	0	7	0	0
9	17432484	.	C	A	3	2	5	0	1	6	0	0
9	17433483	.	A	G	4	0	4	0	2	9	3	0
9	17433794	.	G	C	3	8	11	0	0	11	0	0
9	17433983	.	T	G	3	7	10	0	0	10	0	0
9	17434082	.	A	G	1	3	4	0	0	4	0	0
9	17445217	.	A	G	2	4	6	0	1	7	0	0
9	17445268	.	T	C	5	13	18	0	0	18	0	0
9	17540692	.	A	C	1	4	5	0	1	6	0	0
9	17560343	.	A	G	4	2	6	0	0	6	0	0
9	17987998	.	A	G	2	5	7	0	0	7	0	0
9	17988011	.	C	A	2	4	6	0	0	6	0	0
9	17988072	.	A	C	1	3	4	0	0	4	0	0
9	17988091	.	A	G	1	3	4	0	0	4	0	0
9	18001161	.	T	G	6	6	12	0	1	13	0	0
9	18001200	.	A	C	3	5	8	0	0	8	0	0
9	18003664	.	T	C	5	15	20	0	1	21	0	0
9	18003684	.	C	G	5	14	19	0	0	19	0	0
9	18003807	.	C	T	9	9	18	0	1	19	0	0
9	18003856	.	T	G	15	0	15	0	10	25	0	0
9	18004476	.	A	C	17	5	22	1	4	27	0	0
9	18005023	.	C	T	14	15	29	0	2	31	0	0
9	18005065	.	C	T	19	12	31	0	1	33	1	0
9	18005217	.	A	T	3	6	9	0	1	10	0	0
9	18005245	.	T	C	8	7	15	0	2	17	0	0
9	18005507	.	C	T	5	7	12	0	0	12	0	0
9	18005806	.	A	G	12	8	20	0	0	20	0	0
9	18005864	.	G	A	12	17	29	0	5	34	0	0
9	18005879	.	T	A	13	18	31	0	3	34	0	0
9	18005977	.	T	C	15	18	33	0	0	33	0	0
9	18006144	.	T	A	16	17	33	0	7	40	0	0
9	18006282	.	C	T	28	25	53	0	4	57	0	0
9	18229592	.	A	G	3	0	3	0	5	8	0	0
9	18235383	.	A	G	7	3	10	0	0	10	0	0
9	18310309	.	G	A	7	8	15	0	1	16	0	0
9	18320009	.	G	A	15	8	23	0	2	25	0	0
9	18333107	.	A	G	13	11	24	0	1	25	0	0
9	18390631	.	T	C	1	2	3	0	0	3	0	0
9	18392777	.	T	G	6	4	10	0	0	10	0	0
9	18392903	.	C	A	3	4	7	0	1	8	0	0
9	18392924	.	G	A	3	4	7	0	0	7	0	0
9	18568860	.	C	T	0	3	3	0	5	8	0	0
9	18721152	.	A	G	9	15	24	0	0	24	0	0
9	18732543	.	T	A	10	5	15	0	0	15	0	0
9	18732878	.	C	T	3	27	30	0	26	56	0	0
9	18732899	.	G	A	31	23	54	0	3	57	0	0
9	18733592	.	T	C	33	2	35	0	32	67	0	0
9	18735081	.	A	G	20	14	34	0	0	34	0	0
9	18812765	.	A	G	5	5	10	0	0	10	0	0
9	18812960	.	A	G	4	5	9	0	0	9	0	0
9	18814598	.	T	C	2	2	4	0	0	4	0	0
9	18876332	.	A	T	28	15	43	0	4	47	0	0
9	18876545	.	G	T	17	20	37	0	1	38	0	0
9	18876937	.	C	G	1	18	19	0	16	35	0	0
9	18877051	.	G	A	12	12	24	0	1	25	0	0
9	18877078	.	G	A	16	8	24	0	3	27	0	0
9	18877485	.	T	C	8	0	8	0	5	13	0	0
9	18909235	.	A	T	11	5	16	0	0	16	0	0
9	18909242	.	A	T	9	7	16	0	1	17	0	0
9	18909748	.	A	C	2	5	7	0	0	7	0	0
9	18911575	.	G	A	3	7	10	0	0	10	0	0
9	19027491	.	A	G	1	3	4	0	0	4	0	0
9	19027536	.	T	A	5	6	11	0	0	11	0	0
9	19027560	.	G	C	5	6	11	0	0	11	0	0
9	19027582	.	A	T	4	3	7	0	1	8	0	0
9	19027630	.	T	A	4	2	6	0	1	7	0	0
9	19027637	.	G	T	5	3	8	0	0	8	0	0
9	19074628	.	T	C	4	4	8	0	0	8	0	0
9	19074642	.	G	T	5	4	9	0	0	9	0	0
9	19074687	.	G	A	4	2	6	0	0	6	0	0
9	19074800	.	A	G	1	3	4	0	0	4	0	0
9	19074840	.	A	G	2	3	5	0	0	5	0	0
9	19109043	.	C	T	3	2	5	0	0	5	0	0
9	19118853	.	T	C	5	10	15	0	0	15	0	0
9	19118903	.	T	G	3	0	3	0	9	12	0	0
9	19118929	.	G	A	2	10	12	0	0	12	0	0
9	19119185	.	T	C	1	10	11	0	1	12	0	0
9	19119214	.	A	G	4	12	16	0	0	16	0	0
9	19119285	.	T	C	3	9	12	0	0	12	0	0
9	19307064	.	C	T	4	2	6	0	0	6	0	0
9	19407614	.	G	T	1	2	3	0	2	5	0	0
9	19408248	.	A	G	7	4	11	0	0	11	0	0
9	19408327	.	C	G	8	3	11	0	0	11	0	0
9	19408345	.	G	A	8	5	13	0	0	13	0	0
9	19442787	.	T	C	1	2	3	0	0	3	0	0
9	19471377	.	A	G	4	12	16	0	1	17	0	0
9	19477856	.	A	G	2	2	4	0	0	4	0	0
9	19477882	.	T	G	4	3	7	0	0	7	0	0
9	19480893	.	T	C	3	4	7	0	0	7	0	0
9	19490058	.	G	C	17	6	23	0	1	24	0	0
9	19504678	.	C	T	21	13	34	0	1	35	0	0
9	19510730	.	T	G	11	12	23	0	0	23	0	0
9	19510773	.	A	G	5	13	18	0	3	21	0	0
9	19510887	.	T	C	6	4	10	0	0	10	0	0
9	19518690	.	A	T	2	4	6	0	0	6	0	0
9	19527883	.	T	C	14	20	34	0	0	34	0	0
9	19539840	.	T	C	6	4	10	1	0	11	0	0
9	19545511	.	T	G	2	2	4	0	0	4	0	0
9	19545529	.	T	C	2	2	4	0	0	4	0	0
9	19545550	.	T	C	4	2	6	0	0	6	0	0
9	19549346	.	A	G	7	0	7	0	9	16	0	0
9	19549349	.	G	C	8	7	15	0	0	15	0	0
9	19549620	.	C	T	3	5	8	0	2	10	0	0
9	19549868	.	A	T	5	2	7	0	0	7	0	0
9	19549958	.	C	A	4	6	10	0	0	10	0	0
9	19549989	.	G	A	6	4	10	0	1	11	0	0
9	19636514	.	G	A	1	2	3	0	1	4	0	0
9	19641135	.	A	T	3	4	7	0	0	7	0	0
9	19641138	.	C	A	3	4	7	0	0	7	0	0
9	19646511	.	A	G	5	6	11	0	0	11	0	0
9	19648173	.	A	G	5	7	12	0	0	12	0	0
9	19648295	.	T	C	7	5	12	0	0	12	0	0
9	19652691	.	A	C	13	9	22	0	0	22	0	0
9	19692953	.	A	C	1	2	3	0	1	4	0	0
9	19693865	.	T	A	1	2	3	0	0	3	0	0
9	20076691	.	G	C	6	2	8	0	1	9	0	0
9	20076913	.	T	C	4	0	4	0	5	9	0	0
9	20078034	.	G	A	2	4	6	0	0	6	0	0
9	20160387	.	C	T	1	2	3	0	0	3	0	0
9	20500337	.	A	C	2	1	3	0	0	3	0	0
9	20500347	.	G	A	3	1	4	0	2	6	0	0
9	20623998	.	G	A	3	2	5	0	1	6	0	0
9	20763517	.	C	T	5	7	12	0	0	12	0	0
9	20763564	.	C	T	13	8	21	0	0	21	0	0
9	20763585	.	C	T	13	12	25	0	0	25	0	0
9	20763877	.	C	T	9	5	14	0	1	15	0	0
9	20763907	.	A	T	9	5	14	0	0	14	0	0
9	20764019	.	T	A	10	9	19	0	0	19	0	0
9	20764276	.	A	G	15	1	16	0	8	24	0	0
9	20764468	.	C	T	9	10	19	0	7	26	0	0
9	20764685	.	C	T	19	12	31	0	0	31	0	0
9	20765065	.	T	A	21	3	24	0	0	24	0	0
9	20765104	.	A	G	14	5	19	0	0	19	0	0
9	20765193	.	A	G	10	21	31	0	1	32	0	0
9	20765280	.	G	T	1	3	4	0	0	4	0	0
9	20806648	.	A	T	9	4	13	0	0	13	0	0
9	20806657	.	A	G	9	4	13	0	0	13	0	0
9	20806925	.	C	T	7	4	11	0	1	12	0	0
9	20806942	.	C	T	6	4	10	0	1	11	0	0
9	20807171	.	C	T	5	3	8	0	0	8	0	0
9	20807216	.	T	C	4	0	4	0	4	8	0	0
9	20826146	.	T	C	3	1	4	0	7	11	0	0
9	20846506	.	A	G	1	2	3	0	0	3	0	0
9	20860161	.	G	C	1	3	4	0	0	4	0	0
9	20863342	.	T	C	2	2	4	0	0	4	0	0
9	20868978	.	T	A	5	3	8	0	0	8	0	0
9	20869156	.	G	T	1	3	4	0	0	4	0	0
9	20870779	.	T	C	2	7	9	0	0	9	0	0
9	20872523	.	C	T	1	1	2	0	1	3	0	0
9	21072922	.	T	C	3	7	10	0	1	11	0	0
9	21084894	.	G	C	1	3	4	0	0	4	0	0
9	21204063	.	T	G	2	3	5	0	0	5	0	0
9	21204244	.	T	G	6	10	16	0	1	17	0	0
9	21205138	.	A	G	4	2	6	0	0	6	0	0
9	21216897	.	T	C	2	4	6	0	0	6	0	0
9	21216898	.	T	C	2	4	6	0	0	6	0	0
9	21217438	.	A	G	2	3	5	0	0	5	0	0
9	21221874	.	G	A	3	7	10	0	0	10	0	0
9	21221932	.	T	A	6	8	14	0	0	14	0	0
9	21222749	.	G	A	2	9	11	0	5	16	0	0
9	21222750	.	T	A	7	9	16	0	0	16	0	0
9	21222807	.	G	A	1	9	10	0	7	17	0	0
9	21224671	.	A	C	2	4	6	0	0	6	0	0
9	21224703	.	T	C	3	6	9	0	0	9	0	0
9	21224753	.	G	A	3	11	14	0	0	14	0	0
9	21224768	.	T	G	2	12	14	0	0	14	0	0
9	21224963	.	T	C	3	7	10	0	1	11	0	0
9	21225011	.	C	A	2	6	8	0	0	8	0	0
9	21225256	.	A	G	4	2	6	0	0	6	0	0
9	21225461	.	C	A	2	4	6	0	0	6	0	0
9	21225503	.	G	T	0	2	2	0	3	5	0	0
9	21225550	.	G	A	2	3	5	0	0	5	0	0
9	21225987	.	C	A	6	7	13	0	0	13	0	0
9	21235770	.	A	T	10	7	17	0	0	17	0	0
9	21236049	.	G	C	1	4	5	0	0	5	0	0
9	21266854	.	A	G	10	16	26	0	0	26	0	0
9	21266878	.	C	T	1	12	13	0	16	29	0	0
9	21267097	.	T	A	24	24	48	0	0	48	0	0
9	21267133	.	C	T	20	20	40	0	3	43	0	0
9	21273348	.	C	A	5	4	9	0	0	9	0	0
9	21356621	.	G	A	0	4	4	0	6	10	0	0
9	21357172	.	A	C	8	8	16	0	0	16	0	0
9	21357501	.	T	C	3	2	5	0	1	6	0	0
9	21357526	.	A	C	6	2	8	0	2	10	0	0
9	21361507	.	C	T	3	2	5	0	0	5	0	0
9	21362858	.	A	G	3	2	5	0	0	5	0	0
9	21363323	.	T	C	6	4	10	0	0	10	0	0
9	21365805	.	A	T	1	2	3	0	0	3	0	0
9	21366340	.	G	A	10	20	30	1	1	32	0	0
9	21366346	.	A	G	10	20	30	1	0	31	0	0
9	21369378	.	T	C	5	11	16	0	1	17	0	0
9	21374039	.	G	A	16	13	29	0	0	29	0	0
9	21374336	.	G	A	14	11	25	0	0	25	0	0
9	21374354	.	A	C	12	10	22	0	1	23	0	0
9	21375928	.	G	A	7	4	11	0	1	12	0	0
9	21375997	.	G	A	2	3	5	0	0	5	0	0
9	21376217	.	C	T	4	4	8	0	0	8	0	0
9	21376279	.	G	A	11	4	15	0	0	15	0	0
9	21376280	.	A	G	11	3	14	0	1	15	0	0
9	21377476	.	A	G	4	7	11	0	0	11	0	0
9	21385956	.	A	G	3	0	3	0	2	5	0	0
9	21391949	.	C	T	3	4	7	0	0	7	0	0
9	21399284	.	A	C	4	6	10	0	0	10	0	0
9	21430647	.	C	T	10	3	13	0	2	15	0	0
9	21430889	.	T	C	9	16	25	0	0	25	0	0
9	21437060	.	G	A	4	2	6	0	1	7	0	0
9	21437094	.	A	G	3	3	6	0	1	7	0	0
9	21437349	.	G	A	7	2	9	0	0	9	0	0
9	21462651	.	T	C	6	7	13	0	1	14	0	0
9	21462692	.	C	T	1	6	7	0	11	18	0	0
9	21463152	.	C	T	0	13	13	1	19	33	0	0
9	21463333	.	T	A	3	11	14	0	0	14	0	0
9	21470362	.	A	G	6	4	10	0	1	11	0	0
9	21470446	.	T	C	10	9	19	0	0	19	0	0
9	21471685	.	T	C	2	3	5	0	0	5	0	0
9	21472758	.	G	T	2	5	7	0	0	7	0	0
9	21476284	.	T	C	3	2	5	0	0	5	0	0
9	21476307	.	T	G	3	4	7	0	1	8	0	0
9	21476422	.	T	C	9	5	14	0	0	14	0	0
9	21476425	.	T	C	6	5	11	0	2	13	0	0
9	21478881	.	C	T	0	6	6	0	5	11	0	0
9	21478935	.	T	C	2	5	7	0	1	8	0	0
9	21479192	.	C	T	9	3	12	0	1	13	0	0
9	21479208	.	A	G	8	3	11	0	0	11	0	0
9	21479295	.	G	A	5	5	10	0	0	10	0	0
9	21495866	.	T	G	1	3	4	0	0	4	0	0
9	21535963	.	A	G	3	2	5	0	1	6	0	0
9	21558019	.	G	A	1	3	4	0	1	5	0	0
9	21560580	.	G	A	7	5	12	0	1	13	0	0
9	21560749	.	T	C	6	16	22	0	1	23	0	0
9	21561709	.	A	T	8	13	21	0	4	25	0	0
9	21563194	.	T	C	8	4	12	0	0	12	0	0
9	21566268	.	T	G	2	2	4	0	0	4	0	0
9	21722951	.	T	C	8	7	15	0	0	15	0	0
9	21723202	.	C	A	6	3	9	0	0	9	0	0
9	21724003	.	G	A	4	11	15	0	8	23	0	0
9	21810866	.	C	T	1	2	3	0	0	3	0	0
9	21811829	.	T	C	6	5	11	0	0	11	0	0
9	21811872	.	T	G	4	5	9	0	0	9	0	0
9	21812480	.	C	T	5	5	10	0	0	10	0	0
9	21816596	.	A	G	2	2	4	0	0	4	0	0
9	21821061	.	T	C	16	11	27	0	0	27	0	0
9	21821362	.	A	G	13	0	13	0	20	33	0	0
9	21821437	.	C	T	17	13	30	0	1	31	0	0
9	21824069	.	C	G	14	0	14	0	15	29	0	0
9	21824124	.	G	A	1	9	10	0	14	24	0	0
9	21824510	.	T	C	15	20	35	0	1	36	0	0
9	21824564	.	A	C	10	14	24	0	1	25	0	0
9	21824588	.	G	T	10	2	12	0	0	12	0	0
9	21824788	.	G	A	6	11	17	0	1	18	0	0
9	21824847	.	T	C	24	13	37	0	0	37	0	0
9	21825345	.	C	T	18	13	31	0	0	31	0	0
9	21825632	.	G	A	9	6	15	0	0	15	0	0
9	21825819	.	C	A	11	11	22	0	3	25	0	0
9	21825844	.	A	G	8	7	15	0	1	16	0	0
9	21826817	.	C	T	4	8	12	0	0	12	0	0
9	21826893	.	G	A	1	3	4	0	0	4	0	0
9	21829505	.	C	T	4	5	9	0	1	10	0	0
9	21831293	.	T	A	5	6	11	0	0	11	0	0
9	21834021	.	T	C	1	2	3	0	0	3	0	0
9	21843991	.	C	T	8	4	12	0	0	12	0	0
9	21844438	.	T	A	1	5	6	0	1	7	0	0
9	21844702	.	A	G	3	3	6	0	0	6	0	0
9	21844944	.	T	C	11	6	17	0	0	17	0	0
9	21845038	.	C	A	5	4	9	0	0	9	0	0
9	21845208	.	G	A	9	4	13	0	0	13	0	0
9	21845365	.	G	C	17	6	23	0	0	23	0	0
9	21845366	.	G	A	15	6	21	0	1	22	0	0
9	21845541	.	T	C	5	6	11	0	0	11	0	0
9	21893856	.	A	G	6	12	18	0	0	18	0	0
9	21893862	.	G	A	5	14	19	0	1	20	0	0
9	21894057	.	T	G	9	11	20	0	0	20	0	0
9	21899687	.	T	C	8	6	14	0	2	16	0	0
9	21899795	.	T	C	6	0	6	0	6	12	0	0
9	21899973	.	G	A	6	5	11	0	0	11	0	0
9	21900123	.	C	A	9	6	15	0	0	15	0	0
9	21900141	.	T	C	8	0	8	0	6	14	0	0
9	21904973	.	G	A	6	4	10	0	1	11	0	0
9	21906892	.	T	C	4	6	10	0	0	10	0	0
9	21908363	.	A	T	6	5	11	0	1	12	0	0
9	21914170	.	A	G	1	3	4	0	0	4	0	0
9	21914184	.	C	G	0	2	2	0	1	3	0	0
9	21927072	.	C	T	3	7	10	0	0	10	0	0
9	21969976	.	T	G	1	2	3	0	0	3	0	0
9	21971511	.	G	T	1	3	4	0	0	4	0	0
9	21974246	.	T	C	9	8	17	0	1	18	0	0
9	21974252	.	A	C	12	7	19	0	0	19	0	0
9	21976540	.	T	C	3	3	6	0	0	6	0	0
9	22634324	.	T	C	8	9	17	0	1	18	0	0
9	22636747	.	C	T	11	13	24	0	2	26	0	0
9	22636988	.	C	T	9	12	21	0	0	21	0	0
9	22637031	.	C	G	9	17	26	0	0	26	0	0
9	22637082	.	A	T	13	13	26	0	3	29	0	0
9	22638738	.	C	G	13	9	22	0	2	24	0	0
9	22647331	.	T	C	17	19	36	0	0	36	0	0
9	22647373	.	A	G	27	0	27	0	19	46	0	0
9	22647391	.	C	T	23	21	44	0	1	45	0	0
9	22647607	.	A	T	19	17	36	0	0	36	0	0
9	22647754	.	A	T	11	14	25	0	0	25	0	0
9	22647755	.	A	T	12	12	24	0	1	25	0	0
9	22648004	.	A	G	11	0	11	0	16	27	0	0
9	22648010	.	G	A	0	16	16	0	13	29	0	0
9	22648051	.	T	C	13	13	26	0	0	26	0	0
9	22648355	.	A	T	17	29	46	1	1	48	0	0
9	22648747	.	T	G	29	32	61	0	1	62	0	0
9	22707477	.	C	T	4	2	6	0	0	6	0	0
9	22707493	.	C	A	2	4	6	0	0	6	0	0
9	22747419	.	A	G	8	0	8	0	3	11	0	0
9	22747644	.	G	A	0	4	4	0	6	10	0	0
9	22747811	.	G	T	5	4	9	0	1	10	0	0
9	22747865	.	A	C	10	6	16	0	0	16	0	0
9	22797500	.	G	A	2	2	4	0	1	5	0	0
9	22797816	.	C	A	4	3	7	0	0	7	0	0
9	22797962	.	A	C	1	2	3	0	1	4	0	0
9	22798087	.	C	T	1	3	4	0	0	4	0	0
9	22798715	.	A	G	3	2	5	0	0	5	0	0
9	22798736	.	G	T	2	4	6	0	0	6	0	0
9	22798765	.	A	G	2	2	4	0	0	4	0	0
9	22798789	.	C	T	2	3	5	0	0	5	0	0
9	22799115	.	T	A	4	3	7	0	0	7	0	0
9	22799157	.	G	A	7	2	9	0	0	9	0	0
9	22799456	.	G	C	1	4	5	0	6	11	0	0
9	22799508	.	T	C	6	7	13	0	0	13	0	0
9	22799810	.	A	G	6	10	16	0	0	16	0	0
9	22799883	.	C	T	7	5	12	0	1	13	0	0
9	22800271	.	T	C	6	5	11	0	1	12	0	0
9	22801205	.	C	T	4	10	14	0	1	15	0	0
9	22801527	.	C	T	10	11	21	0	0	21	0	0
9	22801746	.	A	G	12	9	21	0	0	21	0	0
9	22801785	.	A	G	13	0	13	0	10	23	0	0
9	22801860	.	C	A	7	5	12	0	0	12	0	0
9	22801929	.	A	G	9	3	12	0	1	13	0	0
9	22802045	.	A	G	4	0	4	0	6	10	0	0
9	22802066	.	G	A	1	4	5	0	5	10	0	0
9	22902938	.	A	T	5	4	9	0	0	9	0	0
9	22902997	.	G	A	7	7	14	0	0	14	0	0
9	22903012	.	T	G	7	8	15	0	0	15	0	0
9	22903166	.	C	T	1	24	25	0	18	43	0	0
9	22903270	.	A	T	12	13	25	0	0	25	0	0
9	22906425	.	C	T	3	3	6	0	0	6	0	0
9	22937852	.	G	A	3	6	9	0	0	9	0	0
9	22938719	.	A	T	10	9	19	0	0	19	0	0
9	22938828	.	T	G	7	8	15	0	2	17	0	0
9	22938932	.	T	G	4	0	4	0	10	14	0	0
9	22938967	.	T	G	5	10	15	0	0	15	0	0
9	22939068	.	A	G	3	10	13	0	7	20	0	0
9	22939201	.	C	G	9	9	18	0	1	19	0	0
9	22941166	.	C	A	4	5	9	0	0	9	0	0
9	22941285	.	G	T	1	4	5	0	1	6	0	0
9	23006862	.	T	C	1	2	3	0	0	3	0	0
9	23018709	.	C	A	2	3	5	0	0	5	0	0
9	23022763	.	A	T	3	2	5	0	1	6	0	0
9	23023064	.	C	T	3	4	7	0	1	8	0	0
9	23023103	.	G	C	6	3	9	0	1	10	0	0
9	23026412	.	A	T	5	8	13	0	0	13	0	0
9	23026901	.	C	T	8	8	16	0	0	16	0	0
9	23051913	.	G	T	0	5	5	0	6	11	0	0
9	23055635	.	C	T	7	8	15	0	0	15	0	0
9	23055644	.	A	G	8	6	14	0	0	14	0	0
9	23055674	.	G	C	7	6	13	0	0	13	0	0
9	23055986	.	A	C	5	7	12	0	0	12	0	0
9	23056098	.	A	T	6	6	12	0	0	12	0	0
9	23056104	.	G	C	7	5	12	0	1	13	0	0
9	23056148	.	A	T	7	3	10	0	0	10	0	0
9	23185674	.	A	G	10	9	19	0	1	20	0	0
9	23185786	.	A	C	17	9	26	0	1	27	0	0
9	23185801	.	T	A	14	10	24	0	0	24	0	0
9	23186163	.	A	C	3	5	8	0	1	9	0	0
9	23187985	.	T	C	1	4	5	0	0	5	0	0
9	23188003	.	C	T	1	2	3	0	0	3	0	0
9	23194587	.	G	A	4	5	9	0	0	9	0	0
9	23194608	.	A	T	4	5	9	0	0	9	0	0
9	23198166	.	C	T	1	2	3	0	0	3	0	0
9	23234567	.	T	C	7	0	7	0	19	26	0	0
9	23234777	.	C	T	5	11	16	0	9	25	0	0
9	23236339	.	T	C	5	10	15	0	0	15	0	0
9	23236465	.	G	C	10	11	21	0	1	22	0	0
9	23236515	.	G	A	16	10	26	0	1	27	0	0
9	23236531	.	C	T	1	10	11	0	15	26	0	0
9	23357063	.	T	A	0	3	3	0	2	5	0	0
9	23357134	.	A	G	6	3	9	0	1	10	0	0
9	23357142	.	G	C	7	0	7	0	3	10	0	0
9	23357194	.	C	T	7	10	17	0	0	17	0	0
9	23357200	.	T	C	5	8	13	0	3	16	0	0
9	23357234	.	C	G	4	10	14	0	1	15	0	0
9	23357317	.	T	C	8	0	8	0	9	17	0	0
9	23357528	.	C	T	12	9	21	0	2	23	0	0
9	23372041	.	C	T	3	3	6	0	0	6	0	0
9	23740555	.	G	C	6	4	10	0	0	10	0	0
9	23740676	.	A	G	19	22	41	0	1	42	0	0
9	23745176	.	C	T	0	13	13	0	10	23	0	0
9	23745201	.	T	A	10	11	21	0	0	21	0	0
9	23745471	.	C	A	18	5	23	0	0	23	0	0
9	23745504	.	A	G	10	3	13	0	0	13	0	0
9	23745531	.	C	T	8	7	15	0	0	15	0	0
9	23745558	.	T	C	3	0	3	0	8	11	0	0
9	23745570	.	G	A	6	5	11	0	1	12	0	0
9	23746628	.	A	G	7	4	11	0	1	12	0	0
9	23747226	.	A	C	2	2	4	0	1	5	0	0
9	23748417	.	C	G	2	4	6	0	1	7	0	0
9	23748421	.	A	G	2	4	6	0	1	7	0	0
9	23748993	.	G	C	2	3	5	0	0	5	0	0
9	23750634	.	T	C	8	9	17	0	0	17	0	0
9	23750643	.	C	T	8	9	17	0	0	17	0	0
9	23754905	.	T	C	13	5	18	0	0	18	0	0
9	23754989	.	C	A	4	3	7	0	0	7	0	0
9	23755024	.	A	T	3	3	6	0	0	6	0	0
9	23755083	.	C	G	5	4	9	0	0	9	0	0
9	23755774	.	G	A	3	4	7	0	0	7	0	0
9	23756108	.	G	C	4	5	9	0	0	9	0	0
9	23756268	.	G	A	4	8	12	0	1	13	0	0
9	23756298	.	A	G	3	0	3	0	5	8	0	0
9	23756519	.	C	T	7	3	10	0	0	10	0	0
9	23756552	.	C	T	8	3	11	0	0	11	0	0
9	23756584	.	T	C	4	5	9	0	0	9	0	0
9	23756636	.	T	A	5	5	10	0	1	11	0	0
9	23756640	.	C	G	6	5	11	0	0	11	0	0
9	23757103	.	G	T	3	1	4	0	1	5	0	0
9	23757145	.	C	T	1	3	4	0	0	4	0	0
9	23757157	.	G	A	1	4	5	0	0	5	0	0
9	23757196	.	G	C	1	2	3	0	0	3	0	0
9	23757197	.	G	A	1	2	3	0	0	3	0	0
9	23814104	.	G	C	11	20	31	0	2	33	0	0
9	23823895	.	A	G	6	11	17	0	0	17	0	0
9	23836415	.	T	C	2	4	6	0	0	6	0	0
9	23838389	.	G	C	1	2	3	0	0	3	0	0
9	23840554	.	G	A	5	4	9	0	0	9	0	0
9	23840775	.	G	C	6	5	11	1	3	15	0	0
9	23840824	.	C	T	8	4	12	0	0	12	0	0
9	23841000	.	A	G	5	0	5	0	4	9	0	0
9	23841037	.	T	G	7	6	13	0	1	14	0	0
9	23841088	.	G	A	6	8	14	0	1	15	0	0
9	23841139	.	T	C	4	13	17	0	0	17	0	0
9	23841507	.	C	G	3	5	8	0	2	10	0	0
9	23841533	.	A	G	1	3	4	0	2	6	0	0
9	23841562	.	C	A	1	3	4	0	0	4	0	0
9	23843116	.	A	G	4	2	6	0	0	6	0	0
9	23905834	.	A	C	6	6	12	0	1	13	0	0
9	23905848	.	G	T	7	6	13	0	0	13	0	0
9	23906101	.	C	T	5	3	8	0	0	8	0	0
9	23914555	.	T	C	6	5	11	0	0	11	0	0
9	23914684	.	C	G	2	3	5	0	0	5	0	0
9	23914696	.	G	C	2	2	4	0	0	4	0	0
9	24026088	.	G	T	3	2	5	0	1	6	0	0
9	24026116	.	C	A	2	5	7	0	0	7	0	0
9	24026332	.	G	T	3	4	7	0	0	7	0	0
9	24026397	.	G	A	4	6	10	0	1	11	0	0
9	24026400	.	G	A	4	8	12	0	0	12	0	0
9	24111958	.	G	T	2	3	5	0	0	5	0	0
9	24114655	.	G	C	0	3	3	0	3	6	0	0
9	24114826	.	C	T	4	3	7	0	1	8	0	0
9	24114867	.	T	G	2	2	4	0	1	5	0	0
9	24116814	.	G	A	4	5	9	0	0	9	0	0
9	24122676	.	C	T	6	11	17	0	0	17	0	0
9	24122715	.	G	T	1	3	4	0	7	11	0	0
9	24123504	.	T	C	1	3	4	0	1	5	0	0
9	24187805	.	C	G	3	4	7	0	1	8	0	0
9	24187967	.	A	G	4	0	4	0	3	7	0	0
9	24188100	.	A	T	1	2	3	0	1	4	0	0
9	24188110	.	A	T	2	2	4	0	0	4	0	0
9	24188729	.	C	G	5	4	9	0	0	9	0	0
9	24188969	.	T	G	7	3	10	0	0	10	0	0
9	24189179	.	T	G	1	6	7	0	0	7	0	0
9	24189198	.	A	G	4	6	10	0	0	10	0	0
9	24189283	.	G	A	5	5	10	0	0	10	0	0
9	24189757	.	C	A	11	3	14	0	1	15	0	0
9	24189825	.	T	A	9	3	12	0	0	12	0	0
9	24189946	.	C	T	7	3	10	1	1	12	0	0
9	24190010	.	G	A	16	3	19	0	1	20	0	0
9	24190020	.	G	A	14	7	21	0	1	22	0	0
9	24190048	.	T	C	11	15	26	0	0	26	0	0
9	24190139	.	A	G	4	14	18	1	1	20	0	0
9	24190419	.	G	A	9	7	16	0	2	18	0	0
9	24190466	.	G	T	13	8	21	0	0	21	0	0
9	24190489	.	C	G	12	6	18	0	1	19	0	0
9	24190547	.	C	A	17	5	22	0	1	23	0	0
9	24190748	.	G	T	11	6	17	0	0	17	0	0
9	24190792	.	A	G	9	7	16	0	0	16	0	0
9	24191053	.	T	A	16	13	29	2	1	32	0	0
9	24191462	.	G	A	16	16	32	0	1	33	0	0
9	24204218	.	C	T	5	4	9	0	0	9	0	0
9	24204231	.	A	T	9	4	13	0	0	13	0	0
9	24204661	.	T	A	7	3	10	0	0	10	0	0
9	24204723	.	T	A	7	9	16	0	1	17	0	0
9	24204749	.	T	A	8	9	17	0	1	18	0	0
9	24204762	.	A	G	8	10	18	0	0	18	0	0
9	24204806	.	T	C	5	1	6	0	8	14	0	0
9	24204905	.	T	A	10	4	14	0	0	14	0	0
9	24204913	.	G	C	5	5	10	0	2	12	0	0
9	24204947	.	A	C	8	9	17	0	1	18	0	0
9	24205136	.	G	A	1	4	5	0	1	6	0	0
9	24205242	.	C	G	4	4	8	0	0	8	0	0
9	24205260	.	C	T	4	3	7	0	0	7	0	0
9	24205292	.	C	T	2	6	8	0	0	8	0	0
9	24205391	.	T	C	3	6	9	0	0	9	0	0
9	24205484	.	A	G	3	3	6	0	0	6	0	0
9	24205596	.	C	T	3	3	6	0	0	6	0	0
9	24205681	.	G	T	6	6	12	0	1	13	0	0
9	24205818	.	G	T	5	2	7	0	1	8	0	0
9	24205916	.	G	A	6	5	11	0	0	11	0	0
9	24208774	.	T	C	3	4	7	0	0	7	0	0
9	24208779	.	T	A	3	4	7	0	0	7	0	0
9	24208868	.	A	G	1	5	6	0	2	8	0	0
9	24211172	.	A	G	3	1	4	0	2	6	0	0
9	24212230	.	T	G	2	7	9	0	3	12	0	0
9	24212277	.	C	T	3	4	7	0	0	7	0	0
9	24212299	.	G	A	3	2	5	0	1	6	0	0
9	24214709	.	C	A	0	3	3	0	3	6	0	0
9	24216417	.	C	T	7	2	9	0	0	9	0	0
9	24217459	.	G	A	5	3	8	0	0	8	0	0
9	24217801	.	T	A	2	2	4	0	1	5	0	0
9	24217894	.	T	A	3	2	5	0	0	5	0	0
9	24217910	.	T	C	1	3	4	0	1	5	0	0
9	24223493	.	G	T	3	1	4	0	0	4	0	0
9	24223499	.	G	A	3	2	5	0	0	5	0	0
9	24249396	.	T	G	24	23	47	1	2	51	1	0
9	24249414	.	T	C	21	1	22	1	21	44	0	0
9	24252457	.	C	T	1	28	29	0	20	49	0	0
9	24252490	.	T	C	16	0	16	0	28	44	0	0
9	24255690	.	G	T	24	19	43	0	0	43	0	0
9	24366142	.	G	A	15	13	28	0	4	32	0	0
9	24412781	.	A	G	14	5	19	0	0	19	0	0
9	24412790	.	A	G	14	5	19	0	1	20	0	0
9	24950910	.	G	A	10	5	15	0	1	16	0	0
9	25154390	.	T	G	2	4	6	0	0	6	0	0
9	25154910	.	T	A	3	5	8	0	1	9	0	0
9	25167620	.	C	G	1	3	4	0	0	4	0	0
9	25168500	.	A	T	1	2	3	0	0	3	0	0
9	25168569	.	A	C	2	3	5	0	1	6	0	0
9	25169258	.	A	T	1	2	3	0	0	3	0	0
9	25169295	.	T	A	3	2	5	0	0	5	0	0
9	25169380	.	A	G	9	7	16	0	0	16	0	0
9	25169399	.	T	A	10	5	15	0	1	16	0	0
9	25169444	.	T	G	8	5	13	0	0	13	0	0
9	25169738	.	G	A	6	5	11	0	1	12	0	0
9	25172158	.	G	C	1	3	4	0	0	4	0	0
9	25177600	.	A	G	3	2	5	0	0	5	0	0
9	25177642	.	A	G	4	2	6	0	1	7	0	0
9	25180196	.	G	A	3	3	6	0	0	6	0	0
9	25320799	.	C	T	5	5	10	0	3	13	0	0
9	25320812	.	C	T	5	6	11	0	0	11	0	0
9	25320914	.	T	A	11	7	18	0	1	19	0	0
9	25320980	.	A	T	12	5	17	1	1	19	0	0
9	25321073	.	C	A	0	4	4	0	4	8	0	0
9	25321094	.	A	C	4	2	6	0	2	8	0	0
9	25321131	.	T	C	7	3	10	0	2	12	0	0
9	25321144	.	T	G	8	3	11	0	2	13	0	0
9	25321538	.	G	A	3	4	7	0	0	7	0	0
9	25323773	.	C	T	2	3	5	0	0	5	0	0
9	25337499	.	G	A	1	4	5	0	0	5	0	0
9	25345948	.	A	G	2	4	6	0	0	6	0	0
9	25345974	.	A	G	3	6	9	0	0	9	0	0
9	25346001	.	G	T	2	5	7	0	3	10	0	0
9	25347908	.	T	A	7	4	11	0	0	11	0	0
9	25347916	.	G	T	7	3	10	0	1	11	0	0
9	25349838	.	G	A	10	18	28	0	0	28	0	0
9	25353387	.	C	T	0	3	3	0	10	13	0	0
9	25356838	.	A	G	2	6	8	0	0	8	0	0
9	25381021	.	A	G	17	15	32	0	1	33	0	0
9	25381150	.	A	G	12	13	25	0	2	27	0	0
9	25382028	.	T	C	6	0	6	0	5	11	0	0
9	25382097	.	T	C	1	2	3	0	0	3	0	0
9	25382322	.	C	G	1	6	7	0	1	8	0	0
9	25382478	.	C	A	4	4	8	0	0	8	0	0
9	25383046	.	C	A	6	4	10	0	0	10	0	0
9	25383124	.	T	C	2	0	2	0	2	4	0	0
9	25384091	.	G	A	3	3	6	0	0	6	0	0
9	25837206	.	A	T	2	1	3	0	2	5	0	0
9	27381934	.	A	C	2	4	6	0	0	6	0	0
9	27381941	.	A	G	3	3	6	0	0	6	0	0
9	27691970	.	A	G	4	3	7	0	1	8	0	0
9	27692005	.	C	A	2	7	9	0	0	9	0	0
9	27692017	.	T	C	4	6	10	0	1	11	0	0
9	27692075	.	G	T	6	3	9	0	0	10	1	0
9	27692121	.	C	A	0	4	4	0	1	5	0	0
9	27692325	.	A	G	8	5	13	0	2	15	0	0
9	27692329	.	G	T	8	7	15	0	0	15	0	0
9	27692389	.	A	G	4	7	11	0	1	12	0	0
9	27692402	.	G	T	5	6	11	0	2	13	0	0
9	27692471	.	C	T	0	3	3	0	4	7	0	0
9	27692699	.	C	G	0	6	6	0	2	8	0	0
9	27694630	.	T	C	2	2	4	0	0	4	0	0
9	27716762	.	A	G	2	4	6	0	0	6	0	0
9	27741271	.	G	T	2	2	4	0	0	4	0	0
9	27741286	.	C	T	3	2	5	0	0	5	0	0
9	27741431	.	T	C	6	3	9	0	0	9	0	0
9	27757831	.	C	T	8	11	19	0	1	20	0	0
9	27856652	.	C	G	2	3	5	1	0	6	0	0
9	27856675	.	C	T	2	3	5	1	0	6	0	0
9	27860603	.	G	A	10	4	14	1	4	19	0	0
9	27860734	.	C	T	0	5	5	0	9	14	0	0
9	27861186	.	G	T	3	2	5	0	2	7	0	0
9	27861293	.	C	G	1	3	4	0	10	14	0	0
9	27863828	.	G	T	3	3	6	0	0	6	0	0
9	27894444	.	G	T	2	3	5	0	1	6	0	0
9	27894656	.	T	C	2	2	4	0	1	5	0	0
9	27897012	.	T	C	4	6	10	0	0	10	0	0
9	28115901	.	A	G	1	2	3	0	1	4	0	0
9	28116064	.	T	C	2	2	4	0	0	4	0	0
9	28124661	.	G	A	5	2	7	0	1	8	0	0
9	28124775	.	A	G	7	0	7	0	3	10	0	0
9	28127334	.	A	G	8	0	8	0	11	19	0	0
9	28127471	.	A	G	17	10	27	0	2	29	0	0
9	28127513	.	A	C	17	10	27	0	1	28	0	0
9	28127532	.	A	C	15	10	25	0	1	26	0	0
9	28127573	.	A	G	12	7	19	0	2	21	0	0
9	28127706	.	C	G	13	6	19	0	1	20	0	0
9	28205743	.	T	C	3	2	5	0	0	5	0	0
9	28206947	.	A	T	5	8	13	1	0	14	0	0
9	28207339	.	T	A	3	6	9	0	0	9	0	0
9	28207392	.	T	A	4	3	7	0	1	8	0	0
9	28207647	.	C	T	3	3	6	0	1	7	0	0
9	28207804	.	C	T	2	6	8	0	0	8	0	0
9	28238302	.	C	T	15	12	27	0	2	29	0	0
9	28238305	.	C	T	1	13	14	0	15	29	0	0
9	28245874	.	G	A	10	11	21	0	2	23	0	0
9	28254633	.	C	T	11	6	17	0	0	17	0	0
9	28254783	.	C	T	0	9	9	0	5	14	0	0
9	28254810	.	G	A	3	8	11	0	0	11	0	0
9	28263971	.	C	T	8	10	18	0	0	18	0	0
9	28264469	.	T	C	5	0	5	0	8	13	0	0
9	28267158	.	G	A	2	6	8	0	1	9	0	0
9	28268543	.	G	A	7	4	11	0	1	12	0	0
9	28341330	.	C	A	0	9	9	0	10	19	0	0
9	28341382	.	G	A	10	9	19	0	2	21	0	0
9	28341591	.	C	A	19	22	41	2	2	45	0	0
9	28341593	.	T	A	20	22	42	2	4	48	0	0
9	28342963	.	G	A	3	5	8	0	1	9	0	0
9	28343054	.	G	A	7	14	21	0	1	22	0	0
9	28343100	.	A	G	7	16	23	0	0	23	0	0
9	28343121	.	T	G	6	12	18	0	0	18	0	0
9	28344026	.	T	C	5	5	10	0	2	12	0	0
9	28344126	.	A	C	4	3	7	0	0	7	0	0
9	28688956	.	C	G	6	0	6	0	4	10	0	0
9	28688965	.	A	G	6	4	10	0	1	11	0	0
9	28689032	.	G	A	9	4	13	0	0	13	0	0
9	28689033	.	C	A	8	4	12	0	0	12	0	0
9	28691645	.	T	C	5	12	17	0	1	18	0	0
9	28696610	.	A	C	5	8	13	0	0	13	0	0
9	28696643	.	A	G	6	6	12	0	0	12	0	0
9	28818069	.	T	C	2	4	6	0	0	6	0	0
9	28818072	.	T	C	2	4	6	0	0	6	0	0
9	28818106	.	G	A	3	2	5	0	0	5	0	0
9	28818498	.	A	T	6	2	8	0	1	9	0	0
9	28839859	.	G	A	7	4	11	0	0	11	0	0
9	28839879	.	T	A	7	5	12	0	1	13	0	0
9	28867421	.	A	C	1	2	3	0	1	4	0	0
9	28867426	.	A	C	1	3	4	0	0	4	0	0
9	28871367	.	A	T	2	4	6	0	1	7	0	0
9	28872253	.	T	G	3	4	7	0	1	8	0	0
9	28875319	.	C	T	3	5	8	0	0	8	0	0
9	28879348	.	C	T	1	1	2	0	2	4	0	0
9	28940998	.	G	A	18	18	36	0	0	36	0	0
9	28941003	.	T	C	20	0	20	0	16	36	0	0
9	28941061	.	A	C	18	11	29	0	2	31	0	0
9	28941179	.	A	G	8	13	21	0	0	21	0	0
9	28941189	.	G	A	7	12	19	0	1	20	0	0
9	28941234	.	C	T	5	5	10	0	0	10	0	0
9	28941414	.	A	G	15	16	31	0	1	32	0	0
9	28941446	.	A	G	16	16	32	0	1	33	0	0
9	28941488	.	T	A	15	10	25	0	1	26	0	0
9	28941498	.	C	G	17	10	27	0	1	28	0	0
9	28941629	.	G	A	6	3	9	0	1	10	0	0
9	28941630	.	G	A	5	4	9	0	0	9	0	0
9	28941684	.	C	G	7	4	11	0	0	11	0	0
9	28941795	.	C	T	4	4	8	0	0	8	0	0
9	28941832	.	A	G	3	3	6	0	0	6	0	0
9	28942018	.	G	A	7	2	9	0	1	10	0	0
9	28942542	.	T	A	12	10	22	0	3	25	0	0
9	28942553	.	T	A	13	10	23	0	0	23	0	0
9	28946132	.	A	T	6	6	12	0	0	12	0	0
9	28955543	.	A	G	4	5	9	0	0	9	0	0
9	28964849	.	C	A	3	3	6	0	0	6	0	0
9	28983790	.	C	A	0	5	5	0	1	6	0	0
9	29035075	.	T	C	0	2	2	0	1	3	0	0
9	29035086	.	A	C	1	2	3	0	0	3	0	0
9	29035572	.	T	C	2	3	5	0	0	5	0	0
9	29035575	.	A	G	2	3	5	0	0	5	0	0
9	29035614	.	A	C	2	3	5	0	1	6	0	0
9	29122231	.	T	G	6	6	12	0	0	12	0	0
9	29122536	.	T	A	5	11	16	0	0	16	0	0
9	29122725	.	C	T	5	3	8	0	1	9	0	0
9	29122849	.	A	G	7	6	13	0	0	13	0	0
9	29195268	.	A	G	2	2	4	0	0	4	0	0
9	29339133	.	G	C	1	4	5	0	0	5	0	0
9	29339139	.	A	T	1	3	4	0	0	4	0	0
9	29473879	.	T	A	6	3	9	0	0	9	0	0
9	29477021	.	G	C	5	2	7	0	0	7	0	0
9	29481518	.	T	C	10	5	15	0	0	15	0	0
9	29481708	.	A	G	2	4	6	0	0	6	0	0
9	29482135	.	T	A	2	3	5	0	0	5	0	0
9	29484238	.	G	A	8	5	13	0	0	13	0	0
9	29484291	.	T	G	7	5	12	0	0	12	0	0
9	29487163	.	C	T	5	2	7	0	0	7	0	0
9	29489797	.	A	G	6	3	9	0	1	10	0	0
9	29492571	.	A	G	1	2	3	0	0	3	0	0
9	29497181	.	C	T	0	2	2	0	2	4	0	0
9	29497200	.	A	T	1	2	3	0	0	3	0	0
9	29520819	.	A	G	7	10	17	0	3	20	0	0
9	29523552	.	T	G	7	0	7	0	10	17	0	0
9	29602959	.	T	C	3	4	7	0	0	7	0	0
9	29607543	.	C	T	9	4	13	0	1	14	0	0
9	29615087	.	C	G	18	23	41	0	2	43	0	0
9	29615238	.	T	A	16	20	36	0	1	37	0	0
9	29615575	.	C	T	15	16	31	0	3	34	0	0
9	29647469	.	G	A	21	12	33	0	1	34	0	0
9	29647470	.	C	T	21	12	33	0	1	34	0	0
9	29649571	.	C	A	20	23	43	0	9	52	0	0
9	29992145	.	A	G	12	0	12	0	12	24	0	0
9	29992332	.	G	A	3	5	8	0	2	10	0	0
9	30105956	.	G	A	4	4	8	3	0	11	0	0
9	30106009	.	G	A	6	10	16	1	0	17	0	0
9	30106090	.	T	A	2	2	4	2	0	6	0	0
9	30107428	.	C	T	5	2	7	0	1	8	0	0
9	30107439	.	T	A	3	4	7	0	1	8	0	0
9	30108779	.	T	C	3	4	7	0	0	7	0	0
9	30110026	.	T	C	2	3	5	0	0	5	0	0
9	30110217	.	T	C	6	3	9	0	0	9	0	0
9	30114853	.	A	G	3	7	10	0	0	10	0	0
9	30121155	.	C	A	8	12	20	0	0	20	0	0
9	30121167	.	C	T	5	11	16	0	1	17	0	0
9	30126136	.	A	G	20	1	21	0	20	41	0	0
9	30128084	.	C	G	28	24	52	0	4	56	0	0
9	30128085	.	C	T	27	25	52	0	3	55	0	0
9	30128450	.	G	A	13	2	15	3	2	20	0	0
9	30218140	.	C	T	8	4	12	0	0	12	0	0
9	30218310	.	G	A	3	5	8	0	1	9	0	0
9	30218323	.	A	G	3	6	9	0	0	9	0	0
9	30220931	.	C	T	3	5	8	0	0	8	0	0
9	30220968	.	T	A	5	5	10	0	0	10	0	0
9	30220975	.	C	T	6	4	10	0	0	10	0	0
9	30226160	.	T	C	2	0	2	0	6	8	0	0
9	30226583	.	T	C	1	0	1	0	5	6	0	0
9	30231616	.	T	C	1	0	1	0	4	5	0	0
9	30231659	.	A	T	3	2	5	0	1	6	0	0
9	30231664	.	C	T	0	3	3	0	3	6	0	0
9	30236090	.	A	C	2	2	4	0	0	4	0	0
9	30246172	.	C	G	10	6	16	0	0	16	0	0
9	30247941	.	A	G	10	4	14	0	0	14	0	0
9	30249039	.	C	T	0	4	4	0	2	6	0	0
9	30251977	.	A	G	1	2	3	0	1	4	0	0
9	30255146	.	C	G	2	3	5	0	0	5	0	0
9	30259418	.	C	G	2	2	4	0	0	4	0	0
9	30375082	.	T	A	2	4	6	0	0	6	0	0
9	30375117	.	A	C	1	3	4	0	1	5	0	0
9	30375132	.	G	A	2	2	4	0	0	4	0	0
9	30375470	.	A	T	6	7	13	0	0	13	0	0
9	30375746	.	G	A	3	3	6	0	0	6	0	0
9	30381813	.	C	G	1	2	3	0	0	3	0	0
9	30487596	.	C	A	3	5	8	0	0	8	0	0
9	30487599	.	T	C	3	5	8	0	0	8	0	0
9	30489813	.	A	G	2	4	6	1	0	7	0	0
9	30490106	.	G	A	1	2	3	0	0	3	0	0
9	30490949	.	G	T	4	2	6	0	1	7	0	0
9	30491053	.	T	C	6	5	11	0	1	12	0	0
9	30491197	.	G	A	6	4	10	0	1	11	0	0
9	30491560	.	C	T	3	5	8	0	7	15	0	0
9	30494225	.	T	C	10	3	13	0	0	13	0	0
9	30494498	.	C	G	0	1	1	0	8	9	0	0
9	30494839	.	A	G	2	5	7	0	1	8	0	0
9	30494854	.	T	A	3	5	8	0	2	10	0	0
9	30494965	.	G	A	8	6	14	0	2	16	0	0
9	30495139	.	C	T	0	2	2	0	6	8	0	0
9	30562611	.	T	C	2	5	7	0	0	7	0	0
9	30562659	.	A	G	3	3	6	0	0	6	0	0
9	30562689	.	A	T	3	4	7	0	0	7	0	0
9	30581779	.	G	C	2	10	12	0	1	13	0	0
9	30581942	.	C	T	4	5	9	0	0	9	0	0
9	30800990	.	C	T	3	2	5	0	1	6	0	0
9	30806492	.	A	G	1	2	3	0	0	3	0	0
9	30807944	.	C	T	2	4	6	0	1	7	0	0
9	30990845	.	A	G	3	4	7	0	0	7	0	0
9	31042584	.	T	C	13	13	26	0	1	27	0	0
9	31062518	.	T	A	17	16	33	0	0	33	0	0
9	31062588	.	G	A	21	14	35	0	1	36	0	0
9	31062589	.	G	A	22	14	36	0	0	36	0	0
9	31248923	.	C	T	3	4	7	0	0	7	0	0
9	31258832	.	G	A	12	7	19	0	0	19	0	0
9	31274993	.	T	C	12	0	12	5	11	28	0	0
9	31276912	.	C	T	20	18	38	0	1	39	0	0
9	31497304	.	G	A	0	2	2	0	1	3	0	0
9	31510724	.	T	A	6	4	10	0	0	10	0	0
9	31524405	.	G	A	1	2	3	0	0	3	0	0
9	31524406	.	T	C	1	2	3	0	0	3	0	0
9	31586434	.	G	A	1	3	4	0	0	4	0	0
9	31595634	.	C	T	16	7	23	0	2	25	0	0
9	31604943	.	G	A	5	3	8	0	0	8	0	0
9	31605235	.	A	G	1	2	3	0	0	3	0	0
9	31605281	.	C	A	0	3	3	0	3	6	0	0
9	31606333	.	C	T	4	4	8	0	1	9	0	0
9	31612184	.	C	T	3	3	6	0	0	6	0	0
9	31617687	.	A	G	1	4	5	0	0	5	0	0
9	31619998	.	A	G	2	2	4	0	0	4	0	0
9	31639107	.	C	T	1	2	3	0	0	3	0	0
9	32169182	.	A	G	14	26	40	0	3	43	0	0
9	32169287	.	G	A	23	10	33	0	3	36	0	0
9	32286804	.	C	G	4	8	12	0	1	13	0	0
9	32286858	.	C	T	6	13	19	0	1	20	0	0
9	32287162	.	A	G	11	18	29	0	0	29	0	0
9	32287208	.	A	C	21	20	41	0	1	42	0	0
9	32287418	.	A	G	19	10	29	0	0	29	0	0
9	32287419	.	A	G	17	10	27	0	2	29	0	0
9	32287481	.	T	C	22	19	41	0	1	42	0	0
9	32287688	.	A	G	19	13	32	0	0	32	0	0
9	32289064	.	C	A	1	6	7	0	15	22	0	0
9	32289281	.	G	A	18	7	25	0	0	25	0	0
9	32290957	.	G	A	9	4	13	0	0	13	0	0
9	32304476	.	G	A	4	8	12	0	1	13	0	0
9	32304874	.	T	G	5	2	7	0	0	7	0	0
9	32304951	.	T	G	1	9	10	0	0	10	0	0
9	32307717	.	T	C	10	10	20	0	0	20	0	0
9	32308523	.	A	C	4	4	8	0	2	10	0	0
9	32312472	.	C	T	23	28	51	0	2	53	0	0
9	32312600	.	A	G	35	1	36	0	16	52	0	0
9	32312683	.	C	A	22	15	37	0	2	39	0	0
9	32313206	.	T	G	1	2	3	0	1	4	0	0
9	32313209	.	T	G	1	3	4	0	0	4	0	0
9	32313260	.	T	C	4	4	8	0	2	10	0	0
9	32313875	.	G	T	3	3	6	0	1	7	0	0
9	32313964	.	G	A	4	3	7	0	0	7	0	0
9	32457192	.	C	T	2	3	5	0	1	6	0	0
9	32641131	.	T	A	8	9	17	0	0	17	0	0
9	32641175	.	T	G	12	15	27	0	1	28	0	0
9	32641278	.	A	T	9	13	22	0	0	22	0	0
9	32641294	.	G	T	8	14	22	0	0	22	0	0
9	32641424	.	G	A	12	8	20	1	0	21	0	0
9	32641442	.	G	C	12	11	23	1	0	24	0	0
9	32641548	.	T	A	9	6	15	0	1	16	0	0
9	32641600	.	A	G	8	13	21	0	0	21	0	0
9	32641682	.	A	G	5	14	19	0	1	20	0	0
9	32641731	.	C	A	6	15	21	0	1	22	0	0
9	32641737	.	A	G	7	16	23	0	1	24	0	0
9	32641802	.	T	C	4	10	14	0	0	14	0	0
9	32641805	.	A	G	3	9	12	0	1	13	0	0
9	32642342	.	A	G	9	13	22	0	1	23	0	0
9	32643643	.	G	A	6	8	14	0	1	15	0	0
9	32645615	.	G	C	4	12	16	0	4	20	0	0
9	32645939	.	T	C	1	4	5	0	1	6	0	0
9	32651241	.	A	T	2	4	6	0	1	7	0	0
9	32651334	.	C	T	1	3	4	0	0	4	0	0
9	32651527	.	C	A	3	3	6	0	0	6	0	0
9	32651648	.	A	G	0	2	2	0	1	3	0	0
9	32651665	.	T	C	2	4	6	0	0	6	0	0
9	32651826	.	T	C	7	3	10	0	0	10	0	0
9	32651959	.	A	G	1	3	4	0	0	4	0	0
9	32652059	.	A	G	2	0	2	0	5	7	0	0
9	32652072	.	T	C	4	6	10	0	0	10	0	0
9	32652129	.	C	T	4	7	11	0	1	12	0	0
9	32670920	.	C	T	1	3	4	0	0	4	0	0
9	32670934	.	A	G	1	2	3	0	0	3	0	0
9	32671163	.	G	T	2	2	4	0	0	4	0	0
9	32681877	.	A	C	3	2	5	0	1	6	0	0
9	32681880	.	A	C	4	0	4	0	2	6	0	0
9	32728896	.	G	C	8	6	14	0	0	14	0	0
9	32728969	.	A	G	10	5	15	0	2	17	0	0
9	32728984	.	C	A	11	5	16	0	1	17	0	0
9	32729022	.	T	C	10	4	14	0	0	14	0	0
9	32729072	.	G	A	3	4	7	0	0	7	0	0
9	32751579	.	A	G	2	3	5	0	0	5	0	0
9	32751640	.	A	G	8	13	21	0	0	21	0	0
9	32751812	.	A	G	15	16	31	0	0	31	0	0
9	32751825	.	C	T	14	15	29	0	1	30	0	0
9	32752272	.	C	T	13	8	21	0	3	24	0	0
9	32752555	.	C	T	5	9	14	0	1	15	0	0
9	32752824	.	G	T	10	6	16	0	1	17	0	0
9	32752864	.	G	T	8	4	12	0	0	12	0	0
9	32804802	.	C	T	6	2	8	0	0	8	0	0
9	32872932	.	T	C	4	2	6	0	0	6	0	0
9	32873544	.	G	T	0	2	2	0	7	9	0	0
9	32873788	.	C	A	8	2	10	0	0	10	0	0
9	32873792	.	C	A	7	2	9	0	0	9	0	0
9	32873940	.	G	A	5	3	8	0	1	9	0	0
9	32874603	.	G	A	1	9	10	0	10	20	0	0
9	32895294	.	A	T	4	3	7	0	0	7	0	0
9	32895297	.	T	C	4	0	4	0	3	7	0	0
9	32897304	.	C	T	2	2	4	0	0	4	0	0
9	32899796	.	C	T	2	2	4	0	0	4	0	0
9	32900267	.	C	T	0	4	4	0	1	5	0	0
9	32901173	.	A	G	3	2	5	0	0	5	0	0
9	32901176	.	T	A	3	2	5	0	0	5	0	0
9	32901275	.	G	A	1	2	3	0	0	3	0	0
9	32980561	.	T	A	1	6	7	0	0	7	0	0
9	32981302	.	C	T	2	6	8	0	0	8	0	0
9	32981317	.	T	C	2	6	8	0	0	8	0	0
9	32981549	.	T	C	3	2	5	0	0	5	0	0
9	33411227	.	C	A	4	5	9	0	0	9	0	0
9	33411228	.	A	G	4	5	9	0	0	9	0	0
9	33661021	.	T	C	5	0	5	0	10	15	0	0
9	33661399	.	A	G	11	16	27	0	0	27	0	0
9	33661424	.	G	A	9	15	24	0	0	24	0	0
9	33661645	.	A	T	12	7	19	0	0	19	0	0
9	33661691	.	A	T	6	7	13	0	2	15	0	0
9	33661714	.	G	A	5	8	13	0	0	13	0	0
9	33661765	.	C	T	7	7	14	0	0	14	0	0
9	33661773	.	A	C	7	6	13	0	0	13	0	0
9	33661816	.	T	C	2	2	4	0	0	4	0	0
9	33661939	.	T	A	13	4	17	0	1	18	0	0
9	33662134	.	C	T	7	6	13	0	1	14	0	0
9	33662158	.	A	G	9	12	21	0	3	24	0	0
9	33662175	.	T	G	7	17	24	0	1	25	0	0
9	33662223	.	A	T	3	5	8	0	1	9	0	0
9	33662250	.	A	T	2	1	3	0	1	4	0	0
9	33662273	.	A	C	1	2	3	0	0	3	0	0
9	33663300	.	G	A	5	4	9	0	0	9	0	0
9	33663455	.	A	G	4	4	8	0	0	8	0	0
9	33678124	.	A	G	1	2	3	0	0	3	0	0
9	33783731	.	T	A	6	3	9	0	0	9	0	0
9	33783800	.	A	T	8	14	22	0	0	22	0	0
9	33783822	.	T	A	17	16	33	0	2	35	0	0
9	33783852	.	A	G	28	14	42	0	2	44	0	0
9	33783884	.	C	G	37	9	46	0	2	48	0	0
9	33783956	.	T	C	28	22	50	0	1	51	0	0
9	33784689	.	T	G	28	23	51	0	1	52	0	0
9	33853510	.	A	G	4	1	5	0	10	15	0	0
9	33857776	.	C	T	12	5	17	0	0	17	0	0
9	33858088	.	G	A	6	7	13	0	0	13	0	0
9	33858111	.	T	C	9	5	14	0	1	15	0	0
9	33861805	.	C	T	4	2	6	0	2	8	0	0
9	34090715	.	T	A	2	1	3	0	1	4	0	0
9	34112981	.	T	C	3	4	7	0	0	7	0	0
9	34113008	.	A	T	5	4	9	0	0	9	0	0
9	34113140	.	G	A	1	5	6	0	0	6	0	0
9	34116933	.	A	G	3	6	9	0	1	10	0	0
9	34117293	.	A	C	1	4	5	0	0	5	0	0
9	34161749	.	G	A	1	2	3	0	1	4	0	0
9	34161933	.	C	T	2	3	5	1	0	6	0	0
9	34170057	.	G	A	9	11	20	0	0	20	0	0
9	34174561	.	C	T	7	5	12	0	0	12	0	0
9	34174682	.	G	A	2	4	6	0	2	8	0	0
9	34222113	.	C	T	5	7	12	0	1	13	0	0
9	34225055	.	A	G	10	10	20	0	1	21	0	0
9	34225316	.	G	C	17	21	38	0	1	39	0	0
9	34226884	.	G	A	18	25	43	0	6	50	1	0
9	34226888	.	G	A	3	29	32	0	20	52	0	0
9	34226960	.	A	C	23	22	45	0	0	45	0	0
9	34227016	.	A	T	16	19	35	0	4	39	0	0
9	34227020	.	C	G	18	18	36	0	1	37	0	0
9	34227054	.	C	T	12	15	27	0	3	30	0	0
9	34227074	.	C	A	12	12	24	0	0	24	0	0
9	34243122	.	G	C	4	5	9	0	0	9	0	0
9	34246415	.	A	G	1	3	4	0	0	4	0	0
9	34246473	.	G	A	12	7	19	0	1	20	0	0
9	34246524	.	G	A	17	11	28	0	0	28	0	0
9	34246555	.	T	G	14	9	23	0	0	23	0	0
9	34246628	.	G	A	7	10	17	0	1	18	0	0
9	34246710	.	G	A	8	10	18	0	2	20	0	0
9	34246932	.	A	G	12	16	28	0	1	29	0	0
9	34247087	.	C	T	22	3	25	0	0	25	0	0
9	34247356	.	G	A	9	9	18	0	2	20	0	0
9	34251632	.	G	A	10	5	15	0	1	16	0	0
9	34251707	.	C	G	4	10	14	0	0	14	0	0
9	34251752	.	G	A	6	8	14	0	0	14	0	0
9	34251764	.	G	A	7	5	12	0	2	14	0	0
9	34254896	.	G	A	2	2	4	0	1	5	0	0
9	34256016	.	A	C	2	2	4	0	1	5	0	0
9	34349379	.	T	C	1	2	3	0	0	3	0	0
9	34382946	.	A	T	1	5	6	0	1	7	0	0
9	34385183	.	A	G	2	5	7	0	1	8	0	0
9	34385396	.	A	G	12	1	13	0	12	25	0	0
9	34388882	.	G	A	10	12	22	0	0	22	0	0
9	34389077	.	T	C	4	12	16	0	2	18	0	0
9	34389101	.	C	G	6	12	18	0	0	18	0	0
9	34389288	.	T	G	8	17	25	0	0	25	0	0
9	34389299	.	T	G	10	0	10	0	17	27	0	0
9	34389427	.	C	T	17	13	30	0	0	30	0	0
9	34389602	.	A	G	31	2	33	0	19	52	0	0
9	34389666	.	A	G	23	18	41	0	1	42	0	0
9	34389701	.	A	T	30	18	48	0	0	48	0	0
9	34389704	.	G	C	30	19	49	0	0	49	0	0
9	34389743	.	G	T	18	22	40	0	4	44	0	0
9	34389748	.	A	C	19	23	42	0	4	46	0	0
9	34389791	.	A	G	4	12	16	0	2	18	0	0
9	34415308	.	T	C	4	8	12	0	1	13	0	0
9	34416575	.	A	T	7	8	15	0	0	15	0	0
9	34423397	.	C	A	5	13	18	1	2	21	0	0
9	34423415	.	T	A	8	16	24	0	1	25	0	0
9	34423468	.	T	A	10	9	19	0	2	21	0	0
9	34423474	.	A	G	13	0	13	0	7	20	0	0
9	34423593	.	G	T	3	3	6	0	0	6	0	0
9	34423794	.	T	C	1	1	2	0	1	3	0	0
9	34425920	.	C	T	7	2	9	0	0	9	0	0
9	34482462	.	G	A	5	4	9	0	0	9	0	0
9	34647415	.	A	G	10	0	10	0	12	22	0	0
9	34647427	.	A	C	11	8	19	0	1	20	0	0
9	34866888	.	C	T	9	6	15	0	1	16	0	0
9	34867007	.	C	A	2	9	11	0	4	15	0	0
9	34867015	.	T	C	4	1	5	0	10	15	0	0
9	34869945	.	G	A	2	2	4	0	0	4	0	0
9	34877042	.	G	A	2	3	5	0	0	5	0	0
9	34877074	.	C	T	2	1	3	0	1	4	0	0
9	34903218	.	T	G	29	23	52	1	0	53	0	0
9	34906337	.	C	G	25	23	48	0	4	52	0	0
9	34912626	.	A	T	18	12	30	0	0	30	0	0
9	34912695	.	T	C	14	0	14	0	10	24	0	0
9	34912895	.	T	A	9	12	21	0	3	24	0	0
9	34920149	.	A	G	1	2	3	0	2	5	0	0
9	34920395	.	G	A	3	4	7	0	0	7	0	0
9	34922670	.	C	T	1	8	9	0	7	16	0	0
9	34922898	.	A	G	5	2	7	0	1	8	0	0
9	34937099	.	G	A	2	2	4	0	0	4	0	0
9	34937145	.	C	G	1	2	3	0	0	3	0	0
9	34937154	.	A	T	1	2	3	0	0	3	0	0
9	34938795	.	C	T	8	10	18	0	1	19	0	0
9	34939336	.	A	G	12	13	25	0	0	25	0	0
9	34939800	.	T	C	5	4	9	0	0	9	0	0
9	34967565	.	A	G	7	7	14	0	0	14	0	0
9	34967647	.	C	T	6	4	10	0	0	10	0	0
9	34967649	.	C	T	7	4	11	0	0	11	0	0
9	34967733	.	A	G	6	3	9	0	0	9	0	0
9	34967743	.	A	C	7	2	9	0	0	9	0	0
9	34968005	.	A	G	7	10	17	0	0	17	0	0
9	35009716	.	C	T	1	2	3	0	0	3	0	0
9	35024459	.	G	C	0	4	4	0	6	10	0	0
9	35025183	.	C	T	14	12	26	0	0	26	0	0
9	35025243	.	A	T	9	6	15	0	0	15	0	0
9	35025430	.	C	T	7	4	11	0	0	11	0	0
9	35026418	.	G	T	6	2	8	0	0	8	0	0
9	35026736	.	T	A	29	30	59	0	2	61	0	0
9	35026941	.	T	C	34	29	63	0	1	65	1	0
9	35027262	.	A	G	33	28	61	0	2	63	0	0
9	35027309	.	T	C	32	0	32	0	32	64	0	0
9	35027333	.	A	G	32	29	61	0	2	63	0	0
9	35027365	.	G	T	32	20	52	0	5	57	0	0
9	35027371	.	G	T	33	18	51	0	6	57	0	0
9	35027402	.	G	A	37	24	61	0	2	63	0	0
9	35027549	.	T	G	28	27	55	0	2	57	0	0
9	35027705	.	G	A	19	2	21	0	3	31	7	0
9	35028086	.	T	C	32	0	32	0	30	62	0	0
9	35028282	.	T	C	36	5	41	0	27	68	0	0
9	35030977	.	G	A	21	23	44	1	0	45	0	0
9	35032640	.	A	G	12	17	29	0	2	31	0	0
9	35032643	.	A	G	12	17	29	0	2	31	0	0
9	35033347	.	C	T	11	8	19	0	1	20	0	0
9	35039175	.	T	C	5	9	14	0	1	15	0	0
9	35170671	.	G	A	8	8	16	0	2	18	0	0
9	35176030	.	A	G	8	16	24	0	1	25	0	0
9	35838477	.	T	A	7	7	14	0	2	16	0	0
9	35840713	.	G	A	6	13	19	0	0	19	0	0
9	35840782	.	T	C	5	7	12	0	0	12	0	0
9	35841279	.	G	T	5	6	11	0	0	11	0	0
9	35841282	.	A	G	5	6	11	0	0	11	0	0
9	35841663	.	G	T	6	3	9	0	2	11	0	0
9	35841879	.	T	A	8	12	20	0	1	21	0	0
9	35841994	.	A	G	7	9	16	0	1	17	0	0
9	35842164	.	T	A	12	11	23	0	1	24	0	0
9	35842209	.	G	T	12	10	22	0	1	23	0	0
9	35862184	.	A	T	3	6	9	0	1	10	0	0
9	35862299	.	G	A	5	8	13	0	1	14	0	0
9	35863132	.	C	T	10	9	19	0	0	19	0	0
9	35863555	.	T	C	13	7	20	0	0	20	0	0
9	35863603	.	T	C	12	7	19	0	1	20	0	0
9	35863798	.	C	T	10	14	24	0	0	24	0	0
9	35863968	.	A	T	10	6	16	0	5	22	1	0
9	35864155	.	A	T	9	6	15	0	0	15	0	0
9	35864210	.	C	T	7	11	18	0	0	18	0	0
9	35864266	.	C	A	3	8	11	0	1	12	0	0
9	35864277	.	C	T	1	7	8	0	1	9	0	0
9	35864486	.	C	T	2	1	3	0	1	4	0	0
9	35865073	.	C	T	22	17	39	0	1	40	0	0
9	35865162	.	G	T	12	14	26	0	1	27	0	0
9	35865270	.	C	G	18	17	35	0	4	39	0	0
9	35872927	.	G	A	7	3	10	0	2	12	0	0
9	35872942	.	G	A	6	4	10	0	2	12	0	0
9	35872993	.	A	T	5	9	14	0	0	14	0	0
9	35901654	.	T	A	6	3	9	0	0	9	0	0
9	35910390	.	C	G	1	3	4	0	0	4	0	0
9	35912447	.	A	T	3	4	7	0	1	8	0	0
9	35912459	.	G	A	1	4	5	0	2	7	0	0
9	35912661	.	G	C	2	2	4	0	0	4	0	0
9	35915548	.	C	T	1	4	5	0	0	5	0	0
9	35915557	.	G	A	1	4	5	0	0	5	0	0
9	35916518	.	T	G	5	8	13	0	0	13	0	0
9	35916786	.	G	A	4	10	14	0	1	15	0	0
9	35922046	.	T	G	10	31	41	2	0	43	0	0
9	35922115	.	T	C	7	8	15	0	2	17	0	0
9	36119175	.	A	G	6	3	9	0	0	9	0	0
9	36656011	.	A	G	1	3	4	0	1	5	0	0
9	36659702	.	T	G	1	5	6	0	1	7	0	0
9	36899065	.	C	T	0	3	3	0	2	5	0	0
9	36973841	.	C	G	1	3	4	0	0	4	0	0
9	36974170	.	G	T	3	4	7	0	0	7	0	0
9	36974191	.	T	C	1	2	3	0	0	3	0	0
9	37294806	.	T	C	2	2	4	0	0	4	0	0
9	37296124	.	A	G	2	2	4	0	0	4	0	0
9	37296454	.	T	A	1	2	3	0	0	3	0	0
9	37341614	.	T	C	1	2	3	0	1	4	0	0
9	37345228	.	T	C	1	2	3	0	0	3	0	0
9	37348530	.	A	G	1	2	3	0	0	3	0	0
9	37371515	.	A	T	1	2	3	0	0	3	0	0
9	37451609	.	T	G	6	3	9	0	1	10	0	0
9	37451809	.	A	G	11	7	18	0	1	19	0	0
9	37452012	.	A	T	10	5	15	0	0	15	0	0
9	37452223	.	C	T	4	5	9	0	0	9	0	0
9	37452432	.	G	A	6	9	15	0	2	17	0	0
9	37452499	.	T	G	11	6	17	0	1	18	0	0
9	37452515	.	G	T	13	6	19	0	0	19	0	0
9	37452616	.	T	G	21	14	35	0	1	36	0	0
9	37452819	.	G	C	9	7	16	0	3	19	0	0
9	37452862	.	T	C	10	10	20	0	1	21	0	0
9	37452924	.	C	G	15	5	20	0	1	21	0	0
9	37815520	.	A	T	1	1	2	0	2	4	0	0
9	37840024	.	G	T	6	2	8	0	0	8	0	0
9	37850559	.	T	A	2	2	4	0	0	4	0	0
9	37853970	.	A	C	2	3	5	0	0	5	0	0
9	37856541	.	C	T	6	4	10	0	0	10	0	0
9	37856895	.	T	A	5	7	12	0	1	13	0	0
9	37859807	.	G	T	6	12	18	0	0	18	0	0
9	37859881	.	T	G	20	7	27	0	1	28	0	0
9	37860116	.	T	C	2	5	7	1	0	8	0	0
9	37860674	.	A	G	6	2	8	0	1	9	0	0
9	37860686	.	A	G	5	3	8	0	0	8	0	0
9	37861834	.	G	A	4	3	7	0	0	7	0	0
9	37861844	.	G	A	3	5	8	0	0	8	0	0
9	37862065	.	T	G	3	0	3	1	10	14	0	0
9	37862333	.	C	A	5	3	8	0	0	8	0	0
9	37862376	.	T	C	1	2	3	0	1	4	0	0
9	38029489	.	C	T	1	3	4	0	0	4	0	0
9	38030131	.	A	T	12	13	25	0	0	25	0	0
9	38030366	.	A	T	9	5	14	0	0	14	0	0
9	38030574	.	G	A	11	6	17	0	0	17	0	0
9	38033363	.	T	C	9	0	9	0	6	15	0	0
9	38033578	.	A	G	8	6	14	0	1	15	0	0
9	38061525	.	G	T	0	4	4	0	2	6	0	0
9	38061699	.	T	C	3	3	6	0	0	6	0	0
9	38061788	.	T	C	5	5	10	0	0	10	0	0
9	38063688	.	C	A	3	4	7	0	0	7	0	0
9	38063689	.	C	A	3	4	7	0	0	7	0	0
9	38064268	.	T	C	5	6	11	0	1	12	0	0
9	38064420	.	T	G	3	7	10	0	0	10	0	0
9	38064421	.	C	A	2	7	9	0	1	10	0	0
9	38064672	.	A	C	2	5	7	0	0	7	0	0
9	38142493	.	A	G	4	4	8	0	0	8	0	0
9	38161177	.	A	G	1	0	1	0	5	6	0	0
9	38161842	.	C	T	3	7	10	0	1	11	0	0
9	38161905	.	G	A	1	3	4	0	0	4	0	0
9	38269630	.	A	G	2	3	5	0	0	5	0	0
9	38273171	.	G	A	8	5	13	0	0	13	0	0
9	38273264	.	T	A	12	13	25	0	0	25	0	0
9	38276558	.	T	G	2	0	2	0	5	7	0	0
9	38277513	.	A	G	7	6	13	0	0	13	0	0
9	38278121	.	A	G	9	12	21	0	1	22	0	0
9	38278289	.	C	T	12	6	18	0	0	18	0	0
9	38278301	.	T	C	12	6	18	0	0	18	0	0
9	38278337	.	T	C	7	4	11	0	1	12	0	0
9	38283647	.	G	A	5	11	16	0	0	16	0	0
9	38283659	.	C	T	5	14	19	0	2	21	0	0
9	38284317	.	A	G	3	0	3	0	13	16	0	0
9	38285598	.	A	G	12	11	23	0	0	23	0	0
9	38290165	.	C	T	7	11	18	0	1	19	0	0
9	38290210	.	A	G	13	9	22	0	0	22	0	0
9	38290220	.	T	G	10	0	10	0	11	21	0	0
9	38290245	.	C	T	14	5	19	0	2	21	0	0
9	38290414	.	A	G	11	10	21	0	1	22	0	0
9	38290517	.	A	C	14	5	19	0	0	19	0	0
9	38290530	.	A	T	11	5	16	1	1	18	0	0
9	38290561	.	C	T	10	5	15	1	1	17	0	0
9	38290777	.	G	T	0	11	11	0	19	30	0	0
9	38290959	.	A	C	27	20	47	0	1	48	0	0
9	38291439	.	G	T	18	18	36	0	3	39	0	0
9	38291616	.	C	T	11	13	24	0	1	25	0	0
9	38291737	.	C	A	7	6	13	0	4	17	0	0
9	38308549	.	A	C	1	3	4	0	0	4	0	0
9	38348252	.	G	A	4	3	7	0	1	8	0	0
9	38351016	.	T	C	3	3	6	0	0	6	0	0
9	38353794	.	T	C	12	7	19	0	0	19	0	0
9	38354000	.	T	C	15	6	21	0	0	21	0	0
9	38354224	.	A	G	8	8	16	0	0	16	0	0
9	38354689	.	G	A	8	4	12	0	0	12	0	0
9	38359027	.	A	C	2	0	2	0	8	10	0	0
9	38359737	.	G	A	5	6	11	0	0	11	0	0
9	38360102	.	C	T	1	6	7	0	3	10	0	0
9	38362354	.	G	A	8	7	15	0	0	15	0	0
9	38362380	.	C	T	7	6	13	0	0	13	0	0
9	38368055	.	A	G	1	2	3	0	0	3	0	0
9	38377858	.	G	A	3	2	5	0	0	5	0	0
9	38385734	.	G	A	1	4	5	0	0	5	0	0
9	38386066	.	A	G	1	0	1	0	3	4	0	0
9	38386205	.	C	T	2	5	7	0	0	7	0	0
9	38386546	.	T	C	6	2	8	0	0	8	0	0
9	38386615	.	C	A	4	3	7	0	0	7	0	0
9	38388492	.	C	T	8	2	10	0	0	10	0	0
9	38388493	.	C	T	4	2	6	0	4	10	0	0
9	38388703	.	T	C	6	3	9	1	1	11	0	0
9	38389194	.	C	T	10	7	17	0	0	17	0	0
9	38389263	.	T	A	7	4	11	0	0	11	0	0
9	38389426	.	G	A	19	11	30	0	1	31	0	0
9	38389603	.	A	G	18	1	19	0	6	25	0	0
9	38389616	.	C	T	18	9	27	0	1	28	0	0
9	38389644	.	A	T	17	10	27	0	2	29	0	0
9	38389722	.	G	T	11	3	14	0	1	15	0	0
9	38389746	.	T	C	13	5	18	0	0	18	0	0
9	38389886	.	C	T	9	6	15	0	0	15	0	0
9	38391549	.	C	T	2	2	4	0	0	4	0	0
9	38400232	.	T	A	1	2	3	0	0	3	0	0
9	38400233	.	T	C	1	2	3	0	0	3	0	0
9	38403411	.	T	A	2	2	4	0	0	4	0	0
9	38405271	.	G	C	2	6	8	0	0	8	0	0
9	38418623	.	C	T	2	2	4	0	0	4	0	0
9	38418864	.	T	C	2	4	6	0	0	6	0	0
9	38427634	.	C	G	1	2	3	0	0	3	0	0
9	38427651	.	C	T	1	2	3	0	0	3	0	0
9	38429624	.	G	T	2	2	4	0	0	4	0	0
9	38433354	.	C	A	2	4	6	8	0	14	0	0
9	38456091	.	A	C	1	3	4	0	1	5	0	0
9	38456111	.	T	C	1	5	6	0	0	6	0	0
9	38456782	.	C	T	3	5	8	0	0	8	0	0
9	38476650	.	A	C	2	2	4	0	0	4	0	0
9	38476748	.	G	A	2	2	4	0	2	6	0	0
9	38478643	.	A	T	5	2	7	0	0	7	0	0
9	38479579	.	A	G	4	0	4	0	7	11	0	0
9	38481034	.	G	A	1	3	4	0	0	4	0	0
9	38495985	.	C	T	3	4	7	0	0	7	0	0
9	38497393	.	C	T	1	3	4	0	1	5	0	0
9	38500149	.	A	T	2	2	4	0	0	4	0	0
9	38600006	.	G	A	1	2	3	0	1	4	0	0
9	38603338	.	A	T	3	3	6	0	0	6	0	0
9	38603742	.	T	C	10	6	16	0	0	16	0	0
9	38620058	.	C	T	9	6	15	0	0	15	0	0
9	38620308	.	C	A	5	5	10	0	0	10	0	0
9	38620673	.	A	G	18	15	33	0	0	33	0	0
9	38638452	.	A	T	4	2	6	0	0	6	0	0
9	38638461	.	C	G	4	2	6	0	0	6	0	0
9	38638518	.	T	C	3	4	7	0	1	8	0	0
9	38638743	.	T	C	5	2	7	0	0	7	0	0
9	38638862	.	C	T	3	3	6	0	0	6	0	0
9	38638863	.	C	A	4	3	7	0	0	7	0	0
9	38638970	.	G	A	2	2	4	0	0	4	0	0
9	38639799	.	T	C	3	5	8	0	0	8	0	0
9	38639846	.	C	T	4	6	10	0	0	10	0	0
9	38639907	.	A	C	5	4	9	0	0	9	0	0
9	38640114	.	T	A	9	3	12	0	1	13	0	0
9	38640186	.	T	C	6	5	11	0	0	11	0	0
9	38640193	.	T	C	4	5	9	0	1	10	0	0
9	38640598	.	A	G	7	1	8	0	6	14	0	0
9	38640773	.	A	T	4	5	9	0	0	9	0	0
9	38641111	.	C	T	7	4	11	0	0	11	0	0
9	38765096	.	C	T	2	1	3	0	0	3	0	0
9	38765102	.	A	G	2	6	8	0	0	8	0	0
9	38765158	.	C	T	2	3	5	0	0	5	0	0
9	40928199	.	T	C	6	7	13	0	0	13	0	0
9	40928245	.	T	C	13	7	20	0	1	21	0	0
9	40928284	.	T	C	11	0	11	0	6	17	0	0
9	40928706	.	T	C	3	5	8	0	0	8	0	0
9	40928720	.	T	C	5	2	7	0	0	7	0	0
9	42421027	.	G	A	5	2	7	0	1	8	0	0
9	42421044	.	G	T	5	2	7	0	0	7	0	0
9	42644892	.	A	G	14	0	14	0	13	27	0	0
9	42649583	.	A	G	3	5	8	0	0	8	0	0
9	42649636	.	T	A	3	2	5	0	0	5	0	0
9	42649653	.	T	C	4	2	6	0	0	6	0	0
9	42649739	.	C	T	4	8	12	0	0	12	0	0
9	42649743	.	A	G	4	8	12	0	0	12	0	0
9	42649923	.	A	G	4	6	10	0	0	10	0	0
9	42657418	.	A	T	1	5	6	0	0	6	0	0
9	42728866	.	C	A	3	2	5	0	0	5	0	0
9	43082373	.	A	T	2	4	6	0	0	6	0	0
9	43082398	.	A	G	3	5	8	0	0	8	0	0
9	43082519	.	C	A	0	4	4	1	7	12	0	0
9	43082541	.	A	C	3	1	4	0	0	4	0	0
9	43082717	.	T	G	3	2	5	0	0	5	0	0
9	43085369	.	G	T	3	2	5	0	0	5	0	0
9	43085471	.	G	C	2	6	8	0	0	8	0	0
9	43085728	.	A	C	4	4	8	0	0	8	0	0
9	43150018	.	T	A	10	12	22	0	1	23	0	0
9	43150278	.	T	G	6	8	14	0	0	14	0	0
9	43150604	.	A	G	15	14	29	5	0	34	0	0
9	43150817	.	C	T	1	18	19	0	5	24	0	0
9	43153287	.	C	T	9	12	21	0	1	22	0	0
9	43154841	.	C	T	6	12	18	0	1	19	0	0
9	43243265	.	A	C	7	3	10	0	0	10	0	0
9	43243266	.	T	C	7	2	9	0	1	10	0	0
9	43552604	.	C	A	6	8	14	0	1	15	0	0
9	43552687	.	A	C	19	11	30	2	1	33	0	0
9	43553036	.	G	T	20	8	28	0	0	28	0	0
9	43559501	.	A	C	4	7	11	0	2	13	0	0
9	43612482	.	T	G	6	3	9	0	0	9	0	0
9	43617899	.	A	G	6	4	10	0	0	10	0	0
9	44080301	.	C	T	1	3	4	0	0	4	0	0
9	44080411	.	C	T	2	2	4	0	0	4	0	0
9	44097854	.	C	T	0	11	11	0	6	17	0	0
9	44109260	.	A	G	3	6	9	0	0	9	0	0
9	44109589	.	T	C	3	0	3	0	6	9	0	0
9	44109595	.	T	C	3	0	3	0	7	10	0	0
9	44292285	.	A	C	32	0	32	0	18	50	0	0
9	44292737	.	T	C	26	31	57	0	1	58	0	0
9	44292909	.	C	T	5	25	30	0	27	57	0	0
9	44293488	.	C	T	16	16	32	0	3	35	0	0
9	44294792	.	A	G	10	9	19	0	1	20	0	0
9	44411647	.	A	G	0	5	5	0	1	6	0	0
9	44411652	.	C	A	1	5	6	0	0	6	0	0
9	44419793	.	C	A	3	1	4	0	1	5	0	0
9	44431117	.	G	A	3	4	7	0	1	8	0	0
9	44431157	.	C	G	3	2	5	0	0	5	0	0
9	44443998	.	T	C	15	13	28	0	0	28	0	0
9	44469318	.	A	G	19	0	19	0	14	33	0	0
9	44486011	.	A	G	7	4	11	0	3	14	0	0
9	44488578	.	T	A	7	6	13	0	0	13	0	0
9	44488620	.	G	A	5	4	9	0	1	10	0	0
9	44489843	.	G	A	0	9	9	0	5	14	0	0
9	44489844	.	T	A	5	9	14	0	0	14	0	0
9	44498332	.	T	C	1	2	3	0	1	4	0	0
9	44511218	.	C	T	1	3	4	0	0	4	0	0
9	44837441	.	G	T	2	1	3	0	2	5	0	0
9	44837588	.	A	G	2	2	4	0	0	4	0	0
9	44961166	.	A	G	3	2	5	0	1	6	0	0
9	45551273	.	T	C	8	10	18	2	2	22	0	0
9	45552266	.	A	T	20	7	27	1	1	29	0	0
9	45552338	.	T	G	9	12	21	0	0	21	0	0
9	45552364	.	G	A	2	9	11	0	7	18	0	0
9	45552386	.	C	G	7	10	17	0	1	18	0	0
9	45552567	.	G	A	1	15	16	0	17	34	1	0
9	45552715	.	C	T	15	16	31	0	3	34	0	0
9	45552806	.	G	A	2	23	25	0	15	40	0	0
9	45552881	.	T	C	18	19	37	0	3	40	0	0
9	45552924	.	C	A	22	11	33	0	2	35	0	0
9	45552957	.	C	T	19	13	32	0	1	33	0	0
9	46409337	.	A	G	2	3	5	0	0	5	0	0
9	46409361	.	G	C	3	3	6	0	0	6	0	0
9	46692261	.	T	G	12	23	35	0	5	40	0	0
9	46821464	.	C	T	7	9	16	0	1	17	0	0
9	46821568	.	C	A	1	4	5	0	0	5	0	0
9	46821576	.	G	A	1	3	4	0	0	4	0	0
9	46821853	.	G	A	3	2	5	1	0	6	0	0
9	46821855	.	G	T	3	2	5	1	0	6	0	0
9	46821905	.	A	G	6	6	12	0	1	13	0	0
9	46821916	.	A	T	6	5	11	0	2	13	0	0
9	46823198	.	C	T	7	12	19	0	0	19	0	0
9	46823325	.	G	A	9	7	16	0	1	17	0	0
9	46823366	.	T	C	7	6	13	1	0	14	0	0
9	46823524	.	A	G	2	7	9	0	1	10	0	0
9	46824110	.	A	G	6	2	8	0	0	8	0	0
9	46824160	.	T	A	3	3	6	0	0	6	0	0
9	48054753	.	G	A	27	20	47	0	1	48	0	0
9	48060592	.	G	C	18	10	28	0	0	28	0	0
9	48076973	.	C	T	8	8	16	0	1	17	0	0
9	48123222	.	G	C	3	3	6	0	0	6	0	0
9	48127200	.	G	A	5	4	9	0	0	9	0	0
9	48128027	.	G	T	1	4	5	0	3	8	0	0
9	48131814	.	A	T	5	4	9	0	0	9	0	0
9	48131865	.	G	A	2	2	4	0	0	4	0	0
9	48131956	.	G	A	2	4	6	1	0	7	0	0
9	48131997	.	C	T	0	7	7	0	2	9	0	0
9	48132029	.	T	C	3	1	4	0	7	11	0	0
9	48132037	.	T	A	6	7	13	0	0	13	0	0
9	48132095	.	A	C	10	12	22	0	1	23	0	0
9	48132156	.	A	C	4	10	14	0	2	16	0	0
9	48132176	.	C	T	4	8	12	0	0	12	0	0
9	48132194	.	G	T	4	4	8	0	0	8	0	0
9	48132309	.	G	T	2	4	6	0	1	7	0	0
9	48132336	.	C	T	2	4	6	0	2	8	0	0
9	48132531	.	G	A	3	4	7	0	0	7	0	0
9	48132592	.	G	T	3	3	6	0	0	6	0	0
9	48133105	.	G	T	6	6	12	0	0	12	0	0
9	48133541	.	T	C	2	3	5	0	1	6	0	0
9	48133687	.	A	G	3	3	6	0	0	6	0	0
9	48133900	.	G	T	3	3	6	0	1	7	0	0
9	48133967	.	C	T	1	2	3	0	0	3	0	0
9	48134351	.	G	A	4	6	10	0	1	11	0	0
9	48134568	.	G	A	3	6	9	0	6	15	0	0
9	48134678	.	A	T	5	2	7	0	1	8	0	0
9	48186519	.	C	A	3	4	7	0	0	7	0	0
9	48189403	.	C	G	0	2	2	0	5	7	0	0
9	48189411	.	T	C	4	2	6	0	0	6	0	0
9	48222670	.	G	A	0	2	2	0	1	3	0	0
9	48225779	.	T	C	2	2	4	0	0	4	0	0
9	48225854	.	G	A	1	3	4	0	0	4	0	0
9	48227847	.	T	A	2	4	6	0	0	6	0	0
9	48227885	.	T	G	2	3	5	0	0	5	0	0
9	48227953	.	T	C	2	4	6	0	0	6	0	0
9	48228950	.	T	C	2	3	5	0	0	5	0	0
9	48229039	.	C	G	2	4	6	0	0	6	0	0
9	48229074	.	T	C	4	2	6	0	0	6	0	0
9	48230871	.	C	A	1	4	5	0	0	5	0	0
9	48264034	.	C	T	2	2	4	0	0	4	0	0
9	48266182	.	C	T	2	2	4	0	0	4	0	0
9	48266227	.	A	G	1	0	1	0	3	4	0	0
9	48266242	.	C	G	1	2	3	0	0	3	0	0
9	48284901	.	T	C	15	12	27	0	1	28	0	0
9	48284917	.	C	A	2	13	15	0	13	28	0	0
9	48284972	.	T	C	9	8	17	0	1	18	0	0
9	48285019	.	G	A	10	5	15	0	0	15	0	0
9	48286702	.	G	A	8	5	13	0	1	14	0	0
9	48287441	.	G	A	7	7	14	0	0	14	0	0
9	48289797	.	A	T	5	6	11	0	1	12	0	0
9	48289961	.	A	G	1	5	6	0	1	7	0	0
9	48653759	.	T	C	1	2	3	0	1	4	0	0
9	48665654	.	G	A	2	2	4	0	1	5	0	0
9	48668834	.	C	G	5	3	8	0	0	8	0	0
9	48670316	.	C	T	2	3	5	0	0	5	0	0
9	48670395	.	A	C	2	2	4	0	0	4	0	0
9	48670454	.	T	G	2	4	6	0	0	6	0	0
9	48670525	.	T	C	2	5	7	0	0	7	0	0
9	48670660	.	G	A	0	4	4	0	6	10	0	0
9	48670747	.	T	G	2	0	2	0	3	5	0	0
9	48670748	.	T	C	2	3	5	0	0	5	0	0
9	48671010	.	T	G	2	2	4	2	0	6	0	0
9	48671052	.	A	G	1	3	4	0	0	4	0	0
9	48706302	.	C	T	2	4	6	0	1	7	0	0
9	48706305	.	C	T	3	4	7	0	0	7	0	0
9	48718225	.	C	A	0	5	5	0	1	6	0	0
9	48718229	.	C	G	2	5	7	0	0	7	0	0
9	48870578	.	T	C	15	0	15	0	12	27	0	0
9	48870593	.	A	T	13	14	27	0	0	28	1	0
9	48870627	.	T	A	11	4	15	0	1	16	0	0
9	48870886	.	C	T	9	9	18	1	0	19	0	0
9	48871080	.	G	C	4	11	15	0	1	16	0	0
9	48871973	.	A	C	5	8	13	4	0	17	0	0
9	48871996	.	A	T	9	4	13	3	0	16	0	0
9	48872039	.	C	G	0	4	4	3	5	12	0	0
9	48872688	.	A	T	3	2	5	0	0	5	0	0
9	48872694	.	A	G	4	2	6	0	0	6	0	0
9	48872890	.	C	A	2	4	6	0	0	6	0	0
9	48872924	.	A	G	5	4	9	0	1	10	0	0
9	48872926	.	C	T	0	5	5	0	5	10	0	0
9	48873092	.	G	C	3	2	5	0	0	5	0	0
9	48873144	.	A	G	2	5	7	1	0	8	0	0
9	48873150	.	C	T	1	3	4	1	5	10	0	0
9	48873302	.	T	C	3	3	6	0	0	6	0	0
9	48873371	.	A	G	2	3	5	0	0	5	0	0
9	48873522	.	C	G	5	2	7	0	0	7	0	0
9	48874562	.	G	A	2	4	6	0	0	6	0	0
9	48874577	.	G	A	2	3	5	0	2	7	0	0
9	48874728	.	T	C	2	2	4	1	1	6	0	0
9	48875510	.	T	C	1	3	4	0	0	4	0	0
9	48875516	.	G	A	2	2	4	0	1	5	0	0
9	50196047	.	A	C	1	2	3	0	0	3	0	0
9	50205289	.	A	C	2	4	6	0	1	7	0	0
9	51271433	.	A	G	1	0	1	0	2	3	0	0
9	51302422	.	A	G	2	3	5	0	3	8	0	0
9	51430606	.	C	G	1	4	5	0	0	5	0	0
9	51430737	.	C	T	2	4	6	0	2	8	0	0
9	51430767	.	T	A	2	6	8	0	0	8	0	0
9	51430826	.	A	T	2	4	6	0	0	6	0	0
9	51430886	.	G	C	2	3	5	0	0	5	0	0
9	51431179	.	C	G	10	14	24	0	1	25	0	0
9	51431642	.	A	C	4	0	4	0	5	9	0	0
9	51431831	.	G	A	3	2	5	0	1	6	0	0
9	51431843	.	C	G	0	2	2	0	4	6	0	0
9	51432381	.	C	T	0	4	4	0	1	5	0	0
9	51996212	.	A	T	11	5	16	0	0	16	0	0
9	51996246	.	C	T	0	10	10	0	5	15	0	0
9	51996280	.	T	A	9	5	14	0	2	16	0	0
9	51996281	.	G	A	9	6	15	0	1	16	0	0
9	51996444	.	T	G	19	9	28	0	0	28	0	0
9	51996469	.	C	T	1	15	16	0	13	29	0	0
9	51996788	.	A	G	3	2	5	1	1	7	0	0
9	51996876	.	A	G	5	3	8	0	0	8	0	0
9	51997231	.	T	A	3	5	8	0	0	8	0	0
9	51997232	.	C	A	0	5	5	0	3	8	0	0
9	51998761	.	C	G	1	3	4	0	0	4	0	0
9	51999991	.	A	G	1	4	5	0	0	5	0	0
9	52000032	.	C	T	0	2	2	0	2	4	0	0
9	52000088	.	G	A	1	3	4	1	0	5	0	0
9	52378682	.	C	T	27	9	36	0	1	37	0	0
9	52378697	.	A	G	24	17	41	0	1	42	0	0
9	52378832	.	T	A	37	12	49	1	2	52	0	0
9	52432669	.	T	C	1	3	4	0	1	5	0	0
9	52433132	.	T	C	2	2	4	0	0	4	0	0
9	52435058	.	G	C	2	2	4	0	0	4	0	0
9	52435100	.	G	A	3	5	8	0	0	8	0	0
9	52435112	.	C	T	5	5	10	0	0	10	0	0
9	52439166	.	G	A	3	2	5	0	0	5	0	0
9	52439171	.	C	A	2	3	5	0	0	5	0	0
9	52479199	.	T	C	1	4	5	0	0	5	0	0
9	52490127	.	A	G	1	2	3	0	0	3	0	0
9	52490157	.	C	T	1	2	3	0	0	3	0	0
9	52492641	.	A	C	1	2	3	0	0	3	0	0
9	52492705	.	A	G	2	6	8	0	0	8	0	0
9	52493059	.	A	T	9	2	11	0	1	12	0	0
9	52493231	.	A	T	3	3	6	0	2	8	0	0
9	52539290	.	G	A	0	6	6	0	7	13	0	0
9	52539453	.	C	T	9	18	27	0	1	28	0	0
9	52539629	.	C	T	8	6	14	0	1	15	0	0
9	52564578	.	T	C	5	0	5	0	5	10	0	0
9	52564622	.	T	C	5	4	9	0	1	11	1	0
9	52572555	.	C	T	5	4	9	0	0	9	0	0
9	52572573	.	G	A	5	3	8	0	1	9	0	0
9	52572609	.	C	G	5	2	7	0	0	7	0	0
9	52629113	.	C	T	3	2	5	0	1	6	0	0
9	52629119	.	C	T	2	3	5	0	0	5	0	0
9	53276681	.	G	A	2	6	8	0	6	14	0	0
9	53276976	.	C	T	3	6	9	0	2	11	0	0
9	53277068	.	C	G	8	0	8	0	5	13	0	0
9	53277131	.	A	T	16	7	23	0	0	23	0	0
9	53277453	.	G	A	2	10	12	0	8	20	0	0
9	53277493	.	A	T	7	11	18	0	4	22	0	0
9	54712413	.	T	C	12	0	12	11	10	33	0	0
9	56225617	.	A	G	4	5	9	0	0	9	0	0
